team,n,rank,w,d,l,gf,ga,gd,pts
FCSB,0,1,9,5,0,27,11,16,32
CFR Cluj,0,2,6,6,2,14,9,5,24
FC Botosani,0,3,4,5,5,7,13,-6,17
D Bucuresti,0,4,4,4,6,18,19,-1,16
Universitate,0,5,3,5,6,15,21,-6,14
Concordia Ch,0,6,2,3,9,16,24,-8,9
FCSB,1,1,8,5,1,26,13,13,29
CFR Cluj,1,2,6,6,2,14,10,4,24
Universitate,1,3,4,5,5,17,19,-2,17
FC Botosani,1,4,4,5,5,8,13,-5,17
D Bucuresti,1,5,3,4,7,18,23,-5,13
Concordia Ch,1,6,3,3,8,19,24,-5,12
FCSB,2,1,7,6,1,25,14,11,27
CFR Cluj,2,2,5,8,1,15,9,6,23
Universitate,2,3,4,6,4,18,20,-2,18
D Bucuresti,2,4,4,5,5,17,18,-1,17
FC Botosani,2,5,3,5,6,5,13,-8,14
Concordia Ch,2,6,2,4,8,15,21,-6,10
FCSB,3,1,9,5,0,28,12,16,32
CFR Cluj,3,2,5,7,2,14,10,4,22
FC Botosani,3,3,4,5,5,8,14,-6,17
Universitate,3,4,3,6,5,15,20,-5,15
D Bucuresti,3,5,3,5,6,18,22,-4,14
Concordia Ch,3,6,3,2,9,17,22,-5,11
FCSB,4,1,8,6,0,26,12,14,30
CFR Cluj,4,2,6,7,1,17,10,7,25
D Bucuresti,4,3,5,4,5,21,18,3,19
FC Botosani,4,4,4,4,6,8,14,-6,16
Universitate,4,5,3,5,6,15,21,-6,14
Concordia Ch,4,6,2,2,10,16,28,-12,8
FCSB,5,1,8,6,0,26,12,14,30
CFR Cluj,5,2,5,8,1,14,8,6,23
D Bucuresti,5,3,4,4,6,19,22,-3,16
Universitate,5,4,3,6,5,15,20,-5,15
FC Botosani,5,5,3,5,6,5,13,-8,14
Concordia Ch,5,6,3,3,8,19,23,-4,12
FCSB,6,1,9,5,0,26,10,16,32
CFR Cluj,6,2,5,6,3,14,10,4,21
FC Botosani,6,3,5,4,5,9,13,-4,19
Universitate,6,4,4,5,5,16,21,-5,17
D Bucuresti,6,5,4,4,6,19,22,-3,16
Concordia Ch,6,6,2,2,10,16,24,-8,8
FCSB,7,1,7,5,2,23,14,9,26
CFR Cluj,7,2,6,6,2,16,9,7,24
Universitate,7,3,5,5,4,18,19,-1,20
FC Botosani,7,4,5,4,5,10,15,-5,19
D Bucuresti,7,5,3,4,7,18,22,-4,13
Concordia Ch,7,6,3,2,9,19,25,-6,11
FCSB,8,1,8,5,1,24,12,12,29
CFR Cluj,8,2,6,6,2,16,9,7,24
Universitate,8,3,4,5,5,17,21,-4,17
Concordia Ch,8,4,4,2,8,19,21,-2,14
D Bucuresti,8,5,3,5,6,18,22,-4,14
FC Botosani,8,6,3,5,6,7,16,-9,14
FCSB,9,1,7,6,1,26,14,12,27
CFR Cluj,9,2,7,6,1,18,10,8,27
D Bucuresti,9,3,4,4,6,17,20,-3,16
Universitate,9,4,3,6,5,14,19,-5,15
FC Botosani,9,5,3,5,6,6,14,-8,14
Concordia Ch,9,6,3,3,8,18,22,-4,12
FCSB,10,1,8,6,0,28,13,15,30
CFR Cluj,10,2,6,6,2,14,9,5,24
D Bucuresti,10,3,4,5,5,17,18,-1,17
FC Botosani,10,4,4,5,5,7,12,-5,17
Universitate,10,5,3,6,5,17,22,-5,15
Concordia Ch,10,6,2,2,10,15,24,-9,8
CFR Cluj,11,1,7,6,1,17,8,9,27
FCSB,11,2,7,5,2,24,15,9,26
D Bucuresti,11,3,5,4,5,19,18,1,19
Universitate,11,4,4,5,5,17,20,-3,17
FC Botosani,11,5,3,5,6,5,13,-8,14
Concordia Ch,11,6,2,3,9,15,23,-8,9
FCSB,12,1,8,5,1,28,15,13,29
CFR Cluj,12,2,6,6,2,15,8,7,24
Universitate,12,3,4,5,5,18,23,-5,17
FC Botosani,12,4,3,6,5,5,12,-7,15
D Bucuresti,12,5,3,5,6,16,20,-4,14
Concordia Ch,12,6,3,3,8,17,21,-4,12
FCSB,13,1,7,5,2,23,12,11,26
CFR Cluj,13,2,6,6,2,14,8,6,24
Universitate,13,3,5,5,4,16,18,-2,20
FC Botosani,13,4,4,5,5,6,12,-6,17
D Bucuresti,13,5,3,5,6,16,20,-4,14
Concordia Ch,13,6,3,2,9,17,22,-5,11
FCSB,14,1,9,5,0,26,10,16,32
CFR Cluj,14,2,6,6,2,15,9,6,24
D Bucuresti,14,3,5,4,5,21,19,2,19
Universitate,14,4,3,5,6,15,22,-7,14
FC Botosani,14,5,3,5,6,7,15,-8,14
Concordia Ch,14,6,2,3,9,16,25,-9,9
FCSB,15,1,8,5,1,28,12,16,29
CFR Cluj,15,2,6,6,2,16,12,4,24
D Bucuresti,15,3,4,5,5,19,20,-1,17
Universitate,15,4,4,5,5,15,20,-5,17
FC Botosani,15,5,4,5,5,9,15,-6,17
Concordia Ch,15,6,2,2,10,16,24,-8,8
FCSB,16,1,8,5,1,26,15,11,29
CFR Cluj,16,2,5,7,2,15,10,5,22
Universitate,16,3,4,6,4,19,20,-1,18
FC Botosani,16,4,4,5,5,10,15,-5,17
D Bucuresti,16,5,3,5,6,20,23,-3,14
Concordia Ch,16,6,3,2,9,17,24,-7,11
FCSB,17,1,8,6,0,24,10,14,30
CFR Cluj,17,2,5,7,2,15,10,5,22
Universitate,17,3,4,5,5,17,21,-4,17
D Bucuresti,17,4,4,4,6,18,22,-4,16
Concordia Ch,17,5,4,2,8,20,21,-1,14
FC Botosani,17,6,3,4,7,5,15,-10,13
FCSB,18,1,8,5,1,25,12,13,29
CFR Cluj,18,2,7,6,1,16,8,8,27
D Bucuresti,18,3,4,4,6,19,21,-2,16
Concordia Ch,18,4,4,2,8,18,21,-3,14
Universitate,18,5,3,5,6,16,22,-6,14
FC Botosani,18,6,3,4,7,6,16,-10,13
FCSB,19,1,8,6,0,29,12,17,30
CFR Cluj,19,2,6,7,1,17,9,8,25
D Bucuresti,19,3,4,4,6,19,22,-3,16
Concordia Ch,19,4,4,2,8,22,23,-1,14
Universitate,19,5,3,5,6,14,24,-10,14
FC Botosani,19,6,3,4,7,7,18,-11,13
FCSB,20,1,8,5,1,24,12,12,29
CFR Cluj,20,2,6,6,2,15,8,7,24
Universitate,20,3,4,5,5,16,20,-4,17
D Bucuresti,20,4,4,4,6,17,19,-2,16
FC Botosani,20,5,4,4,6,9,14,-5,16
Concordia Ch,20,6,3,2,9,17,25,-8,11
FCSB,21,1,7,6,1,24,12,12,27
CFR Cluj,21,2,5,8,1,14,8,6,23
Universitate,21,3,4,6,4,17,20,-3,18
FC Botosani,21,4,4,5,5,6,12,-6,17
D Bucuresti,21,5,3,4,7,17,24,-7,13
Concordia Ch,21,6,3,3,8,20,22,-2,12
FCSB,22,1,8,5,1,26,12,14,29
CFR Cluj,22,2,6,6,2,15,10,5,24
Universitate,22,3,4,5,5,15,19,-4,17
D Bucuresti,22,4,4,4,6,22,23,-1,16
FC Botosani,22,5,4,4,6,6,18,-12,16
Concordia Ch,22,6,3,2,9,20,22,-2,11
FCSB,23,1,9,5,0,29,12,17,32
CFR Cluj,23,2,5,7,2,16,11,5,22
D Bucuresti,23,3,4,5,5,19,20,-1,17
FC Botosani,23,4,4,4,6,8,13,-5,16
Universitate,23,5,3,6,5,15,22,-7,15
Concordia Ch,23,6,2,3,9,17,26,-9,9
FCSB,24,1,8,6,0,26,11,15,30
CFR Cluj,24,2,5,8,1,13,7,6,23
D Bucuresti,24,3,4,4,6,19,20,-1,16
FC Botosani,24,4,4,4,6,8,16,-8,16
Universitate,24,5,3,6,5,15,21,-6,15
Concordia Ch,24,6,3,2,9,17,23,-6,11
FCSB,25,1,8,6,0,26,11,15,30
CFR Cluj,25,2,5,7,2,13,9,4,22
FC Botosani,25,3,4,5,5,7,12,-5,17
D Bucuresti,25,4,4,4,6,18,20,-2,16
Universitate,25,5,3,7,4,15,19,-4,16
Concordia Ch,25,6,2,3,9,15,23,-8,9
FCSB,26,1,8,6,0,29,12,17,30
CFR Cluj,26,2,6,7,1,16,9,7,25
FC Botosani,26,3,4,4,6,7,14,-7,16
D Bucuresti,26,4,3,5,6,17,20,-3,14
Universitate,26,5,3,5,6,16,25,-9,14
Concordia Ch,26,6,3,3,8,16,21,-5,12
FCSB,27,1,8,5,1,25,12,13,29
CFR Cluj,27,2,6,7,1,17,9,8,25
FC Botosani,27,3,4,4,6,8,15,-7,16
Universitate,27,4,3,6,5,16,22,-6,15
Concordia Ch,27,5,4,2,8,18,21,-3,14
D Bucuresti,27,6,3,4,7,18,23,-5,13
FCSB,28,1,8,5,1,26,12,14,29
CFR Cluj,28,2,6,6,2,14,9,5,24
Universitate,28,3,4,5,5,16,20,-4,17
FC Botosani,28,4,4,5,5,9,13,-4,17
D Bucuresti,28,5,3,4,7,17,24,-7,13
Concordia Ch,28,6,3,3,8,19,23,-4,12
FCSB,29,1,7,6,1,23,11,12,27
CFR Cluj,29,2,5,7,2,13,8,5,22
Universitate,29,3,5,5,4,16,18,-2,20
D Bucuresti,29,4,4,5,5,18,19,-1,17
FC Botosani,29,5,3,4,7,5,14,-9,13
Concordia Ch,29,6,3,3,8,17,22,-5,12
FCSB,30,1,8,5,1,24,12,12,29
CFR Cluj,30,2,6,6,2,15,8,7,24
Universitate,30,3,4,5,5,16,20,-4,17
D Bucuresti,30,4,4,4,6,19,19,0,16
FC Botosani,30,5,4,4,6,7,14,-7,16
Concordia Ch,30,6,3,2,9,17,25,-8,11
FCSB,31,1,7,6,1,25,14,11,27
CFR Cluj,31,2,5,7,2,14,10,4,22
Universitate,31,3,5,5,4,19,19,0,20
D Bucuresti,31,4,4,4,6,17,19,-2,16
FC Botosani,31,5,4,4,6,6,13,-7,16
Concordia Ch,31,6,3,2,9,16,22,-6,11
FCSB,32,1,7,5,2,23,13,10,26
CFR Cluj,32,2,6,6,2,14,9,5,24
Universitate,32,3,5,5,4,18,18,0,20
FC Botosani,32,4,4,5,5,9,15,-6,17
D Bucuresti,32,5,3,4,7,17,24,-7,13
Concordia Ch,32,6,3,3,8,21,23,-2,12
FCSB,33,1,8,5,1,24,11,13,29
CFR Cluj,33,2,5,7,2,15,10,5,22
Universitate,33,3,4,6,4,17,20,-3,18
Concordia Ch,33,4,4,2,8,19,22,-3,14
D Bucuresti,33,5,3,5,6,17,21,-4,14
FC Botosani,33,6,3,5,6,7,15,-8,14
FCSB,34,1,7,6,1,23,11,12,27
CFR Cluj,34,2,6,7,1,14,7,7,25
Universitate,34,3,3,7,4,14,18,-4,16
D Bucuresti,34,4,3,5,6,16,19,-3,14
Concordia Ch,34,5,4,2,8,18,22,-4,14
FC Botosani,34,6,3,5,6,6,14,-8,14
FCSB,35,1,8,6,0,26,12,14,30
CFR Cluj,35,2,6,7,1,16,9,7,25
D Bucuresti,35,3,4,4,6,21,19,2,16
FC Botosani,35,4,4,4,6,7,18,-11,16
Universitate,35,5,3,5,6,16,22,-6,14
Concordia Ch,35,6,3,2,9,17,23,-6,11
FCSB,36,1,7,6,1,24,12,12,27
CFR Cluj,36,2,6,7,1,14,7,7,25
Universitate,36,3,3,7,4,15,19,-4,16
D Bucuresti,36,4,3,6,5,19,21,-2,15
FC Botosani,36,5,3,6,5,7,14,-7,15
Concordia Ch,36,6,2,4,8,18,24,-6,10
FCSB,37,1,9,5,0,28,10,18,32
CFR Cluj,37,2,6,6,2,14,10,4,24
D Bucuresti,37,3,4,4,6,22,23,-1,16
Concordia Ch,37,4,4,2,8,21,23,-2,14
Universitate,37,5,3,5,6,14,21,-7,14
FC Botosani,37,6,3,4,7,7,19,-12,13
FCSB,38,1,8,5,1,26,14,12,29
CFR Cluj,38,2,6,6,2,16,10,6,24
Universitate,38,3,4,5,5,19,22,-3,17
FC Botosani,38,4,4,5,5,7,13,-6,17
D Bucuresti,38,5,3,5,6,17,20,-3,14
Concordia Ch,38,6,3,2,9,16,22,-6,11
FCSB,39,1,8,5,1,26,12,14,29
CFR Cluj,39,2,7,6,1,17,8,9,27
D Bucuresti,39,3,4,4,6,19,20,-1,16
FC Botosani,39,4,4,4,6,7,15,-8,16
Universitate,39,5,3,5,6,15,23,-8,14
Concordia Ch,39,6,3,2,9,17,23,-6,11
FCSB,40,1,7,6,1,24,13,11,27
CFR Cluj,40,2,6,7,1,15,8,7,25
Universitate,40,3,4,5,5,18,21,-3,17
FC Botosani,40,4,4,5,5,9,14,-5,17
D Bucuresti,40,5,3,5,6,18,22,-4,14
Concordia Ch,40,6,2,4,8,17,23,-6,10
FCSB,41,1,7,6,1,23,11,12,27
CFR Cluj,41,2,6,7,1,15,7,8,25
Universitate,41,3,4,5,5,15,20,-5,17
D Bucuresti,41,4,4,4,6,22,23,-1,16
FC Botosani,41,5,3,5,6,5,14,-9,14
Concordia Ch,41,6,3,3,8,20,25,-5,12
FCSB,42,1,8,6,0,25,11,14,30
CFR Cluj,42,2,5,7,2,14,10,4,22
FC Botosani,42,3,5,4,5,10,13,-3,19
Universitate,42,4,4,5,5,16,19,-3,17
D Bucuresti,42,5,3,5,6,17,22,-5,14
Concordia Ch,42,6,2,3,9,17,24,-7,9
FCSB,43,1,7,6,1,24,12,12,27
CFR Cluj,43,2,5,8,1,16,10,6,23
FC Botosani,43,3,5,4,5,7,12,-5,19
Universitate,43,4,4,6,4,17,20,-3,18
D Bucuresti,43,5,3,4,7,16,22,-6,13
Concordia Ch,43,6,3,2,9,18,22,-4,11
FCSB,44,1,8,5,1,27,15,12,29
CFR Cluj,44,2,5,6,3,16,12,4,21
Universitate,44,3,5,5,4,17,18,-1,20
D Bucuresti,44,4,5,4,5,18,18,0,19
FC Botosani,44,5,3,4,7,5,16,-11,13
Concordia Ch,44,6,3,2,9,18,22,-4,11
FCSB,45,1,8,6,0,27,12,15,30
CFR Cluj,45,2,5,6,3,14,11,3,21
Universitate,45,3,4,6,4,18,21,-3,18
FC Botosani,45,4,4,5,5,10,16,-6,17
D Bucuresti,45,5,3,5,6,19,22,-3,14
Concordia Ch,45,6,2,4,8,18,24,-6,10
FCSB,46,1,8,6,0,27,12,15,30
CFR Cluj,46,2,6,6,2,15,10,5,24
D Bucuresti,46,3,5,4,5,22,19,3,19
FC Botosani,46,4,4,4,6,7,14,-7,16
Universitate,46,5,3,6,5,17,22,-5,15
Concordia Ch,46,6,2,2,10,16,27,-11,8
FCSB,47,1,9,5,0,27,11,16,32
CFR Cluj,47,2,5,7,2,14,10,4,22
FC Botosani,47,3,4,4,6,6,13,-7,16
Universitate,47,4,3,6,5,16,21,-5,15
D Bucuresti,47,5,3,5,6,16,19,-3,14
Concordia Ch,47,6,3,3,8,16,21,-5,12
FCSB,48,1,9,5,0,30,13,17,32
CFR Cluj,48,2,6,6,2,18,12,6,24
D Bucuresti,48,3,3,6,5,19,21,-2,15
Universitate,48,4,3,5,6,14,22,-8,14
FC Botosani,48,5,3,5,6,6,14,-8,14
Concordia Ch,48,6,3,3,8,18,23,-5,12
FCSB,49,1,8,6,0,27,12,15,30
CFR Cluj,49,2,6,7,1,16,9,7,25
D Bucuresti,49,3,3,6,5,19,21,-2,15
Universitate,49,4,3,5,6,14,21,-7,14
FC Botosani,49,5,3,5,6,6,14,-8,14
Concordia Ch,49,6,3,3,8,18,23,-5,12
FCSB,50,1,7,7,0,25,12,13,28
CFR Cluj,50,2,6,7,1,14,7,7,25
FC Botosani,50,3,5,4,5,10,13,-3,19
D Bucuresti,50,4,4,4,6,17,20,-3,16
Universitate,50,5,3,6,5,16,21,-5,15
Concordia Ch,50,6,2,2,10,16,25,-9,8
FCSB,51,1,8,6,0,25,11,14,30
CFR Cluj,51,2,6,6,2,15,8,7,24
D Bucuresti,51,3,4,4,6,19,21,-2,16
FC Botosani,51,4,4,4,6,6,14,-8,16
Universitate,51,5,3,6,5,15,21,-6,15
Concordia Ch,51,6,3,2,9,18,23,-5,11
FCSB,52,1,8,5,1,26,13,13,29
CFR Cluj,52,2,6,6,2,16,8,8,24
Universitate,52,3,4,5,5,17,23,-6,17
FC Botosani,52,4,4,4,6,7,14,-7,16
Concordia Ch,52,5,4,2,8,19,22,-3,14
D Bucuresti,52,6,3,4,7,17,22,-5,13
FCSB,53,1,8,6,0,27,12,15,30
CFR Cluj,53,2,5,7,2,14,10,4,22
D Bucuresti,53,3,4,5,5,19,20,-1,17
Universitate,53,4,3,7,4,17,21,-4,16
FC Botosani,53,5,3,5,6,8,16,-8,14
Concordia Ch,53,6,3,2,9,19,25,-6,11
FCSB,54,1,8,6,0,30,14,16,30
CFR Cluj,54,2,6,7,1,17,9,8,25
FC Botosani,54,3,4,5,5,8,14,-6,17
D Bucuresti,54,4,3,6,5,18,20,-2,15
Universitate,54,5,3,5,6,16,25,-9,14
Concordia Ch,54,6,2,3,9,17,24,-7,9
FCSB,55,1,8,5,1,26,12,14,29
CFR Cluj,55,2,5,6,3,14,11,3,21
Universitate,55,3,5,5,4,18,20,-2,20
D Bucuresti,55,4,5,4,5,19,18,1,19
FC Botosani,55,5,4,4,6,8,14,-6,16
Concordia Ch,55,6,2,2,10,16,26,-10,8
FCSB,56,1,8,5,1,26,12,14,29
CFR Cluj,56,2,6,7,1,15,8,7,25
FC Botosani,56,3,5,4,5,11,13,-2,19
Universitate,56,4,3,6,5,16,22,-6,15
D Bucuresti,56,5,3,4,7,18,24,-6,13
Concordia Ch,56,6,3,2,9,18,25,-7,11
FCSB,57,1,8,6,0,24,10,14,30
CFR Cluj,57,2,6,7,1,15,7,8,25
FC Botosani,57,3,4,5,5,6,12,-6,17
D Bucuresti,57,4,3,6,5,17,19,-2,15
Universitate,57,5,3,5,6,14,21,-7,14
Concordia Ch,57,6,2,3,9,16,23,-7,9
FCSB,58,1,9,5,0,26,11,15,32
CFR Cluj,58,2,6,6,2,15,9,6,24
D Bucuresti,58,3,5,4,5,19,19,0,19
FC Botosani,58,4,4,4,6,6,13,-7,16
Universitate,58,5,3,5,6,14,20,-6,14
Concordia Ch,58,6,2,2,10,16,24,-8,8
FCSB,59,1,8,6,0,24,10,14,30
CFR Cluj,59,2,6,6,2,14,8,6,24
FC Botosani,59,3,5,4,5,10,14,-4,19
D Bucuresti,59,4,4,4,6,19,21,-2,16
Universitate,59,5,3,6,5,14,19,-5,15
Concordia Ch,59,6,2,2,10,15,24,-9,8
FCSB,60,1,8,6,0,25,11,14,30
CFR Cluj,60,2,6,6,2,17,9,8,24
FC Botosani,60,3,4,5,5,9,13,-4,17
Universitate,60,4,3,6,5,14,21,-7,15
D Bucuresti,60,5,3,5,6,16,19,-3,14
Concordia Ch,60,6,3,2,9,17,25,-8,11
FCSB,61,1,7,7,0,24,11,13,28
CFR Cluj,61,2,5,7,2,14,9,5,22
Universitate,61,3,4,6,4,15,18,-3,18
FC Botosani,61,4,4,5,5,8,13,-5,17
D Bucuresti,61,5,4,4,6,18,20,-2,16
Concordia Ch,61,6,2,3,9,16,24,-8,9
FCSB,62,1,7,7,0,25,12,13,28
CFR Cluj,62,2,6,7,1,18,10,8,25
FC Botosani,62,3,4,5,5,7,13,-6,17
Universitate,62,4,3,6,5,17,23,-6,15
D Bucuresti,62,5,3,5,6,18,22,-4,14
Concordia Ch,62,6,3,2,9,20,25,-5,11
FCSB,63,1,8,6,0,26,12,14,30
CFR Cluj,63,2,6,7,1,15,8,7,25
D Bucuresti,63,3,5,4,5,21,18,3,19
Universitate,63,4,3,5,6,15,21,-6,14
FC Botosani,63,5,3,5,6,7,17,-10,14
Concordia Ch,63,6,2,3,9,17,25,-8,9
FCSB,64,1,7,5,2,23,14,9,26
CFR Cluj,64,2,6,7,1,17,8,9,25
FC Botosani,64,3,5,4,5,11,13,-2,19
Universitate,64,4,4,6,4,16,19,-3,18
D Bucuresti,64,5,3,5,6,19,25,-6,14
Concordia Ch,64,6,2,3,9,19,26,-7,9
FCSB,65,1,8,5,1,24,12,12,29
CFR Cluj,65,2,5,6,3,13,10,3,21
Universitate,65,3,5,5,4,18,18,0,20
FC Botosani,65,4,4,4,6,7,14,-7,16
Concordia Ch,65,5,4,2,8,17,21,-4,14
D Bucuresti,65,6,3,4,7,17,21,-4,13
FCSB,66,1,9,5,0,27,11,16,32
CFR Cluj,66,2,5,7,2,14,9,5,22
FC Botosani,66,3,4,5,5,10,13,-3,17
D Bucuresti,66,4,3,6,5,17,19,-2,15
Universitate,66,5,3,6,5,14,20,-6,15
Concordia Ch,66,6,2,3,9,15,25,-10,9
FCSB,67,1,7,5,2,24,13,11,26
CFR Cluj,67,2,6,7,1,15,8,7,25
Universitate,67,3,4,6,4,17,20,-3,18
D Bucuresti,67,4,4,5,5,21,19,2,17
FC Botosani,67,5,3,6,5,6,13,-7,15
Concordia Ch,67,6,2,3,9,15,25,-10,9
FCSB,68,1,7,5,2,23,12,11,26
CFR Cluj,68,2,6,6,2,14,10,4,24
Universitate,68,3,5,5,4,18,18,0,20
D Bucuresti,68,4,4,4,6,19,21,-2,16
FC Botosani,68,5,4,4,6,6,13,-7,16
Concordia Ch,68,6,3,2,9,18,24,-6,11
FCSB,69,1,8,6,0,25,11,14,30
CFR Cluj,69,2,6,7,1,15,8,7,25
FC Botosani,69,3,5,4,5,8,13,-5,19
D Bucuresti,69,4,4,4,6,18,19,-1,16
Universitate,69,5,3,5,6,14,20,-6,14
Concordia Ch,69,6,2,2,10,16,25,-9,8
FCSB,70,1,8,5,1,26,14,12,29
CFR Cluj,70,2,7,6,1,17,7,10,27
FC Botosani,70,3,4,4,6,9,15,-6,16
D Bucuresti,70,4,3,5,6,19,23,-4,14
Universitate,70,5,3,5,6,16,23,-7,14
Concordia Ch,70,6,3,3,8,17,22,-5,12
FCSB,71,1,8,6,0,25,11,14,30
CFR Cluj,71,2,5,8,1,14,8,6,23
FC Botosani,71,3,4,5,5,9,13,-4,17
D Bucuresti,71,4,3,6,5,18,20,-2,15
Universitate,71,5,3,6,5,14,19,-5,15
Concordia Ch,71,6,2,3,9,16,25,-9,9
FCSB,72,1,8,5,1,26,14,12,29
CFR Cluj,72,2,5,6,3,14,10,4,21
Universitate,72,3,5,5,4,18,19,-1,20
D Bucuresti,72,4,5,4,5,20,20,0,19
FC Botosani,72,5,4,4,6,9,15,-6,16
Concordia Ch,72,6,2,2,10,17,26,-9,8
FCSB,73,1,9,5,0,28,12,16,32
CFR Cluj,73,2,6,6,2,16,9,7,24
D Bucuresti,73,3,4,4,6,18,23,-5,16
Universitate,73,4,3,5,6,15,23,-8,14
FC Botosani,73,5,3,5,6,6,14,-8,14
Concordia Ch,73,6,3,3,8,19,21,-2,12
FCSB,74,1,9,5,0,29,12,17,32
CFR Cluj,74,2,6,6,2,15,10,5,24
D Bucuresti,74,3,4,5,5,19,20,-1,17
Universitate,74,4,3,5,6,15,22,-7,14
FC Botosani,74,5,3,5,6,6,14,-8,14
Concordia Ch,74,6,3,2,9,17,23,-6,11
FCSB,75,1,8,6,0,26,12,14,30
CFR Cluj,75,2,5,7,2,14,9,5,22
Universitate,75,3,3,7,4,15,19,-4,16
FC Botosani,75,4,4,4,6,8,15,-7,16
D Bucuresti,75,5,3,5,6,18,21,-3,14
Concordia Ch,75,6,3,3,8,16,21,-5,12
FCSB,76,1,7,6,1,25,15,10,27
CFR Cluj,76,2,6,7,1,19,8,11,25
Universitate,76,3,4,5,5,18,24,-6,17
D Bucuresti,76,4,4,4,6,20,20,0,16
FC Botosani,76,5,4,4,6,9,15,-6,16
Concordia Ch,76,6,3,2,9,17,26,-9,11
FCSB,77,1,7,6,1,23,11,12,27
CFR Cluj,77,2,5,8,1,15,9,6,23
Universitate,77,3,4,6,4,17,20,-3,18
D Bucuresti,77,4,4,4,6,17,20,-3,16
FC Botosani,77,5,4,4,6,7,13,-6,16
Concordia Ch,77,6,3,2,9,17,23,-6,11
FCSB,78,1,8,5,1,25,12,13,29
CFR Cluj,78,2,5,7,2,14,9,5,22
Universitate,78,3,4,6,4,17,20,-3,18
FC Botosani,78,4,4,4,6,6,16,-10,16
D Bucuresti,78,5,3,5,6,17,20,-3,14
Concordia Ch,78,6,3,3,8,20,22,-2,12
FCSB,79,1,8,6,0,25,11,14,30
CFR Cluj,79,2,5,8,1,14,8,6,23
D Bucuresti,79,3,4,4,6,20,21,-1,16
Universitate,79,4,3,6,5,16,21,-5,15
FC Botosani,79,5,3,5,6,6,16,-10,14
Concordia Ch,79,6,3,3,8,19,23,-4,12
FCSB,80,1,9,5,0,29,12,17,32
CFR Cluj,80,2,6,6,2,16,10,6,24
FC Botosani,80,3,5,4,5,8,12,-4,19
D Bucuresti,80,4,3,5,6,16,20,-4,14
Universitate,80,5,3,5,6,14,22,-8,14
Concordia Ch,80,6,2,3,9,15,22,-7,9
FCSB,81,1,9,5,0,28,11,17,32
CFR Cluj,81,2,5,6,3,14,12,2,21
Universitate,81,3,4,5,5,19,23,-4,17
FC Botosani,81,4,3,6,5,6,13,-7,15
D Bucuresti,81,5,3,5,6,18,21,-3,14
Concordia Ch,81,6,3,3,8,17,22,-5,12
FCSB,82,1,8,6,0,25,11,14,30
CFR Cluj,82,2,5,8,1,13,7,6,23
D Bucuresti,82,3,4,4,6,20,22,-2,16
FC Botosani,82,4,4,4,6,10,15,-5,16
Universitate,82,5,3,6,5,15,20,-5,15
Concordia Ch,82,6,3,2,9,21,29,-8,11
FCSB,83,1,8,6,0,25,11,14,30
CFR Cluj,83,2,6,7,1,16,9,7,25
FC Botosani,83,3,4,4,6,6,13,-7,16
Concordia Ch,83,4,4,2,8,19,22,-3,14
Universitate,83,5,3,5,6,15,21,-6,14
D Bucuresti,83,6,3,4,7,17,22,-5,13
FCSB,84,1,7,7,0,25,12,13,28
CFR Cluj,84,2,6,7,1,18,9,9,25
D Bucuresti,84,3,4,4,6,17,20,-3,16
FC Botosani,84,4,4,4,6,7,14,-7,16
Universitate,84,5,3,6,5,16,23,-7,15
Concordia Ch,84,6,3,2,9,18,23,-5,11
FCSB,85,1,7,7,0,25,12,13,28
CFR Cluj,85,2,6,7,1,17,9,8,25
Universitate,85,3,3,6,5,16,22,-6,15
FC Botosani,85,4,3,6,5,7,14,-7,15
D Bucuresti,85,5,3,5,6,16,19,-3,14
Concordia Ch,85,6,3,3,8,18,23,-5,12
FCSB,86,1,8,6,0,28,14,14,30
CFR Cluj,86,2,5,8,1,15,9,6,23
FC Botosani,86,3,4,5,5,6,12,-6,17
Universitate,86,4,3,6,5,18,23,-5,15
D Bucuresti,86,5,3,4,7,17,23,-6,13
Concordia Ch,86,6,3,3,8,19,22,-3,12
FCSB,87,1,9,5,0,31,11,20,32
CFR Cluj,87,2,6,6,2,16,9,7,24
D Bucuresti,87,3,5,4,5,19,19,0,19
FC Botosani,87,4,3,5,6,7,15,-8,14
Universitate,87,5,3,5,6,15,27,-12,14
Concordia Ch,87,6,2,3,9,16,23,-7,9
FCSB,88,1,8,5,1,26,13,13,29
CFR Cluj,88,2,5,7,2,15,11,4,22
D Bucuresti,88,3,5,4,5,21,19,2,19
Universitate,88,4,4,6,4,19,21,-2,18
FC Botosani,88,5,3,5,6,7,16,-9,14
Concordia Ch,88,6,2,3,9,16,24,-8,9
FCSB,89,1,8,5,1,25,12,13,29
CFR Cluj,89,2,6,6,2,16,9,7,24
D Bucuresti,89,3,4,5,5,18,19,-1,17
Universitate,89,4,4,5,5,15,20,-5,17
FC Botosani,89,5,3,4,7,7,16,-9,13
Concordia Ch,89,6,3,3,8,17,22,-5,12
FCSB,90,1,7,5,2,23,12,11,26
CFR Cluj,90,2,6,7,1,15,8,7,25
D Bucuresti,90,3,5,4,5,19,19,0,19
Universitate,90,4,4,6,4,16,19,-3,18
FC Botosani,90,5,3,5,6,7,15,-8,14
Concordia Ch,90,6,2,3,9,16,23,-7,9
FCSB,91,1,8,5,1,26,17,9,29
CFR Cluj,91,2,6,6,2,19,11,8,24
Universitate,91,3,4,5,5,18,20,-2,17
FC Botosani,91,4,4,5,5,7,12,-5,17
D Bucuresti,91,5,4,4,6,17,20,-3,16
Concordia Ch,91,6,2,3,9,15,22,-7,9
FCSB,92,1,8,6,0,29,12,17,30
CFR Cluj,92,2,6,7,1,16,8,8,25
D Bucuresti,92,3,4,4,6,17,19,-2,16
Concordia Ch,92,4,4,2,8,17,21,-4,14
Universitate,92,5,3,5,6,15,25,-10,14
FC Botosani,92,6,3,4,7,5,14,-9,13
FCSB,93,1,8,6,0,26,10,16,30
CFR Cluj,93,2,5,8,1,13,7,6,23
D Bucuresti,93,3,4,5,5,21,22,-1,17
FC Botosani,93,4,4,5,5,9,14,-5,17
Universitate,93,5,3,6,5,14,21,-7,15
Concordia Ch,93,6,2,2,10,17,26,-9,8
FCSB,94,1,8,5,1,24,11,13,29
CFR Cluj,94,2,6,6,2,17,10,7,24
D Bucuresti,94,3,5,4,5,20,19,1,19
Universitate,94,4,4,5,5,17,22,-5,17
FC Botosani,94,5,3,5,6,6,15,-9,14
Concordia Ch,94,6,2,3,9,17,24,-7,9
FCSB,95,1,8,5,1,25,13,12,29
CFR Cluj,95,2,5,6,3,14,10,4,21
Universitate,95,3,5,5,4,17,18,-1,20
D Bucuresti,95,4,4,5,5,18,19,-1,17
FC Botosani,95,5,3,5,6,6,14,-8,14
Concordia Ch,95,6,2,4,8,15,21,-6,10
FCSB,96,1,7,6,1,23,11,12,27
CFR Cluj,96,2,6,7,1,17,7,10,25
D Bucuresti,96,3,4,5,5,18,19,-1,17
Universitate,96,4,4,5,5,15,22,-7,17
FC Botosani,96,5,3,4,7,5,15,-10,13
Concordia Ch,96,6,3,3,8,18,22,-4,12
FCSB,97,1,7,7,0,23,10,13,28
CFR Cluj,97,2,5,8,1,15,9,6,23
FC Botosani,97,3,5,4,5,9,13,-4,19
Universitate,97,4,3,7,4,16,20,-4,16
D Bucuresti,97,5,3,5,6,20,23,-3,14
Concordia Ch,97,6,2,3,9,18,26,-8,9
FCSB,98,1,9,5,0,29,10,19,32
CFR Cluj,98,2,5,7,2,13,12,1,22
FC Botosani,98,3,4,4,6,7,14,-7,16
Universitate,98,4,3,6,5,14,19,-5,15
Concordia Ch,98,5,4,2,8,19,23,-4,14
D Bucuresti,98,6,3,4,7,19,23,-4,13
FCSB,99,1,8,5,1,27,14,13,29
CFR Cluj,99,2,7,6,1,20,9,11,27
D Bucuresti,99,3,4,4,6,21,23,-2,16
FC Botosani,99,4,4,4,6,9,16,-7,16
Universitate,99,5,3,5,6,16,25,-9,14
Concordia Ch,99,6,3,2,9,19,25,-6,11
FCSB,100,1,9,5,0,27,10,17,32
CFR Cluj,100,2,5,7,2,13,10,3,22
D Bucuresti,100,3,4,5,5,18,19,-1,17
FC Botosani,100,4,4,4,6,7,13,-6,16
Universitate,100,5,3,6,5,14,19,-5,15
Concordia Ch,100,6,2,3,9,16,24,-8,9
FCSB,101,1,8,5,1,24,12,12,29
CFR Cluj,101,2,6,6,2,16,9,7,24
D Bucuresti,101,3,4,5,5,19,20,-1,17
Universitate,101,4,4,5,5,17,21,-4,17
FC Botosani,101,5,4,4,6,8,13,-5,16
Concordia Ch,101,6,2,3,9,17,26,-9,9
FCSB,102,1,8,6,0,25,11,14,30
CFR Cluj,102,2,6,6,2,15,9,6,24
FC Botosani,102,3,4,5,5,6,12,-6,17
Universitate,102,4,3,6,5,16,21,-5,15
D Bucuresti,102,5,3,5,6,17,21,-4,14
Concordia Ch,102,6,3,2,9,18,23,-5,11
FCSB,103,1,8,5,1,25,13,12,29
CFR Cluj,103,2,5,7,2,14,9,5,22
Universitate,103,3,4,6,4,16,18,-2,18
D Bucuresti,103,4,4,4,6,19,20,-1,16
Concordia Ch,103,5,4,2,8,18,22,-4,14
FC Botosani,103,6,3,4,7,5,15,-10,13
FCSB,104,1,8,5,1,26,14,12,29
CFR Cluj,104,2,5,6,3,14,11,3,21
Universitate,104,3,5,5,4,20,20,0,20
D Bucuresti,104,4,4,4,6,18,20,-2,16
Concordia Ch,104,5,4,2,8,18,21,-3,14
FC Botosani,104,6,3,4,7,5,15,-10,13
FCSB,105,1,9,5,0,30,13,17,32
CFR Cluj,105,2,5,7,2,16,13,3,22
FC Botosani,105,3,5,4,5,10,12,-2,19
D Bucuresti,105,4,4,4,6,21,20,1,16
Universitate,105,5,3,6,5,18,23,-5,15
Concordia Ch,105,6,2,2,10,15,29,-14,8
FCSB,106,1,9,5,0,28,11,17,32
CFR Cluj,106,2,6,6,2,15,10,5,24
FC Botosani,106,3,5,4,5,12,15,-3,19
D Bucuresti,106,4,4,4,6,19,21,-2,16
Universitate,106,5,3,5,6,16,23,-7,14
Concordia Ch,106,6,2,2,10,18,28,-10,8
FCSB,107,1,8,5,1,24,11,13,29
CFR Cluj,107,2,6,6,2,14,8,6,24
FC Botosani,107,3,5,4,5,10,14,-4,19
Universitate,107,4,4,5,5,15,19,-4,17
D Bucuresti,107,5,4,4,6,20,20,0,16
Concordia Ch,107,6,2,2,10,16,27,-11,8
CFR Cluj,108,1,7,6,1,16,7,9,27
FCSB,108,2,7,5,2,24,13,11,26
Universitate,108,3,4,5,5,16,21,-5,17
FC Botosani,108,4,3,6,5,5,12,-7,15
D Bucuresti,108,5,3,5,6,18,23,-5,14
Concordia Ch,108,6,3,3,8,20,23,-3,12
FCSB,109,1,8,5,1,26,14,12,29
CFR Cluj,109,2,7,6,1,19,8,11,27
D Bucuresti,109,3,4,5,5,20,21,-1,17
FC Botosani,109,4,4,5,5,7,13,-6,17
Universitate,109,5,3,5,6,16,24,-8,14
Concordia Ch,109,6,2,2,10,17,25,-8,8
FCSB,110,1,8,6,0,27,13,14,30
CFR Cluj,110,2,6,7,1,19,10,9,25
D Bucuresti,110,3,5,4,5,19,19,0,19
FC Botosani,110,4,4,4,6,7,14,-7,16
Universitate,110,5,3,5,6,14,22,-8,14
Concordia Ch,110,6,2,2,10,15,23,-8,8
FCSB,111,1,8,5,1,26,14,12,29
CFR Cluj,111,2,6,6,2,16,11,5,24
Universitate,111,3,4,5,5,18,20,-2,17
D Bucuresti,111,4,4,4,6,21,21,0,16
FC Botosani,111,5,4,4,6,9,18,-9,16
Concordia Ch,111,6,3,2,9,19,25,-6,11
FCSB,112,1,9,5,0,28,12,16,32
CFR Cluj,112,2,6,6,2,16,10,6,24
D Bucuresti,112,3,4,4,6,21,23,-2,16
Concordia Ch,112,4,4,2,8,20,23,-3,14
Universitate,112,5,3,5,6,14,21,-7,14
FC Botosani,112,6,3,4,7,6,16,-10,13
FCSB,113,1,8,6,0,26,10,16,30
CFR Cluj,113,2,5,7,2,13,8,5,22
D Bucuresti,113,3,5,4,5,21,20,1,19
Universitate,113,4,4,5,5,15,21,-6,17
FC Botosani,113,5,3,4,7,6,15,-9,13
Concordia Ch,113,6,3,2,9,17,24,-7,11
FCSB,114,1,9,5,0,28,11,17,32
CFR Cluj,114,2,6,6,2,15,11,4,24
D Bucuresti,114,3,4,4,6,18,19,-1,16
Concordia Ch,114,4,4,2,8,18,21,-3,14
Universitate,114,5,3,5,6,14,20,-6,14
FC Botosani,114,6,3,4,7,5,16,-11,13
FCSB,115,1,7,6,1,24,13,11,27
CFR Cluj,115,2,5,8,1,15,9,6,23
D Bucuresti,115,3,5,4,5,20,19,1,19
Universitate,115,4,4,6,4,17,19,-2,18
FC Botosani,115,5,4,4,6,8,15,-7,16
Concordia Ch,115,6,2,2,10,15,24,-9,8
CFR Cluj,116,1,7,6,1,20,8,12,27
FCSB,116,2,7,5,2,25,16,9,26
D Bucuresti,116,3,4,5,5,18,19,-1,17
Universitate,116,4,4,5,5,16,22,-6,17
FC Botosani,116,5,3,5,6,6,14,-8,14
Concordia Ch,116,6,2,4,8,17,23,-6,10
FCSB,117,1,9,5,0,28,10,18,32
CFR Cluj,117,2,5,6,3,13,11,2,21
D Bucuresti,117,3,5,4,5,21,19,2,19
Universitate,117,4,4,5,5,15,20,-5,17
FC Botosani,117,5,4,4,6,7,14,-7,16
Concordia Ch,117,6,2,2,10,16,26,-10,8
FCSB,118,1,9,5,0,27,11,16,32
CFR Cluj,118,2,6,6,2,14,8,6,24
D Bucuresti,118,3,4,5,5,18,19,-1,17
FC Botosani,118,4,4,4,6,7,13,-6,16
Universitate,118,5,3,5,6,15,22,-7,14
Concordia Ch,118,6,2,3,9,16,24,-8,9
FCSB,119,1,8,6,0,25,11,14,30
CFR Cluj,119,2,5,7,2,13,8,5,22
Universitate,119,3,3,7,4,15,19,-4,16
D Bucuresti,119,4,3,5,6,19,22,-3,14
Concordia Ch,119,5,4,2,8,19,23,-4,14
FC Botosani,119,6,3,5,6,6,14,-8,14
FCSB,120,1,8,5,1,24,14,10,29
CFR Cluj,120,2,5,7,2,13,8,5,22
FC Botosani,120,3,5,4,5,9,14,-5,19
Universitate,120,4,4,6,4,18,18,0,18
D Bucuresti,120,5,3,5,6,18,21,-3,14
Concordia Ch,120,6,2,3,9,17,24,-7,9
FCSB,121,1,8,6,0,25,11,14,30
CFR Cluj,121,2,6,6,2,14,8,6,24
FC Botosani,121,3,5,4,5,11,12,-1,19
Universitate,121,4,3,6,5,15,20,-5,15
D Bucuresti,121,5,3,5,6,17,20,-3,14
Concordia Ch,121,6,2,3,9,16,27,-11,9
FCSB,122,1,8,6,0,25,10,15,30
CFR Cluj,122,2,6,6,2,14,9,5,24
D Bucuresti,122,3,4,4,6,17,21,-4,16
Universitate,122,4,3,6,5,14,19,-5,15
Concordia Ch,122,5,4,2,8,19,21,-2,14
FC Botosani,122,6,3,4,7,5,14,-9,13
FCSB,123,1,8,5,1,25,12,13,29
CFR Cluj,123,2,6,6,2,15,9,6,24
D Bucuresti,123,3,4,5,5,19,19,0,17
Universitate,123,4,4,5,5,15,19,-4,17
FC Botosani,123,5,4,5,5,8,14,-6,17
Concordia Ch,123,6,2,2,10,16,25,-9,8
FCSB,124,1,8,5,1,28,12,16,29
CFR Cluj,124,2,7,6,1,16,8,8,27
FC Botosani,124,3,4,5,5,11,15,-4,17
D Bucuresti,124,4,3,5,6,19,22,-3,14
Universitate,124,5,3,5,6,14,23,-9,14
Concordia Ch,124,6,3,2,9,16,24,-8,11
FCSB,125,1,8,6,0,25,10,15,30
CFR Cluj,125,2,5,7,2,13,8,5,22
Universitate,125,3,4,5,5,15,20,-5,17
D Bucuresti,125,4,4,4,6,17,20,-3,16
FC Botosani,125,5,4,4,6,7,13,-6,16
Concordia Ch,125,6,3,2,9,16,22,-6,11
FCSB,126,1,7,5,2,24,13,11,26
CFR Cluj,126,2,6,7,1,15,8,7,25
Universitate,126,3,4,6,4,17,20,-3,18
D Bucuresti,126,4,4,5,5,17,18,-1,17
FC Botosani,126,5,3,4,7,5,14,-9,13
Concordia Ch,126,6,3,3,8,16,21,-5,12
FCSB,127,1,7,6,1,24,12,12,27
CFR Cluj,127,2,7,6,1,18,8,10,27
FC Botosani,127,3,5,4,5,8,13,-5,19
Universitate,127,4,3,6,5,14,21,-7,15
D Bucuresti,127,5,3,4,7,17,22,-5,13
Concordia Ch,127,6,3,2,9,17,22,-5,11
FCSB,128,1,8,5,1,26,13,13,29
CFR Cluj,128,2,6,6,2,17,11,6,24
Universitate,128,3,4,5,5,16,20,-4,17
FC Botosani,128,4,4,4,6,8,15,-7,16
D Bucuresti,128,5,3,5,6,17,20,-3,14
Concordia Ch,128,6,3,3,8,17,22,-5,12
FCSB,129,1,9,5,0,26,11,15,32
CFR Cluj,129,2,5,6,3,15,11,4,21
D Bucuresti,129,3,4,5,5,17,18,-1,17
Universitate,129,4,4,5,5,16,20,-4,17
FC Botosani,129,5,3,6,5,5,12,-7,15
Concordia Ch,129,6,2,3,9,15,22,-7,9
FCSB,130,1,7,6,1,24,13,11,27
CFR Cluj,130,2,6,7,1,16,8,8,25
D Bucuresti,130,3,5,4,5,20,18,2,19
Universitate,130,4,3,7,4,16,20,-4,16
FC Botosani,130,5,3,4,7,5,15,-10,13
Concordia Ch,130,6,3,2,9,16,23,-7,11
FCSB,131,1,8,6,0,24,10,14,30
CFR Cluj,131,2,5,6,3,13,9,4,21
FC Botosani,131,3,5,4,5,11,13,-2,19
Universitate,131,4,4,6,4,15,18,-3,18
D Bucuresti,131,5,3,4,7,17,22,-5,13
Concordia Ch,131,6,3,2,9,19,27,-8,11
FCSB,132,1,8,6,0,25,10,15,30
CFR Cluj,132,2,6,7,1,16,7,9,25
FC Botosani,132,3,3,6,5,9,16,-7,15
D Bucuresti,132,4,3,5,6,17,20,-3,14
Universitate,132,5,3,5,6,14,23,-9,14
Concordia Ch,132,6,3,3,8,19,24,-5,12
FCSB,133,1,8,6,0,28,12,16,30
CFR Cluj,133,2,6,6,2,14,10,4,24
FC Botosani,133,3,4,5,5,8,14,-6,17
D Bucuresti,133,4,3,6,5,20,22,-2,15
Universitate,133,5,3,6,5,16,21,-5,15
Concordia Ch,133,6,2,3,9,19,26,-7,9
FCSB,134,1,8,5,1,26,12,14,29
CFR Cluj,134,2,7,6,1,17,9,8,27
D Bucuresti,134,3,4,5,5,18,19,-1,17
FC Botosani,134,4,4,5,5,9,14,-5,17
Universitate,134,5,3,5,6,15,22,-7,14
Concordia Ch,134,6,2,2,10,16,25,-9,8
FCSB,135,1,7,6,1,25,14,11,27
CFR Cluj,135,2,6,7,1,18,10,8,25
D Bucuresti,135,3,4,5,5,20,21,-1,17
Universitate,135,4,4,5,5,17,21,-4,17
FC Botosani,135,5,4,5,5,9,15,-6,17
Concordia Ch,135,6,2,2,10,17,25,-8,8
FCSB,136,1,7,6,1,24,12,12,27
CFR Cluj,136,2,6,7,1,16,7,9,25
D Bucuresti,136,3,5,4,5,21,20,1,19
Universitate,136,4,4,5,5,16,22,-6,17
FC Botosani,136,5,3,5,6,7,15,-8,14
Concordia Ch,136,6,2,3,9,15,23,-8,9
FCSB,137,1,8,6,0,26,11,15,30
CFR Cluj,137,2,5,7,2,14,10,4,22
Universitate,137,3,3,7,4,16,20,-4,16
D Bucuresti,137,4,3,6,5,17,19,-2,15
FC Botosani,137,5,3,5,6,5,14,-9,14
Concordia Ch,137,6,3,3,8,18,22,-4,12
FCSB,138,1,7,5,2,23,14,9,26
CFR Cluj,138,2,6,6,2,16,11,5,24
Universitate,138,3,5,5,4,20,19,1,20
D Bucuresti,138,4,5,4,5,19,19,0,19
FC Botosani,138,5,3,5,6,7,15,-8,14
Concordia Ch,138,6,2,3,9,16,23,-7,9
FCSB,139,1,7,6,1,24,13,11,27
CFR Cluj,139,2,6,7,1,16,8,8,25
D Bucuresti,139,3,4,5,5,20,20,0,17
FC Botosani,139,4,4,5,5,11,13,-2,17
Universitate,139,5,4,5,5,16,20,-4,17
Concordia Ch,139,6,2,2,10,16,29,-13,8
FCSB,140,1,7,6,1,23,12,11,27
CFR Cluj,140,2,6,6,2,15,8,7,24
Universitate,140,3,4,6,4,15,18,-3,18
FC Botosani,140,4,4,4,6,7,14,-7,16
D Bucuresti,140,5,3,5,6,17,20,-3,14
Concordia Ch,140,6,3,3,8,18,23,-5,12
FCSB,141,1,9,5,0,29,12,17,32
CFR Cluj,141,2,5,6,3,14,11,3,21
Universitate,141,3,4,5,5,16,21,-5,17
D Bucuresti,141,4,4,4,6,19,21,-2,16
FC Botosani,141,5,4,4,6,8,14,-6,16
Concordia Ch,141,6,3,2,9,18,25,-7,11
FCSB,142,1,8,6,0,24,10,14,30
CFR Cluj,142,2,6,6,2,15,8,7,24
D Bucuresti,142,3,4,4,6,21,20,1,16
FC Botosani,142,4,4,4,6,6,16,-10,16
Universitate,142,5,3,6,5,14,20,-6,15
Concordia Ch,142,6,3,2,9,17,23,-6,11
FCSB,143,1,8,6,0,26,12,14,30
CFR Cluj,143,2,5,8,1,14,8,6,23
FC Botosani,143,3,4,4,6,8,15,-7,16
Universitate,143,4,3,6,5,15,20,-5,15
Concordia Ch,143,5,4,2,8,20,23,-3,14
D Bucuresti,143,6,3,4,7,18,23,-5,13
FCSB,144,1,8,6,0,27,12,15,30
CFR Cluj,144,2,5,6,3,14,11,3,21
Universitate,144,3,4,6,4,16,19,-3,18
FC Botosani,144,4,4,5,5,6,12,-6,17
D Bucuresti,144,5,3,4,7,16,20,-4,13
Concordia Ch,144,6,3,3,8,16,21,-5,12
FCSB,145,1,8,5,1,25,12,13,29
CFR Cluj,145,2,7,6,1,19,9,10,27
D Bucuresti,145,3,4,5,5,21,20,1,17
Universitate,145,4,3,5,6,15,23,-8,14
FC Botosani,145,5,3,4,7,6,18,-12,13
Concordia Ch,145,6,3,3,8,18,22,-4,12
FCSB,146,1,7,6,1,24,12,12,27
CFR Cluj,146,2,6,6,2,14,9,5,24
Universitate,146,3,4,6,4,17,19,-2,18
D Bucuresti,146,4,4,5,5,18,19,-1,17
FC Botosani,146,5,4,4,6,8,14,-6,16
Concordia Ch,146,6,2,3,9,15,23,-8,9
CFR Cluj,147,1,7,6,1,16,8,8,27
FCSB,147,2,7,5,2,23,14,9,26
Universitate,147,3,4,5,5,18,20,-2,17
FC Botosani,147,4,4,5,5,8,13,-5,17
D Bucuresti,147,5,3,5,6,18,22,-4,14
Concordia Ch,147,6,2,4,8,18,24,-6,10
FCSB,148,1,8,5,1,28,13,15,29
CFR Cluj,148,2,7,6,1,16,7,9,27
D Bucuresti,148,3,5,4,5,19,19,0,19
FC Botosani,148,4,4,4,6,8,13,-5,16
Universitate,148,5,3,5,6,16,25,-9,14
Concordia Ch,148,6,2,2,10,16,26,-10,8
FCSB,149,1,8,5,1,26,13,13,29
CFR Cluj,149,2,7,6,1,16,8,8,27
FC Botosani,149,3,4,4,6,6,13,-7,16
D Bucuresti,149,4,3,5,6,18,21,-3,14
Universitate,149,5,3,5,6,17,23,-6,14
Concordia Ch,149,6,3,3,8,18,23,-5,12
FCSB,150,1,8,5,1,27,12,15,29
CFR Cluj,150,2,6,6,2,18,12,6,24
D Bucuresti,150,3,4,5,5,17,18,-1,17
Universitate,150,4,4,5,5,17,23,-6,17
FC Botosani,150,5,3,4,7,5,14,-9,13
Concordia Ch,150,6,3,3,8,16,21,-5,12
FCSB,151,1,8,6,0,29,12,17,30
CFR Cluj,151,2,5,7,2,15,13,2,22
Universitate,151,3,3,7,4,16,20,-4,16
FC Botosani,151,4,3,6,5,6,13,-7,15
D Bucuresti,151,5,3,5,6,18,22,-4,14
Concordia Ch,151,6,3,3,8,18,22,-4,12
FCSB,152,1,9,5,0,27,12,15,32
CFR Cluj,152,2,6,6,2,16,9,7,24
D Bucuresti,152,3,4,4,6,21,22,-1,16
FC Botosani,152,4,4,4,6,7,15,-8,16
Universitate,152,5,3,5,6,17,24,-7,14
Concordia Ch,152,6,3,2,9,18,24,-6,11
FCSB,153,1,8,5,1,27,13,14,29
CFR Cluj,153,2,6,6,2,19,11,8,24
D Bucuresti,153,3,5,4,5,19,18,1,19
Universitate,153,4,4,5,5,17,24,-7,17
FC Botosani,153,5,3,4,7,6,15,-9,13
Concordia Ch,153,6,3,2,9,17,24,-7,11
FCSB,154,1,8,5,1,24,13,11,29
CFR Cluj,154,2,5,6,3,14,10,4,21
Universitate,154,3,5,5,4,19,19,0,20
FC Botosani,154,4,4,5,5,7,13,-6,17
D Bucuresti,154,5,3,6,5,17,19,-2,15
Concordia Ch,154,6,2,3,9,15,22,-7,9
FCSB,155,1,9,5,0,28,11,17,32
CFR Cluj,155,2,5,7,2,13,10,3,22
FC Botosani,155,3,4,5,5,8,14,-6,17
Universitate,155,4,3,6,5,15,20,-5,15
D Bucuresti,155,5,3,5,6,17,21,-4,14
Concordia Ch,155,6,3,2,9,18,23,-5,11
FCSB,156,1,7,6,1,23,11,12,27
CFR Cluj,156,2,6,7,1,14,7,7,25
Universitate,156,3,4,5,5,15,19,-4,17
FC Botosani,156,4,4,4,6,6,13,-7,16
D Bucuresti,156,5,3,5,6,16,19,-3,14
Concordia Ch,156,6,3,3,8,16,21,-5,12
FCSB,157,1,9,5,0,27,12,15,32
CFR Cluj,157,2,6,6,2,17,9,8,24
D Bucuresti,157,3,4,4,6,18,20,-2,16
FC Botosani,157,4,4,4,6,7,14,-7,16
Universitate,157,5,3,5,6,15,23,-8,14
Concordia Ch,157,6,3,2,9,18,24,-6,11
FCSB,158,1,8,5,1,24,11,13,29
CFR Cluj,158,2,7,6,1,17,8,9,27
D Bucuresti,158,3,4,4,6,19,22,-3,16
FC Botosani,158,4,4,4,6,8,14,-6,16
Universitate,158,5,3,5,6,15,22,-7,14
Concordia Ch,158,6,3,2,9,17,23,-6,11
FCSB,159,1,8,6,0,24,10,14,30
CFR Cluj,159,2,5,8,1,13,7,6,23
FC Botosani,159,3,5,4,5,10,13,-3,19
Universitate,159,4,3,6,5,14,19,-5,15
D Bucuresti,159,5,3,5,6,17,21,-4,14
Concordia Ch,159,6,2,3,9,17,25,-8,9
FCSB,160,1,9,5,0,26,11,15,32
CFR Cluj,160,2,6,6,2,16,9,7,24
D Bucuresti,160,3,4,4,6,17,21,-4,16
Concordia Ch,160,4,4,2,8,20,21,-1,14
Universitate,160,5,3,5,6,14,21,-7,14
FC Botosani,160,6,3,4,7,5,15,-10,13
FCSB,161,1,8,5,1,25,11,14,29
CFR Cluj,161,2,6,6,2,14,9,5,24
Universitate,161,3,4,5,5,16,20,-4,17
D Bucuresti,161,4,4,4,6,17,19,-2,16
Concordia Ch,161,5,4,2,8,18,21,-3,14
FC Botosani,161,6,3,4,7,5,15,-10,13
FCSB,162,1,7,6,1,24,14,10,27
CFR Cluj,162,2,6,7,1,17,9,8,25
Universitate,162,3,4,5,5,18,21,-3,17
FC Botosani,162,4,4,5,5,8,13,-5,17
D Bucuresti,162,5,3,5,6,17,21,-4,14
Concordia Ch,162,6,2,4,8,17,23,-6,10
FCSB,163,1,8,6,0,27,12,15,30
CFR Cluj,163,2,5,6,3,13,10,3,21
Universitate,163,3,4,6,4,17,20,-3,18
D Bucuresti,163,4,4,4,6,19,23,-4,16
FC Botosani,163,5,3,5,6,6,14,-8,14
Concordia Ch,163,6,3,3,8,21,24,-3,12
FCSB,164,1,8,5,1,26,15,11,29
CFR Cluj,164,2,6,6,2,15,9,6,24
FC Botosani,164,3,5,4,5,9,12,-3,19
Universitate,164,4,4,5,5,18,20,-2,17
D Bucuresti,164,5,4,4,6,18,20,-2,16
Concordia Ch,164,6,2,2,10,15,25,-10,8
FCSB,165,1,7,6,1,24,13,11,27
CFR Cluj,165,2,5,7,2,14,10,4,22
Universitate,165,3,5,5,4,18,18,0,20
D Bucuresti,165,4,4,4,6,19,21,-2,16
FC Botosani,165,5,4,4,6,7,14,-7,16
Concordia Ch,165,6,3,2,9,18,24,-6,11
FCSB,166,1,7,6,1,25,14,11,27
CFR Cluj,166,2,6,7,1,17,9,8,25
D Bucuresti,166,3,4,5,5,18,18,0,17
Universitate,166,4,4,5,5,18,22,-4,17
FC Botosani,166,5,4,5,5,6,12,-6,17
Concordia Ch,166,6,2,2,10,15,24,-9,8
FCSB,167,1,8,6,0,26,12,14,30
CFR Cluj,167,2,6,7,1,16,8,8,25
D Bucuresti,167,3,4,4,6,18,22,-4,16
Universitate,167,4,3,5,6,15,22,-7,14
FC Botosani,167,5,3,5,6,6,15,-9,14
Concordia Ch,167,6,3,3,8,20,22,-2,12
FCSB,168,1,9,5,0,26,10,16,32
CFR Cluj,168,2,5,7,2,13,9,4,22
FC Botosani,168,3,4,5,5,7,13,-6,17
Universitate,168,4,3,6,5,14,19,-5,15
D Bucuresti,168,5,3,5,6,19,23,-4,14
Concordia Ch,168,6,3,2,9,19,24,-5,11
FCSB,169,1,7,6,1,24,12,12,27
CFR Cluj,169,2,7,6,1,18,7,11,27
FC Botosani,169,3,5,4,5,10,12,-2,19
Universitate,169,4,3,6,5,15,23,-8,15
D Bucuresti,169,5,3,5,6,18,22,-4,14
Concordia Ch,169,6,2,3,9,17,26,-9,9
FCSB,170,1,9,5,0,28,10,18,32
CFR Cluj,170,2,5,6,3,13,10,3,21
Universitate,170,3,4,5,5,15,21,-6,17
FC Botosani,170,4,4,5,5,8,14,-6,17
D Bucuresti,170,5,4,4,6,18,20,-2,16
Concordia Ch,170,6,2,3,9,16,23,-7,9
FCSB,171,1,8,6,0,26,12,14,30
CFR Cluj,171,2,6,7,1,16,8,8,25
D Bucuresti,171,3,4,5,5,19,20,-1,17
FC Botosani,171,4,4,4,6,9,14,-5,16
Universitate,171,5,3,5,6,15,22,-7,14
Concordia Ch,171,6,2,3,9,18,27,-9,9
FCSB,172,1,8,5,1,26,14,12,29
CFR Cluj,172,2,6,6,2,17,10,7,24
FC Botosani,172,3,5,4,5,10,12,-2,19
Universitate,172,4,4,5,5,16,20,-4,17
D Bucuresti,172,5,3,4,7,17,22,-5,13
Concordia Ch,172,6,3,2,9,17,25,-8,11
FCSB,173,1,8,5,1,26,13,13,29
CFR Cluj,173,2,5,7,2,13,9,4,22
Universitate,173,3,4,6,4,17,19,-2,18
D Bucuresti,173,4,4,5,5,20,20,0,17
FC Botosani,173,5,3,4,7,6,16,-10,13
Concordia Ch,173,6,3,3,8,17,22,-5,12
FCSB,174,1,7,6,1,24,14,10,27
CFR Cluj,174,2,7,6,1,18,8,10,27
FC Botosani,174,3,5,4,5,9,13,-4,19
Universitate,174,4,3,6,5,14,19,-5,15
D Bucuresti,174,5,3,5,6,21,25,-4,14
Concordia Ch,174,6,2,3,9,19,26,-7,9
FCSB,175,1,8,5,1,25,13,12,29
CFR Cluj,175,2,6,6,2,16,8,8,24
Universitate,175,3,4,5,5,17,22,-5,17
FC Botosani,175,4,4,5,5,8,13,-5,17
D Bucuresti,175,5,4,4,6,23,22,1,16
Concordia Ch,175,6,2,3,9,16,27,-11,9
FCSB,176,1,8,5,1,27,12,15,29
CFR Cluj,176,2,7,6,1,18,9,9,27
FC Botosani,176,3,5,4,5,9,13,-4,19
D Bucuresti,176,4,4,4,6,18,21,-3,16
Universitate,176,5,3,5,6,15,24,-9,14
Concordia Ch,176,6,2,2,10,15,23,-8,8
FCSB,177,1,9,5,0,28,11,17,32
CFR Cluj,177,2,6,6,2,15,11,4,24
D Bucuresti,177,3,4,5,5,19,19,0,17
Universitate,177,4,3,5,6,14,20,-6,14
FC Botosani,177,5,3,5,6,6,15,-9,14
Concordia Ch,177,6,3,2,9,17,23,-6,11
FCSB,178,1,8,5,1,24,11,13,29
CFR Cluj,178,2,5,6,3,14,10,4,21
Universitate,178,3,5,5,4,17,19,-2,20
D Bucuresti,178,4,4,5,5,17,18,-1,17
FC Botosani,178,5,4,5,5,7,13,-6,17
Concordia Ch,178,6,2,2,10,16,24,-8,8
FCSB,179,1,8,6,0,26,12,14,30
CFR Cluj,179,2,6,7,1,17,8,9,25
D Bucuresti,179,3,4,5,5,19,19,0,17
Universitate,179,4,3,5,6,15,23,-8,14
FC Botosani,179,5,3,4,7,6,16,-10,13
Concordia Ch,179,6,3,3,8,18,23,-5,12
FCSB,180,1,7,6,1,24,12,12,27
CFR Cluj,180,2,7,6,1,17,9,8,27
FC Botosani,180,3,5,4,5,7,12,-5,19
D Bucuresti,180,4,4,4,6,19,20,-1,16
Universitate,180,5,3,6,5,15,20,-5,15
Concordia Ch,180,6,2,2,10,16,25,-9,8
FCSB,181,1,7,6,1,25,13,12,27
CFR Cluj,181,2,5,8,1,13,7,6,23
Universitate,181,3,4,6,4,17,20,-3,18
D Bucuresti,181,4,4,5,5,21,21,0,17
FC Botosani,181,5,3,5,6,7,16,-9,14
Concordia Ch,181,6,2,4,8,18,24,-6,10
FCSB,182,1,8,5,1,25,12,13,29
CFR Cluj,182,2,6,6,2,15,9,6,24
Universitate,182,3,4,5,5,17,21,-4,17
D Bucuresti,182,4,4,4,6,20,21,-1,16
Concordia Ch,182,5,4,2,8,20,24,-4,14
FC Botosani,182,6,3,4,7,6,16,-10,13
FCSB,183,1,7,5,2,25,15,10,26
CFR Cluj,183,2,6,7,1,14,7,7,25
Universitate,183,3,4,6,4,18,20,-2,18
D Bucuresti,183,4,4,4,6,18,21,-3,16
Concordia Ch,183,5,4,2,8,20,22,-2,14
FC Botosani,183,6,3,4,7,7,17,-10,13
FCSB,184,1,8,6,0,27,11,16,30
CFR Cluj,184,2,5,6,3,15,14,1,21
D Bucuresti,184,3,5,4,5,19,19,0,19
Universitate,184,4,4,6,4,17,19,-2,18
FC Botosani,184,5,4,4,6,8,15,-7,16
Concordia Ch,184,6,2,2,10,16,24,-8,8
FCSB,185,1,8,5,1,26,11,15,29
CFR Cluj,185,2,5,7,2,13,10,3,22
Universitate,185,3,4,6,4,15,18,-3,18
D Bucuresti,185,4,4,4,6,18,20,-2,16
FC Botosani,185,5,4,4,6,7,15,-8,16
Concordia Ch,185,6,3,2,9,19,24,-5,11
FCSB,186,1,7,7,0,24,11,13,28
CFR Cluj,186,2,5,8,1,15,9,6,23
D Bucuresti,186,3,5,4,5,21,19,2,19
Universitate,186,4,3,7,4,15,19,-4,16
FC Botosani,186,5,4,4,6,8,15,-7,16
Concordia Ch,186,6,2,2,10,15,25,-10,8
FCSB,187,1,7,6,1,25,14,11,27
CFR Cluj,187,2,5,7,2,15,10,5,22
Universitate,187,3,5,5,4,17,18,-1,20
D Bucuresti,187,4,5,4,5,21,20,1,19
FC Botosani,187,5,3,5,6,6,15,-9,14
Concordia Ch,187,6,2,3,9,16,23,-7,9
FCSB,188,1,9,5,0,26,10,16,32
CFR Cluj,188,2,5,7,2,14,9,5,22
D Bucuresti,188,3,5,4,5,20,18,2,19
FC Botosani,188,4,4,4,6,8,15,-7,16
Universitate,188,5,3,6,5,15,21,-6,15
Concordia Ch,188,6,2,2,10,17,27,-10,8
FCSB,189,1,7,6,1,25,13,12,27
CFR Cluj,189,2,7,6,1,19,10,9,27
D Bucuresti,189,3,5,4,5,18,18,0,19
Universitate,189,4,3,6,5,17,23,-6,15
FC Botosani,189,5,3,5,6,6,14,-8,14
Concordia Ch,189,6,2,3,9,16,23,-7,9
CFR Cluj,190,1,7,6,1,18,9,9,27
FCSB,190,2,7,5,2,26,15,11,26
Universitate,190,3,4,5,5,18,23,-5,17
D Bucuresti,190,4,4,4,6,19,21,-2,16
Concordia Ch,190,5,4,2,8,19,22,-3,14
FC Botosani,190,6,3,4,7,7,17,-10,13
CFR Cluj,191,1,7,6,1,20,10,10,27
FCSB,191,2,7,5,2,25,16,9,26
FC Botosani,191,3,5,4,5,8,13,-5,19
Universitate,191,4,4,5,5,19,23,-4,17
D Bucuresti,191,5,3,5,6,17,20,-3,14
Concordia Ch,191,6,2,3,9,15,22,-7,9
FCSB,192,1,8,5,1,24,11,13,29
CFR Cluj,192,2,7,6,1,18,7,11,27
D Bucuresti,192,3,5,4,5,19,19,0,19
FC Botosani,192,4,4,4,6,6,13,-7,16
Universitate,192,5,3,5,6,14,23,-9,14
Concordia Ch,192,6,2,2,10,16,24,-8,8
FCSB,193,1,8,6,0,28,14,14,30
CFR Cluj,193,2,6,6,2,17,10,7,24
D Bucuresti,193,3,4,4,6,18,20,-2,16
FC Botosani,193,4,4,4,6,6,13,-7,16
Universitate,193,5,3,6,5,16,22,-6,15
Concordia Ch,193,6,3,2,9,17,23,-6,11
FCSB,194,1,8,5,1,26,12,14,29
CFR Cluj,194,2,6,6,2,15,9,6,24
D Bucuresti,194,3,4,5,5,18,19,-1,17
Universitate,194,4,4,5,5,16,21,-5,17
FC Botosani,194,5,4,4,6,8,14,-6,16
Concordia Ch,194,6,2,3,9,17,25,-8,9
FCSB,195,1,7,6,1,24,13,11,27
CFR Cluj,195,2,6,7,1,15,7,8,25
D Bucuresti,195,3,5,4,5,22,18,4,19
Universitate,195,4,4,5,5,17,21,-4,17
FC Botosani,195,5,3,5,6,6,16,-10,14
Concordia Ch,195,6,2,3,9,16,25,-9,9
FCSB,196,1,8,5,1,26,13,13,29
CFR Cluj,196,2,7,6,1,19,8,11,27
D Bucuresti,196,3,4,4,6,18,19,-1,16
Universitate,196,4,3,5,6,15,24,-9,14
FC Botosani,196,5,3,5,6,5,14,-9,14
Concordia Ch,196,6,3,3,8,16,21,-5,12
FCSB,197,1,8,6,0,24,10,14,30
CFR Cluj,197,2,6,6,2,15,9,6,24
FC Botosani,197,3,5,4,5,7,12,-5,19
Universitate,197,4,3,6,5,15,20,-5,15
D Bucuresti,197,5,3,4,7,16,22,-6,13
Concordia Ch,197,6,3,2,9,18,22,-4,11
FCSB,198,1,8,5,1,26,12,14,29
CFR Cluj,198,2,6,7,1,16,9,7,25
Universitate,198,3,3,6,5,15,21,-6,15
Concordia Ch,198,4,4,2,8,21,24,-3,14
D Bucuresti,198,5,3,5,6,18,22,-4,14
FC Botosani,198,6,3,5,6,6,14,-8,14
FCSB,199,1,8,6,0,24,10,14,30
CFR Cluj,199,2,5,7,2,13,8,5,22
Universitate,199,3,4,5,5,15,19,-4,17
D Bucuresti,199,4,4,4,6,19,22,-3,16
FC Botosani,199,5,4,4,6,9,14,-5,16
Concordia Ch,199,6,3,2,9,18,25,-7,11
FCSB,200,1,8,6,0,27,12,15,30
CFR Cluj,200,2,6,6,2,16,9,7,24
D Bucuresti,200,3,3,6,5,17,19,-2,15
Universitate,200,4,3,6,5,16,23,-7,15
FC Botosani,200,5,3,6,5,8,15,-7,15
Concordia Ch,200,6,2,4,8,17,23,-6,10
FCSB,201,1,9,5,0,28,10,18,32
CFR Cluj,201,2,5,6,3,13,11,2,21
D Bucuresti,201,3,4,5,5,19,20,-1,17
Universitate,201,4,4,5,5,16,21,-5,17
FC Botosani,201,5,3,4,7,6,15,-9,13
Concordia Ch,201,6,3,3,8,17,22,-5,12
CFR Cluj,202,1,7,6,1,19,8,11,27
FCSB,202,2,7,5,2,25,15,10,26
Universitate,202,3,4,5,5,16,22,-6,17
FC Botosani,202,4,3,6,5,7,14,-7,15
D Bucuresti,202,5,3,5,6,17,20,-3,14
Concordia Ch,202,6,3,3,8,17,22,-5,12
FCSB,203,1,9,5,0,26,11,15,32
CFR Cluj,203,2,5,6,3,14,10,4,21
Universitate,203,3,4,5,5,15,19,-4,17
D Bucuresti,203,4,4,4,6,17,19,-2,16
FC Botosani,203,5,4,4,6,6,13,-7,16
Concordia Ch,203,6,3,2,9,16,22,-6,11
FCSB,204,1,9,5,0,27,10,17,32
CFR Cluj,204,2,5,6,3,13,9,4,21
Universitate,204,3,4,5,5,15,21,-6,17
FC Botosani,204,4,3,6,5,7,14,-7,15
D Bucuresti,204,5,3,5,6,17,22,-5,14
Concordia Ch,204,6,3,3,8,19,22,-3,12
FCSB,205,1,8,5,1,24,11,13,29
CFR Cluj,205,2,6,6,2,14,8,6,24
FC Botosani,205,3,5,4,5,8,13,-5,19
Universitate,205,4,4,5,5,15,19,-4,17
D Bucuresti,205,5,3,5,6,17,20,-3,14
Concordia Ch,205,6,2,3,9,17,24,-7,9
FCSB,206,1,9,5,0,29,13,16,32
CFR Cluj,206,2,6,6,2,16,9,7,24
D Bucuresti,206,3,4,4,6,18,21,-3,16
Concordia Ch,206,4,4,2,8,20,22,-2,14
Universitate,206,5,3,5,6,16,24,-8,14
FC Botosani,206,6,3,4,7,6,16,-10,13
CFR Cluj,207,1,7,6,1,15,7,8,27
FCSB,207,2,7,5,2,25,14,11,26
D Bucuresti,207,3,4,5,5,19,20,-1,17
Universitate,207,4,4,5,5,17,21,-4,17
FC Botosani,207,5,3,5,6,7,15,-8,14
Concordia Ch,207,6,3,2,9,18,24,-6,11
FCSB,208,1,8,6,0,25,11,14,30
CFR Cluj,208,2,5,7,2,14,9,5,22
D Bucuresti,208,3,4,5,5,18,19,-1,17
Universitate,208,4,4,5,5,15,19,-4,17
FC Botosani,208,5,3,5,6,5,13,-8,14
Concordia Ch,208,6,2,4,8,16,22,-6,10
CFR Cluj,209,1,7,6,1,17,7,10,27
FCSB,209,2,7,5,2,23,14,9,26
FC Botosani,209,3,5,4,5,9,12,-3,19
Universitate,209,4,4,5,5,15,19,-4,17
D Bucuresti,209,5,4,4,6,19,22,-3,16
Concordia Ch,209,6,2,2,10,17,26,-9,8
FCSB,210,1,8,5,1,25,12,13,29
CFR Cluj,210,2,5,6,3,14,13,1,21
Universitate,210,3,5,5,4,19,18,1,20
D Bucuresti,210,4,4,4,6,21,21,0,16
Concordia Ch,210,5,4,2,8,22,26,-4,14
FC Botosani,210,6,3,4,7,8,19,-11,13
FCSB,211,1,8,5,1,25,12,13,29
CFR Cluj,211,2,7,6,1,16,8,8,27
D Bucuresti,211,3,4,4,6,19,20,-1,16
FC Botosani,211,4,4,4,6,7,15,-8,16
Universitate,211,5,3,5,6,14,20,-6,14
Concordia Ch,211,6,3,2,9,18,24,-6,11
FCSB,212,1,7,7,0,24,11,13,28
CFR Cluj,212,2,5,8,1,14,8,6,23
D Bucuresti,212,3,4,4,6,22,24,-2,16
Universitate,212,4,3,7,4,16,20,-4,16
FC Botosani,212,5,3,5,6,7,15,-8,14
Concordia Ch,212,6,3,3,8,21,26,-5,12
FCSB,213,1,8,5,1,26,15,11,29
CFR Cluj,213,2,7,6,1,19,9,10,27
FC Botosani,213,3,3,6,5,7,14,-7,15
D Bucuresti,213,4,3,5,6,18,21,-3,14
Universitate,213,5,3,5,6,16,22,-6,14
Concordia Ch,213,6,3,3,8,18,23,-5,12
FCSB,214,1,8,5,1,25,12,13,29
CFR Cluj,214,2,5,7,2,14,9,5,22
D Bucuresti,214,3,5,4,5,19,18,1,19
Universitate,214,4,4,6,4,17,20,-3,18
FC Botosani,214,5,3,5,6,6,15,-9,14
Concordia Ch,214,6,2,3,9,16,23,-7,9
FCSB,215,1,7,6,1,23,13,10,27
CFR Cluj,215,2,5,8,1,14,8,6,23
Universitate,215,3,4,6,4,18,19,-1,18
D Bucuresti,215,4,4,4,6,19,21,-2,16
FC Botosani,215,5,3,5,6,7,15,-8,14
Concordia Ch,215,6,3,3,8,18,23,-5,12
FCSB,216,1,8,5,1,24,11,13,29
CFR Cluj,216,2,6,7,1,14,7,7,25
FC Botosani,216,3,4,5,5,8,13,-5,17
D Bucuresti,216,4,4,4,6,21,20,1,16
Universitate,216,5,3,6,5,14,19,-5,15
Concordia Ch,216,6,2,3,9,16,27,-11,9
FCSB,217,1,7,7,0,24,11,13,28
CFR Cluj,217,2,6,7,1,17,8,9,25
D Bucuresti,217,3,4,5,5,18,18,0,17
Universitate,217,4,3,6,5,14,21,-7,15
FC Botosani,217,5,3,5,6,6,15,-9,14
Concordia Ch,217,6,2,4,8,16,22,-6,10
FCSB,218,1,8,6,0,26,10,16,30
CFR Cluj,218,2,6,6,2,14,10,4,24
FC Botosani,218,3,4,5,5,7,12,-5,17
D Bucuresti,218,4,3,6,5,17,19,-2,15
Universitate,218,5,3,6,5,14,19,-5,15
Concordia Ch,218,6,2,3,9,16,24,-8,9
FCSB,219,1,7,6,1,24,12,12,27
CFR Cluj,219,2,7,6,1,16,8,8,27
D Bucuresti,219,3,4,4,6,18,21,-3,16
Universitate,219,4,3,6,5,14,19,-5,15
FC Botosani,219,5,3,5,6,5,13,-8,14
Concordia Ch,219,6,3,3,8,18,22,-4,12
FCSB,220,1,8,5,1,26,13,13,29
CFR Cluj,220,2,6,7,1,17,10,7,25
D Bucuresti,220,3,4,4,6,20,23,-3,16
Universitate,220,4,3,6,5,17,22,-5,15
FC Botosani,220,5,3,5,6,6,15,-9,14
Concordia Ch,220,6,3,3,8,19,22,-3,12
FCSB,221,1,9,5,0,29,11,18,32
CFR Cluj,221,2,5,6,3,14,12,2,21
D Bucuresti,221,3,5,4,5,19,18,1,19
Universitate,221,4,4,5,5,15,20,-5,17
FC Botosani,221,5,3,5,6,5,13,-8,14
Concordia Ch,221,6,2,3,9,15,23,-8,9
FCSB,222,1,8,6,0,28,12,16,30
CFR Cluj,222,2,6,7,1,16,9,7,25
D Bucuresti,222,3,4,4,6,19,21,-2,16
Universitate,222,4,3,5,6,14,22,-8,14
FC Botosani,222,5,3,5,6,7,15,-8,14
Concordia Ch,222,6,3,3,8,20,25,-5,12
FCSB,223,1,7,6,1,24,12,12,27
CFR Cluj,223,2,6,7,1,17,8,9,25
FC Botosani,223,3,4,5,5,11,16,-5,17
Universitate,223,4,4,5,5,17,23,-6,17
D Bucuresti,223,5,3,5,6,20,24,-4,14
Concordia Ch,223,6,3,2,9,21,27,-6,11
FCSB,224,1,7,7,0,25,12,13,28
CFR Cluj,224,2,6,7,1,16,8,8,25
D Bucuresti,224,3,5,4,5,18,18,0,19
Universitate,224,4,3,6,5,15,21,-6,15
FC Botosani,224,5,3,5,6,6,14,-8,14
Concordia Ch,224,6,2,3,9,16,23,-7,9
FCSB,225,1,9,5,0,28,11,17,32
CFR Cluj,225,2,6,6,2,15,10,5,24
FC Botosani,225,3,4,4,6,8,17,-9,16
Concordia Ch,225,4,4,2,8,20,22,-2,14
Universitate,225,5,3,5,6,15,22,-7,14
D Bucuresti,225,6,3,4,7,19,23,-4,13
FCSB,226,1,9,5,0,27,10,17,32
CFR Cluj,226,2,5,7,2,15,10,5,22
FC Botosani,226,3,4,5,5,8,14,-6,17
D Bucuresti,226,4,4,4,6,18,20,-2,16
Universitate,226,5,3,6,5,16,23,-7,15
Concordia Ch,226,6,2,3,9,16,23,-7,9
FCSB,227,1,9,5,0,32,12,20,32
CFR Cluj,227,2,5,7,2,16,15,1,22
D Bucuresti,227,3,4,4,6,18,20,-2,16
FC Botosani,227,4,4,4,6,8,15,-7,16
Universitate,227,5,3,6,5,15,21,-6,15
Concordia Ch,227,6,3,2,9,17,23,-6,11
FCSB,228,1,9,5,0,29,12,17,32
CFR Cluj,228,2,6,6,2,15,10,5,24
D Bucuresti,228,3,4,5,5,18,18,0,17
Universitate,228,4,3,5,6,15,22,-7,14
FC Botosani,228,5,3,5,6,6,14,-8,14
Concordia Ch,228,6,3,2,9,17,24,-7,11
CFR Cluj,229,1,7,6,1,17,8,9,27
FCSB,229,2,7,5,2,23,13,10,26
FC Botosani,229,3,5,4,5,10,13,-3,19
Universitate,229,4,4,5,5,16,20,-4,17
D Bucuresti,229,5,3,4,7,17,21,-4,13
Concordia Ch,229,6,3,2,9,16,24,-8,11
FCSB,230,1,8,5,1,26,12,14,29
CFR Cluj,230,2,6,6,2,16,12,4,24
Universitate,230,3,4,5,5,18,21,-3,17
FC Botosani,230,4,4,5,5,7,13,-6,17
D Bucuresti,230,5,3,5,6,17,20,-3,14
Concordia Ch,230,6,2,4,8,17,23,-6,10
FCSB,231,1,7,7,0,23,10,13,28
CFR Cluj,231,2,6,7,1,15,7,8,25
D Bucuresti,231,3,4,4,6,20,22,-2,16
Universitate,231,4,3,6,5,14,20,-6,15
Concordia Ch,231,5,4,2,8,19,23,-4,14
FC Botosani,231,6,3,4,7,6,15,-9,13
FCSB,232,1,8,5,1,26,13,13,29
CFR Cluj,232,2,6,6,2,16,10,6,24
D Bucuresti,232,3,5,4,5,20,18,2,19
Universitate,232,4,4,5,5,17,21,-4,17
FC Botosani,232,5,3,4,7,5,16,-11,13
Concordia Ch,232,6,3,2,9,16,22,-6,11
FCSB,233,1,9,5,0,26,11,15,32
CFR Cluj,233,2,6,6,2,15,9,6,24
D Bucuresti,233,3,4,4,6,20,22,-2,16
FC Botosani,233,4,4,4,6,9,15,-6,16
Universitate,233,5,3,5,6,14,20,-6,14
Concordia Ch,233,6,3,2,9,16,23,-7,11
FCSB,234,1,8,6,0,25,11,14,30
CFR Cluj,234,2,5,8,1,14,8,6,23
D Bucuresti,234,3,3,6,5,20,22,-2,15
Universitate,234,4,3,6,5,14,19,-5,15
FC Botosani,234,5,3,6,5,8,15,-7,15
Concordia Ch,234,6,2,4,8,18,24,-6,10
FCSB,235,1,8,6,0,28,11,17,30
CFR Cluj,235,2,6,6,2,14,11,3,24
D Bucuresti,235,3,4,5,5,18,19,-1,17
Universitate,235,4,3,6,5,15,20,-5,15
FC Botosani,235,5,3,5,6,7,15,-8,14
Concordia Ch,235,6,2,4,8,16,22,-6,10
FCSB,236,1,8,6,0,25,11,14,30
CFR Cluj,236,2,5,7,2,17,12,5,22
D Bucuresti,236,3,4,5,5,19,20,-1,17
Universitate,236,4,3,7,4,19,23,-4,16
FC Botosani,236,5,4,4,6,7,14,-7,16
Concordia Ch,236,6,2,3,9,16,23,-7,9
CFR Cluj,237,1,7,6,1,20,7,13,27
FCSB,237,2,7,6,1,24,14,10,27
Universitate,237,3,3,6,5,15,23,-8,15
D Bucuresti,237,4,3,5,6,19,22,-3,14
Concordia Ch,237,5,4,2,8,19,23,-4,14
FC Botosani,237,6,3,5,6,6,14,-8,14
FCSB,238,1,8,6,0,26,11,15,30
CFR Cluj,238,2,6,6,2,16,9,7,24
D Bucuresti,238,3,4,4,6,21,22,-1,16
Universitate,238,4,3,6,5,15,22,-7,15
FC Botosani,238,5,3,5,6,5,16,-11,14
Concordia Ch,238,6,3,3,8,19,22,-3,12
CFR Cluj,239,1,7,6,1,16,8,8,27
FCSB,239,2,7,5,2,25,14,11,26
D Bucuresti,239,3,4,5,5,18,19,-1,17
Universitate,239,4,4,5,5,16,20,-4,17
FC Botosani,239,5,3,5,6,6,14,-8,14
Concordia Ch,239,6,3,2,9,18,24,-6,11
FCSB,240,1,7,6,1,23,11,12,27
CFR Cluj,240,2,6,6,2,15,9,6,24
Universitate,240,3,4,6,4,16,19,-3,18
D Bucuresti,240,4,4,4,6,17,19,-2,16
FC Botosani,240,5,4,4,6,8,14,-6,16
Concordia Ch,240,6,3,2,9,17,24,-7,11
FCSB,241,1,8,6,0,27,12,15,30
CFR Cluj,241,2,6,7,1,17,9,8,25
D Bucuresti,241,3,4,4,6,17,20,-3,16
FC Botosani,241,4,4,4,6,7,14,-7,16
Universitate,241,5,3,5,6,16,24,-8,14
Concordia Ch,241,6,3,2,9,17,22,-5,11
FCSB,242,1,9,5,0,29,13,16,32
CFR Cluj,242,2,6,6,2,15,10,5,24
FC Botosani,242,3,4,4,6,7,14,-7,16
Concordia Ch,242,4,4,2,8,18,22,-4,14
Universitate,242,5,3,5,6,16,22,-6,14
D Bucuresti,242,6,3,4,7,16,20,-4,13
FCSB,243,1,7,6,1,23,11,12,27
CFR Cluj,243,2,7,6,1,16,7,9,27
D Bucuresti,243,3,4,5,5,20,21,-1,17
FC Botosani,243,4,4,5,5,7,13,-6,17
Universitate,243,5,3,6,5,14,20,-6,15
Concordia Ch,243,6,2,2,10,17,25,-8,8
FCSB,244,1,8,6,0,27,13,14,30
CFR Cluj,244,2,6,7,1,19,12,7,25
FC Botosani,244,3,4,5,5,6,12,-6,17
D Bucuresti,244,4,4,4,6,17,19,-2,16
Universitate,244,5,3,5,6,16,22,-6,14
Concordia Ch,244,6,2,3,9,15,22,-7,9
FCSB,245,1,8,5,1,24,13,11,29
CFR Cluj,245,2,7,6,1,18,8,10,27
D Bucuresti,245,3,4,4,6,18,21,-3,16
FC Botosani,245,4,4,4,6,9,15,-6,16
Universitate,245,5,3,5,6,15,21,-6,14
Concordia Ch,245,6,3,2,9,18,24,-6,11
FCSB,246,1,9,5,0,30,11,19,32
CFR Cluj,246,2,6,6,2,14,11,3,24
FC Botosani,246,3,5,4,5,8,12,-4,19
Universitate,246,4,3,5,6,15,22,-7,14
D Bucuresti,246,5,3,4,7,16,20,-4,13
Concordia Ch,246,6,3,2,9,16,23,-7,11
FCSB,247,1,8,5,1,24,11,13,29
CFR Cluj,247,2,6,6,2,15,9,6,24
Universitate,247,3,4,5,5,16,20,-4,17
D Bucuresti,247,4,4,4,6,20,22,-2,16
FC Botosani,247,5,4,4,6,10,15,-5,16
Concordia Ch,247,6,3,2,9,17,25,-8,11
FCSB,248,1,8,6,0,26,12,14,30
CFR Cluj,248,2,6,6,2,17,10,7,24
D Bucuresti,248,3,3,6,5,19,21,-2,15
Universitate,248,4,3,6,5,14,20,-6,15
FC Botosani,248,5,3,5,6,6,14,-8,14
Concordia Ch,248,6,3,3,8,18,23,-5,12
FCSB,249,1,9,5,0,28,12,16,32
CFR Cluj,249,2,5,6,3,15,12,3,21
D Bucuresti,249,3,5,4,5,18,18,0,19
Universitate,249,4,4,5,5,17,21,-4,17
FC Botosani,249,5,3,5,6,5,13,-8,14
Concordia Ch,249,6,2,3,9,15,22,-7,9
FCSB,250,1,9,5,0,27,10,17,32
CFR Cluj,250,2,5,7,2,15,11,4,22
D Bucuresti,250,3,4,5,5,20,20,0,17
FC Botosani,250,4,4,4,6,10,17,-7,16
Universitate,250,5,3,6,5,16,22,-6,15
Concordia Ch,250,6,2,3,9,18,26,-8,9
FCSB,251,1,8,5,1,26,13,13,29
CFR Cluj,251,2,5,6,3,13,11,2,21
Universitate,251,3,5,5,4,19,19,0,20
FC Botosani,251,4,4,5,5,8,13,-5,17
D Bucuresti,251,5,3,4,7,17,22,-5,13
Concordia Ch,251,6,3,3,8,18,23,-5,12
FCSB,252,1,8,5,1,25,13,12,29
CFR Cluj,252,2,5,6,3,14,11,3,21
Universitate,252,3,5,5,4,18,18,0,20
D Bucuresti,252,4,3,5,6,17,20,-3,14
Concordia Ch,252,5,4,2,8,18,22,-4,14
FC Botosani,252,6,3,5,6,7,15,-8,14
FCSB,253,1,8,5,1,25,11,14,29
CFR Cluj,253,2,5,7,2,14,10,4,22
Universitate,253,3,4,6,4,16,19,-3,18
FC Botosani,253,4,4,5,5,8,14,-6,17
D Bucuresti,253,5,4,4,6,18,20,-2,16
Concordia Ch,253,6,2,3,9,16,23,-7,9
FCSB,254,1,9,5,0,26,10,16,32
CFR Cluj,254,2,6,6,2,15,8,7,24
FC Botosani,254,3,4,5,5,6,12,-6,17
D Bucuresti,254,4,3,5,6,16,20,-4,14
Universitate,254,5,3,5,6,14,22,-8,14
Concordia Ch,254,6,3,2,9,17,22,-5,11
FCSB,255,1,9,5,0,27,11,16,32
CFR Cluj,255,2,6,6,2,16,11,5,24
D Bucuresti,255,3,4,5,5,18,19,-1,17
Universitate,255,4,3,5,6,15,21,-6,14
FC Botosani,255,5,3,5,6,7,16,-9,14
Concordia Ch,255,6,3,2,9,18,23,-5,11
FCSB,256,1,8,5,1,24,11,13,29
CFR Cluj,256,2,6,6,2,15,9,6,24
D Bucuresti,256,3,4,5,5,17,18,-1,17
Universitate,256,4,4,5,5,16,20,-4,17
FC Botosani,256,5,4,4,6,8,13,-5,16
Concordia Ch,256,6,2,3,9,15,24,-9,9
FCSB,257,1,9,5,0,27,11,16,32
CFR Cluj,257,2,5,6,3,14,11,3,21
Universitate,257,3,4,5,5,17,21,-4,17
FC Botosani,257,4,4,4,6,6,14,-8,16
Concordia Ch,257,5,4,2,8,18,21,-3,14
D Bucuresti,257,6,3,4,7,16,20,-4,13
FCSB,258,1,7,5,2,24,14,10,26
CFR Cluj,258,2,6,7,1,16,8,8,25
Universitate,258,3,4,6,4,17,20,-3,18
FC Botosani,258,4,4,4,6,6,13,-7,16
D Bucuresti,258,5,3,5,6,18,21,-3,14
Concordia Ch,258,6,3,3,8,18,23,-5,12
FCSB,259,1,7,6,1,23,12,11,27
CFR Cluj,259,2,7,6,1,16,7,9,27
D Bucuresti,259,3,5,4,5,20,19,1,19
FC Botosani,259,4,4,4,6,9,15,-6,16
Universitate,259,5,3,6,5,14,19,-5,15
Concordia Ch,259,6,2,2,10,15,25,-10,8
FCSB,260,1,8,5,1,26,13,13,29
CFR Cluj,260,2,6,6,2,16,11,5,24
Universitate,260,3,4,5,5,18,21,-3,17
D Bucuresti,260,4,4,4,6,19,21,-2,16
FC Botosani,260,5,4,4,6,7,15,-8,16
Concordia Ch,260,6,3,2,9,19,24,-5,11
FCSB,261,1,7,6,1,25,13,12,27
CFR Cluj,261,2,6,7,1,17,10,7,25
Universitate,261,3,4,5,5,18,22,-4,17
FC Botosani,261,4,4,5,5,6,12,-6,17
D Bucuresti,261,5,3,4,7,16,20,-4,13
Concordia Ch,261,6,3,3,8,16,21,-5,12
FCSB,262,1,8,6,0,28,14,14,30
CFR Cluj,262,2,5,7,2,15,10,5,22
FC Botosani,262,3,5,4,5,8,13,-5,19
Universitate,262,4,4,5,5,17,21,-4,17
D Bucuresti,262,5,3,5,6,16,19,-3,14
Concordia Ch,262,6,2,3,9,16,23,-7,9
FCSB,263,1,8,6,0,28,12,16,30
CFR Cluj,263,2,6,6,2,18,12,6,24
D Bucuresti,263,3,4,4,6,18,20,-2,16
FC Botosani,263,4,4,4,6,8,14,-6,16
Universitate,263,5,3,6,5,16,23,-7,15
Concordia Ch,263,6,3,2,9,16,23,-7,11
FCSB,264,1,8,5,1,28,16,12,29
CFR Cluj,264,2,5,7,2,15,10,5,22
D Bucuresti,264,3,5,4,5,23,19,4,19
Universitate,264,4,4,6,4,20,22,-2,18
FC Botosani,264,5,3,4,7,6,19,-13,13
Concordia Ch,264,6,3,2,9,18,24,-6,11
FCSB,265,1,9,5,0,26,11,15,32
CFR Cluj,265,2,5,6,3,15,11,4,21
FC Botosani,265,3,5,4,5,9,14,-5,19
Universitate,265,4,4,5,5,18,22,-4,17
D Bucuresti,265,5,3,5,6,18,21,-3,14
Concordia Ch,265,6,2,3,9,17,24,-7,9
FCSB,266,1,9,5,0,27,11,16,32
CFR Cluj,266,2,5,7,2,13,9,4,22
FC Botosani,266,3,5,4,5,8,12,-4,19
Universitate,266,4,3,6,5,15,20,-5,15
D Bucuresti,266,5,3,5,6,17,20,-3,14
Concordia Ch,266,6,2,3,9,16,24,-8,9
FCSB,267,1,8,6,0,26,11,15,30
CFR Cluj,267,2,5,7,2,13,9,4,22
D Bucuresti,267,3,4,4,6,20,21,-1,16
Universitate,267,4,3,7,4,15,19,-4,16
FC Botosani,267,5,3,5,6,7,16,-9,14
Concordia Ch,267,6,3,3,8,18,23,-5,12
FCSB,268,1,8,5,1,24,11,13,29
CFR Cluj,268,2,7,6,1,15,7,8,27
FC Botosani,268,3,4,5,5,7,13,-6,17
D Bucuresti,268,4,3,5,6,19,22,-3,14
Universitate,268,5,3,5,6,14,20,-6,14
Concordia Ch,268,6,2,4,8,19,25,-6,10
FCSB,269,1,8,5,1,28,12,16,29
CFR Cluj,269,2,5,6,3,14,14,0,21
Universitate,269,3,5,5,4,18,19,-1,20
D Bucuresti,269,4,4,4,6,19,20,-1,16
Concordia Ch,269,5,4,2,8,17,21,-4,14
FC Botosani,269,6,3,4,7,6,16,-10,13
FCSB,270,1,8,6,0,27,13,14,30
CFR Cluj,270,2,5,7,2,16,11,5,22
D Bucuresti,270,3,5,4,5,23,20,3,19
Universitate,270,4,4,5,5,17,21,-4,17
FC Botosani,270,5,3,5,6,8,17,-9,14
Concordia Ch,270,6,2,3,9,18,27,-9,9
FCSB,271,1,8,5,1,28,14,14,29
CFR Cluj,271,2,7,6,1,19,10,9,27
Concordia Ch,271,3,4,2,8,19,22,-3,14
D Bucuresti,271,4,3,5,6,17,21,-4,14
Universitate,271,5,3,5,6,17,25,-8,14
FC Botosani,271,6,3,5,6,7,15,-8,14
FCSB,272,1,8,5,1,27,12,15,29
CFR Cluj,272,2,6,6,2,15,10,5,24
D Bucuresti,272,3,4,5,5,19,18,1,17
Universitate,272,4,4,5,5,16,21,-5,17
FC Botosani,272,5,3,5,6,5,13,-8,14
Concordia Ch,272,6,3,2,9,16,24,-8,11
FCSB,273,1,7,6,1,24,12,12,27
CFR Cluj,273,2,5,7,2,15,10,5,22
Universitate,273,3,5,5,4,17,19,-2,20
D Bucuresti,273,4,4,4,6,19,21,-2,16
FC Botosani,273,5,4,4,6,8,15,-7,16
Concordia Ch,273,6,3,2,9,16,22,-6,11
FCSB,274,1,8,5,1,27,13,14,29
CFR Cluj,274,2,6,7,1,15,8,7,25
FC Botosani,274,3,4,5,5,8,13,-5,17
Universitate,274,4,3,6,5,15,21,-6,15
D Bucuresti,274,5,3,5,6,20,24,-4,14
Concordia Ch,274,6,2,4,8,20,26,-6,10
FCSB,275,1,8,6,0,25,10,15,30
CFR Cluj,275,2,5,7,2,14,10,4,22
D Bucuresti,275,3,4,5,5,18,19,-1,17
FC Botosani,275,4,4,5,5,6,12,-6,17
Universitate,275,5,3,7,4,15,19,-4,16
Concordia Ch,275,6,2,2,10,16,24,-8,8
FCSB,276,1,8,5,1,27,12,15,29
CFR Cluj,276,2,5,7,2,15,12,3,22
Universitate,276,3,4,6,4,16,19,-3,18
D Bucuresti,276,4,4,4,6,17,19,-2,16
FC Botosani,276,5,4,4,6,8,13,-5,16
Concordia Ch,276,6,3,2,9,16,24,-8,11
FCSB,277,1,7,7,0,24,11,13,28
CFR Cluj,277,2,5,7,2,14,11,3,22
Universitate,277,3,4,6,4,17,18,-1,18
D Bucuresti,277,4,4,5,5,18,19,-1,17
FC Botosani,277,5,4,4,6,8,14,-6,16
Concordia Ch,277,6,2,3,9,15,23,-8,9
FCSB,278,1,7,7,0,25,12,13,28
CFR Cluj,278,2,5,8,1,15,9,6,23
D Bucuresti,278,3,4,4,6,18,20,-2,16
Universitate,278,4,3,7,4,18,22,-4,16
FC Botosani,278,5,4,4,6,6,13,-7,16
Concordia Ch,278,6,3,2,9,17,23,-6,11
FCSB,279,1,7,5,2,24,15,9,26
CFR Cluj,279,2,6,6,2,18,11,7,24
Universitate,279,3,5,5,4,19,20,-1,20
D Bucuresti,279,4,4,5,5,18,18,0,17
FC Botosani,279,5,3,5,6,6,15,-9,14
Concordia Ch,279,6,2,4,8,16,22,-6,10
FCSB,280,1,8,5,1,26,11,15,29
CFR Cluj,280,2,7,6,1,16,8,8,27
D Bucuresti,280,3,4,5,5,19,19,0,17
FC Botosani,280,4,3,6,5,7,14,-7,15
Universitate,280,5,3,5,6,15,23,-8,14
Concordia Ch,280,6,2,3,9,18,26,-8,9
FCSB,281,1,8,6,0,27,13,14,30
CFR Cluj,281,2,6,7,1,17,10,7,25
D Bucuresti,281,3,4,5,5,20,19,1,17
FC Botosani,281,4,4,4,6,9,17,-8,16
Universitate,281,5,3,5,6,16,22,-6,14
Concordia Ch,281,6,2,3,9,16,24,-8,9
FCSB,282,1,7,7,0,24,11,13,28
CFR Cluj,282,2,6,7,1,14,7,7,25
D Bucuresti,282,3,5,4,5,19,18,1,19
Universitate,282,4,3,6,5,15,20,-5,15
FC Botosani,282,5,3,5,6,6,15,-9,14
Concordia Ch,282,6,2,3,9,16,23,-7,9
FCSB,283,1,7,5,2,23,13,10,26
CFR Cluj,283,2,6,7,1,16,9,7,25
FC Botosani,283,3,5,4,5,10,15,-5,19
Universitate,283,4,4,6,4,18,20,-2,18
D Bucuresti,283,5,3,4,7,18,24,-6,13
Concordia Ch,283,6,3,2,9,19,23,-4,11
FCSB,284,1,8,5,1,24,11,13,29
CFR Cluj,284,2,7,6,1,15,7,8,27
FC Botosani,284,3,4,5,5,8,13,-5,17
D Bucuresti,284,4,3,5,6,17,20,-3,14
Universitate,284,5,3,5,6,14,20,-6,14
Concordia Ch,284,6,3,2,9,18,25,-7,11
FCSB,285,1,8,5,1,27,12,15,29
CFR Cluj,285,2,6,6,2,15,10,5,24
Universitate,285,3,4,5,5,16,21,-5,17
D Bucuresti,285,4,4,4,6,17,19,-2,16
FC Botosani,285,5,4,4,6,7,14,-7,16
Concordia Ch,285,6,3,2,9,17,23,-6,11
FCSB,286,1,8,6,0,25,11,14,30
CFR Cluj,286,2,6,6,2,15,9,6,24
D Bucuresti,286,3,3,6,5,18,20,-2,15
Universitate,286,4,3,6,5,16,21,-5,15
FC Botosani,286,5,3,5,6,6,15,-9,14
Concordia Ch,286,6,3,3,8,18,22,-4,12
FCSB,287,1,8,5,1,25,13,12,29
CFR Cluj,287,2,7,6,1,18,9,9,27
D Bucuresti,287,3,4,5,5,18,19,-1,17
Universitate,287,4,3,5,6,15,21,-6,14
FC Botosani,287,5,3,5,6,5,13,-8,14
Concordia Ch,287,6,3,2,9,17,23,-6,11
FCSB,288,1,8,5,1,24,13,11,29
CFR Cluj,288,2,5,7,2,13,8,5,22
Universitate,288,3,4,6,4,17,18,-1,18
D Bucuresti,288,4,4,4,6,22,23,-1,16
FC Botosani,288,5,3,5,6,6,17,-11,14
Concordia Ch,288,6,3,3,8,21,24,-3,12
FCSB,289,1,7,7,0,25,12,13,28
CFR Cluj,289,2,5,8,1,14,8,6,23
FC Botosani,289,3,4,5,5,8,13,-5,17
Universitate,289,4,3,7,4,15,19,-4,16
D Bucuresti,289,5,3,5,6,18,21,-3,14
Concordia Ch,289,6,3,2,9,17,24,-7,11
FCSB,290,1,8,6,0,27,12,15,30
CFR Cluj,290,2,5,7,2,15,11,4,22
FC Botosani,290,3,4,5,5,9,13,-4,17
Universitate,290,4,3,7,4,18,22,-4,16
D Bucuresti,290,5,3,4,7,17,23,-6,13
Concordia Ch,290,6,3,3,8,18,23,-5,12
FCSB,291,1,9,5,0,28,11,17,32
CFR Cluj,291,2,5,6,3,14,12,2,21
Universitate,291,3,4,5,5,15,19,-4,17
FC Botosani,291,4,4,5,5,8,14,-6,17
D Bucuresti,291,5,4,4,6,17,19,-2,16
Concordia Ch,291,6,2,3,9,17,24,-7,9
FCSB,292,1,7,6,1,23,11,12,27
CFR Cluj,292,2,5,7,2,13,8,5,22
Universitate,292,3,5,5,4,16,18,-2,20
D Bucuresti,292,4,4,5,5,18,18,0,17
FC Botosani,292,5,4,5,5,6,12,-6,17
Concordia Ch,292,6,2,2,10,15,24,-9,8
FCSB,293,1,7,6,1,24,13,11,27
CFR Cluj,293,2,5,7,2,14,10,4,22
Universitate,293,3,5,5,4,18,18,0,20
FC Botosani,293,4,3,6,5,8,15,-7,15
D Bucuresti,293,5,3,5,6,18,23,-5,14
Concordia Ch,293,6,3,3,8,21,24,-3,12
FCSB,294,1,8,5,1,25,12,13,29
CFR Cluj,294,2,6,6,2,16,8,8,24
Universitate,294,3,4,5,5,16,22,-6,17
D Bucuresti,294,4,4,4,6,21,21,0,16
FC Botosani,294,5,4,4,6,8,15,-7,16
Concordia Ch,294,6,3,2,9,17,25,-8,11
FCSB,295,1,7,6,1,25,13,12,27
CFR Cluj,295,2,7,6,1,17,8,9,27
D Bucuresti,295,3,4,4,6,17,21,-4,16
Universitate,295,4,3,6,5,15,21,-6,15
FC Botosani,295,5,3,5,6,5,13,-8,14
Concordia Ch,295,6,3,3,8,18,21,-3,12
FCSB,296,1,9,5,0,29,13,16,32
CFR Cluj,296,2,6,6,2,14,9,5,24
FC Botosani,296,3,5,4,5,8,12,-4,19
Universitate,296,4,3,5,6,17,23,-6,14
D Bucuresti,296,5,3,4,7,19,23,-4,13
Concordia Ch,296,6,3,2,9,19,26,-7,11
FCSB,297,1,7,5,2,26,16,10,26
CFR Cluj,297,2,6,7,1,18,11,7,25
Universitate,297,3,4,6,4,19,21,-2,18
D Bucuresti,297,4,4,5,5,18,19,-1,17
FC Botosani,297,5,3,6,5,7,14,-7,15
Concordia Ch,297,6,2,3,9,16,23,-7,9
FCSB,298,1,9,5,0,29,11,18,32
CFR Cluj,298,2,6,6,2,16,10,6,24
FC Botosani,298,3,4,5,5,8,12,-4,17
D Bucuresti,298,4,3,5,6,17,22,-5,14
Universitate,298,5,3,5,6,14,23,-9,14
Concordia Ch,298,6,2,4,8,16,22,-6,10
FCSB,299,1,8,6,0,25,11,14,30
CFR Cluj,299,2,6,6,2,17,9,8,24
D Bucuresti,299,3,4,4,6,19,21,-2,16
FC Botosani,299,4,4,4,6,10,16,-6,16
Universitate,299,5,3,6,5,14,21,-7,15
Concordia Ch,299,6,3,2,9,17,24,-7,11
FCSB,300,1,9,5,0,25,10,15,32
CFR Cluj,300,2,5,7,2,13,8,5,22
D Bucuresti,300,3,4,5,5,21,20,1,17
FC Botosani,300,4,4,5,5,8,14,-6,17
Universitate,300,5,3,6,5,14,19,-5,15
Concordia Ch,300,6,2,2,10,15,25,-10,8
FCSB,301,1,8,6,0,26,12,14,30
CFR Cluj,301,2,5,6,3,14,10,4,21
Universitate,301,3,4,6,4,16,19,-3,18
D Bucuresti,301,4,4,4,6,19,19,0,16
Concordia Ch,301,5,4,2,8,18,22,-4,14
FC Botosani,301,6,3,4,7,6,17,-11,13
FCSB,302,1,8,5,1,26,12,14,29
CFR Cluj,302,2,6,7,1,16,8,8,25
D Bucuresti,302,3,5,4,5,23,19,4,19
Universitate,302,4,3,6,5,15,22,-7,15
FC Botosani,302,5,3,4,7,8,19,-11,13
Concordia Ch,302,6,3,2,9,19,27,-8,11
FCSB,303,1,9,5,0,27,11,16,32
CFR Cluj,303,2,6,6,2,14,8,6,24
D Bucuresti,303,3,3,5,6,16,19,-3,14
Concordia Ch,303,4,4,2,8,19,23,-4,14
Universitate,303,5,3,5,6,15,22,-7,14
FC Botosani,303,6,3,5,6,7,15,-8,14
FCSB,304,1,9,5,0,28,11,17,32
CFR Cluj,304,2,6,6,2,16,8,8,24
FC Botosani,304,3,4,5,5,9,14,-5,17
D Bucuresti,304,4,3,6,5,19,21,-2,15
Universitate,304,5,3,5,6,15,25,-10,14
Concordia Ch,304,6,2,3,9,18,26,-8,9
FCSB,305,1,9,5,0,29,12,17,32
CFR Cluj,305,2,5,6,3,16,13,3,21
Universitate,305,3,4,5,5,18,23,-5,17
FC Botosani,305,4,4,5,5,7,13,-6,17
D Bucuresti,305,5,3,6,5,18,20,-2,15
Concordia Ch,305,6,2,3,9,16,23,-7,9
FCSB,306,1,9,5,0,25,10,15,32
CFR Cluj,306,2,5,6,3,14,10,4,21
D Bucuresti,306,3,4,5,5,18,18,0,17
Universitate,306,4,4,5,5,16,20,-4,17
FC Botosani,306,5,3,5,6,6,15,-9,14
Concordia Ch,306,6,2,4,8,16,22,-6,10
FCSB,307,1,8,5,1,25,11,14,29
CFR Cluj,307,2,6,6,2,16,10,6,24
D Bucuresti,307,3,5,4,5,21,19,2,19
Universitate,307,4,4,5,5,17,22,-5,17
FC Botosani,307,5,3,4,7,5,16,-11,13
Concordia Ch,307,6,3,2,9,17,23,-6,11
FCSB,308,1,8,5,1,27,13,14,29
CFR Cluj,308,2,6,6,2,14,9,5,24
Universitate,308,3,4,5,5,17,21,-4,17
D Bucuresti,308,4,4,4,6,18,23,-5,16
Concordia Ch,308,5,4,2,8,20,21,-1,14
FC Botosani,308,6,3,4,7,6,15,-9,13
FCSB,309,1,8,6,0,25,11,14,30
CFR Cluj,309,2,6,7,1,14,7,7,25
D Bucuresti,309,3,4,5,5,18,19,-1,17
Universitate,309,4,3,5,6,15,21,-6,14
FC Botosani,309,5,3,5,6,7,16,-9,14
Concordia Ch,309,6,3,2,9,18,23,-5,11
FCSB,310,1,7,6,1,25,14,11,27
CFR Cluj,310,2,5,8,1,16,10,6,23
Universitate,310,3,4,6,4,19,21,-2,18
FC Botosani,310,4,4,5,5,9,12,-3,17
D Bucuresti,310,5,3,5,6,16,19,-3,14
Concordia Ch,310,6,3,2,9,16,25,-9,11
FCSB,311,1,8,5,1,24,14,10,29
CFR Cluj,311,2,6,6,2,17,9,8,24
D Bucuresti,311,3,5,4,5,20,19,1,19
Universitate,311,4,4,5,5,19,22,-3,17
FC Botosani,311,5,4,4,6,6,14,-8,16
Concordia Ch,311,6,2,2,10,16,24,-8,8
FCSB,312,1,8,6,0,27,13,14,30
CFR Cluj,312,2,5,7,2,15,11,4,22
D Bucuresti,312,3,4,5,5,20,20,0,17
Universitate,312,4,4,5,5,17,20,-3,17
FC Botosani,312,5,4,5,5,7,12,-5,17
Concordia Ch,312,6,2,2,10,17,27,-10,8
FCSB,313,1,7,5,2,24,14,10,26
CFR Cluj,313,2,6,6,2,17,10,7,24
Universitate,313,3,5,5,4,19,21,-2,20
D Bucuresti,313,4,4,5,5,20,20,0,17
FC Botosani,313,5,3,5,6,6,15,-9,14
Concordia Ch,313,6,2,4,8,18,24,-6,10
FCSB,314,1,9,5,0,27,12,15,32
CFR Cluj,314,2,6,6,2,16,10,6,24
D Bucuresti,314,3,5,4,5,18,18,0,19
Universitate,314,4,3,5,6,14,20,-6,14
FC Botosani,314,5,3,5,6,5,13,-8,14
Concordia Ch,314,6,2,3,9,15,22,-7,9
FCSB,315,1,7,6,1,25,13,12,27
CFR Cluj,315,2,7,6,1,17,8,9,27
D Bucuresti,315,3,4,4,6,19,20,-1,16
FC Botosani,315,4,4,4,6,8,15,-7,16
Universitate,315,5,3,6,5,15,21,-6,15
Concordia Ch,315,6,3,2,9,16,23,-7,11
FCSB,316,1,9,5,0,26,10,16,32
CFR Cluj,316,2,6,6,2,14,9,5,24
D Bucuresti,316,3,3,6,5,18,20,-2,15
Universitate,316,4,3,5,6,14,20,-6,14
FC Botosani,316,5,3,5,6,7,15,-8,14
Concordia Ch,316,6,3,3,8,18,23,-5,12
FCSB,317,1,8,5,1,24,11,13,29
CFR Cluj,317,2,6,6,2,14,8,6,24
Universitate,317,3,4,5,5,15,19,-4,17
FC Botosani,317,4,4,5,5,8,14,-6,17
D Bucuresti,317,5,3,5,6,19,22,-3,14
Concordia Ch,317,6,3,2,9,19,25,-6,11
FCSB,318,1,8,5,1,26,13,13,29
CFR Cluj,318,2,6,6,2,15,9,6,24
Universitate,318,3,4,5,5,18,22,-4,17
D Bucuresti,318,4,4,4,6,19,21,-2,16
FC Botosani,318,5,4,4,6,7,14,-7,16
Concordia Ch,318,6,3,2,9,17,23,-6,11
FCSB,319,1,9,5,0,30,11,19,32
CFR Cluj,319,2,6,6,2,16,10,6,24
D Bucuresti,319,3,4,5,5,20,19,1,17
FC Botosani,319,4,3,6,5,7,14,-7,15
Universitate,319,5,3,5,6,14,24,-10,14
Concordia Ch,319,6,2,3,9,16,25,-9,9
FCSB,320,1,8,5,1,25,12,13,29
CFR Cluj,320,2,5,7,2,13,8,5,22
D Bucuresti,320,3,5,4,5,18,18,0,19
Universitate,320,4,4,6,4,16,19,-3,18
FC Botosani,320,5,3,4,7,5,14,-9,13
Concordia Ch,320,6,3,2,9,16,22,-6,11
FCSB,321,1,8,6,0,26,11,15,30
CFR Cluj,321,2,6,6,2,15,10,5,24
FC Botosani,321,3,4,4,6,6,13,-7,16
Universitate,321,4,3,6,5,16,21,-5,15
Concordia Ch,321,5,4,2,8,20,21,-1,14
D Bucuresti,321,6,3,4,7,16,23,-7,13
FCSB,322,1,7,7,0,25,12,13,28
CFR Cluj,322,2,6,7,1,16,8,8,25
D Bucuresti,322,3,5,4,5,21,19,2,19
Universitate,322,4,3,6,5,15,21,-6,15
FC Botosani,322,5,3,5,6,5,15,-10,14
Concordia Ch,322,6,2,3,9,16,23,-7,9
FCSB,323,1,8,5,1,27,14,13,29
CFR Cluj,323,2,6,6,2,16,10,6,24
D Bucuresti,323,3,4,5,5,20,21,-1,17
Universitate,323,4,4,5,5,18,22,-4,17
FC Botosani,323,5,3,5,6,7,15,-8,14
Concordia Ch,323,6,2,4,8,18,24,-6,10
FCSB,324,1,8,5,1,26,12,14,29
CFR Cluj,324,2,6,6,2,14,8,6,24
D Bucuresti,324,3,4,5,5,18,19,-1,17
Universitate,324,4,4,5,5,16,21,-5,17
FC Botosani,324,5,4,4,6,6,13,-7,16
Concordia Ch,324,6,2,3,9,16,23,-7,9
FCSB,325,1,7,5,2,23,13,10,26
CFR Cluj,325,2,6,6,2,15,10,5,24
Universitate,325,3,5,5,4,18,18,0,20
D Bucuresti,325,4,4,4,6,19,21,-2,16
FC Botosani,325,5,4,4,6,8,13,-5,16
Concordia Ch,325,6,3,2,9,18,26,-8,11
FCSB,326,1,9,5,0,27,11,16,32
CFR Cluj,326,2,6,6,2,15,9,6,24
D Bucuresti,326,3,4,5,5,21,20,1,17
FC Botosani,326,4,4,4,6,6,15,-9,16
Universitate,326,5,3,5,6,16,23,-7,14
Concordia Ch,326,6,2,3,9,17,24,-7,9
FCSB,327,1,7,7,0,24,11,13,28
CFR Cluj,327,2,5,8,1,15,9,6,23
D Bucuresti,327,3,4,5,5,17,18,-1,17
Universitate,327,4,3,7,4,15,19,-4,16
FC Botosani,327,5,4,4,6,6,13,-7,16
Concordia Ch,327,6,2,3,9,15,22,-7,9
FCSB,328,1,8,5,1,25,13,12,29
CFR Cluj,328,2,5,6,3,13,10,3,21
Universitate,328,3,5,5,4,18,18,0,20
D Bucuresti,328,4,4,5,5,18,18,0,17
FC Botosani,328,5,3,5,6,5,13,-8,14
Concordia Ch,328,6,3,2,9,16,23,-7,11
FCSB,329,1,9,5,0,27,11,16,32
CFR Cluj,329,2,6,6,2,18,10,8,24
D Bucuresti,329,3,4,4,6,18,21,-3,16
FC Botosani,329,4,3,5,6,6,14,-8,14
Universitate,329,5,3,5,6,14,23,-9,14
Concordia Ch,329,6,3,3,8,19,23,-4,12
FCSB,330,1,7,6,1,27,15,12,27
CFR Cluj,330,2,6,7,1,15,8,7,25
D Bucuresti,330,3,4,4,6,18,19,-1,16
Universitate,330,4,3,7,4,17,21,-4,16
FC Botosani,330,5,4,4,6,6,14,-8,16
Concordia Ch,330,6,3,2,9,16,22,-6,11
FCSB,331,1,7,6,1,23,11,12,27
CFR Cluj,331,2,6,7,1,14,7,7,25
Universitate,331,3,4,5,5,15,19,-4,17
D Bucuresti,331,4,4,4,6,17,19,-2,16
FC Botosani,331,5,4,4,6,7,13,-6,16
Concordia Ch,331,6,3,2,9,16,23,-7,11
FCSB,332,1,8,6,0,24,10,14,30
CFR Cluj,332,2,6,6,2,15,9,6,24
FC Botosani,332,3,4,4,6,8,15,-7,16
Universitate,332,4,3,6,5,15,20,-5,15
Concordia Ch,332,5,4,2,8,19,22,-3,14
D Bucuresti,332,6,3,4,7,17,22,-5,13
FCSB,333,1,8,6,0,24,10,14,30
CFR Cluj,333,2,5,6,3,13,9,4,21
Universitate,333,3,4,6,4,15,18,-3,18
FC Botosani,333,4,4,5,5,8,12,-4,17
D Bucuresti,333,5,3,5,6,17,22,-5,14
Concordia Ch,333,6,2,4,8,16,22,-6,10
FCSB,334,1,8,5,1,24,11,13,29
CFR Cluj,334,2,5,7,2,14,9,5,22
Universitate,334,3,4,6,4,16,19,-3,18
FC Botosani,334,4,4,5,5,7,13,-6,17
D Bucuresti,334,5,3,5,6,17,22,-5,14
Concordia Ch,334,6,3,2,9,18,22,-4,11
FCSB,335,1,8,6,0,25,10,15,30
CFR Cluj,335,2,6,7,1,15,7,8,25
FC Botosani,335,3,4,5,5,6,12,-6,17
D Bucuresti,335,4,4,4,6,18,20,-2,16
Universitate,335,5,3,5,6,14,22,-8,14
Concordia Ch,335,6,2,3,9,16,23,-7,9
FCSB,336,1,8,5,1,29,15,14,29
CFR Cluj,336,2,5,6,3,15,13,2,21
Universitate,336,3,5,5,4,18,19,-1,20
FC Botosani,336,4,4,5,5,7,12,-5,17
D Bucuresti,336,5,3,5,6,17,21,-4,14
Concordia Ch,336,6,2,4,8,16,22,-6,10
FCSB,337,1,8,6,0,27,11,16,30
CFR Cluj,337,2,5,8,1,15,9,6,23
FC Botosani,337,3,4,5,5,8,13,-5,17
D Bucuresti,337,4,3,6,5,18,20,-2,15
Universitate,337,5,3,6,5,15,22,-7,15
Concordia Ch,337,6,2,3,9,16,24,-8,9
FCSB,338,1,7,6,1,24,12,12,27
CFR Cluj,338,2,5,7,2,14,9,5,22
Universitate,338,3,5,5,4,18,20,-2,20
D Bucuresti,338,4,4,5,5,19,20,-1,17
FC Botosani,338,5,4,4,6,9,15,-6,16
Concordia Ch,338,6,2,3,9,15,23,-8,9
FCSB,339,1,8,6,0,27,13,14,30
CFR Cluj,339,2,6,7,1,16,9,7,25
FC Botosani,339,3,4,5,5,8,12,-4,17
D Bucuresti,339,4,3,5,6,20,23,-3,14
Universitate,339,5,3,5,6,15,21,-6,14
Concordia Ch,339,6,3,2,9,20,28,-8,11
FCSB,340,1,8,5,1,25,13,12,29
CFR Cluj,340,2,7,6,1,18,8,10,27
FC Botosani,340,3,4,5,5,9,14,-5,17
D Bucuresti,340,4,3,6,5,19,21,-2,15
Universitate,340,5,3,5,6,15,22,-7,14
Concordia Ch,340,6,2,3,9,16,24,-8,9
FCSB,341,1,8,6,0,26,11,15,30
CFR Cluj,341,2,5,8,1,14,8,6,23
D Bucuresti,341,3,4,5,5,17,18,-1,17
FC Botosani,341,4,4,4,6,6,13,-7,16
Universitate,341,5,3,6,5,14,20,-6,15
Concordia Ch,341,6,2,3,9,15,22,-7,9
FCSB,342,1,8,5,1,25,13,12,29
CFR Cluj,342,2,6,6,2,16,10,6,24
D Bucuresti,342,3,4,5,5,19,20,-1,17
Universitate,342,4,4,5,5,19,22,-3,17
FC Botosani,342,5,3,4,7,6,15,-9,13
Concordia Ch,342,6,3,3,8,17,22,-5,12
FCSB,343,1,7,7,0,24,11,13,28
CFR Cluj,343,2,6,7,1,15,8,7,25
D Bucuresti,343,3,4,4,6,21,23,-2,16
FC Botosani,343,4,4,4,6,10,16,-6,16
Universitate,343,5,3,6,5,14,19,-5,15
Concordia Ch,343,6,3,2,9,17,24,-7,11
FCSB,344,1,9,5,0,26,11,15,32
CFR Cluj,344,2,6,6,2,14,8,6,24
D Bucuresti,344,3,5,4,5,20,19,1,19
Universitate,344,4,3,5,6,15,21,-6,14
FC Botosani,344,5,3,5,6,5,14,-9,14
Concordia Ch,344,6,2,3,9,16,23,-7,9
FCSB,345,1,9,5,0,25,10,15,32
CFR Cluj,345,2,6,6,2,14,8,6,24
D Bucuresti,345,3,4,4,6,19,23,-4,16
Universitate,345,4,3,5,6,14,20,-6,14
FC Botosani,345,5,3,5,6,6,15,-9,14
Concordia Ch,345,6,3,3,8,21,23,-2,12
FCSB,346,1,7,5,2,23,13,10,26
CFR Cluj,346,2,6,7,1,15,7,8,25
Universitate,346,3,4,6,4,15,18,-3,18
D Bucuresti,346,4,4,4,6,17,20,-3,16
FC Botosani,346,5,3,5,6,5,13,-8,14
Concordia Ch,346,6,3,3,8,17,21,-4,12
FCSB,347,1,8,6,0,24,10,14,30
CFR Cluj,347,2,5,7,2,13,8,5,22
D Bucuresti,347,3,4,5,5,19,20,-1,17
Universitate,347,4,3,7,4,14,18,-4,16
FC Botosani,347,5,4,4,6,8,14,-6,16
Concordia Ch,347,6,2,3,9,16,24,-8,9
FCSB,348,1,8,6,0,27,13,14,30
CFR Cluj,348,2,6,7,1,14,7,7,25
FC Botosani,348,3,4,4,6,8,17,-9,16
Concordia Ch,348,4,4,2,8,21,22,-1,14
Universitate,348,5,3,5,6,17,23,-6,14
D Bucuresti,348,6,3,4,7,19,24,-5,13
FCSB,349,1,8,6,0,26,11,15,30
CFR Cluj,349,2,6,7,1,15,8,7,25
D Bucuresti,349,3,4,5,5,20,20,0,17
Universitate,349,4,3,5,6,14,21,-7,14
FC Botosani,349,5,3,5,6,7,15,-8,14
Concordia Ch,349,6,3,2,9,18,25,-7,11
FCSB,350,1,8,6,0,25,10,15,30
CFR Cluj,350,2,5,8,1,13,7,6,23
D Bucuresti,350,3,4,4,6,20,21,-1,16
FC Botosani,350,4,4,4,6,6,15,-9,16
Universitate,350,5,3,6,5,14,20,-6,15
Concordia Ch,350,6,3,2,9,18,23,-5,11
FCSB,351,1,7,6,1,26,15,11,27
CFR Cluj,351,2,5,8,1,16,10,6,23
Universitate,351,3,4,6,4,18,20,-2,18
FC Botosani,351,4,4,5,5,7,13,-6,17
D Bucuresti,351,5,3,5,6,17,20,-3,14
Concordia Ch,351,6,3,2,9,18,24,-6,11
FCSB,352,1,7,7,0,24,11,13,28
CFR Cluj,352,2,5,8,1,15,9,6,23
D Bucuresti,352,3,4,4,6,19,20,-1,16
Universitate,352,4,3,7,4,15,19,-4,16
FC Botosani,352,5,4,4,6,8,14,-6,16
Concordia Ch,352,6,3,2,9,17,25,-8,11
FCSB,353,1,7,7,0,26,13,13,28
CFR Cluj,353,2,5,8,1,16,10,6,23
Universitate,353,3,3,7,4,16,20,-4,16
FC Botosani,353,4,3,6,5,8,15,-7,15
D Bucuresti,353,5,3,5,6,17,23,-6,14
Concordia Ch,353,6,3,3,8,21,23,-2,12
CFR Cluj,354,1,7,6,1,19,8,11,27
FCSB,354,2,7,5,2,23,17,6,26
D Bucuresti,354,3,5,4,5,18,18,0,19
Universitate,354,4,4,5,5,18,20,-2,17
FC Botosani,354,5,3,4,7,6,17,-11,13
Concordia Ch,354,6,3,2,9,19,23,-4,11
FCSB,355,1,9,5,0,27,10,17,32
CFR Cluj,355,2,6,6,2,15,10,5,24
D Bucuresti,355,3,5,4,5,20,19,1,19
FC Botosani,355,4,4,4,6,8,16,-8,16
Universitate,355,5,3,5,6,15,22,-7,14
Concordia Ch,355,6,2,2,10,16,24,-8,8
FCSB,356,1,7,6,1,25,13,12,27
CFR Cluj,356,2,6,7,1,16,8,8,25
Universitate,356,3,4,5,5,16,21,-5,17
FC Botosani,356,4,4,4,6,7,14,-7,16
D Bucuresti,356,5,3,5,6,17,20,-3,14
Concordia Ch,356,6,3,3,8,16,21,-5,12
FCSB,357,1,9,5,0,26,10,16,32
CFR Cluj,357,2,5,7,2,14,10,4,22
Universitate,357,3,3,6,5,15,20,-5,15
Concordia Ch,357,4,4,2,8,19,22,-3,14
D Bucuresti,357,5,3,5,6,17,20,-3,14
FC Botosani,357,6,3,5,6,7,16,-9,14
FCSB,358,1,7,7,0,25,12,13,28
CFR Cluj,358,2,6,7,1,16,7,9,25
FC Botosani,358,3,4,5,5,8,14,-6,17
Universitate,358,4,3,6,5,16,23,-7,15
D Bucuresti,358,5,3,5,6,19,22,-3,14
Concordia Ch,358,6,2,4,8,18,24,-6,10
FCSB,359,1,9,5,0,29,11,18,32
CFR Cluj,359,2,6,6,2,17,12,5,24
FC Botosani,359,3,4,5,5,7,12,-5,17
D Bucuresti,359,4,3,6,5,18,20,-2,15
Universitate,359,5,3,5,6,15,23,-8,14
Concordia Ch,359,6,2,3,9,17,25,-8,9
FCSB,360,1,7,7,0,26,13,13,28
CFR Cluj,360,2,6,7,1,17,10,7,25
FC Botosani,360,3,4,4,6,6,13,-7,16
Universitate,360,4,3,6,5,16,21,-5,15
Concordia Ch,360,5,4,2,8,19,21,-2,14
D Bucuresti,360,6,3,4,7,16,22,-6,13
FCSB,361,1,9,5,0,26,10,16,32
CFR Cluj,361,2,5,6,3,14,12,2,21
Universitate,361,3,4,5,5,18,21,-3,17
FC Botosani,361,4,4,5,5,7,12,-5,17
D Bucuresti,361,5,4,4,6,19,20,-1,16
Concordia Ch,361,6,2,3,9,15,24,-9,9
FCSB,362,1,8,5,1,25,15,10,29
CFR Cluj,362,2,7,6,1,19,7,12,27
D Bucuresti,362,3,4,5,5,18,18,0,17
Universitate,362,4,3,5,6,15,22,-7,14
FC Botosani,362,5,3,5,6,5,13,-8,14
Concordia Ch,362,6,3,2,9,16,23,-7,11
FCSB,363,1,7,6,1,24,12,12,27
CFR Cluj,363,2,6,7,1,18,7,11,25
Universitate,363,3,4,5,5,16,24,-8,17
D Bucuresti,363,4,4,4,6,20,21,-1,16
Concordia Ch,363,5,4,2,8,19,23,-4,14
FC Botosani,363,6,3,4,7,5,15,-10,13
FCSB,364,1,9,5,0,29,11,18,32
CFR Cluj,364,2,5,6,3,14,10,4,21
Universitate,364,3,4,5,5,17,24,-7,17
D Bucuresti,364,4,4,4,6,19,20,-1,16
Concordia Ch,364,5,4,2,8,18,22,-4,14
FC Botosani,364,6,3,4,7,5,15,-10,13
FCSB,365,1,8,5,1,25,12,13,29
CFR Cluj,365,2,6,6,2,15,9,6,24
D Bucuresti,365,3,4,5,5,20,21,-1,17
Universitate,365,4,4,5,5,16,20,-4,17
FC Botosani,365,5,4,4,6,8,15,-7,16
Concordia Ch,365,6,2,3,9,18,25,-7,9
FCSB,366,1,8,6,0,26,11,15,30
CFR Cluj,366,2,6,6,2,16,10,6,24
Universitate,366,3,3,6,5,16,22,-6,15
FC Botosani,366,4,3,6,5,7,14,-7,15
D Bucuresti,366,5,3,5,6,17,22,-5,14
Concordia Ch,366,6,3,3,8,19,22,-3,12
FCSB,367,1,8,6,0,26,10,16,30
CFR Cluj,367,2,5,8,1,14,8,6,23
FC Botosani,367,3,4,5,5,8,14,-6,17
Universitate,367,4,3,6,5,15,22,-7,15
D Bucuresti,367,5,3,4,7,16,21,-5,13
Concordia Ch,367,6,3,3,8,19,23,-4,12
FCSB,368,1,9,5,0,31,13,18,32
CFR Cluj,368,2,5,7,2,14,10,4,22
D Bucuresti,368,3,5,4,5,21,21,0,19
FC Botosani,368,4,4,4,6,10,17,-7,16
Universitate,368,5,3,6,5,16,23,-7,15
Concordia Ch,368,6,2,2,10,18,26,-8,8
FCSB,369,1,8,5,1,25,12,13,29
CFR Cluj,369,2,6,6,2,15,8,7,24
D Bucuresti,369,3,5,4,5,21,19,2,19
Universitate,369,4,4,5,5,16,21,-5,17
FC Botosani,369,5,4,4,6,8,15,-7,16
Concordia Ch,369,6,2,2,10,16,26,-10,8
FCSB,370,1,8,5,1,27,12,15,29
CFR Cluj,370,2,5,7,2,15,12,3,22
Universitate,370,3,4,6,4,16,19,-3,18
FC Botosani,370,4,4,5,5,7,12,-5,17
D Bucuresti,370,5,3,6,5,16,18,-2,15
Concordia Ch,370,6,2,3,9,15,23,-8,9
FCSB,371,1,8,5,1,26,13,13,29
CFR Cluj,371,2,6,6,2,15,9,6,24
Universitate,371,3,4,5,5,16,20,-4,17
FC Botosani,371,4,3,6,5,5,12,-7,15
D Bucuresti,371,5,3,5,6,17,20,-3,14
Concordia Ch,371,6,3,3,8,17,22,-5,12
FCSB,372,1,7,6,1,26,14,12,27
CFR Cluj,372,2,6,7,1,16,8,8,25
FC Botosani,372,3,5,4,5,8,12,-4,19
Universitate,372,4,4,5,5,17,22,-5,17
D Bucuresti,372,5,3,5,6,17,20,-3,14
Concordia Ch,372,6,2,3,9,16,24,-8,9
FCSB,373,1,8,5,1,25,13,12,29
CFR Cluj,373,2,6,7,1,17,9,8,25
D Bucuresti,373,3,4,4,6,17,20,-3,16
FC Botosani,373,4,4,4,6,6,13,-7,16
Universitate,373,5,3,6,5,17,22,-5,15
Concordia Ch,373,6,3,2,9,17,22,-5,11
FCSB,374,1,7,7,0,24,11,13,28
CFR Cluj,374,2,6,7,1,15,7,8,25
D Bucuresti,374,3,4,5,5,18,19,-1,17
Universitate,374,4,3,6,5,15,21,-6,15
FC Botosani,374,5,3,5,6,8,16,-8,14
Concordia Ch,374,6,3,2,9,18,24,-6,11
FCSB,375,1,8,5,1,27,13,14,29
CFR Cluj,375,2,7,6,1,17,8,9,27
D Bucuresti,375,3,3,6,5,19,21,-2,15
FC Botosani,375,4,3,6,5,9,16,-7,15
Universitate,375,5,3,5,6,16,24,-8,14
Concordia Ch,375,6,2,4,8,18,24,-6,10
FCSB,376,1,8,6,0,25,11,14,30
CFR Cluj,376,2,6,6,2,14,8,6,24
D Bucuresti,376,3,4,5,5,19,20,-1,17
FC Botosani,376,4,4,5,5,8,13,-5,17
Universitate,376,5,3,6,5,15,20,-5,15
Concordia Ch,376,6,2,2,10,16,25,-9,8
FCSB,377,1,8,5,1,26,14,12,29
CFR Cluj,377,2,5,6,3,16,12,4,21
Universitate,377,3,5,5,4,18,19,-1,20
D Bucuresti,377,4,4,4,6,22,22,0,16
Concordia Ch,377,5,4,2,8,21,23,-2,14
FC Botosani,377,6,3,4,7,5,18,-13,13
FCSB,378,1,8,5,1,25,12,13,29
CFR Cluj,378,2,6,6,2,14,8,6,24
Universitate,378,3,4,5,5,16,20,-4,17
D Bucuresti,378,4,4,4,6,18,21,-3,16
FC Botosani,378,5,3,5,6,5,14,-9,14
Concordia Ch,378,6,3,3,8,18,21,-3,12
FCSB,379,1,8,6,0,25,11,14,30
CFR Cluj,379,2,5,8,1,15,9,6,23
FC Botosani,379,3,4,4,6,6,14,-8,16
Universitate,379,4,3,6,5,15,20,-5,15
D Bucuresti,379,5,3,5,6,17,20,-3,14
Concordia Ch,379,6,3,3,8,18,22,-4,12
FCSB,380,1,7,7,0,24,11,13,28
CFR Cluj,380,2,5,8,1,13,7,6,23
D Bucuresti,380,3,4,4,6,17,20,-3,16
Universitate,380,4,3,7,4,15,19,-4,16
FC Botosani,380,5,3,5,6,5,13,-8,14
Concordia Ch,380,6,3,3,8,17,21,-4,12
FCSB,381,1,9,5,0,29,10,19,32
CFR Cluj,381,2,6,6,2,14,8,6,24
D Bucuresti,381,3,4,5,5,17,18,-1,17
FC Botosani,381,4,3,5,6,6,14,-8,14
Universitate,381,5,3,5,6,14,24,-10,14
Concordia Ch,381,6,2,4,8,16,22,-6,10
FCSB,382,1,8,5,1,25,12,13,29
CFR Cluj,382,2,5,7,2,15,10,5,22
Universitate,382,3,4,6,4,18,21,-3,18
D Bucuresti,382,4,4,5,5,23,22,1,17
FC Botosani,382,5,3,5,6,6,16,-10,14
Concordia Ch,382,6,2,4,8,20,26,-6,10
FCSB,383,1,8,6,0,24,10,14,30
CFR Cluj,383,2,6,6,2,15,8,7,24
FC Botosani,383,3,4,5,5,8,14,-6,17
Universitate,383,4,3,6,5,14,20,-6,15
D Bucuresti,383,5,3,5,6,18,25,-7,14
Concordia Ch,383,6,3,2,9,22,24,-2,11
FCSB,384,1,9,5,0,30,11,19,32
CFR Cluj,384,2,5,7,2,14,11,3,22
D Bucuresti,384,3,5,4,5,22,19,3,19
Universitate,384,4,3,6,5,14,21,-7,15
FC Botosani,384,5,3,5,6,6,16,-10,14
Concordia Ch,384,6,2,3,9,15,23,-8,9
FCSB,385,1,7,6,1,23,11,12,27
CFR Cluj,385,2,5,8,1,14,8,6,23
Universitate,385,3,4,6,4,16,19,-3,18
FC Botosani,385,4,4,4,6,7,13,-6,16
Concordia Ch,385,5,4,2,8,17,21,-4,14
D Bucuresti,385,6,3,4,7,16,21,-5,13
FCSB,386,1,7,5,2,23,15,8,26
CFR Cluj,386,2,6,7,1,17,8,9,25
FC Botosani,386,3,5,4,5,8,13,-5,19
Universitate,386,4,4,6,4,17,19,-2,18
D Bucuresti,386,5,3,4,7,16,23,-7,13
Concordia Ch,386,6,3,2,9,20,23,-3,11
FCSB,387,1,7,6,1,24,13,11,27
CFR Cluj,387,2,6,6,2,16,9,7,24
Universitate,387,3,4,6,4,17,20,-3,18
D Bucuresti,387,4,4,4,6,20,20,0,16
Concordia Ch,387,5,4,2,8,20,22,-2,14
FC Botosani,387,6,3,4,7,6,19,-13,13
FCSB,388,1,8,5,1,25,12,13,29
CFR Cluj,388,2,5,6,3,13,9,4,21
Universitate,388,3,5,5,4,17,19,-2,20
FC Botosani,388,4,5,4,5,7,12,-5,19
D Bucuresti,388,5,3,5,6,17,20,-3,14
Concordia Ch,388,6,2,3,9,16,23,-7,9
FCSB,389,1,9,5,0,27,10,17,32
CFR Cluj,389,2,5,6,3,15,13,2,21
Universitate,389,3,4,5,5,17,21,-4,17
FC Botosani,389,4,4,5,5,11,16,-5,17
D Bucuresti,389,5,4,4,6,18,21,-3,16
Concordia Ch,389,6,2,3,9,20,27,-7,9
FCSB,390,1,8,5,1,26,12,14,29
CFR Cluj,390,2,5,7,2,15,11,4,22
D Bucuresti,390,3,5,4,5,21,20,1,19
Universitate,390,4,4,6,4,18,21,-3,18
FC Botosani,390,5,4,4,6,8,14,-6,16
Concordia Ch,390,6,2,2,10,16,26,-10,8
FCSB,391,1,8,6,0,25,11,14,30
CFR Cluj,391,2,5,8,1,16,10,6,23
FC Botosani,391,3,5,4,5,12,14,-2,19
Universitate,391,4,3,6,5,16,21,-5,15
D Bucuresti,391,5,3,5,6,18,21,-3,14
Concordia Ch,391,6,2,3,9,15,25,-10,9
FCSB,392,1,8,6,0,26,10,16,30
CFR Cluj,392,2,6,6,2,16,11,5,24
D Bucuresti,392,3,4,5,5,19,20,-1,17
FC Botosani,392,4,4,4,6,7,14,-7,16
Universitate,392,5,3,6,5,15,21,-6,15
Concordia Ch,392,6,2,3,9,18,25,-7,9
FCSB,393,1,8,5,1,26,13,13,29
CFR Cluj,393,2,5,6,3,16,14,2,21
Universitate,393,3,5,5,4,19,19,0,20
FC Botosani,393,4,4,5,5,7,13,-6,17
D Bucuresti,393,5,3,5,6,19,23,-4,14
Concordia Ch,393,6,3,2,9,19,24,-5,11
FCSB,394,1,7,6,1,23,13,10,27
CFR Cluj,394,2,5,8,1,15,9,6,23
D Bucuresti,394,3,5,4,5,22,20,2,19
Universitate,394,4,4,6,4,19,20,-1,18
FC Botosani,394,5,4,4,6,7,16,-9,16
Concordia Ch,394,6,2,2,10,16,24,-8,8
FCSB,395,1,8,6,0,26,10,16,30
CFR Cluj,395,2,5,7,2,13,10,3,22
D Bucuresti,395,3,4,4,6,18,20,-2,16
Universitate,395,4,3,7,4,14,18,-4,16
Concordia Ch,395,5,4,2,8,18,22,-4,14
FC Botosani,395,6,3,4,7,7,16,-9,13
FCSB,396,1,9,5,0,25,10,15,32
CFR Cluj,396,2,5,6,3,14,10,4,21
Universitate,396,3,4,5,5,16,20,-4,17
D Bucuresti,396,4,4,4,6,18,21,-3,16
FC Botosani,396,5,4,4,6,7,14,-7,16
Concordia Ch,396,6,3,2,9,17,22,-5,11
FCSB,397,1,8,6,0,27,11,16,30
CFR Cluj,397,2,5,6,3,13,11,2,21
Universitate,397,3,4,6,4,16,19,-3,18
D Bucuresti,397,4,4,5,5,20,20,0,17
FC Botosani,397,5,4,4,6,8,15,-7,16
Concordia Ch,397,6,2,3,9,16,24,-8,9
FCSB,398,1,7,6,1,25,13,12,27
CFR Cluj,398,2,5,8,1,15,9,6,23
Universitate,398,3,4,6,4,17,20,-3,18
FC Botosani,398,4,4,5,5,7,12,-5,17
D Bucuresti,398,5,4,4,6,17,20,-3,16
Concordia Ch,398,6,2,3,9,15,22,-7,9
FCSB,399,1,8,5,1,27,13,14,29
CFR Cluj,399,2,6,7,1,15,8,7,25
D Bucuresti,399,3,4,5,5,19,20,-1,17
FC Botosani,399,4,4,5,5,9,13,-4,17
Universitate,399,5,3,6,5,15,21,-6,15
Concordia Ch,399,6,2,2,10,16,26,-10,8
FCSB,400,1,9,5,0,28,10,18,32
CFR Cluj,400,2,5,7,2,14,9,5,22
D Bucuresti,400,3,5,4,5,19,19,0,19
FC Botosani,400,4,4,4,6,6,13,-7,16
Universitate,400,5,3,6,5,15,23,-8,15
Concordia Ch,400,6,2,2,10,16,24,-8,8
FCSB,401,1,8,6,0,27,12,15,30
CFR Cluj,401,2,6,7,1,14,7,7,25
D Bucuresti,401,3,4,4,6,19,20,-1,16
FC Botosani,401,4,4,4,6,7,14,-7,16
Universitate,401,5,3,5,6,16,23,-7,14
Concordia Ch,401,6,3,2,9,16,23,-7,11
FCSB,402,1,8,6,0,24,10,14,30
CFR Cluj,402,2,6,6,2,16,9,7,24
D Bucuresti,402,3,4,4,6,18,21,-3,16
Universitate,402,4,3,6,5,15,21,-6,15
FC Botosani,402,5,3,5,6,6,14,-8,14
Concordia Ch,402,6,3,3,8,17,21,-4,12
FCSB,403,1,8,5,1,25,13,12,29
CFR Cluj,403,2,6,6,2,15,8,7,24
Universitate,403,3,4,5,5,17,21,-4,17
D Bucuresti,403,4,4,4,6,20,20,0,16
FC Botosani,403,5,4,4,6,7,16,-9,16
Concordia Ch,403,6,3,2,9,18,24,-6,11
FCSB,404,1,9,5,0,26,11,15,32
CFR Cluj,404,2,6,6,2,19,9,10,24
D Bucuresti,404,3,5,4,5,19,18,1,19
Universitate,404,4,3,5,6,14,24,-10,14
FC Botosani,404,5,3,4,7,7,16,-9,13
Concordia Ch,404,6,3,2,9,18,25,-7,11
FCSB,405,1,8,5,1,25,12,13,29
CFR Cluj,405,2,5,7,2,14,9,5,22
Universitate,405,3,4,6,4,17,20,-3,18
D Bucuresti,405,4,4,4,6,18,20,-2,16
FC Botosani,405,5,4,4,6,7,13,-6,16
Concordia Ch,405,6,3,2,9,17,24,-7,11
FCSB,406,1,8,5,1,24,11,13,29
CFR Cluj,406,2,6,7,1,15,8,7,25
FC Botosani,406,3,4,4,6,6,13,-7,16
Universitate,406,4,3,6,5,15,20,-5,15
Concordia Ch,406,5,4,2,8,19,23,-4,14
D Bucuresti,406,6,3,4,7,18,22,-4,13
FCSB,407,1,7,7,0,25,12,13,28
CFR Cluj,407,2,5,8,1,15,9,6,23
FC Botosani,407,3,4,5,5,8,14,-6,17
Universitate,407,4,3,7,4,14,18,-4,16
D Bucuresti,407,5,3,4,7,17,21,-4,13
Concordia Ch,407,6,3,3,8,19,24,-5,12
FCSB,408,1,8,6,0,26,11,15,30
CFR Cluj,408,2,5,8,1,14,8,6,23
D Bucuresti,408,3,4,4,6,18,22,-4,16
FC Botosani,408,4,4,4,6,7,15,-8,16
Universitate,408,5,3,6,5,16,22,-6,15
Concordia Ch,408,6,3,2,9,20,23,-3,11
FCSB,409,1,9,5,0,26,10,16,32
CFR Cluj,409,2,5,6,3,13,9,4,21
D Bucuresti,409,3,5,4,5,20,19,1,19
Universitate,409,4,4,5,5,15,20,-5,17
FC Botosani,409,5,4,4,6,8,16,-8,16
Concordia Ch,409,6,2,2,10,16,24,-8,8
FCSB,410,1,8,6,0,26,12,14,30
CFR Cluj,410,2,5,6,3,13,9,4,21
D Bucuresti,410,3,5,4,5,21,18,3,19
Universitate,410,4,4,6,4,17,20,-3,18
FC Botosani,410,5,4,4,6,6,16,-10,16
Concordia Ch,410,6,2,2,10,15,23,-8,8
FCSB,411,1,8,6,0,27,12,15,30
CFR Cluj,411,2,6,7,1,17,9,8,25
D Bucuresti,411,3,3,6,5,17,19,-2,15
FC Botosani,411,4,3,6,5,7,14,-7,15
Universitate,411,5,3,5,6,14,22,-8,14
Concordia Ch,411,6,2,4,8,16,22,-6,10
FCSB,412,1,8,5,1,26,13,13,29
CFR Cluj,412,2,6,6,2,16,10,6,24
FC Botosani,412,3,5,4,5,9,14,-5,19
Universitate,412,4,4,5,5,15,19,-4,17
D Bucuresti,412,5,4,4,6,17,19,-2,16
Concordia Ch,412,6,2,2,10,17,25,-8,8
FCSB,413,1,8,5,1,26,11,15,29
CFR Cluj,413,2,6,6,2,15,11,4,24
FC Botosani,413,3,5,4,5,7,12,-5,19
Universitate,413,4,4,5,5,16,20,-4,17
D Bucuresti,413,5,3,4,7,16,20,-4,13
Concordia Ch,413,6,3,2,9,16,22,-6,11
FCSB,414,1,8,5,1,28,13,15,29
CFR Cluj,414,2,6,6,2,15,12,3,24
Universitate,414,3,4,5,5,17,20,-3,17
FC Botosani,414,4,4,5,5,8,13,-5,17
D Bucuresti,414,5,3,5,6,17,21,-4,14
Concordia Ch,414,6,3,2,9,17,23,-6,11
FCSB,415,1,7,5,2,23,15,8,26
CFR Cluj,415,2,6,6,2,16,10,6,24
Universitate,415,3,5,5,4,20,19,1,20
D Bucuresti,415,4,4,4,6,18,20,-2,16
FC Botosani,415,5,3,5,6,5,13,-8,14
Concordia Ch,415,6,3,3,8,17,22,-5,12
FCSB,416,1,9,5,0,25,10,15,32
CFR Cluj,416,2,5,6,3,13,10,3,21
Universitate,416,3,4,5,5,16,19,-3,17
D Bucuresti,416,4,4,4,6,20,23,-3,16
Concordia Ch,416,5,4,2,8,20,22,-2,14
FC Botosani,416,6,3,4,7,6,16,-10,13
FCSB,417,1,7,7,0,25,12,13,28
CFR Cluj,417,2,6,7,1,15,8,7,25
FC Botosani,417,3,5,4,5,8,12,-4,19
Universitate,417,4,3,6,5,15,20,-5,15
D Bucuresti,417,5,3,4,7,16,20,-4,13
Concordia Ch,417,6,3,2,9,16,23,-7,11
FCSB,418,1,7,7,0,24,11,13,28
CFR Cluj,418,2,5,7,2,15,10,5,22
FC Botosani,418,3,5,4,5,8,12,-4,19
Universitate,418,4,4,6,4,16,19,-3,18
D Bucuresti,418,5,3,4,7,16,20,-4,13
Concordia Ch,418,6,3,2,9,16,23,-7,11
FCSB,419,1,8,5,1,24,12,12,29
CFR Cluj,419,2,6,6,2,15,8,7,24
D Bucuresti,419,3,4,5,5,19,19,0,17
Universitate,419,4,4,5,5,16,20,-4,17
FC Botosani,419,5,3,4,7,5,16,-11,13
Concordia Ch,419,6,3,3,8,18,22,-4,12
FCSB,420,1,8,6,0,26,11,15,30
CFR Cluj,420,2,6,6,2,15,9,6,24
FC Botosani,420,3,4,5,5,8,13,-5,17
Universitate,420,4,3,6,5,15,21,-6,15
D Bucuresti,420,5,3,5,6,17,21,-4,14
Concordia Ch,420,6,3,2,9,17,23,-6,11
FCSB,421,1,7,6,1,24,13,11,27
CFR Cluj,421,2,5,8,1,15,9,6,23
D Bucuresti,421,3,5,4,5,22,20,2,19
Universitate,421,4,4,6,4,17,19,-2,18
FC Botosani,421,5,3,4,7,6,18,-12,13
Concordia Ch,421,6,3,2,9,20,25,-5,11
FCSB,422,1,8,6,0,27,12,15,30
CFR Cluj,422,2,5,7,2,13,9,4,22
FC Botosani,422,3,5,4,5,9,13,-4,19
Universitate,422,4,3,7,4,16,20,-4,16
D Bucuresti,422,5,3,5,6,18,21,-3,14
Concordia Ch,422,6,2,3,9,16,24,-8,9
FCSB,423,1,9,5,0,27,10,17,32
CFR Cluj,423,2,5,7,2,14,9,5,22
D Bucuresti,423,3,5,4,5,21,20,1,19
Universitate,423,4,3,6,5,15,22,-7,15
FC Botosani,423,5,3,4,7,6,17,-11,13
Concordia Ch,423,6,3,2,9,18,23,-5,11
FCSB,424,1,8,5,1,26,13,13,29
CFR Cluj,424,2,6,7,1,16,9,7,25
FC Botosani,424,3,4,5,5,7,13,-6,17
Universitate,424,4,3,6,5,18,23,-5,15
D Bucuresti,424,5,3,5,6,16,19,-3,14
Concordia Ch,424,6,2,4,8,16,22,-6,10
FCSB,425,1,8,6,0,26,11,15,30
CFR Cluj,425,2,5,6,3,13,10,3,21
Universitate,425,3,4,6,4,16,19,-3,18
FC Botosani,425,4,4,5,5,8,14,-6,17
D Bucuresti,425,5,3,5,6,18,21,-3,14
Concordia Ch,425,6,3,2,9,18,24,-6,11
FCSB,426,1,8,6,0,27,11,16,30
CFR Cluj,426,2,5,8,1,14,8,6,23
FC Botosani,426,3,4,4,6,9,15,-6,16
Universitate,426,4,3,6,5,14,21,-7,15
D Bucuresti,426,5,3,5,6,19,24,-5,14
Concordia Ch,426,6,3,3,8,19,23,-4,12
FCSB,427,1,8,6,0,25,10,15,30
CFR Cluj,427,2,5,6,3,13,12,1,21
Universitate,427,3,4,6,4,17,18,-1,18
FC Botosani,427,4,4,5,5,6,12,-6,17
D Bucuresti,427,5,3,4,7,17,21,-4,13
Concordia Ch,427,6,3,3,8,17,22,-5,12
FCSB,428,1,8,5,1,28,14,14,29
CFR Cluj,428,2,5,6,3,14,12,2,21
Universitate,428,3,5,5,4,18,19,-1,20
D Bucuresti,428,4,5,4,5,20,19,1,19
FC Botosani,428,5,4,4,6,8,15,-7,16
Concordia Ch,428,6,2,2,10,18,27,-9,8
FCSB,429,1,8,5,1,26,11,15,29
CFR Cluj,429,2,6,7,1,15,8,7,25
FC Botosani,429,3,5,4,5,8,13,-5,19
Universitate,429,4,3,6,5,15,22,-7,15
D Bucuresti,429,5,3,5,6,17,20,-3,14
Concordia Ch,429,6,2,3,9,17,24,-7,9
FCSB,430,1,8,6,0,26,12,14,30
CFR Cluj,430,2,6,6,2,14,8,6,24
FC Botosani,430,3,4,4,6,8,15,-7,16
Universitate,430,4,3,6,5,16,21,-5,15
D Bucuresti,430,5,3,5,6,18,21,-3,14
Concordia Ch,430,6,3,3,8,18,23,-5,12
FCSB,431,1,8,6,0,24,10,14,30
CFR Cluj,431,2,6,6,2,14,8,6,24
D Bucuresti,431,3,5,4,5,18,18,0,19
FC Botosani,431,4,4,4,6,8,15,-7,16
Universitate,431,5,3,6,5,14,19,-5,15
Concordia Ch,431,6,2,2,10,17,25,-8,8
CFR Cluj,432,1,7,6,1,17,7,10,27
FCSB,432,2,7,5,2,23,15,8,26
Universitate,432,3,4,5,5,16,19,-3,17
FC Botosani,432,4,3,6,5,5,12,-7,15
D Bucuresti,432,5,3,5,6,17,20,-3,14
Concordia Ch,432,6,3,3,8,17,22,-5,12
FCSB,433,1,7,6,1,25,14,11,27
CFR Cluj,433,2,6,7,1,16,8,8,25
D Bucuresti,433,3,4,5,5,18,19,-1,17
Universitate,433,4,4,5,5,19,23,-4,17
FC Botosani,433,5,3,6,5,6,13,-7,15
Concordia Ch,433,6,2,3,9,17,24,-7,9
FCSB,434,1,8,5,1,26,14,12,29
CFR Cluj,434,2,6,6,2,15,8,7,24
Universitate,434,3,4,5,5,17,21,-4,17
FC Botosani,434,4,3,6,5,8,15,-7,15
D Bucuresti,434,5,3,5,6,19,22,-3,14
Concordia Ch,434,6,3,3,8,16,21,-5,12
FCSB,435,1,8,5,1,27,16,11,29
CFR Cluj,435,2,6,7,1,16,7,9,25
D Bucuresti,435,3,4,5,5,18,19,-1,17
FC Botosani,435,4,4,4,6,7,13,-6,16
Universitate,435,5,3,6,5,17,22,-5,15
Concordia Ch,435,6,2,3,9,16,24,-8,9
FCSB,436,1,7,6,1,25,14,11,27
CFR Cluj,436,2,6,7,1,15,7,8,25
D Bucuresti,436,3,5,4,5,19,19,0,19
Universitate,436,4,3,7,4,16,20,-4,16
FC Botosani,436,5,4,4,6,7,14,-7,16
Concordia Ch,436,6,2,2,10,17,25,-8,8
FCSB,437,1,8,5,1,26,14,12,29
CFR Cluj,437,2,6,6,2,17,12,5,24
Universitate,437,3,4,5,5,19,21,-2,17
D Bucuresti,437,4,4,4,6,20,22,-2,16
FC Botosani,437,5,4,4,6,6,15,-9,16
Concordia Ch,437,6,3,2,9,19,23,-4,11
FCSB,438,1,8,6,0,27,12,15,30
CFR Cluj,438,2,6,7,1,17,9,8,25
D Bucuresti,438,3,3,6,5,17,19,-2,15
Universitate,438,4,3,5,6,14,22,-8,14
FC Botosani,438,5,3,5,6,6,15,-9,14
Concordia Ch,438,6,3,3,8,19,23,-4,12
FCSB,439,1,8,6,0,25,10,15,30
CFR Cluj,439,2,5,7,2,15,11,4,22
D Bucuresti,439,3,4,4,6,19,20,-1,16
Universitate,439,4,3,7,4,16,20,-4,16
Concordia Ch,439,5,4,2,8,20,24,-4,14
FC Botosani,439,6,3,4,7,7,17,-10,13
FCSB,440,1,7,6,1,23,12,11,27
CFR Cluj,440,2,6,7,1,14,7,7,25
Universitate,440,3,4,5,5,16,19,-3,17
FC Botosani,440,4,3,6,5,7,14,-7,15
D Bucuresti,440,5,3,5,6,16,20,-4,14
Concordia Ch,440,6,3,3,8,19,23,-4,12
FCSB,441,1,8,5,1,25,12,13,29
CFR Cluj,441,2,5,6,3,14,11,3,21
Universitate,441,3,5,5,4,17,18,-1,20
D Bucuresti,441,4,5,4,5,18,18,0,19
FC Botosani,441,5,3,4,7,7,16,-9,13
Concordia Ch,441,6,3,2,9,18,24,-6,11
FCSB,442,1,7,6,1,25,13,12,27
CFR Cluj,442,2,7,6,1,16,8,8,27
FC Botosani,442,3,4,5,5,7,12,-5,17
D Bucuresti,442,4,3,6,5,17,19,-2,15
Universitate,442,5,3,6,5,17,22,-5,15
Concordia Ch,442,6,2,3,9,16,24,-8,9
FCSB,443,1,7,6,1,26,14,12,27
CFR Cluj,443,2,5,8,1,16,10,6,23
FC Botosani,443,3,5,4,5,7,12,-5,19
Universitate,443,4,4,6,4,17,20,-3,18
D Bucuresti,443,5,3,4,7,16,22,-6,13
Concordia Ch,443,6,3,2,9,18,22,-4,11
FCSB,444,1,8,5,1,27,13,14,29
CFR Cluj,444,2,6,7,1,17,9,8,25
D Bucuresti,444,3,4,4,6,17,19,-2,16
FC Botosani,444,4,4,4,6,7,13,-6,16
Universitate,444,5,3,6,5,17,24,-7,15
Concordia Ch,444,6,3,2,9,16,23,-7,11
FCSB,445,1,9,5,0,26,11,15,32
CFR Cluj,445,2,6,6,2,15,9,6,24
D Bucuresti,445,3,4,5,5,20,20,0,17
Universitate,445,4,3,5,6,14,20,-6,14
FC Botosani,445,5,3,5,6,7,15,-8,14
Concordia Ch,445,6,3,2,9,16,23,-7,11
FCSB,446,1,8,6,0,26,12,14,30
CFR Cluj,446,2,5,6,3,14,10,4,21
Universitate,446,3,4,6,4,16,19,-3,18
D Bucuresti,446,4,4,5,5,19,20,-1,17
FC Botosani,446,5,3,5,6,6,14,-8,14
Concordia Ch,446,6,2,4,8,16,22,-6,10
FCSB,447,1,8,5,1,26,12,14,29
CFR Cluj,447,2,5,7,2,14,10,4,22
Universitate,447,3,4,6,4,17,20,-3,18
FC Botosani,447,4,4,5,5,7,13,-6,17
D Bucuresti,447,5,3,5,6,19,22,-3,14
Concordia Ch,447,6,3,2,9,18,24,-6,11
FCSB,448,1,7,7,0,24,11,13,28
CFR Cluj,448,2,5,8,1,15,9,6,23
D Bucuresti,448,3,4,5,5,21,20,1,17
Universitate,448,4,3,7,4,15,19,-4,16
FC Botosani,448,5,3,4,7,6,17,-11,13
Concordia Ch,448,6,3,3,8,19,24,-5,12
FCSB,449,1,7,7,0,26,13,13,28
CFR Cluj,449,2,5,7,2,14,9,5,22
Universitate,449,3,4,6,4,17,20,-3,18
D Bucuresti,449,4,4,4,6,19,23,-4,16
Concordia Ch,449,5,4,2,8,22,22,0,14
FC Botosani,449,6,3,4,7,6,17,-11,13
FCSB,450,1,7,6,1,25,13,12,27
CFR Cluj,450,2,7,6,1,16,8,8,27
D Bucuresti,450,3,5,4,5,19,19,0,19
Universitate,450,4,3,6,5,15,20,-5,15
FC Botosani,450,5,3,5,6,6,14,-8,14
Concordia Ch,450,6,2,3,9,17,24,-7,9
FCSB,451,1,9,5,0,26,11,15,32
CFR Cluj,451,2,5,7,2,14,9,5,22
D Bucuresti,451,3,4,4,6,17,20,-3,16
Universitate,451,4,3,6,5,16,21,-5,15
FC Botosani,451,5,3,5,6,6,14,-8,14
Concordia Ch,451,6,3,3,8,18,22,-4,12
FCSB,452,1,9,5,0,27,12,15,32
CFR Cluj,452,2,5,7,2,15,10,5,22
D Bucuresti,452,3,5,4,5,20,18,2,19
Universitate,452,4,3,6,5,16,21,-5,15
FC Botosani,452,5,3,5,6,6,14,-8,14
Concordia Ch,452,6,2,3,9,16,25,-9,9
FCSB,453,1,9,5,0,25,10,15,32
CFR Cluj,453,2,6,6,2,14,8,6,24
FC Botosani,453,3,4,5,5,7,13,-6,17
D Bucuresti,453,4,4,4,6,21,21,0,16
Universitate,453,5,3,5,6,14,20,-6,14
Concordia Ch,453,6,2,3,9,16,25,-9,9
FCSB,454,1,7,5,2,24,14,10,26
CFR Cluj,454,2,6,6,2,16,10,6,24
Universitate,454,3,5,5,4,18,19,-1,20
D Bucuresti,454,4,4,5,5,22,20,2,17
FC Botosani,454,5,3,4,7,5,18,-13,13
Concordia Ch,454,6,3,3,8,19,23,-4,12
FCSB,455,1,8,5,1,27,13,14,29
CFR Cluj,455,2,7,6,1,17,9,8,27
D Bucuresti,455,3,4,4,6,17,22,-5,16
Universitate,455,4,3,5,6,14,21,-7,14
FC Botosani,455,5,3,5,6,6,14,-8,14
Concordia Ch,455,6,3,3,8,20,22,-2,12
FCSB,456,1,7,7,0,24,11,13,28
CFR Cluj,456,2,5,7,2,14,11,3,22
Universitate,456,3,4,6,4,17,18,-1,18
D Bucuresti,456,4,4,5,5,17,18,-1,17
FC Botosani,456,5,3,4,7,5,14,-9,13
Concordia Ch,456,6,3,3,8,16,21,-5,12
FCSB,457,1,7,7,0,23,10,13,28
CFR Cluj,457,2,6,7,1,16,7,9,25
D Bucuresti,457,3,4,5,5,18,19,-1,17
Universitate,457,4,3,6,5,14,21,-7,15
FC Botosani,457,5,3,4,7,6,15,-9,13
Concordia Ch,457,6,3,3,8,18,23,-5,12
FCSB,458,1,8,5,1,24,12,12,29
CFR Cluj,458,2,5,7,2,14,9,5,22
Universitate,458,3,4,6,4,17,19,-2,18
FC Botosani,458,4,4,5,5,7,13,-6,17
D Bucuresti,458,5,3,4,7,17,21,-4,13
Concordia Ch,458,6,3,3,8,18,23,-5,12
FCSB,459,1,8,6,0,27,13,14,30
CFR Cluj,459,2,6,6,2,15,9,6,24
D Bucuresti,459,3,4,5,5,18,19,-1,17
Universitate,459,4,3,6,5,16,21,-5,15
FC Botosani,459,5,3,6,5,5,12,-7,15
Concordia Ch,459,6,2,3,9,16,23,-7,9
FCSB,460,1,8,6,0,27,13,14,30
CFR Cluj,460,2,5,7,2,17,12,5,22
D Bucuresti,460,3,4,5,5,20,21,-1,17
Universitate,460,4,3,7,4,17,21,-4,16
FC Botosani,460,5,4,4,6,9,16,-7,16
Concordia Ch,460,6,2,3,9,17,24,-7,9
FCSB,461,1,8,5,1,25,12,13,29
CFR Cluj,461,2,7,6,1,19,10,9,27
FC Botosani,461,3,5,4,5,8,12,-4,19
D Bucuresti,461,4,4,4,6,18,20,-2,16
Universitate,461,5,3,5,6,16,23,-7,14
Concordia Ch,461,6,2,2,10,16,25,-9,8
FCSB,462,1,9,5,0,28,11,17,32
CFR Cluj,462,2,5,6,3,14,13,1,21
Universitate,462,3,4,5,5,16,19,-3,17
FC Botosani,462,4,4,5,5,9,13,-4,17
D Bucuresti,462,5,3,5,6,18,23,-5,14
Concordia Ch,462,6,2,4,8,16,22,-6,10
FCSB,463,1,8,6,0,24,10,14,30
CFR Cluj,463,2,6,7,1,15,7,8,25
D Bucuresti,463,3,4,4,6,17,21,-4,16
FC Botosani,463,4,4,4,6,8,13,-5,16
Universitate,463,5,3,5,6,14,21,-7,14
Concordia Ch,463,6,3,2,9,18,24,-6,11
FCSB,464,1,8,6,0,26,11,15,30
CFR Cluj,464,2,5,6,3,14,13,1,21
Universitate,464,3,4,6,4,17,18,-1,18
FC Botosani,464,4,4,4,6,6,16,-10,16
D Bucuresti,464,5,3,5,6,18,21,-3,14
Concordia Ch,464,6,3,3,8,21,23,-2,12
FCSB,465,1,7,7,0,24,11,13,28
CFR Cluj,465,2,5,8,1,15,9,6,23
D Bucuresti,465,3,4,4,6,17,20,-3,16
Universitate,465,4,3,7,4,15,19,-4,16
Concordia Ch,465,5,4,2,8,19,21,-2,14
FC Botosani,465,6,3,4,7,5,15,-10,13
FCSB,466,1,7,6,1,26,16,10,27
CFR Cluj,466,2,6,7,1,17,9,8,25
D Bucuresti,466,3,4,5,5,18,19,-1,17
Universitate,466,4,4,5,5,18,21,-3,17
FC Botosani,466,5,3,6,5,6,13,-7,15
Concordia Ch,466,6,2,3,9,17,24,-7,9
FCSB,467,1,7,6,1,25,14,11,27
CFR Cluj,467,2,7,6,1,16,7,9,27
FC Botosani,467,3,5,4,5,8,12,-4,19
D Bucuresti,467,4,4,4,6,18,20,-2,16
Universitate,467,5,3,6,5,16,21,-5,15
Concordia Ch,467,6,2,2,10,16,25,-9,8
FCSB,468,1,7,7,0,26,13,13,28
CFR Cluj,468,2,6,7,1,16,8,8,25
FC Botosani,468,3,4,5,5,7,13,-6,17
Universitate,468,4,3,6,5,16,22,-6,15
D Bucuresti,468,5,3,4,7,17,22,-5,13
Concordia Ch,468,6,3,3,8,19,23,-4,12
FCSB,469,1,8,5,1,27,14,13,29
CFR Cluj,469,2,5,7,2,15,10,5,22
Universitate,469,3,4,6,4,16,19,-3,18
D Bucuresti,469,4,4,4,6,22,22,0,16
FC Botosani,469,5,4,4,6,9,17,-8,16
Concordia Ch,469,6,3,2,9,17,24,-7,11
FCSB,470,1,9,5,0,28,10,18,32
CFR Cluj,470,2,5,6,3,14,12,2,21
Universitate,470,3,4,5,5,16,21,-5,17
FC Botosani,470,4,4,4,6,7,13,-6,16
D Bucuresti,470,5,3,5,6,17,21,-4,14
Concordia Ch,470,6,3,3,8,17,22,-5,12
FCSB,471,1,9,5,0,29,12,17,32
CFR Cluj,471,2,6,6,2,17,11,6,24
D Bucuresti,471,3,4,5,5,19,20,-1,17
FC Botosani,471,4,4,5,5,8,14,-6,17
Universitate,471,5,3,5,6,16,24,-8,14
Concordia Ch,471,6,2,2,10,15,23,-8,8
FCSB,472,1,8,5,1,26,13,13,29
CFR Cluj,472,2,7,6,1,18,9,9,27
D Bucuresti,472,3,4,5,5,19,20,-1,17
FC Botosani,472,4,4,5,5,7,13,-6,17
Universitate,472,5,3,5,6,14,21,-7,14
Concordia Ch,472,6,2,2,10,16,24,-8,8
FCSB,473,1,7,7,0,26,13,13,28
CFR Cluj,473,2,5,7,2,14,9,5,22
Universitate,473,3,4,6,4,19,22,-3,18
D Bucuresti,473,4,4,4,6,18,21,-3,16
FC Botosani,473,5,4,4,6,8,15,-7,16
Concordia Ch,473,6,3,2,9,18,23,-5,11
FCSB,474,1,8,5,1,26,13,13,29
CFR Cluj,474,2,5,7,2,13,8,5,22
Universitate,474,3,4,6,4,17,20,-3,18
FC Botosani,474,4,4,5,5,10,13,-3,17
D Bucuresti,474,5,3,5,6,17,20,-3,14
Concordia Ch,474,6,3,2,9,16,25,-9,11
FCSB,475,1,8,6,0,24,10,14,30
CFR Cluj,475,2,5,6,3,13,10,3,21
Universitate,475,3,4,6,4,16,18,-2,18
D Bucuresti,475,4,4,4,6,19,21,-2,16
Concordia Ch,475,5,4,2,8,19,23,-4,14
FC Botosani,475,6,3,4,7,5,14,-9,13
FCSB,476,1,8,5,1,26,15,11,29
CFR Cluj,476,2,6,6,2,14,8,6,24
D Bucuresti,476,3,5,4,5,19,19,0,19
Universitate,476,4,4,5,5,19,21,-2,17
FC Botosani,476,5,4,4,6,7,14,-7,16
Concordia Ch,476,6,2,2,10,17,25,-8,8
FCSB,477,1,9,5,0,26,11,15,32
CFR Cluj,477,2,5,7,2,13,8,5,22
FC Botosani,477,3,4,5,5,7,13,-6,17
D Bucuresti,477,4,4,4,6,18,20,-2,16
Universitate,477,5,3,6,5,15,20,-5,15
Concordia Ch,477,6,2,3,9,17,24,-7,9
FCSB,478,1,8,6,0,27,13,14,30
CFR Cluj,478,2,6,6,2,16,10,6,24
FC Botosani,478,3,4,5,5,9,15,-6,17
D Bucuresti,478,4,4,4,6,19,20,-1,16
Universitate,478,5,3,6,5,17,22,-5,15
Concordia Ch,478,6,2,3,9,17,25,-8,9
FCSB,479,1,7,5,2,24,15,9,26
CFR Cluj,479,2,6,7,1,17,8,9,25
Universitate,479,3,4,6,4,17,20,-3,18
D Bucuresti,479,4,4,4,6,19,22,-3,16
FC Botosani,479,5,4,4,6,6,13,-7,16
Concordia Ch,479,6,3,2,9,19,24,-5,11
FCSB,480,1,8,6,0,29,13,16,30
CFR Cluj,480,2,6,7,1,16,9,7,25
D Bucuresti,480,3,5,4,5,19,19,0,19
Universitate,480,4,3,5,6,15,23,-8,14
FC Botosani,480,5,3,5,6,6,14,-8,14
Concordia Ch,480,6,2,3,9,17,24,-7,9
FCSB,481,1,8,6,0,25,11,14,30
CFR Cluj,481,2,5,8,1,15,9,6,23
D Bucuresti,481,3,5,4,5,20,20,0,19
Universitate,481,4,3,6,5,15,20,-5,15
FC Botosani,481,5,3,5,6,7,15,-8,14
Concordia Ch,481,6,2,3,9,17,24,-7,9
FCSB,482,1,9,5,0,26,10,16,32
CFR Cluj,482,2,6,6,2,14,8,6,24
FC Botosani,482,3,4,5,5,8,14,-6,17
Universitate,482,4,3,5,6,14,21,-7,14
D Bucuresti,482,5,3,4,7,17,22,-5,13
Concordia Ch,482,6,3,3,8,18,22,-4,12
FCSB,483,1,8,6,0,26,12,14,30
CFR Cluj,483,2,5,7,2,15,10,5,22
Universitate,483,3,3,7,4,16,20,-4,16
D Bucuresti,483,4,3,6,5,18,20,-2,15
FC Botosani,483,5,3,5,6,5,13,-8,14
Concordia Ch,483,6,3,3,8,18,23,-5,12
FCSB,484,1,8,5,1,26,14,12,29
CFR Cluj,484,2,5,6,3,13,9,4,21
Universitate,484,3,5,5,4,19,20,-1,20
D Bucuresti,484,4,4,4,6,18,21,-3,16
Concordia Ch,484,5,4,2,8,18,21,-3,14
FC Botosani,484,6,3,4,7,6,15,-9,13
FCSB,485,1,9,5,0,28,12,16,32
CFR Cluj,485,2,6,6,2,16,9,7,24
D Bucuresti,485,3,3,6,5,16,18,-2,15
Universitate,485,4,3,5,6,16,24,-8,14
FC Botosani,485,5,3,5,6,6,14,-8,14
Concordia Ch,485,6,3,3,8,17,22,-5,12
FCSB,486,1,7,6,1,23,11,12,27
CFR Cluj,486,2,6,7,1,17,8,9,25
Universitate,486,3,4,5,5,16,22,-6,17
FC Botosani,486,4,4,5,5,6,12,-6,17
D Bucuresti,486,5,3,6,5,17,19,-2,15
Concordia Ch,486,6,2,3,9,16,23,-7,9
FCSB,487,1,8,6,0,25,11,14,30
CFR Cluj,487,2,5,7,2,14,9,5,22
Universitate,487,3,3,7,4,16,20,-4,16
D Bucuresti,487,4,3,5,6,17,20,-3,14
Concordia Ch,487,5,4,2,8,18,22,-4,14
FC Botosani,487,6,3,5,6,7,15,-8,14
FCSB,488,1,8,5,1,26,13,13,29
CFR Cluj,488,2,6,6,2,15,9,6,24
D Bucuresti,488,3,5,4,5,19,19,0,19
Universitate,488,4,4,5,5,16,20,-4,17
FC Botosani,488,5,3,4,7,7,16,-9,13
Concordia Ch,488,6,3,2,9,17,23,-6,11
CFR Cluj,489,1,7,6,1,15,7,8,27
FCSB,489,2,7,5,2,24,13,11,26
Universitate,489,3,4,5,5,16,20,-4,17
D Bucuresti,489,4,4,4,6,17,20,-3,16
FC Botosani,489,5,4,4,6,10,17,-7,16
Concordia Ch,489,6,3,2,9,20,25,-5,11
FCSB,490,1,7,7,0,25,12,13,28
CFR Cluj,490,2,6,7,1,16,9,7,25
D Bucuresti,490,3,4,4,6,18,20,-2,16
FC Botosani,490,4,4,4,6,7,14,-7,16
Universitate,490,5,3,6,5,16,21,-5,15
Concordia Ch,490,6,3,2,9,18,24,-6,11
FCSB,491,1,8,5,1,24,14,10,29
CFR Cluj,491,2,6,6,2,14,8,6,24
D Bucuresti,491,3,5,4,5,22,20,2,19
Universitate,491,4,4,5,5,18,19,-1,17
FC Botosani,491,5,3,5,6,7,16,-9,14
Concordia Ch,491,6,2,3,9,17,25,-8,9
FCSB,492,1,8,5,1,25,12,13,29
CFR Cluj,492,2,6,7,1,17,10,7,25
D Bucuresti,492,3,4,4,6,19,24,-5,16
Universitate,492,4,3,6,5,18,23,-5,15
Concordia Ch,492,5,4,2,8,22,22,0,14
FC Botosani,492,6,3,4,7,7,17,-10,13
CFR Cluj,493,1,7,6,1,15,7,8,27
FCSB,493,2,7,5,2,26,15,11,26
D Bucuresti,493,3,4,5,5,18,18,0,17
Universitate,493,4,4,5,5,18,22,-4,17
FC Botosani,493,5,3,4,7,5,15,-10,13
Concordia Ch,493,6,3,3,8,16,21,-5,12
FCSB,494,1,7,7,0,24,11,13,28
CFR Cluj,494,2,5,7,2,14,9,5,22
Universitate,494,3,4,6,4,17,20,-3,18
FC Botosani,494,4,4,4,6,6,14,-8,16
Concordia Ch,494,5,4,2,8,18,21,-3,14
D Bucuresti,494,6,3,4,7,16,20,-4,13
FCSB,495,1,7,6,1,24,12,12,27
CFR Cluj,495,2,6,7,1,16,9,7,25
Universitate,495,3,4,5,5,16,20,-4,17
FC Botosani,495,4,4,5,5,10,14,-4,17
D Bucuresti,495,5,3,5,6,19,22,-3,14
Concordia Ch,495,6,3,2,9,17,25,-8,11
FCSB,496,1,7,6,1,25,13,12,27
CFR Cluj,496,2,6,7,1,16,9,7,25
D Bucuresti,496,3,5,4,5,20,19,1,19
Universitate,496,4,3,7,4,16,20,-4,16
FC Botosani,496,5,4,4,6,8,14,-6,16
Concordia Ch,496,6,2,2,10,15,25,-10,8
FCSB,497,1,8,5,1,25,14,11,29
CFR Cluj,497,2,5,7,2,14,9,5,22
D Bucuresti,497,3,5,4,5,21,20,1,19
Universitate,497,4,4,6,4,19,20,-1,18
FC Botosani,497,5,3,4,7,7,18,-11,13
Concordia Ch,497,6,3,2,9,17,22,-5,11
FCSB,498,1,8,5,1,28,13,15,29
CFR Cluj,498,2,5,7,2,14,11,3,22
Universitate,498,3,4,6,4,18,21,-3,18
D Bucuresti,498,4,4,5,5,19,19,0,17
FC Botosani,498,5,4,4,6,6,14,-8,16
Concordia Ch,498,6,2,3,9,16,23,-7,9
FCSB,499,1,7,7,0,24,11,13,28
CFR Cluj,499,2,5,8,1,15,9,6,23
D Bucuresti,499,3,4,4,6,20,19,1,16
Universitate,499,4,3,7,4,15,19,-4,16
Concordia Ch,499,5,4,2,8,18,22,-4,14
FC Botosani,499,6,3,4,7,6,18,-12,13
FCSB,500,1,7,7,0,24,11,13,28
CFR Cluj,500,2,5,8,1,14,8,6,23
FC Botosani,500,3,5,4,5,7,12,-5,19
D Bucuresti,500,4,4,4,6,18,20,-2,16
Universitate,500,5,3,7,4,16,20,-4,16
Concordia Ch,500,6,2,2,10,16,24,-8,8
FCSB,501,1,9,5,0,29,10,19,32
CFR Cluj,501,2,5,7,2,15,12,3,22
FC Botosani,501,3,5,4,5,7,12,-5,19
Universitate,501,4,3,6,5,16,23,-7,15
D Bucuresti,501,5,3,5,6,16,19,-3,14
Concordia Ch,501,6,2,3,9,15,22,-7,9
FCSB,502,1,8,5,1,25,12,13,29
CFR Cluj,502,2,5,7,2,14,9,5,22
Universitate,502,3,4,6,4,17,20,-3,18
FC Botosani,502,4,4,5,5,7,12,-5,17
D Bucuresti,502,5,4,4,6,18,21,-3,16
Concordia Ch,502,6,2,3,9,16,23,-7,9
FCSB,503,1,8,5,1,25,12,13,29
CFR Cluj,503,2,5,6,3,14,10,4,21
Universitate,503,3,5,5,4,18,20,-2,20
FC Botosani,503,4,3,6,5,5,12,-7,15
D Bucuresti,503,5,3,5,6,16,19,-3,14
Concordia Ch,503,6,3,3,8,16,21,-5,12
FCSB,504,1,9,5,0,26,10,16,32
CFR Cluj,504,2,5,6,3,13,10,3,21
D Bucuresti,504,3,5,4,5,20,20,0,19
Universitate,504,4,4,5,5,16,20,-4,17
FC Botosani,504,5,3,4,7,6,15,-9,13
Concordia Ch,504,6,3,2,9,19,25,-6,11
FCSB,505,1,8,5,1,25,13,12,29
CFR Cluj,505,2,5,7,2,15,10,5,22
FC Botosani,505,3,5,4,5,10,14,-4,19
Universitate,505,4,4,6,4,17,19,-2,18
D Bucuresti,505,5,3,4,7,17,22,-5,13
Concordia Ch,505,6,3,2,9,17,23,-6,11
FCSB,506,1,8,6,0,26,10,16,30
CFR Cluj,506,2,6,6,2,17,13,4,24
FC Botosani,506,3,4,5,5,6,12,-6,17
D Bucuresti,506,4,3,6,5,17,19,-2,15
Universitate,506,5,3,6,5,17,22,-5,15
Concordia Ch,506,6,2,3,9,16,23,-7,9
FCSB,507,1,9,5,0,26,11,15,32
CFR Cluj,507,2,6,6,2,17,10,7,24
D Bucuresti,507,3,4,4,6,19,21,-2,16
FC Botosani,507,4,4,4,6,9,18,-9,16
Universitate,507,5,3,5,6,15,22,-7,14
Concordia Ch,507,6,3,2,9,20,24,-4,11
FCSB,508,1,9,5,0,30,12,18,32
CFR Cluj,508,2,5,7,2,14,10,4,22
FC Botosani,508,3,4,5,5,7,12,-5,17
Universitate,508,4,3,6,5,15,22,-7,15
D Bucuresti,508,5,3,5,6,17,21,-4,14
Concordia Ch,508,6,2,4,8,16,22,-6,10
FCSB,509,1,7,6,1,25,13,12,27
CFR Cluj,509,2,6,6,2,14,9,5,24
Universitate,509,3,4,6,4,18,20,-2,18
FC Botosani,509,4,4,4,6,12,16,-4,16
Concordia Ch,509,5,4,2,8,19,22,-3,14
D Bucuresti,509,6,3,4,7,18,26,-8,13
FCSB,510,1,8,6,0,26,12,14,30
CFR Cluj,510,2,5,7,2,16,11,5,22
Universitate,510,3,4,5,5,16,20,-4,17
D Bucuresti,510,4,4,4,6,19,20,-1,16
FC Botosani,510,5,4,4,6,9,16,-7,16
Concordia Ch,510,6,3,2,9,17,24,-7,11
FCSB,511,1,8,5,1,25,14,11,29
CFR Cluj,511,2,6,6,2,15,9,6,24
Universitate,511,3,4,5,5,19,21,-2,17
D Bucuresti,511,4,4,4,6,18,19,-1,16
FC Botosani,511,5,3,5,6,5,14,-9,14
Concordia Ch,511,6,3,3,8,16,21,-5,12
FCSB,512,1,8,6,0,25,10,15,30
CFR Cluj,512,2,5,7,2,13,9,4,22
FC Botosani,512,3,4,5,5,8,14,-6,17
Universitate,512,4,3,7,4,14,18,-4,16
D Bucuresti,512,5,3,6,5,19,21,-2,15
Concordia Ch,512,6,2,3,9,18,25,-7,9
FCSB,513,1,8,5,1,25,11,14,29
CFR Cluj,513,2,6,6,2,14,9,5,24
D Bucuresti,513,3,4,5,5,19,20,-1,17
FC Botosani,513,4,4,5,5,10,13,-3,17
Universitate,513,5,4,5,5,15,19,-4,17
Concordia Ch,513,6,2,2,10,16,27,-11,8
FCSB,514,1,8,5,1,25,12,13,29
CFR Cluj,514,2,6,6,2,15,8,7,24
Universitate,514,3,4,5,5,16,21,-5,17
D Bucuresti,514,4,4,4,6,17,19,-2,16
FC Botosani,514,5,4,4,6,7,14,-7,16
Concordia Ch,514,6,3,2,9,17,23,-6,11
FCSB,515,1,8,5,1,25,12,13,29
CFR Cluj,515,2,6,6,2,16,9,7,24
Universitate,515,3,4,5,5,16,21,-5,17
FC Botosani,515,4,4,5,5,7,13,-6,17
D Bucuresti,515,5,3,4,7,18,23,-5,13
Concordia Ch,515,6,3,3,8,18,22,-4,12
FCSB,516,1,8,5,1,26,11,15,29
CFR Cluj,516,2,6,6,2,15,10,5,24
D Bucuresti,516,3,4,5,5,19,19,0,17
Universitate,516,4,4,5,5,15,20,-5,17
FC Botosani,516,5,4,5,5,7,12,-5,17
Concordia Ch,516,6,2,2,10,16,26,-10,8
FCSB,517,1,8,5,1,25,15,10,29
CFR Cluj,517,2,6,6,2,15,9,6,24
Universitate,517,3,4,5,5,18,19,-1,17
FC Botosani,517,4,4,4,6,9,16,-7,16
Concordia Ch,517,5,4,2,8,20,22,-2,14
D Bucuresti,517,6,3,4,7,17,23,-6,13
FCSB,518,1,7,5,2,24,14,10,26
CFR Cluj,518,2,6,6,2,15,9,6,24
Universitate,518,3,5,5,4,19,20,-1,20
D Bucuresti,518,4,4,4,6,18,21,-3,16
Concordia Ch,518,5,4,2,8,19,22,-3,14
FC Botosani,518,6,3,4,7,5,14,-9,13
FCSB,519,1,8,5,1,26,11,15,29
CFR Cluj,519,2,6,6,2,14,9,5,24
Universitate,519,3,4,5,5,16,21,-5,17
FC Botosani,519,4,4,5,5,7,13,-6,17
D Bucuresti,519,5,3,5,6,17,21,-4,14
Concordia Ch,519,6,3,2,9,17,22,-5,11
FCSB,520,1,9,5,0,27,10,17,32
CFR Cluj,520,2,5,6,3,13,10,3,21
Universitate,520,3,4,5,5,15,20,-5,17
D Bucuresti,520,4,4,4,6,17,19,-2,16
FC Botosani,520,5,4,4,6,7,13,-6,16
Concordia Ch,520,6,3,2,9,16,23,-7,11
FCSB,521,1,7,6,1,25,13,12,27
CFR Cluj,521,2,6,7,1,15,8,7,25
Universitate,521,3,4,5,5,18,22,-4,17
FC Botosani,521,4,4,4,6,6,13,-7,16
Concordia Ch,521,5,4,2,8,19,23,-4,14
D Bucuresti,521,6,3,4,7,18,22,-4,13
FCSB,522,1,7,6,1,27,15,12,27
CFR Cluj,522,2,6,7,1,19,12,7,25
Universitate,522,3,4,5,5,16,20,-4,17
FC Botosani,522,4,4,5,5,8,12,-4,17
D Bucuresti,522,5,4,4,6,18,21,-3,16
Concordia Ch,522,6,2,3,9,15,23,-8,9
FCSB,523,1,9,5,0,28,11,17,32
CFR Cluj,523,2,6,6,2,14,8,6,24
D Bucuresti,523,3,4,4,6,18,21,-3,16
FC Botosani,523,4,4,4,6,7,14,-7,16
Universitate,523,5,3,5,6,15,23,-8,14
Concordia Ch,523,6,3,2,9,17,22,-5,11
FCSB,524,1,9,5,0,30,12,18,32
CFR Cluj,524,2,6,6,2,17,11,6,24
D Bucuresti,524,3,3,6,5,18,20,-2,15
Universitate,524,4,3,5,6,16,25,-9,14
FC Botosani,524,5,3,5,6,5,14,-9,14
Concordia Ch,524,6,3,3,8,19,23,-4,12
FCSB,525,1,8,5,1,25,12,13,29
CFR Cluj,525,2,6,6,2,14,9,5,24
Universitate,525,3,4,5,5,17,20,-3,17
D Bucuresti,525,4,4,4,6,17,20,-3,16
FC Botosani,525,5,4,4,6,7,14,-7,16
Concordia Ch,525,6,3,2,9,18,23,-5,11
CFR Cluj,526,1,7,6,1,16,7,9,27
FCSB,526,2,7,5,2,23,13,10,26
FC Botosani,526,3,5,4,5,8,12,-4,19
Universitate,526,4,4,5,5,15,19,-4,17
D Bucuresti,526,5,4,4,6,18,19,-1,16
Concordia Ch,526,6,2,2,10,15,25,-10,8
FCSB,527,1,8,6,0,26,11,15,30
CFR Cluj,527,2,5,7,2,14,10,4,22
D Bucuresti,527,3,4,4,6,18,21,-3,16
Universitate,527,4,3,7,4,16,20,-4,16
Concordia Ch,527,5,4,2,8,20,23,-3,14
FC Botosani,527,6,3,4,7,6,15,-9,13
FCSB,528,1,8,5,1,26,12,14,29
CFR Cluj,528,2,7,6,1,17,9,8,27
D Bucuresti,528,3,4,4,6,19,22,-3,16
Concordia Ch,528,4,4,2,8,22,22,0,14
Universitate,528,5,3,5,6,17,24,-7,14
FC Botosani,528,6,3,4,7,6,18,-12,13
FCSB,529,1,9,5,0,29,14,15,32
CFR Cluj,529,2,5,7,2,17,12,5,22
FC Botosani,529,3,4,4,6,6,14,-8,16
Universitate,529,4,3,6,5,18,23,-5,15
Concordia Ch,529,5,4,2,8,19,22,-3,14
D Bucuresti,529,6,3,4,7,17,21,-4,13
FCSB,530,1,8,6,0,26,12,14,30
CFR Cluj,530,2,6,6,2,17,9,8,24
D Bucuresti,530,3,5,4,5,19,18,1,19
FC Botosani,530,4,4,4,6,8,14,-6,16
Universitate,530,5,3,6,5,15,22,-7,15
Concordia Ch,530,6,2,2,10,16,26,-10,8
FCSB,531,1,8,5,1,27,13,14,29
CFR Cluj,531,2,6,6,2,15,9,6,24
Universitate,531,3,4,5,5,16,21,-5,17
FC Botosani,531,4,4,5,5,6,12,-6,17
D Bucuresti,531,5,3,5,6,17,20,-3,14
Concordia Ch,531,6,3,2,9,17,23,-6,11
FCSB,532,1,9,5,0,25,10,15,32
CFR Cluj,532,2,6,6,2,14,8,6,24
D Bucuresti,532,3,4,4,6,18,20,-2,16
Concordia Ch,532,4,4,2,8,19,22,-3,14
Universitate,532,5,3,5,6,14,20,-6,14
FC Botosani,532,6,3,4,7,7,17,-10,13
FCSB,533,1,8,5,1,28,12,16,29
CFR Cluj,533,2,6,7,1,16,9,7,25
D Bucuresti,533,3,4,5,5,19,19,0,17
FC Botosani,533,4,3,6,5,7,14,-7,15
Universitate,533,5,3,6,5,15,23,-8,15
Concordia Ch,533,6,2,3,9,16,24,-8,9
FCSB,534,1,8,5,1,26,12,14,29
CFR Cluj,534,2,7,6,1,16,8,8,27
FC Botosani,534,3,3,6,5,5,12,-7,15
D Bucuresti,534,4,3,5,6,16,20,-4,14
Universitate,534,5,3,5,6,14,21,-7,14
Concordia Ch,534,6,3,3,8,17,21,-4,12
FCSB,535,1,9,5,0,31,10,21,32
CFR Cluj,535,2,5,6,3,14,13,1,21
FC Botosani,535,3,4,5,5,8,13,-5,17
Universitate,535,4,4,5,5,16,23,-7,17
D Bucuresti,535,5,3,6,5,20,22,-2,15
Concordia Ch,535,6,2,3,9,18,26,-8,9
FCSB,536,1,8,5,1,27,12,15,29
CFR Cluj,536,2,5,7,2,13,10,3,22
Universitate,536,3,4,6,4,16,19,-3,18
D Bucuresti,536,4,4,4,6,17,19,-2,16
FC Botosani,536,5,3,5,6,7,15,-8,14
Concordia Ch,536,6,3,3,8,18,23,-5,12
FCSB,537,1,8,6,0,26,11,15,30
CFR Cluj,537,2,5,8,1,14,8,6,23
FC Botosani,537,3,4,5,5,7,12,-5,17
D Bucuresti,537,4,3,6,5,17,19,-2,15
Universitate,537,5,3,6,5,14,20,-6,15
Concordia Ch,537,6,2,3,9,16,24,-8,9
FCSB,538,1,7,6,1,26,15,11,27
CFR Cluj,538,2,5,8,1,14,8,6,23
Universitate,538,3,4,6,4,18,20,-2,18
D Bucuresti,538,4,4,4,6,18,20,-2,16
FC Botosani,538,5,3,5,6,6,14,-8,14
Concordia Ch,538,6,3,3,8,16,21,-5,12
FCSB,539,1,9,5,0,27,10,17,32
CFR Cluj,539,2,6,6,2,15,9,6,24
D Bucuresti,539,3,5,4,5,23,19,4,19
FC Botosani,539,4,4,4,6,7,17,-10,16
Universitate,539,5,3,5,6,14,22,-8,14
Concordia Ch,539,6,2,2,10,17,26,-9,8
FCSB,540,1,8,5,1,25,13,12,29
CFR Cluj,540,2,6,6,2,15,9,6,24
Universitate,540,3,4,5,5,16,19,-3,17
D Bucuresti,540,4,4,4,6,19,21,-2,16
FC Botosani,540,5,4,4,6,7,15,-8,16
Concordia Ch,540,6,3,2,9,18,23,-5,11
FCSB,541,1,8,6,0,26,12,14,30
CFR Cluj,541,2,6,6,2,16,10,6,24
FC Botosani,541,3,5,4,5,9,12,-3,19
D Bucuresti,541,4,4,4,6,17,19,-2,16
Universitate,541,5,3,6,5,16,21,-5,15
Concordia Ch,541,6,2,2,10,15,25,-10,8
FCSB,542,1,9,5,0,28,12,16,32
CFR Cluj,542,2,5,6,3,14,11,3,21
Universitate,542,3,4,5,5,16,20,-4,17
FC Botosani,542,4,3,6,5,7,14,-7,15
D Bucuresti,542,5,3,5,6,17,20,-3,14
Concordia Ch,542,6,3,3,8,17,22,-5,12
FCSB,543,1,9,5,0,31,11,20,32
CFR Cluj,543,2,6,6,2,17,11,6,24
D Bucuresti,543,3,4,4,6,19,20,-1,16
FC Botosani,543,4,4,4,6,7,15,-8,16
Universitate,543,5,3,5,6,15,26,-11,14
Concordia Ch,543,6,3,2,9,16,22,-6,11
FCSB,544,1,7,6,1,23,11,12,27
CFR Cluj,544,2,6,6,2,16,10,6,24
D Bucuresti,544,3,5,4,5,20,20,0,19
Universitate,544,4,4,6,4,17,20,-3,18
FC Botosani,544,5,4,4,6,11,15,-4,16
Concordia Ch,544,6,2,2,10,19,30,-11,8
FCSB,545,1,9,5,0,29,11,18,32
CFR Cluj,545,2,6,6,2,18,11,7,24
D Bucuresti,545,3,4,5,5,18,18,0,17
FC Botosani,545,4,3,5,6,6,15,-9,14
Universitate,545,5,3,5,6,15,25,-10,14
Concordia Ch,545,6,2,4,8,16,22,-6,10
FCSB,546,1,7,7,0,23,10,13,28
CFR Cluj,546,2,5,8,1,14,8,6,23
D Bucuresti,546,3,4,4,6,20,22,-2,16
Universitate,546,4,3,7,4,15,19,-4,16
FC Botosani,546,5,3,5,6,8,17,-9,14
Concordia Ch,546,6,3,3,8,18,22,-4,12
FCSB,547,1,9,5,0,26,10,16,32
CFR Cluj,547,2,6,6,2,15,8,7,24
D Bucuresti,547,3,4,5,5,17,18,-1,17
Universitate,547,4,3,5,6,14,22,-8,14
FC Botosani,547,5,3,4,7,6,15,-9,13
Concordia Ch,547,6,3,3,8,17,22,-5,12
FCSB,548,1,7,7,0,25,12,13,28
CFR Cluj,548,2,6,7,1,15,7,8,25
FC Botosani,548,3,4,5,5,6,12,-6,17
Universitate,548,4,3,6,5,16,22,-6,15
D Bucuresti,548,5,3,5,6,16,19,-3,14
Concordia Ch,548,6,3,2,9,16,22,-6,11
FCSB,549,1,7,6,1,25,13,12,27
CFR Cluj,549,2,5,7,2,13,10,3,22
Universitate,549,3,5,5,4,20,20,0,20
FC Botosani,549,4,4,5,5,9,13,-4,17
D Bucuresti,549,5,3,5,6,17,20,-3,14
Concordia Ch,549,6,3,2,9,16,24,-8,11
FCSB,550,1,7,6,1,26,14,12,27
CFR Cluj,550,2,7,6,1,17,8,9,27
FC Botosani,550,3,4,5,5,9,14,-5,17
D Bucuresti,550,4,3,6,5,20,22,-2,15
Universitate,550,5,3,6,5,16,22,-6,15
Concordia Ch,550,6,2,3,9,19,27,-8,9
FCSB,551,1,8,5,1,28,15,13,29
CFR Cluj,551,2,6,6,2,15,10,5,24
D Bucuresti,551,3,4,5,5,18,18,0,17
Universitate,551,4,4,5,5,18,21,-3,17
FC Botosani,551,5,3,5,6,8,16,-8,14
Concordia Ch,551,6,3,2,9,19,26,-7,11
FCSB,552,1,9,5,0,25,10,15,32
CFR Cluj,552,2,6,6,2,15,9,6,24
D Bucuresti,552,3,4,5,5,19,20,-1,17
Universitate,552,4,3,5,6,15,21,-6,14
FC Botosani,552,5,3,5,6,7,15,-8,14
Concordia Ch,552,6,3,2,9,16,22,-6,11
CFR Cluj,553,1,7,6,1,17,9,8,27
FCSB,553,2,7,5,2,26,15,11,26
D Bucuresti,553,3,5,4,5,20,19,1,19
Universitate,553,4,4,5,5,16,20,-4,17
FC Botosani,553,5,4,4,6,7,14,-7,16
Concordia Ch,553,6,2,2,10,15,24,-9,8
FCSB,554,1,8,5,1,24,12,12,29
CFR Cluj,554,2,5,6,3,13,9,4,21
Universitate,554,3,5,5,4,17,18,-1,20
D Bucuresti,554,4,3,6,5,18,20,-2,15
FC Botosani,554,5,3,5,6,7,16,-9,14
Concordia Ch,554,6,3,3,8,19,23,-4,12
FCSB,555,1,7,5,2,24,14,10,26
CFR Cluj,555,2,6,6,2,16,10,6,24
Universitate,555,3,5,5,4,18,19,-1,20
FC Botosani,555,4,5,4,5,9,13,-4,19
D Bucuresti,555,5,4,4,6,20,19,1,16
Concordia Ch,555,6,2,2,10,16,28,-12,8
FCSB,556,1,7,5,2,23,15,8,26
CFR Cluj,556,2,6,7,1,16,8,8,25
D Bucuresti,556,3,5,4,5,20,18,2,19
Universitate,556,4,4,6,4,18,19,-1,18
FC Botosani,556,5,4,4,6,6,14,-8,16
Concordia Ch,556,6,2,2,10,15,24,-9,8
FCSB,557,1,9,5,0,26,11,15,32
CFR Cluj,557,2,5,6,3,14,10,4,21
Universitate,557,3,4,5,5,15,19,-4,17
FC Botosani,557,4,4,5,5,8,13,-5,17
D Bucuresti,557,5,4,4,6,19,20,-1,16
Concordia Ch,557,6,2,3,9,16,25,-9,9
FCSB,558,1,9,5,0,26,11,15,32
CFR Cluj,558,2,6,6,2,18,9,9,24
FC Botosani,558,3,4,5,5,8,14,-6,17
Universitate,558,4,3,5,6,16,25,-9,14
D Bucuresti,558,5,3,4,7,19,23,-4,13
Concordia Ch,558,6,3,3,8,19,24,-5,12
FCSB,559,1,8,5,1,24,12,12,29
CFR Cluj,559,2,5,7,2,13,8,5,22
Universitate,559,3,4,6,4,16,18,-2,18
FC Botosani,559,4,4,5,5,6,12,-6,17
D Bucuresti,559,5,3,6,5,18,20,-2,15
Concordia Ch,559,6,2,3,9,17,24,-7,9
FCSB,560,1,8,5,1,26,13,13,29
CFR Cluj,560,2,7,6,1,18,9,9,27
D Bucuresti,560,3,3,6,5,17,19,-2,15
FC Botosani,560,4,3,6,5,6,13,-7,15
Universitate,560,5,3,5,6,14,21,-7,14
Concordia Ch,560,6,2,4,8,17,23,-6,10
FCSB,561,1,9,5,0,27,11,16,32
CFR Cluj,561,2,5,6,3,14,11,3,21
Universitate,561,3,4,5,5,17,21,-4,17
FC Botosani,561,4,4,5,5,6,12,-6,17
D Bucuresti,561,5,3,6,5,19,21,-2,15
Concordia Ch,561,6,2,3,9,18,25,-7,9
FCSB,562,1,9,5,0,26,10,16,32
CFR Cluj,562,2,5,6,3,14,11,3,21
D Bucuresti,562,3,5,4,5,24,19,5,19
Universitate,562,4,4,5,5,16,20,-4,17
FC Botosani,562,5,4,4,6,8,14,-6,16
Concordia Ch,562,6,2,2,10,15,29,-14,8
FCSB,563,1,7,5,2,24,14,10,26
CFR Cluj,563,2,6,7,1,16,8,8,25
Universitate,563,3,4,6,4,17,20,-3,18
D Bucuresti,563,4,4,5,5,19,20,-1,17
FC Botosani,563,5,4,4,6,9,14,-5,16
Concordia Ch,563,6,2,3,9,16,25,-9,9
FCSB,564,1,8,6,0,28,13,15,30
CFR Cluj,564,2,6,6,2,17,11,6,24
D Bucuresti,564,3,3,6,5,18,20,-2,15
Universitate,564,4,3,6,5,17,23,-6,15
FC Botosani,564,5,3,5,6,5,13,-8,14
Concordia Ch,564,6,3,3,8,18,23,-5,12
FCSB,565,1,7,6,1,23,11,12,27
CFR Cluj,565,2,7,6,1,16,8,8,27
D Bucuresti,565,3,4,4,6,18,19,-1,16
FC Botosani,565,4,4,4,6,6,14,-8,16
Universitate,565,5,3,6,5,15,20,-5,15
Concordia Ch,565,6,3,2,9,16,22,-6,11
FCSB,566,1,8,6,0,27,12,15,30
CFR Cluj,566,2,5,7,2,15,10,5,22
Universitate,566,3,4,5,5,17,22,-5,17
D Bucuresti,566,4,4,4,6,20,20,0,16
Concordia Ch,566,5,4,2,8,18,21,-3,14
FC Botosani,566,6,3,4,7,5,17,-12,13
FCSB,567,1,8,5,1,25,11,14,29
CFR Cluj,567,2,5,6,3,13,10,3,21
Universitate,567,3,5,5,4,16,18,-2,20
D Bucuresti,567,4,4,4,6,17,19,-2,16
Concordia Ch,567,5,4,2,8,19,22,-3,14
FC Botosani,567,6,3,4,7,6,16,-10,13
FCSB,568,1,7,6,1,26,15,11,27
CFR Cluj,568,2,6,7,1,17,9,8,25
Universitate,568,3,4,5,5,19,23,-4,17
D Bucuresti,568,4,3,6,5,18,20,-2,15
FC Botosani,568,5,3,6,5,6,13,-7,15
Concordia Ch,568,6,2,4,8,18,24,-6,10
FCSB,569,1,8,6,0,26,11,15,30
CFR Cluj,569,2,6,7,1,15,8,7,25
D Bucuresti,569,3,4,4,6,20,22,-2,16
FC Botosani,569,4,4,4,6,8,14,-6,16
Universitate,569,5,3,5,6,16,23,-7,14
Concordia Ch,569,6,3,2,9,17,24,-7,11
FCSB,570,1,8,5,1,25,11,14,29
CFR Cluj,570,2,7,6,1,15,7,8,27
D Bucuresti,570,3,4,4,6,18,20,-2,16
Universitate,570,4,3,5,6,14,21,-7,14
FC Botosani,570,5,3,5,6,6,14,-8,14
Concordia Ch,570,6,3,3,8,18,23,-5,12
FCSB,571,1,9,5,0,28,12,16,32
CFR Cluj,571,2,6,6,2,15,9,6,24
D Bucuresti,571,3,5,4,5,19,18,1,19
Universitate,571,4,3,5,6,15,22,-7,14
FC Botosani,571,5,3,5,6,6,14,-8,14
Concordia Ch,571,6,2,3,9,16,24,-8,9
FCSB,572,1,9,5,0,27,11,16,32
CFR Cluj,572,2,5,6,3,13,12,1,21
Universitate,572,3,4,5,5,18,20,-2,17
FC Botosani,572,4,4,5,5,7,13,-6,17
D Bucuresti,572,5,3,5,6,19,22,-3,14
Concordia Ch,572,6,2,4,8,17,23,-6,10
FCSB,573,1,9,5,0,26,10,16,32
CFR Cluj,573,2,5,6,3,13,12,1,21
D Bucuresti,573,3,4,5,5,20,20,0,17
Universitate,573,4,4,5,5,17,19,-2,17
FC Botosani,573,5,3,4,7,6,16,-10,13
Concordia Ch,573,6,3,3,8,17,22,-5,12
FCSB,574,1,8,5,1,25,12,13,29
CFR Cluj,574,2,6,6,2,16,10,6,24
Universitate,574,3,4,5,5,16,20,-4,17
D Bucuresti,574,4,4,4,6,19,23,-4,16
FC Botosani,574,5,4,4,6,8,14,-6,16
Concordia Ch,574,6,3,2,9,19,24,-5,11
FCSB,575,1,8,5,1,24,11,13,29
CFR Cluj,575,2,5,7,2,13,8,5,22
Universitate,575,3,4,6,4,15,18,-3,18
D Bucuresti,575,4,3,6,5,19,21,-2,15
FC Botosani,575,5,3,6,5,8,15,-7,15
Concordia Ch,575,6,2,4,8,17,23,-6,10
FCSB,576,1,9,5,0,28,11,17,32
CFR Cluj,576,2,6,6,2,14,9,5,24
D Bucuresti,576,3,5,4,5,23,21,2,19
Universitate,576,4,3,5,6,15,22,-7,14
FC Botosani,576,5,3,4,7,8,18,-10,13
Concordia Ch,576,6,3,2,9,18,25,-7,11
FCSB,577,1,8,6,0,24,10,14,30
CFR Cluj,577,2,5,7,2,13,8,5,22
FC Botosani,577,3,5,4,5,8,12,-4,19
Universitate,577,4,3,7,4,14,18,-4,16
D Bucuresti,577,5,3,5,6,17,20,-3,14
Concordia Ch,577,6,2,3,9,16,24,-8,9
CFR Cluj,578,1,7,6,1,18,10,8,27
FCSB,578,2,7,5,2,26,15,11,26
Universitate,578,3,4,5,5,19,23,-4,17
D Bucuresti,578,4,4,4,6,19,21,-2,16
Concordia Ch,578,5,4,2,8,18,21,-3,14
FC Botosani,578,6,3,4,7,6,16,-10,13
FCSB,579,1,9,5,0,28,12,16,32
CFR Cluj,579,2,6,6,2,18,9,9,24
D Bucuresti,579,3,4,5,5,18,18,0,17
Universitate,579,4,3,5,6,15,25,-10,14
FC Botosani,579,5,3,4,7,5,15,-10,13
Concordia Ch,579,6,3,3,8,16,21,-5,12
FCSB,580,1,9,5,0,29,11,18,32
CFR Cluj,580,2,6,6,2,18,11,7,24
D Bucuresti,580,3,4,4,6,20,22,-2,16
FC Botosani,580,4,4,4,6,8,15,-7,16
Universitate,580,5,3,5,6,16,26,-10,14
Concordia Ch,580,6,3,2,9,17,23,-6,11
FCSB,581,1,8,5,1,25,12,13,29
CFR Cluj,581,2,7,6,1,16,8,8,27
D Bucuresti,581,3,4,4,6,17,20,-3,16
Concordia Ch,581,4,4,2,8,19,22,-3,14
Universitate,581,5,3,5,6,16,22,-6,14
FC Botosani,581,6,3,4,7,6,15,-9,13
CFR Cluj,582,1,7,6,1,16,7,9,27
FCSB,582,2,7,5,2,25,14,11,26
FC Botosani,582,3,5,4,5,9,13,-4,19
Universitate,582,4,4,5,5,17,22,-5,17
D Bucuresti,582,5,4,4,6,18,20,-2,16
Concordia Ch,582,6,2,2,10,15,24,-9,8
FCSB,583,1,7,6,1,25,13,12,27
CFR Cluj,583,2,7,6,1,18,9,9,27
D Bucuresti,583,3,5,4,5,20,18,2,19
FC Botosani,583,4,4,4,6,7,16,-9,16
Universitate,583,5,3,6,5,16,22,-6,15
Concordia Ch,583,6,2,2,10,16,24,-8,8
CFR Cluj,584,1,7,6,1,15,7,8,27
FCSB,584,2,7,5,2,23,13,10,26
Universitate,584,3,4,5,5,16,19,-3,17
FC Botosani,584,4,4,5,5,8,14,-6,17
D Bucuresti,584,5,3,5,6,18,21,-3,14
Concordia Ch,584,6,2,4,8,17,23,-6,10
FCSB,585,1,9,5,0,28,10,18,32
CFR Cluj,585,2,6,6,2,20,11,9,24
FC Botosani,585,3,4,5,5,7,13,-6,17
Universitate,585,4,3,5,6,15,27,-12,14
D Bucuresti,585,5,3,4,7,17,21,-4,13
Concordia Ch,585,6,3,3,8,18,23,-5,12
FCSB,586,1,8,5,1,25,14,11,29
CFR Cluj,586,2,5,7,2,15,10,5,22
Universitate,586,3,4,6,4,20,21,-1,18
D Bucuresti,586,4,4,4,6,21,22,-1,16
FC Botosani,586,5,3,5,6,8,18,-10,14
Concordia Ch,586,6,3,3,8,20,24,-4,12
FCSB,587,1,8,5,1,28,16,12,29
CFR Cluj,587,2,7,6,1,20,10,10,27
D Bucuresti,587,3,4,4,6,19,22,-3,16
Concordia Ch,587,4,4,2,8,19,22,-3,14
Universitate,587,5,3,5,6,14,21,-7,14
FC Botosani,587,6,3,4,7,6,15,-9,13
FCSB,588,1,8,6,0,25,11,14,30
CFR Cluj,588,2,5,7,2,15,10,5,22
D Bucuresti,588,3,4,5,5,20,18,2,17
Universitate,588,4,3,7,4,15,19,-4,16
FC Botosani,588,5,4,4,6,8,18,-10,16
Concordia Ch,588,6,2,3,9,17,24,-7,9
FCSB,589,1,8,6,0,25,10,15,30
CFR Cluj,589,2,5,8,1,14,8,6,23
FC Botosani,589,3,4,4,6,6,15,-9,16
Universitate,589,4,3,6,5,15,21,-6,15
D Bucuresti,589,5,3,5,6,16,19,-3,14
Concordia Ch,589,6,3,3,8,18,21,-3,12
FCSB,590,1,8,6,0,26,11,15,30
CFR Cluj,590,2,5,6,3,15,12,3,21
Universitate,590,3,4,6,4,16,19,-3,18
D Bucuresti,590,4,3,6,5,20,22,-2,15
FC Botosani,590,5,3,5,6,6,14,-8,14
Concordia Ch,590,6,3,3,8,19,24,-5,12
FCSB,591,1,8,5,1,24,12,12,29
CFR Cluj,591,2,6,6,2,16,9,7,24
Universitate,591,3,4,5,5,17,21,-4,17
D Bucuresti,591,4,4,4,6,22,22,0,16
FC Botosani,591,5,3,5,6,6,16,-10,14
Concordia Ch,591,6,3,3,8,18,23,-5,12
FCSB,592,1,7,6,1,23,12,11,27
CFR Cluj,592,2,6,7,1,14,7,7,25
D Bucuresti,592,3,5,4,5,21,20,1,19
Universitate,592,4,4,5,5,16,19,-3,17
FC Botosani,592,5,4,4,6,8,14,-6,16
Concordia Ch,592,6,2,2,10,16,26,-10,8
FCSB,593,1,8,5,1,26,13,13,29
CFR Cluj,593,2,7,6,1,17,9,8,27
D Bucuresti,593,3,4,4,6,20,19,1,16
Concordia Ch,593,4,4,2,8,18,22,-4,14
Universitate,593,5,3,5,6,16,22,-6,14
FC Botosani,593,6,3,4,7,6,18,-12,13
FCSB,594,1,8,5,1,26,13,13,29
CFR Cluj,594,2,5,7,2,16,12,4,22
Universitate,594,3,4,6,4,18,20,-2,18
FC Botosani,594,4,4,5,5,7,12,-5,17
D Bucuresti,594,5,3,5,6,17,20,-3,14
Concordia Ch,594,6,3,2,9,17,24,-7,11
FCSB,595,1,8,6,0,25,11,14,30
CFR Cluj,595,2,6,6,2,16,8,8,24
FC Botosani,595,3,5,4,5,9,13,-4,19
Universitate,595,4,3,6,5,15,22,-7,15
D Bucuresti,595,5,3,4,7,17,21,-4,13
Concordia Ch,595,6,3,2,9,16,23,-7,11
FCSB,596,1,7,6,1,26,14,12,27
CFR Cluj,596,2,6,7,1,15,8,7,25
D Bucuresti,596,3,5,4,5,19,19,0,19
Universitate,596,4,3,7,4,16,20,-4,16
FC Botosani,596,5,3,5,6,6,14,-8,14
Concordia Ch,596,6,2,3,9,17,24,-7,9
FCSB,597,1,7,7,0,24,11,13,28
CFR Cluj,597,2,5,8,1,14,8,6,23
D Bucuresti,597,3,4,4,6,19,20,-1,16
Universitate,597,4,3,7,4,16,20,-4,16
FC Botosani,597,5,4,4,6,6,14,-8,16
Concordia Ch,597,6,3,2,9,17,23,-6,11
FCSB,598,1,8,5,1,24,14,10,29
CFR Cluj,598,2,5,7,2,13,8,5,22
Universitate,598,3,4,6,4,18,18,0,18
D Bucuresti,598,4,4,5,5,17,18,-1,17
FC Botosani,598,5,3,4,7,5,16,-11,13
Concordia Ch,598,6,3,3,8,18,21,-3,12
FCSB,599,1,7,6,1,23,11,12,27
CFR Cluj,599,2,6,6,2,15,9,6,24
Universitate,599,3,4,6,4,16,19,-3,18
FC Botosani,599,4,4,5,5,7,13,-6,17
D Bucuresti,599,5,3,5,6,17,20,-3,14
Concordia Ch,599,6,3,2,9,16,22,-6,11
FCSB,600,1,8,5,1,26,13,13,29
CFR Cluj,600,2,5,6,3,14,11,3,21
Universitate,600,3,5,5,4,18,19,-1,20
D Bucuresti,600,4,5,4,5,20,19,1,19
FC Botosani,600,5,3,5,6,6,14,-8,14
Concordia Ch,600,6,2,3,9,17,25,-8,9
FCSB,601,1,9,5,0,27,10,17,32
CFR Cluj,601,2,6,6,2,14,9,5,24
D Bucuresti,601,3,4,5,5,19,19,0,17
FC Botosani,601,4,4,5,5,7,13,-6,17
Universitate,601,5,3,5,6,14,21,-7,14
Concordia Ch,601,6,2,2,10,15,24,-9,8
FCSB,602,1,7,6,1,24,13,11,27
CFR Cluj,602,2,5,8,1,14,8,6,23
Universitate,602,3,4,6,4,18,20,-2,18
D Bucuresti,602,4,3,5,6,18,21,-3,14
Concordia Ch,602,5,4,2,8,18,22,-4,14
FC Botosani,602,6,3,5,6,6,14,-8,14
FCSB,603,1,8,6,0,26,12,14,30
CFR Cluj,603,2,6,7,1,15,8,7,25
FC Botosani,603,3,4,5,5,9,15,-6,17
D Bucuresti,603,4,4,4,6,21,23,-2,16
Universitate,603,5,3,5,6,15,21,-6,14
Concordia Ch,603,6,2,3,9,18,25,-7,9
FCSB,604,1,8,5,1,26,13,13,29
CFR Cluj,604,2,6,6,2,16,11,5,24
D Bucuresti,604,3,5,4,5,20,18,2,19
Universitate,604,4,4,5,5,16,19,-3,17
FC Botosani,604,5,3,5,6,6,15,-9,14
Concordia Ch,604,6,2,3,9,16,24,-8,9
FCSB,605,1,9,5,0,27,10,17,32
CFR Cluj,605,2,5,6,3,13,11,2,21
D Bucuresti,605,3,5,4,5,19,18,1,19
Universitate,605,4,4,5,5,15,19,-4,17
FC Botosani,605,5,4,4,6,7,14,-7,16
Concordia Ch,605,6,2,2,10,15,24,-9,8
CFR Cluj,606,1,7,6,1,18,8,10,27
FCSB,606,2,7,5,2,25,17,8,26
Universitate,606,3,4,5,5,18,21,-3,17
FC Botosani,606,4,4,5,5,9,13,-4,17
D Bucuresti,606,5,3,5,6,16,21,-5,14
Concordia Ch,606,6,2,4,8,16,22,-6,10
FCSB,607,1,8,6,0,25,11,14,30
CFR Cluj,607,2,6,6,2,15,8,7,24
FC Botosani,607,3,5,4,5,8,13,-5,19
D Bucuresti,607,4,4,4,6,18,20,-2,16
Universitate,607,5,3,6,5,15,21,-6,15
Concordia Ch,607,6,2,2,10,17,25,-8,8
FCSB,608,1,9,5,0,27,10,17,32
CFR Cluj,608,2,5,7,2,13,9,4,22
D Bucuresti,608,3,4,5,5,18,19,-1,17
Universitate,608,4,3,6,5,14,20,-6,15
FC Botosani,608,5,3,5,6,6,14,-8,14
Concordia Ch,608,6,3,2,9,18,24,-6,11
FCSB,609,1,9,5,0,27,10,17,32
CFR Cluj,609,2,5,7,2,13,10,3,22
FC Botosani,609,3,4,5,5,8,13,-5,17
D Bucuresti,609,4,3,6,5,17,19,-2,15
Universitate,609,5,3,6,5,14,19,-5,15
Concordia Ch,609,6,2,3,9,17,25,-8,9
FCSB,610,1,9,5,0,25,10,15,32
CFR Cluj,610,2,6,6,2,16,8,8,24
D Bucuresti,610,3,4,5,5,21,20,1,17
Universitate,610,4,3,5,6,14,22,-8,14
FC Botosani,610,5,3,5,6,6,15,-9,14
Concordia Ch,610,6,3,2,9,18,25,-7,11
FCSB,611,1,8,5,1,25,13,12,29
CFR Cluj,611,2,5,7,2,15,10,5,22
Universitate,611,3,4,6,4,17,19,-2,18
D Bucuresti,611,4,4,5,5,17,18,-1,17
FC Botosani,611,5,4,5,5,7,13,-6,17
Concordia Ch,611,6,2,2,10,16,24,-8,8
FCSB,612,1,8,6,0,30,13,17,30
CFR Cluj,612,2,5,6,3,15,14,1,21
Universitate,612,3,4,6,4,18,21,-3,18
D Bucuresti,612,4,4,4,6,18,20,-2,16
FC Botosani,612,5,3,5,6,7,15,-8,14
Concordia Ch,612,6,3,3,8,17,22,-5,12
FCSB,613,1,8,6,0,26,12,14,30
CFR Cluj,613,2,6,7,1,18,10,8,25
D Bucuresti,613,3,4,5,5,20,20,0,17
FC Botosani,613,4,4,5,5,9,14,-5,17
Universitate,613,5,3,5,6,15,22,-7,14
Concordia Ch,613,6,2,2,10,17,27,-10,8
FCSB,614,1,7,7,0,23,10,13,28
CFR Cluj,614,2,6,7,1,15,8,7,25
FC Botosani,614,3,5,4,5,7,12,-5,19
Universitate,614,4,3,6,5,15,20,-5,15
D Bucuresti,614,5,3,4,7,17,21,-4,13
Concordia Ch,614,6,3,2,9,17,23,-6,11
FCSB,615,1,8,5,1,26,13,13,29
CFR Cluj,615,2,6,6,2,15,10,5,24
D Bucuresti,615,3,5,4,5,19,19,0,19
Universitate,615,4,4,5,5,17,20,-3,17
FC Botosani,615,5,4,4,6,6,13,-7,16
Concordia Ch,615,6,2,2,10,16,24,-8,8
FCSB,616,1,8,5,1,26,13,13,29
CFR Cluj,616,2,6,7,1,18,11,7,25
D Bucuresti,616,3,4,5,5,18,19,-1,17
Universitate,616,4,3,6,5,18,23,-5,15
FC Botosani,616,5,3,6,5,7,14,-7,15
Concordia Ch,616,6,2,3,9,18,25,-7,9
FCSB,617,1,9,5,0,27,11,16,32
CFR Cluj,617,2,6,6,2,16,10,6,24
D Bucuresti,617,3,5,4,5,21,19,2,19
Universitate,617,4,3,5,6,15,22,-7,14
FC Botosani,617,5,3,4,7,6,18,-12,13
Concordia Ch,617,6,3,2,9,19,24,-5,11
FCSB,618,1,8,6,0,25,10,15,30
CFR Cluj,618,2,6,6,2,16,10,6,24
FC Botosani,618,3,4,4,6,8,14,-6,16
Universitate,618,4,3,6,5,15,21,-6,15
D Bucuresti,618,5,3,5,6,17,21,-4,14
Concordia Ch,618,6,3,3,8,16,21,-5,12
FCSB,619,1,7,6,1,25,14,11,27
CFR Cluj,619,2,5,7,2,13,8,5,22
Universitate,619,3,5,5,4,19,20,-1,20
D Bucuresti,619,4,4,5,5,19,20,-1,17
FC Botosani,619,5,4,4,6,7,13,-6,16
Concordia Ch,619,6,2,3,9,17,25,-8,9
FCSB,620,1,9,5,0,28,12,16,32
CFR Cluj,620,2,5,6,3,15,12,3,21
D Bucuresti,620,3,4,5,5,19,19,0,17
Universitate,620,4,4,5,5,18,22,-4,17
FC Botosani,620,5,4,4,6,7,14,-7,16
Concordia Ch,620,6,2,3,9,16,24,-8,9
FCSB,621,1,8,6,0,27,12,15,30
CFR Cluj,621,2,5,7,2,14,9,5,22
Universitate,621,3,4,5,5,16,21,-5,17
D Bucuresti,621,4,4,4,6,23,25,-2,16
FC Botosani,621,5,3,5,6,9,17,-8,14
Concordia Ch,621,6,3,3,8,20,25,-5,12
FCSB,622,1,8,5,1,25,12,13,29
CFR Cluj,622,2,6,6,2,14,8,6,24
D Bucuresti,622,3,4,5,5,18,19,-1,17
Universitate,622,4,4,5,5,16,20,-4,17
FC Botosani,622,5,3,5,6,5,13,-8,14
Concordia Ch,622,6,2,4,8,16,22,-6,10
FCSB,623,1,8,5,1,24,12,12,29
CFR Cluj,623,2,6,6,2,14,8,6,24
FC Botosani,623,3,5,4,5,9,13,-4,19
Universitate,623,4,4,5,5,16,19,-3,17
D Bucuresti,623,5,3,5,6,18,21,-3,14
Concordia Ch,623,6,2,3,9,16,24,-8,9
FCSB,624,1,8,5,1,25,13,12,29
CFR Cluj,624,2,5,7,2,15,10,5,22
Universitate,624,3,4,6,4,19,21,-2,18
D Bucuresti,624,4,4,5,5,20,20,0,17
FC Botosani,624,5,3,5,6,6,15,-9,14
Concordia Ch,624,6,2,4,8,18,24,-6,10
FCSB,625,1,8,6,0,26,12,14,30
CFR Cluj,625,2,5,8,1,14,8,6,23
Universitate,625,3,3,6,5,15,20,-5,15
FC Botosani,625,4,3,6,5,5,12,-7,15
D Bucuresti,625,5,3,5,6,18,21,-3,14
Concordia Ch,625,6,3,3,8,18,23,-5,12
FCSB,626,1,8,5,1,25,13,12,29
CFR Cluj,626,2,7,6,1,17,7,10,27
FC Botosani,626,3,4,5,5,8,13,-5,17
Universitate,626,4,3,5,6,14,21,-7,14
D Bucuresti,626,5,3,4,7,18,23,-5,13
Concordia Ch,626,6,3,3,8,19,24,-5,12
FCSB,627,1,9,5,0,27,11,16,32
CFR Cluj,627,2,6,6,2,18,10,8,24
FC Botosani,627,3,4,5,5,6,12,-6,17
D Bucuresti,627,4,3,5,6,16,20,-4,14
Universitate,627,5,3,5,6,14,23,-9,14
Concordia Ch,627,6,3,2,9,17,22,-5,11
FCSB,628,1,8,5,1,25,12,13,29
CFR Cluj,628,2,7,6,1,16,7,9,27
FC Botosani,628,3,4,5,5,6,12,-6,17
D Bucuresti,628,4,3,5,6,17,21,-4,14
Universitate,628,5,3,5,6,14,21,-7,14
Concordia Ch,628,6,3,2,9,18,23,-5,11
FCSB,629,1,8,5,1,26,13,13,29
CFR Cluj,629,2,5,6,3,16,13,3,21
Universitate,629,3,5,5,4,19,20,-1,20
D Bucuresti,629,4,4,5,5,19,20,-1,17
FC Botosani,629,5,3,6,5,6,13,-7,15
Concordia Ch,629,6,2,3,9,16,23,-7,9
FCSB,630,1,7,7,0,24,11,13,28
CFR Cluj,630,2,5,7,2,13,8,5,22
Universitate,630,3,4,6,4,16,19,-3,18
D Bucuresti,630,4,4,4,6,19,21,-2,16
Concordia Ch,630,5,4,2,8,19,22,-3,14
FC Botosani,630,6,3,4,7,6,16,-10,13
FCSB,631,1,8,5,1,26,12,14,29
CFR Cluj,631,2,7,6,1,16,8,8,27
D Bucuresti,631,3,4,5,5,18,19,-1,17
Universitate,631,4,3,5,6,14,21,-7,14
FC Botosani,631,5,3,5,6,8,16,-8,14
Concordia Ch,631,6,2,4,8,19,25,-6,10
FCSB,632,1,7,7,0,25,12,13,28
CFR Cluj,632,2,6,7,1,17,8,9,25
D Bucuresti,632,3,4,4,6,20,21,-1,16
Universitate,632,4,3,6,5,15,22,-7,15
FC Botosani,632,5,3,5,6,6,15,-9,14
Concordia Ch,632,6,3,3,8,19,24,-5,12
FCSB,633,1,8,5,1,25,12,13,29
CFR Cluj,633,2,6,6,2,14,8,6,24
Universitate,633,3,4,5,5,16,20,-4,17
D Bucuresti,633,4,4,4,6,20,22,-2,16
FC Botosani,633,5,4,4,6,7,16,-9,16
Concordia Ch,633,6,3,2,9,20,24,-4,11
FCSB,634,1,9,5,0,28,10,18,32
CFR Cluj,634,2,6,6,2,14,10,4,24
D Bucuresti,634,3,4,5,5,19,20,-1,17
FC Botosani,634,4,4,4,6,7,13,-6,16
Universitate,634,5,3,5,6,14,21,-7,14
Concordia Ch,634,6,2,3,9,17,25,-8,9
FCSB,635,1,9,5,0,27,11,16,32
CFR Cluj,635,2,5,7,2,13,8,5,22
D Bucuresti,635,3,4,4,6,18,20,-2,16
FC Botosani,635,4,4,4,6,8,15,-7,16
Universitate,635,5,3,6,5,15,21,-6,15
Concordia Ch,635,6,3,2,9,17,23,-6,11
FCSB,636,1,9,5,0,27,11,16,32
CFR Cluj,636,2,6,6,2,14,9,5,24
FC Botosani,636,3,4,5,5,8,13,-5,17
D Bucuresti,636,4,3,6,5,18,20,-2,15
Universitate,636,5,3,5,6,15,21,-6,14
Concordia Ch,636,6,2,3,9,16,24,-8,9
FCSB,637,1,8,5,1,25,12,13,29
CFR Cluj,637,2,5,7,2,15,10,5,22
Universitate,637,3,4,6,4,16,19,-3,18
D Bucuresti,637,4,4,4,6,19,21,-2,16
Concordia Ch,637,5,4,2,8,20,23,-3,14
FC Botosani,637,6,3,4,7,8,18,-10,13
FCSB,638,1,7,6,1,25,13,12,27
CFR Cluj,638,2,6,7,1,15,8,7,25
Universitate,638,3,4,5,5,16,20,-4,17
D Bucuresti,638,4,4,4,6,17,19,-2,16
FC Botosani,638,5,4,4,6,7,14,-7,16
Concordia Ch,638,6,3,2,9,17,23,-6,11
FCSB,639,1,7,6,1,24,12,12,27
CFR Cluj,639,2,7,6,1,17,7,10,27
D Bucuresti,639,3,4,4,6,19,21,-2,16
FC Botosani,639,4,4,4,6,8,16,-8,16
Universitate,639,5,3,6,5,15,22,-7,15
Concordia Ch,639,6,3,2,9,18,23,-5,11
FCSB,640,1,8,5,1,26,12,14,29
CFR Cluj,640,2,6,6,2,15,10,5,24
D Bucuresti,640,3,5,4,5,21,18,3,19
Universitate,640,4,4,5,5,16,20,-4,17
FC Botosani,640,5,4,4,6,7,16,-9,16
Concordia Ch,640,6,2,2,10,16,25,-9,8
FCSB,641,1,8,5,1,24,12,12,29
CFR Cluj,641,2,5,7,2,13,8,5,22
Universitate,641,3,4,6,4,16,18,-2,18
D Bucuresti,641,4,3,6,5,18,20,-2,15
FC Botosani,641,5,3,5,6,7,15,-8,14
Concordia Ch,641,6,3,3,8,18,23,-5,12
FCSB,642,1,8,6,0,26,12,14,30
CFR Cluj,642,2,6,7,1,17,8,9,25
D Bucuresti,642,3,4,5,5,21,22,-1,17
Universitate,642,4,3,5,6,15,23,-8,14
FC Botosani,642,5,3,5,6,9,18,-9,14
Concordia Ch,642,6,3,2,9,21,26,-5,11
FCSB,643,1,8,6,0,27,12,15,30
CFR Cluj,643,2,5,6,3,15,12,3,21
Universitate,643,3,4,6,4,17,20,-3,18
D Bucuresti,643,4,4,4,6,19,21,-2,16
FC Botosani,643,5,4,4,6,8,15,-7,16
Concordia Ch,643,6,3,2,9,18,24,-6,11
FCSB,644,1,8,5,1,26,14,12,29
CFR Cluj,644,2,5,7,2,15,11,4,22
Universitate,644,3,4,6,4,18,19,-1,18
D Bucuresti,644,4,4,5,5,18,19,-1,17
FC Botosani,644,5,4,5,5,7,13,-6,17
Concordia Ch,644,6,2,2,10,17,25,-8,8
FCSB,645,1,8,5,1,24,13,11,29
CFR Cluj,645,2,5,6,3,13,9,4,21
Universitate,645,3,5,5,4,18,18,0,20
D Bucuresti,645,4,5,4,5,19,19,0,19
FC Botosani,645,5,3,5,6,6,14,-8,14
Concordia Ch,645,6,2,3,9,15,22,-7,9
FCSB,646,1,7,5,2,24,15,9,26
CFR Cluj,646,2,6,6,2,16,9,7,24
Universitate,646,3,5,5,4,17,18,-1,20
FC Botosani,646,4,3,6,5,6,13,-7,15
D Bucuresti,646,5,3,5,6,17,22,-5,14
Concordia Ch,646,6,3,3,8,18,21,-3,12
FCSB,647,1,8,5,1,28,13,15,29
CFR Cluj,647,2,6,6,2,15,11,4,24
D Bucuresti,647,3,5,4,5,20,18,2,19
Universitate,647,4,4,5,5,16,20,-4,17
FC Botosani,647,5,3,4,7,5,15,-10,13
Concordia Ch,647,6,3,2,9,16,23,-7,11
FCSB,648,1,8,6,0,25,11,14,30
CFR Cluj,648,2,5,6,3,13,10,3,21
Universitate,648,3,4,6,4,17,19,-2,18
D Bucuresti,648,4,4,5,5,18,19,-1,17
FC Botosani,648,5,3,5,6,6,15,-9,14
Concordia Ch,648,6,3,2,9,17,22,-5,11
FCSB,649,1,8,5,1,25,14,11,29
CFR Cluj,649,2,7,6,1,19,7,12,27
D Bucuresti,649,3,5,4,5,18,18,0,19
Universitate,649,4,3,5,6,14,22,-8,14
FC Botosani,649,5,3,5,6,6,14,-8,14
Concordia Ch,649,6,2,3,9,16,23,-7,9
FCSB,650,1,8,6,0,26,11,15,30
CFR Cluj,650,2,6,6,2,17,10,7,24
D Bucuresti,650,3,5,4,5,21,18,3,19
Universitate,650,4,3,6,5,14,21,-7,15
FC Botosani,650,5,3,5,6,6,14,-8,14
Concordia Ch,650,6,2,3,9,16,26,-10,9
FCSB,651,1,7,5,2,23,14,9,26
CFR Cluj,651,2,6,6,2,14,8,6,24
Universitate,651,3,5,5,4,18,18,0,20
D Bucuresti,651,4,4,4,6,19,20,-1,16
FC Botosani,651,5,4,4,6,8,15,-7,16
Concordia Ch,651,6,3,2,9,16,23,-7,11
FCSB,652,1,9,5,0,27,11,16,32
CFR Cluj,652,2,6,6,2,16,9,7,24
FC Botosani,652,3,4,5,5,9,14,-5,17
D Bucuresti,652,4,3,5,6,17,21,-4,14
Universitate,652,5,3,5,6,14,22,-8,14
Concordia Ch,652,6,2,4,8,16,22,-6,10
FCSB,653,1,7,6,1,26,16,10,27
CFR Cluj,653,2,6,7,1,17,10,7,25
D Bucuresti,653,3,4,5,5,20,19,1,17
Universitate,653,4,4,5,5,19,21,-2,17
FC Botosani,653,5,3,6,5,6,13,-7,15
Concordia Ch,653,6,2,3,9,17,26,-9,9
FCSB,654,1,8,5,1,24,11,13,29
CFR Cluj,654,2,5,6,3,13,10,3,21
Universitate,654,3,5,5,4,17,18,-1,20
D Bucuresti,654,4,5,4,5,21,20,1,19
FC Botosani,654,5,4,4,6,8,15,-7,16
Concordia Ch,654,6,2,2,10,15,24,-9,8
FCSB,655,1,8,6,0,26,12,14,30
CFR Cluj,655,2,6,6,2,16,10,6,24
D Bucuresti,655,3,4,5,5,18,19,-1,17
FC Botosani,655,4,4,4,6,6,13,-7,16
Universitate,655,5,3,6,5,16,21,-5,15
Concordia Ch,655,6,2,3,9,16,23,-7,9
FCSB,656,1,7,6,1,25,14,11,27
CFR Cluj,656,2,6,7,1,17,9,8,25
Universitate,656,3,4,5,5,16,20,-4,17
D Bucuresti,656,4,4,4,6,18,20,-2,16
FC Botosani,656,5,4,4,6,9,15,-6,16
Concordia Ch,656,6,3,2,9,17,24,-7,11
FCSB,657,1,8,5,1,24,14,10,29
CFR Cluj,657,2,6,6,2,14,8,6,24
D Bucuresti,657,3,4,5,5,20,20,0,17
Universitate,657,4,4,5,5,18,19,-1,17
FC Botosani,657,5,4,4,6,7,15,-8,16
Concordia Ch,657,6,2,3,9,18,25,-7,9
FCSB,658,1,8,5,1,26,13,13,29
CFR Cluj,658,2,5,7,2,15,10,5,22
Universitate,658,3,4,6,4,17,20,-3,18
FC Botosani,658,4,4,5,5,7,13,-6,17
D Bucuresti,658,5,3,6,5,17,19,-2,15
Concordia Ch,658,6,2,3,9,17,24,-7,9
FCSB,659,1,7,6,1,27,17,10,27
CFR Cluj,659,2,5,7,2,16,11,5,22
Universitate,659,3,5,5,4,21,21,0,20
D Bucuresti,659,4,4,4,6,20,22,-2,16
Concordia Ch,659,5,4,2,8,18,22,-4,14
FC Botosani,659,6,3,4,7,7,16,-9,13
CFR Cluj,660,1,7,6,1,17,9,8,27
FCSB,660,2,7,5,2,25,14,11,26
Universitate,660,3,4,5,5,15,19,-4,17
FC Botosani,660,4,4,5,5,9,14,-5,17
D Bucuresti,660,5,3,4,7,18,24,-6,13
Concordia Ch,660,6,3,3,8,19,23,-4,12
FCSB,661,1,7,5,2,23,12,11,26
CFR Cluj,661,2,6,7,1,15,8,7,25
Universitate,661,3,4,6,4,16,19,-3,18
D Bucuresti,661,4,3,6,5,16,18,-2,15
FC Botosani,661,5,3,6,5,6,13,-7,15
Concordia Ch,661,6,2,4,8,16,22,-6,10
FCSB,662,1,7,5,2,24,14,10,26
CFR Cluj,662,2,6,7,1,16,8,8,25
Universitate,662,3,4,6,4,15,18,-3,18
FC Botosani,662,4,4,5,5,9,14,-5,17
D Bucuresti,662,5,3,5,6,16,20,-4,14
Concordia Ch,662,6,3,2,9,19,25,-6,11
FCSB,663,1,8,5,1,29,12,17,29
CFR Cluj,663,2,6,7,1,16,9,7,25
D Bucuresti,663,3,4,4,6,21,23,-2,16
Universitate,663,4,3,6,5,17,26,-9,15
FC Botosani,663,5,3,5,6,8,17,-9,14
Concordia Ch,663,6,3,3,8,19,23,-4,12
FCSB,664,1,8,5,1,25,12,13,29
CFR Cluj,664,2,7,6,1,17,8,9,27
D Bucuresti,664,3,4,4,6,18,21,-3,16
FC Botosani,664,4,4,4,6,10,14,-4,16
Universitate,664,5,3,5,6,14,21,-7,14
Concordia Ch,664,6,3,2,9,17,25,-8,11
FCSB,665,1,7,7,0,26,13,13,28
CFR Cluj,665,2,5,7,2,15,10,5,22
Universitate,665,3,4,6,4,16,19,-3,18
FC Botosani,665,4,3,6,5,7,14,-7,15
D Bucuresti,665,5,3,5,6,17,20,-3,14
Concordia Ch,665,6,3,3,8,17,22,-5,12
FCSB,666,1,8,5,1,27,14,13,29
CFR Cluj,666,2,5,6,3,13,12,1,21
Universitate,666,3,5,5,4,21,20,1,20
Concordia Ch,666,4,4,2,8,23,23,0,14
D Bucuresti,666,5,3,5,6,18,23,-5,14
FC Botosani,666,6,3,5,6,5,15,-10,14
FCSB,667,1,8,6,0,24,10,14,30
CFR Cluj,667,2,5,6,3,13,9,4,21
Universitate,667,3,4,6,4,15,18,-3,18
D Bucuresti,667,4,4,4,6,18,21,-3,16
FC Botosani,667,5,4,4,6,6,13,-7,16
Concordia Ch,667,6,3,2,9,18,23,-5,11
FCSB,668,1,8,6,0,25,11,14,30
CFR Cluj,668,2,5,7,2,14,9,5,22
Universitate,668,3,3,7,4,16,20,-4,16
D Bucuresti,668,4,3,6,5,18,20,-2,15
FC Botosani,668,5,3,5,6,7,15,-8,14
Concordia Ch,668,6,3,3,8,16,21,-5,12
FCSB,669,1,8,5,1,25,13,12,29
CFR Cluj,669,2,6,6,2,16,10,6,24
D Bucuresti,669,3,4,5,5,17,18,-1,17
Universitate,669,4,4,5,5,18,21,-3,17
FC Botosani,669,5,4,5,5,6,12,-6,17
Concordia Ch,669,6,2,2,10,15,23,-8,8
FCSB,670,1,8,6,0,25,10,15,30
CFR Cluj,670,2,6,7,1,18,8,10,25
D Bucuresti,670,3,4,5,5,18,19,-1,17
FC Botosani,670,4,4,4,6,6,13,-7,16
Universitate,670,5,3,5,6,15,25,-10,14
Concordia Ch,670,6,2,3,9,16,23,-7,9
FCSB,671,1,7,7,0,27,14,13,28
CFR Cluj,671,2,5,8,1,15,9,6,23
Universitate,671,3,3,7,4,16,20,-4,16
FC Botosani,671,4,4,4,6,8,15,-7,16
Concordia Ch,671,5,4,2,8,21,23,-2,14
D Bucuresti,671,6,3,4,7,17,23,-6,13
FCSB,672,1,9,5,0,28,11,17,32
CFR Cluj,672,2,6,6,2,14,8,6,24
D Bucuresti,672,3,5,4,5,21,20,1,19
Universitate,672,4,3,5,6,15,23,-8,14
FC Botosani,672,5,3,4,7,7,18,-11,13
Concordia Ch,672,6,3,2,9,19,24,-5,11
FCSB,673,1,7,6,1,25,13,12,27
CFR Cluj,673,2,5,8,1,16,10,6,23
Universitate,673,3,4,6,4,18,21,-3,18
FC Botosani,673,4,4,5,5,10,13,-3,17
D Bucuresti,673,5,3,6,5,17,19,-2,15
Concordia Ch,673,6,2,3,9,15,25,-10,9
FCSB,674,1,7,6,1,25,14,11,27
CFR Cluj,674,2,7,6,1,17,8,9,27
D Bucuresti,674,3,5,4,5,20,20,0,19
FC Botosani,674,4,4,4,6,6,13,-7,16
Universitate,674,5,3,6,5,17,22,-5,15
Concordia Ch,674,6,2,2,10,17,25,-8,8
FCSB,675,1,7,7,0,27,14,13,28
CFR Cluj,675,2,5,8,1,16,10,6,23
D Bucuresti,675,3,4,4,6,18,20,-2,16
Universitate,675,4,3,7,4,15,19,-4,16
FC Botosani,675,5,4,4,6,8,14,-6,16
Concordia Ch,675,6,3,2,9,18,25,-7,11
FCSB,676,1,7,5,2,27,17,10,26
CFR Cluj,676,2,6,6,2,16,10,6,24
Universitate,676,3,5,5,4,19,20,-1,20
D Bucuresti,676,4,5,4,5,22,21,1,19
FC Botosani,676,5,3,5,6,7,15,-8,14
Concordia Ch,676,6,2,3,9,16,24,-8,9
FCSB,677,1,8,5,1,27,16,11,29
CFR Cluj,677,2,6,6,2,16,12,4,24
Universitate,677,3,4,5,5,20,20,0,17
D Bucuresti,677,4,4,5,5,19,19,0,17
FC Botosani,677,5,3,6,5,7,14,-7,15
Concordia Ch,677,6,2,3,9,16,24,-8,9
FCSB,678,1,9,5,0,25,10,15,32
CFR Cluj,678,2,5,6,3,15,11,4,21
Universitate,678,3,4,5,5,17,21,-4,17
D Bucuresti,678,4,4,4,6,18,20,-2,16
FC Botosani,678,5,4,4,6,7,13,-6,16
Concordia Ch,678,6,3,2,9,17,24,-7,11
FCSB,679,1,8,5,1,28,13,15,29
CFR Cluj,679,2,6,7,1,16,9,7,25
D Bucuresti,679,3,4,4,6,21,23,-2,16
Universitate,679,4,3,6,5,16,23,-7,15
FC Botosani,679,5,3,5,6,7,17,-10,14
Concordia Ch,679,6,3,3,8,20,23,-3,12
FCSB,680,1,8,5,1,26,13,13,29
CFR Cluj,680,2,7,6,1,16,8,8,27
FC Botosani,680,3,4,5,5,9,13,-4,17
D Bucuresti,680,4,3,6,5,17,19,-2,15
Universitate,680,5,3,5,6,15,21,-6,14
Concordia Ch,680,6,2,3,9,15,24,-9,9
FCSB,681,1,7,6,1,27,15,12,27
CFR Cluj,681,2,6,7,1,15,8,7,25
Universitate,681,3,4,5,5,18,22,-4,17
FC Botosani,681,4,4,5,5,7,13,-6,17
D Bucuresti,681,5,3,5,6,17,21,-4,14
Concordia Ch,681,6,3,2,9,17,22,-5,11
FCSB,682,1,7,6,1,25,13,12,27
CFR Cluj,682,2,6,7,1,15,8,7,25
FC Botosani,682,3,5,4,5,11,13,-2,19
Universitate,682,4,4,5,5,16,20,-4,17
D Bucuresti,682,5,4,4,6,20,21,-1,16
Concordia Ch,682,6,2,2,10,16,28,-12,8
FCSB,683,1,9,5,0,29,12,17,32
CFR Cluj,683,2,5,6,3,14,11,3,21
D Bucuresti,683,3,5,4,5,21,19,2,19
Universitate,683,4,4,5,5,16,21,-5,17
FC Botosani,683,5,3,4,7,6,15,-9,13
Concordia Ch,683,6,3,2,9,16,24,-8,11
FCSB,684,1,9,5,0,25,10,15,32
CFR Cluj,684,2,6,6,2,16,10,6,24
FC Botosani,684,3,3,6,5,8,15,-7,15
D Bucuresti,684,4,3,5,6,17,21,-4,14
Universitate,684,5,3,5,6,16,22,-6,14
Concordia Ch,684,6,3,3,8,19,23,-4,12
FCSB,685,1,8,6,0,26,11,15,30
CFR Cluj,685,2,5,8,1,14,8,6,23
D Bucuresti,685,3,5,4,5,20,20,0,19
FC Botosani,685,4,4,4,6,8,15,-7,16
Universitate,685,5,3,6,5,14,20,-6,15
Concordia Ch,685,6,2,2,10,15,23,-8,8
FCSB,686,1,8,5,1,24,12,12,29
CFR Cluj,686,2,6,6,2,17,10,7,24
Universitate,686,3,4,5,5,18,22,-4,17
D Bucuresti,686,4,3,6,5,20,22,-2,15
FC Botosani,686,5,3,6,5,7,14,-7,15
Concordia Ch,686,6,2,4,8,19,25,-6,10
FCSB,687,1,7,6,1,23,11,12,27
CFR Cluj,687,2,5,7,2,14,9,5,22
Universitate,687,3,5,5,4,17,19,-2,20
D Bucuresti,687,4,5,4,5,22,21,1,19
FC Botosani,687,5,3,4,7,7,17,-10,13
Concordia Ch,687,6,3,2,9,19,25,-6,11
FCSB,688,1,9,5,0,26,11,15,32
CFR Cluj,688,2,6,6,2,15,8,7,24
D Bucuresti,688,3,4,4,6,18,20,-2,16
Concordia Ch,688,4,4,2,8,18,22,-4,14
Universitate,688,5,3,5,6,15,22,-7,14
FC Botosani,688,6,3,4,7,5,14,-9,13
FCSB,689,1,9,5,0,30,11,19,32
CFR Cluj,689,2,6,6,2,15,11,4,24
D Bucuresti,689,3,3,6,5,18,20,-2,15
Universitate,689,4,3,5,6,15,23,-8,14
FC Botosani,689,5,3,5,6,6,14,-8,14
Concordia Ch,689,6,3,3,8,17,22,-5,12
FCSB,690,1,8,5,1,27,12,15,29
CFR Cluj,690,2,5,7,2,14,11,3,22
FC Botosani,690,3,5,4,5,9,13,-4,19
Universitate,690,4,4,6,4,17,20,-3,18
D Bucuresti,690,5,3,5,6,17,21,-4,14
Concordia Ch,690,6,2,3,9,17,24,-7,9
FCSB,691,1,8,5,1,27,13,14,29
CFR Cluj,691,2,7,6,1,18,9,9,27
D Bucuresti,691,3,4,5,5,18,18,0,17
Universitate,691,4,3,5,6,14,22,-8,14
FC Botosani,691,5,3,5,6,6,14,-8,14
Concordia Ch,691,6,3,2,9,17,24,-7,11
FCSB,692,1,8,5,1,26,13,13,29
CFR Cluj,692,2,6,6,2,17,9,8,24
FC Botosani,692,3,5,4,5,8,13,-5,19
Universitate,692,4,4,5,5,17,23,-6,17
D Bucuresti,692,5,3,4,7,19,23,-4,13
Concordia Ch,692,6,3,2,9,18,24,-6,11
FCSB,693,1,8,6,0,26,12,14,30
CFR Cluj,693,2,5,6,3,14,10,4,21
Universitate,693,3,4,6,4,18,21,-3,18
D Bucuresti,693,4,4,4,6,17,20,-3,16
Concordia Ch,693,5,4,2,8,20,23,-3,14
FC Botosani,693,6,3,4,7,7,16,-9,13
FCSB,694,1,9,5,0,26,11,15,32
CFR Cluj,694,2,5,7,2,14,9,5,22
D Bucuresti,694,3,4,5,5,19,19,0,17
Universitate,694,4,3,6,5,14,19,-5,15
FC Botosani,694,5,3,5,6,6,15,-9,14
Concordia Ch,694,6,2,4,8,15,21,-6,10
FCSB,695,1,8,5,1,25,11,14,29
CFR Cluj,695,2,5,7,2,13,9,4,22
Universitate,695,3,4,6,4,15,18,-3,18
D Bucuresti,695,4,4,5,5,18,19,-1,17
FC Botosani,695,5,4,5,5,8,14,-6,17
Concordia Ch,695,6,2,2,10,16,24,-8,8
FCSB,696,1,7,7,0,23,10,13,28
CFR Cluj,696,2,6,7,1,16,9,7,25
D Bucuresti,696,3,4,5,5,21,20,1,17
Universitate,696,4,3,6,5,16,21,-5,15
FC Botosani,696,5,3,5,6,5,15,-10,14
Concordia Ch,696,6,2,4,8,17,23,-6,10
FCSB,697,1,9,5,0,26,10,16,32
CFR Cluj,697,2,5,7,2,14,9,5,22
D Bucuresti,697,3,5,4,5,20,19,1,19
FC Botosani,697,4,4,4,6,7,14,-7,16
Universitate,697,5,3,6,5,15,21,-6,15
Concordia Ch,697,6,2,2,10,15,24,-9,8
FCSB,698,1,8,5,1,24,11,13,29
CFR Cluj,698,2,5,6,3,15,11,4,21
Universitate,698,3,5,5,4,18,20,-2,20
FC Botosani,698,4,5,4,5,7,12,-5,19
D Bucuresti,698,5,4,4,6,17,19,-2,16
Concordia Ch,698,6,2,2,10,15,23,-8,8
FCSB,699,1,7,7,0,24,11,13,28
CFR Cluj,699,2,5,8,1,15,9,6,23
D Bucuresti,699,3,4,5,5,19,19,0,17
Universitate,699,4,3,7,4,15,19,-4,16
FC Botosani,699,5,4,4,6,7,14,-7,16
Concordia Ch,699,6,2,3,9,16,24,-8,9
FCSB,700,1,8,5,1,24,11,13,29
CFR Cluj,700,2,6,6,2,15,9,6,24
D Bucuresti,700,3,5,4,5,20,18,2,19
Universitate,700,4,4,5,5,16,20,-4,17
FC Botosani,700,5,4,4,6,8,15,-7,16
Concordia Ch,700,6,2,2,10,15,25,-10,8
FCSB,701,1,8,5,1,27,13,14,29
CFR Cluj,701,2,6,7,1,15,8,7,25
D Bucuresti,701,3,4,4,6,18,20,-2,16
FC Botosani,701,4,4,4,6,9,14,-5,16
Universitate,701,5,3,6,5,15,21,-6,15
Concordia Ch,701,6,3,2,9,16,24,-8,11
FCSB,702,1,8,5,1,28,13,15,29
CFR Cluj,702,2,6,6,2,14,12,2,24
Universitate,702,3,4,5,5,17,19,-2,17
D Bucuresti,702,4,4,4,6,19,21,-2,16
FC Botosani,702,5,4,4,6,10,16,-6,16
Concordia Ch,702,6,3,2,9,17,24,-7,11
FCSB,703,1,9,5,0,28,13,15,32
CFR Cluj,703,2,6,6,2,16,9,7,24
FC Botosani,703,3,4,5,5,7,13,-6,17
D Bucuresti,703,4,4,4,6,20,21,-1,16
Universitate,703,5,3,5,6,16,23,-7,14
Concordia Ch,703,6,2,3,9,16,24,-8,9
FCSB,704,1,8,5,1,24,12,12,29
CFR Cluj,704,2,7,6,1,18,8,10,27
FC Botosani,704,3,3,6,5,8,15,-7,15
D Bucuresti,704,4,3,5,6,18,22,-4,14
Universitate,704,5,3,5,6,15,22,-7,14
Concordia Ch,704,6,3,3,8,18,22,-4,12
FCSB,705,1,9,5,0,27,11,16,32
CFR Cluj,705,2,6,6,2,16,11,5,24
D Bucuresti,705,3,5,4,5,22,18,4,19
Universitate,705,4,3,5,6,17,23,-6,14
FC Botosani,705,5,3,4,7,5,16,-11,13
Concordia Ch,705,6,3,2,9,16,24,-8,11
FCSB,706,1,8,5,1,27,13,14,29
CFR Cluj,706,2,6,7,1,15,7,8,25
FC Botosani,706,3,4,5,5,7,12,-5,17
Universitate,706,4,3,6,5,15,22,-7,15
D Bucuresti,706,5,3,5,6,18,21,-3,14
Concordia Ch,706,6,3,2,9,18,25,-7,11
FCSB,707,1,9,5,0,28,12,16,32
CFR Cluj,707,2,5,7,2,14,10,4,22
Universitate,707,3,3,6,5,15,20,-5,15
Concordia Ch,707,4,4,2,8,20,22,-2,14
D Bucuresti,707,5,3,5,6,17,20,-3,14
FC Botosani,707,6,3,5,6,5,15,-10,14
FCSB,708,1,8,6,0,27,12,15,30
CFR Cluj,708,2,6,6,2,15,10,5,24
D Bucuresti,708,3,4,5,5,19,20,-1,17
FC Botosani,708,4,4,4,6,9,16,-7,16
Universitate,708,5,3,6,5,15,20,-5,15
Concordia Ch,708,6,2,3,9,18,25,-7,9
FCSB,709,1,7,6,1,26,14,12,27
CFR Cluj,709,2,6,6,2,15,10,5,24
Universitate,709,3,4,6,4,20,22,-2,18
D Bucuresti,709,4,3,6,5,16,18,-2,15
FC Botosani,709,5,3,6,5,5,12,-7,15
Concordia Ch,709,6,2,4,8,15,21,-6,10
FCSB,710,1,7,6,1,26,15,11,27
CFR Cluj,710,2,5,8,1,16,10,6,23
Universitate,710,3,4,6,4,18,20,-2,18
FC Botosani,710,4,4,5,5,9,14,-5,17
D Bucuresti,710,5,4,4,6,20,22,-2,16
Concordia Ch,710,6,2,3,9,17,25,-8,9
FCSB,711,1,8,5,1,27,13,14,29
CFR Cluj,711,2,5,6,3,15,13,2,21
Universitate,711,3,5,5,4,17,18,-1,20
D Bucuresti,711,4,4,5,5,19,20,-1,17
FC Botosani,711,5,3,4,7,7,16,-9,13
Concordia Ch,711,6,3,3,8,20,25,-5,12
FCSB,712,1,7,7,0,24,11,13,28
CFR Cluj,712,2,5,7,2,13,9,4,22
Universitate,712,3,4,6,4,17,19,-2,18
D Bucuresti,712,4,3,6,5,20,22,-2,15
FC Botosani,712,5,3,6,5,7,14,-7,15
Concordia Ch,712,6,2,4,8,19,25,-6,10
FCSB,713,1,8,5,1,26,14,12,29
CFR Cluj,713,2,5,7,2,14,9,5,22
D Bucuresti,713,3,5,4,5,21,20,1,19
Universitate,713,4,4,6,4,17,19,-2,18
FC Botosani,713,5,3,4,7,6,16,-10,13
Concordia Ch,713,6,3,2,9,19,25,-6,11
FCSB,714,1,9,5,0,27,11,16,32
CFR Cluj,714,2,5,7,2,14,9,5,22
FC Botosani,714,3,4,5,5,9,14,-5,17
D Bucuresti,714,4,4,4,6,20,23,-3,16
Universitate,714,5,3,6,5,14,20,-6,15
Concordia Ch,714,6,2,3,9,20,27,-7,9
FCSB,715,1,9,5,0,27,10,17,32
CFR Cluj,715,2,5,6,3,14,11,3,21
D Bucuresti,715,3,5,4,5,19,19,0,19
Universitate,715,4,4,5,5,17,22,-5,17
FC Botosani,715,5,3,4,7,5,14,-9,13
Concordia Ch,715,6,3,2,9,17,23,-6,11
FCSB,716,1,9,5,0,30,10,20,32
CFR Cluj,716,2,5,6,3,13,12,1,21
D Bucuresti,716,3,4,5,5,17,18,-1,17
FC Botosani,716,4,4,5,5,7,12,-5,17
Universitate,716,5,4,5,5,15,21,-6,17
Concordia Ch,716,6,2,2,10,15,24,-9,8
FCSB,717,1,9,5,0,30,10,20,32
CFR Cluj,717,2,6,6,2,15,10,5,24
FC Botosani,717,3,4,5,5,7,13,-6,17
D Bucuresti,717,4,3,5,6,16,21,-5,14
Universitate,717,5,3,5,6,14,24,-10,14
Concordia Ch,717,6,3,2,9,19,23,-4,11
FCSB,718,1,7,7,0,26,13,13,28
CFR Cluj,718,2,6,7,1,15,8,7,25
D Bucuresti,718,3,5,4,5,19,18,1,19
FC Botosani,718,4,4,4,6,6,13,-7,16
Universitate,718,5,3,6,5,18,23,-5,15
Concordia Ch,718,6,2,2,10,15,24,-9,8
FCSB,719,1,8,5,1,27,14,13,29
CFR Cluj,719,2,5,6,3,16,13,3,21
Universitate,719,3,5,5,4,17,18,-1,20
D Bucuresti,719,4,4,4,6,18,20,-2,16
FC Botosani,719,5,3,5,6,6,15,-9,14
Concordia Ch,719,6,3,3,8,18,22,-4,12
FCSB,720,1,7,6,1,24,12,12,27
CFR Cluj,720,2,6,7,1,14,7,7,25
D Bucuresti,720,3,4,5,5,20,20,0,17
Universitate,720,4,4,5,5,16,20,-4,17
FC Botosani,720,5,3,5,6,5,14,-9,14
Concordia Ch,720,6,2,4,8,17,23,-6,10
FCSB,721,1,8,6,0,26,10,16,30
CFR Cluj,721,2,6,6,2,14,10,4,24
D Bucuresti,721,3,4,4,6,17,20,-3,16
Universitate,721,4,3,6,5,14,19,-5,15
Concordia Ch,721,5,4,2,8,20,22,-2,14
FC Botosani,721,6,3,4,7,6,16,-10,13
FCSB,722,1,9,5,0,30,11,19,32
CFR Cluj,722,2,5,7,2,15,12,3,22
D Bucuresti,722,3,4,5,5,19,20,-1,17
FC Botosani,722,4,4,4,6,8,14,-6,16
Universitate,722,5,3,6,5,15,22,-7,15
Concordia Ch,722,6,2,3,9,16,24,-8,9
FCSB,723,1,7,6,1,24,12,12,27
CFR Cluj,723,2,6,7,1,16,9,7,25
Universitate,723,3,4,5,5,16,20,-4,17
FC Botosani,723,4,3,6,5,6,13,-7,15
D Bucuresti,723,5,3,5,6,17,23,-6,14
Concordia Ch,723,6,3,3,8,19,21,-2,12
FCSB,724,1,7,5,2,24,14,10,26
CFR Cluj,724,2,6,6,2,16,9,7,24
Universitate,724,3,5,5,4,16,18,-2,20
FC Botosani,724,4,3,6,5,5,12,-7,15
D Bucuresti,724,5,3,5,6,19,22,-3,14
Concordia Ch,724,6,3,3,8,19,24,-5,12
FCSB,725,1,7,6,1,24,12,12,27
CFR Cluj,725,2,6,6,2,15,9,6,24
D Bucuresti,725,3,5,4,5,20,19,1,19
Universitate,725,4,4,6,4,17,20,-3,18
FC Botosani,725,5,3,5,6,5,14,-9,14
Concordia Ch,725,6,2,3,9,16,23,-7,9
FCSB,726,1,8,6,0,25,11,14,30
CFR Cluj,726,2,6,7,1,14,7,7,25
D Bucuresti,726,3,5,4,5,18,18,0,19
FC Botosani,726,4,4,4,6,6,13,-7,16
Universitate,726,5,3,5,6,15,21,-6,14
Concordia Ch,726,6,2,2,10,15,23,-8,8
FCSB,727,1,8,5,1,26,12,14,29
CFR Cluj,727,2,6,7,1,15,8,7,25
D Bucuresti,727,3,4,4,6,19,23,-4,16
Universitate,727,4,3,6,5,14,20,-6,15
FC Botosani,727,5,3,5,6,7,15,-8,14
Concordia Ch,727,6,3,3,8,18,21,-3,12
FCSB,728,1,8,6,0,25,11,14,30
CFR Cluj,728,2,5,7,2,13,8,5,22
D Bucuresti,728,3,4,4,6,18,19,-1,16
Universitate,728,4,3,7,4,15,19,-4,16
FC Botosani,728,5,3,5,6,7,16,-9,14
Concordia Ch,728,6,3,3,8,18,23,-5,12
CFR Cluj,729,1,7,6,1,19,9,10,27
FCSB,729,2,7,5,2,24,13,11,26
Universitate,729,3,4,5,5,16,22,-6,17
D Bucuresti,729,4,4,4,6,19,20,-1,16
FC Botosani,729,5,4,4,6,7,14,-7,16
Concordia Ch,729,6,3,2,9,17,24,-7,11
FCSB,730,1,8,6,0,27,12,15,30
CFR Cluj,730,2,5,6,3,14,13,1,21
Universitate,730,3,4,6,4,18,19,-1,18
FC Botosani,730,4,4,5,5,8,14,-6,17
D Bucuresti,730,5,3,6,5,17,19,-2,15
Concordia Ch,730,6,2,3,9,16,23,-7,9
FCSB,731,1,8,5,1,26,13,13,29
CFR Cluj,731,2,5,7,2,14,9,5,22
D Bucuresti,731,3,5,4,5,18,18,0,19
Universitate,731,4,4,6,4,18,21,-3,18
FC Botosani,731,5,3,4,7,5,15,-10,13
Concordia Ch,731,6,3,2,9,17,22,-5,11
FCSB,732,1,9,5,0,29,10,19,32
CFR Cluj,732,2,6,6,2,16,11,5,24
D Bucuresti,732,3,4,4,6,18,22,-4,16
Concordia Ch,732,4,4,2,8,20,22,-2,14
Universitate,732,5,3,5,6,14,23,-9,14
FC Botosani,732,6,3,4,7,5,14,-9,13
FCSB,733,1,8,6,0,25,11,14,30
CFR Cluj,733,2,5,7,2,16,11,5,22
D Bucuresti,733,3,4,5,5,19,19,0,17
Universitate,733,4,3,7,4,18,22,-4,16
FC Botosani,733,5,3,4,7,5,16,-11,13
Concordia Ch,733,6,3,3,8,18,22,-4,12
FCSB,734,1,8,6,0,28,14,14,30
CFR Cluj,734,2,5,7,2,15,10,5,22
FC Botosani,734,3,4,5,5,7,13,-6,17
Universitate,734,4,3,7,4,18,22,-4,16
D Bucuresti,734,5,3,4,7,16,22,-6,13
Concordia Ch,734,6,3,3,8,19,22,-3,12
FCSB,735,1,7,6,1,25,13,12,27
CFR Cluj,735,2,6,7,1,16,9,7,25
Universitate,735,3,3,7,4,16,20,-4,16
D Bucuresti,735,4,3,5,6,16,19,-3,14
Concordia Ch,735,5,4,2,8,17,21,-4,14
FC Botosani,735,6,3,5,6,5,13,-8,14
FCSB,736,1,8,6,0,26,10,16,30
CFR Cluj,736,2,6,7,1,14,7,7,25
D Bucuresti,736,3,5,4,5,21,18,3,19
Universitate,736,4,3,5,6,14,22,-8,14
FC Botosani,736,5,3,5,6,6,15,-9,14
Concordia Ch,736,6,2,3,9,16,25,-9,9
FCSB,737,1,9,5,0,26,10,16,32
CFR Cluj,737,2,6,6,2,14,8,6,24
D Bucuresti,737,3,4,4,6,18,20,-2,16
Concordia Ch,737,4,4,2,8,20,24,-4,14
Universitate,737,5,3,5,6,14,21,-7,14
FC Botosani,737,6,3,4,7,7,16,-9,13
FCSB,738,1,8,5,1,25,12,13,29
CFR Cluj,738,2,7,6,1,17,8,9,27
FC Botosani,738,3,5,4,5,11,13,-2,19
D Bucuresti,738,4,4,4,6,19,22,-3,16
Universitate,738,5,3,5,6,14,21,-7,14
Concordia Ch,738,6,2,2,10,16,26,-10,8
FCSB,739,1,9,5,0,27,10,17,32
CFR Cluj,739,2,6,6,2,17,10,7,24
D Bucuresti,739,3,4,4,6,18,20,-2,16
FC Botosani,739,4,4,4,6,6,14,-8,16
Universitate,739,5,3,5,6,15,24,-9,14
Concordia Ch,739,6,3,2,9,18,23,-5,11
FCSB,740,1,8,6,0,25,11,14,30
CFR Cluj,740,2,5,8,1,15,9,6,23
D Bucuresti,740,3,5,4,5,22,19,3,19
Universitate,740,4,3,6,5,15,20,-5,15
FC Botosani,740,5,3,4,7,5,16,-11,13
Concordia Ch,740,6,3,2,9,17,24,-7,11
FCSB,741,1,8,5,1,24,11,13,29
CFR Cluj,741,2,7,6,1,19,7,12,27
D Bucuresti,741,3,4,4,6,18,22,-4,16
Concordia Ch,741,4,4,2,8,19,21,-2,14
Universitate,741,5,3,5,6,14,24,-10,14
FC Botosani,741,6,3,4,7,6,15,-9,13
FCSB,742,1,8,6,0,25,11,14,30
CFR Cluj,742,2,6,7,1,16,9,7,25
FC Botosani,742,3,4,4,6,7,14,-7,16
Concordia Ch,742,4,4,2,8,20,23,-3,14
Universitate,742,5,3,5,6,15,21,-6,14
D Bucuresti,742,6,3,4,7,17,22,-5,13
FCSB,743,1,8,5,1,26,13,13,29
CFR Cluj,743,2,6,7,1,15,8,7,25
FC Botosani,743,3,4,5,5,7,13,-6,17
Universitate,743,4,3,6,5,15,20,-5,15
D Bucuresti,743,5,3,5,6,16,20,-4,14
Concordia Ch,743,6,3,2,9,18,23,-5,11
FCSB,744,1,8,5,1,27,13,14,29
CFR Cluj,744,2,6,7,1,17,10,7,25
D Bucuresti,744,3,4,4,6,19,21,-2,16
FC Botosani,744,4,4,4,6,7,15,-8,16
Universitate,744,5,3,6,5,17,23,-6,15
Concordia Ch,744,6,3,2,9,19,24,-5,11
FCSB,745,1,7,6,1,25,13,12,27
CFR Cluj,745,2,6,7,1,17,8,9,25
D Bucuresti,745,3,5,4,5,21,20,1,19
Universitate,745,4,4,5,5,16,22,-6,17
FC Botosani,745,5,3,4,7,7,17,-10,13
Concordia Ch,745,6,3,2,9,19,25,-6,11
FCSB,746,1,7,6,1,24,14,10,27
CFR Cluj,746,2,7,6,1,17,7,10,27
FC Botosani,746,3,4,5,5,8,14,-6,17
Universitate,746,4,3,6,5,15,20,-5,15
D Bucuresti,746,5,3,5,6,19,23,-4,14
Concordia Ch,746,6,3,2,9,18,23,-5,11
FCSB,747,1,7,6,1,28,18,10,27
CFR Cluj,747,2,6,7,1,18,11,7,25
D Bucuresti,747,3,4,5,5,18,18,0,17
Universitate,747,4,4,5,5,18,20,-2,17
FC Botosani,747,5,4,4,6,7,15,-8,16
Concordia Ch,747,6,2,3,9,16,23,-7,9
FCSB,748,1,8,6,0,28,11,17,30
CFR Cluj,748,2,5,7,2,15,11,4,22
Universitate,748,3,4,5,5,17,23,-6,17
FC Botosani,748,4,3,6,5,9,16,-7,15
D Bucuresti,748,5,3,5,6,19,22,-3,14
Concordia Ch,748,6,3,3,8,19,24,-5,12
FCSB,749,1,8,6,0,26,11,15,30
CFR Cluj,749,2,6,7,1,18,9,9,25
FC Botosani,749,3,5,4,5,8,12,-4,19
D Bucuresti,749,4,3,5,6,17,20,-3,14
Universitate,749,5,3,5,6,15,24,-9,14
Concordia Ch,749,6,2,3,9,16,24,-8,9
FCSB,750,1,9,5,0,28,11,17,32
CFR Cluj,750,2,6,6,2,17,12,5,24
D Bucuresti,750,3,4,5,5,21,20,1,17
FC Botosani,750,4,4,4,6,10,18,-8,16
Universitate,750,5,3,5,6,16,23,-7,14
Concordia Ch,750,6,2,3,9,18,26,-8,9
FCSB,751,1,7,5,2,25,14,11,26
CFR Cluj,751,2,6,7,1,16,9,7,25
Universitate,751,3,4,6,4,15,18,-3,18
D Bucuresti,751,4,4,4,6,18,23,-5,16
FC Botosani,751,5,3,5,6,6,14,-8,14
Concordia Ch,751,6,3,3,8,21,23,-2,12
FCSB,752,1,8,5,1,24,11,13,29
CFR Cluj,752,2,5,7,2,13,8,5,22
FC Botosani,752,3,5,4,5,10,14,-4,19
Universitate,752,4,4,6,4,15,18,-3,18
D Bucuresti,752,5,3,5,6,17,20,-3,14
Concordia Ch,752,6,2,3,9,18,26,-8,9
FCSB,753,1,7,5,2,24,15,9,26
CFR Cluj,753,2,6,6,2,18,11,7,24
Universitate,753,3,5,5,4,19,20,-1,20
D Bucuresti,753,4,5,4,5,20,19,1,19
FC Botosani,753,5,4,4,6,9,14,-5,16
Concordia Ch,753,6,2,2,10,15,26,-11,8
FCSB,754,1,7,6,1,24,13,11,27
CFR Cluj,754,2,6,7,1,16,8,8,25
D Bucuresti,754,3,5,4,5,21,19,2,19
Universitate,754,4,3,7,4,16,20,-4,16
FC Botosani,754,5,3,4,7,7,18,-11,13
Concordia Ch,754,6,3,2,9,19,25,-6,11
FCSB,755,1,8,6,0,26,11,15,30
CFR Cluj,755,2,6,7,1,14,7,7,25
FC Botosani,755,3,4,4,6,8,15,-7,16
Concordia Ch,755,4,4,2,8,17,21,-4,14
Universitate,755,5,3,5,6,15,22,-7,14
D Bucuresti,755,6,3,4,7,18,22,-4,13
FCSB,756,1,7,7,0,25,12,13,28
CFR Cluj,756,2,5,8,1,15,9,6,23
FC Botosani,756,3,4,5,5,6,12,-6,17
Universitate,756,4,3,7,4,16,20,-4,16
D Bucuresti,756,5,3,4,7,16,20,-4,13
Concordia Ch,756,6,3,3,8,16,21,-5,12
FCSB,757,1,8,6,0,26,12,14,30
CFR Cluj,757,2,6,6,2,15,9,6,24
D Bucuresti,757,3,4,5,5,19,20,-1,17
Universitate,757,4,3,6,5,15,20,-5,15
FC Botosani,757,5,3,5,6,6,14,-8,14
Concordia Ch,757,6,2,4,8,18,24,-6,10
FCSB,758,1,8,5,1,28,14,14,29
CFR Cluj,758,2,7,6,1,19,9,10,27
D Bucuresti,758,3,5,4,5,20,18,2,19
Universitate,758,4,3,5,6,16,25,-9,14
FC Botosani,758,5,3,5,6,5,15,-10,14
Concordia Ch,758,6,2,3,9,15,22,-7,9
FCSB,759,1,8,5,1,24,11,13,29
CFR Cluj,759,2,5,6,3,13,9,4,21
Universitate,759,3,5,5,4,16,18,-2,20
Concordia Ch,759,4,4,2,8,19,21,-2,14
D Bucuresti,759,5,3,5,6,17,22,-5,14
FC Botosani,759,6,3,5,6,6,14,-8,14
FCSB,760,1,8,6,0,25,11,14,30
CFR Cluj,760,2,6,6,2,15,8,7,24
D Bucuresti,760,3,3,6,5,17,19,-2,15
Universitate,760,4,3,6,5,15,21,-6,15
FC Botosani,760,5,3,5,6,6,14,-8,14
Concordia Ch,760,6,3,3,8,18,23,-5,12
CFR Cluj,761,1,7,6,1,18,7,11,27
FCSB,761,2,7,5,2,23,13,10,26
FC Botosani,761,3,4,5,5,10,14,-4,17
Universitate,761,4,4,5,5,15,21,-6,17
D Bucuresti,761,5,3,4,7,18,24,-6,13
Concordia Ch,761,6,3,3,8,18,23,-5,12
FCSB,762,1,8,5,1,28,15,13,29
CFR Cluj,762,2,5,7,2,15,11,4,22
Universitate,762,3,4,6,4,17,19,-2,18
D Bucuresti,762,4,4,5,5,19,20,-1,17
FC Botosani,762,5,3,4,7,7,17,-10,13
Concordia Ch,762,6,3,3,8,21,25,-4,12
FCSB,763,1,8,5,1,25,12,13,29
CFR Cluj,763,2,5,6,3,13,9,4,21
Universitate,763,3,5,5,4,17,19,-2,20
FC Botosani,763,4,3,6,5,5,12,-7,15
D Bucuresti,763,5,3,5,6,16,22,-6,14
Concordia Ch,763,6,3,3,8,19,21,-2,12
FCSB,764,1,8,6,0,25,11,14,30
CFR Cluj,764,2,6,6,2,16,8,8,24
D Bucuresti,764,3,5,4,5,20,18,2,19
FC Botosani,764,4,4,4,6,6,14,-8,16
Universitate,764,5,3,6,5,15,22,-7,15
Concordia Ch,764,6,2,2,10,15,24,-9,8
FCSB,765,1,7,6,1,25,13,12,27
CFR Cluj,765,2,5,8,1,14,8,6,23
D Bucuresti,765,3,5,4,5,19,18,1,19
Universitate,765,4,4,6,4,16,19,-3,18
FC Botosani,765,5,3,5,6,5,13,-8,14
Concordia Ch,765,6,2,3,9,15,23,-8,9
CFR Cluj,766,1,7,6,1,16,8,8,27
FCSB,766,2,7,5,2,23,14,9,26
Universitate,766,3,4,5,5,18,20,-2,17
D Bucuresti,766,4,3,5,6,17,20,-3,14
Concordia Ch,766,5,4,2,8,17,21,-4,14
FC Botosani,766,6,3,5,6,6,14,-8,14
FCSB,767,1,9,5,0,26,11,15,32
CFR Cluj,767,2,6,6,2,14,8,6,24
D Bucuresti,767,3,4,4,6,19,20,-1,16
Concordia Ch,767,4,4,2,8,20,23,-3,14
Universitate,767,5,3,5,6,15,21,-6,14
FC Botosani,767,6,3,4,7,6,17,-11,13
CFR Cluj,768,1,7,6,1,16,8,8,27
FCSB,768,2,7,5,2,25,14,11,26
FC Botosani,768,3,5,4,5,7,12,-5,19
Universitate,768,4,4,5,5,16,20,-4,17
D Bucuresti,768,5,3,5,6,17,20,-3,14
Concordia Ch,768,6,2,3,9,16,23,-7,9
FCSB,769,1,8,5,1,24,11,13,29
CFR Cluj,769,2,7,6,1,15,7,8,27
D Bucuresti,769,3,4,4,6,20,22,-2,16
Concordia Ch,769,4,4,2,8,17,21,-4,14
Universitate,769,5,3,5,6,14,20,-6,14
FC Botosani,769,6,3,4,7,8,17,-9,13
FCSB,770,1,8,5,1,26,13,13,29
CFR Cluj,770,2,5,7,2,14,9,5,22
D Bucuresti,770,3,5,4,5,20,20,0,19
Universitate,770,4,4,6,4,16,19,-3,18
FC Botosani,770,5,3,5,6,8,16,-8,14
Concordia Ch,770,6,2,3,9,18,25,-7,9
FCSB,771,1,8,5,1,25,12,13,29
CFR Cluj,771,2,7,6,1,16,8,8,27
D Bucuresti,771,3,4,4,6,19,23,-4,16
Universitate,771,4,3,5,6,14,20,-6,14
FC Botosani,771,5,3,5,6,5,15,-10,14
Concordia Ch,771,6,3,3,8,20,21,-1,12
FCSB,772,1,8,6,0,26,12,14,30
CFR Cluj,772,2,5,7,2,16,11,5,22
Universitate,772,3,4,5,5,16,20,-4,17
D Bucuresti,772,4,4,4,6,18,20,-2,16
FC Botosani,772,5,4,4,6,7,14,-7,16
Concordia Ch,772,6,3,2,9,17,23,-6,11
FCSB,773,1,8,6,0,25,11,14,30
CFR Cluj,773,2,6,6,2,14,8,6,24
D Bucuresti,773,3,4,4,6,18,21,-3,16
Universitate,773,4,3,6,5,15,20,-5,15
FC Botosani,773,5,3,5,6,6,15,-9,14
Concordia Ch,773,6,3,3,8,19,22,-3,12
FCSB,774,1,8,6,0,27,13,14,30
CFR Cluj,774,2,5,8,1,15,9,6,23
FC Botosani,774,3,5,4,5,9,12,-3,19
Universitate,774,4,3,6,5,15,20,-5,15
D Bucuresti,774,5,3,4,7,16,24,-8,13
Concordia Ch,774,6,3,2,9,19,23,-4,11
FCSB,775,1,7,6,1,25,13,12,27
CFR Cluj,775,2,5,7,2,14,9,5,22
Universitate,775,3,5,5,4,19,21,-2,20
FC Botosani,775,4,4,5,5,7,13,-6,17
D Bucuresti,775,5,3,5,6,16,19,-3,14
Concordia Ch,775,6,3,2,9,17,23,-6,11
FCSB,776,1,7,6,1,23,11,12,27
CFR Cluj,776,2,5,8,1,13,7,6,23
Universitate,776,3,4,6,4,15,18,-3,18
D Bucuresti,776,4,4,4,6,17,20,-3,16
Concordia Ch,776,5,4,2,8,18,21,-3,14
FC Botosani,776,6,3,4,7,5,14,-9,13
FCSB,777,1,9,5,0,27,11,16,32
CFR Cluj,777,2,6,6,2,14,9,5,24
FC Botosani,777,3,4,5,5,8,14,-6,17
D Bucuresti,777,4,4,4,6,19,20,-1,16
Universitate,777,5,3,5,6,15,21,-6,14
Concordia Ch,777,6,2,3,9,16,24,-8,9
FCSB,778,1,7,6,1,24,12,12,27
CFR Cluj,778,2,7,6,1,16,7,9,27
Universitate,778,3,3,6,5,15,21,-6,15
Concordia Ch,778,4,4,2,8,20,23,-3,14
D Bucuresti,778,5,3,5,6,18,22,-4,14
FC Botosani,778,6,3,5,6,7,15,-8,14
FCSB,779,1,8,6,0,25,11,14,30
CFR Cluj,779,2,6,7,1,14,7,7,25
D Bucuresti,779,3,4,4,6,19,19,0,16
FC Botosani,779,4,4,4,6,8,16,-8,16
Universitate,779,5,3,5,6,15,21,-6,14
Concordia Ch,779,6,3,2,9,17,24,-7,11
FCSB,780,1,8,5,1,24,12,12,29
CFR Cluj,780,2,6,7,1,16,8,8,25
FC Botosani,780,3,4,5,5,6,12,-6,17
Universitate,780,4,3,6,5,15,20,-5,15
D Bucuresti,780,5,3,5,6,17,20,-3,14
Concordia Ch,780,6,3,2,9,17,23,-6,11
FCSB,781,1,8,5,1,25,13,12,29
CFR Cluj,781,2,6,6,2,16,10,6,24
FC Botosani,781,3,5,4,5,10,14,-4,19
Universitate,781,4,4,5,5,17,20,-3,17
D Bucuresti,781,5,4,4,6,18,21,-3,16
Concordia Ch,781,6,2,2,10,16,24,-8,8
FCSB,782,1,8,5,1,24,14,10,29
CFR Cluj,782,2,7,6,1,18,7,11,27
FC Botosani,782,3,4,4,6,6,13,-7,16
Concordia Ch,782,4,4,2,8,17,21,-4,14
Universitate,782,5,3,5,6,14,20,-6,14
D Bucuresti,782,6,3,4,7,16,20,-4,13
FCSB,783,1,7,7,0,24,11,13,28
CFR Cluj,783,2,5,7,2,13,8,5,22
Universitate,783,3,4,6,4,16,19,-3,18
D Bucuresti,783,4,4,4,6,17,20,-3,16
FC Botosani,783,5,4,4,6,9,14,-5,16
Concordia Ch,783,6,3,2,9,18,25,-7,11
FCSB,784,1,8,5,1,24,11,13,29
CFR Cluj,784,2,7,6,1,15,7,8,27
D Bucuresti,784,3,4,4,6,19,20,-1,16
FC Botosani,784,4,4,4,6,6,14,-8,16
Universitate,784,5,3,5,6,14,20,-6,14
Concordia Ch,784,6,3,2,9,17,23,-6,11
FCSB,785,1,9,5,0,27,11,16,32
CFR Cluj,785,2,5,6,3,14,12,2,21
Universitate,785,3,4,5,5,17,20,-3,17
FC Botosani,785,4,4,5,5,7,13,-6,17
D Bucuresti,785,5,3,4,7,18,22,-4,13
Concordia Ch,785,6,3,3,8,17,22,-5,12
FCSB,786,1,7,6,1,25,15,10,27
CFR Cluj,786,2,6,7,1,18,9,9,25
Universitate,786,3,4,5,5,17,21,-4,17
D Bucuresti,786,4,4,4,6,21,21,0,16
FC Botosani,786,5,3,5,6,6,16,-10,14
Concordia Ch,786,6,3,3,8,17,22,-5,12
FCSB,787,1,8,6,0,26,12,14,30
CFR Cluj,787,2,6,7,1,17,9,8,25
D Bucuresti,787,3,4,5,5,17,18,-1,17
Universitate,787,4,3,5,6,14,21,-7,14
FC Botosani,787,5,3,4,7,5,14,-9,13
Concordia Ch,787,6,3,3,8,16,21,-5,12
FCSB,788,1,7,6,1,24,12,12,27
CFR Cluj,788,2,6,7,1,14,7,7,25
Universitate,788,3,3,7,4,15,19,-4,16
FC Botosani,788,4,4,4,6,8,17,-9,16
Concordia Ch,788,5,4,2,8,20,22,-2,14
D Bucuresti,788,6,3,4,7,19,23,-4,13
FCSB,789,1,8,6,0,26,12,14,30
CFR Cluj,789,2,5,7,2,16,11,5,22
D Bucuresti,789,3,4,5,5,17,18,-1,17
Universitate,789,4,3,7,4,17,21,-4,16
FC Botosani,789,5,3,6,5,5,12,-7,15
Concordia Ch,789,6,2,3,9,15,22,-7,9
FCSB,790,1,9,5,0,26,10,16,32
CFR Cluj,790,2,5,6,3,13,10,3,21
Universitate,790,3,4,5,5,16,20,-4,17
FC Botosani,790,4,4,5,5,10,15,-5,17
D Bucuresti,790,5,4,4,6,22,23,-1,16
Concordia Ch,790,6,2,3,9,19,28,-9,9
FCSB,791,1,9,5,0,26,11,15,32
CFR Cluj,791,2,6,6,2,15,9,6,24
FC Botosani,791,3,4,4,6,6,14,-8,16
Concordia Ch,791,4,4,2,8,18,21,-3,14
Universitate,791,5,3,5,6,14,20,-6,14
D Bucuresti,791,6,3,4,7,16,20,-4,13
FCSB,792,1,8,5,1,24,13,11,29
CFR Cluj,792,2,5,6,3,14,10,4,21
Universitate,792,3,5,5,4,19,19,0,20
D Bucuresti,792,4,4,4,6,17,21,-4,16
FC Botosani,792,5,3,5,6,5,13,-8,14
Concordia Ch,792,6,3,3,8,18,21,-3,12
FCSB,793,1,8,5,1,25,12,13,29
CFR Cluj,793,2,7,6,1,19,8,11,27
D Bucuresti,793,3,4,4,6,20,21,-1,16
Universitate,793,4,3,5,6,14,23,-9,14
FC Botosani,793,5,3,5,6,6,15,-9,14
Concordia Ch,793,6,3,3,8,17,22,-5,12
FCSB,794,1,8,5,1,26,13,13,29
CFR Cluj,794,2,6,6,2,14,9,5,24
Universitate,794,3,4,5,5,18,21,-3,17
D Bucuresti,794,4,4,4,6,19,20,-1,16
FC Botosani,794,5,3,5,6,6,15,-9,14
Concordia Ch,794,6,3,3,8,18,23,-5,12
FCSB,795,1,8,6,0,27,13,14,30
CFR Cluj,795,2,6,6,2,16,9,7,24
FC Botosani,795,3,4,5,5,8,14,-6,17
Universitate,795,4,3,6,5,16,22,-6,15
D Bucuresti,795,5,3,5,6,18,21,-3,14
Concordia Ch,795,6,2,4,8,17,23,-6,10
CFR Cluj,796,1,7,6,1,19,8,11,27
FCSB,796,2,7,5,2,24,16,8,26
Universitate,796,3,4,5,5,18,22,-4,17
Concordia Ch,796,4,4,2,8,22,22,0,14
D Bucuresti,796,5,3,5,6,17,22,-5,14
FC Botosani,796,6,3,5,6,7,17,-10,14
FCSB,797,1,8,6,0,27,11,16,30
CFR Cluj,797,2,6,6,2,14,10,4,24
D Bucuresti,797,3,4,4,6,17,19,-2,16
FC Botosani,797,4,4,4,6,6,13,-7,16
Universitate,797,5,3,6,5,15,20,-5,15
Concordia Ch,797,6,3,2,9,16,22,-6,11
FCSB,798,1,9,5,0,28,12,16,32
CFR Cluj,798,2,6,6,2,15,10,5,24
Concordia Ch,798,3,4,2,8,21,22,-1,14
D Bucuresti,798,4,3,5,6,17,22,-5,14
Universitate,798,5,3,5,6,15,21,-6,14
FC Botosani,798,6,3,5,6,7,16,-9,14
FCSB,799,1,7,7,0,24,11,13,28
CFR Cluj,799,2,5,8,1,14,8,6,23
Universitate,799,3,3,7,4,16,20,-4,16
FC Botosani,799,4,4,4,6,7,13,-6,16
D Bucuresti,799,5,3,5,6,16,20,-4,14
Concordia Ch,799,6,3,3,8,16,21,-5,12
FCSB,800,1,7,6,1,25,13,12,27
CFR Cluj,800,2,6,7,1,16,9,7,25
Universitate,800,3,4,5,5,17,21,-4,17
Concordia Ch,800,4,4,2,8,19,22,-3,14
D Bucuresti,800,5,3,5,6,18,21,-3,14
FC Botosani,800,6,3,5,6,6,15,-9,14
FCSB,801,1,8,5,1,27,12,15,29
CFR Cluj,801,2,6,7,1,14,7,7,25
D Bucuresti,801,3,4,5,5,18,19,-1,17
Universitate,801,4,3,6,5,15,22,-7,15
FC Botosani,801,5,3,4,7,7,17,-10,13
Concordia Ch,801,6,3,3,8,18,22,-4,12
FCSB,802,1,9,5,0,26,10,16,32
CFR Cluj,802,2,5,7,2,14,10,4,22
D Bucuresti,802,3,4,4,6,18,20,-2,16
Universitate,802,4,3,6,5,15,20,-5,15
Concordia Ch,802,5,4,2,8,19,22,-3,14
FC Botosani,802,6,3,4,7,5,15,-10,13
FCSB,803,1,7,6,1,23,12,11,27
CFR Cluj,803,2,6,7,1,14,7,7,25
Universitate,803,3,4,5,5,16,19,-3,17
FC Botosani,803,4,4,5,5,7,13,-6,17
D Bucuresti,803,5,4,4,6,17,19,-2,16
Concordia Ch,803,6,2,3,9,16,23,-7,9
FCSB,804,1,8,6,0,28,12,16,30
CFR Cluj,804,2,6,7,1,15,8,7,25
D Bucuresti,804,3,5,4,5,21,18,3,19
FC Botosani,804,4,4,4,6,9,15,-6,16
Universitate,804,5,3,5,6,15,23,-8,14
Concordia Ch,804,6,2,2,10,15,27,-12,8
FCSB,805,1,8,6,0,26,11,15,30
CFR Cluj,805,2,5,6,3,14,12,2,21
Universitate,805,3,4,6,4,18,20,-2,18
FC Botosani,805,4,4,5,5,8,14,-6,17
D Bucuresti,805,5,3,6,5,18,20,-2,15
Concordia Ch,805,6,2,3,9,17,24,-7,9
FCSB,806,1,7,6,1,26,15,11,27
CFR Cluj,806,2,6,7,1,17,10,7,25
FC Botosani,806,3,5,4,5,8,13,-5,19
Universitate,806,4,4,5,5,18,21,-3,17
D Bucuresti,806,5,3,5,6,18,21,-3,14
Concordia Ch,806,6,2,3,9,16,23,-7,9
FCSB,807,1,8,6,0,25,11,14,30
CFR Cluj,807,2,5,7,2,13,10,3,22
D Bucuresti,807,3,5,4,5,21,19,2,19
Universitate,807,4,4,5,5,18,20,-2,17
FC Botosani,807,5,4,4,6,6,14,-8,16
Concordia Ch,807,6,2,2,10,16,25,-9,8
FCSB,808,1,7,6,1,25,14,11,27
CFR Cluj,808,2,6,6,2,16,9,7,24
Universitate,808,3,4,6,4,16,19,-3,18
D Bucuresti,808,4,4,4,6,19,20,-1,16
FC Botosani,808,5,4,4,6,8,16,-8,16
Concordia Ch,808,6,3,2,9,18,24,-6,11
FCSB,809,1,7,6,1,24,12,12,27
CFR Cluj,809,2,5,8,1,15,9,6,23
Universitate,809,3,4,6,4,16,19,-3,18
D Bucuresti,809,4,4,4,6,20,23,-3,16
FC Botosani,809,5,4,4,6,10,15,-5,16
Concordia Ch,809,6,3,2,9,18,25,-7,11
FCSB,810,1,9,5,0,29,11,18,32
CFR Cluj,810,2,5,7,2,13,11,2,22
D Bucuresti,810,3,5,4,5,20,19,1,19
FC Botosani,810,4,4,4,6,7,14,-7,16
Universitate,810,5,3,6,5,15,20,-5,15
Concordia Ch,810,6,2,2,10,15,24,-9,8
FCSB,811,1,9,5,0,29,11,18,32
CFR Cluj,811,2,5,6,3,14,11,3,21
Universitate,811,3,4,5,5,15,21,-6,17
D Bucuresti,811,4,4,4,6,18,21,-3,16
FC Botosani,811,5,4,4,6,7,13,-6,16
Concordia Ch,811,6,3,2,9,18,24,-6,11
FCSB,812,1,8,6,0,26,12,14,30
CFR Cluj,812,2,5,7,2,15,10,5,22
D Bucuresti,812,3,4,5,5,17,18,-1,17
Universitate,812,4,3,7,4,16,20,-4,16
FC Botosani,812,5,3,5,6,5,13,-8,14
Concordia Ch,812,6,2,4,8,15,21,-6,10
FCSB,813,1,7,6,1,23,12,11,27
CFR Cluj,813,2,6,7,1,15,7,8,25
D Bucuresti,813,3,4,5,5,17,18,-1,17
Universitate,813,4,4,5,5,16,20,-4,17
FC Botosani,813,5,4,4,6,6,13,-7,16
Concordia Ch,813,6,2,3,9,15,22,-7,9
FCSB,814,1,7,5,2,24,14,10,26
CFR Cluj,814,2,6,7,1,17,9,8,25
Universitate,814,3,4,6,4,18,21,-3,18
FC Botosani,814,4,4,5,5,7,13,-6,17
D Bucuresti,814,5,3,4,7,16,20,-4,13
Concordia Ch,814,6,3,3,8,17,22,-5,12
FCSB,815,1,7,6,1,24,12,12,27
CFR Cluj,815,2,6,7,1,15,7,8,25
FC Botosani,815,3,5,4,5,9,13,-4,19
Universitate,815,4,4,5,5,16,21,-5,17
D Bucuresti,815,5,3,5,6,18,22,-4,14
Concordia Ch,815,6,2,3,9,16,23,-7,9
FCSB,816,1,8,6,0,24,10,14,30
CFR Cluj,816,2,5,7,2,13,8,5,22
FC Botosani,816,3,5,4,5,8,13,-5,19
Universitate,816,4,3,7,4,14,18,-4,16
D Bucuresti,816,5,3,4,7,17,24,-7,13
Concordia Ch,816,6,3,2,9,21,24,-3,11
FCSB,817,1,8,6,0,26,12,14,30
CFR Cluj,817,2,6,6,2,16,8,8,24
FC Botosani,817,3,4,5,5,6,12,-6,17
D Bucuresti,817,4,3,6,5,17,19,-2,15
Universitate,817,5,3,6,5,16,23,-7,15
Concordia Ch,817,6,2,3,9,16,23,-7,9
FCSB,818,1,9,5,0,26,11,15,32
CFR Cluj,818,2,6,6,2,14,8,6,24
FC Botosani,818,3,5,4,5,9,13,-4,19
D Bucuresti,818,4,3,5,6,17,21,-4,14
Universitate,818,5,3,5,6,15,21,-6,14
Concordia Ch,818,6,2,3,9,17,24,-7,9
FCSB,819,1,8,6,0,26,12,14,30
CFR Cluj,819,2,6,6,2,17,8,9,24
FC Botosani,819,3,4,5,5,7,13,-6,17
Universitate,819,4,3,6,5,16,24,-8,15
D Bucuresti,819,5,3,5,6,17,20,-3,14
Concordia Ch,819,6,2,4,8,17,23,-6,10
FCSB,820,1,9,5,0,28,11,17,32
CFR Cluj,820,2,6,6,2,15,11,4,24
FC Botosani,820,3,4,5,5,10,13,-3,17
D Bucuresti,820,4,3,5,6,18,21,-3,14
Universitate,820,5,3,5,6,16,22,-6,14
Concordia Ch,820,6,3,2,9,17,26,-9,11
FCSB,821,1,7,6,1,25,13,12,27
CFR Cluj,821,2,6,7,1,17,9,8,25
D Bucuresti,821,3,5,4,5,22,20,2,19
Universitate,821,4,4,5,5,17,22,-5,17
FC Botosani,821,5,3,5,6,6,15,-9,14
Concordia Ch,821,6,2,3,9,16,24,-8,9
FCSB,822,1,9,5,0,26,10,16,32
CFR Cluj,822,2,5,7,2,14,10,4,22
FC Botosani,822,3,4,5,5,7,13,-6,17
Universitate,822,4,3,6,5,15,20,-5,15
D Bucuresti,822,5,3,4,7,16,20,-4,13
Concordia Ch,822,6,3,3,8,17,22,-5,12
FCSB,823,1,8,6,0,26,11,15,30
CFR Cluj,823,2,6,6,2,14,9,5,24
D Bucuresti,823,3,4,4,6,19,22,-3,16
Universitate,823,4,3,6,5,15,20,-5,15
Concordia Ch,823,5,4,2,8,18,21,-3,14
FC Botosani,823,6,3,4,7,7,16,-9,13
FCSB,824,1,8,6,0,28,13,15,30
CFR Cluj,824,2,5,7,2,17,12,5,22
Universitate,824,3,4,5,5,16,21,-5,17
D Bucuresti,824,4,4,4,6,18,20,-2,16
Concordia Ch,824,5,4,2,8,18,22,-4,14
FC Botosani,824,6,3,4,7,7,16,-9,13
FCSB,825,1,8,5,1,26,13,13,29
CFR Cluj,825,2,6,6,2,17,11,6,24
D Bucuresti,825,3,5,4,5,21,18,3,19
Universitate,825,4,4,5,5,18,22,-4,17
FC Botosani,825,5,4,4,6,7,16,-9,16
Concordia Ch,825,6,2,2,10,16,25,-9,8
FCSB,826,1,8,5,1,25,12,13,29
CFR Cluj,826,2,6,6,2,16,10,6,24
D Bucuresti,826,3,5,4,5,18,18,0,19
Universitate,826,4,4,5,5,16,20,-4,17
FC Botosani,826,5,4,4,6,9,14,-5,16
Concordia Ch,826,6,2,2,10,16,26,-10,8
FCSB,827,1,7,6,1,25,13,12,27
CFR Cluj,827,2,5,7,2,15,10,5,22
Universitate,827,3,5,5,4,18,20,-2,20
D Bucuresti,827,4,3,6,5,21,23,-2,15
FC Botosani,827,5,3,6,5,9,16,-7,15
Concordia Ch,827,6,2,4,8,16,22,-6,10
FCSB,828,1,8,5,1,26,13,13,29
CFR Cluj,828,2,6,6,2,17,10,7,24
Universitate,828,3,4,5,5,16,21,-5,17
D Bucuresti,828,4,3,6,5,18,20,-2,15
FC Botosani,828,5,3,6,5,7,14,-7,15
Concordia Ch,828,6,2,4,8,17,23,-6,10
FCSB,829,1,8,6,0,27,11,16,30
CFR Cluj,829,2,5,7,2,14,9,5,22
D Bucuresti,829,3,4,5,5,17,18,-1,17
Universitate,829,4,4,5,5,15,21,-6,17
FC Botosani,829,5,3,4,7,5,15,-10,13
Concordia Ch,829,6,3,3,8,17,21,-4,12
FCSB,830,1,8,6,0,26,12,14,30
CFR Cluj,830,2,6,6,2,18,10,8,24
FC Botosani,830,3,4,5,5,7,13,-6,17
Universitate,830,4,3,6,5,16,23,-7,15
D Bucuresti,830,5,3,5,6,16,19,-3,14
Concordia Ch,830,6,3,2,9,17,23,-6,11
FCSB,831,1,8,5,1,25,13,12,29
CFR Cluj,831,2,5,7,2,13,9,4,22
Universitate,831,3,4,6,4,17,18,-1,18
D Bucuresti,831,4,4,4,6,18,20,-2,16
FC Botosani,831,5,4,4,6,8,15,-7,16
Concordia Ch,831,6,3,2,9,17,23,-6,11
FCSB,832,1,8,5,1,26,13,13,29
CFR Cluj,832,2,6,6,2,15,9,6,24
Universitate,832,3,4,5,5,16,20,-4,17
D Bucuresti,832,4,3,6,5,19,21,-2,15
FC Botosani,832,5,3,5,6,7,15,-8,14
Concordia Ch,832,6,3,3,8,17,22,-5,12
FCSB,833,1,8,5,1,27,14,13,29
CFR Cluj,833,2,5,7,2,15,10,5,22
Universitate,833,3,4,6,4,18,21,-3,18
FC Botosani,833,4,4,5,5,8,13,-5,17
D Bucuresti,833,5,4,4,6,20,21,-1,16
Concordia Ch,833,6,2,3,9,17,26,-9,9
FCSB,834,1,8,5,1,25,12,13,29
CFR Cluj,834,2,7,6,1,16,7,9,27
FC Botosani,834,3,3,6,5,5,12,-7,15
D Bucuresti,834,4,3,5,6,17,21,-4,14
Universitate,834,5,3,5,6,15,22,-7,14
Concordia Ch,834,6,3,3,8,18,22,-4,12
FCSB,835,1,9,5,0,27,10,17,32
CFR Cluj,835,2,6,6,2,16,10,6,24
FC Botosani,835,3,4,4,6,7,15,-8,16
D Bucuresti,835,4,3,5,6,18,22,-4,14
Universitate,835,5,3,5,6,16,24,-8,14
Concordia Ch,835,6,3,3,8,20,23,-3,12
FCSB,836,1,8,5,1,26,12,14,29
CFR Cluj,836,2,5,6,3,13,10,3,21
Universitate,836,3,5,5,4,17,19,-2,20
D Bucuresti,836,4,4,4,6,18,20,-2,16
FC Botosani,836,5,4,4,6,8,15,-7,16
Concordia Ch,836,6,3,2,9,17,23,-6,11
FCSB,837,1,8,5,1,26,13,13,29
CFR Cluj,837,2,7,6,1,17,8,9,27
D Bucuresti,837,3,4,4,6,19,20,-1,16
Universitate,837,4,3,5,6,16,23,-7,14
FC Botosani,837,5,3,5,6,6,15,-9,14
Concordia Ch,837,6,3,3,8,18,23,-5,12
FCSB,838,1,9,5,0,29,11,18,32
CFR Cluj,838,2,6,6,2,16,10,6,24
D Bucuresti,838,3,4,5,5,19,20,-1,17
FC Botosani,838,4,3,6,5,6,13,-7,15
Universitate,838,5,3,5,6,14,23,-9,14
Concordia Ch,838,6,2,3,9,16,23,-7,9
FCSB,839,1,8,6,0,28,12,16,30
CFR Cluj,839,2,6,6,2,14,10,4,24
FC Botosani,839,3,4,4,6,6,13,-7,16
Universitate,839,4,3,6,5,16,21,-5,15
Concordia Ch,839,5,4,2,8,19,23,-4,14
D Bucuresti,839,6,3,4,7,18,22,-4,13
FCSB,840,1,9,5,0,26,10,16,32
CFR Cluj,840,2,5,6,3,13,11,2,21
Universitate,840,3,4,5,5,17,20,-3,17
FC Botosani,840,4,4,4,6,6,13,-7,16
Concordia Ch,840,5,4,2,8,18,22,-4,14
D Bucuresti,840,6,3,4,7,17,21,-4,13
FCSB,841,1,8,5,1,25,11,14,29
CFR Cluj,841,2,6,6,2,18,9,9,24
Universitate,841,3,4,5,5,15,23,-8,17
D Bucuresti,841,4,3,6,5,18,20,-2,15
FC Botosani,841,5,3,5,6,7,15,-8,14
Concordia Ch,841,6,3,3,8,18,23,-5,12
FCSB,842,1,8,6,0,27,12,15,30
CFR Cluj,842,2,6,7,1,14,7,7,25
FC Botosani,842,3,4,5,5,9,13,-4,17
D Bucuresti,842,4,3,5,6,18,23,-5,14
Universitate,842,5,3,5,6,16,23,-7,14
Concordia Ch,842,6,2,4,8,16,22,-6,10
FCSB,843,1,7,5,2,25,15,10,26
CFR Cluj,843,2,6,6,2,16,10,6,24
Universitate,843,3,5,5,4,19,20,-1,20
D Bucuresti,843,4,4,5,5,17,18,-1,17
FC Botosani,843,5,3,5,6,6,14,-8,14
Concordia Ch,843,6,3,2,9,17,23,-6,11
FCSB,844,1,7,6,1,26,14,12,27
CFR Cluj,844,2,5,7,2,15,11,4,22
Universitate,844,3,5,5,4,18,19,-1,20
FC Botosani,844,4,5,4,5,7,12,-5,19
D Bucuresti,844,5,4,4,6,19,21,-2,16
Concordia Ch,844,6,2,2,10,17,25,-8,8
FCSB,845,1,7,6,1,25,13,12,27
CFR Cluj,845,2,6,6,2,14,8,6,24
D Bucuresti,845,3,5,4,5,21,19,2,19
Universitate,845,4,4,6,4,17,20,-3,18
FC Botosani,845,5,4,4,6,7,14,-7,16
Concordia Ch,845,6,2,2,10,15,25,-10,8
FCSB,846,1,8,5,1,25,12,13,29
CFR Cluj,846,2,6,6,2,14,9,5,24
D Bucuresti,846,3,4,5,5,18,19,-1,17
Universitate,846,4,4,5,5,16,19,-3,17
FC Botosani,846,5,3,6,5,5,12,-7,15
Concordia Ch,846,6,2,3,9,16,23,-7,9
FCSB,847,1,8,6,0,29,12,17,30
CFR Cluj,847,2,6,7,1,16,9,7,25
D Bucuresti,847,3,4,4,6,19,20,-1,16
Concordia Ch,847,4,4,2,8,19,22,-3,14
Universitate,847,5,3,5,6,14,23,-9,14
FC Botosani,847,6,3,4,7,5,16,-11,13
FCSB,848,1,8,5,1,25,12,13,29
CFR Cluj,848,2,6,6,2,15,8,7,24
D Bucuresti,848,3,4,5,5,19,19,0,17
Universitate,848,4,4,5,5,16,21,-5,17
FC Botosani,848,5,4,4,6,8,15,-7,16
Concordia Ch,848,6,2,3,9,15,23,-8,9
FCSB,849,1,7,6,1,27,15,12,27
CFR Cluj,849,2,6,7,1,17,10,7,25
Universitate,849,3,3,7,4,17,21,-4,16
Concordia Ch,849,4,4,2,8,20,23,-3,14
D Bucuresti,849,5,3,5,6,17,20,-3,14
FC Botosani,849,6,3,5,6,6,15,-9,14
FCSB,850,1,7,7,0,25,12,13,28
CFR Cluj,850,2,6,7,1,17,9,8,25
D Bucuresti,850,3,3,6,5,16,18,-2,15
Universitate,850,4,3,6,5,16,22,-6,15
FC Botosani,850,5,3,6,5,6,13,-7,15
Concordia Ch,850,6,2,4,8,16,22,-6,10
FCSB,851,1,8,5,1,26,12,14,29
CFR Cluj,851,2,6,7,1,16,8,8,25
D Bucuresti,851,3,4,4,6,17,19,-2,16
Universitate,851,4,3,6,5,15,22,-7,15
FC Botosani,851,5,3,5,6,5,13,-8,14
Concordia Ch,851,6,3,3,8,16,21,-5,12
FCSB,852,1,7,7,0,25,12,13,28
CFR Cluj,852,2,5,7,2,14,9,5,22
Universitate,852,3,4,6,4,16,19,-3,18
D Bucuresti,852,4,4,5,5,19,20,-1,17
FC Botosani,852,5,3,5,6,7,15,-8,14
Concordia Ch,852,6,2,4,8,17,23,-6,10
FCSB,853,1,9,5,0,26,11,15,32
CFR Cluj,853,2,6,6,2,15,8,7,24
FC Botosani,853,3,4,5,5,7,13,-6,17
D Bucuresti,853,4,3,6,5,18,20,-2,15
Universitate,853,5,3,5,6,15,22,-7,14
Concordia Ch,853,6,2,3,9,16,23,-7,9
FCSB,854,1,8,6,0,28,14,14,30
CFR Cluj,854,2,5,7,2,14,9,5,22
D Bucuresti,854,3,4,5,5,17,18,-1,17
Universitate,854,4,3,7,4,17,21,-4,16
FC Botosani,854,5,3,6,5,5,12,-7,15
Concordia Ch,854,6,2,3,9,15,22,-7,9
FCSB,855,1,8,6,0,25,10,15,30
CFR Cluj,855,2,6,7,1,14,7,7,25
D Bucuresti,855,3,4,5,5,17,18,-1,17
FC Botosani,855,4,3,6,5,6,13,-7,15
Universitate,855,5,3,5,6,14,21,-7,14
Concordia Ch,855,6,2,3,9,16,23,-7,9
FCSB,856,1,8,5,1,27,12,15,29
CFR Cluj,856,2,6,6,2,17,10,7,24
FC Botosani,856,3,4,5,5,8,13,-5,17
Universitate,856,4,4,5,5,16,23,-7,17
D Bucuresti,856,5,4,4,6,18,21,-3,16
Concordia Ch,856,6,2,3,9,15,22,-7,9
FCSB,857,1,9,5,0,30,13,17,32
CFR Cluj,857,2,6,6,2,17,12,5,24
FC Botosani,857,3,4,4,6,8,15,-7,16
D Bucuresti,857,4,3,5,6,19,22,-3,14
Universitate,857,5,3,5,6,17,24,-7,14
Concordia Ch,857,6,3,3,8,19,24,-5,12
FCSB,858,1,9,5,0,26,10,16,32
CFR Cluj,858,2,5,7,2,14,9,5,22
D Bucuresti,858,3,4,4,6,20,20,0,16
Universitate,858,4,3,6,5,15,21,-6,15
Concordia Ch,858,5,4,2,8,18,22,-4,14
FC Botosani,858,6,3,4,7,7,18,-11,13
FCSB,859,1,8,5,1,25,11,14,29
CFR Cluj,859,2,6,6,2,15,10,5,24
D Bucuresti,859,3,5,4,5,22,22,0,19
Universitate,859,4,4,5,5,16,20,-4,17
FC Botosani,859,5,3,5,6,10,18,-8,14
Concordia Ch,859,6,2,3,9,20,27,-7,9
FCSB,860,1,7,6,1,24,13,11,27
CFR Cluj,860,2,6,7,1,16,9,7,25
Universitate,860,3,4,5,5,17,20,-3,17
D Bucuresti,860,4,4,4,6,19,21,-2,16
FC Botosani,860,5,3,5,6,7,16,-9,14
Concordia Ch,860,6,3,3,8,18,22,-4,12
FCSB,861,1,8,5,1,24,12,12,29
CFR Cluj,861,2,6,7,1,15,7,8,25
FC Botosani,861,3,5,4,5,10,14,-4,19
Universitate,861,4,3,6,5,14,19,-5,15
D Bucuresti,861,5,3,4,7,18,22,-4,13
Concordia Ch,861,6,3,2,9,16,23,-7,11
FCSB,862,1,7,6,1,26,14,12,27
CFR Cluj,862,2,6,6,2,14,9,5,24
FC Botosani,862,3,5,4,5,8,13,-5,19
Universitate,862,4,4,6,4,19,21,-2,18
D Bucuresti,862,5,3,5,6,17,20,-3,14
Concordia Ch,862,6,2,3,9,15,22,-7,9
FCSB,863,1,8,5,1,28,13,15,29
CFR Cluj,863,2,5,7,2,13,10,3,22
Universitate,863,3,4,6,4,17,20,-3,18
D Bucuresti,863,4,4,4,6,19,19,0,16
FC Botosani,863,5,4,4,6,7,15,-8,16
Concordia Ch,863,6,3,2,9,16,23,-7,11
FCSB,864,1,8,6,0,25,11,14,30
CFR Cluj,864,2,5,7,2,15,10,5,22
D Bucuresti,864,3,4,5,5,19,20,-1,17
Universitate,864,4,3,7,4,15,19,-4,16
FC Botosani,864,5,3,5,6,6,15,-9,14
Concordia Ch,864,6,3,2,9,18,23,-5,11
FCSB,865,1,9,5,0,29,10,19,32
CFR Cluj,865,2,5,6,3,13,9,4,21
D Bucuresti,865,3,4,5,5,19,19,0,17
Universitate,865,4,4,5,5,15,23,-8,17
FC Botosani,865,5,3,4,7,6,16,-10,13
Concordia Ch,865,6,3,3,8,18,23,-5,12
FCSB,866,1,8,6,0,26,11,15,30
CFR Cluj,866,2,5,7,2,15,11,4,22
D Bucuresti,866,3,4,4,6,19,20,-1,16
Universitate,866,4,3,7,4,17,21,-4,16
FC Botosani,866,5,3,5,6,6,15,-9,14
Concordia Ch,866,6,3,3,8,16,21,-5,12
FCSB,867,1,8,6,0,28,12,16,30
CFR Cluj,867,2,5,6,3,14,13,1,21
Universitate,867,3,4,6,4,17,19,-2,18
FC Botosani,867,4,4,4,6,8,13,-5,16
Concordia Ch,867,5,4,2,8,18,22,-4,14
D Bucuresti,867,6,3,4,7,17,23,-6,13
FCSB,868,1,8,5,1,25,14,11,29
CFR Cluj,868,2,6,6,2,19,9,10,24
Universitate,868,3,4,5,5,19,25,-6,17
D Bucuresti,868,4,4,4,6,20,19,1,16
FC Botosani,868,5,4,4,6,7,17,-10,16
Concordia Ch,868,6,3,2,9,17,23,-6,11
FCSB,869,1,7,6,1,24,13,11,27
CFR Cluj,869,2,7,6,1,16,7,9,27
D Bucuresti,869,3,5,4,5,20,20,0,19
Universitate,869,4,3,6,5,15,20,-5,15
FC Botosani,869,5,3,4,7,6,16,-10,13
Concordia Ch,869,6,3,2,9,18,23,-5,11
FCSB,870,1,8,6,0,30,11,19,30
CFR Cluj,870,2,6,6,2,16,13,3,24
D Bucuresti,870,3,4,5,5,18,19,-1,17
Universitate,870,4,3,6,5,15,22,-7,15
FC Botosani,870,5,3,5,6,7,15,-8,14
Concordia Ch,870,6,2,4,8,18,24,-6,10
FCSB,871,1,8,6,0,24,10,14,30
CFR Cluj,871,2,6,6,2,15,9,6,24
D Bucuresti,871,3,3,6,5,17,19,-2,15
Universitate,871,4,3,6,5,15,20,-5,15
FC Botosani,871,5,3,6,5,6,13,-7,15
Concordia Ch,871,6,2,4,8,15,21,-6,10
FCSB,872,1,8,5,1,24,12,12,29
CFR Cluj,872,2,6,6,2,16,9,7,24
FC Botosani,872,3,5,4,5,8,12,-4,19
Universitate,872,4,4,5,5,16,20,-4,17
D Bucuresti,872,5,3,4,7,16,21,-5,13
Concordia Ch,872,6,3,2,9,16,22,-6,11
FCSB,873,1,7,6,1,27,15,12,27
CFR Cluj,873,2,7,6,1,17,9,8,27
FC Botosani,873,3,4,5,5,8,14,-6,17
Universitate,873,4,3,6,5,16,21,-5,15
D Bucuresti,873,5,3,4,7,16,22,-6,13
Concordia Ch,873,6,3,3,8,20,23,-3,12
FCSB,874,1,7,7,0,26,13,13,28
CFR Cluj,874,2,5,8,1,15,9,6,23
FC Botosani,874,3,4,5,5,7,13,-6,17
Universitate,874,4,3,7,4,15,19,-4,16
D Bucuresti,874,5,3,6,5,18,20,-2,15
Concordia Ch,874,6,2,3,9,16,23,-7,9
FCSB,875,1,7,6,1,23,13,10,27
CFR Cluj,875,2,6,7,1,14,7,7,25
FC Botosani,875,3,5,4,5,7,12,-5,19
Universitate,875,4,4,5,5,17,19,-2,17
D Bucuresti,875,5,3,5,6,17,20,-3,14
Concordia Ch,875,6,2,3,9,16,23,-7,9
FCSB,876,1,7,6,1,23,11,12,27
CFR Cluj,876,2,5,8,1,13,7,6,23
Universitate,876,3,4,6,4,15,18,-3,18
FC Botosani,876,4,4,4,6,8,15,-7,16
Concordia Ch,876,5,4,2,8,20,22,-2,14
D Bucuresti,876,6,3,4,7,17,23,-6,13
FCSB,877,1,8,6,0,25,11,14,30
CFR Cluj,877,2,6,6,2,15,9,6,24
FC Botosani,877,3,4,5,5,7,13,-6,17
Universitate,877,4,3,6,5,14,19,-5,15
D Bucuresti,877,5,3,4,7,17,22,-5,13
Concordia Ch,877,6,3,3,8,17,21,-4,12
FCSB,878,1,8,5,1,25,13,12,29
CFR Cluj,878,2,5,6,3,13,9,4,21
Universitate,878,3,5,5,4,18,19,-1,20
D Bucuresti,878,4,4,4,6,17,20,-3,16
FC Botosani,878,5,3,5,6,5,13,-8,14
Concordia Ch,878,6,3,3,8,17,21,-4,12
FCSB,879,1,9,5,0,27,12,15,32
CFR Cluj,879,2,6,6,2,16,10,6,24
FC Botosani,879,3,5,4,5,8,12,-4,19
D Bucuresti,879,4,4,4,6,18,20,-2,16
Universitate,879,5,3,5,6,14,20,-6,14
Concordia Ch,879,6,2,2,10,16,25,-9,8
FCSB,880,1,8,6,0,25,11,14,30
CFR Cluj,880,2,5,6,3,14,10,4,21
Universitate,880,3,4,6,4,15,18,-3,18
FC Botosani,880,4,4,5,5,6,12,-6,17
D Bucuresti,880,5,4,4,6,17,19,-2,16
Concordia Ch,880,6,2,3,9,15,22,-7,9
FCSB,881,1,8,5,1,25,12,13,29
CFR Cluj,881,2,5,6,3,14,10,4,21
Universitate,881,3,5,5,4,16,18,-2,20
FC Botosani,881,4,4,5,5,7,13,-6,17
D Bucuresti,881,5,3,5,6,17,20,-3,14
Concordia Ch,881,6,3,2,9,18,24,-6,11
FCSB,882,1,8,6,0,26,11,15,30
CFR Cluj,882,2,5,6,3,13,10,3,21
Universitate,882,3,4,6,4,16,19,-3,18
D Bucuresti,882,4,4,4,6,19,21,-2,16
Concordia Ch,882,5,4,2,8,20,23,-3,14
FC Botosani,882,6,3,4,7,5,15,-10,13
FCSB,883,1,7,6,1,25,13,12,27
CFR Cluj,883,2,6,6,2,16,10,6,24
D Bucuresti,883,3,5,4,5,19,19,0,19
Universitate,883,4,4,6,4,19,22,-3,18
FC Botosani,883,5,4,4,6,6,13,-7,16
Concordia Ch,883,6,2,2,10,16,24,-8,8
FCSB,884,1,7,5,2,24,15,9,26
CFR Cluj,884,2,6,6,2,14,8,6,24
Universitate,884,3,5,5,4,19,19,0,20
FC Botosani,884,4,4,5,5,8,13,-5,17
D Bucuresti,884,5,3,6,5,17,19,-2,15
Concordia Ch,884,6,2,3,9,15,23,-8,9
FCSB,885,1,7,7,0,25,12,13,28
CFR Cluj,885,2,5,8,1,16,10,6,23
FC Botosani,885,3,4,5,5,7,13,-6,17
Universitate,885,4,3,7,4,17,21,-4,16
D Bucuresti,885,5,3,6,5,17,19,-2,15
Concordia Ch,885,6,2,3,9,17,24,-7,9
FCSB,886,1,7,6,1,23,11,12,27
CFR Cluj,886,2,6,7,1,14,7,7,25
D Bucuresti,886,3,4,5,5,18,19,-1,17
Universitate,886,4,4,5,5,15,19,-4,17
FC Botosani,886,5,4,5,5,7,13,-6,17
Concordia Ch,886,6,2,2,10,15,23,-8,8
FCSB,887,1,8,6,0,27,12,15,30
CFR Cluj,887,2,5,6,3,14,12,2,21
Universitate,887,3,4,6,4,17,19,-2,18
D Bucuresti,887,4,4,4,6,17,20,-3,16
FC Botosani,887,5,4,4,6,7,14,-7,16
Concordia Ch,887,6,3,2,9,18,23,-5,11
FCSB,888,1,8,5,1,25,11,14,29
CFR Cluj,888,2,6,6,2,15,10,5,24
D Bucuresti,888,3,5,4,5,20,20,0,19
Universitate,888,4,4,5,5,17,21,-4,17
FC Botosani,888,5,3,5,6,5,13,-8,14
Concordia Ch,888,6,2,3,9,17,24,-7,9
FCSB,889,1,7,6,1,24,13,11,27
CFR Cluj,889,2,7,6,1,17,8,9,27
FC Botosani,889,3,4,4,6,9,16,-7,16
Universitate,889,4,3,6,5,14,19,-5,15
Concordia Ch,889,5,4,2,8,24,23,1,14
D Bucuresti,889,6,3,4,7,19,28,-9,13
FCSB,890,1,9,5,0,27,11,16,32
CFR Cluj,890,2,5,6,3,15,11,4,21
Universitate,890,3,4,5,5,16,21,-5,17
D Bucuresti,890,4,3,6,5,17,19,-2,15
FC Botosani,890,5,3,6,5,5,12,-7,15
Concordia Ch,890,6,2,4,8,16,22,-6,10
FCSB,891,1,8,5,1,25,12,13,29
CFR Cluj,891,2,7,6,1,15,7,8,27
D Bucuresti,891,3,4,5,5,20,20,0,17
FC Botosani,891,4,4,4,6,8,15,-7,16
Universitate,891,5,3,5,6,15,21,-6,14
Concordia Ch,891,6,2,3,9,16,24,-8,9
FCSB,892,1,7,6,1,25,16,9,27
CFR Cluj,892,2,5,7,2,14,10,4,22
Universitate,892,3,5,5,4,21,19,2,20
FC Botosani,892,4,5,4,5,8,12,-4,19
D Bucuresti,892,5,3,5,6,17,20,-3,14
Concordia Ch,892,6,2,3,9,16,24,-8,9
FCSB,893,1,8,6,0,26,11,15,30
CFR Cluj,893,2,5,6,3,14,12,2,21
Universitate,893,3,4,6,4,16,18,-2,18
D Bucuresti,893,4,4,5,5,18,19,-1,17
FC Botosani,893,5,3,6,5,7,14,-7,15
Concordia Ch,893,6,2,3,9,16,23,-7,9
FCSB,894,1,9,5,0,26,10,16,32
CFR Cluj,894,2,5,7,2,14,10,4,22
D Bucuresti,894,3,4,4,6,18,20,-2,16
FC Botosani,894,4,4,4,6,8,14,-6,16
Universitate,894,5,3,6,5,15,20,-5,15
Concordia Ch,894,6,3,2,9,16,23,-7,11
FCSB,895,1,7,6,1,24,14,10,27
CFR Cluj,895,2,6,7,1,16,9,7,25
Universitate,895,3,4,5,5,18,20,-2,17
D Bucuresti,895,4,4,4,6,19,19,0,16
FC Botosani,895,5,4,4,6,7,16,-9,16
Concordia Ch,895,6,3,2,9,17,23,-6,11
FCSB,896,1,7,7,0,23,10,13,28
CFR Cluj,896,2,6,7,1,14,7,7,25
D Bucuresti,896,3,4,5,5,20,20,0,17
FC Botosani,896,4,4,5,5,10,13,-3,17
Universitate,896,5,3,6,5,14,19,-5,15
Concordia Ch,896,6,2,2,10,16,28,-12,8
FCSB,897,1,8,5,1,25,12,13,29
CFR Cluj,897,2,7,6,1,15,7,8,27
FC Botosani,897,3,4,5,5,8,13,-5,17
D Bucuresti,897,4,3,5,6,17,21,-4,14
Universitate,897,5,3,5,6,15,21,-6,14
Concordia Ch,897,6,3,2,9,17,23,-6,11
FCSB,898,1,9,5,0,25,10,15,32
CFR Cluj,898,2,5,6,3,13,9,4,21
Universitate,898,3,4,5,5,15,19,-4,17
D Bucuresti,898,4,4,4,6,21,20,1,16
FC Botosani,898,5,4,4,6,8,18,-10,16
Concordia Ch,898,6,3,2,9,18,24,-6,11
FCSB,899,1,8,5,1,26,15,11,29
CFR Cluj,899,2,5,6,3,14,10,4,21
Universitate,899,3,5,5,4,21,21,0,20
D Bucuresti,899,4,4,4,6,18,20,-2,16
FC Botosani,899,5,3,5,6,5,14,-9,14
Concordia Ch,899,6,3,3,8,17,21,-4,12
FCSB,900,1,8,5,1,27,14,13,29
CFR Cluj,900,2,5,6,3,15,11,4,21
Universitate,900,3,5,5,4,17,19,-2,20
D Bucuresti,900,4,4,5,5,22,20,2,17
FC Botosani,900,5,4,4,6,8,18,-10,16
Concordia Ch,900,6,2,3,9,15,22,-7,9
FCSB,901,1,7,6,1,24,12,12,27
CFR Cluj,901,2,6,7,1,14,7,7,25
Universitate,901,3,4,5,5,16,20,-4,17
FC Botosani,901,4,4,4,6,8,17,-9,16
D Bucuresti,901,5,3,5,6,20,23,-3,14
Concordia Ch,901,6,3,3,8,20,23,-3,12
FCSB,902,1,8,5,1,28,11,17,29
CFR Cluj,902,2,7,6,1,17,9,8,27
FC Botosani,902,3,3,6,5,6,13,-7,15
D Bucuresti,902,4,3,5,6,16,19,-3,14
Universitate,902,5,3,5,6,16,26,-10,14
Concordia Ch,902,6,3,3,8,17,22,-5,12
FCSB,903,1,8,6,0,25,11,14,30
CFR Cluj,903,2,5,7,2,13,8,5,22
Universitate,903,3,3,7,4,15,19,-4,16
Concordia Ch,903,4,4,2,8,20,23,-3,14
D Bucuresti,903,5,3,5,6,19,23,-4,14
FC Botosani,903,6,3,5,6,6,14,-8,14
FCSB,904,1,8,5,1,27,12,15,29
CFR Cluj,904,2,6,6,2,14,11,3,24
Universitate,904,3,4,5,5,16,19,-3,17
D Bucuresti,904,4,4,4,6,19,21,-2,16
FC Botosani,904,5,3,5,6,7,15,-8,14
Concordia Ch,904,6,3,3,8,18,23,-5,12
FCSB,905,1,7,6,1,24,13,11,27
CFR Cluj,905,2,5,8,1,14,8,6,23
D Bucuresti,905,3,5,4,5,21,18,3,19
Universitate,905,4,4,6,4,16,18,-2,18
FC Botosani,905,5,4,4,6,6,14,-8,16
Concordia Ch,905,6,2,2,10,15,25,-10,8
FCSB,906,1,7,6,1,25,13,12,27
CFR Cluj,906,2,7,6,1,16,8,8,27
D Bucuresti,906,3,4,5,5,18,19,-1,17
FC Botosani,906,4,4,5,5,7,13,-6,17
Universitate,906,5,3,6,5,15,20,-5,15
Concordia Ch,906,6,2,2,10,15,23,-8,8
FCSB,907,1,7,6,1,24,12,12,27
CFR Cluj,907,2,6,7,1,16,8,8,25
FC Botosani,907,3,5,4,5,8,12,-4,19
Universitate,907,4,4,5,5,15,20,-5,17
D Bucuresti,907,5,3,4,7,16,20,-4,13
Concordia Ch,907,6,3,2,9,16,23,-7,11
FCSB,908,1,9,5,0,27,11,16,32
CFR Cluj,908,2,5,6,3,14,10,4,21
Universitate,908,3,4,5,5,15,20,-5,17
FC Botosani,908,4,4,5,5,6,12,-6,17
D Bucuresti,908,5,4,4,6,20,21,-1,16
Concordia Ch,908,6,2,3,9,17,25,-8,9
FCSB,909,1,9,5,0,28,12,16,32
CFR Cluj,909,2,5,7,2,16,11,5,22
D Bucuresti,909,3,4,4,6,17,20,-3,16
Universitate,909,4,3,6,5,15,21,-6,15
Concordia Ch,909,5,4,2,8,19,22,-3,14
FC Botosani,909,6,3,4,7,6,15,-9,13
FCSB,910,1,8,5,1,24,14,10,29
CFR Cluj,910,2,6,6,2,14,8,6,24
D Bucuresti,910,3,4,5,5,18,19,-1,17
Universitate,910,3,4,5,5,18,19,-1,17
FC Botosani,910,5,3,4,7,6,15,-9,13
Concordia Ch,910,6,3,3,8,18,23,-5,12
FCSB,911,1,9,5,0,29,12,17,32
CFR Cluj,911,2,6,6,2,15,11,4,24
FC Botosani,911,3,4,5,5,8,14,-6,17
D Bucuresti,911,4,3,6,5,18,20,-2,15
Universitate,911,5,3,5,6,15,21,-6,14
Concordia Ch,911,6,2,3,9,15,22,-7,9
FCSB,912,1,9,5,0,27,10,17,32
CFR Cluj,912,2,6,6,2,14,9,5,24
FC Botosani,912,3,4,5,5,9,13,-4,17
D Bucuresti,912,4,3,5,6,16,19,-3,14
Universitate,912,5,3,5,6,14,21,-7,14
Concordia Ch,912,6,3,2,9,17,25,-8,11
FCSB,913,1,9,5,0,26,10,16,32
CFR Cluj,913,2,6,6,2,14,9,5,24
D Bucuresti,913,3,5,4,5,19,19,0,19
Universitate,913,4,3,5,6,14,20,-6,14
FC Botosani,913,5,3,5,6,7,15,-8,14
Concordia Ch,913,6,2,3,9,18,25,-7,9
FCSB,914,1,8,6,0,25,11,14,30
CFR Cluj,914,2,5,6,3,13,9,4,21
FC Botosani,914,3,5,4,5,8,12,-4,19
Universitate,914,4,4,6,4,16,19,-3,18
D Bucuresti,914,5,3,5,6,16,19,-3,14
Concordia Ch,914,6,2,3,9,15,23,-8,9
FCSB,915,1,8,5,1,26,13,13,29
CFR Cluj,915,2,7,6,1,18,9,9,27
FC Botosani,915,3,4,4,6,7,14,-7,16
Concordia Ch,915,4,4,2,8,18,22,-4,14
Universitate,915,5,3,5,6,16,23,-7,14
D Bucuresti,915,6,3,4,7,18,22,-4,13
FCSB,916,1,7,7,0,24,11,13,28
CFR Cluj,916,2,5,8,1,15,9,6,23
D Bucuresti,916,3,4,5,5,20,21,-1,17
FC Botosani,916,4,4,5,5,8,14,-6,17
Universitate,916,5,3,7,4,17,21,-4,16
Concordia Ch,916,6,2,2,10,18,26,-8,8
FCSB,917,1,8,6,0,25,11,14,30
CFR Cluj,917,2,6,7,1,14,7,7,25
FC Botosani,917,3,4,4,6,6,14,-8,16
Concordia Ch,917,4,4,2,8,19,22,-3,14
Universitate,917,5,3,5,6,15,21,-6,14
D Bucuresti,917,6,3,4,7,17,21,-4,13
FCSB,918,1,8,6,0,26,12,14,30
CFR Cluj,918,2,5,8,1,15,9,6,23
D Bucuresti,918,3,5,4,5,21,20,1,19
Universitate,918,4,3,6,5,16,21,-5,15
FC Botosani,918,5,3,5,6,7,16,-9,14
Concordia Ch,918,6,2,3,9,17,24,-7,9
FCSB,919,1,9,5,0,27,11,16,32
CFR Cluj,919,2,6,6,2,17,8,9,24
D Bucuresti,919,3,4,4,6,19,21,-2,16
FC Botosani,919,4,3,5,6,5,14,-9,14
Universitate,919,5,3,5,6,15,25,-10,14
Concordia Ch,919,6,3,3,8,18,22,-4,12
FCSB,920,1,8,5,1,26,13,13,29
CFR Cluj,920,2,5,7,2,14,9,5,22
Universitate,920,3,4,6,4,16,19,-3,18
D Bucuresti,920,4,4,4,6,18,19,-1,16
FC Botosani,920,5,3,5,6,5,14,-9,14
Concordia Ch,920,6,3,3,8,16,21,-5,12
FCSB,921,1,8,5,1,27,13,14,29
CFR Cluj,921,2,6,6,2,16,8,8,24
Universitate,921,3,4,5,5,15,22,-7,17
D Bucuresti,921,4,4,4,6,19,21,-2,16
FC Botosani,921,5,3,5,6,6,15,-9,14
Concordia Ch,921,6,3,3,8,19,23,-4,12
FCSB,922,1,7,7,0,24,11,13,28
CFR Cluj,922,2,6,7,1,16,7,9,25
FC Botosani,922,3,4,5,5,9,13,-4,17
Universitate,922,4,3,6,5,15,22,-7,15
D Bucuresti,922,5,3,4,7,17,23,-6,13
Concordia Ch,922,6,3,3,8,16,21,-5,12
FCSB,923,1,8,5,1,26,11,15,29
CFR Cluj,923,2,6,6,2,16,10,6,24
D Bucuresti,923,3,5,4,5,18,18,0,19
Universitate,923,4,4,5,5,17,23,-6,17
FC Botosani,923,5,3,4,7,6,15,-9,13
Concordia Ch,923,6,3,2,9,17,23,-6,11
FCSB,924,1,9,5,0,26,11,15,32
CFR Cluj,924,2,5,7,2,14,9,5,22
FC Botosani,924,3,4,5,5,9,14,-5,17
D Bucuresti,924,4,4,4,6,20,21,-1,16
Universitate,924,5,3,6,5,14,19,-5,15
Concordia Ch,924,6,2,3,9,16,25,-9,9
FCSB,925,1,9,5,0,28,10,18,32
CFR Cluj,925,2,6,6,2,15,9,6,24
D Bucuresti,925,3,5,4,5,20,18,2,19
Universitate,925,4,3,5,6,14,23,-9,14
FC Botosani,925,5,3,4,7,6,17,-11,13
Concordia Ch,925,6,3,2,9,17,23,-6,11
FCSB,926,1,9,5,0,27,11,16,32
CFR Cluj,926,2,6,6,2,14,9,5,24
FC Botosani,926,3,4,5,5,8,13,-5,17
D Bucuresti,926,4,3,5,6,18,22,-4,14
Universitate,926,5,3,5,6,15,21,-6,14
Concordia Ch,926,6,3,2,9,18,24,-6,11
FCSB,927,1,8,5,1,26,12,14,29
CFR Cluj,927,2,5,7,2,15,11,4,22
Universitate,927,3,4,6,4,18,21,-3,18
D Bucuresti,927,4,3,6,5,17,19,-2,15
FC Botosani,927,5,3,5,6,5,14,-9,14
Concordia Ch,927,6,3,3,8,18,22,-4,12
FCSB,928,1,9,5,0,27,11,16,32
CFR Cluj,928,2,5,7,2,14,9,5,22
D Bucuresti,928,3,4,5,5,19,20,-1,17
Universitate,928,4,3,6,5,16,22,-6,15
FC Botosani,928,5,3,5,6,6,14,-8,14
Concordia Ch,928,6,2,4,8,16,22,-6,10
FCSB,929,1,9,5,0,26,11,15,32
CFR Cluj,929,2,6,6,2,15,8,7,24
D Bucuresti,929,3,4,5,5,21,21,0,17
FC Botosani,929,4,3,6,5,7,14,-7,15
Universitate,929,5,3,5,6,15,22,-7,14
Concordia Ch,929,6,2,3,9,18,26,-8,9
FCSB,930,1,7,6,1,24,12,12,27
CFR Cluj,930,2,5,8,1,15,9,6,23
Universitate,930,3,4,6,4,16,19,-3,18
D Bucuresti,930,4,4,5,5,20,20,0,17
FC Botosani,930,5,4,4,6,10,16,-6,16
Concordia Ch,930,6,2,3,9,17,26,-9,9
FCSB,931,1,8,6,0,26,11,15,30
CFR Cluj,931,2,5,6,3,14,12,2,21
FC Botosani,931,3,5,4,5,9,13,-4,19
Universitate,931,4,4,6,4,18,20,-2,18
D Bucuresti,931,5,3,4,7,17,23,-6,13
Concordia Ch,931,6,3,2,9,18,23,-5,11
FCSB,932,1,8,6,0,27,13,14,30
CFR Cluj,932,2,6,6,2,14,8,6,24
FC Botosani,932,3,5,4,5,8,13,-5,19
D Bucuresti,932,4,4,4,6,18,20,-2,16
Universitate,932,5,3,6,5,17,22,-5,15
Concordia Ch,932,6,2,2,10,17,25,-8,8
FCSB,933,1,8,5,1,26,12,14,29
CFR Cluj,933,2,5,6,3,13,12,1,21
Universitate,933,3,5,5,4,18,18,0,20
D Bucuresti,933,4,4,4,6,17,20,-3,16
FC Botosani,933,5,3,5,6,6,14,-8,14
Concordia Ch,933,6,3,3,8,18,22,-4,12
CFR Cluj,934,1,7,6,1,16,7,9,27
FCSB,934,2,7,5,2,25,15,10,26
FC Botosani,934,3,4,5,5,9,12,-3,17
Universitate,934,4,4,5,5,18,22,-4,17
D Bucuresti,934,5,3,4,7,16,23,-7,13
Concordia Ch,934,6,3,3,8,16,21,-5,12
FCSB,935,1,8,5,1,26,12,14,29
CFR Cluj,935,2,6,6,2,14,10,4,24
Universitate,935,3,4,5,5,16,19,-3,17
D Bucuresti,935,4,4,4,6,17,20,-3,16
FC Botosani,935,5,3,5,6,6,14,-8,14
Concordia Ch,935,6,3,3,8,18,22,-4,12
FCSB,936,1,7,6,1,23,13,10,27
CFR Cluj,936,2,5,8,1,14,8,6,23
Universitate,936,3,4,6,4,18,19,-1,18
D Bucuresti,936,4,4,4,6,17,20,-3,16
Concordia Ch,936,5,4,2,8,19,22,-3,14
FC Botosani,936,6,3,4,7,6,15,-9,13
FCSB,937,1,7,6,1,25,13,12,27
CFR Cluj,937,2,6,7,1,18,9,9,25
D Bucuresti,937,3,5,4,5,21,19,2,19
Universitate,937,4,4,5,5,15,21,-6,17
FC Botosani,937,5,3,5,6,6,16,-10,14
Concordia Ch,937,6,2,3,9,17,24,-7,9
FCSB,938,1,9,5,0,28,11,17,32
CFR Cluj,938,2,5,6,3,14,11,3,21
Universitate,938,3,4,5,5,17,22,-5,17
FC Botosani,938,4,3,6,5,7,14,-7,15
D Bucuresti,938,5,3,5,6,18,21,-3,14
Concordia Ch,938,6,3,3,8,18,23,-5,12
FCSB,939,1,8,5,1,25,12,13,29
CFR Cluj,939,2,6,6,2,16,10,6,24
D Bucuresti,939,3,4,5,5,17,18,-1,17
Universitate,939,4,4,5,5,18,22,-4,17
FC Botosani,939,5,3,6,5,6,13,-7,15
Concordia Ch,939,6,2,3,9,16,23,-7,9
FCSB,940,1,7,5,2,23,13,10,26
CFR Cluj,940,2,6,6,2,15,9,6,24
Universitate,940,3,5,5,4,18,19,-1,20
D Bucuresti,940,4,4,5,5,18,19,-1,17
FC Botosani,940,5,3,5,6,7,15,-8,14
Concordia Ch,940,6,2,4,8,16,22,-6,10
FCSB,941,1,9,5,0,28,11,17,32
CFR Cluj,941,2,6,6,2,15,11,4,24
FC Botosani,941,3,5,4,5,10,12,-2,19
D Bucuresti,941,4,4,4,6,17,19,-2,16
Universitate,941,5,3,5,6,14,20,-6,14
Concordia Ch,941,6,2,2,10,15,26,-11,8
FCSB,942,1,8,6,0,25,10,15,30
CFR Cluj,942,2,6,7,1,14,7,7,25
FC Botosani,942,3,3,6,5,7,14,-7,15
D Bucuresti,942,4,3,5,6,17,20,-3,14
Universitate,942,5,3,5,6,14,21,-7,14
Concordia Ch,942,6,3,3,8,17,22,-5,12
FCSB,943,1,9,5,0,32,12,20,32
CFR Cluj,943,2,6,6,2,15,11,4,24
D Bucuresti,943,3,4,5,5,20,21,-1,17
FC Botosani,943,4,4,5,5,10,13,-3,17
Universitate,943,5,3,5,6,16,25,-9,14
Concordia Ch,943,6,2,2,10,17,28,-11,8
FCSB,944,1,8,5,1,26,12,14,29
CFR Cluj,944,2,6,6,2,15,9,6,24
D Bucuresti,944,3,5,4,5,18,18,0,19
Universitate,944,4,4,5,5,17,22,-5,17
FC Botosani,944,5,3,5,6,6,14,-8,14
Concordia Ch,944,6,2,3,9,16,23,-7,9
FCSB,945,1,8,6,0,26,11,15,30
CFR Cluj,945,2,6,7,1,16,7,9,25
FC Botosani,945,3,4,4,6,8,16,-8,16
Concordia Ch,945,4,4,2,8,20,22,-2,14
Universitate,945,5,3,5,6,15,24,-9,14
D Bucuresti,945,6,3,4,7,17,22,-5,13
FCSB,946,1,7,7,0,24,11,13,28
CFR Cluj,946,2,5,8,1,13,7,6,23
D Bucuresti,946,3,4,4,6,19,21,-2,16
Universitate,946,4,3,7,4,15,19,-4,16
Concordia Ch,946,5,4,2,8,19,22,-3,14
FC Botosani,946,6,3,4,7,6,16,-10,13
FCSB,947,1,8,5,1,25,12,13,29
CFR Cluj,947,2,6,6,2,16,8,8,24
Universitate,947,3,4,5,5,16,22,-6,17
FC Botosani,947,4,4,5,5,7,13,-6,17
D Bucuresti,947,5,3,6,5,17,19,-2,15
Concordia Ch,947,6,2,3,9,15,22,-7,9
FCSB,948,1,8,6,0,24,10,14,30
CFR Cluj,948,2,5,7,2,15,10,5,22
D Bucuresti,948,3,4,5,5,19,19,0,17
Universitate,948,4,4,5,5,17,21,-4,17
FC Botosani,948,5,3,5,6,6,14,-8,14
Concordia Ch,948,6,3,2,9,16,23,-7,11
FCSB,949,1,7,7,0,27,14,13,28
CFR Cluj,949,2,6,7,1,20,11,9,25
FC Botosani,949,3,5,4,5,10,12,-2,19
Universitate,949,4,3,6,5,16,23,-7,15
D Bucuresti,949,5,3,5,6,21,25,-4,14
Concordia Ch,949,6,2,3,9,20,29,-9,9
FCSB,950,1,7,7,0,28,15,13,28
CFR Cluj,950,2,6,7,1,16,9,7,25
FC Botosani,950,3,4,5,5,8,12,-4,17
Universitate,950,4,3,6,5,19,24,-5,15
D Bucuresti,950,5,3,5,6,18,21,-3,14
Concordia Ch,950,6,3,2,9,18,26,-8,11
FCSB,951,1,9,5,0,27,12,15,32
CFR Cluj,951,2,6,6,2,15,8,7,24
D Bucuresti,951,3,4,5,5,19,19,0,17
FC Botosani,951,4,4,5,5,7,13,-6,17
Universitate,951,5,3,5,6,16,23,-7,14
Concordia Ch,951,6,2,2,10,17,26,-9,8
FCSB,952,1,7,5,2,23,12,11,26
CFR Cluj,952,2,6,7,1,16,9,7,25
Universitate,952,3,4,6,4,17,20,-3,18
D Bucuresti,952,4,4,5,5,19,20,-1,17
FC Botosani,952,5,4,5,5,8,13,-5,17
Concordia Ch,952,6,2,2,10,16,25,-9,8
FCSB,953,1,8,6,0,27,12,15,30
CFR Cluj,953,2,5,7,2,13,9,4,22
FC Botosani,953,3,4,5,5,8,13,-5,17
Universitate,953,4,3,7,4,16,20,-4,16
D Bucuresti,953,5,3,6,5,16,18,-2,15
Concordia Ch,953,6,2,3,9,16,24,-8,9
FCSB,954,1,9,5,0,27,12,15,32
CFR Cluj,954,2,6,6,2,15,9,6,24
FC Botosani,954,3,4,5,5,8,14,-6,17
D Bucuresti,954,4,3,5,6,18,22,-4,14
Universitate,954,5,3,5,6,15,21,-6,14
Concordia Ch,954,6,3,2,9,17,22,-5,11
FCSB,955,1,9,5,0,26,11,15,32
CFR Cluj,955,2,5,6,3,14,10,4,21
Universitate,955,3,4,5,5,17,21,-4,17
D Bucuresti,955,4,4,4,6,19,21,-2,16
FC Botosani,955,5,3,5,6,5,13,-8,14
Concordia Ch,955,6,3,3,8,18,23,-5,12
FCSB,956,1,8,5,1,28,13,15,29
CFR Cluj,956,2,6,6,2,16,12,4,24
D Bucuresti,956,3,4,5,5,18,18,0,17
Universitate,956,4,4,5,5,15,19,-4,17
FC Botosani,956,5,3,6,5,5,12,-7,15
Concordia Ch,956,6,2,3,9,15,23,-8,9
FCSB,957,1,8,6,0,25,11,14,30
CFR Cluj,957,2,6,6,2,16,8,8,24
D Bucuresti,957,3,4,4,6,19,20,-1,16
FC Botosani,957,4,4,4,6,8,15,-7,16
Universitate,957,5,3,6,5,15,22,-7,15
Concordia Ch,957,6,3,2,9,19,26,-7,11
CFR Cluj,958,1,7,6,1,17,8,9,27
FCSB,958,2,7,5,2,24,13,11,26
FC Botosani,958,3,4,5,5,8,12,-4,17
Universitate,958,4,4,5,5,15,20,-5,17
D Bucuresti,958,5,3,5,6,16,21,-5,14
Concordia Ch,958,6,3,2,9,18,24,-6,11
FCSB,959,1,8,5,1,26,12,14,29
CFR Cluj,959,2,5,7,2,15,11,4,22
FC Botosani,959,3,5,4,5,12,16,-4,19
Universitate,959,4,4,6,4,16,19,-3,18
D Bucuresti,959,5,3,4,7,20,24,-4,13
Concordia Ch,959,6,3,2,9,20,27,-7,11
FCSB,960,1,8,5,1,25,12,13,29
CFR Cluj,960,2,6,6,2,15,8,7,24
D Bucuresti,960,3,4,5,5,20,20,0,17
Universitate,960,4,4,5,5,16,21,-5,17
FC Botosani,960,5,4,4,6,8,16,-8,16
Concordia Ch,960,6,2,3,9,15,22,-7,9
FCSB,961,1,8,6,0,28,13,15,30
CFR Cluj,961,2,6,7,1,20,10,10,25
FC Botosani,961,3,5,4,5,8,13,-5,19
D Bucuresti,961,4,4,4,6,19,19,0,16
Universitate,961,5,3,5,6,16,26,-10,14
Concordia Ch,961,6,2,2,10,16,26,-10,8
FCSB,962,1,7,6,1,25,13,12,27
CFR Cluj,962,2,6,7,1,17,10,7,25
Universitate,962,3,4,5,5,16,20,-4,17
D Bucuresti,962,4,4,4,6,20,22,-2,16
Concordia Ch,962,5,4,2,8,19,23,-4,14
FC Botosani,962,6,3,4,7,6,15,-9,13
FCSB,963,1,7,6,1,24,13,11,27
CFR Cluj,963,2,7,6,1,17,7,10,27
FC Botosani,963,3,4,5,5,8,14,-6,17
D Bucuresti,963,4,4,4,6,19,21,-2,16
Universitate,963,5,3,6,5,15,21,-6,15
Concordia Ch,963,6,2,3,9,15,22,-7,9
CFR Cluj,964,1,7,6,1,15,7,8,27
FCSB,964,2,7,5,2,25,14,11,26
FC Botosani,964,3,5,4,5,9,13,-4,19
Universitate,964,4,4,5,5,17,21,-4,17
D Bucuresti,964,5,3,5,6,18,21,-3,14
Concordia Ch,964,6,2,3,9,16,24,-8,9
FCSB,965,1,9,5,0,28,12,16,32
CFR Cluj,965,2,5,6,3,15,14,1,21
Universitate,965,3,4,5,5,19,21,-2,17
FC Botosani,965,4,4,4,6,6,13,-7,16
Concordia Ch,965,5,4,2,8,18,22,-4,14
D Bucuresti,965,6,3,4,7,17,21,-4,13
FCSB,966,1,8,5,1,25,12,13,29
CFR Cluj,966,2,6,6,2,17,8,9,24
Universitate,966,3,4,5,5,16,23,-7,17
FC Botosani,966,4,3,6,5,6,13,-7,15
D Bucuresti,966,5,3,5,6,17,20,-3,14
Concordia Ch,966,6,3,3,8,16,21,-5,12
FCSB,967,1,8,5,1,24,12,12,29
CFR Cluj,967,2,5,7,2,13,8,5,22
Universitate,967,3,4,6,4,16,18,-2,18
FC Botosani,967,4,4,5,5,10,13,-3,17
D Bucuresti,967,5,3,5,6,16,19,-3,14
Concordia Ch,967,6,3,2,9,17,26,-9,11
FCSB,968,1,8,6,0,26,11,15,30
CFR Cluj,968,2,5,7,2,14,9,5,22
D Bucuresti,968,3,4,5,5,20,21,-1,17
Universitate,968,4,4,5,5,15,20,-5,17
FC Botosani,968,5,4,4,6,8,14,-6,16
Concordia Ch,968,6,2,3,9,19,27,-8,9
FCSB,969,1,7,6,1,24,13,11,27
CFR Cluj,969,2,6,7,1,16,8,8,25
FC Botosani,969,3,5,4,5,10,14,-4,19
Universitate,969,4,4,5,5,16,20,-4,17
D Bucuresti,969,5,3,5,6,18,21,-3,14
Concordia Ch,969,6,2,3,9,17,25,-8,9
FCSB,970,1,9,5,0,29,11,18,32
CFR Cluj,970,2,5,6,3,14,13,1,21
D Bucuresti,970,3,4,5,5,18,19,-1,17
Universitate,970,4,4,5,5,17,21,-4,17
FC Botosani,970,5,4,5,5,6,12,-6,17
Concordia Ch,970,6,2,2,10,16,24,-8,8
FCSB,971,1,7,5,2,25,14,11,26
CFR Cluj,971,2,6,7,1,15,8,7,25
Universitate,971,3,4,6,4,16,19,-3,18
D Bucuresti,971,4,4,4,6,17,20,-3,16
FC Botosani,971,5,4,4,6,7,14,-7,16
Concordia Ch,971,6,3,2,9,18,23,-5,11
FCSB,972,1,7,5,2,24,13,11,26
CFR Cluj,972,2,6,7,1,17,10,7,25
Universitate,972,3,4,6,4,17,20,-3,18
D Bucuresti,972,4,4,4,6,18,19,-1,16
FC Botosani,972,5,3,5,6,5,14,-9,14
Concordia Ch,972,6,3,3,8,16,21,-5,12
FCSB,973,1,8,6,0,28,12,16,30
CFR Cluj,973,2,6,6,2,16,11,5,24
Universitate,973,3,3,6,5,17,23,-6,15
FC Botosani,973,4,3,6,5,6,13,-7,15
D Bucuresti,973,5,3,5,6,18,21,-3,14
Concordia Ch,973,6,3,3,8,19,24,-5,12
FCSB,974,1,8,5,1,25,11,14,29
CFR Cluj,974,2,5,7,2,15,11,4,22
Universitate,974,3,4,6,4,17,20,-3,18
D Bucuresti,974,4,4,4,6,19,22,-3,16
Concordia Ch,974,5,4,2,8,22,23,-1,14
FC Botosani,974,6,3,4,7,5,16,-11,13
FCSB,975,1,7,6,1,25,13,12,27
CFR Cluj,975,2,6,7,1,15,8,7,25
FC Botosani,975,3,4,5,5,10,15,-5,17
Universitate,975,4,3,7,4,15,19,-4,16
D Bucuresti,975,5,3,5,6,17,20,-3,14
Concordia Ch,975,6,3,2,9,18,25,-7,11
FCSB,976,1,8,5,1,26,13,13,29
CFR Cluj,976,2,5,6,3,15,12,3,21
Universitate,976,3,5,5,4,18,19,-1,20
Concordia Ch,976,4,4,2,8,21,23,-2,14
D Bucuresti,976,5,3,5,6,20,25,-5,14
FC Botosani,976,6,3,5,6,7,15,-8,14
FCSB,977,1,9,5,0,29,10,19,32
CFR Cluj,977,2,6,6,2,15,10,5,24
D Bucuresti,977,3,4,4,6,18,20,-2,16
FC Botosani,977,4,3,5,6,5,13,-8,14
Universitate,977,5,3,5,6,14,23,-9,14
Concordia Ch,977,6,3,3,8,17,22,-5,12
FCSB,978,1,9,5,0,27,11,16,32
CFR Cluj,978,2,5,6,3,15,11,4,21
Universitate,978,3,4,5,5,16,21,-5,17
D Bucuresti,978,4,3,6,5,18,20,-2,15
FC Botosani,978,5,3,5,6,6,14,-8,14
Concordia Ch,978,6,3,3,8,17,22,-5,12
FCSB,979,1,8,6,0,24,10,14,30
CFR Cluj,979,2,5,6,3,14,11,3,21
FC Botosani,979,3,5,4,5,10,13,-3,19
Universitate,979,4,4,6,4,17,19,-2,18
D Bucuresti,979,5,3,4,7,17,22,-5,13
Concordia Ch,979,6,3,2,9,16,23,-7,11
FCSB,980,1,8,6,0,27,12,15,30
CFR Cluj,980,2,6,7,1,17,10,7,25
D Bucuresti,980,3,4,5,5,19,20,-1,17
Universitate,980,4,3,5,6,17,24,-7,14
FC Botosani,980,5,3,5,6,6,14,-8,14
Concordia Ch,980,6,3,2,9,17,23,-6,11
FCSB,981,1,8,6,0,27,13,14,30
CFR Cluj,981,2,5,7,2,15,10,5,22
Universitate,981,3,3,7,4,17,21,-4,16
FC Botosani,981,4,3,6,5,5,12,-7,15
D Bucuresti,981,5,3,5,6,16,19,-3,14
Concordia Ch,981,6,3,3,8,16,21,-5,12
FCSB,982,1,7,6,1,24,12,12,27
CFR Cluj,982,2,7,6,1,17,7,10,27
D Bucuresti,982,3,4,4,6,17,20,-3,16
FC Botosani,982,4,4,4,6,7,13,-6,16
Universitate,982,5,3,6,5,15,22,-7,15
Concordia Ch,982,6,3,2,9,17,23,-6,11
FCSB,983,1,8,5,1,26,12,14,29
CFR Cluj,983,2,6,6,2,15,10,5,24
D Bucuresti,983,3,4,5,5,18,18,0,17
Universitate,983,4,4,5,5,18,22,-4,17
FC Botosani,983,5,3,4,7,5,16,-11,13
Concordia Ch,983,6,3,3,8,17,21,-4,12
FCSB,984,1,8,6,0,26,11,15,30
CFR Cluj,984,2,5,6,3,13,11,2,21
Universitate,984,3,4,6,4,17,19,-2,18
FC Botosani,984,4,4,5,5,7,12,-5,17
D Bucuresti,984,5,3,6,5,19,21,-2,15
Concordia Ch,984,6,2,3,9,18,26,-8,9
FCSB,985,1,8,5,1,26,13,13,29
CFR Cluj,985,2,6,6,2,14,9,5,24
FC Botosani,985,3,5,4,5,9,12,-3,19
Universitate,985,4,4,5,5,17,20,-3,17
D Bucuresti,985,5,3,4,7,16,22,-6,13
Concordia Ch,985,6,3,2,9,17,23,-6,11
FCSB,986,1,8,5,1,25,12,13,29
CFR Cluj,986,2,6,7,1,16,9,7,25
FC Botosani,986,3,4,5,5,10,13,-3,17
Universitate,986,4,3,6,5,15,20,-5,15
D Bucuresti,986,5,3,5,6,18,24,-6,14
Concordia Ch,986,6,2,4,8,16,22,-6,10
FCSB,987,1,8,5,1,26,12,14,29
CFR Cluj,987,2,5,6,3,14,11,3,21
Universitate,987,3,5,5,4,18,20,-2,20
FC Botosani,987,4,4,5,5,10,13,-3,17
D Bucuresti,987,5,3,6,5,19,21,-2,15
Concordia Ch,987,6,2,3,9,17,27,-10,9
FCSB,988,1,8,6,0,27,11,16,30
CFR Cluj,988,2,5,7,2,13,10,3,22
FC Botosani,988,3,5,4,5,9,12,-3,19
D Bucuresti,988,4,4,4,6,17,19,-2,16
Universitate,988,5,3,7,4,15,19,-4,16
Concordia Ch,988,6,2,2,10,15,25,-10,8
FCSB,989,1,8,5,1,26,14,12,29
CFR Cluj,989,2,7,6,1,18,9,9,27
D Bucuresti,989,3,5,4,5,21,18,3,19
Universitate,989,4,3,5,6,14,20,-6,14
FC Botosani,989,5,3,4,7,6,18,-12,13
Concordia Ch,989,6,3,2,9,17,23,-6,11
FCSB,990,1,8,5,1,26,12,14,29
CFR Cluj,990,2,5,6,3,13,10,3,21
Universitate,990,3,5,5,4,17,19,-2,20
D Bucuresti,990,4,5,4,5,20,20,0,19
FC Botosani,990,5,3,5,6,5,13,-8,14
Concordia Ch,990,6,2,3,9,17,24,-7,9
FCSB,991,1,8,6,0,25,11,14,30
CFR Cluj,991,2,5,7,2,14,9,5,22
D Bucuresti,991,3,4,5,5,17,18,-1,17
Universitate,991,4,3,7,4,14,18,-4,16
FC Botosani,991,5,3,6,5,6,13,-7,15
Concordia Ch,991,6,2,3,9,16,23,-7,9
FCSB,992,1,8,6,0,26,12,14,30
CFR Cluj,992,2,6,7,1,17,9,8,25
D Bucuresti,992,3,4,4,6,19,20,-1,16
Universitate,992,4,3,5,6,16,23,-7,14
FC Botosani,992,5,3,5,6,8,17,-9,14
Concordia Ch,992,6,3,3,8,18,23,-5,12
FCSB,993,1,8,6,0,27,11,16,30
CFR Cluj,993,2,5,6,3,13,11,2,21
Universitate,993,3,4,6,4,16,19,-3,18
D Bucuresti,993,4,3,6,5,18,20,-2,15
FC Botosani,993,5,3,5,6,7,17,-10,14
Concordia Ch,993,6,3,3,8,18,21,-3,12
FCSB,994,1,8,6,0,28,11,17,30
CFR Cluj,994,2,5,7,2,16,11,5,22
D Bucuresti,994,3,5,4,5,20,20,0,19
Universitate,994,4,4,5,5,17,24,-7,17
FC Botosani,994,5,4,4,6,8,14,-6,16
Concordia Ch,994,6,2,2,10,16,25,-9,8
CFR Cluj,995,1,7,6,1,16,7,9,27
FCSB,995,2,7,5,2,23,14,9,26
Universitate,995,3,4,5,5,16,19,-3,17
D Bucuresti,995,4,4,4,6,18,19,-1,16
Concordia Ch,995,5,4,2,8,19,22,-3,14
FC Botosani,995,6,3,4,7,6,17,-11,13
FCSB,996,1,9,5,0,27,10,17,32
CFR Cluj,996,2,6,6,2,15,8,7,24
D Bucuresti,996,3,4,5,5,20,20,0,17
FC Botosani,996,4,4,4,6,9,16,-7,16
Universitate,996,5,3,5,6,14,23,-9,14
Concordia Ch,996,6,2,3,9,15,23,-8,9
FCSB,997,1,9,5,0,27,10,17,32
CFR Cluj,997,2,5,7,2,14,10,4,22
D Bucuresti,997,3,4,4,6,18,22,-4,16
Universitate,997,4,3,6,5,15,21,-6,15
Concordia Ch,997,5,4,2,8,19,21,-2,14
FC Botosani,997,6,3,4,7,6,15,-9,13
FCSB,998,1,9,5,0,32,14,18,32
CFR Cluj,998,2,5,6,3,17,16,1,21
Universitate,998,3,4,5,5,18,22,-4,17
D Bucuresti,998,4,4,4,6,19,20,-1,16
Concordia Ch,998,5,4,2,8,19,21,-2,14
FC Botosani,998,6,3,4,7,5,17,-12,13
FCSB,999,1,8,6,0,25,11,14,30
CFR Cluj,999,2,6,6,2,15,9,6,24
FC Botosani,999,3,5,4,5,9,13,-4,19
Universitate,999,4,3,6,5,16,21,-5,15
D Bucuresti,999,5,3,5,6,18,21,-3,14
Concordia Ch,999,6,2,3,9,16,24,-8,9
FCSB,1000,1,9,5,0,27,10,17,32
CFR Cluj,1000,2,5,7,2,13,10,3,22
Universitate,1000,3,3,6,5,14,19,-5,15
FC Botosani,1000,4,3,6,5,6,13,-7,15
D Bucuresti,1000,5,3,5,6,16,19,-3,14
Concordia Ch,1000,6,3,3,8,17,22,-5,12
FCSB,1001,1,8,6,0,27,12,15,30
CFR Cluj,1001,2,6,7,1,16,9,7,25
FC Botosani,1001,3,5,4,5,7,12,-5,19
Universitate,1001,4,3,5,6,14,21,-7,14
D Bucuresti,1001,5,3,4,7,16,22,-6,13
Concordia Ch,1001,6,3,2,9,18,22,-4,11
FCSB,1002,1,9,5,0,28,11,17,32
CFR Cluj,1002,2,6,6,2,14,9,5,24
FC Botosani,1002,3,5,4,5,9,13,-4,19
D Bucuresti,1002,4,4,4,6,19,20,-1,16
Universitate,1002,5,3,5,6,15,22,-7,14
Concordia Ch,1002,6,2,2,10,15,25,-10,8
FCSB,1003,1,8,5,1,25,12,13,29
CFR Cluj,1003,2,5,7,2,14,9,5,22
Universitate,1003,3,4,6,4,17,20,-3,18
FC Botosani,1003,4,4,5,5,8,13,-5,17
D Bucuresti,1003,5,3,4,7,16,21,-5,13
Concordia Ch,1003,6,3,3,8,17,22,-5,12
FCSB,1004,1,8,5,1,25,12,13,29
CFR Cluj,1004,2,5,7,2,16,11,5,22
Universitate,1004,3,4,6,4,17,20,-3,18
D Bucuresti,1004,4,4,4,6,18,20,-2,16
Concordia Ch,1004,5,4,2,8,18,22,-4,14
FC Botosani,1004,6,3,4,7,5,14,-9,13
FCSB,1005,1,7,6,1,24,13,11,27
CFR Cluj,1005,2,5,8,1,14,8,6,23
Universitate,1005,3,4,6,4,18,20,-2,18
FC Botosani,1005,4,4,5,5,12,17,-5,17
D Bucuresti,1005,5,3,5,6,19,23,-4,14
Concordia Ch,1005,6,3,2,9,21,27,-6,11
FCSB,1006,1,9,5,0,29,13,16,32
CFR Cluj,1006,2,6,6,2,15,10,5,24
D Bucuresti,1006,3,4,4,6,18,20,-2,16
Concordia Ch,1006,4,4,2,8,18,22,-4,14
Universitate,1006,5,3,5,6,16,22,-6,14
FC Botosani,1006,6,3,4,7,5,14,-9,13
FCSB,1007,1,7,7,0,23,10,13,28
CFR Cluj,1007,2,6,7,1,16,7,9,25
FC Botosani,1007,3,4,5,5,7,13,-6,17
Universitate,1007,4,3,6,5,14,21,-7,15
D Bucuresti,1007,5,3,5,6,17,20,-3,14
Concordia Ch,1007,6,3,2,9,16,22,-6,11
FCSB,1008,1,8,6,0,25,11,14,30
CFR Cluj,1008,2,5,7,2,14,9,5,22
D Bucuresti,1008,3,5,4,5,19,18,1,19
Universitate,1008,4,4,5,5,17,21,-4,17
FC Botosani,1008,5,4,4,6,7,15,-8,16
Concordia Ch,1008,6,2,2,10,16,24,-8,8
FCSB,1009,1,8,5,1,27,14,13,29
CFR Cluj,1009,2,7,6,1,18,8,10,27
FC Botosani,1009,3,4,4,6,8,14,-6,16
D Bucuresti,1009,4,3,5,6,18,22,-4,14
Universitate,1009,5,3,5,6,14,22,-8,14
Concordia Ch,1009,6,3,3,8,17,22,-5,12
FCSB,1010,1,9,5,0,26,10,16,32
CFR Cluj,1010,2,6,6,2,18,10,8,24
FC Botosani,1010,3,4,5,5,9,13,-4,17
Universitate,1010,4,3,5,6,16,25,-9,14
D Bucuresti,1010,5,3,4,7,16,22,-6,13
Concordia Ch,1010,6,3,3,8,17,22,-5,12
CFR Cluj,1011,1,7,6,1,16,8,8,27
FCSB,1011,2,7,5,2,25,14,11,26
D Bucuresti,1011,3,4,5,5,18,18,0,17
Universitate,1011,4,4,5,5,16,20,-4,17
FC Botosani,1011,5,4,4,6,9,16,-7,16
Concordia Ch,1011,6,2,3,9,17,25,-8,9
FCSB,1012,1,8,5,1,26,13,13,29
CFR Cluj,1012,2,5,7,2,15,10,5,22
Universitate,1012,3,4,6,4,17,20,-3,18
D Bucuresti,1012,4,4,4,6,20,22,-2,16
Concordia Ch,1012,5,4,2,8,18,22,-4,14
FC Botosani,1012,6,3,4,7,7,16,-9,13
FCSB,1013,1,7,6,1,25,13,12,27
CFR Cluj,1013,2,7,6,1,20,9,11,27
D Bucuresti,1013,3,5,4,5,22,18,4,19
Universitate,1013,4,3,6,5,16,24,-8,15
FC Botosani,1013,5,3,5,6,5,14,-9,14
Concordia Ch,1013,6,2,3,9,15,25,-10,9
FCSB,1014,1,8,6,0,25,10,15,30
CFR Cluj,1014,2,6,6,2,15,9,6,24
D Bucuresti,1014,3,4,4,6,18,21,-3,16
FC Botosani,1014,4,4,4,6,7,14,-7,16
Universitate,1014,5,3,6,5,14,20,-6,15
Concordia Ch,1014,6,3,2,9,17,22,-5,11
FCSB,1015,1,7,6,1,23,12,11,27
CFR Cluj,1015,2,6,7,1,15,8,7,25
D Bucuresti,1015,3,4,5,5,21,18,3,17
Universitate,1015,4,4,5,5,17,20,-3,17
FC Botosani,1015,5,3,6,5,6,13,-7,15
Concordia Ch,1015,6,2,3,9,16,27,-11,9
FCSB,1016,1,9,5,0,27,10,17,32
CFR Cluj,1016,2,6,6,2,15,9,6,24
D Bucuresti,1016,3,4,5,5,19,19,0,17
FC Botosani,1016,4,4,4,6,7,15,-8,16
Universitate,1016,5,3,5,6,14,22,-8,14
Concordia Ch,1016,6,2,3,9,17,24,-7,9
FCSB,1017,1,7,7,0,25,12,13,28
CFR Cluj,1017,2,6,7,1,16,7,9,25
FC Botosani,1017,3,5,4,5,8,12,-4,19
Universitate,1017,4,3,6,5,16,23,-7,15
D Bucuresti,1017,5,3,4,7,17,22,-5,13
Concordia Ch,1017,6,3,2,9,18,24,-6,11
FCSB,1018,1,7,5,2,24,13,11,26
CFR Cluj,1018,2,6,7,1,16,9,7,25
Universitate,1018,3,4,6,4,16,19,-3,18
FC Botosani,1018,4,4,5,5,7,12,-5,17
D Bucuresti,1018,5,3,5,6,16,19,-3,14
Concordia Ch,1018,6,3,2,9,16,23,-7,11
FCSB,1019,1,9,5,0,27,12,15,32
CFR Cluj,1019,2,5,6,3,13,9,4,21
Universitate,1019,3,4,5,5,17,21,-4,17
D Bucuresti,1019,4,4,4,6,19,22,-3,16
FC Botosani,1019,5,4,4,6,6,14,-8,16
Concordia Ch,1019,6,3,2,9,19,23,-4,11
FCSB,1020,1,9,5,0,27,11,16,32
CFR Cluj,1020,2,6,6,2,14,9,5,24
D Bucuresti,1020,3,5,4,5,22,19,3,19
Universitate,1020,4,3,5,6,15,21,-6,14
FC Botosani,1020,5,3,4,7,5,16,-11,13
Concordia Ch,1020,6,3,2,9,17,24,-7,11
FCSB,1021,1,8,6,0,26,12,14,30
CFR Cluj,1021,2,6,6,2,15,9,6,24
D Bucuresti,1021,3,4,5,5,19,20,-1,17
Universitate,1021,4,3,6,5,17,22,-5,15
FC Botosani,1021,5,3,5,6,7,15,-8,14
Concordia Ch,1021,6,2,4,8,17,23,-6,10
FCSB,1022,1,9,5,0,27,10,17,32
CFR Cluj,1022,2,5,6,3,13,10,3,21
Universitate,1022,3,4,5,5,15,20,-5,17
FC Botosani,1022,4,3,6,5,5,12,-7,15
D Bucuresti,1022,5,3,5,6,16,19,-3,14
Concordia Ch,1022,6,3,3,8,16,21,-5,12
FCSB,1023,1,8,5,1,27,14,13,29
CFR Cluj,1023,2,5,6,3,13,13,0,21
Universitate,1023,3,5,5,4,20,18,2,20
FC Botosani,1023,4,4,5,5,6,12,-6,17
D Bucuresti,1023,5,3,5,6,17,20,-3,14
Concordia Ch,1023,6,2,4,8,16,22,-6,10
FCSB,1024,1,9,5,0,29,14,15,32
CFR Cluj,1024,2,6,6,2,16,10,6,24
FC Botosani,1024,3,5,4,5,11,13,-2,19
D Bucuresti,1024,4,4,4,6,20,22,-2,16
Universitate,1024,5,3,5,6,18,24,-6,14
Concordia Ch,1024,6,2,2,10,16,27,-11,8
FCSB,1025,1,8,5,1,24,11,13,29
CFR Cluj,1025,2,6,6,2,14,8,6,24
D Bucuresti,1025,3,5,4,5,20,18,2,19
Universitate,1025,4,4,5,5,15,19,-4,17
FC Botosani,1025,5,3,4,7,6,15,-9,13
Concordia Ch,1025,6,3,2,9,17,25,-8,11
FCSB,1026,1,8,6,0,26,11,15,30
CFR Cluj,1026,2,5,7,2,17,13,4,22
D Bucuresti,1026,3,4,4,6,20,23,-3,16
Universitate,1026,4,3,7,4,17,21,-4,16
Concordia Ch,1026,5,4,2,8,21,24,-3,14
FC Botosani,1026,6,3,4,7,9,18,-9,13
FCSB,1027,1,8,5,1,27,13,14,29
CFR Cluj,1027,2,6,7,1,15,8,7,25
D Bucuresti,1027,3,4,5,5,19,19,0,17
FC Botosani,1027,4,4,5,5,6,12,-6,17
Universitate,1027,5,3,6,5,17,23,-6,15
Concordia Ch,1027,6,2,2,10,16,25,-9,8
FCSB,1028,1,8,6,0,26,11,15,30
CFR Cluj,1028,2,6,7,1,16,8,8,25
FC Botosani,1028,3,4,5,5,8,13,-5,17
D Bucuresti,1028,4,3,5,6,18,22,-4,14
Universitate,1028,5,3,5,6,14,22,-8,14
Concordia Ch,1028,6,2,4,8,18,24,-6,10
FCSB,1029,1,7,5,2,23,13,10,26
CFR Cluj,1029,2,6,7,1,14,7,7,25
Universitate,1029,3,4,6,4,16,18,-2,18
FC Botosani,1029,4,4,5,5,7,13,-6,17
D Bucuresti,1029,5,3,4,7,17,21,-4,13
Concordia Ch,1029,6,3,3,8,18,23,-5,12
FCSB,1030,1,8,5,1,25,14,11,29
CFR Cluj,1030,2,5,7,2,14,9,5,22
Universitate,1030,3,4,6,4,19,20,-1,18
D Bucuresti,1030,4,3,6,5,18,20,-2,15
FC Botosani,1030,5,3,5,6,6,14,-8,14
Concordia Ch,1030,6,3,3,8,17,22,-5,12
FCSB,1031,1,7,6,1,24,12,12,27
CFR Cluj,1031,2,7,6,1,17,9,8,27
D Bucuresti,1031,3,4,4,6,18,20,-2,16
FC Botosani,1031,4,4,4,6,6,14,-8,16
Universitate,1031,5,3,6,5,15,20,-5,15
Concordia Ch,1031,6,3,2,9,17,22,-5,11
FCSB,1032,1,9,5,0,27,11,16,32
CFR Cluj,1032,2,5,7,2,15,11,4,22
FC Botosani,1032,3,4,5,5,6,12,-6,17
Universitate,1032,4,3,6,5,15,20,-5,15
D Bucuresti,1032,5,3,5,6,16,20,-4,14
Concordia Ch,1032,6,3,2,9,17,22,-5,11
FCSB,1033,1,7,6,1,23,12,11,27
CFR Cluj,1033,2,5,7,2,13,8,5,22
Universitate,1033,3,5,5,4,17,18,-1,20
FC Botosani,1033,4,4,5,5,7,12,-5,17
D Bucuresti,1033,5,3,5,6,17,20,-3,14
Concordia Ch,1033,6,3,2,9,17,24,-7,11
FCSB,1034,1,7,7,0,24,11,13,28
CFR Cluj,1034,2,5,7,2,14,9,5,22
D Bucuresti,1034,3,5,4,5,21,19,2,19
Universitate,1034,4,4,6,4,15,18,-3,18
FC Botosani,1034,5,4,4,6,8,15,-7,16
Concordia Ch,1034,6,2,2,10,16,26,-10,8
FCSB,1035,1,8,6,0,25,10,15,30
CFR Cluj,1035,2,5,6,3,14,12,2,21
Universitate,1035,3,4,6,4,17,19,-2,18
D Bucuresti,1035,4,4,4,6,23,20,3,16
FC Botosani,1035,5,4,4,6,8,19,-11,16
Concordia Ch,1035,6,3,2,9,16,23,-7,11
FCSB,1036,1,8,6,0,28,12,16,30
CFR Cluj,1036,2,5,6,3,14,12,2,21
Universitate,1036,3,4,6,4,18,21,-3,18
D Bucuresti,1036,4,4,5,5,19,20,-1,17
FC Botosani,1036,5,4,4,6,8,15,-7,16
Concordia Ch,1036,6,2,3,9,17,24,-7,9
FCSB,1037,1,8,6,0,28,11,17,30
CFR Cluj,1037,2,5,7,2,14,10,4,22
Universitate,1037,3,4,5,5,16,22,-6,17
D Bucuresti,1037,4,4,4,6,20,23,-3,16
Concordia Ch,1037,5,4,2,8,20,22,-2,14
FC Botosani,1037,6,3,4,7,7,17,-10,13
FCSB,1038,1,7,6,1,25,13,12,27
CFR Cluj,1038,2,6,7,1,15,8,7,25
FC Botosani,1038,3,4,5,5,10,14,-4,17
Universitate,1038,4,3,7,4,15,19,-4,16
D Bucuresti,1038,5,3,5,6,18,24,-6,14
Concordia Ch,1038,6,3,2,9,19,24,-5,11
FCSB,1039,1,8,5,1,26,13,13,29
CFR Cluj,1039,2,5,7,2,14,9,5,22
Universitate,1039,3,4,6,4,16,19,-3,18
D Bucuresti,1039,4,4,4,6,20,21,-1,16
FC Botosani,1039,5,4,4,6,7,14,-7,16
Concordia Ch,1039,6,3,2,9,18,25,-7,11
FCSB,1040,1,8,5,1,26,11,15,29
CFR Cluj,1040,2,6,6,2,16,11,5,24
Universitate,1040,3,4,5,5,16,21,-5,17
FC Botosani,1040,4,3,6,5,7,14,-7,15
D Bucuresti,1040,5,3,5,6,18,21,-3,14
Concordia Ch,1040,6,3,3,8,18,23,-5,12
FCSB,1041,1,7,7,0,24,11,13,28
CFR Cluj,1041,2,6,7,1,16,7,9,25
D Bucuresti,1041,3,4,4,6,17,20,-3,16
Universitate,1041,4,3,6,5,15,22,-7,15
FC Botosani,1041,5,3,5,6,6,14,-8,14
Concordia Ch,1041,6,3,3,8,18,22,-4,12
FCSB,1042,1,9,5,0,29,11,18,32
CFR Cluj,1042,2,6,6,2,16,9,7,24
FC Botosani,1042,3,5,4,5,9,13,-4,19
Universitate,1042,4,3,5,6,15,25,-10,14
D Bucuresti,1042,5,3,4,7,16,21,-5,13
Concordia Ch,1042,6,3,2,9,17,23,-6,11
FCSB,1043,1,8,5,1,25,11,14,29
CFR Cluj,1043,2,6,6,2,14,9,5,24
Universitate,1043,3,4,5,5,15,19,-4,17
FC Botosani,1043,4,4,5,5,7,13,-6,17
D Bucuresti,1043,5,3,5,6,18,21,-3,14
Concordia Ch,1043,6,3,2,9,17,23,-6,11
FCSB,1044,1,8,6,0,27,12,15,30
CFR Cluj,1044,2,5,6,3,13,10,3,21
Universitate,1044,3,4,6,4,17,20,-3,18
FC Botosani,1044,4,3,6,5,8,15,-7,15
D Bucuresti,1044,5,3,5,6,19,22,-3,14
Concordia Ch,1044,6,3,3,8,18,23,-5,12
FCSB,1045,1,7,7,0,23,10,13,28
CFR Cluj,1045,2,5,7,2,13,12,1,22
Universitate,1045,3,4,6,4,19,18,1,18
D Bucuresti,1045,4,4,4,6,20,21,-1,16
FC Botosani,1045,5,3,5,6,7,17,-10,14
Concordia Ch,1045,6,3,3,8,20,24,-4,12
FCSB,1046,1,8,6,0,25,11,14,30
CFR Cluj,1046,2,6,6,2,16,10,6,24
D Bucuresti,1046,3,4,4,6,18,21,-3,16
Universitate,1046,4,3,6,5,15,20,-5,15
FC Botosani,1046,5,3,5,6,6,15,-9,14
Concordia Ch,1046,6,3,3,8,19,22,-3,12
FCSB,1047,1,9,5,0,26,10,16,32
CFR Cluj,1047,2,5,7,2,14,10,4,22
D Bucuresti,1047,3,4,4,6,17,20,-3,16
Universitate,1047,4,3,6,5,15,20,-5,15
FC Botosani,1047,5,3,5,6,6,14,-8,14
Concordia Ch,1047,6,3,3,8,18,22,-4,12
FCSB,1048,1,8,6,0,25,11,14,30
CFR Cluj,1048,2,6,6,2,18,9,9,24
FC Botosani,1048,3,4,4,6,7,15,-8,16
Universitate,1048,4,3,6,5,16,24,-8,15
Concordia Ch,1048,5,4,2,8,19,21,-2,14
D Bucuresti,1048,6,3,4,7,17,22,-5,13
FCSB,1049,1,7,7,0,25,12,13,28
CFR Cluj,1049,2,5,8,1,15,9,6,23
D Bucuresti,1049,3,4,5,5,18,19,-1,17
FC Botosani,1049,4,4,5,5,7,13,-6,17
Universitate,1049,5,3,7,4,16,20,-4,16
Concordia Ch,1049,6,2,2,10,15,23,-8,8
FCSB,1050,1,7,5,2,24,14,10,26
CFR Cluj,1050,2,6,7,1,15,8,7,25
Universitate,1050,3,4,6,4,16,18,-2,18
D Bucuresti,1050,4,4,5,5,20,21,-1,17
FC Botosani,1050,5,4,4,6,7,14,-7,16
Concordia Ch,1050,6,2,3,9,17,24,-7,9
FCSB,1051,1,9,5,0,26,10,16,32
CFR Cluj,1051,2,5,7,2,14,10,4,22
D Bucuresti,1051,3,5,4,5,21,20,1,19
Universitate,1051,4,3,6,5,15,20,-5,15
FC Botosani,1051,5,3,5,6,8,16,-8,14
Concordia Ch,1051,6,2,3,9,18,26,-8,9
FCSB,1052,1,8,5,1,26,13,13,29
CFR Cluj,1052,2,6,6,2,16,11,5,24
Universitate,1052,3,4,5,5,17,20,-3,17
D Bucuresti,1052,4,4,4,6,19,21,-2,16
FC Botosani,1052,5,4,4,6,6,15,-9,16
Concordia Ch,1052,6,3,2,9,18,22,-4,11
CFR Cluj,1053,1,7,6,1,15,7,8,27
FCSB,1053,2,7,5,2,24,15,9,26
D Bucuresti,1053,3,5,4,5,19,19,0,19
Universitate,1053,4,4,5,5,18,20,-2,17
FC Botosani,1053,5,3,4,7,6,15,-9,13
Concordia Ch,1053,6,3,2,9,18,24,-6,11
FCSB,1054,1,7,5,2,24,15,9,26
CFR Cluj,1054,2,6,7,1,18,10,8,25
FC Botosani,1054,3,5,4,5,8,12,-4,19
Universitate,1054,4,4,6,4,18,20,-2,18
D Bucuresti,1054,5,3,4,7,16,22,-6,13
Concordia Ch,1054,6,3,2,9,17,22,-5,11
FCSB,1055,1,9,5,0,25,10,15,32
CFR Cluj,1055,2,5,6,3,14,10,4,21
FC Botosani,1055,3,5,4,5,10,12,-2,19
Universitate,1055,4,4,5,5,16,20,-4,17
D Bucuresti,1055,5,4,4,6,20,22,-2,16
Concordia Ch,1055,6,2,2,10,18,29,-11,8
FCSB,1056,1,7,7,0,24,11,13,28
CFR Cluj,1056,2,5,8,1,14,8,6,23
D Bucuresti,1056,3,5,4,5,19,18,1,19
Universitate,1056,4,3,7,4,16,20,-4,16
FC Botosani,1056,5,3,4,7,5,15,-10,13
Concordia Ch,1056,6,3,2,9,16,22,-6,11
FCSB,1057,1,7,7,0,26,13,13,28
CFR Cluj,1057,2,5,7,2,16,11,5,22
Universitate,1057,3,4,6,4,19,22,-3,18
D Bucuresti,1057,4,4,4,6,18,19,-1,16
Concordia Ch,1057,5,4,2,8,18,21,-3,14
FC Botosani,1057,6,3,4,7,5,16,-11,13
FCSB,1058,1,8,6,0,25,11,14,30
CFR Cluj,1058,2,5,7,2,13,8,5,22
D Bucuresti,1058,3,4,5,5,20,21,-1,17
Universitate,1058,4,4,5,5,16,20,-4,17
FC Botosani,1058,5,3,4,7,6,15,-9,13
Concordia Ch,1058,6,3,3,8,18,23,-5,12
FCSB,1059,1,8,5,1,25,12,13,29
CFR Cluj,1059,2,5,6,3,13,10,3,21
Universitate,1059,3,5,5,4,17,18,-1,20
FC Botosani,1059,4,4,5,5,7,13,-6,17
D Bucuresti,1059,5,3,5,6,18,21,-3,14
Concordia Ch,1059,6,3,2,9,17,23,-6,11
FCSB,1060,1,9,5,0,27,10,17,32
CFR Cluj,1060,2,6,6,2,14,8,6,24
D Bucuresti,1060,3,5,4,5,21,21,0,19
Universitate,1060,4,3,5,6,14,22,-8,14
FC Botosani,1060,5,3,4,7,6,15,-9,13
Concordia Ch,1060,6,3,2,9,18,24,-6,11
FCSB,1061,1,8,6,0,24,10,14,30
CFR Cluj,1061,2,5,8,1,15,9,6,23
D Bucuresti,1061,3,4,4,6,19,21,-2,16
Universitate,1061,4,3,6,5,16,21,-5,15
Concordia Ch,1061,5,4,2,8,18,22,-4,14
FC Botosani,1061,6,3,4,7,6,15,-9,13
FCSB,1062,1,8,6,0,24,10,14,30
CFR Cluj,1062,2,6,7,1,16,8,8,25
D Bucuresti,1062,3,4,4,6,19,21,-2,16
FC Botosani,1062,4,4,4,6,8,15,-7,16
Universitate,1062,5,3,5,6,15,22,-7,14
Concordia Ch,1062,6,3,2,9,16,22,-6,11
FCSB,1063,1,8,5,1,24,12,12,29
CFR Cluj,1063,2,7,6,1,18,7,11,27
FC Botosani,1063,3,4,5,5,9,13,-4,17
D Bucuresti,1063,4,3,5,6,17,21,-4,14
Universitate,1063,5,3,5,6,14,22,-8,14
Concordia Ch,1063,6,3,2,9,17,24,-7,11
FCSB,1064,1,7,6,1,25,13,12,27
CFR Cluj,1064,2,5,7,2,14,9,5,22
Universitate,1064,3,5,5,4,17,19,-2,20
FC Botosani,1064,4,5,4,5,8,13,-5,19
D Bucuresti,1064,5,3,4,7,16,21,-5,13
Concordia Ch,1064,6,3,2,9,18,23,-5,11
FCSB,1065,1,8,6,0,29,11,18,30
CFR Cluj,1065,2,6,7,1,16,9,7,25
FC Botosani,1065,3,4,5,5,6,12,-6,17
D Bucuresti,1065,4,4,4,6,17,19,-2,16
Universitate,1065,5,3,5,6,15,25,-10,14
Concordia Ch,1065,6,2,3,9,15,22,-7,9
FCSB,1066,1,8,5,1,26,12,14,29
CFR Cluj,1066,2,5,6,3,14,11,3,21
Universitate,1066,3,5,5,4,18,20,-2,20
FC Botosani,1066,4,4,5,5,8,13,-5,17
D Bucuresti,1066,5,3,5,6,18,22,-4,14
Concordia Ch,1066,6,2,4,8,18,24,-6,10
FCSB,1067,1,8,5,1,25,11,14,29
CFR Cluj,1067,2,6,6,2,15,9,6,24
Universitate,1067,3,4,5,5,15,20,-5,17
D Bucuresti,1067,4,3,6,5,18,20,-2,15
FC Botosani,1067,5,3,5,6,7,15,-8,14
Concordia Ch,1067,6,3,3,8,16,21,-5,12
FCSB,1068,1,7,7,0,25,12,13,28
CFR Cluj,1068,2,5,7,2,14,9,5,22
Universitate,1068,3,4,6,4,16,19,-3,18
FC Botosani,1068,4,4,5,5,8,14,-6,17
D Bucuresti,1068,5,3,4,7,18,22,-4,13
Concordia Ch,1068,6,3,3,8,18,23,-5,12
FCSB,1069,1,7,6,1,24,13,11,27
CFR Cluj,1069,2,5,8,1,15,9,6,23
Universitate,1069,3,4,6,4,17,19,-2,18
D Bucuresti,1069,4,4,4,6,17,23,-6,16
FC Botosani,1069,5,3,5,6,5,13,-8,14
Concordia Ch,1069,6,3,3,8,20,21,-1,12
FCSB,1070,1,9,5,0,25,10,15,32
CFR Cluj,1070,2,6,6,2,15,8,7,24
D Bucuresti,1070,3,5,4,5,20,19,1,19
Universitate,1070,4,3,5,6,14,21,-7,14
FC Botosani,1070,5,3,5,6,6,15,-9,14
Concordia Ch,1070,6,2,3,9,15,22,-7,9
FCSB,1071,1,8,6,0,26,12,14,30
CFR Cluj,1071,2,6,6,2,17,10,7,24
Universitate,1071,3,3,6,5,14,20,-6,15
Concordia Ch,1071,4,4,2,8,18,21,-3,14
D Bucuresti,1071,5,3,5,6,16,20,-4,14
FC Botosani,1071,6,3,5,6,5,13,-8,14
FCSB,1072,1,8,6,0,26,11,15,30
CFR Cluj,1072,2,6,6,2,15,10,5,24
Universitate,1072,3,3,6,5,14,19,-5,15
FC Botosani,1072,4,3,6,5,6,13,-7,15
D Bucuresti,1072,5,3,5,6,16,19,-3,14
Concordia Ch,1072,6,3,3,8,17,22,-5,12
FCSB,1073,1,8,6,0,24,10,14,30
CFR Cluj,1073,2,5,7,2,13,8,5,22
Universitate,1073,3,4,5,5,15,19,-4,17
D Bucuresti,1073,4,3,6,5,17,19,-2,15
FC Botosani,1073,5,3,5,6,6,15,-9,14
Concordia Ch,1073,6,3,3,8,17,21,-4,12
FCSB,1074,1,9,5,0,26,10,16,32
CFR Cluj,1074,2,5,7,2,13,9,4,22
D Bucuresti,1074,3,4,4,6,18,20,-2,16
Universitate,1074,4,3,6,5,14,19,-5,15
Concordia Ch,1074,5,4,2,8,18,22,-4,14
FC Botosani,1074,6,3,4,7,5,14,-9,13
FCSB,1075,1,9,5,0,27,11,16,32
CFR Cluj,1075,2,6,6,2,16,8,8,24
FC Botosani,1075,3,4,5,5,8,13,-5,17
Universitate,1075,4,3,5,6,15,24,-9,14
D Bucuresti,1075,5,3,4,7,16,21,-5,13
Concordia Ch,1075,6,3,3,8,17,22,-5,12
FCSB,1076,1,8,6,0,29,10,19,30
CFR Cluj,1076,2,5,7,2,13,13,0,22
D Bucuresti,1076,3,4,4,6,19,22,-3,16
Universitate,1076,4,3,7,4,14,18,-4,16
Concordia Ch,1076,5,4,2,8,20,21,-1,14
FC Botosani,1076,6,3,4,7,5,16,-11,13
FCSB,1077,1,8,6,0,24,10,14,30
CFR Cluj,1077,2,5,8,1,13,7,6,23
Universitate,1077,3,3,6,5,14,19,-5,15
D Bucuresti,1077,4,3,5,6,19,22,-3,14
Concordia Ch,1077,5,4,2,8,19,23,-4,14
FC Botosani,1077,6,3,5,6,6,14,-8,14
FCSB,1078,1,9,5,0,26,11,15,32
CFR Cluj,1078,2,6,6,2,15,9,6,24
D Bucuresti,1078,3,4,4,6,18,21,-3,16
Concordia Ch,1078,4,4,2,8,19,22,-3,14
Universitate,1078,5,3,5,6,16,22,-6,14
FC Botosani,1078,6,3,4,7,5,14,-9,13
FCSB,1079,1,8,5,1,25,12,13,29
CFR Cluj,1079,2,6,6,2,15,9,6,24
Universitate,1079,3,4,5,5,16,20,-4,17
FC Botosani,1079,4,4,5,5,9,14,-5,17
D Bucuresti,1079,5,3,5,6,18,21,-3,14
Concordia Ch,1079,6,3,2,9,18,25,-7,11
FCSB,1080,1,8,5,1,26,13,13,29
CFR Cluj,1080,2,6,7,1,15,8,7,25
FC Botosani,1080,3,5,4,5,9,14,-5,19
Universitate,1080,4,3,6,5,15,20,-5,15
D Bucuresti,1080,5,3,4,7,16,21,-5,13
Concordia Ch,1080,6,3,2,9,19,24,-5,11
FCSB,1081,1,8,5,1,26,13,13,29
CFR Cluj,1081,2,5,7,2,15,10,5,22
Universitate,1081,3,4,6,4,17,20,-3,18
FC Botosani,1081,4,4,5,5,9,13,-4,17
D Bucuresti,1081,5,3,4,7,16,22,-6,13
Concordia Ch,1081,6,3,3,8,17,22,-5,12
FCSB,1082,1,9,5,0,26,11,15,32
CFR Cluj,1082,2,5,7,2,13,8,5,22
FC Botosani,1082,3,4,5,5,9,13,-4,17
Universitate,1082,4,3,6,5,15,20,-5,15
D Bucuresti,1082,5,3,4,7,16,22,-6,13
Concordia Ch,1082,6,3,3,8,17,22,-5,12
FCSB,1083,1,9,5,0,27,11,16,32
CFR Cluj,1083,2,6,6,2,15,10,5,24
D Bucuresti,1083,3,3,6,5,17,19,-2,15
Universitate,1083,4,3,5,6,16,22,-6,14
FC Botosani,1083,5,3,5,6,6,14,-8,14
Concordia Ch,1083,6,3,3,8,18,23,-5,12
FCSB,1084,1,8,6,0,25,11,14,30
CFR Cluj,1084,2,6,7,1,15,8,7,25
FC Botosani,1084,3,3,6,5,6,13,-7,15
D Bucuresti,1084,4,3,5,6,16,20,-4,14
Universitate,1084,5,3,5,6,14,20,-6,14
Concordia Ch,1084,6,3,3,8,18,22,-4,12
FCSB,1085,1,8,5,1,24,12,12,29
CFR Cluj,1085,2,6,6,2,14,8,6,24
Universitate,1085,3,4,5,5,16,19,-3,17
FC Botosani,1085,4,4,5,5,8,13,-5,17
D Bucuresti,1085,5,3,5,6,17,20,-3,14
Concordia Ch,1085,6,3,2,9,18,25,-7,11
FCSB,1086,1,8,6,0,25,11,14,30
CFR Cluj,1086,2,5,7,2,14,9,5,22
Universitate,1086,3,3,7,4,16,20,-4,16
Concordia Ch,1086,4,4,2,8,20,23,-3,14
D Bucuresti,1086,5,3,5,6,18,22,-4,14
FC Botosani,1086,6,3,5,6,7,15,-8,14
FCSB,1087,1,9,5,0,27,11,16,32
CFR Cluj,1087,2,5,7,2,14,10,4,22
D Bucuresti,1087,3,4,5,5,18,19,-1,17
Universitate,1087,4,3,6,5,14,19,-5,15
FC Botosani,1087,5,3,5,6,5,13,-8,14
Concordia Ch,1087,6,3,2,9,17,23,-6,11
FCSB,1088,1,7,6,1,24,13,11,27
CFR Cluj,1088,2,5,7,2,15,10,5,22
Universitate,1088,3,5,5,4,18,19,-1,20
D Bucuresti,1088,4,4,4,6,20,21,-1,16
FC Botosani,1088,5,4,4,6,8,15,-7,16
Concordia Ch,1088,6,3,2,9,17,24,-7,11
FCSB,1089,1,7,7,0,25,12,13,28
CFR Cluj,1089,2,6,7,1,17,9,8,25
D Bucuresti,1089,3,4,5,5,18,19,-1,17
Universitate,1089,4,3,6,5,16,22,-6,15
FC Botosani,1089,5,3,4,7,6,15,-9,13
Concordia Ch,1089,6,3,3,8,16,21,-5,12
FCSB,1090,1,7,6,1,25,14,11,27
CFR Cluj,1090,2,5,8,1,16,10,6,23
Universitate,1090,3,4,6,4,17,19,-2,18
D Bucuresti,1090,4,3,6,5,18,20,-2,15
FC Botosani,1090,5,3,5,6,6,14,-8,14
Concordia Ch,1090,6,3,3,8,19,24,-5,12
FCSB,1091,1,9,5,0,28,13,15,32
CFR Cluj,1091,2,6,6,2,17,11,6,24
Concordia Ch,1091,3,4,2,8,22,24,-2,14
D Bucuresti,1091,4,3,5,6,18,23,-5,14
Universitate,1091,5,3,5,6,16,22,-6,14
FC Botosani,1091,6,3,5,6,6,14,-8,14
FCSB,1092,1,7,6,1,24,13,11,27
CFR Cluj,1092,2,5,7,2,14,10,4,22
Universitate,1092,3,5,5,4,18,18,0,20
D Bucuresti,1092,4,4,5,5,18,18,0,17
FC Botosani,1092,5,3,6,5,7,14,-7,15
Concordia Ch,1092,6,2,3,9,17,25,-8,9
FCSB,1093,1,8,6,0,26,12,14,30
CFR Cluj,1093,2,6,6,2,17,10,7,24
D Bucuresti,1093,3,5,4,5,19,18,1,19
Universitate,1093,4,3,6,5,16,22,-6,15
FC Botosani,1093,5,3,4,7,5,14,-9,13
Concordia Ch,1093,6,3,2,9,16,23,-7,11
FCSB,1094,1,8,5,1,24,12,12,29
CFR Cluj,1094,2,6,6,2,16,9,7,24
Universitate,1094,3,4,5,5,16,20,-4,17
D Bucuresti,1094,4,4,4,6,18,19,-1,16
FC Botosani,1094,5,4,4,6,6,13,-7,16
Concordia Ch,1094,6,3,2,9,16,23,-7,11
FCSB,1095,1,8,5,1,24,12,12,29
CFR Cluj,1095,2,6,6,2,17,10,7,24
FC Botosani,1095,3,5,4,5,7,12,-5,19
Universitate,1095,4,4,5,5,17,21,-4,17
D Bucuresti,1095,5,3,5,6,17,20,-3,14
Concordia Ch,1095,6,2,3,9,16,23,-7,9
FCSB,1096,1,9,5,0,27,10,17,32
CFR Cluj,1096,2,5,6,3,13,11,2,21
Universitate,1096,3,4,5,5,16,20,-4,17
FC Botosani,1096,4,4,5,5,7,13,-6,17
D Bucuresti,1096,5,3,6,5,17,19,-2,15
Concordia Ch,1096,6,2,3,9,17,24,-7,9
FCSB,1097,1,7,6,1,25,13,12,27
CFR Cluj,1097,2,7,6,1,17,7,10,27
D Bucuresti,1097,3,4,5,5,21,22,-1,17
Universitate,1097,4,3,6,5,16,23,-7,15
FC Botosani,1097,5,3,5,6,6,14,-8,14
Concordia Ch,1097,6,2,4,8,18,24,-6,10
FCSB,1098,1,9,5,0,28,10,18,32
CFR Cluj,1098,2,6,6,2,15,11,4,24
FC Botosani,1098,3,4,5,5,7,12,-5,17
D Bucuresti,1098,4,4,4,6,18,21,-3,16
Universitate,1098,5,3,5,6,15,22,-7,14
Concordia Ch,1098,6,2,3,9,16,23,-7,9
FCSB,1099,1,7,6,1,23,11,12,27
CFR Cluj,1099,2,7,6,1,15,7,8,27
FC Botosani,1099,3,4,5,5,6,12,-6,17
Universitate,1099,4,3,6,5,14,19,-5,15
D Bucuresti,1099,5,3,4,7,16,21,-5,13
Concordia Ch,1099,6,3,3,8,17,21,-4,12
FCSB,1100,1,7,5,2,25,14,11,26
CFR Cluj,1100,2,6,6,2,15,10,5,24
Universitate,1100,3,5,5,4,18,19,-1,20
D Bucuresti,1100,4,4,5,5,18,18,0,17
FC Botosani,1100,5,3,5,6,5,14,-9,14
Concordia Ch,1100,6,3,2,9,17,23,-6,11
FCSB,1101,1,8,6,0,27,13,14,30
CFR Cluj,1101,2,6,6,2,18,10,8,24
D Bucuresti,1101,3,4,4,6,19,21,-2,16
FC Botosani,1101,4,4,4,6,7,14,-7,16
Universitate,1101,5,3,6,5,17,24,-7,15
Concordia Ch,1101,6,3,2,9,19,25,-6,11
FCSB,1102,1,8,6,0,25,11,14,30
CFR Cluj,1102,2,5,7,2,13,8,5,22
D Bucuresti,1102,3,4,4,6,20,21,-1,16
Universitate,1102,4,3,7,4,15,19,-4,16
FC Botosani,1102,5,3,5,6,7,16,-9,14
Concordia Ch,1102,6,3,3,8,18,23,-5,12
CFR Cluj,1103,1,7,6,1,19,9,10,27
FCSB,1103,2,7,5,2,23,13,10,26
D Bucuresti,1103,3,4,5,5,18,19,-1,17
Universitate,1103,4,4,5,5,18,23,-5,17
FC Botosani,1103,5,3,5,6,5,13,-8,14
Concordia Ch,1103,6,2,4,8,16,22,-6,10
FCSB,1104,1,7,7,0,25,12,13,28
CFR Cluj,1104,2,6,7,1,17,9,8,25
Universitate,1104,3,3,6,5,14,20,-6,15
FC Botosani,1104,4,3,6,5,7,14,-7,15
D Bucuresti,1104,5,3,5,6,17,21,-4,14
Concordia Ch,1104,6,3,3,8,18,22,-4,12
CFR Cluj,1105,1,7,6,1,15,7,8,27
FCSB,1105,2,7,5,2,23,13,10,26
Universitate,1105,3,4,5,5,16,19,-3,17
FC Botosani,1105,4,4,5,5,7,13,-6,17
D Bucuresti,1105,5,3,5,6,17,20,-3,14
Concordia Ch,1105,6,3,2,9,16,22,-6,11
FCSB,1106,1,9,5,0,26,11,15,32
CFR Cluj,1106,2,5,6,3,13,9,4,21
Universitate,1106,3,4,5,5,16,20,-4,17
D Bucuresti,1106,4,4,4,6,17,24,-7,16
FC Botosani,1106,5,4,4,6,7,14,-7,16
Concordia Ch,1106,6,3,2,9,22,23,-1,11
FCSB,1107,1,8,5,1,27,12,15,29
CFR Cluj,1107,2,6,6,2,15,10,5,24
Universitate,1107,3,4,5,5,16,21,-5,17
FC Botosani,1107,4,4,4,6,8,14,-6,16
Concordia Ch,1107,5,4,2,8,20,22,-2,14
D Bucuresti,1107,6,3,4,7,18,25,-7,13
FCSB,1108,1,8,5,1,28,13,15,29
CFR Cluj,1108,2,6,7,1,15,8,7,25
D Bucuresti,1108,3,4,5,5,19,19,0,17
Universitate,1108,4,3,6,5,15,22,-7,15
FC Botosani,1108,5,3,5,6,6,15,-9,14
Concordia Ch,1108,6,3,2,9,19,25,-6,11
FCSB,1109,1,8,5,1,29,16,13,29
CFR Cluj,1109,2,5,7,2,15,13,2,22
Universitate,1109,3,4,6,4,20,20,0,18
D Bucuresti,1109,4,4,4,6,19,19,0,16
FC Botosani,1109,5,3,5,6,5,15,-10,14
Concordia Ch,1109,6,3,3,8,16,21,-5,12
FCSB,1110,1,8,5,1,24,12,12,29
CFR Cluj,1110,2,6,6,2,15,9,6,24
Universitate,1110,3,4,5,5,17,20,-3,17
D Bucuresti,1110,4,3,6,5,19,21,-2,15
FC Botosani,1110,5,3,5,6,6,14,-8,14
Concordia Ch,1110,6,3,3,8,18,23,-5,12
FCSB,1111,1,8,6,0,25,11,14,30
CFR Cluj,1111,2,5,6,3,13,11,2,21
D Bucuresti,1111,3,5,4,5,21,19,2,19
Universitate,1111,4,4,6,4,18,19,-1,18
FC Botosani,1111,5,4,4,6,8,15,-7,16
Concordia Ch,1111,6,2,2,10,16,26,-10,8
FCSB,1112,1,8,5,1,28,14,14,29
CFR Cluj,1112,2,6,6,2,16,12,4,24
Universitate,1112,3,4,5,5,18,21,-3,17
D Bucuresti,1112,4,4,4,6,18,22,-4,16
FC Botosani,1112,5,4,4,6,6,13,-7,16
Concordia Ch,1112,6,3,2,9,19,23,-4,11
FCSB,1113,1,9,5,0,28,11,17,32
CFR Cluj,1113,2,5,6,3,14,12,2,21
Universitate,1113,3,4,5,5,16,20,-4,17
FC Botosani,1113,4,4,5,5,8,14,-6,17
D Bucuresti,1113,5,3,5,6,18,21,-3,14
Concordia Ch,1113,6,2,4,8,19,25,-6,10
FCSB,1114,1,8,6,0,30,11,19,30
CFR Cluj,1114,2,5,6,3,13,15,-2,21
D Bucuresti,1114,3,5,4,5,19,19,0,19
Universitate,1114,4,4,6,4,17,19,-2,18
FC Botosani,1114,5,3,5,6,7,15,-8,14
Concordia Ch,1114,6,2,3,9,16,23,-7,9
FCSB,1115,1,8,6,0,25,11,14,30
CFR Cluj,1115,2,6,6,2,15,9,6,24
Universitate,1115,3,3,6,5,14,19,-5,15
FC Botosani,1115,4,3,6,5,5,12,-7,15
D Bucuresti,1115,5,3,5,6,16,19,-3,14
Concordia Ch,1115,6,3,3,8,16,21,-5,12
FCSB,1116,1,8,5,1,25,12,13,29
CFR Cluj,1116,2,7,6,1,16,7,9,27
D Bucuresti,1116,3,5,4,5,22,18,4,19
FC Botosani,1116,4,4,4,6,7,18,-11,16
Universitate,1116,5,3,5,6,14,21,-7,14
Concordia Ch,1116,6,2,2,10,16,24,-8,8
FCSB,1117,1,8,6,0,25,10,15,30
CFR Cluj,1117,2,5,7,2,13,9,4,22
FC Botosani,1117,3,4,5,5,7,13,-6,17
Universitate,1117,4,3,7,4,14,18,-4,16
D Bucuresti,1117,5,3,4,7,17,22,-5,13
Concordia Ch,1117,6,3,3,8,19,23,-4,12
FCSB,1118,1,8,5,1,27,12,15,29
CFR Cluj,1118,2,6,6,2,15,8,7,24
FC Botosani,1118,3,4,5,5,8,13,-5,17
Universitate,1118,4,4,5,5,15,22,-7,17
D Bucuresti,1118,5,3,5,6,18,22,-4,14
Concordia Ch,1118,6,2,4,8,18,24,-6,10
CFR Cluj,1119,1,7,6,1,18,9,9,27
FCSB,1119,2,7,5,2,26,16,10,26
Universitate,1119,3,4,5,5,18,22,-4,17
FC Botosani,1119,4,4,5,5,9,15,-6,17
D Bucuresti,1119,5,3,5,6,17,20,-3,14
Concordia Ch,1119,6,3,2,9,18,24,-6,11
FCSB,1120,1,8,5,1,27,14,13,29
CFR Cluj,1120,2,6,6,2,16,10,6,24
Universitate,1120,3,4,5,5,20,24,-4,17
D Bucuresti,1120,4,4,4,6,17,21,-4,16
FC Botosani,1120,5,4,4,6,7,13,-6,16
Concordia Ch,1120,6,3,2,9,18,23,-5,11
FCSB,1121,1,7,6,1,25,13,12,27
CFR Cluj,1121,2,5,7,2,15,11,4,22
Universitate,1121,3,5,5,4,19,20,-1,20
D Bucuresti,1121,4,4,4,6,17,21,-4,16
FC Botosani,1121,5,4,4,6,9,14,-5,16
Concordia Ch,1121,6,3,2,9,19,25,-6,11
FCSB,1122,1,8,5,1,25,13,12,29
CFR Cluj,1122,2,5,6,3,14,10,4,21
Universitate,1122,3,5,5,4,17,18,-1,20
Concordia Ch,1122,4,4,2,8,19,22,-3,14
D Bucuresti,1122,5,3,5,6,16,20,-4,14
FC Botosani,1122,6,3,5,6,6,14,-8,14
FCSB,1123,1,7,5,2,24,13,11,26
CFR Cluj,1123,2,6,6,2,14,8,6,24
Universitate,1123,3,5,5,4,17,19,-2,20
FC Botosani,1123,4,4,5,5,6,12,-6,17
D Bucuresti,1123,5,4,4,6,18,20,-2,16
Concordia Ch,1123,6,2,3,9,16,23,-7,9
FCSB,1124,1,9,5,0,27,10,17,32
CFR Cluj,1124,2,6,6,2,14,9,5,24
D Bucuresti,1124,3,3,6,5,17,19,-2,15
FC Botosani,1124,4,3,6,5,7,14,-7,15
Universitate,1124,5,3,5,6,14,21,-7,14
Concordia Ch,1124,6,2,4,8,16,22,-6,10
FCSB,1125,1,8,6,0,27,10,17,30
CFR Cluj,1125,2,5,6,3,14,13,1,21
Universitate,1125,3,4,6,4,16,19,-3,18
D Bucuresti,1125,4,4,4,6,18,21,-3,16
FC Botosani,1125,5,4,4,6,7,13,-6,16
Concordia Ch,1125,6,3,2,9,18,24,-6,11
FCSB,1126,1,8,6,0,26,11,15,30
CFR Cluj,1126,2,5,7,2,14,10,4,22
FC Botosani,1126,3,4,5,5,9,14,-5,17
Universitate,1126,4,3,7,4,16,20,-4,16
D Bucuresti,1126,5,3,5,6,17,21,-4,14
Concordia Ch,1126,6,2,4,8,18,24,-6,10
FCSB,1127,1,7,7,0,24,11,13,28
CFR Cluj,1127,2,5,8,1,14,8,6,23
D Bucuresti,1127,3,4,4,6,18,21,-3,16
Universitate,1127,4,3,7,4,14,18,-4,16
FC Botosani,1127,5,4,4,6,6,14,-8,16
Concordia Ch,1127,6,3,2,9,18,22,-4,11
FCSB,1128,1,8,6,0,25,10,15,30
CFR Cluj,1128,2,5,6,3,13,11,2,21
Universitate,1128,3,4,6,4,16,18,-2,18
D Bucuresti,1128,4,4,4,6,19,19,0,16
Concordia Ch,1128,5,4,2,8,18,21,-3,14
FC Botosani,1128,6,3,4,7,5,17,-12,13
FCSB,1129,1,8,5,1,24,13,11,29
CFR Cluj,1129,2,5,7,2,13,8,5,22
Universitate,1129,3,4,6,4,17,18,-1,18
D Bucuresti,1129,4,4,5,5,19,20,-1,17
FC Botosani,1129,5,3,6,5,8,15,-7,15
Concordia Ch,1129,6,2,3,9,16,23,-7,9
FCSB,1130,1,7,7,0,25,12,13,28
CFR Cluj,1130,2,6,7,1,16,9,7,25
D Bucuresti,1130,3,4,5,5,20,20,0,17
FC Botosani,1130,4,4,4,6,8,16,-8,16
Universitate,1130,5,3,6,5,16,21,-5,15
Concordia Ch,1130,6,2,3,9,19,26,-7,9
FCSB,1131,1,7,7,0,23,10,13,28
CFR Cluj,1131,2,5,8,1,14,8,6,23
FC Botosani,1131,3,4,5,5,8,14,-6,17
D Bucuresti,1131,4,4,4,6,19,20,-1,16
Universitate,1131,5,3,7,4,15,19,-4,16
Concordia Ch,1131,6,2,3,9,18,26,-8,9
FCSB,1132,1,8,6,0,27,11,16,30
CFR Cluj,1132,2,5,7,2,14,11,3,22
D Bucuresti,1132,3,4,5,5,19,20,-1,17
Universitate,1132,4,3,7,4,16,20,-4,16
FC Botosani,1132,5,4,4,6,8,14,-6,16
Concordia Ch,1132,6,2,3,9,18,26,-8,9
CFR Cluj,1133,1,7,6,1,15,7,8,27
FCSB,1133,2,7,5,2,23,13,10,26
D Bucuresti,1133,3,4,5,5,18,19,-1,17
Universitate,1133,4,4,5,5,16,19,-3,17
FC Botosani,1133,5,4,5,5,7,13,-6,17
Concordia Ch,1133,6,2,2,10,17,25,-8,8
FCSB,1134,1,7,7,0,25,12,13,28
CFR Cluj,1134,2,6,7,1,15,8,7,25
D Bucuresti,1134,3,4,5,5,17,18,-1,17
FC Botosani,1134,4,4,4,6,6,13,-7,16
Universitate,1134,5,3,6,5,15,20,-5,15
Concordia Ch,1134,6,2,3,9,15,22,-7,9
FCSB,1135,1,8,5,1,27,14,13,29
CFR Cluj,1135,2,6,6,2,16,12,4,24
Universitate,1135,3,4,5,5,20,22,-2,17
D Bucuresti,1135,4,4,4,6,17,19,-2,16
FC Botosani,1135,5,4,4,6,7,14,-7,16
Concordia Ch,1135,6,3,2,9,17,23,-6,11
FCSB,1136,1,8,6,0,25,11,14,30
CFR Cluj,1136,2,5,7,2,13,8,5,22
FC Botosani,1136,3,4,5,5,10,15,-5,17
Universitate,1136,4,3,7,4,15,19,-4,16
D Bucuresti,1136,5,3,6,5,19,21,-2,15
Concordia Ch,1136,6,2,3,9,17,25,-8,9
FCSB,1137,1,8,6,0,28,12,16,30
CFR Cluj,1137,2,5,7,2,13,10,3,22
Universitate,1137,3,3,7,4,16,20,-4,16
D Bucuresti,1137,4,3,6,5,19,21,-2,15
FC Botosani,1137,5,3,6,5,6,13,-7,15
Concordia Ch,1137,6,2,4,8,17,23,-6,10
FCSB,1138,1,9,5,0,26,11,15,32
CFR Cluj,1138,2,5,6,3,14,10,4,21
Universitate,1138,3,4,5,5,15,19,-4,17
FC Botosani,1138,4,4,5,5,7,13,-6,17
D Bucuresti,1138,5,3,5,6,16,19,-3,14
Concordia Ch,1138,6,2,4,8,16,22,-6,10
FCSB,1139,1,9,5,0,29,12,17,32
CFR Cluj,1139,2,6,6,2,16,11,5,24
FC Botosani,1139,3,4,5,5,7,13,-6,17
Universitate,1139,4,3,5,6,15,22,-7,14
D Bucuresti,1139,5,3,4,7,20,25,-5,13
Concordia Ch,1139,6,3,3,8,20,24,-4,12
FCSB,1140,1,8,5,1,26,12,14,29
CFR Cluj,1140,2,6,6,2,15,11,4,24
Universitate,1140,3,4,5,5,17,20,-3,17
D Bucuresti,1140,4,4,4,6,17,19,-2,16
Concordia Ch,1140,5,4,2,8,18,22,-4,14
FC Botosani,1140,6,3,4,7,6,15,-9,13
FCSB,1141,1,7,7,0,23,10,13,28
CFR Cluj,1141,2,6,7,1,14,7,7,25
FC Botosani,1141,3,4,5,5,10,13,-3,17
Universitate,1141,4,3,6,5,14,19,-5,15
D Bucuresti,1141,5,3,5,6,17,20,-3,14
Concordia Ch,1141,6,3,2,9,16,25,-9,11
FCSB,1142,1,8,6,0,24,10,14,30
CFR Cluj,1142,2,6,7,1,16,8,8,25
D Bucuresti,1142,3,5,4,5,19,18,1,19
Universitate,1142,4,3,5,6,15,22,-7,14
FC Botosani,1142,5,3,4,7,5,16,-11,13
Concordia Ch,1142,6,3,2,9,17,22,-5,11
FCSB,1143,1,8,6,0,28,11,17,30
CFR Cluj,1143,2,6,7,1,17,9,8,25
FC Botosani,1143,3,4,5,5,8,13,-5,17
D Bucuresti,1143,4,3,5,6,18,22,-4,14
Universitate,1143,5,3,5,6,15,25,-10,14
Concordia Ch,1143,6,3,2,9,18,24,-6,11
FCSB,1144,1,9,5,0,26,11,15,32
CFR Cluj,1144,2,5,6,3,14,10,4,21
D Bucuresti,1144,3,4,5,5,18,19,-1,17
Universitate,1144,4,4,5,5,17,21,-4,17
FC Botosani,1144,5,3,5,6,6,14,-8,14
Concordia Ch,1144,6,3,2,9,16,22,-6,11
FCSB,1145,1,9,5,0,26,11,15,32
CFR Cluj,1145,2,5,7,2,13,8,5,22
D Bucuresti,1145,3,3,6,5,18,20,-2,15
Universitate,1145,4,3,6,5,15,20,-5,15
FC Botosani,1145,5,3,5,6,6,14,-8,14
Concordia Ch,1145,6,3,3,8,17,22,-5,12
FCSB,1146,1,7,6,1,27,15,12,27
CFR Cluj,1146,2,6,7,1,17,10,7,25
D Bucuresti,1146,3,4,5,5,21,21,0,17
Universitate,1146,4,4,5,5,18,22,-4,17
FC Botosani,1146,5,3,4,7,6,17,-11,13
Concordia Ch,1146,6,3,3,8,19,23,-4,12
FCSB,1147,1,8,5,1,25,11,14,29
CFR Cluj,1147,2,5,6,3,13,10,3,21
Universitate,1147,3,5,5,4,16,18,-2,20
D Bucuresti,1147,4,4,4,6,20,21,-1,16
FC Botosani,1147,5,4,4,6,10,17,-7,16
Concordia Ch,1147,6,3,2,9,20,27,-7,11
FCSB,1148,1,8,5,1,25,12,13,29
CFR Cluj,1148,2,6,6,2,14,8,6,24
D Bucuresti,1148,3,5,4,5,21,18,3,19
Universitate,1148,4,4,5,5,16,20,-4,17
FC Botosani,1148,5,3,4,7,5,17,-12,13
Concordia Ch,1148,6,3,2,9,17,23,-6,11
FCSB,1149,1,8,5,1,24,13,11,29
CFR Cluj,1149,2,6,6,2,17,10,7,24
Universitate,1149,3,4,5,5,19,22,-3,17
D Bucuresti,1149,4,4,4,6,19,23,-4,16
Concordia Ch,1149,5,4,2,8,20,22,-2,14
FC Botosani,1149,6,3,4,7,6,15,-9,13
FCSB,1150,1,7,7,0,24,11,13,28
CFR Cluj,1150,2,5,7,2,14,9,5,22
Universitate,1150,3,4,6,4,15,18,-3,18
D Bucuresti,1150,4,4,5,5,18,19,-1,17
FC Botosani,1150,5,4,4,6,8,14,-6,16
Concordia Ch,1150,6,2,3,9,15,23,-8,9
FCSB,1151,1,7,6,1,25,13,12,27
CFR Cluj,1151,2,6,7,1,17,8,9,25
Universitate,1151,3,4,5,5,16,22,-6,17
D Bucuresti,1151,4,3,5,6,19,22,-3,14
Concordia Ch,1151,5,4,2,8,20,24,-4,14
FC Botosani,1151,6,3,5,6,7,15,-8,14
FCSB,1152,1,8,6,0,26,12,14,30
CFR Cluj,1152,2,6,6,2,18,9,9,24
D Bucuresti,1152,3,4,4,6,20,20,0,16
Universitate,1152,4,3,6,5,15,23,-8,15
FC Botosani,1152,5,3,5,6,6,16,-10,14
Concordia Ch,1152,6,3,3,8,18,23,-5,12
FCSB,1153,1,8,6,0,25,11,14,30
CFR Cluj,1153,2,5,8,1,13,7,6,23
D Bucuresti,1153,3,5,4,5,21,19,2,19
Universitate,1153,4,3,6,5,15,20,-5,15
FC Botosani,1153,5,3,4,7,5,15,-10,13
Concordia Ch,1153,6,3,2,9,17,24,-7,11
FCSB,1154,1,8,5,1,25,13,12,29
CFR Cluj,1154,2,6,6,2,17,10,7,24
D Bucuresti,1154,3,5,4,5,21,18,3,19
Universitate,1154,4,4,5,5,16,20,-4,17
FC Botosani,1154,5,3,4,7,6,18,-12,13
Concordia Ch,1154,6,3,2,9,18,24,-6,11
FCSB,1155,1,8,6,0,26,11,15,30
CFR Cluj,1155,2,6,7,1,15,7,8,25
FC Botosani,1155,3,4,5,5,8,14,-6,17
Universitate,1155,4,3,5,6,15,23,-8,14
D Bucuresti,1155,5,3,4,7,18,22,-4,13
Concordia Ch,1155,6,3,3,8,16,21,-5,12
FCSB,1156,1,7,7,0,25,12,13,28
CFR Cluj,1156,2,5,7,2,16,11,5,22
Universitate,1156,3,4,6,4,18,21,-3,18
FC Botosani,1156,4,4,5,5,10,15,-5,17
D Bucuresti,1156,5,3,4,7,19,25,-6,13
Concordia Ch,1156,6,3,3,8,19,23,-4,12
FCSB,1157,1,8,6,0,24,10,14,30
CFR Cluj,1157,2,6,6,2,15,9,6,24
FC Botosani,1157,3,5,4,5,9,13,-4,19
Universitate,1157,4,3,6,5,15,20,-5,15
D Bucuresti,1157,5,3,4,7,18,23,-5,13
Concordia Ch,1157,6,3,2,9,17,23,-6,11
FCSB,1158,1,8,5,1,26,13,13,29
CFR Cluj,1158,2,6,6,2,14,10,4,24
D Bucuresti,1158,3,5,4,5,19,18,1,19
Universitate,1158,4,4,5,5,17,19,-2,17
FC Botosani,1158,5,3,5,6,5,14,-9,14
Concordia Ch,1158,6,2,3,9,15,22,-7,9
FCSB,1159,1,7,7,0,25,12,13,28
CFR Cluj,1159,2,5,8,1,15,9,6,23
Universitate,1159,3,3,7,4,16,20,-4,16
D Bucuresti,1159,4,3,6,5,19,21,-2,15
FC Botosani,1159,5,3,6,5,7,14,-7,15
Concordia Ch,1159,6,2,4,8,18,24,-6,10
FCSB,1160,1,8,5,1,27,13,14,29
CFR Cluj,1160,2,6,7,1,17,10,7,25
D Bucuresti,1160,3,4,4,6,17,19,-2,16
FC Botosani,1160,4,4,4,6,7,14,-7,16
Universitate,1160,5,3,6,5,15,21,-6,15
Concordia Ch,1160,6,3,2,9,17,23,-6,11
FCSB,1161,1,8,5,1,25,13,12,29
CFR Cluj,1161,2,6,7,1,15,7,8,25
D Bucuresti,1161,3,4,4,6,18,20,-2,16
FC Botosani,1161,4,4,4,6,6,14,-8,16
Universitate,1161,5,3,6,5,15,20,-5,15
Concordia Ch,1161,6,3,2,9,18,23,-5,11
FCSB,1162,1,7,5,2,26,15,11,26
CFR Cluj,1162,2,6,6,2,17,11,6,24
Universitate,1162,3,5,5,4,18,20,-2,20
D Bucuresti,1162,4,4,4,6,18,21,-3,16
FC Botosani,1162,5,3,5,6,7,15,-8,14
Concordia Ch,1162,6,3,3,8,20,24,-4,12
FCSB,1163,1,8,6,0,25,11,14,30
CFR Cluj,1163,2,5,8,1,14,8,6,23
D Bucuresti,1163,3,5,4,5,21,18,3,19
FC Botosani,1163,4,4,4,6,6,15,-9,16
Universitate,1163,5,3,6,5,16,21,-5,15
Concordia Ch,1163,6,2,2,10,15,24,-9,8
FCSB,1164,1,9,5,0,27,11,16,32
CFR Cluj,1164,2,6,6,2,18,10,8,24
D Bucuresti,1164,3,4,5,5,17,18,-1,17
Universitate,1164,4,3,5,6,15,24,-9,14
FC Botosani,1164,5,3,4,7,5,14,-9,13
Concordia Ch,1164,6,3,3,8,16,21,-5,12
FCSB,1165,1,7,7,0,25,12,13,28
CFR Cluj,1165,2,6,7,1,17,9,8,25
D Bucuresti,1165,3,4,5,5,17,18,-1,17
Universitate,1165,4,3,6,5,16,22,-6,15
FC Botosani,1165,5,3,4,7,5,14,-9,13
Concordia Ch,1165,6,3,3,8,16,21,-5,12
FCSB,1166,1,7,6,1,24,12,12,27
CFR Cluj,1166,2,6,6,2,14,8,6,24
Universitate,1166,3,4,6,4,16,19,-3,18
Concordia Ch,1166,4,4,2,8,19,22,-3,14
D Bucuresti,1166,5,3,5,6,18,22,-4,14
FC Botosani,1166,6,3,5,6,6,14,-8,14
FCSB,1167,1,9,5,0,25,10,15,32
CFR Cluj,1167,2,5,7,2,14,9,5,22
D Bucuresti,1167,3,4,4,6,18,23,-5,16
Universitate,1167,4,3,6,5,15,20,-5,15
FC Botosani,1167,5,3,5,6,6,14,-8,14
Concordia Ch,1167,6,3,3,8,19,21,-2,12
FCSB,1168,1,7,6,1,25,13,12,27
CFR Cluj,1168,2,5,8,1,13,7,6,23
Universitate,1168,3,4,6,4,17,20,-3,18
Concordia Ch,1168,4,4,2,8,18,21,-3,14
D Bucuresti,1168,5,3,5,6,16,20,-4,14
FC Botosani,1168,6,3,5,6,5,13,-8,14
CFR Cluj,1169,1,7,6,1,18,9,9,27
FCSB,1169,2,7,5,2,26,15,11,26
D Bucuresti,1169,3,4,5,5,20,19,1,17
Universitate,1169,4,4,5,5,16,21,-5,17
FC Botosani,1169,5,4,5,5,8,13,-5,17
Concordia Ch,1169,6,2,2,10,15,26,-11,8
CFR Cluj,1170,1,7,6,1,16,8,8,27
FCSB,1170,2,7,5,2,23,13,10,26
D Bucuresti,1170,3,4,5,5,21,21,0,17
Universitate,1170,4,4,5,5,17,20,-3,17
FC Botosani,1170,5,3,4,7,5,17,-12,13
Concordia Ch,1170,6,3,3,8,21,24,-3,12
FCSB,1171,1,7,6,1,25,13,12,27
CFR Cluj,1171,2,6,7,1,16,8,8,25
Universitate,1171,3,4,5,5,16,21,-5,17
FC Botosani,1171,4,4,5,5,9,15,-6,17
D Bucuresti,1171,5,3,6,5,21,23,-2,15
Concordia Ch,1171,6,2,3,9,17,24,-7,9
FCSB,1172,1,7,6,1,24,13,11,27
CFR Cluj,1172,2,7,6,1,17,7,10,27
D Bucuresti,1172,3,4,4,6,20,24,-4,16
Universitate,1172,4,3,6,5,15,21,-6,15
FC Botosani,1172,5,3,5,6,7,16,-9,14
Concordia Ch,1172,6,3,3,8,19,21,-2,12
FCSB,1173,1,8,6,0,24,10,14,30
CFR Cluj,1173,2,5,8,1,14,8,6,23
FC Botosani,1173,3,5,4,5,10,12,-2,19
Universitate,1173,4,3,6,5,15,20,-5,15
D Bucuresti,1173,5,3,5,6,18,21,-3,14
Concordia Ch,1173,6,2,3,9,17,27,-10,9
FCSB,1174,1,8,5,1,24,12,12,29
CFR Cluj,1174,2,5,7,2,14,9,5,22
D Bucuresti,1174,3,5,4,5,22,21,1,19
Universitate,1174,4,4,6,4,17,19,-2,18
FC Botosani,1174,5,3,4,7,7,17,-10,13
Concordia Ch,1174,6,3,2,9,17,23,-6,11
FCSB,1175,1,8,5,1,26,12,14,29
CFR Cluj,1175,2,6,6,2,14,9,5,24
Universitate,1175,3,4,5,5,16,20,-4,17
Concordia Ch,1175,4,4,2,8,19,21,-2,14
D Bucuresti,1175,5,3,5,6,17,21,-4,14
FC Botosani,1175,6,3,5,6,6,15,-9,14
FCSB,1176,1,7,6,1,23,11,12,27
CFR Cluj,1176,2,6,6,2,15,10,5,24
FC Botosani,1176,3,5,4,5,10,14,-4,19
Universitate,1176,4,4,6,4,17,19,-2,18
D Bucuresti,1176,5,4,4,6,20,21,-1,16
Concordia Ch,1176,6,2,2,10,17,27,-10,8
FCSB,1177,1,8,6,0,29,12,17,30
CFR Cluj,1177,2,5,7,2,16,12,4,22
D Bucuresti,1177,3,5,4,5,23,19,4,19
Universitate,1177,4,4,5,5,17,23,-6,17
FC Botosani,1177,5,4,4,6,8,15,-7,16
Concordia Ch,1177,6,2,2,10,17,29,-12,8
FCSB,1178,1,9,5,0,27,10,17,32
CFR Cluj,1178,2,5,6,3,14,12,2,21
Universitate,1178,3,4,5,5,16,20,-4,17
Concordia Ch,1178,4,4,2,8,23,25,-2,14
D Bucuresti,1178,5,3,5,6,21,26,-5,14
FC Botosani,1178,6,3,5,6,10,18,-8,14
FCSB,1179,1,9,5,0,27,11,16,32
CFR Cluj,1179,2,6,6,2,15,8,7,24
D Bucuresti,1179,3,4,5,5,20,21,-1,17
FC Botosani,1179,4,4,4,6,7,14,-7,16
Universitate,1179,5,3,5,6,15,23,-8,14
Concordia Ch,1179,6,2,3,9,17,24,-7,9
FCSB,1180,1,9,5,0,26,11,15,32
CFR Cluj,1180,2,6,6,2,15,9,6,24
D Bucuresti,1180,3,4,4,6,18,21,-3,16
FC Botosani,1180,4,4,4,6,7,14,-7,16
Universitate,1180,5,3,5,6,16,22,-6,14
Concordia Ch,1180,6,3,2,9,17,22,-5,11
FCSB,1181,1,8,5,1,26,13,13,29
CFR Cluj,1181,2,7,6,1,17,8,9,27
D Bucuresti,1181,3,4,5,5,17,18,-1,17
Universitate,1181,4,3,5,6,14,21,-7,14
FC Botosani,1181,5,3,5,6,5,13,-8,14
Concordia Ch,1181,6,3,2,9,16,22,-6,11
FCSB,1182,1,7,6,1,24,12,12,27
CFR Cluj,1182,2,5,7,2,14,9,5,22
Universitate,1182,3,5,5,4,16,18,-2,20
FC Botosani,1182,4,5,4,5,8,12,-4,19
D Bucuresti,1182,5,3,4,7,16,23,-7,13
Concordia Ch,1182,6,3,2,9,18,22,-4,11
FCSB,1183,1,8,6,0,28,10,18,30
CFR Cluj,1183,2,6,6,2,15,13,2,24
D Bucuresti,1183,3,4,4,6,20,20,0,16
FC Botosani,1183,4,4,4,6,9,16,-7,16
Universitate,1183,5,3,6,5,15,20,-5,15
Concordia Ch,1183,6,3,2,9,16,24,-8,11
FCSB,1184,1,8,5,1,26,12,14,29
CFR Cluj,1184,2,5,6,3,13,12,1,21
Universitate,1184,3,5,5,4,18,18,0,20
D Bucuresti,1184,4,4,4,6,18,20,-2,16
Concordia Ch,1184,5,4,2,8,19,22,-3,14
FC Botosani,1184,6,3,4,7,6,16,-10,13
FCSB,1185,1,9,5,0,26,11,15,32
CFR Cluj,1185,2,5,7,2,14,9,5,22
D Bucuresti,1185,3,5,4,5,22,19,3,19
FC Botosani,1185,4,4,4,6,7,14,-7,16
Universitate,1185,5,3,6,5,16,21,-5,15
Concordia Ch,1185,6,2,2,10,16,27,-11,8
FCSB,1186,1,7,5,2,24,13,11,26
CFR Cluj,1186,2,6,6,2,15,9,6,24
Universitate,1186,3,5,5,4,16,18,-2,20
D Bucuresti,1186,4,4,5,5,17,18,-1,17
FC Botosani,1186,5,3,5,6,5,13,-8,14
Concordia Ch,1186,6,3,2,9,16,22,-6,11
FCSB,1187,1,9,5,0,25,10,15,32
CFR Cluj,1187,2,6,6,2,14,8,6,24
D Bucuresti,1187,3,4,4,6,18,20,-2,16
FC Botosani,1187,4,4,4,6,9,15,-6,16
Universitate,1187,5,3,5,6,14,20,-6,14
Concordia Ch,1187,6,3,2,9,17,24,-7,11
FCSB,1188,1,9,5,0,28,13,15,32
CFR Cluj,1188,2,6,6,2,18,10,8,24
D Bucuresti,1188,3,4,4,6,18,23,-5,16
Concordia Ch,1188,4,4,2,8,23,24,-1,14
Universitate,1188,5,3,5,6,15,23,-8,14
FC Botosani,1188,6,3,4,7,7,16,-9,13
FCSB,1189,1,8,5,1,25,11,14,29
CFR Cluj,1189,2,6,7,1,15,8,7,25
D Bucuresti,1189,3,4,5,5,18,19,-1,17
Universitate,1189,4,3,6,5,15,21,-6,15
FC Botosani,1189,5,3,4,7,5,15,-10,13
Concordia Ch,1189,6,3,3,8,18,22,-4,12
FCSB,1190,1,8,6,0,26,12,14,30
CFR Cluj,1190,2,5,7,2,13,8,5,22
D Bucuresti,1190,3,4,4,6,19,21,-2,16
Universitate,1190,4,3,7,4,16,20,-4,16
Concordia Ch,1190,5,4,2,8,20,22,-2,14
FC Botosani,1190,6,3,4,7,5,16,-11,13
FCSB,1191,1,7,6,1,27,15,12,27
CFR Cluj,1191,2,6,7,1,18,11,7,25
D Bucuresti,1191,3,5,4,5,20,18,2,19
Universitate,1191,4,4,5,5,17,21,-4,17
FC Botosani,1191,5,3,4,7,6,18,-12,13
Concordia Ch,1191,6,3,2,9,18,23,-5,11
FCSB,1192,1,9,5,0,26,11,15,32
CFR Cluj,1192,2,6,6,2,18,9,9,24
D Bucuresti,1192,3,4,4,6,21,23,-2,16
Concordia Ch,1192,4,4,2,8,20,24,-4,14
Universitate,1192,5,3,5,6,14,23,-9,14
FC Botosani,1192,6,3,4,7,6,15,-9,13
FCSB,1193,1,9,5,0,28,10,18,32
CFR Cluj,1193,2,6,6,2,14,9,5,24
D Bucuresti,1193,3,4,5,5,19,20,-1,17
Universitate,1193,4,3,5,6,14,22,-8,14
FC Botosani,1193,5,3,5,6,7,15,-8,14
Concordia Ch,1193,6,2,4,8,17,23,-6,10
FCSB,1194,1,8,5,1,26,13,13,29
CFR Cluj,1194,2,6,7,1,16,7,9,25
FC Botosani,1194,3,5,4,5,8,13,-5,19
D Bucuresti,1194,4,4,4,6,19,21,-2,16
Universitate,1194,5,3,6,5,14,21,-7,15
Concordia Ch,1194,6,2,2,10,18,26,-8,8
FCSB,1195,1,7,7,0,25,12,13,28
CFR Cluj,1195,2,5,7,2,16,11,5,22
Universitate,1195,3,4,6,4,16,19,-3,18
FC Botosani,1195,4,4,5,5,7,12,-5,17
D Bucuresti,1195,5,3,4,7,16,21,-5,13
Concordia Ch,1195,6,3,3,8,16,21,-5,12
FCSB,1196,1,8,6,0,28,13,15,30
CFR Cluj,1196,2,6,6,2,16,11,5,24
D Bucuresti,1196,3,5,4,5,21,18,3,19
Universitate,1196,4,3,6,5,17,22,-5,15
FC Botosani,1196,5,3,4,7,6,18,-12,13
Concordia Ch,1196,6,3,2,9,18,24,-6,11
FCSB,1197,1,7,6,1,23,11,12,27
CFR Cluj,1197,2,6,6,2,16,10,6,24
Universitate,1197,3,4,6,4,17,20,-3,18
FC Botosani,1197,4,4,5,5,7,12,-5,17
D Bucuresti,1197,5,3,5,6,17,20,-3,14
Concordia Ch,1197,6,3,2,9,17,24,-7,11
FCSB,1198,1,8,5,1,25,12,13,29
CFR Cluj,1198,2,6,6,2,16,9,7,24
Universitate,1198,3,4,5,5,15,20,-5,17
FC Botosani,1198,4,4,5,5,8,14,-6,17
D Bucuresti,1198,5,3,6,5,18,20,-2,15
Concordia Ch,1198,6,2,3,9,15,22,-7,9
FCSB,1199,1,8,5,1,25,12,13,29
CFR Cluj,1199,2,6,6,2,15,9,6,24
D Bucuresti,1199,3,5,4,5,19,18,1,19
Universitate,1199,4,4,5,5,15,19,-4,17
FC Botosani,1199,5,3,5,6,6,15,-9,14
Concordia Ch,1199,6,2,3,9,16,23,-7,9
FCSB,1200,1,7,6,1,25,13,12,27
CFR Cluj,1200,2,6,7,1,16,9,7,25
Universitate,1200,3,4,5,5,17,21,-4,17
D Bucuresti,1200,4,4,4,6,20,22,-2,16
FC Botosani,1200,5,4,4,6,10,16,-6,16
Concordia Ch,1200,6,3,2,9,18,25,-7,11
FCSB,1201,1,8,5,1,27,13,14,29
CFR Cluj,1201,2,5,6,3,13,11,2,21
Universitate,1201,3,5,5,4,18,19,-1,20
D Bucuresti,1201,4,5,4,5,19,18,1,19
FC Botosani,1201,5,3,5,6,8,17,-9,14
Concordia Ch,1201,6,2,3,9,18,25,-7,9
FCSB,1202,1,9,5,0,28,12,16,32
CFR Cluj,1202,2,6,6,2,18,13,5,24
D Bucuresti,1202,3,5,4,5,21,20,1,19
Universitate,1202,4,3,5,6,16,22,-6,14
FC Botosani,1202,5,3,5,6,5,14,-9,14
Concordia Ch,1202,6,2,3,9,17,24,-7,9
FCSB,1203,1,8,5,1,28,14,14,29
CFR Cluj,1203,2,5,7,2,14,11,3,22
Universitate,1203,3,4,6,4,17,19,-2,18
FC Botosani,1203,4,3,6,5,6,13,-7,15
D Bucuresti,1203,5,3,5,6,17,21,-4,14
Concordia Ch,1203,6,3,3,8,19,23,-4,12
FCSB,1204,1,8,6,0,26,11,15,30
CFR Cluj,1204,2,6,7,1,14,7,7,25
FC Botosani,1204,3,4,4,6,6,15,-9,16
D Bucuresti,1204,4,3,5,6,18,21,-3,14
Universitate,1204,5,3,5,6,15,22,-7,14
Concordia Ch,1204,6,3,3,8,20,23,-3,12
FCSB,1205,1,8,5,1,25,12,13,29
CFR Cluj,1205,2,7,6,1,16,8,8,27
D Bucuresti,1205,3,4,5,5,20,19,1,17
FC Botosani,1205,4,3,6,5,7,14,-7,15
Universitate,1205,5,3,5,6,16,22,-6,14
Concordia Ch,1205,6,2,3,9,16,25,-9,9
FCSB,1206,1,7,5,2,25,14,11,26
CFR Cluj,1206,2,6,6,2,15,10,5,24
Universitate,1206,3,5,5,4,18,19,-1,20
D Bucuresti,1206,4,4,4,6,20,19,1,16
FC Botosani,1206,5,3,5,6,6,17,-11,14
Concordia Ch,1206,6,3,3,8,17,22,-5,12
FCSB,1207,1,9,5,0,28,13,15,32
CFR Cluj,1207,2,6,6,2,15,9,6,24
D Bucuresti,1207,3,4,4,6,19,19,0,16
Universitate,1207,4,3,5,6,16,22,-6,14
FC Botosani,1207,5,3,5,6,5,15,-10,14
Concordia Ch,1207,6,3,3,8,16,21,-5,12
FCSB,1208,1,9,5,0,29,11,18,32
CFR Cluj,1208,2,6,6,2,16,11,5,24
D Bucuresti,1208,3,3,6,5,18,20,-2,15
Universitate,1208,4,3,5,6,15,23,-8,14
FC Botosani,1208,5,3,5,6,6,14,-8,14
Concordia Ch,1208,6,3,3,8,17,22,-5,12
FCSB,1209,1,7,6,1,25,14,11,27
CFR Cluj,1209,2,6,7,1,18,10,8,25
D Bucuresti,1209,3,5,4,5,20,18,2,19
Universitate,1209,4,3,7,4,15,19,-4,16
FC Botosani,1209,5,3,5,6,7,16,-9,14
Concordia Ch,1209,6,2,3,9,17,25,-8,9
FCSB,1210,1,8,6,0,28,13,15,30
CFR Cluj,1210,2,6,7,1,18,10,8,25
D Bucuresti,1210,3,5,4,5,21,19,2,19
Universitate,1210,4,3,5,6,14,22,-8,14
FC Botosani,1210,5,3,4,7,6,17,-11,13
Concordia Ch,1210,6,3,2,9,18,24,-6,11
FCSB,1211,1,8,6,0,24,10,14,30
CFR Cluj,1211,2,5,6,3,14,10,4,21
D Bucuresti,1211,3,5,4,5,18,18,0,19
Universitate,1211,4,4,6,4,16,19,-3,18
FC Botosani,1211,5,3,4,7,7,17,-10,13
Concordia Ch,1211,6,3,2,9,19,24,-5,11
FCSB,1212,1,8,5,1,25,12,13,29
CFR Cluj,1212,2,6,7,1,16,8,8,25
FC Botosani,1212,3,4,5,5,7,13,-6,17
Universitate,1212,4,3,6,5,15,21,-6,15
D Bucuresti,1212,5,3,4,7,16,21,-5,13
Concordia Ch,1212,6,3,3,8,18,22,-4,12
FCSB,1213,1,8,5,1,26,13,13,29
CFR Cluj,1213,2,6,6,2,15,9,6,24
Universitate,1213,3,4,5,5,16,20,-4,17
FC Botosani,1213,4,4,5,5,8,14,-6,17
D Bucuresti,1213,5,3,5,6,18,21,-3,14
Concordia Ch,1213,6,3,2,9,16,22,-6,11
FCSB,1214,1,8,5,1,24,12,12,29
CFR Cluj,1214,2,6,6,2,15,8,7,24
D Bucuresti,1214,3,4,5,5,19,20,-1,17
Universitate,1214,4,4,5,5,16,20,-4,17
FC Botosani,1214,5,3,4,7,6,15,-9,13
Concordia Ch,1214,6,3,3,8,17,22,-5,12
FCSB,1215,1,8,5,1,25,12,13,29
CFR Cluj,1215,2,5,7,2,14,9,5,22
Universitate,1215,3,4,6,4,17,20,-3,18
D Bucuresti,1215,4,4,5,5,18,19,-1,17
FC Botosani,1215,5,3,5,6,7,15,-8,14
Concordia Ch,1215,6,2,4,8,18,24,-6,10
FCSB,1216,1,8,5,1,25,12,13,29
CFR Cluj,1216,2,6,6,2,16,9,7,24
Universitate,1216,3,4,5,5,16,21,-5,17
D Bucuresti,1216,4,4,4,6,17,19,-2,16
Concordia Ch,1216,5,4,2,8,17,21,-4,14
FC Botosani,1216,6,3,4,7,5,14,-9,13
FCSB,1217,1,7,7,0,25,12,13,28
CFR Cluj,1217,2,5,8,1,15,9,6,23
D Bucuresti,1217,3,5,4,5,21,20,1,19
Universitate,1217,4,3,7,4,14,18,-4,16
FC Botosani,1217,5,3,5,6,6,15,-9,14
Concordia Ch,1217,6,2,3,9,18,25,-7,9
FCSB,1218,1,7,6,1,24,12,12,27
CFR Cluj,1218,2,6,6,2,14,9,5,24
Universitate,1218,3,4,6,4,17,19,-2,18
FC Botosani,1218,4,4,4,6,6,16,-10,16
Concordia Ch,1218,5,4,2,8,21,22,-1,14
D Bucuresti,1218,6,3,4,7,17,21,-4,13
FCSB,1219,1,9,5,0,30,12,18,32
CFR Cluj,1219,2,5,7,2,15,11,4,22
FC Botosani,1219,3,5,4,5,9,14,-5,19
D Bucuresti,1219,4,4,4,6,18,20,-2,16
Universitate,1219,5,3,6,5,16,23,-7,15
Concordia Ch,1219,6,2,2,10,16,24,-8,8
FCSB,1220,1,8,6,0,25,10,15,30
CFR Cluj,1220,2,6,6,2,17,9,8,24
D Bucuresti,1220,3,4,4,6,18,19,-1,16
Universitate,1220,4,3,6,5,14,22,-8,15
FC Botosani,1220,5,3,5,6,8,17,-9,14
Concordia Ch,1220,6,3,3,8,19,24,-5,12
FCSB,1221,1,8,6,0,24,10,14,30
CFR Cluj,1221,2,6,7,1,17,7,10,25
D Bucuresti,1221,3,4,5,5,21,21,0,17
FC Botosani,1221,4,4,4,6,8,14,-6,16
Universitate,1221,5,3,5,6,14,23,-9,14
Concordia Ch,1221,6,2,3,9,18,27,-9,9
FCSB,1222,1,8,6,0,24,10,14,30
CFR Cluj,1222,2,6,7,1,14,7,7,25
FC Botosani,1222,3,4,4,6,8,14,-6,16
Concordia Ch,1222,4,4,2,8,18,21,-3,14
Universitate,1222,5,3,5,6,14,20,-6,14
D Bucuresti,1222,6,3,4,7,17,23,-6,13
FCSB,1223,1,7,6,1,24,13,11,27
CFR Cluj,1223,2,6,7,1,16,9,7,25
FC Botosani,1223,3,5,4,5,9,12,-3,19
Universitate,1223,4,4,5,5,17,20,-3,17
D Bucuresti,1223,5,3,5,6,18,22,-4,14
Concordia Ch,1223,6,2,3,9,17,25,-8,9
FCSB,1224,1,7,7,0,27,14,13,28
CFR Cluj,1224,2,5,8,1,14,8,6,23
D Bucuresti,1224,3,4,4,6,20,20,0,16
Universitate,1224,4,3,7,4,19,23,-4,16
FC Botosani,1224,5,4,4,6,8,17,-9,16
Concordia Ch,1224,6,3,2,9,17,23,-6,11
FCSB,1225,1,8,5,1,24,11,13,29
CFR Cluj,1225,2,5,7,2,13,8,5,22
FC Botosani,1225,3,5,4,5,10,13,-3,19
Universitate,1225,4,4,6,4,15,18,-3,18
D Bucuresti,1225,5,3,4,7,18,25,-7,13
Concordia Ch,1225,6,3,2,9,18,23,-5,11
FCSB,1226,1,8,5,1,27,13,14,29
CFR Cluj,1226,2,6,6,2,16,12,4,24
Universitate,1226,3,4,5,5,17,20,-3,17
FC Botosani,1226,4,4,5,5,8,13,-5,17
D Bucuresti,1226,5,3,5,6,17,21,-4,14
Concordia Ch,1226,6,3,2,9,17,23,-6,11
FCSB,1227,1,8,5,1,26,13,13,29
CFR Cluj,1227,2,6,6,2,15,9,6,24
Universitate,1227,3,4,5,5,16,20,-4,17
D Bucuresti,1227,4,4,4,6,18,19,-1,16
FC Botosani,1227,5,3,5,6,6,15,-9,14
Concordia Ch,1227,6,3,3,8,17,22,-5,12
FCSB,1228,1,9,5,0,26,11,15,32
CFR Cluj,1228,2,6,6,2,15,8,7,24
FC Botosani,1228,3,4,5,5,6,12,-6,17
D Bucuresti,1228,4,3,5,6,16,21,-5,14
Universitate,1228,5,3,5,6,15,22,-7,14
Concordia Ch,1228,6,3,2,9,18,22,-4,11
FCSB,1229,1,8,6,0,28,14,14,30
CFR Cluj,1229,2,5,7,2,16,12,4,22
FC Botosani,1229,3,5,4,5,8,13,-5,19
Universitate,1229,4,4,5,5,19,22,-3,17
D Bucuresti,1229,5,4,4,6,18,20,-2,16
Concordia Ch,1229,6,2,2,10,17,25,-8,8
CFR Cluj,1230,1,7,6,1,19,7,12,27
FCSB,1230,2,7,5,2,23,13,10,26
D Bucuresti,1230,3,4,5,5,20,19,1,17
Universitate,1230,4,4,5,5,15,22,-7,17
FC Botosani,1230,5,3,4,7,5,16,-11,13
Concordia Ch,1230,6,3,3,8,17,22,-5,12
FCSB,1231,1,8,6,0,25,11,14,30
CFR Cluj,1231,2,5,6,3,13,10,3,21
Universitate,1231,3,4,6,4,17,19,-2,18
D Bucuresti,1231,4,4,4,6,18,21,-3,16
FC Botosani,1231,5,4,4,6,7,14,-7,16
Concordia Ch,1231,6,3,2,9,17,22,-5,11
FCSB,1232,1,8,6,0,27,12,15,30
CFR Cluj,1232,2,6,6,2,19,10,9,24
D Bucuresti,1232,3,5,4,5,20,19,1,19
Universitate,1232,4,3,6,5,15,24,-9,15
FC Botosani,1232,5,3,4,7,7,16,-9,13
Concordia Ch,1232,6,3,2,9,17,24,-7,11
FCSB,1233,1,9,5,0,29,11,18,32
CFR Cluj,1233,2,5,6,3,13,11,2,21
FC Botosani,1233,3,5,4,5,11,13,-2,19
Universitate,1233,4,4,5,5,16,21,-5,17
D Bucuresti,1233,5,3,4,7,18,23,-5,13
Concordia Ch,1233,6,3,2,9,17,25,-8,11
FCSB,1234,1,7,7,0,23,10,13,28
CFR Cluj,1234,2,6,7,1,16,7,9,25
FC Botosani,1234,3,4,5,5,8,13,-5,17
Universitate,1234,4,3,6,5,14,21,-7,15
D Bucuresti,1234,5,3,5,6,18,21,-3,14
Concordia Ch,1234,6,3,2,9,17,24,-7,11
FCSB,1235,1,7,6,1,25,14,11,27
CFR Cluj,1235,2,6,7,1,16,8,8,25
Universitate,1235,3,4,5,5,17,21,-4,17
FC Botosani,1235,4,4,5,5,7,12,-5,17
D Bucuresti,1235,5,4,4,6,19,22,-3,16
Concordia Ch,1235,6,2,3,9,17,24,-7,9
FCSB,1236,1,8,6,0,24,10,14,30
CFR Cluj,1236,2,6,7,1,14,7,7,25
D Bucuresti,1236,3,4,4,6,19,21,-2,16
Universitate,1236,4,3,5,6,14,20,-6,14
FC Botosani,1236,5,3,5,6,7,15,-8,14
Concordia Ch,1236,6,3,3,8,18,23,-5,12
FCSB,1237,1,8,5,1,26,13,13,29
CFR Cluj,1237,2,5,6,3,14,12,2,21
Universitate,1237,3,5,5,4,19,19,0,20
D Bucuresti,1237,4,4,4,6,18,21,-3,16
FC Botosani,1237,5,3,5,6,6,14,-8,14
Concordia Ch,1237,6,3,3,8,19,23,-4,12
FCSB,1238,1,8,6,0,24,10,14,30
CFR Cluj,1238,2,6,6,2,16,9,7,24
Universitate,1238,3,3,6,5,15,21,-6,15
FC Botosani,1238,4,3,6,5,7,14,-7,15
D Bucuresti,1238,5,3,5,6,17,21,-4,14
Concordia Ch,1238,6,3,3,8,18,22,-4,12
FCSB,1239,1,9,5,0,31,11,20,32
CFR Cluj,1239,2,5,7,2,14,14,0,22
D Bucuresti,1239,3,5,4,5,18,18,0,19
Universitate,1239,4,3,6,5,16,21,-5,15
FC Botosani,1239,5,3,5,6,5,13,-8,14
Concordia Ch,1239,6,2,3,9,15,22,-7,9
FCSB,1240,1,8,5,1,26,12,14,29
CFR Cluj,1240,2,6,6,2,17,11,6,24
D Bucuresti,1240,3,4,5,5,18,19,-1,17
Universitate,1240,4,4,5,5,17,22,-5,17
FC Botosani,1240,5,3,4,7,7,16,-9,13
Concordia Ch,1240,6,3,3,8,19,24,-5,12
CFR Cluj,1241,1,7,6,1,19,8,11,27
FCSB,1241,2,7,5,2,24,15,9,26
Universitate,1241,3,4,5,5,18,23,-5,17
D Bucuresti,1241,4,4,4,6,20,20,0,16
FC Botosani,1241,5,4,4,6,8,17,-9,16
Concordia Ch,1241,6,3,2,9,17,23,-6,11
FCSB,1242,1,8,5,1,27,13,14,29
CFR Cluj,1242,2,5,6,3,16,13,3,21
Universitate,1242,3,5,5,4,17,19,-2,20
FC Botosani,1242,4,4,5,5,8,14,-6,17
D Bucuresti,1242,5,3,5,6,18,22,-4,14
Concordia Ch,1242,6,3,2,9,19,24,-5,11
FCSB,1243,1,8,6,0,28,13,15,30
CFR Cluj,1243,2,5,7,2,16,11,5,22
Universitate,1243,3,4,5,5,17,22,-5,17
FC Botosani,1243,4,4,4,6,6,15,-9,16
Concordia Ch,1243,5,4,2,8,21,22,-1,14
D Bucuresti,1243,6,3,4,7,17,22,-5,13
FCSB,1244,1,7,5,2,24,15,9,26
CFR Cluj,1244,2,6,6,2,17,9,8,24
Universitate,1244,3,5,5,4,16,18,-2,20
D Bucuresti,1244,4,5,4,5,22,21,1,19
FC Botosani,1244,5,3,4,7,6,16,-10,13
Concordia Ch,1244,6,3,2,9,18,24,-6,11
FCSB,1245,1,7,7,0,25,12,13,28
CFR Cluj,1245,2,6,7,1,15,8,7,25
Universitate,1245,3,3,6,5,15,20,-5,15
D Bucuresti,1245,4,3,5,6,19,22,-3,14
Concordia Ch,1245,5,4,2,8,18,22,-4,14
FC Botosani,1245,6,3,5,6,7,15,-8,14
CFR Cluj,1246,1,7,6,1,15,7,8,27
FCSB,1246,2,7,5,2,24,13,11,26
Universitate,1246,3,4,5,5,16,20,-4,17
FC Botosani,1246,4,3,6,5,6,13,-7,15
D Bucuresti,1246,5,3,5,6,19,22,-3,14
Concordia Ch,1246,6,3,3,8,18,23,-5,12
CFR Cluj,1247,1,7,6,1,17,7,10,27
FCSB,1247,2,7,5,2,23,15,8,26
Universitate,1247,3,4,5,5,16,19,-3,17
FC Botosani,1247,4,4,5,5,7,13,-6,17
D Bucuresti,1247,5,3,5,6,19,22,-3,14
Concordia Ch,1247,6,3,2,9,20,26,-6,11
FCSB,1248,1,8,6,0,25,11,14,30
CFR Cluj,1248,2,6,7,1,15,7,8,25
FC Botosani,1248,3,5,4,5,8,12,-4,19
Universitate,1248,4,3,5,6,15,22,-7,14
D Bucuresti,1248,5,3,4,7,16,22,-6,13
Concordia Ch,1248,6,3,2,9,18,23,-5,11
FCSB,1249,1,9,5,0,28,12,16,32
CFR Cluj,1249,2,5,7,2,14,10,4,22
D Bucuresti,1249,3,3,6,5,17,19,-2,15
Universitate,1249,4,3,6,5,17,22,-5,15
FC Botosani,1249,5,3,5,6,6,16,-10,14
Concordia Ch,1249,6,3,3,8,20,23,-3,12
FCSB,1250,1,7,7,0,27,14,13,28
CFR Cluj,1250,2,6,7,1,17,10,7,25
D Bucuresti,1250,3,4,4,6,18,20,-2,16
Universitate,1250,4,3,6,5,15,20,-5,15
Concordia Ch,1250,5,4,2,8,19,22,-3,14
FC Botosani,1250,6,3,4,7,5,15,-10,13
FCSB,1251,1,7,7,0,25,12,13,28
CFR Cluj,1251,2,5,8,1,15,9,6,23
FC Botosani,1251,3,4,5,5,8,14,-6,17
Universitate,1251,4,3,7,4,14,18,-4,16
D Bucuresti,1251,5,3,4,7,17,23,-6,13
Concordia Ch,1251,6,3,3,8,19,22,-3,12
FCSB,1252,1,8,5,1,25,12,13,29
CFR Cluj,1252,2,7,6,1,18,9,9,27
D Bucuresti,1252,3,4,5,5,18,19,-1,17
FC Botosani,1252,4,4,5,5,8,13,-5,17
Universitate,1252,5,3,5,6,15,22,-7,14
Concordia Ch,1252,6,2,2,10,17,26,-9,8
FCSB,1253,1,7,6,1,25,13,12,27
CFR Cluj,1253,2,5,8,1,13,7,6,23
Universitate,1253,3,4,6,4,17,20,-3,18
D Bucuresti,1253,4,4,5,5,18,19,-1,17
FC Botosani,1253,5,4,5,5,9,13,-4,17
Concordia Ch,1253,6,2,2,10,15,25,-10,8
FCSB,1254,1,7,7,0,25,12,13,28
CFR Cluj,1254,2,6,7,1,14,7,7,25
D Bucuresti,1254,3,4,4,6,18,22,-4,16
Universitate,1254,4,3,6,5,16,21,-5,15
FC Botosani,1254,5,3,5,6,7,15,-8,14
Concordia Ch,1254,6,3,3,8,19,22,-3,12
FCSB,1255,1,7,5,2,25,15,10,26
CFR Cluj,1255,2,6,7,1,16,8,8,25
Universitate,1255,3,4,6,4,16,19,-3,18
FC Botosani,1255,4,4,4,6,8,14,-6,16
D Bucuresti,1255,5,3,5,6,16,20,-4,14
Concordia Ch,1255,6,3,3,8,17,22,-5,12
FCSB,1256,1,9,5,0,27,12,15,32
CFR Cluj,1256,2,5,6,3,16,12,4,21
Universitate,1256,3,4,5,5,16,20,-4,17
D Bucuresti,1256,4,3,6,5,18,20,-2,15
FC Botosani,1256,5,3,6,5,7,14,-7,15
Concordia Ch,1256,6,2,4,8,17,23,-6,10
FCSB,1257,1,8,6,0,24,10,14,30
CFR Cluj,1257,2,6,6,2,15,9,6,24
D Bucuresti,1257,3,4,4,6,19,21,-2,16
Universitate,1257,4,3,6,5,15,20,-5,15
Concordia Ch,1257,5,4,2,8,20,22,-2,14
FC Botosani,1257,6,3,4,7,5,16,-11,13
FCSB,1258,1,8,5,1,25,12,13,29
CFR Cluj,1258,2,6,6,2,15,9,6,24
Universitate,1258,3,4,5,5,15,19,-4,17
Concordia Ch,1258,4,4,2,8,18,21,-3,14
D Bucuresti,1258,5,3,5,6,16,20,-4,14
FC Botosani,1258,6,3,5,6,5,13,-8,14
FCSB,1259,1,8,6,0,25,11,14,30
CFR Cluj,1259,2,5,8,1,15,9,6,23
Universitate,1259,3,3,6,5,17,22,-5,15
FC Botosani,1259,4,3,6,5,8,15,-7,15
D Bucuresti,1259,5,3,5,6,18,22,-4,14
Concordia Ch,1259,6,3,3,8,20,24,-4,12
FCSB,1260,1,8,5,1,25,14,11,29
CFR Cluj,1260,2,5,6,3,14,10,4,21
Universitate,1260,3,5,5,4,18,18,0,20
D Bucuresti,1260,4,5,4,5,19,19,0,19
FC Botosani,1260,5,4,4,6,8,14,-6,16
Concordia Ch,1260,6,2,2,10,15,24,-9,8
FCSB,1261,1,8,6,0,26,12,14,30
CFR Cluj,1261,2,5,8,1,15,9,6,23
D Bucuresti,1261,3,4,4,6,17,19,-2,16
Universitate,1261,4,3,6,5,16,21,-5,15
Concordia Ch,1261,5,4,2,8,18,21,-3,14
FC Botosani,1261,6,3,4,7,5,15,-10,13
FCSB,1262,1,8,5,1,26,13,13,29
CFR Cluj,1262,2,6,6,2,17,10,7,24
Universitate,1262,3,4,5,5,18,23,-5,17
FC Botosani,1262,4,4,5,5,6,12,-6,17
D Bucuresti,1262,5,4,4,6,17,19,-2,16
Concordia Ch,1262,6,2,3,9,15,22,-7,9
FCSB,1263,1,8,5,1,26,13,13,29
CFR Cluj,1263,2,5,6,3,14,11,3,21
Universitate,1263,3,5,5,4,18,19,-1,20
FC Botosani,1263,4,5,4,5,9,13,-4,19
D Bucuresti,1263,5,3,4,7,17,23,-6,13
Concordia Ch,1263,6,3,2,9,17,22,-5,11
FCSB,1264,1,7,7,0,25,12,13,28
CFR Cluj,1264,2,6,7,1,16,9,7,25
D Bucuresti,1264,3,5,4,5,21,20,1,19
Universitate,1264,4,3,6,5,14,19,-5,15
FC Botosani,1264,5,3,5,6,7,15,-8,14
Concordia Ch,1264,6,2,3,9,17,25,-8,9
FCSB,1265,1,8,6,0,27,13,14,30
CFR Cluj,1265,2,5,7,2,16,11,5,22
D Bucuresti,1265,3,4,4,6,18,19,-1,16
Universitate,1265,4,3,7,4,16,20,-4,16
Concordia Ch,1265,5,4,2,8,20,22,-2,14
FC Botosani,1265,6,3,4,7,6,18,-12,13
FCSB,1266,1,7,7,0,25,12,13,28
CFR Cluj,1266,2,5,7,2,15,10,5,22
D Bucuresti,1266,3,5,4,5,19,18,1,19
Universitate,1266,4,4,6,4,17,20,-3,18
FC Botosani,1266,5,3,5,6,6,15,-9,14
Concordia Ch,1266,6,2,3,9,16,23,-7,9
FCSB,1267,1,7,6,1,24,13,11,27
CFR Cluj,1267,2,6,6,2,16,9,7,24
Universitate,1267,3,4,6,4,17,20,-3,18
D Bucuresti,1267,4,4,4,6,20,21,-1,16
FC Botosani,1267,5,4,4,6,9,15,-6,16
Concordia Ch,1267,6,3,2,9,17,25,-8,11
FCSB,1268,1,7,6,1,24,12,12,27
CFR Cluj,1268,2,7,6,1,16,8,8,27
D Bucuresti,1268,3,4,4,6,18,21,-3,16
Universitate,1268,4,3,6,5,16,21,-5,15
FC Botosani,1268,5,3,5,6,7,15,-8,14
Concordia Ch,1268,6,3,3,8,18,22,-4,12
FCSB,1269,1,8,6,0,25,11,14,30
CFR Cluj,1269,2,6,7,1,16,7,9,25
Concordia Ch,1269,3,4,2,8,20,21,-1,14
D Bucuresti,1269,4,3,5,6,17,21,-4,14
Universitate,1269,5,3,5,6,15,23,-8,14
FC Botosani,1269,6,3,5,6,6,16,-10,14
FCSB,1270,1,7,6,1,24,12,12,27
CFR Cluj,1270,2,6,7,1,16,8,8,25
Universitate,1270,3,4,5,5,17,22,-5,17
FC Botosani,1270,4,4,5,5,8,14,-6,17
D Bucuresti,1270,5,3,4,7,18,23,-5,13
Concordia Ch,1270,6,3,3,8,17,21,-4,12
FCSB,1271,1,8,6,0,30,15,15,30
CFR Cluj,1271,2,6,6,2,19,12,7,24
FC Botosani,1271,3,4,5,5,9,14,-5,17
D Bucuresti,1271,4,3,6,5,18,20,-2,15
Universitate,1271,5,3,6,5,16,23,-7,15
Concordia Ch,1271,6,2,3,9,17,25,-8,9
FCSB,1272,1,8,6,0,27,12,15,30
CFR Cluj,1272,2,6,6,2,16,10,6,24
D Bucuresti,1272,3,3,6,5,19,21,-2,15
Universitate,1272,4,3,6,5,15,21,-6,15
FC Botosani,1272,5,3,6,5,6,13,-7,15
Concordia Ch,1272,6,2,4,8,17,23,-6,10
FCSB,1273,1,8,5,1,24,13,11,29
CFR Cluj,1273,2,6,6,2,15,8,7,24
Universitate,1273,3,4,5,5,17,20,-3,17
D Bucuresti,1273,4,4,4,6,19,21,-2,16
FC Botosani,1273,5,3,5,6,7,15,-8,14
Concordia Ch,1273,6,3,3,8,20,25,-5,12
FCSB,1274,1,7,6,1,25,13,12,27
CFR Cluj,1274,2,6,6,2,14,8,6,24
D Bucuresti,1274,3,5,4,5,18,18,0,19
Universitate,1274,4,4,6,4,17,20,-3,18
FC Botosani,1274,5,3,5,6,5,13,-8,14
Concordia Ch,1274,6,2,3,9,15,22,-7,9
FCSB,1275,1,8,6,0,25,10,15,30
CFR Cluj,1275,2,6,6,2,16,11,5,24
D Bucuresti,1275,3,4,5,5,19,20,-1,17
Universitate,1275,4,3,6,5,16,21,-5,15
FC Botosani,1275,5,3,5,6,7,15,-8,14
Concordia Ch,1275,6,2,4,8,17,23,-6,10
FCSB,1276,1,9,5,0,28,11,17,32
CFR Cluj,1276,2,6,6,2,15,9,6,24
D Bucuresti,1276,3,4,5,5,19,18,1,17
Universitate,1276,4,3,5,6,16,24,-8,14
FC Botosani,1276,5,3,5,6,6,16,-10,14
Concordia Ch,1276,6,2,4,8,16,22,-6,10
FCSB,1277,1,7,6,1,24,13,11,27
CFR Cluj,1277,2,6,6,2,15,10,5,24
Universitate,1277,3,4,6,4,18,19,-1,18
FC Botosani,1277,4,4,5,5,7,13,-6,17
D Bucuresti,1277,5,3,5,6,18,21,-3,14
Concordia Ch,1277,6,2,4,8,16,22,-6,10
FCSB,1278,1,8,6,0,25,11,14,30
CFR Cluj,1278,2,6,6,2,15,8,7,24
D Bucuresti,1278,3,4,4,6,20,23,-3,16
Universitate,1278,4,3,6,5,15,21,-6,15
FC Botosani,1278,5,3,5,6,6,15,-9,14
Concordia Ch,1278,6,3,3,8,19,22,-3,12
FCSB,1279,1,9,5,0,26,11,15,32
CFR Cluj,1279,2,5,6,3,14,11,3,21
D Bucuresti,1279,3,5,4,5,20,20,0,19
Universitate,1279,4,4,5,5,18,21,-3,17
FC Botosani,1279,5,3,4,7,6,16,-10,13
Concordia Ch,1279,6,3,2,9,18,23,-5,11
FCSB,1280,1,7,6,1,25,14,11,27
CFR Cluj,1280,2,6,7,1,15,7,8,25
FC Botosani,1280,3,4,5,5,12,15,-3,17
Universitate,1280,4,4,5,5,18,22,-4,17
D Bucuresti,1280,5,3,6,5,17,19,-2,15
Concordia Ch,1280,6,2,3,9,17,27,-10,9
FCSB,1281,1,8,5,1,24,11,13,29
CFR Cluj,1281,2,6,6,2,16,9,7,24
D Bucuresti,1281,3,4,5,5,20,21,-1,17
Universitate,1281,4,4,5,5,16,21,-5,17
FC Botosani,1281,5,3,5,6,6,14,-8,14
Concordia Ch,1281,6,3,2,9,20,26,-6,11
FCSB,1282,1,9,5,0,25,10,15,32
CFR Cluj,1282,2,6,6,2,16,9,7,24
D Bucuresti,1282,3,4,5,5,20,20,0,17
Universitate,1282,4,3,5,6,15,22,-7,14
FC Botosani,1282,5,3,4,7,7,17,-10,13
Concordia Ch,1282,6,3,3,8,18,23,-5,12
FCSB,1283,1,8,5,1,27,13,14,29
CFR Cluj,1283,2,6,6,2,16,10,6,24
Universitate,1283,3,4,5,5,16,21,-5,17
D Bucuresti,1283,4,4,4,6,18,21,-3,16
FC Botosani,1283,5,4,4,6,7,13,-6,16
Concordia Ch,1283,6,3,2,9,18,24,-6,11
FCSB,1284,1,8,6,0,26,10,16,30
CFR Cluj,1284,2,6,7,1,18,7,11,25
FC Botosani,1284,3,4,5,5,7,12,-5,17
D Bucuresti,1284,4,3,6,5,16,18,-2,15
Universitate,1284,5,3,5,6,14,26,-12,14
Concordia Ch,1284,6,2,3,9,15,23,-8,9
FCSB,1285,1,7,6,1,24,12,12,27
CFR Cluj,1285,2,5,8,1,14,8,6,23
D Bucuresti,1285,3,5,4,5,20,18,2,19
Universitate,1285,4,4,6,4,17,20,-3,18
FC Botosani,1285,5,3,5,6,7,17,-10,14
Concordia Ch,1285,6,2,3,9,17,24,-7,9
FCSB,1286,1,7,5,2,23,14,9,26
CFR Cluj,1286,2,6,7,1,16,9,7,25
Universitate,1286,3,4,6,4,19,20,-1,18
FC Botosani,1286,4,4,5,5,7,13,-6,17
D Bucuresti,1286,5,3,5,6,18,22,-4,14
Concordia Ch,1286,6,3,2,9,18,23,-5,11
FCSB,1287,1,7,5,2,24,13,11,26
CFR Cluj,1287,2,6,6,2,15,9,6,24
Universitate,1287,3,5,5,4,18,20,-2,20
D Bucuresti,1287,4,4,5,5,18,19,-1,17
FC Botosani,1287,5,3,6,5,5,12,-7,15
Concordia Ch,1287,6,2,3,9,16,23,-7,9
FCSB,1288,1,7,5,2,26,16,10,26
CFR Cluj,1288,2,6,6,2,18,12,6,24
Universitate,1288,3,5,5,4,18,19,-1,20
D Bucuresti,1288,4,4,5,5,19,20,-1,17
FC Botosani,1288,5,3,4,7,6,15,-9,13
Concordia Ch,1288,6,3,3,8,17,22,-5,12
FCSB,1289,1,8,5,1,25,11,14,29
CFR Cluj,1289,2,5,7,2,14,10,4,22
Universitate,1289,3,4,6,4,16,19,-3,18
D Bucuresti,1289,4,4,4,6,18,19,-1,16
FC Botosani,1289,5,4,4,6,8,14,-6,16
Concordia Ch,1289,6,3,2,9,16,24,-8,11
FCSB,1290,1,8,5,1,25,13,12,29
CFR Cluj,1290,2,5,6,3,13,9,4,21
Universitate,1290,3,5,5,4,18,19,-1,20
FC Botosani,1290,4,3,6,5,5,12,-7,15
D Bucuresti,1290,5,3,5,6,17,20,-3,14
Concordia Ch,1290,6,3,3,8,17,22,-5,12
FCSB,1291,1,9,5,0,27,10,17,32
CFR Cluj,1291,2,5,6,3,14,11,3,21
D Bucuresti,1291,3,4,5,5,18,19,-1,17
Universitate,1291,4,4,5,5,16,21,-5,17
FC Botosani,1291,5,3,4,7,6,16,-10,13
Concordia Ch,1291,6,3,3,8,19,23,-4,12
FCSB,1292,1,8,5,1,27,14,13,29
CFR Cluj,1292,2,7,6,1,18,10,8,27
FC Botosani,1292,3,4,4,6,7,13,-6,16
D Bucuresti,1292,4,3,5,6,16,20,-4,14
Universitate,1292,5,3,5,6,16,22,-6,14
Concordia Ch,1292,6,3,3,8,16,21,-5,12
FCSB,1293,1,8,5,1,27,12,15,29
CFR Cluj,1293,2,5,7,2,14,11,3,22
Universitate,1293,3,4,6,4,17,20,-3,18
D Bucuresti,1293,4,4,4,6,19,22,-3,16
FC Botosani,1293,5,3,5,6,5,15,-10,14
Concordia Ch,1293,6,3,3,8,19,21,-2,12
FCSB,1294,1,9,5,0,29,11,18,32
CFR Cluj,1294,2,5,6,3,14,12,2,21
FC Botosani,1294,3,4,5,5,8,12,-4,17
Universitate,1294,4,4,5,5,17,22,-5,17
D Bucuresti,1294,5,4,4,6,17,21,-4,16
Concordia Ch,1294,6,2,3,9,15,22,-7,9
FCSB,1295,1,9,5,0,27,10,17,32
CFR Cluj,1295,2,5,7,2,14,10,4,22
D Bucuresti,1295,3,3,6,5,19,21,-2,15
Universitate,1295,4,3,6,5,15,21,-6,15
FC Botosani,1295,5,3,5,6,6,14,-8,14
Concordia Ch,1295,6,3,3,8,18,23,-5,12
FCSB,1296,1,8,6,0,26,11,15,30
CFR Cluj,1296,2,5,7,2,14,9,5,22
Universitate,1296,3,4,5,5,17,22,-5,17
FC Botosani,1296,4,4,5,5,7,13,-6,17
D Bucuresti,1296,5,4,4,6,18,20,-2,16
Concordia Ch,1296,6,2,3,9,17,24,-7,9
FCSB,1297,1,8,5,1,26,12,14,29
CFR Cluj,1297,2,5,7,2,14,10,4,22
Universitate,1297,3,4,6,4,15,18,-3,18
D Bucuresti,1297,4,4,5,5,19,20,-1,17
FC Botosani,1297,5,4,4,6,7,14,-7,16
Concordia Ch,1297,6,2,3,9,16,23,-7,9
FCSB,1298,1,9,5,0,27,10,17,32
CFR Cluj,1298,2,5,7,2,15,12,3,22
D Bucuresti,1298,3,4,5,5,19,18,1,17
FC Botosani,1298,4,4,5,5,6,12,-6,17
Universitate,1298,5,3,6,5,16,21,-5,15
Concordia Ch,1298,6,2,2,10,15,25,-10,8
FCSB,1299,1,8,5,1,24,12,12,29
CFR Cluj,1299,2,6,6,2,15,8,7,24
FC Botosani,1299,3,5,4,5,9,13,-4,19
Universitate,1299,4,4,5,5,16,20,-4,17
D Bucuresti,1299,5,4,4,6,20,22,-2,16
Concordia Ch,1299,6,2,2,10,17,26,-9,8
FCSB,1300,1,8,5,1,28,15,13,29
CFR Cluj,1300,2,6,6,2,16,9,7,24
D Bucuresti,1300,3,4,5,5,23,22,1,17
Universitate,1300,4,4,5,5,17,22,-5,17
FC Botosani,1300,5,3,4,7,6,17,-11,13
Concordia Ch,1300,6,3,3,8,19,24,-5,12
FCSB,1301,1,8,6,0,27,11,16,30
CFR Cluj,1301,2,6,6,2,16,11,5,24
FC Botosani,1301,3,4,4,6,10,14,-4,16
Universitate,1301,4,3,6,5,14,20,-6,15
Concordia Ch,1301,5,4,2,8,19,21,-2,14
D Bucuresti,1301,6,3,4,7,17,26,-9,13
FCSB,1302,1,8,6,0,26,12,14,30
CFR Cluj,1302,2,5,8,1,16,10,6,23
D Bucuresti,1302,3,4,4,6,20,21,-1,16
Universitate,1302,4,3,6,5,15,20,-5,15
FC Botosani,1302,5,3,5,6,5,15,-10,14
Concordia Ch,1302,6,3,3,8,18,22,-4,12
FCSB,1303,1,8,6,0,24,10,14,30
CFR Cluj,1303,2,5,6,3,13,9,4,21
D Bucuresti,1303,3,5,4,5,21,18,3,19
Universitate,1303,4,4,6,4,15,18,-3,18
FC Botosani,1303,5,3,5,6,7,18,-11,14
Concordia Ch,1303,6,2,3,9,17,24,-7,9
FCSB,1304,1,7,6,1,23,11,12,27
CFR Cluj,1304,2,6,7,1,14,7,7,25
Universitate,1304,3,4,5,5,15,19,-4,17
FC Botosani,1304,4,4,5,5,6,12,-6,17
D Bucuresti,1304,5,4,4,6,18,20,-2,16
Concordia Ch,1304,6,2,3,9,16,23,-7,9
FCSB,1305,1,7,5,2,25,16,9,26
CFR Cluj,1305,2,6,7,1,16,8,8,25
Universitate,1305,3,4,6,4,17,19,-2,18
FC Botosani,1305,4,3,6,5,8,15,-7,15
D Bucuresti,1305,5,3,5,6,18,22,-4,14
Concordia Ch,1305,6,3,3,8,18,22,-4,12
FCSB,1306,1,7,6,1,25,16,9,27
CFR Cluj,1306,2,5,8,1,15,9,6,23
Universitate,1306,3,4,6,4,20,20,0,18
D Bucuresti,1306,4,4,4,6,19,20,-1,16
FC Botosani,1306,5,4,4,6,7,15,-8,16
Concordia Ch,1306,6,3,2,9,16,22,-6,11
FCSB,1307,1,8,5,1,26,13,13,29
CFR Cluj,1307,2,7,6,1,19,10,9,27
FC Botosani,1307,3,4,4,6,7,15,-8,16
D Bucuresti,1307,4,3,5,6,19,22,-3,14
Universitate,1307,5,3,5,6,16,23,-7,14
Concordia Ch,1307,6,3,3,8,19,23,-4,12
FCSB,1308,1,8,6,0,29,13,16,30
CFR Cluj,1308,2,5,6,3,16,14,2,21
Universitate,1308,3,4,6,4,17,20,-3,18
D Bucuresti,1308,4,4,4,6,19,21,-2,16
FC Botosani,1308,5,4,4,6,8,13,-5,16
Concordia Ch,1308,6,3,2,9,18,26,-8,11
FCSB,1309,1,9,5,0,25,10,15,32
CFR Cluj,1309,2,6,6,2,15,8,7,24
D Bucuresti,1309,3,4,4,6,19,20,-1,16
FC Botosani,1309,4,4,4,6,8,14,-6,16
Universitate,1309,5,3,5,6,14,21,-7,14
Concordia Ch,1309,6,3,2,9,17,25,-8,11
FCSB,1310,1,8,6,0,26,11,15,30
CFR Cluj,1310,2,5,6,3,13,11,2,21
FC Botosani,1310,3,5,4,5,9,13,-4,19
Universitate,1310,4,4,6,4,17,19,-2,18
D Bucuresti,1310,5,3,5,6,18,21,-3,14
Concordia Ch,1310,6,2,3,9,16,24,-8,9
FCSB,1311,1,8,6,0,26,12,14,30
CFR Cluj,1311,2,6,7,1,15,8,7,25
FC Botosani,1311,3,3,6,5,6,13,-7,15
D Bucuresti,1311,4,3,5,6,17,22,-5,14
Universitate,1311,5,3,5,6,15,21,-6,14
Concordia Ch,1311,6,3,3,8,18,21,-3,12
FCSB,1312,1,8,5,1,25,13,12,29
CFR Cluj,1312,2,5,7,2,13,9,4,22
FC Botosani,1312,3,5,4,5,8,13,-5,19
Universitate,1312,4,4,6,4,17,18,-1,18
D Bucuresti,1312,5,3,4,7,16,21,-5,13
Concordia Ch,1312,6,3,2,9,18,23,-5,11
FCSB,1313,1,9,5,0,29,10,19,32
CFR Cluj,1313,2,5,7,2,14,9,5,22
FC Botosani,1313,3,4,5,5,8,14,-6,17
D Bucuresti,1313,4,3,6,5,18,20,-2,15
Universitate,1313,5,3,6,5,15,24,-9,15
Concordia Ch,1313,6,2,3,9,17,24,-7,9
FCSB,1314,1,7,6,1,24,14,10,27
CFR Cluj,1314,2,5,7,2,16,11,5,22
Universitate,1314,3,5,5,4,20,20,0,20
D Bucuresti,1314,4,4,4,6,17,20,-3,16
Concordia Ch,1314,5,4,2,8,18,21,-3,14
FC Botosani,1314,6,3,4,7,5,14,-9,13
FCSB,1315,1,8,5,1,24,11,13,29
CFR Cluj,1315,2,6,7,1,15,8,7,25
D Bucuresti,1315,3,4,4,6,20,22,-2,16
FC Botosani,1315,4,4,4,6,8,16,-8,16
Universitate,1315,5,3,6,5,15,20,-5,15
Concordia Ch,1315,6,3,2,9,19,24,-5,11
FCSB,1316,1,7,7,0,25,12,13,28
CFR Cluj,1316,2,6,7,1,16,8,8,25
D Bucuresti,1316,3,4,5,5,19,18,1,17
FC Botosani,1316,4,4,5,5,6,12,-6,17
Universitate,1316,5,3,6,5,15,21,-6,15
Concordia Ch,1316,6,2,2,10,15,25,-10,8
CFR Cluj,1317,1,7,6,1,16,7,9,27
FCSB,1317,2,7,5,2,23,13,10,26
D Bucuresti,1317,3,4,5,5,17,18,-1,17
Universitate,1317,4,4,5,5,16,20,-4,17
FC Botosani,1317,5,3,4,7,5,14,-9,13
Concordia Ch,1317,6,3,3,8,16,21,-5,12
FCSB,1318,1,7,6,1,24,13,11,27
CFR Cluj,1318,2,6,7,1,15,8,7,25
D Bucuresti,1318,3,5,4,5,22,21,1,19
Universitate,1318,4,4,5,5,16,19,-3,17
FC Botosani,1318,5,4,4,6,9,16,-7,16
Concordia Ch,1318,6,2,2,10,16,25,-9,8
FCSB,1319,1,8,6,0,27,13,14,30
CFR Cluj,1319,2,5,8,1,16,10,6,23
D Bucuresti,1319,3,4,4,6,20,20,0,16
FC Botosani,1319,4,4,4,6,7,14,-7,16
Universitate,1319,5,3,6,5,16,21,-5,15
Concordia Ch,1319,6,3,2,9,18,26,-8,11
FCSB,1320,1,8,5,1,24,12,12,29
CFR Cluj,1320,2,6,6,2,15,8,7,24
Universitate,1320,3,4,5,5,16,20,-4,17
FC Botosani,1320,4,4,5,5,8,13,-5,17
D Bucuresti,1320,5,3,4,7,17,23,-6,13
Concordia Ch,1320,6,3,3,8,17,21,-4,12
FCSB,1321,1,7,6,1,25,13,12,27
CFR Cluj,1321,2,6,7,1,15,8,7,25
D Bucuresti,1321,3,4,5,5,19,19,0,17
Universitate,1321,4,4,5,5,18,22,-4,17
FC Botosani,1321,5,4,5,5,7,12,-5,17
Concordia Ch,1321,6,2,2,10,16,26,-10,8
FCSB,1322,1,8,6,0,26,12,14,30
CFR Cluj,1322,2,5,7,2,15,10,5,22
Universitate,1322,3,4,5,5,17,21,-4,17
FC Botosani,1322,4,4,5,5,9,15,-6,17
D Bucuresti,1322,5,4,4,6,20,21,-1,16
Concordia Ch,1322,6,2,3,9,16,24,-8,9
FCSB,1323,1,9,5,0,27,10,17,32
CFR Cluj,1323,2,6,6,2,15,10,5,24
D Bucuresti,1323,3,4,5,5,18,19,-1,17
Universitate,1323,4,3,5,6,15,22,-7,14
FC Botosani,1323,5,3,4,7,5,15,-10,13
Concordia Ch,1323,6,3,3,8,18,22,-4,12
FCSB,1324,1,7,6,1,23,11,12,27
CFR Cluj,1324,2,6,7,1,16,8,8,25
D Bucuresti,1324,3,4,5,5,18,19,-1,17
Universitate,1324,4,4,5,5,16,21,-5,17
FC Botosani,1324,5,3,5,6,5,13,-8,14
Concordia Ch,1324,6,2,4,8,16,22,-6,10
FCSB,1325,1,8,5,1,27,14,13,29
CFR Cluj,1325,2,6,6,2,15,10,5,24
D Bucuresti,1325,3,5,4,5,18,18,0,19
Universitate,1325,4,4,5,5,18,21,-3,17
FC Botosani,1325,5,3,4,7,5,15,-10,13
Concordia Ch,1325,6,3,2,9,17,22,-5,11
FCSB,1326,1,8,5,1,27,14,13,29
CFR Cluj,1326,2,6,7,1,16,8,8,25
FC Botosani,1326,3,5,4,5,12,12,0,19
Universitate,1326,4,3,6,5,17,23,-6,15
D Bucuresti,1326,5,3,4,7,17,22,-5,13
Concordia Ch,1326,6,3,2,9,18,28,-10,11
FCSB,1327,1,7,7,0,24,11,13,28
CFR Cluj,1327,2,6,7,1,18,7,11,25
Universitate,1327,3,3,6,5,15,24,-9,15
D Bucuresti,1327,4,3,5,6,18,21,-3,14
Concordia Ch,1327,5,4,2,8,18,22,-4,14
FC Botosani,1327,6,3,5,6,8,16,-8,14
FCSB,1328,1,8,5,1,26,13,13,29
CFR Cluj,1328,2,5,7,2,16,12,4,22
Universitate,1328,3,4,6,4,18,20,-2,18
D Bucuresti,1328,4,4,5,5,21,20,1,17
FC Botosani,1328,5,3,5,6,5,15,-10,14
Concordia Ch,1328,6,2,4,8,17,23,-6,10
FCSB,1329,1,7,7,0,26,13,13,28
CFR Cluj,1329,2,5,8,1,15,9,6,23
D Bucuresti,1329,3,4,4,6,21,23,-2,16
Universitate,1329,4,3,7,4,15,19,-4,16
Concordia Ch,1329,5,4,2,8,21,25,-4,14
FC Botosani,1329,6,3,4,7,5,14,-9,13
FCSB,1330,1,8,5,1,26,12,14,29
CFR Cluj,1330,2,7,6,1,16,8,8,27
D Bucuresti,1330,3,4,5,5,23,22,1,17
FC Botosani,1330,4,4,4,6,9,17,-8,16
Universitate,1330,5,3,5,6,14,21,-7,14
Concordia Ch,1330,6,2,3,9,17,25,-8,9
FCSB,1331,1,8,6,0,25,11,14,30
CFR Cluj,1331,2,6,7,1,16,7,9,25
FC Botosani,1331,3,4,5,5,7,13,-6,17
D Bucuresti,1331,4,3,5,6,17,20,-3,14
Universitate,1331,5,3,5,6,15,23,-8,14
Concordia Ch,1331,6,3,2,9,16,22,-6,11
FCSB,1332,1,9,5,0,29,10,19,32
CFR Cluj,1332,2,5,6,3,13,12,1,21
Universitate,1332,3,4,5,5,15,20,-5,17
D Bucuresti,1332,4,4,4,6,18,20,-2,16
FC Botosani,1332,5,4,4,6,7,14,-7,16
Concordia Ch,1332,6,3,2,9,18,24,-6,11
FCSB,1333,1,9,5,0,26,10,16,32
CFR Cluj,1333,2,5,6,3,14,11,3,21
Universitate,1333,3,4,5,5,17,21,-4,17
FC Botosani,1333,4,4,5,5,10,16,-6,17
D Bucuresti,1333,5,3,5,6,20,23,-3,14
Concordia Ch,1333,6,2,4,8,19,25,-6,10
FCSB,1334,1,7,6,1,25,14,11,27
CFR Cluj,1334,2,6,7,1,17,9,8,25
Universitate,1334,3,4,5,5,16,20,-4,17
D Bucuresti,1334,4,4,4,6,21,23,-2,16
Concordia Ch,1334,5,4,2,8,20,22,-2,14
FC Botosani,1334,6,3,4,7,6,17,-11,13
FCSB,1335,1,7,6,1,23,11,12,27
CFR Cluj,1335,2,6,7,1,17,8,9,25
Universitate,1335,3,4,5,5,16,22,-6,17
D Bucuresti,1335,4,4,4,6,18,21,-3,16
Concordia Ch,1335,5,4,2,8,19,22,-3,14
FC Botosani,1335,6,3,4,7,5,14,-9,13
FCSB,1336,1,8,6,0,26,11,15,30
CFR Cluj,1336,2,5,7,2,15,11,4,22
D Bucuresti,1336,3,5,4,5,20,18,2,19
Universitate,1336,4,3,7,4,17,21,-4,16
FC Botosani,1336,5,4,4,6,7,13,-6,16
Concordia Ch,1336,6,2,2,10,15,26,-11,8
FCSB,1337,1,9,5,0,27,11,16,32
CFR Cluj,1337,2,6,6,2,16,10,6,24
D Bucuresti,1337,3,4,5,5,20,21,-1,17
FC Botosani,1337,4,4,5,5,7,13,-6,17
Universitate,1337,5,3,5,6,14,21,-7,14
Concordia Ch,1337,6,2,2,10,17,25,-8,8
FCSB,1338,1,8,6,0,27,12,15,30
CFR Cluj,1338,2,6,7,1,17,9,8,25
FC Botosani,1338,3,4,5,5,8,13,-5,17
Universitate,1338,4,3,5,6,14,22,-8,14
D Bucuresti,1338,5,3,4,7,17,22,-5,13
Concordia Ch,1338,6,3,3,8,18,23,-5,12
FCSB,1339,1,8,6,0,26,12,14,30
CFR Cluj,1339,2,5,7,2,15,10,5,22
D Bucuresti,1339,3,5,4,5,21,21,0,19
Universitate,1339,4,4,5,5,17,21,-4,17
FC Botosani,1339,5,4,4,6,6,13,-7,16
Concordia Ch,1339,6,2,2,10,18,26,-8,8
FCSB,1340,1,9,5,0,28,12,16,32
CFR Cluj,1340,2,6,6,2,15,10,5,24
FC Botosani,1340,3,4,5,5,7,12,-5,17
D Bucuresti,1340,4,4,4,6,18,21,-3,16
Universitate,1340,5,3,5,6,15,21,-6,14
Concordia Ch,1340,6,2,3,9,16,23,-7,9
FCSB,1341,1,7,5,2,25,14,11,26
CFR Cluj,1341,2,6,6,2,16,10,6,24
Universitate,1341,3,5,5,4,18,20,-2,20
D Bucuresti,1341,4,3,6,5,17,19,-2,15
FC Botosani,1341,5,3,6,5,5,12,-7,15
Concordia Ch,1341,6,2,4,8,16,22,-6,10
FCSB,1342,1,8,6,0,26,12,14,30
CFR Cluj,1342,2,5,6,3,14,10,4,21
Universitate,1342,3,4,6,4,16,19,-3,18
D Bucuresti,1342,4,4,4,6,17,19,-2,16
FC Botosani,1342,5,4,4,6,8,13,-5,16
Concordia Ch,1342,6,3,2,9,16,24,-8,11
CFR Cluj,1343,1,7,6,1,19,8,11,27
FCSB,1343,2,7,5,2,23,14,9,26
D Bucuresti,1343,3,5,4,5,19,18,1,19
Universitate,1343,4,4,5,5,18,23,-5,17
FC Botosani,1343,5,4,4,6,7,14,-7,16
Concordia Ch,1343,6,2,2,10,16,25,-9,8
FCSB,1344,1,7,7,0,27,14,13,28
CFR Cluj,1344,2,6,7,1,18,9,9,25
FC Botosani,1344,3,4,5,5,9,14,-5,17
D Bucuresti,1344,4,4,4,6,19,22,-3,16
Universitate,1344,5,3,6,5,16,23,-7,15
Concordia Ch,1344,6,2,3,9,17,24,-7,9
FCSB,1345,1,7,7,0,26,13,13,28
CFR Cluj,1345,2,6,7,1,18,9,9,25
FC Botosani,1345,3,4,4,6,6,14,-8,16
Universitate,1345,4,3,6,5,15,22,-7,15
D Bucuresti,1345,5,3,5,6,16,19,-3,14
Concordia Ch,1345,6,3,3,8,17,21,-4,12
FCSB,1346,1,7,7,0,25,12,13,28
CFR Cluj,1346,2,5,8,1,14,8,6,23
D Bucuresti,1346,3,5,4,5,19,19,0,19
Universitate,1346,4,3,7,4,15,19,-4,16
FC Botosani,1346,5,4,4,6,6,13,-7,16
Concordia Ch,1346,6,2,2,10,16,24,-8,8
FCSB,1347,1,8,5,1,28,14,14,29
CFR Cluj,1347,2,7,6,1,16,7,9,27
FC Botosani,1347,3,5,4,5,9,12,-3,19
D Bucuresti,1347,4,4,4,6,19,21,-2,16
Universitate,1347,5,3,5,6,16,24,-8,14
Concordia Ch,1347,6,2,2,10,15,25,-10,8
FCSB,1348,1,8,5,1,26,12,14,29
CFR Cluj,1348,2,6,6,2,14,9,5,24
D Bucuresti,1348,3,4,5,5,19,20,-1,17
Universitate,1348,4,4,5,5,16,20,-4,17
FC Botosani,1348,5,4,5,5,8,13,-5,17
Concordia Ch,1348,6,2,2,10,16,25,-9,8
FCSB,1349,1,8,5,1,25,12,13,29
CFR Cluj,1349,2,5,7,2,15,10,5,22
FC Botosani,1349,3,5,4,5,7,12,-5,19
Universitate,1349,4,4,6,4,16,19,-3,18
D Bucuresti,1349,5,4,4,6,17,19,-2,16
Concordia Ch,1349,6,2,2,10,15,23,-8,8
FCSB,1350,1,9,5,0,27,10,17,32
CFR Cluj,1350,2,6,6,2,14,8,6,24
D Bucuresti,1350,3,4,4,6,22,22,0,16
FC Botosani,1350,4,4,4,6,12,18,-6,16
Universitate,1350,5,3,5,6,14,22,-8,14
Concordia Ch,1350,6,3,2,9,20,29,-9,11
FCSB,1351,1,8,5,1,27,13,14,29
CFR Cluj,1351,2,5,7,2,14,10,4,22
D Bucuresti,1351,3,5,4,5,20,19,1,19
Universitate,1351,4,4,6,4,16,19,-3,18
FC Botosani,1351,5,3,4,7,5,15,-10,13
Concordia Ch,1351,6,3,2,9,17,23,-6,11
FCSB,1352,1,8,5,1,26,13,13,29
CFR Cluj,1352,2,6,6,2,14,9,5,24
D Bucuresti,1352,3,4,5,5,18,19,-1,17
Universitate,1352,4,4,5,5,17,20,-3,17
FC Botosani,1352,5,3,4,7,5,14,-9,13
Concordia Ch,1352,6,3,3,8,17,22,-5,12
FCSB,1353,1,8,5,1,27,12,15,29
CFR Cluj,1353,2,5,6,3,13,11,2,21
Universitate,1353,3,5,5,4,17,19,-2,20
D Bucuresti,1353,4,4,5,5,19,20,-1,17
FC Botosani,1353,5,4,5,5,6,12,-6,17
Concordia Ch,1353,6,2,2,10,17,25,-8,8
FCSB,1354,1,7,6,1,23,12,11,27
CFR Cluj,1354,2,5,7,2,13,8,5,22
Universitate,1354,3,5,5,4,17,18,-1,20
D Bucuresti,1354,4,4,4,6,20,22,-2,16
FC Botosani,1354,5,3,5,6,8,17,-9,14
Concordia Ch,1354,6,3,3,8,18,22,-4,12
FCSB,1355,1,8,5,1,26,12,14,29
CFR Cluj,1355,2,5,7,2,15,11,4,22
Universitate,1355,3,4,6,4,18,21,-3,18
D Bucuresti,1355,4,4,4,6,19,21,-2,16
FC Botosani,1355,5,4,4,6,9,15,-6,16
Concordia Ch,1355,6,3,2,9,18,25,-7,11
FCSB,1356,1,9,5,0,27,12,15,32
CFR Cluj,1356,2,5,7,2,13,8,5,22
D Bucuresti,1356,3,5,4,5,21,18,3,19
Universitate,1356,4,3,6,5,16,21,-5,15
FC Botosani,1356,5,3,5,6,6,17,-11,14
Concordia Ch,1356,6,2,3,9,16,23,-7,9
FCSB,1357,1,7,5,2,26,15,11,26
CFR Cluj,1357,2,6,6,2,16,11,5,24
Universitate,1357,3,5,5,4,20,21,-1,20
FC Botosani,1357,4,4,5,5,7,13,-6,17
D Bucuresti,1357,5,3,5,6,17,22,-5,14
Concordia Ch,1357,6,3,2,9,18,22,-4,11
FCSB,1358,1,9,5,0,26,11,15,32
CFR Cluj,1358,2,6,6,2,14,8,6,24
D Bucuresti,1358,3,4,5,5,19,19,0,17
Universitate,1358,4,3,5,6,15,21,-6,14
FC Botosani,1358,5,3,5,6,5,14,-9,14
Concordia Ch,1358,6,2,4,8,16,22,-6,10
FCSB,1359,1,8,5,1,28,15,13,29
CFR Cluj,1359,2,7,6,1,19,11,8,27
D Bucuresti,1359,3,4,5,5,19,20,-1,17
FC Botosani,1359,4,4,5,5,7,13,-6,17
Universitate,1359,5,3,5,6,16,22,-6,14
Concordia Ch,1359,6,2,2,10,16,24,-8,8
FCSB,1360,1,7,5,2,24,14,10,26
CFR Cluj,1360,2,6,6,2,15,9,6,24
Universitate,1360,3,5,5,4,18,19,-1,20
D Bucuresti,1360,4,4,5,5,21,21,0,17
FC Botosani,1360,5,4,4,6,8,15,-7,16
Concordia Ch,1360,6,2,3,9,17,25,-8,9
FCSB,1361,1,8,6,0,26,12,14,30
CFR Cluj,1361,2,5,7,2,16,11,5,22
Universitate,1361,3,3,7,4,19,23,-4,16
Concordia Ch,1361,4,4,2,8,20,21,-1,14
D Bucuresti,1361,5,3,5,6,17,23,-6,14
FC Botosani,1361,6,3,5,6,6,14,-8,14
FCSB,1362,1,7,7,0,24,11,13,28
CFR Cluj,1362,2,5,7,2,15,10,5,22
Universitate,1362,3,4,6,4,16,19,-3,18
D Bucuresti,1362,4,3,6,5,18,20,-2,15
FC Botosani,1362,5,3,5,6,7,16,-9,14
Concordia Ch,1362,6,3,3,8,17,21,-4,12
FCSB,1363,1,9,5,0,28,12,16,32
CFR Cluj,1363,2,5,6,3,14,11,3,21
D Bucuresti,1363,3,5,4,5,18,18,0,19
Universitate,1363,4,4,5,5,17,21,-4,17
FC Botosani,1363,5,4,4,6,7,13,-6,16
Concordia Ch,1363,6,2,2,10,15,24,-9,8
FCSB,1364,1,9,5,0,26,11,15,32
CFR Cluj,1364,2,6,6,2,16,9,7,24
FC Botosani,1364,3,4,5,5,8,14,-6,17
D Bucuresti,1364,4,3,6,5,17,19,-2,15
Universitate,1364,5,3,5,6,16,23,-7,14
Concordia Ch,1364,6,2,3,9,16,23,-7,9
FCSB,1365,1,9,5,0,25,10,15,32
CFR Cluj,1365,2,6,6,2,16,9,7,24
FC Botosani,1365,3,4,4,6,7,15,-8,16
Concordia Ch,1365,4,4,2,8,18,21,-3,14
Universitate,1365,5,3,5,6,15,22,-7,14
D Bucuresti,1365,6,3,4,7,17,21,-4,13
FCSB,1366,1,9,5,0,31,10,21,32
CFR Cluj,1366,2,5,7,2,13,12,1,22
FC Botosani,1366,3,4,5,5,8,14,-6,17
D Bucuresti,1366,4,3,6,5,18,20,-2,15
Universitate,1366,5,3,6,5,14,21,-7,15
Concordia Ch,1366,6,2,3,9,15,22,-7,9
FCSB,1367,1,8,6,0,26,12,14,30
CFR Cluj,1367,2,5,7,2,16,11,5,22
FC Botosani,1367,3,5,4,5,9,13,-4,19
Universitate,1367,4,3,7,4,17,21,-4,16
D Bucuresti,1367,5,3,4,7,16,22,-6,13
Concordia Ch,1367,6,3,2,9,18,23,-5,11
FCSB,1368,1,8,6,0,27,13,14,30
CFR Cluj,1368,2,5,7,2,16,11,5,22
D Bucuresti,1368,3,5,4,5,18,18,0,19
Universitate,1368,4,3,7,4,16,20,-4,16
FC Botosani,1368,5,4,4,6,7,14,-7,16
Concordia Ch,1368,6,2,2,10,16,24,-8,8
FCSB,1369,1,8,5,1,25,13,12,29
CFR Cluj,1369,2,5,7,2,14,9,5,22
Universitate,1369,3,4,6,4,16,18,-2,18
D Bucuresti,1369,4,4,5,5,18,19,-1,17
FC Botosani,1369,5,3,5,6,6,14,-8,14
Concordia Ch,1369,6,2,4,8,17,23,-6,10
FCSB,1370,1,7,6,1,24,13,11,27
CFR Cluj,1370,2,7,6,1,16,7,9,27
FC Botosani,1370,3,4,5,5,7,13,-6,17
Universitate,1370,4,3,6,5,15,20,-5,15
D Bucuresti,1370,5,3,5,6,17,21,-4,14
Concordia Ch,1370,6,3,2,9,17,22,-5,11
FCSB,1371,1,9,5,0,29,12,17,32
CFR Cluj,1371,2,5,7,2,15,10,5,22
D Bucuresti,1371,3,4,5,5,19,20,-1,17
Universitate,1371,4,3,6,5,14,21,-7,15
FC Botosani,1371,5,3,6,5,7,14,-7,15
Concordia Ch,1371,6,2,3,9,15,22,-7,9
FCSB,1372,1,7,6,1,25,14,11,27
CFR Cluj,1372,2,5,7,2,15,10,5,22
Universitate,1372,3,5,5,4,17,18,-1,20
D Bucuresti,1372,4,5,4,5,20,18,2,19
FC Botosani,1372,5,4,4,6,8,14,-6,16
Concordia Ch,1372,6,2,2,10,16,27,-11,8
FCSB,1373,1,9,5,0,28,11,17,32
CFR Cluj,1373,2,5,7,2,13,10,3,22
D Bucuresti,1373,3,4,4,6,19,20,-1,16
Universitate,1373,4,3,6,5,15,20,-5,15
Concordia Ch,1373,5,4,2,8,17,21,-4,14
FC Botosani,1373,6,3,4,7,6,16,-10,13
FCSB,1374,1,8,6,0,24,10,14,30
CFR Cluj,1374,2,6,6,2,17,9,8,24
D Bucuresti,1374,3,4,4,6,18,20,-2,16
FC Botosani,1374,4,4,4,6,6,14,-8,16
Universitate,1374,5,3,6,5,15,22,-7,15
Concordia Ch,1374,6,3,2,9,17,22,-5,11
FCSB,1375,1,8,5,1,24,11,13,29
CFR Cluj,1375,2,7,6,1,16,8,8,27
FC Botosani,1375,3,5,4,5,9,12,-3,19
Universitate,1375,4,3,5,6,15,21,-6,14
D Bucuresti,1375,5,3,4,7,17,22,-5,13
Concordia Ch,1375,6,3,2,9,18,25,-7,11
FCSB,1376,1,8,5,1,25,11,14,29
CFR Cluj,1376,2,6,7,1,15,8,7,25
FC Botosani,1376,3,5,4,5,11,12,-1,19
D Bucuresti,1376,4,4,4,6,17,21,-4,16
Universitate,1376,5,3,6,5,15,21,-6,15
Concordia Ch,1376,6,2,2,10,15,25,-10,8
FCSB,1377,1,7,6,1,24,12,12,27
CFR Cluj,1377,2,6,7,1,14,7,7,25
D Bucuresti,1377,3,5,4,5,19,19,0,19
Universitate,1377,4,3,7,4,15,19,-4,16
FC Botosani,1377,5,3,4,7,6,16,-10,13
Concordia Ch,1377,6,3,2,9,17,22,-5,11
FCSB,1378,1,7,6,1,24,13,11,27
CFR Cluj,1378,2,6,7,1,16,9,7,25
Universitate,1378,3,4,5,5,17,20,-3,17
D Bucuresti,1378,4,4,4,6,21,20,1,16
FC Botosani,1378,5,3,5,6,5,16,-11,14
Concordia Ch,1378,6,3,3,8,17,22,-5,12
FCSB,1379,1,8,6,0,25,10,15,30
CFR Cluj,1379,2,5,6,3,13,11,2,21
Universitate,1379,3,4,6,4,16,18,-2,18
D Bucuresti,1379,4,4,4,6,17,19,-2,16
FC Botosani,1379,5,4,4,6,6,13,-7,16
Concordia Ch,1379,6,3,2,9,16,22,-6,11
FCSB,1380,1,8,6,0,25,10,15,30
CFR Cluj,1380,2,6,6,2,14,9,5,24
FC Botosani,1380,3,4,5,5,8,14,-6,17
Universitate,1380,4,3,6,5,14,19,-5,15
D Bucuresti,1380,5,3,5,6,17,20,-3,14
Concordia Ch,1380,6,2,4,8,16,22,-6,10
FCSB,1381,1,9,5,0,27,11,16,32
CFR Cluj,1381,2,6,6,2,17,10,7,24
FC Botosani,1381,3,5,4,5,7,12,-5,19
D Bucuresti,1381,4,4,4,6,17,19,-2,16
Universitate,1381,5,3,5,6,15,23,-8,14
Concordia Ch,1381,6,2,2,10,15,23,-8,8
FCSB,1382,1,8,6,0,25,10,15,30
CFR Cluj,1382,2,6,6,2,17,11,6,24
Universitate,1382,3,3,6,5,16,22,-6,15
FC Botosani,1382,4,3,6,5,7,14,-7,15
D Bucuresti,1382,5,3,5,6,17,22,-5,14
Concordia Ch,1382,6,3,3,8,19,22,-3,12
FCSB,1383,1,7,6,1,24,12,12,27
CFR Cluj,1383,2,6,7,1,16,8,8,25
Universitate,1383,3,4,5,5,15,20,-5,17
D Bucuresti,1383,4,3,5,6,16,19,-3,14
Concordia Ch,1383,5,4,2,8,17,21,-4,14
FC Botosani,1383,6,3,5,6,5,13,-8,14
FCSB,1384,1,8,6,0,24,10,14,30
CFR Cluj,1384,2,5,6,3,13,9,4,21
Universitate,1384,3,4,6,4,15,18,-3,18
FC Botosani,1384,4,4,5,5,7,13,-6,17
D Bucuresti,1384,5,3,5,6,16,20,-4,14
Concordia Ch,1384,6,3,2,9,18,23,-5,11
FCSB,1385,1,8,5,1,28,14,14,29
CFR Cluj,1385,2,7,6,1,17,8,9,27
FC Botosani,1385,3,4,5,5,9,13,-4,17
D Bucuresti,1385,4,3,6,5,18,20,-2,15
Universitate,1385,5,3,5,6,18,26,-8,14
Concordia Ch,1385,6,2,3,9,16,25,-9,9
FCSB,1386,1,9,5,0,26,10,16,32
CFR Cluj,1386,2,5,6,3,13,11,2,21
Universitate,1386,3,4,5,5,16,19,-3,17
D Bucuresti,1386,4,3,6,5,19,21,-2,15
FC Botosani,1386,5,3,6,5,7,14,-7,15
Concordia Ch,1386,6,2,4,8,18,24,-6,10
FCSB,1387,1,8,6,0,28,12,16,30
CFR Cluj,1387,2,5,6,3,13,11,2,21
Universitate,1387,3,4,6,4,17,20,-3,18
FC Botosani,1387,4,4,4,6,9,16,-7,16
D Bucuresti,1387,5,3,5,6,18,21,-3,14
Concordia Ch,1387,6,3,3,8,17,22,-5,12
FCSB,1388,1,9,5,0,27,12,15,32
CFR Cluj,1388,2,6,6,2,16,9,7,24
FC Botosani,1388,3,4,5,5,7,13,-6,17
D Bucuresti,1388,4,4,4,6,21,21,0,16
Universitate,1388,5,3,5,6,17,24,-7,14
Concordia Ch,1388,6,2,3,9,16,25,-9,9
FCSB,1389,1,8,6,0,28,13,15,30
CFR Cluj,1389,2,6,6,2,16,10,6,24
D Bucuresti,1389,3,5,4,5,18,18,0,19
Universitate,1389,4,3,6,5,16,22,-6,15
FC Botosani,1389,5,3,5,6,5,13,-8,14
Concordia Ch,1389,6,2,3,9,15,22,-7,9
FCSB,1390,1,7,7,0,26,13,13,28
CFR Cluj,1390,2,5,7,2,15,11,4,22
D Bucuresti,1390,3,5,4,5,20,18,2,19
Universitate,1390,4,4,6,4,19,21,-2,18
FC Botosani,1390,5,4,4,6,6,15,-9,16
Concordia Ch,1390,6,2,2,10,15,23,-8,8
FCSB,1391,1,8,5,1,27,14,13,29
CFR Cluj,1391,2,5,7,2,17,12,5,22
Universitate,1391,3,4,6,4,18,21,-3,18
FC Botosani,1391,4,4,5,5,6,12,-6,17
D Bucuresti,1391,5,3,5,6,17,21,-4,14
Concordia Ch,1391,6,3,2,9,18,23,-5,11
FCSB,1392,1,8,5,1,26,12,14,29
CFR Cluj,1392,2,6,7,1,15,8,7,25
FC Botosani,1392,3,4,5,5,8,13,-5,17
D Bucuresti,1392,4,4,4,6,21,24,-3,16
Universitate,1392,5,3,6,5,16,22,-6,15
Concordia Ch,1392,6,2,3,9,18,25,-7,9
FCSB,1393,1,7,7,0,24,11,13,28
CFR Cluj,1393,2,6,7,1,14,7,7,25
FC Botosani,1393,3,4,5,5,6,12,-6,17
Universitate,1393,4,3,6,5,15,20,-5,15
D Bucuresti,1393,5,3,4,7,19,23,-4,13
Concordia Ch,1393,6,3,3,8,19,24,-5,12
FCSB,1394,1,8,5,1,26,13,13,29
CFR Cluj,1394,2,6,6,2,17,9,8,24
FC Botosani,1394,3,4,5,5,9,14,-5,17
Universitate,1394,4,4,5,5,18,24,-6,17
D Bucuresti,1394,5,3,4,7,16,22,-6,13
Concordia Ch,1394,6,3,3,8,19,23,-4,12
FCSB,1395,1,8,5,1,26,14,12,29
CFR Cluj,1395,2,5,7,2,13,9,4,22
Universitate,1395,3,4,6,4,18,19,-1,18
D Bucuresti,1395,4,4,5,5,21,21,0,17
FC Botosani,1395,5,4,5,5,8,13,-5,17
Concordia Ch,1395,6,2,2,10,17,27,-10,8
FCSB,1396,1,7,7,0,25,12,13,28
CFR Cluj,1396,2,5,7,2,14,9,5,22
Universitate,1396,3,4,6,4,16,19,-3,18
D Bucuresti,1396,4,4,4,6,18,21,-3,16
Concordia Ch,1396,5,4,2,8,20,22,-2,14
FC Botosani,1396,6,3,4,7,6,16,-10,13
FCSB,1397,1,8,6,0,25,11,14,30
CFR Cluj,1397,2,6,7,1,16,8,8,25
D Bucuresti,1397,3,5,4,5,20,18,2,19
FC Botosani,1397,4,4,4,6,7,14,-7,16
Universitate,1397,5,3,5,6,14,21,-7,14
Concordia Ch,1397,6,2,2,10,16,26,-10,8
FCSB,1398,1,7,6,1,25,14,11,27
CFR Cluj,1398,2,6,7,1,16,9,7,25
Universitate,1398,3,4,5,5,18,21,-3,17
FC Botosani,1398,4,4,5,5,9,12,-3,17
D Bucuresti,1398,5,3,6,5,17,19,-2,15
Concordia Ch,1398,6,2,3,9,16,26,-10,9
FCSB,1399,1,8,6,0,27,11,16,30
CFR Cluj,1399,2,5,7,2,15,12,3,22
D Bucuresti,1399,3,4,5,5,20,18,2,17
Universitate,1399,4,3,7,4,15,19,-4,16
FC Botosani,1399,5,4,4,6,6,16,-10,16
Concordia Ch,1399,6,2,3,9,15,22,-7,9
FCSB,1400,1,9,5,0,29,12,17,32
CFR Cluj,1400,2,6,6,2,17,12,5,24
D Bucuresti,1400,3,5,4,5,20,19,1,19
FC Botosani,1400,4,4,4,6,7,15,-8,16
Universitate,1400,5,3,5,6,16,23,-7,14
Concordia Ch,1400,6,2,2,10,17,25,-8,8
FCSB,1401,1,7,6,1,24,14,10,27
CFR Cluj,1401,2,7,6,1,17,7,10,27
D Bucuresti,1401,3,4,5,5,18,19,-1,17
Universitate,1401,4,3,6,5,15,20,-5,15
FC Botosani,1401,5,3,4,7,5,14,-9,13
Concordia Ch,1401,6,3,3,8,17,22,-5,12
FCSB,1402,1,7,6,1,23,12,11,27
CFR Cluj,1402,2,6,7,1,15,7,8,25
Universitate,1402,3,3,7,4,14,18,-4,16
Concordia Ch,1402,4,4,2,8,20,23,-3,14
D Bucuresti,1402,5,3,5,6,20,24,-4,14
FC Botosani,1402,6,3,5,6,7,15,-8,14
FCSB,1403,1,8,5,1,26,12,14,29
CFR Cluj,1403,2,6,6,2,14,8,6,24
Universitate,1403,3,4,5,5,16,21,-5,17
D Bucuresti,1403,4,4,4,6,18,21,-3,16
FC Botosani,1403,5,3,5,6,7,15,-8,14
Concordia Ch,1403,6,3,3,8,18,22,-4,12
FCSB,1404,1,8,6,0,26,12,14,30
CFR Cluj,1404,2,6,7,1,15,8,7,25
FC Botosani,1404,3,5,4,5,8,13,-5,19
Universitate,1404,4,3,5,6,15,21,-6,14
D Bucuresti,1404,5,3,4,7,17,22,-5,13
Concordia Ch,1404,6,3,2,9,19,24,-5,11
FCSB,1405,1,9,5,0,31,10,21,32
CFR Cluj,1405,2,5,7,2,13,12,1,22
D Bucuresti,1405,3,4,5,5,21,21,0,17
FC Botosani,1405,4,4,4,6,9,16,-7,16
Universitate,1405,5,3,6,5,14,21,-7,15
Concordia Ch,1405,6,2,3,9,18,26,-8,9
FCSB,1406,1,9,5,0,30,12,18,32
CFR Cluj,1406,2,6,6,2,17,11,6,24
D Bucuresti,1406,3,5,4,5,18,18,0,19
Universitate,1406,4,3,5,6,15,24,-9,14
FC Botosani,1406,5,3,4,7,5,15,-10,13
Concordia Ch,1406,6,3,2,9,17,22,-5,11
FCSB,1407,1,8,6,0,27,10,17,30
CFR Cluj,1407,2,5,6,3,13,13,0,21
Universitate,1407,3,4,6,4,16,18,-2,18
D Bucuresti,1407,4,3,6,5,18,20,-2,15
FC Botosani,1407,5,3,5,6,6,14,-8,14
Concordia Ch,1407,6,3,3,8,17,22,-5,12
FCSB,1408,1,8,5,1,26,15,11,29
CFR Cluj,1408,2,7,6,1,18,8,10,27
D Bucuresti,1408,3,3,6,5,18,20,-2,15
FC Botosani,1408,4,3,6,5,6,13,-7,15
Universitate,1408,5,3,5,6,15,21,-6,14
Concordia Ch,1408,6,2,4,8,16,22,-6,10
FCSB,1409,1,8,6,0,26,12,14,30
CFR Cluj,1409,2,6,6,2,15,8,7,24
D Bucuresti,1409,3,4,5,5,21,22,-1,17
FC Botosani,1409,4,4,5,5,8,13,-5,17
Universitate,1409,5,3,6,5,16,22,-6,15
Concordia Ch,1409,6,2,2,10,18,27,-9,8
FCSB,1410,1,8,6,0,25,11,14,30
CFR Cluj,1410,2,6,6,2,14,8,6,24
D Bucuresti,1410,3,5,4,5,21,19,2,19
Universitate,1410,4,3,6,5,15,20,-5,15
FC Botosani,1410,5,3,5,6,6,15,-9,14
Concordia Ch,1410,6,2,3,9,15,23,-8,9
FCSB,1411,1,8,5,1,27,12,15,29
CFR Cluj,1411,2,6,6,2,14,10,4,24
Universitate,1411,3,4,5,5,16,20,-4,17
FC Botosani,1411,4,4,4,6,8,16,-8,16
Concordia Ch,1411,5,4,2,8,21,24,-3,14
D Bucuresti,1411,6,3,4,7,21,25,-4,13
FCSB,1412,1,9,5,0,27,10,17,32
CFR Cluj,1412,2,6,6,2,16,10,6,24
FC Botosani,1412,3,5,4,5,11,12,-1,19
D Bucuresti,1412,4,3,5,6,16,20,-4,14
Universitate,1412,5,3,5,6,16,24,-8,14
Concordia Ch,1412,6,2,3,9,15,25,-10,9
FCSB,1413,1,8,5,1,28,11,17,29
CFR Cluj,1413,2,5,7,2,14,13,1,22
Universitate,1413,3,4,6,4,16,19,-3,18
D Bucuresti,1413,4,4,5,5,18,19,-1,17
FC Botosani,1413,5,3,5,6,5,13,-8,14
Concordia Ch,1413,6,2,4,8,16,22,-6,10
FCSB,1414,1,7,7,0,25,12,13,28
CFR Cluj,1414,2,6,7,1,16,8,8,25
Universitate,1414,3,3,6,5,15,21,-6,15
FC Botosani,1414,4,3,6,5,5,12,-7,15
D Bucuresti,1414,5,3,5,6,17,20,-3,14
Concordia Ch,1414,6,3,3,8,17,22,-5,12
FCSB,1415,1,8,5,1,30,15,15,29
CFR Cluj,1415,2,6,7,1,17,9,8,25
FC Botosani,1415,3,5,4,5,9,12,-3,19
D Bucuresti,1415,4,4,4,6,17,20,-3,16
Universitate,1415,5,3,6,5,17,25,-8,15
Concordia Ch,1415,6,2,2,10,15,24,-9,8
FCSB,1416,1,7,6,1,23,11,12,27
CFR Cluj,1416,2,6,7,1,17,8,9,25
Universitate,1416,3,4,5,5,16,22,-6,17
D Bucuresti,1416,4,4,4,6,18,20,-2,16
FC Botosani,1416,5,4,4,6,8,14,-6,16
Concordia Ch,1416,6,3,2,9,18,25,-7,11
FCSB,1417,1,8,6,0,26,12,14,30
CFR Cluj,1417,2,6,7,1,18,9,9,25
D Bucuresti,1417,3,4,5,5,20,21,-1,17
FC Botosani,1417,4,4,4,6,8,15,-7,16
Universitate,1417,5,3,5,6,14,22,-8,14
Concordia Ch,1417,6,2,3,9,16,23,-7,9
FCSB,1418,1,8,5,1,26,12,14,29
CFR Cluj,1418,2,6,6,2,14,10,4,24
Universitate,1418,3,4,5,5,16,19,-3,17
D Bucuresti,1418,4,4,4,6,22,23,-1,16
FC Botosani,1418,5,3,5,6,6,16,-10,14
Concordia Ch,1418,6,3,3,8,21,25,-4,12
FCSB,1419,1,7,5,2,25,16,9,26
CFR Cluj,1419,2,6,6,2,16,8,8,24
Universitate,1419,3,5,5,4,18,20,-2,20
D Bucuresti,1419,4,4,4,6,18,20,-2,16
FC Botosani,1419,5,3,5,6,7,15,-8,14
Concordia Ch,1419,6,3,3,8,19,24,-5,12
FCSB,1420,1,8,6,0,28,11,17,30
CFR Cluj,1420,2,5,7,2,14,12,2,22
Universitate,1420,3,3,7,4,16,20,-4,16
FC Botosani,1420,4,4,4,6,7,15,-8,16
Concordia Ch,1420,5,4,2,8,20,23,-3,14
D Bucuresti,1420,6,3,4,7,17,21,-4,13
FCSB,1421,1,8,5,1,25,12,13,29
CFR Cluj,1421,2,6,6,2,15,10,5,24
D Bucuresti,1421,3,5,4,5,22,18,4,19
Universitate,1421,4,4,5,5,16,19,-3,17
FC Botosani,1421,5,3,5,6,6,16,-10,14
Concordia Ch,1421,6,2,3,9,16,25,-9,9
CFR Cluj,1422,1,7,6,1,15,7,8,27
FCSB,1422,2,7,5,2,24,13,11,26
D Bucuresti,1422,3,5,4,5,19,19,0,19
Universitate,1422,4,4,5,5,16,20,-4,17
FC Botosani,1422,5,3,5,6,6,14,-8,14
Concordia Ch,1422,6,2,3,9,15,22,-7,9
FCSB,1423,1,7,5,2,24,15,9,26
CFR Cluj,1423,2,6,7,1,17,9,8,25
Universitate,1423,3,4,6,4,17,19,-2,18
FC Botosani,1423,4,4,5,5,9,13,-4,17
D Bucuresti,1423,5,3,5,6,17,23,-6,14
Concordia Ch,1423,6,3,2,9,19,24,-5,11
FCSB,1424,1,8,5,1,26,13,13,29
CFR Cluj,1424,2,7,6,1,17,7,10,27
D Bucuresti,1424,3,4,5,5,17,18,-1,17
Universitate,1424,4,3,5,6,15,23,-8,14
FC Botosani,1424,5,3,4,7,6,15,-9,13
Concordia Ch,1424,6,3,3,8,17,22,-5,12
FCSB,1425,1,8,6,0,28,12,16,30
CFR Cluj,1425,2,5,7,2,15,13,2,22
D Bucuresti,1425,3,4,5,5,17,18,-1,17
Universitate,1425,4,4,5,5,18,21,-3,17
FC Botosani,1425,5,3,4,7,5,14,-9,13
Concordia Ch,1425,6,3,3,8,16,21,-5,12
FCSB,1426,1,7,6,1,26,14,12,27
CFR Cluj,1426,2,6,7,1,16,9,7,25
D Bucuresti,1426,3,4,5,5,19,20,-1,17
Universitate,1426,4,3,7,4,15,19,-4,16
FC Botosani,1426,5,3,5,6,7,15,-8,14
Concordia Ch,1426,6,2,4,8,17,23,-6,10
FCSB,1427,1,8,5,1,26,13,13,29
CFR Cluj,1427,2,6,6,2,16,10,6,24
FC Botosani,1427,3,5,4,5,8,12,-4,19
Universitate,1427,4,4,5,5,17,21,-4,17
D Bucuresti,1427,5,3,5,6,18,21,-3,14
Concordia Ch,1427,6,2,3,9,17,25,-8,9
FCSB,1428,1,8,6,0,25,10,15,30
CFR Cluj,1428,2,5,6,3,13,11,2,21
Universitate,1428,3,4,6,4,16,18,-2,18
FC Botosani,1428,4,4,5,5,8,13,-5,17
D Bucuresti,1428,5,3,5,6,17,23,-6,14
Concordia Ch,1428,6,3,2,9,19,23,-4,11
FCSB,1429,1,8,5,1,25,12,13,29
CFR Cluj,1429,2,6,6,2,15,9,6,24
Universitate,1429,3,4,5,5,16,20,-4,17
D Bucuresti,1429,4,4,4,6,19,20,-1,16
FC Botosani,1429,5,3,5,6,5,14,-9,14
Concordia Ch,1429,6,3,3,8,17,22,-5,12
FCSB,1430,1,8,5,1,26,12,14,29
CFR Cluj,1430,2,5,7,2,15,11,4,22
Universitate,1430,3,4,6,4,18,21,-3,18
D Bucuresti,1430,4,4,5,5,18,19,-1,17
FC Botosani,1430,5,4,5,5,9,13,-4,17
Concordia Ch,1430,6,2,2,10,17,27,-10,8
FCSB,1431,1,7,6,1,25,16,9,27
CFR Cluj,1431,2,5,7,2,15,10,5,22
Universitate,1431,3,5,5,4,21,20,1,20
D Bucuresti,1431,4,4,5,5,18,19,-1,17
FC Botosani,1431,5,3,5,6,5,13,-8,14
Concordia Ch,1431,6,2,4,8,16,22,-6,10
FCSB,1432,1,9,5,0,29,10,19,32
CFR Cluj,1432,2,5,7,2,15,14,1,22
FC Botosani,1432,3,5,4,5,9,13,-4,19
Universitate,1432,4,3,6,5,16,21,-5,15
D Bucuresti,1432,5,3,5,6,19,22,-3,14
Concordia Ch,1432,6,2,3,9,19,27,-8,9
FCSB,1433,1,8,5,1,27,13,14,29
CFR Cluj,1433,2,7,6,1,17,7,10,27
D Bucuresti,1433,3,3,5,6,18,21,-3,14
Concordia Ch,1433,4,4,2,8,19,23,-4,14
FC Botosani,1433,5,3,5,6,7,15,-8,14
Universitate,1433,6,3,5,6,16,25,-9,14
FCSB,1434,1,8,6,0,25,10,15,30
CFR Cluj,1434,2,5,8,1,14,8,6,23
D Bucuresti,1434,3,4,5,5,21,20,1,17
Universitate,1434,4,3,6,5,15,21,-6,15
FC Botosani,1434,5,3,5,6,7,16,-9,14
Concordia Ch,1434,6,3,2,9,17,24,-7,11
FCSB,1435,1,7,6,1,25,15,10,27
CFR Cluj,1435,2,7,6,1,18,8,10,27
FC Botosani,1435,3,4,5,5,7,13,-6,17
Universitate,1435,4,3,6,5,17,22,-5,15
D Bucuresti,1435,5,3,4,7,17,21,-4,13
Concordia Ch,1435,6,3,3,8,18,23,-5,12
FCSB,1436,1,8,5,1,28,14,14,29
CFR Cluj,1436,2,5,6,3,15,12,3,21
Universitate,1436,3,5,5,4,17,19,-2,20
D Bucuresti,1436,4,4,4,6,17,20,-3,16
Concordia Ch,1436,5,4,2,8,20,21,-1,14
FC Botosani,1436,6,3,4,7,5,16,-11,13
FCSB,1437,1,8,6,0,28,12,16,30
CFR Cluj,1437,2,5,6,3,13,12,1,21
Universitate,1437,3,4,6,4,18,20,-2,18
D Bucuresti,1437,4,4,4,6,18,20,-2,16
FC Botosani,1437,5,4,4,6,7,15,-8,16
Concordia Ch,1437,6,3,2,9,18,23,-5,11
FCSB,1438,1,9,5,0,25,10,15,32
CFR Cluj,1438,2,6,6,2,15,9,6,24
D Bucuresti,1438,3,4,5,5,19,20,-1,17
Universitate,1438,4,3,5,6,15,21,-6,14
FC Botosani,1438,5,3,4,7,6,16,-10,13
Concordia Ch,1438,6,3,3,8,18,22,-4,12
FCSB,1439,1,7,6,1,23,11,12,27
CFR Cluj,1439,2,5,7,2,13,10,3,22
Universitate,1439,3,5,5,4,18,18,0,20
FC Botosani,1439,4,5,4,5,9,13,-4,19
D Bucuresti,1439,5,3,4,7,16,21,-5,13
Concordia Ch,1439,6,3,2,9,18,24,-6,11
FCSB,1440,1,8,5,1,27,13,14,29
CFR Cluj,1440,2,5,6,3,14,11,3,21
Universitate,1440,3,5,5,4,19,21,-2,20
FC Botosani,1440,4,4,5,5,8,14,-6,17
D Bucuresti,1440,5,3,6,5,18,20,-2,15
Concordia Ch,1440,6,2,3,9,19,26,-7,9
FCSB,1441,1,8,5,1,28,15,13,29
CFR Cluj,1441,2,6,6,2,18,12,6,24
Universitate,1441,3,4,5,5,19,23,-4,17
D Bucuresti,1441,4,3,6,5,19,21,-2,15
FC Botosani,1441,5,3,5,6,6,14,-8,14
Concordia Ch,1441,6,3,3,8,18,23,-5,12
CFR Cluj,1442,1,7,6,1,16,7,9,27
FCSB,1442,2,7,5,2,24,13,11,26
D Bucuresti,1442,3,5,4,5,20,18,2,19
Universitate,1442,4,4,5,5,16,21,-5,17
FC Botosani,1442,5,4,4,6,8,16,-8,16
Concordia Ch,1442,6,2,2,10,16,25,-9,8
FCSB,1443,1,7,5,2,24,13,11,26
CFR Cluj,1443,2,6,7,1,18,11,7,25
Universitate,1443,3,4,6,4,18,21,-3,18
D Bucuresti,1443,4,4,4,6,18,20,-2,16
FC Botosani,1443,5,4,4,6,7,14,-7,16
Concordia Ch,1443,6,3,2,9,16,22,-6,11
FCSB,1444,1,8,6,0,26,11,15,30
CFR Cluj,1444,2,5,7,2,14,10,4,22
D Bucuresti,1444,3,5,4,5,20,19,1,19
Universitate,1444,4,4,5,5,16,20,-4,17
FC Botosani,1444,5,3,5,6,6,14,-8,14
Concordia Ch,1444,6,2,3,9,15,23,-8,9
FCSB,1445,1,7,5,2,24,14,10,26
CFR Cluj,1445,2,6,6,2,15,10,5,24
Universitate,1445,3,5,5,4,20,20,0,20
D Bucuresti,1445,4,4,4,6,18,21,-3,16
Concordia Ch,1445,5,4,2,8,20,21,-1,14
FC Botosani,1445,6,3,4,7,5,16,-11,13
FCSB,1446,1,9,5,0,28,11,17,32
CFR Cluj,1446,2,5,7,2,13,10,3,22
D Bucuresti,1446,3,4,5,5,20,20,0,17
Universitate,1446,4,3,6,5,15,20,-5,15
FC Botosani,1446,5,3,6,5,6,13,-7,15
Concordia Ch,1446,6,2,3,9,16,24,-8,9
FCSB,1447,1,7,7,0,25,12,13,28
CFR Cluj,1447,2,6,7,1,16,8,8,25
D Bucuresti,1447,3,4,4,6,17,22,-5,16
Universitate,1447,4,3,6,5,15,21,-6,15
Concordia Ch,1447,5,4,2,8,21,22,-1,14
FC Botosani,1447,6,3,4,7,6,15,-9,13
FCSB,1448,1,9,5,0,29,12,17,32
CFR Cluj,1448,2,6,6,2,14,8,6,24
D Bucuresti,1448,3,4,4,6,20,22,-2,16
Concordia Ch,1448,4,4,2,8,21,24,-3,14
Universitate,1448,5,3,5,6,16,24,-8,14
FC Botosani,1448,6,3,4,7,5,15,-10,13
FCSB,1449,1,7,6,1,24,13,11,27
CFR Cluj,1449,2,6,6,2,16,10,6,24
Universitate,1449,3,4,6,4,16,18,-2,18
D Bucuresti,1449,4,4,5,5,19,19,0,17
FC Botosani,1449,5,4,4,6,10,15,-5,16
Concordia Ch,1449,6,2,3,9,15,25,-10,9
FCSB,1450,1,8,6,0,27,11,16,30
CFR Cluj,1450,2,5,8,1,17,11,6,23
D Bucuresti,1450,3,5,4,5,19,18,1,19
Universitate,1450,4,3,6,5,17,24,-7,15
FC Botosani,1450,5,3,4,7,5,16,-11,13
Concordia Ch,1450,6,3,2,9,17,22,-5,11
FCSB,1451,1,8,6,0,27,12,15,30
CFR Cluj,1451,2,6,7,1,15,8,7,25
D Bucuresti,1451,3,5,4,5,19,18,1,19
Universitate,1451,4,3,5,6,15,22,-7,14
FC Botosani,1451,5,3,5,6,6,15,-9,14
Concordia Ch,1451,6,2,3,9,16,23,-7,9
FCSB,1452,1,8,5,1,25,12,13,29
CFR Cluj,1452,2,7,6,1,18,7,11,27
D Bucuresti,1452,3,4,5,5,18,18,0,17
FC Botosani,1452,4,3,6,5,5,12,-7,15
Universitate,1452,5,3,5,6,14,23,-9,14
Concordia Ch,1452,6,2,3,9,15,23,-8,9
FCSB,1453,1,7,7,0,24,11,13,28
CFR Cluj,1453,2,5,7,2,13,9,4,22
FC Botosani,1453,3,5,4,5,8,12,-4,19
Universitate,1453,4,4,6,4,17,19,-2,18
D Bucuresti,1453,5,3,4,7,16,21,-5,13
Concordia Ch,1453,6,3,2,9,17,23,-6,11
FCSB,1454,1,8,5,1,25,12,13,29
CFR Cluj,1454,2,5,6,3,14,10,4,21
Universitate,1454,3,5,5,4,16,18,-2,20
D Bucuresti,1454,4,4,4,6,18,21,-3,16
FC Botosani,1454,5,3,5,6,6,14,-8,14
Concordia Ch,1454,6,3,3,8,19,23,-4,12
FCSB,1455,1,8,5,1,27,11,16,29
CFR Cluj,1455,2,7,6,1,16,8,8,27
D Bucuresti,1455,3,4,5,5,17,18,-1,17
Universitate,1455,4,3,5,6,15,24,-9,14
FC Botosani,1455,5,3,5,6,5,14,-9,14
Concordia Ch,1455,6,3,2,9,17,22,-5,11
FCSB,1456,1,8,5,1,28,12,16,29
CFR Cluj,1456,2,6,6,2,17,13,4,24
Universitate,1456,3,4,5,5,17,22,-5,17
FC Botosani,1456,4,4,4,6,7,14,-7,16
Concordia Ch,1456,5,4,2,8,18,21,-3,14
D Bucuresti,1456,6,3,4,7,17,22,-5,13
FCSB,1457,1,7,6,1,26,14,12,27
CFR Cluj,1457,2,7,6,1,17,9,8,27
D Bucuresti,1457,3,4,5,5,18,19,-1,17
Universitate,1457,4,3,6,5,15,20,-5,15
FC Botosani,1457,5,3,4,7,6,15,-9,13
Concordia Ch,1457,6,3,3,8,18,23,-5,12
FCSB,1458,1,7,6,1,24,12,12,27
CFR Cluj,1458,2,7,6,1,18,9,9,27
FC Botosani,1458,3,5,4,5,10,14,-4,19
Universitate,1458,4,3,6,5,15,21,-6,15
D Bucuresti,1458,5,3,5,6,18,21,-3,14
Concordia Ch,1458,6,2,3,9,17,25,-8,9
FCSB,1459,1,9,5,0,27,10,17,32
CFR Cluj,1459,2,5,6,3,14,11,3,21
Universitate,1459,3,4,5,5,16,21,-5,17
FC Botosani,1459,4,4,4,6,6,13,-7,16
Concordia Ch,1459,5,4,2,8,18,22,-4,14
D Bucuresti,1459,6,3,4,7,17,21,-4,13
FCSB,1460,1,7,7,0,25,12,13,28
CFR Cluj,1460,2,5,8,1,15,9,6,23
FC Botosani,1460,3,4,5,5,7,13,-6,17
Universitate,1460,4,3,7,4,16,20,-4,16
D Bucuresti,1460,5,3,5,6,19,22,-3,14
Concordia Ch,1460,6,3,2,9,18,24,-6,11
FCSB,1461,1,7,6,1,23,12,11,27
CFR Cluj,1461,2,6,6,2,15,8,7,24
Universitate,1461,3,4,6,4,15,18,-3,18
D Bucuresti,1461,4,4,4,6,21,23,-2,16
Concordia Ch,1461,5,4,2,8,19,23,-4,14
FC Botosani,1461,6,3,4,7,9,18,-9,13
FCSB,1462,1,8,5,1,25,11,14,29
CFR Cluj,1462,2,7,6,1,17,7,10,27
D Bucuresti,1462,3,4,4,6,19,21,-2,16
FC Botosani,1462,4,3,5,6,7,15,-8,14
Universitate,1462,5,3,5,6,14,23,-9,14
Concordia Ch,1462,6,3,3,8,18,23,-5,12
FCSB,1463,1,7,5,2,24,16,8,26
CFR Cluj,1463,2,6,6,2,16,8,8,24
Universitate,1463,3,5,5,4,18,19,-1,20
D Bucuresti,1463,4,4,5,5,19,20,-1,17
FC Botosani,1463,5,3,4,7,6,15,-9,13
Concordia Ch,1463,6,3,3,8,19,24,-5,12
FCSB,1464,1,8,5,1,26,14,12,29
CFR Cluj,1464,2,6,6,2,17,9,8,24
D Bucuresti,1464,3,4,5,5,19,20,-1,17
Universitate,1464,4,4,5,5,17,22,-5,17
FC Botosani,1464,5,3,4,7,6,15,-9,13
Concordia Ch,1464,6,3,3,8,17,22,-5,12
FCSB,1465,1,8,6,0,26,12,14,30
CFR Cluj,1465,2,5,7,2,14,9,5,22
FC Botosani,1465,3,4,5,5,8,14,-6,17
Universitate,1465,4,3,7,4,15,19,-4,16
D Bucuresti,1465,5,3,6,5,18,20,-2,15
Concordia Ch,1465,6,2,3,9,15,22,-7,9
FCSB,1466,1,8,5,1,25,12,13,29
CFR Cluj,1466,2,6,7,1,15,8,7,25
FC Botosani,1466,3,4,5,5,8,13,-5,17
Universitate,1466,4,3,6,5,14,19,-5,15
D Bucuresti,1466,5,3,5,6,18,24,-6,14
Concordia Ch,1466,6,3,2,9,20,24,-4,11
FCSB,1467,1,8,6,0,27,12,15,30
CFR Cluj,1467,2,5,7,2,14,11,3,22
FC Botosani,1467,3,5,4,5,9,13,-4,19
Universitate,1467,4,4,5,5,18,21,-3,17
D Bucuresti,1467,5,3,4,7,17,21,-4,13
Concordia Ch,1467,6,3,2,9,16,23,-7,11
FCSB,1468,1,9,5,0,26,10,16,32
CFR Cluj,1468,2,6,6,2,14,8,6,24
D Bucuresti,1468,3,4,5,5,20,21,-1,17
Universitate,1468,4,3,5,6,14,21,-7,14
FC Botosani,1468,5,3,4,7,6,15,-9,13
Concordia Ch,1468,6,3,3,8,18,23,-5,12
FCSB,1469,1,8,5,1,24,12,12,29
CFR Cluj,1469,2,5,7,2,13,8,5,22
Universitate,1469,3,4,6,4,16,18,-2,18
D Bucuresti,1469,4,4,5,5,20,19,1,17
FC Botosani,1469,5,3,5,6,6,16,-10,14
Concordia Ch,1469,6,2,4,8,17,23,-6,10
FCSB,1470,1,9,5,0,28,11,17,32
CFR Cluj,1470,2,6,6,2,15,11,4,24
FC Botosani,1470,3,4,5,5,8,13,-5,17
D Bucuresti,1470,4,3,5,6,19,22,-3,14
Universitate,1470,5,3,5,6,16,22,-6,14
Concordia Ch,1470,6,3,2,9,18,25,-7,11
FCSB,1471,1,8,5,1,25,13,12,29
CFR Cluj,1471,2,7,6,1,21,8,13,27
D Bucuresti,1471,3,4,5,5,20,20,0,17
FC Botosani,1471,4,3,5,6,7,15,-8,14
Universitate,1471,5,3,5,6,14,24,-10,14
Concordia Ch,1471,6,3,2,9,16,23,-7,11
FCSB,1472,1,8,5,1,27,13,14,29
CFR Cluj,1472,2,6,7,1,16,9,7,25
D Bucuresti,1472,3,4,4,6,22,21,1,16
FC Botosani,1472,4,4,4,6,6,17,-11,16
Universitate,1472,5,3,6,5,18,24,-6,15
Concordia Ch,1472,6,3,2,9,18,23,-5,11
FCSB,1473,1,7,6,1,25,15,10,27
CFR Cluj,1473,2,5,8,1,15,9,6,23
Universitate,1473,3,4,6,4,17,18,-1,18
FC Botosani,1473,4,3,6,5,6,13,-7,15
D Bucuresti,1473,5,3,5,6,18,23,-5,14
Concordia Ch,1473,6,3,3,8,19,22,-3,12
FCSB,1474,1,9,5,0,31,12,19,32
CFR Cluj,1474,2,5,6,3,16,14,2,21
FC Botosani,1474,3,5,4,5,10,12,-2,19
Universitate,1474,4,4,5,5,16,22,-6,17
D Bucuresti,1474,5,4,4,6,18,19,-1,16
Concordia Ch,1474,6,2,2,10,15,27,-12,8
FCSB,1475,1,8,5,1,29,14,15,29
CFR Cluj,1475,2,7,6,1,19,11,8,27
D Bucuresti,1475,3,4,4,6,21,20,1,16
FC Botosani,1475,4,4,4,6,7,16,-9,16
Universitate,1475,5,3,5,6,17,25,-8,14
Concordia Ch,1475,6,3,2,9,17,24,-7,11
FCSB,1476,1,7,6,1,24,12,12,27
CFR Cluj,1476,2,6,7,1,16,9,7,25
Universitate,1476,3,3,7,4,17,21,-4,16
D Bucuresti,1476,4,3,5,6,17,20,-3,14
Concordia Ch,1476,5,4,2,8,17,21,-4,14
FC Botosani,1476,6,3,5,6,6,14,-8,14
FCSB,1477,1,8,5,1,26,15,11,29
CFR Cluj,1477,2,5,7,2,16,11,5,22
FC Botosani,1477,3,5,4,5,8,13,-5,19
Universitate,1477,4,4,6,4,18,19,-1,18
D Bucuresti,1477,5,4,4,6,18,20,-2,16
Concordia Ch,1477,6,2,2,10,17,25,-8,8
FCSB,1478,1,7,5,2,24,17,7,26
CFR Cluj,1478,2,6,7,1,18,8,10,25
Universitate,1478,3,4,6,4,18,20,-2,18
D Bucuresti,1478,4,4,5,5,22,19,3,17
FC Botosani,1478,5,4,4,6,9,18,-9,16
Concordia Ch,1478,6,2,3,9,17,26,-9,9
CFR Cluj,1479,1,7,6,1,20,8,12,27
FCSB,1479,2,7,6,1,25,16,9,27
D Bucuresti,1479,3,4,4,6,18,20,-2,16
Universitate,1479,4,3,6,5,15,21,-6,15
FC Botosani,1479,5,3,5,6,5,13,-8,14
Concordia Ch,1479,6,3,3,8,17,22,-5,12
FCSB,1480,1,8,5,1,26,12,14,29
CFR Cluj,1480,2,6,6,2,16,9,7,24
D Bucuresti,1480,3,4,5,5,18,19,-1,17
Universitate,1480,4,4,5,5,16,22,-6,17
FC Botosani,1480,5,3,5,6,6,14,-8,14
Concordia Ch,1480,6,2,4,8,17,23,-6,10
FCSB,1481,1,8,6,0,26,11,15,30
CFR Cluj,1481,2,6,6,2,17,9,8,24
D Bucuresti,1481,3,4,4,6,18,20,-2,16
Universitate,1481,4,3,6,5,15,23,-8,15
FC Botosani,1481,5,3,5,6,7,16,-9,14
Concordia Ch,1481,6,3,3,8,19,23,-4,12
FCSB,1482,1,9,5,0,26,11,15,32
CFR Cluj,1482,2,5,6,3,14,10,4,21
D Bucuresti,1482,3,4,5,5,17,18,-1,17
Universitate,1482,4,4,5,5,15,19,-4,17
FC Botosani,1482,5,3,4,7,5,14,-9,13
Concordia Ch,1482,6,3,3,8,16,21,-5,12
FCSB,1483,1,9,5,0,27,12,15,32
CFR Cluj,1483,2,5,6,3,15,12,3,21
D Bucuresti,1483,3,5,4,5,20,18,2,19
Universitate,1483,4,4,5,5,18,21,-3,17
FC Botosani,1483,5,4,4,6,8,13,-5,16
Concordia Ch,1483,6,2,2,10,15,27,-12,8
FCSB,1484,1,8,6,0,26,11,15,30
CFR Cluj,1484,2,6,7,1,16,9,7,25
D Bucuresti,1484,3,4,4,6,20,19,1,16
Concordia Ch,1484,4,4,2,8,19,23,-4,14
Universitate,1484,5,3,5,6,15,22,-7,14
FC Botosani,1484,6,3,4,7,7,19,-12,13
FCSB,1485,1,8,5,1,26,13,13,29
CFR Cluj,1485,2,5,7,2,13,9,4,22
Universitate,1485,3,4,6,4,17,19,-2,18
D Bucuresti,1485,4,4,5,5,20,21,-1,17
FC Botosani,1485,5,3,5,6,6,14,-8,14
Concordia Ch,1485,6,2,4,8,19,25,-6,10
FCSB,1486,1,7,6,1,25,13,12,27
CFR Cluj,1486,2,6,7,1,19,12,7,25
Universitate,1486,3,4,5,5,20,24,-4,17
Concordia Ch,1486,4,4,2,8,20,22,-2,14
D Bucuresti,1486,5,3,5,6,18,22,-4,14
FC Botosani,1486,6,3,5,6,6,15,-9,14
FCSB,1487,1,8,5,1,25,13,12,29
CFR Cluj,1487,2,7,6,1,17,7,10,27
FC Botosani,1487,3,4,5,5,7,13,-6,17
D Bucuresti,1487,4,4,4,6,19,20,-1,16
Universitate,1487,5,3,5,6,15,22,-7,14
Concordia Ch,1487,6,2,3,9,17,25,-8,9
FCSB,1488,1,8,5,1,26,13,13,29
CFR Cluj,1488,2,6,7,1,16,9,7,25
D Bucuresti,1488,3,4,4,6,18,20,-2,16
Universitate,1488,4,3,6,5,16,21,-5,15
FC Botosani,1488,5,3,5,6,8,16,-8,14
Concordia Ch,1488,6,3,3,8,20,25,-5,12
FCSB,1489,1,9,5,0,26,10,16,32
CFR Cluj,1489,2,5,7,2,13,9,4,22
D Bucuresti,1489,3,5,4,5,19,19,0,19
Universitate,1489,4,3,6,5,14,19,-5,15
FC Botosani,1489,5,3,5,6,6,14,-8,14
Concordia Ch,1489,6,2,3,9,15,22,-7,9
FCSB,1490,1,7,7,0,25,12,13,28
CFR Cluj,1490,2,6,7,1,17,9,8,25
D Bucuresti,1490,3,4,5,5,23,21,2,17
Universitate,1490,4,3,6,5,16,22,-6,15
FC Botosani,1490,5,3,5,6,8,19,-11,14
Concordia Ch,1490,6,3,2,9,19,25,-6,11
FCSB,1491,1,8,5,1,25,12,13,29
CFR Cluj,1491,2,6,7,1,14,7,7,25
D Bucuresti,1491,3,4,5,5,18,19,-1,17
Universitate,1491,4,3,6,5,15,20,-5,15
FC Botosani,1491,5,3,4,7,5,14,-9,13
Concordia Ch,1491,6,3,3,8,17,22,-5,12
FCSB,1492,1,9,5,0,27,11,16,32
CFR Cluj,1492,2,5,6,3,14,11,3,21
Universitate,1492,3,4,5,5,16,20,-4,17
FC Botosani,1492,4,4,5,5,7,13,-6,17
D Bucuresti,1492,5,4,4,6,22,19,3,16
Concordia Ch,1492,6,2,3,9,16,28,-12,9
FCSB,1493,1,8,5,1,25,12,13,29
CFR Cluj,1493,2,6,6,2,15,9,6,24
Universitate,1493,3,4,5,5,17,21,-4,17
D Bucuresti,1493,4,4,4,6,21,21,0,16
FC Botosani,1493,5,4,4,6,7,16,-9,16
Concordia Ch,1493,6,3,2,9,17,23,-6,11
FCSB,1494,1,9,5,0,30,13,17,32
CFR Cluj,1494,2,6,6,2,18,13,5,24
D Bucuresti,1494,3,5,4,5,20,19,1,19
FC Botosani,1494,4,4,4,6,8,14,-6,16
Universitate,1494,5,3,5,6,15,22,-7,14
Concordia Ch,1494,6,2,2,10,17,27,-10,8
FCSB,1495,1,7,6,1,24,13,11,27
CFR Cluj,1495,2,7,6,1,16,7,9,27
D Bucuresti,1495,3,5,4,5,22,20,2,19
Universitate,1495,4,3,6,5,15,20,-5,15
FC Botosani,1495,5,3,5,6,7,15,-8,14
Concordia Ch,1495,6,2,3,9,17,26,-9,9
FCSB,1496,1,7,6,1,24,12,12,27
CFR Cluj,1496,2,6,7,1,17,8,9,25
D Bucuresti,1496,3,5,4,5,20,20,0,19
Universitate,1496,4,4,5,5,15,21,-6,17
FC Botosani,1496,5,3,5,6,6,14,-8,14
Concordia Ch,1496,6,2,3,9,18,25,-7,9
FCSB,1497,1,8,5,1,26,12,14,29
CFR Cluj,1497,2,6,6,2,15,9,6,24
D Bucuresti,1497,3,5,4,5,20,18,2,19
Universitate,1497,4,4,5,5,16,21,-5,17
FC Botosani,1497,5,3,4,7,6,18,-12,13
Concordia Ch,1497,6,3,2,9,18,23,-5,11
CFR Cluj,1498,1,7,6,1,16,7,9,27
FCSB,1498,2,7,5,2,23,14,9,26
Universitate,1498,3,4,5,5,16,19,-3,17
D Bucuresti,1498,4,4,4,6,18,20,-2,16
FC Botosani,1498,5,3,5,6,6,14,-8,14
Concordia Ch,1498,6,3,3,8,18,23,-5,12
FCSB,1499,1,8,6,0,26,11,15,30
CFR Cluj,1499,2,5,8,1,15,9,6,23
D Bucuresti,1499,3,4,5,5,19,19,0,17
FC Botosani,1499,4,4,4,6,9,16,-7,16
Universitate,1499,5,3,6,5,15,21,-6,15
Concordia Ch,1499,6,2,3,9,16,24,-8,9
FCSB,1500,1,7,6,1,24,12,12,27
CFR Cluj,1500,2,7,6,1,17,8,9,27
D Bucuresti,1500,3,4,4,6,20,22,-2,16
FC Botosani,1500,4,4,4,6,6,14,-8,16
Universitate,1500,5,3,6,5,16,22,-6,15
Concordia Ch,1500,6,3,2,9,19,24,-5,11
FCSB,1501,1,7,6,1,24,12,12,27
CFR Cluj,1501,2,5,8,1,16,10,6,23
Universitate,1501,3,4,6,4,17,20,-3,18
D Bucuresti,1501,4,4,5,5,20,20,0,17
FC Botosani,1501,5,4,4,6,7,15,-8,16
Concordia Ch,1501,6,2,3,9,18,25,-7,9
FCSB,1502,1,8,5,1,29,12,17,29
CFR Cluj,1502,2,6,7,1,17,9,8,25
Universitate,1502,3,3,6,5,16,26,-10,15
Concordia Ch,1502,4,4,2,8,21,22,-1,14
D Bucuresti,1502,5,3,5,6,16,22,-6,14
FC Botosani,1502,6,3,5,6,6,14,-8,14
FCSB,1503,1,8,5,1,27,15,12,29
CFR Cluj,1503,2,5,7,2,14,10,4,22
Universitate,1503,3,4,6,4,18,19,-1,18
FC Botosani,1503,4,4,5,5,9,13,-4,17
D Bucuresti,1503,5,3,4,7,17,23,-6,13
Concordia Ch,1503,6,3,3,8,18,23,-5,12
FCSB,1504,1,7,7,0,26,13,13,28
CFR Cluj,1504,2,6,7,1,14,7,7,25
FC Botosani,1504,3,4,5,5,10,15,-5,17
Universitate,1504,4,3,6,5,17,22,-5,15
D Bucuresti,1504,5,3,4,7,16,22,-6,13
Concordia Ch,1504,6,3,3,8,20,24,-4,12
FCSB,1505,1,8,6,0,27,12,15,30
CFR Cluj,1505,2,5,7,2,15,11,4,22
D Bucuresti,1505,3,4,4,6,18,20,-2,16
Universitate,1505,4,3,7,4,16,20,-4,16
FC Botosani,1505,5,4,4,6,8,15,-7,16
Concordia Ch,1505,6,3,2,9,18,24,-6,11
FCSB,1506,1,8,5,1,27,12,15,29
CFR Cluj,1506,2,6,6,2,15,11,4,24
Universitate,1506,3,4,5,5,15,19,-4,17
FC Botosani,1506,4,3,6,5,6,13,-7,15
D Bucuresti,1506,5,3,5,6,16,20,-4,14
Concordia Ch,1506,6,3,3,8,18,22,-4,12
FCSB,1507,1,8,5,1,26,13,13,29
CFR Cluj,1507,2,6,6,2,17,9,8,24
Universitate,1507,3,4,5,5,16,22,-6,17
D Bucuresti,1507,4,4,4,6,20,23,-3,16
FC Botosani,1507,5,4,4,6,9,13,-4,16
Concordia Ch,1507,6,3,2,9,17,25,-8,11
CFR Cluj,1508,1,7,6,1,17,7,10,27
FCSB,1508,2,7,5,2,23,14,9,26
D Bucuresti,1508,3,5,4,5,18,18,0,19
Universitate,1508,4,4,5,5,16,20,-4,17
FC Botosani,1508,5,4,4,6,9,14,-5,16
Concordia Ch,1508,6,2,2,10,16,26,-10,8
FCSB,1509,1,7,6,1,25,14,11,27
CFR Cluj,1509,2,6,7,1,16,7,9,25
D Bucuresti,1509,3,4,5,5,19,19,0,17
Universitate,1509,4,4,5,5,18,23,-5,17
FC Botosani,1509,5,4,4,6,8,14,-6,16
Concordia Ch,1509,6,2,3,9,16,25,-9,9
FCSB,1510,1,7,6,1,24,12,12,27
CFR Cluj,1510,2,5,7,2,14,9,5,22
Universitate,1510,3,5,5,4,16,18,-2,20
D Bucuresti,1510,4,4,4,6,22,22,0,16
FC Botosani,1510,5,4,4,6,7,16,-9,16
Concordia Ch,1510,6,3,2,9,18,24,-6,11
FCSB,1511,1,7,6,1,26,14,12,27
CFR Cluj,1511,2,6,7,1,18,11,7,25
FC Botosani,1511,3,4,5,5,6,12,-6,17
Universitate,1511,4,3,7,4,15,19,-4,16
D Bucuresti,1511,5,3,5,6,16,19,-3,14
Concordia Ch,1511,6,3,2,9,16,22,-6,11
FCSB,1512,1,8,6,0,26,12,14,30
CFR Cluj,1512,2,6,6,2,14,8,6,24
D Bucuresti,1512,3,4,4,6,18,21,-3,16
Universitate,1512,4,3,6,5,16,21,-5,15
Concordia Ch,1512,5,4,2,8,19,22,-3,14
FC Botosani,1512,6,3,4,7,5,14,-9,13
FCSB,1513,1,7,6,1,24,12,12,27
CFR Cluj,1513,2,5,7,2,14,9,5,22
Universitate,1513,3,5,5,4,18,20,-2,20
FC Botosani,1513,4,4,4,6,6,14,-8,16
Concordia Ch,1513,5,4,2,8,19,22,-3,14
D Bucuresti,1513,6,3,4,7,17,21,-4,13
FCSB,1514,1,8,6,0,30,13,17,30
CFR Cluj,1514,2,6,6,2,14,11,3,24
D Bucuresti,1514,3,4,5,5,18,19,-1,17
FC Botosani,1514,4,4,4,6,9,13,-4,16
Universitate,1514,5,3,6,5,17,22,-5,15
Concordia Ch,1514,6,2,3,9,16,26,-10,9
FCSB,1515,1,8,6,0,27,11,16,30
CFR Cluj,1515,2,5,6,3,14,14,0,21
Universitate,1515,3,4,6,4,17,18,-1,18
D Bucuresti,1515,4,4,5,5,22,22,0,17
FC Botosani,1515,5,4,5,5,9,14,-5,17
Concordia Ch,1515,6,2,2,10,19,29,-10,8
FCSB,1516,1,8,5,1,26,11,15,29
CFR Cluj,1516,2,7,6,1,16,8,8,27
FC Botosani,1516,3,5,4,5,8,12,-4,19
Universitate,1516,4,3,5,6,15,23,-8,14
D Bucuresti,1516,5,3,4,7,17,21,-4,13
Concordia Ch,1516,6,3,2,9,17,24,-7,11
FCSB,1517,1,7,7,0,24,11,13,28
CFR Cluj,1517,2,5,8,1,15,9,6,23
FC Botosani,1517,3,5,4,5,8,13,-5,19
Universitate,1517,4,3,7,4,17,21,-4,16
D Bucuresti,1517,5,3,4,7,19,25,-6,13
Concordia Ch,1517,6,3,2,9,20,24,-4,11
FCSB,1518,1,7,7,0,24,11,13,28
CFR Cluj,1518,2,6,7,1,15,8,7,25
FC Botosani,1518,3,4,5,5,10,14,-4,17
Universitate,1518,4,3,6,5,14,19,-5,15
D Bucuresti,1518,5,3,4,7,16,22,-6,13
Concordia Ch,1518,6,3,3,8,18,23,-5,12
FCSB,1519,1,7,5,2,24,13,11,26
CFR Cluj,1519,2,6,7,1,14,7,7,25
D Bucuresti,1519,3,5,4,5,20,18,2,19
Universitate,1519,4,4,6,4,16,19,-3,18
FC Botosani,1519,5,3,4,7,5,15,-10,13
Concordia Ch,1519,6,3,2,9,17,24,-7,11
FCSB,1520,1,8,5,1,27,11,16,29
CFR Cluj,1520,2,6,7,1,15,8,7,25
D Bucuresti,1520,3,4,4,6,18,20,-2,16
FC Botosani,1520,4,4,4,6,9,15,-6,16
Universitate,1520,5,3,6,5,15,23,-8,15
Concordia Ch,1520,6,3,2,9,17,24,-7,11
FCSB,1521,1,8,5,1,25,12,13,29
CFR Cluj,1521,2,5,6,3,14,10,4,21
Universitate,1521,3,5,5,4,18,20,-2,20
D Bucuresti,1521,4,3,6,5,17,19,-2,15
FC Botosani,1521,5,3,6,5,5,12,-7,15
Concordia Ch,1521,6,2,4,8,16,22,-6,10
FCSB,1522,1,8,6,0,24,10,14,30
CFR Cluj,1522,2,5,8,1,13,7,6,23
FC Botosani,1522,3,4,5,5,7,13,-6,17
D Bucuresti,1522,4,4,4,6,19,20,-1,16
Universitate,1522,5,3,6,5,14,19,-5,15
Concordia Ch,1522,6,2,3,9,17,25,-8,9
FCSB,1523,1,8,5,1,28,15,13,29
CFR Cluj,1523,2,6,7,1,17,8,9,25
D Bucuresti,1523,3,4,4,6,18,19,-1,16
FC Botosani,1523,4,4,4,6,6,13,-7,16
Universitate,1523,5,3,6,5,15,22,-7,15
Concordia Ch,1523,6,3,2,9,16,23,-7,11
FCSB,1524,1,8,6,0,29,13,16,30
CFR Cluj,1524,2,5,6,3,16,14,2,21
Universitate,1524,3,4,6,4,17,20,-3,18
D Bucuresti,1524,4,4,4,6,17,20,-3,16
FC Botosani,1524,5,4,4,6,6,13,-7,16
Concordia Ch,1524,6,3,2,9,17,22,-5,11
FCSB,1525,1,8,5,1,27,12,15,29
CFR Cluj,1525,2,5,6,3,14,12,2,21
Universitate,1525,3,5,5,4,16,18,-2,20
D Bucuresti,1525,4,4,5,5,20,20,0,17
FC Botosani,1525,5,4,5,5,8,14,-6,17
Concordia Ch,1525,6,2,2,10,15,24,-9,8
FCSB,1526,1,8,5,1,24,12,12,29
CFR Cluj,1526,2,6,6,2,14,8,6,24
D Bucuresti,1526,3,4,5,5,20,19,1,17
Universitate,1526,4,4,5,5,16,19,-3,17
FC Botosani,1526,5,4,4,6,7,16,-9,16
Concordia Ch,1526,6,2,3,9,17,24,-7,9
FCSB,1527,1,9,5,0,26,11,15,32
CFR Cluj,1527,2,6,6,2,15,9,6,24
FC Botosani,1527,3,4,5,5,8,13,-5,17
D Bucuresti,1527,4,3,5,6,18,22,-4,14
Universitate,1527,5,3,5,6,14,20,-6,14
Concordia Ch,1527,6,3,2,9,20,26,-6,11
FCSB,1528,1,7,6,1,24,12,12,27
CFR Cluj,1528,2,6,7,1,15,8,7,25
D Bucuresti,1528,3,5,4,5,20,18,2,19
Universitate,1528,4,4,5,5,15,19,-4,17
FC Botosani,1528,5,4,4,6,6,15,-9,16
Concordia Ch,1528,6,2,2,10,15,23,-8,8
FCSB,1529,1,8,5,1,25,12,13,29
CFR Cluj,1529,2,5,6,3,13,11,2,21
Universitate,1529,3,5,5,4,19,19,0,20
FC Botosani,1529,4,4,5,5,11,17,-6,17
D Bucuresti,1529,5,3,6,5,20,22,-2,15
Concordia Ch,1529,6,2,3,9,20,27,-7,9
FCSB,1530,1,8,5,1,25,12,13,29
CFR Cluj,1530,2,7,6,1,16,8,8,27
D Bucuresti,1530,3,4,4,6,17,20,-3,16
Concordia Ch,1530,4,4,2,8,18,21,-3,14
Universitate,1530,5,3,5,6,16,22,-6,14
FC Botosani,1530,6,3,4,7,5,14,-9,13
FCSB,1531,1,7,5,2,23,12,11,26
CFR Cluj,1531,2,6,6,2,14,9,5,24
Universitate,1531,3,5,5,4,17,18,-1,20
FC Botosani,1531,4,3,6,5,5,12,-7,15
D Bucuresti,1531,5,3,5,6,16,20,-4,14
Concordia Ch,1531,6,3,3,8,17,21,-4,12
FCSB,1532,1,8,6,0,25,11,14,30
CFR Cluj,1532,2,5,7,2,15,10,5,22
Universitate,1532,3,3,7,4,17,21,-4,16
Concordia Ch,1532,4,4,2,8,23,24,-1,14
D Bucuresti,1532,5,3,5,6,18,22,-4,14
FC Botosani,1532,6,3,5,6,6,16,-10,14
FCSB,1533,1,8,5,1,26,13,13,29
CFR Cluj,1533,2,6,7,1,17,10,7,25
D Bucuresti,1533,3,5,4,5,22,19,3,19
Universitate,1533,4,3,6,5,15,20,-5,15
FC Botosani,1533,5,3,4,7,5,15,-10,13
Concordia Ch,1533,6,3,2,9,17,25,-8,11
FCSB,1534,1,8,5,1,26,12,14,29
CFR Cluj,1534,2,5,7,2,13,10,3,22
Universitate,1534,3,4,6,4,16,18,-2,18
D Bucuresti,1534,4,4,4,6,18,22,-4,16
FC Botosani,1534,5,4,4,6,8,14,-6,16
Concordia Ch,1534,6,3,2,9,19,24,-5,11
FCSB,1535,1,8,5,1,26,13,13,29
CFR Cluj,1535,2,5,6,3,13,11,2,21
Universitate,1535,3,5,5,4,19,19,0,20
FC Botosani,1535,4,4,4,6,7,14,-7,16
Concordia Ch,1535,5,4,2,8,18,21,-3,14
D Bucuresti,1535,6,3,4,7,17,22,-5,13
FCSB,1536,1,8,5,1,25,12,13,29
CFR Cluj,1536,2,5,7,2,13,8,5,22
Universitate,1536,3,4,6,4,16,19,-3,18
D Bucuresti,1536,4,4,4,6,20,22,-2,16
Concordia Ch,1536,5,4,2,8,20,24,-4,14
FC Botosani,1536,6,3,4,7,7,16,-9,13
FCSB,1537,1,7,7,0,25,12,13,28
CFR Cluj,1537,2,6,7,1,17,9,8,25
D Bucuresti,1537,3,4,4,6,19,21,-2,16
Universitate,1537,4,3,6,5,16,22,-6,15
FC Botosani,1537,5,3,5,6,5,15,-10,14
Concordia Ch,1537,6,3,3,8,18,21,-3,12
FCSB,1538,1,8,6,0,24,10,14,30
CFR Cluj,1538,2,6,6,2,15,8,7,24
FC Botosani,1538,3,4,5,5,8,13,-5,17
D Bucuresti,1538,4,4,4,6,19,20,-1,16
Universitate,1538,5,3,6,5,14,20,-6,15
Concordia Ch,1538,6,2,3,9,16,25,-9,9
FCSB,1539,1,8,5,1,26,14,12,29
CFR Cluj,1539,2,5,6,3,15,12,3,21
Universitate,1539,3,5,5,4,18,18,0,20
FC Botosani,1539,4,4,5,5,8,12,-4,17
D Bucuresti,1539,5,3,5,6,16,21,-5,14
Concordia Ch,1539,6,3,2,9,18,24,-6,11
FCSB,1540,1,8,5,1,26,14,12,29
CFR Cluj,1540,2,6,6,2,18,9,9,24
FC Botosani,1540,3,5,4,5,12,16,-4,19
Universitate,1540,4,4,5,5,17,23,-6,17
D Bucuresti,1540,5,3,4,7,17,28,-11,13
Concordia Ch,1540,6,3,2,9,25,25,0,11
FCSB,1541,1,8,5,1,29,14,15,29
CFR Cluj,1541,2,6,6,2,19,11,8,24
Universitate,1541,3,4,5,5,17,25,-8,17
D Bucuresti,1541,4,4,4,6,19,20,-1,16
Concordia Ch,1541,5,4,2,8,20,23,-3,14
FC Botosani,1541,6,3,4,7,6,17,-11,13
FCSB,1542,1,8,5,1,26,12,14,29
CFR Cluj,1542,2,5,7,2,15,11,4,22
FC Botosani,1542,3,5,4,5,11,14,-3,19
Universitate,1542,4,4,6,4,18,21,-3,18
D Bucuresti,1542,5,4,4,6,18,21,-3,16
Concordia Ch,1542,6,2,2,10,16,25,-9,8
FCSB,1543,1,8,5,1,26,12,14,29
CFR Cluj,1543,2,6,6,2,14,9,5,24
Universitate,1543,3,4,5,5,16,20,-4,17
D Bucuresti,1543,4,4,4,6,20,21,-1,16
FC Botosani,1543,5,4,4,6,9,16,-7,16
Concordia Ch,1543,6,3,2,9,19,26,-7,11
FCSB,1544,1,9,5,0,30,12,18,32
CFR Cluj,1544,2,6,6,2,15,11,4,24
D Bucuresti,1544,3,4,4,6,20,24,-4,16
FC Botosani,1544,4,4,4,6,8,15,-7,16
Universitate,1544,5,3,5,6,15,22,-7,14
Concordia Ch,1544,6,3,2,9,20,24,-4,11
FCSB,1545,1,8,5,1,25,12,13,29
CFR Cluj,1545,2,6,6,2,15,9,6,24
FC Botosani,1545,3,5,4,5,9,13,-4,19
Universitate,1545,4,4,5,5,16,20,-4,17
D Bucuresti,1545,5,3,5,6,18,21,-3,14
Concordia Ch,1545,6,2,3,9,16,24,-8,9
FCSB,1546,1,8,6,0,24,10,14,30
CFR Cluj,1546,2,5,6,3,13,9,4,21
Universitate,1546,3,4,6,4,15,18,-3,18
Concordia Ch,1546,4,4,2,8,21,23,-2,14
D Bucuresti,1546,5,3,5,6,17,22,-5,14
FC Botosani,1546,6,3,5,6,8,16,-8,14
FCSB,1547,1,8,6,0,25,11,14,30
CFR Cluj,1547,2,5,6,3,13,9,4,21
D Bucuresti,1547,3,5,4,5,19,19,0,19
Universitate,1547,4,4,6,4,16,19,-3,18
FC Botosani,1547,5,4,4,6,9,13,-4,16
Concordia Ch,1547,6,2,2,10,16,27,-11,8
FCSB,1548,1,9,5,0,26,11,15,32
CFR Cluj,1548,2,6,6,2,15,9,6,24
FC Botosani,1548,3,4,4,6,6,13,-7,16
D Bucuresti,1548,4,3,5,6,17,20,-3,14
Universitate,1548,5,3,5,6,14,20,-6,14
Concordia Ch,1548,6,3,3,8,17,22,-5,12
FCSB,1549,1,7,7,0,25,12,13,28
CFR Cluj,1549,2,6,7,1,16,9,7,25
D Bucuresti,1549,3,4,5,5,18,19,-1,17
Universitate,1549,4,3,6,5,14,19,-5,15
FC Botosani,1549,5,3,4,7,6,15,-9,13
Concordia Ch,1549,6,3,3,8,18,23,-5,12
FCSB,1550,1,9,5,0,30,13,17,32
CFR Cluj,1550,2,5,6,3,14,10,4,21
Universitate,1550,3,4,5,5,17,23,-6,17
FC Botosani,1550,4,3,6,5,8,15,-7,15
D Bucuresti,1550,5,3,5,6,17,21,-4,14
Concordia Ch,1550,6,3,3,8,19,23,-4,12
FCSB,1551,1,8,6,0,27,12,15,30
CFR Cluj,1551,2,5,7,2,13,9,4,22
D Bucuresti,1551,3,4,5,5,21,20,1,17
Universitate,1551,4,3,7,4,16,20,-4,16
FC Botosani,1551,5,3,5,6,7,16,-9,14
Concordia Ch,1551,6,3,2,9,17,24,-7,11
FCSB,1552,1,9,5,0,25,10,15,32
CFR Cluj,1552,2,5,7,2,13,8,5,22
FC Botosani,1552,3,4,5,5,10,16,-6,17
Universitate,1552,4,3,6,5,14,19,-5,15
D Bucuresti,1552,5,3,5,6,18,23,-5,14
Concordia Ch,1552,6,3,2,9,20,24,-4,11
FCSB,1553,1,7,6,1,25,13,12,27
CFR Cluj,1553,2,6,7,1,14,7,7,25
D Bucuresti,1553,3,4,5,5,20,21,-1,17
Universitate,1553,4,3,7,4,16,20,-4,16
FC Botosani,1553,5,4,4,6,6,13,-7,16
Concordia Ch,1553,6,2,3,9,18,25,-7,9
FCSB,1554,1,8,5,1,26,12,14,29
CFR Cluj,1554,2,5,7,2,15,11,4,22
Universitate,1554,3,4,6,4,16,19,-3,18
D Bucuresti,1554,4,4,5,5,21,21,0,17
FC Botosani,1554,5,4,5,5,9,15,-6,17
Concordia Ch,1554,6,2,2,10,17,26,-9,8
FCSB,1555,1,9,5,0,25,10,15,32
CFR Cluj,1555,2,5,7,2,14,9,5,22
D Bucuresti,1555,3,4,4,6,17,19,-2,16
Universitate,1555,4,3,6,5,15,20,-5,15
FC Botosani,1555,5,3,5,6,5,13,-8,14
Concordia Ch,1555,6,3,3,8,16,21,-5,12
FCSB,1556,1,8,6,0,26,12,14,30
CFR Cluj,1556,2,5,8,1,16,10,6,23
FC Botosani,1556,3,4,4,6,6,14,-8,16
Universitate,1556,4,3,6,5,17,22,-5,15
Concordia Ch,1556,5,4,2,8,18,21,-3,14
D Bucuresti,1556,6,3,4,7,16,20,-4,13
FCSB,1557,1,7,7,0,23,10,13,28
CFR Cluj,1557,2,5,8,1,14,8,6,23
FC Botosani,1557,3,4,5,5,9,14,-5,17
Universitate,1557,4,3,7,4,15,19,-4,16
D Bucuresti,1557,5,3,4,7,18,23,-5,13
Concordia Ch,1557,6,3,3,8,18,23,-5,12
FCSB,1558,1,7,7,0,26,13,13,28
CFR Cluj,1558,2,5,8,1,16,10,6,23
D Bucuresti,1558,3,4,4,6,21,23,-2,16
Universitate,1558,4,3,7,4,16,20,-4,16
Concordia Ch,1558,5,4,2,8,20,24,-4,14
FC Botosani,1558,6,3,4,7,6,15,-9,13
FCSB,1559,1,8,5,1,25,12,13,29
CFR Cluj,1559,2,6,7,1,16,9,7,25
D Bucuresti,1559,3,4,4,6,17,19,-2,16
Universitate,1559,4,3,6,5,15,20,-5,15
FC Botosani,1559,5,3,5,6,5,13,-8,14
Concordia Ch,1559,6,3,3,8,16,21,-5,12
FCSB,1560,1,8,5,1,25,12,13,29
CFR Cluj,1560,2,6,6,2,14,9,5,24
Universitate,1560,3,4,5,5,16,19,-3,17
FC Botosani,1560,4,4,4,6,6,14,-8,16
Concordia Ch,1560,5,4,2,8,20,22,-2,14
D Bucuresti,1560,6,3,4,7,17,22,-5,13
CFR Cluj,1561,1,7,6,1,22,8,14,27
FCSB,1561,2,7,6,1,24,14,10,27
FC Botosani,1561,3,4,5,5,8,12,-4,17
Universitate,1561,4,3,6,5,14,23,-9,15
D Bucuresti,1561,5,3,5,6,17,20,-3,14
Concordia Ch,1561,6,3,2,9,17,25,-8,11
FCSB,1562,1,7,6,1,24,13,11,27
CFR Cluj,1562,2,6,6,2,16,9,7,24
Universitate,1562,3,4,6,4,17,20,-3,18
FC Botosani,1562,4,4,5,5,8,14,-6,17
D Bucuresti,1562,5,4,4,6,18,20,-2,16
Concordia Ch,1562,6,2,3,9,16,23,-7,9
FCSB,1563,1,8,5,1,25,15,10,29
CFR Cluj,1563,2,6,6,2,14,8,6,24
D Bucuresti,1563,3,4,5,5,20,21,-1,17
Universitate,1563,4,4,5,5,19,20,-1,17
FC Botosani,1563,5,3,6,5,8,15,-7,15
Concordia Ch,1563,6,2,3,9,15,22,-7,9
FCSB,1564,1,8,6,0,26,12,14,30
CFR Cluj,1564,2,5,8,1,15,9,6,23
D Bucuresti,1564,3,4,5,5,18,18,0,17
FC Botosani,1564,4,4,4,6,6,14,-8,16
Universitate,1564,5,3,6,5,16,21,-5,15
Concordia Ch,1564,6,2,3,9,15,22,-7,9
FCSB,1565,1,8,5,1,28,15,13,29
CFR Cluj,1565,2,6,6,2,16,10,6,24
Universitate,1565,3,4,5,5,17,21,-4,17
FC Botosani,1565,4,4,5,5,6,12,-6,17
D Bucuresti,1565,5,3,5,6,16,22,-6,14
Concordia Ch,1565,6,3,2,9,19,22,-3,11
FCSB,1566,1,8,6,0,26,12,14,30
CFR Cluj,1566,2,6,7,1,18,9,9,25
FC Botosani,1566,3,5,4,5,8,12,-4,19
Universitate,1566,4,3,5,6,16,24,-8,14
D Bucuresti,1566,5,3,4,7,18,24,-6,13
Concordia Ch,1566,6,3,2,9,19,24,-5,11
FCSB,1567,1,8,5,1,27,12,15,29
CFR Cluj,1567,2,6,6,2,15,11,4,24
FC Botosani,1567,3,5,4,5,7,12,-5,19
Universitate,1567,4,4,5,5,15,19,-4,17
D Bucuresti,1567,5,3,4,7,17,22,-5,13
Concordia Ch,1567,6,3,2,9,18,23,-5,11
FCSB,1568,1,7,6,1,24,12,12,27
CFR Cluj,1568,2,7,6,1,17,7,10,27
D Bucuresti,1568,3,4,4,6,20,20,0,16
FC Botosani,1568,4,4,4,6,8,16,-8,16
Universitate,1568,5,3,6,5,15,22,-7,15
Concordia Ch,1568,6,3,2,9,18,25,-7,11
FCSB,1569,1,7,6,1,25,14,11,27
CFR Cluj,1569,2,6,7,1,17,9,8,25
D Bucuresti,1569,3,5,4,5,19,18,1,19
Universitate,1569,4,4,5,5,16,20,-4,17
FC Botosani,1569,5,3,4,7,7,17,-10,13
Concordia Ch,1569,6,3,2,9,18,24,-6,11
CFR Cluj,1570,1,7,6,1,15,7,8,27
FCSB,1570,2,7,5,2,23,13,10,26
D Bucuresti,1570,3,4,5,5,20,20,0,17
Universitate,1570,4,4,5,5,16,19,-3,17
FC Botosani,1570,5,4,4,6,9,17,-8,16
Concordia Ch,1570,6,2,3,9,20,27,-7,9
FCSB,1571,1,7,6,1,26,14,12,27
CFR Cluj,1571,2,6,6,2,18,12,6,24
Universitate,1571,3,4,6,4,20,23,-3,18
D Bucuresti,1571,4,4,5,5,20,21,-1,17
FC Botosani,1571,5,4,5,5,11,14,-3,17
Concordia Ch,1571,6,2,2,10,16,27,-11,8
FCSB,1572,1,9,5,0,26,11,15,32
CFR Cluj,1572,2,6,6,2,17,9,8,24
FC Botosani,1572,3,3,6,5,7,14,-7,15
D Bucuresti,1572,4,3,5,6,18,21,-3,14
Universitate,1572,5,3,5,6,16,24,-8,14
Concordia Ch,1572,6,3,3,8,16,21,-5,12
FCSB,1573,1,7,5,2,24,16,8,26
CFR Cluj,1573,2,6,7,1,19,10,9,25
D Bucuresti,1573,3,5,4,5,18,18,0,19
Universitate,1573,4,4,6,4,20,22,-2,18
FC Botosani,1573,5,4,4,6,8,14,-6,16
Concordia Ch,1573,6,2,2,10,16,25,-9,8
FCSB,1574,1,8,6,0,25,10,15,30
CFR Cluj,1574,2,6,6,2,14,9,5,24
D Bucuresti,1574,3,5,4,5,23,20,3,19
Universitate,1574,4,3,6,5,14,19,-5,15
FC Botosani,1574,5,3,5,6,6,14,-8,14
Concordia Ch,1574,6,2,3,9,16,26,-10,9
FCSB,1575,1,9,5,0,27,12,15,32
CFR Cluj,1575,2,6,6,2,15,8,7,24
D Bucuresti,1575,3,3,6,5,16,18,-2,15
Universitate,1575,4,3,5,6,16,23,-7,14
FC Botosani,1575,5,3,5,6,5,14,-9,14
Concordia Ch,1575,6,3,3,8,17,21,-4,12
FCSB,1576,1,8,6,0,27,12,15,30
CFR Cluj,1576,2,5,7,2,14,10,4,22
FC Botosani,1576,3,5,4,5,8,12,-4,19
Universitate,1576,4,3,7,4,15,19,-4,16
D Bucuresti,1576,5,3,4,7,16,22,-6,13
Concordia Ch,1576,6,3,2,9,17,22,-5,11
FCSB,1577,1,7,6,1,23,11,12,27
CFR Cluj,1577,2,6,7,1,14,7,7,25
D Bucuresti,1577,3,4,4,6,23,22,1,16
Universitate,1577,4,3,7,4,14,18,-4,16
FC Botosani,1577,5,3,5,6,7,18,-11,14
Concordia Ch,1577,6,3,3,8,19,24,-5,12
CFR Cluj,1578,1,7,6,1,18,8,10,27
FCSB,1578,2,7,5,2,24,14,10,26
D Bucuresti,1578,3,5,4,5,20,18,2,19
Universitate,1578,4,4,5,5,16,21,-5,17
FC Botosani,1578,5,3,4,7,5,17,-12,13
Concordia Ch,1578,6,3,2,9,18,23,-5,11
FCSB,1579,1,7,7,0,27,14,13,28
CFR Cluj,1579,2,6,7,1,18,11,7,25
FC Botosani,1579,3,5,4,5,11,13,-2,19
Universitate,1579,4,3,6,5,16,21,-5,15
D Bucuresti,1579,5,3,4,7,19,26,-7,13
Concordia Ch,1579,6,3,2,9,18,24,-6,11
FCSB,1580,1,8,6,0,26,12,14,30
CFR Cluj,1580,2,6,7,1,16,9,7,25
FC Botosani,1580,3,4,4,6,8,15,-7,16
D Bucuresti,1580,4,3,5,6,17,20,-3,14
Universitate,1580,5,3,5,6,16,22,-6,14
Concordia Ch,1580,6,3,3,8,19,24,-5,12
FCSB,1581,1,8,6,0,26,11,15,30
CFR Cluj,1581,2,6,7,1,23,8,15,25
D Bucuresti,1581,3,5,4,5,21,19,2,19
FC Botosani,1581,4,4,4,6,8,16,-8,16
Universitate,1581,5,3,5,6,14,29,-15,14
Concordia Ch,1581,6,2,2,10,17,26,-9,8
FCSB,1582,1,9,5,0,29,11,18,32
CFR Cluj,1582,2,6,6,2,15,9,6,24
D Bucuresti,1582,3,3,6,5,18,20,-2,15
FC Botosani,1582,4,3,6,5,5,12,-7,15
Universitate,1582,5,3,5,6,14,23,-9,14
Concordia Ch,1582,6,2,4,8,17,23,-6,10
FCSB,1583,1,8,6,0,24,10,14,30
CFR Cluj,1583,2,5,6,3,13,10,3,21
Universitate,1583,3,4,6,4,16,18,-2,18
FC Botosani,1583,4,4,5,5,7,13,-6,17
D Bucuresti,1583,5,4,4,6,19,21,-2,16
Concordia Ch,1583,6,2,3,9,18,25,-7,9
FCSB,1584,1,8,5,1,27,13,14,29
CFR Cluj,1584,2,5,6,3,16,13,3,21
Universitate,1584,3,5,5,4,19,21,-2,20
FC Botosani,1584,4,4,5,5,6,12,-6,17
D Bucuresti,1584,5,3,5,6,17,22,-5,14
Concordia Ch,1584,6,3,2,9,19,23,-4,11
FCSB,1585,1,8,6,0,26,12,14,30
CFR Cluj,1585,2,6,6,2,15,9,6,24
D Bucuresti,1585,3,4,4,6,21,22,-1,16
Universitate,1585,4,3,6,5,15,20,-5,15
Concordia Ch,1585,5,4,2,8,19,22,-3,14
FC Botosani,1585,6,3,4,7,6,17,-11,13
FCSB,1586,1,8,5,1,26,12,14,29
CFR Cluj,1586,2,6,6,2,15,10,5,24
D Bucuresti,1586,3,4,5,5,19,18,1,17
Universitate,1586,4,4,5,5,16,20,-4,17
FC Botosani,1586,5,4,4,6,9,15,-6,16
Concordia Ch,1586,6,2,3,9,15,25,-10,9
FCSB,1587,1,8,5,1,25,13,12,29
CFR Cluj,1587,2,5,7,2,13,8,5,22
D Bucuresti,1587,3,5,4,5,20,19,1,19
Universitate,1587,4,4,6,4,17,19,-2,18
FC Botosani,1587,5,3,4,7,5,14,-9,13
Concordia Ch,1587,6,3,2,9,17,24,-7,11
FCSB,1588,1,7,7,0,27,14,13,28
CFR Cluj,1588,2,6,7,1,17,8,9,25
D Bucuresti,1588,3,4,5,5,21,20,1,17
Universitate,1588,4,3,6,5,17,24,-7,15
FC Botosani,1588,5,3,4,7,5,16,-11,13
Concordia Ch,1588,6,3,3,8,18,23,-5,12
CFR Cluj,1589,1,7,6,1,16,8,8,27
FCSB,1589,2,7,5,2,24,13,11,26
FC Botosani,1589,3,5,4,5,11,13,-2,19
Universitate,1589,4,4,5,5,15,19,-4,17
D Bucuresti,1589,5,4,4,6,17,19,-2,16
Concordia Ch,1589,6,2,2,10,16,27,-11,8
FCSB,1590,1,9,5,0,28,12,16,32
CFR Cluj,1590,2,6,6,2,19,10,9,24
FC Botosani,1590,3,4,5,5,7,12,-5,17
D Bucuresti,1590,4,4,4,6,19,21,-2,16
Universitate,1590,5,3,5,6,14,24,-10,14
Concordia Ch,1590,6,2,3,9,16,24,-8,9
FCSB,1591,1,8,5,1,24,11,13,29
CFR Cluj,1591,2,7,6,1,15,7,8,27
D Bucuresti,1591,3,4,5,5,18,19,-1,17
Universitate,1591,4,3,5,6,14,20,-6,14
FC Botosani,1591,5,3,4,7,5,14,-9,13
Concordia Ch,1591,6,3,3,8,17,22,-5,12
FCSB,1592,1,8,6,0,25,11,14,30
CFR Cluj,1592,2,6,6,2,15,9,6,24
D Bucuresti,1592,3,5,4,5,21,18,3,19
Universitate,1592,4,3,6,5,16,21,-5,15
FC Botosani,1592,5,3,4,7,5,16,-11,13
Concordia Ch,1592,6,3,2,9,16,23,-7,11
FCSB,1593,1,8,5,1,27,12,15,29
CFR Cluj,1593,2,6,6,2,16,12,4,24
Universitate,1593,3,4,5,5,17,21,-4,17
FC Botosani,1593,4,4,5,5,8,13,-5,17
D Bucuresti,1593,5,3,6,5,18,20,-2,15
Concordia Ch,1593,6,2,3,9,16,24,-8,9
FCSB,1594,1,8,5,1,25,11,14,29
CFR Cluj,1594,2,5,6,3,14,11,3,21
Universitate,1594,3,5,5,4,17,19,-2,20
FC Botosani,1594,4,4,5,5,8,14,-6,17
D Bucuresti,1594,5,3,5,6,17,20,-3,14
Concordia Ch,1594,6,3,2,9,17,23,-6,11
FCSB,1595,1,9,5,0,29,12,17,32
CFR Cluj,1595,2,6,6,2,17,10,7,24
D Bucuresti,1595,3,5,4,5,20,19,1,19
FC Botosani,1595,4,4,4,6,9,15,-6,16
Universitate,1595,5,3,5,6,15,24,-9,14
Concordia Ch,1595,6,2,2,10,17,27,-10,8
FCSB,1596,1,9,5,0,25,10,15,32
CFR Cluj,1596,2,6,6,2,16,10,6,24
D Bucuresti,1596,3,3,6,5,19,21,-2,15
Universitate,1596,4,3,5,6,16,22,-6,14
FC Botosani,1596,5,3,5,6,6,14,-8,14
Concordia Ch,1596,6,3,3,8,18,23,-5,12
FCSB,1597,1,9,5,0,28,11,17,32
CFR Cluj,1597,2,5,7,2,14,10,4,22
D Bucuresti,1597,3,4,4,6,18,22,-4,16
Universitate,1597,4,3,6,5,14,20,-6,15
Concordia Ch,1597,5,4,2,8,19,21,-2,14
FC Botosani,1597,6,3,4,7,6,15,-9,13
FCSB,1598,1,8,6,0,26,10,16,30
CFR Cluj,1598,2,6,6,2,16,10,6,24
D Bucuresti,1598,3,5,4,5,21,19,2,19
FC Botosani,1598,4,4,4,6,7,14,-7,16
Universitate,1598,5,3,6,5,14,21,-7,15
Concordia Ch,1598,6,2,2,10,15,25,-10,8
FCSB,1599,1,7,5,2,23,13,10,26
CFR Cluj,1599,2,6,7,1,14,7,7,25
Universitate,1599,3,4,6,4,16,18,-2,18
D Bucuresti,1599,4,4,4,6,19,20,-1,16
FC Botosani,1599,5,4,4,6,6,14,-8,16
Concordia Ch,1599,6,3,2,9,18,24,-6,11
FCSB,1600,1,9,5,0,26,11,15,32
CFR Cluj,1600,2,6,6,2,15,9,6,24
D Bucuresti,1600,3,4,4,6,17,19,-2,16
FC Botosani,1600,4,4,4,6,6,13,-7,16
Universitate,1600,5,3,5,6,16,22,-6,14
Concordia Ch,1600,6,3,2,9,16,22,-6,11
FCSB,1601,1,7,5,2,23,14,9,26
CFR Cluj,1601,2,6,7,1,17,9,8,25
Universitate,1601,3,4,6,4,18,20,-2,18
D Bucuresti,1601,4,4,5,5,20,20,0,17
FC Botosani,1601,5,4,5,5,10,15,-5,17
Concordia Ch,1601,6,2,2,10,16,26,-10,8
FCSB,1602,1,8,6,0,24,10,14,30
CFR Cluj,1602,2,6,6,2,15,8,7,24
D Bucuresti,1602,3,5,4,5,20,18,2,19
Universitate,1602,4,3,6,5,14,20,-6,15
FC Botosani,1602,5,3,5,6,6,14,-8,14
Concordia Ch,1602,6,2,3,9,16,25,-9,9
FCSB,1603,1,8,5,1,27,13,14,29
CFR Cluj,1603,2,6,6,2,14,11,3,24
D Bucuresti,1603,3,4,5,5,18,19,-1,17
Universitate,1603,4,4,5,5,17,19,-2,17
FC Botosani,1603,5,4,5,5,7,12,-5,17
Concordia Ch,1603,6,2,2,10,16,25,-9,8
FCSB,1604,1,8,6,0,28,13,15,30
CFR Cluj,1604,2,6,7,1,15,8,7,25
D Bucuresti,1604,3,3,6,5,19,21,-2,15
Universitate,1604,4,3,5,6,16,23,-7,14
FC Botosani,1604,5,3,5,6,7,15,-8,14
Concordia Ch,1604,6,3,3,8,17,22,-5,12
FCSB,1605,1,9,5,0,29,13,16,32
CFR Cluj,1605,2,5,7,2,14,10,4,22
FC Botosani,1605,3,4,5,5,7,13,-6,17
Universitate,1605,4,3,6,5,16,21,-5,15
D Bucuresti,1605,5,3,5,6,17,23,-6,14
Concordia Ch,1605,6,3,2,9,21,24,-3,11
FCSB,1606,1,8,5,1,26,12,14,29
CFR Cluj,1606,2,5,7,2,15,12,3,22
Universitate,1606,3,4,6,4,18,20,-2,18
D Bucuresti,1606,4,4,4,6,17,19,-2,16
FC Botosani,1606,5,3,5,6,5,13,-8,14
Concordia Ch,1606,6,3,3,8,16,21,-5,12
FCSB,1607,1,8,6,0,25,11,14,30
CFR Cluj,1607,2,5,6,3,13,9,4,21
Universitate,1607,3,4,6,4,16,19,-3,18
FC Botosani,1607,4,4,5,5,6,12,-6,17
D Bucuresti,1607,5,3,4,7,16,20,-4,13
Concordia Ch,1607,6,3,3,8,16,21,-5,12
FCSB,1608,1,8,5,1,29,15,14,29
CFR Cluj,1608,2,6,6,2,17,11,6,24
FC Botosani,1608,3,4,5,5,11,14,-3,17
Universitate,1608,4,4,5,5,19,24,-5,17
D Bucuresti,1608,5,3,5,6,18,24,-6,14
Concordia Ch,1608,6,3,2,9,19,25,-6,11
FCSB,1609,1,8,6,0,25,11,14,30
CFR Cluj,1609,2,5,6,3,14,11,3,21
Universitate,1609,3,4,6,4,16,18,-2,18
FC Botosani,1609,4,4,5,5,7,13,-6,17
D Bucuresti,1609,5,3,6,5,16,18,-2,15
Concordia Ch,1609,6,2,3,9,16,23,-7,9
FCSB,1610,1,8,5,1,27,14,13,29
CFR Cluj,1610,2,6,6,2,14,9,5,24
Universitate,1610,3,4,5,5,18,21,-3,17
D Bucuresti,1610,4,4,4,6,19,21,-2,16
Concordia Ch,1610,5,4,2,8,21,24,-3,14
FC Botosani,1610,6,3,4,7,6,16,-10,13
FCSB,1611,1,9,5,0,27,10,17,32
CFR Cluj,1611,2,6,6,2,15,9,6,24
D Bucuresti,1611,3,4,5,5,21,21,0,17
FC Botosani,1611,4,4,4,6,8,16,-8,16
Universitate,1611,5,3,5,6,14,22,-8,14
Concordia Ch,1611,6,2,3,9,18,25,-7,9
FCSB,1612,1,8,6,0,28,11,17,30
CFR Cluj,1612,2,5,8,1,16,10,6,23
FC Botosani,1612,3,4,5,5,9,14,-5,17
Universitate,1612,4,3,6,5,18,26,-8,15
D Bucuresti,1612,5,3,4,7,17,23,-6,13
Concordia Ch,1612,6,3,3,8,18,22,-4,12
FCSB,1613,1,9,5,0,28,11,17,32
CFR Cluj,1613,2,6,6,2,14,10,4,24
FC Botosani,1613,3,4,5,5,8,13,-5,17
D Bucuresti,1613,4,3,5,6,18,22,-4,14
Universitate,1613,5,3,5,6,15,21,-6,14
Concordia Ch,1613,6,2,4,8,16,22,-6,10
FCSB,1614,1,8,5,1,26,13,13,29
CFR Cluj,1614,2,5,6,3,14,11,3,21
Universitate,1614,3,5,5,4,17,18,-1,20
FC Botosani,1614,4,4,5,5,7,13,-6,17
D Bucuresti,1614,5,3,4,7,19,23,-4,13
Concordia Ch,1614,6,3,3,8,18,23,-5,12
FCSB,1615,1,7,5,2,24,13,11,26
CFR Cluj,1615,2,6,7,1,14,7,7,25
Universitate,1615,3,4,6,4,16,19,-3,18
D Bucuresti,1615,4,3,5,6,17,20,-3,14
Concordia Ch,1615,5,4,2,8,17,21,-4,14
FC Botosani,1615,6,3,5,6,6,14,-8,14
FCSB,1616,1,9,5,0,26,10,16,32
CFR Cluj,1616,2,5,6,3,14,11,3,21
Universitate,1616,3,4,5,5,17,21,-4,17
FC Botosani,1616,4,4,5,5,7,13,-6,17
D Bucuresti,1616,5,4,4,6,20,22,-2,16
Concordia Ch,1616,6,2,3,9,19,26,-7,9
FCSB,1617,1,9,5,0,29,11,18,32
CFR Cluj,1617,2,6,6,2,16,11,5,24
FC Botosani,1617,3,4,4,6,8,15,-7,16
Concordia Ch,1617,4,4,2,8,21,25,-4,14
Universitate,1617,5,3,5,6,15,23,-8,14
D Bucuresti,1617,6,3,4,7,20,24,-4,13
FCSB,1618,1,8,5,1,26,12,14,29
CFR Cluj,1618,2,6,6,2,16,10,6,24
FC Botosani,1618,3,4,5,5,8,12,-4,17
Universitate,1618,4,4,5,5,16,21,-5,17
D Bucuresti,1618,5,3,5,6,17,20,-3,14
Concordia Ch,1618,6,3,2,9,17,25,-8,11
FCSB,1619,1,9,5,0,25,10,15,32
CFR Cluj,1619,2,5,7,2,14,9,5,22
D Bucuresti,1619,3,4,4,6,18,23,-5,16
FC Botosani,1619,4,4,4,6,8,14,-6,16
Universitate,1619,5,3,6,5,15,20,-5,15
Concordia Ch,1619,6,3,2,9,19,23,-4,11
FCSB,1620,1,7,7,0,24,11,13,28
CFR Cluj,1620,2,6,7,1,16,9,7,25
FC Botosani,1620,3,4,5,5,7,13,-6,17
Universitate,1620,4,3,6,5,15,20,-5,15
D Bucuresti,1620,5,3,5,6,16,20,-4,14
Concordia Ch,1620,6,3,2,9,18,23,-5,11
FCSB,1621,1,9,5,0,26,10,16,32
CFR Cluj,1621,2,6,6,2,15,10,5,24
D Bucuresti,1621,3,5,4,5,22,22,0,19
Universitate,1621,4,3,5,6,15,21,-6,14
FC Botosani,1621,5,3,4,7,7,16,-9,13
Concordia Ch,1621,6,3,2,9,20,26,-6,11
FCSB,1622,1,8,6,0,26,11,15,30
CFR Cluj,1622,2,5,6,3,13,11,2,21
FC Botosani,1622,3,5,4,5,9,13,-4,19
Universitate,1622,4,4,6,4,17,19,-2,18
D Bucuresti,1622,5,4,4,6,20,21,-1,16
Concordia Ch,1622,6,2,2,10,17,27,-10,8
FCSB,1623,1,8,6,0,27,13,14,30
CFR Cluj,1623,2,5,6,3,14,11,3,21
Universitate,1623,3,4,6,4,18,20,-2,18
D Bucuresti,1623,4,4,4,6,20,22,-2,16
FC Botosani,1623,5,3,5,6,6,14,-8,14
Concordia Ch,1623,6,3,3,8,18,23,-5,12
FCSB,1624,1,8,5,1,26,13,13,29
CFR Cluj,1624,2,6,6,2,15,8,7,24
Universitate,1624,3,4,5,5,16,21,-5,17
FC Botosani,1624,4,4,4,6,8,15,-7,16
D Bucuresti,1624,5,3,5,6,18,21,-3,14
Concordia Ch,1624,6,3,3,8,18,23,-5,12
FCSB,1625,1,9,5,0,26,11,15,32
CFR Cluj,1625,2,5,7,2,16,11,5,22
D Bucuresti,1625,3,5,4,5,21,19,2,19
Universitate,1625,4,3,6,5,16,21,-5,15
FC Botosani,1625,5,3,4,7,5,17,-12,13
Concordia Ch,1625,6,3,2,9,19,24,-5,11
FCSB,1626,1,7,6,1,23,11,12,27
CFR Cluj,1626,2,6,7,1,16,9,7,25
FC Botosani,1626,3,4,5,5,7,13,-6,17
Universitate,1626,4,3,7,4,16,20,-4,16
D Bucuresti,1626,5,3,5,6,18,21,-3,14
Concordia Ch,1626,6,2,4,8,18,24,-6,10
FCSB,1627,1,8,5,1,25,12,13,29
CFR Cluj,1627,2,6,7,1,15,8,7,25
FC Botosani,1627,3,4,5,5,7,13,-6,17
Universitate,1627,4,3,6,5,14,19,-5,15
D Bucuresti,1627,5,3,5,6,17,20,-3,14
Concordia Ch,1627,6,3,2,9,16,22,-6,11
FCSB,1628,1,8,5,1,26,13,13,29
CFR Cluj,1628,2,7,6,1,17,8,9,27
D Bucuresti,1628,3,4,5,5,23,19,4,17
FC Botosani,1628,4,4,4,6,8,20,-12,16
Universitate,1628,5,3,5,6,15,22,-7,14
Concordia Ch,1628,6,2,3,9,18,25,-7,9
FCSB,1629,1,9,5,0,27,10,17,32
CFR Cluj,1629,2,6,6,2,15,9,6,24
FC Botosani,1629,3,5,4,5,9,12,-3,19
Universitate,1629,4,3,5,6,15,23,-8,14
D Bucuresti,1629,5,3,4,7,16,22,-6,13
Concordia Ch,1629,6,3,2,9,18,24,-6,11
FCSB,1630,1,8,6,0,26,12,14,30
CFR Cluj,1630,2,5,6,3,14,10,4,21
Universitate,1630,3,4,6,4,16,19,-3,18
D Bucuresti,1630,4,4,4,6,17,21,-4,16
FC Botosani,1630,5,4,4,6,8,14,-6,16
Concordia Ch,1630,6,3,2,9,19,24,-5,11
FCSB,1631,1,8,5,1,27,13,14,29
CFR Cluj,1631,2,6,6,2,17,11,6,24
D Bucuresti,1631,3,4,5,5,18,19,-1,17
Universitate,1631,4,4,5,5,16,21,-5,17
FC Botosani,1631,5,4,4,6,8,13,-5,16
Concordia Ch,1631,6,2,3,9,16,25,-9,9
CFR Cluj,1632,1,7,6,1,16,7,9,27
FCSB,1632,2,7,5,2,23,13,10,26
FC Botosani,1632,3,5,4,5,9,13,-4,19
Universitate,1632,4,4,5,5,15,19,-4,17
D Bucuresti,1632,5,3,4,7,18,26,-8,13
Concordia Ch,1632,6,3,2,9,20,23,-3,11
FCSB,1633,1,8,6,0,25,10,15,30
CFR Cluj,1633,2,6,6,2,14,9,5,24
D Bucuresti,1633,3,4,4,6,18,20,-2,16
FC Botosani,1633,4,4,4,6,8,15,-7,16
Universitate,1633,5,3,6,5,14,19,-5,15
Concordia Ch,1633,6,3,2,9,18,24,-6,11
FCSB,1634,1,9,5,0,26,10,16,32
CFR Cluj,1634,2,5,7,2,14,9,5,22
D Bucuresti,1634,3,5,4,5,18,18,0,19
FC Botosani,1634,4,4,4,6,10,14,-4,16
Universitate,1634,5,3,6,5,15,21,-6,15
Concordia Ch,1634,6,2,2,10,16,27,-11,8
FCSB,1635,1,8,6,0,26,12,14,30
CFR Cluj,1635,2,6,7,1,14,7,7,25
D Bucuresti,1635,3,4,5,5,18,19,-1,17
FC Botosani,1635,4,4,5,5,7,13,-6,17
Universitate,1635,5,3,5,6,16,22,-6,14
Concordia Ch,1635,6,2,2,10,17,25,-8,8
FCSB,1636,1,8,6,0,26,11,15,30
CFR Cluj,1636,2,5,8,1,13,7,6,23
D Bucuresti,1636,3,4,4,6,18,20,-2,16
FC Botosani,1636,4,4,4,6,7,14,-7,16
Universitate,1636,5,3,6,5,15,21,-6,15
Concordia Ch,1636,6,3,2,9,16,22,-6,11
FCSB,1637,1,8,5,1,25,13,12,29
CFR Cluj,1637,2,6,6,2,16,10,6,24
D Bucuresti,1637,3,4,5,5,20,19,1,17
Universitate,1637,4,4,5,5,18,21,-3,17
FC Botosani,1637,5,4,5,5,9,14,-5,17
Concordia Ch,1637,6,2,2,10,16,27,-11,8
FCSB,1638,1,8,6,0,27,12,15,30
CFR Cluj,1638,2,5,7,2,14,9,5,22
FC Botosani,1638,3,5,4,5,8,12,-4,19
Universitate,1638,4,4,5,5,16,21,-5,17
D Bucuresti,1638,5,3,4,7,17,23,-6,13
Concordia Ch,1638,6,3,2,9,19,24,-5,11
FCSB,1639,1,8,6,0,27,10,17,30
CFR Cluj,1639,2,5,7,2,15,13,2,22
Universitate,1639,3,3,7,4,16,20,-4,16
Concordia Ch,1639,4,4,2,8,19,21,-2,14
D Bucuresti,1639,5,3,5,6,16,20,-4,14
FC Botosani,1639,6,3,5,6,5,14,-9,14
FCSB,1640,1,7,7,0,23,10,13,28
CFR Cluj,1640,2,5,7,2,13,9,4,22
Universitate,1640,3,4,6,4,16,18,-2,18
FC Botosani,1640,4,3,6,5,5,12,-7,15
D Bucuresti,1640,5,3,5,6,17,20,-3,14
Concordia Ch,1640,6,3,3,8,17,22,-5,12
FCSB,1641,1,7,6,1,25,13,12,27
CFR Cluj,1641,2,5,8,1,14,8,6,23
Universitate,1641,3,4,6,4,16,19,-3,18
FC Botosani,1641,4,4,5,5,6,12,-6,17
D Bucuresti,1641,5,4,4,6,17,19,-2,16
Concordia Ch,1641,6,2,3,9,15,22,-7,9
FCSB,1642,1,8,6,0,29,15,14,30
CFR Cluj,1642,2,6,6,2,17,10,7,24
Universitate,1642,3,3,6,5,19,25,-6,15
Concordia Ch,1642,4,4,2,8,18,21,-3,14
D Bucuresti,1642,5,3,5,6,16,20,-4,14
FC Botosani,1642,6,3,5,6,5,13,-8,14
FCSB,1643,1,8,6,0,27,12,15,30
CFR Cluj,1643,2,6,7,1,17,10,7,25
D Bucuresti,1643,3,4,4,6,19,20,-1,16
FC Botosani,1643,4,4,4,6,8,14,-6,16
Universitate,1643,5,3,5,6,15,22,-7,14
Concordia Ch,1643,6,3,2,9,17,25,-8,11
FCSB,1644,1,8,6,0,26,12,14,30
CFR Cluj,1644,2,6,6,2,14,8,6,24
FC Botosani,1644,3,5,4,5,10,14,-4,19
Universitate,1644,4,3,6,5,16,21,-5,15
D Bucuresti,1644,5,3,4,7,17,21,-4,13
Concordia Ch,1644,6,3,2,9,17,24,-7,11
FCSB,1645,1,8,6,0,26,10,16,30
CFR Cluj,1645,2,5,7,2,14,11,3,22
D Bucuresti,1645,3,5,4,5,24,21,3,19
Universitate,1645,4,3,7,4,15,19,-4,16
FC Botosani,1645,5,4,4,6,6,15,-9,16
Concordia Ch,1645,6,2,2,10,18,27,-9,8
FCSB,1646,1,8,5,1,24,11,13,29
CFR Cluj,1646,2,7,6,1,15,7,8,27
FC Botosani,1646,3,4,5,5,8,13,-5,17
D Bucuresti,1646,4,3,5,6,18,21,-3,14
Universitate,1646,5,3,5,6,14,20,-6,14
Concordia Ch,1646,6,3,2,9,17,24,-7,11
FCSB,1647,1,8,5,1,25,12,13,29
CFR Cluj,1647,2,6,7,1,15,8,7,25
D Bucuresti,1647,3,4,4,6,19,20,-1,16
FC Botosani,1647,4,4,4,6,6,13,-7,16
Universitate,1647,5,3,6,5,16,21,-5,15
Concordia Ch,1647,6,3,2,9,17,24,-7,11
FCSB,1648,1,9,5,0,28,12,16,32
CFR Cluj,1648,2,6,6,2,16,9,7,24
D Bucuresti,1648,3,4,4,6,20,22,-2,16
Concordia Ch,1648,4,4,2,8,19,23,-4,14
Universitate,1648,5,3,5,6,15,23,-8,14
FC Botosani,1648,6,3,4,7,6,15,-9,13
FCSB,1649,1,8,5,1,24,14,10,29
CFR Cluj,1649,2,6,6,2,15,8,7,24
FC Botosani,1649,3,5,4,5,9,12,-3,19
Universitate,1649,4,4,5,5,18,20,-2,17
D Bucuresti,1649,5,3,5,6,16,21,-5,14
Concordia Ch,1649,6,2,3,9,15,22,-7,9
FCSB,1650,1,9,5,0,28,11,17,32
CFR Cluj,1650,2,5,7,2,15,11,4,22
D Bucuresti,1650,3,3,6,5,17,19,-2,15
Universitate,1650,4,3,6,5,17,23,-6,15
FC Botosani,1650,5,3,6,5,5,12,-7,15
Concordia Ch,1650,6,2,4,8,16,22,-6,10
FCSB,1651,1,7,6,1,24,13,11,27
CFR Cluj,1651,2,6,7,1,18,8,10,25
D Bucuresti,1651,3,4,5,5,19,20,-1,17
Universitate,1651,4,4,5,5,16,22,-6,17
FC Botosani,1651,5,3,6,5,9,16,-7,15
Concordia Ch,1651,6,2,3,9,17,24,-7,9
FCSB,1652,1,8,6,0,28,12,16,30
CFR Cluj,1652,2,5,6,3,14,13,1,21
Universitate,1652,3,4,6,4,17,19,-2,18
FC Botosani,1652,4,4,5,5,7,13,-6,17
D Bucuresti,1652,5,4,4,6,19,20,-1,16
Concordia Ch,1652,6,2,3,9,17,25,-8,9
FCSB,1653,1,8,5,1,26,12,14,29
CFR Cluj,1653,2,6,6,2,14,10,4,24
D Bucuresti,1653,3,4,5,5,18,18,0,17
Universitate,1653,4,4,5,5,16,19,-3,17
FC Botosani,1653,5,4,5,5,7,12,-5,17
Concordia Ch,1653,6,2,2,10,15,25,-10,8
FCSB,1654,1,7,7,0,25,12,13,28
CFR Cluj,1654,2,6,7,1,16,8,8,25
D Bucuresti,1654,3,4,4,6,20,22,-2,16
FC Botosani,1654,4,4,4,6,8,16,-8,16
Universitate,1654,5,3,6,5,15,21,-6,15
Concordia Ch,1654,6,3,2,9,19,24,-5,11
FCSB,1655,1,8,6,0,26,10,16,30
CFR Cluj,1655,2,5,8,1,15,9,6,23
FC Botosani,1655,3,4,5,5,8,14,-6,17
Universitate,1655,4,3,6,5,16,23,-7,15
D Bucuresti,1655,5,3,5,6,18,21,-3,14
Concordia Ch,1655,6,2,4,8,19,25,-6,10
FCSB,1656,1,8,6,0,25,11,14,30
CFR Cluj,1656,2,5,7,2,14,9,5,22
Universitate,1656,3,4,5,5,15,19,-4,17
D Bucuresti,1656,4,4,4,6,17,20,-3,16
Concordia Ch,1656,5,4,2,8,21,23,-2,14
FC Botosani,1656,6,3,4,7,7,17,-10,13
FCSB,1657,1,8,5,1,26,12,14,29
CFR Cluj,1657,2,6,7,1,16,8,8,25
D Bucuresti,1657,3,4,5,5,21,21,0,17
Universitate,1657,4,3,6,5,15,22,-7,15
FC Botosani,1657,5,3,4,7,7,18,-11,13
Concordia Ch,1657,6,3,3,8,18,22,-4,12
FCSB,1658,1,9,5,0,27,12,15,32
CFR Cluj,1658,2,5,6,3,15,11,4,21
Universitate,1658,3,4,5,5,17,21,-4,17
FC Botosani,1658,4,3,6,5,6,13,-7,15
D Bucuresti,1658,5,3,5,6,16,19,-3,14
Concordia Ch,1658,6,3,3,8,17,22,-5,12
FCSB,1659,1,8,5,1,27,13,14,29
CFR Cluj,1659,2,6,6,2,17,9,8,24
D Bucuresti,1659,3,5,4,5,21,20,1,19
Universitate,1659,4,4,5,5,17,24,-7,17
FC Botosani,1659,5,4,4,6,8,16,-8,16
Concordia Ch,1659,6,2,2,10,17,25,-8,8
FCSB,1660,1,7,6,1,24,12,12,27
CFR Cluj,1660,2,5,7,2,14,9,5,22
Universitate,1660,3,5,5,4,16,18,-2,20
D Bucuresti,1660,4,4,4,6,19,20,-1,16
FC Botosani,1660,5,4,4,6,7,14,-7,16
Concordia Ch,1660,6,3,2,9,17,24,-7,11
FCSB,1661,1,9,5,0,29,12,17,32
CFR Cluj,1661,2,5,7,2,13,9,4,22
D Bucuresti,1661,3,4,5,5,18,19,-1,17
FC Botosani,1661,4,4,4,6,6,13,-7,16
Universitate,1661,5,3,6,5,16,22,-6,15
Concordia Ch,1661,6,2,3,9,16,23,-7,9
FCSB,1662,1,8,5,1,25,12,13,29
CFR Cluj,1662,2,6,6,2,16,8,8,24
D Bucuresti,1662,3,4,5,5,18,19,-1,17
Universitate,1662,4,4,5,5,16,22,-6,17
FC Botosani,1662,5,3,6,5,6,13,-7,15
Concordia Ch,1662,6,2,3,9,15,22,-7,9
CFR Cluj,1663,1,7,6,1,17,7,10,27
FCSB,1663,2,7,5,2,25,18,7,26
FC Botosani,1663,3,5,4,5,8,12,-4,19
Universitate,1663,4,4,5,5,20,22,-2,17
D Bucuresti,1663,5,3,5,6,17,20,-3,14
Concordia Ch,1663,6,2,3,9,16,24,-8,9
FCSB,1664,1,8,5,1,25,12,13,29
CFR Cluj,1664,2,5,7,2,15,10,5,22
Universitate,1664,3,4,6,4,16,19,-3,18
D Bucuresti,1664,4,4,4,6,18,20,-2,16
FC Botosani,1664,5,3,5,6,6,15,-9,14
Concordia Ch,1664,6,3,3,8,18,22,-4,12
FCSB,1665,1,8,6,0,24,10,14,30
CFR Cluj,1665,2,6,7,1,14,7,7,25
D Bucuresti,1665,3,4,4,6,19,20,-1,16
FC Botosani,1665,4,4,4,6,7,15,-8,16
Universitate,1665,5,3,5,6,14,20,-6,14
Concordia Ch,1665,6,3,2,9,16,22,-6,11
FCSB,1666,1,8,6,0,25,11,14,30
CFR Cluj,1666,2,5,8,1,15,9,6,23
D Bucuresti,1666,3,4,4,6,17,19,-2,16
FC Botosani,1666,4,4,4,6,6,13,-7,16
Universitate,1666,5,3,6,5,15,20,-5,15
Concordia Ch,1666,6,3,2,9,16,22,-6,11
FCSB,1667,1,8,6,0,25,11,14,30
CFR Cluj,1667,2,6,7,1,14,7,7,25
D Bucuresti,1667,3,4,4,6,19,23,-4,16
Concordia Ch,1667,4,4,2,8,21,21,0,14
Universitate,1667,5,3,5,6,15,21,-6,14
FC Botosani,1667,6,3,4,7,6,17,-11,13
FCSB,1668,1,8,6,0,27,13,14,30
CFR Cluj,1668,2,5,6,3,17,13,4,21
Universitate,1668,3,4,6,4,18,21,-3,18
D Bucuresti,1668,4,4,4,6,19,19,0,16
FC Botosani,1668,5,4,4,6,6,15,-9,16
Concordia Ch,1668,6,3,2,9,16,22,-6,11
FCSB,1669,1,8,6,0,27,12,15,30
CFR Cluj,1669,2,5,8,1,15,9,6,23
D Bucuresti,1669,3,4,4,6,18,21,-3,16
FC Botosani,1669,4,4,4,6,8,15,-7,16
Universitate,1669,5,3,6,5,16,22,-6,15
Concordia Ch,1669,6,3,2,9,19,24,-5,11
FCSB,1670,1,8,5,1,25,12,13,29
CFR Cluj,1670,2,6,6,2,15,8,7,24
Universitate,1670,3,4,5,5,16,21,-5,17
FC Botosani,1670,4,4,4,6,9,16,-7,16
D Bucuresti,1670,5,3,5,6,18,21,-3,14
Concordia Ch,1670,6,3,3,8,19,24,-5,12
FCSB,1671,1,9,5,0,29,13,16,32
CFR Cluj,1671,2,5,6,3,17,13,4,21
Universitate,1671,3,4,5,5,16,21,-5,17
FC Botosani,1671,4,3,6,5,6,13,-7,15
D Bucuresti,1671,5,3,5,6,16,20,-4,14
Concordia Ch,1671,6,3,3,8,18,22,-4,12
FCSB,1672,1,8,5,1,26,12,14,29
CFR Cluj,1672,2,6,6,2,15,10,5,24
Universitate,1672,3,4,5,5,17,21,-4,17
D Bucuresti,1672,4,4,4,6,22,26,-4,16
FC Botosani,1672,5,4,4,6,12,17,-5,16
Concordia Ch,1672,6,3,2,9,21,27,-6,11
FCSB,1673,1,8,6,0,26,12,14,30
CFR Cluj,1673,2,5,8,1,16,10,6,23
D Bucuresti,1673,3,4,5,5,18,19,-1,17
Universitate,1673,4,3,6,5,15,20,-5,15
FC Botosani,1673,5,3,6,5,6,13,-7,15
Concordia Ch,1673,6,2,3,9,15,22,-7,9
FCSB,1674,1,8,6,0,24,10,14,30
CFR Cluj,1674,2,6,7,1,14,7,7,25
D Bucuresti,1674,3,4,4,6,20,21,-1,16
FC Botosani,1674,4,4,4,6,7,16,-9,16
Universitate,1674,5,3,5,6,14,20,-6,14
Concordia Ch,1674,6,3,2,9,19,24,-5,11
FCSB,1675,1,7,7,0,23,10,13,28
CFR Cluj,1675,2,5,7,2,15,10,5,22
Universitate,1675,3,4,6,4,17,20,-3,18
D Bucuresti,1675,4,4,5,5,19,20,-1,17
FC Botosani,1675,5,3,5,6,6,15,-9,14
Concordia Ch,1675,6,3,2,9,18,23,-5,11
FCSB,1676,1,9,5,0,27,11,16,32
CFR Cluj,1676,2,6,6,2,16,10,6,24
D Bucuresti,1676,3,3,6,5,16,18,-2,15
Universitate,1676,4,3,5,6,16,23,-7,14
FC Botosani,1676,5,3,5,6,6,16,-10,14
Concordia Ch,1676,6,3,3,8,19,22,-3,12
FCSB,1677,1,7,6,1,23,11,12,27
CFR Cluj,1677,2,7,6,1,16,8,8,27
D Bucuresti,1677,3,3,6,5,20,22,-2,15
Universitate,1677,4,3,6,5,15,20,-5,15
FC Botosani,1677,5,3,6,5,9,16,-7,15
Concordia Ch,1677,6,2,4,8,19,25,-6,10
FCSB,1678,1,8,5,1,26,13,13,29
CFR Cluj,1678,2,6,6,2,15,8,7,24
FC Botosani,1678,3,5,4,5,8,13,-5,19
Universitate,1678,4,4,5,5,17,22,-5,17
D Bucuresti,1678,5,3,4,7,17,21,-4,13
Concordia Ch,1678,6,3,2,9,18,24,-6,11
FCSB,1679,1,9,5,0,25,10,15,32
CFR Cluj,1679,2,6,6,2,16,9,7,24
FC Botosani,1679,3,4,5,5,9,13,-4,17
D Bucuresti,1679,4,3,5,6,16,19,-3,14
Universitate,1679,5,3,5,6,15,22,-7,14
Concordia Ch,1679,6,3,2,9,17,25,-8,11
FCSB,1680,1,7,6,1,24,12,12,27
CFR Cluj,1680,2,6,7,1,15,8,7,25
D Bucuresti,1680,3,5,4,5,21,20,1,19
Universitate,1680,4,3,7,4,16,20,-4,16
FC Botosani,1680,5,3,4,7,5,15,-10,13
Concordia Ch,1680,6,3,2,9,18,24,-6,11
FCSB,1681,1,7,6,1,23,11,12,27
CFR Cluj,1681,2,7,6,1,15,7,8,27
D Bucuresti,1681,3,4,5,5,19,19,0,17
FC Botosani,1681,4,4,5,5,6,12,-6,17
Universitate,1681,5,3,6,5,14,19,-5,15
Concordia Ch,1681,6,2,2,10,16,25,-9,8
FCSB,1682,1,8,5,1,26,11,15,29
CFR Cluj,1682,2,6,6,2,14,9,5,24
Universitate,1682,3,4,5,5,16,21,-5,17
D Bucuresti,1682,4,4,4,6,21,23,-2,16
Concordia Ch,1682,5,4,2,8,19,23,-4,14
FC Botosani,1682,6,3,4,7,9,18,-9,13
FCSB,1683,1,8,5,1,25,14,11,29
CFR Cluj,1683,2,5,6,3,13,9,4,21
Universitate,1683,3,5,5,4,19,19,0,20
D Bucuresti,1683,4,4,4,6,17,19,-2,16
FC Botosani,1683,5,3,5,6,5,13,-8,14
Concordia Ch,1683,6,3,3,8,16,21,-5,12
FCSB,1684,1,7,7,0,24,11,13,28
CFR Cluj,1684,2,5,8,1,15,9,6,23
D Bucuresti,1684,3,5,4,5,18,18,0,19
Universitate,1684,4,3,7,4,17,21,-4,16
FC Botosani,1684,5,3,4,7,6,17,-11,13
Concordia Ch,1684,6,3,2,9,19,23,-4,11
FCSB,1685,1,8,6,0,25,11,14,30
CFR Cluj,1685,2,5,7,2,14,9,5,22
FC Botosani,1685,3,5,4,5,8,13,-5,19
Universitate,1685,4,3,7,4,16,20,-4,16
D Bucuresti,1685,5,3,5,6,17,20,-3,14
Concordia Ch,1685,6,2,3,9,17,24,-7,9
FCSB,1686,1,7,7,0,25,12,13,28
CFR Cluj,1686,2,5,7,2,14,9,5,22
Universitate,1686,3,4,6,4,16,19,-3,18
FC Botosani,1686,4,4,5,5,8,14,-6,17
D Bucuresti,1686,5,3,5,6,17,20,-3,14
Concordia Ch,1686,6,3,2,9,17,23,-6,11
FCSB,1687,1,7,6,1,23,13,10,27
CFR Cluj,1687,2,6,7,1,16,8,8,25
D Bucuresti,1687,3,5,4,5,20,20,0,19
Universitate,1687,4,4,5,5,18,21,-3,17
FC Botosani,1687,5,4,4,6,7,14,-7,16
Concordia Ch,1687,6,2,2,10,16,24,-8,8
CFR Cluj,1688,1,7,6,1,19,7,12,27
FCSB,1688,2,7,5,2,23,14,9,26
D Bucuresti,1688,3,5,4,5,20,18,2,19
Universitate,1688,4,4,5,5,15,21,-6,17
FC Botosani,1688,5,3,5,6,5,14,-9,14
Concordia Ch,1688,6,2,3,9,15,23,-8,9
CFR Cluj,1689,1,7,6,1,15,7,8,27
FCSB,1689,2,7,5,2,23,14,9,26
Universitate,1689,3,4,5,5,17,19,-2,17
FC Botosani,1689,4,4,5,5,7,12,-5,17
D Bucuresti,1689,5,3,6,5,16,18,-2,15
Concordia Ch,1689,6,2,3,9,15,23,-8,9
FCSB,1690,1,8,6,0,24,10,14,30
CFR Cluj,1690,2,5,7,2,14,9,5,22
Universitate,1690,3,3,7,4,15,19,-4,16
D Bucuresti,1690,4,3,5,6,17,20,-3,14
Concordia Ch,1690,5,4,2,8,18,22,-4,14
FC Botosani,1690,6,3,5,6,7,15,-8,14
FCSB,1691,1,8,6,0,26,11,15,30
CFR Cluj,1691,2,6,6,2,17,9,8,24
D Bucuresti,1691,3,4,5,5,17,18,-1,17
Universitate,1691,4,3,6,5,15,23,-8,15
FC Botosani,1691,5,3,5,6,8,16,-8,14
Concordia Ch,1691,6,2,4,8,18,24,-6,10
FCSB,1692,1,9,5,0,25,10,15,32
CFR Cluj,1692,2,5,6,3,13,10,3,21
FC Botosani,1692,3,5,4,5,8,12,-4,19
Universitate,1692,4,4,5,5,16,19,-3,17
D Bucuresti,1692,5,3,4,7,16,20,-4,13
Concordia Ch,1692,6,3,2,9,16,23,-7,11
FCSB,1693,1,9,5,0,27,11,16,32
CFR Cluj,1693,2,6,6,2,18,11,7,24
D Bucuresti,1693,3,5,4,5,20,19,1,19
Universitate,1693,4,3,5,6,15,23,-8,14
FC Botosani,1693,5,3,5,6,6,15,-9,14
Concordia Ch,1693,6,2,3,9,17,24,-7,9
FCSB,1694,1,8,6,0,28,12,16,30
CFR Cluj,1694,2,6,7,1,16,9,7,25
D Bucuresti,1694,3,4,4,6,19,20,-1,16
FC Botosani,1694,4,4,4,6,6,14,-8,16
Universitate,1694,5,3,5,6,14,22,-8,14
Concordia Ch,1694,6,3,2,9,17,23,-6,11
CFR Cluj,1695,1,7,6,1,16,7,9,27
FCSB,1695,2,7,5,2,24,13,11,26
Universitate,1695,3,4,5,5,16,21,-5,17
FC Botosani,1695,4,3,6,5,7,14,-7,15
D Bucuresti,1695,5,3,5,6,17,21,-4,14
Concordia Ch,1695,6,3,3,8,18,22,-4,12
FCSB,1696,1,8,5,1,24,11,13,29
CFR Cluj,1696,2,6,6,2,14,8,6,24
Universitate,1696,3,4,5,5,15,19,-4,17
FC Botosani,1696,4,3,6,5,5,12,-7,15
D Bucuresti,1696,5,3,5,6,17,21,-4,14
Concordia Ch,1696,6,3,3,8,18,22,-4,12
FCSB,1697,1,7,6,1,29,20,9,27
CFR Cluj,1697,2,6,7,1,18,8,10,25
D Bucuresti,1697,3,4,4,6,19,19,0,16
Universitate,1697,4,3,7,4,21,25,-4,16
Concordia Ch,1697,5,4,2,8,17,21,-4,14
FC Botosani,1697,6,3,4,7,5,16,-11,13
FCSB,1698,1,8,6,0,26,12,14,30
CFR Cluj,1698,2,6,6,2,16,9,7,24
FC Botosani,1698,3,5,4,5,8,12,-4,19
Universitate,1698,4,3,6,5,15,21,-6,15
D Bucuresti,1698,5,3,4,7,16,20,-4,13
Concordia Ch,1698,6,3,2,9,16,23,-7,11
FCSB,1699,1,7,6,1,25,13,12,27
CFR Cluj,1699,2,6,7,1,16,8,8,25
Universitate,1699,3,4,5,5,16,21,-5,17
D Bucuresti,1699,4,4,4,6,18,20,-2,16
FC Botosani,1699,5,3,5,6,5,14,-9,14
Concordia Ch,1699,6,3,3,8,17,21,-4,12
FCSB,1700,1,9,5,0,29,13,16,32
CFR Cluj,1700,2,6,6,2,17,11,6,24
D Bucuresti,1700,3,5,4,5,22,20,2,19
FC Botosani,1700,4,4,4,6,7,14,-7,16
Universitate,1700,5,3,5,6,16,23,-7,14
Concordia Ch,1700,6,2,2,10,18,28,-10,8
FCSB,1701,1,9,5,0,27,11,16,32
CFR Cluj,1701,2,6,6,2,15,8,7,24
D Bucuresti,1701,3,5,4,5,20,19,1,19
FC Botosani,1701,4,4,4,6,7,15,-8,16
Universitate,1701,5,3,5,6,15,23,-8,14
Concordia Ch,1701,6,2,2,10,17,25,-8,8
FCSB,1702,1,8,6,0,25,11,14,30
CFR Cluj,1702,2,5,7,2,14,10,4,22
Universitate,1702,3,4,5,5,18,21,-3,17
FC Botosani,1702,4,4,5,5,7,12,-5,17
D Bucuresti,1702,5,3,6,5,16,18,-2,15
Concordia Ch,1702,6,2,3,9,15,23,-8,9
FCSB,1703,1,9,5,0,27,11,16,32
CFR Cluj,1703,2,6,6,2,16,9,7,24
D Bucuresti,1703,3,3,5,6,19,22,-3,14
Concordia Ch,1703,4,4,2,8,19,23,-4,14
Universitate,1703,5,3,5,6,15,23,-8,14
FC Botosani,1703,6,3,5,6,6,14,-8,14
FCSB,1704,1,8,6,0,27,13,14,30
CFR Cluj,1704,2,6,7,1,19,11,8,25
D Bucuresti,1704,3,4,4,6,19,21,-2,16
FC Botosani,1704,4,4,4,6,7,16,-9,16
Universitate,1704,5,3,5,6,15,22,-7,14
Concordia Ch,1704,6,3,2,9,19,23,-4,11
CFR Cluj,1705,1,7,6,1,16,8,8,27
FCSB,1705,2,7,5,2,23,14,9,26
Universitate,1705,3,4,5,5,18,20,-2,17
D Bucuresti,1705,4,4,4,6,18,21,-3,16
FC Botosani,1705,5,3,5,6,6,14,-8,14
Concordia Ch,1705,6,3,3,8,19,23,-4,12
FCSB,1706,1,8,5,1,25,13,12,29
CFR Cluj,1706,2,7,6,1,18,8,10,27
FC Botosani,1706,3,4,5,5,9,14,-5,17
D Bucuresti,1706,4,4,4,6,20,20,0,16
Universitate,1706,5,3,5,6,14,21,-7,14
Concordia Ch,1706,6,2,3,9,17,27,-10,9
CFR Cluj,1707,1,7,6,1,19,9,10,27
FCSB,1707,2,7,5,2,25,15,10,26
Universitate,1707,3,4,5,5,16,21,-5,17
FC Botosani,1707,4,4,5,5,7,12,-5,17
D Bucuresti,1707,5,4,4,6,18,21,-3,16
Concordia Ch,1707,6,2,3,9,16,23,-7,9
FCSB,1708,1,8,5,1,26,13,13,29
CFR Cluj,1708,2,6,6,2,14,9,5,24
D Bucuresti,1708,3,4,5,5,20,21,-1,17
Universitate,1708,4,4,5,5,17,20,-3,17
FC Botosani,1708,5,4,5,5,8,14,-6,17
Concordia Ch,1708,6,2,2,10,16,24,-8,8
FCSB,1709,1,7,6,1,25,13,12,27
CFR Cluj,1709,2,7,6,1,18,9,9,27
D Bucuresti,1709,3,4,4,6,18,20,-2,16
Universitate,1709,4,3,6,5,16,22,-6,15
FC Botosani,1709,5,3,5,6,5,14,-9,14
Concordia Ch,1709,6,3,3,8,17,21,-4,12
FCSB,1710,1,9,5,0,27,12,15,32
CFR Cluj,1710,2,5,7,2,15,10,5,22
FC Botosani,1710,3,4,5,5,8,14,-6,17
Universitate,1710,4,3,6,5,16,21,-5,15
D Bucuresti,1710,5,3,5,6,18,21,-3,14
Concordia Ch,1710,6,2,4,8,17,23,-6,10
FCSB,1711,1,8,6,0,27,12,15,30
CFR Cluj,1711,2,6,7,1,17,9,8,25
FC Botosani,1711,3,3,6,5,6,13,-7,15
D Bucuresti,1711,4,3,5,6,19,23,-4,14
Universitate,1711,5,3,5,6,14,22,-8,14
Concordia Ch,1711,6,3,3,8,19,23,-4,12
FCSB,1712,1,8,6,0,26,12,14,30
CFR Cluj,1712,2,5,6,3,14,10,4,21
FC Botosani,1712,3,5,4,5,11,14,-3,19
Universitate,1712,4,4,6,4,16,19,-3,18
D Bucuresti,1712,5,3,4,7,17,23,-6,13
Concordia Ch,1712,6,3,2,9,19,25,-6,11
FCSB,1713,1,9,5,0,31,16,15,32
CFR Cluj,1713,2,5,7,2,16,11,5,22
D Bucuresti,1713,3,4,5,5,21,22,-1,17
Universitate,1713,4,3,6,5,19,24,-5,15
FC Botosani,1713,5,3,5,6,10,18,-8,14
Concordia Ch,1713,6,2,4,8,18,24,-6,10
FCSB,1714,1,8,6,0,25,11,14,30
CFR Cluj,1714,2,5,6,3,13,9,4,21
D Bucuresti,1714,3,5,4,5,21,21,0,19
Universitate,1714,4,4,6,4,16,19,-3,18
FC Botosani,1714,5,3,5,6,7,15,-8,14
Concordia Ch,1714,6,2,3,9,20,27,-7,9
FCSB,1715,1,8,6,0,26,10,16,30
CFR Cluj,1715,2,5,8,1,14,8,6,23
D Bucuresti,1715,3,4,4,6,17,19,-2,16
Universitate,1715,4,3,6,5,15,22,-7,15
FC Botosani,1715,5,3,5,6,5,13,-8,14
Concordia Ch,1715,6,3,3,8,16,21,-5,12
FCSB,1716,1,7,6,1,26,15,11,27
CFR Cluj,1716,2,6,7,1,15,8,7,25
FC Botosani,1716,3,5,4,5,7,12,-5,19
Universitate,1716,4,4,5,5,18,21,-3,17
D Bucuresti,1716,5,3,5,6,19,22,-3,14
Concordia Ch,1716,6,2,3,9,18,25,-7,9
FCSB,1717,1,8,6,0,26,12,14,30
CFR Cluj,1717,2,5,8,1,14,8,6,23
D Bucuresti,1717,3,5,4,5,24,18,6,19
FC Botosani,1717,4,4,4,6,7,17,-10,16
Universitate,1717,5,3,6,5,15,20,-5,15
Concordia Ch,1717,6,2,2,10,15,26,-11,8
FCSB,1718,1,9,5,0,27,10,17,32
CFR Cluj,1718,2,5,7,2,14,10,4,22
D Bucuresti,1718,3,5,4,5,21,20,1,19
FC Botosani,1718,4,4,4,6,8,14,-6,16
Universitate,1718,5,3,6,5,15,21,-6,15
Concordia Ch,1718,6,2,2,10,18,28,-10,8
FCSB,1719,1,9,5,0,26,11,15,32
CFR Cluj,1719,2,5,7,2,16,11,5,22
D Bucuresti,1719,3,4,4,6,19,21,-2,16
Universitate,1719,4,3,6,5,16,21,-5,15
FC Botosani,1719,5,3,5,6,7,15,-8,14
Concordia Ch,1719,6,3,3,8,16,21,-5,12
FCSB,1720,1,8,6,0,26,11,15,30
CFR Cluj,1720,2,6,7,1,17,9,8,25
FC Botosani,1720,3,4,5,5,9,13,-4,17
D Bucuresti,1720,4,3,5,6,18,23,-5,14
Universitate,1720,5,3,5,6,15,23,-8,14
Concordia Ch,1720,6,3,2,9,19,25,-6,11
FCSB,1721,1,7,7,0,23,10,13,28
CFR Cluj,1721,2,6,7,1,15,8,7,25
D Bucuresti,1721,3,5,4,5,21,19,2,19
Universitate,1721,4,3,6,5,15,20,-5,15
FC Botosani,1721,5,3,5,6,7,15,-8,14
Concordia Ch,1721,6,2,3,9,16,25,-9,9
FCSB,1722,1,8,6,0,26,12,14,30
CFR Cluj,1722,2,6,7,1,18,9,9,25
FC Botosani,1722,3,4,5,5,6,12,-6,17
D Bucuresti,1722,4,3,5,6,17,20,-3,14
Universitate,1722,5,3,5,6,14,22,-8,14
Concordia Ch,1722,6,3,2,9,17,23,-6,11
FCSB,1723,1,7,6,1,23,12,11,27
CFR Cluj,1723,2,7,6,1,17,7,10,27
D Bucuresti,1723,3,4,4,6,18,20,-2,16
FC Botosani,1723,4,4,4,6,7,14,-7,16
Universitate,1723,5,3,6,5,14,20,-6,15
Concordia Ch,1723,6,3,2,9,17,23,-6,11
FCSB,1724,1,8,5,1,24,11,13,29
CFR Cluj,1724,2,5,6,3,14,13,1,21
Universitate,1724,3,5,5,4,20,19,1,20
D Bucuresti,1724,4,4,5,5,18,18,0,17
FC Botosani,1724,5,3,5,6,6,15,-9,14
Concordia Ch,1724,6,2,4,8,16,22,-6,10
FCSB,1725,1,8,5,1,27,13,14,29
CFR Cluj,1725,2,6,6,2,15,11,4,24
Universitate,1725,3,4,5,5,18,21,-3,17
FC Botosani,1725,4,4,5,5,9,13,-4,17
D Bucuresti,1725,5,4,4,6,20,22,-2,16
Concordia Ch,1725,6,2,3,9,17,26,-9,9
FCSB,1726,1,9,5,0,26,11,15,32
CFR Cluj,1726,2,5,7,2,14,9,5,22
FC Botosani,1726,3,4,4,6,8,16,-8,16
Universitate,1726,4,3,6,5,14,19,-5,15
Concordia Ch,1726,5,4,2,8,21,23,-2,14
D Bucuresti,1726,6,3,4,7,18,23,-5,13
FCSB,1727,1,8,5,1,26,11,15,29
CFR Cluj,1727,2,7,6,1,16,7,9,27
D Bucuresti,1727,3,3,6,5,16,18,-2,15
Universitate,1727,4,3,5,6,14,23,-9,14
FC Botosani,1727,5,3,5,6,5,15,-10,14
Concordia Ch,1727,6,3,3,8,18,21,-3,12
FCSB,1728,1,8,6,0,26,11,15,30
CFR Cluj,1728,2,5,7,2,14,9,5,22
FC Botosani,1728,3,5,4,5,7,12,-5,19
Universitate,1728,4,4,5,5,15,20,-5,17
D Bucuresti,1728,5,3,4,7,17,22,-5,13
Concordia Ch,1728,6,3,2,9,18,23,-5,11
FCSB,1729,1,8,5,1,25,12,13,29
CFR Cluj,1729,2,5,7,2,14,9,5,22
Universitate,1729,3,4,6,4,15,18,-3,18
D Bucuresti,1729,4,4,4,6,17,19,-2,16
FC Botosani,1729,5,4,4,6,7,15,-8,16
Concordia Ch,1729,6,3,2,9,18,23,-5,11
FCSB,1730,1,9,5,0,27,11,16,32
CFR Cluj,1730,2,6,6,2,16,11,5,24
D Bucuresti,1730,3,5,4,5,23,20,3,19
Universitate,1730,4,3,5,6,17,23,-6,14
FC Botosani,1730,5,3,4,7,6,17,-11,13
Concordia Ch,1730,6,3,2,9,17,24,-7,11
FCSB,1731,1,9,5,0,25,10,15,32
CFR Cluj,1731,2,5,7,2,13,8,5,22
FC Botosani,1731,3,4,5,5,6,12,-6,17
D Bucuresti,1731,4,3,6,5,17,19,-2,15
Universitate,1731,5,3,6,5,14,19,-5,15
Concordia Ch,1731,6,2,3,9,16,23,-7,9
FCSB,1732,1,9,5,0,28,10,18,32
CFR Cluj,1732,2,5,6,3,13,11,2,21
Universitate,1732,3,4,5,5,16,21,-5,17
FC Botosani,1732,4,4,5,5,7,13,-6,17
D Bucuresti,1732,5,3,5,6,18,22,-4,14
Concordia Ch,1732,6,3,2,9,18,23,-5,11
FCSB,1733,1,8,6,0,24,10,14,30
CFR Cluj,1733,2,6,7,1,15,8,7,25
D Bucuresti,1733,3,5,4,5,21,21,0,19
FC Botosani,1733,4,4,4,6,8,13,-5,16
Universitate,1733,5,3,5,6,15,21,-6,14
Concordia Ch,1733,6,2,2,10,18,28,-10,8
FCSB,1734,1,7,7,0,24,11,13,28
CFR Cluj,1734,2,6,7,1,15,7,8,25
D Bucuresti,1734,3,5,4,5,19,19,0,19
FC Botosani,1734,4,4,4,6,7,13,-6,16
Universitate,1734,5,3,6,5,15,21,-6,15
Concordia Ch,1734,6,2,2,10,16,25,-9,8
FCSB,1735,1,8,5,1,25,12,13,29
CFR Cluj,1735,2,6,7,1,15,8,7,25
D Bucuresti,1735,3,4,5,5,19,19,0,17
Universitate,1735,4,3,6,5,16,21,-5,15
FC Botosani,1735,5,3,4,7,5,15,-10,13
Concordia Ch,1735,6,3,3,8,17,22,-5,12
FCSB,1736,1,7,7,0,25,12,13,28
CFR Cluj,1736,2,5,7,2,14,10,4,22
D Bucuresti,1736,3,5,4,5,21,20,1,19
Universitate,1736,4,4,6,4,17,19,-2,18
FC Botosani,1736,5,3,4,7,7,19,-12,13
Concordia Ch,1736,6,3,2,9,20,24,-4,11
FCSB,1737,1,8,5,1,25,13,12,29
CFR Cluj,1737,2,7,6,1,16,7,9,27
D Bucuresti,1737,3,4,4,6,19,20,-1,16
Concordia Ch,1737,4,4,2,8,19,22,-3,14
Universitate,1737,5,3,5,6,15,21,-6,14
FC Botosani,1737,6,3,4,7,7,18,-11,13
FCSB,1738,1,9,5,0,29,12,17,32
CFR Cluj,1738,2,6,6,2,15,11,4,24
D Bucuresti,1738,3,4,5,5,18,19,-1,17
FC Botosani,1738,4,3,6,5,5,12,-7,15
Universitate,1738,5,3,5,6,17,23,-6,14
Concordia Ch,1738,6,2,3,9,16,23,-7,9
CFR Cluj,1739,1,7,6,1,17,8,9,27
FCSB,1739,2,7,5,2,24,15,9,26
FC Botosani,1739,3,5,4,5,8,13,-5,19
Universitate,1739,4,4,5,5,16,19,-3,17
D Bucuresti,1739,5,3,5,6,16,19,-3,14
Concordia Ch,1739,6,2,3,9,16,23,-7,9
FCSB,1740,1,9,5,0,26,11,15,32
CFR Cluj,1740,2,6,6,2,14,8,6,24
FC Botosani,1740,3,4,5,5,7,13,-6,17
D Bucuresti,1740,4,3,5,6,18,21,-3,14
Universitate,1740,5,3,5,6,15,21,-6,14
Concordia Ch,1740,6,2,4,8,16,22,-6,10
FCSB,1741,1,7,5,2,24,15,9,26
CFR Cluj,1741,2,6,7,1,16,8,8,25
Universitate,1741,3,4,6,4,18,20,-2,18
FC Botosani,1741,4,4,5,5,9,15,-6,17
D Bucuresti,1741,5,3,4,7,17,21,-4,13
Concordia Ch,1741,6,3,3,8,20,25,-5,12
FCSB,1742,1,8,5,1,24,11,13,29
CFR Cluj,1742,2,5,7,2,14,9,5,22
Universitate,1742,3,4,6,4,16,19,-3,18
FC Botosani,1742,4,3,6,5,5,12,-7,15
D Bucuresti,1742,5,3,5,6,16,19,-3,14
Concordia Ch,1742,6,3,3,8,16,21,-5,12
FCSB,1743,1,7,6,1,27,15,12,27
CFR Cluj,1743,2,5,8,1,14,8,6,23
Universitate,1743,3,4,6,4,18,21,-3,18
FC Botosani,1743,4,4,5,5,7,13,-6,17
D Bucuresti,1743,5,3,6,5,19,21,-2,15
Concordia Ch,1743,6,2,3,9,17,24,-7,9
FCSB,1744,1,7,6,1,24,15,9,27
CFR Cluj,1744,2,5,8,1,13,7,6,23
Universitate,1744,3,4,6,4,19,19,0,18
D Bucuresti,1744,4,4,4,6,19,21,-2,16
FC Botosani,1744,5,4,4,6,9,15,-6,16
Concordia Ch,1744,6,3,2,9,17,24,-7,11
FCSB,1745,1,8,6,0,25,11,14,30
CFR Cluj,1745,2,5,6,3,14,10,4,21
Universitate,1745,3,4,6,4,15,18,-3,18
D Bucuresti,1745,4,4,4,6,18,21,-3,16
FC Botosani,1745,5,4,4,6,7,13,-6,16
Concordia Ch,1745,6,3,2,9,18,24,-6,11
FCSB,1746,1,8,6,0,25,11,14,30
CFR Cluj,1746,2,5,7,2,13,8,5,22
D Bucuresti,1746,3,4,5,5,18,18,0,17
Universitate,1746,4,4,5,5,16,20,-4,17
FC Botosani,1746,5,4,4,6,6,14,-8,16
Concordia Ch,1746,6,2,3,9,15,22,-7,9
FCSB,1747,1,8,6,0,28,13,15,30
CFR Cluj,1747,2,6,6,2,17,11,6,24
Universitate,1747,3,3,6,5,15,21,-6,15
Concordia Ch,1747,4,4,2,8,19,21,-2,14
D Bucuresti,1747,5,3,5,6,17,22,-5,14
FC Botosani,1747,6,3,5,6,6,14,-8,14
FCSB,1748,1,8,6,0,27,13,14,30
CFR Cluj,1748,2,6,6,2,16,9,7,24
D Bucuresti,1748,3,4,5,5,19,20,-1,17
FC Botosani,1748,4,4,4,6,8,13,-5,16
Universitate,1748,5,3,6,5,16,22,-6,15
Concordia Ch,1748,6,2,3,9,17,26,-9,9
FCSB,1749,1,7,5,2,23,14,9,26
CFR Cluj,1749,2,6,6,2,15,8,7,24
Universitate,1749,3,5,5,4,17,18,-1,20
D Bucuresti,1749,4,4,5,5,20,20,0,17
FC Botosani,1749,5,4,4,6,9,15,-6,16
Concordia Ch,1749,6,2,3,9,16,25,-9,9
FCSB,1750,1,8,5,1,26,14,12,29
CFR Cluj,1750,2,5,6,3,14,10,4,21
Universitate,1750,3,5,5,4,18,19,-1,20
D Bucuresti,1750,4,4,4,6,20,20,0,16
Concordia Ch,1750,5,4,2,8,18,22,-4,14
FC Botosani,1750,6,3,4,7,5,16,-11,13
FCSB,1751,1,7,6,1,25,14,11,27
CFR Cluj,1751,2,5,8,1,14,8,6,23
Universitate,1751,3,4,6,4,17,19,-2,18
FC Botosani,1751,4,4,4,6,6,13,-7,16
D Bucuresti,1751,5,3,5,6,16,19,-3,14
Concordia Ch,1751,6,3,3,8,16,21,-5,12
FCSB,1752,1,9,5,0,28,13,15,32
CFR Cluj,1752,2,5,6,3,14,10,4,21
Universitate,1752,3,4,5,5,17,21,-4,17
D Bucuresti,1752,4,4,4,6,19,22,-3,16
FC Botosani,1752,5,4,4,6,8,14,-6,16
Concordia Ch,1752,6,3,2,9,18,24,-6,11
FCSB,1753,1,7,7,0,25,12,13,28
CFR Cluj,1753,2,6,7,1,16,8,8,25
D Bucuresti,1753,3,4,4,6,21,24,-3,16
Universitate,1753,4,3,6,5,15,21,-6,15
Concordia Ch,1753,5,4,2,8,21,22,-1,14
FC Botosani,1753,6,3,4,7,6,17,-11,13
FCSB,1754,1,9,5,0,29,11,18,32
CFR Cluj,1754,2,5,7,2,16,11,5,22
FC Botosani,1754,3,4,4,6,8,16,-8,16
Universitate,1754,4,3,6,5,16,24,-8,15
Concordia Ch,1754,5,4,2,8,19,22,-3,14
D Bucuresti,1754,6,3,4,7,19,23,-4,13
FCSB,1755,1,7,6,1,25,14,11,27
CFR Cluj,1755,2,5,8,1,16,10,6,23
Universitate,1755,3,4,6,4,17,19,-2,18
D Bucuresti,1755,4,3,6,5,17,19,-2,15
FC Botosani,1755,5,3,6,5,7,14,-7,15
Concordia Ch,1755,6,2,4,8,16,22,-6,10
FCSB,1756,1,7,7,0,24,11,13,28
CFR Cluj,1756,2,5,7,2,15,10,5,22
Universitate,1756,3,4,6,4,16,19,-3,18
D Bucuresti,1756,4,3,5,6,19,22,-3,14
Concordia Ch,1756,5,4,2,8,19,23,-4,14
FC Botosani,1756,6,3,5,6,6,14,-8,14
FCSB,1757,1,7,5,2,24,13,11,26
CFR Cluj,1757,2,6,7,1,14,7,7,25
Universitate,1757,3,4,6,4,16,19,-3,18
D Bucuresti,1757,4,4,5,5,18,19,-1,17
FC Botosani,1757,5,3,5,6,6,15,-9,14
Concordia Ch,1757,6,3,2,9,17,22,-5,11
FCSB,1758,1,7,7,0,24,11,13,28
CFR Cluj,1758,2,5,8,1,14,8,6,23
FC Botosani,1758,3,5,4,5,9,13,-4,19
Universitate,1758,4,3,7,4,16,20,-4,16
D Bucuresti,1758,5,3,4,7,18,24,-6,13
Concordia Ch,1758,6,3,2,9,18,23,-5,11
FCSB,1759,1,8,6,0,25,11,14,30
CFR Cluj,1759,2,6,6,2,15,9,6,24
D Bucuresti,1759,3,4,5,5,17,18,-1,17
FC Botosani,1759,4,4,4,6,8,15,-7,16
Universitate,1759,5,3,6,5,16,21,-5,15
Concordia Ch,1759,6,2,3,9,17,24,-7,9
FCSB,1760,1,8,6,0,26,11,15,30
CFR Cluj,1760,2,6,6,2,15,10,5,24
FC Botosani,1760,3,4,5,5,7,13,-6,17
Universitate,1760,4,3,6,5,16,21,-5,15
D Bucuresti,1760,5,3,5,6,17,20,-3,14
Concordia Ch,1760,6,3,2,9,16,22,-6,11
CFR Cluj,1761,1,7,6,1,16,8,8,27
FCSB,1761,2,7,5,2,25,14,11,26
D Bucuresti,1761,3,4,5,5,21,22,-1,17
Universitate,1761,4,4,5,5,16,20,-4,17
FC Botosani,1761,5,3,4,7,7,16,-9,13
Concordia Ch,1761,6,3,3,8,18,23,-5,12
FCSB,1762,1,9,5,0,32,12,20,32
CFR Cluj,1762,2,5,7,2,16,13,3,22
D Bucuresti,1762,3,4,5,5,17,18,-1,17
FC Botosani,1762,4,4,4,6,7,14,-7,16
Universitate,1762,5,3,6,5,15,23,-8,15
Concordia Ch,1762,6,2,3,9,16,23,-7,9
CFR Cluj,1763,1,7,6,1,16,7,9,27
FCSB,1763,2,7,5,2,23,13,10,26
Universitate,1763,3,4,5,5,16,20,-4,17
FC Botosani,1763,4,4,5,5,10,16,-6,17
D Bucuresti,1763,5,3,6,5,19,21,-2,15
Concordia Ch,1763,6,2,3,9,18,25,-7,9
FCSB,1764,1,9,5,0,28,12,16,32
CFR Cluj,1764,2,5,7,2,14,10,4,22
D Bucuresti,1764,3,5,4,5,21,20,1,19
FC Botosani,1764,4,4,4,6,8,15,-7,16
Universitate,1764,5,3,6,5,17,22,-5,15
Concordia Ch,1764,6,2,2,10,15,24,-9,8
FCSB,1765,1,8,6,0,25,11,14,30
CFR Cluj,1765,2,5,7,2,13,8,5,22
D Bucuresti,1765,3,4,5,5,19,19,0,17
Universitate,1765,4,3,7,4,15,19,-4,16
FC Botosani,1765,5,3,5,6,7,16,-9,14
Concordia Ch,1765,6,2,4,8,18,24,-6,10
FCSB,1766,1,7,6,1,23,11,12,27
CFR Cluj,1766,2,6,7,1,17,10,7,25
Universitate,1766,3,3,7,4,17,21,-4,16
D Bucuresti,1766,4,3,5,6,18,21,-3,14
Concordia Ch,1766,5,4,2,8,17,21,-4,14
FC Botosani,1766,6,3,5,6,7,15,-8,14
FCSB,1767,1,8,6,0,27,13,14,30
CFR Cluj,1767,2,6,7,1,17,9,8,25
FC Botosani,1767,3,5,4,5,9,12,-3,19
D Bucuresti,1767,4,4,4,6,21,24,-3,16
Universitate,1767,5,3,5,6,15,22,-7,14
Concordia Ch,1767,6,2,2,10,18,27,-9,8
FCSB,1768,1,8,6,0,26,12,14,30
CFR Cluj,1768,2,5,6,3,14,10,4,21
Universitate,1768,3,4,6,4,16,19,-3,18
D Bucuresti,1768,4,4,5,5,22,20,2,17
FC Botosani,1768,5,4,4,6,7,17,-10,16
Concordia Ch,1768,6,2,3,9,18,25,-7,9
FCSB,1769,1,8,5,1,28,13,15,29
CFR Cluj,1769,2,7,6,1,18,10,8,27
FC Botosani,1769,3,4,5,5,8,13,-5,17
D Bucuresti,1769,4,3,5,6,18,22,-4,14
Universitate,1769,5,3,5,6,17,25,-8,14
Concordia Ch,1769,6,3,2,9,18,24,-6,11
FCSB,1770,1,7,7,0,24,11,13,28
CFR Cluj,1770,2,6,7,1,15,8,7,25
FC Botosani,1770,3,4,4,6,8,16,-8,16
Universitate,1770,4,3,6,5,14,19,-5,15
Concordia Ch,1770,5,4,2,8,21,21,0,14
D Bucuresti,1770,6,3,4,7,17,24,-7,13
FCSB,1771,1,7,6,1,25,13,12,27
CFR Cluj,1771,2,6,6,2,14,9,5,24
Universitate,1771,3,4,6,4,18,20,-2,18
D Bucuresti,1771,4,4,4,6,18,21,-3,16
FC Botosani,1771,5,3,5,6,6,15,-9,14
Concordia Ch,1771,6,3,3,8,19,22,-3,12
FCSB,1772,1,7,6,1,24,13,11,27
CFR Cluj,1772,2,6,7,1,17,8,9,25
Universitate,1772,3,4,5,5,16,21,-5,17
D Bucuresti,1772,4,3,6,5,18,20,-2,15
FC Botosani,1772,5,3,5,6,6,16,-10,14
Concordia Ch,1772,6,3,3,8,19,22,-3,12
FCSB,1773,1,7,5,2,23,17,6,26
CFR Cluj,1773,2,6,7,1,17,7,10,25
Universitate,1773,3,4,6,4,17,18,-1,18
D Bucuresti,1773,4,4,4,6,18,20,-2,16
FC Botosani,1773,5,4,4,6,7,13,-6,16
Concordia Ch,1773,6,3,2,9,17,24,-7,11
FCSB,1774,1,9,5,0,29,13,16,32
CFR Cluj,1774,2,6,6,2,17,11,6,24
FC Botosani,1774,3,4,4,6,7,14,-7,16
Concordia Ch,1774,4,4,2,8,18,21,-3,14
Universitate,1774,5,3,5,6,17,24,-7,14
D Bucuresti,1774,6,3,4,7,16,21,-5,13
FCSB,1775,1,9,5,0,27,12,15,32
CFR Cluj,1775,2,5,7,2,14,9,5,22
D Bucuresti,1775,3,4,4,6,19,19,0,16
FC Botosani,1775,4,4,4,6,8,16,-8,16
Universitate,1775,5,3,6,5,17,22,-5,15
Concordia Ch,1775,6,3,2,9,17,24,-7,11
FCSB,1776,1,8,5,1,26,12,14,29
CFR Cluj,1776,2,7,6,1,16,8,8,27
FC Botosani,1776,3,4,5,5,9,14,-5,17
D Bucuresti,1776,4,3,5,6,19,23,-4,14
Universitate,1776,5,3,5,6,16,23,-7,14
Concordia Ch,1776,6,2,4,8,16,22,-6,10
FCSB,1777,1,8,6,0,27,13,14,30
CFR Cluj,1777,2,5,6,3,15,11,4,21
Universitate,1777,3,4,6,4,16,19,-3,18
D Bucuresti,1777,4,4,4,6,20,23,-3,16
FC Botosani,1777,5,4,4,6,8,14,-6,16
Concordia Ch,1777,6,3,2,9,18,24,-6,11
FCSB,1778,1,8,6,0,24,10,14,30
CFR Cluj,1778,2,6,7,1,14,7,7,25
D Bucuresti,1778,3,4,5,5,19,20,-1,17
FC Botosani,1778,4,3,6,5,7,14,-7,15
Universitate,1778,5,3,5,6,14,20,-6,14
Concordia Ch,1778,6,2,3,9,17,24,-7,9
FCSB,1779,1,9,5,0,30,14,16,32
CFR Cluj,1779,2,5,7,2,14,10,4,22
D Bucuresti,1779,3,5,4,5,19,18,1,19
Universitate,1779,4,3,6,5,17,22,-5,15
FC Botosani,1779,5,3,4,7,5,16,-11,13
Concordia Ch,1779,6,3,2,9,17,22,-5,11
FCSB,1780,1,8,5,1,25,11,14,29
CFR Cluj,1780,2,6,7,1,15,8,7,25
FC Botosani,1780,3,4,5,5,7,13,-6,17
Universitate,1780,4,3,6,5,15,21,-6,15
D Bucuresti,1780,5,3,5,6,16,19,-3,14
Concordia Ch,1780,6,2,4,8,16,22,-6,10
FCSB,1781,1,8,6,0,24,10,14,30
CFR Cluj,1781,2,5,6,3,13,9,4,21
D Bucuresti,1781,3,5,4,5,20,19,1,19
Universitate,1781,4,4,6,4,15,18,-3,18
FC Botosani,1781,5,3,5,6,7,16,-9,14
Concordia Ch,1781,6,2,3,9,16,23,-7,9
CFR Cluj,1782,1,7,6,1,15,7,8,27
FCSB,1782,2,7,5,2,23,12,11,26
Universitate,1782,3,4,5,5,15,19,-4,17
D Bucuresti,1782,4,4,4,6,20,21,-1,16
Concordia Ch,1782,5,4,2,8,21,24,-3,14
FC Botosani,1782,6,3,4,7,8,19,-11,13
FCSB,1783,1,7,7,0,25,12,13,28
CFR Cluj,1783,2,5,7,2,14,9,5,22
Universitate,1783,3,4,6,4,16,19,-3,18
D Bucuresti,1783,4,4,5,5,18,19,-1,17
FC Botosani,1783,5,3,5,6,7,15,-8,14
Concordia Ch,1783,6,2,4,8,16,22,-6,10
FCSB,1784,1,8,5,1,25,11,14,29
CFR Cluj,1784,2,5,7,2,13,9,4,22
Universitate,1784,3,4,6,4,15,18,-3,18
D Bucuresti,1784,4,3,6,5,17,19,-2,15
FC Botosani,1784,5,3,6,5,8,15,-7,15
Concordia Ch,1784,6,2,4,8,17,23,-6,10
FCSB,1785,1,9,5,0,28,11,17,32
CFR Cluj,1785,2,5,6,3,13,10,3,21
FC Botosani,1785,3,4,5,5,9,13,-4,17
Universitate,1785,4,4,5,5,17,22,-5,17
D Bucuresti,1785,5,3,5,6,17,21,-4,14
Concordia Ch,1785,6,3,2,9,17,24,-7,11
FCSB,1786,1,8,5,1,26,12,14,29
CFR Cluj,1786,2,6,6,2,15,9,6,24
D Bucuresti,1786,3,5,4,5,19,18,1,19
Universitate,1786,4,4,5,5,17,22,-5,17
FC Botosani,1786,5,4,4,6,7,13,-6,16
Concordia Ch,1786,6,2,2,10,15,25,-10,8
FCSB,1787,1,7,5,2,24,13,11,26
CFR Cluj,1787,2,6,6,2,14,8,6,24
Universitate,1787,3,5,5,4,17,19,-2,20
D Bucuresti,1787,4,4,4,6,18,20,-2,16
FC Botosani,1787,5,4,4,6,6,13,-7,16
Concordia Ch,1787,6,3,2,9,17,23,-6,11
FCSB,1788,1,9,5,0,28,13,15,32
CFR Cluj,1788,2,6,6,2,17,10,7,24
D Bucuresti,1788,3,4,4,6,17,20,-3,16
FC Botosani,1788,4,4,4,6,7,14,-7,16
Universitate,1788,5,3,5,6,15,22,-7,14
Concordia Ch,1788,6,3,2,9,18,23,-5,11
FCSB,1789,1,8,6,0,24,10,14,30
CFR Cluj,1789,2,6,6,2,17,8,9,24
D Bucuresti,1789,3,4,4,6,18,19,-1,16
Universitate,1789,4,3,6,5,14,22,-8,15
Concordia Ch,1789,5,4,2,8,18,21,-3,14
FC Botosani,1789,6,3,4,7,5,16,-11,13
FCSB,1790,1,7,7,0,26,13,13,28
CFR Cluj,1790,2,6,7,1,16,9,7,25
D Bucuresti,1790,3,4,4,6,17,23,-6,16
FC Botosani,1790,4,4,4,6,7,13,-6,16
Universitate,1790,5,3,6,5,15,20,-5,15
Concordia Ch,1790,6,3,2,9,20,23,-3,11
FCSB,1791,1,8,6,0,25,11,14,30
CFR Cluj,1791,2,5,7,2,15,10,5,22
D Bucuresti,1791,3,4,5,5,18,19,-1,17
Universitate,1791,4,3,7,4,17,21,-4,16
FC Botosani,1791,5,4,4,6,7,13,-6,16
Concordia Ch,1791,6,2,3,9,16,24,-8,9
FCSB,1792,1,9,5,0,29,11,18,32
CFR Cluj,1792,2,5,7,2,14,10,4,22
FC Botosani,1792,3,4,5,5,8,13,-5,17
D Bucuresti,1792,4,3,6,5,16,18,-2,15
Universitate,1792,5,3,6,5,16,23,-7,15
Concordia Ch,1792,6,2,3,9,16,24,-8,9
FCSB,1793,1,7,6,1,24,14,10,27
CFR Cluj,1793,2,6,7,1,15,8,7,25
D Bucuresti,1793,3,4,5,5,17,18,-1,17
Universitate,1793,4,4,5,5,19,21,-2,17
FC Botosani,1793,5,4,5,5,6,12,-6,17
Concordia Ch,1793,6,2,2,10,15,23,-8,8
FCSB,1794,1,8,6,0,26,12,14,30
CFR Cluj,1794,2,5,8,1,16,10,6,23
Universitate,1794,3,3,6,5,17,22,-5,15
FC Botosani,1794,4,3,6,5,8,15,-7,15
D Bucuresti,1794,5,3,5,6,18,24,-6,14
Concordia Ch,1794,6,3,3,8,20,22,-2,12
FCSB,1795,1,8,6,0,26,10,16,30
CFR Cluj,1795,2,5,7,2,14,10,4,22
D Bucuresti,1795,3,5,4,5,21,20,1,19
Universitate,1795,4,4,5,5,17,22,-5,17
FC Botosani,1795,5,3,4,7,8,18,-10,13
Concordia Ch,1795,6,3,2,9,17,23,-6,11
FCSB,1796,1,8,6,0,25,10,15,30
CFR Cluj,1796,2,6,6,2,14,9,5,24
FC Botosani,1796,3,4,5,5,8,13,-5,17
Universitate,1796,4,3,6,5,14,19,-5,15
D Bucuresti,1796,5,3,5,6,18,21,-3,14
Concordia Ch,1796,6,3,2,9,17,24,-7,11
FCSB,1797,1,8,6,0,25,11,14,30
CFR Cluj,1797,2,5,8,1,15,9,6,23
D Bucuresti,1797,3,5,4,5,23,18,5,19
FC Botosani,1797,4,4,4,6,7,18,-11,16
Universitate,1797,5,3,6,5,17,22,-5,15
Concordia Ch,1797,6,2,2,10,16,25,-9,8
FCSB,1798,1,8,5,1,26,13,13,29
CFR Cluj,1798,2,5,6,3,14,10,4,21
Universitate,1798,3,5,5,4,19,21,-2,20
FC Botosani,1798,4,4,5,5,6,12,-6,17
D Bucuresti,1798,5,4,4,6,17,19,-2,16
Concordia Ch,1798,6,2,3,9,15,22,-7,9
FCSB,1799,1,7,6,1,26,14,12,27
CFR Cluj,1799,2,7,6,1,16,8,8,27
FC Botosani,1799,3,5,4,5,9,12,-3,19
D Bucuresti,1799,4,4,4,6,17,20,-3,16
Universitate,1799,5,3,6,5,18,23,-5,15
Concordia Ch,1799,6,2,2,10,15,24,-9,8
FCSB,1800,1,9,5,0,27,12,15,32
CFR Cluj,1800,2,6,6,2,16,10,6,24
D Bucuresti,1800,3,4,5,5,20,20,0,17
FC Botosani,1800,4,4,5,5,9,14,-5,17
Universitate,1800,5,3,5,6,16,22,-6,14
Concordia Ch,1800,6,2,2,10,17,27,-10,8
FCSB,1801,1,7,6,1,24,12,12,27
CFR Cluj,1801,2,6,7,1,17,9,8,25
Universitate,1801,3,4,5,5,16,21,-5,17
FC Botosani,1801,4,4,4,6,6,13,-7,16
D Bucuresti,1801,5,3,5,6,17,20,-3,14
Concordia Ch,1801,6,3,3,8,17,22,-5,12
FCSB,1802,1,7,6,1,24,13,11,27
CFR Cluj,1802,2,5,7,2,14,9,5,22
Universitate,1802,3,5,5,4,17,18,-1,20
D Bucuresti,1802,4,4,4,6,17,20,-3,16
FC Botosani,1802,5,3,5,6,6,14,-8,14
Concordia Ch,1802,6,3,3,8,18,22,-4,12
FCSB,1803,1,7,6,1,24,13,11,27
CFR Cluj,1803,2,5,7,2,15,11,4,22
Universitate,1803,3,5,5,4,19,19,0,20
FC Botosani,1803,4,5,4,5,9,14,-5,19
D Bucuresti,1803,5,4,4,6,20,22,-2,16
Concordia Ch,1803,6,2,2,10,16,24,-8,8
FCSB,1804,1,7,7,0,26,13,13,28
CFR Cluj,1804,2,6,7,1,15,8,7,25
FC Botosani,1804,3,4,4,6,8,15,-7,16
Universitate,1804,4,3,6,5,16,21,-5,15
Concordia Ch,1804,5,4,2,8,19,22,-3,14
D Bucuresti,1804,6,3,4,7,17,22,-5,13
FCSB,1805,1,8,6,0,28,12,16,30
CFR Cluj,1805,2,5,8,1,14,8,6,23
FC Botosani,1805,3,4,5,5,9,13,-4,17
Universitate,1805,4,3,6,5,15,22,-7,15
D Bucuresti,1805,5,3,4,7,16,22,-6,13
Concordia Ch,1805,6,3,3,8,17,22,-5,12
FCSB,1806,1,7,6,1,23,12,11,27
CFR Cluj,1806,2,5,8,1,13,7,6,23
D Bucuresti,1806,3,5,4,5,21,19,2,19
Universitate,1806,4,4,6,4,16,18,-2,18
FC Botosani,1806,5,4,4,6,9,16,-7,16
Concordia Ch,1806,6,2,2,10,17,27,-10,8
FCSB,1807,1,9,5,0,27,10,17,32
CFR Cluj,1807,2,6,6,2,14,8,6,24
FC Botosani,1807,3,5,4,5,9,13,-4,19
D Bucuresti,1807,4,3,5,6,19,23,-4,14
Universitate,1807,5,3,5,6,14,22,-8,14
Concordia Ch,1807,6,2,3,9,17,24,-7,9
FCSB,1808,1,7,6,1,26,14,12,27
CFR Cluj,1808,2,6,7,1,18,10,8,25
Universitate,1808,3,4,5,5,15,20,-5,17
D Bucuresti,1808,4,4,4,6,19,22,-3,16
Concordia Ch,1808,5,4,2,8,20,23,-3,14
FC Botosani,1808,6,3,4,7,7,16,-9,13
FCSB,1809,1,7,7,0,25,12,13,28
CFR Cluj,1809,2,6,7,1,17,8,9,25
D Bucuresti,1809,3,4,4,6,17,21,-4,16
FC Botosani,1809,4,4,4,6,6,13,-7,16
Universitate,1809,5,3,6,5,15,22,-7,15
Concordia Ch,1809,6,3,2,9,18,22,-4,11
FCSB,1810,1,9,5,0,27,11,16,32
CFR Cluj,1810,2,6,6,2,16,10,6,24
D Bucuresti,1810,3,5,4,5,23,19,4,19
FC Botosani,1810,4,4,4,6,8,18,-10,16
Universitate,1810,5,3,5,6,16,23,-7,14
Concordia Ch,1810,6,2,2,10,18,27,-9,8
FCSB,1811,1,8,6,0,25,10,15,30
CFR Cluj,1811,2,6,6,2,14,9,5,24
D Bucuresti,1811,3,4,5,5,20,20,0,17
FC Botosani,1811,4,4,4,6,7,14,-7,16
Universitate,1811,5,3,6,5,14,19,-5,15
Concordia Ch,1811,6,2,3,9,17,25,-8,9
FCSB,1812,1,8,6,0,26,10,16,30
CFR Cluj,1812,2,6,6,2,16,10,6,24
D Bucuresti,1812,3,4,4,6,19,20,-1,16
Universitate,1812,4,3,6,5,14,21,-7,15
Concordia Ch,1812,5,4,2,8,20,22,-2,14
FC Botosani,1812,6,3,4,7,5,17,-12,13
FCSB,1813,1,8,6,0,26,12,14,30
CFR Cluj,1813,2,5,6,3,15,11,4,21
Universitate,1813,3,4,6,4,17,20,-3,18
D Bucuresti,1813,4,4,5,5,19,20,-1,17
FC Botosani,1813,5,3,5,6,7,16,-9,14
Concordia Ch,1813,6,3,2,9,19,24,-5,11
FCSB,1814,1,8,6,0,25,10,15,30
CFR Cluj,1814,2,5,7,2,13,8,5,22
D Bucuresti,1814,3,5,4,5,20,19,1,19
Universitate,1814,4,4,5,5,15,20,-5,17
FC Botosani,1814,5,4,4,6,10,15,-5,16
Concordia Ch,1814,6,2,2,10,15,26,-11,8
FCSB,1815,1,8,5,1,25,13,12,29
CFR Cluj,1815,2,6,6,2,15,9,6,24
D Bucuresti,1815,3,4,5,5,19,20,-1,17
Universitate,1815,4,4,5,5,16,19,-3,17
FC Botosani,1815,5,3,5,6,7,15,-8,14
Concordia Ch,1815,6,3,2,9,18,24,-6,11
FCSB,1816,1,8,5,1,27,13,14,29
CFR Cluj,1816,2,6,7,1,16,9,7,25
FC Botosani,1816,3,4,5,5,9,15,-6,17
Universitate,1816,4,3,6,5,14,20,-6,15
D Bucuresti,1816,5,3,5,6,18,21,-3,14
Concordia Ch,1816,6,2,4,8,18,24,-6,10
FCSB,1817,1,8,6,0,26,11,15,30
CFR Cluj,1817,2,6,7,1,15,8,7,25
FC Botosani,1817,3,4,5,5,8,14,-6,17
Universitate,1817,4,3,5,6,14,21,-7,14
D Bucuresti,1817,5,3,4,7,18,22,-4,13
Concordia Ch,1817,6,3,3,8,18,23,-5,12
FCSB,1818,1,7,7,0,27,14,13,28
CFR Cluj,1818,2,5,8,1,16,10,6,23
D Bucuresti,1818,3,4,4,6,19,21,-2,16
Universitate,1818,4,3,7,4,17,21,-4,16
FC Botosani,1818,5,3,5,6,6,15,-9,14
Concordia Ch,1818,6,3,3,8,19,23,-4,12
FCSB,1819,1,8,5,1,26,13,13,29
CFR Cluj,1819,2,5,7,2,15,11,4,22
Universitate,1819,3,4,6,4,17,19,-2,18
FC Botosani,1819,4,4,5,5,7,12,-5,17
D Bucuresti,1819,5,3,6,5,17,19,-2,15
Concordia Ch,1819,6,2,3,9,16,24,-8,9
FCSB,1820,1,7,6,1,24,14,10,27
CFR Cluj,1820,2,5,8,1,14,8,6,23
FC Botosani,1820,3,5,4,5,8,12,-4,19
Universitate,1820,4,4,6,4,17,18,-1,18
D Bucuresti,1820,5,3,4,7,16,20,-4,13
Concordia Ch,1820,6,3,2,9,16,23,-7,11
FCSB,1821,1,7,7,0,25,12,13,28
CFR Cluj,1821,2,5,8,1,14,8,6,23
D Bucuresti,1821,3,4,5,5,19,20,-1,17
Universitate,1821,4,3,7,4,15,19,-4,16
FC Botosani,1821,5,4,4,6,7,14,-7,16
Concordia Ch,1821,6,2,3,9,18,25,-7,9
FCSB,1822,1,7,5,2,23,13,10,26
CFR Cluj,1822,2,6,7,1,15,8,7,25
Universitate,1822,3,4,6,4,17,19,-2,18
D Bucuresti,1822,4,3,6,5,19,21,-2,15
FC Botosani,1822,5,3,5,6,6,16,-10,14
Concordia Ch,1822,6,3,3,8,20,23,-3,12
FCSB,1823,1,7,7,0,25,12,13,28
CFR Cluj,1823,2,5,8,1,15,9,6,23
FC Botosani,1823,3,5,4,5,10,13,-3,19
Universitate,1823,4,3,7,4,16,20,-4,16
D Bucuresti,1823,5,3,5,6,17,22,-5,14
Concordia Ch,1823,6,2,3,9,17,24,-7,9
FCSB,1824,1,8,6,0,27,12,15,30
CFR Cluj,1824,2,6,6,2,15,10,5,24
D Bucuresti,1824,3,4,4,6,17,19,-2,16
FC Botosani,1824,4,4,4,6,6,14,-8,16
Universitate,1824,5,3,6,5,15,20,-5,15
Concordia Ch,1824,6,3,2,9,17,22,-5,11
FCSB,1825,1,8,5,1,26,14,12,29
CFR Cluj,1825,2,5,6,3,13,13,0,21
Universitate,1825,3,5,5,4,21,18,3,20
FC Botosani,1825,4,5,4,5,8,12,-4,19
D Bucuresti,1825,5,3,4,7,16,22,-6,13
Concordia Ch,1825,6,3,2,9,17,22,-5,11
FCSB,1826,1,8,6,0,25,11,14,30
CFR Cluj,1826,2,6,6,2,15,8,7,24
D Bucuresti,1826,3,4,5,5,21,21,0,17
FC Botosani,1826,4,4,4,6,8,16,-8,16
Universitate,1826,5,3,6,5,15,21,-6,15
Concordia Ch,1826,6,2,3,9,16,23,-7,9
FCSB,1827,1,8,5,1,24,11,13,29
CFR Cluj,1827,2,6,6,2,16,9,7,24
D Bucuresti,1827,3,4,5,5,20,21,-1,17
Universitate,1827,4,4,5,5,16,21,-5,17
FC Botosani,1827,5,4,5,5,9,15,-6,17
Concordia Ch,1827,6,2,2,10,19,27,-8,8
FCSB,1828,1,7,6,1,24,12,12,27
CFR Cluj,1828,2,6,7,1,15,8,7,25
Universitate,1828,3,3,7,4,16,20,-4,16
Concordia Ch,1828,4,4,2,8,21,23,-2,14
D Bucuresti,1828,5,3,5,6,20,23,-3,14
FC Botosani,1828,6,3,5,6,7,17,-10,14
FCSB,1829,1,8,6,0,24,10,14,30
CFR Cluj,1829,2,6,6,2,18,8,10,24
D Bucuresti,1829,3,5,4,5,22,19,3,19
Universitate,1829,4,3,6,5,14,23,-9,15
FC Botosani,1829,5,3,4,7,6,17,-11,13
Concordia Ch,1829,6,3,2,9,18,25,-7,11
FCSB,1830,1,8,5,1,24,12,12,29
CFR Cluj,1830,2,6,6,2,14,8,6,24
Universitate,1830,3,4,5,5,16,19,-3,17
D Bucuresti,1830,4,4,4,6,20,20,0,16
FC Botosani,1830,5,4,4,6,6,13,-7,16
Concordia Ch,1830,6,3,2,9,17,25,-8,11
FCSB,1831,1,9,5,0,28,12,16,32
CFR Cluj,1831,2,5,6,3,14,10,4,21
Universitate,1831,3,4,5,5,16,21,-5,17
FC Botosani,1831,4,4,5,5,10,15,-5,17
D Bucuresti,1831,5,3,6,5,18,20,-2,15
Concordia Ch,1831,6,2,3,9,18,26,-8,9
FCSB,1832,1,8,6,0,26,12,14,30
CFR Cluj,1832,2,5,8,1,14,8,6,23
FC Botosani,1832,3,5,4,5,8,12,-4,19
Universitate,1832,4,3,6,5,15,20,-5,15
D Bucuresti,1832,5,3,5,6,16,20,-4,14
Concordia Ch,1832,6,2,3,9,15,22,-7,9
FCSB,1833,1,8,6,0,26,11,15,30
CFR Cluj,1833,2,6,6,2,15,9,6,24
D Bucuresti,1833,3,3,6,5,18,20,-2,15
Universitate,1833,4,3,6,5,15,21,-6,15
FC Botosani,1833,5,3,6,5,5,12,-7,15
Concordia Ch,1833,6,2,4,8,17,23,-6,10
FCSB,1834,1,7,7,0,25,12,13,28
CFR Cluj,1834,2,6,7,1,17,8,9,25
FC Botosani,1834,3,4,4,6,6,13,-7,16
Universitate,1834,4,3,6,5,15,22,-7,15
D Bucuresti,1834,5,3,5,6,17,20,-3,14
Concordia Ch,1834,6,3,3,8,17,22,-5,12
FCSB,1835,1,8,6,0,25,11,14,30
CFR Cluj,1835,2,6,7,1,16,9,7,25
D Bucuresti,1835,3,5,4,5,20,20,0,19
Universitate,1835,4,3,5,6,15,21,-6,14
FC Botosani,1835,5,3,4,7,5,14,-9,13
Concordia Ch,1835,6,3,2,9,18,24,-6,11
FCSB,1836,1,8,6,0,27,12,15,30
CFR Cluj,1836,2,5,7,2,13,9,4,22
FC Botosani,1836,3,4,5,5,7,12,-5,17
Universitate,1836,4,3,7,4,16,20,-4,16
D Bucuresti,1836,5,3,6,5,16,18,-2,15
Concordia Ch,1836,6,2,3,9,15,23,-8,9
FCSB,1837,1,8,5,1,25,13,12,29
CFR Cluj,1837,2,6,6,2,15,9,6,24
Universitate,1837,3,4,5,5,16,19,-3,17
FC Botosani,1837,4,4,5,5,7,13,-6,17
D Bucuresti,1837,5,3,4,7,17,23,-6,13
Concordia Ch,1837,6,3,3,8,20,23,-3,12
FCSB,1838,1,8,6,0,27,12,15,30
CFR Cluj,1838,2,6,6,2,15,10,5,24
D Bucuresti,1838,3,4,5,5,18,19,-1,17
FC Botosani,1838,4,4,4,6,6,13,-7,16
Universitate,1838,5,3,6,5,17,22,-5,15
Concordia Ch,1838,6,2,3,9,16,23,-7,9
FCSB,1839,1,7,7,0,26,13,13,28
CFR Cluj,1839,2,6,7,1,16,9,7,25
D Bucuresti,1839,3,4,5,5,17,18,-1,17
Universitate,1839,4,3,6,5,15,20,-5,15
FC Botosani,1839,5,3,6,5,5,12,-7,15
Concordia Ch,1839,6,2,3,9,15,22,-7,9
FCSB,1840,1,7,6,1,25,15,10,27
CFR Cluj,1840,2,7,6,1,18,8,10,27
Universitate,1840,3,3,6,5,15,20,-5,15
FC Botosani,1840,4,3,6,5,7,14,-7,15
D Bucuresti,1840,5,3,5,6,17,20,-3,14
Concordia Ch,1840,6,3,3,8,17,22,-5,12
FCSB,1841,1,8,6,0,27,11,16,30
CFR Cluj,1841,2,5,7,2,16,11,5,22
Universitate,1841,3,4,5,5,17,23,-6,17
D Bucuresti,1841,4,4,4,6,19,21,-2,16
FC Botosani,1841,5,4,4,6,7,13,-6,16
Concordia Ch,1841,6,3,2,9,17,24,-7,11
FCSB,1842,1,8,6,0,26,11,15,30
CFR Cluj,1842,2,5,6,3,13,11,2,21
D Bucuresti,1842,3,5,4,5,18,18,0,19
Universitate,1842,4,4,6,4,17,19,-2,18
FC Botosani,1842,5,3,5,6,6,14,-8,14
Concordia Ch,1842,6,2,3,9,16,23,-7,9
FCSB,1843,1,9,5,0,28,11,17,32
CFR Cluj,1843,2,5,7,2,14,9,5,22
FC Botosani,1843,3,4,5,5,7,13,-6,17
Universitate,1843,4,3,6,5,16,23,-7,15
D Bucuresti,1843,5,3,5,6,17,21,-4,14
Concordia Ch,1843,6,3,2,9,17,22,-5,11
FCSB,1844,1,9,5,0,28,11,17,32
CFR Cluj,1844,2,5,7,2,15,11,4,22
D Bucuresti,1844,3,4,4,6,17,20,-3,16
Universitate,1844,4,3,6,5,15,21,-6,15
Concordia Ch,1844,5,4,2,8,19,22,-3,14
FC Botosani,1844,6,3,4,7,6,15,-9,13
FCSB,1845,1,9,5,0,28,11,17,32
CFR Cluj,1845,2,5,6,3,13,11,2,21
D Bucuresti,1845,3,4,5,5,21,20,1,17
Universitate,1845,4,4,5,5,17,21,-4,17
FC Botosani,1845,5,3,5,6,8,16,-8,14
Concordia Ch,1845,6,3,2,9,17,25,-8,11
FCSB,1846,1,7,6,1,26,14,12,27
CFR Cluj,1846,2,6,7,1,16,9,7,25
Universitate,1846,3,4,5,5,16,20,-4,17
FC Botosani,1846,4,4,5,5,7,13,-6,17
D Bucuresti,1846,5,3,5,6,18,21,-3,14
Concordia Ch,1846,6,3,2,9,19,25,-6,11
FCSB,1847,1,9,5,0,31,10,21,32
CFR Cluj,1847,2,5,6,3,13,9,4,21
D Bucuresti,1847,3,4,5,5,18,19,-1,17
FC Botosani,1847,4,4,5,5,7,12,-5,17
Universitate,1847,5,4,5,5,15,25,-10,17
Concordia Ch,1847,6,2,2,10,16,25,-9,8
FCSB,1848,1,8,5,1,25,11,14,29
CFR Cluj,1848,2,6,6,2,16,10,6,24
D Bucuresti,1848,3,4,5,5,20,20,0,17
Universitate,1848,4,4,5,5,17,22,-5,17
FC Botosani,1848,5,4,4,6,6,14,-8,16
Concordia Ch,1848,6,2,3,9,17,24,-7,9
FCSB,1849,1,8,6,0,26,10,16,30
CFR Cluj,1849,2,6,6,2,16,12,4,24
FC Botosani,1849,3,4,4,6,9,15,-6,16
D Bucuresti,1849,4,4,4,6,19,26,-7,16
Universitate,1849,5,3,6,5,16,21,-5,15
Concordia Ch,1849,6,3,2,9,22,24,-2,11
CFR Cluj,1850,1,7,6,1,20,7,13,27
FCSB,1850,2,7,5,2,23,17,6,26
Universitate,1850,3,4,5,5,15,19,-4,17
D Bucuresti,1850,4,4,4,6,17,19,-2,16
Concordia Ch,1850,5,4,2,8,18,21,-3,14
FC Botosani,1850,6,3,4,7,5,15,-10,13
FCSB,1851,1,8,6,0,26,11,15,30
CFR Cluj,1851,2,6,6,2,17,10,7,24
FC Botosani,1851,3,4,5,5,7,13,-6,17
Universitate,1851,4,3,6,5,16,23,-7,15
D Bucuresti,1851,5,3,5,6,18,21,-3,14
Concordia Ch,1851,6,3,2,9,17,23,-6,11
FCSB,1852,1,8,6,0,28,13,15,30
CFR Cluj,1852,2,6,6,2,16,11,5,24
Universitate,1852,3,3,6,5,15,20,-5,15
D Bucuresti,1852,4,3,5,6,17,20,-3,14
Concordia Ch,1852,5,4,2,8,18,22,-4,14
FC Botosani,1852,6,3,5,6,7,15,-8,14
FCSB,1853,1,8,6,0,26,12,14,30
CFR Cluj,1853,2,5,7,2,15,10,5,22
D Bucuresti,1853,3,5,4,5,19,18,1,19
Universitate,1853,4,3,7,4,16,20,-4,16
FC Botosani,1853,5,3,5,6,7,15,-8,14
Concordia Ch,1853,6,2,3,9,17,25,-8,9
FCSB,1854,1,7,5,2,24,14,10,26
CFR Cluj,1854,2,6,7,1,17,9,8,25
Universitate,1854,3,4,6,4,16,19,-3,18
D Bucuresti,1854,4,4,4,6,19,21,-2,16
FC Botosani,1854,5,4,4,6,7,14,-7,16
Concordia Ch,1854,6,3,2,9,18,24,-6,11
FCSB,1855,1,8,5,1,26,12,14,29
CFR Cluj,1855,2,6,6,2,15,10,5,24
Universitate,1855,3,4,5,5,15,19,-4,17
D Bucuresti,1855,4,4,4,6,19,20,-1,16
FC Botosani,1855,5,3,5,6,6,15,-9,14
Concordia Ch,1855,6,3,3,8,18,23,-5,12
FCSB,1856,1,8,5,1,29,14,15,29
CFR Cluj,1856,2,6,7,1,16,9,7,25
D Bucuresti,1856,3,4,4,6,20,20,0,16
FC Botosani,1856,4,4,4,6,7,15,-8,16
Universitate,1856,5,3,6,5,15,22,-7,15
Concordia Ch,1856,6,3,2,9,17,24,-7,11
CFR Cluj,1857,1,7,6,1,17,8,9,27
FCSB,1857,2,7,5,2,23,13,10,26
FC Botosani,1857,3,5,4,5,10,12,-2,19
Universitate,1857,4,4,5,5,16,20,-4,17
D Bucuresti,1857,5,4,4,6,17,20,-3,16
Concordia Ch,1857,6,2,2,10,15,25,-10,8
FCSB,1858,1,8,5,1,26,12,14,29
CFR Cluj,1858,2,7,6,1,15,7,8,27
D Bucuresti,1858,3,4,5,5,18,19,-1,17
Universitate,1858,4,3,5,6,15,22,-7,14
FC Botosani,1858,5,3,4,7,5,14,-9,13
Concordia Ch,1858,6,3,3,8,17,22,-5,12
FCSB,1859,1,8,6,0,27,13,14,30
CFR Cluj,1859,2,5,8,1,15,9,6,23
D Bucuresti,1859,3,4,5,5,19,18,1,17
Universitate,1859,4,3,6,5,17,22,-5,15
FC Botosani,1859,5,3,4,7,5,16,-11,13
Concordia Ch,1859,6,3,3,8,16,21,-5,12
FCSB,1860,1,8,6,0,26,12,14,30
CFR Cluj,1860,2,5,8,1,16,10,6,23
D Bucuresti,1860,3,4,4,6,19,20,-1,16
Universitate,1860,4,3,6,5,19,24,-5,15
Concordia Ch,1860,5,4,2,8,18,21,-3,14
FC Botosani,1860,6,3,4,7,5,16,-11,13
FCSB,1861,1,8,6,0,27,12,15,30
CFR Cluj,1861,2,6,6,2,16,9,7,24
FC Botosani,1861,3,5,4,5,9,13,-4,19
Universitate,1861,4,3,6,5,16,23,-7,15
D Bucuresti,1861,5,3,4,7,16,22,-6,13
Concordia Ch,1861,6,3,2,9,19,24,-5,11
FCSB,1862,1,9,5,0,27,11,16,32
CFR Cluj,1862,2,6,6,2,17,11,6,24
D Bucuresti,1862,3,4,4,6,20,21,-1,16
FC Botosani,1862,4,4,4,6,8,16,-8,16
Universitate,1862,5,3,5,6,15,22,-7,14
Concordia Ch,1862,6,3,2,9,18,24,-6,11
FCSB,1863,1,9,5,0,30,12,18,32
CFR Cluj,1863,2,6,6,2,17,13,4,24
D Bucuresti,1863,3,4,4,6,20,23,-3,16
Concordia Ch,1863,4,4,2,8,20,22,-2,14
Universitate,1863,5,3,5,6,17,24,-7,14
FC Botosani,1863,6,3,4,7,6,16,-10,13
FCSB,1864,1,7,7,0,25,12,13,28
CFR Cluj,1864,2,5,7,2,14,10,4,22
Universitate,1864,3,4,6,4,17,19,-2,18
D Bucuresti,1864,4,4,5,5,18,19,-1,17
FC Botosani,1864,5,3,6,5,5,12,-7,15
Concordia Ch,1864,6,2,3,9,16,23,-7,9
FCSB,1865,1,8,5,1,25,13,12,29
CFR Cluj,1865,2,6,7,1,16,8,8,25
D Bucuresti,1865,3,4,4,6,19,19,0,16
Universitate,1865,4,3,6,5,16,21,-5,15
FC Botosani,1865,5,3,5,6,5,15,-10,14
Concordia Ch,1865,6,3,3,8,16,21,-5,12
CFR Cluj,1866,1,7,6,1,18,9,9,27
FCSB,1866,2,7,5,2,23,13,10,26
Universitate,1866,3,4,5,5,17,21,-4,17
D Bucuresti,1866,4,4,4,6,19,21,-2,16
FC Botosani,1866,5,3,5,6,7,16,-9,14
Concordia Ch,1866,6,3,3,8,20,24,-4,12
FCSB,1867,1,9,5,0,27,12,15,32
CFR Cluj,1867,2,5,7,2,14,9,5,22
FC Botosani,1867,3,5,4,5,8,12,-4,19
D Bucuresti,1867,4,4,4,6,18,20,-2,16
Universitate,1867,5,3,6,5,17,22,-5,15
Concordia Ch,1867,6,2,2,10,16,25,-9,8
FCSB,1868,1,9,5,0,28,10,18,32
CFR Cluj,1868,2,5,6,3,13,11,2,21
D Bucuresti,1868,3,4,5,5,19,19,0,17
Universitate,1868,4,4,5,5,17,22,-5,17
FC Botosani,1868,5,3,4,7,6,17,-11,13
Concordia Ch,1868,6,3,3,8,19,23,-4,12
FCSB,1869,1,7,6,1,23,11,12,27
CFR Cluj,1869,2,5,8,1,14,8,6,23
Universitate,1869,3,4,6,4,16,19,-3,18
D Bucuresti,1869,4,4,4,6,18,22,-4,16
FC Botosani,1869,5,4,4,6,9,14,-5,16
Concordia Ch,1869,6,3,2,9,18,24,-6,11
FCSB,1870,1,8,5,1,25,13,12,29
CFR Cluj,1870,2,6,6,2,16,9,7,24
FC Botosani,1870,3,5,4,5,13,12,1,19
Universitate,1870,4,4,5,5,16,20,-4,17
D Bucuresti,1870,5,4,4,6,17,22,-5,16
Concordia Ch,1870,6,2,2,10,15,26,-11,8
FCSB,1871,1,8,5,1,26,12,14,29
CFR Cluj,1871,2,5,6,3,13,10,3,21
Universitate,1871,3,5,5,4,17,19,-2,20
D Bucuresti,1871,4,4,5,5,17,18,-1,17
FC Botosani,1871,5,4,4,6,7,13,-6,16
Concordia Ch,1871,6,2,3,9,15,23,-8,9
FCSB,1872,1,8,5,1,29,13,16,29
CFR Cluj,1872,2,6,7,1,16,9,7,25
D Bucuresti,1872,3,4,4,6,18,20,-2,16
Universitate,1872,4,3,6,5,14,22,-8,15
FC Botosani,1872,5,3,5,6,6,14,-8,14
Concordia Ch,1872,6,3,3,8,16,21,-5,12
FCSB,1873,1,8,5,1,25,13,12,29
CFR Cluj,1873,2,6,6,2,16,9,7,24
D Bucuresti,1873,3,4,5,5,20,20,0,17
Universitate,1873,4,4,5,5,16,20,-4,17
FC Botosani,1873,5,4,5,5,8,14,-6,17
Concordia Ch,1873,6,2,2,10,15,24,-9,8
CFR Cluj,1874,1,7,6,1,15,7,8,27
FCSB,1874,2,7,5,2,24,13,11,26
Universitate,1874,3,4,5,5,16,20,-4,17
FC Botosani,1874,4,4,4,6,8,15,-7,16
Concordia Ch,1874,5,4,2,8,19,23,-4,14
D Bucuresti,1874,6,3,4,7,16,20,-4,13
FCSB,1875,1,7,7,0,26,13,13,28
CFR Cluj,1875,2,5,7,2,15,11,4,22
Universitate,1875,3,4,6,4,19,21,-2,18
FC Botosani,1875,4,4,4,6,7,14,-7,16
D Bucuresti,1875,5,3,5,6,17,20,-3,14
Concordia Ch,1875,6,3,3,8,18,23,-5,12
FCSB,1876,1,7,6,1,23,13,10,27
CFR Cluj,1876,2,6,7,1,17,8,9,25
D Bucuresti,1876,3,4,4,6,18,20,-2,16
Universitate,1876,4,3,7,4,15,19,-4,16
Concordia Ch,1876,5,4,2,8,19,22,-3,14
FC Botosani,1876,6,3,4,7,6,16,-10,13
FCSB,1877,1,8,6,0,25,10,15,30
CFR Cluj,1877,2,5,7,2,13,9,4,22
D Bucuresti,1877,3,4,4,6,19,21,-2,16
Universitate,1877,4,3,7,4,14,18,-4,16
Concordia Ch,1877,5,4,2,8,19,22,-3,14
FC Botosani,1877,6,3,4,7,7,17,-10,13
FCSB,1878,1,8,6,0,26,11,15,30
CFR Cluj,1878,2,6,6,2,17,11,6,24
D Bucuresti,1878,3,5,4,5,20,19,1,19
Universitate,1878,4,3,6,5,15,21,-6,15
FC Botosani,1878,5,3,5,6,7,15,-8,14
Concordia Ch,1878,6,2,3,9,16,24,-8,9
FCSB,1879,1,8,5,1,26,13,13,29
CFR Cluj,1879,2,5,6,3,13,10,3,21
Universitate,1879,3,5,5,4,18,19,-1,20
FC Botosani,1879,4,5,4,5,12,15,-3,19
D Bucuresti,1879,5,3,5,6,19,22,-3,14
Concordia Ch,1879,6,2,3,9,17,26,-9,9
FCSB,1880,1,9,5,0,26,10,16,32
CFR Cluj,1880,2,6,6,2,15,9,6,24
D Bucuresti,1880,3,4,4,6,18,20,-2,16
FC Botosani,1880,4,4,4,6,8,13,-5,16
Universitate,1880,5,3,5,6,15,22,-7,14
Concordia Ch,1880,6,3,2,9,17,25,-8,11
FCSB,1881,1,8,5,1,25,12,13,29
CFR Cluj,1881,2,7,6,1,16,8,8,27
D Bucuresti,1881,3,4,4,6,22,20,2,16
Concordia Ch,1881,4,4,2,8,19,22,-3,14
Universitate,1881,5,3,5,6,16,22,-6,14
FC Botosani,1881,6,3,4,7,7,21,-14,13
FCSB,1882,1,8,6,0,27,13,14,30
CFR Cluj,1882,2,6,7,1,18,9,9,25
FC Botosani,1882,3,4,5,5,6,12,-6,17
D Bucuresti,1882,4,3,6,5,17,19,-2,15
Universitate,1882,5,3,5,6,17,25,-8,14
Concordia Ch,1882,6,2,3,9,16,23,-7,9
CFR Cluj,1883,1,7,6,1,16,7,9,27
FCSB,1883,2,7,5,2,23,15,8,26
Universitate,1883,3,4,5,5,18,20,-2,17
D Bucuresti,1883,4,4,4,6,20,20,0,16
FC Botosani,1883,5,3,5,6,6,16,-10,14
Concordia Ch,1883,6,3,3,8,18,23,-5,12
FCSB,1884,1,9,5,0,29,10,19,32
CFR Cluj,1884,2,6,6,2,15,11,4,24
D Bucuresti,1884,3,4,4,6,18,20,-2,16
FC Botosani,1884,4,4,4,6,6,14,-8,16
Universitate,1884,5,3,5,6,15,23,-8,14
Concordia Ch,1884,6,3,2,9,18,23,-5,11
FCSB,1885,1,9,5,0,26,11,15,32
CFR Cluj,1885,2,6,6,2,15,9,6,24
D Bucuresti,1885,3,4,5,5,19,20,-1,17
Universitate,1885,4,3,5,6,14,20,-6,14
FC Botosani,1885,5,3,5,6,5,13,-8,14
Concordia Ch,1885,6,2,4,8,17,23,-6,10
FCSB,1886,1,9,5,0,27,12,15,32
CFR Cluj,1886,2,5,6,3,15,11,4,21
Universitate,1886,3,4,5,5,17,21,-4,17
FC Botosani,1886,4,4,5,5,8,12,-4,17
D Bucuresti,1886,5,3,6,5,16,18,-2,15
Concordia Ch,1886,6,2,3,9,15,24,-9,9
FCSB,1887,1,7,6,1,25,16,9,27
CFR Cluj,1887,2,6,7,1,17,10,7,25
D Bucuresti,1887,3,4,5,5,20,21,-1,17
Universitate,1887,4,4,5,5,19,20,-1,17
FC Botosani,1887,5,3,4,7,6,16,-10,13
Concordia Ch,1887,6,3,3,8,19,23,-4,12
FCSB,1888,1,7,6,1,26,14,12,27
CFR Cluj,1888,2,7,6,1,17,8,9,27
D Bucuresti,1888,3,4,5,5,20,21,-1,17
FC Botosani,1888,4,4,5,5,9,14,-5,17
Universitate,1888,5,3,6,5,18,24,-6,15
Concordia Ch,1888,6,2,2,10,16,25,-9,8
FCSB,1889,1,8,6,0,26,12,14,30
CFR Cluj,1889,2,6,7,1,15,7,8,25
FC Botosani,1889,3,5,4,5,10,12,-2,19
Universitate,1889,4,3,5,6,16,23,-7,14
D Bucuresti,1889,5,3,4,7,16,20,-4,13
Concordia Ch,1889,6,3,2,9,16,25,-9,11
FCSB,1890,1,8,5,1,24,13,11,29
CFR Cluj,1890,2,6,6,2,15,9,6,24
Universitate,1890,3,4,5,5,18,20,-2,17
D Bucuresti,1890,4,4,4,6,17,19,-2,16
FC Botosani,1890,5,3,5,6,7,15,-8,14
Concordia Ch,1890,6,3,3,8,18,23,-5,12
FCSB,1891,1,8,5,1,26,13,13,29
CFR Cluj,1891,2,6,6,2,16,9,7,24
D Bucuresti,1891,3,4,5,5,20,20,0,17
Universitate,1891,4,4,5,5,15,20,-5,17
FC Botosani,1891,5,4,5,5,8,14,-6,17
Concordia Ch,1891,6,2,2,10,15,24,-9,8
FCSB,1892,1,9,5,0,28,10,18,32
CFR Cluj,1892,2,6,6,2,15,11,4,24
Concordia Ch,1892,3,4,2,8,19,22,-3,14
D Bucuresti,1892,4,3,5,6,18,22,-4,14
Universitate,1892,5,3,5,6,15,22,-7,14
FC Botosani,1892,6,3,5,6,6,14,-8,14
FCSB,1893,1,9,5,0,27,12,15,32
CFR Cluj,1893,2,5,6,3,14,10,4,21
D Bucuresti,1893,3,4,5,5,21,20,1,17
Universitate,1893,4,4,5,5,16,20,-4,17
FC Botosani,1893,5,3,5,6,5,15,-10,14
Concordia Ch,1893,6,2,4,8,17,23,-6,10
FCSB,1894,1,8,5,1,27,14,13,29
CFR Cluj,1894,2,5,6,3,14,10,4,21
Universitate,1894,3,5,5,4,18,20,-2,20
D Bucuresti,1894,4,3,6,5,18,20,-2,15
FC Botosani,1894,5,3,5,6,7,15,-8,14
Concordia Ch,1894,6,3,3,8,18,23,-5,12
FCSB,1895,1,9,5,0,26,10,16,32
CFR Cluj,1895,2,5,6,3,14,11,3,21
D Bucuresti,1895,3,4,5,5,19,19,0,17
Universitate,1895,4,4,5,5,17,21,-4,17
FC Botosani,1895,5,3,5,6,6,15,-9,14
Concordia Ch,1895,6,2,4,8,15,21,-6,10
FCSB,1896,1,8,6,0,27,13,14,30
CFR Cluj,1896,2,5,7,2,17,12,5,22
FC Botosani,1896,3,4,5,5,7,13,-6,17
Universitate,1896,4,3,7,4,15,19,-4,16
D Bucuresti,1896,5,3,4,7,17,23,-6,13
Concordia Ch,1896,6,3,3,8,20,23,-3,12
FCSB,1897,1,8,6,0,29,12,17,30
CFR Cluj,1897,2,5,6,3,13,12,1,21
Universitate,1897,3,4,6,4,17,20,-3,18
D Bucuresti,1897,4,4,4,6,20,21,-1,16
FC Botosani,1897,5,3,5,6,6,15,-9,14
Concordia Ch,1897,6,3,3,8,19,24,-5,12
FCSB,1898,1,8,5,1,25,12,13,29
CFR Cluj,1898,2,6,7,1,17,9,8,25
D Bucuresti,1898,3,4,4,6,20,23,-3,16
FC Botosani,1898,4,4,4,6,9,16,-7,16
Universitate,1898,5,3,6,5,16,22,-6,15
Concordia Ch,1898,6,3,2,9,18,23,-5,11
FCSB,1899,1,9,5,0,31,10,21,32
CFR Cluj,1899,2,5,7,2,13,10,3,22
D Bucuresti,1899,3,4,4,6,21,21,0,16
Universitate,1899,4,3,6,5,14,23,-9,15
Concordia Ch,1899,5,4,2,8,18,22,-4,14
FC Botosani,1899,6,3,4,7,6,17,-11,13
FCSB,1900,1,8,6,0,29,14,15,30
CFR Cluj,1900,2,6,7,1,18,9,9,25
FC Botosani,1900,3,4,5,5,6,12,-6,17
Universitate,1900,4,3,5,6,16,25,-9,14
D Bucuresti,1900,5,3,4,7,17,21,-4,13
Concordia Ch,1900,6,3,3,8,17,22,-5,12
FCSB,1901,1,7,6,1,25,13,12,27
CFR Cluj,1901,2,6,7,1,17,9,8,25
D Bucuresti,1901,3,5,4,5,20,19,1,19
Universitate,1901,4,4,5,5,15,20,-5,17
FC Botosani,1901,5,4,4,6,7,14,-7,16
Concordia Ch,1901,6,2,2,10,17,26,-9,8
FCSB,1902,1,9,5,0,28,11,17,32
CFR Cluj,1902,2,6,6,2,14,9,5,24
D Bucuresti,1902,3,4,4,6,17,24,-7,16
FC Botosani,1902,4,4,4,6,6,13,-7,16
Universitate,1902,5,3,5,6,15,22,-7,14
Concordia Ch,1902,6,3,2,9,21,22,-1,11
FCSB,1903,1,7,6,1,24,12,12,27
CFR Cluj,1903,2,5,7,2,14,10,4,22
Universitate,1903,3,5,5,4,17,18,-1,20
D Bucuresti,1903,4,4,5,5,20,20,0,17
FC Botosani,1903,5,4,4,6,8,15,-7,16
Concordia Ch,1903,6,2,3,9,16,24,-8,9
FCSB,1904,1,9,5,0,27,10,17,32
CFR Cluj,1904,2,5,7,2,13,9,4,22
FC Botosani,1904,3,5,4,5,7,12,-5,19
Universitate,1904,4,3,6,5,14,20,-6,15
D Bucuresti,1904,5,3,4,7,17,21,-4,13
Concordia Ch,1904,6,3,2,9,17,23,-6,11
FCSB,1905,1,7,7,0,24,11,13,28
CFR Cluj,1905,2,5,8,1,15,9,6,23
Universitate,1905,3,3,7,4,17,21,-4,16
FC Botosani,1905,4,4,4,6,7,14,-7,16
Concordia Ch,1905,5,4,2,8,19,23,-4,14
D Bucuresti,1905,6,3,4,7,17,21,-4,13
FCSB,1906,1,8,6,0,28,12,16,30
CFR Cluj,1906,2,5,7,2,14,11,3,22
FC Botosani,1906,3,4,5,5,6,12,-6,17
Universitate,1906,4,3,7,4,17,21,-4,16
D Bucuresti,1906,5,3,6,5,18,20,-2,15
Concordia Ch,1906,6,2,3,9,17,24,-7,9
FCSB,1907,1,8,5,1,25,13,12,29
CFR Cluj,1907,2,5,6,3,13,10,3,21
Universitate,1907,3,5,5,4,19,19,0,20
D Bucuresti,1907,4,3,6,5,17,19,-2,15
FC Botosani,1907,5,3,6,5,5,12,-7,15
Concordia Ch,1907,6,2,4,8,16,22,-6,10
FCSB,1908,1,7,6,1,24,12,12,27
CFR Cluj,1908,2,5,8,1,14,8,6,23
D Bucuresti,1908,3,5,4,5,20,19,1,19
Universitate,1908,4,4,6,4,15,18,-3,18
FC Botosani,1908,5,4,4,6,10,16,-6,16
Concordia Ch,1908,6,2,2,10,18,28,-10,8
FCSB,1909,1,8,6,0,27,13,14,30
CFR Cluj,1909,2,5,8,1,15,9,6,23
FC Botosani,1909,3,4,5,5,7,13,-6,17
D Bucuresti,1909,4,4,4,6,19,21,-2,16
Universitate,1909,5,3,6,5,15,20,-5,15
Concordia Ch,1909,6,2,3,9,16,23,-7,9
FCSB,1910,1,8,6,0,25,10,15,30
CFR Cluj,1910,2,6,7,1,14,7,7,25
FC Botosani,1910,3,5,4,5,8,13,-5,19
Universitate,1910,4,3,5,6,14,21,-7,14
D Bucuresti,1910,5,3,4,7,17,22,-5,13
Concordia Ch,1910,6,3,2,9,17,22,-5,11
FCSB,1911,1,7,7,0,24,11,13,28
CFR Cluj,1911,2,6,7,1,14,7,7,25
D Bucuresti,1911,3,4,5,5,18,19,-1,17
FC Botosani,1911,4,4,5,5,8,13,-5,17
Universitate,1911,5,3,6,5,15,20,-5,15
Concordia Ch,1911,6,2,2,10,15,24,-9,8
FCSB,1912,1,9,5,0,30,10,20,32
CFR Cluj,1912,2,6,6,2,16,11,5,24
D Bucuresti,1912,3,4,5,5,20,20,0,17
Universitate,1912,4,3,5,6,15,25,-10,14
FC Botosani,1912,5,3,4,7,5,16,-11,13
Concordia Ch,1912,6,3,3,8,19,23,-4,12
FCSB,1913,1,7,5,2,24,15,9,26
CFR Cluj,1913,2,6,6,2,15,9,6,24
Universitate,1913,3,5,5,4,18,18,0,20
D Bucuresti,1913,4,4,5,5,18,19,-1,17
FC Botosani,1913,5,3,6,5,6,13,-7,15
Concordia Ch,1913,6,2,3,9,17,24,-7,9
FCSB,1914,1,8,5,1,26,15,11,29
CFR Cluj,1914,2,6,6,2,15,9,6,24
Universitate,1914,3,4,5,5,20,22,-2,17
D Bucuresti,1914,4,4,4,6,17,19,-2,16
FC Botosani,1914,5,3,5,6,5,13,-8,14
Concordia Ch,1914,6,3,3,8,16,21,-5,12
FCSB,1915,1,9,5,0,28,11,17,32
CFR Cluj,1915,2,5,6,3,14,11,3,21
Universitate,1915,3,4,5,5,17,22,-5,17
FC Botosani,1915,4,4,4,6,8,15,-7,16
Concordia Ch,1915,5,4,2,8,17,21,-4,14
D Bucuresti,1915,6,3,4,7,18,22,-4,13
FCSB,1916,1,8,5,1,25,13,12,29
CFR Cluj,1916,2,5,7,2,13,9,4,22
Universitate,1916,3,4,6,4,17,18,-1,18
D Bucuresti,1916,4,3,6,5,18,20,-2,15
FC Botosani,1916,5,3,6,5,7,14,-7,15
Concordia Ch,1916,6,2,4,8,19,25,-6,10
CFR Cluj,1917,1,7,6,1,16,8,8,27
FCSB,1917,2,7,5,2,24,15,9,26
Universitate,1917,3,4,5,5,17,19,-2,17
D Bucuresti,1917,4,4,4,6,18,21,-3,16
FC Botosani,1917,5,3,5,6,5,13,-8,14
Concordia Ch,1917,6,3,3,8,18,22,-4,12
FCSB,1918,1,8,5,1,27,14,13,29
CFR Cluj,1918,2,5,7,2,14,9,5,22
Universitate,1918,3,4,6,4,17,20,-3,18
FC Botosani,1918,4,4,5,5,10,15,-5,17
D Bucuresti,1918,5,3,4,7,16,22,-6,13
Concordia Ch,1918,6,3,3,8,20,24,-4,12
FCSB,1919,1,7,6,1,24,12,12,27
CFR Cluj,1919,2,5,8,1,14,8,6,23
Universitate,1919,3,4,6,4,15,18,-3,18
FC Botosani,1919,4,4,5,5,9,14,-5,17
D Bucuresti,1919,5,3,6,5,18,20,-2,15
Concordia Ch,1919,6,2,3,9,17,25,-8,9
FCSB,1920,1,9,5,0,26,11,15,32
CFR Cluj,1920,2,5,7,2,16,11,5,22
D Bucuresti,1920,3,4,5,5,20,20,0,17
FC Botosani,1920,4,4,4,6,7,15,-8,16
Universitate,1920,5,3,6,5,16,21,-5,15
Concordia Ch,1920,6,2,3,9,16,23,-7,9
FCSB,1921,1,9,5,0,28,11,17,32
CFR Cluj,1921,2,5,7,2,15,12,3,22
D Bucuresti,1921,3,4,4,6,17,19,-2,16
Universitate,1921,4,3,6,5,15,20,-5,15
FC Botosani,1921,5,3,5,6,5,13,-8,14
Concordia Ch,1921,6,3,3,8,16,21,-5,12
FCSB,1922,1,8,5,1,25,13,12,29
CFR Cluj,1922,2,5,7,2,14,9,5,22
Universitate,1922,3,4,6,4,16,18,-2,18
D Bucuresti,1922,4,4,5,5,18,18,0,17
FC Botosani,1922,5,4,4,6,6,14,-8,16
Concordia Ch,1922,6,2,3,9,15,22,-7,9
FCSB,1923,1,8,6,0,24,10,14,30
CFR Cluj,1923,2,5,8,1,14,8,6,23
D Bucuresti,1923,3,5,4,5,21,21,0,19
Universitate,1923,4,3,6,5,15,20,-5,15
FC Botosani,1923,5,3,4,7,7,16,-9,13
Concordia Ch,1923,6,3,2,9,17,23,-6,11
FCSB,1924,1,7,5,2,25,14,11,26
CFR Cluj,1924,2,6,7,1,17,10,7,25
Universitate,1924,3,4,6,4,16,19,-3,18
D Bucuresti,1924,4,4,4,6,17,20,-3,16
FC Botosani,1924,5,3,5,6,6,14,-8,14
Concordia Ch,1924,6,3,3,8,18,22,-4,12
FCSB,1925,1,8,6,0,25,11,14,30
CFR Cluj,1925,2,6,7,1,14,7,7,25
D Bucuresti,1925,3,4,5,5,18,19,-1,17
FC Botosani,1925,4,4,4,6,9,14,-5,16
Universitate,1925,5,3,5,6,15,21,-6,14
Concordia Ch,1925,6,2,3,9,15,24,-9,9
FCSB,1926,1,8,5,1,26,15,11,29
CFR Cluj,1926,2,6,6,2,15,9,6,24
Universitate,1926,3,4,5,5,20,22,-2,17
D Bucuresti,1926,4,3,6,5,17,19,-2,15
FC Botosani,1926,5,3,6,5,8,15,-7,15
Concordia Ch,1926,6,2,4,8,17,23,-6,10
FCSB,1927,1,9,5,0,28,13,15,32
CFR Cluj,1927,2,6,6,2,17,8,9,24
FC Botosani,1927,3,4,4,6,10,14,-4,16
Concordia Ch,1927,4,4,2,8,20,23,-3,14
Universitate,1927,5,3,5,6,17,26,-9,14
D Bucuresti,1927,6,3,4,7,17,25,-8,13
FCSB,1928,1,7,6,1,23,12,11,27
CFR Cluj,1928,2,5,8,1,14,8,6,23
Universitate,1928,3,4,6,4,17,19,-2,18
D Bucuresti,1928,4,4,4,6,18,20,-2,16
FC Botosani,1928,5,4,4,6,7,14,-7,16
Concordia Ch,1928,6,3,2,9,18,24,-6,11
FCSB,1929,1,7,6,1,24,13,11,27
CFR Cluj,1929,2,5,7,2,14,13,1,22
Universitate,1929,3,5,5,4,21,18,3,20
FC Botosani,1929,4,3,6,5,6,13,-7,15
D Bucuresti,1929,5,3,5,6,17,21,-4,14
Concordia Ch,1929,6,3,3,8,19,23,-4,12
FCSB,1930,1,7,6,1,27,15,12,27
CFR Cluj,1930,2,6,6,2,18,12,6,24
Universitate,1930,3,4,6,4,15,18,-3,18
D Bucuresti,1930,4,4,4,6,18,20,-2,16
Concordia Ch,1930,5,4,2,8,18,22,-4,14
FC Botosani,1930,6,3,4,7,7,16,-9,13
CFR Cluj,1931,1,7,6,1,17,8,9,27
FCSB,1931,2,7,5,2,24,14,10,26
Universitate,1931,3,4,5,5,17,21,-4,17
FC Botosani,1931,4,4,5,5,8,13,-5,17
D Bucuresti,1931,5,3,6,5,18,20,-2,15
Concordia Ch,1931,6,2,3,9,16,24,-8,9
FCSB,1932,1,7,6,1,25,13,12,27
CFR Cluj,1932,2,7,6,1,17,9,8,27
D Bucuresti,1932,3,4,4,6,20,21,-1,16
Universitate,1932,4,3,6,5,16,21,-5,15
FC Botosani,1932,5,3,5,6,5,14,-9,14
Concordia Ch,1932,6,3,3,8,18,23,-5,12
FCSB,1933,1,8,6,0,25,10,15,30
CFR Cluj,1933,2,5,7,2,13,9,4,22
FC Botosani,1933,3,5,4,5,7,12,-5,19
Universitate,1933,4,3,7,4,14,18,-4,16
D Bucuresti,1933,5,3,4,7,18,22,-4,13
Concordia Ch,1933,6,3,2,9,18,24,-6,11
FCSB,1934,1,7,6,1,23,11,12,27
CFR Cluj,1934,2,6,7,1,16,9,7,25
D Bucuresti,1934,3,4,4,6,20,22,-2,16
Universitate,1934,4,3,7,4,16,20,-4,16
Concordia Ch,1934,5,4,2,8,19,22,-3,14
FC Botosani,1934,6,3,4,7,7,17,-10,13
FCSB,1935,1,9,5,0,29,12,17,32
CFR Cluj,1935,2,5,7,2,14,11,3,22
D Bucuresti,1935,3,4,5,5,19,20,-1,17
Universitate,1935,4,3,6,5,15,20,-5,15
FC Botosani,1935,5,3,6,5,6,13,-7,15
Concordia Ch,1935,6,2,3,9,16,23,-7,9
FCSB,1936,1,9,5,0,29,11,18,32
CFR Cluj,1936,2,5,6,3,13,12,1,21
FC Botosani,1936,3,5,4,5,10,12,-2,19
Universitate,1936,4,4,5,5,16,20,-4,17
D Bucuresti,1936,5,4,4,6,20,22,-2,16
Concordia Ch,1936,6,2,2,10,16,27,-11,8
FCSB,1937,1,8,6,0,25,11,14,30
CFR Cluj,1937,2,5,8,1,16,10,6,23
FC Botosani,1937,3,5,4,5,11,13,-2,19
Universitate,1937,4,3,6,5,16,21,-5,15
D Bucuresti,1937,5,3,5,6,17,23,-6,14
Concordia Ch,1937,6,2,3,9,17,24,-7,9
FCSB,1938,1,8,5,1,26,13,13,29
CFR Cluj,1938,2,5,6,3,14,11,3,21
Universitate,1938,3,5,5,4,18,19,-1,20
FC Botosani,1938,4,5,4,5,7,12,-5,19
D Bucuresti,1938,5,3,5,6,16,19,-3,14
Concordia Ch,1938,6,2,3,9,15,22,-7,9
FCSB,1939,1,7,7,0,26,13,13,28
CFR Cluj,1939,2,6,7,1,18,10,8,25
D Bucuresti,1939,3,4,5,5,20,20,0,17
FC Botosani,1939,4,4,4,6,9,16,-7,16
Universitate,1939,5,3,6,5,18,24,-6,15
Concordia Ch,1939,6,2,3,9,17,25,-8,9
CFR Cluj,1940,1,7,6,1,19,9,10,27
FCSB,1940,2,7,5,2,25,16,9,26
D Bucuresti,1940,3,4,5,5,19,19,0,17
Universitate,1940,4,4,5,5,15,19,-4,17
FC Botosani,1940,5,3,5,6,6,14,-8,14
Concordia Ch,1940,6,3,2,9,18,25,-7,11
FCSB,1941,1,8,5,1,31,17,14,29
CFR Cluj,1941,2,5,6,3,16,16,0,21
Universitate,1941,3,5,5,4,20,19,1,20
D Bucuresti,1941,4,5,4,5,22,18,4,19
FC Botosani,1941,5,4,4,6,8,17,-9,16
Concordia Ch,1941,6,2,2,10,15,25,-10,8
FCSB,1942,1,8,5,1,25,14,11,29
CFR Cluj,1942,2,5,7,2,16,11,5,22
Universitate,1942,3,4,6,4,19,20,-1,18
D Bucuresti,1942,4,4,4,6,19,23,-4,16
FC Botosani,1942,5,4,4,6,7,15,-8,16
Concordia Ch,1942,6,3,2,9,19,22,-3,11
FCSB,1943,1,8,5,1,27,14,13,29
CFR Cluj,1943,2,6,6,2,15,8,7,24
Universitate,1943,3,4,5,5,18,23,-5,17
FC Botosani,1943,4,4,5,5,6,12,-6,17
D Bucuresti,1943,5,3,5,6,17,20,-3,14
Concordia Ch,1943,6,2,4,8,16,22,-6,10
FCSB,1944,1,7,6,1,25,15,10,27
CFR Cluj,1944,2,6,7,1,17,10,7,25
D Bucuresti,1944,3,5,4,5,21,19,2,19
Universitate,1944,4,4,5,5,18,20,-2,17
FC Botosani,1944,5,3,5,6,5,15,-10,14
Concordia Ch,1944,6,2,3,9,16,23,-7,9
FCSB,1945,1,8,5,1,26,12,14,29
CFR Cluj,1945,2,7,6,1,17,8,9,27
D Bucuresti,1945,3,4,4,6,17,21,-4,16
FC Botosani,1945,4,4,4,6,8,14,-6,16
Universitate,1945,5,3,5,6,16,24,-8,14
Concordia Ch,1945,6,3,2,9,17,22,-5,11
FCSB,1946,1,8,5,1,25,12,13,29
CFR Cluj,1946,2,6,6,2,14,8,6,24
Universitate,1946,3,4,5,5,16,20,-4,17
D Bucuresti,1946,4,4,4,6,18,21,-3,16
FC Botosani,1946,5,4,4,6,8,15,-7,16
Concordia Ch,1946,6,3,2,9,20,25,-5,11
FCSB,1947,1,9,5,0,26,10,16,32
CFR Cluj,1947,2,5,6,3,14,10,4,21
FC Botosani,1947,3,5,4,5,8,13,-5,19
Universitate,1947,4,4,5,5,16,21,-5,17
D Bucuresti,1947,5,3,4,7,17,22,-5,13
Concordia Ch,1947,6,3,2,9,17,22,-5,11
FCSB,1948,1,7,5,2,24,13,11,26
CFR Cluj,1948,2,6,7,1,16,9,7,25
D Bucuresti,1948,3,5,4,5,22,21,1,19
Universitate,1948,4,4,6,4,16,19,-3,18
FC Botosani,1948,5,3,5,6,8,16,-8,14
Concordia Ch,1948,6,2,3,9,15,23,-8,9
FCSB,1949,1,8,6,0,26,10,16,30
CFR Cluj,1949,2,6,7,1,14,7,7,25
D Bucuresti,1949,3,5,4,5,20,20,0,19
FC Botosani,1949,4,4,4,6,7,14,-7,16
Universitate,1949,5,3,5,6,14,22,-8,14
Concordia Ch,1949,6,2,2,10,16,24,-8,8
FCSB,1950,1,9,5,0,29,12,17,32
CFR Cluj,1950,2,6,6,2,15,10,5,24
D Bucuresti,1950,3,4,4,6,17,19,-2,16
Concordia Ch,1950,4,4,2,8,18,22,-4,14
Universitate,1950,5,3,5,6,15,22,-7,14
FC Botosani,1950,6,3,4,7,6,15,-9,13
FCSB,1951,1,8,6,0,26,10,16,30
CFR Cluj,1951,2,5,8,1,13,7,6,23
D Bucuresti,1951,3,4,5,5,19,20,-1,17
Universitate,1951,4,3,6,5,14,21,-7,15
FC Botosani,1951,5,3,5,6,8,16,-8,14
Concordia Ch,1951,6,2,4,8,18,24,-6,10
FCSB,1952,1,8,6,0,27,12,15,30
CFR Cluj,1952,2,6,6,2,14,9,5,24
D Bucuresti,1952,3,3,6,5,18,20,-2,15
Universitate,1952,4,3,6,5,16,21,-5,15
FC Botosani,1952,5,3,6,5,6,13,-7,15
Concordia Ch,1952,6,2,4,8,16,22,-6,10
FCSB,1953,1,8,6,0,26,11,15,30
CFR Cluj,1953,2,6,7,1,16,7,9,25
D Bucuresti,1953,3,3,5,6,16,19,-3,14
Concordia Ch,1953,4,4,2,8,18,22,-4,14
FC Botosani,1953,5,3,5,6,6,14,-8,14
Universitate,1953,6,3,5,6,15,24,-9,14
FCSB,1954,1,8,5,1,27,14,13,29
CFR Cluj,1954,2,5,7,2,13,8,5,22
Universitate,1954,3,4,6,4,18,21,-3,18
Concordia Ch,1954,4,4,2,8,18,21,-3,14
D Bucuresti,1954,5,3,5,6,16,19,-3,14
FC Botosani,1954,6,3,5,6,5,14,-9,14
FCSB,1955,1,7,6,1,23,12,11,27
CFR Cluj,1955,2,6,6,2,15,9,6,24
Universitate,1955,3,4,6,4,16,18,-2,18
D Bucuresti,1955,4,4,4,6,18,21,-3,16
FC Botosani,1955,5,4,4,6,7,14,-7,16
Concordia Ch,1955,6,3,2,9,19,24,-5,11
FCSB,1956,1,8,5,1,25,12,13,29
CFR Cluj,1956,2,7,6,1,17,7,10,27
FC Botosani,1956,3,4,5,5,6,12,-6,17
D Bucuresti,1956,4,3,6,5,16,18,-2,15
Universitate,1956,5,3,5,6,15,23,-8,14
Concordia Ch,1956,6,2,3,9,15,22,-7,9
FCSB,1957,1,9,5,0,25,10,15,32
CFR Cluj,1957,2,6,6,2,15,9,6,24
D Bucuresti,1957,3,5,4,5,20,20,0,19
Universitate,1957,4,3,5,6,15,21,-6,14
FC Botosani,1957,5,3,5,6,8,16,-8,14
Concordia Ch,1957,6,2,3,9,18,25,-7,9
FCSB,1958,1,8,5,1,26,12,14,29
CFR Cluj,1958,2,6,7,1,15,7,8,25
D Bucuresti,1958,3,4,4,6,18,19,-1,16
FC Botosani,1958,4,4,4,6,7,14,-7,16
Universitate,1958,5,3,6,5,14,21,-7,15
Concordia Ch,1958,6,3,2,9,16,23,-7,11
CFR Cluj,1959,1,7,6,1,17,8,9,27
FCSB,1959,2,7,5,2,26,15,11,26
FC Botosani,1959,3,4,5,5,9,13,-4,17
Universitate,1959,4,4,5,5,17,22,-5,17
D Bucuresti,1959,5,3,5,6,17,22,-5,14
Concordia Ch,1959,6,3,2,9,18,24,-6,11
FCSB,1960,1,8,6,0,27,11,16,30
CFR Cluj,1960,2,6,7,1,16,8,8,25
D Bucuresti,1960,3,5,4,5,21,20,1,19
Universitate,1960,4,3,5,6,14,23,-9,14
FC Botosani,1960,5,3,4,7,6,16,-10,13
Concordia Ch,1960,6,3,2,9,19,25,-6,11
FCSB,1961,1,9,5,0,27,11,16,32
CFR Cluj,1961,2,6,6,2,16,10,6,24
FC Botosani,1961,3,4,4,6,9,18,-9,16
D Bucuresti,1961,4,3,5,6,19,22,-3,14
Universitate,1961,5,3,5,6,16,23,-7,14
Concordia Ch,1961,6,3,3,8,20,23,-3,12
FCSB,1962,1,7,7,0,25,12,13,28
CFR Cluj,1962,2,5,7,2,16,11,5,22
Universitate,1962,3,4,6,4,18,21,-3,18
D Bucuresti,1962,4,4,4,6,18,20,-2,16
FC Botosani,1962,5,3,5,6,6,15,-9,14
Concordia Ch,1962,6,3,3,8,18,22,-4,12
FCSB,1963,1,8,5,1,27,13,14,29
CFR Cluj,1963,2,6,6,2,15,10,5,24
FC Botosani,1963,3,5,4,5,9,13,-4,19
Universitate,1963,4,4,5,5,16,20,-4,17
D Bucuresti,1963,5,3,4,7,17,21,-4,13
Concordia Ch,1963,6,3,2,9,16,23,-7,11
FCSB,1964,1,8,5,1,26,11,15,29
CFR Cluj,1964,2,5,7,2,14,11,3,22
D Bucuresti,1964,3,5,4,5,20,18,2,19
Universitate,1964,4,4,6,4,16,19,-3,18
FC Botosani,1964,5,3,5,6,6,14,-8,14
Concordia Ch,1964,6,2,3,9,16,25,-9,9
FCSB,1965,1,8,5,1,27,13,14,29
CFR Cluj,1965,2,6,7,1,14,7,7,25
D Bucuresti,1965,3,3,6,5,19,21,-2,15
Universitate,1965,4,3,6,5,16,22,-6,15
FC Botosani,1965,5,3,6,5,8,15,-7,15
Concordia Ch,1965,6,2,4,8,19,25,-6,10
FCSB,1966,1,8,6,0,27,11,16,30
CFR Cluj,1966,2,6,7,1,15,8,7,25
D Bucuresti,1966,3,4,4,6,22,21,1,16
Universitate,1966,4,3,5,6,16,24,-8,14
FC Botosani,1966,5,3,5,6,6,17,-11,14
Concordia Ch,1966,6,3,3,8,19,24,-5,12
CFR Cluj,1967,1,7,6,1,19,9,10,27
FCSB,1967,2,7,5,2,24,15,9,26
Universitate,1967,3,4,5,5,16,20,-4,17
FC Botosani,1967,4,4,5,5,7,13,-6,17
D Bucuresti,1967,5,3,6,5,17,19,-2,15
Concordia Ch,1967,6,2,3,9,17,24,-7,9
FCSB,1968,1,7,6,1,24,13,11,27
CFR Cluj,1968,2,6,6,2,16,9,7,24
Universitate,1968,3,4,6,4,17,20,-3,18
D Bucuresti,1968,4,4,5,5,20,20,0,17
FC Botosani,1968,5,3,4,7,6,16,-10,13
Concordia Ch,1968,6,3,3,8,19,24,-5,12
FCSB,1969,1,8,5,1,27,14,13,29
CFR Cluj,1969,2,5,7,2,15,10,5,22
Universitate,1969,3,4,6,4,18,21,-3,18
D Bucuresti,1969,4,4,5,5,19,20,-1,17
FC Botosani,1969,5,4,5,5,8,14,-6,17
Concordia Ch,1969,6,2,2,10,17,25,-8,8
FCSB,1970,1,8,5,1,25,11,14,29
CFR Cluj,1970,2,6,7,1,14,7,7,25
D Bucuresti,1970,3,4,4,6,18,20,-2,16
Universitate,1970,4,3,6,5,14,20,-6,15
Concordia Ch,1970,5,4,2,8,19,23,-4,14
FC Botosani,1970,6,3,4,7,8,17,-9,13
FCSB,1971,1,7,7,0,26,13,13,28
CFR Cluj,1971,2,5,8,1,16,10,6,23
D Bucuresti,1971,3,4,5,5,19,20,-1,17
Universitate,1971,4,3,7,4,16,20,-4,16
FC Botosani,1971,5,3,5,6,7,16,-9,14
Concordia Ch,1971,6,3,2,9,19,24,-5,11
FCSB,1972,1,8,5,1,24,11,13,29
CFR Cluj,1972,2,6,6,2,14,8,6,24
Universitate,1972,3,4,5,5,15,19,-4,17
D Bucuresti,1972,4,4,4,6,19,22,-3,16
FC Botosani,1972,5,4,4,6,9,13,-4,16
Concordia Ch,1972,6,3,2,9,16,24,-8,11
FCSB,1973,1,8,6,0,28,11,17,30
CFR Cluj,1973,2,6,7,1,16,9,7,25
FC Botosani,1973,3,4,5,5,7,13,-6,17
D Bucuresti,1973,4,3,5,6,18,21,-3,14
Universitate,1973,5,3,5,6,15,24,-9,14
Concordia Ch,1973,6,3,2,9,17,23,-6,11
FCSB,1974,1,8,5,1,27,11,16,29
CFR Cluj,1974,2,6,6,2,15,11,4,24
Universitate,1974,3,4,5,5,15,20,-5,17
D Bucuresti,1974,4,4,4,6,20,23,-3,16
FC Botosani,1974,5,4,4,6,8,15,-7,16
Concordia Ch,1974,6,3,2,9,18,23,-5,11
FCSB,1975,1,7,6,1,26,14,12,27
CFR Cluj,1975,2,5,7,2,16,11,5,22
Universitate,1975,3,5,5,4,18,20,-2,20
D Bucuresti,1975,4,4,4,6,18,21,-3,16
FC Botosani,1975,5,3,5,6,5,14,-9,14
Concordia Ch,1975,6,3,3,8,18,21,-3,12
FCSB,1976,1,8,6,0,25,11,14,30
CFR Cluj,1976,2,5,7,2,13,8,5,22
D Bucuresti,1976,3,4,4,6,20,22,-2,16
Universitate,1976,4,3,7,4,15,19,-4,16
Concordia Ch,1976,5,4,2,8,20,23,-3,14
FC Botosani,1976,6,3,4,7,5,15,-10,13
FCSB,1977,1,8,6,0,27,12,15,30
CFR Cluj,1977,2,5,6,3,14,11,3,21
Universitate,1977,3,4,6,4,16,19,-3,18
FC Botosani,1977,4,4,5,5,8,13,-5,17
D Bucuresti,1977,5,3,5,6,18,22,-4,14
Concordia Ch,1977,6,3,2,9,18,24,-6,11
CFR Cluj,1978,1,7,6,1,21,10,11,27
FCSB,1978,2,7,5,2,24,16,8,26
Universitate,1978,3,4,5,5,17,21,-4,17
D Bucuresti,1978,4,4,4,6,20,20,0,16
FC Botosani,1978,5,4,4,6,8,15,-7,16
Concordia Ch,1978,6,3,2,9,17,25,-8,11
FCSB,1979,1,8,5,1,26,13,13,29
CFR Cluj,1979,2,6,6,2,16,9,7,24
Universitate,1979,3,4,5,5,16,21,-5,17
D Bucuresti,1979,4,4,4,6,19,20,-1,16
Concordia Ch,1979,5,4,2,8,19,23,-4,14
FC Botosani,1979,6,3,4,7,6,16,-10,13
FCSB,1980,1,8,5,1,30,15,15,29
CFR Cluj,1980,2,6,6,2,15,13,2,24
D Bucuresti,1980,3,4,5,5,20,19,1,17
Universitate,1980,4,4,5,5,18,20,-2,17
FC Botosani,1980,5,3,5,6,6,16,-10,14
Concordia Ch,1980,6,2,4,8,17,23,-6,10
FCSB,1981,1,8,6,0,26,11,15,30
CFR Cluj,1981,2,6,7,1,15,8,7,25
FC Botosani,1981,3,3,6,5,7,14,-7,15
D Bucuresti,1981,4,3,5,6,17,20,-3,14
Universitate,1981,5,3,5,6,14,21,-7,14
Concordia Ch,1981,6,3,3,8,17,22,-5,12
FCSB,1982,1,8,5,1,26,13,13,29
CFR Cluj,1982,2,5,6,3,15,12,3,21
Universitate,1982,3,5,5,4,18,19,-1,20
D Bucuresti,1982,4,3,6,5,18,20,-2,15
FC Botosani,1982,5,3,5,6,5,14,-9,14
Concordia Ch,1982,6,3,3,8,19,23,-4,12
FCSB,1983,1,8,5,1,25,14,11,29
CFR Cluj,1983,2,6,6,2,16,8,8,24
Universitate,1983,3,4,5,5,16,20,-4,17
D Bucuresti,1983,4,4,4,6,19,21,-2,16
FC Botosani,1983,5,4,4,6,8,15,-7,16
Concordia Ch,1983,6,3,2,9,18,24,-6,11
FCSB,1984,1,8,5,1,25,12,13,29
CFR Cluj,1984,2,6,6,2,17,11,6,24
Universitate,1984,3,4,5,5,17,21,-4,17
FC Botosani,1984,4,4,4,6,7,14,-7,16
D Bucuresti,1984,5,3,5,6,16,20,-4,14
Concordia Ch,1984,6,3,3,8,17,21,-4,12
CFR Cluj,1985,1,7,6,1,17,9,8,27
FCSB,1985,2,7,5,2,25,16,9,26
D Bucuresti,1985,3,5,4,5,20,19,1,19
Universitate,1985,4,4,5,5,19,21,-2,17
FC Botosani,1985,5,3,5,6,5,14,-9,14
Concordia Ch,1985,6,2,3,9,16,23,-7,9
FCSB,1986,1,8,6,0,27,12,15,30
CFR Cluj,1986,2,6,6,2,16,11,5,24
D Bucuresti,1986,3,5,4,5,20,18,2,19
Universitate,1986,4,3,6,5,18,23,-5,15
FC Botosani,1986,5,3,4,7,5,18,-13,13
Concordia Ch,1986,6,3,2,9,18,22,-4,11
FCSB,1987,1,8,5,1,26,12,14,29
CFR Cluj,1987,2,6,7,1,16,8,8,25
D Bucuresti,1987,3,4,5,5,18,19,-1,17
FC Botosani,1987,4,4,5,5,7,13,-6,17
Universitate,1987,5,3,6,5,15,22,-7,15
Concordia Ch,1987,6,2,2,10,17,25,-8,8
FCSB,1988,1,8,5,1,25,11,14,29
CFR Cluj,1988,2,5,7,2,13,9,4,22
Universitate,1988,3,4,6,4,15,18,-3,18
D Bucuresti,1988,4,4,4,6,19,20,-1,16
FC Botosani,1988,5,3,5,6,5,15,-10,14
Concordia Ch,1988,6,3,3,8,17,21,-4,12
FCSB,1989,1,8,6,0,27,12,15,30
CFR Cluj,1989,2,6,7,1,17,9,8,25
D Bucuresti,1989,3,5,4,5,20,19,1,19
Universitate,1989,4,3,5,6,14,22,-8,14
FC Botosani,1989,5,3,4,7,7,16,-9,13
Concordia Ch,1989,6,3,2,9,17,24,-7,11
FCSB,1990,1,7,5,2,24,15,9,26
CFR Cluj,1990,2,6,6,2,17,9,8,24
Universitate,1990,3,5,5,4,18,20,-2,20
Concordia Ch,1990,4,4,2,8,21,22,-1,14
D Bucuresti,1990,5,3,5,6,19,24,-5,14
FC Botosani,1990,6,3,5,6,7,16,-9,14
FCSB,1991,1,8,5,1,26,12,14,29
CFR Cluj,1991,2,5,7,2,15,11,4,22
Universitate,1991,3,4,6,4,18,21,-3,18
D Bucuresti,1991,4,4,4,6,18,19,-1,16
FC Botosani,1991,5,4,4,6,7,15,-8,16
Concordia Ch,1991,6,3,2,9,17,23,-6,11
FCSB,1992,1,8,5,1,25,13,12,29
CFR Cluj,1992,2,6,6,2,16,9,7,24
Universitate,1992,3,4,5,5,16,20,-4,17
FC Botosani,1992,4,3,6,5,7,14,-7,15
D Bucuresti,1992,5,3,5,6,19,22,-3,14
Concordia Ch,1992,6,3,3,8,17,22,-5,12
FCSB,1993,1,8,6,0,25,10,15,30
CFR Cluj,1993,2,6,6,2,14,9,5,24
D Bucuresti,1993,3,4,4,6,18,20,-2,16
FC Botosani,1993,4,4,4,6,7,13,-6,16
Universitate,1993,5,3,6,5,14,19,-5,15
Concordia Ch,1993,6,3,2,9,17,24,-7,11
FCSB,1994,1,8,5,1,25,11,14,29
CFR Cluj,1994,2,7,6,1,15,7,8,27
D Bucuresti,1994,3,5,4,5,20,19,1,19
Universitate,1994,4,3,5,6,14,21,-7,14
FC Botosani,1994,5,3,4,7,5,17,-12,13
Concordia Ch,1994,6,3,2,9,19,23,-4,11
FCSB,1995,1,7,6,1,27,19,8,27
CFR Cluj,1995,2,6,7,1,20,13,7,25
Universitate,1995,3,4,5,5,21,21,0,17
D Bucuresti,1995,4,4,4,6,19,20,-1,16
FC Botosani,1995,5,3,5,6,6,15,-9,14
Concordia Ch,1995,6,3,3,8,18,23,-5,12
CFR Cluj,1996,1,7,6,1,18,7,11,27
FCSB,1996,2,7,5,2,24,14,10,26
D Bucuresti,1996,3,4,5,5,17,18,-1,17
Universitate,1996,4,4,5,5,16,22,-6,17
FC Botosani,1996,5,4,5,5,7,13,-6,17
Concordia Ch,1996,6,2,2,10,16,24,-8,8
FCSB,1997,1,7,7,0,25,12,13,28
CFR Cluj,1997,2,5,7,2,13,8,5,22
Universitate,1997,3,4,6,4,17,20,-3,18
D Bucuresti,1997,4,4,4,6,20,22,-2,16
FC Botosani,1997,5,4,4,6,8,14,-6,16
Concordia Ch,1997,6,3,2,9,20,27,-7,11
CFR Cluj,1998,1,7,6,1,20,9,11,27
FCSB,1998,2,7,6,1,24,14,10,27
FC Botosani,1998,3,4,5,5,8,14,-6,17
Universitate,1998,4,3,6,5,15,21,-6,15
D Bucuresti,1998,5,3,4,7,17,21,-4,13
Concordia Ch,1998,6,3,3,8,17,22,-5,12
FCSB,1999,1,8,6,0,26,12,14,30
CFR Cluj,1999,2,5,7,2,14,10,4,22
D Bucuresti,1999,3,4,5,5,19,20,-1,17
Universitate,1999,4,4,5,5,17,20,-3,17
FC Botosani,1999,5,3,6,5,6,13,-7,15
Concordia Ch,1999,6,2,3,9,18,25,-7,9
FCSB,2000,1,7,5,2,23,12,11,26
CFR Cluj,2000,2,6,6,2,16,10,6,24
Universitate,2000,3,5,5,4,18,20,-2,20
D Bucuresti,2000,4,4,5,5,19,19,0,17
FC Botosani,2000,5,4,5,5,6,12,-6,17
Concordia Ch,2000,6,2,2,10,16,25,-9,8
FCSB,2001,1,9,5,0,25,10,15,32
CFR Cluj,2001,2,6,6,2,14,8,6,24
FC Botosani,2001,3,4,4,6,7,14,-7,16
D Bucuresti,2001,4,3,5,6,17,20,-3,14
Universitate,2001,5,3,5,6,14,20,-6,14
Concordia Ch,2001,6,3,3,8,18,23,-5,12
FCSB,2002,1,8,6,0,27,12,15,30
CFR Cluj,2002,2,5,7,2,14,10,4,22
D Bucuresti,2002,3,4,5,5,20,21,-1,17
Universitate,2002,4,4,5,5,17,21,-4,17
FC Botosani,2002,5,4,5,5,8,14,-6,17
Concordia Ch,2002,6,2,2,10,16,24,-8,8
FCSB,2003,1,9,5,0,26,11,15,32
CFR Cluj,2003,2,6,6,2,15,9,6,24
FC Botosani,2003,3,4,5,5,6,12,-6,17
D Bucuresti,2003,4,3,5,6,18,21,-3,14
Universitate,2003,5,3,5,6,16,22,-6,14
Concordia Ch,2003,6,2,4,8,17,23,-6,10
FCSB,2004,1,7,5,2,24,13,11,26
CFR Cluj,2004,2,6,6,2,15,10,5,24
Universitate,2004,3,5,5,4,17,18,-1,20
FC Botosani,2004,4,4,5,5,7,13,-6,17
D Bucuresti,2004,5,3,6,5,19,21,-2,15
Concordia Ch,2004,6,2,3,9,17,24,-7,9
FCSB,2005,1,7,5,2,24,15,9,26
CFR Cluj,2005,2,6,7,1,16,8,8,25
Universitate,2005,3,4,6,4,16,18,-2,18
D Bucuresti,2005,4,4,5,5,20,19,1,17
FC Botosani,2005,5,4,4,6,9,15,-6,16
Concordia Ch,2005,6,2,3,9,16,26,-10,9
FCSB,2006,1,8,5,1,29,15,14,29
CFR Cluj,2006,2,7,6,1,19,10,9,27
D Bucuresti,2006,3,4,4,6,18,20,-2,16
Concordia Ch,2006,4,4,2,8,18,21,-3,14
Universitate,2006,5,3,5,6,15,23,-8,14
FC Botosani,2006,6,3,4,7,5,15,-10,13
FCSB,2007,1,7,6,1,25,13,12,27
CFR Cluj,2007,2,6,7,1,19,8,11,25
Universitate,2007,3,4,5,5,16,24,-8,17
D Bucuresti,2007,4,4,4,6,19,22,-3,16
Concordia Ch,2007,5,4,2,8,19,22,-3,14
FC Botosani,2007,6,3,4,7,6,15,-9,13
FCSB,2008,1,8,6,0,25,11,14,30
CFR Cluj,2008,2,5,7,2,14,9,5,22
D Bucuresti,2008,3,4,4,6,20,20,0,16
Universitate,2008,4,3,7,4,14,18,-4,16
Concordia Ch,2008,5,4,2,8,17,21,-4,14
FC Botosani,2008,6,3,4,7,6,17,-11,13
FCSB,2009,1,8,6,0,26,12,14,30
CFR Cluj,2009,2,5,7,2,15,10,5,22
D Bucuresti,2009,3,4,4,6,20,22,-2,16
Universitate,2009,4,3,7,4,16,20,-4,16
Concordia Ch,2009,5,4,2,8,20,23,-3,14
FC Botosani,2009,6,3,4,7,5,15,-10,13
FCSB,2010,1,7,6,1,23,13,10,27
CFR Cluj,2010,2,5,8,1,15,9,6,23
Universitate,2010,3,4,6,4,19,20,-1,18
FC Botosani,2010,4,3,6,5,9,16,-7,15
D Bucuresti,2010,5,3,5,6,19,23,-4,14
Concordia Ch,2010,6,3,3,8,18,22,-4,12
FCSB,2011,1,7,6,1,25,13,12,27
CFR Cluj,2011,2,5,8,1,14,8,6,23
FC Botosani,2011,3,5,4,5,10,14,-4,19
Universitate,2011,4,4,6,4,16,19,-3,18
D Bucuresti,2011,5,4,4,6,20,21,-1,16
Concordia Ch,2011,6,2,2,10,17,27,-10,8
CFR Cluj,2012,1,7,6,1,16,7,9,27
FCSB,2012,2,7,5,2,23,12,11,26
D Bucuresti,2012,3,5,4,5,21,18,3,19
Universitate,2012,4,4,5,5,15,20,-5,17
FC Botosani,2012,5,4,4,6,7,15,-8,16
Concordia Ch,2012,6,2,2,10,16,26,-10,8
FCSB,2013,1,9,5,0,28,10,18,32
CFR Cluj,2013,2,5,7,2,13,9,4,22
FC Botosani,2013,3,4,5,5,7,13,-6,17
D Bucuresti,2013,4,4,4,6,17,19,-2,16
Universitate,2013,5,3,6,5,14,21,-7,15
Concordia Ch,2013,6,2,3,9,16,23,-7,9
FCSB,2014,1,8,6,0,26,12,14,30
CFR Cluj,2014,2,5,7,2,14,10,4,22
Universitate,2014,3,4,5,5,17,20,-3,17
D Bucuresti,2014,4,3,5,6,21,24,-3,14
Concordia Ch,2014,5,4,2,8,18,22,-4,14
FC Botosani,2014,6,3,5,6,9,17,-8,14
FCSB,2015,1,8,6,0,25,11,14,30
CFR Cluj,2015,2,5,7,2,16,11,5,22
D Bucuresti,2015,3,4,5,5,19,20,-1,17
Universitate,2015,4,4,5,5,17,21,-4,17
FC Botosani,2015,5,4,4,6,8,15,-7,16
Concordia Ch,2015,6,2,3,9,15,22,-7,9
FCSB,2016,1,7,6,1,23,12,11,27
CFR Cluj,2016,2,5,7,2,13,8,5,22
Universitate,2016,3,5,5,4,17,18,-1,20
D Bucuresti,2016,4,4,5,5,18,19,-1,17
FC Botosani,2016,5,3,5,6,6,14,-8,14
Concordia Ch,2016,6,3,2,9,16,22,-6,11
FCSB,2017,1,8,5,1,24,11,13,29
CFR Cluj,2017,2,6,7,1,14,7,7,25
FC Botosani,2017,3,5,4,5,7,12,-5,19
Universitate,2017,4,3,6,5,14,19,-5,15
D Bucuresti,2017,5,3,4,7,16,20,-4,13
Concordia Ch,2017,6,3,2,9,16,22,-6,11
FCSB,2018,1,9,5,0,25,10,15,32
CFR Cluj,2018,2,6,6,2,15,9,6,24
D Bucuresti,2018,3,4,4,6,18,21,-3,16
FC Botosani,2018,4,4,4,6,9,14,-5,16
Universitate,2018,5,3,5,6,15,21,-6,14
Concordia Ch,2018,6,3,2,9,17,24,-7,11
FCSB,2019,1,7,7,0,26,13,13,28
CFR Cluj,2019,2,6,7,1,17,9,8,25
FC Botosani,2019,3,5,4,5,10,13,-3,19
Universitate,2019,4,3,6,5,15,21,-6,15
D Bucuresti,2019,5,3,4,7,19,27,-8,13
Concordia Ch,2019,6,3,2,9,20,24,-4,11
FCSB,2020,1,8,5,1,29,15,14,29
CFR Cluj,2020,2,5,6,3,17,14,3,21
Universitate,2020,3,5,5,4,18,20,-2,20
FC Botosani,2020,4,4,5,5,8,14,-6,17
D Bucuresti,2020,5,3,5,6,17,20,-3,14
Concordia Ch,2020,6,3,2,9,17,23,-6,11
FCSB,2021,1,9,5,0,29,11,18,32
CFR Cluj,2021,2,5,7,2,13,10,3,22
D Bucuresti,2021,3,4,5,5,17,18,-1,17
Universitate,2021,4,3,6,5,15,21,-6,15
FC Botosani,2021,5,3,4,7,5,15,-10,13
Concordia Ch,2021,6,3,3,8,17,21,-4,12
FCSB,2022,1,9,5,0,27,10,17,32
CFR Cluj,2022,2,6,6,2,14,9,5,24
Concordia Ch,2022,3,4,2,8,20,22,-2,14
D Bucuresti,2022,4,3,5,6,17,22,-5,14
Universitate,2022,5,3,5,6,14,21,-7,14
FC Botosani,2022,6,3,5,6,7,15,-8,14
FCSB,2023,1,7,6,1,25,14,11,27
CFR Cluj,2023,2,5,8,1,14,8,6,23
Universitate,2023,3,4,6,4,17,19,-2,18
D Bucuresti,2023,4,4,5,5,18,18,0,17
FC Botosani,2023,5,3,5,6,6,15,-9,14
Concordia Ch,2023,6,2,4,8,16,22,-6,10
FCSB,2024,1,8,5,1,26,12,14,29
CFR Cluj,2024,2,6,6,2,14,10,4,24
Universitate,2024,3,4,5,5,16,19,-3,17
D Bucuresti,2024,4,4,4,6,18,22,-4,16
FC Botosani,2024,5,3,5,6,6,15,-9,14
Concordia Ch,2024,6,3,3,8,20,22,-2,12
FCSB,2025,1,7,6,1,26,14,12,27
CFR Cluj,2025,2,7,6,1,17,7,10,27
FC Botosani,2025,3,4,5,5,8,13,-5,17
Universitate,2025,4,3,6,5,17,24,-7,15
D Bucuresti,2025,5,3,5,6,16,20,-4,14
Concordia Ch,2025,6,3,2,9,18,24,-6,11
FCSB,2026,1,8,6,0,27,11,16,30
CFR Cluj,2026,2,5,7,2,13,10,3,22
D Bucuresti,2026,3,5,4,5,20,19,1,19
Universitate,2026,4,3,7,4,15,19,-4,16
FC Botosani,2026,5,3,5,6,6,14,-8,14
Concordia Ch,2026,6,2,3,9,15,23,-8,9
FCSB,2027,1,9,5,0,28,11,17,32
CFR Cluj,2027,2,5,6,3,16,14,2,21
D Bucuresti,2027,3,5,4,5,18,18,0,19
Universitate,2027,4,4,5,5,17,21,-4,17
FC Botosani,2027,5,4,4,6,7,14,-7,16
Concordia Ch,2027,6,2,2,10,16,24,-8,8
FCSB,2028,1,7,7,0,27,14,13,28
CFR Cluj,2028,2,5,7,2,15,11,4,22
D Bucuresti,2028,3,5,4,5,19,19,0,19
Universitate,2028,4,4,6,4,18,20,-2,18
FC Botosani,2028,5,4,4,6,9,15,-6,16
Concordia Ch,2028,6,2,2,10,16,25,-9,8
FCSB,2029,1,8,6,0,25,11,14,30
CFR Cluj,2029,2,5,6,3,14,10,4,21
D Bucuresti,2029,3,5,4,5,20,20,0,19
Universitate,2029,4,4,6,4,15,18,-3,18
FC Botosani,2029,5,4,4,6,7,14,-7,16
Concordia Ch,2029,6,2,2,10,16,24,-8,8
FCSB,2030,1,8,6,0,25,10,15,30
CFR Cluj,2030,2,5,6,3,14,11,3,21
Universitate,2030,3,4,6,4,16,19,-3,18
D Bucuresti,2030,4,4,5,5,19,19,0,17
FC Botosani,2030,5,4,5,5,8,14,-6,17
Concordia Ch,2030,6,2,2,10,16,25,-9,8
FCSB,2031,1,8,5,1,28,16,12,29
CFR Cluj,2031,2,5,7,2,17,12,5,22
Universitate,2031,3,4,6,4,18,20,-2,18
D Bucuresti,2031,4,4,5,5,21,19,2,17
FC Botosani,2031,5,3,5,6,5,16,-11,14
Concordia Ch,2031,6,2,4,8,16,22,-6,10
FCSB,2032,1,8,6,0,25,11,14,30
CFR Cluj,2032,2,6,7,1,16,8,8,25
D Bucuresti,2032,3,3,6,5,18,20,-2,15
FC Botosani,2032,4,3,6,5,6,13,-7,15
Universitate,2032,5,3,5,6,16,23,-7,14
Concordia Ch,2032,6,2,4,8,18,24,-6,10
FCSB,2033,1,7,7,0,23,10,13,28
CFR Cluj,2033,2,6,7,1,14,7,7,25
D Bucuresti,2033,3,4,4,6,20,20,0,16
Universitate,2033,4,3,6,5,14,19,-5,15
FC Botosani,2033,5,3,5,6,7,17,-10,14
Concordia Ch,2033,6,3,3,8,19,24,-5,12
FCSB,2034,1,8,5,1,28,12,16,29
CFR Cluj,2034,2,5,6,3,13,12,1,21
Universitate,2034,3,5,5,4,17,19,-2,20
D Bucuresti,2034,4,4,5,5,19,19,0,17
FC Botosani,2034,5,4,4,6,8,14,-6,16
Concordia Ch,2034,6,2,3,9,16,25,-9,9
FCSB,2035,1,9,5,0,26,10,16,32
CFR Cluj,2035,2,5,7,2,14,9,5,22
D Bucuresti,2035,3,4,5,5,18,18,0,17
FC Botosani,2035,4,4,5,5,6,12,-6,17
Universitate,2035,5,3,6,5,15,21,-6,15
Concordia Ch,2035,6,2,2,10,15,24,-9,8
FCSB,2036,1,7,5,2,24,13,11,26
CFR Cluj,2036,2,6,6,2,15,9,6,24
Universitate,2036,3,5,5,4,18,20,-2,20
D Bucuresti,2036,4,4,4,6,19,20,-1,16
FC Botosani,2036,5,3,5,6,7,16,-9,14
Concordia Ch,2036,6,3,3,8,17,22,-5,12
FCSB,2037,1,8,6,0,25,11,14,30
CFR Cluj,2037,2,6,7,1,16,9,7,25
D Bucuresti,2037,3,4,4,6,19,19,0,16
FC Botosani,2037,4,4,4,6,7,14,-7,16
Universitate,2037,5,3,5,6,15,21,-6,14
Concordia Ch,2037,6,3,2,9,17,25,-8,11
FCSB,2038,1,8,6,0,25,11,14,30
CFR Cluj,2038,2,5,7,2,14,9,5,22
D Bucuresti,2038,3,5,4,5,20,19,1,19
Universitate,2038,4,4,5,5,15,19,-4,17
FC Botosani,2038,5,4,4,6,6,14,-8,16
Concordia Ch,2038,6,2,2,10,16,24,-8,8
FCSB,2039,1,8,5,1,24,11,13,29
CFR Cluj,2039,2,6,7,1,15,8,7,25
D Bucuresti,2039,3,4,4,6,18,20,-2,16
FC Botosani,2039,4,4,4,6,10,13,-3,16
Universitate,2039,5,3,6,5,15,20,-5,15
Concordia Ch,2039,6,3,2,9,17,27,-10,11
FCSB,2040,1,9,5,0,25,10,15,32
CFR Cluj,2040,2,5,6,3,13,10,3,21
D Bucuresti,2040,3,5,4,5,20,19,1,19
Universitate,2040,4,4,5,5,16,19,-3,17
FC Botosani,2040,5,3,5,6,7,16,-9,14
Concordia Ch,2040,6,2,3,9,18,25,-7,9
FCSB,2041,1,8,5,1,30,15,15,29
CFR Cluj,2041,2,6,6,2,17,12,5,24
FC Botosani,2041,3,5,4,5,7,12,-5,19
Universitate,2041,4,4,5,5,17,22,-5,17
D Bucuresti,2041,5,4,4,6,19,21,-2,16
Concordia Ch,2041,6,2,2,10,17,25,-8,8
FCSB,2042,1,9,5,0,27,11,16,32
CFR Cluj,2042,2,5,7,2,14,9,5,22
FC Botosani,2042,3,4,5,5,8,13,-5,17
Universitate,2042,4,3,6,5,16,22,-6,15
D Bucuresti,2042,5,3,4,7,16,21,-5,13
Concordia Ch,2042,6,3,3,8,17,22,-5,12
CFR Cluj,2043,1,7,6,1,16,8,8,27
FCSB,2043,2,7,5,2,24,14,10,26
FC Botosani,2043,3,5,4,5,10,12,-2,19
Universitate,2043,4,4,5,5,18,21,-3,17
D Bucuresti,2043,5,4,4,6,19,19,0,16
Concordia Ch,2043,6,2,2,10,15,28,-13,8
FCSB,2044,1,7,7,0,24,11,13,28
CFR Cluj,2044,2,6,7,1,17,8,9,25
FC Botosani,2044,3,5,4,5,10,12,-2,19
D Bucuresti,2044,4,4,4,6,17,21,-4,16
Universitate,2044,5,3,6,5,14,21,-7,15
Concordia Ch,2044,6,2,2,10,15,24,-9,8
FCSB,2045,1,7,6,1,24,13,11,27
CFR Cluj,2045,2,6,7,1,18,10,8,25
Universitate,2045,3,4,5,5,18,22,-4,17
FC Botosani,2045,4,4,5,5,6,12,-6,17
D Bucuresti,2045,5,3,6,5,16,18,-2,15
Concordia Ch,2045,6,2,3,9,15,22,-7,9
FCSB,2046,1,9,5,0,28,13,15,32
CFR Cluj,2046,2,5,7,2,14,9,5,22
D Bucuresti,2046,3,5,4,5,20,19,1,19
Universitate,2046,4,3,6,5,18,23,-5,15
FC Botosani,2046,5,3,4,7,6,18,-12,13
Concordia Ch,2046,6,3,2,9,18,22,-4,11
FCSB,2047,1,7,6,1,26,15,11,27
CFR Cluj,2047,2,6,7,1,18,11,7,25
D Bucuresti,2047,3,4,5,5,19,19,0,17
Universitate,2047,4,4,5,5,17,20,-3,17
FC Botosani,2047,5,4,5,5,7,13,-6,17
Concordia Ch,2047,6,2,2,10,15,24,-9,8
FCSB,2048,1,8,5,1,24,11,13,29
CFR Cluj,2048,2,5,7,2,13,8,5,22
D Bucuresti,2048,3,5,4,5,19,19,0,19
Universitate,2048,4,4,6,4,15,18,-3,18
FC Botosani,2048,5,4,4,6,8,14,-6,16
Concordia Ch,2048,6,2,2,10,15,24,-9,8
FCSB,2049,1,7,7,0,24,11,13,28
CFR Cluj,2049,2,6,7,1,15,7,8,25
FC Botosani,2049,3,4,5,5,7,13,-6,17
Universitate,2049,4,3,6,5,15,21,-6,15
D Bucuresti,2049,5,3,4,7,17,21,-4,13
Concordia Ch,2049,6,3,3,8,18,23,-5,12
FCSB,2050,1,7,7,0,26,13,13,28
CFR Cluj,2050,2,5,7,2,15,11,4,22
Universitate,2050,3,4,6,4,17,19,-2,18
D Bucuresti,2050,4,4,5,5,18,18,0,17
FC Botosani,2050,5,4,5,5,8,13,-5,17
Concordia Ch,2050,6,2,2,10,16,26,-10,8
FCSB,2051,1,8,6,0,25,11,14,30
CFR Cluj,2051,2,5,7,2,14,10,4,22
D Bucuresti,2051,3,4,5,5,19,20,-1,17
Universitate,2051,4,4,5,5,18,21,-3,17
FC Botosani,2051,5,3,4,7,6,15,-9,13
Concordia Ch,2051,6,3,3,8,19,24,-5,12
FCSB,2052,1,8,5,1,29,14,15,29
CFR Cluj,2052,2,7,6,1,20,10,10,27
FC Botosani,2052,3,4,5,5,7,12,-5,17
D Bucuresti,2052,4,3,5,6,16,20,-4,14
Universitate,2052,5,3,5,6,16,26,-10,14
Concordia Ch,2052,6,2,4,8,15,21,-6,10
FCSB,2053,1,8,6,0,26,11,15,30
CFR Cluj,2053,2,6,7,1,17,8,9,25
D Bucuresti,2053,3,4,4,6,17,19,-2,16
FC Botosani,2053,4,4,4,6,8,14,-6,16
Universitate,2053,5,3,5,6,14,23,-9,14
Concordia Ch,2053,6,3,2,9,17,24,-7,11
FCSB,2054,1,9,5,0,27,11,16,32
CFR Cluj,2054,2,6,6,2,14,8,6,24
D Bucuresti,2054,3,4,5,5,19,20,-1,17
FC Botosani,2054,4,4,5,5,9,14,-5,17
Universitate,2054,5,3,5,6,15,22,-7,14
Concordia Ch,2054,6,2,2,10,17,26,-9,8
FCSB,2055,1,8,6,0,26,12,14,30
CFR Cluj,2055,2,5,6,3,14,10,4,21
D Bucuresti,2055,3,5,4,5,22,20,2,19
Universitate,2055,4,4,6,4,16,19,-3,18
FC Botosani,2055,5,3,4,7,6,16,-10,13
Concordia Ch,2055,6,3,2,9,17,24,-7,11
FCSB,2056,1,8,5,1,24,11,13,29
CFR Cluj,2056,2,6,6,2,15,9,6,24
D Bucuresti,2056,3,4,5,5,21,22,-1,17
Universitate,2056,4,4,5,5,16,20,-4,17
FC Botosani,2056,5,4,5,5,8,12,-4,17
Concordia Ch,2056,6,2,2,10,19,29,-10,8
FCSB,2057,1,8,5,1,24,11,13,29
CFR Cluj,2057,2,6,6,2,14,8,6,24
D Bucuresti,2057,3,4,5,5,19,20,-1,17
Universitate,2057,4,4,5,5,15,19,-4,17
FC Botosani,2057,5,3,5,6,6,14,-8,14
Concordia Ch,2057,6,3,2,9,17,23,-6,11
FCSB,2058,1,9,5,0,29,12,17,32
CFR Cluj,2058,2,5,6,3,15,11,4,21
FC Botosani,2058,3,5,4,5,7,12,-5,19
Universitate,2058,4,4,5,5,15,21,-6,17
D Bucuresti,2058,5,4,4,6,19,19,0,16
Concordia Ch,2058,6,2,2,10,15,25,-10,8
FCSB,2059,1,8,6,0,27,13,14,30
CFR Cluj,2059,2,5,7,2,15,10,5,22
Universitate,2059,3,4,5,5,16,20,-4,17
D Bucuresti,2059,4,4,4,6,20,21,-1,16
FC Botosani,2059,5,4,4,6,8,14,-6,16
Concordia Ch,2059,6,3,2,9,18,26,-8,11
FCSB,2060,1,7,7,0,26,13,13,28
CFR Cluj,2060,2,6,7,1,15,8,7,25
D Bucuresti,2060,3,4,5,5,20,19,1,17
Universitate,2060,4,3,6,5,16,21,-5,15
FC Botosani,2060,5,3,4,7,5,17,-12,13
Concordia Ch,2060,6,3,3,8,18,22,-4,12
FCSB,2061,1,8,6,0,25,11,14,30
CFR Cluj,2061,2,5,6,3,14,10,4,21
Universitate,2061,3,4,6,4,17,20,-3,18
D Bucuresti,2061,4,4,4,6,20,20,0,16
Concordia Ch,2061,5,4,2,8,18,22,-4,14
FC Botosani,2061,6,3,4,7,5,16,-11,13
FCSB,2062,1,7,6,1,24,12,12,27
CFR Cluj,2062,2,6,6,2,14,9,5,24
Universitate,2062,3,4,6,4,17,19,-2,18
D Bucuresti,2062,4,4,4,6,19,21,-2,16
FC Botosani,2062,5,3,5,6,7,15,-8,14
Concordia Ch,2062,6,3,3,8,18,23,-5,12
FCSB,2063,1,9,5,0,30,12,18,32
CFR Cluj,2063,2,5,6,3,16,13,3,21
Universitate,2063,3,4,5,5,16,22,-6,17
D Bucuresti,2063,4,4,4,6,19,22,-3,16
FC Botosani,2063,5,3,5,6,8,16,-8,14
Concordia Ch,2063,6,3,3,8,20,24,-4,12
FCSB,2064,1,8,5,1,25,12,13,29
CFR Cluj,2064,2,6,7,1,15,8,7,25
D Bucuresti,2064,3,4,4,6,19,21,-2,16
Universitate,2064,4,3,6,5,16,21,-5,15
FC Botosani,2064,5,3,5,6,10,18,-8,14
Concordia Ch,2064,6,3,3,8,21,26,-5,12
FCSB,2065,1,9,5,0,25,10,15,32
CFR Cluj,2065,2,6,6,2,16,9,7,24
D Bucuresti,2065,3,4,5,5,19,19,0,17
Universitate,2065,4,3,5,6,15,22,-7,14
FC Botosani,2065,5,3,5,6,6,14,-8,14
Concordia Ch,2065,6,3,2,9,16,23,-7,11
FCSB,2066,1,9,5,0,26,10,16,32
CFR Cluj,2066,2,6,6,2,14,9,5,24
D Bucuresti,2066,3,4,4,6,19,20,-1,16
FC Botosani,2066,4,4,4,6,7,15,-8,16
Universitate,2066,5,3,5,6,14,20,-6,14
Concordia Ch,2066,6,3,2,9,18,24,-6,11
FCSB,2067,1,7,6,1,24,12,12,27
CFR Cluj,2067,2,6,7,1,16,9,7,25
D Bucuresti,2067,3,4,5,5,19,20,-1,17
Universitate,2067,4,4,5,5,16,20,-4,17
FC Botosani,2067,5,3,5,6,6,14,-8,14
Concordia Ch,2067,6,2,4,8,18,24,-6,10
FCSB,2068,1,7,6,1,26,14,12,27
CFR Cluj,2068,2,5,8,1,16,10,6,23
Universitate,2068,3,4,6,4,19,22,-3,18
FC Botosani,2068,4,4,5,5,9,13,-4,17
D Bucuresti,2068,5,3,4,7,16,22,-6,13
Concordia Ch,2068,6,3,3,8,17,22,-5,12
FCSB,2069,1,8,5,1,26,12,14,29
CFR Cluj,2069,2,7,6,1,17,8,9,27
FC Botosani,2069,3,4,5,5,7,12,-5,17
D Bucuresti,2069,4,3,5,6,17,21,-4,14
Universitate,2069,5,3,5,6,16,24,-8,14
Concordia Ch,2069,6,2,4,8,16,22,-6,10
FCSB,2070,1,7,6,1,24,13,11,27
CFR Cluj,2070,2,7,6,1,17,8,9,27
Universitate,2070,3,3,6,5,16,21,-5,15
FC Botosani,2070,4,3,6,5,7,14,-7,15
D Bucuresti,2070,5,3,5,6,18,22,-4,14
Concordia Ch,2070,6,3,3,8,19,23,-4,12
FCSB,2071,1,9,5,0,28,12,16,32
CFR Cluj,2071,2,5,6,3,14,12,2,21
Universitate,2071,3,4,5,5,18,21,-3,17
FC Botosani,2071,4,3,6,5,8,15,-7,15
D Bucuresti,2071,5,3,5,6,19,22,-3,14
Concordia Ch,2071,6,3,3,8,18,23,-5,12
FCSB,2072,1,8,5,1,28,12,16,29
CFR Cluj,2072,2,6,6,2,15,12,3,24
FC Botosani,2072,3,5,4,5,9,12,-3,19
Universitate,2072,4,4,5,5,17,21,-4,17
D Bucuresti,2072,5,4,4,6,18,21,-3,16
Concordia Ch,2072,6,2,2,10,15,24,-9,8
FCSB,2073,1,7,5,2,23,12,11,26
CFR Cluj,2073,2,6,6,2,15,9,6,24
Universitate,2073,3,5,5,4,17,19,-2,20
D Bucuresti,2073,4,4,5,5,21,20,1,17
FC Botosani,2073,5,4,4,6,8,17,-9,16
Concordia Ch,2073,6,2,3,9,17,24,-7,9
FCSB,2074,1,8,5,1,25,13,12,29
CFR Cluj,2074,2,5,7,2,13,9,4,22
D Bucuresti,2074,3,5,4,5,21,20,1,19
Universitate,2074,4,4,6,4,17,18,-1,18
FC Botosani,2074,5,4,4,6,8,15,-7,16
Concordia Ch,2074,6,2,2,10,17,26,-9,8
FCSB,2075,1,7,5,2,25,16,9,26
CFR Cluj,2075,2,6,7,1,17,9,8,25
Universitate,2075,3,4,6,4,18,20,-2,18
D Bucuresti,2075,4,4,4,6,17,21,-4,16
Concordia Ch,2075,5,4,2,8,20,21,-1,14
FC Botosani,2075,6,3,4,7,5,15,-10,13
FCSB,2076,1,7,6,1,25,13,12,27
CFR Cluj,2076,2,7,6,1,17,9,8,27
D Bucuresti,2076,3,3,6,5,18,20,-2,15
Universitate,2076,4,3,6,5,16,21,-5,15
FC Botosani,2076,5,3,6,5,7,14,-7,15
Concordia Ch,2076,6,2,4,8,17,23,-6,10
FCSB,2077,1,7,6,1,26,14,12,27
CFR Cluj,2077,2,7,6,1,17,8,9,27
D Bucuresti,2077,3,4,5,5,18,18,0,17
Universitate,2077,4,3,6,5,16,22,-6,15
FC Botosani,2077,5,3,5,6,7,16,-9,14
Concordia Ch,2077,6,2,4,8,17,23,-6,10
FCSB,2078,1,8,5,1,24,11,13,29
CFR Cluj,2078,2,5,6,3,14,10,4,21
Universitate,2078,3,5,5,4,17,19,-2,20
D Bucuresti,2078,4,4,5,5,18,18,0,17
FC Botosani,2078,5,3,4,7,6,16,-10,13
Concordia Ch,2078,6,3,3,8,17,22,-5,12
FCSB,2079,1,8,6,0,27,11,16,30
CFR Cluj,2079,2,6,7,1,15,8,7,25
FC Botosani,2079,3,4,5,5,6,12,-6,17
D Bucuresti,2079,4,3,5,6,16,20,-4,14
Universitate,2079,5,3,5,6,16,24,-8,14
Concordia Ch,2079,6,3,2,9,17,22,-5,11
FCSB,2080,1,8,5,1,27,12,15,29
CFR Cluj,2080,2,6,6,2,15,10,5,24
D Bucuresti,2080,3,5,4,5,22,20,2,19
Universitate,2080,4,4,5,5,16,21,-5,17
FC Botosani,2080,5,4,4,6,6,13,-7,16
Concordia Ch,2080,6,2,2,10,17,27,-10,8
FCSB,2081,1,7,6,1,25,13,12,27
CFR Cluj,2081,2,6,7,1,15,8,7,25
FC Botosani,2081,3,5,4,5,8,12,-4,19
Universitate,2081,4,3,7,4,15,19,-4,16
D Bucuresti,2081,5,3,5,6,16,19,-3,14
Concordia Ch,2081,6,2,3,9,15,23,-8,9
FCSB,2082,1,7,6,1,23,12,11,27
CFR Cluj,2082,2,7,6,1,17,8,9,27
D Bucuresti,2082,3,4,5,5,20,20,0,17
FC Botosani,2082,4,4,4,6,9,15,-6,16
Universitate,2082,5,3,6,5,15,20,-5,15
Concordia Ch,2082,6,2,3,9,16,25,-9,9
FCSB,2083,1,7,7,0,24,11,13,28
CFR Cluj,2083,2,5,8,1,14,8,6,23
D Bucuresti,2083,3,4,5,5,19,19,0,17
Universitate,2083,4,3,7,4,16,20,-4,16
FC Botosani,2083,5,3,6,5,6,13,-7,15
Concordia Ch,2083,6,2,3,9,17,25,-8,9
FCSB,2084,1,9,5,0,32,10,22,32
CFR Cluj,2084,2,6,6,2,16,13,3,24
D Bucuresti,2084,3,4,5,5,19,20,-1,17
FC Botosani,2084,4,4,5,5,9,14,-5,17
Universitate,2084,5,3,5,6,14,24,-10,14
Concordia Ch,2084,6,2,2,10,15,24,-9,8
FCSB,2085,1,8,6,0,25,11,14,30
CFR Cluj,2085,2,5,7,2,14,9,5,22
D Bucuresti,2085,3,4,5,5,19,20,-1,17
Universitate,2085,4,4,5,5,15,19,-4,17
FC Botosani,2085,5,3,4,7,7,16,-9,13
Concordia Ch,2085,6,3,3,8,20,25,-5,12
FCSB,2086,1,9,5,0,31,11,20,32
CFR Cluj,2086,2,5,7,2,15,12,3,22
FC Botosani,2086,3,4,5,5,10,15,-5,17
Universitate,2086,4,3,6,5,15,23,-8,15
D Bucuresti,2086,5,3,5,6,20,24,-4,14
Concordia Ch,2086,6,2,4,8,18,24,-6,10
FCSB,2087,1,8,5,1,28,14,14,29
CFR Cluj,2087,2,5,7,2,16,12,4,22
Universitate,2087,3,4,6,4,17,20,-3,18
FC Botosani,2087,4,4,5,5,7,13,-6,17
D Bucuresti,2087,5,3,4,7,17,22,-5,13
Concordia Ch,2087,6,3,3,8,17,21,-4,12
FCSB,2088,1,8,5,1,25,11,14,29
CFR Cluj,2088,2,7,6,1,15,7,8,27
D Bucuresti,2088,3,3,5,6,19,22,-3,14
Concordia Ch,2088,4,4,2,8,18,22,-4,14
Universitate,2088,5,3,5,6,14,21,-7,14
FC Botosani,2088,6,3,5,6,7,15,-8,14
FCSB,2089,1,8,5,1,26,13,13,29
CFR Cluj,2089,2,6,7,1,16,9,7,25
FC Botosani,2089,3,4,4,6,7,14,-7,16
Universitate,2089,4,3,6,5,16,21,-5,15
Concordia Ch,2089,5,4,2,8,19,23,-4,14
D Bucuresti,2089,6,3,4,7,17,21,-4,13
FCSB,2090,1,8,5,1,25,13,12,29
CFR Cluj,2090,2,5,7,2,14,9,5,22
Universitate,2090,3,4,6,4,16,18,-2,18
D Bucuresti,2090,4,4,4,6,19,22,-3,16
Concordia Ch,2090,5,4,2,8,19,22,-3,14
FC Botosani,2090,6,3,4,7,6,15,-9,13
FCSB,2091,1,8,6,0,26,12,14,30
CFR Cluj,2091,2,5,8,1,14,8,6,23
FC Botosani,2091,3,5,4,5,8,12,-4,19
Universitate,2091,4,3,6,5,15,20,-5,15
D Bucuresti,2091,5,3,4,7,17,23,-6,13
Concordia Ch,2091,6,3,2,9,19,24,-5,11
FCSB,2092,1,8,5,1,26,14,12,29
CFR Cluj,2092,2,5,7,2,13,8,5,22
D Bucuresti,2092,3,5,4,5,21,19,2,19
Universitate,2092,4,4,6,4,18,20,-2,18
FC Botosani,2092,5,3,4,7,5,17,-12,13
Concordia Ch,2092,6,3,2,9,18,23,-5,11
CFR Cluj,2093,1,7,6,1,18,9,9,27
FCSB,2093,2,7,5,2,24,14,10,26
Universitate,2093,3,4,5,5,16,20,-4,17
FC Botosani,2093,4,4,5,5,6,12,-6,17
D Bucuresti,2093,5,3,5,6,18,21,-3,14
Concordia Ch,2093,6,3,2,9,18,24,-6,11
FCSB,2094,1,7,6,1,24,12,12,27
CFR Cluj,2094,2,6,7,1,15,7,8,25
Universitate,2094,3,4,5,5,16,21,-5,17
FC Botosani,2094,4,4,5,5,7,13,-6,17
D Bucuresti,2094,5,3,4,7,16,22,-6,13
Concordia Ch,2094,6,3,3,8,19,22,-3,12
CFR Cluj,2095,1,7,6,1,20,9,11,27
FCSB,2095,2,7,5,2,24,14,10,26
FC Botosani,2095,3,4,5,5,7,12,-5,17
Universitate,2095,4,4,5,5,16,22,-6,17
D Bucuresti,2095,5,3,5,6,17,21,-4,14
Concordia Ch,2095,6,2,4,8,16,22,-6,10
FCSB,2096,1,9,5,0,30,10,20,32
CFR Cluj,2096,2,5,7,2,14,12,2,22
D Bucuresti,2096,3,4,4,6,19,23,-4,16
Universitate,2096,4,3,6,5,15,22,-7,15
Concordia Ch,2096,5,4,2,8,23,22,1,14
FC Botosani,2096,6,3,4,7,6,18,-12,13
FCSB,2097,1,8,5,1,26,13,13,29
CFR Cluj,2097,2,5,7,2,15,10,5,22
D Bucuresti,2097,3,5,4,5,21,18,3,19
Universitate,2097,4,4,6,4,15,18,-3,18
FC Botosani,2097,5,4,4,6,7,15,-8,16
Concordia Ch,2097,6,2,2,10,16,26,-10,8
FCSB,2098,1,7,6,1,23,12,11,27
CFR Cluj,2098,2,5,8,1,13,7,6,23
D Bucuresti,2098,3,5,4,5,19,18,1,19
Universitate,2098,4,4,6,4,16,18,-2,18
FC Botosani,2098,5,3,4,7,5,15,-10,13
Concordia Ch,2098,6,3,2,9,17,23,-6,11
FCSB,2099,1,9,5,0,26,11,15,32
CFR Cluj,2099,2,6,6,2,17,9,8,24
FC Botosani,2099,3,3,6,5,5,12,-7,15
D Bucuresti,2099,4,3,5,6,17,20,-3,14
Universitate,2099,5,3,5,6,14,22,-8,14
Concordia Ch,2099,6,3,3,8,17,22,-5,12
FCSB,2100,1,7,6,1,25,13,12,27
CFR Cluj,2100,2,7,6,1,18,8,10,27
D Bucuresti,2100,3,4,4,6,18,19,-1,16
Universitate,2100,4,3,6,5,17,24,-7,15
FC Botosani,2100,5,3,5,6,6,15,-9,14
Concordia Ch,2100,6,3,3,8,17,22,-5,12
FCSB,2101,1,7,7,0,26,13,13,28
CFR Cluj,2101,2,6,7,1,17,8,9,25
D Bucuresti,2101,3,4,4,6,20,24,-4,16
FC Botosani,2101,4,4,4,6,9,16,-7,16
Universitate,2101,5,3,6,5,16,23,-7,15
Concordia Ch,2101,6,3,2,9,18,22,-4,11
FCSB,2102,1,9,5,0,30,12,18,32
CFR Cluj,2102,2,5,6,3,14,14,0,21
Universitate,2102,3,4,5,5,20,23,-3,17
D Bucuresti,2102,4,3,6,5,17,19,-2,15
FC Botosani,2102,5,3,5,6,7,15,-8,14
Concordia Ch,2102,6,3,3,8,17,22,-5,12
FCSB,2103,1,8,5,1,25,13,12,29
CFR Cluj,2103,2,7,6,1,17,7,10,27
FC Botosani,2103,3,5,4,5,12,15,-3,19
Universitate,2103,4,3,5,6,15,22,-7,14
D Bucuresti,2103,5,3,4,7,18,26,-8,13
Concordia Ch,2103,6,3,2,9,19,23,-4,11
FCSB,2104,1,8,5,1,25,12,13,29
CFR Cluj,2104,2,6,7,1,15,8,7,25
D Bucuresti,2104,3,5,4,5,20,20,0,19
Universitate,2104,4,3,6,5,16,21,-5,15
FC Botosani,2104,5,3,5,6,7,15,-8,14
Concordia Ch,2104,6,2,3,9,17,24,-7,9
FCSB,2105,1,8,6,0,27,13,14,30
CFR Cluj,2105,2,6,7,1,16,9,7,25
D Bucuresti,2105,3,4,4,6,20,20,0,16
FC Botosani,2105,4,4,4,6,7,14,-7,16
Universitate,2105,5,3,5,6,15,21,-6,14
Concordia Ch,2105,6,3,2,9,18,26,-8,11
FCSB,2106,1,8,6,0,27,12,15,30
CFR Cluj,2106,2,5,6,3,14,11,3,21
Universitate,2106,3,4,6,4,16,19,-3,18
FC Botosani,2106,4,4,5,5,7,13,-6,17
D Bucuresti,2106,5,3,5,6,17,20,-3,14
Concordia Ch,2106,6,2,4,8,17,23,-6,10
FCSB,2107,1,9,5,0,27,11,16,32
CFR Cluj,2107,2,5,6,3,13,10,3,21
Universitate,2107,3,4,5,5,17,21,-4,17
D Bucuresti,2107,4,4,4,6,19,21,-2,16
FC Botosani,2107,5,3,5,6,6,14,-8,14
Concordia Ch,2107,6,3,3,8,19,24,-5,12
FCSB,2108,1,7,6,1,23,11,12,27
CFR Cluj,2108,2,5,7,2,13,8,5,22
Universitate,2108,3,5,5,4,16,18,-2,20
FC Botosani,2108,4,3,6,5,7,14,-7,15
D Bucuresti,2108,5,3,5,6,17,21,-4,14
Concordia Ch,2108,6,3,3,8,18,22,-4,12
FCSB,2109,1,7,7,0,25,12,13,28
CFR Cluj,2109,2,5,7,2,14,10,4,22
Universitate,2109,3,4,6,4,17,19,-2,18
FC Botosani,2109,4,4,5,5,9,15,-6,17
D Bucuresti,2109,5,4,4,6,19,20,-1,16
Concordia Ch,2109,6,2,3,9,19,27,-8,9
FCSB,2110,1,9,5,0,28,11,17,32
CFR Cluj,2110,2,5,7,2,16,12,4,22
D Bucuresti,2110,3,5,4,5,20,19,1,19
FC Botosani,2110,4,4,4,6,6,14,-8,16
Universitate,2110,5,3,6,5,16,22,-6,15
Concordia Ch,2110,6,2,2,10,16,24,-8,8
FCSB,2111,1,9,5,0,28,11,17,32
CFR Cluj,2111,2,5,6,3,13,11,2,21
Universitate,2111,3,4,5,5,16,20,-4,17
D Bucuresti,2111,4,4,4,6,18,21,-3,16
FC Botosani,2111,5,4,4,6,8,14,-6,16
Concordia Ch,2111,6,3,2,9,19,25,-6,11
FCSB,2112,1,8,5,1,25,12,13,29
CFR Cluj,2112,2,7,6,1,16,8,8,27
D Bucuresti,2112,3,4,4,6,20,22,-2,16
FC Botosani,2112,4,4,4,6,8,15,-7,16
Universitate,2112,5,3,5,6,16,22,-6,14
Concordia Ch,2112,6,3,2,9,20,26,-6,11
CFR Cluj,2113,1,7,6,1,15,7,8,27
FCSB,2113,2,7,5,2,24,13,11,26
Universitate,2113,3,4,5,5,16,20,-4,17
FC Botosani,2113,4,4,4,6,8,19,-11,16
Concordia Ch,2113,5,4,2,8,24,23,1,14
D Bucuresti,2113,6,3,4,7,18,23,-5,13
FCSB,2114,1,7,6,1,23,11,12,27
CFR Cluj,2114,2,6,7,1,14,7,7,25
Universitate,2114,3,4,5,5,15,19,-4,17
D Bucuresti,2114,4,4,4,6,18,21,-3,16
Concordia Ch,2114,5,4,2,8,19,22,-3,14
FC Botosani,2114,6,3,4,7,5,14,-9,13
FCSB,2115,1,7,6,1,24,12,12,27
CFR Cluj,2115,2,6,6,2,16,10,6,24
Universitate,2115,3,4,6,4,16,19,-3,18
D Bucuresti,2115,4,4,4,6,17,19,-2,16
FC Botosani,2115,5,3,5,6,6,14,-8,14
Concordia Ch,2115,6,3,3,8,17,22,-5,12
FCSB,2116,1,7,5,2,24,13,11,26
CFR Cluj,2116,2,6,6,2,15,10,5,24
Universitate,2116,3,5,5,4,17,18,-1,20
FC Botosani,2116,4,4,5,5,7,13,-6,17
D Bucuresti,2116,5,3,5,6,17,20,-3,14
Concordia Ch,2116,6,3,2,9,16,22,-6,11
FCSB,2117,1,8,6,0,25,11,14,30
CFR Cluj,2117,2,6,6,2,17,9,8,24
D Bucuresti,2117,3,4,5,5,18,19,-1,17
Universitate,2117,4,3,6,5,14,21,-7,15
FC Botosani,2117,5,3,4,7,5,15,-10,13
Concordia Ch,2117,6,3,3,8,18,22,-4,12
FCSB,2118,1,9,5,0,25,10,15,32
CFR Cluj,2118,2,6,6,2,15,9,6,24
D Bucuresti,2118,3,4,5,5,20,19,1,17
FC Botosani,2118,4,4,4,6,8,16,-8,16
Universitate,2118,5,3,5,6,15,21,-6,14
Concordia Ch,2118,6,2,3,9,17,25,-8,9
FCSB,2119,1,7,7,0,25,12,13,28
CFR Cluj,2119,2,6,7,1,17,8,9,25
D Bucuresti,2119,3,5,4,5,21,21,0,19
Universitate,2119,4,3,6,5,15,22,-7,15
FC Botosani,2119,5,3,4,7,6,15,-9,13
Concordia Ch,2119,6,3,2,9,18,24,-6,11
FCSB,2120,1,8,6,0,27,11,16,30
CFR Cluj,2120,2,6,6,2,14,10,4,24
D Bucuresti,2120,3,5,4,5,21,19,2,19
Universitate,2120,4,3,6,5,15,20,-5,15
FC Botosani,2120,5,3,4,7,6,17,-11,13
Concordia Ch,2120,6,3,2,9,18,24,-6,11
FCSB,2121,1,7,6,1,25,14,11,27
CFR Cluj,2121,2,6,7,1,16,8,8,25
D Bucuresti,2121,3,5,4,5,19,19,0,19
Universitate,2121,4,3,7,4,15,19,-4,16
FC Botosani,2121,5,3,5,6,8,16,-8,14
Concordia Ch,2121,6,2,3,9,17,24,-7,9
FCSB,2122,1,8,5,1,28,13,15,29
CFR Cluj,2122,2,5,7,2,15,13,2,22
Universitate,2122,3,4,6,4,19,21,-2,18
FC Botosani,2122,4,4,5,5,9,14,-5,17
D Bucuresti,2122,5,3,6,5,19,21,-2,15
Concordia Ch,2122,6,2,3,9,16,24,-8,9
FCSB,2123,1,8,6,0,25,11,14,30
CFR Cluj,2123,2,5,7,2,14,9,5,22
Universitate,2123,3,3,7,4,16,20,-4,16
Concordia Ch,2123,4,4,2,8,20,22,-2,14
D Bucuresti,2123,5,3,5,6,17,20,-3,14
FC Botosani,2123,6,3,5,6,7,17,-10,14
FCSB,2124,1,7,6,1,23,12,11,27
CFR Cluj,2124,2,6,7,1,14,7,7,25
Universitate,2124,3,4,5,5,16,19,-3,17
FC Botosani,2124,4,4,4,6,6,14,-8,16
D Bucuresti,2124,5,3,5,6,18,21,-3,14
Concordia Ch,2124,6,3,3,8,19,23,-4,12
FCSB,2125,1,9,5,0,27,12,15,32
CFR Cluj,2125,2,5,6,3,15,11,4,21
Universitate,2125,3,4,5,5,17,21,-4,17
D Bucuresti,2125,4,4,4,6,18,21,-3,16
FC Botosani,2125,5,3,5,6,6,14,-8,14
Concordia Ch,2125,6,3,3,8,17,21,-4,12
FCSB,2126,1,8,5,1,24,11,13,29
CFR Cluj,2126,2,5,7,2,16,11,5,22
Universitate,2126,3,4,6,4,18,21,-3,18
D Bucuresti,2126,4,4,5,5,18,19,-1,17
FC Botosani,2126,5,4,5,5,10,15,-5,17
Concordia Ch,2126,6,2,2,10,17,26,-9,8
FCSB,2127,1,7,7,0,24,11,13,28
CFR Cluj,2127,2,5,7,2,14,10,4,22
Universitate,2127,3,4,6,4,18,20,-2,18
D Bucuresti,2127,4,4,4,6,17,22,-5,16
FC Botosani,2127,5,3,5,6,6,14,-8,14
Concordia Ch,2127,6,3,3,8,20,22,-2,12
FCSB,2128,1,8,6,0,26,11,15,30
CFR Cluj,2128,2,6,6,2,15,9,6,24
D Bucuresti,2128,3,4,4,6,18,21,-3,16
FC Botosani,2128,4,4,4,6,9,15,-6,16
Universitate,2128,5,3,6,5,15,21,-6,15
Concordia Ch,2128,6,3,2,9,20,26,-6,11
FCSB,2129,1,8,5,1,25,11,14,29
CFR Cluj,2129,2,6,6,2,14,9,5,24
FC Botosani,2129,3,5,4,5,11,15,-4,19
Universitate,2129,4,4,5,5,15,19,-4,17
D Bucuresti,2129,5,4,4,6,19,20,-1,16
Concordia Ch,2129,6,2,2,10,17,27,-10,8
FCSB,2130,1,7,6,1,23,12,11,27
CFR Cluj,2130,2,5,8,1,13,7,6,23
D Bucuresti,2130,3,5,4,5,21,19,2,19
Universitate,2130,4,4,6,4,16,18,-2,18
FC Botosani,2130,5,3,5,6,6,15,-9,14
Concordia Ch,2130,6,2,3,9,17,25,-8,9
FCSB,2131,1,9,5,0,27,11,16,32
CFR Cluj,2131,2,6,6,2,16,9,7,24
FC Botosani,2131,3,4,5,5,10,16,-6,17
D Bucuresti,2131,4,3,6,5,20,22,-2,15
Universitate,2131,5,3,5,6,14,22,-8,14
Concordia Ch,2131,6,2,3,9,17,24,-7,9
FCSB,2132,1,7,6,1,25,13,12,27
CFR Cluj,2132,2,5,8,1,15,9,6,23
Universitate,2132,3,4,6,4,15,18,-3,18
FC Botosani,2132,4,4,4,6,6,13,-7,16
Concordia Ch,2132,5,4,2,8,17,21,-4,14
D Bucuresti,2132,6,3,4,7,16,20,-4,13
FCSB,2133,1,7,5,2,23,13,10,26
CFR Cluj,2133,2,6,6,2,14,8,6,24
Universitate,2133,3,5,5,4,17,18,-1,20
FC Botosani,2133,4,4,4,6,7,16,-9,16
Concordia Ch,2133,5,4,2,8,20,21,-1,14
D Bucuresti,2133,6,3,4,7,17,22,-5,13
FCSB,2134,1,8,6,0,25,10,15,30
CFR Cluj,2134,2,5,7,2,13,10,3,22
Universitate,2134,3,4,5,5,17,20,-3,17
FC Botosani,2134,4,4,5,5,8,13,-5,17
D Bucuresti,2134,5,3,5,6,18,22,-4,14
Concordia Ch,2134,6,3,2,9,20,26,-6,11
FCSB,2135,1,7,5,2,25,15,10,26
CFR Cluj,2135,2,6,7,1,16,8,8,25
D Bucuresti,2135,3,5,4,5,19,18,1,19
Universitate,2135,4,4,6,4,18,21,-3,18
FC Botosani,2135,5,3,4,7,5,16,-11,13
Concordia Ch,2135,6,3,2,9,17,22,-5,11
FCSB,2136,1,8,6,0,27,12,15,30
CFR Cluj,2136,2,6,7,1,15,8,7,25
D Bucuresti,2136,3,4,5,5,20,20,0,17
Universitate,2136,4,3,5,6,15,22,-7,14
FC Botosani,2136,5,3,5,6,5,14,-9,14
Concordia Ch,2136,6,2,4,8,17,23,-6,10
FCSB,2137,1,9,5,0,26,10,16,32
CFR Cluj,2137,2,6,6,2,16,8,8,24
D Bucuresti,2137,3,4,5,5,18,18,0,17
FC Botosani,2137,4,4,5,5,7,13,-6,17
Universitate,2137,5,3,5,6,14,23,-9,14
Concordia Ch,2137,6,2,2,10,16,25,-9,8
FCSB,2138,1,8,5,1,25,14,11,29
CFR Cluj,2138,2,6,6,2,16,9,7,24
Universitate,2138,3,4,5,5,17,20,-3,17
FC Botosani,2138,4,4,5,5,7,13,-6,17
D Bucuresti,2138,5,3,6,5,17,19,-2,15
Concordia Ch,2138,6,2,3,9,15,22,-7,9
FCSB,2139,1,8,6,0,25,10,15,30
CFR Cluj,2139,2,5,8,1,13,7,6,23
D Bucuresti,2139,3,5,4,5,20,18,2,19
Universitate,2139,4,3,6,5,14,20,-6,15
FC Botosani,2139,5,3,5,6,6,16,-10,14
Concordia Ch,2139,6,2,3,9,16,23,-7,9
FCSB,2140,1,8,6,0,27,11,16,30
CFR Cluj,2140,2,6,7,1,16,9,7,25
D Bucuresti,2140,3,4,5,5,20,20,0,17
Universitate,2140,4,3,5,6,15,23,-8,14
FC Botosani,2140,5,3,4,7,6,16,-10,13
Concordia Ch,2140,6,3,3,8,19,24,-5,12
FCSB,2141,1,7,6,1,23,12,11,27
CFR Cluj,2141,2,6,7,1,16,8,8,25
D Bucuresti,2141,3,5,4,5,21,20,1,19
Universitate,2141,4,3,7,4,15,19,-4,16
FC Botosani,2141,5,4,4,6,8,14,-6,16
Concordia Ch,2141,6,2,2,10,17,27,-10,8
FCSB,2142,1,7,6,1,26,17,9,27
CFR Cluj,2142,2,5,8,1,17,11,6,23
D Bucuresti,2142,3,5,4,5,19,19,0,19
Universitate,2142,4,4,6,4,19,19,0,18
FC Botosani,2142,5,4,4,6,6,13,-7,16
Concordia Ch,2142,6,2,2,10,16,24,-8,8
FCSB,2143,1,7,5,2,24,14,10,26
CFR Cluj,2143,2,6,7,1,16,8,8,25
Universitate,2143,3,4,6,4,17,20,-3,18
FC Botosani,2143,4,4,5,5,7,13,-6,17
D Bucuresti,2143,5,3,5,6,18,21,-3,14
Concordia Ch,2143,6,2,4,8,16,22,-6,10
FCSB,2144,1,8,5,1,26,14,12,29
CFR Cluj,2144,2,6,6,2,17,10,7,24
Universitate,2144,3,4,5,5,18,22,-4,17
D Bucuresti,2144,4,4,4,6,19,23,-4,16
FC Botosani,2144,5,4,4,6,10,15,-5,16
Concordia Ch,2144,6,3,2,9,18,24,-6,11
FCSB,2145,1,7,6,1,24,12,12,27
CFR Cluj,2145,2,5,8,1,14,8,6,23
FC Botosani,2145,3,5,4,5,8,12,-4,19
Universitate,2145,4,4,6,4,15,18,-3,18
D Bucuresti,2145,5,3,4,7,17,21,-4,13
Concordia Ch,2145,6,3,2,9,17,24,-7,11
FCSB,2146,1,7,6,1,24,12,12,27
CFR Cluj,2146,2,6,7,1,14,7,7,25
Universitate,2146,3,4,5,5,16,20,-4,17
FC Botosani,2146,4,4,5,5,8,14,-6,17
D Bucuresti,2146,5,4,4,6,19,21,-2,16
Concordia Ch,2146,6,2,3,9,15,22,-7,9
FCSB,2147,1,9,5,0,26,10,16,32
CFR Cluj,2147,2,6,6,2,15,10,5,24
D Bucuresti,2147,3,4,5,5,18,19,-1,17
Universitate,2147,4,3,5,6,15,21,-6,14
FC Botosani,2147,5,3,4,7,5,15,-10,13
Concordia Ch,2147,6,3,3,8,18,22,-4,12
FCSB,2148,1,9,5,0,27,12,15,32
CFR Cluj,2148,2,5,7,2,15,10,5,22
D Bucuresti,2148,3,5,4,5,18,18,0,19
Universitate,2148,4,3,6,5,16,21,-5,15
FC Botosani,2148,5,3,4,7,6,15,-9,13
Concordia Ch,2148,6,3,2,9,17,23,-6,11
FCSB,2149,1,8,6,0,25,10,15,30
CFR Cluj,2149,2,6,7,1,17,8,9,25
D Bucuresti,2149,3,4,4,6,18,20,-2,16
Concordia Ch,2149,4,4,2,8,18,22,-4,14
Universitate,2149,5,3,5,6,15,24,-9,14
FC Botosani,2149,6,3,4,7,7,16,-9,13
FCSB,2150,1,7,6,1,25,13,12,27
CFR Cluj,2150,2,7,6,1,17,9,8,27
D Bucuresti,2150,3,4,5,5,19,19,0,17
FC Botosani,2150,4,4,4,6,11,18,-7,16
Universitate,2150,5,3,6,5,14,19,-5,15
Concordia Ch,2150,6,2,3,9,18,26,-8,9
FCSB,2151,1,8,6,0,24,10,14,30
CFR Cluj,2151,2,6,7,1,16,8,8,25
D Bucuresti,2151,3,4,5,5,18,19,-1,17
Universitate,2151,4,3,5,6,15,22,-7,14
FC Botosani,2151,5,3,5,6,7,15,-8,14
Concordia Ch,2151,6,2,4,8,16,22,-6,10
FCSB,2152,1,7,6,1,23,12,11,27
CFR Cluj,2152,2,7,6,1,17,8,9,27
FC Botosani,2152,3,5,4,5,8,12,-4,19
Universitate,2152,4,3,6,5,15,20,-5,15
D Bucuresti,2152,5,3,4,7,17,21,-4,13
Concordia Ch,2152,6,3,2,9,17,24,-7,11
FCSB,2153,1,8,6,0,24,10,14,30
CFR Cluj,2153,2,5,7,2,13,8,5,22
D Bucuresti,2153,3,4,4,6,18,21,-3,16
Universitate,2153,4,3,7,4,14,18,-4,16
FC Botosani,2153,5,3,5,6,6,14,-8,14
Concordia Ch,2153,6,3,3,8,19,23,-4,12
FCSB,2154,1,7,5,2,24,14,10,26
CFR Cluj,2154,2,6,7,1,16,8,8,25
Universitate,2154,3,4,6,4,17,20,-3,18
D Bucuresti,2154,4,4,4,6,18,20,-2,16
FC Botosani,2154,5,3,5,6,7,15,-8,14
Concordia Ch,2154,6,3,3,8,17,22,-5,12
FCSB,2155,1,7,6,1,24,13,11,27
CFR Cluj,2155,2,5,7,2,13,10,3,22
Universitate,2155,3,5,5,4,20,19,1,20
D Bucuresti,2155,4,4,4,6,18,20,-2,16
FC Botosani,2155,5,4,4,6,8,15,-7,16
Concordia Ch,2155,6,3,2,9,17,23,-6,11
FCSB,2156,1,7,6,1,23,11,12,27
CFR Cluj,2156,2,6,7,1,15,8,7,25
D Bucuresti,2156,3,4,5,5,18,19,-1,17
Universitate,2156,4,4,5,5,16,20,-4,17
FC Botosani,2156,5,3,6,5,6,13,-7,15
Concordia Ch,2156,6,2,3,9,15,22,-7,9
CFR Cluj,2157,1,7,6,1,17,9,8,27
FCSB,2157,2,7,5,2,25,14,11,26
FC Botosani,2157,3,5,4,5,8,13,-5,19
Universitate,2157,4,4,5,5,17,21,-4,17
D Bucuresti,2157,5,3,4,7,17,22,-5,13
Concordia Ch,2157,6,3,2,9,17,22,-5,11
FCSB,2158,1,8,6,0,27,10,17,30
CFR Cluj,2158,2,5,8,1,15,9,6,23
FC Botosani,2158,3,4,4,6,8,14,-6,16
Universitate,2158,4,3,6,5,16,24,-8,15
D Bucuresti,2158,5,3,5,6,17,21,-4,14
Concordia Ch,2158,6,3,3,8,18,23,-5,12
FCSB,2159,1,8,6,0,26,12,14,30
CFR Cluj,2159,2,5,8,1,15,9,6,23
FC Botosani,2159,3,4,5,5,9,12,-3,17
D Bucuresti,2159,4,3,6,5,18,20,-2,15
Universitate,2159,5,3,6,5,16,21,-5,15
Concordia Ch,2159,6,2,3,9,17,27,-10,9
FCSB,2160,1,9,5,0,27,11,16,32
CFR Cluj,2160,2,6,6,2,15,9,6,24
FC Botosani,2160,3,5,4,5,7,12,-5,19
D Bucuresti,2160,4,3,5,6,18,21,-3,14
Universitate,2160,5,3,5,6,15,22,-7,14
Concordia Ch,2160,6,2,3,9,17,24,-7,9
FCSB,2161,1,8,6,0,25,11,14,30
CFR Cluj,2161,2,6,7,1,17,9,8,25
D Bucuresti,2161,3,4,5,5,18,19,-1,17
Universitate,2161,4,3,5,6,15,22,-7,14
FC Botosani,2161,5,3,4,7,6,16,-10,13
Concordia Ch,2161,6,3,3,8,17,21,-4,12
FCSB,2162,1,8,5,1,27,13,14,29
CFR Cluj,2162,2,7,6,1,17,8,9,27
D Bucuresti,2162,3,4,5,5,20,21,-1,17
FC Botosani,2162,4,4,5,5,6,12,-6,17
Universitate,2162,5,3,5,6,15,23,-8,14
Concordia Ch,2162,6,2,2,10,18,26,-8,8
FCSB,2163,1,8,5,1,27,14,13,29
CFR Cluj,2163,2,6,6,2,16,10,6,24
Universitate,2163,3,4,5,5,16,20,-4,17
FC Botosani,2163,4,4,4,6,8,15,-7,16
D Bucuresti,2163,5,3,5,6,17,20,-3,14
Concordia Ch,2163,6,3,3,8,17,22,-5,12
FCSB,2164,1,8,5,1,25,13,12,29
CFR Cluj,2164,2,6,6,2,15,8,7,24
D Bucuresti,2164,3,5,4,5,21,20,1,19
Universitate,2164,4,4,5,5,17,21,-4,17
FC Botosani,2164,5,4,4,6,8,15,-7,16
Concordia Ch,2164,6,2,2,10,17,26,-9,8
FCSB,2165,1,8,6,0,24,10,14,30
CFR Cluj,2165,2,6,7,1,14,7,7,25
D Bucuresti,2165,3,4,5,5,19,19,0,17
Universitate,2165,4,3,5,6,14,20,-6,14
FC Botosani,2165,5,3,4,7,7,18,-11,13
Concordia Ch,2165,6,3,3,8,18,22,-4,12
FCSB,2166,1,7,7,0,23,10,13,28
CFR Cluj,2166,2,6,7,1,15,7,8,25
D Bucuresti,2166,3,4,5,5,19,20,-1,17
FC Botosani,2166,4,4,4,6,8,14,-6,16
Universitate,2166,5,3,6,5,14,20,-6,15
Concordia Ch,2166,6,2,3,9,16,24,-8,9
FCSB,2167,1,8,6,0,27,13,14,30
CFR Cluj,2167,2,6,6,2,16,10,6,24
FC Botosani,2167,3,4,5,5,7,13,-6,17
D Bucuresti,2167,4,3,6,5,16,18,-2,15
Universitate,2167,5,3,6,5,15,20,-5,15
Concordia Ch,2167,6,2,3,9,16,23,-7,9
FCSB,2168,1,8,5,1,27,13,14,29
CFR Cluj,2168,2,6,6,2,17,10,7,24
Universitate,2168,3,4,5,5,16,22,-6,17
D Bucuresti,2168,4,3,6,5,19,21,-2,15
FC Botosani,2168,5,3,5,6,8,16,-8,14
Concordia Ch,2168,6,3,3,8,20,25,-5,12
FCSB,2169,1,9,5,0,31,10,21,32
CFR Cluj,2169,2,5,6,3,14,15,-1,21
Universitate,2169,3,4,5,5,16,21,-5,17
FC Botosani,2169,4,4,4,6,8,15,-7,16
D Bucuresti,2169,5,3,5,6,19,22,-3,14
Concordia Ch,2169,6,3,3,8,19,24,-5,12
FCSB,2170,1,7,6,1,24,12,12,27
CFR Cluj,2170,2,6,7,1,16,9,7,25
Universitate,2170,3,4,5,5,16,20,-4,17
FC Botosani,2170,4,4,5,5,8,14,-6,17
D Bucuresti,2170,5,3,4,7,16,21,-5,13
Concordia Ch,2170,6,3,3,8,19,23,-4,12
FCSB,2171,1,7,6,1,24,12,12,27
CFR Cluj,2171,2,6,7,1,15,8,7,25
D Bucuresti,2171,3,5,4,5,20,19,1,19
Universitate,2171,4,4,5,5,15,19,-4,17
FC Botosani,2171,5,3,5,6,6,14,-8,14
Concordia Ch,2171,6,2,3,9,15,23,-8,9
FCSB,2172,1,8,5,1,26,14,12,29
CFR Cluj,2172,2,6,6,2,16,10,6,24
D Bucuresti,2172,3,5,4,5,21,18,3,19
Universitate,2172,4,4,5,5,17,20,-3,17
FC Botosani,2172,5,3,5,6,7,17,-10,14
Concordia Ch,2172,6,2,3,9,17,25,-8,9
FCSB,2173,1,8,6,0,26,11,15,30
CFR Cluj,2173,2,5,7,2,14,9,5,22
Universitate,2173,3,4,5,5,15,20,-5,17
D Bucuresti,2173,4,4,4,6,18,20,-2,16
FC Botosani,2173,5,3,5,6,7,15,-8,14
Concordia Ch,2173,6,3,3,8,17,22,-5,12
FCSB,2174,1,7,5,2,23,14,9,26
CFR Cluj,2174,2,6,6,2,15,8,7,24
Universitate,2174,3,5,5,4,17,18,-1,20
D Bucuresti,2174,4,3,5,6,18,21,-3,14
Concordia Ch,2174,5,4,2,8,19,23,-4,14
FC Botosani,2174,6,3,5,6,7,15,-8,14
FCSB,2175,1,9,5,0,27,12,15,32
CFR Cluj,2175,2,5,7,2,14,9,5,22
FC Botosani,2175,3,5,4,5,11,14,-3,19
Universitate,2175,4,3,6,5,17,22,-5,15
D Bucuresti,2175,5,3,4,7,16,24,-8,13
Concordia Ch,2175,6,3,2,9,22,26,-4,11
FCSB,2176,1,8,5,1,26,12,14,29
CFR Cluj,2176,2,6,7,1,14,7,7,25
FC Botosani,2176,3,4,5,5,8,13,-5,17
Universitate,2176,4,3,6,5,15,21,-6,15
D Bucuresti,2176,5,3,5,6,17,21,-4,14
Concordia Ch,2176,6,2,4,8,17,23,-6,10
FCSB,2177,1,8,6,0,26,11,15,30
CFR Cluj,2177,2,6,7,1,15,7,8,25
D Bucuresti,2177,3,5,4,5,20,19,1,19
Universitate,2177,4,3,5,6,15,23,-8,14
FC Botosani,2177,5,3,4,7,5,15,-10,13
Concordia Ch,2177,6,3,2,9,17,23,-6,11
FCSB,2178,1,8,5,1,24,11,13,29
CFR Cluj,2178,2,6,7,1,14,7,7,25
FC Botosani,2178,3,4,5,5,7,13,-6,17
Universitate,2178,4,3,6,5,14,19,-5,15
D Bucuresti,2178,5,3,5,6,17,21,-4,14
Concordia Ch,2178,6,3,2,9,17,22,-5,11
FCSB,2179,1,9,5,0,27,10,17,32
CFR Cluj,2179,2,6,6,2,16,8,8,24
FC Botosani,2179,3,5,4,5,7,12,-5,19
D Bucuresti,2179,4,3,5,6,17,20,-3,14
Universitate,2179,5,3,5,6,14,24,-10,14
Concordia Ch,2179,6,2,3,9,16,23,-7,9
FCSB,2180,1,7,7,0,24,11,13,28
CFR Cluj,2180,2,6,7,1,15,8,7,25
D Bucuresti,2180,3,4,5,5,19,20,-1,17
Universitate,2180,4,3,6,5,14,19,-5,15
FC Botosani,2180,5,3,5,6,6,15,-9,14
Concordia Ch,2180,6,3,2,9,18,23,-5,11
FCSB,2181,1,7,6,1,25,14,11,27
CFR Cluj,2181,2,7,6,1,19,9,10,27
D Bucuresti,2181,3,4,4,6,20,22,-2,16
Universitate,2181,4,3,6,5,16,22,-6,15
Concordia Ch,2181,5,4,2,8,19,23,-4,14
FC Botosani,2181,6,3,4,7,6,15,-9,13
FCSB,2182,1,9,5,0,30,12,18,32
CFR Cluj,2182,2,5,7,2,15,11,4,22
D Bucuresti,2182,3,4,4,6,19,22,-3,16
FC Botosani,2182,4,4,4,6,7,14,-7,16
Universitate,2182,5,3,6,5,16,23,-7,15
Concordia Ch,2182,6,3,2,9,20,25,-5,11
FCSB,2183,1,8,6,0,28,12,16,30
CFR Cluj,2183,2,5,6,3,15,13,2,21
D Bucuresti,2183,3,5,4,5,22,19,3,19
Universitate,2183,4,4,6,4,17,20,-3,18
FC Botosani,2183,5,3,4,7,6,18,-12,13
Concordia Ch,2183,6,3,2,9,19,25,-6,11
FCSB,2184,1,8,6,0,26,11,15,30
CFR Cluj,2184,2,5,7,2,15,11,4,22
D Bucuresti,2184,3,4,4,6,19,21,-2,16
Universitate,2184,4,3,7,4,15,19,-4,16
FC Botosani,2184,5,4,4,6,8,15,-7,16
Concordia Ch,2184,6,3,2,9,17,23,-6,11
FCSB,2185,1,8,5,1,24,12,12,29
CFR Cluj,2185,2,5,7,2,14,9,5,22
Universitate,2185,3,4,6,4,17,19,-2,18
FC Botosani,2185,4,4,5,5,7,13,-6,17
D Bucuresti,2185,5,3,6,5,18,20,-2,15
Concordia Ch,2185,6,2,3,9,16,23,-7,9
FCSB,2186,1,8,6,0,30,11,19,30
CFR Cluj,2186,2,5,7,2,14,14,0,22
Universitate,2186,3,3,7,4,16,20,-4,16
FC Botosani,2186,4,4,4,6,8,16,-8,16
D Bucuresti,2186,5,3,5,6,19,22,-3,14
Concordia Ch,2186,6,3,3,8,18,22,-4,12
FCSB,2187,1,7,6,1,24,12,12,27
CFR Cluj,2187,2,5,8,1,14,8,6,23
Universitate,2187,3,4,6,4,15,18,-3,18
FC Botosani,2187,4,4,5,5,10,16,-6,17
D Bucuresti,2187,5,3,5,6,18,21,-3,14
Concordia Ch,2187,6,3,2,9,18,24,-6,11
FCSB,2188,1,7,6,1,23,11,12,27
CFR Cluj,2188,2,6,7,1,14,7,7,25
Universitate,2188,3,4,5,5,15,19,-4,17
FC Botosani,2188,4,4,5,5,6,12,-6,17
D Bucuresti,2188,5,3,5,6,16,20,-4,14
Concordia Ch,2188,6,3,2,9,17,22,-5,11
FCSB,2189,1,8,5,1,26,15,11,29
CFR Cluj,2189,2,7,6,1,20,10,10,27
FC Botosani,2189,3,4,5,5,7,13,-6,17
D Bucuresti,2189,4,3,5,6,19,24,-5,14
Universitate,2189,5,3,5,6,17,23,-6,14
Concordia Ch,2189,6,3,2,9,20,24,-4,11
FCSB,2190,1,9,5,0,25,10,15,32
CFR Cluj,2190,2,5,7,2,13,8,5,22
D Bucuresti,2190,3,4,4,6,19,20,-1,16
FC Botosani,2190,4,4,4,6,6,14,-8,16
Universitate,2190,5,3,6,5,14,19,-5,15
Concordia Ch,2190,6,3,2,9,17,23,-6,11
FCSB,2191,1,8,6,0,26,12,14,30
CFR Cluj,2191,2,5,6,3,13,9,4,21
Universitate,2191,3,4,6,4,17,20,-3,18
D Bucuresti,2191,4,4,5,5,21,18,3,17
FC Botosani,2191,5,4,5,5,6,12,-6,17
Concordia Ch,2191,6,2,2,10,15,27,-12,8
CFR Cluj,2192,1,7,6,1,18,10,8,27
FCSB,2192,2,7,5,2,26,15,11,26
Universitate,2192,3,4,5,5,15,19,-4,17
D Bucuresti,2192,4,4,4,6,20,23,-3,16
Concordia Ch,2192,5,4,2,8,21,22,-1,14
FC Botosani,2192,6,3,4,7,6,17,-11,13
FCSB,2193,1,9,5,0,27,10,17,32
CFR Cluj,2193,2,5,7,2,14,11,3,22
D Bucuresti,2193,3,4,4,6,19,20,-1,16
FC Botosani,2193,4,4,4,6,7,15,-8,16
Universitate,2193,5,3,6,5,15,20,-5,15
Concordia Ch,2193,6,3,2,9,17,23,-6,11
FCSB,2194,1,8,6,0,28,12,16,30
CFR Cluj,2194,2,5,7,2,16,13,3,22
D Bucuresti,2194,3,4,5,5,18,19,-1,17
Universitate,2194,4,3,7,4,15,19,-4,16
FC Botosani,2194,5,4,4,6,7,13,-6,16
Concordia Ch,2194,6,2,3,9,16,24,-8,9
FCSB,2195,1,8,6,0,26,10,16,30
CFR Cluj,2195,2,6,7,1,16,8,8,25
D Bucuresti,2195,3,4,5,5,18,19,-1,17
FC Botosani,2195,4,3,5,6,6,14,-8,14
Universitate,2195,5,3,5,6,15,24,-9,14
Concordia Ch,2195,6,3,2,9,18,24,-6,11
FCSB,2196,1,7,5,2,23,12,11,26
CFR Cluj,2196,2,6,7,1,14,7,7,25
Universitate,2196,3,4,6,4,15,18,-3,18
D Bucuresti,2196,4,4,5,5,21,22,-1,17
FC Botosani,2196,5,3,4,7,7,17,-10,13
Concordia Ch,2196,6,3,3,8,19,23,-4,12
CFR Cluj,2197,1,7,6,1,16,8,8,27
FCSB,2197,2,7,5,2,24,13,11,26
FC Botosani,2197,3,5,4,5,8,12,-4,19
Universitate,2197,4,4,5,5,17,21,-4,17
D Bucuresti,2197,5,4,4,6,19,21,-2,16
Concordia Ch,2197,6,2,2,10,16,25,-9,8
FCSB,2198,1,8,6,0,25,11,14,30
CFR Cluj,2198,2,6,7,1,16,9,7,25
D Bucuresti,2198,3,5,4,5,21,21,0,19
FC Botosani,2198,4,4,4,6,8,14,-6,16
Universitate,2198,5,3,5,6,17,23,-6,14
Concordia Ch,2198,6,2,2,10,17,26,-9,8
FCSB,2199,1,9,5,0,27,10,17,32
CFR Cluj,2199,2,5,7,2,14,10,4,22
D Bucuresti,2199,3,4,5,5,21,21,0,17
FC Botosani,2199,4,4,5,5,9,15,-6,17
Universitate,2199,5,3,6,5,15,21,-6,15
Concordia Ch,2199,6,2,2,10,17,26,-9,8
FCSB,2200,1,8,6,0,26,11,15,30
CFR Cluj,2200,2,5,7,2,13,10,3,22
Universitate,2200,3,4,5,5,18,21,-3,17
D Bucuresti,2200,4,3,6,5,17,19,-2,15
FC Botosani,2200,5,3,5,6,5,15,-10,14
Concordia Ch,2200,6,3,3,8,19,22,-3,12
FCSB,2201,1,8,5,1,24,11,13,29
CFR Cluj,2201,2,6,6,2,14,8,6,24
D Bucuresti,2201,3,4,5,5,20,21,-1,17
Universitate,2201,4,4,5,5,15,19,-4,17
FC Botosani,2201,5,3,5,6,7,16,-9,14
Concordia Ch,2201,6,3,2,9,18,23,-5,11
FCSB,2202,1,9,5,0,28,12,16,32
CFR Cluj,2202,2,6,6,2,14,9,5,24
D Bucuresti,2202,3,3,5,6,19,22,-3,14
Concordia Ch,2202,4,4,2,8,18,22,-4,14
Universitate,2202,5,3,5,6,16,22,-6,14
FC Botosani,2202,6,3,5,6,7,15,-8,14
FCSB,2203,1,7,6,1,23,11,12,27
CFR Cluj,2203,2,6,7,1,14,7,7,25
Universitate,2203,3,4,5,5,15,19,-4,17
D Bucuresti,2203,4,3,6,5,19,21,-2,15
FC Botosani,2203,5,3,6,5,6,13,-7,15
Concordia Ch,2203,6,2,4,8,17,23,-6,10
FCSB,2204,1,9,5,0,27,11,16,32
CFR Cluj,2204,2,5,7,2,14,9,5,22
D Bucuresti,2204,3,4,4,6,19,20,-1,16
FC Botosani,2204,4,4,4,6,6,15,-9,16
Universitate,2204,5,3,6,5,14,20,-6,15
Concordia Ch,2204,6,3,2,9,17,22,-5,11
FCSB,2205,1,8,5,1,24,11,13,29
CFR Cluj,2205,2,5,6,3,13,9,4,21
Universitate,2205,3,5,5,4,16,18,-2,20
D Bucuresti,2205,4,4,4,6,17,22,-5,16
FC Botosani,2205,5,3,5,6,6,14,-8,14
Concordia Ch,2205,6,3,3,8,20,22,-2,12
FCSB,2206,1,7,5,2,24,13,11,26
CFR Cluj,2206,2,6,7,1,16,9,7,25
D Bucuresti,2206,3,5,4,5,18,18,0,19
Universitate,2206,4,4,6,4,16,19,-3,18
FC Botosani,2206,5,3,4,7,5,15,-10,13
Concordia Ch,2206,6,3,2,9,17,22,-5,11
FCSB,2207,1,8,6,0,25,11,14,30
CFR Cluj,2207,2,6,6,2,15,8,7,24
D Bucuresti,2207,3,5,4,5,20,19,1,19
Universitate,2207,4,3,6,5,15,21,-6,15
FC Botosani,2207,5,3,5,6,8,16,-8,14
Concordia Ch,2207,6,2,3,9,17,25,-8,9
FCSB,2208,1,8,5,1,25,11,14,29
CFR Cluj,2208,2,5,7,2,14,10,4,22
Universitate,2208,3,4,6,4,16,19,-3,18
FC Botosani,2208,4,4,5,5,11,17,-6,17
D Bucuresti,2208,5,3,6,5,20,22,-2,15
Concordia Ch,2208,6,2,3,9,18,25,-7,9
FCSB,2209,1,7,6,1,23,13,10,27
CFR Cluj,2209,2,5,8,1,15,9,6,23
Universitate,2209,3,4,6,4,19,20,-1,18
FC Botosani,2209,4,4,5,5,7,12,-5,17
D Bucuresti,2209,5,3,4,7,17,23,-6,13
Concordia Ch,2209,6,3,3,8,18,22,-4,12
FCSB,2210,1,9,5,0,29,12,17,32
CFR Cluj,2210,2,6,6,2,17,13,4,24
D Bucuresti,2210,3,4,4,6,20,24,-4,16
Concordia Ch,2210,4,4,2,8,23,24,-1,14
Universitate,2210,5,3,5,6,17,23,-6,14
FC Botosani,2210,6,3,4,7,7,17,-10,13
FCSB,2211,1,8,6,0,27,11,16,30
CFR Cluj,2211,2,6,6,2,15,10,5,24
FC Botosani,2211,3,4,4,6,8,15,-7,16
Universitate,2211,4,3,6,5,15,21,-6,15
D Bucuresti,2211,5,3,5,6,19,22,-3,14
Concordia Ch,2211,6,3,3,8,19,24,-5,12
FCSB,2212,1,7,5,2,23,12,11,26
CFR Cluj,2212,2,6,6,2,15,9,6,24
Universitate,2212,3,5,5,4,17,19,-2,20
D Bucuresti,2212,4,5,4,5,19,19,0,19
FC Botosani,2212,5,3,4,7,6,15,-9,13
Concordia Ch,2212,6,3,2,9,18,24,-6,11
FCSB,2213,1,8,5,1,27,12,15,29
CFR Cluj,2213,2,5,6,3,14,12,2,21
Universitate,2213,3,5,5,4,16,18,-2,20
D Bucuresti,2213,4,4,5,5,20,21,-1,17
FC Botosani,2213,5,3,5,6,7,15,-8,14
Concordia Ch,2213,6,2,4,8,18,24,-6,10
FCSB,2214,1,7,6,1,25,14,11,27
CFR Cluj,2214,2,7,6,1,18,8,10,27
D Bucuresti,2214,3,5,4,5,20,19,1,19
Universitate,2214,4,3,6,5,15,21,-6,15
FC Botosani,2214,5,3,5,6,7,16,-9,14
Concordia Ch,2214,6,2,3,9,18,25,-7,9
FCSB,2215,1,8,6,0,24,10,14,30
CFR Cluj,2215,2,5,8,1,13,7,6,23
D Bucuresti,2215,3,5,4,5,23,18,5,19
FC Botosani,2215,4,4,4,6,7,17,-10,16
Universitate,2215,5,3,6,5,14,19,-5,15
Concordia Ch,2215,6,2,2,10,16,26,-10,8
FCSB,2216,1,7,6,1,24,12,12,27
CFR Cluj,2216,2,7,6,1,17,8,9,27
D Bucuresti,2216,3,4,4,6,18,21,-3,16
Universitate,2216,4,3,6,5,16,22,-6,15
FC Botosani,2216,5,3,5,6,6,14,-8,14
Concordia Ch,2216,6,3,3,8,19,23,-4,12
FCSB,2217,1,8,5,1,25,12,13,29
CFR Cluj,2217,2,5,6,3,14,10,4,21
Universitate,2217,3,5,5,4,16,18,-2,20
D Bucuresti,2217,4,4,4,6,19,21,-2,16
Concordia Ch,2217,5,4,2,8,20,22,-2,14
FC Botosani,2217,6,3,4,7,5,16,-11,13
FCSB,2218,1,8,5,1,27,15,12,29
CFR Cluj,2218,2,7,6,1,17,8,9,27
D Bucuresti,2218,3,5,4,5,21,18,3,19
Universitate,2218,4,3,5,6,16,22,-6,14
FC Botosani,2218,5,3,4,7,5,14,-9,13
Concordia Ch,2218,6,3,2,9,16,25,-9,11
FCSB,2219,1,8,5,1,25,12,13,29
CFR Cluj,2219,2,7,6,1,16,7,9,27
D Bucuresti,2219,3,5,4,5,20,18,2,19
FC Botosani,2219,4,4,4,6,10,14,-4,16
Universitate,2219,5,3,5,6,14,21,-7,14
Concordia Ch,2219,6,2,2,10,16,29,-13,8
FCSB,2220,1,7,6,1,24,13,11,27
CFR Cluj,2220,2,6,7,1,16,8,8,25
D Bucuresti,2220,3,4,5,5,20,20,0,17
Universitate,2220,4,4,5,5,16,20,-4,17
FC Botosani,2220,5,4,4,6,9,17,-8,16
Concordia Ch,2220,6,2,3,9,18,25,-7,9
FCSB,2221,1,8,6,0,27,10,17,30
CFR Cluj,2221,2,5,8,1,13,7,6,23
D Bucuresti,2221,3,5,4,5,23,19,4,19
FC Botosani,2221,4,4,4,6,9,15,-6,16
Universitate,2221,5,3,6,5,14,22,-8,15
Concordia Ch,2221,6,2,2,10,16,29,-13,8
FCSB,2222,1,7,5,2,24,14,10,26
CFR Cluj,2222,2,6,6,2,15,10,5,24
Universitate,2222,3,5,5,4,18,18,0,20
D Bucuresti,2222,4,4,4,6,23,23,0,16
FC Botosani,2222,5,3,5,6,5,17,-12,14
Concordia Ch,2222,6,3,3,8,20,23,-3,12
FCSB,2223,1,9,5,0,27,11,16,32
CFR Cluj,2223,2,6,6,2,17,10,7,24
Concordia Ch,2223,3,4,2,8,19,22,-3,14
D Bucuresti,2223,4,3,5,6,17,21,-4,14
Universitate,2223,5,3,5,6,16,24,-8,14
FC Botosani,2223,6,3,5,6,5,13,-8,14
FCSB,2224,1,8,5,1,24,12,12,29
CFR Cluj,2224,2,5,6,3,15,11,4,21
Universitate,2224,3,5,5,4,19,20,-1,20
D Bucuresti,2224,4,4,5,5,19,20,-1,17
FC Botosani,2224,5,4,4,6,7,14,-7,16
Concordia Ch,2224,6,2,3,9,16,23,-7,9
FCSB,2225,1,8,6,0,25,11,14,30
CFR Cluj,2225,2,6,6,2,17,8,9,24
D Bucuresti,2225,3,4,5,5,19,18,1,17
FC Botosani,2225,4,3,6,5,6,13,-7,15
Universitate,2225,5,3,6,5,15,23,-8,15
Concordia Ch,2225,6,2,3,9,16,25,-9,9
FCSB,2226,1,9,5,0,27,12,15,32
CFR Cluj,2226,2,5,6,3,16,13,3,21
D Bucuresti,2226,3,4,5,5,19,19,0,17
Universitate,2226,4,4,5,5,19,22,-3,17
FC Botosani,2226,5,4,5,5,8,14,-6,17
Concordia Ch,2226,6,2,2,10,16,25,-9,8
FCSB,2227,1,9,5,0,28,13,15,32
CFR Cluj,2227,2,6,6,2,16,8,8,24
FC Botosani,2227,3,5,4,5,8,13,-5,19
Universitate,2227,4,3,5,6,17,25,-8,14
D Bucuresti,2227,5,3,4,7,16,20,-4,13
Concordia Ch,2227,6,3,2,9,17,23,-6,11
FCSB,2228,1,9,5,0,30,11,19,32
CFR Cluj,2228,2,5,6,3,13,10,3,21
Universitate,2228,3,4,5,5,16,23,-7,17
D Bucuresti,2228,4,3,6,5,17,19,-2,15
FC Botosani,2228,5,3,5,6,6,14,-8,14
Concordia Ch,2228,6,3,3,8,18,23,-5,12
CFR Cluj,2229,1,7,6,1,17,7,10,27
FCSB,2229,2,7,5,2,23,12,11,26
FC Botosani,2229,3,5,4,5,7,12,-5,19
Universitate,2229,4,4,5,5,15,21,-6,17
D Bucuresti,2229,5,3,5,6,17,20,-3,14
Concordia Ch,2229,6,2,3,9,16,23,-7,9
FCSB,2230,1,8,5,1,25,11,14,29
CFR Cluj,2230,2,5,7,2,14,10,4,22
D Bucuresti,2230,3,5,4,5,20,20,0,19
Universitate,2230,4,4,6,4,16,19,-3,18
FC Botosani,2230,5,3,5,6,7,15,-8,14
Concordia Ch,2230,6,2,3,9,17,24,-7,9
FCSB,2231,1,8,6,0,26,11,15,30
CFR Cluj,2231,2,5,6,3,14,11,3,21
Universitate,2231,3,4,6,4,17,20,-3,18
FC Botosani,2231,4,4,5,5,7,13,-6,17
D Bucuresti,2231,5,3,5,6,17,20,-3,14
Concordia Ch,2231,6,2,4,8,17,23,-6,10
FCSB,2232,1,7,7,0,24,11,13,28
CFR Cluj,2232,2,6,7,1,15,8,7,25
FC Botosani,2232,3,4,5,5,8,14,-6,17
Universitate,2232,4,3,6,5,14,19,-5,15
D Bucuresti,2232,5,3,5,6,17,20,-3,14
Concordia Ch,2232,6,3,2,9,19,25,-6,11
FCSB,2233,1,8,5,1,26,16,10,29
CFR Cluj,2233,2,6,6,2,17,10,7,24
D Bucuresti,2233,3,5,4,5,20,18,2,19
Universitate,2233,4,4,5,5,18,20,-2,17
FC Botosani,2233,5,3,5,6,7,17,-10,14
Concordia Ch,2233,6,2,3,9,17,24,-7,9
FCSB,2234,1,8,5,1,27,11,16,29
CFR Cluj,2234,2,6,6,2,14,11,3,24
Universitate,2234,3,4,5,5,15,19,-4,17
D Bucuresti,2234,4,3,6,5,19,21,-2,15
FC Botosani,2234,5,3,6,5,7,14,-7,15
Concordia Ch,2234,6,2,4,8,16,22,-6,10
FCSB,2235,1,8,6,0,27,10,17,30
CFR Cluj,2235,2,6,6,2,16,11,5,24
D Bucuresti,2235,3,5,4,5,19,19,0,19
Universitate,2235,4,3,6,5,14,21,-7,15
FC Botosani,2235,5,3,5,6,7,15,-8,14
Concordia Ch,2235,6,2,3,9,18,25,-7,9
FCSB,2236,1,7,6,1,24,12,12,27
CFR Cluj,2236,2,6,7,1,14,7,7,25
D Bucuresti,2236,3,4,5,5,19,19,0,17
Universitate,2236,4,3,7,4,15,19,-4,16
FC Botosani,2236,5,3,5,6,6,15,-9,14
Concordia Ch,2236,6,2,4,8,17,23,-6,10
FCSB,2237,1,7,6,1,24,12,12,27
CFR Cluj,2237,2,5,7,2,13,8,5,22
Universitate,2237,3,5,5,4,17,19,-2,20
D Bucuresti,2237,4,4,4,6,20,23,-3,16
Concordia Ch,2237,5,4,2,8,21,23,-2,14
FC Botosani,2237,6,3,4,7,7,17,-10,13
FCSB,2238,1,7,6,1,24,13,11,27
CFR Cluj,2238,2,5,7,2,14,11,3,22
Universitate,2238,3,5,5,4,19,18,1,20
FC Botosani,2238,4,4,5,5,6,12,-6,17
D Bucuresti,2238,5,3,4,7,18,23,-5,13
Concordia Ch,2238,6,3,3,8,19,23,-4,12
FCSB,2239,1,9,5,0,29,12,17,32
CFR Cluj,2239,2,5,7,2,15,10,5,22
FC Botosani,2239,3,4,5,5,9,14,-5,17
D Bucuresti,2239,4,3,6,5,18,20,-2,15
Universitate,2239,5,3,6,5,16,23,-7,15
Concordia Ch,2239,6,2,3,9,19,27,-8,9
FCSB,2240,1,9,5,0,30,11,19,32
CFR Cluj,2240,2,5,7,2,14,9,5,22
FC Botosani,2240,3,5,4,5,7,12,-5,19
Universitate,2240,4,3,6,5,16,25,-9,15
D Bucuresti,2240,5,3,4,7,16,20,-4,13
Concordia Ch,2240,6,3,2,9,16,22,-6,11
FCSB,2241,1,7,6,1,25,13,12,27
CFR Cluj,2241,2,6,7,1,16,8,8,25
D Bucuresti,2241,3,4,5,5,20,20,0,17
Universitate,2241,4,4,5,5,18,23,-5,17
FC Botosani,2241,5,3,5,6,6,15,-9,14
Concordia Ch,2241,6,2,4,8,18,24,-6,10
FCSB,2242,1,8,5,1,29,13,16,29
CFR Cluj,2242,2,6,6,2,15,12,3,24
Universitate,2242,3,4,5,5,16,20,-4,17
D Bucuresti,2242,4,4,4,6,18,19,-1,16
Concordia Ch,2242,5,4,2,8,18,22,-4,14
FC Botosani,2242,6,3,4,7,6,16,-10,13
FCSB,2243,1,8,5,1,27,13,14,29
CFR Cluj,2243,2,5,7,2,14,10,4,22
Universitate,2243,3,4,6,4,18,21,-3,18
FC Botosani,2243,4,4,5,5,8,13,-5,17
D Bucuresti,2243,5,3,6,5,18,20,-2,15
Concordia Ch,2243,6,2,3,9,16,24,-8,9
FCSB,2244,1,8,6,0,25,11,14,30
CFR Cluj,2244,2,5,7,2,14,9,5,22
D Bucuresti,2244,3,4,4,6,18,19,-1,16
Universitate,2244,4,3,7,4,16,20,-4,16
FC Botosani,2244,5,3,5,6,6,15,-9,14
Concordia Ch,2244,6,3,3,8,17,22,-5,12
FCSB,2245,1,7,6,1,24,13,11,27
CFR Cluj,2245,2,6,7,1,17,9,8,25
Universitate,2245,3,3,7,4,17,21,-4,16
D Bucuresti,2245,4,3,6,5,17,19,-2,15
FC Botosani,2245,5,3,5,6,7,15,-8,14
Concordia Ch,2245,6,3,3,8,17,22,-5,12
FCSB,2246,1,8,5,1,26,13,13,29
CFR Cluj,2246,2,6,6,2,15,9,6,24
FC Botosani,2246,3,5,4,5,11,14,-3,19
Universitate,2246,4,4,5,5,16,20,-4,17
D Bucuresti,2246,5,3,5,6,19,22,-3,14
Concordia Ch,2246,6,2,3,9,16,25,-9,9
FCSB,2247,1,8,5,1,26,12,14,29
CFR Cluj,2247,2,5,7,2,13,10,3,22
Universitate,2247,3,4,6,4,16,18,-2,18
D Bucuresti,2247,4,4,5,5,20,21,-1,17
FC Botosani,2247,5,4,4,6,10,15,-5,16
Concordia Ch,2247,6,2,3,9,16,25,-9,9
FCSB,2248,1,8,6,0,25,11,14,30
CFR Cluj,2248,2,5,7,2,14,9,5,22
D Bucuresti,2248,3,4,5,5,18,19,-1,17
Universitate,2248,4,4,5,5,15,19,-4,17
FC Botosani,2248,5,3,5,6,6,14,-8,14
Concordia Ch,2248,6,2,4,8,17,23,-6,10
FCSB,2249,1,7,5,2,24,14,10,26
CFR Cluj,2249,2,6,7,1,16,8,8,25
Universitate,2249,3,4,6,4,17,20,-3,18
D Bucuresti,2249,4,3,6,5,17,19,-2,15
FC Botosani,2249,5,3,6,5,5,12,-7,15
Concordia Ch,2249,6,2,4,8,16,22,-6,10
FCSB,2250,1,7,7,0,24,11,13,28
CFR Cluj,2250,2,6,7,1,16,7,9,25
D Bucuresti,2250,3,4,5,5,19,20,-1,17
Universitate,2250,4,3,6,5,15,22,-7,15
FC Botosani,2250,5,3,5,6,6,16,-10,14
Concordia Ch,2250,6,3,2,9,19,23,-4,11
FCSB,2251,1,8,5,1,27,11,16,29
CFR Cluj,2251,2,5,6,3,14,13,1,21
Universitate,2251,3,5,5,4,17,19,-2,20
D Bucuresti,2251,4,3,6,5,19,21,-2,15
FC Botosani,2251,5,3,5,6,7,15,-8,14
Concordia Ch,2251,6,3,3,8,17,22,-5,12
FCSB,2252,1,8,5,1,25,12,13,29
CFR Cluj,2252,2,6,7,1,17,10,7,25
D Bucuresti,2252,3,4,4,6,19,20,-1,16
Universitate,2252,4,3,6,5,16,21,-5,15
Concordia Ch,2252,5,4,2,8,19,23,-4,14
FC Botosani,2252,6,3,4,7,6,16,-10,13
FCSB,2253,1,8,5,1,24,11,13,29
CFR Cluj,2253,2,6,6,2,14,8,6,24
D Bucuresti,2253,3,4,5,5,18,19,-1,17
Universitate,2253,4,4,5,5,15,19,-4,17
FC Botosani,2253,5,3,4,7,5,14,-9,13
Concordia Ch,2253,6,3,3,8,17,22,-5,12
FCSB,2254,1,7,6,1,25,14,11,27
CFR Cluj,2254,2,5,7,2,14,9,5,22
Universitate,2254,3,5,5,4,18,19,-1,20
FC Botosani,2254,4,4,5,5,7,13,-6,17
D Bucuresti,2254,5,3,6,5,16,18,-2,15
Concordia Ch,2254,6,2,3,9,16,23,-7,9
FCSB,2255,1,8,6,0,25,11,14,30
CFR Cluj,2255,2,6,7,1,15,8,7,25
D Bucuresti,2255,3,4,5,5,19,19,0,17
FC Botosani,2255,4,4,5,5,7,13,-6,17
Universitate,2255,5,3,5,6,14,20,-6,14
Concordia Ch,2255,6,2,2,10,17,26,-9,8
FCSB,2256,1,9,5,0,27,11,16,32
CFR Cluj,2256,2,6,6,2,15,10,5,24
D Bucuresti,2256,3,4,5,5,19,20,-1,17
FC Botosani,2256,4,4,5,5,8,14,-6,17
Universitate,2256,5,3,5,6,16,22,-6,14
Concordia Ch,2256,6,2,2,10,17,25,-8,8
FCSB,2257,1,8,6,0,27,12,15,30
CFR Cluj,2257,2,6,6,2,15,10,5,24
FC Botosani,2257,3,4,5,5,7,12,-5,17
D Bucuresti,2257,4,3,6,5,18,20,-2,15
Universitate,2257,5,3,6,5,17,22,-5,15
Concordia Ch,2257,6,2,3,9,17,25,-8,9
FCSB,2258,1,7,6,1,23,12,11,27
CFR Cluj,2258,2,5,7,2,13,8,5,22
Universitate,2258,3,5,5,4,17,18,-1,20
FC Botosani,2258,4,4,5,5,6,12,-6,17
D Bucuresti,2258,5,3,6,5,16,18,-2,15
Concordia Ch,2258,6,2,3,9,15,22,-7,9
FCSB,2259,1,8,6,0,28,13,15,30
CFR Cluj,2259,2,5,7,2,15,10,5,22
FC Botosani,2259,3,5,4,5,11,16,-5,19
Universitate,2259,4,4,5,5,18,23,-5,17
D Bucuresti,2259,5,3,5,6,20,23,-3,14
Concordia Ch,2259,6,2,3,9,19,26,-7,9
FCSB,2260,1,8,6,0,26,12,14,30
CFR Cluj,2260,2,5,7,2,14,9,5,22
D Bucuresti,2260,3,4,5,5,19,20,-1,17
Universitate,2260,4,4,5,5,18,22,-4,17
FC Botosani,2260,5,3,4,7,5,15,-10,13
Concordia Ch,2260,6,3,3,8,19,23,-4,12
FCSB,2261,1,7,6,1,24,12,12,27
CFR Cluj,2261,2,6,7,1,15,8,7,25
D Bucuresti,2261,3,4,5,5,17,18,-1,17
Universitate,2261,4,4,5,5,15,19,-4,17
FC Botosani,2261,5,3,6,5,6,13,-7,15
Concordia Ch,2261,6,2,3,9,16,23,-7,9
FCSB,2262,1,7,6,1,25,14,11,27
CFR Cluj,2262,2,5,8,1,16,10,6,23
Universitate,2262,3,4,6,4,19,21,-2,18
D Bucuresti,2262,4,4,5,5,20,19,1,17
FC Botosani,2262,5,3,5,6,8,17,-9,14
Concordia Ch,2262,6,3,2,9,19,26,-7,11
FCSB,2263,1,7,7,0,24,11,13,28
CFR Cluj,2263,2,5,8,1,15,9,6,23
Universitate,2263,3,3,7,4,15,19,-4,16
D Bucuresti,2263,4,3,6,5,19,21,-2,15
FC Botosani,2263,5,3,5,6,7,16,-9,14
Concordia Ch,2263,6,3,3,8,20,24,-4,12
CFR Cluj,2264,1,7,6,1,16,7,9,27
FCSB,2264,2,7,5,2,23,13,10,26
Universitate,2264,3,4,5,5,15,19,-4,17
D Bucuresti,2264,4,3,6,5,17,19,-2,15
FC Botosani,2264,5,3,5,6,5,13,-8,14
Concordia Ch,2264,6,3,3,8,17,22,-5,12
FCSB,2265,1,9,5,0,26,11,15,32
CFR Cluj,2265,2,5,7,2,15,10,5,22
FC Botosani,2265,3,4,5,5,8,14,-6,17
Universitate,2265,4,3,6,5,15,20,-5,15
D Bucuresti,2265,5,3,4,7,20,24,-4,13
Concordia Ch,2265,6,3,3,8,18,23,-5,12
FCSB,2266,1,8,5,1,25,12,13,29
CFR Cluj,2266,2,7,6,1,17,9,8,27
FC Botosani,2266,3,5,4,5,8,13,-5,19
Universitate,2266,4,3,5,6,15,21,-6,14
D Bucuresti,2266,5,3,4,7,19,23,-4,13
Concordia Ch,2266,6,3,2,9,20,26,-6,11
FCSB,2267,1,8,5,1,27,12,15,29
CFR Cluj,2267,2,6,7,1,17,10,7,25
FC Botosani,2267,3,4,5,5,8,13,-5,17
D Bucuresti,2267,4,4,4,6,21,23,-2,16
Universitate,2267,5,3,6,5,18,25,-7,15
Concordia Ch,2267,6,2,3,9,17,25,-8,9
FCSB,2268,1,9,5,0,26,10,16,32
CFR Cluj,2268,2,6,6,2,15,8,7,24
FC Botosani,2268,3,4,5,5,7,13,-6,17
D Bucuresti,2268,4,4,4,6,18,19,-1,16
Universitate,2268,5,3,5,6,14,22,-8,14
Concordia Ch,2268,6,2,3,9,16,24,-8,9
FCSB,2269,1,9,5,0,27,10,17,32
CFR Cluj,2269,2,5,6,3,14,11,3,21
Universitate,2269,3,4,5,5,16,21,-5,17
D Bucuresti,2269,4,4,4,6,17,19,-2,16
Concordia Ch,2269,5,4,2,8,18,21,-3,14
FC Botosani,2269,6,3,4,7,5,15,-10,13
FCSB,2270,1,9,5,0,27,12,15,32
CFR Cluj,2270,2,6,6,2,16,10,6,24
D Bucuresti,2270,3,4,4,6,22,21,1,16
FC Botosani,2270,4,4,4,6,7,17,-10,16
Universitate,2270,5,3,5,6,14,20,-6,14
Concordia Ch,2270,6,3,2,9,19,25,-6,11
FCSB,2271,1,8,5,1,25,12,13,29
CFR Cluj,2271,2,5,7,2,15,10,5,22
D Bucuresti,2271,3,5,4,5,21,19,2,19
Universitate,2271,4,4,6,4,16,19,-3,18
FC Botosani,2271,5,3,5,6,6,15,-9,14
Concordia Ch,2271,6,2,3,9,17,25,-8,9
FCSB,2272,1,9,5,0,27,11,16,32
CFR Cluj,2272,2,5,6,3,14,11,3,21
Universitate,2272,3,4,5,5,17,21,-4,17
D Bucuresti,2272,4,4,4,6,17,20,-3,16
FC Botosani,2272,5,4,4,6,6,13,-7,16
Concordia Ch,2272,6,3,2,9,17,22,-5,11
FCSB,2273,1,7,6,1,24,12,12,27
CFR Cluj,2273,2,6,7,1,15,8,7,25
D Bucuresti,2273,3,4,5,5,21,19,2,17
Universitate,2273,4,4,5,5,15,19,-4,17
FC Botosani,2273,5,3,5,6,8,17,-9,14
Concordia Ch,2273,6,3,2,9,19,27,-8,11
FCSB,2274,1,7,7,0,23,10,13,28
CFR Cluj,2274,2,5,7,2,13,8,5,22
Universitate,2274,3,4,6,4,15,18,-3,18
D Bucuresti,2274,4,4,4,6,17,21,-4,16
FC Botosani,2274,5,4,4,6,6,13,-7,16
Concordia Ch,2274,6,3,2,9,18,22,-4,11
FCSB,2275,1,8,6,0,26,11,15,30
CFR Cluj,2275,2,5,7,2,14,9,5,22
Universitate,2275,3,4,5,5,17,22,-5,17
FC Botosani,2275,4,4,4,6,7,15,-8,16
D Bucuresti,2275,5,3,5,6,19,22,-3,14
Concordia Ch,2275,6,3,3,8,19,23,-4,12
FCSB,2276,1,8,6,0,26,10,16,30
CFR Cluj,2276,2,6,6,2,14,10,4,24
D Bucuresti,2276,3,4,4,6,18,20,-2,16
FC Botosani,2276,4,4,4,6,7,16,-9,16
Universitate,2276,5,3,6,5,14,19,-5,15
Concordia Ch,2276,6,3,2,9,18,22,-4,11
FCSB,2277,1,7,6,1,24,12,12,27
CFR Cluj,2277,2,7,6,1,15,7,8,27
FC Botosani,2277,3,4,5,5,9,14,-5,17
Universitate,2277,4,3,6,5,15,20,-5,15
D Bucuresti,2277,5,3,5,6,19,24,-5,14
Concordia Ch,2277,6,3,2,9,19,24,-5,11
FCSB,2278,1,8,5,1,27,13,14,29
CFR Cluj,2278,2,5,7,2,17,13,4,22
Universitate,2278,3,4,6,4,19,22,-3,18
D Bucuresti,2278,4,4,5,5,17,18,-1,17
FC Botosani,2278,5,4,4,6,8,13,-5,16
Concordia Ch,2278,6,2,3,9,15,24,-9,9
FCSB,2279,1,7,6,1,23,11,12,27
CFR Cluj,2279,2,6,7,1,15,7,8,25
Universitate,2279,3,4,5,5,15,20,-5,17
FC Botosani,2279,4,4,5,5,7,13,-6,17
D Bucuresti,2279,5,3,4,7,17,22,-5,13
Concordia Ch,2279,6,3,3,8,19,23,-4,12
FCSB,2280,1,8,6,0,27,11,16,30
CFR Cluj,2280,2,5,7,2,14,9,5,22
FC Botosani,2280,3,4,5,5,10,14,-4,17
Universitate,2280,4,4,5,5,15,21,-6,17
D Bucuresti,2280,5,3,6,5,18,20,-2,15
Concordia Ch,2280,6,2,3,9,17,26,-9,9
FCSB,2281,1,7,7,0,24,11,13,28
CFR Cluj,2281,2,5,7,2,13,10,3,22
Universitate,2281,3,4,6,4,18,19,-1,18
D Bucuresti,2281,4,4,5,5,18,18,0,17
FC Botosani,2281,5,3,5,6,5,14,-9,14
Concordia Ch,2281,6,2,4,8,15,21,-6,10
FCSB,2282,1,8,5,1,26,15,11,29
CFR Cluj,2282,2,6,6,2,15,9,6,24
Universitate,2282,3,4,5,5,18,20,-2,17
D Bucuresti,2282,4,4,4,6,18,22,-4,16
Concordia Ch,2282,5,4,2,8,20,22,-2,14
FC Botosani,2282,6,3,4,7,5,14,-9,13
FCSB,2283,1,7,6,1,23,12,11,27
CFR Cluj,2283,2,6,7,1,17,9,8,25
D Bucuresti,2283,3,4,5,5,19,20,-1,17
Universitate,2283,4,3,7,4,16,20,-4,16
FC Botosani,2283,5,3,5,6,6,14,-8,14
Concordia Ch,2283,6,3,2,9,19,25,-6,11
FCSB,2284,1,7,6,1,25,13,12,27
CFR Cluj,2284,2,5,8,1,15,9,6,23
Universitate,2284,3,4,6,4,17,20,-3,18
FC Botosani,2284,4,4,5,5,7,13,-6,17
D Bucuresti,2284,5,3,6,5,18,20,-2,15
Concordia Ch,2284,6,2,3,9,16,23,-7,9
FCSB,2285,1,8,5,1,25,12,13,29
CFR Cluj,2285,2,6,6,2,15,9,6,24
D Bucuresti,2285,3,5,4,5,21,19,2,19
Universitate,2285,4,4,5,5,15,19,-4,17
FC Botosani,2285,5,3,4,7,9,18,-9,13
Concordia Ch,2285,6,3,2,9,19,27,-8,11
FCSB,2286,1,7,6,1,25,13,12,27
CFR Cluj,2286,2,5,7,2,14,9,5,22
Universitate,2286,3,5,5,4,17,19,-2,20
FC Botosani,2286,4,5,4,5,9,13,-4,19
D Bucuresti,2286,5,3,4,7,18,22,-4,13
Concordia Ch,2286,6,3,2,9,17,24,-7,11
CFR Cluj,2287,1,7,6,1,16,8,8,27
FCSB,2287,2,7,5,2,24,14,10,26
D Bucuresti,2287,3,4,5,5,20,21,-1,17
Universitate,2287,4,4,5,5,16,19,-3,17
FC Botosani,2287,5,3,5,6,8,16,-8,14
Concordia Ch,2287,6,3,2,9,18,24,-6,11
FCSB,2288,1,8,5,1,27,11,16,29
CFR Cluj,2288,2,5,7,2,15,13,2,22
Universitate,2288,3,4,6,4,17,20,-3,18
D Bucuresti,2288,4,4,5,5,18,18,0,17
FC Botosani,2288,5,3,6,5,6,13,-7,15
Concordia Ch,2288,6,2,3,9,16,24,-8,9
FCSB,2289,1,8,5,1,24,11,13,29
CFR Cluj,2289,2,5,7,2,14,9,5,22
Universitate,2289,3,4,6,4,16,19,-3,18
D Bucuresti,2289,4,3,6,5,17,19,-2,15
FC Botosani,2289,5,3,5,6,5,13,-8,14
Concordia Ch,2289,6,3,3,8,17,22,-5,12
FCSB,2290,1,8,5,1,24,11,13,29
CFR Cluj,2290,2,7,6,1,15,7,8,27
D Bucuresti,2290,3,4,4,6,17,20,-3,16
Universitate,2290,4,3,5,6,14,20,-6,14
FC Botosani,2290,5,3,5,6,5,13,-8,14
Concordia Ch,2290,6,3,3,8,17,21,-4,12
FCSB,2291,1,8,5,1,25,11,14,29
CFR Cluj,2291,2,7,6,1,15,7,8,27
FC Botosani,2291,3,4,4,6,8,14,-6,16
Concordia Ch,2291,4,4,2,8,19,22,-3,14
Universitate,2291,5,3,5,6,14,21,-7,14
D Bucuresti,2291,6,3,4,7,18,24,-6,13
FCSB,2292,1,8,5,1,26,12,14,29
CFR Cluj,2292,2,6,6,2,15,9,6,24
D Bucuresti,2292,3,5,4,5,21,21,0,19
Universitate,2292,4,4,5,5,15,20,-5,17
FC Botosani,2292,5,4,4,6,8,15,-7,16
Concordia Ch,2292,6,2,2,10,16,24,-8,8
FCSB,2293,1,8,6,0,24,10,14,30
CFR Cluj,2293,2,6,6,2,16,8,8,24
D Bucuresti,2293,3,4,5,5,19,20,-1,17
FC Botosani,2293,4,4,4,6,8,14,-6,16
Universitate,2293,5,3,6,5,14,21,-7,15
Concordia Ch,2293,6,2,3,9,16,24,-8,9
FCSB,2294,1,7,7,0,25,12,13,28
CFR Cluj,2294,2,6,7,1,15,8,7,25
D Bucuresti,2294,3,5,4,5,21,18,3,19
Universitate,2294,4,3,6,5,15,20,-5,15
FC Botosani,2294,5,3,4,7,5,15,-10,13
Concordia Ch,2294,6,3,2,9,16,24,-8,11
FCSB,2295,1,7,6,1,23,12,11,27
CFR Cluj,2295,2,6,7,1,15,8,7,25
Universitate,2295,3,4,5,5,17,20,-3,17
D Bucuresti,2295,4,4,4,6,17,20,-3,16
Concordia Ch,2295,5,4,2,8,18,21,-3,14
FC Botosani,2295,6,3,4,7,5,14,-9,13
FCSB,2296,1,8,5,1,25,12,13,29
CFR Cluj,2296,2,7,6,1,19,8,11,27
D Bucuresti,2296,3,4,4,6,19,21,-2,16
Universitate,2296,4,3,5,6,14,23,-9,14
FC Botosani,2296,5,3,5,6,6,15,-9,14
Concordia Ch,2296,6,3,3,8,19,23,-4,12
FCSB,2297,1,9,5,0,28,11,17,32
CFR Cluj,2297,2,6,6,2,16,10,6,24
D Bucuresti,2297,3,4,5,5,18,19,-1,17
Universitate,2297,4,3,5,6,15,23,-8,14
FC Botosani,2297,5,3,4,7,6,15,-9,13
Concordia Ch,2297,6,3,3,8,16,21,-5,12
CFR Cluj,2298,1,7,6,1,16,8,8,27
FCSB,2298,2,7,5,2,23,15,8,26
Universitate,2298,3,4,5,5,19,20,-1,17
D Bucuresti,2298,4,4,5,5,18,19,-1,17
FC Botosani,2298,5,4,4,6,7,14,-7,16
Concordia Ch,2298,6,2,3,9,17,24,-7,9
FCSB,2299,1,9,5,0,27,11,16,32
CFR Cluj,2299,2,5,6,3,14,11,3,21
Universitate,2299,3,4,5,5,17,21,-4,17
D Bucuresti,2299,4,4,4,6,18,25,-7,16
Concordia Ch,2299,5,4,2,8,23,21,2,14
FC Botosani,2299,6,3,4,7,6,16,-10,13
FCSB,2300,1,7,6,1,23,12,11,27
CFR Cluj,2300,2,6,7,1,15,8,7,25
D Bucuresti,2300,3,4,5,5,19,19,0,17
Universitate,2300,4,4,5,5,17,20,-3,17
FC Botosani,2300,5,3,5,6,5,14,-9,14
Concordia Ch,2300,6,2,4,8,16,22,-6,10
FCSB,2301,1,8,5,1,25,11,14,29
CFR Cluj,2301,2,5,6,3,13,10,3,21
Universitate,2301,3,5,5,4,16,18,-2,20
D Bucuresti,2301,4,4,5,5,18,18,0,17
FC Botosani,2301,5,3,5,6,5,14,-9,14
Concordia Ch,2301,6,3,2,9,17,23,-6,11
FCSB,2302,1,7,6,1,26,14,12,27
CFR Cluj,2302,2,6,7,1,18,9,9,25
D Bucuresti,2302,3,4,5,5,19,20,-1,17
Universitate,2302,4,4,5,5,16,22,-6,17
FC Botosani,2302,5,3,4,7,5,14,-9,13
Concordia Ch,2302,6,3,3,8,18,23,-5,12
FCSB,2303,1,9,5,0,26,10,16,32
CFR Cluj,2303,2,5,6,3,13,9,4,21
Universitate,2303,3,4,5,5,15,20,-5,17
D Bucuresti,2303,4,3,6,5,17,19,-2,15
FC Botosani,2303,5,3,6,5,6,13,-7,15
Concordia Ch,2303,6,2,4,8,15,21,-6,10
FCSB,2304,1,7,6,1,27,15,12,27
CFR Cluj,2304,2,6,7,1,18,10,8,25
D Bucuresti,2304,3,5,4,5,21,19,2,19
Universitate,2304,4,4,5,5,16,21,-5,17
FC Botosani,2304,5,3,5,6,6,16,-10,14
Concordia Ch,2304,6,2,3,9,17,24,-7,9
FCSB,2305,1,8,6,0,28,12,16,30
CFR Cluj,2305,2,5,6,3,13,11,2,21
Universitate,2305,3,4,6,4,17,20,-3,18
D Bucuresti,2305,4,4,4,6,18,21,-3,16
FC Botosani,2305,5,4,4,6,7,13,-6,16
Concordia Ch,2305,6,3,2,9,18,24,-6,11
FCSB,2306,1,7,6,1,24,13,11,27
CFR Cluj,2306,2,5,8,1,14,8,6,23
D Bucuresti,2306,3,5,4,5,22,22,0,19
Universitate,2306,4,4,6,4,18,20,-2,18
FC Botosani,2306,5,4,4,6,8,14,-6,16
Concordia Ch,2306,6,2,2,10,18,27,-9,8
FCSB,2307,1,8,6,0,29,14,15,30
CFR Cluj,2307,2,6,6,2,17,11,6,24
Universitate,2307,3,3,6,5,16,22,-6,15
Concordia Ch,2307,4,4,2,8,20,22,-2,14
D Bucuresti,2307,5,3,5,6,16,20,-4,14
FC Botosani,2307,6,3,5,6,6,15,-9,14
FCSB,2308,1,8,5,1,25,12,13,29
CFR Cluj,2308,2,7,6,1,15,7,8,27
Concordia Ch,2308,3,4,2,8,19,22,-3,14
D Bucuresti,2308,4,3,5,6,17,21,-4,14
Universitate,2308,5,3,5,6,15,21,-6,14
FC Botosani,2308,6,3,5,6,5,13,-8,14
FCSB,2309,1,8,5,1,26,12,14,29
CFR Cluj,2309,2,5,6,3,14,11,3,21
Universitate,2309,3,5,5,4,16,18,-2,20
FC Botosani,2309,4,4,4,6,7,14,-7,16
Concordia Ch,2309,5,4,2,8,20,23,-3,14
D Bucuresti,2309,6,3,4,7,17,22,-5,13
FCSB,2310,1,8,5,1,26,12,14,29
CFR Cluj,2310,2,5,7,2,13,9,4,22
Universitate,2310,3,4,6,4,16,19,-3,18
FC Botosani,2310,4,4,4,6,8,15,-7,16
Concordia Ch,2310,5,4,2,8,19,22,-3,14
D Bucuresti,2310,6,3,4,7,16,21,-5,13
FCSB,2311,1,7,7,0,23,10,13,28
CFR Cluj,2311,2,5,8,1,13,7,6,23
FC Botosani,2311,3,4,5,5,7,13,-6,17
D Bucuresti,2311,4,4,4,6,18,20,-2,16
Universitate,2311,5,3,7,4,14,18,-4,16
Concordia Ch,2311,6,2,3,9,15,22,-7,9
FCSB,2312,1,8,5,1,27,12,15,29
CFR Cluj,2312,2,7,6,1,17,9,8,27
FC Botosani,2312,3,5,4,5,10,12,-2,19
D Bucuresti,2312,4,3,5,6,16,22,-6,14
Universitate,2312,5,3,5,6,15,23,-8,14
Concordia Ch,2312,6,2,3,9,15,22,-7,9
FCSB,2313,1,8,6,0,27,12,15,30
CFR Cluj,2313,2,5,7,2,14,10,4,22
D Bucuresti,2313,3,4,5,5,19,19,0,17
Universitate,2313,4,3,7,4,15,19,-4,16
FC Botosani,2313,5,3,4,7,5,15,-10,13
Concordia Ch,2313,6,3,3,8,17,22,-5,12
FCSB,2314,1,8,6,0,26,11,15,30
CFR Cluj,2314,2,6,6,2,17,10,7,24
D Bucuresti,2314,3,4,4,6,18,20,-2,16
FC Botosani,2314,4,4,4,6,7,14,-7,16
Universitate,2314,5,3,6,5,16,23,-7,15
Concordia Ch,2314,6,3,2,9,18,24,-6,11
FCSB,2315,1,8,5,1,25,12,13,29
CFR Cluj,2315,2,6,7,1,14,7,7,25
D Bucuresti,2315,3,4,4,6,18,20,-2,16
Universitate,2315,4,3,6,5,15,20,-5,15
FC Botosani,2315,5,3,5,6,7,15,-8,14
Concordia Ch,2315,6,3,3,8,19,24,-5,12
FCSB,2316,1,8,5,1,26,12,14,29
CFR Cluj,2316,2,6,6,2,15,9,6,24
Universitate,2316,3,4,5,5,15,20,-5,17
D Bucuresti,2316,4,4,4,6,19,21,-2,16
FC Botosani,2316,5,4,4,6,8,15,-7,16
Concordia Ch,2316,6,3,2,9,18,24,-6,11
FCSB,2317,1,8,6,0,27,12,15,30
CFR Cluj,2317,2,5,6,3,14,12,2,21
Universitate,2317,3,4,6,4,17,19,-2,18
FC Botosani,2317,4,4,4,6,8,15,-7,16
Concordia Ch,2317,5,4,2,8,20,23,-3,14
D Bucuresti,2317,6,3,4,7,17,22,-5,13
FCSB,2318,1,8,6,0,26,11,15,30
CFR Cluj,2318,2,6,6,2,15,10,5,24
D Bucuresti,2318,3,4,4,6,19,23,-4,16
Universitate,2318,4,3,6,5,16,21,-5,15
Concordia Ch,2318,5,4,2,8,20,22,-2,14
FC Botosani,2318,6,3,4,7,6,15,-9,13
FCSB,2319,1,9,5,0,29,12,17,32
CFR Cluj,2319,2,5,7,2,14,10,4,22
D Bucuresti,2319,3,4,5,5,20,21,-1,17
FC Botosani,2319,4,4,5,5,9,13,-4,17
Universitate,2319,5,3,6,5,15,21,-6,15
Concordia Ch,2319,6,2,2,10,17,27,-10,8
FCSB,2320,1,7,7,0,24,11,13,28
CFR Cluj,2320,2,5,7,2,14,9,5,22
Universitate,2320,3,4,6,4,17,20,-3,18
FC Botosani,2320,4,4,4,6,8,15,-7,16
D Bucuresti,2320,5,3,5,6,18,21,-3,14
Concordia Ch,2320,6,3,3,8,18,23,-5,12
FCSB,2321,1,7,5,2,23,16,7,26
CFR Cluj,2321,2,6,6,2,15,8,7,24
Universitate,2321,3,5,5,4,19,18,1,20
D Bucuresti,2321,4,3,6,5,19,21,-2,15
FC Botosani,2321,5,3,5,6,6,14,-8,14
Concordia Ch,2321,6,3,3,8,18,23,-5,12
FCSB,2322,1,9,5,0,31,13,18,32
CFR Cluj,2322,2,6,6,2,16,11,5,24
D Bucuresti,2322,3,4,5,5,19,19,0,17
FC Botosani,2322,4,4,4,6,7,14,-7,16
Universitate,2322,5,3,5,6,15,23,-8,14
Concordia Ch,2322,6,2,3,9,16,24,-8,9
FCSB,2323,1,9,5,0,25,10,15,32
CFR Cluj,2323,2,6,6,2,15,8,7,24
FC Botosani,2323,3,4,4,6,6,14,-8,16
D Bucuresti,2323,4,3,5,6,18,21,-3,14
Universitate,2323,5,3,5,6,14,21,-7,14
Concordia Ch,2323,6,3,3,8,19,23,-4,12
FCSB,2324,1,7,6,1,24,12,12,27
CFR Cluj,2324,2,6,7,1,15,8,7,25
D Bucuresti,2324,3,4,4,6,17,21,-4,16
Universitate,2324,4,3,7,4,16,20,-4,16
FC Botosani,2324,5,3,5,6,7,15,-8,14
Concordia Ch,2324,6,3,3,8,20,23,-3,12
FCSB,2325,1,8,5,1,26,12,14,29
CFR Cluj,2325,2,5,6,3,15,12,3,21
Universitate,2325,3,5,5,4,19,21,-2,20
Concordia Ch,2325,4,4,2,8,19,21,-2,14
D Bucuresti,2325,5,3,5,6,18,23,-5,14
FC Botosani,2325,6,3,5,6,7,15,-8,14
FCSB,2326,1,9,5,0,29,12,17,32
CFR Cluj,2326,2,5,6,3,16,12,4,21
Universitate,2326,3,4,5,5,16,22,-6,17
D Bucuresti,2326,4,4,4,6,19,21,-2,16
FC Botosani,2326,5,4,4,6,7,15,-8,16
Concordia Ch,2326,6,3,2,9,19,24,-5,11
FCSB,2327,1,8,5,1,26,14,12,29
CFR Cluj,2327,2,6,6,2,16,9,7,24
Universitate,2327,3,4,5,5,17,21,-4,17
D Bucuresti,2327,4,3,6,5,17,19,-2,15
FC Botosani,2327,5,3,6,5,5,12,-7,15
Concordia Ch,2327,6,2,4,8,16,22,-6,10
FCSB,2328,1,8,5,1,25,12,13,29
CFR Cluj,2328,2,5,6,3,13,9,4,21
Universitate,2328,3,5,5,4,17,19,-2,20
FC Botosani,2328,4,4,5,5,6,12,-6,17
D Bucuresti,2328,5,3,5,6,17,20,-3,14
Concordia Ch,2328,6,3,2,9,17,23,-6,11
FCSB,2329,1,7,6,1,24,12,12,27
CFR Cluj,2329,2,6,7,1,15,8,7,25
Universitate,2329,3,4,5,5,15,19,-4,17
D Bucuresti,2329,4,3,6,5,20,22,-2,15
FC Botosani,2329,5,3,5,6,7,15,-8,14
Concordia Ch,2329,6,3,3,8,20,25,-5,12
FCSB,2330,1,8,5,1,24,13,11,29
CFR Cluj,2330,2,5,7,2,14,9,5,22
Universitate,2330,3,4,6,4,18,19,-1,18
FC Botosani,2330,4,3,6,5,7,14,-7,15
D Bucuresti,2330,5,3,5,6,17,20,-3,14
Concordia Ch,2330,6,3,3,8,17,22,-5,12
FCSB,2331,1,8,6,0,26,11,15,30
CFR Cluj,2331,2,5,7,2,14,10,4,22
D Bucuresti,2331,3,5,4,5,21,19,2,19
Universitate,2331,4,3,7,4,16,20,-4,16
FC Botosani,2331,5,3,5,6,6,15,-9,14
Concordia Ch,2331,6,2,3,9,17,25,-8,9
FCSB,2332,1,7,6,1,24,14,10,27
CFR Cluj,2332,2,6,7,1,15,8,7,25
Universitate,2332,3,4,5,5,17,19,-2,17
D Bucuresti,2332,4,4,4,6,18,20,-2,16
Concordia Ch,2332,5,4,2,8,17,21,-4,14
FC Botosani,2332,6,3,4,7,6,15,-9,13
FCSB,2333,1,7,5,2,23,15,8,26
CFR Cluj,2333,2,6,6,2,15,9,6,24
Universitate,2333,3,5,5,4,19,18,1,20
D Bucuresti,2333,4,3,6,5,19,21,-2,15
FC Botosani,2333,5,3,5,6,6,16,-10,14
Concordia Ch,2333,6,3,3,8,20,23,-3,12
FCSB,2334,1,7,5,2,26,16,10,26
CFR Cluj,2334,2,6,7,1,17,10,7,25
D Bucuresti,2334,3,5,4,5,20,19,1,19
Universitate,2334,4,4,6,4,18,20,-2,18
FC Botosani,2334,5,3,5,6,7,15,-8,14
Concordia Ch,2334,6,2,3,9,18,26,-8,9
FCSB,2335,1,8,5,1,25,13,12,29
CFR Cluj,2335,2,6,6,2,16,10,6,24
FC Botosani,2335,3,5,4,5,8,12,-4,19
Universitate,2335,4,4,5,5,19,22,-3,17
D Bucuresti,2335,5,3,4,7,17,22,-5,13
Concordia Ch,2335,6,3,2,9,17,23,-6,11
FCSB,2336,1,9,5,0,25,10,15,32
CFR Cluj,2336,2,6,6,2,15,8,7,24
FC Botosani,2336,3,4,5,5,8,14,-6,17
D Bucuresti,2336,4,3,6,5,17,19,-2,15
Universitate,2336,5,3,5,6,14,21,-7,14
Concordia Ch,2336,6,2,3,9,16,23,-7,9
FCSB,2337,1,9,5,0,26,11,15,32
CFR Cluj,2337,2,5,6,3,14,10,4,21
D Bucuresti,2337,3,4,5,5,18,19,-1,17
Universitate,2337,4,4,5,5,15,19,-4,17
FC Botosani,2337,5,4,4,6,9,16,-7,16
Concordia Ch,2337,6,2,3,9,17,24,-7,9
FCSB,2338,1,8,5,1,25,12,13,29
CFR Cluj,2338,2,7,6,1,19,8,11,27
D Bucuresti,2338,3,5,4,5,19,19,0,19
Universitate,2338,4,3,5,6,14,23,-9,14
FC Botosani,2338,5,3,4,7,7,16,-9,13
Concordia Ch,2338,6,3,2,9,17,23,-6,11
FCSB,2339,1,9,5,0,27,11,16,32
CFR Cluj,2339,2,6,6,2,15,9,6,24
FC Botosani,2339,3,4,5,5,7,13,-6,17
D Bucuresti,2339,4,3,5,6,16,20,-4,14
Universitate,2339,5,3,5,6,15,22,-7,14
Concordia Ch,2339,6,3,2,9,18,23,-5,11
FCSB,2340,1,7,6,1,23,13,10,27
CFR Cluj,2340,2,5,7,2,13,8,5,22
Universitate,2340,3,5,5,4,18,18,0,20
D Bucuresti,2340,4,5,4,5,19,19,0,19
FC Botosani,2340,5,3,4,7,5,14,-9,13
Concordia Ch,2340,6,3,2,9,17,23,-6,11
FCSB,2341,1,9,5,0,25,10,15,32
CFR Cluj,2341,2,5,6,3,14,11,3,21
D Bucuresti,2341,3,5,4,5,21,19,2,19
Universitate,2341,4,4,5,5,17,20,-3,17
FC Botosani,2341,5,3,5,6,6,16,-10,14
Concordia Ch,2341,6,2,3,9,17,24,-7,9
FCSB,2342,1,7,5,2,25,15,10,26
CFR Cluj,2342,2,6,6,2,16,10,6,24
Universitate,2342,3,5,5,4,19,20,-1,20
D Bucuresti,2342,4,3,6,5,19,21,-2,15
FC Botosani,2342,5,3,6,5,6,13,-7,15
Concordia Ch,2342,6,2,4,8,17,23,-6,10
FCSB,2343,1,7,6,1,23,11,12,27
CFR Cluj,2343,2,5,8,1,14,8,6,23
Universitate,2343,3,4,6,4,16,19,-3,18
FC Botosani,2343,4,3,6,5,8,15,-7,15
D Bucuresti,2343,5,3,5,6,17,20,-3,14
Concordia Ch,2343,6,3,3,8,18,23,-5,12
FCSB,2344,1,7,6,1,25,14,11,27
CFR Cluj,2344,2,7,6,1,18,8,10,27
FC Botosani,2344,3,4,5,5,12,15,-3,17
Universitate,2344,4,3,6,5,15,21,-6,15
D Bucuresti,2344,5,3,5,6,18,21,-3,14
Concordia Ch,2344,6,3,2,9,17,26,-9,11
FCSB,2345,1,8,5,1,26,12,14,29
CFR Cluj,2345,2,5,6,3,14,11,3,21
Universitate,2345,3,5,5,4,16,18,-2,20
FC Botosani,2345,4,4,4,6,7,14,-7,16
D Bucuresti,2345,5,3,5,6,18,21,-3,14
Concordia Ch,2345,6,3,3,8,17,22,-5,12
FCSB,2346,1,8,5,1,25,12,13,29
CFR Cluj,2346,2,6,6,2,16,9,7,24
Universitate,2346,3,4,5,5,17,22,-5,17
FC Botosani,2346,4,4,5,5,8,14,-6,17
D Bucuresti,2346,5,3,4,7,17,21,-4,13
Concordia Ch,2346,6,3,3,8,17,22,-5,12
FCSB,2347,1,7,7,0,24,11,13,28
CFR Cluj,2347,2,6,7,1,14,7,7,25
D Bucuresti,2347,3,4,5,5,19,18,1,17
Universitate,2347,4,3,6,5,15,20,-5,15
FC Botosani,2347,5,3,6,5,5,12,-7,15
Concordia Ch,2347,6,2,3,9,15,24,-9,9
FCSB,2348,1,8,5,1,24,13,11,29
CFR Cluj,2348,2,7,6,1,18,7,11,27
D Bucuresti,2348,3,4,5,5,20,20,0,17
FC Botosani,2348,4,4,5,5,8,14,-6,17
Universitate,2348,5,3,5,6,14,21,-7,14
Concordia Ch,2348,6,2,2,10,15,24,-9,8
CFR Cluj,2349,1,7,6,1,16,8,8,27
FCSB,2349,2,7,5,2,24,16,8,26
Universitate,2349,3,4,5,5,20,21,-1,17
D Bucuresti,2349,4,4,4,6,18,20,-2,16
FC Botosani,2349,5,4,4,6,7,14,-7,16
Concordia Ch,2349,6,3,2,9,16,22,-6,11
CFR Cluj,2350,1,7,6,1,19,7,12,27
FCSB,2350,2,7,5,2,23,13,10,26
FC Botosani,2350,3,4,5,5,7,13,-6,17
Universitate,2350,4,4,5,5,15,22,-7,17
D Bucuresti,2350,5,3,5,6,17,21,-4,14
Concordia Ch,2350,6,3,2,9,17,22,-5,11
FCSB,2351,1,8,6,0,25,11,14,30
CFR Cluj,2351,2,6,6,2,15,9,6,24
FC Botosani,2351,3,5,4,5,11,13,-2,19
Universitate,2351,4,3,6,5,14,19,-5,15
D Bucuresti,2351,5,3,5,6,16,22,-6,14
Concordia Ch,2351,6,2,3,9,16,23,-7,9
FCSB,2352,1,9,5,0,27,10,17,32
CFR Cluj,2352,2,5,7,2,13,9,4,22
FC Botosani,2352,3,4,5,5,9,13,-4,17
Universitate,2352,4,3,6,5,14,20,-6,15
D Bucuresti,2352,5,3,5,6,17,21,-4,14
Concordia Ch,2352,6,3,2,9,17,24,-7,11
FCSB,2353,1,8,6,0,25,11,14,30
CFR Cluj,2353,2,6,6,2,14,8,6,24
D Bucuresti,2353,3,5,4,5,20,19,1,19
FC Botosani,2353,4,4,4,6,7,13,-6,16
Universitate,2353,5,3,6,5,15,20,-5,15
Concordia Ch,2353,6,2,2,10,16,26,-10,8
FCSB,2354,1,8,5,1,26,13,13,29
CFR Cluj,2354,2,5,6,3,14,10,4,21
Universitate,2354,3,5,5,4,17,19,-2,20
D Bucuresti,2354,4,3,6,5,18,20,-2,15
FC Botosani,2354,5,3,6,5,6,13,-7,15
Concordia Ch,2354,6,2,4,8,16,22,-6,10
FCSB,2355,1,8,5,1,25,11,14,29
CFR Cluj,2355,2,6,7,1,14,7,7,25
FC Botosani,2355,3,5,4,5,9,13,-4,19
Universitate,2355,4,3,6,5,14,20,-6,15
D Bucuresti,2355,5,3,4,7,17,22,-5,13
Concordia Ch,2355,6,3,2,9,16,22,-6,11
FCSB,2356,1,7,6,1,24,12,12,27
CFR Cluj,2356,2,6,7,1,14,7,7,25
D Bucuresti,2356,3,4,5,5,17,18,-1,17
Universitate,2356,4,3,7,4,15,19,-4,16
FC Botosani,2356,5,3,4,7,5,14,-9,13
Concordia Ch,2356,6,3,3,8,16,21,-5,12
FCSB,2357,1,9,5,0,27,11,16,32
CFR Cluj,2357,2,5,6,3,13,10,3,21
D Bucuresti,2357,3,4,5,5,20,20,0,17
Universitate,2357,4,4,5,5,17,21,-4,17
FC Botosani,2357,5,3,5,6,6,15,-9,14
Concordia Ch,2357,6,3,2,9,18,24,-6,11
FCSB,2358,1,9,5,0,27,11,16,32
CFR Cluj,2358,2,5,7,2,16,11,5,22
FC Botosani,2358,3,4,5,5,9,13,-4,17
Universitate,2358,4,3,6,5,16,22,-6,15
D Bucuresti,2358,5,3,4,7,16,23,-7,13
Concordia Ch,2358,6,3,3,8,18,22,-4,12
FCSB,2359,1,8,6,0,25,10,15,30
CFR Cluj,2359,2,5,7,2,14,10,4,22
Universitate,2359,3,3,7,4,15,19,-4,16
D Bucuresti,2359,4,3,5,6,18,21,-3,14
Concordia Ch,2359,5,4,2,8,18,22,-4,14
FC Botosani,2359,6,3,5,6,6,14,-8,14
FCSB,2360,1,8,5,1,27,14,13,29
CFR Cluj,2360,2,6,6,2,18,11,7,24
Universitate,2360,3,4,5,5,16,21,-5,17
D Bucuresti,2360,4,4,4,6,18,21,-3,16
FC Botosani,2360,5,4,4,6,7,14,-7,16
Concordia Ch,2360,6,3,2,9,18,23,-5,11
FCSB,2361,1,8,5,1,27,14,13,29
CFR Cluj,2361,2,6,6,2,15,10,5,24
Universitate,2361,3,4,5,5,17,20,-3,17
FC Botosani,2361,4,4,5,5,9,15,-6,17
D Bucuresti,2361,5,3,6,5,19,21,-2,15
Concordia Ch,2361,6,2,3,9,15,22,-7,9
CFR Cluj,2362,1,7,6,1,16,8,8,27
FCSB,2362,2,7,5,2,25,15,10,26
Universitate,2362,3,4,5,5,17,20,-3,17
FC Botosani,2362,4,4,5,5,7,13,-6,17
D Bucuresti,2362,5,3,5,6,18,21,-3,14
Concordia Ch,2362,6,3,2,9,17,23,-6,11
FCSB,2363,1,7,6,1,26,15,11,27
CFR Cluj,2363,2,7,6,1,17,8,9,27
FC Botosani,2363,3,5,4,5,8,13,-5,19
Universitate,2363,4,3,6,5,16,21,-5,15
D Bucuresti,2363,5,3,5,6,17,20,-3,14
Concordia Ch,2363,6,2,3,9,17,24,-7,9
FCSB,2364,1,8,6,0,26,10,16,30
CFR Cluj,2364,2,6,7,1,14,7,7,25
D Bucuresti,2364,3,4,4,6,17,20,-3,16
Concordia Ch,2364,4,4,2,8,18,21,-3,14
Universitate,2364,5,3,5,6,14,22,-8,14
FC Botosani,2364,6,3,4,7,5,14,-9,13
CFR Cluj,2365,1,7,6,1,16,7,9,27
FCSB,2365,2,7,5,2,23,15,8,26
Universitate,2365,3,4,5,5,17,19,-2,17
D Bucuresti,2365,4,4,4,6,19,20,-1,16
FC Botosani,2365,5,3,5,6,7,16,-9,14
Concordia Ch,2365,6,3,3,8,17,22,-5,12
FCSB,2366,1,7,7,0,25,12,13,28
CFR Cluj,2366,2,5,8,1,15,9,6,23
D Bucuresti,2366,3,5,4,5,20,20,0,19
Universitate,2366,4,3,7,4,16,20,-4,16
FC Botosani,2366,5,4,4,6,7,14,-7,16
Concordia Ch,2366,6,2,2,10,16,24,-8,8
FCSB,2367,1,7,7,0,24,11,13,28
CFR Cluj,2367,2,6,7,1,16,7,9,25
FC Botosani,2367,3,4,5,5,9,15,-6,17
D Bucuresti,2367,4,3,6,5,20,22,-2,15
Universitate,2367,5,3,6,5,15,22,-7,15
Concordia Ch,2367,6,2,3,9,16,23,-7,9
FCSB,2368,1,8,5,1,26,12,14,29
CFR Cluj,2368,2,7,6,1,17,9,8,27
D Bucuresti,2368,3,4,5,5,19,19,0,17
FC Botosani,2368,4,3,6,5,7,14,-7,15
Universitate,2368,5,3,5,6,15,22,-7,14
Concordia Ch,2368,6,2,3,9,16,24,-8,9
FCSB,2369,1,7,6,1,25,14,11,27
CFR Cluj,2369,2,6,6,2,17,10,7,24
Universitate,2369,3,4,6,4,17,20,-3,18
FC Botosani,2369,4,4,5,5,6,12,-6,17
D Bucuresti,2369,5,4,4,6,17,19,-2,16
Concordia Ch,2369,6,2,3,9,15,22,-7,9
FCSB,2370,1,9,5,0,27,12,15,32
CFR Cluj,2370,2,6,6,2,16,9,7,24
FC Botosani,2370,3,4,5,5,8,14,-6,17
D Bucuresti,2370,4,4,4,6,20,22,-2,16
Universitate,2370,5,3,5,6,15,22,-7,14
Concordia Ch,2370,6,2,3,9,18,25,-7,9
FCSB,2371,1,8,5,1,26,13,13,29
CFR Cluj,2371,2,6,6,2,16,11,5,24
Universitate,2371,3,4,5,5,16,19,-3,17
D Bucuresti,2371,4,4,4,6,21,20,1,16
FC Botosani,2371,5,4,4,6,7,17,-10,16
Concordia Ch,2371,6,3,2,9,18,24,-6,11
FCSB,2372,1,8,5,1,29,14,15,29
CFR Cluj,2372,2,5,7,2,14,11,3,22
Universitate,2372,3,4,6,4,17,20,-3,18
FC Botosani,2372,4,4,5,5,7,13,-6,17
D Bucuresti,2372,5,3,4,7,17,21,-4,13
Concordia Ch,2372,6,3,3,8,18,23,-5,12
FCSB,2373,1,7,6,1,24,12,12,27
CFR Cluj,2373,2,7,6,1,18,10,8,27
D Bucuresti,2373,3,4,4,6,18,20,-2,16
Universitate,2373,4,3,6,5,16,21,-5,15
Concordia Ch,2373,5,4,2,8,17,21,-4,14
FC Botosani,2373,6,3,4,7,6,15,-9,13
FCSB,2374,1,7,6,1,24,12,12,27
CFR Cluj,2374,2,5,8,1,14,8,6,23
Universitate,2374,3,4,6,4,17,20,-3,18
D Bucuresti,2374,4,4,5,5,19,19,0,17
FC Botosani,2374,5,4,5,5,7,13,-6,17
Concordia Ch,2374,6,2,2,10,15,24,-9,8
FCSB,2375,1,8,5,1,26,13,13,29
CFR Cluj,2375,2,6,7,1,14,7,7,25
D Bucuresti,2375,3,5,4,5,20,18,2,19
Universitate,2375,4,3,6,5,16,21,-5,15
FC Botosani,2375,5,3,5,6,7,16,-9,14
Concordia Ch,2375,6,2,3,9,17,25,-8,9
FCSB,2376,1,7,6,1,24,12,12,27
CFR Cluj,2376,2,6,7,1,16,9,7,25
FC Botosani,2376,3,4,5,5,7,13,-6,17
D Bucuresti,2376,4,4,4,6,18,20,-2,16
Universitate,2376,5,3,7,4,17,21,-4,16
Concordia Ch,2376,6,2,3,9,15,22,-7,9
CFR Cluj,2377,1,7,6,1,17,8,9,27
FCSB,2377,2,7,5,2,23,12,11,26
D Bucuresti,2377,3,4,5,5,20,21,-1,17
Universitate,2377,4,4,5,5,16,21,-5,17
FC Botosani,2377,5,4,5,5,8,14,-6,17
Concordia Ch,2377,6,2,2,10,16,24,-8,8
FCSB,2378,1,9,5,0,27,11,16,32
CFR Cluj,2378,2,6,6,2,14,8,6,24
D Bucuresti,2378,3,4,4,6,20,22,-2,16
Universitate,2378,4,3,5,6,15,22,-7,14
FC Botosani,2378,5,3,5,6,7,15,-8,14
Concordia Ch,2378,6,3,3,8,19,24,-5,12
FCSB,2379,1,7,6,1,24,13,11,27
CFR Cluj,2379,2,7,6,1,17,8,9,27
D Bucuresti,2379,3,4,5,5,17,18,-1,17
Universitate,2379,4,3,6,5,14,19,-5,15
FC Botosani,2379,5,3,6,5,7,14,-7,15
Concordia Ch,2379,6,2,3,9,17,24,-7,9
FCSB,2380,1,8,6,0,25,11,14,30
CFR Cluj,2380,2,5,8,1,14,8,6,23
D Bucuresti,2380,3,3,6,5,16,18,-2,15
Universitate,2380,4,3,6,5,16,21,-5,15
FC Botosani,2380,5,3,6,5,7,14,-7,15
Concordia Ch,2380,6,2,4,8,17,23,-6,10
FCSB,2381,1,7,6,1,24,13,11,27
CFR Cluj,2381,2,5,8,1,15,9,6,23
Universitate,2381,3,4,6,4,17,19,-2,18
Concordia Ch,2381,4,4,2,8,20,22,-2,14
D Bucuresti,2381,5,3,5,6,18,23,-5,14
FC Botosani,2381,6,3,5,6,8,16,-8,14
FCSB,2382,1,8,6,0,27,13,14,30
CFR Cluj,2382,2,5,7,2,15,10,5,22
FC Botosani,2382,3,4,5,5,6,12,-6,17
Universitate,2382,4,3,7,4,17,21,-4,16
D Bucuresti,2382,5,3,5,6,16,19,-3,14
Concordia Ch,2382,6,3,2,9,16,22,-6,11
FCSB,2383,1,9,5,0,26,11,15,32
CFR Cluj,2383,2,5,7,2,15,10,5,22
FC Botosani,2383,3,4,4,6,7,14,-7,16
Universitate,2383,4,3,6,5,15,20,-5,15
Concordia Ch,2383,5,4,2,8,18,22,-4,14
D Bucuresti,2383,6,3,4,7,16,20,-4,13
FCSB,2384,1,9,5,0,26,11,15,32
CFR Cluj,2384,2,6,6,2,15,9,6,24
D Bucuresti,2384,3,4,5,5,21,19,2,17
FC Botosani,2384,4,3,6,5,6,13,-7,15
Universitate,2384,5,3,5,6,14,20,-6,14
Concordia Ch,2384,6,2,3,9,15,25,-10,9
FCSB,2385,1,8,6,0,25,10,15,30
CFR Cluj,2385,2,6,6,2,17,10,7,24
Universitate,2385,3,3,6,5,15,22,-7,15
D Bucuresti,2385,4,3,5,6,19,22,-3,14
Concordia Ch,2385,5,4,2,8,20,24,-4,14
FC Botosani,2385,6,3,5,6,7,15,-8,14
FCSB,2386,1,7,6,1,23,11,12,27
CFR Cluj,2386,2,6,7,1,16,7,9,25
D Bucuresti,2386,3,4,5,5,17,18,-1,17
Universitate,2386,4,4,5,5,15,21,-6,17
FC Botosani,2386,5,3,4,7,5,14,-9,13
Concordia Ch,2386,6,3,3,8,16,21,-5,12
FCSB,2387,1,8,5,1,25,12,13,29
CFR Cluj,2387,2,6,6,2,15,9,6,24
FC Botosani,2387,3,5,4,5,8,12,-4,19
Universitate,2387,4,4,5,5,16,20,-4,17
D Bucuresti,2387,5,3,4,7,16,21,-5,13
Concordia Ch,2387,6,3,2,9,17,23,-6,11
FCSB,2388,1,9,5,0,29,11,18,32
CFR Cluj,2388,2,6,6,2,15,10,5,24
FC Botosani,2388,3,4,5,5,7,13,-6,17
D Bucuresti,2388,4,3,5,6,16,20,-4,14
Universitate,2388,5,3,5,6,14,22,-8,14
Concordia Ch,2388,6,3,2,9,18,23,-5,11
FCSB,2389,1,8,6,0,26,12,14,30
CFR Cluj,2389,2,5,7,2,14,9,5,22
Universitate,2389,3,4,5,5,16,20,-4,17
FC Botosani,2389,4,4,5,5,8,13,-5,17
D Bucuresti,2389,5,3,4,7,17,23,-6,13
Concordia Ch,2389,6,3,3,8,17,21,-4,12
FCSB,2390,1,8,6,0,27,13,14,30
CFR Cluj,2390,2,6,6,2,14,8,6,24
D Bucuresti,2390,3,4,5,5,17,18,-1,17
Universitate,2390,4,3,6,5,17,22,-5,15
FC Botosani,2390,5,3,4,7,5,14,-9,13
Concordia Ch,2390,6,3,3,8,16,21,-5,12
FCSB,2391,1,9,5,0,27,12,15,32
CFR Cluj,2391,2,6,6,2,15,9,6,24
FC Botosani,2391,3,5,4,5,9,14,-5,19
D Bucuresti,2391,4,4,4,6,19,20,-1,16
Universitate,2391,5,3,5,6,15,21,-6,14
Concordia Ch,2391,6,2,2,10,16,25,-9,8
FCSB,2392,1,7,6,1,25,13,12,27
CFR Cluj,2392,2,6,7,1,16,9,7,25
Universitate,2392,3,4,5,5,15,19,-4,17
FC Botosani,2392,4,3,6,5,5,12,-7,15
D Bucuresti,2392,5,3,5,6,16,20,-4,14
Concordia Ch,2392,6,3,3,8,17,21,-4,12
FCSB,2393,1,8,6,0,27,13,14,30
CFR Cluj,2393,2,6,7,1,16,9,7,25
D Bucuresti,2393,3,4,5,5,20,21,-1,17
Universitate,2393,4,3,5,6,15,21,-6,14
FC Botosani,2393,5,3,4,7,8,17,-9,13
Concordia Ch,2393,6,3,3,8,18,23,-5,12
FCSB,2394,1,9,5,0,26,11,15,32
CFR Cluj,2394,2,5,6,3,13,9,4,21
D Bucuresti,2394,3,4,5,5,20,21,-1,17
Universitate,2394,4,4,5,5,16,20,-4,17
FC Botosani,2394,5,4,4,6,7,14,-7,16
Concordia Ch,2394,6,2,3,9,17,24,-7,9
FCSB,2395,1,7,5,2,25,14,11,26
CFR Cluj,2395,2,6,7,1,16,9,7,25
Universitate,2395,3,4,6,4,17,20,-3,18
D Bucuresti,2395,4,4,5,5,18,19,-1,17
FC Botosani,2395,5,3,6,5,6,13,-7,15
Concordia Ch,2395,6,2,3,9,15,22,-7,9
FCSB,2396,1,8,6,0,26,11,15,30
CFR Cluj,2396,2,5,7,2,15,11,4,22
D Bucuresti,2396,3,5,4,5,21,18,3,19
Universitate,2396,4,3,7,4,17,21,-4,16
FC Botosani,2396,5,4,4,6,7,15,-8,16
Concordia Ch,2396,6,2,2,10,16,26,-10,8
FCSB,2397,1,8,6,0,25,10,15,30
CFR Cluj,2397,2,6,6,2,17,10,7,24
Universitate,2397,3,3,6,5,15,22,-7,15
FC Botosani,2397,4,3,6,5,7,14,-7,15
D Bucuresti,2397,5,3,5,6,17,21,-4,14
Concordia Ch,2397,6,3,3,8,18,22,-4,12
FCSB,2398,1,8,6,0,24,10,14,30
CFR Cluj,2398,2,6,7,1,15,8,7,25
D Bucuresti,2398,3,4,5,5,23,21,2,17
Universitate,2398,4,3,5,6,15,21,-6,14
FC Botosani,2398,5,3,4,7,7,19,-12,13
Concordia Ch,2398,6,3,3,8,17,22,-5,12
CFR Cluj,2399,1,7,6,1,17,8,9,27
FCSB,2399,2,7,5,2,25,15,10,26
D Bucuresti,2399,3,5,4,5,21,18,3,19
Universitate,2399,4,4,5,5,17,21,-4,17
FC Botosani,2399,5,4,4,6,8,16,-8,16
Concordia Ch,2399,6,2,2,10,16,26,-10,8
FCSB,2400,1,8,5,1,26,13,13,29
CFR Cluj,2400,2,5,7,2,15,12,3,22
Universitate,2400,3,4,6,4,19,20,-1,18
D Bucuresti,2400,4,4,4,6,18,20,-2,16
FC Botosani,2400,5,4,4,6,7,14,-7,16
Concordia Ch,2400,6,3,2,9,18,24,-6,11
FCSB,2401,1,9,5,0,28,10,18,32
CFR Cluj,2401,2,5,7,2,14,10,4,22
FC Botosani,2401,3,4,5,5,6,12,-6,17
Universitate,2401,4,3,6,5,15,22,-7,15
D Bucuresti,2401,5,3,5,6,17,21,-4,14
Concordia Ch,2401,6,3,2,9,18,23,-5,11
FCSB,2402,1,7,6,1,23,11,12,27
CFR Cluj,2402,2,6,7,1,15,7,8,25
Universitate,2402,3,4,5,5,15,20,-5,17
FC Botosani,2402,4,4,5,5,7,13,-6,17
D Bucuresti,2402,5,3,4,7,16,22,-6,13
Concordia Ch,2402,6,3,3,8,19,22,-3,12
FCSB,2403,1,8,5,1,25,12,13,29
CFR Cluj,2403,2,6,6,2,15,9,6,24
Universitate,2403,3,4,5,5,15,19,-4,17
D Bucuresti,2403,4,4,4,6,21,22,-1,16
FC Botosani,2403,5,4,4,6,7,14,-7,16
Concordia Ch,2403,6,3,2,9,18,25,-7,11
FCSB,2404,1,8,5,1,25,12,13,29
CFR Cluj,2404,2,5,7,2,13,8,5,22
D Bucuresti,2404,3,5,4,5,19,19,0,19
Universitate,2404,4,4,6,4,16,19,-3,18
FC Botosani,2404,5,3,5,6,6,14,-8,14
Concordia Ch,2404,6,2,3,9,17,24,-7,9
FCSB,2405,1,7,7,0,25,12,13,28
CFR Cluj,2405,2,5,7,2,15,10,5,22
Universitate,2405,3,4,6,4,15,18,-3,18
FC Botosani,2405,4,4,5,5,9,15,-6,17
D Bucuresti,2405,5,3,4,7,18,24,-6,13
Concordia Ch,2405,6,3,3,8,19,22,-3,12
FCSB,2406,1,7,7,0,25,12,13,28
CFR Cluj,2406,2,6,7,1,17,9,8,25
D Bucuresti,2406,3,4,4,6,20,19,1,16
FC Botosani,2406,4,4,4,6,8,17,-9,16
Universitate,2406,5,3,6,5,16,22,-6,15
Concordia Ch,2406,6,3,2,9,17,24,-7,11
FCSB,2407,1,8,5,1,25,11,14,29
CFR Cluj,2407,2,6,6,2,14,9,5,24
Universitate,2407,3,4,5,5,15,19,-4,17
D Bucuresti,2407,4,4,4,6,18,23,-5,16
FC Botosani,2407,5,4,4,6,9,14,-5,16
Concordia Ch,2407,6,3,2,9,19,24,-5,11
FCSB,2408,1,8,5,1,25,13,12,29
CFR Cluj,2408,2,7,6,1,17,7,10,27
D Bucuresti,2408,3,5,4,5,22,20,2,19
Universitate,2408,4,3,5,6,15,22,-7,14
FC Botosani,2408,5,3,5,6,7,16,-9,14
Concordia Ch,2408,6,2,3,9,17,25,-8,9
FCSB,2409,1,9,5,0,27,11,16,32
CFR Cluj,2409,2,5,6,3,17,14,3,21
Universitate,2409,3,4,5,5,18,22,-4,17
D Bucuresti,2409,4,4,4,6,20,21,-1,16
Concordia Ch,2409,5,4,2,8,18,22,-4,14
FC Botosani,2409,6,3,4,7,6,16,-10,13
FCSB,2410,1,7,6,1,25,13,12,27
CFR Cluj,2410,2,7,6,1,17,8,9,27
FC Botosani,2410,3,5,4,5,9,13,-4,19
Universitate,2410,4,3,6,5,15,21,-6,15
D Bucuresti,2410,5,3,4,7,18,22,-4,13
Concordia Ch,2410,6,3,2,9,19,26,-7,11
FCSB,2411,1,7,5,2,25,15,10,26
CFR Cluj,2411,2,6,7,1,16,9,7,25
Universitate,2411,3,4,6,4,18,20,-2,18
D Bucuresti,2411,4,4,4,6,18,20,-2,16
FC Botosani,2411,5,4,4,6,6,13,-7,16
Concordia Ch,2411,6,3,2,9,17,23,-6,11
FCSB,2412,1,8,5,1,25,12,13,29
CFR Cluj,2412,2,7,6,1,15,7,8,27
FC Botosani,2412,3,3,6,5,6,13,-7,15
D Bucuresti,2412,4,3,5,6,16,19,-3,14
Universitate,2412,5,3,5,6,15,21,-6,14
Concordia Ch,2412,6,3,3,8,17,22,-5,12
FCSB,2413,1,9,5,0,26,10,16,32
CFR Cluj,2413,2,5,7,2,13,9,4,22
FC Botosani,2413,3,4,5,5,8,14,-6,17
D Bucuresti,2413,4,3,6,5,18,20,-2,15
Universitate,2413,5,3,6,5,14,19,-5,15
Concordia Ch,2413,6,2,3,9,17,24,-7,9
FCSB,2414,1,8,5,1,24,11,13,29
CFR Cluj,2414,2,6,6,2,15,9,6,24
Universitate,2414,3,4,5,5,16,20,-4,17
FC Botosani,2414,4,4,5,5,9,14,-5,17
D Bucuresti,2414,5,3,6,5,19,21,-2,15
Concordia Ch,2414,6,2,3,9,16,24,-8,9
FCSB,2415,1,8,6,0,28,13,15,30
CFR Cluj,2415,2,6,6,2,17,11,6,24
D Bucuresti,2415,3,4,4,6,18,20,-2,16
FC Botosani,2415,4,4,4,6,7,14,-7,16
Universitate,2415,5,3,6,5,17,23,-6,15
Concordia Ch,2415,6,3,2,9,17,23,-6,11
CFR Cluj,2416,1,7,6,1,18,7,11,27
FCSB,2416,2,7,5,2,26,15,11,26
Universitate,2416,3,4,5,5,18,25,-7,17
D Bucuresti,2416,4,4,4,6,20,22,-2,16
Concordia Ch,2416,5,4,2,8,20,21,-1,14
FC Botosani,2416,6,3,4,7,5,17,-12,13
FCSB,2417,1,8,6,0,24,10,14,30
CFR Cluj,2417,2,6,7,1,16,7,9,25
FC Botosani,2417,3,5,4,5,7,12,-5,19
D Bucuresti,2417,4,3,5,6,17,20,-3,14
Universitate,2417,5,3,5,6,14,22,-8,14
Concordia Ch,2417,6,2,3,9,16,23,-7,9
FCSB,2418,1,8,6,0,25,10,15,30
CFR Cluj,2418,2,6,6,2,14,9,5,24
FC Botosani,2418,3,5,4,5,7,12,-5,19
Universitate,2418,4,3,6,5,14,19,-5,15
D Bucuresti,2418,5,3,5,6,16,19,-3,14
Concordia Ch,2418,6,2,3,9,15,22,-7,9
FCSB,2419,1,7,6,1,24,12,12,27
CFR Cluj,2419,2,7,6,1,16,8,8,27
FC Botosani,2419,3,4,5,5,8,12,-4,17
Universitate,2419,4,3,6,5,14,19,-5,15
D Bucuresti,2419,5,3,5,6,19,22,-3,14
Concordia Ch,2419,6,3,2,9,19,27,-8,11
CFR Cluj,2420,1,7,6,1,17,7,10,27
FCSB,2420,2,7,5,2,23,13,10,26
D Bucuresti,2420,3,5,4,5,21,18,3,19
Universitate,2420,4,4,5,5,16,21,-5,17
FC Botosani,2420,5,4,4,6,7,17,-10,16
Concordia Ch,2420,6,2,2,10,16,24,-8,8
FCSB,2421,1,8,5,1,26,12,14,29
CFR Cluj,2421,2,5,7,2,16,12,4,22
Universitate,2421,3,4,6,4,17,20,-3,18
FC Botosani,2421,4,4,5,5,7,13,-6,17
D Bucuresti,2421,5,3,6,5,18,20,-2,15
Concordia Ch,2421,6,2,3,9,16,23,-7,9
FCSB,2422,1,7,7,0,25,12,13,28
CFR Cluj,2422,2,5,8,1,14,8,6,23
FC Botosani,2422,3,4,5,5,9,14,-5,17
Universitate,2422,4,3,7,4,15,19,-4,16
D Bucuresti,2422,5,3,4,7,17,22,-5,13
Concordia Ch,2422,6,3,3,8,17,22,-5,12
FCSB,2423,1,9,5,0,28,10,18,32
CFR Cluj,2423,2,6,6,2,15,10,5,24
FC Botosani,2423,3,4,4,6,9,16,-7,16
D Bucuresti,2423,4,3,5,6,18,21,-3,14
Universitate,2423,5,3,5,6,15,23,-8,14
Concordia Ch,2423,6,3,3,8,17,22,-5,12
FCSB,2424,1,8,6,0,26,10,16,30
CFR Cluj,2424,2,6,7,1,16,8,8,25
D Bucuresti,2424,3,5,4,5,19,19,0,19
Universitate,2424,4,3,5,6,15,24,-9,14
FC Botosani,2424,5,3,4,7,5,14,-9,13
Concordia Ch,2424,6,3,2,9,17,23,-6,11
FCSB,2425,1,8,5,1,24,11,13,29
CFR Cluj,2425,2,6,6,2,17,8,9,24
Universitate,2425,3,4,5,5,15,22,-7,17
D Bucuresti,2425,4,4,4,6,17,19,-2,16
FC Botosani,2425,5,4,4,6,7,15,-8,16
Concordia Ch,2425,6,3,2,9,18,23,-5,11
FCSB,2426,1,9,5,0,26,10,16,32
CFR Cluj,2426,2,5,7,2,14,9,5,22
D Bucuresti,2426,3,4,4,6,24,25,-1,16
Universitate,2426,4,3,6,5,15,21,-6,15
Concordia Ch,2426,5,4,2,8,22,23,-1,14
FC Botosani,2426,6,3,4,7,6,19,-13,13
FCSB,2427,1,8,6,0,27,11,16,30
CFR Cluj,2427,2,6,6,2,17,11,6,24
Universitate,2427,3,3,6,5,16,23,-7,15
D Bucuresti,2427,4,3,5,6,16,19,-3,14
Concordia Ch,2427,5,4,2,8,18,22,-4,14
FC Botosani,2427,6,3,5,6,6,14,-8,14
FCSB,2428,1,8,5,1,24,11,13,29
CFR Cluj,2428,2,7,6,1,17,7,10,27
FC Botosani,2428,3,3,6,5,5,12,-7,15
D Bucuresti,2428,4,3,5,6,17,23,-6,14
Universitate,2428,5,3,5,6,14,22,-8,14
Concordia Ch,2428,6,3,3,8,20,22,-2,12
FCSB,2429,1,9,5,0,28,10,18,32
CFR Cluj,2429,2,6,6,2,17,12,5,24
D Bucuresti,2429,3,4,5,5,21,20,1,17
Universitate,2429,4,3,5,6,16,24,-8,14
FC Botosani,2429,5,3,5,6,7,17,-10,14
Concordia Ch,2429,6,2,4,8,19,25,-6,10
FCSB,2430,1,8,6,0,26,10,16,30
CFR Cluj,2430,2,5,7,2,13,11,2,22
D Bucuresti,2430,3,4,5,5,22,21,1,17
Universitate,2430,4,4,5,5,18,21,-3,17
FC Botosani,2430,5,4,4,6,8,17,-9,16
Concordia Ch,2430,6,2,3,9,18,25,-7,9
FCSB,2431,1,9,5,0,26,10,16,32
CFR Cluj,2431,2,5,6,3,13,11,2,21
Universitate,2431,3,4,5,5,16,19,-3,17
Concordia Ch,2431,4,4,2,8,19,22,-3,14
D Bucuresti,2431,5,3,5,6,16,19,-3,14
FC Botosani,2431,6,3,5,6,6,15,-9,14
FCSB,2432,1,8,5,1,27,15,12,29
CFR Cluj,2432,2,7,6,1,19,9,10,27
D Bucuresti,2432,3,4,4,6,18,19,-1,16
Universitate,2432,4,3,5,6,15,22,-7,14
FC Botosani,2432,5,3,5,6,5,14,-9,14
Concordia Ch,2432,6,3,3,8,16,21,-5,12
FCSB,2433,1,8,5,1,27,16,11,29
CFR Cluj,2433,2,5,6,3,14,11,3,21
Universitate,2433,3,5,5,4,20,19,1,20
FC Botosani,2433,4,3,6,5,5,12,-7,15
D Bucuresti,2433,5,3,5,6,18,23,-5,14
Concordia Ch,2433,6,3,3,8,20,23,-3,12
FCSB,2434,1,9,5,0,27,12,15,32
CFR Cluj,2434,2,6,6,2,14,8,6,24
FC Botosani,2434,3,5,4,5,9,12,-3,19
D Bucuresti,2434,4,4,4,6,18,20,-2,16
Universitate,2434,5,3,5,6,16,22,-6,14
Concordia Ch,2434,6,2,2,10,16,26,-10,8
CFR Cluj,2435,1,7,6,1,17,7,10,27
FCSB,2435,2,7,5,2,23,12,11,26
D Bucuresti,2435,3,4,5,5,19,18,1,17
FC Botosani,2435,4,4,5,5,9,12,-3,17
Universitate,2435,5,4,5,5,15,21,-6,17
Concordia Ch,2435,6,2,2,10,15,28,-13,8
FCSB,2436,1,8,6,0,26,12,14,30
CFR Cluj,2436,2,5,6,3,14,10,4,21
Universitate,2436,3,4,6,4,18,21,-3,18
D Bucuresti,2436,4,3,6,5,20,22,-2,15
FC Botosani,2436,5,3,5,6,7,17,-10,14
Concordia Ch,2436,6,3,3,8,20,23,-3,12
FCSB,2437,1,8,5,1,26,12,14,29
CFR Cluj,2437,2,5,6,3,13,10,3,21
Universitate,2437,3,5,5,4,17,19,-2,20
D Bucuresti,2437,4,4,5,5,18,19,-1,17
FC Botosani,2437,5,3,5,6,7,15,-8,14
Concordia Ch,2437,6,3,2,9,17,23,-6,11
FCSB,2438,1,7,6,1,24,12,12,27
CFR Cluj,2438,2,5,8,1,14,8,6,23
FC Botosani,2438,3,5,4,5,7,12,-5,19
Universitate,2438,4,4,6,4,17,20,-3,18
D Bucuresti,2438,5,3,4,7,17,21,-4,13
Concordia Ch,2438,6,3,2,9,17,23,-6,11
FCSB,2439,1,8,6,0,26,12,14,30
CFR Cluj,2439,2,6,7,1,15,8,7,25
FC Botosani,2439,3,5,4,5,10,14,-4,19
Universitate,2439,4,3,5,6,15,21,-6,14
D Bucuresti,2439,5,3,4,7,17,22,-5,13
Concordia Ch,2439,6,3,2,9,19,25,-6,11
FCSB,2440,1,7,7,0,27,14,13,28
CFR Cluj,2440,2,5,7,2,15,10,5,22
Universitate,2440,3,4,6,4,17,20,-3,18
D Bucuresti,2440,4,4,5,5,21,22,-1,17
FC Botosani,2440,5,3,5,6,8,16,-8,14
Concordia Ch,2440,6,3,2,9,19,25,-6,11
FCSB,2441,1,8,5,1,25,13,12,29
CFR Cluj,2441,2,5,6,3,14,12,2,21
Universitate,2441,3,5,5,4,19,18,1,20
FC Botosani,2441,4,4,5,5,7,13,-6,17
D Bucuresti,2441,5,3,5,6,17,20,-3,14
Concordia Ch,2441,6,2,4,8,17,23,-6,10
FCSB,2442,1,8,5,1,25,12,13,29
CFR Cluj,2442,2,6,6,2,15,10,5,24
D Bucuresti,2442,3,4,5,5,22,20,2,17
Universitate,2442,4,4,5,5,17,20,-3,17
FC Botosani,2442,5,3,5,6,6,17,-11,14
Concordia Ch,2442,6,2,4,8,16,22,-6,10
FCSB,2443,1,7,7,0,24,11,13,28
CFR Cluj,2443,2,5,7,2,14,10,4,22
Universitate,2443,3,4,6,4,18,20,-2,18
D Bucuresti,2443,4,4,5,5,19,19,0,17
FC Botosani,2443,5,3,4,7,5,16,-11,13
Concordia Ch,2443,6,3,3,8,18,22,-4,12
FCSB,2444,1,8,5,1,25,11,14,29
CFR Cluj,2444,2,7,6,1,18,8,10,27
D Bucuresti,2444,3,3,6,5,19,21,-2,15
FC Botosani,2444,4,3,6,5,8,15,-7,15
Universitate,2444,5,3,5,6,15,24,-9,14
Concordia Ch,2444,6,2,4,8,17,23,-6,10
FCSB,2445,1,8,6,0,25,11,14,30
CFR Cluj,2445,2,6,6,2,17,10,7,24
D Bucuresti,2445,3,4,4,6,20,22,-2,16
FC Botosani,2445,4,4,4,6,10,15,-5,16
Universitate,2445,5,3,6,5,15,21,-6,15
Concordia Ch,2445,6,3,2,9,17,25,-8,11
FCSB,2446,1,9,5,0,28,12,16,32
CFR Cluj,2446,2,5,6,3,14,10,4,21
Universitate,2446,3,4,5,5,16,21,-5,17
D Bucuresti,2446,4,4,4,6,17,19,-2,16
FC Botosani,2446,5,3,5,6,5,13,-8,14
Concordia Ch,2446,6,3,3,8,16,21,-5,12
FCSB,2447,1,7,6,1,25,15,10,27
CFR Cluj,2447,2,5,7,2,14,9,5,22
Universitate,2447,3,5,5,4,19,19,0,20
D Bucuresti,2447,4,4,4,6,18,20,-2,16
Concordia Ch,2447,5,4,2,8,19,23,-4,14
FC Botosani,2447,6,3,4,7,6,15,-9,13
CFR Cluj,2448,1,7,6,1,18,7,11,27
FCSB,2448,2,7,5,2,24,15,9,26
Universitate,2448,3,4,5,5,16,21,-5,17
FC Botosani,2448,4,4,5,5,6,12,-6,17
D Bucuresti,2448,5,4,4,6,19,20,-1,16
Concordia Ch,2448,6,2,3,9,16,24,-8,9
FCSB,2449,1,8,6,0,31,13,18,30
CFR Cluj,2449,2,6,6,2,16,13,3,24
D Bucuresti,2449,3,4,4,6,19,19,0,16
Universitate,2449,4,3,6,5,16,22,-6,15
Concordia Ch,2449,5,4,2,8,17,21,-4,14
FC Botosani,2449,6,3,4,7,5,16,-11,13
FCSB,2450,1,8,6,0,28,13,15,30
CFR Cluj,2450,2,5,6,3,14,11,3,21
Universitate,2450,3,4,6,4,17,20,-3,18
D Bucuresti,2450,4,4,5,5,18,19,-1,17
FC Botosani,2450,5,3,5,6,6,14,-8,14
Concordia Ch,2450,6,2,4,8,17,23,-6,10
FCSB,2451,1,9,5,0,28,11,17,32
CFR Cluj,2451,2,5,6,3,15,12,3,21
Universitate,2451,3,4,5,5,16,21,-5,17
D Bucuresti,2451,4,4,4,6,18,21,-3,16
Concordia Ch,2451,5,4,2,8,19,22,-3,14
FC Botosani,2451,6,3,4,7,5,14,-9,13
FCSB,2452,1,8,5,1,27,11,16,29
CFR Cluj,2452,2,6,6,2,15,12,3,24
D Bucuresti,2452,3,4,5,5,18,19,-1,17
Universitate,2452,4,4,5,5,16,20,-4,17
FC Botosani,2452,5,3,6,5,7,14,-7,15
Concordia Ch,2452,6,2,3,9,16,23,-7,9
FCSB,2453,1,8,5,1,26,11,15,29
CFR Cluj,2453,2,6,6,2,15,10,5,24
Universitate,2453,3,4,5,5,15,20,-5,17
FC Botosani,2453,4,4,5,5,8,14,-6,17
D Bucuresti,2453,5,3,6,5,19,21,-2,15
Concordia Ch,2453,6,2,3,9,18,25,-7,9
FCSB,2454,1,9,5,0,27,12,15,32
CFR Cluj,2454,2,5,6,3,14,10,4,21
D Bucuresti,2454,3,4,5,5,18,19,-1,17
Universitate,2454,4,4,5,5,16,20,-4,17
FC Botosani,2454,5,4,4,6,7,13,-6,16
Concordia Ch,2454,6,2,3,9,16,24,-8,9
FCSB,2455,1,8,5,1,25,12,13,29
CFR Cluj,2455,2,5,6,3,14,12,2,21
Universitate,2455,3,5,5,4,19,19,0,20
D Bucuresti,2455,4,4,5,5,20,21,-1,17
FC Botosani,2455,5,4,4,6,7,14,-7,16
Concordia Ch,2455,6,2,3,9,17,24,-7,9
FCSB,2456,1,8,6,0,26,12,14,30
CFR Cluj,2456,2,6,6,2,16,9,7,24
D Bucuresti,2456,3,4,5,5,20,20,0,17
Universitate,2456,4,3,6,5,15,21,-6,15
FC Botosani,2456,5,3,4,7,6,16,-10,13
Concordia Ch,2456,6,3,3,8,17,22,-5,12
FCSB,2457,1,8,5,1,27,14,13,29
CFR Cluj,2457,2,6,6,2,15,10,5,24
Universitate,2457,3,4,5,5,19,22,-3,17
FC Botosani,2457,4,4,5,5,7,13,-6,17
D Bucuresti,2457,5,3,5,6,16,20,-4,14
Concordia Ch,2457,6,3,2,9,18,23,-5,11
FCSB,2458,1,8,6,0,24,10,14,30
CFR Cluj,2458,2,6,6,2,14,8,6,24
D Bucuresti,2458,3,4,5,5,18,19,-1,17
Universitate,2458,4,3,6,5,14,19,-5,15
FC Botosani,2458,5,3,5,6,6,14,-8,14
Concordia Ch,2458,6,3,2,9,16,22,-6,11
FCSB,2459,1,7,6,1,23,12,11,27
CFR Cluj,2459,2,6,6,2,15,8,7,24
Universitate,2459,3,4,6,4,15,18,-3,18
D Bucuresti,2459,4,4,4,6,17,22,-5,16
FC Botosani,2459,5,3,5,6,7,15,-8,14
Concordia Ch,2459,6,3,3,8,21,23,-2,12
FCSB,2460,1,9,5,0,27,11,16,32
CFR Cluj,2460,2,5,7,2,14,9,5,22
D Bucuresti,2460,3,4,5,5,19,20,-1,17
FC Botosani,2460,4,4,5,5,10,16,-6,17
Universitate,2460,5,3,6,5,14,20,-6,15
Concordia Ch,2460,6,2,2,10,17,25,-8,8
FCSB,2461,1,9,5,0,26,10,16,32
CFR Cluj,2461,2,5,6,3,14,12,2,21
Universitate,2461,3,4,5,5,17,20,-3,17
FC Botosani,2461,4,4,5,5,8,13,-5,17
D Bucuresti,2461,5,3,5,6,17,21,-4,14
Concordia Ch,2461,6,3,2,9,17,23,-6,11
FCSB,2462,1,8,6,0,25,11,14,30
CFR Cluj,2462,2,5,8,1,14,8,6,23
D Bucuresti,2462,3,3,6,5,20,22,-2,15
Universitate,2462,4,3,6,5,14,19,-5,15
FC Botosani,2462,5,3,6,5,8,15,-7,15
Concordia Ch,2462,6,2,4,8,18,24,-6,10
FCSB,2463,1,8,6,0,27,10,17,30
CFR Cluj,2463,2,6,7,1,14,7,7,25
D Bucuresti,2463,3,5,4,5,20,19,1,19
FC Botosani,2463,4,4,4,6,8,14,-6,16
Universitate,2463,5,3,5,6,14,23,-9,14
Concordia Ch,2463,6,2,2,10,16,26,-10,8
FCSB,2464,1,8,5,1,24,11,13,29
CFR Cluj,2464,2,6,7,1,15,8,7,25
D Bucuresti,2464,3,4,5,5,19,19,0,17
FC Botosani,2464,4,4,5,5,8,13,-5,17
Universitate,2464,5,3,6,5,15,20,-5,15
Concordia Ch,2464,6,2,2,10,15,25,-10,8
FCSB,2465,1,7,5,2,24,13,11,26
CFR Cluj,2465,2,6,6,2,14,8,6,24
Universitate,2465,3,5,5,4,17,19,-2,20
FC Botosani,2465,4,5,4,5,7,12,-5,19
D Bucuresti,2465,5,3,5,6,17,20,-3,14
Concordia Ch,2465,6,2,3,9,16,23,-7,9
FCSB,2466,1,9,5,0,30,11,19,32
CFR Cluj,2466,2,6,6,2,16,11,5,24
D Bucuresti,2466,3,4,5,5,20,18,2,17
Universitate,2466,4,3,5,6,15,24,-9,14
FC Botosani,2466,5,3,4,7,5,17,-12,13
Concordia Ch,2466,6,3,3,8,16,21,-5,12
FCSB,2467,1,7,5,2,24,13,11,26
CFR Cluj,2467,2,6,7,1,15,8,7,25
Universitate,2467,3,4,6,4,15,18,-3,18
D Bucuresti,2467,4,4,5,5,20,20,0,17
FC Botosani,2467,5,4,5,5,8,13,-5,17
Concordia Ch,2467,6,2,2,10,16,26,-10,8
FCSB,2468,1,8,5,1,25,12,13,29
CFR Cluj,2468,2,6,7,1,14,7,7,25
D Bucuresti,2468,3,4,5,5,19,20,-1,17
FC Botosani,2468,4,4,5,5,7,13,-6,17
Universitate,2468,5,3,6,5,15,20,-5,15
Concordia Ch,2468,6,2,2,10,16,24,-8,8
FCSB,2469,1,7,6,1,25,13,12,27
CFR Cluj,2469,2,5,8,1,15,9,6,23
Universitate,2469,3,4,6,4,17,20,-3,18
D Bucuresti,2469,4,4,5,5,19,19,0,17
FC Botosani,2469,5,3,5,6,5,13,-8,14
Concordia Ch,2469,6,3,2,9,17,24,-7,11
FCSB,2470,1,8,6,0,26,12,14,30
CFR Cluj,2470,2,6,7,1,15,8,7,25
FC Botosani,2470,3,5,4,5,11,12,-1,19
Universitate,2470,4,3,5,6,17,23,-6,14
D Bucuresti,2470,5,3,4,7,17,27,-10,13
Concordia Ch,2470,6,3,2,9,19,23,-4,11
FCSB,2471,1,8,5,1,26,12,14,29
CFR Cluj,2471,2,5,7,2,15,11,4,22
Universitate,2471,3,4,6,4,18,21,-3,18
D Bucuresti,2471,4,4,5,5,17,18,-1,17
FC Botosani,2471,5,3,5,6,5,13,-8,14
Concordia Ch,2471,6,2,4,8,15,21,-6,10
FCSB,2472,1,7,6,1,24,13,11,27
CFR Cluj,2472,2,7,6,1,16,7,9,27
FC Botosani,2472,3,4,5,5,7,13,-6,17
Universitate,2472,4,3,6,5,15,20,-5,15
D Bucuresti,2472,5,3,5,6,18,21,-3,14
Concordia Ch,2472,6,3,2,9,17,23,-6,11
FCSB,2473,1,7,6,1,24,14,10,27
CFR Cluj,2473,2,5,8,1,14,8,6,23
Universitate,2473,3,4,6,4,19,20,-1,18
D Bucuresti,2473,4,4,4,6,19,22,-3,16
FC Botosani,2473,5,3,5,6,6,14,-8,14
Concordia Ch,2473,6,3,3,8,18,22,-4,12
FCSB,2474,1,8,5,1,25,11,14,29
CFR Cluj,2474,2,5,7,2,13,9,4,22
Universitate,2474,3,4,6,4,15,18,-3,18
D Bucuresti,2474,4,4,5,5,17,18,-1,17
FC Botosani,2474,5,3,6,5,6,13,-7,15
Concordia Ch,2474,6,2,3,9,16,23,-7,9
FCSB,2475,1,9,5,0,29,11,18,32
CFR Cluj,2475,2,6,6,2,16,10,6,24
D Bucuresti,2475,3,5,4,5,19,19,0,19
Universitate,2475,4,3,5,6,14,23,-9,14
FC Botosani,2475,5,3,4,7,6,15,-9,13
Concordia Ch,2475,6,3,2,9,18,24,-6,11
FCSB,2476,1,8,5,1,26,13,13,29
CFR Cluj,2476,2,5,6,3,13,11,2,21
Universitate,2476,3,5,5,4,19,19,0,20
D Bucuresti,2476,4,4,4,6,20,24,-4,16
FC Botosani,2476,5,3,5,6,7,15,-8,14
Concordia Ch,2476,6,3,3,8,19,22,-3,12
FCSB,2477,1,9,5,0,25,10,15,32
CFR Cluj,2477,2,5,6,3,13,10,3,21
Universitate,2477,3,4,5,5,16,19,-3,17
FC Botosani,2477,4,4,5,5,6,12,-6,17
D Bucuresti,2477,5,3,4,7,17,23,-6,13
Concordia Ch,2477,6,3,3,8,19,22,-3,12
FCSB,2478,1,7,6,1,23,11,12,27
CFR Cluj,2478,2,6,7,1,14,7,7,25
D Bucuresti,2478,3,4,5,5,19,20,-1,17
Universitate,2478,4,4,5,5,15,19,-4,17
FC Botosani,2478,5,3,4,7,5,14,-9,13
Concordia Ch,2478,6,3,3,8,18,23,-5,12
FCSB,2479,1,9,5,0,28,12,16,32
CFR Cluj,2479,2,5,7,2,16,11,5,22
D Bucuresti,2479,3,4,5,5,21,21,0,17
Universitate,2479,4,3,6,5,17,23,-6,15
FC Botosani,2479,5,3,5,6,8,17,-9,14
Concordia Ch,2479,6,2,4,8,17,23,-6,10
FCSB,2480,1,7,7,0,24,11,13,28
CFR Cluj,2480,2,5,8,1,14,8,6,23
D Bucuresti,2480,3,4,5,5,18,19,-1,17
Universitate,2480,4,3,7,4,14,18,-4,16
FC Botosani,2480,5,3,6,5,6,13,-7,15
Concordia Ch,2480,6,2,3,9,15,22,-7,9
FCSB,2481,1,9,5,0,28,13,15,32
CFR Cluj,2481,2,6,6,2,16,10,6,24
D Bucuresti,2481,3,4,5,5,18,19,-1,17
Universitate,2481,4,3,5,6,17,23,-6,14
FC Botosani,2481,5,3,5,6,7,15,-8,14
Concordia Ch,2481,6,2,4,8,18,24,-6,10
CFR Cluj,2482,1,7,6,1,15,7,8,27
FCSB,2482,2,7,5,2,24,14,10,26
Universitate,2482,3,4,5,5,17,20,-3,17
FC Botosani,2482,4,4,5,5,7,13,-6,17
D Bucuresti,2482,5,3,5,6,17,20,-3,14
Concordia Ch,2482,6,2,4,8,17,23,-6,10
FCSB,2483,1,7,5,2,25,15,10,26
CFR Cluj,2483,2,6,6,2,16,10,6,24
Universitate,2483,3,5,5,4,18,19,-1,20
FC Botosani,2483,4,4,4,6,6,13,-7,16
D Bucuresti,2483,5,3,5,6,17,20,-3,14
Concordia Ch,2483,6,3,3,8,17,22,-5,12
FCSB,2484,1,8,6,0,27,12,15,30
CFR Cluj,2484,2,5,7,2,13,9,4,22
FC Botosani,2484,3,4,5,5,7,12,-5,17
Universitate,2484,4,3,7,4,16,20,-4,16
D Bucuresti,2484,5,3,5,6,17,20,-3,14
Concordia Ch,2484,6,3,2,9,17,24,-7,11
FCSB,2485,1,7,6,1,24,12,12,27
CFR Cluj,2485,2,6,7,1,15,8,7,25
FC Botosani,2485,3,5,4,5,8,12,-4,19
D Bucuresti,2485,4,4,4,6,19,20,-1,16
Universitate,2485,5,3,7,4,16,20,-4,16
Concordia Ch,2485,6,2,2,10,16,26,-10,8
FCSB,2486,1,7,6,1,26,14,12,27
CFR Cluj,2486,2,6,6,2,16,10,6,24
D Bucuresti,2486,3,5,4,5,20,18,2,19
Universitate,2486,4,4,6,4,18,21,-3,18
FC Botosani,2486,5,3,4,7,5,16,-11,13
Concordia Ch,2486,6,3,2,9,17,23,-6,11
FCSB,2487,1,9,5,0,25,10,15,32
CFR Cluj,2487,2,6,6,2,14,8,6,24
FC Botosani,2487,3,4,5,5,7,13,-6,17
D Bucuresti,2487,4,3,5,6,16,19,-3,14
Universitate,2487,5,3,5,6,14,20,-6,14
Concordia Ch,2487,6,3,2,9,17,23,-6,11
FCSB,2488,1,7,6,1,25,13,12,27
CFR Cluj,2488,2,5,7,2,16,14,2,22
Universitate,2488,3,5,5,4,20,19,1,20
D Bucuresti,2488,4,4,4,6,19,21,-2,16
Concordia Ch,2488,5,4,2,8,19,22,-3,14
FC Botosani,2488,6,3,4,7,5,15,-10,13
FCSB,2489,1,7,5,2,23,12,11,26
CFR Cluj,2489,2,6,6,2,16,10,6,24
Universitate,2489,3,5,5,4,18,20,-2,20
D Bucuresti,2489,4,5,4,5,18,18,0,19
FC Botosani,2489,5,3,4,7,5,14,-9,13
Concordia Ch,2489,6,3,2,9,16,22,-6,11
FCSB,2490,1,7,7,0,23,10,13,28
CFR Cluj,2490,2,6,7,1,15,8,7,25
FC Botosani,2490,3,4,5,5,8,13,-5,17
Universitate,2490,4,3,6,5,15,20,-5,15
D Bucuresti,2490,5,3,5,6,20,23,-3,14
Concordia Ch,2490,6,3,2,9,19,26,-7,11
FCSB,2491,1,9,5,0,26,10,16,32
CFR Cluj,2491,2,6,6,2,16,9,7,24
FC Botosani,2491,3,4,4,6,10,14,-4,16
D Bucuresti,2491,4,4,4,6,17,22,-5,16
Universitate,2491,5,3,5,6,14,22,-8,14
Concordia Ch,2491,6,3,2,9,20,26,-6,11
FCSB,2492,1,8,5,1,24,11,13,29
CFR Cluj,2492,2,6,6,2,14,8,6,24
D Bucuresti,2492,3,5,4,5,20,19,1,19
Universitate,2492,4,4,5,5,15,19,-4,17
FC Botosani,2492,5,4,4,6,8,16,-8,16
Concordia Ch,2492,6,2,2,10,18,26,-8,8
CFR Cluj,2493,1,7,6,1,16,7,9,27
FCSB,2493,2,7,5,2,23,13,10,26
Universitate,2493,3,4,5,5,15,19,-4,17
D Bucuresti,2493,4,4,4,6,19,19,0,16
Concordia Ch,2493,5,4,2,8,17,21,-4,14
FC Botosani,2493,6,3,4,7,5,16,-11,13
FCSB,2494,1,8,5,1,25,12,13,29
CFR Cluj,2494,2,6,6,2,14,8,6,24
Universitate,2494,3,4,5,5,16,20,-4,17
D Bucuresti,2494,4,4,4,6,22,21,1,16
FC Botosani,2494,5,3,5,6,5,16,-11,14
Concordia Ch,2494,6,3,3,8,18,23,-5,12
FCSB,2495,1,8,5,1,26,13,13,29
CFR Cluj,2495,2,7,6,1,16,8,8,27
D Bucuresti,2495,3,4,4,6,18,21,-3,16
Universitate,2495,4,3,5,6,15,21,-6,14
FC Botosani,2495,5,3,5,6,5,13,-8,14
Concordia Ch,2495,6,3,3,8,18,22,-4,12
FCSB,2496,1,7,5,2,23,14,9,26
CFR Cluj,2496,2,6,7,1,16,8,8,25
Universitate,2496,3,4,6,4,17,19,-2,18
D Bucuresti,2496,4,4,5,5,20,19,1,17
FC Botosani,2496,5,3,4,7,5,16,-11,13
Concordia Ch,2496,6,3,3,8,17,22,-5,12
FCSB,2497,1,9,5,0,27,11,16,32
CFR Cluj,2497,2,5,6,3,14,10,4,21
D Bucuresti,2497,3,5,4,5,19,18,1,19
Universitate,2497,4,4,5,5,15,20,-5,17
FC Botosani,2497,5,3,4,7,5,16,-11,13
Concordia Ch,2497,6,3,2,9,17,22,-5,11
FCSB,2498,1,7,6,1,24,13,11,27
CFR Cluj,2498,2,6,7,1,17,10,7,25
Universitate,2498,3,4,5,5,18,21,-3,17
D Bucuresti,2498,4,4,4,6,20,23,-3,16
Concordia Ch,2498,5,4,2,8,23,23,0,14
FC Botosani,2498,6,3,4,7,6,18,-12,13
FCSB,2499,1,8,6,0,27,11,16,30
CFR Cluj,2499,2,5,7,2,14,11,3,22
D Bucuresti,2499,3,4,5,5,19,19,0,17
Universitate,2499,4,3,7,4,16,20,-4,16
FC Botosani,2499,5,3,5,6,6,15,-9,14
Concordia Ch,2499,6,2,4,8,17,23,-6,10
FCSB,2500,1,7,7,0,25,12,13,28
CFR Cluj,2500,2,6,7,1,15,8,7,25
FC Botosani,2500,3,4,4,6,8,14,-6,16
Universitate,2500,4,3,6,5,17,22,-5,15
D Bucuresti,2500,5,3,5,6,18,22,-4,14
Concordia Ch,2500,6,3,3,8,19,24,-5,12
FCSB,2501,1,8,5,1,25,12,13,29
CFR Cluj,2501,2,6,6,2,15,10,5,24
Universitate,2501,3,4,5,5,17,20,-3,17
FC Botosani,2501,4,4,5,5,7,12,-5,17
D Bucuresti,2501,5,3,5,6,17,20,-3,14
Concordia Ch,2501,6,3,2,9,17,24,-7,11
FCSB,2502,1,7,6,1,23,11,12,27
CFR Cluj,2502,2,6,6,2,14,9,5,24
Universitate,2502,3,4,6,4,16,18,-2,18
D Bucuresti,2502,4,4,4,6,19,21,-2,16
Concordia Ch,2502,5,4,2,8,20,24,-4,14
FC Botosani,2502,6,3,4,7,6,15,-9,13
FCSB,2503,1,8,5,1,25,12,13,29
CFR Cluj,2503,2,6,6,2,15,9,6,24
Universitate,2503,3,4,5,5,15,19,-4,17
D Bucuresti,2503,4,4,4,6,19,21,-2,16
FC Botosani,2503,5,4,4,6,8,15,-7,16
Concordia Ch,2503,6,3,2,9,16,22,-6,11
FCSB,2504,1,7,7,0,24,11,13,28
CFR Cluj,2504,2,6,7,1,14,7,7,25
Universitate,2504,3,3,6,5,15,20,-5,15
Concordia Ch,2504,4,4,2,8,20,22,-2,14
D Bucuresti,2504,5,3,5,6,17,21,-4,14
FC Botosani,2504,6,3,5,6,5,14,-9,14
FCSB,2505,1,8,6,0,26,11,15,30
CFR Cluj,2505,2,6,7,1,15,8,7,25
D Bucuresti,2505,3,4,5,5,17,18,-1,17
FC Botosani,2505,4,4,4,6,7,14,-7,16
Universitate,2505,5,3,5,6,14,21,-7,14
Concordia Ch,2505,6,2,3,9,16,23,-7,9
FCSB,2506,1,7,6,1,25,13,12,27
CFR Cluj,2506,2,6,7,1,16,9,7,25
D Bucuresti,2506,3,4,4,6,19,19,0,16
Universitate,2506,4,3,7,4,14,18,-4,16
FC Botosani,2506,5,3,5,6,6,16,-10,14
Concordia Ch,2506,6,3,3,8,17,22,-5,12
FCSB,2507,1,8,6,0,28,14,14,30
CFR Cluj,2507,2,6,6,2,17,10,7,24
FC Botosani,2507,3,4,5,5,8,13,-5,17
Universitate,2507,4,3,6,5,16,22,-6,15
D Bucuresti,2507,5,3,5,6,18,21,-3,14
Concordia Ch,2507,6,3,2,9,17,24,-7,11
FCSB,2508,1,8,5,1,24,11,13,29
CFR Cluj,2508,2,5,6,3,13,9,4,21
Universitate,2508,3,5,5,4,16,18,-2,20
D Bucuresti,2508,4,4,4,6,19,20,-1,16
FC Botosani,2508,5,4,4,6,8,16,-8,16
Concordia Ch,2508,6,3,2,9,19,25,-6,11
FCSB,2509,1,7,5,2,25,14,11,26
CFR Cluj,2509,2,6,7,1,16,9,7,25
FC Botosani,2509,3,5,4,5,8,12,-4,19
Universitate,2509,4,4,6,4,17,20,-3,18
D Bucuresti,2509,5,3,4,7,18,22,-4,13
Concordia Ch,2509,6,3,2,9,18,25,-7,11
FCSB,2510,1,9,5,0,27,11,16,32
CFR Cluj,2510,2,6,6,2,15,10,5,24
FC Botosani,2510,3,5,4,5,8,13,-5,19
D Bucuresti,2510,4,3,5,6,19,22,-3,14
Universitate,2510,5,3,5,6,16,22,-6,14
Concordia Ch,2510,6,2,3,9,17,24,-7,9
FCSB,2511,1,8,5,1,25,12,13,29
CFR Cluj,2511,2,5,6,3,13,9,4,21
Universitate,2511,3,5,5,4,17,19,-2,20
D Bucuresti,2511,4,5,4,5,20,18,2,19
FC Botosani,2511,5,3,4,7,5,15,-10,13
Concordia Ch,2511,6,3,2,9,16,23,-7,11
FCSB,2512,1,7,6,1,25,13,12,27
CFR Cluj,2512,2,6,7,1,20,9,11,25
Universitate,2512,3,4,5,5,15,23,-8,17
D Bucuresti,2512,4,4,4,6,18,19,-1,16
FC Botosani,2512,5,3,5,6,5,14,-9,14
Concordia Ch,2512,6,3,3,8,16,21,-5,12
FCSB,2513,1,8,6,0,27,12,15,30
CFR Cluj,2513,2,5,6,3,14,11,3,21
D Bucuresti,2513,3,5,4,5,19,18,1,19
Universitate,2513,4,4,6,4,18,21,-3,18
FC Botosani,2513,5,4,4,6,6,14,-8,16
Concordia Ch,2513,6,2,2,10,15,23,-8,8
FCSB,2514,1,8,6,0,26,12,14,30
CFR Cluj,2514,2,5,8,1,14,8,6,23
D Bucuresti,2514,3,4,5,5,19,19,0,17
Universitate,2514,4,3,6,5,15,20,-5,15
FC Botosani,2514,5,3,4,7,5,15,-10,13
Concordia Ch,2514,6,3,3,8,17,22,-5,12
FCSB,2515,1,8,6,0,27,12,15,30
CFR Cluj,2515,2,5,7,2,14,10,4,22
D Bucuresti,2515,3,4,5,5,19,20,-1,17
Universitate,2515,4,3,7,4,17,21,-4,16
FC Botosani,2515,5,4,4,6,8,15,-7,16
Concordia Ch,2515,6,2,3,9,17,24,-7,9
FCSB,2516,1,8,5,1,26,13,13,29
CFR Cluj,2516,2,6,6,2,14,8,6,24
Universitate,2516,3,4,5,5,17,21,-4,17
FC Botosani,2516,4,3,6,5,5,12,-7,15
D Bucuresti,2516,5,3,5,6,17,20,-3,14
Concordia Ch,2516,6,3,3,8,17,22,-5,12
FCSB,2517,1,8,6,0,24,10,14,30
CFR Cluj,2517,2,5,7,2,14,9,5,22
D Bucuresti,2517,3,4,5,5,19,20,-1,17
Universitate,2517,4,3,7,4,15,19,-4,16
FC Botosani,2517,5,3,4,7,6,16,-10,13
Concordia Ch,2517,6,3,3,8,18,22,-4,12
FCSB,2518,1,8,5,1,26,15,11,29
CFR Cluj,2518,2,5,7,2,15,11,4,22
Universitate,2518,3,4,6,4,19,19,0,18
FC Botosani,2518,4,4,5,5,7,13,-6,17
D Bucuresti,2518,5,3,4,7,17,22,-5,13
Concordia Ch,2518,6,3,3,8,17,21,-4,12
FCSB,2519,1,8,6,0,26,11,15,30
CFR Cluj,2519,2,5,6,3,13,12,1,21
Universitate,2519,3,4,6,4,18,19,-1,18
FC Botosani,2519,4,4,5,5,6,12,-6,17
D Bucuresti,2519,5,3,5,6,17,20,-3,14
Concordia Ch,2519,6,3,2,9,17,23,-6,11
FCSB,2520,1,8,5,1,25,13,12,29
CFR Cluj,2520,2,5,6,3,13,9,4,21
Universitate,2520,3,5,5,4,18,19,-1,20
D Bucuresti,2520,4,4,5,5,19,20,-1,17
FC Botosani,2520,5,4,4,6,8,14,-6,16
Concordia Ch,2520,6,2,3,9,16,24,-8,9
FCSB,2521,1,7,7,0,25,12,13,28
CFR Cluj,2521,2,5,7,2,15,11,4,22
Universitate,2521,3,4,6,4,16,18,-2,18
Concordia Ch,2521,4,4,2,8,19,21,-2,14
D Bucuresti,2521,5,3,5,6,18,22,-4,14
FC Botosani,2521,6,3,5,6,7,16,-9,14
CFR Cluj,2522,1,7,6,1,18,7,11,27
FCSB,2522,2,7,5,2,25,17,8,26
D Bucuresti,2522,3,5,4,5,23,20,3,19
Universitate,2522,4,4,5,5,17,21,-4,17
FC Botosani,2522,5,3,4,7,5,17,-12,13
Concordia Ch,2522,6,3,2,9,18,24,-6,11
FCSB,2523,1,8,5,1,26,14,12,29
CFR Cluj,2523,2,7,6,1,18,8,10,27
D Bucuresti,2523,3,3,6,5,18,20,-2,15
FC Botosani,2523,4,3,6,5,7,14,-7,15
Universitate,2523,5,3,5,6,16,23,-7,14
Concordia Ch,2523,6,2,4,8,19,25,-6,10
FCSB,2524,1,9,5,0,26,10,16,32
CFR Cluj,2524,2,6,6,2,16,9,7,24
D Bucuresti,2524,3,4,5,5,20,20,0,17
Universitate,2524,4,3,5,6,14,22,-8,14
FC Botosani,2524,5,3,5,6,6,16,-10,14
Concordia Ch,2524,6,3,2,9,19,24,-5,11
FCSB,2525,1,7,6,1,24,12,12,27
CFR Cluj,2525,2,6,7,1,17,10,7,25
Universitate,2525,3,3,7,4,16,20,-4,16
D Bucuresti,2525,4,3,6,5,19,21,-2,15
FC Botosani,2525,5,3,6,5,8,15,-7,15
Concordia Ch,2525,6,2,4,8,17,23,-6,10
FCSB,2526,1,8,6,0,27,12,15,30
CFR Cluj,2526,2,5,7,2,14,10,4,22
D Bucuresti,2526,3,4,5,5,21,22,-1,17
Universitate,2526,4,3,7,4,15,19,-4,16
FC Botosani,2526,5,3,4,7,7,16,-9,13
Concordia Ch,2526,6,3,3,8,18,23,-5,12
FCSB,2527,1,8,6,0,28,13,15,30
CFR Cluj,2527,2,5,7,2,16,12,4,22
D Bucuresti,2527,3,4,5,5,18,18,0,17
Universitate,2527,4,3,7,4,18,22,-4,16
FC Botosani,2527,5,3,6,5,6,13,-7,15
Concordia Ch,2527,6,2,3,9,16,24,-8,9
FCSB,2528,1,8,5,1,26,13,13,29
CFR Cluj,2528,2,5,6,3,13,12,1,21
Universitate,2528,3,5,5,4,20,19,1,20
D Bucuresti,2528,4,4,4,6,19,21,-2,16
Concordia Ch,2528,5,4,2,8,20,22,-2,14
FC Botosani,2528,6,3,4,7,5,16,-11,13
FCSB,2529,1,7,6,1,24,12,12,27
CFR Cluj,2529,2,5,8,1,14,8,6,23
Universitate,2529,3,4,6,4,17,20,-3,18
Concordia Ch,2529,4,4,2,8,23,22,1,14
D Bucuresti,2529,5,3,5,6,18,25,-7,14
FC Botosani,2529,6,3,5,6,8,17,-9,14
FCSB,2530,1,7,6,1,25,13,12,27
CFR Cluj,2530,2,6,6,2,14,8,6,24
Universitate,2530,3,4,6,4,17,20,-3,18
D Bucuresti,2530,4,4,4,6,17,20,-3,16
FC Botosani,2530,5,4,4,6,6,13,-7,16
Concordia Ch,2530,6,3,2,9,17,22,-5,11
FCSB,2531,1,8,6,0,24,10,14,30
CFR Cluj,2531,2,5,8,1,14,8,6,23
D Bucuresti,2531,3,4,5,5,21,18,3,17
FC Botosani,2531,4,4,4,6,8,17,-9,16
Universitate,2531,5,3,6,5,15,20,-5,15
Concordia Ch,2531,6,2,3,9,15,24,-9,9
FCSB,2532,1,9,5,0,28,10,18,32
CFR Cluj,2532,2,5,6,3,15,13,2,21
D Bucuresti,2532,3,4,5,5,19,20,-1,17
Universitate,2532,4,4,5,5,17,22,-5,17
FC Botosani,2532,5,3,5,6,6,14,-8,14
Concordia Ch,2532,6,2,4,8,16,22,-6,10
FCSB,2533,1,9,5,0,27,12,15,32
CFR Cluj,2533,2,6,6,2,17,9,8,24
D Bucuresti,2533,3,4,4,6,17,19,-2,16
Concordia Ch,2533,4,4,2,8,18,22,-4,14
Universitate,2533,5,3,5,6,15,23,-8,14
FC Botosani,2533,6,3,4,7,6,15,-9,13
FCSB,2534,1,8,6,0,26,12,14,30
CFR Cluj,2534,2,6,6,2,16,10,6,24
D Bucuresti,2534,3,4,5,5,20,19,1,17
FC Botosani,2534,4,4,5,5,7,13,-6,17
Universitate,2534,5,3,6,5,16,21,-5,15
Concordia Ch,2534,6,2,2,10,15,25,-10,8
FCSB,2535,1,8,6,0,25,11,14,30
CFR Cluj,2535,2,6,7,1,16,9,7,25
FC Botosani,2535,3,4,5,5,10,15,-5,17
D Bucuresti,2535,4,3,5,6,18,22,-4,14
Universitate,2535,5,3,5,6,17,23,-6,14
Concordia Ch,2535,6,3,2,9,18,24,-6,11
FCSB,2536,1,8,5,1,24,13,11,29
CFR Cluj,2536,2,7,6,1,18,8,10,27
D Bucuresti,2536,3,5,4,5,18,18,0,19
FC Botosani,2536,4,4,4,6,7,14,-7,16
Universitate,2536,5,3,5,6,15,21,-6,14
Concordia Ch,2536,6,2,2,10,16,24,-8,8
FCSB,2537,1,8,5,1,28,12,16,29
CFR Cluj,2537,2,6,6,2,17,12,5,24
D Bucuresti,2537,3,4,5,5,18,19,-1,17
Universitate,2537,4,4,5,5,17,23,-6,17
FC Botosani,2537,5,4,4,6,8,15,-7,16
Concordia Ch,2537,6,2,3,9,18,25,-7,9
CFR Cluj,2538,1,7,6,1,16,7,9,27
FCSB,2538,2,7,5,2,23,13,10,26
Universitate,2538,3,4,5,5,15,19,-4,17
D Bucuresti,2538,4,4,4,6,17,20,-3,16
FC Botosani,2538,5,3,5,6,5,13,-8,14
Concordia Ch,2538,6,3,3,8,17,21,-4,12
FCSB,2539,1,9,5,0,27,12,15,32
CFR Cluj,2539,2,6,6,2,16,9,7,24
D Bucuresti,2539,3,4,5,5,19,19,0,17
Universitate,2539,4,3,5,6,15,22,-7,14
FC Botosani,2539,5,3,4,7,6,16,-10,13
Concordia Ch,2539,6,3,3,8,18,23,-5,12
FCSB,2540,1,9,5,0,26,11,15,32
CFR Cluj,2540,2,5,6,3,13,9,4,21
FC Botosani,2540,3,5,4,5,7,12,-5,19
Universitate,2540,4,4,5,5,16,20,-4,17
D Bucuresti,2540,5,3,5,6,17,20,-3,14
Concordia Ch,2540,6,2,3,9,16,23,-7,9
FCSB,2541,1,9,5,0,29,11,18,32
CFR Cluj,2541,2,6,6,2,15,9,6,24
FC Botosani,2541,3,5,4,5,9,14,-5,19
D Bucuresti,2541,4,4,4,6,19,20,-1,16
Universitate,2541,5,3,5,6,14,23,-9,14
Concordia Ch,2541,6,2,2,10,16,25,-9,8
FCSB,2542,1,8,5,1,24,11,13,29
CFR Cluj,2542,2,5,7,2,13,8,5,22
D Bucuresti,2542,3,5,4,5,19,19,0,19
Universitate,2542,4,4,6,4,15,18,-3,18
FC Botosani,2542,5,3,4,7,6,15,-9,13
Concordia Ch,2542,6,3,2,9,16,22,-6,11
FCSB,2543,1,7,6,1,24,12,12,27
CFR Cluj,2543,2,6,6,2,15,9,6,24
FC Botosani,2543,3,5,4,5,7,12,-5,19
Universitate,2543,4,4,6,4,15,18,-3,18
D Bucuresti,2543,5,4,4,6,20,22,-2,16
Concordia Ch,2543,6,2,2,10,18,26,-8,8
FCSB,2544,1,8,6,0,26,11,15,30
CFR Cluj,2544,2,5,8,1,14,8,6,23
FC Botosani,2544,3,5,4,5,9,13,-4,19
Universitate,2544,4,3,6,5,14,20,-6,15
D Bucuresti,2544,5,3,4,7,17,21,-4,13
Concordia Ch,2544,6,3,2,9,18,25,-7,11
FCSB,2545,1,9,5,0,27,12,15,32
CFR Cluj,2545,2,6,6,2,16,10,6,24
FC Botosani,2545,3,4,5,5,8,13,-5,17
D Bucuresti,2545,4,3,6,5,18,20,-2,15
Universitate,2545,5,3,5,6,16,22,-6,14
Concordia Ch,2545,6,2,3,9,16,24,-8,9
FCSB,2546,1,9,5,0,29,11,18,32
CFR Cluj,2546,2,6,6,2,14,10,4,24
D Bucuresti,2546,3,5,4,5,22,20,2,19
Universitate,2546,4,3,5,6,15,22,-7,14
FC Botosani,2546,5,3,4,7,6,17,-11,13
Concordia Ch,2546,6,3,2,9,19,25,-6,11
FCSB,2547,1,8,5,1,24,12,12,29
CFR Cluj,2547,2,5,7,2,14,9,5,22
D Bucuresti,2547,3,5,4,5,22,18,4,19
Universitate,2547,4,4,6,4,17,19,-2,18
FC Botosani,2547,5,3,4,7,5,18,-13,13
Concordia Ch,2547,6,3,2,9,16,22,-6,11
FCSB,2548,1,9,5,0,27,11,16,32
CFR Cluj,2548,2,5,7,2,14,9,5,22
FC Botosani,2548,3,4,5,5,10,15,-5,17
D Bucuresti,2548,4,4,4,6,18,21,-3,16
Universitate,2548,5,3,6,5,16,22,-6,15
Concordia Ch,2548,6,2,3,9,17,24,-7,9
FCSB,2549,1,7,6,1,26,14,12,27
CFR Cluj,2549,2,5,7,2,15,10,5,22
Universitate,2549,3,5,5,4,17,19,-2,20
D Bucuresti,2549,4,5,4,5,21,19,2,19
FC Botosani,2549,5,3,4,7,5,16,-11,13
Concordia Ch,2549,6,3,2,9,17,23,-6,11
FCSB,2550,1,8,5,1,25,12,13,29
CFR Cluj,2550,2,6,6,2,14,8,6,24
Universitate,2550,3,4,5,5,16,20,-4,17
D Bucuresti,2550,4,4,4,6,22,21,1,16
Concordia Ch,2550,5,4,2,8,19,23,-4,14
FC Botosani,2550,6,3,4,7,5,17,-12,13
CFR Cluj,2551,1,7,6,1,16,7,9,27
FCSB,2551,2,7,5,2,23,13,10,26
FC Botosani,2551,3,5,4,5,8,12,-4,19
Universitate,2551,4,4,5,5,15,19,-4,17
D Bucuresti,2551,5,4,4,6,18,20,-2,16
Concordia Ch,2551,6,2,2,10,16,25,-9,8
FCSB,2552,1,7,6,1,23,11,12,27
CFR Cluj,2552,2,6,6,2,15,10,5,24
Universitate,2552,3,4,6,4,17,19,-2,18
D Bucuresti,2552,4,4,4,6,18,21,-3,16
FC Botosani,2552,5,4,4,6,7,14,-7,16
Concordia Ch,2552,6,3,2,9,18,23,-5,11
FCSB,2553,1,8,6,0,29,13,16,30
CFR Cluj,2553,2,5,7,2,14,10,4,22
Universitate,2553,3,4,5,5,18,23,-5,17
D Bucuresti,2553,4,4,4,6,19,20,-1,16
Concordia Ch,2553,5,4,2,8,20,22,-2,14
FC Botosani,2553,6,3,4,7,5,17,-12,13
FCSB,2554,1,9,5,0,26,10,16,32
CFR Cluj,2554,2,6,6,2,15,9,6,24
D Bucuresti,2554,3,5,4,5,20,20,0,19
Universitate,2554,4,3,5,6,14,21,-7,14
FC Botosani,2554,5,3,5,6,8,16,-8,14
Concordia Ch,2554,6,2,3,9,18,25,-7,9
FCSB,2555,1,8,6,0,24,10,14,30
CFR Cluj,2555,2,6,7,1,14,7,7,25
D Bucuresti,2555,3,4,5,5,18,19,-1,17
FC Botosani,2555,4,4,4,6,6,13,-7,16
Universitate,2555,5,3,5,6,14,20,-6,14
Concordia Ch,2555,6,2,3,9,16,23,-7,9
FCSB,2556,1,8,5,1,25,13,12,29
CFR Cluj,2556,2,6,7,1,17,8,9,25
D Bucuresti,2556,3,5,4,5,19,18,1,19
FC Botosani,2556,4,4,4,6,6,13,-7,16
Universitate,2556,5,3,6,5,15,21,-6,15
Concordia Ch,2556,6,2,2,10,15,24,-9,8
FCSB,2557,1,7,7,0,23,10,13,28
CFR Cluj,2557,2,6,7,1,15,8,7,25
D Bucuresti,2557,3,5,4,5,20,19,1,19
Universitate,2557,4,3,6,5,15,20,-5,15
FC Botosani,2557,5,3,4,7,6,16,-10,13
Concordia Ch,2557,6,3,2,9,18,24,-6,11
FCSB,2558,1,7,6,1,24,13,11,27
CFR Cluj,2558,2,5,8,1,13,7,6,23
Universitate,2558,3,4,6,4,17,19,-2,18
D Bucuresti,2558,4,4,5,5,19,20,-1,17
FC Botosani,2558,5,3,6,5,8,15,-7,15
Concordia Ch,2558,6,2,3,9,16,23,-7,9
CFR Cluj,2559,1,7,6,1,18,10,8,27
FCSB,2559,2,7,5,2,25,14,11,26
Universitate,2559,3,4,5,5,18,22,-4,17
FC Botosani,2559,4,4,5,5,10,14,-4,17
D Bucuresti,2559,5,3,4,7,16,22,-6,13
Concordia Ch,2559,6,3,3,8,18,23,-5,12
FCSB,2560,1,9,5,0,27,10,17,32
CFR Cluj,2560,2,6,6,2,15,9,6,24
D Bucuresti,2560,3,4,5,5,17,18,-1,17
Universitate,2560,4,3,5,6,14,22,-8,14
FC Botosani,2560,5,3,5,6,5,13,-8,14
Concordia Ch,2560,6,3,2,9,16,22,-6,11
FCSB,2561,1,8,5,1,26,13,13,29
CFR Cluj,2561,2,5,6,3,15,13,2,21
Universitate,2561,3,5,5,4,19,19,0,20
FC Botosani,2561,4,4,5,5,8,13,-5,17
D Bucuresti,2561,5,3,6,5,17,19,-2,15
Concordia Ch,2561,6,2,3,9,17,25,-8,9
FCSB,2562,1,7,6,1,23,12,11,27
CFR Cluj,2562,2,5,8,1,14,8,6,23
Universitate,2562,3,4,6,4,17,19,-2,18
D Bucuresti,2562,4,4,4,6,17,19,-2,16
FC Botosani,2562,5,4,4,6,7,13,-6,16
Concordia Ch,2562,6,3,2,9,16,23,-7,11
FCSB,2563,1,9,5,0,25,10,15,32
CFR Cluj,2563,2,6,6,2,17,8,9,24
FC Botosani,2563,3,5,4,5,8,12,-4,19
D Bucuresti,2563,4,3,5,6,16,19,-3,14
Universitate,2563,5,3,5,6,14,23,-9,14
Concordia Ch,2563,6,2,3,9,15,23,-8,9
FCSB,2564,1,8,5,1,24,12,12,29
CFR Cluj,2564,2,5,6,3,14,12,2,21
Universitate,2564,3,5,5,4,20,19,1,20
FC Botosani,2564,4,5,4,5,10,12,-2,19
D Bucuresti,2564,5,3,4,7,16,20,-4,13
Concordia Ch,2564,6,3,2,9,16,25,-9,11
FCSB,2565,1,7,6,1,23,13,10,27
CFR Cluj,2565,2,6,7,1,17,8,9,25
FC Botosani,2565,3,4,5,5,9,14,-5,17
Universitate,2565,4,3,7,4,15,19,-4,16
D Bucuresti,2565,5,3,4,7,16,23,-7,13
Concordia Ch,2565,6,3,3,8,20,23,-3,12
FCSB,2566,1,8,5,1,24,12,12,29
CFR Cluj,2566,2,5,6,3,14,10,4,21
Universitate,2566,3,5,5,4,18,19,-1,20
D Bucuresti,2566,4,3,5,6,16,19,-3,14
Concordia Ch,2566,5,4,2,8,17,21,-4,14
FC Botosani,2566,6,3,5,6,5,13,-8,14
FCSB,2567,1,7,6,1,24,12,12,27
CFR Cluj,2567,2,5,8,1,16,10,6,23
D Bucuresti,2567,3,5,4,5,18,18,0,19
Universitate,2567,4,4,6,4,17,20,-3,18
FC Botosani,2567,5,3,4,7,6,16,-10,13
Concordia Ch,2567,6,3,2,9,18,23,-5,11
FCSB,2568,1,9,5,0,30,13,17,32
CFR Cluj,2568,2,6,6,2,16,12,4,24
FC Botosani,2568,3,4,4,6,7,14,-7,16
D Bucuresti,2568,4,3,5,6,17,20,-3,14
Universitate,2568,5,3,5,6,17,23,-6,14
Concordia Ch,2568,6,3,3,8,18,23,-5,12
FCSB,2569,1,8,6,0,29,15,14,30
CFR Cluj,2569,2,6,6,2,17,11,6,24
D Bucuresti,2569,3,4,5,5,19,20,-1,17
Universitate,2569,4,3,6,5,18,23,-5,15
FC Botosani,2569,5,3,5,6,7,15,-8,14
Concordia Ch,2569,6,3,2,9,16,22,-6,11
FCSB,2570,1,8,5,1,25,12,13,29
CFR Cluj,2570,2,5,7,2,14,9,5,22
FC Botosani,2570,3,5,4,5,9,12,-3,19
Universitate,2570,4,4,6,4,17,20,-3,18
D Bucuresti,2570,5,3,4,7,18,22,-4,13
Concordia Ch,2570,6,3,2,9,18,26,-8,11
FCSB,2571,1,7,6,1,24,13,11,27
CFR Cluj,2571,2,6,6,2,17,10,7,24
Universitate,2571,3,4,6,4,16,19,-3,18
FC Botosani,2571,4,4,5,5,9,14,-5,17
D Bucuresti,2571,5,3,5,6,18,21,-3,14
Concordia Ch,2571,6,3,2,9,18,25,-7,11
FCSB,2572,1,8,6,0,25,10,15,30
CFR Cluj,2572,2,5,6,3,13,11,2,21
D Bucuresti,2572,3,5,4,5,19,18,1,19
Universitate,2572,4,4,6,4,16,18,-2,18
FC Botosani,2572,5,3,5,6,6,14,-8,14
Concordia Ch,2572,6,2,3,9,16,24,-8,9
FCSB,2573,1,8,5,1,25,12,13,29
CFR Cluj,2573,2,7,6,1,15,7,8,27
D Bucuresti,2573,3,3,6,5,20,22,-2,15
FC Botosani,2573,4,3,6,5,7,14,-7,15
Universitate,2573,5,3,5,6,15,21,-6,14
Concordia Ch,2573,6,2,4,8,19,25,-6,10
FCSB,2574,1,8,5,1,24,11,13,29
CFR Cluj,2574,2,7,6,1,16,8,8,27
FC Botosani,2574,3,4,4,6,7,13,-6,16
Concordia Ch,2574,4,4,2,8,18,22,-4,14
Universitate,2574,5,3,5,6,15,21,-6,14
D Bucuresti,2574,6,3,4,7,17,22,-5,13
FCSB,2575,1,7,6,1,24,12,12,27
CFR Cluj,2575,2,6,7,1,15,7,8,25
D Bucuresti,2575,3,5,4,5,20,19,1,19
Universitate,2575,4,4,5,5,16,21,-5,17
FC Botosani,2575,5,3,5,6,5,14,-9,14
Concordia Ch,2575,6,2,3,9,16,23,-7,9
FCSB,2576,1,7,6,1,24,13,11,27
CFR Cluj,2576,2,6,7,1,15,8,7,25
Universitate,2576,3,4,5,5,16,19,-3,17
FC Botosani,2576,4,4,4,6,7,13,-6,16
D Bucuresti,2576,5,3,5,6,18,22,-4,14
Concordia Ch,2576,6,3,3,8,18,23,-5,12
FCSB,2577,1,9,5,0,26,11,15,32
CFR Cluj,2577,2,5,6,3,13,9,4,21
Universitate,2577,3,4,5,5,16,20,-4,17
FC Botosani,2577,4,4,4,6,6,14,-8,16
Concordia Ch,2577,5,4,2,8,18,21,-3,14
D Bucuresti,2577,6,3,4,7,16,20,-4,13
FCSB,2578,1,9,5,0,30,15,15,32
CFR Cluj,2578,2,5,6,3,16,12,4,21
Universitate,2578,3,4,5,5,17,21,-4,17
FC Botosani,2578,4,4,5,5,8,14,-6,17
D Bucuresti,2578,5,3,5,6,19,22,-3,14
Concordia Ch,2578,6,2,4,8,16,22,-6,10
CFR Cluj,2579,1,7,6,1,18,8,10,27
FCSB,2579,2,7,5,2,24,14,10,26
Universitate,2579,3,4,5,5,15,20,-5,17
D Bucuresti,2579,4,4,4,6,18,21,-3,16
Concordia Ch,2579,5,4,2,8,20,22,-2,14
FC Botosani,2579,6,3,4,7,7,17,-10,13
FCSB,2580,1,8,5,1,26,12,14,29
CFR Cluj,2580,2,6,6,2,16,11,5,24
D Bucuresti,2580,3,5,4,5,19,19,0,19
Universitate,2580,4,4,5,5,16,20,-4,17
FC Botosani,2580,5,3,4,7,6,15,-9,13
Concordia Ch,2580,6,3,2,9,18,24,-6,11
FCSB,2581,1,9,5,0,28,12,16,32
CFR Cluj,2581,2,5,7,2,14,10,4,22
FC Botosani,2581,3,4,5,5,10,16,-6,17
Universitate,2581,4,3,6,5,17,22,-5,15
D Bucuresti,2581,5,3,5,6,17,21,-4,14
Concordia Ch,2581,6,3,2,9,20,25,-5,11
FCSB,2582,1,7,6,1,27,15,12,27
CFR Cluj,2582,2,5,7,2,17,12,5,22
Universitate,2582,3,5,5,4,16,18,-2,20
D Bucuresti,2582,4,4,5,5,19,20,-1,17
FC Botosani,2582,5,3,5,6,7,15,-8,14
Concordia Ch,2582,6,2,4,8,19,25,-6,10
FCSB,2583,1,8,5,1,26,13,13,29
CFR Cluj,2583,2,6,7,1,15,8,7,25
D Bucuresti,2583,3,4,5,5,17,18,-1,17
FC Botosani,2583,4,4,4,6,7,14,-7,16
Universitate,2583,5,3,6,5,15,20,-5,15
Concordia Ch,2583,6,2,3,9,16,23,-7,9
FCSB,2584,1,8,6,0,27,13,14,30
CFR Cluj,2584,2,6,6,2,15,9,6,24
D Bucuresti,2584,3,4,4,6,18,19,-1,16
FC Botosani,2584,4,4,4,6,9,15,-6,16
Universitate,2584,5,3,6,5,16,21,-5,15
Concordia Ch,2584,6,3,2,9,17,25,-8,11
FCSB,2585,1,8,5,1,25,14,11,29
CFR Cluj,2585,2,6,7,1,17,8,9,25
FC Botosani,2585,3,5,4,5,7,12,-5,19
Universitate,2585,4,3,6,5,16,21,-5,15
D Bucuresti,2585,5,3,4,7,16,21,-5,13
Concordia Ch,2585,6,3,2,9,17,22,-5,11
CFR Cluj,2586,1,7,6,1,17,8,9,27
FCSB,2586,2,7,5,2,24,15,9,26
Universitate,2586,3,4,5,5,17,20,-3,17
FC Botosani,2586,4,4,5,5,7,13,-6,17
D Bucuresti,2586,5,3,5,6,17,20,-3,14
Concordia Ch,2586,6,3,2,9,16,22,-6,11
FCSB,2587,1,8,5,1,27,11,16,29
CFR Cluj,2587,2,6,6,2,15,11,4,24
Universitate,2587,3,4,5,5,15,20,-5,17
D Bucuresti,2587,4,4,4,6,17,20,-3,16
FC Botosani,2587,5,3,5,6,6,14,-8,14
Concordia Ch,2587,6,3,3,8,18,22,-4,12
FCSB,2588,1,8,5,1,25,12,13,29
CFR Cluj,2588,2,7,6,1,16,7,9,27
FC Botosani,2588,3,4,5,5,8,13,-5,17
D Bucuresti,2588,4,3,5,6,17,21,-4,14
Universitate,2588,5,3,5,6,14,21,-7,14
Concordia Ch,2588,6,2,4,8,17,23,-6,10
FCSB,2589,1,7,6,1,24,13,11,27
CFR Cluj,2589,2,6,7,1,16,9,7,25
FC Botosani,2589,3,5,4,5,10,13,-3,19
Universitate,2589,4,4,5,5,17,20,-3,17
D Bucuresti,2589,5,3,5,6,18,21,-3,14
Concordia Ch,2589,6,2,3,9,16,25,-9,9
FCSB,2590,1,8,6,0,27,10,17,30
CFR Cluj,2590,2,5,6,3,13,13,0,21
Universitate,2590,3,4,6,4,16,18,-2,18
D Bucuresti,2590,4,4,5,5,21,22,-1,17
FC Botosani,2590,5,4,5,5,8,14,-6,17
Concordia Ch,2590,6,2,2,10,17,25,-8,8
FCSB,2591,1,7,7,0,24,11,13,28
CFR Cluj,2591,2,5,8,1,14,8,6,23
D Bucuresti,2591,3,4,4,6,20,20,0,16
Universitate,2591,4,3,7,4,14,18,-4,16
FC Botosani,2591,5,4,4,6,6,13,-7,16
Concordia Ch,2591,6,3,2,9,17,25,-8,11
FCSB,2592,1,7,7,0,25,12,13,28
CFR Cluj,2592,2,5,8,1,15,9,6,23
D Bucuresti,2592,3,4,5,5,18,19,-1,17
Universitate,2592,4,3,7,4,16,20,-4,16
FC Botosani,2592,5,3,5,6,5,13,-8,14
Concordia Ch,2592,6,2,4,8,16,22,-6,10
FCSB,2593,1,8,5,1,27,13,14,29
CFR Cluj,2593,2,6,6,2,14,10,4,24
D Bucuresti,2593,3,4,5,5,19,20,-1,17
Universitate,2593,4,4,5,5,17,20,-3,17
FC Botosani,2593,5,4,4,6,8,15,-7,16
Concordia Ch,2593,6,2,3,9,17,24,-7,9
FCSB,2594,1,7,6,1,24,14,10,27
CFR Cluj,2594,2,6,7,1,16,9,7,25
Universitate,2594,3,4,5,5,18,20,-2,17
Concordia Ch,2594,4,4,2,8,19,22,-3,14
D Bucuresti,2594,5,3,5,6,17,20,-3,14
FC Botosani,2594,6,3,5,6,5,14,-9,14
FCSB,2595,1,8,5,1,25,12,13,29
CFR Cluj,2595,2,6,6,2,16,9,7,24
D Bucuresti,2595,3,5,4,5,22,20,2,19
Universitate,2595,4,4,5,5,17,22,-5,17
FC Botosani,2595,5,4,4,6,10,18,-8,16
Concordia Ch,2595,6,2,2,10,17,26,-9,8
FCSB,2596,1,8,5,1,28,13,15,29
CFR Cluj,2596,2,5,7,2,14,11,3,22
Universitate,2596,3,4,6,4,16,19,-3,18
D Bucuresti,2596,4,4,5,5,21,20,1,17
FC Botosani,2596,5,4,4,6,8,16,-8,16
Concordia Ch,2596,6,2,3,9,16,24,-8,9
CFR Cluj,2597,1,7,6,1,16,7,9,27
FCSB,2597,2,7,5,2,24,13,11,26
D Bucuresti,2597,3,5,4,5,20,19,1,19
Universitate,2597,4,4,5,5,16,21,-5,17
FC Botosani,2597,5,3,5,6,6,14,-8,14
Concordia Ch,2597,6,2,3,9,17,25,-8,9
FCSB,2598,1,8,6,0,27,13,14,30
CFR Cluj,2598,2,5,7,2,15,11,4,22
Universitate,2598,3,4,5,5,19,22,-3,17
D Bucuresti,2598,4,4,4,6,17,19,-2,16
FC Botosani,2598,5,4,4,6,8,15,-7,16
Concordia Ch,2598,6,3,2,9,18,24,-6,11
FCSB,2599,1,7,6,1,25,14,11,27
CFR Cluj,2599,2,6,7,1,15,7,8,25
Universitate,2599,3,4,5,5,18,22,-4,17
D Bucuresti,2599,4,4,4,6,19,21,-2,16
FC Botosani,2599,5,4,4,6,7,14,-7,16
Concordia Ch,2599,6,3,2,9,19,25,-6,11
FCSB,2600,1,8,5,1,27,13,14,29
CFR Cluj,2600,2,5,7,2,14,10,4,22
Universitate,2600,3,4,6,4,18,21,-3,18
FC Botosani,2600,4,4,5,5,8,14,-6,17
D Bucuresti,2600,5,3,5,6,17,21,-4,14
Concordia Ch,2600,6,3,2,9,18,23,-5,11
FCSB,2601,1,7,5,2,23,15,8,26
CFR Cluj,2601,2,6,6,2,15,9,6,24
Universitate,2601,3,5,5,4,20,19,1,20
D Bucuresti,2601,4,5,4,5,21,21,0,19
FC Botosani,2601,5,3,5,6,7,15,-8,14
Concordia Ch,2601,6,2,3,9,18,25,-7,9
FCSB,2602,1,9,5,0,26,11,15,32
CFR Cluj,2602,2,6,6,2,15,8,7,24
Concordia Ch,2602,3,4,2,8,18,21,-3,14
D Bucuresti,2602,4,3,5,6,17,21,-4,14
Universitate,2602,5,3,5,6,15,22,-7,14
FC Botosani,2602,6,3,5,6,6,14,-8,14
FCSB,2603,1,7,5,2,23,12,11,26
CFR Cluj,2603,2,6,7,1,17,10,7,25
FC Botosani,2603,3,5,4,5,8,13,-5,19
Universitate,2603,4,4,6,4,18,21,-3,18
D Bucuresti,2603,5,4,4,6,17,19,-2,16
Concordia Ch,2603,6,2,2,10,16,24,-8,8
FCSB,2604,1,8,6,0,26,12,14,30
CFR Cluj,2604,2,5,7,2,14,9,5,22
FC Botosani,2604,3,4,5,5,9,14,-5,17
Universitate,2604,4,3,7,4,15,19,-4,16
D Bucuresti,2604,5,3,4,7,17,23,-6,13
Concordia Ch,2604,6,3,3,8,18,22,-4,12
FCSB,2605,1,8,6,0,27,12,15,30
CFR Cluj,2605,2,5,7,2,15,11,4,22
FC Botosani,2605,3,4,5,5,7,12,-5,17
D Bucuresti,2605,4,4,4,6,18,21,-3,16
Universitate,2605,5,3,7,4,16,20,-4,16
Concordia Ch,2605,6,2,3,9,16,23,-7,9
FCSB,2606,1,9,5,0,28,11,17,32
CFR Cluj,2606,2,5,6,3,14,11,3,21
D Bucuresti,2606,3,5,4,5,20,18,2,19
Universitate,2606,4,4,5,5,15,20,-5,17
FC Botosani,2606,5,3,5,6,7,15,-8,14
Concordia Ch,2606,6,2,3,9,17,26,-9,9
FCSB,2607,1,8,6,0,28,12,16,30
CFR Cluj,2607,2,6,7,1,14,7,7,25
D Bucuresti,2607,3,4,4,6,19,20,-1,16
Concordia Ch,2607,4,4,2,8,19,23,-4,14
Universitate,2607,5,3,5,6,16,24,-8,14
FC Botosani,2607,6,3,4,7,6,16,-10,13
FCSB,2608,1,8,6,0,24,10,14,30
CFR Cluj,2608,2,5,8,1,14,8,6,23
FC Botosani,2608,3,5,4,5,7,12,-5,19
D Bucuresti,2608,4,4,4,6,18,20,-2,16
Universitate,2608,5,3,6,5,15,20,-5,15
Concordia Ch,2608,6,2,2,10,16,24,-8,8
FCSB,2609,1,8,5,1,25,12,13,29
CFR Cluj,2609,2,5,6,3,14,11,3,21
Universitate,2609,3,5,5,4,18,19,-1,20
D Bucuresti,2609,4,5,4,5,19,18,1,19
FC Botosani,2609,5,3,4,7,7,16,-9,13
Concordia Ch,2609,6,3,2,9,18,25,-7,11
FCSB,2610,1,8,5,1,26,13,13,29
CFR Cluj,2610,2,7,6,1,16,7,9,27
FC Botosani,2610,3,4,5,5,8,13,-5,17
D Bucuresti,2610,4,3,6,5,17,19,-2,15
Universitate,2610,5,3,5,6,16,23,-7,14
Concordia Ch,2610,6,2,3,9,17,25,-8,9
FCSB,2611,1,8,5,1,24,12,12,29
CFR Cluj,2611,2,5,7,2,13,8,5,22
Universitate,2611,3,4,6,4,16,18,-2,18
D Bucuresti,2611,4,4,4,6,17,19,-2,16
FC Botosani,2611,5,4,4,6,6,13,-7,16
Concordia Ch,2611,6,3,2,9,16,22,-6,11
CFR Cluj,2612,1,7,6,1,18,7,11,27
FCSB,2612,2,7,6,1,23,13,10,27
D Bucuresti,2612,3,5,4,5,19,18,1,19
FC Botosani,2612,4,4,4,6,7,14,-7,16
Universitate,2612,5,3,6,5,14,20,-6,15
Concordia Ch,2612,6,2,2,10,15,24,-9,8
FCSB,2613,1,7,6,1,25,15,10,27
CFR Cluj,2613,2,6,7,1,17,10,7,25
D Bucuresti,2613,3,5,4,5,20,18,2,19
Universitate,2613,4,4,5,5,18,20,-2,17
FC Botosani,2613,5,3,4,7,5,15,-10,13
Concordia Ch,2613,6,3,2,9,16,23,-7,11
FCSB,2614,1,7,7,0,25,12,13,28
CFR Cluj,2614,2,5,8,1,16,10,6,23
D Bucuresti,2614,3,4,4,6,18,22,-4,16
Universitate,2614,4,3,7,4,17,21,-4,16
FC Botosani,2614,5,4,4,6,8,14,-6,16
Concordia Ch,2614,6,3,2,9,18,23,-5,11
FCSB,2615,1,7,5,2,23,14,9,26
CFR Cluj,2615,2,6,7,1,17,9,8,25
Universitate,2615,3,4,6,4,18,20,-2,18
D Bucuresti,2615,4,4,4,6,21,23,-2,16
Concordia Ch,2615,5,4,2,8,21,25,-4,14
FC Botosani,2615,6,3,4,7,7,16,-9,13
CFR Cluj,2616,1,7,6,1,19,7,12,27
FCSB,2616,2,7,5,2,25,15,10,26
D Bucuresti,2616,3,4,5,5,21,20,1,17
Universitate,2616,4,4,5,5,17,24,-7,17
FC Botosani,2616,5,3,5,6,6,16,-10,14
Concordia Ch,2616,6,2,4,8,16,22,-6,10
FCSB,2617,1,7,7,0,25,12,13,28
CFR Cluj,2617,2,6,7,1,16,8,8,25
D Bucuresti,2617,3,5,4,5,20,18,2,19
Universitate,2617,4,3,6,5,17,23,-6,15
FC Botosani,2617,5,3,5,6,5,14,-9,14
Concordia Ch,2617,6,2,3,9,15,23,-8,9
FCSB,2618,1,8,5,1,24,11,13,29
CFR Cluj,2618,2,6,6,2,16,8,8,24
D Bucuresti,2618,3,4,5,5,18,19,-1,17
Universitate,2618,4,4,5,5,15,21,-6,17
FC Botosani,2618,5,3,4,7,5,14,-9,13
Concordia Ch,2618,6,3,3,8,17,22,-5,12
FCSB,2619,1,8,6,0,26,12,14,30
CFR Cluj,2619,2,5,7,2,14,11,3,22
D Bucuresti,2619,3,4,5,5,20,20,0,17
Universitate,2619,4,4,5,5,18,20,-2,17
FC Botosani,2619,5,3,5,6,8,17,-9,14
Concordia Ch,2619,6,2,4,8,18,24,-6,10
FCSB,2620,1,8,6,0,27,12,15,30
CFR Cluj,2620,2,5,7,2,13,9,4,22
D Bucuresti,2620,3,4,4,6,18,21,-3,16
Universitate,2620,4,3,7,4,16,20,-4,16
FC Botosani,2620,5,4,4,6,7,13,-6,16
Concordia Ch,2620,6,3,2,9,18,24,-6,11
FCSB,2621,1,8,5,1,26,13,13,29
CFR Cluj,2621,2,6,6,2,18,11,7,24
D Bucuresti,2621,3,5,4,5,21,18,3,19
Universitate,2621,4,4,5,5,16,21,-5,17
FC Botosani,2621,5,4,4,6,8,14,-6,16
Concordia Ch,2621,6,2,2,10,15,27,-12,8
FCSB,2622,1,7,7,0,24,11,13,28
CFR Cluj,2622,2,6,7,1,16,8,8,25
D Bucuresti,2622,3,4,4,6,18,21,-3,16
Universitate,2622,4,3,6,5,14,20,-6,15
FC Botosani,2622,5,3,5,6,5,13,-8,14
Concordia Ch,2622,6,3,3,8,18,22,-4,12
FCSB,2623,1,7,7,0,26,13,13,28
CFR Cluj,2623,2,6,7,1,19,9,10,25
D Bucuresti,2623,3,4,5,5,17,18,-1,17
Universitate,2623,4,3,6,5,17,25,-8,15
FC Botosani,2623,5,3,5,6,5,13,-8,14
Concordia Ch,2623,6,3,2,9,16,22,-6,11
FCSB,2624,1,7,7,0,24,11,13,28
CFR Cluj,2624,2,5,7,2,13,9,4,22
Universitate,2624,3,4,6,4,17,19,-2,18
D Bucuresti,2624,4,3,5,6,17,20,-3,14
Concordia Ch,2624,5,4,2,8,17,21,-4,14
FC Botosani,2624,6,3,5,6,6,14,-8,14
FCSB,2625,1,8,5,1,26,12,14,29
CFR Cluj,2625,2,6,6,2,16,10,6,24
D Bucuresti,2625,3,4,5,5,17,18,-1,17
Universitate,2625,4,4,5,5,16,21,-5,17
FC Botosani,2625,5,3,4,7,5,14,-9,13
Concordia Ch,2625,6,3,3,8,16,21,-5,12
FCSB,2626,1,9,5,0,29,12,17,32
CFR Cluj,2626,2,5,7,2,14,10,4,22
D Bucuresti,2626,3,4,5,5,18,18,0,17
Universitate,2626,4,3,6,5,17,23,-6,15
FC Botosani,2626,5,3,6,5,5,12,-7,15
Concordia Ch,2626,6,2,3,9,15,23,-8,9
FCSB,2627,1,8,6,0,27,11,16,30
CFR Cluj,2627,2,6,6,2,16,10,6,24
FC Botosani,2627,3,4,4,6,6,14,-8,16
Universitate,2627,4,3,6,5,15,22,-7,15
Concordia Ch,2627,5,4,2,8,19,21,-2,14
D Bucuresti,2627,6,3,4,7,16,21,-5,13
FCSB,2628,1,9,5,0,28,12,16,32
CFR Cluj,2628,2,5,7,2,14,9,5,22
D Bucuresti,2628,3,5,4,5,20,20,0,19
Universitate,2628,4,3,6,5,15,21,-6,15
FC Botosani,2628,5,3,4,7,6,15,-9,13
Concordia Ch,2628,6,3,2,9,19,25,-6,11
FCSB,2629,1,9,5,0,26,10,16,32
CFR Cluj,2629,2,6,6,2,15,9,6,24
D Bucuresti,2629,3,4,4,6,17,19,-2,16
FC Botosani,2629,4,4,4,6,7,14,-7,16
Universitate,2629,5,3,5,6,15,22,-7,14
Concordia Ch,2629,6,3,2,9,17,23,-6,11
FCSB,2630,1,9,5,0,28,10,18,32
CFR Cluj,2630,2,5,7,2,13,9,4,22
FC Botosani,2630,3,5,4,5,8,12,-4,19
D Bucuresti,2630,4,4,4,6,18,20,-2,16
Universitate,2630,5,3,6,5,14,21,-7,15
Concordia Ch,2630,6,2,2,10,16,25,-9,8
FCSB,2631,1,7,6,1,24,13,11,27
CFR Cluj,2631,2,7,6,1,18,8,10,27
FC Botosani,2631,3,5,4,5,9,13,-4,19
Universitate,2631,4,3,6,5,16,22,-6,15
D Bucuresti,2631,5,3,4,7,18,23,-5,13
Concordia Ch,2631,6,3,2,9,17,23,-6,11
FCSB,2632,1,8,6,0,25,11,14,30
CFR Cluj,2632,2,5,6,3,14,10,4,21
Universitate,2632,3,4,6,4,17,20,-3,18
D Bucuresti,2632,4,4,5,5,20,20,0,17
FC Botosani,2632,5,3,6,5,7,14,-7,15
Concordia Ch,2632,6,2,3,9,15,23,-8,9
FCSB,2633,1,8,5,1,27,11,16,29
CFR Cluj,2633,2,6,7,1,14,7,7,25
D Bucuresti,2633,3,5,4,5,19,18,1,19
Universitate,2633,4,3,6,5,14,22,-8,15
FC Botosani,2633,5,3,5,6,5,14,-9,14
Concordia Ch,2633,6,2,3,9,15,22,-7,9
FCSB,2634,1,8,6,0,25,10,15,30
CFR Cluj,2634,2,5,7,2,13,9,4,22
Universitate,2634,3,3,7,4,14,18,-4,16
D Bucuresti,2634,4,3,6,5,18,20,-2,15
FC Botosani,2634,5,3,6,5,7,14,-7,15
Concordia Ch,2634,6,2,4,8,17,23,-6,10
FCSB,2635,1,8,5,1,26,12,14,29
CFR Cluj,2635,2,5,6,3,14,11,3,21
Universitate,2635,3,5,5,4,16,18,-2,20
D Bucuresti,2635,4,4,5,5,18,18,0,17
FC Botosani,2635,5,4,4,6,6,14,-8,16
Concordia Ch,2635,6,2,3,9,15,22,-7,9
FCSB,2636,1,8,6,0,25,11,14,30
CFR Cluj,2636,2,5,6,3,14,11,3,21
Universitate,2636,3,4,6,4,16,18,-2,18
FC Botosani,2636,4,4,5,5,9,14,-5,17
D Bucuresti,2636,5,3,5,6,17,22,-5,14
Concordia Ch,2636,6,3,2,9,19,24,-5,11
FCSB,2637,1,9,5,0,28,11,17,32
CFR Cluj,2637,2,5,7,2,13,8,5,22
D Bucuresti,2637,3,5,4,5,20,20,0,19
Universitate,2637,4,3,6,5,15,22,-7,15
FC Botosani,2637,5,3,5,6,7,15,-8,14
Concordia Ch,2637,6,2,3,9,17,24,-7,9
FCSB,2638,1,7,6,1,24,12,12,27
CFR Cluj,2638,2,5,7,2,14,10,4,22
Universitate,2638,3,5,5,4,17,18,-1,20
D Bucuresti,2638,4,4,5,5,19,19,0,17
FC Botosani,2638,5,3,5,6,6,15,-9,14
Concordia Ch,2638,6,2,4,8,17,23,-6,10
FCSB,2639,1,9,5,0,28,12,16,32
CFR Cluj,2639,2,6,6,2,16,10,6,24
D Bucuresti,2639,3,3,6,5,17,19,-2,15
Universitate,2639,4,3,5,6,16,23,-7,14
FC Botosani,2639,5,3,5,6,7,15,-8,14
Concordia Ch,2639,6,3,3,8,17,22,-5,12
FCSB,2640,1,8,5,1,25,12,13,29
CFR Cluj,2640,2,7,6,1,17,9,8,27
FC Botosani,2640,3,4,5,5,7,13,-6,17
Universitate,2640,4,3,5,6,15,21,-6,14
D Bucuresti,2640,5,3,4,7,16,21,-5,13
Concordia Ch,2640,6,3,3,8,18,22,-4,12
FCSB,2641,1,9,5,0,27,12,15,32
CFR Cluj,2641,2,5,7,2,15,10,5,22
D Bucuresti,2641,3,5,4,5,20,19,1,19
Universitate,2641,4,3,6,5,16,21,-5,15
FC Botosani,2641,5,3,4,7,6,15,-9,13
Concordia Ch,2641,6,3,2,9,16,23,-7,11
FCSB,2642,1,8,5,1,26,13,13,29
CFR Cluj,2642,2,7,6,1,17,8,9,27
FC Botosani,2642,3,5,4,5,10,13,-3,19
Universitate,2642,4,3,5,6,14,21,-7,14
D Bucuresti,2642,5,3,4,7,17,22,-5,13
Concordia Ch,2642,6,3,2,9,18,25,-7,11
FCSB,2643,1,8,5,1,30,13,17,29
CFR Cluj,2643,2,5,7,2,13,12,1,22
Universitate,2643,3,4,6,4,17,20,-3,18
FC Botosani,2643,4,3,6,5,5,12,-7,15
D Bucuresti,2643,5,3,5,6,16,20,-4,14
Concordia Ch,2643,6,3,3,8,17,21,-4,12
FCSB,2644,1,7,7,0,23,10,13,28
CFR Cluj,2644,2,5,7,2,13,8,5,22
Universitate,2644,3,4,6,4,15,18,-3,18
D Bucuresti,2644,4,4,4,6,20,21,-1,16
Concordia Ch,2644,5,4,2,8,22,22,0,14
FC Botosani,2644,6,3,4,7,6,20,-14,13
FCSB,2645,1,7,6,1,23,11,12,27
CFR Cluj,2645,2,5,7,2,13,8,5,22
Universitate,2645,3,5,5,4,16,18,-2,20
D Bucuresti,2645,4,4,5,5,19,19,0,17
FC Botosani,2645,5,4,5,5,8,13,-5,17
Concordia Ch,2645,6,2,2,10,17,27,-10,8
FCSB,2646,1,9,5,0,27,11,16,32
CFR Cluj,2646,2,5,6,3,13,9,4,21
D Bucuresti,2646,3,4,5,5,19,19,0,17
Universitate,2646,4,4,5,5,16,21,-5,17
FC Botosani,2646,5,3,5,6,5,13,-8,14
Concordia Ch,2646,6,3,2,9,17,24,-7,11
FCSB,2647,1,7,6,1,25,13,12,27
CFR Cluj,2647,2,6,7,1,16,9,7,25
Universitate,2647,3,4,5,5,17,21,-4,17
FC Botosani,2647,4,4,5,5,8,13,-5,17
D Bucuresti,2647,5,3,4,7,17,23,-6,13
Concordia Ch,2647,6,3,3,8,19,23,-4,12
FCSB,2648,1,7,7,0,25,12,13,28
CFR Cluj,2648,2,6,7,1,16,7,9,25
D Bucuresti,2648,3,4,4,6,17,21,-4,16
Universitate,2648,4,3,6,5,16,23,-7,15
Concordia Ch,2648,5,4,2,8,20,21,-1,14
FC Botosani,2648,6,3,4,7,5,15,-10,13
FCSB,2649,1,8,6,0,25,11,14,30
CFR Cluj,2649,2,5,7,2,15,10,5,22
D Bucuresti,2649,3,5,4,5,22,20,2,19
Universitate,2649,4,4,5,5,18,22,-4,17
FC Botosani,2649,5,3,5,6,6,15,-9,14
Concordia Ch,2649,6,2,3,9,16,24,-8,9
FCSB,2650,1,7,5,2,23,13,10,26
CFR Cluj,2650,2,6,7,1,16,8,8,25
Universitate,2650,3,4,6,4,16,19,-3,18
D Bucuresti,2650,4,4,5,5,17,18,-1,17
FC Botosani,2650,5,4,4,6,6,13,-7,16
Concordia Ch,2650,6,2,3,9,15,22,-7,9
FCSB,2651,1,8,5,1,26,13,13,29
CFR Cluj,2651,2,5,6,3,15,11,4,21
Universitate,2651,3,5,5,4,20,22,-2,20
D Bucuresti,2651,4,5,4,5,18,18,0,19
FC Botosani,2651,5,3,4,7,5,15,-10,13
Concordia Ch,2651,6,3,2,9,17,22,-5,11
FCSB,2652,1,7,5,2,23,16,7,26
CFR Cluj,2652,2,6,6,2,16,9,7,24
Universitate,2652,3,5,5,4,20,19,1,20
FC Botosani,2652,4,5,4,5,8,13,-5,19
D Bucuresti,2652,5,4,4,6,19,19,0,16
Concordia Ch,2652,6,2,2,10,16,26,-10,8
FCSB,2653,1,9,5,0,27,10,17,32
CFR Cluj,2653,2,5,7,2,14,11,3,22
D Bucuresti,2653,3,4,4,6,20,22,-2,16
FC Botosani,2653,4,4,4,6,9,16,-7,16
Universitate,2653,5,3,6,5,15,20,-5,15
Concordia Ch,2653,6,3,2,9,20,26,-6,11
FCSB,2654,1,7,6,1,23,12,11,27
CFR Cluj,2654,2,6,7,1,15,7,8,25
Universitate,2654,3,4,5,5,16,20,-4,17
D Bucuresti,2654,4,4,4,6,19,22,-3,16
Concordia Ch,2654,5,4,2,8,20,22,-2,14
FC Botosani,2654,6,3,4,7,5,15,-10,13
FCSB,2655,1,9,5,0,27,11,16,32
CFR Cluj,2655,2,5,7,2,14,10,4,22
D Bucuresti,2655,3,4,4,6,19,19,0,16
Universitate,2655,4,3,6,5,16,21,-5,15
Concordia Ch,2655,5,4,2,8,17,21,-4,14
FC Botosani,2655,6,3,4,7,5,16,-11,13
CFR Cluj,2656,1,7,6,1,16,8,8,27
FCSB,2656,2,7,5,2,25,14,11,26
D Bucuresti,2656,3,5,4,5,20,19,1,19
Universitate,2656,4,4,5,5,16,20,-4,17
FC Botosani,2656,5,4,4,6,8,14,-6,16
Concordia Ch,2656,6,2,2,10,15,25,-10,8
FCSB,2657,1,9,5,0,26,11,15,32
CFR Cluj,2657,2,6,6,2,16,9,7,24
D Bucuresti,2657,3,4,4,6,19,19,0,16
FC Botosani,2657,4,4,4,6,6,15,-9,16
Universitate,2657,5,3,5,6,14,21,-7,14
Concordia Ch,2657,6,3,2,9,16,22,-6,11
FCSB,2658,1,7,7,0,23,10,13,28
CFR Cluj,2658,2,5,8,1,13,7,6,23
D Bucuresti,2658,3,4,5,5,21,18,3,17
Universitate,2658,4,3,7,4,14,18,-4,16
FC Botosani,2658,5,3,5,6,6,14,-8,14
Concordia Ch,2658,6,3,2,9,17,27,-10,11
FCSB,2659,1,8,6,0,25,11,14,30
CFR Cluj,2659,2,6,7,1,16,9,7,25
D Bucuresti,2659,3,4,4,6,20,24,-4,16
FC Botosani,2659,4,4,4,6,11,16,-5,16
Universitate,2659,5,3,5,6,15,21,-6,14
Concordia Ch,2659,6,3,2,9,18,24,-6,11
FCSB,2660,1,7,7,0,26,13,13,28
CFR Cluj,2660,2,6,7,1,16,8,8,25
D Bucuresti,2660,3,5,4,5,19,18,1,19
FC Botosani,2660,4,4,4,6,10,15,-5,16
Universitate,2660,5,3,6,5,18,24,-6,15
Concordia Ch,2660,6,2,2,10,16,27,-11,8
FCSB,2661,1,7,7,0,25,12,13,28
CFR Cluj,2661,2,6,7,1,16,8,8,25
FC Botosani,2661,3,4,5,5,8,13,-5,17
D Bucuresti,2661,4,3,6,5,16,18,-2,15
Universitate,2661,5,3,6,5,15,21,-6,15
Concordia Ch,2661,6,2,3,9,16,24,-8,9
FCSB,2662,1,7,5,2,25,18,7,26
CFR Cluj,2662,2,6,7,1,17,8,9,25
D Bucuresti,2662,3,5,4,5,19,19,0,19
Universitate,2662,4,4,6,4,18,19,-1,18
FC Botosani,2662,5,4,4,6,8,14,-6,16
Concordia Ch,2662,6,2,2,10,15,24,-9,8
FCSB,2663,1,7,5,2,24,17,7,26
CFR Cluj,2663,2,6,7,1,16,8,8,25
Universitate,2663,3,4,6,4,18,18,0,18
FC Botosani,2663,4,4,5,5,8,14,-6,17
D Bucuresti,2663,5,3,6,5,18,20,-2,15
Concordia Ch,2663,6,2,3,9,17,24,-7,9
FCSB,2664,1,8,5,1,27,12,15,29
CFR Cluj,2664,2,6,6,2,15,10,5,24
Universitate,2664,3,4,5,5,16,21,-5,17
FC Botosani,2664,4,3,6,5,9,16,-7,15
D Bucuresti,2664,5,3,5,6,19,22,-3,14
Concordia Ch,2664,6,3,3,8,19,24,-5,12
CFR Cluj,2665,1,7,6,1,17,8,9,27
FCSB,2665,2,7,5,2,23,14,9,26
Universitate,2665,3,4,5,5,17,20,-3,17
FC Botosani,2665,4,4,5,5,7,13,-6,17
D Bucuresti,2665,5,3,5,6,18,21,-3,14
Concordia Ch,2665,6,2,4,8,16,22,-6,10
FCSB,2666,1,8,5,1,29,12,17,29
CFR Cluj,2666,2,6,6,2,17,13,4,24
FC Botosani,2666,3,5,4,5,8,13,-5,19
Universitate,2666,4,4,5,5,17,23,-6,17
D Bucuresti,2666,5,3,4,7,17,22,-5,13
Concordia Ch,2666,6,3,2,9,19,24,-5,11
FCSB,2667,1,8,5,1,25,11,14,29
CFR Cluj,2667,2,5,6,3,13,10,3,21
Universitate,2667,3,5,5,4,16,18,-2,20
FC Botosani,2667,4,5,4,5,9,13,-4,19
D Bucuresti,2667,5,4,4,6,17,20,-3,16
Concordia Ch,2667,6,2,2,10,16,24,-8,8
FCSB,2668,1,8,5,1,25,11,14,29
CFR Cluj,2668,2,7,6,1,15,7,8,27
D Bucuresti,2668,3,4,4,6,19,20,-1,16
FC Botosani,2668,4,4,4,6,9,15,-6,16
Universitate,2668,5,3,5,6,14,21,-7,14
Concordia Ch,2668,6,3,2,9,18,26,-8,11
FCSB,2669,1,8,6,0,26,10,16,30
CFR Cluj,2669,2,5,7,2,15,10,5,22
Universitate,2669,3,4,5,5,17,23,-6,17
D Bucuresti,2669,4,4,4,6,17,20,-3,16
FC Botosani,2669,5,4,4,6,6,13,-7,16
Concordia Ch,2669,6,3,2,9,17,22,-5,11
FCSB,2670,1,7,7,0,24,11,13,28
CFR Cluj,2670,2,5,7,2,13,8,5,22
Universitate,2670,3,4,6,4,16,19,-3,18
FC Botosani,2670,4,3,6,5,7,14,-7,15
D Bucuresti,2670,5,3,5,6,18,21,-3,14
Concordia Ch,2670,6,3,3,8,18,23,-5,12
FCSB,2671,1,8,6,0,24,10,14,30
CFR Cluj,2671,2,5,6,3,13,9,4,21
FC Botosani,2671,3,5,4,5,8,12,-4,19
Universitate,2671,4,4,6,4,15,18,-3,18
D Bucuresti,2671,5,3,4,7,16,22,-6,13
Concordia Ch,2671,6,3,2,9,18,23,-5,11
FCSB,2672,1,7,6,1,24,12,12,27
CFR Cluj,2672,2,7,6,1,18,9,9,27
FC Botosani,2672,3,5,4,5,9,13,-4,19
Universitate,2672,4,3,6,5,15,21,-6,15
D Bucuresti,2672,5,3,5,6,18,21,-3,14
Concordia Ch,2672,6,2,3,9,18,26,-8,9
CFR Cluj,2673,1,7,6,1,17,8,9,27
FCSB,2673,2,7,5,2,24,13,11,26
D Bucuresti,2673,3,4,5,5,21,20,1,17
Universitate,2673,4,4,5,5,15,20,-5,17
FC Botosani,2673,5,4,4,6,7,15,-8,16
Concordia Ch,2673,6,2,3,9,17,25,-8,9
CFR Cluj,2674,1,7,6,1,16,7,9,27
FCSB,2674,2,7,5,2,25,16,9,26
Universitate,2674,3,4,5,5,18,21,-3,17
D Bucuresti,2674,4,4,4,6,20,23,-3,16
FC Botosani,2674,5,3,5,6,8,16,-8,14
Concordia Ch,2674,6,3,3,8,17,21,-4,12
FCSB,2675,1,9,5,0,32,12,20,32
CFR Cluj,2675,2,6,6,2,17,13,4,24
D Bucuresti,2675,3,4,4,6,19,23,-4,16
Universitate,2675,4,3,5,6,15,24,-9,14
FC Botosani,2675,5,3,5,6,7,16,-9,14
Concordia Ch,2675,6,3,3,8,20,22,-2,12
FCSB,2676,1,9,5,0,26,11,15,32
CFR Cluj,2676,2,5,6,3,13,9,4,21
Universitate,2676,3,4,5,5,16,20,-4,17
FC Botosani,2676,4,4,5,5,7,13,-6,17
D Bucuresti,2676,5,3,6,5,18,20,-2,15
Concordia Ch,2676,6,2,3,9,18,25,-7,9
FCSB,2677,1,8,5,1,26,12,14,29
CFR Cluj,2677,2,6,6,2,15,10,5,24
D Bucuresti,2677,3,4,5,5,18,19,-1,17
Universitate,2677,4,4,5,5,15,19,-4,17
FC Botosani,2677,5,4,5,5,7,13,-6,17
Concordia Ch,2677,6,2,2,10,15,23,-8,8
CFR Cluj,2678,1,7,6,1,17,8,9,27
FCSB,2678,2,7,5,2,23,14,9,26
D Bucuresti,2678,3,4,5,5,20,20,0,17
Universitate,2678,4,4,5,5,17,20,-3,17
FC Botosani,2678,5,4,5,5,8,14,-6,17
Concordia Ch,2678,6,2,2,10,15,24,-9,8
FCSB,2679,1,8,5,1,27,13,14,29
CFR Cluj,2679,2,7,6,1,16,8,8,27
FC Botosani,2679,3,4,5,5,6,12,-6,17
D Bucuresti,2679,4,3,6,5,18,20,-2,15
Universitate,2679,5,3,5,6,15,22,-7,14
Concordia Ch,2679,6,2,3,9,17,24,-7,9
FCSB,2680,1,8,6,0,26,12,14,30
CFR Cluj,2680,2,5,6,3,16,12,4,21
Universitate,2680,3,4,6,4,18,21,-3,18
FC Botosani,2680,4,4,5,5,8,13,-5,17
D Bucuresti,2680,5,3,5,6,17,21,-4,14
Concordia Ch,2680,6,3,2,9,19,25,-6,11
FCSB,2681,1,7,6,1,25,13,12,27
CFR Cluj,2681,2,6,7,1,16,9,7,25
D Bucuresti,2681,3,5,4,5,22,19,3,19
Universitate,2681,4,4,5,5,17,21,-4,17
FC Botosani,2681,5,4,4,6,8,16,-8,16
Concordia Ch,2681,6,2,2,10,17,27,-10,8
CFR Cluj,2682,1,7,6,1,17,7,10,27
FCSB,2682,2,7,5,2,24,13,11,26
FC Botosani,2682,3,4,5,5,9,14,-5,17
Universitate,2682,4,4,5,5,16,22,-6,17
D Bucuresti,2682,5,4,4,6,20,20,0,16
Concordia Ch,2682,6,2,3,9,17,27,-10,9
FCSB,2683,1,9,5,0,26,11,15,32
CFR Cluj,2683,2,6,6,2,14,8,6,24
D Bucuresti,2683,3,5,4,5,21,18,3,19
Universitate,2683,4,3,5,6,15,21,-6,14
FC Botosani,2683,5,3,4,7,5,16,-11,13
Concordia Ch,2683,6,3,2,9,17,24,-7,11
FCSB,2684,1,9,5,0,27,12,15,32
CFR Cluj,2684,2,5,6,3,15,12,3,21
Universitate,2684,3,4,5,5,18,21,-3,17
D Bucuresti,2684,4,4,4,6,18,20,-2,16
FC Botosani,2684,5,4,4,6,6,13,-7,16
Concordia Ch,2684,6,3,2,9,17,23,-6,11
FCSB,2685,1,8,5,1,25,12,13,29
CFR Cluj,2685,2,5,7,2,14,10,4,22
FC Botosani,2685,3,5,4,5,7,12,-5,19
Universitate,2685,4,4,6,4,17,19,-2,18
D Bucuresti,2685,5,3,4,7,16,21,-5,13
Concordia Ch,2685,6,3,2,9,17,22,-5,11
FCSB,2686,1,7,5,2,23,12,11,26
CFR Cluj,2686,2,6,6,2,14,9,5,24
Universitate,2686,3,5,5,4,17,18,-1,20
D Bucuresti,2686,4,4,4,6,18,20,-2,16
FC Botosani,2686,5,3,5,6,6,15,-9,14
Concordia Ch,2686,6,3,3,8,18,22,-4,12
FCSB,2687,1,7,6,1,25,13,12,27
CFR Cluj,2687,2,5,7,2,14,11,3,22
Universitate,2687,3,5,5,4,19,19,0,20
D Bucuresti,2687,4,3,6,5,18,20,-2,15
FC Botosani,2687,5,3,6,5,8,15,-7,15
Concordia Ch,2687,6,2,4,8,18,24,-6,10
FCSB,2688,1,7,7,0,24,11,13,28
CFR Cluj,2688,2,5,7,2,13,8,5,22
Universitate,2688,3,4,6,4,16,19,-3,18
D Bucuresti,2688,4,4,5,5,20,19,1,17
FC Botosani,2688,5,4,5,5,8,13,-5,17
Concordia Ch,2688,6,2,2,10,15,26,-11,8
FCSB,2689,1,8,6,0,24,10,14,30
CFR Cluj,2689,2,6,6,2,16,8,8,24
FC Botosani,2689,3,4,5,5,7,13,-6,17
D Bucuresti,2689,4,3,6,5,17,19,-2,15
Universitate,2689,5,3,6,5,14,21,-7,15
Concordia Ch,2689,6,2,3,9,17,24,-7,9
FCSB,2690,1,8,5,1,26,13,13,29
CFR Cluj,2690,2,7,6,1,19,7,12,27
D Bucuresti,2690,3,4,4,6,17,19,-2,16
FC Botosani,2690,4,3,5,6,7,15,-8,14
Universitate,2690,5,3,5,6,14,24,-10,14
Concordia Ch,2690,6,3,3,8,18,23,-5,12
FCSB,2691,1,8,5,1,26,15,11,29
CFR Cluj,2691,2,5,7,2,14,10,4,22
Universitate,2691,3,4,6,4,18,18,0,18
D Bucuresti,2691,4,4,4,6,18,20,-2,16
FC Botosani,2691,5,4,4,6,8,15,-7,16
Concordia Ch,2691,6,3,2,9,17,23,-6,11
FCSB,2692,1,8,5,1,25,12,13,29
CFR Cluj,2692,2,5,7,2,13,8,5,22
Universitate,2692,3,4,6,4,16,19,-3,18
D Bucuresti,2692,4,3,6,5,19,21,-2,15
FC Botosani,2692,5,3,6,5,7,14,-7,15
Concordia Ch,2692,6,2,4,8,18,24,-6,10
FCSB,2693,1,7,6,1,26,14,12,27
CFR Cluj,2693,2,6,7,1,15,8,7,25
Universitate,2693,3,4,5,5,17,21,-4,17
D Bucuresti,2693,4,4,4,6,20,21,-1,16
FC Botosani,2693,5,4,4,6,8,15,-7,16
Concordia Ch,2693,6,3,2,9,18,25,-7,11
FCSB,2694,1,9,5,0,26,10,16,32
CFR Cluj,2694,2,5,6,3,13,9,4,21
FC Botosani,2694,3,5,4,5,7,12,-5,19
Universitate,2694,4,4,5,5,15,20,-5,17
D Bucuresti,2694,5,3,4,7,16,23,-7,13
Concordia Ch,2694,6,3,2,9,19,22,-3,11
FCSB,2695,1,8,5,1,26,12,14,29
CFR Cluj,2695,2,6,6,2,15,9,6,24
D Bucuresti,2695,3,4,5,5,21,20,1,17
Universitate,2695,4,4,5,5,15,20,-5,17
FC Botosani,2695,5,3,4,7,6,17,-11,13
Concordia Ch,2695,6,3,3,8,19,24,-5,12
CFR Cluj,2696,1,7,6,1,16,7,9,27
FCSB,2696,2,7,5,2,26,17,9,26
Universitate,2696,3,4,5,5,19,22,-3,17
D Bucuresti,2696,4,4,4,6,19,25,-6,16
FC Botosani,2696,5,3,5,6,8,16,-8,14
Concordia Ch,2696,6,3,3,8,21,22,-1,12
FCSB,2697,1,7,6,1,24,12,12,27
CFR Cluj,2697,2,6,7,1,14,7,7,25
D Bucuresti,2697,3,5,4,5,19,19,0,19
Universitate,2697,4,3,7,4,15,19,-4,16
FC Botosani,2697,5,3,5,6,6,14,-8,14
Concordia Ch,2697,6,2,3,9,15,22,-7,9
FCSB,2698,1,8,6,0,26,11,15,30
CFR Cluj,2698,2,6,6,2,17,9,8,24
D Bucuresti,2698,3,5,4,5,19,18,1,19
FC Botosani,2698,4,4,4,6,7,13,-6,16
Universitate,2698,5,3,6,5,15,23,-8,15
Concordia Ch,2698,6,2,2,10,15,25,-10,8
FCSB,2699,1,8,5,1,25,14,11,29
CFR Cluj,2699,2,5,6,3,14,12,2,21
Universitate,2699,3,5,5,4,22,20,2,20
Concordia Ch,2699,4,4,2,8,19,21,-2,14
D Bucuresti,2699,5,3,5,6,17,22,-5,14
FC Botosani,2699,6,3,5,6,6,14,-8,14
FCSB,2700,1,7,6,1,23,12,11,27
CFR Cluj,2700,2,6,7,1,14,7,7,25
D Bucuresti,2700,3,4,5,5,17,18,-1,17
Universitate,2700,4,4,5,5,16,19,-3,17
FC Botosani,2700,5,4,5,5,7,13,-6,17
Concordia Ch,2700,6,2,2,10,16,24,-8,8
FCSB,2701,1,7,6,1,24,13,11,27
CFR Cluj,2701,2,7,6,1,17,7,10,27
D Bucuresti,2701,3,4,4,6,20,21,-1,16
Universitate,2701,4,3,6,5,15,21,-6,15
Concordia Ch,2701,5,4,2,8,20,23,-3,14
FC Botosani,2701,6,3,4,7,6,17,-11,13
FCSB,2702,1,8,5,1,28,14,14,29
CFR Cluj,2702,2,6,7,1,16,9,7,25
Universitate,2702,3,3,6,5,19,25,-6,15
Concordia Ch,2702,4,4,2,8,19,22,-3,14
D Bucuresti,2702,5,3,5,6,17,20,-3,14
FC Botosani,2702,6,3,5,6,7,16,-9,14
FCSB,2703,1,8,6,0,29,12,17,30
CFR Cluj,2703,2,6,6,2,17,14,3,24
D Bucuresti,2703,3,5,4,5,20,20,0,19
Universitate,2703,4,3,6,5,19,24,-5,15
FC Botosani,2703,5,3,5,6,6,14,-8,14
Concordia Ch,2703,6,2,3,9,18,25,-7,9
FCSB,2704,1,8,5,1,27,13,14,29
CFR Cluj,2704,2,5,6,3,14,11,3,21
Universitate,2704,3,5,5,4,17,19,-2,20
D Bucuresti,2704,4,4,5,5,18,19,-1,17
FC Botosani,2704,5,4,4,6,7,14,-7,16
Concordia Ch,2704,6,2,3,9,15,22,-7,9
FCSB,2705,1,8,5,1,26,13,13,29
CFR Cluj,2705,2,5,6,3,15,13,2,21
Universitate,2705,3,5,5,4,19,19,0,20
FC Botosani,2705,4,4,4,6,7,13,-6,16
Concordia Ch,2705,5,4,2,8,19,21,-2,14
D Bucuresti,2705,6,3,4,7,16,23,-7,13
FCSB,2706,1,7,7,0,25,12,13,28
CFR Cluj,2706,2,6,7,1,17,8,9,25
FC Botosani,2706,3,4,5,5,7,12,-5,17
Universitate,2706,4,3,6,5,15,22,-7,15
D Bucuresti,2706,5,3,4,7,16,25,-9,13
Concordia Ch,2706,6,3,3,8,20,21,-1,12
FCSB,2707,1,9,5,0,27,11,16,32
CFR Cluj,2707,2,6,6,2,16,10,6,24
D Bucuresti,2707,3,3,5,6,19,22,-3,14
Concordia Ch,2707,4,4,2,8,17,21,-4,14
Universitate,2707,5,3,5,6,14,21,-7,14
FC Botosani,2707,6,3,5,6,8,16,-8,14
FCSB,2708,1,7,6,1,26,14,12,27
CFR Cluj,2708,2,6,7,1,16,8,8,25
Universitate,2708,3,4,5,5,17,22,-5,17
D Bucuresti,2708,4,4,4,6,19,21,-2,16
Concordia Ch,2708,5,4,2,8,19,22,-3,14
FC Botosani,2708,6,3,4,7,7,17,-10,13
FCSB,2709,1,7,6,1,24,12,12,27
CFR Cluj,2709,2,6,7,1,14,7,7,25
FC Botosani,2709,3,5,4,5,8,12,-4,19
D Bucuresti,2709,4,4,4,6,20,22,-2,16
Universitate,2709,5,3,7,4,15,19,-4,16
Concordia Ch,2709,6,2,2,10,18,27,-9,8
FCSB,2710,1,7,7,0,24,11,13,28
CFR Cluj,2710,2,5,7,2,16,11,5,22
Universitate,2710,3,4,6,4,17,20,-3,18
D Bucuresti,2710,4,4,4,6,20,22,-2,16
FC Botosani,2710,5,4,4,6,9,15,-6,16
Concordia Ch,2710,6,3,2,9,18,25,-7,11
FCSB,2711,1,8,6,0,27,13,14,30
CFR Cluj,2711,2,5,8,1,18,12,6,23
FC Botosani,2711,3,4,4,6,9,16,-7,16
Universitate,2711,4,3,6,5,18,23,-5,15
D Bucuresti,2711,5,3,5,6,18,21,-3,14
Concordia Ch,2711,6,3,3,8,17,22,-5,12
FCSB,2712,1,7,6,1,24,12,12,27
CFR Cluj,2712,2,7,6,1,16,8,8,27
D Bucuresti,2712,3,3,6,5,18,20,-2,15
Universitate,2712,4,3,6,5,16,21,-5,15
FC Botosani,2712,5,3,5,6,6,15,-9,14
Concordia Ch,2712,6,3,3,8,18,22,-4,12
FCSB,2713,1,8,5,1,24,12,12,29
CFR Cluj,2713,2,5,6,3,13,9,4,21
Universitate,2713,3,5,5,4,17,18,-1,20
FC Botosani,2713,4,4,5,5,8,14,-6,17
D Bucuresti,2713,5,3,5,6,17,20,-3,14
Concordia Ch,2713,6,3,2,9,19,25,-6,11
FCSB,2714,1,9,5,0,26,10,16,32
CFR Cluj,2714,2,5,6,3,13,9,4,21
Universitate,2714,3,4,5,5,15,20,-5,17
FC Botosani,2714,4,4,5,5,8,13,-5,17
D Bucuresti,2714,5,3,4,7,17,23,-6,13
Concordia Ch,2714,6,3,3,8,19,23,-4,12
FCSB,2715,1,8,6,0,27,13,14,30
CFR Cluj,2715,2,5,7,2,17,12,5,22
FC Botosani,2715,3,4,5,5,8,13,-5,17
Universitate,2715,4,3,7,4,17,21,-4,16
D Bucuresti,2715,5,3,4,7,18,23,-5,13
Concordia Ch,2715,6,3,3,8,17,22,-5,12
FCSB,2716,1,7,5,2,24,13,11,26
CFR Cluj,2716,2,6,6,2,14,11,3,24
Universitate,2716,3,5,5,4,20,19,1,20
D Bucuresti,2716,4,3,5,6,16,19,-3,14
Concordia Ch,2716,5,4,2,8,18,22,-4,14
FC Botosani,2716,6,3,5,6,6,14,-8,14
FCSB,2717,1,8,6,0,25,11,14,30
CFR Cluj,2717,2,5,8,1,14,8,6,23
D Bucuresti,2717,3,5,4,5,19,18,1,19
Universitate,2717,4,3,6,5,16,21,-5,15
FC Botosani,2717,5,3,4,7,5,15,-10,13
Concordia Ch,2717,6,3,2,9,16,22,-6,11
FCSB,2718,1,8,5,1,27,13,14,29
CFR Cluj,2718,2,5,7,2,15,12,3,22
Universitate,2718,3,4,6,4,17,19,-2,18
D Bucuresti,2718,4,4,4,6,19,23,-4,16
Concordia Ch,2718,5,4,2,8,20,21,-1,14
FC Botosani,2718,6,3,4,7,7,17,-10,13
FCSB,2719,1,8,5,1,27,14,13,29
CFR Cluj,2719,2,5,6,3,14,10,4,21
Universitate,2719,3,5,5,4,18,20,-2,20
D Bucuresti,2719,4,4,4,6,18,21,-3,16
Concordia Ch,2719,5,4,2,8,18,21,-3,14
FC Botosani,2719,6,3,4,7,6,15,-9,13
FCSB,2720,1,8,5,1,25,12,13,29
CFR Cluj,2720,2,6,7,1,14,7,7,25
FC Botosani,2720,3,4,5,5,7,13,-6,17
Universitate,2720,4,3,6,5,15,20,-5,15
D Bucuresti,2720,5,3,4,7,17,21,-4,13
Concordia Ch,2720,6,3,3,8,18,23,-5,12
FCSB,2721,1,7,6,1,24,12,12,27
CFR Cluj,2721,2,7,6,1,15,7,8,27
Universitate,2721,3,3,6,5,15,20,-5,15
FC Botosani,2721,4,3,6,5,5,12,-7,15
D Bucuresti,2721,5,3,5,6,16,19,-3,14
Concordia Ch,2721,6,3,3,8,16,21,-5,12
FCSB,2722,1,8,6,0,24,10,14,30
CFR Cluj,2722,2,6,6,2,15,8,7,24
D Bucuresti,2722,3,4,5,5,17,18,-1,17
Universitate,2722,4,3,6,5,14,20,-6,15
FC Botosani,2722,5,3,5,6,6,14,-8,14
Concordia Ch,2722,6,2,4,8,16,22,-6,10
FCSB,2723,1,8,6,0,24,10,14,30
CFR Cluj,2723,2,5,7,2,14,9,5,22
D Bucuresti,2723,3,5,4,5,19,18,1,19
Universitate,2723,4,3,7,4,15,19,-4,16
FC Botosani,2723,5,3,5,6,5,13,-8,14
Concordia Ch,2723,6,2,3,9,15,23,-8,9
FCSB,2724,1,9,5,0,28,11,17,32
CFR Cluj,2724,2,5,7,2,13,9,4,22
Universitate,2724,3,3,6,5,15,21,-6,15
D Bucuresti,2724,4,3,5,6,17,20,-3,14
Concordia Ch,2724,5,4,2,8,19,23,-4,14
FC Botosani,2724,6,3,5,6,6,14,-8,14
FCSB,2725,1,8,6,0,27,13,14,30
CFR Cluj,2725,2,6,7,1,18,10,8,25
D Bucuresti,2725,3,5,4,5,19,19,0,19
FC Botosani,2725,4,4,4,6,10,14,-4,16
Universitate,2725,5,3,5,6,14,21,-7,14
Concordia Ch,2725,6,2,2,10,15,26,-11,8
FCSB,2726,1,8,6,0,24,10,14,30
CFR Cluj,2726,2,6,6,2,14,8,6,24
D Bucuresti,2726,3,5,4,5,20,19,1,19
Universitate,2726,4,3,6,5,14,19,-5,15
FC Botosani,2726,5,3,4,7,7,17,-10,13
Concordia Ch,2726,6,3,2,9,19,25,-6,11
FCSB,2727,1,8,6,0,26,12,14,30
CFR Cluj,2727,2,6,6,2,14,8,6,24
D Bucuresti,2727,3,4,5,5,21,19,2,17
Universitate,2727,4,3,6,5,16,21,-5,15
FC Botosani,2727,5,3,5,6,7,18,-11,14
Concordia Ch,2727,6,2,4,8,16,22,-6,10
FCSB,2728,1,7,6,1,26,14,12,27
CFR Cluj,2728,2,6,7,1,16,9,7,25
D Bucuresti,2728,3,4,5,5,18,19,-1,17
Universitate,2728,4,3,7,4,15,19,-4,16
FC Botosani,2728,5,3,5,6,6,16,-10,14
Concordia Ch,2728,6,3,2,9,18,22,-4,11
FCSB,2729,1,7,7,0,25,12,13,28
CFR Cluj,2729,2,5,8,1,16,10,6,23
D Bucuresti,2729,3,5,4,5,19,18,1,19
Universitate,2729,4,3,7,4,17,21,-4,16
FC Botosani,2729,5,4,4,6,6,13,-7,16
Concordia Ch,2729,6,2,2,10,15,24,-9,8
FCSB,2730,1,8,5,1,24,12,12,29
CFR Cluj,2730,2,7,6,1,16,7,9,27
D Bucuresti,2730,3,4,5,5,20,20,0,17
Universitate,2730,4,3,5,6,14,20,-6,14
FC Botosani,2730,5,3,5,6,5,14,-9,14
Concordia Ch,2730,6,2,4,8,17,23,-6,10
FCSB,2731,1,9,5,0,28,12,16,32
CFR Cluj,2731,2,6,6,2,16,10,6,24
FC Botosani,2731,3,4,4,6,8,15,-7,16
Concordia Ch,2731,4,4,2,8,18,21,-3,14
Universitate,2731,5,3,5,6,15,22,-7,14
D Bucuresti,2731,6,3,4,7,18,23,-5,13
FCSB,2732,1,7,6,1,24,12,12,27
CFR Cluj,2732,2,6,6,2,17,13,4,24
D Bucuresti,2732,3,5,4,5,21,18,3,19
Universitate,2732,4,4,6,4,19,20,-1,18
FC Botosani,2732,5,3,5,6,5,14,-9,14
Concordia Ch,2732,6,2,3,9,15,24,-9,9
FCSB,2733,1,8,5,1,24,12,12,29
CFR Cluj,2733,2,7,6,1,18,7,11,27
FC Botosani,2733,3,5,4,5,7,12,-5,19
D Bucuresti,2733,4,4,4,6,18,19,-1,16
Universitate,2733,5,3,5,6,14,22,-8,14
Concordia Ch,2733,6,2,2,10,15,24,-9,8
FCSB,2734,1,8,5,1,24,12,12,29
CFR Cluj,2734,2,6,6,2,15,8,7,24
Universitate,2734,3,4,5,5,15,19,-4,17
FC Botosani,2734,4,4,5,5,8,13,-5,17
D Bucuresti,2734,5,4,4,6,18,20,-2,16
Concordia Ch,2734,6,2,3,9,16,24,-8,9
FCSB,2735,1,8,5,1,26,11,15,29
CFR Cluj,2735,2,5,6,3,14,12,2,21
Universitate,2735,3,5,5,4,17,19,-2,20
FC Botosani,2735,4,5,4,5,9,12,-3,19
D Bucuresti,2735,5,3,5,6,16,19,-3,14
Concordia Ch,2735,6,2,3,9,15,24,-9,9
FCSB,2736,1,7,7,0,25,12,13,28
CFR Cluj,2736,2,5,8,1,16,10,6,23
D Bucuresti,2736,3,5,4,5,19,19,0,19
Universitate,2736,4,3,7,4,17,21,-4,16
FC Botosani,2736,5,4,4,6,6,13,-7,16
Concordia Ch,2736,6,2,2,10,16,24,-8,8
FCSB,2737,1,8,6,0,24,10,14,30
CFR Cluj,2737,2,5,6,3,14,11,3,21
Universitate,2737,3,4,6,4,17,19,-2,18
D Bucuresti,2737,4,4,5,5,19,20,-1,17
FC Botosani,2737,5,4,5,5,9,15,-6,17
Concordia Ch,2737,6,2,2,10,16,24,-8,8
FCSB,2738,1,8,5,1,25,12,13,29
CFR Cluj,2738,2,5,6,3,14,12,2,21
Universitate,2738,3,5,5,4,18,18,0,20
FC Botosani,2738,4,4,5,5,8,13,-5,17
D Bucuresti,2738,5,4,4,6,17,20,-3,16
Concordia Ch,2738,6,2,3,9,16,23,-7,9
FCSB,2739,1,8,6,0,26,11,15,30
CFR Cluj,2739,2,5,7,2,14,10,4,22
FC Botosani,2739,3,4,5,5,6,12,-6,17
Universitate,2739,4,3,7,4,14,18,-4,16
D Bucuresti,2739,5,3,5,6,16,19,-3,14
Concordia Ch,2739,6,2,4,8,15,21,-6,10
FCSB,2740,1,8,5,1,26,12,14,29
CFR Cluj,2740,2,6,6,2,15,10,5,24
Universitate,2740,3,4,5,5,16,20,-4,17
FC Botosani,2740,4,4,5,5,9,13,-4,17
D Bucuresti,2740,5,3,5,6,17,21,-4,14
Concordia Ch,2740,6,3,2,9,17,24,-7,11
FCSB,2741,1,8,5,1,27,14,13,29
CFR Cluj,2741,2,5,7,2,14,10,4,22
Universitate,2741,3,4,6,4,17,19,-2,18
FC Botosani,2741,4,4,5,5,6,12,-6,17
D Bucuresti,2741,5,3,5,6,16,20,-4,14
Concordia Ch,2741,6,3,2,9,17,22,-5,11
FCSB,2742,1,8,5,1,26,13,13,29
CFR Cluj,2742,2,6,6,2,16,10,6,24
Universitate,2742,3,4,5,5,16,20,-4,17
D Bucuresti,2742,4,4,4,6,17,19,-2,16
Concordia Ch,2742,5,4,2,8,18,21,-3,14
FC Botosani,2742,6,3,4,7,5,15,-10,13
FCSB,2743,1,7,5,2,24,15,9,26
CFR Cluj,2743,2,6,6,2,17,10,7,24
Universitate,2743,3,5,5,4,17,18,-1,20
D Bucuresti,2743,4,5,4,5,20,20,0,19
FC Botosani,2743,5,3,5,6,7,15,-8,14
Concordia Ch,2743,6,2,3,9,17,24,-7,9
FCSB,2744,1,7,7,0,26,13,13,28
CFR Cluj,2744,2,5,8,1,14,8,6,23
D Bucuresti,2744,3,4,4,6,19,21,-2,16
Universitate,2744,4,3,7,4,16,20,-4,16
FC Botosani,2744,5,4,4,6,7,16,-9,16
Concordia Ch,2744,6,3,2,9,19,23,-4,11
FCSB,2745,1,8,5,1,25,12,13,29
CFR Cluj,2745,2,5,6,3,13,10,3,21
Universitate,2745,3,5,5,4,17,18,-1,20
D Bucuresti,2745,4,4,4,6,18,19,-1,16
FC Botosani,2745,5,4,4,6,6,14,-8,16
Concordia Ch,2745,6,3,2,9,16,22,-6,11
FCSB,2746,1,8,6,0,26,11,15,30
CFR Cluj,2746,2,5,7,2,14,10,4,22
FC Botosani,2746,3,4,5,5,9,15,-6,17
Universitate,2746,4,3,7,4,16,20,-4,16
D Bucuresti,2746,5,3,5,6,17,20,-3,14
Concordia Ch,2746,6,3,2,9,18,24,-6,11
FCSB,2747,1,7,6,1,24,12,12,27
CFR Cluj,2747,2,5,7,2,13,8,5,22
Universitate,2747,3,5,5,4,17,19,-2,20
D Bucuresti,2747,4,4,5,5,19,20,-1,17
FC Botosani,2747,5,4,4,6,8,14,-6,16
Concordia Ch,2747,6,2,3,9,18,26,-8,9
FCSB,2748,1,8,5,1,26,13,13,29
CFR Cluj,2748,2,7,6,1,17,7,10,27
FC Botosani,2748,3,5,4,5,8,13,-5,19
Universitate,2748,4,3,5,6,15,23,-8,14
D Bucuresti,2748,5,3,4,7,16,20,-4,13
Concordia Ch,2748,6,3,2,9,17,23,-6,11
FCSB,2749,1,8,6,0,29,11,18,30
CFR Cluj,2749,2,6,6,2,15,12,3,24
D Bucuresti,2749,3,5,4,5,21,19,2,19
FC Botosani,2749,4,4,4,6,7,15,-8,16
Universitate,2749,5,3,6,5,15,21,-6,15
Concordia Ch,2749,6,2,2,10,17,26,-9,8
FCSB,2750,1,8,5,1,27,13,14,29
CFR Cluj,2750,2,6,6,2,18,13,5,24
Universitate,2750,3,4,5,5,18,22,-4,17
D Bucuresti,2750,4,3,6,5,17,19,-2,15
FC Botosani,2750,5,3,5,6,6,14,-8,14
Concordia Ch,2750,6,3,3,8,18,23,-5,12
FCSB,2751,1,7,6,1,25,13,12,27
CFR Cluj,2751,2,6,7,1,15,8,7,25
D Bucuresti,2751,3,4,5,5,19,18,1,17
Universitate,2751,4,3,7,4,15,19,-4,16
FC Botosani,2751,5,3,6,5,8,15,-7,15
Concordia Ch,2751,6,2,3,9,18,27,-9,9
FCSB,2752,1,9,5,0,25,10,15,32
CFR Cluj,2752,2,5,6,3,13,9,4,21
D Bucuresti,2752,3,4,5,5,18,19,-1,17
Universitate,2752,4,4,5,5,15,19,-4,17
FC Botosani,2752,5,4,5,5,6,12,-6,17
Concordia Ch,2752,6,2,2,10,16,24,-8,8
CFR Cluj,2753,1,7,6,1,16,8,8,27
FCSB,2753,2,7,5,2,25,14,11,26
D Bucuresti,2753,3,4,5,5,18,18,0,17
Universitate,2753,4,4,5,5,18,22,-4,17
FC Botosani,2753,5,4,4,6,8,14,-6,16
Concordia Ch,2753,6,2,3,9,15,24,-9,9
FCSB,2754,1,9,5,0,28,11,17,32
CFR Cluj,2754,2,5,7,2,15,11,4,22
D Bucuresti,2754,3,4,4,6,17,21,-4,16
Universitate,2754,4,3,6,5,15,21,-6,15
Concordia Ch,2754,5,4,2,8,20,22,-2,14
FC Botosani,2754,6,3,4,7,6,15,-9,13
FCSB,2755,1,8,5,1,27,14,13,29
CFR Cluj,2755,2,6,7,1,19,11,8,25
D Bucuresti,2755,3,4,5,5,18,19,-1,17
Universitate,2755,4,3,6,5,18,24,-6,15
FC Botosani,2755,5,3,5,6,5,13,-8,14
Concordia Ch,2755,6,2,4,8,16,22,-6,10
FCSB,2756,1,9,5,0,28,12,16,32
CFR Cluj,2756,2,6,6,2,16,10,6,24
D Bucuresti,2756,3,4,5,5,19,19,0,17
Universitate,2756,4,3,5,6,16,23,-7,14
FC Botosani,2756,5,3,4,7,5,16,-11,13
Concordia Ch,2756,6,3,3,8,18,22,-4,12
FCSB,2757,1,8,5,1,26,14,12,29
CFR Cluj,2757,2,7,6,1,17,8,9,27
FC Botosani,2757,3,4,5,5,8,14,-6,17
D Bucuresti,2757,4,3,6,5,19,21,-2,15
Universitate,2757,5,3,5,6,15,21,-6,14
Concordia Ch,2757,6,2,3,9,16,23,-7,9
FCSB,2758,1,9,5,0,26,11,15,32
CFR Cluj,2758,2,6,6,2,16,8,8,24
D Bucuresti,2758,3,3,6,5,17,19,-2,15
FC Botosani,2758,4,3,6,5,8,15,-7,15
Universitate,2758,5,3,5,6,15,23,-8,14
Concordia Ch,2758,6,2,4,8,17,23,-6,10
FCSB,2759,1,9,5,0,25,10,15,32
CFR Cluj,2759,2,5,6,3,13,9,4,21
D Bucuresti,2759,3,4,5,5,21,19,2,17
Universitate,2759,4,4,5,5,15,19,-4,17
FC Botosani,2759,5,4,4,6,8,17,-9,16
Concordia Ch,2759,6,2,3,9,17,25,-8,9
FCSB,2760,1,9,5,0,29,10,19,32
CFR Cluj,2760,2,6,6,2,15,11,4,24
FC Botosani,2760,3,4,5,5,9,14,-5,17
D Bucuresti,2760,4,3,5,6,17,20,-3,14
Universitate,2760,5,3,5,6,14,22,-8,14
Concordia Ch,2760,6,3,2,9,17,24,-7,11
FCSB,2761,1,8,5,1,25,13,12,29
CFR Cluj,2761,2,6,6,2,15,8,7,24
Universitate,2761,3,4,5,5,16,20,-4,17
D Bucuresti,2761,4,4,4,6,18,21,-3,16
Concordia Ch,2761,5,4,2,8,18,21,-3,14
FC Botosani,2761,6,3,4,7,6,15,-9,13
FCSB,2762,1,9,5,0,27,10,17,32
CFR Cluj,2762,2,5,6,3,13,12,1,21
Universitate,2762,3,4,5,5,16,19,-3,17
D Bucuresti,2762,4,4,4,6,18,20,-2,16
FC Botosani,2762,5,3,5,6,6,14,-8,14
Concordia Ch,2762,6,3,3,8,16,21,-5,12
FCSB,2763,1,9,5,0,28,11,17,32
CFR Cluj,2763,2,5,7,2,17,14,3,22
D Bucuresti,2763,3,4,5,5,19,20,-1,17
Universitate,2763,4,3,6,5,17,22,-5,15
FC Botosani,2763,5,3,6,5,8,15,-7,15
Concordia Ch,2763,6,2,3,9,18,25,-7,9
FCSB,2764,1,9,5,0,29,11,18,32
CFR Cluj,2764,2,5,6,3,13,9,4,21
D Bucuresti,2764,3,4,5,5,19,19,0,17
FC Botosani,2764,4,4,5,5,9,14,-5,17
Universitate,2764,5,4,5,5,16,23,-7,17
Concordia Ch,2764,6,2,2,10,18,28,-10,8
FCSB,2765,1,7,6,1,23,13,10,27
CFR Cluj,2765,2,5,8,1,15,9,6,23
Universitate,2765,3,4,6,4,19,20,-1,18
D Bucuresti,2765,4,4,4,6,19,20,-1,16
FC Botosani,2765,5,3,5,6,6,16,-10,14
Concordia Ch,2765,6,3,3,8,18,22,-4,12
FCSB,2766,1,7,6,1,25,13,12,27
CFR Cluj,2766,2,6,7,1,15,8,7,25
Universitate,2766,3,4,5,5,16,20,-4,17
D Bucuresti,2766,4,4,4,6,18,20,-2,16
Concordia Ch,2766,5,4,2,8,18,22,-4,14
FC Botosani,2766,6,3,4,7,7,16,-9,13
FCSB,2767,1,8,6,0,27,12,15,30
CFR Cluj,2767,2,5,6,3,14,12,2,21
Universitate,2767,3,4,6,4,17,19,-2,18
FC Botosani,2767,4,4,5,5,8,14,-6,17
D Bucuresti,2767,5,3,4,7,18,22,-4,13
Concordia Ch,2767,6,3,3,8,18,23,-5,12
FCSB,2768,1,9,5,0,26,11,15,32
CFR Cluj,2768,2,6,6,2,16,10,6,24
FC Botosani,2768,3,4,4,6,9,15,-6,16
Concordia Ch,2768,4,4,2,8,19,22,-3,14
Universitate,2768,5,3,5,6,15,21,-6,14
D Bucuresti,2768,6,3,4,7,17,23,-6,13
FCSB,2769,1,7,5,2,23,15,8,26
CFR Cluj,2769,2,6,7,1,15,8,7,25
Universitate,2769,3,4,6,4,19,19,0,18
D Bucuresti,2769,4,4,4,6,18,20,-2,16
FC Botosani,2769,5,3,5,6,6,14,-8,14
Concordia Ch,2769,6,3,3,8,18,23,-5,12
FCSB,2770,1,8,6,0,26,11,15,30
CFR Cluj,2770,2,6,6,2,16,10,6,24
D Bucuresti,2770,3,4,4,6,20,21,-1,16
Universitate,2770,4,3,6,5,14,20,-6,15
FC Botosani,2770,5,3,5,6,6,16,-10,14
Concordia Ch,2770,6,3,3,8,17,21,-4,12
FCSB,2771,1,9,5,0,28,13,15,32
CFR Cluj,2771,2,6,6,2,18,10,8,24
D Bucuresti,2771,3,4,5,5,21,20,1,17
FC Botosani,2771,4,4,5,5,10,15,-5,17
Universitate,2771,5,3,5,6,15,23,-8,14
Concordia Ch,2771,6,2,2,10,18,29,-11,8
FCSB,2772,1,8,6,0,27,12,15,30
CFR Cluj,2772,2,5,7,2,15,11,4,22
D Bucuresti,2772,3,4,4,6,18,20,-2,16
Universitate,2772,4,3,7,4,16,20,-4,16
FC Botosani,2772,5,3,5,6,7,15,-8,14
Concordia Ch,2772,6,3,3,8,19,24,-5,12
FCSB,2773,1,9,5,0,30,11,19,32
CFR Cluj,2773,2,6,6,2,16,10,6,24
FC Botosani,2773,3,4,4,6,8,15,-7,16
Concordia Ch,2773,4,4,2,8,19,23,-4,14
Universitate,2773,5,3,5,6,15,25,-10,14
D Bucuresti,2773,6,3,4,7,16,20,-4,13
FCSB,2774,1,9,5,0,26,10,16,32
CFR Cluj,2774,2,6,6,2,15,9,6,24
D Bucuresti,2774,3,4,5,5,18,19,-1,17
Universitate,2774,4,3,5,6,15,22,-7,14
FC Botosani,2774,5,3,4,7,5,15,-10,13
Concordia Ch,2774,6,3,3,8,18,22,-4,12
FCSB,2775,1,8,5,1,25,12,13,29
CFR Cluj,2775,2,6,6,2,15,9,6,24
D Bucuresti,2775,3,4,5,5,19,18,1,17
Universitate,2775,4,4,5,5,17,21,-4,17
FC Botosani,2775,5,3,5,6,5,15,-10,14
Concordia Ch,2775,6,2,4,8,15,21,-6,10
FCSB,2776,1,8,5,1,24,15,9,29
CFR Cluj,2776,2,5,6,3,14,10,4,21
Universitate,2776,3,5,5,4,21,19,2,20
FC Botosani,2776,4,4,4,6,6,13,-7,16
Concordia Ch,2776,5,4,2,8,19,21,-2,14
D Bucuresti,2776,6,3,4,7,16,22,-6,13
FCSB,2777,1,7,7,0,24,11,13,28
CFR Cluj,2777,2,5,7,2,14,9,5,22
FC Botosani,2777,3,5,4,5,7,12,-5,19
Universitate,2777,4,4,6,4,15,18,-3,18
D Bucuresti,2777,5,3,4,7,16,22,-6,13
Concordia Ch,2777,6,3,2,9,18,22,-4,11
CFR Cluj,2778,1,7,6,1,17,7,10,27
FCSB,2778,2,7,5,2,23,15,8,26
Universitate,2778,3,4,5,5,16,19,-3,17
D Bucuresti,2778,4,3,6,5,18,20,-2,15
FC Botosani,2778,5,3,5,6,5,13,-8,14
Concordia Ch,2778,6,3,3,8,18,23,-5,12
CFR Cluj,2779,1,7,6,1,18,9,9,27
FCSB,2779,2,7,5,2,24,13,11,26
FC Botosani,2779,3,5,4,5,7,12,-5,19
Universitate,2779,4,4,5,5,16,21,-5,17
D Bucuresti,2779,5,3,5,6,18,21,-3,14
Concordia Ch,2779,6,2,3,9,17,24,-7,9
FCSB,2780,1,7,6,1,25,14,11,27
CFR Cluj,2780,2,5,7,2,13,9,4,22
Universitate,2780,3,5,5,4,20,20,0,20
D Bucuresti,2780,4,4,5,5,21,20,1,17
FC Botosani,2780,5,4,4,6,7,15,-8,16
Concordia Ch,2780,6,2,3,9,17,25,-8,9
FCSB,2781,1,8,5,1,24,12,12,29
CFR Cluj,2781,2,5,7,2,13,8,5,22
Universitate,2781,3,4,6,4,16,18,-2,18
D Bucuresti,2781,4,4,5,5,20,20,0,17
FC Botosani,2781,5,3,5,6,5,14,-9,14
Concordia Ch,2781,6,2,4,8,17,23,-6,10
FCSB,2782,1,9,5,0,29,11,18,32
CFR Cluj,2782,2,5,7,2,15,10,5,22
FC Botosani,2782,3,4,5,5,7,13,-6,17
D Bucuresti,2782,4,3,6,5,19,21,-2,15
Universitate,2782,5,3,6,5,15,23,-8,15
Concordia Ch,2782,6,2,3,9,17,24,-7,9
FCSB,2783,1,8,5,1,27,14,13,29
CFR Cluj,2783,2,7,6,1,18,8,10,27
D Bucuresti,2783,3,4,4,6,17,20,-3,16
Universitate,2783,4,3,5,6,15,23,-8,14
FC Botosani,2783,5,3,5,6,6,14,-8,14
Concordia Ch,2783,6,3,3,8,18,22,-4,12
FCSB,2784,1,8,6,0,26,12,14,30
CFR Cluj,2784,2,6,6,2,17,10,7,24
D Bucuresti,2784,3,4,4,6,17,21,-4,16
FC Botosani,2784,4,4,4,6,8,14,-6,16
Universitate,2784,5,3,6,5,14,20,-6,15
Concordia Ch,2784,6,3,2,9,19,24,-5,11
FCSB,2785,1,8,5,1,27,14,13,29
CFR Cluj,2785,2,5,7,2,16,11,5,22
Universitate,2785,3,4,6,4,17,20,-3,18
D Bucuresti,2785,4,3,6,5,16,18,-2,15
FC Botosani,2785,5,3,5,6,5,13,-8,14
Concordia Ch,2785,6,3,3,8,16,21,-5,12
FCSB,2786,1,7,6,1,24,13,11,27
CFR Cluj,2786,2,5,8,1,16,10,6,23
Universitate,2786,3,4,6,4,18,20,-2,18
FC Botosani,2786,4,4,4,6,7,15,-8,16
D Bucuresti,2786,5,3,5,6,18,21,-3,14
Concordia Ch,2786,6,3,3,8,20,24,-4,12
FCSB,2787,1,8,6,0,26,12,14,30
CFR Cluj,2787,2,5,6,3,14,10,4,21
Universitate,2787,3,4,6,4,16,19,-3,18
FC Botosani,2787,4,4,5,5,9,15,-6,17
D Bucuresti,2787,5,3,6,5,19,21,-2,15
Concordia Ch,2787,6,2,3,9,19,26,-7,9
FCSB,2788,1,9,5,0,26,11,15,32
CFR Cluj,2788,2,5,6,3,14,13,1,21
Universitate,2788,3,4,5,5,18,19,-1,17
D Bucuresti,2788,4,4,4,6,19,22,-3,16
FC Botosani,2788,5,4,4,6,6,14,-8,16
Concordia Ch,2788,6,3,2,9,19,23,-4,11
FCSB,2789,1,8,5,1,24,13,11,29
CFR Cluj,2789,2,5,7,2,13,8,5,22
Universitate,2789,3,4,6,4,17,18,-1,18
FC Botosani,2789,4,4,5,5,8,14,-6,17
D Bucuresti,2789,5,3,6,5,18,20,-2,15
Concordia Ch,2789,6,2,3,9,17,24,-7,9
FCSB,2790,1,9,5,0,28,11,17,32
CFR Cluj,2790,2,5,6,3,13,10,3,21
D Bucuresti,2790,3,5,4,5,23,19,4,19
Universitate,2790,4,4,5,5,16,21,-5,17
FC Botosani,2790,5,4,4,6,8,15,-7,16
Concordia Ch,2790,6,2,2,10,15,27,-12,8
FCSB,2791,1,9,5,0,28,13,15,32
CFR Cluj,2791,2,5,7,2,15,10,5,22
FC Botosani,2791,3,5,4,5,9,14,-5,19
Universitate,2791,4,3,6,5,17,22,-5,15
D Bucuresti,2791,5,3,4,7,17,21,-4,13
Concordia Ch,2791,6,3,2,9,17,23,-6,11
FCSB,2792,1,8,6,0,27,12,15,30
CFR Cluj,2792,2,6,7,1,17,10,7,25
D Bucuresti,2792,3,3,6,5,19,21,-2,15
Universitate,2792,4,3,5,6,15,22,-7,14
FC Botosani,2792,5,3,5,6,6,14,-8,14
Concordia Ch,2792,6,3,3,8,18,23,-5,12
FCSB,2793,1,7,6,1,24,12,12,27
CFR Cluj,2793,2,6,7,1,17,9,8,25
D Bucuresti,2793,3,5,4,5,21,20,1,19
Universitate,2793,4,4,5,5,16,21,-5,17
FC Botosani,2793,5,3,5,6,7,16,-9,14
Concordia Ch,2793,6,2,3,9,17,24,-7,9
FCSB,2794,1,8,6,0,26,12,14,30
CFR Cluj,2794,2,6,6,2,16,10,6,24
D Bucuresti,2794,3,3,6,5,18,20,-2,15
Universitate,2794,4,3,6,5,16,21,-5,15
FC Botosani,2794,5,3,5,6,5,13,-8,14
Concordia Ch,2794,6,3,3,8,18,23,-5,12
FCSB,2795,1,9,5,0,29,13,16,32
CFR Cluj,2795,2,6,6,2,14,8,6,24
D Bucuresti,2795,3,5,4,5,19,18,1,19
FC Botosani,2795,4,4,4,6,6,13,-7,16
Universitate,2795,5,3,5,6,17,24,-7,14
Concordia Ch,2795,6,2,2,10,15,24,-9,8
FCSB,2796,1,8,6,0,27,12,15,30
CFR Cluj,2796,2,5,7,2,14,9,5,22
Universitate,2796,3,4,5,5,16,21,-5,17
FC Botosani,2796,4,4,5,5,7,13,-6,17
D Bucuresti,2796,5,3,5,6,17,21,-4,14
Concordia Ch,2796,6,3,2,9,17,22,-5,11
FCSB,2797,1,8,5,1,27,13,14,29
CFR Cluj,2797,2,5,7,2,15,12,3,22
Universitate,2797,3,4,6,4,19,21,-2,18
D Bucuresti,2797,4,4,5,5,21,20,1,17
FC Botosani,2797,5,4,5,5,8,14,-6,17
Concordia Ch,2797,6,2,2,10,15,25,-10,8
FCSB,2798,1,8,5,1,26,12,14,29
CFR Cluj,2798,2,5,6,3,14,11,3,21
Universitate,2798,3,5,5,4,18,20,-2,20
FC Botosani,2798,4,4,5,5,10,14,-4,17
D Bucuresti,2798,5,3,4,7,16,23,-7,13
Concordia Ch,2798,6,3,3,8,19,23,-4,12
FCSB,2799,1,8,5,1,25,12,13,29
CFR Cluj,2799,2,6,7,1,15,8,7,25
D Bucuresti,2799,3,4,5,5,18,19,-1,17
Universitate,2799,4,3,6,5,16,21,-5,15
FC Botosani,2799,5,3,5,6,7,15,-8,14
Concordia Ch,2799,6,2,4,8,18,24,-6,10
FCSB,2800,1,8,6,0,26,12,14,30
CFR Cluj,2800,2,6,7,1,16,8,8,25
D Bucuresti,2800,3,4,4,6,19,21,-2,16
Concordia Ch,2800,4,4,2,8,19,21,-2,14
Universitate,2800,5,3,5,6,15,22,-7,14
FC Botosani,2800,6,3,4,7,5,16,-11,13
FCSB,2801,1,7,5,2,25,15,10,26
CFR Cluj,2801,2,6,7,1,17,9,8,25
Universitate,2801,3,4,6,4,17,20,-3,18
FC Botosani,2801,4,4,5,5,11,17,-6,17
D Bucuresti,2801,5,3,5,6,19,22,-3,14
Concordia Ch,2801,6,2,4,8,19,25,-6,10
FCSB,2802,1,7,7,0,24,11,13,28
CFR Cluj,2802,2,6,7,1,15,8,7,25
D Bucuresti,2802,3,4,4,6,19,22,-3,16
Universitate,2802,4,3,6,5,16,21,-5,15
FC Botosani,2802,5,3,5,6,8,17,-9,14
Concordia Ch,2802,6,3,3,8,20,23,-3,12
FCSB,2803,1,8,5,1,25,12,13,29
CFR Cluj,2803,2,5,7,2,13,8,5,22
Universitate,2803,3,4,6,4,16,19,-3,18
FC Botosani,2803,4,3,6,5,7,14,-7,15
D Bucuresti,2803,5,3,5,6,19,23,-4,14
Concordia Ch,2803,6,3,3,8,20,24,-4,12
FCSB,2804,1,8,6,0,25,11,14,30
CFR Cluj,2804,2,6,6,2,16,10,6,24
D Bucuresti,2804,3,4,4,6,19,19,0,16
Universitate,2804,4,3,6,5,15,20,-5,15
FC Botosani,2804,5,3,5,6,5,15,-10,14
Concordia Ch,2804,6,3,3,8,16,21,-5,12
FCSB,2805,1,8,6,0,26,11,15,30
CFR Cluj,2805,2,5,7,2,14,10,4,22
D Bucuresti,2805,3,4,5,5,18,19,-1,17
Universitate,2805,4,3,7,4,16,20,-4,16
FC Botosani,2805,5,3,6,5,6,13,-7,15
Concordia Ch,2805,6,2,3,9,15,22,-7,9
FCSB,2806,1,7,6,1,23,13,10,27
CFR Cluj,2806,2,5,7,2,13,8,5,22
Universitate,2806,3,5,5,4,18,18,0,20
D Bucuresti,2806,4,4,4,6,19,21,-2,16
FC Botosani,2806,5,3,5,6,5,14,-9,14
Concordia Ch,2806,6,3,3,8,18,22,-4,12
FCSB,2807,1,8,6,0,25,11,14,30
CFR Cluj,2807,2,5,7,2,16,11,5,22
FC Botosani,2807,3,4,5,5,8,14,-6,17
Universitate,2807,4,3,7,4,16,20,-4,16
D Bucuresti,2807,5,3,5,6,18,21,-3,14
Concordia Ch,2807,6,2,4,8,17,23,-6,10
FCSB,2808,1,8,6,0,26,12,14,30
CFR Cluj,2808,2,6,6,2,15,9,6,24
D Bucuresti,2808,3,4,4,6,21,21,0,16
FC Botosani,2808,4,4,4,6,8,16,-8,16
Universitate,2808,5,3,6,5,15,20,-5,15
Concordia Ch,2808,6,3,2,9,18,25,-7,11
FCSB,2809,1,8,6,0,27,12,15,30
CFR Cluj,2809,2,6,7,1,16,7,9,25
FC Botosani,2809,3,4,5,5,8,14,-6,17
D Bucuresti,2809,4,3,5,6,18,21,-3,14
Universitate,2809,5,3,5,6,16,25,-9,14
Concordia Ch,2809,6,3,2,9,16,22,-6,11
FCSB,2810,1,7,6,1,25,13,12,27
CFR Cluj,2810,2,5,8,1,14,8,6,23
Universitate,2810,3,4,6,4,16,19,-3,18
FC Botosani,2810,4,3,6,5,7,14,-7,15
D Bucuresti,2810,5,3,5,6,17,22,-5,14
Concordia Ch,2810,6,3,3,8,19,22,-3,12
FCSB,2811,1,8,5,1,24,11,13,29
CFR Cluj,2811,2,6,6,2,14,9,5,24
Universitate,2811,3,4,5,5,16,19,-3,17
FC Botosani,2811,4,4,4,6,6,14,-8,16
D Bucuresti,2811,5,3,5,6,16,19,-3,14
Concordia Ch,2811,6,3,3,8,17,21,-4,12
FCSB,2812,1,7,7,0,24,11,13,28
CFR Cluj,2812,2,6,7,1,14,7,7,25
D Bucuresti,2812,3,4,4,6,17,20,-3,16
FC Botosani,2812,4,4,4,6,7,14,-7,16
Universitate,2812,5,3,6,5,15,20,-5,15
Concordia Ch,2812,6,3,2,9,18,23,-5,11
FCSB,2813,1,7,7,0,24,11,13,28
CFR Cluj,2813,2,5,8,1,13,7,6,23
FC Botosani,2813,3,5,4,5,10,12,-2,19
Universitate,2813,4,3,7,4,15,19,-4,16
D Bucuresti,2813,5,3,5,6,17,22,-5,14
Concordia Ch,2813,6,2,3,9,16,24,-8,9
FCSB,2814,1,7,7,0,24,11,13,28
CFR Cluj,2814,2,5,7,2,13,8,5,22
D Bucuresti,2814,3,5,4,5,20,18,2,19
Universitate,2814,4,4,6,4,16,19,-3,18
FC Botosani,2814,5,4,4,6,6,13,-7,16
Concordia Ch,2814,6,2,2,10,15,25,-10,8
FCSB,2815,1,7,6,1,24,14,10,27
CFR Cluj,2815,2,5,8,1,14,8,6,23
Universitate,2815,3,4,6,4,17,18,-1,18
D Bucuresti,2815,4,4,5,5,19,20,-1,17
FC Botosani,2815,5,4,4,6,7,13,-6,16
Concordia Ch,2815,6,2,3,9,17,25,-8,9
FCSB,2816,1,8,5,1,25,12,13,29
CFR Cluj,2816,2,7,6,1,19,9,10,27
D Bucuresti,2816,3,4,4,6,17,19,-2,16
Universitate,2816,4,3,5,6,15,23,-8,14
FC Botosani,2816,5,3,5,6,5,13,-8,14
Concordia Ch,2816,6,3,3,8,16,21,-5,12
FCSB,2817,1,8,5,1,25,12,13,29
CFR Cluj,2817,2,5,6,3,15,11,4,21
Universitate,2817,3,5,5,4,17,19,-2,20
D Bucuresti,2817,4,3,5,6,19,22,-3,14
Concordia Ch,2817,5,4,2,8,21,25,-4,14
FC Botosani,2817,6,3,5,6,8,16,-8,14
FCSB,2818,1,8,5,1,26,11,15,29
CFR Cluj,2818,2,6,6,2,17,11,6,24
Universitate,2818,3,4,5,5,16,22,-6,17
D Bucuresti,2818,4,4,4,6,18,20,-2,16
FC Botosani,2818,5,4,4,6,7,14,-7,16
Concordia Ch,2818,6,3,2,9,16,22,-6,11
FCSB,2819,1,7,6,1,25,14,11,27
CFR Cluj,2819,2,7,6,1,17,7,10,27
D Bucuresti,2819,3,4,4,6,17,19,-2,16
Universitate,2819,4,3,6,5,16,22,-6,15
FC Botosani,2819,5,3,5,6,6,14,-8,14
Concordia Ch,2819,6,3,3,8,17,22,-5,12
FCSB,2820,1,7,6,1,24,12,12,27
CFR Cluj,2820,2,7,6,1,17,8,9,27
Universitate,2820,3,3,6,5,14,20,-6,15
Concordia Ch,2820,4,4,2,8,19,22,-3,14
D Bucuresti,2820,4,3,5,6,19,22,-3,14
FC Botosani,2820,6,3,5,6,9,18,-9,14
FCSB,2821,1,7,6,1,27,15,12,27
CFR Cluj,2821,2,7,6,1,18,10,8,27
D Bucuresti,2821,3,4,5,5,19,18,1,17
Universitate,2821,4,3,6,5,17,22,-5,15
FC Botosani,2821,5,3,4,7,7,18,-11,13
Concordia Ch,2821,6,3,3,8,18,23,-5,12
FCSB,2822,1,9,5,0,26,11,15,32
CFR Cluj,2822,2,5,6,3,14,10,4,21
D Bucuresti,2822,3,4,5,5,18,18,0,17
Universitate,2822,4,4,5,5,17,21,-4,17
FC Botosani,2822,5,3,4,7,5,15,-10,13
Concordia Ch,2822,6,3,3,8,16,21,-5,12
FCSB,2823,1,9,5,0,31,12,19,32
CFR Cluj,2823,2,6,6,2,17,11,6,24
FC Botosani,2823,3,4,5,5,8,13,-5,17
D Bucuresti,2823,4,3,5,6,17,21,-4,14
Universitate,2823,5,3,5,6,15,25,-10,14
Concordia Ch,2823,6,3,2,9,17,23,-6,11
FCSB,2824,1,8,5,1,25,12,13,29
CFR Cluj,2824,2,6,6,2,15,10,5,24
Universitate,2824,3,4,5,5,17,20,-3,17
D Bucuresti,2824,4,4,4,6,19,22,-3,16
FC Botosani,2824,5,4,4,6,10,14,-4,16
Concordia Ch,2824,6,3,2,9,18,26,-8,11
FCSB,2825,1,7,6,1,23,11,12,27
CFR Cluj,2825,2,5,7,2,13,9,4,22
Universitate,2825,3,5,5,4,17,18,-1,20
D Bucuresti,2825,4,4,5,5,17,18,-1,17
FC Botosani,2825,5,3,6,5,7,14,-7,15
Concordia Ch,2825,6,2,3,9,17,24,-7,9
FCSB,2826,1,8,5,1,25,14,11,29
CFR Cluj,2826,2,5,7,2,15,10,5,22
Universitate,2826,3,4,6,4,18,19,-1,18
FC Botosani,2826,4,4,5,5,7,13,-6,17
D Bucuresti,2826,5,4,4,6,19,20,-1,16
Concordia Ch,2826,6,2,3,9,17,25,-8,9
FCSB,2827,1,7,6,1,24,12,12,27
CFR Cluj,2827,2,6,7,1,15,8,7,25
D Bucuresti,2827,3,4,4,6,17,21,-4,16
Universitate,2827,4,3,7,4,16,20,-4,16
Concordia Ch,2827,5,4,2,8,20,21,-1,14
FC Botosani,2827,6,3,4,7,5,15,-10,13
FCSB,2828,1,9,5,0,28,12,16,32
CFR Cluj,2828,2,5,6,3,14,11,3,21
Universitate,2828,3,4,5,5,16,20,-4,17
D Bucuresti,2828,4,4,4,6,19,22,-3,16
FC Botosani,2828,5,4,4,6,8,15,-7,16
Concordia Ch,2828,6,3,2,9,19,24,-5,11
FCSB,2829,1,7,6,1,26,14,12,27
CFR Cluj,2829,2,7,6,1,19,10,9,27
FC Botosani,2829,3,4,5,5,7,13,-6,17
D Bucuresti,2829,4,3,6,5,17,19,-2,15
Universitate,2829,5,3,6,5,16,22,-6,15
Concordia Ch,2829,6,2,3,9,17,24,-7,9
FCSB,2830,1,7,6,1,25,14,11,27
CFR Cluj,2830,2,7,6,1,19,9,10,27
FC Botosani,2830,3,5,4,5,8,12,-4,19
Universitate,2830,4,3,6,5,16,22,-6,15
D Bucuresti,2830,5,3,4,7,16,20,-4,13
Concordia Ch,2830,6,3,2,9,16,23,-7,11
FCSB,2831,1,8,6,0,25,10,15,30
CFR Cluj,2831,2,6,6,2,14,9,5,24
D Bucuresti,2831,3,4,5,5,18,19,-1,17
Universitate,2831,4,3,6,5,14,19,-5,15
FC Botosani,2831,5,3,4,7,8,19,-11,13
Concordia Ch,2831,6,3,3,8,20,23,-3,12
FCSB,2832,1,9,5,0,29,12,17,32
CFR Cluj,2832,2,6,6,2,17,8,9,24
D Bucuresti,2832,3,4,5,5,20,20,0,17
FC Botosani,2832,4,4,4,6,8,16,-8,16
Universitate,2832,5,3,5,6,16,27,-11,14
Concordia Ch,2832,6,2,3,9,17,24,-7,9
FCSB,2833,1,8,6,0,26,11,15,30
CFR Cluj,2833,2,5,7,2,14,10,4,22
FC Botosani,2833,3,4,5,5,8,14,-6,17
Universitate,2833,4,3,7,4,16,20,-4,16
D Bucuresti,2833,5,3,5,6,18,21,-3,14
Concordia Ch,2833,6,2,4,8,17,23,-6,10
FCSB,2834,1,9,5,0,26,11,15,32
CFR Cluj,2834,2,5,6,3,16,12,4,21
FC Botosani,2834,3,5,4,5,8,12,-4,19
Universitate,2834,4,4,5,5,17,21,-4,17
D Bucuresti,2834,5,3,4,7,17,21,-4,13
Concordia Ch,2834,6,3,2,9,17,24,-7,11
FCSB,2835,1,7,5,2,24,14,10,26
CFR Cluj,2835,2,6,6,2,15,9,6,24
Universitate,2835,3,5,5,4,17,18,-1,20
FC Botosani,2835,4,3,6,5,7,14,-7,15
D Bucuresti,2835,5,3,5,6,18,22,-4,14
Concordia Ch,2835,6,3,3,8,19,23,-4,12
FCSB,2836,1,8,6,0,27,12,15,30
CFR Cluj,2836,2,6,6,2,19,11,8,24
FC Botosani,2836,3,4,4,6,9,16,-7,16
Universitate,2836,4,3,6,5,16,24,-8,15
Concordia Ch,2836,5,4,2,8,19,22,-3,14
D Bucuresti,2836,6,3,4,7,17,22,-5,13
FCSB,2837,1,9,5,0,27,10,17,32
CFR Cluj,2837,2,5,7,2,14,10,4,22
D Bucuresti,2837,3,4,5,5,19,20,-1,17
Universitate,2837,4,3,6,5,15,21,-6,15
FC Botosani,2837,5,3,5,6,6,14,-8,14
Concordia Ch,2837,6,2,4,8,16,22,-6,10
FCSB,2838,1,8,5,1,24,11,13,29
CFR Cluj,2838,2,5,7,2,14,9,5,22
FC Botosani,2838,3,5,4,5,10,12,-2,19
Universitate,2838,4,4,6,4,16,19,-3,18
D Bucuresti,2838,5,3,4,7,16,23,-7,13
Concordia Ch,2838,6,3,2,9,16,22,-6,11
FCSB,2839,1,9,5,0,25,10,15,32
CFR Cluj,2839,2,5,7,2,14,9,5,22
D Bucuresti,2839,3,5,4,5,18,18,0,19
Universitate,2839,4,3,6,5,15,20,-5,15
FC Botosani,2839,5,3,5,6,5,13,-8,14
Concordia Ch,2839,6,2,3,9,15,22,-7,9
FCSB,2840,1,7,7,0,25,12,13,28
CFR Cluj,2840,2,6,7,1,15,8,7,25
D Bucuresti,2840,3,4,4,6,19,20,-1,16
FC Botosani,2840,4,4,4,6,6,13,-7,16
Universitate,2840,5,3,6,5,15,20,-5,15
Concordia Ch,2840,6,3,2,9,17,24,-7,11
FCSB,2841,1,8,6,0,28,12,16,30
CFR Cluj,2841,2,5,7,2,16,11,5,22
D Bucuresti,2841,3,4,5,5,18,19,-1,17
Universitate,2841,4,4,5,5,16,22,-6,17
FC Botosani,2841,5,3,4,7,6,15,-9,13
Concordia Ch,2841,6,3,3,8,16,21,-5,12
FCSB,2842,1,7,6,1,25,14,11,27
CFR Cluj,2842,2,7,6,1,17,8,9,27
Universitate,2842,3,3,6,5,17,22,-5,15
FC Botosani,2842,4,3,6,5,6,13,-7,15
D Bucuresti,2842,5,3,5,6,19,24,-5,14
Concordia Ch,2842,6,3,3,8,20,23,-3,12
FCSB,2843,1,8,5,1,27,13,14,29
CFR Cluj,2843,2,5,7,2,15,11,4,22
D Bucuresti,2843,3,5,4,5,19,19,0,19
Universitate,2843,4,4,6,4,17,20,-3,18
FC Botosani,2843,5,4,4,6,6,13,-7,16
Concordia Ch,2843,6,2,2,10,16,24,-8,8
FCSB,2844,1,9,5,0,26,11,15,32
CFR Cluj,2844,2,6,6,2,14,8,6,24
FC Botosani,2844,3,3,6,5,8,15,-7,15
D Bucuresti,2844,4,3,5,6,19,23,-4,14
Universitate,2844,5,3,5,6,15,21,-6,14
Concordia Ch,2844,6,3,3,8,19,23,-4,12
FCSB,2845,1,7,5,2,24,15,9,26
CFR Cluj,2845,2,6,6,2,15,9,6,24
Universitate,2845,3,5,5,4,18,18,0,20
D Bucuresti,2845,4,3,6,5,17,19,-2,15
FC Botosani,2845,5,3,5,6,5,16,-11,14
Concordia Ch,2845,6,3,3,8,20,22,-2,12
FCSB,2846,1,7,5,2,24,14,10,26
CFR Cluj,2846,2,6,6,2,16,9,7,24
Universitate,2846,3,5,5,4,16,18,-2,20
D Bucuresti,2846,4,5,4,5,18,18,0,19
FC Botosani,2846,5,4,4,6,8,15,-7,16
Concordia Ch,2846,6,2,2,10,17,25,-8,8
FCSB,2847,1,8,6,0,26,11,15,30
CFR Cluj,2847,2,5,8,1,15,9,6,23
FC Botosani,2847,3,4,5,5,8,14,-6,17
Universitate,2847,4,3,6,5,15,21,-6,15
D Bucuresti,2847,5,3,5,6,19,22,-3,14
Concordia Ch,2847,6,3,2,9,19,25,-6,11
CFR Cluj,2848,1,7,6,1,16,8,8,27
FCSB,2848,2,7,5,2,23,12,11,26
D Bucuresti,2848,3,4,5,5,18,19,-1,17
Universitate,2848,4,4,5,5,16,20,-4,17
FC Botosani,2848,5,3,5,6,6,14,-8,14
Concordia Ch,2848,6,2,4,8,17,23,-6,10
FCSB,2849,1,8,5,1,24,12,12,29
CFR Cluj,2849,2,6,6,2,16,9,7,24
Universitate,2849,3,4,5,5,16,20,-4,17
D Bucuresti,2849,4,4,4,6,18,19,-1,16
FC Botosani,2849,5,4,4,6,8,15,-7,16
Concordia Ch,2849,6,3,2,9,17,24,-7,11
FCSB,2850,1,7,6,1,23,13,10,27
CFR Cluj,2850,2,5,7,2,13,8,5,22
Universitate,2850,3,5,5,4,18,18,0,20
FC Botosani,2850,4,4,5,5,7,13,-6,17
D Bucuresti,2850,5,3,5,6,16,20,-4,14
Concordia Ch,2850,6,3,2,9,18,23,-5,11
FCSB,2851,1,8,5,1,26,13,13,29
CFR Cluj,2851,2,5,7,2,13,8,5,22
Universitate,2851,3,4,6,4,17,20,-3,18
D Bucuresti,2851,4,4,5,5,17,18,-1,17
FC Botosani,2851,5,4,4,6,6,13,-7,16
Concordia Ch,2851,6,2,3,9,15,22,-7,9
FCSB,2852,1,8,6,0,26,12,14,30
CFR Cluj,2852,2,5,7,2,14,10,4,22
Universitate,2852,3,4,5,5,17,20,-3,17
D Bucuresti,2852,4,4,4,6,17,19,-2,16
Concordia Ch,2852,5,4,2,8,17,21,-4,14
FC Botosani,2852,6,3,4,7,5,14,-9,13
CFR Cluj,2853,1,7,6,1,18,8,10,27
FCSB,2853,2,7,5,2,25,14,11,26
Universitate,2853,3,4,5,5,16,22,-6,17
D Bucuresti,2853,4,4,4,6,20,22,-2,16
Concordia Ch,2853,5,4,2,8,22,24,-2,14
FC Botosani,2853,6,3,4,7,8,19,-11,13
FCSB,2854,1,7,5,2,23,13,10,26
CFR Cluj,2854,2,6,7,1,15,8,7,25
D Bucuresti,2854,3,5,4,5,22,19,3,19
Universitate,2854,4,4,6,4,17,19,-2,18
FC Botosani,2854,5,3,4,7,6,15,-9,13
Concordia Ch,2854,6,3,2,9,18,27,-9,11
FCSB,2855,1,7,7,0,25,12,13,28
CFR Cluj,2855,2,5,7,2,14,10,4,22
D Bucuresti,2855,3,5,4,5,20,18,2,19
Universitate,2855,4,4,6,4,17,19,-2,18
FC Botosani,2855,5,3,5,6,5,14,-9,14
Concordia Ch,2855,6,2,3,9,15,23,-8,9
FCSB,2856,1,8,6,0,26,12,14,30
CFR Cluj,2856,2,6,7,1,16,8,8,25
D Bucuresti,2856,3,5,4,5,19,18,1,19
Universitate,2856,4,3,5,6,15,22,-7,14
FC Botosani,2856,5,3,5,6,5,13,-8,14
Concordia Ch,2856,6,2,3,9,15,23,-8,9
FCSB,2857,1,9,5,0,27,11,16,32
CFR Cluj,2857,2,6,6,2,17,11,6,24
FC Botosani,2857,3,4,5,5,11,14,-3,17
D Bucuresti,2857,4,3,5,6,18,21,-3,14
Universitate,2857,5,3,5,6,15,22,-7,14
Concordia Ch,2857,6,3,2,9,16,25,-9,11
FCSB,2858,1,7,5,2,25,14,11,26
CFR Cluj,2858,2,6,6,2,15,9,6,24
Universitate,2858,3,5,5,4,17,19,-2,20
D Bucuresti,2858,4,3,6,5,17,19,-2,15
FC Botosani,2858,5,3,6,5,5,12,-7,15
Concordia Ch,2858,6,2,4,8,16,22,-6,10
FCSB,2859,1,7,6,1,23,11,12,27
CFR Cluj,2859,2,5,7,2,13,8,5,22
Universitate,2859,3,5,5,4,16,18,-2,20
FC Botosani,2859,4,4,5,5,6,12,-6,17
D Bucuresti,2859,5,3,6,5,18,20,-2,15
Concordia Ch,2859,6,2,3,9,17,24,-7,9
FCSB,2860,1,9,5,0,28,12,16,32
CFR Cluj,2860,2,6,6,2,17,9,8,24
FC Botosani,2860,3,4,5,5,9,14,-5,17
D Bucuresti,2860,4,3,5,6,18,21,-3,14
Universitate,2860,5,3,5,6,17,26,-9,14
Concordia Ch,2860,6,3,2,9,18,25,-7,11
FCSB,2861,1,9,5,0,29,11,18,32
CFR Cluj,2861,2,6,6,2,15,11,4,24
Concordia Ch,2861,3,4,2,8,18,21,-3,14
D Bucuresti,2861,4,3,5,6,18,22,-4,14
Universitate,2861,5,3,5,6,15,22,-7,14
FC Botosani,2861,6,3,5,6,7,15,-8,14
FCSB,2862,1,7,5,2,24,15,9,26
CFR Cluj,2862,2,6,6,2,16,9,7,24
Universitate,2862,3,5,5,4,17,18,-1,20
FC Botosani,2862,4,4,5,5,7,13,-6,17
D Bucuresti,2862,5,3,4,7,18,23,-5,13
Concordia Ch,2862,6,3,3,8,20,24,-4,12
FCSB,2863,1,8,6,0,26,11,15,30
CFR Cluj,2863,2,5,6,3,13,10,3,21
Universitate,2863,3,4,6,4,16,19,-3,18
D Bucuresti,2863,4,4,5,5,19,20,-1,17
FC Botosani,2863,5,3,5,6,7,15,-8,14
Concordia Ch,2863,6,2,4,8,19,25,-6,10
FCSB,2864,1,9,5,0,30,12,18,32
CFR Cluj,2864,2,5,6,3,14,13,1,21
Universitate,2864,3,4,5,5,17,21,-4,17
FC Botosani,2864,4,4,5,5,7,13,-6,17
D Bucuresti,2864,5,3,5,6,17,20,-3,14
Concordia Ch,2864,6,3,2,9,16,22,-6,11
FCSB,2865,1,7,6,1,23,14,9,27
CFR Cluj,2865,2,6,6,2,17,8,9,24
Universitate,2865,3,4,6,4,15,18,-3,18
D Bucuresti,2865,4,4,5,5,18,19,-1,17
FC Botosani,2865,5,4,5,5,8,14,-6,17
Concordia Ch,2865,6,2,2,10,18,26,-8,8
FCSB,2866,1,7,6,1,23,12,11,27
CFR Cluj,2866,2,7,6,1,17,7,10,27
Universitate,2866,3,3,6,5,14,20,-6,15
FC Botosani,2866,4,3,6,5,6,13,-7,15
D Bucuresti,2866,5,3,5,6,19,25,-6,14
Concordia Ch,2866,6,3,3,8,21,23,-2,12
CFR Cluj,2867,1,7,6,1,17,7,10,27
FCSB,2867,2,7,5,2,23,13,10,26
D Bucuresti,2867,3,5,4,5,22,19,3,19
Universitate,2867,4,4,5,5,16,21,-5,17
FC Botosani,2867,5,4,4,6,9,14,-5,16
Concordia Ch,2867,6,2,2,10,15,28,-13,8
FCSB,2868,1,7,6,1,24,12,12,27
CFR Cluj,2868,2,6,7,1,14,7,7,25
D Bucuresti,2868,3,5,4,5,21,18,3,19
Universitate,2868,4,4,5,5,16,20,-4,17
FC Botosani,2868,5,3,4,7,5,15,-10,13
Concordia Ch,2868,6,3,2,9,16,24,-8,11
CFR Cluj,2869,1,7,6,1,17,9,8,27
FCSB,2869,2,7,5,2,24,16,8,26
D Bucuresti,2869,3,5,4,5,21,19,2,19
Universitate,2869,4,4,5,5,19,20,-1,17
FC Botosani,2869,5,3,5,6,5,15,-10,14
Concordia Ch,2869,6,2,3,9,16,23,-7,9
FCSB,2870,1,8,5,1,26,13,13,29
CFR Cluj,2870,2,5,7,2,14,9,5,22
Universitate,2870,3,4,6,4,16,19,-3,18
FC Botosani,2870,4,4,5,5,7,12,-5,17
D Bucuresti,2870,5,3,5,6,16,21,-5,14
Concordia Ch,2870,6,3,2,9,18,23,-5,11
FCSB,2871,1,8,6,0,25,11,14,30
CFR Cluj,2871,2,5,6,3,14,10,4,21
Universitate,2871,3,4,6,4,17,20,-3,18
D Bucuresti,2871,4,4,4,6,18,20,-2,16
FC Botosani,2871,5,3,5,6,6,14,-8,14
Concordia Ch,2871,6,3,3,8,18,23,-5,12
FCSB,2872,1,9,5,0,25,10,15,32
CFR Cluj,2872,2,6,6,2,14,8,6,24
FC Botosani,2872,3,4,5,5,7,13,-6,17
D Bucuresti,2872,4,3,5,6,18,21,-3,14
Universitate,2872,5,3,5,6,14,20,-6,14
Concordia Ch,2872,6,2,4,8,16,22,-6,10
FCSB,2873,1,9,5,0,27,11,16,32
CFR Cluj,2873,2,6,6,2,15,9,6,24
D Bucuresti,2873,3,5,4,5,20,20,0,19
Universitate,2873,4,3,5,6,14,21,-7,14
FC Botosani,2873,5,3,4,7,7,17,-10,13
Concordia Ch,2873,6,3,2,9,19,24,-5,11
FCSB,2874,1,7,6,1,25,13,12,27
CFR Cluj,2874,2,7,6,1,18,9,9,27
D Bucuresti,2874,3,4,5,5,19,19,0,17
Universitate,2874,4,3,6,5,16,22,-6,15
FC Botosani,2874,5,3,6,5,6,13,-7,15
Concordia Ch,2874,6,2,3,9,15,23,-8,9
FCSB,2875,1,8,5,1,26,11,15,29
CFR Cluj,2875,2,6,6,2,15,10,5,24
Universitate,2875,3,4,5,5,15,20,-5,17
D Bucuresti,2875,4,4,4,6,19,20,-1,16
FC Botosani,2875,5,4,4,6,7,14,-7,16
Concordia Ch,2875,6,3,2,9,17,24,-7,11
FCSB,2876,1,7,7,0,25,12,13,28
CFR Cluj,2876,2,5,8,1,14,8,6,23
D Bucuresti,2876,3,4,4,6,19,21,-2,16
Universitate,2876,4,3,7,4,15,19,-4,16
Concordia Ch,2876,5,4,2,8,19,22,-3,14
FC Botosani,2876,6,3,4,7,7,17,-10,13
FCSB,2877,1,7,6,1,23,12,11,27
CFR Cluj,2877,2,6,7,1,15,7,8,25
D Bucuresti,2877,3,5,4,5,20,20,0,19
Universitate,2877,4,3,7,4,14,18,-4,16
FC Botosani,2877,5,3,5,6,6,14,-8,14
Concordia Ch,2877,6,2,3,9,16,23,-7,9
FCSB,2878,1,8,5,1,24,12,12,29
CFR Cluj,2878,2,6,6,2,14,8,6,24
Universitate,2878,3,4,5,5,16,19,-3,17
FC Botosani,2878,4,4,4,6,8,14,-6,16
Concordia Ch,2878,5,4,2,8,17,21,-4,14
D Bucuresti,2878,6,3,4,7,17,22,-5,13
FCSB,2879,1,7,6,1,25,13,12,27
CFR Cluj,2879,2,6,7,1,20,10,10,25
Universitate,2879,3,4,5,5,16,23,-7,17
D Bucuresti,2879,4,4,4,6,20,21,-1,16
FC Botosani,2879,5,4,4,6,7,16,-9,16
Concordia Ch,2879,6,3,2,9,17,22,-5,11
FCSB,2880,1,8,5,1,30,15,15,29
CFR Cluj,2880,2,5,7,2,17,14,3,22
Universitate,2880,3,4,6,4,17,20,-3,18
D Bucuresti,2880,4,4,5,5,20,19,1,17
FC Botosani,2880,5,3,4,7,6,17,-11,13
Concordia Ch,2880,6,3,3,8,18,23,-5,12
FCSB,2881,1,7,6,1,25,13,12,27
CFR Cluj,2881,2,7,6,1,16,7,9,27
FC Botosani,2881,3,5,4,5,8,13,-5,19
Universitate,2881,4,3,6,5,16,22,-6,15
D Bucuresti,2881,5,3,5,6,18,21,-3,14
Concordia Ch,2881,6,2,3,9,18,25,-7,9
FCSB,2882,1,8,5,1,26,14,12,29
CFR Cluj,2882,2,7,6,1,18,9,9,27
D Bucuresti,2882,3,4,5,5,20,19,1,17
Universitate,2882,4,3,5,6,14,20,-6,14
FC Botosani,2882,5,3,4,7,6,18,-12,13
Concordia Ch,2882,6,3,3,8,19,23,-4,12
FCSB,2883,1,7,6,1,24,12,12,27
CFR Cluj,2883,2,6,7,1,17,8,9,25
Universitate,2883,3,4,5,5,15,21,-6,17
D Bucuresti,2883,4,4,4,6,21,21,0,16
FC Botosani,2883,5,3,5,6,6,17,-11,14
Concordia Ch,2883,6,3,3,8,19,23,-4,12
FCSB,2884,1,8,5,1,27,14,13,29
CFR Cluj,2884,2,6,6,2,16,10,6,24
D Bucuresti,2884,3,4,5,5,17,18,-1,17
Universitate,2884,4,4,5,5,16,20,-4,17
FC Botosani,2884,5,4,5,5,8,12,-4,17
Concordia Ch,2884,6,2,2,10,15,25,-10,8
FCSB,2885,1,8,6,0,26,11,15,30
CFR Cluj,2885,2,5,7,2,13,9,4,22
Universitate,2885,3,3,7,4,15,19,-4,16
FC Botosani,2885,4,4,4,6,6,13,-7,16
Concordia Ch,2885,5,4,2,8,18,22,-4,14
D Bucuresti,2885,6,3,4,7,17,21,-4,13
FCSB,2886,1,8,6,0,24,10,14,30
CFR Cluj,2886,2,5,6,3,14,10,4,21
Universitate,2886,3,4,6,4,16,19,-3,18
D Bucuresti,2886,4,4,5,5,18,19,-1,17
FC Botosani,2886,5,4,5,5,7,12,-5,17
Concordia Ch,2886,6,2,2,10,16,25,-9,8
FCSB,2887,1,8,5,1,26,16,10,29
CFR Cluj,2887,2,5,6,3,15,12,3,21
Universitate,2887,3,5,5,4,21,19,2,20
FC Botosani,2887,4,4,5,5,6,12,-6,17
D Bucuresti,2887,5,3,6,5,17,19,-2,15
Concordia Ch,2887,6,2,3,9,16,23,-7,9
FCSB,2888,1,8,6,0,25,11,14,30
CFR Cluj,2888,2,6,7,1,16,8,8,25
D Bucuresti,2888,3,4,4,6,17,19,-2,16
Universitate,2888,4,3,5,6,14,21,-7,14
FC Botosani,2888,5,3,5,6,6,14,-8,14
Concordia Ch,2888,6,3,3,8,17,22,-5,12
FCSB,2889,1,9,5,0,26,10,16,32
CFR Cluj,2889,2,5,7,2,14,10,4,22
Universitate,2889,3,3,6,5,15,20,-5,15
FC Botosani,2889,4,3,6,5,6,13,-7,15
D Bucuresti,2889,5,3,5,6,17,21,-4,14
Concordia Ch,2889,6,3,3,8,19,23,-4,12
FCSB,2890,1,7,6,1,24,15,9,27
CFR Cluj,2890,2,6,7,1,17,8,9,25
Universitate,2890,3,4,5,5,18,21,-3,17
D Bucuresti,2890,4,4,4,6,18,19,-1,16
Concordia Ch,2890,5,4,2,8,18,21,-3,14
FC Botosani,2890,6,3,4,7,5,16,-11,13
FCSB,2891,1,8,5,1,26,13,13,29
CFR Cluj,2891,2,7,6,1,16,7,9,27
D Bucuresti,2891,3,5,4,5,18,18,0,19
FC Botosani,2891,4,4,4,6,6,13,-7,16
Universitate,2891,5,3,5,6,16,23,-7,14
Concordia Ch,2891,6,2,2,10,15,23,-8,8
FCSB,2892,1,7,5,2,24,14,10,26
CFR Cluj,2892,2,6,7,1,15,7,8,25
FC Botosani,2892,3,5,4,5,8,13,-5,19
Universitate,2892,4,4,6,4,16,19,-3,18
D Bucuresti,2892,5,3,4,7,18,22,-4,13
Concordia Ch,2892,6,3,2,9,19,25,-6,11
FCSB,2893,1,7,6,1,23,12,11,27
CFR Cluj,2893,2,5,7,2,13,9,4,22
Universitate,2893,3,5,5,4,18,18,0,20
D Bucuresti,2893,4,4,4,6,17,19,-2,16
Concordia Ch,2893,5,4,2,8,20,21,-1,14
FC Botosani,2893,6,3,4,7,5,17,-12,13
FCSB,2894,1,8,5,1,25,12,13,29
CFR Cluj,2894,2,5,6,3,14,10,4,21
Universitate,2894,3,5,5,4,16,18,-2,20
FC Botosani,2894,4,4,4,6,11,15,-4,16
Concordia Ch,2894,5,4,2,8,20,23,-3,14
D Bucuresti,2894,6,3,4,7,17,25,-8,13
CFR Cluj,2895,1,7,6,1,16,7,9,27
FCSB,2895,2,7,5,2,24,16,8,26
D Bucuresti,2895,3,5,4,5,21,21,0,19
Universitate,2895,4,4,5,5,18,20,-2,17
FC Botosani,2895,5,3,4,7,6,15,-9,13
Concordia Ch,2895,6,3,2,9,20,26,-6,11
FCSB,2896,1,7,6,1,24,12,12,27
CFR Cluj,2896,2,5,7,2,16,11,5,22
Universitate,2896,3,5,5,4,18,20,-2,20
FC Botosani,2896,4,5,4,5,9,14,-5,19
D Bucuresti,2896,5,3,4,7,17,21,-4,13
Concordia Ch,2896,6,3,2,9,17,23,-6,11
FCSB,2897,1,9,5,0,26,11,15,32
CFR Cluj,2897,2,5,7,2,14,9,5,22
FC Botosani,2897,3,4,5,5,7,13,-6,17
Universitate,2897,4,3,6,5,16,21,-5,15
D Bucuresti,2897,5,3,4,7,17,23,-6,13
Concordia Ch,2897,6,3,3,8,18,21,-3,12
FCSB,2898,1,7,7,0,25,12,13,28
CFR Cluj,2898,2,5,7,2,14,9,5,22
Universitate,2898,3,4,6,4,16,19,-3,18
D Bucuresti,2898,4,4,4,6,18,20,-2,16
FC Botosani,2898,5,3,5,6,6,14,-8,14
Concordia Ch,2898,6,3,3,8,16,21,-5,12
FCSB,2899,1,7,6,1,24,12,12,27
CFR Cluj,2899,2,6,6,2,15,10,5,24
Universitate,2899,3,4,6,4,16,18,-2,18
D Bucuresti,2899,4,4,5,5,19,20,-1,17
FC Botosani,2899,5,4,5,5,9,14,-5,17
Concordia Ch,2899,6,2,2,10,17,26,-9,8
FCSB,2900,1,7,6,1,23,11,12,27
CFR Cluj,2900,2,7,6,1,15,7,8,27
FC Botosani,2900,3,4,5,5,9,15,-6,17
Universitate,2900,4,3,6,5,14,19,-5,15
D Bucuresti,2900,5,3,4,7,17,24,-7,13
Concordia Ch,2900,6,3,3,8,21,23,-2,12
FCSB,2901,1,9,5,0,28,11,17,32
CFR Cluj,2901,2,5,6,3,13,12,1,21
Universitate,2901,3,4,5,5,17,20,-3,17
D Bucuresti,2901,4,4,4,6,18,22,-4,16
FC Botosani,2901,5,3,5,6,5,13,-8,14
Concordia Ch,2901,6,3,3,8,19,22,-3,12
FCSB,2902,1,7,6,1,23,14,9,27
CFR Cluj,2902,2,6,7,1,15,7,8,25
D Bucuresti,2902,3,4,5,5,22,20,2,17
Universitate,2902,4,4,5,5,18,20,-2,17
FC Botosani,2902,5,3,4,7,6,18,-12,13
Concordia Ch,2902,6,3,3,8,19,24,-5,12
FCSB,2903,1,7,6,1,27,17,10,27
CFR Cluj,2903,2,6,7,1,18,9,9,25
D Bucuresti,2903,3,4,5,5,20,20,0,17
Universitate,2903,4,3,7,4,18,22,-4,16
FC Botosani,2903,5,4,4,6,8,16,-8,16
Concordia Ch,2903,6,2,3,9,17,24,-7,9
FCSB,2904,1,8,6,0,25,11,14,30
CFR Cluj,2904,2,6,6,2,15,9,6,24
FC Botosani,2904,3,4,5,5,7,13,-6,17
Universitate,2904,4,3,6,5,14,19,-5,15
D Bucuresti,2904,5,3,4,7,20,24,-4,13
Concordia Ch,2904,6,3,3,8,21,26,-5,12
FCSB,2905,1,8,5,1,27,14,13,29
CFR Cluj,2905,2,5,6,3,15,13,2,21
Universitate,2905,3,5,5,4,19,19,0,20
D Bucuresti,2905,4,4,4,6,20,20,0,16
FC Botosani,2905,5,4,4,6,8,16,-8,16
Concordia Ch,2905,6,3,2,9,18,25,-7,11
FCSB,2906,1,8,5,1,25,12,13,29
CFR Cluj,2906,2,5,6,3,14,10,4,21
Universitate,2906,3,5,5,4,16,18,-2,20
D Bucuresti,2906,4,5,4,5,19,18,1,19
FC Botosani,2906,5,3,4,7,6,15,-9,13
Concordia Ch,2906,6,3,2,9,17,24,-7,11
FCSB,2907,1,8,6,0,26,12,14,30
CFR Cluj,2907,2,5,7,2,17,12,5,22
FC Botosani,2907,3,4,5,5,8,13,-5,17
Universitate,2907,4,3,7,4,20,24,-4,16
D Bucuresti,2907,5,3,5,6,18,22,-4,14
Concordia Ch,2907,6,2,4,8,18,24,-6,10
FCSB,2908,1,8,5,1,29,15,14,29
CFR Cluj,2908,2,5,7,2,14,10,4,22
Universitate,2908,3,4,6,4,18,21,-3,18
D Bucuresti,2908,4,4,5,5,23,20,3,17
FC Botosani,2908,5,3,6,5,7,14,-7,15
Concordia Ch,2908,6,2,3,9,15,26,-11,9
FCSB,2909,1,8,5,1,26,11,15,29
CFR Cluj,2909,2,6,6,2,14,10,4,24
D Bucuresti,2909,3,4,5,5,18,18,0,17
Universitate,2909,4,4,5,5,15,19,-4,17
FC Botosani,2909,5,3,4,7,5,17,-12,13
Concordia Ch,2909,6,3,3,8,18,21,-3,12
FCSB,2910,1,7,6,1,26,14,12,27
CFR Cluj,2910,2,7,6,1,19,10,9,27
Universitate,2910,3,3,6,5,16,22,-6,15
FC Botosani,2910,4,3,6,5,9,16,-7,15
D Bucuresti,2910,5,3,5,6,18,21,-3,14
Concordia Ch,2910,6,3,3,8,20,25,-5,12
FCSB,2911,1,8,6,0,24,10,14,30
CFR Cluj,2911,2,6,7,1,15,7,8,25
D Bucuresti,2911,3,4,5,5,19,19,0,17
Universitate,2911,4,3,5,6,14,21,-7,14
FC Botosani,2911,5,3,5,6,7,15,-8,14
Concordia Ch,2911,6,3,2,9,17,24,-7,11
FCSB,2912,1,8,5,1,26,12,14,29
CFR Cluj,2912,2,5,7,2,13,10,3,22
Universitate,2912,3,4,6,4,16,18,-2,18
D Bucuresti,2912,4,4,5,5,19,19,0,17
FC Botosani,2912,5,3,5,6,5,14,-9,14
Concordia Ch,2912,6,3,2,9,18,24,-6,11
FCSB,2913,1,9,5,0,28,12,16,32
CFR Cluj,2913,2,5,6,3,15,11,4,21
D Bucuresti,2913,3,4,5,5,21,21,0,17
Universitate,2913,4,4,5,5,15,20,-5,17
FC Botosani,2913,5,3,4,7,6,16,-10,13
Concordia Ch,2913,6,3,3,8,20,25,-5,12
FCSB,2914,1,7,5,2,24,15,9,26
CFR Cluj,2914,2,6,7,1,16,8,8,25
Universitate,2914,3,4,6,4,16,18,-2,18
D Bucuresti,2914,4,4,5,5,19,20,-1,17
FC Botosani,2914,5,3,5,6,6,14,-8,14
Concordia Ch,2914,6,2,4,8,16,22,-6,10
FCSB,2915,1,8,6,0,26,12,14,30
CFR Cluj,2915,2,5,7,2,14,9,5,22
D Bucuresti,2915,3,4,5,5,22,22,0,17
Universitate,2915,4,3,7,4,17,21,-4,16
FC Botosani,2915,5,3,5,6,7,16,-9,14
Concordia Ch,2915,6,2,4,8,17,23,-6,10
FCSB,2916,1,9,5,0,28,11,17,32
CFR Cluj,2916,2,5,6,3,14,11,3,21
Universitate,2916,3,4,5,5,16,21,-5,17
FC Botosani,2916,4,3,6,5,6,13,-7,15
D Bucuresti,2916,5,3,5,6,17,20,-3,14
Concordia Ch,2916,6,3,3,8,16,21,-5,12
FCSB,2917,1,7,6,1,25,15,10,27
CFR Cluj,2917,2,6,6,2,16,9,7,24
Universitate,2917,3,4,6,4,18,20,-2,18
FC Botosani,2917,4,4,5,5,9,14,-5,17
D Bucuresti,2917,5,4,4,6,17,20,-3,16
Concordia Ch,2917,6,2,3,9,17,24,-7,9
FCSB,2918,1,8,6,0,24,10,14,30
CFR Cluj,2918,2,5,7,2,13,8,5,22
FC Botosani,2918,3,5,4,5,9,13,-4,19
D Bucuresti,2918,4,4,4,6,19,22,-3,16
Universitate,2918,5,3,7,4,14,18,-4,16
Concordia Ch,2918,6,2,2,10,16,24,-8,8
FCSB,2919,1,8,5,1,28,13,15,29
CFR Cluj,2919,2,5,6,3,13,13,0,21
Universitate,2919,3,5,5,4,19,19,0,20
D Bucuresti,2919,4,4,4,6,19,22,-3,16
FC Botosani,2919,5,3,5,6,9,17,-8,14
Concordia Ch,2919,6,3,3,8,19,23,-4,12
CFR Cluj,2920,1,7,6,1,18,7,11,27
FCSB,2920,2,7,5,2,23,14,9,26
Universitate,2920,3,4,5,5,17,22,-5,17
D Bucuresti,2920,4,3,6,5,17,19,-2,15
FC Botosani,2920,5,3,6,5,5,12,-7,15
Concordia Ch,2920,6,2,4,8,16,22,-6,10
FCSB,2921,1,7,5,2,25,14,11,26
CFR Cluj,2921,2,6,7,1,16,9,7,25
FC Botosani,2921,3,5,4,5,8,13,-5,19
Universitate,2921,4,4,6,4,15,18,-3,18
D Bucuresti,2921,5,4,4,6,20,20,0,16
Concordia Ch,2921,6,2,2,10,15,25,-10,8
FCSB,2922,1,8,5,1,27,12,15,29
CFR Cluj,2922,2,6,6,2,15,9,6,24
Universitate,2922,3,4,5,5,17,23,-6,17
FC Botosani,2922,4,4,5,5,9,15,-6,17
D Bucuresti,2922,5,3,4,7,18,22,-4,13
Concordia Ch,2922,6,3,3,8,17,22,-5,12
FCSB,2923,1,8,5,1,24,12,12,29
CFR Cluj,2923,2,6,6,2,15,10,5,24
Universitate,2923,3,4,5,5,17,19,-2,17
D Bucuresti,2923,4,4,4,6,20,21,-1,16
FC Botosani,2923,5,4,4,6,8,16,-8,16
Concordia Ch,2923,6,3,2,9,17,23,-6,11
FCSB,2924,1,7,6,1,24,12,12,27
CFR Cluj,2924,2,5,7,2,14,9,5,22
Universitate,2924,3,5,5,4,16,18,-2,20
FC Botosani,2924,4,4,5,5,7,12,-5,17
D Bucuresti,2924,5,3,5,6,17,21,-4,14
Concordia Ch,2924,6,2,4,8,16,22,-6,10
FCSB,2925,1,8,6,0,26,11,15,30
CFR Cluj,2925,2,5,6,3,13,10,3,21
Universitate,2925,3,4,6,4,16,19,-3,18
Concordia Ch,2925,4,4,2,8,19,21,-2,14
D Bucuresti,2925,5,3,5,6,18,22,-4,14
FC Botosani,2925,6,3,5,6,7,16,-9,14
FCSB,2926,1,7,7,0,27,14,13,28
CFR Cluj,2926,2,5,8,1,15,9,6,23
Universitate,2926,3,3,7,4,16,20,-4,16
D Bucuresti,2926,4,3,6,5,17,19,-2,15
FC Botosani,2926,5,3,5,6,7,15,-8,14
Concordia Ch,2926,6,3,3,8,19,24,-5,12
FCSB,2927,1,8,5,1,29,13,16,29
CFR Cluj,2927,2,5,7,2,13,11,2,22
Universitate,2927,3,4,6,4,17,20,-3,18
FC Botosani,2927,4,4,4,6,7,16,-9,16
D Bucuresti,2927,5,3,5,6,17,20,-3,14
Concordia Ch,2927,6,3,3,8,20,23,-3,12
FCSB,2928,1,9,5,0,29,12,17,32
CFR Cluj,2928,2,6,6,2,16,10,6,24
D Bucuresti,2928,3,5,4,5,20,20,0,19
FC Botosani,2928,4,4,4,6,7,14,-7,16
Universitate,2928,5,3,5,6,14,22,-8,14
Concordia Ch,2928,6,2,2,10,18,26,-8,8
FCSB,2929,1,8,6,0,26,12,14,30
CFR Cluj,2929,2,5,8,1,13,7,6,23
FC Botosani,2929,3,5,4,5,9,14,-5,19
Universitate,2929,4,3,6,5,16,21,-5,15
D Bucuresti,2929,5,3,4,7,16,21,-5,13
Concordia Ch,2929,6,3,2,9,19,24,-5,11
FCSB,2930,1,8,6,0,25,11,14,30
CFR Cluj,2930,2,5,7,2,13,8,5,22
D Bucuresti,2930,3,4,5,5,19,20,-1,17
Universitate,2930,4,3,7,4,15,19,-4,16
FC Botosani,2930,5,3,5,6,6,15,-9,14
Concordia Ch,2930,6,3,2,9,18,23,-5,11
FCSB,2931,1,8,5,1,26,12,14,29
CFR Cluj,2931,2,6,6,2,14,9,5,24
Universitate,2931,3,4,5,5,16,20,-4,17
FC Botosani,2931,4,4,4,6,7,14,-7,16
D Bucuresti,2931,5,3,5,6,17,20,-3,14
Concordia Ch,2931,6,3,3,8,18,23,-5,12
CFR Cluj,2932,1,7,6,1,19,9,10,27
FCSB,2932,2,7,5,2,24,14,10,26
D Bucuresti,2932,3,4,5,5,18,19,-1,17
Universitate,2932,4,4,5,5,16,21,-5,17
FC Botosani,2932,5,4,5,5,7,13,-6,17
Concordia Ch,2932,6,2,2,10,15,23,-8,8
FCSB,2933,1,8,6,0,26,12,14,30
CFR Cluj,2933,2,6,6,2,16,10,6,24
D Bucuresti,2933,3,5,4,5,23,18,5,19
Universitate,2933,4,3,6,5,14,19,-5,15
FC Botosani,2933,5,3,5,6,8,20,-12,14
Concordia Ch,2933,6,2,3,9,18,26,-8,9
FCSB,2934,1,8,5,1,27,14,13,29
CFR Cluj,2934,2,6,6,2,15,9,6,24
D Bucuresti,2934,3,5,4,5,19,19,0,19
Universitate,2934,4,4,5,5,18,22,-4,17
FC Botosani,2934,5,4,4,6,7,13,-6,16
Concordia Ch,2934,6,2,2,10,16,25,-9,8
FCSB,2935,1,7,7,0,24,11,13,28
CFR Cluj,2935,2,5,8,1,13,7,6,23
D Bucuresti,2935,3,4,5,5,18,19,-1,17
Universitate,2935,4,3,7,4,15,19,-4,16
FC Botosani,2935,5,3,4,7,5,14,-9,13
Concordia Ch,2935,6,3,3,8,17,22,-5,12
FCSB,2936,1,8,5,1,26,13,13,29
CFR Cluj,2936,2,5,6,3,14,12,2,21
Universitate,2936,3,5,5,4,19,19,0,20
D Bucuresti,2936,4,3,6,5,20,22,-2,15
FC Botosani,2936,5,3,6,5,9,16,-7,15
Concordia Ch,2936,6,2,4,8,17,23,-6,10
FCSB,2937,1,8,5,1,25,13,12,29
CFR Cluj,2937,2,6,6,2,18,10,8,24
D Bucuresti,2937,3,5,4,5,22,21,1,19
Universitate,2937,4,4,5,5,17,22,-5,17
FC Botosani,2937,5,3,4,7,6,16,-10,13
Concordia Ch,2937,6,3,2,9,19,25,-6,11
FCSB,2938,1,7,7,0,25,12,13,28
CFR Cluj,2938,2,6,7,1,16,8,8,25
FC Botosani,2938,3,4,5,5,6,12,-6,17
Universitate,2938,4,3,6,5,15,21,-6,15
D Bucuresti,2938,5,3,5,6,18,21,-3,14
Concordia Ch,2938,6,2,4,8,17,23,-6,10
FCSB,2939,1,8,5,1,27,14,13,29
CFR Cluj,2939,2,7,6,1,18,10,8,27
D Bucuresti,2939,3,4,5,5,20,21,-1,17
Universitate,2939,4,3,5,6,18,24,-6,14
FC Botosani,2939,5,3,4,7,6,15,-9,13
Concordia Ch,2939,6,3,3,8,18,23,-5,12
FCSB,2940,1,7,5,2,24,14,10,26
CFR Cluj,2940,2,6,6,2,16,10,6,24
Universitate,2940,3,5,5,4,20,21,-1,20
D Bucuresti,2940,4,4,4,6,19,20,-1,16
FC Botosani,2940,5,4,4,6,7,15,-8,16
Concordia Ch,2940,6,3,2,9,17,23,-6,11
FCSB,2941,1,7,7,0,23,10,13,28
CFR Cluj,2941,2,6,7,1,17,10,7,25
FC Botosani,2941,3,4,5,5,8,13,-5,17
Universitate,2941,4,3,6,5,17,22,-5,15
D Bucuresti,2941,5,3,5,6,17,20,-3,14
Concordia Ch,2941,6,3,2,9,16,23,-7,11
FCSB,2942,1,7,6,1,24,12,12,27
CFR Cluj,2942,2,7,6,1,20,8,12,27
FC Botosani,2942,3,3,6,5,6,13,-7,15
Universitate,2942,4,3,6,5,14,23,-9,15
D Bucuresti,2942,5,3,5,6,17,20,-3,14
Concordia Ch,2942,6,3,3,8,16,21,-5,12
FCSB,2943,1,7,5,2,23,13,10,26
CFR Cluj,2943,2,6,6,2,14,8,6,24
Universitate,2943,3,5,5,4,17,18,-1,20
FC Botosani,2943,4,5,4,5,8,13,-5,19
D Bucuresti,2943,5,4,4,6,19,20,-1,16
Concordia Ch,2943,6,2,2,10,17,26,-9,8
FCSB,2944,1,8,6,0,27,12,15,30
CFR Cluj,2944,2,5,6,3,13,11,2,21
Universitate,2944,3,4,6,4,18,20,-2,18
FC Botosani,2944,4,4,5,5,8,13,-5,17
D Bucuresti,2944,5,4,4,6,17,20,-3,16
Concordia Ch,2944,6,2,3,9,16,23,-7,9
FCSB,2945,1,7,7,0,25,12,13,28
CFR Cluj,2945,2,6,7,1,19,8,11,25
D Bucuresti,2945,3,4,4,6,20,23,-3,16
FC Botosani,2945,4,4,4,6,9,14,-5,16
Universitate,2945,5,3,6,5,15,24,-9,15
Concordia Ch,2945,6,3,2,9,19,26,-7,11
FCSB,2946,1,8,6,0,26,11,15,30
CFR Cluj,2946,2,6,6,2,15,9,6,24
D Bucuresti,2946,3,5,4,5,20,19,1,19
Universitate,2946,4,3,6,5,15,21,-6,15
FC Botosani,2946,5,3,5,6,6,14,-8,14
Concordia Ch,2946,6,2,3,9,15,23,-8,9
FCSB,2947,1,7,6,1,25,13,12,27
CFR Cluj,2947,2,6,7,1,16,9,7,25
D Bucuresti,2947,3,4,5,5,17,18,-1,17
Universitate,2947,4,4,5,5,15,19,-4,17
FC Botosani,2947,5,3,5,6,5,13,-8,14
Concordia Ch,2947,6,3,2,9,16,22,-6,11
FCSB,2948,1,9,5,0,25,10,15,32
CFR Cluj,2948,2,6,6,2,14,8,6,24
D Bucuresti,2948,3,3,6,5,18,20,-2,15
Universitate,2948,4,3,5,6,14,20,-6,14
FC Botosani,2948,5,3,5,6,6,15,-9,14
Concordia Ch,2948,6,3,3,8,18,22,-4,12
FCSB,2949,1,7,7,0,25,12,13,28
CFR Cluj,2949,2,6,7,1,17,8,9,25
D Bucuresti,2949,3,5,4,5,22,21,1,19
Universitate,2949,4,3,6,5,15,22,-7,15
FC Botosani,2949,5,3,4,7,7,17,-10,13
Concordia Ch,2949,6,3,2,9,17,23,-6,11
FCSB,2950,1,9,5,0,27,11,16,32
CFR Cluj,2950,2,5,6,3,14,11,3,21
Universitate,2950,3,4,5,5,16,20,-4,17
FC Botosani,2950,4,4,4,6,8,14,-6,16
D Bucuresti,2950,5,3,5,6,16,20,-4,14
Concordia Ch,2950,6,3,3,8,17,22,-5,12
FCSB,2951,1,8,6,0,26,11,15,30
CFR Cluj,2951,2,6,6,2,16,11,5,24
FC Botosani,2951,3,4,5,5,7,13,-6,17
Universitate,2951,4,3,6,5,15,20,-5,15
D Bucuresti,2951,5,3,4,7,17,24,-7,13
Concordia Ch,2951,6,3,3,8,21,23,-2,12
FCSB,2952,1,8,6,0,25,11,14,30
CFR Cluj,2952,2,5,7,2,14,9,5,22
D Bucuresti,2952,3,4,4,6,19,21,-2,16
Universitate,2952,4,3,7,4,14,18,-4,16
Concordia Ch,2952,5,4,2,8,18,22,-4,14
FC Botosani,2952,6,3,4,7,6,15,-9,13
FCSB,2953,1,8,5,1,26,14,12,29
CFR Cluj,2953,2,6,7,1,17,9,8,25
D Bucuresti,2953,3,4,4,6,19,21,-2,16
Universitate,2953,4,3,6,5,16,21,-5,15
Concordia Ch,2953,5,4,2,8,20,22,-2,14
FC Botosani,2953,6,3,4,7,7,18,-11,13
FCSB,2954,1,7,6,1,24,12,12,27
CFR Cluj,2954,2,5,7,2,13,9,4,22
Universitate,2954,3,5,5,4,18,19,-1,20
D Bucuresti,2954,4,4,5,5,17,18,-1,17
FC Botosani,2954,5,3,6,5,6,13,-7,15
Concordia Ch,2954,6,2,3,9,16,23,-7,9
FCSB,2955,1,9,5,0,26,10,16,32
CFR Cluj,2955,2,6,6,2,14,8,6,24
D Bucuresti,2955,3,4,5,5,18,19,-1,17
FC Botosani,2955,4,4,4,6,7,14,-7,16
Universitate,2955,5,3,5,6,14,21,-7,14
Concordia Ch,2955,6,2,3,9,17,24,-7,9
FCSB,2956,1,8,6,0,25,11,14,30
CFR Cluj,2956,2,5,7,2,13,8,5,22
D Bucuresti,2956,3,4,4,6,19,21,-2,16
Universitate,2956,4,3,7,4,15,19,-4,16
Concordia Ch,2956,5,4,2,8,20,23,-3,14
FC Botosani,2956,6,3,4,7,7,17,-10,13
FCSB,2957,1,8,5,1,26,13,13,29
CFR Cluj,2957,2,6,7,1,15,8,7,25
FC Botosani,2957,3,4,5,5,7,13,-6,17
Universitate,2957,4,3,6,5,17,22,-5,15
D Bucuresti,2957,5,3,4,7,18,22,-4,13
Concordia Ch,2957,6,3,3,8,17,22,-5,12
FCSB,2958,1,7,6,1,25,14,11,27
CFR Cluj,2958,2,6,7,1,17,9,8,25
Universitate,2958,3,4,5,5,16,20,-4,17
D Bucuresti,2958,4,4,4,6,18,23,-5,16
FC Botosani,2958,5,4,4,6,7,14,-7,16
Concordia Ch,2958,6,3,2,9,19,22,-3,11
FCSB,2959,1,7,6,1,23,12,11,27
CFR Cluj,2959,2,6,7,1,14,7,7,25
Universitate,2959,3,4,5,5,16,19,-3,17
FC Botosani,2959,4,3,6,5,7,14,-7,15
D Bucuresti,2959,5,3,5,6,17,20,-3,14
Concordia Ch,2959,6,3,3,8,19,24,-5,12
FCSB,2960,1,8,5,1,28,14,14,29
CFR Cluj,2960,2,7,6,1,18,10,8,27
D Bucuresti,2960,3,4,4,6,19,20,-1,16
FC Botosani,2960,4,4,4,6,7,15,-8,16
Universitate,2960,5,3,5,6,16,23,-7,14
Concordia Ch,2960,6,3,2,9,17,23,-6,11
FCSB,2961,1,7,6,1,23,11,12,27
CFR Cluj,2961,2,5,7,2,14,9,5,22
Universitate,2961,3,5,5,4,17,19,-2,20
FC Botosani,2961,4,4,5,5,6,12,-6,17
D Bucuresti,2961,5,3,5,6,17,20,-3,14
Concordia Ch,2961,6,2,4,8,16,22,-6,10
FCSB,2962,1,9,5,0,26,10,16,32
CFR Cluj,2962,2,5,7,2,13,9,4,22
Universitate,2962,3,3,6,5,14,19,-5,15
FC Botosani,2962,4,3,6,5,7,14,-7,15
D Bucuresti,2962,5,3,5,6,18,23,-5,14
Concordia Ch,2962,6,3,3,8,18,21,-3,12
FCSB,2963,1,8,5,1,26,13,13,29
CFR Cluj,2963,2,6,6,2,16,11,5,24
Universitate,2963,3,4,5,5,19,22,-3,17
FC Botosani,2963,4,4,5,5,8,13,-5,17
D Bucuresti,2963,5,3,5,6,20,23,-3,14
Concordia Ch,2963,6,3,2,9,19,26,-7,11
FCSB,2964,1,8,5,1,26,13,13,29
CFR Cluj,2964,2,6,6,2,16,10,6,24
Universitate,2964,3,4,5,5,16,20,-4,17
Concordia Ch,2964,4,4,2,8,19,21,-2,14
D Bucuresti,2964,5,3,5,6,17,22,-5,14
FC Botosani,2964,6,3,5,6,6,14,-8,14
FCSB,2965,1,8,5,1,26,14,12,29
CFR Cluj,2965,2,6,6,2,16,10,6,24
FC Botosani,2965,3,5,4,5,9,13,-4,19
Universitate,2965,4,4,5,5,18,21,-3,17
D Bucuresti,2965,5,4,4,6,20,22,-2,16
Concordia Ch,2965,6,2,2,10,17,26,-9,8
FCSB,2966,1,8,6,0,28,12,16,30
CFR Cluj,2966,2,5,7,2,15,10,5,22
FC Botosani,2966,3,5,4,5,9,14,-5,19
Universitate,2966,4,4,5,5,15,21,-6,17
D Bucuresti,2966,5,3,5,6,19,22,-3,14
Concordia Ch,2966,6,2,3,9,16,23,-7,9
FCSB,2967,1,9,5,0,27,11,16,32
CFR Cluj,2967,2,5,6,3,13,10,3,21
FC Botosani,2967,3,5,4,5,8,12,-4,19
Universitate,2967,4,4,5,5,17,21,-4,17
D Bucuresti,2967,5,3,4,7,16,21,-5,13
Concordia Ch,2967,6,3,2,9,17,23,-6,11
FCSB,2968,1,7,5,2,25,15,10,26
CFR Cluj,2968,2,6,7,1,16,9,7,25
Universitate,2968,3,4,6,4,18,20,-2,18
D Bucuresti,2968,4,4,4,6,17,20,-3,16
FC Botosani,2968,5,4,4,6,7,14,-7,16
Concordia Ch,2968,6,3,2,9,18,23,-5,11
FCSB,2969,1,9,5,0,27,11,16,32
CFR Cluj,2969,2,6,6,2,15,10,5,24
FC Botosani,2969,3,5,4,5,8,13,-5,19
D Bucuresti,2969,4,3,5,6,17,20,-3,14
Universitate,2969,5,3,5,6,14,20,-6,14
Concordia Ch,2969,6,2,3,9,15,22,-7,9
FCSB,2970,1,8,6,0,27,11,16,30
CFR Cluj,2970,2,6,7,1,15,8,7,25
FC Botosani,2970,3,4,5,5,9,14,-5,17
Universitate,2970,4,3,5,6,14,22,-8,14
D Bucuresti,2970,5,3,4,7,16,21,-5,13
Concordia Ch,2970,6,3,3,8,18,23,-5,12
FCSB,2971,1,9,5,0,28,11,17,32
CFR Cluj,2971,2,5,6,3,14,10,4,21
D Bucuresti,2971,3,4,5,5,17,18,-1,17
FC Botosani,2971,4,4,5,5,8,12,-4,17
Universitate,2971,5,4,5,5,15,21,-6,17
Concordia Ch,2971,6,2,2,10,15,25,-10,8
FCSB,2972,1,8,6,0,24,10,14,30
CFR Cluj,2972,2,5,6,3,13,9,4,21
Universitate,2972,3,4,6,4,15,18,-3,18
D Bucuresti,2972,4,4,4,6,18,21,-3,16
FC Botosani,2972,5,4,4,6,7,14,-7,16
Concordia Ch,2972,6,3,2,9,17,22,-5,11
FCSB,2973,1,8,6,0,26,12,14,30
CFR Cluj,2973,2,6,7,1,17,9,8,25
D Bucuresti,2973,3,4,4,6,17,20,-3,16
Concordia Ch,2973,4,4,2,8,19,21,-2,14
Universitate,2973,5,3,5,6,14,21,-7,14
FC Botosani,2973,6,3,4,7,5,15,-10,13
FCSB,2974,1,8,5,1,28,11,17,29
CFR Cluj,2974,2,5,7,2,14,13,1,22
Universitate,2974,3,4,6,4,16,19,-3,18
D Bucuresti,2974,4,4,5,5,18,19,-1,17
FC Botosani,2974,5,3,5,6,5,13,-8,14
Concordia Ch,2974,6,2,4,8,16,22,-6,10
FCSB,2975,1,9,5,0,26,10,16,32
CFR Cluj,2975,2,5,7,2,13,8,5,22
D Bucuresti,2975,3,3,6,5,17,19,-2,15
Universitate,2975,4,3,6,5,14,20,-6,15
FC Botosani,2975,5,3,6,5,5,12,-7,15
Concordia Ch,2975,6,2,4,8,16,22,-6,10
FCSB,2976,1,9,5,0,26,11,15,32
CFR Cluj,2976,2,5,7,2,13,8,5,22
D Bucuresti,2976,3,5,4,5,19,18,1,19
FC Botosani,2976,4,4,4,6,6,14,-8,16
Universitate,2976,5,3,6,5,15,20,-5,15
Concordia Ch,2976,6,2,2,10,15,23,-8,8
FCSB,2977,1,7,6,1,24,12,12,27
CFR Cluj,2977,2,5,7,2,14,10,4,22
Universitate,2977,3,5,5,4,17,18,-1,20
D Bucuresti,2977,4,4,5,5,19,20,-1,17
FC Botosani,2977,5,4,5,5,9,14,-5,17
Concordia Ch,2977,6,2,2,10,17,26,-9,8
CFR Cluj,2978,1,7,6,1,16,8,8,27
FCSB,2978,2,7,5,2,25,15,10,26
D Bucuresti,2978,3,4,5,5,17,18,-1,17
Universitate,2978,4,4,5,5,17,20,-3,17
FC Botosani,2978,5,4,5,5,6,12,-6,17
Concordia Ch,2978,6,2,2,10,15,23,-8,8
FCSB,2979,1,8,6,0,26,10,16,30
CFR Cluj,2979,2,6,7,1,15,7,8,25
D Bucuresti,2979,3,5,4,5,19,19,0,19
Universitate,2979,4,3,5,6,14,23,-9,14
FC Botosani,2979,5,3,4,7,6,15,-9,13
Concordia Ch,2979,6,3,2,9,18,24,-6,11
FCSB,2980,1,9,5,0,27,10,17,32
CFR Cluj,2980,2,6,6,2,17,9,8,24
D Bucuresti,2980,3,5,4,5,23,20,3,19
FC Botosani,2980,4,4,4,6,8,17,-9,16
Universitate,2980,5,3,5,6,15,25,-10,14
Concordia Ch,2980,6,2,2,10,17,26,-9,8
FCSB,2981,1,7,7,0,23,10,13,28
CFR Cluj,2981,2,6,7,1,14,7,7,25
D Bucuresti,2981,3,4,4,6,18,20,-2,16
FC Botosani,2981,4,4,4,6,6,13,-7,16
Universitate,2981,5,3,6,5,14,19,-5,15
Concordia Ch,2981,6,3,2,9,17,23,-6,11
FCSB,2982,1,8,5,1,25,12,13,29
CFR Cluj,2982,2,6,6,2,15,10,5,24
Universitate,2982,3,4,5,5,17,20,-3,17
FC Botosani,2982,4,4,5,5,7,13,-6,17
D Bucuresti,2982,5,3,5,6,18,21,-3,14
Concordia Ch,2982,6,3,2,9,17,23,-6,11
FCSB,2983,1,7,7,0,23,10,13,28
CFR Cluj,2983,2,5,8,1,13,7,6,23
Universitate,2983,3,3,7,4,14,18,-4,16
FC Botosani,2983,4,3,6,5,8,15,-7,15
D Bucuresti,2983,5,3,5,6,18,23,-5,14
Concordia Ch,2983,6,3,3,8,19,22,-3,12
FCSB,2984,1,9,5,0,28,11,17,32
CFR Cluj,2984,2,6,6,2,17,10,7,24
D Bucuresti,2984,3,5,4,5,18,18,0,19
FC Botosani,2984,4,4,4,6,6,13,-7,16
Universitate,2984,5,3,5,6,14,23,-9,14
Concordia Ch,2984,6,2,2,10,15,23,-8,8
FCSB,2985,1,8,5,1,25,13,12,29
CFR Cluj,2985,2,6,6,2,16,9,7,24
Universitate,2985,3,4,5,5,16,20,-4,17
D Bucuresti,2985,4,4,4,6,20,21,-1,16
Concordia Ch,2985,5,4,2,8,19,23,-4,14
FC Botosani,2985,6,3,4,7,5,15,-10,13
FCSB,2986,1,8,6,0,26,11,15,30
CFR Cluj,2986,2,5,7,2,13,9,4,22
D Bucuresti,2986,3,4,5,5,20,20,0,17
Universitate,2986,4,4,5,5,17,21,-4,17
FC Botosani,2986,5,3,4,7,5,15,-10,13
Concordia Ch,2986,6,3,3,8,18,23,-5,12
FCSB,2987,1,9,5,0,27,11,16,32
CFR Cluj,2987,2,6,6,2,15,10,5,24
D Bucuresti,2987,3,4,5,5,17,18,-1,17
FC Botosani,2987,4,4,5,5,9,13,-4,17
Universitate,2987,5,3,5,6,16,22,-6,14
Concordia Ch,2987,6,2,2,10,16,26,-10,8
FCSB,2988,1,7,6,1,24,13,11,27
CFR Cluj,2988,2,6,7,1,17,9,8,25
Universitate,2988,3,3,7,4,15,19,-4,16
FC Botosani,2988,4,3,6,5,5,12,-7,15
D Bucuresti,2988,5,3,5,6,16,20,-4,14
Concordia Ch,2988,6,3,3,8,17,21,-4,12
FCSB,2989,1,7,7,0,26,13,13,28
CFR Cluj,2989,2,5,7,2,16,11,5,22
Universitate,2989,3,4,6,4,17,20,-3,18
D Bucuresti,2989,4,4,5,5,20,21,-1,17
FC Botosani,2989,5,3,5,6,7,15,-8,14
Concordia Ch,2989,6,3,2,9,17,23,-6,11
FCSB,2990,1,9,5,0,28,11,17,32
CFR Cluj,2990,2,5,7,2,15,12,3,22
FC Botosani,2990,3,4,5,5,9,14,-5,17
Universitate,2990,4,3,6,5,17,22,-5,15
D Bucuresti,2990,5,3,5,6,17,22,-5,14
Concordia Ch,2990,6,3,2,9,19,24,-5,11
FCSB,2991,1,8,6,0,24,10,14,30
CFR Cluj,2991,2,5,7,2,13,8,5,22
Universitate,2991,3,4,5,5,15,19,-4,17
FC Botosani,2991,4,4,5,5,9,14,-5,17
D Bucuresti,2991,5,3,4,7,16,23,-7,13
Concordia Ch,2991,6,3,3,8,20,23,-3,12
CFR Cluj,2992,1,7,6,1,15,7,8,27
FCSB,2992,2,7,5,2,23,12,11,26
D Bucuresti,2992,3,5,4,5,20,20,0,19
Universitate,2992,4,4,5,5,15,19,-4,17
FC Botosani,2992,5,3,4,7,5,15,-10,13
Concordia Ch,2992,6,3,2,9,19,24,-5,11
FCSB,2993,1,8,6,0,26,10,16,30
CFR Cluj,2993,2,5,7,2,13,10,3,22
FC Botosani,2993,3,5,4,5,9,14,-5,19
D Bucuresti,2993,4,4,4,6,19,20,-1,16
Universitate,2993,5,3,7,4,14,18,-4,16
Concordia Ch,2993,6,2,2,10,16,25,-9,8
FCSB,2994,1,8,6,0,26,11,15,30
CFR Cluj,2994,2,5,7,2,14,11,3,22
D Bucuresti,2994,3,4,5,5,19,20,-1,17
Universitate,2994,4,4,5,5,19,22,-3,17
FC Botosani,2994,5,4,5,5,9,15,-6,17
Concordia Ch,2994,6,2,2,10,18,26,-8,8
FCSB,2995,1,7,6,1,25,14,11,27
CFR Cluj,2995,2,6,6,2,16,9,7,24
Universitate,2995,3,4,6,4,16,19,-3,18
D Bucuresti,2995,4,4,4,6,18,20,-2,16
Concordia Ch,2995,5,4,2,8,18,21,-3,14
FC Botosani,2995,6,3,4,7,5,15,-10,13
FCSB,2996,1,8,6,0,25,11,14,30
CFR Cluj,2996,2,6,6,2,16,8,8,24
D Bucuresti,2996,3,5,4,5,19,19,0,19
FC Botosani,2996,4,4,4,6,7,13,-6,16
Universitate,2996,5,3,6,5,15,22,-7,15
Concordia Ch,2996,6,2,2,10,16,25,-9,8
FCSB,2997,1,7,6,1,23,11,12,27
CFR Cluj,2997,2,5,7,2,13,8,5,22
Universitate,2997,3,5,5,4,16,18,-2,20
D Bucuresti,2997,4,5,4,5,23,21,2,19
FC Botosani,2997,5,3,4,7,6,18,-12,13
Concordia Ch,2997,6,3,2,9,19,24,-5,11
FCSB,2998,1,8,5,1,26,14,12,29
CFR Cluj,2998,2,6,6,2,17,10,7,24
Universitate,2998,3,4,5,5,17,21,-4,17
FC Botosani,2998,4,3,6,5,7,14,-7,15
D Bucuresti,2998,5,3,5,6,18,21,-3,14
Concordia Ch,2998,6,3,3,8,18,23,-5,12
FCSB,2999,1,8,6,0,26,11,15,30
CFR Cluj,2999,2,5,7,2,13,10,3,22
D Bucuresti,2999,3,4,5,5,19,19,0,17
Universitate,2999,4,4,5,5,18,21,-3,17
FC Botosani,2999,5,4,4,6,8,15,-7,16
Concordia Ch,2999,6,2,3,9,15,23,-8,9
FCSB,3000,1,8,5,1,26,14,12,29
CFR Cluj,3000,2,6,6,2,15,9,6,24
Universitate,3000,3,4,5,5,17,20,-3,17
D Bucuresti,3000,4,4,4,6,19,21,-2,16
FC Botosani,3000,5,4,4,6,9,16,-7,16
Concordia Ch,3000,6,3,2,9,19,25,-6,11
FCSB,3001,1,8,5,1,25,11,14,29
CFR Cluj,3001,2,5,7,2,13,9,4,22
Universitate,3001,3,4,6,4,15,18,-3,18
D Bucuresti,3001,4,4,5,5,19,20,-1,17
FC Botosani,3001,5,3,5,6,7,15,-8,14
Concordia Ch,3001,6,2,4,8,17,23,-6,10
FCSB,3002,1,8,5,1,28,13,15,29
CFR Cluj,3002,2,6,6,2,14,11,3,24
Universitate,3002,3,4,5,5,17,20,-3,17
D Bucuresti,3002,4,4,4,6,21,21,0,16
FC Botosani,3002,5,4,4,6,8,15,-7,16
Concordia Ch,3002,6,3,2,9,16,24,-8,11
FCSB,3003,1,8,6,0,25,11,14,30
CFR Cluj,3003,2,6,6,2,14,8,6,24
D Bucuresti,3003,3,4,5,5,18,19,-1,17
FC Botosani,3003,4,4,5,5,7,12,-5,17
Universitate,3003,5,3,6,5,15,20,-5,15
Concordia Ch,3003,6,2,2,10,16,25,-9,8
FCSB,3004,1,8,6,0,25,11,14,30
CFR Cluj,3004,2,6,7,1,16,8,8,25
FC Botosani,3004,3,4,5,5,7,13,-6,17
D Bucuresti,3004,4,3,5,6,17,23,-6,14
Universitate,3004,5,3,5,6,14,21,-7,14
Concordia Ch,3004,6,3,2,9,19,22,-3,11
FCSB,3005,1,7,5,2,26,15,11,26
CFR Cluj,3005,2,6,6,2,15,9,6,24
Universitate,3005,3,5,5,4,18,20,-2,20
FC Botosani,3005,4,4,5,5,9,14,-5,17
D Bucuresti,3005,5,3,5,6,17,20,-3,14
Concordia Ch,3005,6,3,2,9,17,24,-7,11
FCSB,3006,1,9,5,0,28,11,17,32
CFR Cluj,3006,2,6,6,2,14,9,5,24
FC Botosani,3006,3,4,5,5,7,13,-6,17
Universitate,3006,4,3,5,6,15,22,-7,14
D Bucuresti,3006,5,3,4,7,16,20,-4,13
Concordia Ch,3006,6,3,3,8,17,22,-5,12
FCSB,3007,1,8,5,1,25,12,13,29
CFR Cluj,3007,2,5,6,3,14,10,4,21
Universitate,3007,3,5,5,4,16,18,-2,20
D Bucuresti,3007,4,4,5,5,20,20,0,17
FC Botosani,3007,5,4,5,5,8,14,-6,17
Concordia Ch,3007,6,2,2,10,17,26,-9,8
FCSB,3008,1,7,5,2,26,16,10,26
CFR Cluj,3008,2,6,7,1,17,9,8,25
Universitate,3008,3,4,6,4,16,19,-3,18
FC Botosani,3008,4,3,6,5,8,15,-7,15
D Bucuresti,3008,5,3,5,6,20,24,-4,14
Concordia Ch,3008,6,3,3,8,20,24,-4,12
FCSB,3009,1,7,6,1,24,12,12,27
CFR Cluj,3009,2,7,6,1,16,7,9,27
D Bucuresti,3009,3,4,4,6,21,20,1,16
Universitate,3009,4,3,6,5,15,21,-6,15
Concordia Ch,3009,5,4,2,8,19,23,-4,14
FC Botosani,3009,6,3,4,7,6,18,-12,13
FCSB,3010,1,8,5,1,24,12,12,29
CFR Cluj,3010,2,5,7,2,13,8,5,22
FC Botosani,3010,3,5,4,5,9,13,-4,19
Universitate,3010,4,4,6,4,16,18,-2,18
D Bucuresti,3010,5,4,4,6,18,21,-3,16
Concordia Ch,3010,6,2,2,10,17,25,-8,8
FCSB,3011,1,8,5,1,24,11,13,29
CFR Cluj,3011,2,5,7,2,13,8,5,22
Universitate,3011,3,4,6,4,15,18,-3,18
D Bucuresti,3011,4,4,4,6,18,22,-4,16
FC Botosani,3011,5,4,4,6,7,14,-7,16
Concordia Ch,3011,6,3,2,9,18,22,-4,11
FCSB,3012,1,8,5,1,25,12,13,29
CFR Cluj,3012,2,6,7,1,15,8,7,25
Universitate,3012,3,3,6,5,16,21,-5,15
FC Botosani,3012,4,3,6,5,7,14,-7,15
D Bucuresti,3012,5,3,5,6,17,22,-5,14
Concordia Ch,3012,6,3,3,8,19,22,-3,12
FCSB,3013,1,7,6,1,25,13,12,27
CFR Cluj,3013,2,6,7,1,15,8,7,25
FC Botosani,3013,3,4,5,5,6,12,-6,17
Universitate,3013,4,3,7,4,17,21,-4,16
D Bucuresti,3013,5,3,5,6,17,20,-3,14
Concordia Ch,3013,6,3,2,9,17,23,-6,11
FCSB,3014,1,7,6,1,24,12,12,27
CFR Cluj,3014,2,6,7,1,16,9,7,25
Universitate,3014,3,3,7,4,15,19,-4,16
FC Botosani,3014,4,4,4,6,8,15,-7,16
Concordia Ch,3014,5,4,2,8,21,21,0,14
D Bucuresti,3014,6,3,4,7,17,25,-8,13
FCSB,3015,1,8,6,0,26,11,15,30
CFR Cluj,3015,2,5,7,2,15,12,3,22
Universitate,3015,3,4,5,5,18,21,-3,17
FC Botosani,3015,4,4,5,5,9,14,-5,17
D Bucuresti,3015,5,3,5,6,18,22,-4,14
Concordia Ch,3015,6,3,2,9,17,23,-6,11
FCSB,3016,1,9,5,0,26,10,16,32
CFR Cluj,3016,2,5,7,2,14,9,5,22
D Bucuresti,3016,3,5,4,5,22,20,2,19
Universitate,3016,4,3,6,5,15,21,-6,15
FC Botosani,3016,5,3,5,6,7,16,-9,14
Concordia Ch,3016,6,2,3,9,17,25,-8,9
FCSB,3017,1,8,5,1,26,14,12,29
CFR Cluj,3017,2,7,6,1,19,9,10,27
FC Botosani,3017,3,4,4,6,8,14,-6,16
Concordia Ch,3017,4,4,2,8,20,23,-3,14
Universitate,3017,5,3,5,6,16,23,-7,14
D Bucuresti,3017,6,3,4,7,17,23,-6,13
FCSB,3018,1,7,7,0,24,11,13,28
CFR Cluj,3018,2,5,7,2,13,8,5,22
Universitate,3018,3,4,6,4,16,19,-3,18
D Bucuresti,3018,4,4,5,5,21,22,-1,17
FC Botosani,3018,5,3,5,6,8,16,-8,14
Concordia Ch,3018,6,2,4,8,18,24,-6,10
FCSB,3019,1,8,5,1,26,13,13,29
CFR Cluj,3019,2,6,6,2,16,11,5,24
Universitate,3019,3,4,5,5,18,21,-3,17
FC Botosani,3019,4,4,5,5,6,12,-6,17
D Bucuresti,3019,5,3,4,7,17,21,-4,13
Concordia Ch,3019,6,3,3,8,17,22,-5,12
FCSB,3020,1,7,7,0,24,11,13,28
CFR Cluj,3020,2,6,7,1,19,11,8,25
D Bucuresti,3020,3,4,4,6,19,25,-6,16
FC Botosani,3020,4,4,4,6,8,15,-7,16
Universitate,3020,5,3,6,5,17,23,-6,15
Concordia Ch,3020,6,3,2,9,22,24,-2,11
FCSB,3021,1,7,7,0,24,11,13,28
CFR Cluj,3021,2,5,7,2,14,9,5,22
Universitate,3021,3,4,6,4,17,20,-3,18
D Bucuresti,3021,4,3,6,5,19,21,-2,15
FC Botosani,3021,5,3,6,5,9,16,-7,15
Concordia Ch,3021,6,2,4,8,16,22,-6,10
FCSB,3022,1,8,6,0,25,10,15,30
CFR Cluj,3022,2,5,7,2,13,9,4,22
FC Botosani,3022,3,5,4,5,10,13,-3,19
D Bucuresti,3022,4,4,4,6,19,20,-1,16
Universitate,3022,5,3,7,4,14,18,-4,16
Concordia Ch,3022,6,2,2,10,15,26,-11,8
FCSB,3023,1,9,5,0,29,12,17,32
CFR Cluj,3023,2,5,7,2,14,11,3,22
FC Botosani,3023,3,5,4,5,9,14,-5,19
Universitate,3023,4,3,6,5,17,22,-5,15
D Bucuresti,3023,5,3,4,7,16,20,-4,13
Concordia Ch,3023,6,3,2,9,18,24,-6,11
FCSB,3024,1,7,6,1,24,13,11,27
CFR Cluj,3024,2,6,6,2,16,10,6,24
Universitate,3024,3,4,6,4,18,20,-2,18
D Bucuresti,3024,4,4,4,6,19,20,-1,16
FC Botosani,3024,5,4,4,6,8,15,-7,16
Concordia Ch,3024,6,3,2,9,18,25,-7,11
FCSB,3025,1,7,6,1,26,14,12,27
CFR Cluj,3025,2,5,7,2,14,9,5,22
Universitate,3025,3,5,5,4,18,20,-2,20
FC Botosani,3025,4,4,5,5,9,14,-5,17
D Bucuresti,3025,5,3,5,6,16,20,-4,14
Concordia Ch,3025,6,2,4,8,17,23,-6,10
FCSB,3026,1,7,7,0,25,12,13,28
CFR Cluj,3026,2,5,8,1,14,8,6,23
D Bucuresti,3026,3,4,4,6,19,20,-1,16
Universitate,3026,4,3,7,4,17,21,-4,16
FC Botosani,3026,5,4,4,6,7,15,-8,16
Concordia Ch,3026,6,3,2,9,18,24,-6,11
FCSB,3027,1,8,5,1,25,12,13,29
CFR Cluj,3027,2,7,6,1,17,7,10,27
D Bucuresti,3027,3,4,5,5,21,21,0,17
FC Botosani,3027,4,4,4,6,8,16,-8,16
Universitate,3027,5,3,5,6,14,22,-8,14
Concordia Ch,3027,6,2,3,9,16,23,-7,9
FCSB,3028,1,8,6,0,27,11,16,30
CFR Cluj,3028,2,5,7,2,13,10,3,22
Universitate,3028,3,3,7,4,15,19,-4,16
FC Botosani,3028,4,3,6,5,7,14,-7,15
D Bucuresti,3028,5,3,5,6,17,20,-3,14
Concordia Ch,3028,6,3,3,8,17,22,-5,12
FCSB,3029,1,8,5,1,24,13,11,29
CFR Cluj,3029,2,6,6,2,15,8,7,24
FC Botosani,3029,3,5,4,5,8,12,-4,19
Universitate,3029,4,4,5,5,17,20,-3,17
D Bucuresti,3029,5,4,4,6,18,21,-3,16
Concordia Ch,3029,6,2,2,10,16,24,-8,8
FCSB,3030,1,7,6,1,26,14,12,27
CFR Cluj,3030,2,7,6,1,18,9,9,27
D Bucuresti,3030,3,4,4,6,18,21,-3,16
FC Botosani,3030,4,4,4,6,8,13,-5,16
Universitate,3030,5,3,6,5,15,21,-6,15
Concordia Ch,3030,6,3,2,9,18,25,-7,11
FCSB,3031,1,8,5,1,24,11,13,29
CFR Cluj,3031,2,7,6,1,15,7,8,27
D Bucuresti,3031,3,4,4,6,22,21,1,16
Universitate,3031,4,3,5,6,14,20,-6,14
FC Botosani,3031,5,3,5,6,5,16,-11,14
Concordia Ch,3031,6,3,3,8,18,23,-5,12
FCSB,3032,1,9,5,0,27,11,16,32
CFR Cluj,3032,2,6,6,2,15,10,5,24
D Bucuresti,3032,3,4,5,5,19,19,0,17
FC Botosani,3032,4,4,5,5,7,13,-6,17
Universitate,3032,5,3,5,6,14,20,-6,14
Concordia Ch,3032,6,2,2,10,15,24,-9,8
FCSB,3033,1,7,7,0,25,12,13,28
CFR Cluj,3033,2,6,7,1,16,9,7,25
D Bucuresti,3033,3,3,6,5,17,19,-2,15
Universitate,3033,4,3,6,5,16,21,-5,15
FC Botosani,3033,5,3,5,6,5,14,-9,14
Concordia Ch,3033,6,3,3,8,18,22,-4,12
FCSB,3034,1,8,6,0,24,10,14,30
CFR Cluj,3034,2,5,8,1,14,8,6,23
FC Botosani,3034,3,4,4,6,6,17,-11,16
Universitate,3034,4,3,6,5,15,20,-5,15
Concordia Ch,3034,5,4,2,8,24,21,3,14
D Bucuresti,3034,6,3,4,7,16,23,-7,13
FCSB,3035,1,7,6,1,26,14,12,27
CFR Cluj,3035,2,6,7,1,16,8,8,25
Universitate,3035,3,4,5,5,17,22,-5,17
D Bucuresti,3035,4,4,4,6,18,20,-2,16
FC Botosani,3035,5,3,5,6,6,14,-8,14
Concordia Ch,3035,6,3,3,8,16,21,-5,12
FCSB,3036,1,7,5,2,24,14,10,26
CFR Cluj,3036,2,6,7,1,17,9,8,25
Universitate,3036,3,4,6,4,16,19,-3,18
FC Botosani,3036,4,4,5,5,7,12,-5,17
D Bucuresti,3036,5,3,5,6,16,19,-3,14
Concordia Ch,3036,6,3,2,9,16,23,-7,11
FCSB,3037,1,7,6,1,25,13,12,27
CFR Cluj,3037,2,5,8,1,13,7,6,23
Universitate,3037,3,4,6,4,17,20,-3,18
FC Botosani,3037,4,4,5,5,11,14,-3,17
D Bucuresti,3037,5,3,4,7,16,23,-7,13
Concordia Ch,3037,6,3,3,8,18,23,-5,12
FCSB,3038,1,7,7,0,24,11,13,28
CFR Cluj,3038,2,5,7,2,14,9,5,22
Universitate,3038,3,4,6,4,15,18,-3,18
FC Botosani,3038,4,4,5,5,6,12,-6,17
D Bucuresti,3038,5,3,6,5,17,19,-2,15
Concordia Ch,3038,6,2,3,9,16,23,-7,9
FCSB,3039,1,7,6,1,26,15,11,27
CFR Cluj,3039,2,5,8,1,15,9,6,23
Universitate,3039,3,4,6,4,17,19,-2,18
D Bucuresti,3039,4,4,4,6,17,22,-5,16
FC Botosani,3039,5,4,4,6,6,13,-7,16
Concordia Ch,3039,6,3,2,9,19,22,-3,11
FCSB,3040,1,8,5,1,27,14,13,29
CFR Cluj,3040,2,5,6,3,14,10,4,21
Universitate,3040,3,5,5,4,18,20,-2,20
D Bucuresti,3040,4,4,5,5,19,19,0,17
FC Botosani,3040,5,3,4,7,6,16,-10,13
Concordia Ch,3040,6,3,3,8,18,23,-5,12
FCSB,3041,1,7,7,0,24,11,13,28
CFR Cluj,3041,2,5,8,1,15,9,6,23
FC Botosani,3041,3,4,5,5,8,14,-6,17
Universitate,3041,4,3,7,4,15,19,-4,16
D Bucuresti,3041,5,3,4,7,19,23,-4,13
Concordia Ch,3041,6,3,3,8,21,26,-5,12
FCSB,3042,1,8,6,0,27,12,15,30
CFR Cluj,3042,2,5,6,3,14,11,3,21
Universitate,3042,3,4,6,4,18,21,-3,18
D Bucuresti,3042,4,4,4,6,19,20,-1,16
Concordia Ch,3042,5,4,2,8,19,23,-4,14
FC Botosani,3042,6,3,4,7,6,16,-10,13
FCSB,3043,1,7,6,1,24,12,12,27
CFR Cluj,3043,2,5,8,1,15,9,6,23
Universitate,3043,3,4,6,4,16,19,-3,18
FC Botosani,3043,4,3,6,5,7,14,-7,15
D Bucuresti,3043,5,3,5,6,17,20,-3,14
Concordia Ch,3043,6,3,3,8,17,22,-5,12
FCSB,3044,1,9,5,0,27,10,17,32
CFR Cluj,3044,2,6,6,2,14,10,4,24
FC Botosani,3044,3,5,4,5,7,12,-5,19
Universitate,3044,4,3,5,6,14,20,-6,14
D Bucuresti,3044,5,3,4,7,16,24,-8,13
Concordia Ch,3044,6,3,2,9,20,22,-2,11
FCSB,3045,1,8,5,1,25,12,13,29
CFR Cluj,3045,2,6,6,2,16,10,6,24
Universitate,3045,3,4,5,5,16,20,-4,17
FC Botosani,3045,4,4,5,5,10,16,-6,17
D Bucuresti,3045,5,3,5,6,17,20,-3,14
Concordia Ch,3045,6,2,4,8,18,24,-6,10
FCSB,3046,1,7,7,0,25,12,13,28
CFR Cluj,3046,2,6,7,1,15,8,7,25
FC Botosani,3046,3,4,5,5,8,14,-6,17
D Bucuresti,3046,4,3,6,5,17,19,-2,15
Universitate,3046,5,3,6,5,15,20,-5,15
Concordia Ch,3046,6,2,3,9,16,23,-7,9
FCSB,3047,1,9,5,0,26,10,16,32
CFR Cluj,3047,2,6,6,2,19,8,11,24
D Bucuresti,3047,3,5,4,5,19,19,0,19
Universitate,3047,4,3,5,6,14,26,-12,14
FC Botosani,3047,5,3,4,7,5,14,-9,13
Concordia Ch,3047,6,3,2,9,17,23,-6,11
FCSB,3048,1,8,5,1,27,13,14,29
CFR Cluj,3048,2,6,6,2,16,12,4,24
D Bucuresti,3048,3,5,4,5,21,19,2,19
Universitate,3048,4,4,5,5,17,20,-3,17
FC Botosani,3048,5,4,4,6,9,16,-7,16
Concordia Ch,3048,6,2,2,10,16,26,-10,8
CFR Cluj,3049,1,7,6,1,16,8,8,27
FCSB,3049,2,7,5,2,24,13,11,26
Universitate,3049,3,4,5,5,15,19,-4,17
Concordia Ch,3049,4,4,2,8,22,22,0,14
D Bucuresti,3049,5,3,5,6,17,21,-4,14
FC Botosani,3049,6,3,5,6,5,16,-11,14
FCSB,3050,1,8,6,0,25,10,15,30
CFR Cluj,3050,2,6,6,2,15,9,6,24
FC Botosani,3050,3,5,4,5,9,12,-3,19
Universitate,3050,4,3,6,5,14,20,-6,15
D Bucuresti,3050,5,3,5,6,17,22,-5,14
Concordia Ch,3050,6,2,3,9,16,23,-7,9
FCSB,3051,1,9,5,0,30,13,17,32
CFR Cluj,3051,2,5,6,3,14,11,3,21
D Bucuresti,3051,3,5,4,5,20,20,0,19
Universitate,3051,4,4,5,5,19,24,-5,17
FC Botosani,3051,5,3,5,6,6,14,-8,14
Concordia Ch,3051,6,2,3,9,18,25,-7,9
FCSB,3052,1,8,6,0,28,13,15,30
CFR Cluj,3052,2,5,7,2,15,11,4,22
D Bucuresti,3052,3,4,4,6,17,19,-2,16
Universitate,3052,4,3,7,4,17,21,-4,16
FC Botosani,3052,5,4,4,6,7,13,-6,16
Concordia Ch,3052,6,3,2,9,16,23,-7,11
FCSB,3053,1,9,5,0,26,11,15,32
CFR Cluj,3053,2,5,7,2,15,10,5,22
FC Botosani,3053,3,4,4,6,7,14,-7,16
Universitate,3053,4,3,6,5,15,20,-5,15
D Bucuresti,3053,5,3,5,6,18,21,-3,14
Concordia Ch,3053,6,3,3,8,19,24,-5,12
FCSB,3054,1,9,5,0,26,11,15,32
CFR Cluj,3054,2,5,6,3,14,10,4,21
Universitate,3054,3,4,5,5,17,21,-4,17
FC Botosani,3054,4,4,5,5,6,12,-6,17
D Bucuresti,3054,5,3,4,7,17,21,-4,13
Concordia Ch,3054,6,3,3,8,17,22,-5,12
FCSB,3055,1,8,6,0,27,12,15,30
CFR Cluj,3055,2,6,6,2,17,11,6,24
FC Botosani,3055,3,5,4,5,9,12,-3,19
D Bucuresti,3055,4,4,4,6,18,19,-1,16
Universitate,3055,5,3,6,5,16,22,-6,15
Concordia Ch,3055,6,2,2,10,15,26,-11,8
FCSB,3056,1,8,5,1,25,12,13,29
CFR Cluj,3056,2,7,6,1,16,8,8,27
FC Botosani,3056,3,5,4,5,10,14,-4,19
D Bucuresti,3056,4,4,4,6,19,21,-2,16
Universitate,3056,5,3,5,6,14,20,-6,14
Concordia Ch,3056,6,2,2,10,15,24,-9,8
FCSB,3057,1,8,6,0,27,11,16,30
CFR Cluj,3057,2,6,6,2,15,11,4,24
D Bucuresti,3057,3,5,4,5,20,19,1,19
Universitate,3057,4,3,6,5,16,21,-5,15
FC Botosani,3057,5,3,4,7,6,15,-9,13
Concordia Ch,3057,6,3,2,9,16,23,-7,11
FCSB,3058,1,7,6,1,24,12,12,27
CFR Cluj,3058,2,7,6,1,16,8,8,27
FC Botosani,3058,3,5,4,5,11,14,-3,19
Universitate,3058,4,3,6,5,14,19,-5,15
D Bucuresti,3058,5,3,4,7,18,22,-4,13
Concordia Ch,3058,6,3,2,9,16,24,-8,11
FCSB,3059,1,9,5,0,28,10,18,32
CFR Cluj,3059,2,5,6,3,14,11,3,21
D Bucuresti,3059,3,4,5,5,20,20,0,17
Universitate,3059,4,4,5,5,16,22,-6,17
FC Botosani,3059,5,3,5,6,5,14,-9,14
Concordia Ch,3059,6,2,4,8,17,23,-6,10
FCSB,3060,1,9,5,0,27,10,17,32
CFR Cluj,3060,2,5,7,2,13,9,4,22
D Bucuresti,3060,3,3,6,5,17,19,-2,15
Universitate,3060,4,3,6,5,14,20,-6,15
FC Botosani,3060,5,3,6,5,5,12,-7,15
Concordia Ch,3060,6,2,4,8,16,22,-6,10
FCSB,3061,1,8,5,1,26,12,14,29
CFR Cluj,3061,2,5,7,2,13,10,3,22
Universitate,3061,3,4,6,4,16,18,-2,18
D Bucuresti,3061,4,4,5,5,20,21,-1,17
FC Botosani,3061,5,4,4,6,10,15,-5,16
Concordia Ch,3061,6,2,3,9,16,25,-9,9
FCSB,3062,1,8,6,0,26,12,14,30
CFR Cluj,3062,2,6,6,2,16,9,7,24
FC Botosani,3062,3,5,4,5,9,13,-4,19
D Bucuresti,3062,4,4,4,6,19,21,-2,16
Universitate,3062,5,3,6,5,17,23,-6,15
Concordia Ch,3062,6,2,2,10,16,25,-9,8
FCSB,3063,1,8,6,0,29,14,15,30
CFR Cluj,3063,2,6,7,1,16,9,7,25
Concordia Ch,3063,3,4,2,8,23,22,1,14
D Bucuresti,3063,4,3,5,6,17,23,-6,14
Universitate,3063,5,3,5,6,16,23,-7,14
FC Botosani,3063,6,3,5,6,5,15,-10,14
FCSB,3064,1,8,5,1,27,16,11,29
CFR Cluj,3064,2,6,6,2,18,12,6,24
D Bucuresti,3064,3,4,5,5,18,19,-1,17
Universitate,3064,4,4,5,5,20,22,-2,17
FC Botosani,3064,5,3,6,5,6,13,-7,15
Concordia Ch,3064,6,2,3,9,15,22,-7,9
FCSB,3065,1,8,5,1,24,11,13,29
CFR Cluj,3065,2,6,6,2,17,9,8,24
D Bucuresti,3065,3,5,4,5,20,19,1,19
Universitate,3065,4,4,5,5,16,22,-6,17
FC Botosani,3065,5,3,5,6,8,16,-8,14
Concordia Ch,3065,6,2,3,9,17,25,-8,9
FCSB,3066,1,7,6,1,24,12,12,27
CFR Cluj,3066,2,6,7,1,14,7,7,25
Universitate,3066,3,3,7,4,15,19,-4,16
D Bucuresti,3066,4,3,5,6,17,20,-3,14
Concordia Ch,3066,5,4,2,8,18,22,-4,14
FC Botosani,3066,6,3,5,6,7,15,-8,14
FCSB,3067,1,9,5,0,25,10,15,32
CFR Cluj,3067,2,6,6,2,16,8,8,24
D Bucuresti,3067,3,5,4,5,22,19,3,19
FC Botosani,3067,4,4,4,6,7,17,-10,16
Universitate,3067,5,3,5,6,14,22,-8,14
Concordia Ch,3067,6,2,2,10,17,25,-8,8
CFR Cluj,3068,1,7,6,1,16,7,9,27
FCSB,3068,2,7,5,2,24,13,11,26
Universitate,3068,3,4,5,5,16,21,-5,17
FC Botosani,3068,4,4,5,5,7,13,-6,17
D Bucuresti,3068,5,3,4,7,16,21,-5,13
Concordia Ch,3068,6,3,3,8,18,22,-4,12
FCSB,3069,1,7,6,1,24,12,12,27
CFR Cluj,3069,2,5,8,1,14,8,6,23
Universitate,3069,3,4,6,4,17,20,-3,18
D Bucuresti,3069,4,4,5,5,20,21,-1,17
FC Botosani,3069,5,4,4,6,9,15,-6,16
Concordia Ch,3069,6,2,3,9,18,26,-8,9
FCSB,3070,1,7,6,1,27,16,11,27
CFR Cluj,3070,2,7,6,1,19,10,9,27
D Bucuresti,3070,3,3,6,5,16,18,-2,15
Universitate,3070,4,3,6,5,17,22,-5,15
FC Botosani,3070,5,3,6,5,6,13,-7,15
Concordia Ch,3070,6,2,4,8,16,22,-6,10
FCSB,3071,1,9,5,0,25,10,15,32
CFR Cluj,3071,2,6,6,2,15,8,7,24
FC Botosani,3071,3,4,5,5,7,13,-6,17
Universitate,3071,4,3,5,6,14,21,-7,14
D Bucuresti,3071,5,3,4,7,16,20,-4,13
Concordia Ch,3071,6,3,3,8,17,22,-5,12
FCSB,3072,1,9,5,0,29,11,18,32
CFR Cluj,3072,2,6,6,2,14,11,3,24
D Bucuresti,3072,3,4,5,5,17,18,-1,17
FC Botosani,3072,4,4,4,6,8,13,-5,16
Universitate,3072,5,3,5,6,15,21,-6,14
Concordia Ch,3072,6,2,3,9,15,24,-9,9
FCSB,3073,1,9,5,0,25,10,15,32
CFR Cluj,3073,2,5,7,2,13,8,5,22
FC Botosani,3073,3,4,5,5,7,13,-6,17
Universitate,3073,4,3,6,5,14,19,-5,15
D Bucuresti,3073,5,3,4,7,19,23,-4,13
Concordia Ch,3073,6,3,3,8,18,23,-5,12
FCSB,3074,1,7,6,1,24,12,12,27
CFR Cluj,3074,2,6,7,1,14,7,7,25
Universitate,3074,3,4,5,5,16,20,-4,17
D Bucuresti,3074,4,4,4,6,20,21,-1,16
FC Botosani,3074,5,4,4,6,6,15,-9,16
Concordia Ch,3074,6,3,2,9,18,23,-5,11
FCSB,3075,1,8,5,1,25,14,11,29
CFR Cluj,3075,2,7,6,1,18,7,11,27
D Bucuresti,3075,3,4,5,5,18,19,-1,17
FC Botosani,3075,4,4,4,6,9,14,-5,16
Universitate,3075,5,3,5,6,15,22,-7,14
Concordia Ch,3075,6,2,3,9,17,26,-9,9
FCSB,3076,1,9,5,0,28,11,17,32
CFR Cluj,3076,2,5,7,2,15,12,3,22
D Bucuresti,3076,3,4,4,6,20,21,-1,16
FC Botosani,3076,4,4,4,6,7,15,-8,16
Universitate,3076,5,3,6,5,15,20,-5,15
Concordia Ch,3076,6,3,2,9,17,23,-6,11
FCSB,3077,1,9,5,0,30,11,19,32
CFR Cluj,3077,2,5,7,2,14,11,3,22
FC Botosani,3077,3,4,4,6,7,14,-7,16
Universitate,3077,4,3,6,5,16,23,-7,15
Concordia Ch,3077,5,4,2,8,20,24,-4,14
D Bucuresti,3077,6,3,4,7,18,22,-4,13
FCSB,3078,1,8,6,0,27,11,16,30
CFR Cluj,3078,2,6,7,1,15,7,8,25
D Bucuresti,3078,3,4,5,5,20,20,0,17
Universitate,3078,4,3,5,6,15,24,-9,14
FC Botosani,3078,5,3,4,7,7,18,-11,13
Concordia Ch,3078,6,3,3,8,19,23,-4,12
FCSB,3079,1,8,6,0,27,12,15,30
CFR Cluj,3079,2,5,6,3,14,11,3,21
D Bucuresti,3079,3,5,4,5,20,18,2,19
Universitate,3079,4,4,6,4,16,19,-3,18
FC Botosani,3079,5,3,5,6,5,15,-10,14
Concordia Ch,3079,6,2,3,9,15,22,-7,9
FCSB,3080,1,8,5,1,26,14,12,29
CFR Cluj,3080,2,5,7,2,15,11,4,22
Universitate,3080,3,4,6,4,18,19,-1,18
FC Botosani,3080,4,4,5,5,7,13,-6,17
D Bucuresti,3080,5,3,5,6,17,20,-3,14
Concordia Ch,3080,6,2,4,8,17,23,-6,10
FCSB,3081,1,7,7,0,25,12,13,28
CFR Cluj,3081,2,5,8,1,15,9,6,23
D Bucuresti,3081,3,4,5,5,21,22,-1,17
Universitate,3081,4,3,7,4,16,20,-4,16
FC Botosani,3081,5,3,4,7,8,17,-9,13
Concordia Ch,3081,6,3,3,8,19,24,-5,12
FCSB,3082,1,8,5,1,25,11,14,29
CFR Cluj,3082,2,5,6,3,15,12,3,21
Universitate,3082,3,5,5,4,18,20,-2,20
D Bucuresti,3082,4,5,4,5,21,18,3,19
FC Botosani,3082,5,4,4,6,6,13,-7,16
Concordia Ch,3082,6,2,2,10,15,26,-11,8
FCSB,3083,1,9,5,0,28,12,16,32
CFR Cluj,3083,2,6,6,2,15,9,6,24
D Bucuresti,3083,3,5,4,5,18,18,0,19
Universitate,3083,4,3,5,6,15,22,-7,14
FC Botosani,3083,5,3,4,7,6,15,-9,13
Concordia Ch,3083,6,3,2,9,17,23,-6,11
FCSB,3084,1,9,5,0,27,11,16,32
CFR Cluj,3084,2,5,7,2,14,9,5,22
D Bucuresti,3084,3,4,4,6,17,21,-4,16
FC Botosani,3084,4,4,4,6,6,13,-7,16
Universitate,3084,5,3,6,5,14,20,-6,15
Concordia Ch,3084,6,3,2,9,18,22,-4,11
CFR Cluj,3085,1,7,6,1,18,10,8,27
FCSB,3085,2,7,5,2,25,14,11,26
D Bucuresti,3085,3,4,5,5,19,18,1,17
Universitate,3085,4,4,5,5,16,20,-4,17
FC Botosani,3085,5,4,5,5,7,13,-6,17
Concordia Ch,3085,6,2,2,10,16,26,-10,8
FCSB,3086,1,8,5,1,24,11,13,29
CFR Cluj,3086,2,7,6,1,18,8,10,27
D Bucuresti,3086,3,4,5,5,18,19,-1,17
FC Botosani,3086,4,3,6,5,6,13,-7,15
Universitate,3086,5,3,5,6,15,23,-8,14
Concordia Ch,3086,6,2,3,9,15,22,-7,9
CFR Cluj,3087,1,7,6,1,18,8,10,27
FCSB,3087,2,7,5,2,23,12,11,26
D Bucuresti,3087,3,4,5,5,18,19,-1,17
Universitate,3087,4,4,5,5,16,22,-6,17
FC Botosani,3087,5,3,5,6,5,13,-8,14
Concordia Ch,3087,6,2,4,8,16,22,-6,10
FCSB,3088,1,8,5,1,25,12,13,29
CFR Cluj,3088,2,5,6,3,14,11,3,21
Universitate,3088,3,5,5,4,18,19,-1,20
D Bucuresti,3088,4,4,5,5,19,20,-1,17
FC Botosani,3088,5,3,4,7,9,18,-9,13
Concordia Ch,3088,6,3,3,8,22,27,-5,12
CFR Cluj,3089,1,7,6,1,18,7,11,27
FCSB,3089,2,7,5,2,23,13,10,26
D Bucuresti,3089,3,5,4,5,22,18,4,19
Universitate,3089,4,4,5,5,15,21,-6,17
FC Botosani,3089,5,4,4,6,7,14,-7,16
Concordia Ch,3089,6,2,2,10,16,28,-12,8
FCSB,3090,1,7,6,1,24,12,12,27
CFR Cluj,3090,2,6,7,1,16,9,7,25
D Bucuresti,3090,3,4,4,6,18,21,-3,16
FC Botosani,3090,4,4,4,6,11,14,-3,16
Universitate,3090,5,3,7,4,15,19,-4,16
Concordia Ch,3090,6,3,2,9,19,28,-9,11
FCSB,3091,1,7,7,0,24,11,13,28
CFR Cluj,3091,2,5,8,1,14,8,6,23
D Bucuresti,3091,3,4,4,6,18,19,-1,16
Universitate,3091,4,3,7,4,14,18,-4,16
Concordia Ch,3091,5,4,2,8,17,21,-4,14
FC Botosani,3091,6,3,4,7,5,15,-10,13
CFR Cluj,3092,1,7,6,1,19,8,11,27
FCSB,3092,2,7,6,1,23,13,10,27
D Bucuresti,3092,3,4,4,6,19,22,-3,16
Universitate,3092,4,3,6,5,15,21,-6,15
Concordia Ch,3092,5,4,2,8,20,22,-2,14
FC Botosani,3092,6,3,4,7,6,16,-10,13
FCSB,3093,1,7,6,1,24,13,11,27
CFR Cluj,3093,2,7,6,1,17,7,10,27
D Bucuresti,3093,3,4,4,6,22,21,1,16
Universitate,3093,4,3,6,5,15,21,-6,15
FC Botosani,3093,5,3,5,6,5,17,-12,14
Concordia Ch,3093,6,3,3,8,18,22,-4,12
FCSB,3094,1,8,6,0,26,11,15,30
CFR Cluj,3094,2,6,7,1,15,8,7,25
FC Botosani,3094,3,4,5,5,6,12,-6,17
D Bucuresti,3094,4,3,5,6,16,19,-3,14
Universitate,3094,5,3,5,6,14,21,-7,14
Concordia Ch,3094,6,2,4,8,15,21,-6,10
FCSB,3095,1,9,5,0,26,11,15,32
CFR Cluj,3095,2,6,6,2,16,9,7,24
D Bucuresti,3095,3,4,5,5,19,20,-1,17
Universitate,3095,4,3,5,6,16,23,-7,14
FC Botosani,3095,5,3,4,7,6,16,-10,13
Concordia Ch,3095,6,3,3,8,18,22,-4,12
FCSB,3096,1,8,6,0,28,14,14,30
CFR Cluj,3096,2,5,7,2,16,11,5,22
FC Botosani,3096,3,5,4,5,8,13,-5,19
Universitate,3096,4,4,5,5,16,20,-4,17
D Bucuresti,3096,5,4,4,6,18,19,-1,16
Concordia Ch,3096,6,2,2,10,16,25,-9,8
FCSB,3097,1,9,5,0,29,10,19,32
CFR Cluj,3097,2,5,6,3,13,12,1,21
Universitate,3097,3,4,5,5,16,21,-5,17
D Bucuresti,3097,4,4,4,6,19,21,-2,16
FC Botosani,3097,5,4,4,6,6,14,-8,16
Concordia Ch,3097,6,3,2,9,18,23,-5,11
FCSB,3098,1,8,6,0,28,11,17,30
CFR Cluj,3098,2,6,6,2,15,12,3,24
D Bucuresti,3098,3,4,5,5,20,19,1,17
Universitate,3098,4,3,6,5,14,19,-5,15
FC Botosani,3098,5,3,5,6,7,16,-9,14
Concordia Ch,3098,6,3,2,9,18,25,-7,11
FCSB,3099,1,7,6,1,24,13,11,27
CFR Cluj,3099,2,5,7,2,14,10,4,22
Universitate,3099,3,5,5,4,18,18,0,20
D Bucuresti,3099,4,3,6,5,17,19,-2,15
FC Botosani,3099,5,3,6,5,7,14,-7,15
Concordia Ch,3099,6,2,4,8,16,22,-6,10
FCSB,3100,1,8,5,1,25,12,13,29
CFR Cluj,3100,2,6,6,2,14,9,5,24
D Bucuresti,3100,3,4,5,5,19,19,0,17
Universitate,3100,4,4,5,5,16,19,-3,17
FC Botosani,3100,5,3,5,6,6,15,-9,14
Concordia Ch,3100,6,2,4,8,17,23,-6,10
FCSB,3101,1,8,6,0,25,11,14,30
CFR Cluj,3101,2,6,6,2,16,10,6,24
FC Botosani,3101,3,4,5,5,9,14,-5,17
D Bucuresti,3101,4,4,4,6,20,22,-2,16
Universitate,3101,5,3,6,5,15,20,-5,15
Concordia Ch,3101,6,2,3,9,17,25,-8,9
FCSB,3102,1,7,6,1,28,16,12,27
CFR Cluj,3102,2,5,8,1,17,11,6,23
Universitate,3102,3,4,6,4,18,21,-3,18
D Bucuresti,3102,4,4,5,5,18,19,-1,17
FC Botosani,3102,5,4,4,6,7,13,-6,16
Concordia Ch,3102,6,2,3,9,16,24,-8,9
FCSB,3103,1,8,5,1,25,12,13,29
CFR Cluj,3103,2,5,6,3,14,10,4,21
Universitate,3103,3,5,5,4,16,18,-2,20
FC Botosani,3103,4,4,4,6,7,13,-6,16
D Bucuresti,3103,5,3,5,6,17,21,-4,14
Concordia Ch,3103,6,3,3,8,17,22,-5,12
FCSB,3104,1,7,6,1,27,15,12,27
CFR Cluj,3104,2,6,7,1,17,9,8,25
Universitate,3104,3,4,5,5,19,24,-5,17
D Bucuresti,3104,4,4,4,6,20,20,0,16
Concordia Ch,3104,5,4,2,8,17,21,-4,14
FC Botosani,3104,6,3,4,7,6,17,-11,13
FCSB,3105,1,8,6,0,27,13,14,30
CFR Cluj,3105,2,6,6,2,16,9,7,24
D Bucuresti,3105,3,4,5,5,18,19,-1,17
Universitate,3105,4,3,6,5,16,22,-6,15
FC Botosani,3105,5,3,5,6,5,13,-8,14
Concordia Ch,3105,6,2,4,8,16,22,-6,10
FCSB,3106,1,8,6,0,25,10,15,30
CFR Cluj,3106,2,6,7,1,14,7,7,25
FC Botosani,3106,3,5,4,5,10,14,-4,19
D Bucuresti,3106,4,3,5,6,19,22,-3,14
Universitate,3106,5,3,5,6,14,21,-7,14
Concordia Ch,3106,6,2,3,9,18,26,-8,9
FCSB,3107,1,8,6,0,26,11,15,30
CFR Cluj,3107,2,6,7,1,16,8,8,25
FC Botosani,3107,3,4,5,5,11,14,-3,17
D Bucuresti,3107,4,3,5,6,18,21,-3,14
Universitate,3107,5,3,5,6,14,22,-8,14
Concordia Ch,3107,6,3,2,9,16,25,-9,11
FCSB,3108,1,9,5,0,27,11,16,32
CFR Cluj,3108,2,6,6,2,14,9,5,24
FC Botosani,3108,3,4,4,6,7,14,-7,16
Concordia Ch,3108,4,4,2,8,20,22,-2,14
Universitate,3108,5,3,5,6,15,21,-6,14
D Bucuresti,3108,6,3,4,7,16,22,-6,13
FCSB,3109,1,9,5,0,26,10,16,32
CFR Cluj,3109,2,6,6,2,15,8,7,24
D Bucuresti,3109,3,5,4,5,18,18,0,19
FC Botosani,3109,4,4,4,6,6,13,-7,16
Universitate,3109,5,3,5,6,14,22,-8,14
Concordia Ch,3109,6,2,2,10,15,23,-8,8
FCSB,3110,1,8,6,0,26,12,14,30
CFR Cluj,3110,2,5,6,3,13,9,4,21
Universitate,3110,3,4,6,4,17,20,-3,18
D Bucuresti,3110,4,4,4,6,17,21,-4,16
FC Botosani,3110,5,3,5,6,6,14,-8,14
Concordia Ch,3110,6,3,3,8,19,22,-3,12
FCSB,3111,1,7,6,1,24,13,11,27
CFR Cluj,3111,2,5,8,1,15,9,6,23
Universitate,3111,3,4,6,4,17,19,-2,18
D Bucuresti,3111,4,4,4,6,19,21,-2,16
FC Botosani,3111,5,4,4,6,7,14,-7,16
Concordia Ch,3111,6,3,2,9,17,23,-6,11
FCSB,3112,1,7,6,1,25,13,12,27
CFR Cluj,3112,2,5,8,1,14,8,6,23
Universitate,3112,3,4,6,4,16,19,-3,18
FC Botosani,3112,4,4,5,5,7,12,-5,17
D Bucuresti,3112,5,3,5,6,17,20,-3,14
Concordia Ch,3112,6,3,2,9,17,24,-7,11
FCSB,3113,1,7,6,1,23,11,12,27
CFR Cluj,3113,2,6,6,2,15,9,6,24
Universitate,3113,3,4,6,4,16,19,-3,18
FC Botosani,3113,4,4,5,5,6,12,-6,17
D Bucuresti,3113,5,3,5,6,17,20,-3,14
Concordia Ch,3113,6,3,2,9,17,23,-6,11
FCSB,3114,1,7,6,1,25,13,12,27
CFR Cluj,3114,2,5,7,2,13,8,5,22
Universitate,3114,3,5,5,4,18,20,-2,20
D Bucuresti,3114,4,4,4,6,18,20,-2,16
FC Botosani,3114,5,4,4,6,6,13,-7,16
Concordia Ch,3114,6,3,2,9,17,23,-6,11
FCSB,3115,1,7,7,0,25,12,13,28
CFR Cluj,3115,2,6,7,1,15,8,7,25
D Bucuresti,3115,3,4,4,6,18,20,-2,16
FC Botosani,3115,4,4,4,6,6,14,-8,16
Universitate,3115,5,3,6,5,15,20,-5,15
Concordia Ch,3115,6,3,2,9,17,22,-5,11
FCSB,3116,1,8,5,1,25,12,13,29
CFR Cluj,3116,2,5,7,2,14,10,4,22
D Bucuresti,3116,3,5,4,5,20,19,1,19
Universitate,3116,4,4,6,4,17,19,-2,18
FC Botosani,3116,5,4,4,6,7,15,-8,16
Concordia Ch,3116,6,2,2,10,15,23,-8,8
FCSB,3117,1,9,5,0,28,10,18,32
CFR Cluj,3117,2,6,6,2,15,10,5,24
D Bucuresti,3117,3,4,4,6,19,21,-2,16
Universitate,3117,4,3,5,6,15,23,-8,14
FC Botosani,3117,5,3,5,6,5,13,-8,14
Concordia Ch,3117,6,3,3,8,18,23,-5,12
FCSB,3118,1,8,5,1,25,12,13,29
CFR Cluj,3118,2,7,6,1,17,7,10,27
D Bucuresti,3118,3,4,5,5,19,19,0,17
Universitate,3118,4,3,5,6,15,23,-8,14
FC Botosani,3118,5,3,5,6,7,16,-9,14
Concordia Ch,3118,6,2,4,8,16,22,-6,10
FCSB,3119,1,8,5,1,26,12,14,29
CFR Cluj,3119,2,6,6,2,16,10,6,24
Universitate,3119,3,4,5,5,15,20,-5,17
D Bucuresti,3119,4,4,4,6,17,21,-4,16
Concordia Ch,3119,5,4,2,8,21,21,0,14
FC Botosani,3119,6,3,4,7,5,16,-11,13
FCSB,3120,1,8,5,1,26,14,12,29
CFR Cluj,3120,2,7,6,1,19,8,11,27
D Bucuresti,3120,3,4,4,6,18,21,-3,16
Concordia Ch,3120,4,4,2,8,20,22,-2,14
Universitate,3120,5,3,5,6,15,23,-8,14
FC Botosani,3120,6,3,4,7,6,16,-10,13
FCSB,3121,1,7,6,1,23,11,12,27
CFR Cluj,3121,2,6,7,1,16,9,7,25
D Bucuresti,3121,3,5,4,5,19,19,0,19
Universitate,3121,4,4,5,5,17,21,-4,17
FC Botosani,3121,5,4,4,6,6,13,-7,16
Concordia Ch,3121,6,2,2,10,16,24,-8,8
FCSB,3122,1,7,7,0,24,11,13,28
CFR Cluj,3122,2,5,8,1,15,9,6,23
D Bucuresti,3122,3,4,5,5,19,20,-1,17
FC Botosani,3122,4,4,5,5,8,14,-6,17
Universitate,3122,5,3,7,4,15,19,-4,16
Concordia Ch,3122,6,2,2,10,15,23,-8,8
FCSB,3123,1,9,5,0,27,11,16,32
CFR Cluj,3123,2,5,7,2,16,12,4,22
D Bucuresti,3123,3,4,5,5,19,19,0,17
Universitate,3123,4,3,6,5,16,21,-5,15
FC Botosani,3123,5,3,4,7,5,15,-10,13
Concordia Ch,3123,6,3,3,8,17,22,-5,12
FCSB,3124,1,8,6,0,24,10,14,30
CFR Cluj,3124,2,6,6,2,15,8,7,24
FC Botosani,3124,3,4,5,5,7,13,-6,17
Universitate,3124,4,3,6,5,14,20,-6,15
D Bucuresti,3124,5,3,5,6,18,22,-4,14
Concordia Ch,3124,6,3,2,9,18,23,-5,11
FCSB,3125,1,8,5,1,24,14,10,29
CFR Cluj,3125,2,6,7,1,17,7,10,25
FC Botosani,3125,3,4,5,5,10,15,-5,17
Universitate,3125,4,3,6,5,14,19,-5,15
D Bucuresti,3125,5,3,5,6,19,25,-6,14
Concordia Ch,3125,6,3,2,9,19,23,-4,11
FCSB,3126,1,8,5,1,27,16,11,29
CFR Cluj,3126,2,6,6,2,17,12,5,24
FC Botosani,3126,3,5,4,5,9,12,-3,19
Universitate,3126,4,4,5,5,19,20,-1,17
D Bucuresti,3126,5,3,4,7,17,22,-5,13
Concordia Ch,3126,6,3,2,9,18,25,-7,11
FCSB,3127,1,7,6,1,25,14,11,27
CFR Cluj,3127,2,6,7,1,17,9,8,25
D Bucuresti,3127,3,4,4,6,19,21,-2,16
Universitate,3127,4,3,7,4,18,22,-4,16
FC Botosani,3127,5,4,4,6,7,15,-8,16
Concordia Ch,3127,6,3,2,9,19,24,-5,11
FCSB,3128,1,8,5,1,27,12,15,29
CFR Cluj,3128,2,6,7,1,15,8,7,25
FC Botosani,3128,3,4,5,5,6,12,-6,17
D Bucuresti,3128,4,3,6,5,16,18,-2,15
Universitate,3128,5,3,6,5,16,23,-7,15
Concordia Ch,3128,6,2,3,9,15,22,-7,9
FCSB,3129,1,7,5,2,23,14,9,26
CFR Cluj,3129,2,6,6,2,16,10,6,24
Universitate,3129,3,5,5,4,20,20,0,20
D Bucuresti,3129,4,4,4,6,18,20,-2,16
Concordia Ch,3129,5,4,2,8,19,22,-3,14
FC Botosani,3129,6,3,4,7,6,16,-10,13
FCSB,3130,1,7,6,1,24,12,12,27
CFR Cluj,3130,2,5,8,1,15,9,6,23
Universitate,3130,3,4,6,4,16,19,-3,18
D Bucuresti,3130,4,4,5,5,18,19,-1,17
FC Botosani,3130,5,4,4,6,7,14,-7,16
Concordia Ch,3130,6,2,3,9,15,22,-7,9
FCSB,3131,1,8,6,0,25,11,14,30
CFR Cluj,3131,2,6,6,2,16,9,7,24
D Bucuresti,3131,3,3,6,5,17,19,-2,15
Universitate,3131,4,3,6,5,16,22,-6,15
FC Botosani,3131,5,3,6,5,5,12,-7,15
Concordia Ch,3131,6,2,4,8,16,22,-6,10
FCSB,3132,1,7,5,2,23,12,11,26
CFR Cluj,3132,2,6,6,2,16,11,5,24
Universitate,3132,3,5,5,4,19,20,-1,20
D Bucuresti,3132,4,4,5,5,18,19,-1,17
FC Botosani,3132,5,4,5,5,9,12,-3,17
Concordia Ch,3132,6,2,2,10,16,27,-11,8
FCSB,3133,1,7,5,2,25,14,11,26
CFR Cluj,3133,2,6,6,2,16,10,6,24
Universitate,3133,3,5,5,4,18,20,-2,20
Concordia Ch,3133,4,4,2,8,19,21,-2,14
D Bucuresti,3133,5,3,5,6,17,22,-5,14
FC Botosani,3133,6,3,5,6,6,14,-8,14
FCSB,3134,1,8,6,0,25,11,14,30
CFR Cluj,3134,2,6,6,2,15,8,7,24
Universitate,3134,3,3,6,5,15,21,-6,15
FC Botosani,3134,4,3,6,5,7,14,-7,15
D Bucuresti,3134,5,3,5,6,17,20,-3,14
Concordia Ch,3134,6,3,3,8,19,24,-5,12
FCSB,3135,1,9,5,0,28,12,16,32
CFR Cluj,3135,2,5,6,3,14,12,2,21
D Bucuresti,3135,3,4,5,5,18,18,0,17
Universitate,3135,4,4,5,5,17,20,-3,17
FC Botosani,3135,5,4,5,5,7,13,-6,17
Concordia Ch,3135,6,2,2,10,16,25,-9,8
FCSB,3136,1,8,5,1,26,13,13,29
CFR Cluj,3136,2,5,7,2,14,10,4,22
Universitate,3136,3,4,6,4,16,18,-2,18
D Bucuresti,3136,4,4,4,6,19,21,-2,16
Concordia Ch,3136,5,4,2,8,18,22,-4,14
FC Botosani,3136,6,3,4,7,6,15,-9,13
FCSB,3137,1,8,6,0,29,11,18,30
CFR Cluj,3137,2,5,6,3,14,14,0,21
Universitate,3137,3,4,6,4,17,20,-3,18
D Bucuresti,3137,4,4,4,6,19,22,-3,16
Concordia Ch,3137,5,4,2,8,23,23,0,14
FC Botosani,3137,6,3,4,7,5,17,-12,13
FCSB,3138,1,7,7,0,26,13,13,28
CFR Cluj,3138,2,5,8,1,16,10,6,23
Universitate,3138,3,3,7,4,16,20,-4,16
FC Botosani,3138,4,3,6,5,5,12,-7,15
D Bucuresti,3138,5,3,5,6,17,20,-3,14
Concordia Ch,3138,6,3,3,8,17,22,-5,12
FCSB,3139,1,7,5,2,24,15,9,26
CFR Cluj,3139,2,6,6,2,17,10,7,24
Universitate,3139,3,5,5,4,20,21,-1,20
FC Botosani,3139,4,4,5,5,6,12,-6,17
D Bucuresti,3139,5,3,4,7,16,20,-4,13
Concordia Ch,3139,6,3,3,8,16,21,-5,12
FCSB,3140,1,8,6,0,25,10,15,30
CFR Cluj,3140,2,6,6,2,14,9,5,24
FC Botosani,3140,3,4,5,5,6,12,-6,17
Universitate,3140,4,3,6,5,14,19,-5,15
D Bucuresti,3140,5,3,4,7,17,23,-6,13
Concordia Ch,3140,6,3,3,8,19,22,-3,12
FCSB,3141,1,8,6,0,25,11,14,30
CFR Cluj,3141,2,6,7,1,14,7,7,25
FC Botosani,3141,3,4,5,5,8,14,-6,17
D Bucuresti,3141,4,3,5,6,18,21,-3,14
Universitate,3141,5,3,5,6,15,21,-6,14
Concordia Ch,3141,6,2,4,8,17,23,-6,10
FCSB,3142,1,8,6,0,26,12,14,30
CFR Cluj,3142,2,6,6,2,16,9,7,24
D Bucuresti,3142,3,4,5,5,21,20,1,17
FC Botosani,3142,4,4,4,6,9,16,-7,16
Universitate,3142,5,3,6,5,15,21,-6,15
Concordia Ch,3142,6,2,3,9,16,25,-9,9
FCSB,3143,1,9,5,0,29,10,19,32
CFR Cluj,3143,2,6,6,2,15,11,4,24
D Bucuresti,3143,3,4,4,6,19,20,-1,16
Concordia Ch,3143,4,4,2,8,19,21,-2,14
Universitate,3143,5,3,5,6,15,23,-8,14
FC Botosani,3143,6,3,4,7,5,17,-12,13
FCSB,3144,1,8,6,0,30,14,16,30
CFR Cluj,3144,2,6,6,2,17,13,4,24
FC Botosani,3144,3,5,4,5,10,13,-3,19
Universitate,3144,4,3,6,5,19,24,-5,15
D Bucuresti,3144,5,3,4,7,17,21,-4,13
Concordia Ch,3144,6,3,2,9,18,26,-8,11
FCSB,3145,1,8,6,0,26,12,14,30
CFR Cluj,3145,2,5,7,2,15,10,5,22
FC Botosani,3145,3,5,4,5,7,12,-5,19
Universitate,3145,4,4,5,5,15,19,-4,17
D Bucuresti,3145,5,4,4,6,18,19,-1,16
Concordia Ch,3145,6,2,2,10,15,24,-9,8
FCSB,3146,1,7,6,1,24,14,10,27
CFR Cluj,3146,2,5,8,1,14,8,6,23
Universitate,3146,3,4,6,4,17,18,-1,18
FC Botosani,3146,4,4,5,5,9,14,-5,17
D Bucuresti,3146,5,3,6,5,19,21,-2,15
Concordia Ch,3146,6,2,3,9,16,24,-8,9
FCSB,3147,1,7,7,0,23,10,13,28
CFR Cluj,3147,2,5,8,1,14,8,6,23
FC Botosani,3147,3,4,5,5,8,13,-5,17
Universitate,3147,4,3,7,4,15,19,-4,16
D Bucuresti,3147,5,3,5,6,16,20,-4,14
Concordia Ch,3147,6,2,4,8,16,22,-6,10
FCSB,3148,1,8,6,0,29,13,16,30
CFR Cluj,3148,2,5,7,2,14,11,3,22
FC Botosani,3148,3,4,5,5,8,12,-4,17
Universitate,3148,4,3,7,4,18,22,-4,16
D Bucuresti,3148,5,3,5,6,18,21,-3,14
Concordia Ch,3148,6,3,2,9,18,26,-8,11
FCSB,3149,1,8,5,1,25,12,13,29
CFR Cluj,3149,2,6,6,2,15,9,6,24
D Bucuresti,3149,3,4,5,5,18,19,-1,17
Universitate,3149,4,4,5,5,17,21,-4,17
FC Botosani,3149,5,3,6,5,6,13,-7,15
Concordia Ch,3149,6,2,3,9,17,24,-7,9
FCSB,3150,1,7,7,0,25,12,13,28
CFR Cluj,3150,2,5,7,2,14,11,3,22
Universitate,3150,3,4,6,4,20,21,-1,18
D Bucuresti,3150,4,4,4,6,19,22,-3,16
FC Botosani,3150,5,4,4,6,10,16,-6,16
Concordia Ch,3150,6,3,2,9,19,25,-6,11
FCSB,3151,1,7,7,0,24,11,13,28
CFR Cluj,3151,2,6,7,1,15,8,7,25
FC Botosani,3151,3,5,4,5,12,12,0,19
Universitate,3151,4,3,6,5,14,19,-5,15
D Bucuresti,3151,5,3,5,6,19,24,-5,14
Concordia Ch,3151,6,2,3,9,18,28,-10,9
FCSB,3152,1,9,5,0,27,11,16,32
CFR Cluj,3152,2,5,6,3,14,11,3,21
Universitate,3152,3,4,5,5,17,21,-4,17
D Bucuresti,3152,4,4,4,6,18,19,-1,16
FC Botosani,3152,5,3,5,6,6,15,-9,14
Concordia Ch,3152,6,3,3,8,17,22,-5,12
FCSB,3153,1,8,5,1,24,12,12,29
CFR Cluj,3153,2,5,6,3,13,9,4,21
Universitate,3153,3,5,5,4,17,18,-1,20
D Bucuresti,3153,4,5,4,5,20,20,0,19
FC Botosani,3153,5,3,5,6,8,16,-8,14
Concordia Ch,3153,6,2,3,9,16,23,-7,9
FCSB,3154,1,9,5,0,26,10,16,32
CFR Cluj,3154,2,6,6,2,15,10,5,24
Concordia Ch,3154,3,4,2,8,19,21,-2,14
D Bucuresti,3154,4,3,5,6,17,20,-3,14
Universitate,3154,5,3,5,6,15,21,-6,14
FC Botosani,3154,6,3,5,6,6,16,-10,14
FCSB,3155,1,8,6,0,25,11,14,30
CFR Cluj,3155,2,5,6,3,13,10,3,21
FC Botosani,3155,3,5,4,5,8,13,-5,19
Universitate,3155,4,4,6,4,17,19,-2,18
D Bucuresti,3155,5,3,5,6,18,21,-3,14
Concordia Ch,3155,6,2,3,9,16,23,-7,9
FCSB,3156,1,8,5,1,25,12,13,29
CFR Cluj,3156,2,6,6,2,16,9,7,24
Universitate,3156,3,4,5,5,15,20,-5,17
FC Botosani,3156,4,4,5,5,6,12,-6,17
D Bucuresti,3156,5,3,5,6,18,21,-3,14
Concordia Ch,3156,6,2,4,8,17,23,-6,10
FCSB,3157,1,8,6,0,29,13,16,30
CFR Cluj,3157,2,6,7,1,19,9,10,25
FC Botosani,3157,3,5,4,5,12,14,-2,19
D Bucuresti,3157,4,3,5,6,18,21,-3,14
Universitate,3157,5,3,5,6,15,26,-11,14
Concordia Ch,3157,6,2,3,9,17,27,-10,9
FCSB,3158,1,9,5,0,27,10,17,32
CFR Cluj,3158,2,6,6,2,15,10,5,24
FC Botosani,3158,3,4,4,6,10,14,-4,16
D Bucuresti,3158,4,4,4,6,18,23,-5,16
Universitate,3158,5,3,5,6,15,22,-7,14
Concordia Ch,3158,6,3,2,9,19,25,-6,11
FCSB,3159,1,8,6,0,26,12,14,30
CFR Cluj,3159,2,6,6,2,16,8,8,24
FC Botosani,3159,3,4,5,5,7,13,-6,17
D Bucuresti,3159,4,4,4,6,19,21,-2,16
Universitate,3159,5,3,6,5,16,23,-7,15
Concordia Ch,3159,6,2,3,9,18,25,-7,9
FCSB,3160,1,8,5,1,27,14,13,29
CFR Cluj,3160,2,6,6,2,16,9,7,24
Universitate,3160,3,4,5,5,18,23,-5,17
FC Botosani,3160,4,4,5,5,8,13,-5,17
D Bucuresti,3160,5,3,5,6,17,20,-3,14
Concordia Ch,3160,6,3,2,9,16,23,-7,11
FCSB,3161,1,7,6,1,24,12,12,27
CFR Cluj,3161,2,6,7,1,14,7,7,25
D Bucuresti,3161,3,5,4,5,24,22,2,19
Universitate,3161,4,3,7,4,15,19,-4,16
FC Botosani,3161,5,3,5,6,7,16,-9,14
Concordia Ch,3161,6,2,3,9,19,27,-8,9
CFR Cluj,3162,1,7,6,1,15,7,8,27
FCSB,3162,2,7,5,2,23,12,11,26
D Bucuresti,3162,3,5,4,5,20,19,1,19
Universitate,3162,4,4,5,5,15,19,-4,17
FC Botosani,3162,5,3,4,7,5,14,-9,13
Concordia Ch,3162,6,3,2,9,17,24,-7,11
FCSB,3163,1,8,6,0,26,12,14,30
CFR Cluj,3163,2,6,7,1,16,9,7,25
D Bucuresti,3163,3,5,4,5,20,18,2,19
FC Botosani,3163,4,4,4,6,7,15,-8,16
Universitate,3163,5,3,5,6,14,20,-6,14
Concordia Ch,3163,6,2,2,10,15,24,-9,8
FCSB,3164,1,8,5,1,27,12,15,29
CFR Cluj,3164,2,6,6,2,16,11,5,24
Universitate,3164,3,4,5,5,17,22,-5,17
FC Botosani,3164,4,4,5,5,7,13,-6,17
D Bucuresti,3164,5,4,4,6,20,22,-2,16
Concordia Ch,3164,6,2,3,9,17,24,-7,9
FCSB,3165,1,8,5,1,26,12,14,29
CFR Cluj,3165,2,5,7,2,15,11,4,22
FC Botosani,3165,3,5,4,5,12,12,0,19
Universitate,3165,4,4,6,4,16,19,-3,18
D Bucuresti,3165,5,3,4,7,18,23,-5,13
Concordia Ch,3165,6,3,2,9,19,29,-10,11
FCSB,3166,1,7,6,1,24,15,9,27
CFR Cluj,3166,2,6,6,2,18,9,9,24
D Bucuresti,3166,3,5,4,5,19,19,0,19
Universitate,3166,4,4,6,4,17,20,-3,18
FC Botosani,3166,5,4,4,6,7,13,-6,16
Concordia Ch,3166,6,2,2,10,16,25,-9,8
FCSB,3167,1,7,6,1,24,13,11,27
CFR Cluj,3167,2,5,8,1,14,8,6,23
Universitate,3167,3,4,6,4,16,18,-2,18
D Bucuresti,3167,4,4,4,6,19,21,-2,16
FC Botosani,3167,5,4,4,6,6,15,-9,16
Concordia Ch,3167,6,3,2,9,18,22,-4,11
FCSB,3168,1,9,5,0,31,12,19,32
CFR Cluj,3168,2,5,7,2,15,11,4,22
FC Botosani,3168,3,4,5,5,7,13,-6,17
Universitate,3168,4,3,6,5,16,24,-8,15
D Bucuresti,3168,5,3,4,7,18,22,-4,13
Concordia Ch,3168,6,3,3,8,19,24,-5,12
FCSB,3169,1,9,5,0,29,11,18,32
CFR Cluj,3169,2,6,6,2,15,11,4,24
D Bucuresti,3169,3,3,5,6,17,20,-3,14
Concordia Ch,3169,4,4,2,8,17,21,-4,14
Universitate,3169,5,3,5,6,16,23,-7,14
FC Botosani,3169,6,3,5,6,6,14,-8,14
FCSB,3170,1,9,5,0,29,11,18,32
CFR Cluj,3170,2,5,6,3,15,12,3,21
FC Botosani,3170,3,5,4,5,11,13,-2,19
Universitate,3170,4,4,5,5,16,22,-6,17
D Bucuresti,3170,5,3,5,6,19,22,-3,14
Concordia Ch,3170,6,2,3,9,17,27,-10,9
FCSB,3171,1,8,5,1,26,13,13,29
CFR Cluj,3171,2,7,6,1,18,10,8,27
D Bucuresti,3171,3,3,6,5,17,19,-2,15
Universitate,3171,4,3,5,6,15,21,-6,14
FC Botosani,3171,5,3,5,6,5,17,-12,14
Concordia Ch,3171,6,3,3,8,21,22,-1,12
FCSB,3172,1,7,7,0,24,11,13,28
CFR Cluj,3172,2,5,8,1,14,8,6,23
D Bucuresti,3172,3,4,5,5,20,21,-1,17
FC Botosani,3172,4,4,5,5,8,14,-6,17
Universitate,3172,5,3,7,4,14,18,-4,16
Concordia Ch,3172,6,2,2,10,16,24,-8,8
FCSB,3173,1,9,5,0,28,11,17,32
CFR Cluj,3173,2,5,6,3,14,12,2,21
Universitate,3173,3,4,5,5,18,22,-4,17
D Bucuresti,3173,4,4,4,6,19,19,0,16
Concordia Ch,3173,5,4,2,8,18,22,-4,14
FC Botosani,3173,6,3,4,7,6,17,-11,13
FCSB,3174,1,7,7,0,24,11,13,28
CFR Cluj,3174,2,5,8,1,13,7,6,23
FC Botosani,3174,3,5,4,5,8,12,-4,19
Universitate,3174,4,3,7,4,15,19,-4,16
D Bucuresti,3174,5,3,4,7,16,21,-5,13
Concordia Ch,3174,6,3,2,9,16,22,-6,11
FCSB,3175,1,8,5,1,28,15,13,29
CFR Cluj,3175,2,5,7,2,14,13,1,22
Universitate,3175,3,4,6,4,20,19,1,18
FC Botosani,3175,4,4,4,6,7,14,-7,16
Concordia Ch,3175,5,4,2,8,19,22,-3,14
D Bucuresti,3175,6,3,4,7,18,23,-5,13
FCSB,3176,1,9,5,0,31,11,20,32
CFR Cluj,3176,2,6,6,2,16,12,4,24
D Bucuresti,3176,3,5,4,5,20,19,1,19
FC Botosani,3176,4,4,4,6,7,15,-8,16
Universitate,3176,5,3,5,6,14,23,-9,14
Concordia Ch,3176,6,2,2,10,15,23,-8,8
FCSB,3177,1,8,6,0,26,12,14,30
CFR Cluj,3177,2,5,7,2,14,9,5,22
D Bucuresti,3177,3,5,4,5,18,18,0,19
Universitate,3177,4,4,5,5,16,20,-4,17
FC Botosani,3177,5,3,5,6,6,14,-8,14
Concordia Ch,3177,6,2,3,9,16,23,-7,9
FCSB,3178,1,7,6,1,27,17,10,27
CFR Cluj,3178,2,6,7,1,21,12,9,25
Universitate,3178,3,4,5,5,20,24,-4,17
D Bucuresti,3178,4,4,4,6,18,19,-1,16
Concordia Ch,3178,5,4,2,8,18,22,-4,14
FC Botosani,3178,6,3,4,7,6,16,-10,13
FCSB,3179,1,7,5,2,24,13,11,26
CFR Cluj,3179,2,6,7,1,15,8,7,25
Universitate,3179,3,4,6,4,15,18,-3,18
D Bucuresti,3179,4,4,5,5,19,20,-1,17
FC Botosani,3179,5,4,4,6,11,14,-3,16
Concordia Ch,3179,6,2,3,9,16,27,-11,9
CFR Cluj,3180,1,7,6,1,15,7,8,27
FCSB,3180,2,7,5,2,23,13,10,26
Universitate,3180,3,4,5,5,16,19,-3,17
Concordia Ch,3180,4,4,2,8,21,21,0,14
D Bucuresti,3180,5,3,5,6,17,23,-6,14
FC Botosani,3180,6,3,5,6,6,15,-9,14
FCSB,3181,1,9,5,0,29,11,18,32
CFR Cluj,3181,2,5,6,3,14,12,2,21
Universitate,3181,3,4,5,5,16,21,-5,17
D Bucuresti,3181,4,3,5,6,18,21,-3,14
Concordia Ch,3181,5,4,2,8,19,23,-4,14
FC Botosani,3181,6,3,5,6,7,15,-8,14
FCSB,3182,1,8,6,0,26,11,15,30
CFR Cluj,3182,2,5,6,3,13,10,3,21
Universitate,3182,3,4,6,4,16,19,-3,18
D Bucuresti,3182,4,4,5,5,21,19,2,17
FC Botosani,3182,5,3,5,6,8,16,-8,14
Concordia Ch,3182,6,3,2,9,18,27,-9,11
FCSB,3183,1,8,5,1,26,14,12,29
CFR Cluj,3183,2,6,6,2,15,10,5,24
Universitate,3183,3,4,5,5,17,19,-2,17
D Bucuresti,3183,4,4,4,6,18,20,-2,16
Concordia Ch,3183,5,4,2,8,18,22,-4,14
FC Botosani,3183,6,3,4,7,5,14,-9,13
CFR Cluj,3184,1,7,6,1,19,8,11,27
FCSB,3184,2,7,5,2,25,16,9,26
Universitate,3184,3,4,5,5,17,22,-5,17
D Bucuresti,3184,4,3,5,6,17,20,-3,14
Concordia Ch,3184,5,4,2,8,17,21,-4,14
FC Botosani,3184,6,3,5,6,6,14,-8,14
FCSB,3185,1,7,5,2,24,15,9,26
CFR Cluj,3185,2,6,7,1,16,9,7,25
Universitate,3185,3,4,6,4,18,19,-1,18
FC Botosani,3185,4,4,5,5,7,13,-6,17
D Bucuresti,3185,5,4,4,6,17,19,-2,16
Concordia Ch,3185,6,2,3,9,16,23,-7,9
FCSB,3186,1,7,5,2,27,16,11,26
CFR Cluj,3186,2,6,6,2,18,12,6,24
Universitate,3186,3,5,5,4,18,20,-2,20
FC Botosani,3186,4,3,6,5,7,14,-7,15
D Bucuresti,3186,5,3,5,6,19,23,-4,14
Concordia Ch,3186,6,3,3,8,20,24,-4,12
FCSB,3187,1,9,5,0,27,12,15,32
CFR Cluj,3187,2,5,7,2,14,9,5,22
D Bucuresti,3187,3,4,4,6,18,20,-2,16
Universitate,3187,4,3,6,5,17,22,-5,15
Concordia Ch,3187,5,4,2,8,19,23,-4,14
FC Botosani,3187,6,3,4,7,6,15,-9,13
FCSB,3188,1,8,6,0,28,12,16,30
CFR Cluj,3188,2,6,6,2,15,10,5,24
D Bucuresti,3188,3,4,5,5,19,20,-1,17
Universitate,3188,4,3,6,5,16,22,-6,15
FC Botosani,3188,5,3,5,6,6,14,-8,14
Concordia Ch,3188,6,3,2,9,19,25,-6,11
FCSB,3189,1,8,6,0,26,11,15,30
CFR Cluj,3189,2,6,6,2,17,10,7,24
FC Botosani,3189,3,4,5,5,9,15,-6,17
Universitate,3189,4,3,6,5,14,21,-7,15
D Bucuresti,3189,5,3,5,6,18,24,-6,14
Concordia Ch,3189,6,3,2,9,20,23,-3,11
FCSB,3190,1,7,5,2,26,15,11,26
CFR Cluj,3190,2,6,7,1,16,9,7,25
Universitate,3190,3,4,6,4,18,21,-3,18
FC Botosani,3190,4,4,5,5,8,13,-5,17
D Bucuresti,3190,5,3,5,6,17,21,-4,14
Concordia Ch,3190,6,3,2,9,17,23,-6,11
CFR Cluj,3191,1,7,6,1,16,8,8,27
FCSB,3191,2,7,5,2,23,12,11,26
D Bucuresti,3191,3,5,4,5,19,18,1,19
Universitate,3191,4,4,5,5,16,20,-4,17
FC Botosani,3191,5,3,5,6,7,15,-8,14
Concordia Ch,3191,6,2,3,9,17,25,-8,9
FCSB,3192,1,8,5,1,25,13,12,29
CFR Cluj,3192,2,6,6,2,18,10,8,24
D Bucuresti,3192,3,5,4,5,21,20,1,19
Universitate,3192,4,4,5,5,17,22,-5,17
FC Botosani,3192,5,3,4,7,5,15,-10,13
Concordia Ch,3192,6,3,2,9,18,24,-6,11
FCSB,3193,1,7,6,1,23,13,10,27
CFR Cluj,3193,2,5,7,2,13,8,5,22
Universitate,3193,3,5,5,4,18,18,0,20
D Bucuresti,3193,4,5,4,5,22,21,1,19
FC Botosani,3193,5,3,4,7,6,16,-10,13
Concordia Ch,3193,6,3,2,9,19,25,-6,11
FCSB,3194,1,8,5,1,26,13,13,29
CFR Cluj,3194,2,5,6,3,14,14,0,21
Universitate,3194,3,5,5,4,22,20,2,20
D Bucuresti,3194,4,5,4,5,21,20,1,19
FC Botosani,3194,5,4,4,6,7,14,-7,16
Concordia Ch,3194,6,2,2,10,17,26,-9,8
FCSB,3195,1,8,6,0,29,13,16,30
CFR Cluj,3195,2,6,7,1,15,8,7,25
D Bucuresti,3195,3,5,4,5,22,19,3,19
Universitate,3195,4,3,5,6,16,24,-8,14
FC Botosani,3195,5,3,5,6,7,18,-11,14
Concordia Ch,3195,6,2,3,9,16,23,-7,9
CFR Cluj,3196,1,7,6,1,17,8,9,27
FCSB,3196,2,7,5,2,25,16,9,26
Universitate,3196,3,4,5,5,18,21,-3,17
D Bucuresti,3196,4,4,4,6,18,20,-2,16
Concordia Ch,3196,5,4,2,8,18,22,-4,14
FC Botosani,3196,6,3,4,7,5,14,-9,13
FCSB,3197,1,7,7,0,24,11,13,28
CFR Cluj,3197,2,5,8,1,14,8,6,23
D Bucuresti,3197,3,5,4,5,19,18,1,19
Universitate,3197,4,3,7,4,16,20,-4,16
FC Botosani,3197,5,4,4,6,6,13,-7,16
Concordia Ch,3197,6,2,2,10,15,24,-9,8
FCSB,3198,1,9,5,0,26,10,16,32
CFR Cluj,3198,2,6,6,2,15,10,5,24
FC Botosani,3198,3,3,6,5,7,14,-7,15
D Bucuresti,3198,4,3,5,6,19,22,-3,14
Universitate,3198,5,3,5,6,15,21,-6,14
Concordia Ch,3198,6,3,3,8,19,24,-5,12
FCSB,3199,1,9,5,0,29,13,16,32
CFR Cluj,3199,2,5,6,3,15,11,4,21
Universitate,3199,3,4,5,5,16,21,-5,17
D Bucuresti,3199,4,4,4,6,19,22,-3,16
Concordia Ch,3199,5,4,2,8,18,21,-3,14
FC Botosani,3199,6,3,4,7,7,16,-9,13
FCSB,3200,1,8,5,1,24,11,13,29
CFR Cluj,3200,2,6,6,2,14,8,6,24
Universitate,3200,3,4,5,5,15,19,-4,17
D Bucuresti,3200,4,4,4,6,20,21,-1,16
FC Botosani,3200,5,4,4,6,9,15,-6,16
Concordia Ch,3200,6,3,2,9,17,25,-8,11
FCSB,3201,1,8,6,0,26,10,16,30
CFR Cluj,3201,2,5,7,2,14,11,3,22
D Bucuresti,3201,3,4,5,5,20,20,0,17
FC Botosani,3201,4,4,5,5,7,13,-6,17
Universitate,3201,5,3,7,4,15,19,-4,16
Concordia Ch,3201,6,2,2,10,16,25,-9,8
FCSB,3202,1,7,5,2,23,14,9,26
CFR Cluj,3202,2,6,7,1,15,7,8,25
Universitate,3202,3,4,6,4,16,18,-2,18
FC Botosani,3202,4,4,5,5,7,13,-6,17
D Bucuresti,3202,5,3,5,6,18,21,-3,14
Concordia Ch,3202,6,3,2,9,19,25,-6,11
FCSB,3203,1,7,6,1,24,12,12,27
CFR Cluj,3203,2,6,7,1,17,8,9,25
D Bucuresti,3203,3,5,4,5,22,21,1,19
Universitate,3203,4,4,5,5,15,21,-6,17
FC Botosani,3203,5,3,5,6,8,16,-8,14
Concordia Ch,3203,6,2,3,9,17,25,-8,9
FCSB,3204,1,9,5,0,26,11,15,32
CFR Cluj,3204,2,6,6,2,14,8,6,24
D Bucuresti,3204,3,5,4,5,25,20,5,19
FC Botosani,3204,4,4,4,6,12,18,-6,16
Universitate,3204,5,3,5,6,15,21,-6,14
Concordia Ch,3204,6,2,2,10,15,29,-14,8
FCSB,3205,1,8,6,0,25,10,15,30
CFR Cluj,3205,2,5,8,1,14,8,6,23
D Bucuresti,3205,3,4,4,6,18,21,-3,16
FC Botosani,3205,4,4,4,6,7,14,-7,16
Universitate,3205,5,3,6,5,15,21,-6,15
Concordia Ch,3205,6,3,2,9,19,24,-5,11
FCSB,3206,1,8,5,1,26,14,12,29
CFR Cluj,3206,2,5,7,2,13,9,4,22
Universitate,3206,3,4,6,4,18,19,-1,18
FC Botosani,3206,4,3,6,5,7,14,-7,15
D Bucuresti,3206,5,3,5,6,19,22,-3,14
Concordia Ch,3206,6,3,3,8,17,22,-5,12
CFR Cluj,3207,1,7,6,1,16,7,9,27
FCSB,3207,2,7,5,2,24,14,10,26
Universitate,3207,3,4,5,5,16,20,-4,17
FC Botosani,3207,4,3,6,5,8,15,-7,15
D Bucuresti,3207,5,3,5,6,19,22,-3,14
Concordia Ch,3207,6,3,3,8,18,23,-5,12
FCSB,3208,1,7,5,2,24,13,11,26
CFR Cluj,3208,2,6,7,1,14,7,7,25
Universitate,3208,3,4,6,4,16,19,-3,18
D Bucuresti,3208,4,4,4,6,17,20,-3,16
FC Botosani,3208,5,4,4,6,7,13,-6,16
Concordia Ch,3208,6,3,2,9,17,23,-6,11
FCSB,3209,1,9,5,0,30,12,18,32
CFR Cluj,3209,2,5,6,3,14,13,1,21
Universitate,3209,3,4,5,5,17,21,-4,17
D Bucuresti,3209,4,4,4,6,20,21,-1,16
FC Botosani,3209,5,3,5,6,6,15,-9,14
Concordia Ch,3209,6,3,3,8,17,22,-5,12
FCSB,3210,1,7,7,0,27,14,13,28
CFR Cluj,3210,2,6,7,1,17,10,7,25
FC Botosani,3210,3,4,5,5,6,12,-6,17
Universitate,3210,4,3,6,5,15,20,-5,15
D Bucuresti,3210,5,3,5,6,18,21,-3,14
Concordia Ch,3210,6,3,2,9,18,24,-6,11
FCSB,3211,1,9,5,0,26,11,15,32
CFR Cluj,3211,2,5,6,3,15,11,4,21
Universitate,3211,3,4,5,5,18,22,-4,17
D Bucuresti,3211,4,4,4,6,21,23,-2,16
FC Botosani,3211,5,4,4,6,8,14,-6,16
Concordia Ch,3211,6,3,2,9,19,26,-7,11
FCSB,3212,1,8,6,0,25,11,14,30
CFR Cluj,3212,2,6,7,1,17,7,10,25
D Bucuresti,3212,3,3,6,5,18,20,-2,15
FC Botosani,3212,4,3,5,6,10,18,-8,14
Universitate,3212,5,3,5,6,15,24,-9,14
Concordia Ch,3212,6,3,3,8,19,24,-5,12
FCSB,3213,1,7,5,2,25,14,11,26
CFR Cluj,3213,2,6,6,2,17,11,6,24
Universitate,3213,3,5,5,4,17,19,-2,20
D Bucuresti,3213,4,4,4,6,19,20,-1,16
FC Botosani,3213,5,4,4,6,7,14,-7,16
Concordia Ch,3213,6,3,2,9,17,24,-7,11
FCSB,3214,1,8,6,0,24,10,14,30
CFR Cluj,3214,2,5,8,1,14,8,6,23
D Bucuresti,3214,3,4,4,6,20,20,0,16
Universitate,3214,4,3,6,5,15,20,-5,15
FC Botosani,3214,5,3,5,6,6,16,-10,14
Concordia Ch,3214,6,3,3,8,18,23,-5,12
FCSB,3215,1,8,5,1,26,11,15,29
CFR Cluj,3215,2,6,6,2,14,10,4,24
FC Botosani,3215,3,5,4,5,8,12,-4,19
Universitate,3215,4,4,5,5,15,19,-4,17
D Bucuresti,3215,5,3,4,7,16,20,-4,13
Concordia Ch,3215,6,3,2,9,16,23,-7,11
FCSB,3216,1,9,5,0,26,10,16,32
CFR Cluj,3216,2,5,6,3,13,10,3,21
Universitate,3216,3,4,5,5,16,20,-4,17
D Bucuresti,3216,4,4,4,6,20,21,-1,16
FC Botosani,3216,5,3,5,6,7,17,-10,14
Concordia Ch,3216,6,3,3,8,18,22,-4,12
FCSB,3217,1,7,6,1,23,11,12,27
CFR Cluj,3217,2,6,7,1,17,7,10,25
Universitate,3217,3,4,5,5,15,22,-7,17
D Bucuresti,3217,4,4,4,6,17,19,-2,16
FC Botosani,3217,5,4,4,6,6,13,-7,16
Concordia Ch,3217,6,3,2,9,16,22,-6,11
FCSB,3218,1,8,5,1,24,11,13,29
CFR Cluj,3218,2,5,7,2,13,8,5,22
Universitate,3218,3,4,6,4,15,18,-3,18
FC Botosani,3218,4,4,4,6,6,14,-8,16
D Bucuresti,3218,5,3,5,6,16,19,-3,14
Concordia Ch,3218,6,3,3,8,17,21,-4,12
FCSB,3219,1,9,5,0,30,10,20,32
CFR Cluj,3219,2,5,6,3,13,12,1,21
Universitate,3219,3,4,5,5,17,23,-6,17
FC Botosani,3219,4,4,5,5,9,15,-6,17
D Bucuresti,3219,5,3,6,5,20,22,-2,15
Concordia Ch,3219,6,2,3,9,16,23,-7,9
FCSB,3220,1,7,7,0,25,12,13,28
CFR Cluj,3220,2,5,8,1,14,8,6,23
Universitate,3220,3,3,7,4,17,21,-4,16
FC Botosani,3220,4,4,4,6,7,15,-8,16
D Bucuresti,3220,5,3,5,6,17,21,-4,14
Concordia Ch,3220,6,3,3,8,19,22,-3,12
FCSB,3221,1,9,5,0,28,10,18,32
CFR Cluj,3221,2,6,6,2,15,8,7,24
D Bucuresti,3221,3,4,5,5,18,19,-1,17
FC Botosani,3221,4,3,5,6,5,13,-8,14
Universitate,3221,5,3,5,6,14,24,-10,14
Concordia Ch,3221,6,3,2,9,17,23,-6,11
FCSB,3222,1,8,5,1,27,12,15,29
CFR Cluj,3222,2,5,7,2,13,10,3,22
Universitate,3222,3,4,6,4,16,19,-3,18
D Bucuresti,3222,4,4,4,6,20,21,-1,16
Concordia Ch,3222,5,4,2,8,18,21,-3,14
FC Botosani,3222,6,3,4,7,6,17,-11,13
FCSB,3223,1,7,7,0,24,11,13,28
CFR Cluj,3223,2,6,7,1,16,9,7,25
D Bucuresti,3223,3,4,5,5,18,19,-1,17
FC Botosani,3223,4,4,5,5,9,14,-5,17
Universitate,3223,5,3,6,5,15,20,-5,15
Concordia Ch,3223,6,2,2,10,16,25,-9,8
FCSB,3224,1,9,5,0,27,10,17,32
CFR Cluj,3224,2,5,6,3,13,10,3,21
Universitate,3224,3,4,5,5,15,20,-5,17
D Bucuresti,3224,4,4,4,6,19,22,-3,16
FC Botosani,3224,5,3,5,6,6,14,-8,14
Concordia Ch,3224,6,3,3,8,18,22,-4,12
FCSB,3225,1,9,5,0,27,12,15,32
CFR Cluj,3225,2,5,7,2,14,9,5,22
D Bucuresti,3225,3,4,4,6,19,22,-3,16
FC Botosani,3225,4,4,4,6,7,14,-7,16
Universitate,3225,5,3,6,5,15,20,-5,15
Concordia Ch,3225,6,3,2,9,19,24,-5,11
FCSB,3226,1,9,5,0,26,11,15,32
CFR Cluj,3226,2,6,6,2,16,8,8,24
D Bucuresti,3226,3,4,5,5,19,20,-1,17
FC Botosani,3226,4,4,5,5,7,13,-6,17
Universitate,3226,5,3,5,6,15,23,-8,14
Concordia Ch,3226,6,2,2,10,16,24,-8,8
CFR Cluj,3227,1,7,6,1,16,8,8,27
FCSB,3227,2,7,5,2,23,12,11,26
Universitate,3227,3,4,5,5,16,20,-4,17
D Bucuresti,3227,4,4,4,6,22,23,-1,16
FC Botosani,3227,5,3,5,6,9,18,-9,14
Concordia Ch,3227,6,3,3,8,18,23,-5,12
FCSB,3228,1,7,6,1,23,11,12,27
CFR Cluj,3228,2,6,7,1,17,9,8,25
D Bucuresti,3228,3,4,5,5,21,20,1,17
Universitate,3228,4,4,5,5,17,22,-5,17
FC Botosani,3228,5,3,4,7,5,17,-12,13
Concordia Ch,3228,6,3,3,8,19,23,-4,12
FCSB,3229,1,8,5,1,26,13,13,29
CFR Cluj,3229,2,6,6,2,14,8,6,24
FC Botosani,3229,3,5,4,5,10,12,-2,19
Universitate,3229,4,4,5,5,17,21,-4,17
D Bucuresti,3229,5,3,4,7,17,22,-5,13
Concordia Ch,3229,6,3,2,9,18,26,-8,11
FCSB,3230,1,8,5,1,25,12,13,29
CFR Cluj,3230,2,6,7,1,15,8,7,25
D Bucuresti,3230,3,4,4,6,19,24,-5,16
FC Botosani,3230,4,4,4,6,8,15,-7,16
Universitate,3230,5,3,6,5,16,21,-5,15
Concordia Ch,3230,6,3,2,9,21,24,-3,11
FCSB,3231,1,8,5,1,25,13,12,29
CFR Cluj,3231,2,5,6,3,14,10,4,21
Universitate,3231,3,5,5,4,17,18,-1,20
D Bucuresti,3231,4,5,4,5,21,18,3,19
FC Botosani,3231,5,3,5,6,7,17,-10,14
Concordia Ch,3231,6,2,3,9,17,25,-8,9
FCSB,3232,1,8,6,0,24,10,14,30
CFR Cluj,3232,2,6,6,2,15,9,6,24
D Bucuresti,3232,3,5,4,5,19,19,0,19
FC Botosani,3232,4,4,4,6,8,15,-7,16
Universitate,3232,5,3,6,5,15,20,-5,15
Concordia Ch,3232,6,2,2,10,18,26,-8,8
FCSB,3233,1,8,6,0,28,12,16,30
CFR Cluj,3233,2,6,6,2,16,10,6,24
D Bucuresti,3233,3,4,4,6,20,20,0,16
FC Botosani,3233,4,4,4,6,6,14,-8,16
Universitate,3233,5,3,6,5,16,23,-7,15
Concordia Ch,3233,6,3,2,9,18,25,-7,11
FCSB,3234,1,7,6,1,24,12,12,27
CFR Cluj,3234,2,6,7,1,15,8,7,25
Universitate,3234,3,4,5,5,15,19,-4,17
D Bucuresti,3234,4,4,4,6,18,20,-2,16
FC Botosani,3234,5,4,4,6,8,15,-7,16
Concordia Ch,3234,6,3,2,9,19,25,-6,11
FCSB,3235,1,8,5,1,24,11,13,29
CFR Cluj,3235,2,5,6,3,13,11,2,21
Universitate,3235,3,5,5,4,18,18,0,20
FC Botosani,3235,4,3,6,5,8,15,-7,15
D Bucuresti,3235,5,3,5,6,18,22,-4,14
Concordia Ch,3235,6,3,3,8,20,24,-4,12
FCSB,3236,1,9,5,0,30,14,16,32
CFR Cluj,3236,2,6,6,2,16,10,6,24
D Bucuresti,3236,3,4,5,5,18,19,-1,17
FC Botosani,3236,4,4,5,5,11,13,-2,17
Universitate,3236,5,3,5,6,18,25,-7,14
Concordia Ch,3236,6,2,2,10,15,27,-12,8
FCSB,3237,1,8,5,1,24,11,13,29
CFR Cluj,3237,2,5,7,2,13,8,5,22
Universitate,3237,3,4,6,4,15,18,-3,18
FC Botosani,3237,4,3,6,5,6,13,-7,15
D Bucuresti,3237,5,3,5,6,17,21,-4,14
Concordia Ch,3237,6,3,3,8,17,21,-4,12
CFR Cluj,3238,1,7,6,1,19,7,12,27
FCSB,3238,2,7,6,1,24,13,11,27
FC Botosani,3238,3,5,4,5,7,12,-5,19
Universitate,3238,4,3,6,5,15,23,-8,15
D Bucuresti,3238,5,3,4,7,16,20,-4,13
Concordia Ch,3238,6,3,2,9,16,22,-6,11
FCSB,3239,1,9,5,0,27,10,17,32
CFR Cluj,3239,2,6,6,2,15,9,6,24
D Bucuresti,3239,3,5,4,5,19,18,1,19
FC Botosani,3239,4,4,4,6,8,15,-7,16
Universitate,3239,5,3,5,6,15,23,-8,14
Concordia Ch,3239,6,2,2,10,16,25,-9,8
FCSB,3240,1,9,5,0,26,10,16,32
CFR Cluj,3240,2,5,6,3,14,12,2,21
Universitate,3240,3,4,5,5,17,20,-3,17
FC Botosani,3240,4,4,4,6,7,14,-7,16
D Bucuresti,3240,5,3,5,6,17,20,-3,14
Concordia Ch,3240,6,3,3,8,16,21,-5,12
FCSB,3241,1,8,6,0,27,11,16,30
CFR Cluj,3241,2,6,7,1,14,7,7,25
D Bucuresti,3241,3,5,4,5,19,18,1,19
Universitate,3241,4,3,5,6,15,23,-8,14
FC Botosani,3241,5,3,4,7,6,15,-9,13
Concordia Ch,3241,6,3,2,9,17,24,-7,11
FCSB,3242,1,7,6,1,26,14,12,27
CFR Cluj,3242,2,6,7,1,15,8,7,25
Universitate,3242,3,3,7,4,16,20,-4,16
FC Botosani,3242,4,3,6,5,7,14,-7,15
D Bucuresti,3242,5,3,5,6,16,22,-6,14
Concordia Ch,3242,6,3,3,8,21,23,-2,12
FCSB,3243,1,8,6,0,28,11,17,30
CFR Cluj,3243,2,6,7,1,14,7,7,25
FC Botosani,3243,3,4,5,5,6,12,-6,17
Universitate,3243,4,3,5,6,15,24,-9,14
D Bucuresti,3243,5,3,4,7,17,22,-5,13
Concordia Ch,3243,6,3,3,8,18,22,-4,12
FCSB,3244,1,8,5,1,25,12,13,29
CFR Cluj,3244,2,5,6,3,14,11,3,21
Universitate,3244,3,5,5,4,17,18,-1,20
D Bucuresti,3244,4,4,5,5,21,20,1,17
FC Botosani,3244,5,3,5,6,7,17,-10,14
Concordia Ch,3244,6,2,4,8,17,23,-6,10
FCSB,3245,1,9,5,0,27,11,16,32
CFR Cluj,3245,2,6,6,2,16,9,7,24
FC Botosani,3245,3,3,6,5,7,14,-7,15
D Bucuresti,3245,4,3,5,6,17,21,-4,14
Universitate,3245,5,3,5,6,15,23,-8,14
Concordia Ch,3245,6,3,3,8,18,22,-4,12
FCSB,3246,1,9,5,0,27,11,16,32
CFR Cluj,3246,2,6,6,2,16,9,7,24
FC Botosani,3246,3,5,4,5,11,13,-2,19
Universitate,3246,4,3,5,6,15,23,-8,14
D Bucuresti,3246,5,3,4,7,20,24,-4,13
Concordia Ch,3246,6,3,2,9,19,28,-9,11
FCSB,3247,1,8,5,1,24,11,13,29
CFR Cluj,3247,2,5,6,3,13,9,4,21
Universitate,3247,3,5,5,4,16,18,-2,20
D Bucuresti,3247,4,4,4,6,20,23,-3,16
Concordia Ch,3247,5,4,2,8,19,22,-3,14
FC Botosani,3247,6,3,4,7,7,16,-9,13
FCSB,3248,1,7,7,0,26,13,13,28
CFR Cluj,3248,2,6,7,1,17,9,8,25
D Bucuresti,3248,3,4,5,5,20,20,0,17
Universitate,3248,4,3,6,5,17,23,-6,15
FC Botosani,3248,5,3,4,7,5,15,-10,13
Concordia Ch,3248,6,3,3,8,18,23,-5,12
FCSB,3249,1,9,5,0,27,10,17,32
CFR Cluj,3249,2,5,7,2,15,10,5,22
FC Botosani,3249,3,4,5,5,6,12,-6,17
Universitate,3249,4,3,6,5,16,23,-7,15
D Bucuresti,3249,5,3,5,6,17,22,-5,14
Concordia Ch,3249,6,3,2,9,19,23,-4,11
FCSB,3250,1,7,6,1,24,13,11,27
CFR Cluj,3250,2,6,7,1,15,8,7,25
D Bucuresti,3250,3,4,5,5,19,19,0,17
Universitate,3250,4,4,5,5,16,19,-3,17
FC Botosani,3250,5,3,6,5,6,13,-7,15
Concordia Ch,3250,6,2,3,9,15,23,-8,9
FCSB,3251,1,8,5,1,26,14,12,29
CFR Cluj,3251,2,7,6,1,16,7,9,27
D Bucuresti,3251,3,5,4,5,22,19,3,19
Universitate,3251,4,3,5,6,16,22,-6,14
FC Botosani,3251,5,3,4,7,5,18,-13,13
Concordia Ch,3251,6,3,2,9,19,24,-5,11
FCSB,3252,1,7,5,2,23,13,10,26
CFR Cluj,3252,2,6,7,1,16,8,8,25
Universitate,3252,3,4,6,4,16,19,-3,18
FC Botosani,3252,4,4,4,6,7,15,-8,16
D Bucuresti,3252,5,3,5,6,20,23,-3,14
Concordia Ch,3252,6,3,3,8,20,24,-4,12
FCSB,3253,1,8,5,1,26,13,13,29
CFR Cluj,3253,2,6,7,1,15,8,7,25
D Bucuresti,3253,3,4,4,6,19,21,-2,16
FC Botosani,3253,4,4,4,6,8,18,-10,16
Universitate,3253,5,3,6,5,15,20,-5,15
Concordia Ch,3253,6,3,2,9,19,22,-3,11
FCSB,3254,1,9,5,0,27,10,17,32
CFR Cluj,3254,2,5,6,3,13,11,2,21
D Bucuresti,3254,3,4,5,5,19,19,0,17
Universitate,3254,4,4,5,5,16,20,-4,17
FC Botosani,3254,5,3,5,6,6,15,-9,14
Concordia Ch,3254,6,2,4,8,17,23,-6,10
FCSB,3255,1,9,5,0,26,10,16,32
CFR Cluj,3255,2,6,6,2,16,10,6,24
FC Botosani,3255,3,5,4,5,7,12,-5,19
Universitate,3255,4,3,5,6,16,23,-7,14
D Bucuresti,3255,5,3,4,7,16,20,-4,13
Concordia Ch,3255,6,3,2,9,16,22,-6,11
FCSB,3256,1,9,5,0,26,11,15,32
CFR Cluj,3256,2,5,6,3,15,11,4,21
D Bucuresti,3256,3,4,5,5,18,19,-1,17
Universitate,3256,4,4,5,5,16,20,-4,17
FC Botosani,3256,5,3,4,7,5,16,-11,13
Concordia Ch,3256,6,3,3,8,19,22,-3,12
FCSB,3257,1,7,7,0,25,12,13,28
CFR Cluj,3257,2,6,7,1,15,8,7,25
D Bucuresti,3257,3,4,5,5,22,22,0,17
Universitate,3257,4,3,6,5,15,20,-5,15
FC Botosani,3257,5,3,5,6,5,14,-9,14
Concordia Ch,3257,6,2,4,8,19,25,-6,10
FCSB,3258,1,7,6,1,26,14,12,27
CFR Cluj,3258,2,7,6,1,16,8,8,27
D Bucuresti,3258,3,5,4,5,21,21,0,19
Universitate,3258,4,3,6,5,16,21,-5,15
FC Botosani,3258,5,3,5,6,6,14,-8,14
Concordia Ch,3258,6,2,3,9,17,24,-7,9
FCSB,3259,1,8,6,0,26,11,15,30
CFR Cluj,3259,2,5,7,2,17,13,4,22
D Bucuresti,3259,3,4,5,5,18,19,-1,17
Universitate,3259,4,3,7,4,17,21,-4,16
FC Botosani,3259,5,4,4,6,7,14,-7,16
Concordia Ch,3259,6,2,3,9,17,24,-7,9
CFR Cluj,3260,1,7,6,1,17,8,9,27
FCSB,3260,2,7,5,2,23,14,9,26
Universitate,3260,3,4,5,5,17,20,-3,17
FC Botosani,3260,4,3,6,5,6,13,-7,15
D Bucuresti,3260,5,3,5,6,17,22,-5,14
Concordia Ch,3260,6,3,3,8,18,21,-3,12
CFR Cluj,3261,1,7,6,1,20,7,13,27
FCSB,3261,2,7,6,1,25,14,11,27
Universitate,3261,3,3,6,5,16,25,-9,15
Concordia Ch,3261,4,4,2,8,20,22,-2,14
D Bucuresti,3261,5,3,5,6,18,23,-5,14
FC Botosani,3261,6,3,5,6,6,14,-8,14
FCSB,3262,1,9,5,0,26,10,16,32
CFR Cluj,3262,2,5,7,2,14,10,4,22
D Bucuresti,3262,3,4,4,6,19,21,-2,16
Universitate,3262,4,3,6,5,15,20,-5,15
FC Botosani,3262,5,3,5,6,6,16,-10,14
Concordia Ch,3262,6,3,3,8,19,22,-3,12
FCSB,3263,1,8,6,0,26,12,14,30
CFR Cluj,3263,2,5,7,2,15,10,5,22
D Bucuresti,3263,3,5,4,5,20,20,0,19
Universitate,3263,4,4,5,5,17,21,-4,17
FC Botosani,3263,5,4,4,6,7,13,-6,16
Concordia Ch,3263,6,2,2,10,17,26,-9,8
CFR Cluj,3264,1,7,6,1,21,8,13,27
FCSB,3264,2,7,5,2,24,14,10,26
D Bucuresti,3264,3,4,5,5,19,20,-1,17
Universitate,3264,4,4,5,5,15,23,-8,17
FC Botosani,3264,5,3,6,5,6,13,-7,15
Concordia Ch,3264,6,2,3,9,18,25,-7,9
FCSB,3265,1,8,6,0,26,12,14,30
CFR Cluj,3265,2,5,7,2,15,10,5,22
Universitate,3265,3,4,5,5,15,19,-4,17
FC Botosani,3265,4,4,5,5,8,13,-5,17
D Bucuresti,3265,5,3,5,6,18,21,-3,14
Concordia Ch,3265,6,3,2,9,17,24,-7,11
FCSB,3266,1,9,5,0,29,12,17,32
CFR Cluj,3266,2,6,6,2,18,13,5,24
D Bucuresti,3266,3,4,4,6,17,21,-4,16
FC Botosani,3266,4,4,4,6,6,13,-7,16
Universitate,3266,5,3,5,6,15,22,-7,14
Concordia Ch,3266,6,3,2,9,18,22,-4,11
FCSB,3267,1,7,6,1,25,13,12,27
CFR Cluj,3267,2,5,7,2,15,10,5,22
Universitate,3267,3,5,5,4,16,18,-2,20
D Bucuresti,3267,4,4,5,5,19,19,0,17
FC Botosani,3267,5,3,5,6,6,15,-9,14
Concordia Ch,3267,6,2,4,8,17,23,-6,10
FCSB,3268,1,7,6,1,24,13,11,27
CFR Cluj,3268,2,5,7,2,14,9,5,22
Universitate,3268,3,5,5,4,17,18,-1,20
D Bucuresti,3268,4,4,4,6,18,24,-6,16
Concordia Ch,3268,5,4,2,8,21,21,0,14
FC Botosani,3268,6,3,4,7,6,15,-9,13
FCSB,3269,1,7,6,1,25,14,11,27
CFR Cluj,3269,2,6,7,1,17,8,9,25
Universitate,3269,3,4,5,5,17,22,-5,17
FC Botosani,3269,4,4,4,6,7,14,-7,16
Concordia Ch,3269,5,4,2,8,18,22,-4,14
D Bucuresti,3269,6,3,4,7,16,20,-4,13
FCSB,3270,1,8,5,1,26,11,15,29
CFR Cluj,3270,2,5,6,3,14,12,2,21
Universitate,3270,3,5,5,4,17,19,-2,20
D Bucuresti,3270,4,4,4,6,19,20,-1,16
FC Botosani,3270,5,3,5,6,7,16,-9,14
Concordia Ch,3270,6,3,3,8,17,22,-5,12
FCSB,3271,1,8,5,1,26,13,13,29
CFR Cluj,3271,2,7,6,1,17,7,10,27
D Bucuresti,3271,3,4,4,6,17,19,-2,16
FC Botosani,3271,4,4,4,6,7,15,-8,16
Universitate,3271,5,3,5,6,16,24,-8,14
Concordia Ch,3271,6,3,2,9,18,23,-5,11
FCSB,3272,1,7,7,0,26,13,13,28
CFR Cluj,3272,2,6,7,1,16,9,7,25
D Bucuresti,3272,3,3,6,5,18,20,-2,15
Universitate,3272,4,3,6,5,17,22,-5,15
FC Botosani,3272,5,3,5,6,6,15,-9,14
Concordia Ch,3272,6,3,3,8,18,22,-4,12
FCSB,3273,1,7,6,1,24,12,12,27
CFR Cluj,3273,2,6,7,1,15,8,7,25
D Bucuresti,3273,3,5,4,5,21,19,2,19
Universitate,3273,4,3,7,4,14,18,-4,16
FC Botosani,3273,5,3,4,7,6,16,-10,13
Concordia Ch,3273,6,3,2,9,18,25,-7,11
FCSB,3274,1,7,6,1,24,12,12,27
CFR Cluj,3274,2,7,6,1,16,7,9,27
FC Botosani,3274,3,4,5,5,9,14,-5,17
Universitate,3274,4,3,6,5,15,21,-6,15
D Bucuresti,3274,5,3,5,6,17,20,-3,14
Concordia Ch,3274,6,3,2,9,17,24,-7,11
FCSB,3275,1,7,6,1,25,14,11,27
CFR Cluj,3275,2,6,7,1,16,8,8,25
Universitate,3275,3,4,5,5,17,21,-4,17
FC Botosani,3275,4,4,5,5,8,13,-5,17
D Bucuresti,3275,5,3,5,6,17,22,-5,14
Concordia Ch,3275,6,3,2,9,18,23,-5,11
FCSB,3276,1,8,5,1,24,11,13,29
CFR Cluj,3276,2,6,7,1,14,7,7,25
D Bucuresti,3276,3,5,4,5,21,21,0,19
Universitate,3276,4,3,6,5,14,19,-5,15
FC Botosani,3276,5,3,4,7,7,17,-10,13
Concordia Ch,3276,6,3,2,9,20,25,-5,11
CFR Cluj,3277,1,7,6,1,15,7,8,27
FCSB,3277,2,7,5,2,25,14,11,26
Universitate,3277,3,4,5,5,17,21,-4,17
D Bucuresti,3277,4,3,6,5,19,21,-2,15
FC Botosani,3277,5,3,5,6,5,16,-11,14
Concordia Ch,3277,6,3,3,8,22,24,-2,12
FCSB,3278,1,9,5,0,25,10,15,32
CFR Cluj,3278,2,5,7,2,15,10,5,22
D Bucuresti,3278,3,4,4,6,18,23,-5,16
Universitate,3278,4,3,6,5,16,21,-5,15
FC Botosani,3278,5,3,5,6,6,14,-8,14
Concordia Ch,3278,6,3,3,8,19,21,-2,12
FCSB,3279,1,7,6,1,25,13,12,27
CFR Cluj,3279,2,6,7,1,16,8,8,25
Universitate,3279,3,4,5,5,16,21,-5,17
FC Botosani,3279,4,4,5,5,6,12,-6,17
D Bucuresti,3279,5,3,4,7,16,23,-7,13
Concordia Ch,3279,6,3,3,8,19,21,-2,12
FCSB,3280,1,7,6,1,24,14,10,27
CFR Cluj,3280,2,6,7,1,16,9,7,25
Universitate,3280,3,4,5,5,18,20,-2,17
D Bucuresti,3280,4,4,4,6,20,21,-1,16
FC Botosani,3280,5,4,4,6,9,17,-8,16
Concordia Ch,3280,6,3,2,9,18,24,-6,11
FCSB,3281,1,9,5,0,25,10,15,32
CFR Cluj,3281,2,6,6,2,16,9,7,24
D Bucuresti,3281,3,5,4,5,22,20,2,19
Universitate,3281,4,3,5,6,15,22,-7,14
FC Botosani,3281,5,3,5,6,5,15,-10,14
Concordia Ch,3281,6,2,3,9,17,24,-7,9
FCSB,3282,1,7,7,0,26,13,13,28
CFR Cluj,3282,2,6,7,1,16,9,7,25
D Bucuresti,3282,3,4,4,6,20,20,0,16
FC Botosani,3282,4,4,4,6,10,18,-8,16
Universitate,3282,5,3,6,5,15,20,-5,15
Concordia Ch,3282,6,3,2,9,18,25,-7,11
FCSB,3283,1,8,5,1,26,14,12,29
CFR Cluj,3283,2,6,6,2,15,9,6,24
D Bucuresti,3283,3,4,5,5,20,19,1,17
Universitate,3283,4,4,5,5,18,21,-3,17
FC Botosani,3283,5,3,4,7,5,16,-11,13
Concordia Ch,3283,6,3,3,8,17,22,-5,12
FCSB,3284,1,8,6,0,25,10,15,30
CFR Cluj,3284,2,6,7,1,15,8,7,25
FC Botosani,3284,3,4,4,6,9,13,-4,16
Concordia Ch,3284,4,4,2,8,18,22,-4,14
Universitate,3284,5,3,5,6,15,22,-7,14
D Bucuresti,3284,6,3,4,7,17,24,-7,13
FCSB,3285,1,8,5,1,25,13,12,29
CFR Cluj,3285,2,5,7,2,14,9,5,22
Universitate,3285,3,4,6,4,18,20,-2,18
D Bucuresti,3285,4,3,6,5,17,19,-2,15
FC Botosani,3285,5,3,6,5,8,15,-7,15
Concordia Ch,3285,6,2,4,8,19,25,-6,10
FCSB,3286,1,8,6,0,26,12,14,30
CFR Cluj,3286,2,6,6,2,15,9,6,24
D Bucuresti,3286,3,4,5,5,17,18,-1,17
FC Botosani,3286,4,4,5,5,6,12,-6,17
Universitate,3286,5,3,6,5,15,20,-5,15
Concordia Ch,3286,6,2,2,10,15,23,-8,8
FCSB,3287,1,7,7,0,25,12,13,28
CFR Cluj,3287,2,6,7,1,16,9,7,25
D Bucuresti,3287,3,4,4,6,20,24,-4,16
FC Botosani,3287,4,4,4,6,7,15,-8,16
Universitate,3287,5,3,6,5,16,21,-5,15
Concordia Ch,3287,6,3,2,9,20,23,-3,11
FCSB,3288,1,8,6,0,26,11,15,30
CFR Cluj,3288,2,6,7,1,15,8,7,25
FC Botosani,3288,3,4,5,5,7,12,-5,17
D Bucuresti,3288,4,3,6,5,16,18,-2,15
Universitate,3288,5,3,5,6,14,21,-7,14
Concordia Ch,3288,6,2,3,9,15,23,-8,9
CFR Cluj,3289,1,7,6,1,16,7,9,27
FCSB,3289,2,7,5,2,23,13,10,26
Universitate,3289,3,4,5,5,15,19,-4,17
D Bucuresti,3289,4,4,4,6,18,20,-2,16
FC Botosani,3289,5,4,4,6,8,15,-7,16
Concordia Ch,3289,6,3,2,9,18,24,-6,11
FCSB,3290,1,7,6,1,23,12,11,27
CFR Cluj,3290,2,6,7,1,14,7,7,25
D Bucuresti,3290,3,5,4,5,21,20,1,19
Universitate,3290,4,4,5,5,16,19,-3,17
FC Botosani,3290,5,4,4,6,7,13,-6,16
Concordia Ch,3290,6,2,2,10,17,27,-10,8
FCSB,3291,1,8,6,0,24,10,14,30
CFR Cluj,3291,2,6,6,2,15,9,6,24
FC Botosani,3291,3,5,4,5,11,13,-2,19
Universitate,3291,4,3,6,5,15,20,-5,15
D Bucuresti,3291,5,3,4,7,16,21,-5,13
Concordia Ch,3291,6,3,2,9,17,25,-8,11
FCSB,3292,1,9,5,0,27,10,17,32
CFR Cluj,3292,2,5,6,3,14,11,3,21
Universitate,3292,3,4,5,5,16,21,-5,17
D Bucuresti,3292,4,4,4,6,19,20,-1,16
FC Botosani,3292,5,3,5,6,6,15,-9,14
Concordia Ch,3292,6,3,3,8,18,23,-5,12
FCSB,3293,1,8,5,1,27,15,12,29
CFR Cluj,3293,2,6,6,2,15,9,6,24
Universitate,3293,3,4,5,5,18,21,-3,17
D Bucuresti,3293,4,4,4,6,18,23,-5,16
FC Botosani,3293,5,3,5,6,5,14,-9,14
Concordia Ch,3293,6,3,3,8,20,21,-1,12
FCSB,3294,1,7,6,1,24,13,11,27
CFR Cluj,3294,2,6,7,1,14,7,7,25
Universitate,3294,3,4,5,5,17,20,-3,17
D Bucuresti,3294,4,3,6,5,18,20,-2,15
FC Botosani,3294,5,3,5,6,9,18,-9,14
Concordia Ch,3294,6,3,3,8,21,25,-4,12
FCSB,3295,1,7,7,0,25,12,13,28
CFR Cluj,3295,2,5,8,1,15,9,6,23
FC Botosani,3295,3,4,5,5,8,13,-5,17
Universitate,3295,4,3,7,4,16,20,-4,16
D Bucuresti,3295,5,3,4,7,17,23,-6,13
Concordia Ch,3295,6,3,3,8,19,23,-4,12
FCSB,3296,1,8,6,0,26,12,14,30
CFR Cluj,3296,2,5,6,3,14,10,4,21
Universitate,3296,3,4,6,4,16,19,-3,18
D Bucuresti,3296,4,4,5,5,20,20,0,17
FC Botosani,3296,5,4,4,6,8,16,-8,16
Concordia Ch,3296,6,2,3,9,17,24,-7,9
FCSB,3297,1,8,5,1,25,12,13,29
CFR Cluj,3297,2,5,7,2,14,9,5,22
Universitate,3297,3,4,6,4,15,18,-3,18
D Bucuresti,3297,4,4,5,5,19,20,-1,17
FC Botosani,3297,5,4,4,6,9,14,-5,16
Concordia Ch,3297,6,2,3,9,16,25,-9,9
FCSB,3298,1,9,5,0,27,11,16,32
CFR Cluj,3298,2,6,6,2,14,8,6,24
Concordia Ch,3298,3,4,2,8,21,23,-2,14
D Bucuresti,3298,4,3,5,6,17,22,-5,14
Universitate,3298,5,3,5,6,15,22,-7,14
FC Botosani,3298,6,3,5,6,8,16,-8,14
FCSB,3299,1,8,5,1,25,12,13,29
CFR Cluj,3299,2,6,6,2,14,8,6,24
Universitate,3299,3,4,5,5,16,20,-4,17
FC Botosani,3299,4,4,5,5,9,14,-5,17
D Bucuresti,3299,5,3,4,7,16,21,-5,13
Concordia Ch,3299,6,3,3,8,18,23,-5,12
FCSB,3300,1,9,5,0,25,10,15,32
CFR Cluj,3300,2,6,6,2,15,8,7,24
D Bucuresti,3300,3,4,5,5,19,20,-1,17
Universitate,3300,4,3,5,6,14,21,-7,14
FC Botosani,3300,5,3,4,7,5,14,-9,13
Concordia Ch,3300,6,3,3,8,18,23,-5,12
CFR Cluj,3301,1,7,6,1,21,8,13,27
FCSB,3301,2,7,5,2,25,14,11,26
Universitate,3301,3,4,5,5,16,25,-9,17
FC Botosani,3301,4,3,6,5,6,13,-7,15
D Bucuresti,3301,5,3,5,6,16,20,-4,14
Concordia Ch,3301,6,3,3,8,18,22,-4,12
FCSB,3302,1,7,6,1,24,12,12,27
CFR Cluj,3302,2,6,7,1,15,8,7,25
Universitate,3302,3,4,5,5,15,19,-4,17
FC Botosani,3302,4,3,6,5,6,13,-7,15
D Bucuresti,3302,5,3,5,6,18,22,-4,14
Concordia Ch,3302,6,3,3,8,18,22,-4,12
FCSB,3303,1,7,5,2,23,14,9,26
CFR Cluj,3303,2,6,7,1,14,7,7,25
Universitate,3303,3,4,6,4,17,18,-1,18
D Bucuresti,3303,4,4,5,5,18,19,-1,17
FC Botosani,3303,5,3,5,6,5,13,-8,14
Concordia Ch,3303,6,2,4,8,16,22,-6,10
FCSB,3304,1,8,6,0,27,13,14,30
CFR Cluj,3304,2,5,8,1,16,10,6,23
D Bucuresti,3304,3,4,5,5,18,19,-1,17
Universitate,3304,4,3,6,5,16,21,-5,15
FC Botosani,3304,5,3,6,5,7,14,-7,15
Concordia Ch,3304,6,2,3,9,16,23,-7,9
FCSB,3305,1,9,5,0,26,11,15,32
CFR Cluj,3305,2,6,6,2,15,9,6,24
FC Botosani,3305,3,4,5,5,7,13,-6,17
D Bucuresti,3305,4,3,6,5,18,20,-2,15
Universitate,3305,5,3,5,6,14,20,-6,14
Concordia Ch,3305,6,2,3,9,16,23,-7,9
FCSB,3306,1,7,5,2,24,14,10,26
CFR Cluj,3306,2,6,7,1,17,10,7,25
D Bucuresti,3306,3,5,4,5,20,18,2,19
Universitate,3306,4,4,6,4,18,20,-2,18
FC Botosani,3306,5,3,4,7,5,16,-11,13
Concordia Ch,3306,6,3,2,9,17,23,-6,11
FCSB,3307,1,8,5,1,25,12,13,29
CFR Cluj,3307,2,6,7,1,15,8,7,25
FC Botosani,3307,3,4,5,5,7,12,-5,17
Universitate,3307,4,3,6,5,14,19,-5,15
D Bucuresti,3307,5,3,5,6,16,23,-7,14
Concordia Ch,3307,6,3,2,9,20,23,-3,11
FCSB,3308,1,9,5,0,30,11,19,32
CFR Cluj,3308,2,6,6,2,15,10,5,24
FC Botosani,3308,3,4,4,6,7,14,-7,16
D Bucuresti,3308,4,3,5,6,16,19,-3,14
Universitate,3308,5,3,5,6,14,23,-9,14
Concordia Ch,3308,6,3,3,8,17,22,-5,12
FCSB,3309,1,9,5,0,29,11,18,32
CFR Cluj,3309,2,5,6,3,14,12,2,21
Universitate,3309,3,4,5,5,15,20,-5,17
FC Botosani,3309,4,4,5,5,9,15,-6,17
D Bucuresti,3309,5,3,4,7,16,20,-4,13
Concordia Ch,3309,6,3,3,8,19,24,-5,12
FCSB,3310,1,8,5,1,25,12,13,29
CFR Cluj,3310,2,7,6,1,17,9,8,27
D Bucuresti,3310,3,5,4,5,20,20,0,19
Universitate,3310,4,3,5,6,15,21,-6,14
FC Botosani,3310,5,3,5,6,7,15,-8,14
Concordia Ch,3310,6,2,3,9,17,24,-7,9
FCSB,3311,1,9,5,0,30,12,18,32
CFR Cluj,3311,2,5,7,2,15,12,3,22
D Bucuresti,3311,3,4,5,5,18,19,-1,17
FC Botosani,3311,4,4,5,5,6,12,-6,17
Universitate,3311,5,3,6,5,14,20,-6,15
Concordia Ch,3311,6,2,2,10,16,24,-8,8
FCSB,3312,1,8,6,0,27,12,15,30
CFR Cluj,3312,2,6,6,2,17,9,8,24
D Bucuresti,3312,3,5,4,5,20,18,2,19
Universitate,3312,4,3,6,5,16,24,-8,15
FC Botosani,3312,5,3,4,7,6,16,-10,13
Concordia Ch,3312,6,3,2,9,17,24,-7,11
FCSB,3313,1,7,5,2,25,14,11,26
CFR Cluj,3313,2,6,7,1,15,8,7,25
Universitate,3313,3,4,6,4,16,19,-3,18
D Bucuresti,3313,4,4,5,5,20,21,-1,17
FC Botosani,3313,5,3,4,7,5,16,-11,13
Concordia Ch,3313,6,3,3,8,21,24,-3,12
FCSB,3314,1,8,6,0,28,14,14,30
CFR Cluj,3314,2,6,6,2,18,11,7,24
D Bucuresti,3314,3,4,5,5,18,18,0,17
Universitate,3314,4,3,6,5,17,23,-6,15
FC Botosani,3314,5,3,4,7,6,16,-10,13
Concordia Ch,3314,6,3,3,8,17,22,-5,12
FCSB,3315,1,7,7,0,26,13,13,28
CFR Cluj,3315,2,5,7,2,14,10,4,22
Universitate,3315,3,4,6,4,18,20,-2,18
FC Botosani,3315,4,4,5,5,6,12,-6,17
D Bucuresti,3315,5,3,5,6,17,20,-3,14
Concordia Ch,3315,6,3,2,9,17,23,-6,11
FCSB,3316,1,7,6,1,24,13,11,27
CFR Cluj,3316,2,7,6,1,18,8,10,27
D Bucuresti,3316,3,3,6,5,20,22,-2,15
Universitate,3316,4,3,6,5,16,22,-6,15
FC Botosani,3316,5,3,6,5,9,16,-7,15
Concordia Ch,3316,6,2,4,8,19,25,-6,10
FCSB,3317,1,7,6,1,25,15,10,27
CFR Cluj,3317,2,6,6,2,16,8,8,24
Universitate,3317,3,4,6,4,17,20,-3,18
FC Botosani,3317,4,4,4,6,7,13,-6,16
D Bucuresti,3317,5,3,5,6,18,22,-4,14
Concordia Ch,3317,6,3,3,8,18,23,-5,12
FCSB,3318,1,8,5,1,25,12,13,29
CFR Cluj,3318,2,6,6,2,15,8,7,24
Universitate,3318,3,4,5,5,16,21,-5,17
D Bucuresti,3318,4,3,6,5,17,19,-2,15
FC Botosani,3318,5,3,6,5,6,13,-7,15
Concordia Ch,3318,6,2,4,8,15,21,-6,10
FCSB,3319,1,8,5,1,24,11,13,29
CFR Cluj,3319,2,6,6,2,14,8,6,24
Universitate,3319,3,4,5,5,15,19,-4,17
FC Botosani,3319,4,4,4,6,7,15,-8,16
Concordia Ch,3319,5,4,2,8,19,22,-3,14
D Bucuresti,3319,6,3,4,7,16,20,-4,13
FCSB,3320,1,7,6,1,26,14,12,27
CFR Cluj,3320,2,6,7,1,18,10,8,25
FC Botosani,3320,3,5,4,5,8,13,-5,19
Universitate,3320,4,4,5,5,17,22,-5,17
D Bucuresti,3320,5,4,4,6,19,21,-2,16
Concordia Ch,3320,6,2,2,10,16,24,-8,8
FCSB,3321,1,8,6,0,25,11,14,30
CFR Cluj,3321,2,5,8,1,14,8,6,23
D Bucuresti,3321,3,4,5,5,20,18,2,17
Universitate,3321,4,3,6,5,14,19,-5,15
FC Botosani,3321,5,3,4,7,5,17,-12,13
Concordia Ch,3321,6,3,3,8,16,21,-5,12
FCSB,3322,1,8,5,1,26,11,15,29
CFR Cluj,3322,2,5,7,2,16,13,3,22
Universitate,3322,3,4,6,4,18,21,-3,18
D Bucuresti,3322,4,4,4,6,19,22,-3,16
FC Botosani,3322,5,4,4,6,8,15,-7,16
Concordia Ch,3322,6,3,2,9,19,24,-5,11
FCSB,3323,1,7,6,1,25,15,10,27
CFR Cluj,3323,2,6,7,1,16,9,7,25
Universitate,3323,3,4,5,5,19,21,-2,17
D Bucuresti,3323,4,4,4,6,18,20,-2,16
FC Botosani,3323,5,3,5,6,6,14,-8,14
Concordia Ch,3323,6,3,3,8,18,23,-5,12
CFR Cluj,3324,1,7,6,1,17,9,8,27
FCSB,3324,2,7,5,2,26,15,11,26
D Bucuresti,3324,3,4,5,5,20,19,1,17
Universitate,3324,4,4,5,5,16,20,-4,17
FC Botosani,3324,5,3,4,7,6,18,-12,13
Concordia Ch,3324,6,3,3,8,17,21,-4,12
FCSB,3325,1,8,6,0,27,12,15,30
CFR Cluj,3325,2,6,6,2,18,9,9,24
D Bucuresti,3325,3,3,6,5,16,18,-2,15
Universitate,3325,4,3,6,5,16,25,-9,15
FC Botosani,3325,5,3,5,6,5,13,-8,14
Concordia Ch,3325,6,3,3,8,16,21,-5,12
FCSB,3326,1,8,5,1,29,13,16,29
CFR Cluj,3326,2,6,6,2,15,12,3,24
D Bucuresti,3326,3,4,5,5,19,20,-1,17
Universitate,3326,4,4,5,5,16,20,-4,17
FC Botosani,3326,5,3,4,7,6,15,-9,13
Concordia Ch,3326,6,3,3,8,17,22,-5,12
FCSB,3327,1,7,6,1,24,14,10,27
CFR Cluj,3327,2,5,8,1,15,9,6,23
Universitate,3327,3,4,6,4,18,19,-1,18
D Bucuresti,3327,4,4,4,6,19,20,-1,16
FC Botosani,3327,5,3,5,6,6,15,-9,14
Concordia Ch,3327,6,3,3,8,18,23,-5,12
FCSB,3328,1,8,5,1,27,15,12,29
CFR Cluj,3328,2,5,7,2,15,11,4,22
Universitate,3328,3,4,6,4,17,18,-1,18
D Bucuresti,3328,4,4,4,6,19,22,-3,16
Concordia Ch,3328,5,4,2,8,19,22,-3,14
FC Botosani,3328,6,3,4,7,6,15,-9,13
FCSB,3329,1,8,6,0,26,12,14,30
CFR Cluj,3329,2,5,6,3,17,13,4,21
Universitate,3329,3,4,6,4,17,20,-3,18
FC Botosani,3329,4,3,6,5,6,13,-7,15
D Bucuresti,3329,5,3,5,6,17,20,-3,14
Concordia Ch,3329,6,3,3,8,16,21,-5,12
FCSB,3330,1,8,5,1,26,13,13,29
CFR Cluj,3330,2,5,7,2,14,9,5,22
Universitate,3330,3,4,6,4,16,19,-3,18
D Bucuresti,3330,4,4,4,6,17,22,-5,16
FC Botosani,3330,5,4,4,6,7,13,-6,16
Concordia Ch,3330,6,3,2,9,19,23,-4,11
FCSB,3331,1,7,6,1,23,11,12,27
CFR Cluj,3331,2,6,6,2,14,8,6,24
Universitate,3331,3,4,6,4,15,18,-3,18
D Bucuresti,3331,4,4,4,6,19,19,0,16
FC Botosani,3331,5,3,5,6,5,15,-10,14
Concordia Ch,3331,6,3,3,8,16,21,-5,12
FCSB,3332,1,8,5,1,28,13,15,29
CFR Cluj,3332,2,6,6,2,14,11,3,24
Universitate,3332,3,4,5,5,17,20,-3,17
D Bucuresti,3332,4,4,4,6,19,20,-1,16
FC Botosani,3332,5,3,5,6,5,14,-9,14
Concordia Ch,3332,6,3,3,8,17,22,-5,12
FCSB,3333,1,8,5,1,28,12,16,29
CFR Cluj,3333,2,5,7,2,13,11,2,22
D Bucuresti,3333,3,5,4,5,21,21,0,19
Universitate,3333,4,4,6,4,16,19,-3,18
FC Botosani,3333,5,4,4,6,10,15,-5,16
Concordia Ch,3333,6,2,2,10,18,28,-10,8
FCSB,3334,1,7,6,1,24,14,10,27
CFR Cluj,3334,2,5,8,1,15,9,6,23
Universitate,3334,3,4,6,4,18,19,-1,18
FC Botosani,3334,4,4,4,6,8,14,-6,16
D Bucuresti,3334,5,3,5,6,17,21,-4,14
Concordia Ch,3334,6,3,3,8,16,21,-5,12
FCSB,3335,1,8,5,1,26,12,14,29
CFR Cluj,3335,2,7,6,1,17,7,10,27
FC Botosani,3335,3,3,6,5,7,14,-7,15
D Bucuresti,3335,4,3,5,6,17,22,-5,14
Universitate,3335,5,3,5,6,15,24,-9,14
Concordia Ch,3335,6,3,3,8,19,22,-3,12
FCSB,3336,1,8,6,0,25,10,15,30
CFR Cluj,3336,2,6,6,2,15,10,5,24
FC Botosani,3336,3,4,5,5,7,13,-6,17
Universitate,3336,4,3,6,5,15,20,-5,15
D Bucuresti,3336,5,3,5,6,17,20,-3,14
Concordia Ch,3336,6,2,4,8,17,23,-6,10
FCSB,3337,1,8,6,0,26,11,15,30
CFR Cluj,3337,2,5,6,3,13,11,2,21
Universitate,3337,3,4,6,4,17,19,-2,18
D Bucuresti,3337,4,3,6,5,18,20,-2,15
FC Botosani,3337,5,3,5,6,6,14,-8,14
Concordia Ch,3337,6,3,3,8,19,24,-5,12
FCSB,3338,1,8,5,1,25,13,12,29
CFR Cluj,3338,2,6,7,1,17,9,8,25
D Bucuresti,3338,3,4,4,6,17,19,-2,16
Universitate,3338,4,3,6,5,15,20,-5,15
Concordia Ch,3338,5,4,2,8,18,21,-3,14
FC Botosani,3338,6,3,4,7,5,15,-10,13
FCSB,3339,1,7,6,1,23,11,12,27
CFR Cluj,3339,2,6,7,1,14,7,7,25
D Bucuresti,3339,3,5,4,5,19,18,1,19
Universitate,3339,4,4,5,5,15,19,-4,17
FC Botosani,3339,5,4,4,6,7,15,-8,16
Concordia Ch,3339,6,2,2,10,16,24,-8,8
FCSB,3340,1,8,6,0,24,10,14,30
CFR Cluj,3340,2,5,7,2,13,8,5,22
D Bucuresti,3340,3,4,5,5,18,19,-1,17
Universitate,3340,4,4,5,5,15,19,-4,17
FC Botosani,3340,5,4,4,6,6,13,-7,16
Concordia Ch,3340,6,2,3,9,16,23,-7,9
FCSB,3341,1,8,5,1,27,14,13,29
CFR Cluj,3341,2,5,6,3,15,12,3,21
Universitate,3341,3,5,5,4,18,19,-1,20
D Bucuresti,3341,4,5,4,5,19,18,1,19
FC Botosani,3341,5,4,4,6,7,14,-7,16
Concordia Ch,3341,6,2,2,10,15,24,-9,8
CFR Cluj,3342,1,7,6,1,15,7,8,27
FCSB,3342,2,7,5,2,23,12,11,26
D Bucuresti,3342,3,4,5,5,20,21,-1,17
Universitate,3342,4,4,5,5,15,19,-4,17
FC Botosani,3342,5,3,6,5,6,13,-7,15
Concordia Ch,3342,6,2,3,9,17,24,-7,9
FCSB,3343,1,8,5,1,24,11,13,29
CFR Cluj,3343,2,5,7,2,14,9,5,22
Universitate,3343,3,4,6,4,16,19,-3,18
FC Botosani,3343,4,3,6,5,7,14,-7,15
D Bucuresti,3343,5,3,5,6,17,20,-3,14
Concordia Ch,3343,6,3,3,8,19,24,-5,12
FCSB,3344,1,8,5,1,26,12,14,29
CFR Cluj,3344,2,5,7,2,15,11,4,22
FC Botosani,3344,3,5,4,5,7,12,-5,19
Universitate,3344,4,4,6,4,18,21,-3,18
D Bucuresti,3344,5,3,4,7,16,20,-4,13
Concordia Ch,3344,6,3,2,9,16,22,-6,11
FCSB,3345,1,7,5,2,25,15,10,26
CFR Cluj,3345,2,6,7,1,16,9,7,25
Universitate,3345,3,4,6,4,16,18,-2,18
D Bucuresti,3345,4,4,4,6,20,22,-2,16
FC Botosani,3345,5,4,4,6,9,16,-7,16
Concordia Ch,3345,6,3,2,9,17,23,-6,11
FCSB,3346,1,8,6,0,26,11,15,30
CFR Cluj,3346,2,6,7,1,16,9,7,25
FC Botosani,3346,3,5,4,5,11,14,-3,19
Universitate,3346,4,3,5,6,15,22,-7,14
D Bucuresti,3346,5,3,4,7,18,25,-7,13
Concordia Ch,3346,6,3,2,9,20,25,-5,11
CFR Cluj,3347,1,7,6,1,15,7,8,27
FCSB,3347,2,7,5,2,24,14,10,26
Universitate,3347,3,4,5,5,17,20,-3,17
FC Botosani,3347,4,3,6,5,9,16,-7,15
D Bucuresti,3347,5,3,5,6,18,23,-5,14
Concordia Ch,3347,6,3,3,8,20,23,-3,12
FCSB,3348,1,8,6,0,25,11,14,30
CFR Cluj,3348,2,6,7,1,18,7,11,25
FC Botosani,3348,3,3,6,5,8,15,-7,15
D Bucuresti,3348,4,3,5,6,18,22,-4,14
Universitate,3348,5,3,5,6,15,25,-10,14
Concordia Ch,3348,6,3,3,8,18,22,-4,12
FCSB,3349,1,7,6,1,25,13,12,27
CFR Cluj,3349,2,6,7,1,16,7,9,25
D Bucuresti,3349,3,4,5,5,19,19,0,17
Universitate,3349,4,4,5,5,17,23,-6,17
FC Botosani,3349,5,3,4,7,7,17,-10,13
Concordia Ch,3349,6,3,3,8,19,24,-5,12
FCSB,3350,1,8,6,0,25,11,14,30
CFR Cluj,3350,2,5,6,3,13,10,3,21
Universitate,3350,3,4,6,4,17,19,-2,18
FC Botosani,3350,4,4,4,6,7,14,-7,16
Concordia Ch,3350,5,4,2,8,20,22,-2,14
D Bucuresti,3350,6,3,4,7,17,23,-6,13
FCSB,3351,1,7,6,1,25,14,11,27
CFR Cluj,3351,2,6,7,1,16,8,8,25
Universitate,3351,3,3,7,4,15,19,-4,16
FC Botosani,3351,4,3,6,5,6,13,-7,15
D Bucuresti,3351,5,3,5,6,17,20,-3,14
Concordia Ch,3351,6,3,3,8,16,21,-5,12
FCSB,3352,1,8,5,1,25,12,13,29
CFR Cluj,3352,2,7,6,1,17,8,9,27
D Bucuresti,3352,3,4,5,5,18,19,-1,17
FC Botosani,3352,4,3,6,5,6,13,-7,15
Universitate,3352,5,3,5,6,16,23,-7,14
Concordia Ch,3352,6,2,3,9,17,24,-7,9
FCSB,3353,1,9,5,0,27,11,16,32
CFR Cluj,3353,2,5,6,3,13,10,3,21
Universitate,3353,3,4,5,5,16,20,-4,17
D Bucuresti,3353,4,4,4,6,18,21,-3,16
Concordia Ch,3353,5,4,2,8,18,21,-3,14
FC Botosani,3353,6,3,4,7,6,15,-9,13
FCSB,3354,1,8,5,1,25,12,13,29
CFR Cluj,3354,2,6,6,2,16,10,6,24
Universitate,3354,3,4,5,5,18,22,-4,17
FC Botosani,3354,4,4,4,6,7,13,-6,16
D Bucuresti,3354,5,3,5,6,17,21,-4,14
Concordia Ch,3354,6,3,3,8,17,22,-5,12
FCSB,3355,1,8,6,0,28,14,14,30
CFR Cluj,3355,2,6,6,2,14,8,6,24
D Bucuresti,3355,3,4,5,5,20,20,0,17
FC Botosani,3355,4,4,4,6,6,14,-8,16
Universitate,3355,5,3,6,5,18,23,-5,15
Concordia Ch,3355,6,2,3,9,17,24,-7,9
FCSB,3356,1,7,6,1,24,12,12,27
CFR Cluj,3356,2,6,7,1,15,8,7,25
D Bucuresti,3356,3,5,4,5,20,19,1,19
Universitate,3356,4,3,7,4,16,20,-4,16
FC Botosani,3356,5,3,4,7,5,15,-10,13
Concordia Ch,3356,6,3,2,9,17,23,-6,11
FCSB,3357,1,8,6,0,25,10,15,30
CFR Cluj,3357,2,5,7,2,14,9,5,22
D Bucuresti,3357,3,5,4,5,21,18,3,19
Universitate,3357,4,4,5,5,16,21,-5,17
FC Botosani,3357,5,3,5,6,7,16,-9,14
Concordia Ch,3357,6,2,3,9,17,26,-9,9
FCSB,3358,1,9,5,0,26,10,16,32
CFR Cluj,3358,2,6,6,2,15,8,7,24
FC Botosani,3358,3,5,4,5,7,12,-5,19
D Bucuresti,3358,4,4,4,6,18,19,-1,16
Universitate,3358,5,3,5,6,14,22,-8,14
Concordia Ch,3358,6,2,2,10,15,24,-9,8
CFR Cluj,3359,1,7,6,1,16,7,9,27
FCSB,3359,2,7,5,2,23,12,11,26
FC Botosani,3359,3,5,4,5,7,12,-5,19
Universitate,3359,4,4,5,5,15,20,-5,17
D Bucuresti,3359,5,4,4,6,19,19,0,16
Concordia Ch,3359,6,2,2,10,15,25,-10,8
FCSB,3360,1,9,5,0,28,11,17,32
CFR Cluj,3360,2,5,7,2,14,10,4,22
FC Botosani,3360,3,5,4,5,8,12,-4,19
Universitate,3360,4,3,6,5,16,22,-6,15
D Bucuresti,3360,5,3,5,6,18,22,-4,14
Concordia Ch,3360,6,2,3,9,17,24,-7,9
FCSB,3361,1,8,6,0,26,12,14,30
CFR Cluj,3361,2,5,7,2,14,9,5,22
Universitate,3361,3,4,5,5,16,20,-4,17
FC Botosani,3361,4,4,5,5,8,13,-5,17
D Bucuresti,3361,5,3,6,5,18,20,-2,15
Concordia Ch,3361,6,2,3,9,16,24,-8,9
FCSB,3362,1,7,7,0,23,10,13,28
CFR Cluj,3362,2,5,8,1,15,9,6,23
D Bucuresti,3362,3,5,4,5,22,18,4,19
Universitate,3362,4,3,7,4,16,20,-4,16
FC Botosani,3362,5,3,5,6,5,14,-9,14
Concordia Ch,3362,6,2,3,9,15,25,-10,9
FCSB,3363,1,8,5,1,28,14,14,29
CFR Cluj,3363,2,6,6,2,16,11,5,24
FC Botosani,3363,3,5,4,5,8,13,-5,19
Universitate,3363,4,4,5,5,18,22,-4,17
D Bucuresti,3363,5,3,4,7,18,22,-4,13
Concordia Ch,3363,6,3,2,9,17,23,-6,11
FCSB,3364,1,8,6,0,28,14,14,30
CFR Cluj,3364,2,5,8,1,15,9,6,23
D Bucuresti,3364,3,4,5,5,20,20,0,17
FC Botosani,3364,4,4,5,5,8,13,-5,17
Universitate,3364,5,3,6,5,16,21,-5,15
Concordia Ch,3364,6,2,2,10,16,26,-10,8
FCSB,3365,1,8,5,1,29,12,17,29
CFR Cluj,3365,2,6,6,2,15,11,4,24
Universitate,3365,3,4,5,5,17,23,-6,17
D Bucuresti,3365,4,4,4,6,17,19,-2,16
FC Botosani,3365,5,4,4,6,9,13,-4,16
Concordia Ch,3365,6,3,2,9,16,25,-9,11
FCSB,3366,1,8,5,1,24,11,13,29
CFR Cluj,3366,2,6,6,2,17,9,8,24
D Bucuresti,3366,3,4,5,5,19,20,-1,17
Universitate,3366,4,4,5,5,16,22,-6,17
FC Botosani,3366,5,3,5,6,6,14,-8,14
Concordia Ch,3366,6,3,2,9,17,23,-6,11
FCSB,3367,1,7,7,0,25,12,13,28
CFR Cluj,3367,2,6,7,1,17,8,9,25
D Bucuresti,3367,3,4,5,5,19,20,-1,17
Universitate,3367,4,3,6,5,15,22,-7,15
FC Botosani,3367,5,3,5,6,7,16,-9,14
Concordia Ch,3367,6,3,2,9,17,22,-5,11
FCSB,3368,1,8,5,1,27,12,15,29
CFR Cluj,3368,2,6,6,2,15,9,6,24
D Bucuresti,3368,3,4,5,5,19,20,-1,17
Universitate,3368,4,4,5,5,17,23,-6,17
FC Botosani,3368,5,3,6,5,8,15,-7,15
Concordia Ch,3368,6,2,3,9,18,25,-7,9
FCSB,3369,1,8,6,0,27,12,15,30
CFR Cluj,3369,2,6,6,2,15,10,5,24
D Bucuresti,3369,3,4,4,6,19,21,-2,16
Universitate,3369,4,3,6,5,17,22,-5,15
FC Botosani,3369,5,3,5,6,6,14,-8,14
Concordia Ch,3369,6,3,3,8,19,24,-5,12
FCSB,3370,1,8,5,1,26,12,14,29
CFR Cluj,3370,2,6,6,2,17,12,5,24
Universitate,3370,3,4,5,5,17,21,-4,17
FC Botosani,3370,4,4,5,5,7,13,-6,17
D Bucuresti,3370,5,3,6,5,17,19,-2,15
Concordia Ch,3370,6,2,3,9,15,22,-7,9
FCSB,3371,1,7,6,1,25,13,12,27
CFR Cluj,3371,2,6,7,1,16,8,8,25
D Bucuresti,3371,3,4,5,5,20,20,0,17
Universitate,3371,4,4,5,5,16,21,-5,17
FC Botosani,3371,5,4,5,5,6,12,-6,17
Concordia Ch,3371,6,2,2,10,17,26,-9,8
FCSB,3372,1,7,6,1,24,12,12,27
CFR Cluj,3372,2,6,7,1,15,8,7,25
Universitate,3372,3,3,7,4,16,20,-4,16
D Bucuresti,3372,4,3,6,5,20,22,-2,15
FC Botosani,3372,5,3,6,5,6,13,-7,15
Concordia Ch,3372,6,2,4,8,18,24,-6,10
CFR Cluj,3373,1,7,6,1,17,8,9,27
FCSB,3373,2,7,5,2,24,15,9,26
Universitate,3373,3,4,5,5,17,20,-3,17
D Bucuresti,3373,4,4,4,6,17,19,-2,16
Concordia Ch,3373,5,4,2,8,17,21,-4,14
FC Botosani,3373,6,3,4,7,5,14,-9,13
FCSB,3374,1,8,5,1,26,12,14,29
CFR Cluj,3374,2,6,6,2,15,11,4,24
D Bucuresti,3374,3,5,4,5,19,18,1,19
Universitate,3374,4,4,5,5,17,20,-3,17
FC Botosani,3374,5,3,5,6,5,14,-9,14
Concordia Ch,3374,6,2,3,9,15,22,-7,9
FCSB,3375,1,8,5,1,25,12,13,29
CFR Cluj,3375,2,5,7,2,14,9,5,22
Universitate,3375,3,4,6,4,17,20,-3,18
D Bucuresti,3375,4,4,5,5,18,19,-1,17
FC Botosani,3375,5,4,5,5,9,15,-6,17
Concordia Ch,3375,6,2,2,10,17,25,-8,8
FCSB,3376,1,9,5,0,31,14,17,32
CFR Cluj,3376,2,6,6,2,17,12,5,24
D Bucuresti,3376,3,4,5,5,17,18,-1,17
FC Botosani,3376,4,4,5,5,9,14,-5,17
Universitate,3376,5,3,5,6,15,22,-7,14
Concordia Ch,3376,6,2,2,10,17,26,-9,8
FCSB,3377,1,7,6,1,24,15,9,27
CFR Cluj,3377,2,6,7,1,15,8,7,25
Universitate,3377,3,4,5,5,18,19,-1,17
D Bucuresti,3377,4,3,6,5,21,23,-2,15
FC Botosani,3377,5,3,5,6,8,18,-10,14
Concordia Ch,3377,6,3,3,8,22,25,-3,12
FCSB,3378,1,9,5,0,26,11,15,32
CFR Cluj,3378,2,6,6,2,16,8,8,24
Concordia Ch,3378,3,4,2,8,22,25,-3,14
D Bucuresti,3378,4,3,5,6,18,21,-3,14
Universitate,3378,5,3,5,6,15,23,-8,14
FC Botosani,3378,6,3,5,6,7,16,-9,14
FCSB,3379,1,8,5,1,27,15,12,29
CFR Cluj,3379,2,5,6,3,15,12,3,21
Universitate,3379,3,5,5,4,19,19,0,20
FC Botosani,3379,4,4,4,6,6,13,-7,16
D Bucuresti,3379,5,3,5,6,17,20,-3,14
Concordia Ch,3379,6,3,3,8,17,22,-5,12
FCSB,3380,1,7,6,1,25,13,12,27
CFR Cluj,3380,2,6,6,2,15,9,6,24
D Bucuresti,3380,3,5,4,5,19,19,0,19
Universitate,3380,4,4,6,4,18,21,-3,18
FC Botosani,3380,5,4,4,6,7,13,-6,16
Concordia Ch,3380,6,2,2,10,16,25,-9,8
FCSB,3381,1,7,5,2,23,12,11,26
CFR Cluj,3381,2,6,6,2,14,8,6,24
Universitate,3381,3,5,5,4,16,18,-2,20
D Bucuresti,3381,4,4,5,5,19,20,-1,17
FC Botosani,3381,5,4,5,5,9,14,-5,17
Concordia Ch,3381,6,2,2,10,15,24,-9,8
FCSB,3382,1,8,5,1,25,13,12,29
CFR Cluj,3382,2,6,6,2,15,9,6,24
D Bucuresti,3382,3,5,4,5,22,19,3,19
Universitate,3382,4,4,5,5,17,20,-3,17
FC Botosani,3382,5,3,4,7,6,18,-12,13
Concordia Ch,3382,6,3,2,9,18,24,-6,11
FCSB,3383,1,8,5,1,26,13,13,29
CFR Cluj,3383,2,5,6,3,14,10,4,21
Universitate,3383,3,5,5,4,17,19,-2,20
D Bucuresti,3383,4,4,5,5,19,20,-1,17
FC Botosani,3383,5,3,5,6,6,14,-8,14
Concordia Ch,3383,6,2,4,8,18,24,-6,10
FCSB,3384,1,7,6,1,25,13,12,27
CFR Cluj,3384,2,7,6,1,17,8,9,27
Universitate,3384,3,3,6,5,15,21,-6,15
FC Botosani,3384,4,3,6,5,7,14,-7,15
D Bucuresti,3384,5,3,5,6,17,20,-3,14
Concordia Ch,3384,6,3,3,8,17,22,-5,12
FCSB,3385,1,8,6,0,25,11,14,30
CFR Cluj,3385,2,6,7,1,15,8,7,25
D Bucuresti,3385,3,4,5,5,20,20,0,17
FC Botosani,3385,4,3,6,5,8,15,-7,15
Universitate,3385,5,3,5,6,16,22,-6,14
Concordia Ch,3385,6,2,3,9,16,24,-8,9
FCSB,3386,1,8,6,0,25,11,14,30
CFR Cluj,3386,2,5,8,1,14,8,6,23
D Bucuresti,3386,3,5,4,5,20,19,1,19
FC Botosani,3386,4,4,4,6,6,13,-7,16
Universitate,3386,5,3,6,5,14,19,-5,15
Concordia Ch,3386,6,2,2,10,16,25,-9,8
FCSB,3387,1,9,5,0,30,13,17,32
CFR Cluj,3387,2,5,7,2,15,10,5,22
D Bucuresti,3387,3,4,5,5,17,18,-1,17
Universitate,3387,4,3,6,5,15,22,-7,15
FC Botosani,3387,5,3,5,6,6,14,-8,14
Concordia Ch,3387,6,3,2,9,17,23,-6,11
FCSB,3388,1,8,6,0,26,11,15,30
CFR Cluj,3388,2,6,7,1,15,8,7,25
D Bucuresti,3388,3,4,5,5,20,21,-1,17
FC Botosani,3388,4,4,5,5,9,15,-6,17
Universitate,3388,5,3,5,6,16,23,-7,14
Concordia Ch,3388,6,2,2,10,17,25,-8,8
FCSB,3389,1,7,6,1,25,13,12,27
CFR Cluj,3389,2,6,7,1,16,9,7,25
Universitate,3389,3,3,7,4,16,20,-4,16
FC Botosani,3389,4,4,4,6,8,15,-7,16
D Bucuresti,3389,5,3,5,6,19,22,-3,14
Concordia Ch,3389,6,3,3,8,19,24,-5,12
FCSB,3390,1,8,6,0,26,12,14,30
CFR Cluj,3390,2,5,7,2,14,9,5,22
FC Botosani,3390,3,4,5,5,10,14,-4,17
D Bucuresti,3390,4,4,4,6,19,22,-3,16
Universitate,3390,5,3,7,4,17,21,-4,16
Concordia Ch,3390,6,2,3,9,16,24,-8,9
FCSB,3391,1,8,5,1,25,12,13,29
CFR Cluj,3391,2,6,6,2,16,10,6,24
D Bucuresti,3391,3,4,5,5,19,19,0,17
Universitate,3391,4,4,5,5,16,20,-4,17
FC Botosani,3391,5,3,5,6,6,15,-9,14
Concordia Ch,3391,6,2,4,8,17,23,-6,10
FCSB,3392,1,8,6,0,26,11,15,30
CFR Cluj,3392,2,5,7,2,14,10,4,22
D Bucuresti,3392,3,4,5,5,21,20,1,17
Universitate,3392,4,3,7,4,16,20,-4,16
FC Botosani,3392,5,4,4,6,7,16,-9,16
Concordia Ch,3392,6,2,3,9,16,23,-7,9
CFR Cluj,3393,1,7,6,1,18,7,11,27
FCSB,3393,2,7,5,2,24,15,9,26
Universitate,3393,3,4,5,5,16,21,-5,17
D Bucuresti,3393,4,3,6,5,17,19,-2,15
FC Botosani,3393,5,3,5,6,6,14,-8,14
Concordia Ch,3393,6,3,3,8,18,23,-5,12
FCSB,3394,1,8,5,1,26,13,13,29
CFR Cluj,3394,2,5,7,2,13,8,5,22
D Bucuresti,3394,3,5,4,5,21,19,2,19
Universitate,3394,4,4,6,4,17,20,-3,18
FC Botosani,3394,5,3,5,6,6,15,-9,14
Concordia Ch,3394,6,2,3,9,17,25,-8,9
FCSB,3395,1,7,5,2,23,12,11,26
CFR Cluj,3395,2,6,7,1,14,7,7,25
D Bucuresti,3395,3,5,4,5,21,18,3,19
Universitate,3395,4,4,6,4,15,18,-3,18
FC Botosani,3395,5,4,4,6,8,17,-9,16
Concordia Ch,3395,6,2,2,10,16,25,-9,8
FCSB,3396,1,7,6,1,26,15,11,27
CFR Cluj,3396,2,6,7,1,16,9,7,25
Universitate,3396,3,4,5,5,19,22,-3,17
FC Botosani,3396,4,4,5,5,8,14,-6,17
D Bucuresti,3396,5,3,6,5,20,22,-2,15
Concordia Ch,3396,6,2,3,9,17,24,-7,9
FCSB,3397,1,9,5,0,29,14,15,32
CFR Cluj,3397,2,5,6,3,16,12,4,21
Universitate,3397,3,4,5,5,18,22,-4,17
FC Botosani,3397,4,4,4,6,6,15,-9,16
Concordia Ch,3397,5,4,2,8,21,23,-2,14
D Bucuresti,3397,6,3,4,7,18,22,-4,13
FCSB,3398,1,8,5,1,30,13,17,29
CFR Cluj,3398,2,7,6,1,16,8,8,27
D Bucuresti,3398,3,4,5,5,20,20,0,17
FC Botosani,3398,4,3,6,5,7,14,-7,15
Universitate,3398,5,3,5,6,15,25,-10,14
Concordia Ch,3398,6,2,3,9,17,25,-8,9
FCSB,3399,1,8,5,1,26,12,14,29
CFR Cluj,3399,2,6,6,2,15,9,6,24
D Bucuresti,3399,3,4,5,5,19,20,-1,17
Universitate,3399,4,4,5,5,15,20,-5,17
FC Botosani,3399,5,3,5,6,5,13,-8,14
Concordia Ch,3399,6,2,4,8,17,23,-6,10
FCSB,3400,1,9,5,0,27,12,15,32
CFR Cluj,3400,2,5,6,3,13,10,3,21
FC Botosani,3400,3,5,4,5,10,12,-2,19
Universitate,3400,4,4,5,5,18,21,-3,17
D Bucuresti,3400,5,3,4,7,17,22,-5,13
Concordia Ch,3400,6,3,2,9,17,25,-8,11
FCSB,3401,1,7,6,1,24,13,11,27
CFR Cluj,3401,2,7,6,1,20,10,10,27
D Bucuresti,3401,3,4,4,6,18,20,-2,16
Universitate,3401,4,3,6,5,16,22,-6,15
FC Botosani,3401,5,3,5,6,6,14,-8,14
Concordia Ch,3401,6,3,3,8,18,23,-5,12
FCSB,3402,1,9,5,0,27,10,17,32
CFR Cluj,3402,2,6,6,2,16,10,6,24
D Bucuresti,3402,3,4,4,6,20,21,-1,16
FC Botosani,3402,4,4,4,6,7,15,-8,16
Universitate,3402,5,3,5,6,15,23,-8,14
Concordia Ch,3402,6,3,2,9,17,23,-6,11
FCSB,3403,1,8,5,1,25,12,13,29
CFR Cluj,3403,2,6,6,2,15,10,5,24
Universitate,3403,3,4,5,5,17,20,-3,17
Concordia Ch,3403,4,4,2,8,18,21,-3,14
D Bucuresti,3403,5,3,5,6,17,21,-4,14
FC Botosani,3403,6,3,5,6,6,14,-8,14
FCSB,3404,1,8,6,0,27,12,15,30
CFR Cluj,3404,2,6,7,1,15,8,7,25
FC Botosani,3404,3,3,6,5,6,13,-7,15
D Bucuresti,3404,4,3,5,6,17,23,-6,14
Universitate,3404,5,3,5,6,15,22,-7,14
Concordia Ch,3404,6,3,3,8,21,23,-2,12
FCSB,3405,1,7,7,0,24,11,13,28
CFR Cluj,3405,2,5,7,2,15,10,5,22
Universitate,3405,3,4,6,4,16,19,-3,18
FC Botosani,3405,4,3,6,5,5,12,-7,15
D Bucuresti,3405,5,3,5,6,17,20,-3,14
Concordia Ch,3405,6,3,3,8,17,22,-5,12
FCSB,3406,1,7,7,0,24,11,13,28
CFR Cluj,3406,2,6,7,1,15,8,7,25
FC Botosani,3406,3,5,4,5,8,13,-5,19
Universitate,3406,4,3,6,5,14,19,-5,15
D Bucuresti,3406,5,3,4,7,19,25,-6,13
Concordia Ch,3406,6,3,2,9,20,24,-4,11
CFR Cluj,3407,1,7,6,1,19,7,12,27
FCSB,3407,2,7,6,1,24,15,9,27
FC Botosani,3407,3,4,5,5,6,12,-6,17
Universitate,3407,4,3,6,5,15,21,-6,15
D Bucuresti,3407,5,3,5,6,17,20,-3,14
Concordia Ch,3407,6,2,4,8,16,22,-6,10
FCSB,3408,1,8,5,1,24,12,12,29
CFR Cluj,3408,2,5,6,3,14,10,4,21
Universitate,3408,3,5,5,4,18,19,-1,20
D Bucuresti,3408,4,4,5,5,18,18,0,17
FC Botosani,3408,5,3,4,7,6,16,-10,13
Concordia Ch,3408,6,3,3,8,17,22,-5,12
FCSB,3409,1,9,5,0,28,12,16,32
CFR Cluj,3409,2,6,6,2,16,9,7,24
D Bucuresti,3409,3,4,4,6,19,23,-4,16
Concordia Ch,3409,4,4,2,8,21,22,-1,14
Universitate,3409,5,3,5,6,15,23,-8,14
FC Botosani,3409,6,3,4,7,5,15,-10,13
FCSB,3410,1,7,6,1,24,12,12,27
CFR Cluj,3410,2,6,7,1,14,7,7,25
FC Botosani,3410,3,5,4,5,9,12,-3,19
Universitate,3410,4,3,7,4,15,19,-4,16
D Bucuresti,3410,5,3,4,7,16,20,-4,13
Concordia Ch,3410,6,3,2,9,16,24,-8,11
FCSB,3411,1,8,5,1,25,12,13,29
CFR Cluj,3411,2,7,6,1,16,7,9,27
D Bucuresti,3411,3,4,4,6,19,19,0,16
FC Botosani,3411,4,4,4,6,7,15,-8,16
Universitate,3411,5,3,5,6,14,21,-7,14
Concordia Ch,3411,6,3,2,9,16,23,-7,11
FCSB,3412,1,8,5,1,25,12,13,29
CFR Cluj,3412,2,5,7,2,13,8,5,22
Universitate,3412,3,4,6,4,16,19,-3,18
D Bucuresti,3412,4,4,5,5,19,19,0,17
FC Botosani,3412,5,3,4,7,6,16,-10,13
Concordia Ch,3412,6,3,3,8,16,21,-5,12
FCSB,3413,1,8,5,1,26,12,14,29
CFR Cluj,3413,2,6,6,2,19,11,8,24
D Bucuresti,3413,3,4,5,5,20,21,-1,17
FC Botosani,3413,4,4,5,5,7,13,-6,17
Universitate,3413,5,4,5,5,17,24,-7,17
Concordia Ch,3413,6,2,2,10,17,25,-8,8
FCSB,3414,1,7,6,1,24,12,12,27
CFR Cluj,3414,2,6,6,2,15,9,6,24
Universitate,3414,3,4,6,4,15,18,-3,18
D Bucuresti,3414,4,4,5,5,20,19,1,17
FC Botosani,3414,5,4,4,6,7,16,-9,16
Concordia Ch,3414,6,2,3,9,17,24,-7,9
FCSB,3415,1,8,6,0,28,11,17,30
CFR Cluj,3415,2,5,7,2,14,12,2,22
FC Botosani,3415,3,4,5,5,10,15,-5,17
Universitate,3415,4,3,7,4,16,20,-4,16
D Bucuresti,3415,5,3,5,6,18,24,-6,14
Concordia Ch,3415,6,3,2,9,20,24,-4,11
FCSB,3416,1,8,5,1,27,15,12,29
CFR Cluj,3416,2,6,6,2,15,9,6,24
Universitate,3416,3,4,5,5,18,21,-3,17
FC Botosani,3416,4,4,5,5,8,14,-6,17
D Bucuresti,3416,5,3,4,7,17,23,-6,13
Concordia Ch,3416,6,3,3,8,19,22,-3,12
FCSB,3417,1,7,7,0,26,13,13,28
CFR Cluj,3417,2,5,7,2,15,10,5,22
Universitate,3417,3,4,6,4,18,21,-3,18
D Bucuresti,3417,4,4,5,5,20,19,1,17
FC Botosani,3417,5,3,4,7,6,17,-11,13
Concordia Ch,3417,6,3,3,8,18,23,-5,12
FCSB,3418,1,9,5,0,27,12,15,32
CFR Cluj,3418,2,6,6,2,15,8,7,24
FC Botosani,3418,3,4,4,6,8,19,-11,16
D Bucuresti,3418,4,3,5,6,18,21,-3,14
Universitate,3418,5,3,5,6,16,23,-7,14
Concordia Ch,3418,6,3,3,8,20,21,-1,12
FCSB,3419,1,7,5,2,23,13,10,26
CFR Cluj,3419,2,6,7,1,16,8,8,25
D Bucuresti,3419,3,5,4,5,19,18,1,19
Universitate,3419,4,4,6,4,16,19,-3,18
FC Botosani,3419,5,3,5,6,5,14,-9,14
Concordia Ch,3419,6,2,3,9,15,22,-7,9
FCSB,3420,1,9,5,0,27,12,15,32
CFR Cluj,3420,2,5,7,2,15,10,5,22
D Bucuresti,3420,3,4,5,5,23,21,2,17
Universitate,3420,4,3,6,5,16,21,-5,15
FC Botosani,3420,5,3,6,5,7,14,-7,15
Concordia Ch,3420,6,2,3,9,16,26,-10,9
FCSB,3421,1,8,5,1,25,12,13,29
CFR Cluj,3421,2,7,6,1,16,7,9,27
FC Botosani,3421,3,3,6,5,8,15,-7,15
D Bucuresti,3421,4,3,5,6,18,21,-3,14
Universitate,3421,5,3,5,6,15,22,-7,14
Concordia Ch,3421,6,3,3,8,19,24,-5,12
FCSB,3422,1,8,6,0,28,13,15,30
CFR Cluj,3422,2,6,6,2,16,10,6,24
FC Botosani,3422,3,4,5,5,10,14,-4,17
D Bucuresti,3422,4,3,6,5,18,20,-2,15
Universitate,3422,5,3,6,5,16,22,-6,15
Concordia Ch,3422,6,2,3,9,17,26,-9,9
FCSB,3423,1,8,5,1,26,13,13,29
CFR Cluj,3423,2,5,6,3,14,10,4,21
Universitate,3423,3,5,5,4,17,19,-2,20
D Bucuresti,3423,4,3,6,5,19,21,-2,15
FC Botosani,3423,5,3,6,5,6,13,-7,15
Concordia Ch,3423,6,2,4,8,17,23,-6,10
FCSB,3424,1,8,5,1,28,14,14,29
CFR Cluj,3424,2,6,7,1,16,9,7,25
D Bucuresti,3424,3,4,5,5,18,18,0,17
FC Botosani,3424,4,4,5,5,8,13,-5,17
Universitate,3424,5,3,6,5,15,21,-6,15
Concordia Ch,3424,6,2,2,10,16,26,-10,8
FCSB,3425,1,7,6,1,25,13,12,27
CFR Cluj,3425,2,6,7,1,15,8,7,25
D Bucuresti,3425,3,5,4,5,21,19,2,19
Universitate,3425,4,4,5,5,16,20,-4,17
FC Botosani,3425,5,4,4,6,7,16,-9,16
Concordia Ch,3425,6,2,2,10,17,25,-8,8
FCSB,3426,1,7,7,0,23,10,13,28
CFR Cluj,3426,2,5,8,1,13,7,6,23
D Bucuresti,3426,3,5,4,5,22,19,3,19
Universitate,3426,4,3,7,4,14,18,-4,16
FC Botosani,3426,5,4,4,6,8,15,-7,16
Concordia Ch,3426,6,2,2,10,15,26,-11,8
FCSB,3427,1,7,6,1,24,12,12,27
CFR Cluj,3427,2,6,7,1,15,8,7,25
D Bucuresti,3427,3,5,4,5,23,20,3,19
Universitate,3427,4,4,5,5,17,21,-4,17
FC Botosani,3427,5,3,5,6,7,16,-9,14
Concordia Ch,3427,6,2,3,9,15,24,-9,9
FCSB,3428,1,8,6,0,28,11,17,30
CFR Cluj,3428,2,6,6,2,18,11,7,24
FC Botosani,3428,3,5,4,5,9,13,-4,19
D Bucuresti,3428,4,4,4,6,18,19,-1,16
Universitate,3428,5,3,6,5,15,24,-9,15
Concordia Ch,3428,6,2,2,10,16,26,-10,8
FCSB,3429,1,8,5,1,27,11,16,29
CFR Cluj,3429,2,7,6,1,16,7,9,27
D Bucuresti,3429,3,4,4,6,18,20,-2,16
FC Botosani,3429,4,4,4,6,7,14,-7,16
Universitate,3429,5,3,5,6,14,24,-10,14
Concordia Ch,3429,6,3,2,9,17,23,-6,11
FCSB,3430,1,9,5,0,26,11,15,32
CFR Cluj,3430,2,5,6,3,14,10,4,21
Universitate,3430,3,4,5,5,15,19,-4,17
FC Botosani,3430,4,4,4,6,6,13,-7,16
Concordia Ch,3430,5,4,2,8,19,22,-3,14
D Bucuresti,3430,6,3,4,7,17,22,-5,13
FCSB,3431,1,8,6,0,24,10,14,30
CFR Cluj,3431,2,5,6,3,13,9,4,21
Universitate,3431,3,4,6,4,15,18,-3,18
D Bucuresti,3431,4,4,4,6,18,20,-2,16
FC Botosani,3431,5,4,4,6,6,14,-8,16
Concordia Ch,3431,6,3,2,9,18,23,-5,11
FCSB,3432,1,8,5,1,25,14,11,29
CFR Cluj,3432,2,6,6,2,15,8,7,24
Universitate,3432,3,4,5,5,18,21,-3,17
D Bucuresti,3432,4,4,4,6,19,22,-3,16
Concordia Ch,3432,5,4,2,8,19,21,-2,14
FC Botosani,3432,6,3,4,7,6,16,-10,13
FCSB,3433,1,8,5,1,26,14,12,29
CFR Cluj,3433,2,6,6,2,16,9,7,24
D Bucuresti,3433,3,5,4,5,20,18,2,19
Universitate,3433,4,4,5,5,17,21,-4,17
FC Botosani,3433,5,4,4,6,6,15,-9,16
Concordia Ch,3433,6,2,2,10,15,23,-8,8
FCSB,3434,1,8,5,1,26,11,15,29
CFR Cluj,3434,2,6,6,2,16,11,5,24
D Bucuresti,3434,3,4,5,5,17,18,-1,17
Universitate,3434,4,4,5,5,16,21,-5,17
FC Botosani,3434,5,4,4,6,6,13,-7,16
Concordia Ch,3434,6,2,3,9,15,22,-7,9
FCSB,3435,1,7,6,1,26,14,12,27
CFR Cluj,3435,2,7,6,1,16,8,8,27
D Bucuresti,3435,3,4,5,5,18,19,-1,17
Universitate,3435,4,3,6,5,16,21,-5,15
FC Botosani,3435,5,3,5,6,5,14,-9,14
Concordia Ch,3435,6,3,2,9,18,23,-5,11
FCSB,3436,1,8,6,0,25,11,14,30
CFR Cluj,3436,2,6,7,1,15,7,8,25
D Bucuresti,3436,3,4,4,6,18,20,-2,16
Universitate,3436,4,3,5,6,15,22,-7,14
FC Botosani,3436,5,3,5,6,6,14,-8,14
Concordia Ch,3436,6,3,3,8,18,23,-5,12
FCSB,3437,1,7,6,1,25,14,11,27
CFR Cluj,3437,2,7,6,1,17,7,10,27
D Bucuresti,3437,3,4,5,5,17,18,-1,17
Universitate,3437,4,3,6,5,16,22,-6,15
FC Botosani,3437,5,3,6,5,6,13,-7,15
Concordia Ch,3437,6,2,3,9,16,23,-7,9
FCSB,3438,1,8,6,0,25,11,14,30
CFR Cluj,3438,2,6,7,1,14,7,7,25
D Bucuresti,3438,3,4,4,6,18,20,-2,16
Concordia Ch,3438,4,4,2,8,20,22,-2,14
Universitate,3438,5,3,5,6,15,21,-6,14
FC Botosani,3438,6,3,4,7,6,17,-11,13
FCSB,3439,1,7,6,1,23,11,12,27
CFR Cluj,3439,2,7,6,1,15,7,8,27
D Bucuresti,3439,3,4,5,5,21,21,0,17
FC Botosani,3439,4,4,4,6,9,16,-7,16
Universitate,3439,5,3,6,5,14,19,-5,15
Concordia Ch,3439,6,2,3,9,18,26,-8,9
FCSB,3440,1,8,5,1,27,13,14,29
CFR Cluj,3440,2,6,6,2,15,10,5,24
Universitate,3440,3,4,5,5,16,20,-4,17
D Bucuresti,3440,4,4,4,6,18,19,-1,16
FC Botosani,3440,5,4,4,6,7,14,-7,16
Concordia Ch,3440,6,3,2,9,16,23,-7,11
FCSB,3441,1,7,6,1,26,14,12,27
CFR Cluj,3441,2,6,7,1,15,8,7,25
Universitate,3441,3,3,7,4,16,20,-4,16
Concordia Ch,3441,4,4,2,8,19,22,-3,14
D Bucuresti,3441,5,3,5,6,16,19,-3,14
FC Botosani,3441,6,3,5,6,6,15,-9,14
FCSB,3442,1,8,6,0,27,12,15,30
CFR Cluj,3442,2,5,6,3,15,12,3,21
Universitate,3442,3,4,6,4,15,18,-3,18
D Bucuresti,3442,4,4,4,6,17,19,-2,16
FC Botosani,3442,5,4,4,6,8,14,-6,16
Concordia Ch,3442,6,3,2,9,17,24,-7,11
FCSB,3443,1,8,6,0,27,11,16,30
CFR Cluj,3443,2,5,7,2,14,11,3,22
D Bucuresti,3443,3,4,5,5,23,20,3,17
Universitate,3443,4,4,5,5,17,21,-4,17
FC Botosani,3443,5,3,5,6,5,17,-12,14
Concordia Ch,3443,6,2,4,8,17,23,-6,10
FCSB,3444,1,9,5,0,28,12,16,32
CFR Cluj,3444,2,5,6,3,14,12,2,21
D Bucuresti,3444,3,4,5,5,21,22,-1,17
Universitate,3444,4,4,5,5,17,20,-3,17
FC Botosani,3444,5,3,6,5,9,16,-7,15
Concordia Ch,3444,6,2,3,9,19,26,-7,9
FCSB,3445,1,7,5,2,24,14,10,26
CFR Cluj,3445,2,6,7,1,16,8,8,25
Universitate,3445,3,4,6,4,15,18,-3,18
D Bucuresti,3445,4,4,4,6,18,20,-2,16
FC Botosani,3445,5,4,4,6,9,16,-7,16
Concordia Ch,3445,6,3,2,9,18,24,-6,11
FCSB,3446,1,8,6,0,26,12,14,30
CFR Cluj,3446,2,6,6,2,16,9,7,24
D Bucuresti,3446,3,4,4,6,20,20,0,16
FC Botosani,3446,4,4,4,6,7,15,-8,16
Universitate,3446,5,3,6,5,15,21,-6,15
Concordia Ch,3446,6,3,2,9,17,24,-7,11
FCSB,3447,1,7,6,1,25,13,12,27
CFR Cluj,3447,2,5,8,1,13,7,6,23
D Bucuresti,3447,3,5,4,5,22,21,1,19
Universitate,3447,4,4,6,4,17,20,-3,18
FC Botosani,3447,5,4,4,6,8,14,-6,16
Concordia Ch,3447,6,2,2,10,17,27,-10,8
FCSB,3448,1,8,6,0,25,11,14,30
CFR Cluj,3448,2,5,8,1,14,8,6,23
D Bucuresti,3448,3,4,4,6,18,20,-2,16
Universitate,3448,4,3,6,5,16,21,-5,15
FC Botosani,3448,5,3,5,6,6,14,-8,14
Concordia Ch,3448,6,3,3,8,18,23,-5,12
FCSB,3449,1,9,5,0,26,11,15,32
CFR Cluj,3449,2,6,6,2,18,10,8,24
D Bucuresti,3449,3,4,5,5,19,20,-1,17
FC Botosani,3449,4,3,6,5,7,14,-7,15
Universitate,3449,5,3,5,6,15,23,-8,14
Concordia Ch,3449,6,2,3,9,15,22,-7,9
FCSB,3450,1,8,6,0,25,10,15,30
CFR Cluj,3450,2,6,7,1,14,7,7,25
D Bucuresti,3450,3,4,4,6,18,20,-2,16
FC Botosani,3450,4,4,4,6,8,15,-7,16
Universitate,3450,5,3,5,6,14,21,-7,14
Concordia Ch,3450,6,3,2,9,18,24,-6,11
FCSB,3451,1,9,5,0,29,13,16,32
CFR Cluj,3451,2,5,7,2,16,12,4,22
D Bucuresti,3451,3,4,5,5,18,18,0,17
Universitate,3451,4,3,6,5,16,21,-5,15
FC Botosani,3451,5,3,4,7,5,16,-11,13
Concordia Ch,3451,6,3,3,8,17,21,-4,12
FCSB,3452,1,8,5,1,24,11,13,29
CFR Cluj,3452,2,6,7,1,15,8,7,25
FC Botosani,3452,3,4,5,5,7,13,-6,17
Universitate,3452,4,3,6,5,15,20,-5,15
D Bucuresti,3452,5,3,5,6,17,20,-3,14
Concordia Ch,3452,6,3,2,9,16,22,-6,11
FCSB,3453,1,8,6,0,27,11,16,30
CFR Cluj,3453,2,5,8,1,15,9,6,23
FC Botosani,3453,3,5,4,5,7,12,-5,19
Universitate,3453,4,3,6,5,15,22,-7,15
D Bucuresti,3453,5,3,4,7,16,20,-4,13
Concordia Ch,3453,6,3,2,9,16,22,-6,11
FCSB,3454,1,7,7,0,24,11,13,28
CFR Cluj,3454,2,5,8,1,16,10,6,23
FC Botosani,3454,3,4,5,5,7,12,-5,17
D Bucuresti,3454,4,4,4,6,19,22,-3,16
Universitate,3454,5,3,7,4,16,20,-4,16
Concordia Ch,3454,6,2,3,9,17,24,-7,9
FCSB,3455,1,8,6,0,26,12,14,30
CFR Cluj,3455,2,6,6,2,14,8,6,24
D Bucuresti,3455,3,4,5,5,19,20,-1,17
FC Botosani,3455,4,4,5,5,7,13,-6,17
Universitate,3455,5,3,6,5,16,21,-5,15
Concordia Ch,3455,6,2,2,10,18,26,-8,8
FCSB,3456,1,7,6,1,23,11,12,27
CFR Cluj,3456,2,6,7,1,14,7,7,25
FC Botosani,3456,3,5,4,5,10,12,-2,19
Universitate,3456,4,3,7,4,14,18,-4,16
D Bucuresti,3456,5,3,5,6,17,20,-3,14
Concordia Ch,3456,6,2,3,9,16,26,-10,9
FCSB,3457,1,9,5,0,27,10,17,32
CFR Cluj,3457,2,6,6,2,15,11,4,24
D Bucuresti,3457,3,4,4,6,19,22,-3,16
Universitate,3457,4,3,5,6,15,21,-6,14
FC Botosani,3457,5,3,5,6,5,14,-9,14
Concordia Ch,3457,6,3,3,8,19,22,-3,12
FCSB,3458,1,8,6,0,26,12,14,30
CFR Cluj,3458,2,5,8,1,14,8,6,23
FC Botosani,3458,3,4,5,5,6,12,-6,17
Universitate,3458,4,3,6,5,15,20,-5,15
D Bucuresti,3458,5,3,4,7,17,21,-4,13
Concordia Ch,3458,6,3,3,8,17,22,-5,12
FCSB,3459,1,8,5,1,25,12,13,29
CFR Cluj,3459,2,5,7,2,13,8,5,22
Universitate,3459,3,4,6,4,16,19,-3,18
D Bucuresti,3459,4,4,4,6,18,21,-3,16
FC Botosani,3459,5,3,5,6,6,14,-8,14
Concordia Ch,3459,6,3,3,8,19,23,-4,12
FCSB,3460,1,9,5,0,27,12,15,32
CFR Cluj,3460,2,5,7,2,14,9,5,22
D Bucuresti,3460,3,4,4,6,18,21,-3,16
Universitate,3460,4,3,6,5,15,20,-5,15
FC Botosani,3460,5,3,5,6,5,14,-9,14
Concordia Ch,3460,6,3,3,8,18,21,-3,12
FCSB,3461,1,9,5,0,27,12,15,32
CFR Cluj,3461,2,6,6,2,16,8,8,24
D Bucuresti,3461,3,4,4,6,18,21,-3,16
FC Botosani,3461,4,4,4,6,8,17,-9,16
Universitate,3461,5,3,5,6,16,24,-8,14
Concordia Ch,3461,6,3,2,9,21,24,-3,11
FCSB,3462,1,8,6,0,29,11,18,30
CFR Cluj,3462,2,6,6,2,16,13,3,24
FC Botosani,3462,3,5,4,5,8,12,-4,19
Universitate,3462,4,3,6,5,14,20,-6,15
D Bucuresti,3462,5,3,4,7,16,22,-6,13
Concordia Ch,3462,6,3,2,9,18,23,-5,11
FCSB,3463,1,8,5,1,26,13,13,29
CFR Cluj,3463,2,7,6,1,16,8,8,27
FC Botosani,3463,3,5,4,5,9,13,-4,19
D Bucuresti,3463,4,4,4,6,21,21,0,16
Universitate,3463,5,3,5,6,15,21,-6,14
Concordia Ch,3463,6,2,2,10,15,26,-11,8
FCSB,3464,1,9,5,0,26,10,16,32
CFR Cluj,3464,2,5,6,3,13,12,1,21
Universitate,3464,3,4,5,5,17,19,-2,17
D Bucuresti,3464,4,3,6,5,16,18,-2,15
FC Botosani,3464,5,3,5,6,6,14,-8,14
Concordia Ch,3464,6,3,3,8,17,22,-5,12
FCSB,3465,1,8,5,1,24,11,13,29
CFR Cluj,3465,2,7,6,1,15,7,8,27
FC Botosani,3465,3,5,4,5,9,12,-3,19
D Bucuresti,3465,4,3,5,6,17,21,-4,14
Universitate,3465,5,3,5,6,14,20,-6,14
Concordia Ch,3465,6,2,3,9,16,24,-8,9
CFR Cluj,3466,1,7,6,1,17,8,9,27
FCSB,3466,2,7,5,2,26,15,11,26
D Bucuresti,3466,3,4,5,5,19,20,-1,17
Universitate,3466,4,4,5,5,19,24,-5,17
FC Botosani,3466,5,4,4,6,7,14,-7,16
Concordia Ch,3466,6,2,3,9,16,23,-7,9
FCSB,3467,1,9,5,0,28,11,17,32
CFR Cluj,3467,2,5,6,3,16,13,3,21
Universitate,3467,3,4,5,5,17,22,-5,17
D Bucuresti,3467,4,4,4,6,20,21,-1,16
Concordia Ch,3467,5,4,2,8,18,22,-4,14
FC Botosani,3467,6,3,4,7,6,16,-10,13
FCSB,3468,1,8,5,1,24,11,13,29
CFR Cluj,3468,2,5,6,3,14,10,4,21
Universitate,3468,3,5,5,4,17,19,-2,20
FC Botosani,3468,4,4,4,6,6,14,-8,16
Concordia Ch,3468,5,4,2,8,18,21,-3,14
D Bucuresti,3468,6,3,4,7,16,20,-4,13
FCSB,3469,1,7,6,1,24,12,12,27
CFR Cluj,3469,2,6,7,1,17,8,9,25
Universitate,3469,3,4,5,5,17,23,-6,17
FC Botosani,3469,4,4,4,6,6,14,-8,16
Concordia Ch,3469,5,4,2,8,19,22,-3,14
D Bucuresti,3469,6,3,4,7,17,21,-4,13
FCSB,3470,1,7,6,1,23,13,10,27
CFR Cluj,3470,2,6,6,2,16,10,6,24
FC Botosani,3470,3,5,4,5,9,12,-3,19
Universitate,3470,4,4,6,4,17,18,-1,18
D Bucuresti,3470,5,3,5,6,16,19,-3,14
Concordia Ch,3470,6,2,3,9,15,24,-9,9
FCSB,3471,1,7,6,1,25,14,11,27
CFR Cluj,3471,2,6,7,1,15,7,8,25
D Bucuresti,3471,3,4,5,5,19,19,0,17
Universitate,3471,4,4,5,5,18,22,-4,17
FC Botosani,3471,5,3,5,6,7,16,-9,14
Concordia Ch,3471,6,2,4,8,18,24,-6,10
FCSB,3472,1,8,5,1,24,13,11,29
CFR Cluj,3472,2,5,7,2,13,8,5,22
Universitate,3472,3,4,6,4,17,18,-1,18
FC Botosani,3472,4,4,5,5,7,13,-6,17
D Bucuresti,3472,5,3,6,5,18,20,-2,15
Concordia Ch,3472,6,2,3,9,16,23,-7,9
FCSB,3473,1,9,5,0,25,10,15,32
CFR Cluj,3473,2,5,7,2,15,10,5,22
D Bucuresti,3473,3,4,5,5,21,22,-1,17
FC Botosani,3473,4,4,5,5,7,13,-6,17
Universitate,3473,5,3,6,5,16,21,-5,15
Concordia Ch,3473,6,2,2,10,18,26,-8,8
FCSB,3474,1,7,7,0,26,13,13,28
CFR Cluj,3474,2,6,7,1,17,10,7,25
D Bucuresti,3474,3,4,4,6,20,24,-4,16
Universitate,3474,4,3,6,5,16,21,-5,15
Concordia Ch,3474,5,4,2,8,21,23,-2,14
FC Botosani,3474,6,3,4,7,8,17,-9,13
FCSB,3475,1,8,6,0,25,11,14,30
CFR Cluj,3475,2,5,6,3,14,10,4,21
D Bucuresti,3475,3,5,4,5,21,19,2,19
Universitate,3475,4,4,6,4,15,18,-3,18
FC Botosani,3475,5,4,4,6,6,13,-7,16
Concordia Ch,3475,6,2,2,10,16,26,-10,8
FCSB,3476,1,7,6,1,24,12,12,27
CFR Cluj,3476,2,5,7,2,15,10,5,22
Universitate,3476,3,5,5,4,17,19,-2,20
FC Botosani,3476,4,5,4,5,11,13,-2,19
D Bucuresti,3476,5,3,5,6,18,22,-4,14
Concordia Ch,3476,6,2,3,9,18,27,-9,9
FCSB,3477,1,8,5,1,26,13,13,29
CFR Cluj,3477,2,5,6,3,14,13,1,21
Universitate,3477,3,5,5,4,20,19,1,20
D Bucuresti,3477,4,4,4,6,17,19,-2,16
FC Botosani,3477,5,3,5,6,6,14,-8,14
Concordia Ch,3477,6,3,3,8,17,22,-5,12
FCSB,3478,1,8,5,1,27,13,14,29
CFR Cluj,3478,2,5,7,2,14,12,2,22
Universitate,3478,3,4,6,4,18,19,-1,18
D Bucuresti,3478,4,4,5,5,19,20,-1,17
FC Botosani,3478,5,4,4,6,7,14,-7,16
Concordia Ch,3478,6,2,3,9,16,23,-7,9
FCSB,3479,1,9,5,0,28,11,17,32
CFR Cluj,3479,2,6,6,2,15,11,4,24
D Bucuresti,3479,3,4,5,5,20,21,-1,17
FC Botosani,3479,4,4,5,5,8,14,-6,17
Universitate,3479,5,3,5,6,16,22,-6,14
Concordia Ch,3479,6,2,2,10,18,26,-8,8
CFR Cluj,3480,1,7,6,1,17,8,9,27
FCSB,3480,2,7,5,2,25,14,11,26
Universitate,3480,3,4,5,5,16,21,-5,17
FC Botosani,3480,4,4,5,5,7,13,-6,17
D Bucuresti,3480,5,4,4,6,20,19,1,16
Concordia Ch,3480,6,2,3,9,16,26,-10,9
FCSB,3481,1,7,6,1,25,13,12,27
CFR Cluj,3481,2,6,7,1,15,7,8,25
FC Botosani,3481,3,4,5,5,11,13,-2,17
Universitate,3481,4,4,5,5,17,22,-5,17
D Bucuresti,3481,5,3,5,6,17,20,-3,14
Concordia Ch,3481,6,3,2,9,16,26,-10,11
FCSB,3482,1,8,5,1,26,13,13,29
CFR Cluj,3482,2,6,6,2,15,9,6,24
D Bucuresti,3482,3,4,5,5,20,21,-1,17
Universitate,3482,4,4,5,5,16,20,-4,17
FC Botosani,3482,5,3,6,5,9,16,-7,15
Concordia Ch,3482,6,2,3,9,16,23,-7,9
FCSB,3483,1,7,7,0,24,11,13,28
CFR Cluj,3483,2,6,7,1,15,8,7,25
D Bucuresti,3483,3,4,4,6,20,21,-1,16
FC Botosani,3483,4,4,4,6,7,16,-9,16
Universitate,3483,5,3,6,5,14,19,-5,15
Concordia Ch,3483,6,3,2,9,17,22,-5,11
FCSB,3484,1,9,5,0,25,10,15,32
CFR Cluj,3484,2,5,7,2,13,8,5,22
FC Botosani,3484,3,4,5,5,7,13,-6,17
D Bucuresti,3484,4,4,4,6,18,20,-2,16
Universitate,3484,5,3,6,5,14,19,-5,15
Concordia Ch,3484,6,2,3,9,15,22,-7,9
FCSB,3485,1,9,5,0,27,10,17,32
CFR Cluj,3485,2,6,6,2,15,9,6,24
FC Botosani,3485,3,4,5,5,8,13,-5,17
D Bucuresti,3485,4,4,4,6,17,20,-3,16
Universitate,3485,5,3,5,6,14,22,-8,14
Concordia Ch,3485,6,2,3,9,16,23,-7,9
FCSB,3486,1,9,5,0,26,11,15,32
CFR Cluj,3486,2,5,6,3,13,9,4,21
Universitate,3486,3,4,5,5,16,20,-4,17
D Bucuresti,3486,4,4,4,6,17,19,-2,16
FC Botosani,3486,5,3,5,6,6,14,-8,14
Concordia Ch,3486,6,3,3,8,17,22,-5,12
FCSB,3487,1,9,5,0,26,11,15,32
CFR Cluj,3487,2,5,6,3,13,11,2,21
Universitate,3487,3,4,5,5,18,20,-2,17
FC Botosani,3487,4,3,6,5,7,14,-7,15
D Bucuresti,3487,5,3,5,6,17,22,-5,14
Concordia Ch,3487,6,3,3,8,21,24,-3,12
FCSB,3488,1,7,6,1,26,14,12,27
CFR Cluj,3488,2,6,7,1,18,9,9,25
FC Botosani,3488,3,4,5,5,9,14,-5,17
Universitate,3488,4,4,5,5,16,22,-6,17
D Bucuresti,3488,5,4,4,6,18,21,-3,16
Concordia Ch,3488,6,2,3,9,18,25,-7,9
FCSB,3489,1,8,5,1,25,12,13,29
CFR Cluj,3489,2,5,7,2,15,10,5,22
Universitate,3489,3,4,6,4,18,21,-3,18
D Bucuresti,3489,4,4,4,6,17,20,-3,16
FC Botosani,3489,5,4,4,6,9,15,-6,16
Concordia Ch,3489,6,3,2,9,18,24,-6,11
FCSB,3490,1,9,5,0,26,11,15,32
CFR Cluj,3490,2,6,6,2,15,8,7,24
FC Botosani,3490,3,4,5,5,9,15,-6,17
D Bucuresti,3490,4,3,5,6,20,23,-3,14
Universitate,3490,5,3,5,6,15,22,-7,14
Concordia Ch,3490,6,3,2,9,19,25,-6,11
CFR Cluj,3491,1,7,6,1,18,8,10,27
FCSB,3491,2,7,5,2,26,16,10,26
Universitate,3491,3,4,5,5,17,22,-5,17
FC Botosani,3491,4,4,5,5,7,13,-6,17
D Bucuresti,3491,5,3,4,7,16,22,-6,13
Concordia Ch,3491,6,3,3,8,19,22,-3,12
FCSB,3492,1,8,5,1,24,12,12,29
CFR Cluj,3492,2,5,7,2,13,8,5,22
Universitate,3492,3,4,6,4,16,18,-2,18
D Bucuresti,3492,4,4,4,6,21,24,-3,16
FC Botosani,3492,5,4,4,6,8,14,-6,16
Concordia Ch,3492,6,3,2,9,21,27,-6,11
FCSB,3493,1,8,5,1,27,11,16,29
CFR Cluj,3493,2,5,6,3,13,12,1,21
Universitate,3493,3,5,5,4,16,18,-2,20
Concordia Ch,3493,4,4,2,8,20,21,-1,14
D Bucuresti,3493,5,3,5,6,17,22,-5,14
FC Botosani,3493,6,3,5,6,6,15,-9,14
FCSB,3494,1,8,6,0,24,10,14,30
CFR Cluj,3494,2,6,7,1,18,7,11,25
FC Botosani,3494,3,4,5,5,7,12,-5,17
D Bucuresti,3494,4,3,5,6,17,20,-3,14
Universitate,3494,5,3,5,6,14,24,-10,14
Concordia Ch,3494,6,3,2,9,17,24,-7,11
FCSB,3495,1,7,7,0,27,14,13,28
CFR Cluj,3495,2,6,7,1,17,10,7,25
FC Botosani,3495,3,4,5,5,6,12,-6,17
Universitate,3495,4,3,6,5,15,20,-5,15
D Bucuresti,3495,5,3,5,6,17,20,-3,14
Concordia Ch,3495,6,3,2,9,17,23,-6,11
FCSB,3496,1,7,6,1,23,14,9,27
CFR Cluj,3496,2,6,7,1,15,8,7,25
Universitate,3496,3,4,5,5,19,20,-1,17
D Bucuresti,3496,4,3,6,5,18,20,-2,15
FC Botosani,3496,5,3,5,6,7,15,-8,14
Concordia Ch,3496,6,3,3,8,18,23,-5,12
FCSB,3497,1,7,7,0,25,12,13,28
CFR Cluj,3497,2,5,7,2,14,10,4,22
Universitate,3497,3,4,6,4,17,19,-2,18
D Bucuresti,3497,4,4,5,5,19,20,-1,17
FC Botosani,3497,5,3,5,6,7,15,-8,14
Concordia Ch,3497,6,3,2,9,18,24,-6,11
CFR Cluj,3498,1,7,6,1,15,7,8,27
FCSB,3498,2,7,5,2,24,13,11,26
Universitate,3498,3,4,5,5,16,20,-4,17
D Bucuresti,3498,4,4,4,6,19,21,-2,16
Concordia Ch,3498,5,4,2,8,19,22,-3,14
FC Botosani,3498,6,3,4,7,5,15,-10,13
FCSB,3499,1,8,6,0,27,11,16,30
CFR Cluj,3499,2,5,6,3,13,11,2,21
FC Botosani,3499,3,5,4,5,9,13,-4,19
Universitate,3499,4,4,6,4,16,19,-3,18
D Bucuresti,3499,5,3,5,6,17,21,-4,14
Concordia Ch,3499,6,2,3,9,17,24,-7,9
FCSB,3500,1,8,6,0,27,13,14,30
CFR Cluj,3500,2,5,6,3,16,12,4,21
Universitate,3500,3,4,6,4,17,20,-3,18
FC Botosani,3500,4,4,5,5,6,12,-6,17
D Bucuresti,3500,5,3,5,6,16,19,-3,14
Concordia Ch,3500,6,3,2,9,16,22,-6,11
CFR Cluj,3501,1,7,6,1,16,8,8,27
FCSB,3501,2,7,5,2,24,13,11,26
Universitate,3501,3,4,5,5,17,21,-4,17
D Bucuresti,3501,4,4,4,6,17,19,-2,16
FC Botosani,3501,5,4,4,6,7,14,-7,16
Concordia Ch,3501,6,3,2,9,17,23,-6,11
FCSB,3502,1,7,7,0,25,12,13,28
CFR Cluj,3502,2,5,8,1,17,11,6,23
D Bucuresti,3502,3,4,4,6,20,21,-1,16
Universitate,3502,4,3,7,4,16,20,-4,16
Concordia Ch,3502,5,4,2,8,20,23,-3,14
FC Botosani,3502,6,3,4,7,5,16,-11,13
FCSB,3503,1,7,5,2,23,12,11,26
CFR Cluj,3503,2,6,7,1,15,8,7,25
Universitate,3503,3,4,6,4,16,19,-3,18
D Bucuresti,3503,4,4,4,6,17,20,-3,16
FC Botosani,3503,5,4,4,6,7,13,-6,16
Concordia Ch,3503,6,3,2,9,17,23,-6,11
FCSB,3504,1,8,6,0,25,11,14,30
CFR Cluj,3504,2,5,7,2,13,8,5,22
D Bucuresti,3504,3,4,4,6,18,22,-4,16
Universitate,3504,4,3,7,4,15,19,-4,16
FC Botosani,3504,5,3,5,6,5,13,-8,14
Concordia Ch,3504,6,3,3,8,19,22,-3,12
FCSB,3505,1,8,5,1,27,16,11,29
CFR Cluj,3505,2,7,6,1,21,9,12,27
FC Botosani,3505,3,5,4,5,8,12,-4,19
D Bucuresti,3505,4,3,5,6,18,21,-3,14
Universitate,3505,5,3,5,6,15,23,-8,14
Concordia Ch,3505,6,2,3,9,17,25,-8,9
CFR Cluj,3506,1,7,6,1,16,8,8,27
FCSB,3506,2,7,5,2,26,18,8,26
D Bucuresti,3506,3,4,5,5,20,21,-1,17
Universitate,3506,3,4,5,5,20,21,-1,17
FC Botosani,3506,5,4,5,5,8,14,-6,17
Concordia Ch,3506,6,2,2,10,16,24,-8,8
FCSB,3507,1,8,6,0,28,12,16,30
CFR Cluj,3507,2,6,6,2,16,11,5,24
D Bucuresti,3507,3,4,5,5,20,21,-1,17
Universitate,3507,4,3,6,5,15,21,-6,15
FC Botosani,3507,5,3,6,5,7,14,-7,15
Concordia Ch,3507,6,2,3,9,16,23,-7,9
FCSB,3508,1,7,7,0,24,11,13,28
CFR Cluj,3508,2,5,7,2,14,9,5,22
Universitate,3508,3,4,6,4,15,18,-3,18
D Bucuresti,3508,4,4,4,6,20,22,-2,16
Concordia Ch,3508,5,4,2,8,21,23,-2,14
FC Botosani,3508,6,3,4,7,6,17,-11,13
FCSB,3509,1,8,6,0,26,11,15,30
CFR Cluj,3509,2,6,6,2,16,10,6,24
D Bucuresti,3509,3,3,6,5,18,20,-2,15
Universitate,3509,4,3,6,5,16,22,-6,15
FC Botosani,3509,5,3,5,6,7,15,-8,14
Concordia Ch,3509,6,3,3,8,18,23,-5,12
FCSB,3510,1,8,6,0,27,12,15,30
CFR Cluj,3510,2,5,8,1,14,8,6,23
FC Botosani,3510,3,4,5,5,10,14,-4,17
D Bucuresti,3510,4,3,6,5,20,22,-2,15
Universitate,3510,5,3,6,5,15,21,-6,15
Concordia Ch,3510,6,2,3,9,17,26,-9,9
FCSB,3511,1,8,6,0,27,12,15,30
CFR Cluj,3511,2,5,8,1,15,9,6,23
D Bucuresti,3511,3,4,4,6,17,21,-4,16
FC Botosani,3511,4,4,4,6,6,13,-7,16
Universitate,3511,5,3,6,5,16,22,-6,15
Concordia Ch,3511,6,3,2,9,18,22,-4,11
FCSB,3512,1,9,5,0,27,10,17,32
CFR Cluj,3512,2,6,6,2,15,10,5,24
D Bucuresti,3512,3,5,4,5,20,18,2,19
Universitate,3512,4,3,5,6,14,21,-7,14
FC Botosani,3512,5,3,5,6,7,15,-8,14
Concordia Ch,3512,6,2,3,9,17,26,-9,9
FCSB,3513,1,8,6,0,24,10,14,30
CFR Cluj,3513,2,6,7,1,15,7,8,25
D Bucuresti,3513,3,4,4,6,19,21,-2,16
FC Botosani,3513,4,4,4,6,8,15,-7,16
Universitate,3513,5,3,5,6,14,21,-7,14
Concordia Ch,3513,6,3,2,9,20,26,-6,11
FCSB,3514,1,8,6,0,27,13,14,30
CFR Cluj,3514,2,5,7,2,14,9,5,22
FC Botosani,3514,3,5,4,5,8,13,-5,19
Universitate,3514,4,3,7,4,16,20,-4,16
D Bucuresti,3514,5,3,4,7,16,20,-4,13
Concordia Ch,3514,6,3,2,9,17,23,-6,11
FCSB,3515,1,8,6,0,25,11,14,30
CFR Cluj,3515,2,6,6,2,14,8,6,24
D Bucuresti,3515,3,4,4,6,18,20,-2,16
FC Botosani,3515,4,4,4,6,8,14,-6,16
Universitate,3515,5,3,6,5,15,20,-5,15
Concordia Ch,3515,6,3,2,9,18,25,-7,11
FCSB,3516,1,8,6,0,28,14,14,30
CFR Cluj,3516,2,6,7,1,18,10,8,25
D Bucuresti,3516,3,4,5,5,17,18,-1,17
FC Botosani,3516,4,4,4,6,6,13,-7,16
Universitate,3516,5,3,5,6,15,22,-7,14
Concordia Ch,3516,6,2,3,9,15,22,-7,9
FCSB,3517,1,8,5,1,25,12,13,29
CFR Cluj,3517,2,7,6,1,16,8,8,27
FC Botosani,3517,3,4,4,6,9,15,-6,16
Concordia Ch,3517,4,4,2,8,20,22,-2,14
Universitate,3517,5,3,5,6,14,20,-6,14
D Bucuresti,3517,6,3,4,7,16,23,-7,13
FCSB,3518,1,7,7,0,24,11,13,28
CFR Cluj,3518,2,6,7,1,15,8,7,25
FC Botosani,3518,3,4,5,5,10,15,-5,17
D Bucuresti,3518,4,3,6,5,18,20,-2,15
Universitate,3518,5,3,6,5,14,19,-5,15
Concordia Ch,3518,6,2,3,9,18,26,-8,9
FCSB,3519,1,8,6,0,25,11,14,30
CFR Cluj,3519,2,6,7,1,15,7,8,25
D Bucuresti,3519,3,4,5,5,19,19,0,17
FC Botosani,3519,4,3,6,5,7,14,-7,15
Universitate,3519,5,3,5,6,15,22,-7,14
Concordia Ch,3519,6,2,3,9,16,24,-8,9
FCSB,3520,1,8,6,0,27,12,15,30
CFR Cluj,3520,2,5,7,2,16,12,4,22
Universitate,3520,3,3,7,4,15,19,-4,16
FC Botosani,3520,4,4,4,6,8,15,-7,16
Concordia Ch,3520,5,4,2,8,22,24,-2,14
D Bucuresti,3520,6,3,4,7,17,23,-6,13
FCSB,3521,1,9,5,0,28,11,17,32
CFR Cluj,3521,2,6,6,2,15,11,4,24
D Bucuresti,3521,3,5,4,5,22,19,3,19
FC Botosani,3521,4,4,4,6,8,16,-8,16
Universitate,3521,5,3,5,6,14,20,-6,14
Concordia Ch,3521,6,2,2,10,15,25,-10,8
FCSB,3522,1,7,6,1,24,12,12,27
CFR Cluj,3522,2,6,6,2,14,10,4,24
Universitate,3522,3,4,6,4,18,19,-1,18
D Bucuresti,3522,4,4,5,5,18,18,0,17
FC Botosani,3522,5,3,6,5,5,12,-7,15
Concordia Ch,3522,6,2,3,9,15,23,-8,9
FCSB,3523,1,8,6,0,25,11,14,30
CFR Cluj,3523,2,5,7,2,14,9,5,22
Universitate,3523,3,3,7,4,16,20,-4,16
FC Botosani,3523,4,3,6,5,5,12,-7,15
D Bucuresti,3523,5,3,5,6,16,19,-3,14
Concordia Ch,3523,6,3,3,8,16,21,-5,12
FCSB,3524,1,8,5,1,27,13,14,29
CFR Cluj,3524,2,7,6,1,20,9,11,27
D Bucuresti,3524,3,3,5,6,18,21,-3,14
Concordia Ch,3524,4,4,2,8,17,21,-4,14
FC Botosani,3524,5,3,5,6,7,15,-8,14
Universitate,3524,6,3,5,6,14,24,-10,14
FCSB,3525,1,8,6,0,25,11,14,30
CFR Cluj,3525,2,5,7,2,13,8,5,22
Universitate,3525,3,4,5,5,16,20,-4,17
FC Botosani,3525,4,4,4,6,9,15,-6,16
D Bucuresti,3525,5,3,5,6,19,23,-4,14
Concordia Ch,3525,6,3,3,8,19,24,-5,12
FCSB,3526,1,8,6,0,25,11,14,30
CFR Cluj,3526,2,6,7,1,16,8,8,25
D Bucuresti,3526,3,4,4,6,17,20,-3,16
Universitate,3526,4,3,5,6,16,23,-7,14
FC Botosani,3526,5,3,5,6,7,15,-8,14
Concordia Ch,3526,6,3,3,8,19,23,-4,12
FCSB,3527,1,8,5,1,24,13,11,29
CFR Cluj,3527,2,6,6,2,16,8,8,24
D Bucuresti,3527,3,4,5,5,17,18,-1,17
Universitate,3527,4,4,5,5,17,21,-4,17
FC Botosani,3527,5,4,4,6,7,14,-7,16
Concordia Ch,3527,6,2,3,9,16,23,-7,9
FCSB,3528,1,7,7,0,26,13,13,28
CFR Cluj,3528,2,6,7,1,16,9,7,25
D Bucuresti,3528,3,4,5,5,17,18,-1,17
FC Botosani,3528,4,4,5,5,6,12,-6,17
Universitate,3528,5,3,6,5,17,22,-5,15
Concordia Ch,3528,6,2,2,10,15,23,-8,8
FCSB,3529,1,9,5,0,30,11,19,32
CFR Cluj,3529,2,6,6,2,15,12,3,24
D Bucuresti,3529,3,4,5,5,19,20,-1,17
FC Botosani,3529,4,4,4,6,7,13,-6,16
Universitate,3529,5,3,5,6,16,23,-7,14
Concordia Ch,3529,6,2,3,9,17,25,-8,9
FCSB,3530,1,7,7,0,24,11,13,28
CFR Cluj,3530,2,5,8,1,13,7,6,23
Universitate,3530,3,3,7,4,15,19,-4,16
D Bucuresti,3530,4,3,6,5,17,19,-2,15
FC Botosani,3530,5,3,6,5,7,14,-7,15
Concordia Ch,3530,6,2,4,8,18,24,-6,10
FCSB,3531,1,8,6,0,26,12,14,30
CFR Cluj,3531,2,6,7,1,19,9,10,25
D Bucuresti,3531,3,4,4,6,17,19,-2,16
FC Botosani,3531,4,4,4,6,7,14,-7,16
Universitate,3531,5,3,5,6,14,23,-9,14
Concordia Ch,3531,6,3,2,9,17,23,-6,11
FCSB,3532,1,9,5,0,25,10,15,32
CFR Cluj,3532,2,6,6,2,16,8,8,24
D Bucuresti,3532,3,4,4,6,18,20,-2,16
FC Botosani,3532,4,4,4,6,7,15,-8,16
Universitate,3532,5,3,5,6,14,22,-8,14
Concordia Ch,3532,6,3,2,9,19,24,-5,11
FCSB,3533,1,7,6,1,25,14,11,27
CFR Cluj,3533,2,6,6,2,15,8,7,24
Universitate,3533,3,4,6,4,17,20,-3,18
D Bucuresti,3533,4,4,4,6,18,21,-3,16
FC Botosani,3533,5,4,4,6,9,14,-5,16
Concordia Ch,3533,6,3,2,9,17,24,-7,11
FCSB,3534,1,7,6,1,24,14,10,27
CFR Cluj,3534,2,5,8,1,15,9,6,23
Universitate,3534,3,4,6,4,18,19,-1,18
FC Botosani,3534,4,4,5,5,7,13,-6,17
D Bucuresti,3534,5,3,4,7,19,25,-6,13
Concordia Ch,3534,6,3,3,8,20,23,-3,12
FCSB,3535,1,7,6,1,25,13,12,27
CFR Cluj,3535,2,5,7,2,14,9,5,22
Universitate,3535,3,5,5,4,17,19,-2,20
D Bucuresti,3535,4,4,5,5,19,20,-1,17
FC Botosani,3535,5,4,4,6,8,14,-6,16
Concordia Ch,3535,6,2,3,9,16,24,-8,9
CFR Cluj,3536,1,7,6,1,18,10,8,27
FCSB,3536,2,7,5,2,24,15,9,26
FC Botosani,3536,3,5,4,5,10,14,-4,19
Universitate,3536,4,4,5,5,19,21,-2,17
D Bucuresti,3536,5,3,4,7,17,21,-4,13
Concordia Ch,3536,6,3,2,9,17,24,-7,11
FCSB,3537,1,8,6,0,25,10,15,30
CFR Cluj,3537,2,5,6,3,13,10,3,21
FC Botosani,3537,3,5,4,5,9,13,-4,19
Universitate,3537,4,4,6,4,15,18,-3,18
D Bucuresti,3537,5,4,4,6,18,20,-2,16
Concordia Ch,3537,6,2,2,10,17,26,-9,8
CFR Cluj,3538,1,7,6,1,17,9,8,27
FCSB,3538,2,7,5,2,23,12,11,26
Universitate,3538,3,4,5,5,17,21,-4,17
D Bucuresti,3538,4,4,4,6,21,20,1,16
FC Botosani,3538,5,3,5,6,5,17,-12,14
Concordia Ch,3538,6,3,3,8,17,21,-4,12
FCSB,3539,1,8,6,0,27,13,14,30
CFR Cluj,3539,2,5,7,2,15,10,5,22
D Bucuresti,3539,3,4,5,5,18,19,-1,17
Universitate,3539,4,3,7,4,15,19,-4,16
FC Botosani,3539,5,3,6,5,5,12,-7,15
Concordia Ch,3539,6,2,3,9,16,23,-7,9
FCSB,3540,1,7,7,0,25,12,13,28
CFR Cluj,3540,2,6,7,1,17,9,8,25
FC Botosani,3540,3,5,4,5,8,12,-4,19
Universitate,3540,4,3,6,5,16,22,-6,15
D Bucuresti,3540,5,3,5,6,17,21,-4,14
Concordia Ch,3540,6,2,3,9,16,23,-7,9
FCSB,3541,1,7,6,1,24,16,8,27
CFR Cluj,3541,2,6,7,1,17,10,7,25
Universitate,3541,3,4,5,5,21,21,0,17
FC Botosani,3541,4,4,4,6,7,14,-7,16
Concordia Ch,3541,5,4,2,8,18,21,-3,14
D Bucuresti,3541,6,3,4,7,17,22,-5,13
FCSB,3542,1,8,6,0,25,10,15,30
CFR Cluj,3542,2,5,7,2,14,10,4,22
Universitate,3542,3,3,7,4,15,19,-4,16
Concordia Ch,3542,4,4,2,8,20,22,-2,14
D Bucuresti,3542,5,3,5,6,17,21,-4,14
FC Botosani,3542,6,3,5,6,5,14,-9,14
CFR Cluj,3543,1,7,6,1,18,9,9,27
FCSB,3543,2,7,5,2,25,15,10,26
D Bucuresti,3543,3,4,5,5,20,20,0,17
Universitate,3543,4,4,5,5,17,21,-4,17
FC Botosani,3543,5,4,4,6,7,15,-8,16
Concordia Ch,3543,6,2,3,9,16,23,-7,9
FCSB,3544,1,8,5,1,26,11,15,29
CFR Cluj,3544,2,7,6,1,16,7,9,27
FC Botosani,3544,3,5,4,5,7,12,-5,19
D Bucuresti,3544,4,3,5,6,17,20,-3,14
Universitate,3544,5,3,5,6,14,23,-9,14
Concordia Ch,3544,6,2,3,9,16,23,-7,9
FCSB,3545,1,8,5,1,24,11,13,29
CFR Cluj,3545,2,7,6,1,16,7,9,27
D Bucuresti,3545,3,4,5,5,17,18,-1,17
FC Botosani,3545,4,4,5,5,7,13,-6,17
Universitate,3545,5,3,5,6,14,21,-7,14
Concordia Ch,3545,6,2,2,10,16,24,-8,8
FCSB,3546,1,9,5,0,30,11,19,32
CFR Cluj,3546,2,5,6,3,14,13,1,21
Universitate,3546,3,4,5,5,18,23,-5,17
D Bucuresti,3546,4,4,4,6,19,21,-2,16
FC Botosani,3546,5,3,5,6,7,15,-8,14
Concordia Ch,3546,6,3,3,8,16,21,-5,12
FCSB,3547,1,8,5,1,26,13,13,29
CFR Cluj,3547,2,6,6,2,16,10,6,24
Universitate,3547,3,4,5,5,17,21,-4,17
FC Botosani,3547,4,4,5,5,7,13,-6,17
D Bucuresti,3547,5,3,5,6,19,22,-3,14
Concordia Ch,3547,6,3,2,9,18,24,-6,11
FCSB,3548,1,7,6,1,24,13,11,27
CFR Cluj,3548,2,6,7,1,15,7,8,25
D Bucuresti,3548,3,4,5,5,20,20,0,17
Universitate,3548,4,3,7,4,15,19,-4,16
FC Botosani,3548,5,4,4,6,7,15,-8,16
Concordia Ch,3548,6,2,3,9,16,23,-7,9
FCSB,3549,1,7,6,1,24,12,12,27
CFR Cluj,3549,2,5,8,1,14,8,6,23
Universitate,3549,3,4,6,4,17,20,-3,18
D Bucuresti,3549,4,4,5,5,20,20,0,17
FC Botosani,3549,5,4,5,5,9,15,-6,17
Concordia Ch,3549,6,2,2,10,16,25,-9,8
FCSB,3550,1,8,5,1,27,13,14,29
CFR Cluj,3550,2,6,7,1,16,8,8,25
FC Botosani,3550,3,4,5,5,8,13,-5,17
Universitate,3550,4,3,6,5,14,21,-7,15
D Bucuresti,3550,5,3,5,6,18,21,-3,14
Concordia Ch,3550,6,3,2,9,17,24,-7,11
FCSB,3551,1,7,6,1,27,16,11,27
CFR Cluj,3551,2,6,6,2,17,11,6,24
Universitate,3551,3,4,6,4,18,20,-2,18
D Bucuresti,3551,4,3,6,5,18,20,-2,15
FC Botosani,3551,5,3,5,6,8,17,-9,14
Concordia Ch,3551,6,3,3,8,20,24,-4,12
FCSB,3552,1,7,6,1,26,14,12,27
CFR Cluj,3552,2,6,7,1,16,9,7,25
D Bucuresti,3552,3,4,4,6,18,21,-3,16
Universitate,3552,4,3,7,4,15,19,-4,16
FC Botosani,3552,5,3,5,6,6,14,-8,14
Concordia Ch,3552,6,3,3,8,19,23,-4,12
FCSB,3553,1,8,5,1,25,12,13,29
CFR Cluj,3553,2,6,6,2,17,9,8,24
FC Botosani,3553,3,4,5,5,7,12,-5,17
Universitate,3553,4,4,5,5,15,21,-6,17
D Bucuresti,3553,5,3,5,6,16,23,-7,14
Concordia Ch,3553,6,3,2,9,20,23,-3,11
FCSB,3554,1,8,5,1,27,13,14,29
CFR Cluj,3554,2,6,6,2,14,9,5,24
Universitate,3554,3,4,5,5,17,21,-4,17
FC Botosani,3554,4,4,4,6,7,14,-7,16
Concordia Ch,3554,5,4,2,8,17,21,-4,14
D Bucuresti,3554,6,3,4,7,17,21,-4,13
FCSB,3555,1,7,6,1,24,12,12,27
CFR Cluj,3555,2,7,6,1,18,9,9,27
FC Botosani,3555,3,4,5,5,8,13,-5,17
Universitate,3555,4,3,6,5,15,21,-6,15
D Bucuresti,3555,5,3,5,6,18,21,-3,14
Concordia Ch,3555,6,3,2,9,17,24,-7,11
CFR Cluj,3556,1,7,6,1,15,7,8,27
FCSB,3556,2,7,5,2,24,13,11,26
Universitate,3556,3,4,5,5,16,20,-4,17
D Bucuresti,3556,4,4,4,6,20,20,0,16
FC Botosani,3556,5,3,5,6,6,17,-11,14
Concordia Ch,3556,6,3,3,8,18,22,-4,12
FCSB,3557,1,9,5,0,27,11,16,32
CFR Cluj,3557,2,6,6,2,17,12,5,24
FC Botosani,3557,3,5,4,5,9,12,-3,19
Universitate,3557,4,3,5,6,16,22,-6,14
D Bucuresti,3557,5,3,4,7,17,22,-5,13
Concordia Ch,3557,6,3,2,9,17,24,-7,11
FCSB,3558,1,7,7,0,27,14,13,28
CFR Cluj,3558,2,5,8,1,15,9,6,23
D Bucuresti,3558,3,4,4,6,18,20,-2,16
Universitate,3558,4,3,7,4,16,20,-4,16
Concordia Ch,3558,5,4,2,8,19,22,-3,14
FC Botosani,3558,6,3,4,7,5,15,-10,13
FCSB,3559,1,7,6,1,24,13,11,27
CFR Cluj,3559,2,6,7,1,17,9,8,25
Universitate,3559,3,4,5,5,17,21,-4,17
D Bucuresti,3559,4,4,4,6,17,19,-2,16
FC Botosani,3559,5,4,4,6,7,14,-7,16
Concordia Ch,3559,6,3,2,9,17,23,-6,11
FCSB,3560,1,8,5,1,24,12,12,29
CFR Cluj,3560,2,6,6,2,14,8,6,24
Universitate,3560,3,4,5,5,16,19,-3,17
FC Botosani,3560,4,4,5,5,8,13,-5,17
D Bucuresti,3560,5,3,6,5,19,21,-2,15
Concordia Ch,3560,6,2,3,9,17,25,-8,9
FCSB,3561,1,7,5,2,24,14,10,26
CFR Cluj,3561,2,6,7,1,15,8,7,25
Universitate,3561,3,4,6,4,18,20,-2,18
FC Botosani,3561,4,4,5,5,7,13,-6,17
D Bucuresti,3561,5,3,5,6,17,20,-3,14
Concordia Ch,3561,6,2,4,8,17,23,-6,10
FCSB,3562,1,7,6,1,24,12,12,27
CFR Cluj,3562,2,6,7,1,15,8,7,25
D Bucuresti,3562,3,4,5,5,17,18,-1,17
Universitate,3562,4,4,5,5,15,19,-4,17
FC Botosani,3562,5,3,5,6,6,14,-8,14
Concordia Ch,3562,6,3,2,9,17,23,-6,11
FCSB,3563,1,9,5,0,27,11,16,32
CFR Cluj,3563,2,5,6,3,14,10,4,21
Universitate,3563,3,4,5,5,15,20,-5,17
Concordia Ch,3563,4,4,2,8,23,22,1,14
D Bucuresti,3563,5,3,5,6,18,24,-6,14
FC Botosani,3563,6,3,5,6,6,16,-10,14
FCSB,3564,1,8,5,1,27,13,14,29
CFR Cluj,3564,2,6,6,2,15,10,5,24
Universitate,3564,3,4,5,5,16,20,-4,17
D Bucuresti,3564,4,4,4,6,19,22,-3,16
Concordia Ch,3564,5,4,2,8,19,21,-2,14
FC Botosani,3564,6,3,4,7,6,16,-10,13
FCSB,3565,1,8,6,0,25,11,14,30
CFR Cluj,3565,2,6,6,2,14,8,6,24
D Bucuresti,3565,3,4,5,5,18,19,-1,17
Universitate,3565,4,3,6,5,15,20,-5,15
FC Botosani,3565,5,3,6,5,5,12,-7,15
Concordia Ch,3565,6,2,3,9,16,23,-7,9
FCSB,3566,1,8,5,1,25,11,14,29
CFR Cluj,3566,2,6,6,2,16,11,5,24
D Bucuresti,3566,3,5,4,5,20,19,1,19
Universitate,3566,4,4,5,5,17,21,-4,17
FC Botosani,3566,5,4,4,6,8,14,-6,16
Concordia Ch,3566,6,2,2,10,15,25,-10,8
FCSB,3567,1,8,5,1,27,13,14,29
CFR Cluj,3567,2,7,6,1,17,7,10,27
FC Botosani,3567,3,4,5,5,6,12,-6,17
D Bucuresti,3567,4,3,6,5,18,20,-2,15
Universitate,3567,5,3,5,6,15,24,-9,14
Concordia Ch,3567,6,2,3,9,17,24,-7,9
FCSB,3568,1,7,6,1,26,15,11,27
CFR Cluj,3568,2,5,7,2,16,13,3,22
Universitate,3568,3,5,5,4,21,20,1,20
D Bucuresti,3568,4,5,4,5,22,22,0,19
FC Botosani,3568,5,4,4,6,8,15,-7,16
Concordia Ch,3568,6,2,2,10,19,27,-8,8
FCSB,3569,1,9,5,0,26,11,15,32
CFR Cluj,3569,2,6,6,2,17,8,9,24
FC Botosani,3569,3,4,5,5,8,13,-5,17
D Bucuresti,3569,4,3,5,6,17,23,-6,14
Universitate,3569,5,3,5,6,15,24,-9,14
Concordia Ch,3569,6,3,2,9,19,23,-4,11
FCSB,3570,1,8,5,1,25,12,13,29
CFR Cluj,3570,2,6,6,2,15,8,7,24
Universitate,3570,3,4,5,5,15,20,-5,17
FC Botosani,3570,4,4,5,5,7,13,-6,17
D Bucuresti,3570,5,3,6,5,18,20,-2,15
Concordia Ch,3570,6,2,3,9,18,25,-7,9
FCSB,3571,1,7,7,0,27,14,13,28
CFR Cluj,3571,2,6,7,1,15,8,7,25
D Bucuresti,3571,3,4,4,6,17,19,-2,16
FC Botosani,3571,4,4,4,6,7,14,-7,16
Universitate,3571,5,3,6,5,17,22,-5,15
Concordia Ch,3571,6,3,2,9,17,23,-6,11
FCSB,3572,1,9,5,0,28,11,17,32
CFR Cluj,3572,2,6,6,2,16,12,4,24
D Bucuresti,3572,3,4,4,6,19,19,0,16
FC Botosani,3572,4,4,4,6,8,15,-7,16
Universitate,3572,5,3,5,6,17,23,-6,14
Concordia Ch,3572,6,3,2,9,16,24,-8,11
FCSB,3573,1,8,5,1,24,12,12,29
CFR Cluj,3573,2,7,6,1,19,8,11,27
FC Botosani,3573,3,4,4,6,11,16,-5,16
Concordia Ch,3573,4,4,2,8,20,23,-3,14
Universitate,3573,5,3,5,6,15,23,-8,14
D Bucuresti,3573,6,3,4,7,17,24,-7,13
FCSB,3574,1,7,7,0,27,14,13,28
CFR Cluj,3574,2,5,7,2,14,9,5,22
Universitate,3574,3,4,6,4,18,21,-3,18
D Bucuresti,3574,4,4,4,6,19,21,-2,16
FC Botosani,3574,5,4,4,6,8,15,-7,16
Concordia Ch,3574,6,3,2,9,18,24,-6,11
FCSB,3575,1,9,5,0,27,11,16,32
CFR Cluj,3575,2,6,6,2,16,11,5,24
D Bucuresti,3575,3,4,4,6,20,22,-2,16
Concordia Ch,3575,4,4,2,8,19,23,-4,14
Universitate,3575,5,3,5,6,17,23,-6,14
FC Botosani,3575,6,3,4,7,8,17,-9,13
FCSB,3576,1,8,5,1,25,12,13,29
CFR Cluj,3576,2,7,6,1,18,9,9,27
FC Botosani,3576,3,3,6,5,9,16,-7,15
D Bucuresti,3576,4,3,5,6,18,21,-3,14
Universitate,3576,5,3,5,6,16,23,-7,14
Concordia Ch,3576,6,3,3,8,18,23,-5,12
FCSB,3577,1,7,6,1,24,12,12,27
CFR Cluj,3577,2,5,8,1,14,8,6,23
Universitate,3577,3,4,6,4,17,20,-3,18
D Bucuresti,3577,4,3,5,6,18,21,-3,14
Concordia Ch,3577,5,4,2,8,19,23,-4,14
FC Botosani,3577,6,3,5,6,5,13,-8,14
FCSB,3578,1,8,6,0,27,12,15,30
CFR Cluj,3578,2,6,7,1,16,9,7,25
FC Botosani,3578,3,5,4,5,9,12,-3,19
Universitate,3578,4,3,5,6,14,21,-7,14
D Bucuresti,3578,5,3,4,7,16,21,-5,13
Concordia Ch,3578,6,3,2,9,17,24,-7,11
FCSB,3579,1,9,5,0,29,13,16,32
CFR Cluj,3579,2,5,7,2,15,10,5,22
D Bucuresti,3579,3,4,4,6,19,21,-2,16
Universitate,3579,4,3,6,5,15,21,-6,15
FC Botosani,3579,5,3,5,6,6,14,-8,14
Concordia Ch,3579,6,3,3,8,17,22,-5,12
FCSB,3580,1,8,6,0,25,11,14,30
CFR Cluj,3580,2,6,7,1,16,8,8,25
FC Botosani,3580,3,4,5,5,9,13,-4,17
D Bucuresti,3580,4,4,4,6,19,23,-4,16
Universitate,3580,5,3,5,6,14,21,-7,14
Concordia Ch,3580,6,2,3,9,18,25,-7,9
FCSB,3581,1,8,5,1,26,14,12,29
CFR Cluj,3581,2,6,6,2,18,10,8,24
Universitate,3581,3,4,5,5,18,23,-5,17
FC Botosani,3581,4,4,5,5,7,12,-5,17
D Bucuresti,3581,5,3,6,5,19,21,-2,15
Concordia Ch,3581,6,2,3,9,18,26,-8,9
FCSB,3582,1,9,5,0,28,13,15,32
CFR Cluj,3582,2,6,6,2,17,11,6,24
FC Botosani,3582,3,3,6,5,6,13,-7,15
D Bucuresti,3582,4,3,5,6,17,22,-5,14
Universitate,3582,5,3,5,6,16,22,-6,14
Concordia Ch,3582,6,3,3,8,20,23,-3,12
FCSB,3583,1,9,5,0,28,12,16,32
CFR Cluj,3583,2,5,7,2,14,10,4,22
D Bucuresti,3583,3,5,4,5,21,20,1,19
Universitate,3583,4,3,6,5,15,20,-5,15
FC Botosani,3583,5,3,4,7,6,16,-10,13
Concordia Ch,3583,6,3,2,9,19,25,-6,11
FCSB,3584,1,7,6,1,23,11,12,27
CFR Cluj,3584,2,6,6,2,14,8,6,24
Universitate,3584,3,4,6,4,15,18,-3,18
D Bucuresti,3584,4,4,4,6,19,23,-4,16
Concordia Ch,3584,5,4,2,8,21,22,-1,14
FC Botosani,3584,6,3,4,7,5,15,-10,13
FCSB,3585,1,7,7,0,24,11,13,28
CFR Cluj,3585,2,5,8,1,15,9,6,23
FC Botosani,3585,3,4,5,5,8,14,-6,17
Universitate,3585,4,3,7,4,15,19,-4,16
D Bucuresti,3585,5,3,5,6,17,22,-5,14
Concordia Ch,3585,6,3,2,9,19,23,-4,11
FCSB,3586,1,7,5,2,23,12,11,26
CFR Cluj,3586,2,6,6,2,15,9,6,24
Universitate,3586,3,5,5,4,17,19,-2,20
FC Botosani,3586,4,4,5,5,8,14,-6,17
D Bucuresti,3586,5,3,5,6,19,22,-3,14
Concordia Ch,3586,6,2,4,8,16,22,-6,10
FCSB,3587,1,8,5,1,25,12,13,29
CFR Cluj,3587,2,5,7,2,14,9,5,22
Universitate,3587,3,4,6,4,17,20,-3,18
D Bucuresti,3587,4,4,5,5,18,19,-1,17
FC Botosani,3587,5,3,5,6,5,14,-9,14
Concordia Ch,3587,6,3,2,9,18,23,-5,11
FCSB,3588,1,7,6,1,26,14,12,27
CFR Cluj,3588,2,7,6,1,18,9,9,27
FC Botosani,3588,3,4,5,5,9,13,-4,17
Universitate,3588,4,3,6,5,15,21,-6,15
D Bucuresti,3588,5,3,5,6,16,20,-4,14
Concordia Ch,3588,6,3,2,9,18,25,-7,11
CFR Cluj,3589,1,7,6,1,19,7,12,27
FCSB,3589,2,7,6,1,24,13,11,27
D Bucuresti,3589,3,4,5,5,20,20,0,17
FC Botosani,3589,4,4,5,5,7,13,-6,17
Universitate,3589,5,3,6,5,15,23,-8,15
Concordia Ch,3589,6,2,2,10,16,25,-9,8
FCSB,3590,1,8,5,1,25,14,11,29
CFR Cluj,3590,2,5,6,3,13,9,4,21
Universitate,3590,3,5,5,4,19,19,0,20
D Bucuresti,3590,4,4,5,5,19,20,-1,17
FC Botosani,3590,5,4,4,6,6,13,-7,16
Concordia Ch,3590,6,2,3,9,17,24,-7,9
FCSB,3591,1,9,5,0,27,12,15,32
CFR Cluj,3591,2,6,6,2,17,10,7,24
FC Botosani,3591,3,4,4,6,8,15,-7,16
D Bucuresti,3591,4,3,5,6,18,21,-3,14
Universitate,3591,5,3,5,6,16,23,-7,14
Concordia Ch,3591,6,3,3,8,18,23,-5,12
FCSB,3592,1,9,5,0,27,10,17,32
CFR Cluj,3592,2,5,7,2,13,8,5,22
D Bucuresti,3592,3,4,4,6,19,20,-1,16
FC Botosani,3592,4,4,4,6,7,15,-8,16
Universitate,3592,5,3,6,5,14,21,-7,15
Concordia Ch,3592,6,3,2,9,16,22,-6,11
FCSB,3593,1,7,6,1,24,12,12,27
CFR Cluj,3593,2,5,8,1,15,9,6,23
Universitate,3593,3,4,6,4,18,21,-3,18
D Bucuresti,3593,4,4,5,5,20,21,-1,17
FC Botosani,3593,5,3,4,7,5,14,-9,13
Concordia Ch,3593,6,3,3,8,19,24,-5,12
FCSB,3594,1,8,6,0,26,12,14,30
CFR Cluj,3594,2,6,6,2,15,9,6,24
FC Botosani,3594,3,4,5,5,8,14,-6,17
D Bucuresti,3594,4,4,4,6,20,22,-2,16
Universitate,3594,5,3,6,5,17,22,-5,15
Concordia Ch,3594,6,2,3,9,16,23,-7,9
FCSB,3595,1,8,5,1,25,12,13,29
CFR Cluj,3595,2,6,6,2,14,9,5,24
D Bucuresti,3595,3,5,4,5,21,19,2,19
Universitate,3595,4,4,5,5,17,20,-3,17
FC Botosani,3595,5,4,4,6,6,14,-8,16
Concordia Ch,3595,6,2,2,10,16,25,-9,8
FCSB,3596,1,9,5,0,26,11,15,32
CFR Cluj,3596,2,6,6,2,15,8,7,24
D Bucuresti,3596,3,4,5,5,19,19,0,17
Universitate,3596,4,3,5,6,15,22,-7,14
FC Botosani,3596,5,3,4,7,5,15,-10,13
Concordia Ch,3596,6,3,3,8,17,22,-5,12
FCSB,3597,1,8,5,1,25,12,13,29
CFR Cluj,3597,2,6,6,2,16,10,6,24
Universitate,3597,3,4,5,5,17,21,-4,17
D Bucuresti,3597,4,4,4,6,20,22,-2,16
Concordia Ch,3597,5,4,2,8,25,22,3,14
FC Botosani,3597,6,3,4,7,7,23,-16,13
FCSB,3598,1,7,5,2,24,13,11,26
CFR Cluj,3598,2,6,6,2,15,9,6,24
Universitate,3598,3,5,5,4,18,20,-2,20
D Bucuresti,3598,4,4,5,5,19,18,1,17
FC Botosani,3598,5,3,4,7,5,18,-13,13
Concordia Ch,3598,6,3,3,8,18,21,-3,12
FCSB,3599,1,7,6,1,26,14,12,27
CFR Cluj,3599,2,6,7,1,15,8,7,25
D Bucuresti,3599,3,5,4,5,21,20,1,19
Universitate,3599,4,4,5,5,17,21,-4,17
FC Botosani,3599,5,3,5,6,7,16,-9,14
Concordia Ch,3599,6,2,3,9,19,26,-7,9
FCSB,3600,1,9,5,0,27,12,15,32
CFR Cluj,3600,2,6,6,2,17,10,7,24
D Bucuresti,3600,3,4,4,6,20,21,-1,16
FC Botosani,3600,4,4,4,6,8,16,-8,16
Universitate,3600,5,3,5,6,16,23,-7,14
Concordia Ch,3600,6,3,2,9,18,24,-6,11
FCSB,3601,1,7,7,0,27,14,13,28
CFR Cluj,3601,2,5,8,1,15,9,6,23
Universitate,3601,3,3,7,4,18,22,-4,16
D Bucuresti,3601,4,3,5,6,16,19,-3,14
Concordia Ch,3601,5,4,2,8,17,21,-4,14
FC Botosani,3601,6,3,5,6,5,13,-8,14
FCSB,3602,1,7,7,0,24,11,13,28
CFR Cluj,3602,2,5,7,2,13,8,5,22
Universitate,3602,3,4,6,4,16,19,-3,18
D Bucuresti,3602,4,4,4,6,17,19,-2,16
FC Botosani,3602,5,4,4,6,7,14,-7,16
Concordia Ch,3602,6,3,2,9,17,23,-6,11
FCSB,3603,1,8,6,0,26,11,15,30
CFR Cluj,3603,2,5,6,3,14,12,2,21
Universitate,3603,3,4,6,4,18,20,-2,18
D Bucuresti,3603,4,4,4,6,19,21,-2,16
FC Botosani,3603,5,4,4,6,8,15,-7,16
Concordia Ch,3603,6,3,2,9,18,24,-6,11
FCSB,3604,1,8,6,0,28,12,16,30
CFR Cluj,3604,2,6,6,2,16,11,5,24
FC Botosani,3604,3,5,4,5,7,12,-5,19
Universitate,3604,4,3,6,5,15,21,-6,15
D Bucuresti,3604,5,3,5,6,16,19,-3,14
Concordia Ch,3604,6,2,3,9,15,22,-7,9
FCSB,3605,1,8,5,1,26,14,12,29
CFR Cluj,3605,2,6,6,2,16,9,7,24
FC Botosani,3605,3,5,4,5,10,13,-3,19
Universitate,3605,4,4,5,5,17,21,-4,17
D Bucuresti,3605,5,3,5,6,18,21,-3,14
Concordia Ch,3605,6,2,3,9,16,25,-9,9
FCSB,3606,1,8,5,1,25,12,13,29
CFR Cluj,3606,2,5,6,3,15,11,4,21
Universitate,3606,3,5,5,4,19,21,-2,20
D Bucuresti,3606,4,4,4,6,17,19,-2,16
FC Botosani,3606,5,4,4,6,7,14,-7,16
Concordia Ch,3606,6,3,2,9,17,23,-6,11
FCSB,3607,1,9,5,0,27,11,16,32
CFR Cluj,3607,2,6,6,2,16,8,8,24
FC Botosani,3607,3,4,5,5,8,13,-5,17
Universitate,3607,4,3,5,6,15,24,-9,14
D Bucuresti,3607,5,3,4,7,17,22,-5,13
Concordia Ch,3607,6,3,3,8,16,21,-5,12
FCSB,3608,1,8,6,0,25,11,14,30
CFR Cluj,3608,2,6,7,1,18,9,9,25
D Bucuresti,3608,3,4,5,5,21,21,0,17
Universitate,3608,4,3,5,6,15,23,-8,14
FC Botosani,3608,5,3,4,7,5,16,-11,13
Concordia Ch,3608,6,3,3,8,20,24,-4,12
FCSB,3609,1,8,5,1,29,16,13,29
CFR Cluj,3609,2,7,6,1,19,9,10,27
D Bucuresti,3609,3,5,4,5,18,18,0,19
FC Botosani,3609,4,4,4,6,8,13,-5,16
Universitate,3609,5,3,5,6,19,27,-8,14
Concordia Ch,3609,6,2,2,10,15,25,-10,8
FCSB,3610,1,8,5,1,26,14,12,29
CFR Cluj,3610,2,5,6,3,13,10,3,21
Universitate,3610,3,5,5,4,19,19,0,20
D Bucuresti,3610,4,4,4,6,20,21,-1,16
Concordia Ch,3610,5,4,2,8,20,23,-3,14
FC Botosani,3610,6,3,4,7,6,17,-11,13
FCSB,3611,1,9,5,0,26,10,16,32
CFR Cluj,3611,2,6,6,2,16,8,8,24
D Bucuresti,3611,3,5,4,5,20,19,1,19
Universitate,3611,4,3,5,6,14,23,-9,14
FC Botosani,3611,5,3,5,6,8,17,-9,14
Concordia Ch,3611,6,2,3,9,17,24,-7,9
FCSB,3612,1,8,6,0,27,13,14,30
CFR Cluj,3612,2,6,6,2,19,11,8,24
D Bucuresti,3612,3,4,5,5,20,20,0,17
FC Botosani,3612,4,4,4,6,10,15,-5,16
Universitate,3612,5,3,6,5,16,23,-7,15
Concordia Ch,3612,6,2,3,9,16,26,-10,9
FCSB,3613,1,8,5,1,26,12,14,29
CFR Cluj,3613,2,6,7,1,14,7,7,25
D Bucuresti,3613,3,5,4,5,19,18,1,19
FC Botosani,3613,4,4,4,6,7,14,-7,16
Universitate,3613,5,3,6,5,15,21,-6,15
Concordia Ch,3613,6,2,2,10,15,24,-9,8
FCSB,3614,1,7,7,0,26,13,13,28
CFR Cluj,3614,2,6,7,1,17,10,7,25
D Bucuresti,3614,3,4,5,5,19,20,-1,17
Universitate,3614,4,3,6,5,16,21,-5,15
FC Botosani,3614,5,3,6,5,8,15,-7,15
Concordia Ch,3614,6,2,3,9,16,23,-7,9
FCSB,3615,1,7,6,1,24,12,12,27
CFR Cluj,3615,2,7,6,1,18,8,10,27
D Bucuresti,3615,3,4,5,5,20,20,0,17
Universitate,3615,4,3,6,5,16,23,-7,15
FC Botosani,3615,5,3,6,5,5,12,-7,15
Concordia Ch,3615,6,2,3,9,17,25,-8,9
FCSB,3616,1,9,5,0,29,13,16,32
CFR Cluj,3616,2,6,6,2,17,12,5,24
D Bucuresti,3616,3,4,4,6,19,22,-3,16
Universitate,3616,4,3,5,6,16,22,-6,14
FC Botosani,3616,5,3,5,6,5,13,-8,14
Concordia Ch,3616,6,3,3,8,19,23,-4,12
FCSB,3617,1,9,5,0,27,12,15,32
CFR Cluj,3617,2,6,6,2,15,9,6,24
FC Botosani,3617,3,4,5,5,7,13,-6,17
Universitate,3617,4,3,5,6,15,21,-6,14
D Bucuresti,3617,5,3,4,7,17,23,-6,13
Concordia Ch,3617,6,3,3,8,18,21,-3,12
FCSB,3618,1,8,6,0,24,10,14,30
CFR Cluj,3618,2,5,6,3,14,10,4,21
Universitate,3618,3,4,6,4,16,19,-3,18
FC Botosani,3618,4,4,5,5,9,14,-5,17
D Bucuresti,3618,5,3,5,6,16,19,-3,14
Concordia Ch,3618,6,3,2,9,18,25,-7,11
CFR Cluj,3619,1,7,6,1,17,9,8,27
FCSB,3619,2,7,5,2,25,14,11,26
D Bucuresti,3619,3,5,4,5,22,21,1,19
Universitate,3619,4,4,5,5,17,21,-4,17
FC Botosani,3619,5,4,4,6,11,15,-4,16
Concordia Ch,3619,6,2,2,10,18,30,-12,8
FCSB,3620,1,8,6,0,25,11,14,30
CFR Cluj,3620,2,5,7,2,14,10,4,22
Universitate,3620,3,4,5,5,16,19,-3,17
D Bucuresti,3620,4,3,6,5,16,18,-2,15
FC Botosani,3620,5,3,6,5,6,13,-7,15
Concordia Ch,3620,6,2,4,8,16,22,-6,10
FCSB,3621,1,8,6,0,26,11,15,30
CFR Cluj,3621,2,6,6,2,16,9,7,24
FC Botosani,3621,3,4,4,6,10,14,-4,16
Universitate,3621,4,3,6,5,15,22,-7,15
D Bucuresti,3621,5,3,5,6,18,24,-6,14
Concordia Ch,3621,6,3,3,8,17,22,-5,12
FCSB,3622,1,8,5,1,25,14,11,29
CFR Cluj,3622,2,7,6,1,19,9,10,27
D Bucuresti,3622,3,4,5,5,18,19,-1,17
Universitate,3622,4,3,5,6,15,21,-6,14
FC Botosani,3622,5,3,5,6,7,15,-8,14
Concordia Ch,3622,6,3,2,9,19,25,-6,11
FCSB,3623,1,8,5,1,25,13,12,29
CFR Cluj,3623,2,7,6,1,20,9,11,27
FC Botosani,3623,3,4,5,5,7,13,-6,17
Universitate,3623,4,3,5,6,15,23,-8,14
D Bucuresti,3623,5,3,4,7,17,21,-4,13
Concordia Ch,3623,6,3,3,8,18,23,-5,12
FCSB,3624,1,8,6,0,26,12,14,30
CFR Cluj,3624,2,6,6,2,19,10,9,24
D Bucuresti,3624,3,5,4,5,19,18,1,19
FC Botosani,3624,4,4,4,6,6,14,-8,16
Universitate,3624,5,3,6,5,16,24,-8,15
Concordia Ch,3624,6,2,2,10,15,23,-8,8
FCSB,3625,1,8,5,1,24,13,11,29
CFR Cluj,3625,2,6,6,2,15,9,6,24
Universitate,3625,3,4,5,5,18,20,-2,17
FC Botosani,3625,4,4,4,6,6,13,-7,16
Concordia Ch,3625,5,4,2,8,18,21,-3,14
D Bucuresti,3625,6,3,4,7,16,21,-5,13
FCSB,3626,1,9,5,0,29,11,18,32
CFR Cluj,3626,2,6,6,2,17,12,5,24
D Bucuresti,3626,3,3,6,5,19,21,-2,15
Universitate,3626,4,3,5,6,14,22,-8,14
FC Botosani,3626,5,3,5,6,7,15,-8,14
Concordia Ch,3626,6,3,3,8,19,24,-5,12
CFR Cluj,3627,1,7,6,1,17,7,10,27
FCSB,3627,2,7,5,2,23,14,9,26
Universitate,3627,3,4,5,5,16,20,-4,17
D Bucuresti,3627,4,4,4,6,19,19,0,16
FC Botosani,3627,5,4,4,6,7,16,-9,16
Concordia Ch,3627,6,3,2,9,17,23,-6,11
FCSB,3628,1,7,6,1,24,12,12,27
CFR Cluj,3628,2,6,7,1,16,9,7,25
D Bucuresti,3628,3,5,4,5,22,22,0,19
Universitate,3628,4,4,5,5,16,20,-4,17
FC Botosani,3628,5,3,4,7,6,16,-10,13
Concordia Ch,3628,6,3,2,9,20,25,-5,11
FCSB,3629,1,7,5,2,27,17,10,26
CFR Cluj,3629,2,6,7,1,18,10,8,25
Universitate,3629,3,4,6,4,18,21,-3,18
D Bucuresti,3629,4,4,4,6,19,21,-2,16
FC Botosani,3629,5,4,4,6,9,15,-6,16
Concordia Ch,3629,6,3,2,9,19,26,-7,11
FCSB,3630,1,7,7,0,27,14,13,28
CFR Cluj,3630,2,6,7,1,19,11,8,25
FC Botosani,3630,3,4,4,6,7,14,-7,16
Universitate,3630,4,3,6,5,16,22,-6,15
Concordia Ch,3630,5,4,2,8,22,23,-1,14
D Bucuresti,3630,6,3,4,7,17,24,-7,13
FCSB,3631,1,9,5,0,29,11,18,32
CFR Cluj,3631,2,6,6,2,14,11,3,24
D Bucuresti,3631,3,4,5,5,18,19,-1,17
FC Botosani,3631,4,4,5,5,7,13,-6,17
Universitate,3631,5,3,5,6,15,21,-6,14
Concordia Ch,3631,6,2,2,10,15,23,-8,8
FCSB,3632,1,8,5,1,25,13,12,29
CFR Cluj,3632,2,5,7,2,14,10,4,22
FC Botosani,3632,3,5,4,5,8,12,-4,19
Universitate,3632,4,4,6,4,18,19,-1,18
D Bucuresti,3632,5,3,4,7,17,22,-5,13
Concordia Ch,3632,6,3,2,9,17,23,-6,11
FCSB,3633,1,8,5,1,25,11,14,29
CFR Cluj,3633,2,6,6,2,16,10,6,24
FC Botosani,3633,3,5,4,5,10,13,-3,19
Universitate,3633,4,4,5,5,17,22,-5,17
D Bucuresti,3633,5,3,4,7,17,22,-5,13
Concordia Ch,3633,6,3,2,9,17,24,-7,11
FCSB,3634,1,9,5,0,26,10,16,32
CFR Cluj,3634,2,6,6,2,16,9,7,24
D Bucuresti,3634,3,5,4,5,20,18,2,19
Universitate,3634,4,3,5,6,15,23,-8,14
FC Botosani,3634,5,3,5,6,5,15,-10,14
Concordia Ch,3634,6,2,3,9,15,22,-7,9
FCSB,3635,1,9,5,0,26,11,15,32
CFR Cluj,3635,2,5,6,3,14,11,3,21
D Bucuresti,3635,3,4,5,5,18,18,0,17
Universitate,3635,4,4,5,5,18,21,-3,17
FC Botosani,3635,5,3,6,5,6,13,-7,15
Concordia Ch,3635,6,2,3,9,16,24,-8,9
FCSB,3636,1,7,7,0,27,14,13,28
CFR Cluj,3636,2,6,7,1,17,10,7,25
D Bucuresti,3636,3,5,4,5,20,19,1,19
Universitate,3636,4,3,6,5,15,20,-5,15
FC Botosani,3636,5,3,4,7,5,15,-10,13
Concordia Ch,3636,6,3,2,9,17,23,-6,11
FCSB,3637,1,7,5,2,23,12,11,26
CFR Cluj,3637,2,6,6,2,14,8,6,24
Universitate,3637,3,5,5,4,16,18,-2,20
D Bucuresti,3637,4,4,5,5,19,19,0,17
FC Botosani,3637,5,4,4,6,7,15,-8,16
Concordia Ch,3637,6,2,3,9,17,24,-7,9
FCSB,3638,1,8,6,0,26,12,14,30
CFR Cluj,3638,2,5,7,2,14,9,5,22
Universitate,3638,3,4,5,5,16,20,-4,17
D Bucuresti,3638,4,3,5,6,18,21,-3,14
Concordia Ch,3638,5,4,2,8,19,23,-4,14
FC Botosani,3638,6,3,5,6,7,15,-8,14
FCSB,3639,1,8,5,1,25,13,12,29
CFR Cluj,3639,2,5,6,3,15,12,3,21
Universitate,3639,3,5,5,4,19,19,0,20
FC Botosani,3639,4,4,5,5,9,13,-4,17
D Bucuresti,3639,5,3,5,6,17,20,-3,14
Concordia Ch,3639,6,3,2,9,16,24,-8,11
FCSB,3640,1,8,6,0,26,11,15,30
CFR Cluj,3640,2,5,7,2,14,10,4,22
Universitate,3640,3,3,7,4,16,20,-4,16
FC Botosani,3640,4,3,6,5,7,14,-7,15
D Bucuresti,3640,5,3,5,6,17,20,-3,14
Concordia Ch,3640,6,3,3,8,19,24,-5,12
CFR Cluj,3641,1,7,6,1,17,7,10,27
FCSB,3641,2,7,5,2,23,14,9,26
FC Botosani,3641,3,5,4,5,11,13,-2,19
Universitate,3641,4,4,5,5,17,21,-4,17
D Bucuresti,3641,5,3,4,7,16,20,-4,13
Concordia Ch,3641,6,3,2,9,17,26,-9,11
FCSB,3642,1,8,6,0,27,11,16,30
CFR Cluj,3642,2,5,7,2,14,11,3,22
D Bucuresti,3642,3,4,4,6,19,21,-2,16
Universitate,3642,4,3,7,4,16,20,-4,16
FC Botosani,3642,5,4,4,6,8,15,-7,16
Concordia Ch,3642,6,3,2,9,16,22,-6,11
FCSB,3643,1,8,6,0,27,13,14,30
CFR Cluj,3643,2,6,6,2,19,12,7,24
D Bucuresti,3643,3,4,4,6,18,20,-2,16
Universitate,3643,4,3,6,5,17,23,-6,15
FC Botosani,3643,5,3,5,6,6,14,-8,14
Concordia Ch,3643,6,3,3,8,16,21,-5,12
FCSB,3644,1,8,5,1,25,13,12,29
CFR Cluj,3644,2,5,7,2,15,10,5,22
Universitate,3644,3,4,6,4,17,19,-2,18
D Bucuresti,3644,4,4,5,5,19,20,-1,17
FC Botosani,3644,5,4,5,5,6,12,-6,17
Concordia Ch,3644,6,2,2,10,17,25,-8,8
FCSB,3645,1,7,6,1,25,13,12,27
CFR Cluj,3645,2,6,6,2,16,10,6,24
Universitate,3645,3,4,6,4,17,20,-3,18
D Bucuresti,3645,4,4,4,6,18,20,-2,16
FC Botosani,3645,5,4,4,6,6,14,-8,16
Concordia Ch,3645,6,3,2,9,17,22,-5,11
FCSB,3646,1,8,5,1,25,11,14,29
CFR Cluj,3646,2,6,6,2,15,10,5,24
D Bucuresti,3646,3,5,4,5,20,18,2,19
Universitate,3646,4,4,5,5,16,20,-4,17
FC Botosani,3646,5,3,5,6,5,14,-9,14
Concordia Ch,3646,6,2,3,9,15,23,-8,9
FCSB,3647,1,7,7,0,24,11,13,28
CFR Cluj,3647,2,6,7,1,19,7,12,25
D Bucuresti,3647,3,4,4,6,18,19,-1,16
FC Botosani,3647,4,4,4,6,7,14,-7,16
Universitate,3647,5,3,6,5,15,25,-10,15
Concordia Ch,3647,6,3,2,9,17,24,-7,11
FCSB,3648,1,7,6,1,23,11,12,27
CFR Cluj,3648,2,6,7,1,15,7,8,25
Universitate,3648,3,4,5,5,15,20,-5,17
FC Botosani,3648,4,4,5,5,7,12,-5,17
D Bucuresti,3648,5,3,5,6,16,21,-5,14
Concordia Ch,3648,6,3,2,9,18,23,-5,11
FCSB,3649,1,8,6,0,27,13,14,30
CFR Cluj,3649,2,6,7,1,17,8,9,25
D Bucuresti,3649,3,4,4,6,18,20,-2,16
Concordia Ch,3649,4,4,2,8,19,23,-4,14
Universitate,3649,5,3,5,6,16,24,-8,14
FC Botosani,3649,6,3,4,7,6,15,-9,13
FCSB,3650,1,8,5,1,29,15,14,29
CFR Cluj,3650,2,6,6,2,17,13,4,24
FC Botosani,3650,3,5,4,5,9,13,-4,19
Universitate,3650,4,4,5,5,19,22,-3,17
D Bucuresti,3650,5,4,4,6,19,19,0,16
Concordia Ch,3650,6,2,2,10,16,27,-11,8
FCSB,3651,1,8,6,0,26,11,15,30
CFR Cluj,3651,2,5,7,2,14,9,5,22
Universitate,3651,3,4,5,5,15,20,-5,17
D Bucuresti,3651,4,3,5,6,17,20,-3,14
Concordia Ch,3651,5,4,2,8,17,21,-4,14
FC Botosani,3651,6,3,5,6,6,14,-8,14
FCSB,3652,1,7,7,0,24,11,13,28
CFR Cluj,3652,2,6,7,1,18,9,9,25
FC Botosani,3652,3,4,5,5,8,13,-5,17
Universitate,3652,4,3,6,5,15,22,-7,15
D Bucuresti,3652,5,3,5,6,18,23,-5,14
Concordia Ch,3652,6,3,2,9,21,26,-5,11
FCSB,3653,1,7,5,2,24,13,11,26
CFR Cluj,3653,2,6,7,1,15,8,7,25
Universitate,3653,3,4,6,4,15,18,-3,18
D Bucuresti,3653,4,3,6,5,18,20,-2,15
FC Botosani,3653,5,3,5,6,6,14,-8,14
Concordia Ch,3653,6,3,3,8,19,24,-5,12
FCSB,3654,1,8,5,1,27,12,15,29
CFR Cluj,3654,2,5,6,3,13,11,2,21
Universitate,3654,3,5,5,4,17,19,-2,20
FC Botosani,3654,4,4,5,5,7,12,-5,17
D Bucuresti,3654,5,3,5,6,16,20,-4,14
Concordia Ch,3654,6,2,4,8,15,21,-6,10
FCSB,3655,1,9,5,0,28,12,16,32
CFR Cluj,3655,2,6,6,2,16,9,7,24
FC Botosani,3655,3,4,5,5,9,14,-5,17
D Bucuresti,3655,4,3,6,5,20,22,-2,15
Universitate,3655,5,3,5,6,16,24,-8,14
Concordia Ch,3655,6,2,3,9,19,27,-8,9
FCSB,3656,1,9,5,0,30,13,17,32
CFR Cluj,3656,2,5,7,2,14,10,4,22
D Bucuresti,3656,3,4,4,6,21,20,1,16
FC Botosani,3656,4,4,4,6,7,17,-10,16
Universitate,3656,5,3,6,5,16,22,-6,15
Concordia Ch,3656,6,3,2,9,17,23,-6,11
FCSB,3657,1,8,5,1,27,13,14,29
CFR Cluj,3657,2,6,7,1,16,9,7,25
FC Botosani,3657,3,4,5,5,7,13,-6,17
Universitate,3657,4,3,6,5,16,22,-6,15
D Bucuresti,3657,5,3,5,6,17,21,-4,14
Concordia Ch,3657,6,3,2,9,19,24,-5,11
FCSB,3658,1,8,5,1,26,12,14,29
CFR Cluj,3658,2,6,6,2,14,10,4,24
Universitate,3658,3,4,5,5,16,19,-3,17
D Bucuresti,3658,4,3,5,6,17,20,-3,14
Concordia Ch,3658,5,4,2,8,20,24,-4,14
FC Botosani,3658,6,3,5,6,7,15,-8,14
FCSB,3659,1,8,5,1,26,11,15,29
CFR Cluj,3659,2,6,6,2,16,10,6,24
D Bucuresti,3659,3,4,5,5,20,21,-1,17
Universitate,3659,4,4,5,5,15,21,-6,17
FC Botosani,3659,5,3,5,6,5,13,-8,14
Concordia Ch,3659,6,2,4,8,18,24,-6,10
FCSB,3660,1,7,7,0,25,12,13,28
CFR Cluj,3660,2,6,7,1,16,9,7,25
D Bucuresti,3660,3,4,5,5,19,18,1,17
FC Botosani,3660,4,4,5,5,6,12,-6,17
Universitate,3660,5,3,6,5,16,21,-5,15
Concordia Ch,3660,6,2,2,10,15,25,-10,8
FCSB,3661,1,7,5,2,23,14,9,26
CFR Cluj,3661,2,6,7,1,15,7,8,25
Universitate,3661,3,4,6,4,16,18,-2,18
D Bucuresti,3661,4,4,5,5,20,19,1,17
FC Botosani,3661,5,4,5,5,12,14,-2,17
Concordia Ch,3661,6,2,2,10,16,30,-14,8
FCSB,3662,1,8,5,1,28,15,13,29
CFR Cluj,3662,2,5,6,3,15,14,1,21
Universitate,3662,3,5,5,4,19,18,1,20
D Bucuresti,3662,4,4,5,5,17,18,-1,17
FC Botosani,3662,5,3,5,6,5,14,-9,14
Concordia Ch,3662,6,3,2,9,17,22,-5,11
FCSB,3663,1,7,5,2,24,13,11,26
CFR Cluj,3663,2,6,7,1,14,7,7,25
Universitate,3663,3,4,6,4,16,19,-3,18
D Bucuresti,3663,4,4,4,6,20,24,-4,16
Concordia Ch,3663,5,4,2,8,23,25,-2,14
FC Botosani,3663,6,3,4,7,8,17,-9,13
FCSB,3664,1,8,5,1,24,12,12,29
CFR Cluj,3664,2,5,6,3,14,10,4,21
Universitate,3664,3,5,5,4,18,19,-1,20
D Bucuresti,3664,4,5,4,5,20,19,1,19
FC Botosani,3664,5,3,4,7,6,16,-10,13
Concordia Ch,3664,6,3,2,9,17,23,-6,11
FCSB,3665,1,7,6,1,25,13,12,27
CFR Cluj,3665,2,6,7,1,15,7,8,25
Universitate,3665,3,4,5,5,17,22,-5,17
D Bucuresti,3665,4,4,4,6,18,19,-1,16
FC Botosani,3665,5,4,4,6,6,14,-8,16
Concordia Ch,3665,6,3,2,9,17,23,-6,11
FCSB,3666,1,8,6,0,26,12,14,30
CFR Cluj,3666,2,6,7,1,15,7,8,25
D Bucuresti,3666,3,3,6,5,17,19,-2,15
FC Botosani,3666,4,3,6,5,6,13,-7,15
Universitate,3666,5,3,5,6,16,23,-7,14
Concordia Ch,3666,6,2,4,8,17,23,-6,10
FCSB,3667,1,8,5,1,24,13,11,29
CFR Cluj,3667,2,5,7,2,16,11,5,22
Universitate,3667,3,4,6,4,20,21,-1,18
D Bucuresti,3667,4,3,6,5,20,22,-2,15
FC Botosani,3667,5,3,6,5,8,15,-7,15
Concordia Ch,3667,6,2,4,8,18,24,-6,10
FCSB,3668,1,8,5,1,27,14,13,29
CFR Cluj,3668,2,7,6,1,16,8,8,27
D Bucuresti,3668,3,4,5,5,18,19,-1,17
Universitate,3668,4,3,5,6,16,22,-6,14
FC Botosani,3668,5,3,5,6,8,16,-8,14
Concordia Ch,3668,6,3,2,9,18,24,-6,11
FCSB,3669,1,9,5,0,28,12,16,32
CFR Cluj,3669,2,6,6,2,16,9,7,24
FC Botosani,3669,3,4,5,5,7,12,-5,17
Universitate,3669,4,3,5,6,17,25,-8,14
D Bucuresti,3669,5,3,4,7,17,22,-5,13
Concordia Ch,3669,6,3,3,8,17,22,-5,12
FCSB,3670,1,9,5,0,27,12,15,32
CFR Cluj,3670,2,5,7,2,15,10,5,22
Universitate,3670,3,3,6,5,16,21,-5,15
FC Botosani,3670,4,3,6,5,8,15,-7,15
D Bucuresti,3670,5,3,5,6,20,23,-3,14
Concordia Ch,3670,6,3,3,8,17,22,-5,12
FCSB,3671,1,8,5,1,25,12,13,29
CFR Cluj,3671,2,6,6,2,15,9,6,24
Universitate,3671,3,4,5,5,15,19,-4,17
FC Botosani,3671,4,4,4,6,8,15,-7,16
Concordia Ch,3671,5,4,2,8,20,23,-3,14
D Bucuresti,3671,6,3,4,7,17,22,-5,13
FCSB,3672,1,8,6,0,29,13,16,30
CFR Cluj,3672,2,6,7,1,19,11,8,25
FC Botosani,3672,3,3,6,5,6,13,-7,15
D Bucuresti,3672,4,3,5,6,16,20,-4,14
Universitate,3672,5,3,5,6,17,26,-9,14
Concordia Ch,3672,6,3,3,8,18,22,-4,12
FCSB,3673,1,8,6,0,26,12,14,30
CFR Cluj,3673,2,6,6,2,15,9,6,24
D Bucuresti,3673,3,4,5,5,17,18,-1,17
Universitate,3673,4,3,6,5,15,20,-5,15
FC Botosani,3673,5,3,6,5,6,13,-7,15
Concordia Ch,3673,6,2,3,9,16,23,-7,9
FCSB,3674,1,8,6,0,25,11,14,30
CFR Cluj,3674,2,6,6,2,15,9,6,24
D Bucuresti,3674,3,5,4,5,18,18,0,19
FC Botosani,3674,4,4,4,6,8,14,-6,16
Universitate,3674,5,3,6,5,16,21,-5,15
Concordia Ch,3674,6,2,2,10,16,25,-9,8
FCSB,3675,1,7,5,2,25,16,9,26
CFR Cluj,3675,2,6,7,1,16,8,8,25
Universitate,3675,3,4,6,4,19,21,-2,18
D Bucuresti,3675,4,4,4,6,19,22,-3,16
FC Botosani,3675,5,3,5,6,7,17,-10,14
Concordia Ch,3675,6,3,3,8,21,23,-2,12
FCSB,3676,1,8,5,1,27,13,14,29
CFR Cluj,3676,2,7,6,1,18,8,10,27
FC Botosani,3676,3,5,4,5,11,14,-3,19
D Bucuresti,3676,4,3,5,6,19,22,-3,14
Universitate,3676,5,3,5,6,15,24,-9,14
Concordia Ch,3676,6,2,3,9,16,25,-9,9
FCSB,3677,1,9,5,0,29,10,19,32
CFR Cluj,3677,2,6,6,2,15,11,4,24
D Bucuresti,3677,3,4,4,6,20,22,-2,16
FC Botosani,3677,4,4,4,6,9,16,-7,16
Universitate,3677,5,3,5,6,15,23,-8,14
Concordia Ch,3677,6,3,2,9,20,26,-6,11
FCSB,3678,1,9,5,0,26,10,16,32
CFR Cluj,3678,2,5,7,2,14,9,5,22
FC Botosani,3678,3,5,4,5,7,12,-5,19
Universitate,3678,4,3,6,5,15,21,-6,15
D Bucuresti,3678,5,3,5,6,17,20,-3,14
Concordia Ch,3678,6,2,3,9,16,23,-7,9
FCSB,3679,1,7,6,1,24,13,11,27
CFR Cluj,3679,2,7,6,1,18,8,10,27
D Bucuresti,3679,3,5,4,5,20,19,1,19
FC Botosani,3679,4,4,4,6,10,14,-4,16
Universitate,3679,5,3,6,5,14,20,-6,15
Concordia Ch,3679,6,2,2,10,15,27,-12,8
FCSB,3680,1,8,6,0,26,12,14,30
CFR Cluj,3680,2,6,7,1,15,8,7,25
D Bucuresti,3680,3,4,5,5,19,20,-1,17
FC Botosani,3680,4,3,6,5,9,16,-7,15
Universitate,3680,5,3,5,6,15,21,-6,14
Concordia Ch,3680,6,2,3,9,17,24,-7,9
FCSB,3681,1,7,6,1,24,12,12,27
CFR Cluj,3681,2,6,7,1,15,8,7,25
Universitate,3681,3,4,5,5,15,19,-4,17
D Bucuresti,3681,4,4,4,6,18,20,-2,16
Concordia Ch,3681,5,4,2,8,19,22,-3,14
FC Botosani,3681,6,3,4,7,5,15,-10,13
FCSB,3682,1,8,5,1,24,11,13,29
CFR Cluj,3682,2,6,6,2,16,8,8,24
Universitate,3682,3,4,5,5,15,21,-6,17
D Bucuresti,3682,4,4,4,6,17,19,-2,16
FC Botosani,3682,5,3,5,6,6,14,-8,14
Concordia Ch,3682,6,3,3,8,17,22,-5,12
FCSB,3683,1,9,5,0,27,11,16,32
CFR Cluj,3683,2,5,6,3,14,11,3,21
D Bucuresti,3683,3,4,5,5,19,20,-1,17
Universitate,3683,4,4,5,5,15,19,-4,17
FC Botosani,3683,5,3,5,6,6,16,-10,14
Concordia Ch,3683,6,3,2,9,19,23,-4,11
FCSB,3684,1,8,6,0,29,12,17,30
CFR Cluj,3684,2,6,7,1,19,9,10,25
FC Botosani,3684,3,5,4,5,9,13,-4,19
Universitate,3684,4,3,5,6,14,26,-12,14
D Bucuresti,3684,5,3,4,7,18,23,-5,13
Concordia Ch,3684,6,3,2,9,18,24,-6,11
FCSB,3685,1,7,5,2,24,15,9,26
CFR Cluj,3685,2,6,7,1,17,8,9,25
Universitate,3685,3,4,6,4,17,20,-3,18
FC Botosani,3685,4,4,5,5,6,12,-6,17
D Bucuresti,3685,5,3,5,6,16,19,-3,14
Concordia Ch,3685,6,2,4,8,15,21,-6,10
FCSB,3686,1,8,6,0,26,11,15,30
CFR Cluj,3686,2,6,6,2,17,10,7,24
D Bucuresti,3686,3,4,4,6,18,20,-2,16
FC Botosani,3686,4,4,4,6,7,14,-7,16
Universitate,3686,5,3,6,5,14,21,-7,15
Concordia Ch,3686,6,3,2,9,18,24,-6,11
CFR Cluj,3687,1,7,6,1,18,8,10,27
FCSB,3687,2,7,5,2,26,15,11,26
D Bucuresti,3687,3,5,4,5,20,19,1,19
Universitate,3687,4,4,5,5,17,23,-6,17
FC Botosani,3687,5,3,5,6,6,15,-9,14
Concordia Ch,3687,6,2,3,9,17,24,-7,9
FCSB,3688,1,8,6,0,25,10,15,30
CFR Cluj,3688,2,5,7,2,13,8,5,22
D Bucuresti,3688,3,5,4,5,20,18,2,19
Universitate,3688,4,4,5,5,15,20,-5,17
FC Botosani,3688,5,3,5,6,5,14,-9,14
Concordia Ch,3688,6,2,3,9,15,23,-8,9
FCSB,3689,1,8,5,1,26,15,11,29
CFR Cluj,3689,2,6,6,2,16,10,6,24
D Bucuresti,3689,3,5,4,5,20,20,0,19
Universitate,3689,4,4,5,5,19,21,-2,17
FC Botosani,3689,5,4,4,6,9,16,-7,16
Concordia Ch,3689,6,2,2,10,16,24,-8,8
FCSB,3690,1,8,6,0,26,12,14,30
CFR Cluj,3690,2,5,7,2,15,10,5,22
FC Botosani,3690,3,4,5,5,6,12,-6,17
Universitate,3690,4,3,7,4,18,22,-4,16
D Bucuresti,3690,5,3,6,5,18,20,-2,15
Concordia Ch,3690,6,2,3,9,17,24,-7,9
FCSB,3691,1,7,6,1,24,14,10,27
CFR Cluj,3691,2,6,7,1,16,8,8,25
FC Botosani,3691,3,5,4,5,8,12,-4,19
Universitate,3691,4,4,5,5,17,20,-3,17
D Bucuresti,3691,5,4,4,6,18,19,-1,16
Concordia Ch,3691,6,2,2,10,15,25,-10,8
FCSB,3692,1,7,6,1,23,11,12,27
CFR Cluj,3692,2,6,6,2,14,8,6,24
Universitate,3692,3,4,6,4,15,18,-3,18
FC Botosani,3692,4,4,5,5,7,13,-6,17
D Bucuresti,3692,5,3,6,5,18,20,-2,15
Concordia Ch,3692,6,2,3,9,18,25,-7,9
FCSB,3693,1,7,7,0,27,14,13,28
CFR Cluj,3693,2,5,7,2,15,10,5,22
Universitate,3693,3,4,6,4,19,22,-3,18
D Bucuresti,3693,4,4,4,6,18,23,-5,16
FC Botosani,3693,5,4,4,6,7,14,-7,16
Concordia Ch,3693,6,3,2,9,20,23,-3,11
FCSB,3694,1,8,6,0,24,10,14,30
CFR Cluj,3694,2,6,7,1,15,8,7,25
FC Botosani,3694,3,3,6,5,5,12,-7,15
D Bucuresti,3694,4,3,5,6,16,21,-5,14
Universitate,3694,5,3,5,6,15,21,-6,14
Concordia Ch,3694,6,3,3,8,18,21,-3,12
FCSB,3695,1,7,7,0,25,12,13,28
CFR Cluj,3695,2,5,7,2,14,9,5,22
Universitate,3695,3,4,6,4,16,19,-3,18
D Bucuresti,3695,4,4,5,5,17,18,-1,17
FC Botosani,3695,5,3,5,6,5,13,-8,14
Concordia Ch,3695,6,3,2,9,16,22,-6,11
FCSB,3696,1,8,6,0,25,11,14,30
CFR Cluj,3696,2,5,7,2,14,9,5,22
FC Botosani,3696,3,5,4,5,8,12,-4,19
Universitate,3696,4,3,7,4,16,20,-4,16
D Bucuresti,3696,5,3,5,6,18,22,-4,14
Concordia Ch,3696,6,2,3,9,17,24,-7,9
FCSB,3697,1,9,5,0,25,10,15,32
CFR Cluj,3697,2,6,6,2,15,9,6,24
D Bucuresti,3697,3,3,6,5,19,21,-2,15
FC Botosani,3697,4,3,6,5,8,15,-7,15
Universitate,3697,5,3,5,6,15,21,-6,14
Concordia Ch,3697,6,2,4,8,15,21,-6,10
FCSB,3698,1,9,5,0,26,10,16,32
CFR Cluj,3698,2,6,6,2,15,10,5,24
D Bucuresti,3698,3,4,5,5,19,19,0,17
Universitate,3698,4,3,5,6,15,21,-6,14
FC Botosani,3698,5,3,5,6,6,15,-9,14
Concordia Ch,3698,6,3,2,9,17,23,-6,11
FCSB,3699,1,8,5,1,25,11,14,29
CFR Cluj,3699,2,6,6,2,14,9,5,24
Universitate,3699,3,4,5,5,15,19,-4,17
FC Botosani,3699,4,4,5,5,8,13,-5,17
D Bucuresti,3699,5,3,5,6,17,22,-5,14
Concordia Ch,3699,6,3,2,9,18,23,-5,11
FCSB,3700,1,8,5,1,25,12,13,29
CFR Cluj,3700,2,5,7,2,13,8,5,22
Universitate,3700,3,4,6,4,16,19,-3,18
D Bucuresti,3700,4,4,4,6,19,22,-3,16
FC Botosani,3700,5,4,4,6,6,13,-7,16
Concordia Ch,3700,6,3,2,9,19,24,-5,11
FCSB,3701,1,9,5,0,28,11,17,32
CFR Cluj,3701,2,6,6,2,16,9,7,24
Concordia Ch,3701,3,4,2,8,20,22,-2,14
D Bucuresti,3701,4,3,5,6,18,22,-4,14
Universitate,3701,5,3,5,6,16,25,-9,14
FC Botosani,3701,6,3,5,6,6,15,-9,14
FCSB,3702,1,7,6,1,24,12,12,27
CFR Cluj,3702,2,6,6,2,15,9,6,24
Universitate,3702,3,4,6,4,17,20,-3,18
FC Botosani,3702,4,4,4,6,9,15,-6,16
Concordia Ch,3702,5,4,2,8,21,23,-2,14
D Bucuresti,3702,6,3,4,7,16,23,-7,13
FCSB,3703,1,7,7,0,23,10,13,28
CFR Cluj,3703,2,6,7,1,15,8,7,25
D Bucuresti,3703,3,4,5,5,22,20,2,17
FC Botosani,3703,4,4,4,6,8,17,-9,16
Universitate,3703,5,3,6,5,15,20,-5,15
Concordia Ch,3703,6,2,3,9,16,24,-8,9
FCSB,3704,1,8,5,1,29,16,13,29
CFR Cluj,3704,2,6,6,2,16,10,6,24
Universitate,3704,3,4,5,5,19,23,-4,17
FC Botosani,3704,4,4,5,5,8,14,-6,17
D Bucuresti,3704,5,3,5,6,19,22,-3,14
Concordia Ch,3704,6,2,4,8,18,24,-6,10
FCSB,3705,1,7,6,1,24,12,12,27
CFR Cluj,3705,2,6,7,1,15,8,7,25
FC Botosani,3705,3,5,4,5,8,13,-5,19
Universitate,3705,4,4,5,5,15,19,-4,17
D Bucuresti,3705,5,3,4,7,17,22,-5,13
Concordia Ch,3705,6,3,2,9,17,22,-5,11
FCSB,3706,1,8,5,1,24,11,13,29
CFR Cluj,3706,2,6,6,2,14,8,6,24
Universitate,3706,3,4,5,5,15,19,-4,17
D Bucuresti,3706,4,4,4,6,17,20,-3,16
Concordia Ch,3706,5,4,2,8,18,21,-3,14
FC Botosani,3706,6,3,4,7,5,14,-9,13
FCSB,3707,1,7,6,1,24,12,12,27
CFR Cluj,3707,2,7,6,1,16,8,8,27
FC Botosani,3707,3,4,4,6,6,15,-9,16
Universitate,3707,4,3,6,5,16,21,-5,15
Concordia Ch,3707,5,4,2,8,21,22,-1,14
D Bucuresti,3707,6,3,4,7,17,22,-5,13
FCSB,3708,1,7,6,1,23,11,12,27
CFR Cluj,3708,2,6,7,1,15,7,8,25
Universitate,3708,3,4,5,5,15,20,-5,17
D Bucuresti,3708,4,4,4,6,18,22,-4,16
Concordia Ch,3708,5,4,2,8,21,22,-1,14
FC Botosani,3708,6,3,4,7,5,15,-10,13
FCSB,3709,1,9,5,0,26,11,15,32
CFR Cluj,3709,2,6,6,2,16,8,8,24
D Bucuresti,3709,3,4,4,6,19,20,-1,16
Concordia Ch,3709,4,4,2,8,19,22,-3,14
Universitate,3709,5,3,5,6,15,23,-8,14
FC Botosani,3709,6,3,4,7,5,16,-11,13
FCSB,3710,1,8,6,0,25,10,15,30
CFR Cluj,3710,2,6,6,2,14,9,5,24
D Bucuresti,3710,3,3,6,5,19,21,-2,15
Universitate,3710,4,3,6,5,14,19,-5,15
FC Botosani,3710,5,3,6,5,6,13,-7,15
Concordia Ch,3710,6,2,4,8,17,23,-6,10
FCSB,3711,1,8,5,1,25,12,13,29
CFR Cluj,3711,2,5,7,2,13,8,5,22
Universitate,3711,3,4,6,4,16,19,-3,18
D Bucuresti,3711,4,4,4,6,18,19,-1,16
FC Botosani,3711,5,3,5,6,6,15,-9,14
Concordia Ch,3711,6,3,3,8,17,22,-5,12
FCSB,3712,1,7,6,1,24,12,12,27
CFR Cluj,3712,2,6,6,2,15,9,6,24
Universitate,3712,3,4,6,4,15,18,-3,18
D Bucuresti,3712,4,3,6,5,19,21,-2,15
FC Botosani,3712,5,3,6,5,8,15,-7,15
Concordia Ch,3712,6,2,4,8,19,25,-6,10
FCSB,3713,1,9,5,0,26,11,15,32
CFR Cluj,3713,2,5,7,2,13,8,5,22
Universitate,3713,3,3,6,5,15,20,-5,15
D Bucuresti,3713,4,3,5,6,18,21,-3,14
Concordia Ch,3713,5,4,2,8,20,24,-4,14
FC Botosani,3713,6,3,5,6,6,14,-8,14
FCSB,3714,1,8,6,0,26,12,14,30
CFR Cluj,3714,2,5,7,2,13,8,5,22
D Bucuresti,3714,3,4,5,5,19,20,-1,17
Universitate,3714,4,3,7,4,16,20,-4,16
FC Botosani,3714,5,3,5,6,8,16,-8,14
Concordia Ch,3714,6,3,2,9,19,25,-6,11
FCSB,3715,1,8,6,0,24,10,14,30
CFR Cluj,3715,2,5,7,2,13,8,5,22
Universitate,3715,3,4,5,5,15,19,-4,17
FC Botosani,3715,4,4,5,5,9,13,-4,17
D Bucuresti,3715,5,3,6,5,17,19,-2,15
Concordia Ch,3715,6,2,3,9,15,24,-9,9
FCSB,3716,1,7,6,1,24,13,11,27
CFR Cluj,3716,2,5,7,2,14,9,5,22
Universitate,3716,3,5,5,4,17,18,-1,20
D Bucuresti,3716,4,4,5,5,19,20,-1,17
FC Botosani,3716,5,4,5,5,9,14,-5,17
Concordia Ch,3716,6,2,2,10,17,26,-9,8
FCSB,3717,1,7,7,0,24,11,13,28
CFR Cluj,3717,2,6,7,1,14,7,7,25
FC Botosani,3717,3,5,4,5,7,12,-5,19
Universitate,3717,4,3,6,5,15,20,-5,15
D Bucuresti,3717,5,3,4,7,17,23,-6,13
Concordia Ch,3717,6,3,2,9,19,23,-4,11
FCSB,3718,1,7,5,2,24,14,10,26
CFR Cluj,3718,2,6,7,1,17,9,8,25
D Bucuresti,3718,3,5,4,5,20,19,1,19
Universitate,3718,4,4,6,4,16,19,-3,18
FC Botosani,3718,5,4,4,6,9,16,-7,16
Concordia Ch,3718,6,2,2,10,16,25,-9,8
FCSB,3719,1,7,7,0,26,13,13,28
CFR Cluj,3719,2,6,7,1,16,9,7,25
D Bucuresti,3719,3,4,4,6,20,20,0,16
Universitate,3719,4,3,6,5,17,22,-5,15
FC Botosani,3719,5,3,5,6,5,15,-10,14
Concordia Ch,3719,6,3,3,8,17,22,-5,12
FCSB,3720,1,8,6,0,25,10,15,30
CFR Cluj,3720,2,6,6,2,16,11,5,24
FC Botosani,3720,3,4,5,5,6,12,-6,17
Universitate,3720,4,3,6,5,16,21,-5,15
D Bucuresti,3720,5,3,5,6,16,19,-3,14
Concordia Ch,3720,6,2,4,8,15,21,-6,10
FCSB,3721,1,8,6,0,28,14,14,30
CFR Cluj,3721,2,5,7,2,15,10,5,22
FC Botosani,3721,3,4,5,5,6,12,-6,17
Universitate,3721,4,3,7,4,18,22,-4,16
D Bucuresti,3721,5,3,4,7,17,22,-5,13
Concordia Ch,3721,6,3,3,8,18,22,-4,12
FCSB,3722,1,7,6,1,24,13,11,27
CFR Cluj,3722,2,6,7,1,17,9,8,25
D Bucuresti,3722,3,5,4,5,19,19,0,19
Universitate,3722,4,4,5,5,17,21,-4,17
FC Botosani,3722,5,3,4,7,6,16,-10,13
Concordia Ch,3722,6,3,2,9,17,22,-5,11
FCSB,3723,1,9,5,0,28,13,15,32
CFR Cluj,3723,2,6,6,2,16,10,6,24
FC Botosani,3723,3,4,4,6,7,13,-6,16
Concordia Ch,3723,4,4,2,8,19,23,-4,14
Universitate,3723,5,3,5,6,17,23,-6,14
D Bucuresti,3723,6,3,4,7,18,23,-5,13
FCSB,3724,1,8,5,1,25,12,13,29
CFR Cluj,3724,2,6,6,2,14,9,5,24
FC Botosani,3724,3,5,4,5,9,12,-3,19
Universitate,3724,4,4,5,5,16,19,-3,17
D Bucuresti,3724,5,3,4,7,16,21,-5,13
Concordia Ch,3724,6,3,2,9,17,24,-7,11
FCSB,3725,1,9,5,0,26,11,15,32
CFR Cluj,3725,2,6,6,2,15,9,6,24
FC Botosani,3725,3,4,5,5,6,12,-6,17
Universitate,3725,4,3,5,6,16,22,-6,14
D Bucuresti,3725,5,3,4,7,16,20,-4,13
Concordia Ch,3725,6,3,3,8,16,21,-5,12
CFR Cluj,3726,1,7,6,1,19,7,12,27
FCSB,3726,2,7,5,2,23,15,8,26
D Bucuresti,3726,3,5,4,5,22,19,3,19
Universitate,3726,4,4,5,5,16,21,-5,17
FC Botosani,3726,5,3,5,6,5,15,-10,14
Concordia Ch,3726,6,2,3,9,16,24,-8,9
FCSB,3727,1,9,5,0,29,11,18,32
CFR Cluj,3727,2,5,6,3,14,12,2,21
Universitate,3727,3,4,5,5,17,22,-5,17
FC Botosani,3727,4,3,6,5,6,13,-7,15
D Bucuresti,3727,5,3,5,6,16,19,-3,14
Concordia Ch,3727,6,3,3,8,17,22,-5,12
FCSB,3728,1,7,7,0,25,12,13,28
CFR Cluj,3728,2,5,8,1,15,9,6,23
FC Botosani,3728,3,4,5,5,6,12,-6,17
Universitate,3728,4,3,7,4,16,20,-4,16
D Bucuresti,3728,5,3,6,5,17,19,-2,15
Concordia Ch,3728,6,2,3,9,16,23,-7,9
FCSB,3729,1,7,6,1,27,15,12,27
CFR Cluj,3729,2,5,8,1,15,9,6,23
Universitate,3729,3,4,6,4,17,20,-3,18
D Bucuresti,3729,4,3,6,5,16,18,-2,15
FC Botosani,3729,5,3,6,5,5,12,-7,15
Concordia Ch,3729,6,2,4,8,15,21,-6,10
FCSB,3730,1,8,6,0,27,12,15,30
CFR Cluj,3730,2,6,7,1,15,8,7,25
FC Botosani,3730,3,3,6,5,5,12,-7,15
D Bucuresti,3730,4,3,5,6,18,21,-3,14
Universitate,3730,5,3,5,6,15,22,-7,14
Concordia Ch,3730,6,3,3,8,18,23,-5,12
FCSB,3731,1,8,6,0,28,13,15,30
CFR Cluj,3731,2,5,7,2,15,11,4,22
D Bucuresti,3731,3,4,5,5,19,20,-1,17
FC Botosani,3731,4,4,5,5,10,14,-4,17
Universitate,3731,5,3,7,4,17,21,-4,16
Concordia Ch,3731,6,2,2,10,17,27,-10,8
FCSB,3732,1,8,6,0,26,12,14,30
CFR Cluj,3732,2,5,7,2,13,8,5,22
D Bucuresti,3732,3,5,4,5,23,18,5,19
Universitate,3732,4,3,7,4,16,20,-4,16
FC Botosani,3732,5,3,4,7,5,18,-13,13
Concordia Ch,3732,6,3,2,9,16,23,-7,11
FCSB,3733,1,8,5,1,25,12,13,29
CFR Cluj,3733,2,5,7,2,15,11,4,22
D Bucuresti,3733,3,5,4,5,19,18,1,19
Universitate,3733,4,4,6,4,18,20,-2,18
FC Botosani,3733,5,3,4,7,5,15,-10,13
Concordia Ch,3733,6,3,2,9,16,22,-6,11
FCSB,3734,1,9,5,0,27,11,16,32
CFR Cluj,3734,2,6,6,2,15,8,7,24
D Bucuresti,3734,3,4,4,6,17,19,-2,16
FC Botosani,3734,4,4,4,6,6,14,-8,16
Universitate,3734,5,3,5,6,15,23,-8,14
Concordia Ch,3734,6,3,2,9,17,22,-5,11
FCSB,3735,1,9,5,0,28,10,18,32
CFR Cluj,3735,2,5,6,3,13,12,1,21
FC Botosani,3735,3,5,4,5,9,13,-4,19
Universitate,3735,4,4,5,5,15,19,-4,17
D Bucuresti,3735,5,3,5,6,18,21,-3,14
Concordia Ch,3735,6,2,3,9,18,26,-8,9
FCSB,3736,1,8,6,0,26,11,15,30
CFR Cluj,3736,2,6,6,2,15,9,6,24
FC Botosani,3736,3,4,5,5,8,14,-6,17
Universitate,3736,4,3,6,5,15,21,-6,15
D Bucuresti,3736,5,3,5,6,18,21,-3,14
Concordia Ch,3736,6,2,4,8,19,25,-6,10
FCSB,3737,1,8,5,1,24,11,13,29
CFR Cluj,3737,2,7,6,1,16,7,9,27
D Bucuresti,3737,3,4,4,6,18,20,-2,16
FC Botosani,3737,4,4,4,6,7,14,-7,16
Universitate,3737,5,3,5,6,14,21,-7,14
Concordia Ch,3737,6,3,2,9,17,23,-6,11
FCSB,3738,1,7,5,2,24,14,10,26
CFR Cluj,3738,2,6,7,1,17,10,7,25
Universitate,3738,3,4,6,4,18,20,-2,18
D Bucuresti,3738,4,4,4,6,19,21,-2,16
FC Botosani,3738,5,4,4,6,8,15,-7,16
Concordia Ch,3738,6,3,2,9,20,26,-6,11
FCSB,3739,1,9,5,0,26,11,15,32
CFR Cluj,3739,2,6,6,2,16,9,7,24
FC Botosani,3739,3,4,5,5,11,15,-4,17
Universitate,3739,4,3,5,6,14,21,-7,14
D Bucuresti,3739,5,3,4,7,17,24,-7,13
Concordia Ch,3739,6,3,3,8,19,23,-4,12
FCSB,3740,1,7,6,1,25,13,12,27
CFR Cluj,3740,2,5,8,1,14,8,6,23
Universitate,3740,3,4,6,4,18,21,-3,18
Concordia Ch,3740,4,4,2,8,19,21,-2,14
D Bucuresti,3740,5,3,5,6,17,22,-5,14
FC Botosani,3740,6,3,5,6,6,14,-8,14
FCSB,3741,1,7,6,1,23,12,11,27
CFR Cluj,3741,2,7,6,1,16,7,9,27
D Bucuresti,3741,3,5,4,5,24,19,5,19
Universitate,3741,4,3,6,5,14,19,-5,15
FC Botosani,3741,5,3,5,6,8,20,-12,14
Concordia Ch,3741,6,2,3,9,17,25,-8,9
FCSB,3742,1,8,5,1,26,13,13,29
CFR Cluj,3742,2,5,7,2,15,10,5,22
FC Botosani,3742,3,5,4,5,10,14,-4,19
Universitate,3742,4,4,6,4,17,20,-3,18
D Bucuresti,3742,5,3,4,7,19,24,-5,13
Concordia Ch,3742,6,3,2,9,20,26,-6,11
FCSB,3743,1,8,6,0,25,11,14,30
CFR Cluj,3743,2,6,7,1,14,7,7,25
FC Botosani,3743,3,3,6,5,6,13,-7,15
D Bucuresti,3743,4,3,5,6,17,20,-3,14
Universitate,3743,5,3,5,6,15,21,-6,14
Concordia Ch,3743,6,3,3,8,18,23,-5,12
CFR Cluj,3744,1,7,6,1,15,7,8,27
FCSB,3744,2,7,5,2,24,13,11,26
Universitate,3744,3,4,5,5,16,20,-4,17
FC Botosani,3744,4,4,4,6,8,15,-7,16
Concordia Ch,3744,5,4,2,8,19,21,-2,14
D Bucuresti,3744,6,3,4,7,18,24,-6,13
FCSB,3745,1,9,5,0,29,14,15,32
CFR Cluj,3745,2,5,6,3,16,13,3,21
D Bucuresti,3745,3,4,5,5,19,18,1,17
Universitate,3745,4,4,5,5,17,20,-3,17
FC Botosani,3745,5,3,6,5,6,13,-7,15
Concordia Ch,3745,6,2,3,9,16,25,-9,9
FCSB,3746,1,8,5,1,28,12,16,29
CFR Cluj,3746,2,7,6,1,16,7,9,27
D Bucuresti,3746,3,4,5,5,21,21,0,17
Universitate,3746,4,3,5,6,15,25,-10,14
FC Botosani,3746,5,3,4,7,6,16,-10,13
Concordia Ch,3746,6,3,3,8,18,23,-5,12
FCSB,3747,1,9,5,0,27,10,17,32
CFR Cluj,3747,2,6,6,2,18,10,8,24
D Bucuresti,3747,3,5,4,5,20,19,1,19
FC Botosani,3747,4,3,5,6,5,13,-8,14
Universitate,3747,5,3,5,6,15,25,-10,14
Concordia Ch,3747,6,2,3,9,16,24,-8,9
FCSB,3748,1,8,5,1,24,12,12,29
CFR Cluj,3748,2,6,6,2,15,8,7,24
FC Botosani,3748,3,5,4,5,8,12,-4,19
Universitate,3748,4,4,5,5,16,20,-4,17
D Bucuresti,3748,5,3,4,7,16,20,-4,13
Concordia Ch,3748,6,3,2,9,16,23,-7,11
FCSB,3749,1,8,6,0,27,12,15,30
CFR Cluj,3749,2,5,6,3,14,11,3,21
D Bucuresti,3749,3,5,4,5,20,19,1,19
Universitate,3749,4,4,6,4,16,19,-3,18
FC Botosani,3749,5,4,4,6,7,14,-7,16
Concordia Ch,3749,6,2,2,10,17,26,-9,8
FCSB,3750,1,8,6,0,26,12,14,30
CFR Cluj,3750,2,6,7,1,16,8,8,25
D Bucuresti,3750,3,4,4,6,19,20,-1,16
Concordia Ch,3750,4,4,2,8,19,23,-4,14
Universitate,3750,5,3,5,6,17,24,-7,14
FC Botosani,3750,6,3,4,7,6,16,-10,13
FCSB,3751,1,8,6,0,25,11,14,30
CFR Cluj,3751,2,6,6,2,15,9,6,24
Universitate,3751,3,3,6,5,16,21,-5,15
Concordia Ch,3751,4,4,2,8,20,22,-2,14
D Bucuresti,3751,5,3,5,6,19,23,-4,14
FC Botosani,3751,6,3,5,6,7,16,-9,14
FCSB,3752,1,9,5,0,26,10,16,32
CFR Cluj,3752,2,6,6,2,17,9,8,24
D Bucuresti,3752,3,4,5,5,18,18,0,17
Universitate,3752,4,3,5,6,14,23,-9,14
FC Botosani,3752,5,3,5,6,5,14,-9,14
Concordia Ch,3752,6,2,4,8,15,21,-6,10
FCSB,3753,1,7,6,1,24,12,12,27
CFR Cluj,3753,2,7,6,1,16,8,8,27
Universitate,3753,3,3,6,5,16,21,-5,15
D Bucuresti,3753,4,3,5,6,17,20,-3,14
Concordia Ch,3753,5,4,2,8,20,24,-4,14
FC Botosani,3753,6,3,5,6,7,15,-8,14
FCSB,3754,1,7,6,1,26,14,12,27
CFR Cluj,3754,2,5,8,1,16,10,6,23
Universitate,3754,3,4,6,4,17,20,-3,18
D Bucuresti,3754,4,4,4,6,19,20,-1,16
FC Botosani,3754,5,4,4,6,6,14,-8,16
Concordia Ch,3754,6,3,2,9,17,23,-6,11
FCSB,3755,1,7,6,1,24,12,12,27
CFR Cluj,3755,2,5,7,2,14,9,5,22
Universitate,3755,3,5,5,4,16,18,-2,20
D Bucuresti,3755,4,4,5,5,19,20,-1,17
FC Botosani,3755,5,4,5,5,8,13,-5,17
Concordia Ch,3755,6,2,2,10,16,25,-9,8
FCSB,3756,1,8,5,1,26,12,14,29
CFR Cluj,3756,2,5,6,3,14,12,2,21
Universitate,3756,3,5,5,4,18,19,-1,20
D Bucuresti,3756,4,4,5,5,19,20,-1,17
FC Botosani,3756,5,3,6,5,7,14,-7,15
Concordia Ch,3756,6,2,3,9,17,24,-7,9
FCSB,3757,1,8,5,1,25,14,11,29
CFR Cluj,3757,2,6,6,2,17,11,6,24
D Bucuresti,3757,3,5,4,5,22,19,3,19
Universitate,3757,4,4,5,5,19,21,-2,17
FC Botosani,3757,5,3,5,6,5,15,-10,14
Concordia Ch,3757,6,2,3,9,16,24,-8,9
FCSB,3758,1,8,6,0,25,10,15,30
CFR Cluj,3758,2,6,7,1,14,7,7,25
FC Botosani,3758,3,5,4,5,8,13,-5,19
D Bucuresti,3758,4,4,4,6,19,21,-2,16
Universitate,3758,5,3,5,6,14,21,-7,14
Concordia Ch,3758,6,2,2,10,16,24,-8,8
FCSB,3759,1,8,6,0,26,12,14,30
CFR Cluj,3759,2,5,7,2,15,10,5,22
FC Botosani,3759,3,5,4,5,8,13,-5,19
D Bucuresti,3759,4,4,4,6,18,20,-2,16
Universitate,3759,5,3,7,4,16,20,-4,16
Concordia Ch,3759,6,2,2,10,17,25,-8,8
FCSB,3760,1,8,6,0,26,12,14,30
CFR Cluj,3760,2,5,8,1,16,10,6,23
FC Botosani,3760,3,4,5,5,7,12,-5,17
Universitate,3760,4,3,6,5,15,20,-5,15
D Bucuresti,3760,5,3,4,7,16,21,-5,13
Concordia Ch,3760,6,3,3,8,16,21,-5,12
FCSB,3761,1,9,5,0,25,10,15,32
CFR Cluj,3761,2,6,6,2,16,8,8,24
FC Botosani,3761,3,4,4,6,8,17,-9,16
D Bucuresti,3761,4,3,5,6,17,21,-4,14
Universitate,3761,5,3,5,6,14,22,-8,14
Concordia Ch,3761,6,3,3,8,19,21,-2,12
FCSB,3762,1,8,5,1,28,15,13,29
CFR Cluj,3762,2,5,6,3,14,14,0,21
Universitate,3762,3,5,5,4,22,20,2,20
D Bucuresti,3762,4,4,5,5,18,19,-1,17
FC Botosani,3762,5,4,5,5,8,14,-6,17
Concordia Ch,3762,6,2,2,10,18,26,-8,8
FCSB,3763,1,8,5,1,27,12,15,29
CFR Cluj,3763,2,6,6,2,17,11,6,24
D Bucuresti,3763,3,4,5,5,18,19,-1,17
Universitate,3763,4,4,5,5,15,21,-6,17
FC Botosani,3763,5,4,4,6,8,14,-6,16
Concordia Ch,3763,6,2,3,9,17,25,-8,9
FCSB,3764,1,8,6,0,26,11,15,30
CFR Cluj,3764,2,5,7,2,14,10,4,22
Universitate,3764,3,3,7,4,16,20,-4,16
FC Botosani,3764,4,3,6,5,8,15,-7,15
D Bucuresti,3764,5,3,5,6,18,21,-3,14
Concordia Ch,3764,6,3,3,8,17,22,-5,12
FCSB,3765,1,9,5,0,26,11,15,32
CFR Cluj,3765,2,6,6,2,15,8,7,24
D Bucuresti,3765,3,4,4,6,17,19,-2,16
FC Botosani,3765,4,4,4,6,6,13,-7,16
Universitate,3765,5,3,5,6,15,22,-7,14
Concordia Ch,3765,6,3,2,9,16,22,-6,11
FCSB,3766,1,8,6,0,27,13,14,30
CFR Cluj,3766,2,5,7,2,16,11,5,22
D Bucuresti,3766,3,4,5,5,19,20,-1,17
Universitate,3766,4,4,5,5,17,21,-4,17
FC Botosani,3766,5,4,4,6,7,14,-7,16
Concordia Ch,3766,6,2,3,9,16,23,-7,9
FCSB,3767,1,8,6,0,26,12,14,30
CFR Cluj,3767,2,6,7,1,14,7,7,25
D Bucuresti,3767,3,5,4,5,21,19,2,19
Universitate,3767,4,3,5,6,16,22,-6,14
FC Botosani,3767,5,3,4,7,7,17,-10,13
Concordia Ch,3767,6,3,2,9,17,24,-7,11
CFR Cluj,3768,1,7,6,1,19,8,11,27
FCSB,3768,2,7,5,2,25,16,9,26
D Bucuresti,3768,3,4,5,5,17,18,-1,17
Universitate,3768,4,4,5,5,17,22,-5,17
FC Botosani,3768,5,3,4,7,6,15,-9,13
Concordia Ch,3768,6,3,3,8,17,22,-5,12
FCSB,3769,1,8,6,0,26,11,15,30
CFR Cluj,3769,2,6,6,2,17,10,7,24
FC Botosani,3769,3,4,5,5,8,13,-5,17
Universitate,3769,4,3,6,5,16,23,-7,15
D Bucuresti,3769,5,3,5,6,17,20,-3,14
Concordia Ch,3769,6,3,2,9,16,23,-7,11
FCSB,3770,1,9,5,0,30,12,18,32
CFR Cluj,3770,2,6,6,2,15,11,4,24
D Bucuresti,3770,3,5,4,5,21,19,2,19
FC Botosani,3770,4,4,4,6,7,15,-8,16
Universitate,3770,5,3,5,6,15,22,-7,14
Concordia Ch,3770,6,2,2,10,15,24,-9,8
FCSB,3771,1,8,6,0,27,11,16,30
CFR Cluj,3771,2,5,8,1,14,8,6,23
D Bucuresti,3771,3,4,4,6,18,20,-2,16
Universitate,3771,4,3,6,5,14,21,-7,15
Concordia Ch,3771,5,4,2,8,19,22,-3,14
FC Botosani,3771,6,3,4,7,6,16,-10,13
FCSB,3772,1,9,5,0,28,10,18,32
CFR Cluj,3772,2,6,6,2,16,9,7,24
D Bucuresti,3772,3,3,6,5,17,19,-2,15
FC Botosani,3772,4,3,6,5,6,13,-7,15
Universitate,3772,5,3,5,6,14,24,-10,14
Concordia Ch,3772,6,2,4,8,17,23,-6,10
FCSB,3773,1,8,5,1,26,14,12,29
CFR Cluj,3773,2,7,6,1,16,7,9,27
D Bucuresti,3773,3,4,4,6,19,21,-2,16
Universitate,3773,4,3,5,6,16,22,-6,14
FC Botosani,3773,5,3,5,6,6,14,-8,14
Concordia Ch,3773,6,3,3,8,19,24,-5,12
FCSB,3774,1,9,5,0,27,12,15,32
CFR Cluj,3774,2,5,6,3,14,10,4,21
FC Botosani,3774,3,5,4,5,9,12,-3,19
Universitate,3774,4,4,5,5,16,20,-4,17
D Bucuresti,3774,5,3,4,7,16,20,-4,13
Concordia Ch,3774,6,3,2,9,16,24,-8,11
FCSB,3775,1,9,5,0,29,11,18,32
CFR Cluj,3775,2,5,7,2,14,11,3,22
D Bucuresti,3775,3,4,5,5,19,19,0,17
Universitate,3775,4,3,6,5,14,20,-6,15
FC Botosani,3775,5,3,6,5,6,13,-7,15
Concordia Ch,3775,6,2,3,9,15,23,-8,9
CFR Cluj,3776,1,7,6,1,15,7,8,27
FCSB,3776,2,7,5,2,23,12,11,26
Universitate,3776,3,4,5,5,15,19,-4,17
D Bucuresti,3776,4,4,4,6,18,19,-1,16
FC Botosani,3776,5,4,4,6,7,15,-8,16
Concordia Ch,3776,6,3,2,9,17,23,-6,11
FCSB,3777,1,7,6,1,24,13,11,27
CFR Cluj,3777,2,5,8,1,14,8,6,23
Universitate,3777,3,4,6,4,16,18,-2,18
D Bucuresti,3777,4,3,6,5,17,19,-2,15
FC Botosani,3777,5,3,5,6,5,13,-8,14
Concordia Ch,3777,6,3,3,8,17,22,-5,12
FCSB,3778,1,7,6,1,25,13,12,27
CFR Cluj,3778,2,5,8,1,15,9,6,23
Universitate,3778,3,4,6,4,15,18,-3,18
FC Botosani,3778,4,4,5,5,7,13,-6,17
D Bucuresti,3778,5,3,4,7,17,21,-4,13
Concordia Ch,3778,6,3,3,8,18,23,-5,12
FCSB,3779,1,8,5,1,26,12,14,29
CFR Cluj,3779,2,6,7,1,17,10,7,25
FC Botosani,3779,3,4,4,6,7,14,-7,16
Universitate,3779,4,3,6,5,16,22,-6,15
Concordia Ch,3779,5,4,2,8,18,22,-4,14
D Bucuresti,3779,6,3,4,7,16,20,-4,13
FCSB,3780,1,8,6,0,25,11,14,30
CFR Cluj,3780,2,6,7,1,16,8,8,25
FC Botosani,3780,3,4,5,5,6,12,-6,17
D Bucuresti,3780,4,3,6,5,17,19,-2,15
Universitate,3780,5,3,5,6,14,21,-7,14
Concordia Ch,3780,6,2,3,9,16,23,-7,9
CFR Cluj,3781,1,7,6,1,19,8,11,27
FCSB,3781,2,7,6,1,23,14,9,27
FC Botosani,3781,3,5,4,5,10,15,-5,19
D Bucuresti,3781,4,4,4,6,19,21,-2,16
Universitate,3781,5,3,6,5,15,20,-5,15
Concordia Ch,3781,6,2,2,10,18,26,-8,8
FCSB,3782,1,8,5,1,24,11,13,29
CFR Cluj,3782,2,7,6,1,16,8,8,27
D Bucuresti,3782,3,4,4,6,17,21,-4,16
Concordia Ch,3782,4,4,2,8,19,21,-2,14
Universitate,3782,5,3,5,6,15,21,-6,14
FC Botosani,3782,6,3,4,7,5,14,-9,13
FCSB,3783,1,8,5,1,25,12,13,29
CFR Cluj,3783,2,7,6,1,17,9,8,27
D Bucuresti,3783,3,5,4,5,18,18,0,19
Universitate,3783,4,3,5,6,15,21,-6,14
FC Botosani,3783,5,3,4,7,6,15,-9,13
Concordia Ch,3783,6,3,2,9,17,23,-6,11
FCSB,3784,1,8,6,0,25,11,14,30
CFR Cluj,3784,2,5,7,2,14,9,5,22
Universitate,3784,3,4,5,5,15,19,-4,17
D Bucuresti,3784,4,4,4,6,18,20,-2,16
FC Botosani,3784,5,4,4,6,7,14,-7,16
Concordia Ch,3784,6,3,2,9,16,22,-6,11
FCSB,3785,1,8,6,0,26,11,15,30
CFR Cluj,3785,2,5,6,3,13,13,0,21
Universitate,3785,3,4,6,4,19,19,0,18
FC Botosani,3785,4,4,5,5,8,14,-6,17
D Bucuresti,3785,5,3,5,6,18,22,-4,14
Concordia Ch,3785,6,3,2,9,17,22,-5,11
FCSB,3786,1,8,6,0,27,12,15,30
CFR Cluj,3786,2,6,6,2,16,10,6,24
Universitate,3786,3,3,6,5,15,21,-6,15
D Bucuresti,3786,4,3,5,6,16,19,-3,14
Concordia Ch,3786,5,4,2,8,17,21,-4,14
FC Botosani,3786,6,3,5,6,5,13,-8,14
FCSB,3787,1,8,6,0,25,11,14,30
CFR Cluj,3787,2,5,8,1,14,8,6,23
FC Botosani,3787,3,4,5,5,8,13,-5,17
Universitate,3787,4,3,6,5,14,19,-5,15
D Bucuresti,3787,5,3,5,6,17,21,-4,14
Concordia Ch,3787,6,2,4,8,17,23,-6,10
FCSB,3788,1,7,6,1,27,15,12,27
CFR Cluj,3788,2,7,6,1,16,8,8,27
FC Botosani,3788,3,5,4,5,9,13,-4,19
Universitate,3788,4,3,6,5,17,22,-5,15
D Bucuresti,3788,5,3,5,6,18,21,-3,14
Concordia Ch,3788,6,2,3,9,16,24,-8,9
FCSB,3789,1,8,5,1,28,12,16,29
CFR Cluj,3789,2,6,6,2,15,12,3,24
Universitate,3789,3,4,5,5,15,19,-4,17
FC Botosani,3789,4,4,4,6,7,15,-8,16
D Bucuresti,3789,5,3,5,6,18,21,-3,14
Concordia Ch,3789,6,3,3,8,18,22,-4,12
FCSB,3790,1,9,5,0,26,11,15,32
CFR Cluj,3790,2,6,6,2,16,9,7,24
FC Botosani,3790,3,4,5,5,8,14,-6,17
D Bucuresti,3790,4,3,5,6,19,22,-3,14
Universitate,3790,5,3,5,6,14,21,-7,14
Concordia Ch,3790,6,3,2,9,17,23,-6,11
FCSB,3791,1,8,6,0,24,10,14,30
CFR Cluj,3791,2,5,6,3,14,11,3,21
FC Botosani,3791,3,5,4,5,9,14,-5,19
Universitate,3791,4,4,6,4,17,19,-2,18
D Bucuresti,3791,5,3,5,6,18,21,-3,14
Concordia Ch,3791,6,2,3,9,17,24,-7,9
FCSB,3792,1,7,6,1,25,14,11,27
CFR Cluj,3792,2,6,7,1,18,9,9,25
D Bucuresti,3792,3,4,5,5,20,21,-1,17
Universitate,3792,4,4,5,5,18,23,-5,17
FC Botosani,3792,5,4,4,6,11,15,-4,16
Concordia Ch,3792,6,2,3,9,16,26,-10,9
FCSB,3793,1,7,5,2,23,13,10,26
CFR Cluj,3793,2,6,7,1,16,9,7,25
Universitate,3793,3,4,6,4,18,20,-2,18
FC Botosani,3793,4,4,5,5,9,13,-4,17
D Bucuresti,3793,5,4,4,6,19,23,-4,16
Concordia Ch,3793,6,2,3,9,16,23,-7,9
FCSB,3794,1,8,6,0,24,10,14,30
CFR Cluj,3794,2,5,7,2,14,9,5,22
D Bucuresti,3794,3,5,4,5,20,19,1,19
Universitate,3794,4,4,5,5,16,20,-4,17
FC Botosani,3794,5,3,4,7,6,16,-10,13
Concordia Ch,3794,6,3,2,9,16,22,-6,11
CFR Cluj,3795,1,7,6,1,17,8,9,27
FCSB,3795,2,7,5,2,24,13,11,26
D Bucuresti,3795,3,5,4,5,19,18,1,19
Universitate,3795,4,4,5,5,17,22,-5,17
FC Botosani,3795,5,3,5,6,6,14,-8,14
Concordia Ch,3795,6,2,3,9,16,24,-8,9
FCSB,3796,1,8,5,1,26,14,12,29
CFR Cluj,3796,2,6,6,2,16,10,6,24
Universitate,3796,3,4,5,5,19,22,-3,17
D Bucuresti,3796,4,4,4,6,18,19,-1,16
FC Botosani,3796,5,4,4,6,7,15,-8,16
Concordia Ch,3796,6,3,2,9,17,23,-6,11
FCSB,3797,1,8,6,0,26,11,15,30
CFR Cluj,3797,2,5,7,2,14,10,4,22
D Bucuresti,3797,3,4,5,5,18,19,-1,17
Universitate,3797,4,3,7,4,16,20,-4,16
FC Botosani,3797,5,4,4,6,7,14,-7,16
Concordia Ch,3797,6,2,3,9,15,22,-7,9
FCSB,3798,1,9,5,0,31,13,18,32
CFR Cluj,3798,2,6,6,2,17,12,5,24
D Bucuresti,3798,3,5,4,5,21,19,2,19
FC Botosani,3798,4,4,4,6,10,14,-4,16
Universitate,3798,5,3,5,6,14,22,-8,14
Concordia Ch,3798,6,2,2,10,15,28,-13,8
FCSB,3799,1,9,5,0,27,11,16,32
CFR Cluj,3799,2,6,6,2,18,10,8,24
FC Botosani,3799,3,4,5,5,6,12,-6,17
D Bucuresti,3799,4,3,5,6,16,19,-3,14
Universitate,3799,5,3,5,6,14,23,-9,14
Concordia Ch,3799,6,3,2,9,16,22,-6,11
FCSB,3800,1,9,5,0,27,11,16,32
CFR Cluj,3800,2,5,6,3,13,12,1,21
Universitate,3800,3,4,5,5,18,20,-2,17
FC Botosani,3800,4,3,6,5,8,15,-7,15
D Bucuresti,3800,5,3,5,6,18,23,-5,14
Concordia Ch,3800,6,3,3,8,19,22,-3,12
FCSB,3801,1,8,6,0,24,10,14,30
CFR Cluj,3801,2,6,6,2,15,8,7,24
D Bucuresti,3801,3,4,4,6,18,19,-1,16
Universitate,3801,4,3,6,5,14,20,-6,15
FC Botosani,3801,5,3,5,6,6,15,-9,14
Concordia Ch,3801,6,3,3,8,17,22,-5,12
CFR Cluj,3802,1,7,6,1,15,7,8,27
FCSB,3802,2,7,5,2,23,14,9,26
Universitate,3802,3,4,5,5,17,19,-2,17
D Bucuresti,3802,4,3,6,5,17,19,-2,15
FC Botosani,3802,5,3,6,5,6,13,-7,15
Concordia Ch,3802,6,2,4,8,17,23,-6,10
FCSB,3803,1,9,5,0,30,12,18,32
CFR Cluj,3803,2,6,6,2,15,11,4,24
D Bucuresti,3803,3,3,6,5,19,21,-2,15
FC Botosani,3803,4,3,6,5,6,13,-7,15
Universitate,3803,5,3,5,6,16,23,-7,14
Concordia Ch,3803,6,2,4,8,17,23,-6,10
FCSB,3804,1,8,5,1,27,15,12,29
CFR Cluj,3804,2,5,6,3,14,12,2,21
Universitate,3804,3,5,5,4,20,19,1,20
FC Botosani,3804,4,5,4,5,9,13,-4,19
D Bucuresti,3804,5,3,4,7,18,22,-4,13
Concordia Ch,3804,6,3,2,9,17,24,-7,11
FCSB,3805,1,8,5,1,28,12,16,29
CFR Cluj,3805,2,6,6,2,16,12,4,24
Universitate,3805,3,4,5,5,17,22,-5,17
FC Botosani,3805,4,4,5,5,9,15,-6,17
D Bucuresti,3805,5,3,5,6,17,21,-4,14
Concordia Ch,3805,6,3,2,9,19,24,-5,11
FCSB,3806,1,7,6,1,27,15,12,27
CFR Cluj,3806,2,7,6,1,18,8,10,27
FC Botosani,3806,3,4,5,5,11,15,-4,17
D Bucuresti,3806,4,4,4,6,19,22,-3,16
Universitate,3806,5,3,6,5,17,24,-7,15
Concordia Ch,3806,6,2,3,9,17,25,-8,9
FCSB,3807,1,8,6,0,26,11,15,30
CFR Cluj,3807,2,5,8,1,14,8,6,23
Universitate,3807,3,3,6,5,14,20,-6,15
Concordia Ch,3807,4,4,2,8,20,22,-2,14
D Bucuresti,3807,5,3,5,6,17,20,-3,14
FC Botosani,3807,6,3,5,6,5,15,-10,14
FCSB,3808,1,7,6,1,25,17,8,27
CFR Cluj,3808,2,6,7,1,20,9,11,25
D Bucuresti,3808,3,4,5,5,17,18,-1,17
Universitate,3808,4,4,5,5,19,23,-4,17
FC Botosani,3808,5,3,5,6,5,13,-8,14
Concordia Ch,3808,6,3,2,9,16,22,-6,11
FCSB,3809,1,7,6,1,25,13,12,27
CFR Cluj,3809,2,7,6,1,15,7,8,27
D Bucuresti,3809,3,4,5,5,18,18,0,17
Universitate,3809,4,3,6,5,16,21,-5,15
FC Botosani,3809,5,3,5,6,6,15,-9,14
Concordia Ch,3809,6,2,4,8,16,22,-6,10
FCSB,3810,1,7,7,0,26,13,13,28
CFR Cluj,3810,2,5,8,1,15,9,6,23
FC Botosani,3810,3,5,4,5,8,13,-5,19
Universitate,3810,4,3,7,4,15,19,-4,16
D Bucuresti,3810,5,3,4,7,19,23,-4,13
Concordia Ch,3810,6,3,2,9,18,24,-6,11
FCSB,3811,1,8,6,0,24,10,14,30
CFR Cluj,3811,2,6,6,2,14,8,6,24
D Bucuresti,3811,3,4,4,6,19,21,-2,16
Universitate,3811,4,3,6,5,14,19,-5,15
Concordia Ch,3811,5,4,2,8,19,22,-3,14
FC Botosani,3811,6,3,4,7,5,15,-10,13
FCSB,3812,1,7,5,2,24,13,11,26
CFR Cluj,3812,2,6,6,2,15,10,5,24
Universitate,3812,3,5,5,4,19,20,-1,20
D Bucuresti,3812,4,5,4,5,20,19,1,19
FC Botosani,3812,5,4,4,6,7,14,-7,16
Concordia Ch,3812,6,2,2,10,16,25,-9,8
FCSB,3813,1,8,6,0,27,11,16,30
CFR Cluj,3813,2,5,7,2,14,9,5,22
D Bucuresti,3813,3,4,5,5,20,21,-1,17
Universitate,3813,4,4,5,5,15,21,-6,17
FC Botosani,3813,5,3,6,5,7,14,-7,15
Concordia Ch,3813,6,2,3,9,18,25,-7,9
FCSB,3814,1,9,5,0,28,12,16,32
CFR Cluj,3814,2,5,7,2,14,10,4,22
D Bucuresti,3814,3,4,4,6,20,19,1,16
Universitate,3814,4,3,6,5,15,20,-5,15
FC Botosani,3814,5,3,5,6,8,19,-11,14
Concordia Ch,3814,6,3,3,8,19,24,-5,12
FCSB,3815,1,8,5,1,28,13,15,29
CFR Cluj,3815,2,6,6,2,15,11,4,24
FC Botosani,3815,3,5,4,5,11,13,-2,19
Universitate,3815,4,4,5,5,17,21,-4,17
D Bucuresti,3815,5,3,4,7,18,24,-6,13
Concordia Ch,3815,6,3,2,9,19,26,-7,11
FCSB,3816,1,9,5,0,27,11,16,32
CFR Cluj,3816,2,6,6,2,15,10,5,24
D Bucuresti,3816,3,5,4,5,20,18,2,19
Universitate,3816,4,3,5,6,14,20,-6,14
FC Botosani,3816,5,3,5,6,6,15,-9,14
Concordia Ch,3816,6,2,3,9,16,24,-8,9
FCSB,3817,1,7,6,1,24,12,12,27
CFR Cluj,3817,2,6,7,1,16,9,7,25
FC Botosani,3817,3,4,5,5,8,13,-5,17
Universitate,3817,4,3,7,4,15,19,-4,16
D Bucuresti,3817,5,3,6,5,18,20,-2,15
Concordia Ch,3817,6,2,3,9,16,24,-8,9
FCSB,3818,1,9,5,0,29,12,17,32
CFR Cluj,3818,2,6,6,2,17,12,5,24
D Bucuresti,3818,3,4,5,5,19,20,-1,17
FC Botosani,3818,4,3,6,5,7,14,-7,15
Universitate,3818,5,3,5,6,16,23,-7,14
Concordia Ch,3818,6,2,3,9,15,22,-7,9
FCSB,3819,1,7,6,1,24,15,9,27
CFR Cluj,3819,2,5,8,1,16,10,6,23
FC Botosani,3819,3,5,4,5,8,13,-5,19
Universitate,3819,4,4,6,4,20,20,0,18
D Bucuresti,3819,5,3,4,7,17,22,-5,13
Concordia Ch,3819,6,3,2,9,19,24,-5,11
FCSB,3820,1,8,5,1,24,11,13,29
CFR Cluj,3820,2,5,7,2,14,9,5,22
Universitate,3820,3,4,6,4,16,19,-3,18
D Bucuresti,3820,4,4,5,5,20,19,1,17
FC Botosani,3820,5,4,5,5,9,14,-5,17
Concordia Ch,3820,6,2,2,10,16,27,-11,8
FCSB,3821,1,9,5,0,31,12,19,32
CFR Cluj,3821,2,6,6,2,17,11,6,24
D Bucuresti,3821,3,5,4,5,20,18,2,19
Universitate,3821,4,3,5,6,16,26,-10,14
FC Botosani,3821,5,3,4,7,5,14,-9,13
Concordia Ch,3821,6,3,2,9,16,24,-8,11
CFR Cluj,3822,1,7,6,1,18,8,10,27
FCSB,3822,2,7,5,2,25,19,6,26
D Bucuresti,3822,3,4,5,5,20,20,0,17
Universitate,3822,4,4,5,5,21,22,-1,17
FC Botosani,3822,5,3,6,5,9,16,-7,15
Concordia Ch,3822,6,2,3,9,17,25,-8,9
FCSB,3823,1,8,6,0,28,13,15,30
CFR Cluj,3823,2,6,7,1,15,8,7,25
D Bucuresti,3823,3,4,5,5,23,23,0,17
FC Botosani,3823,4,4,5,5,11,17,-6,17
Universitate,3823,5,3,5,6,16,23,-7,14
Concordia Ch,3823,6,2,2,10,19,28,-9,8
FCSB,3824,1,8,5,1,25,12,13,29
CFR Cluj,3824,2,5,6,3,14,10,4,21
Universitate,3824,3,5,5,4,18,20,-2,20
FC Botosani,3824,4,4,5,5,7,12,-5,17
D Bucuresti,3824,5,4,4,6,18,20,-2,16
Concordia Ch,3824,6,2,3,9,15,23,-8,9
FCSB,3825,1,8,5,1,25,11,14,29
CFR Cluj,3825,2,6,6,2,14,9,5,24
D Bucuresti,3825,3,4,5,5,20,21,-1,17
Universitate,3825,4,4,5,5,15,19,-4,17
FC Botosani,3825,5,3,5,6,9,17,-8,14
Concordia Ch,3825,6,2,4,8,18,24,-6,10
FCSB,3826,1,8,5,1,24,11,13,29
CFR Cluj,3826,2,6,6,2,15,9,6,24
Universitate,3826,3,4,5,5,16,20,-4,17
D Bucuresti,3826,4,4,4,6,19,19,0,16
Concordia Ch,3826,5,4,2,8,18,21,-3,14
FC Botosani,3826,6,3,4,7,5,17,-12,13
FCSB,3827,1,9,5,0,29,10,19,32
CFR Cluj,3827,2,6,6,2,17,9,8,24
D Bucuresti,3827,3,4,5,5,21,21,0,17
FC Botosani,3827,4,4,4,6,10,17,-7,16
Universitate,3827,5,3,5,6,14,26,-12,14
Concordia Ch,3827,6,2,3,9,17,25,-8,9
FCSB,3828,1,9,5,0,29,10,19,32
CFR Cluj,3828,2,6,6,2,14,8,6,24
D Bucuresti,3828,3,4,5,5,17,18,-1,17
Universitate,3828,4,3,5,6,14,24,-10,14
FC Botosani,3828,5,3,4,7,5,15,-10,13
Concordia Ch,3828,6,3,3,8,17,21,-4,12
FCSB,3829,1,8,6,0,25,11,14,30
CFR Cluj,3829,2,6,6,2,16,10,6,24
FC Botosani,3829,3,4,5,5,8,12,-4,17
Universitate,3829,4,3,6,5,15,20,-5,15
D Bucuresti,3829,5,3,4,7,17,24,-7,13
Concordia Ch,3829,6,3,3,8,18,22,-4,12
FCSB,3830,1,8,6,0,26,12,14,30
CFR Cluj,3830,2,6,6,2,16,10,6,24
D Bucuresti,3830,3,3,6,5,17,19,-2,15
Universitate,3830,4,3,6,5,16,21,-5,15
FC Botosani,3830,5,3,6,5,6,13,-7,15
Concordia Ch,3830,6,2,4,8,17,23,-6,10
FCSB,3831,1,8,6,0,28,10,18,30
CFR Cluj,3831,2,5,7,2,13,12,1,22
FC Botosani,3831,3,4,5,5,7,13,-6,17
Universitate,3831,4,3,7,4,14,18,-4,16
D Bucuresti,3831,5,3,4,7,17,21,-4,13
Concordia Ch,3831,6,3,3,8,18,23,-5,12
FCSB,3832,1,8,6,0,25,11,14,30
CFR Cluj,3832,2,6,7,1,17,10,7,25
FC Botosani,3832,3,4,5,5,8,14,-6,17
D Bucuresti,3832,4,3,5,6,18,21,-3,14
Universitate,3832,5,3,5,6,16,22,-6,14
Concordia Ch,3832,6,3,2,9,18,24,-6,11
FCSB,3833,1,8,6,0,25,11,14,30
CFR Cluj,3833,2,6,6,2,14,8,6,24
D Bucuresti,3833,3,4,4,6,18,21,-3,16
FC Botosani,3833,4,4,4,6,8,14,-6,16
Universitate,3833,5,3,6,5,15,20,-5,15
Concordia Ch,3833,6,3,2,9,18,24,-6,11
FCSB,3834,1,9,5,0,30,12,18,32
CFR Cluj,3834,2,5,6,3,15,13,2,21
Universitate,3834,3,4,5,5,18,23,-5,17
D Bucuresti,3834,4,4,4,6,17,22,-5,16
FC Botosani,3834,5,3,5,6,5,13,-8,14
Concordia Ch,3834,6,3,3,8,19,21,-2,12
FCSB,3835,1,7,6,1,24,12,12,27
CFR Cluj,3835,2,7,6,1,20,8,12,27
D Bucuresti,3835,3,5,4,5,18,18,0,19
FC Botosani,3835,4,4,4,6,7,14,-7,16
Universitate,3835,5,3,6,5,14,23,-9,15
Concordia Ch,3835,6,2,2,10,16,24,-8,8
FCSB,3836,1,9,5,0,28,11,17,32
CFR Cluj,3836,2,6,6,2,15,9,6,24
D Bucuresti,3836,3,4,5,5,19,19,0,17
Universitate,3836,4,3,5,6,15,23,-8,14
FC Botosani,3836,5,3,4,7,5,16,-11,13
Concordia Ch,3836,6,3,3,8,18,22,-4,12
FCSB,3837,1,9,5,0,27,11,16,32
CFR Cluj,3837,2,5,6,3,14,12,2,21
Universitate,3837,3,4,5,5,16,19,-3,17
FC Botosani,3837,4,4,5,5,9,14,-5,17
D Bucuresti,3837,5,3,6,5,18,20,-2,15
Concordia Ch,3837,6,2,3,9,17,25,-8,9
FCSB,3838,1,7,7,0,26,13,13,28
CFR Cluj,3838,2,5,7,2,13,8,5,22
FC Botosani,3838,3,5,4,5,8,12,-4,19
Universitate,3838,4,4,6,4,18,21,-3,18
D Bucuresti,3838,5,3,4,7,16,23,-7,13
Concordia Ch,3838,6,3,2,9,18,22,-4,11
FCSB,3839,1,9,5,0,28,13,15,32
CFR Cluj,3839,2,6,6,2,16,10,6,24
FC Botosani,3839,3,5,4,5,10,13,-3,19
D Bucuresti,3839,4,4,4,6,17,21,-4,16
Universitate,3839,5,3,5,6,17,23,-6,14
Concordia Ch,3839,6,2,2,10,16,24,-8,8
FCSB,3840,1,7,6,1,25,13,12,27
CFR Cluj,3840,2,7,6,1,17,8,9,27
FC Botosani,3840,3,4,4,6,7,13,-6,16
Universitate,3840,4,3,6,5,15,21,-6,15
D Bucuresti,3840,5,3,5,6,17,21,-4,14
Concordia Ch,3840,6,3,3,8,17,22,-5,12
FCSB,3841,1,8,6,0,29,12,17,30
CFR Cluj,3841,2,6,6,2,15,12,3,24
FC Botosani,3841,3,5,4,5,9,14,-5,19
D Bucuresti,3841,4,4,4,6,18,19,-1,16
Universitate,3841,5,3,6,5,15,20,-5,15
Concordia Ch,3841,6,2,2,10,17,26,-9,8
CFR Cluj,3842,1,7,6,1,17,9,8,27
FCSB,3842,2,7,5,2,25,14,11,26
D Bucuresti,3842,3,5,4,5,19,18,1,19
Universitate,3842,4,4,5,5,17,21,-4,17
FC Botosani,3842,5,3,4,7,5,14,-9,13
Concordia Ch,3842,6,3,2,9,16,23,-7,11
FCSB,3843,1,8,6,0,30,14,16,30
CFR Cluj,3843,2,6,7,1,17,10,7,25
D Bucuresti,3843,3,3,6,5,19,21,-2,15
FC Botosani,3843,4,3,6,5,8,15,-7,15
Universitate,3843,5,3,5,6,15,23,-8,14
Concordia Ch,3843,6,2,4,8,17,23,-6,10
FCSB,3844,1,8,6,0,29,12,17,30
CFR Cluj,3844,2,6,6,2,16,12,4,24
D Bucuresti,3844,3,4,5,5,19,18,1,17
Universitate,3844,4,3,6,5,15,21,-6,15
FC Botosani,3844,5,3,4,7,6,20,-14,13
Concordia Ch,3844,6,3,3,8,20,22,-2,12
FCSB,3845,1,7,6,1,25,14,11,27
CFR Cluj,3845,2,6,7,1,17,9,8,25
D Bucuresti,3845,3,4,4,6,17,19,-2,16
Universitate,3845,4,3,7,4,16,20,-4,16
FC Botosani,3845,5,4,4,6,7,13,-6,16
Concordia Ch,3845,6,3,2,9,16,23,-7,11
FCSB,3846,1,8,6,0,25,11,14,30
CFR Cluj,3846,2,5,7,2,14,9,5,22
D Bucuresti,3846,3,4,5,5,18,18,0,17
Universitate,3846,4,4,5,5,15,19,-4,17
FC Botosani,3846,5,4,4,6,6,14,-8,16
Concordia Ch,3846,6,2,3,9,15,22,-7,9
FCSB,3847,1,8,5,1,25,13,12,29
CFR Cluj,3847,2,6,6,2,14,9,5,24
Universitate,3847,3,4,5,5,17,19,-2,17
FC Botosani,3847,4,4,5,5,8,14,-6,17
D Bucuresti,3847,5,3,6,5,18,20,-2,15
Concordia Ch,3847,6,2,3,9,15,22,-7,9
FCSB,3848,1,7,6,1,27,15,12,27
CFR Cluj,3848,2,6,7,1,16,9,7,25
Universitate,3848,3,3,7,4,18,22,-4,16
D Bucuresti,3848,4,4,4,6,18,23,-5,16
FC Botosani,3848,5,3,5,6,7,16,-9,14
Concordia Ch,3848,6,3,3,8,22,23,-1,12
FCSB,3849,1,7,7,0,26,13,13,28
CFR Cluj,3849,2,6,7,1,15,8,7,25
D Bucuresti,3849,3,5,4,5,24,23,1,19
FC Botosani,3849,4,4,4,6,9,17,-8,16
Universitate,3849,5,3,6,5,18,23,-5,15
Concordia Ch,3849,6,2,2,10,17,25,-8,8
FCSB,3850,1,7,5,2,23,13,10,26
CFR Cluj,3850,2,6,6,2,16,10,6,24
Universitate,3850,3,5,5,4,18,19,-1,20
D Bucuresti,3850,4,4,5,5,17,18,-1,17
FC Botosani,3850,5,4,4,6,6,13,-7,16
Concordia Ch,3850,6,2,3,9,15,22,-7,9
FCSB,3851,1,7,6,1,25,13,12,27
CFR Cluj,3851,2,6,7,1,18,11,7,25
FC Botosani,3851,3,5,4,5,8,12,-4,19
Universitate,3851,4,4,5,5,17,21,-4,17
D Bucuresti,3851,5,3,5,6,17,20,-3,14
Concordia Ch,3851,6,2,3,9,16,24,-8,9
FCSB,3852,1,7,5,2,24,16,8,26
CFR Cluj,3852,2,6,6,2,17,9,8,24
Universitate,3852,3,5,5,4,17,18,-1,20
D Bucuresti,3852,4,4,5,5,19,19,0,17
FC Botosani,3852,5,4,4,6,9,14,-5,16
Concordia Ch,3852,6,2,3,9,16,26,-10,9
FCSB,3853,1,8,5,1,25,12,13,29
CFR Cluj,3853,2,6,6,2,16,9,7,24
D Bucuresti,3853,3,5,4,5,19,19,0,19
Universitate,3853,4,4,5,5,15,20,-5,17
FC Botosani,3853,5,3,5,6,6,14,-8,14
Concordia Ch,3853,6,2,3,9,17,24,-7,9
FCSB,3854,1,9,5,0,29,11,18,32
CFR Cluj,3854,2,5,6,3,14,14,0,21
D Bucuresti,3854,3,5,4,5,19,18,1,19
Universitate,3854,4,4,5,5,17,20,-3,17
FC Botosani,3854,5,3,5,6,6,14,-8,14
Concordia Ch,3854,6,2,3,9,16,24,-8,9
FCSB,3855,1,8,5,1,26,12,14,29
CFR Cluj,3855,2,6,6,2,16,10,6,24
Universitate,3855,3,4,5,5,17,22,-5,17
D Bucuresti,3855,4,4,4,6,20,19,1,16
FC Botosani,3855,5,3,5,6,7,18,-11,14
Concordia Ch,3855,6,3,3,8,18,23,-5,12
FCSB,3856,1,7,6,1,26,15,11,27
CFR Cluj,3856,2,6,7,1,17,9,8,25
Universitate,3856,3,4,5,5,17,21,-4,17
D Bucuresti,3856,4,4,4,6,20,22,-2,16
FC Botosani,3856,5,4,4,6,10,16,-6,16
Concordia Ch,3856,6,3,2,9,16,23,-7,11
FCSB,3857,1,7,6,1,25,14,11,27
CFR Cluj,3857,2,6,7,1,16,8,8,25
D Bucuresti,3857,3,5,4,5,20,20,0,19
Universitate,3857,4,3,7,4,15,19,-4,16
FC Botosani,3857,5,4,4,6,8,14,-6,16
Concordia Ch,3857,6,2,2,10,16,25,-9,8
FCSB,3858,1,7,5,2,24,15,9,26
CFR Cluj,3858,2,6,7,1,16,8,8,25
Universitate,3858,3,4,6,4,16,18,-2,18
D Bucuresti,3858,4,3,6,5,17,19,-2,15
FC Botosani,3858,5,3,6,5,7,14,-7,15
Concordia Ch,3858,6,2,4,8,18,24,-6,10
FCSB,3859,1,8,6,0,26,12,14,30
CFR Cluj,3859,2,5,8,1,16,10,6,23
D Bucuresti,3859,3,4,4,6,17,20,-3,16
FC Botosani,3859,4,4,4,6,7,14,-7,16
Universitate,3859,5,3,6,5,15,20,-5,15
Concordia Ch,3859,6,3,2,9,17,22,-5,11
FCSB,3860,1,9,5,0,28,11,17,32
CFR Cluj,3860,2,6,6,2,15,11,4,24
D Bucuresti,3860,3,5,4,5,18,18,0,19
FC Botosani,3860,4,4,4,6,6,13,-7,16
Universitate,3860,5,3,5,6,16,22,-6,14
Concordia Ch,3860,6,2,2,10,15,23,-8,8
FCSB,3861,1,8,6,0,29,11,18,30
CFR Cluj,3861,2,6,7,1,16,9,7,25
D Bucuresti,3861,3,5,4,5,20,18,2,19
FC Botosani,3861,4,4,4,6,8,16,-8,16
Universitate,3861,5,3,5,6,15,25,-10,14
Concordia Ch,3861,6,2,2,10,17,26,-9,8
FCSB,3862,1,8,5,1,25,13,12,29
CFR Cluj,3862,2,6,7,1,16,7,9,25
FC Botosani,3862,3,5,4,5,9,12,-3,19
Universitate,3862,4,3,6,5,14,20,-6,15
D Bucuresti,3862,5,3,4,7,17,21,-4,13
Concordia Ch,3862,6,3,2,9,17,25,-8,11
FCSB,3863,1,7,7,0,24,11,13,28
CFR Cluj,3863,2,6,7,1,14,7,7,25
D Bucuresti,3863,3,4,4,6,17,21,-4,16
Universitate,3863,4,3,6,5,15,20,-5,15
FC Botosani,3863,5,3,5,6,6,14,-8,14
Concordia Ch,3863,6,3,3,8,19,22,-3,12
FCSB,3864,1,8,5,1,26,15,11,29
CFR Cluj,3864,2,6,6,2,16,10,6,24
FC Botosani,3864,3,5,4,5,8,12,-4,19
Universitate,3864,4,4,5,5,19,21,-2,17
D Bucuresti,3864,5,3,4,7,18,22,-4,13
Concordia Ch,3864,6,3,2,9,18,25,-7,11
FCSB,3865,1,8,5,1,24,11,13,29
CFR Cluj,3865,2,6,6,2,18,10,8,24
Universitate,3865,3,4,5,5,17,23,-6,17
D Bucuresti,3865,4,4,4,6,19,20,-1,16
FC Botosani,3865,5,3,5,6,8,18,-10,14
Concordia Ch,3865,6,3,3,8,20,24,-4,12
FCSB,3866,1,8,6,0,25,11,14,30
CFR Cluj,3866,2,5,6,3,15,11,4,21
Universitate,3866,3,4,6,4,18,21,-3,18
FC Botosani,3866,4,3,6,5,8,15,-7,15
D Bucuresti,3866,5,3,5,6,18,22,-4,14
Concordia Ch,3866,6,3,3,8,20,24,-4,12
FCSB,3867,1,8,6,0,31,13,18,30
CFR Cluj,3867,2,5,7,2,13,12,1,22
D Bucuresti,3867,3,4,5,5,18,19,-1,17
Universitate,3867,4,3,7,4,17,21,-4,16
FC Botosani,3867,5,3,5,6,6,14,-8,14
Concordia Ch,3867,6,2,4,8,17,23,-6,10
FCSB,3868,1,8,5,1,28,12,16,29
CFR Cluj,3868,2,6,6,2,14,11,3,24
Universitate,3868,3,4,5,5,16,20,-4,17
FC Botosani,3868,4,4,5,5,7,13,-6,17
D Bucuresti,3868,5,3,6,5,18,20,-2,15
Concordia Ch,3868,6,2,3,9,16,23,-7,9
FCSB,3869,1,7,5,2,24,16,8,26
CFR Cluj,3869,2,6,7,1,15,8,7,25
Universitate,3869,3,4,6,4,18,18,0,18
D Bucuresti,3869,4,4,5,5,21,20,1,17
FC Botosani,3869,5,4,5,5,8,13,-5,17
Concordia Ch,3869,6,2,2,10,16,27,-11,8
CFR Cluj,3870,1,7,6,1,16,7,9,27
FCSB,3870,2,7,5,2,23,12,11,26
D Bucuresti,3870,3,5,4,5,21,18,3,19
Universitate,3870,4,4,5,5,15,20,-5,17
FC Botosani,3870,5,4,4,6,6,14,-8,16
Concordia Ch,3870,6,2,2,10,15,25,-10,8
FCSB,3871,1,9,5,0,27,12,15,32
CFR Cluj,3871,2,6,6,2,16,9,7,24
D Bucuresti,3871,3,4,4,6,18,21,-3,16
Concordia Ch,3871,4,4,2,8,20,21,-1,14
Universitate,3871,5,3,5,6,15,22,-7,14
FC Botosani,3871,6,3,4,7,5,16,-11,13
FCSB,3872,1,8,5,1,25,12,13,29
CFR Cluj,3872,2,6,6,2,14,8,6,24
D Bucuresti,3872,3,5,4,5,23,20,3,19
Universitate,3872,4,4,5,5,16,20,-4,17
FC Botosani,3872,5,4,4,6,8,18,-10,16
Concordia Ch,3872,6,2,2,10,17,25,-8,8
FCSB,3873,1,8,5,1,25,12,13,29
CFR Cluj,3873,2,7,6,1,20,8,12,27
D Bucuresti,3873,3,5,4,5,21,19,2,19
Universitate,3873,4,3,5,6,15,25,-10,14
FC Botosani,3873,5,3,4,7,6,15,-9,13
Concordia Ch,3873,6,3,2,9,18,26,-8,11
FCSB,3874,1,8,5,1,25,12,13,29
CFR Cluj,3874,2,5,7,2,14,9,5,22
Universitate,3874,3,4,6,4,15,18,-3,18
D Bucuresti,3874,4,4,4,6,19,20,-1,16
FC Botosani,3874,5,3,5,6,5,14,-9,14
Concordia Ch,3874,6,3,3,8,17,22,-5,12
FCSB,3875,1,8,6,0,27,13,14,30
CFR Cluj,3875,2,6,6,2,14,8,6,24
D Bucuresti,3875,3,5,4,5,19,19,0,19
Universitate,3875,4,3,6,5,17,22,-5,15
FC Botosani,3875,5,3,5,6,6,14,-8,14
Concordia Ch,3875,6,2,3,9,17,24,-7,9
FCSB,3876,1,9,5,0,25,10,15,32
CFR Cluj,3876,2,5,6,3,14,10,4,21
FC Botosani,3876,3,5,4,5,11,13,-2,19
Universitate,3876,4,4,5,5,16,20,-4,17
D Bucuresti,3876,5,3,4,7,17,24,-7,13
Concordia Ch,3876,6,3,2,9,17,23,-6,11
FCSB,3877,1,9,5,0,29,11,18,32
CFR Cluj,3877,2,6,6,2,15,9,6,24
FC Botosani,3877,3,4,4,6,6,13,-7,16
D Bucuresti,3877,4,3,5,6,17,20,-3,14
Universitate,3877,5,3,5,6,14,23,-9,14
Concordia Ch,3877,6,3,3,8,17,22,-5,12
FCSB,3878,1,8,5,1,27,12,15,29
CFR Cluj,3878,2,5,6,3,13,11,2,21
Universitate,3878,3,5,5,4,17,19,-2,20
FC Botosani,3878,4,4,4,6,8,16,-8,16
D Bucuresti,3878,5,3,5,6,17,20,-3,14
Concordia Ch,3878,6,3,3,8,18,22,-4,12
FCSB,3879,1,9,5,0,25,10,15,32
CFR Cluj,3879,2,6,6,2,18,8,10,24
D Bucuresti,3879,3,4,4,6,18,21,-3,16
FC Botosani,3879,4,3,5,6,7,15,-8,14
Universitate,3879,5,3,5,6,14,24,-10,14
Concordia Ch,3879,6,3,3,8,20,24,-4,12
FCSB,3880,1,8,5,1,25,14,11,29
CFR Cluj,3880,2,7,6,1,20,10,10,27
FC Botosani,3880,3,5,4,5,10,13,-3,19
D Bucuresti,3880,4,3,5,6,18,21,-3,14
Universitate,3880,5,3,5,6,16,22,-6,14
Concordia Ch,3880,6,2,3,9,16,25,-9,9
FCSB,3881,1,8,6,0,26,12,14,30
CFR Cluj,3881,2,6,6,2,16,9,7,24
D Bucuresti,3881,3,5,4,5,21,19,2,19
FC Botosani,3881,4,4,4,6,7,15,-8,16
Universitate,3881,5,3,6,5,15,21,-6,15
Concordia Ch,3881,6,2,2,10,16,25,-9,8
FCSB,3882,1,9,5,0,28,13,15,32
CFR Cluj,3882,2,6,6,2,15,9,6,24
FC Botosani,3882,3,4,4,6,7,14,-7,16
D Bucuresti,3882,4,3,5,6,18,21,-3,14
Universitate,3882,5,3,5,6,16,22,-6,14
Concordia Ch,3882,6,3,3,8,17,22,-5,12
FCSB,3883,1,8,6,0,26,12,14,30
CFR Cluj,3883,2,6,6,2,17,10,7,24
D Bucuresti,3883,3,3,6,5,21,23,-2,15
Universitate,3883,4,3,6,5,16,22,-6,15
FC Botosani,3883,5,3,5,6,7,15,-8,14
Concordia Ch,3883,6,3,3,8,21,26,-5,12
FCSB,3884,1,9,5,0,27,10,17,32
CFR Cluj,3884,2,6,6,2,15,10,5,24
FC Botosani,3884,3,5,4,5,10,15,-5,19
D Bucuresti,3884,4,3,5,6,17,20,-3,14
Universitate,3884,5,3,5,6,14,21,-7,14
Concordia Ch,3884,6,2,3,9,17,24,-7,9
CFR Cluj,3885,1,7,6,1,16,8,8,27
FCSB,3885,2,7,5,2,24,15,9,26
FC Botosani,3885,3,5,4,5,9,12,-3,19
Universitate,3885,4,4,5,5,17,19,-2,17
D Bucuresti,3885,5,4,4,6,17,19,-2,16
Concordia Ch,3885,6,2,2,10,15,25,-10,8
FCSB,3886,1,8,6,0,25,11,14,30
CFR Cluj,3886,2,6,6,2,15,9,6,24
D Bucuresti,3886,3,4,4,6,17,19,-2,16
Universitate,3886,4,3,6,5,14,19,-5,15
FC Botosani,3886,5,3,5,6,7,15,-8,14
Concordia Ch,3886,6,3,3,8,18,23,-5,12
FCSB,3887,1,9,5,0,26,11,15,32
CFR Cluj,3887,2,5,6,3,13,10,3,21
Universitate,3887,3,4,5,5,17,20,-3,17
D Bucuresti,3887,4,4,4,6,18,24,-6,16
FC Botosani,3887,5,4,4,6,6,14,-8,16
Concordia Ch,3887,6,3,2,9,21,22,-1,11
FCSB,3888,1,7,7,0,26,13,13,28
CFR Cluj,3888,2,6,7,1,17,8,9,25
FC Botosani,3888,3,4,4,6,6,14,-8,16
Universitate,3888,4,3,6,5,16,23,-7,15
Concordia Ch,3888,5,4,2,8,20,21,-1,14
D Bucuresti,3888,6,3,4,7,16,22,-6,13
FCSB,3889,1,9,5,0,29,13,16,32
CFR Cluj,3889,2,6,6,2,14,9,5,24
D Bucuresti,3889,3,5,4,5,20,20,0,19
FC Botosani,3889,4,4,4,6,7,14,-7,16
Universitate,3889,5,3,5,6,17,23,-6,14
Concordia Ch,3889,6,2,2,10,16,24,-8,8
FCSB,3890,1,7,6,1,24,14,10,27
CFR Cluj,3890,2,6,6,2,16,9,7,24
Universitate,3890,3,4,6,4,17,19,-2,18
FC Botosani,3890,4,4,5,5,9,15,-6,17
D Bucuresti,3890,5,3,5,6,19,22,-3,14
Concordia Ch,3890,6,2,4,8,17,23,-6,10
FCSB,3891,1,8,6,0,26,12,14,30
CFR Cluj,3891,2,6,6,2,16,10,6,24
Universitate,3891,3,3,6,5,16,21,-5,15
Concordia Ch,3891,4,4,2,8,19,22,-3,14
D Bucuresti,3891,5,3,5,6,18,22,-4,14
FC Botosani,3891,6,3,5,6,6,14,-8,14
FCSB,3892,1,8,6,0,26,12,14,30
CFR Cluj,3892,2,5,7,2,15,10,5,22
D Bucuresti,3892,3,5,4,5,21,20,1,19
Universitate,3892,4,4,5,5,17,21,-4,17
FC Botosani,3892,5,4,4,6,9,14,-5,16
Concordia Ch,3892,6,2,2,10,16,27,-11,8
FCSB,3893,1,7,7,0,24,11,13,28
CFR Cluj,3893,2,6,7,1,19,10,9,25
Universitate,3893,3,3,6,5,16,23,-7,15
FC Botosani,3893,4,3,6,5,6,13,-7,15
D Bucuresti,3893,5,3,5,6,17,20,-3,14
Concordia Ch,3893,6,3,3,8,16,21,-5,12
FCSB,3894,1,8,5,1,27,13,14,29
CFR Cluj,3894,2,5,6,3,14,11,3,21
Universitate,3894,3,5,5,4,17,19,-2,20
D Bucuresti,3894,4,4,5,5,23,20,3,17
FC Botosani,3894,5,3,4,7,6,19,-13,13
Concordia Ch,3894,6,3,3,8,19,24,-5,12
FCSB,3895,1,8,5,1,26,12,14,29
CFR Cluj,3895,2,7,6,1,15,7,8,27
D Bucuresti,3895,3,5,4,5,20,19,1,19
Universitate,3895,4,3,5,6,15,22,-7,14
FC Botosani,3895,5,3,5,6,5,14,-9,14
Concordia Ch,3895,6,2,3,9,16,23,-7,9
CFR Cluj,3896,1,7,6,1,16,7,9,27
FCSB,3896,2,7,5,2,23,12,11,26
Universitate,3896,3,4,5,5,15,20,-5,17
FC Botosani,3896,4,4,5,5,9,14,-5,17
D Bucuresti,3896,5,3,4,7,19,24,-5,13
Concordia Ch,3896,6,3,3,8,19,24,-5,12
FCSB,3897,1,9,5,0,26,10,16,32
CFR Cluj,3897,2,5,7,2,13,8,5,22
D Bucuresti,3897,3,4,5,5,20,21,-1,17
Universitate,3897,4,3,6,5,14,20,-6,15
FC Botosani,3897,5,3,4,7,6,16,-10,13
Concordia Ch,3897,6,3,3,8,19,23,-4,12
CFR Cluj,3898,1,7,6,1,19,10,9,27
FCSB,3898,2,7,5,2,26,15,11,26
Universitate,3898,3,4,5,5,15,20,-5,17
D Bucuresti,3898,4,3,6,5,19,21,-2,15
FC Botosani,3898,5,3,6,5,7,14,-7,15
Concordia Ch,3898,6,2,4,8,16,22,-6,10
FCSB,3899,1,7,6,1,25,13,12,27
CFR Cluj,3899,2,7,6,1,17,9,8,27
D Bucuresti,3899,3,3,6,5,17,19,-2,15
Universitate,3899,4,3,6,5,16,21,-5,15
FC Botosani,3899,5,3,5,6,5,14,-9,14
Concordia Ch,3899,6,3,3,8,18,22,-4,12
FCSB,3900,1,8,5,1,25,14,11,29
CFR Cluj,3900,2,6,6,2,16,9,7,24
Universitate,3900,3,4,5,5,18,21,-3,17
FC Botosani,3900,4,4,5,5,7,13,-6,17
D Bucuresti,3900,5,4,4,6,19,21,-2,16
Concordia Ch,3900,6,2,3,9,16,23,-7,9
FCSB,3901,1,7,7,0,23,10,13,28
CFR Cluj,3901,2,5,7,2,13,8,5,22
Universitate,3901,3,4,6,4,15,18,-3,18
D Bucuresti,3901,4,4,4,6,19,21,-2,16
Concordia Ch,3901,5,4,2,8,19,22,-3,14
FC Botosani,3901,6,3,4,7,5,15,-10,13
FCSB,3902,1,7,6,1,25,13,12,27
CFR Cluj,3902,2,7,6,1,18,8,10,27
FC Botosani,3902,3,4,5,5,9,15,-6,17
D Bucuresti,3902,4,4,4,6,19,21,-2,16
Universitate,3902,5,3,6,5,15,22,-7,15
Concordia Ch,3902,6,2,3,9,18,25,-7,9
FCSB,3903,1,8,5,1,26,12,14,29
CFR Cluj,3903,2,7,6,1,15,7,8,27
D Bucuresti,3903,3,4,5,5,21,20,1,17
Universitate,3903,4,3,5,6,15,22,-7,14
FC Botosani,3903,5,3,5,6,6,16,-10,14
Concordia Ch,3903,6,2,4,8,18,24,-6,10
FCSB,3904,1,8,6,0,27,13,14,30
CFR Cluj,3904,2,6,6,2,17,11,6,24
D Bucuresti,3904,3,5,4,5,18,18,0,19
FC Botosani,3904,4,4,4,6,6,13,-7,16
Universitate,3904,5,3,6,5,16,21,-5,15
Concordia Ch,3904,6,2,2,10,15,23,-8,8
CFR Cluj,3905,1,7,6,1,16,8,8,27
FCSB,3905,2,7,5,2,25,14,11,26
Universitate,3905,3,4,5,5,16,20,-4,17
D Bucuresti,3905,4,3,6,5,20,22,-2,15
FC Botosani,3905,5,3,5,6,10,18,-8,14
Concordia Ch,3905,6,3,3,8,19,24,-5,12
FCSB,3906,1,8,5,1,25,11,14,29
CFR Cluj,3906,2,5,6,3,14,11,3,21
Universitate,3906,3,5,5,4,17,19,-2,20
D Bucuresti,3906,4,3,6,5,17,19,-2,15
FC Botosani,3906,5,3,5,6,6,14,-8,14
Concordia Ch,3906,6,3,3,8,16,21,-5,12
FCSB,3907,1,9,5,0,27,11,16,32
CFR Cluj,3907,2,5,7,2,15,11,4,22
Universitate,3907,3,3,6,5,15,20,-5,15
FC Botosani,3907,4,3,6,5,6,13,-7,15
D Bucuresti,3907,5,3,5,6,16,21,-5,14
Concordia Ch,3907,6,3,3,8,19,22,-3,12
FCSB,3908,1,7,7,0,26,13,13,28
CFR Cluj,3908,2,6,7,1,17,10,7,25
D Bucuresti,3908,3,4,4,6,19,20,-1,16
Universitate,3908,4,3,6,5,18,23,-5,15
Concordia Ch,3908,5,4,2,8,17,21,-4,14
FC Botosani,3908,6,3,4,7,6,16,-10,13
FCSB,3909,1,8,5,1,24,14,10,29
CFR Cluj,3909,2,5,7,2,14,9,5,22
Universitate,3909,3,4,6,4,19,19,0,18
FC Botosani,3909,4,4,5,5,9,15,-6,17
D Bucuresti,3909,5,4,4,6,18,20,-2,16
Concordia Ch,3909,6,2,3,9,17,24,-7,9
FCSB,3910,1,7,6,1,25,13,12,27
CFR Cluj,3910,2,5,7,2,14,9,5,22
Universitate,3910,3,5,5,4,17,19,-2,20
D Bucuresti,3910,4,4,5,5,19,20,-1,17
FC Botosani,3910,5,4,5,5,7,13,-6,17
Concordia Ch,3910,6,2,2,10,16,24,-8,8
FCSB,3911,1,8,5,1,27,12,15,29
CFR Cluj,3911,2,6,6,2,14,11,3,24
D Bucuresti,3911,3,5,4,5,20,18,2,19
Universitate,3911,4,4,5,5,16,19,-3,17
FC Botosani,3911,5,3,5,6,6,15,-9,14
Concordia Ch,3911,6,2,3,9,16,24,-8,9
FCSB,3912,1,9,5,0,27,12,15,32
CFR Cluj,3912,2,6,6,2,16,9,7,24
D Bucuresti,3912,3,4,5,5,17,18,-1,17
Universitate,3912,4,3,5,6,15,22,-7,14
FC Botosani,3912,5,3,5,6,6,14,-8,14
Concordia Ch,3912,6,2,4,8,16,22,-6,10
FCSB,3913,1,8,6,0,25,11,14,30
CFR Cluj,3913,2,6,7,1,15,8,7,25
D Bucuresti,3913,3,4,5,5,20,21,-1,17
FC Botosani,3913,4,4,4,6,7,14,-7,16
Universitate,3913,5,3,5,6,16,22,-6,14
Concordia Ch,3913,6,2,3,9,17,24,-7,9
FCSB,3914,1,8,5,1,25,13,12,29
CFR Cluj,3914,2,6,7,1,16,8,8,25
FC Botosani,3914,3,5,4,5,7,12,-5,19
D Bucuresti,3914,4,4,4,6,19,20,-1,16
Universitate,3914,5,3,6,5,14,19,-5,15
Concordia Ch,3914,6,2,2,10,16,25,-9,8
FCSB,3915,1,9,5,0,28,13,15,32
CFR Cluj,3915,2,6,6,2,16,9,7,24
D Bucuresti,3915,3,3,6,5,17,19,-2,15
FC Botosani,3915,4,3,6,5,6,13,-7,15
Universitate,3915,5,3,5,6,16,23,-7,14
Concordia Ch,3915,6,2,4,8,17,23,-6,10
FCSB,3916,1,8,5,1,28,15,13,29
CFR Cluj,3916,2,7,6,1,20,9,11,27
D Bucuresti,3916,3,4,5,5,22,22,0,17
FC Botosani,3916,4,3,6,5,7,14,-7,15
Universitate,3916,5,3,5,6,15,24,-9,14
Concordia Ch,3916,6,2,3,9,17,25,-8,9
FCSB,3917,1,7,7,0,24,11,13,28
CFR Cluj,3917,2,6,7,1,15,8,7,25
D Bucuresti,3917,3,5,4,5,22,21,1,19
Universitate,3917,4,3,6,5,16,21,-5,15
FC Botosani,3917,5,3,4,7,6,16,-10,13
Concordia Ch,3917,6,3,2,9,19,25,-6,11
FCSB,3918,1,7,6,1,24,12,12,27
CFR Cluj,3918,2,5,7,2,15,12,3,22
Universitate,3918,3,5,5,4,19,19,0,20
D Bucuresti,3918,4,4,5,5,18,18,0,17
FC Botosani,3918,5,4,4,6,8,14,-6,16
Concordia Ch,3918,6,2,3,9,15,24,-9,9
FCSB,3919,1,8,5,1,27,13,14,29
CFR Cluj,3919,2,5,6,3,13,10,3,21
Universitate,3919,3,5,5,4,18,20,-2,20
FC Botosani,3919,4,4,5,5,7,13,-6,17
D Bucuresti,3919,5,3,6,5,16,18,-2,15
Concordia Ch,3919,6,2,3,9,16,23,-7,9
FCSB,3920,1,8,6,0,26,12,14,30
CFR Cluj,3920,2,6,6,2,16,10,6,24
D Bucuresti,3920,3,3,6,5,17,19,-2,15
Universitate,3920,4,3,6,5,14,19,-5,15
FC Botosani,3920,5,3,5,6,6,15,-9,14
Concordia Ch,3920,6,3,3,8,19,23,-4,12
FCSB,3921,1,9,5,0,28,12,16,32
CFR Cluj,3921,2,6,6,2,17,10,7,24
D Bucuresti,3921,3,4,4,6,19,21,-2,16
FC Botosani,3921,4,4,4,6,7,15,-8,16
Universitate,3921,5,3,5,6,14,22,-8,14
Concordia Ch,3921,6,3,2,9,19,24,-5,11
FCSB,3922,1,8,6,0,28,11,17,30
CFR Cluj,3922,2,6,6,2,14,11,3,24
D Bucuresti,3922,3,5,4,5,20,20,0,19
Universitate,3922,4,3,6,5,15,20,-5,15
FC Botosani,3922,5,3,4,7,6,15,-9,13
Concordia Ch,3922,6,3,2,9,17,23,-6,11
FCSB,3923,1,9,5,0,29,12,17,32
CFR Cluj,3923,2,5,7,2,13,10,3,22
Universitate,3923,3,3,6,5,16,21,-5,15
Concordia Ch,3923,4,4,2,8,18,21,-3,14
D Bucuresti,3923,4,3,5,6,18,21,-3,14
FC Botosani,3923,6,3,5,6,7,16,-9,14
FCSB,3924,1,7,6,1,24,12,12,27
CFR Cluj,3924,2,6,7,1,15,8,7,25
FC Botosani,3924,3,5,4,5,8,12,-4,19
Universitate,3924,4,4,5,5,15,19,-4,17
D Bucuresti,3924,5,4,4,6,18,19,-1,16
Concordia Ch,3924,6,2,2,10,15,25,-10,8
FCSB,3925,1,7,5,2,23,12,11,26
CFR Cluj,3925,2,6,7,1,14,7,7,25
D Bucuresti,3925,3,5,4,5,21,19,2,19
Universitate,3925,4,4,6,4,15,18,-3,18
FC Botosani,3925,5,4,4,6,13,16,-3,16
Concordia Ch,3925,6,2,2,10,17,31,-14,8
FCSB,3926,1,9,5,0,30,10,20,32
CFR Cluj,3926,2,5,6,3,14,12,2,21
Universitate,3926,3,4,5,5,16,23,-7,17
FC Botosani,3926,4,4,4,6,8,15,-7,16
Concordia Ch,3926,5,4,2,8,19,22,-3,14
D Bucuresti,3926,6,3,4,7,19,24,-5,13
FCSB,3927,1,7,6,1,25,13,12,27
CFR Cluj,3927,2,5,8,1,14,8,6,23
FC Botosani,3927,3,5,4,5,8,13,-5,19
Universitate,3927,4,4,6,4,16,19,-3,18
D Bucuresti,3927,5,3,4,7,16,22,-6,13
Concordia Ch,3927,6,3,2,9,19,23,-4,11
FCSB,3928,1,9,5,0,25,10,15,32
CFR Cluj,3928,2,5,7,2,13,8,5,22
D Bucuresti,3928,3,4,4,6,18,24,-6,16
Universitate,3928,4,3,6,5,14,19,-5,15
FC Botosani,3928,5,3,5,6,7,15,-8,14
Concordia Ch,3928,6,3,3,8,21,22,-1,12
FCSB,3929,1,9,5,0,26,11,15,32
CFR Cluj,3929,2,6,6,2,15,9,6,24
FC Botosani,3929,3,4,5,5,6,12,-6,17
D Bucuresti,3929,4,4,4,6,17,19,-2,16
Universitate,3929,5,3,5,6,14,20,-6,14
Concordia Ch,3929,6,2,3,9,15,22,-7,9
FCSB,3930,1,8,5,1,24,11,13,29
CFR Cluj,3930,2,7,6,1,17,8,9,27
D Bucuresti,3930,3,5,4,5,22,18,4,19
Universitate,3930,4,3,5,6,15,22,-7,14
FC Botosani,3930,5,3,5,6,5,14,-9,14
Concordia Ch,3930,6,2,3,9,15,25,-10,9
FCSB,3931,1,7,6,1,25,13,12,27
CFR Cluj,3931,2,7,6,1,16,8,8,27
D Bucuresti,3931,3,4,5,5,20,20,0,17
FC Botosani,3931,4,4,5,5,8,13,-5,17
Universitate,3931,5,3,6,5,15,20,-5,15
Concordia Ch,3931,6,2,2,10,16,26,-10,8
FCSB,3932,1,8,5,1,27,14,13,29
CFR Cluj,3932,2,6,6,2,15,10,5,24
D Bucuresti,3932,3,5,4,5,24,20,4,19
Universitate,3932,4,4,5,5,17,20,-3,17
FC Botosani,3932,5,3,4,7,6,17,-11,13
Concordia Ch,3932,6,3,2,9,18,26,-8,11
FCSB,3933,1,9,5,0,28,10,18,32
CFR Cluj,3933,2,5,7,2,14,11,3,22
D Bucuresti,3933,3,5,4,5,21,19,2,19
FC Botosani,3933,4,4,4,6,6,15,-9,16
Universitate,3933,5,3,6,5,15,21,-6,15
Concordia Ch,3933,6,2,2,10,16,24,-8,8
FCSB,3934,1,7,6,1,23,12,11,27
CFR Cluj,3934,2,5,7,2,14,9,5,22
Universitate,3934,3,5,5,4,18,19,-1,20
D Bucuresti,3934,4,4,4,6,21,22,-1,16
FC Botosani,3934,5,4,4,6,8,15,-7,16
Concordia Ch,3934,6,3,2,9,18,25,-7,11
FCSB,3935,1,9,5,0,29,12,17,32
CFR Cluj,3935,2,6,6,2,17,12,5,24
FC Botosani,3935,3,4,5,5,6,12,-6,17
Universitate,3935,4,3,5,6,14,21,-7,14
D Bucuresti,3935,5,3,4,7,17,21,-4,13
Concordia Ch,3935,6,3,3,8,17,22,-5,12
FCSB,3936,1,8,6,0,26,12,14,30
CFR Cluj,3936,2,5,8,1,14,8,6,23
FC Botosani,3936,3,5,4,5,11,12,-1,19
D Bucuresti,3936,4,4,4,6,17,22,-5,16
Universitate,3936,5,3,6,5,17,22,-5,15
Concordia Ch,3936,6,2,2,10,15,24,-9,8
FCSB,3937,1,8,5,1,24,11,13,29
CFR Cluj,3937,2,7,6,1,15,7,8,27
FC Botosani,3937,3,4,5,5,6,12,-6,17
Universitate,3937,4,3,5,6,14,20,-6,14
D Bucuresti,3937,5,3,4,7,16,21,-5,13
Concordia Ch,3937,6,3,3,8,17,21,-4,12
FCSB,3938,1,9,5,0,28,11,17,32
CFR Cluj,3938,2,6,6,2,16,10,6,24
FC Botosani,3938,3,5,4,5,8,13,-5,19
D Bucuresti,3938,4,3,5,6,18,21,-3,14
Universitate,3938,5,3,5,6,15,23,-8,14
Concordia Ch,3938,6,2,3,9,16,23,-7,9
FCSB,3939,1,9,5,0,26,11,15,32
CFR Cluj,3939,2,5,6,3,13,9,4,21
D Bucuresti,3939,3,5,4,5,23,18,5,19
Universitate,3939,4,4,5,5,16,20,-4,17
FC Botosani,3939,5,3,4,7,6,18,-12,13
Concordia Ch,3939,6,3,2,9,17,25,-8,11
FCSB,3940,1,7,6,1,25,13,12,27
CFR Cluj,3940,2,6,7,1,15,8,7,25
D Bucuresti,3940,3,4,5,5,21,20,1,17
Universitate,3940,4,4,5,5,16,20,-4,17
FC Botosani,3940,5,4,4,6,8,15,-7,16
Concordia Ch,3940,6,2,3,9,17,26,-9,9
FCSB,3941,1,8,5,1,24,11,13,29
CFR Cluj,3941,2,5,7,2,13,8,5,22
Universitate,3941,3,4,6,4,15,18,-3,18
FC Botosani,3941,4,4,4,6,8,15,-7,16
Concordia Ch,3941,5,4,2,8,22,25,-3,14
D Bucuresti,3941,6,3,4,7,18,23,-5,13
FCSB,3942,1,7,7,0,26,13,13,28
CFR Cluj,3942,2,5,7,2,15,10,5,22
FC Botosani,3942,3,5,4,5,8,12,-4,19
Universitate,3942,4,4,6,4,16,19,-3,18
D Bucuresti,3942,5,4,4,6,18,20,-2,16
Concordia Ch,3942,6,2,2,10,16,25,-9,8
FCSB,3943,1,8,5,1,27,13,14,29
CFR Cluj,3943,2,6,6,2,17,12,5,24
Universitate,3943,3,4,5,5,18,22,-4,17
FC Botosani,3943,4,4,5,5,6,12,-6,17
D Bucuresti,3943,5,3,4,7,16,20,-4,13
Concordia Ch,3943,6,3,3,8,16,21,-5,12
FCSB,3944,1,7,7,0,24,11,13,28
CFR Cluj,3944,2,6,7,1,15,8,7,25
D Bucuresti,3944,3,5,4,5,22,20,2,19
FC Botosani,3944,4,4,4,6,8,16,-8,16
Universitate,3944,5,3,6,5,14,19,-5,15
Concordia Ch,3944,6,2,2,10,15,24,-9,8
FCSB,3945,1,7,6,1,23,14,9,27
CFR Cluj,3945,2,5,8,1,13,7,6,23
Universitate,3945,3,4,6,4,18,18,0,18
D Bucuresti,3945,4,4,5,5,18,19,-1,17
FC Botosani,3945,5,3,5,6,6,16,-10,14
Concordia Ch,3945,6,3,2,9,18,22,-4,11
FCSB,3946,1,7,7,0,24,11,13,28
CFR Cluj,3946,2,5,8,1,15,9,6,23
D Bucuresti,3946,3,5,4,5,20,19,1,19
Universitate,3946,4,3,7,4,15,19,-4,16
FC Botosani,3946,5,3,4,7,6,15,-9,13
Concordia Ch,3946,6,3,2,9,16,23,-7,11
FCSB,3947,1,7,6,1,26,14,12,27
CFR Cluj,3947,2,6,7,1,14,7,7,25
D Bucuresti,3947,3,4,5,5,18,19,-1,17
Universitate,3947,4,3,7,4,17,21,-4,16
FC Botosani,3947,5,3,6,5,6,13,-7,15
Concordia Ch,3947,6,2,3,9,17,24,-7,9
FCSB,3948,1,8,5,1,24,11,13,29
CFR Cluj,3948,2,7,6,1,16,8,8,27
FC Botosani,3948,3,5,4,5,9,12,-3,19
Universitate,3948,4,3,5,6,15,21,-6,14
D Bucuresti,3948,5,3,4,7,16,22,-6,13
Concordia Ch,3948,6,3,2,9,17,23,-6,11
FCSB,3949,1,7,6,1,26,14,12,27
CFR Cluj,3949,2,7,6,1,18,9,9,27
D Bucuresti,3949,3,4,5,5,19,20,-1,17
Universitate,3949,4,3,6,5,15,21,-6,15
FC Botosani,3949,5,3,4,7,6,15,-9,13
Concordia Ch,3949,6,3,3,8,19,24,-5,12
FCSB,3950,1,8,6,0,27,11,16,30
CFR Cluj,3950,2,5,7,2,14,11,3,22
FC Botosani,3950,3,5,4,5,8,13,-5,19
D Bucuresti,3950,4,4,4,6,18,20,-2,16
Universitate,3950,5,3,7,4,16,20,-4,16
Concordia Ch,3950,6,2,2,10,15,23,-8,8
FCSB,3951,1,9,5,0,28,12,16,32
CFR Cluj,3951,2,6,6,2,15,8,7,24
FC Botosani,3951,3,5,4,5,11,15,-4,19
D Bucuresti,3951,4,3,5,6,18,21,-3,14
Universitate,3951,5,3,5,6,16,24,-8,14
Concordia Ch,3951,6,2,3,9,18,26,-8,9
FCSB,3952,1,8,5,1,25,12,13,29
CFR Cluj,3952,2,6,6,2,16,10,6,24
Universitate,3952,3,4,5,5,16,20,-4,17
D Bucuresti,3952,4,4,4,6,17,21,-4,16
FC Botosani,3952,5,4,4,6,8,13,-5,16
Concordia Ch,3952,6,3,2,9,18,24,-6,11
FCSB,3953,1,8,5,1,26,12,14,29
CFR Cluj,3953,2,5,6,3,14,12,2,21
Universitate,3953,3,5,5,4,17,18,-1,20
D Bucuresti,3953,4,4,5,5,19,20,-1,17
FC Botosani,3953,5,4,4,6,7,13,-6,16
Concordia Ch,3953,6,2,3,9,17,25,-8,9
FCSB,3954,1,8,5,1,24,11,13,29
CFR Cluj,3954,2,6,7,1,14,7,7,25
D Bucuresti,3954,3,5,4,5,19,18,1,19
Universitate,3954,4,3,6,5,14,19,-5,15
FC Botosani,3954,5,3,5,6,5,13,-8,14
Concordia Ch,3954,6,2,3,9,15,23,-8,9
FCSB,3955,1,7,6,1,24,14,10,27
CFR Cluj,3955,2,6,7,1,16,9,7,25
Universitate,3955,3,4,5,5,18,20,-2,17
D Bucuresti,3955,4,4,4,6,18,19,-1,16
FC Botosani,3955,5,3,5,6,5,14,-9,14
Concordia Ch,3955,6,3,3,8,16,21,-5,12
FCSB,3956,1,9,5,0,28,12,16,32
CFR Cluj,3956,2,5,7,2,13,9,4,22
D Bucuresti,3956,3,4,5,5,18,19,-1,17
Universitate,3956,4,3,6,5,16,21,-5,15
FC Botosani,3956,5,3,5,6,5,13,-8,14
Concordia Ch,3956,6,2,4,8,16,22,-6,10
FCSB,3957,1,8,5,1,27,12,15,29
CFR Cluj,3957,2,6,6,2,15,11,4,24
FC Botosani,3957,3,4,5,5,9,12,-3,17
Universitate,3957,4,4,5,5,15,19,-4,17
D Bucuresti,3957,5,3,6,5,16,18,-2,15
Concordia Ch,3957,6,2,3,9,15,25,-10,9
FCSB,3958,1,8,6,0,28,12,16,30
CFR Cluj,3958,2,6,7,1,16,9,7,25
FC Botosani,3958,3,4,5,5,9,14,-5,17
D Bucuresti,3958,4,4,4,6,19,22,-3,16
Universitate,3958,5,3,5,6,16,24,-8,14
Concordia Ch,3958,6,2,3,9,17,24,-7,9
CFR Cluj,3959,1,7,6,1,16,8,8,27
FCSB,3959,2,7,5,2,25,14,11,26
D Bucuresti,3959,3,4,5,5,21,20,1,17
Universitate,3959,4,4,5,5,16,20,-4,17
FC Botosani,3959,5,4,5,5,9,15,-6,17
Concordia Ch,3959,6,2,2,10,18,28,-10,8
FCSB,3960,1,8,5,1,25,13,12,29
CFR Cluj,3960,2,6,6,2,15,9,6,24
D Bucuresti,3960,3,4,5,5,17,18,-1,17
Universitate,3960,4,4,5,5,17,20,-3,17
FC Botosani,3960,5,3,6,5,5,12,-7,15
Concordia Ch,3960,6,2,3,9,15,22,-7,9
FCSB,3961,1,9,5,0,29,12,17,32
CFR Cluj,3961,2,5,6,3,14,13,1,21
FC Botosani,3961,3,5,4,5,11,14,-3,19
Universitate,3961,4,4,5,5,18,21,-3,17
D Bucuresti,3961,5,3,5,6,17,21,-4,14
Concordia Ch,3961,6,2,3,9,18,26,-8,9
FCSB,3962,1,8,6,0,29,14,15,30
CFR Cluj,3962,2,5,7,2,14,10,4,22
D Bucuresti,3962,3,4,5,5,18,19,-1,17
Universitate,3962,4,3,7,4,17,21,-4,16
FC Botosani,3962,5,3,6,5,6,13,-7,15
Concordia Ch,3962,6,2,3,9,17,24,-7,9
FCSB,3963,1,8,6,0,27,12,15,30
CFR Cluj,3963,2,5,7,2,15,11,4,22
Universitate,3963,3,3,7,4,16,20,-4,16
FC Botosani,3963,4,3,6,5,7,14,-7,15
D Bucuresti,3963,5,3,5,6,18,21,-3,14
Concordia Ch,3963,6,3,3,8,16,21,-5,12
FCSB,3964,1,7,6,1,25,13,12,27
CFR Cluj,3964,2,5,8,1,17,11,6,23
D Bucuresti,3964,3,5,4,5,23,18,5,19
Universitate,3964,4,4,6,4,17,20,-3,18
FC Botosani,3964,5,3,5,6,5,15,-10,14
Concordia Ch,3964,6,2,3,9,15,25,-10,9
FCSB,3965,1,8,5,1,25,12,13,29
CFR Cluj,3965,2,5,7,2,14,9,5,22
Universitate,3965,3,4,6,4,17,20,-3,18
D Bucuresti,3965,4,4,5,5,18,19,-1,17
FC Botosani,3965,5,3,5,6,8,16,-8,14
Concordia Ch,3965,6,2,4,8,17,23,-6,10
FCSB,3966,1,7,7,0,24,11,13,28
CFR Cluj,3966,2,5,8,1,14,8,6,23
D Bucuresti,3966,3,5,4,5,19,18,1,19
Universitate,3966,4,3,7,4,16,20,-4,16
FC Botosani,3966,5,4,4,6,8,13,-5,16
Concordia Ch,3966,6,2,2,10,15,26,-11,8
FCSB,3967,1,7,6,1,23,11,12,27
CFR Cluj,3967,2,6,6,2,15,9,6,24
Universitate,3967,3,4,6,4,16,19,-3,18
D Bucuresti,3967,4,4,4,6,18,22,-4,16
Concordia Ch,3967,5,4,2,8,21,22,-1,14
FC Botosani,3967,6,3,4,7,7,17,-10,13
FCSB,3968,1,7,6,1,24,12,12,27
CFR Cluj,3968,2,7,6,1,16,8,8,27
D Bucuresti,3968,3,4,5,5,21,20,1,17
FC Botosani,3968,4,4,5,5,10,14,-4,17
Universitate,3968,5,3,6,5,14,19,-5,15
Concordia Ch,3968,6,2,2,10,17,29,-12,8
FCSB,3969,1,8,6,0,25,11,14,30
CFR Cluj,3969,2,5,7,2,14,9,5,22
Universitate,3969,3,4,5,5,15,19,-4,17
Concordia Ch,3969,4,4,2,8,20,23,-3,14
D Bucuresti,3969,5,3,5,6,18,21,-3,14
FC Botosani,3969,6,3,5,6,7,16,-9,14
FCSB,3970,1,9,5,0,27,11,16,32
CFR Cluj,3970,2,6,6,2,15,9,6,24
D Bucuresti,3970,3,4,4,6,19,20,-1,16
FC Botosani,3970,4,4,4,6,9,14,-5,16
Universitate,3970,5,3,5,6,15,22,-7,14
Concordia Ch,3970,6,3,2,9,17,26,-9,11
FCSB,3971,1,8,5,1,25,12,13,29
CFR Cluj,3971,2,5,6,3,13,9,4,21
Universitate,3971,3,5,5,4,17,19,-2,20
D Bucuresti,3971,4,4,4,6,17,20,-3,16
FC Botosani,3971,5,4,4,6,7,14,-7,16
Concordia Ch,3971,6,3,2,9,17,22,-5,11
FCSB,3972,1,7,6,1,23,11,12,27
CFR Cluj,3972,2,5,8,1,14,8,6,23
Universitate,3972,3,4,6,4,16,19,-3,18
FC Botosani,3972,4,4,5,5,10,15,-5,17
D Bucuresti,3972,5,3,5,6,19,23,-4,14
Concordia Ch,3972,6,2,4,8,17,23,-6,10
CFR Cluj,3973,1,7,6,1,15,7,8,27
FCSB,3973,2,7,5,2,24,13,11,26
Universitate,3973,3,4,5,5,16,20,-4,17
D Bucuresti,3973,4,4,4,6,18,21,-3,16
FC Botosani,3973,5,3,5,6,5,13,-8,14
Concordia Ch,3973,6,3,3,8,18,22,-4,12
FCSB,3974,1,8,6,0,26,12,14,30
CFR Cluj,3974,2,6,6,2,16,9,7,24
Universitate,3974,3,3,6,5,15,21,-6,15
D Bucuresti,3974,4,3,5,6,17,20,-3,14
Concordia Ch,3974,5,4,2,8,17,21,-4,14
FC Botosani,3974,6,3,5,6,6,14,-8,14
FCSB,3975,1,8,5,1,25,12,13,29
CFR Cluj,3975,2,6,6,2,16,9,7,24
Universitate,3975,3,4,5,5,15,20,-5,17
FC Botosani,3975,4,4,5,5,7,13,-6,17
D Bucuresti,3975,5,3,6,5,19,21,-2,15
Concordia Ch,3975,6,2,3,9,17,24,-7,9
FCSB,3976,1,7,6,1,24,12,12,27
CFR Cluj,3976,2,6,7,1,14,7,7,25
D Bucuresti,3976,3,4,5,5,17,18,-1,17
Universitate,3976,4,4,5,5,16,20,-4,17
FC Botosani,3976,5,3,5,6,6,14,-8,14
Concordia Ch,3976,6,3,2,9,17,23,-6,11
FCSB,3977,1,8,6,0,25,11,14,30
CFR Cluj,3977,2,6,6,2,15,8,7,24
D Bucuresti,3977,3,4,4,6,17,21,-4,16
Universitate,3977,4,3,6,5,15,21,-6,15
FC Botosani,3977,5,3,5,6,5,13,-8,14
Concordia Ch,3977,6,3,3,8,18,21,-3,12
FCSB,3978,1,8,5,1,24,13,11,29
CFR Cluj,3978,2,5,6,3,15,11,4,21
Universitate,3978,3,5,5,4,20,20,0,20
FC Botosani,3978,4,4,4,6,7,14,-7,16
D Bucuresti,3978,5,3,5,6,18,21,-3,14
Concordia Ch,3978,6,3,3,8,17,22,-5,12
FCSB,3979,1,8,6,0,25,11,14,30
CFR Cluj,3979,2,5,8,1,14,8,6,23
D Bucuresti,3979,3,4,4,6,18,19,-1,16
FC Botosani,3979,4,4,4,6,9,14,-5,16
Universitate,3979,5,3,6,5,16,21,-5,15
Concordia Ch,3979,6,3,2,9,16,25,-9,11
FCSB,3980,1,7,7,0,24,11,13,28
CFR Cluj,3980,2,5,8,1,15,9,6,23
D Bucuresti,3980,3,4,4,6,17,20,-3,16
Universitate,3980,4,3,7,4,17,21,-4,16
FC Botosani,3980,5,4,4,6,6,13,-7,16
Concordia Ch,3980,6,3,2,9,17,22,-5,11
FCSB,3981,1,8,6,0,27,13,14,30
CFR Cluj,3981,2,6,6,2,17,8,9,24
D Bucuresti,3981,3,5,4,5,20,19,1,19
Universitate,3981,4,3,6,5,17,25,-8,15
FC Botosani,3981,5,3,4,7,6,15,-9,13
Concordia Ch,3981,6,3,2,9,18,25,-7,11
FCSB,3982,1,7,6,1,25,13,12,27
CFR Cluj,3982,2,6,7,1,15,8,7,25
D Bucuresti,3982,3,5,4,5,24,23,1,19
Universitate,3982,4,4,5,5,16,20,-4,17
FC Botosani,3982,5,3,4,7,8,19,-11,13
Concordia Ch,3982,6,3,2,9,21,26,-5,11
FCSB,3983,1,8,5,1,26,13,13,29
CFR Cluj,3983,2,5,7,2,14,9,5,22
FC Botosani,3983,3,5,4,5,9,13,-4,19
Universitate,3983,4,4,6,4,16,19,-3,18
D Bucuresti,3983,5,3,5,6,16,20,-4,14
Concordia Ch,3983,6,2,3,9,16,23,-7,9
FCSB,3984,1,7,5,2,24,14,10,26
CFR Cluj,3984,2,6,7,1,15,8,7,25
Universitate,3984,3,4,6,4,16,18,-2,18
D Bucuresti,3984,4,4,4,6,19,23,-4,16
FC Botosani,3984,5,4,4,6,9,16,-7,16
Concordia Ch,3984,6,3,2,9,19,23,-4,11
FCSB,3985,1,8,6,0,24,10,14,30
CFR Cluj,3985,2,6,7,1,14,7,7,25
D Bucuresti,3985,3,4,4,6,18,21,-3,16
FC Botosani,3985,4,4,4,6,7,14,-7,16
Universitate,3985,5,3,5,6,14,20,-6,14
Concordia Ch,3985,6,3,2,9,19,24,-5,11
FCSB,3986,1,8,6,0,24,10,14,30
CFR Cluj,3986,2,5,8,1,13,7,6,23
FC Botosani,3986,3,5,4,5,9,14,-5,19
Universitate,3986,4,3,6,5,14,19,-5,15
D Bucuresti,3986,5,3,5,6,17,20,-3,14
Concordia Ch,3986,6,2,3,9,18,25,-7,9
FCSB,3987,1,7,5,2,26,15,11,26
CFR Cluj,3987,2,6,6,2,17,12,5,24
Universitate,3987,3,5,5,4,19,20,-1,20
FC Botosani,3987,4,4,5,5,8,13,-5,17
D Bucuresti,3987,5,3,5,6,19,22,-3,14
Concordia Ch,3987,6,3,2,9,18,25,-7,11
FCSB,3988,1,8,6,0,24,10,14,30
CFR Cluj,3988,2,6,7,1,15,8,7,25
D Bucuresti,3988,3,4,5,5,21,19,2,17
Universitate,3988,4,3,5,6,15,21,-6,14
FC Botosani,3988,5,3,4,7,6,19,-13,13
Concordia Ch,3988,6,3,3,8,19,23,-4,12
FCSB,3989,1,7,6,1,24,12,12,27
CFR Cluj,3989,2,5,8,1,13,7,6,23
D Bucuresti,3989,3,5,4,5,23,18,5,19
Universitate,3989,4,4,6,4,16,19,-3,18
FC Botosani,3989,5,3,5,6,5,16,-11,14
Concordia Ch,3989,6,2,3,9,15,24,-9,9
FCSB,3990,1,7,7,0,24,11,13,28
CFR Cluj,3990,2,5,8,1,15,9,6,23
D Bucuresti,3990,3,4,4,6,20,21,-1,16
Universitate,3990,4,3,7,4,15,19,-4,16
Concordia Ch,3990,5,4,2,8,19,23,-4,14
FC Botosani,3990,6,3,4,7,7,17,-10,13
FCSB,3991,1,8,5,1,29,12,17,29
CFR Cluj,3991,2,5,6,3,13,13,0,21
Universitate,3991,3,5,5,4,17,19,-2,20
FC Botosani,3991,4,4,5,5,6,12,-6,17
D Bucuresti,3991,5,3,5,6,17,21,-4,14
Concordia Ch,3991,6,3,2,9,18,23,-5,11
CFR Cluj,3992,1,7,6,1,17,8,9,27
FCSB,3992,2,7,5,2,23,14,9,26
D Bucuresti,3992,3,4,5,5,18,19,-1,17
Universitate,3992,4,4,5,5,17,20,-3,17
FC Botosani,3992,5,4,4,6,8,13,-5,16
Concordia Ch,3992,6,2,3,9,16,25,-9,9
FCSB,3993,1,7,6,1,26,14,12,27
CFR Cluj,3993,2,6,7,1,15,8,7,25
Universitate,3993,3,4,5,5,19,23,-4,17
FC Botosani,3993,4,4,4,6,6,14,-8,16
D Bucuresti,3993,5,3,5,6,18,21,-3,14
Concordia Ch,3993,6,3,3,8,19,23,-4,12
FCSB,3994,1,8,6,0,27,11,16,30
CFR Cluj,3994,2,6,7,1,16,9,7,25
D Bucuresti,3994,3,5,4,5,23,22,1,19
Universitate,3994,4,3,5,6,15,23,-8,14
FC Botosani,3994,5,3,5,6,6,15,-9,14
Concordia Ch,3994,6,2,3,9,18,25,-7,9
FCSB,3995,1,8,5,1,27,12,15,29
CFR Cluj,3995,2,6,6,2,15,10,5,24
D Bucuresti,3995,3,5,4,5,23,20,3,19
Universitate,3995,4,4,5,5,16,21,-5,17
FC Botosani,3995,5,4,4,6,8,16,-8,16
Concordia Ch,3995,6,2,2,10,17,27,-10,8
FCSB,3996,1,8,5,1,25,12,13,29
CFR Cluj,3996,2,5,7,2,15,10,5,22
Universitate,3996,3,4,6,4,16,19,-3,18
D Bucuresti,3996,4,4,4,6,18,19,-1,16
Concordia Ch,3996,5,4,2,8,18,22,-4,14
FC Botosani,3996,6,3,4,7,6,16,-10,13
FCSB,3997,1,9,5,0,26,11,15,32
CFR Cluj,3997,2,6,6,2,14,8,6,24
D Bucuresti,3997,3,5,4,5,21,19,2,19
Universitate,3997,4,3,5,6,15,21,-6,14
FC Botosani,3997,5,3,4,7,5,16,-11,13
Concordia Ch,3997,6,3,2,9,17,23,-6,11
FCSB,3998,1,8,5,1,25,14,11,29
CFR Cluj,3998,2,6,6,2,14,9,5,24
Universitate,3998,3,4,5,5,18,19,-1,17
D Bucuresti,3998,4,4,4,6,20,24,-4,16
FC Botosani,3998,5,4,4,6,10,14,-4,16
Concordia Ch,3998,6,3,2,9,20,27,-7,11
FCSB,3999,1,8,6,0,27,11,16,30
CFR Cluj,3999,2,6,7,1,19,9,10,25
D Bucuresti,3999,3,5,4,5,20,18,2,19
FC Botosani,3999,4,4,4,6,7,13,-6,16
Universitate,3999,5,3,5,6,15,26,-11,14
Concordia Ch,3999,6,2,2,10,15,26,-11,8
FCSB,4000,1,9,5,0,28,13,15,32
CFR Cluj,4000,2,6,6,2,17,11,6,24
FC Botosani,4000,3,4,5,5,7,13,-6,17
Universitate,4000,4,3,5,6,16,22,-6,14
D Bucuresti,4000,5,3,4,7,17,23,-6,13
Concordia Ch,4000,6,3,3,8,20,23,-3,12
FCSB,4001,1,7,6,1,27,15,12,27
CFR Cluj,4001,2,6,6,2,16,10,6,24
Universitate,4001,3,4,6,4,17,20,-3,18
FC Botosani,4001,4,4,5,5,8,12,-4,17
D Bucuresti,4001,5,3,6,5,18,20,-2,15
Concordia Ch,4001,6,2,3,9,17,26,-9,9
FCSB,4002,1,7,5,2,24,15,9,26
CFR Cluj,4002,2,6,6,2,15,9,6,24
Universitate,4002,3,5,5,4,20,20,0,20
D Bucuresti,4002,4,4,4,6,18,22,-4,16
FC Botosani,4002,5,4,4,6,7,13,-6,16
Concordia Ch,4002,6,3,2,9,19,24,-5,11
FCSB,4003,1,7,6,1,23,12,11,27
CFR Cluj,4003,2,6,7,1,17,9,8,25
D Bucuresti,4003,3,5,4,5,22,21,1,19
Universitate,4003,4,3,7,4,16,20,-4,16
FC Botosani,4003,5,3,5,6,7,16,-9,14
Concordia Ch,4003,6,2,3,9,18,25,-7,9
FCSB,4004,1,8,5,1,26,13,13,29
CFR Cluj,4004,2,7,6,1,16,8,8,27
D Bucuresti,4004,3,5,4,5,19,18,1,19
Universitate,4004,4,3,5,6,17,23,-6,14
FC Botosani,4004,5,3,5,6,6,14,-8,14
Concordia Ch,4004,6,2,3,9,16,24,-8,9
FCSB,4005,1,8,6,0,27,11,16,30
CFR Cluj,4005,2,5,7,2,15,12,3,22
D Bucuresti,4005,3,4,4,6,18,20,-2,16
Universitate,4005,4,3,7,4,17,21,-4,16
Concordia Ch,4005,5,4,2,8,18,21,-3,14
FC Botosani,4005,6,3,4,7,5,15,-10,13
FCSB,4006,1,8,5,1,25,14,11,29
CFR Cluj,4006,2,5,7,2,15,10,5,22
Universitate,4006,3,4,6,4,20,21,-1,18
D Bucuresti,4006,4,4,4,6,20,21,-1,16
Concordia Ch,4006,5,4,2,8,20,23,-3,14
FC Botosani,4006,6,3,4,7,6,17,-11,13
FCSB,4007,1,8,5,1,25,12,13,29
CFR Cluj,4007,2,7,6,1,17,7,10,27
FC Botosani,4007,3,4,5,5,8,12,-4,17
D Bucuresti,4007,4,3,5,6,16,20,-4,14
Universitate,4007,5,3,5,6,15,23,-8,14
Concordia Ch,4007,6,3,2,9,17,24,-7,11
FCSB,4008,1,9,5,0,27,11,16,32
CFR Cluj,4008,2,6,6,2,17,11,6,24
D Bucuresti,4008,3,4,5,5,20,21,-1,17
FC Botosani,4008,4,4,4,6,7,14,-7,16
Universitate,4008,5,3,5,6,15,22,-7,14
Concordia Ch,4008,6,2,3,9,19,26,-7,9
FCSB,4009,1,7,7,0,26,13,13,28
CFR Cluj,4009,2,5,8,1,14,8,6,23
D Bucuresti,4009,3,4,5,5,18,19,-1,17
FC Botosani,4009,4,4,5,5,7,13,-6,17
Universitate,4009,5,3,7,4,16,20,-4,16
Concordia Ch,4009,6,2,2,10,17,25,-8,8
FCSB,4010,1,9,5,0,31,11,20,32
CFR Cluj,4010,2,6,6,2,15,12,3,24
FC Botosani,4010,3,4,4,6,6,13,-7,16
Concordia Ch,4010,4,4,2,8,18,22,-4,14
Universitate,4010,5,3,5,6,15,23,-8,14
D Bucuresti,4010,6,3,4,7,17,21,-4,13
FCSB,4011,1,9,5,0,26,10,16,32
CFR Cluj,4011,2,5,6,3,14,11,3,21
D Bucuresti,4011,3,4,5,5,19,20,-1,17
Universitate,4011,4,4,5,5,16,20,-4,17
FC Botosani,4011,5,3,4,7,7,16,-9,13
Concordia Ch,4011,6,3,3,8,18,23,-5,12
FCSB,4012,1,9,5,0,26,11,15,32
CFR Cluj,4012,2,6,6,2,14,8,6,24
FC Botosani,4012,3,4,5,5,6,12,-6,17
D Bucuresti,4012,4,3,5,6,17,20,-3,14
Universitate,4012,5,3,5,6,15,21,-6,14
Concordia Ch,4012,6,3,2,9,17,23,-6,11
FCSB,4013,1,8,5,1,25,13,12,29
CFR Cluj,4013,2,6,6,2,14,8,6,24
Universitate,4013,3,4,5,5,17,20,-3,17
FC Botosani,4013,4,4,5,5,6,12,-6,17
D Bucuresti,4013,5,3,5,6,16,19,-3,14
Concordia Ch,4013,6,3,2,9,16,22,-6,11
FCSB,4014,1,9,5,0,27,11,16,32
CFR Cluj,4014,2,6,6,2,15,10,5,24
FC Botosani,4014,3,5,4,5,10,13,-3,19
D Bucuresti,4014,4,4,4,6,19,21,-2,16
Universitate,4014,5,3,5,6,14,20,-6,14
Concordia Ch,4014,6,2,2,10,15,25,-10,8
FCSB,4015,1,7,6,1,26,14,12,27
CFR Cluj,4015,2,6,7,1,17,10,7,25
D Bucuresti,4015,3,4,4,6,18,21,-3,16
Universitate,4015,4,3,7,4,18,22,-4,16
Concordia Ch,4015,5,4,2,8,22,22,0,14
FC Botosani,4015,6,3,4,7,5,17,-12,13
FCSB,4016,1,8,5,1,25,14,11,29
CFR Cluj,4016,2,6,6,2,14,8,6,24
D Bucuresti,4016,3,4,5,5,20,21,-1,17
Universitate,4016,4,4,5,5,18,20,-2,17
FC Botosani,4016,5,3,4,7,6,16,-10,13
Concordia Ch,4016,6,3,3,8,21,25,-4,12
FCSB,4017,1,9,5,0,28,11,17,32
CFR Cluj,4017,2,6,6,2,15,11,4,24
FC Botosani,4017,3,4,5,5,8,14,-6,17
D Bucuresti,4017,4,3,5,6,17,21,-4,14
Universitate,4017,5,3,5,6,14,20,-6,14
Concordia Ch,4017,6,3,2,9,18,23,-5,11
FCSB,4018,1,8,5,1,26,12,14,29
CFR Cluj,4018,2,5,6,3,14,11,3,21
Universitate,4018,3,5,5,4,18,20,-2,20
D Bucuresti,4018,4,4,5,5,20,20,0,17
FC Botosani,4018,5,3,4,7,5,15,-10,13
Concordia Ch,4018,6,3,3,8,18,23,-5,12
FCSB,4019,1,8,6,0,24,10,14,30
CFR Cluj,4019,2,6,6,2,15,9,6,24
FC Botosani,4019,3,5,4,5,8,13,-5,19
D Bucuresti,4019,4,4,4,6,19,20,-1,16
Universitate,4019,5,3,6,5,15,20,-5,15
Concordia Ch,4019,6,2,2,10,15,24,-9,8
FCSB,4020,1,8,5,1,24,11,13,29
CFR Cluj,4020,2,7,6,1,15,7,8,27
FC Botosani,4020,3,4,5,5,7,13,-6,17
D Bucuresti,4020,4,3,6,5,18,20,-2,15
Universitate,4020,5,3,5,6,14,20,-6,14
Concordia Ch,4020,6,2,3,9,16,23,-7,9
FCSB,4021,1,8,5,1,25,12,13,29
CFR Cluj,4021,2,6,6,2,14,8,6,24
FC Botosani,4021,3,5,4,5,8,13,-5,19
Universitate,4021,4,4,5,5,16,20,-4,17
D Bucuresti,4021,5,3,5,6,16,19,-3,14
Concordia Ch,4021,6,2,3,9,16,23,-7,9
FCSB,4022,1,8,5,1,26,15,11,29
CFR Cluj,4022,2,5,6,3,14,12,2,21
Universitate,4022,3,5,5,4,20,18,2,20
Concordia Ch,4022,4,4,2,8,20,23,-3,14
D Bucuresti,4022,5,3,5,6,17,20,-3,14
FC Botosani,4022,6,3,5,6,8,17,-9,14
FCSB,4023,1,8,5,1,28,13,15,29
CFR Cluj,4023,2,6,6,2,15,9,6,24
D Bucuresti,4023,3,4,5,5,21,19,2,17
Universitate,4023,4,4,5,5,18,24,-6,17
FC Botosani,4023,5,3,5,6,5,16,-11,14
Concordia Ch,4023,6,2,4,8,16,22,-6,10
FCSB,4024,1,9,5,0,29,10,19,32
CFR Cluj,4024,2,6,6,2,14,12,2,24
FC Botosani,4024,3,4,4,6,9,15,-6,16
Concordia Ch,4024,4,4,2,8,19,23,-4,14
Universitate,4024,5,3,5,6,14,20,-6,14
D Bucuresti,4024,6,3,4,7,18,23,-5,13
CFR Cluj,4025,1,7,6,1,17,8,9,27
FCSB,4025,2,7,5,2,26,15,11,26
D Bucuresti,4025,3,5,4,5,23,19,4,19
Universitate,4025,4,4,5,5,17,22,-5,17
FC Botosani,4025,5,3,4,7,5,17,-12,13
Concordia Ch,4025,6,3,2,9,17,24,-7,11
FCSB,4026,1,7,6,1,24,12,12,27
CFR Cluj,4026,2,6,7,1,17,8,9,25
Universitate,4026,3,4,5,5,15,21,-6,17
FC Botosani,4026,4,4,5,5,6,12,-6,17
D Bucuresti,4026,5,3,4,7,16,20,-4,13
Concordia Ch,4026,6,3,3,8,16,21,-5,12
FCSB,4027,1,8,5,1,25,12,13,29
CFR Cluj,4027,2,6,7,1,14,7,7,25
D Bucuresti,4027,3,4,4,6,17,19,-2,16
Universitate,4027,4,3,6,5,15,20,-5,15
FC Botosani,4027,5,3,5,6,5,13,-8,14
Concordia Ch,4027,6,3,3,8,16,21,-5,12
FCSB,4028,1,7,6,1,23,11,12,27
CFR Cluj,4028,2,5,8,1,16,10,6,23
Universitate,4028,3,4,6,4,18,21,-3,18
Concordia Ch,4028,4,4,2,8,20,22,-2,14
D Bucuresti,4028,5,3,5,6,19,22,-3,14
FC Botosani,4028,6,3,5,6,7,17,-10,14
FCSB,4029,1,8,5,1,25,11,14,29
CFR Cluj,4029,2,5,7,2,13,9,4,22
Universitate,4029,3,4,6,4,15,18,-3,18
D Bucuresti,4029,4,4,5,5,19,19,0,17
FC Botosani,4029,5,3,4,7,6,16,-10,13
Concordia Ch,4029,6,3,3,8,18,23,-5,12
FCSB,4030,1,7,7,0,26,13,13,28
CFR Cluj,4030,2,6,7,1,16,9,7,25
D Bucuresti,4030,3,5,4,5,21,19,2,19
Universitate,4030,4,3,6,5,15,20,-5,15
FC Botosani,4030,5,3,4,7,6,17,-11,13
Concordia Ch,4030,6,3,2,9,17,23,-6,11
FCSB,4031,1,8,5,1,25,11,14,29
CFR Cluj,4031,2,6,6,2,14,9,5,24
FC Botosani,4031,3,5,4,5,10,12,-2,19
Universitate,4031,4,4,5,5,15,19,-4,17
D Bucuresti,4031,5,3,4,7,17,23,-6,13
Concordia Ch,4031,6,3,2,9,17,24,-7,11
FCSB,4032,1,7,6,1,24,12,12,27
CFR Cluj,4032,2,6,6,2,15,9,6,24
D Bucuresti,4032,3,5,4,5,22,21,1,19
Universitate,4032,4,4,6,4,17,20,-3,18
FC Botosani,4032,5,4,4,6,9,14,-5,16
Concordia Ch,4032,6,2,2,10,17,28,-11,8
FCSB,4033,1,9,5,0,27,10,17,32
CFR Cluj,4033,2,5,7,2,14,10,4,22
FC Botosani,4033,3,4,5,5,8,14,-6,17
Universitate,4033,4,3,6,5,15,21,-6,15
D Bucuresti,4033,5,3,5,6,18,22,-4,14
Concordia Ch,4033,6,3,2,9,19,24,-5,11
FCSB,4034,1,8,5,1,24,12,12,29
CFR Cluj,4034,2,6,6,2,15,9,6,24
D Bucuresti,4034,3,4,5,5,17,18,-1,17
Universitate,4034,4,4,5,5,17,20,-3,17
FC Botosani,4034,5,3,4,7,6,15,-9,13
Concordia Ch,4034,6,3,3,8,17,22,-5,12
FCSB,4035,1,8,5,1,26,11,15,29
CFR Cluj,4035,2,6,6,2,14,10,4,24
D Bucuresti,4035,3,5,4,5,23,21,2,19
Universitate,4035,4,4,5,5,15,19,-4,17
FC Botosani,4035,5,4,4,6,7,14,-7,16
Concordia Ch,4035,6,2,2,10,18,28,-10,8
FCSB,4036,1,8,5,1,24,11,13,29
CFR Cluj,4036,2,5,6,3,14,10,4,21
Universitate,4036,3,5,5,4,17,19,-2,20
D Bucuresti,4036,4,5,4,5,20,20,0,19
FC Botosani,4036,5,3,4,7,7,17,-10,13
Concordia Ch,4036,6,3,2,9,19,24,-5,11
FCSB,4037,1,7,5,2,25,16,9,26
CFR Cluj,4037,2,6,6,2,17,10,7,24
Universitate,4037,3,5,5,4,17,18,-1,20
D Bucuresti,4037,4,4,4,6,19,24,-5,16
FC Botosani,4037,5,3,5,6,6,15,-9,14
Concordia Ch,4037,6,3,3,8,20,21,-1,12
FCSB,4038,1,7,6,1,24,12,12,27
CFR Cluj,4038,2,6,7,1,16,9,7,25
D Bucuresti,4038,3,4,5,5,21,18,3,17
Universitate,4038,4,4,5,5,16,20,-4,17
FC Botosani,4038,5,4,4,6,8,17,-9,16
Concordia Ch,4038,6,2,3,9,15,24,-9,9
FCSB,4039,1,7,7,0,26,13,13,28
CFR Cluj,4039,2,6,7,1,19,10,9,25
D Bucuresti,4039,3,4,4,6,19,23,-4,16
FC Botosani,4039,4,4,4,6,8,15,-7,16
Universitate,4039,5,3,6,5,16,23,-7,15
Concordia Ch,4039,6,3,2,9,18,22,-4,11
CFR Cluj,4040,1,7,6,1,17,9,8,27
FCSB,4040,2,7,5,2,26,15,11,26
FC Botosani,4040,3,5,4,5,12,13,-1,19
Universitate,4040,4,4,5,5,16,20,-4,17
D Bucuresti,4040,5,3,4,7,16,22,-6,13
Concordia Ch,4040,6,3,2,9,17,25,-8,11
FCSB,4041,1,8,5,1,27,13,14,29
CFR Cluj,4041,2,5,7,2,14,11,3,22
Universitate,4041,3,4,6,4,18,20,-2,18
D Bucuresti,4041,4,4,5,5,17,18,-1,17
FC Botosani,4041,5,3,6,5,6,13,-7,15
Concordia Ch,4041,6,2,3,9,16,23,-7,9
FCSB,4042,1,8,6,0,25,11,14,30
CFR Cluj,4042,2,6,6,2,14,8,6,24
D Bucuresti,4042,3,4,5,5,17,18,-1,17
FC Botosani,4042,4,4,5,5,8,12,-4,17
Universitate,4042,5,3,6,5,15,20,-5,15
Concordia Ch,4042,6,2,2,10,15,25,-10,8
FCSB,4043,1,8,6,0,25,11,14,30
CFR Cluj,4043,2,6,7,1,16,8,8,25
FC Botosani,4043,3,4,5,5,8,14,-6,17
Universitate,4043,4,3,5,6,14,21,-7,14
D Bucuresti,4043,5,3,4,7,16,23,-7,13
Concordia Ch,4043,6,3,3,8,21,23,-2,12
FCSB,4044,1,9,5,0,27,12,15,32
CFR Cluj,4044,2,6,6,2,15,9,6,24
D Bucuresti,4044,3,4,4,6,22,25,-3,16
Concordia Ch,4044,4,4,2,8,21,22,-1,14
Universitate,4044,5,3,5,6,17,23,-6,14
FC Botosani,4044,6,3,4,7,7,18,-11,13
FCSB,4045,1,8,5,1,24,11,13,29
CFR Cluj,4045,2,5,7,2,14,9,5,22
Universitate,4045,3,4,6,4,16,19,-3,18
D Bucuresti,4045,4,4,4,6,19,20,-1,16
FC Botosani,4045,5,4,4,6,6,14,-8,16
Concordia Ch,4045,6,3,2,9,17,23,-6,11
FCSB,4046,1,8,6,0,27,12,15,30
CFR Cluj,4046,2,5,7,2,14,9,5,22
FC Botosani,4046,3,5,4,5,8,13,-5,19
Universitate,4046,4,4,5,5,16,21,-5,17
D Bucuresti,4046,5,4,4,6,18,20,-2,16
Concordia Ch,4046,6,2,2,10,15,23,-8,8
FCSB,4047,1,8,6,0,27,12,15,30
CFR Cluj,4047,2,6,6,2,17,10,7,24
D Bucuresti,4047,3,4,4,6,18,20,-2,16
FC Botosani,4047,4,4,4,6,7,14,-7,16
Universitate,4047,5,3,6,5,17,24,-7,15
Concordia Ch,4047,6,3,2,9,18,24,-6,11
CFR Cluj,4048,1,7,6,1,16,7,9,27
FCSB,4048,2,7,5,2,23,13,10,26
Universitate,4048,3,4,5,5,15,19,-4,17
FC Botosani,4048,4,4,5,5,8,14,-6,17
D Bucuresti,4048,5,3,5,6,17,21,-4,14
Concordia Ch,4048,6,3,2,9,18,23,-5,11
FCSB,4049,1,8,5,1,27,13,14,29
CFR Cluj,4049,2,6,6,2,15,11,4,24
Universitate,4049,3,4,5,5,17,20,-3,17
D Bucuresti,4049,4,3,6,5,16,18,-2,15
FC Botosani,4049,5,3,6,5,6,13,-7,15
Concordia Ch,4049,6,2,4,8,16,22,-6,10
FCSB,4050,1,9,5,0,28,10,18,32
CFR Cluj,4050,2,6,6,2,15,11,4,24
FC Botosani,4050,3,4,5,5,8,12,-4,17
D Bucuresti,4050,4,3,5,6,16,20,-4,14
Universitate,4050,5,3,5,6,14,21,-7,14
Concordia Ch,4050,6,3,2,9,17,24,-7,11
FCSB,4051,1,8,5,1,26,12,14,29
CFR Cluj,4051,2,7,6,1,19,8,11,27
FC Botosani,4051,3,5,4,5,9,14,-5,19
Universitate,4051,4,3,5,6,16,26,-10,14
D Bucuresti,4051,5,3,4,7,18,22,-4,13
Concordia Ch,4051,6,3,2,9,18,24,-6,11
FCSB,4052,1,8,5,1,27,13,14,29
CFR Cluj,4052,2,6,6,2,14,8,6,24
Universitate,4052,3,4,5,5,17,22,-5,17
FC Botosani,4052,4,3,6,5,7,14,-7,15
D Bucuresti,4052,5,3,5,6,17,20,-3,14
Concordia Ch,4052,6,3,3,8,17,22,-5,12
FCSB,4053,1,7,7,0,24,11,13,28
CFR Cluj,4053,2,5,7,2,15,11,4,22
Universitate,4053,3,4,6,4,17,19,-2,18
D Bucuresti,4053,4,4,5,5,18,18,0,17
FC Botosani,4053,5,3,5,6,5,14,-9,14
Concordia Ch,4053,6,2,4,8,15,21,-6,10
FCSB,4054,1,8,6,0,25,10,15,30
CFR Cluj,4054,2,6,7,1,15,8,7,25
FC Botosani,4054,3,4,4,6,6,13,-7,16
D Bucuresti,4054,4,3,5,6,16,19,-3,14
Universitate,4054,5,3,5,6,15,22,-7,14
Concordia Ch,4054,6,3,3,8,16,21,-5,12
FCSB,4055,1,8,5,1,24,11,13,29
CFR Cluj,4055,2,5,7,2,14,9,5,22
Universitate,4055,3,4,6,4,16,19,-3,18
FC Botosani,4055,4,4,5,5,6,12,-6,17
D Bucuresti,4055,5,3,6,5,18,20,-2,15
Concordia Ch,4055,6,2,3,9,17,24,-7,9
FCSB,4056,1,7,6,1,24,12,12,27
CFR Cluj,4056,2,5,7,2,14,9,5,22
Universitate,4056,3,5,5,4,16,18,-2,20
FC Botosani,4056,4,3,6,5,6,13,-7,15
D Bucuresti,4056,5,3,5,6,17,22,-5,14
Concordia Ch,4056,6,3,3,8,18,21,-3,12
FCSB,4057,1,8,5,1,26,12,14,29
CFR Cluj,4057,2,5,6,3,14,11,3,21
Universitate,4057,3,5,5,4,16,18,-2,20
D Bucuresti,4057,4,4,5,5,19,19,0,17
FC Botosani,4057,5,4,4,6,7,15,-8,16
Concordia Ch,4057,6,2,3,9,17,24,-7,9
FCSB,4058,1,8,5,1,24,11,13,29
CFR Cluj,4058,2,6,6,2,15,8,7,24
D Bucuresti,4058,3,5,4,5,18,18,0,19
Universitate,4058,4,4,5,5,15,20,-5,17
FC Botosani,4058,5,4,4,6,9,14,-5,16
Concordia Ch,4058,6,2,2,10,16,26,-10,8
FCSB,4059,1,7,7,0,24,11,13,28
CFR Cluj,4059,2,5,7,2,15,10,5,22
Universitate,4059,3,4,6,4,16,19,-3,18
FC Botosani,4059,4,4,4,6,6,14,-8,16
D Bucuresti,4059,5,3,5,6,18,21,-3,14
Concordia Ch,4059,6,3,3,8,19,23,-4,12
FCSB,4060,1,8,5,1,25,12,13,29
CFR Cluj,4060,2,6,6,2,14,8,6,24
Universitate,4060,3,4,5,5,16,20,-4,17
D Bucuresti,4060,4,4,4,6,21,21,0,16
FC Botosani,4060,5,4,4,6,7,16,-9,16
Concordia Ch,4060,6,3,2,9,19,25,-6,11
FCSB,4061,1,8,5,1,24,12,12,29
CFR Cluj,4061,2,7,6,1,16,7,9,27
FC Botosani,4061,3,5,4,5,8,13,-5,19
D Bucuresti,4061,4,4,4,6,18,20,-2,16
Universitate,4061,5,3,5,6,14,20,-6,14
Concordia Ch,4061,6,2,2,10,15,23,-8,8
FCSB,4062,1,7,5,2,23,13,10,26
CFR Cluj,4062,2,6,6,2,15,9,6,24
Universitate,4062,3,5,5,4,17,18,-1,20
FC Botosani,4062,4,4,5,5,7,13,-6,17
D Bucuresti,4062,5,3,4,7,16,20,-4,13
Concordia Ch,4062,6,3,3,8,17,22,-5,12
CFR Cluj,4063,1,7,6,1,16,8,8,27
FCSB,4063,2,7,5,2,24,14,10,26
D Bucuresti,4063,3,4,5,5,19,19,0,17
Universitate,4063,4,4,5,5,18,21,-3,17
FC Botosani,4063,5,4,4,6,7,15,-8,16
Concordia Ch,4063,6,2,3,9,17,24,-7,9
FCSB,4064,1,8,5,1,26,12,14,29
CFR Cluj,4064,2,6,6,2,17,10,7,24
D Bucuresti,4064,3,5,4,5,20,18,2,19
Universitate,4064,4,4,5,5,17,23,-6,17
FC Botosani,4064,5,3,5,6,6,15,-9,14
Concordia Ch,4064,6,2,3,9,16,24,-8,9
FCSB,4065,1,7,6,1,26,14,12,27
CFR Cluj,4065,2,5,8,1,14,8,6,23
Universitate,4065,3,4,6,4,17,20,-3,18
D Bucuresti,4065,4,4,4,6,18,22,-4,16
Concordia Ch,4065,5,4,2,8,20,21,-1,14
FC Botosani,4065,6,3,4,7,5,15,-10,13
FCSB,4066,1,8,5,1,27,12,15,29
CFR Cluj,4066,2,5,7,2,14,11,3,22
Universitate,4066,3,4,6,4,17,20,-3,18
D Bucuresti,4066,4,3,6,5,16,18,-2,15
FC Botosani,4066,5,3,5,6,5,14,-9,14
Concordia Ch,4066,6,3,3,8,17,21,-4,12
FCSB,4067,1,8,6,0,26,12,14,30
CFR Cluj,4067,2,6,7,1,16,9,7,25
D Bucuresti,4067,3,4,4,6,21,21,0,16
Concordia Ch,4067,4,4,2,8,19,23,-4,14
Universitate,4067,5,3,5,6,16,22,-6,14
FC Botosani,4067,6,3,4,7,5,16,-11,13
FCSB,4068,1,7,6,1,25,13,12,27
CFR Cluj,4068,2,6,7,1,15,8,7,25
D Bucuresti,4068,3,5,4,5,21,19,2,19
Universitate,4068,4,3,7,4,15,19,-4,16
FC Botosani,4068,5,3,5,6,6,15,-9,14
Concordia Ch,4068,6,2,3,9,15,23,-8,9
FCSB,4069,1,8,6,0,26,12,14,30
CFR Cluj,4069,2,5,6,3,15,11,4,21
Universitate,4069,3,4,6,4,17,20,-3,18
FC Botosani,4069,4,4,5,5,7,13,-6,17
D Bucuresti,4069,5,3,5,6,19,22,-3,14
Concordia Ch,4069,6,3,2,9,18,24,-6,11
FCSB,4070,1,8,6,0,27,12,15,30
CFR Cluj,4070,2,5,6,3,14,11,3,21
Universitate,4070,3,4,6,4,18,21,-3,18
D Bucuresti,4070,4,4,4,6,20,22,-2,16
Concordia Ch,4070,5,4,2,8,21,24,-3,14
FC Botosani,4070,6,3,4,7,7,17,-10,13
FCSB,4071,1,9,5,0,27,10,17,32
CFR Cluj,4071,2,6,6,2,17,8,9,24
FC Botosani,4071,3,4,5,5,8,14,-6,17
D Bucuresti,4071,4,4,4,6,18,19,-1,16
Universitate,4071,5,3,5,6,14,25,-11,14
Concordia Ch,4071,6,2,3,9,17,25,-8,9
FCSB,4072,1,8,6,0,26,12,14,30
CFR Cluj,4072,2,5,7,2,16,12,4,22
Universitate,4072,3,4,5,5,17,20,-3,17
D Bucuresti,4072,4,4,4,6,19,22,-3,16
Concordia Ch,4072,5,4,2,8,20,23,-3,14
FC Botosani,4072,6,3,4,7,7,16,-9,13
FCSB,4073,1,7,7,0,23,10,13,28
CFR Cluj,4073,2,6,7,1,15,8,7,25
D Bucuresti,4073,3,3,6,5,17,19,-2,15
Universitate,4073,4,3,6,5,15,20,-5,15
FC Botosani,4073,5,3,5,6,6,14,-8,14
Concordia Ch,4073,6,3,3,8,16,21,-5,12
FCSB,4074,1,8,5,1,25,12,13,29
CFR Cluj,4074,2,7,6,1,17,7,10,27
FC Botosani,4074,3,4,5,5,8,13,-5,17
D Bucuresti,4074,4,3,5,6,17,21,-4,14
Universitate,4074,5,3,5,6,14,22,-8,14
Concordia Ch,4074,6,3,2,9,17,23,-6,11
FCSB,4075,1,9,5,0,29,11,18,32
CFR Cluj,4075,2,6,6,2,15,11,4,24
D Bucuresti,4075,3,4,4,6,18,19,-1,16
Universitate,4075,4,3,5,6,14,21,-7,14
FC Botosani,4075,5,3,5,6,7,16,-9,14
Concordia Ch,4075,6,3,3,8,18,23,-5,12
CFR Cluj,4076,1,7,6,1,18,7,11,27
FCSB,4076,2,7,5,2,24,16,8,26
Universitate,4076,3,4,5,5,16,20,-4,17
FC Botosani,4076,4,4,5,5,8,13,-5,17
D Bucuresti,4076,5,3,6,5,18,20,-2,15
Concordia Ch,4076,6,2,3,9,16,24,-8,9
FCSB,4077,1,8,6,0,27,10,17,30
CFR Cluj,4077,2,5,8,1,15,9,6,23
FC Botosani,4077,3,5,4,5,10,12,-2,19
D Bucuresti,4077,4,4,4,6,17,20,-3,16
Universitate,4077,5,3,6,5,16,24,-8,15
Concordia Ch,4077,6,2,2,10,15,25,-10,8
FCSB,4078,1,7,6,1,24,13,11,27
CFR Cluj,4078,2,6,6,2,15,8,7,24
Universitate,4078,3,4,6,4,16,19,-3,18
D Bucuresti,4078,4,4,5,5,18,19,-1,17
FC Botosani,4078,5,3,5,6,5,13,-8,14
Concordia Ch,4078,6,2,4,8,16,22,-6,10
FCSB,4079,1,8,6,0,26,12,14,30
CFR Cluj,4079,2,5,7,2,14,9,5,22
D Bucuresti,4079,3,4,4,6,20,22,-2,16
Universitate,4079,4,3,7,4,15,19,-4,16
FC Botosani,4079,5,4,4,6,8,14,-6,16
Concordia Ch,4079,6,3,2,9,18,25,-7,11
FCSB,4080,1,8,5,1,25,12,13,29
CFR Cluj,4080,2,5,6,3,14,11,3,21
Universitate,4080,3,5,5,4,18,19,-1,20
FC Botosani,4080,4,4,5,5,7,12,-5,17
D Bucuresti,4080,5,4,4,6,19,22,-3,16
Concordia Ch,4080,6,2,3,9,17,24,-7,9
FCSB,4081,1,8,5,1,25,12,13,29
CFR Cluj,4081,2,6,6,2,14,9,5,24
D Bucuresti,4081,3,4,5,5,17,18,-1,17
Universitate,4081,4,4,5,5,17,20,-3,17
FC Botosani,4081,5,4,4,6,7,14,-7,16
Concordia Ch,4081,6,2,3,9,16,23,-7,9
FCSB,4082,1,8,6,0,28,12,16,30
CFR Cluj,4082,2,5,6,3,15,13,2,21
D Bucuresti,4082,3,5,4,5,19,19,0,19
Universitate,4082,4,4,6,4,17,20,-3,18
FC Botosani,4082,5,3,5,6,8,16,-8,14
Concordia Ch,4082,6,2,3,9,17,24,-7,9
CFR Cluj,4083,1,7,6,1,17,7,10,27
FCSB,4083,2,7,5,2,24,14,10,26
Universitate,4083,3,4,5,5,16,21,-5,17
FC Botosani,4083,4,4,5,5,8,14,-6,17
D Bucuresti,4083,5,3,5,6,17,21,-4,14
Concordia Ch,4083,6,3,2,9,18,23,-5,11
FCSB,4084,1,8,6,0,28,13,15,30
CFR Cluj,4084,2,6,7,1,17,8,9,25
FC Botosani,4084,3,5,4,5,8,12,-4,19
Universitate,4084,4,3,5,6,16,25,-9,14
D Bucuresti,4084,5,3,4,7,16,20,-4,13
Concordia Ch,4084,6,3,2,9,16,23,-7,11
FCSB,4085,1,8,5,1,24,13,11,29
CFR Cluj,4085,2,6,7,1,17,8,9,25
FC Botosani,4085,3,4,5,5,11,14,-3,17
Universitate,4085,4,3,6,5,15,20,-5,15
D Bucuresti,4085,5,3,5,6,18,24,-6,14
Concordia Ch,4085,6,2,4,8,17,23,-6,10
FCSB,4086,1,8,6,0,27,12,15,30
CFR Cluj,4086,2,5,6,3,13,10,3,21
D Bucuresti,4086,3,5,4,5,20,20,0,19
Universitate,4086,4,4,6,4,17,20,-3,18
FC Botosani,4086,5,3,4,7,7,16,-9,13
Concordia Ch,4086,6,3,2,9,18,24,-6,11
FCSB,4087,1,8,5,1,24,11,13,29
CFR Cluj,4087,2,6,6,2,16,11,5,24
D Bucuresti,4087,3,4,5,5,19,19,0,17
Universitate,4087,4,4,5,5,18,21,-3,17
FC Botosani,4087,5,3,5,6,7,15,-8,14
Concordia Ch,4087,6,3,2,9,17,24,-7,11
FCSB,4088,1,7,6,1,25,13,12,27
CFR Cluj,4088,2,6,7,1,15,8,7,25
Universitate,4088,3,4,5,5,16,20,-4,17
D Bucuresti,4088,4,4,4,6,18,20,-2,16
FC Botosani,4088,5,4,4,6,7,13,-6,16
Concordia Ch,4088,6,3,2,9,17,24,-7,11
FCSB,4089,1,8,6,0,26,11,15,30
CFR Cluj,4089,2,5,8,1,13,7,6,23
D Bucuresti,4089,3,4,4,6,18,20,-2,16
FC Botosani,4089,4,4,4,6,7,15,-8,16
Universitate,4089,5,3,6,5,15,21,-6,15
Concordia Ch,4089,6,3,2,9,17,22,-5,11
FCSB,4090,1,7,6,1,24,12,12,27
CFR Cluj,4090,2,6,7,1,15,8,7,25
FC Botosani,4090,3,5,4,5,7,12,-5,19
Universitate,4090,4,4,5,5,15,19,-4,17
D Bucuresti,4090,5,3,5,6,17,20,-3,14
Concordia Ch,4090,6,2,3,9,16,23,-7,9
FCSB,4091,1,9,5,0,27,12,15,32
CFR Cluj,4091,2,6,6,2,15,9,6,24
D Bucuresti,4091,3,4,5,5,20,19,1,17
Universitate,4091,4,3,5,6,15,21,-6,14
FC Botosani,4091,5,3,5,6,5,15,-10,14
Concordia Ch,4091,6,2,4,8,16,22,-6,10
FCSB,4092,1,8,5,1,25,13,12,29
CFR Cluj,4092,2,5,7,2,14,9,5,22
Universitate,4092,3,4,6,4,18,20,-2,18
Concordia Ch,4092,4,4,2,8,19,22,-3,14
D Bucuresti,4092,5,3,5,6,18,22,-4,14
FC Botosani,4092,6,3,5,6,6,14,-8,14
FCSB,4093,1,8,5,1,24,12,12,29
CFR Cluj,4093,2,5,7,2,14,9,5,22
Universitate,4093,3,4,6,4,17,19,-2,18
FC Botosani,4093,4,4,5,5,8,13,-5,17
D Bucuresti,4093,5,3,5,6,17,20,-3,14
Concordia Ch,4093,6,3,2,9,18,25,-7,11
FCSB,4094,1,8,5,1,24,12,12,29
CFR Cluj,4094,2,6,6,2,16,10,6,24
D Bucuresti,4094,3,5,4,5,19,19,0,19
Universitate,4094,4,4,5,5,18,21,-3,17
FC Botosani,4094,5,3,4,7,6,15,-9,13
Concordia Ch,4094,6,3,2,9,18,24,-6,11
FCSB,4095,1,8,5,1,24,11,13,29
CFR Cluj,4095,2,6,6,2,15,8,7,24
Universitate,4095,3,4,5,5,15,20,-5,17
D Bucuresti,4095,4,4,4,6,17,20,-3,16
FC Botosani,4095,5,4,4,6,7,13,-6,16
Concordia Ch,4095,6,3,2,9,16,22,-6,11
FCSB,4096,1,8,5,1,27,12,15,29
CFR Cluj,4096,2,6,6,2,15,10,5,24
Universitate,4096,3,4,5,5,16,21,-5,17
D Bucuresti,4096,4,4,4,6,21,21,0,16
FC Botosani,4096,5,4,4,6,8,15,-7,16
Concordia Ch,4096,6,3,2,9,18,26,-8,11
FCSB,4097,1,9,5,0,29,12,17,32
CFR Cluj,4097,2,5,7,2,15,11,4,22
D Bucuresti,4097,3,5,4,5,19,18,1,19
FC Botosani,4097,4,4,4,6,6,13,-7,16
Universitate,4097,5,3,6,5,16,22,-6,15
Concordia Ch,4097,6,2,2,10,15,24,-9,8
FCSB,4098,1,7,6,1,26,16,10,27
CFR Cluj,4098,2,5,7,2,16,12,4,22
Universitate,4098,3,5,5,4,21,20,1,20
D Bucuresti,4098,4,4,4,6,20,21,-1,16
Concordia Ch,4098,5,4,2,8,19,22,-3,14
FC Botosani,4098,6,3,4,7,5,16,-11,13
FCSB,4099,1,8,6,0,26,11,15,30
CFR Cluj,4099,2,6,6,2,15,9,6,24
D Bucuresti,4099,3,4,4,6,18,19,-1,16
Universitate,4099,4,3,6,5,15,21,-6,15
Concordia Ch,4099,5,4,2,8,17,21,-4,14
FC Botosani,4099,6,3,4,7,5,15,-10,13
FCSB,4100,1,7,7,0,25,12,13,28
CFR Cluj,4100,2,5,8,1,14,8,6,23
Universitate,4100,3,3,7,4,17,21,-4,16
FC Botosani,4100,4,4,4,6,6,13,-7,16
D Bucuresti,4100,5,3,5,6,18,21,-3,14
Concordia Ch,4100,6,3,3,8,18,23,-5,12
FCSB,4101,1,7,5,2,24,13,11,26
CFR Cluj,4101,2,6,7,1,15,8,7,25
Universitate,4101,3,4,6,4,17,20,-3,18
D Bucuresti,4101,4,4,5,5,19,19,0,17
FC Botosani,4101,5,3,5,6,6,15,-9,14
Concordia Ch,4101,6,2,4,8,17,23,-6,10
FCSB,4102,1,8,5,1,25,11,14,29
CFR Cluj,4102,2,6,6,2,14,9,5,24
D Bucuresti,4102,3,4,5,5,19,20,-1,17
Universitate,4102,4,4,5,5,15,19,-4,17
FC Botosani,4102,5,4,5,5,10,15,-5,17
Concordia Ch,4102,6,2,2,10,16,25,-9,8
FCSB,4103,1,9,5,0,26,11,15,32
CFR Cluj,4103,2,5,6,3,14,11,3,21
Universitate,4103,3,4,5,5,16,19,-3,17
FC Botosani,4103,4,4,5,5,7,13,-6,17
D Bucuresti,4103,5,4,4,6,18,20,-2,16
Concordia Ch,4103,6,2,3,9,15,22,-7,9
FCSB,4104,1,8,5,1,26,15,11,29
CFR Cluj,4104,2,7,6,1,18,8,10,27
FC Botosani,4104,3,5,4,5,8,12,-4,19
D Bucuresti,4104,4,3,5,6,18,21,-3,14
Universitate,4104,5,3,5,6,15,21,-6,14
Concordia Ch,4104,6,2,3,9,17,25,-8,9
FCSB,4105,1,7,7,0,24,11,13,28
CFR Cluj,4105,2,5,8,1,14,8,6,23
D Bucuresti,4105,3,5,4,5,20,20,0,19
Universitate,4105,4,3,7,4,16,20,-4,16
FC Botosani,4105,5,4,4,6,8,14,-6,16
Concordia Ch,4105,6,2,2,10,18,27,-9,8
FCSB,4106,1,7,5,2,24,13,11,26
CFR Cluj,4106,2,6,7,1,15,8,7,25
Universitate,4106,3,4,6,4,17,20,-3,18
D Bucuresti,4106,4,4,4,6,20,21,-1,16
FC Botosani,4106,5,3,5,6,7,16,-9,14
Concordia Ch,4106,6,3,3,8,18,23,-5,12
FCSB,4107,1,7,5,2,26,17,9,26
CFR Cluj,4107,2,6,7,1,17,8,9,25
Universitate,4107,3,4,6,4,17,20,-3,18
FC Botosani,4107,4,4,5,5,7,13,-6,17
D Bucuresti,4107,5,3,4,7,17,23,-6,13
Concordia Ch,4107,6,3,3,8,20,23,-3,12
FCSB,4108,1,7,7,0,25,12,13,28
CFR Cluj,4108,2,5,7,2,13,8,5,22
D Bucuresti,4108,3,5,4,5,18,18,0,19
Universitate,4108,4,4,6,4,17,20,-3,18
FC Botosani,4108,5,4,4,6,8,14,-6,16
Concordia Ch,4108,6,2,2,10,16,25,-9,8
FCSB,4109,1,7,6,1,26,15,11,27
CFR Cluj,4109,2,6,7,1,16,8,8,25
FC Botosani,4109,3,4,5,5,9,15,-6,17
Universitate,4109,4,3,7,4,16,20,-4,16
D Bucuresti,4109,5,3,6,5,19,21,-2,15
Concordia Ch,4109,6,2,3,9,15,22,-7,9
FCSB,4110,1,7,6,1,26,15,11,27
CFR Cluj,4110,2,5,7,2,14,9,5,22
Universitate,4110,3,5,5,4,19,20,-1,20
D Bucuresti,4110,4,5,4,5,23,20,3,19
FC Botosani,4110,5,3,5,6,7,15,-8,14
Concordia Ch,4110,6,2,3,9,15,25,-10,9
FCSB,4111,1,8,5,1,24,11,13,29
CFR Cluj,4111,2,5,6,3,14,10,4,21
Universitate,4111,3,5,5,4,17,19,-2,20
FC Botosani,4111,4,4,4,6,11,17,-6,16
D Bucuresti,4111,5,3,5,6,19,23,-4,14
Concordia Ch,4111,6,3,3,8,19,24,-5,12
FCSB,4112,1,8,6,0,25,11,14,30
CFR Cluj,4112,2,5,7,2,15,10,5,22
D Bucuresti,4112,3,4,5,5,18,19,-1,17
Universitate,4112,4,3,7,4,15,19,-4,16
FC Botosani,4112,5,3,6,5,7,14,-7,15
Concordia Ch,4112,6,2,3,9,16,23,-7,9
FCSB,4113,1,8,5,1,29,13,16,29
CFR Cluj,4113,2,5,6,3,13,13,0,21
Universitate,4113,3,5,5,4,19,20,-1,20
D Bucuresti,4113,4,5,4,5,24,21,3,19
FC Botosani,4113,5,3,5,6,8,19,-11,14
Concordia Ch,4113,6,2,3,9,17,24,-7,9
FCSB,4114,1,7,5,2,23,13,10,26
CFR Cluj,4114,2,6,7,1,15,8,7,25
D Bucuresti,4114,3,5,4,5,20,18,2,19
Universitate,4114,4,4,6,4,17,19,-2,18
FC Botosani,4114,5,4,4,6,6,13,-7,16
Concordia Ch,4114,6,2,2,10,15,25,-10,8
FCSB,4115,1,9,5,0,27,12,15,32
CFR Cluj,4115,2,5,6,3,15,12,3,21
D Bucuresti,4115,3,4,5,5,19,20,-1,17
Universitate,4115,4,4,5,5,18,21,-3,17
FC Botosani,4115,5,3,4,7,5,15,-10,13
Concordia Ch,4115,6,3,3,8,19,23,-4,12
FCSB,4116,1,7,6,1,24,12,12,27
CFR Cluj,4116,2,6,7,1,17,9,8,25
D Bucuresti,4116,3,4,5,5,18,19,-1,17
Universitate,4116,4,4,5,5,16,21,-5,17
FC Botosani,4116,5,3,5,6,6,14,-8,14
Concordia Ch,4116,6,2,4,8,17,23,-6,10
FCSB,4117,1,8,5,1,25,12,13,29
CFR Cluj,4117,2,5,6,3,13,9,4,21
Universitate,4117,3,5,5,4,17,19,-2,20
FC Botosani,4117,4,4,5,5,8,12,-4,17
D Bucuresti,4117,5,3,6,5,17,19,-2,15
Concordia Ch,4117,6,2,3,9,16,25,-9,9
FCSB,4118,1,8,5,1,26,12,14,29
CFR Cluj,4118,2,7,6,1,15,7,8,27
FC Botosani,4118,3,4,5,5,6,12,-6,17
D Bucuresti,4118,4,3,5,6,16,20,-4,14
Universitate,4118,5,3,5,6,15,22,-7,14
Concordia Ch,4118,6,3,2,9,17,22,-5,11
FCSB,4119,1,8,6,0,26,12,14,30
CFR Cluj,4119,2,5,7,2,14,10,4,22
D Bucuresti,4119,3,4,5,5,20,19,1,17
Universitate,4119,4,4,5,5,17,20,-3,17
FC Botosani,4119,5,4,5,5,8,14,-6,17
Concordia Ch,4119,6,2,2,10,16,26,-10,8
FCSB,4120,1,8,5,1,26,12,14,29
CFR Cluj,4120,2,6,6,2,14,9,5,24
D Bucuresti,4120,3,4,5,5,19,20,-1,17
Universitate,4120,4,4,5,5,17,21,-4,17
FC Botosani,4120,5,3,4,7,5,14,-9,13
Concordia Ch,4120,6,3,3,8,18,23,-5,12
FCSB,4121,1,8,6,0,26,11,15,30
CFR Cluj,4121,2,6,7,1,16,8,8,25
D Bucuresti,4121,3,4,5,5,20,21,-1,17
FC Botosani,4121,4,4,4,6,10,16,-6,16
Universitate,4121,5,3,5,6,14,22,-8,14
Concordia Ch,4121,6,2,3,9,17,25,-8,9
FCSB,4122,1,8,5,1,26,12,14,29
CFR Cluj,4122,2,5,6,3,13,10,3,21
Universitate,4122,3,5,5,4,17,19,-2,20
D Bucuresti,4122,4,4,4,6,18,22,-4,16
FC Botosani,4122,5,4,4,6,6,13,-7,16
Concordia Ch,4122,6,3,2,9,19,23,-4,11
FCSB,4123,1,7,5,2,24,15,9,26
CFR Cluj,4123,2,6,7,1,16,8,8,25
Universitate,4123,3,4,6,4,18,20,-2,18
D Bucuresti,4123,4,4,4,6,18,20,-2,16
Concordia Ch,4123,5,4,2,8,18,22,-4,14
FC Botosani,4123,6,3,4,7,5,14,-9,13
FCSB,4124,1,7,7,0,25,12,13,28
CFR Cluj,4124,2,5,7,2,14,9,5,22
D Bucuresti,4124,3,5,4,5,22,20,2,19
Universitate,4124,4,4,6,4,16,19,-3,18
FC Botosani,4124,5,4,4,6,7,15,-8,16
Concordia Ch,4124,6,2,2,10,16,25,-9,8
FCSB,4125,1,7,5,2,23,13,10,26
CFR Cluj,4125,2,6,7,1,15,7,8,25
Universitate,4125,3,4,6,4,15,18,-3,18
FC Botosani,4125,4,3,6,5,7,14,-7,15
D Bucuresti,4125,5,3,5,6,18,22,-4,14
Concordia Ch,4125,6,3,3,8,17,21,-4,12
FCSB,4126,1,8,6,0,25,11,14,30
CFR Cluj,4126,2,5,8,1,16,10,6,23
D Bucuresti,4126,3,5,4,5,20,20,0,19
Universitate,4126,4,3,6,5,16,21,-5,15
FC Botosani,4126,5,3,5,6,6,14,-8,14
Concordia Ch,4126,6,2,3,9,16,23,-7,9
FCSB,4127,1,8,5,1,27,13,14,29
CFR Cluj,4127,2,6,6,2,15,10,5,24
Universitate,4127,3,4,5,5,17,21,-4,17
D Bucuresti,4127,4,4,4,6,18,20,-2,16
FC Botosani,4127,5,4,4,6,7,15,-8,16
Concordia Ch,4127,6,3,2,9,17,22,-5,11
FCSB,4128,1,9,5,0,28,13,15,32
CFR Cluj,4128,2,6,6,2,17,9,8,24
D Bucuresti,4128,3,5,4,5,18,18,0,19
FC Botosani,4128,4,4,4,6,9,15,-6,16
Universitate,4128,5,3,5,6,16,24,-8,14
Concordia Ch,4128,6,2,2,10,17,26,-9,8
FCSB,4129,1,8,5,1,25,13,12,29
CFR Cluj,4129,2,7,6,1,17,8,9,27
FC Botosani,4129,3,5,4,5,10,14,-4,19
Universitate,4129,4,3,5,6,16,22,-6,14
D Bucuresti,4129,5,3,4,7,16,21,-5,13
Concordia Ch,4129,6,3,2,9,19,25,-6,11
FCSB,4130,1,8,6,0,27,13,14,30
CFR Cluj,4130,2,5,7,2,15,10,5,22
D Bucuresti,4130,3,4,4,6,18,21,-3,16
Universitate,4130,4,3,7,4,17,21,-4,16
FC Botosani,4130,5,4,4,6,7,14,-7,16
Concordia Ch,4130,6,3,2,9,19,24,-5,11
FCSB,4131,1,9,5,0,28,12,16,32
CFR Cluj,4131,2,6,6,2,16,10,6,24
FC Botosani,4131,3,5,4,5,8,12,-4,19
Universitate,4131,4,3,5,6,15,22,-7,14
D Bucuresti,4131,5,3,4,7,17,22,-5,13
Concordia Ch,4131,6,3,2,9,17,23,-6,11
FCSB,4132,1,9,5,0,29,12,17,32
CFR Cluj,4132,2,5,7,2,14,10,4,22
Universitate,4132,3,3,6,5,15,21,-6,15
Concordia Ch,4132,4,4,2,8,22,23,-1,14
D Bucuresti,4132,5,3,5,6,17,23,-6,14
FC Botosani,4132,6,3,5,6,6,14,-8,14
FCSB,4133,1,8,6,0,28,12,16,30
CFR Cluj,4133,2,6,7,1,16,9,7,25
FC Botosani,4133,3,4,5,5,8,14,-6,17
D Bucuresti,4133,4,3,5,6,19,22,-3,14
Universitate,4133,5,3,5,6,16,24,-8,14
Concordia Ch,4133,6,3,2,9,19,25,-6,11
FCSB,4134,1,9,5,0,25,10,15,32
CFR Cluj,4134,2,6,6,2,14,8,6,24
FC Botosani,4134,3,4,5,5,8,12,-4,17
D Bucuresti,4134,4,3,6,5,16,18,-2,15
Universitate,4134,5,3,5,6,14,20,-6,14
Concordia Ch,4134,6,2,3,9,15,24,-9,9
FCSB,4135,1,7,6,1,26,15,11,27
CFR Cluj,4135,2,5,8,1,15,9,6,23
FC Botosani,4135,3,5,4,5,11,12,-1,19
Universitate,4135,4,4,6,4,19,21,-2,18
D Bucuresti,4135,5,3,5,6,17,21,-4,14
Concordia Ch,4135,6,2,3,9,16,26,-10,9
FCSB,4136,1,8,5,1,24,13,11,29
CFR Cluj,4136,2,7,6,1,18,7,11,27
FC Botosani,4136,3,4,5,5,9,15,-6,17
D Bucuresti,4136,4,3,6,5,18,20,-2,15
Universitate,4136,5,3,5,6,14,21,-7,14
Concordia Ch,4136,6,2,3,9,18,25,-7,9
FCSB,4137,1,8,6,0,27,13,14,30
CFR Cluj,4137,2,6,7,1,16,8,8,25
FC Botosani,4137,3,4,4,6,7,14,-7,16
Concordia Ch,4137,4,4,2,8,18,21,-3,14
Universitate,4137,5,3,5,6,16,23,-7,14
D Bucuresti,4137,6,3,4,7,17,22,-5,13
FCSB,4138,1,9,5,0,32,13,19,32
CFR Cluj,4138,2,6,6,2,15,12,3,24
D Bucuresti,4138,3,4,4,6,18,22,-4,16
Concordia Ch,4138,4,4,2,8,21,22,-1,14
Universitate,4138,5,3,5,6,16,23,-7,14
FC Botosani,4138,6,3,4,7,6,16,-10,13
FCSB,4139,1,8,5,1,24,12,12,29
CFR Cluj,4139,2,5,7,2,13,8,5,22
Universitate,4139,3,4,6,4,16,18,-2,18
FC Botosani,4139,4,4,5,5,9,15,-6,17
D Bucuresti,4139,5,3,4,7,16,22,-6,13
Concordia Ch,4139,6,3,3,8,21,24,-3,12
FCSB,4140,1,8,5,1,25,12,13,29
CFR Cluj,4140,2,5,7,2,14,10,4,22
Universitate,4140,3,4,6,4,17,19,-2,18
D Bucuresti,4140,4,4,5,5,18,19,-1,17
FC Botosani,4140,5,4,5,5,8,13,-5,17
Concordia Ch,4140,6,2,2,10,15,24,-9,8
FCSB,4141,1,8,5,1,27,15,12,29
CFR Cluj,4141,2,7,6,1,18,8,10,27
D Bucuresti,4141,3,3,6,5,17,19,-2,15
Universitate,4141,4,3,5,6,16,23,-7,14
FC Botosani,4141,5,3,5,6,5,13,-8,14
Concordia Ch,4141,6,3,3,8,17,22,-5,12
FCSB,4142,1,8,5,1,26,14,12,29
CFR Cluj,4142,2,7,6,1,22,10,12,27
Concordia Ch,4142,3,4,2,8,19,21,-2,14
D Bucuresti,4142,4,3,5,6,16,20,-4,14
Universitate,4142,5,3,5,6,15,24,-9,14
FC Botosani,4142,6,3,5,6,5,14,-9,14
FCSB,4143,1,8,6,0,25,11,14,30
CFR Cluj,4143,2,6,6,2,16,10,6,24
Universitate,4143,3,3,6,5,17,22,-5,15
D Bucuresti,4143,4,3,5,6,17,20,-3,14
Concordia Ch,4143,5,4,2,8,19,23,-4,14
FC Botosani,4143,6,3,5,6,6,14,-8,14
FCSB,4144,1,8,5,1,25,11,14,29
CFR Cluj,4144,2,5,6,3,13,10,3,21
Universitate,4144,3,5,5,4,16,18,-2,20
D Bucuresti,4144,4,4,4,6,19,20,-1,16
Concordia Ch,4144,5,4,2,8,19,22,-3,14
FC Botosani,4144,6,3,4,7,6,17,-11,13
FCSB,4145,1,8,5,1,26,12,14,29
CFR Cluj,4145,2,6,6,2,15,9,6,24
FC Botosani,4145,3,4,5,5,12,15,-3,17
Universitate,4145,4,4,5,5,15,20,-5,17
D Bucuresti,4145,5,4,4,6,20,23,-3,16
Concordia Ch,4145,6,2,3,9,19,28,-9,9
FCSB,4146,1,8,5,1,24,11,13,29
CFR Cluj,4146,2,5,6,3,13,9,4,21
Universitate,4146,3,5,5,4,16,18,-2,20
D Bucuresti,4146,4,4,5,5,21,20,1,17
FC Botosani,4146,5,3,6,5,8,15,-7,15
Concordia Ch,4146,6,2,3,9,16,25,-9,9
FCSB,4147,1,7,7,0,25,12,13,28
CFR Cluj,4147,2,6,7,1,15,8,7,25
FC Botosani,4147,3,4,5,5,6,12,-6,17
Universitate,4147,4,3,6,5,15,20,-5,15
D Bucuresti,4147,5,3,5,6,16,19,-3,14
Concordia Ch,4147,6,2,4,8,15,21,-6,10
FCSB,4148,1,7,6,1,23,11,12,27
CFR Cluj,4148,2,6,7,1,14,7,7,25
Universitate,4148,3,4,5,5,15,19,-4,17
FC Botosani,4148,4,3,6,5,5,12,-7,15
D Bucuresti,4148,5,3,5,6,17,20,-3,14
Concordia Ch,4148,6,3,3,8,17,22,-5,12
FCSB,4149,1,8,6,0,25,11,14,30
CFR Cluj,4149,2,6,6,2,16,9,7,24
D Bucuresti,4149,3,4,5,5,20,20,0,17
Universitate,4149,4,3,6,5,16,22,-6,15
FC Botosani,4149,5,3,4,7,5,15,-10,13
Concordia Ch,4149,6,3,3,8,18,23,-5,12
FCSB,4150,1,9,5,0,28,10,18,32
CFR Cluj,4150,2,6,6,2,15,10,5,24
FC Botosani,4150,3,4,4,6,7,13,-6,16
Concordia Ch,4150,4,4,2,8,20,22,-2,14
Universitate,4150,5,3,5,6,15,23,-8,14
D Bucuresti,4150,6,3,4,7,17,24,-7,13
FCSB,4151,1,7,5,2,23,12,11,26
CFR Cluj,4151,2,6,6,2,14,9,5,24
Universitate,4151,3,5,5,4,17,18,-1,20
D Bucuresti,4151,4,4,4,6,19,21,-2,16
Concordia Ch,4151,5,4,2,8,19,21,-2,14
FC Botosani,4151,6,3,4,7,6,17,-11,13
FCSB,4152,1,8,6,0,24,10,14,30
CFR Cluj,4152,2,5,6,3,13,9,4,21
Universitate,4152,3,4,6,4,15,18,-3,18
FC Botosani,4152,4,4,5,5,7,13,-6,17
D Bucuresti,4152,5,3,5,6,16,20,-4,14
Concordia Ch,4152,6,3,2,9,18,23,-5,11
FCSB,4153,1,8,6,0,25,10,15,30
CFR Cluj,4153,2,6,7,1,15,8,7,25
FC Botosani,4153,3,4,5,5,6,12,-6,17
D Bucuresti,4153,4,3,6,5,17,19,-2,15
Universitate,4153,5,3,5,6,15,22,-7,14
Concordia Ch,4153,6,2,3,9,16,23,-7,9
FCSB,4154,1,8,5,1,24,13,11,29
CFR Cluj,4154,2,6,6,2,14,8,6,24
Universitate,4154,3,4,5,5,17,19,-2,17
D Bucuresti,4154,4,4,4,6,18,20,-2,16
Concordia Ch,4154,5,4,2,8,19,22,-3,14
FC Botosani,4154,6,3,4,7,7,17,-10,13
FCSB,4155,1,9,5,0,26,11,15,32
CFR Cluj,4155,2,6,6,2,16,8,8,24
FC Botosani,4155,3,4,4,6,9,17,-8,16
Concordia Ch,4155,4,4,2,8,22,25,-3,14
Universitate,4155,5,3,5,6,15,23,-8,14
D Bucuresti,4155,6,3,4,7,19,23,-4,13
CFR Cluj,4156,1,7,6,1,18,8,10,27
FCSB,4156,2,7,5,2,25,15,10,26
Universitate,4156,3,4,5,5,19,24,-5,17
FC Botosani,4156,4,4,4,6,8,15,-7,16
D Bucuresti,4156,5,3,5,6,18,21,-3,14
Concordia Ch,4156,6,3,3,8,18,23,-5,12
FCSB,4157,1,8,5,1,26,13,13,29
CFR Cluj,4157,2,7,6,1,18,9,9,27
FC Botosani,4157,3,5,4,5,11,13,-2,19
Universitate,4157,4,3,5,6,14,21,-7,14
D Bucuresti,4157,5,3,4,7,18,22,-4,13
Concordia Ch,4157,6,3,2,9,17,26,-9,11
FCSB,4158,1,8,6,0,25,11,14,30
CFR Cluj,4158,2,6,6,2,14,8,6,24
D Bucuresti,4158,3,5,4,5,19,19,0,19
Universitate,4158,4,3,6,5,15,20,-5,15
FC Botosani,4158,5,3,4,7,6,18,-12,13
Concordia Ch,4158,6,3,2,9,19,22,-3,11
FCSB,4159,1,9,5,0,28,11,17,32
CFR Cluj,4159,2,5,6,3,14,12,2,21
D Bucuresti,4159,3,5,4,5,21,19,2,19
Universitate,4159,4,4,5,5,17,21,-4,17
FC Botosani,4159,5,4,4,6,7,14,-7,16
Concordia Ch,4159,6,2,2,10,17,27,-10,8
FCSB,4160,1,7,5,2,25,15,10,26
CFR Cluj,4160,2,6,7,1,17,9,8,25
Universitate,4160,3,4,6,4,15,18,-3,18
D Bucuresti,4160,4,4,5,5,19,18,1,17
FC Botosani,4160,5,4,5,5,7,13,-6,17
Concordia Ch,4160,6,2,2,10,16,26,-10,8
FCSB,4161,1,7,6,1,24,12,12,27
CFR Cluj,4161,2,5,7,2,13,9,4,22
Universitate,4161,3,5,5,4,18,19,-1,20
FC Botosani,4161,4,4,5,5,6,12,-6,17
D Bucuresti,4161,5,3,4,7,18,22,-4,13
Concordia Ch,4161,6,3,3,8,18,23,-5,12
FCSB,4162,1,9,5,0,26,11,15,32
CFR Cluj,4162,2,6,6,2,15,8,7,24
D Bucuresti,4162,3,5,4,5,19,18,1,19
FC Botosani,4162,4,4,4,6,7,14,-7,16
Universitate,4162,5,3,5,6,15,22,-7,14
Concordia Ch,4162,6,2,2,10,16,25,-9,8
FCSB,4163,1,8,6,0,25,11,14,30
CFR Cluj,4163,2,5,8,1,15,9,6,23
D Bucuresti,4163,3,4,5,5,19,19,0,17
FC Botosani,4163,4,4,5,5,9,13,-4,17
Universitate,4163,5,3,6,5,15,20,-5,15
Concordia Ch,4163,6,2,2,10,15,26,-11,8
FCSB,4164,1,8,6,0,26,12,14,30
CFR Cluj,4164,2,5,7,2,13,8,5,22
D Bucuresti,4164,3,4,4,6,18,22,-4,16
Universitate,4164,4,3,7,4,16,20,-4,16
FC Botosani,4164,5,4,4,6,7,14,-7,16
Concordia Ch,4164,6,3,2,9,18,22,-4,11
FCSB,4165,1,8,5,1,25,13,12,29
CFR Cluj,4165,2,6,6,2,15,9,6,24
Universitate,4165,3,4,5,5,18,21,-3,17
D Bucuresti,4165,4,3,5,6,18,21,-3,14
Concordia Ch,4165,5,4,2,8,17,21,-4,14
FC Botosani,4165,6,3,5,6,7,15,-8,14
CFR Cluj,4166,1,7,6,1,18,10,8,27
FCSB,4166,2,7,5,2,27,16,11,26
D Bucuresti,4166,3,5,4,5,18,18,0,19
Universitate,4166,4,4,5,5,18,22,-4,17
FC Botosani,4166,5,3,5,6,7,15,-8,14
Concordia Ch,4166,6,2,3,9,17,24,-7,9
FCSB,4167,1,8,5,1,25,12,13,29
CFR Cluj,4167,2,6,6,2,15,9,6,24
Universitate,4167,3,4,5,5,15,19,-4,17
D Bucuresti,4167,4,4,4,6,18,21,-3,16
FC Botosani,4167,5,4,4,6,10,16,-6,16
Concordia Ch,4167,6,3,2,9,19,25,-6,11
FCSB,4168,1,7,6,1,24,13,11,27
CFR Cluj,4168,2,6,7,1,19,9,10,25
Universitate,4168,3,4,5,5,17,23,-6,17
D Bucuresti,4168,4,4,4,6,18,20,-2,16
FC Botosani,4168,5,3,5,6,6,14,-8,14
Concordia Ch,4168,6,3,3,8,18,23,-5,12
FCSB,4169,1,7,6,1,23,13,10,27
CFR Cluj,4169,2,7,6,1,18,8,10,27
D Bucuresti,4169,3,4,5,5,19,20,-1,17
Universitate,4169,4,3,6,5,15,20,-5,15
FC Botosani,4169,5,3,5,6,6,14,-8,14
Concordia Ch,4169,6,3,2,9,17,23,-6,11
FCSB,4170,1,8,5,1,25,12,13,29
CFR Cluj,4170,2,5,6,3,13,11,2,21
Universitate,4170,3,5,5,4,18,18,0,20
D Bucuresti,4170,4,4,4,6,21,24,-3,16
FC Botosani,4170,5,3,5,6,8,17,-9,14
Concordia Ch,4170,6,3,3,8,20,23,-3,12
FCSB,4171,1,8,5,1,26,13,13,29
CFR Cluj,4171,2,6,6,2,15,8,7,24
D Bucuresti,4171,3,4,5,5,20,21,-1,17
Universitate,4171,4,4,5,5,16,21,-5,17
FC Botosani,4171,5,4,4,6,9,16,-7,16
Concordia Ch,4171,6,2,3,9,17,24,-7,9
FCSB,4172,1,9,5,0,27,11,16,32
CFR Cluj,4172,2,5,7,2,17,12,5,22
FC Botosani,4172,3,4,5,5,6,12,-6,17
D Bucuresti,4172,4,3,6,5,17,19,-2,15
Universitate,4172,5,3,6,5,17,23,-6,15
Concordia Ch,4172,6,2,3,9,16,23,-7,9
CFR Cluj,4173,1,7,6,1,20,7,13,27
FCSB,4173,2,7,5,2,23,13,10,26
Universitate,4173,3,4,5,5,15,23,-8,17
Concordia Ch,4173,4,4,2,8,19,22,-3,14
D Bucuresti,4173,5,3,5,6,17,21,-4,14
FC Botosani,4173,6,3,5,6,7,15,-8,14
FCSB,4174,1,7,5,2,24,14,10,26
CFR Cluj,4174,2,6,6,2,15,10,5,24
Universitate,4174,3,5,5,4,18,18,0,20
D Bucuresti,4174,4,5,4,5,21,18,3,19
FC Botosani,4174,5,4,4,6,7,16,-9,16
Concordia Ch,4174,6,2,2,10,16,25,-9,8
FCSB,4175,1,8,6,0,27,13,14,30
CFR Cluj,4175,2,5,8,1,15,9,6,23
FC Botosani,4175,3,4,4,6,8,14,-6,16
Universitate,4175,4,3,6,5,17,22,-5,15
Concordia Ch,4175,5,4,2,8,19,23,-4,14
D Bucuresti,4175,6,3,4,7,17,22,-5,13
FCSB,4176,1,9,5,0,27,10,17,32
CFR Cluj,4176,2,5,6,3,14,10,4,21
Universitate,4176,3,4,5,5,16,22,-6,17
D Bucuresti,4176,4,4,4,6,21,22,-1,16
FC Botosani,4176,5,3,5,6,6,15,-9,14
Concordia Ch,4176,6,3,3,8,18,23,-5,12
FCSB,4177,1,7,6,1,24,12,12,27
CFR Cluj,4177,2,6,7,1,17,9,8,25
Universitate,4177,3,4,5,5,16,21,-5,17
FC Botosani,4177,4,4,5,5,9,14,-5,17
D Bucuresti,4177,5,3,4,7,17,22,-5,13
Concordia Ch,4177,6,3,3,8,17,22,-5,12
FCSB,4178,1,8,5,1,27,14,13,29
CFR Cluj,4178,2,6,7,1,17,9,8,25
Universitate,4178,3,3,6,5,18,24,-6,15
FC Botosani,4178,4,3,6,5,5,12,-7,15
D Bucuresti,4178,5,3,5,6,18,23,-5,14
Concordia Ch,4178,6,3,3,8,20,23,-3,12
FCSB,4179,1,8,6,0,25,11,14,30
CFR Cluj,4179,2,6,6,2,15,8,7,24
D Bucuresti,4179,3,4,4,6,19,21,-2,16
FC Botosani,4179,4,4,4,6,7,15,-8,16
Universitate,4179,5,3,6,5,15,21,-6,15
Concordia Ch,4179,6,3,2,9,17,22,-5,11
FCSB,4180,1,7,6,1,24,12,12,27
CFR Cluj,4180,2,5,7,2,14,10,4,22
Universitate,4180,3,5,5,4,19,20,-1,20
D Bucuresti,4180,4,4,5,5,19,20,-1,17
FC Botosani,4180,5,4,4,6,7,13,-6,16
Concordia Ch,4180,6,2,3,9,17,25,-8,9
FCSB,4181,1,7,6,1,24,14,10,27
CFR Cluj,4181,2,5,8,1,14,8,6,23
Universitate,4181,3,4,6,4,17,18,-1,18
D Bucuresti,4181,4,4,5,5,19,20,-1,17
FC Botosani,4181,5,3,5,6,6,14,-8,14
Concordia Ch,4181,6,2,4,8,18,24,-6,10
FCSB,4182,1,8,5,1,26,14,12,29
CFR Cluj,4182,2,5,7,2,14,10,4,22
Universitate,4182,3,4,6,4,19,20,-1,18
D Bucuresti,4182,4,4,4,6,17,19,-2,16
FC Botosani,4182,5,4,4,6,6,13,-7,16
Concordia Ch,4182,6,3,2,9,16,22,-6,11
FCSB,4183,1,9,5,0,30,12,18,32
CFR Cluj,4183,2,6,6,2,15,11,4,24
D Bucuresti,4183,3,5,4,5,19,19,0,19
Universitate,4183,4,3,5,6,15,22,-7,14
FC Botosani,4183,5,3,4,7,5,15,-10,13
Concordia Ch,4183,6,3,2,9,18,23,-5,11
FCSB,4184,1,7,5,2,23,13,10,26
CFR Cluj,4184,2,6,6,2,15,10,5,24
Universitate,4184,3,5,5,4,19,19,0,20
D Bucuresti,4184,4,4,4,6,19,20,-1,16
Concordia Ch,4184,5,4,2,8,19,22,-3,14
FC Botosani,4184,6,3,4,7,5,16,-11,13
FCSB,4185,1,8,6,0,26,11,15,30
CFR Cluj,4185,2,5,6,3,14,12,2,21
Universitate,4185,3,4,6,4,18,20,-2,18
D Bucuresti,4185,4,4,5,5,20,21,-1,17
FC Botosani,4185,5,3,4,7,7,16,-9,13
Concordia Ch,4185,6,3,3,8,19,24,-5,12
FCSB,4186,1,9,5,0,26,11,15,32
CFR Cluj,4186,2,6,6,2,14,8,6,24
D Bucuresti,4186,3,4,5,5,18,19,-1,17
Universitate,4186,4,3,5,6,15,21,-6,14
FC Botosani,4186,5,3,5,6,5,14,-9,14
Concordia Ch,4186,6,3,2,9,18,23,-5,11
FCSB,4187,1,8,5,1,25,15,10,29
CFR Cluj,4187,2,5,7,2,13,9,4,22
D Bucuresti,4187,3,5,4,5,19,19,0,19
Universitate,4187,4,4,6,4,19,18,1,18
FC Botosani,4187,5,3,4,7,6,15,-9,13
Concordia Ch,4187,6,3,2,9,18,24,-6,11
FCSB,4188,1,8,6,0,28,11,17,30
CFR Cluj,4188,2,5,7,2,13,8,5,22
D Bucuresti,4188,3,4,5,5,18,18,0,17
Universitate,4188,4,4,5,5,16,23,-7,17
FC Botosani,4188,5,3,4,7,6,16,-10,13
Concordia Ch,4188,6,3,3,8,17,22,-5,12
FCSB,4189,1,8,5,1,26,12,14,29
CFR Cluj,4189,2,7,6,1,17,9,8,27
Concordia Ch,4189,3,4,2,8,21,21,0,14
D Bucuresti,4189,4,3,5,6,17,23,-6,14
Universitate,4189,5,3,5,6,15,22,-7,14
FC Botosani,4189,6,3,5,6,6,15,-9,14
FCSB,4190,1,7,6,1,25,13,12,27
CFR Cluj,4190,2,6,7,1,17,9,8,25
D Bucuresti,4190,3,5,4,5,23,19,4,19
Universitate,4190,4,4,5,5,17,22,-5,17
FC Botosani,4190,5,3,4,7,5,16,-11,13
Concordia Ch,4190,6,3,2,9,18,26,-8,11
FCSB,4191,1,7,6,1,23,11,12,27
CFR Cluj,4191,2,6,7,1,14,7,7,25
D Bucuresti,4191,3,4,4,6,18,21,-3,16
Universitate,4191,4,3,7,4,14,18,-4,16
FC Botosani,4191,5,3,5,6,6,14,-8,14
Concordia Ch,4191,6,3,3,8,19,23,-4,12
FCSB,4192,1,7,6,1,25,13,12,27
CFR Cluj,4192,2,6,6,2,16,10,6,24
Universitate,4192,3,4,6,4,17,20,-3,18
D Bucuresti,4192,4,4,5,5,18,19,-1,17
FC Botosani,4192,5,3,4,7,5,15,-10,13
Concordia Ch,4192,6,3,3,8,18,22,-4,12
FCSB,4193,1,7,6,1,24,13,11,27
CFR Cluj,4193,2,5,7,2,13,8,5,22
Universitate,4193,3,5,5,4,18,19,-1,20
FC Botosani,4193,4,3,6,5,7,14,-7,15
D Bucuresti,4193,5,3,5,6,18,21,-3,14
Concordia Ch,4193,6,3,3,8,18,23,-5,12
FCSB,4194,1,9,5,0,26,11,15,32
CFR Cluj,4194,2,6,6,2,14,8,6,24
D Bucuresti,4194,3,4,4,6,18,19,-1,16
Concordia Ch,4194,4,4,2,8,18,22,-4,14
Universitate,4194,5,3,5,6,15,21,-6,14
FC Botosani,4194,6,3,4,7,6,16,-10,13
FCSB,4195,1,9,5,0,28,11,17,32
CFR Cluj,4195,2,5,6,3,13,11,2,21
Universitate,4195,3,4,5,5,16,20,-4,17
FC Botosani,4195,4,3,6,5,6,13,-7,15
D Bucuresti,4195,5,3,5,6,16,19,-3,14
Concordia Ch,4195,6,3,3,8,17,22,-5,12
FCSB,4196,1,8,6,0,24,10,14,30
CFR Cluj,4196,2,5,6,3,13,9,4,21
Universitate,4196,3,4,6,4,15,18,-3,18
FC Botosani,4196,4,4,5,5,8,13,-5,17
D Bucuresti,4196,5,3,4,7,17,22,-5,13
Concordia Ch,4196,6,3,3,8,18,23,-5,12
FCSB,4197,1,8,6,0,26,12,14,30
CFR Cluj,4197,2,5,8,1,14,8,6,23
FC Botosani,4197,3,4,5,5,6,12,-6,17
D Bucuresti,4197,4,3,6,5,16,18,-2,15
Universitate,4197,5,3,6,5,15,20,-5,15
Concordia Ch,4197,6,2,3,9,15,22,-7,9
FCSB,4198,1,8,6,0,25,11,14,30
CFR Cluj,4198,2,6,6,2,15,8,7,24
Universitate,4198,3,3,6,5,15,21,-6,15
FC Botosani,4198,4,3,6,5,7,14,-7,15
D Bucuresti,4198,5,3,5,6,17,23,-6,14
Concordia Ch,4198,6,3,3,8,20,22,-2,12
FCSB,4199,1,7,6,1,24,14,10,27
CFR Cluj,4199,2,6,6,2,17,9,8,24
Universitate,4199,3,4,6,4,17,20,-3,18
D Bucuresti,4199,4,4,4,6,21,23,-2,16
Concordia Ch,4199,5,4,2,8,20,24,-4,14
FC Botosani,4199,6,3,4,7,6,15,-9,13
FCSB,4200,1,8,5,1,25,12,13,29
CFR Cluj,4200,2,5,6,3,14,10,4,21
Universitate,4200,3,5,5,4,18,20,-2,20
FC Botosani,4200,4,4,5,5,9,14,-5,17
D Bucuresti,4200,5,3,5,6,17,20,-3,14
Concordia Ch,4200,6,3,2,9,17,24,-7,11
FCSB,4201,1,9,5,0,26,10,16,32
CFR Cluj,4201,2,6,6,2,16,10,6,24
D Bucuresti,4201,3,4,4,6,20,20,0,16
Concordia Ch,4201,4,4,2,8,19,23,-4,14
Universitate,4201,5,3,5,6,15,22,-7,14
FC Botosani,4201,6,3,4,7,6,17,-11,13
FCSB,4202,1,9,5,0,26,11,15,32
CFR Cluj,4202,2,5,6,3,14,10,4,21
D Bucuresti,4202,3,5,4,5,20,19,1,19
Universitate,4202,4,4,5,5,15,19,-4,17
FC Botosani,4202,5,4,4,6,9,15,-6,16
Concordia Ch,4202,6,2,2,10,18,28,-10,8
FCSB,4203,1,8,5,1,25,12,13,29
CFR Cluj,4203,2,5,7,2,14,10,4,22
Universitate,4203,3,4,6,4,17,19,-2,18
D Bucuresti,4203,4,4,4,6,18,20,-2,16
Concordia Ch,4203,5,4,2,8,18,22,-4,14
FC Botosani,4203,6,3,4,7,7,16,-9,13
FCSB,4204,1,7,6,1,24,14,10,27
CFR Cluj,4204,2,6,7,1,16,8,8,25
Universitate,4204,3,4,5,5,17,20,-3,17
D Bucuresti,4204,4,4,4,6,20,22,-2,16
FC Botosani,4204,5,4,4,6,8,14,-6,16
Concordia Ch,4204,6,3,2,9,18,25,-7,11
FCSB,4205,1,9,5,0,28,11,17,32
CFR Cluj,4205,2,6,6,2,16,8,8,24
D Bucuresti,4205,3,4,5,5,19,18,1,17
FC Botosani,4205,4,4,4,6,6,15,-9,16
Universitate,4205,5,3,5,6,15,25,-10,14
Concordia Ch,4205,6,2,3,9,15,22,-7,9
FCSB,4206,1,8,6,0,25,11,14,30
CFR Cluj,4206,2,6,6,2,14,8,6,24
D Bucuresti,4206,3,4,4,6,17,19,-2,16
Universitate,4206,4,3,6,5,15,20,-5,15
FC Botosani,4206,5,3,5,6,5,13,-8,14
Concordia Ch,4206,6,3,3,8,16,21,-5,12
FCSB,4207,1,8,5,1,25,12,13,29
CFR Cluj,4207,2,5,7,2,13,8,5,22
D Bucuresti,4207,3,5,4,5,19,19,0,19
Universitate,4207,4,4,6,4,16,19,-3,18
FC Botosani,4207,5,3,4,7,6,15,-9,13
Concordia Ch,4207,6,3,2,9,16,22,-6,11
FCSB,4208,1,9,5,0,27,11,16,32
CFR Cluj,4208,2,6,6,2,15,9,6,24
D Bucuresti,4208,3,4,4,6,18,21,-3,16
Concordia Ch,4208,4,4,2,8,21,21,0,14
Universitate,4208,5,3,5,6,15,22,-7,14
FC Botosani,4208,6,3,4,7,5,17,-12,13
FCSB,4209,1,9,5,0,28,10,18,32
CFR Cluj,4209,2,5,7,2,15,12,3,22
FC Botosani,4209,3,5,4,5,10,14,-4,19
Universitate,4209,4,3,6,5,16,22,-6,15
D Bucuresti,4209,5,3,4,7,18,24,-6,13
Concordia Ch,4209,6,3,2,9,22,27,-5,11
FCSB,4210,1,7,5,2,23,14,9,26
CFR Cluj,4210,2,6,7,1,16,8,8,25
Universitate,4210,3,4,6,4,17,19,-2,18
FC Botosani,4210,4,4,5,5,10,16,-6,17
D Bucuresti,4210,5,3,5,6,19,23,-4,14
Concordia Ch,4210,6,3,2,9,18,23,-5,11
CFR Cluj,4211,1,7,6,1,18,8,10,27
FCSB,4211,2,7,5,2,24,14,10,26
FC Botosani,4211,3,5,4,5,9,13,-4,19
Universitate,4211,4,4,5,5,17,22,-5,17
D Bucuresti,4211,5,3,5,6,17,20,-3,14
Concordia Ch,4211,6,2,3,9,17,25,-8,9
FCSB,4212,1,8,6,0,31,13,18,30
CFR Cluj,4212,2,6,6,2,15,13,2,24
D Bucuresti,4212,3,4,5,5,18,19,-1,17
FC Botosani,4212,4,4,5,5,7,13,-6,17
Universitate,4212,5,3,6,5,16,21,-5,15
Concordia Ch,4212,6,2,2,10,17,25,-8,8
FCSB,4213,1,8,5,1,27,13,14,29
CFR Cluj,4213,2,6,7,1,16,8,8,25
D Bucuresti,4213,3,4,4,6,18,21,-3,16
Universitate,4213,4,3,6,5,14,21,-7,15
Concordia Ch,4213,5,4,2,8,20,22,-2,14
FC Botosani,4213,6,3,4,7,5,15,-10,13
FCSB,4214,1,7,6,1,23,13,10,27
CFR Cluj,4214,2,6,7,1,14,7,7,25
Universitate,4214,3,4,5,5,17,19,-2,17
D Bucuresti,4214,4,4,4,6,18,22,-4,16
FC Botosani,4214,5,3,5,6,6,14,-8,14
Concordia Ch,4214,6,3,3,8,20,23,-3,12
CFR Cluj,4215,1,7,6,1,17,7,10,27
FCSB,4215,2,7,5,2,24,13,11,26
FC Botosani,4215,3,4,5,5,8,13,-5,17
Universitate,4215,4,4,5,5,16,22,-6,17
D Bucuresti,4215,5,3,5,6,17,20,-3,14
Concordia Ch,4215,6,3,2,9,16,23,-7,11
FCSB,4216,1,8,6,0,26,12,14,30
CFR Cluj,4216,2,5,6,3,14,11,3,21
Universitate,4216,3,4,6,4,17,19,-2,18
FC Botosani,4216,4,4,4,6,9,16,-7,16
D Bucuresti,4216,5,3,5,6,19,23,-4,14
Concordia Ch,4216,6,3,3,8,20,24,-4,12
FCSB,4217,1,8,5,1,26,12,14,29
CFR Cluj,4217,2,7,6,1,19,8,11,27
D Bucuresti,4217,3,4,5,5,18,19,-1,17
FC Botosani,4217,4,4,5,5,6,12,-6,17
Universitate,4217,5,3,5,6,14,24,-10,14
Concordia Ch,4217,6,2,2,10,16,24,-8,8
FCSB,4218,1,8,6,0,27,13,14,30
CFR Cluj,4218,2,6,7,1,15,8,7,25
D Bucuresti,4218,3,3,5,6,18,21,-3,14
Concordia Ch,4218,4,4,2,8,18,22,-4,14
Universitate,4218,5,3,5,6,16,22,-6,14
FC Botosani,4218,6,3,5,6,6,14,-8,14
FCSB,4219,1,8,5,1,28,14,14,29
CFR Cluj,4219,2,6,6,2,16,10,6,24
FC Botosani,4219,3,5,4,5,9,14,-5,19
Universitate,4219,4,4,5,5,18,23,-5,17
D Bucuresti,4219,5,4,4,6,19,21,-2,16
Concordia Ch,4219,6,2,2,10,15,23,-8,8
FCSB,4220,1,9,5,0,26,10,16,32
CFR Cluj,4220,2,6,6,2,16,9,7,24
D Bucuresti,4220,3,4,5,5,18,19,-1,17
FC Botosani,4220,4,4,5,5,6,12,-6,17
Universitate,4220,5,3,5,6,14,22,-8,14
Concordia Ch,4220,6,2,2,10,16,24,-8,8
FCSB,4221,1,8,6,0,26,12,14,30
CFR Cluj,4221,2,6,6,2,16,9,7,24
D Bucuresti,4221,3,4,5,5,21,20,1,17
FC Botosani,4221,4,4,4,6,7,15,-8,16
Universitate,4221,5,3,6,5,17,23,-6,15
Concordia Ch,4221,6,2,3,9,17,25,-8,9
FCSB,4222,1,8,5,1,24,13,11,29
CFR Cluj,4222,2,6,6,2,18,9,9,24
D Bucuresti,4222,3,4,5,5,19,20,-1,17
Universitate,4222,4,4,5,5,18,23,-5,17
FC Botosani,4222,5,3,5,6,6,14,-8,14
Concordia Ch,4222,6,3,2,9,17,23,-6,11
FCSB,4223,1,8,6,0,25,10,15,30
CFR Cluj,4223,2,5,8,1,15,9,6,23
D Bucuresti,4223,3,4,4,6,17,20,-3,16
FC Botosani,4223,4,4,4,6,7,13,-6,16
Universitate,4223,5,3,6,5,16,22,-6,15
Concordia Ch,4223,6,3,2,9,16,22,-6,11
CFR Cluj,4224,1,7,6,1,17,7,10,27
FCSB,4224,2,7,5,2,23,13,10,26
Universitate,4224,3,4,5,5,15,20,-5,17
D Bucuresti,4224,4,4,4,6,19,21,-2,16
FC Botosani,4224,5,3,5,6,7,15,-8,14
Concordia Ch,4224,6,3,3,8,18,23,-5,12
FCSB,4225,1,7,7,0,24,11,13,28
CFR Cluj,4225,2,5,8,1,16,10,6,23
D Bucuresti,4225,3,4,5,5,21,22,-1,17
Universitate,4225,4,3,7,4,16,20,-4,16
FC Botosani,4225,5,3,4,7,6,15,-9,13
Concordia Ch,4225,6,3,3,8,19,24,-5,12
FCSB,4226,1,8,6,0,25,11,14,30
CFR Cluj,4226,2,5,7,2,14,9,5,22
Universitate,4226,3,4,5,5,15,19,-4,17
D Bucuresti,4226,4,4,4,6,19,22,-3,16
FC Botosani,4226,5,4,4,6,7,14,-7,16
Concordia Ch,4226,6,3,2,9,20,25,-5,11
FCSB,4227,1,8,5,1,25,12,13,29
CFR Cluj,4227,2,6,6,2,15,9,6,24
D Bucuresti,4227,3,4,5,5,18,19,-1,17
Universitate,4227,4,4,5,5,15,19,-4,17
FC Botosani,4227,5,3,6,5,7,14,-7,15
Concordia Ch,4227,6,2,3,9,16,23,-7,9
FCSB,4228,1,7,7,0,24,11,13,28
CFR Cluj,4228,2,5,8,1,14,8,6,23
D Bucuresti,4228,3,4,4,6,19,21,-2,16
Universitate,4228,4,3,7,4,16,20,-4,16
FC Botosani,4228,5,3,5,6,6,15,-9,14
Concordia Ch,4228,6,3,3,8,17,21,-4,12
FCSB,4229,1,8,6,0,24,10,14,30
CFR Cluj,4229,2,6,7,1,14,7,7,25
FC Botosani,4229,3,4,5,5,8,13,-5,17
D Bucuresti,4229,4,3,5,6,17,21,-4,14
Universitate,4229,5,3,5,6,14,20,-6,14
Concordia Ch,4229,6,2,4,8,17,23,-6,10
FCSB,4230,1,7,6,1,25,13,12,27
CFR Cluj,4230,2,5,7,2,14,9,5,22
Universitate,4230,3,5,5,4,17,19,-2,20
FC Botosani,4230,4,4,4,6,7,13,-6,16
Concordia Ch,4230,5,4,2,8,18,22,-4,14
D Bucuresti,4230,6,3,4,7,17,22,-5,13
FCSB,4231,1,8,6,0,26,11,15,30
CFR Cluj,4231,2,6,6,2,14,9,5,24
D Bucuresti,4231,3,5,4,5,20,19,1,19
Universitate,4231,4,3,6,5,15,20,-5,15
FC Botosani,4231,5,3,5,6,8,16,-8,14
Concordia Ch,4231,6,2,3,9,17,25,-8,9
FCSB,4232,1,9,5,0,29,12,17,32
CFR Cluj,4232,2,5,6,3,14,12,2,21
D Bucuresti,4232,3,4,5,5,20,21,-1,17
Universitate,4232,4,4,5,5,19,23,-4,17
FC Botosani,4232,5,3,4,7,7,18,-11,13
Concordia Ch,4232,6,3,3,8,21,24,-3,12
FCSB,4233,1,8,6,0,24,10,14,30
CFR Cluj,4233,2,6,7,1,14,7,7,25
D Bucuresti,4233,3,5,4,5,25,20,5,19
FC Botosani,4233,4,4,4,6,10,20,-10,16
Universitate,4233,5,3,5,6,14,20,-6,14
Concordia Ch,4233,6,2,2,10,19,29,-10,8
CFR Cluj,4234,1,7,6,1,16,8,8,27
FCSB,4234,2,7,5,2,23,13,10,26
FC Botosani,4234,3,5,4,5,9,12,-3,19
Universitate,4234,4,4,5,5,17,20,-3,17
D Bucuresti,4234,5,3,4,7,17,23,-6,13
Concordia Ch,4234,6,3,2,9,17,23,-6,11
FCSB,4235,1,8,5,1,26,13,13,29
CFR Cluj,4235,2,7,6,1,17,8,9,27
FC Botosani,4235,3,4,5,5,9,14,-5,17
Universitate,4235,4,3,5,6,15,22,-7,14
D Bucuresti,4235,5,3,4,7,17,22,-5,13
Concordia Ch,4235,6,3,3,8,17,22,-5,12
FCSB,4236,1,8,5,1,27,12,15,29
CFR Cluj,4236,2,5,6,3,14,13,1,21
Universitate,4236,3,5,5,4,17,18,-1,20
D Bucuresti,4236,4,4,5,5,19,20,-1,17
FC Botosani,4236,5,3,5,6,7,16,-9,14
Concordia Ch,4236,6,3,2,9,21,26,-5,11
FCSB,4237,1,8,5,1,25,11,14,29
CFR Cluj,4237,2,6,6,2,16,9,7,24
Universitate,4237,3,4,5,5,15,21,-6,17
D Bucuresti,4237,4,4,4,6,18,22,-4,16
FC Botosani,4237,5,4,4,6,7,14,-7,16
Concordia Ch,4237,6,3,2,9,18,22,-4,11
FCSB,4238,1,8,6,0,27,11,16,30
CFR Cluj,4238,2,6,7,1,18,10,8,25
D Bucuresti,4238,3,4,5,5,18,18,0,17
Universitate,4238,4,3,5,6,16,25,-9,14
FC Botosani,4238,5,3,5,6,6,15,-9,14
Concordia Ch,4238,6,2,4,8,16,22,-6,10
FCSB,4239,1,8,6,0,29,11,18,30
CFR Cluj,4239,2,5,7,2,13,12,1,22
D Bucuresti,4239,3,4,5,5,18,18,0,17
Universitate,4239,4,3,7,4,15,19,-4,16
FC Botosani,4239,5,3,4,7,6,18,-12,13
Concordia Ch,4239,6,3,3,8,19,22,-3,12
FCSB,4240,1,7,7,0,24,11,13,28
CFR Cluj,4240,2,6,7,1,14,7,7,25
D Bucuresti,4240,3,4,4,6,19,21,-2,16
FC Botosani,4240,4,4,4,6,9,16,-7,16
Universitate,4240,5,3,6,5,15,20,-5,15
Concordia Ch,4240,6,3,2,9,19,25,-6,11
FCSB,4241,1,8,5,1,26,14,12,29
CFR Cluj,4241,2,6,6,2,14,9,5,24
Universitate,4241,3,4,5,5,18,20,-2,17
FC Botosani,4241,4,4,5,5,10,16,-6,17
D Bucuresti,4241,5,3,5,6,20,23,-3,14
Concordia Ch,4241,6,3,2,9,18,24,-6,11
FCSB,4242,1,8,6,0,24,10,14,30
CFR Cluj,4242,2,6,6,2,14,8,6,24
D Bucuresti,4242,3,5,4,5,18,18,0,19
FC Botosani,4242,4,4,4,6,7,14,-7,16
Universitate,4242,5,3,6,5,14,19,-5,15
Concordia Ch,4242,6,2,2,10,16,24,-8,8
FCSB,4243,1,8,5,1,26,12,14,29
CFR Cluj,4243,2,7,6,1,18,8,10,27
FC Botosani,4243,3,4,5,5,6,12,-6,17
D Bucuresti,4243,4,4,4,6,18,20,-2,16
Universitate,4243,5,3,5,6,14,23,-9,14
Concordia Ch,4243,6,2,3,9,16,23,-7,9
FCSB,4244,1,7,5,2,24,13,11,26
CFR Cluj,4244,2,6,6,2,14,8,6,24
Universitate,4244,3,5,5,4,17,19,-2,20
FC Botosani,4244,4,4,5,5,7,12,-5,17
D Bucuresti,4244,5,3,4,7,16,22,-6,13
Concordia Ch,4244,6,3,3,8,17,21,-4,12
FCSB,4245,1,7,6,1,23,11,12,27
CFR Cluj,4245,2,5,8,1,14,8,6,23
Universitate,4245,3,4,6,4,16,19,-3,18
D Bucuresti,4245,4,4,5,5,18,19,-1,17
FC Botosani,4245,5,3,4,7,6,15,-9,13
Concordia Ch,4245,6,3,3,8,18,23,-5,12
FCSB,4246,1,8,5,1,26,12,14,29
CFR Cluj,4246,2,5,7,2,14,10,4,22
Universitate,4246,3,4,6,4,17,20,-3,18
D Bucuresti,4246,4,4,4,6,18,20,-2,16
FC Botosani,4246,5,3,5,6,6,15,-9,14
Concordia Ch,4246,6,3,3,8,18,22,-4,12
FCSB,4247,1,7,6,1,25,13,12,27
CFR Cluj,4247,2,7,6,1,19,9,10,27
FC Botosani,4247,3,5,4,5,12,12,0,19
Universitate,4247,4,3,6,5,16,23,-7,15
D Bucuresti,4247,5,3,4,7,16,20,-4,13
Concordia Ch,4247,6,3,2,9,16,27,-11,11
FCSB,4248,1,9,5,0,29,11,18,32
CFR Cluj,4248,2,5,7,2,15,13,2,22
FC Botosani,4248,3,4,5,5,8,13,-5,17
D Bucuresti,4248,4,4,4,6,18,20,-2,16
Universitate,4248,5,3,6,5,15,20,-5,15
Concordia Ch,4248,6,2,3,9,16,24,-8,9
CFR Cluj,4249,1,7,6,1,19,8,11,27
FCSB,4249,2,7,6,1,24,14,10,27
D Bucuresti,4249,3,4,5,5,17,18,-1,17
FC Botosani,4249,4,4,4,6,9,14,-5,16
Universitate,4249,5,3,6,5,16,22,-6,15
Concordia Ch,4249,6,2,3,9,16,25,-9,9
FCSB,4250,1,9,5,0,25,10,15,32
CFR Cluj,4250,2,6,6,2,15,9,6,24
FC Botosani,4250,3,4,4,6,6,13,-7,16
D Bucuresti,4250,4,3,5,6,16,19,-3,14
Universitate,4250,5,3,5,6,15,21,-6,14
Concordia Ch,4250,6,3,3,8,16,21,-5,12
CFR Cluj,4251,1,7,6,1,17,7,10,27
FCSB,4251,2,7,5,2,23,13,10,26
D Bucuresti,4251,3,5,4,5,19,18,1,19
Universitate,4251,4,4,5,5,15,20,-5,17
FC Botosani,4251,5,4,4,6,9,15,-6,16
Concordia Ch,4251,6,2,2,10,16,26,-10,8
FCSB,4252,1,8,5,1,24,11,13,29
CFR Cluj,4252,2,7,6,1,16,7,9,27
FC Botosani,4252,3,5,4,5,8,13,-5,19
D Bucuresti,4252,4,3,5,6,18,21,-3,14
Universitate,4252,5,3,5,6,14,21,-7,14
Concordia Ch,4252,6,2,3,9,16,23,-7,9
CFR Cluj,4253,1,7,6,1,21,9,12,27
FCSB,4253,2,7,6,1,24,14,10,27
D Bucuresti,4253,3,5,4,5,20,19,1,19
Universitate,4253,4,3,6,5,15,22,-7,15
FC Botosani,4253,5,3,5,6,6,14,-8,14
Concordia Ch,4253,6,2,3,9,17,25,-8,9
FCSB,4254,1,7,6,1,25,13,12,27
CFR Cluj,4254,2,7,6,1,17,9,8,27
FC Botosani,4254,3,4,5,5,8,14,-6,17
Universitate,4254,4,3,6,5,14,19,-5,15
D Bucuresti,4254,5,3,5,6,17,20,-3,14
Concordia Ch,4254,6,3,2,9,17,23,-6,11
FCSB,4255,1,8,5,1,27,13,14,29
CFR Cluj,4255,2,7,6,1,16,8,8,27
Concordia Ch,4255,3,4,2,8,19,22,-3,14
D Bucuresti,4255,4,3,5,6,18,22,-4,14
Universitate,4255,5,3,5,6,15,22,-7,14
FC Botosani,4255,6,3,5,6,8,16,-8,14
FCSB,4256,1,8,5,1,26,11,15,29
CFR Cluj,4256,2,7,6,1,15,7,8,27
FC Botosani,4256,3,5,4,5,7,12,-5,19
Universitate,4256,4,3,5,6,14,22,-8,14
D Bucuresti,4256,5,3,4,7,17,22,-5,13
Concordia Ch,4256,6,3,2,9,18,23,-5,11
FCSB,4257,1,7,6,1,23,12,11,27
CFR Cluj,4257,2,6,7,1,15,7,8,25
Universitate,4257,3,3,7,4,14,18,-4,16
D Bucuresti,4257,4,3,6,5,17,19,-2,15
FC Botosani,4257,5,3,6,5,5,12,-7,15
Concordia Ch,4257,6,2,4,8,16,22,-6,10
FCSB,4258,1,8,5,1,26,12,14,29
CFR Cluj,4258,2,6,6,2,16,10,6,24
Universitate,4258,3,4,5,5,15,20,-5,17
D Bucuresti,4258,4,4,4,6,19,20,-1,16
FC Botosani,4258,5,4,4,6,6,14,-8,16
Concordia Ch,4258,6,3,2,9,17,23,-6,11
FCSB,4259,1,8,6,0,26,11,15,30
CFR Cluj,4259,2,5,6,3,13,10,3,21
Universitate,4259,3,4,6,4,16,19,-3,18
D Bucuresti,4259,4,4,4,6,18,19,-1,16
FC Botosani,4259,5,4,4,6,6,14,-8,16
Concordia Ch,4259,6,3,2,9,16,22,-6,11
FCSB,4260,1,8,6,0,26,11,15,30
CFR Cluj,4260,2,6,6,2,15,10,5,24
D Bucuresti,4260,3,4,5,5,19,19,0,17
FC Botosani,4260,4,4,4,6,6,14,-8,16
Universitate,4260,5,3,6,5,16,21,-5,15
Concordia Ch,4260,6,2,3,9,16,23,-7,9
FCSB,4261,1,8,5,1,29,13,16,29
CFR Cluj,4261,2,5,6,3,13,12,1,21
Universitate,4261,3,5,5,4,18,20,-2,20
D Bucuresti,4261,4,4,5,5,20,19,1,17
FC Botosani,4261,5,4,4,6,7,16,-9,16
Concordia Ch,4261,6,2,3,9,17,24,-7,9
FCSB,4262,1,8,5,1,26,12,14,29
CFR Cluj,4262,2,5,6,3,13,12,1,21
Universitate,4262,3,5,5,4,18,18,0,20
FC Botosani,4262,4,4,5,5,7,13,-6,17
D Bucuresti,4262,5,3,5,6,17,20,-3,14
Concordia Ch,4262,6,2,4,8,17,23,-6,10
FCSB,4263,1,8,6,0,26,11,15,30
CFR Cluj,4263,2,5,6,3,13,10,3,21
Universitate,4263,3,4,6,4,16,19,-3,18
D Bucuresti,4263,4,4,4,6,18,20,-2,16
FC Botosani,4263,5,4,4,6,7,14,-7,16
Concordia Ch,4263,6,3,2,9,18,24,-6,11
FCSB,4264,1,9,5,0,27,10,17,32
CFR Cluj,4264,2,6,6,2,15,9,6,24
D Bucuresti,4264,3,4,4,6,18,19,-1,16
FC Botosani,4264,4,4,4,6,6,14,-8,16
Universitate,4264,5,3,5,6,14,22,-8,14
Concordia Ch,4264,6,3,2,9,17,23,-6,11
FCSB,4265,1,8,6,0,26,12,14,30
CFR Cluj,4265,2,6,6,2,18,11,7,24
D Bucuresti,4265,3,4,5,5,18,19,-1,17
Universitate,4265,4,3,6,5,17,23,-6,15
FC Botosani,4265,5,3,4,7,6,16,-10,13
Concordia Ch,4265,6,3,3,8,17,21,-4,12
FCSB,4266,1,8,5,1,26,12,14,29
CFR Cluj,4266,2,6,6,2,15,9,6,24
Universitate,4266,3,4,5,5,16,21,-5,17
FC Botosani,4266,4,4,5,5,6,12,-6,17
D Bucuresti,4266,5,3,5,6,18,21,-3,14
Concordia Ch,4266,6,3,2,9,18,24,-6,11
FCSB,4267,1,7,7,0,26,13,13,28
CFR Cluj,4267,2,5,8,1,15,9,6,23
D Bucuresti,4267,3,4,5,5,22,18,4,17
Universitate,4267,4,3,7,4,15,19,-4,16
FC Botosani,4267,5,3,6,5,7,14,-7,15
Concordia Ch,4267,6,2,3,9,17,29,-12,9
FCSB,4268,1,8,5,1,25,13,12,29
CFR Cluj,4268,2,5,7,2,14,9,5,22
D Bucuresti,4268,3,5,4,5,21,20,1,19
Universitate,4268,4,4,6,4,16,18,-2,18
FC Botosani,4268,5,4,4,6,8,15,-7,16
Concordia Ch,4268,6,2,2,10,17,26,-9,8
FCSB,4269,1,7,6,1,24,12,12,27
CFR Cluj,4269,2,5,7,2,14,10,4,22
Universitate,4269,3,5,5,4,17,18,-1,20
D Bucuresti,4269,4,3,6,5,18,20,-2,15
FC Botosani,4269,5,3,5,6,6,15,-9,14
Concordia Ch,4269,6,3,3,8,18,22,-4,12
FCSB,4270,1,7,7,0,28,15,13,28
CFR Cluj,4270,2,5,7,2,16,12,4,22
Universitate,4270,3,4,6,4,18,20,-2,18
D Bucuresti,4270,4,4,4,6,19,22,-3,16
FC Botosani,4270,5,4,4,6,7,14,-7,16
Concordia Ch,4270,6,3,2,9,19,24,-5,11
FCSB,4271,1,9,5,0,28,11,17,32
CFR Cluj,4271,2,5,6,3,14,10,4,21
FC Botosani,4271,3,4,5,5,7,12,-5,17
Universitate,4271,4,4,5,5,17,23,-6,17
D Bucuresti,4271,5,3,4,7,17,22,-5,13
Concordia Ch,4271,6,3,3,8,17,22,-5,12
FCSB,4272,1,8,5,1,29,14,15,29
CFR Cluj,4272,2,6,6,2,15,9,6,24
Universitate,4272,3,4,5,5,17,23,-6,17
FC Botosani,4272,4,3,6,5,5,12,-7,15
D Bucuresti,4272,5,3,5,6,16,19,-3,14
Concordia Ch,4272,6,3,3,8,16,21,-5,12
FCSB,4273,1,9,5,0,29,12,17,32
CFR Cluj,4273,2,5,6,3,14,13,1,21
D Bucuresti,4273,3,4,5,5,20,20,0,17
Universitate,4273,4,4,5,5,17,20,-3,17
FC Botosani,4273,5,4,4,6,8,15,-7,16
Concordia Ch,4273,6,2,3,9,18,26,-8,9
FCSB,4274,1,8,5,1,25,12,13,29
CFR Cluj,4274,2,6,7,1,14,7,7,25
D Bucuresti,4274,3,4,5,5,21,20,1,17
Universitate,4274,4,3,6,5,15,20,-5,15
FC Botosani,4274,5,3,5,6,8,16,-8,14
Concordia Ch,4274,6,3,2,9,17,25,-8,11
FCSB,4275,1,7,5,2,24,13,11,26
CFR Cluj,4275,2,6,6,2,16,10,6,24
Universitate,4275,3,5,5,4,17,19,-2,20
D Bucuresti,4275,4,4,4,6,17,19,-2,16
FC Botosani,4275,5,4,4,6,8,13,-5,16
Concordia Ch,4275,6,3,2,9,16,24,-8,11
FCSB,4276,1,8,6,0,27,12,15,30
CFR Cluj,4276,2,5,6,3,14,11,3,21
Universitate,4276,3,4,6,4,16,19,-3,18
D Bucuresti,4276,4,4,5,5,17,18,-1,17
FC Botosani,4276,5,3,6,5,5,12,-7,15
Concordia Ch,4276,6,2,3,9,15,22,-7,9
FCSB,4277,1,9,5,0,27,11,16,32
CFR Cluj,4277,2,5,7,2,14,10,4,22
D Bucuresti,4277,3,4,5,5,22,20,2,17
FC Botosani,4277,4,4,4,6,8,16,-8,16
Universitate,4277,5,3,6,5,16,21,-5,15
Concordia Ch,4277,6,2,3,9,17,26,-9,9
FCSB,4278,1,7,6,1,23,11,12,27
CFR Cluj,4278,2,6,7,1,14,7,7,25
Universitate,4278,3,4,5,5,15,19,-4,17
D Bucuresti,4278,4,4,4,6,19,20,-1,16
FC Botosani,4278,5,3,5,6,6,16,-10,14
Concordia Ch,4278,6,3,3,8,18,22,-4,12
FCSB,4279,1,8,5,1,26,12,14,29
CFR Cluj,4279,2,6,6,2,15,10,5,24
D Bucuresti,4279,3,4,5,5,19,19,0,17
Universitate,4279,4,4,5,5,17,21,-4,17
FC Botosani,4279,5,4,4,6,10,15,-5,16
Concordia Ch,4279,6,2,3,9,15,25,-10,9
FCSB,4280,1,8,5,1,28,12,16,29
CFR Cluj,4280,2,6,6,2,18,12,6,24
FC Botosani,4280,3,5,4,5,9,13,-4,19
Universitate,4280,4,4,5,5,17,24,-7,17
D Bucuresti,4280,5,3,4,7,19,24,-5,13
Concordia Ch,4280,6,3,2,9,18,24,-6,11
FCSB,4281,1,8,6,0,25,11,14,30
CFR Cluj,4281,2,5,7,2,14,9,5,22
Universitate,4281,3,3,7,4,14,18,-4,16
D Bucuresti,4281,4,3,6,5,19,21,-2,15
FC Botosani,4281,5,3,5,6,8,16,-8,14
Concordia Ch,4281,6,3,3,8,20,25,-5,12
FCSB,4282,1,8,6,0,30,14,16,30
CFR Cluj,4282,2,5,7,2,14,9,5,22
Universitate,4282,3,4,5,5,18,24,-6,17
D Bucuresti,4282,4,4,4,6,17,20,-3,16
FC Botosani,4282,5,3,5,6,6,14,-8,14
Concordia Ch,4282,6,3,3,8,18,22,-4,12
FCSB,4283,1,8,5,1,24,11,13,29
CFR Cluj,4283,2,6,6,2,16,8,8,24
Universitate,4283,3,4,5,5,15,21,-6,17
Concordia Ch,4283,4,4,2,8,20,23,-3,14
D Bucuresti,4283,5,3,5,6,16,20,-4,14
FC Botosani,4283,6,3,5,6,7,15,-8,14
FCSB,4284,1,7,6,1,24,12,12,27
CFR Cluj,4284,2,7,6,1,18,7,11,27
FC Botosani,4284,3,5,4,5,8,13,-5,19
Universitate,4284,4,3,6,5,15,23,-8,15
D Bucuresti,4284,5,3,4,7,17,24,-7,13
Concordia Ch,4284,6,3,2,9,19,22,-3,11
FCSB,4285,1,7,5,2,25,15,10,26
CFR Cluj,4285,2,6,6,2,16,10,6,24
Universitate,4285,3,5,5,4,19,20,-1,20
D Bucuresti,4285,4,4,5,5,18,19,-1,17
FC Botosani,4285,5,4,4,6,9,16,-7,16
Concordia Ch,4285,6,2,3,9,17,24,-7,9
FCSB,4286,1,8,6,0,27,11,16,30
CFR Cluj,4286,2,5,6,3,13,11,2,21
FC Botosani,4286,3,5,4,5,9,14,-5,19
Universitate,4286,4,4,6,4,16,19,-3,18
D Bucuresti,4286,5,3,4,7,17,23,-6,13
Concordia Ch,4286,6,3,2,9,21,25,-4,11
FCSB,4287,1,8,5,1,25,12,13,29
CFR Cluj,4287,2,6,6,2,16,9,7,24
Universitate,4287,3,4,5,5,17,22,-5,17
FC Botosani,4287,4,4,4,6,8,13,-5,16
D Bucuresti,4287,5,3,5,6,18,23,-5,14
Concordia Ch,4287,6,3,3,8,18,23,-5,12
FCSB,4288,1,7,6,1,24,13,11,27
CFR Cluj,4288,2,6,6,2,15,9,6,24
Universitate,4288,3,4,6,4,17,19,-2,18
Concordia Ch,4288,4,4,2,8,22,23,-1,14
D Bucuresti,4288,5,3,5,6,17,23,-6,14
FC Botosani,4288,6,3,5,6,8,16,-8,14
FCSB,4289,1,9,5,0,27,11,16,32
CFR Cluj,4289,2,5,7,2,14,9,5,22
FC Botosani,4289,3,4,5,5,6,12,-6,17
Universitate,4289,4,3,6,5,16,22,-6,15
D Bucuresti,4289,5,3,5,6,16,20,-4,14
Concordia Ch,4289,6,3,2,9,17,22,-5,11
FCSB,4290,1,7,6,1,27,15,12,27
CFR Cluj,4290,2,5,8,1,15,9,6,23
Universitate,4290,3,4,6,4,19,22,-3,18
D Bucuresti,4290,4,3,5,6,16,19,-3,14
Concordia Ch,4290,5,4,2,8,17,21,-4,14
FC Botosani,4290,6,3,5,6,5,13,-8,14
CFR Cluj,4291,1,7,6,1,19,8,11,27
FCSB,4291,2,7,6,1,24,14,10,27
D Bucuresti,4291,3,4,5,5,19,19,0,17
Universitate,4291,4,3,6,5,14,20,-6,15
FC Botosani,4291,5,3,5,6,6,14,-8,14
Concordia Ch,4291,6,3,2,9,16,23,-7,11
FCSB,4292,1,7,6,1,24,12,12,27
CFR Cluj,4292,2,6,7,1,16,7,9,25
Universitate,4292,3,4,5,5,16,22,-6,17
D Bucuresti,4292,4,4,4,6,20,21,-1,16
Concordia Ch,4292,5,4,2,8,20,23,-3,14
FC Botosani,4292,6,3,4,7,8,19,-11,13
FCSB,4293,1,7,6,1,23,11,12,27
CFR Cluj,4293,2,6,7,1,16,8,8,25
Universitate,4293,3,4,5,5,16,21,-5,17
D Bucuresti,4293,4,4,4,6,17,19,-2,16
FC Botosani,4293,5,3,5,6,6,14,-8,14
Concordia Ch,4293,6,3,3,8,17,22,-5,12
FCSB,4294,1,8,5,1,27,14,13,29
CFR Cluj,4294,2,6,6,2,15,9,6,24
Universitate,4294,3,4,5,5,17,21,-4,17
FC Botosani,4294,4,4,5,5,7,13,-6,17
D Bucuresti,4294,5,4,4,6,20,22,-2,16
Concordia Ch,4294,6,2,3,9,17,24,-7,9
FCSB,4295,1,7,6,1,28,16,12,27
CFR Cluj,4295,2,6,7,1,18,11,7,25
Universitate,4295,3,4,5,5,18,22,-4,17
D Bucuresti,4295,4,4,4,6,19,21,-2,16
FC Botosani,4295,5,4,4,6,9,14,-5,16
Concordia Ch,4295,6,3,2,9,17,25,-8,11
FCSB,4296,1,8,5,1,28,13,15,29
CFR Cluj,4296,2,5,7,2,14,11,3,22
D Bucuresti,4296,3,5,4,5,18,18,0,19
Universitate,4296,4,4,6,4,16,19,-3,18
FC Botosani,4296,5,4,4,6,8,14,-6,16
Concordia Ch,4296,6,2,2,10,16,25,-9,8
FCSB,4297,1,9,5,0,30,11,19,32
CFR Cluj,4297,2,5,7,2,14,11,3,22
FC Botosani,4297,3,4,5,5,10,15,-5,17
D Bucuresti,4297,4,4,4,6,18,21,-3,16
Universitate,4297,5,3,6,5,14,21,-7,15
Concordia Ch,4297,6,2,3,9,17,24,-7,9
FCSB,4298,1,7,6,1,27,15,12,27
CFR Cluj,4298,2,7,6,1,19,9,10,27
D Bucuresti,4298,3,5,4,5,22,21,1,19
Universitate,4298,4,3,6,5,18,25,-7,15
FC Botosani,4298,5,3,4,7,6,16,-10,13
Concordia Ch,4298,6,3,2,9,18,24,-6,11
FCSB,4299,1,9,5,0,26,10,16,32
CFR Cluj,4299,2,6,6,2,14,9,5,24
D Bucuresti,4299,3,4,4,6,18,19,-1,16
Concordia Ch,4299,4,4,2,8,18,22,-4,14
Universitate,4299,5,3,5,6,14,20,-6,14
FC Botosani,4299,6,3,4,7,6,16,-10,13
FCSB,4300,1,7,5,2,24,14,10,26
CFR Cluj,4300,2,6,6,2,16,11,5,24
Universitate,4300,3,5,5,4,18,18,0,20
FC Botosani,4300,4,4,5,5,6,12,-6,17
D Bucuresti,4300,5,3,4,7,16,20,-4,13
Concordia Ch,4300,6,3,3,8,16,21,-5,12
FCSB,4301,1,7,5,2,23,14,9,26
CFR Cluj,4301,2,6,6,2,16,9,7,24
Universitate,4301,3,5,5,4,18,19,-1,20
FC Botosani,4301,4,4,5,5,7,13,-6,17
D Bucuresti,4301,5,3,6,5,18,20,-2,15
Concordia Ch,4301,6,2,3,9,16,23,-7,9
FCSB,4302,1,9,5,0,26,10,16,32
CFR Cluj,4302,2,6,6,2,15,10,5,24
D Bucuresti,4302,3,4,4,6,20,21,-1,16
FC Botosani,4302,4,4,4,6,8,16,-8,16
Universitate,4302,5,3,5,6,15,21,-6,14
Concordia Ch,4302,6,3,2,9,17,23,-6,11
FCSB,4303,1,8,6,0,25,11,14,30
CFR Cluj,4303,2,5,7,2,14,9,5,22
Universitate,4303,3,3,7,4,16,20,-4,16
D Bucuresti,4303,4,3,6,5,18,20,-2,15
FC Botosani,4303,5,3,6,5,5,12,-7,15
Concordia Ch,4303,6,2,4,8,17,23,-6,10
CFR Cluj,4304,1,7,6,1,16,7,9,27
FCSB,4304,2,7,5,2,23,13,10,26
D Bucuresti,4304,3,4,5,5,19,20,-1,17
Universitate,4304,4,4,5,5,15,19,-4,17
FC Botosani,4304,5,4,5,5,8,14,-6,17
Concordia Ch,4304,6,2,2,10,17,25,-8,8
FCSB,4305,1,8,5,1,25,12,13,29
CFR Cluj,4305,2,7,6,1,15,7,8,27
FC Botosani,4305,3,4,5,5,8,13,-5,17
Universitate,4305,4,3,5,6,15,21,-6,14
D Bucuresti,4305,5,3,4,7,18,23,-5,13
Concordia Ch,4305,6,3,3,8,19,24,-5,12
FCSB,4306,1,9,5,0,26,10,16,32
CFR Cluj,4306,2,5,6,3,13,9,4,21
Universitate,4306,3,4,5,5,15,20,-5,17
FC Botosani,4306,4,3,6,5,6,13,-7,15
D Bucuresti,4306,5,3,5,6,20,23,-3,14
Concordia Ch,4306,6,3,3,8,19,24,-5,12
FCSB,4307,1,7,7,0,24,11,13,28
CFR Cluj,4307,2,5,7,2,14,9,5,22
Universitate,4307,3,4,6,4,17,20,-3,18
D Bucuresti,4307,4,4,5,5,20,19,1,17
FC Botosani,4307,5,3,4,7,5,16,-11,13
Concordia Ch,4307,6,3,3,8,17,22,-5,12
FCSB,4308,1,8,6,0,26,12,14,30
CFR Cluj,4308,2,6,7,1,16,9,7,25
D Bucuresti,4308,3,4,5,5,22,21,1,17
Universitate,4308,4,3,5,6,16,22,-6,14
FC Botosani,4308,5,3,4,7,5,16,-11,13
Concordia Ch,4308,6,3,3,8,19,24,-5,12
FCSB,4309,1,7,6,1,24,12,12,27
CFR Cluj,4309,2,6,7,1,14,7,7,25
D Bucuresti,4309,3,4,4,6,19,19,0,16
Universitate,4309,4,3,7,4,15,19,-4,16
FC Botosani,4309,5,3,5,6,7,17,-10,14
Concordia Ch,4309,6,3,3,8,18,23,-5,12
FCSB,4310,1,8,5,1,24,12,12,29
CFR Cluj,4310,2,6,6,2,15,8,7,24
D Bucuresti,4310,3,5,4,5,20,18,2,19
Universitate,4310,4,4,5,5,16,20,-4,17
FC Botosani,4310,5,3,4,7,5,16,-11,13
Concordia Ch,4310,6,3,2,9,16,22,-6,11
FCSB,4311,1,7,5,2,25,14,11,26
CFR Cluj,4311,2,6,7,1,16,9,7,25
Universitate,4311,3,4,6,4,17,20,-3,18
FC Botosani,4311,4,4,5,5,8,14,-6,17
D Bucuresti,4311,5,3,5,6,17,22,-5,14
Concordia Ch,4311,6,3,2,9,19,23,-4,11
FCSB,4312,1,7,6,1,24,12,12,27
CFR Cluj,4312,2,7,6,1,16,8,8,27
D Bucuresti,4312,3,5,4,5,20,19,1,19
FC Botosani,4312,4,4,4,6,7,14,-7,16
Universitate,4312,5,3,6,5,16,21,-5,15
Concordia Ch,4312,6,2,2,10,15,24,-9,8
FCSB,4313,1,7,6,1,27,15,12,27
CFR Cluj,4313,2,5,7,2,16,11,5,22
Universitate,4313,3,5,5,4,19,21,-2,20
D Bucuresti,4313,4,4,5,5,19,20,-1,17
FC Botosani,4313,5,4,5,5,8,13,-5,17
Concordia Ch,4313,6,2,2,10,16,25,-9,8
FCSB,4314,1,8,6,0,24,10,14,30
CFR Cluj,4314,2,5,8,1,14,8,6,23
FC Botosani,4314,3,4,5,5,8,12,-4,17
Universitate,4314,4,3,6,5,15,20,-5,15
D Bucuresti,4314,5,3,5,6,17,22,-5,14
Concordia Ch,4314,6,2,4,8,16,22,-6,10
FCSB,4315,1,7,6,1,25,14,11,27
CFR Cluj,4315,2,6,7,1,15,8,7,25
D Bucuresti,4315,3,4,5,5,18,19,-1,17
Universitate,4315,4,4,5,5,17,20,-3,17
FC Botosani,4315,5,3,5,6,6,14,-8,14
Concordia Ch,4315,6,2,4,8,17,23,-6,10
FCSB,4316,1,8,6,0,25,10,15,30
CFR Cluj,4316,2,5,8,1,14,8,6,23
D Bucuresti,4316,3,4,4,6,23,21,2,16
Universitate,4316,4,3,6,5,15,21,-6,15
Concordia Ch,4316,5,4,2,8,19,23,-4,14
FC Botosani,4316,6,3,4,7,7,20,-13,13
FCSB,4317,1,8,5,1,24,11,13,29
CFR Cluj,4317,2,5,6,3,13,9,4,21
Universitate,4317,3,5,5,4,16,18,-2,20
D Bucuresti,4317,4,4,5,5,19,20,-1,17
FC Botosani,4317,5,4,5,5,6,12,-6,17
Concordia Ch,4317,6,2,2,10,17,25,-8,8
FCSB,4318,1,8,5,1,26,13,13,29
CFR Cluj,4318,2,6,6,2,14,8,6,24
Universitate,4318,3,4,5,5,17,21,-4,17
FC Botosani,4318,4,3,6,5,6,13,-7,15
D Bucuresti,4318,5,3,5,6,18,23,-5,14
Concordia Ch,4318,6,3,3,8,19,22,-3,12
FCSB,4319,1,8,5,1,24,11,13,29
CFR Cluj,4319,2,5,7,2,13,8,5,22
FC Botosani,4319,3,5,4,5,9,13,-4,19
Universitate,4319,4,4,6,4,15,18,-3,18
D Bucuresti,4319,5,3,5,6,18,22,-4,14
Concordia Ch,4319,6,2,3,9,16,23,-7,9
FCSB,4320,1,9,5,0,26,10,16,32
CFR Cluj,4320,2,6,6,2,14,8,6,24
D Bucuresti,4320,3,3,5,6,18,21,-3,14
Concordia Ch,4320,4,4,2,8,18,22,-4,14
Universitate,4320,5,3,5,6,14,21,-7,14
FC Botosani,4320,6,3,5,6,6,14,-8,14
FCSB,4321,1,8,6,0,25,11,14,30
CFR Cluj,4321,2,6,7,1,17,9,8,25
FC Botosani,4321,3,4,4,6,8,14,-6,16
Concordia Ch,4321,4,4,2,8,20,22,-2,14
Universitate,4321,5,3,5,6,15,22,-7,14
D Bucuresti,4321,6,3,4,7,16,23,-7,13
FCSB,4322,1,8,6,0,24,10,14,30
CFR Cluj,4322,2,6,7,1,14,7,7,25
FC Botosani,4322,3,4,5,5,8,14,-6,17
D Bucuresti,4322,4,3,6,5,18,20,-2,15
Universitate,4322,5,3,5,6,14,20,-6,14
Concordia Ch,4322,6,2,3,9,15,22,-7,9
FCSB,4323,1,8,6,0,25,10,15,30
CFR Cluj,4323,2,5,7,2,13,9,4,22
Universitate,4323,3,4,5,5,16,20,-4,17
FC Botosani,4323,4,4,5,5,6,12,-6,17
D Bucuresti,4323,5,3,6,5,18,20,-2,15
Concordia Ch,4323,6,2,3,9,17,24,-7,9
FCSB,4324,1,8,5,1,28,13,15,29
CFR Cluj,4324,2,7,6,1,18,8,10,27
D Bucuresti,4324,3,4,5,5,19,20,-1,17
FC Botosani,4324,4,4,5,5,7,13,-6,17
Universitate,4324,5,3,5,6,14,24,-10,14
Concordia Ch,4324,6,2,2,10,16,24,-8,8
FCSB,4325,1,7,7,0,24,11,13,28
CFR Cluj,4325,2,6,7,1,16,9,7,25
D Bucuresti,4325,3,5,4,5,21,20,1,19
FC Botosani,4325,4,4,4,6,7,14,-7,16
Universitate,4325,5,3,6,5,15,20,-5,15
Concordia Ch,4325,6,2,2,10,16,25,-9,8
CFR Cluj,4326,1,7,6,1,16,7,9,27
FCSB,4326,2,7,5,2,23,12,11,26
D Bucuresti,4326,3,4,5,5,18,18,0,17
Universitate,4326,4,4,5,5,15,20,-5,17
FC Botosani,4326,5,3,5,6,5,14,-9,14
Concordia Ch,4326,6,3,2,9,17,23,-6,11
FCSB,4327,1,7,6,1,25,13,12,27
CFR Cluj,4327,2,5,7,2,13,8,5,22
Universitate,4327,3,5,5,4,18,20,-2,20
FC Botosani,4327,4,4,5,5,8,13,-5,17
D Bucuresti,4327,5,3,6,5,17,19,-2,15
Concordia Ch,4327,6,2,3,9,17,25,-8,9
FCSB,4328,1,9,5,0,29,14,15,32
CFR Cluj,4328,2,6,6,2,17,10,7,24
FC Botosani,4328,3,4,4,6,7,13,-6,16
D Bucuresti,4328,4,3,5,6,16,20,-4,14
Universitate,4328,5,3,5,6,16,23,-7,14
Concordia Ch,4328,6,3,3,8,16,21,-5,12
FCSB,4329,1,7,6,1,25,13,12,27
CFR Cluj,4329,2,5,8,1,15,9,6,23
D Bucuresti,4329,3,5,4,5,18,18,0,19
Universitate,4329,4,4,6,4,17,20,-3,18
FC Botosani,4329,5,4,4,6,8,13,-5,16
Concordia Ch,4329,6,2,2,10,15,25,-10,8
FCSB,4330,1,9,5,0,26,11,15,32
CFR Cluj,4330,2,6,6,2,14,8,6,24
FC Botosani,4330,3,5,4,5,8,13,-5,19
Universitate,4330,4,3,5,6,15,21,-6,14
D Bucuresti,4330,5,3,4,7,18,23,-5,13
Concordia Ch,4330,6,3,2,9,18,23,-5,11
FCSB,4331,1,9,5,0,26,10,16,32
CFR Cluj,4331,2,6,6,2,15,8,7,24
D Bucuresti,4331,3,5,4,5,21,20,1,19
FC Botosani,4331,4,4,4,6,7,14,-7,16
Universitate,4331,5,3,5,6,14,22,-8,14
Concordia Ch,4331,6,2,2,10,16,25,-9,8
FCSB,4332,1,9,5,0,29,12,17,32
CFR Cluj,4332,2,5,7,2,15,11,4,22
D Bucuresti,4332,3,5,4,5,19,19,0,19
Universitate,4332,4,3,6,5,16,22,-6,15
FC Botosani,4332,5,3,5,6,6,14,-8,14
Concordia Ch,4332,6,2,3,9,15,22,-7,9
FCSB,4333,1,8,5,1,27,13,14,29
CFR Cluj,4333,2,6,6,2,15,10,5,24
Universitate,4333,3,4,5,5,17,21,-4,17
D Bucuresti,4333,4,4,4,6,21,24,-3,16
FC Botosani,4333,5,3,5,6,6,15,-9,14
Concordia Ch,4333,6,3,3,8,20,23,-3,12
FCSB,4334,1,7,7,0,29,16,13,28
CFR Cluj,4334,2,5,8,1,17,11,6,23
D Bucuresti,4334,3,4,5,5,20,20,0,17
Universitate,4334,4,3,7,4,18,22,-4,16
FC Botosani,4334,5,4,4,6,7,15,-8,16
Concordia Ch,4334,6,2,3,9,18,25,-7,9
FCSB,4335,1,7,7,0,23,10,13,28
CFR Cluj,4335,2,6,7,1,16,8,8,25
D Bucuresti,4335,3,4,5,5,19,19,0,17
FC Botosani,4335,4,4,4,6,7,15,-8,16
Universitate,4335,5,3,6,5,15,21,-6,15
Concordia Ch,4335,6,2,3,9,17,24,-7,9
FCSB,4336,1,9,5,0,28,12,16,32
CFR Cluj,4336,2,6,6,2,16,10,6,24
D Bucuresti,4336,3,4,5,5,21,21,0,17
FC Botosani,4336,4,4,5,5,8,14,-6,17
Universitate,4336,5,3,5,6,16,23,-7,14
Concordia Ch,4336,6,2,2,10,16,25,-9,8
FCSB,4337,1,7,7,0,25,12,13,28
CFR Cluj,4337,2,6,7,1,15,8,7,25
D Bucuresti,4337,3,4,5,5,18,19,-1,17
FC Botosani,4337,4,4,4,6,7,14,-7,16
Universitate,4337,5,3,6,5,15,20,-5,15
Concordia Ch,4337,6,2,3,9,15,22,-7,9
FCSB,4338,1,8,6,0,25,11,14,30
CFR Cluj,4338,2,6,6,2,14,8,6,24
FC Botosani,4338,3,4,4,6,7,14,-7,16
Universitate,4338,4,3,6,5,15,20,-5,15
D Bucuresti,4338,5,3,5,6,17,20,-3,14
Concordia Ch,4338,6,3,3,8,18,23,-5,12
FCSB,4339,1,8,6,0,27,11,16,30
CFR Cluj,4339,2,5,7,2,13,10,3,22
D Bucuresti,4339,3,4,5,5,18,19,-1,17
Universitate,4339,4,3,7,4,15,19,-4,16
FC Botosani,4339,5,3,5,6,5,14,-9,14
Concordia Ch,4339,6,3,2,9,18,23,-5,11
FCSB,4340,1,7,5,2,23,13,10,26
CFR Cluj,4340,2,6,7,1,15,8,7,25
Universitate,4340,3,4,6,4,17,19,-2,18
FC Botosani,4340,4,4,5,5,10,16,-6,17
D Bucuresti,4340,5,3,5,6,18,21,-3,14
Concordia Ch,4340,6,3,2,9,18,24,-6,11
FCSB,4341,1,8,6,0,27,11,16,30
CFR Cluj,4341,2,5,6,3,15,13,2,21
Universitate,4341,3,4,6,4,16,19,-3,18
FC Botosani,4341,4,4,5,5,6,12,-6,17
D Bucuresti,4341,5,4,4,6,19,19,0,16
Concordia Ch,4341,6,2,3,9,15,24,-9,9
FCSB,4342,1,8,6,0,25,10,15,30
CFR Cluj,4342,2,5,8,1,13,7,6,23
D Bucuresti,4342,3,4,5,5,21,21,0,17
FC Botosani,4342,4,4,4,6,9,17,-8,16
Universitate,4342,5,3,6,5,14,20,-6,15
Concordia Ch,4342,6,2,3,9,17,24,-7,9
FCSB,4343,1,8,5,1,27,12,15,29
CFR Cluj,4343,2,6,6,2,19,12,7,24
Universitate,4343,3,4,5,5,16,23,-7,17
D Bucuresti,4343,4,4,4,6,18,20,-2,16
FC Botosani,4343,5,4,4,6,7,13,-6,16
Concordia Ch,4343,6,3,2,9,17,24,-7,11
FCSB,4344,1,8,5,1,26,12,14,29
CFR Cluj,4344,2,5,7,2,14,10,4,22
Universitate,4344,3,4,6,4,15,18,-3,18
D Bucuresti,4344,4,4,4,6,18,21,-3,16
Concordia Ch,4344,5,4,2,8,20,22,-2,14
FC Botosani,4344,6,3,4,7,5,15,-10,13
FCSB,4345,1,8,6,0,24,10,14,30
CFR Cluj,4345,2,5,7,2,14,9,5,22
D Bucuresti,4345,3,5,4,5,20,20,0,19
Universitate,4345,4,3,7,4,15,19,-4,16
FC Botosani,4345,5,3,4,7,6,15,-9,13
Concordia Ch,4345,6,3,2,9,17,23,-6,11
FCSB,4346,1,9,5,0,26,10,16,32
CFR Cluj,4346,2,6,6,2,16,10,6,24
D Bucuresti,4346,3,4,4,6,19,22,-3,16
FC Botosani,4346,4,4,4,6,7,13,-6,16
Universitate,4346,5,3,5,6,15,22,-7,14
Concordia Ch,4346,6,3,2,9,18,24,-6,11
FCSB,4347,1,8,5,1,25,12,13,29
CFR Cluj,4347,2,6,6,2,15,8,7,24
D Bucuresti,4347,3,4,5,5,18,19,-1,17
Universitate,4347,4,4,5,5,16,21,-5,17
FC Botosani,4347,5,3,4,7,7,16,-9,13
Concordia Ch,4347,6,3,3,8,17,22,-5,12
FCSB,4348,1,8,5,1,26,15,11,29
CFR Cluj,4348,2,6,6,2,16,10,6,24
Universitate,4348,3,4,5,5,18,20,-2,17
FC Botosani,4348,4,4,4,6,7,14,-7,16
Concordia Ch,4348,5,4,2,8,18,21,-3,14
D Bucuresti,4348,6,3,4,7,16,21,-5,13
FCSB,4349,1,7,6,1,24,12,12,27
CFR Cluj,4349,2,5,8,1,15,9,6,23
Universitate,4349,3,4,6,4,16,19,-3,18
D Bucuresti,4349,4,4,4,6,18,21,-3,16
FC Botosani,4349,5,4,4,6,6,13,-7,16
Concordia Ch,4349,6,3,2,9,18,23,-5,11
FCSB,4350,1,9,5,0,26,11,15,32
CFR Cluj,4350,2,6,6,2,16,9,7,24
FC Botosani,4350,3,3,6,5,8,15,-7,15
D Bucuresti,4350,4,3,5,6,17,22,-5,14
Universitate,4350,5,3,5,6,14,21,-7,14
Concordia Ch,4350,6,3,3,8,20,23,-3,12
FCSB,4351,1,8,5,1,28,15,13,29
CFR Cluj,4351,2,6,6,2,16,9,7,24
FC Botosani,4351,3,5,4,5,8,12,-4,19
Universitate,4351,4,4,5,5,17,22,-5,17
D Bucuresti,4351,5,3,4,7,16,20,-4,13
Concordia Ch,4351,6,3,2,9,16,23,-7,11
FCSB,4352,1,8,5,1,26,12,14,29
CFR Cluj,4352,2,6,7,1,16,8,8,25
D Bucuresti,4352,3,4,4,6,21,20,1,16
FC Botosani,4352,4,4,4,6,8,17,-9,16
Universitate,4352,5,3,6,5,15,22,-7,15
Concordia Ch,4352,6,3,2,9,16,23,-7,11
FCSB,4353,1,7,6,1,24,14,10,27
CFR Cluj,4353,2,6,7,1,16,9,7,25
Universitate,4353,3,4,5,5,18,20,-2,17
D Bucuresti,4353,4,4,4,6,19,21,-2,16
FC Botosani,4353,5,4,4,6,6,14,-8,16
Concordia Ch,4353,6,3,2,9,19,24,-5,11
FCSB,4354,1,9,5,0,29,12,17,32
CFR Cluj,4354,2,6,6,2,15,10,5,24
Concordia Ch,4354,3,4,2,8,20,22,-2,14
D Bucuresti,4354,4,3,5,6,17,22,-5,14
Universitate,4354,5,3,5,6,16,23,-7,14
FC Botosani,4354,6,3,5,6,7,15,-8,14
FCSB,4355,1,9,5,0,27,11,16,32
CFR Cluj,4355,2,5,6,3,15,11,4,21
D Bucuresti,4355,3,4,5,5,18,19,-1,17
FC Botosani,4355,4,4,5,5,9,13,-4,17
Universitate,4355,5,4,5,5,18,23,-5,17
Concordia Ch,4355,6,2,2,10,15,25,-10,8
FCSB,4356,1,8,5,1,28,14,14,29
CFR Cluj,4356,2,5,7,2,16,12,4,22
FC Botosani,4356,3,5,4,5,9,13,-4,19
Universitate,4356,4,4,6,4,19,22,-3,18
D Bucuresti,4356,5,3,5,6,16,20,-4,14
Concordia Ch,4356,6,2,3,9,16,23,-7,9
FCSB,4357,1,8,6,0,26,12,14,30
CFR Cluj,4357,2,6,7,1,16,8,8,25
D Bucuresti,4357,3,5,4,5,21,20,1,19
Universitate,4357,4,3,5,6,15,22,-7,14
FC Botosani,4357,5,3,4,7,6,18,-12,13
Concordia Ch,4357,6,3,2,9,19,23,-4,11
FCSB,4358,1,7,6,1,24,13,11,27
CFR Cluj,4358,2,7,6,1,17,8,9,27
FC Botosani,4358,3,5,4,5,7,12,-5,19
Universitate,4358,4,3,6,5,16,21,-5,15
D Bucuresti,4358,5,3,4,7,17,21,-4,13
Concordia Ch,4358,6,3,2,9,17,23,-6,11
FCSB,4359,1,8,5,1,25,14,11,29
CFR Cluj,4359,2,5,6,3,13,9,4,21
Universitate,4359,3,5,5,4,19,19,0,20
FC Botosani,4359,4,4,5,5,6,12,-6,17
D Bucuresti,4359,5,3,4,7,16,21,-5,13
Concordia Ch,4359,6,3,3,8,17,21,-4,12
FCSB,4360,1,8,5,1,26,14,12,29
CFR Cluj,4360,2,5,7,2,15,10,5,22
D Bucuresti,4360,3,5,4,5,20,19,1,19
Universitate,4360,4,4,6,4,18,20,-2,18
FC Botosani,4360,5,4,4,6,9,14,-5,16
Concordia Ch,4360,6,2,2,10,15,26,-11,8
FCSB,4361,1,7,6,1,25,13,12,27
CFR Cluj,4361,2,6,6,2,15,9,6,24
Universitate,4361,3,4,6,4,16,19,-3,18
D Bucuresti,4361,4,4,4,6,17,21,-4,16
FC Botosani,4361,5,4,4,6,6,13,-7,16
Concordia Ch,4361,6,3,2,9,18,22,-4,11
FCSB,4362,1,7,6,1,24,14,10,27
CFR Cluj,4362,2,6,7,1,17,9,8,25
Universitate,4362,3,4,5,5,18,21,-3,17
FC Botosani,4362,4,4,5,5,6,12,-6,17
D Bucuresti,4362,5,4,4,6,19,21,-2,16
Concordia Ch,4362,6,2,3,9,17,24,-7,9
FCSB,4363,1,7,6,1,25,13,12,27
CFR Cluj,4363,2,7,6,1,16,8,8,27
Universitate,4363,3,3,6,5,17,22,-5,15
Concordia Ch,4363,4,4,2,8,21,24,-3,14
D Bucuresti,4363,5,3,5,6,17,21,-4,14
FC Botosani,4363,6,3,5,6,7,15,-8,14
FCSB,4364,1,8,6,0,28,11,17,30
CFR Cluj,4364,2,6,7,1,17,8,9,25
D Bucuresti,4364,3,5,4,5,20,20,0,19
FC Botosani,4364,4,3,5,6,7,15,-8,14
Universitate,4364,5,3,5,6,14,25,-11,14
Concordia Ch,4364,6,2,3,9,17,24,-7,9
FCSB,4365,1,9,5,0,27,12,15,32
CFR Cluj,4365,2,6,6,2,15,9,6,24
Concordia Ch,4365,3,4,2,8,19,22,-3,14
D Bucuresti,4365,4,3,5,6,18,22,-4,14
Universitate,4365,5,3,5,6,17,23,-6,14
FC Botosani,4365,6,3,5,6,6,14,-8,14
FCSB,4366,1,8,6,0,24,10,14,30
CFR Cluj,4366,2,5,7,2,13,11,2,22
Universitate,4366,3,4,5,5,18,19,-1,17
D Bucuresti,4366,4,3,5,6,17,20,-3,14
Concordia Ch,4366,5,4,2,8,19,23,-4,14
FC Botosani,4366,6,3,5,6,6,14,-8,14
FCSB,4367,1,9,5,0,27,10,17,32
CFR Cluj,4367,2,6,6,2,17,10,7,24
D Bucuresti,4367,3,4,4,6,17,22,-5,16
FC Botosani,4367,4,4,4,6,7,14,-7,16
Universitate,4367,5,3,5,6,14,23,-9,14
Concordia Ch,4367,6,3,2,9,20,23,-3,11
FCSB,4368,1,7,7,0,25,12,13,28
CFR Cluj,4368,2,6,7,1,15,8,7,25
FC Botosani,4368,3,4,5,5,9,14,-5,17
Universitate,4368,4,3,6,5,15,20,-5,15
D Bucuresti,4368,5,3,4,7,17,22,-5,13
Concordia Ch,4368,6,3,3,8,19,24,-5,12
FCSB,4369,1,8,6,0,27,11,16,30
CFR Cluj,4369,2,6,6,2,14,10,4,24
D Bucuresti,4369,3,4,4,6,20,20,0,16
FC Botosani,4369,4,4,4,6,7,15,-8,16
Universitate,4369,5,3,6,5,15,20,-5,15
Concordia Ch,4369,6,3,2,9,17,24,-7,11
FCSB,4370,1,8,5,1,24,12,12,29
CFR Cluj,4370,2,6,6,2,16,9,7,24
Universitate,4370,3,4,5,5,17,21,-4,17
D Bucuresti,4370,4,4,4,6,18,22,-4,16
FC Botosani,4370,5,4,4,6,8,15,-7,16
Concordia Ch,4370,6,3,2,9,19,23,-4,11
FCSB,4371,1,9,5,0,25,10,15,32
CFR Cluj,4371,2,5,7,2,13,8,5,22
FC Botosani,4371,3,4,5,5,8,13,-5,17
Universitate,4371,4,3,6,5,14,19,-5,15
D Bucuresti,4371,5,3,4,7,16,25,-9,13
Concordia Ch,4371,6,3,3,8,21,22,-1,12
FCSB,4372,1,8,6,0,25,10,15,30
CFR Cluj,4372,2,5,7,2,13,11,2,22
Universitate,4372,3,4,5,5,18,20,-2,17
FC Botosani,4372,4,3,6,5,6,13,-7,15
D Bucuresti,4372,5,3,5,6,17,22,-5,14
Concordia Ch,4372,6,3,3,8,18,21,-3,12
FCSB,4373,1,7,6,1,24,12,12,27
CFR Cluj,4373,2,6,6,2,15,9,6,24
Universitate,4373,3,4,6,4,15,18,-3,18
FC Botosani,4373,4,4,5,5,10,14,-4,17
D Bucuresti,4373,5,3,6,5,17,19,-2,15
Concordia Ch,4373,6,2,3,9,16,25,-9,9
FCSB,4374,1,8,6,0,28,12,16,30
CFR Cluj,4374,2,6,7,1,15,8,7,25
FC Botosani,4374,3,3,6,5,6,13,-7,15
D Bucuresti,4374,4,3,5,6,17,20,-3,14
Universitate,4374,5,3,5,6,15,23,-8,14
Concordia Ch,4374,6,3,3,8,16,21,-5,12
FCSB,4375,1,8,5,1,26,11,15,29
CFR Cluj,4375,2,6,6,2,14,10,4,24
D Bucuresti,4375,3,4,5,5,17,18,-1,17
Universitate,4375,4,4,5,5,15,19,-4,17
FC Botosani,4375,5,3,6,5,5,12,-7,15
Concordia Ch,4375,6,2,3,9,15,22,-7,9
FCSB,4376,1,9,5,0,29,10,19,32
CFR Cluj,4376,2,6,6,2,16,12,4,24
FC Botosani,4376,3,3,6,5,7,14,-7,15
D Bucuresti,4376,4,3,5,6,17,21,-4,14
Universitate,4376,5,3,5,6,15,23,-8,14
Concordia Ch,4376,6,3,3,8,18,22,-4,12
FCSB,4377,1,9,5,0,25,10,15,32
CFR Cluj,4377,2,6,6,2,15,9,6,24
D Bucuresti,4377,3,4,5,5,20,21,-1,17
Universitate,4377,4,3,5,6,15,21,-6,14
FC Botosani,4377,5,3,4,7,6,16,-10,13
Concordia Ch,4377,6,3,3,8,19,23,-4,12
FCSB,4378,1,8,6,0,26,12,14,30
CFR Cluj,4378,2,6,7,1,17,8,9,25
D Bucuresti,4378,3,5,4,5,20,18,2,19
FC Botosani,4378,4,4,4,6,7,13,-6,16
Universitate,4378,5,3,5,6,15,23,-8,14
Concordia Ch,4378,6,2,2,10,15,26,-11,8
FCSB,4379,1,7,6,1,25,13,12,27
CFR Cluj,4379,2,6,6,2,14,8,6,24
D Bucuresti,4379,3,5,4,5,19,18,1,19
Universitate,4379,4,4,6,4,17,20,-3,18
FC Botosani,4379,5,3,4,7,5,15,-10,13
Concordia Ch,4379,6,3,2,9,16,22,-6,11
FCSB,4380,1,8,6,0,28,12,16,30
CFR Cluj,4380,2,5,7,2,14,9,5,22
D Bucuresti,4380,3,4,5,5,18,19,-1,17
Universitate,4380,4,4,5,5,16,22,-6,17
FC Botosani,4380,5,4,4,6,7,13,-6,16
Concordia Ch,4380,6,2,3,9,16,24,-8,9
FCSB,4381,1,7,6,1,26,14,12,27
CFR Cluj,4381,2,7,6,1,17,8,9,27
FC Botosani,4381,3,4,4,6,8,15,-7,16
Universitate,4381,4,3,6,5,18,24,-6,15
Concordia Ch,4381,5,4,2,8,19,22,-3,14
D Bucuresti,4381,6,3,4,7,17,22,-5,13
FCSB,4382,1,8,6,0,26,12,14,30
CFR Cluj,4382,2,6,7,1,15,8,7,25
Concordia Ch,4382,3,4,2,8,18,21,-3,14
D Bucuresti,4382,4,3,5,6,18,22,-4,14
Universitate,4382,5,3,5,6,15,21,-6,14
FC Botosani,4382,6,3,5,6,7,15,-8,14
FCSB,4383,1,7,6,1,25,13,12,27
CFR Cluj,4383,2,6,7,1,16,8,8,25
Universitate,4383,3,4,5,5,16,21,-5,17
FC Botosani,4383,4,3,6,5,7,14,-7,15
D Bucuresti,4383,5,3,5,6,18,23,-5,14
Concordia Ch,4383,6,3,3,8,18,21,-3,12
FCSB,4384,1,9,5,0,27,11,16,32
CFR Cluj,4384,2,5,6,3,15,12,3,21
D Bucuresti,4384,3,4,5,5,19,19,0,17
Universitate,4384,4,4,5,5,16,20,-4,17
FC Botosani,4384,5,3,6,5,5,12,-7,15
Concordia Ch,4384,6,2,3,9,16,24,-8,9
FCSB,4385,1,7,5,2,24,13,11,26
CFR Cluj,4385,2,6,7,1,14,7,7,25
Universitate,4385,3,4,6,4,16,19,-3,18
D Bucuresti,4385,4,4,4,6,18,19,-1,16
Concordia Ch,4385,5,4,2,8,20,21,-1,14
FC Botosani,4385,6,3,4,7,5,18,-13,13
FCSB,4386,1,8,6,0,27,10,17,30
CFR Cluj,4386,2,6,7,1,15,8,7,25
FC Botosani,4386,3,5,4,5,9,12,-3,19
D Bucuresti,4386,4,4,4,6,20,20,0,16
Universitate,4386,5,3,5,6,15,24,-9,14
Concordia Ch,4386,6,2,2,10,16,28,-12,8
FCSB,4387,1,8,6,0,26,12,14,30
CFR Cluj,4387,2,5,7,2,15,10,5,22
FC Botosani,4387,3,5,4,5,8,13,-5,19
Universitate,4387,4,4,5,5,17,21,-4,17
D Bucuresti,4387,5,4,4,6,20,22,-2,16
Concordia Ch,4387,6,2,2,10,17,25,-8,8
FCSB,4388,1,7,5,2,23,13,10,26
CFR Cluj,4388,2,6,7,1,14,7,7,25
Universitate,4388,3,4,6,4,16,18,-2,18
D Bucuresti,4388,4,4,5,5,19,20,-1,17
FC Botosani,4388,5,4,4,6,9,14,-5,16
Concordia Ch,4388,6,2,3,9,16,25,-9,9
FCSB,4389,1,8,6,0,26,12,14,30
CFR Cluj,4389,2,5,7,2,14,9,5,22
D Bucuresti,4389,3,4,5,5,17,18,-1,17
Universitate,4389,4,4,5,5,16,20,-4,17
FC Botosani,4389,5,4,4,6,7,13,-6,16
Concordia Ch,4389,6,2,3,9,15,23,-8,9
FCSB,4390,1,9,5,0,29,10,19,32
CFR Cluj,4390,2,6,6,2,14,10,4,24
FC Botosani,4390,3,4,5,5,8,14,-6,17
D Bucuresti,4390,4,3,5,6,16,19,-3,14
Universitate,4390,5,3,5,6,14,22,-8,14
Concordia Ch,4390,6,2,4,8,17,23,-6,10
FCSB,4391,1,8,5,1,25,11,14,29
CFR Cluj,4391,2,6,6,2,16,10,6,24
Universitate,4391,3,4,5,5,16,21,-5,17
FC Botosani,4391,4,3,6,5,10,17,-7,15
D Bucuresti,4391,5,3,5,6,19,23,-4,14
Concordia Ch,4391,6,3,3,8,19,23,-4,12
FCSB,4392,1,8,6,0,27,12,15,30
CFR Cluj,4392,2,5,8,1,16,10,6,23
D Bucuresti,4392,3,5,4,5,21,21,0,19
Universitate,4392,4,3,6,5,15,21,-6,15
FC Botosani,4392,5,3,5,6,8,16,-8,14
Concordia Ch,4392,6,2,3,9,17,24,-7,9
FCSB,4393,1,7,7,0,24,11,13,28
CFR Cluj,4393,2,6,7,1,17,9,8,25
FC Botosani,4393,3,4,5,5,9,15,-6,17
D Bucuresti,4393,4,3,6,5,20,22,-2,15
Universitate,4393,5,3,6,5,15,21,-6,15
Concordia Ch,4393,6,2,3,9,18,25,-7,9
FCSB,4394,1,8,6,0,26,10,16,30
CFR Cluj,4394,2,5,7,2,14,11,3,22
D Bucuresti,4394,3,4,4,6,19,20,-1,16
Universitate,4394,4,3,7,4,15,19,-4,16
FC Botosani,4394,5,3,5,6,7,16,-9,14
Concordia Ch,4394,6,3,3,8,19,24,-5,12
FCSB,4395,1,8,5,1,24,11,13,29
CFR Cluj,4395,2,6,6,2,15,8,7,24
Universitate,4395,3,4,5,5,15,20,-5,17
D Bucuresti,4395,4,4,4,6,18,20,-2,16
Concordia Ch,4395,5,4,2,8,18,21,-3,14
FC Botosani,4395,6,3,4,7,6,16,-10,13
FCSB,4396,1,8,5,1,26,16,10,29
CFR Cluj,4396,2,6,7,1,20,10,10,25
FC Botosani,4396,3,4,5,5,7,12,-5,17
Universitate,4396,4,3,6,5,17,22,-5,15
D Bucuresti,4396,5,3,5,6,17,21,-4,14
Concordia Ch,4396,6,2,4,8,16,22,-6,10
FCSB,4397,1,7,6,1,24,13,11,27
CFR Cluj,4397,2,7,6,1,17,8,9,27
Universitate,4397,3,3,6,5,16,21,-5,15
Concordia Ch,4397,4,4,2,8,20,23,-3,14
D Bucuresti,4397,5,3,5,6,18,21,-3,14
FC Botosani,4397,6,3,5,6,5,14,-9,14
FCSB,4398,1,7,6,1,25,14,11,27
CFR Cluj,4398,2,5,7,2,14,9,5,22
Universitate,4398,3,5,5,4,18,19,-1,20
Concordia Ch,4398,4,4,2,8,22,22,0,14
D Bucuresti,4398,5,3,5,6,16,22,-6,14
FC Botosani,4398,6,3,5,6,6,15,-9,14
FCSB,4399,1,9,5,0,26,10,16,32
CFR Cluj,4399,2,5,7,2,13,8,5,22
FC Botosani,4399,3,4,4,6,7,13,-6,16
Universitate,4399,4,3,6,5,14,20,-6,15
D Bucuresti,4399,5,3,5,6,16,20,-4,14
Concordia Ch,4399,6,3,3,8,16,21,-5,12
FCSB,4400,1,7,5,2,24,13,11,26
CFR Cluj,4400,2,6,6,2,14,9,5,24
Universitate,4400,3,5,5,4,18,19,-1,20
FC Botosani,4400,4,4,5,5,8,14,-6,17
D Bucuresti,4400,5,3,5,6,18,21,-3,14
Concordia Ch,4400,6,2,4,8,17,23,-6,10
FCSB,4401,1,8,6,0,26,11,15,30
CFR Cluj,4401,2,5,7,2,15,10,5,22
D Bucuresti,4401,3,4,5,5,18,18,0,17
Universitate,4401,4,4,5,5,16,21,-5,17
FC Botosani,4401,5,4,4,6,6,14,-8,16
Concordia Ch,4401,6,2,3,9,15,22,-7,9
FCSB,4402,1,8,5,1,27,11,16,29
CFR Cluj,4402,2,6,6,2,15,11,4,24
Universitate,4402,3,4,5,5,15,20,-5,17
D Bucuresti,4402,4,4,4,6,19,20,-1,16
FC Botosani,4402,5,4,4,6,7,15,-8,16
Concordia Ch,4402,6,3,2,9,17,23,-6,11
FCSB,4403,1,8,5,1,29,17,12,29
CFR Cluj,4403,2,5,7,2,16,11,5,22
Universitate,4403,3,4,6,4,20,22,-2,18
D Bucuresti,4403,4,4,4,6,18,21,-3,16
FC Botosani,4403,5,4,4,6,8,14,-6,16
Concordia Ch,4403,6,3,2,9,19,25,-6,11
FCSB,4404,1,9,5,0,28,12,16,32
CFR Cluj,4404,2,5,6,3,17,13,4,21
FC Botosani,4404,3,5,4,5,9,12,-3,19
Universitate,4404,4,4,5,5,17,22,-5,17
D Bucuresti,4404,5,3,4,7,17,22,-5,13
Concordia Ch,4404,6,3,2,9,17,24,-7,11
FCSB,4405,1,7,6,1,25,13,12,27
CFR Cluj,4405,2,6,7,1,14,7,7,25
D Bucuresti,4405,3,4,4,6,19,20,-1,16
Universitate,4405,4,3,7,4,16,20,-4,16
FC Botosani,4405,5,3,5,6,5,14,-9,14
Concordia Ch,4405,6,3,3,8,17,22,-5,12
FCSB,4406,1,7,5,2,24,15,9,26
CFR Cluj,4406,2,6,7,1,15,8,7,25
Universitate,4406,3,4,6,4,17,18,-1,18
D Bucuresti,4406,4,4,5,5,21,21,0,17
FC Botosani,4406,5,3,5,6,5,14,-9,14
Concordia Ch,4406,6,2,4,8,18,24,-6,10
FCSB,4407,1,8,5,1,27,12,15,29
CFR Cluj,4407,2,6,6,2,15,10,5,24
D Bucuresti,4407,3,4,5,5,21,21,0,17
Universitate,4407,4,4,5,5,16,21,-5,17
FC Botosani,4407,5,4,4,6,11,18,-7,16
Concordia Ch,4407,6,2,3,9,18,26,-8,9
FCSB,4408,1,7,7,0,25,12,13,28
CFR Cluj,4408,2,6,7,1,15,8,7,25
D Bucuresti,4408,3,3,6,5,18,20,-2,15
Universitate,4408,4,3,6,5,15,20,-5,15
FC Botosani,4408,5,3,6,5,7,14,-7,15
Concordia Ch,4408,6,2,4,8,17,23,-6,10
FCSB,4409,1,7,7,0,25,12,13,28
CFR Cluj,4409,2,5,8,1,15,9,6,23
FC Botosani,4409,3,4,5,5,7,13,-6,17
Universitate,4409,4,3,7,4,14,18,-4,16
D Bucuresti,4409,5,3,5,6,17,20,-3,14
Concordia Ch,4409,6,2,4,8,17,23,-6,10
FCSB,4410,1,7,6,1,23,11,12,27
CFR Cluj,4410,2,6,7,1,15,7,8,25
Universitate,4410,3,4,5,5,15,20,-5,17
FC Botosani,4410,4,4,5,5,7,13,-6,17
D Bucuresti,4410,5,3,5,6,16,19,-3,14
Concordia Ch,4410,6,2,4,8,16,22,-6,10
FCSB,4411,1,8,5,1,25,13,12,29
CFR Cluj,4411,2,5,6,3,13,10,3,21
Universitate,4411,3,5,5,4,18,18,0,20
D Bucuresti,4411,4,4,4,6,20,23,-3,16
FC Botosani,4411,5,4,4,6,8,16,-8,16
Concordia Ch,4411,6,3,2,9,19,23,-4,11
FCSB,4412,1,8,5,1,27,13,14,29
CFR Cluj,4412,2,6,6,2,15,10,5,24
FC Botosani,4412,3,5,4,5,8,13,-5,19
Universitate,4412,4,4,5,5,17,21,-4,17
D Bucuresti,4412,5,3,4,7,17,21,-4,13
Concordia Ch,4412,6,3,2,9,16,22,-6,11
FCSB,4413,1,7,6,1,24,13,11,27
CFR Cluj,4413,2,5,8,1,14,8,6,23
Universitate,4413,3,4,6,4,18,20,-2,18
D Bucuresti,4413,4,4,4,6,20,23,-3,16
FC Botosani,4413,5,4,4,6,9,15,-6,16
Concordia Ch,4413,6,3,2,9,20,26,-6,11
FCSB,4414,1,7,7,0,26,13,13,28
CFR Cluj,4414,2,5,7,2,16,11,5,22
Universitate,4414,3,4,6,4,17,20,-3,18
D Bucuresti,4414,4,4,5,5,17,18,-1,17
FC Botosani,4414,5,3,6,5,6,13,-7,15
Concordia Ch,4414,6,2,3,9,16,23,-7,9
FCSB,4415,1,8,6,0,26,10,16,30
CFR Cluj,4415,2,5,7,2,13,10,3,22
D Bucuresti,4415,3,4,5,5,20,20,0,17
Universitate,4415,4,3,7,4,14,18,-4,16
FC Botosani,4415,5,4,4,6,6,14,-8,16
Concordia Ch,4415,6,2,3,9,17,24,-7,9
FCSB,4416,1,8,6,0,27,10,17,30
CFR Cluj,4416,2,6,6,2,14,11,3,24
FC Botosani,4416,3,4,5,5,8,14,-6,17
Universitate,4416,4,3,6,5,14,19,-5,15
D Bucuresti,4416,5,3,5,6,19,22,-3,14
Concordia Ch,4416,6,2,4,8,18,24,-6,10
FCSB,4417,1,7,6,1,23,11,12,27
CFR Cluj,4417,2,6,7,1,14,7,7,25
Universitate,4417,3,4,5,5,15,19,-4,17
Concordia Ch,4417,4,4,2,8,21,22,-1,14
D Bucuresti,4417,5,3,5,6,17,22,-5,14
FC Botosani,4417,6,3,5,6,7,16,-9,14
CFR Cluj,4418,1,7,6,1,21,8,13,27
FCSB,4418,2,7,5,2,24,16,8,26
D Bucuresti,4418,3,4,5,5,20,19,1,17
Universitate,4418,4,4,5,5,17,23,-6,17
FC Botosani,4418,5,3,5,6,5,15,-10,14
Concordia Ch,4418,6,2,4,8,16,22,-6,10
FCSB,4419,1,9,5,0,26,11,15,32
CFR Cluj,4419,2,5,6,3,13,9,4,21
Universitate,4419,3,4,5,5,16,20,-4,17
D Bucuresti,4419,4,4,4,6,17,19,-2,16
Concordia Ch,4419,5,4,2,8,17,21,-4,14
FC Botosani,4419,6,3,4,7,5,14,-9,13
FCSB,4420,1,8,5,1,24,11,13,29
CFR Cluj,4420,2,5,7,2,14,9,5,22
Universitate,4420,3,4,6,4,16,19,-3,18
FC Botosani,4420,4,4,4,6,8,14,-6,16
D Bucuresti,4420,5,3,5,6,17,21,-4,14
Concordia Ch,4420,6,3,3,8,16,21,-5,12
FCSB,4421,1,9,5,0,27,10,17,32
CFR Cluj,4421,2,5,7,2,13,9,4,22
D Bucuresti,4421,3,4,5,5,20,20,0,17
Universitate,4421,4,3,6,5,14,20,-6,15
FC Botosani,4421,5,3,4,7,5,15,-10,13
Concordia Ch,4421,6,3,3,8,18,23,-5,12
FCSB,4422,1,9,5,0,26,11,15,32
CFR Cluj,4422,2,6,6,2,16,9,7,24
D Bucuresti,4422,3,5,4,5,18,18,0,19
Universitate,4422,4,3,5,6,14,21,-7,14
FC Botosani,4422,5,3,4,7,6,15,-9,13
Concordia Ch,4422,6,3,2,9,17,23,-6,11
FCSB,4423,1,8,5,1,26,13,13,29
CFR Cluj,4423,2,5,6,3,14,10,4,21
Universitate,4423,3,5,5,4,17,19,-2,20
FC Botosani,4423,4,5,4,5,7,12,-5,19
D Bucuresti,4423,5,3,4,7,16,22,-6,13
Concordia Ch,4423,6,3,2,9,18,22,-4,11
FCSB,4424,1,8,5,1,28,16,12,29
CFR Cluj,4424,2,7,6,1,19,8,11,27
FC Botosani,4424,3,3,6,5,7,14,-7,15
D Bucuresti,4424,4,3,5,6,18,21,-3,14
Universitate,4424,5,3,5,6,17,25,-8,14
Concordia Ch,4424,6,3,3,8,18,23,-5,12
FCSB,4425,1,8,5,1,25,12,13,29
CFR Cluj,4425,2,5,7,2,14,9,5,22
Universitate,4425,3,4,6,4,17,20,-3,18
D Bucuresti,4425,4,4,4,6,17,21,-4,16
Concordia Ch,4425,5,4,2,8,21,21,0,14
FC Botosani,4425,6,3,4,7,5,16,-11,13
FCSB,4426,1,8,6,0,28,12,16,30
CFR Cluj,4426,2,6,7,1,17,9,8,25
FC Botosani,4426,3,5,4,5,9,12,-3,19
D Bucuresti,4426,4,3,5,6,18,21,-3,14
Universitate,4426,5,3,5,6,16,25,-9,14
Concordia Ch,4426,6,2,3,9,17,26,-9,9
FCSB,4427,1,8,6,0,26,11,15,30
CFR Cluj,4427,2,5,6,3,13,10,3,21
Universitate,4427,3,4,6,4,16,19,-3,18
FC Botosani,4427,4,4,5,5,9,14,-5,17
D Bucuresti,4427,5,3,5,6,19,23,-4,14
Concordia Ch,4427,6,2,4,8,18,24,-6,10
FCSB,4428,1,8,6,0,27,12,15,30
CFR Cluj,4428,2,6,6,2,16,10,6,24
D Bucuresti,4428,3,4,5,5,20,20,0,17
Universitate,4428,4,3,6,5,15,21,-6,15
FC Botosani,4428,5,3,4,7,6,16,-10,13
Concordia Ch,4428,6,3,3,8,19,24,-5,12
FCSB,4429,1,7,7,0,24,11,13,28
CFR Cluj,4429,2,6,7,1,16,8,8,25
D Bucuresti,4429,3,4,4,6,19,24,-5,16
FC Botosani,4429,4,4,4,6,6,14,-8,16
Universitate,4429,5,3,6,5,16,22,-6,15
Concordia Ch,4429,6,3,2,9,21,23,-2,11
FCSB,4430,1,9,5,0,26,11,15,32
CFR Cluj,4430,2,5,6,3,13,9,4,21
Universitate,4430,3,4,5,5,16,20,-4,17
D Bucuresti,4430,4,4,4,6,18,21,-3,16
FC Botosani,4430,5,4,4,6,8,15,-7,16
Concordia Ch,4430,6,3,2,9,18,23,-5,11
FCSB,4431,1,9,5,0,26,11,15,32
CFR Cluj,4431,2,5,6,3,14,12,2,21
Universitate,4431,3,4,5,5,17,19,-2,17
FC Botosani,4431,4,4,5,5,10,16,-6,17
D Bucuresti,4431,5,3,5,6,19,22,-3,14
Concordia Ch,4431,6,3,2,9,19,25,-6,11
FCSB,4432,1,8,5,1,24,14,10,29
CFR Cluj,4432,2,6,6,2,15,9,6,24
Universitate,4432,3,4,5,5,19,20,-1,17
FC Botosani,4432,4,4,5,5,9,13,-4,17
D Bucuresti,4432,5,3,6,5,18,20,-2,15
Concordia Ch,4432,6,2,3,9,16,25,-9,9
FCSB,4433,1,7,7,0,25,12,13,28
CFR Cluj,4433,2,5,8,1,15,9,6,23
D Bucuresti,4433,3,4,4,6,20,21,-1,16
Universitate,4433,4,3,7,4,14,18,-4,16
FC Botosani,4433,5,4,4,6,8,16,-8,16
Concordia Ch,4433,6,3,2,9,19,25,-6,11
FCSB,4434,1,8,5,1,24,11,13,29
CFR Cluj,4434,2,7,6,1,15,7,8,27
FC Botosani,4434,3,5,4,5,8,13,-5,19
D Bucuresti,4434,4,4,4,6,19,21,-2,16
Universitate,4434,5,3,5,6,14,20,-6,14
Concordia Ch,4434,6,2,2,10,18,26,-8,8
FCSB,4435,1,8,6,0,26,11,15,30
CFR Cluj,4435,2,6,7,1,15,8,7,25
FC Botosani,4435,3,4,5,5,6,12,-6,17
Universitate,4435,4,3,5,6,14,21,-7,14
D Bucuresti,4435,5,3,4,7,18,22,-4,13
Concordia Ch,4435,6,3,3,8,18,23,-5,12
FCSB,4436,1,8,5,1,27,13,14,29
CFR Cluj,4436,2,5,7,2,15,11,4,22
D Bucuresti,4436,3,5,4,5,19,18,1,19
Universitate,4436,4,4,6,4,17,20,-3,18
FC Botosani,4436,5,4,4,6,7,14,-7,16
Concordia Ch,4436,6,2,2,10,16,25,-9,8
FCSB,4437,1,8,6,0,26,11,15,30
CFR Cluj,4437,2,6,6,2,18,9,9,24
D Bucuresti,4437,3,4,5,5,18,19,-1,17
Universitate,4437,4,3,6,5,15,24,-9,15
FC Botosani,4437,5,3,5,6,5,14,-9,14
Concordia Ch,4437,6,3,2,9,18,23,-5,11
FCSB,4438,1,7,5,2,24,14,10,26
CFR Cluj,4438,2,6,7,1,16,8,8,25
Universitate,4438,3,4,6,4,17,20,-3,18
D Bucuresti,4438,4,4,5,5,18,19,-1,17
FC Botosani,4438,5,4,4,6,7,13,-6,16
Concordia Ch,4438,6,2,3,9,16,24,-8,9
FCSB,4439,1,8,6,0,29,11,18,30
CFR Cluj,4439,2,6,6,2,15,12,3,24
FC Botosani,4439,3,5,4,5,9,12,-3,19
Universitate,4439,4,3,6,5,15,21,-6,15
D Bucuresti,4439,5,3,4,7,16,21,-5,13
Concordia Ch,4439,6,3,2,9,16,23,-7,11
FCSB,4440,1,9,5,0,28,10,18,32
CFR Cluj,4440,2,5,7,2,14,9,5,22
FC Botosani,4440,3,4,5,5,10,16,-6,17
Universitate,4440,4,3,6,5,15,23,-8,15
D Bucuresti,4440,5,3,5,6,18,21,-3,14
Concordia Ch,4440,6,3,2,9,18,24,-6,11
FCSB,4441,1,8,5,1,25,12,13,29
CFR Cluj,4441,2,6,6,2,15,9,6,24
D Bucuresti,4441,3,4,5,5,18,19,-1,17
Universitate,4441,4,4,5,5,16,20,-4,17
FC Botosani,4441,5,3,6,5,6,13,-7,15
Concordia Ch,4441,6,2,3,9,17,24,-7,9
FCSB,4442,1,8,5,1,24,11,13,29
CFR Cluj,4442,2,5,6,3,13,9,4,21
Universitate,4442,3,5,5,4,16,18,-2,20
FC Botosani,4442,4,3,6,5,6,13,-7,15
D Bucuresti,4442,5,3,5,6,17,20,-3,14
Concordia Ch,4442,6,3,3,8,18,23,-5,12
FCSB,4443,1,7,7,0,29,16,13,28
CFR Cluj,4443,2,6,7,1,18,10,8,25
D Bucuresti,4443,3,4,4,6,18,21,-3,16
Universitate,4443,4,3,6,5,17,23,-6,15
FC Botosani,4443,5,3,5,6,6,14,-8,14
Concordia Ch,4443,6,3,3,8,19,23,-4,12
FCSB,4444,1,7,6,1,26,14,12,27
CFR Cluj,4444,2,6,7,1,17,9,8,25
FC Botosani,4444,3,5,4,5,12,15,-3,19
Universitate,4444,4,4,5,5,16,21,-5,17
D Bucuresti,4444,5,3,5,6,19,22,-3,14
Concordia Ch,4444,6,2,3,9,19,28,-9,9
FCSB,4445,1,8,5,1,27,13,14,29
CFR Cluj,4445,2,6,6,2,17,10,7,24
FC Botosani,4445,3,5,4,5,8,12,-4,19
Universitate,4445,4,4,5,5,18,24,-6,17
D Bucuresti,4445,5,3,4,7,18,22,-4,13
Concordia Ch,4445,6,3,2,9,18,25,-7,11
FCSB,4446,1,8,5,1,24,11,13,29
CFR Cluj,4446,2,5,6,3,13,9,4,21
Universitate,4446,3,5,5,4,16,18,-2,20
D Bucuresti,4446,4,4,5,5,17,18,-1,17
FC Botosani,4446,5,3,4,7,7,16,-9,13
Concordia Ch,4446,6,3,3,8,18,23,-5,12
FCSB,4447,1,7,6,1,25,14,11,27
CFR Cluj,4447,2,5,8,1,14,8,6,23
Universitate,4447,3,4,6,4,17,19,-2,18
D Bucuresti,4447,4,4,5,5,18,19,-1,17
FC Botosani,4447,5,3,6,5,7,14,-7,15
Concordia Ch,4447,6,2,3,9,18,25,-7,9
FCSB,4448,1,8,6,0,25,11,14,30
CFR Cluj,4448,2,6,6,2,15,8,7,24
D Bucuresti,4448,3,4,4,6,17,20,-3,16
Universitate,4448,4,3,6,5,15,21,-6,15
Concordia Ch,4448,5,4,2,8,19,21,-2,14
FC Botosani,4448,6,3,4,7,5,15,-10,13
FCSB,4449,1,8,6,0,27,13,14,30
CFR Cluj,4449,2,5,7,2,15,10,5,22
Universitate,4449,3,4,5,5,18,22,-4,17
FC Botosani,4449,4,3,6,5,7,14,-7,15
D Bucuresti,4449,5,3,5,6,17,21,-4,14
Concordia Ch,4449,6,3,3,8,18,22,-4,12
FCSB,4450,1,8,5,1,27,13,14,29
CFR Cluj,4450,2,6,6,2,14,9,5,24
Universitate,4450,3,4,5,5,17,21,-4,17
D Bucuresti,4450,4,4,4,6,18,20,-2,16
FC Botosani,4450,5,4,4,6,7,14,-7,16
Concordia Ch,4450,6,3,2,9,18,24,-6,11
FCSB,4451,1,7,6,1,25,13,12,27
CFR Cluj,4451,2,5,7,2,16,11,5,22
Universitate,4451,3,5,5,4,17,19,-2,20
D Bucuresti,4451,4,5,4,5,20,19,1,19
FC Botosani,4451,5,4,4,6,8,14,-6,16
Concordia Ch,4451,6,2,2,10,15,25,-10,8
FCSB,4452,1,7,7,0,26,13,13,28
CFR Cluj,4452,2,5,8,1,15,9,6,23
D Bucuresti,4452,3,4,4,6,19,21,-2,16
Universitate,4452,4,3,7,4,17,21,-4,16
Concordia Ch,4452,5,4,2,8,19,23,-4,14
FC Botosani,4452,6,3,4,7,5,14,-9,13
FCSB,4453,1,9,5,0,28,12,16,32
CFR Cluj,4453,2,6,6,2,17,9,8,24
FC Botosani,4453,3,4,4,6,7,14,-7,16
D Bucuresti,4453,4,3,5,6,18,22,-4,14
Universitate,4453,5,3,5,6,15,24,-9,14
Concordia Ch,4453,6,3,3,8,19,23,-4,12
FCSB,4454,1,8,5,1,26,12,14,29
CFR Cluj,4454,2,6,6,2,15,10,5,24
Universitate,4454,3,4,5,5,17,21,-4,17
FC Botosani,4454,4,3,6,5,7,14,-7,15
D Bucuresti,4454,5,3,5,6,17,21,-4,14
Concordia Ch,4454,6,3,3,8,20,24,-4,12
FCSB,4455,1,8,5,1,26,12,14,29
CFR Cluj,4455,2,6,6,2,14,9,5,24
Universitate,4455,3,4,5,5,16,20,-4,17
D Bucuresti,4455,4,4,4,6,19,21,-2,16
Concordia Ch,4455,5,4,2,8,21,21,0,14
FC Botosani,4455,6,3,4,7,5,18,-13,13
FCSB,4456,1,7,5,2,25,14,11,26
CFR Cluj,4456,2,6,6,2,14,8,6,24
Universitate,4456,3,5,5,4,18,20,-2,20
FC Botosani,4456,4,4,5,5,9,13,-4,17
D Bucuresti,4456,5,3,4,7,16,26,-10,13
Concordia Ch,4456,6,3,3,8,21,22,-1,12
FCSB,4457,1,7,6,1,25,13,12,27
CFR Cluj,4457,2,6,7,1,15,8,7,25
Universitate,4457,3,4,5,5,16,20,-4,17
D Bucuresti,4457,4,4,4,6,18,20,-2,16
Concordia Ch,4457,5,4,2,8,17,21,-4,14
FC Botosani,4457,6,3,4,7,6,15,-9,13
CFR Cluj,4458,1,7,6,1,18,9,9,27
FCSB,4458,2,7,5,2,24,13,11,26
Universitate,4458,3,4,5,5,16,21,-5,17
FC Botosani,4458,4,4,5,5,7,13,-6,17
D Bucuresti,4458,5,3,4,7,17,21,-4,13
Concordia Ch,4458,6,3,3,8,18,23,-5,12
FCSB,4459,1,7,6,1,25,14,11,27
CFR Cluj,4459,2,6,7,1,15,7,8,25
Universitate,4459,3,4,5,5,18,22,-4,17
D Bucuresti,4459,4,4,4,6,18,20,-2,16
FC Botosani,4459,5,4,4,6,7,13,-6,16
Concordia Ch,4459,6,3,2,9,16,23,-7,11
FCSB,4460,1,7,6,1,24,14,10,27
CFR Cluj,4460,2,6,7,1,15,8,7,25
Universitate,4460,3,4,5,5,17,19,-2,17
D Bucuresti,4460,4,4,4,6,18,20,-2,16
FC Botosani,4460,5,4,4,6,8,13,-5,16
Concordia Ch,4460,6,3,2,9,17,25,-8,11
FCSB,4461,1,9,5,0,29,11,18,32
CFR Cluj,4461,2,5,7,2,15,10,5,22
FC Botosani,4461,3,5,4,5,8,12,-4,19
Universitate,4461,4,3,6,5,17,25,-8,15
D Bucuresti,4461,5,3,4,7,16,20,-4,13
Concordia Ch,4461,6,3,2,9,16,23,-7,11
FCSB,4462,1,8,5,1,24,13,11,29
CFR Cluj,4462,2,6,6,2,14,8,6,24
D Bucuresti,4462,3,5,4,5,18,18,0,19
Universitate,4462,4,4,5,5,17,19,-2,17
FC Botosani,4462,5,4,4,6,6,13,-7,16
Concordia Ch,4462,6,2,2,10,15,23,-8,8
FCSB,4463,1,7,7,0,25,12,13,28
CFR Cluj,4463,2,6,7,1,15,7,8,25
FC Botosani,4463,3,4,5,5,8,14,-6,17
Universitate,4463,4,3,6,5,16,22,-6,15
D Bucuresti,4463,5,3,5,6,18,21,-3,14
Concordia Ch,4463,6,2,4,8,17,23,-6,10
FCSB,4464,1,7,5,2,24,13,11,26
CFR Cluj,4464,2,6,7,1,15,8,7,25
Universitate,4464,3,4,6,4,17,20,-3,18
D Bucuresti,4464,4,4,5,5,18,19,-1,17
FC Botosani,4464,5,3,5,6,5,13,-8,14
Concordia Ch,4464,6,2,4,8,16,22,-6,10
FCSB,4465,1,9,5,0,30,13,17,32
CFR Cluj,4465,2,5,7,2,15,11,4,22
D Bucuresti,4465,3,5,4,5,20,19,1,19
Universitate,4465,4,3,6,5,17,23,-6,15
FC Botosani,4465,5,3,4,7,6,15,-9,13
Concordia Ch,4465,6,3,2,9,16,23,-7,11
FCSB,4466,1,8,6,0,25,11,14,30
CFR Cluj,4466,2,6,6,2,16,10,6,24
D Bucuresti,4466,3,4,5,5,19,19,0,17
Universitate,4466,4,3,6,5,15,20,-5,15
FC Botosani,4466,5,3,5,6,5,14,-9,14
Concordia Ch,4466,6,2,4,8,16,22,-6,10
FCSB,4467,1,9,5,0,27,10,17,32
CFR Cluj,4467,2,5,7,2,14,9,5,22
D Bucuresti,4467,3,4,5,5,21,21,0,17
FC Botosani,4467,4,4,5,5,7,13,-6,17
Universitate,4467,5,3,6,5,15,22,-7,15
Concordia Ch,4467,6,2,2,10,17,26,-9,8
FCSB,4468,1,8,5,1,27,14,13,29
CFR Cluj,4468,2,7,6,1,19,9,10,27
Concordia Ch,4468,3,4,2,8,21,21,0,14
D Bucuresti,4468,4,3,5,6,18,25,-7,14
Universitate,4468,5,3,5,6,15,23,-8,14
FC Botosani,4468,6,3,5,6,7,15,-8,14
FCSB,4469,1,7,6,1,24,12,12,27
CFR Cluj,4469,2,6,6,2,15,9,6,24
Universitate,4469,3,4,6,4,17,20,-3,18
FC Botosani,4469,4,4,5,5,10,16,-6,17
D Bucuresti,4469,5,4,4,6,20,22,-2,16
Concordia Ch,4469,6,2,3,9,16,23,-7,9
FCSB,4470,1,7,6,1,23,13,10,27
CFR Cluj,4470,2,5,8,1,14,8,6,23
Universitate,4470,3,4,6,4,18,19,-1,18
D Bucuresti,4470,4,4,4,6,18,20,-2,16
FC Botosani,4470,5,4,4,6,7,14,-7,16
Concordia Ch,4470,6,3,2,9,18,24,-6,11
FCSB,4471,1,7,7,0,25,12,13,28
CFR Cluj,4471,2,6,7,1,18,10,8,25
FC Botosani,4471,3,4,5,5,8,13,-5,17
D Bucuresti,4471,4,4,4,6,19,21,-2,16
Universitate,4471,5,3,6,5,15,21,-6,15
Concordia Ch,4471,6,2,3,9,17,25,-8,9
FCSB,4472,1,9,5,0,29,11,18,32
CFR Cluj,4472,2,5,7,2,13,10,3,22
D Bucuresti,4472,3,4,4,6,18,20,-2,16
FC Botosani,4472,4,4,4,6,8,15,-7,16
Universitate,4472,5,3,6,5,15,21,-6,15
Concordia Ch,4472,6,3,2,9,17,23,-6,11
FCSB,4473,1,7,6,1,24,13,11,27
CFR Cluj,4473,2,6,7,1,18,9,9,25
D Bucuresti,4473,3,4,5,5,17,18,-1,17
Universitate,4473,4,4,5,5,17,22,-5,17
FC Botosani,4473,5,4,5,5,7,12,-5,17
Concordia Ch,4473,6,2,2,10,15,24,-9,8
FCSB,4474,1,8,6,0,26,11,15,30
CFR Cluj,4474,2,5,8,1,13,7,6,23
FC Botosani,4474,3,5,4,5,10,15,-5,19
D Bucuresti,4474,4,4,4,6,18,20,-2,16
Universitate,4474,5,3,6,5,15,21,-6,15
Concordia Ch,4474,6,2,2,10,17,25,-8,8
FCSB,4475,1,8,5,1,26,11,15,29
CFR Cluj,4475,2,6,7,1,14,7,7,25
Universitate,4475,3,3,6,5,14,21,-7,15
FC Botosani,4475,4,3,6,5,7,14,-7,15
D Bucuresti,4475,5,3,5,6,18,22,-4,14
Concordia Ch,4475,6,3,3,8,19,23,-4,12
FCSB,4476,1,8,6,0,26,11,15,30
CFR Cluj,4476,2,5,6,3,13,11,2,21
D Bucuresti,4476,3,5,4,5,19,19,0,19
Universitate,4476,4,4,6,4,17,19,-2,18
FC Botosani,4476,5,4,4,6,7,14,-7,16
Concordia Ch,4476,6,2,2,10,15,23,-8,8
FCSB,4477,1,8,5,1,26,11,15,29
CFR Cluj,4477,2,5,6,3,13,11,2,21
Universitate,4477,3,5,5,4,16,18,-2,20
D Bucuresti,4477,4,4,4,6,17,20,-3,16
FC Botosani,4477,5,4,4,6,7,14,-7,16
Concordia Ch,4477,6,3,2,9,17,22,-5,11
FCSB,4478,1,8,6,0,25,11,14,30
CFR Cluj,4478,2,6,7,1,16,7,9,25
D Bucuresti,4478,3,4,5,5,19,20,-1,17
Universitate,4478,4,3,5,6,15,23,-8,14
FC Botosani,4478,5,3,4,7,7,16,-9,13
Concordia Ch,4478,6,3,3,8,20,25,-5,12
FCSB,4479,1,8,5,1,25,12,13,29
CFR Cluj,4479,2,5,6,3,15,12,3,21
Universitate,4479,3,5,5,4,18,19,-1,20
FC Botosani,4479,4,4,5,5,8,13,-5,17
D Bucuresti,4479,5,3,5,6,17,20,-3,14
Concordia Ch,4479,6,3,2,9,16,23,-7,11
FCSB,4480,1,8,5,1,27,13,14,29
CFR Cluj,4480,2,6,6,2,15,9,6,24
D Bucuresti,4480,3,4,5,5,20,21,-1,17
Universitate,4480,4,4,5,5,16,21,-5,17
FC Botosani,4480,5,3,5,6,7,15,-8,14
Concordia Ch,4480,6,2,4,8,16,22,-6,10
FCSB,4481,1,8,6,0,25,11,14,30
CFR Cluj,4481,2,6,7,1,15,8,7,25
D Bucuresti,4481,3,5,4,5,18,18,0,19
FC Botosani,4481,4,4,4,6,10,15,-5,16
Universitate,4481,5,3,5,6,16,22,-6,14
Concordia Ch,4481,6,2,2,10,17,27,-10,8
FCSB,4482,1,7,7,0,24,11,13,28
CFR Cluj,4482,2,5,7,2,13,8,5,22
FC Botosani,4482,3,5,4,5,9,13,-4,19
Universitate,4482,4,4,6,4,16,19,-3,18
D Bucuresti,4482,5,3,5,6,18,21,-3,14
Concordia Ch,4482,6,2,3,9,16,24,-8,9
FCSB,4483,1,8,5,1,24,12,12,29
CFR Cluj,4483,2,6,6,2,15,8,7,24
Universitate,4483,3,4,5,5,16,20,-4,17
Concordia Ch,4483,4,4,2,8,22,22,0,14
D Bucuresti,4483,5,3,5,6,18,23,-5,14
FC Botosani,4483,6,3,5,6,6,16,-10,14
FCSB,4484,1,7,6,1,25,14,11,27
CFR Cluj,4484,2,5,7,2,15,10,5,22
Universitate,4484,3,5,5,4,21,22,-1,20
D Bucuresti,4484,4,5,4,5,19,19,0,19
FC Botosani,4484,5,3,5,6,6,14,-8,14
Concordia Ch,4484,6,2,3,9,17,24,-7,9
FCSB,4485,1,8,5,1,27,13,14,29
CFR Cluj,4485,2,5,6,3,14,11,3,21
Universitate,4485,3,5,5,4,17,19,-2,20
D Bucuresti,4485,4,5,4,5,18,18,0,19
FC Botosani,4485,5,4,4,6,7,13,-6,16
Concordia Ch,4485,6,2,2,10,15,24,-9,8
FCSB,4486,1,8,6,0,25,11,14,30
CFR Cluj,4486,2,6,7,1,16,9,7,25
FC Botosani,4486,3,5,4,5,9,12,-3,19
D Bucuresti,4486,4,4,4,6,20,19,1,16
Universitate,4486,5,3,5,6,15,21,-6,14
Concordia Ch,4486,6,2,2,10,15,28,-13,8
FCSB,4487,1,7,6,1,24,12,12,27
CFR Cluj,4487,2,5,7,2,14,12,2,22
Universitate,4487,3,5,5,4,19,18,1,20
D Bucuresti,4487,4,4,4,6,19,22,-3,16
FC Botosani,4487,5,3,5,6,9,17,-8,14
Concordia Ch,4487,6,3,3,8,19,23,-4,12
FCSB,4488,1,7,7,0,23,10,13,28
CFR Cluj,4488,2,5,8,1,14,8,6,23
Universitate,4488,3,3,7,4,15,19,-4,16
FC Botosani,4488,4,3,6,5,7,14,-7,15
D Bucuresti,4488,5,3,5,6,17,21,-4,14
Concordia Ch,4488,6,3,3,8,18,22,-4,12
FCSB,4489,1,7,6,1,24,12,12,27
CFR Cluj,4489,2,7,6,1,16,8,8,27
D Bucuresti,4489,3,5,4,5,19,18,1,19
FC Botosani,4489,4,4,4,6,6,13,-7,16
Universitate,4489,5,3,6,5,16,21,-5,15
Concordia Ch,4489,6,2,2,10,15,24,-9,8
FCSB,4490,1,8,5,1,27,12,15,29
CFR Cluj,4490,2,5,7,2,13,10,3,22
Universitate,4490,3,4,6,4,16,19,-3,18
FC Botosani,4490,4,3,6,5,5,12,-7,15
D Bucuresti,4490,5,3,5,6,17,21,-4,14
Concordia Ch,4490,6,3,3,8,18,22,-4,12
FCSB,4491,1,8,5,1,25,13,12,29
CFR Cluj,4491,2,6,6,2,14,8,6,24
Universitate,4491,3,4,5,5,17,20,-3,17
D Bucuresti,4491,4,4,4,6,18,20,-2,16
Concordia Ch,4491,5,4,2,8,20,22,-2,14
FC Botosani,4491,6,3,4,7,6,17,-11,13
FCSB,4492,1,9,5,0,27,11,16,32
CFR Cluj,4492,2,6,6,2,14,8,6,24
D Bucuresti,4492,3,4,4,6,18,19,-1,16
Concordia Ch,4492,4,4,2,8,18,21,-3,14
Universitate,4492,5,3,5,6,15,22,-7,14
FC Botosani,4492,6,3,4,7,5,16,-11,13
FCSB,4493,1,8,5,1,25,14,11,29
CFR Cluj,4493,2,7,6,1,18,7,11,27
D Bucuresti,4493,3,4,4,6,20,20,0,16
Concordia Ch,4493,4,4,2,8,19,22,-3,14
Universitate,4493,5,3,5,6,15,22,-7,14
FC Botosani,4493,6,3,4,7,5,17,-12,13
FCSB,4494,1,7,7,0,26,13,13,28
CFR Cluj,4494,2,5,7,2,15,10,5,22
Universitate,4494,3,4,6,4,18,21,-3,18
D Bucuresti,4494,4,3,6,5,17,19,-2,15
FC Botosani,4494,5,3,6,5,6,13,-7,15
Concordia Ch,4494,6,2,4,8,17,23,-6,10
FCSB,4495,1,7,5,2,24,17,7,26
CFR Cluj,4495,2,6,7,1,18,10,8,25
Universitate,4495,3,4,6,4,20,20,0,18
FC Botosani,4495,4,4,5,5,9,14,-5,17
D Bucuresti,4495,5,3,6,5,18,20,-2,15
Concordia Ch,4495,6,2,3,9,17,25,-8,9
CFR Cluj,4496,1,7,6,1,15,7,8,27
FCSB,4496,2,7,5,2,25,14,11,26
D Bucuresti,4496,3,4,5,5,19,20,-1,17
Universitate,4496,4,4,5,5,17,21,-4,17
FC Botosani,4496,5,4,5,5,6,12,-6,17
Concordia Ch,4496,6,2,2,10,17,25,-8,8
FCSB,4497,1,7,6,1,24,12,12,27
CFR Cluj,4497,2,6,6,2,15,9,6,24
Universitate,4497,3,4,6,4,15,18,-3,18
D Bucuresti,4497,4,4,4,6,19,21,-2,16
Concordia Ch,4497,5,4,2,8,20,24,-4,14
FC Botosani,4497,6,3,4,7,6,15,-9,13
FCSB,4498,1,7,6,1,25,13,12,27
CFR Cluj,4498,2,6,7,1,19,9,10,25
Universitate,4498,3,4,5,5,15,22,-7,17
FC Botosani,4498,4,4,4,6,7,13,-6,16
D Bucuresti,4498,5,3,5,6,17,21,-4,14
Concordia Ch,4498,6,3,3,8,17,22,-5,12
FCSB,4499,1,7,6,1,26,14,12,27
CFR Cluj,4499,2,5,7,2,14,10,4,22
Universitate,4499,3,5,5,4,19,20,-1,20
FC Botosani,4499,4,5,4,5,9,13,-4,19
D Bucuresti,4499,5,3,4,7,16,20,-4,13
Concordia Ch,4499,6,3,2,9,17,24,-7,11
FCSB,4500,1,9,5,0,27,12,15,32
CFR Cluj,4500,2,6,6,2,17,9,8,24
FC Botosani,4500,3,5,4,5,9,14,-5,19
Universitate,4500,4,3,5,6,17,25,-8,14
D Bucuresti,4500,5,3,4,7,17,21,-4,13
Concordia Ch,4500,6,3,2,9,17,23,-6,11
FCSB,4501,1,7,6,1,25,15,10,27
CFR Cluj,4501,2,5,8,1,17,11,6,23
Universitate,4501,3,4,6,4,19,20,-1,18
D Bucuresti,4501,4,4,5,5,19,20,-1,17
FC Botosani,4501,5,4,4,6,9,16,-7,16
Concordia Ch,4501,6,2,3,9,16,23,-7,9
FCSB,4502,1,7,5,2,24,15,9,26
CFR Cluj,4502,2,6,7,1,16,9,7,25
Universitate,4502,3,4,6,4,18,19,-1,18
D Bucuresti,4502,4,4,5,5,21,21,0,17
FC Botosani,4502,5,4,4,6,7,15,-8,16
Concordia Ch,4502,6,2,3,9,17,24,-7,9
FCSB,4503,1,8,5,1,26,12,14,29
CFR Cluj,4503,2,5,7,2,13,10,3,22
Universitate,4503,3,4,6,4,16,18,-2,18
D Bucuresti,4503,4,3,6,5,16,18,-2,15
FC Botosani,4503,5,3,6,5,5,12,-7,15
Concordia Ch,4503,6,2,4,8,15,21,-6,10
FCSB,4504,1,9,5,0,26,10,16,32
CFR Cluj,4504,2,6,6,2,16,10,6,24
D Bucuresti,4504,3,4,4,6,17,19,-2,16
FC Botosani,4504,4,4,4,6,8,15,-7,16
Universitate,4504,5,3,5,6,15,22,-7,14
Concordia Ch,4504,6,3,2,9,18,24,-6,11
FCSB,4505,1,8,5,1,26,12,14,29
CFR Cluj,4505,2,5,6,3,13,11,2,21
Universitate,4505,3,5,5,4,17,18,-1,20
FC Botosani,4505,4,5,4,5,8,12,-4,19
D Bucuresti,4505,5,3,5,6,16,20,-4,14
Concordia Ch,4505,6,2,3,9,15,22,-7,9
FCSB,4506,1,9,5,0,26,10,16,32
CFR Cluj,4506,2,5,6,3,13,10,3,21
Universitate,4506,3,4,5,5,15,19,-4,17
D Bucuresti,4506,4,3,5,6,17,20,-3,14
Concordia Ch,4506,5,4,2,8,18,22,-4,14
FC Botosani,4506,6,3,5,6,5,13,-8,14
FCSB,4507,1,8,6,0,25,11,14,30
CFR Cluj,4507,2,6,7,1,17,9,8,25
D Bucuresti,4507,3,4,4,6,17,20,-3,16
Universitate,4507,4,3,5,6,15,22,-7,14
FC Botosani,4507,5,3,5,6,5,13,-8,14
Concordia Ch,4507,6,3,3,8,17,21,-4,12
FCSB,4508,1,8,5,1,26,11,15,29
CFR Cluj,4508,2,5,7,2,13,10,3,22
FC Botosani,4508,3,5,4,5,8,13,-5,19
Universitate,4508,4,4,6,4,15,18,-3,18
D Bucuresti,4508,5,3,4,7,17,27,-10,13
Concordia Ch,4508,6,3,2,9,22,22,0,11
FCSB,4509,1,8,5,1,25,11,14,29
CFR Cluj,4509,2,6,6,2,14,8,6,24
Universitate,4509,3,4,5,5,15,20,-5,17
D Bucuresti,4509,4,4,4,6,20,20,0,16
FC Botosani,4509,5,4,4,6,7,16,-9,16
Concordia Ch,4509,6,3,2,9,18,24,-6,11
FCSB,4510,1,8,5,1,25,12,13,29
CFR Cluj,4510,2,5,6,3,14,11,3,21
Universitate,4510,3,5,5,4,18,19,-1,20
D Bucuresti,4510,4,4,4,6,20,22,-2,16
FC Botosani,4510,5,4,4,6,8,15,-7,16
Concordia Ch,4510,6,3,2,9,17,23,-6,11
FCSB,4511,1,7,7,0,25,12,13,28
CFR Cluj,4511,2,5,8,1,14,8,6,23
FC Botosani,4511,3,4,5,5,7,13,-6,17
Universitate,4511,4,3,7,4,17,21,-4,16
D Bucuresti,4511,5,3,5,6,16,19,-3,14
Concordia Ch,4511,6,3,2,9,17,23,-6,11
FCSB,4512,1,8,5,1,26,13,13,29
CFR Cluj,4512,2,5,7,2,14,10,4,22
FC Botosani,4512,3,5,4,5,10,14,-4,19
Universitate,4512,4,4,6,4,18,20,-2,18
D Bucuresti,4512,5,3,5,6,19,23,-4,14
Concordia Ch,4512,6,2,3,9,16,23,-7,9
FCSB,4513,1,8,5,1,29,14,15,29
CFR Cluj,4513,2,5,6,3,14,12,2,21
Universitate,4513,3,5,5,4,18,20,-2,20
Concordia Ch,4513,4,4,2,8,21,21,0,14
D Bucuresti,4513,5,3,5,6,17,24,-7,14
FC Botosani,4513,6,3,5,6,6,14,-8,14
FCSB,4514,1,9,5,0,25,10,15,32
CFR Cluj,4514,2,6,6,2,14,8,6,24
D Bucuresti,4514,3,3,5,6,18,21,-3,14
Concordia Ch,4514,4,4,2,8,18,22,-4,14
Universitate,4514,5,3,5,6,14,20,-6,14
FC Botosani,4514,6,3,5,6,8,16,-8,14
FCSB,4515,1,8,5,1,26,13,13,29
CFR Cluj,4515,2,6,6,2,15,11,4,24
Universitate,4515,3,4,5,5,18,20,-2,17
D Bucuresti,4515,4,4,4,6,18,20,-2,16
FC Botosani,4515,5,4,4,6,6,14,-8,16
Concordia Ch,4515,6,3,2,9,17,22,-5,11
FCSB,4516,1,7,6,1,24,13,11,27
CFR Cluj,4516,2,5,7,2,14,9,5,22
Universitate,4516,3,5,5,4,17,18,-1,20
D Bucuresti,4516,4,3,6,5,19,21,-2,15
FC Botosani,4516,5,3,6,5,7,14,-7,15
Concordia Ch,4516,6,2,4,8,18,24,-6,10
FCSB,4517,1,7,7,0,26,13,13,28
CFR Cluj,4517,2,5,8,1,17,11,6,23
FC Botosani,4517,3,4,5,5,8,13,-5,17
Universitate,4517,4,3,7,4,17,21,-4,16
D Bucuresti,4517,5,3,6,5,17,19,-2,15
Concordia Ch,4517,6,2,3,9,15,23,-8,9
FCSB,4518,1,7,6,1,23,11,12,27
CFR Cluj,4518,2,5,8,1,14,8,6,23
Universitate,4518,3,4,6,4,16,19,-3,18
FC Botosani,4518,4,4,4,6,8,15,-7,16
Concordia Ch,4518,5,4,2,8,21,23,-2,14
D Bucuresti,4518,6,3,4,7,16,22,-6,13
FCSB,4519,1,9,5,0,28,11,17,32
CFR Cluj,4519,2,6,6,2,14,8,6,24
D Bucuresti,4519,3,4,4,6,19,21,-2,16
FC Botosani,4519,4,4,4,6,7,15,-8,16
Universitate,4519,5,3,5,6,15,23,-8,14
Concordia Ch,4519,6,3,2,9,17,22,-5,11
FCSB,4520,1,8,6,0,25,10,15,30
CFR Cluj,4520,2,6,7,1,15,7,8,25
FC Botosani,4520,3,5,4,5,8,13,-5,19
Universitate,4520,4,3,5,6,14,22,-8,14
D Bucuresti,4520,5,3,4,7,18,22,-4,13
Concordia Ch,4520,6,3,2,9,19,25,-6,11
FCSB,4521,1,8,5,1,25,14,11,29
CFR Cluj,4521,2,7,6,1,18,8,10,27
D Bucuresti,4521,3,5,4,5,20,19,1,19
FC Botosani,4521,4,4,4,6,6,14,-8,16
Universitate,4521,5,3,5,6,16,22,-6,14
Concordia Ch,4521,6,2,2,10,16,24,-8,8
FCSB,4522,1,8,5,1,26,15,11,29
CFR Cluj,4522,2,6,6,2,18,10,8,24
D Bucuresti,4522,3,4,5,5,20,20,0,17
Universitate,4522,4,4,5,5,17,21,-4,17
FC Botosani,4522,5,3,5,6,7,16,-9,14
Concordia Ch,4522,6,2,4,8,15,21,-6,10
FCSB,4523,1,9,5,0,25,10,15,32
CFR Cluj,4523,2,5,6,3,14,10,4,21
D Bucuresti,4523,3,4,5,5,18,19,-1,17
Universitate,4523,4,4,5,5,16,20,-4,17
FC Botosani,4523,5,3,5,6,7,15,-8,14
Concordia Ch,4523,6,2,4,8,18,24,-6,10
FCSB,4524,1,8,5,1,25,14,11,29
CFR Cluj,4524,2,6,6,2,15,9,6,24
FC Botosani,4524,3,5,4,5,11,16,-5,19
Universitate,4524,4,4,5,5,17,19,-2,17
D Bucuresti,4524,5,3,4,7,19,23,-4,13
Concordia Ch,4524,6,3,2,9,19,25,-6,11
FCSB,4525,1,7,6,1,24,12,12,27
CFR Cluj,4525,2,5,8,1,13,7,6,23
Universitate,4525,3,4,6,4,16,19,-3,18
FC Botosani,4525,4,4,5,5,7,13,-6,17
D Bucuresti,4525,5,3,6,5,18,20,-2,15
Concordia Ch,4525,6,2,3,9,16,23,-7,9
FCSB,4526,1,9,5,0,28,12,16,32
CFR Cluj,4526,2,6,6,2,14,9,5,24
FC Botosani,4526,3,4,5,5,7,13,-6,17
D Bucuresti,4526,4,3,5,6,18,23,-5,14
Universitate,4526,5,3,5,6,16,22,-6,14
Concordia Ch,4526,6,3,2,9,19,23,-4,11
FCSB,4527,1,8,6,0,25,11,14,30
CFR Cluj,4527,2,6,7,1,17,8,9,25
FC Botosani,4527,3,4,5,5,8,14,-6,17
D Bucuresti,4527,4,3,6,5,18,20,-2,15
Universitate,4527,5,3,5,6,14,22,-8,14
Concordia Ch,4527,6,2,3,9,17,24,-7,9
FCSB,4528,1,7,7,0,25,12,13,28
CFR Cluj,4528,2,6,7,1,14,7,7,25
D Bucuresti,4528,3,5,4,5,20,19,1,19
FC Botosani,4528,4,4,4,6,8,16,-8,16
Universitate,4528,5,3,6,5,16,21,-5,15
Concordia Ch,4528,6,2,2,10,16,24,-8,8
FCSB,4529,1,7,7,0,26,13,13,28
CFR Cluj,4529,2,6,7,1,16,9,7,25
D Bucuresti,4529,3,3,6,5,18,20,-2,15
Universitate,4529,4,3,6,5,15,20,-5,15
FC Botosani,4529,5,3,6,5,7,14,-7,15
Concordia Ch,4529,6,2,4,8,17,23,-6,10
FCSB,4530,1,7,6,1,26,14,12,27
CFR Cluj,4530,2,6,6,2,15,9,6,24
Universitate,4530,3,4,6,4,17,20,-3,18
FC Botosani,4530,4,4,5,5,6,12,-6,17
D Bucuresti,4530,5,3,5,6,17,20,-3,14
Concordia Ch,4530,6,2,4,8,16,22,-6,10
FCSB,4531,1,8,5,1,26,12,14,29
CFR Cluj,4531,2,5,7,2,15,11,4,22
D Bucuresti,4531,3,5,4,5,19,19,0,19
Universitate,4531,4,4,6,4,16,19,-3,18
FC Botosani,4531,5,3,4,7,8,17,-9,13
Concordia Ch,4531,6,3,2,9,18,24,-6,11
FCSB,4532,1,8,5,1,24,11,13,29
CFR Cluj,4532,2,6,7,1,14,7,7,25
D Bucuresti,4532,3,4,4,6,19,20,-1,16
FC Botosani,4532,4,4,4,6,6,14,-8,16
Universitate,4532,5,3,6,5,14,19,-5,15
Concordia Ch,4532,6,3,2,9,17,23,-6,11
FCSB,4533,1,8,6,0,25,11,14,30
CFR Cluj,4533,2,6,6,2,14,8,6,24
D Bucuresti,4533,3,4,4,6,19,22,-3,16
FC Botosani,4533,4,4,4,6,8,15,-7,16
Universitate,4533,5,3,6,5,15,20,-5,15
Concordia Ch,4533,6,3,2,9,21,26,-5,11
FCSB,4534,1,8,5,1,26,12,14,29
CFR Cluj,4534,2,6,6,2,15,9,6,24
D Bucuresti,4534,3,5,4,5,20,18,2,19
Universitate,4534,4,4,5,5,16,21,-5,17
FC Botosani,4534,5,4,4,6,8,15,-7,16
Concordia Ch,4534,6,2,2,10,15,25,-10,8
FCSB,4535,1,7,5,2,23,17,6,26
CFR Cluj,4535,2,6,6,2,14,9,5,24
Universitate,4535,3,5,5,4,22,18,4,20
FC Botosani,4535,4,4,5,5,7,12,-5,17
D Bucuresti,4535,5,3,5,6,16,19,-3,14
Concordia Ch,4535,6,3,2,9,16,23,-7,11
FCSB,4536,1,8,5,1,25,13,12,29
CFR Cluj,4536,2,7,6,1,19,10,9,27
D Bucuresti,4536,3,3,6,5,17,19,-2,15
FC Botosani,4536,4,3,6,5,5,12,-7,15
Universitate,4536,5,3,5,6,16,22,-6,14
Concordia Ch,4536,6,2,4,8,16,22,-6,10
FCSB,4537,1,7,6,1,26,14,12,27
CFR Cluj,4537,2,5,8,1,15,9,6,23
Universitate,4537,3,4,6,4,16,19,-3,18
D Bucuresti,4537,4,4,5,5,19,19,0,17
FC Botosani,4537,5,4,5,5,7,13,-6,17
Concordia Ch,4537,6,2,2,10,17,26,-9,8
FCSB,4538,1,8,5,1,27,13,14,29
CFR Cluj,4538,2,5,6,3,14,11,3,21
Universitate,4538,3,5,5,4,17,19,-2,20
D Bucuresti,4538,4,4,4,6,17,19,-2,16
Concordia Ch,4538,5,4,2,8,17,21,-4,14
FC Botosani,4538,6,3,4,7,5,14,-9,13
FCSB,4539,1,7,6,1,24,12,12,27
CFR Cluj,4539,2,6,7,1,15,8,7,25
Universitate,4539,3,4,5,5,17,21,-4,17
D Bucuresti,4539,4,4,4,6,17,21,-4,16
FC Botosani,4539,5,3,5,6,6,14,-8,14
Concordia Ch,4539,6,3,3,8,19,22,-3,12
FCSB,4540,1,8,6,0,26,11,15,30
CFR Cluj,4540,2,5,6,3,13,11,2,21
Universitate,4540,3,4,6,4,17,19,-2,18
FC Botosani,4540,4,4,4,6,8,15,-7,16
Concordia Ch,4540,5,4,2,8,20,22,-2,14
D Bucuresti,4540,6,3,4,7,16,22,-6,13
FCSB,4541,1,8,5,1,24,11,13,29
CFR Cluj,4541,2,7,6,1,16,8,8,27
FC Botosani,4541,3,4,5,5,8,12,-4,17
D Bucuresti,4541,4,3,6,5,18,20,-2,15
Universitate,4541,5,3,5,6,15,21,-6,14
Concordia Ch,4541,6,2,3,9,17,26,-9,9
FCSB,4542,1,8,6,0,25,10,15,30
CFR Cluj,4542,2,5,7,2,13,9,4,22
D Bucuresti,4542,3,5,4,5,23,18,5,19
Universitate,4542,4,3,7,4,14,18,-4,16
FC Botosani,4542,5,3,5,6,7,17,-10,14
Concordia Ch,4542,6,2,3,9,17,27,-10,9
FCSB,4543,1,7,7,0,24,11,13,28
CFR Cluj,4543,2,5,8,1,14,8,6,23
D Bucuresti,4543,3,4,5,5,18,19,-1,17
Universitate,4543,4,3,7,4,14,18,-4,16
FC Botosani,4543,5,4,4,6,7,13,-6,16
Concordia Ch,4543,6,2,3,9,16,24,-8,9
FCSB,4544,1,7,6,1,25,16,9,27
CFR Cluj,4544,2,6,7,1,17,8,9,25
Universitate,4544,3,4,5,5,19,22,-3,17
D Bucuresti,4544,4,4,4,6,18,21,-3,16
FC Botosani,4544,5,4,4,6,8,15,-7,16
Concordia Ch,4544,6,3,2,9,19,24,-5,11
FCSB,4545,1,8,5,1,28,14,14,29
CFR Cluj,4545,2,6,6,2,16,11,5,24
Universitate,4545,3,4,5,5,18,22,-4,17
D Bucuresti,4545,4,3,6,5,18,20,-2,15
FC Botosani,4545,5,3,5,6,6,15,-9,14
Concordia Ch,4545,6,3,3,8,20,24,-4,12
FCSB,4546,1,8,5,1,25,12,13,29
CFR Cluj,4546,2,6,7,1,16,8,8,25
D Bucuresti,4546,3,5,4,5,20,19,1,19
Universitate,4546,4,3,6,5,15,21,-6,15
FC Botosani,4546,5,3,4,7,5,15,-10,13
Concordia Ch,4546,6,3,2,9,17,23,-6,11
FCSB,4547,1,8,5,1,27,13,14,29
CFR Cluj,4547,2,6,7,1,16,9,7,25
D Bucuresti,4547,3,4,4,6,19,23,-4,16
Universitate,4547,4,3,6,5,14,20,-6,15
Concordia Ch,4547,5,4,2,8,21,22,-1,14
FC Botosani,4547,6,3,4,7,5,15,-10,13
FCSB,4548,1,8,5,1,24,13,11,29
CFR Cluj,4548,2,5,7,2,13,8,5,22
D Bucuresti,4548,3,5,4,5,22,18,4,19
Universitate,4548,4,4,6,4,17,18,-1,18
FC Botosani,4548,5,3,4,7,5,15,-10,13
Concordia Ch,4548,6,3,2,9,16,25,-9,11
FCSB,4549,1,9,5,0,29,11,18,32
CFR Cluj,4549,2,6,6,2,17,10,7,24
D Bucuresti,4549,3,4,5,5,18,19,-1,17
FC Botosani,4549,4,3,5,6,6,14,-8,14
Universitate,4549,5,3,5,6,14,24,-10,14
Concordia Ch,4549,6,2,4,8,17,23,-6,10
FCSB,4550,1,8,6,0,25,10,15,30
CFR Cluj,4550,2,5,7,2,14,10,4,22
D Bucuresti,4550,3,4,4,6,19,22,-3,16
Universitate,4550,4,3,7,4,15,19,-4,16
FC Botosani,4550,5,4,4,6,8,15,-7,16
Concordia Ch,4550,6,3,2,9,18,23,-5,11
FCSB,4551,1,8,5,1,26,13,13,29
CFR Cluj,4551,2,5,6,3,13,10,3,21
Universitate,4551,3,5,5,4,18,19,-1,20
D Bucuresti,4551,4,4,4,6,20,23,-3,16
FC Botosani,4551,5,4,4,6,9,15,-6,16
Concordia Ch,4551,6,3,2,9,19,25,-6,11
FCSB,4552,1,9,5,0,28,11,17,32
CFR Cluj,4552,2,6,6,2,15,9,6,24
FC Botosani,4552,3,3,6,5,8,15,-7,15
D Bucuresti,4552,4,3,5,6,18,21,-3,14
Universitate,4552,5,3,5,6,16,24,-8,14
Concordia Ch,4552,6,3,3,8,19,24,-5,12
FCSB,4553,1,8,6,0,28,13,15,30
CFR Cluj,4553,2,6,7,1,22,10,12,25
D Bucuresti,4553,3,5,4,5,20,19,1,19
FC Botosani,4553,4,3,5,6,6,15,-9,14
Universitate,4553,5,3,5,6,16,28,-12,14
Concordia Ch,4553,6,2,3,9,15,22,-7,9
FCSB,4554,1,7,6,1,24,13,11,27
CFR Cluj,4554,2,5,8,1,15,9,6,23
Universitate,4554,3,4,6,4,17,19,-2,18
D Bucuresti,4554,4,4,4,6,18,21,-3,16
FC Botosani,4554,5,3,5,6,7,16,-9,14
Concordia Ch,4554,6,3,3,8,20,23,-3,12
FCSB,4555,1,8,5,1,27,13,14,29
CFR Cluj,4555,2,6,6,2,16,11,5,24
FC Botosani,4555,3,5,4,5,8,12,-4,19
Universitate,4555,4,4,5,5,18,22,-4,17
D Bucuresti,4555,5,3,4,7,16,21,-5,13
Concordia Ch,4555,6,3,2,9,17,23,-6,11
FCSB,4556,1,7,6,1,25,13,12,27
CFR Cluj,4556,2,6,7,1,16,9,7,25
D Bucuresti,4556,3,5,4,5,19,19,0,19
Universitate,4556,4,4,5,5,17,21,-4,17
FC Botosani,4556,5,3,4,7,6,15,-9,13
Concordia Ch,4556,6,3,2,9,16,22,-6,11
CFR Cluj,4557,1,7,6,1,15,7,8,27
FCSB,4557,2,7,5,2,24,14,10,26
D Bucuresti,4557,3,5,4,5,19,18,1,19
Universitate,4557,4,4,5,5,17,20,-3,17
FC Botosani,4557,5,3,5,6,8,16,-8,14
Concordia Ch,4557,6,2,3,9,18,26,-8,9
FCSB,4558,1,8,5,1,25,12,13,29
CFR Cluj,4558,2,7,6,1,16,8,8,27
FC Botosani,4558,3,5,4,5,8,13,-5,19
D Bucuresti,4558,4,4,4,6,18,20,-2,16
Universitate,4558,5,3,5,6,14,20,-6,14
Concordia Ch,4558,6,2,2,10,15,23,-8,8
CFR Cluj,4559,1,7,6,1,16,7,9,27
FCSB,4559,2,7,5,2,23,14,9,26
Universitate,4559,3,4,5,5,17,20,-3,17
D Bucuresti,4559,4,4,4,6,17,20,-3,16
FC Botosani,4559,5,4,4,6,7,13,-6,16
Concordia Ch,4559,6,3,2,9,16,22,-6,11
FCSB,4560,1,7,7,0,26,13,13,28
CFR Cluj,4560,2,6,7,1,16,9,7,25
D Bucuresti,4560,3,4,4,6,17,20,-3,16
Universitate,4560,4,3,6,5,17,22,-5,15
Concordia Ch,4560,5,4,2,8,18,21,-3,14
FC Botosani,4560,6,3,4,7,5,14,-9,13
FCSB,4561,1,8,6,0,26,11,15,30
CFR Cluj,4561,2,6,6,2,14,9,5,24
D Bucuresti,4561,3,4,5,5,19,20,-1,17
FC Botosani,4561,4,4,4,6,9,13,-4,16
Universitate,4561,5,3,6,5,15,20,-5,15
Concordia Ch,4561,6,2,3,9,17,27,-10,9
FCSB,4562,1,8,5,1,26,12,14,29
CFR Cluj,4562,2,6,6,2,14,9,5,24
D Bucuresti,4562,3,4,5,5,18,18,0,17
Universitate,4562,4,4,5,5,16,20,-4,17
FC Botosani,4562,5,4,4,6,7,14,-7,16
Concordia Ch,4562,6,2,3,9,15,23,-8,9
FCSB,4563,1,8,5,1,25,13,12,29
CFR Cluj,4563,2,6,6,2,15,9,6,24
Universitate,4563,3,4,5,5,17,20,-3,17
FC Botosani,4563,4,4,5,5,8,12,-4,17
D Bucuresti,4563,5,3,6,5,17,19,-2,15
Concordia Ch,4563,6,2,3,9,16,25,-9,9
FCSB,4564,1,8,6,0,26,12,14,30
CFR Cluj,4564,2,6,7,1,17,10,7,25
FC Botosani,4564,3,4,5,5,7,13,-6,17
D Bucuresti,4564,4,3,5,6,17,20,-3,14
Universitate,4564,5,3,5,6,15,21,-6,14
Concordia Ch,4564,6,2,4,8,17,23,-6,10
FCSB,4565,1,8,6,0,26,11,15,30
CFR Cluj,4565,2,5,7,2,15,11,4,22
FC Botosani,4565,3,4,5,5,9,14,-5,17
Universitate,4565,4,3,7,4,17,21,-4,16
D Bucuresti,4565,5,3,4,7,17,22,-5,13
Concordia Ch,4565,6,3,3,8,17,22,-5,12
FCSB,4566,1,7,7,0,24,11,13,28
CFR Cluj,4566,2,6,7,1,14,7,7,25
D Bucuresti,4566,3,4,5,5,18,19,-1,17
Universitate,4566,4,3,6,5,15,20,-5,15
FC Botosani,4566,5,3,6,5,6,13,-7,15
Concordia Ch,4566,6,2,3,9,17,24,-7,9
FCSB,4567,1,8,5,1,25,12,13,29
CFR Cluj,4567,2,5,6,3,13,9,4,21
Universitate,4567,3,5,5,4,17,19,-2,20
D Bucuresti,4567,4,4,4,6,20,22,-2,16
FC Botosani,4567,5,4,4,6,9,16,-7,16
Concordia Ch,4567,6,3,2,9,18,24,-6,11
FCSB,4568,1,7,7,0,27,14,13,28
CFR Cluj,4568,2,5,7,2,15,11,4,22
Universitate,4568,3,4,6,4,18,20,-2,18
D Bucuresti,4568,4,4,4,6,19,20,-1,16
FC Botosani,4568,5,4,4,6,8,15,-7,16
Concordia Ch,4568,6,3,2,9,17,24,-7,11
FCSB,4569,1,7,7,0,23,10,13,28
CFR Cluj,4569,2,6,7,1,15,7,8,25
D Bucuresti,4569,3,5,4,5,22,22,0,19
FC Botosani,4569,4,4,4,6,8,14,-6,16
Universitate,4569,5,3,6,5,14,20,-6,15
Concordia Ch,4569,6,2,2,10,18,27,-9,8
FCSB,4570,1,7,7,0,24,11,13,28
CFR Cluj,4570,2,6,7,1,15,7,8,25
D Bucuresti,4570,3,4,5,5,20,18,2,17
FC Botosani,4570,4,4,5,5,7,12,-5,17
Universitate,4570,5,3,6,5,15,21,-6,15
Concordia Ch,4570,6,2,2,10,15,27,-12,8
FCSB,4571,1,8,5,1,24,11,13,29
CFR Cluj,4571,2,5,6,3,14,10,4,21
Universitate,4571,3,5,5,4,17,19,-2,20
D Bucuresti,4571,4,4,5,5,19,20,-1,17
FC Botosani,4571,5,4,4,6,7,13,-6,16
Concordia Ch,4571,6,2,3,9,17,25,-8,9
FCSB,4572,1,9,5,0,27,11,16,32
CFR Cluj,4572,2,5,6,3,13,10,3,21
Universitate,4572,3,4,5,5,16,20,-4,17
D Bucuresti,4572,4,4,4,6,18,22,-4,16
FC Botosani,4572,5,4,4,6,11,16,-5,16
Concordia Ch,4572,6,3,2,9,20,26,-6,11
FCSB,4573,1,9,5,0,29,10,19,32
CFR Cluj,4573,2,5,7,2,15,11,4,22
Universitate,4573,3,3,6,5,16,24,-8,15
D Bucuresti,4573,4,3,5,6,20,23,-3,14
Concordia Ch,4573,5,4,2,8,21,25,-4,14
FC Botosani,4573,6,3,5,6,9,17,-8,14
FCSB,4574,1,8,6,0,26,11,15,30
CFR Cluj,4574,2,5,8,1,15,9,6,23
FC Botosani,4574,3,4,5,5,9,14,-5,17
Universitate,4574,4,3,6,5,15,21,-6,15
D Bucuresti,4574,5,3,5,6,20,24,-4,14
Concordia Ch,4574,6,3,2,9,19,25,-6,11
FCSB,4575,1,8,5,1,26,13,13,29
CFR Cluj,4575,2,7,6,1,16,7,9,27
D Bucuresti,4575,3,4,5,5,19,19,0,17
Universitate,4575,4,3,5,6,15,22,-7,14
FC Botosani,4575,5,3,5,6,7,16,-9,14
Concordia Ch,4575,6,2,4,8,16,22,-6,10
FCSB,4576,1,8,5,1,25,12,13,29
CFR Cluj,4576,2,6,6,2,15,8,7,24
Universitate,4576,3,4,5,5,16,21,-5,17
FC Botosani,4576,4,4,5,5,6,12,-6,17
D Bucuresti,4576,5,4,4,6,18,20,-2,16
Concordia Ch,4576,6,2,3,9,16,23,-7,9
FCSB,4577,1,9,5,0,29,14,15,32
CFR Cluj,4577,2,5,7,2,17,12,5,22
FC Botosani,4577,3,4,5,5,6,12,-6,17
Universitate,4577,4,3,6,5,18,23,-5,15
D Bucuresti,4577,5,3,5,6,16,19,-3,14
Concordia Ch,4577,6,2,4,8,15,21,-6,10
FCSB,4578,1,8,5,1,28,13,15,29
CFR Cluj,4578,2,6,6,2,15,12,3,24
Universitate,4578,3,4,5,5,16,19,-3,17
D Bucuresti,4578,4,4,4,6,18,21,-3,16
FC Botosani,4578,5,4,4,6,9,13,-4,16
Concordia Ch,4578,6,3,2,9,18,26,-8,11
FCSB,4579,1,8,5,1,25,11,14,29
CFR Cluj,4579,2,7,6,1,16,7,9,27
FC Botosani,4579,3,3,6,5,6,13,-7,15
D Bucuresti,4579,4,3,5,6,17,20,-3,14
Universitate,4579,5,3,5,6,14,22,-8,14
Concordia Ch,4579,6,3,3,8,18,23,-5,12
FCSB,4580,1,8,6,0,28,14,14,30
CFR Cluj,4580,2,5,7,2,13,8,5,22
FC Botosani,4580,3,4,5,5,8,14,-6,17
Universitate,4580,4,3,7,4,18,22,-4,16
D Bucuresti,4580,5,3,4,7,19,24,-5,13
Concordia Ch,4580,6,3,3,8,20,24,-4,12
FCSB,4581,1,7,6,1,25,14,11,27
CFR Cluj,4581,2,7,6,1,17,8,9,27
D Bucuresti,4581,3,5,4,5,22,19,3,19
Universitate,4581,4,3,6,5,15,20,-5,15
FC Botosani,4581,5,3,4,7,5,15,-10,13
Concordia Ch,4581,6,3,2,9,17,25,-8,11
FCSB,4582,1,8,6,0,27,12,15,30
CFR Cluj,4582,2,5,7,2,14,10,4,22
D Bucuresti,4582,3,4,4,6,20,21,-1,16
Universitate,4582,4,3,7,4,15,19,-4,16
FC Botosani,4582,5,3,5,6,5,14,-9,14
Concordia Ch,4582,6,3,3,8,18,23,-5,12
FCSB,4583,1,8,5,1,26,13,13,29
CFR Cluj,4583,2,5,7,2,16,11,5,22
Universitate,4583,3,4,6,4,18,21,-3,18
FC Botosani,4583,4,4,4,6,8,14,-6,16
D Bucuresti,4583,5,3,5,6,17,22,-5,14
Concordia Ch,4583,6,3,3,8,18,22,-4,12
FCSB,4584,1,9,5,0,31,12,19,32
CFR Cluj,4584,2,6,6,2,18,13,5,24
D Bucuresti,4584,3,4,4,6,17,20,-3,16
FC Botosani,4584,4,4,4,6,6,13,-7,16
Universitate,4584,5,3,5,6,17,26,-9,14
Concordia Ch,4584,6,3,2,9,17,22,-5,11
FCSB,4585,1,8,6,0,25,11,14,30
CFR Cluj,4585,2,5,6,3,14,10,4,21
D Bucuresti,4585,3,5,4,5,19,19,0,19
Universitate,4585,4,4,6,4,17,20,-3,18
FC Botosani,4585,5,3,4,7,6,15,-9,13
Concordia Ch,4585,6,3,2,9,16,22,-6,11
FCSB,4586,1,8,5,1,27,13,14,29
CFR Cluj,4586,2,6,6,2,17,12,5,24
D Bucuresti,4586,3,5,4,5,21,18,3,19
Universitate,4586,4,4,5,5,16,20,-4,17
FC Botosani,4586,5,3,4,7,5,14,-9,13
Concordia Ch,4586,6,3,2,9,16,25,-9,11
FCSB,4587,1,8,6,0,27,13,14,30
CFR Cluj,4587,2,5,8,1,17,11,6,23
FC Botosani,4587,3,4,5,5,8,14,-6,17
Universitate,4587,4,3,6,5,17,22,-5,15
D Bucuresti,4587,5,3,4,7,18,23,-5,13
Concordia Ch,4587,6,3,3,8,19,23,-4,12
FCSB,4588,1,8,5,1,25,13,12,29
CFR Cluj,4588,2,7,6,1,18,8,10,27
D Bucuresti,4588,3,4,4,6,18,19,-1,16
Concordia Ch,4588,4,4,2,8,17,21,-4,14
Universitate,4588,5,3,5,6,14,21,-7,14
FC Botosani,4588,6,3,4,7,5,15,-10,13
FCSB,4589,1,8,6,0,24,10,14,30
CFR Cluj,4589,2,5,8,1,14,8,6,23
D Bucuresti,4589,3,3,6,5,16,18,-2,15
Universitate,4589,4,3,6,5,15,20,-5,15
FC Botosani,4589,5,3,5,6,7,15,-8,14
Concordia Ch,4589,6,3,3,8,18,23,-5,12
FCSB,4590,1,8,6,0,26,11,15,30
CFR Cluj,4590,2,5,7,2,15,11,4,22
Universitate,4590,3,3,7,4,17,21,-4,16
FC Botosani,4590,4,4,4,6,7,14,-7,16
Concordia Ch,4590,5,4,2,8,19,21,-2,14
D Bucuresti,4590,6,3,4,7,16,22,-6,13
FCSB,4591,1,7,6,1,23,12,11,27
CFR Cluj,4591,2,6,6,2,16,9,7,24
Universitate,4591,3,4,6,4,16,19,-3,18
D Bucuresti,4591,4,4,4,6,21,22,-1,16
FC Botosani,4591,5,3,5,6,6,15,-9,14
Concordia Ch,4591,6,3,3,8,20,25,-5,12
FCSB,4592,1,7,6,1,26,14,12,27
CFR Cluj,4592,2,6,7,1,15,8,7,25
Universitate,4592,3,4,5,5,17,21,-4,17
FC Botosani,4592,4,4,5,5,9,14,-5,17
D Bucuresti,4592,5,3,6,5,18,20,-2,15
Concordia Ch,4592,6,2,3,9,15,23,-8,9
FCSB,4593,1,7,6,1,25,14,11,27
CFR Cluj,4593,2,7,6,1,20,9,11,27
D Bucuresti,4593,3,4,4,6,17,19,-2,16
Universitate,4593,4,3,6,5,14,21,-7,15
FC Botosani,4593,5,3,5,6,6,14,-8,14
Concordia Ch,4593,6,3,3,8,17,22,-5,12
FCSB,4594,1,8,6,0,26,11,15,30
CFR Cluj,4594,2,5,7,2,13,9,4,22
Universitate,4594,3,3,7,4,15,19,-4,16
FC Botosani,4594,4,3,6,5,8,15,-7,15
D Bucuresti,4594,5,3,5,6,17,20,-3,14
Concordia Ch,4594,6,3,3,8,18,23,-5,12
FCSB,4595,1,8,6,0,26,12,14,30
CFR Cluj,4595,2,5,7,2,14,9,5,22
D Bucuresti,4595,3,4,5,5,19,19,0,17
Universitate,4595,4,3,7,4,17,21,-4,16
FC Botosani,4595,5,3,4,7,6,16,-10,13
Concordia Ch,4595,6,3,3,8,18,23,-5,12
CFR Cluj,4596,1,7,6,1,15,7,8,27
FCSB,4596,2,7,5,2,24,13,11,26
D Bucuresti,4596,3,5,4,5,20,19,1,19
Universitate,4596,4,4,5,5,16,20,-4,17
FC Botosani,4596,5,4,4,6,7,15,-8,16
Concordia Ch,4596,6,2,2,10,15,23,-8,8
FCSB,4597,1,7,7,0,25,12,13,28
CFR Cluj,4597,2,6,7,1,17,8,9,25
D Bucuresti,4597,3,4,5,5,20,20,0,17
Universitate,4597,4,3,6,5,15,22,-7,15
FC Botosani,4597,5,3,6,5,6,13,-7,15
Concordia Ch,4597,6,2,3,9,16,24,-8,9
FCSB,4598,1,8,6,0,25,11,14,30
CFR Cluj,4598,2,5,7,2,13,8,5,22
D Bucuresti,4598,3,5,4,5,19,19,0,19
Universitate,4598,4,3,7,4,15,19,-4,16
FC Botosani,4598,5,4,4,6,7,14,-7,16
Concordia Ch,4598,6,2,2,10,15,23,-8,8
FCSB,4599,1,8,6,0,26,12,14,30
CFR Cluj,4599,2,6,7,1,15,8,7,25
FC Botosani,4599,3,4,5,5,7,13,-6,17
D Bucuresti,4599,4,3,6,5,19,21,-2,15
Universitate,4599,5,3,5,6,15,21,-6,14
Concordia Ch,4599,6,2,3,9,17,24,-7,9
FCSB,4600,1,7,6,1,25,13,12,27
CFR Cluj,4600,2,6,7,1,17,8,9,25
D Bucuresti,4600,3,5,4,5,20,19,1,19
Universitate,4600,4,4,5,5,16,22,-6,17
FC Botosani,4600,5,3,4,7,5,15,-10,13
Concordia Ch,4600,6,3,2,9,17,23,-6,11
FCSB,4601,1,9,5,0,29,11,18,32
CFR Cluj,4601,2,6,6,2,15,11,4,24
D Bucuresti,4601,3,4,4,6,18,19,-1,16
Concordia Ch,4601,4,4,2,8,18,21,-3,14
Universitate,4601,5,3,5,6,15,22,-7,14
FC Botosani,4601,6,3,4,7,5,16,-11,13
CFR Cluj,4602,1,7,6,1,16,8,8,27
FCSB,4602,2,7,5,2,25,14,11,26
Universitate,4602,3,4,5,5,16,20,-4,17
FC Botosani,4602,4,4,4,6,8,15,-7,16
Concordia Ch,4602,5,4,2,8,19,23,-4,14
D Bucuresti,4602,6,3,4,7,18,22,-4,13
FCSB,4603,1,8,5,1,24,14,10,29
CFR Cluj,4603,2,6,6,2,14,8,6,24
Universitate,4603,3,4,5,5,18,19,-1,17
FC Botosani,4603,4,4,4,6,9,15,-6,16
Concordia Ch,4603,5,4,2,8,18,22,-4,14
D Bucuresti,4603,6,3,4,7,19,24,-5,13
FCSB,4604,1,8,5,1,28,14,14,29
CFR Cluj,4604,2,6,7,1,17,9,8,25
D Bucuresti,4604,3,4,5,5,19,19,0,17
Universitate,4604,4,3,6,5,16,23,-7,15
FC Botosani,4604,5,3,6,5,7,14,-7,15
Concordia Ch,4604,6,2,3,9,16,24,-8,9
FCSB,4605,1,7,6,1,25,13,12,27
CFR Cluj,4605,2,5,7,2,15,11,4,22
Universitate,4605,3,5,5,4,17,18,-1,20
D Bucuresti,4605,4,4,5,5,23,23,0,17
FC Botosani,4605,5,4,4,6,9,16,-7,16
Concordia Ch,4605,6,2,3,9,18,26,-8,9
FCSB,4606,1,7,6,1,24,12,12,27
CFR Cluj,4606,2,6,7,1,15,8,7,25
D Bucuresti,4606,3,4,5,5,20,21,-1,17
Universitate,4606,4,3,7,4,16,20,-4,16
FC Botosani,4606,5,4,4,6,11,15,-4,16
Concordia Ch,4606,6,2,3,9,16,26,-10,9
FCSB,4607,1,8,5,1,25,13,12,29
CFR Cluj,4607,2,6,7,1,16,7,9,25
FC Botosani,4607,3,4,5,5,8,14,-6,17
Universitate,4607,4,3,6,5,14,20,-6,15
D Bucuresti,4607,5,3,4,7,18,23,-5,13
Concordia Ch,4607,6,3,3,8,17,21,-4,12
FCSB,4608,1,8,5,1,28,14,14,29
CFR Cluj,4608,2,6,6,2,20,11,9,24
Universitate,4608,3,4,5,5,16,24,-8,17
D Bucuresti,4608,4,4,4,6,17,19,-2,16
FC Botosani,4608,5,4,4,6,7,13,-6,16
Concordia Ch,4608,6,3,2,9,16,23,-7,11
FCSB,4609,1,8,5,1,24,12,12,29
CFR Cluj,4609,2,5,7,2,14,9,5,22
Universitate,4609,3,4,6,4,17,19,-2,18
D Bucuresti,4609,4,4,5,5,19,20,-1,17
FC Botosani,4609,5,3,4,7,7,16,-9,13
Concordia Ch,4609,6,3,3,8,18,23,-5,12
FCSB,4610,1,8,6,0,27,12,15,30
CFR Cluj,4610,2,6,6,2,17,10,7,24
D Bucuresti,4610,3,4,5,5,19,20,-1,17
Universitate,4610,4,3,6,5,17,24,-7,15
FC Botosani,4610,5,3,5,6,8,16,-8,14
Concordia Ch,4610,6,3,2,9,19,25,-6,11
FCSB,4611,1,7,6,1,25,13,12,27
CFR Cluj,4611,2,5,8,1,14,8,6,23
FC Botosani,4611,3,5,4,5,8,13,-5,19
Universitate,4611,4,4,6,4,16,19,-3,18
D Bucuresti,4611,5,3,5,6,17,20,-3,14
Concordia Ch,4611,6,2,3,9,17,24,-7,9
FCSB,4612,1,8,6,0,26,11,15,30
CFR Cluj,4612,2,5,6,3,15,12,3,21
Universitate,4612,3,4,6,4,16,19,-3,18
D Bucuresti,4612,4,4,4,6,17,20,-3,16
FC Botosani,4612,5,4,4,6,6,13,-7,16
Concordia Ch,4612,6,3,2,9,17,22,-5,11
FCSB,4613,1,8,5,1,24,13,11,29
CFR Cluj,4613,2,6,6,2,14,8,6,24
Universitate,4613,3,4,5,5,17,19,-2,17
D Bucuresti,4613,4,4,4,6,17,19,-2,16
FC Botosani,4613,5,4,4,6,7,14,-7,16
Concordia Ch,4613,6,3,2,9,17,23,-6,11
FCSB,4614,1,8,5,1,25,12,13,29
CFR Cluj,4614,2,6,6,2,15,9,6,24
D Bucuresti,4614,3,4,5,5,20,19,1,17
Universitate,4614,4,4,5,5,17,21,-4,17
FC Botosani,4614,5,3,4,7,6,18,-12,13
Concordia Ch,4614,6,3,3,8,19,23,-4,12
FCSB,4615,1,8,5,1,27,13,14,29
CFR Cluj,4615,2,5,7,2,15,11,4,22
D Bucuresti,4615,3,5,4,5,19,18,1,19
Universitate,4615,4,4,6,4,17,20,-3,18
FC Botosani,4615,5,4,4,6,6,14,-8,16
Concordia Ch,4615,6,2,2,10,15,23,-8,8
FCSB,4616,1,9,5,0,28,12,16,32
CFR Cluj,4616,2,5,6,3,14,11,3,21
D Bucuresti,4616,3,4,5,5,24,21,3,17
Universitate,4616,4,4,5,5,19,23,-4,17
FC Botosani,4616,5,3,4,7,6,19,-13,13
Concordia Ch,4616,6,3,3,8,18,23,-5,12
FCSB,4617,1,8,6,0,27,11,16,30
CFR Cluj,4617,2,5,7,2,14,11,3,22
FC Botosani,4617,3,5,4,5,8,12,-4,19
Universitate,4617,4,3,7,4,16,20,-4,16
D Bucuresti,4617,5,3,4,7,16,20,-4,13
Concordia Ch,4617,6,3,2,9,16,23,-7,11
FCSB,4618,1,8,5,1,27,14,13,29
CFR Cluj,4618,2,6,6,2,16,11,5,24
Universitate,4618,3,4,5,5,17,20,-3,17
FC Botosani,4618,4,4,5,5,8,14,-6,17
D Bucuresti,4618,5,3,5,6,17,23,-6,14
Concordia Ch,4618,6,3,2,9,20,23,-3,11
FCSB,4619,1,8,6,0,26,11,15,30
CFR Cluj,4619,2,5,7,2,14,10,4,22
D Bucuresti,4619,3,4,4,6,18,20,-2,16
Universitate,4619,4,3,7,4,16,20,-4,16
FC Botosani,4619,5,4,4,6,8,15,-7,16
Concordia Ch,4619,6,3,2,9,18,24,-6,11
FCSB,4620,1,9,5,0,30,12,18,32
CFR Cluj,4620,2,5,7,2,14,11,3,22
D Bucuresti,4620,3,4,5,5,19,19,0,17
FC Botosani,4620,4,4,4,6,8,15,-7,16
Universitate,4620,5,3,6,5,15,21,-6,15
Concordia Ch,4620,6,2,3,9,15,23,-8,9
FCSB,4621,1,8,6,0,30,12,18,30
CFR Cluj,4621,2,5,7,2,14,13,1,22
D Bucuresti,4621,3,5,4,5,19,18,1,19
Universitate,4621,4,3,7,4,17,21,-4,16
FC Botosani,4621,5,3,5,6,6,14,-8,14
Concordia Ch,4621,6,2,3,9,16,24,-8,9
FCSB,4622,1,8,5,1,25,12,13,29
CFR Cluj,4622,2,5,7,2,15,10,5,22
Universitate,4622,3,4,6,4,18,21,-3,18
D Bucuresti,4622,4,4,4,6,19,22,-3,16
Concordia Ch,4622,5,4,2,8,21,24,-3,14
FC Botosani,4622,6,3,4,7,6,15,-9,13
FCSB,4623,1,9,5,0,32,13,19,32
CFR Cluj,4623,2,6,6,2,16,13,3,24
D Bucuresti,4623,3,4,4,6,20,21,-1,16
FC Botosani,4623,4,4,4,6,6,14,-8,16
Universitate,4623,5,3,5,6,18,25,-7,14
Concordia Ch,4623,6,3,2,9,18,24,-6,11
FCSB,4624,1,8,6,0,26,10,16,30
CFR Cluj,4624,2,6,6,2,15,10,5,24
D Bucuresti,4624,3,4,4,6,18,21,-3,16
FC Botosani,4624,4,4,4,6,8,14,-6,16
Universitate,4624,5,3,6,5,14,20,-6,15
Concordia Ch,4624,6,3,2,9,16,22,-6,11
FCSB,4625,1,8,5,1,25,12,13,29
CFR Cluj,4625,2,7,6,1,16,7,9,27
D Bucuresti,4625,3,5,4,5,21,19,2,19
FC Botosani,4625,4,4,4,6,8,16,-8,16
Universitate,4625,5,3,5,6,14,21,-7,14
Concordia Ch,4625,6,2,2,10,18,27,-9,8
FCSB,4626,1,9,5,0,27,10,17,32
CFR Cluj,4626,2,5,6,3,13,10,3,21
Universitate,4626,3,4,5,5,16,21,-5,17
FC Botosani,4626,4,4,4,6,7,13,-6,16
D Bucuresti,4626,5,3,5,6,16,20,-4,14
Concordia Ch,4626,6,3,3,8,16,21,-5,12
FCSB,4627,1,7,5,2,24,14,10,26
CFR Cluj,4627,2,6,7,1,16,9,7,25
Universitate,4627,3,4,6,4,17,19,-2,18
D Bucuresti,4627,4,4,4,6,18,20,-2,16
Concordia Ch,4627,5,4,2,8,18,22,-4,14
FC Botosani,4627,6,3,4,7,5,14,-9,13
FCSB,4628,1,9,5,0,28,13,15,32
CFR Cluj,4628,2,6,6,2,16,9,7,24
D Bucuresti,4628,3,4,4,6,20,22,-2,16
Universitate,4628,4,3,5,6,16,23,-7,14
FC Botosani,4628,5,3,5,6,8,18,-10,14
Concordia Ch,4628,6,3,3,8,20,23,-3,12
FCSB,4629,1,8,6,0,26,12,14,30
CFR Cluj,4629,2,6,6,2,15,9,6,24
Universitate,4629,3,3,6,5,15,20,-5,15
FC Botosani,4629,4,3,6,5,5,12,-7,15
D Bucuresti,4629,5,3,5,6,17,20,-3,14
Concordia Ch,4629,6,3,3,8,17,22,-5,12
FCSB,4630,1,8,6,0,24,10,14,30
CFR Cluj,4630,2,5,8,1,13,7,6,23
D Bucuresti,4630,3,4,5,5,20,20,0,17
FC Botosani,4630,4,4,4,6,7,15,-8,16
Universitate,4630,5,3,6,5,14,19,-5,15
Concordia Ch,4630,6,2,3,9,16,23,-7,9
FCSB,4631,1,8,6,0,26,11,15,30
CFR Cluj,4631,2,5,7,2,14,10,4,22
D Bucuresti,4631,3,5,4,5,19,19,0,19
Universitate,4631,4,3,7,4,16,20,-4,16
FC Botosani,4631,5,3,4,7,7,19,-12,13
Concordia Ch,4631,6,3,2,9,20,23,-3,11
FCSB,4632,1,8,5,1,25,12,13,29
CFR Cluj,4632,2,5,6,3,13,11,2,21
Universitate,4632,3,5,5,4,19,19,0,20
D Bucuresti,4632,4,4,5,5,20,20,0,17
FC Botosani,4632,5,4,4,6,8,15,-7,16
Concordia Ch,4632,6,2,3,9,16,24,-8,9
FCSB,4633,1,8,5,1,25,12,13,29
CFR Cluj,4633,2,6,6,2,15,8,7,24
Universitate,4633,3,4,5,5,16,21,-5,17
FC Botosani,4633,4,4,5,5,7,13,-6,17
D Bucuresti,4633,5,3,5,6,18,21,-3,14
Concordia Ch,4633,6,2,4,8,18,24,-6,10
FCSB,4634,1,8,5,1,26,11,15,29
CFR Cluj,4634,2,6,6,2,15,11,4,24
D Bucuresti,4634,3,4,5,5,18,18,0,17
Universitate,4634,4,4,5,5,16,20,-4,17
FC Botosani,4634,5,4,5,5,8,13,-5,17
Concordia Ch,4634,6,2,2,10,16,26,-10,8
FCSB,4635,1,9,5,0,29,12,17,32
CFR Cluj,4635,2,5,6,3,13,11,2,21
D Bucuresti,4635,3,4,5,5,19,20,-1,17
Universitate,4635,4,4,5,5,17,21,-4,17
FC Botosani,4635,5,4,4,6,7,14,-7,16
Concordia Ch,4635,6,2,3,9,16,23,-7,9
CFR Cluj,4636,1,7,6,1,19,9,10,27
FCSB,4636,2,7,5,2,26,15,11,26
D Bucuresti,4636,3,4,5,5,18,18,0,17
Universitate,4636,4,4,5,5,18,24,-6,17
FC Botosani,4636,5,3,5,6,5,13,-8,14
Concordia Ch,4636,6,3,2,9,16,23,-7,11
FCSB,4637,1,9,5,0,31,13,18,32
CFR Cluj,4637,2,5,7,2,15,12,3,22
FC Botosani,4637,3,4,4,6,10,14,-4,16
Universitate,4637,4,3,6,5,15,21,-6,15
Concordia Ch,4637,5,4,2,8,18,22,-4,14
D Bucuresti,4637,6,3,4,7,16,23,-7,13
FCSB,4638,1,7,7,0,25,12,13,28
CFR Cluj,4638,2,6,7,1,15,8,7,25
D Bucuresti,4638,3,4,4,6,18,20,-2,16
FC Botosani,4638,4,4,4,6,6,13,-7,16
Universitate,4638,5,3,6,5,15,20,-5,15
Concordia Ch,4638,6,3,2,9,17,23,-6,11
FCSB,4639,1,8,5,1,28,14,14,29
CFR Cluj,4639,2,7,6,1,19,10,9,27
D Bucuresti,4639,3,4,4,6,19,19,0,16
FC Botosani,4639,4,4,4,6,6,13,-7,16
Universitate,4639,5,3,5,6,16,24,-8,14
Concordia Ch,4639,6,3,2,9,16,24,-8,11
FCSB,4640,1,7,6,1,25,13,12,27
CFR Cluj,4640,2,6,7,1,16,8,8,25
Universitate,4640,3,4,5,5,16,21,-5,17
D Bucuresti,4640,4,3,6,5,19,21,-2,15
FC Botosani,4640,5,3,6,5,6,13,-7,15
Concordia Ch,4640,6,2,4,8,17,23,-6,10
FCSB,4641,1,8,6,0,28,12,16,30
CFR Cluj,4641,2,5,8,1,15,9,6,23
FC Botosani,4641,3,5,4,5,9,14,-5,19
Universitate,4641,4,3,6,5,14,21,-7,15
D Bucuresti,4641,5,3,4,7,18,23,-5,13
Concordia Ch,4641,6,3,2,9,21,26,-5,11
FCSB,4642,1,7,7,0,25,12,13,28
CFR Cluj,4642,2,6,7,1,19,8,11,25
D Bucuresti,4642,3,4,4,6,17,20,-3,16
Universitate,4642,4,3,6,5,15,24,-9,15
Concordia Ch,4642,5,4,2,8,20,22,-2,14
FC Botosani,4642,6,3,4,7,6,16,-10,13
FCSB,4643,1,7,5,2,24,13,11,26
CFR Cluj,4643,2,6,7,1,15,8,7,25
Universitate,4643,3,4,6,4,15,18,-3,18
FC Botosani,4643,4,4,5,5,6,12,-6,17
D Bucuresti,4643,5,4,4,6,18,20,-2,16
Concordia Ch,4643,6,2,3,9,16,23,-7,9
FCSB,4644,1,8,6,0,26,11,15,30
CFR Cluj,4644,2,5,7,2,13,9,4,22
FC Botosani,4644,3,4,5,5,8,14,-6,17
Universitate,4644,4,3,7,4,15,19,-4,16
D Bucuresti,4644,5,3,5,6,17,20,-3,14
Concordia Ch,4644,6,2,4,8,18,24,-6,10
FCSB,4645,1,8,6,0,26,12,14,30
CFR Cluj,4645,2,6,6,2,16,10,6,24
FC Botosani,4645,3,5,4,5,7,12,-5,19
Universitate,4645,4,3,6,5,16,21,-5,15
D Bucuresti,4645,5,3,4,7,17,23,-6,13
Concordia Ch,4645,6,3,2,9,19,23,-4,11
FCSB,4646,1,7,6,1,24,12,12,27
CFR Cluj,4646,2,6,6,2,15,9,6,24
D Bucuresti,4646,3,5,4,5,22,20,2,19
Universitate,4646,4,4,6,4,17,20,-3,18
FC Botosani,4646,5,3,5,6,5,14,-9,14
Concordia Ch,4646,6,2,3,9,17,25,-8,9
FCSB,4647,1,7,7,0,25,12,13,28
CFR Cluj,4647,2,6,7,1,14,7,7,25
FC Botosani,4647,3,5,4,5,9,12,-3,19
Universitate,4647,4,3,6,5,16,21,-5,15
D Bucuresti,4647,5,3,4,7,16,20,-4,13
Concordia Ch,4647,6,3,2,9,16,24,-8,11
FCSB,4648,1,8,6,0,26,11,15,30
CFR Cluj,4648,2,6,7,1,15,8,7,25
D Bucuresti,4648,3,4,5,5,19,19,0,17
FC Botosani,4648,4,4,4,6,7,15,-8,16
Universitate,4648,5,3,5,6,14,21,-7,14
Concordia Ch,4648,6,2,3,9,17,24,-7,9
FCSB,4649,1,8,5,1,25,11,14,29
CFR Cluj,4649,2,5,7,2,13,9,4,22
Universitate,4649,3,4,6,4,15,18,-3,18
D Bucuresti,4649,4,4,5,5,19,18,1,17
FC Botosani,4649,5,3,5,6,6,16,-10,14
Concordia Ch,4649,6,2,4,8,16,22,-6,10
FCSB,4650,1,8,6,0,24,10,14,30
CFR Cluj,4650,2,6,6,2,15,8,7,24
D Bucuresti,4650,3,4,4,6,18,20,-2,16
Universitate,4650,4,3,6,5,14,20,-6,15
FC Botosani,4650,5,3,5,6,5,13,-8,14
Concordia Ch,4650,6,3,3,8,17,22,-5,12
FCSB,4651,1,9,5,0,27,10,17,32
CFR Cluj,4651,2,5,7,2,13,9,4,22
D Bucuresti,4651,3,4,5,5,17,18,-1,17
FC Botosani,4651,4,4,5,5,8,12,-4,17
Universitate,4651,5,3,6,5,14,20,-6,15
Concordia Ch,4651,6,2,2,10,15,25,-10,8
FCSB,4652,1,8,5,1,27,12,15,29
CFR Cluj,4652,2,5,7,2,14,11,3,22
Universitate,4652,3,4,6,4,15,18,-3,18
FC Botosani,4652,4,3,6,5,6,13,-7,15
D Bucuresti,4652,5,3,5,6,16,20,-4,14
Concordia Ch,4652,6,3,3,8,18,22,-4,12
CFR Cluj,4653,1,7,6,1,18,7,11,27
FCSB,4653,2,7,5,2,23,16,7,26
Universitate,4653,3,4,5,5,18,21,-3,17
D Bucuresti,4653,4,4,4,6,19,20,-1,16
Concordia Ch,4653,5,4,2,8,18,21,-3,14
FC Botosani,4653,6,3,4,7,5,16,-11,13
FCSB,4654,1,7,5,2,25,14,11,26
CFR Cluj,4654,2,6,6,2,15,9,6,24
Universitate,4654,3,5,5,4,17,19,-2,20
D Bucuresti,4654,4,4,5,5,19,20,-1,17
FC Botosani,4654,5,4,5,5,7,13,-6,17
Concordia Ch,4654,6,2,2,10,16,24,-8,8
FCSB,4655,1,8,6,0,26,12,14,30
CFR Cluj,4655,2,6,7,1,16,9,7,25
FC Botosani,4655,3,3,6,5,5,12,-7,15
D Bucuresti,4655,4,3,5,6,17,20,-3,14
Universitate,4655,5,3,5,6,16,22,-6,14
Concordia Ch,4655,6,3,3,8,17,22,-5,12
FCSB,4656,1,7,5,2,24,14,10,26
CFR Cluj,4656,2,6,6,2,14,8,6,24
Universitate,4656,3,5,5,4,18,19,-1,20
D Bucuresti,4656,4,4,5,5,21,22,-1,17
FC Botosani,4656,5,4,4,6,8,15,-7,16
Concordia Ch,4656,6,2,3,9,19,26,-7,9
FCSB,4657,1,8,6,0,24,10,14,30
CFR Cluj,4657,2,6,7,1,16,9,7,25
FC Botosani,4657,3,3,6,5,7,14,-7,15
D Bucuresti,4657,4,3,5,6,17,20,-3,14
Universitate,4657,5,3,5,6,16,22,-6,14
Concordia Ch,4657,6,3,3,8,17,22,-5,12
FCSB,4658,1,8,5,1,24,11,13,29
CFR Cluj,4658,2,5,7,2,14,9,5,22
Universitate,4658,3,4,6,4,16,19,-3,18
D Bucuresti,4658,4,4,4,6,20,20,0,16
FC Botosani,4658,5,4,4,6,7,17,-10,16
Concordia Ch,4658,6,3,2,9,18,23,-5,11
FCSB,4659,1,7,5,2,23,14,9,26
CFR Cluj,4659,2,6,7,1,15,7,8,25
D Bucuresti,4659,3,5,4,5,20,18,2,19
Universitate,4659,4,4,6,4,16,18,-2,18
FC Botosani,4659,5,3,4,7,6,16,-10,13
Concordia Ch,4659,6,3,2,9,17,24,-7,11
FCSB,4660,1,7,6,1,25,13,12,27
CFR Cluj,4660,2,6,6,2,17,11,6,24
Universitate,4660,3,4,6,4,18,21,-3,18
D Bucuresti,4660,4,4,5,5,20,21,-1,17
FC Botosani,4660,5,4,4,6,7,14,-7,16
Concordia Ch,4660,6,2,3,9,19,26,-7,9
FCSB,4661,1,8,5,1,27,14,13,29
CFR Cluj,4661,2,5,7,2,15,10,5,22
Universitate,4661,3,4,6,4,16,19,-3,18
D Bucuresti,4661,4,4,5,5,22,22,0,17
FC Botosani,4661,5,3,5,6,7,16,-9,14
Concordia Ch,4661,6,2,4,8,19,25,-6,10
FCSB,4662,1,7,6,1,24,12,12,27
CFR Cluj,4662,2,6,7,1,15,8,7,25
D Bucuresti,4662,3,4,5,5,19,20,-1,17
Universitate,4662,4,4,5,5,15,19,-4,17
FC Botosani,4662,5,3,5,6,7,15,-8,14
Concordia Ch,4662,6,2,4,8,19,25,-6,10
FCSB,4663,1,7,7,0,27,14,13,28
CFR Cluj,4663,2,6,7,1,17,9,8,25
D Bucuresti,4663,3,4,4,6,18,20,-2,16
Universitate,4663,4,3,6,5,18,24,-6,15
Concordia Ch,4663,5,4,2,8,17,21,-4,14
FC Botosani,4663,6,3,4,7,6,15,-9,13
FCSB,4664,1,8,5,1,24,11,13,29
CFR Cluj,4664,2,6,6,2,15,9,6,24
D Bucuresti,4664,3,4,5,5,21,20,1,17
Universitate,4664,4,4,5,5,16,20,-4,17
FC Botosani,4664,5,4,4,6,7,16,-9,16
Concordia Ch,4664,6,2,3,9,16,23,-7,9
FCSB,4665,1,8,5,1,27,14,13,29
CFR Cluj,4665,2,5,7,2,15,11,4,22
FC Botosani,4665,3,5,4,5,8,12,-4,19
Universitate,4665,4,4,6,4,18,20,-2,18
D Bucuresti,4665,5,3,4,7,17,22,-5,13
Concordia Ch,4665,6,3,2,9,17,23,-6,11
FCSB,4666,1,8,6,0,25,10,15,30
CFR Cluj,4666,2,6,7,1,16,7,9,25
D Bucuresti,4666,3,4,4,6,21,21,0,16
FC Botosani,4666,4,4,4,6,8,15,-7,16
Universitate,4666,5,3,5,6,14,23,-9,14
Concordia Ch,4666,6,3,2,9,20,28,-8,11
FCSB,4667,1,9,5,0,27,10,17,32
CFR Cluj,4667,2,6,6,2,14,9,5,24
D Bucuresti,4667,3,4,4,6,19,21,-2,16
FC Botosani,4667,4,4,4,6,9,17,-8,16
Universitate,4667,5,3,5,6,14,21,-7,14
Concordia Ch,4667,6,3,2,9,19,24,-5,11
FCSB,4668,1,8,6,0,27,12,15,30
CFR Cluj,4668,2,5,8,1,15,9,6,23
D Bucuresti,4668,3,4,5,5,18,18,0,17
FC Botosani,4668,4,4,5,5,6,12,-6,17
Universitate,4668,5,3,6,5,16,22,-6,15
Concordia Ch,4668,6,2,2,10,15,24,-9,8
FCSB,4669,1,9,5,0,30,11,19,32
CFR Cluj,4669,2,5,7,2,14,12,2,22
Universitate,4669,3,3,6,5,16,22,-6,15
Concordia Ch,4669,4,4,2,8,22,21,1,14
D Bucuresti,4669,5,3,5,6,17,23,-6,14
FC Botosani,4669,6,3,5,6,6,16,-10,14
CFR Cluj,4670,1,7,6,1,17,9,8,27
FCSB,4670,2,7,5,2,23,12,11,26
Universitate,4670,3,4,5,5,17,21,-4,17
FC Botosani,4670,4,4,5,5,6,12,-6,17
D Bucuresti,4670,5,3,5,6,16,19,-3,14
Concordia Ch,4670,6,2,4,8,15,21,-6,10
FCSB,4671,1,8,5,1,25,12,13,29
CFR Cluj,4671,2,6,6,2,15,9,6,24
Universitate,4671,3,4,5,5,15,19,-4,17
D Bucuresti,4671,4,4,4,6,18,21,-3,16
FC Botosani,4671,5,4,4,6,8,14,-6,16
Concordia Ch,4671,6,3,2,9,16,22,-6,11
FCSB,4672,1,7,5,2,24,13,11,26
CFR Cluj,4672,2,6,7,1,15,8,7,25
Universitate,4672,3,4,6,4,15,18,-3,18
FC Botosani,4672,4,3,6,5,6,13,-7,15
D Bucuresti,4672,5,3,5,6,17,22,-5,14
Concordia Ch,4672,6,3,3,8,18,21,-3,12
FCSB,4673,1,8,6,0,25,11,14,30
CFR Cluj,4673,2,5,7,2,14,9,5,22
Universitate,4673,3,3,7,4,16,20,-4,16
FC Botosani,4673,4,3,6,5,5,12,-7,15
D Bucuresti,4673,5,3,5,6,17,20,-3,14
Concordia Ch,4673,6,3,3,8,17,22,-5,12
FCSB,4674,1,9,5,0,29,13,16,32
CFR Cluj,4674,2,5,6,3,16,14,2,21
D Bucuresti,4674,3,4,5,5,23,22,1,17
Universitate,4674,4,4,5,5,19,22,-3,17
FC Botosani,4674,5,4,4,6,8,16,-8,16
Concordia Ch,4674,6,2,3,9,20,28,-8,9
FCSB,4675,1,8,6,0,26,11,15,30
CFR Cluj,4675,2,5,7,2,14,10,4,22
D Bucuresti,4675,3,4,4,6,20,22,-2,16
Universitate,4675,4,3,7,4,16,20,-4,16
FC Botosani,4675,5,3,5,6,6,15,-9,14
Concordia Ch,4675,6,3,3,8,18,22,-4,12
FCSB,4676,1,8,6,0,24,10,14,30
CFR Cluj,4676,2,5,7,2,16,11,5,22
FC Botosani,4676,3,4,5,5,6,12,-6,17
D Bucuresti,4676,4,4,4,6,18,20,-2,16
Universitate,4676,5,3,7,4,17,21,-4,16
Concordia Ch,4676,6,2,3,9,16,23,-7,9
FCSB,4677,1,8,5,1,25,14,11,29
CFR Cluj,4677,2,6,6,2,15,9,6,24
Universitate,4677,3,4,5,5,17,19,-2,17
D Bucuresti,4677,4,4,4,6,19,21,-2,16
FC Botosani,4677,5,4,4,6,9,15,-6,16
Concordia Ch,4677,6,3,2,9,18,25,-7,11
FCSB,4678,1,9,5,0,27,10,17,32
CFR Cluj,4678,2,6,6,2,17,10,7,24
D Bucuresti,4678,3,4,4,6,23,24,-1,16
FC Botosani,4678,4,4,4,6,9,16,-7,16
Universitate,4678,5,3,5,6,14,23,-9,14
Concordia Ch,4678,6,3,2,9,19,26,-7,11
FCSB,4679,1,9,5,0,28,12,16,32
CFR Cluj,4679,2,6,6,2,18,9,9,24
D Bucuresti,4679,3,4,5,5,18,19,-1,17
Universitate,4679,4,3,5,6,15,25,-10,14
FC Botosani,4679,5,3,4,7,6,15,-9,13
Concordia Ch,4679,6,3,3,8,18,23,-5,12
FCSB,4680,1,7,6,1,24,12,12,27
CFR Cluj,4680,2,5,8,1,14,8,6,23
Universitate,4680,3,4,6,4,15,18,-3,18
FC Botosani,4680,4,4,5,5,8,14,-6,17
D Bucuresti,4680,5,3,4,7,17,21,-4,13
Concordia Ch,4680,6,3,3,8,17,22,-5,12
FCSB,4681,1,8,6,0,24,10,14,30
CFR Cluj,4681,2,6,6,2,14,8,6,24
Universitate,4681,3,3,6,5,14,19,-5,15
FC Botosani,4681,4,3,6,5,5,12,-7,15
D Bucuresti,4681,5,3,5,6,16,19,-3,14
Concordia Ch,4681,6,3,3,8,16,21,-5,12
FCSB,4682,1,8,6,0,26,12,14,30
CFR Cluj,4682,2,5,7,2,15,10,5,22
FC Botosani,4682,3,4,5,5,6,12,-6,17
Universitate,4682,4,3,7,4,16,20,-4,16
D Bucuresti,4682,5,3,6,5,17,19,-2,15
Concordia Ch,4682,6,2,3,9,16,23,-7,9
FCSB,4683,1,7,5,2,23,15,8,26
CFR Cluj,4683,2,6,7,1,16,8,8,25
Universitate,4683,3,4,6,4,18,19,-1,18
D Bucuresti,4683,4,4,5,5,19,20,-1,17
FC Botosani,4683,5,4,5,5,7,13,-6,17
Concordia Ch,4683,6,2,2,10,16,24,-8,8
FCSB,4684,1,8,6,0,26,12,14,30
CFR Cluj,4684,2,5,8,1,15,9,6,23
D Bucuresti,4684,3,5,4,5,21,19,2,19
FC Botosani,4684,4,4,4,6,8,17,-9,16
Universitate,4684,5,3,6,5,16,21,-5,15
Concordia Ch,4684,6,2,2,10,18,26,-8,8
FCSB,4685,1,8,6,0,25,11,14,30
CFR Cluj,4685,2,6,7,1,17,9,8,25
FC Botosani,4685,3,4,4,6,7,15,-8,16
D Bucuresti,4685,4,3,5,6,17,20,-3,14
Universitate,4685,5,3,5,6,15,22,-7,14
Concordia Ch,4685,6,3,3,8,17,21,-4,12
FCSB,4686,1,9,5,0,27,10,17,32
CFR Cluj,4686,2,5,7,2,14,10,4,22
D Bucuresti,4686,3,4,4,6,20,22,-2,16
FC Botosani,4686,4,4,4,6,11,16,-5,16
Universitate,4686,5,3,6,5,15,21,-6,15
Concordia Ch,4686,6,3,2,9,19,27,-8,11
FCSB,4687,1,8,5,1,25,15,10,29
CFR Cluj,4687,2,7,6,1,18,7,11,27
D Bucuresti,4687,3,5,4,5,18,18,0,19
FC Botosani,4687,4,4,4,6,7,13,-6,16
Universitate,4687,5,3,5,6,15,21,-6,14
Concordia Ch,4687,6,2,2,10,15,24,-9,8
CFR Cluj,4688,1,7,6,1,15,7,8,27
FCSB,4688,2,7,5,2,24,14,10,26
Universitate,4688,3,4,5,5,17,20,-3,17
FC Botosani,4688,4,4,5,5,8,13,-5,17
D Bucuresti,4688,5,3,5,6,17,20,-3,14
Concordia Ch,4688,6,3,2,9,16,23,-7,11
FCSB,4689,1,8,5,1,28,15,13,29
CFR Cluj,4689,2,5,7,2,14,10,4,22
D Bucuresti,4689,3,5,4,5,20,19,1,19
Universitate,4689,4,4,6,4,20,22,-2,18
FC Botosani,4689,5,4,4,6,6,13,-7,16
Concordia Ch,4689,6,2,2,10,16,25,-9,8
FCSB,4690,1,7,6,1,24,12,12,27
CFR Cluj,4690,2,6,7,1,15,8,7,25
Universitate,4690,3,3,7,4,16,20,-4,16
Concordia Ch,4690,4,4,2,8,23,24,-1,14
D Bucuresti,4690,5,3,5,6,18,24,-6,14
FC Botosani,4690,6,3,5,6,8,16,-8,14
FCSB,4691,1,8,6,0,25,11,14,30
CFR Cluj,4691,2,6,7,1,16,8,8,25
D Bucuresti,4691,3,4,4,6,17,19,-2,16
FC Botosani,4691,4,4,4,6,6,14,-8,16
Universitate,4691,5,3,5,6,16,23,-7,14
Concordia Ch,4691,6,3,2,9,17,22,-5,11
FCSB,4692,1,8,5,1,26,12,14,29
CFR Cluj,4692,2,5,6,3,14,11,3,21
Universitate,4692,3,5,5,4,18,20,-2,20
FC Botosani,4692,4,4,5,5,8,14,-6,17
D Bucuresti,4692,5,3,5,6,17,20,-3,14
Concordia Ch,4692,6,2,4,8,18,24,-6,10
FCSB,4693,1,8,5,1,25,13,12,29
CFR Cluj,4693,2,5,7,2,14,9,5,22
Universitate,4693,3,4,6,4,16,18,-2,18
D Bucuresti,4693,4,4,4,6,18,23,-5,16
FC Botosani,4693,5,4,4,6,7,13,-6,16
Concordia Ch,4693,6,3,2,9,20,24,-4,11
FCSB,4694,1,7,6,1,26,15,11,27
CFR Cluj,4694,2,7,6,1,17,7,10,27
D Bucuresti,4694,3,4,4,6,19,19,0,16
Universitate,4694,4,3,6,5,17,23,-6,15
Concordia Ch,4694,5,4,2,8,17,21,-4,14
FC Botosani,4694,6,3,4,7,5,16,-11,13
FCSB,4695,1,8,6,0,28,12,16,30
CFR Cluj,4695,2,6,6,2,15,11,4,24
D Bucuresti,4695,3,4,5,5,20,21,-1,17
Universitate,4695,4,3,6,5,17,22,-5,15
FC Botosani,4695,5,3,5,6,6,14,-8,14
Concordia Ch,4695,6,3,2,9,18,24,-6,11
FCSB,4696,1,9,5,0,27,11,16,32
CFR Cluj,4696,2,6,6,2,14,8,6,24
FC Botosani,4696,3,4,5,5,7,13,-6,17
D Bucuresti,4696,4,3,5,6,18,21,-3,14
Universitate,4696,5,3,5,6,15,22,-7,14
Concordia Ch,4696,6,3,2,9,17,23,-6,11
FCSB,4697,1,8,6,0,29,14,15,30
CFR Cluj,4697,2,5,7,2,16,12,4,22
D Bucuresti,4697,3,4,4,6,20,21,-1,16
Universitate,4697,4,3,7,4,17,21,-4,16
FC Botosani,4697,5,3,5,6,6,15,-9,14
Concordia Ch,4697,6,3,3,8,19,24,-5,12
FCSB,4698,1,8,6,0,26,10,16,30
CFR Cluj,4698,2,5,6,3,14,12,2,21
Universitate,4698,3,4,6,4,16,19,-3,18
FC Botosani,4698,4,4,5,5,7,12,-5,17
D Bucuresti,4698,5,3,6,5,17,19,-2,15
Concordia Ch,4698,6,2,3,9,16,24,-8,9
FCSB,4699,1,9,5,0,27,10,17,32
CFR Cluj,4699,2,5,7,2,13,10,3,22
D Bucuresti,4699,3,4,4,6,18,21,-3,16
FC Botosani,4699,4,4,4,6,8,15,-7,16
Universitate,4699,5,3,6,5,14,19,-5,15
Concordia Ch,4699,6,3,2,9,17,22,-5,11
FCSB,4700,1,8,5,1,27,13,14,29
CFR Cluj,4700,2,7,6,1,16,8,8,27
FC Botosani,4700,3,4,5,5,7,13,-6,17
D Bucuresti,4700,4,3,5,6,19,24,-5,14
Universitate,4700,5,3,5,6,15,22,-7,14
Concordia Ch,4700,6,3,2,9,20,24,-4,11
FCSB,4701,1,8,6,0,26,12,14,30
CFR Cluj,4701,2,6,6,2,16,10,6,24
FC Botosani,4701,3,4,5,5,12,17,-5,17
Universitate,4701,4,3,6,5,16,21,-5,15
D Bucuresti,4701,5,3,5,6,19,23,-4,14
Concordia Ch,4701,6,3,2,9,21,27,-6,11
FCSB,4702,1,8,6,0,26,12,14,30
CFR Cluj,4702,2,6,6,2,14,8,6,24
D Bucuresti,4702,3,5,4,5,20,19,1,19
Universitate,4702,4,3,6,5,16,21,-5,15
FC Botosani,4702,5,3,4,7,5,16,-11,13
Concordia Ch,4702,6,3,2,9,18,23,-5,11
FCSB,4703,1,8,6,0,25,11,14,30
CFR Cluj,4703,2,6,6,2,15,9,6,24
D Bucuresti,4703,3,4,5,5,19,19,0,17
Universitate,4703,4,3,6,5,16,21,-5,15
FC Botosani,4703,5,3,5,6,7,16,-9,14
Concordia Ch,4703,6,2,4,8,18,24,-6,10
FCSB,4704,1,7,6,1,24,13,11,27
CFR Cluj,4704,2,6,6,2,16,10,6,24
D Bucuresti,4704,3,5,4,5,18,18,0,19
Universitate,4704,4,4,6,4,16,18,-2,18
FC Botosani,4704,5,3,5,6,6,14,-8,14
Concordia Ch,4704,6,2,3,9,16,23,-7,9
FCSB,4705,1,8,5,1,24,13,11,29
CFR Cluj,4705,2,7,6,1,19,9,10,27
D Bucuresti,4705,3,5,4,5,18,18,0,19
FC Botosani,4705,4,4,4,6,7,14,-7,16
Universitate,4705,5,3,5,6,16,22,-6,14
Concordia Ch,4705,6,2,2,10,16,24,-8,8
FCSB,4706,1,8,6,0,25,10,15,30
CFR Cluj,4706,2,5,6,3,13,10,3,21
FC Botosani,4706,3,5,4,5,9,13,-4,19
Universitate,4706,4,4,6,4,15,18,-3,18
D Bucuresti,4706,5,3,4,7,17,21,-4,13
Concordia Ch,4706,6,3,2,9,18,25,-7,11
FCSB,4707,1,8,6,0,28,11,17,30
CFR Cluj,4707,2,6,6,2,17,12,5,24
FC Botosani,4707,3,4,4,6,7,14,-7,16
Universitate,4707,4,3,6,5,16,23,-7,15
Concordia Ch,4707,5,4,2,8,17,21,-4,14
D Bucuresti,4707,6,3,4,7,17,21,-4,13
FCSB,4708,1,7,7,0,24,11,13,28
CFR Cluj,4708,2,5,7,2,14,10,4,22
Universitate,4708,3,4,6,4,16,18,-2,18
FC Botosani,4708,4,4,5,5,6,12,-6,17
D Bucuresti,4708,5,3,6,5,17,19,-2,15
Concordia Ch,4708,6,2,3,9,16,23,-7,9
FCSB,4709,1,8,5,1,24,13,11,29
CFR Cluj,4709,2,5,7,2,13,8,5,22
D Bucuresti,4709,3,5,4,5,21,19,2,19
Universitate,4709,4,4,6,4,17,18,-1,18
FC Botosani,4709,5,4,4,6,7,14,-7,16
Concordia Ch,4709,6,2,2,10,15,25,-10,8
FCSB,4710,1,7,6,1,23,12,11,27
CFR Cluj,4710,2,5,8,1,14,8,6,23
Universitate,4710,3,4,6,4,17,19,-2,18
D Bucuresti,4710,4,4,4,6,18,24,-6,16
Concordia Ch,4710,5,4,2,8,21,21,0,14
FC Botosani,4710,6,3,4,7,6,15,-9,13
FCSB,4711,1,7,6,1,24,13,11,27
CFR Cluj,4711,2,6,7,1,16,9,7,25
Universitate,4711,3,4,5,5,17,20,-3,17
FC Botosani,4711,4,4,5,5,10,13,-3,17
D Bucuresti,4711,5,3,5,6,17,22,-5,14
Concordia Ch,4711,6,3,2,9,18,25,-7,11
FCSB,4712,1,8,5,1,25,12,13,29
CFR Cluj,4712,2,6,6,2,15,9,6,24
Universitate,4712,3,4,5,5,15,19,-4,17
Concordia Ch,4712,4,4,2,8,19,22,-3,14
D Bucuresti,4712,5,3,5,6,18,22,-4,14
FC Botosani,4712,6,3,5,6,6,14,-8,14
FCSB,4713,1,9,5,0,27,12,15,32
CFR Cluj,4713,2,5,6,3,14,10,4,21
D Bucuresti,4713,3,5,4,5,19,19,0,19
Universitate,4713,4,4,5,5,16,20,-4,17
FC Botosani,4713,5,3,5,6,7,15,-8,14
Concordia Ch,4713,6,2,3,9,16,23,-7,9
FCSB,4714,1,7,7,0,24,11,13,28
CFR Cluj,4714,2,6,7,1,16,9,7,25
D Bucuresti,4714,3,4,4,6,20,21,-1,16
FC Botosani,4714,4,4,4,6,9,14,-5,16
Universitate,4714,5,3,6,5,15,20,-5,15
Concordia Ch,4714,6,3,2,9,18,27,-9,11
FCSB,4715,1,8,5,1,27,12,15,29
CFR Cluj,4715,2,6,6,2,16,11,5,24
Universitate,4715,3,4,5,5,15,20,-5,17
FC Botosani,4715,4,4,5,5,8,14,-6,17
D Bucuresti,4715,5,3,5,6,20,23,-3,14
Concordia Ch,4715,6,3,2,9,18,24,-6,11
FCSB,4716,1,8,5,1,27,14,13,29
CFR Cluj,4716,2,6,6,2,18,12,6,24
Universitate,4716,3,4,5,5,19,23,-4,17
FC Botosani,4716,4,4,5,5,10,14,-4,17
D Bucuresti,4716,5,3,5,6,17,22,-5,14
Concordia Ch,4716,6,3,2,9,19,25,-6,11
FCSB,4717,1,7,7,0,25,12,13,28
CFR Cluj,4717,2,5,8,1,13,7,6,23
D Bucuresti,4717,3,5,4,5,20,20,0,19
Universitate,4717,4,3,7,4,16,20,-4,16
FC Botosani,4717,5,3,5,6,7,15,-8,14
Concordia Ch,4717,6,2,3,9,17,24,-7,9
FCSB,4718,1,8,5,1,25,12,13,29
CFR Cluj,4718,2,5,7,2,13,8,5,22
Universitate,4718,3,4,6,4,16,19,-3,18
D Bucuresti,4718,4,4,5,5,19,19,0,17
FC Botosani,4718,5,3,5,6,6,16,-10,14
Concordia Ch,4718,6,3,2,9,18,23,-5,11
FCSB,4719,1,7,5,2,23,13,10,26
CFR Cluj,4719,2,6,7,1,14,7,7,25
Universitate,4719,3,4,6,4,16,18,-2,18
FC Botosani,4719,4,4,5,5,7,13,-6,17
D Bucuresti,4719,5,3,6,5,19,21,-2,15
Concordia Ch,4719,6,2,3,9,17,24,-7,9
FCSB,4720,1,8,6,0,33,12,21,30
CFR Cluj,4720,2,5,6,3,15,18,-3,21
Universitate,4720,3,4,6,4,17,20,-3,18
FC Botosani,4720,4,4,5,5,8,13,-5,17
D Bucuresti,4720,5,3,5,6,18,22,-4,14
Concordia Ch,4720,6,3,2,9,18,24,-6,11
FCSB,4721,1,9,5,0,28,12,16,32
CFR Cluj,4721,2,6,6,2,15,10,5,24
FC Botosani,4721,3,4,5,5,10,15,-5,17
D Bucuresti,4721,4,3,5,6,18,23,-5,14
Universitate,4721,5,3,5,6,15,21,-6,14
Concordia Ch,4721,6,3,2,9,19,24,-5,11
FCSB,4722,1,7,6,1,23,11,12,27
CFR Cluj,4722,2,6,7,1,14,7,7,25
Universitate,4722,3,3,7,4,14,18,-4,16
D Bucuresti,4722,4,3,6,5,17,19,-2,15
FC Botosani,4722,5,3,6,5,6,13,-7,15
Concordia Ch,4722,6,2,4,8,17,23,-6,10
FCSB,4723,1,7,6,1,25,13,12,27
CFR Cluj,4723,2,6,7,1,17,10,7,25
Universitate,4723,3,3,7,4,15,19,-4,16
FC Botosani,4723,4,4,4,6,7,15,-8,16
D Bucuresti,4723,5,3,5,6,18,22,-4,14
Concordia Ch,4723,6,3,3,8,20,23,-3,12
FCSB,4724,1,8,6,0,25,11,14,30
CFR Cluj,4724,2,5,6,3,14,10,4,21
FC Botosani,4724,3,5,4,5,12,15,-3,19
Universitate,4724,4,4,6,4,17,20,-3,18
D Bucuresti,4724,5,3,4,7,21,26,-5,13
Concordia Ch,4724,6,3,2,9,20,27,-7,11
FCSB,4725,1,8,5,1,25,14,11,29
CFR Cluj,4725,2,6,7,1,17,8,9,25
D Bucuresti,4725,3,4,4,6,20,20,0,16
FC Botosani,4725,4,4,4,6,7,13,-6,16
Universitate,4725,5,3,6,5,16,21,-5,15
Concordia Ch,4725,6,3,2,9,16,25,-9,11
FCSB,4726,1,9,5,0,27,11,16,32
CFR Cluj,4726,2,5,6,3,14,11,3,21
Universitate,4726,3,4,5,5,15,19,-4,17
FC Botosani,4726,4,4,5,5,7,13,-6,17
D Bucuresti,4726,5,3,4,7,17,22,-5,13
Concordia Ch,4726,6,3,3,8,17,21,-4,12
FCSB,4727,1,8,5,1,27,13,14,29
CFR Cluj,4727,2,5,7,2,15,11,4,22
Universitate,4727,3,4,6,4,17,20,-3,18
FC Botosani,4727,4,4,5,5,6,12,-6,17
D Bucuresti,4727,5,3,4,7,16,22,-6,13
Concordia Ch,4727,6,3,3,8,18,21,-3,12
FCSB,4728,1,8,6,0,26,12,14,30
CFR Cluj,4728,2,5,7,2,14,9,5,22
Universitate,4728,3,4,5,5,16,20,-4,17
FC Botosani,4728,4,4,5,5,8,13,-5,17
D Bucuresti,4728,5,3,5,6,18,22,-4,14
Concordia Ch,4728,6,3,2,9,18,24,-6,11
FCSB,4729,1,8,5,1,26,14,12,29
CFR Cluj,4729,2,6,6,2,16,10,6,24
FC Botosani,4729,3,5,4,5,9,13,-4,19
Universitate,4729,4,4,5,5,16,19,-3,17
D Bucuresti,4729,5,3,5,6,17,20,-3,14
Concordia Ch,4729,6,2,3,9,15,23,-8,9
FCSB,4730,1,9,5,0,28,11,17,32
CFR Cluj,4730,2,5,7,2,15,11,4,22
D Bucuresti,4730,3,5,4,5,20,19,1,19
FC Botosani,4730,4,4,4,6,9,14,-5,16
Universitate,4730,5,3,6,5,17,23,-6,15
Concordia Ch,4730,6,2,2,10,15,26,-11,8
FCSB,4731,1,7,7,0,25,12,13,28
CFR Cluj,4731,2,5,8,1,14,8,6,23
Universitate,4731,3,3,7,4,15,19,-4,16
FC Botosani,4731,4,4,4,6,7,15,-8,16
Concordia Ch,4731,5,4,2,8,19,21,-2,14
D Bucuresti,4731,6,3,4,7,17,22,-5,13
FCSB,4732,1,7,6,1,23,12,11,27
CFR Cluj,4732,2,6,7,1,15,8,7,25
Universitate,4732,3,4,5,5,17,20,-3,17
FC Botosani,4732,4,4,5,5,9,14,-5,17
D Bucuresti,4732,5,3,5,6,18,22,-4,14
Concordia Ch,4732,6,3,2,9,19,25,-6,11
FCSB,4733,1,9,5,0,29,12,17,32
CFR Cluj,4733,2,6,6,2,17,11,6,24
FC Botosani,4733,3,4,4,6,6,13,-7,16
Concordia Ch,4733,4,4,2,8,19,23,-4,14
Universitate,4733,5,3,5,6,14,22,-8,14
D Bucuresti,4733,6,3,4,7,18,22,-4,13
FCSB,4734,1,9,5,0,25,10,15,32
CFR Cluj,4734,2,6,6,2,15,8,7,24
FC Botosani,4734,3,5,4,5,8,13,-5,19
D Bucuresti,4734,4,3,5,6,17,20,-3,14
Universitate,4734,5,3,5,6,14,21,-7,14
Concordia Ch,4734,6,2,3,9,17,24,-7,9
FCSB,4735,1,8,6,0,26,12,14,30
CFR Cluj,4735,2,6,6,2,16,9,7,24
D Bucuresti,4735,3,4,4,6,19,21,-2,16
FC Botosani,4735,4,4,4,6,8,17,-9,16
Universitate,4735,5,3,6,5,15,21,-6,15
Concordia Ch,4735,6,3,2,9,20,24,-4,11
FCSB,4736,1,8,5,1,26,12,14,29
CFR Cluj,4736,2,6,6,2,15,10,5,24
D Bucuresti,4736,3,4,5,5,22,21,1,17
Universitate,4736,4,4,5,5,15,19,-4,17
FC Botosani,4736,5,4,4,6,9,17,-8,16
Concordia Ch,4736,6,2,3,9,18,26,-8,9
CFR Cluj,4737,1,7,6,1,16,7,9,27
FCSB,4737,2,7,5,2,23,14,9,26
D Bucuresti,4737,3,4,5,5,22,19,3,17
Universitate,4737,4,4,5,5,16,19,-3,17
FC Botosani,4737,5,4,4,6,6,17,-11,16
Concordia Ch,4737,6,2,3,9,16,23,-7,9
FCSB,4738,1,9,5,0,27,11,16,32
CFR Cluj,4738,2,6,6,2,17,9,8,24
D Bucuresti,4738,3,3,6,5,17,19,-2,15
Universitate,4738,4,3,5,6,15,24,-9,14
FC Botosani,4738,5,3,5,6,7,16,-9,14
Concordia Ch,4738,6,3,3,8,18,22,-4,12
FCSB,4739,1,8,5,1,27,12,15,29
CFR Cluj,4739,2,5,6,3,13,14,-1,21
Universitate,4739,3,5,5,4,19,18,1,20
D Bucuresti,4739,4,4,5,5,19,19,0,17
FC Botosani,4739,5,4,5,5,8,14,-6,17
Concordia Ch,4739,6,2,2,10,16,25,-9,8
FCSB,4740,1,8,5,1,28,15,13,29
CFR Cluj,4740,2,5,7,2,18,14,4,22
Universitate,4740,3,4,6,4,18,20,-2,18
FC Botosani,4740,4,4,5,5,9,15,-6,17
D Bucuresti,4740,5,3,5,6,18,22,-4,14
Concordia Ch,4740,6,3,2,9,20,25,-5,11
FCSB,4741,1,8,5,1,28,13,15,29
CFR Cluj,4741,2,6,6,2,17,12,5,24
Universitate,4741,3,4,5,5,16,21,-5,17
Concordia Ch,4741,4,4,2,8,21,23,-2,14
D Bucuresti,4741,5,3,5,6,18,21,-3,14
FC Botosani,4741,6,3,5,6,5,15,-10,14
FCSB,4742,1,8,5,1,24,12,12,29
CFR Cluj,4742,2,6,6,2,15,8,7,24
D Bucuresti,4742,3,5,4,5,19,19,0,19
Universitate,4742,4,4,5,5,16,20,-4,17
FC Botosani,4742,5,4,4,6,6,13,-7,16
Concordia Ch,4742,6,2,2,10,16,24,-8,8
FCSB,4743,1,8,6,0,25,11,14,30
CFR Cluj,4743,2,6,6,2,15,9,6,24
Universitate,4743,3,3,6,5,14,19,-5,15
Concordia Ch,4743,4,4,2,8,18,21,-3,14
D Bucuresti,4743,5,3,5,6,17,21,-4,14
FC Botosani,4743,6,3,5,6,6,14,-8,14
FCSB,4744,1,8,5,1,27,14,13,29
CFR Cluj,4744,2,6,6,2,18,10,8,24
Universitate,4744,3,4,5,5,16,22,-6,17
FC Botosani,4744,4,4,5,5,8,14,-6,17
D Bucuresti,4744,5,3,5,6,18,21,-3,14
Concordia Ch,4744,6,2,4,8,17,23,-6,10
CFR Cluj,4745,1,7,6,1,20,7,13,27
FCSB,4745,2,7,5,2,23,14,9,26
FC Botosani,4745,3,4,5,5,7,13,-6,17
Universitate,4745,4,4,5,5,15,22,-7,17
D Bucuresti,4745,5,3,6,5,18,20,-2,15
Concordia Ch,4745,6,2,3,9,16,23,-7,9
FCSB,4746,1,7,6,1,24,13,11,27
CFR Cluj,4746,2,6,6,2,16,9,7,24
Universitate,4746,3,4,6,4,17,20,-3,18
D Bucuresti,4746,4,4,5,5,22,20,2,17
FC Botosani,4746,5,4,5,5,8,13,-5,17
Concordia Ch,4746,6,2,2,10,16,28,-12,8
FCSB,4747,1,8,6,0,27,11,16,30
CFR Cluj,4747,2,5,8,1,14,8,6,23
D Bucuresti,4747,3,4,4,6,19,21,-2,16
FC Botosani,4747,4,4,4,6,7,15,-8,16
Universitate,4747,5,3,6,5,14,21,-7,15
Concordia Ch,4747,6,3,2,9,18,23,-5,11
FCSB,4748,1,8,5,1,26,14,12,29
CFR Cluj,4748,2,6,6,2,18,11,7,24
Universitate,4748,3,4,5,5,17,21,-4,17
D Bucuresti,4748,4,4,4,6,18,20,-2,16
FC Botosani,4748,5,4,4,6,7,15,-8,16
Concordia Ch,4748,6,3,2,9,18,23,-5,11
CFR Cluj,4749,1,7,6,1,18,8,10,27
FCSB,4749,2,7,5,2,23,12,11,26
Universitate,4749,3,4,5,5,16,22,-6,17
D Bucuresti,4749,4,4,4,6,20,22,-2,16
FC Botosani,4749,5,3,5,6,8,17,-9,14
Concordia Ch,4749,6,3,3,8,18,22,-4,12
FCSB,4750,1,8,5,1,25,13,12,29
CFR Cluj,4750,2,7,6,1,17,8,9,27
D Bucuresti,4750,3,4,5,5,18,19,-1,17
FC Botosani,4750,4,3,6,5,7,14,-7,15
Universitate,4750,5,3,5,6,14,20,-6,14
Concordia Ch,4750,6,2,3,9,16,23,-7,9
FCSB,4751,1,8,5,1,26,12,14,29
CFR Cluj,4751,2,5,7,2,14,10,4,22
Universitate,4751,3,4,6,4,17,20,-3,18
D Bucuresti,4751,4,4,5,5,19,20,-1,17
FC Botosani,4751,5,4,5,5,7,12,-5,17
Concordia Ch,4751,6,2,2,10,17,26,-9,8
FCSB,4752,1,9,5,0,28,13,15,32
CFR Cluj,4752,2,5,7,2,16,11,5,22
Universitate,4752,3,3,6,5,14,19,-5,15
Concordia Ch,4752,4,4,2,8,19,22,-3,14
D Bucuresti,4752,5,3,5,6,16,20,-4,14
FC Botosani,4752,6,3,5,6,6,14,-8,14
CFR Cluj,4753,1,7,6,1,16,8,8,27
FCSB,4753,2,7,5,2,24,14,10,26
D Bucuresti,4753,3,5,4,5,23,21,2,19
Universitate,4753,4,4,5,5,18,21,-3,17
FC Botosani,4753,5,4,4,6,9,15,-6,16
Concordia Ch,4753,6,2,2,10,16,27,-11,8
FCSB,4754,1,8,6,0,28,14,14,30
CFR Cluj,4754,2,5,6,3,15,12,3,21
Universitate,4754,3,4,6,4,18,20,-2,18
FC Botosani,4754,4,3,6,5,5,12,-7,15
D Bucuresti,4754,5,3,5,6,16,19,-3,14
Concordia Ch,4754,6,3,3,8,16,21,-5,12
FCSB,4755,1,7,7,0,24,11,13,28
CFR Cluj,4755,2,6,7,1,14,7,7,25
FC Botosani,4755,3,4,4,6,6,15,-9,16
Universitate,4755,4,3,6,5,15,20,-5,15
D Bucuresti,4755,5,3,5,6,16,19,-3,14
Concordia Ch,4755,6,3,3,8,18,21,-3,12
FCSB,4756,1,8,6,0,28,14,14,30
CFR Cluj,4756,2,6,7,1,17,9,8,25
FC Botosani,4756,3,5,4,5,10,13,-3,19
D Bucuresti,4756,4,3,5,6,18,22,-4,14
Universitate,4756,5,3,5,6,16,23,-7,14
Concordia Ch,4756,6,2,3,9,18,26,-8,9
CFR Cluj,4757,1,7,6,1,16,7,9,27
FCSB,4757,2,7,5,2,23,12,11,26
Universitate,4757,3,4,5,5,15,20,-5,17
FC Botosani,4757,4,4,5,5,8,14,-6,17
D Bucuresti,4757,5,3,6,5,18,20,-2,15
Concordia Ch,4757,6,2,3,9,17,24,-7,9
FCSB,4758,1,9,5,0,29,12,17,32
CFR Cluj,4758,2,5,7,2,15,10,5,22
FC Botosani,4758,3,5,4,5,11,14,-3,19
Universitate,4758,4,3,6,5,14,21,-7,15
D Bucuresti,4758,5,3,4,7,17,21,-4,13
Concordia Ch,4758,6,3,2,9,17,25,-8,11
FCSB,4759,1,7,7,0,25,12,13,28
CFR Cluj,4759,2,5,8,1,13,7,6,23
D Bucuresti,4759,3,4,5,5,19,19,0,17
FC Botosani,4759,4,4,5,5,6,12,-6,17
Universitate,4759,5,3,7,4,16,20,-4,16
Concordia Ch,4759,6,2,2,10,16,25,-9,8
FCSB,4760,1,7,6,1,23,11,12,27
CFR Cluj,4760,2,7,6,1,15,7,8,27
FC Botosani,4760,3,4,5,5,8,14,-6,17
D Bucuresti,4760,4,4,4,6,19,20,-1,16
Universitate,4760,5,3,6,5,14,19,-5,15
Concordia Ch,4760,6,2,3,9,18,26,-8,9
FCSB,4761,1,8,5,1,26,11,15,29
CFR Cluj,4761,2,5,6,3,14,13,1,21
Universitate,4761,3,5,5,4,18,19,-1,20
FC Botosani,4761,4,4,4,6,6,13,-7,16
Concordia Ch,4761,5,4,2,8,19,22,-3,14
D Bucuresti,4761,6,3,4,7,17,22,-5,13
FCSB,4762,1,8,5,1,24,11,13,29
CFR Cluj,4762,2,5,6,3,13,9,4,21
Universitate,4762,3,5,5,4,16,18,-2,20
Concordia Ch,4762,4,4,2,8,21,24,-3,14
D Bucuresti,4762,5,3,5,6,17,20,-3,14
FC Botosani,4762,6,3,5,6,7,16,-9,14
FCSB,4763,1,8,6,0,25,11,14,30
CFR Cluj,4763,2,5,6,3,15,11,4,21
Universitate,4763,3,4,6,4,16,19,-3,18
D Bucuresti,4763,4,4,5,5,19,18,1,17
FC Botosani,4763,5,3,6,5,5,12,-7,15
Concordia Ch,4763,6,2,3,9,15,24,-9,9
FCSB,4764,1,7,6,1,24,13,11,27
CFR Cluj,4764,2,7,6,1,17,8,9,27
D Bucuresti,4764,3,4,4,6,21,25,-4,16
FC Botosani,4764,4,4,4,6,8,15,-7,16
Universitate,4764,5,3,6,5,14,19,-5,15
Concordia Ch,4764,6,3,2,9,20,24,-4,11
FCSB,4765,1,7,6,1,25,13,12,27
CFR Cluj,4765,2,6,6,2,14,8,6,24
Universitate,4765,3,4,6,4,17,20,-3,18
D Bucuresti,4765,4,4,4,6,18,19,-1,16
FC Botosani,4765,5,3,5,6,5,14,-9,14
Concordia Ch,4765,6,3,3,8,16,21,-5,12
FCSB,4766,1,8,5,1,27,12,15,29
CFR Cluj,4766,2,5,6,3,14,14,0,21
Universitate,4766,3,5,5,4,19,19,0,20
D Bucuresti,4766,4,4,4,6,18,22,-4,16
FC Botosani,4766,5,4,4,6,7,14,-7,16
Concordia Ch,4766,6,3,2,9,18,22,-4,11
FCSB,4767,1,8,6,0,26,12,14,30
CFR Cluj,4767,2,6,6,2,16,9,7,24
D Bucuresti,4767,3,3,6,5,16,18,-2,15
Universitate,4767,4,3,6,5,17,23,-6,15
FC Botosani,4767,5,3,5,6,5,13,-8,14
Concordia Ch,4767,6,3,3,8,16,21,-5,12
FCSB,4768,1,8,5,1,25,13,12,29
CFR Cluj,4768,2,6,6,2,16,10,6,24
D Bucuresti,4768,3,5,4,5,20,19,1,19
Universitate,4768,4,4,5,5,17,20,-3,17
FC Botosani,4768,5,4,4,6,8,16,-8,16
Concordia Ch,4768,6,2,2,10,16,24,-8,8
FCSB,4769,1,9,5,0,26,10,16,32
CFR Cluj,4769,2,6,6,2,14,8,6,24
D Bucuresti,4769,3,4,5,5,19,19,0,17
Universitate,4769,4,3,5,6,14,21,-7,14
FC Botosani,4769,5,3,4,7,5,15,-10,13
Concordia Ch,4769,6,3,3,8,17,22,-5,12
FCSB,4770,1,9,5,0,28,12,16,32
CFR Cluj,4770,2,6,6,2,14,9,5,24
D Bucuresti,4770,3,4,4,6,17,20,-3,16
FC Botosani,4770,4,4,4,6,8,14,-6,16
Universitate,4770,5,3,5,6,16,22,-6,14
Concordia Ch,4770,6,3,2,9,17,23,-6,11
FCSB,4771,1,8,5,1,25,12,13,29
CFR Cluj,4771,2,6,6,2,14,9,5,24
Universitate,4771,3,4,5,5,16,19,-3,17
FC Botosani,4771,4,4,5,5,8,13,-5,17
D Bucuresti,4771,5,3,5,6,17,21,-4,14
Concordia Ch,4771,6,2,4,8,17,23,-6,10
CFR Cluj,4772,1,7,6,1,17,7,10,27
FCSB,4772,2,7,5,2,23,12,11,26
D Bucuresti,4772,3,5,4,5,23,19,4,19
Universitate,4772,4,4,5,5,15,21,-6,17
FC Botosani,4772,5,3,5,6,7,19,-12,14
Concordia Ch,4772,6,2,3,9,18,25,-7,9
FCSB,4773,1,7,6,1,24,12,12,27
CFR Cluj,4773,2,5,8,1,13,7,6,23
D Bucuresti,4773,3,5,4,5,19,18,1,19
Universitate,4773,4,4,6,4,16,19,-3,18
FC Botosani,4773,5,4,4,6,7,14,-7,16
Concordia Ch,4773,6,2,2,10,16,25,-9,8
FCSB,4774,1,8,5,1,26,12,14,29
CFR Cluj,4774,2,6,7,1,15,8,7,25
D Bucuresti,4774,3,4,4,6,17,21,-4,16
FC Botosani,4774,4,4,4,6,6,13,-7,16
Universitate,4774,5,3,6,5,14,20,-6,15
Concordia Ch,4774,6,3,2,9,18,22,-4,11
FCSB,4775,1,8,6,0,25,10,15,30
CFR Cluj,4775,2,5,8,1,15,9,6,23
D Bucuresti,4775,3,5,4,5,20,19,1,19
Universitate,4775,4,3,6,5,16,22,-6,15
FC Botosani,4775,5,3,4,7,6,18,-12,13
Concordia Ch,4775,6,3,2,9,18,22,-4,11
FCSB,4776,1,8,5,1,26,13,13,29
CFR Cluj,4776,2,6,6,2,18,10,8,24
D Bucuresti,4776,3,4,5,5,19,20,-1,17
Universitate,4776,4,4,5,5,16,22,-6,17
FC Botosani,4776,5,3,5,6,7,15,-8,14
Concordia Ch,4776,6,3,2,9,18,24,-6,11
FCSB,4777,1,8,5,1,27,15,12,29
CFR Cluj,4777,2,6,6,2,16,9,7,24
Universitate,4777,3,4,5,5,18,22,-4,17
D Bucuresti,4777,4,4,4,6,22,24,-2,16
FC Botosani,4777,5,4,4,6,6,16,-10,16
Concordia Ch,4777,6,3,2,9,21,24,-3,11
FCSB,4778,1,8,5,1,25,13,12,29
CFR Cluj,4778,2,6,6,2,17,10,7,24
Universitate,4778,3,4,5,5,17,21,-4,17
D Bucuresti,4778,4,4,4,6,18,22,-4,16
FC Botosani,4778,5,3,5,6,7,15,-8,14
Concordia Ch,4778,6,3,3,8,19,22,-3,12
FCSB,4779,1,8,5,1,25,15,10,29
CFR Cluj,4779,2,6,6,2,15,8,7,24
D Bucuresti,4779,3,4,5,5,18,19,-1,17
Universitate,4779,4,4,5,5,19,21,-2,17
FC Botosani,4779,5,4,5,5,6,12,-6,17
Concordia Ch,4779,6,2,2,10,16,24,-8,8
FCSB,4780,1,7,7,0,24,11,13,28
CFR Cluj,4780,2,6,7,1,15,8,7,25
FC Botosani,4780,3,5,4,5,9,14,-5,19
Universitate,4780,4,3,6,5,14,19,-5,15
D Bucuresti,4780,5,3,4,7,17,21,-4,13
Concordia Ch,4780,6,3,2,9,17,23,-6,11
FCSB,4781,1,8,6,0,27,12,15,30
CFR Cluj,4781,2,6,7,1,16,9,7,25
D Bucuresti,4781,3,5,4,5,20,20,0,19
Universitate,4781,4,3,5,6,16,23,-7,14
FC Botosani,4781,5,3,5,6,6,14,-8,14
Concordia Ch,4781,6,2,3,9,18,25,-7,9
CFR Cluj,4782,1,7,6,1,16,7,9,27
FCSB,4782,2,7,5,2,23,13,10,26
D Bucuresti,4782,3,4,5,5,17,18,-1,17
Universitate,4782,4,4,5,5,15,19,-4,17
FC Botosani,4782,5,3,5,6,5,13,-8,14
Concordia Ch,4782,6,2,4,8,15,21,-6,10
FCSB,4783,1,8,6,0,26,11,15,30
CFR Cluj,4783,2,6,6,2,14,9,5,24
D Bucuresti,4783,3,3,6,5,16,18,-2,15
Universitate,4783,4,3,6,5,15,20,-5,15
FC Botosani,4783,5,3,5,6,5,14,-9,14
Concordia Ch,4783,6,3,3,8,17,21,-4,12
FCSB,4784,1,8,5,1,24,11,13,29
CFR Cluj,4784,2,7,6,1,15,7,8,27
D Bucuresti,4784,3,4,5,5,18,19,-1,17
FC Botosani,4784,4,4,5,5,8,14,-6,17
Universitate,4784,5,3,5,6,14,20,-6,14
Concordia Ch,4784,6,2,2,10,16,24,-8,8
FCSB,4785,1,8,6,0,26,12,14,30
CFR Cluj,4785,2,5,7,2,15,10,5,22
D Bucuresti,4785,3,4,4,6,21,21,0,16
Universitate,4785,4,3,7,4,16,20,-4,16
Concordia Ch,4785,5,4,2,8,19,23,-4,14
FC Botosani,4785,6,3,4,7,5,16,-11,13
FCSB,4786,1,8,5,1,25,12,13,29
CFR Cluj,4786,2,7,6,1,16,7,9,27
D Bucuresti,4786,3,4,5,5,20,20,0,17
Universitate,4786,4,3,5,6,15,22,-7,14
FC Botosani,4786,5,3,5,6,6,14,-8,14
Concordia Ch,4786,6,3,2,9,17,24,-7,11
FCSB,4787,1,9,5,0,29,11,18,32
CFR Cluj,4787,2,5,7,2,15,13,2,22
D Bucuresti,4787,3,5,4,5,20,19,1,19
Universitate,4787,4,3,6,5,17,22,-5,15
FC Botosani,4787,5,3,5,6,6,14,-8,14
Concordia Ch,4787,6,2,3,9,15,23,-8,9
FCSB,4788,1,8,6,0,29,13,16,30
CFR Cluj,4788,2,5,6,3,14,12,2,21
Universitate,4788,3,4,6,4,17,20,-3,18
D Bucuresti,4788,4,4,4,6,17,19,-2,16
FC Botosani,4788,5,4,4,6,7,14,-7,16
Concordia Ch,4788,6,3,2,9,17,23,-6,11
FCSB,4789,1,7,7,0,24,11,13,28
CFR Cluj,4789,2,6,7,1,16,9,7,25
FC Botosani,4789,3,4,5,5,8,14,-6,17
Universitate,4789,4,3,6,5,15,20,-5,15
D Bucuresti,4789,5,3,4,7,16,20,-4,13
Concordia Ch,4789,6,3,3,8,18,23,-5,12
FCSB,4790,1,7,6,1,25,13,12,27
CFR Cluj,4790,2,6,7,1,15,8,7,25
Universitate,4790,3,4,5,5,16,20,-4,17
D Bucuresti,4790,4,4,4,6,20,22,-2,16
FC Botosani,4790,5,4,4,6,9,16,-7,16
Concordia Ch,4790,6,3,2,9,19,25,-6,11
FCSB,4791,1,8,5,1,28,12,16,29
CFR Cluj,4791,2,5,6,3,14,13,1,21
Universitate,4791,3,5,5,4,16,18,-2,20
D Bucuresti,4791,4,5,4,5,19,19,0,19
FC Botosani,4791,5,3,5,6,7,15,-8,14
Concordia Ch,4791,6,2,3,9,18,25,-7,9
FCSB,4792,1,8,6,0,25,11,14,30
CFR Cluj,4792,2,5,7,2,13,8,5,22
FC Botosani,4792,3,5,4,5,8,12,-4,19
Universitate,4792,4,4,5,5,16,20,-4,17
D Bucuresti,4792,5,3,5,6,18,22,-4,14
Concordia Ch,4792,6,2,3,9,17,24,-7,9
FCSB,4793,1,7,6,1,23,11,12,27
CFR Cluj,4793,2,6,7,1,14,7,7,25
Universitate,4793,3,4,5,5,15,19,-4,17
D Bucuresti,4793,4,4,4,6,20,20,0,16
FC Botosani,4793,5,4,4,6,8,16,-8,16
Concordia Ch,4793,6,3,2,9,18,25,-7,11
FCSB,4794,1,7,6,1,23,11,12,27
CFR Cluj,4794,2,7,6,1,16,7,9,27
D Bucuresti,4794,3,5,4,5,21,19,2,19
FC Botosani,4794,4,4,4,6,8,17,-9,16
Universitate,4794,5,3,6,5,14,20,-6,15
Concordia Ch,4794,6,2,2,10,16,24,-8,8
FCSB,4795,1,7,6,1,25,13,12,27
CFR Cluj,4795,2,6,7,1,15,8,7,25
D Bucuresti,4795,3,5,4,5,21,19,2,19
Universitate,4795,4,3,7,4,17,21,-4,16
FC Botosani,4795,5,3,5,6,5,15,-10,14
Concordia Ch,4795,6,2,3,9,16,23,-7,9
CFR Cluj,4796,1,7,6,1,16,7,9,27
FCSB,4796,2,7,5,2,24,16,8,26
Universitate,4796,3,4,5,5,18,20,-2,17
D Bucuresti,4796,4,4,4,6,19,21,-2,16
FC Botosani,4796,5,4,4,6,8,14,-6,16
Concordia Ch,4796,6,3,2,9,17,24,-7,11
FCSB,4797,1,9,5,0,26,10,16,32
CFR Cluj,4797,2,6,6,2,15,9,6,24
D Bucuresti,4797,3,5,4,5,19,19,0,19
Universitate,4797,4,3,5,6,14,21,-7,14
FC Botosani,4797,5,3,4,7,5,15,-10,13
Concordia Ch,4797,6,3,2,9,18,23,-5,11
FCSB,4798,1,8,5,1,26,13,13,29
CFR Cluj,4798,2,6,6,2,16,10,6,24
D Bucuresti,4798,3,5,4,5,20,19,1,19
Universitate,4798,4,4,5,5,17,21,-4,17
FC Botosani,4798,5,3,4,7,5,14,-9,13
Concordia Ch,4798,6,3,2,9,17,24,-7,11
FCSB,4799,1,8,6,0,30,12,18,30
CFR Cluj,4799,2,5,6,3,13,13,0,21
Universitate,4799,3,4,6,4,17,20,-3,18
D Bucuresti,4799,4,4,4,6,18,20,-2,16
Concordia Ch,4799,5,4,2,8,18,22,-4,14
FC Botosani,4799,6,3,4,7,7,16,-9,13
FCSB,4800,1,8,6,0,25,11,14,30
CFR Cluj,4800,2,5,8,1,14,8,6,23
D Bucuresti,4800,3,4,4,6,17,19,-2,16
FC Botosani,4800,4,4,4,6,7,13,-6,16
Universitate,4800,5,3,6,5,14,19,-5,15
Concordia Ch,4800,6,3,2,9,16,23,-7,11
FCSB,4801,1,7,6,1,23,11,12,27
CFR Cluj,4801,2,6,7,1,16,8,8,25
Universitate,4801,3,4,5,5,16,21,-5,17
Concordia Ch,4801,4,4,2,8,20,23,-3,14
D Bucuresti,4801,5,3,5,6,19,22,-3,14
FC Botosani,4801,6,3,5,6,6,15,-9,14
FCSB,4802,1,7,6,1,25,13,12,27
CFR Cluj,4802,2,6,7,1,15,8,7,25
Universitate,4802,3,3,7,4,17,21,-4,16
D Bucuresti,4802,4,3,6,5,18,20,-2,15
FC Botosani,4802,5,3,5,6,5,14,-9,14
Concordia Ch,4802,6,3,3,8,19,23,-4,12
FCSB,4803,1,8,5,1,25,14,11,29
CFR Cluj,4803,2,5,7,2,15,11,4,22
FC Botosani,4803,3,5,4,5,9,12,-3,19
Universitate,4803,4,4,6,4,20,20,0,18
D Bucuresti,4803,5,3,5,6,18,23,-5,14
Concordia Ch,4803,6,2,3,9,17,24,-7,9
FCSB,4804,1,8,6,0,29,12,17,30
CFR Cluj,4804,2,5,6,3,13,12,1,21
Universitate,4804,3,4,6,4,17,20,-3,18
D Bucuresti,4804,4,4,4,6,18,21,-3,16
Concordia Ch,4804,5,4,2,8,18,21,-3,14
FC Botosani,4804,6,3,4,7,6,15,-9,13
FCSB,4805,1,8,5,1,26,13,13,29
CFR Cluj,4805,2,6,7,1,15,8,7,25
D Bucuresti,4805,3,4,5,5,18,19,-1,17
Universitate,4805,4,3,6,5,17,22,-5,15
FC Botosani,4805,5,3,5,6,7,15,-8,14
Concordia Ch,4805,6,3,2,9,19,25,-6,11
FCSB,4806,1,7,6,1,25,13,12,27
CFR Cluj,4806,2,6,7,1,14,7,7,25
Universitate,4806,3,4,5,5,17,21,-4,17
D Bucuresti,4806,4,4,4,6,18,22,-4,16
FC Botosani,4806,5,4,4,6,8,16,-8,16
Concordia Ch,4806,6,3,2,9,21,24,-3,11
FCSB,4807,1,8,6,0,28,12,16,30
CFR Cluj,4807,2,5,7,2,14,11,3,22
D Bucuresti,4807,3,4,5,5,19,20,-1,17
Universitate,4807,4,3,7,4,17,21,-4,16
FC Botosani,4807,5,4,4,6,8,14,-6,16
Concordia Ch,4807,6,2,3,9,16,24,-8,9
FCSB,4808,1,7,7,0,27,14,13,28
CFR Cluj,4808,2,5,8,1,15,9,6,23
FC Botosani,4808,3,4,5,5,7,13,-6,17
Universitate,4808,4,3,7,4,18,22,-4,16
D Bucuresti,4808,5,3,6,5,17,19,-2,15
Concordia Ch,4808,6,2,3,9,17,24,-7,9
FCSB,4809,1,8,5,1,28,13,15,29
CFR Cluj,4809,2,7,6,1,18,9,9,27
D Bucuresti,4809,3,4,4,6,18,20,-2,16
FC Botosani,4809,4,4,4,6,7,15,-8,16
Universitate,4809,5,3,5,6,14,23,-9,14
Concordia Ch,4809,6,3,2,9,18,23,-5,11
FCSB,4810,1,8,6,0,28,14,14,30
CFR Cluj,4810,2,5,7,2,16,13,3,22
Universitate,4810,3,4,5,5,18,20,-2,17
D Bucuresti,4810,4,4,4,6,18,20,-2,16
FC Botosani,4810,5,3,5,6,6,14,-8,14
Concordia Ch,4810,6,3,3,8,16,21,-5,12
FCSB,4811,1,7,5,2,25,15,10,26
CFR Cluj,4811,2,6,6,2,15,11,4,24
Universitate,4811,3,5,5,4,20,19,1,20
D Bucuresti,4811,4,4,4,6,18,22,-4,16
Concordia Ch,4811,5,4,2,8,19,21,-2,14
FC Botosani,4811,6,3,4,7,6,15,-9,13
FCSB,4812,1,9,5,0,25,10,15,32
CFR Cluj,4812,2,5,6,3,13,9,4,21
Universitate,4812,3,4,5,5,15,19,-4,17
D Bucuresti,4812,4,4,4,6,17,20,-3,16
Concordia Ch,4812,5,4,2,8,18,21,-3,14
FC Botosani,4812,6,3,4,7,5,14,-9,13
FCSB,4813,1,8,5,1,27,13,14,29
CFR Cluj,4813,2,5,6,3,14,11,3,21
Universitate,4813,3,5,5,4,17,19,-2,20
FC Botosani,4813,4,4,5,5,6,12,-6,17
D Bucuresti,4813,5,3,5,6,16,20,-4,14
Concordia Ch,4813,6,3,2,9,17,22,-5,11
FCSB,4814,1,9,5,0,29,12,17,32
CFR Cluj,4814,2,5,6,3,13,10,3,21
D Bucuresti,4814,3,4,5,5,17,18,-1,17
Universitate,4814,4,4,5,5,17,22,-5,17
FC Botosani,4814,5,4,5,5,6,12,-6,17
Concordia Ch,4814,6,2,2,10,15,23,-8,8
FCSB,4815,1,8,6,0,26,11,15,30
CFR Cluj,4815,2,6,7,1,15,8,7,25
D Bucuresti,4815,3,3,6,5,19,21,-2,15
FC Botosani,4815,4,3,6,5,6,13,-7,15
Universitate,4815,5,3,5,6,14,21,-7,14
Concordia Ch,4815,6,2,4,8,19,25,-6,10
FCSB,4816,1,7,6,1,23,11,12,27
CFR Cluj,4816,2,5,8,1,14,8,6,23
Universitate,4816,3,4,6,4,16,19,-3,18
D Bucuresti,4816,4,4,4,6,18,20,-2,16
FC Botosani,4816,5,4,4,6,8,14,-6,16
Concordia Ch,4816,6,3,2,9,17,24,-7,11
FCSB,4817,1,8,5,1,26,11,15,29
CFR Cluj,4817,2,5,7,2,15,12,3,22
Universitate,4817,3,4,6,4,17,20,-3,18
FC Botosani,4817,4,3,6,5,8,15,-7,15
D Bucuresti,4817,5,3,5,6,17,24,-7,14
Concordia Ch,4817,6,3,3,8,22,23,-1,12
FCSB,4818,1,9,5,0,26,10,16,32
CFR Cluj,4818,2,5,7,2,13,9,4,22
D Bucuresti,4818,3,3,6,5,20,22,-2,15
Universitate,4818,4,3,6,5,14,19,-5,15
FC Botosani,4818,5,3,5,6,7,15,-8,14
Concordia Ch,4818,6,3,3,8,18,23,-5,12
FCSB,4819,1,8,6,0,25,10,15,30
CFR Cluj,4819,2,5,8,1,13,7,6,23
D Bucuresti,4819,3,5,4,5,21,18,3,19
Universitate,4819,4,3,6,5,14,20,-6,15
FC Botosani,4819,5,3,5,6,5,14,-9,14
Concordia Ch,4819,6,2,3,9,15,24,-9,9
FCSB,4820,1,8,6,0,25,11,14,30
CFR Cluj,4820,2,6,6,2,19,8,11,24
D Bucuresti,4820,3,4,4,6,19,21,-2,16
Universitate,4820,4,3,6,5,15,25,-10,15
FC Botosani,4820,5,3,5,6,6,14,-8,14
Concordia Ch,4820,6,3,3,8,19,24,-5,12
FCSB,4821,1,7,5,2,24,15,9,26
CFR Cluj,4821,2,6,7,1,16,7,9,25
Universitate,4821,3,4,6,4,16,19,-3,18
D Bucuresti,4821,4,4,5,5,20,20,0,17
FC Botosani,4821,5,3,5,6,6,15,-9,14
Concordia Ch,4821,6,2,4,8,18,24,-6,10
FCSB,4822,1,7,6,1,26,15,11,27
CFR Cluj,4822,2,5,8,1,14,8,6,23
Universitate,4822,3,4,6,4,18,20,-2,18
FC Botosani,4822,4,3,6,5,7,14,-7,15
D Bucuresti,4822,5,3,5,6,17,20,-3,14
Concordia Ch,4822,6,3,3,8,17,22,-5,12
FCSB,4823,1,8,6,0,25,11,14,30
CFR Cluj,4823,2,6,7,1,16,7,9,25
D Bucuresti,4823,3,4,4,6,18,21,-3,16
Concordia Ch,4823,4,4,2,8,18,21,-3,14
Universitate,4823,5,3,5,6,15,23,-8,14
FC Botosani,4823,6,3,4,7,6,15,-9,13
FCSB,4824,1,7,7,0,24,11,13,28
CFR Cluj,4824,2,6,7,1,16,8,8,25
FC Botosani,4824,3,4,5,5,11,16,-5,17
Universitate,4824,4,3,6,5,14,20,-6,15
D Bucuresti,4824,5,3,5,6,19,22,-3,14
Concordia Ch,4824,6,3,2,9,17,24,-7,11
FCSB,4825,1,7,7,0,23,10,13,28
CFR Cluj,4825,2,6,7,1,16,9,7,25
FC Botosani,4825,3,4,5,5,12,16,-4,17
D Bucuresti,4825,4,3,6,5,19,21,-2,15
Universitate,4825,5,3,6,5,16,21,-5,15
Concordia Ch,4825,6,2,3,9,18,27,-9,9
FCSB,4826,1,8,5,1,25,14,11,29
CFR Cluj,4826,2,6,6,2,16,10,6,24
D Bucuresti,4826,3,4,5,5,18,19,-1,17
Universitate,4826,4,4,5,5,18,20,-2,17
FC Botosani,4826,5,4,5,5,7,13,-6,17
Concordia Ch,4826,6,2,2,10,15,23,-8,8
FCSB,4827,1,9,5,0,27,10,17,32
CFR Cluj,4827,2,5,7,2,14,10,4,22
FC Botosani,4827,3,5,4,5,7,12,-5,19
Universitate,4827,4,3,6,5,15,21,-6,15
D Bucuresti,4827,5,3,4,7,16,21,-5,13
Concordia Ch,4827,6,3,2,9,17,22,-5,11
FCSB,4828,1,9,5,0,29,11,18,32
CFR Cluj,4828,2,5,7,2,15,10,5,22
D Bucuresti,4828,3,4,5,5,19,18,1,17
FC Botosani,4828,4,4,4,6,7,16,-9,16
Universitate,4828,5,3,6,5,15,23,-8,15
Concordia Ch,4828,6,2,3,9,16,23,-7,9
FCSB,4829,1,9,5,0,29,12,17,32
CFR Cluj,4829,2,5,6,3,14,12,2,21
D Bucuresti,4829,3,4,5,5,19,19,0,17
Universitate,4829,4,4,5,5,17,21,-4,17
FC Botosani,4829,5,3,5,6,7,16,-9,14
Concordia Ch,4829,6,2,4,8,18,24,-6,10
FCSB,4830,1,8,5,1,27,14,13,29
CFR Cluj,4830,2,6,6,2,15,12,3,24
Universitate,4830,3,4,5,5,19,20,-1,17
D Bucuresti,4830,4,4,4,6,20,21,-1,16
FC Botosani,4830,5,4,4,6,8,14,-6,16
Concordia Ch,4830,6,3,2,9,16,24,-8,11
FCSB,4831,1,7,7,0,26,13,13,28
CFR Cluj,4831,2,5,7,2,15,10,5,22
Universitate,4831,3,4,6,4,18,21,-3,18
FC Botosani,4831,4,4,5,5,9,15,-6,17
D Bucuresti,4831,5,4,4,6,21,20,1,16
Concordia Ch,4831,6,2,3,9,17,27,-10,9
FCSB,4832,1,7,6,1,25,14,11,27
CFR Cluj,4832,2,6,7,1,17,9,8,25
D Bucuresti,4832,3,5,4,5,21,19,2,19
Universitate,4832,4,4,5,5,16,20,-4,17
FC Botosani,4832,5,3,5,6,5,15,-10,14
Concordia Ch,4832,6,2,3,9,16,23,-7,9
FCSB,4833,1,8,5,1,24,12,12,29
CFR Cluj,4833,2,5,6,3,15,11,4,21
Universitate,4833,3,5,5,4,19,20,-1,20
D Bucuresti,4833,4,4,5,5,19,20,-1,17
FC Botosani,4833,5,4,5,5,8,14,-6,17
Concordia Ch,4833,6,2,2,10,17,25,-8,8
FCSB,4834,1,9,5,0,26,10,16,32
CFR Cluj,4834,2,6,6,2,15,9,6,24
D Bucuresti,4834,3,5,4,5,18,18,0,19
FC Botosani,4834,4,4,4,6,7,14,-7,16
Universitate,4834,5,3,5,6,15,22,-7,14
Concordia Ch,4834,6,2,2,10,16,24,-8,8
FCSB,4835,1,8,5,1,24,11,13,29
CFR Cluj,4835,2,6,6,2,14,8,6,24
Universitate,4835,3,4,5,5,15,19,-4,17
FC Botosani,4835,4,4,5,5,7,12,-5,17
D Bucuresti,4835,5,3,5,6,17,20,-3,14
Concordia Ch,4835,6,3,2,9,17,24,-7,11
FCSB,4836,1,8,5,1,26,12,14,29
CFR Cluj,4836,2,6,6,2,14,9,5,24
Universitate,4836,3,4,5,5,17,21,-4,17
D Bucuresti,4836,4,4,4,6,18,21,-3,16
FC Botosani,4836,5,4,4,6,8,14,-6,16
Concordia Ch,4836,6,3,2,9,18,24,-6,11
FCSB,4837,1,8,6,0,27,11,16,30
CFR Cluj,4837,2,5,8,1,15,9,6,23
D Bucuresti,4837,3,4,5,5,18,18,0,17
Universitate,4837,4,3,6,5,15,22,-7,15
FC Botosani,4837,5,3,6,5,7,14,-7,15
Concordia Ch,4837,6,2,3,9,17,25,-8,9
FCSB,4838,1,9,5,0,26,10,16,32
CFR Cluj,4838,2,5,6,3,14,11,3,21
Universitate,4838,3,4,5,5,17,21,-4,17
D Bucuresti,4838,4,4,4,6,20,21,-1,16
Concordia Ch,4838,5,4,2,8,20,23,-3,14
FC Botosani,4838,6,3,4,7,6,17,-11,13
FCSB,4839,1,9,5,0,29,10,19,32
CFR Cluj,4839,2,6,6,2,15,11,4,24
D Bucuresti,4839,3,4,4,6,18,20,-2,16
Universitate,4839,4,3,5,6,14,22,-8,14
FC Botosani,4839,5,3,5,6,6,14,-8,14
Concordia Ch,4839,6,3,3,8,16,21,-5,12
FCSB,4840,1,9,5,0,27,10,17,32
CFR Cluj,4840,2,6,6,2,16,10,6,24
FC Botosani,4840,3,5,4,5,9,12,-3,19
D Bucuresti,4840,4,4,4,6,18,20,-2,16
Universitate,4840,5,3,5,6,15,23,-8,14
Concordia Ch,4840,6,2,2,10,16,26,-10,8
FCSB,4841,1,7,7,0,25,12,13,28
CFR Cluj,4841,2,5,8,1,13,7,6,23
D Bucuresti,4841,3,4,4,6,18,20,-2,16
Universitate,4841,4,3,7,4,16,20,-4,16
Concordia Ch,4841,5,4,2,8,19,22,-3,14
FC Botosani,4841,6,3,4,7,6,16,-10,13
FCSB,4842,1,9,5,0,26,10,16,32
CFR Cluj,4842,2,6,6,2,14,9,5,24
FC Botosani,4842,3,4,5,5,8,14,-6,17
Universitate,4842,4,3,5,6,14,20,-6,14
D Bucuresti,4842,5,3,4,7,17,21,-4,13
Concordia Ch,4842,6,3,3,8,17,22,-5,12
FCSB,4843,1,8,5,1,27,13,14,29
CFR Cluj,4843,2,7,6,1,17,9,8,27
D Bucuresti,4843,3,5,4,5,23,18,5,19
Universitate,4843,4,3,5,6,16,23,-7,14
FC Botosani,4843,5,3,5,6,6,17,-11,14
Concordia Ch,4843,6,2,3,9,16,25,-9,9
FCSB,4844,1,8,6,0,29,13,16,30
CFR Cluj,4844,2,5,8,1,17,11,6,23
D Bucuresti,4844,3,4,4,6,17,19,-2,16
Universitate,4844,4,3,6,5,17,24,-7,15
FC Botosani,4844,5,3,5,6,6,14,-8,14
Concordia Ch,4844,6,3,3,8,17,22,-5,12
FCSB,4845,1,8,5,1,25,12,13,29
CFR Cluj,4845,2,6,6,2,16,9,7,24
D Bucuresti,4845,3,5,4,5,20,19,1,19
Universitate,4845,4,4,5,5,15,20,-5,17
FC Botosani,4845,5,4,4,6,8,14,-6,16
Concordia Ch,4845,6,2,2,10,17,27,-10,8
FCSB,4846,1,8,6,0,24,10,14,30
CFR Cluj,4846,2,5,7,2,14,9,5,22
Universitate,4846,3,3,7,4,15,19,-4,16
FC Botosani,4846,4,4,4,6,7,14,-7,16
Concordia Ch,4846,5,4,2,8,18,21,-3,14
D Bucuresti,4846,6,3,4,7,17,22,-5,13
FCSB,4847,1,9,5,0,26,11,15,32
CFR Cluj,4847,2,5,6,3,14,10,4,21
D Bucuresti,4847,3,5,4,5,20,20,0,19
Universitate,4847,4,4,5,5,17,21,-4,17
FC Botosani,4847,5,4,4,6,9,14,-5,16
Concordia Ch,4847,6,2,2,10,16,26,-10,8
FCSB,4848,1,7,6,1,27,17,10,27
CFR Cluj,4848,2,6,6,2,16,8,8,24
FC Botosani,4848,3,5,4,5,8,13,-5,19
Universitate,4848,4,4,6,4,19,22,-3,18
D Bucuresti,4848,5,4,4,6,18,20,-2,16
Concordia Ch,4848,6,2,2,10,15,23,-8,8
FCSB,4849,1,7,5,2,23,12,11,26
CFR Cluj,4849,2,6,7,1,16,9,7,25
Universitate,4849,3,4,6,4,17,20,-3,18
FC Botosani,4849,4,4,5,5,10,14,-4,17
D Bucuresti,4849,5,3,4,7,17,26,-9,13
Concordia Ch,4849,6,3,3,8,22,24,-2,12
FCSB,4850,1,8,5,1,27,12,15,29
CFR Cluj,4850,2,5,7,2,13,10,3,22
Universitate,4850,3,4,6,4,16,19,-3,18
D Bucuresti,4850,4,4,4,6,20,20,0,16
Concordia Ch,4850,5,4,2,8,19,22,-3,14
FC Botosani,4850,6,3,4,7,5,17,-12,13
CFR Cluj,4851,1,7,6,1,18,9,9,27
FCSB,4851,2,7,5,2,26,15,11,26
Universitate,4851,3,4,5,5,18,23,-5,17
FC Botosani,4851,4,4,4,6,7,14,-7,16
Concordia Ch,4851,5,4,2,8,19,22,-3,14
D Bucuresti,4851,6,3,4,7,17,22,-5,13
FCSB,4852,1,8,6,0,25,11,14,30
CFR Cluj,4852,2,5,7,2,15,10,5,22
Universitate,4852,3,4,5,5,16,20,-4,17
FC Botosani,4852,4,4,5,5,7,13,-6,17
D Bucuresti,4852,5,3,5,6,16,19,-3,14
Concordia Ch,4852,6,3,2,9,17,23,-6,11
FCSB,4853,1,8,6,0,25,11,14,30
CFR Cluj,4853,2,6,6,2,14,8,6,24
D Bucuresti,4853,3,4,4,6,19,20,-1,16
Universitate,4853,4,3,6,5,15,20,-5,15
Concordia Ch,4853,5,4,2,8,19,22,-3,14
FC Botosani,4853,6,3,4,7,5,16,-11,13
FCSB,4854,1,7,7,0,24,11,13,28
CFR Cluj,4854,2,6,7,1,16,7,9,25
D Bucuresti,4854,3,4,4,6,18,22,-4,16
FC Botosani,4854,4,4,4,6,8,15,-7,16
Universitate,4854,5,3,6,5,15,22,-7,15
Concordia Ch,4854,6,3,2,9,21,25,-4,11
CFR Cluj,4855,1,7,6,1,16,8,8,27
FCSB,4855,2,7,5,2,25,14,11,26
D Bucuresti,4855,3,4,5,5,18,19,-1,17
Universitate,4855,4,4,5,5,16,20,-4,17
FC Botosani,4855,5,3,4,7,6,15,-9,13
Concordia Ch,4855,6,3,3,8,18,23,-5,12
FCSB,4856,1,7,7,0,27,14,13,28
CFR Cluj,4856,2,5,8,1,15,9,6,23
D Bucuresti,4856,3,4,4,6,18,20,-2,16
Universitate,4856,4,3,7,4,16,20,-4,16
Concordia Ch,4856,5,4,2,8,21,23,-2,14
FC Botosani,4856,6,3,4,7,6,17,-11,13
FCSB,4857,1,8,5,1,26,12,14,29
CFR Cluj,4857,2,6,7,1,16,8,8,25
D Bucuresti,4857,3,4,4,6,21,23,-2,16
Universitate,4857,4,3,6,5,15,22,-7,15
Concordia Ch,4857,5,4,2,8,19,21,-2,14
FC Botosani,4857,6,3,4,7,7,18,-11,13
FCSB,4858,1,8,5,1,27,13,14,29
CFR Cluj,4858,2,5,7,2,14,10,4,22
Universitate,4858,3,4,6,4,16,19,-3,18
FC Botosani,4858,4,4,5,5,8,14,-6,17
D Bucuresti,4858,5,3,5,6,18,21,-3,14
Concordia Ch,4858,6,2,4,8,17,23,-6,10
FCSB,4859,1,9,5,0,27,11,16,32
CFR Cluj,4859,2,5,6,3,14,12,2,21
FC Botosani,4859,3,5,4,5,9,12,-3,19
Universitate,4859,4,4,5,5,17,20,-3,17
D Bucuresti,4859,5,3,4,7,17,22,-5,13
Concordia Ch,4859,6,3,2,9,17,24,-7,11
FCSB,4860,1,7,5,2,24,13,11,26
CFR Cluj,4860,2,6,6,2,15,9,6,24
Universitate,4860,3,5,5,4,16,18,-2,20
FC Botosani,4860,4,5,4,5,12,14,-2,19
D Bucuresti,4860,5,3,5,6,18,21,-3,14
Concordia Ch,4860,6,2,3,9,15,25,-10,9
FCSB,4861,1,7,6,1,24,13,11,27
CFR Cluj,4861,2,5,7,2,14,9,5,22
Universitate,4861,3,5,5,4,17,18,-1,20
FC Botosani,4861,4,4,5,5,6,12,-6,17
D Bucuresti,4861,5,3,5,6,17,20,-3,14
Concordia Ch,4861,6,2,4,8,16,22,-6,10
FCSB,4862,1,8,6,0,25,11,14,30
CFR Cluj,4862,2,6,7,1,16,9,7,25
FC Botosani,4862,3,4,5,5,11,15,-4,17
D Bucuresti,4862,4,3,5,6,18,21,-3,14
Universitate,4862,5,3,5,6,15,21,-6,14
Concordia Ch,4862,6,3,2,9,19,27,-8,11
FCSB,4863,1,9,5,0,27,11,16,32
CFR Cluj,4863,2,5,7,2,16,11,5,22
D Bucuresti,4863,3,4,5,5,20,21,-1,17
FC Botosani,4863,4,4,4,6,8,15,-7,16
Universitate,4863,5,3,6,5,16,22,-6,15
Concordia Ch,4863,6,2,3,9,18,25,-7,9
FCSB,4864,1,7,6,1,23,12,11,27
CFR Cluj,4864,2,6,7,1,15,7,8,25
D Bucuresti,4864,3,4,5,5,18,18,0,17
Universitate,4864,4,4,5,5,16,20,-4,17
FC Botosani,4864,5,3,4,7,5,16,-11,13
Concordia Ch,4864,6,3,3,8,17,21,-4,12
FCSB,4865,1,9,5,0,27,10,17,32
CFR Cluj,4865,2,5,6,3,14,13,1,21
D Bucuresti,4865,3,4,5,5,19,19,0,17
Universitate,4865,4,4,5,5,17,20,-3,17
FC Botosani,4865,5,3,4,7,7,18,-11,13
Concordia Ch,4865,6,3,3,8,20,24,-4,12
FCSB,4866,1,8,5,1,25,12,13,29
CFR Cluj,4866,2,5,7,2,13,9,4,22
Universitate,4866,3,4,6,4,16,18,-2,18
FC Botosani,4866,4,4,4,6,6,15,-9,16
Concordia Ch,4866,5,4,2,8,19,21,-2,14
D Bucuresti,4866,6,3,4,7,16,20,-4,13
FCSB,4867,1,8,5,1,25,12,13,29
CFR Cluj,4867,2,6,6,2,14,8,6,24
D Bucuresti,4867,3,5,4,5,22,18,4,19
Universitate,4867,4,4,5,5,16,20,-4,17
FC Botosani,4867,5,3,5,6,7,15,-8,14
Concordia Ch,4867,6,2,3,9,17,28,-11,9
FCSB,4868,1,8,5,1,25,14,11,29
CFR Cluj,4868,2,5,7,2,14,9,5,22
Universitate,4868,3,4,6,4,19,20,-1,18
FC Botosani,4868,4,4,5,5,7,13,-6,17
D Bucuresti,4868,5,3,5,6,16,19,-3,14
Concordia Ch,4868,6,2,4,8,16,22,-6,10
FCSB,4869,1,8,5,1,24,11,13,29
CFR Cluj,4869,2,5,6,3,13,9,4,21
Universitate,4869,3,5,5,4,16,18,-2,20
FC Botosani,4869,4,5,4,5,8,12,-4,19
D Bucuresti,4869,5,4,4,6,20,22,-2,16
Concordia Ch,4869,6,2,2,10,17,26,-9,8
FCSB,4870,1,8,5,1,26,14,12,29
CFR Cluj,4870,2,5,6,3,15,11,4,21
Universitate,4870,3,5,5,4,17,18,-1,20
FC Botosani,4870,4,4,5,5,10,16,-6,17
D Bucuresti,4870,5,3,4,7,17,22,-5,13
Concordia Ch,4870,6,3,3,8,20,24,-4,12
CFR Cluj,4871,1,7,6,1,16,7,9,27
FCSB,4871,2,7,5,2,23,13,10,26
Universitate,4871,3,4,5,5,15,19,-4,17
D Bucuresti,4871,4,4,4,6,20,23,-3,16
FC Botosani,4871,5,3,5,6,8,16,-8,14
Concordia Ch,4871,6,3,3,8,19,23,-4,12
FCSB,4872,1,7,6,1,23,11,12,27
CFR Cluj,4872,2,5,7,2,13,8,5,22
Universitate,4872,3,5,5,4,16,18,-2,20
D Bucuresti,4872,4,4,4,6,17,19,-2,16
Concordia Ch,4872,5,4,2,8,17,21,-4,14
FC Botosani,4872,6,3,4,7,5,14,-9,13
FCSB,4873,1,7,5,2,24,13,11,26
CFR Cluj,4873,2,6,7,1,15,8,7,25
Universitate,4873,3,4,6,4,15,18,-3,18
D Bucuresti,4873,4,4,5,5,21,19,2,17
FC Botosani,4873,5,3,5,6,6,17,-11,14
Concordia Ch,4873,6,2,4,8,17,23,-6,10
FCSB,4874,1,7,7,0,26,13,13,28
CFR Cluj,4874,2,6,7,1,15,8,7,25
D Bucuresti,4874,3,4,4,6,19,21,-2,16
Universitate,4874,4,3,6,5,16,21,-5,15
FC Botosani,4874,5,3,5,6,6,14,-8,14
Concordia Ch,4874,6,3,3,8,17,22,-5,12
FCSB,4875,1,7,6,1,25,13,12,27
CFR Cluj,4875,2,5,8,1,16,10,6,23
Universitate,4875,3,4,6,4,16,19,-3,18
Concordia Ch,4875,4,4,2,8,22,25,-3,14
D Bucuresti,4875,5,3,5,6,21,24,-3,14
FC Botosani,4875,6,3,5,6,6,15,-9,14
CFR Cluj,4876,1,7,6,1,21,9,12,27
FCSB,4876,2,7,5,2,26,17,9,26
Universitate,4876,3,4,5,5,18,24,-6,17
D Bucuresti,4876,4,4,4,6,19,23,-4,16
Concordia Ch,4876,5,4,2,8,22,23,-1,14
FC Botosani,4876,6,3,4,7,5,15,-10,13
FCSB,4877,1,9,5,0,29,12,17,32
CFR Cluj,4877,2,6,6,2,17,12,5,24
D Bucuresti,4877,3,5,4,5,20,19,1,19
FC Botosani,4877,4,4,4,6,8,13,-5,16
Universitate,4877,5,3,5,6,17,24,-7,14
Concordia Ch,4877,6,2,2,10,16,27,-11,8
FCSB,4878,1,7,5,2,24,13,11,26
CFR Cluj,4878,2,6,6,2,14,8,6,24
Universitate,4878,3,5,5,4,17,19,-2,20
FC Botosani,4878,4,4,5,5,7,13,-6,17
D Bucuresti,4878,5,3,4,7,17,22,-5,13
Concordia Ch,4878,6,3,3,8,19,23,-4,12
FCSB,4879,1,7,6,1,24,12,12,27
CFR Cluj,4879,2,5,8,1,14,8,6,23
Universitate,4879,3,4,6,4,15,18,-3,18
D Bucuresti,4879,4,4,5,5,19,20,-1,17
FC Botosani,4879,5,3,4,7,5,14,-9,13
Concordia Ch,4879,6,3,3,8,18,23,-5,12
FCSB,4880,1,9,5,0,28,11,17,32
CFR Cluj,4880,2,5,7,2,15,12,3,22
D Bucuresti,4880,3,5,4,5,21,21,0,19
FC Botosani,4880,4,4,4,6,8,15,-7,16
Universitate,4880,5,3,6,5,17,22,-5,15
Concordia Ch,4880,6,2,2,10,18,26,-8,8
FCSB,4881,1,9,5,0,29,12,17,32
CFR Cluj,4881,2,6,6,2,18,11,7,24
D Bucuresti,4881,3,4,4,6,20,22,-2,16
Concordia Ch,4881,4,4,2,8,20,24,-4,14
Universitate,4881,5,3,5,6,17,26,-9,14
FC Botosani,4881,6,3,4,7,7,16,-9,13
FCSB,4882,1,7,6,1,24,12,12,27
CFR Cluj,4882,2,6,7,1,15,8,7,25
D Bucuresti,4882,3,4,4,6,19,21,-2,16
Universitate,4882,4,3,7,4,14,18,-4,16
FC Botosani,4882,5,4,4,6,8,15,-7,16
Concordia Ch,4882,6,3,2,9,18,24,-6,11
FCSB,4883,1,7,6,1,24,13,11,27
CFR Cluj,4883,2,7,6,1,17,8,9,27
FC Botosani,4883,3,4,5,5,8,13,-5,17
D Bucuresti,4883,4,4,4,6,19,22,-3,16
Universitate,4883,5,3,6,5,16,21,-5,15
Concordia Ch,4883,6,2,3,9,18,25,-7,9
FCSB,4884,1,8,6,0,26,12,14,30
CFR Cluj,4884,2,5,8,1,14,8,6,23
FC Botosani,4884,3,5,4,5,10,15,-5,19
Universitate,4884,4,3,6,5,15,20,-5,15
D Bucuresti,4884,5,3,4,7,18,22,-4,13
Concordia Ch,4884,6,3,2,9,17,23,-6,11
FCSB,4885,1,7,7,0,24,11,13,28
CFR Cluj,4885,2,5,8,1,14,8,6,23
FC Botosani,4885,3,5,4,5,9,12,-3,19
Universitate,4885,4,3,7,4,16,20,-4,16
D Bucuresti,4885,5,3,5,6,18,21,-3,14
Concordia Ch,4885,6,2,3,9,17,26,-9,9
FCSB,4886,1,8,5,1,25,12,13,29
CFR Cluj,4886,2,6,7,1,16,9,7,25
D Bucuresti,4886,3,5,4,5,20,19,1,19
Universitate,4886,4,3,6,5,15,20,-5,15
FC Botosani,4886,5,3,5,6,7,15,-8,14
Concordia Ch,4886,6,2,3,9,16,24,-8,9
FCSB,4887,1,8,5,1,26,14,12,29
CFR Cluj,4887,2,5,7,2,15,10,5,22
Universitate,4887,3,4,6,4,16,18,-2,18
FC Botosani,4887,4,4,5,5,7,13,-6,17
D Bucuresti,4887,5,3,4,7,18,22,-4,13
Concordia Ch,4887,6,3,3,8,17,22,-5,12
FCSB,4888,1,9,5,0,28,11,17,32
CFR Cluj,4888,2,6,6,2,16,9,7,24
D Bucuresti,4888,3,4,4,6,19,23,-4,16
Concordia Ch,4888,4,4,2,8,21,21,0,14
Universitate,4888,5,3,5,6,14,23,-9,14
FC Botosani,4888,6,3,4,7,6,17,-11,13
FCSB,4889,1,8,5,1,28,15,13,29
CFR Cluj,4889,2,7,6,1,16,8,8,27
D Bucuresti,4889,3,5,4,5,21,19,2,19
FC Botosani,4889,4,4,4,6,7,14,-7,16
Universitate,4889,5,3,5,6,17,23,-6,14
Concordia Ch,4889,6,2,2,10,16,26,-10,8
FCSB,4890,1,9,5,0,28,13,15,32
CFR Cluj,4890,2,6,6,2,18,12,6,24
D Bucuresti,4890,3,4,5,5,20,20,0,17
Universitate,4890,4,3,5,6,15,21,-6,14
FC Botosani,4890,5,3,5,6,6,15,-9,14
Concordia Ch,4890,6,2,4,8,18,24,-6,10
FCSB,4891,1,8,5,1,26,13,13,29
CFR Cluj,4891,2,6,6,2,16,11,5,24
D Bucuresti,4891,3,4,5,5,18,19,-1,17
Universitate,4891,4,4,5,5,18,21,-3,17
FC Botosani,4891,5,3,6,5,8,15,-7,15
Concordia Ch,4891,6,2,3,9,17,24,-7,9
FCSB,4892,1,8,5,1,26,15,11,29
CFR Cluj,4892,2,6,6,2,16,9,7,24
Universitate,4892,3,4,5,5,18,21,-3,17
D Bucuresti,4892,4,4,4,6,19,22,-3,16
FC Botosani,4892,5,3,5,6,7,16,-9,14
Concordia Ch,4892,6,3,3,8,19,22,-3,12
FCSB,4893,1,7,6,1,25,14,11,27
CFR Cluj,4893,2,6,7,1,15,7,8,25
Universitate,4893,3,4,5,5,18,22,-4,17
D Bucuresti,4893,4,4,4,6,20,20,0,16
FC Botosani,4893,5,4,4,6,8,16,-8,16
Concordia Ch,4893,6,3,2,9,16,23,-7,11
FCSB,4894,1,8,6,0,26,11,15,30
CFR Cluj,4894,2,5,7,2,13,9,4,22
D Bucuresti,4894,3,4,4,6,18,21,-3,16
Universitate,4894,4,3,7,4,15,19,-4,16
Concordia Ch,4894,5,4,2,8,19,22,-3,14
FC Botosani,4894,6,3,4,7,5,14,-9,13
FCSB,4895,1,8,5,1,27,15,12,29
CFR Cluj,4895,2,5,7,2,16,11,5,22
FC Botosani,4895,3,5,4,5,11,13,-2,19
Universitate,4895,4,4,6,4,18,20,-2,18
D Bucuresti,4895,5,3,5,6,18,23,-5,14
Concordia Ch,4895,6,2,3,9,18,26,-8,9
FCSB,4896,1,8,5,1,24,12,12,29
CFR Cluj,4896,2,5,6,3,14,10,4,21
Universitate,4896,3,5,5,4,18,19,-1,20
D Bucuresti,4896,4,3,6,5,18,20,-2,15
FC Botosani,4896,5,3,6,5,7,14,-7,15
Concordia Ch,4896,6,2,4,8,19,25,-6,10
FCSB,4897,1,8,5,1,26,13,13,29
CFR Cluj,4897,2,5,7,2,14,9,5,22
Universitate,4897,3,4,6,4,18,21,-3,18
FC Botosani,4897,4,4,5,5,7,13,-6,17
D Bucuresti,4897,5,3,6,5,18,20,-2,15
Concordia Ch,4897,6,2,3,9,18,25,-7,9
FCSB,4898,1,8,5,1,27,13,14,29
CFR Cluj,4898,2,6,7,1,15,8,7,25
D Bucuresti,4898,3,4,5,5,18,19,-1,17
Universitate,4898,4,3,6,5,15,21,-6,15
FC Botosani,4898,5,3,6,5,5,12,-7,15
Concordia Ch,4898,6,2,3,9,16,23,-7,9
FCSB,4899,1,8,6,0,27,12,15,30
CFR Cluj,4899,2,6,7,1,17,7,10,25
D Bucuresti,4899,3,4,4,6,17,19,-2,16
FC Botosani,4899,4,4,4,6,7,14,-7,16
Universitate,4899,5,3,5,6,16,26,-10,14
Concordia Ch,4899,6,3,2,9,17,23,-6,11
FCSB,4900,1,7,6,1,24,13,11,27
CFR Cluj,4900,2,7,6,1,17,8,9,27
D Bucuresti,4900,3,4,5,5,17,18,-1,17
FC Botosani,4900,4,4,5,5,6,12,-6,17
Universitate,4900,5,3,6,5,14,19,-5,15
Concordia Ch,4900,6,2,2,10,15,23,-8,8
FCSB,4901,1,8,5,1,26,16,10,29
CFR Cluj,4901,2,6,6,2,20,10,10,24
D Bucuresti,4901,3,4,5,5,18,19,-1,17
Universitate,4901,4,4,5,5,20,25,-5,17
FC Botosani,4901,5,3,5,6,7,15,-8,14
Concordia Ch,4901,6,2,4,8,18,24,-6,10
FCSB,4902,1,7,6,1,25,13,12,27
CFR Cluj,4902,2,7,6,1,18,8,10,27
FC Botosani,4902,3,4,5,5,9,15,-6,17
D Bucuresti,4902,4,4,4,6,21,21,0,16
Universitate,4902,5,3,6,5,15,22,-7,15
Concordia Ch,4902,6,2,3,9,18,27,-9,9
FCSB,4903,1,8,6,0,24,10,14,30
CFR Cluj,4903,2,5,6,3,13,9,4,21
Universitate,4903,3,4,6,4,15,18,-3,18
FC Botosani,4903,4,3,6,5,5,12,-7,15
D Bucuresti,4903,5,3,5,6,17,22,-5,14
Concordia Ch,4903,6,3,3,8,19,22,-3,12
FCSB,4904,1,7,5,2,25,15,10,26
CFR Cluj,4904,2,6,6,2,15,9,6,24
Universitate,4904,3,5,5,4,18,19,-1,20
D Bucuresti,4904,4,4,4,6,18,24,-6,16
Concordia Ch,4904,5,4,2,8,22,21,1,14
FC Botosani,4904,6,3,4,7,6,16,-10,13
FCSB,4905,1,7,7,0,25,12,13,28
CFR Cluj,4905,2,6,7,1,15,8,7,25
D Bucuresti,4905,3,5,4,5,20,20,0,19
Universitate,4905,4,3,6,5,17,22,-5,15
FC Botosani,4905,5,3,5,6,7,15,-8,14
Concordia Ch,4905,6,2,3,9,17,24,-7,9
FCSB,4906,1,7,6,1,25,14,11,27
CFR Cluj,4906,2,5,8,1,14,8,6,23
Universitate,4906,3,4,6,4,17,19,-2,18
D Bucuresti,4906,4,4,5,5,18,19,-1,17
FC Botosani,4906,5,3,5,6,7,15,-8,14
Concordia Ch,4906,6,2,4,8,18,24,-6,10
FCSB,4907,1,8,6,0,27,13,14,30
CFR Cluj,4907,2,5,7,2,15,11,4,22
Universitate,4907,3,4,5,5,17,20,-3,17
FC Botosani,4907,4,4,5,5,9,14,-5,17
D Bucuresti,4907,5,3,5,6,20,23,-3,14
Concordia Ch,4907,6,3,2,9,18,25,-7,11
FCSB,4908,1,8,6,0,27,11,16,30
CFR Cluj,4908,2,5,7,2,14,11,3,22
D Bucuresti,4908,3,4,5,5,19,19,0,17
Universitate,4908,4,3,7,4,16,20,-4,16
FC Botosani,4908,5,3,5,6,5,14,-9,14
Concordia Ch,4908,6,2,4,8,16,22,-6,10
FCSB,4909,1,9,5,0,26,11,15,32
CFR Cluj,4909,2,6,6,2,15,8,7,24
FC Botosani,4909,3,4,5,5,11,13,-2,17
D Bucuresti,4909,4,3,5,6,17,23,-6,14
Universitate,4909,5,3,5,6,15,22,-7,14
Concordia Ch,4909,6,3,2,9,19,26,-7,11
FCSB,4910,1,7,6,1,24,13,11,27
CFR Cluj,4910,2,7,6,1,16,7,9,27
FC Botosani,4910,3,4,4,6,7,16,-9,16
Universitate,4910,4,3,6,5,15,20,-5,15
Concordia Ch,4910,5,4,2,8,21,23,-2,14
D Bucuresti,4910,6,3,4,7,19,23,-4,13
FCSB,4911,1,8,5,1,24,12,12,29
CFR Cluj,4911,2,6,6,2,16,8,8,24
D Bucuresti,4911,3,4,5,5,20,21,-1,17
Universitate,4911,4,4,5,5,16,21,-5,17
FC Botosani,4911,5,3,5,6,7,16,-9,14
Concordia Ch,4911,6,3,2,9,18,23,-5,11
FCSB,4912,1,7,5,2,23,15,8,26
CFR Cluj,4912,2,6,7,1,17,8,9,25
Universitate,4912,3,4,6,4,17,19,-2,18
D Bucuresti,4912,4,4,4,6,17,21,-4,16
FC Botosani,4912,5,3,5,6,5,13,-8,14
Concordia Ch,4912,6,3,3,8,18,21,-3,12
FCSB,4913,1,8,5,1,28,15,13,29
CFR Cluj,4913,2,6,6,2,14,8,6,24
D Bucuresti,4913,3,4,5,5,18,19,-1,17
Universitate,4913,4,4,5,5,19,23,-4,17
FC Botosani,4913,5,4,5,5,9,13,-4,17
Concordia Ch,4913,6,2,2,10,15,25,-10,8
FCSB,4914,1,7,6,1,24,13,11,27
CFR Cluj,4914,2,7,6,1,18,8,10,27
D Bucuresti,4914,3,4,4,6,18,20,-2,16
FC Botosani,4914,4,4,4,6,7,14,-7,16
Universitate,4914,5,3,6,5,14,20,-6,15
Concordia Ch,4914,6,3,2,9,18,24,-6,11
FCSB,4915,1,7,6,1,25,15,10,27
CFR Cluj,4915,2,6,7,1,23,10,13,25
Universitate,4915,3,4,5,5,18,26,-8,17
D Bucuresti,4915,4,3,6,5,16,18,-2,15
FC Botosani,4915,5,3,6,5,8,15,-7,15
Concordia Ch,4915,6,2,4,8,18,24,-6,10
FCSB,4916,1,7,5,2,23,12,11,26
CFR Cluj,4916,2,6,6,2,14,10,4,24
Universitate,4916,3,5,5,4,18,18,0,20
FC Botosani,4916,4,4,5,5,8,14,-6,17
D Bucuresti,4916,5,3,5,6,17,20,-3,14
Concordia Ch,4916,6,2,4,8,16,22,-6,10
FCSB,4917,1,9,5,0,25,10,15,32
CFR Cluj,4917,2,5,7,2,14,9,5,22
FC Botosani,4917,3,5,4,5,8,12,-4,19
Universitate,4917,4,3,6,5,15,20,-5,15
D Bucuresti,4917,5,3,4,7,16,20,-4,13
Concordia Ch,4917,6,3,2,9,16,23,-7,11
FCSB,4918,1,9,5,0,28,10,18,32
CFR Cluj,4918,2,5,6,3,13,11,2,21
Universitate,4918,3,4,5,5,16,21,-5,17
FC Botosani,4918,4,4,5,5,9,14,-5,17
D Bucuresti,4918,5,3,6,5,18,20,-2,15
Concordia Ch,4918,6,2,3,9,19,27,-8,9
FCSB,4919,1,8,6,0,28,13,15,30
CFR Cluj,4919,2,6,6,2,16,11,5,24
D Bucuresti,4919,3,4,4,6,17,19,-2,16
Universitate,4919,4,3,6,5,15,20,-5,15
Concordia Ch,4919,5,4,2,8,17,21,-4,14
FC Botosani,4919,6,3,4,7,5,14,-9,13
FCSB,4920,1,7,5,2,23,14,9,26
CFR Cluj,4920,2,6,6,2,14,8,6,24
Universitate,4920,3,5,5,4,18,18,0,20
D Bucuresti,4920,4,3,6,5,17,19,-2,15
FC Botosani,4920,5,3,6,5,5,12,-7,15
Concordia Ch,4920,6,2,4,8,16,22,-6,10
CFR Cluj,4921,1,7,6,1,20,7,13,27
FCSB,4921,2,7,6,1,25,15,10,27
FC Botosani,4921,3,4,5,5,6,12,-6,17
Universitate,4921,4,3,6,5,16,24,-8,15
D Bucuresti,4921,5,3,5,6,16,19,-3,14
Concordia Ch,4921,6,3,2,9,16,22,-6,11
FCSB,4922,1,8,5,1,25,12,13,29
CFR Cluj,4922,2,5,7,2,14,9,5,22
Universitate,4922,3,4,6,4,17,20,-3,18
FC Botosani,4922,4,4,5,5,6,12,-6,17
D Bucuresti,4922,5,4,4,6,18,20,-2,16
Concordia Ch,4922,6,2,3,9,16,23,-7,9
FCSB,4923,1,9,5,0,29,11,18,32
CFR Cluj,4923,2,5,6,3,13,11,2,21
Universitate,4923,3,4,5,5,16,21,-5,17
D Bucuresti,4923,4,4,4,6,20,20,0,16
FC Botosani,4923,5,3,5,6,7,17,-10,14
Concordia Ch,4923,6,3,3,8,19,24,-5,12
FCSB,4924,1,9,5,0,26,10,16,32
CFR Cluj,4924,2,6,6,2,15,8,7,24
D Bucuresti,4924,3,4,4,6,18,20,-2,16
FC Botosani,4924,4,4,4,6,8,15,-7,16
Universitate,4924,5,3,5,6,14,22,-8,14
Concordia Ch,4924,6,3,2,9,17,23,-6,11
FCSB,4925,1,8,5,1,26,13,13,29
CFR Cluj,4925,2,5,7,2,14,10,4,22
Universitate,4925,3,4,6,4,18,20,-2,18
D Bucuresti,4925,4,4,5,5,21,20,1,17
FC Botosani,4925,5,3,6,5,7,14,-7,15
Concordia Ch,4925,6,2,3,9,17,26,-9,9
FCSB,4926,1,8,5,1,26,11,15,29
CFR Cluj,4926,2,5,6,3,14,12,2,21
Universitate,4926,3,5,5,4,17,19,-2,20
FC Botosani,4926,4,4,5,5,10,15,-5,17
D Bucuresti,4926,5,3,5,6,17,21,-4,14
Concordia Ch,4926,6,2,4,8,19,25,-6,10
FCSB,4927,1,8,6,0,25,10,15,30
CFR Cluj,4927,2,6,6,2,14,9,5,24
FC Botosani,4927,3,4,4,6,8,15,-7,16
Universitate,4927,4,3,6,5,14,19,-5,15
Concordia Ch,4927,5,4,2,8,19,22,-3,14
D Bucuresti,4927,6,3,4,7,16,21,-5,13
FCSB,4928,1,7,5,2,26,16,10,26
CFR Cluj,4928,2,6,6,2,18,13,5,24
Universitate,4928,3,5,5,4,20,20,0,20
D Bucuresti,4928,4,3,6,5,18,20,-2,15
FC Botosani,4928,5,3,5,6,5,13,-8,14
Concordia Ch,4928,6,3,3,8,18,23,-5,12
FCSB,4929,1,8,6,0,26,12,14,30
CFR Cluj,4929,2,6,7,1,15,8,7,25
D Bucuresti,4929,3,4,5,5,20,19,1,17
Universitate,4929,4,3,5,6,17,23,-6,14
FC Botosani,4929,5,3,5,6,5,15,-10,14
Concordia Ch,4929,6,2,4,8,16,22,-6,10
FCSB,4930,1,7,6,1,24,12,12,27
CFR Cluj,4930,2,5,8,1,13,7,6,23
Universitate,4930,3,4,6,4,16,19,-3,18
FC Botosani,4930,4,4,5,5,6,12,-6,17
D Bucuresti,4930,5,3,4,7,18,22,-4,13
Concordia Ch,4930,6,3,3,8,18,23,-5,12
FCSB,4931,1,8,5,1,25,13,12,29
CFR Cluj,4931,2,5,7,2,14,9,5,22
Universitate,4931,3,4,6,4,16,18,-2,18
D Bucuresti,4931,4,4,5,5,19,20,-1,17
FC Botosani,4931,5,3,5,6,5,13,-8,14
Concordia Ch,4931,6,2,4,8,17,23,-6,10
FCSB,4932,1,8,5,1,28,13,15,29
CFR Cluj,4932,2,7,6,1,15,7,8,27
D Bucuresti,4932,3,4,5,5,19,20,-1,17
FC Botosani,4932,4,3,6,5,7,14,-7,15
Universitate,4932,5,3,5,6,16,24,-8,14
Concordia Ch,4932,6,2,3,9,17,24,-7,9
FCSB,4933,1,8,6,0,24,10,14,30
CFR Cluj,4933,2,6,6,2,16,10,6,24
D Bucuresti,4933,3,4,4,6,19,20,-1,16
FC Botosani,4933,4,4,4,6,9,14,-5,16
Universitate,4933,5,3,6,5,16,21,-5,15
Concordia Ch,4933,6,3,2,9,17,26,-9,11
FCSB,4934,1,7,6,1,25,13,12,27
CFR Cluj,4934,2,6,7,1,15,8,7,25
FC Botosani,4934,3,4,5,5,9,12,-3,17
Universitate,4934,4,3,7,4,15,19,-4,16
D Bucuresti,4934,5,3,6,5,17,19,-2,15
Concordia Ch,4934,6,2,3,9,16,26,-10,9
FCSB,4935,1,7,7,0,27,14,13,28
CFR Cluj,4935,2,5,7,2,16,12,4,22
Universitate,4935,3,4,6,4,19,21,-2,18
FC Botosani,4935,4,4,5,5,7,13,-6,17
D Bucuresti,4935,5,3,6,5,18,20,-2,15
Concordia Ch,4935,6,2,3,9,16,23,-7,9
FCSB,4936,1,7,6,1,24,12,12,27
CFR Cluj,4936,2,6,7,1,15,8,7,25
D Bucuresti,4936,3,5,4,5,21,21,0,19
Universitate,4936,4,3,7,4,14,18,-4,16
FC Botosani,4936,5,4,4,6,9,15,-6,16
Concordia Ch,4936,6,2,2,10,16,25,-9,8
FCSB,4937,1,8,5,1,27,14,13,29
CFR Cluj,4937,2,5,7,2,15,10,5,22
D Bucuresti,4937,3,5,4,5,21,19,2,19
Universitate,4937,4,4,6,4,18,21,-3,18
FC Botosani,4937,5,3,5,6,6,15,-9,14
Concordia Ch,4937,6,2,3,9,15,23,-8,9
FCSB,4938,1,8,5,1,24,11,13,29
CFR Cluj,4938,2,6,6,2,15,11,4,24
Universitate,4938,3,4,5,5,18,20,-2,17
D Bucuresti,4938,4,3,6,5,18,20,-2,15
FC Botosani,4938,5,3,6,5,6,13,-7,15
Concordia Ch,4938,6,2,4,8,16,22,-6,10
FCSB,4939,1,7,7,0,23,10,13,28
CFR Cluj,4939,2,6,7,1,16,7,9,25
D Bucuresti,4939,3,4,4,6,18,21,-3,16
Universitate,4939,4,3,6,5,14,21,-7,15
Concordia Ch,4939,5,4,2,8,18,21,-3,14
FC Botosani,4939,6,3,4,7,6,15,-9,13
CFR Cluj,4940,1,7,6,1,17,8,9,27
FCSB,4940,2,7,5,2,25,14,11,26
Universitate,4940,3,4,5,5,16,21,-5,17
D Bucuresti,4940,4,4,4,6,18,19,-1,16
FC Botosani,4940,5,4,4,6,7,15,-8,16
Concordia Ch,4940,6,3,2,9,17,23,-6,11
FCSB,4941,1,8,5,1,24,11,13,29
CFR Cluj,4941,2,6,6,2,16,10,6,24
Universitate,4941,3,4,5,5,17,21,-4,17
FC Botosani,4941,4,4,5,5,7,13,-6,17
D Bucuresti,4941,5,3,4,7,17,21,-4,13
Concordia Ch,4941,6,3,3,8,18,23,-5,12
FCSB,4942,1,8,6,0,28,14,14,30
CFR Cluj,4942,2,5,7,2,17,12,5,22
D Bucuresti,4942,3,4,4,6,18,20,-2,16
Universitate,4942,4,3,7,4,18,22,-4,16
FC Botosani,4942,5,4,4,6,6,13,-7,16
Concordia Ch,4942,6,3,2,9,17,23,-6,11
FCSB,4943,1,9,5,0,30,12,18,32
CFR Cluj,4943,2,5,7,2,17,13,4,22
FC Botosani,4943,3,5,4,5,10,12,-2,19
D Bucuresti,4943,4,4,4,6,18,20,-2,16
Universitate,4943,5,3,6,5,16,23,-7,15
Concordia Ch,4943,6,2,2,10,16,27,-11,8
FCSB,4944,1,8,6,0,26,11,15,30
CFR Cluj,4944,2,6,6,2,15,9,6,24
D Bucuresti,4944,3,4,4,6,19,23,-4,16
Universitate,4944,4,3,6,5,15,21,-6,15
Concordia Ch,4944,5,4,2,8,21,22,-1,14
FC Botosani,4944,6,3,4,7,5,15,-10,13
FCSB,4945,1,8,6,0,26,11,15,30
CFR Cluj,4945,2,6,6,2,14,9,5,24
Universitate,4945,3,3,6,5,15,20,-5,15
D Bucuresti,4945,4,3,5,6,18,21,-3,14
Concordia Ch,4945,5,4,2,8,19,23,-4,14
FC Botosani,4945,6,3,5,6,7,15,-8,14
FCSB,4946,1,8,5,1,24,11,13,29
CFR Cluj,4946,2,5,6,3,13,10,3,21
Universitate,4946,3,5,5,4,17,18,-1,20
D Bucuresti,4946,4,4,5,5,18,19,-1,17
FC Botosani,4946,5,3,5,6,6,14,-8,14
Concordia Ch,4946,6,2,4,8,17,23,-6,10
FCSB,4947,1,7,6,1,25,13,12,27
CFR Cluj,4947,2,6,6,2,15,9,6,24
D Bucuresti,4947,3,5,4,5,21,19,2,19
Universitate,4947,4,4,6,4,16,19,-3,18
FC Botosani,4947,5,3,5,6,6,15,-9,14
Concordia Ch,4947,6,2,3,9,17,25,-8,9
FCSB,4948,1,8,6,0,28,14,14,30
CFR Cluj,4948,2,5,7,2,16,11,5,22
D Bucuresti,4948,3,5,4,5,19,19,0,19
Universitate,4948,4,3,7,4,17,21,-4,16
FC Botosani,4948,5,3,4,7,5,14,-9,13
Concordia Ch,4948,6,3,2,9,17,23,-6,11
FCSB,4949,1,9,5,0,27,11,16,32
CFR Cluj,4949,2,6,6,2,16,9,7,24
D Bucuresti,4949,3,3,6,5,17,19,-2,15
Universitate,4949,4,3,5,6,14,22,-8,14
FC Botosani,4949,5,3,5,6,6,14,-8,14
Concordia Ch,4949,6,3,3,8,16,21,-5,12
FCSB,4950,1,8,6,0,28,11,17,30
CFR Cluj,4950,2,6,7,1,17,8,9,25
D Bucuresti,4950,3,3,6,5,18,20,-2,15
FC Botosani,4950,4,3,5,6,6,14,-8,14
Universitate,4950,5,3,5,6,14,25,-11,14
Concordia Ch,4950,6,3,3,8,17,22,-5,12
FCSB,4951,1,8,5,1,27,14,13,29
CFR Cluj,4951,2,7,6,1,17,7,10,27
D Bucuresti,4951,3,4,5,5,18,19,-1,17
FC Botosani,4951,4,4,4,6,7,14,-7,16
Universitate,4951,5,3,5,6,15,23,-8,14
Concordia Ch,4951,6,2,3,9,17,24,-7,9
FCSB,4952,1,7,6,1,25,15,10,27
CFR Cluj,4952,2,5,8,1,17,11,6,23
D Bucuresti,4952,3,5,4,5,20,19,1,19
Universitate,4952,4,4,6,4,19,20,-1,18
FC Botosani,4952,5,4,4,6,7,15,-8,16
Concordia Ch,4952,6,2,2,10,15,23,-8,8
FCSB,4953,1,7,5,2,23,12,11,26
CFR Cluj,4953,2,6,7,1,15,8,7,25
Universitate,4953,3,4,6,4,16,19,-3,18
FC Botosani,4953,4,4,4,6,7,14,-7,16
Concordia Ch,4953,5,4,2,8,17,21,-4,14
D Bucuresti,4953,6,3,4,7,17,21,-4,13
FCSB,4954,1,8,6,0,25,11,14,30
CFR Cluj,4954,2,6,7,1,16,9,7,25
FC Botosani,4954,3,4,4,6,8,16,-8,16
Concordia Ch,4954,4,4,2,8,20,22,-2,14
Universitate,4954,5,3,5,6,15,21,-6,14
D Bucuresti,4954,6,3,4,7,18,23,-5,13
FCSB,4955,1,9,5,0,30,12,18,32
CFR Cluj,4955,2,5,7,2,15,10,5,22
Universitate,4955,3,3,6,5,14,22,-8,15
Concordia Ch,4955,4,4,2,8,19,21,-2,14
D Bucuresti,4955,5,3,5,6,18,22,-4,14
FC Botosani,4955,6,3,5,6,7,16,-9,14
FCSB,4956,1,8,5,1,24,11,13,29
CFR Cluj,4956,2,7,6,1,16,7,9,27
D Bucuresti,4956,3,4,5,5,22,20,2,17
Universitate,4956,4,3,5,6,14,21,-7,14
FC Botosani,4956,5,3,4,7,6,19,-13,13
Concordia Ch,4956,6,3,3,8,18,22,-4,12
FCSB,4957,1,9,5,0,28,11,17,32
CFR Cluj,4957,2,5,7,2,15,10,5,22
D Bucuresti,4957,3,4,5,5,21,20,1,17
FC Botosani,4957,4,4,5,5,11,14,-3,17
Universitate,4957,5,3,6,5,15,22,-7,15
Concordia Ch,4957,6,2,2,10,15,28,-13,8
CFR Cluj,4958,1,7,6,1,17,7,10,27
FCSB,4958,2,7,5,2,25,14,11,26
D Bucuresti,4958,3,4,5,5,18,19,-1,17
FC Botosani,4958,4,4,5,5,10,14,-4,17
Universitate,4958,5,4,5,5,17,23,-6,17
Concordia Ch,4958,6,2,2,10,16,26,-10,8
FCSB,4959,1,8,6,0,25,11,14,30
CFR Cluj,4959,2,6,6,2,17,10,7,24
D Bucuresti,4959,3,4,5,5,18,19,-1,17
Universitate,4959,4,3,6,5,15,21,-6,15
FC Botosani,4959,5,3,6,5,5,12,-7,15
Concordia Ch,4959,6,2,3,9,16,23,-7,9
FCSB,4960,1,8,6,0,26,10,16,30
CFR Cluj,4960,2,6,7,1,15,8,7,25
D Bucuresti,4960,3,4,4,6,20,23,-3,16
Universitate,4960,4,3,5,6,15,23,-8,14
FC Botosani,4960,5,3,5,6,6,15,-9,14
Concordia Ch,4960,6,3,3,8,21,24,-3,12
FCSB,4961,1,7,6,1,27,17,10,27
CFR Cluj,4961,2,6,7,1,16,9,7,25
D Bucuresti,4961,3,4,5,5,19,19,0,17
Universitate,4961,4,4,5,5,21,23,-2,17
FC Botosani,4961,5,4,5,5,9,14,-5,17
Concordia Ch,4961,6,2,2,10,16,26,-10,8
FCSB,4962,1,8,5,1,27,12,15,29
CFR Cluj,4962,2,7,6,1,17,9,8,27
D Bucuresti,4962,3,4,4,6,18,19,-1,16
Universitate,4962,4,3,5,6,15,23,-8,14
FC Botosani,4962,5,3,5,6,6,15,-9,14
Concordia Ch,4962,6,3,3,8,17,22,-5,12
FCSB,4963,1,8,5,1,24,11,13,29
CFR Cluj,4963,2,5,7,2,15,10,5,22
Universitate,4963,3,4,6,4,17,20,-3,18
D Bucuresti,4963,4,3,6,5,16,18,-2,15
FC Botosani,4963,5,3,6,5,5,12,-7,15
Concordia Ch,4963,6,2,4,8,15,21,-6,10
FCSB,4964,1,8,6,0,27,11,16,30
CFR Cluj,4964,2,5,7,2,14,11,3,22
FC Botosani,4964,3,5,4,5,8,12,-4,19
Universitate,4964,4,3,7,4,14,18,-4,16
D Bucuresti,4964,5,3,4,7,16,21,-5,13
Concordia Ch,4964,6,3,2,9,16,22,-6,11
FCSB,4965,1,8,6,0,27,11,16,30
CFR Cluj,4965,2,6,6,2,17,12,5,24
Universitate,4965,3,3,6,5,15,21,-6,15
D Bucuresti,4965,4,3,5,6,17,20,-3,14
Concordia Ch,4965,5,4,2,8,17,21,-4,14
FC Botosani,4965,6,3,5,6,6,14,-8,14
FCSB,4966,1,8,5,1,24,11,13,29
CFR Cluj,4966,2,5,7,2,14,9,5,22
Universitate,4966,3,4,6,4,16,19,-3,18
D Bucuresti,4966,4,4,4,6,20,20,0,16
FC Botosani,4966,5,4,4,6,8,16,-8,16
Concordia Ch,4966,6,3,2,9,18,25,-7,11
FCSB,4967,1,8,5,1,25,13,12,29
CFR Cluj,4967,2,5,7,2,13,8,5,22
Universitate,4967,3,4,6,4,17,19,-2,18
FC Botosani,4967,4,4,4,6,7,14,-7,16
Concordia Ch,4967,5,4,2,8,19,21,-2,14
D Bucuresti,4967,6,3,4,7,17,23,-6,13
FCSB,4968,1,7,6,1,23,11,12,27
CFR Cluj,4968,2,6,7,1,15,8,7,25
D Bucuresti,4968,3,4,5,5,18,19,-1,17
Universitate,4968,4,4,5,5,16,20,-4,17
FC Botosani,4968,5,4,4,6,7,14,-7,16
Concordia Ch,4968,6,2,3,9,15,22,-7,9
FCSB,4969,1,7,7,0,25,12,13,28
CFR Cluj,4969,2,6,7,1,18,8,10,25
D Bucuresti,4969,3,4,4,6,18,19,-1,16
Universitate,4969,4,3,6,5,15,23,-8,15
FC Botosani,4969,5,3,5,6,6,15,-9,14
Concordia Ch,4969,6,3,3,8,17,22,-5,12
FCSB,4970,1,7,6,1,24,13,11,27
CFR Cluj,4970,2,5,8,1,14,8,6,23
Universitate,4970,3,4,6,4,16,18,-2,18
D Bucuresti,4970,4,4,5,5,19,19,0,17
FC Botosani,4970,5,3,6,5,7,14,-7,15
Concordia Ch,4970,6,2,3,9,16,24,-8,9
FCSB,4971,1,7,6,1,23,11,12,27
CFR Cluj,4971,2,6,7,1,17,7,10,25
D Bucuresti,4971,3,4,5,5,18,19,-1,17
Universitate,4971,4,4,5,5,15,22,-7,17
FC Botosani,4971,5,3,4,7,6,15,-9,13
Concordia Ch,4971,6,3,3,8,16,21,-5,12
FCSB,4972,1,8,5,1,27,16,11,29
CFR Cluj,4972,2,5,6,3,14,12,2,21
Universitate,4972,3,5,5,4,20,18,2,20
D Bucuresti,4972,4,4,5,5,19,20,-1,17
FC Botosani,4972,5,4,4,6,9,14,-5,16
Concordia Ch,4972,6,2,3,9,16,25,-9,9
FCSB,4973,1,8,5,1,28,14,14,29
CFR Cluj,4973,2,5,7,2,15,12,3,22
D Bucuresti,4973,3,5,4,5,21,19,2,19
Universitate,4973,4,4,6,4,16,18,-2,18
FC Botosani,4973,5,3,5,6,6,14,-8,14
Concordia Ch,4973,6,2,3,9,15,24,-9,9
FCSB,4974,1,7,7,0,23,10,13,28
CFR Cluj,4974,2,6,7,1,17,8,9,25
FC Botosani,4974,3,4,5,5,7,13,-6,17
Universitate,4974,4,3,6,5,15,22,-7,15
D Bucuresti,4974,5,3,4,7,17,21,-4,13
Concordia Ch,4974,6,3,3,8,18,23,-5,12
FCSB,4975,1,7,6,1,23,12,11,27
CFR Cluj,4975,2,6,7,1,14,7,7,25
D Bucuresti,4975,3,4,5,5,19,20,-1,17
Universitate,4975,4,4,5,5,16,19,-3,17
FC Botosani,4975,5,4,4,6,6,13,-7,16
Concordia Ch,4975,6,2,3,9,17,24,-7,9
CFR Cluj,4976,1,7,6,1,17,9,8,27
FCSB,4976,2,7,5,2,26,16,10,26
D Bucuresti,4976,3,5,4,5,23,22,1,19
Universitate,4976,4,4,5,5,17,20,-3,17
FC Botosani,4976,5,4,4,6,8,15,-7,16
Concordia Ch,4976,6,2,2,10,19,28,-9,8
FCSB,4977,1,8,5,1,25,12,13,29
CFR Cluj,4977,2,7,6,1,16,8,8,27
D Bucuresti,4977,3,4,4,6,18,20,-2,16
FC Botosani,4977,4,4,4,6,6,14,-8,16
Universitate,4977,5,3,5,6,16,22,-6,14
Concordia Ch,4977,6,3,2,9,17,22,-5,11
FCSB,4978,1,8,5,1,26,14,12,29
CFR Cluj,4978,2,6,6,2,16,9,7,24
FC Botosani,4978,3,5,4,5,7,12,-5,19
Universitate,4978,4,4,5,5,18,22,-4,17
D Bucuresti,4978,5,3,4,7,17,21,-4,13
Concordia Ch,4978,6,3,2,9,17,23,-6,11
FCSB,4979,1,7,6,1,26,14,12,27
CFR Cluj,4979,2,5,7,2,15,10,5,22
Universitate,4979,3,5,5,4,17,19,-2,20
D Bucuresti,4979,4,4,5,5,18,19,-1,17
FC Botosani,4979,5,3,4,7,5,15,-10,13
Concordia Ch,4979,6,3,3,8,18,22,-4,12
FCSB,4980,1,8,6,0,25,11,14,30
CFR Cluj,4980,2,5,7,2,15,11,4,22
D Bucuresti,4980,3,5,4,5,19,19,0,19
Universitate,4980,4,4,5,5,17,20,-3,17
FC Botosani,4980,5,3,4,7,6,15,-9,13
Concordia Ch,4980,6,3,2,9,16,22,-6,11
FCSB,4981,1,7,7,0,26,13,13,28
CFR Cluj,4981,2,5,8,1,15,9,6,23
FC Botosani,4981,3,4,5,5,7,12,-5,17
Universitate,4981,4,3,7,4,17,21,-4,16
D Bucuresti,4981,5,3,5,6,16,20,-4,14
Concordia Ch,4981,6,2,4,8,15,21,-6,10
FCSB,4982,1,8,6,0,27,12,15,30
CFR Cluj,4982,2,5,7,2,13,8,5,22
D Bucuresti,4982,3,4,5,5,17,18,-1,17
FC Botosani,4982,4,4,5,5,10,13,-3,17
Universitate,4982,5,4,5,5,17,22,-5,17
Concordia Ch,4982,6,2,2,10,16,27,-11,8
FCSB,4983,1,9,5,0,28,10,18,32
CFR Cluj,4983,2,6,6,2,14,9,5,24
D Bucuresti,4983,3,4,5,5,18,18,0,17
FC Botosani,4983,4,4,4,6,7,15,-8,16
Universitate,4983,5,3,5,6,14,22,-8,14
Concordia Ch,4983,6,2,3,9,16,23,-7,9
FCSB,4984,1,7,5,2,24,15,9,26
CFR Cluj,4984,2,6,7,1,18,9,9,25
Universitate,4984,3,4,6,4,18,21,-3,18
D Bucuresti,4984,4,4,5,5,21,19,2,17
FC Botosani,4984,5,4,4,6,6,16,-10,16
Concordia Ch,4984,6,2,3,9,16,23,-7,9
FCSB,4985,1,9,5,0,28,12,16,32
CFR Cluj,4985,2,6,6,2,15,9,6,24
D Bucuresti,4985,3,4,5,5,18,18,0,17
FC Botosani,4985,4,4,5,5,8,14,-6,17
Universitate,4985,5,3,5,6,15,22,-7,14
Concordia Ch,4985,6,2,2,10,17,26,-9,8
FCSB,4986,1,7,7,0,24,11,13,28
CFR Cluj,4986,2,6,7,1,15,7,8,25
D Bucuresti,4986,3,4,4,6,17,24,-7,16
Universitate,4986,4,3,6,5,15,21,-6,15
FC Botosani,4986,5,3,5,6,5,13,-8,14
Concordia Ch,4986,6,3,3,8,21,21,0,12
FCSB,4987,1,7,5,2,23,15,8,26
CFR Cluj,4987,2,6,6,2,15,9,6,24
Universitate,4987,3,5,5,4,19,18,1,20
Concordia Ch,4987,4,4,2,8,20,21,-1,14
D Bucuresti,4987,5,3,5,6,17,23,-6,14
FC Botosani,4987,6,3,5,6,6,14,-8,14
FCSB,4988,1,7,6,1,24,13,11,27
CFR Cluj,4988,2,6,7,1,17,8,9,25
D Bucuresti,4988,3,5,4,5,18,18,0,19
Universitate,4988,4,4,5,5,16,21,-5,17
FC Botosani,4988,5,3,5,6,5,13,-8,14
Concordia Ch,4988,6,2,3,9,15,22,-7,9
FCSB,4989,1,8,5,1,24,12,12,29
CFR Cluj,4989,2,5,6,3,13,9,4,21
Universitate,4989,3,5,5,4,17,18,-1,20
D Bucuresti,4989,4,4,4,6,18,20,-2,16
FC Botosani,4989,5,3,5,6,6,14,-8,14
Concordia Ch,4989,6,3,3,8,18,23,-5,12
FCSB,4990,1,8,6,0,25,11,14,30
CFR Cluj,4990,2,5,7,2,15,10,5,22
Universitate,4990,3,4,5,5,16,20,-4,17
D Bucuresti,4990,4,4,4,6,19,20,-1,16
FC Botosani,4990,5,4,4,6,7,15,-8,16
Concordia Ch,4990,6,3,2,9,18,24,-6,11
FCSB,4991,1,8,6,0,24,10,14,30
CFR Cluj,4991,2,6,6,2,14,8,6,24
D Bucuresti,4991,3,5,4,5,21,20,1,19
Universitate,4991,4,3,6,5,14,19,-5,15
FC Botosani,4991,5,3,4,7,7,17,-10,13
Concordia Ch,4991,6,3,2,9,18,24,-6,11
FCSB,4992,1,8,5,1,25,12,13,29
CFR Cluj,4992,2,7,6,1,16,7,9,27
D Bucuresti,4992,3,5,4,5,19,18,1,19
Universitate,4992,4,3,5,6,15,22,-7,14
FC Botosani,4992,5,3,5,6,7,15,-8,14
Concordia Ch,4992,6,2,3,9,17,25,-8,9
FCSB,4993,1,9,5,0,28,11,17,32
CFR Cluj,4993,2,6,6,2,17,10,7,24
D Bucuresti,4993,3,4,4,6,18,20,-2,16
Concordia Ch,4993,4,4,2,8,17,21,-4,14
Universitate,4993,5,3,5,6,14,23,-9,14
FC Botosani,4993,6,3,4,7,6,15,-9,13
FCSB,4994,1,8,5,1,26,11,15,29
CFR Cluj,4994,2,5,7,2,15,12,3,22
Universitate,4994,3,4,6,4,17,20,-3,18
D Bucuresti,4994,4,4,4,6,17,22,-5,16
FC Botosani,4994,5,3,5,6,5,13,-8,14
Concordia Ch,4994,6,3,3,8,19,21,-2,12
FCSB,4995,1,9,5,0,28,11,17,32
CFR Cluj,4995,2,6,6,2,19,10,9,24
FC Botosani,4995,3,3,6,5,5,12,-7,15
D Bucuresti,4995,4,3,5,6,17,20,-3,14
Universitate,4995,5,3,5,6,17,28,-11,14
Concordia Ch,4995,6,3,3,8,17,22,-5,12
FCSB,4996,1,8,5,1,26,13,13,29
CFR Cluj,4996,2,6,7,1,17,10,7,25
D Bucuresti,4996,3,4,4,6,17,21,-4,16
FC Botosani,4996,4,4,4,6,8,15,-7,16
Universitate,4996,5,3,6,5,15,20,-5,15
Concordia Ch,4996,6,3,2,9,18,22,-4,11
FCSB,4997,1,8,5,1,28,14,14,29
CFR Cluj,4997,2,5,6,3,14,11,3,21
Universitate,4997,3,5,5,4,18,20,-2,20
D Bucuresti,4997,4,4,4,6,17,19,-2,16
FC Botosani,4997,5,4,4,6,7,14,-7,16
Concordia Ch,4997,6,3,2,9,17,23,-6,11
FCSB,4998,1,8,5,1,25,13,12,29
CFR Cluj,4998,2,6,6,2,16,9,7,24
Universitate,4998,3,4,5,5,17,21,-4,17
D Bucuresti,4998,4,4,4,6,18,24,-6,16
FC Botosani,4998,5,4,4,6,7,14,-7,16
Concordia Ch,4998,6,3,2,9,20,22,-2,11
FCSB,4999,1,8,6,0,25,11,14,30
CFR Cluj,4999,2,6,6,2,15,9,6,24
D Bucuresti,4999,3,5,4,5,21,20,1,19
FC Botosani,4999,4,4,4,6,7,15,-8,16
Universitate,4999,5,3,6,5,14,19,-5,15
Concordia Ch,4999,6,2,2,10,16,24,-8,8
FCSB,5000,1,8,6,0,25,11,14,30
CFR Cluj,5000,2,6,6,2,14,8,6,24
FC Botosani,5000,3,5,4,5,9,13,-4,19
Universitate,5000,4,3,6,5,15,20,-5,15
D Bucuresti,5000,5,3,4,7,18,22,-4,13
Concordia Ch,5000,6,3,2,9,17,24,-7,11
FCSB,5001,1,8,6,0,24,10,14,30
CFR Cluj,5001,2,6,7,1,15,8,7,25
D Bucuresti,5001,3,4,5,5,22,23,-1,17
FC Botosani,5001,4,4,4,6,8,15,-7,16
Universitate,5001,5,3,5,6,15,21,-6,14
Concordia Ch,5001,6,2,3,9,18,25,-7,9
FCSB,5002,1,9,5,0,26,10,16,32
CFR Cluj,5002,2,6,6,2,15,8,7,24
FC Botosani,5002,3,3,6,5,6,13,-7,15
D Bucuresti,5002,4,3,5,6,17,21,-4,14
Universitate,5002,5,3,5,6,14,22,-8,14
Concordia Ch,5002,6,3,3,8,17,21,-4,12
FCSB,5003,1,9,5,0,27,10,17,32
CFR Cluj,5003,2,6,6,2,15,9,6,24
FC Botosani,5003,3,4,5,5,6,12,-6,17
Universitate,5003,4,3,5,6,14,22,-8,14
D Bucuresti,5003,5,3,4,7,16,20,-4,13
Concordia Ch,5003,6,3,3,8,16,21,-5,12
FCSB,5004,1,7,6,1,24,12,12,27
CFR Cluj,5004,2,6,6,2,15,9,6,24
Universitate,5004,3,4,6,4,15,18,-3,18
D Bucuresti,5004,4,4,5,5,19,20,-1,17
FC Botosani,5004,5,3,6,5,7,14,-7,15
Concordia Ch,5004,6,2,3,9,17,24,-7,9
FCSB,5005,1,8,6,0,28,14,14,30
CFR Cluj,5005,2,6,7,1,17,10,7,25
FC Botosani,5005,3,5,4,5,8,12,-4,19
D Bucuresti,5005,4,4,4,6,17,19,-2,16
Universitate,5005,5,3,5,6,17,23,-6,14
Concordia Ch,5005,6,2,2,10,15,24,-9,8
FCSB,5006,1,7,7,0,24,11,13,28
CFR Cluj,5006,2,6,7,1,16,8,8,25
FC Botosani,5006,3,4,5,5,9,14,-5,17
Universitate,5006,4,3,6,5,16,22,-6,15
D Bucuresti,5006,5,3,4,7,17,24,-7,13
Concordia Ch,5006,6,3,3,8,19,22,-3,12
FCSB,5007,1,9,5,0,27,12,15,32
CFR Cluj,5007,2,5,6,3,14,10,4,21
D Bucuresti,5007,3,4,5,5,21,22,-1,17
Universitate,5007,4,4,5,5,18,22,-4,17
FC Botosani,5007,5,3,6,5,10,17,-7,15
Concordia Ch,5007,6,2,3,9,20,27,-7,9
FCSB,5008,1,8,6,0,25,11,14,30
CFR Cluj,5008,2,5,7,2,14,9,5,22
FC Botosani,5008,3,5,4,5,8,13,-5,19
D Bucuresti,5008,4,4,4,6,20,22,-2,16
Universitate,5008,5,3,7,4,16,20,-4,16
Concordia Ch,5008,6,2,2,10,17,25,-8,8
FCSB,5009,1,8,5,1,26,14,12,29
CFR Cluj,5009,2,6,6,2,14,8,6,24
D Bucuresti,5009,3,5,4,5,18,18,0,19
Universitate,5009,4,4,5,5,18,21,-3,17
FC Botosani,5009,5,3,5,6,6,14,-8,14
Concordia Ch,5009,6,2,3,9,16,23,-7,9
FCSB,5010,1,7,5,2,23,13,10,26
CFR Cluj,5010,2,6,7,1,17,9,8,25
Universitate,5010,3,4,6,4,17,20,-3,18
FC Botosani,5010,4,4,5,5,6,12,-6,17
D Bucuresti,5010,5,3,4,7,17,21,-4,13
Concordia Ch,5010,6,3,3,8,17,22,-5,12
FCSB,5011,1,7,6,1,25,14,11,27
CFR Cluj,5011,2,6,7,1,19,11,8,25
D Bucuresti,5011,3,4,4,6,19,21,-2,16
Universitate,5011,4,3,7,4,16,20,-4,16
FC Botosani,5011,5,4,4,6,8,14,-6,16
Concordia Ch,5011,6,3,2,9,17,24,-7,11
FCSB,5012,1,7,6,1,26,14,12,27
CFR Cluj,5012,2,6,6,2,16,10,6,24
D Bucuresti,5012,3,5,4,5,20,20,0,19
Universitate,5012,4,4,6,4,18,21,-3,18
FC Botosani,5012,5,4,4,6,7,14,-7,16
Concordia Ch,5012,6,2,2,10,18,26,-8,8
FCSB,5013,1,8,5,1,25,11,14,29
CFR Cluj,5013,2,5,6,3,13,10,3,21
Universitate,5013,3,5,5,4,16,18,-2,20
FC Botosani,5013,4,5,4,5,10,13,-3,19
D Bucuresti,5013,5,4,4,6,21,21,0,16
Concordia Ch,5013,6,2,2,10,15,27,-12,8
FCSB,5014,1,9,5,0,29,11,18,32
CFR Cluj,5014,2,5,7,2,14,11,3,22
D Bucuresti,5014,3,4,4,6,18,22,-4,16
Universitate,5014,4,3,6,5,16,22,-6,15
Concordia Ch,5014,5,4,2,8,21,22,-1,14
FC Botosani,5014,6,3,4,7,7,17,-10,13
FCSB,5015,1,8,5,1,25,12,13,29
CFR Cluj,5015,2,5,7,2,14,9,5,22
D Bucuresti,5015,3,5,4,5,20,19,1,19
Universitate,5015,4,4,6,4,15,18,-3,18
FC Botosani,5015,5,3,5,6,6,14,-8,14
Concordia Ch,5015,6,2,3,9,15,23,-8,9
FCSB,5016,1,7,6,1,24,12,12,27
CFR Cluj,5016,2,5,7,2,14,12,2,22
Universitate,5016,3,5,5,4,19,18,1,20
FC Botosani,5016,4,4,5,5,7,13,-6,17
D Bucuresti,5016,5,3,4,7,17,21,-4,13
Concordia Ch,5016,6,3,3,8,16,21,-5,12
FCSB,5017,1,8,6,0,27,11,16,30
CFR Cluj,5017,2,5,7,2,13,10,3,22
D Bucuresti,5017,3,5,4,5,21,20,1,19
Universitate,5017,4,3,7,4,15,19,-4,16
FC Botosani,5017,5,4,4,6,8,15,-7,16
Concordia Ch,5017,6,2,2,10,16,25,-9,8
FCSB,5018,1,8,5,1,26,13,13,29
CFR Cluj,5018,2,5,7,2,14,9,5,22
Universitate,5018,3,4,6,4,16,19,-3,18
FC Botosani,5018,4,4,5,5,6,12,-6,17
D Bucuresti,5018,5,3,6,5,17,19,-2,15
Concordia Ch,5018,6,2,3,9,16,23,-7,9
FCSB,5019,1,9,5,0,31,14,17,32
CFR Cluj,5019,2,5,7,2,15,11,4,22
D Bucuresti,5019,3,4,5,5,20,20,0,17
FC Botosani,5019,4,4,4,6,9,16,-7,16
Universitate,5019,5,3,6,5,16,22,-6,15
Concordia Ch,5019,6,2,3,9,17,25,-8,9
FCSB,5020,1,8,6,0,27,12,15,30
CFR Cluj,5020,2,6,6,2,16,11,5,24
D Bucuresti,5020,3,5,4,5,19,18,1,19
FC Botosani,5020,4,4,4,6,7,13,-6,16
Universitate,5020,5,3,6,5,16,21,-5,15
Concordia Ch,5020,6,2,2,10,15,25,-10,8
FCSB,5021,1,7,6,1,24,12,12,27
CFR Cluj,5021,2,7,6,1,16,8,8,27
D Bucuresti,5021,3,4,4,6,18,20,-2,16
Universitate,5021,4,3,6,5,14,19,-5,15
Concordia Ch,5021,5,4,2,8,17,21,-4,14
FC Botosani,5021,6,3,4,7,6,15,-9,13
FCSB,5022,1,7,6,1,24,12,12,27
CFR Cluj,5022,2,5,7,2,13,8,5,22
Universitate,5022,3,5,5,4,17,19,-2,20
D Bucuresti,5022,4,5,4,5,20,20,0,19
FC Botosani,5022,5,4,4,6,7,14,-7,16
Concordia Ch,5022,6,2,2,10,16,24,-8,8
FCSB,5023,1,8,6,0,30,10,20,30
CFR Cluj,5023,2,5,8,1,13,7,6,23
D Bucuresti,5023,3,5,4,5,20,19,1,19
FC Botosani,5023,4,4,4,6,6,14,-8,16
Universitate,5023,5,3,6,5,14,25,-11,15
Concordia Ch,5023,6,2,2,10,16,24,-8,8
FCSB,5024,1,9,5,0,26,10,16,32
CFR Cluj,5024,2,6,6,2,16,10,6,24
FC Botosani,5024,3,4,4,6,7,14,-7,16
D Bucuresti,5024,4,3,5,6,16,19,-3,14
Universitate,5024,5,3,5,6,16,23,-7,14
Concordia Ch,5024,6,3,3,8,17,22,-5,12
FCSB,5025,1,8,5,1,26,13,13,29
CFR Cluj,5025,2,7,6,1,16,8,8,27
D Bucuresti,5025,3,4,4,6,19,21,-2,16
Universitate,5025,4,3,5,6,15,21,-6,14
FC Botosani,5025,5,3,5,6,6,14,-8,14
Concordia Ch,5025,6,3,3,8,19,24,-5,12
FCSB,5026,1,9,5,0,26,10,16,32
CFR Cluj,5026,2,5,7,2,14,10,4,22
D Bucuresti,5026,3,4,4,6,19,21,-2,16
Universitate,5026,4,3,6,5,15,20,-5,15
FC Botosani,5026,5,3,5,6,7,15,-8,14
Concordia Ch,5026,6,3,3,8,18,23,-5,12
FCSB,5027,1,8,6,0,28,13,15,30
CFR Cluj,5027,2,6,6,2,14,9,5,24
D Bucuresti,5027,3,4,4,6,17,23,-6,16
FC Botosani,5027,4,4,4,6,7,13,-6,16
Universitate,5027,5,3,6,5,17,22,-5,15
Concordia Ch,5027,6,3,2,9,20,23,-3,11
FCSB,5028,1,8,6,0,26,11,15,30
CFR Cluj,5028,2,5,7,2,13,9,4,22
Universitate,5028,3,3,7,4,15,19,-4,16
D Bucuresti,5028,4,3,5,6,18,21,-3,14
Concordia Ch,5028,5,4,2,8,19,23,-4,14
FC Botosani,5028,6,3,5,6,7,15,-8,14
FCSB,5029,1,8,5,1,29,14,15,29
CFR Cluj,5029,2,6,6,2,17,11,6,24
D Bucuresti,5029,3,5,4,5,20,19,1,19
Universitate,5029,4,4,5,5,15,21,-6,17
FC Botosani,5029,5,3,4,7,7,17,-10,13
Concordia Ch,5029,6,3,2,9,17,23,-6,11
FCSB,5030,1,8,6,0,25,11,14,30
CFR Cluj,5030,2,5,6,3,14,10,4,21
FC Botosani,5030,3,5,4,5,14,12,2,19
Universitate,5030,4,4,6,4,17,20,-3,18
D Bucuresti,5030,5,3,4,7,16,24,-8,13
Concordia Ch,5030,6,3,2,9,17,26,-9,11
FCSB,5031,1,8,6,0,25,10,15,30
CFR Cluj,5031,2,6,7,1,16,9,7,25
D Bucuresti,5031,3,5,4,5,20,20,0,19
FC Botosani,5031,4,4,4,6,7,14,-7,16
Universitate,5031,5,3,5,6,16,23,-7,14
Concordia Ch,5031,6,2,2,10,16,24,-8,8
FCSB,5032,1,8,6,0,24,10,14,30
CFR Cluj,5032,2,5,7,2,13,8,5,22
D Bucuresti,5032,3,5,4,5,19,19,0,19
Universitate,5032,4,3,7,4,14,18,-4,16
FC Botosani,5032,5,3,4,7,5,14,-9,13
Concordia Ch,5032,6,3,2,9,17,23,-6,11
FCSB,5033,1,8,5,1,24,12,12,29
CFR Cluj,5033,2,5,7,2,13,8,5,22
FC Botosani,5033,3,5,4,5,9,14,-5,19
Universitate,5033,4,4,6,4,16,18,-2,18
D Bucuresti,5033,5,4,4,6,18,20,-2,16
Concordia Ch,5033,6,2,2,10,16,24,-8,8
FCSB,5034,1,8,5,1,25,13,12,29
CFR Cluj,5034,2,5,7,2,14,9,5,22
Universitate,5034,3,4,6,4,18,20,-2,18
FC Botosani,5034,4,4,5,5,7,13,-6,17
D Bucuresti,5034,5,3,5,6,17,21,-4,14
Concordia Ch,5034,6,3,2,9,17,22,-5,11
FCSB,5035,1,7,7,0,26,13,13,28
CFR Cluj,5035,2,6,7,1,15,8,7,25
FC Botosani,5035,3,4,5,5,7,13,-6,17
Universitate,5035,4,3,6,5,16,21,-5,15
D Bucuresti,5035,5,3,4,7,17,22,-5,13
Concordia Ch,5035,6,3,3,8,17,21,-4,12
FCSB,5036,1,9,5,0,29,12,17,32
CFR Cluj,5036,2,5,6,3,14,10,4,21
D Bucuresti,5036,3,4,5,5,19,20,-1,17
Universitate,5036,4,4,5,5,18,24,-6,17
FC Botosani,5036,5,4,5,5,7,13,-6,17
Concordia Ch,5036,6,2,2,10,16,24,-8,8
FCSB,5037,1,7,6,1,24,13,11,27
CFR Cluj,5037,2,5,8,1,14,8,6,23
Universitate,5037,3,4,6,4,16,18,-2,18
D Bucuresti,5037,4,4,4,6,19,23,-4,16
FC Botosani,5037,5,3,5,6,6,14,-8,14
Concordia Ch,5037,6,3,3,8,21,24,-3,12
FCSB,5038,1,8,6,0,26,11,15,30
CFR Cluj,5038,2,6,6,2,17,9,8,24
FC Botosani,5038,3,5,4,5,9,13,-4,19
Universitate,5038,4,3,6,5,15,23,-8,15
D Bucuresti,5038,5,3,5,6,20,23,-3,14
Concordia Ch,5038,6,2,3,9,18,26,-8,9
FCSB,5039,1,8,5,1,25,12,13,29
CFR Cluj,5039,2,5,6,3,13,9,4,21
Universitate,5039,3,5,5,4,17,19,-2,20
D Bucuresti,5039,4,4,4,6,20,22,-2,16
FC Botosani,5039,5,4,4,6,7,16,-9,16
Concordia Ch,5039,6,3,2,9,18,22,-4,11
FCSB,5040,1,8,6,0,26,11,15,30
CFR Cluj,5040,2,6,7,1,15,8,7,25
FC Botosani,5040,3,4,5,5,8,14,-6,17
D Bucuresti,5040,4,3,5,6,18,21,-3,14
Universitate,5040,5,3,5,6,14,21,-7,14
Concordia Ch,5040,6,3,2,9,18,24,-6,11
FCSB,5041,1,8,6,0,28,13,15,30
CFR Cluj,5041,2,5,7,2,16,11,5,22
FC Botosani,5041,3,5,4,5,8,13,-5,19
Universitate,5041,4,4,5,5,15,20,-5,17
D Bucuresti,5041,5,4,4,6,19,20,-1,16
Concordia Ch,5041,6,2,2,10,15,24,-9,8
FCSB,5042,1,8,5,1,26,13,13,29
CFR Cluj,5042,2,5,6,3,13,10,3,21
Universitate,5042,3,5,5,4,19,20,-1,20
FC Botosani,5042,4,5,4,5,8,13,-5,19
D Bucuresti,5042,5,3,4,7,17,22,-5,13
Concordia Ch,5042,6,3,2,9,19,24,-5,11
FCSB,5043,1,7,6,1,25,15,10,27
CFR Cluj,5043,2,5,7,2,16,11,5,22
Universitate,5043,3,5,5,4,21,21,0,20
D Bucuresti,5043,4,5,4,5,20,18,2,19
FC Botosani,5043,5,3,5,6,7,16,-9,14
Concordia Ch,5043,6,2,3,9,17,25,-8,9
FCSB,5044,1,8,5,1,28,12,16,29
CFR Cluj,5044,2,6,6,2,17,12,5,24
FC Botosani,5044,3,5,4,5,9,14,-5,19
Universitate,5044,4,4,5,5,15,21,-6,17
D Bucuresti,5044,5,3,5,6,17,20,-3,14
Concordia Ch,5044,6,2,3,9,16,23,-7,9
FCSB,5045,1,9,5,0,27,12,15,32
CFR Cluj,5045,2,6,6,2,16,9,7,24
D Bucuresti,5045,3,4,4,6,20,22,-2,16
FC Botosani,5045,4,4,4,6,9,15,-6,16
Universitate,5045,5,3,5,6,15,22,-7,14
Concordia Ch,5045,6,3,2,9,18,25,-7,11
FCSB,5046,1,8,6,0,24,10,14,30
CFR Cluj,5046,2,5,8,1,13,7,6,23
D Bucuresti,5046,3,4,5,5,19,20,-1,17
Universitate,5046,4,3,6,5,14,19,-5,15
FC Botosani,5046,5,3,5,6,6,14,-8,14
Concordia Ch,5046,6,2,4,8,18,24,-6,10
FCSB,5047,1,8,5,1,25,13,12,29
CFR Cluj,5047,2,6,6,2,18,10,8,24
FC Botosani,5047,3,5,4,5,8,13,-5,19
Universitate,5047,4,4,5,5,17,22,-5,17
D Bucuresti,5047,5,3,4,7,17,24,-7,13
Concordia Ch,5047,6,3,2,9,21,24,-3,11
FCSB,5048,1,9,5,0,26,11,15,32
CFR Cluj,5048,2,5,6,3,15,11,4,21
FC Botosani,5048,3,5,4,5,7,12,-5,19
Universitate,5048,4,4,5,5,16,20,-4,17
D Bucuresti,5048,5,3,5,6,17,20,-3,14
Concordia Ch,5048,6,2,3,9,16,23,-7,9
FCSB,5049,1,8,6,0,28,12,16,30
CFR Cluj,5049,2,6,6,2,14,10,4,24
D Bucuresti,5049,3,5,4,5,24,20,4,19
Universitate,5049,4,3,6,5,16,21,-5,15
FC Botosani,5049,5,3,5,6,8,20,-12,14
Concordia Ch,5049,6,2,3,9,16,23,-7,9
FCSB,5050,1,9,5,0,26,11,15,32
CFR Cluj,5050,2,5,7,2,16,11,5,22
D Bucuresti,5050,3,5,4,5,19,18,1,19
Universitate,5050,4,3,6,5,16,21,-5,15
FC Botosani,5050,5,3,4,7,5,14,-9,13
Concordia Ch,5050,6,3,2,9,16,23,-7,11
FCSB,5051,1,8,5,1,27,14,13,29
CFR Cluj,5051,2,5,7,2,15,11,4,22
Universitate,5051,3,4,6,4,18,20,-2,18
D Bucuresti,5051,4,4,4,6,20,20,0,16
FC Botosani,5051,5,3,5,6,7,18,-11,14
Concordia Ch,5051,6,3,3,8,19,23,-4,12
FCSB,5052,1,7,7,0,25,12,13,28
CFR Cluj,5052,2,5,7,2,14,9,5,22
D Bucuresti,5052,3,5,4,5,23,19,4,19
Universitate,5052,4,4,6,4,16,19,-3,18
FC Botosani,5052,5,4,4,6,8,15,-7,16
Concordia Ch,5052,6,2,2,10,16,28,-12,8
FCSB,5053,1,8,6,0,27,12,15,30
CFR Cluj,5053,2,6,6,2,16,11,5,24
Universitate,5053,3,3,6,5,16,21,-5,15
FC Botosani,5053,4,3,6,5,8,15,-7,15
D Bucuresti,5053,5,3,5,6,16,20,-4,14
Concordia Ch,5053,6,3,3,8,20,24,-4,12
FCSB,5054,1,9,5,0,26,11,15,32
CFR Cluj,5054,2,5,7,2,15,10,5,22
D Bucuresti,5054,3,4,4,6,17,19,-2,16
FC Botosani,5054,4,4,4,6,6,13,-7,16
Universitate,5054,5,3,6,5,15,20,-5,15
Concordia Ch,5054,6,3,2,9,16,22,-6,11
FCSB,5055,1,8,6,0,28,12,16,30
CFR Cluj,5055,2,5,7,2,13,10,3,22
D Bucuresti,5055,3,4,5,5,20,21,-1,17
Universitate,5055,4,3,7,4,16,20,-4,16
FC Botosani,5055,5,3,5,6,11,19,-8,14
Concordia Ch,5055,6,3,2,9,19,25,-6,11
FCSB,5056,1,8,5,1,27,13,14,29
CFR Cluj,5056,2,6,6,2,16,10,6,24
D Bucuresti,5056,3,5,4,5,20,18,2,19
Universitate,5056,4,4,5,5,16,21,-5,17
FC Botosani,5056,5,3,5,6,6,14,-8,14
Concordia Ch,5056,6,2,3,9,16,25,-9,9
FCSB,5057,1,9,5,0,27,12,15,32
CFR Cluj,5057,2,6,6,2,15,9,6,24
D Bucuresti,5057,3,4,4,6,19,21,-2,16
Universitate,5057,4,3,5,6,15,21,-6,14
FC Botosani,5057,5,3,5,6,6,14,-8,14
Concordia Ch,5057,6,3,3,8,17,22,-5,12
FCSB,5058,1,8,5,1,24,11,13,29
CFR Cluj,5058,2,6,6,2,14,9,5,24
Universitate,5058,3,4,5,5,16,19,-3,17
D Bucuresti,5058,4,4,4,6,19,20,-1,16
FC Botosani,5058,5,3,5,6,6,16,-10,14
Concordia Ch,5058,6,3,3,8,18,22,-4,12
FCSB,5059,1,8,5,1,25,12,13,29
CFR Cluj,5059,2,5,6,3,13,10,3,21
Universitate,5059,3,5,5,4,18,19,-1,20
D Bucuresti,5059,4,4,5,5,18,19,-1,17
FC Botosani,5059,5,3,6,5,6,13,-7,15
Concordia Ch,5059,6,2,3,9,17,24,-7,9
FCSB,5060,1,8,6,0,26,11,15,30
CFR Cluj,5060,2,5,7,2,13,8,5,22
FC Botosani,5060,3,5,4,5,8,13,-5,19
Universitate,5060,4,4,5,5,16,21,-5,17
D Bucuresti,5060,5,4,4,6,21,22,-1,16
Concordia Ch,5060,6,2,2,10,17,26,-9,8
CFR Cluj,5061,1,7,6,1,23,9,14,27
FCSB,5061,2,7,6,1,27,16,11,27
D Bucuresti,5061,3,4,5,5,20,21,-1,17
FC Botosani,5061,4,3,6,5,6,13,-7,15
Universitate,5061,5,3,6,5,16,26,-10,15
Concordia Ch,5061,6,2,3,9,17,24,-7,9
FCSB,5062,1,8,6,0,27,11,16,30
CFR Cluj,5062,2,6,6,2,15,10,5,24
D Bucuresti,5062,3,4,5,5,20,21,-1,17
FC Botosani,5062,4,4,4,6,10,15,-5,16
Universitate,5062,5,3,6,5,15,21,-6,15
Concordia Ch,5062,6,2,3,9,16,25,-9,9
FCSB,5063,1,7,7,0,25,12,13,28
CFR Cluj,5063,2,5,7,2,14,9,5,22
Universitate,5063,3,4,6,4,16,19,-3,18
D Bucuresti,5063,4,4,5,5,21,20,1,17
FC Botosani,5063,5,3,5,6,6,14,-8,14
Concordia Ch,5063,6,3,2,9,17,25,-8,11
FCSB,5064,1,8,6,0,25,11,14,30
CFR Cluj,5064,2,5,8,1,13,7,6,23
D Bucuresti,5064,3,4,4,6,19,21,-2,16
Universitate,5064,4,3,6,5,15,20,-5,15
Concordia Ch,5064,5,4,2,8,18,22,-4,14
FC Botosani,5064,6,3,4,7,6,15,-9,13
FCSB,5065,1,8,5,1,26,13,13,29
CFR Cluj,5065,2,6,6,2,14,10,4,24
D Bucuresti,5065,3,5,4,5,20,19,1,19
Universitate,5065,4,4,5,5,17,19,-2,17
FC Botosani,5065,5,4,4,6,9,14,-5,16
Concordia Ch,5065,6,2,2,10,17,28,-11,8
FCSB,5066,1,8,5,1,25,12,13,29
CFR Cluj,5066,2,5,6,3,13,10,3,21
Universitate,5066,3,5,5,4,17,18,-1,20
D Bucuresti,5066,4,3,5,6,17,20,-3,14
Concordia Ch,5066,5,4,2,8,18,22,-4,14
FC Botosani,5066,6,3,5,6,5,13,-8,14
FCSB,5067,1,7,6,1,26,14,12,27
CFR Cluj,5067,2,7,6,1,18,8,10,27
D Bucuresti,5067,3,4,5,5,19,19,0,17
Universitate,5067,4,3,6,5,16,23,-7,15
FC Botosani,5067,5,3,5,6,7,15,-8,14
Concordia Ch,5067,6,3,2,9,17,24,-7,11
FCSB,5068,1,8,5,1,28,13,15,29
CFR Cluj,5068,2,6,6,2,16,10,6,24
Universitate,5068,3,4,5,5,17,23,-6,17
D Bucuresti,5068,4,4,4,6,17,20,-3,16
FC Botosani,5068,5,4,4,6,6,13,-7,16
Concordia Ch,5068,6,3,2,9,17,22,-5,11
FCSB,5069,1,8,5,1,27,12,15,29
CFR Cluj,5069,2,6,6,2,15,10,5,24
D Bucuresti,5069,3,4,5,5,19,20,-1,17
Universitate,5069,4,4,5,5,16,21,-5,17
FC Botosani,5069,5,3,4,7,6,15,-9,13
Concordia Ch,5069,6,3,3,8,19,24,-5,12
FCSB,5070,1,8,5,1,27,12,15,29
CFR Cluj,5070,2,6,7,1,16,9,7,25
D Bucuresti,5070,3,4,4,6,19,19,0,16
Universitate,5070,4,3,6,5,17,24,-7,15
Concordia Ch,5070,5,4,2,8,20,21,-1,14
FC Botosani,5070,6,3,4,7,5,19,-14,13
CFR Cluj,5071,1,7,6,1,17,8,9,27
FCSB,5071,2,7,5,2,24,13,11,26
Universitate,5071,3,4,5,5,17,22,-5,17
D Bucuresti,5071,4,4,4,6,19,22,-3,16
Concordia Ch,5071,5,4,2,8,19,22,-3,14
FC Botosani,5071,6,3,4,7,6,15,-9,13
FCSB,5072,1,7,6,1,24,12,12,27
CFR Cluj,5072,2,6,7,1,16,9,7,25
Universitate,5072,3,4,5,5,16,20,-4,17
D Bucuresti,5072,4,3,6,5,17,19,-2,15
FC Botosani,5072,5,3,6,5,7,14,-7,15
Concordia Ch,5072,6,2,4,8,16,22,-6,10
FCSB,5073,1,7,6,1,26,14,12,27
CFR Cluj,5073,2,6,7,1,18,9,9,25
Universitate,5073,3,4,5,5,18,24,-6,17
D Bucuresti,5073,4,4,4,6,18,20,-2,16
Concordia Ch,5073,5,4,2,8,19,23,-4,14
FC Botosani,5073,6,3,4,7,6,15,-9,13
FCSB,5074,1,8,6,0,26,12,14,30
CFR Cluj,5074,2,5,7,2,15,10,5,22
Universitate,5074,3,4,5,5,17,21,-4,17
FC Botosani,5074,4,4,4,6,7,14,-7,16
Concordia Ch,5074,5,4,2,8,19,22,-3,14
D Bucuresti,5074,6,3,4,7,16,21,-5,13
FCSB,5075,1,8,5,1,25,12,13,29
CFR Cluj,5075,2,7,6,1,15,7,8,27
D Bucuresti,5075,3,5,4,5,20,19,1,19
Universitate,5075,4,3,5,6,15,21,-6,14
FC Botosani,5075,5,3,5,6,8,16,-8,14
Concordia Ch,5075,6,2,3,9,17,25,-8,9
FCSB,5076,1,8,6,0,24,10,14,30
CFR Cluj,5076,2,5,6,3,13,9,4,21
D Bucuresti,5076,3,5,4,5,19,18,1,19
Universitate,5076,4,4,6,4,15,18,-3,18
FC Botosani,5076,5,3,4,7,6,15,-9,13
Concordia Ch,5076,6,3,2,9,17,24,-7,11
FCSB,5077,1,8,6,0,26,11,15,30
CFR Cluj,5077,2,5,7,2,13,9,4,22
D Bucuresti,5077,3,4,5,5,18,18,0,17
Universitate,5077,4,3,7,4,15,19,-4,16
FC Botosani,5077,5,3,6,5,7,14,-7,15
Concordia Ch,5077,6,2,3,9,17,25,-8,9
FCSB,5078,1,7,6,1,26,16,10,27
CFR Cluj,5078,2,5,7,2,15,11,4,22
Universitate,5078,3,5,5,4,20,19,1,20
D Bucuresti,5078,4,3,6,5,19,21,-2,15
FC Botosani,5078,5,3,5,6,8,16,-8,14
Concordia Ch,5078,6,3,3,8,18,23,-5,12
FCSB,5079,1,9,5,0,26,11,15,32
CFR Cluj,5079,2,6,6,2,16,9,7,24
D Bucuresti,5079,3,3,6,5,17,19,-2,15
Universitate,5079,4,3,5,6,14,21,-7,14
FC Botosani,5079,5,3,5,6,5,14,-9,14
Concordia Ch,5079,6,3,3,8,18,22,-4,12
FCSB,5080,1,8,6,0,24,10,14,30
CFR Cluj,5080,2,5,8,1,13,7,6,23
D Bucuresti,5080,3,5,4,5,22,18,4,19
Universitate,5080,4,3,6,5,14,19,-5,15
FC Botosani,5080,5,3,4,7,5,17,-12,13
Concordia Ch,5080,6,3,2,9,17,24,-7,11
FCSB,5081,1,8,5,1,25,15,10,29
CFR Cluj,5081,2,5,6,3,13,10,3,21
Universitate,5081,3,5,5,4,21,19,2,20
FC Botosani,5081,4,4,5,5,7,13,-6,17
D Bucuresti,5081,5,3,5,6,16,19,-3,14
Concordia Ch,5081,6,2,4,8,16,22,-6,10
FCSB,5082,1,7,6,1,25,13,12,27
CFR Cluj,5082,2,6,6,2,15,13,2,24
Universitate,5082,3,4,6,4,20,19,1,18
FC Botosani,5082,4,3,6,5,6,13,-7,15
D Bucuresti,5082,5,3,5,6,16,19,-3,14
Concordia Ch,5082,6,3,3,8,17,22,-5,12
FCSB,5083,1,8,6,0,26,10,16,30
CFR Cluj,5083,2,6,6,2,14,10,4,24
D Bucuresti,5083,3,4,4,6,17,21,-4,16
Universitate,5083,4,3,6,5,14,19,-5,15
Concordia Ch,5083,5,4,2,8,19,21,-2,14
FC Botosani,5083,6,3,4,7,5,14,-9,13
FCSB,5084,1,7,6,1,23,12,11,27
CFR Cluj,5084,2,6,7,1,16,7,9,25
D Bucuresti,5084,3,4,5,5,19,20,-1,17
Universitate,5084,4,4,5,5,16,21,-5,17
FC Botosani,5084,5,3,5,6,6,14,-8,14
Concordia Ch,5084,6,2,4,8,16,22,-6,10
FCSB,5085,1,8,5,1,29,14,15,29
CFR Cluj,5085,2,6,6,2,15,10,5,24
D Bucuresti,5085,3,5,4,5,19,19,0,19
Universitate,5085,4,4,5,5,18,23,-5,17
FC Botosani,5085,5,3,5,6,6,14,-8,14
Concordia Ch,5085,6,2,3,9,17,24,-7,9
FCSB,5086,1,8,6,0,26,11,15,30
CFR Cluj,5086,2,6,7,1,16,9,7,25
D Bucuresti,5086,3,4,4,6,17,20,-3,16
FC Botosani,5086,4,4,4,6,7,13,-6,16
Universitate,5086,5,3,5,6,15,22,-7,14
Concordia Ch,5086,6,3,2,9,17,23,-6,11
FCSB,5087,1,9,5,0,26,10,16,32
CFR Cluj,5087,2,6,6,2,14,9,5,24
FC Botosani,5087,3,4,5,5,6,12,-6,17
D Bucuresti,5087,4,3,5,6,16,19,-3,14
Universitate,5087,5,3,5,6,14,20,-6,14
Concordia Ch,5087,6,3,2,9,16,22,-6,11
FCSB,5088,1,8,5,1,26,14,12,29
CFR Cluj,5088,2,5,6,3,14,11,3,21
Universitate,5088,3,5,5,4,20,20,0,20
D Bucuresti,5088,4,3,5,6,18,21,-3,14
Concordia Ch,5088,5,4,2,8,18,22,-4,14
FC Botosani,5088,6,3,5,6,6,14,-8,14
FCSB,5089,1,8,5,1,25,12,13,29
CFR Cluj,5089,2,7,6,1,18,7,11,27
FC Botosani,5089,3,5,4,5,9,13,-4,19
D Bucuresti,5089,4,3,5,6,19,22,-3,14
Universitate,5089,5,3,5,6,14,23,-9,14
Concordia Ch,5089,6,2,3,9,17,25,-8,9
FCSB,5090,1,7,7,0,24,11,13,28
CFR Cluj,5090,2,5,7,2,14,9,5,22
Universitate,5090,3,4,6,4,15,18,-3,18
D Bucuresti,5090,4,3,5,6,16,19,-3,14
Concordia Ch,5090,5,4,2,8,18,22,-4,14
FC Botosani,5090,6,3,5,6,6,14,-8,14
FCSB,5091,1,8,6,0,26,11,15,30
CFR Cluj,5091,2,5,7,2,16,11,5,22
D Bucuresti,5091,3,5,4,5,22,18,4,19
Universitate,5091,4,4,5,5,17,22,-5,17
FC Botosani,5091,5,3,5,6,7,17,-10,14
Concordia Ch,5091,6,2,3,9,17,26,-9,9
FCSB,5092,1,7,6,1,26,15,11,27
CFR Cluj,5092,2,6,7,1,16,8,8,25
Universitate,5092,3,4,5,5,18,22,-4,17
D Bucuresti,5092,4,4,4,6,17,19,-2,16
FC Botosani,5092,5,3,5,6,6,14,-8,14
Concordia Ch,5092,6,3,3,8,17,22,-5,12
FCSB,5093,1,8,6,0,26,12,14,30
CFR Cluj,5093,2,5,8,1,15,9,6,23
D Bucuresti,5093,3,5,4,5,21,18,3,19
FC Botosani,5093,4,4,4,6,7,15,-8,16
Universitate,5093,5,3,6,5,16,21,-5,15
Concordia Ch,5093,6,2,2,10,16,26,-10,8
FCSB,5094,1,8,5,1,28,14,14,29
CFR Cluj,5094,2,6,7,1,18,10,8,25
FC Botosani,5094,3,4,5,5,10,15,-5,17
Universitate,5094,4,3,6,5,15,22,-7,15
D Bucuresti,5094,5,3,4,7,18,25,-7,13
Concordia Ch,5094,6,3,3,8,21,24,-3,12
FCSB,5095,1,9,5,0,28,12,16,32
CFR Cluj,5095,2,6,6,2,15,10,5,24
D Bucuresti,5095,3,3,5,6,17,20,-3,14
Concordia Ch,5095,4,4,2,8,18,22,-4,14
Universitate,5095,5,3,5,6,17,23,-6,14
FC Botosani,5095,6,3,5,6,7,15,-8,14
FCSB,5096,1,7,7,0,27,14,13,28
CFR Cluj,5096,2,5,7,2,15,10,5,22
Universitate,5096,3,4,6,4,17,20,-3,18
FC Botosani,5096,4,4,5,5,7,12,-5,17
D Bucuresti,5096,5,4,4,6,18,21,-3,16
Concordia Ch,5096,6,2,3,9,16,23,-7,9
FCSB,5097,1,7,6,1,24,12,12,27
CFR Cluj,5097,2,5,7,2,14,10,4,22
Universitate,5097,3,5,5,4,17,18,-1,20
FC Botosani,5097,4,4,5,5,6,12,-6,17
D Bucuresti,5097,5,3,6,5,17,19,-2,15
Concordia Ch,5097,6,2,3,9,16,23,-7,9
FCSB,5098,1,9,5,0,28,11,17,32
CFR Cluj,5098,2,5,7,2,13,10,3,22
FC Botosani,5098,3,5,4,5,10,13,-3,19
D Bucuresti,5098,4,4,4,6,17,20,-3,16
Universitate,5098,5,3,6,5,15,20,-5,15
Concordia Ch,5098,6,2,2,10,16,25,-9,8
FCSB,5099,1,9,5,0,26,11,15,32
CFR Cluj,5099,2,5,7,2,15,10,5,22
Universitate,5099,3,3,6,5,15,20,-5,15
Concordia Ch,5099,4,4,2,8,20,22,-2,14
D Bucuresti,5099,5,3,5,6,18,22,-4,14
FC Botosani,5099,6,3,5,6,6,15,-9,14
FCSB,5100,1,9,5,0,30,10,20,32
CFR Cluj,5100,2,6,6,2,18,14,4,24
D Bucuresti,5100,3,5,4,5,19,18,1,19
Universitate,5100,4,3,5,6,16,25,-9,14
FC Botosani,5100,5,3,4,7,6,15,-9,13
Concordia Ch,5100,6,3,2,9,17,24,-7,11
FCSB,5101,1,7,6,1,24,13,11,27
CFR Cluj,5101,2,5,8,1,14,8,6,23
Universitate,5101,3,4,6,4,16,18,-2,18
D Bucuresti,5101,4,4,4,6,22,23,-1,16
FC Botosani,5101,5,4,4,6,9,17,-8,16
Concordia Ch,5101,6,3,2,9,19,25,-6,11
CFR Cluj,5102,1,7,6,1,16,8,8,27
FCSB,5102,2,7,5,2,24,13,11,26
D Bucuresti,5102,3,4,5,5,18,19,-1,17
Universitate,5102,4,4,5,5,15,19,-4,17
FC Botosani,5102,5,3,4,7,7,16,-9,13
Concordia Ch,5102,6,3,3,8,19,24,-5,12
FCSB,5103,1,8,6,0,26,12,14,30
CFR Cluj,5103,2,5,7,2,14,9,5,22
Universitate,5103,3,4,5,5,16,20,-4,17
Concordia Ch,5103,4,4,2,8,22,23,-1,14
D Bucuresti,5103,5,3,5,6,18,24,-6,14
FC Botosani,5103,6,3,5,6,7,15,-8,14
FCSB,5104,1,8,6,0,26,12,14,30
CFR Cluj,5104,2,6,7,1,16,8,8,25
D Bucuresti,5104,3,5,4,5,22,21,1,19
Universitate,5104,4,3,5,6,15,22,-7,14
FC Botosani,5104,5,3,4,7,7,17,-10,13
Concordia Ch,5104,6,3,2,9,19,25,-6,11
FCSB,5105,1,8,6,0,26,12,14,30
CFR Cluj,5105,2,5,7,2,15,10,5,22
Universitate,5105,3,4,5,5,15,19,-4,17
D Bucuresti,5105,4,4,4,6,18,20,-2,16
FC Botosani,5105,5,4,4,6,7,14,-7,16
Concordia Ch,5105,6,3,2,9,17,23,-6,11
FCSB,5106,1,9,5,0,28,12,16,32
CFR Cluj,5106,2,6,6,2,17,11,6,24
FC Botosani,5106,3,4,4,6,7,14,-7,16
Concordia Ch,5106,4,4,2,8,18,22,-4,14
Universitate,5106,5,3,5,6,16,23,-7,14
D Bucuresti,5106,6,3,4,7,18,22,-4,13
FCSB,5107,1,8,5,1,24,12,12,29
CFR Cluj,5107,2,7,6,1,18,7,11,27
D Bucuresti,5107,3,4,4,6,18,21,-3,16
Universitate,5107,4,3,5,6,14,22,-8,14
FC Botosani,5107,5,3,5,6,6,14,-8,14
Concordia Ch,5107,6,3,3,8,19,23,-4,12
FCSB,5108,1,9,5,0,29,11,18,32
CFR Cluj,5108,2,5,6,3,14,11,3,21
D Bucuresti,5108,3,5,4,5,22,19,3,19
Universitate,5108,4,4,5,5,16,22,-6,17
FC Botosani,5108,5,4,4,6,7,16,-9,16
Concordia Ch,5108,6,2,2,10,16,25,-9,8
FCSB,5109,1,8,5,1,25,11,14,29
CFR Cluj,5109,2,6,6,2,14,9,5,24
Universitate,5109,3,4,5,5,16,20,-4,17
FC Botosani,5109,4,4,4,6,7,13,-6,16
Concordia Ch,5109,5,4,2,8,20,22,-2,14
D Bucuresti,5109,6,3,4,7,17,24,-7,13
FCSB,5110,1,8,6,0,24,10,14,30
CFR Cluj,5110,2,6,7,1,15,8,7,25
FC Botosani,5110,3,5,4,5,9,13,-4,19
Universitate,5110,4,3,5,6,15,21,-6,14
D Bucuresti,5110,5,3,4,7,16,21,-5,13
Concordia Ch,5110,6,3,2,9,18,24,-6,11
FCSB,5111,1,8,5,1,28,14,14,29
CFR Cluj,5111,2,6,7,1,16,9,7,25
D Bucuresti,5111,3,5,4,5,21,20,1,19
Universitate,5111,4,3,6,5,15,21,-6,15
FC Botosani,5111,5,3,5,6,7,16,-9,14
Concordia Ch,5111,6,2,3,9,19,26,-7,9
FCSB,5112,1,7,6,1,24,12,12,27
CFR Cluj,5112,2,7,6,1,15,7,8,27
D Bucuresti,5112,3,4,4,6,19,22,-3,16
FC Botosani,5112,4,4,4,6,8,15,-7,16
Universitate,5112,5,3,6,5,15,20,-5,15
Concordia Ch,5112,6,3,2,9,19,24,-5,11
FCSB,5113,1,8,5,1,30,15,15,29
CFR Cluj,5113,2,5,6,3,15,13,2,21
Universitate,5113,3,5,5,4,20,22,-2,20
D Bucuresti,5113,4,4,4,6,19,21,-2,16
FC Botosani,5113,5,4,4,6,7,15,-8,16
Concordia Ch,5113,6,3,2,9,19,24,-5,11
FCSB,5114,1,8,5,1,25,11,14,29
CFR Cluj,5114,2,6,6,2,14,10,4,24
Universitate,5114,3,4,5,5,17,20,-3,17
D Bucuresti,5114,4,3,6,5,18,20,-2,15
FC Botosani,5114,5,3,6,5,7,14,-7,15
Concordia Ch,5114,6,2,4,8,17,23,-6,10
FCSB,5115,1,7,6,1,24,12,12,27
CFR Cluj,5115,2,6,7,1,15,8,7,25
Universitate,5115,3,4,5,5,15,19,-4,17
FC Botosani,5115,4,4,5,5,7,13,-6,17
D Bucuresti,5115,5,3,5,6,17,21,-4,14
Concordia Ch,5115,6,3,2,9,17,22,-5,11
FCSB,5116,1,9,5,0,30,12,18,32
CFR Cluj,5116,2,5,6,3,14,12,2,21
D Bucuresti,5116,3,5,4,5,22,19,3,19
Universitate,5116,4,4,5,5,18,23,-5,17
FC Botosani,5116,5,3,5,6,7,16,-9,14
Concordia Ch,5116,6,2,3,9,16,25,-9,9
FCSB,5117,1,8,6,0,27,11,16,30
CFR Cluj,5117,2,5,8,1,15,9,6,23
D Bucuresti,5117,3,5,4,5,18,18,0,19
FC Botosani,5117,4,4,4,6,6,13,-7,16
Universitate,5117,5,3,6,5,15,22,-7,15
Concordia Ch,5117,6,2,2,10,15,23,-8,8
FCSB,5118,1,8,5,1,24,13,11,29
CFR Cluj,5118,2,5,6,3,14,10,4,21
Universitate,5118,3,5,5,4,19,19,0,20
FC Botosani,5118,4,5,4,5,9,13,-4,19
D Bucuresti,5118,5,3,5,6,16,19,-3,14
Concordia Ch,5118,6,2,3,9,16,24,-8,9
FCSB,5119,1,8,5,1,25,11,14,29
CFR Cluj,5119,2,6,6,2,16,10,6,24
Universitate,5119,3,4,5,5,16,21,-5,17
FC Botosani,5119,4,3,6,5,6,13,-7,15
D Bucuresti,5119,5,3,5,6,17,20,-3,14
Concordia Ch,5119,6,3,3,8,16,21,-5,12
FCSB,5120,1,7,6,1,24,13,11,27
CFR Cluj,5120,2,5,8,1,14,8,6,23
Universitate,5120,3,4,6,4,16,18,-2,18
D Bucuresti,5120,4,4,5,5,19,20,-1,17
FC Botosani,5120,5,3,4,7,6,15,-9,13
Concordia Ch,5120,6,3,3,8,19,24,-5,12
FCSB,5121,1,7,7,0,24,11,13,28
CFR Cluj,5121,2,6,7,1,15,8,7,25
D Bucuresti,5121,3,4,4,6,19,19,0,16
FC Botosani,5121,4,4,4,6,6,14,-8,16
Universitate,5121,5,3,6,5,14,19,-5,15
Concordia Ch,5121,6,3,2,9,17,24,-7,11
FCSB,5122,1,7,7,0,24,11,13,28
CFR Cluj,5122,2,5,7,2,14,10,4,22
FC Botosani,5122,3,5,4,5,9,12,-3,19
Universitate,5122,4,4,6,4,16,18,-2,18
D Bucuresti,5122,5,3,4,7,16,22,-6,13
Concordia Ch,5122,6,3,2,9,18,24,-6,11
FCSB,5123,1,8,6,0,27,12,15,30
CFR Cluj,5123,2,5,6,3,14,11,3,21
Universitate,5123,3,4,6,4,16,19,-3,18
FC Botosani,5123,4,4,5,5,7,12,-5,17
D Bucuresti,5123,5,3,5,6,20,24,-4,14
Concordia Ch,5123,6,2,4,8,19,25,-6,10
FCSB,5124,1,7,6,1,24,12,12,27
CFR Cluj,5124,2,6,7,1,15,8,7,25
D Bucuresti,5124,3,4,5,5,18,19,-1,17
Universitate,5124,4,3,7,4,16,20,-4,16
FC Botosani,5124,5,3,5,6,5,13,-8,14
Concordia Ch,5124,6,2,4,8,16,22,-6,10
FCSB,5125,1,7,6,1,23,11,12,27
CFR Cluj,5125,2,5,8,1,14,8,6,23
FC Botosani,5125,3,5,4,5,10,12,-2,19
Universitate,5125,4,4,6,4,16,19,-3,18
D Bucuresti,5125,5,3,5,6,16,21,-5,14
Concordia Ch,5125,6,2,3,9,15,23,-8,9
FCSB,5126,1,7,7,0,26,13,13,28
CFR Cluj,5126,2,5,7,2,14,9,5,22
Universitate,5126,3,4,6,4,17,20,-3,18
FC Botosani,5126,4,4,5,5,7,13,-6,17
D Bucuresti,5126,5,4,4,6,19,19,0,16
Concordia Ch,5126,6,2,3,9,16,25,-9,9
FCSB,5127,1,8,6,0,25,11,14,30
CFR Cluj,5127,2,5,6,3,14,10,4,21
D Bucuresti,5127,3,5,4,5,20,19,1,19
Universitate,5127,4,4,6,4,17,20,-3,18
FC Botosani,5127,5,3,4,7,8,17,-9,13
Concordia Ch,5127,6,3,2,9,18,25,-7,11
FCSB,5128,1,7,6,1,23,11,12,27
CFR Cluj,5128,2,6,7,1,15,7,8,25
FC Botosani,5128,3,5,4,5,10,12,-2,19
Universitate,5128,4,4,5,5,15,20,-5,17
D Bucuresti,5128,5,3,5,6,16,21,-5,14
Concordia Ch,5128,6,2,3,9,15,23,-8,9
FCSB,5129,1,9,5,0,27,10,17,32
CFR Cluj,5129,2,5,7,2,14,10,4,22
D Bucuresti,5129,3,4,5,5,19,19,0,17
Universitate,5129,4,3,6,5,15,21,-6,15
FC Botosani,5129,5,3,4,7,6,16,-10,13
Concordia Ch,5129,6,3,3,8,18,23,-5,12
FCSB,5130,1,7,5,2,23,16,7,26
CFR Cluj,5130,2,6,7,1,16,7,9,25
Universitate,5130,3,4,6,4,17,18,-1,18
D Bucuresti,5130,4,4,5,5,18,19,-1,17
FC Botosani,5130,5,3,5,6,5,13,-8,14
Concordia Ch,5130,6,2,4,8,16,22,-6,10
FCSB,5131,1,8,6,0,26,12,14,30
CFR Cluj,5131,2,5,7,2,16,11,5,22
D Bucuresti,5131,3,4,5,5,21,19,2,17
Universitate,5131,4,3,7,4,15,19,-4,16
FC Botosani,5131,5,3,5,6,6,15,-9,14
Concordia Ch,5131,6,3,2,9,17,25,-8,11
FCSB,5132,1,7,6,1,25,13,12,27
CFR Cluj,5132,2,5,7,2,15,11,4,22
Universitate,5132,3,5,5,4,19,20,-1,20
D Bucuresti,5132,4,4,5,5,19,19,0,17
FC Botosani,5132,5,3,4,7,5,15,-10,13
Concordia Ch,5132,6,3,3,8,17,22,-5,12
FCSB,5133,1,9,5,0,26,11,15,32
CFR Cluj,5133,2,6,6,2,16,9,7,24
D Bucuresti,5133,3,4,4,6,17,20,-3,16
FC Botosani,5133,4,4,4,6,8,13,-5,16
Universitate,5133,5,3,5,6,16,23,-7,14
Concordia Ch,5133,6,3,2,9,17,24,-7,11
FCSB,5134,1,7,5,2,24,13,11,26
CFR Cluj,5134,2,6,7,1,14,7,7,25
Universitate,5134,3,4,6,4,16,19,-3,18
D Bucuresti,5134,4,4,4,6,19,21,-2,16
FC Botosani,5134,5,3,5,6,5,14,-9,14
Concordia Ch,5134,6,3,3,8,18,22,-4,12
FCSB,5135,1,7,6,1,25,13,12,27
CFR Cluj,5135,2,6,7,1,16,9,7,25
Universitate,5135,3,4,5,5,15,19,-4,17
D Bucuresti,5135,4,3,5,6,17,20,-3,14
Concordia Ch,5135,5,4,2,8,17,21,-4,14
FC Botosani,5135,6,3,5,6,6,14,-8,14
FCSB,5136,1,7,7,0,25,12,13,28
CFR Cluj,5136,2,6,7,1,18,10,8,25
D Bucuresti,5136,3,4,5,5,19,19,0,17
Universitate,5136,4,3,6,5,15,21,-6,15
FC Botosani,5136,5,3,5,6,6,15,-9,14
Concordia Ch,5136,6,2,4,8,15,21,-6,10
FCSB,5137,1,7,5,2,23,12,11,26
CFR Cluj,5137,2,6,7,1,18,11,7,25
Universitate,5137,3,4,6,4,19,22,-3,18
D Bucuresti,5137,4,4,4,6,18,21,-3,16
Concordia Ch,5137,5,4,2,8,19,22,-3,14
FC Botosani,5137,6,3,4,7,5,14,-9,13
FCSB,5138,1,8,6,0,27,11,16,30
CFR Cluj,5138,2,5,6,3,14,13,1,21
Universitate,5138,3,4,6,4,18,20,-2,18
D Bucuresti,5138,4,4,4,6,17,21,-4,16
FC Botosani,5138,5,3,5,6,6,14,-8,14
Concordia Ch,5138,6,3,3,8,19,22,-3,12
FCSB,5139,1,9,5,0,26,11,15,32
CFR Cluj,5139,2,5,7,2,13,8,5,22
D Bucuresti,5139,3,4,5,5,17,18,-1,17
Universitate,5139,4,3,6,5,15,20,-5,15
FC Botosani,5139,5,3,4,7,5,15,-10,13
Concordia Ch,5139,6,3,3,8,17,21,-4,12
FCSB,5140,1,8,6,0,28,12,16,30
CFR Cluj,5140,2,5,7,2,16,11,5,22
Universitate,5140,3,4,5,5,18,24,-6,17
D Bucuresti,5140,4,4,4,6,21,22,-1,16
FC Botosani,5140,5,4,4,6,8,18,-10,16
Concordia Ch,5140,6,3,2,9,19,23,-4,11
FCSB,5141,1,8,6,0,26,11,15,30
CFR Cluj,5141,2,6,6,2,15,10,5,24
Universitate,5141,3,3,6,5,16,21,-5,15
FC Botosani,5141,4,3,6,5,7,14,-7,15
D Bucuresti,5141,5,3,5,6,17,21,-4,14
Concordia Ch,5141,6,3,3,8,18,22,-4,12
FCSB,5142,1,7,6,1,25,13,12,27
CFR Cluj,5142,2,5,8,1,15,9,6,23
Universitate,5142,3,4,6,4,17,20,-3,18
Concordia Ch,5142,4,4,2,8,21,22,-1,14
D Bucuresti,5142,5,3,5,6,18,24,-6,14
FC Botosani,5142,6,3,5,6,6,14,-8,14
FCSB,5143,1,7,6,1,24,13,11,27
CFR Cluj,5143,2,6,7,1,17,9,8,25
D Bucuresti,5143,3,4,4,6,18,20,-2,16
Universitate,5143,4,3,7,4,17,21,-4,16
FC Botosani,5143,5,4,4,6,8,14,-6,16
Concordia Ch,5143,6,3,2,9,16,23,-7,11
FCSB,5144,1,7,6,1,24,13,11,27
CFR Cluj,5144,2,5,8,1,15,9,6,23
Universitate,5144,3,4,6,4,17,19,-2,18
D Bucuresti,5144,4,3,5,6,16,19,-3,14
Concordia Ch,5144,5,4,2,8,17,21,-4,14
FC Botosani,5144,6,3,5,6,5,13,-8,14
FCSB,5145,1,8,5,1,25,13,12,29
CFR Cluj,5145,2,6,7,1,18,10,8,25
FC Botosani,5145,3,4,5,5,7,12,-5,17
Universitate,5145,4,3,6,5,16,21,-5,15
D Bucuresti,5145,5,3,5,6,19,22,-3,14
Concordia Ch,5145,6,3,2,9,19,26,-7,11
FCSB,5146,1,7,6,1,24,13,11,27
CFR Cluj,5146,2,5,7,2,16,11,5,22
Universitate,5146,3,5,5,4,19,20,-1,20
D Bucuresti,5146,4,4,4,6,19,20,-1,16
FC Botosani,5146,5,4,4,6,7,15,-8,16
Concordia Ch,5146,6,3,2,9,18,24,-6,11
FCSB,5147,1,9,5,0,28,11,17,32
CFR Cluj,5147,2,6,6,2,15,11,4,24
D Bucuresti,5147,3,4,5,5,17,18,-1,17
Universitate,5147,4,3,5,6,16,22,-6,14
FC Botosani,5147,5,3,5,6,5,14,-9,14
Concordia Ch,5147,6,3,2,9,17,22,-5,11
FCSB,5148,1,7,6,1,23,12,11,27
CFR Cluj,5148,2,6,7,1,18,9,9,25
Universitate,5148,3,4,5,5,18,23,-5,17
D Bucuresti,5148,4,4,4,6,21,22,-1,16
FC Botosani,5148,5,4,4,6,7,15,-8,16
Concordia Ch,5148,6,3,2,9,18,24,-6,11
FCSB,5149,1,8,5,1,25,12,13,29
CFR Cluj,5149,2,6,6,2,14,9,5,24
D Bucuresti,5149,3,4,5,5,21,22,-1,17
Universitate,5149,4,4,5,5,16,19,-3,17
FC Botosani,5149,5,4,5,5,9,13,-4,17
Concordia Ch,5149,6,2,2,10,18,28,-10,8
FCSB,5150,1,8,5,1,25,12,13,29
CFR Cluj,5150,2,6,6,2,18,9,9,24
D Bucuresti,5150,3,4,5,5,19,20,-1,17
FC Botosani,5150,4,4,5,5,8,13,-5,17
Universitate,5150,5,4,5,5,17,24,-7,17
Concordia Ch,5150,6,2,2,10,18,27,-9,8
FCSB,5151,1,9,5,0,27,10,17,32
CFR Cluj,5151,2,6,6,2,15,9,6,24
Concordia Ch,5151,3,4,2,8,19,22,-3,14
D Bucuresti,5151,4,3,5,6,16,20,-4,14
Universitate,5151,5,3,5,6,15,23,-8,14
FC Botosani,5151,6,3,5,6,6,14,-8,14
FCSB,5152,1,9,5,0,26,10,16,32
CFR Cluj,5152,2,6,6,2,15,10,5,24
D Bucuresti,5152,3,5,4,5,21,18,3,19
Universitate,5152,4,3,5,6,15,21,-6,14
FC Botosani,5152,5,3,5,6,5,15,-10,14
Concordia Ch,5152,6,2,3,9,15,23,-8,9
FCSB,5153,1,8,5,1,25,11,14,29
CFR Cluj,5153,2,7,6,1,15,7,8,27
D Bucuresti,5153,3,5,4,5,19,18,1,19
FC Botosani,5153,4,4,4,6,7,14,-7,16
Universitate,5153,5,3,5,6,14,21,-7,14
Concordia Ch,5153,6,2,2,10,15,24,-9,8
FCSB,5154,1,7,7,0,25,12,13,28
CFR Cluj,5154,2,6,7,1,18,9,9,25
D Bucuresti,5154,3,4,4,6,18,21,-3,16
Universitate,5154,4,3,6,5,16,23,-7,15
Concordia Ch,5154,5,4,2,8,20,23,-3,14
FC Botosani,5154,6,3,4,7,6,15,-9,13
FCSB,5155,1,8,6,0,27,11,16,30
CFR Cluj,5155,2,5,7,2,13,8,5,22
D Bucuresti,5155,3,4,5,5,19,20,-1,17
Universitate,5155,4,4,5,5,16,22,-6,17
FC Botosani,5155,5,3,5,6,5,13,-8,14
Concordia Ch,5155,6,2,4,8,17,23,-6,10
FCSB,5156,1,9,5,0,28,11,17,32
CFR Cluj,5156,2,6,6,2,17,11,6,24
FC Botosani,5156,3,4,4,6,7,15,-8,16
Concordia Ch,5156,4,4,2,8,19,22,-3,14
Universitate,5156,5,3,5,6,16,24,-8,14
D Bucuresti,5156,6,3,4,7,18,22,-4,13
FCSB,5157,1,8,6,0,26,12,14,30
CFR Cluj,5157,2,5,6,3,14,10,4,21
D Bucuresti,5157,3,5,4,5,19,19,0,19
Universitate,5157,4,4,6,4,16,19,-3,18
FC Botosani,5157,5,3,4,7,6,15,-9,13
Concordia Ch,5157,6,3,2,9,18,24,-6,11
FCSB,5158,1,9,5,0,28,10,18,32
CFR Cluj,5158,2,5,6,3,13,10,3,21
Universitate,5158,3,4,5,5,15,21,-6,17
Concordia Ch,5158,4,4,2,8,18,21,-3,14
D Bucuresti,5158,5,3,5,6,16,20,-4,14
FC Botosani,5158,6,3,5,6,5,13,-8,14
FCSB,5159,1,8,5,1,26,13,13,29
CFR Cluj,5159,2,5,7,2,14,10,4,22
Universitate,5159,3,4,6,4,16,18,-2,18
FC Botosani,5159,4,4,5,5,10,16,-6,17
D Bucuresti,5159,5,3,5,6,19,22,-3,14
Concordia Ch,5159,6,3,2,9,19,25,-6,11
FCSB,5160,1,7,7,0,23,10,13,28
CFR Cluj,5160,2,6,7,1,16,8,8,25
Universitate,5160,3,3,6,5,15,21,-6,15
FC Botosani,5160,4,3,6,5,5,12,-7,15
D Bucuresti,5160,5,3,5,6,16,19,-3,14
Concordia Ch,5160,6,3,3,8,16,21,-5,12
FCSB,5161,1,7,6,1,25,14,11,27
CFR Cluj,5161,2,6,7,1,16,8,8,25
D Bucuresti,5161,3,4,5,5,23,21,2,17
Universitate,5161,4,3,7,4,17,21,-4,16
FC Botosani,5161,5,3,4,7,6,18,-12,13
Concordia Ch,5161,6,3,3,8,20,25,-5,12
FCSB,5162,1,9,5,0,26,10,16,32
CFR Cluj,5162,2,6,6,2,15,9,6,24
D Bucuresti,5162,3,4,5,5,18,19,-1,17
FC Botosani,5162,4,3,6,5,6,13,-7,15
Universitate,5162,5,3,5,6,14,21,-7,14
Concordia Ch,5162,6,2,3,9,17,24,-7,9
FCSB,5163,1,8,5,1,26,14,12,29
CFR Cluj,5163,2,5,6,3,14,10,4,21
Universitate,5163,3,5,5,4,18,19,-1,20
FC Botosani,5163,4,5,4,5,9,14,-5,19
D Bucuresti,5163,5,3,4,7,16,20,-4,13
Concordia Ch,5163,6,3,2,9,18,24,-6,11
FCSB,5164,1,8,5,1,25,12,13,29
CFR Cluj,5164,2,5,7,2,15,10,5,22
Universitate,5164,3,4,6,4,18,21,-3,18
FC Botosani,5164,4,4,5,5,8,12,-4,17
D Bucuresti,5164,5,3,6,5,17,19,-2,15
Concordia Ch,5164,6,2,3,9,16,25,-9,9
FCSB,5165,1,8,5,1,27,12,15,29
CFR Cluj,5165,2,5,6,3,14,12,2,21
Universitate,5165,3,5,5,4,16,18,-2,20
D Bucuresti,5165,4,4,5,5,21,21,0,17
FC Botosani,5165,5,4,4,6,7,15,-8,16
Concordia Ch,5165,6,2,3,9,17,24,-7,9
FCSB,5166,1,7,6,1,25,13,12,27
CFR Cluj,5166,2,7,6,1,18,8,10,27
D Bucuresti,5166,3,4,4,6,18,20,-2,16
Universitate,5166,4,3,6,5,15,22,-7,15
Concordia Ch,5166,5,4,2,8,17,21,-4,14
FC Botosani,5166,6,3,4,7,6,15,-9,13
FCSB,5167,1,7,6,1,25,15,10,27
CFR Cluj,5167,2,5,7,2,14,10,4,22
Universitate,5167,3,5,5,4,20,19,1,20
D Bucuresti,5167,4,5,4,5,20,19,1,19
FC Botosani,5167,5,3,4,7,7,16,-9,13
Concordia Ch,5167,6,3,2,9,17,24,-7,11
FCSB,5168,1,8,6,0,24,10,14,30
CFR Cluj,5168,2,5,6,3,13,10,3,21
Universitate,5168,3,4,6,4,16,18,-2,18
FC Botosani,5168,4,3,6,5,7,14,-7,15
D Bucuresti,5168,5,3,5,6,18,21,-3,14
Concordia Ch,5168,6,3,3,8,20,25,-5,12
FCSB,5169,1,8,5,1,26,11,15,29
CFR Cluj,5169,2,7,6,1,18,7,11,27
D Bucuresti,5169,3,4,5,5,19,19,0,17
FC Botosani,5169,4,4,4,6,7,15,-8,16
Universitate,5169,5,3,5,6,14,25,-11,14
Concordia Ch,5169,6,2,3,9,17,24,-7,9
FCSB,5170,1,9,5,0,30,13,17,32
CFR Cluj,5170,2,5,7,2,16,13,3,22
D Bucuresti,5170,3,4,4,6,17,20,-3,16
FC Botosani,5170,4,4,4,6,6,13,-7,16
Universitate,5170,5,3,6,5,16,21,-5,15
Concordia Ch,5170,6,3,2,9,17,22,-5,11
FCSB,5171,1,9,5,0,27,12,15,32
CFR Cluj,5171,2,5,6,3,14,10,4,21
D Bucuresti,5171,3,4,5,5,17,18,-1,17
Universitate,5171,4,4,5,5,18,22,-4,17
FC Botosani,5171,5,3,4,7,8,18,-10,13
Concordia Ch,5171,6,3,3,8,20,24,-4,12
FCSB,5172,1,8,5,1,24,12,12,29
CFR Cluj,5172,2,6,6,2,15,9,6,24
D Bucuresti,5172,3,4,5,5,20,20,0,17
Universitate,5172,4,4,5,5,17,20,-3,17
FC Botosani,5172,5,3,5,6,7,15,-8,14
Concordia Ch,5172,6,3,2,9,16,23,-7,11
FCSB,5173,1,8,5,1,25,13,12,29
CFR Cluj,5173,2,6,6,2,15,9,6,24
Universitate,5173,3,4,5,5,17,20,-3,17
D Bucuresti,5173,4,4,4,6,18,20,-2,16
FC Botosani,5173,5,4,4,6,7,14,-7,16
Concordia Ch,5173,6,3,2,9,18,24,-6,11
FCSB,5174,1,8,6,0,26,11,15,30
CFR Cluj,5174,2,6,6,2,16,10,6,24
D Bucuresti,5174,3,5,4,5,20,19,1,19
FC Botosani,5174,4,4,4,6,9,14,-5,16
Universitate,5174,5,3,6,5,16,22,-6,15
Concordia Ch,5174,6,2,2,10,15,26,-11,8
FCSB,5175,1,8,6,0,26,12,14,30
CFR Cluj,5175,2,6,7,1,16,8,8,25
D Bucuresti,5175,3,4,4,6,17,21,-4,16
FC Botosani,5175,4,4,4,6,7,14,-7,16
Universitate,5175,5,3,5,6,17,24,-7,14
Concordia Ch,5175,6,3,2,9,19,23,-4,11
FCSB,5176,1,9,5,0,26,11,15,32
CFR Cluj,5176,2,5,7,2,13,8,5,22
Universitate,5176,3,3,6,5,15,20,-5,15
D Bucuresti,5176,4,3,5,6,17,20,-3,14
Concordia Ch,5176,5,4,2,8,18,22,-4,14
FC Botosani,5176,6,3,5,6,5,13,-8,14
FCSB,5177,1,8,5,1,28,15,13,29
CFR Cluj,5177,2,5,7,2,16,12,4,22
FC Botosani,5177,3,5,4,5,8,13,-5,19
Universitate,5177,4,4,6,4,18,20,-2,18
D Bucuresti,5177,5,3,5,6,18,21,-3,14
Concordia Ch,5177,6,2,3,9,18,25,-7,9
FCSB,5178,1,7,6,1,24,12,12,27
CFR Cluj,5178,2,5,8,1,13,7,6,23
D Bucuresti,5178,3,5,4,5,20,18,2,19
Universitate,5178,4,4,6,4,16,19,-3,18
FC Botosani,5178,5,3,4,7,6,15,-9,13
Concordia Ch,5178,6,3,2,9,17,25,-8,11
FCSB,5179,1,9,5,0,26,10,16,32
CFR Cluj,5179,2,5,7,2,13,9,4,22
D Bucuresti,5179,3,5,4,5,19,18,1,19
FC Botosani,5179,4,4,4,6,8,15,-7,16
Universitate,5179,5,3,6,5,14,19,-5,15
Concordia Ch,5179,6,2,2,10,16,25,-9,8
FCSB,5180,1,8,6,0,25,10,15,30
CFR Cluj,5180,2,6,6,2,15,9,6,24
FC Botosani,5180,3,4,5,5,8,13,-5,17
Universitate,5180,4,3,6,5,14,20,-6,15
D Bucuresti,5180,5,3,5,6,16,20,-4,14
Concordia Ch,5180,6,2,4,8,16,22,-6,10
FCSB,5181,1,7,6,1,25,13,12,27
CFR Cluj,5181,2,7,6,1,15,7,8,27
D Bucuresti,5181,3,4,5,5,17,18,-1,17
FC Botosani,5181,4,4,5,5,6,12,-6,17
Universitate,5181,5,3,6,5,16,21,-5,15
Concordia Ch,5181,6,2,2,10,15,23,-8,8
FCSB,5182,1,9,5,0,25,10,15,32
CFR Cluj,5182,2,6,6,2,15,8,7,24
FC Botosani,5182,3,4,5,5,6,12,-6,17
Universitate,5182,4,3,5,6,14,21,-7,14
D Bucuresti,5182,5,3,4,7,18,22,-4,13
Concordia Ch,5182,6,3,3,8,18,23,-5,12
FCSB,5183,1,8,5,1,24,12,12,29
CFR Cluj,5183,2,5,7,2,13,8,5,22
FC Botosani,5183,3,5,4,5,8,12,-4,19
Universitate,5183,4,4,6,4,16,18,-2,18
D Bucuresti,5183,5,3,4,7,16,22,-6,13
Concordia Ch,5183,6,3,2,9,18,23,-5,11
FCSB,5184,1,8,5,1,28,14,14,29
CFR Cluj,5184,2,5,7,2,17,14,3,22
Universitate,5184,3,4,6,4,20,22,-2,18
FC Botosani,5184,4,4,5,5,6,12,-6,17
D Bucuresti,5184,5,3,5,6,16,19,-3,14
Concordia Ch,5184,6,3,2,9,16,22,-6,11
FCSB,5185,1,7,7,0,24,11,13,28
CFR Cluj,5185,2,6,7,1,15,7,8,25
D Bucuresti,5185,3,4,4,6,21,21,0,16
FC Botosani,5185,4,4,4,6,8,18,-10,16
Universitate,5185,5,3,6,5,15,21,-6,15
Concordia Ch,5185,6,3,2,9,19,24,-5,11
FCSB,5186,1,9,5,0,28,10,18,32
CFR Cluj,5186,2,6,6,2,15,12,3,24
FC Botosani,5186,3,3,6,5,7,14,-7,15
D Bucuresti,5186,4,3,5,6,18,22,-4,14
Universitate,5186,5,3,5,6,15,21,-6,14
Concordia Ch,5186,6,3,3,8,19,23,-4,12
FCSB,5187,1,7,6,1,25,14,11,27
CFR Cluj,5187,2,5,8,1,15,9,6,23
D Bucuresti,5187,3,5,4,5,21,19,2,19
Universitate,5187,4,4,6,4,18,20,-2,18
FC Botosani,5187,5,4,4,6,7,14,-7,16
Concordia Ch,5187,6,2,2,10,16,26,-10,8
FCSB,5188,1,7,6,1,25,15,10,27
CFR Cluj,5188,2,6,7,1,16,9,7,25
D Bucuresti,5188,3,5,4,5,21,20,1,19
Universitate,5188,4,4,5,5,17,19,-2,17
FC Botosani,5188,5,3,5,6,6,15,-9,14
Concordia Ch,5188,6,2,3,9,18,25,-7,9
FCSB,5189,1,7,7,0,24,11,13,28
CFR Cluj,5189,2,5,7,2,14,11,3,22
FC Botosani,5189,3,5,4,5,8,13,-5,19
Universitate,5189,4,4,6,4,17,18,-1,18
D Bucuresti,5189,5,3,4,7,17,21,-4,13
Concordia Ch,5189,6,3,2,9,18,24,-6,11
FCSB,5190,1,9,5,0,26,11,15,32
CFR Cluj,5190,2,5,6,3,13,9,4,21
Universitate,5190,3,4,5,5,16,20,-4,17
D Bucuresti,5190,4,3,6,5,18,20,-2,15
FC Botosani,5190,5,3,6,5,7,14,-7,15
Concordia Ch,5190,6,2,4,8,17,23,-6,10
FCSB,5191,1,9,5,0,29,13,16,32
CFR Cluj,5191,2,6,6,2,17,11,6,24
D Bucuresti,5191,3,4,5,5,20,19,1,17
FC Botosani,5191,4,4,4,6,7,15,-8,16
Universitate,5191,5,3,5,6,15,22,-7,14
Concordia Ch,5191,6,2,3,9,16,24,-8,9
FCSB,5192,1,7,7,0,25,12,13,28
CFR Cluj,5192,2,5,7,2,15,10,5,22
Universitate,5192,3,4,6,4,19,22,-3,18
D Bucuresti,5192,4,4,5,5,19,20,-1,17
FC Botosani,5192,5,3,4,7,6,15,-9,13
Concordia Ch,5192,6,3,3,8,19,24,-5,12
FCSB,5193,1,7,6,1,26,14,12,27
CFR Cluj,5193,2,6,7,1,17,8,9,25
Universitate,5193,3,4,5,5,17,23,-6,17
FC Botosani,5193,4,4,5,5,9,15,-6,17
D Bucuresti,5193,5,4,4,6,20,21,-1,16
Concordia Ch,5193,6,2,3,9,16,24,-8,9
FCSB,5194,1,9,5,0,26,10,16,32
CFR Cluj,5194,2,5,7,2,15,11,4,22
D Bucuresti,5194,3,4,5,5,18,19,-1,17
FC Botosani,5194,4,4,4,6,6,13,-7,16
Universitate,5194,5,3,6,5,16,21,-5,15
Concordia Ch,5194,6,2,3,9,16,23,-7,9
FCSB,5195,1,8,6,0,25,11,14,30
CFR Cluj,5195,2,5,7,2,14,9,5,22
D Bucuresti,5195,3,5,4,5,20,18,2,19
Universitate,5195,4,3,7,4,16,20,-4,16
FC Botosani,5195,5,3,5,6,5,14,-9,14
Concordia Ch,5195,6,2,3,9,15,23,-8,9
FCSB,5196,1,9,5,0,26,10,16,32
CFR Cluj,5196,2,5,7,2,14,10,4,22
D Bucuresti,5196,3,4,4,6,17,20,-3,16
FC Botosani,5196,4,4,4,6,7,14,-7,16
Universitate,5196,5,3,6,5,15,20,-5,15
Concordia Ch,5196,6,3,2,9,18,23,-5,11
FCSB,5197,1,7,6,1,23,11,12,27
CFR Cluj,5197,2,7,6,1,16,7,9,27
D Bucuresti,5197,3,3,6,5,16,18,-2,15
Universitate,5197,4,3,6,5,14,20,-6,15
FC Botosani,5197,5,3,5,6,5,13,-8,14
Concordia Ch,5197,6,3,3,8,16,21,-5,12
FCSB,5198,1,7,7,0,25,12,13,28
CFR Cluj,5198,2,6,7,1,15,8,7,25
D Bucuresti,5198,3,4,5,5,18,18,0,17
FC Botosani,5198,4,4,4,6,7,14,-7,16
Universitate,5198,5,3,6,5,15,20,-5,15
Concordia Ch,5198,6,2,3,9,15,23,-8,9
FCSB,5199,1,9,5,0,28,13,15,32
CFR Cluj,5199,2,6,6,2,16,10,6,24
D Bucuresti,5199,3,4,4,6,18,20,-2,16
Universitate,5199,4,3,5,6,15,21,-6,14
FC Botosani,5199,5,3,5,6,6,14,-8,14
Concordia Ch,5199,6,3,3,8,18,23,-5,12
CFR Cluj,5200,1,7,6,1,19,8,11,27
FCSB,5200,2,7,5,2,24,14,10,26
Universitate,5200,3,4,5,5,15,21,-6,17
D Bucuresti,5200,4,4,4,6,19,21,-2,16
FC Botosani,5200,5,3,5,6,7,16,-9,14
Concordia Ch,5200,6,3,3,8,18,22,-4,12
FCSB,5201,1,8,5,1,26,12,14,29
CFR Cluj,5201,2,5,6,3,13,11,2,21
Universitate,5201,3,5,5,4,17,18,-1,20
D Bucuresti,5201,4,4,4,6,17,20,-3,16
FC Botosani,5201,5,4,4,6,8,14,-6,16
Concordia Ch,5201,6,3,2,9,17,23,-6,11
FCSB,5202,1,9,5,0,27,11,16,32
CFR Cluj,5202,2,6,6,2,17,10,7,24
D Bucuresti,5202,3,4,4,6,20,21,-1,16
FC Botosani,5202,4,4,4,6,7,15,-8,16
Universitate,5202,5,3,5,6,16,24,-8,14
Concordia Ch,5202,6,3,2,9,17,23,-6,11
CFR Cluj,5203,1,7,6,1,15,7,8,27
FCSB,5203,2,7,5,2,24,15,9,26
FC Botosani,5203,3,5,4,5,8,13,-5,19
Universitate,5203,4,4,5,5,18,20,-2,17
D Bucuresti,5203,5,3,5,6,19,22,-3,14
Concordia Ch,5203,6,2,3,9,17,24,-7,9
FCSB,5204,1,7,6,1,24,12,12,27
CFR Cluj,5204,2,5,8,1,14,8,6,23
FC Botosani,5204,3,5,4,5,10,12,-2,19
Universitate,5204,4,4,6,4,15,18,-3,18
D Bucuresti,5204,5,4,4,6,18,21,-3,16
Concordia Ch,5204,6,2,2,10,15,25,-10,8
FCSB,5205,1,8,5,1,26,13,13,29
CFR Cluj,5205,2,5,7,2,13,9,4,22
Universitate,5205,3,4,6,4,17,19,-2,18
Concordia Ch,5205,4,4,2,8,21,22,-1,14
D Bucuresti,5205,5,3,5,6,18,22,-4,14
FC Botosani,5205,6,3,5,6,8,18,-10,14
FCSB,5206,1,7,6,1,26,14,12,27
CFR Cluj,5206,2,6,7,1,17,10,7,25
D Bucuresti,5206,3,5,4,5,21,18,3,19
Universitate,5206,4,4,5,5,19,23,-4,17
FC Botosani,5206,5,3,5,6,6,16,-10,14
Concordia Ch,5206,6,2,3,9,16,24,-8,9
FCSB,5207,1,8,6,0,25,11,14,30
CFR Cluj,5207,2,6,6,2,16,9,7,24
D Bucuresti,5207,3,4,5,5,20,20,0,17
Universitate,5207,4,3,6,5,14,20,-6,15
FC Botosani,5207,5,3,5,6,7,15,-8,14
Concordia Ch,5207,6,3,2,9,18,25,-7,11
FCSB,5208,1,8,5,1,25,12,13,29
CFR Cluj,5208,2,6,7,1,16,9,7,25
D Bucuresti,5208,3,5,4,5,19,18,1,19
Universitate,5208,4,3,6,5,15,20,-5,15
FC Botosani,5208,5,3,4,7,5,15,-10,13
Concordia Ch,5208,6,3,2,9,17,23,-6,11
FCSB,5209,1,7,7,0,25,12,13,28
CFR Cluj,5209,2,6,7,1,16,9,7,25
FC Botosani,5209,3,4,5,5,8,12,-4,17
D Bucuresti,5209,4,4,4,6,17,21,-4,16
Universitate,5209,5,3,6,5,16,21,-5,15
Concordia Ch,5209,6,2,3,9,15,22,-7,9
FCSB,5210,1,7,6,1,25,14,11,27
CFR Cluj,5210,2,6,7,1,16,9,7,25
D Bucuresti,5210,3,4,5,5,21,21,0,17
Universitate,5210,4,4,5,5,18,21,-3,17
FC Botosani,5210,5,3,4,7,7,17,-10,13
Concordia Ch,5210,6,3,3,8,19,24,-5,12
FCSB,5211,1,7,6,1,24,14,10,27
CFR Cluj,5211,2,7,6,1,18,8,10,27
D Bucuresti,5211,3,4,5,5,19,19,0,17
Universitate,5211,4,3,6,5,16,21,-5,15
FC Botosani,5211,5,3,6,5,6,13,-7,15
Concordia Ch,5211,6,2,3,9,15,23,-8,9
FCSB,5212,1,8,6,0,27,10,17,30
CFR Cluj,5212,2,6,6,2,14,11,3,24
D Bucuresti,5212,3,4,4,6,21,20,1,16
Universitate,5212,4,3,6,5,14,19,-5,15
FC Botosani,5212,5,3,5,6,6,17,-11,14
Concordia Ch,5212,6,3,3,8,16,21,-5,12
FCSB,5213,1,9,5,0,28,10,18,32
CFR Cluj,5213,2,6,6,2,17,10,7,24
FC Botosani,5213,3,4,5,5,6,12,-6,17
D Bucuresti,5213,4,4,4,6,18,19,-1,16
Universitate,5213,5,3,5,6,15,25,-10,14
Concordia Ch,5213,6,2,3,9,15,23,-8,9
FCSB,5214,1,8,5,1,27,14,13,29
CFR Cluj,5214,2,7,6,1,18,9,9,27
D Bucuresti,5214,3,4,4,6,18,19,-1,16
Concordia Ch,5214,4,4,2,8,17,21,-4,14
Universitate,5214,5,3,5,6,15,22,-7,14
FC Botosani,5214,6,3,4,7,5,15,-10,13
FCSB,5215,1,8,5,1,27,15,12,29
CFR Cluj,5215,2,7,6,1,18,8,10,27
D Bucuresti,5215,3,4,5,5,20,20,0,17
Universitate,5215,4,3,5,6,16,23,-7,14
FC Botosani,5215,5,3,4,7,6,16,-10,13
Concordia Ch,5215,6,3,3,8,17,22,-5,12
FCSB,5216,1,8,6,0,28,14,14,30
CFR Cluj,5216,2,5,8,1,16,10,6,23
D Bucuresti,5216,3,4,5,5,23,21,2,17
Universitate,5216,4,3,6,5,15,20,-5,15
FC Botosani,5216,5,3,4,7,7,21,-14,13
Concordia Ch,5216,6,3,3,8,21,24,-3,12
FCSB,5217,1,9,5,0,29,12,17,32
CFR Cluj,5217,2,6,6,2,16,11,5,24
D Bucuresti,5217,3,4,4,6,18,20,-2,16
FC Botosani,5217,4,4,4,6,6,13,-7,16
Universitate,5217,5,3,5,6,16,23,-7,14
Concordia Ch,5217,6,3,2,9,17,23,-6,11
FCSB,5218,1,8,5,1,26,14,12,29
CFR Cluj,5218,2,6,7,1,16,8,8,25
D Bucuresti,5218,3,3,6,5,18,20,-2,15
Universitate,5218,4,3,6,5,15,20,-5,15
FC Botosani,5218,5,3,5,6,6,14,-8,14
Concordia Ch,5218,6,3,3,8,17,22,-5,12
FCSB,5219,1,8,5,1,25,11,14,29
CFR Cluj,5219,2,6,6,2,16,10,6,24
Universitate,5219,3,4,5,5,16,21,-5,17
Concordia Ch,5219,4,4,2,8,19,22,-3,14
D Bucuresti,5219,5,3,5,6,17,20,-3,14
FC Botosani,5219,6,3,5,6,5,14,-9,14
FCSB,5220,1,8,5,1,28,12,16,29
CFR Cluj,5220,2,6,7,1,16,8,8,25
FC Botosani,5220,3,5,4,5,8,12,-4,19
D Bucuresti,5220,4,4,4,6,17,19,-2,16
Universitate,5220,5,3,6,5,15,24,-9,15
Concordia Ch,5220,6,2,2,10,15,24,-9,8
FCSB,5221,1,9,5,0,26,11,15,32
CFR Cluj,5221,2,6,6,2,15,9,6,24
D Bucuresti,5221,3,4,5,5,19,20,-1,17
FC Botosani,5221,4,4,5,5,7,13,-6,17
Universitate,5221,5,3,5,6,14,20,-6,14
Concordia Ch,5221,6,2,2,10,16,24,-8,8
FCSB,5222,1,9,5,0,27,11,16,32
CFR Cluj,5222,2,6,6,2,14,8,6,24
FC Botosani,5222,3,3,6,5,5,12,-7,15
D Bucuresti,5222,4,3,5,6,16,22,-6,14
Universitate,5222,5,3,5,6,15,22,-7,14
Concordia Ch,5222,6,3,3,8,19,21,-2,12
FCSB,5223,1,7,6,1,24,12,12,27
CFR Cluj,5223,2,6,6,2,15,10,5,24
Universitate,5223,3,4,6,4,16,18,-2,18
D Bucuresti,5223,4,4,4,6,19,21,-2,16
FC Botosani,5223,5,4,4,6,8,15,-7,16
Concordia Ch,5223,6,3,2,9,17,23,-6,11
FCSB,5224,1,7,5,2,23,14,9,26
CFR Cluj,5224,2,6,7,1,16,8,8,25
Universitate,5224,3,4,6,4,17,19,-2,18
FC Botosani,5224,4,3,6,5,6,13,-7,15
D Bucuresti,5224,5,3,5,6,16,20,-4,14
Concordia Ch,5224,6,3,3,8,18,22,-4,12
FCSB,5225,1,7,5,2,24,14,10,26
CFR Cluj,5225,2,6,7,1,16,9,7,25
D Bucuresti,5225,3,5,4,5,19,19,0,19
Universitate,5225,4,4,6,4,17,19,-2,18
FC Botosani,5225,5,4,4,6,8,14,-6,16
Concordia Ch,5225,6,2,2,10,15,24,-9,8
FCSB,5226,1,8,5,1,25,12,13,29
CFR Cluj,5226,2,6,6,2,16,9,7,24
D Bucuresti,5226,3,4,5,5,19,18,1,17
Universitate,5226,4,4,5,5,15,20,-5,17
FC Botosani,5226,5,3,4,7,5,17,-12,13
Concordia Ch,5226,6,3,3,8,17,21,-4,12
FCSB,5227,1,8,6,0,26,11,15,30
CFR Cluj,5227,2,6,7,1,15,8,7,25
FC Botosani,5227,3,4,4,6,6,14,-8,16
Concordia Ch,5227,4,4,2,8,18,21,-3,14
Universitate,5227,5,3,5,6,14,21,-7,14
D Bucuresti,5227,6,3,4,7,16,20,-4,13
CFR Cluj,5228,1,7,6,1,15,7,8,27
FCSB,5228,2,7,5,2,23,17,6,26
Universitate,5228,3,4,5,5,20,19,1,17
D Bucuresti,5228,4,4,5,5,19,20,-1,17
FC Botosani,5228,5,4,5,5,9,13,-4,17
Concordia Ch,5228,6,2,2,10,16,26,-10,8
FCSB,5229,1,8,5,1,25,12,13,29
CFR Cluj,5229,2,5,7,2,14,9,5,22
Universitate,5229,3,4,6,4,17,20,-3,18
D Bucuresti,5229,4,4,5,5,21,21,0,17
FC Botosani,5229,5,3,6,5,7,14,-7,15
Concordia Ch,5229,6,2,3,9,18,26,-8,9
FCSB,5230,1,8,6,0,26,11,15,30
CFR Cluj,5230,2,6,7,1,16,8,8,25
D Bucuresti,5230,3,4,4,6,21,22,-1,16
FC Botosani,5230,4,4,4,6,8,16,-8,16
Universitate,5230,5,3,5,6,14,22,-8,14
Concordia Ch,5230,6,3,2,9,19,25,-6,11
FCSB,5231,1,9,5,0,27,10,17,32
CFR Cluj,5231,2,5,7,2,14,10,4,22
Universitate,5231,3,3,6,5,15,21,-6,15
FC Botosani,5231,4,3,6,5,7,14,-7,15
D Bucuresti,5231,5,3,5,6,18,23,-5,14
Concordia Ch,5231,6,3,3,8,18,21,-3,12
FCSB,5232,1,8,6,0,27,12,15,30
CFR Cluj,5232,2,5,7,2,15,11,4,22
D Bucuresti,5232,3,4,4,6,17,19,-2,16
Universitate,5232,4,3,7,4,16,20,-4,16
FC Botosani,5232,5,4,4,6,9,14,-5,16
Concordia Ch,5232,6,3,2,9,17,25,-8,11
FCSB,5233,1,8,6,0,26,10,16,30
CFR Cluj,5233,2,5,7,2,13,9,4,22
Universitate,5233,3,4,5,5,16,21,-5,17
D Bucuresti,5233,4,4,4,6,19,20,-1,16
FC Botosani,5233,5,4,4,6,8,16,-8,16
Concordia Ch,5233,6,3,2,9,19,25,-6,11
FCSB,5234,1,8,6,0,27,13,14,30
CFR Cluj,5234,2,5,7,2,15,10,5,22
D Bucuresti,5234,3,4,4,6,18,20,-2,16
Universitate,5234,4,3,7,4,17,21,-4,16
FC Botosani,5234,5,3,5,6,5,13,-8,14
Concordia Ch,5234,6,3,3,8,17,22,-5,12
FCSB,5235,1,9,5,0,25,10,15,32
CFR Cluj,5235,2,5,7,2,13,8,5,22
D Bucuresti,5235,3,4,4,6,19,24,-5,16
FC Botosani,5235,4,4,4,6,8,16,-8,16
Universitate,5235,5,3,6,5,14,19,-5,15
Concordia Ch,5235,6,3,2,9,21,23,-2,11
FCSB,5236,1,8,6,0,24,10,14,30
CFR Cluj,5236,2,6,7,1,14,7,7,25
D Bucuresti,5236,3,5,4,5,20,19,1,19
FC Botosani,5236,4,4,4,6,8,14,-6,16
Universitate,5236,5,3,5,6,14,20,-6,14
Concordia Ch,5236,6,2,2,10,16,26,-10,8
FCSB,5237,1,8,6,0,26,12,14,30
CFR Cluj,5237,2,6,6,2,16,8,8,24
Universitate,5237,3,3,6,5,16,23,-7,15
D Bucuresti,5237,4,3,5,6,19,22,-3,14
Concordia Ch,5237,5,4,2,8,20,24,-4,14
FC Botosani,5237,6,3,5,6,7,15,-8,14
FCSB,5238,1,8,6,0,25,11,14,30
CFR Cluj,5238,2,5,7,2,15,10,5,22
D Bucuresti,5238,3,5,4,5,21,20,1,19
Universitate,5238,4,3,7,4,15,19,-4,16
FC Botosani,5238,5,3,5,6,7,15,-8,14
Concordia Ch,5238,6,2,3,9,17,25,-8,9
FCSB,5239,1,9,5,0,28,11,17,32
CFR Cluj,5239,2,6,6,2,16,9,7,24
FC Botosani,5239,3,4,5,5,7,13,-6,17
D Bucuresti,5239,4,3,5,6,16,19,-3,14
Universitate,5239,5,3,5,6,15,24,-9,14
Concordia Ch,5239,6,3,2,9,17,23,-6,11
FCSB,5240,1,8,6,0,27,13,14,30
CFR Cluj,5240,2,5,8,1,15,9,6,23
D Bucuresti,5240,3,5,4,5,20,20,0,19
Universitate,5240,4,3,6,5,17,22,-5,15
FC Botosani,5240,5,3,5,6,6,14,-8,14
Concordia Ch,5240,6,2,3,9,16,23,-7,9
FCSB,5241,1,8,5,1,25,11,14,29
CFR Cluj,5241,2,7,6,1,15,7,8,27
D Bucuresti,5241,3,4,4,6,18,20,-2,16
FC Botosani,5241,4,4,4,6,9,14,-5,16
Universitate,5241,5,3,5,6,14,21,-7,14
Concordia Ch,5241,6,3,2,9,16,24,-8,11
FCSB,5242,1,8,5,1,26,13,13,29
CFR Cluj,5242,2,5,6,3,14,10,4,21
Universitate,5242,3,5,5,4,19,21,-2,20
FC Botosani,5242,4,5,4,5,9,14,-5,19
D Bucuresti,5242,5,4,4,6,19,20,-1,16
Concordia Ch,5242,6,2,2,10,16,25,-9,8
FCSB,5243,1,8,6,0,25,11,14,30
CFR Cluj,5243,2,5,8,1,15,9,6,23
D Bucuresti,5243,3,4,5,5,18,19,-1,17
FC Botosani,5243,4,4,4,6,8,15,-7,16
Universitate,5243,5,3,6,5,17,22,-5,15
Concordia Ch,5243,6,2,3,9,18,25,-7,9
FCSB,5244,1,9,5,0,27,12,15,32
CFR Cluj,5244,2,5,6,3,15,11,4,21
D Bucuresti,5244,3,4,5,5,20,19,1,17
Universitate,5244,4,4,5,5,17,21,-4,17
FC Botosani,5244,5,3,6,5,7,14,-7,15
Concordia Ch,5244,6,2,3,9,16,25,-9,9
FCSB,5245,1,7,6,1,23,12,11,27
CFR Cluj,5245,2,6,7,1,15,8,7,25
FC Botosani,5245,3,5,4,5,9,14,-5,19
Universitate,5245,4,4,5,5,17,20,-3,17
D Bucuresti,5245,5,3,5,6,18,21,-3,14
Concordia Ch,5245,6,2,3,9,17,24,-7,9
FCSB,5246,1,9,5,0,28,12,16,32
CFR Cluj,5246,2,5,7,2,14,9,5,22
FC Botosani,5246,3,4,5,5,6,12,-6,17
Universitate,5246,4,3,6,5,17,23,-6,15
D Bucuresti,5246,5,3,5,6,16,20,-4,14
Concordia Ch,5246,6,3,2,9,17,22,-5,11
FCSB,5247,1,8,6,0,27,11,16,30
CFR Cluj,5247,2,6,6,2,15,10,5,24
D Bucuresti,5247,3,5,4,5,25,20,5,19
Universitate,5247,4,3,6,5,15,21,-6,15
FC Botosani,5247,5,3,5,6,8,19,-11,14
Concordia Ch,5247,6,2,3,9,18,27,-9,9
FCSB,5248,1,9,5,0,28,10,18,32
CFR Cluj,5248,2,6,6,2,15,11,4,24
D Bucuresti,5248,3,4,5,5,19,20,-1,17
FC Botosani,5248,4,3,6,5,6,13,-7,15
Universitate,5248,5,3,5,6,14,21,-7,14
Concordia Ch,5248,6,2,3,9,16,23,-7,9
FCSB,5249,1,8,6,0,26,11,15,30
CFR Cluj,5249,2,5,8,1,13,7,6,23
FC Botosani,5249,3,5,4,5,9,12,-3,19
Universitate,5249,4,3,6,5,15,21,-6,15
D Bucuresti,5249,5,3,4,7,17,22,-5,13
Concordia Ch,5249,6,3,2,9,17,24,-7,11
FCSB,5250,1,7,6,1,23,12,11,27
CFR Cluj,5250,2,5,7,2,13,8,5,22
Universitate,5250,3,5,5,4,17,18,-1,20
FC Botosani,5250,4,4,5,5,7,13,-6,17
D Bucuresti,5250,5,3,5,6,17,20,-3,14
Concordia Ch,5250,6,3,2,9,16,22,-6,11
FCSB,5251,1,7,6,1,25,14,11,27
CFR Cluj,5251,2,5,8,1,14,8,6,23
Universitate,5251,3,4,6,4,19,21,-2,18
D Bucuresti,5251,4,4,4,6,19,24,-5,16
FC Botosani,5251,5,4,4,6,9,15,-6,16
Concordia Ch,5251,6,3,2,9,22,26,-4,11
FCSB,5252,1,7,7,0,26,13,13,28
CFR Cluj,5252,2,6,7,1,16,9,7,25
D Bucuresti,5252,3,4,4,6,20,21,-1,16
FC Botosani,5252,4,4,4,6,8,15,-7,16
Universitate,5252,5,3,6,5,15,20,-5,15
Concordia Ch,5252,6,3,2,9,19,26,-7,11
FCSB,5253,1,7,7,0,25,12,13,28
CFR Cluj,5253,2,6,7,1,15,8,7,25
FC Botosani,5253,3,4,4,6,9,15,-6,16
Universitate,5253,4,3,6,5,15,20,-5,15
D Bucuresti,5253,5,3,5,6,18,22,-4,14
Concordia Ch,5253,6,3,3,8,18,23,-5,12
FCSB,5254,1,7,5,2,24,14,10,26
CFR Cluj,5254,2,6,7,1,18,11,7,25
Universitate,5254,3,4,6,4,19,21,-2,18
D Bucuresti,5254,4,4,4,6,17,19,-2,16
Concordia Ch,5254,5,4,2,8,18,22,-4,14
FC Botosani,5254,6,3,4,7,6,15,-9,13
FCSB,5255,1,8,5,1,27,13,14,29
CFR Cluj,5255,2,7,6,1,20,8,12,27
FC Botosani,5255,3,4,5,5,8,14,-6,17
Universitate,5255,4,3,5,6,14,25,-11,14
D Bucuresti,5255,5,3,4,7,18,22,-4,13
Concordia Ch,5255,6,3,3,8,16,21,-5,12
FCSB,5256,1,7,5,2,25,15,10,26
CFR Cluj,5256,2,6,7,1,16,9,7,25
Universitate,5256,3,4,6,4,18,20,-2,18
FC Botosani,5256,4,4,4,6,7,15,-8,16
D Bucuresti,5256,5,3,5,6,17,21,-4,14
Concordia Ch,5256,6,3,3,8,19,22,-3,12
FCSB,5257,1,8,5,1,25,14,11,29
CFR Cluj,5257,2,5,7,2,15,10,5,22
Universitate,5257,3,4,6,4,18,19,-1,18
D Bucuresti,5257,4,4,5,5,17,18,-1,17
FC Botosani,5257,5,3,4,7,6,15,-9,13
Concordia Ch,5257,6,3,3,8,17,22,-5,12
FCSB,5258,1,9,5,0,30,14,16,32
CFR Cluj,5258,2,6,6,2,18,11,7,24
D Bucuresti,5258,3,4,4,6,20,23,-3,16
FC Botosani,5258,4,4,4,6,8,16,-8,16
Universitate,5258,5,3,5,6,15,23,-8,14
Concordia Ch,5258,6,3,2,9,20,24,-4,11
FCSB,5259,1,8,5,1,27,14,13,29
CFR Cluj,5259,2,5,6,3,14,13,1,21
Universitate,5259,3,5,5,4,20,19,1,20
D Bucuresti,5259,4,3,5,6,18,21,-3,14
Concordia Ch,5259,5,4,2,8,18,22,-4,14
FC Botosani,5259,6,3,5,6,6,14,-8,14
FCSB,5260,1,7,7,0,24,11,13,28
CFR Cluj,5260,2,5,8,1,16,10,6,23
D Bucuresti,5260,3,4,4,6,20,24,-4,16
Universitate,5260,4,3,7,4,16,20,-4,16
FC Botosani,5260,5,4,4,6,9,15,-6,16
Concordia Ch,5260,6,3,2,9,19,24,-5,11
FCSB,5261,1,7,6,1,23,12,11,27
CFR Cluj,5261,2,6,7,1,16,8,8,25
D Bucuresti,5261,3,5,4,5,20,18,2,19
Universitate,5261,4,4,5,5,17,21,-4,17
FC Botosani,5261,5,4,4,6,6,15,-9,16
Concordia Ch,5261,6,2,2,10,15,23,-8,8
FCSB,5262,1,8,6,0,27,12,15,30
CFR Cluj,5262,2,5,7,2,15,11,4,22
FC Botosani,5262,3,4,5,5,8,13,-5,17
Universitate,5262,4,3,7,4,16,20,-4,16
D Bucuresti,5262,5,3,5,6,17,21,-4,14
Concordia Ch,5262,6,3,2,9,19,25,-6,11
FCSB,5263,1,9,5,0,27,11,16,32
CFR Cluj,5263,2,6,6,2,14,9,5,24
D Bucuresti,5263,3,4,5,5,20,20,0,17
Universitate,5263,4,3,5,6,15,21,-6,14
FC Botosani,5263,5,3,4,7,5,19,-14,13
Concordia Ch,5263,6,3,3,8,22,23,-1,12
CFR Cluj,5264,1,7,6,1,18,10,8,27
FCSB,5264,2,7,5,2,25,14,11,26
Universitate,5264,3,4,5,5,18,22,-4,17
D Bucuresti,5264,4,4,4,6,18,20,-2,16
Concordia Ch,5264,5,4,2,8,18,21,-3,14
FC Botosani,5264,6,3,4,7,5,15,-10,13
FCSB,5265,1,9,5,0,26,11,15,32
CFR Cluj,5265,2,5,7,2,14,9,5,22
D Bucuresti,5265,3,4,5,5,21,21,0,17
Universitate,5265,4,3,6,5,16,21,-5,15
FC Botosani,5265,5,3,6,5,6,13,-7,15
Concordia Ch,5265,6,2,3,9,17,25,-8,9
FCSB,5266,1,8,5,1,24,11,13,29
CFR Cluj,5266,2,6,6,2,14,9,5,24
Universitate,5266,3,4,5,5,16,19,-3,17
FC Botosani,5266,4,4,4,6,7,15,-8,16
Concordia Ch,5266,5,4,2,8,18,21,-3,14
D Bucuresti,5266,6,3,4,7,17,21,-4,13
FCSB,5267,1,9,5,0,27,10,17,32
CFR Cluj,5267,2,5,7,2,14,9,5,22
D Bucuresti,5267,3,4,5,5,20,19,1,17
Universitate,5267,4,3,6,5,15,22,-7,15
FC Botosani,5267,5,3,5,6,5,15,-10,14
Concordia Ch,5267,6,2,4,8,16,22,-6,10
FCSB,5268,1,9,5,0,29,11,18,32
CFR Cluj,5268,2,5,6,3,14,13,1,21
D Bucuresti,5268,3,5,4,5,18,18,0,19
Universitate,5268,4,4,5,5,17,21,-4,17
FC Botosani,5268,5,4,4,6,6,13,-7,16
Concordia Ch,5268,6,2,2,10,15,23,-8,8
FCSB,5269,1,8,6,0,26,10,16,30
CFR Cluj,5269,2,6,7,1,14,7,7,25
D Bucuresti,5269,3,3,5,6,17,20,-3,14
Concordia Ch,5269,4,4,2,8,18,22,-4,14
Universitate,5269,5,3,5,6,14,22,-8,14
FC Botosani,5269,6,3,5,6,7,15,-8,14
FCSB,5270,1,8,5,1,26,14,12,29
CFR Cluj,5270,2,6,6,2,16,10,6,24
Universitate,5270,3,4,5,5,18,21,-3,17
D Bucuresti,5270,4,4,4,6,18,19,-1,16
FC Botosani,5270,5,4,4,6,7,15,-8,16
Concordia Ch,5270,6,3,2,9,18,24,-6,11
FCSB,5271,1,8,6,0,26,12,14,30
CFR Cluj,5271,2,6,6,2,15,9,6,24
D Bucuresti,5271,3,4,4,6,18,21,-3,16
FC Botosani,5271,4,4,4,6,10,14,-4,16
Universitate,5271,5,3,6,5,15,20,-5,15
Concordia Ch,5271,6,3,2,9,17,25,-8,11
FCSB,5272,1,8,6,0,28,12,16,30
CFR Cluj,5272,2,6,7,1,16,9,7,25
D Bucuresti,5272,3,4,4,6,18,21,-3,16
Concordia Ch,5272,4,4,2,8,19,21,-2,14
Universitate,5272,5,3,5,6,14,22,-8,14
FC Botosani,5272,6,3,4,7,5,15,-10,13
FCSB,5273,1,7,7,0,26,13,13,28
CFR Cluj,5273,2,5,8,1,14,8,6,23
D Bucuresti,5273,3,5,4,5,24,19,5,19
Universitate,5273,4,3,7,4,16,20,-4,16
FC Botosani,5273,5,3,5,6,6,17,-11,14
Concordia Ch,5273,6,2,3,9,15,24,-9,9
FCSB,5274,1,7,7,0,25,12,13,28
CFR Cluj,5274,2,6,7,1,14,7,7,25
Universitate,5274,3,3,6,5,16,21,-5,15
Concordia Ch,5274,4,4,2,8,20,23,-3,14
D Bucuresti,5274,5,3,5,6,18,22,-4,14
FC Botosani,5274,6,3,5,6,7,15,-8,14
FCSB,5275,1,7,6,1,24,12,12,27
CFR Cluj,5275,2,5,7,2,14,9,5,22
Universitate,5275,3,5,5,4,16,18,-2,20
D Bucuresti,5275,4,4,4,6,17,24,-7,16
FC Botosani,5275,5,4,4,6,7,14,-7,16
Concordia Ch,5275,6,3,2,9,22,23,-1,11
FCSB,5276,1,8,5,1,24,11,13,29
CFR Cluj,5276,2,5,7,2,13,8,5,22
FC Botosani,5276,3,5,4,5,7,12,-5,19
Universitate,5276,4,4,6,4,15,18,-3,18
D Bucuresti,5276,5,4,4,6,17,19,-2,16
Concordia Ch,5276,6,2,2,10,15,23,-8,8
FCSB,5277,1,9,5,0,26,10,16,32
CFR Cluj,5277,2,5,7,2,13,8,5,22
D Bucuresti,5277,3,4,4,6,19,19,0,16
FC Botosani,5277,4,4,4,6,6,15,-9,16
Universitate,5277,5,3,6,5,14,20,-6,15
Concordia Ch,5277,6,3,2,9,16,22,-6,11
FCSB,5278,1,8,5,1,24,11,13,29
CFR Cluj,5278,2,5,6,3,14,10,4,21
Universitate,5278,3,5,5,4,17,19,-2,20
D Bucuresti,5278,4,4,4,6,19,21,-2,16
FC Botosani,5278,5,4,4,6,6,14,-8,16
Concordia Ch,5278,6,3,2,9,18,23,-5,11
FCSB,5279,1,8,6,0,24,10,14,30
CFR Cluj,5279,2,5,7,2,13,8,5,22
D Bucuresti,5279,3,5,4,5,21,21,0,19
Universitate,5279,4,4,5,5,15,19,-4,17
FC Botosani,5279,5,4,4,6,7,14,-7,16
Concordia Ch,5279,6,2,2,10,17,25,-8,8
FCSB,5280,1,7,7,0,25,12,13,28
CFR Cluj,5280,2,6,7,1,16,9,7,25
D Bucuresti,5280,3,5,4,5,21,20,1,19
Universitate,5280,4,3,6,5,14,19,-5,15
FC Botosani,5280,5,3,5,6,6,14,-8,14
Concordia Ch,5280,6,2,3,9,16,24,-8,9
FCSB,5281,1,7,6,1,23,11,12,27
CFR Cluj,5281,2,5,7,2,14,10,4,22
Universitate,5281,3,5,5,4,18,19,-1,20
FC Botosani,5281,4,5,4,5,7,12,-5,19
D Bucuresti,5281,5,3,5,6,17,20,-3,14
Concordia Ch,5281,6,2,3,9,16,23,-7,9
FCSB,5282,1,8,5,1,26,14,12,29
CFR Cluj,5282,2,6,6,2,16,10,6,24
D Bucuresti,5282,3,5,4,5,19,18,1,19
Universitate,5282,4,4,5,5,18,21,-3,17
FC Botosani,5282,5,4,4,6,6,13,-7,16
Concordia Ch,5282,6,2,2,10,15,24,-9,8
FCSB,5283,1,9,5,0,26,11,15,32
CFR Cluj,5283,2,5,6,3,14,10,4,21
Universitate,5283,3,4,5,5,17,21,-4,17
FC Botosani,5283,4,4,5,5,8,14,-6,17
D Bucuresti,5283,5,4,4,6,21,23,-2,16
Concordia Ch,5283,6,2,3,9,17,24,-7,9
FCSB,5284,1,8,6,0,26,11,15,30
CFR Cluj,5284,2,6,6,2,15,9,6,24
D Bucuresti,5284,3,4,5,5,19,19,0,17
Universitate,5284,4,3,6,5,15,21,-6,15
FC Botosani,5284,5,3,4,7,5,15,-10,13
Concordia Ch,5284,6,3,3,8,17,22,-5,12
FCSB,5285,1,7,6,1,26,14,12,27
CFR Cluj,5285,2,6,7,1,15,8,7,25
Universitate,5285,3,4,5,5,17,21,-4,17
FC Botosani,5285,4,4,5,5,8,13,-5,17
D Bucuresti,5285,5,3,5,6,18,22,-4,14
Concordia Ch,5285,6,3,2,9,18,24,-6,11
FCSB,5286,1,8,6,0,25,11,14,30
CFR Cluj,5286,2,5,7,2,15,10,5,22
D Bucuresti,5286,3,4,5,5,18,19,-1,17
FC Botosani,5286,4,4,5,5,9,14,-5,17
Universitate,5286,5,3,7,4,15,19,-4,16
Concordia Ch,5286,6,2,2,10,16,25,-9,8
FCSB,5287,1,8,5,1,31,13,18,29
CFR Cluj,5287,2,6,6,2,15,14,1,24
D Bucuresti,5287,3,4,5,5,18,19,-1,17
Universitate,5287,4,4,5,5,17,21,-4,17
FC Botosani,5287,5,3,6,5,5,12,-7,15
Concordia Ch,5287,6,2,3,9,16,23,-7,9
FCSB,5288,1,8,6,0,26,10,16,30
CFR Cluj,5288,2,6,7,1,15,7,8,25
FC Botosani,5288,3,4,4,6,11,17,-6,16
D Bucuresti,5288,4,3,5,6,18,23,-5,14
Universitate,5288,5,3,5,6,14,23,-9,14
Concordia Ch,5288,6,3,3,8,20,24,-4,12
FCSB,5289,1,9,5,0,27,11,16,32
CFR Cluj,5289,2,5,6,3,14,12,2,21
D Bucuresti,5289,3,5,4,5,20,20,0,19
Universitate,5289,4,4,5,5,17,20,-3,17
FC Botosani,5289,5,3,5,6,8,16,-8,14
Concordia Ch,5289,6,2,3,9,16,23,-7,9
FCSB,5290,1,8,5,1,25,13,12,29
CFR Cluj,5290,2,5,7,2,15,10,5,22
Universitate,5290,3,4,6,4,17,19,-2,18
D Bucuresti,5290,4,4,4,6,17,19,-2,16
FC Botosani,5290,5,4,4,6,8,14,-6,16
Concordia Ch,5290,6,3,2,9,17,24,-7,11
FCSB,5291,1,8,5,1,29,13,16,29
CFR Cluj,5291,2,5,7,2,14,12,2,22
Universitate,5291,3,4,6,4,16,19,-3,18
FC Botosani,5291,4,4,5,5,7,13,-6,17
D Bucuresti,5291,5,3,6,5,19,21,-2,15
Concordia Ch,5291,6,2,3,9,17,24,-7,9
FCSB,5292,1,7,6,1,24,12,12,27
CFR Cluj,5292,2,5,7,2,14,9,5,22
Universitate,5292,3,5,5,4,18,20,-2,20
D Bucuresti,5292,4,5,4,5,22,19,3,19
FC Botosani,5292,5,4,4,6,6,16,-10,16
Concordia Ch,5292,6,2,2,10,16,24,-8,8
FCSB,5293,1,8,5,1,25,15,10,29
CFR Cluj,5293,2,6,6,2,15,9,6,24
Universitate,5293,3,4,5,5,18,19,-1,17
D Bucuresti,5293,4,4,4,6,19,21,-2,16
FC Botosani,5293,5,4,4,6,7,13,-6,16
Concordia Ch,5293,6,3,2,9,18,25,-7,11
FCSB,5294,1,8,6,0,28,12,16,30
CFR Cluj,5294,2,5,6,3,14,12,2,21
Universitate,5294,3,4,6,4,16,19,-3,18
D Bucuresti,5294,4,4,5,5,19,19,0,17
FC Botosani,5294,5,3,6,5,7,14,-7,15
Concordia Ch,5294,6,2,3,9,18,26,-8,9
FCSB,5295,1,8,5,1,26,12,14,29
CFR Cluj,5295,2,6,6,2,17,11,6,24
Universitate,5295,3,4,5,5,16,21,-5,17
D Bucuresti,5295,4,4,4,6,19,19,0,16
Concordia Ch,5295,5,4,2,8,19,21,-2,14
FC Botosani,5295,6,3,4,7,5,18,-13,13
FCSB,5296,1,8,6,0,28,12,16,30
CFR Cluj,5296,2,6,7,1,16,8,8,25
FC Botosani,5296,3,5,4,5,9,12,-3,19
D Bucuresti,5296,4,3,5,6,16,19,-3,14
Universitate,5296,5,3,5,6,15,24,-9,14
Concordia Ch,5296,6,2,3,9,15,24,-9,9
FCSB,5297,1,9,5,0,26,10,16,32
CFR Cluj,5297,2,6,6,2,16,9,7,24
D Bucuresti,5297,3,4,5,5,20,21,-1,17
Universitate,5297,4,3,5,6,14,22,-8,14
FC Botosani,5297,5,3,4,7,6,15,-9,13
Concordia Ch,5297,6,3,3,8,18,23,-5,12
FCSB,5298,1,7,6,1,23,11,12,27
CFR Cluj,5298,2,5,7,2,14,9,5,22
Universitate,5298,3,5,5,4,17,19,-2,20
FC Botosani,5298,4,4,4,6,6,13,-7,16
Concordia Ch,5298,5,4,2,8,18,21,-3,14
D Bucuresti,5298,6,3,4,7,16,21,-5,13
FCSB,5299,1,7,6,1,24,14,10,27
CFR Cluj,5299,2,5,7,2,15,11,4,22
Universitate,5299,3,5,5,4,20,19,1,20
FC Botosani,5299,4,4,5,5,9,15,-6,17
D Bucuresti,5299,5,3,5,6,19,23,-4,14
Concordia Ch,5299,6,3,2,9,17,22,-5,11
FCSB,5300,1,7,6,1,24,12,12,27
CFR Cluj,5300,2,6,7,1,15,8,7,25
FC Botosani,5300,3,4,5,5,10,16,-6,17
Universitate,5300,4,3,7,4,14,18,-4,16
D Bucuresti,5300,5,3,5,6,18,21,-3,14
Concordia Ch,5300,6,2,4,8,17,23,-6,10
FCSB,5301,1,9,5,0,29,11,18,32
CFR Cluj,5301,2,6,6,2,16,12,4,24
FC Botosani,5301,3,4,5,5,9,14,-5,17
Universitate,5301,4,3,5,6,15,22,-7,14
D Bucuresti,5301,5,3,4,7,17,22,-5,13
Concordia Ch,5301,6,3,3,8,17,22,-5,12
CFR Cluj,5302,1,7,6,1,16,8,8,27
FCSB,5302,2,7,5,2,25,14,11,26
D Bucuresti,5302,3,5,4,5,21,19,2,19
Universitate,5302,4,4,5,5,16,20,-4,17
FC Botosani,5302,5,3,5,6,6,15,-9,14
Concordia Ch,5302,6,2,3,9,17,25,-8,9
FCSB,5303,1,8,5,1,25,12,13,29
CFR Cluj,5303,2,6,6,2,15,10,5,24
Universitate,5303,3,4,5,5,17,20,-3,17
FC Botosani,5303,4,4,5,5,8,14,-6,17
D Bucuresti,5303,5,3,5,6,17,23,-6,14
Concordia Ch,5303,6,3,2,9,20,23,-3,11
FCSB,5304,1,8,5,1,27,13,14,29
CFR Cluj,5304,2,7,6,1,20,8,12,27
D Bucuresti,5304,3,4,4,6,17,19,-2,16
FC Botosani,5304,4,4,4,6,6,13,-7,16
Universitate,5304,5,3,5,6,14,25,-11,14
Concordia Ch,5304,6,3,2,9,16,22,-6,11
FCSB,5305,1,7,7,0,26,13,13,28
CFR Cluj,5305,2,5,8,1,15,9,6,23
D Bucuresti,5305,3,4,5,5,23,21,2,17
Universitate,5305,4,3,7,4,15,19,-4,16
FC Botosani,5305,5,3,6,5,7,14,-7,15
Concordia Ch,5305,6,2,3,9,16,26,-10,9
FCSB,5306,1,8,5,1,25,12,13,29
CFR Cluj,5306,2,7,6,1,18,8,10,27
FC Botosani,5306,3,5,4,5,9,12,-3,19
Universitate,5306,4,3,5,6,16,24,-8,14
D Bucuresti,5306,5,3,4,7,16,22,-6,13
Concordia Ch,5306,6,3,2,9,17,23,-6,11
FCSB,5307,1,7,7,0,25,12,13,28
CFR Cluj,5307,2,5,8,1,15,9,6,23
FC Botosani,5307,3,4,5,5,8,12,-4,17
Universitate,5307,4,3,7,4,16,20,-4,16
D Bucuresti,5307,5,3,4,7,18,24,-6,13
Concordia Ch,5307,6,3,3,8,18,23,-5,12
FCSB,5308,1,7,6,1,27,15,12,27
CFR Cluj,5308,2,6,7,1,16,9,7,25
Universitate,5308,3,4,5,5,17,21,-4,17
Concordia Ch,5308,4,4,2,8,20,22,-2,14
D Bucuresti,5308,5,3,5,6,18,22,-4,14
FC Botosani,5308,6,3,5,6,6,15,-9,14
FCSB,5309,1,8,6,0,26,11,15,30
CFR Cluj,5309,2,5,7,2,14,9,5,22
Universitate,5309,3,4,5,5,17,22,-5,17
FC Botosani,5309,4,4,5,5,7,13,-6,17
D Bucuresti,5309,5,3,5,6,16,20,-4,14
Concordia Ch,5309,6,3,2,9,18,23,-5,11
FCSB,5310,1,7,6,1,25,13,12,27
CFR Cluj,5310,2,5,8,1,14,8,6,23
D Bucuresti,5310,3,5,4,5,21,20,1,19
Universitate,5310,4,4,6,4,16,19,-3,18
FC Botosani,5310,5,3,5,6,6,15,-9,14
Concordia Ch,5310,6,2,3,9,16,23,-7,9
FCSB,5311,1,8,5,1,24,14,10,29
CFR Cluj,5311,2,6,6,2,14,8,6,24
FC Botosani,5311,3,5,4,5,7,12,-5,19
Universitate,5311,4,4,5,5,18,19,-1,17
D Bucuresti,5311,5,3,5,6,17,20,-3,14
Concordia Ch,5311,6,2,3,9,16,23,-7,9
FCSB,5312,1,7,7,0,23,10,13,28
CFR Cluj,5312,2,5,8,1,14,8,6,23
D Bucuresti,5312,3,4,4,6,18,19,-1,16
Universitate,5312,4,3,7,4,15,19,-4,16
FC Botosani,5312,5,3,5,6,5,14,-9,14
Concordia Ch,5312,6,3,3,8,16,21,-5,12
FCSB,5313,1,8,6,0,25,10,15,30
CFR Cluj,5313,2,6,7,1,14,7,7,25
D Bucuresti,5313,3,4,4,6,18,21,-3,16
Universitate,5313,4,3,5,6,14,21,-7,14
FC Botosani,5313,5,3,5,6,6,14,-8,14
Concordia Ch,5313,6,3,3,8,17,21,-4,12
FCSB,5314,1,9,5,0,26,11,15,32
CFR Cluj,5314,2,5,6,3,14,10,4,21
Universitate,5314,3,4,5,5,15,19,-4,17
FC Botosani,5314,4,4,5,5,8,14,-6,17
D Bucuresti,5314,5,3,5,6,19,22,-3,14
Concordia Ch,5314,6,2,4,8,18,24,-6,10
FCSB,5315,1,9,5,0,25,10,15,32
CFR Cluj,5315,2,5,6,3,13,10,3,21
Universitate,5315,3,4,5,5,16,19,-3,17
D Bucuresti,5315,4,4,4,6,19,22,-3,16
FC Botosani,5315,5,3,5,6,8,16,-8,14
Concordia Ch,5315,6,3,3,8,20,24,-4,12
FCSB,5316,1,8,6,0,25,10,15,30
CFR Cluj,5316,2,5,6,3,13,10,3,21
Universitate,5316,3,4,6,4,15,18,-3,18
D Bucuresti,5316,4,4,4,6,20,23,-3,16
FC Botosani,5316,5,4,4,6,7,15,-8,16
Concordia Ch,5316,6,3,2,9,19,23,-4,11
FCSB,5317,1,8,6,0,30,14,16,30
CFR Cluj,5317,2,6,6,2,17,13,4,24
FC Botosani,5317,3,5,4,5,9,12,-3,19
Universitate,5317,4,3,6,5,17,22,-5,15
D Bucuresti,5317,5,3,4,7,17,21,-4,13
Concordia Ch,5317,6,3,2,9,17,25,-8,11
FCSB,5318,1,8,5,1,24,13,11,29
CFR Cluj,5318,2,6,6,2,16,8,8,24
Universitate,5318,3,4,5,5,15,19,-4,17
D Bucuresti,5318,4,4,4,6,19,21,-2,16
Concordia Ch,5318,5,4,2,8,19,23,-4,14
FC Botosani,5318,6,3,4,7,7,16,-9,13
FCSB,5319,1,8,5,1,25,14,11,29
CFR Cluj,5319,2,6,6,2,15,9,6,24
Universitate,5319,3,4,5,5,17,19,-2,17
D Bucuresti,5319,4,4,4,6,17,19,-2,16
FC Botosani,5319,5,4,4,6,6,13,-7,16
Concordia Ch,5319,6,3,2,9,16,22,-6,11
FCSB,5320,1,7,6,1,24,12,12,27
CFR Cluj,5320,2,6,7,1,15,8,7,25
Universitate,5320,3,4,5,5,15,19,-4,17
FC Botosani,5320,4,4,4,6,8,15,-7,16
Concordia Ch,5320,5,4,2,8,19,23,-4,14
D Bucuresti,5320,6,3,4,7,18,22,-4,13
FCSB,5321,1,8,5,1,26,13,13,29
CFR Cluj,5321,2,5,6,3,15,11,4,21
Universitate,5321,3,5,5,4,16,18,-2,20
FC Botosani,5321,4,5,4,5,9,14,-5,19
D Bucuresti,5321,5,3,5,6,18,21,-3,14
Concordia Ch,5321,6,2,3,9,17,24,-7,9
FCSB,5322,1,9,5,0,28,12,16,32
CFR Cluj,5322,2,5,6,3,13,12,1,21
D Bucuresti,5322,3,4,5,5,20,20,0,17
Universitate,5322,4,4,5,5,19,21,-2,17
FC Botosani,5322,5,4,4,6,9,17,-8,16
Concordia Ch,5322,6,2,3,9,18,25,-7,9
FCSB,5323,1,7,7,0,26,13,13,28
CFR Cluj,5323,2,6,7,1,17,10,7,25
D Bucuresti,5323,3,4,4,6,20,22,-2,16
Universitate,5323,4,3,6,5,16,21,-5,15
Concordia Ch,5323,5,4,2,8,18,22,-4,14
FC Botosani,5323,6,3,4,7,7,16,-9,13
FCSB,5324,1,7,6,1,25,14,11,27
CFR Cluj,5324,2,7,6,1,17,8,9,27
FC Botosani,5324,3,4,5,5,8,13,-5,17
Universitate,5324,4,3,6,5,17,22,-5,15
D Bucuresti,5324,5,3,5,6,16,20,-4,14
Concordia Ch,5324,6,3,2,9,18,24,-6,11
FCSB,5325,1,8,6,0,24,10,14,30
CFR Cluj,5325,2,5,7,2,14,9,5,22
Universitate,5325,3,4,5,5,16,20,-4,17
D Bucuresti,5325,4,4,4,6,17,21,-4,16
Concordia Ch,5325,5,4,2,8,20,22,-2,14
FC Botosani,5325,6,3,4,7,6,15,-9,13
FCSB,5326,1,8,6,0,26,12,14,30
CFR Cluj,5326,2,6,6,2,17,10,7,24
FC Botosani,5326,3,4,4,6,9,15,-6,16
Universitate,5326,4,3,6,5,16,22,-6,15
Concordia Ch,5326,5,4,2,8,21,24,-3,14
D Bucuresti,5326,6,3,4,7,17,23,-6,13
FCSB,5327,1,8,5,1,27,12,15,29
CFR Cluj,5327,2,7,6,1,17,9,8,27
FC Botosani,5327,3,5,4,5,8,13,-5,19
Universitate,5327,4,3,5,6,15,23,-8,14
D Bucuresti,5327,5,3,4,7,18,22,-4,13
Concordia Ch,5327,6,3,2,9,17,23,-6,11
FCSB,5328,1,8,6,0,26,11,15,30
CFR Cluj,5328,2,6,6,2,16,9,7,24
D Bucuresti,5328,3,4,5,5,18,19,-1,17
Universitate,5328,4,3,6,5,15,22,-7,15
FC Botosani,5328,5,3,6,5,7,14,-7,15
Concordia Ch,5328,6,2,3,9,16,23,-7,9
FCSB,5329,1,9,5,0,26,10,16,32
CFR Cluj,5329,2,5,7,2,14,9,5,22
D Bucuresti,5329,3,4,4,6,19,21,-2,16
FC Botosani,5329,4,4,4,6,8,14,-6,16
Universitate,5329,5,3,6,5,15,21,-6,15
Concordia Ch,5329,6,3,2,9,18,25,-7,11
FCSB,5330,1,8,5,1,24,11,13,29
CFR Cluj,5330,2,5,6,3,13,9,4,21
Universitate,5330,3,5,5,4,16,18,-2,20
FC Botosani,5330,4,5,4,5,10,13,-3,19
D Bucuresti,5330,5,3,5,6,19,24,-5,14
Concordia Ch,5330,6,2,3,9,19,26,-7,9
FCSB,5331,1,8,5,1,26,13,13,29
CFR Cluj,5331,2,7,6,1,19,10,9,27
D Bucuresti,5331,3,5,4,5,21,20,1,19
FC Botosani,5331,4,4,4,6,8,16,-8,16
Universitate,5331,5,3,5,6,17,24,-7,14
Concordia Ch,5331,6,2,2,10,17,25,-8,8
FCSB,5332,1,8,5,1,24,11,13,29
CFR Cluj,5332,2,6,6,2,14,9,5,24
Universitate,5332,3,4,5,5,16,19,-3,17
FC Botosani,5332,4,4,5,5,7,13,-6,17
D Bucuresti,5332,5,3,5,6,18,21,-3,14
Concordia Ch,5332,6,3,2,9,19,25,-6,11
FCSB,5333,1,8,5,1,25,12,13,29
CFR Cluj,5333,2,6,6,2,15,10,5,24
D Bucuresti,5333,3,5,4,5,23,23,0,19
Universitate,5333,4,4,5,5,18,21,-3,17
FC Botosani,5333,5,4,4,6,9,16,-7,16
Concordia Ch,5333,6,2,2,10,19,27,-8,8
FCSB,5334,1,8,5,1,27,14,13,29
CFR Cluj,5334,2,6,6,2,16,11,5,24
Universitate,5334,3,4,5,5,17,20,-3,17
D Bucuresti,5334,4,4,4,6,18,20,-2,16
Concordia Ch,5334,5,4,2,8,19,22,-3,14
FC Botosani,5334,6,3,4,7,6,16,-10,13
FCSB,5335,1,8,6,0,26,11,15,30
CFR Cluj,5335,2,5,7,2,14,10,4,22
Universitate,5335,3,4,5,5,16,20,-4,17
FC Botosani,5335,4,4,5,5,9,15,-6,17
D Bucuresti,5335,5,3,6,5,18,20,-2,15
Concordia Ch,5335,6,2,3,9,16,23,-7,9
FCSB,5336,1,8,6,0,26,12,14,30
CFR Cluj,5336,2,5,6,3,13,9,4,21
D Bucuresti,5336,3,5,4,5,21,21,0,19
Universitate,5336,4,4,6,4,17,20,-3,18
FC Botosani,5336,5,3,5,6,9,17,-8,14
Concordia Ch,5336,6,2,3,9,16,23,-7,9
FCSB,5337,1,8,6,0,26,12,14,30
CFR Cluj,5337,2,6,7,1,16,8,8,25
D Bucuresti,5337,3,4,4,6,21,21,0,16
FC Botosani,5337,4,4,4,6,6,17,-11,16
Universitate,5337,5,3,5,6,15,22,-7,14
Concordia Ch,5337,6,3,2,9,18,22,-4,11
CFR Cluj,5338,1,7,6,1,16,8,8,27
FCSB,5338,2,7,5,2,24,13,11,26
Universitate,5338,3,4,5,5,15,19,-4,17
D Bucuresti,5338,4,4,4,6,18,19,-1,16
Concordia Ch,5338,5,4,2,8,19,21,-2,14
FC Botosani,5338,6,3,4,7,5,17,-12,13
FCSB,5339,1,8,6,0,28,12,16,30
CFR Cluj,5339,2,6,6,2,14,10,4,24
D Bucuresti,5339,3,5,4,5,21,19,2,19
Universitate,5339,4,3,6,5,16,21,-5,15
FC Botosani,5339,5,3,4,7,6,16,-10,13
Concordia Ch,5339,6,3,2,9,17,24,-7,11
FCSB,5340,1,8,5,1,26,13,13,29
CFR Cluj,5340,2,7,6,1,20,8,12,27
FC Botosani,5340,3,4,5,5,7,12,-5,17
D Bucuresti,5340,4,3,5,6,18,21,-3,14
Universitate,5340,5,3,5,6,15,25,-10,14
Concordia Ch,5340,6,3,2,9,18,25,-7,11
FCSB,5341,1,7,6,1,24,12,12,27
CFR Cluj,5341,2,6,7,1,15,7,8,25
D Bucuresti,5341,3,5,4,5,22,21,1,19
Universitate,5341,4,4,5,5,16,21,-5,17
FC Botosani,5341,5,3,5,6,5,14,-9,14
Concordia Ch,5341,6,2,3,9,18,25,-7,9
FCSB,5342,1,9,5,0,25,10,15,32
CFR Cluj,5342,2,5,6,3,14,10,4,21
Universitate,5342,3,4,5,5,16,20,-4,17
FC Botosani,5342,4,4,5,5,6,12,-6,17
D Bucuresti,5342,5,3,4,7,16,20,-4,13
Concordia Ch,5342,6,3,3,8,16,21,-5,12
FCSB,5343,1,9,5,0,27,11,16,32
CFR Cluj,5343,2,6,6,2,15,9,6,24
FC Botosani,5343,3,5,4,5,7,12,-5,19
D Bucuresti,5343,4,3,5,6,18,21,-3,14
Universitate,5343,5,3,5,6,16,23,-7,14
Concordia Ch,5343,6,2,3,9,17,24,-7,9
FCSB,5344,1,8,6,0,25,11,14,30
CFR Cluj,5344,2,5,8,1,13,7,6,23
FC Botosani,5344,3,5,4,5,7,12,-5,19
Universitate,5344,4,3,6,5,15,20,-5,15
D Bucuresti,5344,5,3,4,7,16,20,-4,13
Concordia Ch,5344,6,3,2,9,16,22,-6,11
FCSB,5345,1,8,6,0,26,10,16,30
CFR Cluj,5345,2,5,7,2,13,10,3,22
D Bucuresti,5345,3,4,5,5,17,18,-1,17
Universitate,5345,4,3,7,4,14,18,-4,16
FC Botosani,5345,5,4,4,6,7,14,-7,16
Concordia Ch,5345,6,2,3,9,16,23,-7,9
FCSB,5346,1,7,5,2,23,12,11,26
CFR Cluj,5346,2,6,6,2,14,8,6,24
Universitate,5346,3,5,5,4,16,18,-2,20
D Bucuresti,5346,4,4,4,6,20,20,0,16
FC Botosani,5346,5,3,5,6,6,16,-10,14
Concordia Ch,5346,6,3,3,8,18,23,-5,12
FCSB,5347,1,8,5,1,24,13,11,29
CFR Cluj,5347,2,6,6,2,17,9,8,24
Universitate,5347,3,4,5,5,18,22,-4,17
D Bucuresti,5347,4,4,4,6,19,20,-1,16
FC Botosani,5347,5,3,5,6,7,16,-9,14
Concordia Ch,5347,6,3,3,8,17,22,-5,12
FCSB,5348,1,8,5,1,24,12,12,29
CFR Cluj,5348,2,5,7,2,13,8,5,22
Universitate,5348,3,4,6,4,16,18,-2,18
FC Botosani,5348,4,4,5,5,6,12,-6,17
D Bucuresti,5348,5,3,5,6,16,20,-4,14
Concordia Ch,5348,6,3,2,9,17,22,-5,11
FCSB,5349,1,7,6,1,24,12,12,27
CFR Cluj,5349,2,7,6,1,16,7,9,27
D Bucuresti,5349,3,4,5,5,18,19,-1,17
Universitate,5349,4,3,6,5,15,21,-6,15
FC Botosani,5349,5,3,6,5,7,14,-7,15
Concordia Ch,5349,6,2,3,9,16,23,-7,9
FCSB,5350,1,8,5,1,27,14,13,29
CFR Cluj,5350,2,6,6,2,15,10,5,24
Universitate,5350,3,4,5,5,18,21,-3,17
D Bucuresti,5350,4,4,4,6,22,25,-3,16
FC Botosani,5350,5,3,5,6,11,20,-9,14
Concordia Ch,5350,6,3,3,8,22,25,-3,12
FCSB,5351,1,8,5,1,24,12,12,29
CFR Cluj,5351,2,6,6,2,15,8,7,24
Universitate,5351,3,4,5,5,15,19,-4,17
D Bucuresti,5351,4,4,4,6,19,21,-2,16
FC Botosani,5351,5,4,4,6,7,14,-7,16
Concordia Ch,5351,6,3,2,9,17,23,-6,11
FCSB,5352,1,8,5,1,26,12,14,29
CFR Cluj,5352,2,5,7,2,13,9,4,22
FC Botosani,5352,3,5,4,5,8,12,-4,19
Universitate,5352,4,4,6,4,16,19,-3,18
D Bucuresti,5352,5,3,5,6,16,19,-3,14
Concordia Ch,5352,6,2,3,9,15,23,-8,9
FCSB,5353,1,9,5,0,27,10,17,32
CFR Cluj,5353,2,6,6,2,17,11,6,24
D Bucuresti,5353,3,5,4,5,21,20,1,19
Universitate,5353,4,3,5,6,16,24,-8,14
FC Botosani,5353,5,3,4,7,8,18,-10,13
Concordia Ch,5353,6,3,2,9,17,23,-6,11
FCSB,5354,1,7,6,1,24,13,11,27
CFR Cluj,5354,2,7,6,1,18,8,10,27
D Bucuresti,5354,3,4,4,6,18,20,-2,16
Universitate,5354,4,3,6,5,14,20,-6,15
Concordia Ch,5354,5,4,2,8,20,22,-2,14
FC Botosani,5354,6,3,4,7,5,16,-11,13
FCSB,5355,1,8,6,0,26,12,14,30
CFR Cluj,5355,2,6,6,2,14,8,6,24
D Bucuresti,5355,3,5,4,5,22,20,2,19
Universitate,5355,4,3,6,5,16,21,-5,15
FC Botosani,5355,5,3,5,6,6,16,-10,14
Concordia Ch,5355,6,2,3,9,16,23,-7,9
CFR Cluj,5356,1,7,6,1,17,7,10,27
FCSB,5356,2,7,5,2,23,13,10,26
D Bucuresti,5356,3,5,4,5,18,18,0,19
Universitate,5356,4,4,5,5,15,20,-5,17
FC Botosani,5356,5,3,5,6,7,15,-8,14
Concordia Ch,5356,6,2,3,9,17,24,-7,9
FCSB,5357,1,8,5,1,28,17,11,29
CFR Cluj,5357,2,7,6,1,19,8,11,27
D Bucuresti,5357,3,3,5,6,17,20,-3,14
Concordia Ch,5357,4,4,2,8,18,22,-4,14
Universitate,5357,5,3,5,6,17,24,-7,14
FC Botosani,5357,6,3,5,6,5,13,-8,14
FCSB,5358,1,8,6,0,26,10,16,30
CFR Cluj,5358,2,6,6,2,15,10,5,24
D Bucuresti,5358,3,4,4,6,19,23,-4,16
Universitate,5358,4,3,6,5,14,20,-6,15
FC Botosani,5358,5,3,5,6,7,15,-8,14
Concordia Ch,5358,6,3,3,8,18,21,-3,12
FCSB,5359,1,7,6,1,26,14,12,27
CFR Cluj,5359,2,7,6,1,17,7,10,27
D Bucuresti,5359,3,4,4,6,18,22,-4,16
FC Botosani,5359,4,4,4,6,8,13,-5,16
Universitate,5359,5,3,6,5,17,24,-7,15
Concordia Ch,5359,6,3,2,9,19,25,-6,11
FCSB,5360,1,8,6,0,29,13,16,30
CFR Cluj,5360,2,5,7,2,15,10,5,22
Universitate,5360,3,4,5,5,16,22,-6,17
D Bucuresti,5360,4,4,4,6,17,19,-2,16
FC Botosani,5360,5,3,5,6,6,14,-8,14
Concordia Ch,5360,6,3,3,8,17,22,-5,12
FCSB,5361,1,8,6,0,28,14,14,30
CFR Cluj,5361,2,5,6,3,15,12,3,21
Universitate,5361,3,4,6,4,18,20,-2,18
FC Botosani,5361,4,4,5,5,8,14,-6,17
D Bucuresti,5361,5,4,4,6,19,20,-1,16
Concordia Ch,5361,6,2,3,9,16,24,-8,9
FCSB,5362,1,7,6,1,24,12,12,27
CFR Cluj,5362,2,6,6,2,15,9,6,24
D Bucuresti,5362,3,5,4,5,20,18,2,19
Universitate,5362,4,4,6,4,17,20,-3,18
FC Botosani,5362,5,3,5,6,5,15,-10,14
Concordia Ch,5362,6,2,3,9,15,22,-7,9
FCSB,5363,1,8,5,1,25,11,14,29
CFR Cluj,5363,2,5,6,3,14,11,3,21
Universitate,5363,3,5,5,4,17,19,-2,20
D Bucuresti,5363,4,5,4,5,19,18,1,19
FC Botosani,5363,5,3,5,6,5,14,-9,14
Concordia Ch,5363,6,2,3,9,15,22,-7,9
FCSB,5364,1,8,5,1,24,11,13,29
CFR Cluj,5364,2,5,6,3,13,10,3,21
Universitate,5364,3,5,5,4,17,18,-1,20
FC Botosani,5364,4,4,4,6,7,14,-7,16
D Bucuresti,5364,5,3,5,6,16,19,-3,14
Concordia Ch,5364,6,3,3,8,17,22,-5,12
FCSB,5365,1,8,5,1,27,12,15,29
CFR Cluj,5365,2,6,6,2,15,9,6,24
Universitate,5365,3,4,5,5,15,21,-6,17
D Bucuresti,5365,4,4,4,6,19,19,0,16
FC Botosani,5365,5,4,4,6,7,15,-8,16
Concordia Ch,5365,6,3,2,9,16,23,-7,11
CFR Cluj,5366,1,7,6,1,17,7,10,27
FCSB,5366,2,7,5,2,23,13,10,26
Universitate,5366,3,4,5,5,15,20,-5,17
Concordia Ch,5366,4,4,2,8,20,23,-3,14
D Bucuresti,5366,5,3,5,6,17,21,-4,14
FC Botosani,5366,6,3,5,6,6,14,-8,14
FCSB,5367,1,9,5,0,28,11,17,32
CFR Cluj,5367,2,6,6,2,14,10,4,24
FC Botosani,5367,3,5,4,5,8,13,-5,19
D Bucuresti,5367,4,4,4,6,19,21,-2,16
Universitate,5367,5,3,5,6,15,21,-6,14
Concordia Ch,5367,6,2,2,10,16,24,-8,8
FCSB,5368,1,7,6,1,24,12,12,27
CFR Cluj,5368,2,7,6,1,17,8,9,27
D Bucuresti,5368,3,4,4,6,19,22,-3,16
Universitate,5368,4,3,6,5,14,20,-6,15
Concordia Ch,5368,5,4,2,8,19,21,-2,14
FC Botosani,5368,6,3,4,7,6,16,-10,13
FCSB,5369,1,8,5,1,27,12,15,29
CFR Cluj,5369,2,7,6,1,19,8,11,27
D Bucuresti,5369,3,4,5,5,21,21,0,17
FC Botosani,5369,4,4,5,5,8,14,-6,17
Universitate,5369,5,3,5,6,16,27,-11,14
Concordia Ch,5369,6,2,2,10,16,25,-9,8
FCSB,5370,1,9,5,0,29,12,17,32
CFR Cluj,5370,2,6,6,2,16,11,5,24
Concordia Ch,5370,3,4,2,8,22,24,-2,14
D Bucuresti,5370,4,3,5,6,18,23,-5,14
Universitate,5370,5,3,5,6,15,22,-7,14
FC Botosani,5370,6,3,5,6,6,14,-8,14
FCSB,5371,1,8,6,0,26,11,15,30
CFR Cluj,5371,2,6,7,1,18,8,10,25
D Bucuresti,5371,3,5,4,5,18,18,0,19
FC Botosani,5371,4,4,4,6,8,14,-6,16
Universitate,5371,5,3,5,6,14,24,-10,14
Concordia Ch,5371,6,2,2,10,16,25,-9,8
FCSB,5372,1,8,5,1,27,12,15,29
CFR Cluj,5372,2,5,6,3,13,11,2,21
Universitate,5372,3,5,5,4,17,19,-2,20
D Bucuresti,5372,4,4,5,5,21,21,0,17
FC Botosani,5372,5,3,6,5,8,15,-7,15
Concordia Ch,5372,6,2,3,9,17,25,-8,9
FCSB,5373,1,8,6,0,25,11,14,30
CFR Cluj,5373,2,6,6,2,16,9,7,24
FC Botosani,5373,3,5,4,5,8,13,-5,19
D Bucuresti,5373,4,4,4,6,17,19,-2,16
Universitate,5373,5,3,6,5,16,22,-6,15
Concordia Ch,5373,6,2,2,10,16,24,-8,8
FCSB,5374,1,9,5,0,27,12,15,32
CFR Cluj,5374,2,6,6,2,16,10,6,24
D Bucuresti,5374,3,3,6,5,18,20,-2,15
FC Botosani,5374,4,3,6,5,7,14,-7,15
Universitate,5374,5,3,5,6,14,20,-6,14
Concordia Ch,5374,6,2,4,8,17,23,-6,10
FCSB,5375,1,7,6,1,25,14,11,27
CFR Cluj,5375,2,6,7,1,16,9,7,25
FC Botosani,5375,3,5,4,5,8,13,-5,19
Universitate,5375,4,4,5,5,16,19,-3,17
D Bucuresti,5375,5,4,4,6,18,19,-1,16
Concordia Ch,5375,6,2,2,10,16,25,-9,8
FCSB,5376,1,9,5,0,29,11,18,32
CFR Cluj,5376,2,5,7,2,13,9,4,22
D Bucuresti,5376,3,5,4,5,18,18,0,19
FC Botosani,5376,4,4,4,6,8,15,-7,16
Universitate,5376,5,3,6,5,15,22,-7,15
Concordia Ch,5376,6,2,2,10,17,25,-8,8
FCSB,5377,1,8,6,0,26,12,14,30
CFR Cluj,5377,2,6,6,2,19,9,10,24
FC Botosani,5377,3,4,5,5,8,14,-6,17
D Bucuresti,5377,4,4,4,6,21,22,-1,16
Universitate,5377,5,3,6,5,15,24,-9,15
Concordia Ch,5377,6,2,3,9,16,24,-8,9
FCSB,5378,1,8,6,0,28,14,14,30
CFR Cluj,5378,2,5,8,1,17,11,6,23
FC Botosani,5378,3,5,4,5,9,12,-3,19
Universitate,5378,4,3,6,5,16,21,-5,15
D Bucuresti,5378,5,3,5,6,17,22,-5,14
Concordia Ch,5378,6,2,3,9,16,23,-7,9
FCSB,5379,1,8,5,1,25,12,13,29
CFR Cluj,5379,2,5,7,2,14,10,4,22
Universitate,5379,3,4,6,4,17,19,-2,18
FC Botosani,5379,4,4,5,5,10,12,-2,17
D Bucuresti,5379,5,3,5,6,17,20,-3,14
Concordia Ch,5379,6,3,2,9,17,27,-10,11
FCSB,5380,1,8,6,0,27,13,14,30
CFR Cluj,5380,2,5,6,3,14,10,4,21
Universitate,5380,3,4,6,4,17,20,-3,18
D Bucuresti,5380,4,4,5,5,20,20,0,17
FC Botosani,5380,5,3,4,7,7,18,-11,13
Concordia Ch,5380,6,3,3,8,21,25,-4,12
FCSB,5381,1,7,6,1,25,13,12,27
CFR Cluj,5381,2,6,6,2,16,10,6,24
Universitate,5381,3,4,6,4,15,18,-3,18
FC Botosani,5381,4,4,4,6,8,15,-7,16
D Bucuresti,5381,5,3,5,6,21,24,-3,14
Concordia Ch,5381,6,3,3,8,19,24,-5,12
FCSB,5382,1,8,5,1,25,12,13,29
CFR Cluj,5382,2,7,6,1,17,7,10,27
FC Botosani,5382,3,4,5,5,7,12,-5,17
D Bucuresti,5382,4,3,6,5,18,20,-2,15
Universitate,5382,5,3,5,6,14,22,-8,14
Concordia Ch,5382,6,2,3,9,17,25,-8,9
FCSB,5383,1,8,6,0,25,11,14,30
CFR Cluj,5383,2,6,6,2,17,8,9,24
D Bucuresti,5383,3,4,4,6,17,20,-3,16
FC Botosani,5383,4,4,4,6,7,14,-7,16
Universitate,5383,5,3,6,5,15,23,-8,15
Concordia Ch,5383,6,3,2,9,18,23,-5,11
FCSB,5384,1,9,5,0,27,11,16,32
CFR Cluj,5384,2,5,6,3,14,12,2,21
D Bucuresti,5384,3,4,5,5,21,20,1,17
Universitate,5384,4,4,5,5,16,19,-3,17
FC Botosani,5384,5,4,5,5,8,14,-6,17
Concordia Ch,5384,6,2,2,10,15,25,-10,8
FCSB,5385,1,7,6,1,23,11,12,27
CFR Cluj,5385,2,6,6,2,14,11,3,24
Universitate,5385,3,4,6,4,18,18,0,18
FC Botosani,5385,4,4,4,6,10,13,-3,16
Concordia Ch,5385,5,4,2,8,18,21,-3,14
D Bucuresti,5385,6,3,4,7,16,25,-9,13
FCSB,5386,1,7,6,1,25,15,10,27
CFR Cluj,5386,2,7,6,1,19,9,10,27
D Bucuresti,5386,3,3,6,5,17,19,-2,15
Universitate,5386,4,3,6,5,16,21,-5,15
FC Botosani,5386,5,3,6,5,8,15,-7,15
Concordia Ch,5386,6,2,4,8,17,23,-6,10
FCSB,5387,1,8,6,0,27,10,17,30
CFR Cluj,5387,2,6,6,2,15,11,4,24
D Bucuresti,5387,3,4,4,6,20,22,-2,16
FC Botosani,5387,4,4,4,6,6,14,-8,16
Universitate,5387,5,3,6,5,14,20,-6,15
Concordia Ch,5387,6,3,2,9,19,24,-5,11
FCSB,5388,1,8,5,1,26,13,13,29
CFR Cluj,5388,2,5,7,2,14,9,5,22
Universitate,5388,3,4,6,4,16,19,-3,18
D Bucuresti,5388,4,4,5,5,17,18,-1,17
FC Botosani,5388,5,3,6,5,5,12,-7,15
Concordia Ch,5388,6,2,3,9,15,22,-7,9
FCSB,5389,1,8,6,0,24,10,14,30
CFR Cluj,5389,2,5,8,1,14,8,6,23
D Bucuresti,5389,3,4,4,6,19,21,-2,16
FC Botosani,5389,4,4,4,6,9,17,-8,16
Universitate,5389,5,3,6,5,15,20,-5,15
Concordia Ch,5389,6,3,2,9,19,24,-5,11
CFR Cluj,5390,1,7,6,1,17,7,10,27
FCSB,5390,2,7,5,2,23,15,8,26
Universitate,5390,3,4,5,5,16,19,-3,17
FC Botosani,5390,4,3,6,5,7,14,-7,15
D Bucuresti,5390,5,3,5,6,17,24,-7,14
Concordia Ch,5390,6,3,3,8,21,22,-1,12
FCSB,5391,1,9,5,0,32,15,17,32
CFR Cluj,5391,2,6,6,2,18,12,6,24
FC Botosani,5391,3,4,5,5,6,12,-6,17
D Bucuresti,5391,4,3,5,6,16,20,-4,14
Universitate,5391,5,3,5,6,18,26,-8,14
Concordia Ch,5391,6,3,2,9,17,22,-5,11
FCSB,5392,1,8,5,1,25,12,13,29
CFR Cluj,5392,2,6,6,2,14,8,6,24
Universitate,5392,3,4,5,5,16,20,-4,17
D Bucuresti,5392,4,4,4,6,19,21,-2,16
FC Botosani,5392,5,3,5,6,8,16,-8,14
Concordia Ch,5392,6,3,3,8,17,22,-5,12
FCSB,5393,1,9,5,0,28,12,16,32
CFR Cluj,5393,2,6,6,2,16,11,5,24
D Bucuresti,5393,3,5,4,5,19,18,1,19
Universitate,5393,4,3,5,6,14,20,-6,14
FC Botosani,5393,5,3,4,7,5,15,-10,13
Concordia Ch,5393,6,3,2,9,17,23,-6,11
FCSB,5394,1,8,5,1,26,15,11,29
CFR Cluj,5394,2,6,6,2,14,10,4,24
Universitate,5394,3,4,5,5,19,19,0,17
D Bucuresti,5394,4,4,5,5,20,21,-1,17
FC Botosani,5394,5,3,6,5,7,14,-7,15
Concordia Ch,5394,6,2,3,9,16,23,-7,9
FCSB,5395,1,8,6,0,26,10,16,30
CFR Cluj,5395,2,6,7,1,15,7,8,25
FC Botosani,5395,3,5,4,5,9,13,-4,19
D Bucuresti,5395,4,4,4,6,17,20,-3,16
Universitate,5395,5,3,5,6,14,23,-9,14
Concordia Ch,5395,6,2,2,10,16,24,-8,8
FCSB,5396,1,7,5,2,24,14,10,26
CFR Cluj,5396,2,6,6,2,15,10,5,24
Universitate,5396,3,5,5,4,18,18,0,20
D Bucuresti,5396,4,4,4,6,20,22,-2,16
Concordia Ch,5396,5,4,2,8,19,22,-3,14
FC Botosani,5396,6,3,4,7,6,16,-10,13
FCSB,5397,1,9,5,0,28,12,16,32
CFR Cluj,5397,2,6,6,2,19,10,9,24
D Bucuresti,5397,3,4,5,5,18,19,-1,17
FC Botosani,5397,4,4,5,5,6,12,-6,17
Universitate,5397,5,3,5,6,14,24,-10,14
Concordia Ch,5397,6,2,2,10,16,24,-8,8
FCSB,5398,1,7,7,0,24,11,13,28
CFR Cluj,5398,2,5,8,1,13,7,6,23
D Bucuresti,5398,3,4,4,6,19,21,-2,16
Universitate,5398,4,3,7,4,15,19,-4,16
FC Botosani,5398,5,4,4,6,7,14,-7,16
Concordia Ch,5398,6,3,2,9,17,23,-6,11
FCSB,5399,1,8,5,1,26,15,11,29
CFR Cluj,5399,2,5,6,3,14,10,4,21
Universitate,5399,3,5,5,4,19,19,0,20
D Bucuresti,5399,4,4,4,6,20,21,-1,16
FC Botosani,5399,5,4,4,6,7,16,-9,16
Concordia Ch,5399,6,3,2,9,19,24,-5,11
FCSB,5400,1,8,6,0,27,13,14,30
CFR Cluj,5400,2,5,8,1,14,8,6,23
D Bucuresti,5400,3,4,5,5,20,21,-1,17
Universitate,5400,4,3,6,5,16,21,-5,15
FC Botosani,5400,5,3,4,7,6,16,-10,13
Concordia Ch,5400,6,3,3,8,19,23,-4,12
FCSB,5401,1,7,6,1,23,11,12,27
CFR Cluj,5401,2,5,7,2,13,8,5,22
Universitate,5401,3,5,5,4,16,18,-2,20
D Bucuresti,5401,4,5,4,5,19,18,1,19
FC Botosani,5401,5,4,4,6,8,14,-6,16
Concordia Ch,5401,6,2,2,10,16,26,-10,8
FCSB,5402,1,8,5,1,25,12,13,29
CFR Cluj,5402,2,6,6,2,15,9,6,24
Universitate,5402,3,4,5,5,15,19,-4,17
D Bucuresti,5402,4,4,4,6,17,21,-4,16
FC Botosani,5402,5,4,4,6,7,13,-6,16
Concordia Ch,5402,6,3,2,9,18,23,-5,11
FCSB,5403,1,9,5,0,27,11,16,32
CFR Cluj,5403,2,6,6,2,14,8,6,24
D Bucuresti,5403,3,4,4,6,19,21,-2,16
Universitate,5403,4,3,5,6,15,22,-7,14
FC Botosani,5403,5,3,5,6,5,14,-9,14
Concordia Ch,5403,6,3,3,8,18,22,-4,12
FCSB,5404,1,9,5,0,27,11,16,32
CFR Cluj,5404,2,6,6,2,15,10,5,24
FC Botosani,5404,3,5,4,5,8,13,-5,19
Universitate,5404,4,3,5,6,14,20,-6,14
D Bucuresti,5404,5,3,4,7,17,21,-4,13
Concordia Ch,5404,6,3,2,9,16,22,-6,11
FCSB,5405,1,8,6,0,25,11,14,30
CFR Cluj,5405,2,5,8,1,15,9,6,23
D Bucuresti,5405,3,5,4,5,19,19,0,19
Universitate,5405,4,3,6,5,15,20,-5,15
FC Botosani,5405,5,3,4,7,6,16,-10,13
Concordia Ch,5405,6,3,2,9,17,22,-5,11
FCSB,5406,1,8,5,1,25,14,11,29
CFR Cluj,5406,2,6,7,1,18,8,10,25
D Bucuresti,5406,3,4,5,5,17,18,-1,17
Universitate,5406,4,3,6,5,15,21,-6,15
FC Botosani,5406,5,3,5,6,5,13,-8,14
Concordia Ch,5406,6,2,4,8,15,21,-6,10
FCSB,5407,1,7,6,1,24,12,12,27
CFR Cluj,5407,2,6,7,1,15,8,7,25
D Bucuresti,5407,3,5,4,5,20,19,1,19
Universitate,5407,4,3,7,4,16,20,-4,16
FC Botosani,5407,5,3,4,7,6,15,-9,13
Concordia Ch,5407,6,3,2,9,16,23,-7,11
FCSB,5408,1,7,6,1,25,13,12,27
CFR Cluj,5408,2,6,7,1,16,7,9,25
FC Botosani,5408,3,5,4,5,11,13,-2,19
Universitate,5408,4,4,5,5,17,23,-6,17
D Bucuresti,5408,5,3,5,6,20,23,-3,14
Concordia Ch,5408,6,2,3,9,18,28,-10,9
FCSB,5409,1,8,5,1,26,15,11,29
CFR Cluj,5409,2,7,6,1,18,8,10,27
D Bucuresti,5409,3,4,5,5,21,20,1,17
FC Botosani,5409,4,3,6,5,8,15,-7,15
Universitate,5409,5,3,5,6,15,21,-6,14
Concordia Ch,5409,6,2,3,9,16,25,-9,9
FCSB,5410,1,7,7,0,25,12,13,28
CFR Cluj,5410,2,5,7,2,14,9,5,22
Universitate,5410,3,4,6,4,16,19,-3,18
D Bucuresti,5410,4,4,5,5,18,19,-1,17
FC Botosani,5410,5,3,5,6,5,13,-8,14
Concordia Ch,5410,6,2,4,8,16,22,-6,10
FCSB,5411,1,8,6,0,26,12,14,30
CFR Cluj,5411,2,6,7,1,16,8,8,25
D Bucuresti,5411,3,4,4,6,20,22,-2,16
FC Botosani,5411,4,4,4,6,8,15,-7,16
Universitate,5411,5,3,5,6,15,22,-7,14
Concordia Ch,5411,6,3,2,9,20,26,-6,11
FCSB,5412,1,8,6,0,25,11,14,30
CFR Cluj,5412,2,5,7,2,13,8,5,22
D Bucuresti,5412,3,5,4,5,20,20,0,19
FC Botosani,5412,4,4,4,6,13,15,-2,16
Universitate,5412,5,3,7,4,15,19,-4,16
Concordia Ch,5412,6,2,2,10,17,30,-13,8
FCSB,5413,1,9,5,0,27,10,17,32
CFR Cluj,5413,2,5,6,3,13,11,2,21
D Bucuresti,5413,3,5,4,5,20,18,2,19
Universitate,5413,4,4,5,5,15,19,-4,17
FC Botosani,5413,5,4,4,6,6,13,-7,16
Concordia Ch,5413,6,2,2,10,15,25,-10,8
FCSB,5414,1,7,6,1,26,15,11,27
CFR Cluj,5414,2,6,6,2,16,12,4,24
Universitate,5414,3,4,6,4,20,20,0,18
FC Botosani,5414,4,4,5,5,8,14,-6,17
D Bucuresti,5414,5,3,4,7,17,22,-5,13
Concordia Ch,5414,6,3,3,8,18,22,-4,12
FCSB,5415,1,8,6,0,24,10,14,30
CFR Cluj,5415,2,6,6,2,15,9,6,24
D Bucuresti,5415,3,4,5,5,18,19,-1,17
Universitate,5415,4,3,6,5,15,20,-5,15
FC Botosani,5415,5,3,5,6,8,16,-8,14
Concordia Ch,5415,6,3,2,9,18,24,-6,11
FCSB,5416,1,8,5,1,25,13,12,29
CFR Cluj,5416,2,6,6,2,16,9,7,24
D Bucuresti,5416,3,4,5,5,19,19,0,17
Universitate,5416,4,4,5,5,17,21,-4,17
FC Botosani,5416,5,4,5,5,7,13,-6,17
Concordia Ch,5416,6,2,2,10,15,24,-9,8
FCSB,5417,1,9,5,0,28,11,17,32
CFR Cluj,5417,2,5,7,2,13,9,4,22
FC Botosani,5417,3,4,5,5,8,12,-4,17
Universitate,5417,4,3,6,5,15,21,-6,15
D Bucuresti,5417,5,3,5,6,16,19,-3,14
Concordia Ch,5417,6,3,2,9,16,24,-8,11
FCSB,5418,1,7,6,1,25,14,11,27
CFR Cluj,5418,2,6,7,1,18,8,10,25
D Bucuresti,5418,3,4,5,5,19,19,0,17
Universitate,5418,4,4,5,5,17,23,-6,17
FC Botosani,5418,5,3,4,7,5,15,-10,13
Concordia Ch,5418,6,3,3,8,17,22,-5,12
FCSB,5419,1,8,6,0,26,12,14,30
CFR Cluj,5419,2,5,8,1,14,8,6,23
D Bucuresti,5419,3,4,4,6,17,20,-3,16
Universitate,5419,4,3,6,5,15,20,-5,15
Concordia Ch,5419,5,4,2,8,20,22,-2,14
FC Botosani,5419,6,3,4,7,6,16,-10,13
FCSB,5420,1,8,6,0,28,14,14,30
CFR Cluj,5420,2,6,6,2,15,9,6,24
D Bucuresti,5420,3,5,4,5,19,18,1,19
Universitate,5420,4,3,6,5,17,22,-5,15
FC Botosani,5420,5,3,5,6,5,14,-9,14
Concordia Ch,5420,6,2,3,9,15,22,-7,9
FCSB,5421,1,8,5,1,25,12,13,29
CFR Cluj,5421,2,6,6,2,16,9,7,24
Universitate,5421,3,4,5,5,15,20,-5,17
FC Botosani,5421,4,4,5,5,6,12,-6,17
D Bucuresti,5421,5,3,5,6,17,20,-3,14
Concordia Ch,5421,6,2,4,8,16,22,-6,10
FCSB,5422,1,7,6,1,23,13,10,27
CFR Cluj,5422,2,6,7,1,14,7,7,25
Universitate,5422,3,4,5,5,17,19,-2,17
FC Botosani,5422,4,4,4,6,7,13,-6,16
D Bucuresti,5422,5,3,5,6,16,20,-4,14
Concordia Ch,5422,6,3,3,8,16,21,-5,12
FCSB,5423,1,8,6,0,27,11,16,30
CFR Cluj,5423,2,6,7,1,16,8,8,25
FC Botosani,5423,3,4,5,5,6,12,-6,17
D Bucuresti,5423,4,3,5,6,17,20,-3,14
Universitate,5423,5,3,5,6,14,23,-9,14
Concordia Ch,5423,6,3,2,9,17,23,-6,11
FCSB,5424,1,8,5,1,24,11,13,29
CFR Cluj,5424,2,7,6,1,16,7,9,27
D Bucuresti,5424,3,4,5,5,17,18,-1,17
Universitate,5424,4,3,5,6,14,21,-7,14
FC Botosani,5424,5,3,5,6,5,13,-8,14
Concordia Ch,5424,6,3,2,9,16,22,-6,11
FCSB,5425,1,8,6,0,26,12,14,30
CFR Cluj,5425,2,5,8,1,14,8,6,23
FC Botosani,5425,3,4,5,5,6,12,-6,17
Universitate,5425,4,3,6,5,17,22,-5,15
D Bucuresti,5425,5,3,4,7,19,23,-4,13
Concordia Ch,5425,6,3,3,8,19,24,-5,12
FCSB,5426,1,7,5,2,24,13,11,26
CFR Cluj,5426,2,6,6,2,14,8,6,24
Universitate,5426,3,5,5,4,17,19,-2,20
D Bucuresti,5426,4,4,4,6,17,20,-3,16
FC Botosani,5426,5,4,4,6,7,14,-7,16
Concordia Ch,5426,6,3,2,9,18,23,-5,11
FCSB,5427,1,7,6,1,25,13,12,27
CFR Cluj,5427,2,6,7,1,15,7,8,25
Universitate,5427,3,4,5,5,17,22,-5,17
FC Botosani,5427,4,4,5,5,8,14,-6,17
D Bucuresti,5427,5,3,5,6,19,22,-3,14
Concordia Ch,5427,6,3,2,9,19,25,-6,11
FCSB,5428,1,8,6,0,27,12,15,30
CFR Cluj,5428,2,5,7,2,14,9,5,22
Universitate,5428,3,4,5,5,16,21,-5,17
FC Botosani,5428,4,4,4,6,7,15,-8,16
Concordia Ch,5428,5,4,2,8,20,21,-1,14
D Bucuresti,5428,6,3,4,7,17,23,-6,13
FCSB,5429,1,9,5,0,28,12,16,32
CFR Cluj,5429,2,5,6,3,16,12,4,21
D Bucuresti,5429,3,4,5,5,20,19,1,17
Universitate,5429,4,4,5,5,16,21,-5,17
FC Botosani,5429,5,3,6,5,5,12,-7,15
Concordia Ch,5429,6,2,3,9,16,25,-9,9
FCSB,5430,1,9,5,0,27,12,15,32
CFR Cluj,5430,2,6,6,2,16,10,6,24
FC Botosani,5430,3,4,5,5,8,12,-4,17
D Bucuresti,5430,4,3,5,6,17,22,-5,14
Universitate,5430,5,3,5,6,14,20,-6,14
Concordia Ch,5430,6,3,2,9,19,25,-6,11
FCSB,5431,1,8,5,1,24,11,13,29
CFR Cluj,5431,2,6,6,2,14,8,6,24
Universitate,5431,3,4,5,5,15,19,-4,17
FC Botosani,5431,4,4,5,5,7,12,-5,17
D Bucuresti,5431,5,3,5,6,16,19,-3,14
Concordia Ch,5431,6,3,2,9,16,23,-7,11
FCSB,5432,1,7,7,0,26,13,13,28
CFR Cluj,5432,2,6,7,1,15,8,7,25
D Bucuresti,5432,3,4,5,5,19,19,0,17
Universitate,5432,4,3,6,5,16,21,-5,15
FC Botosani,5432,5,3,5,6,6,15,-9,14
Concordia Ch,5432,6,3,2,9,17,23,-6,11
FCSB,5433,1,9,5,0,29,10,19,32
CFR Cluj,5433,2,6,6,2,14,10,4,24
FC Botosani,5433,3,4,5,5,8,14,-6,17
D Bucuresti,5433,4,3,5,6,20,23,-3,14
Universitate,5433,5,3,5,6,14,22,-8,14
Concordia Ch,5433,6,2,4,8,17,23,-6,10
FCSB,5434,1,8,5,1,26,13,13,29
CFR Cluj,5434,2,6,6,2,16,9,7,24
Universitate,5434,3,4,5,5,16,21,-5,17
D Bucuresti,5434,4,4,4,6,19,21,-2,16
FC Botosani,5434,5,3,5,6,5,14,-9,14
Concordia Ch,5434,6,3,3,8,18,22,-4,12
FCSB,5435,1,9,5,0,29,13,16,32
CFR Cluj,5435,2,6,6,2,16,11,5,24
FC Botosani,5435,3,5,4,5,9,13,-4,19
Universitate,5435,4,3,5,6,15,21,-6,14
D Bucuresti,5435,5,3,4,7,18,24,-6,13
Concordia Ch,5435,6,3,2,9,18,23,-5,11
CFR Cluj,5436,1,7,6,1,16,8,8,27
FCSB,5436,2,7,5,2,25,14,11,26
Universitate,5436,3,4,5,5,16,20,-4,17
FC Botosani,5436,4,4,5,5,8,14,-6,17
D Bucuresti,5436,5,3,5,6,18,21,-3,14
Concordia Ch,5436,6,3,2,9,18,24,-6,11
FCSB,5437,1,8,6,0,26,11,15,30
CFR Cluj,5437,2,6,7,1,16,8,8,25
D Bucuresti,5437,3,5,4,5,21,20,1,19
FC Botosani,5437,4,4,4,6,8,15,-7,16
Universitate,5437,5,3,5,6,14,22,-8,14
Concordia Ch,5437,6,2,2,10,17,26,-9,8
FCSB,5438,1,7,7,0,25,12,13,28
CFR Cluj,5438,2,6,7,1,17,9,8,25
FC Botosani,5438,3,4,5,5,6,12,-6,17
D Bucuresti,5438,4,4,4,6,18,20,-2,16
Universitate,5438,5,3,6,5,18,24,-6,15
Concordia Ch,5438,6,2,3,9,16,23,-7,9
FCSB,5439,1,8,5,1,26,12,14,29
CFR Cluj,5439,2,6,6,2,15,10,5,24
Universitate,5439,3,4,5,5,17,21,-4,17
D Bucuresti,5439,4,3,6,5,18,20,-2,15
FC Botosani,5439,5,3,5,6,6,14,-8,14
Concordia Ch,5439,6,3,3,8,17,22,-5,12
FCSB,5440,1,8,5,1,25,15,10,29
CFR Cluj,5440,2,5,6,3,14,11,3,21
Universitate,5440,3,5,5,4,20,18,2,20
FC Botosani,5440,4,4,4,6,6,13,-7,16
Concordia Ch,5440,5,4,2,8,18,21,-3,14
D Bucuresti,5440,6,3,4,7,16,21,-5,13
FCSB,5441,1,8,5,1,25,12,13,29
CFR Cluj,5441,2,6,6,2,15,10,5,24
D Bucuresti,5441,3,5,4,5,22,20,2,19
Universitate,5441,4,4,5,5,17,20,-3,17
FC Botosani,5441,5,4,4,6,8,14,-6,16
Concordia Ch,5441,6,2,2,10,18,29,-11,8
FCSB,5442,1,8,5,1,27,13,14,29
CFR Cluj,5442,2,6,6,2,17,11,6,24
FC Botosani,5442,3,5,4,5,8,12,-4,19
Universitate,5442,4,4,5,5,19,24,-5,17
D Bucuresti,5442,5,4,4,6,18,19,-1,16
Concordia Ch,5442,6,2,2,10,15,25,-10,8
FCSB,5443,1,8,6,0,26,12,14,30
CFR Cluj,5443,2,6,6,2,16,10,6,24
D Bucuresti,5443,3,4,4,6,21,21,0,16
Universitate,5443,4,3,6,5,18,23,-5,15
Concordia Ch,5443,5,4,2,8,19,22,-3,14
FC Botosani,5443,6,3,4,7,5,17,-12,13
FCSB,5444,1,8,6,0,28,14,14,30
CFR Cluj,5444,2,6,7,1,16,9,7,25
D Bucuresti,5444,3,3,6,5,16,18,-2,15
FC Botosani,5444,4,3,6,5,5,12,-7,15
Universitate,5444,5,3,5,6,16,22,-6,14
Concordia Ch,5444,6,2,4,8,15,21,-6,10
FCSB,5445,1,8,6,0,25,11,14,30
CFR Cluj,5445,2,6,7,1,15,8,7,25
D Bucuresti,5445,3,3,6,5,16,18,-2,15
Universitate,5445,4,3,5,6,14,20,-6,14
FC Botosani,5445,5,3,5,6,7,15,-8,14
Concordia Ch,5445,6,3,3,8,18,23,-5,12
FCSB,5446,1,8,6,0,26,11,15,30
CFR Cluj,5446,2,5,8,1,16,10,6,23
D Bucuresti,5446,3,4,5,5,17,18,-1,17
FC Botosani,5446,4,4,4,6,6,13,-7,16
Universitate,5446,5,3,6,5,16,22,-6,15
Concordia Ch,5446,6,2,3,9,15,22,-7,9
FCSB,5447,1,7,6,1,24,13,11,27
CFR Cluj,5447,2,6,6,2,16,11,5,24
Universitate,5447,3,4,6,4,19,20,-1,18
D Bucuresti,5447,4,4,5,5,19,20,-1,17
FC Botosani,5447,5,4,4,6,7,13,-6,16
Concordia Ch,5447,6,2,3,9,17,25,-8,9
FCSB,5448,1,8,6,0,25,11,14,30
CFR Cluj,5448,2,5,7,2,13,8,5,22
Universitate,5448,3,3,7,4,15,19,-4,16
Concordia Ch,5448,4,4,2,8,19,22,-3,14
D Bucuresti,5448,5,3,5,6,16,20,-4,14
FC Botosani,5448,6,3,5,6,6,14,-8,14
FCSB,5449,1,9,5,0,26,11,15,32
CFR Cluj,5449,2,6,6,2,14,8,6,24
FC Botosani,5449,3,4,5,5,7,13,-6,17
Universitate,5449,4,3,5,6,15,21,-6,14
D Bucuresti,5449,5,3,4,7,16,23,-7,13
Concordia Ch,5449,6,3,3,8,20,22,-2,12
FCSB,5450,1,8,5,1,30,13,17,29
CFR Cluj,5450,2,6,6,2,17,11,6,24
Universitate,5450,3,4,5,5,16,24,-8,17
D Bucuresti,5450,4,3,6,5,18,20,-2,15
FC Botosani,5450,5,3,5,6,8,16,-8,14
Concordia Ch,5450,6,3,3,8,19,24,-5,12
FCSB,5451,1,7,6,1,24,13,11,27
CFR Cluj,5451,2,7,6,1,17,8,9,27
D Bucuresti,5451,3,5,4,5,21,19,2,19
FC Botosani,5451,4,4,4,6,6,14,-8,16
Universitate,5451,5,3,6,5,16,21,-5,15
Concordia Ch,5451,6,2,2,10,16,25,-9,8
FCSB,5452,1,8,6,0,28,14,14,30
CFR Cluj,5452,2,6,6,2,16,10,6,24
D Bucuresti,5452,3,4,5,5,18,19,-1,17
FC Botosani,5452,4,4,5,5,8,13,-5,17
Universitate,5452,5,3,6,5,16,21,-5,15
Concordia Ch,5452,6,2,2,10,15,24,-9,8
FCSB,5453,1,7,6,1,26,15,11,27
CFR Cluj,5453,2,5,8,1,15,9,6,23
Universitate,5453,3,4,6,4,19,21,-2,18
FC Botosani,5453,4,3,6,5,6,13,-7,15
D Bucuresti,5453,5,3,5,6,17,23,-6,14
Concordia Ch,5453,6,3,3,8,19,21,-2,12
FCSB,5454,1,8,5,1,24,11,13,29
CFR Cluj,5454,2,5,7,2,13,8,5,22
Universitate,5454,3,4,6,4,15,18,-3,18
FC Botosani,5454,4,4,5,5,6,12,-6,17
D Bucuresti,5454,5,3,6,5,17,19,-2,15
Concordia Ch,5454,6,2,3,9,16,23,-7,9
FCSB,5455,1,7,7,0,26,13,13,28
CFR Cluj,5455,2,5,7,2,15,10,5,22
Universitate,5455,3,4,6,4,16,19,-3,18
D Bucuresti,5455,4,4,4,6,19,24,-5,16
Concordia Ch,5455,5,4,2,8,22,21,1,14
FC Botosani,5455,6,3,4,7,5,16,-11,13
FCSB,5456,1,8,5,1,25,11,14,29
CFR Cluj,5456,2,6,6,2,15,9,6,24
D Bucuresti,5456,3,5,4,5,19,18,1,19
Universitate,5456,4,4,5,5,16,21,-5,17
FC Botosani,5456,5,4,4,6,7,14,-7,16
Concordia Ch,5456,6,2,2,10,16,25,-9,8
FCSB,5457,1,9,5,0,26,11,15,32
CFR Cluj,5457,2,5,7,2,15,10,5,22
D Bucuresti,5457,3,5,4,5,18,18,0,19
Universitate,5457,4,3,6,5,15,20,-5,15
FC Botosani,5457,5,3,5,6,5,13,-8,14
Concordia Ch,5457,6,2,3,9,15,22,-7,9
FCSB,5458,1,8,5,1,25,12,13,29
CFR Cluj,5458,2,7,6,1,15,7,8,27
D Bucuresti,5458,3,5,4,5,19,19,0,19
FC Botosani,5458,4,4,4,6,7,14,-7,16
Universitate,5458,5,3,5,6,15,21,-6,14
Concordia Ch,5458,6,2,2,10,17,25,-8,8
FCSB,5459,1,9,5,0,27,10,17,32
CFR Cluj,5459,2,6,6,2,18,11,7,24
FC Botosani,5459,3,4,5,5,7,13,-6,17
D Bucuresti,5459,4,4,4,6,18,20,-2,16
Universitate,5459,5,3,5,6,16,25,-9,14
Concordia Ch,5459,6,2,3,9,17,24,-7,9
FCSB,5460,1,9,5,0,28,13,15,32
CFR Cluj,5460,2,5,7,2,15,10,5,22
D Bucuresti,5460,3,4,5,5,19,18,1,17
FC Botosani,5460,4,4,5,5,6,12,-6,17
Universitate,5460,5,3,6,5,15,20,-5,15
Concordia Ch,5460,6,2,2,10,15,25,-10,8
FCSB,5461,1,8,6,0,27,13,14,30
CFR Cluj,5461,2,6,6,2,15,9,6,24
D Bucuresti,5461,3,4,5,5,17,18,-1,17
Universitate,5461,4,3,6,5,16,21,-5,15
FC Botosani,5461,5,3,4,7,6,15,-9,13
Concordia Ch,5461,6,3,3,8,17,22,-5,12
FCSB,5462,1,8,5,1,26,11,15,29
CFR Cluj,5462,2,7,6,1,15,7,8,27
D Bucuresti,5462,3,4,5,5,17,18,-1,17
Universitate,5462,4,3,5,6,14,22,-8,14
FC Botosani,5462,5,3,4,7,6,15,-9,13
Concordia Ch,5462,6,3,3,8,17,22,-5,12
FCSB,5463,1,8,6,0,27,12,15,30
CFR Cluj,5463,2,6,7,1,15,8,7,25
D Bucuresti,5463,3,4,5,5,18,19,-1,17
Universitate,5463,4,3,5,6,15,22,-7,14
FC Botosani,5463,5,3,5,6,6,14,-8,14
Concordia Ch,5463,6,3,2,9,16,22,-6,11
FCSB,5464,1,8,5,1,24,11,13,29
CFR Cluj,5464,2,5,7,2,14,9,5,22
Universitate,5464,3,4,6,4,16,19,-3,18
FC Botosani,5464,4,4,4,6,6,13,-7,16
Concordia Ch,5464,5,4,2,8,18,22,-4,14
D Bucuresti,5464,6,3,4,7,17,21,-4,13
FCSB,5465,1,8,6,0,26,12,14,30
CFR Cluj,5465,2,6,6,2,16,9,7,24
FC Botosani,5465,3,5,4,5,9,13,-4,19
D Bucuresti,5465,4,4,4,6,18,20,-2,16
Universitate,5465,5,3,6,5,15,21,-6,15
Concordia Ch,5465,6,2,2,10,16,25,-9,8
FCSB,5466,1,8,6,0,26,12,14,30
CFR Cluj,5466,2,6,6,2,15,9,6,24
D Bucuresti,5466,3,4,4,6,18,19,-1,16
Universitate,5466,4,3,6,5,17,22,-5,15
FC Botosani,5466,5,3,5,6,5,14,-9,14
Concordia Ch,5466,6,3,3,8,16,21,-5,12
FCSB,5467,1,7,6,1,25,13,12,27
CFR Cluj,5467,2,6,7,1,15,8,7,25
D Bucuresti,5467,3,4,5,5,19,19,0,17
Universitate,5467,4,3,7,4,15,19,-4,16
FC Botosani,5467,5,3,5,6,5,13,-8,14
Concordia Ch,5467,6,3,2,9,17,24,-7,11
FCSB,5468,1,8,6,0,27,13,14,30
CFR Cluj,5468,2,6,6,2,16,9,7,24
FC Botosani,5468,3,5,4,5,7,12,-5,19
Universitate,5468,4,3,6,5,16,22,-6,15
D Bucuresti,5468,5,3,4,7,16,21,-5,13
Concordia Ch,5468,6,3,2,9,17,22,-5,11
FCSB,5469,1,8,6,0,26,12,14,30
CFR Cluj,5469,2,5,8,1,15,9,6,23
FC Botosani,5469,3,4,5,5,8,14,-6,17
D Bucuresti,5469,4,4,4,6,18,19,-1,16
Universitate,5469,5,3,6,5,16,21,-5,15
Concordia Ch,5469,6,2,3,9,17,25,-8,9
FCSB,5470,1,7,7,0,25,12,13,28
CFR Cluj,5470,2,5,7,2,14,9,5,22
Universitate,5470,3,4,6,4,16,19,-3,18
Concordia Ch,5470,4,4,2,8,19,22,-3,14
D Bucuresti,5470,5,3,5,6,18,22,-4,14
FC Botosani,5470,6,3,5,6,6,14,-8,14
FCSB,5471,1,8,5,1,25,12,13,29
CFR Cluj,5471,2,6,6,2,15,9,6,24
Universitate,5471,3,4,5,5,15,19,-4,17
D Bucuresti,5471,4,3,6,5,16,18,-2,15
FC Botosani,5471,5,3,6,5,9,16,-7,15
Concordia Ch,5471,6,2,4,8,19,25,-6,10
FCSB,5472,1,9,5,0,28,11,17,32
CFR Cluj,5472,2,5,7,2,14,10,4,22
D Bucuresti,5472,3,4,5,5,17,18,-1,17
Universitate,5472,4,3,6,5,14,20,-6,15
FC Botosani,5472,5,3,4,7,5,14,-9,13
Concordia Ch,5472,6,3,3,8,16,21,-5,12
FCSB,5473,1,8,5,1,25,13,12,29
CFR Cluj,5473,2,5,6,3,13,12,1,21
Universitate,5473,3,5,5,4,20,18,2,20
FC Botosani,5473,4,4,5,5,8,14,-6,17
D Bucuresti,5473,5,3,5,6,17,20,-3,14
Concordia Ch,5473,6,2,4,8,16,22,-6,10
FCSB,5474,1,9,5,0,25,10,15,32
CFR Cluj,5474,2,6,6,2,15,9,6,24
D Bucuresti,5474,3,4,5,5,19,19,0,17
Universitate,5474,4,3,5,6,15,21,-6,14
FC Botosani,5474,5,3,5,6,5,14,-9,14
Concordia Ch,5474,6,2,4,8,16,22,-6,10
FCSB,5475,1,7,6,1,23,11,12,27
CFR Cluj,5475,2,6,6,2,14,8,6,24
Universitate,5475,3,4,6,4,15,18,-3,18
D Bucuresti,5475,4,4,4,6,19,20,-1,16
FC Botosani,5475,5,4,4,6,7,14,-7,16
Concordia Ch,5475,6,3,2,9,18,25,-7,11
FCSB,5476,1,9,5,0,27,12,15,32
CFR Cluj,5476,2,5,6,3,14,10,4,21
Universitate,5476,3,4,5,5,16,20,-4,17
FC Botosani,5476,4,4,5,5,6,12,-6,17
D Bucuresti,5476,5,3,5,6,18,21,-3,14
Concordia Ch,5476,6,3,2,9,18,24,-6,11
FCSB,5477,1,9,5,0,28,12,16,32
CFR Cluj,5477,2,6,6,2,15,9,6,24
FC Botosani,5477,3,4,5,5,7,13,-6,17
D Bucuresti,5477,4,3,6,5,17,19,-2,15
Universitate,5477,5,3,5,6,15,22,-7,14
Concordia Ch,5477,6,2,3,9,17,24,-7,9
FCSB,5478,1,9,5,0,27,11,16,32
CFR Cluj,5478,2,5,6,3,15,13,2,21
Universitate,5478,3,4,5,5,17,20,-3,17
D Bucuresti,5478,4,4,4,6,18,23,-5,16
FC Botosani,5478,5,3,5,6,5,13,-8,14
Concordia Ch,5478,6,3,3,8,20,22,-2,12
CFR Cluj,5479,1,7,6,1,18,10,8,27
FCSB,5479,2,7,5,2,25,14,11,26
D Bucuresti,5479,3,5,4,5,20,19,1,19
Universitate,5479,4,4,5,5,16,20,-4,17
FC Botosani,5479,5,3,5,6,5,14,-9,14
Concordia Ch,5479,6,2,3,9,16,23,-7,9
FCSB,5480,1,8,6,0,27,13,14,30
CFR Cluj,5480,2,5,7,2,15,10,5,22
FC Botosani,5480,3,5,4,5,11,13,-2,19
Universitate,5480,4,3,7,4,17,21,-4,16
D Bucuresti,5480,5,3,4,7,16,25,-9,13
Concordia Ch,5480,6,3,2,9,19,23,-4,11
CFR Cluj,5481,1,7,6,1,15,7,8,27
FCSB,5481,2,7,5,2,23,12,11,26
Universitate,5481,3,4,5,5,15,19,-4,17
FC Botosani,5481,4,4,5,5,8,14,-6,17
D Bucuresti,5481,5,3,6,5,18,20,-2,15
Concordia Ch,5481,6,2,3,9,17,24,-7,9
FCSB,5482,1,8,5,1,24,11,13,29
CFR Cluj,5482,2,7,6,1,15,7,8,27
FC Botosani,5482,3,4,5,5,9,14,-5,17
D Bucuresti,5482,4,3,6,5,19,21,-2,15
Universitate,5482,5,3,5,6,14,20,-6,14
Concordia Ch,5482,6,2,3,9,18,26,-8,9
FCSB,5483,1,8,5,1,26,13,13,29
CFR Cluj,5483,2,5,6,3,14,12,2,21
Universitate,5483,3,5,5,4,18,18,0,20
D Bucuresti,5483,4,4,4,6,21,22,-1,16
FC Botosani,5483,5,4,4,6,8,16,-8,16
Concordia Ch,5483,6,3,2,9,19,25,-6,11
FCSB,5484,1,8,6,0,31,13,18,30
CFR Cluj,5484,2,5,7,2,13,12,1,22
FC Botosani,5484,3,4,5,5,7,13,-6,17
Universitate,5484,4,3,7,4,17,21,-4,16
D Bucuresti,5484,5,3,5,6,17,21,-4,14
Concordia Ch,5484,6,3,2,9,19,24,-5,11
FCSB,5485,1,8,5,1,26,13,13,29
CFR Cluj,5485,2,5,6,3,13,9,4,21
Universitate,5485,3,5,5,4,18,20,-2,20
D Bucuresti,5485,4,4,5,5,25,21,4,17
FC Botosani,5485,5,4,4,6,7,19,-12,16
Concordia Ch,5485,6,2,3,9,17,24,-7,9
FCSB,5486,1,7,6,1,26,14,12,27
CFR Cluj,5486,2,7,6,1,16,8,8,27
FC Botosani,5486,3,5,4,5,12,13,-1,19
Universitate,5486,4,3,6,5,16,21,-5,15
D Bucuresti,5486,5,3,5,6,18,22,-4,14
Concordia Ch,5486,6,2,3,9,16,26,-10,9
FCSB,5487,1,8,5,1,25,12,13,29
CFR Cluj,5487,2,6,6,2,15,8,7,24
Universitate,5487,3,4,5,5,16,21,-5,17
D Bucuresti,5487,4,4,4,6,20,22,-2,16
Concordia Ch,5487,5,4,2,8,21,24,-3,14
FC Botosani,5487,6,3,4,7,5,15,-10,13
FCSB,5488,1,9,5,0,28,11,17,32
CFR Cluj,5488,2,5,6,3,14,11,3,21
Universitate,5488,3,4,5,5,16,21,-5,17
D Bucuresti,5488,4,4,4,6,17,21,-4,16
Concordia Ch,5488,5,4,2,8,19,21,-2,14
FC Botosani,5488,6,3,4,7,5,14,-9,13
FCSB,5489,1,9,5,0,26,11,15,32
CFR Cluj,5489,2,5,6,3,16,13,3,21
D Bucuresti,5489,3,4,5,5,22,21,1,17
Universitate,5489,4,4,5,5,18,21,-3,17
FC Botosani,5489,5,4,5,5,9,15,-6,17
Concordia Ch,5489,6,2,2,10,19,29,-10,8
FCSB,5490,1,7,7,0,26,13,13,28
CFR Cluj,5490,2,5,8,1,14,8,6,23
D Bucuresti,5490,3,4,4,6,19,19,0,16
Universitate,5490,4,3,7,4,16,20,-4,16
Concordia Ch,5490,5,4,2,8,17,21,-4,14
FC Botosani,5490,6,3,4,7,5,16,-11,13
FCSB,5491,1,8,6,0,24,10,14,30
CFR Cluj,5491,2,6,6,2,16,8,8,24
D Bucuresti,5491,3,5,4,5,19,18,1,19
Universitate,5491,4,3,6,5,14,21,-7,15
FC Botosani,5491,5,3,5,6,6,14,-8,14
Concordia Ch,5491,6,2,3,9,16,24,-8,9
FCSB,5492,1,7,5,2,23,12,11,26
CFR Cluj,5492,2,6,6,2,14,8,6,24
Universitate,5492,3,5,5,4,16,18,-2,20
FC Botosani,5492,4,5,4,5,8,13,-5,19
D Bucuresti,5492,5,3,5,6,16,19,-3,14
Concordia Ch,5492,6,2,3,9,16,23,-7,9
FCSB,5493,1,8,6,0,25,11,14,30
CFR Cluj,5493,2,6,6,2,15,9,6,24
FC Botosani,5493,3,4,5,5,6,12,-6,17
D Bucuresti,5493,4,3,6,5,16,18,-2,15
Universitate,5493,5,3,6,5,16,21,-5,15
Concordia Ch,5493,6,2,3,9,15,22,-7,9
CFR Cluj,5494,1,7,6,1,19,8,11,27
FCSB,5494,2,7,5,2,24,14,10,26
D Bucuresti,5494,3,4,5,5,18,19,-1,17
Universitate,5494,4,4,5,5,15,21,-6,17
FC Botosani,5494,5,4,4,6,7,14,-7,16
Concordia Ch,5494,6,2,3,9,17,24,-7,9
FCSB,5495,1,9,5,0,31,12,19,32
CFR Cluj,5495,2,5,6,3,14,13,1,21
Universitate,5495,3,4,5,5,18,23,-5,17
D Bucuresti,5495,4,4,4,6,20,21,-1,16
FC Botosani,5495,5,4,4,6,8,17,-9,16
Concordia Ch,5495,6,3,2,9,18,23,-5,11
FCSB,5496,1,7,7,0,25,12,13,28
CFR Cluj,5496,2,6,7,1,17,8,9,25
FC Botosani,5496,3,5,4,5,9,13,-4,19
Universitate,5496,4,3,6,5,15,22,-7,15
D Bucuresti,5496,5,3,5,6,18,22,-4,14
Concordia Ch,5496,6,2,3,9,18,25,-7,9
FCSB,5497,1,7,7,0,25,12,13,28
CFR Cluj,5497,2,5,8,1,17,11,6,23
FC Botosani,5497,3,5,4,5,8,13,-5,19
D Bucuresti,5497,4,4,4,6,17,19,-2,16
Universitate,5497,5,3,7,4,18,22,-4,16
Concordia Ch,5497,6,2,2,10,16,24,-8,8
FCSB,5498,1,8,5,1,25,15,10,29
CFR Cluj,5498,2,5,6,3,14,10,4,21
Universitate,5498,3,5,5,4,21,20,1,20
D Bucuresti,5498,4,4,4,6,17,19,-2,16
Concordia Ch,5498,5,4,2,8,18,21,-3,14
FC Botosani,5498,6,3,4,7,5,15,-10,13
FCSB,5499,1,8,6,0,27,11,16,30
CFR Cluj,5499,2,6,7,1,17,8,9,25
D Bucuresti,5499,3,5,4,5,22,18,4,19
FC Botosani,5499,4,4,4,6,7,16,-9,16
Universitate,5499,5,3,5,6,14,24,-10,14
Concordia Ch,5499,6,2,2,10,16,26,-10,8
FCSB,5500,1,7,7,0,24,11,13,28
CFR Cluj,5500,2,6,7,1,15,7,8,25
FC Botosani,5500,3,4,5,5,7,13,-6,17
Universitate,5500,4,3,6,5,15,21,-6,15
D Bucuresti,5500,5,3,4,7,17,22,-5,13
Concordia Ch,5500,6,3,3,8,19,23,-4,12
FCSB,5501,1,8,5,1,25,12,13,29
CFR Cluj,5501,2,6,7,1,15,8,7,25
D Bucuresti,5501,3,4,5,5,19,20,-1,17
Universitate,5501,4,3,6,5,14,19,-5,15
FC Botosani,5501,5,3,6,5,8,15,-7,15
Concordia Ch,5501,6,2,3,9,18,25,-7,9
FCSB,5502,1,9,5,0,26,10,16,32
CFR Cluj,5502,2,6,6,2,15,9,6,24
D Bucuresti,5502,3,4,4,6,20,21,-1,16
Universitate,5502,4,3,5,6,14,21,-7,14
FC Botosani,5502,5,3,5,6,5,14,-9,14
Concordia Ch,5502,6,3,3,8,18,23,-5,12
FCSB,5503,1,7,7,0,26,13,13,28
CFR Cluj,5503,2,6,7,1,18,10,8,25
D Bucuresti,5503,3,5,4,5,21,20,1,19
FC Botosani,5503,4,4,4,6,6,13,-7,16
Universitate,5503,5,3,6,5,18,24,-6,15
Concordia Ch,5503,6,2,2,10,17,26,-9,8
FCSB,5504,1,8,6,0,24,10,14,30
CFR Cluj,5504,2,5,8,1,14,8,6,23
D Bucuresti,5504,3,4,4,6,18,20,-2,16
Universitate,5504,4,3,6,5,15,20,-5,15
FC Botosani,5504,5,3,5,6,5,14,-9,14
Concordia Ch,5504,6,3,3,8,17,21,-4,12
FCSB,5505,1,7,7,0,24,11,13,28
CFR Cluj,5505,2,6,7,1,15,8,7,25
FC Botosani,5505,3,4,4,6,7,14,-7,16
Universitate,5505,4,3,6,5,16,21,-5,15
Concordia Ch,5505,5,4,2,8,19,23,-4,14
D Bucuresti,5505,6,3,4,7,19,23,-4,13
FCSB,5506,1,7,5,2,23,14,9,26
CFR Cluj,5506,2,6,6,2,15,10,5,24
Universitate,5506,3,5,5,4,20,19,1,20
FC Botosani,5506,4,4,5,5,7,13,-6,17
D Bucuresti,5506,5,3,5,6,16,19,-3,14
Concordia Ch,5506,6,3,2,9,17,23,-6,11
FCSB,5507,1,7,6,1,25,13,12,27
CFR Cluj,5507,2,5,8,1,16,10,6,23
D Bucuresti,5507,3,5,4,5,20,19,1,19
Universitate,5507,4,4,6,4,16,19,-3,18
FC Botosani,5507,5,3,5,6,6,14,-8,14
Concordia Ch,5507,6,2,3,9,15,23,-8,9
CFR Cluj,5508,1,7,6,1,18,7,11,27
FCSB,5508,2,7,5,2,24,16,8,26
Universitate,5508,3,4,5,5,17,21,-4,17
FC Botosani,5508,4,4,4,6,7,13,-6,16
Concordia Ch,5508,5,4,2,8,18,22,-4,14
D Bucuresti,5508,6,3,4,7,17,22,-5,13
FCSB,5509,1,8,6,0,27,13,14,30
CFR Cluj,5509,2,6,7,1,17,10,7,25
FC Botosani,5509,3,3,6,5,5,12,-7,15
D Bucuresti,5509,4,3,5,6,16,20,-4,14
Universitate,5509,5,3,5,6,16,22,-6,14
Concordia Ch,5509,6,3,3,8,17,21,-4,12
FCSB,5510,1,7,5,2,24,13,11,26
CFR Cluj,5510,2,6,7,1,14,7,7,25
Universitate,5510,3,4,6,4,16,19,-3,18
FC Botosani,5510,4,4,4,6,8,15,-7,16
Concordia Ch,5510,5,4,2,8,20,23,-3,14
D Bucuresti,5510,6,3,4,7,16,21,-5,13
FCSB,5511,1,9,5,0,26,10,16,32
CFR Cluj,5511,2,5,7,2,13,8,5,22
FC Botosani,5511,3,5,4,5,13,14,-1,19
Universitate,5511,4,3,6,5,14,20,-6,15
D Bucuresti,5511,5,3,4,7,18,23,-5,13
Concordia Ch,5511,6,3,2,9,18,27,-9,11
FCSB,5512,1,9,5,0,25,10,15,32
CFR Cluj,5512,2,5,7,2,14,9,5,22
FC Botosani,5512,3,4,4,6,7,16,-9,16
Universitate,5512,4,3,6,5,15,20,-5,15
D Bucuresti,5512,5,3,5,6,16,19,-3,14
Concordia Ch,5512,6,3,3,8,19,22,-3,12
FCSB,5513,1,8,6,0,25,11,14,30
CFR Cluj,5513,2,6,6,2,14,8,6,24
D Bucuresti,5513,3,4,5,5,19,20,-1,17
FC Botosani,5513,4,4,5,5,9,15,-6,17
Universitate,5513,5,3,6,5,15,20,-5,15
Concordia Ch,5513,6,2,2,10,16,24,-8,8
FCSB,5514,1,7,6,1,24,12,12,27
CFR Cluj,5514,2,6,6,2,14,8,6,24
D Bucuresti,5514,3,5,4,5,22,20,2,19
Universitate,5514,4,4,6,4,16,19,-3,18
FC Botosani,5514,5,3,4,7,6,16,-10,13
Concordia Ch,5514,6,3,2,9,17,24,-7,11
FCSB,5515,1,8,6,0,28,12,16,30
CFR Cluj,5515,2,5,6,3,14,14,0,21
Universitate,5515,3,4,6,4,20,21,-1,18
D Bucuresti,5515,4,4,5,5,18,18,0,17
FC Botosani,5515,5,4,4,6,6,14,-8,16
Concordia Ch,5515,6,2,3,9,15,22,-7,9
FCSB,5516,1,7,6,1,24,12,12,27
CFR Cluj,5516,2,6,7,1,15,8,7,25
D Bucuresti,5516,3,4,4,6,17,21,-4,16
Universitate,5516,4,3,7,4,14,18,-4,16
Concordia Ch,5516,5,4,2,8,20,22,-2,14
FC Botosani,5516,6,3,4,7,6,15,-9,13
FCSB,5517,1,9,5,0,27,11,16,32
CFR Cluj,5517,2,5,6,3,13,11,2,21
Universitate,5517,3,4,5,5,17,20,-3,17
D Bucuresti,5517,4,4,4,6,21,21,0,16
FC Botosani,5517,5,4,4,6,7,15,-8,16
Concordia Ch,5517,6,3,2,9,18,25,-7,11
FCSB,5518,1,8,5,1,26,12,14,29
CFR Cluj,5518,2,6,6,2,15,11,4,24
Universitate,5518,3,4,5,5,17,20,-3,17
D Bucuresti,5518,4,4,4,6,19,20,-1,16
FC Botosani,5518,5,4,4,6,6,14,-8,16
Concordia Ch,5518,6,3,2,9,17,23,-6,11
FCSB,5519,1,8,5,1,25,13,12,29
CFR Cluj,5519,2,6,6,2,14,9,5,24
D Bucuresti,5519,3,5,4,5,21,19,2,19
Universitate,5519,4,4,5,5,17,19,-2,17
FC Botosani,5519,5,3,5,6,5,14,-9,14
Concordia Ch,5519,6,2,3,9,16,24,-8,9
FCSB,5520,1,8,5,1,25,13,12,29
CFR Cluj,5520,2,5,7,2,14,9,5,22
Universitate,5520,3,4,6,4,18,20,-2,18
D Bucuresti,5520,4,3,6,5,18,20,-2,15
FC Botosani,5520,5,3,5,6,5,14,-9,14
Concordia Ch,5520,6,3,3,8,19,23,-4,12
FCSB,5521,1,8,5,1,27,13,14,29
CFR Cluj,5521,2,5,7,2,16,12,4,22
Universitate,5521,3,4,6,4,16,19,-3,18
FC Botosani,5521,4,4,4,6,6,13,-7,16
D Bucuresti,5521,5,3,5,6,17,20,-3,14
Concordia Ch,5521,6,3,3,8,17,22,-5,12
FCSB,5522,1,9,5,0,26,11,15,32
CFR Cluj,5522,2,5,7,2,13,8,5,22
D Bucuresti,5522,3,4,4,6,19,20,-1,16
FC Botosani,5522,4,4,4,6,9,14,-5,16
Universitate,5522,5,3,6,5,15,20,-5,15
Concordia Ch,5522,6,3,2,9,17,26,-9,11
FCSB,5523,1,8,6,0,25,11,14,30
CFR Cluj,5523,2,5,7,2,15,10,5,22
D Bucuresti,5523,3,5,4,5,19,18,1,19
Universitate,5523,4,3,7,4,15,19,-4,16
FC Botosani,5523,5,3,4,7,5,15,-10,13
Concordia Ch,5523,6,3,2,9,16,22,-6,11
FCSB,5524,1,7,5,2,24,15,9,26
CFR Cluj,5524,2,6,6,2,15,10,5,24
Universitate,5524,3,5,5,4,19,18,1,20
FC Botosani,5524,4,5,4,5,11,14,-3,19
D Bucuresti,5524,5,4,4,6,19,21,-2,16
Concordia Ch,5524,6,2,2,10,15,25,-10,8
FCSB,5525,1,8,6,0,28,14,14,30
CFR Cluj,5525,2,5,8,1,15,9,6,23
FC Botosani,5525,3,4,5,5,7,13,-6,17
Universitate,5525,4,3,6,5,18,23,-5,15
D Bucuresti,5525,5,3,4,7,17,21,-4,13
Concordia Ch,5525,6,3,3,8,18,23,-5,12
FCSB,5526,1,7,7,0,25,12,13,28
CFR Cluj,5526,2,5,8,1,15,9,6,23
FC Botosani,5526,3,4,5,5,9,14,-5,17
Universitate,5526,4,3,7,4,16,20,-4,16
D Bucuresti,5526,5,3,5,6,19,23,-4,14
Concordia Ch,5526,6,2,4,8,18,24,-6,10
FCSB,5527,1,8,5,1,24,17,7,29
CFR Cluj,5527,2,6,6,2,16,9,7,24
Universitate,5527,3,4,5,5,22,21,1,17
D Bucuresti,5527,4,4,4,6,19,21,-2,16
FC Botosani,5527,5,3,5,6,6,16,-10,14
Concordia Ch,5527,6,3,3,8,19,22,-3,12
FCSB,5528,1,8,5,1,27,12,15,29
CFR Cluj,5528,2,6,6,2,14,9,5,24
D Bucuresti,5528,3,5,4,5,20,19,1,19
Universitate,5528,4,4,5,5,17,22,-5,17
FC Botosani,5528,5,4,4,6,6,14,-8,16
Concordia Ch,5528,6,2,2,10,16,24,-8,8
FCSB,5529,1,7,6,1,24,12,12,27
CFR Cluj,5529,2,5,8,1,14,8,6,23
FC Botosani,5529,3,5,4,5,9,14,-5,19
Universitate,5529,4,4,6,4,17,20,-3,18
D Bucuresti,5529,5,3,5,6,18,21,-3,14
Concordia Ch,5529,6,2,3,9,17,24,-7,9
FCSB,5530,1,9,5,0,32,11,21,32
CFR Cluj,5530,2,6,6,2,17,13,4,24
D Bucuresti,5530,3,4,4,6,18,20,-2,16
FC Botosani,5530,4,4,4,6,6,14,-8,16
Universitate,5530,5,3,5,6,15,25,-10,14
Concordia Ch,5530,6,3,2,9,17,22,-5,11
FCSB,5531,1,7,6,1,23,12,11,27
CFR Cluj,5531,2,6,7,1,15,7,8,25
Universitate,5531,3,4,5,5,16,20,-4,17
FC Botosani,5531,4,4,5,5,8,14,-6,17
D Bucuresti,5531,5,4,4,6,17,19,-2,16
Concordia Ch,5531,6,2,3,9,17,24,-7,9
FCSB,5532,1,9,5,0,27,12,15,32
CFR Cluj,5532,2,6,6,2,15,8,7,24
FC Botosani,5532,3,4,4,6,7,16,-9,16
Concordia Ch,5532,4,4,2,8,22,21,1,14
Universitate,5532,5,3,5,6,16,23,-7,14
D Bucuresti,5532,6,3,4,7,17,24,-7,13
FCSB,5533,1,8,6,0,25,11,14,30
CFR Cluj,5533,2,6,6,2,14,8,6,24
D Bucuresti,5533,3,3,6,5,19,21,-2,15
Universitate,5533,4,3,6,5,15,20,-5,15
FC Botosani,5533,5,3,5,6,7,15,-8,14
Concordia Ch,5533,6,3,3,8,19,24,-5,12
FCSB,5534,1,9,5,0,26,11,15,32
CFR Cluj,5534,2,6,6,2,16,9,7,24
D Bucuresti,5534,3,4,4,6,19,20,-1,16
Concordia Ch,5534,4,4,2,8,19,21,-2,14
Universitate,5534,5,3,5,6,16,23,-7,14
FC Botosani,5534,6,3,4,7,5,17,-12,13
FCSB,5535,1,8,6,0,30,13,17,30
CFR Cluj,5535,2,5,6,3,14,14,0,21
Universitate,5535,3,4,6,4,18,20,-2,18
D Bucuresti,5535,4,4,5,5,20,20,0,17
FC Botosani,5535,5,4,5,5,7,13,-6,17
Concordia Ch,5535,6,2,2,10,18,27,-9,8
FCSB,5536,1,7,6,1,25,13,12,27
CFR Cluj,5536,2,6,7,1,15,8,7,25
D Bucuresti,5536,3,4,5,5,20,20,0,17
Universitate,5536,4,3,7,4,15,19,-4,16
FC Botosani,5536,5,3,5,6,6,14,-8,14
Concordia Ch,5536,6,3,2,9,17,24,-7,11
FCSB,5537,1,8,5,1,25,14,11,29
CFR Cluj,5537,2,6,7,1,18,9,9,25
D Bucuresti,5537,3,4,5,5,18,19,-1,17
FC Botosani,5537,4,4,5,5,9,12,-3,17
Universitate,5537,5,3,6,5,15,20,-5,15
Concordia Ch,5537,6,2,2,10,16,27,-11,8
FCSB,5538,1,7,6,1,25,14,11,27
CFR Cluj,5538,2,5,8,1,16,10,6,23
Universitate,5538,3,4,6,4,19,21,-2,18
D Bucuresti,5538,4,4,5,5,20,19,1,17
FC Botosani,5538,5,3,5,6,5,14,-9,14
Concordia Ch,5538,6,3,2,9,18,25,-7,11
FCSB,5539,1,8,5,1,26,13,13,29
CFR Cluj,5539,2,7,6,1,17,7,10,27
FC Botosani,5539,3,5,4,5,9,13,-4,19
Universitate,5539,4,3,5,6,16,24,-8,14
D Bucuresti,5539,5,3,4,7,17,22,-5,13
Concordia Ch,5539,6,3,2,9,16,22,-6,11
FCSB,5540,1,8,5,1,24,11,13,29
CFR Cluj,5540,2,5,6,3,15,11,4,21
Universitate,5540,3,5,5,4,18,20,-2,20
FC Botosani,5540,4,4,5,5,9,14,-5,17
D Bucuresti,5540,5,3,5,6,18,21,-3,14
Concordia Ch,5540,6,3,2,9,18,25,-7,11
FCSB,5541,1,7,7,0,25,12,13,28
CFR Cluj,5541,2,6,7,1,16,9,7,25
D Bucuresti,5541,3,3,6,5,20,22,-2,15
Universitate,5541,4,3,6,5,16,21,-5,15
FC Botosani,5541,5,3,5,6,8,16,-8,14
Concordia Ch,5541,6,3,3,8,19,24,-5,12
FCSB,5542,1,8,6,0,24,10,14,30
CFR Cluj,5542,2,5,6,3,13,10,3,21
Universitate,5542,3,4,6,4,16,18,-2,18
D Bucuresti,5542,4,4,4,6,19,20,-1,16
FC Botosani,5542,5,3,5,6,7,16,-9,14
Concordia Ch,5542,6,3,3,8,19,24,-5,12
FCSB,5543,1,8,5,1,25,13,12,29
CFR Cluj,5543,2,6,6,2,16,9,7,24
D Bucuresti,5543,3,5,4,5,20,18,2,19
Universitate,5543,4,4,5,5,16,20,-4,17
FC Botosani,5543,5,3,5,6,5,13,-8,14
Concordia Ch,5543,6,2,3,9,15,24,-9,9
FCSB,5544,1,7,5,2,24,14,10,26
CFR Cluj,5544,2,6,6,2,15,10,5,24
Universitate,5544,3,5,5,4,18,18,0,20
FC Botosani,5544,4,4,5,5,8,14,-6,17
D Bucuresti,5544,5,4,4,6,19,21,-2,16
Concordia Ch,5544,6,2,3,9,19,26,-7,9
FCSB,5545,1,7,5,2,24,14,10,26
CFR Cluj,5545,2,6,7,1,16,8,8,25
Universitate,5545,3,4,6,4,17,20,-3,18
D Bucuresti,5545,4,4,5,5,19,20,-1,17
FC Botosani,5545,5,3,4,7,6,17,-11,13
Concordia Ch,5545,6,3,3,8,19,22,-3,12
FCSB,5546,1,8,6,0,27,13,14,30
CFR Cluj,5546,2,5,7,2,16,11,5,22
D Bucuresti,5546,3,4,4,6,19,20,-1,16
Universitate,5546,4,3,7,4,16,20,-4,16
Concordia Ch,5546,5,4,2,8,19,22,-3,14
FC Botosani,5546,6,3,4,7,5,16,-11,13
FCSB,5547,1,8,6,0,24,10,14,30
CFR Cluj,5547,2,6,7,1,15,8,7,25
FC Botosani,5547,3,5,4,5,11,14,-3,19
D Bucuresti,5547,4,4,4,6,20,22,-2,16
Universitate,5547,5,3,5,6,15,21,-6,14
Concordia Ch,5547,6,2,2,10,17,27,-10,8
FCSB,5548,1,7,7,0,24,11,13,28
CFR Cluj,5548,2,6,7,1,14,7,7,25
Universitate,5548,3,3,6,5,15,20,-5,15
FC Botosani,5548,4,3,6,5,7,14,-7,15
D Bucuresti,5548,5,3,5,6,18,21,-3,14
Concordia Ch,5548,6,3,3,8,18,23,-5,12
FCSB,5549,1,8,6,0,26,11,15,30
CFR Cluj,5549,2,5,6,3,13,11,2,21
Universitate,5549,3,4,6,4,17,19,-2,18
D Bucuresti,5549,4,3,5,6,20,23,-3,14
Concordia Ch,5549,5,4,2,8,19,23,-4,14
FC Botosani,5549,6,3,5,6,7,15,-8,14
FCSB,5550,1,7,6,1,25,14,11,27
CFR Cluj,5550,2,6,7,1,16,9,7,25
D Bucuresti,5550,3,4,5,5,19,20,-1,17
Universitate,5550,4,4,5,5,18,21,-3,17
FC Botosani,5550,5,4,5,5,8,14,-6,17
Concordia Ch,5550,6,2,2,10,15,23,-8,8
FCSB,5551,1,8,5,1,25,12,13,29
CFR Cluj,5551,2,6,6,2,15,9,6,24
Universitate,5551,3,4,5,5,15,19,-4,17
FC Botosani,5551,4,4,5,5,8,14,-6,17
D Bucuresti,5551,5,3,5,6,18,22,-4,14
Concordia Ch,5551,6,3,2,9,17,22,-5,11
FCSB,5552,1,8,5,1,26,13,13,29
CFR Cluj,5552,2,5,7,2,15,10,5,22
Universitate,5552,3,4,6,4,17,20,-3,18
D Bucuresti,5552,4,4,5,5,18,19,-1,17
FC Botosani,5552,5,4,5,5,6,12,-6,17
Concordia Ch,5552,6,2,2,10,16,24,-8,8
FCSB,5553,1,8,6,0,25,11,14,30
CFR Cluj,5553,2,5,7,2,14,9,5,22
D Bucuresti,5553,3,4,4,6,20,22,-2,16
Universitate,5553,4,3,7,4,16,20,-4,16
Concordia Ch,5553,5,4,2,8,19,21,-2,14
FC Botosani,5553,6,3,4,7,7,18,-11,13
FCSB,5554,1,8,6,0,26,10,16,30
CFR Cluj,5554,2,5,6,3,13,11,2,21
Universitate,5554,3,4,6,4,15,18,-3,18
D Bucuresti,5554,4,4,5,5,20,21,-1,17
FC Botosani,5554,5,4,4,6,8,15,-7,16
Concordia Ch,5554,6,2,3,9,16,23,-7,9
FCSB,5555,1,7,7,0,26,13,13,28
CFR Cluj,5555,2,5,7,2,14,9,5,22
D Bucuresti,5555,3,5,4,5,20,20,0,19
Universitate,5555,4,4,6,4,17,20,-3,18
FC Botosani,5555,5,3,4,7,6,15,-9,13
Concordia Ch,5555,6,3,2,9,17,23,-6,11
FCSB,5556,1,8,5,1,25,12,13,29
CFR Cluj,5556,2,5,6,3,13,10,3,21
Universitate,5556,3,5,5,4,17,18,-1,20
D Bucuresti,5556,4,4,5,5,19,19,0,17
FC Botosani,5556,5,3,6,5,7,14,-7,15
Concordia Ch,5556,6,2,3,9,18,26,-8,9
FCSB,5557,1,8,6,0,25,11,14,30
CFR Cluj,5557,2,5,8,1,13,7,6,23
FC Botosani,5557,3,4,5,5,7,13,-6,17
D Bucuresti,5557,4,3,6,5,17,19,-2,15
Universitate,5557,5,3,6,5,15,20,-5,15
Concordia Ch,5557,6,2,3,9,17,24,-7,9
FCSB,5558,1,9,5,0,28,13,15,32
CFR Cluj,5558,2,6,6,2,17,11,6,24
D Bucuresti,5558,3,5,4,5,19,19,0,19
FC Botosani,5558,4,4,4,6,6,13,-7,16
Universitate,5558,5,3,5,6,16,22,-6,14
Concordia Ch,5558,6,2,2,10,16,24,-8,8
FCSB,5559,1,7,7,0,25,12,13,28
CFR Cluj,5559,2,5,8,1,15,9,6,23
D Bucuresti,5559,3,5,4,5,19,18,1,19
Universitate,5559,4,3,7,4,14,18,-4,16
FC Botosani,5559,5,4,4,6,6,13,-7,16
Concordia Ch,5559,6,2,2,10,15,24,-9,8
FCSB,5560,1,7,6,1,25,14,11,27
CFR Cluj,5560,2,5,8,1,16,10,6,23
Universitate,5560,3,4,6,4,17,19,-2,18
D Bucuresti,5560,4,4,4,6,18,19,-1,16
FC Botosani,5560,5,3,5,6,6,15,-9,14
Concordia Ch,5560,6,3,3,8,17,22,-5,12
FCSB,5561,1,8,5,1,25,12,13,29
CFR Cluj,5561,2,7,6,1,15,7,8,27
FC Botosani,5561,3,4,5,5,9,14,-5,17
Universitate,5561,4,3,5,6,15,21,-6,14
D Bucuresti,5561,5,3,4,7,18,24,-6,13
Concordia Ch,5561,6,3,3,8,19,23,-4,12
FCSB,5562,1,8,6,0,27,12,15,30
CFR Cluj,5562,2,5,7,2,14,10,4,22
D Bucuresti,5562,3,4,4,6,20,22,-2,16
Universitate,5562,4,3,7,4,17,21,-4,16
FC Botosani,5562,5,4,4,6,7,14,-7,16
Concordia Ch,5562,6,3,2,9,18,24,-6,11
FCSB,5563,1,8,6,0,28,13,15,30
CFR Cluj,5563,2,5,7,2,14,10,4,22
Universitate,5563,3,3,7,4,16,20,-4,16
FC Botosani,5563,4,3,6,5,5,12,-7,15
D Bucuresti,5563,5,3,5,6,17,21,-4,14
Concordia Ch,5563,6,3,3,8,18,22,-4,12
FCSB,5564,1,7,5,2,25,14,11,26
CFR Cluj,5564,2,6,6,2,16,10,6,24
Universitate,5564,3,5,5,4,18,20,-2,20
FC Botosani,5564,4,4,5,5,6,12,-6,17
D Bucuresti,5564,5,3,5,6,17,20,-3,14
Concordia Ch,5564,6,3,2,9,17,23,-6,11
FCSB,5565,1,7,6,1,24,13,11,27
CFR Cluj,5565,2,5,8,1,16,10,6,23
Universitate,5565,3,4,6,4,18,20,-2,18
FC Botosani,5565,4,4,5,5,6,12,-6,17
D Bucuresti,5565,5,4,4,6,17,19,-2,16
Concordia Ch,5565,6,2,3,9,15,22,-7,9
FCSB,5566,1,7,5,2,25,14,11,26
CFR Cluj,5566,2,6,6,2,16,10,6,24
Universitate,5566,3,5,5,4,18,20,-2,20
D Bucuresti,5566,4,4,4,6,19,22,-3,16
FC Botosani,5566,5,3,5,6,8,16,-8,14
Concordia Ch,5566,6,3,3,8,18,22,-4,12
FCSB,5567,1,9,5,0,28,12,16,32
CFR Cluj,5567,2,6,6,2,15,10,5,24
FC Botosani,5567,3,3,6,5,8,15,-7,15
D Bucuresti,5567,4,3,5,6,20,24,-4,14
Universitate,5567,5,3,5,6,15,21,-6,14
Concordia Ch,5567,6,3,3,8,18,22,-4,12
FCSB,5568,1,8,5,1,25,12,13,29
CFR Cluj,5568,2,6,6,2,15,8,7,24
FC Botosani,5568,3,5,4,5,8,13,-5,19
Universitate,5568,4,4,5,5,16,21,-5,17
D Bucuresti,5568,5,4,4,6,21,19,2,16
Concordia Ch,5568,6,2,2,10,16,28,-12,8
FCSB,5569,1,7,6,1,24,12,12,27
CFR Cluj,5569,2,6,7,1,15,8,7,25
D Bucuresti,5569,3,4,5,5,19,20,-1,17
Universitate,5569,4,4,5,5,15,19,-4,17
FC Botosani,5569,5,3,5,6,6,15,-9,14
Concordia Ch,5569,6,3,2,9,18,23,-5,11
FCSB,5570,1,9,5,0,27,11,16,32
CFR Cluj,5570,2,5,7,2,13,9,4,22
FC Botosani,5570,3,4,5,5,7,12,-5,17
Universitate,5570,4,3,6,5,15,20,-5,15
D Bucuresti,5570,5,3,5,6,16,19,-3,14
Concordia Ch,5570,6,3,2,9,16,23,-7,11
FCSB,5571,1,9,5,0,27,10,17,32
CFR Cluj,5571,2,5,6,3,14,13,1,21
Universitate,5571,3,4,5,5,18,21,-3,17
Concordia Ch,5571,4,4,2,8,23,23,0,14
D Bucuresti,5571,5,3,5,6,19,22,-3,14
FC Botosani,5571,6,3,5,6,8,20,-12,14
FCSB,5572,1,7,5,2,26,16,10,26
CFR Cluj,5572,2,6,6,2,15,10,5,24
Universitate,5572,3,5,5,4,20,20,0,20
FC Botosani,5572,4,5,4,5,8,12,-4,19
D Bucuresti,5572,5,3,4,7,18,22,-4,13
Concordia Ch,5572,6,3,2,9,18,25,-7,11
FCSB,5573,1,8,6,0,25,11,14,30
CFR Cluj,5573,2,5,7,2,14,9,5,22
FC Botosani,5573,3,5,4,5,10,13,-3,19
D Bucuresti,5573,4,4,4,6,17,21,-4,16
Universitate,5573,5,3,7,4,16,20,-4,16
Concordia Ch,5573,6,2,2,10,16,24,-8,8
FCSB,5574,1,7,7,0,25,12,13,28
CFR Cluj,5574,2,6,7,1,16,8,8,25
D Bucuresti,5574,3,4,4,6,19,21,-2,16
FC Botosani,5574,4,4,4,6,6,15,-9,16
Universitate,5574,5,3,6,5,15,21,-6,15
Concordia Ch,5574,6,3,2,9,18,22,-4,11
FCSB,5575,1,8,5,1,26,13,13,29
CFR Cluj,5575,2,5,7,2,15,10,5,22
Universitate,5575,3,4,6,4,17,20,-3,18
D Bucuresti,5575,4,4,4,6,20,21,-1,16
FC Botosani,5575,5,4,4,6,8,16,-8,16
Concordia Ch,5575,6,3,2,9,19,25,-6,11
FCSB,5576,1,7,7,0,26,13,13,28
CFR Cluj,5576,2,6,7,1,16,9,7,25
D Bucuresti,5576,3,5,4,5,19,18,1,19
FC Botosani,5576,4,4,4,6,9,14,-5,16
Universitate,5576,5,3,6,5,15,20,-5,15
Concordia Ch,5576,6,2,2,10,15,26,-11,8
FCSB,5577,1,9,5,0,27,12,15,32
CFR Cluj,5577,2,6,6,2,16,9,7,24
D Bucuresti,5577,3,5,4,5,20,19,1,19
Universitate,5577,4,3,5,6,15,22,-7,14
FC Botosani,5577,5,3,5,6,6,15,-9,14
Concordia Ch,5577,6,2,3,9,17,24,-7,9
FCSB,5578,1,8,6,0,26,11,15,30
CFR Cluj,5578,2,6,6,2,17,10,7,24
FC Botosani,5578,3,4,5,5,7,13,-6,17
Universitate,5578,4,3,6,5,16,23,-7,15
D Bucuresti,5578,5,3,5,6,17,20,-3,14
Concordia Ch,5578,6,2,4,8,17,23,-6,10
FCSB,5579,1,8,6,0,24,10,14,30
CFR Cluj,5579,2,5,7,2,14,9,5,22
Universitate,5579,3,3,7,4,15,19,-4,16
Concordia Ch,5579,4,4,2,8,23,22,1,14
D Bucuresti,5579,5,3,5,6,17,22,-5,14
FC Botosani,5579,6,3,5,6,5,16,-11,14
FCSB,5580,1,9,5,0,26,11,15,32
CFR Cluj,5580,2,6,6,2,14,8,6,24
D Bucuresti,5580,3,3,6,5,17,19,-2,15
Universitate,5580,4,3,5,6,15,21,-6,14
FC Botosani,5580,5,3,5,6,7,15,-8,14
Concordia Ch,5580,6,3,3,8,17,22,-5,12
FCSB,5581,1,8,5,1,26,13,13,29
CFR Cluj,5581,2,6,6,2,17,9,8,24
FC Botosani,5581,3,5,4,5,10,14,-4,19
Universitate,5581,4,4,5,5,16,22,-6,17
D Bucuresti,5581,5,3,5,6,16,20,-4,14
Concordia Ch,5581,6,2,3,9,17,24,-7,9
FCSB,5582,1,7,6,1,25,13,12,27
CFR Cluj,5582,2,6,6,2,15,10,5,24
Universitate,5582,3,4,6,4,17,19,-2,18
D Bucuresti,5582,4,4,4,6,18,20,-2,16
FC Botosani,5582,5,4,4,6,6,13,-7,16
Concordia Ch,5582,6,3,2,9,17,23,-6,11
FCSB,5583,1,9,5,0,27,11,16,32
CFR Cluj,5583,2,6,6,2,15,10,5,24
D Bucuresti,5583,3,3,6,5,18,20,-2,15
Universitate,5583,4,3,5,6,14,20,-6,14
FC Botosani,5583,5,3,5,6,6,15,-9,14
Concordia Ch,5583,6,3,3,8,18,22,-4,12
FCSB,5584,1,7,6,1,25,13,12,27
CFR Cluj,5584,2,5,7,2,14,10,4,22
Universitate,5584,3,5,5,4,18,19,-1,20
D Bucuresti,5584,4,4,5,5,18,19,-1,17
FC Botosani,5584,5,4,5,5,8,13,-5,17
Concordia Ch,5584,6,2,2,10,15,24,-9,8
FCSB,5585,1,8,6,0,25,11,14,30
CFR Cluj,5585,2,6,6,2,15,9,6,24
D Bucuresti,5585,3,3,6,5,18,20,-2,15
Universitate,5585,4,3,6,5,16,21,-5,15
FC Botosani,5585,5,3,6,5,7,14,-7,15
Concordia Ch,5585,6,2,4,8,17,23,-6,10
FCSB,5586,1,8,6,0,25,11,14,30
CFR Cluj,5586,2,6,6,2,16,9,7,24
FC Botosani,5586,3,4,5,5,7,13,-6,17
Universitate,5586,4,3,6,5,14,20,-6,15
D Bucuresti,5586,5,3,4,7,16,21,-5,13
Concordia Ch,5586,6,3,3,8,18,22,-4,12
FCSB,5587,1,9,5,0,27,10,17,32
CFR Cluj,5587,2,5,7,2,13,8,5,22
FC Botosani,5587,3,4,4,6,6,14,-8,16
Universitate,5587,4,3,6,5,14,21,-7,15
Concordia Ch,5587,5,4,2,8,23,22,1,14
D Bucuresti,5587,6,3,4,7,17,25,-8,13
FCSB,5588,1,9,5,0,26,10,16,32
CFR Cluj,5588,2,6,6,2,16,9,7,24
D Bucuresti,5588,3,4,4,6,19,21,-2,16
FC Botosani,5588,4,4,4,6,7,15,-8,16
Universitate,5588,5,3,5,6,14,22,-8,14
Concordia Ch,5588,6,3,2,9,19,24,-5,11
FCSB,5589,1,8,5,1,26,12,14,29
CFR Cluj,5589,2,6,6,2,17,12,5,24
D Bucuresti,5589,3,5,4,5,20,19,1,19
Universitate,5589,4,4,5,5,17,21,-4,17
FC Botosani,5589,5,3,5,6,8,16,-8,14
Concordia Ch,5589,6,2,3,9,17,25,-8,9
FCSB,5590,1,7,7,0,24,11,13,28
CFR Cluj,5590,2,6,7,1,16,8,8,25
FC Botosani,5590,3,4,5,5,6,12,-6,17
Universitate,5590,4,3,6,5,16,22,-6,15
D Bucuresti,5590,5,3,4,7,18,22,-4,13
Concordia Ch,5590,6,3,3,8,18,23,-5,12
FCSB,5591,1,9,5,0,28,12,16,32
CFR Cluj,5591,2,6,6,2,15,10,5,24
D Bucuresti,5591,3,4,5,5,20,20,0,17
FC Botosani,5591,4,3,6,5,8,15,-7,15
Universitate,5591,5,3,5,6,15,21,-6,14
Concordia Ch,5591,6,2,3,9,18,26,-8,9
FCSB,5592,1,7,6,1,26,14,12,27
CFR Cluj,5592,2,6,7,1,15,8,7,25
D Bucuresti,5592,3,5,4,5,20,19,1,19
Universitate,5592,4,4,5,5,17,21,-4,17
FC Botosani,5592,5,4,4,6,9,15,-6,16
Concordia Ch,5592,6,2,2,10,17,27,-10,8
FCSB,5593,1,8,5,1,26,11,15,29
CFR Cluj,5593,2,5,6,3,13,11,2,21
Universitate,5593,3,5,5,4,16,18,-2,20
D Bucuresti,5593,4,4,5,5,18,19,-1,17
FC Botosani,5593,5,3,5,6,7,15,-8,14
Concordia Ch,5593,6,2,4,8,18,24,-6,10
FCSB,5594,1,9,5,0,25,10,15,32
CFR Cluj,5594,2,6,6,2,14,8,6,24
D Bucuresti,5594,3,4,5,5,20,21,-1,17
FC Botosani,5594,4,4,4,6,8,15,-7,16
Universitate,5594,5,3,5,6,14,20,-6,14
Concordia Ch,5594,6,2,3,9,16,23,-7,9
FCSB,5595,1,8,6,0,25,11,14,30
CFR Cluj,5595,2,6,6,2,15,9,6,24
D Bucuresti,5595,3,3,6,5,17,19,-2,15
Universitate,5595,4,3,6,5,16,21,-5,15
FC Botosani,5595,5,3,5,6,5,13,-8,14
Concordia Ch,5595,6,3,3,8,17,22,-5,12
FCSB,5596,1,7,7,0,25,12,13,28
CFR Cluj,5596,2,6,7,1,17,9,8,25
FC Botosani,5596,3,4,4,6,6,13,-7,16
Universitate,5596,4,3,6,5,14,20,-6,15
Concordia Ch,5596,5,4,2,8,18,21,-3,14
D Bucuresti,5596,6,3,4,7,16,21,-5,13
FCSB,5597,1,7,5,2,23,14,9,26
CFR Cluj,5597,2,6,6,2,14,8,6,24
Universitate,5597,3,5,5,4,18,18,0,20
D Bucuresti,5597,4,4,4,6,18,21,-3,16
FC Botosani,5597,5,4,4,6,10,16,-6,16
Concordia Ch,5597,6,3,2,9,19,25,-6,11
FCSB,5598,1,8,5,1,27,13,14,29
CFR Cluj,5598,2,5,7,2,14,10,4,22
Universitate,5598,3,4,6,4,16,19,-3,18
FC Botosani,5598,4,4,4,6,8,14,-6,16
D Bucuresti,5598,5,3,5,6,20,24,-4,14
Concordia Ch,5598,6,3,3,8,19,24,-5,12
FCSB,5599,1,7,5,2,25,15,10,26
CFR Cluj,5599,2,6,6,2,15,9,6,24
Universitate,5599,3,5,5,4,18,19,-1,20
D Bucuresti,5599,4,5,4,5,19,19,0,19
FC Botosani,5599,5,4,4,6,8,14,-6,16
Concordia Ch,5599,6,2,2,10,15,24,-9,8
FCSB,5600,1,7,6,1,23,11,12,27
CFR Cluj,5600,2,7,6,1,18,7,11,27
FC Botosani,5600,3,3,6,5,5,12,-7,15
Universitate,5600,4,3,6,5,14,22,-8,15
D Bucuresti,5600,5,3,5,6,17,21,-4,14
Concordia Ch,5600,6,3,3,8,18,22,-4,12
FCSB,5601,1,7,6,1,23,12,11,27
CFR Cluj,5601,2,6,7,1,14,7,7,25
D Bucuresti,5601,3,4,5,5,17,18,-1,17
Universitate,5601,4,4,5,5,16,19,-3,17
FC Botosani,5601,5,3,5,6,6,14,-8,14
Concordia Ch,5601,6,3,2,9,17,23,-6,11
FCSB,5602,1,9,5,0,27,11,16,32
CFR Cluj,5602,2,6,6,2,15,9,6,24
FC Botosani,5602,3,4,5,5,10,14,-4,17
D Bucuresti,5602,4,4,4,6,21,23,-2,16
Universitate,5602,5,3,5,6,14,21,-7,14
Concordia Ch,5602,6,2,3,9,17,26,-9,9
FCSB,5603,1,9,5,0,27,12,15,32
CFR Cluj,5603,2,6,6,2,17,10,7,24
D Bucuresti,5603,3,3,5,6,17,20,-3,14
Concordia Ch,5603,4,4,2,8,17,21,-4,14
Universitate,5603,5,3,5,6,16,23,-7,14
FC Botosani,5603,6,3,5,6,6,14,-8,14
FCSB,5604,1,8,5,1,26,12,14,29
CFR Cluj,5604,2,6,6,2,16,12,4,24
Universitate,5604,3,4,5,5,18,21,-3,17
D Bucuresti,5604,4,4,4,6,17,19,-2,16
FC Botosani,5604,5,4,4,6,7,15,-8,16
Concordia Ch,5604,6,3,2,9,18,23,-5,11
FCSB,5605,1,7,7,0,25,12,13,28
CFR Cluj,5605,2,6,7,1,14,7,7,25
FC Botosani,5605,3,4,5,5,6,12,-6,17
D Bucuresti,5605,4,3,6,5,17,19,-2,15
Universitate,5605,5,3,6,5,16,21,-5,15
Concordia Ch,5605,6,2,3,9,16,23,-7,9
FCSB,5606,1,8,5,1,26,15,11,29
CFR Cluj,5606,2,6,6,2,17,11,6,24
Universitate,5606,3,4,5,5,19,21,-2,17
D Bucuresti,5606,4,4,4,6,17,22,-5,16
FC Botosani,5606,5,4,4,6,7,14,-7,16
Concordia Ch,5606,6,3,2,9,20,23,-3,11
FCSB,5607,1,8,5,1,26,13,13,29
CFR Cluj,5607,2,6,6,2,17,11,6,24
Universitate,5607,3,4,5,5,18,22,-4,17
FC Botosani,5607,4,4,4,6,7,14,-7,16
Concordia Ch,5607,5,4,2,8,19,23,-4,14
D Bucuresti,5607,6,3,4,7,17,21,-4,13
FCSB,5608,1,8,5,1,24,12,12,29
CFR Cluj,5608,2,6,7,1,16,8,8,25
D Bucuresti,5608,3,4,4,6,20,21,-1,16
FC Botosani,5608,4,4,4,6,8,14,-6,16
Universitate,5608,5,3,6,5,15,20,-5,15
Concordia Ch,5608,6,3,2,9,18,26,-8,11
FCSB,5609,1,7,6,1,23,11,12,27
CFR Cluj,5609,2,7,6,1,16,7,9,27
Universitate,5609,3,3,6,5,14,20,-6,15
Concordia Ch,5609,4,4,2,8,20,21,-1,14
D Bucuresti,5609,5,3,5,6,16,20,-4,14
FC Botosani,5609,6,3,5,6,5,15,-10,14
FCSB,5610,1,8,6,0,27,11,16,30
CFR Cluj,5610,2,5,7,2,13,8,5,22
Universitate,5610,3,4,5,5,16,22,-6,17
D Bucuresti,5610,4,3,6,5,19,21,-2,15
FC Botosani,5610,5,3,5,6,7,16,-9,14
Concordia Ch,5610,6,3,3,8,18,22,-4,12
FCSB,5611,1,7,7,0,24,11,13,28
CFR Cluj,5611,2,6,7,1,16,8,8,25
D Bucuresti,5611,3,4,5,5,17,18,-1,17
FC Botosani,5611,4,4,4,6,6,13,-7,16
Universitate,5611,5,3,6,5,14,20,-6,15
Concordia Ch,5611,6,2,3,9,15,22,-7,9
CFR Cluj,5612,1,7,6,1,17,7,10,27
FCSB,5612,2,7,5,2,23,14,9,26
FC Botosani,5612,3,5,4,5,10,13,-3,19
Universitate,5612,4,4,5,5,15,19,-4,17
D Bucuresti,5612,5,3,4,7,17,23,-6,13
Concordia Ch,5612,6,3,2,9,18,24,-6,11
FCSB,5613,1,8,5,1,27,13,14,29
CFR Cluj,5613,2,5,6,3,14,11,3,21
Universitate,5613,3,5,5,4,17,19,-2,20
D Bucuresti,5613,4,5,4,5,18,18,0,19
FC Botosani,5613,5,3,5,6,6,14,-8,14
Concordia Ch,5613,6,2,3,9,16,23,-7,9
FCSB,5614,1,8,6,0,27,13,14,30
CFR Cluj,5614,2,5,7,2,16,11,5,22
Universitate,5614,3,4,5,5,17,21,-4,17
FC Botosani,5614,4,4,5,5,7,12,-5,17
D Bucuresti,5614,5,3,6,5,18,20,-2,15
Concordia Ch,5614,6,2,3,9,17,25,-8,9
FCSB,5615,1,9,5,0,26,11,15,32
CFR Cluj,5615,2,5,6,3,14,10,4,21
Universitate,5615,3,4,5,5,17,21,-4,17
FC Botosani,5615,4,3,6,5,5,12,-7,15
D Bucuresti,5615,5,3,5,6,16,19,-3,14
Concordia Ch,5615,6,3,3,8,16,21,-5,12
FCSB,5616,1,8,5,1,25,12,13,29
CFR Cluj,5616,2,7,6,1,17,8,9,27
D Bucuresti,5616,3,3,6,5,18,20,-2,15
Universitate,5616,4,3,5,6,15,22,-7,14
FC Botosani,5616,5,3,5,6,7,15,-8,14
Concordia Ch,5616,6,3,3,8,18,23,-5,12
FCSB,5617,1,9,5,0,28,12,16,32
CFR Cluj,5617,2,6,6,2,15,10,5,24
D Bucuresti,5617,3,3,5,6,18,21,-3,14
Concordia Ch,5617,4,4,2,8,18,22,-4,14
Universitate,5617,5,3,5,6,17,23,-6,14
FC Botosani,5617,6,3,5,6,6,14,-8,14
FCSB,5618,1,8,5,1,28,12,16,29
CFR Cluj,5618,2,6,6,2,15,12,3,24
D Bucuresti,5618,3,4,5,5,18,18,0,17
Universitate,5618,4,4,5,5,15,19,-4,17
FC Botosani,5618,5,3,5,6,5,14,-9,14
Concordia Ch,5618,6,2,4,8,15,21,-6,10
FCSB,5619,1,7,5,2,23,13,10,26
CFR Cluj,5619,2,6,7,1,15,7,8,25
Universitate,5619,3,4,6,4,15,18,-3,18
FC Botosani,5619,4,4,5,5,8,14,-6,17
D Bucuresti,5619,5,3,5,6,19,23,-4,14
Concordia Ch,5619,6,3,2,9,20,25,-5,11
FCSB,5620,1,7,7,0,26,13,13,28
CFR Cluj,5620,2,6,7,1,17,9,8,25
D Bucuresti,5620,3,4,4,6,19,22,-3,16
FC Botosani,5620,4,4,4,6,9,16,-7,16
Universitate,5620,5,3,6,5,17,23,-6,15
Concordia Ch,5620,6,3,2,9,20,25,-5,11
FCSB,5621,1,7,6,1,25,14,11,27
CFR Cluj,5621,2,7,6,1,17,8,9,27
Universitate,5621,3,3,6,5,17,22,-5,15
D Bucuresti,5621,4,3,5,6,18,21,-3,14
Concordia Ch,5621,5,4,2,8,19,23,-4,14
FC Botosani,5621,6,3,5,6,7,15,-8,14
FCSB,5622,1,8,5,1,26,12,14,29
CFR Cluj,5622,2,5,7,2,14,10,4,22
Universitate,5622,3,4,6,4,15,18,-3,18
D Bucuresti,5622,4,4,5,5,20,19,1,17
FC Botosani,5622,5,3,4,7,5,16,-11,13
Concordia Ch,5622,6,3,3,8,17,22,-5,12
FCSB,5623,1,8,6,0,25,11,14,30
CFR Cluj,5623,2,6,7,1,16,9,7,25
FC Botosani,5623,3,4,5,5,8,12,-4,17
D Bucuresti,5623,4,4,4,6,19,21,-2,16
Universitate,5623,5,3,5,6,15,21,-6,14
Concordia Ch,5623,6,2,3,9,15,24,-9,9
FCSB,5624,1,8,6,0,26,10,16,30
CFR Cluj,5624,2,5,6,3,14,12,2,21
Universitate,5624,3,4,6,4,16,19,-3,18
D Bucuresti,5624,4,4,4,6,17,20,-3,16
FC Botosani,5624,5,3,5,6,6,14,-8,14
Concordia Ch,5624,6,3,3,8,18,22,-4,12
FCSB,5625,1,7,6,1,25,15,10,27
CFR Cluj,5625,2,6,7,1,16,8,8,25
FC Botosani,5625,3,5,4,5,8,13,-5,19
Universitate,5625,4,4,5,5,18,21,-3,17
D Bucuresti,5625,5,4,4,6,18,20,-2,16
Concordia Ch,5625,6,2,2,10,17,25,-8,8
FCSB,5626,1,8,5,1,27,13,14,29
CFR Cluj,5626,2,6,7,1,17,9,8,25
D Bucuresti,5626,3,4,4,6,18,20,-2,16
FC Botosani,5626,4,4,4,6,7,13,-6,16
Universitate,5626,5,3,6,5,15,22,-7,15
Concordia Ch,5626,6,3,2,9,17,24,-7,11
FCSB,5627,1,8,6,0,27,12,15,30
CFR Cluj,5627,2,5,7,2,14,10,4,22
FC Botosani,5627,3,4,5,5,8,14,-6,17
D Bucuresti,5627,4,4,4,6,18,20,-2,16
Universitate,5627,5,3,7,4,15,19,-4,16
Concordia Ch,5627,6,2,3,9,18,25,-7,9
FCSB,5628,1,8,5,1,28,16,12,29
CFR Cluj,5628,2,5,7,2,16,11,5,22
Universitate,5628,3,4,6,4,19,21,-2,18
D Bucuresti,5628,4,4,4,6,20,20,0,16
FC Botosani,5628,5,4,4,6,6,15,-9,16
Concordia Ch,5628,6,3,2,9,17,23,-6,11
FCSB,5629,1,7,6,1,25,13,12,27
CFR Cluj,5629,2,7,6,1,18,9,9,27
FC Botosani,5629,3,4,4,6,9,14,-5,16
Universitate,5629,4,3,6,5,16,22,-6,15
Concordia Ch,5629,5,4,2,8,17,21,-4,14
D Bucuresti,5629,6,3,4,7,17,23,-6,13
FCSB,5630,1,8,5,1,24,11,13,29
CFR Cluj,5630,2,5,6,3,13,10,3,21
Universitate,5630,3,5,5,4,17,18,-1,20
FC Botosani,5630,4,4,5,5,9,14,-5,17
D Bucuresti,5630,5,3,6,5,19,21,-2,15
Concordia Ch,5630,6,2,3,9,16,24,-8,9
CFR Cluj,5631,1,7,6,1,19,9,10,27
FCSB,5631,2,7,5,2,25,14,11,26
Universitate,5631,3,4,5,5,17,23,-6,17
FC Botosani,5631,4,3,6,5,8,15,-7,15
D Bucuresti,5631,5,3,5,6,19,23,-4,14
Concordia Ch,5631,6,3,3,8,19,23,-4,12
FCSB,5632,1,8,5,1,27,14,13,29
CFR Cluj,5632,2,6,6,2,17,11,6,24
FC Botosani,5632,3,5,4,5,12,12,0,19
Universitate,5632,4,4,5,5,17,21,-4,17
D Bucuresti,5632,5,3,4,7,16,22,-6,13
Concordia Ch,5632,6,3,2,9,17,26,-9,11
FCSB,5633,1,8,5,1,25,12,13,29
CFR Cluj,5633,2,5,7,2,14,10,4,22
Universitate,5633,3,4,6,4,17,19,-2,18
D Bucuresti,5633,4,4,5,5,20,21,-1,17
FC Botosani,5633,5,4,4,6,7,13,-6,16
Concordia Ch,5633,6,2,3,9,18,26,-8,9
FCSB,5634,1,8,5,1,24,11,13,29
CFR Cluj,5634,2,6,7,1,14,7,7,25
FC Botosani,5634,3,4,5,5,8,14,-6,17
Universitate,5634,4,3,6,5,14,19,-5,15
D Bucuresti,5634,5,3,5,6,18,24,-6,14
Concordia Ch,5634,6,3,2,9,19,22,-3,11
FCSB,5635,1,9,5,0,31,11,20,32
CFR Cluj,5635,2,5,7,2,13,11,2,22
FC Botosani,5635,3,5,4,5,8,12,-4,19
Universitate,5635,4,3,6,5,15,22,-7,15
D Bucuresti,5635,5,3,4,7,17,21,-4,13
Concordia Ch,5635,6,3,2,9,17,24,-7,11
FCSB,5636,1,9,5,0,27,11,16,32
CFR Cluj,5636,2,6,6,2,17,10,7,24
FC Botosani,5636,3,4,5,5,7,13,-6,17
D Bucuresti,5636,4,3,5,6,16,19,-3,14
Universitate,5636,5,3,5,6,16,24,-8,14
Concordia Ch,5636,6,2,4,8,16,22,-6,10
FCSB,5637,1,8,6,0,27,12,15,30
CFR Cluj,5637,2,6,6,2,15,10,5,24
D Bucuresti,5637,3,4,5,5,18,18,0,17
FC Botosani,5637,4,4,4,6,7,14,-7,16
Universitate,5637,5,3,6,5,15,20,-5,15
Concordia Ch,5637,6,2,3,9,15,23,-8,9
FCSB,5638,1,7,7,0,25,12,13,28
CFR Cluj,5638,2,5,8,1,14,8,6,23
Universitate,5638,3,3,7,4,15,19,-4,16
FC Botosani,5638,4,4,4,6,9,14,-5,16
D Bucuresti,5638,5,3,5,6,17,22,-5,14
Concordia Ch,5638,6,3,3,8,18,23,-5,12
FCSB,5639,1,7,6,1,23,11,12,27
CFR Cluj,5639,2,6,6,2,14,8,6,24
Universitate,5639,3,4,6,4,15,18,-3,18
FC Botosani,5639,4,4,4,6,8,14,-6,16
D Bucuresti,5639,5,3,5,6,17,21,-4,14
Concordia Ch,5639,6,3,3,8,18,23,-5,12
FCSB,5640,1,9,5,0,25,10,15,32
CFR Cluj,5640,2,6,6,2,15,8,7,24
FC Botosani,5640,3,5,4,5,8,12,-4,19
Universitate,5640,4,3,5,6,14,21,-7,14
D Bucuresti,5640,5,3,4,7,18,23,-5,13
Concordia Ch,5640,6,3,2,9,18,24,-6,11
FCSB,5641,1,8,5,1,26,13,13,29
CFR Cluj,5641,2,6,7,1,15,8,7,25
D Bucuresti,5641,3,4,4,6,18,20,-2,16
Universitate,5641,4,3,6,5,15,20,-5,15
Concordia Ch,5641,5,4,2,8,18,22,-4,14
FC Botosani,5641,6,3,4,7,7,16,-9,13
FCSB,5642,1,7,6,1,25,13,12,27
CFR Cluj,5642,2,5,8,1,16,10,6,23
Universitate,5642,3,4,6,4,16,19,-3,18
D Bucuresti,5642,4,4,5,5,20,20,0,17
FC Botosani,5642,5,4,5,5,9,14,-5,17
Concordia Ch,5642,6,2,2,10,15,25,-10,8
FCSB,5643,1,7,6,1,23,12,11,27
CFR Cluj,5643,2,6,7,1,15,7,8,25
Universitate,5643,3,4,5,5,16,20,-4,17
FC Botosani,5643,4,4,5,5,7,13,-6,17
D Bucuresti,5643,5,3,5,6,17,21,-4,14
Concordia Ch,5643,6,3,2,9,19,24,-5,11
FCSB,5644,1,8,5,1,25,12,13,29
CFR Cluj,5644,2,6,6,2,16,9,7,24
D Bucuresti,5644,3,4,5,5,19,19,0,17
Universitate,5644,4,4,5,5,16,21,-5,17
FC Botosani,5644,5,4,4,6,9,15,-6,16
Concordia Ch,5644,6,2,3,9,17,26,-9,9
FCSB,5645,1,8,5,1,27,13,14,29
CFR Cluj,5645,2,6,6,2,16,9,7,24
Universitate,5645,3,4,5,5,17,23,-6,17
Concordia Ch,5645,4,4,2,8,24,24,0,14
D Bucuresti,5645,5,3,5,6,16,23,-7,14
FC Botosani,5645,6,3,5,6,8,16,-8,14
FCSB,5646,1,8,5,1,27,13,14,29
CFR Cluj,5646,2,5,6,3,13,11,2,21
Universitate,5646,3,5,5,4,18,19,-1,20
FC Botosani,5646,4,4,5,5,7,13,-6,17
D Bucuresti,5646,5,3,6,5,19,21,-2,15
Concordia Ch,5646,6,2,3,9,17,24,-7,9
FCSB,5647,1,8,6,0,25,11,14,30
CFR Cluj,5647,2,5,7,2,13,8,5,22
D Bucuresti,5647,3,4,5,5,20,20,0,17
Universitate,5647,4,3,7,4,15,19,-4,16
FC Botosani,5647,5,3,5,6,6,15,-9,14
Concordia Ch,5647,6,2,4,8,18,24,-6,10
FCSB,5648,1,8,6,0,26,12,14,30
CFR Cluj,5648,2,6,7,1,15,8,7,25
D Bucuresti,5648,3,4,4,6,19,22,-3,16
Universitate,5648,4,3,5,6,15,21,-6,14
FC Botosani,5648,5,3,5,6,7,15,-8,14
Concordia Ch,5648,6,3,3,8,19,23,-4,12
CFR Cluj,5649,1,7,6,1,16,7,9,27
FCSB,5649,2,7,5,2,23,12,11,26
D Bucuresti,5649,3,4,5,5,18,19,-1,17
Universitate,5649,4,4,5,5,15,20,-5,17
FC Botosani,5649,5,3,6,5,6,13,-7,15
Concordia Ch,5649,6,2,3,9,17,24,-7,9
FCSB,5650,1,7,6,1,25,13,12,27
CFR Cluj,5650,2,6,7,1,14,7,7,25
D Bucuresti,5650,3,4,5,5,20,19,1,17
Universitate,5650,4,3,7,4,16,20,-4,16
FC Botosani,5650,5,4,4,6,8,15,-7,16
Concordia Ch,5650,6,2,3,9,16,25,-9,9
FCSB,5651,1,7,7,0,24,11,13,28
CFR Cluj,5651,2,5,8,1,14,8,6,23
D Bucuresti,5651,3,4,4,6,20,20,0,16
Universitate,5651,4,3,7,4,14,18,-4,16
FC Botosani,5651,5,4,4,6,8,16,-8,16
Concordia Ch,5651,6,3,2,9,16,23,-7,11
FCSB,5652,1,8,5,1,26,13,13,29
CFR Cluj,5652,2,5,6,3,15,12,3,21
Universitate,5652,3,5,5,4,19,20,-1,20
FC Botosani,5652,4,3,6,5,7,14,-7,15
D Bucuresti,5652,5,3,5,6,17,21,-4,14
Concordia Ch,5652,6,3,3,8,18,22,-4,12
FCSB,5653,1,8,6,0,25,11,14,30
CFR Cluj,5653,2,6,7,1,15,8,7,25
D Bucuresti,5653,3,4,5,5,20,21,-1,17
Universitate,5653,4,3,5,6,16,22,-6,14
FC Botosani,5653,5,3,5,6,7,16,-9,14
Concordia Ch,5653,6,3,2,9,18,23,-5,11
FCSB,5654,1,7,6,1,24,12,12,27
CFR Cluj,5654,2,7,6,1,17,7,10,27
D Bucuresti,5654,3,4,5,5,18,19,-1,17
Universitate,5654,4,3,6,5,15,22,-7,15
FC Botosani,5654,5,3,5,6,6,14,-8,14
Concordia Ch,5654,6,2,4,8,17,23,-6,10
FCSB,5655,1,7,5,2,24,16,8,26
CFR Cluj,5655,2,6,6,2,18,9,9,24
Universitate,5655,3,5,5,4,16,18,-2,20
D Bucuresti,5655,4,5,4,5,20,19,1,19
FC Botosani,5655,5,3,4,7,6,16,-10,13
Concordia Ch,5655,6,3,2,9,18,24,-6,11
FCSB,5656,1,9,5,0,27,11,16,32
CFR Cluj,5656,2,5,6,3,13,11,2,21
Universitate,5656,3,4,5,5,17,20,-3,17
FC Botosani,5656,4,4,5,5,8,14,-6,17
D Bucuresti,5656,5,4,4,6,21,22,-1,16
Concordia Ch,5656,6,2,3,9,18,26,-8,9
FCSB,5657,1,8,5,1,26,12,14,29
CFR Cluj,5657,2,6,7,1,16,9,7,25
FC Botosani,5657,3,4,5,5,8,13,-5,17
Universitate,5657,4,3,6,5,15,21,-6,15
D Bucuresti,5657,5,3,5,6,19,23,-4,14
Concordia Ch,5657,6,2,4,8,17,23,-6,10
FCSB,5658,1,8,6,0,27,12,15,30
CFR Cluj,5658,2,6,6,2,16,10,6,24
D Bucuresti,5658,3,5,4,5,19,18,1,19
Universitate,5658,4,3,6,5,15,21,-6,15
FC Botosani,5658,5,3,4,7,6,16,-10,13
Concordia Ch,5658,6,3,2,9,18,24,-6,11
FCSB,5659,1,8,6,0,25,11,14,30
CFR Cluj,5659,2,6,6,2,16,9,7,24
D Bucuresti,5659,3,4,5,5,18,19,-1,17
Universitate,5659,4,3,6,5,16,22,-6,15
FC Botosani,5659,5,3,5,6,8,16,-8,14
Concordia Ch,5659,6,2,4,8,19,25,-6,10
FCSB,5660,1,8,5,1,26,12,14,29
CFR Cluj,5660,2,6,6,2,15,10,5,24
Universitate,5660,3,4,5,5,17,21,-4,17
D Bucuresti,5660,4,4,4,6,19,20,-1,16
FC Botosani,5660,5,4,4,6,6,14,-8,16
Concordia Ch,5660,6,3,2,9,17,23,-6,11
FCSB,5661,1,8,6,0,24,10,14,30
CFR Cluj,5661,2,6,6,2,14,8,6,24
D Bucuresti,5661,3,5,4,5,20,18,2,19
Universitate,5661,4,3,6,5,14,19,-5,15
FC Botosani,5661,5,3,4,7,6,17,-11,13
Concordia Ch,5661,6,3,2,9,17,23,-6,11
FCSB,5662,1,7,5,2,24,13,11,26
CFR Cluj,5662,2,6,6,2,14,8,6,24
Universitate,5662,3,5,5,4,17,19,-2,20
D Bucuresti,5662,4,4,5,5,18,19,-1,17
FC Botosani,5662,5,4,4,6,8,13,-5,16
Concordia Ch,5662,6,2,3,9,16,25,-9,9
FCSB,5663,1,7,6,1,25,13,12,27
CFR Cluj,5663,2,5,7,2,15,10,5,22
Universitate,5663,3,5,5,4,18,20,-2,20
D Bucuresti,5663,4,4,5,5,20,19,1,17
FC Botosani,5663,5,3,5,6,5,15,-10,14
Concordia Ch,5663,6,2,4,8,16,22,-6,10
FCSB,5664,1,9,5,0,27,10,17,32
CFR Cluj,5664,2,6,6,2,15,10,5,24
D Bucuresti,5664,3,4,5,5,17,18,-1,17
Universitate,5664,4,3,5,6,14,21,-7,14
FC Botosani,5664,5,3,5,6,7,15,-8,14
Concordia Ch,5664,6,2,4,8,17,23,-6,10
FCSB,5665,1,7,7,0,24,11,13,28
CFR Cluj,5665,2,6,7,1,16,8,8,25
FC Botosani,5665,3,4,5,5,7,13,-6,17
D Bucuresti,5665,4,4,4,6,17,19,-2,16
Universitate,5665,5,3,6,5,14,20,-6,15
Concordia Ch,5665,6,2,3,9,16,23,-7,9
FCSB,5666,1,7,6,1,24,14,10,27
CFR Cluj,5666,2,6,7,1,15,8,7,25
Universitate,5666,3,4,5,5,17,19,-2,17
FC Botosani,5666,4,4,5,5,8,14,-6,17
D Bucuresti,5666,5,3,5,6,17,20,-3,14
Concordia Ch,5666,6,3,2,9,17,23,-6,11
FCSB,5667,1,9,5,0,26,10,16,32
CFR Cluj,5667,2,5,6,3,13,11,2,21
Universitate,5667,3,4,5,5,16,19,-3,17
FC Botosani,5667,4,4,5,5,8,14,-6,17
D Bucuresti,5667,5,3,4,7,18,23,-5,13
Concordia Ch,5667,6,3,3,8,17,21,-4,12
FCSB,5668,1,9,5,0,28,12,16,32
CFR Cluj,5668,2,5,6,3,13,10,3,21
Universitate,5668,3,4,5,5,17,21,-4,17
FC Botosani,5668,4,4,5,5,7,12,-5,17
D Bucuresti,5668,5,3,4,7,17,22,-5,13
Concordia Ch,5668,6,3,3,8,17,22,-5,12
CFR Cluj,5669,1,7,6,1,17,8,9,27
FCSB,5669,2,7,5,2,25,15,10,26
D Bucuresti,5669,3,5,4,5,21,19,2,19
Universitate,5669,4,4,5,5,16,20,-4,17
FC Botosani,5669,5,4,4,6,7,15,-8,16
Concordia Ch,5669,6,2,2,10,15,24,-9,8
FCSB,5670,1,7,5,2,24,16,8,26
CFR Cluj,5670,2,6,6,2,17,9,8,24
Universitate,5670,3,5,5,4,17,18,-1,20
D Bucuresti,5670,4,5,4,5,18,18,0,19
FC Botosani,5670,5,3,5,6,5,13,-8,14
Concordia Ch,5670,6,2,3,9,15,22,-7,9
FCSB,5671,1,8,5,1,24,11,13,29
CFR Cluj,5671,2,7,6,1,15,7,8,27
D Bucuresti,5671,3,4,4,6,18,19,-1,16
FC Botosani,5671,4,4,4,6,7,14,-7,16
Universitate,5671,5,3,5,6,14,20,-6,14
Concordia Ch,5671,6,3,2,9,16,23,-7,11
FCSB,5672,1,7,6,1,26,14,12,27
CFR Cluj,5672,2,6,7,1,16,9,7,25
D Bucuresti,5672,3,4,5,5,19,20,-1,17
Universitate,5672,4,4,5,5,18,22,-4,17
FC Botosani,5672,5,3,6,5,8,15,-7,15
Concordia Ch,5672,6,2,3,9,18,25,-7,9
FCSB,5673,1,8,5,1,24,12,12,29
CFR Cluj,5673,2,5,7,2,13,8,5,22
Universitate,5673,3,4,6,4,16,18,-2,18
D Bucuresti,5673,4,4,5,5,17,18,-1,17
FC Botosani,5673,5,3,5,6,6,14,-8,14
Concordia Ch,5673,6,2,4,8,16,22,-6,10
FCSB,5674,1,8,6,0,26,12,14,30
CFR Cluj,5674,2,6,6,2,15,9,6,24
D Bucuresti,5674,3,4,5,5,21,20,1,17
FC Botosani,5674,4,4,4,6,8,17,-9,16
Universitate,5674,5,3,6,5,15,20,-5,15
Concordia Ch,5674,6,2,3,9,19,26,-7,9
FCSB,5675,1,8,6,0,25,10,15,30
CFR Cluj,5675,2,5,7,2,14,10,4,22
D Bucuresti,5675,3,4,4,6,18,19,-1,16
Universitate,5675,4,3,7,4,15,19,-4,16
FC Botosani,5675,5,3,5,6,6,15,-9,14
Concordia Ch,5675,6,3,3,8,17,22,-5,12
FCSB,5676,1,7,6,1,24,12,12,27
CFR Cluj,5676,2,6,6,2,14,8,6,24
Universitate,5676,3,4,6,4,16,19,-3,18
FC Botosani,5676,4,4,5,5,7,13,-6,17
D Bucuresti,5676,5,3,4,7,16,20,-4,13
Concordia Ch,5676,6,3,3,8,17,22,-5,12
FCSB,5677,1,7,7,0,25,12,13,28
CFR Cluj,5677,2,5,8,1,13,7,6,23
FC Botosani,5677,3,5,4,5,8,13,-5,19
Universitate,5677,4,3,7,4,16,20,-4,16
D Bucuresti,5677,5,3,5,6,19,22,-3,14
Concordia Ch,5677,6,2,3,9,17,24,-7,9
FCSB,5678,1,8,5,1,24,11,13,29
CFR Cluj,5678,2,5,7,2,13,8,5,22
FC Botosani,5678,3,5,4,5,11,15,-4,19
Universitate,5678,4,4,6,4,15,18,-3,18
D Bucuresti,5678,5,4,4,6,20,23,-3,16
Concordia Ch,5678,6,2,2,10,17,25,-8,8
FCSB,5679,1,8,6,0,25,11,14,30
CFR Cluj,5679,2,6,7,1,15,7,8,25
D Bucuresti,5679,3,4,5,5,23,20,3,17
FC Botosani,5679,4,4,4,6,6,17,-11,16
Universitate,5679,5,3,5,6,15,22,-7,14
Concordia Ch,5679,6,2,3,9,17,24,-7,9
FCSB,5680,1,7,6,1,24,13,11,27
CFR Cluj,5680,2,6,7,1,15,7,8,25
D Bucuresti,5680,3,4,4,6,19,23,-4,16
Universitate,5680,4,3,7,4,15,19,-4,16
FC Botosani,5680,5,3,5,6,8,16,-8,14
Concordia Ch,5680,6,3,3,8,19,22,-3,12
FCSB,5681,1,7,7,0,23,10,13,28
CFR Cluj,5681,2,6,7,1,14,7,7,25
FC Botosani,5681,3,4,4,6,7,14,-7,16
Universitate,5681,4,3,6,5,14,19,-5,15
D Bucuresti,5681,5,3,5,6,16,19,-3,14
Concordia Ch,5681,6,3,3,8,17,22,-5,12
FCSB,5682,1,9,5,0,26,11,15,32
CFR Cluj,5682,2,5,6,3,13,9,4,21
D Bucuresti,5682,3,5,4,5,18,18,0,19
Universitate,5682,4,4,5,5,16,20,-4,17
FC Botosani,5682,5,4,4,6,7,13,-6,16
Concordia Ch,5682,6,2,2,10,15,24,-9,8
FCSB,5683,1,7,6,1,23,11,12,27
CFR Cluj,5683,2,6,7,1,15,8,7,25
FC Botosani,5683,3,5,4,5,9,12,-3,19
Universitate,5683,4,3,7,4,15,19,-4,16
D Bucuresti,5683,5,3,4,7,16,20,-4,13
Concordia Ch,5683,6,3,2,9,16,24,-8,11
FCSB,5684,1,8,5,1,26,12,14,29
CFR Cluj,5684,2,7,6,1,18,9,9,27
D Bucuresti,5684,3,4,4,6,17,19,-2,16
Universitate,5684,4,3,5,6,17,25,-8,14
FC Botosani,5684,5,3,5,6,6,14,-8,14
Concordia Ch,5684,6,3,3,8,17,22,-5,12
FCSB,5685,1,7,6,1,24,12,12,27
CFR Cluj,5685,2,5,7,2,14,9,5,22
Universitate,5685,3,5,5,4,16,18,-2,20
D Bucuresti,5685,4,4,4,6,19,20,-1,16
Concordia Ch,5685,5,4,2,8,18,21,-3,14
FC Botosani,5685,6,3,4,7,5,16,-11,13
FCSB,5686,1,7,5,2,24,13,11,26
CFR Cluj,5686,2,6,6,2,15,9,6,24
Universitate,5686,3,5,5,4,18,20,-2,20
FC Botosani,5686,4,4,5,5,9,13,-4,17
D Bucuresti,5686,5,3,5,6,17,20,-3,14
Concordia Ch,5686,6,3,2,9,18,26,-8,11
FCSB,5687,1,8,5,1,24,11,13,29
CFR Cluj,5687,2,6,6,2,14,8,6,24
FC Botosani,5687,3,5,4,5,9,12,-3,19
Universitate,5687,4,4,5,5,15,19,-4,17
D Bucuresti,5687,5,3,5,6,17,21,-4,14
Concordia Ch,5687,6,2,3,9,16,24,-8,9
FCSB,5688,1,8,5,1,28,13,15,29
CFR Cluj,5688,2,5,7,2,14,11,3,22
Universitate,5688,3,4,6,4,18,21,-3,18
FC Botosani,5688,4,4,5,5,7,13,-6,17
D Bucuresti,5688,5,3,5,6,16,19,-3,14
Concordia Ch,5688,6,3,2,9,17,23,-6,11
FCSB,5689,1,8,5,1,26,16,10,29
CFR Cluj,5689,2,6,6,2,18,9,9,24
Universitate,5689,3,4,5,5,18,22,-4,17
FC Botosani,5689,4,4,5,5,8,14,-6,17
D Bucuresti,5689,5,3,5,6,18,21,-3,14
Concordia Ch,5689,6,3,2,9,18,24,-6,11
FCSB,5690,1,9,5,0,28,11,17,32
CFR Cluj,5690,2,5,7,2,14,11,3,22
D Bucuresti,5690,3,4,4,6,18,19,-1,16
Universitate,5690,4,3,6,5,16,21,-5,15
Concordia Ch,5690,5,4,2,8,18,21,-3,14
FC Botosani,5690,6,3,4,7,5,16,-11,13
FCSB,5691,1,8,5,1,25,12,13,29
CFR Cluj,5691,2,7,6,1,18,8,10,27
D Bucuresti,5691,3,4,5,5,20,20,0,17
Universitate,5691,4,3,5,6,15,23,-8,14
FC Botosani,5691,5,3,4,7,6,18,-12,13
Concordia Ch,5691,6,3,3,8,19,22,-3,12
FCSB,5692,1,8,5,1,26,12,14,29
CFR Cluj,5692,2,6,6,2,15,9,6,24
D Bucuresti,5692,3,4,5,5,20,21,-1,17
Universitate,5692,4,4,5,5,16,21,-5,17
FC Botosani,5692,5,4,4,6,7,14,-7,16
Concordia Ch,5692,6,2,3,9,19,26,-7,9
CFR Cluj,5693,1,7,6,1,21,7,14,27
FCSB,5693,2,7,6,1,23,12,11,27
D Bucuresti,5693,3,5,4,5,20,18,2,19
Universitate,5693,4,3,6,5,14,24,-10,15
FC Botosani,5693,5,3,5,6,6,14,-8,14
Concordia Ch,5693,6,2,3,9,16,25,-9,9
FCSB,5694,1,8,6,0,26,11,15,30
CFR Cluj,5694,2,5,7,2,13,9,4,22
D Bucuresti,5694,3,4,5,5,19,20,-1,17
Universitate,5694,4,3,7,4,15,19,-4,16
FC Botosani,5694,5,3,5,6,6,14,-8,14
Concordia Ch,5694,6,2,4,8,16,22,-6,10
FCSB,5695,1,7,7,0,24,11,13,28
CFR Cluj,5695,2,5,7,2,14,9,5,22
Universitate,5695,3,4,6,4,15,18,-3,18
FC Botosani,5695,4,4,4,6,7,14,-7,16
D Bucuresti,5695,5,3,5,6,17,21,-4,14
Concordia Ch,5695,6,3,3,8,18,22,-4,12
FCSB,5696,1,7,5,2,23,12,11,26
CFR Cluj,5696,2,6,7,1,15,8,7,25
Universitate,5696,3,4,6,4,16,19,-3,18
D Bucuresti,5696,4,4,4,6,19,19,0,16
Concordia Ch,5696,5,4,2,8,18,22,-4,14
FC Botosani,5696,6,3,4,7,6,17,-11,13
FCSB,5697,1,9,5,0,26,11,15,32
CFR Cluj,5697,2,5,7,2,14,9,5,22
FC Botosani,5697,3,5,4,5,11,13,-2,19
Universitate,5697,4,3,6,5,16,21,-5,15
D Bucuresti,5697,5,3,4,7,16,24,-8,13
Concordia Ch,5697,6,3,2,9,18,23,-5,11
FCSB,5698,1,7,7,0,26,13,13,28
CFR Cluj,5698,2,6,7,1,15,8,7,25
D Bucuresti,5698,3,5,4,5,21,18,3,19
Universitate,5698,4,3,6,5,16,21,-5,15
FC Botosani,5698,5,3,5,6,6,17,-11,14
Concordia Ch,5698,6,2,3,9,16,23,-7,9
FCSB,5699,1,8,6,0,26,11,15,30
CFR Cluj,5699,2,5,8,1,14,8,6,23
D Bucuresti,5699,3,4,4,6,17,21,-4,16
Universitate,5699,4,3,6,5,16,22,-6,15
FC Botosani,5699,5,3,5,6,5,13,-8,14
Concordia Ch,5699,6,3,3,8,18,21,-3,12
FCSB,5700,1,8,6,0,26,12,14,30
CFR Cluj,5700,2,5,7,2,15,10,5,22
D Bucuresti,5700,3,4,5,5,19,19,0,17
Universitate,5700,4,3,7,4,14,18,-4,16
FC Botosani,5700,5,3,4,7,5,17,-12,13
Concordia Ch,5700,6,3,3,8,19,22,-3,12
FCSB,5701,1,8,6,0,28,13,15,30
CFR Cluj,5701,2,5,8,1,16,10,6,23
D Bucuresti,5701,3,4,4,6,17,19,-2,16
FC Botosani,5701,4,4,4,6,6,13,-7,16
Universitate,5701,5,3,6,5,16,22,-6,15
Concordia Ch,5701,6,3,2,9,16,22,-6,11
FCSB,5702,1,7,6,1,23,12,11,27
CFR Cluj,5702,2,5,7,2,13,8,5,22
Universitate,5702,3,5,5,4,17,18,-1,20
D Bucuresti,5702,4,3,6,5,19,21,-2,15
FC Botosani,5702,5,3,6,5,9,16,-7,15
Concordia Ch,5702,6,2,4,8,18,24,-6,10
FCSB,5703,1,7,6,1,24,12,12,27
CFR Cluj,5703,2,7,6,1,16,7,9,27
FC Botosani,5703,3,4,5,5,7,12,-5,17
D Bucuresti,5703,4,3,6,5,16,18,-2,15
Universitate,5703,5,3,6,5,15,21,-6,15
Concordia Ch,5703,6,2,3,9,15,23,-8,9
FCSB,5704,1,9,5,0,28,11,17,32
CFR Cluj,5704,2,5,7,2,13,9,4,22
D Bucuresti,5704,3,3,6,5,17,19,-2,15
Universitate,5704,4,3,6,5,15,21,-6,15
FC Botosani,5704,5,3,6,5,5,12,-7,15
Concordia Ch,5704,6,2,4,8,16,22,-6,10
FCSB,5705,1,7,6,1,24,12,12,27
CFR Cluj,5705,2,7,6,1,16,8,8,27
D Bucuresti,5705,3,4,5,5,18,18,0,17
FC Botosani,5705,4,4,4,6,7,14,-7,16
Universitate,5705,5,3,6,5,16,21,-5,15
Concordia Ch,5705,6,2,3,9,15,23,-8,9
FCSB,5706,1,8,6,0,28,12,16,30
CFR Cluj,5706,2,5,7,2,15,12,3,22
D Bucuresti,5706,3,5,4,5,19,19,0,19
Universitate,5706,4,3,7,4,16,20,-4,16
FC Botosani,5706,5,3,4,7,6,15,-9,13
Concordia Ch,5706,6,3,2,9,18,24,-6,11
FCSB,5707,1,7,6,1,24,12,12,27
CFR Cluj,5707,2,5,7,2,13,8,5,22
Universitate,5707,3,5,5,4,17,19,-2,20
D Bucuresti,5707,4,5,4,5,20,19,1,19
FC Botosani,5707,5,4,4,6,7,15,-8,16
Concordia Ch,5707,6,2,2,10,17,25,-8,8
FCSB,5708,1,8,6,0,27,13,14,30
CFR Cluj,5708,2,6,7,1,16,8,8,25
D Bucuresti,5708,3,4,4,6,19,21,-2,16
FC Botosani,5708,4,4,4,6,7,14,-7,16
Universitate,5708,5,3,5,6,16,23,-7,14
Concordia Ch,5708,6,3,2,9,17,23,-6,11
FCSB,5709,1,8,5,1,25,12,13,29
CFR Cluj,5709,2,6,6,2,16,9,7,24
Universitate,5709,3,4,5,5,17,22,-5,17
D Bucuresti,5709,4,3,6,5,18,20,-2,15
FC Botosani,5709,5,3,6,5,6,13,-7,15
Concordia Ch,5709,6,2,4,8,16,22,-6,10
FCSB,5710,1,9,5,0,30,11,19,32
CFR Cluj,5710,2,5,6,3,13,12,1,21
Universitate,5710,3,4,5,5,16,21,-5,17
D Bucuresti,5710,4,3,5,6,19,22,-3,14
Concordia Ch,5710,5,4,2,8,20,24,-4,14
FC Botosani,5710,6,3,5,6,7,15,-8,14
FCSB,5711,1,8,6,0,25,11,14,30
CFR Cluj,5711,2,6,6,2,15,9,6,24
FC Botosani,5711,3,5,4,5,10,13,-3,19
Universitate,5711,4,3,6,5,16,21,-5,15
D Bucuresti,5711,5,3,4,7,16,21,-5,13
Concordia Ch,5711,6,3,2,9,17,24,-7,11
FCSB,5712,1,9,5,0,28,11,17,32
CFR Cluj,5712,2,5,7,2,13,10,3,22
D Bucuresti,5712,3,4,5,5,19,20,-1,17
FC Botosani,5712,4,4,5,5,10,15,-5,17
Universitate,5712,5,3,6,5,15,20,-5,15
Concordia Ch,5712,6,2,2,10,16,25,-9,8
FCSB,5713,1,8,5,1,26,13,13,29
CFR Cluj,5713,2,5,6,3,15,11,4,21
Universitate,5713,3,5,5,4,18,20,-2,20
FC Botosani,5713,4,3,6,5,5,12,-7,15
D Bucuresti,5713,5,3,5,6,17,23,-6,14
Concordia Ch,5713,6,3,3,8,20,22,-2,12
FCSB,5714,1,7,6,1,24,13,11,27
CFR Cluj,5714,2,5,8,1,13,7,6,23
Universitate,5714,3,4,6,4,17,19,-2,18
FC Botosani,5714,4,4,5,5,7,12,-5,17
D Bucuresti,5714,5,3,6,5,16,18,-2,15
Concordia Ch,5714,6,2,3,9,15,23,-8,9
FCSB,5715,1,7,5,2,23,13,10,26
CFR Cluj,5715,2,6,6,2,14,8,6,24
Universitate,5715,3,5,5,4,17,18,-1,20
D Bucuresti,5715,4,5,4,5,22,20,2,19
FC Botosani,5715,5,3,4,7,6,17,-11,13
Concordia Ch,5715,6,3,2,9,19,25,-6,11
FCSB,5716,1,8,5,1,24,11,13,29
CFR Cluj,5716,2,5,7,2,13,8,5,22
Universitate,5716,3,4,6,4,15,18,-3,18
FC Botosani,5716,4,4,4,6,7,13,-6,16
Concordia Ch,5716,5,4,2,8,18,21,-3,14
D Bucuresti,5716,6,3,4,7,16,22,-6,13
FCSB,5717,1,7,5,2,23,12,11,26
CFR Cluj,5717,2,6,6,2,16,11,5,24
Universitate,5717,3,5,5,4,19,20,-1,20
D Bucuresti,5717,4,4,4,6,18,22,-4,16
FC Botosani,5717,5,4,4,6,8,13,-5,16
Concordia Ch,5717,6,3,2,9,17,23,-6,11
FCSB,5718,1,8,5,1,26,13,13,29
CFR Cluj,5718,2,6,6,2,14,8,6,24
D Bucuresti,5718,3,4,5,5,20,21,-1,17
Universitate,5718,4,4,5,5,17,21,-4,17
FC Botosani,5718,5,4,4,6,9,14,-5,16
Concordia Ch,5718,6,2,3,9,17,26,-9,9
FCSB,5719,1,8,6,0,26,12,14,30
CFR Cluj,5719,2,6,6,2,14,8,6,24
D Bucuresti,5719,3,5,4,5,22,18,4,19
FC Botosani,5719,4,4,4,6,7,16,-9,16
Universitate,5719,5,3,6,5,16,21,-5,15
Concordia Ch,5719,6,2,2,10,16,26,-10,8
FCSB,5720,1,9,5,0,28,11,17,32
CFR Cluj,5720,2,6,6,2,14,8,6,24
D Bucuresti,5720,3,4,4,6,19,22,-3,16
Universitate,5720,4,3,5,6,15,23,-8,14
FC Botosani,5720,5,3,5,6,7,15,-8,14
Concordia Ch,5720,6,3,3,8,19,23,-4,12
FCSB,5721,1,9,5,0,28,11,17,32
CFR Cluj,5721,2,6,6,2,15,10,5,24
D Bucuresti,5721,3,4,4,6,19,22,-3,16
FC Botosani,5721,4,4,4,6,6,15,-9,16
Universitate,5721,5,3,5,6,14,21,-7,14
Concordia Ch,5721,6,3,2,9,19,22,-3,11
FCSB,5722,1,8,5,1,26,13,13,29
CFR Cluj,5722,2,5,6,3,14,10,4,21
Universitate,5722,3,5,5,4,17,19,-2,20
D Bucuresti,5722,4,4,4,6,18,20,-2,16
FC Botosani,5722,5,3,5,6,6,14,-8,14
Concordia Ch,5722,6,3,3,8,18,23,-5,12
FCSB,5723,1,7,7,0,24,11,13,28
CFR Cluj,5723,2,5,8,1,14,8,6,23
D Bucuresti,5723,3,4,5,5,18,19,-1,17
Universitate,5723,4,3,7,4,16,20,-4,16
FC Botosani,5723,5,3,6,5,6,13,-7,15
Concordia Ch,5723,6,2,3,9,17,24,-7,9
FCSB,5724,1,8,5,1,25,12,13,29
CFR Cluj,5724,2,6,6,2,15,9,6,24
D Bucuresti,5724,3,4,5,5,19,19,0,17
Universitate,5724,4,4,5,5,15,19,-4,17
FC Botosani,5724,5,3,5,6,6,15,-9,14
Concordia Ch,5724,6,2,4,8,17,23,-6,10
FCSB,5725,1,7,7,0,24,11,13,28
CFR Cluj,5725,2,6,7,1,15,7,8,25
FC Botosani,5725,3,5,4,5,7,12,-5,19
Universitate,5725,4,3,6,5,15,21,-6,15
D Bucuresti,5725,5,3,4,7,16,20,-4,13
Concordia Ch,5725,6,3,2,9,16,22,-6,11
FCSB,5726,1,9,5,0,32,10,22,32
CFR Cluj,5726,2,5,7,2,15,12,3,22
D Bucuresti,5726,3,4,5,5,20,19,1,17
FC Botosani,5726,4,4,4,6,8,16,-8,16
Universitate,5726,5,3,6,5,16,26,-10,15
Concordia Ch,5726,6,2,3,9,17,25,-8,9
FCSB,5727,1,7,7,0,25,12,13,28
CFR Cluj,5727,2,5,8,1,16,10,6,23
D Bucuresti,5727,3,4,5,5,19,20,-1,17
FC Botosani,5727,4,4,5,5,9,13,-4,17
Universitate,5727,5,3,7,4,15,19,-4,16
Concordia Ch,5727,6,2,2,10,16,26,-10,8
FCSB,5728,1,8,5,1,24,11,13,29
CFR Cluj,5728,2,6,6,2,14,8,6,24
D Bucuresti,5728,3,5,4,5,19,18,1,19
Universitate,5728,4,4,5,5,15,19,-4,17
FC Botosani,5728,5,4,4,6,8,14,-6,16
Concordia Ch,5728,6,2,2,10,16,26,-10,8
FCSB,5729,1,9,5,0,27,12,15,32
CFR Cluj,5729,2,5,6,3,14,12,2,21
Universitate,5729,3,4,5,5,18,20,-2,17
D Bucuresti,5729,4,4,4,6,17,19,-2,16
FC Botosani,5729,5,4,4,6,6,13,-7,16
Concordia Ch,5729,6,3,2,9,16,22,-6,11
FCSB,5730,1,7,6,1,25,14,11,27
CFR Cluj,5730,2,5,8,1,15,9,6,23
Universitate,5730,3,4,6,4,16,18,-2,18
FC Botosani,5730,4,4,5,5,8,13,-5,17
D Bucuresti,5730,5,3,5,6,16,20,-4,14
Concordia Ch,5730,6,3,2,9,18,24,-6,11
FCSB,5731,1,8,5,1,27,15,12,29
CFR Cluj,5731,2,6,7,1,17,9,8,25
D Bucuresti,5731,3,4,4,6,17,21,-4,16
Universitate,5731,4,3,6,5,17,22,-5,15
FC Botosani,5731,5,3,5,6,6,14,-8,14
Concordia Ch,5731,6,3,3,8,19,22,-3,12
FCSB,5732,1,8,5,1,24,13,11,29
CFR Cluj,5732,2,6,6,2,17,9,8,24
D Bucuresti,5732,3,5,4,5,19,18,1,19
Universitate,5732,4,4,5,5,16,20,-4,17
FC Botosani,5732,5,3,5,6,5,14,-9,14
Concordia Ch,5732,6,2,3,9,15,22,-7,9
FCSB,5733,1,8,6,0,27,13,14,30
CFR Cluj,5733,2,6,7,1,17,9,8,25
FC Botosani,5733,3,5,4,5,8,12,-4,19
D Bucuresti,5733,4,3,5,6,17,20,-3,14
Universitate,5733,5,3,5,6,15,22,-7,14
Concordia Ch,5733,6,2,3,9,16,24,-8,9
FCSB,5734,1,7,6,1,24,12,12,27
CFR Cluj,5734,2,7,6,1,15,7,8,27
FC Botosani,5734,3,4,5,5,6,12,-6,17
Universitate,5734,4,3,6,5,15,20,-5,15
D Bucuresti,5734,5,3,5,6,18,21,-3,14
Concordia Ch,5734,6,3,2,9,18,24,-6,11
FCSB,5735,1,7,6,1,24,13,11,27
CFR Cluj,5735,2,5,8,1,15,9,6,23
FC Botosani,5735,3,5,4,5,10,14,-4,19
Universitate,5735,4,4,6,4,17,19,-2,18
D Bucuresti,5735,5,4,4,6,20,21,-1,16
Concordia Ch,5735,6,2,2,10,17,27,-10,8
FCSB,5736,1,9,5,0,27,11,16,32
CFR Cluj,5736,2,6,6,2,15,9,6,24
FC Botosani,5736,3,4,4,6,8,15,-7,16
Concordia Ch,5736,4,4,2,8,20,23,-3,14
Universitate,5736,5,3,5,6,14,21,-7,14
D Bucuresti,5736,6,3,4,7,17,22,-5,13
FCSB,5737,1,8,6,0,25,10,15,30
CFR Cluj,5737,2,6,6,2,14,9,5,24
D Bucuresti,5737,3,4,4,6,18,20,-2,16
Universitate,5737,4,3,6,5,14,19,-5,15
Concordia Ch,5737,5,4,2,8,19,22,-3,14
FC Botosani,5737,6,3,4,7,5,15,-10,13
FCSB,5738,1,8,6,0,26,12,14,30
CFR Cluj,5738,2,6,6,2,16,8,8,24
D Bucuresti,5738,3,4,4,6,18,20,-2,16
Universitate,5738,4,3,6,5,16,23,-7,15
Concordia Ch,5738,5,4,2,8,18,22,-4,14
FC Botosani,5738,6,3,4,7,5,14,-9,13
FCSB,5739,1,8,6,0,27,13,14,30
CFR Cluj,5739,2,6,6,2,15,9,6,24
D Bucuresti,5739,3,5,4,5,18,18,0,19
Universitate,5739,4,3,6,5,16,21,-5,15
FC Botosani,5739,5,3,4,7,6,16,-10,13
Concordia Ch,5739,6,3,2,9,18,23,-5,11
FCSB,5740,1,9,5,0,26,11,15,32
CFR Cluj,5740,2,6,6,2,16,9,7,24
D Bucuresti,5740,3,5,4,5,20,19,1,19
FC Botosani,5740,4,4,4,6,7,14,-7,16
Universitate,5740,5,3,5,6,14,21,-7,14
Concordia Ch,5740,6,2,2,10,17,26,-9,8
FCSB,5741,1,8,6,0,26,10,16,30
CFR Cluj,5741,2,6,7,1,15,7,8,25
FC Botosani,5741,3,5,4,5,7,12,-5,19
Universitate,5741,4,3,5,6,14,23,-9,14
D Bucuresti,5741,5,3,4,7,16,22,-6,13
Concordia Ch,5741,6,3,2,9,18,22,-4,11
FCSB,5742,1,8,5,1,25,14,11,29
CFR Cluj,5742,2,5,7,2,13,8,5,22
Universitate,5742,3,4,6,4,18,19,-1,18
D Bucuresti,5742,4,4,5,5,20,20,0,17
FC Botosani,5742,5,3,4,7,5,15,-10,13
Concordia Ch,5742,6,3,3,8,18,23,-5,12
FCSB,5743,1,8,6,0,27,13,14,30
CFR Cluj,5743,2,5,6,3,13,9,4,21
Universitate,5743,3,4,6,4,18,21,-3,18
D Bucuresti,5743,4,4,5,5,18,18,0,17
FC Botosani,5743,5,4,5,5,8,13,-5,17
Concordia Ch,5743,6,2,2,10,16,26,-10,8
FCSB,5744,1,8,5,1,25,11,14,29
CFR Cluj,5744,2,6,7,1,15,8,7,25
D Bucuresti,5744,3,4,4,6,18,19,-1,16
Universitate,5744,4,3,6,5,15,21,-6,15
Concordia Ch,5744,5,4,2,8,17,21,-4,14
FC Botosani,5744,6,3,4,7,5,15,-10,13
FCSB,5745,1,8,5,1,27,13,14,29
CFR Cluj,5745,2,6,7,1,15,8,7,25
D Bucuresti,5745,3,4,4,6,19,19,0,16
Universitate,5745,4,3,6,5,15,21,-6,15
FC Botosani,5745,5,3,5,6,6,16,-10,14
Concordia Ch,5745,6,3,3,8,17,22,-5,12
FCSB,5746,1,8,5,1,25,11,14,29
CFR Cluj,5746,2,7,6,1,15,7,8,27
D Bucuresti,5746,3,4,4,6,19,21,-2,16
Concordia Ch,5746,4,4,2,8,20,23,-3,14
Universitate,5746,5,3,5,6,14,21,-7,14
FC Botosani,5746,6,3,4,7,7,17,-10,13
FCSB,5747,1,8,5,1,27,12,15,29
CFR Cluj,5747,2,6,6,2,15,8,7,24
Universitate,5747,3,4,5,5,15,22,-7,17
FC Botosani,5747,4,4,4,6,7,13,-6,16
Concordia Ch,5747,5,4,2,8,18,22,-4,14
D Bucuresti,5747,6,3,4,7,17,22,-5,13
FCSB,5748,1,7,6,1,23,11,12,27
CFR Cluj,5748,2,6,7,1,14,7,7,25
Universitate,5748,3,4,5,5,15,19,-4,17
D Bucuresti,5748,4,4,4,6,18,22,-4,16
FC Botosani,5748,5,3,5,6,6,14,-8,14
Concordia Ch,5748,6,3,3,8,20,23,-3,12
FCSB,5749,1,7,6,1,25,14,11,27
CFR Cluj,5749,2,7,6,1,17,8,9,27
D Bucuresti,5749,3,4,5,5,18,19,-1,17
FC Botosani,5749,4,4,4,6,6,13,-7,16
Universitate,5749,5,3,6,5,15,20,-5,15
Concordia Ch,5749,6,2,3,9,16,23,-7,9
FCSB,5750,1,7,7,0,24,11,13,28
CFR Cluj,5750,2,6,7,1,16,8,8,25
D Bucuresti,5750,3,4,5,5,18,19,-1,17
Universitate,5750,4,3,6,5,14,20,-6,15
FC Botosani,5750,5,3,6,5,8,15,-7,15
Concordia Ch,5750,6,2,3,9,17,24,-7,9
FCSB,5751,1,8,6,0,27,13,14,30
CFR Cluj,5751,2,5,6,3,14,10,4,21
D Bucuresti,5751,3,5,4,5,20,20,0,19
Universitate,5751,4,4,6,4,17,20,-3,18
FC Botosani,5751,5,4,4,6,9,16,-7,16
Concordia Ch,5751,6,2,2,10,18,26,-8,8
FCSB,5752,1,8,5,1,25,13,12,29
CFR Cluj,5752,2,5,6,3,14,12,2,21
Universitate,5752,3,5,5,4,19,18,1,20
FC Botosani,5752,4,5,4,5,7,12,-5,19
D Bucuresti,5752,5,3,4,7,17,22,-5,13
Concordia Ch,5752,6,3,2,9,18,23,-5,11
CFR Cluj,5753,1,7,6,1,17,8,9,27
FCSB,5753,2,7,5,2,24,13,11,26
Universitate,5753,3,4,5,5,15,20,-5,17
D Bucuresti,5753,4,4,4,6,19,23,-4,16
FC Botosani,5753,5,3,5,6,6,14,-8,14
Concordia Ch,5753,6,3,3,8,19,22,-3,12
FCSB,5754,1,7,7,0,24,11,13,28
CFR Cluj,5754,2,6,7,1,15,8,7,25
FC Botosani,5754,3,4,5,5,7,13,-6,17
D Bucuresti,5754,4,4,4,6,18,20,-2,16
Universitate,5754,5,3,6,5,14,19,-5,15
Concordia Ch,5754,6,2,3,9,17,24,-7,9
FCSB,5755,1,7,6,1,24,12,12,27
CFR Cluj,5755,2,6,7,1,16,9,7,25
FC Botosani,5755,3,5,4,5,7,12,-5,19
Universitate,5755,4,4,5,5,16,20,-4,17
D Bucuresti,5755,5,3,4,7,17,22,-5,13
Concordia Ch,5755,6,3,2,9,18,23,-5,11
FCSB,5756,1,8,6,0,30,13,17,30
CFR Cluj,5756,2,5,6,3,14,13,1,21
Universitate,5756,3,4,6,4,17,20,-3,18
D Bucuresti,5756,4,4,5,5,21,19,2,17
FC Botosani,5756,5,3,4,7,6,22,-16,13
Concordia Ch,5756,6,3,3,8,22,23,-1,12
FCSB,5757,1,8,5,1,27,12,15,29
CFR Cluj,5757,2,6,7,1,15,8,7,25
FC Botosani,5757,3,4,5,5,7,13,-6,17
Universitate,5757,4,3,6,5,14,21,-7,15
D Bucuresti,5757,5,3,5,6,16,20,-4,14
Concordia Ch,5757,6,3,2,9,18,23,-5,11
FCSB,5758,1,8,5,1,29,12,17,29
CFR Cluj,5758,2,7,6,1,18,8,10,27
D Bucuresti,5758,3,5,4,5,23,20,3,19
Universitate,5758,4,3,5,6,14,26,-12,14
FC Botosani,5758,5,3,4,7,6,18,-12,13
Concordia Ch,5758,6,3,2,9,19,25,-6,11
FCSB,5759,1,7,7,0,26,13,13,28
CFR Cluj,5759,2,6,7,1,17,9,8,25
D Bucuresti,5759,3,4,4,6,18,20,-2,16
FC Botosani,5759,4,4,4,6,8,15,-7,16
Universitate,5759,5,3,6,5,17,23,-6,15
Concordia Ch,5759,6,3,2,9,18,24,-6,11
FCSB,5760,1,8,5,1,26,13,13,29
CFR Cluj,5760,2,7,6,1,17,8,9,27
D Bucuresti,5760,3,4,4,6,19,22,-3,16
FC Botosani,5760,4,4,4,6,7,13,-6,16
Universitate,5760,5,3,5,6,15,22,-7,14
Concordia Ch,5760,6,3,2,9,19,25,-6,11
FCSB,5761,1,8,5,1,28,13,15,29
CFR Cluj,5761,2,6,6,2,16,12,4,24
Universitate,5761,3,4,5,5,15,19,-4,17
FC Botosani,5761,4,4,5,5,6,12,-6,17
D Bucuresti,5761,5,3,5,6,16,20,-4,14
Concordia Ch,5761,6,3,2,9,17,22,-5,11
FCSB,5762,1,8,6,0,26,12,14,30
CFR Cluj,5762,2,6,7,1,16,9,7,25
D Bucuresti,5762,3,4,4,6,18,21,-3,16
Universitate,5762,4,3,5,6,18,24,-6,14
FC Botosani,5762,5,3,5,6,5,13,-8,14
Concordia Ch,5762,6,3,3,8,18,22,-4,12
FCSB,5763,1,7,6,1,25,13,12,27
CFR Cluj,5763,2,5,7,2,15,10,5,22
Universitate,5763,3,5,5,4,16,18,-2,20
D Bucuresti,5763,4,3,6,5,16,18,-2,15
FC Botosani,5763,5,3,6,5,6,13,-7,15
Concordia Ch,5763,6,2,4,8,16,22,-6,10
FCSB,5764,1,9,5,0,27,11,16,32
CFR Cluj,5764,2,6,6,2,15,10,5,24
FC Botosani,5764,3,5,4,5,7,12,-5,19
Universitate,5764,4,3,5,6,16,22,-6,14
D Bucuresti,5764,5,3,4,7,16,22,-6,13
Concordia Ch,5764,6,3,2,9,18,22,-4,11
FCSB,5765,1,8,6,0,25,11,14,30
CFR Cluj,5765,2,6,6,2,15,8,7,24
D Bucuresti,5765,3,4,5,5,20,19,1,17
FC Botosani,5765,4,4,5,5,7,13,-6,17
Universitate,5765,5,3,6,5,15,21,-6,15
Concordia Ch,5765,6,2,2,10,17,27,-10,8
FCSB,5766,1,9,5,0,28,12,16,32
CFR Cluj,5766,2,6,6,2,15,8,7,24
D Bucuresti,5766,3,4,5,5,17,18,-1,17
FC Botosani,5766,4,4,4,6,7,13,-6,16
Universitate,5766,5,3,5,6,16,24,-8,14
Concordia Ch,5766,6,2,3,9,15,23,-8,9
FCSB,5767,1,8,6,0,28,13,15,30
CFR Cluj,5767,2,5,6,3,14,11,3,21
Universitate,5767,3,4,6,4,17,20,-3,18
D Bucuresti,5767,4,4,4,6,17,21,-4,16
FC Botosani,5767,5,4,4,6,7,14,-7,16
Concordia Ch,5767,6,3,2,9,19,23,-4,11
FCSB,5768,1,8,6,0,25,11,14,30
CFR Cluj,5768,2,5,8,1,14,8,6,23
D Bucuresti,5768,3,4,4,6,18,22,-4,16
FC Botosani,5768,4,4,4,6,8,13,-5,16
Universitate,5768,5,3,6,5,14,19,-5,15
Concordia Ch,5768,6,3,2,9,19,25,-6,11
FCSB,5769,1,7,6,1,25,13,12,27
CFR Cluj,5769,2,7,6,1,18,8,10,27
D Bucuresti,5769,3,4,4,6,18,22,-4,16
FC Botosani,5769,4,4,4,6,8,14,-6,16
Universitate,5769,5,3,6,5,15,22,-7,15
Concordia Ch,5769,6,3,2,9,18,23,-5,11
FCSB,5770,1,8,5,1,25,12,13,29
CFR Cluj,5770,2,5,7,2,15,10,5,22
Universitate,5770,3,4,6,4,16,19,-3,18
Concordia Ch,5770,4,4,2,8,21,23,-2,14
D Bucuresti,5770,5,3,5,6,20,24,-4,14
FC Botosani,5770,6,3,5,6,7,16,-9,14
FCSB,5771,1,9,5,0,28,11,17,32
CFR Cluj,5771,2,6,6,2,17,10,7,24
D Bucuresti,5771,3,3,6,5,19,21,-2,15
Universitate,5771,4,3,5,6,15,24,-9,14
FC Botosani,5771,5,3,5,6,7,16,-9,14
Concordia Ch,5771,6,3,3,8,18,22,-4,12
FCSB,5772,1,9,5,0,27,10,17,32
CFR Cluj,5772,2,6,6,2,15,9,6,24
FC Botosani,5772,3,4,4,6,6,13,-7,16
Concordia Ch,5772,4,4,2,8,17,21,-4,14
Universitate,5772,5,3,5,6,14,22,-8,14
D Bucuresti,5772,6,3,4,7,16,20,-4,13
FCSB,5773,1,8,5,1,25,12,13,29
CFR Cluj,5773,2,6,6,2,17,10,7,24
Universitate,5773,3,4,5,5,16,21,-5,17
FC Botosani,5773,4,4,4,6,11,15,-4,16
D Bucuresti,5773,5,4,4,6,18,26,-8,16
Concordia Ch,5773,6,3,2,9,23,26,-3,11
FCSB,5774,1,7,6,1,25,13,12,27
CFR Cluj,5774,2,5,8,1,15,9,6,23
Universitate,5774,3,4,6,4,15,18,-3,18
D Bucuresti,5774,4,4,4,6,19,19,0,16
FC Botosani,5774,5,4,4,6,7,15,-8,16
Concordia Ch,5774,6,3,2,9,16,23,-7,11
FCSB,5775,1,8,5,1,26,11,15,29
CFR Cluj,5775,2,5,7,2,13,10,3,22
Universitate,5775,3,4,6,4,15,18,-3,18
D Bucuresti,5775,4,4,5,5,18,19,-1,17
FC Botosani,5775,5,3,5,6,7,15,-8,14
Concordia Ch,5775,6,2,4,8,16,22,-6,10
FCSB,5776,1,9,5,0,29,13,16,32
CFR Cluj,5776,2,5,6,3,14,11,3,21
Universitate,5776,3,4,5,5,17,21,-4,17
FC Botosani,5776,4,4,5,5,8,13,-5,17
D Bucuresti,5776,5,3,5,6,17,21,-4,14
Concordia Ch,5776,6,2,4,8,17,23,-6,10
FCSB,5777,1,7,7,0,26,13,13,28
CFR Cluj,5777,2,5,7,2,14,10,4,22
D Bucuresti,5777,3,5,4,5,19,18,1,19
Universitate,5777,4,4,6,4,18,20,-2,18
FC Botosani,5777,5,4,4,6,7,15,-8,16
Concordia Ch,5777,6,2,2,10,16,24,-8,8
FCSB,5778,1,9,5,0,28,10,18,32
CFR Cluj,5778,2,6,6,2,15,12,3,24
D Bucuresti,5778,3,4,4,6,19,20,-1,16
FC Botosani,5778,4,4,4,6,7,15,-8,16
Universitate,5778,5,3,5,6,15,21,-6,14
Concordia Ch,5778,6,3,2,9,16,22,-6,11
FCSB,5779,1,8,6,0,26,12,14,30
CFR Cluj,5779,2,5,6,3,13,10,3,21
Universitate,5779,3,4,6,4,18,20,-2,18
D Bucuresti,5779,4,4,4,6,18,20,-2,16
FC Botosani,5779,5,4,4,6,7,14,-7,16
Concordia Ch,5779,6,3,2,9,16,22,-6,11
FCSB,5780,1,9,5,0,26,11,15,32
CFR Cluj,5780,2,5,7,2,14,9,5,22
D Bucuresti,5780,3,4,5,5,18,19,-1,17
Universitate,5780,4,3,6,5,16,21,-5,15
FC Botosani,5780,5,3,6,5,5,12,-7,15
Concordia Ch,5780,6,2,3,9,16,23,-7,9
FCSB,5781,1,9,5,0,26,10,16,32
CFR Cluj,5781,2,6,6,2,18,9,9,24
FC Botosani,5781,3,4,5,5,8,13,-5,17
D Bucuresti,5781,4,3,5,6,18,24,-6,14
Universitate,5781,5,3,5,6,14,24,-10,14
Concordia Ch,5781,6,3,2,9,20,24,-4,11
CFR Cluj,5782,1,7,6,1,19,11,8,27
FCSB,5782,2,7,5,2,26,15,11,26
Universitate,5782,3,4,5,5,20,24,-4,17
FC Botosani,5782,4,4,4,6,6,14,-8,16
D Bucuresti,5782,5,3,5,6,17,20,-3,14
Concordia Ch,5782,6,3,3,8,18,22,-4,12
FCSB,5783,1,8,6,0,26,11,15,30
CFR Cluj,5783,2,6,6,2,15,9,6,24
D Bucuresti,5783,3,4,5,5,19,20,-1,17
Universitate,5783,4,3,6,5,15,21,-6,15
FC Botosani,5783,5,3,5,6,7,15,-8,14
Concordia Ch,5783,6,2,4,8,17,23,-6,10
CFR Cluj,5784,1,7,6,1,20,8,12,27
FCSB,5784,2,7,5,2,24,16,8,26
Universitate,5784,3,4,5,5,18,23,-5,17
D Bucuresti,5784,4,4,4,6,18,20,-2,16
Concordia Ch,5784,5,4,2,8,19,22,-3,14
FC Botosani,5784,6,3,4,7,5,15,-10,13
FCSB,5785,1,8,5,1,26,13,13,29
CFR Cluj,5785,2,6,6,2,16,10,6,24
Universitate,5785,3,4,5,5,16,20,-4,17
D Bucuresti,5785,4,4,4,6,20,22,-2,16
FC Botosani,5785,5,3,5,6,5,14,-9,14
Concordia Ch,5785,6,3,3,8,19,23,-4,12
FCSB,5786,1,7,5,2,24,14,10,26
CFR Cluj,5786,2,6,7,1,17,9,8,25
Universitate,5786,3,4,6,4,18,21,-3,18
D Bucuresti,5786,4,4,5,5,20,18,2,17
FC Botosani,5786,5,4,4,6,8,17,-9,16
Concordia Ch,5786,6,2,3,9,16,24,-8,9
FCSB,5787,1,8,6,0,28,12,16,30
CFR Cluj,5787,2,5,6,3,14,14,0,21
Universitate,5787,3,4,6,4,18,19,-1,18
FC Botosani,5787,4,4,5,5,8,14,-6,17
D Bucuresti,5787,5,4,4,6,19,21,-2,16
Concordia Ch,5787,6,2,3,9,17,24,-7,9
FCSB,5788,1,8,5,1,26,13,13,29
CFR Cluj,5788,2,5,7,2,14,11,3,22
Universitate,5788,3,4,6,4,18,19,-1,18
FC Botosani,5788,4,4,4,6,7,14,-7,16
Concordia Ch,5788,5,4,2,8,17,21,-4,14
D Bucuresti,5788,6,3,4,7,17,21,-4,13
FCSB,5789,1,7,7,0,25,12,13,28
CFR Cluj,5789,2,5,7,2,15,11,4,22
Universitate,5789,3,4,6,4,18,20,-2,18
D Bucuresti,5789,4,4,4,6,19,19,0,16
FC Botosani,5789,5,4,4,6,7,14,-7,16
Concordia Ch,5789,6,3,2,9,17,25,-8,11
FCSB,5790,1,8,6,0,26,11,15,30
CFR Cluj,5790,2,5,6,3,15,12,3,21
Universitate,5790,3,4,6,4,18,21,-3,18
FC Botosani,5790,4,3,6,5,6,13,-7,15
D Bucuresti,5790,5,3,5,6,17,20,-3,14
Concordia Ch,5790,6,3,3,8,16,21,-5,12
FCSB,5791,1,8,6,0,27,12,15,30
CFR Cluj,5791,2,5,6,3,14,11,3,21
Universitate,5791,3,4,6,4,16,19,-3,18
D Bucuresti,5791,4,4,5,5,18,19,-1,17
FC Botosani,5791,5,4,5,5,7,12,-5,17
Concordia Ch,5791,6,2,2,10,16,25,-9,8
FCSB,5792,1,9,5,0,28,11,17,32
CFR Cluj,5792,2,6,6,2,16,10,6,24
FC Botosani,5792,3,4,5,5,6,12,-6,17
D Bucuresti,5792,4,4,4,6,18,19,-1,16
Universitate,5792,5,3,5,6,15,23,-8,14
Concordia Ch,5792,6,2,3,9,15,23,-8,9
FCSB,5793,1,7,7,0,25,12,13,28
CFR Cluj,5793,2,5,8,1,15,9,6,23
D Bucuresti,5793,3,4,5,5,18,19,-1,17
Universitate,5793,4,3,7,4,14,18,-4,16
FC Botosani,5793,5,3,5,6,5,14,-9,14
Concordia Ch,5793,6,3,2,9,18,23,-5,11
FCSB,5794,1,7,6,1,24,12,12,27
CFR Cluj,5794,2,5,8,1,14,8,6,23
Universitate,5794,3,4,6,4,17,20,-3,18
D Bucuresti,5794,4,4,4,6,19,20,-1,16
FC Botosani,5794,5,4,4,6,7,14,-7,16
Concordia Ch,5794,6,3,2,9,17,24,-7,11
FCSB,5795,1,7,5,2,24,14,10,26
CFR Cluj,5795,2,6,7,1,15,7,8,25
Universitate,5795,3,4,6,4,16,19,-3,18
D Bucuresti,5795,4,4,4,6,21,21,0,16
FC Botosani,5795,5,3,5,6,6,17,-11,14
Concordia Ch,5795,6,3,3,8,19,23,-4,12
FCSB,5796,1,9,5,0,28,10,18,32
CFR Cluj,5796,2,6,6,2,15,10,5,24
FC Botosani,5796,3,4,5,5,9,14,-5,17
D Bucuresti,5796,4,3,5,6,17,20,-3,14
Universitate,5796,5,3,5,6,14,22,-8,14
Concordia Ch,5796,6,3,2,9,19,26,-7,11
FCSB,5797,1,7,7,0,24,11,13,28
CFR Cluj,5797,2,6,7,1,15,8,7,25
FC Botosani,5797,3,4,5,5,8,13,-5,17
Universitate,5797,4,3,6,5,14,19,-5,15
D Bucuresti,5797,5,3,4,7,16,21,-5,13
Concordia Ch,5797,6,3,3,8,17,22,-5,12
FCSB,5798,1,7,7,0,25,12,13,28
CFR Cluj,5798,2,6,7,1,15,8,7,25
FC Botosani,5798,3,4,4,6,8,14,-6,16
Universitate,5798,4,3,6,5,15,20,-5,15
D Bucuresti,5798,5,3,5,6,18,22,-4,14
Concordia Ch,5798,6,3,3,8,17,22,-5,12
FCSB,5799,1,8,5,1,25,13,12,29
CFR Cluj,5799,2,7,6,1,16,7,9,27
D Bucuresti,5799,3,5,4,5,21,20,1,19
Universitate,5799,4,3,5,6,15,21,-6,14
FC Botosani,5799,5,3,4,7,7,18,-11,13
Concordia Ch,5799,6,3,2,9,19,24,-5,11
FCSB,5800,1,8,5,1,25,12,13,29
CFR Cluj,5800,2,7,6,1,16,8,8,27
FC Botosani,5800,3,4,5,5,6,12,-6,17
D Bucuresti,5800,4,3,6,5,17,19,-2,15
Universitate,5800,5,3,5,6,14,20,-6,14
Concordia Ch,5800,6,2,3,9,16,23,-7,9
FCSB,5801,1,7,7,0,24,11,13,28
CFR Cluj,5801,2,6,7,1,16,8,8,25
FC Botosani,5801,3,4,4,6,7,14,-7,16
Universitate,5801,4,3,6,5,16,22,-6,15
D Bucuresti,5801,5,3,5,6,16,19,-3,14
Concordia Ch,5801,6,3,3,8,17,22,-5,12
FCSB,5802,1,8,5,1,27,12,15,29
CFR Cluj,5802,2,6,6,2,16,12,4,24
Universitate,5802,3,4,5,5,16,20,-4,17
D Bucuresti,5802,4,3,6,5,19,21,-2,15
FC Botosani,5802,5,3,5,6,5,13,-8,14
Concordia Ch,5802,6,3,3,8,19,24,-5,12
FCSB,5803,1,9,5,0,27,10,17,32
CFR Cluj,5803,2,5,7,2,13,10,3,22
Universitate,5803,3,3,6,5,14,19,-5,15
D Bucuresti,5803,4,3,5,6,18,21,-3,14
Concordia Ch,5803,5,4,2,8,18,22,-4,14
FC Botosani,5803,6,3,5,6,6,14,-8,14
FCSB,5804,1,9,5,0,27,12,15,32
CFR Cluj,5804,2,6,6,2,15,9,6,24
FC Botosani,5804,3,4,5,5,11,16,-5,17
D Bucuresti,5804,4,3,5,6,20,23,-3,14
Universitate,5804,5,3,5,6,15,21,-6,14
Concordia Ch,5804,6,3,2,9,18,25,-7,11
FCSB,5805,1,7,7,0,23,10,13,28
CFR Cluj,5805,2,5,7,2,13,8,5,22
Universitate,5805,3,4,6,4,15,18,-3,18
FC Botosani,5805,4,4,5,5,8,12,-4,17
D Bucuresti,5805,5,3,4,7,16,22,-6,13
Concordia Ch,5805,6,3,3,8,16,21,-5,12
FCSB,5806,1,9,5,0,28,10,18,32
CFR Cluj,5806,2,5,6,3,13,12,1,21
D Bucuresti,5806,3,4,5,5,19,20,-1,17
Universitate,5806,4,4,5,5,15,19,-4,17
FC Botosani,5806,5,3,5,6,7,16,-9,14
Concordia Ch,5806,6,3,2,9,19,24,-5,11
CFR Cluj,5807,1,7,6,1,16,7,9,27
FCSB,5807,2,7,5,2,23,12,11,26
Universitate,5807,3,4,5,5,15,20,-5,17
FC Botosani,5807,4,4,4,6,8,14,-6,16
D Bucuresti,5807,5,3,5,6,18,22,-4,14
Concordia Ch,5807,6,3,3,8,19,24,-5,12
FCSB,5808,1,8,5,1,24,11,13,29
CFR Cluj,5808,2,7,6,1,16,7,9,27
D Bucuresti,5808,3,5,4,5,22,19,3,19
Universitate,5808,4,3,5,6,14,21,-7,14
FC Botosani,5808,5,3,5,6,5,15,-10,14
Concordia Ch,5808,6,2,3,9,16,24,-8,9
FCSB,5809,1,8,5,1,26,12,14,29
CFR Cluj,5809,2,7,6,1,18,9,9,27
D Bucuresti,5809,3,4,4,6,18,22,-4,16
FC Botosani,5809,4,4,4,6,6,13,-7,16
Universitate,5809,5,3,5,6,15,23,-8,14
Concordia Ch,5809,6,3,2,9,19,23,-4,11
FCSB,5810,1,8,6,0,25,11,14,30
CFR Cluj,5810,2,6,7,1,16,7,9,25
D Bucuresti,5810,3,4,5,5,21,20,1,17
FC Botosani,5810,4,4,4,6,7,16,-9,16
Universitate,5810,5,3,5,6,15,23,-8,14
Concordia Ch,5810,6,2,3,9,18,25,-7,9
FCSB,5811,1,7,6,1,28,16,12,27
CFR Cluj,5811,2,6,6,2,17,12,5,24
Universitate,5811,3,4,6,4,20,22,-2,18
FC Botosani,5811,4,4,5,5,6,12,-6,17
D Bucuresti,5811,5,3,5,6,16,20,-4,14
Concordia Ch,5811,6,3,2,9,17,22,-5,11
FCSB,5812,1,8,6,0,25,10,15,30
CFR Cluj,5812,2,5,7,2,13,9,4,22
FC Botosani,5812,3,5,4,5,9,13,-4,19
Universitate,5812,4,3,7,4,14,18,-4,16
D Bucuresti,5812,5,3,5,6,17,21,-4,14
Concordia Ch,5812,6,2,3,9,17,24,-7,9
FCSB,5813,1,9,5,0,27,10,17,32
CFR Cluj,5813,2,6,6,2,14,10,4,24
FC Botosani,5813,3,5,4,5,7,12,-5,19
D Bucuresti,5813,4,3,5,6,18,21,-3,14
Universitate,5813,5,3,5,6,14,20,-6,14
Concordia Ch,5813,6,2,3,9,17,24,-7,9
FCSB,5814,1,8,6,0,26,12,14,30
CFR Cluj,5814,2,5,8,1,14,8,6,23
D Bucuresti,5814,3,4,4,6,17,20,-3,16
FC Botosani,5814,4,4,4,6,7,13,-6,16
Universitate,5814,5,3,6,5,15,20,-5,15
Concordia Ch,5814,6,3,2,9,17,23,-6,11
FCSB,5815,1,8,6,0,25,10,15,30
CFR Cluj,5815,2,5,6,3,14,11,3,21
Universitate,5815,3,4,6,4,16,19,-3,18
D Bucuresti,5815,4,4,4,6,17,19,-2,16
FC Botosani,5815,5,3,5,6,6,14,-8,14
Concordia Ch,5815,6,3,3,8,17,22,-5,12
FCSB,5816,1,7,7,0,26,13,13,28
CFR Cluj,5816,2,5,8,1,17,11,6,23
D Bucuresti,5816,3,4,4,6,17,19,-2,16
Universitate,5816,4,3,7,4,17,21,-4,16
FC Botosani,5816,5,3,5,6,5,13,-8,14
Concordia Ch,5816,6,3,3,8,16,21,-5,12
FCSB,5817,1,8,5,1,27,14,13,29
CFR Cluj,5817,2,6,7,1,16,8,8,25
FC Botosani,5817,3,4,5,5,8,14,-6,17
Universitate,5817,4,3,6,5,15,21,-6,15
D Bucuresti,5817,5,3,5,6,21,24,-3,14
Concordia Ch,5817,6,3,2,9,19,25,-6,11
FCSB,5818,1,7,6,1,23,12,11,27
CFR Cluj,5818,2,6,7,1,16,8,8,25
D Bucuresti,5818,3,4,5,5,18,18,0,17
Universitate,5818,4,4,5,5,17,21,-4,17
FC Botosani,5818,5,3,5,6,7,16,-9,14
Concordia Ch,5818,6,2,4,8,17,23,-6,10
FCSB,5819,1,8,5,1,25,11,14,29
CFR Cluj,5819,2,5,6,3,14,11,3,21
Universitate,5819,3,5,5,4,17,19,-2,20
D Bucuresti,5819,4,4,4,6,18,21,-3,16
FC Botosani,5819,5,3,5,6,6,14,-8,14
Concordia Ch,5819,6,3,3,8,19,23,-4,12
FCSB,5820,1,9,5,0,27,12,15,32
CFR Cluj,5820,2,5,6,3,14,10,4,21
FC Botosani,5820,3,5,4,5,10,13,-3,19
Universitate,5820,4,4,5,5,16,20,-4,17
D Bucuresti,5820,5,3,4,7,16,22,-6,13
Concordia Ch,5820,6,3,2,9,18,24,-6,11
FCSB,5821,1,8,5,1,27,14,13,29
CFR Cluj,5821,2,7,6,1,17,8,9,27
FC Botosani,5821,3,4,5,5,7,12,-5,17
D Bucuresti,5821,4,3,6,5,17,19,-2,15
Universitate,5821,5,3,5,6,15,22,-7,14
Concordia Ch,5821,6,2,3,9,16,24,-8,9
CFR Cluj,5822,1,7,6,1,20,7,13,27
FCSB,5822,2,7,6,1,25,14,11,27
D Bucuresti,5822,3,4,5,5,18,19,-1,17
Universitate,5822,4,3,6,5,16,25,-9,15
FC Botosani,5822,5,3,4,7,7,16,-9,13
Concordia Ch,5822,6,3,3,8,19,24,-5,12
FCSB,5823,1,7,5,2,24,15,9,26
CFR Cluj,5823,2,6,7,1,18,9,9,25
FC Botosani,5823,3,5,4,5,10,13,-3,19
Universitate,5823,4,4,6,4,16,19,-3,18
D Bucuresti,5823,5,4,4,6,20,21,-1,16
Concordia Ch,5823,6,2,2,10,15,26,-11,8
FCSB,5824,1,7,7,0,26,13,13,28
CFR Cluj,5824,2,6,7,1,17,9,8,25
D Bucuresti,5824,3,4,5,5,19,20,-1,17
FC Botosani,5824,4,4,5,5,10,14,-4,17
Universitate,5824,5,3,6,5,17,23,-6,15
Concordia Ch,5824,6,2,2,10,15,25,-10,8
FCSB,5825,1,8,5,1,30,14,16,29
CFR Cluj,5825,2,5,6,3,14,13,1,21
Universitate,5825,3,5,5,4,18,20,-2,20
D Bucuresti,5825,4,4,4,6,20,24,-4,16
Concordia Ch,5825,5,4,2,8,23,23,0,14
FC Botosani,5825,6,3,4,7,6,17,-11,13
FCSB,5826,1,8,6,0,26,12,14,30
CFR Cluj,5826,2,6,6,2,16,9,7,24
D Bucuresti,5826,3,4,4,6,17,21,-4,16
Universitate,5826,4,3,6,5,17,23,-6,15
FC Botosani,5826,5,3,5,6,7,15,-8,14
Concordia Ch,5826,6,3,3,8,20,23,-3,12
FCSB,5827,1,7,7,0,26,13,13,28
CFR Cluj,5827,2,6,7,1,17,8,9,25
D Bucuresti,5827,3,5,4,5,22,18,4,19
Universitate,5827,4,3,6,5,16,23,-7,15
FC Botosani,5827,5,3,4,7,5,17,-12,13
Concordia Ch,5827,6,3,2,9,17,24,-7,11
FCSB,5828,1,8,5,1,26,13,13,29
CFR Cluj,5828,2,5,7,2,15,11,4,22
Universitate,5828,3,4,6,4,17,19,-2,18
D Bucuresti,5828,4,4,4,6,20,21,-1,16
FC Botosani,5828,5,3,5,6,5,15,-10,14
Concordia Ch,5828,6,3,3,8,18,22,-4,12
FCSB,5829,1,8,6,0,27,10,17,30
CFR Cluj,5829,2,6,7,1,15,7,8,25
FC Botosani,5829,3,5,4,5,15,13,2,19
D Bucuresti,5829,4,4,4,6,19,22,-3,16
Universitate,5829,5,3,5,6,14,24,-10,14
Concordia Ch,5829,6,2,2,10,16,30,-14,8
FCSB,5830,1,8,5,1,24,11,13,29
CFR Cluj,5830,2,6,6,2,14,8,6,24
Universitate,5830,3,4,5,5,15,19,-4,17
FC Botosani,5830,4,3,6,5,6,13,-7,15
D Bucuresti,5830,5,3,5,6,17,21,-4,14
Concordia Ch,5830,6,3,3,8,17,21,-4,12
FCSB,5831,1,8,5,1,24,11,13,29
CFR Cluj,5831,2,5,7,2,13,8,5,22
Universitate,5831,3,4,6,4,15,18,-3,18
D Bucuresti,5831,4,4,4,6,18,19,-1,16
FC Botosani,5831,5,4,4,6,6,13,-7,16
Concordia Ch,5831,6,3,2,9,16,23,-7,11
FCSB,5832,1,7,6,1,24,12,12,27
CFR Cluj,5832,2,6,7,1,15,8,7,25
Universitate,5832,3,3,7,4,16,20,-4,16
FC Botosani,5832,4,3,6,5,7,14,-7,15
D Bucuresti,5832,5,3,5,6,17,20,-3,14
Concordia Ch,5832,6,3,3,8,19,24,-5,12
FCSB,5833,1,8,5,1,25,12,13,29
CFR Cluj,5833,2,5,7,2,13,9,4,22
Universitate,5833,3,4,6,4,16,18,-2,18
D Bucuresti,5833,4,4,4,6,19,22,-3,16
FC Botosani,5833,5,3,5,6,7,15,-8,14
Concordia Ch,5833,6,3,3,8,19,23,-4,12
FCSB,5834,1,9,5,0,26,11,15,32
CFR Cluj,5834,2,6,6,2,15,9,6,24
D Bucuresti,5834,3,4,4,6,17,20,-3,16
FC Botosani,5834,4,4,4,6,8,14,-6,16
Universitate,5834,5,3,5,6,14,20,-6,14
Concordia Ch,5834,6,3,2,9,18,24,-6,11
FCSB,5835,1,7,6,1,24,12,12,27
CFR Cluj,5835,2,5,8,1,17,11,6,23
Universitate,5835,3,4,6,4,18,21,-3,18
D Bucuresti,5835,4,4,5,5,19,19,0,17
FC Botosani,5835,5,4,4,6,7,14,-7,16
Concordia Ch,5835,6,2,3,9,16,24,-8,9
FCSB,5836,1,9,5,0,28,12,16,32
CFR Cluj,5836,2,6,6,2,16,10,6,24
D Bucuresti,5836,3,4,4,6,22,21,1,16
Concordia Ch,5836,4,4,2,8,20,21,-1,14
Universitate,5836,5,3,5,6,15,22,-7,14
FC Botosani,5836,6,3,4,7,6,21,-15,13
FCSB,5837,1,9,5,0,29,10,19,32
CFR Cluj,5837,2,5,7,2,13,8,5,22
D Bucuresti,5837,3,4,4,6,20,21,-1,16
Universitate,5837,4,3,6,5,14,23,-9,15
FC Botosani,5837,5,3,5,6,8,17,-9,14
Concordia Ch,5837,6,3,3,8,17,22,-5,12
FCSB,5838,1,7,6,1,25,13,12,27
CFR Cluj,5838,2,5,8,1,16,10,6,23
Universitate,5838,3,4,6,4,18,21,-3,18
D Bucuresti,5838,4,4,5,5,21,19,2,17
FC Botosani,5838,5,4,5,5,9,14,-5,17
Concordia Ch,5838,6,2,2,10,16,28,-12,8
FCSB,5839,1,9,5,0,25,10,15,32
CFR Cluj,5839,2,5,6,3,14,11,3,21
D Bucuresti,5839,3,5,4,5,20,20,0,19
Universitate,5839,4,4,5,5,17,20,-3,17
FC Botosani,5839,5,3,5,6,7,15,-8,14
Concordia Ch,5839,6,2,3,9,17,24,-7,9
FCSB,5840,1,9,5,0,27,12,15,32
CFR Cluj,5840,2,5,7,2,14,9,5,22
D Bucuresti,5840,3,5,4,5,20,20,0,19
Universitate,5840,4,3,6,5,15,20,-5,15
FC Botosani,5840,5,3,4,7,5,14,-9,13
Concordia Ch,5840,6,3,2,9,18,24,-6,11
FCSB,5841,1,8,6,0,26,11,15,30
CFR Cluj,5841,2,6,7,1,16,8,8,25
FC Botosani,5841,3,5,4,5,9,14,-5,19
D Bucuresti,5841,4,4,4,6,18,20,-2,16
Universitate,5841,5,3,5,6,14,22,-8,14
Concordia Ch,5841,6,2,2,10,16,24,-8,8
FCSB,5842,1,9,5,0,27,12,15,32
CFR Cluj,5842,2,5,6,3,14,10,4,21
D Bucuresti,5842,3,5,4,5,20,19,1,19
Universitate,5842,4,4,5,5,16,20,-4,17
FC Botosani,5842,5,3,5,6,7,15,-8,14
Concordia Ch,5842,6,2,3,9,16,24,-8,9
FCSB,5843,1,8,6,0,26,11,15,30
CFR Cluj,5843,2,6,7,1,15,8,7,25
D Bucuresti,5843,3,5,4,5,20,19,1,19
FC Botosani,5843,4,4,4,6,8,14,-6,16
Universitate,5843,5,3,5,6,14,21,-7,14
Concordia Ch,5843,6,2,2,10,16,26,-10,8
FCSB,5844,1,8,6,0,26,11,15,30
CFR Cluj,5844,2,5,7,2,14,10,4,22
D Bucuresti,5844,3,4,4,6,20,21,-1,16
Universitate,5844,4,3,7,4,14,18,-4,16
Concordia Ch,5844,5,4,2,8,21,24,-3,14
FC Botosani,5844,6,3,4,7,6,17,-11,13
CFR Cluj,5845,1,7,6,1,19,7,12,27
FCSB,5845,2,7,6,1,23,13,10,27
D Bucuresti,5845,3,4,5,5,19,18,1,17
FC Botosani,5845,4,4,5,5,7,12,-5,17
Universitate,5845,5,3,6,5,14,21,-7,15
Concordia Ch,5845,6,2,2,10,15,26,-11,8
FCSB,5846,1,8,5,1,26,12,14,29
CFR Cluj,5846,2,6,7,1,17,10,7,25
D Bucuresti,5846,3,3,6,5,18,20,-2,15
Universitate,5846,4,3,6,5,16,22,-6,15
FC Botosani,5846,5,3,6,5,6,13,-7,15
Concordia Ch,5846,6,2,4,8,18,24,-6,10
FCSB,5847,1,8,6,0,26,11,15,30
CFR Cluj,5847,2,5,7,2,14,10,4,22
D Bucuresti,5847,3,4,5,5,18,18,0,17
Universitate,5847,4,3,7,4,16,20,-4,16
FC Botosani,5847,5,3,5,6,6,15,-9,14
Concordia Ch,5847,6,2,4,8,16,22,-6,10
FCSB,5848,1,8,6,0,26,11,15,30
CFR Cluj,5848,2,6,6,2,14,9,5,24
FC Botosani,5848,3,5,4,5,10,13,-3,19
Universitate,5848,4,3,6,5,15,20,-5,15
D Bucuresti,5848,5,3,5,6,17,20,-3,14
Concordia Ch,5848,6,2,3,9,17,26,-9,9
FCSB,5849,1,8,5,1,27,14,13,29
CFR Cluj,5849,2,7,6,1,17,8,9,27
D Bucuresti,5849,3,4,5,5,17,18,-1,17
Universitate,5849,4,3,5,6,17,24,-7,14
FC Botosani,5849,5,3,4,7,5,15,-10,13
Concordia Ch,5849,6,3,3,8,17,21,-4,12
FCSB,5850,1,9,5,0,28,12,16,32
CFR Cluj,5850,2,5,7,2,15,10,5,22
FC Botosani,5850,3,4,5,5,6,12,-6,17
Universitate,5850,4,3,6,5,16,22,-6,15
D Bucuresti,5850,5,3,5,6,17,20,-3,14
Concordia Ch,5850,6,2,4,8,16,22,-6,10
FCSB,5851,1,7,6,1,24,13,11,27
CFR Cluj,5851,2,5,8,1,14,8,6,23
Universitate,5851,3,4,6,4,16,18,-2,18
FC Botosani,5851,4,4,5,5,8,13,-5,17
D Bucuresti,5851,5,3,5,6,17,20,-3,14
Concordia Ch,5851,6,3,2,9,16,23,-7,11
FCSB,5852,1,7,6,1,24,12,12,27
CFR Cluj,5852,2,5,8,1,14,8,6,23
Universitate,5852,3,4,6,4,15,18,-3,18
D Bucuresti,5852,4,3,5,6,17,20,-3,14
Concordia Ch,5852,5,4,2,8,17,21,-4,14
FC Botosani,5852,6,3,5,6,6,14,-8,14
FCSB,5853,1,8,5,1,27,15,12,29
CFR Cluj,5853,2,6,6,2,16,10,6,24
Universitate,5853,3,4,5,5,19,22,-3,17
D Bucuresti,5853,4,4,4,6,18,19,-1,16
Concordia Ch,5853,5,4,2,8,17,21,-4,14
FC Botosani,5853,6,3,4,7,5,15,-10,13
FCSB,5854,1,8,5,1,25,12,13,29
CFR Cluj,5854,2,6,6,2,15,9,6,24
FC Botosani,5854,3,5,4,5,10,15,-5,19
Universitate,5854,4,4,5,5,16,20,-4,17
D Bucuresti,5854,5,3,4,7,19,23,-4,13
Concordia Ch,5854,6,3,2,9,18,24,-6,11
FCSB,5855,1,9,5,0,27,11,16,32
CFR Cluj,5855,2,6,6,2,14,9,5,24
D Bucuresti,5855,3,3,5,6,19,22,-3,14
Concordia Ch,5855,4,4,2,8,20,24,-4,14
Universitate,5855,5,3,5,6,15,21,-6,14
FC Botosani,5855,6,3,5,6,7,15,-8,14
FCSB,5856,1,8,6,0,28,13,15,30
CFR Cluj,5856,2,6,6,2,14,9,5,24
D Bucuresti,5856,3,4,4,6,19,22,-3,16
FC Botosani,5856,4,4,4,6,9,15,-6,16
Universitate,5856,5,3,6,5,17,22,-5,15
Concordia Ch,5856,6,3,2,9,17,23,-6,11
FCSB,5857,1,7,7,0,26,13,13,28
CFR Cluj,5857,2,6,7,1,18,9,9,25
FC Botosani,5857,3,5,4,5,8,12,-4,19
Universitate,5857,4,3,6,5,15,22,-7,15
D Bucuresti,5857,5,3,4,7,17,24,-7,13
Concordia Ch,5857,6,3,2,9,20,24,-4,11
FCSB,5858,1,8,5,1,25,13,12,29
CFR Cluj,5858,2,6,7,1,16,8,8,25
D Bucuresti,5858,3,3,6,5,18,20,-2,15
Universitate,5858,4,3,6,5,14,19,-5,15
FC Botosani,5858,5,3,5,6,8,16,-8,14
Concordia Ch,5858,6,3,3,8,17,22,-5,12
FCSB,5859,1,8,6,0,28,12,16,30
CFR Cluj,5859,2,5,6,3,14,12,2,21
Universitate,5859,3,4,6,4,16,19,-3,18
FC Botosani,5859,4,4,5,5,8,14,-6,17
D Bucuresti,5859,5,3,4,7,16,20,-4,13
Concordia Ch,5859,6,3,3,8,18,23,-5,12
FCSB,5860,1,7,7,0,25,12,13,28
CFR Cluj,5860,2,6,7,1,15,8,7,25
D Bucuresti,5860,3,4,5,5,20,19,1,17
FC Botosani,5860,4,4,4,6,8,16,-8,16
Universitate,5860,5,3,6,5,15,20,-5,15
Concordia Ch,5860,6,2,3,9,17,25,-8,9
FCSB,5861,1,9,5,0,27,11,16,32
CFR Cluj,5861,2,6,6,2,14,9,5,24
FC Botosani,5861,3,5,4,5,8,13,-5,19
D Bucuresti,5861,4,3,5,6,17,20,-3,14
Universitate,5861,5,3,5,6,15,21,-6,14
Concordia Ch,5861,6,2,3,9,17,24,-7,9
FCSB,5862,1,8,5,1,26,11,15,29
CFR Cluj,5862,2,5,7,2,13,10,3,22
Universitate,5862,3,4,6,4,15,18,-3,18
D Bucuresti,5862,4,4,4,6,19,22,-3,16
FC Botosani,5862,5,4,4,6,10,17,-7,16
Concordia Ch,5862,6,3,2,9,21,26,-5,11
FCSB,5863,1,7,7,0,25,12,13,28
CFR Cluj,5863,2,6,7,1,15,8,7,25
D Bucuresti,5863,3,4,5,5,22,20,2,17
Universitate,5863,4,3,6,5,15,20,-5,15
FC Botosani,5863,5,3,5,6,7,18,-11,14
Concordia Ch,5863,6,2,4,8,17,23,-6,10
FCSB,5864,1,8,6,0,26,11,15,30
CFR Cluj,5864,2,6,7,1,17,8,9,25
D Bucuresti,5864,3,5,4,5,19,18,1,19
Universitate,5864,4,3,5,6,14,23,-9,14
FC Botosani,5864,5,3,4,7,6,15,-9,13
Concordia Ch,5864,6,3,2,9,17,24,-7,11
FCSB,5865,1,7,6,1,26,14,12,27
CFR Cluj,5865,2,5,7,2,15,10,5,22
Universitate,5865,3,5,5,4,17,19,-2,20
D Bucuresti,5865,4,4,4,6,18,19,-1,16
FC Botosani,5865,5,3,5,6,5,14,-9,14
Concordia Ch,5865,6,3,3,8,16,21,-5,12
FCSB,5866,1,7,6,1,23,11,12,27
CFR Cluj,5866,2,6,7,1,14,7,7,25
Universitate,5866,3,4,5,5,15,19,-4,17
D Bucuresti,5866,4,4,4,6,17,19,-2,16
FC Botosani,5866,5,4,4,6,7,13,-6,16
Concordia Ch,5866,6,3,2,9,16,23,-7,11
FCSB,5867,1,8,5,1,26,12,14,29
CFR Cluj,5867,2,5,7,2,13,9,4,22
Universitate,5867,3,4,6,4,16,19,-3,18
D Bucuresti,5867,4,4,5,5,18,19,-1,17
FC Botosani,5867,5,4,4,6,6,13,-7,16
Concordia Ch,5867,6,2,3,9,16,23,-7,9
CFR Cluj,5868,1,7,6,1,16,8,8,27
FCSB,5868,2,7,5,2,27,16,11,26
Universitate,5868,3,4,5,5,18,22,-4,17
D Bucuresti,5868,4,4,4,6,19,21,-2,16
Concordia Ch,5868,5,4,2,8,19,22,-3,14
FC Botosani,5868,6,3,4,7,5,15,-10,13
FCSB,5869,1,8,5,1,26,13,13,29
CFR Cluj,5869,2,5,7,2,15,12,3,22
Universitate,5869,3,4,6,4,19,20,-1,18
FC Botosani,5869,4,4,5,5,8,12,-4,17
D Bucuresti,5869,5,3,6,5,16,18,-2,15
Concordia Ch,5869,6,2,3,9,15,24,-9,9
FCSB,5870,1,7,7,0,24,11,13,28
CFR Cluj,5870,2,6,7,1,15,7,8,25
D Bucuresti,5870,3,4,5,5,18,19,-1,17
FC Botosani,5870,4,4,5,5,7,13,-6,17
Universitate,5870,5,3,6,5,15,21,-6,15
Concordia Ch,5870,6,2,2,10,17,25,-8,8
CFR Cluj,5871,1,7,6,1,19,9,10,27
FCSB,5871,2,7,5,2,26,15,11,26
Universitate,5871,3,4,5,5,16,22,-6,17
FC Botosani,5871,4,4,5,5,7,13,-6,17
D Bucuresti,5871,5,3,5,6,17,20,-3,14
Concordia Ch,5871,6,3,2,9,16,22,-6,11
CFR Cluj,5872,1,7,6,1,17,9,8,27
FCSB,5872,2,7,5,2,26,15,11,26
Universitate,5872,3,4,5,5,18,22,-4,17
FC Botosani,5872,4,3,6,5,7,14,-7,15
D Bucuresti,5872,5,3,5,6,17,21,-4,14
Concordia Ch,5872,6,3,3,8,18,22,-4,12
FCSB,5873,1,7,7,0,26,13,13,28
CFR Cluj,5873,2,5,7,2,15,10,5,22
Universitate,5873,3,4,6,4,16,19,-3,18
D Bucuresti,5873,4,4,5,5,20,21,-1,17
FC Botosani,5873,5,4,4,6,8,15,-7,16
Concordia Ch,5873,6,2,3,9,18,25,-7,9
FCSB,5874,1,7,6,1,24,13,11,27
CFR Cluj,5874,2,5,7,2,14,10,4,22
Universitate,5874,3,5,5,4,20,20,0,20
Concordia Ch,5874,4,4,2,8,20,21,-1,14
D Bucuresti,5874,5,3,5,6,17,21,-4,14
FC Botosani,5874,6,3,5,6,6,16,-10,14
FCSB,5875,1,8,6,0,30,11,19,30
CFR Cluj,5875,2,6,6,2,16,13,3,24
FC Botosani,5875,3,4,5,5,8,13,-5,17
Universitate,5875,4,3,6,5,15,22,-7,15
D Bucuresti,5875,5,3,4,7,16,23,-7,13
Concordia Ch,5875,6,3,3,8,19,22,-3,12
FCSB,5876,1,8,5,1,24,13,11,29
CFR Cluj,5876,2,6,6,2,16,9,7,24
Universitate,5876,3,4,5,5,18,21,-3,17
FC Botosani,5876,4,4,5,5,9,15,-6,17
D Bucuresti,5876,5,3,6,5,19,21,-2,15
Concordia Ch,5876,6,2,3,9,17,24,-7,9
CFR Cluj,5877,1,7,6,1,17,9,8,27
FCSB,5877,2,7,5,2,24,16,8,26
Universitate,5877,3,4,5,5,19,20,-1,17
D Bucuresti,5877,4,4,4,6,18,20,-2,16
FC Botosani,5877,5,4,4,6,7,13,-6,16
Concordia Ch,5877,6,3,2,9,16,23,-7,11
FCSB,5878,1,8,6,0,24,10,14,30
CFR Cluj,5878,2,5,8,1,14,8,6,23
D Bucuresti,5878,3,5,4,5,22,20,2,19
FC Botosani,5878,4,4,4,6,7,15,-8,16
Universitate,5878,5,3,6,5,15,20,-5,15
Concordia Ch,5878,6,2,2,10,16,25,-9,8
CFR Cluj,5879,1,7,6,1,16,7,9,27
FCSB,5879,2,7,5,2,23,16,7,26
Universitate,5879,3,4,5,5,18,19,-1,17
D Bucuresti,5879,4,4,4,6,18,21,-3,16
FC Botosani,5879,5,4,4,6,6,13,-7,16
Concordia Ch,5879,6,3,2,9,18,23,-5,11
FCSB,5880,1,7,5,2,24,13,11,26
CFR Cluj,5880,2,6,6,2,15,10,5,24
Universitate,5880,3,5,5,4,17,18,-1,20
D Bucuresti,5880,4,4,4,6,20,23,-3,16
FC Botosani,5880,5,4,4,6,8,16,-8,16
Concordia Ch,5880,6,3,2,9,19,23,-4,11
FCSB,5881,1,7,6,1,27,15,12,27
CFR Cluj,5881,2,7,6,1,18,9,9,27
FC Botosani,5881,3,5,4,5,9,14,-5,19
Universitate,5881,4,3,6,5,16,22,-6,15
D Bucuresti,5881,5,3,4,7,17,21,-4,13
Concordia Ch,5881,6,3,2,9,17,23,-6,11
FCSB,5882,1,8,5,1,30,16,14,29
CFR Cluj,5882,2,6,6,2,16,11,5,24
Universitate,5882,3,4,5,5,18,22,-4,17
FC Botosani,5882,4,4,5,5,7,13,-6,17
D Bucuresti,5882,5,3,5,6,18,21,-3,14
Concordia Ch,5882,6,3,2,9,17,23,-6,11
FCSB,5883,1,9,5,0,26,11,15,32
CFR Cluj,5883,2,5,6,3,14,10,4,21
Universitate,5883,3,4,5,5,15,19,-4,17
D Bucuresti,5883,4,4,4,6,19,21,-2,16
Concordia Ch,5883,5,4,2,8,20,23,-3,14
FC Botosani,5883,6,3,4,7,5,15,-10,13
FCSB,5884,1,8,5,1,27,14,13,29
CFR Cluj,5884,2,6,6,2,15,10,5,24
Universitate,5884,3,4,5,5,18,21,-3,17
D Bucuresti,5884,4,4,4,6,20,21,-1,16
FC Botosani,5884,5,4,4,6,8,15,-7,16
Concordia Ch,5884,6,3,2,9,18,25,-7,11
FCSB,5885,1,9,5,0,26,11,15,32
CFR Cluj,5885,2,5,7,2,16,11,5,22
D Bucuresti,5885,3,4,4,6,21,21,0,16
Universitate,5885,4,3,6,5,16,21,-5,15
FC Botosani,5885,5,3,5,6,8,18,-10,14
Concordia Ch,5885,6,3,3,8,19,24,-5,12
CFR Cluj,5886,1,7,6,1,16,7,9,27
FCSB,5886,2,7,5,2,23,13,10,26
FC Botosani,5886,3,5,4,5,8,13,-5,19
Universitate,5886,4,4,5,5,16,20,-4,17
D Bucuresti,5886,5,3,5,6,17,20,-3,14
Concordia Ch,5886,6,2,3,9,15,22,-7,9
FCSB,5887,1,8,5,1,25,13,12,29
CFR Cluj,5887,2,5,7,2,15,10,5,22
Universitate,5887,3,4,6,4,17,19,-2,18
D Bucuresti,5887,4,4,5,5,20,18,2,17
FC Botosani,5887,5,3,5,6,5,16,-11,14
Concordia Ch,5887,6,2,4,8,15,21,-6,10
FCSB,5888,1,9,5,0,27,11,16,32
CFR Cluj,5888,2,6,6,2,16,10,6,24
FC Botosani,5888,3,3,6,5,6,13,-7,15
D Bucuresti,5888,4,3,5,6,16,19,-3,14
Universitate,5888,5,3,5,6,14,21,-7,14
Concordia Ch,5888,6,3,3,8,17,22,-5,12
FCSB,5889,1,8,6,0,25,11,14,30
CFR Cluj,5889,2,5,7,2,15,10,5,22
D Bucuresti,5889,3,4,5,5,18,19,-1,17
Universitate,5889,4,3,7,4,15,19,-4,16
FC Botosani,5889,5,4,4,6,7,14,-7,16
Concordia Ch,5889,6,2,3,9,17,24,-7,9
FCSB,5890,1,8,5,1,24,12,12,29
CFR Cluj,5890,2,7,6,1,17,7,10,27
D Bucuresti,5890,3,4,4,6,21,19,2,16
Concordia Ch,5890,4,4,2,8,18,21,-3,14
Universitate,5890,5,3,5,6,14,21,-7,14
FC Botosani,5890,6,3,4,7,5,19,-14,13
FCSB,5891,1,9,5,0,28,11,17,32
CFR Cluj,5891,2,6,6,2,15,9,6,24
D Bucuresti,5891,3,4,4,6,20,23,-3,16
FC Botosani,5891,4,4,4,6,7,14,-7,16
Universitate,5891,5,3,5,6,15,23,-8,14
Concordia Ch,5891,6,3,2,9,21,26,-5,11
FCSB,5892,1,8,5,1,26,13,13,29
CFR Cluj,5892,2,7,6,1,18,9,9,27
FC Botosani,5892,3,4,5,5,9,15,-6,17
D Bucuresti,5892,4,4,4,6,19,21,-2,16
Universitate,5892,5,3,5,6,16,23,-7,14
Concordia Ch,5892,6,2,3,9,18,25,-7,9
FCSB,5893,1,8,5,1,30,15,15,29
CFR Cluj,5893,2,7,6,1,18,10,8,27
FC Botosani,5893,3,5,4,5,8,12,-4,19
Universitate,5893,4,3,5,6,17,25,-8,14
D Bucuresti,5893,5,3,4,7,17,21,-4,13
Concordia Ch,5893,6,3,2,9,17,24,-7,11
FCSB,5894,1,8,5,1,27,15,12,29
CFR Cluj,5894,2,6,6,2,17,11,6,24
Universitate,5894,3,4,5,5,18,21,-3,17
D Bucuresti,5894,4,4,4,6,19,21,-2,16
FC Botosani,5894,5,4,4,6,8,14,-6,16
Concordia Ch,5894,6,3,2,9,17,24,-7,11
FCSB,5895,1,8,5,1,24,11,13,29
CFR Cluj,5895,2,5,7,2,14,9,5,22
Universitate,5895,3,4,6,4,16,19,-3,18
D Bucuresti,5895,4,4,5,5,19,19,0,17
FC Botosani,5895,5,3,5,6,5,14,-9,14
Concordia Ch,5895,6,2,4,8,16,22,-6,10
FCSB,5896,1,8,5,1,26,11,15,29
CFR Cluj,5896,2,6,6,2,14,8,6,24
D Bucuresti,5896,3,4,5,5,23,20,3,17
Universitate,5896,4,4,5,5,15,21,-6,17
FC Botosani,5896,5,4,4,6,7,17,-10,16
Concordia Ch,5896,6,2,3,9,17,25,-8,9
FCSB,5897,1,7,7,0,26,13,13,28
CFR Cluj,5897,2,5,8,1,13,7,6,23
FC Botosani,5897,3,4,5,5,7,13,-6,17
Universitate,5897,4,3,7,4,17,21,-4,16
D Bucuresti,5897,5,3,5,6,17,21,-4,14
Concordia Ch,5897,6,3,2,9,19,24,-5,11
FCSB,5898,1,8,6,0,28,13,15,30
CFR Cluj,5898,2,5,6,3,14,11,3,21
D Bucuresti,5898,3,5,4,5,21,19,2,19
Universitate,5898,4,4,6,4,17,20,-3,18
FC Botosani,5898,5,3,5,6,5,15,-10,14
Concordia Ch,5898,6,2,3,9,16,23,-7,9
FCSB,5899,1,7,6,1,26,15,11,27
CFR Cluj,5899,2,7,6,1,17,8,9,27
D Bucuresti,5899,3,5,4,5,20,20,0,19
FC Botosani,5899,4,4,4,6,6,13,-7,16
Universitate,5899,5,3,6,5,16,21,-5,15
Concordia Ch,5899,6,2,2,10,17,25,-8,8
FCSB,5900,1,9,5,0,28,10,18,32
CFR Cluj,5900,2,6,6,2,14,11,3,24
Concordia Ch,5900,3,4,2,8,19,22,-3,14
D Bucuresti,5900,3,3,5,6,19,22,-3,14
Universitate,5900,5,3,5,6,14,20,-6,14
FC Botosani,5900,6,3,5,6,7,16,-9,14
CFR Cluj,5901,1,7,6,1,19,8,11,27
FCSB,5901,2,7,5,2,25,15,10,26
D Bucuresti,5901,3,5,4,5,22,20,2,19
Universitate,5901,4,4,5,5,16,22,-6,17
FC Botosani,5901,5,3,5,6,8,17,-9,14
Concordia Ch,5901,6,2,3,9,18,26,-8,9
FCSB,5902,1,8,5,1,25,16,9,29
CFR Cluj,5902,2,6,6,2,15,9,6,24
Universitate,5902,3,4,5,5,19,19,0,17
D Bucuresti,5902,4,4,5,5,18,19,-1,17
FC Botosani,5902,5,4,4,6,6,13,-7,16
Concordia Ch,5902,6,2,3,9,16,23,-7,9
FCSB,5903,1,8,5,1,25,12,13,29
CFR Cluj,5903,2,7,6,1,16,7,9,27
FC Botosani,5903,3,4,5,5,8,14,-6,17
D Bucuresti,5903,4,3,6,5,17,19,-2,15
Universitate,5903,5,3,5,6,15,22,-7,14
Concordia Ch,5903,6,2,3,9,16,23,-7,9
FCSB,5904,1,9,5,0,29,13,16,32
CFR Cluj,5904,2,6,6,2,16,10,6,24
FC Botosani,5904,3,3,6,5,8,15,-7,15
Universitate,5904,4,3,5,6,18,25,-7,14
D Bucuresti,5904,5,3,5,6,17,25,-8,14
Concordia Ch,5904,6,3,3,8,23,23,0,12
FCSB,5905,1,9,5,0,30,13,17,32
CFR Cluj,5905,2,5,7,2,14,9,5,22
D Bucuresti,5905,3,4,5,5,18,19,-1,17
Universitate,5905,4,3,6,5,16,23,-7,15
FC Botosani,5905,5,3,6,5,7,14,-7,15
Concordia Ch,5905,6,2,3,9,16,23,-7,9
FCSB,5906,1,7,6,1,25,15,10,27
CFR Cluj,5906,2,6,7,1,17,10,7,25
D Bucuresti,5906,3,4,5,5,19,20,-1,17
Universitate,5906,4,4,5,5,18,20,-2,17
FC Botosani,5906,5,3,5,6,5,13,-8,14
Concordia Ch,5906,6,2,4,8,17,23,-6,10
FCSB,5907,1,8,5,1,25,13,12,29
CFR Cluj,5907,2,6,6,2,18,10,8,24
D Bucuresti,5907,3,4,5,5,20,19,1,17
Universitate,5907,4,4,5,5,17,22,-5,17
FC Botosani,5907,5,3,6,5,8,15,-7,15
Concordia Ch,5907,6,2,3,9,17,26,-9,9
FCSB,5908,1,7,7,0,23,10,13,28
CFR Cluj,5908,2,6,7,1,14,7,7,25
D Bucuresti,5908,3,4,4,6,18,21,-3,16
FC Botosani,5908,4,4,4,6,7,14,-7,16
Universitate,5908,5,3,6,5,14,19,-5,15
Concordia Ch,5908,6,3,2,9,17,22,-5,11
FCSB,5909,1,8,5,1,24,11,13,29
CFR Cluj,5909,2,7,6,1,16,7,9,27
FC Botosani,5909,3,4,5,5,8,13,-5,17
D Bucuresti,5909,4,3,5,6,18,21,-3,14
Universitate,5909,5,3,5,6,14,21,-7,14
Concordia Ch,5909,6,3,2,9,17,24,-7,11
FCSB,5910,1,9,5,0,28,11,17,32
CFR Cluj,5910,2,6,6,2,16,11,5,24
D Bucuresti,5910,3,4,4,6,18,21,-3,16
FC Botosani,5910,4,4,4,6,7,13,-6,16
Universitate,5910,5,3,5,6,15,22,-7,14
Concordia Ch,5910,6,3,2,9,18,24,-6,11
FCSB,5911,1,8,6,0,24,10,14,30
CFR Cluj,5911,2,6,6,2,14,8,6,24
D Bucuresti,5911,3,4,5,5,21,20,1,17
Universitate,5911,4,3,6,5,14,19,-5,15
FC Botosani,5911,5,3,5,6,6,16,-10,14
Concordia Ch,5911,6,2,4,8,18,24,-6,10
FCSB,5912,1,7,7,0,25,12,13,28
CFR Cluj,5912,2,5,8,1,15,9,6,23
Universitate,5912,3,3,7,4,16,20,-4,16
D Bucuresti,5912,4,4,4,6,17,22,-5,16
FC Botosani,5912,5,3,5,6,6,14,-8,14
Concordia Ch,5912,6,3,3,8,20,22,-2,12
FCSB,5913,1,8,5,1,26,13,13,29
CFR Cluj,5913,2,6,6,2,17,10,7,24
Universitate,5913,3,4,5,5,18,23,-5,17
D Bucuresti,5913,4,4,4,6,17,20,-3,16
FC Botosani,5913,5,4,4,6,8,14,-6,16
Concordia Ch,5913,6,3,2,9,18,24,-6,11
FCSB,5914,1,7,7,0,26,13,13,28
CFR Cluj,5914,2,6,7,1,16,9,7,25
D Bucuresti,5914,3,4,5,5,20,20,0,17
FC Botosani,5914,4,4,4,6,8,15,-7,16
Universitate,5914,5,3,6,5,15,20,-5,15
Concordia Ch,5914,6,2,3,9,18,26,-8,9
FCSB,5915,1,8,6,0,28,12,16,30
CFR Cluj,5915,2,6,6,2,17,12,5,24
FC Botosani,5915,3,4,5,5,6,12,-6,17
Universitate,5915,4,3,6,5,16,22,-6,15
D Bucuresti,5915,5,3,5,6,17,20,-3,14
Concordia Ch,5915,6,2,4,8,16,22,-6,10
FCSB,5916,1,8,5,1,25,11,14,29
CFR Cluj,5916,2,7,6,1,15,7,8,27
D Bucuresti,5916,3,5,4,5,21,18,3,19
FC Botosani,5916,4,4,4,6,7,16,-9,16
Universitate,5916,5,3,5,6,14,21,-7,14
Concordia Ch,5916,6,2,2,10,16,25,-9,8
FCSB,5917,1,9,5,0,27,11,16,32
CFR Cluj,5917,2,5,7,2,14,10,4,22
FC Botosani,5917,3,4,5,5,8,13,-5,17
Universitate,5917,4,3,6,5,16,21,-5,15
D Bucuresti,5917,5,3,5,6,17,23,-6,14
Concordia Ch,5917,6,3,2,9,21,25,-4,11
FCSB,5918,1,9,5,0,28,11,17,32
CFR Cluj,5918,2,5,7,2,14,11,3,22
D Bucuresti,5918,3,5,4,5,20,20,0,19
FC Botosani,5918,4,4,4,6,9,14,-5,16
Universitate,5918,5,3,6,5,14,19,-5,15
Concordia Ch,5918,6,2,2,10,16,26,-10,8
FCSB,5919,1,7,6,1,24,15,9,27
CFR Cluj,5919,2,6,7,1,15,8,7,25
D Bucuresti,5919,3,4,5,5,19,19,0,17
Universitate,5919,4,4,5,5,18,19,-1,17
FC Botosani,5919,5,3,5,6,7,16,-9,14
Concordia Ch,5919,6,2,4,8,18,24,-6,10
FCSB,5920,1,8,5,1,26,13,13,29
CFR Cluj,5920,2,5,7,2,14,9,5,22
Universitate,5920,3,4,6,4,18,21,-3,18
D Bucuresti,5920,4,4,5,5,18,19,-1,17
FC Botosani,5920,5,4,4,6,7,13,-6,16
Concordia Ch,5920,6,2,3,9,16,24,-8,9
FCSB,5921,1,8,5,1,26,13,13,29
CFR Cluj,5921,2,7,6,1,18,8,10,27
D Bucuresti,5921,3,5,4,5,19,19,0,19
Universitate,5921,4,3,5,6,15,23,-8,14
FC Botosani,5921,5,3,4,7,5,15,-10,13
Concordia Ch,5921,6,3,2,9,18,23,-5,11
FCSB,5922,1,8,5,1,27,13,14,29
CFR Cluj,5922,2,6,6,2,15,10,5,24
Universitate,5922,3,4,5,5,16,20,-4,17
D Bucuresti,5922,4,4,4,6,18,21,-3,16
FC Botosani,5922,5,4,4,6,8,13,-5,16
Concordia Ch,5922,6,3,2,9,18,25,-7,11
FCSB,5923,1,8,6,0,25,11,14,30
CFR Cluj,5923,2,6,6,2,15,8,7,24
D Bucuresti,5923,3,4,4,6,18,19,-1,16
FC Botosani,5923,4,4,4,6,6,14,-8,16
Universitate,5923,5,3,6,5,15,21,-6,15
Concordia Ch,5923,6,3,2,9,16,22,-6,11
FCSB,5924,1,8,5,1,25,13,12,29
CFR Cluj,5924,2,6,6,2,17,9,8,24
FC Botosani,5924,3,5,4,5,10,12,-2,19
Universitate,5924,4,4,5,5,16,21,-5,17
D Bucuresti,5924,5,3,5,6,18,22,-4,14
Concordia Ch,5924,6,2,3,9,17,26,-9,9
FCSB,5925,1,8,5,1,25,12,13,29
CFR Cluj,5925,2,5,6,3,14,11,3,21
Universitate,5925,3,5,5,4,17,18,-1,20
FC Botosani,5925,4,4,5,5,8,13,-5,17
D Bucuresti,5925,5,3,4,7,19,25,-6,13
Concordia Ch,5925,6,3,3,8,19,23,-4,12
FCSB,5926,1,9,5,0,28,11,17,32
CFR Cluj,5926,2,5,7,2,14,9,5,22
FC Botosani,5926,3,4,5,5,8,14,-6,17
Universitate,5926,4,3,6,5,16,23,-7,15
D Bucuresti,5926,5,3,4,7,17,22,-5,13
Concordia Ch,5926,6,3,3,8,20,24,-4,12
FCSB,5927,1,8,6,0,25,11,14,30
CFR Cluj,5927,2,5,7,2,14,9,5,22
Universitate,5927,3,3,7,4,16,20,-4,16
FC Botosani,5927,4,4,4,6,7,15,-8,16
D Bucuresti,5927,5,3,5,6,17,21,-4,14
Concordia Ch,5927,6,3,3,8,19,22,-3,12
FCSB,5928,1,8,6,0,26,12,14,30
CFR Cluj,5928,2,5,7,2,15,10,5,22
D Bucuresti,5928,3,4,5,5,21,21,0,17
Universitate,5928,4,3,7,4,16,20,-4,16
FC Botosani,5928,5,4,4,6,7,15,-8,16
Concordia Ch,5928,6,2,3,9,17,24,-7,9
FCSB,5929,1,9,5,0,26,11,15,32
CFR Cluj,5929,2,6,6,2,15,9,6,24
D Bucuresti,5929,3,3,6,5,19,21,-2,15
Universitate,5929,4,3,5,6,16,22,-6,14
FC Botosani,5929,5,3,5,6,7,16,-9,14
Concordia Ch,5929,6,3,3,8,20,24,-4,12
FCSB,5930,1,7,6,1,25,13,12,27
CFR Cluj,5930,2,6,7,1,15,8,7,25
D Bucuresti,5930,3,5,4,5,21,21,0,19
Universitate,5930,4,3,7,4,15,19,-4,16
FC Botosani,5930,5,3,4,7,6,15,-9,13
Concordia Ch,5930,6,3,2,9,18,24,-6,11
CFR Cluj,5931,1,7,6,1,16,8,8,27
FCSB,5931,2,7,5,2,25,14,11,26
Universitate,5931,3,4,5,5,16,20,-4,17
FC Botosani,5931,4,4,5,5,9,15,-6,17
D Bucuresti,5931,5,3,5,6,18,21,-3,14
Concordia Ch,5931,6,2,4,8,18,24,-6,10
FCSB,5932,1,8,6,0,26,11,15,30
CFR Cluj,5932,2,5,6,3,14,11,3,21
Universitate,5932,3,4,6,4,17,20,-3,18
D Bucuresti,5932,4,4,4,6,17,20,-3,16
Concordia Ch,5932,5,4,2,8,19,22,-3,14
FC Botosani,5932,6,3,4,7,6,15,-9,13
FCSB,5933,1,9,5,0,26,10,16,32
CFR Cluj,5933,2,6,6,2,14,8,6,24
D Bucuresti,5933,3,4,4,6,19,19,0,16
Concordia Ch,5933,4,4,2,8,19,23,-4,14
Universitate,5933,5,3,5,6,14,21,-7,14
FC Botosani,5933,6,3,4,7,7,18,-11,13
FCSB,5934,1,9,5,0,29,10,19,32
CFR Cluj,5934,2,6,6,2,15,11,4,24
D Bucuresti,5934,3,4,5,5,19,20,-1,17
Universitate,5934,4,3,5,6,14,22,-8,14
FC Botosani,5934,5,3,5,6,6,14,-8,14
Concordia Ch,5934,6,2,4,8,16,22,-6,10
FCSB,5935,1,7,6,1,24,12,12,27
CFR Cluj,5935,2,7,6,1,16,7,9,27
D Bucuresti,5935,3,4,5,5,18,18,0,17
FC Botosani,5935,4,4,5,5,8,12,-4,17
Universitate,5935,5,3,6,5,15,21,-6,15
Concordia Ch,5935,6,2,2,10,15,26,-11,8
FCSB,5936,1,9,5,0,28,12,16,32
CFR Cluj,5936,2,5,6,3,15,12,3,21
Universitate,5936,3,4,5,5,17,21,-4,17
D Bucuresti,5936,4,4,4,6,17,20,-3,16
FC Botosani,5936,5,4,4,6,6,13,-7,16
Concordia Ch,5936,6,3,2,9,17,22,-5,11
FCSB,5937,1,8,5,1,27,15,12,29
CFR Cluj,5937,2,5,7,2,15,11,4,22
Universitate,5937,3,4,6,4,19,20,-1,18
D Bucuresti,5937,4,3,6,5,18,20,-2,15
FC Botosani,5937,5,3,5,6,7,15,-8,14
Concordia Ch,5937,6,3,3,8,18,23,-5,12
FCSB,5938,1,8,5,1,25,12,13,29
CFR Cluj,5938,2,6,6,2,16,9,7,24
D Bucuresti,5938,3,5,4,5,20,19,1,19
Universitate,5938,4,4,5,5,15,20,-5,17
FC Botosani,5938,5,3,4,7,6,16,-10,13
Concordia Ch,5938,6,3,2,9,16,22,-6,11
FCSB,5939,1,8,5,1,25,14,11,29
CFR Cluj,5939,2,6,6,2,15,9,6,24
D Bucuresti,5939,3,5,4,5,20,20,0,19
Universitate,5939,4,4,5,5,19,21,-2,17
FC Botosani,5939,5,4,4,6,9,14,-5,16
Concordia Ch,5939,6,2,2,10,16,26,-10,8
FCSB,5940,1,8,5,1,25,12,13,29
CFR Cluj,5940,2,7,6,1,16,8,8,27
D Bucuresti,5940,3,4,5,5,17,18,-1,17
Universitate,5940,4,3,5,6,16,22,-6,14
FC Botosani,5940,5,3,4,7,5,15,-10,13
Concordia Ch,5940,6,3,3,8,17,21,-4,12
FCSB,5941,1,8,5,1,25,12,13,29
CFR Cluj,5941,2,5,6,3,13,9,4,21
Universitate,5941,3,5,5,4,17,19,-2,20
D Bucuresti,5941,4,4,4,6,18,20,-2,16
FC Botosani,5941,5,4,4,6,7,14,-7,16
Concordia Ch,5941,6,3,2,9,16,22,-6,11
FCSB,5942,1,8,6,0,25,11,14,30
CFR Cluj,5942,2,5,7,2,14,9,5,22
FC Botosani,5942,3,5,4,5,8,13,-5,19
Universitate,5942,4,4,5,5,17,21,-4,17
D Bucuresti,5942,5,3,5,6,17,20,-3,14
Concordia Ch,5942,6,2,3,9,15,22,-7,9
FCSB,5943,1,8,5,1,27,12,15,29
CFR Cluj,5943,2,7,6,1,17,8,9,27
D Bucuresti,5943,3,4,4,6,18,24,-6,16
Concordia Ch,5943,4,4,2,8,23,22,1,14
Universitate,5943,5,3,5,6,14,23,-9,14
FC Botosani,5943,6,3,4,7,5,15,-10,13
FCSB,5944,1,7,5,2,23,12,11,26
CFR Cluj,5944,2,6,7,1,16,9,7,25
FC Botosani,5944,3,5,4,5,10,14,-4,19
Universitate,5944,4,4,6,4,17,20,-3,18
D Bucuresti,5944,5,3,4,7,17,21,-4,13
Concordia Ch,5944,6,3,2,9,17,24,-7,11
CFR Cluj,5945,1,7,6,1,17,7,10,27
FCSB,5945,2,7,5,2,24,14,10,26
D Bucuresti,5945,3,4,5,5,19,19,0,17
Universitate,5945,4,4,5,5,16,21,-5,17
FC Botosani,5945,5,3,4,7,6,16,-10,13
Concordia Ch,5945,6,3,3,8,16,21,-5,12
FCSB,5946,1,8,6,0,26,11,15,30
CFR Cluj,5946,2,6,7,1,16,9,7,25
FC Botosani,5946,3,4,4,6,8,14,-6,16
D Bucuresti,5946,4,3,5,6,19,24,-5,14
Universitate,5946,5,3,5,6,15,22,-7,14
Concordia Ch,5946,6,3,3,8,20,24,-4,12
FCSB,5947,1,7,6,1,23,12,11,27
CFR Cluj,5947,2,6,7,1,14,7,7,25
D Bucuresti,5947,3,5,4,5,19,19,0,19
Universitate,5947,4,4,5,5,16,19,-3,17
FC Botosani,5947,5,4,4,6,8,15,-7,16
Concordia Ch,5947,6,2,2,10,18,26,-8,8
FCSB,5948,1,8,5,1,28,13,15,29
CFR Cluj,5948,2,7,6,1,16,7,9,27
D Bucuresti,5948,3,4,4,6,18,20,-2,16
Concordia Ch,5948,4,4,2,8,18,21,-3,14
Universitate,5948,5,3,5,6,15,24,-9,14
FC Botosani,5948,6,3,4,7,5,15,-10,13
FCSB,5949,1,7,6,1,23,11,12,27
CFR Cluj,5949,2,7,6,1,16,7,9,27
FC Botosani,5949,3,5,4,5,8,13,-5,19
Universitate,5949,4,3,6,5,14,20,-6,15
D Bucuresti,5949,5,3,4,7,18,22,-4,13
Concordia Ch,5949,6,3,2,9,17,23,-6,11
FCSB,5950,1,8,6,0,26,11,15,30
CFR Cluj,5950,2,6,6,2,14,9,5,24
FC Botosani,5950,3,4,5,5,7,13,-6,17
Universitate,5950,4,3,6,5,15,20,-5,15
D Bucuresti,5950,5,3,5,6,17,20,-3,14
Concordia Ch,5950,6,3,2,9,18,24,-6,11
FCSB,5951,1,8,6,0,27,12,15,30
CFR Cluj,5951,2,5,7,2,14,10,4,22
D Bucuresti,5951,3,4,4,6,18,19,-1,16
Universitate,5951,4,3,7,4,15,19,-4,16
Concordia Ch,5951,5,4,2,8,18,22,-4,14
FC Botosani,5951,6,3,4,7,6,16,-10,13
FCSB,5952,1,8,5,1,25,12,13,29
CFR Cluj,5952,2,6,6,2,15,9,6,24
D Bucuresti,5952,3,4,5,5,21,19,2,17
Universitate,5952,4,4,5,5,15,19,-4,17
FC Botosani,5952,5,4,4,6,6,16,-10,16
Concordia Ch,5952,6,2,3,9,16,23,-7,9
FCSB,5953,1,8,5,1,25,12,13,29
CFR Cluj,5953,2,6,6,2,15,9,6,24
Universitate,5953,3,4,5,5,15,19,-4,17
D Bucuresti,5953,4,4,4,6,19,21,-2,16
FC Botosani,5953,5,4,4,6,9,16,-7,16
Concordia Ch,5953,6,3,2,9,19,25,-6,11
FCSB,5954,1,8,5,1,24,12,12,29
CFR Cluj,5954,2,5,7,2,14,9,5,22
Universitate,5954,3,4,6,4,17,19,-2,18
D Bucuresti,5954,4,4,5,5,21,22,-1,17
FC Botosani,5954,5,4,4,6,8,15,-7,16
Concordia Ch,5954,6,2,3,9,19,26,-7,9
FCSB,5955,1,9,5,0,29,12,17,32
CFR Cluj,5955,2,5,7,2,14,10,4,22
FC Botosani,5955,3,5,4,5,8,13,-5,19
D Bucuresti,5955,4,4,4,6,21,21,0,16
Universitate,5955,5,3,6,5,17,23,-6,15
Concordia Ch,5955,6,2,2,10,16,26,-10,8
FCSB,5956,1,7,6,1,23,12,11,27
CFR Cluj,5956,2,5,7,2,13,8,5,22
Universitate,5956,3,5,5,4,17,18,-1,20
FC Botosani,5956,4,4,5,5,7,13,-6,17
D Bucuresti,5956,5,3,4,7,17,21,-4,13
Concordia Ch,5956,6,3,3,8,18,23,-5,12
FCSB,5957,1,9,5,0,26,11,15,32
CFR Cluj,5957,2,5,7,2,14,9,5,22
D Bucuresti,5957,3,5,4,5,19,18,1,19
Universitate,5957,4,3,6,5,16,21,-5,15
FC Botosani,5957,5,3,4,7,6,18,-12,13
Concordia Ch,5957,6,3,2,9,19,23,-4,11
FCSB,5958,1,8,6,0,26,11,15,30
CFR Cluj,5958,2,6,7,1,17,8,9,25
D Bucuresti,5958,3,5,4,5,19,19,0,19
FC Botosani,5958,4,3,5,6,7,15,-8,14
Universitate,5958,5,3,5,6,14,23,-9,14
Concordia Ch,5958,6,2,3,9,16,23,-7,9
FCSB,5959,1,8,6,0,27,12,15,30
CFR Cluj,5959,2,5,7,2,15,11,4,22
D Bucuresti,5959,3,5,4,5,18,18,0,19
Universitate,5959,4,3,7,4,18,22,-4,16
FC Botosani,5959,5,4,4,6,8,14,-6,16
Concordia Ch,5959,6,2,2,10,16,25,-9,8
FCSB,5960,1,9,5,0,27,11,16,32
CFR Cluj,5960,2,5,7,2,15,11,4,22
FC Botosani,5960,3,4,5,5,8,14,-6,17
D Bucuresti,5960,4,4,4,6,19,20,-1,16
Universitate,5960,5,3,6,5,15,20,-5,15
Concordia Ch,5960,6,2,3,9,16,24,-8,9
FCSB,5961,1,8,5,1,26,13,13,29
CFR Cluj,5961,2,7,6,1,19,8,11,27
FC Botosani,5961,3,4,5,5,6,12,-6,17
D Bucuresti,5961,4,3,5,6,17,20,-3,14
Universitate,5961,5,3,5,6,14,23,-9,14
Concordia Ch,5961,6,3,2,9,17,23,-6,11
CFR Cluj,5962,1,7,6,1,18,8,10,27
FCSB,5962,2,7,5,2,24,16,8,26
D Bucuresti,5962,3,4,5,5,18,19,-1,17
Universitate,5962,4,4,5,5,16,19,-3,17
FC Botosani,5962,5,4,4,6,8,14,-6,16
Concordia Ch,5962,6,2,3,9,15,23,-8,9
FCSB,5963,1,8,5,1,27,13,14,29
CFR Cluj,5963,2,5,6,3,15,13,2,21
Universitate,5963,3,5,5,4,19,20,-1,20
D Bucuresti,5963,4,4,5,5,20,21,-1,17
FC Botosani,5963,5,3,5,6,7,15,-8,14
Concordia Ch,5963,6,2,4,8,16,22,-6,10
FCSB,5964,1,8,6,0,25,11,14,30
CFR Cluj,5964,2,6,7,1,15,8,7,25
FC Botosani,5964,3,4,5,5,7,13,-6,17
D Bucuresti,5964,4,4,4,6,20,20,0,16
Universitate,5964,5,3,5,6,16,22,-6,14
Concordia Ch,5964,6,2,3,9,17,26,-9,9
FCSB,5965,1,9,5,0,26,11,15,32
CFR Cluj,5965,2,5,6,3,15,11,4,21
Universitate,5965,3,4,5,5,16,20,-4,17
D Bucuresti,5965,4,3,5,6,18,21,-3,14
Concordia Ch,5965,5,4,2,8,19,23,-4,14
FC Botosani,5965,6,3,5,6,5,13,-8,14
FCSB,5966,1,7,7,0,26,13,13,28
CFR Cluj,5966,2,6,7,1,16,9,7,25
Universitate,5966,3,3,6,5,17,22,-5,15
FC Botosani,5966,4,3,6,5,6,13,-7,15
D Bucuresti,5966,5,3,5,6,16,19,-3,14
Concordia Ch,5966,6,3,3,8,17,22,-5,12
FCSB,5967,1,7,7,0,27,14,13,28
CFR Cluj,5967,2,6,7,1,16,9,7,25
D Bucuresti,5967,3,4,5,5,19,20,-1,17
FC Botosani,5967,4,4,5,5,10,14,-4,17
Universitate,5967,5,3,6,5,18,23,-5,15
Concordia Ch,5967,6,2,2,10,17,27,-10,8
FCSB,5968,1,8,6,0,26,11,15,30
CFR Cluj,5968,2,6,6,2,16,10,6,24
FC Botosani,5968,3,4,4,6,8,15,-7,16
Universitate,5968,4,3,6,5,14,20,-6,15
Concordia Ch,5968,5,4,2,8,17,21,-4,14
D Bucuresti,5968,6,3,4,7,18,22,-4,13
CFR Cluj,5969,1,7,6,1,17,7,10,27
FCSB,5969,2,7,5,2,24,13,11,26
FC Botosani,5969,3,5,4,5,7,12,-5,19
Universitate,5969,4,4,5,5,16,22,-6,17
D Bucuresti,5969,5,3,4,7,17,21,-4,13
Concordia Ch,5969,6,3,2,9,17,23,-6,11
FCSB,5970,1,8,6,0,26,12,14,30
CFR Cluj,5970,2,6,6,2,15,9,6,24
D Bucuresti,5970,3,4,4,6,18,21,-3,16
FC Botosani,5970,4,4,4,6,7,14,-7,16
Universitate,5970,5,3,6,5,15,20,-5,15
Concordia Ch,5970,6,3,2,9,18,23,-5,11
FCSB,5971,1,9,5,0,27,11,16,32
CFR Cluj,5971,2,6,6,2,15,9,6,24
FC Botosani,5971,3,4,5,5,9,12,-3,17
D Bucuresti,5971,4,3,5,6,17,24,-7,14
Universitate,5971,5,3,5,6,14,21,-7,14
Concordia Ch,5971,6,3,2,9,21,26,-5,11
FCSB,5972,1,9,5,0,28,12,16,32
CFR Cluj,5972,2,5,6,3,15,11,4,21
D Bucuresti,5972,3,4,5,5,21,20,1,17
Universitate,5972,4,4,5,5,15,20,-5,17
FC Botosani,5972,5,3,4,7,6,17,-11,13
Concordia Ch,5972,6,3,3,8,17,22,-5,12
FCSB,5973,1,7,6,1,23,11,12,27
CFR Cluj,5973,2,6,7,1,14,7,7,25
D Bucuresti,5973,3,4,5,5,19,20,-1,17
Universitate,5973,4,4,5,5,15,19,-4,17
FC Botosani,5973,5,3,5,6,5,13,-8,14
Concordia Ch,5973,6,2,4,8,17,23,-6,10
FCSB,5974,1,9,5,0,28,11,17,32
CFR Cluj,5974,2,5,6,3,15,13,2,21
D Bucuresti,5974,3,5,4,5,20,20,0,19
Universitate,5974,4,4,5,5,16,20,-4,17
FC Botosani,5974,5,3,5,6,6,14,-8,14
Concordia Ch,5974,6,2,3,9,16,23,-7,9
FCSB,5975,1,8,6,0,24,10,14,30
CFR Cluj,5975,2,6,6,2,14,8,6,24
D Bucuresti,5975,3,4,5,5,20,20,0,17
FC Botosani,5975,4,4,5,5,9,14,-5,17
Universitate,5975,5,3,6,5,14,19,-5,15
Concordia Ch,5975,6,2,2,10,15,25,-10,8
FCSB,5976,1,8,5,1,25,13,12,29
CFR Cluj,5976,2,7,6,1,17,7,10,27
D Bucuresti,5976,3,4,5,5,22,20,2,17
FC Botosani,5976,4,4,5,5,9,14,-5,17
Universitate,5976,5,3,5,6,15,22,-7,14
Concordia Ch,5976,6,2,2,10,17,29,-12,8
FCSB,5977,1,7,6,1,25,17,8,27
CFR Cluj,5977,2,5,8,1,15,9,6,23
Universitate,5977,3,4,6,4,19,18,1,18
D Bucuresti,5977,4,4,4,6,18,19,-1,16
Concordia Ch,5977,5,4,2,8,17,21,-4,14
FC Botosani,5977,6,3,4,7,5,15,-10,13
FCSB,5978,1,9,5,0,29,12,17,32
CFR Cluj,5978,2,6,6,2,16,10,6,24
D Bucuresti,5978,3,3,6,5,16,18,-2,15
Universitate,5978,4,3,5,6,16,24,-8,14
FC Botosani,5978,5,3,5,6,7,15,-8,14
Concordia Ch,5978,6,3,3,8,18,23,-5,12
FCSB,5979,1,7,6,1,24,12,12,27
CFR Cluj,5979,2,5,8,1,14,8,6,23
Universitate,5979,3,4,6,4,17,20,-3,18
FC Botosani,5979,4,4,5,5,7,13,-6,17
D Bucuresti,5979,5,4,4,6,20,21,-1,16
Concordia Ch,5979,6,2,3,9,16,24,-8,9
FCSB,5980,1,8,5,1,24,12,12,29
CFR Cluj,5980,2,6,6,2,14,8,6,24
Universitate,5980,3,4,5,5,16,19,-3,17
FC Botosani,5980,4,4,5,5,7,13,-6,17
D Bucuresti,5980,5,4,4,6,18,19,-1,16
Concordia Ch,5980,6,2,3,9,16,24,-8,9
FCSB,5981,1,7,6,1,25,13,12,27
CFR Cluj,5981,2,6,6,2,14,8,6,24
D Bucuresti,5981,3,5,4,5,19,19,0,19
Universitate,5981,4,4,6,4,17,20,-3,18
FC Botosani,5981,5,4,4,6,7,13,-6,16
Concordia Ch,5981,6,2,2,10,16,25,-9,8
FCSB,5982,1,8,6,0,26,12,14,30
CFR Cluj,5982,2,6,6,2,16,9,7,24
D Bucuresti,5982,3,5,4,5,21,20,1,19
FC Botosani,5982,4,4,4,6,8,16,-8,16
Universitate,5982,5,3,6,5,15,21,-6,15
Concordia Ch,5982,6,2,2,10,17,25,-8,8
FCSB,5983,1,8,5,1,27,13,14,29
CFR Cluj,5983,2,7,6,1,16,7,9,27
D Bucuresti,5983,3,4,4,6,19,20,-1,16
FC Botosani,5983,4,4,4,6,7,14,-7,16
Universitate,5983,5,3,5,6,16,24,-8,14
Concordia Ch,5983,6,3,2,9,17,24,-7,11
FCSB,5984,1,7,5,2,23,12,11,26
CFR Cluj,5984,2,6,7,1,15,8,7,25
Universitate,5984,3,4,6,4,16,19,-3,18
D Bucuresti,5984,4,4,5,5,19,19,0,17
FC Botosani,5984,5,4,4,6,9,15,-6,16
Concordia Ch,5984,6,2,3,9,17,26,-9,9
FCSB,5985,1,7,6,1,23,12,11,27
CFR Cluj,5985,2,5,7,2,14,9,5,22
Universitate,5985,3,5,5,4,18,19,-1,20
D Bucuresti,5985,4,4,5,5,18,19,-1,17
FC Botosani,5985,5,3,5,6,7,15,-8,14
Concordia Ch,5985,6,3,2,9,17,23,-6,11
FCSB,5986,1,7,7,0,25,12,13,28
CFR Cluj,5986,2,6,7,1,17,8,9,25
D Bucuresti,5986,3,5,4,5,24,20,4,19
FC Botosani,5986,4,4,4,6,7,17,-10,16
Universitate,5986,5,3,6,5,15,22,-7,15
Concordia Ch,5986,6,2,2,10,16,25,-9,8
FCSB,5987,1,8,6,0,26,12,14,30
CFR Cluj,5987,2,5,7,2,15,10,5,22
D Bucuresti,5987,3,5,4,5,18,18,0,19
Universitate,5987,4,4,5,5,17,21,-4,17
FC Botosani,5987,5,3,5,6,5,13,-8,14
Concordia Ch,5987,6,2,3,9,15,22,-7,9
FCSB,5988,1,9,5,0,27,11,16,32
CFR Cluj,5988,2,5,6,3,13,10,3,21
D Bucuresti,5988,3,4,5,5,17,18,-1,17
Universitate,5988,4,4,5,5,16,20,-4,17
FC Botosani,5988,5,3,5,6,6,14,-8,14
Concordia Ch,5988,6,2,4,8,16,22,-6,10
FCSB,5989,1,7,6,1,25,15,10,27
CFR Cluj,5989,2,5,8,1,13,7,6,23
Universitate,5989,3,4,6,4,19,20,-1,18
D Bucuresti,5989,4,4,4,6,18,19,-1,16
FC Botosani,5989,5,4,4,6,7,14,-7,16
Concordia Ch,5989,6,3,2,9,16,23,-7,11
FCSB,5990,1,7,6,1,23,11,12,27
CFR Cluj,5990,2,6,7,1,15,8,7,25
D Bucuresti,5990,3,4,5,5,20,19,1,17
Universitate,5990,4,4,5,5,16,20,-4,17
FC Botosani,5990,5,3,5,6,7,17,-10,14
Concordia Ch,5990,6,2,4,8,18,24,-6,10
FCSB,5991,1,7,6,1,24,12,12,27
CFR Cluj,5991,2,6,7,1,15,8,7,25
D Bucuresti,5991,3,4,4,6,17,20,-3,16
Universitate,5991,4,3,7,4,16,20,-4,16
FC Botosani,5991,5,3,5,6,5,13,-8,14
Concordia Ch,5991,6,3,3,8,17,21,-4,12
FCSB,5992,1,9,5,0,27,11,16,32
CFR Cluj,5992,2,5,6,3,14,11,3,21
D Bucuresti,5992,3,4,5,5,20,18,2,17
Universitate,5992,4,4,5,5,16,20,-4,17
FC Botosani,5992,5,4,4,6,6,16,-10,16
Concordia Ch,5992,6,2,3,9,15,22,-7,9
FCSB,5993,1,8,6,0,24,10,14,30
CFR Cluj,5993,2,6,6,2,16,8,8,24
D Bucuresti,5993,3,4,4,6,18,19,-1,16
FC Botosani,5993,4,4,4,6,8,16,-8,16
Universitate,5993,5,3,6,5,14,21,-7,15
Concordia Ch,5993,6,3,2,9,18,24,-6,11
FCSB,5994,1,7,6,1,25,14,11,27
CFR Cluj,5994,2,5,7,2,14,9,5,22
Universitate,5994,3,5,5,4,18,19,-1,20
FC Botosani,5994,4,4,5,5,8,13,-5,17
D Bucuresti,5994,5,3,5,6,17,21,-4,14
Concordia Ch,5994,6,2,4,8,17,23,-6,10
FCSB,5995,1,7,6,1,23,12,11,27
CFR Cluj,5995,2,5,7,2,13,8,5,22
Universitate,5995,3,5,5,4,17,18,-1,20
D Bucuresti,5995,4,4,5,5,18,18,0,17
FC Botosani,5995,5,3,4,7,5,15,-10,13
Concordia Ch,5995,6,3,3,8,16,21,-5,12
FCSB,5996,1,9,5,0,28,12,16,32
CFR Cluj,5996,2,5,6,3,15,14,1,21
Universitate,5996,3,4,5,5,19,21,-2,17
FC Botosani,5996,4,4,4,6,6,14,-8,16
D Bucuresti,5996,5,3,5,6,17,20,-3,14
Concordia Ch,5996,6,3,3,8,18,22,-4,12
FCSB,5997,1,9,5,0,28,10,18,32
CFR Cluj,5997,2,6,6,2,15,11,4,24
D Bucuresti,5997,3,4,5,5,19,19,0,17
FC Botosani,5997,4,4,5,5,6,12,-6,17
Universitate,5997,5,3,5,6,15,22,-7,14
Concordia Ch,5997,6,2,2,10,16,25,-9,8
FCSB,5998,1,8,5,1,26,13,13,29
CFR Cluj,5998,2,6,7,1,16,8,8,25
FC Botosani,5998,3,4,5,5,8,13,-5,17
D Bucuresti,5998,4,3,6,5,18,20,-2,15
Universitate,5998,5,3,6,5,14,20,-6,15
Concordia Ch,5998,6,2,3,9,16,24,-8,9
FCSB,5999,1,8,6,0,25,11,14,30
CFR Cluj,5999,2,6,6,2,15,9,6,24
D Bucuresti,5999,3,3,6,5,18,20,-2,15
Universitate,5999,4,3,6,5,14,19,-5,15
FC Botosani,5999,5,3,5,6,6,15,-9,14
Concordia Ch,5999,6,3,3,8,18,22,-4,12
FCSB,6000,1,8,5,1,24,11,13,29
CFR Cluj,6000,2,6,6,2,14,8,6,24
D Bucuresti,6000,3,4,5,5,18,19,-1,17
Universitate,6000,4,4,5,5,15,19,-4,17
FC Botosani,6000,5,4,4,6,7,13,-6,16
Concordia Ch,6000,6,2,3,9,16,24,-8,9
FCSB,6001,1,7,5,2,25,14,11,26
CFR Cluj,6001,2,6,6,2,15,9,6,24
Universitate,6001,3,5,5,4,17,19,-2,20
D Bucuresti,6001,4,4,5,5,18,18,0,17
FC Botosani,6001,5,3,4,7,6,16,-10,13
Concordia Ch,6001,6,3,3,8,17,22,-5,12
FCSB,6002,1,8,5,1,26,11,15,29
CFR Cluj,6002,2,6,7,1,14,7,7,25
FC Botosani,6002,3,4,5,5,8,14,-6,17
D Bucuresti,6002,4,3,6,5,18,20,-2,15
Universitate,6002,5,3,6,5,14,21,-7,15
Concordia Ch,6002,6,2,3,9,15,22,-7,9
FCSB,6003,1,9,5,0,26,10,16,32
CFR Cluj,6003,2,5,6,3,13,10,3,21
Universitate,6003,3,4,5,5,15,19,-4,17
FC Botosani,6003,4,4,4,6,6,13,-7,16
Concordia Ch,6003,5,4,2,8,18,22,-4,14
D Bucuresti,6003,6,3,4,7,17,21,-4,13
FCSB,6004,1,9,5,0,28,11,17,32
CFR Cluj,6004,2,6,6,2,14,10,4,24
FC Botosani,6004,3,4,5,5,6,12,-6,17
D Bucuresti,6004,4,3,5,6,16,19,-3,14
Universitate,6004,5,3,5,6,15,21,-6,14
Concordia Ch,6004,6,3,2,9,16,22,-6,11
FCSB,6005,1,8,5,1,25,12,13,29
CFR Cluj,6005,2,6,6,2,15,10,5,24
Universitate,6005,3,4,5,5,17,20,-3,17
FC Botosani,6005,4,4,5,5,7,13,-6,17
D Bucuresti,6005,5,3,5,6,16,19,-3,14
Concordia Ch,6005,6,3,2,9,17,23,-6,11
FCSB,6006,1,7,6,1,23,11,12,27
CFR Cluj,6006,2,6,7,1,17,10,7,25
D Bucuresti,6006,3,4,5,5,18,19,-1,17
Universitate,6006,4,4,5,5,18,22,-4,17
FC Botosani,6006,5,4,5,5,9,15,-6,17
Concordia Ch,6006,6,2,2,10,17,25,-8,8
FCSB,6007,1,9,5,0,27,12,15,32
CFR Cluj,6007,2,5,7,2,13,8,5,22
D Bucuresti,6007,3,3,6,5,18,20,-2,15
Universitate,6007,4,3,6,5,16,21,-5,15
FC Botosani,6007,5,3,5,6,5,15,-10,14
Concordia Ch,6007,6,3,3,8,20,23,-3,12
FCSB,6008,1,9,5,0,26,11,15,32
CFR Cluj,6008,2,5,7,2,15,10,5,22
D Bucuresti,6008,3,4,4,6,18,20,-2,16
Universitate,6008,4,3,6,5,15,20,-5,15
FC Botosani,6008,5,3,5,6,7,15,-8,14
Concordia Ch,6008,6,3,3,8,17,22,-5,12
FCSB,6009,1,8,5,1,25,11,14,29
CFR Cluj,6009,2,5,6,3,14,12,2,21
Universitate,6009,3,5,5,4,18,19,-1,20
FC Botosani,6009,4,3,6,5,6,13,-7,15
D Bucuresti,6009,5,3,5,6,18,21,-3,14
Concordia Ch,6009,6,3,3,8,17,22,-5,12
FCSB,6010,1,8,5,1,25,12,13,29
CFR Cluj,6010,2,6,6,2,15,9,6,24
D Bucuresti,6010,3,5,4,5,19,19,0,19
Universitate,6010,4,4,5,5,15,19,-4,17
FC Botosani,6010,5,4,4,6,7,14,-7,16
Concordia Ch,6010,6,2,2,10,15,23,-8,8
FCSB,6011,1,9,5,0,27,11,16,32
CFR Cluj,6011,2,6,6,2,15,10,5,24
D Bucuresti,6011,3,4,4,6,20,24,-4,16
Concordia Ch,6011,4,4,2,8,22,21,1,14
Universitate,6011,5,3,5,6,14,20,-6,14
FC Botosani,6011,6,3,4,7,8,20,-12,13
FCSB,6012,1,8,5,1,26,13,13,29
CFR Cluj,6012,2,7,6,1,20,7,13,27
FC Botosani,6012,3,4,5,5,6,12,-6,17
Universitate,6012,4,3,5,6,14,25,-11,14
D Bucuresti,6012,5,3,4,7,17,21,-4,13
Concordia Ch,6012,6,3,3,8,17,22,-5,12
FCSB,6013,1,8,5,1,26,13,13,29
CFR Cluj,6013,2,5,6,3,14,11,3,21
Universitate,6013,3,5,5,4,18,19,-1,20
D Bucuresti,6013,4,3,6,5,19,21,-2,15
FC Botosani,6013,5,3,6,5,8,15,-7,15
Concordia Ch,6013,6,2,4,8,19,25,-6,10
FCSB,6014,1,8,6,0,26,11,15,30
CFR Cluj,6014,2,5,6,3,14,12,2,21
Universitate,6014,3,4,6,4,16,18,-2,18
D Bucuresti,6014,4,4,4,6,20,21,-1,16
FC Botosani,6014,5,3,5,6,7,16,-9,14
Concordia Ch,6014,6,3,3,8,18,23,-5,12
FCSB,6015,1,7,6,1,24,13,11,27
CFR Cluj,6015,2,5,7,2,14,10,4,22
Universitate,6015,3,5,5,4,18,18,0,20
D Bucuresti,6015,4,5,4,5,18,18,0,19
FC Botosani,6015,5,4,4,6,8,15,-7,16
Concordia Ch,6015,6,2,2,10,17,25,-8,8
FCSB,6016,1,7,6,1,25,13,12,27
CFR Cluj,6016,2,6,7,1,15,8,7,25
Universitate,6016,3,4,5,5,16,20,-4,17
FC Botosani,6016,4,4,5,5,7,13,-6,17
D Bucuresti,6016,5,3,5,6,17,21,-4,14
Concordia Ch,6016,6,3,2,9,19,24,-5,11
FCSB,6017,1,7,6,1,26,15,11,27
CFR Cluj,6017,2,6,6,2,16,10,6,24
Universitate,6017,3,4,6,4,18,20,-2,18
D Bucuresti,6017,4,4,5,5,20,19,1,17
FC Botosani,6017,5,3,5,6,7,15,-8,14
Concordia Ch,6017,6,3,2,9,17,25,-8,11
FCSB,6018,1,7,7,0,25,12,13,28
CFR Cluj,6018,2,5,8,1,14,8,6,23
D Bucuresti,6018,3,4,4,6,19,20,-1,16
Universitate,6018,4,3,7,4,15,19,-4,16
Concordia Ch,6018,5,4,2,8,19,22,-3,14
FC Botosani,6018,6,3,4,7,6,17,-11,13
FCSB,6019,1,8,5,1,25,12,13,29
CFR Cluj,6019,2,6,6,2,16,10,6,24
D Bucuresti,6019,3,4,5,5,20,20,0,17
Universitate,6019,4,4,5,5,16,20,-4,17
FC Botosani,6019,5,4,5,5,9,13,-4,17
Concordia Ch,6019,6,2,2,10,16,27,-11,8
FCSB,6020,1,7,6,1,25,13,12,27
CFR Cluj,6020,2,6,7,1,14,7,7,25
D Bucuresti,6020,3,5,4,5,21,20,1,19
Universitate,6020,4,3,7,4,16,20,-4,16
FC Botosani,6020,5,4,4,6,7,14,-7,16
Concordia Ch,6020,6,2,2,10,16,25,-9,8
FCSB,6021,1,8,5,1,24,11,13,29
CFR Cluj,6021,2,6,6,2,14,8,6,24
Universitate,6021,3,4,5,5,15,19,-4,17
D Bucuresti,6021,4,4,4,6,18,21,-3,16
FC Botosani,6021,5,4,4,6,6,13,-7,16
Concordia Ch,6021,6,3,2,9,18,23,-5,11
FCSB,6022,1,8,5,1,24,11,13,29
CFR Cluj,6022,2,6,6,2,14,8,6,24
D Bucuresti,6022,3,4,5,5,18,19,-1,17
Universitate,6022,4,4,5,5,15,19,-4,17
FC Botosani,6022,5,3,5,6,6,14,-8,14
Concordia Ch,6022,6,2,4,8,17,23,-6,10
FCSB,6023,1,8,6,0,28,14,14,30
CFR Cluj,6023,2,5,6,3,15,11,4,21
Universitate,6023,3,4,6,4,17,20,-3,18
D Bucuresti,6023,4,4,5,5,18,18,0,17
FC Botosani,6023,5,3,5,6,5,15,-10,14
Concordia Ch,6023,6,3,2,9,18,23,-5,11
FCSB,6024,1,9,5,0,27,12,15,32
CFR Cluj,6024,2,6,6,2,16,9,7,24
FC Botosani,6024,3,4,5,5,8,14,-6,17
Universitate,6024,4,3,5,6,15,22,-7,14
D Bucuresti,6024,5,3,4,7,17,22,-5,13
Concordia Ch,6024,6,3,3,8,18,22,-4,12
FCSB,6025,1,7,7,0,24,11,13,28
CFR Cluj,6025,2,6,7,1,17,9,8,25
D Bucuresti,6025,3,5,4,5,19,19,0,19
Universitate,6025,4,3,6,5,15,21,-6,15
FC Botosani,6025,5,3,5,6,5,13,-8,14
Concordia Ch,6025,6,2,3,9,16,23,-7,9
FCSB,6026,1,8,5,1,28,15,13,29
CFR Cluj,6026,2,5,6,3,13,12,1,21
Universitate,6026,3,5,5,4,21,20,1,20
FC Botosani,6026,4,4,4,6,9,14,-5,16
D Bucuresti,6026,5,3,5,6,17,22,-5,14
Concordia Ch,6026,6,3,3,8,16,21,-5,12
FCSB,6027,1,9,5,0,28,11,17,32
CFR Cluj,6027,2,5,6,3,13,10,3,21
Universitate,6027,3,4,5,5,16,21,-5,17
Concordia Ch,6027,4,4,2,8,20,21,-1,14
D Bucuresti,6027,5,3,5,6,17,22,-5,14
FC Botosani,6027,6,3,5,6,6,15,-9,14
FCSB,6028,1,9,5,0,29,11,18,32
CFR Cluj,6028,2,5,6,3,14,12,2,21
FC Botosani,6028,3,5,4,5,10,15,-5,19
Universitate,6028,4,4,5,5,17,22,-5,17
D Bucuresti,6028,5,3,5,6,17,20,-3,14
Concordia Ch,6028,6,2,3,9,17,24,-7,9
FCSB,6029,1,9,5,0,30,10,20,32
CFR Cluj,6029,2,5,6,3,13,13,0,21
FC Botosani,6029,3,4,5,5,9,13,-4,17
Universitate,6029,4,4,5,5,17,22,-5,17
D Bucuresti,6029,5,3,5,6,16,20,-4,14
Concordia Ch,6029,6,3,2,9,18,25,-7,11
FCSB,6030,1,7,5,2,24,16,8,26
CFR Cluj,6030,2,6,6,2,16,9,7,24
Universitate,6030,3,5,5,4,19,19,0,20
D Bucuresti,6030,4,4,5,5,19,19,0,17
FC Botosani,6030,5,3,4,7,6,18,-12,13
Concordia Ch,6030,6,3,3,8,20,23,-3,12
FCSB,6031,1,8,5,1,27,12,15,29
CFR Cluj,6031,2,5,7,2,14,11,3,22
FC Botosani,6031,3,5,4,5,8,12,-4,19
Universitate,6031,4,4,6,4,17,20,-3,18
D Bucuresti,6031,5,3,4,7,16,21,-5,13
Concordia Ch,6031,6,3,2,9,17,23,-6,11
FCSB,6032,1,8,5,1,27,14,13,29
CFR Cluj,6032,2,6,6,2,15,10,5,24
Universitate,6032,3,4,5,5,17,20,-3,17
FC Botosani,6032,4,4,5,5,7,13,-6,17
D Bucuresti,6032,5,3,5,6,17,20,-3,14
Concordia Ch,6032,6,2,4,8,15,21,-6,10
FCSB,6033,1,8,5,1,25,12,13,29
CFR Cluj,6033,2,5,6,3,13,10,3,21
Universitate,6033,3,5,5,4,18,19,-1,20
D Bucuresti,6033,4,4,5,5,20,19,1,17
FC Botosani,6033,5,4,4,6,6,15,-9,16
Concordia Ch,6033,6,2,3,9,16,23,-7,9
FCSB,6034,1,9,5,0,26,10,16,32
CFR Cluj,6034,2,5,6,3,14,11,3,21
D Bucuresti,6034,3,4,5,5,19,20,-1,17
Universitate,6034,4,4,5,5,17,21,-4,17
FC Botosani,6034,5,3,5,6,6,14,-8,14
Concordia Ch,6034,6,2,4,8,16,22,-6,10
FCSB,6035,1,8,5,1,25,13,12,29
CFR Cluj,6035,2,5,6,3,14,10,4,21
Universitate,6035,3,5,5,4,19,20,-1,20
D Bucuresti,6035,4,5,4,5,21,18,3,19
FC Botosani,6035,5,3,4,7,5,14,-9,13
Concordia Ch,6035,6,3,2,9,16,25,-9,11
FCSB,6036,1,8,5,1,26,14,12,29
CFR Cluj,6036,2,6,6,2,16,9,7,24
D Bucuresti,6036,3,4,5,5,18,18,0,17
Universitate,6036,4,4,5,5,17,21,-4,17
FC Botosani,6036,5,4,5,5,8,12,-4,17
Concordia Ch,6036,6,2,2,10,15,26,-11,8
FCSB,6037,1,9,5,0,27,11,16,32
CFR Cluj,6037,2,5,7,2,14,10,4,22
D Bucuresti,6037,3,5,4,5,19,19,0,19
Universitate,6037,4,3,6,5,16,21,-5,15
FC Botosani,6037,5,3,5,6,6,14,-8,14
Concordia Ch,6037,6,2,3,9,17,24,-7,9
FCSB,6038,1,8,6,0,27,13,14,30
CFR Cluj,6038,2,6,6,2,16,10,6,24
Universitate,6038,3,3,6,5,15,20,-5,15
Concordia Ch,6038,4,4,2,8,20,21,-1,14
D Bucuresti,6038,5,3,5,6,16,22,-6,14
FC Botosani,6038,6,3,5,6,5,13,-8,14
FCSB,6039,1,7,6,1,26,14,12,27
CFR Cluj,6039,2,5,8,1,16,10,6,23
D Bucuresti,6039,3,5,4,5,18,18,0,19
Universitate,6039,4,4,6,4,19,22,-3,18
FC Botosani,6039,5,3,4,7,6,18,-12,13
Concordia Ch,6039,6,3,2,9,20,23,-3,11
CFR Cluj,6040,1,7,6,1,19,10,9,27
FCSB,6040,2,7,5,2,25,15,10,26
FC Botosani,6040,3,5,4,5,8,12,-4,19
Universitate,6040,4,4,5,5,17,21,-4,17
D Bucuresti,6040,5,3,5,6,16,20,-4,14
Concordia Ch,6040,6,2,3,9,15,22,-7,9
FCSB,6041,1,8,6,0,24,10,14,30
CFR Cluj,6041,2,6,6,2,17,9,8,24
D Bucuresti,6041,3,4,5,5,19,19,0,17
Universitate,6041,4,3,6,5,15,22,-7,15
FC Botosani,6041,5,3,5,6,5,14,-9,14
Concordia Ch,6041,6,2,4,8,16,22,-6,10
FCSB,6042,1,7,6,1,25,13,12,27
CFR Cluj,6042,2,6,7,1,18,9,9,25
Universitate,6042,3,4,5,5,15,21,-6,17
D Bucuresti,6042,4,3,6,5,19,21,-2,15
FC Botosani,6042,5,3,6,5,6,13,-7,15
Concordia Ch,6042,6,2,4,8,17,23,-6,10
FCSB,6043,1,8,6,0,27,13,14,30
CFR Cluj,6043,2,5,7,2,13,8,5,22
Universitate,6043,3,4,5,5,18,22,-4,17
D Bucuresti,6043,4,4,4,6,19,20,-1,16
FC Botosani,6043,5,4,4,6,8,15,-7,16
Concordia Ch,6043,6,3,2,9,18,25,-7,11
FCSB,6044,1,7,7,0,24,11,13,28
CFR Cluj,6044,2,5,8,1,15,9,6,23
FC Botosani,6044,3,5,4,5,10,14,-4,19
Universitate,6044,4,3,7,4,15,19,-4,16
D Bucuresti,6044,5,3,5,6,18,22,-4,14
Concordia Ch,6044,6,2,3,9,17,24,-7,9
FCSB,6045,1,8,6,0,26,11,15,30
CFR Cluj,6045,2,5,7,2,14,10,4,22
D Bucuresti,6045,3,4,4,6,19,20,-1,16
Universitate,6045,4,3,7,4,14,18,-4,16
FC Botosani,6045,5,4,4,6,7,15,-8,16
Concordia Ch,6045,6,3,2,9,17,23,-6,11
FCSB,6046,1,8,6,0,24,10,14,30
CFR Cluj,6046,2,6,7,1,16,7,9,25
D Bucuresti,6046,3,3,6,5,18,20,-2,15
Universitate,6046,4,3,5,6,14,22,-8,14
FC Botosani,6046,5,3,5,6,6,14,-8,14
Concordia Ch,6046,6,3,3,8,17,22,-5,12
FCSB,6047,1,7,6,1,24,12,12,27
CFR Cluj,6047,2,5,8,1,13,7,6,23
Universitate,6047,3,4,6,4,16,19,-3,18
D Bucuresti,6047,4,4,4,6,17,19,-2,16
FC Botosani,6047,5,3,5,6,6,14,-8,14
Concordia Ch,6047,6,3,3,8,17,22,-5,12
FCSB,6048,1,8,6,0,25,11,14,30
CFR Cluj,6048,2,6,6,2,17,9,8,24
D Bucuresti,6048,3,4,5,5,17,18,-1,17
Universitate,6048,4,3,6,5,14,21,-7,15
FC Botosani,6048,5,3,6,5,5,12,-7,15
Concordia Ch,6048,6,2,3,9,15,22,-7,9
FCSB,6049,1,8,6,0,28,12,16,30
CFR Cluj,6049,2,5,6,3,15,13,2,21
Universitate,6049,3,4,6,4,17,20,-3,18
D Bucuresti,6049,4,4,5,5,18,18,0,17
FC Botosani,6049,5,3,5,6,6,15,-9,14
Concordia Ch,6049,6,2,4,8,16,22,-6,10
FCSB,6050,1,7,7,0,23,10,13,28
CFR Cluj,6050,2,5,8,1,14,8,6,23
D Bucuresti,6050,3,5,4,5,20,19,1,19
Universitate,6050,4,3,7,4,15,19,-4,16
FC Botosani,6050,5,4,4,6,9,16,-7,16
Concordia Ch,6050,6,2,2,10,16,25,-9,8
FCSB,6051,1,9,5,0,28,13,15,32
CFR Cluj,6051,2,5,7,2,15,10,5,22
FC Botosani,6051,3,5,4,5,8,13,-5,19
Universitate,6051,4,3,6,5,17,22,-5,15
D Bucuresti,6051,5,3,5,6,18,21,-3,14
Concordia Ch,6051,6,2,3,9,16,23,-7,9
FCSB,6052,1,7,6,1,24,13,11,27
CFR Cluj,6052,2,6,7,1,18,10,8,25
D Bucuresti,6052,3,5,4,5,22,19,3,19
Universitate,6052,4,3,7,4,16,20,-4,16
FC Botosani,6052,5,3,4,7,8,21,-13,13
Concordia Ch,6052,6,3,2,9,19,24,-5,11
FCSB,6053,1,8,6,0,26,11,15,30
CFR Cluj,6053,2,6,6,2,16,10,6,24
D Bucuresti,6053,3,4,5,5,20,20,0,17
FC Botosani,6053,4,4,5,5,10,16,-6,17
Universitate,6053,5,3,6,5,16,22,-6,15
Concordia Ch,6053,6,2,2,10,17,26,-9,8
FCSB,6054,1,7,5,2,23,12,11,26
CFR Cluj,6054,2,6,6,2,14,8,6,24
Universitate,6054,3,5,5,4,16,18,-2,20
D Bucuresti,6054,4,5,4,5,19,18,1,19
FC Botosani,6054,5,4,4,6,7,15,-8,16
Concordia Ch,6054,6,2,2,10,16,24,-8,8
FCSB,6055,1,9,5,0,26,11,15,32
CFR Cluj,6055,2,5,6,3,13,10,3,21
Universitate,6055,3,4,5,5,17,20,-3,17
D Bucuresti,6055,4,4,4,6,17,20,-3,16
Concordia Ch,6055,5,4,2,8,20,22,-2,14
FC Botosani,6055,6,3,4,7,6,16,-10,13
FCSB,6056,1,8,5,1,27,14,13,29
CFR Cluj,6056,2,6,6,2,16,9,7,24
Universitate,6056,3,4,5,5,17,22,-5,17
FC Botosani,6056,4,4,4,6,7,14,-7,16
Concordia Ch,6056,5,4,2,8,18,21,-3,14
D Bucuresti,6056,6,3,4,7,16,21,-5,13
FCSB,6057,1,8,5,1,25,12,13,29
CFR Cluj,6057,2,5,6,3,13,9,4,21
Universitate,6057,3,5,5,4,17,19,-2,20
D Bucuresti,6057,4,4,4,6,20,20,0,16
FC Botosani,6057,5,4,4,6,6,15,-9,16
Concordia Ch,6057,6,3,2,9,17,23,-6,11
FCSB,6058,1,9,5,0,29,12,17,32
CFR Cluj,6058,2,5,7,2,16,12,4,22
D Bucuresti,6058,3,3,6,5,19,21,-2,15
Universitate,6058,4,3,6,5,17,23,-6,15
FC Botosani,6058,5,3,6,5,8,15,-7,15
Concordia Ch,6058,6,2,4,8,17,23,-6,10
FCSB,6059,1,8,5,1,25,15,10,29
CFR Cluj,6059,2,6,6,2,15,9,6,24
Universitate,6059,3,4,5,5,18,19,-1,17
D Bucuresti,6059,4,3,6,5,20,22,-2,15
FC Botosani,6059,5,3,6,5,6,13,-7,15
Concordia Ch,6059,6,2,4,8,18,24,-6,10
FCSB,6060,1,8,6,0,25,10,15,30
CFR Cluj,6060,2,6,6,2,15,10,5,24
D Bucuresti,6060,3,4,4,6,18,19,-1,16
Universitate,6060,4,3,6,5,15,20,-5,15
Concordia Ch,6060,5,4,2,8,17,21,-4,14
FC Botosani,6060,6,3,4,7,5,15,-10,13
FCSB,6061,1,7,5,2,23,12,11,26
CFR Cluj,6061,2,6,6,2,14,8,6,24
Universitate,6061,3,5,5,4,16,18,-2,20
FC Botosani,6061,4,5,4,5,11,14,-3,19
D Bucuresti,6061,5,3,5,6,18,22,-4,14
Concordia Ch,6061,6,2,3,9,19,27,-8,9
FCSB,6062,1,7,6,1,25,13,12,27
CFR Cluj,6062,2,6,7,1,16,9,7,25
FC Botosani,6062,3,5,4,5,9,13,-4,19
Universitate,6062,4,4,5,5,15,19,-4,17
D Bucuresti,6062,5,3,5,6,19,22,-3,14
Concordia Ch,6062,6,2,3,9,17,25,-8,9
FCSB,6063,1,7,7,0,25,12,13,28
CFR Cluj,6063,2,5,8,1,15,9,6,23
D Bucuresti,6063,3,5,4,5,25,21,4,19
Universitate,6063,4,3,7,4,16,20,-4,16
FC Botosani,6063,5,3,5,6,6,18,-12,14
Concordia Ch,6063,6,2,3,9,19,26,-7,9
FCSB,6064,1,7,6,1,24,12,12,27
CFR Cluj,6064,2,5,8,1,15,9,6,23
Universitate,6064,3,4,6,4,16,19,-3,18
D Bucuresti,6064,4,4,4,6,17,19,-2,16
FC Botosani,6064,5,4,4,6,7,14,-7,16
Concordia Ch,6064,6,3,2,9,17,23,-6,11
FCSB,6065,1,8,5,1,25,13,12,29
CFR Cluj,6065,2,5,7,2,13,8,5,22
D Bucuresti,6065,3,5,4,5,20,20,0,19
Universitate,6065,4,4,6,4,17,19,-2,18
FC Botosani,6065,5,4,4,6,6,13,-7,16
Concordia Ch,6065,6,2,2,10,17,25,-8,8
FCSB,6066,1,7,7,0,25,12,13,28
CFR Cluj,6066,2,5,7,2,14,10,4,22
Universitate,6066,3,4,6,4,17,19,-2,18
D Bucuresti,6066,4,4,5,5,20,20,0,17
FC Botosani,6066,5,3,4,7,6,16,-10,13
Concordia Ch,6066,6,3,3,8,17,22,-5,12
FCSB,6067,1,7,6,1,23,11,12,27
CFR Cluj,6067,2,7,6,1,16,8,8,27
D Bucuresti,6067,3,4,5,5,17,18,-1,17
FC Botosani,6067,4,4,4,6,7,14,-7,16
Universitate,6067,5,3,6,5,15,20,-5,15
Concordia Ch,6067,6,2,3,9,16,23,-7,9
FCSB,6068,1,7,5,2,24,14,10,26
CFR Cluj,6068,2,6,6,2,14,9,5,24
Universitate,6068,3,5,5,4,19,19,0,20
D Bucuresti,6068,4,4,5,5,18,19,-1,17
FC Botosani,6068,5,4,4,6,7,13,-6,16
Concordia Ch,6068,6,2,3,9,16,24,-8,9
FCSB,6069,1,8,6,0,28,13,15,30
CFR Cluj,6069,2,6,6,2,17,12,5,24
D Bucuresti,6069,3,5,4,5,20,19,1,19
Universitate,6069,4,3,6,5,16,21,-5,15
FC Botosani,6069,5,3,4,7,5,15,-10,13
Concordia Ch,6069,6,3,2,9,17,23,-6,11
FCSB,6070,1,8,5,1,25,12,13,29
CFR Cluj,6070,2,5,6,3,13,10,3,21
Universitate,6070,3,5,5,4,18,19,-1,20
D Bucuresti,6070,4,3,5,6,17,20,-3,14
Concordia Ch,6070,5,4,2,8,19,23,-4,14
FC Botosani,6070,6,3,5,6,6,14,-8,14
FCSB,6071,1,8,6,0,27,12,15,30
CFR Cluj,6071,2,5,7,2,14,10,4,22
Universitate,6071,3,3,7,4,15,19,-4,16
Concordia Ch,6071,4,4,2,8,23,22,1,14
D Bucuresti,6071,5,3,5,6,18,25,-7,14
FC Botosani,6071,6,3,5,6,8,17,-9,14
FCSB,6072,1,8,6,0,26,11,15,30
CFR Cluj,6072,2,5,8,1,15,9,6,23
D Bucuresti,6072,3,5,4,5,22,21,1,19
FC Botosani,6072,4,4,4,6,8,16,-8,16
Universitate,6072,5,3,6,5,15,21,-6,15
Concordia Ch,6072,6,2,2,10,16,24,-8,8
FCSB,6073,1,8,6,0,26,12,14,30
CFR Cluj,6073,2,5,7,2,15,10,5,22
D Bucuresti,6073,3,4,5,5,20,19,1,17
Universitate,6073,4,3,7,4,16,20,-4,16
FC Botosani,6073,5,3,4,7,5,16,-11,13
Concordia Ch,6073,6,3,3,8,17,22,-5,12
FCSB,6074,1,7,6,1,23,11,12,27
CFR Cluj,6074,2,6,7,1,16,8,8,25
D Bucuresti,6074,3,4,5,5,18,19,-1,17
Universitate,6074,4,4,5,5,16,21,-5,17
FC Botosani,6074,5,4,4,6,7,13,-6,16
Concordia Ch,6074,6,2,3,9,16,24,-8,9
CFR Cluj,6075,1,7,6,1,18,8,10,27
FCSB,6075,2,7,5,2,24,18,6,26
FC Botosani,6075,3,5,4,5,8,13,-5,19
Universitate,6075,4,4,5,5,18,19,-1,17
D Bucuresti,6075,5,4,4,6,20,22,-2,16
Concordia Ch,6075,6,2,2,10,17,25,-8,8
FCSB,6076,1,7,6,1,23,11,12,27
CFR Cluj,6076,2,6,7,1,14,7,7,25
Universitate,6076,3,4,5,5,15,19,-4,17
FC Botosani,6076,4,4,5,5,6,12,-6,17
D Bucuresti,6076,5,3,5,6,17,20,-3,14
Concordia Ch,6076,6,2,4,8,16,22,-6,10
FCSB,6077,1,7,7,0,25,12,13,28
CFR Cluj,6077,2,5,8,1,14,8,6,23
FC Botosani,6077,3,4,5,5,6,12,-6,17
Universitate,6077,4,3,7,4,15,19,-4,16
D Bucuresti,6077,5,3,5,6,17,22,-5,14
Concordia Ch,6077,6,3,2,9,19,23,-4,11
FCSB,6078,1,8,6,0,27,12,15,30
CFR Cluj,6078,2,6,6,2,14,9,5,24
FC Botosani,6078,3,4,4,6,7,14,-7,16
Universitate,6078,4,3,6,5,16,21,-5,15
D Bucuresti,6078,5,3,5,6,17,20,-3,14
Concordia Ch,6078,6,3,3,8,16,21,-5,12
FCSB,6079,1,8,5,1,27,14,13,29
CFR Cluj,6079,2,5,6,3,16,13,3,21
Universitate,6079,3,5,5,4,21,22,-1,20
D Bucuresti,6079,4,4,4,6,17,20,-3,16
FC Botosani,6079,5,4,4,6,7,13,-6,16
Concordia Ch,6079,6,3,2,9,17,23,-6,11
FCSB,6080,1,7,7,0,25,12,13,28
CFR Cluj,6080,2,5,7,2,16,11,5,22
D Bucuresti,6080,3,5,4,5,21,19,2,19
Universitate,6080,4,4,6,4,16,19,-3,18
FC Botosani,6080,5,3,5,6,5,14,-9,14
Concordia Ch,6080,6,2,3,9,16,24,-8,9
FCSB,6081,1,7,5,2,23,14,9,26
CFR Cluj,6081,2,6,6,2,16,8,8,24
Universitate,6081,3,5,5,4,16,18,-2,20
D Bucuresti,6081,4,4,4,6,19,22,-3,16
FC Botosani,6081,5,4,4,6,7,15,-8,16
Concordia Ch,6081,6,3,2,9,20,24,-4,11
FCSB,6082,1,7,6,1,24,12,12,27
CFR Cluj,6082,2,7,6,1,17,9,8,27
FC Botosani,6082,3,5,4,5,8,12,-4,19
Universitate,6082,4,3,6,5,15,20,-5,15
D Bucuresti,6082,5,3,5,6,17,20,-3,14
Concordia Ch,6082,6,2,3,9,16,24,-8,9
FCSB,6083,1,8,5,1,26,13,13,29
CFR Cluj,6083,2,6,6,2,18,12,6,24
Universitate,6083,3,4,5,5,19,23,-4,17
FC Botosani,6083,4,4,5,5,9,14,-5,17
D Bucuresti,6083,5,3,4,7,17,23,-6,13
Concordia Ch,6083,6,3,3,8,18,22,-4,12
FCSB,6084,1,8,5,1,26,14,12,29
CFR Cluj,6084,2,5,7,2,14,9,5,22
Universitate,6084,3,4,6,4,17,19,-2,18
D Bucuresti,6084,4,4,4,6,20,21,-1,16
FC Botosani,6084,5,4,4,6,9,16,-7,16
Concordia Ch,6084,6,3,2,9,19,26,-7,11
FCSB,6085,1,7,7,0,26,13,13,28
CFR Cluj,6085,2,5,8,1,14,8,6,23
FC Botosani,6085,3,5,4,5,11,15,-4,19
D Bucuresti,6085,4,4,4,6,21,21,0,16
Universitate,6085,5,3,7,4,16,20,-4,16
Concordia Ch,6085,6,2,2,10,16,27,-11,8
FCSB,6086,1,7,6,1,26,15,11,27
CFR Cluj,6086,2,7,6,1,18,8,10,27
FC Botosani,6086,3,4,5,5,10,16,-6,17
Universitate,6086,4,3,6,5,16,22,-6,15
D Bucuresti,6086,5,3,5,6,17,20,-3,14
Concordia Ch,6086,6,3,2,9,19,25,-6,11
FCSB,6087,1,8,6,0,25,11,14,30
CFR Cluj,6087,2,5,8,1,14,8,6,23
FC Botosani,6087,3,5,4,5,8,12,-4,19
D Bucuresti,6087,4,4,4,6,18,21,-3,16
Universitate,6087,5,3,6,5,14,19,-5,15
Concordia Ch,6087,6,2,2,10,16,24,-8,8
FCSB,6088,1,8,5,1,26,12,14,29
CFR Cluj,6088,2,6,7,1,17,10,7,25
FC Botosani,6088,3,4,5,5,10,16,-6,17
D Bucuresti,6088,4,4,4,6,21,21,0,16
Universitate,6088,5,3,6,5,16,22,-6,15
Concordia Ch,6088,6,2,3,9,17,26,-9,9
FCSB,6089,1,8,6,0,24,10,14,30
CFR Cluj,6089,2,6,6,2,16,9,7,24
D Bucuresti,6089,3,4,5,5,20,20,0,17
FC Botosani,6089,4,4,4,6,6,14,-8,16
Universitate,6089,5,3,6,5,15,21,-6,15
Concordia Ch,6089,6,2,3,9,17,24,-7,9
FCSB,6090,1,7,7,0,24,11,13,28
CFR Cluj,6090,2,6,7,1,15,7,8,25
D Bucuresti,6090,3,4,4,6,18,20,-2,16
Universitate,6090,4,3,6,5,15,21,-6,15
Concordia Ch,6090,5,4,2,8,18,22,-4,14
FC Botosani,6090,6,3,4,7,5,14,-9,13
FCSB,6091,1,8,5,1,24,13,11,29
CFR Cluj,6091,2,6,6,2,15,8,7,24
Universitate,6091,3,4,5,5,17,20,-3,17
D Bucuresti,6091,4,3,6,5,18,20,-2,15
FC Botosani,6091,5,3,5,6,5,13,-8,14
Concordia Ch,6091,6,3,3,8,18,23,-5,12
FCSB,6092,1,8,6,0,26,11,15,30
CFR Cluj,6092,2,5,7,2,14,10,4,22
D Bucuresti,6092,3,4,5,5,22,19,3,17
Universitate,6092,4,3,7,4,14,18,-4,16
FC Botosani,6092,5,4,4,6,8,19,-11,16
Concordia Ch,6092,6,2,3,9,18,25,-7,9
FCSB,6093,1,8,5,1,24,12,12,29
CFR Cluj,6093,2,6,6,2,18,9,9,24
D Bucuresti,6093,3,4,5,5,17,18,-1,17
Universitate,6093,4,4,5,5,17,23,-6,17
FC Botosani,6093,5,4,5,5,8,14,-6,17
Concordia Ch,6093,6,2,2,10,17,25,-8,8
FCSB,6094,1,8,5,1,26,12,14,29
CFR Cluj,6094,2,7,6,1,16,8,8,27
FC Botosani,6094,3,4,5,5,7,13,-6,17
Universitate,6094,4,3,5,6,14,21,-7,14
D Bucuresti,6094,5,3,4,7,17,22,-5,13
Concordia Ch,6094,6,3,3,8,19,23,-4,12
FCSB,6095,1,8,6,0,25,11,14,30
CFR Cluj,6095,2,5,7,2,15,10,5,22
D Bucuresti,6095,3,4,5,5,18,19,-1,17
Universitate,6095,4,4,5,5,16,20,-4,17
FC Botosani,6095,5,3,5,6,6,14,-8,14
Concordia Ch,6095,6,2,4,8,17,23,-6,10
FCSB,6096,1,7,6,1,25,13,12,27
CFR Cluj,6096,2,7,6,1,17,9,8,27
FC Botosani,6096,3,4,5,5,7,13,-6,17
D Bucuresti,6096,4,3,6,5,16,18,-2,15
Universitate,6096,5,3,6,5,16,21,-5,15
Concordia Ch,6096,6,2,3,9,16,23,-7,9
FCSB,6097,1,8,5,1,27,15,12,29
CFR Cluj,6097,2,6,6,2,18,10,8,24
Universitate,6097,3,4,5,5,17,22,-5,17
Concordia Ch,6097,4,4,2,8,20,22,-2,14
D Bucuresti,6097,5,3,5,6,17,21,-4,14
FC Botosani,6097,6,3,5,6,7,16,-9,14
FCSB,6098,1,8,6,0,27,12,15,30
CFR Cluj,6098,2,5,6,3,14,11,3,21
Universitate,6098,3,4,6,4,16,19,-3,18
D Bucuresti,6098,4,3,6,5,18,20,-2,15
FC Botosani,6098,5,3,6,5,6,13,-7,15
Concordia Ch,6098,6,2,4,8,18,24,-6,10
FCSB,6099,1,7,6,1,24,15,9,27
CFR Cluj,6099,2,6,7,1,15,8,7,25
FC Botosani,6099,3,5,4,5,12,14,-2,19
Universitate,6099,4,4,5,5,20,21,-1,17
D Bucuresti,6099,5,3,4,7,17,23,-6,13
Concordia Ch,6099,6,3,2,9,17,24,-7,11
FCSB,6100,1,8,5,1,25,14,11,29
CFR Cluj,6100,2,6,7,1,17,8,9,25
D Bucuresti,6100,3,4,4,6,21,23,-2,16
Universitate,6100,4,3,6,5,16,21,-5,15
FC Botosani,6100,5,3,5,6,8,17,-9,14
Concordia Ch,6100,6,3,3,8,19,23,-4,12
CFR Cluj,6101,1,7,6,1,22,8,14,27
FCSB,6101,2,7,6,1,23,14,9,27
D Bucuresti,6101,3,5,4,5,20,19,1,19
FC Botosani,6101,4,4,4,6,6,13,-7,16
Universitate,6101,5,3,6,5,15,23,-8,15
Concordia Ch,6101,6,2,2,10,16,25,-9,8
FCSB,6102,1,7,7,0,23,10,13,28
CFR Cluj,6102,2,5,7,2,14,10,4,22
FC Botosani,6102,3,5,4,5,7,12,-5,19
Universitate,6102,4,4,6,4,17,19,-2,18
D Bucuresti,6102,5,3,5,6,16,19,-3,14
Concordia Ch,6102,6,2,3,9,15,22,-7,9
FCSB,6103,1,9,5,0,25,10,15,32
CFR Cluj,6103,2,5,7,2,15,10,5,22
D Bucuresti,6103,3,4,5,5,17,18,-1,17
Universitate,6103,4,3,6,5,16,21,-5,15
FC Botosani,6103,5,3,5,6,5,13,-8,14
Concordia Ch,6103,6,3,2,9,16,22,-6,11
FCSB,6104,1,7,6,1,25,13,12,27
CFR Cluj,6104,2,5,7,2,16,11,5,22
Universitate,6104,3,5,5,4,17,19,-2,20
D Bucuresti,6104,4,5,4,5,19,18,1,19
FC Botosani,6104,5,4,4,6,8,16,-8,16
Concordia Ch,6104,6,2,2,10,17,25,-8,8
FCSB,6105,1,8,6,0,25,11,14,30
CFR Cluj,6105,2,5,7,2,14,9,5,22
Universitate,6105,3,3,7,4,16,20,-4,16
FC Botosani,6105,4,4,4,6,6,14,-8,16
D Bucuresti,6105,5,3,5,6,18,21,-3,14
Concordia Ch,6105,6,3,3,8,19,23,-4,12
FCSB,6106,1,8,5,1,27,12,15,29
CFR Cluj,6106,2,5,7,2,13,10,3,22
Universitate,6106,3,4,6,4,16,19,-3,18
D Bucuresti,6106,4,4,5,5,19,19,0,17
FC Botosani,6106,5,3,6,5,5,12,-7,15
Concordia Ch,6106,6,2,3,9,16,24,-8,9
CFR Cluj,6107,1,7,6,1,19,8,11,27
FCSB,6107,2,7,6,1,24,14,10,27
D Bucuresti,6107,3,4,4,6,18,21,-3,16
FC Botosani,6107,4,4,4,6,8,13,-5,16
Universitate,6107,5,3,6,5,14,20,-6,15
Concordia Ch,6107,6,3,2,9,18,25,-7,11
FCSB,6108,1,7,6,1,24,12,12,27
CFR Cluj,6108,2,6,6,2,14,8,6,24
D Bucuresti,6108,3,5,4,5,19,18,1,19
Universitate,6108,4,4,6,4,16,19,-3,18
FC Botosani,6108,5,3,5,6,6,15,-9,14
Concordia Ch,6108,6,2,3,9,16,23,-7,9
FCSB,6109,1,7,6,1,24,12,12,27
CFR Cluj,6109,2,5,8,1,14,8,6,23
Universitate,6109,3,4,6,4,17,20,-3,18
D Bucuresti,6109,4,4,5,5,21,20,1,17
FC Botosani,6109,5,4,4,6,7,16,-9,16
Concordia Ch,6109,6,2,3,9,16,23,-7,9
FCSB,6110,1,8,5,1,25,11,14,29
CFR Cluj,6110,2,6,6,2,14,10,4,24
D Bucuresti,6110,3,4,5,5,20,21,-1,17
Universitate,6110,4,4,5,5,17,20,-3,17
FC Botosani,6110,5,3,4,7,6,15,-9,13
Concordia Ch,6110,6,3,3,8,18,23,-5,12
FCSB,6111,1,8,5,1,27,12,15,29
CFR Cluj,6111,2,5,7,2,13,10,3,22
Universitate,6111,3,4,6,4,16,19,-3,18
D Bucuresti,6111,4,4,4,6,18,20,-2,16
FC Botosani,6111,5,4,4,6,6,13,-7,16
Concordia Ch,6111,6,3,2,9,17,23,-6,11
FCSB,6112,1,8,6,0,26,11,15,30
CFR Cluj,6112,2,5,7,2,14,10,4,22
Universitate,6112,3,3,7,4,14,18,-4,16
FC Botosani,6112,4,4,4,6,10,16,-6,16
D Bucuresti,6112,5,3,5,6,17,22,-5,14
Concordia Ch,6112,6,3,3,8,20,24,-4,12
FCSB,6113,1,8,5,1,26,13,13,29
CFR Cluj,6113,2,6,6,2,16,10,6,24
Universitate,6113,3,4,5,5,15,19,-4,17
D Bucuresti,6113,4,3,6,5,18,20,-2,15
FC Botosani,6113,5,3,6,5,7,14,-7,15
Concordia Ch,6113,6,2,4,8,17,23,-6,10
FCSB,6114,1,7,7,0,25,12,13,28
CFR Cluj,6114,2,5,8,1,14,8,6,23
Universitate,6114,3,3,7,4,15,19,-4,16
D Bucuresti,6114,4,3,6,5,17,19,-2,15
FC Botosani,6114,5,3,6,5,6,13,-7,15
Concordia Ch,6114,6,2,4,8,17,23,-6,10
FCSB,6115,1,8,6,0,26,11,15,30
CFR Cluj,6115,2,5,7,2,15,11,4,22
D Bucuresti,6115,3,4,5,5,19,19,0,17
Universitate,6115,4,3,7,4,15,19,-4,16
FC Botosani,6115,5,4,4,6,9,15,-6,16
Concordia Ch,6115,6,2,3,9,17,26,-9,9
FCSB,6116,1,7,5,2,24,14,10,26
CFR Cluj,6116,2,6,7,1,15,8,7,25
FC Botosani,6116,3,5,4,5,10,13,-3,19
Universitate,6116,4,4,6,4,18,20,-2,18
D Bucuresti,6116,5,3,5,6,18,21,-3,14
Concordia Ch,6116,6,2,3,9,16,25,-9,9
FCSB,6117,1,7,6,1,24,13,11,27
CFR Cluj,6117,2,5,8,1,15,9,6,23
Universitate,6117,3,4,6,4,17,19,-2,18
D Bucuresti,6117,4,4,5,5,18,19,-1,17
FC Botosani,6117,5,3,5,6,5,13,-8,14
Concordia Ch,6117,6,2,4,8,16,22,-6,10
FCSB,6118,1,8,5,1,28,14,14,29
CFR Cluj,6118,2,6,7,1,17,10,7,25
FC Botosani,6118,3,4,5,5,7,12,-5,17
Universitate,6118,4,3,6,5,16,22,-6,15
D Bucuresti,6118,5,3,4,7,16,21,-5,13
Concordia Ch,6118,6,3,3,8,16,21,-5,12
FCSB,6119,1,8,5,1,26,13,13,29
CFR Cluj,6119,2,6,6,2,17,10,7,24
Universitate,6119,3,4,5,5,15,20,-5,17
D Bucuresti,6119,4,3,6,5,17,19,-2,15
FC Botosani,6119,5,3,6,5,5,12,-7,15
Concordia Ch,6119,6,2,4,8,16,22,-6,10
FCSB,6120,1,7,5,2,24,14,10,26
CFR Cluj,6120,2,6,7,1,14,7,7,25
FC Botosani,6120,3,5,4,5,8,12,-4,19
Universitate,6120,4,4,6,4,17,19,-2,18
D Bucuresti,6120,5,3,4,7,16,20,-4,13
Concordia Ch,6120,6,3,2,9,16,23,-7,11
FCSB,6121,1,7,7,0,26,13,13,28
CFR Cluj,6121,2,6,7,1,14,7,7,25
Universitate,6121,3,3,6,5,17,22,-5,15
Concordia Ch,6121,4,4,2,8,18,21,-3,14
D Bucuresti,6121,5,3,5,6,16,19,-3,14
FC Botosani,6121,6,3,5,6,5,14,-9,14
FCSB,6122,1,8,6,0,27,12,15,30
CFR Cluj,6122,2,5,7,2,14,10,4,22
Universitate,6122,3,3,7,4,17,21,-4,16
FC Botosani,6122,4,4,4,6,8,15,-7,16
Concordia Ch,6122,5,4,2,8,20,23,-3,14
D Bucuresti,6122,6,3,4,7,18,23,-5,13
FCSB,6123,1,8,6,0,25,10,15,30
CFR Cluj,6123,2,5,8,1,13,7,6,23
D Bucuresti,6123,3,5,4,5,21,19,2,19
FC Botosani,6123,4,4,4,6,7,16,-9,16
Universitate,6123,5,3,6,5,14,20,-6,15
Concordia Ch,6123,6,2,2,10,15,23,-8,8
FCSB,6124,1,8,5,1,26,11,15,29
CFR Cluj,6124,2,5,7,2,14,11,3,22
D Bucuresti,6124,3,5,4,5,20,18,2,19
Universitate,6124,4,4,6,4,16,19,-3,18
FC Botosani,6124,5,3,4,7,6,15,-9,13
Concordia Ch,6124,6,3,2,9,17,25,-8,11
FCSB,6125,1,8,5,1,27,13,14,29
CFR Cluj,6125,2,6,6,2,15,10,5,24
D Bucuresti,6125,3,5,4,5,18,18,0,19
Universitate,6125,4,4,5,5,16,20,-4,17
FC Botosani,6125,5,4,4,6,8,13,-5,16
Concordia Ch,6125,6,2,2,10,15,25,-10,8
FCSB,6126,1,8,5,1,26,12,14,29
CFR Cluj,6126,2,5,7,2,14,10,4,22
Universitate,6126,3,4,6,4,15,18,-3,18
D Bucuresti,6126,4,4,5,5,21,22,-1,17
FC Botosani,6126,5,3,4,7,7,16,-9,13
Concordia Ch,6126,6,3,3,8,20,25,-5,12
FCSB,6127,1,8,6,0,26,11,15,30
CFR Cluj,6127,2,6,7,1,14,7,7,25
D Bucuresti,6127,3,4,5,5,18,19,-1,17
FC Botosani,6127,4,4,5,5,7,12,-5,17
Universitate,6127,5,3,5,6,15,22,-7,14
Concordia Ch,6127,6,2,2,10,16,25,-9,8
FCSB,6128,1,7,6,1,23,12,11,27
CFR Cluj,6128,2,5,8,1,13,7,6,23
Universitate,6128,3,4,6,4,16,18,-2,18
FC Botosani,6128,4,4,4,6,7,16,-9,16
Concordia Ch,6128,5,4,2,8,21,23,-2,14
D Bucuresti,6128,6,3,4,7,19,23,-4,13
FCSB,6129,1,8,6,0,26,11,15,30
CFR Cluj,6129,2,5,8,1,15,9,6,23
FC Botosani,6129,3,4,5,5,8,14,-6,17
D Bucuresti,6129,4,4,4,6,18,20,-2,16
Universitate,6129,5,3,6,5,15,21,-6,15
Concordia Ch,6129,6,2,3,9,16,23,-7,9
FCSB,6130,1,8,5,1,26,12,14,29
CFR Cluj,6130,2,5,7,2,13,9,4,22
Universitate,6130,3,4,6,4,16,19,-3,18
D Bucuresti,6130,4,4,5,5,18,19,-1,17
FC Botosani,6130,5,4,5,5,7,13,-6,17
Concordia Ch,6130,6,2,2,10,15,23,-8,8
FCSB,6131,1,8,6,0,26,10,16,30
CFR Cluj,6131,2,5,7,2,13,9,4,22
Universitate,6131,3,4,5,5,16,21,-5,17
FC Botosani,6131,4,4,5,5,7,13,-6,17
D Bucuresti,6131,5,3,5,6,18,21,-3,14
Concordia Ch,6131,6,2,4,8,18,24,-6,10
FCSB,6132,1,9,5,0,26,10,16,32
CFR Cluj,6132,2,5,6,3,13,11,2,21
D Bucuresti,6132,3,4,5,5,17,18,-1,17
Universitate,6132,4,4,5,5,16,19,-3,17
FC Botosani,6132,5,4,5,5,8,12,-4,17
Concordia Ch,6132,6,2,2,10,15,25,-10,8
FCSB,6133,1,8,6,0,26,12,14,30
CFR Cluj,6133,2,5,7,2,16,11,5,22
D Bucuresti,6133,3,4,4,6,17,19,-2,16
Universitate,6133,4,3,7,4,17,21,-4,16
FC Botosani,6133,5,3,5,6,7,15,-8,14
Concordia Ch,6133,6,3,3,8,18,23,-5,12
FCSB,6134,1,8,5,1,25,12,13,29
CFR Cluj,6134,2,6,6,2,15,8,7,24
FC Botosani,6134,3,5,4,5,7,12,-5,19
Universitate,6134,4,4,5,5,16,21,-5,17
D Bucuresti,6134,5,3,4,7,17,21,-4,13
Concordia Ch,6134,6,3,2,9,17,23,-6,11
FCSB,6135,1,8,6,0,24,10,14,30
CFR Cluj,6135,2,6,7,1,15,8,7,25
D Bucuresti,6135,3,4,5,5,19,19,0,17
FC Botosani,6135,4,3,6,5,6,13,-7,15
Universitate,6135,5,3,5,6,15,21,-6,14
Concordia Ch,6135,6,2,3,9,15,23,-8,9
FCSB,6136,1,8,5,1,26,12,14,29
CFR Cluj,6136,2,6,6,2,14,9,5,24
Universitate,6136,3,4,5,5,16,20,-4,17
FC Botosani,6136,4,4,5,5,10,14,-4,17
D Bucuresti,6136,5,3,6,5,18,20,-2,15
Concordia Ch,6136,6,2,3,9,15,24,-9,9
FCSB,6137,1,7,6,1,25,14,11,27
CFR Cluj,6137,2,5,8,1,16,10,6,23
Universitate,6137,3,4,6,4,17,19,-2,18
FC Botosani,6137,4,4,5,5,9,12,-3,17
D Bucuresti,6137,5,3,6,5,17,19,-2,15
Concordia Ch,6137,6,2,3,9,16,26,-10,9
CFR Cluj,6138,1,7,6,1,18,7,11,27
FCSB,6138,2,7,5,2,23,12,11,26
D Bucuresti,6138,3,5,4,5,20,19,1,19
Universitate,6138,4,4,5,5,15,22,-7,17
FC Botosani,6138,5,3,5,6,5,14,-9,14
Concordia Ch,6138,6,2,3,9,16,23,-7,9
FCSB,6139,1,7,6,1,24,12,12,27
CFR Cluj,6139,2,6,7,1,16,9,7,25
D Bucuresti,6139,3,4,5,5,18,19,-1,17
Universitate,6139,4,3,7,4,15,19,-4,16
FC Botosani,6139,5,4,4,6,6,13,-7,16
Concordia Ch,6139,6,2,3,9,16,23,-7,9
FCSB,6140,1,8,6,0,25,10,15,30
CFR Cluj,6140,2,5,6,3,14,11,3,21
Universitate,6140,3,4,6,4,16,19,-3,18
D Bucuresti,6140,4,4,4,6,17,19,-2,16
Concordia Ch,6140,5,4,2,8,19,21,-2,14
FC Botosani,6140,6,3,4,7,5,16,-11,13
FCSB,6141,1,8,6,0,25,11,14,30
CFR Cluj,6141,2,6,7,1,14,7,7,25
D Bucuresti,6141,3,4,4,6,20,23,-3,16
Concordia Ch,6141,4,4,2,8,20,23,-3,14
Universitate,6141,5,3,5,6,15,21,-6,14
FC Botosani,6141,6,3,4,7,6,15,-9,13
FCSB,6142,1,9,5,0,26,10,16,32
CFR Cluj,6142,2,6,6,2,14,8,6,24
D Bucuresti,6142,3,4,4,6,18,20,-2,16
Universitate,6142,4,3,5,6,14,21,-7,14
FC Botosani,6142,5,3,5,6,6,14,-8,14
Concordia Ch,6142,6,3,3,8,16,21,-5,12
CFR Cluj,6143,1,7,6,1,18,9,9,27
FCSB,6143,2,7,5,2,24,16,8,26
D Bucuresti,6143,3,4,5,5,17,18,-1,17
Universitate,6143,4,4,5,5,18,20,-2,17
FC Botosani,6143,5,4,5,5,9,13,-4,17
Concordia Ch,6143,6,2,2,10,16,26,-10,8
FCSB,6144,1,9,5,0,25,10,15,32
CFR Cluj,6144,2,6,6,2,14,8,6,24
FC Botosani,6144,3,5,4,5,10,14,-4,19
Universitate,6144,4,3,5,6,14,20,-6,14
D Bucuresti,6144,5,3,4,7,17,23,-6,13
Concordia Ch,6144,6,3,2,9,19,24,-5,11
FCSB,6145,1,8,5,1,26,12,14,29
CFR Cluj,6145,2,6,6,2,15,10,5,24
D Bucuresti,6145,3,4,5,5,20,20,0,17
Universitate,6145,4,4,5,5,15,19,-4,17
FC Botosani,6145,5,3,5,6,8,17,-9,14
Concordia Ch,6145,6,2,4,8,16,22,-6,10
FCSB,6146,1,7,6,1,24,15,9,27
CFR Cluj,6146,2,6,7,1,16,8,8,25
Universitate,6146,3,4,5,5,18,20,-2,17
D Bucuresti,6146,4,3,5,6,19,22,-3,14
Concordia Ch,6146,5,4,2,8,18,22,-4,14
FC Botosani,6146,6,3,5,6,7,15,-8,14
FCSB,6147,1,8,6,0,26,10,16,30
CFR Cluj,6147,2,6,7,1,15,8,7,25
D Bucuresti,6147,3,4,4,6,20,22,-2,16
FC Botosani,6147,4,4,4,6,8,16,-8,16
Universitate,6147,5,3,5,6,15,23,-8,14
Concordia Ch,6147,6,3,2,9,20,25,-5,11
CFR Cluj,6148,1,7,6,1,17,7,10,27
FCSB,6148,2,7,5,2,23,14,9,26
Universitate,6148,3,4,5,5,16,20,-4,17
FC Botosani,6148,4,4,5,5,8,14,-6,17
D Bucuresti,6148,5,3,4,7,18,24,-6,13
Concordia Ch,6148,6,3,3,8,20,23,-3,12
FCSB,6149,1,7,7,0,26,13,13,28
CFR Cluj,6149,2,5,8,1,15,9,6,23
FC Botosani,6149,3,5,4,5,8,12,-4,19
D Bucuresti,6149,4,4,4,6,17,19,-2,16
Universitate,6149,5,3,7,4,15,19,-4,16
Concordia Ch,6149,6,2,2,10,15,24,-9,8
FCSB,6150,1,7,5,2,26,15,11,26
CFR Cluj,6150,2,6,6,2,15,9,6,24
Universitate,6150,3,5,5,4,18,20,-2,20
D Bucuresti,6150,4,4,5,5,18,19,-1,17
FC Botosani,6150,5,3,5,6,6,15,-9,14
Concordia Ch,6150,6,3,2,9,19,24,-5,11
CFR Cluj,6151,1,7,6,1,15,7,8,27
FCSB,6151,2,7,5,2,23,12,11,26
Universitate,6151,3,4,5,5,15,19,-4,17
FC Botosani,6151,4,4,5,5,6,12,-6,17
D Bucuresti,6151,5,3,4,7,16,20,-4,13
Concordia Ch,6151,6,3,3,8,16,21,-5,12
FCSB,6152,1,7,6,1,23,11,12,27
CFR Cluj,6152,2,5,7,2,13,9,4,22
Universitate,6152,3,5,5,4,17,18,-1,20
D Bucuresti,6152,4,4,5,5,22,19,3,17
FC Botosani,6152,5,3,5,6,6,14,-8,14
Concordia Ch,6152,6,3,2,9,16,26,-10,11
FCSB,6153,1,8,6,0,27,10,17,30
CFR Cluj,6153,2,5,8,1,14,8,6,23
D Bucuresti,6153,3,4,4,6,19,19,0,16
Universitate,6153,4,3,6,5,15,23,-8,15
FC Botosani,6153,5,3,5,6,5,15,-10,14
Concordia Ch,6153,6,3,3,8,16,21,-5,12
FCSB,6154,1,8,6,0,27,11,16,30
CFR Cluj,6154,2,5,6,3,13,12,1,21
FC Botosani,6154,3,5,4,5,7,12,-5,19
Universitate,6154,4,4,6,4,17,19,-2,18
D Bucuresti,6154,5,3,4,7,16,21,-5,13
Concordia Ch,6154,6,3,2,9,17,22,-5,11
FCSB,6155,1,7,6,1,25,14,11,27
CFR Cluj,6155,2,6,6,2,15,8,7,24
Universitate,6155,3,4,6,4,17,20,-3,18
D Bucuresti,6155,4,4,4,6,18,20,-2,16
FC Botosani,6155,5,3,5,6,5,14,-9,14
Concordia Ch,6155,6,3,3,8,17,21,-4,12
FCSB,6156,1,8,5,1,24,11,13,29
CFR Cluj,6156,2,5,7,2,13,8,5,22
Universitate,6156,3,4,6,4,15,18,-3,18
FC Botosani,6156,4,4,5,5,8,13,-5,17
D Bucuresti,6156,5,3,5,6,17,22,-5,14
Concordia Ch,6156,6,3,2,9,18,23,-5,11
FCSB,6157,1,7,6,1,24,12,12,27
CFR Cluj,6157,2,7,6,1,18,8,10,27
D Bucuresti,6157,3,4,5,5,21,21,0,17
Universitate,6157,4,3,6,5,16,23,-7,15
FC Botosani,6157,5,3,5,6,8,17,-9,14
Concordia Ch,6157,6,2,4,8,17,23,-6,10
FCSB,6158,1,7,6,1,24,13,11,27
CFR Cluj,6158,2,6,6,2,17,11,6,24
D Bucuresti,6158,3,5,4,5,18,18,0,19
Universitate,6158,4,4,6,4,17,19,-2,18
FC Botosani,6158,5,3,4,7,5,16,-11,13
Concordia Ch,6158,6,3,2,9,18,22,-4,11
FCSB,6159,1,7,6,1,26,14,12,27
CFR Cluj,6159,2,5,8,1,17,11,6,23
Universitate,6159,3,4,6,4,18,21,-3,18
FC Botosani,6159,4,4,5,5,7,13,-6,17
D Bucuresti,6159,5,4,4,6,18,20,-2,16
Concordia Ch,6159,6,2,3,9,15,22,-7,9
FCSB,6160,1,8,5,1,26,13,13,29
CFR Cluj,6160,2,6,6,2,15,9,6,24
D Bucuresti,6160,3,4,5,5,19,20,-1,17
Universitate,6160,4,4,5,5,16,20,-4,17
FC Botosani,6160,5,4,4,6,8,15,-7,16
Concordia Ch,6160,6,2,3,9,17,24,-7,9
FCSB,6161,1,8,6,0,26,12,14,30
CFR Cluj,6161,2,5,7,2,15,10,5,22
Universitate,6161,3,4,5,5,15,19,-4,17
D Bucuresti,6161,4,3,6,5,17,19,-2,15
FC Botosani,6161,5,3,5,6,7,15,-8,14
Concordia Ch,6161,6,3,3,8,19,24,-5,12
FCSB,6162,1,8,5,1,25,11,14,29
CFR Cluj,6162,2,6,6,2,18,10,8,24
FC Botosani,6162,3,4,5,5,6,12,-6,17
Universitate,6162,4,4,5,5,16,23,-7,17
D Bucuresti,6162,5,3,5,6,16,21,-5,14
Concordia Ch,6162,6,3,2,9,18,22,-4,11
FCSB,6163,1,8,6,0,27,13,14,30
CFR Cluj,6163,2,5,7,2,16,11,5,22
FC Botosani,6163,3,4,5,5,7,13,-6,17
Universitate,6163,4,3,7,4,16,20,-4,16
D Bucuresti,6163,5,3,5,6,17,21,-4,14
Concordia Ch,6163,6,3,2,9,19,24,-5,11
FCSB,6164,1,8,6,0,25,11,14,30
CFR Cluj,6164,2,5,7,2,14,13,1,22
Universitate,6164,3,4,5,5,19,19,0,17
D Bucuresti,6164,4,4,5,5,18,19,-1,17
FC Botosani,6164,5,4,4,6,7,13,-6,16
Concordia Ch,6164,6,2,3,9,16,24,-8,9
FCSB,6165,1,7,6,1,23,11,12,27
CFR Cluj,6165,2,6,7,1,14,7,7,25
Universitate,6165,3,4,5,5,15,19,-4,17
D Bucuresti,6165,4,3,6,5,17,19,-2,15
FC Botosani,6165,5,3,6,5,6,13,-7,15
Concordia Ch,6165,6,2,4,8,17,23,-6,10
FCSB,6166,1,8,5,1,25,13,12,29
CFR Cluj,6166,2,6,6,2,15,8,7,24
Universitate,6166,3,4,5,5,16,20,-4,17
D Bucuresti,6166,4,4,4,6,17,19,-2,16
FC Botosani,6166,5,4,4,6,6,13,-7,16
Concordia Ch,6166,6,3,2,9,16,22,-6,11
FCSB,6167,1,7,5,2,23,14,9,26
CFR Cluj,6167,2,6,6,2,14,8,6,24
Universitate,6167,3,5,5,4,18,18,0,20
FC Botosani,6167,4,4,5,5,7,13,-6,17
D Bucuresti,6167,5,3,5,6,17,20,-3,14
Concordia Ch,6167,6,3,2,9,18,24,-6,11
FCSB,6168,1,7,5,2,23,13,10,26
CFR Cluj,6168,2,6,7,1,16,9,7,25
Universitate,6168,3,4,6,4,18,20,-2,18
D Bucuresti,6168,4,3,6,5,16,18,-2,15
FC Botosani,6168,5,3,6,5,5,12,-7,15
Concordia Ch,6168,6,2,4,8,15,21,-6,10
FCSB,6169,1,7,6,1,24,13,11,27
CFR Cluj,6169,2,6,7,1,17,9,8,25
FC Botosani,6169,3,5,4,5,11,15,-4,19
Universitate,6169,4,3,7,4,17,21,-4,16
D Bucuresti,6169,5,3,5,6,18,22,-4,14
Concordia Ch,6169,6,2,3,9,18,25,-7,9
FCSB,6170,1,7,6,1,24,13,11,27
CFR Cluj,6170,2,6,6,2,16,10,6,24
Universitate,6170,3,4,6,4,16,18,-2,18
FC Botosani,6170,4,4,5,5,7,13,-6,17
D Bucuresti,6170,5,3,4,7,16,22,-6,13
Concordia Ch,6170,6,3,3,8,19,22,-3,12
FCSB,6171,1,7,6,1,25,14,11,27
CFR Cluj,6171,2,5,7,2,14,9,5,22
Universitate,6171,3,5,5,4,18,19,-1,20
D Bucuresti,6171,4,4,4,6,19,20,-1,16
Concordia Ch,6171,5,4,2,8,19,22,-3,14
FC Botosani,6171,6,3,4,7,5,16,-11,13
FCSB,6172,1,7,7,0,25,12,13,28
CFR Cluj,6172,2,5,8,1,15,9,6,23
D Bucuresti,6172,3,4,5,5,18,19,-1,17
Universitate,6172,4,3,7,4,16,20,-4,16
FC Botosani,6172,5,3,4,7,5,14,-9,13
Concordia Ch,6172,6,3,3,8,17,22,-5,12
FCSB,6173,1,8,6,0,27,11,16,30
CFR Cluj,6173,2,6,7,1,15,7,8,25
D Bucuresti,6173,3,4,4,6,18,22,-4,16
FC Botosani,6173,4,3,5,6,7,15,-8,14
Universitate,6173,5,3,5,6,15,24,-9,14
Concordia Ch,6173,6,3,3,8,21,24,-3,12
FCSB,6174,1,8,5,1,25,11,14,29
CFR Cluj,6174,2,5,6,3,13,10,3,21
Universitate,6174,3,5,5,4,16,18,-2,20
D Bucuresti,6174,4,5,4,5,20,18,2,19
FC Botosani,6174,5,3,4,7,6,16,-10,13
Concordia Ch,6174,6,3,2,9,17,24,-7,11
FCSB,6175,1,8,6,0,24,10,14,30
CFR Cluj,6175,2,5,8,1,13,7,6,23
D Bucuresti,6175,3,4,4,6,17,20,-3,16
Universitate,6175,4,3,6,5,14,19,-5,15
Concordia Ch,6175,5,4,2,8,18,21,-3,14
FC Botosani,6175,6,3,4,7,5,14,-9,13
FCSB,6176,1,8,6,0,24,10,14,30
CFR Cluj,6176,2,5,6,3,13,10,3,21
Universitate,6176,3,4,6,4,16,18,-2,18
FC Botosani,6176,4,4,5,5,8,14,-6,17
D Bucuresti,6176,5,3,5,6,17,24,-7,14
Concordia Ch,6176,6,3,2,9,23,25,-2,11
FCSB,6177,1,7,7,0,25,12,13,28
CFR Cluj,6177,2,5,7,2,15,10,5,22
Universitate,6177,3,4,6,4,15,18,-3,18
D Bucuresti,6177,4,4,5,5,20,21,-1,17
FC Botosani,6177,5,4,5,5,7,13,-6,17
Concordia Ch,6177,6,2,2,10,17,25,-8,8
FCSB,6178,1,8,5,1,25,14,11,29
CFR Cluj,6178,2,5,7,2,13,8,5,22
Universitate,6178,3,4,6,4,18,19,-1,18
D Bucuresti,6178,4,4,4,6,17,19,-2,16
FC Botosani,6178,5,3,5,6,6,14,-8,14
Concordia Ch,6178,6,3,3,8,17,22,-5,12
FCSB,6179,1,7,6,1,24,13,11,27
CFR Cluj,6179,2,6,6,2,15,10,5,24
Universitate,6179,3,4,6,4,18,19,-1,18
FC Botosani,6179,4,4,5,5,8,14,-6,17
D Bucuresti,6179,5,3,4,7,18,23,-5,13
Concordia Ch,6179,6,3,3,8,19,23,-4,12
FCSB,6180,1,9,5,0,25,10,15,32
CFR Cluj,6180,2,5,7,2,13,8,5,22
D Bucuresti,6180,3,4,5,5,20,19,1,17
Universitate,6180,4,3,6,5,14,19,-5,15
FC Botosani,6180,5,3,6,5,6,13,-7,15
Concordia Ch,6180,6,2,3,9,17,26,-9,9
FCSB,6181,1,8,5,1,25,13,12,29
CFR Cluj,6181,2,5,7,2,14,9,5,22
Universitate,6181,3,4,6,4,18,20,-2,18
D Bucuresti,6181,4,4,5,5,18,18,0,17
FC Botosani,6181,5,4,4,6,9,14,-5,16
Concordia Ch,6181,6,2,3,9,15,25,-10,9
FCSB,6182,1,8,6,0,30,13,17,30
CFR Cluj,6182,2,6,7,1,18,9,9,25
D Bucuresti,6182,3,4,5,5,20,21,-1,17
FC Botosani,6182,4,4,4,6,10,14,-4,16
Universitate,6182,5,3,5,6,15,26,-11,14
Concordia Ch,6182,6,2,3,9,17,27,-10,9
FCSB,6183,1,8,5,1,25,11,14,29
CFR Cluj,6183,2,5,7,2,13,9,4,22
D Bucuresti,6183,3,5,4,5,22,20,2,19
Universitate,6183,4,4,6,4,15,18,-3,18
FC Botosani,6183,5,3,5,6,6,16,-10,14
Concordia Ch,6183,6,2,3,9,16,23,-7,9
FCSB,6184,1,8,5,1,25,13,12,29
CFR Cluj,6184,2,6,6,2,15,8,7,24
Universitate,6184,3,4,5,5,17,21,-4,17
FC Botosani,6184,4,4,5,5,8,14,-6,17
D Bucuresti,6184,5,3,5,6,18,22,-4,14
Concordia Ch,6184,6,3,2,9,17,22,-5,11
FCSB,6185,1,8,6,0,26,12,14,30
CFR Cluj,6185,2,6,6,2,19,10,9,24
FC Botosani,6185,3,4,5,5,9,15,-6,17
Universitate,6185,4,3,6,5,16,24,-8,15
D Bucuresti,6185,5,3,4,7,17,25,-8,13
Concordia Ch,6185,6,3,3,8,22,23,-1,12
FCSB,6186,1,7,6,1,23,12,11,27
CFR Cluj,6186,2,6,7,1,16,9,7,25
Universitate,6186,3,4,5,5,18,21,-3,17
FC Botosani,6186,4,4,5,5,8,14,-6,17
D Bucuresti,6186,5,3,5,6,18,21,-3,14
Concordia Ch,6186,6,3,2,9,18,24,-6,11
FCSB,6187,1,8,5,1,27,13,14,29
CFR Cluj,6187,2,7,6,1,16,7,9,27
FC Botosani,6187,3,4,4,6,8,15,-7,16
Concordia Ch,6187,4,4,2,8,23,25,-2,14
Universitate,6187,5,3,5,6,16,24,-8,14
D Bucuresti,6187,6,3,4,7,18,24,-6,13
FCSB,6188,1,9,5,0,28,11,17,32
CFR Cluj,6188,2,5,6,3,13,9,4,21
Universitate,6188,3,4,5,5,16,22,-6,17
FC Botosani,6188,4,4,5,5,7,13,-6,17
D Bucuresti,6188,5,3,4,7,17,21,-4,13
Concordia Ch,6188,6,3,3,8,18,23,-5,12
FCSB,6189,1,8,6,0,27,12,15,30
CFR Cluj,6189,2,6,6,2,14,9,5,24
D Bucuresti,6189,3,5,4,5,20,18,2,19
FC Botosani,6189,4,4,4,6,6,13,-7,16
Universitate,6189,5,3,6,5,16,21,-5,15
Concordia Ch,6189,6,2,2,10,15,25,-10,8
CFR Cluj,6190,1,7,6,1,18,8,10,27
FCSB,6190,2,7,5,2,24,15,9,26
Universitate,6190,3,4,5,5,17,21,-4,17
D Bucuresti,6190,4,4,4,6,22,22,0,16
FC Botosani,6190,5,3,5,6,6,16,-10,14
Concordia Ch,6190,6,3,3,8,18,23,-5,12
FCSB,6191,1,8,5,1,26,13,13,29
CFR Cluj,6191,2,5,7,2,15,10,5,22
Universitate,6191,3,4,6,4,17,20,-3,18
D Bucuresti,6191,4,4,5,5,18,19,-1,17
FC Botosani,6191,5,4,4,6,8,13,-5,16
Concordia Ch,6191,6,2,3,9,16,25,-9,9
FCSB,6192,1,7,6,1,24,12,12,27
CFR Cluj,6192,2,6,7,1,17,10,7,25
D Bucuresti,6192,3,4,5,5,17,18,-1,17
Universitate,6192,4,4,5,5,17,21,-4,17
FC Botosani,6192,5,4,5,5,8,14,-6,17
Concordia Ch,6192,6,2,2,10,17,25,-8,8
FCSB,6193,1,8,5,1,24,11,13,29
CFR Cluj,6193,2,7,6,1,16,7,9,27
D Bucuresti,6193,3,4,4,6,18,20,-2,16
FC Botosani,6193,4,4,4,6,8,14,-6,16
Universitate,6193,5,3,5,6,14,21,-7,14
Concordia Ch,6193,6,3,2,9,16,23,-7,11
FCSB,6194,1,9,5,0,29,12,17,32
CFR Cluj,6194,2,5,7,2,15,12,3,22
D Bucuresti,6194,3,4,5,5,20,19,1,17
Universitate,6194,4,3,6,5,14,19,-5,15
FC Botosani,6194,5,3,5,6,9,19,-10,14
Concordia Ch,6194,6,2,4,8,18,24,-6,10
FCSB,6195,1,8,5,1,25,11,14,29
CFR Cluj,6195,2,7,6,1,19,10,9,27
D Bucuresti,6195,3,5,4,5,19,18,1,19
Universitate,6195,4,3,5,6,17,25,-8,14
FC Botosani,6195,5,3,4,7,6,16,-10,13
Concordia Ch,6195,6,3,2,9,18,24,-6,11
FCSB,6196,1,8,5,1,25,11,14,29
CFR Cluj,6196,2,5,6,3,13,10,3,21
Universitate,6196,3,5,5,4,16,18,-2,20
D Bucuresti,6196,4,4,4,6,19,20,-1,16
Concordia Ch,6196,5,4,2,8,19,22,-3,14
FC Botosani,6196,6,3,4,7,6,17,-11,13
FCSB,6197,1,7,7,0,24,11,13,28
CFR Cluj,6197,2,6,7,1,17,9,8,25
D Bucuresti,6197,3,4,5,5,19,20,-1,17
Universitate,6197,4,3,6,5,15,21,-6,15
FC Botosani,6197,5,3,5,6,6,14,-8,14
Concordia Ch,6197,6,2,4,8,16,22,-6,10
CFR Cluj,6198,1,7,6,1,16,8,8,27
FCSB,6198,2,7,5,2,24,14,10,26
D Bucuresti,6198,3,5,4,5,20,19,1,19
Universitate,6198,4,4,5,5,18,21,-3,17
FC Botosani,6198,5,4,4,6,6,13,-7,16
Concordia Ch,6198,6,2,2,10,16,25,-9,8
FCSB,6199,1,8,5,1,26,11,15,29
CFR Cluj,6199,2,7,6,1,17,7,10,27
D Bucuresti,6199,3,4,5,5,18,19,-1,17
FC Botosani,6199,4,4,4,6,7,13,-6,16
Universitate,6199,5,3,5,6,14,24,-10,14
Concordia Ch,6199,6,2,3,9,16,24,-8,9
FCSB,6200,1,7,6,1,23,11,12,27
CFR Cluj,6200,2,6,7,1,15,7,8,25
D Bucuresti,6200,3,4,5,5,20,20,0,17
Universitate,6200,4,4,5,5,15,20,-5,17
FC Botosani,6200,5,3,6,5,9,16,-7,15
Concordia Ch,6200,6,2,3,9,17,25,-8,9
FCSB,6201,1,8,6,0,26,12,14,30
CFR Cluj,6201,2,5,8,1,13,7,6,23
D Bucuresti,6201,3,4,4,6,20,21,-1,16
Universitate,6201,4,3,6,5,16,21,-5,15
Concordia Ch,6201,5,4,2,8,18,22,-4,14
FC Botosani,6201,6,3,4,7,6,16,-10,13
FCSB,6202,1,8,6,0,25,11,14,30
CFR Cluj,6202,2,5,7,2,13,8,5,22
Universitate,6202,3,4,5,5,16,20,-4,17
D Bucuresti,6202,4,4,4,6,18,21,-3,16
FC Botosani,6202,5,4,4,6,6,14,-8,16
Concordia Ch,6202,6,3,2,9,18,22,-4,11
FCSB,6203,1,8,5,1,25,12,13,29
CFR Cluj,6203,2,5,7,2,13,8,5,22
FC Botosani,6203,3,5,4,5,7,12,-5,19
Universitate,6203,4,4,6,4,16,19,-3,18
D Bucuresti,6203,5,4,4,6,17,19,-2,16
Concordia Ch,6203,6,2,2,10,15,23,-8,8
FCSB,6204,1,7,7,0,24,11,13,28
CFR Cluj,6204,2,5,8,1,15,9,6,23
D Bucuresti,6204,3,4,5,5,19,20,-1,17
Universitate,6204,4,3,7,4,15,19,-4,16
FC Botosani,6204,5,3,6,5,7,14,-7,15
Concordia Ch,6204,6,2,3,9,17,24,-7,9
FCSB,6205,1,7,6,1,25,13,12,27
CFR Cluj,6205,2,5,7,2,15,10,5,22
Universitate,6205,3,5,5,4,18,20,-2,20
D Bucuresti,6205,4,4,5,5,19,20,-1,17
FC Botosani,6205,5,3,5,6,8,17,-9,14
Concordia Ch,6205,6,3,2,9,20,25,-5,11
FCSB,6206,1,9,5,0,27,11,16,32
CFR Cluj,6206,2,5,6,3,14,10,4,21
Universitate,6206,3,4,5,5,17,22,-5,17
FC Botosani,6206,4,4,5,5,6,12,-6,17
D Bucuresti,6206,5,3,4,7,16,21,-5,13
Concordia Ch,6206,6,3,3,8,17,21,-4,12
FCSB,6207,1,8,5,1,25,12,13,29
CFR Cluj,6207,2,5,7,2,16,12,4,22
FC Botosani,6207,3,5,4,5,8,12,-4,19
Universitate,6207,4,4,6,4,19,21,-2,18
D Bucuresti,6207,5,4,4,6,19,20,-1,16
Concordia Ch,6207,6,2,2,10,16,26,-10,8
FCSB,6208,1,8,5,1,25,13,12,29
CFR Cluj,6208,2,5,7,2,14,9,5,22
Universitate,6208,3,4,6,4,16,18,-2,18
D Bucuresti,6208,4,4,5,5,18,19,-1,17
FC Botosani,6208,5,4,5,5,7,12,-5,17
Concordia Ch,6208,6,2,2,10,16,25,-9,8
FCSB,6209,1,7,6,1,24,13,11,27
CFR Cluj,6209,2,6,7,1,16,8,8,25
FC Botosani,6209,3,4,5,5,7,12,-5,17
Universitate,6209,4,3,7,4,16,20,-4,16
D Bucuresti,6209,5,3,5,6,16,20,-4,14
Concordia Ch,6209,6,3,2,9,17,23,-6,11
FCSB,6210,1,7,7,0,25,12,13,28
CFR Cluj,6210,2,6,7,1,14,7,7,25
D Bucuresti,6210,3,4,4,6,17,19,-2,16
FC Botosani,6210,4,4,4,6,6,13,-7,16
Universitate,6210,5,3,6,5,16,21,-5,15
Concordia Ch,6210,6,3,2,9,16,22,-6,11
FCSB,6211,1,8,6,0,25,10,15,30
CFR Cluj,6211,2,5,7,2,14,10,4,22
D Bucuresti,6211,3,5,4,5,20,18,2,19
Universitate,6211,4,3,7,4,15,19,-4,16
FC Botosani,6211,5,3,4,7,6,16,-10,13
Concordia Ch,6211,6,3,2,9,17,24,-7,11
FCSB,6212,1,9,5,0,25,10,15,32
CFR Cluj,6212,2,5,6,3,13,9,4,21
Universitate,6212,3,4,5,5,15,19,-4,17
FC Botosani,6212,4,4,5,5,8,13,-5,17
D Bucuresti,6212,5,3,5,6,17,20,-3,14
Concordia Ch,6212,6,3,2,9,16,23,-7,11
FCSB,6213,1,9,5,0,26,11,15,32
CFR Cluj,6213,2,6,6,2,17,9,8,24
D Bucuresti,6213,3,4,4,6,19,21,-2,16
FC Botosani,6213,4,4,4,6,8,14,-6,16
Universitate,6213,5,3,5,6,14,22,-8,14
Concordia Ch,6213,6,3,2,9,18,25,-7,11
FCSB,6214,1,8,6,0,25,11,14,30
CFR Cluj,6214,2,6,6,2,16,8,8,24
FC Botosani,6214,3,4,5,5,7,12,-5,17
D Bucuresti,6214,4,3,6,5,18,20,-2,15
Universitate,6214,5,3,6,5,15,22,-7,15
Concordia Ch,6214,6,2,3,9,17,25,-8,9
FCSB,6215,1,8,5,1,24,11,13,29
CFR Cluj,6215,2,5,7,2,14,9,5,22
Universitate,6215,3,4,6,4,16,19,-3,18
Concordia Ch,6215,4,4,2,8,19,21,-2,14
D Bucuresti,6215,5,3,5,6,18,23,-5,14
FC Botosani,6215,6,3,5,6,7,15,-8,14
FCSB,6216,1,7,7,0,25,12,13,28
CFR Cluj,6216,2,6,7,1,16,9,7,25
D Bucuresti,6216,3,4,5,5,19,20,-1,17
FC Botosani,6216,4,4,4,6,7,14,-7,16
Universitate,6216,5,3,6,5,16,21,-5,15
Concordia Ch,6216,6,2,3,9,16,23,-7,9
FCSB,6217,1,8,5,1,24,11,13,29
CFR Cluj,6217,2,5,6,3,13,10,3,21
Universitate,6217,3,5,5,4,17,18,-1,20
D Bucuresti,6217,4,5,4,5,20,19,1,19
FC Botosani,6217,5,3,4,7,5,14,-9,13
Concordia Ch,6217,6,3,2,9,17,24,-7,11
FCSB,6218,1,9,5,0,29,12,17,32
CFR Cluj,6218,2,6,6,2,15,10,5,24
FC Botosani,6218,3,4,4,6,9,16,-7,16
D Bucuresti,6218,4,3,5,6,19,23,-4,14
Universitate,6218,5,3,5,6,15,22,-7,14
Concordia Ch,6218,6,3,3,8,18,22,-4,12
FCSB,6219,1,8,5,1,25,12,13,29
CFR Cluj,6219,2,6,6,2,14,8,6,24
Universitate,6219,3,4,5,5,16,20,-4,17
D Bucuresti,6219,4,4,4,6,19,23,-4,16
FC Botosani,6219,5,4,4,6,9,14,-5,16
Concordia Ch,6219,6,3,2,9,19,25,-6,11
FCSB,6220,1,7,6,1,24,12,12,27
CFR Cluj,6220,2,5,8,1,13,7,6,23
FC Botosani,6220,3,5,4,5,10,12,-2,19
Universitate,6220,4,4,6,4,16,19,-3,18
D Bucuresti,6220,5,4,4,6,18,21,-3,16
Concordia Ch,6220,6,2,2,10,16,26,-10,8
FCSB,6221,1,7,5,2,23,12,11,26
CFR Cluj,6221,2,6,6,2,15,9,6,24
Universitate,6221,3,5,5,4,17,19,-2,20
D Bucuresti,6221,4,4,5,5,20,20,0,17
FC Botosani,6221,5,4,5,5,8,14,-6,17
Concordia Ch,6221,6,2,2,10,15,24,-9,8
FCSB,6222,1,8,6,0,26,12,14,30
CFR Cluj,6222,2,5,7,2,14,9,5,22
Universitate,6222,3,4,5,5,16,20,-4,17
D Bucuresti,6222,4,4,4,6,20,22,-2,16
Concordia Ch,6222,5,4,2,8,19,23,-4,14
FC Botosani,6222,6,3,4,7,6,15,-9,13
FCSB,6223,1,8,5,1,26,12,14,29
CFR Cluj,6223,2,5,7,2,14,10,4,22
Universitate,6223,3,4,6,4,15,18,-3,18
D Bucuresti,6223,4,4,4,6,19,21,-2,16
FC Botosani,6223,5,4,4,6,6,13,-7,16
Concordia Ch,6223,6,3,2,9,18,24,-6,11
FCSB,6224,1,7,6,1,25,15,10,27
CFR Cluj,6224,2,6,7,1,16,7,9,25
FC Botosani,6224,3,5,4,5,8,13,-5,19
Universitate,6224,4,4,5,5,19,23,-4,17
D Bucuresti,6224,5,3,4,7,17,23,-6,13
Concordia Ch,6224,6,3,2,9,18,22,-4,11
FCSB,6225,1,8,5,1,25,12,13,29
CFR Cluj,6225,2,5,6,3,13,11,2,21
Universitate,6225,3,5,5,4,18,18,0,20
D Bucuresti,6225,4,4,5,5,20,20,0,17
FC Botosani,6225,5,3,4,7,7,17,-10,13
Concordia Ch,6225,6,3,3,8,18,23,-5,12
FCSB,6226,1,8,5,1,26,11,15,29
CFR Cluj,6226,2,7,6,1,15,7,8,27
D Bucuresti,6226,3,4,5,5,19,19,0,17
FC Botosani,6226,4,4,4,6,7,15,-8,16
Universitate,6226,5,3,5,6,14,22,-8,14
Concordia Ch,6226,6,2,3,9,17,24,-7,9
FCSB,6227,1,8,5,1,27,14,13,29
CFR Cluj,6227,2,7,6,1,16,8,8,27
FC Botosani,6227,3,4,5,5,8,13,-5,17
D Bucuresti,6227,4,4,4,6,18,21,-3,16
Universitate,6227,5,3,5,6,16,22,-6,14
Concordia Ch,6227,6,2,3,9,17,24,-7,9
FCSB,6228,1,9,5,0,28,12,16,32
CFR Cluj,6228,2,6,6,2,15,10,5,24
FC Botosani,6228,3,4,5,5,8,14,-6,17
Universitate,6228,4,3,5,6,17,23,-6,14
D Bucuresti,6228,5,3,4,7,18,24,-6,13
Concordia Ch,6228,6,3,3,8,20,23,-3,12
FCSB,6229,1,8,5,1,26,11,15,29
CFR Cluj,6229,2,6,6,2,16,11,5,24
FC Botosani,6229,3,5,4,5,9,13,-4,19
Universitate,6229,4,4,5,5,16,21,-5,17
D Bucuresti,6229,5,3,5,6,20,23,-3,14
Concordia Ch,6229,6,2,3,9,18,26,-8,9
FCSB,6230,1,8,6,0,28,12,16,30
CFR Cluj,6230,2,5,7,2,14,9,5,22
Universitate,6230,3,4,5,5,16,22,-6,17
FC Botosani,6230,4,4,5,5,6,12,-6,17
D Bucuresti,6230,5,3,4,7,16,20,-4,13
Concordia Ch,6230,6,3,3,8,16,21,-5,12
FCSB,6231,1,7,6,1,25,13,12,27
CFR Cluj,6231,2,6,7,1,15,8,7,25
FC Botosani,6231,3,4,5,5,9,15,-6,17
Universitate,6231,4,3,7,4,15,19,-4,16
D Bucuresti,6231,5,3,5,6,19,22,-3,14
Concordia Ch,6231,6,3,2,9,18,24,-6,11
FCSB,6232,1,9,5,0,25,10,15,32
CFR Cluj,6232,2,5,7,2,14,9,5,22
D Bucuresti,6232,3,4,5,5,18,19,-1,17
FC Botosani,6232,4,4,4,6,7,14,-7,16
Universitate,6232,5,3,6,5,15,20,-5,15
Concordia Ch,6232,6,2,3,9,15,22,-7,9
FCSB,6233,1,7,6,1,25,13,12,27
CFR Cluj,6233,2,7,6,1,17,9,8,27
FC Botosani,6233,3,4,5,5,8,14,-6,17
Universitate,6233,4,3,6,5,18,23,-5,15
D Bucuresti,6233,5,3,5,6,18,21,-3,14
Concordia Ch,6233,6,3,2,9,18,24,-6,11
FCSB,6234,1,8,5,1,25,14,11,29
CFR Cluj,6234,2,7,6,1,18,7,11,27
D Bucuresti,6234,3,4,5,5,17,18,-1,17
FC Botosani,6234,4,4,4,6,6,13,-7,16
Universitate,6234,5,3,5,6,14,21,-7,14
Concordia Ch,6234,6,2,3,9,15,22,-7,9
FCSB,6235,1,8,6,0,25,11,14,30
CFR Cluj,6235,2,5,6,3,14,11,3,21
Universitate,6235,3,4,6,4,16,18,-2,18
Concordia Ch,6235,4,4,2,8,21,21,0,14
D Bucuresti,6235,5,3,5,6,16,20,-4,14
FC Botosani,6235,6,3,5,6,5,16,-11,14
FCSB,6236,1,7,7,0,25,12,13,28
CFR Cluj,6236,2,6,7,1,17,10,7,25
D Bucuresti,6236,3,4,5,5,17,18,-1,17
Universitate,6236,4,3,6,5,15,20,-5,15
FC Botosani,6236,5,3,5,6,5,13,-8,14
Concordia Ch,6236,6,3,2,9,16,22,-6,11
FCSB,6237,1,8,6,0,26,11,15,30
CFR Cluj,6237,2,5,6,3,14,11,3,21
Universitate,6237,3,4,6,4,15,18,-3,18
D Bucuresti,6237,4,4,5,5,20,20,0,17
FC Botosani,6237,5,4,5,5,6,12,-6,17
Concordia Ch,6237,6,2,2,10,17,26,-9,8
FCSB,6238,1,7,5,2,24,13,11,26
CFR Cluj,6238,2,6,7,1,14,7,7,25
Universitate,6238,3,4,6,4,16,19,-3,18
D Bucuresti,6238,4,4,4,6,20,22,-2,16
Concordia Ch,6238,5,4,2,8,20,23,-3,14
FC Botosani,6238,6,3,4,7,7,17,-10,13
FCSB,6239,1,9,5,0,29,11,18,32
CFR Cluj,6239,2,6,6,2,15,9,6,24
FC Botosani,6239,3,4,4,6,7,16,-9,16
Concordia Ch,6239,4,4,2,8,20,21,-1,14
Universitate,6239,5,3,5,6,14,23,-9,14
D Bucuresti,6239,6,3,4,7,17,22,-5,13
FCSB,6240,1,7,6,1,24,12,12,27
CFR Cluj,6240,2,6,6,2,14,9,5,24
D Bucuresti,6240,3,5,4,5,22,18,4,19
Universitate,6240,4,4,6,4,17,19,-2,18
FC Botosani,6240,5,3,4,7,5,17,-12,13
Concordia Ch,6240,6,3,2,9,16,23,-7,11
FCSB,6241,1,8,6,0,27,13,14,30
CFR Cluj,6241,2,5,6,3,16,13,3,21
Universitate,6241,3,4,6,4,18,20,-2,18
D Bucuresti,6241,4,4,4,6,19,20,-1,16
FC Botosani,6241,5,4,4,6,7,14,-7,16
Concordia Ch,6241,6,3,2,9,17,24,-7,11
FCSB,6242,1,9,5,0,30,11,19,32
CFR Cluj,6242,2,6,6,2,15,11,4,24
D Bucuresti,6242,3,5,4,5,21,18,3,19
FC Botosani,6242,4,4,4,6,6,15,-9,16
Universitate,6242,5,3,5,6,15,23,-8,14
Concordia Ch,6242,6,2,2,10,15,24,-9,8
FCSB,6243,1,8,5,1,27,14,13,29
CFR Cluj,6243,2,5,7,2,17,12,5,22
Universitate,6243,3,4,6,4,16,19,-3,18
D Bucuresti,6243,4,4,4,6,17,19,-2,16
Concordia Ch,6243,5,4,2,8,17,21,-4,14
FC Botosani,6243,6,3,4,7,5,14,-9,13
FCSB,6244,1,7,7,0,25,12,13,28
CFR Cluj,6244,2,6,7,1,17,9,8,25
D Bucuresti,6244,3,3,6,5,17,19,-2,15
Universitate,6244,4,3,6,5,18,24,-6,15
FC Botosani,6244,5,3,6,5,7,14,-7,15
Concordia Ch,6244,6,2,4,8,16,22,-6,10
FCSB,6245,1,8,5,1,26,13,13,29
CFR Cluj,6245,2,6,6,2,16,9,7,24
Universitate,6245,3,4,5,5,16,21,-5,17
D Bucuresti,6245,4,4,4,6,18,23,-5,16
FC Botosani,6245,5,3,5,6,6,14,-8,14
Concordia Ch,6245,6,3,3,8,19,21,-2,12
FCSB,6246,1,8,6,0,27,13,14,30
CFR Cluj,6246,2,6,7,1,16,9,7,25
D Bucuresti,6246,3,4,5,5,17,18,-1,17
Universitate,6246,4,3,5,6,17,23,-6,14
FC Botosani,6246,5,3,5,6,5,13,-8,14
Concordia Ch,6246,6,2,4,8,15,21,-6,10
FCSB,6247,1,7,7,0,25,12,13,28
CFR Cluj,6247,2,5,7,2,14,9,5,22
Universitate,6247,3,4,6,4,16,19,-3,18
FC Botosani,6247,4,4,4,6,7,15,-8,16
D Bucuresti,6247,5,3,5,6,18,21,-3,14
Concordia Ch,6247,6,3,3,8,18,22,-4,12
FCSB,6248,1,7,7,0,26,13,13,28
CFR Cluj,6248,2,6,7,1,17,10,7,25
D Bucuresti,6248,3,4,5,5,17,18,-1,17
FC Botosani,6248,4,4,4,6,6,13,-7,16
Universitate,6248,5,3,6,5,14,19,-5,15
Concordia Ch,6248,6,2,3,9,15,22,-7,9
FCSB,6249,1,8,6,0,24,10,14,30
CFR Cluj,6249,2,6,6,2,15,9,6,24
FC Botosani,6249,3,5,4,5,9,12,-3,19
Universitate,6249,4,3,6,5,15,20,-5,15
D Bucuresti,6249,5,3,5,6,17,21,-4,14
Concordia Ch,6249,6,2,3,9,16,24,-8,9
FCSB,6250,1,8,5,1,25,12,13,29
CFR Cluj,6250,2,7,6,1,17,7,10,27
FC Botosani,6250,3,4,5,5,6,12,-6,17
D Bucuresti,6250,4,3,5,6,16,21,-5,14
Universitate,6250,5,3,5,6,15,23,-8,14
Concordia Ch,6250,6,3,2,9,18,22,-4,11
FCSB,6251,1,9,5,0,26,10,16,32
CFR Cluj,6251,2,5,6,3,14,10,4,21
Universitate,6251,3,4,5,5,16,21,-5,17
D Bucuresti,6251,4,3,6,5,18,20,-2,15
FC Botosani,6251,5,3,5,6,6,16,-10,14
Concordia Ch,6251,6,3,3,8,19,22,-3,12
FCSB,6252,1,7,6,1,24,12,12,27
CFR Cluj,6252,2,6,7,1,18,8,10,25
FC Botosani,6252,3,5,4,5,8,12,-4,19
Universitate,6252,4,4,5,5,15,22,-7,17
D Bucuresti,6252,5,4,4,6,17,19,-2,16
Concordia Ch,6252,6,2,2,10,15,24,-9,8
FCSB,6253,1,8,6,0,26,12,14,30
CFR Cluj,6253,2,6,7,1,17,9,8,25
Concordia Ch,6253,3,4,2,8,21,21,0,14
D Bucuresti,6253,4,3,5,6,18,25,-7,14
Universitate,6253,5,3,5,6,16,23,-7,14
FC Botosani,6253,6,3,5,6,7,15,-8,14
FCSB,6254,1,8,6,0,26,12,14,30
CFR Cluj,6254,2,6,6,2,16,10,6,24
D Bucuresti,6254,3,5,4,5,19,19,0,19
FC Botosani,6254,4,4,4,6,7,14,-7,16
Universitate,6254,5,3,6,5,16,21,-5,15
Concordia Ch,6254,6,2,2,10,15,23,-8,8
FCSB,6255,1,8,5,1,26,12,14,29
CFR Cluj,6255,2,6,7,1,16,8,8,25
Universitate,6255,3,3,6,5,15,22,-7,15
Concordia Ch,6255,4,4,2,8,21,22,-1,14
D Bucuresti,6255,5,3,5,6,18,23,-5,14
FC Botosani,6255,6,3,5,6,6,15,-9,14
FCSB,6256,1,8,6,0,28,13,15,30
CFR Cluj,6256,2,6,6,2,16,9,7,24
D Bucuresti,6256,3,4,5,5,20,21,-1,17
Universitate,6256,4,3,6,5,17,24,-7,15
FC Botosani,6256,5,3,5,6,7,15,-8,14
Concordia Ch,6256,6,3,2,9,17,23,-6,11
FCSB,6257,1,8,6,0,25,11,14,30
CFR Cluj,6257,2,5,7,2,13,8,5,22
D Bucuresti,6257,3,4,5,5,20,20,0,17
FC Botosani,6257,4,4,5,5,8,14,-6,17
Universitate,6257,5,3,7,4,15,19,-4,16
Concordia Ch,6257,6,2,2,10,17,26,-9,8
FCSB,6258,1,7,6,1,24,12,12,27
CFR Cluj,6258,2,7,6,1,16,7,9,27
FC Botosani,6258,3,4,5,5,7,13,-6,17
Universitate,6258,4,3,6,5,15,21,-6,15
D Bucuresti,6258,5,3,4,7,16,21,-5,13
Concordia Ch,6258,6,3,3,8,18,22,-4,12
FCSB,6259,1,8,6,0,24,10,14,30
CFR Cluj,6259,2,5,8,1,14,8,6,23
D Bucuresti,6259,3,4,4,6,19,20,-1,16
FC Botosani,6259,4,4,4,6,8,15,-7,16
Universitate,6259,5,3,6,5,15,20,-5,15
Concordia Ch,6259,6,3,2,9,17,24,-7,11
FCSB,6260,1,9,5,0,27,11,16,32
CFR Cluj,6260,2,5,6,3,13,10,3,21
Universitate,6260,3,4,5,5,16,20,-4,17
FC Botosani,6260,4,4,4,6,7,14,-7,16
Concordia Ch,6260,5,4,2,8,18,21,-3,14
D Bucuresti,6260,6,3,4,7,17,22,-5,13
FCSB,6261,1,8,6,0,29,14,15,30
CFR Cluj,6261,2,5,8,1,17,11,6,23
FC Botosani,6261,3,4,5,5,8,14,-6,17
Universitate,6261,4,3,6,5,16,22,-6,15
D Bucuresti,6261,5,3,4,7,19,24,-5,13
Concordia Ch,6261,6,3,3,8,20,24,-4,12
CFR Cluj,6262,1,7,6,1,16,8,8,27
FCSB,6262,2,7,5,2,23,12,11,26
Universitate,6262,3,4,5,5,16,20,-4,17
D Bucuresti,6262,4,4,4,6,18,20,-2,16
Concordia Ch,6262,5,4,2,8,19,23,-4,14
FC Botosani,6262,6,3,4,7,6,15,-9,13
FCSB,6263,1,8,6,0,29,14,15,30
CFR Cluj,6263,2,6,6,2,16,11,5,24
D Bucuresti,6263,3,4,5,5,20,19,1,17
FC Botosani,6263,4,4,5,5,7,13,-6,17
Universitate,6263,5,3,6,5,16,21,-5,15
Concordia Ch,6263,6,2,2,10,15,25,-10,8
FCSB,6264,1,9,5,0,27,11,16,32
CFR Cluj,6264,2,5,7,2,15,10,5,22
D Bucuresti,6264,3,4,5,5,20,19,1,17
Universitate,6264,4,3,6,5,17,23,-6,15
FC Botosani,6264,5,3,6,5,7,14,-7,15
Concordia Ch,6264,6,2,3,9,16,25,-9,9
FCSB,6265,1,7,7,0,28,15,13,28
CFR Cluj,6265,2,6,7,1,16,8,8,25
FC Botosani,6265,3,4,4,6,9,13,-4,16
D Bucuresti,6265,4,4,4,6,17,22,-5,16
Universitate,6265,5,3,6,5,18,24,-6,15
Concordia Ch,6265,6,3,2,9,16,22,-6,11
FCSB,6266,1,7,7,0,27,14,13,28
CFR Cluj,6266,2,6,7,1,16,9,7,25
D Bucuresti,6266,3,4,4,6,18,20,-2,16
Universitate,6266,4,3,6,5,16,21,-5,15
FC Botosani,6266,5,3,5,6,7,15,-8,14
Concordia Ch,6266,6,3,3,8,17,22,-5,12
FCSB,6267,1,8,6,0,27,10,17,30
CFR Cluj,6267,2,5,7,2,13,11,2,22
Universitate,6267,3,3,7,4,14,18,-4,16
FC Botosani,6267,4,3,6,5,5,12,-7,15
D Bucuresti,6267,5,3,5,6,18,22,-4,14
Concordia Ch,6267,6,3,3,8,19,23,-4,12
CFR Cluj,6268,1,7,6,1,17,9,8,27
FCSB,6268,2,7,5,2,26,15,11,26
D Bucuresti,6268,3,5,4,5,21,18,3,19
Universitate,6268,4,4,5,5,16,20,-4,17
FC Botosani,6268,5,3,4,7,6,16,-10,13
Concordia Ch,6268,6,3,2,9,18,26,-8,11
FCSB,6269,1,7,7,0,25,12,13,28
CFR Cluj,6269,2,5,7,2,14,9,5,22
D Bucuresti,6269,3,5,4,5,22,20,2,19
Universitate,6269,4,4,6,4,16,19,-3,18
FC Botosani,6269,5,4,4,6,12,15,-3,16
Concordia Ch,6269,6,2,2,10,17,31,-14,8
FCSB,6270,1,8,6,0,25,11,14,30
CFR Cluj,6270,2,6,6,2,15,8,7,24
D Bucuresti,6270,3,4,4,6,20,23,-3,16
FC Botosani,6270,4,4,4,6,8,17,-9,16
Universitate,6270,5,3,6,5,15,21,-6,15
Concordia Ch,6270,6,3,2,9,20,23,-3,11
FCSB,6271,1,8,6,0,26,11,15,30
CFR Cluj,6271,2,6,6,2,15,9,6,24
D Bucuresti,6271,3,4,4,6,19,23,-4,16
Universitate,6271,4,3,6,5,15,21,-6,15
Concordia Ch,6271,5,4,2,8,20,21,-1,14
FC Botosani,6271,6,3,4,7,7,17,-10,13
FCSB,6272,1,9,5,0,29,12,17,32
CFR Cluj,6272,2,6,6,2,17,10,7,24
FC Botosani,6272,3,4,5,5,8,13,-5,17
D Bucuresti,6272,4,3,6,5,17,19,-2,15
Universitate,6272,5,3,5,6,16,25,-9,14
Concordia Ch,6272,6,2,3,9,15,23,-8,9
FCSB,6273,1,7,6,1,25,14,11,27
CFR Cluj,6273,2,5,8,1,18,12,6,23
Universitate,6273,3,4,6,4,19,21,-2,18
D Bucuresti,6273,4,3,6,5,17,19,-2,15
FC Botosani,6273,5,3,6,5,9,16,-7,15
Concordia Ch,6273,6,2,4,8,18,24,-6,10
FCSB,6274,1,7,5,2,23,13,10,26
CFR Cluj,6274,2,6,6,2,14,9,5,24
Universitate,6274,3,5,5,4,18,18,0,20
D Bucuresti,6274,4,4,4,6,18,20,-2,16
FC Botosani,6274,5,4,4,6,8,15,-7,16
Concordia Ch,6274,6,3,2,9,17,23,-6,11
FCSB,6275,1,7,5,2,24,13,11,26
CFR Cluj,6275,2,6,6,2,15,9,6,24
Universitate,6275,3,5,5,4,18,20,-2,20
FC Botosani,6275,4,4,5,5,6,12,-6,17
D Bucuresti,6275,5,3,5,6,16,19,-3,14
Concordia Ch,6275,6,2,4,8,15,21,-6,10
FCSB,6276,1,7,6,1,25,14,11,27
CFR Cluj,6276,2,5,7,2,14,9,5,22
Universitate,6276,3,5,5,4,20,21,-1,20
FC Botosani,6276,4,4,5,5,6,12,-6,17
D Bucuresti,6276,5,3,4,7,19,23,-4,13
Concordia Ch,6276,6,3,3,8,19,24,-5,12
FCSB,6277,1,8,5,1,27,15,12,29
CFR Cluj,6277,2,6,6,2,17,9,8,24
D Bucuresti,6277,3,4,5,5,18,19,-1,17
Universitate,6277,4,4,5,5,18,23,-5,17
FC Botosani,6277,5,4,4,6,7,14,-7,16
Concordia Ch,6277,6,2,3,9,17,24,-7,9
FCSB,6278,1,8,6,0,27,13,14,30
CFR Cluj,6278,2,6,7,1,16,8,8,25
FC Botosani,6278,3,3,6,5,7,14,-7,15
D Bucuresti,6278,4,3,5,6,18,25,-7,14
Universitate,6278,5,3,5,6,16,23,-7,14
Concordia Ch,6278,6,3,3,8,22,23,-1,12
FCSB,6279,1,9,5,0,29,13,16,32
CFR Cluj,6279,2,5,6,3,14,10,4,21
D Bucuresti,6279,3,4,5,5,20,21,-1,17
Universitate,6279,4,4,5,5,17,22,-5,17
FC Botosani,6279,5,3,5,6,7,15,-8,14
Concordia Ch,6279,6,3,2,9,17,23,-6,11
FCSB,6280,1,9,5,0,27,10,17,32
CFR Cluj,6280,2,6,6,2,17,9,8,24
D Bucuresti,6280,3,4,4,6,20,21,-1,16
Concordia Ch,6280,4,4,2,8,17,21,-4,14
Universitate,6280,5,3,5,6,14,24,-10,14
FC Botosani,6280,6,3,4,7,7,17,-10,13
FCSB,6281,1,7,7,0,24,11,13,28
CFR Cluj,6281,2,5,7,2,14,9,5,22
Universitate,6281,3,4,6,4,15,18,-3,18
D Bucuresti,6281,4,4,4,6,19,23,-4,16
Concordia Ch,6281,5,4,2,8,22,23,-1,14
FC Botosani,6281,6,3,4,7,6,16,-10,13
FCSB,6282,1,8,5,1,24,11,13,29
CFR Cluj,6282,2,6,6,2,16,8,8,24
Universitate,6282,3,4,5,5,15,21,-6,17
D Bucuresti,6282,4,3,5,6,17,20,-3,14
Concordia Ch,6282,5,4,2,8,17,21,-4,14
FC Botosani,6282,6,3,5,6,6,14,-8,14
FCSB,6283,1,7,7,0,26,13,13,28
CFR Cluj,6283,2,6,7,1,16,9,7,25
FC Botosani,6283,3,5,4,5,10,13,-3,19
D Bucuresti,6283,4,4,4,6,21,22,-1,16
Universitate,6283,5,3,6,5,15,20,-5,15
Concordia Ch,6283,6,2,2,10,17,28,-11,8
FCSB,6284,1,7,7,0,24,11,13,28
CFR Cluj,6284,2,6,7,1,15,8,7,25
FC Botosani,6284,3,4,5,5,6,12,-6,17
D Bucuresti,6284,4,3,6,5,18,20,-2,15
Universitate,6284,5,3,6,5,16,21,-5,15
Concordia Ch,6284,6,2,3,9,17,24,-7,9
FCSB,6285,1,7,7,0,24,11,13,28
CFR Cluj,6285,2,5,8,1,14,8,6,23
FC Botosani,6285,3,4,5,5,7,12,-5,17
D Bucuresti,6285,4,4,4,6,20,21,-1,16
Universitate,6285,5,3,7,4,16,20,-4,16
Concordia Ch,6285,6,2,3,9,16,25,-9,9
FCSB,6286,1,8,6,0,28,13,15,30
CFR Cluj,6286,2,5,7,2,16,12,4,22
Universitate,6286,3,4,5,5,18,22,-4,17
FC Botosani,6286,4,4,5,5,8,14,-6,17
D Bucuresti,6286,5,4,4,6,20,22,-2,16
Concordia Ch,6286,6,2,3,9,16,23,-7,9
FCSB,6287,1,8,5,1,26,13,13,29
CFR Cluj,6287,2,6,6,2,16,10,6,24
Universitate,6287,3,4,5,5,17,21,-4,17
FC Botosani,6287,4,4,5,5,9,15,-6,17
D Bucuresti,6287,5,3,5,6,18,21,-3,14
Concordia Ch,6287,6,3,2,9,17,23,-6,11
FCSB,6288,1,8,5,1,25,14,11,29
CFR Cluj,6288,2,6,7,1,18,9,9,25
FC Botosani,6288,3,4,5,5,8,13,-5,17
D Bucuresti,6288,4,3,6,5,18,20,-2,15
Universitate,6288,5,3,6,5,17,22,-5,15
Concordia Ch,6288,6,2,3,9,16,24,-8,9
FCSB,6289,1,8,5,1,25,13,12,29
CFR Cluj,6289,2,6,6,2,16,10,6,24
D Bucuresti,6289,3,4,5,5,18,19,-1,17
Universitate,6289,4,4,5,5,17,20,-3,17
FC Botosani,6289,5,3,5,6,7,16,-9,14
Concordia Ch,6289,6,3,2,9,18,23,-5,11
FCSB,6290,1,7,7,0,24,11,13,28
CFR Cluj,6290,2,6,7,1,14,7,7,25
D Bucuresti,6290,3,4,4,6,21,20,1,16
FC Botosani,6290,4,4,4,6,8,17,-9,16
Universitate,6290,5,3,6,5,15,20,-5,15
Concordia Ch,6290,6,3,2,9,19,26,-7,11
FCSB,6291,1,8,6,0,27,12,15,30
CFR Cluj,6291,2,6,6,2,15,9,6,24
D Bucuresti,6291,3,4,5,5,19,19,0,17
Universitate,6291,4,3,6,5,16,22,-6,15
FC Botosani,6291,5,3,5,6,5,14,-9,14
Concordia Ch,6291,6,2,4,8,16,22,-6,10
FCSB,6292,1,7,7,0,25,12,13,28
CFR Cluj,6292,2,6,7,1,17,9,8,25
D Bucuresti,6292,3,4,4,6,17,22,-5,16
Universitate,6292,4,3,6,5,14,20,-6,15
FC Botosani,6292,5,3,5,6,6,14,-8,14
Concordia Ch,6292,6,3,3,8,20,22,-2,12
FCSB,6293,1,7,6,1,26,15,11,27
CFR Cluj,6293,2,6,7,1,18,10,8,25
Universitate,6293,3,3,7,4,16,20,-4,16
FC Botosani,6293,4,4,4,6,7,13,-6,16
Concordia Ch,6293,5,4,2,8,17,21,-4,14
D Bucuresti,6293,6,3,4,7,16,21,-5,13
FCSB,6294,1,7,6,1,23,11,12,27
CFR Cluj,6294,2,5,8,1,13,7,6,23
Universitate,6294,3,4,6,4,15,18,-3,18
FC Botosani,6294,4,4,5,5,7,13,-6,17
D Bucuresti,6294,5,4,4,6,18,19,-1,16
Concordia Ch,6294,6,2,3,9,16,24,-8,9
FCSB,6295,1,8,5,1,25,12,13,29
CFR Cluj,6295,2,5,7,2,14,10,4,22
Universitate,6295,3,4,6,4,17,19,-2,18
D Bucuresti,6295,4,3,5,6,18,21,-3,14
Concordia Ch,6295,5,4,2,8,19,23,-4,14
FC Botosani,6295,6,3,5,6,7,15,-8,14
FCSB,6296,1,8,6,0,26,11,15,30
CFR Cluj,6296,2,5,8,1,16,10,6,23
FC Botosani,6296,3,5,4,5,7,12,-5,19
Universitate,6296,4,3,6,5,16,22,-6,15
D Bucuresti,6296,5,3,4,7,17,23,-6,13
Concordia Ch,6296,6,3,2,9,19,23,-4,11
FCSB,6297,1,7,7,0,26,13,13,28
CFR Cluj,6297,2,6,7,1,18,9,9,25
D Bucuresti,6297,3,4,4,6,20,21,-1,16
FC Botosani,6297,4,4,4,6,7,15,-8,16
Universitate,6297,5,3,6,5,15,22,-7,15
Concordia Ch,6297,6,3,2,9,19,25,-6,11
FCSB,6298,1,8,5,1,25,14,11,29
CFR Cluj,6298,2,7,6,1,17,7,10,27
D Bucuresti,6298,3,5,4,5,20,18,2,19
FC Botosani,6298,4,4,4,6,8,14,-6,16
Universitate,6298,5,3,5,6,15,21,-6,14
Concordia Ch,6298,6,2,2,10,16,27,-11,8
FCSB,6299,1,8,6,0,25,11,14,30
CFR Cluj,6299,2,6,7,1,18,8,10,25
FC Botosani,6299,3,4,4,6,6,13,-7,16
D Bucuresti,6299,4,3,5,6,18,21,-3,14
Universitate,6299,5,3,5,6,14,23,-9,14
Concordia Ch,6299,6,3,3,8,18,23,-5,12
FCSB,6300,1,8,5,1,24,11,13,29
CFR Cluj,6300,2,6,6,2,16,8,8,24
D Bucuresti,6300,3,4,5,5,19,20,-1,17
FC Botosani,6300,4,4,5,5,10,15,-5,17
Universitate,6300,5,4,5,5,15,21,-6,17
Concordia Ch,6300,6,2,2,10,18,27,-9,8
FCSB,6301,1,9,5,0,26,10,16,32
CFR Cluj,6301,2,5,6,3,13,9,4,21
Universitate,6301,3,4,5,5,15,20,-5,17
FC Botosani,6301,4,3,6,5,7,14,-7,15
D Bucuresti,6301,5,3,5,6,17,20,-3,14
Concordia Ch,6301,6,3,3,8,17,22,-5,12
FCSB,6302,1,7,6,1,24,15,9,27
CFR Cluj,6302,2,5,8,1,15,9,6,23
Universitate,6302,3,4,6,4,19,19,0,18
D Bucuresti,6302,4,3,6,5,17,19,-2,15
FC Botosani,6302,5,3,5,6,6,14,-8,14
Concordia Ch,6302,6,3,3,8,16,21,-5,12
FCSB,6303,1,8,6,0,26,11,15,30
CFR Cluj,6303,2,6,6,2,14,9,5,24
D Bucuresti,6303,3,4,4,6,20,23,-3,16
Universitate,6303,4,3,6,5,15,20,-5,15
FC Botosani,6303,5,3,5,6,7,17,-10,14
Concordia Ch,6303,6,3,3,8,20,22,-2,12
FCSB,6304,1,8,6,0,27,13,14,30
CFR Cluj,6304,2,6,7,1,16,9,7,25
D Bucuresti,6304,3,5,4,5,18,18,0,19
FC Botosani,6304,4,4,4,6,8,14,-6,16
Universitate,6304,5,3,5,6,17,23,-6,14
Concordia Ch,6304,6,2,2,10,16,25,-9,8
FCSB,6305,1,8,6,0,26,11,15,30
CFR Cluj,6305,2,5,8,1,13,7,6,23
D Bucuresti,6305,3,5,4,5,19,19,0,19
FC Botosani,6305,4,4,4,6,8,14,-6,16
Universitate,6305,5,3,6,5,15,21,-6,15
Concordia Ch,6305,6,2,2,10,15,24,-9,8
FCSB,6306,1,8,6,0,27,12,15,30
CFR Cluj,6306,2,6,7,1,18,9,9,25
FC Botosani,6306,3,4,5,5,10,13,-3,17
Universitate,6306,4,3,5,6,14,23,-9,14
D Bucuresti,6306,5,3,4,7,16,23,-7,13
Concordia Ch,6306,6,3,3,8,17,22,-5,12
FCSB,6307,1,9,5,0,30,13,17,32
CFR Cluj,6307,2,5,7,2,15,10,5,22
D Bucuresti,6307,3,5,4,5,20,18,2,19
FC Botosani,6307,4,4,4,6,7,14,-7,16
Universitate,6307,5,3,6,5,15,22,-7,15
Concordia Ch,6307,6,2,2,10,15,25,-10,8
FCSB,6308,1,7,6,1,24,13,11,27
CFR Cluj,6308,2,6,7,1,15,8,7,25
D Bucuresti,6308,3,4,5,5,20,21,-1,17
Universitate,6308,4,4,5,5,16,19,-3,17
FC Botosani,6308,5,4,4,6,7,14,-7,16
Concordia Ch,6308,6,2,3,9,17,24,-7,9
CFR Cluj,6309,1,7,6,1,17,7,10,27
FCSB,6309,2,7,5,2,24,15,9,26
Universitate,6309,3,4,5,5,18,22,-4,17
FC Botosani,6309,4,4,5,5,7,12,-5,17
D Bucuresti,6309,5,3,5,6,17,20,-3,14
Concordia Ch,6309,6,3,2,9,17,24,-7,11
FCSB,6310,1,8,6,0,24,10,14,30
CFR Cluj,6310,2,6,7,1,17,9,8,25
D Bucuresti,6310,3,4,5,5,18,18,0,17
FC Botosani,6310,4,3,6,5,6,13,-7,15
Universitate,6310,5,3,5,6,16,23,-7,14
Concordia Ch,6310,6,2,3,9,16,24,-8,9
FCSB,6311,1,7,7,0,25,12,13,28
CFR Cluj,6311,2,6,7,1,16,9,7,25
D Bucuresti,6311,3,4,5,5,21,21,0,17
FC Botosani,6311,4,4,4,6,8,15,-7,16
Universitate,6311,5,3,6,5,16,21,-5,15
Concordia Ch,6311,6,2,3,9,17,25,-8,9
FCSB,6312,1,9,5,0,29,12,17,32
CFR Cluj,6312,2,6,6,2,16,11,5,24
D Bucuresti,6312,3,3,6,5,20,22,-2,15
Universitate,6312,4,3,5,6,14,21,-7,14
FC Botosani,6312,5,3,5,6,7,17,-10,14
Concordia Ch,6312,6,3,3,8,20,23,-3,12
FCSB,6313,1,9,5,0,30,13,17,32
CFR Cluj,6313,2,6,6,2,16,11,5,24
FC Botosani,6313,3,4,5,5,6,12,-6,17
D Bucuresti,6313,4,3,5,6,16,19,-3,14
Universitate,6313,5,3,5,6,16,23,-7,14
Concordia Ch,6313,6,3,2,9,16,22,-6,11
FCSB,6314,1,9,5,0,28,11,17,32
CFR Cluj,6314,2,5,6,3,14,11,3,21
Universitate,6314,3,4,5,5,18,23,-5,17
FC Botosani,6314,4,3,6,5,7,14,-7,15
D Bucuresti,6314,5,3,5,6,16,21,-5,14
Concordia Ch,6314,6,3,3,8,20,23,-3,12
FCSB,6315,1,8,6,0,24,10,14,30
CFR Cluj,6315,2,6,7,1,14,7,7,25
D Bucuresti,6315,3,4,4,6,17,21,-4,16
Concordia Ch,6315,4,4,2,8,19,21,-2,14
Universitate,6315,5,3,5,6,14,20,-6,14
FC Botosani,6315,6,3,4,7,5,14,-9,13
FCSB,6316,1,7,5,2,24,16,8,26
CFR Cluj,6316,2,6,6,2,14,8,6,24
Universitate,6316,3,5,5,4,20,19,1,20
D Bucuresti,6316,4,5,4,5,21,18,3,19
FC Botosani,6316,5,4,4,6,9,16,-7,16
Concordia Ch,6316,6,2,2,10,15,26,-11,8
FCSB,6317,1,7,6,1,26,14,12,27
CFR Cluj,6317,2,5,7,2,15,10,5,22
Universitate,6317,3,5,5,4,17,19,-2,20
D Bucuresti,6317,4,4,4,6,19,20,-1,16
FC Botosani,6317,5,4,4,6,7,15,-8,16
Concordia Ch,6317,6,3,2,9,17,23,-6,11
FCSB,6318,1,8,6,0,27,11,16,30
CFR Cluj,6318,2,6,6,2,14,10,4,24
FC Botosani,6318,3,4,4,6,7,14,-7,16
Universitate,6318,4,3,6,5,15,20,-5,15
Concordia Ch,6318,5,4,2,8,19,23,-4,14
D Bucuresti,6318,6,3,4,7,17,21,-4,13
FCSB,6319,1,9,5,0,30,11,19,32
CFR Cluj,6319,2,5,7,2,13,12,1,22
D Bucuresti,6319,3,4,5,5,19,19,0,17
FC Botosani,6319,4,4,4,6,6,14,-8,16
Universitate,6319,5,3,6,5,15,20,-5,15
Concordia Ch,6319,6,2,3,9,16,23,-7,9
FCSB,6320,1,7,7,0,25,12,13,28
CFR Cluj,6320,2,5,8,1,16,10,6,23
D Bucuresti,6320,3,4,4,6,22,20,2,16
Universitate,6320,4,3,7,4,17,21,-4,16
Concordia Ch,6320,5,4,2,8,18,22,-4,14
FC Botosani,6320,6,3,4,7,5,18,-13,13
CFR Cluj,6321,1,7,6,1,15,7,8,27
FCSB,6321,2,7,5,2,24,13,11,26
Universitate,6321,3,4,5,5,16,20,-4,17
D Bucuresti,6321,4,4,4,6,17,20,-3,16
FC Botosani,6321,5,4,4,6,7,13,-6,16
Concordia Ch,6321,6,3,2,9,17,23,-6,11
FCSB,6322,1,8,5,1,27,14,13,29
CFR Cluj,6322,2,6,6,2,16,9,7,24
FC Botosani,6322,3,5,4,5,10,14,-4,19
Universitate,6322,4,4,5,5,17,22,-5,17
D Bucuresti,6322,5,4,4,6,18,20,-2,16
Concordia Ch,6322,6,2,2,10,18,27,-9,8
FCSB,6323,1,9,5,0,27,12,15,32
CFR Cluj,6323,2,6,6,2,15,9,6,24
FC Botosani,6323,3,4,5,5,9,15,-6,17
D Bucuresti,6323,4,3,5,6,17,21,-4,14
Universitate,6323,5,3,5,6,15,21,-6,14
Concordia Ch,6323,6,3,2,9,19,24,-5,11
FCSB,6324,1,7,7,0,25,12,13,28
CFR Cluj,6324,2,5,7,2,14,9,5,22
Universitate,6324,3,4,6,4,16,19,-3,18
D Bucuresti,6324,4,3,5,6,17,20,-3,14
Concordia Ch,6324,5,4,2,8,18,22,-4,14
FC Botosani,6324,6,3,5,6,5,13,-8,14
FCSB,6325,1,7,5,2,24,15,9,26
CFR Cluj,6325,2,6,7,1,15,8,7,25
Universitate,6325,3,4,6,4,17,18,-1,18
D Bucuresti,6325,4,4,5,5,19,19,0,17
FC Botosani,6325,5,3,5,6,6,16,-10,14
Concordia Ch,6325,6,3,2,9,18,23,-5,11
FCSB,6326,1,9,5,0,27,11,16,32
CFR Cluj,6326,2,5,7,2,14,10,4,22
Universitate,6326,3,3,6,5,16,21,-5,15
D Bucuresti,6326,4,3,5,6,16,19,-3,14
Concordia Ch,6326,5,4,2,8,17,21,-4,14
FC Botosani,6326,6,3,5,6,5,13,-8,14
FCSB,6327,1,7,7,0,25,12,13,28
CFR Cluj,6327,2,5,8,1,15,9,6,23
D Bucuresti,6327,3,4,4,6,19,21,-2,16
Universitate,6327,4,3,7,4,16,20,-4,16
FC Botosani,6327,5,3,5,6,5,13,-8,14
Concordia Ch,6327,6,3,3,8,18,23,-5,12
FCSB,6328,1,8,6,0,27,12,15,30
CFR Cluj,6328,2,6,6,2,14,9,5,24
FC Botosani,6328,3,5,4,5,8,13,-5,19
Universitate,6328,4,3,6,5,16,21,-5,15
D Bucuresti,6328,5,3,5,6,18,21,-3,14
Concordia Ch,6328,6,2,3,9,16,23,-7,9
FCSB,6329,1,7,6,1,24,12,12,27
CFR Cluj,6329,2,5,8,1,13,7,6,23
Universitate,6329,3,4,6,4,16,19,-3,18
D Bucuresti,6329,4,4,4,6,18,20,-2,16
FC Botosani,6329,5,3,5,6,6,14,-8,14
Concordia Ch,6329,6,3,3,8,16,21,-5,12
CFR Cluj,6330,1,7,6,1,18,8,10,27
FCSB,6330,2,7,5,2,24,14,10,26
Universitate,6330,3,4,5,5,15,20,-5,17
D Bucuresti,6330,4,4,4,6,18,22,-4,16
FC Botosani,6330,5,4,4,6,6,13,-7,16
Concordia Ch,6330,6,3,2,9,19,23,-4,11
FCSB,6331,1,9,5,0,29,11,18,32
CFR Cluj,6331,2,5,6,3,13,11,2,21
Universitate,6331,3,4,5,5,17,22,-5,17
FC Botosani,6331,4,4,5,5,7,12,-5,17
D Bucuresti,6331,5,3,4,7,17,23,-6,13
Concordia Ch,6331,6,3,3,8,18,22,-4,12
FCSB,6332,1,9,5,0,26,11,15,32
CFR Cluj,6332,2,6,6,2,17,9,8,24
D Bucuresti,6332,3,4,4,6,19,22,-3,16
Universitate,6332,4,3,5,6,14,22,-8,14
FC Botosani,6332,5,3,5,6,9,17,-8,14
Concordia Ch,6332,6,3,3,8,19,23,-4,12
FCSB,6333,1,7,7,0,26,13,13,28
CFR Cluj,6333,2,6,7,1,15,8,7,25
D Bucuresti,6333,3,3,6,5,17,19,-2,15
Universitate,6333,4,3,6,5,16,21,-5,15
FC Botosani,6333,5,3,5,6,5,13,-8,14
Concordia Ch,6333,6,3,3,8,17,22,-5,12
FCSB,6334,1,7,7,0,23,10,13,28
CFR Cluj,6334,2,5,8,1,13,7,6,23
FC Botosani,6334,3,4,5,5,6,12,-6,17
Universitate,6334,4,3,7,4,14,18,-4,16
D Bucuresti,6334,5,3,5,6,16,21,-5,14
Concordia Ch,6334,6,3,2,9,18,22,-4,11
FCSB,6335,1,9,5,0,27,12,15,32
CFR Cluj,6335,2,6,6,2,15,9,6,24
D Bucuresti,6335,3,4,5,5,18,19,-1,17
Universitate,6335,4,3,5,6,17,23,-6,14
FC Botosani,6335,5,3,5,6,6,14,-8,14
Concordia Ch,6335,6,3,2,9,16,22,-6,11
FCSB,6336,1,8,6,0,26,10,16,30
CFR Cluj,6336,2,5,8,1,13,7,6,23
D Bucuresti,6336,3,4,4,6,17,23,-6,16
FC Botosani,6336,4,4,4,6,9,15,-6,16
Universitate,6336,5,3,6,5,14,21,-7,15
Concordia Ch,6336,6,3,2,9,22,25,-3,11
FCSB,6337,1,8,6,0,26,12,14,30
CFR Cluj,6337,2,6,7,1,19,10,9,25
D Bucuresti,6337,3,4,4,6,21,21,0,16
Universitate,6337,4,3,5,6,17,25,-8,14
FC Botosani,6337,5,3,5,6,7,17,-10,14
Concordia Ch,6337,6,3,3,8,18,23,-5,12
FCSB,6338,1,8,6,0,26,12,14,30
CFR Cluj,6338,2,5,6,3,14,11,3,21
Universitate,6338,3,4,6,4,17,19,-2,18
D Bucuresti,6338,4,4,5,5,18,19,-1,17
FC Botosani,6338,5,3,5,6,6,17,-11,14
Concordia Ch,6338,6,3,2,9,19,22,-3,11
FCSB,6339,1,7,6,1,25,14,11,27
CFR Cluj,6339,2,7,6,1,16,7,9,27
D Bucuresti,6339,3,5,4,5,19,19,0,19
Universitate,6339,4,3,6,5,16,21,-5,15
FC Botosani,6339,5,3,4,7,6,15,-9,13
Concordia Ch,6339,6,3,2,9,16,22,-6,11
FCSB,6340,1,7,5,2,24,13,11,26
CFR Cluj,6340,2,6,7,1,15,8,7,25
D Bucuresti,6340,3,5,4,5,22,19,3,19
Universitate,6340,4,4,6,4,17,20,-3,18
FC Botosani,6340,5,3,4,7,6,16,-10,13
Concordia Ch,6340,6,3,2,9,16,24,-8,11
FCSB,6341,1,7,6,1,24,13,11,27
CFR Cluj,6341,2,5,7,2,15,11,4,22
Universitate,6341,3,5,5,4,19,19,0,20
FC Botosani,6341,4,4,5,5,9,15,-6,17
D Bucuresti,6341,5,4,4,6,19,21,-2,16
Concordia Ch,6341,6,2,3,9,16,23,-7,9
FCSB,6342,1,7,6,1,26,15,11,27
CFR Cluj,6342,2,5,8,1,16,10,6,23
Universitate,6342,3,4,6,4,20,22,-2,18
D Bucuresti,6342,4,4,4,6,19,23,-4,16
FC Botosani,6342,5,3,5,6,6,15,-9,14
Concordia Ch,6342,6,3,3,8,19,21,-2,12
FCSB,6343,1,7,7,0,25,12,13,28
CFR Cluj,6343,2,5,8,1,15,9,6,23
D Bucuresti,6343,3,4,5,5,17,18,-1,17
FC Botosani,6343,4,4,5,5,6,12,-6,17
Universitate,6343,5,3,7,4,16,20,-4,16
Concordia Ch,6343,6,2,2,10,15,23,-8,8
FCSB,6344,1,7,6,1,26,16,10,27
CFR Cluj,6344,2,6,7,1,17,9,8,25
FC Botosani,6344,3,5,4,5,9,14,-5,19
Universitate,6344,4,4,5,5,18,21,-3,17
D Bucuresti,6344,5,3,4,7,20,25,-5,13
Concordia Ch,6344,6,3,2,9,19,24,-5,11
FCSB,6345,1,8,5,1,27,13,14,29
CFR Cluj,6345,2,7,6,1,17,9,8,27
D Bucuresti,6345,3,5,4,5,19,18,1,19
Universitate,6345,4,3,5,6,16,23,-7,14
FC Botosani,6345,5,3,4,7,5,15,-10,13
Concordia Ch,6345,6,3,2,9,17,23,-6,11
FCSB,6346,1,8,5,1,24,12,12,29
CFR Cluj,6346,2,5,7,2,13,8,5,22
Universitate,6346,3,4,6,4,16,18,-2,18
D Bucuresti,6346,4,4,4,6,17,19,-2,16
FC Botosani,6346,5,4,4,6,7,14,-7,16
Concordia Ch,6346,6,3,2,9,17,23,-6,11
FCSB,6347,1,8,6,0,28,13,15,30
CFR Cluj,6347,2,5,7,2,15,10,5,22
D Bucuresti,6347,3,5,4,5,21,18,3,19
Universitate,6347,4,4,5,5,18,23,-5,17
FC Botosani,6347,5,3,4,7,5,16,-11,13
Concordia Ch,6347,6,3,2,9,17,24,-7,11
FCSB,6348,1,8,5,1,29,15,14,29
CFR Cluj,6348,2,6,6,2,17,12,5,24
Universitate,6348,3,4,5,5,17,21,-4,17
Concordia Ch,6348,4,4,2,8,19,21,-2,14
D Bucuresti,6348,5,3,5,6,16,19,-3,14
FC Botosani,6348,6,3,5,6,5,15,-10,14
FCSB,6349,1,8,5,1,25,12,13,29
CFR Cluj,6349,2,6,6,2,15,10,5,24
Universitate,6349,3,4,5,5,16,19,-3,17
D Bucuresti,6349,4,3,6,5,18,20,-2,15
FC Botosani,6349,5,3,5,6,6,16,-10,14
Concordia Ch,6349,6,3,3,8,19,22,-3,12
FCSB,6350,1,8,6,0,25,11,14,30
CFR Cluj,6350,2,5,8,1,14,8,6,23
FC Botosani,6350,3,5,4,5,9,12,-3,19
Universitate,6350,4,3,6,5,16,21,-5,15
D Bucuresti,6350,5,3,4,7,16,21,-5,13
Concordia Ch,6350,6,3,2,9,16,23,-7,11
FCSB,6351,1,9,5,0,28,13,15,32
CFR Cluj,6351,2,5,7,2,14,9,5,22
D Bucuresti,6351,3,4,4,6,17,20,-3,16
FC Botosani,6351,4,4,4,6,8,14,-6,16
Universitate,6351,5,3,6,5,16,21,-5,15
Concordia Ch,6351,6,3,2,9,18,24,-6,11
FCSB,6352,1,8,6,0,24,10,14,30
CFR Cluj,6352,2,5,6,3,15,11,4,21
Universitate,6352,3,4,6,4,17,20,-3,18
D Bucuresti,6352,4,4,4,6,18,20,-2,16
FC Botosani,6352,5,3,5,6,6,14,-8,14
Concordia Ch,6352,6,3,3,8,18,23,-5,12
FCSB,6353,1,7,6,1,23,11,12,27
CFR Cluj,6353,2,7,6,1,15,7,8,27
D Bucuresti,6353,3,3,6,5,17,19,-2,15
Universitate,6353,4,3,6,5,14,19,-5,15
FC Botosani,6353,5,3,6,5,5,12,-7,15
Concordia Ch,6353,6,2,4,8,16,22,-6,10
FCSB,6354,1,8,6,0,24,10,14,30
CFR Cluj,6354,2,6,6,2,14,8,6,24
D Bucuresti,6354,3,5,4,5,20,18,2,19
Universitate,6354,4,3,6,5,14,19,-5,15
FC Botosani,6354,5,3,5,6,6,14,-8,14
Concordia Ch,6354,6,2,3,9,16,25,-9,9
FCSB,6355,1,9,5,0,27,11,16,32
CFR Cluj,6355,2,5,6,3,14,11,3,21
D Bucuresti,6355,3,5,4,5,19,18,1,19
Universitate,6355,4,4,5,5,17,21,-4,17
FC Botosani,6355,5,3,5,6,7,16,-9,14
Concordia Ch,6355,6,2,3,9,17,24,-7,9
FCSB,6356,1,8,5,1,27,12,15,29
CFR Cluj,6356,2,7,6,1,20,9,11,27
D Bucuresti,6356,3,5,4,5,20,19,1,19
FC Botosani,6356,4,3,5,6,5,13,-8,14
Universitate,6356,5,3,5,6,15,26,-11,14
Concordia Ch,6356,6,2,3,9,16,24,-8,9
FCSB,6357,1,7,6,1,23,11,12,27
CFR Cluj,6357,2,6,7,1,15,8,7,25
D Bucuresti,6357,3,5,4,5,18,18,0,19
Universitate,6357,4,4,5,5,16,20,-4,17
FC Botosani,6357,5,3,4,7,5,15,-10,13
Concordia Ch,6357,6,3,2,9,17,22,-5,11
FCSB,6358,1,8,6,0,27,12,15,30
CFR Cluj,6358,2,5,6,3,14,12,2,21
D Bucuresti,6358,3,5,4,5,19,18,1,19
Universitate,6358,4,4,6,4,17,19,-2,18
FC Botosani,6358,5,4,4,6,7,15,-8,16
Concordia Ch,6358,6,2,2,10,16,24,-8,8
FCSB,6359,1,7,5,2,23,14,9,26
CFR Cluj,6359,2,6,6,2,14,9,5,24
Universitate,6359,3,5,5,4,19,18,1,20
D Bucuresti,6359,4,4,4,6,18,21,-3,16
Concordia Ch,6359,5,4,2,8,19,22,-3,14
FC Botosani,6359,6,3,4,7,7,16,-9,13
FCSB,6360,1,7,6,1,25,14,11,27
CFR Cluj,6360,2,6,7,1,16,9,7,25
D Bucuresti,6360,3,5,4,5,18,18,0,19
Universitate,6360,4,4,5,5,18,21,-3,17
FC Botosani,6360,5,3,5,6,5,13,-8,14
Concordia Ch,6360,6,2,3,9,15,22,-7,9
FCSB,6361,1,9,5,0,31,15,16,32
CFR Cluj,6361,2,6,6,2,18,12,6,24
FC Botosani,6361,3,4,5,5,7,13,-6,17
D Bucuresti,6361,4,3,5,6,17,23,-6,14
Universitate,6361,5,3,5,6,16,23,-7,14
Concordia Ch,6361,6,3,2,9,21,24,-3,11
FCSB,6362,1,7,6,1,24,14,10,27
CFR Cluj,6362,2,5,7,2,15,11,4,22
Universitate,6362,3,5,5,4,20,19,1,20
FC Botosani,6362,4,3,6,5,7,14,-7,15
D Bucuresti,6362,5,3,5,6,17,20,-3,14
Concordia Ch,6362,6,3,3,8,17,22,-5,12
FCSB,6363,1,9,5,0,25,10,15,32
CFR Cluj,6363,2,5,7,2,13,8,5,22
D Bucuresti,6363,3,4,5,5,20,20,0,17
FC Botosani,6363,4,4,5,5,10,14,-4,17
Universitate,6363,5,3,6,5,14,19,-5,15
Concordia Ch,6363,6,2,2,10,17,28,-11,8
FCSB,6364,1,7,6,1,24,12,12,27
CFR Cluj,6364,2,6,7,1,15,8,7,25
Universitate,6364,3,4,5,5,17,21,-4,17
D Bucuresti,6364,4,4,4,6,18,20,-2,16
FC Botosani,6364,5,4,4,6,8,14,-6,16
Concordia Ch,6364,6,3,2,9,18,25,-7,11
FCSB,6365,1,8,6,0,27,13,14,30
CFR Cluj,6365,2,6,6,2,17,9,8,24
FC Botosani,6365,3,4,5,5,9,15,-6,17
Universitate,6365,4,3,6,5,16,23,-7,15
D Bucuresti,6365,5,3,5,6,19,22,-3,14
Concordia Ch,6365,6,2,4,8,17,23,-6,10
FCSB,6366,1,8,5,1,24,12,12,29
CFR Cluj,6366,2,7,6,1,16,7,9,27
D Bucuresti,6366,3,4,5,5,19,19,0,17
Universitate,6366,4,3,5,6,14,20,-6,14
FC Botosani,6366,5,3,4,7,5,17,-12,13
Concordia Ch,6366,6,3,3,8,19,22,-3,12
FCSB,6367,1,8,5,1,29,13,16,29
CFR Cluj,6367,2,6,6,2,15,12,3,24
D Bucuresti,6367,3,5,4,5,21,19,2,19
Universitate,6367,4,4,5,5,16,20,-4,17
FC Botosani,6367,5,3,4,7,7,17,-10,13
Concordia Ch,6367,6,3,2,9,18,25,-7,11
FCSB,6368,1,9,5,0,28,12,16,32
CFR Cluj,6368,2,5,6,3,15,13,2,21
Universitate,6368,3,4,5,5,18,21,-3,17
D Bucuresti,6368,4,4,4,6,19,21,-2,16
FC Botosani,6368,5,4,4,6,7,14,-7,16
Concordia Ch,6368,6,3,2,9,19,25,-6,11
FCSB,6369,1,8,5,1,28,13,15,29
CFR Cluj,6369,2,6,6,2,18,12,6,24
D Bucuresti,6369,3,5,4,5,20,18,2,19
Universitate,6369,4,4,5,5,16,22,-6,17
FC Botosani,6369,5,4,4,6,7,16,-9,16
Concordia Ch,6369,6,2,2,10,16,24,-8,8
FCSB,6370,1,7,7,0,24,11,13,28
CFR Cluj,6370,2,5,7,2,14,9,5,22
D Bucuresti,6370,3,5,4,5,21,19,2,19
Universitate,6370,4,4,6,4,15,18,-3,18
FC Botosani,6370,5,4,4,6,6,14,-8,16
Concordia Ch,6370,6,2,2,10,16,25,-9,8
FCSB,6371,1,8,5,1,25,14,11,29
CFR Cluj,6371,2,6,6,2,19,11,8,24
Universitate,6371,3,4,5,5,17,21,-4,17
D Bucuresti,6371,4,4,4,6,18,20,-2,16
Concordia Ch,6371,5,4,2,8,17,21,-4,14
FC Botosani,6371,6,3,4,7,6,15,-9,13
FCSB,6372,1,8,6,0,27,13,14,30
CFR Cluj,6372,2,5,6,3,14,11,3,21
Universitate,6372,3,4,6,4,18,20,-2,18
D Bucuresti,6372,4,4,5,5,17,18,-1,17
FC Botosani,6372,5,3,5,6,5,14,-9,14
Concordia Ch,6372,6,3,2,9,17,22,-5,11
FCSB,6373,1,7,7,0,25,12,13,28
CFR Cluj,6373,2,6,7,1,16,8,8,25
FC Botosani,6373,3,5,4,5,11,13,-2,19
Universitate,6373,4,3,6,5,15,21,-6,15
D Bucuresti,6373,5,3,5,6,18,22,-4,14
Concordia Ch,6373,6,2,3,9,16,25,-9,9
FCSB,6374,1,8,6,0,29,11,18,30
CFR Cluj,6374,2,6,6,2,18,12,6,24
D Bucuresti,6374,3,4,5,5,22,21,1,17
Universitate,6374,4,3,6,5,15,24,-9,15
FC Botosani,6374,5,3,5,6,6,16,-10,14
Concordia Ch,6374,6,2,4,8,19,25,-6,10
FCSB,6375,1,7,7,0,25,12,13,28
CFR Cluj,6375,2,6,7,1,17,9,8,25
D Bucuresti,6375,3,5,4,5,22,21,1,19
FC Botosani,6375,4,4,4,6,9,15,-6,16
Universitate,6375,5,3,6,5,16,22,-6,15
Concordia Ch,6375,6,2,2,10,17,27,-10,8
FCSB,6376,1,8,6,0,26,12,14,30
CFR Cluj,6376,2,6,7,1,15,8,7,25
FC Botosani,6376,3,4,5,5,9,14,-5,17
D Bucuresti,6376,4,3,5,6,18,21,-3,14
Universitate,6376,5,3,5,6,17,23,-6,14
Concordia Ch,6376,6,3,2,9,18,25,-7,11
FCSB,6377,1,8,6,0,25,11,14,30
CFR Cluj,6377,2,5,8,1,14,8,6,23
D Bucuresti,6377,3,5,4,5,21,20,1,19
Universitate,6377,4,3,6,5,14,19,-5,15
FC Botosani,6377,5,3,4,7,6,18,-12,13
Concordia Ch,6377,6,3,2,9,19,23,-4,11
CFR Cluj,6378,1,7,6,1,17,7,10,27
FCSB,6378,2,7,5,2,25,16,9,26
Universitate,6378,3,4,5,5,18,22,-4,17
FC Botosani,6378,4,4,4,6,8,15,-7,16
Concordia Ch,6378,5,4,2,8,19,22,-3,14
D Bucuresti,6378,6,3,4,7,17,22,-5,13
FCSB,6379,1,7,6,1,24,13,11,27
CFR Cluj,6379,2,6,7,1,16,7,9,25
Universitate,6379,3,4,5,5,17,22,-5,17
D Bucuresti,6379,4,4,4,6,21,20,1,16
FC Botosani,6379,5,4,4,6,8,18,-10,16
Concordia Ch,6379,6,3,2,9,19,25,-6,11
CFR Cluj,6380,1,7,6,1,18,8,10,27
FCSB,6380,2,7,5,2,23,14,9,26
Universitate,6380,3,4,5,5,17,21,-4,17
FC Botosani,6380,4,4,5,5,6,12,-6,17
D Bucuresti,6380,5,3,5,6,16,19,-3,14
Concordia Ch,6380,6,3,2,9,16,22,-6,11
FCSB,6381,1,8,6,0,26,12,14,30
CFR Cluj,6381,2,6,7,1,15,8,7,25
D Bucuresti,6381,3,4,4,6,21,23,-2,16
FC Botosani,6381,4,4,4,6,9,14,-5,16
Universitate,6381,5,3,5,6,15,21,-6,14
Concordia Ch,6381,6,3,2,9,19,27,-8,11
FCSB,6382,1,8,6,0,28,12,16,30
CFR Cluj,6382,2,5,6,3,14,12,2,21
Universitate,6382,3,4,6,4,18,21,-3,18
FC Botosani,6382,4,4,5,5,8,14,-6,17
D Bucuresti,6382,5,4,4,6,18,20,-2,16
Concordia Ch,6382,6,2,3,9,16,23,-7,9
FCSB,6383,1,7,6,1,24,12,12,27
CFR Cluj,6383,2,6,7,1,14,7,7,25
Universitate,6383,3,3,7,4,15,19,-4,16
FC Botosani,6383,4,4,4,6,7,13,-6,16
Concordia Ch,6383,5,4,2,8,18,21,-3,14
D Bucuresti,6383,6,3,4,7,16,22,-6,13
FCSB,6384,1,7,6,1,25,13,12,27
CFR Cluj,6384,2,5,7,2,14,9,5,22
Universitate,6384,3,5,5,4,17,19,-2,20
D Bucuresti,6384,4,5,4,5,19,18,1,19
FC Botosani,6384,5,3,5,6,5,13,-8,14
Concordia Ch,6384,6,2,3,9,15,23,-8,9
FCSB,6385,1,7,7,0,26,13,13,28
CFR Cluj,6385,2,5,7,2,14,9,5,22
Universitate,6385,3,4,6,4,17,20,-3,18
FC Botosani,6385,4,4,5,5,8,13,-5,17
D Bucuresti,6385,5,3,5,6,17,22,-5,14
Concordia Ch,6385,6,3,2,9,20,25,-5,11
FCSB,6386,1,7,5,2,24,14,10,26
CFR Cluj,6386,2,6,7,1,15,8,7,25
FC Botosani,6386,3,5,4,5,10,13,-3,19
Universitate,6386,4,4,6,4,18,20,-2,18
D Bucuresti,6386,5,3,5,6,17,22,-5,14
Concordia Ch,6386,6,2,3,9,17,24,-7,9
FCSB,6387,1,7,6,1,24,12,12,27
CFR Cluj,6387,2,6,7,1,15,8,7,25
Universitate,6387,3,3,7,4,16,20,-4,16
FC Botosani,6387,4,4,4,6,6,13,-7,16
D Bucuresti,6387,5,3,5,6,18,21,-3,14
Concordia Ch,6387,6,3,3,8,18,23,-5,12
FCSB,6388,1,9,5,0,29,11,18,32
CFR Cluj,6388,2,6,6,2,14,10,4,24
FC Botosani,6388,3,4,5,5,7,13,-6,17
Universitate,6388,4,3,5,6,15,22,-7,14
D Bucuresti,6388,5,3,4,7,18,24,-6,13
Concordia Ch,6388,6,3,3,8,21,24,-3,12
FCSB,6389,1,8,5,1,26,13,13,29
CFR Cluj,6389,2,6,6,2,16,9,7,24
D Bucuresti,6389,3,4,5,5,21,22,-1,17
Universitate,6389,4,4,5,5,16,21,-5,17
FC Botosani,6389,5,3,5,6,7,15,-8,14
Concordia Ch,6389,6,2,4,8,19,25,-6,10
FCSB,6390,1,9,5,0,25,10,15,32
CFR Cluj,6390,2,6,6,2,14,8,6,24
D Bucuresti,6390,3,5,4,5,21,20,1,19
FC Botosani,6390,4,4,4,6,7,14,-7,16
Universitate,6390,5,3,5,6,14,20,-6,14
Concordia Ch,6390,6,2,2,10,16,25,-9,8
FCSB,6391,1,8,5,1,24,12,12,29
CFR Cluj,6391,2,6,6,2,14,8,6,24
Universitate,6391,3,4,5,5,16,19,-3,17
FC Botosani,6391,4,4,5,5,8,13,-5,17
D Bucuresti,6391,5,4,4,6,18,21,-3,16
Concordia Ch,6391,6,2,3,9,17,24,-7,9
FCSB,6392,1,8,6,0,27,13,14,30
CFR Cluj,6392,2,5,8,1,15,9,6,23
D Bucuresti,6392,3,5,4,5,19,19,0,19
Universitate,6392,4,3,6,5,17,22,-5,15
FC Botosani,6392,5,3,4,7,7,16,-9,13
Concordia Ch,6392,6,3,2,9,17,23,-6,11
FCSB,6393,1,8,6,0,27,10,17,30
CFR Cluj,6393,2,5,7,2,14,12,2,22
D Bucuresti,6393,3,4,4,6,17,19,-2,16
Universitate,6393,4,3,7,4,15,19,-4,16
FC Botosani,6393,5,4,4,6,7,13,-6,16
Concordia Ch,6393,6,3,2,9,16,23,-7,11
FCSB,6394,1,9,5,0,25,10,15,32
CFR Cluj,6394,2,6,6,2,15,9,6,24
D Bucuresti,6394,3,5,4,5,22,19,3,19
Universitate,6394,4,3,5,6,15,21,-6,14
FC Botosani,6394,5,3,5,6,5,16,-11,14
Concordia Ch,6394,6,2,3,9,16,23,-7,9
FCSB,6395,1,7,7,0,25,12,13,28
CFR Cluj,6395,2,5,7,2,14,9,5,22
FC Botosani,6395,3,5,4,5,10,13,-3,19
Universitate,6395,4,4,6,4,18,21,-3,18
D Bucuresti,6395,5,3,4,7,17,23,-6,13
Concordia Ch,6395,6,3,2,9,18,24,-6,11
FCSB,6396,1,8,6,0,25,11,14,30
CFR Cluj,6396,2,5,7,2,14,11,3,22
Universitate,6396,3,4,5,5,17,19,-2,17
FC Botosani,6396,4,3,6,5,6,13,-7,15
D Bucuresti,6396,5,3,5,6,17,20,-3,14
Concordia Ch,6396,6,3,3,8,16,21,-5,12
FCSB,6397,1,7,7,0,27,14,13,28
CFR Cluj,6397,2,6,7,1,17,10,7,25
D Bucuresti,6397,3,4,5,5,20,21,-1,17
Universitate,6397,4,3,6,5,17,22,-5,15
FC Botosani,6397,5,3,5,6,7,15,-8,14
Concordia Ch,6397,6,2,4,8,18,24,-6,10
FCSB,6398,1,8,5,1,25,12,13,29
CFR Cluj,6398,2,6,6,2,16,10,6,24
Universitate,6398,3,4,5,5,16,20,-4,17
D Bucuresti,6398,4,4,4,6,20,22,-2,16
FC Botosani,6398,5,4,4,6,8,15,-7,16
Concordia Ch,6398,6,3,2,9,19,25,-6,11
CFR Cluj,6399,1,7,6,1,16,7,9,27
FCSB,6399,2,7,5,2,23,12,11,26
Universitate,6399,3,4,5,5,15,20,-5,17
Concordia Ch,6399,4,4,2,8,19,22,-3,14
D Bucuresti,6399,5,3,5,6,16,20,-4,14
FC Botosani,6399,6,3,5,6,6,14,-8,14
FCSB,6400,1,8,5,1,26,12,14,29
CFR Cluj,6400,2,5,7,2,14,10,4,22
Universitate,6400,3,4,6,4,17,20,-3,18
D Bucuresti,6400,4,4,5,5,17,18,-1,17
FC Botosani,6400,5,3,6,5,6,13,-7,15
Concordia Ch,6400,6,2,3,9,16,23,-7,9
FCSB,6401,1,7,6,1,24,12,12,27
CFR Cluj,6401,2,7,6,1,17,8,9,27
D Bucuresti,6401,3,4,5,5,19,19,0,17
Universitate,6401,4,3,6,5,14,20,-6,15
FC Botosani,6401,5,3,5,6,5,14,-9,14
Concordia Ch,6401,6,2,4,8,16,22,-6,10
FCSB,6402,1,8,6,0,26,12,14,30
CFR Cluj,6402,2,5,8,1,14,8,6,23
FC Botosani,6402,3,4,4,6,8,15,-7,16
Universitate,6402,4,3,6,5,15,20,-5,15
Concordia Ch,6402,5,4,2,8,22,21,1,14
D Bucuresti,6402,6,3,4,7,16,25,-9,13
FCSB,6403,1,7,6,1,23,11,12,27
CFR Cluj,6403,2,7,6,1,18,8,10,27
D Bucuresti,6403,3,5,4,5,19,19,0,19
FC Botosani,6403,4,4,4,6,6,13,-7,16
Universitate,6403,5,3,6,5,15,22,-7,15
Concordia Ch,6403,6,2,2,10,16,24,-8,8
FCSB,6404,1,8,6,0,25,11,14,30
CFR Cluj,6404,2,5,6,3,14,11,3,21
Universitate,6404,3,4,6,4,18,20,-2,18
D Bucuresti,6404,4,4,4,6,20,22,-2,16
FC Botosani,6404,5,4,4,6,7,15,-8,16
Concordia Ch,6404,6,3,2,9,18,23,-5,11
FCSB,6405,1,7,6,1,24,12,12,27
CFR Cluj,6405,2,5,8,1,15,9,6,23
Universitate,6405,3,4,6,4,18,21,-3,18
D Bucuresti,6405,4,4,4,6,19,21,-2,16
FC Botosani,6405,5,4,4,6,6,14,-8,16
Concordia Ch,6405,6,3,2,9,19,24,-5,11
FCSB,6406,1,8,5,1,26,13,13,29
CFR Cluj,6406,2,7,6,1,16,7,9,27
D Bucuresti,6406,3,5,4,5,21,18,3,19
Universitate,6406,4,3,5,6,16,23,-7,14
FC Botosani,6406,5,3,5,6,6,14,-8,14
Concordia Ch,6406,6,2,3,9,16,26,-10,9
CFR Cluj,6407,1,7,6,1,16,8,8,27
FCSB,6407,2,7,5,2,25,15,10,26
Universitate,6407,3,4,5,5,17,20,-3,17
FC Botosani,6407,4,3,6,5,8,15,-7,15
D Bucuresti,6407,5,3,5,6,17,20,-3,14
Concordia Ch,6407,6,3,3,8,18,23,-5,12
FCSB,6408,1,8,6,0,27,12,15,30
CFR Cluj,6408,2,5,7,2,15,11,4,22
D Bucuresti,6408,3,5,4,5,21,20,1,19
Universitate,6408,4,3,7,4,16,20,-4,16
FC Botosani,6408,5,4,4,6,7,15,-8,16
Concordia Ch,6408,6,2,2,10,18,26,-8,8
FCSB,6409,1,8,5,1,25,11,14,29
CFR Cluj,6409,2,5,6,3,14,12,2,21
Universitate,6409,3,5,5,4,18,19,-1,20
FC Botosani,6409,4,4,4,6,6,13,-7,16
D Bucuresti,6409,5,3,5,6,17,20,-3,14
Concordia Ch,6409,6,3,3,8,17,22,-5,12
FCSB,6410,1,7,6,1,24,12,12,27
CFR Cluj,6410,2,5,7,2,15,10,5,22
Universitate,6410,3,5,5,4,19,21,-2,20
D Bucuresti,6410,4,4,4,6,18,22,-4,16
Concordia Ch,6410,5,4,2,8,21,21,0,14
FC Botosani,6410,6,3,4,7,5,16,-11,13
FCSB,6411,1,8,5,1,24,12,12,29
CFR Cluj,6411,2,5,6,3,14,11,3,21
Universitate,6411,3,5,5,4,19,19,0,20
D Bucuresti,6411,4,4,5,5,19,19,0,17
FC Botosani,6411,5,3,5,6,6,15,-9,14
Concordia Ch,6411,6,2,4,8,15,21,-6,10
FCSB,6412,1,9,5,0,25,10,15,32
CFR Cluj,6412,2,6,6,2,14,8,6,24
D Bucuresti,6412,3,4,5,5,17,18,-1,17
Universitate,6412,4,3,5,6,14,20,-6,14
FC Botosani,6412,5,3,5,6,6,14,-8,14
Concordia Ch,6412,6,2,4,8,16,22,-6,10
FCSB,6413,1,8,6,0,26,11,15,30
CFR Cluj,6413,2,6,6,2,17,10,7,24
D Bucuresti,6413,3,4,4,6,22,22,0,16
Universitate,6413,4,3,6,5,16,23,-7,15
FC Botosani,6413,5,3,5,6,7,17,-10,14
Concordia Ch,6413,6,3,3,8,19,24,-5,12
FCSB,6414,1,8,6,0,28,13,15,30
CFR Cluj,6414,2,6,6,2,16,11,5,24
D Bucuresti,6414,3,3,6,5,19,21,-2,15
Universitate,6414,4,3,6,5,17,22,-5,15
FC Botosani,6414,5,3,6,5,9,16,-7,15
Concordia Ch,6414,6,2,4,8,18,24,-6,10
FCSB,6415,1,8,6,0,26,10,16,30
CFR Cluj,6415,2,6,6,2,15,10,5,24
D Bucuresti,6415,3,5,4,5,20,19,1,19
Universitate,6415,4,3,6,5,14,20,-6,15
FC Botosani,6415,5,3,5,6,5,14,-9,14
Concordia Ch,6415,6,2,3,9,16,23,-7,9
FCSB,6416,1,8,6,0,28,12,16,30
CFR Cluj,6416,2,5,6,3,13,11,2,21
Universitate,6416,3,4,6,4,17,20,-3,18
FC Botosani,6416,4,4,5,5,7,13,-6,17
D Bucuresti,6416,5,3,5,6,17,20,-3,14
Concordia Ch,6416,6,3,2,9,16,22,-6,11
FCSB,6417,1,7,5,2,24,13,11,26
CFR Cluj,6417,2,6,6,2,14,10,4,24
Universitate,6417,3,5,5,4,19,19,0,20
D Bucuresti,6417,4,4,5,5,19,20,-1,17
FC Botosani,6417,5,4,5,5,7,13,-6,17
Concordia Ch,6417,6,2,2,10,16,24,-8,8
FCSB,6418,1,8,5,1,26,13,13,29
CFR Cluj,6418,2,6,6,2,15,9,6,24
D Bucuresti,6418,3,5,4,5,19,18,1,19
Universitate,6418,4,4,5,5,16,20,-4,17
FC Botosani,6418,5,3,5,6,5,14,-9,14
Concordia Ch,6418,6,2,3,9,15,22,-7,9
FCSB,6419,1,8,5,1,25,12,13,29
CFR Cluj,6419,2,6,7,1,16,9,7,25
D Bucuresti,6419,3,5,4,5,23,21,2,19
Universitate,6419,4,3,6,5,15,20,-5,15
FC Botosani,6419,5,3,5,6,9,19,-10,14
Concordia Ch,6419,6,2,3,9,16,23,-7,9
FCSB,6420,1,7,5,2,24,13,11,26
CFR Cluj,6420,2,6,7,1,16,9,7,25
D Bucuresti,6420,3,5,4,5,21,18,3,19
Universitate,6420,4,4,6,4,16,19,-3,18
FC Botosani,6420,5,4,4,6,7,14,-7,16
Concordia Ch,6420,6,2,2,10,16,27,-11,8
FCSB,6421,1,7,7,0,25,12,13,28
CFR Cluj,6421,2,6,7,1,15,8,7,25
D Bucuresti,6421,3,4,5,5,19,20,-1,17
FC Botosani,6421,4,4,5,5,6,12,-6,17
Universitate,6421,5,3,6,5,15,20,-5,15
Concordia Ch,6421,6,2,2,10,17,25,-8,8
CFR Cluj,6422,1,7,6,1,16,8,8,27
FCSB,6422,2,7,5,2,23,13,10,26
Universitate,6422,3,4,5,5,17,20,-3,17
FC Botosani,6422,4,4,5,5,7,13,-6,17
D Bucuresti,6422,5,3,4,7,16,21,-5,13
Concordia Ch,6422,6,3,3,8,18,22,-4,12
FCSB,6423,1,7,6,1,24,12,12,27
CFR Cluj,6423,2,7,6,1,17,7,10,27
FC Botosani,6423,3,5,4,5,8,13,-5,19
Universitate,6423,4,3,6,5,15,22,-7,15
D Bucuresti,6423,5,3,4,7,17,21,-4,13
Concordia Ch,6423,6,3,2,9,18,24,-6,11
FCSB,6424,1,7,6,1,25,14,11,27
CFR Cluj,6424,2,5,7,2,14,9,5,22
Universitate,6424,3,5,5,4,18,19,-1,20
D Bucuresti,6424,4,4,5,5,17,18,-1,17
FC Botosani,6424,5,4,5,5,6,12,-6,17
Concordia Ch,6424,6,2,2,10,15,23,-8,8
FCSB,6425,1,8,6,0,26,11,15,30
CFR Cluj,6425,2,5,8,1,13,7,6,23
D Bucuresti,6425,3,4,4,6,17,21,-4,16
Universitate,6425,4,3,6,5,15,21,-6,15
Concordia Ch,6425,5,4,2,8,22,24,-2,14
FC Botosani,6425,6,3,4,7,8,17,-9,13
CFR Cluj,6426,1,7,6,1,15,7,8,27
FCSB,6426,2,7,5,2,23,12,11,26
Universitate,6426,3,4,5,5,15,19,-4,17
FC Botosani,6426,4,3,6,5,7,14,-7,15
D Bucuresti,6426,5,3,5,6,18,23,-5,14
Concordia Ch,6426,6,3,3,8,20,23,-3,12
FCSB,6427,1,8,5,1,24,12,12,29
CFR Cluj,6427,2,5,7,2,13,8,5,22
Universitate,6427,3,4,6,4,16,18,-2,18
D Bucuresti,6427,4,4,5,5,18,19,-1,17
FC Botosani,6427,5,3,5,6,6,14,-8,14
Concordia Ch,6427,6,3,2,9,16,22,-6,11
FCSB,6428,1,7,6,1,23,11,12,27
CFR Cluj,6428,2,7,6,1,16,7,9,27
D Bucuresti,6428,3,4,5,5,22,20,2,17
Universitate,6428,4,3,6,5,14,20,-6,15
FC Botosani,6428,5,3,5,6,6,17,-11,14
Concordia Ch,6428,6,2,4,8,18,24,-6,10
FCSB,6429,1,8,6,0,25,10,15,30
CFR Cluj,6429,2,6,6,2,15,10,5,24
D Bucuresti,6429,3,5,4,5,19,18,1,19
Universitate,6429,4,3,6,5,15,20,-5,15
FC Botosani,6429,5,3,5,6,6,15,-9,14
Concordia Ch,6429,6,2,3,9,16,23,-7,9
FCSB,6430,1,9,5,0,26,11,15,32
CFR Cluj,6430,2,5,6,3,14,10,4,21
Universitate,6430,3,4,5,5,15,19,-4,17
FC Botosani,6430,4,4,5,5,8,14,-6,17
D Bucuresti,6430,5,4,4,6,19,20,-1,16
Concordia Ch,6430,6,2,3,9,18,26,-8,9
FCSB,6431,1,8,6,0,27,13,14,30
CFR Cluj,6431,2,5,7,2,15,10,5,22
Universitate,6431,3,3,7,4,17,21,-4,16
FC Botosani,6431,4,4,4,6,8,16,-8,16
D Bucuresti,6431,5,3,5,6,19,22,-3,14
Concordia Ch,6431,6,3,3,8,20,24,-4,12
FCSB,6432,1,8,5,1,25,16,9,29
CFR Cluj,6432,2,6,6,2,15,9,6,24
Universitate,6432,3,4,5,5,19,19,0,17
D Bucuresti,6432,4,4,4,6,20,21,-1,16
FC Botosani,6432,5,3,5,6,6,16,-10,14
Concordia Ch,6432,6,3,3,8,19,23,-4,12
FCSB,6433,1,8,6,0,25,11,14,30
CFR Cluj,6433,2,6,6,2,15,9,6,24
D Bucuresti,6433,3,4,4,6,19,20,-1,16
Universitate,6433,4,3,6,5,14,19,-5,15
FC Botosani,6433,5,3,5,6,6,15,-9,14
Concordia Ch,6433,6,3,3,8,18,23,-5,12
FCSB,6434,1,8,5,1,25,11,14,29
CFR Cluj,6434,2,6,6,2,15,9,6,24
D Bucuresti,6434,3,5,4,5,22,19,3,19
Universitate,6434,4,4,5,5,15,20,-5,17
FC Botosani,6434,5,4,4,6,7,15,-8,16
Concordia Ch,6434,6,2,2,10,16,26,-10,8
FCSB,6435,1,7,6,1,25,13,12,27
CFR Cluj,6435,2,5,7,2,14,10,4,22
Universitate,6435,3,5,5,4,20,21,-1,20
D Bucuresti,6435,4,4,4,6,20,22,-2,16
FC Botosani,6435,5,4,4,6,7,14,-7,16
Concordia Ch,6435,6,3,2,9,18,24,-6,11
FCSB,6436,1,8,6,0,25,10,15,30
CFR Cluj,6436,2,6,6,2,16,11,5,24
D Bucuresti,6436,3,4,5,5,17,18,-1,17
FC Botosani,6436,4,4,4,6,6,13,-7,16
Universitate,6436,5,3,6,5,16,21,-5,15
Concordia Ch,6436,6,2,3,9,15,22,-7,9
FCSB,6437,1,8,5,1,26,13,13,29
CFR Cluj,6437,2,6,6,2,15,10,5,24
D Bucuresti,6437,3,4,5,5,18,19,-1,17
Universitate,6437,4,4,5,5,17,20,-3,17
FC Botosani,6437,5,4,4,6,8,13,-5,16
Concordia Ch,6437,6,2,3,9,16,25,-9,9
FCSB,6438,1,8,6,0,29,11,18,30
CFR Cluj,6438,2,5,6,3,13,13,0,21
Universitate,6438,3,4,6,4,16,19,-3,18
FC Botosani,6438,4,4,5,5,8,13,-5,17
D Bucuresti,6438,5,3,5,6,17,21,-4,14
Concordia Ch,6438,6,3,2,9,17,23,-6,11
FCSB,6439,1,7,7,0,24,11,13,28
CFR Cluj,6439,2,5,8,1,15,9,6,23
D Bucuresti,6439,3,5,4,5,20,18,2,19
Universitate,6439,4,3,7,4,17,21,-4,16
FC Botosani,6439,5,3,4,7,6,17,-11,13
Concordia Ch,6439,6,3,2,9,17,23,-6,11
FCSB,6440,1,8,5,1,27,15,12,29
CFR Cluj,6440,2,6,6,2,17,12,5,24
Universitate,6440,3,4,5,5,18,20,-2,17
FC Botosani,6440,4,4,5,5,10,15,-5,17
D Bucuresti,6440,5,3,5,6,17,21,-4,14
Concordia Ch,6440,6,2,4,8,17,23,-6,10
FCSB,6441,1,8,5,1,26,11,15,29
CFR Cluj,6441,2,7,6,1,15,7,8,27
D Bucuresti,6441,3,4,5,5,19,20,-1,17
Universitate,6441,4,3,5,6,14,22,-8,14
FC Botosani,6441,5,3,4,7,6,15,-9,13
Concordia Ch,6441,6,3,3,8,17,22,-5,12
FCSB,6442,1,9,5,0,26,11,15,32
CFR Cluj,6442,2,5,6,3,15,11,4,21
FC Botosani,6442,3,5,4,5,9,13,-4,19
Universitate,6442,4,4,5,5,16,20,-4,17
D Bucuresti,6442,5,3,5,6,18,21,-3,14
Concordia Ch,6442,6,2,3,9,16,24,-8,9
FCSB,6443,1,7,6,1,23,11,12,27
CFR Cluj,6443,2,5,7,2,13,10,3,22
Universitate,6443,3,5,5,4,18,18,0,20
D Bucuresti,6443,4,4,5,5,21,18,3,17
FC Botosani,6443,5,4,5,5,7,13,-6,17
Concordia Ch,6443,6,2,2,10,16,28,-12,8
FCSB,6444,1,7,6,1,25,15,10,27
CFR Cluj,6444,2,6,7,1,17,8,9,25
D Bucuresti,6444,3,4,5,5,18,19,-1,17
Universitate,6444,4,3,7,4,15,19,-4,16
FC Botosani,6444,5,3,5,6,6,14,-8,14
Concordia Ch,6444,6,2,4,8,17,23,-6,10
FCSB,6445,1,9,5,0,26,10,16,32
CFR Cluj,6445,2,5,6,3,13,12,1,21
Universitate,6445,3,4,5,5,17,19,-2,17
FC Botosani,6445,4,4,4,6,7,14,-7,16
Concordia Ch,6445,5,4,2,8,19,21,-2,14
D Bucuresti,6445,6,3,4,7,16,22,-6,13
FCSB,6446,1,8,6,0,25,11,14,30
CFR Cluj,6446,2,5,6,3,15,13,2,21
Universitate,6446,3,4,6,4,18,19,-1,18
D Bucuresti,6446,4,4,4,6,18,21,-3,16
FC Botosani,6446,5,4,4,6,8,14,-6,16
Concordia Ch,6446,6,3,2,9,18,24,-6,11
FCSB,6447,1,9,5,0,25,10,15,32
CFR Cluj,6447,2,5,6,3,13,10,3,21
Universitate,6447,3,4,5,5,16,19,-3,17
D Bucuresti,6447,4,4,4,6,17,22,-5,16
FC Botosani,6447,5,4,4,6,9,15,-6,16
Concordia Ch,6447,6,3,2,9,21,25,-4,11
FCSB,6448,1,7,6,1,24,13,11,27
CFR Cluj,6448,2,7,6,1,17,7,10,27
FC Botosani,6448,3,4,5,5,8,14,-6,17
Universitate,6448,4,3,6,5,15,21,-6,15
D Bucuresti,6448,5,3,4,7,17,21,-4,13
Concordia Ch,6448,6,3,3,8,19,24,-5,12
FCSB,6449,1,9,5,0,26,11,15,32
CFR Cluj,6449,2,6,6,2,16,8,8,24
FC Botosani,6449,3,4,5,5,9,14,-5,17
D Bucuresti,6449,4,3,6,5,19,21,-2,15
Universitate,6449,5,3,5,6,15,23,-8,14
Concordia Ch,6449,6,2,3,9,18,26,-8,9
FCSB,6450,1,8,6,0,25,11,14,30
CFR Cluj,6450,2,5,7,2,14,10,4,22
D Bucuresti,6450,3,4,5,5,17,18,-1,17
Universitate,6450,4,4,5,5,18,21,-3,17
FC Botosani,6450,5,4,4,6,7,14,-7,16
Concordia Ch,6450,6,2,3,9,16,23,-7,9
FCSB,6451,1,7,6,1,23,11,12,27
CFR Cluj,6451,2,6,7,1,14,7,7,25
Universitate,6451,3,4,5,5,15,19,-4,17
D Bucuresti,6451,4,4,4,6,18,21,-3,16
Concordia Ch,6451,5,4,2,8,20,23,-3,14
FC Botosani,6451,6,3,4,7,6,15,-9,13
FCSB,6452,1,9,5,0,27,11,16,32
CFR Cluj,6452,2,6,6,2,18,10,8,24
D Bucuresti,6452,3,5,4,5,20,18,2,19
FC Botosani,6452,4,4,4,6,6,15,-9,16
Universitate,6452,5,3,5,6,15,24,-9,14
Concordia Ch,6452,6,2,2,10,15,23,-8,8
FCSB,6453,1,7,6,1,24,15,9,27
CFR Cluj,6453,2,6,7,1,15,7,8,25
Universitate,6453,3,4,5,5,19,21,-2,17
D Bucuresti,6453,4,4,4,6,17,19,-2,16
Concordia Ch,6453,5,4,2,8,18,22,-4,14
FC Botosani,6453,6,3,4,7,6,15,-9,13
FCSB,6454,1,8,6,0,27,13,14,30
CFR Cluj,6454,2,5,6,3,15,11,4,21
FC Botosani,6454,3,5,4,5,10,12,-2,19
Universitate,6454,4,4,6,4,18,21,-3,18
D Bucuresti,6454,5,3,4,7,16,23,-7,13
Concordia Ch,6454,6,3,2,9,18,24,-6,11
FCSB,6455,1,7,6,1,24,12,12,27
CFR Cluj,6455,2,5,8,1,14,8,6,23
Universitate,6455,3,4,6,4,17,20,-3,18
D Bucuresti,6455,4,4,5,5,18,19,-1,17
FC Botosani,6455,5,3,5,6,6,15,-9,14
Concordia Ch,6455,6,3,2,9,17,22,-5,11
FCSB,6456,1,7,6,1,24,12,12,27
CFR Cluj,6456,2,6,7,1,15,8,7,25
FC Botosani,6456,3,5,4,5,8,12,-4,19
Universitate,6456,4,3,7,4,14,18,-4,16
D Bucuresti,6456,5,3,5,6,16,19,-3,14
Concordia Ch,6456,6,2,3,9,15,23,-8,9
FCSB,6457,1,7,6,1,24,13,11,27
CFR Cluj,6457,2,6,7,1,15,8,7,25
Universitate,6457,3,4,5,5,16,19,-3,17
FC Botosani,6457,4,3,6,5,7,14,-7,15
D Bucuresti,6457,5,3,5,6,18,22,-4,14
Concordia Ch,6457,6,3,3,8,19,23,-4,12
FCSB,6458,1,7,7,0,26,13,13,28
CFR Cluj,6458,2,6,7,1,18,10,8,25
FC Botosani,6458,3,5,4,5,9,13,-4,19
D Bucuresti,6458,4,4,4,6,18,20,-2,16
Universitate,6458,5,3,6,5,16,22,-6,15
Concordia Ch,6458,6,2,2,10,16,25,-9,8
FCSB,6459,1,7,6,1,25,14,11,27
CFR Cluj,6459,2,5,7,2,13,8,5,22
Universitate,6459,3,5,5,4,19,20,-1,20
D Bucuresti,6459,4,4,4,6,18,21,-3,16
FC Botosani,6459,5,4,4,6,7,13,-6,16
Concordia Ch,6459,6,3,2,9,17,23,-6,11
FCSB,6460,1,7,6,1,25,13,12,27
CFR Cluj,6460,2,6,7,1,17,8,9,25
Universitate,6460,3,4,5,5,16,22,-6,17
D Bucuresti,6460,4,4,4,6,19,20,-1,16
Concordia Ch,6460,5,4,2,8,18,22,-4,14
FC Botosani,6460,6,3,4,7,5,15,-10,13
FCSB,6461,1,8,6,0,27,12,15,30
CFR Cluj,6461,2,5,6,3,14,11,3,21
D Bucuresti,6461,3,5,4,5,20,19,1,19
Universitate,6461,4,4,6,4,16,19,-3,18
FC Botosani,6461,5,3,5,6,6,14,-8,14
Concordia Ch,6461,6,2,3,9,15,23,-8,9
FCSB,6462,1,7,6,1,25,15,10,27
CFR Cluj,6462,2,7,6,1,19,9,10,27
D Bucuresti,6462,3,5,4,5,20,20,0,19
Universitate,6462,4,3,6,5,16,21,-5,15
FC Botosani,6462,5,3,5,6,7,15,-8,14
Concordia Ch,6462,6,2,3,9,17,24,-7,9
FCSB,6463,1,7,7,0,24,11,13,28
CFR Cluj,6463,2,5,8,1,15,9,6,23
FC Botosani,6463,3,5,4,5,11,13,-2,19
Universitate,6463,4,3,7,4,17,21,-4,16
D Bucuresti,6463,5,3,4,7,17,23,-6,13
Concordia Ch,6463,6,3,2,9,20,27,-7,11
FCSB,6464,1,7,6,1,24,13,11,27
CFR Cluj,6464,2,7,6,1,17,8,9,27
D Bucuresti,6464,3,4,4,6,19,22,-3,16
Universitate,6464,4,3,6,5,16,21,-5,15
FC Botosani,6464,5,3,5,6,6,15,-9,14
Concordia Ch,6464,6,3,3,8,18,21,-3,12
FCSB,6465,1,7,6,1,23,11,12,27
CFR Cluj,6465,2,6,7,1,14,7,7,25
D Bucuresti,6465,3,4,5,5,18,19,-1,17
Universitate,6465,4,3,7,4,14,18,-4,16
FC Botosani,6465,5,3,4,7,5,15,-10,13
Concordia Ch,6465,6,3,3,8,18,22,-4,12
FCSB,6466,1,8,5,1,28,15,13,29
CFR Cluj,6466,2,6,6,2,15,10,5,24
D Bucuresti,6466,3,5,4,5,20,20,0,19
Universitate,6466,4,4,5,5,18,21,-3,17
FC Botosani,6466,5,3,4,7,5,14,-9,13
Concordia Ch,6466,6,3,2,9,18,24,-6,11
FCSB,6467,1,8,6,0,25,11,14,30
CFR Cluj,6467,2,6,6,2,14,8,6,24
Universitate,6467,3,3,6,5,15,20,-5,15
FC Botosani,6467,4,3,6,5,5,12,-7,15
D Bucuresti,6467,5,3,5,6,18,21,-3,14
Concordia Ch,6467,6,3,3,8,18,23,-5,12
FCSB,6468,1,8,5,1,24,11,13,29
CFR Cluj,6468,2,5,7,2,13,8,5,22
Universitate,6468,3,4,6,4,15,18,-3,18
D Bucuresti,6468,4,4,5,5,19,20,-1,17
FC Botosani,6468,5,3,6,5,8,15,-7,15
Concordia Ch,6468,6,2,3,9,16,23,-7,9
CFR Cluj,6469,1,7,6,1,16,7,9,27
FCSB,6469,2,7,5,2,24,14,10,26
FC Botosani,6469,3,5,4,5,10,13,-3,19
Universitate,6469,4,4,5,5,17,21,-4,17
D Bucuresti,6469,5,3,4,7,18,23,-5,13
Concordia Ch,6469,6,3,2,9,17,24,-7,11
FCSB,6470,1,8,5,1,27,14,13,29
CFR Cluj,6470,2,5,7,2,15,11,4,22
Universitate,6470,3,4,6,4,18,20,-2,18
D Bucuresti,6470,4,4,4,6,18,20,-2,16
FC Botosani,6470,5,4,4,6,7,14,-7,16
Concordia Ch,6470,6,3,2,9,18,24,-6,11
FCSB,6471,1,8,5,1,26,14,12,29
CFR Cluj,6471,2,7,6,1,17,8,9,27
FC Botosani,6471,3,5,4,5,9,13,-4,19
D Bucuresti,6471,4,4,4,6,20,21,-1,16
Universitate,6471,5,3,5,6,15,21,-6,14
Concordia Ch,6471,6,2,2,10,15,25,-10,8
FCSB,6472,1,8,6,0,24,10,14,30
CFR Cluj,6472,2,5,7,2,14,9,5,22
FC Botosani,6472,3,4,5,5,7,13,-6,17
Universitate,6472,4,3,7,4,15,19,-4,16
D Bucuresti,6472,5,3,4,7,16,21,-5,13
Concordia Ch,6472,6,3,3,8,18,22,-4,12
FCSB,6473,1,7,6,1,24,12,12,27
CFR Cluj,6473,2,5,8,1,15,9,6,23
Universitate,6473,3,4,6,4,16,19,-3,18
D Bucuresti,6473,4,3,6,5,18,20,-2,15
FC Botosani,6473,5,3,6,5,8,15,-7,15
Concordia Ch,6473,6,2,4,8,18,24,-6,10
CFR Cluj,6474,1,7,6,1,18,7,11,27
FCSB,6474,2,7,5,2,23,15,8,26
Universitate,6474,3,4,5,5,16,20,-4,17
FC Botosani,6474,4,4,5,5,6,12,-6,17
D Bucuresti,6474,5,3,6,5,16,18,-2,15
Concordia Ch,6474,6,2,3,9,15,22,-7,9
FCSB,6475,1,9,5,0,26,11,15,32
CFR Cluj,6475,2,6,6,2,16,8,8,24
D Bucuresti,6475,3,4,5,5,19,19,0,17
Universitate,6475,4,3,5,6,15,23,-8,14
FC Botosani,6475,5,3,4,7,5,15,-10,13
Concordia Ch,6475,6,3,3,8,17,22,-5,12
CFR Cluj,6476,1,7,6,1,16,7,9,27
FCSB,6476,2,7,5,2,23,14,9,26
Universitate,6476,3,4,5,5,16,19,-3,17
FC Botosani,6476,4,4,5,5,8,14,-6,17
D Bucuresti,6476,5,3,5,6,16,19,-3,14
Concordia Ch,6476,6,2,4,8,17,23,-6,10
FCSB,6477,1,8,5,1,25,11,14,29
CFR Cluj,6477,2,6,7,1,15,8,7,25
D Bucuresti,6477,3,5,4,5,20,18,2,19
FC Botosani,6477,4,4,4,6,6,14,-8,16
Universitate,6477,5,3,6,5,15,21,-6,15
Concordia Ch,6477,6,2,2,10,15,24,-9,8
FCSB,6478,1,8,5,1,25,12,13,29
CFR Cluj,6478,2,7,6,1,19,9,10,27
FC Botosani,6478,3,5,4,5,9,13,-4,19
D Bucuresti,6478,4,3,5,6,19,23,-4,14
Universitate,6478,5,3,5,6,15,23,-8,14
Concordia Ch,6478,6,2,3,9,17,24,-7,9
FCSB,6479,1,7,7,0,25,12,13,28
CFR Cluj,6479,2,5,7,2,15,11,4,22
Universitate,6479,3,4,6,4,18,20,-2,18
FC Botosani,6479,4,3,6,5,6,13,-7,15
D Bucuresti,6479,5,3,5,6,16,19,-3,14
Concordia Ch,6479,6,3,3,8,17,22,-5,12
FCSB,6480,1,8,6,0,25,10,15,30
CFR Cluj,6480,2,5,8,1,14,8,6,23
D Bucuresti,6480,3,4,4,6,19,23,-4,16
Universitate,6480,4,3,6,5,15,21,-6,15
FC Botosani,6480,5,3,5,6,5,13,-8,14
Concordia Ch,6480,6,3,3,8,20,23,-3,12
FCSB,6481,1,7,6,1,26,15,11,27
CFR Cluj,6481,2,6,7,1,17,8,9,25
D Bucuresti,6481,3,4,5,5,20,20,0,17
Universitate,6481,4,4,5,5,18,23,-5,17
FC Botosani,6481,5,3,4,7,6,16,-10,13
Concordia Ch,6481,6,3,3,8,17,22,-5,12
FCSB,6482,1,7,6,1,24,14,10,27
CFR Cluj,6482,2,7,6,1,18,8,10,27
FC Botosani,6482,3,4,4,6,9,15,-6,16
Universitate,6482,4,3,6,5,16,21,-5,15
D Bucuresti,6482,5,3,5,6,18,22,-4,14
Concordia Ch,6482,6,3,3,8,20,25,-5,12
FCSB,6483,1,8,5,1,28,12,16,29
CFR Cluj,6483,2,7,6,1,16,7,9,27
D Bucuresti,6483,3,5,4,5,20,20,0,19
Universitate,6483,4,3,5,6,15,25,-10,14
FC Botosani,6483,5,3,4,7,6,17,-11,13
Concordia Ch,6483,6,3,2,9,19,23,-4,11
CFR Cluj,6484,1,7,6,1,16,8,8,27
FCSB,6484,2,7,5,2,23,13,10,26
D Bucuresti,6484,3,4,5,5,20,19,1,17
Universitate,6484,4,4,5,5,17,20,-3,17
FC Botosani,6484,5,3,5,6,5,15,-10,14
Concordia Ch,6484,6,2,4,8,16,22,-6,10
FCSB,6485,1,8,6,0,26,12,14,30
CFR Cluj,6485,2,5,8,1,15,9,6,23
D Bucuresti,6485,3,4,5,5,20,21,-1,17
Universitate,6485,4,3,6,5,16,21,-5,15
FC Botosani,6485,5,3,4,7,6,15,-9,13
Concordia Ch,6485,6,3,3,8,18,23,-5,12
FCSB,6486,1,7,7,0,25,12,13,28
CFR Cluj,6486,2,5,8,1,14,8,6,23
D Bucuresti,6486,3,4,4,6,20,24,-4,16
Universitate,6486,4,3,7,4,17,21,-4,16
FC Botosani,6486,5,4,4,6,6,15,-9,16
Concordia Ch,6486,6,3,2,9,21,23,-2,11
FCSB,6487,1,8,6,0,24,10,14,30
CFR Cluj,6487,2,6,7,1,16,7,9,25
D Bucuresti,6487,3,4,4,6,18,22,-4,16
FC Botosani,6487,4,4,4,6,6,13,-7,16
Universitate,6487,5,3,5,6,14,22,-8,14
Concordia Ch,6487,6,3,2,9,19,23,-4,11
FCSB,6488,1,8,5,1,24,12,12,29
CFR Cluj,6488,2,5,6,3,13,9,4,21
Universitate,6488,3,5,5,4,17,18,-1,20
FC Botosani,6488,4,5,4,5,9,14,-5,19
D Bucuresti,6488,5,3,4,7,16,21,-5,13
Concordia Ch,6488,6,3,2,9,19,24,-5,11
FCSB,6489,1,8,6,0,27,11,16,30
CFR Cluj,6489,2,6,7,1,16,8,8,25
D Bucuresti,6489,3,3,5,6,18,21,-3,14
Concordia Ch,6489,4,4,2,8,19,23,-4,14
FC Botosani,6489,5,3,5,6,7,15,-8,14
Universitate,6489,6,3,5,6,14,23,-9,14
FCSB,6490,1,9,5,0,27,11,16,32
CFR Cluj,6490,2,5,7,2,13,9,4,22
FC Botosani,6490,3,4,5,5,10,15,-5,17
Universitate,6490,4,3,6,5,15,20,-5,15
D Bucuresti,6490,5,3,5,6,19,23,-4,14
Concordia Ch,6490,6,2,4,8,19,25,-6,10
FCSB,6491,1,8,5,1,25,12,13,29
CFR Cluj,6491,2,5,6,3,13,9,4,21
Universitate,6491,3,5,5,4,17,19,-2,20
D Bucuresti,6491,4,5,4,5,21,19,2,19
FC Botosani,6491,5,3,4,7,5,17,-12,13
Concordia Ch,6491,6,3,2,9,18,23,-5,11
FCSB,6492,1,8,6,0,26,12,14,30
CFR Cluj,6492,2,6,7,1,16,7,9,25
FC Botosani,6492,3,5,4,5,9,13,-4,19
Universitate,6492,4,3,5,6,16,24,-8,14
D Bucuresti,6492,5,3,4,7,18,22,-4,13
Concordia Ch,6492,6,3,2,9,17,24,-7,11
FCSB,6493,1,7,6,1,24,12,12,27
CFR Cluj,6493,2,6,7,1,15,8,7,25
Universitate,6493,3,4,5,5,17,21,-4,17
D Bucuresti,6493,4,3,6,5,17,19,-2,15
FC Botosani,6493,5,3,6,5,5,12,-7,15
Concordia Ch,6493,6,2,4,8,16,22,-6,10
FCSB,6494,1,8,5,1,26,12,14,29
CFR Cluj,6494,2,5,7,2,13,10,3,22
FC Botosani,6494,3,5,4,5,9,13,-4,19
Universitate,6494,4,4,6,4,16,18,-2,18
D Bucuresti,6494,5,4,4,6,21,20,1,16
Concordia Ch,6494,6,2,2,10,15,27,-12,8
FCSB,6495,1,7,6,1,24,13,11,27
CFR Cluj,6495,2,7,6,1,20,9,11,27
D Bucuresti,6495,3,4,4,6,18,19,-1,16
FC Botosani,6495,4,4,4,6,6,13,-7,16
Universitate,6495,5,3,6,5,15,22,-7,15
Concordia Ch,6495,6,3,2,9,16,23,-7,11
FCSB,6496,1,9,5,0,25,10,15,32
CFR Cluj,6496,2,5,7,2,13,8,5,22
D Bucuresti,6496,3,4,5,5,18,19,-1,17
FC Botosani,6496,4,4,4,6,7,14,-7,16
Universitate,6496,5,3,6,5,14,19,-5,15
Concordia Ch,6496,6,2,3,9,15,22,-7,9
FCSB,6497,1,7,6,1,23,11,12,27
CFR Cluj,6497,2,5,7,2,13,9,4,22
Universitate,6497,3,5,5,4,17,18,-1,20
D Bucuresti,6497,4,4,5,5,19,19,0,17
FC Botosani,6497,5,3,5,6,6,14,-8,14
Concordia Ch,6497,6,3,2,9,16,23,-7,11
FCSB,6498,1,8,6,0,29,15,14,30
CFR Cluj,6498,2,5,6,3,15,12,3,21
Universitate,6498,3,4,6,4,19,21,-2,18
D Bucuresti,6498,4,4,5,5,19,20,-1,17
FC Botosani,6498,5,3,6,5,5,12,-7,15
Concordia Ch,6498,6,2,3,9,17,24,-7,9
FCSB,6499,1,8,5,1,26,14,12,29
CFR Cluj,6499,2,7,6,1,19,9,10,27
D Bucuresti,6499,3,4,4,6,19,20,-1,16
FC Botosani,6499,4,4,4,6,6,14,-8,16
Universitate,6499,5,3,5,6,14,21,-7,14
Concordia Ch,6499,6,3,2,9,18,24,-6,11
FCSB,6500,1,8,6,0,33,12,21,30
CFR Cluj,6500,2,6,6,2,15,15,0,24
D Bucuresti,6500,3,3,6,5,20,22,-2,15
Universitate,6500,4,3,6,5,16,22,-6,15
FC Botosani,6500,5,3,5,6,9,17,-8,14
Concordia Ch,6500,6,3,3,8,18,23,-5,12
FCSB,6501,1,8,6,0,25,11,14,30
CFR Cluj,6501,2,6,6,2,15,9,6,24
D Bucuresti,6501,3,4,4,6,19,20,-1,16
Universitate,6501,4,3,6,5,16,21,-5,15
Concordia Ch,6501,5,4,2,8,18,22,-4,14
FC Botosani,6501,6,3,4,7,5,15,-10,13
FCSB,6502,1,8,5,1,28,12,16,29
CFR Cluj,6502,2,7,6,1,17,8,9,27
D Bucuresti,6502,3,3,6,5,18,20,-2,15
FC Botosani,6502,4,3,5,6,8,17,-9,14
Universitate,6502,5,3,5,6,16,26,-10,14
Concordia Ch,6502,6,3,3,8,20,24,-4,12
FCSB,6503,1,8,5,1,27,15,12,29
CFR Cluj,6503,2,5,6,3,15,12,3,21
Universitate,6503,3,5,5,4,20,20,0,20
FC Botosani,6503,4,4,5,5,7,13,-6,17
D Bucuresti,6503,5,3,5,6,18,21,-3,14
Concordia Ch,6503,6,2,4,8,18,24,-6,10
FCSB,6504,1,8,5,1,28,11,17,29
CFR Cluj,6504,2,6,6,2,15,13,2,24
D Bucuresti,6504,3,4,5,5,17,18,-1,17
Universitate,6504,4,4,5,5,16,20,-4,17
FC Botosani,6504,5,3,4,7,7,16,-9,13
Concordia Ch,6504,6,3,3,8,18,23,-5,12
FCSB,6505,1,8,5,1,26,12,14,29
CFR Cluj,6505,2,5,6,3,14,12,2,21
Universitate,6505,3,5,5,4,18,19,-1,20
FC Botosani,6505,4,4,5,5,10,14,-4,17
D Bucuresti,6505,5,3,5,6,18,23,-5,14
Concordia Ch,6505,6,3,2,9,20,26,-6,11
FCSB,6506,1,8,5,1,27,11,16,29
CFR Cluj,6506,2,6,6,2,14,9,5,24
Universitate,6506,3,4,5,5,16,22,-6,17
FC Botosani,6506,4,3,6,5,8,15,-7,15
D Bucuresti,6506,5,3,5,6,17,20,-3,14
Concordia Ch,6506,6,3,3,8,18,23,-5,12
FCSB,6507,1,9,5,0,28,11,17,32
CFR Cluj,6507,2,6,6,2,15,10,5,24
D Bucuresti,6507,3,4,5,5,19,20,-1,17
FC Botosani,6507,4,4,4,6,8,14,-6,16
Universitate,6507,5,3,5,6,14,21,-7,14
Concordia Ch,6507,6,2,3,9,16,24,-8,9
FCSB,6508,1,8,5,1,26,12,14,29
CFR Cluj,6508,2,6,7,1,15,8,7,25
FC Botosani,6508,3,4,5,5,7,13,-6,17
D Bucuresti,6508,4,4,4,6,17,19,-2,16
Universitate,6508,5,3,6,5,16,22,-6,15
Concordia Ch,6508,6,2,3,9,16,23,-7,9
FCSB,6509,1,8,5,1,28,15,13,29
CFR Cluj,6509,2,6,6,2,16,10,6,24
D Bucuresti,6509,3,4,5,5,21,19,2,17
Universitate,6509,4,4,5,5,17,21,-4,17
FC Botosani,6509,5,3,5,6,6,17,-11,14
Concordia Ch,6509,6,2,4,8,17,23,-6,10
FCSB,6510,1,8,5,1,27,12,15,29
CFR Cluj,6510,2,6,7,1,16,9,7,25
D Bucuresti,6510,3,5,4,5,21,19,2,19
Universitate,6510,4,3,6,5,15,22,-7,15
FC Botosani,6510,5,3,5,6,5,15,-10,14
Concordia Ch,6510,6,2,3,9,16,23,-7,9
FCSB,6511,1,9,5,0,27,12,15,32
CFR Cluj,6511,2,5,7,2,14,9,5,22
D Bucuresti,6511,3,4,4,6,19,20,-1,16
FC Botosani,6511,4,4,4,6,6,15,-9,16
Universitate,6511,5,3,6,5,15,20,-5,15
Concordia Ch,6511,6,3,2,9,17,22,-5,11
FCSB,6512,1,8,5,1,24,11,13,29
CFR Cluj,6512,2,6,7,1,14,7,7,25
D Bucuresti,6512,3,4,4,6,19,20,-1,16
FC Botosani,6512,4,4,4,6,7,15,-8,16
Universitate,6512,5,3,6,5,14,19,-5,15
Concordia Ch,6512,6,3,2,9,18,24,-6,11
FCSB,6513,1,8,5,1,26,15,11,29
CFR Cluj,6513,2,5,7,2,18,13,5,22
Universitate,6513,3,4,6,4,20,21,-1,18
D Bucuresti,6513,4,4,5,5,18,18,0,17
FC Botosani,6513,5,3,5,6,6,14,-8,14
Concordia Ch,6513,6,3,2,9,17,24,-7,11
FCSB,6514,1,8,5,1,26,11,15,29
CFR Cluj,6514,2,5,6,3,14,12,2,21
Universitate,6514,3,5,5,4,17,19,-2,20
D Bucuresti,6514,4,4,5,5,19,20,-1,17
FC Botosani,6514,5,4,5,5,7,13,-6,17
Concordia Ch,6514,6,2,2,10,16,24,-8,8
FCSB,6515,1,7,5,2,24,14,10,26
CFR Cluj,6515,2,6,6,2,15,10,5,24
Universitate,6515,3,5,5,4,18,18,0,20
D Bucuresti,6515,4,5,4,5,21,20,1,19
FC Botosani,6515,5,4,4,6,7,13,-6,16
Concordia Ch,6515,6,2,2,10,17,27,-10,8
FCSB,6516,1,8,6,0,26,12,14,30
CFR Cluj,6516,2,6,6,2,15,9,6,24
FC Botosani,6516,3,4,5,5,8,13,-5,17
Universitate,6516,4,3,6,5,15,20,-5,15
D Bucuresti,6516,5,3,5,6,18,22,-4,14
Concordia Ch,6516,6,2,4,8,16,22,-6,10
FCSB,6517,1,8,6,0,28,13,15,30
CFR Cluj,6517,2,6,7,1,18,9,9,25
D Bucuresti,6517,3,5,4,5,19,18,1,19
FC Botosani,6517,4,4,4,6,6,14,-8,16
Universitate,6517,5,3,5,6,15,24,-9,14
Concordia Ch,6517,6,2,2,10,15,23,-8,8
CFR Cluj,6518,1,7,6,1,17,8,9,27
FCSB,6518,2,7,5,2,23,14,9,26
FC Botosani,6518,3,5,4,5,9,14,-5,19
Universitate,6518,4,4,5,5,17,20,-3,17
D Bucuresti,6518,5,4,4,6,19,21,-2,16
Concordia Ch,6518,6,2,2,10,17,25,-8,8
CFR Cluj,6519,1,7,6,1,19,9,10,27
FCSB,6519,2,7,5,2,23,14,9,26
D Bucuresti,6519,3,4,5,5,18,19,-1,17
Universitate,6519,4,4,5,5,18,22,-4,17
FC Botosani,6519,5,3,5,6,5,13,-8,14
Concordia Ch,6519,6,2,4,8,16,22,-6,10
FCSB,6520,1,8,5,1,25,13,12,29
CFR Cluj,6520,2,6,6,2,15,9,6,24
Universitate,6520,3,4,5,5,16,19,-3,17
FC Botosani,6520,4,3,6,5,6,13,-7,15
D Bucuresti,6520,5,3,5,6,16,20,-4,14
Concordia Ch,6520,6,3,3,8,18,22,-4,12
CFR Cluj,6521,1,7,6,1,15,7,8,27
FCSB,6521,2,7,5,2,24,13,11,26
Universitate,6521,3,4,5,5,16,20,-4,17
D Bucuresti,6521,4,4,4,6,18,21,-3,16
FC Botosani,6521,5,4,4,6,7,14,-7,16
Concordia Ch,6521,6,3,2,9,17,22,-5,11
FCSB,6522,1,7,7,0,28,15,13,28
CFR Cluj,6522,2,6,7,1,21,8,13,25
FC Botosani,6522,3,4,4,6,6,15,-9,16
Universitate,6522,4,3,6,5,18,29,-11,15
Concordia Ch,6522,5,4,2,8,19,21,-2,14
D Bucuresti,6522,6,3,4,7,16,20,-4,13
FCSB,6523,1,8,5,1,25,12,13,29
CFR Cluj,6523,2,6,6,2,16,8,8,24
D Bucuresti,6523,3,5,4,5,19,19,0,19
Universitate,6523,4,4,5,5,16,22,-6,17
FC Botosani,6523,5,3,5,6,6,14,-8,14
Concordia Ch,6523,6,2,3,9,15,22,-7,9
FCSB,6524,1,7,5,2,26,15,11,26
CFR Cluj,6524,2,6,7,1,15,8,7,25
Universitate,6524,3,4,6,4,17,20,-3,18
D Bucuresti,6524,4,4,5,5,17,18,-1,17
FC Botosani,6524,5,4,4,6,6,13,-7,16
Concordia Ch,6524,6,2,3,9,15,22,-7,9
FCSB,6525,1,9,5,0,27,11,16,32
CFR Cluj,6525,2,5,7,2,15,10,5,22
D Bucuresti,6525,3,4,5,5,18,19,-1,17
FC Botosani,6525,4,4,4,6,7,14,-7,16
Universitate,6525,5,3,6,5,15,21,-6,15
Concordia Ch,6525,6,2,3,9,15,22,-7,9
FCSB,6526,1,9,5,0,28,12,16,32
CFR Cluj,6526,2,5,6,3,13,10,3,21
Universitate,6526,3,4,5,5,17,21,-4,17
D Bucuresti,6526,4,3,6,5,16,18,-2,15
FC Botosani,6526,5,3,5,6,5,14,-9,14
Concordia Ch,6526,6,3,3,8,17,21,-4,12
FCSB,6527,1,7,6,1,25,13,12,27
CFR Cluj,6527,2,5,7,2,15,10,5,22
Universitate,6527,3,5,5,4,18,20,-2,20
D Bucuresti,6527,4,4,5,5,19,20,-1,17
FC Botosani,6527,5,3,4,7,5,14,-9,13
Concordia Ch,6527,6,3,3,8,18,23,-5,12
FCSB,6528,1,7,7,0,25,12,13,28
CFR Cluj,6528,2,5,7,2,13,9,4,22
Universitate,6528,3,4,6,4,18,20,-2,18
FC Botosani,6528,4,4,5,5,8,14,-6,17
D Bucuresti,6528,5,3,6,5,18,20,-2,15
Concordia Ch,6528,6,2,3,9,15,22,-7,9
CFR Cluj,6529,1,7,6,1,17,9,8,27
FCSB,6529,2,7,5,2,25,14,11,26
D Bucuresti,6529,3,5,4,5,20,20,0,19
Universitate,6529,4,4,5,5,17,21,-4,17
FC Botosani,6529,5,3,4,7,7,17,-10,13
Concordia Ch,6529,6,3,2,9,19,24,-5,11
FCSB,6530,1,7,5,2,26,17,9,26
CFR Cluj,6530,2,6,7,1,17,9,8,25
Universitate,6530,3,4,6,4,17,19,-2,18
D Bucuresti,6530,4,4,4,6,18,19,-1,16
FC Botosani,6530,5,4,4,6,6,14,-8,16
Concordia Ch,6530,6,3,2,9,16,22,-6,11
FCSB,6531,1,7,7,0,25,12,13,28
CFR Cluj,6531,2,6,7,1,16,9,7,25
D Bucuresti,6531,3,4,4,6,19,20,-1,16
Universitate,6531,4,3,6,5,16,21,-5,15
Concordia Ch,6531,5,4,2,8,19,22,-3,14
FC Botosani,6531,6,3,4,7,5,16,-11,13
FCSB,6532,1,9,5,0,28,11,17,32
CFR Cluj,6532,2,5,6,3,13,12,1,21
D Bucuresti,6532,3,4,5,5,20,20,0,17
Universitate,6532,4,4,5,5,17,20,-3,17
FC Botosani,6532,5,4,4,6,8,16,-8,16
Concordia Ch,6532,6,2,3,9,17,24,-7,9
FCSB,6533,1,8,6,0,25,11,14,30
CFR Cluj,6533,2,6,6,2,15,9,6,24
FC Botosani,6533,3,4,4,6,8,15,-7,16
Universitate,6533,4,3,6,5,16,21,-5,15
D Bucuresti,6533,5,3,5,6,18,21,-3,14
Concordia Ch,6533,6,3,3,8,18,23,-5,12
FCSB,6534,1,8,5,1,25,12,13,29
CFR Cluj,6534,2,7,6,1,16,7,9,27
D Bucuresti,6534,3,4,5,5,19,19,0,17
Universitate,6534,4,3,5,6,14,21,-7,14
FC Botosani,6534,5,3,5,6,7,16,-9,14
Concordia Ch,6534,6,2,4,8,18,24,-6,10
FCSB,6535,1,9,5,0,25,10,15,32
CFR Cluj,6535,2,5,7,2,14,9,5,22
D Bucuresti,6535,3,4,4,6,17,19,-2,16
Universitate,6535,4,3,6,5,15,20,-5,15
Concordia Ch,6535,5,4,2,8,17,21,-4,14
FC Botosani,6535,6,3,4,7,5,14,-9,13
FCSB,6536,1,8,5,1,25,12,13,29
CFR Cluj,6536,2,5,7,2,14,9,5,22
Universitate,6536,3,4,6,4,15,18,-3,18
D Bucuresti,6536,4,4,4,6,18,20,-2,16
FC Botosani,6536,5,3,5,6,6,14,-8,14
Concordia Ch,6536,6,3,3,8,16,21,-5,12
FCSB,6537,1,8,6,0,27,12,15,30
CFR Cluj,6537,2,5,6,3,14,11,3,21
Universitate,6537,3,4,6,4,18,21,-3,18
FC Botosani,6537,4,4,5,5,10,13,-3,17
D Bucuresti,6537,5,3,6,5,16,18,-2,15
Concordia Ch,6537,6,2,3,9,16,26,-10,9
FCSB,6538,1,7,6,1,25,14,11,27
CFR Cluj,6538,2,6,7,1,15,7,8,25
FC Botosani,6538,3,5,4,5,9,13,-4,19
Universitate,6538,4,3,7,4,16,20,-4,16
D Bucuresti,6538,5,3,4,7,17,21,-4,13
Concordia Ch,6538,6,3,2,9,16,23,-7,11
FCSB,6539,1,9,5,0,29,13,16,32
CFR Cluj,6539,2,5,6,3,14,11,3,21
D Bucuresti,6539,3,4,5,5,17,18,-1,17
Universitate,6539,4,4,5,5,17,21,-4,17
FC Botosani,6539,5,4,4,6,6,13,-7,16
Concordia Ch,6539,6,2,3,9,15,22,-7,9
FCSB,6540,1,9,5,0,29,11,18,32
CFR Cluj,6540,2,5,7,2,13,9,4,22
D Bucuresti,6540,3,4,5,5,18,18,0,17
Universitate,6540,4,3,6,5,15,22,-7,15
FC Botosani,6540,5,3,4,7,5,17,-12,13
Concordia Ch,6540,6,3,3,8,18,21,-3,12
FCSB,6541,1,8,5,1,27,13,14,29
CFR Cluj,6541,2,6,6,2,16,11,5,24
Universitate,6541,3,4,5,5,15,19,-4,17
D Bucuresti,6541,4,4,4,6,20,21,-1,16
Concordia Ch,6541,5,4,2,8,18,22,-4,14
FC Botosani,6541,6,3,4,7,8,18,-10,13
FCSB,6542,1,9,5,0,27,12,15,32
CFR Cluj,6542,2,6,6,2,16,10,6,24
FC Botosani,6542,3,4,5,5,7,12,-5,17
D Bucuresti,6542,4,3,5,6,17,20,-3,14
Universitate,6542,5,3,5,6,14,20,-6,14
Concordia Ch,6542,6,3,2,9,17,24,-7,11
FCSB,6543,1,7,6,1,23,12,11,27
CFR Cluj,6543,2,6,6,2,16,10,6,24
Universitate,6543,3,4,6,4,17,19,-2,18
D Bucuresti,6543,4,4,5,5,20,20,0,17
FC Botosani,6543,5,3,5,6,6,15,-9,14
Concordia Ch,6543,6,3,2,9,18,24,-6,11
FCSB,6544,1,8,5,1,26,12,14,29
CFR Cluj,6544,2,6,6,2,15,10,5,24
Universitate,6544,3,4,5,5,16,20,-4,17
D Bucuresti,6544,4,4,4,6,18,22,-4,16
FC Botosani,6544,5,4,4,6,9,15,-6,16
Concordia Ch,6544,6,3,2,9,19,24,-5,11
FCSB,6545,1,8,6,0,27,13,14,30
CFR Cluj,6545,2,6,7,1,18,10,8,25
FC Botosani,6545,3,5,4,5,10,13,-3,19
Universitate,6545,4,3,5,6,14,21,-7,14
D Bucuresti,6545,5,3,4,7,16,23,-7,13
Concordia Ch,6545,6,3,2,9,18,23,-5,11
FCSB,6546,1,9,5,0,26,11,15,32
CFR Cluj,6546,2,5,7,2,15,10,5,22
D Bucuresti,6546,3,4,5,5,18,19,-1,17
FC Botosani,6546,4,4,4,6,7,14,-7,16
Universitate,6546,5,3,6,5,15,20,-5,15
Concordia Ch,6546,6,2,3,9,15,22,-7,9
FCSB,6547,1,8,5,1,26,12,14,29
CFR Cluj,6547,2,6,6,2,15,10,5,24
Universitate,6547,3,4,5,5,17,21,-4,17
FC Botosani,6547,4,4,5,5,9,14,-5,17
D Bucuresti,6547,5,3,5,6,19,23,-4,14
Concordia Ch,6547,6,2,4,8,18,24,-6,10
FCSB,6548,1,7,6,1,26,14,12,27
CFR Cluj,6548,2,7,6,1,15,7,8,27
D Bucuresti,6548,3,4,4,6,18,21,-3,16
Universitate,6548,4,3,6,5,17,22,-5,15
Concordia Ch,6548,5,4,2,8,23,21,2,14
FC Botosani,6548,6,3,4,7,5,19,-14,13
FCSB,6549,1,9,5,0,29,12,17,32
CFR Cluj,6549,2,5,7,2,14,9,5,22
D Bucuresti,6549,3,4,5,5,18,19,-1,17
FC Botosani,6549,4,4,4,6,8,15,-7,16
Universitate,6549,5,3,6,5,17,24,-7,15
Concordia Ch,6549,6,2,3,9,18,25,-7,9
FCSB,6550,1,9,5,0,27,11,16,32
CFR Cluj,6550,2,5,7,2,15,11,4,22
D Bucuresti,6550,3,4,5,5,19,20,-1,17
Universitate,6550,4,3,6,5,17,22,-5,15
FC Botosani,6550,5,3,6,5,8,15,-7,15
Concordia Ch,6550,6,2,3,9,18,25,-7,9
FCSB,6551,1,7,5,2,24,14,10,26
CFR Cluj,6551,2,6,7,1,15,8,7,25
Universitate,6551,3,4,6,4,16,18,-2,18
FC Botosani,6551,4,4,5,5,6,12,-6,17
D Bucuresti,6551,5,3,5,6,16,19,-3,14
Concordia Ch,6551,6,3,2,9,16,22,-6,11
FCSB,6552,1,7,7,0,24,11,13,28
CFR Cluj,6552,2,5,8,1,15,9,6,23
FC Botosani,6552,3,4,5,5,7,13,-6,17
Universitate,6552,4,3,7,4,15,19,-4,16
D Bucuresti,6552,5,3,5,6,18,21,-3,14
Concordia Ch,6552,6,2,4,8,18,24,-6,10
FCSB,6553,1,9,5,0,26,10,16,32
CFR Cluj,6553,2,5,6,3,13,12,1,21
D Bucuresti,6553,3,5,4,5,18,18,0,19
Universitate,6553,4,4,5,5,17,19,-2,17
FC Botosani,6553,5,3,4,7,6,15,-9,13
Concordia Ch,6553,6,3,2,9,17,23,-6,11
FCSB,6554,1,7,7,0,24,11,13,28
CFR Cluj,6554,2,6,7,1,15,7,8,25
FC Botosani,6554,3,5,4,5,7,12,-5,19
Universitate,6554,4,3,6,5,15,21,-6,15
D Bucuresti,6554,5,3,4,7,19,23,-4,13
Concordia Ch,6554,6,3,2,9,19,25,-6,11
FCSB,6555,1,8,5,1,24,11,13,29
CFR Cluj,6555,2,6,6,2,14,8,6,24
Universitate,6555,3,4,5,5,15,19,-4,17
FC Botosani,6555,4,4,5,5,9,15,-6,17
D Bucuresti,6555,5,4,4,6,19,21,-2,16
Concordia Ch,6555,6,2,3,9,20,27,-7,9
FCSB,6556,1,7,7,0,24,11,13,28
CFR Cluj,6556,2,6,7,1,15,7,8,25
D Bucuresti,6556,3,5,4,5,21,19,2,19
Universitate,6556,4,3,6,5,15,21,-6,15
FC Botosani,6556,5,3,5,6,6,15,-9,14
Concordia Ch,6556,6,2,3,9,17,25,-8,9
FCSB,6557,1,9,5,0,28,11,17,32
CFR Cluj,6557,2,6,6,2,17,10,7,24
FC Botosani,6557,3,3,6,5,6,13,-7,15
D Bucuresti,6557,4,3,5,6,19,22,-3,14
Universitate,6557,5,3,5,6,15,24,-9,14
Concordia Ch,6557,6,3,3,8,20,25,-5,12
FCSB,6558,1,7,6,1,24,14,10,27
CFR Cluj,6558,2,6,7,1,16,8,8,25
Universitate,6558,3,4,5,5,17,20,-3,17
FC Botosani,6558,4,4,4,6,7,14,-7,16
D Bucuresti,6558,5,3,5,6,17,20,-3,14
Concordia Ch,6558,6,3,3,8,18,23,-5,12
FCSB,6559,1,7,6,1,24,13,11,27
CFR Cluj,6559,2,5,7,2,14,9,5,22
Universitate,6559,3,5,5,4,17,18,-1,20
D Bucuresti,6559,4,4,4,6,17,19,-2,16
Concordia Ch,6559,5,4,2,8,17,21,-4,14
FC Botosani,6559,6,3,4,7,5,14,-9,13
FCSB,6560,1,8,5,1,26,12,14,29
CFR Cluj,6560,2,6,7,1,15,8,7,25
D Bucuresti,6560,3,4,4,6,20,22,-2,16
Universitate,6560,4,3,6,5,16,22,-6,15
FC Botosani,6560,5,3,5,6,6,15,-9,14
Concordia Ch,6560,6,3,3,8,18,22,-4,12
FCSB,6561,1,8,5,1,26,11,15,29
CFR Cluj,6561,2,7,6,1,15,7,8,27
D Bucuresti,6561,3,4,4,6,18,21,-3,16
FC Botosani,6561,4,4,4,6,6,14,-8,16
Universitate,6561,5,3,5,6,14,22,-8,14
Concordia Ch,6561,6,3,2,9,18,22,-4,11
FCSB,6562,1,8,5,1,24,11,13,29
CFR Cluj,6562,2,5,7,2,13,8,5,22
D Bucuresti,6562,3,5,4,5,18,18,0,19
Universitate,6562,4,4,6,4,15,18,-3,18
FC Botosani,6562,5,4,4,6,8,14,-6,16
Concordia Ch,6562,6,2,2,10,16,25,-9,8
FCSB,6563,1,9,5,0,28,11,17,32
CFR Cluj,6563,2,6,6,2,16,9,7,24
FC Botosani,6563,3,4,5,5,7,12,-5,17
D Bucuresti,6563,4,3,5,6,17,21,-4,14
Universitate,6563,5,3,5,6,14,23,-9,14
Concordia Ch,6563,6,3,2,9,18,24,-6,11
FCSB,6564,1,7,5,2,24,13,11,26
CFR Cluj,6564,2,6,7,1,15,8,7,25
Universitate,6564,3,4,6,4,15,18,-3,18
D Bucuresti,6564,4,4,5,5,18,18,0,17
FC Botosani,6564,5,3,5,6,6,15,-9,14
Concordia Ch,6564,6,2,4,8,16,22,-6,10
FCSB,6565,1,7,6,1,24,12,12,27
CFR Cluj,6565,2,6,7,1,18,8,10,25
Universitate,6565,3,4,5,5,15,22,-7,17
D Bucuresti,6565,4,4,4,6,19,21,-2,16
FC Botosani,6565,5,4,4,6,7,14,-7,16
Concordia Ch,6565,6,3,2,9,17,23,-6,11
FCSB,6566,1,8,5,1,25,12,13,29
CFR Cluj,6566,2,6,6,2,16,10,6,24
Universitate,6566,3,4,5,5,18,22,-4,17
D Bucuresti,6566,4,3,6,5,18,20,-2,15
FC Botosani,6566,5,3,6,5,6,13,-7,15
Concordia Ch,6566,6,2,4,8,18,24,-6,10
FCSB,6567,1,8,5,1,25,12,13,29
CFR Cluj,6567,2,6,6,2,15,8,7,24
D Bucuresti,6567,3,5,4,5,23,20,3,19
Universitate,6567,4,4,5,5,16,21,-5,17
FC Botosani,6567,5,4,4,6,7,15,-8,16
Concordia Ch,6567,6,2,2,10,17,27,-10,8
FCSB,6568,1,9,5,0,28,12,16,32
CFR Cluj,6568,2,5,7,2,15,10,5,22
FC Botosani,6568,3,4,4,6,6,13,-7,16
Universitate,6568,4,3,6,5,16,22,-6,15
Concordia Ch,6568,5,4,2,8,19,21,-2,14
D Bucuresti,6568,6,3,4,7,16,22,-6,13
FCSB,6569,1,7,6,1,25,14,11,27
CFR Cluj,6569,2,5,8,1,17,11,6,23
Universitate,6569,3,4,6,4,18,20,-2,18
FC Botosani,6569,4,3,6,5,6,13,-7,15
D Bucuresti,6569,5,3,5,6,16,19,-3,14
Concordia Ch,6569,6,3,3,8,17,22,-5,12
FCSB,6570,1,7,6,1,25,15,10,27
CFR Cluj,6570,2,7,6,1,18,8,10,27
D Bucuresti,6570,3,4,4,6,19,21,-2,16
Universitate,6570,4,3,6,5,17,22,-5,15
FC Botosani,6570,5,3,5,6,6,16,-10,14
Concordia Ch,6570,6,3,3,8,19,22,-3,12
CFR Cluj,6571,1,7,6,1,17,8,9,27
FCSB,6571,2,7,5,2,24,13,11,26
D Bucuresti,6571,3,4,5,5,18,19,-1,17
Universitate,6571,4,4,5,5,15,20,-5,17
FC Botosani,6571,5,3,5,6,6,15,-9,14
Concordia Ch,6571,6,3,2,9,19,24,-5,11
FCSB,6572,1,7,7,0,26,13,13,28
CFR Cluj,6572,2,5,7,2,15,10,5,22
D Bucuresti,6572,3,5,4,5,22,22,0,19
Universitate,6572,4,4,6,4,18,21,-3,18
FC Botosani,6572,5,4,4,6,9,16,-7,16
Concordia Ch,6572,6,2,2,10,20,28,-8,8
FCSB,6573,1,8,6,0,25,11,14,30
CFR Cluj,6573,2,6,6,2,15,9,6,24
FC Botosani,6573,3,5,4,5,8,13,-5,19
D Bucuresti,6573,4,4,4,6,18,20,-2,16
Universitate,6573,5,3,6,5,16,21,-5,15
Concordia Ch,6573,6,2,2,10,15,23,-8,8
FCSB,6574,1,8,5,1,26,12,14,29
CFR Cluj,6574,2,6,6,2,15,9,6,24
FC Botosani,6574,3,5,4,5,9,14,-5,19
Universitate,6574,4,4,5,5,16,21,-5,17
D Bucuresti,6574,5,3,5,6,19,22,-3,14
Concordia Ch,6574,6,2,3,9,16,23,-7,9
FCSB,6575,1,8,6,0,26,12,14,30
CFR Cluj,6575,2,6,6,2,16,10,6,24
D Bucuresti,6575,3,4,4,6,19,21,-2,16
Universitate,6575,4,3,6,5,16,21,-5,15
Concordia Ch,6575,5,4,2,8,20,23,-3,14
FC Botosani,6575,6,3,4,7,6,16,-10,13
FCSB,6576,1,7,6,1,25,13,12,27
CFR Cluj,6576,2,6,6,2,15,9,6,24
Universitate,6576,3,4,6,4,16,19,-3,18
FC Botosani,6576,4,4,4,6,6,13,-7,16
Concordia Ch,6576,5,4,2,8,19,23,-4,14
D Bucuresti,6576,6,3,4,7,18,22,-4,13
FCSB,6577,1,9,5,0,27,12,15,32
CFR Cluj,6577,2,6,6,2,16,10,6,24
FC Botosani,6577,3,5,4,5,9,13,-4,19
Universitate,6577,4,3,5,6,16,22,-6,14
D Bucuresti,6577,5,3,4,7,16,21,-5,13
Concordia Ch,6577,6,3,2,9,17,23,-6,11
FCSB,6578,1,7,6,1,25,13,12,27
CFR Cluj,6578,2,6,7,1,16,9,7,25
D Bucuresti,6578,3,4,5,5,20,20,0,17
Universitate,6578,4,3,7,4,16,20,-4,16
FC Botosani,6578,5,3,5,6,6,15,-9,14
Concordia Ch,6578,6,2,4,8,18,24,-6,10
FCSB,6579,1,8,5,1,26,14,12,29
CFR Cluj,6579,2,5,7,2,15,10,5,22
Universitate,6579,3,4,6,4,18,20,-2,18
D Bucuresti,6579,4,4,5,5,18,18,0,17
FC Botosani,6579,5,3,4,7,5,15,-10,13
Concordia Ch,6579,6,3,3,8,16,21,-5,12
FCSB,6580,1,7,6,1,25,14,11,27
CFR Cluj,6580,2,7,6,1,16,7,9,27
D Bucuresti,6580,3,5,4,5,18,18,0,19
Universitate,6580,4,3,6,5,16,21,-5,15
FC Botosani,6580,5,3,5,6,5,13,-8,14
Concordia Ch,6580,6,2,3,9,15,22,-7,9
FCSB,6581,1,9,5,0,26,10,16,32
CFR Cluj,6581,2,6,6,2,14,9,5,24
FC Botosani,6581,3,4,4,6,9,14,-5,16
D Bucuresti,6581,4,3,5,6,20,25,-5,14
Universitate,6581,5,3,5,6,14,20,-6,14
Concordia Ch,6581,6,3,3,8,19,24,-5,12
FCSB,6582,1,8,6,0,26,11,15,30
CFR Cluj,6582,2,5,6,3,13,11,2,21
Universitate,6582,3,4,6,4,17,19,-2,18
D Bucuresti,6582,4,4,4,6,18,21,-3,16
FC Botosani,6582,5,4,4,6,7,15,-8,16
Concordia Ch,6582,6,3,2,9,19,23,-4,11
FCSB,6583,1,7,6,1,23,12,11,27
CFR Cluj,6583,2,7,6,1,16,7,9,27
FC Botosani,6583,3,4,4,6,6,13,-7,16
Universitate,6583,4,3,6,5,14,19,-5,15
D Bucuresti,6583,5,3,5,6,17,20,-3,14
Concordia Ch,6583,6,3,3,8,17,22,-5,12
FCSB,6584,1,7,6,1,24,12,12,27
CFR Cluj,6584,2,7,6,1,15,7,8,27
D Bucuresti,6584,3,4,4,6,18,22,-4,16
Universitate,6584,4,3,6,5,15,20,-5,15
FC Botosani,6584,5,3,5,6,6,15,-9,14
Concordia Ch,6584,6,3,3,8,20,22,-2,12
CFR Cluj,6585,1,7,6,1,17,7,10,27
FCSB,6585,2,7,5,2,24,15,9,26
Universitate,6585,3,4,5,5,17,21,-4,17
D Bucuresti,6585,4,4,4,6,19,21,-2,16
FC Botosani,6585,5,4,4,6,7,14,-7,16
Concordia Ch,6585,6,3,2,9,17,23,-6,11
FCSB,6586,1,7,5,2,25,15,10,26
CFR Cluj,6586,2,6,7,1,14,7,7,25
Universitate,6586,3,4,6,4,18,20,-2,18
FC Botosani,6586,4,4,5,5,8,14,-6,17
D Bucuresti,6586,5,4,4,6,20,22,-2,16
Concordia Ch,6586,6,2,3,9,18,25,-7,9
FCSB,6587,1,7,7,0,23,10,13,28
CFR Cluj,6587,2,6,7,1,15,8,7,25
D Bucuresti,6587,3,4,5,5,22,22,0,17
Universitate,6587,4,3,6,5,15,20,-5,15
FC Botosani,6587,5,3,5,6,6,15,-9,14
Concordia Ch,6587,6,2,4,8,18,24,-6,10
FCSB,6588,1,8,6,0,27,12,15,30
CFR Cluj,6588,2,6,6,2,18,10,8,24
FC Botosani,6588,3,4,5,5,7,13,-6,17
D Bucuresti,6588,4,3,6,5,18,20,-2,15
Universitate,6588,5,3,6,5,15,23,-8,15
Concordia Ch,6588,6,2,3,9,18,25,-7,9
FCSB,6589,1,8,5,1,26,13,13,29
CFR Cluj,6589,2,5,7,2,13,10,3,22
Universitate,6589,3,4,6,4,17,18,-1,18
FC Botosani,6589,4,4,5,5,8,14,-6,17
D Bucuresti,6589,5,3,5,6,16,19,-3,14
Concordia Ch,6589,6,2,4,8,17,23,-6,10
FCSB,6590,1,8,5,1,26,13,13,29
CFR Cluj,6590,2,7,6,1,15,7,8,27
D Bucuresti,6590,3,5,4,5,19,19,0,19
Universitate,6590,4,3,5,6,16,22,-6,14
FC Botosani,6590,5,3,4,7,6,15,-9,13
Concordia Ch,6590,6,3,2,9,18,24,-6,11
FCSB,6591,1,8,5,1,25,12,13,29
CFR Cluj,6591,2,5,7,2,14,9,5,22
Universitate,6591,3,4,6,4,17,20,-3,18
FC Botosani,6591,4,4,5,5,7,13,-6,17
D Bucuresti,6591,5,3,5,6,18,21,-3,14
Concordia Ch,6591,6,2,4,8,16,22,-6,10
FCSB,6592,1,7,7,0,23,10,13,28
CFR Cluj,6592,2,5,8,1,15,9,6,23
D Bucuresti,6592,3,5,4,5,20,19,1,19
Universitate,6592,4,3,7,4,16,20,-4,16
FC Botosani,6592,5,3,4,7,8,18,-10,13
Concordia Ch,6592,6,3,2,9,18,24,-6,11
FCSB,6593,1,8,6,0,26,12,14,30
CFR Cluj,6593,2,6,6,2,15,9,6,24
D Bucuresti,6593,3,4,5,5,20,19,1,17
FC Botosani,6593,4,4,4,6,6,15,-9,16
Universitate,6593,5,3,6,5,15,20,-5,15
Concordia Ch,6593,6,2,3,9,16,23,-7,9
FCSB,6594,1,8,5,1,24,13,11,29
CFR Cluj,6594,2,7,6,1,17,7,10,27
D Bucuresti,6594,3,4,4,6,18,20,-2,16
FC Botosani,6594,4,4,4,6,7,14,-7,16
Universitate,6594,5,3,5,6,14,20,-6,14
Concordia Ch,6594,6,3,2,9,18,24,-6,11
FCSB,6595,1,7,6,1,24,12,12,27
CFR Cluj,6595,2,5,8,1,13,7,6,23
D Bucuresti,6595,3,5,4,5,22,20,2,19
Universitate,6595,4,4,6,4,16,19,-3,18
FC Botosani,6595,5,3,4,7,8,18,-10,13
Concordia Ch,6595,6,3,2,9,19,26,-7,11
FCSB,6596,1,7,6,1,26,14,12,27
CFR Cluj,6596,2,5,8,1,14,8,6,23
FC Botosani,6596,3,5,4,5,11,13,-2,19
Universitate,6596,4,4,6,4,17,20,-3,18
D Bucuresti,6596,5,3,5,6,17,20,-3,14
Concordia Ch,6596,6,2,3,9,15,25,-10,9
FCSB,6597,1,9,5,0,29,11,18,32
CFR Cluj,6597,2,6,6,2,15,12,3,24
D Bucuresti,6597,3,5,4,5,21,19,2,19
FC Botosani,6597,4,4,4,6,8,16,-8,16
Universitate,6597,5,3,5,6,16,22,-6,14
Concordia Ch,6597,6,2,2,10,15,24,-9,8
CFR Cluj,6598,1,7,6,1,19,8,11,27
FCSB,6598,2,7,6,1,24,14,10,27
D Bucuresti,6598,3,4,4,6,19,21,-2,16
Universitate,6598,4,3,6,5,14,20,-6,15
Concordia Ch,6598,5,4,2,8,23,23,0,14
FC Botosani,6598,6,3,4,7,7,20,-13,13
FCSB,6599,1,8,6,0,27,13,14,30
CFR Cluj,6599,2,5,8,1,15,9,6,23
FC Botosani,6599,3,4,5,5,9,15,-6,17
D Bucuresti,6599,4,3,6,5,19,21,-2,15
Universitate,6599,5,3,6,5,15,20,-5,15
Concordia Ch,6599,6,2,3,9,15,22,-7,9
FCSB,6600,1,7,6,1,23,12,11,27
CFR Cluj,6600,2,5,8,1,14,8,6,23
Universitate,6600,3,4,6,4,17,19,-2,18
FC Botosani,6600,4,4,5,5,7,12,-5,17
D Bucuresti,6600,5,4,4,6,17,20,-3,16
Concordia Ch,6600,6,2,3,9,15,22,-7,9
FCSB,6601,1,9,5,0,28,10,18,32
CFR Cluj,6601,2,5,7,2,14,12,2,22
D Bucuresti,6601,3,4,5,5,21,20,1,17
Universitate,6601,4,3,6,5,15,20,-5,15
FC Botosani,6601,5,3,4,7,6,18,-12,13
Concordia Ch,6601,6,3,3,8,18,22,-4,12
FCSB,6602,1,8,5,1,27,14,13,29
CFR Cluj,6602,2,6,6,2,16,10,6,24
D Bucuresti,6602,3,5,4,5,19,18,1,19
Universitate,6602,4,4,5,5,16,20,-4,17
FC Botosani,6602,5,3,5,6,6,14,-8,14
Concordia Ch,6602,6,2,3,9,16,24,-8,9
FCSB,6603,1,8,6,0,26,12,14,30
CFR Cluj,6603,2,5,8,1,16,10,6,23
D Bucuresti,6603,3,4,5,5,20,19,1,17
Universitate,6603,4,3,6,5,17,22,-5,15
FC Botosani,6603,5,3,4,7,6,17,-11,13
Concordia Ch,6603,6,3,3,8,18,23,-5,12
FCSB,6604,1,8,5,1,27,14,13,29
CFR Cluj,6604,2,6,7,1,14,7,7,25
FC Botosani,6604,3,5,4,5,7,12,-5,19
Universitate,6604,4,3,6,5,17,22,-5,15
D Bucuresti,6604,5,3,4,7,17,22,-5,13
Concordia Ch,6604,6,3,2,9,18,23,-5,11
FCSB,6605,1,8,5,1,26,12,14,29
CFR Cluj,6605,2,5,7,2,15,12,3,22
Universitate,6605,3,4,6,4,18,20,-2,18
FC Botosani,6605,4,4,5,5,7,12,-5,17
D Bucuresti,6605,5,3,6,5,18,20,-2,15
Concordia Ch,6605,6,2,3,9,17,25,-8,9
FCSB,6606,1,8,5,1,26,13,13,29
CFR Cluj,6606,2,6,6,2,18,9,9,24
FC Botosani,6606,3,4,5,5,6,12,-6,17
Universitate,6606,4,4,5,5,16,23,-7,17
D Bucuresti,6606,5,3,5,6,18,21,-3,14
Concordia Ch,6606,6,2,4,8,17,23,-6,10
FCSB,6607,1,7,7,0,24,11,13,28
CFR Cluj,6607,2,5,8,1,15,9,6,23
Universitate,6607,3,3,7,4,15,19,-4,16
Concordia Ch,6607,4,4,2,8,19,21,-2,14
D Bucuresti,6607,5,3,5,6,19,24,-5,14
FC Botosani,6607,6,3,5,6,8,16,-8,14
FCSB,6608,1,9,5,0,26,10,16,32
CFR Cluj,6608,2,6,6,2,17,12,5,24
FC Botosani,6608,3,5,4,5,9,14,-5,19
Universitate,6608,4,3,5,6,17,23,-6,14
D Bucuresti,6608,5,3,4,7,17,23,-6,13
Concordia Ch,6608,6,3,2,9,19,23,-4,11
FCSB,6609,1,8,5,1,26,12,14,29
CFR Cluj,6609,2,5,6,3,14,11,3,21
Universitate,6609,3,5,5,4,16,18,-2,20
D Bucuresti,6609,4,4,5,5,19,19,0,17
FC Botosani,6609,5,4,4,6,6,14,-8,16
Concordia Ch,6609,6,2,3,9,16,23,-7,9
FCSB,6610,1,9,5,0,29,12,17,32
CFR Cluj,6610,2,6,6,2,16,9,7,24
FC Botosani,6610,3,4,5,5,7,13,-6,17
D Bucuresti,6610,4,3,6,5,16,18,-2,15
Universitate,6610,5,3,5,6,15,24,-9,14
Concordia Ch,6610,6,2,3,9,16,23,-7,9
FCSB,6611,1,8,5,1,25,12,13,29
CFR Cluj,6611,2,6,6,2,14,9,5,24
Universitate,6611,3,4,5,5,16,19,-3,17
D Bucuresti,6611,4,4,4,6,19,21,-2,16
Concordia Ch,6611,5,4,2,8,19,23,-4,14
FC Botosani,6611,6,3,4,7,5,14,-9,13
FCSB,6612,1,8,6,0,25,11,14,30
CFR Cluj,6612,2,5,6,3,13,11,2,21
FC Botosani,6612,3,5,4,5,9,14,-5,19
Universitate,6612,4,4,6,4,18,19,-1,18
D Bucuresti,6612,5,3,5,6,18,21,-3,14
Concordia Ch,6612,6,2,3,9,17,24,-7,9
FCSB,6613,1,8,6,0,27,13,14,30
CFR Cluj,6613,2,6,7,1,16,9,7,25
FC Botosani,6613,3,4,5,5,8,14,-6,17
D Bucuresti,6613,4,3,5,6,19,23,-4,14
Universitate,6613,5,3,5,6,15,21,-6,14
Concordia Ch,6613,6,3,2,9,18,23,-5,11
FCSB,6614,1,9,5,0,28,12,16,32
CFR Cluj,6614,2,6,6,2,16,10,6,24
D Bucuresti,6614,3,3,6,5,17,19,-2,15
Universitate,6614,4,3,5,6,16,23,-7,14
FC Botosani,6614,5,3,5,6,5,13,-8,14
Concordia Ch,6614,6,3,3,8,17,22,-5,12
FCSB,6615,1,9,5,0,30,12,18,32
CFR Cluj,6615,2,5,7,2,15,11,4,22
D Bucuresti,6615,3,5,4,5,21,20,1,19
Universitate,6615,4,3,6,5,16,23,-7,15
FC Botosani,6615,5,3,5,6,6,15,-9,14
Concordia Ch,6615,6,2,3,9,18,25,-7,9
FCSB,6616,1,7,5,2,24,14,10,26
CFR Cluj,6616,2,6,6,2,16,9,7,24
Universitate,6616,3,5,5,4,18,20,-2,20
FC Botosani,6616,4,4,4,6,9,15,-6,16
Concordia Ch,6616,5,4,2,8,21,24,-3,14
D Bucuresti,6616,6,3,4,7,19,25,-6,13
FCSB,6617,1,7,6,1,24,12,12,27
CFR Cluj,6617,2,7,6,1,15,7,8,27
Universitate,6617,3,3,6,5,15,20,-5,15
FC Botosani,6617,4,3,6,5,8,15,-7,15
D Bucuresti,6617,5,3,5,6,19,22,-3,14
Concordia Ch,6617,6,3,3,8,18,23,-5,12
FCSB,6618,1,8,6,0,27,11,16,30
CFR Cluj,6618,2,6,6,2,15,11,4,24
FC Botosani,6618,3,4,4,6,9,13,-4,16
D Bucuresti,6618,4,4,4,6,17,22,-5,16
Universitate,6618,5,3,6,5,16,21,-5,15
Concordia Ch,6618,6,3,2,9,16,22,-6,11
FCSB,6619,1,8,5,1,26,13,13,29
CFR Cluj,6619,2,5,7,2,17,12,5,22
FC Botosani,6619,3,5,4,5,9,12,-3,19
Universitate,6619,4,4,6,4,19,22,-3,18
D Bucuresti,6619,5,3,4,7,17,22,-5,13
Concordia Ch,6619,6,3,2,9,18,25,-7,11
FCSB,6620,1,7,6,1,23,11,12,27
CFR Cluj,6620,2,7,6,1,17,8,9,27
FC Botosani,6620,3,5,4,5,8,13,-5,19
Universitate,6620,4,3,6,5,15,21,-6,15
D Bucuresti,6620,5,3,5,6,19,22,-3,14
Concordia Ch,6620,6,2,3,9,17,24,-7,9
FCSB,6621,1,8,5,1,26,13,13,29
CFR Cluj,6621,2,7,6,1,17,8,9,27
D Bucuresti,6621,3,4,5,5,20,19,1,17
Universitate,6621,4,3,5,6,16,23,-7,14
FC Botosani,6621,5,3,5,6,6,16,-10,14
Concordia Ch,6621,6,3,2,9,20,26,-6,11
FCSB,6622,1,7,6,1,23,11,12,27
CFR Cluj,6622,2,6,7,1,15,7,8,25
Universitate,6622,3,4,5,5,15,20,-5,17
FC Botosani,6622,4,4,5,5,6,12,-6,17
D Bucuresti,6622,5,3,6,5,17,19,-2,15
Concordia Ch,6622,6,2,3,9,16,23,-7,9
FCSB,6623,1,8,6,0,25,10,15,30
CFR Cluj,6623,2,5,6,3,13,10,3,21
Universitate,6623,3,4,6,4,15,18,-3,18
D Bucuresti,6623,4,3,5,6,17,20,-3,14
Concordia Ch,6623,5,4,2,8,18,22,-4,14
FC Botosani,6623,6,3,5,6,5,13,-8,14
FCSB,6624,1,8,6,0,25,11,14,30
CFR Cluj,6624,2,6,7,1,16,8,8,25
FC Botosani,6624,3,4,4,6,7,13,-6,16
D Bucuresti,6624,4,3,5,6,17,21,-4,14
Universitate,6624,5,3,5,6,14,21,-7,14
Concordia Ch,6624,6,3,3,8,17,22,-5,12
FCSB,6625,1,8,6,0,29,14,15,30
CFR Cluj,6625,2,6,6,2,17,12,5,24
D Bucuresti,6625,3,4,4,6,18,22,-4,16
FC Botosani,6625,4,4,4,6,9,14,-5,16
Universitate,6625,5,3,6,5,17,22,-5,15
Concordia Ch,6625,6,3,2,9,18,24,-6,11
FCSB,6626,1,8,5,1,26,15,11,29
CFR Cluj,6626,2,5,7,2,15,10,5,22
Universitate,6626,3,4,6,4,19,20,-1,18
FC Botosani,6626,4,4,5,5,7,13,-6,17
D Bucuresti,6626,5,3,5,6,17,21,-4,14
Concordia Ch,6626,6,3,2,9,17,22,-5,11
FCSB,6627,1,9,5,0,26,10,16,32
CFR Cluj,6627,2,5,6,3,14,10,4,21
Universitate,6627,3,4,5,5,16,21,-5,17
FC Botosani,6627,4,4,5,5,8,13,-5,17
D Bucuresti,6627,5,3,6,5,19,21,-2,15
Concordia Ch,6627,6,2,3,9,17,25,-8,9
FCSB,6628,1,7,6,1,25,13,12,27
CFR Cluj,6628,2,6,7,1,17,7,10,25
Universitate,6628,3,4,5,5,17,24,-7,17
D Bucuresti,6628,4,4,4,6,18,20,-2,16
FC Botosani,6628,5,4,4,6,7,13,-6,16
Concordia Ch,6628,6,3,2,9,17,24,-7,11
FCSB,6629,1,9,5,0,28,12,16,32
CFR Cluj,6629,2,5,7,2,15,10,5,22
Universitate,6629,3,3,6,5,16,22,-6,15
Concordia Ch,6629,4,4,2,8,19,21,-2,14
D Bucuresti,6629,5,3,5,6,16,20,-4,14
FC Botosani,6629,6,3,5,6,5,14,-9,14
FCSB,6630,1,7,7,0,24,11,13,28
CFR Cluj,6630,2,5,8,1,13,7,6,23
FC Botosani,6630,3,4,5,5,9,13,-4,17
D Bucuresti,6630,4,4,4,6,17,21,-4,16
Universitate,6630,5,3,7,4,15,19,-4,16
Concordia Ch,6630,6,2,3,9,16,23,-7,9
FCSB,6631,1,8,5,1,24,11,13,29
CFR Cluj,6631,2,7,6,1,15,7,8,27
FC Botosani,6631,3,5,4,5,11,12,-1,19
D Bucuresti,6631,4,4,4,6,17,21,-4,16
Universitate,6631,5,3,5,6,14,20,-6,14
Concordia Ch,6631,6,2,2,10,15,25,-10,8
FCSB,6632,1,8,5,1,26,14,12,29
CFR Cluj,6632,2,6,7,1,17,9,8,25
FC Botosani,6632,3,4,5,5,8,12,-4,17
D Bucuresti,6632,4,3,6,5,18,20,-2,15
Universitate,6632,5,3,6,5,16,21,-5,15
Concordia Ch,6632,6,2,3,9,17,26,-9,9
FCSB,6633,1,9,5,0,25,10,15,32
CFR Cluj,6633,2,5,6,3,13,9,4,21
D Bucuresti,6633,3,5,4,5,20,18,2,19
Universitate,6633,4,4,5,5,15,19,-4,17
FC Botosani,6633,5,3,5,6,6,15,-9,14
Concordia Ch,6633,6,2,3,9,16,24,-8,9
FCSB,6634,1,8,5,1,24,12,12,29
CFR Cluj,6634,2,5,6,3,13,9,4,21
Universitate,6634,3,5,5,4,17,18,-1,20
D Bucuresti,6634,4,3,6,5,16,18,-2,15
FC Botosani,6634,5,3,6,5,6,13,-7,15
Concordia Ch,6634,6,2,4,8,16,22,-6,10
FCSB,6635,1,9,5,0,27,11,16,32
CFR Cluj,6635,2,5,7,2,17,13,4,22
FC Botosani,6635,3,4,5,5,7,13,-6,17
D Bucuresti,6635,4,3,6,5,16,18,-2,15
Universitate,6635,5,3,6,5,17,22,-5,15
Concordia Ch,6635,6,2,3,9,16,23,-7,9
FCSB,6636,1,9,5,0,26,11,15,32
CFR Cluj,6636,2,5,7,2,14,9,5,22
D Bucuresti,6636,3,4,5,5,23,20,3,17
FC Botosani,6636,4,4,4,6,6,17,-11,16
Universitate,6636,5,3,6,5,16,21,-5,15
Concordia Ch,6636,6,2,3,9,17,24,-7,9
FCSB,6637,1,8,6,0,26,10,16,30
CFR Cluj,6637,2,6,6,2,15,11,4,24
D Bucuresti,6637,3,4,4,6,18,20,-2,16
Universitate,6637,4,3,6,5,15,20,-5,15
Concordia Ch,6637,5,4,2,8,19,23,-4,14
FC Botosani,6637,6,3,4,7,6,15,-9,13
FCSB,6638,1,7,6,1,25,13,12,27
CFR Cluj,6638,2,6,7,1,18,11,7,25
Universitate,6638,3,4,5,5,17,21,-4,17
D Bucuresti,6638,4,4,4,6,19,22,-3,16
FC Botosani,6638,5,3,5,6,7,15,-8,14
Concordia Ch,6638,6,3,3,8,19,23,-4,12
FCSB,6639,1,9,5,0,27,10,17,32
CFR Cluj,6639,2,5,7,2,14,9,5,22
Universitate,6639,3,3,6,5,15,22,-7,15
Concordia Ch,6639,4,4,2,8,18,21,-3,14
D Bucuresti,6639,5,3,5,6,17,21,-4,14
FC Botosani,6639,6,3,5,6,6,14,-8,14
FCSB,6640,1,7,5,2,26,16,10,26
CFR Cluj,6640,2,6,6,2,16,10,6,24
Universitate,6640,3,5,5,4,20,21,-1,20
FC Botosani,6640,4,4,4,6,6,13,-7,16
Concordia Ch,6640,5,4,2,8,17,21,-4,14
D Bucuresti,6640,6,3,4,7,16,20,-4,13
FCSB,6641,1,8,6,0,27,12,15,30
CFR Cluj,6641,2,5,8,1,17,11,6,23
FC Botosani,6641,3,4,5,5,6,12,-6,17
Universitate,6641,4,3,6,5,16,22,-6,15
D Bucuresti,6641,5,3,5,6,18,21,-3,14
Concordia Ch,6641,6,2,4,8,17,23,-6,10
FCSB,6642,1,8,5,1,24,12,12,29
CFR Cluj,6642,2,5,7,2,14,9,5,22
Universitate,6642,3,4,6,4,17,19,-2,18
D Bucuresti,6642,4,4,5,5,18,19,-1,17
FC Botosani,6642,5,3,5,6,6,14,-8,14
Concordia Ch,6642,6,3,2,9,16,22,-6,11
FCSB,6643,1,8,6,0,25,10,15,30
CFR Cluj,6643,2,6,7,1,14,7,7,25
Concordia Ch,6643,3,4,2,8,19,22,-3,14
D Bucuresti,6643,4,3,5,6,16,20,-4,14
Universitate,6643,5,3,5,6,14,21,-7,14
FC Botosani,6643,6,3,5,6,6,14,-8,14
CFR Cluj,6644,1,7,6,1,17,8,9,27
FCSB,6644,2,7,5,2,24,13,11,26
Universitate,6644,3,4,5,5,15,20,-5,17
FC Botosani,6644,4,4,5,5,8,14,-6,17
D Bucuresti,6644,5,3,6,5,19,21,-2,15
Concordia Ch,6644,6,2,3,9,18,25,-7,9
FCSB,6645,1,8,5,1,26,13,13,29
CFR Cluj,6645,2,7,6,1,17,9,8,27
FC Botosani,6645,3,4,5,5,10,14,-4,17
D Bucuresti,6645,4,3,5,6,18,24,-6,14
Universitate,6645,5,3,5,6,16,22,-6,14
Concordia Ch,6645,6,3,2,9,19,24,-5,11
FCSB,6646,1,9,5,0,26,10,16,32
CFR Cluj,6646,2,6,6,2,16,9,7,24
D Bucuresti,6646,3,4,4,6,18,21,-3,16
FC Botosani,6646,4,4,4,6,7,14,-7,16
Universitate,6646,5,3,5,6,14,22,-8,14
Concordia Ch,6646,6,3,2,9,17,22,-5,11
FCSB,6647,1,7,6,1,24,12,12,27
CFR Cluj,6647,2,6,7,1,15,8,7,25
D Bucuresti,6647,3,4,5,5,19,20,-1,17
FC Botosani,6647,4,4,5,5,9,14,-5,17
Universitate,6647,5,3,7,4,14,18,-4,16
Concordia Ch,6647,6,2,2,10,15,24,-9,8
FCSB,6648,1,9,5,0,25,10,15,32
CFR Cluj,6648,2,6,6,2,16,8,8,24
FC Botosani,6648,3,4,5,5,7,13,-6,17
Universitate,6648,4,3,5,6,14,22,-8,14
D Bucuresti,6648,5,3,4,7,17,21,-4,13
Concordia Ch,6648,6,3,3,8,16,21,-5,12
FCSB,6649,1,8,6,0,27,12,15,30
CFR Cluj,6649,2,6,7,1,16,8,8,25
FC Botosani,6649,3,4,5,5,8,13,-5,17
D Bucuresti,6649,4,3,5,6,17,20,-3,14
Universitate,6649,5,3,5,6,15,23,-8,14
Concordia Ch,6649,6,3,2,9,16,23,-7,11
FCSB,6650,1,7,6,1,26,14,12,27
CFR Cluj,6650,2,5,8,1,17,11,6,23
D Bucuresti,6650,3,5,4,5,20,18,2,19
Universitate,6650,4,4,6,4,18,21,-3,18
FC Botosani,6650,5,4,4,6,6,14,-8,16
Concordia Ch,6650,6,2,2,10,15,24,-9,8
FCSB,6651,1,8,6,0,28,12,16,30
CFR Cluj,6651,2,5,7,2,15,10,5,22
FC Botosani,6651,3,5,4,5,8,13,-5,19
Universitate,6651,4,4,5,5,15,21,-6,17
D Bucuresti,6651,5,3,4,7,17,21,-4,13
Concordia Ch,6651,6,3,2,9,18,24,-6,11
FCSB,6652,1,7,5,2,23,14,9,26
CFR Cluj,6652,2,6,7,1,14,7,7,25
FC Botosani,6652,3,5,4,5,11,12,-1,19
Universitate,6652,4,4,6,4,17,18,-1,18
D Bucuresti,6652,5,3,4,7,17,21,-4,13
Concordia Ch,6652,6,3,2,9,17,27,-10,11
FCSB,6653,1,8,6,0,26,12,14,30
CFR Cluj,6653,2,5,8,1,15,9,6,23
D Bucuresti,6653,3,4,5,5,20,19,1,17
Universitate,6653,4,3,6,5,16,21,-5,15
FC Botosani,6653,5,3,5,6,5,15,-10,14
Concordia Ch,6653,6,2,4,8,16,22,-6,10
CFR Cluj,6654,1,7,6,1,16,7,9,27
FCSB,6654,2,7,5,2,24,13,11,26
D Bucuresti,6654,3,4,5,5,21,21,0,17
Universitate,6654,4,4,5,5,16,21,-5,17
FC Botosani,6654,5,3,4,7,6,17,-11,13
Concordia Ch,6654,6,3,3,8,19,23,-4,12
FCSB,6655,1,8,6,0,27,13,14,30
CFR Cluj,6655,2,5,7,2,16,11,5,22
FC Botosani,6655,3,5,4,5,7,12,-5,19
D Bucuresti,6655,4,4,4,6,19,20,-1,16
Universitate,6655,5,3,7,4,16,20,-4,16
Concordia Ch,6655,6,2,2,10,16,25,-9,8
FCSB,6656,1,8,6,0,26,11,15,30
CFR Cluj,6656,2,5,7,2,14,10,4,22
D Bucuresti,6656,3,4,4,6,21,19,2,16
Universitate,6656,4,3,7,4,16,20,-4,16
Concordia Ch,6656,5,4,2,8,19,21,-2,14
FC Botosani,6656,6,3,4,7,5,20,-15,13
FCSB,6657,1,8,5,1,27,14,13,29
CFR Cluj,6657,2,5,7,2,16,11,5,22
Universitate,6657,3,4,6,4,17,20,-3,18
D Bucuresti,6657,4,4,5,5,19,19,0,17
FC Botosani,6657,5,4,4,6,7,14,-7,16
Concordia Ch,6657,6,2,3,9,16,24,-8,9
FCSB,6658,1,8,5,1,24,11,13,29
CFR Cluj,6658,2,5,7,2,14,9,5,22
FC Botosani,6658,3,5,4,5,8,13,-5,19
Universitate,6658,4,4,6,4,16,19,-3,18
D Bucuresti,6658,5,4,4,6,19,19,0,16
Concordia Ch,6658,6,2,2,10,16,26,-10,8
FCSB,6659,1,8,5,1,25,11,14,29
CFR Cluj,6659,2,6,6,2,15,9,6,24
Universitate,6659,3,4,5,5,15,20,-5,17
D Bucuresti,6659,4,4,4,6,19,20,-1,16
Concordia Ch,6659,5,4,2,8,20,23,-3,14
FC Botosani,6659,6,3,4,7,6,17,-11,13
FCSB,6660,1,8,6,0,28,12,16,30
CFR Cluj,6660,2,5,7,2,15,12,3,22
D Bucuresti,6660,3,4,5,5,20,21,-1,17
Universitate,6660,4,3,7,4,18,22,-4,16
FC Botosani,6660,5,3,5,6,7,15,-8,14
Concordia Ch,6660,6,2,4,8,18,24,-6,10
FCSB,6661,1,8,5,1,28,14,14,29
CFR Cluj,6661,2,5,6,3,14,11,3,21
Universitate,6661,3,5,5,4,18,20,-2,20
D Bucuresti,6661,4,4,5,5,19,19,0,17
FC Botosani,6661,5,4,4,6,6,14,-8,16
Concordia Ch,6661,6,2,3,9,16,23,-7,9
FCSB,6662,1,9,5,0,26,11,15,32
CFR Cluj,6662,2,5,7,2,15,10,5,22
D Bucuresti,6662,3,4,4,6,19,20,-1,16
Universitate,6662,4,3,6,5,15,20,-5,15
Concordia Ch,6662,5,4,2,8,19,23,-4,14
FC Botosani,6662,6,3,4,7,6,16,-10,13
FCSB,6663,1,9,5,0,28,11,17,32
CFR Cluj,6663,2,5,6,3,14,11,3,21
Universitate,6663,3,4,5,5,17,22,-5,17
D Bucuresti,6663,4,4,4,6,17,20,-3,16
Concordia Ch,6663,5,4,2,8,18,21,-3,14
FC Botosani,6663,6,3,4,7,5,14,-9,13
FCSB,6664,1,7,5,2,24,14,10,26
CFR Cluj,6664,2,6,7,1,15,7,8,25
Universitate,6664,3,4,6,4,16,19,-3,18
FC Botosani,6664,4,4,5,5,9,14,-5,17
D Bucuresti,6664,5,3,5,6,17,22,-5,14
Concordia Ch,6664,6,3,2,9,19,24,-5,11
FCSB,6665,1,8,5,1,26,13,13,29
CFR Cluj,6665,2,5,7,2,13,8,5,22
FC Botosani,6665,3,5,4,5,9,14,-5,19
Universitate,6665,4,4,6,4,17,20,-3,18
D Bucuresti,6665,5,3,4,7,18,23,-5,13
Concordia Ch,6665,6,3,2,9,17,22,-5,11
FCSB,6666,1,8,6,0,27,11,16,30
CFR Cluj,6666,2,5,8,1,14,8,6,23
D Bucuresti,6666,3,5,4,5,20,20,0,19
FC Botosani,6666,4,4,4,6,7,14,-7,16
Universitate,6666,5,3,6,5,14,21,-7,15
Concordia Ch,6666,6,2,2,10,16,24,-8,8
FCSB,6667,1,8,5,1,27,15,12,29
CFR Cluj,6667,2,5,7,2,15,10,5,22
Universitate,6667,3,4,6,4,21,23,-2,18
FC Botosani,6667,4,4,5,5,8,14,-6,17
D Bucuresti,6667,5,4,4,6,20,21,-1,16
Concordia Ch,6667,6,2,3,9,15,23,-8,9
FCSB,6668,1,8,5,1,26,14,12,29
CFR Cluj,6668,2,6,6,2,15,10,5,24
Universitate,6668,3,4,5,5,17,19,-2,17
D Bucuresti,6668,4,4,4,6,18,21,-3,16
FC Botosani,6668,5,4,4,6,8,16,-8,16
Concordia Ch,6668,6,3,2,9,18,22,-4,11
FCSB,6669,1,7,5,2,25,15,10,26
CFR Cluj,6669,2,6,7,1,15,8,7,25
Universitate,6669,3,4,6,4,17,19,-2,18
D Bucuresti,6669,4,4,5,5,19,20,-1,17
FC Botosani,6669,5,4,4,6,8,15,-7,16
Concordia Ch,6669,6,2,3,9,17,24,-7,9
FCSB,6670,1,7,6,1,23,12,11,27
CFR Cluj,6670,2,6,7,1,14,7,7,25
Universitate,6670,3,4,5,5,16,19,-3,17
D Bucuresti,6670,4,4,4,6,17,19,-2,16
FC Botosani,6670,5,3,5,6,5,13,-8,14
Concordia Ch,6670,6,3,3,8,16,21,-5,12
FCSB,6671,1,8,6,0,25,11,14,30
CFR Cluj,6671,2,6,6,2,15,8,7,24
D Bucuresti,6671,3,4,5,5,20,21,-1,17
FC Botosani,6671,4,4,5,5,8,13,-5,17
Universitate,6671,5,3,6,5,15,21,-6,15
Concordia Ch,6671,6,2,2,10,17,26,-9,8
FCSB,6672,1,8,5,1,26,12,14,29
CFR Cluj,6672,2,6,6,2,17,11,6,24
D Bucuresti,6672,3,5,4,5,21,21,0,19
Universitate,6672,4,4,5,5,16,21,-5,17
FC Botosani,6672,5,4,4,6,9,14,-5,16
Concordia Ch,6672,6,2,2,10,17,27,-10,8
FCSB,6673,1,7,6,1,24,13,11,27
CFR Cluj,6673,2,5,8,1,13,7,6,23
Universitate,6673,3,4,6,4,17,19,-2,18
D Bucuresti,6673,4,4,5,5,18,19,-1,17
FC Botosani,6673,5,4,5,5,8,13,-5,17
Concordia Ch,6673,6,2,2,10,15,24,-9,8
CFR Cluj,6674,1,7,6,1,17,7,10,27
FCSB,6674,2,7,5,2,24,15,9,26
Universitate,6674,3,4,5,5,17,21,-4,17
FC Botosani,6674,4,4,5,5,7,13,-6,17
D Bucuresti,6674,5,3,5,6,16,20,-4,14
Concordia Ch,6674,6,3,2,9,18,23,-5,11
FCSB,6675,1,8,6,0,26,11,15,30
CFR Cluj,6675,2,5,6,3,13,10,3,21
Universitate,6675,3,4,6,4,16,19,-3,18
D Bucuresti,6675,4,3,6,5,19,21,-2,15
FC Botosani,6675,5,3,5,6,6,16,-10,14
Concordia Ch,6675,6,3,3,8,20,23,-3,12
FCSB,6676,1,7,5,2,25,15,10,26
CFR Cluj,6676,2,6,7,1,19,11,8,25
Universitate,6676,3,4,6,4,17,20,-3,18
FC Botosani,6676,4,4,5,5,10,15,-5,17
D Bucuresti,6676,5,3,5,6,19,23,-4,14
Concordia Ch,6676,6,3,2,9,19,25,-6,11
FCSB,6677,1,8,6,0,28,14,14,30
CFR Cluj,6677,2,6,6,2,18,11,7,24
FC Botosani,6677,3,5,4,5,8,12,-4,19
Universitate,6677,4,3,6,5,15,21,-6,15
D Bucuresti,6677,5,3,4,7,17,21,-4,13
Concordia Ch,6677,6,3,2,9,17,24,-7,11
FCSB,6678,1,8,6,0,27,11,16,30
CFR Cluj,6678,2,6,6,2,16,11,5,24
D Bucuresti,6678,3,4,4,6,19,24,-5,16
Universitate,6678,4,3,6,5,14,20,-6,15
FC Botosani,6678,5,3,5,6,5,15,-10,14
Concordia Ch,6678,6,3,3,8,21,21,0,12
CFR Cluj,6679,1,7,6,1,17,9,8,27
FCSB,6679,2,7,5,2,24,13,11,26
Universitate,6679,3,4,5,5,18,22,-4,17
D Bucuresti,6679,4,4,4,6,19,21,-2,16
FC Botosani,6679,5,3,5,6,5,13,-8,14
Concordia Ch,6679,6,3,3,8,18,23,-5,12
FCSB,6680,1,7,5,2,23,12,11,26
CFR Cluj,6680,2,6,7,1,14,7,7,25
Universitate,6680,3,4,6,4,15,18,-3,18
FC Botosani,6680,4,4,5,5,9,15,-6,17
D Bucuresti,6680,5,3,4,7,18,23,-5,13
Concordia Ch,6680,6,3,3,8,18,22,-4,12
FCSB,6681,1,8,5,1,27,12,15,29
CFR Cluj,6681,2,6,6,2,15,10,5,24
D Bucuresti,6681,3,5,4,5,22,19,3,19
Universitate,6681,4,4,5,5,16,21,-5,17
FC Botosani,6681,5,4,4,6,11,17,-6,16
Concordia Ch,6681,6,2,2,10,17,29,-12,8
FCSB,6682,1,8,5,1,26,11,15,29
CFR Cluj,6682,2,6,6,2,14,8,6,24
D Bucuresti,6682,3,4,5,5,19,20,-1,17
Universitate,6682,4,4,5,5,15,21,-6,17
FC Botosani,6682,5,4,4,6,8,14,-6,16
Concordia Ch,6682,6,2,3,9,16,24,-8,9
FCSB,6683,1,8,6,0,29,12,17,30
CFR Cluj,6683,2,5,7,2,14,9,5,22
D Bucuresti,6683,3,4,5,5,21,21,0,17
Universitate,6683,4,4,5,5,16,23,-7,17
FC Botosani,6683,5,3,4,7,8,18,-10,13
Concordia Ch,6683,6,3,3,8,18,23,-5,12
FCSB,6684,1,8,5,1,25,12,13,29
CFR Cluj,6684,2,6,6,2,15,9,6,24
Universitate,6684,3,4,5,5,15,19,-4,17
Concordia Ch,6684,4,4,2,8,22,23,-1,14
D Bucuresti,6684,5,3,5,6,17,22,-5,14
FC Botosani,6684,6,3,5,6,6,15,-9,14
FCSB,6685,1,7,6,1,23,12,11,27
CFR Cluj,6685,2,6,7,1,15,8,7,25
Universitate,6685,3,4,5,5,17,20,-3,17
D Bucuresti,6685,4,3,5,6,18,21,-3,14
Concordia Ch,6685,5,4,2,8,19,23,-4,14
FC Botosani,6685,6,3,5,6,7,15,-8,14
FCSB,6686,1,8,6,0,25,11,14,30
CFR Cluj,6686,2,6,7,1,14,7,7,25
FC Botosani,6686,3,4,5,5,8,13,-5,17
D Bucuresti,6686,4,3,5,6,18,21,-3,14
Universitate,6686,5,3,5,6,15,21,-6,14
Concordia Ch,6686,6,3,2,9,17,24,-7,11
FCSB,6687,1,8,5,1,25,12,13,29
CFR Cluj,6687,2,7,6,1,19,9,10,27
D Bucuresti,6687,3,5,4,5,22,20,2,19
FC Botosani,6687,4,4,4,6,8,15,-7,16
Universitate,6687,5,3,5,6,15,23,-8,14
Concordia Ch,6687,6,2,2,10,17,27,-10,8
FCSB,6688,1,9,5,0,28,10,18,32
CFR Cluj,6688,2,6,6,2,15,11,4,24
FC Botosani,6688,3,4,5,5,8,14,-6,17
D Bucuresti,6688,4,3,5,6,20,23,-3,14
Universitate,6688,5,3,5,6,15,22,-7,14
Concordia Ch,6688,6,2,4,8,19,25,-6,10
FCSB,6689,1,7,6,1,23,11,12,27
CFR Cluj,6689,2,6,6,2,14,8,6,24
Universitate,6689,3,4,6,4,15,18,-3,18
D Bucuresti,6689,4,4,4,6,18,20,-2,16
FC Botosani,6689,5,4,4,6,9,13,-4,16
Concordia Ch,6689,6,3,2,9,17,26,-9,11
FCSB,6690,1,8,6,0,27,11,16,30
CFR Cluj,6690,2,6,6,2,15,10,5,24
D Bucuresti,6690,3,5,4,5,18,18,0,19
Universitate,6690,4,3,6,5,15,21,-6,15
FC Botosani,6690,5,3,5,6,6,14,-8,14
Concordia Ch,6690,6,2,3,9,16,23,-7,9
FCSB,6691,1,8,5,1,26,11,15,29
CFR Cluj,6691,2,6,6,2,15,11,4,24
D Bucuresti,6691,3,4,5,5,19,19,0,17
Universitate,6691,4,4,5,5,16,20,-4,17
FC Botosani,6691,5,3,6,5,6,13,-7,15
Concordia Ch,6691,6,2,3,9,17,25,-8,9
FCSB,6692,1,7,5,2,24,14,10,26
CFR Cluj,6692,2,6,6,2,16,9,7,24
Universitate,6692,3,5,5,4,18,20,-2,20
D Bucuresti,6692,4,4,5,5,18,19,-1,17
FC Botosani,6692,5,4,4,6,9,14,-5,16
Concordia Ch,6692,6,2,3,9,15,24,-9,9
FCSB,6693,1,8,6,0,31,13,18,30
CFR Cluj,6693,2,6,6,2,14,12,2,24
D Bucuresti,6693,3,4,5,5,19,20,-1,17
FC Botosani,6693,4,4,4,6,7,14,-7,16
Universitate,6693,5,3,6,5,17,22,-5,15
Concordia Ch,6693,6,2,3,9,18,25,-7,9
FCSB,6694,1,9,5,0,32,10,22,32
CFR Cluj,6694,2,6,6,2,16,12,4,24
D Bucuresti,6694,3,4,4,6,18,20,-2,16
Concordia Ch,6694,4,4,2,8,18,22,-4,14
Universitate,6694,5,3,5,6,14,25,-11,14
FC Botosani,6694,6,3,4,7,5,14,-9,13
FCSB,6695,1,8,6,0,26,11,15,30
CFR Cluj,6695,2,5,7,2,15,11,4,22
FC Botosani,6695,3,5,4,5,9,13,-4,19
D Bucuresti,6695,4,4,4,6,20,23,-3,16
Universitate,6695,5,3,7,4,17,21,-4,16
Concordia Ch,6695,6,2,2,10,17,25,-8,8
FCSB,6696,1,8,5,1,25,14,11,29
CFR Cluj,6696,2,5,7,2,15,10,5,22
Universitate,6696,3,4,6,4,20,21,-1,18
D Bucuresti,6696,4,4,4,6,18,19,-1,16
Concordia Ch,6696,5,4,2,8,18,21,-3,14
FC Botosani,6696,6,3,4,7,5,16,-11,13
FCSB,6697,1,8,5,1,28,13,15,29
CFR Cluj,6697,2,5,6,3,14,14,0,21
Universitate,6697,3,5,5,4,18,18,0,20
D Bucuresti,6697,4,4,5,5,18,19,-1,17
FC Botosani,6697,5,3,5,6,6,14,-8,14
Concordia Ch,6697,6,2,4,8,17,23,-6,10
FCSB,6698,1,9,5,0,27,11,16,32
CFR Cluj,6698,2,6,6,2,17,9,8,24
D Bucuresti,6698,3,4,4,6,18,19,-1,16
FC Botosani,6698,4,4,4,6,9,14,-5,16
Universitate,6698,5,3,5,6,14,23,-9,14
Concordia Ch,6698,6,3,2,9,16,25,-9,11
FCSB,6699,1,9,5,0,25,10,15,32
CFR Cluj,6699,2,5,6,3,13,9,4,21
D Bucuresti,6699,3,5,4,5,21,18,3,19
Universitate,6699,4,4,5,5,15,19,-4,17
FC Botosani,6699,5,3,4,7,5,16,-11,13
Concordia Ch,6699,6,3,2,9,16,23,-7,11
FCSB,6700,1,8,5,1,26,14,12,29
CFR Cluj,6700,2,5,7,2,16,11,5,22
D Bucuresti,6700,3,5,4,5,19,19,0,19
Universitate,6700,4,4,6,4,17,19,-2,18
FC Botosani,6700,5,4,4,6,7,14,-7,16
Concordia Ch,6700,6,2,2,10,15,23,-8,8
FCSB,6701,1,8,6,0,29,12,17,30
CFR Cluj,6701,2,5,7,2,15,10,5,22
FC Botosani,6701,3,4,5,5,7,13,-6,17
Universitate,6701,4,4,5,5,15,22,-7,17
D Bucuresti,6701,5,3,4,7,19,23,-4,13
Concordia Ch,6701,6,3,3,8,18,23,-5,12
FCSB,6702,1,8,5,1,25,14,11,29
CFR Cluj,6702,2,6,6,2,14,8,6,24
Universitate,6702,3,4,5,5,18,20,-2,17
D Bucuresti,6702,4,4,4,6,18,20,-2,16
Concordia Ch,6702,5,4,2,8,19,23,-4,14
FC Botosani,6702,6,3,4,7,6,15,-9,13
FCSB,6703,1,8,5,1,25,11,14,29
CFR Cluj,6703,2,6,6,2,14,8,6,24
Universitate,6703,3,4,5,5,15,20,-5,17
D Bucuresti,6703,4,4,4,6,20,23,-3,16
FC Botosani,6703,5,3,5,6,6,15,-9,14
Concordia Ch,6703,6,3,3,8,19,22,-3,12
FCSB,6704,1,8,6,0,26,11,15,30
CFR Cluj,6704,2,6,7,1,17,8,9,25
D Bucuresti,6704,3,4,4,6,19,21,-2,16
Concordia Ch,6704,4,4,2,8,18,21,-3,14
Universitate,6704,5,3,5,6,14,23,-9,14
FC Botosani,6704,6,3,4,7,6,16,-10,13
FCSB,6705,1,8,5,1,26,12,14,29
CFR Cluj,6705,2,6,6,2,14,9,5,24
Universitate,6705,3,4,5,5,16,20,-4,17
FC Botosani,6705,4,4,4,6,6,13,-7,16
Concordia Ch,6705,5,4,2,8,17,21,-4,14
D Bucuresti,6705,6,3,4,7,16,20,-4,13
FCSB,6706,1,8,5,1,26,14,12,29
CFR Cluj,6706,2,6,6,2,16,9,7,24
D Bucuresti,6706,3,4,5,5,18,19,-1,17
FC Botosani,6706,4,4,5,5,9,12,-3,17
Universitate,6706,5,4,5,5,17,21,-4,17
Concordia Ch,6706,6,2,2,10,16,27,-11,8
FCSB,6707,1,7,5,2,24,14,10,26
CFR Cluj,6707,2,6,6,2,15,8,7,24
Universitate,6707,3,5,5,4,17,19,-2,20
D Bucuresti,6707,4,3,6,5,18,20,-2,15
FC Botosani,6707,5,3,6,5,7,14,-7,15
Concordia Ch,6707,6,2,4,8,17,23,-6,10
FCSB,6708,1,8,6,0,31,13,18,30
CFR Cluj,6708,2,6,7,1,18,11,7,25
D Bucuresti,6708,3,4,4,6,17,20,-3,16
FC Botosani,6708,4,3,5,6,5,13,-8,14
Universitate,6708,5,3,5,6,17,27,-10,14
Concordia Ch,6708,6,3,3,8,17,21,-4,12
FCSB,6709,1,7,5,2,26,17,9,26
CFR Cluj,6709,2,6,6,2,15,8,7,24
Universitate,6709,3,5,5,4,20,21,-1,20
D Bucuresti,6709,4,5,4,5,21,20,1,19
FC Botosani,6709,5,4,4,6,8,15,-7,16
Concordia Ch,6709,6,2,2,10,17,26,-9,8
FCSB,6710,1,8,5,1,25,12,13,29
CFR Cluj,6710,2,5,7,2,14,9,5,22
Universitate,6710,3,4,6,4,15,18,-3,18
FC Botosani,6710,4,3,6,5,6,13,-7,15
D Bucuresti,6710,5,3,5,6,19,22,-3,14
Concordia Ch,6710,6,3,3,8,18,23,-5,12
CFR Cluj,6711,1,7,6,1,15,7,8,27
FCSB,6711,2,7,5,2,23,13,10,26
Universitate,6711,3,4,5,5,16,19,-3,17
D Bucuresti,6711,4,4,4,6,18,23,-5,16
FC Botosani,6711,5,4,4,6,8,15,-7,16
Concordia Ch,6711,6,3,2,9,20,23,-3,11
FCSB,6712,1,8,5,1,26,12,14,29
CFR Cluj,6712,2,6,6,2,15,9,6,24
Universitate,6712,3,4,5,5,17,22,-5,17
D Bucuresti,6712,4,4,4,6,20,20,0,16
FC Botosani,6712,5,4,4,6,8,15,-7,16
Concordia Ch,6712,6,3,2,9,17,25,-8,11
FCSB,6713,1,7,7,0,25,12,13,28
CFR Cluj,6713,2,6,7,1,15,7,8,25
FC Botosani,6713,3,4,5,5,8,13,-5,17
Universitate,6713,4,3,6,5,16,22,-6,15
D Bucuresti,6713,5,3,4,7,17,22,-5,13
Concordia Ch,6713,6,3,3,8,18,23,-5,12
FCSB,6714,1,8,6,0,25,11,14,30
CFR Cluj,6714,2,5,8,1,14,8,6,23
D Bucuresti,6714,3,4,4,6,17,19,-2,16
FC Botosani,6714,4,4,4,6,7,14,-7,16
Universitate,6714,5,3,6,5,16,21,-5,15
Concordia Ch,6714,6,3,2,9,17,23,-6,11
FCSB,6715,1,8,5,1,27,13,14,29
CFR Cluj,6715,2,7,6,1,17,9,8,27
D Bucuresti,6715,3,4,4,6,20,20,0,16
Concordia Ch,6715,4,4,2,8,19,23,-4,14
Universitate,6715,5,3,5,6,16,23,-7,14
FC Botosani,6715,6,3,4,7,6,17,-11,13
FCSB,6716,1,7,6,1,24,12,12,27
CFR Cluj,6716,2,6,7,1,15,8,7,25
Universitate,6716,3,3,7,4,14,18,-4,16
FC Botosani,6716,4,4,4,6,10,14,-4,16
D Bucuresti,6716,5,4,4,6,18,24,-6,16
Concordia Ch,6716,6,3,2,9,18,23,-5,11
FCSB,6717,1,8,5,1,26,13,13,29
CFR Cluj,6717,2,7,6,1,17,9,8,27
FC Botosani,6717,3,4,5,5,7,13,-6,17
Universitate,6717,4,3,5,6,14,20,-6,14
D Bucuresti,6717,5,3,4,7,16,21,-5,13
Concordia Ch,6717,6,3,3,8,18,22,-4,12
FCSB,6718,1,8,5,1,26,13,13,29
CFR Cluj,6718,2,5,7,2,15,11,4,22
Universitate,6718,3,4,6,4,17,19,-2,18
D Bucuresti,6718,4,4,5,5,17,18,-1,17
FC Botosani,6718,5,4,4,6,6,13,-7,16
Concordia Ch,6718,6,2,3,9,15,22,-7,9
FCSB,6719,1,8,5,1,28,11,17,29
CFR Cluj,6719,2,6,7,1,15,8,7,25
D Bucuresti,6719,3,4,5,5,19,19,0,17
Universitate,6719,4,3,6,5,15,24,-9,15
FC Botosani,6719,5,3,5,6,7,16,-9,14
Concordia Ch,6719,6,2,4,8,16,22,-6,10
FCSB,6720,1,8,6,0,25,11,14,30
CFR Cluj,6720,2,5,6,3,14,10,4,21
Universitate,6720,3,4,6,4,17,20,-3,18
D Bucuresti,6720,4,4,5,5,19,20,-1,17
FC Botosani,6720,5,3,5,6,8,16,-8,14
Concordia Ch,6720,6,3,2,9,17,23,-6,11
FCSB,6721,1,8,6,0,25,11,14,30
CFR Cluj,6721,2,5,7,2,13,8,5,22
Universitate,6721,3,4,5,5,16,20,-4,17
FC Botosani,6721,4,4,4,6,8,14,-6,16
Concordia Ch,6721,5,4,2,8,20,23,-3,14
D Bucuresti,6721,6,3,4,7,17,23,-6,13
FCSB,6722,1,9,5,0,27,12,15,32
CFR Cluj,6722,2,5,6,3,15,11,4,21
D Bucuresti,6722,3,4,5,5,18,18,0,17
Universitate,6722,4,4,5,5,17,21,-4,17
FC Botosani,6722,5,4,4,6,6,14,-8,16
Concordia Ch,6722,6,2,3,9,15,22,-7,9
CFR Cluj,6723,1,7,6,1,16,8,8,27
FCSB,6723,2,7,5,2,24,15,9,26
Universitate,6723,3,4,5,5,17,19,-2,17
FC Botosani,6723,4,4,5,5,7,12,-5,17
D Bucuresti,6723,5,3,4,7,17,25,-8,13
Concordia Ch,6723,6,3,3,8,20,22,-2,12
FCSB,6724,1,9,5,0,29,14,15,32
CFR Cluj,6724,2,5,7,2,14,9,5,22
FC Botosani,6724,3,5,4,5,9,12,-3,19
Universitate,6724,4,3,6,5,17,22,-5,15
D Bucuresti,6724,5,3,5,6,17,21,-4,14
Concordia Ch,6724,6,2,3,9,16,24,-8,9
FCSB,6725,1,8,5,1,24,11,13,29
CFR Cluj,6725,2,6,6,2,15,9,6,24
Universitate,6725,3,4,5,5,16,20,-4,17
D Bucuresti,6725,4,4,4,6,17,19,-2,16
Concordia Ch,6725,5,4,2,8,18,22,-4,14
FC Botosani,6725,6,3,4,7,6,15,-9,13
FCSB,6726,1,8,6,0,25,10,15,30
CFR Cluj,6726,2,5,8,1,15,9,6,23
D Bucuresti,6726,3,4,5,5,18,18,0,17
Universitate,6726,4,3,6,5,16,22,-6,15
FC Botosani,6726,5,3,5,6,6,15,-9,14
Concordia Ch,6726,6,2,4,8,16,22,-6,10
FCSB,6727,1,8,5,1,27,13,14,29
CFR Cluj,6727,2,6,6,2,15,10,5,24
Universitate,6727,3,4,5,5,17,21,-4,17
FC Botosani,6727,4,4,5,5,6,12,-6,17
D Bucuresti,6727,5,4,4,6,18,19,-1,16
Concordia Ch,6727,6,2,3,9,15,23,-8,9
FCSB,6728,1,9,5,0,28,11,17,32
CFR Cluj,6728,2,5,6,3,15,12,3,21
Universitate,6728,3,4,5,5,17,22,-5,17
D Bucuresti,6728,4,4,4,6,18,20,-2,16
FC Botosani,6728,5,4,4,6,7,13,-6,16
Concordia Ch,6728,6,3,2,9,17,24,-7,11
FCSB,6729,1,8,6,0,30,10,20,30
CFR Cluj,6729,2,5,7,2,14,9,5,22
D Bucuresti,6729,3,4,5,5,21,22,-1,17
Universitate,6729,4,4,5,5,16,26,-10,17
FC Botosani,6729,5,3,6,5,8,15,-7,15
Concordia Ch,6729,6,2,3,9,20,27,-7,9
FCSB,6730,1,8,5,1,25,12,13,29
CFR Cluj,6730,2,6,7,1,16,9,7,25
D Bucuresti,6730,3,5,4,5,22,20,2,19
FC Botosani,6730,4,4,4,6,7,15,-8,16
Universitate,6730,5,3,6,5,15,20,-5,15
Concordia Ch,6730,6,2,2,10,16,25,-9,8
FCSB,6731,1,9,5,0,29,14,15,32
CFR Cluj,6731,2,5,6,3,15,11,4,21
Universitate,6731,3,4,5,5,19,23,-4,17
FC Botosani,6731,4,4,4,6,8,16,-8,16
D Bucuresti,6731,5,3,5,6,19,22,-3,14
Concordia Ch,6731,6,3,3,8,20,24,-4,12
FCSB,6732,1,7,7,0,24,11,13,28
CFR Cluj,6732,2,5,7,2,14,9,5,22
Universitate,6732,3,4,6,4,15,18,-3,18
D Bucuresti,6732,4,4,5,5,19,20,-1,17
FC Botosani,6732,5,3,6,5,7,14,-7,15
Concordia Ch,6732,6,2,3,9,17,24,-7,9
FCSB,6733,1,9,5,0,33,13,20,32
CFR Cluj,6733,2,6,6,2,17,13,4,24
D Bucuresti,6733,3,4,5,5,19,19,0,17
FC Botosani,6733,4,4,4,6,7,15,-8,16
Universitate,6733,5,3,5,6,16,25,-9,14
Concordia Ch,6733,6,2,3,9,17,24,-7,9
CFR Cluj,6734,1,7,6,1,17,7,10,27
FCSB,6734,2,7,5,2,25,14,11,26
D Bucuresti,6734,3,5,4,5,20,19,1,19
Universitate,6734,4,4,5,5,17,23,-6,17
FC Botosani,6734,5,4,4,6,8,14,-6,16
Concordia Ch,6734,6,2,2,10,15,25,-10,8
FCSB,6735,1,8,6,0,25,10,15,30
CFR Cluj,6735,2,6,6,2,16,10,6,24
D Bucuresti,6735,3,5,4,5,20,18,2,19
Universitate,6735,4,3,6,5,15,21,-6,15
FC Botosani,6735,5,3,5,6,7,16,-9,14
Concordia Ch,6735,6,2,3,9,17,25,-8,9
FCSB,6736,1,7,6,1,24,12,12,27
CFR Cluj,6736,2,7,6,1,16,8,8,27
FC Botosani,6736,3,4,4,6,7,14,-7,16
Universitate,6736,4,3,6,5,16,21,-5,15
D Bucuresti,6736,5,3,5,6,16,19,-3,14
Concordia Ch,6736,6,3,3,8,17,22,-5,12
FCSB,6737,1,8,5,1,26,14,12,29
CFR Cluj,6737,2,5,7,2,15,10,5,22
Universitate,6737,3,4,6,4,16,18,-2,18
D Bucuresti,6737,4,4,4,6,17,20,-3,16
FC Botosani,6737,5,4,4,6,7,13,-6,16
Concordia Ch,6737,6,3,2,9,17,23,-6,11
FCSB,6738,1,8,5,1,25,12,13,29
CFR Cluj,6738,2,6,6,2,15,9,6,24
D Bucuresti,6738,3,5,4,5,19,19,0,19
Universitate,6738,4,4,5,5,15,19,-4,17
FC Botosani,6738,5,4,4,6,9,16,-7,16
Concordia Ch,6738,6,2,2,10,19,27,-8,8
FCSB,6739,1,7,5,2,24,16,8,26
CFR Cluj,6739,2,6,6,2,18,10,8,24
Universitate,6739,3,5,5,4,20,21,-1,20
D Bucuresti,6739,4,4,5,5,18,19,-1,17
FC Botosani,6739,5,3,5,6,7,16,-9,14
Concordia Ch,6739,6,3,2,9,20,25,-5,11
FCSB,6740,1,8,6,0,27,11,16,30
CFR Cluj,6740,2,5,7,2,13,8,5,22
D Bucuresti,6740,3,5,4,5,21,18,3,19
Universitate,6740,4,4,5,5,16,22,-6,17
FC Botosani,6740,5,4,4,6,7,13,-6,16
Concordia Ch,6740,6,2,2,10,15,27,-12,8
CFR Cluj,6741,1,7,6,1,17,8,9,27
FCSB,6741,2,7,5,2,24,14,10,26
D Bucuresti,6741,3,4,5,5,19,20,-1,17
Universitate,6741,4,4,5,5,17,21,-4,17
FC Botosani,6741,5,3,4,7,6,15,-9,13
Concordia Ch,6741,6,3,3,8,17,22,-5,12
FCSB,6742,1,7,7,0,25,12,13,28
CFR Cluj,6742,2,6,7,1,17,9,8,25
D Bucuresti,6742,3,4,4,6,23,22,1,16
FC Botosani,6742,4,4,4,6,8,17,-9,16
Universitate,6742,5,3,6,5,14,20,-6,15
Concordia Ch,6742,6,3,2,9,19,26,-7,11
FCSB,6743,1,7,6,1,24,12,12,27
CFR Cluj,6743,2,5,8,1,13,7,6,23
Universitate,6743,3,4,6,4,16,19,-3,18
FC Botosani,6743,4,4,4,6,9,15,-6,16
Concordia Ch,6743,5,4,2,8,19,23,-4,14
D Bucuresti,6743,6,3,4,7,16,21,-5,13
FCSB,6744,1,9,5,0,27,12,15,32
CFR Cluj,6744,2,5,6,3,14,10,4,21
D Bucuresti,6744,3,5,4,5,21,19,2,19
Universitate,6744,4,4,5,5,16,20,-4,17
FC Botosani,6744,5,4,4,6,6,14,-8,16
Concordia Ch,6744,6,2,2,10,16,25,-9,8
FCSB,6745,1,7,7,0,24,11,13,28
CFR Cluj,6745,2,6,7,1,14,7,7,25
D Bucuresti,6745,3,4,5,5,19,20,-1,17
FC Botosani,6745,4,4,4,6,8,15,-7,16
Universitate,6745,5,3,6,5,15,20,-5,15
Concordia Ch,6745,6,2,3,9,17,24,-7,9
FCSB,6746,1,9,5,0,26,11,15,32
CFR Cluj,6746,2,6,6,2,15,8,7,24
FC Botosani,6746,3,3,6,5,8,15,-7,15
D Bucuresti,6746,4,3,5,6,20,23,-3,14
Universitate,6746,5,3,5,6,15,22,-7,14
Concordia Ch,6746,6,3,3,8,19,24,-5,12
FCSB,6747,1,7,6,1,23,12,11,27
CFR Cluj,6747,2,6,6,2,15,8,7,24
Universitate,6747,3,4,6,4,15,18,-3,18
FC Botosani,6747,4,4,5,5,7,13,-6,17
D Bucuresti,6747,5,3,4,7,17,21,-4,13
Concordia Ch,6747,6,3,3,8,18,23,-5,12
FCSB,6748,1,8,5,1,26,12,14,29
CFR Cluj,6748,2,6,6,2,16,9,7,24
Universitate,6748,3,4,5,5,16,22,-6,17
D Bucuresti,6748,4,4,4,6,19,21,-2,16
FC Botosani,6748,5,4,4,6,6,14,-8,16
Concordia Ch,6748,6,3,2,9,18,23,-5,11
FCSB,6749,1,8,5,1,24,11,13,29
CFR Cluj,6749,2,5,6,3,13,9,4,21
Universitate,6749,3,5,5,4,16,18,-2,20
Concordia Ch,6749,4,4,2,8,19,22,-3,14
D Bucuresti,6749,5,3,5,6,18,21,-3,14
FC Botosani,6749,6,3,5,6,6,15,-9,14
FCSB,6750,1,7,6,1,25,13,12,27
CFR Cluj,6750,2,6,7,1,16,9,7,25
D Bucuresti,6750,3,4,4,6,19,20,-1,16
Universitate,6750,4,3,7,4,18,22,-4,16
FC Botosani,6750,5,3,5,6,6,15,-9,14
Concordia Ch,6750,6,3,3,8,16,21,-5,12
FCSB,6751,1,8,6,0,26,12,14,30
CFR Cluj,6751,2,6,7,1,16,9,7,25
D Bucuresti,6751,3,4,4,6,20,21,-1,16
Universitate,6751,4,3,5,6,14,20,-6,14
FC Botosani,6751,5,3,5,6,5,14,-9,14
Concordia Ch,6751,6,3,3,8,18,23,-5,12
FCSB,6752,1,8,6,0,25,10,15,30
CFR Cluj,6752,2,6,7,1,17,8,9,25
D Bucuresti,6752,3,4,5,5,20,21,-1,17
FC Botosani,6752,4,3,6,5,7,14,-7,15
Universitate,6752,5,3,5,6,15,24,-9,14
Concordia Ch,6752,6,2,3,9,16,23,-7,9
FCSB,6753,1,8,6,0,24,10,14,30
CFR Cluj,6753,2,5,7,2,13,8,5,22
FC Botosani,6753,3,4,5,5,8,13,-5,17
Universitate,6753,4,3,7,4,14,18,-4,16
D Bucuresti,6753,5,3,5,6,18,24,-6,14
Concordia Ch,6753,6,3,2,9,20,24,-4,11
FCSB,6754,1,9,5,0,26,10,16,32
CFR Cluj,6754,2,6,6,2,15,9,6,24
D Bucuresti,6754,3,4,5,5,17,18,-1,17
FC Botosani,6754,4,4,5,5,6,12,-6,17
Universitate,6754,5,3,5,6,14,21,-7,14
Concordia Ch,6754,6,2,2,10,15,23,-8,8
FCSB,6755,1,7,7,0,25,12,13,28
CFR Cluj,6755,2,6,7,1,16,9,7,25
FC Botosani,6755,3,4,5,5,7,12,-5,17
D Bucuresti,6755,4,3,6,5,17,19,-2,15
Universitate,6755,5,3,6,5,14,19,-5,15
Concordia Ch,6755,6,2,3,9,16,24,-8,9
FCSB,6756,1,7,6,1,23,11,12,27
CFR Cluj,6756,2,6,7,1,14,7,7,25
Universitate,6756,3,4,5,5,15,19,-4,17
D Bucuresti,6756,4,4,4,6,18,20,-2,16
Concordia Ch,6756,5,4,2,8,20,23,-3,14
FC Botosani,6756,6,3,4,7,6,16,-10,13
FCSB,6757,1,8,5,1,25,11,14,29
CFR Cluj,6757,2,6,6,2,14,8,6,24
Universitate,6757,3,4,5,5,15,20,-5,17
D Bucuresti,6757,4,3,6,5,17,19,-2,15
FC Botosani,6757,5,3,5,6,6,14,-8,14
Concordia Ch,6757,6,3,3,8,16,21,-5,12
FCSB,6758,1,8,6,0,28,14,14,30
CFR Cluj,6758,2,6,6,2,15,9,6,24
D Bucuresti,6758,3,5,4,5,20,19,1,19
FC Botosani,6758,4,4,4,6,7,14,-7,16
Universitate,6758,5,3,6,5,17,22,-5,15
Concordia Ch,6758,6,2,2,10,16,25,-9,8
FCSB,6759,1,7,6,1,26,14,12,27
CFR Cluj,6759,2,5,8,1,15,9,6,23
Universitate,6759,3,4,6,4,16,19,-3,18
D Bucuresti,6759,4,4,5,5,19,20,-1,17
FC Botosani,6759,5,3,5,6,5,13,-8,14
Concordia Ch,6759,6,3,2,9,18,24,-6,11
FCSB,6760,1,7,6,1,23,11,12,27
CFR Cluj,6760,2,6,7,1,16,7,9,25
FC Botosani,6760,3,4,5,5,8,13,-5,17
Universitate,6760,4,4,5,5,15,21,-6,17
D Bucuresti,6760,5,3,5,6,16,22,-6,14
Concordia Ch,6760,6,3,2,9,20,24,-4,11
CFR Cluj,6761,1,7,6,1,18,8,10,27
FCSB,6761,2,7,5,2,24,14,10,26
D Bucuresti,6761,3,4,5,5,19,20,-1,17
Universitate,6761,4,4,5,5,16,21,-5,17
FC Botosani,6761,5,3,6,5,7,14,-7,15
Concordia Ch,6761,6,2,3,9,17,24,-7,9
FCSB,6762,1,9,5,0,27,10,17,32
CFR Cluj,6762,2,6,6,2,14,10,4,24
FC Botosani,6762,3,4,5,5,8,13,-5,17
D Bucuresti,6762,4,3,5,6,18,21,-3,14
Universitate,6762,5,3,5,6,14,20,-6,14
Concordia Ch,6762,6,3,2,9,17,24,-7,11
FCSB,6763,1,8,6,0,25,11,14,30
CFR Cluj,6763,2,6,7,1,19,8,11,25
D Bucuresti,6763,3,4,5,5,19,20,-1,17
FC Botosani,6763,4,3,5,6,6,14,-8,14
Universitate,6763,5,3,5,6,14,24,-10,14
Concordia Ch,6763,6,2,4,8,16,22,-6,10
FCSB,6764,1,8,6,0,25,11,14,30
CFR Cluj,6764,2,5,7,2,13,8,5,22
FC Botosani,6764,3,5,4,5,8,13,-5,19
D Bucuresti,6764,4,4,4,6,20,19,1,16
Universitate,6764,5,3,7,4,15,19,-4,16
Concordia Ch,6764,6,2,2,10,16,27,-11,8
FCSB,6765,1,9,5,0,30,11,19,32
CFR Cluj,6765,2,5,6,3,13,13,0,21
Universitate,6765,3,4,5,5,16,20,-4,17
FC Botosani,6765,4,4,5,5,10,16,-6,17
D Bucuresti,6765,5,3,6,5,18,20,-2,15
Concordia Ch,6765,6,2,3,9,17,24,-7,9
FCSB,6766,1,8,6,0,28,11,17,30
CFR Cluj,6766,2,6,6,2,15,12,3,24
D Bucuresti,6766,3,4,5,5,21,20,1,17
Universitate,6766,4,3,6,5,16,21,-5,15
FC Botosani,6766,5,3,4,7,7,18,-11,13
Concordia Ch,6766,6,3,3,8,18,23,-5,12
FCSB,6767,1,8,5,1,24,11,13,29
CFR Cluj,6767,2,6,6,2,17,9,8,24
FC Botosani,6767,3,5,4,5,9,13,-4,19
Universitate,6767,4,4,5,5,16,22,-6,17
D Bucuresti,6767,5,4,4,6,17,20,-3,16
Concordia Ch,6767,6,2,2,10,16,24,-8,8
FCSB,6768,1,7,7,0,25,12,13,28
CFR Cluj,6768,2,5,8,1,14,8,6,23
D Bucuresti,6768,3,4,5,5,19,19,0,17
Universitate,6768,4,3,7,4,17,21,-4,16
FC Botosani,6768,5,3,5,6,6,15,-9,14
Concordia Ch,6768,6,2,4,8,15,21,-6,10
FCSB,6769,1,9,5,0,27,10,17,32
CFR Cluj,6769,2,5,7,2,14,10,4,22
FC Botosani,6769,3,4,4,6,9,16,-7,16
Universitate,6769,4,3,6,5,15,21,-6,15
Concordia Ch,6769,5,4,2,8,20,23,-3,14
D Bucuresti,6769,6,3,4,7,17,22,-5,13
FCSB,6770,1,8,5,1,27,13,14,29
CFR Cluj,6770,2,7,6,1,17,8,9,27
D Bucuresti,6770,3,3,6,5,19,21,-2,15
FC Botosani,6770,4,3,6,5,7,14,-7,15
Universitate,6770,5,3,5,6,16,24,-8,14
Concordia Ch,6770,6,2,4,8,16,22,-6,10
FCSB,6771,1,7,6,1,24,12,12,27
CFR Cluj,6771,2,6,7,1,15,8,7,25
D Bucuresti,6771,3,5,4,5,19,19,0,19
Universitate,6771,4,3,7,4,16,20,-4,16
FC Botosani,6771,5,3,4,7,6,17,-11,13
Concordia Ch,6771,6,3,2,9,20,24,-4,11
FCSB,6772,1,8,6,0,26,12,14,30
CFR Cluj,6772,2,5,6,3,15,11,4,21
Universitate,6772,3,4,6,4,15,18,-3,18
D Bucuresti,6772,4,4,4,6,19,21,-2,16
Concordia Ch,6772,5,4,2,8,18,22,-4,14
FC Botosani,6772,6,3,4,7,6,15,-9,13
FCSB,6773,1,8,6,0,24,10,14,30
CFR Cluj,6773,2,5,8,1,13,7,6,23
FC Botosani,6773,3,4,4,6,8,14,-6,16
Universitate,6773,4,3,6,5,14,19,-5,15
Concordia Ch,6773,5,4,2,8,20,24,-4,14
D Bucuresti,6773,6,3,4,7,18,23,-5,13
FCSB,6774,1,8,5,1,25,14,11,29
CFR Cluj,6774,2,7,6,1,20,10,10,27
D Bucuresti,6774,3,3,6,5,18,20,-2,15
Universitate,6774,4,3,5,6,16,22,-6,14
FC Botosani,6774,5,3,5,6,7,16,-9,14
Concordia Ch,6774,6,3,3,8,19,23,-4,12
FCSB,6775,1,7,7,0,27,14,13,28
CFR Cluj,6775,2,5,8,1,16,10,6,23
FC Botosani,6775,3,4,5,5,7,12,-5,17
Universitate,6775,4,3,7,4,17,21,-4,16
D Bucuresti,6775,5,3,5,6,16,21,-5,14
Concordia Ch,6775,6,3,2,9,18,23,-5,11
FCSB,6776,1,8,6,0,25,11,14,30
CFR Cluj,6776,2,5,7,2,14,9,5,22
Universitate,6776,3,4,5,5,15,19,-4,17
D Bucuresti,6776,4,4,4,6,17,20,-3,16
FC Botosani,6776,5,3,5,6,6,14,-8,14
Concordia Ch,6776,6,3,3,8,18,22,-4,12
FCSB,6777,1,8,6,0,26,12,14,30
CFR Cluj,6777,2,6,6,2,14,8,6,24
D Bucuresti,6777,3,4,4,6,19,21,-2,16
FC Botosani,6777,4,4,4,6,6,13,-7,16
Universitate,6777,5,3,6,5,16,21,-5,15
Concordia Ch,6777,6,3,2,9,18,24,-6,11
FCSB,6778,1,8,5,1,25,12,13,29
CFR Cluj,6778,2,5,6,3,14,10,4,21
Universitate,6778,3,5,5,4,18,20,-2,20
D Bucuresti,6778,4,5,4,5,21,19,2,19
FC Botosani,6778,5,4,4,6,7,14,-7,16
Concordia Ch,6778,6,2,2,10,16,26,-10,8
FCSB,6779,1,8,5,1,26,13,13,29
CFR Cluj,6779,2,7,6,1,17,9,8,27
FC Botosani,6779,3,5,4,5,9,14,-5,19
Universitate,6779,4,3,5,6,16,22,-6,14
D Bucuresti,6779,5,3,4,7,17,22,-5,13
Concordia Ch,6779,6,3,2,9,18,23,-5,11
FCSB,6780,1,8,5,1,27,11,16,29
CFR Cluj,6780,2,6,6,2,14,11,3,24
Universitate,6780,3,4,5,5,15,19,-4,17
FC Botosani,6780,4,3,6,5,8,15,-7,15
D Bucuresti,6780,5,3,5,6,18,22,-4,14
Concordia Ch,6780,6,3,3,8,20,24,-4,12
FCSB,6781,1,9,5,0,29,11,18,32
CFR Cluj,6781,2,5,6,3,15,13,2,21
Universitate,6781,3,4,5,5,16,21,-5,17
FC Botosani,6781,4,4,5,5,6,12,-6,17
D Bucuresti,6781,5,3,4,7,17,22,-5,13
Concordia Ch,6781,6,3,3,8,18,22,-4,12
FCSB,6782,1,8,6,0,24,10,14,30
CFR Cluj,6782,2,6,7,1,17,8,9,25
D Bucuresti,6782,3,4,5,5,21,20,1,17
FC Botosani,6782,4,4,4,6,8,16,-8,16
Universitate,6782,5,3,5,6,15,23,-8,14
Concordia Ch,6782,6,2,3,9,18,26,-8,9
FCSB,6783,1,8,6,0,25,11,14,30
CFR Cluj,6783,2,5,8,1,17,11,6,23
D Bucuresti,6783,3,4,5,5,17,18,-1,17
FC Botosani,6783,4,4,5,5,8,12,-4,17
Universitate,6783,5,3,6,5,17,22,-5,15
Concordia Ch,6783,6,2,2,10,15,25,-10,8
FCSB,6784,1,8,6,0,26,11,15,30
CFR Cluj,6784,2,6,7,1,15,8,7,25
D Bucuresti,6784,3,5,4,5,19,18,1,19
Universitate,6784,4,3,5,6,14,21,-7,14
FC Botosani,6784,5,3,5,6,5,13,-8,14
Concordia Ch,6784,6,2,3,9,15,23,-8,9
FCSB,6785,1,8,5,1,25,13,12,29
CFR Cluj,6785,2,6,7,1,15,7,8,25
D Bucuresti,6785,3,4,5,5,17,18,-1,17
FC Botosani,6785,4,4,4,6,7,13,-6,16
Universitate,6785,5,3,6,5,15,20,-5,15
Concordia Ch,6785,6,2,3,9,15,23,-8,9
FCSB,6786,1,7,5,2,25,16,9,26
CFR Cluj,6786,2,6,7,1,15,8,7,25
Universitate,6786,3,4,6,4,18,19,-1,18
D Bucuresti,6786,4,4,5,5,18,19,-1,17
FC Botosani,6786,5,4,5,5,7,12,-5,17
Concordia Ch,6786,6,2,2,10,16,25,-9,8
FCSB,6787,1,7,6,1,26,15,11,27
CFR Cluj,6787,2,5,8,1,15,9,6,23
Universitate,6787,3,4,6,4,19,21,-2,18
D Bucuresti,6787,4,3,6,5,18,20,-2,15
FC Botosani,6787,5,3,6,5,5,12,-7,15
Concordia Ch,6787,6,2,4,8,17,23,-6,10
FCSB,6788,1,7,6,1,23,11,12,27
CFR Cluj,6788,2,6,7,1,14,7,7,25
Universitate,6788,3,4,5,5,15,19,-4,17
D Bucuresti,6788,4,4,4,6,18,20,-2,16
FC Botosani,6788,5,3,5,6,5,13,-8,14
Concordia Ch,6788,6,3,3,8,17,22,-5,12
FCSB,6789,1,8,6,0,25,10,15,30
CFR Cluj,6789,2,6,7,1,16,8,8,25
D Bucuresti,6789,3,4,4,6,18,20,-2,16
FC Botosani,6789,4,4,4,6,7,15,-8,16
Universitate,6789,5,3,5,6,15,23,-8,14
Concordia Ch,6789,6,3,2,9,19,24,-5,11
FCSB,6790,1,9,5,0,29,11,18,32
CFR Cluj,6790,2,5,7,2,14,12,2,22
FC Botosani,6790,3,4,5,5,6,12,-6,17
D Bucuresti,6790,4,3,6,5,17,19,-2,15
Universitate,6790,5,3,6,5,16,21,-5,15
Concordia Ch,6790,6,2,3,9,16,23,-7,9
FCSB,6791,1,8,6,0,27,10,17,30
CFR Cluj,6791,2,5,8,1,13,7,6,23
FC Botosani,6791,3,4,5,5,6,12,-6,17
Universitate,6791,4,3,6,5,14,22,-8,15
D Bucuresti,6791,5,3,4,7,17,21,-4,13
Concordia Ch,6791,6,3,3,8,17,22,-5,12
FCSB,6792,1,7,6,1,26,15,11,27
CFR Cluj,6792,2,6,6,2,16,9,7,24
Universitate,6792,3,4,6,4,17,20,-3,18
FC Botosani,6792,4,4,4,6,7,15,-8,16
Concordia Ch,6792,5,4,2,8,20,21,-1,14
D Bucuresti,6792,6,3,4,7,16,22,-6,13
FCSB,6793,1,9,5,0,28,11,17,32
CFR Cluj,6793,2,6,6,2,16,10,6,24
D Bucuresti,6793,3,4,4,6,22,23,-1,16
Concordia Ch,6793,4,4,2,8,20,24,-4,14
Universitate,6793,5,3,5,6,16,24,-8,14
FC Botosani,6793,6,3,4,7,6,16,-10,13
FCSB,6794,1,9,5,0,27,11,16,32
CFR Cluj,6794,2,6,6,2,15,9,6,24
D Bucuresti,6794,3,5,4,5,21,20,1,19
FC Botosani,6794,4,4,4,6,9,16,-7,16
Universitate,6794,5,3,5,6,15,22,-7,14
Concordia Ch,6794,6,2,2,10,18,27,-9,8
FCSB,6795,1,7,5,2,23,13,10,26
CFR Cluj,6795,2,6,6,2,15,8,7,24
Universitate,6795,3,5,5,4,16,18,-2,20
D Bucuresti,6795,4,4,4,6,18,22,-4,16
FC Botosani,6795,5,4,4,6,9,14,-5,16
Concordia Ch,6795,6,3,2,9,18,24,-6,11
FCSB,6796,1,8,5,1,27,14,13,29
CFR Cluj,6796,2,5,6,3,16,13,3,21
Universitate,6796,3,5,5,4,18,19,-1,20
D Bucuresti,6796,4,4,5,5,19,18,1,17
FC Botosani,6796,5,4,4,6,6,15,-9,16
Concordia Ch,6796,6,2,3,9,15,22,-7,9
FCSB,6797,1,8,6,0,26,11,15,30
CFR Cluj,6797,2,6,6,2,14,9,5,24
FC Botosani,6797,3,4,5,5,8,13,-5,17
Universitate,6797,4,3,6,5,15,20,-5,15
D Bucuresti,6797,5,3,5,6,17,22,-5,14
Concordia Ch,6797,6,3,2,9,18,23,-5,11
FCSB,6798,1,7,6,1,23,11,12,27
CFR Cluj,6798,2,5,8,1,13,7,6,23
Universitate,6798,3,4,6,4,15,18,-3,18
D Bucuresti,6798,4,4,5,5,17,18,-1,17
FC Botosani,6798,5,4,4,6,6,13,-7,16
Concordia Ch,6798,6,2,3,9,15,22,-7,9
FCSB,6799,1,8,6,0,27,12,15,30
CFR Cluj,6799,2,5,7,2,15,11,4,22
D Bucuresti,6799,3,4,5,5,18,19,-1,17
Universitate,6799,4,3,7,4,16,20,-4,16
FC Botosani,6799,5,4,4,6,6,13,-7,16
Concordia Ch,6799,6,2,3,9,16,23,-7,9
FCSB,6800,1,8,6,0,25,10,15,30
CFR Cluj,6800,2,6,7,1,14,7,7,25
D Bucuresti,6800,3,5,4,5,19,19,0,19
Universitate,6800,4,3,5,6,14,21,-7,14
FC Botosani,6800,5,3,4,7,5,14,-9,13
Concordia Ch,6800,6,3,2,9,17,23,-6,11
FCSB,6801,1,8,6,0,24,10,14,30
CFR Cluj,6801,2,5,8,1,13,7,6,23
FC Botosani,6801,3,4,5,5,8,13,-5,17
Universitate,6801,4,3,6,5,14,19,-5,15
D Bucuresti,6801,5,3,5,6,18,21,-3,14
Concordia Ch,6801,6,3,2,9,17,24,-7,11
FCSB,6802,1,8,5,1,26,14,12,29
CFR Cluj,6802,2,6,6,2,18,11,7,24
D Bucuresti,6802,3,4,5,5,22,21,1,17
Universitate,6802,4,4,5,5,18,22,-4,17
FC Botosani,6802,5,4,4,6,8,15,-7,16
Concordia Ch,6802,6,2,3,9,18,27,-9,9
FCSB,6803,1,8,5,1,24,11,13,29
CFR Cluj,6803,2,6,7,1,14,7,7,25
D Bucuresti,6803,3,4,4,6,18,21,-3,16
FC Botosani,6803,4,4,4,6,7,13,-6,16
Universitate,6803,5,3,6,5,14,19,-5,15
Concordia Ch,6803,6,3,2,9,18,24,-6,11
FCSB,6804,1,8,5,1,25,12,13,29
CFR Cluj,6804,2,6,7,1,15,7,8,25
FC Botosani,6804,3,5,4,5,9,14,-5,19
D Bucuresti,6804,4,4,4,6,19,21,-2,16
Universitate,6804,5,3,6,5,14,20,-6,15
Concordia Ch,6804,6,2,2,10,17,25,-8,8
FCSB,6805,1,7,5,2,24,13,11,26
CFR Cluj,6805,2,6,7,1,15,8,7,25
Universitate,6805,3,4,6,4,15,18,-3,18
D Bucuresti,6805,4,4,5,5,20,21,-1,17
FC Botosani,6805,5,4,5,5,9,15,-6,17
Concordia Ch,6805,6,2,2,10,17,25,-8,8
FCSB,6806,1,8,6,0,25,10,15,30
CFR Cluj,6806,2,5,8,1,13,7,6,23
D Bucuresti,6806,3,4,4,6,19,21,-2,16
FC Botosani,6806,4,4,4,6,7,14,-7,16
Universitate,6806,5,3,6,5,14,20,-6,15
Concordia Ch,6806,6,3,2,9,19,25,-6,11
FCSB,6807,1,8,5,1,25,12,13,29
CFR Cluj,6807,2,6,6,2,14,8,6,24
Universitate,6807,3,4,5,5,16,20,-4,17
FC Botosani,6807,4,4,5,5,9,15,-6,17
D Bucuresti,6807,5,3,5,6,18,21,-3,14
Concordia Ch,6807,6,3,2,9,17,23,-6,11
FCSB,6808,1,9,5,0,26,11,15,32
CFR Cluj,6808,2,6,6,2,19,10,9,24
D Bucuresti,6808,3,5,4,5,20,20,0,19
FC Botosani,6808,4,3,5,6,6,14,-8,14
Universitate,6808,5,3,5,6,15,24,-9,14
Concordia Ch,6808,6,2,3,9,18,25,-7,9
FCSB,6809,1,9,5,0,30,12,18,32
CFR Cluj,6809,2,6,6,2,16,11,5,24
D Bucuresti,6809,3,5,4,5,19,18,1,19
FC Botosani,6809,4,4,4,6,6,13,-7,16
Universitate,6809,5,3,5,6,14,22,-8,14
Concordia Ch,6809,6,2,2,10,15,24,-9,8
FCSB,6810,1,9,5,0,28,12,16,32
CFR Cluj,6810,2,6,6,2,15,9,6,24
D Bucuresti,6810,3,4,5,5,18,19,-1,17
FC Botosani,6810,4,4,5,5,8,14,-6,17
Universitate,6810,5,3,5,6,15,22,-7,14
Concordia Ch,6810,6,2,2,10,16,24,-8,8
FCSB,6811,1,7,5,2,23,12,11,26
CFR Cluj,6811,2,6,6,2,15,9,6,24
Universitate,6811,3,5,5,4,17,19,-2,20
D Bucuresti,6811,4,4,5,5,19,20,-1,17
FC Botosani,6811,5,3,5,6,7,15,-8,14
Concordia Ch,6811,6,2,4,8,17,23,-6,10
FCSB,6812,1,8,6,0,26,12,14,30
CFR Cluj,6812,2,5,8,1,14,8,6,23
FC Botosani,6812,3,5,4,5,7,12,-5,19
Universitate,6812,4,3,6,5,15,20,-5,15
D Bucuresti,6812,5,3,4,7,16,21,-5,13
Concordia Ch,6812,6,3,2,9,17,22,-5,11
FCSB,6813,1,8,6,0,25,11,14,30
CFR Cluj,6813,2,5,8,1,15,9,6,23
D Bucuresti,6813,3,4,5,5,17,18,-1,17
Universitate,6813,4,3,6,5,15,20,-5,15
FC Botosani,6813,5,3,6,5,6,13,-7,15
Concordia Ch,6813,6,2,3,9,16,23,-7,9
FCSB,6814,1,7,6,1,23,12,11,27
CFR Cluj,6814,2,6,7,1,15,7,8,25
D Bucuresti,6814,3,5,4,5,19,19,0,19
Universitate,6814,4,3,7,4,14,18,-4,16
FC Botosani,6814,5,4,4,6,10,15,-5,16
Concordia Ch,6814,6,2,2,10,16,26,-10,8
FCSB,6815,1,7,6,1,24,14,10,27
CFR Cluj,6815,2,6,7,1,15,8,7,25
FC Botosani,6815,3,5,4,5,8,12,-4,19
Universitate,6815,4,4,5,5,17,19,-2,17
D Bucuresti,6815,5,3,4,7,18,22,-4,13
Concordia Ch,6815,6,3,2,9,18,25,-7,11
FCSB,6816,1,8,6,0,29,12,17,30
CFR Cluj,6816,2,5,8,1,14,8,6,23
D Bucuresti,6816,3,4,4,6,18,20,-2,16
Universitate,6816,4,3,6,5,15,23,-8,15
Concordia Ch,6816,5,4,2,8,19,22,-3,14
FC Botosani,6816,6,3,4,7,6,16,-10,13
FCSB,6817,1,7,7,0,24,11,13,28
CFR Cluj,6817,2,6,7,1,16,8,8,25
D Bucuresti,6817,3,4,5,5,19,20,-1,17
Universitate,6817,4,3,6,5,14,20,-6,15
FC Botosani,6817,5,3,6,5,8,15,-7,15
Concordia Ch,6817,6,2,3,9,18,25,-7,9
FCSB,6818,1,8,6,0,29,11,18,30
CFR Cluj,6818,2,5,6,3,14,14,0,21
Universitate,6818,3,4,6,4,15,18,-3,18
D Bucuresti,6818,4,4,5,5,19,20,-1,17
FC Botosani,6818,5,4,4,6,8,15,-7,16
Concordia Ch,6818,6,2,3,9,19,26,-7,9
FCSB,6819,1,9,5,0,27,10,17,32
CFR Cluj,6819,2,6,6,2,14,9,5,24
FC Botosani,6819,3,5,4,5,10,13,-3,19
D Bucuresti,6819,4,4,4,6,19,21,-2,16
Universitate,6819,5,3,5,6,14,21,-7,14
Concordia Ch,6819,6,2,2,10,17,27,-10,8
FCSB,6820,1,8,6,0,26,12,14,30
CFR Cluj,6820,2,5,7,2,14,9,5,22
Universitate,6820,3,4,5,5,16,20,-4,17
D Bucuresti,6820,4,3,6,5,17,19,-2,15
FC Botosani,6820,5,3,6,5,6,13,-7,15
Concordia Ch,6820,6,2,4,8,17,23,-6,10
CFR Cluj,6821,1,7,6,1,19,11,8,27
FCSB,6821,2,7,5,2,24,13,11,26
Universitate,6821,3,4,5,5,18,22,-4,17
D Bucuresti,6821,4,3,6,5,18,20,-2,15
FC Botosani,6821,5,3,6,5,6,13,-7,15
Concordia Ch,6821,6,2,4,8,16,22,-6,10
FCSB,6822,1,8,5,1,26,11,15,29
CFR Cluj,6822,2,6,7,1,14,7,7,25
D Bucuresti,6822,3,4,4,6,20,21,-1,16
Universitate,6822,4,3,6,5,14,21,-7,15
FC Botosani,6822,5,3,5,6,6,15,-9,14
Concordia Ch,6822,6,3,3,8,17,22,-5,12
FCSB,6823,1,8,5,1,26,12,14,29
CFR Cluj,6823,2,6,6,2,15,11,4,24
Universitate,6823,3,4,5,5,17,20,-3,17
D Bucuresti,6823,4,4,4,6,20,19,1,16
FC Botosani,6823,5,4,4,6,8,16,-8,16
Concordia Ch,6823,6,3,2,9,16,24,-8,11
FCSB,6824,1,8,5,1,25,13,12,29
CFR Cluj,6824,2,6,6,2,15,9,6,24
D Bucuresti,6824,3,4,5,5,18,19,-1,17
Universitate,6824,4,4,5,5,18,21,-3,17
FC Botosani,6824,5,3,5,6,5,13,-8,14
Concordia Ch,6824,6,2,4,8,16,22,-6,10
FCSB,6825,1,7,5,2,24,14,10,26
CFR Cluj,6825,2,6,7,1,15,8,7,25
Universitate,6825,3,4,6,4,18,20,-2,18
Concordia Ch,6825,4,4,2,8,18,21,-3,14
D Bucuresti,6825,5,3,5,6,17,20,-3,14
FC Botosani,6825,6,3,5,6,6,15,-9,14
FCSB,6826,1,7,6,1,23,11,12,27
CFR Cluj,6826,2,7,6,1,16,7,9,27
D Bucuresti,6826,3,4,5,5,19,19,0,17
Universitate,6826,4,3,6,5,14,20,-6,15
FC Botosani,6826,5,3,5,6,6,14,-8,14
Concordia Ch,6826,6,3,2,9,16,23,-7,11
FCSB,6827,1,8,5,1,25,14,11,29
CFR Cluj,6827,2,5,6,3,15,11,4,21
Universitate,6827,3,5,5,4,19,19,0,20
D Bucuresti,6827,4,4,4,6,17,21,-4,16
FC Botosani,6827,5,4,4,6,6,13,-7,16
Concordia Ch,6827,6,3,2,9,18,22,-4,11
FCSB,6828,1,8,6,0,25,11,14,30
CFR Cluj,6828,2,6,6,2,16,9,7,24
D Bucuresti,6828,3,4,4,6,19,20,-1,16
Universitate,6828,4,3,6,5,14,20,-6,15
Concordia Ch,6828,5,4,2,8,21,24,-3,14
FC Botosani,6828,6,3,4,7,7,18,-11,13
FCSB,6829,1,8,6,0,26,11,15,30
CFR Cluj,6829,2,6,6,2,16,10,6,24
D Bucuresti,6829,3,4,4,6,17,20,-3,16
Universitate,6829,4,3,6,5,16,22,-6,15
Concordia Ch,6829,5,4,2,8,18,21,-3,14
FC Botosani,6829,6,3,4,7,5,14,-9,13
FCSB,6830,1,8,5,1,25,13,12,29
CFR Cluj,6830,2,6,6,2,16,9,7,24
Universitate,6830,3,4,5,5,15,19,-4,17
FC Botosani,6830,4,4,5,5,9,15,-6,17
D Bucuresti,6830,5,3,6,5,18,20,-2,15
Concordia Ch,6830,6,2,3,9,18,25,-7,9
FCSB,6831,1,7,6,1,25,13,12,27
CFR Cluj,6831,2,7,6,1,18,8,10,27
FC Botosani,6831,3,5,4,5,9,13,-4,19
Universitate,6831,4,3,6,5,17,24,-7,15
D Bucuresti,6831,5,3,4,7,18,24,-6,13
Concordia Ch,6831,6,3,2,9,19,24,-5,11
FCSB,6832,1,8,5,1,27,13,14,29
CFR Cluj,6832,2,6,7,1,16,9,7,25
D Bucuresti,6832,3,4,5,5,18,19,-1,17
Universitate,6832,4,3,6,5,16,22,-6,15
FC Botosani,6832,5,3,6,5,7,14,-7,15
Concordia Ch,6832,6,2,3,9,16,23,-7,9
FCSB,6833,1,8,6,0,25,11,14,30
CFR Cluj,6833,2,6,6,2,19,10,9,24
FC Botosani,6833,3,4,5,5,8,13,-5,17
D Bucuresti,6833,4,3,6,5,18,20,-2,15
Universitate,6833,5,3,6,5,15,23,-8,15
Concordia Ch,6833,6,2,3,9,16,24,-8,9
FCSB,6834,1,8,6,0,26,12,14,30
CFR Cluj,6834,2,6,6,2,15,8,7,24
D Bucuresti,6834,3,5,4,5,21,20,1,19
Universitate,6834,4,3,6,5,16,22,-6,15
FC Botosani,6834,5,3,5,6,6,14,-8,14
Concordia Ch,6834,6,2,3,9,16,24,-8,9
FCSB,6835,1,8,5,1,24,14,10,29
CFR Cluj,6835,2,5,6,3,13,9,4,21
Universitate,6835,3,5,5,4,19,18,1,20
D Bucuresti,6835,4,4,4,6,18,20,-2,16
FC Botosani,6835,5,4,4,6,8,17,-9,16
Concordia Ch,6835,6,3,2,9,19,23,-4,11
FCSB,6836,1,9,5,0,28,12,16,32
CFR Cluj,6836,2,6,6,2,17,10,7,24
FC Botosani,6836,3,3,6,5,8,15,-7,15
D Bucuresti,6836,4,3,5,6,17,20,-3,14
Universitate,6836,5,3,5,6,14,22,-8,14
Concordia Ch,6836,6,3,3,8,18,23,-5,12
FCSB,6837,1,7,5,2,25,14,11,26
CFR Cluj,6837,2,6,6,2,14,8,6,24
Universitate,6837,3,5,5,4,18,20,-2,20
D Bucuresti,6837,4,4,4,6,19,19,0,16
Concordia Ch,6837,5,4,2,8,18,21,-3,14
FC Botosani,6837,6,3,4,7,5,17,-12,13
FCSB,6838,1,9,5,0,26,11,15,32
CFR Cluj,6838,2,6,6,2,14,8,6,24
D Bucuresti,6838,3,4,5,5,18,19,-1,17
Universitate,6838,4,3,5,6,15,21,-6,14
FC Botosani,6838,5,3,5,6,6,15,-9,14
Concordia Ch,6838,6,3,2,9,17,22,-5,11
FCSB,6839,1,8,5,1,26,13,13,29
CFR Cluj,6839,2,6,7,1,17,10,7,25
D Bucuresti,6839,3,4,5,5,19,20,-1,17
FC Botosani,6839,4,4,5,5,8,13,-5,17
Universitate,6839,5,3,6,5,17,22,-5,15
Concordia Ch,6839,6,2,2,10,16,25,-9,8
FCSB,6840,1,8,5,1,28,13,15,29
CFR Cluj,6840,2,5,6,3,14,13,1,21
Universitate,6840,3,5,5,4,18,19,-1,20
D Bucuresti,6840,4,4,5,5,19,20,-1,17
FC Botosani,6840,5,4,5,5,8,14,-6,17
Concordia Ch,6840,6,2,2,10,17,25,-8,8
FCSB,6841,1,8,6,0,25,11,14,30
CFR Cluj,6841,2,6,7,1,14,7,7,25
D Bucuresti,6841,3,4,4,6,18,20,-2,16
Universitate,6841,4,3,5,6,15,21,-6,14
FC Botosani,6841,5,3,5,6,6,14,-8,14
Concordia Ch,6841,6,3,3,8,16,21,-5,12
FCSB,6842,1,8,5,1,24,11,13,29
CFR Cluj,6842,2,6,6,2,16,8,8,24
D Bucuresti,6842,3,5,4,5,21,18,3,19
Universitate,6842,4,4,5,5,15,21,-6,17
FC Botosani,6842,5,4,4,6,9,14,-5,16
Concordia Ch,6842,6,2,2,10,15,28,-13,8
FCSB,6843,1,8,6,0,26,12,14,30
CFR Cluj,6843,2,6,6,2,16,9,7,24
FC Botosani,6843,3,4,5,5,8,13,-5,17
D Bucuresti,6843,4,4,4,6,20,23,-3,16
Universitate,6843,5,3,6,5,15,21,-6,15
Concordia Ch,6843,6,2,3,9,17,24,-7,9
FCSB,6844,1,8,5,1,24,12,12,29
CFR Cluj,6844,2,7,6,1,16,7,9,27
FC Botosani,6844,3,3,6,5,8,15,-7,15
D Bucuresti,6844,4,3,5,6,16,19,-3,14
Universitate,6844,5,3,5,6,14,20,-6,14
Concordia Ch,6844,6,3,3,8,19,24,-5,12
FCSB,6845,1,7,7,0,29,16,13,28
CFR Cluj,6845,2,5,7,2,15,10,5,22
Universitate,6845,3,4,6,4,21,24,-3,18
D Bucuresti,6845,4,3,6,5,18,20,-2,15
FC Botosani,6845,5,3,5,6,6,15,-9,14
Concordia Ch,6845,6,3,3,8,18,22,-4,12
FCSB,6846,1,7,6,1,24,12,12,27
CFR Cluj,6846,2,6,7,1,16,9,7,25
D Bucuresti,6846,3,5,4,5,20,18,2,19
Universitate,6846,4,4,5,5,16,20,-4,17
FC Botosani,6846,5,4,4,6,7,14,-7,16
Concordia Ch,6846,6,2,2,10,15,25,-10,8
FCSB,6847,1,8,5,1,26,13,13,29
CFR Cluj,6847,2,7,6,1,19,10,9,27
D Bucuresti,6847,3,4,4,6,20,22,-2,16
FC Botosani,6847,4,4,4,6,8,15,-7,16
Universitate,6847,5,3,5,6,17,24,-7,14
Concordia Ch,6847,6,3,2,9,20,26,-6,11
FCSB,6848,1,7,6,1,24,12,12,27
CFR Cluj,6848,2,5,7,2,14,9,5,22
Universitate,6848,3,5,5,4,18,20,-2,20
FC Botosani,6848,4,5,4,5,7,12,-5,19
D Bucuresti,6848,5,3,4,7,16,20,-4,13
Concordia Ch,6848,6,3,2,9,16,22,-6,11
FCSB,6849,1,7,5,2,23,15,8,26
CFR Cluj,6849,2,6,7,1,18,9,9,25
D Bucuresti,6849,3,5,4,5,18,18,0,19
Universitate,6849,4,4,6,4,18,20,-2,18
FC Botosani,6849,5,4,4,6,8,14,-6,16
Concordia Ch,6849,6,2,2,10,16,25,-9,8
FCSB,6850,1,8,5,1,26,12,14,29
CFR Cluj,6850,2,5,6,3,15,12,3,21
Universitate,6850,3,5,5,4,19,21,-2,20
Concordia Ch,6850,4,4,2,8,21,23,-2,14
D Bucuresti,6850,5,3,5,6,19,24,-5,14
FC Botosani,6850,6,3,5,6,6,14,-8,14
FCSB,6851,1,8,5,1,26,11,15,29
CFR Cluj,6851,2,5,6,3,16,14,2,21
Universitate,6851,3,5,5,4,19,21,-2,20
FC Botosani,6851,4,3,6,5,7,14,-7,15
D Bucuresti,6851,5,3,5,6,17,22,-5,14
Concordia Ch,6851,6,3,3,8,19,22,-3,12
FCSB,6852,1,7,6,1,23,12,11,27
CFR Cluj,6852,2,6,7,1,16,8,8,25
FC Botosani,6852,3,5,4,5,9,14,-5,19
Universitate,6852,4,3,7,4,15,19,-4,16
D Bucuresti,6852,5,3,4,7,19,23,-4,13
Concordia Ch,6852,6,3,2,9,17,23,-6,11
FCSB,6853,1,7,7,0,24,11,13,28
CFR Cluj,6853,2,6,7,1,18,7,11,25
D Bucuresti,6853,3,4,5,5,19,20,-1,17
FC Botosani,6853,4,3,6,5,6,13,-7,15
Universitate,6853,5,3,6,5,15,24,-9,15
Concordia Ch,6853,6,2,3,9,18,25,-7,9
CFR Cluj,6854,1,7,6,1,16,8,8,27
FCSB,6854,2,7,5,2,24,14,10,26
Universitate,6854,3,4,5,5,16,19,-3,17
FC Botosani,6854,4,4,5,5,8,14,-6,17
D Bucuresti,6854,5,3,6,5,18,20,-2,15
Concordia Ch,6854,6,2,3,9,15,22,-7,9
FCSB,6855,1,8,5,1,24,11,13,29
CFR Cluj,6855,2,5,7,2,13,8,5,22
FC Botosani,6855,3,5,4,5,7,12,-5,19
Universitate,6855,4,4,6,4,15,18,-3,18
D Bucuresti,6855,5,3,4,7,17,21,-4,13
Concordia Ch,6855,6,3,2,9,17,23,-6,11
FCSB,6856,1,7,7,0,24,11,13,28
CFR Cluj,6856,2,5,7,2,13,9,4,22
Universitate,6856,3,4,6,4,17,19,-2,18
FC Botosani,6856,4,4,5,5,9,14,-5,17
D Bucuresti,6856,5,3,5,6,18,21,-3,14
Concordia Ch,6856,6,3,2,9,18,25,-7,11
FCSB,6857,1,8,5,1,27,14,13,29
CFR Cluj,6857,2,6,6,2,17,11,6,24
Universitate,6857,3,4,5,5,17,21,-4,17
D Bucuresti,6857,4,4,4,6,21,19,2,16
Concordia Ch,6857,5,4,2,8,17,21,-4,14
FC Botosani,6857,6,3,4,7,5,18,-13,13
FCSB,6858,1,8,5,1,24,11,13,29
CFR Cluj,6858,2,7,6,1,16,8,8,27
FC Botosani,6858,3,3,6,5,6,13,-7,15
D Bucuresti,6858,4,3,5,6,17,20,-3,14
Universitate,6858,5,3,5,6,15,21,-6,14
Concordia Ch,6858,6,3,3,8,18,23,-5,12
FCSB,6859,1,8,5,1,24,12,12,29
CFR Cluj,6859,2,6,6,2,15,9,6,24
FC Botosani,6859,3,5,4,5,9,13,-4,19
Universitate,6859,4,4,5,5,17,20,-3,17
D Bucuresti,6859,5,3,5,6,17,20,-3,14
Concordia Ch,6859,6,2,3,9,17,25,-8,9
FCSB,6860,1,9,5,0,28,11,17,32
CFR Cluj,6860,2,5,6,3,15,13,2,21
D Bucuresti,6860,3,4,5,5,17,18,-1,17
Universitate,6860,4,4,5,5,16,20,-4,17
FC Botosani,6860,5,3,4,7,7,16,-9,13
Concordia Ch,6860,6,3,3,8,18,23,-5,12
FCSB,6861,1,8,6,0,27,11,16,30
CFR Cluj,6861,2,6,6,2,16,11,5,24
FC Botosani,6861,3,4,5,5,11,15,-4,17
Universitate,6861,4,3,6,5,16,22,-6,15
D Bucuresti,6861,5,3,5,6,19,22,-3,14
Concordia Ch,6861,6,3,2,9,18,26,-8,11
FCSB,6862,1,8,6,0,24,10,14,30
CFR Cluj,6862,2,6,7,1,15,7,8,25
D Bucuresti,6862,3,5,4,5,19,18,1,19
Universitate,6862,4,3,5,6,14,21,-7,14
FC Botosani,6862,5,3,5,6,5,14,-9,14
Concordia Ch,6862,6,2,3,9,15,22,-7,9
FCSB,6863,1,7,5,2,26,16,10,26
CFR Cluj,6863,2,6,7,1,18,10,8,25
Universitate,6863,3,4,6,4,17,20,-3,18
D Bucuresti,6863,4,4,5,5,20,20,0,17
FC Botosani,6863,5,3,6,5,8,15,-7,15
Concordia Ch,6863,6,2,3,9,16,24,-8,9
FCSB,6864,1,8,6,0,26,11,15,30
CFR Cluj,6864,2,5,7,2,14,9,5,22
Universitate,6864,3,4,5,5,15,20,-5,17
FC Botosani,6864,4,3,6,5,7,14,-7,15
D Bucuresti,6864,5,3,5,6,17,20,-3,14
Concordia Ch,6864,6,3,3,8,17,22,-5,12
FCSB,6865,1,8,6,0,26,10,16,30
CFR Cluj,6865,2,5,7,2,14,11,3,22
D Bucuresti,6865,3,4,5,5,22,20,2,17
Universitate,6865,4,3,7,4,15,19,-4,16
FC Botosani,6865,5,4,4,6,8,16,-8,16
Concordia Ch,6865,6,2,3,9,17,26,-9,9
FCSB,6866,1,9,5,0,29,13,16,32
CFR Cluj,6866,2,5,7,2,14,9,5,22
D Bucuresti,6866,3,5,4,5,20,19,1,19
Universitate,6866,4,3,6,5,16,22,-6,15
FC Botosani,6866,5,3,5,6,5,13,-8,14
Concordia Ch,6866,6,2,3,9,16,24,-8,9
FCSB,6867,1,8,5,1,25,13,12,29
CFR Cluj,6867,2,7,6,1,17,8,9,27
D Bucuresti,6867,3,5,4,5,22,19,3,19
FC Botosani,6867,4,4,4,6,6,16,-10,16
Universitate,6867,5,3,5,6,14,20,-6,14
Concordia Ch,6867,6,2,2,10,16,24,-8,8
FCSB,6868,1,7,6,1,25,14,11,27
CFR Cluj,6868,2,6,7,1,18,10,8,25
D Bucuresti,6868,3,4,5,5,20,21,-1,17
FC Botosani,6868,4,4,5,5,6,12,-6,17
Universitate,6868,5,3,7,4,17,21,-4,16
Concordia Ch,6868,6,2,2,10,18,26,-8,8
FCSB,6869,1,7,5,2,24,13,11,26
CFR Cluj,6869,2,6,7,1,15,8,7,25
Universitate,6869,3,4,6,4,17,20,-3,18
D Bucuresti,6869,4,4,5,5,18,18,0,17
FC Botosani,6869,5,3,5,6,5,14,-9,14
Concordia Ch,6869,6,2,4,8,15,21,-6,10
FCSB,6870,1,8,6,0,25,10,15,30
CFR Cluj,6870,2,6,7,1,14,7,7,25
D Bucuresti,6870,3,4,5,5,20,21,-1,17
FC Botosani,6870,4,4,4,6,8,15,-7,16
Universitate,6870,5,3,5,6,14,21,-7,14
Concordia Ch,6870,6,2,3,9,18,25,-7,9
FCSB,6871,1,9,5,0,26,11,15,32
CFR Cluj,6871,2,5,6,3,14,10,4,21
D Bucuresti,6871,3,4,5,5,18,19,-1,17
Universitate,6871,4,4,5,5,15,19,-4,17
FC Botosani,6871,5,4,5,5,7,13,-6,17
Concordia Ch,6871,6,2,2,10,17,25,-8,8
FCSB,6872,1,8,5,1,27,14,13,29
CFR Cluj,6872,2,6,6,2,17,12,5,24
D Bucuresti,6872,3,4,5,5,18,18,0,17
Universitate,6872,4,4,5,5,18,21,-3,17
FC Botosani,6872,5,4,4,6,6,14,-8,16
Concordia Ch,6872,6,2,3,9,15,22,-7,9
FCSB,6873,1,8,5,1,24,12,12,29
CFR Cluj,6873,2,5,7,2,13,8,5,22
Universitate,6873,3,4,6,4,16,18,-2,18
FC Botosani,6873,4,4,5,5,8,14,-6,17
D Bucuresti,6873,5,3,5,6,16,19,-3,14
Concordia Ch,6873,6,2,4,8,17,23,-6,10
FCSB,6874,1,7,6,1,24,12,12,27
CFR Cluj,6874,2,6,7,1,15,8,7,25
FC Botosani,6874,3,5,4,5,10,13,-3,19
Universitate,6874,4,3,7,4,16,20,-4,16
D Bucuresti,6874,5,3,4,7,17,23,-6,13
Concordia Ch,6874,6,3,2,9,19,25,-6,11
FCSB,6875,1,7,5,2,23,13,10,26
CFR Cluj,6875,2,6,7,1,15,7,8,25
Universitate,6875,3,4,6,4,15,18,-3,18
D Bucuresti,6875,4,4,4,6,18,20,-2,16
FC Botosani,6875,5,4,4,6,7,15,-8,16
Concordia Ch,6875,6,3,2,9,18,23,-5,11
FCSB,6876,1,8,5,1,27,12,15,29
CFR Cluj,6876,2,6,6,2,15,9,6,24
D Bucuresti,6876,3,4,5,5,21,22,-1,17
Universitate,6876,4,4,5,5,15,21,-6,17
FC Botosani,6876,5,3,5,6,8,16,-8,14
Concordia Ch,6876,6,2,4,8,18,24,-6,10
FCSB,6877,1,9,5,0,26,10,16,32
CFR Cluj,6877,2,6,6,2,17,8,9,24
D Bucuresti,6877,3,4,4,6,18,19,-1,16
FC Botosani,6877,4,4,4,6,7,14,-7,16
Universitate,6877,5,3,5,6,14,24,-10,14
Concordia Ch,6877,6,3,2,9,16,23,-7,11
FCSB,6878,1,8,5,1,27,13,14,29
CFR Cluj,6878,2,6,7,1,14,7,7,25
D Bucuresti,6878,3,4,4,6,19,22,-3,16
FC Botosani,6878,4,4,4,6,9,14,-5,16
Universitate,6878,5,3,6,5,16,22,-6,15
Concordia Ch,6878,6,3,2,9,19,26,-7,11
FCSB,6879,1,8,6,0,29,13,16,30
CFR Cluj,6879,2,5,7,2,15,12,3,22
Universitate,6879,3,3,7,4,15,19,-4,16
D Bucuresti,6879,4,4,4,6,18,26,-8,16
Concordia Ch,6879,5,4,2,8,23,21,2,14
FC Botosani,6879,6,3,4,7,6,15,-9,13
FCSB,6880,1,7,6,1,25,13,12,27
CFR Cluj,6880,2,7,6,1,20,9,11,27
D Bucuresti,6880,3,5,4,5,18,18,0,19
Universitate,6880,4,3,6,5,14,22,-8,15
FC Botosani,6880,5,3,5,6,5,13,-8,14
Concordia Ch,6880,6,2,3,9,15,22,-7,9
FCSB,6881,1,7,6,1,23,12,11,27
CFR Cluj,6881,2,6,7,1,15,7,8,25
Universitate,6881,3,4,5,5,16,20,-4,17
D Bucuresti,6881,4,3,6,5,18,20,-2,15
FC Botosani,6881,5,3,6,5,8,15,-7,15
Concordia Ch,6881,6,2,4,8,18,24,-6,10
CFR Cluj,6882,1,7,6,1,18,10,8,27
FCSB,6882,2,7,5,2,25,14,11,26
D Bucuresti,6882,3,5,4,5,20,18,2,19
Universitate,6882,4,4,5,5,18,22,-4,17
FC Botosani,6882,5,3,5,6,7,15,-8,14
Concordia Ch,6882,6,2,3,9,17,26,-9,9
FCSB,6883,1,8,5,1,24,11,13,29
CFR Cluj,6883,2,6,6,2,17,9,8,24
Universitate,6883,3,4,5,5,16,22,-6,17
D Bucuresti,6883,4,4,4,6,19,21,-2,16
FC Botosani,6883,5,4,4,6,6,13,-7,16
Concordia Ch,6883,6,3,2,9,18,24,-6,11
FCSB,6884,1,8,5,1,25,12,13,29
CFR Cluj,6884,2,7,6,1,16,8,8,27
FC Botosani,6884,3,4,5,5,6,12,-6,17
D Bucuresti,6884,4,3,6,5,17,19,-2,15
Universitate,6884,5,3,5,6,14,20,-6,14
Concordia Ch,6884,6,2,3,9,16,23,-7,9
FCSB,6885,1,8,5,1,25,14,11,29
CFR Cluj,6885,2,6,7,1,17,8,9,25
D Bucuresti,6885,3,4,4,6,20,22,-2,16
Universitate,6885,4,3,6,5,14,19,-5,15
FC Botosani,6885,5,3,5,6,8,16,-8,14
Concordia Ch,6885,6,3,3,8,20,25,-5,12
FCSB,6886,1,7,5,2,23,13,10,26
CFR Cluj,6886,2,6,7,1,15,8,7,25
Universitate,6886,3,4,6,4,17,19,-2,18
D Bucuresti,6886,4,4,4,6,19,20,-1,16
FC Botosani,6886,5,3,5,6,6,15,-9,14
Concordia Ch,6886,6,3,3,8,18,23,-5,12
FCSB,6887,1,8,6,0,25,11,14,30
CFR Cluj,6887,2,5,6,3,14,10,4,21
D Bucuresti,6887,3,5,4,5,18,18,0,19
Universitate,6887,4,4,6,4,17,20,-3,18
FC Botosani,6887,5,3,4,7,5,18,-13,13
Concordia Ch,6887,6,3,2,9,20,22,-2,11
FCSB,6888,1,7,6,1,25,13,12,27
CFR Cluj,6888,2,6,7,1,15,8,7,25
D Bucuresti,6888,3,5,4,5,19,19,0,19
Universitate,6888,4,3,7,4,15,19,-4,16
FC Botosani,6888,5,3,4,7,5,15,-10,13
Concordia Ch,6888,6,3,2,9,18,23,-5,11
FCSB,6889,1,9,5,0,27,10,17,32
CFR Cluj,6889,2,5,6,3,14,10,4,21
FC Botosani,6889,3,4,5,5,7,12,-5,17
Universitate,6889,4,4,5,5,16,22,-6,17
D Bucuresti,6889,5,3,5,6,17,20,-3,14
Concordia Ch,6889,6,3,2,9,17,24,-7,11
FCSB,6890,1,9,5,0,29,11,18,32
CFR Cluj,6890,2,5,7,2,13,10,3,22
D Bucuresti,6890,3,4,5,5,20,20,0,17
FC Botosani,6890,4,4,5,5,8,13,-5,17
Universitate,6890,5,3,6,5,15,21,-6,15
Concordia Ch,6890,6,2,2,10,16,26,-10,8
FCSB,6891,1,7,7,0,28,15,13,28
CFR Cluj,6891,2,5,7,2,16,11,5,22
Universitate,6891,3,4,6,4,17,20,-3,18
D Bucuresti,6891,4,4,4,6,18,21,-3,16
Concordia Ch,6891,5,4,2,8,20,22,-2,14
FC Botosani,6891,6,3,4,7,5,15,-10,13
FCSB,6892,1,7,6,1,23,11,12,27
CFR Cluj,6892,2,7,6,1,17,7,10,27
D Bucuresti,6892,3,5,4,5,25,20,5,19
Universitate,6892,4,3,6,5,14,21,-7,15
FC Botosani,6892,5,3,5,6,7,18,-11,14
Concordia Ch,6892,6,2,3,9,17,26,-9,9
FCSB,6893,1,8,5,1,29,13,16,29
CFR Cluj,6893,2,6,6,2,16,10,6,24
Universitate,6893,3,4,5,5,17,24,-7,17
D Bucuresti,6893,4,4,4,6,19,21,-2,16
Concordia Ch,6893,5,4,2,8,19,23,-4,14
FC Botosani,6893,6,3,4,7,5,14,-9,13
FCSB,6894,1,7,6,1,25,13,12,27
CFR Cluj,6894,2,5,8,1,14,8,6,23
Universitate,6894,3,4,6,4,18,21,-3,18
D Bucuresti,6894,4,4,4,6,19,21,-2,16
FC Botosani,6894,5,4,4,6,6,13,-7,16
Concordia Ch,6894,6,3,2,9,18,24,-6,11
FCSB,6895,1,8,5,1,25,11,14,29
CFR Cluj,6895,2,5,7,2,13,9,4,22
Universitate,6895,3,4,6,4,15,18,-3,18
FC Botosani,6895,4,4,5,5,10,14,-4,17
D Bucuresti,6895,5,3,5,6,18,22,-4,14
Concordia Ch,6895,6,3,2,9,17,24,-7,11
FCSB,6896,1,8,5,1,25,12,13,29
CFR Cluj,6896,2,6,6,2,14,8,6,24
D Bucuresti,6896,3,5,4,5,19,19,0,19
Universitate,6896,4,4,5,5,16,20,-4,17
FC Botosani,6896,5,3,5,6,6,14,-8,14
Concordia Ch,6896,6,2,3,9,17,24,-7,9
FCSB,6897,1,7,6,1,25,13,12,27
CFR Cluj,6897,2,5,7,2,14,9,5,22
Universitate,6897,3,5,5,4,17,19,-2,20
Concordia Ch,6897,4,4,2,8,22,24,-2,14
D Bucuresti,6897,5,3,5,6,17,22,-5,14
FC Botosani,6897,6,3,5,6,7,15,-8,14
FCSB,6898,1,7,6,1,23,11,12,27
CFR Cluj,6898,2,6,7,1,15,8,7,25
D Bucuresti,6898,3,5,4,5,22,21,1,19
Universitate,6898,4,4,5,5,16,20,-4,17
FC Botosani,6898,5,3,5,6,8,17,-9,14
Concordia Ch,6898,6,2,3,9,19,26,-7,9
FCSB,6899,1,8,5,1,27,13,14,29
CFR Cluj,6899,2,5,6,3,15,12,3,21
Universitate,6899,3,5,5,4,18,20,-2,20
FC Botosani,6899,4,4,5,5,6,12,-6,17
D Bucuresti,6899,5,3,5,6,16,19,-3,14
Concordia Ch,6899,6,3,2,9,16,22,-6,11
FCSB,6900,1,9,5,0,26,11,15,32
CFR Cluj,6900,2,6,6,2,15,8,7,24
D Bucuresti,6900,3,4,4,6,18,20,-2,16
FC Botosani,6900,4,4,4,6,7,14,-7,16
Universitate,6900,5,3,5,6,15,22,-7,14
Concordia Ch,6900,6,3,2,9,17,23,-6,11
CFR Cluj,6901,1,7,6,1,17,8,9,27
FCSB,6901,2,7,5,2,25,15,10,26
D Bucuresti,6901,3,4,5,5,19,18,1,17
Universitate,6901,4,4,5,5,17,21,-4,17
FC Botosani,6901,5,3,6,5,6,13,-7,15
Concordia Ch,6901,6,2,3,9,16,25,-9,9
FCSB,6902,1,7,7,0,24,11,13,28
CFR Cluj,6902,2,5,8,1,13,7,6,23
D Bucuresti,6902,3,5,4,5,21,20,1,19
Universitate,6902,4,3,7,4,15,19,-4,16
FC Botosani,6902,5,3,4,7,6,17,-11,13
Concordia Ch,6902,6,3,2,9,19,24,-5,11
FCSB,6903,1,8,5,1,26,13,13,29
CFR Cluj,6903,2,7,6,1,16,8,8,27
D Bucuresti,6903,3,5,4,5,21,19,2,19
Universitate,6903,4,3,5,6,15,21,-6,14
FC Botosani,6903,5,3,5,6,6,15,-9,14
Concordia Ch,6903,6,2,3,9,17,25,-8,9
FCSB,6904,1,9,5,0,29,10,19,32
CFR Cluj,6904,2,6,6,2,16,8,8,24
D Bucuresti,6904,3,4,4,6,18,21,-3,16
FC Botosani,6904,4,4,4,6,7,14,-7,16
Universitate,6904,5,3,5,6,14,26,-12,14
Concordia Ch,6904,6,3,2,9,17,22,-5,11
FCSB,6905,1,7,6,1,25,13,12,27
CFR Cluj,6905,2,6,7,1,16,7,9,25
FC Botosani,6905,3,4,5,5,7,12,-5,17
Universitate,6905,4,4,5,5,17,23,-6,17
D Bucuresti,6905,5,3,5,6,16,19,-3,14
Concordia Ch,6905,6,3,2,9,16,23,-7,11
FCSB,6906,1,8,6,0,24,10,14,30
CFR Cluj,6906,2,6,7,1,15,7,8,25
D Bucuresti,6906,3,4,5,5,20,20,0,17
Universitate,6906,4,3,5,6,14,21,-7,14
FC Botosani,6906,5,3,4,7,5,17,-12,13
Concordia Ch,6906,6,3,3,8,20,23,-3,12
FCSB,6907,1,7,6,1,24,12,12,27
CFR Cluj,6907,2,5,8,1,14,8,6,23
Universitate,6907,3,4,6,4,15,18,-3,18
FC Botosani,6907,4,4,4,6,6,14,-8,16
D Bucuresti,6907,5,3,5,6,17,20,-3,14
Concordia Ch,6907,6,3,3,8,18,22,-4,12
FCSB,6908,1,7,7,0,24,11,13,28
CFR Cluj,6908,2,6,7,1,16,8,8,25
FC Botosani,6908,3,4,4,6,6,13,-7,16
Universitate,6908,4,3,6,5,16,22,-6,15
D Bucuresti,6908,5,3,5,6,16,19,-3,14
Concordia Ch,6908,6,3,3,8,16,21,-5,12
FCSB,6909,1,8,6,0,28,11,17,30
CFR Cluj,6909,2,5,7,2,14,12,2,22
Universitate,6909,3,3,7,4,16,20,-4,16
FC Botosani,6909,4,3,6,5,5,12,-7,15
D Bucuresti,6909,5,3,5,6,17,21,-4,14
Concordia Ch,6909,6,3,3,8,18,22,-4,12
CFR Cluj,6910,1,7,6,1,16,8,8,27
FCSB,6910,2,7,5,2,24,15,9,26
D Bucuresti,6910,3,4,5,5,19,20,-1,17
Universitate,6910,4,4,5,5,17,19,-2,17
FC Botosani,6910,5,3,6,5,7,14,-7,15
Concordia Ch,6910,6,2,3,9,17,24,-7,9
FCSB,6911,1,9,5,0,28,13,15,32
CFR Cluj,6911,2,6,6,2,17,9,8,24
FC Botosani,6911,3,4,5,5,7,13,-6,17
D Bucuresti,6911,4,3,5,6,17,20,-3,14
Universitate,6911,5,3,5,6,16,24,-8,14
Concordia Ch,6911,6,3,2,9,16,22,-6,11
FCSB,6912,1,7,5,2,23,12,11,26
CFR Cluj,6912,2,6,6,2,14,8,6,24
Universitate,6912,3,5,5,4,16,18,-2,20
FC Botosani,6912,4,5,4,5,8,13,-5,19
D Bucuresti,6912,5,4,4,6,18,20,-2,16
Concordia Ch,6912,6,2,2,10,15,23,-8,8
FCSB,6913,1,9,5,0,27,12,15,32
CFR Cluj,6913,2,6,6,2,15,9,6,24
D Bucuresti,6913,3,4,5,5,19,18,1,17
Universitate,6913,4,3,5,6,17,23,-6,14
FC Botosani,6913,5,3,5,6,7,15,-8,14
Concordia Ch,6913,6,3,2,9,18,26,-8,11
FCSB,6914,1,8,6,0,24,10,14,30
CFR Cluj,6914,2,6,7,1,15,7,8,25
D Bucuresti,6914,3,5,4,5,20,20,0,19
Universitate,6914,4,3,5,6,14,21,-7,14
FC Botosani,6914,5,3,5,6,6,14,-8,14
Concordia Ch,6914,6,2,3,9,16,23,-7,9
FCSB,6915,1,8,6,0,26,12,14,30
CFR Cluj,6915,2,5,7,2,14,9,5,22
D Bucuresti,6915,3,4,5,5,18,19,-1,17
Universitate,6915,4,3,7,4,15,19,-4,16
FC Botosani,6915,5,3,5,6,7,15,-8,14
Concordia Ch,6915,6,2,4,8,18,24,-6,10
FCSB,6916,1,9,5,0,25,10,15,32
CFR Cluj,6916,2,6,6,2,14,8,6,24
FC Botosani,6916,3,5,4,5,10,12,-2,19
D Bucuresti,6916,4,4,4,6,18,20,-2,16
Universitate,6916,5,3,5,6,14,20,-6,14
Concordia Ch,6916,6,2,2,10,16,27,-11,8
FCSB,6917,1,7,5,2,24,15,9,26
CFR Cluj,6917,2,6,6,2,17,9,8,24
Universitate,6917,3,5,5,4,16,18,-2,20
D Bucuresti,6917,4,4,4,6,18,20,-2,16
Concordia Ch,6917,5,4,2,8,20,22,-2,14
FC Botosani,6917,6,3,4,7,6,17,-11,13
FCSB,6918,1,7,6,1,24,14,10,27
CFR Cluj,6918,2,6,7,1,17,8,9,25
D Bucuresti,6918,3,5,4,5,21,21,0,19
Universitate,6918,4,3,7,4,16,20,-4,16
FC Botosani,6918,5,4,4,6,9,16,-7,16
Concordia Ch,6918,6,2,2,10,17,25,-8,8
FCSB,6919,1,9,5,0,28,11,17,32
CFR Cluj,6919,2,5,6,3,14,12,2,21
Universitate,6919,3,4,5,5,15,19,-4,17
D Bucuresti,6919,4,3,6,5,18,20,-2,15
FC Botosani,6919,5,3,6,5,6,13,-7,15
Concordia Ch,6919,6,2,4,8,16,22,-6,10
FCSB,6920,1,9,5,0,27,12,15,32
CFR Cluj,6920,2,6,6,2,16,10,6,24
D Bucuresti,6920,3,4,4,6,17,19,-2,16
FC Botosani,6920,4,4,4,6,8,14,-6,16
Universitate,6920,5,3,5,6,16,22,-6,14
Concordia Ch,6920,6,3,2,9,17,24,-7,11
FCSB,6921,1,8,5,1,26,13,13,29
CFR Cluj,6921,2,5,7,2,15,10,5,22
Universitate,6921,3,4,6,4,15,18,-3,18
FC Botosani,6921,4,4,5,5,8,13,-5,17
D Bucuresti,6921,5,3,5,6,17,20,-3,14
Concordia Ch,6921,6,3,2,9,16,23,-7,11
FCSB,6922,1,7,6,1,25,13,12,27
CFR Cluj,6922,2,7,6,1,16,8,8,27
D Bucuresti,6922,3,5,4,5,20,18,2,19
Universitate,6922,4,3,6,5,15,20,-5,15
FC Botosani,6922,5,3,4,7,5,16,-11,13
Concordia Ch,6922,6,3,2,9,17,23,-6,11
FCSB,6923,1,7,6,1,25,14,11,27
CFR Cluj,6923,2,7,6,1,17,8,9,27
FC Botosani,6923,3,4,4,6,8,14,-6,16
Universitate,6923,4,3,6,5,17,22,-5,15
Concordia Ch,6923,5,4,2,8,21,25,-4,14
D Bucuresti,6923,6,3,4,7,19,24,-5,13
FCSB,6924,1,8,5,1,27,13,14,29
CFR Cluj,6924,2,6,6,2,15,10,5,24
Universitate,6924,3,4,5,5,16,20,-4,17
FC Botosani,6924,4,4,5,5,6,12,-6,17
D Bucuresti,6924,5,3,4,7,17,21,-4,13
Concordia Ch,6924,6,3,3,8,17,22,-5,12
FCSB,6925,1,8,5,1,26,13,13,29
CFR Cluj,6925,2,6,7,1,16,9,7,25
Universitate,6925,3,3,6,5,16,21,-5,15
Concordia Ch,6925,4,4,2,8,22,22,0,14
D Bucuresti,6925,5,3,5,6,17,23,-6,14
FC Botosani,6925,6,3,5,6,7,16,-9,14
FCSB,6926,1,8,5,1,24,12,12,29
CFR Cluj,6926,2,7,6,1,17,8,9,27
D Bucuresti,6926,3,4,4,6,18,22,-4,16
Universitate,6926,4,3,5,6,15,21,-6,14
FC Botosani,6926,5,3,5,6,8,16,-8,14
Concordia Ch,6926,6,3,3,8,20,23,-3,12
FCSB,6927,1,9,5,0,27,12,15,32
CFR Cluj,6927,2,5,6,3,13,9,4,21
Universitate,6927,3,4,5,5,17,21,-4,17
FC Botosani,6927,4,4,4,6,7,14,-7,16
Concordia Ch,6927,5,4,2,8,18,21,-3,14
D Bucuresti,6927,6,3,4,7,17,22,-5,13
CFR Cluj,6928,1,7,6,1,16,8,8,27
FCSB,6928,2,7,5,2,24,13,11,26
Universitate,6928,3,4,5,5,17,21,-4,17
D Bucuresti,6928,4,4,4,6,18,20,-2,16
FC Botosani,6928,5,3,5,6,5,13,-8,14
Concordia Ch,6928,6,3,3,8,17,22,-5,12
FCSB,6929,1,8,5,1,29,13,16,29
CFR Cluj,6929,2,7,6,1,17,8,9,27
D Bucuresti,6929,3,4,4,6,19,19,0,16
FC Botosani,6929,4,4,4,6,6,14,-8,16
Universitate,6929,5,3,5,6,16,26,-10,14
Concordia Ch,6929,6,3,2,9,17,24,-7,11
FCSB,6930,1,8,5,1,26,14,12,29
CFR Cluj,6930,2,6,7,1,16,8,8,25
D Bucuresti,6930,3,5,4,5,19,19,0,19
FC Botosani,6930,4,4,4,6,8,15,-7,16
Universitate,6930,5,3,6,5,17,22,-5,15
Concordia Ch,6930,6,2,2,10,18,26,-8,8
FCSB,6931,1,8,5,1,26,13,13,29
CFR Cluj,6931,2,7,6,1,19,9,10,27
D Bucuresti,6931,3,4,4,6,18,19,-1,16
Universitate,6931,4,3,5,6,16,24,-8,14
FC Botosani,6931,5,3,5,6,6,15,-9,14
Concordia Ch,6931,6,3,3,8,17,22,-5,12
FCSB,6932,1,8,5,1,25,12,13,29
CFR Cluj,6932,2,6,6,2,18,9,9,24
Universitate,6932,3,4,5,5,16,23,-7,17
D Bucuresti,6932,4,4,4,6,19,21,-2,16
Concordia Ch,6932,5,4,2,8,19,21,-2,14
FC Botosani,6932,6,3,4,7,6,17,-11,13
FCSB,6933,1,8,5,1,27,13,14,29
CFR Cluj,6933,2,5,7,2,13,9,4,22
Universitate,6933,3,4,6,4,17,20,-3,18
FC Botosani,6933,4,3,6,5,5,12,-7,15
D Bucuresti,6933,5,3,5,6,17,20,-3,14
Concordia Ch,6933,6,3,3,8,17,22,-5,12
FCSB,6934,1,8,5,1,27,13,14,29
CFR Cluj,6934,2,6,6,2,16,10,6,24
Universitate,6934,3,4,5,5,16,21,-5,17
FC Botosani,6934,4,4,5,5,8,14,-6,17
D Bucuresti,6934,5,3,5,6,18,21,-3,14
Concordia Ch,6934,6,3,2,9,18,24,-6,11
FCSB,6935,1,9,5,0,26,10,16,32
CFR Cluj,6935,2,6,6,2,15,9,6,24
D Bucuresti,6935,3,4,5,5,19,19,0,17
FC Botosani,6935,4,4,5,5,8,13,-5,17
Universitate,6935,5,3,5,6,14,21,-7,14
Concordia Ch,6935,6,2,2,10,15,25,-10,8
FCSB,6936,1,8,6,0,26,11,15,30
CFR Cluj,6936,2,5,7,2,14,10,4,22
D Bucuresti,6936,3,4,4,6,18,20,-2,16
Universitate,6936,4,3,7,4,16,20,-4,16
Concordia Ch,6936,5,4,2,8,17,21,-4,14
FC Botosani,6936,6,3,4,7,6,15,-9,13
FCSB,6937,1,8,5,1,27,12,15,29
CFR Cluj,6937,2,7,6,1,17,8,9,27
D Bucuresti,6937,3,4,4,6,21,24,-3,16
FC Botosani,6937,4,4,4,6,11,17,-6,16
Universitate,6937,5,3,5,6,14,23,-9,14
Concordia Ch,6937,6,3,2,9,21,27,-6,11
FCSB,6938,1,8,6,0,28,13,15,30
CFR Cluj,6938,2,6,7,1,16,9,7,25
FC Botosani,6938,3,4,5,5,6,12,-6,17
D Bucuresti,6938,4,4,4,6,18,20,-2,16
Universitate,6938,5,3,5,6,17,24,-7,14
Concordia Ch,6938,6,2,3,9,16,23,-7,9
FCSB,6939,1,9,5,0,27,11,16,32
CFR Cluj,6939,2,5,6,3,15,11,4,21
D Bucuresti,6939,3,4,5,5,18,19,-1,17
Universitate,6939,4,4,5,5,16,21,-5,17
FC Botosani,6939,5,4,5,5,7,13,-6,17
Concordia Ch,6939,6,2,2,10,15,23,-8,8
FCSB,6940,1,8,6,0,25,11,14,30
CFR Cluj,6940,2,6,6,2,16,8,8,24
FC Botosani,6940,3,5,4,5,11,14,-3,19
Universitate,6940,4,3,6,5,15,22,-7,15
D Bucuresti,6940,5,3,4,7,17,22,-5,13
Concordia Ch,6940,6,3,2,9,18,25,-7,11
FCSB,6941,1,8,6,0,28,12,16,30
CFR Cluj,6941,2,6,6,2,15,11,4,24
D Bucuresti,6941,3,4,4,6,19,20,-1,16
FC Botosani,6941,4,4,4,6,6,14,-8,16
Universitate,6941,5,3,6,5,17,22,-5,15
Concordia Ch,6941,6,3,2,9,17,23,-6,11
FCSB,6942,1,8,5,1,25,13,12,29
CFR Cluj,6942,2,6,6,2,15,10,5,24
D Bucuresti,6942,3,4,5,5,19,20,-1,17
Universitate,6942,4,4,5,5,18,20,-2,17
FC Botosani,6942,5,4,4,6,7,14,-7,16
Concordia Ch,6942,6,2,3,9,16,23,-7,9
FCSB,6943,1,8,5,1,24,11,13,29
CFR Cluj,6943,2,6,6,2,14,8,6,24
FC Botosani,6943,3,5,4,5,8,13,-5,19
Universitate,6943,4,4,5,5,15,19,-4,17
D Bucuresti,6943,5,4,4,6,19,20,-1,16
Concordia Ch,6943,6,2,2,10,17,26,-9,8
FCSB,6944,1,8,5,1,25,13,12,29
CFR Cluj,6944,2,7,6,1,16,7,9,27
D Bucuresti,6944,3,4,4,6,18,20,-2,16
FC Botosani,6944,4,4,4,6,7,14,-7,16
Universitate,6944,5,3,5,6,15,21,-6,14
Concordia Ch,6944,6,3,2,9,17,23,-6,11
FCSB,6945,1,7,6,1,25,14,11,27
CFR Cluj,6945,2,6,7,1,15,8,7,25
D Bucuresti,6945,3,4,5,5,20,19,1,17
Universitate,6945,4,4,5,5,17,20,-3,17
FC Botosani,6945,5,3,6,5,6,13,-7,15
Concordia Ch,6945,6,2,3,9,17,26,-9,9
FCSB,6946,1,9,5,0,28,11,17,32
CFR Cluj,6946,2,5,7,2,13,10,3,22
D Bucuresti,6946,3,3,6,5,17,19,-2,15
Universitate,6946,4,3,6,5,15,20,-5,15
FC Botosani,6946,5,3,5,6,6,14,-8,14
Concordia Ch,6946,6,3,3,8,18,23,-5,12
FCSB,6947,1,8,5,1,24,11,13,29
CFR Cluj,6947,2,5,7,2,13,8,5,22
Universitate,6947,3,4,6,4,15,18,-3,18
FC Botosani,6947,4,4,4,6,7,13,-6,16
Concordia Ch,6947,5,4,2,8,18,21,-3,14
D Bucuresti,6947,6,3,4,7,16,22,-6,13
FCSB,6948,1,9,5,0,26,11,15,32
CFR Cluj,6948,2,5,6,3,14,10,4,21
D Bucuresti,6948,3,5,4,5,22,19,3,19
Universitate,6948,4,4,5,5,17,21,-4,17
FC Botosani,6948,5,3,5,6,6,16,-10,14
Concordia Ch,6948,6,2,3,9,17,25,-8,9
FCSB,6949,1,8,5,1,28,15,13,29
CFR Cluj,6949,2,7,6,1,17,8,9,27
D Bucuresti,6949,3,5,4,5,23,18,5,19
Universitate,6949,4,3,5,6,16,23,-7,14
FC Botosani,6949,5,3,5,6,6,18,-12,14
Concordia Ch,6949,6,2,3,9,16,24,-8,9
FCSB,6950,1,8,5,1,24,11,13,29
CFR Cluj,6950,2,5,7,2,13,8,5,22
Universitate,6950,3,4,6,4,15,18,-3,18
FC Botosani,6950,4,3,6,5,5,12,-7,15
D Bucuresti,6950,5,3,5,6,17,20,-3,14
Concordia Ch,6950,6,3,3,8,17,22,-5,12
FCSB,6951,1,9,5,0,28,10,18,32
CFR Cluj,6951,2,5,7,2,15,12,3,22
D Bucuresti,6951,3,4,4,6,18,20,-2,16
FC Botosani,6951,4,4,4,6,9,14,-5,16
Universitate,6951,5,3,6,5,16,22,-6,15
Concordia Ch,6951,6,3,2,9,16,24,-8,11
FCSB,6952,1,9,5,0,27,11,16,32
CFR Cluj,6952,2,6,6,2,16,9,7,24
D Bucuresti,6952,3,5,4,5,19,18,1,19
FC Botosani,6952,4,4,4,6,7,15,-8,16
Universitate,6952,5,3,5,6,14,22,-8,14
Concordia Ch,6952,6,2,2,10,16,24,-8,8
FCSB,6953,1,9,5,0,27,10,17,32
CFR Cluj,6953,2,5,7,2,14,11,3,22
D Bucuresti,6953,3,4,4,6,19,21,-2,16
Universitate,6953,4,3,6,5,15,20,-5,15
FC Botosani,6953,5,3,5,6,7,15,-8,14
Concordia Ch,6953,6,3,3,8,18,23,-5,12
FCSB,6954,1,8,6,0,27,12,15,30
CFR Cluj,6954,2,6,6,2,16,10,6,24
Universitate,6954,3,3,6,5,15,21,-6,15
Concordia Ch,6954,4,4,2,8,19,22,-3,14
D Bucuresti,6954,5,3,5,6,17,21,-4,14
FC Botosani,6954,6,3,5,6,5,13,-8,14
FCSB,6955,1,8,5,1,27,13,14,29
CFR Cluj,6955,2,6,6,2,16,9,7,24
Universitate,6955,3,4,5,5,15,21,-6,17
D Bucuresti,6955,4,4,4,6,18,20,-2,16
FC Botosani,6955,5,4,4,6,9,15,-6,16
Concordia Ch,6955,6,3,2,9,17,24,-7,11
FCSB,6956,1,8,6,0,25,11,14,30
CFR Cluj,6956,2,6,6,2,16,10,6,24
D Bucuresti,6956,3,4,5,5,21,19,2,17
FC Botosani,6956,4,4,4,6,7,17,-10,16
Universitate,6956,5,3,6,5,15,20,-5,15
Concordia Ch,6956,6,2,3,9,15,22,-7,9
FCSB,6957,1,7,5,2,23,13,10,26
CFR Cluj,6957,2,6,7,1,16,8,8,25
FC Botosani,6957,3,5,4,5,8,13,-5,19
Universitate,6957,4,4,6,4,16,19,-3,18
D Bucuresti,6957,5,4,4,6,19,20,-1,16
Concordia Ch,6957,6,2,2,10,17,26,-9,8
FCSB,6958,1,7,5,2,23,12,11,26
CFR Cluj,6958,2,6,7,1,14,7,7,25
Universitate,6958,3,4,6,4,15,18,-3,18
D Bucuresti,6958,4,4,4,6,20,24,-4,16
FC Botosani,6958,5,3,5,6,7,15,-8,14
Concordia Ch,6958,6,3,3,8,19,22,-3,12
FCSB,6959,1,9,5,0,26,10,16,32
CFR Cluj,6959,2,6,6,2,16,10,6,24
FC Botosani,6959,3,4,4,6,7,14,-7,16
Concordia Ch,6959,4,4,2,8,19,22,-3,14
Universitate,6959,5,3,5,6,15,22,-7,14
D Bucuresti,6959,6,3,4,7,16,21,-5,13
FCSB,6960,1,9,5,0,25,10,15,32
CFR Cluj,6960,2,5,7,2,13,8,5,22
D Bucuresti,6960,3,5,4,5,20,18,2,19
Universitate,6960,4,3,6,5,14,19,-5,15
FC Botosani,6960,5,3,4,7,6,16,-10,13
Concordia Ch,6960,6,3,2,9,17,24,-7,11
FCSB,6961,1,8,6,0,26,12,14,30
CFR Cluj,6961,2,6,7,1,16,9,7,25
FC Botosani,6961,3,4,5,5,8,14,-6,17
Universitate,6961,4,3,5,6,16,22,-6,14
D Bucuresti,6961,5,3,4,7,18,22,-4,13
Concordia Ch,6961,6,3,3,8,18,23,-5,12
FCSB,6962,1,9,5,0,28,10,18,32
CFR Cluj,6962,2,5,7,2,14,11,3,22
D Bucuresti,6962,3,3,6,5,17,19,-2,15
Universitate,6962,4,3,6,5,15,21,-6,15
FC Botosani,6962,5,3,6,5,6,13,-7,15
Concordia Ch,6962,6,2,4,8,17,23,-6,10
FCSB,6963,1,7,6,1,28,16,12,27
CFR Cluj,6963,2,6,7,1,17,9,8,25
Universitate,6963,3,4,5,5,18,23,-5,17
FC Botosani,6963,4,4,5,5,7,13,-6,17
D Bucuresti,6963,5,3,5,6,17,22,-5,14
Concordia Ch,6963,6,3,2,9,18,22,-4,11
FCSB,6964,1,8,5,1,25,12,13,29
CFR Cluj,6964,2,6,6,2,17,9,8,24
Universitate,6964,3,4,5,5,16,22,-6,17
D Bucuresti,6964,4,4,4,6,18,20,-2,16
FC Botosani,6964,5,3,5,6,6,15,-9,14
Concordia Ch,6964,6,3,3,8,18,22,-4,12
FCSB,6965,1,8,6,0,25,11,14,30
CFR Cluj,6965,2,6,7,1,16,8,8,25
D Bucuresti,6965,3,4,4,6,20,24,-4,16
FC Botosani,6965,4,4,4,6,8,15,-7,16
Universitate,6965,5,3,5,6,14,21,-7,14
Concordia Ch,6965,6,3,2,9,19,23,-4,11
FCSB,6966,1,8,5,1,25,11,14,29
CFR Cluj,6966,2,6,6,2,15,9,6,24
D Bucuresti,6966,3,4,5,5,18,19,-1,17
Universitate,6966,4,4,5,5,16,21,-5,17
FC Botosani,6966,5,3,5,6,8,16,-8,14
Concordia Ch,6966,6,2,4,8,17,23,-6,10
FCSB,6967,1,8,5,1,26,12,14,29
CFR Cluj,6967,2,6,6,2,15,10,5,24
D Bucuresti,6967,3,5,4,5,23,19,4,19
Universitate,6967,4,4,5,5,15,19,-4,17
FC Botosani,6967,5,4,4,6,7,16,-9,16
Concordia Ch,6967,6,2,2,10,17,27,-10,8
FCSB,6968,1,7,6,1,24,13,11,27
CFR Cluj,6968,2,6,6,2,15,8,7,24
Universitate,6968,3,4,6,4,16,19,-3,18
FC Botosani,6968,4,4,5,5,7,13,-6,17
D Bucuresti,6968,5,3,4,7,19,23,-4,13
Concordia Ch,6968,6,3,3,8,18,23,-5,12
FCSB,6969,1,7,6,1,25,13,12,27
CFR Cluj,6969,2,7,6,1,18,9,9,27
D Bucuresti,6969,3,4,5,5,19,19,0,17
FC Botosani,6969,4,4,4,6,7,14,-7,16
Universitate,6969,5,3,6,5,16,22,-6,15
Concordia Ch,6969,6,2,3,9,16,24,-8,9
FCSB,6970,1,9,5,0,30,11,19,32
CFR Cluj,6970,2,5,7,2,15,12,3,22
D Bucuresti,6970,3,5,4,5,22,19,3,19
Universitate,6970,4,3,6,5,15,22,-7,15
FC Botosani,6970,5,3,5,6,7,16,-9,14
Concordia Ch,6970,6,2,3,9,16,25,-9,9
CFR Cluj,6971,1,7,6,1,15,7,8,27
FCSB,6971,2,7,5,2,23,12,11,26
D Bucuresti,6971,3,5,4,5,23,19,4,19
Universitate,6971,4,4,5,5,15,19,-4,17
FC Botosani,6971,5,4,4,6,7,17,-10,16
Concordia Ch,6971,6,2,2,10,15,24,-9,8
FCSB,6972,1,8,5,1,26,12,14,29
CFR Cluj,6972,2,6,7,1,16,9,7,25
Universitate,6972,3,3,6,5,15,21,-6,15
Concordia Ch,6972,4,4,2,8,20,21,-1,14
D Bucuresti,6972,5,3,5,6,17,23,-6,14
FC Botosani,6972,6,3,5,6,6,14,-8,14
FCSB,6973,1,8,6,0,26,11,15,30
CFR Cluj,6973,2,6,7,1,17,8,9,25
D Bucuresti,6973,3,4,4,6,18,20,-2,16
FC Botosani,6973,4,4,4,6,6,14,-8,16
Universitate,6973,5,3,5,6,16,25,-9,14
Concordia Ch,6973,6,3,2,9,18,23,-5,11
FCSB,6974,1,8,6,0,25,11,14,30
CFR Cluj,6974,2,5,6,3,15,11,4,21
Universitate,6974,3,4,6,4,16,19,-3,18
FC Botosani,6974,4,4,5,5,9,15,-6,17
D Bucuresti,6974,5,3,5,6,17,20,-3,14
Concordia Ch,6974,6,2,4,8,17,23,-6,10
FCSB,6975,1,8,6,0,25,11,14,30
CFR Cluj,6975,2,6,7,1,16,9,7,25
FC Botosani,6975,3,4,5,5,6,12,-6,17
D Bucuresti,6975,4,3,6,5,18,20,-2,15
Universitate,6975,5,3,5,6,15,21,-6,14
Concordia Ch,6975,6,2,3,9,17,24,-7,9
CFR Cluj,6976,1,7,6,1,17,9,8,27
FCSB,6976,2,7,5,2,25,14,11,26
Universitate,6976,3,4,5,5,17,21,-4,17
D Bucuresti,6976,4,4,4,6,19,21,-2,16
FC Botosani,6976,5,4,4,6,8,16,-8,16
Concordia Ch,6976,6,3,2,9,18,23,-5,11
FCSB,6977,1,8,6,0,25,11,14,30
CFR Cluj,6977,2,6,6,2,14,8,6,24
Universitate,6977,3,3,6,5,15,20,-5,15
FC Botosani,6977,4,3,6,5,7,14,-7,15
D Bucuresti,6977,5,3,5,6,16,19,-3,14
Concordia Ch,6977,6,3,3,8,18,23,-5,12
FCSB,6978,1,7,6,1,24,12,12,27
CFR Cluj,6978,2,6,7,1,16,9,7,25
FC Botosani,6978,3,5,4,5,8,12,-4,19
Universitate,6978,4,3,7,4,15,19,-4,16
D Bucuresti,6978,5,3,4,7,16,21,-5,13
Concordia Ch,6978,6,3,2,9,16,22,-6,11
FCSB,6979,1,8,5,1,25,12,13,29
CFR Cluj,6979,2,6,6,2,18,9,9,24
D Bucuresti,6979,3,4,5,5,20,20,0,17
Universitate,6979,4,4,5,5,15,22,-7,17
FC Botosani,6979,5,3,5,6,6,15,-9,14
Concordia Ch,6979,6,2,4,8,18,24,-6,10
FCSB,6980,1,8,6,0,26,12,14,30
CFR Cluj,6980,2,5,7,2,15,10,5,22
Universitate,6980,3,4,5,5,17,21,-4,17
D Bucuresti,6980,4,3,6,5,17,19,-2,15
FC Botosani,6980,5,3,5,6,6,17,-11,14
Concordia Ch,6980,6,3,3,8,21,23,-2,12
FCSB,6981,1,8,6,0,26,11,15,30
CFR Cluj,6981,2,6,7,1,16,8,8,25
FC Botosani,6981,3,4,5,5,7,13,-6,17
D Bucuresti,6981,4,3,5,6,17,21,-4,14
Universitate,6981,5,3,5,6,14,22,-8,14
Concordia Ch,6981,6,3,2,9,19,24,-5,11
FCSB,6982,1,8,5,1,25,12,13,29
CFR Cluj,6982,2,6,6,2,17,10,7,24
D Bucuresti,6982,3,4,5,5,18,19,-1,17
Universitate,6982,4,4,5,5,16,21,-5,17
FC Botosani,6982,5,4,5,5,7,12,-5,17
Concordia Ch,6982,6,2,2,10,16,25,-9,8
FCSB,6983,1,9,5,0,28,11,17,32
CFR Cluj,6983,2,5,6,3,14,12,2,21
Universitate,6983,3,4,5,5,17,21,-4,17
FC Botosani,6983,4,4,5,5,9,15,-6,17
D Bucuresti,6983,5,4,4,6,20,21,-1,16
Concordia Ch,6983,6,2,3,9,18,26,-8,9
FCSB,6984,1,7,6,1,25,13,12,27
CFR Cluj,6984,2,5,7,2,14,9,5,22
Universitate,6984,3,5,5,4,17,19,-2,20
D Bucuresti,6984,4,4,5,5,20,21,-1,17
FC Botosani,6984,5,3,5,6,7,17,-10,14
Concordia Ch,6984,6,3,2,9,19,23,-4,11
FCSB,6985,1,8,5,1,28,14,14,29
CFR Cluj,6985,2,7,6,1,21,10,11,27
D Bucuresti,6985,3,5,4,5,20,19,1,19
FC Botosani,6985,4,3,5,6,5,13,-8,14
Universitate,6985,5,3,5,6,15,25,-10,14
Concordia Ch,6985,6,2,3,9,16,24,-8,9
FCSB,6986,1,7,7,0,25,12,13,28
CFR Cluj,6986,2,5,7,2,13,8,5,22
FC Botosani,6986,3,5,4,5,10,13,-3,19
Universitate,6986,4,4,6,4,17,20,-3,18
D Bucuresti,6986,5,3,4,7,19,25,-6,13
Concordia Ch,6986,6,3,2,9,18,24,-6,11
FCSB,6987,1,8,5,1,25,11,14,29
CFR Cluj,6987,2,6,7,1,14,7,7,25
FC Botosani,6987,3,5,4,5,11,13,-2,19
Universitate,6987,4,3,6,5,14,20,-6,15
D Bucuresti,6987,5,3,5,6,16,22,-6,14
Concordia Ch,6987,6,2,3,9,16,23,-7,9
FCSB,6988,1,8,6,0,24,10,14,30
CFR Cluj,6988,2,6,7,1,16,9,7,25
D Bucuresti,6988,3,4,5,5,22,19,3,17
FC Botosani,6988,4,4,5,5,6,12,-6,17
Universitate,6988,5,3,5,6,16,22,-6,14
Concordia Ch,6988,6,2,2,10,16,28,-12,8
FCSB,6989,1,7,6,1,25,14,11,27
CFR Cluj,6989,2,6,7,1,16,8,8,25
D Bucuresti,6989,3,5,4,5,22,19,3,19
Universitate,6989,4,4,5,5,17,21,-4,17
FC Botosani,6989,5,4,4,6,8,16,-8,16
Concordia Ch,6989,6,2,2,10,15,25,-10,8
FCSB,6990,1,7,6,1,24,12,12,27
CFR Cluj,6990,2,7,6,1,18,9,9,27
FC Botosani,6990,3,4,5,5,8,13,-5,17
Universitate,6990,4,3,6,5,17,23,-6,15
D Bucuresti,6990,5,3,5,6,17,20,-3,14
Concordia Ch,6990,6,3,2,9,16,23,-7,11
FCSB,6991,1,8,6,0,26,12,14,30
CFR Cluj,6991,2,6,6,2,15,9,6,24
FC Botosani,6991,3,4,5,5,9,14,-5,17
Universitate,6991,4,3,6,5,17,22,-5,15
D Bucuresti,6991,5,3,5,6,17,21,-4,14
Concordia Ch,6991,6,2,4,8,18,24,-6,10
FCSB,6992,1,8,5,1,26,14,12,29
CFR Cluj,6992,2,7,6,1,18,8,10,27
D Bucuresti,6992,3,4,5,5,19,18,1,17
FC Botosani,6992,4,4,5,5,6,12,-6,17
Universitate,6992,5,3,5,6,16,23,-7,14
Concordia Ch,6992,6,2,2,10,15,25,-10,8
FCSB,6993,1,9,5,0,27,11,16,32
CFR Cluj,6993,2,6,6,2,14,9,5,24
D Bucuresti,6993,3,4,5,5,19,20,-1,17
Universitate,6993,4,3,5,6,15,21,-6,14
FC Botosani,6993,5,3,4,7,6,16,-10,13
Concordia Ch,6993,6,3,3,8,18,22,-4,12
FCSB,6994,1,8,6,0,25,11,14,30
CFR Cluj,6994,2,5,7,2,13,8,5,22
D Bucuresti,6994,3,4,5,5,19,19,0,17
Universitate,6994,4,4,5,5,16,20,-4,17
FC Botosani,6994,5,3,4,7,6,16,-10,13
Concordia Ch,6994,6,3,3,8,16,21,-5,12
FCSB,6995,1,7,5,2,23,15,8,26
CFR Cluj,6995,2,6,7,1,15,8,7,25
Universitate,6995,3,4,6,4,19,19,0,18
FC Botosani,6995,4,4,5,5,8,14,-6,17
D Bucuresti,6995,5,3,5,6,18,21,-3,14
Concordia Ch,6995,6,3,2,9,16,22,-6,11
FCSB,6996,1,8,5,1,26,13,13,29
CFR Cluj,6996,2,7,6,1,18,8,10,27
D Bucuresti,6996,3,5,4,5,21,19,2,19
FC Botosani,6996,4,4,4,6,7,15,-8,16
Universitate,6996,5,3,5,6,14,22,-8,14
Concordia Ch,6996,6,2,2,10,15,24,-9,8
FCSB,6997,1,8,6,0,29,11,18,30
CFR Cluj,6997,2,6,6,2,16,13,3,24
FC Botosani,6997,3,4,4,6,9,16,-7,16
Universitate,6997,4,3,6,5,14,20,-6,15
Concordia Ch,6997,5,4,2,8,18,22,-4,14
D Bucuresti,6997,6,3,4,7,18,22,-4,13
FCSB,6998,1,9,5,0,26,10,16,32
CFR Cluj,6998,2,5,7,2,13,9,4,22
FC Botosani,6998,3,4,4,6,6,14,-8,16
Universitate,6998,4,3,6,5,14,19,-5,15
D Bucuresti,6998,5,3,5,6,16,19,-3,14
Concordia Ch,6998,6,3,3,8,17,21,-4,12
FCSB,6999,1,7,6,1,24,12,12,27
CFR Cluj,6999,2,6,7,1,17,10,7,25
Universitate,6999,3,3,7,4,16,20,-4,16
FC Botosani,6999,4,3,6,5,6,13,-7,15
D Bucuresti,6999,5,3,5,6,17,22,-5,14
Concordia Ch,6999,6,3,3,8,18,21,-3,12
FCSB,7000,1,8,5,1,25,11,14,29
CFR Cluj,7000,2,6,6,2,16,9,7,24
D Bucuresti,7000,3,4,5,5,19,19,0,17
Universitate,7000,4,4,5,5,15,21,-6,17
FC Botosani,7000,5,4,4,6,8,16,-8,16
Concordia Ch,7000,6,2,3,9,18,25,-7,9
FCSB,7001,1,7,7,0,24,11,13,28
CFR Cluj,7001,2,6,7,1,15,7,8,25
FC Botosani,7001,3,5,4,5,10,15,-5,19
Universitate,7001,4,3,6,5,15,21,-6,15
D Bucuresti,7001,5,3,5,6,18,21,-3,14
Concordia Ch,7001,6,2,3,9,18,25,-7,9
FCSB,7002,1,8,5,1,28,12,16,29
CFR Cluj,7002,2,6,6,2,15,10,5,24
D Bucuresti,7002,3,4,5,5,19,19,0,17
Universitate,7002,4,4,5,5,16,22,-6,17
FC Botosani,7002,5,4,4,6,7,15,-8,16
Concordia Ch,7002,6,2,3,9,17,24,-7,9
FCSB,7003,1,8,6,0,25,11,14,30
CFR Cluj,7003,2,6,6,2,14,8,6,24
D Bucuresti,7003,3,4,5,5,18,19,-1,17
Universitate,7003,4,3,6,5,15,20,-5,15
FC Botosani,7003,5,3,5,6,7,15,-8,14
Concordia Ch,7003,6,2,4,8,16,22,-6,10
FCSB,7004,1,7,6,1,24,13,11,27
CFR Cluj,7004,2,6,7,1,16,7,9,25
Universitate,7004,3,4,5,5,17,22,-5,17
D Bucuresti,7004,4,4,4,6,17,19,-2,16
FC Botosani,7004,5,3,5,6,6,14,-8,14
Concordia Ch,7004,6,3,3,8,17,22,-5,12
FCSB,7005,1,8,5,1,25,12,13,29
CFR Cluj,7005,2,7,6,1,16,7,9,27
Concordia Ch,7005,3,4,2,8,19,21,-2,14
D Bucuresti,7005,4,3,5,6,18,23,-5,14
Universitate,7005,5,3,5,6,14,21,-7,14
FC Botosani,7005,6,3,5,6,7,15,-8,14
FCSB,7006,1,7,7,0,26,13,13,28
CFR Cluj,7006,2,5,8,1,15,9,6,23
FC Botosani,7006,3,4,5,5,9,15,-6,17
Universitate,7006,4,3,7,4,17,21,-4,16
D Bucuresti,7006,5,3,4,7,17,22,-5,13
Concordia Ch,7006,6,3,3,8,19,23,-4,12
FCSB,7007,1,7,6,1,23,11,12,27
CFR Cluj,7007,2,6,6,2,15,9,6,24
Universitate,7007,3,4,6,4,16,19,-3,18
D Bucuresti,7007,4,4,5,5,20,21,-1,17
FC Botosani,7007,5,4,4,6,8,15,-7,16
Concordia Ch,7007,6,2,3,9,16,23,-7,9
FCSB,7008,1,8,5,1,27,15,12,29
CFR Cluj,7008,2,5,6,3,15,11,4,21
Universitate,7008,3,5,5,4,20,21,-1,20
D Bucuresti,7008,4,5,4,5,21,18,3,19
FC Botosani,7008,5,3,4,7,5,15,-10,13
Concordia Ch,7008,6,3,2,9,16,24,-8,11
FCSB,7009,1,9,5,0,26,11,15,32
CFR Cluj,7009,2,5,6,3,14,11,3,21
FC Botosani,7009,3,5,4,5,9,13,-4,19
Universitate,7009,4,4,5,5,18,21,-3,17
D Bucuresti,7009,5,3,5,6,17,21,-4,14
Concordia Ch,7009,6,2,3,9,15,22,-7,9
FCSB,7010,1,8,6,0,27,11,16,30
CFR Cluj,7010,2,6,6,2,18,13,5,24
FC Botosani,7010,3,5,4,5,8,12,-4,19
D Bucuresti,7010,4,4,4,6,17,19,-2,16
Universitate,7010,5,3,6,5,16,22,-6,15
Concordia Ch,7010,6,2,2,10,15,24,-9,8
FCSB,7011,1,8,6,0,26,11,15,30
CFR Cluj,7011,2,5,6,3,13,10,3,21
Universitate,7011,3,4,6,4,16,19,-3,18
D Bucuresti,7011,4,4,5,5,20,21,-1,17
FC Botosani,7011,5,4,4,6,9,15,-6,16
Concordia Ch,7011,6,2,3,9,18,26,-8,9
FCSB,7012,1,9,5,0,28,11,17,32
CFR Cluj,7012,2,5,6,3,15,11,4,21
Universitate,7012,3,4,5,5,16,22,-6,17
FC Botosani,7012,4,4,4,6,9,15,-6,16
D Bucuresti,7012,5,3,5,6,17,21,-4,14
Concordia Ch,7012,6,3,3,8,17,22,-5,12
FCSB,7013,1,7,6,1,24,12,12,27
CFR Cluj,7013,2,5,8,1,13,7,6,23
Universitate,7013,3,4,6,4,16,19,-3,18
D Bucuresti,7013,4,4,4,6,18,20,-2,16
FC Botosani,7013,5,4,4,6,6,13,-7,16
Concordia Ch,7013,6,3,2,9,17,23,-6,11
FCSB,7014,1,8,6,0,27,13,14,30
CFR Cluj,7014,2,5,7,2,15,10,5,22
Universitate,7014,3,3,7,4,15,19,-4,16
D Bucuresti,7014,4,3,6,5,18,20,-2,15
FC Botosani,7014,5,3,6,5,7,14,-7,15
Concordia Ch,7014,6,2,4,8,19,25,-6,10
FCSB,7015,1,8,5,1,25,12,13,29
CFR Cluj,7015,2,6,6,2,15,9,6,24
Universitate,7015,3,4,5,5,16,20,-4,17
D Bucuresti,7015,4,4,4,6,18,20,-2,16
FC Botosani,7015,5,4,4,6,6,14,-8,16
Concordia Ch,7015,6,3,2,9,18,23,-5,11
FCSB,7016,1,8,5,1,27,12,15,29
CFR Cluj,7016,2,7,6,1,16,7,9,27
D Bucuresti,7016,3,4,4,6,19,20,-1,16
Concordia Ch,7016,4,4,2,8,18,22,-4,14
Universitate,7016,5,3,5,6,15,24,-9,14
FC Botosani,7016,6,3,4,7,5,15,-10,13
FCSB,7017,1,8,6,0,25,10,15,30
CFR Cluj,7017,2,6,6,2,15,9,6,24
D Bucuresti,7017,3,5,4,5,21,18,3,19
Universitate,7017,4,3,6,5,14,20,-6,15
FC Botosani,7017,5,3,5,6,5,16,-11,14
Concordia Ch,7017,6,2,3,9,15,22,-7,9
CFR Cluj,7018,1,7,6,1,16,8,8,27
FCSB,7018,2,7,5,2,23,12,11,26
Universitate,7018,3,4,5,5,16,20,-4,17
D Bucuresti,7018,4,4,4,6,20,22,-2,16
Concordia Ch,7018,5,4,2,8,19,23,-4,14
FC Botosani,7018,6,3,4,7,6,15,-9,13
FCSB,7019,1,7,5,2,24,13,11,26
CFR Cluj,7019,2,6,7,1,16,9,7,25
Universitate,7019,3,4,6,4,16,19,-3,18
FC Botosani,7019,4,4,5,5,8,13,-5,17
D Bucuresti,7019,5,3,5,6,17,21,-4,14
Concordia Ch,7019,6,3,2,9,17,23,-6,11
FCSB,7020,1,8,5,1,26,11,15,29
CFR Cluj,7020,2,5,6,3,13,11,2,21
Universitate,7020,3,5,5,4,16,18,-2,20
FC Botosani,7020,4,5,4,5,9,14,-5,19
D Bucuresti,7020,5,3,5,6,18,21,-3,14
Concordia Ch,7020,6,2,3,9,17,24,-7,9
FCSB,7021,1,7,6,1,23,12,11,27
CFR Cluj,7021,2,6,7,1,14,7,7,25
D Bucuresti,7021,3,5,4,5,19,19,0,19
Universitate,7021,4,4,5,5,16,19,-3,17
FC Botosani,7021,5,4,4,6,8,15,-7,16
Concordia Ch,7021,6,2,2,10,16,24,-8,8
FCSB,7022,1,7,7,0,24,11,13,28
CFR Cluj,7022,2,6,7,1,15,8,7,25
FC Botosani,7022,3,5,4,5,8,13,-5,19
Universitate,7022,4,3,6,5,14,19,-5,15
D Bucuresti,7022,5,3,5,6,22,25,-3,14
Concordia Ch,7022,6,2,3,9,20,27,-7,9
FCSB,7023,1,8,6,0,27,13,14,30
CFR Cluj,7023,2,6,6,2,15,9,6,24
D Bucuresti,7023,3,4,4,6,20,23,-3,16
Universitate,7023,4,3,6,5,16,21,-5,15
FC Botosani,7023,5,3,5,6,6,15,-9,14
Concordia Ch,7023,6,3,3,8,19,22,-3,12
FCSB,7024,1,9,5,0,29,11,18,32
CFR Cluj,7024,2,5,6,3,14,12,2,21
D Bucuresti,7024,3,5,4,5,21,19,2,19
Universitate,7024,4,4,5,5,18,23,-5,17
FC Botosani,7024,5,4,4,6,9,15,-6,16
Concordia Ch,7024,6,2,2,10,15,26,-11,8
FCSB,7025,1,8,6,0,27,12,15,30
CFR Cluj,7025,2,5,8,1,16,10,6,23
D Bucuresti,7025,3,4,4,6,18,22,-4,16
Universitate,7025,4,3,6,5,15,21,-6,15
Concordia Ch,7025,5,4,2,8,19,21,-2,14
FC Botosani,7025,6,3,4,7,6,15,-9,13
FCSB,7026,1,8,5,1,25,11,14,29
CFR Cluj,7026,2,6,6,2,15,9,6,24
D Bucuresti,7026,3,4,5,5,18,19,-1,17
Universitate,7026,4,4,5,5,15,20,-5,17
FC Botosani,7026,5,4,4,6,8,14,-6,16
Concordia Ch,7026,6,2,3,9,17,25,-8,9
FCSB,7027,1,9,5,0,29,12,17,32
CFR Cluj,7027,2,6,6,2,17,10,7,24
FC Botosani,7027,3,4,4,6,6,13,-7,16
Concordia Ch,7027,4,4,2,8,17,21,-4,14
Universitate,7027,5,3,5,6,14,23,-9,14
D Bucuresti,7027,6,3,4,7,16,20,-4,13
FCSB,7028,1,7,6,1,25,16,9,27
CFR Cluj,7028,2,6,7,1,16,9,7,25
Universitate,7028,3,4,5,5,20,21,-1,17
D Bucuresti,7028,4,4,5,5,18,19,-1,17
FC Botosani,7028,5,4,4,6,8,14,-6,16
Concordia Ch,7028,6,2,3,9,17,25,-8,9
FCSB,7029,1,8,5,1,24,13,11,29
CFR Cluj,7029,2,5,6,3,13,10,3,21
Universitate,7029,3,5,5,4,19,18,1,20
D Bucuresti,7029,4,4,4,6,19,20,-1,16
FC Botosani,7029,5,4,4,6,7,14,-7,16
Concordia Ch,7029,6,3,2,9,16,23,-7,11
FCSB,7030,1,7,7,0,24,11,13,28
CFR Cluj,7030,2,5,7,2,13,9,4,22
Universitate,7030,3,4,6,4,17,19,-2,18
D Bucuresti,7030,4,4,5,5,19,20,-1,17
FC Botosani,7030,5,4,4,6,7,14,-7,16
Concordia Ch,7030,6,2,3,9,18,25,-7,9
FCSB,7031,1,7,6,1,24,16,8,27
CFR Cluj,7031,2,6,7,1,15,8,7,25
Universitate,7031,3,4,5,5,19,19,0,17
D Bucuresti,7031,4,4,5,5,18,19,-1,17
FC Botosani,7031,5,3,4,7,5,15,-10,13
Concordia Ch,7031,6,3,3,8,18,22,-4,12
FCSB,7032,1,8,6,0,27,13,14,30
CFR Cluj,7032,2,6,7,1,16,9,7,25
Concordia Ch,7032,3,4,2,8,22,23,-1,14
D Bucuresti,7032,4,3,5,6,18,23,-5,14
Universitate,7032,5,3,5,6,15,21,-6,14
FC Botosani,7032,6,3,5,6,7,16,-9,14
FCSB,7033,1,7,7,0,28,15,13,28
CFR Cluj,7033,2,6,7,1,18,10,8,25
FC Botosani,7033,3,5,4,5,9,12,-3,19
Universitate,7033,4,3,6,5,16,22,-6,15
D Bucuresti,7033,5,3,5,6,17,22,-5,14
Concordia Ch,7033,6,2,3,9,16,23,-7,9
FCSB,7034,1,7,6,1,24,12,12,27
CFR Cluj,7034,2,6,7,1,15,8,7,25
Universitate,7034,3,4,5,5,15,19,-4,17
FC Botosani,7034,4,4,4,6,7,13,-6,16
Concordia Ch,7034,5,4,2,8,18,21,-3,14
D Bucuresti,7034,6,3,4,7,16,22,-6,13
FCSB,7035,1,7,5,2,24,14,10,26
CFR Cluj,7035,2,6,6,2,15,8,7,24
Universitate,7035,3,5,5,4,17,19,-2,20
D Bucuresti,7035,4,4,4,6,20,22,-2,16
Concordia Ch,7035,5,4,2,8,20,23,-3,14
FC Botosani,7035,6,3,4,7,7,17,-10,13
FCSB,7036,1,7,6,1,27,15,12,27
CFR Cluj,7036,2,6,7,1,17,10,7,25
Universitate,7036,3,4,5,5,20,24,-4,17
FC Botosani,7036,4,4,4,6,8,15,-7,16
Concordia Ch,7036,5,4,2,8,19,23,-4,14
D Bucuresti,7036,6,3,4,7,18,22,-4,13
FCSB,7037,1,7,6,1,25,13,12,27
CFR Cluj,7037,2,5,7,2,16,11,5,22
Universitate,7037,3,5,5,4,19,21,-2,20
D Bucuresti,7037,4,4,4,6,19,22,-3,16
Concordia Ch,7037,5,4,2,8,18,21,-3,14
FC Botosani,7037,6,3,4,7,7,16,-9,13
FCSB,7038,1,7,7,0,24,11,13,28
CFR Cluj,7038,2,5,7,2,14,10,4,22
Universitate,7038,3,4,6,4,16,18,-2,18
D Bucuresti,7038,4,4,5,5,19,20,-1,17
FC Botosani,7038,5,3,6,5,7,14,-7,15
Concordia Ch,7038,6,2,3,9,17,24,-7,9
FCSB,7039,1,8,6,0,26,12,14,30
CFR Cluj,7039,2,5,7,2,14,9,5,22
FC Botosani,7039,3,4,5,5,9,14,-5,17
Universitate,7039,4,3,7,4,17,21,-4,16
D Bucuresti,7039,5,3,5,6,17,20,-3,14
Concordia Ch,7039,6,3,2,9,17,24,-7,11
FCSB,7040,1,9,5,0,27,12,15,32
CFR Cluj,7040,2,5,6,3,14,12,2,21
D Bucuresti,7040,3,4,5,5,20,21,-1,17
Universitate,7040,4,4,5,5,20,22,-2,17
FC Botosani,7040,5,4,5,5,9,15,-6,17
Concordia Ch,7040,6,2,2,10,17,25,-8,8
FCSB,7041,1,8,6,0,25,10,15,30
CFR Cluj,7041,2,5,6,3,13,10,3,21
FC Botosani,7041,3,5,4,5,8,12,-4,19
Universitate,7041,4,4,6,4,15,18,-3,18
D Bucuresti,7041,5,3,4,7,18,22,-4,13
Concordia Ch,7041,6,3,2,9,18,25,-7,11
FCSB,7042,1,9,5,0,26,11,15,32
CFR Cluj,7042,2,5,6,3,14,10,4,21
Universitate,7042,3,4,5,5,15,19,-4,17
D Bucuresti,7042,4,3,6,5,19,21,-2,15
FC Botosani,7042,5,3,6,5,7,14,-7,15
Concordia Ch,7042,6,2,4,8,18,24,-6,10
FCSB,7043,1,9,5,0,29,11,18,32
CFR Cluj,7043,2,5,6,3,13,11,2,21
Universitate,7043,3,4,5,5,16,21,-5,17
D Bucuresti,7043,4,3,5,6,17,20,-3,14
Concordia Ch,7043,5,4,2,8,17,21,-4,14
FC Botosani,7043,6,3,5,6,6,14,-8,14
FCSB,7044,1,7,7,0,25,12,13,28
CFR Cluj,7044,2,5,7,2,14,10,4,22
Universitate,7044,3,4,6,4,17,19,-2,18
D Bucuresti,7044,4,4,5,5,18,19,-1,17
FC Botosani,7044,5,4,5,5,6,12,-6,17
Concordia Ch,7044,6,2,2,10,16,24,-8,8
FCSB,7045,1,8,5,1,25,12,13,29
CFR Cluj,7045,2,7,6,1,17,8,9,27
FC Botosani,7045,3,4,5,5,7,13,-6,17
D Bucuresti,7045,4,3,5,6,17,20,-3,14
Universitate,7045,5,3,5,6,14,21,-7,14
Concordia Ch,7045,6,3,2,9,16,22,-6,11
FCSB,7046,1,8,6,0,26,11,15,30
CFR Cluj,7046,2,5,7,2,15,11,4,22
Universitate,7046,3,3,7,4,17,21,-4,16
D Bucuresti,7046,4,3,6,5,18,20,-2,15
FC Botosani,7046,5,3,6,5,6,13,-7,15
Concordia Ch,7046,6,2,4,8,18,24,-6,10
FCSB,7047,1,7,6,1,25,13,12,27
CFR Cluj,7047,2,7,6,1,17,8,9,27
D Bucuresti,7047,3,4,4,6,18,22,-4,16
Universitate,7047,4,3,6,5,15,21,-6,15
Concordia Ch,7047,5,4,2,8,21,22,-1,14
FC Botosani,7047,6,3,4,7,5,15,-10,13
FCSB,7048,1,7,7,0,23,10,13,28
CFR Cluj,7048,2,6,7,1,14,7,7,25
FC Botosani,7048,3,4,5,5,8,14,-6,17
D Bucuresti,7048,4,3,6,5,20,22,-2,15
Universitate,7048,5,3,6,5,14,19,-5,15
Concordia Ch,7048,6,2,3,9,19,26,-7,9
FCSB,7049,1,9,5,0,26,10,16,32
CFR Cluj,7049,2,5,7,2,14,10,4,22
FC Botosani,7049,3,5,4,5,9,14,-5,19
D Bucuresti,7049,4,4,4,6,21,21,0,16
Universitate,7049,5,3,6,5,15,20,-5,15
Concordia Ch,7049,6,2,2,10,15,25,-10,8
CFR Cluj,7050,1,7,6,1,16,8,8,27
FCSB,7050,2,7,5,2,25,14,11,26
FC Botosani,7050,3,5,4,5,7,12,-5,19
Universitate,7050,4,4,5,5,16,20,-4,17
D Bucuresti,7050,5,4,4,6,18,20,-2,16
Concordia Ch,7050,6,2,2,10,16,24,-8,8
FCSB,7051,1,8,6,0,24,10,14,30
CFR Cluj,7051,2,5,7,2,13,8,5,22
D Bucuresti,7051,3,4,4,6,19,20,-1,16
Universitate,7051,4,3,7,4,14,18,-4,16
FC Botosani,7051,5,4,4,6,7,15,-8,16
Concordia Ch,7051,6,3,2,9,16,22,-6,11
FCSB,7052,1,8,5,1,26,12,14,29
CFR Cluj,7052,2,6,6,2,16,11,5,24
Universitate,7052,3,4,5,5,16,20,-4,17
FC Botosani,7052,4,4,5,5,7,13,-6,17
D Bucuresti,7052,5,3,4,7,16,22,-6,13
Concordia Ch,7052,6,3,3,8,19,22,-3,12
FCSB,7053,1,9,5,0,27,11,16,32
CFR Cluj,7053,2,5,7,2,13,9,4,22
D Bucuresti,7053,3,5,4,5,21,18,3,19
Universitate,7053,4,3,6,5,15,20,-5,15
FC Botosani,7053,5,3,5,6,5,14,-9,14
Concordia Ch,7053,6,2,3,9,15,24,-9,9
FCSB,7054,1,8,5,1,25,12,13,29
CFR Cluj,7054,2,5,6,3,13,12,1,21
Universitate,7054,3,5,5,4,19,18,1,20
FC Botosani,7054,4,5,4,5,9,13,-4,19
D Bucuresti,7054,5,4,4,6,20,22,-2,16
Concordia Ch,7054,6,2,2,10,17,26,-9,8
FCSB,7055,1,8,5,1,25,11,14,29
CFR Cluj,7055,2,6,6,2,16,11,5,24
Universitate,7055,3,4,5,5,18,22,-4,17
D Bucuresti,7055,4,3,6,5,17,19,-2,15
FC Botosani,7055,5,3,6,5,6,13,-7,15
Concordia Ch,7055,6,2,4,8,15,21,-6,10
CFR Cluj,7056,1,7,6,1,17,9,8,27
FCSB,7056,2,7,5,2,26,15,11,26
D Bucuresti,7056,3,4,5,5,18,19,-1,17
Universitate,7056,4,4,5,5,18,22,-4,17
FC Botosani,7056,5,3,5,6,5,13,-8,14
Concordia Ch,7056,6,3,2,9,17,23,-6,11
FCSB,7057,1,9,5,0,25,10,15,32
CFR Cluj,7057,2,6,6,2,16,8,8,24
FC Botosani,7057,3,4,5,5,8,13,-5,17
D Bucuresti,7057,4,3,5,6,17,21,-4,14
Universitate,7057,5,3,5,6,14,22,-8,14
Concordia Ch,7057,6,2,4,8,15,21,-6,10
FCSB,7058,1,8,6,0,25,10,15,30
CFR Cluj,7058,2,5,6,3,13,11,2,21
FC Botosani,7058,3,5,4,5,8,12,-4,19
Universitate,7058,4,4,6,4,16,18,-2,18
D Bucuresti,7058,5,3,4,7,16,24,-8,13
Concordia Ch,7058,6,3,2,9,20,23,-3,11
FCSB,7059,1,8,5,1,27,12,15,29
CFR Cluj,7059,2,5,6,3,14,12,2,21
Universitate,7059,3,5,5,4,18,20,-2,20
FC Botosani,7059,4,4,5,5,8,14,-6,17
D Bucuresti,7059,5,3,4,7,17,23,-6,13
Concordia Ch,7059,6,3,3,8,21,24,-3,12
FCSB,7060,1,9,5,0,26,11,15,32
CFR Cluj,7060,2,6,6,2,19,8,11,24
FC Botosani,7060,3,4,5,5,9,15,-6,17
D Bucuresti,7060,4,3,6,5,18,20,-2,15
Universitate,7060,5,3,5,6,15,26,-11,14
Concordia Ch,7060,6,2,3,9,18,25,-7,9
FCSB,7061,1,7,6,1,25,14,11,27
CFR Cluj,7061,2,6,7,1,16,9,7,25
FC Botosani,7061,3,5,4,5,9,12,-3,19
Universitate,7061,4,4,5,5,18,21,-3,17
D Bucuresti,7061,5,4,4,6,18,21,-3,16
Concordia Ch,7061,6,2,2,10,16,25,-9,8
FCSB,7062,1,7,7,0,25,12,13,28
CFR Cluj,7062,2,6,7,1,17,8,9,25
D Bucuresti,7062,3,4,5,5,19,18,1,17
Universitate,7062,4,3,6,5,15,22,-7,15
FC Botosani,7062,5,3,5,6,6,14,-8,14
Concordia Ch,7062,6,3,2,9,17,25,-8,11
FCSB,7063,1,8,5,1,24,11,13,29
CFR Cluj,7063,2,5,6,3,13,9,4,21
Universitate,7063,3,5,5,4,16,18,-2,20
D Bucuresti,7063,4,4,5,5,20,21,-1,17
FC Botosani,7063,5,3,4,7,5,14,-9,13
Concordia Ch,7063,6,3,3,8,19,24,-5,12
FCSB,7064,1,8,6,0,27,13,14,30
CFR Cluj,7064,2,5,7,2,14,9,5,22
Universitate,7064,3,4,5,5,17,21,-4,17
D Bucuresti,7064,4,4,4,6,19,20,-1,16
FC Botosani,7064,5,4,4,6,7,15,-8,16
Concordia Ch,7064,6,3,2,9,17,23,-6,11
FCSB,7065,1,9,5,0,27,11,16,32
CFR Cluj,7065,2,5,6,3,13,10,3,21
FC Botosani,7065,3,5,4,5,8,13,-5,19
Universitate,7065,4,4,5,5,16,20,-4,17
D Bucuresti,7065,5,3,5,6,19,22,-3,14
Concordia Ch,7065,6,2,3,9,17,24,-7,9
FCSB,7066,1,9,5,0,27,11,16,32
CFR Cluj,7066,2,5,6,3,15,11,4,21
Universitate,7066,3,4,5,5,16,21,-5,17
D Bucuresti,7066,4,4,4,6,19,20,-1,16
FC Botosani,7066,5,4,4,6,8,17,-9,16
Concordia Ch,7066,6,3,2,9,19,24,-5,11
CFR Cluj,7067,1,7,6,1,17,9,8,27
FCSB,7067,2,7,5,2,25,14,11,26
Universitate,7067,3,4,5,5,15,19,-4,17
D Bucuresti,7067,4,3,6,5,18,20,-2,15
FC Botosani,7067,5,3,5,6,5,13,-8,14
Concordia Ch,7067,6,3,3,8,18,23,-5,12
FCSB,7068,1,8,6,0,25,10,15,30
CFR Cluj,7068,2,6,6,2,14,9,5,24
FC Botosani,7068,3,4,5,5,8,14,-6,17
Universitate,7068,4,3,6,5,14,19,-5,15
D Bucuresti,7068,5,3,5,6,19,22,-3,14
Concordia Ch,7068,6,3,2,9,17,23,-6,11
FCSB,7069,1,8,5,1,27,13,14,29
CFR Cluj,7069,2,6,6,2,15,11,4,24
Universitate,7069,3,4,5,5,17,20,-3,17
FC Botosani,7069,4,4,5,5,7,13,-6,17
D Bucuresti,7069,5,3,5,6,18,23,-5,14
Concordia Ch,7069,6,3,2,9,19,23,-4,11
FCSB,7070,1,7,6,1,26,15,11,27
CFR Cluj,7070,2,6,6,2,17,10,7,24
Universitate,7070,3,4,6,4,16,19,-3,18
D Bucuresti,7070,4,4,4,6,18,21,-3,16
FC Botosani,7070,5,4,4,6,8,15,-7,16
Concordia Ch,7070,6,3,2,9,20,25,-5,11
FCSB,7071,1,8,5,1,25,13,12,29
CFR Cluj,7071,2,5,7,2,13,9,4,22
Universitate,7071,3,4,6,4,17,18,-1,18
D Bucuresti,7071,4,4,4,6,20,22,-2,16
Concordia Ch,7071,5,4,2,8,21,24,-3,14
FC Botosani,7071,6,3,4,7,8,18,-10,13
FCSB,7072,1,8,6,0,28,13,15,30
CFR Cluj,7072,2,5,6,3,14,11,3,21
Universitate,7072,3,4,6,4,17,20,-3,18
D Bucuresti,7072,4,4,5,5,19,20,-1,17
FC Botosani,7072,5,4,5,5,6,12,-6,17
Concordia Ch,7072,6,2,2,10,17,25,-8,8
FCSB,7073,1,8,5,1,27,11,16,29
CFR Cluj,7073,2,5,6,3,13,12,1,21
Universitate,7073,3,5,5,4,16,18,-2,20
FC Botosani,7073,4,5,4,5,11,15,-4,19
D Bucuresti,7073,5,4,4,6,18,20,-2,16
Concordia Ch,7073,6,2,2,10,17,26,-9,8
FCSB,7074,1,8,6,0,25,11,14,30
CFR Cluj,7074,2,5,8,1,14,8,6,23
D Bucuresti,7074,3,4,5,5,20,20,0,17
Universitate,7074,4,3,6,5,14,19,-5,15
FC Botosani,7074,5,3,4,7,5,15,-10,13
Concordia Ch,7074,6,3,3,8,18,23,-5,12
FCSB,7075,1,7,5,2,24,15,9,26
CFR Cluj,7075,2,6,6,2,17,10,7,24
Universitate,7075,3,5,5,4,19,20,-1,20
FC Botosani,7075,4,5,4,5,9,13,-4,19
D Bucuresti,7075,5,3,5,6,17,21,-4,14
Concordia Ch,7075,6,2,3,9,17,24,-7,9
FCSB,7076,1,8,5,1,26,13,13,29
CFR Cluj,7076,2,7,6,1,15,7,8,27
FC Botosani,7076,3,5,4,5,10,14,-4,19
D Bucuresti,7076,4,3,5,6,18,22,-4,14
Universitate,7076,5,3,5,6,16,22,-6,14
Concordia Ch,7076,6,2,3,9,15,22,-7,9
FCSB,7077,1,8,5,1,25,12,13,29
CFR Cluj,7077,2,6,6,2,15,8,7,24
D Bucuresti,7077,3,5,4,5,21,20,1,19
Universitate,7077,4,4,5,5,16,21,-5,17
FC Botosani,7077,5,3,5,6,6,15,-9,14
Concordia Ch,7077,6,2,3,9,18,25,-7,9
FCSB,7078,1,8,6,0,25,11,14,30
CFR Cluj,7078,2,5,8,1,13,7,6,23
D Bucuresti,7078,3,5,4,5,19,19,0,19
FC Botosani,7078,4,4,4,6,8,15,-7,16
Universitate,7078,5,3,6,5,15,20,-5,15
Concordia Ch,7078,6,2,2,10,16,24,-8,8
FCSB,7079,1,7,7,0,25,12,13,28
CFR Cluj,7079,2,6,7,1,17,8,9,25
D Bucuresti,7079,3,4,4,6,19,21,-2,16
FC Botosani,7079,4,4,4,6,8,15,-7,16
Universitate,7079,5,3,6,5,15,22,-7,15
Concordia Ch,7079,6,3,2,9,16,22,-6,11
FCSB,7080,1,9,5,0,28,13,15,32
CFR Cluj,7080,2,5,6,3,15,11,4,21
FC Botosani,7080,3,5,4,5,7,12,-5,19
Universitate,7080,4,4,5,5,16,20,-4,17
D Bucuresti,7080,5,3,4,7,16,20,-4,13
Concordia Ch,7080,6,3,2,9,16,22,-6,11
FCSB,7081,1,7,7,0,26,13,13,28
CFR Cluj,7081,2,6,7,1,22,13,9,25
Universitate,7081,3,3,6,5,17,24,-7,15
FC Botosani,7081,4,3,6,5,9,16,-7,15
D Bucuresti,7081,5,3,5,6,18,23,-5,14
Concordia Ch,7081,6,3,3,8,20,23,-3,12
FCSB,7082,1,8,6,0,26,12,14,30
CFR Cluj,7082,2,6,7,1,16,9,7,25
FC Botosani,7082,3,4,5,5,11,16,-5,17
D Bucuresti,7082,4,4,4,6,21,23,-2,16
Universitate,7082,5,3,5,6,14,20,-6,14
Concordia Ch,7082,6,2,3,9,18,26,-8,9
FCSB,7083,1,8,5,1,24,11,13,29
CFR Cluj,7083,2,5,6,3,13,9,4,21
Universitate,7083,3,5,5,4,16,18,-2,20
FC Botosani,7083,4,4,5,5,9,14,-5,17
D Bucuresti,7083,5,4,4,6,18,20,-2,16
Concordia Ch,7083,6,2,3,9,17,25,-8,9
FCSB,7084,1,9,5,0,27,12,15,32
CFR Cluj,7084,2,5,7,2,15,10,5,22
D Bucuresti,7084,3,5,4,5,20,19,1,19
FC Botosani,7084,4,4,4,6,7,15,-8,16
Universitate,7084,5,3,6,5,14,19,-5,15
Concordia Ch,7084,6,2,2,10,17,25,-8,8
FCSB,7085,1,8,5,1,24,12,12,29
CFR Cluj,7085,2,7,6,1,17,8,9,27
D Bucuresti,7085,3,4,5,5,17,18,-1,17
FC Botosani,7085,4,3,6,5,6,13,-7,15
Universitate,7085,5,3,5,6,15,21,-6,14
Concordia Ch,7085,6,2,3,9,16,23,-7,9
FCSB,7086,1,9,5,0,30,10,20,32
CFR Cluj,7086,2,6,6,2,15,10,5,24
D Bucuresti,7086,3,4,5,5,19,19,0,17
Universitate,7086,4,3,5,6,14,24,-10,14
FC Botosani,7086,5,3,4,7,5,16,-11,13
Concordia Ch,7086,6,3,3,8,18,22,-4,12
FCSB,7087,1,8,6,0,28,13,15,30
CFR Cluj,7087,2,5,6,3,15,13,2,21
Universitate,7087,3,4,6,4,17,19,-2,18
D Bucuresti,7087,4,4,4,6,17,19,-2,16
FC Botosani,7087,5,3,5,6,6,14,-8,14
Concordia Ch,7087,6,3,3,8,17,22,-5,12
FCSB,7088,1,8,5,1,25,11,14,29
CFR Cluj,7088,2,7,6,1,15,7,8,27
D Bucuresti,7088,3,4,5,5,18,19,-1,17
FC Botosani,7088,4,4,5,5,7,13,-6,17
Universitate,7088,5,3,5,6,14,21,-7,14
Concordia Ch,7088,6,2,2,10,15,23,-8,8
FCSB,7089,1,8,6,0,29,14,15,30
CFR Cluj,7089,2,6,6,2,17,11,6,24
FC Botosani,7089,3,5,4,5,9,14,-5,19
Universitate,7089,4,3,6,5,16,22,-6,15
D Bucuresti,7089,5,3,5,6,18,21,-3,14
Concordia Ch,7089,6,2,3,9,17,24,-7,9
FCSB,7090,1,8,5,1,27,13,14,29
CFR Cluj,7090,2,7,6,1,17,8,9,27
D Bucuresti,7090,3,5,4,5,21,20,1,19
FC Botosani,7090,4,4,4,6,9,16,-7,16
Universitate,7090,5,3,5,6,14,22,-8,14
Concordia Ch,7090,6,2,2,10,17,26,-9,8
FCSB,7091,1,9,5,0,26,10,16,32
CFR Cluj,7091,2,5,6,3,13,10,3,21
Universitate,7091,3,4,5,5,16,20,-4,17
FC Botosani,7091,4,4,5,5,9,14,-5,17
D Bucuresti,7091,5,3,5,6,18,23,-5,14
Concordia Ch,7091,6,3,2,9,18,23,-5,11
FCSB,7092,1,7,5,2,23,15,8,26
CFR Cluj,7092,2,6,6,2,18,11,7,24
Universitate,7092,3,5,5,4,21,21,0,20
FC Botosani,7092,4,5,4,5,9,13,-4,19
D Bucuresti,7092,5,3,4,7,17,22,-5,13
Concordia Ch,7092,6,3,2,9,19,25,-6,11
FCSB,7093,1,8,5,1,26,13,13,29
CFR Cluj,7093,2,7,6,1,16,7,9,27
D Bucuresti,7093,3,4,4,6,18,20,-2,16
Concordia Ch,7093,4,4,2,8,19,22,-3,14
Universitate,7093,5,3,5,6,16,23,-7,14
FC Botosani,7093,6,3,4,7,5,15,-10,13
FCSB,7094,1,8,6,0,25,10,15,30
CFR Cluj,7094,2,6,6,2,15,9,6,24
D Bucuresti,7094,3,4,5,5,17,18,-1,17
FC Botosani,7094,4,4,4,6,7,13,-6,16
Universitate,7094,5,3,6,5,14,20,-6,15
Concordia Ch,7094,6,2,3,9,15,23,-8,9
FCSB,7095,1,9,5,0,28,13,15,32
CFR Cluj,7095,2,5,7,2,14,9,5,22
D Bucuresti,7095,3,4,4,6,19,20,-1,16
FC Botosani,7095,4,4,4,6,6,14,-8,16
Universitate,7095,5,3,6,5,16,21,-5,15
Concordia Ch,7095,6,3,2,9,17,23,-6,11
FCSB,7096,1,9,5,0,28,11,17,32
CFR Cluj,7096,2,5,6,3,14,13,1,21
D Bucuresti,7096,3,5,4,5,19,18,1,19
Universitate,7096,4,4,5,5,20,23,-3,17
FC Botosani,7096,5,3,5,6,5,13,-8,14
Concordia Ch,7096,6,2,3,9,15,23,-8,9
FCSB,7097,1,9,5,0,27,10,17,32
CFR Cluj,7097,2,6,6,2,16,10,6,24
D Bucuresti,7097,3,4,4,6,19,22,-3,16
Universitate,7097,4,3,5,6,15,23,-8,14
FC Botosani,7097,5,3,5,6,6,16,-10,14
Concordia Ch,7097,6,3,3,8,20,22,-2,12
FCSB,7098,1,9,5,0,28,12,16,32
CFR Cluj,7098,2,5,7,2,14,9,5,22
D Bucuresti,7098,3,4,4,6,20,23,-3,16
Universitate,7098,4,3,6,5,17,23,-6,15
FC Botosani,7098,5,3,5,6,7,15,-8,14
Concordia Ch,7098,6,3,3,8,20,24,-4,12
FCSB,7099,1,8,6,0,26,12,14,30
CFR Cluj,7099,2,6,7,1,16,7,9,25
FC Botosani,7099,3,4,5,5,7,13,-6,17
D Bucuresti,7099,4,4,4,6,20,19,1,16
Universitate,7099,5,3,5,6,16,24,-8,14
Concordia Ch,7099,6,2,3,9,16,26,-10,9
FCSB,7100,1,8,5,1,26,14,12,29
CFR Cluj,7100,2,6,6,2,15,9,6,24
FC Botosani,7100,3,5,4,5,9,13,-4,19
Universitate,7100,4,4,5,5,17,20,-3,17
D Bucuresti,7100,5,4,4,6,20,21,-1,16
Concordia Ch,7100,6,2,2,10,16,26,-10,8
FCSB,7101,1,9,5,0,32,12,20,32
CFR Cluj,7101,2,6,6,2,14,11,3,24
FC Botosani,7101,3,4,5,5,6,12,-6,17
Universitate,7101,4,3,5,6,16,24,-8,14
D Bucuresti,7101,5,3,4,7,16,20,-4,13
Concordia Ch,7101,6,3,3,8,16,21,-5,12
FCSB,7102,1,7,6,1,24,12,12,27
CFR Cluj,7102,2,6,7,1,16,8,8,25
FC Botosani,7102,3,4,5,5,8,12,-4,17
Universitate,7102,4,4,5,5,15,20,-5,17
D Bucuresti,7102,5,3,6,5,17,19,-2,15
Concordia Ch,7102,6,2,3,9,16,25,-9,9
FCSB,7103,1,8,5,1,25,12,13,29
CFR Cluj,7103,2,6,6,2,17,11,6,24
Universitate,7103,3,4,5,5,17,21,-4,17
D Bucuresti,7103,4,4,4,6,17,20,-3,16
FC Botosani,7103,5,4,4,6,7,13,-6,16
Concordia Ch,7103,6,3,2,9,17,23,-6,11
FCSB,7104,1,7,6,1,25,13,12,27
CFR Cluj,7104,2,6,7,1,16,9,7,25
D Bucuresti,7104,3,4,5,5,18,19,-1,17
Universitate,7104,4,4,5,5,17,21,-4,17
FC Botosani,7104,5,4,4,6,6,13,-7,16
Concordia Ch,7104,6,2,3,9,16,23,-7,9
FCSB,7105,1,7,7,0,25,12,13,28
CFR Cluj,7105,2,6,7,1,16,7,9,25
D Bucuresti,7105,3,4,5,5,20,19,1,17
FC Botosani,7105,4,4,5,5,10,14,-4,17
Universitate,7105,5,3,6,5,16,23,-7,15
Concordia Ch,7105,6,2,2,10,16,28,-12,8
FCSB,7106,1,7,6,1,24,12,12,27
CFR Cluj,7106,2,6,7,1,16,8,8,25
FC Botosani,7106,3,5,4,5,10,13,-3,19
Universitate,7106,4,4,5,5,15,20,-5,17
D Bucuresti,7106,5,3,4,7,17,22,-5,13
Concordia Ch,7106,6,3,2,9,16,23,-7,11
FCSB,7107,1,7,6,1,27,15,12,27
CFR Cluj,7107,2,6,6,2,16,12,4,24
D Bucuresti,7107,3,5,4,5,22,20,2,19
Universitate,7107,4,4,6,4,19,20,-1,18
FC Botosani,7107,5,4,4,6,7,15,-8,16
Concordia Ch,7107,6,2,2,10,18,27,-9,8
FCSB,7108,1,7,7,0,26,13,13,28
CFR Cluj,7108,2,6,7,1,16,8,8,25
D Bucuresti,7108,3,4,5,5,22,21,1,17
Universitate,7108,4,3,6,5,16,22,-6,15
FC Botosani,7108,5,3,5,6,7,17,-10,14
Concordia Ch,7108,6,2,4,8,16,22,-6,10
FCSB,7109,1,8,6,0,26,11,15,30
CFR Cluj,7109,2,5,7,2,13,9,4,22
D Bucuresti,7109,3,4,5,5,19,20,-1,17
Universitate,7109,4,3,7,4,15,19,-4,16
FC Botosani,7109,5,4,4,6,11,16,-5,16
Concordia Ch,7109,6,2,3,9,16,25,-9,9
FCSB,7110,1,8,6,0,25,11,14,30
CFR Cluj,7110,2,5,7,2,13,8,5,22
FC Botosani,7110,3,4,5,5,7,12,-5,17
Universitate,7110,4,3,7,4,15,19,-4,16
D Bucuresti,7110,5,3,5,6,17,21,-4,14
Concordia Ch,7110,6,2,4,8,16,22,-6,10
FCSB,7111,1,9,5,0,26,11,15,32
CFR Cluj,7111,2,5,7,2,14,9,5,22
FC Botosani,7111,3,5,4,5,9,14,-5,19
Universitate,7111,4,3,6,5,16,21,-5,15
D Bucuresti,7111,5,3,5,6,17,20,-3,14
Concordia Ch,7111,6,2,3,9,16,23,-7,9
FCSB,7112,1,8,5,1,25,12,13,29
CFR Cluj,7112,2,5,7,2,14,9,5,22
Universitate,7112,3,4,6,4,15,18,-3,18
FC Botosani,7112,4,4,5,5,9,15,-6,17
D Bucuresti,7112,5,3,6,5,20,22,-2,15
Concordia Ch,7112,6,2,3,9,18,25,-7,9
FCSB,7113,1,7,7,0,24,11,13,28
CFR Cluj,7113,2,6,7,1,15,7,8,25
FC Botosani,7113,3,4,5,5,7,13,-6,17
Universitate,7113,4,3,6,5,15,21,-6,15
D Bucuresti,7113,5,3,5,6,17,21,-4,14
Concordia Ch,7113,6,3,2,9,19,24,-5,11
FCSB,7114,1,8,6,0,26,11,15,30
CFR Cluj,7114,2,5,8,1,15,9,6,23
D Bucuresti,7114,3,3,6,5,18,20,-2,15
Universitate,7114,4,3,6,5,15,21,-6,15
FC Botosani,7114,5,3,5,6,7,16,-9,14
Concordia Ch,7114,6,3,3,8,19,23,-4,12
FCSB,7115,1,7,6,1,24,13,11,27
CFR Cluj,7115,2,7,6,1,16,7,9,27
D Bucuresti,7115,3,4,4,6,19,23,-4,16
FC Botosani,7115,4,4,4,6,7,14,-7,16
Universitate,7115,5,3,6,5,15,20,-5,15
Concordia Ch,7115,6,3,2,9,21,25,-4,11
FCSB,7116,1,8,6,0,25,10,15,30
CFR Cluj,7116,2,5,6,3,14,13,1,21
Universitate,7116,3,4,6,4,18,19,-1,18
D Bucuresti,7116,4,4,5,5,20,21,-1,17
FC Botosani,7116,5,3,5,6,7,15,-8,14
Concordia Ch,7116,6,3,2,9,17,23,-6,11
FCSB,7117,1,9,5,0,27,11,16,32
CFR Cluj,7117,2,6,6,2,16,10,6,24
D Bucuresti,7117,3,4,4,6,18,19,-1,16
FC Botosani,7117,4,4,4,6,7,14,-7,16
Universitate,7117,5,3,5,6,16,23,-7,14
Concordia Ch,7117,6,3,2,9,16,23,-7,11
FCSB,7118,1,8,5,1,25,15,10,29
CFR Cluj,7118,2,6,6,2,17,9,8,24
D Bucuresti,7118,3,5,4,5,23,22,1,19
Universitate,7118,4,4,5,5,18,21,-3,17
FC Botosani,7118,5,3,4,7,6,16,-10,13
Concordia Ch,7118,6,3,2,9,19,25,-6,11
FCSB,7119,1,8,5,1,25,12,13,29
CFR Cluj,7119,2,6,6,2,16,9,7,24
Universitate,7119,3,4,5,5,16,21,-5,17
D Bucuresti,7119,4,4,4,6,18,20,-2,16
Concordia Ch,7119,5,4,2,8,19,23,-4,14
FC Botosani,7119,6,3,4,7,6,15,-9,13
FCSB,7120,1,7,6,1,25,13,12,27
CFR Cluj,7120,2,6,7,1,15,8,7,25
Universitate,7120,3,4,5,5,16,20,-4,17
FC Botosani,7120,4,4,5,5,7,12,-5,17
D Bucuresti,7120,5,3,4,7,17,22,-5,13
Concordia Ch,7120,6,3,3,8,17,22,-5,12
FCSB,7121,1,8,6,0,26,12,14,30
CFR Cluj,7121,2,5,7,2,13,9,4,22
Universitate,7121,3,4,5,5,18,21,-3,17
D Bucuresti,7121,4,3,6,5,18,20,-2,15
FC Botosani,7121,5,3,5,6,6,14,-8,14
Concordia Ch,7121,6,3,3,8,17,22,-5,12
FCSB,7122,1,7,6,1,25,13,12,27
CFR Cluj,7122,2,6,7,1,15,8,7,25
Universitate,7122,3,4,5,5,16,20,-4,17
D Bucuresti,7122,4,4,4,6,20,22,-2,16
FC Botosani,7122,5,4,4,6,9,16,-7,16
Concordia Ch,7122,6,3,2,9,18,24,-6,11
FCSB,7123,1,8,5,1,27,14,13,29
CFR Cluj,7123,2,6,6,2,15,9,6,24
Universitate,7123,3,4,5,5,18,22,-4,17
FC Botosani,7123,4,4,4,6,7,14,-7,16
Concordia Ch,7123,5,4,2,8,19,21,-2,14
D Bucuresti,7123,6,3,4,7,17,23,-6,13
FCSB,7124,1,7,5,2,24,14,10,26
CFR Cluj,7124,2,6,7,1,14,7,7,25
FC Botosani,7124,3,5,4,5,7,12,-5,19
Universitate,7124,4,4,6,4,17,19,-2,18
D Bucuresti,7124,5,3,5,6,17,20,-3,14
Concordia Ch,7124,6,2,3,9,16,23,-7,9
FCSB,7125,1,7,6,1,24,12,12,27
CFR Cluj,7125,2,6,7,1,15,8,7,25
Universitate,7125,3,4,5,5,17,21,-4,17
D Bucuresti,7125,4,3,6,5,16,18,-2,15
FC Botosani,7125,5,3,6,5,7,14,-7,15
Concordia Ch,7125,6,2,4,8,17,23,-6,10
FCSB,7126,1,9,5,0,31,10,21,32
CFR Cluj,7126,2,6,6,2,14,9,5,24
D Bucuresti,7126,3,4,4,6,18,21,-3,16
Concordia Ch,7126,4,4,2,8,19,21,-2,14
Universitate,7126,5,3,5,6,14,25,-11,14
FC Botosani,7126,6,3,4,7,5,15,-10,13
FCSB,7127,1,9,5,0,27,12,15,32
CFR Cluj,7127,2,5,6,3,13,9,4,21
Universitate,7127,3,4,5,5,17,21,-4,17
D Bucuresti,7127,4,4,4,6,18,22,-4,16
FC Botosani,7127,5,4,4,6,7,13,-6,16
Concordia Ch,7127,6,3,2,9,19,24,-5,11
FCSB,7128,1,8,5,1,24,11,13,29
CFR Cluj,7128,2,6,7,1,14,7,7,25
D Bucuresti,7128,3,5,4,5,20,20,0,19
Universitate,7128,4,3,6,5,14,19,-5,15
FC Botosani,7128,5,3,4,7,6,16,-10,13
Concordia Ch,7128,6,3,2,9,18,23,-5,11
FCSB,7129,1,8,5,1,24,12,12,29
CFR Cluj,7129,2,5,7,2,14,9,5,22
Universitate,7129,3,4,6,4,17,19,-2,18
FC Botosani,7129,4,4,5,5,8,13,-5,17
D Bucuresti,7129,5,3,6,5,16,18,-2,15
Concordia Ch,7129,6,2,3,9,16,24,-8,9
FCSB,7130,1,8,5,1,28,14,14,29
CFR Cluj,7130,2,5,7,2,18,14,4,22
Universitate,7130,3,4,6,4,21,24,-3,18
D Bucuresti,7130,4,4,4,6,20,22,-2,16
Concordia Ch,7130,5,4,2,8,19,22,-3,14
FC Botosani,7130,6,3,4,7,6,16,-10,13
FCSB,7131,1,8,5,1,25,11,14,29
CFR Cluj,7131,2,5,6,3,13,10,3,21
Universitate,7131,3,5,5,4,16,18,-2,20
FC Botosani,7131,4,4,5,5,10,15,-5,17
D Bucuresti,7131,5,3,5,6,19,23,-4,14
Concordia Ch,7131,6,3,2,9,19,25,-6,11
FCSB,7132,1,7,6,1,24,12,12,27
CFR Cluj,7132,2,6,6,2,14,8,6,24
Universitate,7132,3,4,6,4,16,19,-3,18
D Bucuresti,7132,4,4,4,6,19,22,-3,16
FC Botosani,7132,5,3,5,6,8,16,-8,14
Concordia Ch,7132,6,3,3,8,20,24,-4,12
FCSB,7133,1,8,6,0,25,11,14,30
CFR Cluj,7133,2,6,7,1,15,8,7,25
D Bucuresti,7133,3,4,4,6,18,21,-3,16
FC Botosani,7133,4,4,4,6,8,13,-5,16
Universitate,7133,5,3,5,6,16,22,-6,14
Concordia Ch,7133,6,3,2,9,16,23,-7,11
FCSB,7134,1,8,6,0,25,10,15,30
CFR Cluj,7134,2,6,7,1,14,7,7,25
D Bucuresti,7134,3,4,5,5,18,19,-1,17
FC Botosani,7134,4,4,5,5,9,15,-6,17
Universitate,7134,5,3,5,6,14,21,-7,14
Concordia Ch,7134,6,2,2,10,17,25,-8,8
FCSB,7135,1,8,6,0,25,11,14,30
CFR Cluj,7135,2,6,6,2,17,9,8,24
D Bucuresti,7135,3,4,4,6,18,21,-3,16
FC Botosani,7135,4,4,4,6,7,14,-7,16
Universitate,7135,5,3,6,5,16,23,-7,15
Concordia Ch,7135,6,3,2,9,19,24,-5,11
FCSB,7136,1,8,6,0,28,12,16,30
CFR Cluj,7136,2,5,8,1,14,8,6,23
FC Botosani,7136,3,5,4,5,8,12,-4,19
Universitate,7136,4,3,6,5,15,22,-7,15
D Bucuresti,7136,5,3,4,7,16,22,-6,13
Concordia Ch,7136,6,3,2,9,17,22,-5,11
FCSB,7137,1,8,5,1,26,11,15,29
CFR Cluj,7137,2,6,6,2,16,11,5,24
Universitate,7137,3,4,5,5,16,21,-5,17
FC Botosani,7137,4,4,5,5,9,15,-6,17
D Bucuresti,7137,5,3,5,6,17,21,-4,14
Concordia Ch,7137,6,3,2,9,19,24,-5,11
FCSB,7138,1,9,5,0,28,11,17,32
CFR Cluj,7138,2,5,7,2,14,9,5,22
D Bucuresti,7138,3,4,5,5,18,19,-1,17
FC Botosani,7138,4,4,5,5,10,13,-3,17
Universitate,7138,5,3,6,5,16,23,-7,15
Concordia Ch,7138,6,2,2,10,15,26,-11,8
FCSB,7139,1,8,5,1,25,12,13,29
CFR Cluj,7139,2,7,6,1,17,8,9,27
FC Botosani,7139,3,5,4,5,8,12,-4,19
Universitate,7139,4,3,5,6,16,23,-7,14
D Bucuresti,7139,5,3,4,7,16,22,-6,13
Concordia Ch,7139,6,3,2,9,18,23,-5,11
FCSB,7140,1,8,5,1,26,13,13,29
CFR Cluj,7140,2,6,6,2,15,8,7,24
Universitate,7140,3,4,5,5,17,22,-5,17
FC Botosani,7140,4,4,5,5,7,13,-6,17
D Bucuresti,7140,5,3,5,6,17,20,-3,14
Concordia Ch,7140,6,3,2,9,16,22,-6,11
FCSB,7141,1,7,6,1,24,12,12,27
CFR Cluj,7141,2,5,7,2,13,8,5,22
Universitate,7141,3,5,5,4,17,19,-2,20
D Bucuresti,7141,4,5,4,5,19,19,0,19
FC Botosani,7141,5,4,4,6,6,13,-7,16
Concordia Ch,7141,6,2,2,10,16,24,-8,8
FCSB,7142,1,8,5,1,26,13,13,29
CFR Cluj,7142,2,6,6,2,15,10,5,24
D Bucuresti,7142,3,4,5,5,20,21,-1,17
Universitate,7142,4,4,5,5,17,20,-3,17
FC Botosani,7142,5,3,6,5,7,14,-7,15
Concordia Ch,7142,6,2,3,9,16,23,-7,9
FCSB,7143,1,9,5,0,29,11,18,32
CFR Cluj,7143,2,6,6,2,14,10,4,24
FC Botosani,7143,3,4,5,5,8,13,-5,17
D Bucuresti,7143,4,3,5,6,16,19,-3,14
Universitate,7143,5,3,5,6,15,22,-7,14
Concordia Ch,7143,6,3,2,9,17,24,-7,11
FCSB,7144,1,7,5,2,26,16,10,26
CFR Cluj,7144,2,6,6,2,16,10,6,24
Universitate,7144,3,5,5,4,19,20,-1,20
D Bucuresti,7144,4,5,4,5,19,18,1,19
FC Botosani,7144,5,4,4,6,6,13,-7,16
Concordia Ch,7144,6,2,2,10,15,24,-9,8
FCSB,7145,1,7,7,0,24,11,13,28
CFR Cluj,7145,2,5,8,1,14,8,6,23
D Bucuresti,7145,3,4,5,5,19,20,-1,17
Universitate,7145,4,3,7,4,16,20,-4,16
FC Botosani,7145,5,3,4,7,7,16,-9,13
Concordia Ch,7145,6,3,3,8,18,23,-5,12
FCSB,7146,1,9,5,0,25,10,15,32
CFR Cluj,7146,2,5,7,2,13,8,5,22
D Bucuresti,7146,3,5,4,5,19,19,0,19
FC Botosani,7146,4,4,4,6,8,15,-7,16
Universitate,7146,5,3,6,5,14,19,-5,15
Concordia Ch,7146,6,2,2,10,16,24,-8,8
FCSB,7147,1,9,5,0,27,11,16,32
CFR Cluj,7147,2,6,6,2,16,11,5,24
D Bucuresti,7147,3,4,5,5,18,19,-1,17
Universitate,7147,4,3,5,6,15,21,-6,14
FC Botosani,7147,5,3,4,7,5,16,-11,13
Concordia Ch,7147,6,3,3,8,19,22,-3,12
FCSB,7148,1,8,5,1,25,12,13,29
CFR Cluj,7148,2,5,7,2,13,8,5,22
Universitate,7148,3,4,6,4,16,19,-3,18
D Bucuresti,7148,4,4,4,6,19,21,-2,16
FC Botosani,7148,5,3,5,6,6,14,-8,14
Concordia Ch,7148,6,3,3,8,17,22,-5,12
FCSB,7149,1,8,5,1,25,12,13,29
CFR Cluj,7149,2,7,6,1,16,7,9,27
D Bucuresti,7149,3,4,4,6,19,20,-1,16
FC Botosani,7149,4,4,4,6,6,15,-9,16
Universitate,7149,5,3,5,6,14,21,-7,14
Concordia Ch,7149,6,3,2,9,17,22,-5,11
FCSB,7150,1,7,6,1,25,13,12,27
CFR Cluj,7150,2,5,8,1,14,8,6,23
FC Botosani,7150,3,5,4,5,10,12,-2,19
Universitate,7150,4,4,6,4,16,19,-3,18
D Bucuresti,7150,5,4,4,6,18,20,-2,16
Concordia Ch,7150,6,2,2,10,16,27,-11,8
FCSB,7151,1,8,5,1,24,13,11,29
CFR Cluj,7151,2,7,6,1,18,8,10,27
FC Botosani,7151,3,4,5,5,7,12,-5,17
Universitate,7151,4,3,5,6,15,21,-6,14
D Bucuresti,7151,5,3,4,7,16,21,-5,13
Concordia Ch,7151,6,3,3,8,16,21,-5,12
FCSB,7152,1,9,5,0,26,10,16,32
CFR Cluj,7152,2,6,6,2,15,9,6,24
FC Botosani,7152,3,4,5,5,7,13,-6,17
D Bucuresti,7152,4,3,5,6,18,22,-4,14
Universitate,7152,5,3,5,6,15,22,-7,14
Concordia Ch,7152,6,3,2,9,18,23,-5,11
FCSB,7153,1,8,5,1,26,13,13,29
CFR Cluj,7153,2,6,7,1,15,7,8,25
D Bucuresti,7153,3,5,4,5,19,19,0,19
Universitate,7153,4,3,6,5,15,21,-6,15
FC Botosani,7153,5,3,4,7,5,14,-9,13
Concordia Ch,7153,6,3,2,9,17,23,-6,11
FCSB,7154,1,7,7,0,27,14,13,28
CFR Cluj,7154,2,6,7,1,18,10,8,25
D Bucuresti,7154,3,5,4,5,20,19,1,19
Universitate,7154,4,3,6,5,17,23,-6,15
FC Botosani,7154,5,3,5,6,6,14,-8,14
Concordia Ch,7154,6,2,3,9,17,25,-8,9
CFR Cluj,7155,1,7,6,1,16,8,8,27
FCSB,7155,2,7,5,2,23,13,10,26
FC Botosani,7155,3,5,4,5,8,12,-4,19
Universitate,7155,4,4,5,5,17,20,-3,17
D Bucuresti,7155,5,4,4,6,17,20,-3,16
Concordia Ch,7155,6,2,2,10,15,23,-8,8
FCSB,7156,1,9,5,0,28,12,16,32
CFR Cluj,7156,2,6,6,2,17,10,7,24
D Bucuresti,7156,3,3,6,5,17,19,-2,15
FC Botosani,7156,4,3,6,5,5,12,-7,15
Universitate,7156,5,3,5,6,16,24,-8,14
Concordia Ch,7156,6,2,4,8,16,22,-6,10
FCSB,7157,1,7,5,2,25,15,10,26
CFR Cluj,7157,2,6,7,1,16,8,8,25
Universitate,7157,3,4,6,4,18,21,-3,18
D Bucuresti,7157,4,4,4,6,18,20,-2,16
FC Botosani,7157,5,4,4,6,9,15,-6,16
Concordia Ch,7157,6,3,2,9,17,24,-7,11
FCSB,7158,1,9,5,0,26,11,15,32
CFR Cluj,7158,2,6,6,2,14,8,6,24
D Bucuresti,7158,3,5,4,5,20,19,1,19
Universitate,7158,4,3,5,6,15,21,-6,14
FC Botosani,7158,5,3,4,7,8,17,-9,13
Concordia Ch,7158,6,3,2,9,18,25,-7,11
FCSB,7159,1,8,5,1,24,12,12,29
CFR Cluj,7159,2,7,6,1,16,7,9,27
FC Botosani,7159,3,5,4,5,10,12,-2,19
D Bucuresti,7159,4,3,5,6,17,21,-4,14
Universitate,7159,5,3,5,6,14,20,-6,14
Concordia Ch,7159,6,2,3,9,16,25,-9,9
FCSB,7160,1,7,7,0,23,10,13,28
CFR Cluj,7160,2,5,8,1,14,8,6,23
D Bucuresti,7160,3,4,4,6,18,20,-2,16
Universitate,7160,4,3,7,4,15,19,-4,16
FC Botosani,7160,5,4,4,6,8,17,-9,16
Concordia Ch,7160,6,3,2,9,19,23,-4,11
FCSB,7161,1,8,5,1,24,11,13,29
CFR Cluj,7161,2,6,6,2,14,8,6,24
D Bucuresti,7161,3,4,5,5,18,19,-1,17
Universitate,7161,4,4,5,5,15,19,-4,17
FC Botosani,7161,5,4,4,6,6,13,-7,16
Concordia Ch,7161,6,2,3,9,16,23,-7,9
FCSB,7162,1,7,6,1,25,13,12,27
CFR Cluj,7162,2,6,6,2,15,9,6,24
Universitate,7162,3,4,6,4,16,19,-3,18
FC Botosani,7162,4,4,5,5,10,14,-4,17
D Bucuresti,7162,5,3,5,6,18,22,-4,14
Concordia Ch,7162,6,3,2,9,19,26,-7,11
FCSB,7163,1,9,5,0,26,11,15,32
CFR Cluj,7163,2,6,6,2,14,8,6,24
D Bucuresti,7163,3,5,4,5,21,19,2,19
FC Botosani,7163,4,4,4,6,9,14,-5,16
Universitate,7163,5,3,5,6,15,21,-6,14
Concordia Ch,7163,6,2,2,10,16,28,-12,8
FCSB,7164,1,8,6,0,25,10,15,30
CFR Cluj,7164,2,6,6,2,15,10,5,24
D Bucuresti,7164,3,4,4,6,18,21,-3,16
Universitate,7164,4,3,6,5,15,20,-5,15
FC Botosani,7164,5,3,5,6,7,16,-9,14
Concordia Ch,7164,6,3,3,8,20,23,-3,12
FCSB,7165,1,8,5,1,24,11,13,29
CFR Cluj,7165,2,6,6,2,14,8,6,24
D Bucuresti,7165,3,5,4,5,22,19,3,19
Universitate,7165,4,4,5,5,15,19,-4,17
FC Botosani,7165,5,4,4,6,7,16,-9,16
Concordia Ch,7165,6,2,2,10,16,25,-9,8
FCSB,7166,1,9,5,0,27,11,16,32
CFR Cluj,7166,2,5,6,3,13,11,2,21
D Bucuresti,7166,3,5,4,5,22,20,2,19
Universitate,7166,4,4,5,5,18,21,-3,17
FC Botosani,7166,5,4,4,6,7,14,-7,16
Concordia Ch,7166,6,2,2,10,16,26,-10,8
FCSB,7167,1,8,5,1,25,12,13,29
CFR Cluj,7167,2,5,6,3,15,12,3,21
Universitate,7167,3,5,5,4,18,19,-1,20
FC Botosani,7167,4,4,5,5,9,15,-6,17
D Bucuresti,7167,5,4,4,6,20,21,-1,16
Concordia Ch,7167,6,2,3,9,16,24,-8,9
FCSB,7168,1,8,5,1,26,15,11,29
CFR Cluj,7168,2,7,6,1,20,8,12,27
D Bucuresti,7168,3,4,5,5,19,19,0,17
Universitate,7168,4,3,5,6,15,23,-8,14
FC Botosani,7168,5,3,5,6,7,16,-9,14
Concordia Ch,7168,6,2,4,8,16,22,-6,10
FCSB,7169,1,8,5,1,26,13,13,29
CFR Cluj,7169,2,6,6,2,16,11,5,24
D Bucuresti,7169,3,5,4,5,21,20,1,19
Universitate,7169,4,4,5,5,17,20,-3,17
FC Botosani,7169,5,3,4,7,7,17,-10,13
Concordia Ch,7169,6,3,2,9,16,22,-6,11
FCSB,7170,1,8,6,0,26,11,15,30
CFR Cluj,7170,2,6,6,2,16,10,6,24
D Bucuresti,7170,3,5,4,5,20,20,0,19
FC Botosani,7170,4,4,4,6,8,15,-7,16
Universitate,7170,5,3,6,5,14,20,-6,15
Concordia Ch,7170,6,2,2,10,15,23,-8,8
FCSB,7171,1,9,5,0,28,13,15,32
CFR Cluj,7171,2,6,6,2,16,9,7,24
FC Botosani,7171,3,5,4,5,8,12,-4,19
D Bucuresti,7171,4,4,4,6,17,20,-3,16
Universitate,7171,5,3,5,6,16,23,-7,14
Concordia Ch,7171,6,2,2,10,15,23,-8,8
FCSB,7172,1,8,5,1,25,12,13,29
CFR Cluj,7172,2,5,7,2,16,11,5,22
Universitate,7172,3,4,6,4,17,20,-3,18
D Bucuresti,7172,4,4,4,6,18,20,-2,16
FC Botosani,7172,5,4,4,6,7,13,-6,16
Concordia Ch,7172,6,3,2,9,17,24,-7,11
FCSB,7173,1,9,5,0,29,10,19,32
CFR Cluj,7173,2,5,7,2,13,11,2,22
FC Botosani,7173,3,5,4,5,8,12,-4,19
D Bucuresti,7173,4,4,4,6,18,21,-3,16
Universitate,7173,5,3,6,5,14,20,-6,15
Concordia Ch,7173,6,2,2,10,16,24,-8,8
FCSB,7174,1,9,5,0,26,11,15,32
CFR Cluj,7174,2,6,6,2,14,8,6,24
D Bucuresti,7174,3,4,5,5,20,18,2,17
FC Botosani,7174,4,4,4,6,6,16,-10,16
Universitate,7174,5,3,5,6,15,21,-6,14
Concordia Ch,7174,6,2,3,9,15,22,-7,9
FCSB,7175,1,9,5,0,28,11,17,32
CFR Cluj,7175,2,5,6,3,13,10,3,21
D Bucuresti,7175,3,5,4,5,19,19,0,19
Universitate,7175,4,4,5,5,16,21,-5,17
FC Botosani,7175,5,4,4,6,6,13,-7,16
Concordia Ch,7175,6,2,2,10,16,24,-8,8
FCSB,7176,1,9,5,0,28,11,17,32
CFR Cluj,7176,2,6,6,2,15,10,5,24
FC Botosani,7176,3,5,4,5,11,13,-2,19
D Bucuresti,7176,4,3,5,6,18,22,-4,14
Universitate,7176,5,3,5,6,14,21,-7,14
Concordia Ch,7176,6,2,3,9,16,25,-9,9
FCSB,7177,1,7,5,2,24,14,10,26
CFR Cluj,7177,2,6,7,1,17,9,8,25
FC Botosani,7177,3,5,4,5,8,13,-5,19
Universitate,7177,4,4,6,4,16,19,-3,18
D Bucuresti,7177,5,3,4,7,18,22,-4,13
Concordia Ch,7177,6,3,2,9,17,23,-6,11
FCSB,7178,1,8,5,1,24,11,13,29
CFR Cluj,7178,2,6,6,2,14,9,5,24
FC Botosani,7178,3,5,4,5,9,14,-5,19
Universitate,7178,4,4,5,5,16,19,-3,17
D Bucuresti,7178,5,4,4,6,20,22,-2,16
Concordia Ch,7178,6,2,2,10,16,24,-8,8
FCSB,7179,1,7,6,1,25,14,11,27
CFR Cluj,7179,2,5,8,1,15,9,6,23
Universitate,7179,3,4,6,4,16,18,-2,18
FC Botosani,7179,4,4,5,5,7,12,-5,17
D Bucuresti,7179,5,3,5,6,17,20,-3,14
Concordia Ch,7179,6,3,2,9,17,24,-7,11
FCSB,7180,1,8,6,0,26,11,15,30
CFR Cluj,7180,2,5,6,3,13,10,3,21
Universitate,7180,3,4,6,4,16,19,-3,18
D Bucuresti,7180,4,4,5,5,20,20,0,17
FC Botosani,7180,5,3,6,5,8,15,-7,15
Concordia Ch,7180,6,2,3,9,16,24,-8,9
FCSB,7181,1,8,5,1,26,13,13,29
CFR Cluj,7181,2,6,7,1,15,8,7,25
FC Botosani,7181,3,4,5,5,7,13,-6,17
Universitate,7181,4,3,6,5,15,20,-5,15
D Bucuresti,7181,5,3,5,6,17,20,-3,14
Concordia Ch,7181,6,3,2,9,18,24,-6,11
FCSB,7182,1,7,5,2,24,14,10,26
CFR Cluj,7182,2,6,6,2,15,9,6,24
Universitate,7182,3,5,5,4,17,18,-1,20
D Bucuresti,7182,4,5,4,5,19,18,1,19
FC Botosani,7182,5,4,4,6,7,14,-7,16
Concordia Ch,7182,6,2,2,10,15,24,-9,8
FCSB,7183,1,8,5,1,25,12,13,29
CFR Cluj,7183,2,7,6,1,17,9,8,27
D Bucuresti,7183,3,4,4,6,19,23,-4,16
Universitate,7183,4,3,5,6,15,21,-6,14
FC Botosani,7183,5,3,5,6,8,16,-8,14
Concordia Ch,7183,6,3,3,8,19,22,-3,12
FCSB,7184,1,7,7,0,24,11,13,28
CFR Cluj,7184,2,6,7,1,15,7,8,25
D Bucuresti,7184,3,4,5,5,22,23,-1,17
FC Botosani,7184,4,4,5,5,9,15,-6,17
Universitate,7184,5,3,6,5,15,21,-6,15
Concordia Ch,7184,6,2,2,10,17,25,-8,8
FCSB,7185,1,8,6,0,26,11,15,30
CFR Cluj,7185,2,6,7,1,20,9,11,25
FC Botosani,7185,3,4,5,5,8,14,-6,17
D Bucuresti,7185,4,4,4,6,20,22,-2,16
Universitate,7185,5,3,5,6,15,26,-11,14
Concordia Ch,7185,6,2,3,9,16,23,-7,9
FCSB,7186,1,8,6,0,26,11,15,30
CFR Cluj,7186,2,5,7,2,16,11,5,22
Universitate,7186,3,4,5,5,17,22,-5,17
D Bucuresti,7186,4,4,4,6,20,21,-1,16
FC Botosani,7186,5,4,4,6,7,16,-9,16
Concordia Ch,7186,6,3,2,9,19,24,-5,11
FCSB,7187,1,9,5,0,28,12,16,32
CFR Cluj,7187,2,5,6,3,14,14,0,21
Universitate,7187,3,4,5,5,20,21,-1,17
D Bucuresti,7187,4,4,5,5,19,20,-1,17
FC Botosani,7187,5,4,5,5,8,14,-6,17
Concordia Ch,7187,6,2,2,10,15,23,-8,8
FCSB,7188,1,8,5,1,26,13,13,29
CFR Cluj,7188,2,6,7,1,15,8,7,25
Universitate,7188,3,3,6,5,15,20,-5,15
Concordia Ch,7188,4,4,2,8,18,21,-3,14
D Bucuresti,7188,5,3,5,6,16,19,-3,14
FC Botosani,7188,6,3,5,6,5,14,-9,14
FCSB,7189,1,9,5,0,25,10,15,32
CFR Cluj,7189,2,5,6,3,13,9,4,21
D Bucuresti,7189,3,4,5,5,19,20,-1,17
Universitate,7189,4,4,5,5,15,19,-4,17
FC Botosani,7189,5,4,4,6,9,15,-6,16
Concordia Ch,7189,6,2,3,9,17,25,-8,9
CFR Cluj,7190,1,7,6,1,15,7,8,27
FCSB,7190,2,7,5,2,23,12,11,26
Universitate,7190,3,4,5,5,15,19,-4,17
FC Botosani,7190,4,4,5,5,7,13,-6,17
D Bucuresti,7190,5,3,5,6,17,21,-4,14
Concordia Ch,7190,6,3,2,9,17,22,-5,11
FCSB,7191,1,8,5,1,25,12,13,29
CFR Cluj,7191,2,7,6,1,16,7,9,27
D Bucuresti,7191,3,4,4,6,19,23,-4,16
Universitate,7191,4,3,5,6,14,21,-7,14
FC Botosani,7191,5,3,5,6,7,15,-8,14
Concordia Ch,7191,6,3,3,8,20,23,-3,12
FCSB,7192,1,8,5,1,26,15,11,29
CFR Cluj,7192,2,5,7,2,14,9,5,22
Universitate,7192,3,4,6,4,20,21,-1,18
FC Botosani,7192,4,4,4,6,9,14,-5,16
Concordia Ch,7192,5,4,2,8,19,21,-2,14
D Bucuresti,7192,6,3,4,7,17,25,-8,13
FCSB,7193,1,7,6,1,24,13,11,27
CFR Cluj,7193,2,5,7,2,15,11,4,22
Universitate,7193,3,5,5,4,19,19,0,20
D Bucuresti,7193,4,4,5,5,20,21,-1,17
FC Botosani,7193,5,3,4,7,7,16,-9,13
Concordia Ch,7193,6,3,3,8,19,24,-5,12
FCSB,7194,1,8,5,1,25,12,13,29
CFR Cluj,7194,2,6,7,1,15,8,7,25
FC Botosani,7194,3,4,5,5,6,12,-6,17
Universitate,7194,4,3,6,5,16,21,-5,15
D Bucuresti,7194,5,3,4,7,16,20,-4,13
Concordia Ch,7194,6,3,3,8,16,21,-5,12
FCSB,7195,1,8,6,0,28,13,15,30
CFR Cluj,7195,2,6,6,2,18,13,5,24
D Bucuresti,7195,3,4,4,6,18,21,-3,16
Universitate,7195,4,3,6,5,19,24,-5,15
Concordia Ch,7195,5,4,2,8,20,22,-2,14
FC Botosani,7195,6,3,4,7,7,17,-10,13
FCSB,7196,1,8,6,0,27,12,15,30
CFR Cluj,7196,2,5,8,1,14,8,6,23
D Bucuresti,7196,3,4,5,5,19,20,-1,17
Universitate,7196,4,3,6,5,15,21,-6,15
FC Botosani,7196,5,3,5,6,7,15,-8,14
Concordia Ch,7196,6,2,4,8,17,23,-6,10
FCSB,7197,1,8,5,1,25,13,12,29
CFR Cluj,7197,2,7,6,1,18,8,10,27
D Bucuresti,7197,3,5,4,5,20,18,2,19
Universitate,7197,4,3,5,6,14,21,-7,14
FC Botosani,7197,5,3,4,7,6,17,-11,13
Concordia Ch,7197,6,3,2,9,18,24,-6,11
FCSB,7198,1,9,5,0,27,11,16,32
CFR Cluj,7198,2,5,7,2,15,10,5,22
FC Botosani,7198,3,5,4,5,10,14,-4,19
Universitate,7198,4,3,6,5,17,23,-6,15
D Bucuresti,7198,5,3,4,7,17,23,-6,13
Concordia Ch,7198,6,3,2,9,19,24,-5,11
CFR Cluj,7199,1,7,6,1,15,7,8,27
FCSB,7199,2,7,5,2,24,13,11,26
D Bucuresti,7199,3,4,5,5,19,20,-1,17
Universitate,7199,4,4,5,5,16,20,-4,17
FC Botosani,7199,5,4,4,6,6,13,-7,16
Concordia Ch,7199,6,2,3,9,17,24,-7,9
FCSB,7200,1,7,6,1,24,13,11,27
CFR Cluj,7200,2,5,8,1,13,7,6,23
Universitate,7200,3,4,6,4,17,19,-2,18
D Bucuresti,7200,4,3,6,5,17,19,-2,15
FC Botosani,7200,5,3,6,5,7,14,-7,15
Concordia Ch,7200,6,2,4,8,18,24,-6,10
FCSB,7201,1,8,6,0,24,10,14,30
CFR Cluj,7201,2,5,8,1,14,8,6,23
D Bucuresti,7201,3,4,4,6,19,24,-5,16
Universitate,7201,4,3,6,5,15,20,-5,15
Concordia Ch,7201,5,4,2,8,24,23,1,14
FC Botosani,7201,6,3,4,7,6,17,-11,13
FCSB,7202,1,8,5,1,26,14,12,29
CFR Cluj,7202,2,6,7,1,15,7,8,25
FC Botosani,7202,3,4,5,5,7,13,-6,17
D Bucuresti,7202,4,3,6,5,17,19,-2,15
Universitate,7202,5,3,6,5,16,21,-5,15
Concordia Ch,7202,6,2,3,9,15,22,-7,9
FCSB,7203,1,8,6,0,26,12,14,30
CFR Cluj,7203,2,5,7,2,14,9,5,22
Universitate,7203,3,3,7,4,17,21,-4,16
D Bucuresti,7203,4,3,6,5,18,20,-2,15
FC Botosani,7203,5,3,6,5,5,12,-7,15
Concordia Ch,7203,6,2,4,8,17,23,-6,10
FCSB,7204,1,7,6,1,27,16,11,27
CFR Cluj,7204,2,6,7,1,19,10,9,25
Universitate,7204,3,4,5,5,19,24,-5,17
D Bucuresti,7204,4,4,4,6,19,19,0,16
Concordia Ch,7204,5,4,2,8,17,21,-4,14
FC Botosani,7204,6,3,4,7,5,16,-11,13
FCSB,7205,1,8,6,0,26,12,14,30
CFR Cluj,7205,2,5,6,3,13,10,3,21
Universitate,7205,3,4,6,4,18,20,-2,18
D Bucuresti,7205,4,4,4,6,19,20,-1,16
FC Botosani,7205,5,3,5,6,5,15,-10,14
Concordia Ch,7205,6,3,3,8,17,21,-4,12
FCSB,7206,1,7,5,2,24,13,11,26
CFR Cluj,7206,2,6,7,1,16,9,7,25
Universitate,7206,3,4,6,4,16,19,-3,18
D Bucuresti,7206,4,3,6,5,18,20,-2,15
FC Botosani,7206,5,3,6,5,6,13,-7,15
Concordia Ch,7206,6,2,4,8,18,24,-6,10
FCSB,7207,1,9,5,0,27,11,16,32
CFR Cluj,7207,2,6,6,2,15,8,7,24
D Bucuresti,7207,3,3,6,5,17,19,-2,15
FC Botosani,7207,4,3,6,5,5,12,-7,15
Universitate,7207,5,3,5,6,15,23,-8,14
Concordia Ch,7207,6,2,4,8,16,22,-6,10
FCSB,7208,1,7,5,2,25,15,10,26
CFR Cluj,7208,2,6,7,1,17,10,7,25
Universitate,7208,3,4,6,4,19,21,-2,18
FC Botosani,7208,4,4,5,5,6,12,-6,17
D Bucuresti,7208,5,3,5,6,17,22,-5,14
Concordia Ch,7208,6,3,2,9,19,23,-4,11
FCSB,7209,1,8,6,0,25,11,14,30
CFR Cluj,7209,2,5,7,2,13,8,5,22
FC Botosani,7209,3,4,5,5,8,13,-5,17
Universitate,7209,4,3,7,4,15,19,-4,16
D Bucuresti,7209,5,3,5,6,17,20,-3,14
Concordia Ch,7209,6,3,2,9,16,23,-7,11
FCSB,7210,1,8,5,1,26,14,12,29
CFR Cluj,7210,2,5,7,2,15,11,4,22
Universitate,7210,3,4,6,4,18,19,-1,18
D Bucuresti,7210,4,4,4,6,19,20,-1,16
FC Botosani,7210,5,3,5,6,5,15,-10,14
Concordia Ch,7210,6,3,3,8,17,21,-4,12
FCSB,7211,1,9,5,0,27,11,16,32
CFR Cluj,7211,2,5,7,2,15,10,5,22
FC Botosani,7211,3,4,5,5,7,13,-6,17
D Bucuresti,7211,4,3,6,5,16,18,-2,15
Universitate,7211,5,3,6,5,15,21,-6,15
Concordia Ch,7211,6,2,3,9,16,23,-7,9
FCSB,7212,1,8,5,1,26,12,14,29
CFR Cluj,7212,2,6,6,2,14,10,4,24
D Bucuresti,7212,3,4,5,5,19,19,0,17
Universitate,7212,4,4,5,5,16,19,-3,17
FC Botosani,7212,5,3,5,6,5,14,-9,14
Concordia Ch,7212,6,2,4,8,16,22,-6,10
FCSB,7213,1,7,7,0,25,12,13,28
CFR Cluj,7213,2,5,8,1,16,10,6,23
D Bucuresti,7213,3,5,4,5,18,18,0,19
Universitate,7213,4,3,7,4,15,19,-4,16
FC Botosani,7213,5,4,4,6,8,13,-5,16
Concordia Ch,7213,6,2,2,10,15,25,-10,8
FCSB,7214,1,9,5,0,27,12,15,32
CFR Cluj,7214,2,6,6,2,15,9,6,24
D Bucuresti,7214,3,3,5,6,16,19,-3,14
Concordia Ch,7214,4,4,2,8,18,22,-4,14
Universitate,7214,5,3,5,6,15,21,-6,14
FC Botosani,7214,6,3,5,6,6,14,-8,14
FCSB,7215,1,7,6,1,27,16,11,27
CFR Cluj,7215,2,5,7,2,13,8,5,22
Universitate,7215,3,5,5,4,21,22,-1,20
Concordia Ch,7215,4,4,2,8,19,22,-3,14
D Bucuresti,7215,5,3,5,6,17,20,-3,14
FC Botosani,7215,6,3,5,6,5,14,-9,14
FCSB,7216,1,7,6,1,25,15,10,27
CFR Cluj,7216,2,5,7,2,14,11,3,22
Universitate,7216,3,5,5,4,21,19,2,20
FC Botosani,7216,4,3,6,5,6,13,-7,15
D Bucuresti,7216,5,3,5,6,16,20,-4,14
Concordia Ch,7216,6,3,3,8,18,22,-4,12
FCSB,7217,1,8,6,0,25,11,14,30
CFR Cluj,7217,2,5,7,2,13,8,5,22
FC Botosani,7217,3,5,4,5,9,13,-4,19
Universitate,7217,4,3,7,4,15,19,-4,16
D Bucuresti,7217,5,3,4,7,18,23,-5,13
Concordia Ch,7217,6,3,2,9,18,24,-6,11
FCSB,7218,1,8,5,1,25,11,14,29
CFR Cluj,7218,2,7,6,1,15,7,8,27
FC Botosani,7218,3,5,4,5,8,12,-4,19
Universitate,7218,4,3,5,6,14,21,-7,14
D Bucuresti,7218,5,3,4,7,16,23,-7,13
Concordia Ch,7218,6,3,2,9,18,22,-4,11
FCSB,7219,1,8,5,1,25,12,13,29
CFR Cluj,7219,2,6,6,2,14,8,6,24
Universitate,7219,3,4,5,5,16,20,-4,17
D Bucuresti,7219,4,4,4,6,20,21,-1,16
Concordia Ch,7219,5,4,2,8,19,23,-4,14
FC Botosani,7219,6,3,4,7,7,17,-10,13
FCSB,7220,1,8,6,0,24,10,14,30
CFR Cluj,7220,2,5,7,2,13,8,5,22
FC Botosani,7220,3,4,5,5,8,13,-5,17
Universitate,7220,4,3,7,4,14,18,-4,16
D Bucuresti,7220,5,3,6,5,17,19,-2,15
Concordia Ch,7220,6,2,3,9,17,25,-8,9
FCSB,7221,1,8,5,1,26,16,10,29
CFR Cluj,7221,2,6,6,2,15,10,5,24
Universitate,7221,3,4,5,5,19,19,0,17
D Bucuresti,7221,4,4,5,5,17,18,-1,17
FC Botosani,7221,5,3,4,7,5,15,-10,13
Concordia Ch,7221,6,3,3,8,17,21,-4,12
FCSB,7222,1,8,6,0,26,12,14,30
CFR Cluj,7222,2,6,6,2,15,8,7,24
FC Botosani,7222,3,4,5,5,7,13,-6,17
Universitate,7222,4,3,6,5,16,22,-6,15
D Bucuresti,7222,5,3,5,6,19,22,-3,14
Concordia Ch,7222,6,3,2,9,18,24,-6,11
FCSB,7223,1,9,5,0,26,11,15,32
CFR Cluj,7223,2,5,6,3,14,11,3,21
Universitate,7223,3,4,5,5,16,19,-3,17
D Bucuresti,7223,4,4,4,6,17,19,-2,16
FC Botosani,7223,5,4,4,6,9,13,-4,16
Concordia Ch,7223,6,3,2,9,16,25,-9,11
FCSB,7224,1,7,7,0,23,10,13,28
CFR Cluj,7224,2,5,8,1,16,10,6,23
FC Botosani,7224,3,5,4,5,10,12,-2,19
Universitate,7224,4,3,7,4,17,21,-4,16
D Bucuresti,7224,5,3,4,7,16,21,-5,13
Concordia Ch,7224,6,3,2,9,16,24,-8,11
FCSB,7225,1,8,6,0,25,11,14,30
CFR Cluj,7225,2,5,7,2,13,8,5,22
Universitate,7225,3,3,7,4,15,19,-4,16
D Bucuresti,7225,4,3,6,5,20,22,-2,15
FC Botosani,7225,5,3,6,5,8,15,-7,15
Concordia Ch,7225,6,2,4,8,18,24,-6,10
FCSB,7226,1,8,6,0,25,11,14,30
CFR Cluj,7226,2,6,7,1,14,7,7,25
D Bucuresti,7226,3,5,4,5,21,20,1,19
FC Botosani,7226,4,4,4,6,7,13,-6,16
Universitate,7226,5,3,5,6,15,21,-6,14
Concordia Ch,7226,6,2,2,10,17,27,-10,8
FCSB,7227,1,8,5,1,24,11,13,29
CFR Cluj,7227,2,7,6,1,16,8,8,27
FC Botosani,7227,3,4,5,5,7,12,-5,17
D Bucuresti,7227,4,3,5,6,17,20,-3,14
Universitate,7227,5,3,5,6,15,21,-6,14
Concordia Ch,7227,6,3,2,9,17,24,-7,11
FCSB,7228,1,8,5,1,26,15,11,29
CFR Cluj,7228,2,5,6,3,13,10,3,21
Universitate,7228,3,5,5,4,21,20,1,20
D Bucuresti,7228,4,4,4,6,20,21,-1,16
FC Botosani,7228,5,4,4,6,6,14,-8,16
Concordia Ch,7228,6,3,2,9,18,24,-6,11
FCSB,7229,1,8,5,1,25,11,14,29
CFR Cluj,7229,2,5,6,3,14,11,3,21
Universitate,7229,3,5,5,4,17,19,-2,20
FC Botosani,7229,4,5,4,5,10,13,-3,19
D Bucuresti,7229,5,4,4,6,19,20,-1,16
Concordia Ch,7229,6,2,2,10,17,28,-11,8
FCSB,7230,1,8,6,0,25,11,14,30
CFR Cluj,7230,2,5,7,2,15,10,5,22
Universitate,7230,3,3,7,4,17,21,-4,16
FC Botosani,7230,4,4,4,6,8,15,-7,16
D Bucuresti,7230,5,3,5,6,18,22,-4,14
Concordia Ch,7230,6,3,3,8,18,22,-4,12
FCSB,7231,1,7,6,1,25,13,12,27
CFR Cluj,7231,2,7,6,1,16,8,8,27
FC Botosani,7231,3,4,5,5,9,13,-4,17
D Bucuresti,7231,4,4,4,6,21,22,-1,16
Universitate,7231,5,3,6,5,15,20,-5,15
Concordia Ch,7231,6,2,3,9,17,27,-10,9
FCSB,7232,1,8,6,0,26,10,16,30
CFR Cluj,7232,2,6,7,1,15,7,8,25
FC Botosani,7232,3,3,6,5,6,13,-7,15
D Bucuresti,7232,4,3,5,6,16,20,-4,14
Universitate,7232,5,3,5,6,14,23,-9,14
Concordia Ch,7232,6,3,3,8,18,22,-4,12
FCSB,7233,1,8,6,0,29,12,17,30
CFR Cluj,7233,2,6,6,2,18,14,4,24
D Bucuresti,7233,3,5,4,5,20,19,1,19
Universitate,7233,4,3,6,5,17,23,-6,15
FC Botosani,7233,5,3,5,6,7,16,-9,14
Concordia Ch,7233,6,2,3,9,18,25,-7,9
FCSB,7234,1,8,5,1,25,13,12,29
CFR Cluj,7234,2,6,6,2,15,8,7,24
Universitate,7234,3,4,5,5,16,20,-4,17
FC Botosani,7234,4,4,5,5,7,12,-5,17
D Bucuresti,7234,5,3,6,5,18,20,-2,15
Concordia Ch,7234,6,2,3,9,17,25,-8,9
FCSB,7235,1,8,5,1,26,12,14,29
CFR Cluj,7235,2,5,7,2,16,12,4,22
D Bucuresti,7235,3,5,4,5,20,20,0,19
Universitate,7235,4,4,6,4,17,20,-3,18
FC Botosani,7235,5,3,4,7,7,16,-9,13
Concordia Ch,7235,6,3,2,9,18,24,-6,11
FCSB,7236,1,8,6,0,25,11,14,30
CFR Cluj,7236,2,6,6,2,17,11,6,24
D Bucuresti,7236,3,3,6,5,17,19,-2,15
Universitate,7236,4,3,6,5,16,21,-5,15
FC Botosani,7236,5,3,5,6,6,15,-9,14
Concordia Ch,7236,6,3,3,8,17,21,-4,12
FCSB,7237,1,9,5,0,27,12,15,32
CFR Cluj,7237,2,5,6,3,16,12,4,21
Universitate,7237,3,4,5,5,16,20,-4,17
FC Botosani,7237,4,4,4,6,7,13,-6,16
Concordia Ch,7237,5,4,2,8,19,21,-2,14
D Bucuresti,7237,6,3,4,7,16,23,-7,13
FCSB,7238,1,9,5,0,31,13,18,32
CFR Cluj,7238,2,5,7,2,16,11,5,22
D Bucuresti,7238,3,4,4,6,17,19,-2,16
Universitate,7238,4,3,6,5,14,22,-8,15
FC Botosani,7238,5,3,5,6,6,14,-8,14
Concordia Ch,7238,6,3,3,8,17,22,-5,12
FCSB,7239,1,8,6,0,25,11,14,30
CFR Cluj,7239,2,5,8,1,15,9,6,23
D Bucuresti,7239,3,4,4,6,19,22,-3,16
Universitate,7239,4,3,6,5,15,20,-5,15
FC Botosani,7239,5,3,5,6,6,15,-9,14
Concordia Ch,7239,6,3,3,8,20,23,-3,12
FCSB,7240,1,7,6,1,24,12,12,27
CFR Cluj,7240,2,7,6,1,16,7,9,27
FC Botosani,7240,3,5,4,5,9,12,-3,19
D Bucuresti,7240,4,4,4,6,18,20,-2,16
Universitate,7240,5,3,6,5,15,21,-6,15
Concordia Ch,7240,6,2,2,10,16,26,-10,8
FCSB,7241,1,8,5,1,24,12,12,29
CFR Cluj,7241,2,6,7,1,16,8,8,25
D Bucuresti,7241,3,4,4,6,18,21,-3,16
Universitate,7241,4,3,6,5,15,20,-5,15
FC Botosani,7241,5,3,5,6,8,16,-8,14
Concordia Ch,7241,6,3,3,8,19,23,-4,12
FCSB,7242,1,8,5,1,25,12,13,29
CFR Cluj,7242,2,7,6,1,15,7,8,27
D Bucuresti,7242,3,5,4,5,20,19,1,19
Universitate,7242,4,3,5,6,15,21,-6,14
FC Botosani,7242,5,3,5,6,7,16,-9,14
Concordia Ch,7242,6,2,3,9,16,23,-7,9
FCSB,7243,1,7,6,1,23,11,12,27
CFR Cluj,7243,2,7,6,1,16,7,9,27
D Bucuresti,7243,3,4,4,6,20,19,1,16
FC Botosani,7243,4,4,4,6,7,16,-9,16
Universitate,7243,5,3,6,5,14,20,-6,15
Concordia Ch,7243,6,3,2,9,16,23,-7,11
FCSB,7244,1,9,5,0,28,11,17,32
CFR Cluj,7244,2,6,6,2,16,11,5,24
FC Botosani,7244,3,3,6,5,8,15,-7,15
D Bucuresti,7244,4,3,5,6,18,21,-3,14
Universitate,7244,5,3,5,6,14,21,-7,14
Concordia Ch,7244,6,3,3,8,19,24,-5,12
FCSB,7245,1,9,5,0,26,11,15,32
CFR Cluj,7245,2,5,7,2,14,9,5,22
FC Botosani,7245,3,4,5,5,9,15,-6,17
D Bucuresti,7245,4,3,6,5,19,21,-2,15
Universitate,7245,5,3,6,5,16,21,-5,15
Concordia Ch,7245,6,2,3,9,17,24,-7,9
FCSB,7246,1,7,7,0,24,11,13,28
CFR Cluj,7246,2,6,7,1,16,8,8,25
Universitate,7246,3,3,6,5,14,20,-6,15
D Bucuresti,7246,4,3,5,6,17,20,-3,14
Concordia Ch,7246,5,4,2,8,17,21,-4,14
FC Botosani,7246,6,3,5,6,6,14,-8,14
FCSB,7247,1,8,6,0,26,10,16,30
CFR Cluj,7247,2,5,7,2,13,8,5,22
D Bucuresti,7247,3,4,5,5,17,18,-1,17
Universitate,7247,4,4,5,5,15,21,-6,17
FC Botosani,7247,5,3,6,5,5,12,-7,15
Concordia Ch,7247,6,2,3,9,15,22,-7,9
FCSB,7248,1,9,5,0,27,10,17,32
CFR Cluj,7248,2,6,6,2,14,8,6,24
D Bucuresti,7248,3,4,5,5,21,21,0,17
Universitate,7248,4,3,5,6,14,22,-8,14
FC Botosani,7248,5,3,5,6,7,16,-9,14
Concordia Ch,7248,6,2,4,8,16,22,-6,10
FCSB,7249,1,7,5,2,23,12,11,26
CFR Cluj,7249,2,6,7,1,14,7,7,25
Universitate,7249,3,4,6,4,15,18,-3,18
D Bucuresti,7249,4,4,5,5,18,19,-1,17
FC Botosani,7249,5,4,5,5,7,13,-6,17
Concordia Ch,7249,6,2,2,10,17,25,-8,8
FCSB,7250,1,8,5,1,26,13,13,29
CFR Cluj,7250,2,5,7,2,14,9,5,22
Universitate,7250,3,4,6,4,16,19,-3,18
FC Botosani,7250,4,4,5,5,7,13,-6,17
D Bucuresti,7250,5,3,5,6,17,20,-3,14
Concordia Ch,7250,6,2,4,8,17,23,-6,10
FCSB,7251,1,8,5,1,26,13,13,29
CFR Cluj,7251,2,6,6,2,14,9,5,24
Universitate,7251,3,4,5,5,17,20,-3,17
D Bucuresti,7251,4,4,4,6,19,19,0,16
Concordia Ch,7251,5,4,2,8,18,22,-4,14
FC Botosani,7251,6,3,4,7,6,17,-11,13
FCSB,7252,1,7,6,1,25,13,12,27
CFR Cluj,7252,2,6,7,1,17,9,8,25
Universitate,7252,3,4,5,5,15,20,-5,17
D Bucuresti,7252,4,4,4,6,17,19,-2,16
FC Botosani,7252,5,4,4,6,7,14,-7,16
Concordia Ch,7252,6,3,2,9,17,23,-6,11
FCSB,7253,1,8,6,0,26,12,14,30
CFR Cluj,7253,2,5,6,3,15,14,1,21
Universitate,7253,3,4,6,4,20,20,0,18
D Bucuresti,7253,4,4,5,5,17,18,-1,17
FC Botosani,7253,5,4,5,5,8,14,-6,17
Concordia Ch,7253,6,2,2,10,17,25,-8,8
FCSB,7254,1,7,6,1,24,14,10,27
CFR Cluj,7254,2,6,7,1,15,8,7,25
D Bucuresti,7254,3,4,5,5,19,20,-1,17
Universitate,7254,4,4,5,5,17,19,-2,17
FC Botosani,7254,5,3,5,6,7,15,-8,14
Concordia Ch,7254,6,2,4,8,19,25,-6,10
FCSB,7255,1,8,5,1,26,12,14,29
CFR Cluj,7255,2,7,6,1,16,8,8,27
D Bucuresti,7255,3,4,5,5,21,20,1,17
Universitate,7255,4,3,5,6,16,23,-7,14
FC Botosani,7255,5,3,5,6,6,16,-10,14
Concordia Ch,7255,6,2,4,8,16,22,-6,10
FCSB,7256,1,8,6,0,31,13,18,30
CFR Cluj,7256,2,6,6,2,16,13,3,24
D Bucuresti,7256,3,4,5,5,23,22,1,17
Universitate,7256,4,3,6,5,16,22,-6,15
FC Botosani,7256,5,3,5,6,6,16,-10,14
Concordia Ch,7256,6,2,4,8,18,24,-6,10
FCSB,7257,1,8,6,0,25,11,14,30
CFR Cluj,7257,2,5,8,1,14,8,6,23
FC Botosani,7257,3,4,5,5,10,16,-6,17
Universitate,7257,4,3,6,5,16,21,-5,15
D Bucuresti,7257,5,3,4,7,19,23,-4,13
Concordia Ch,7257,6,3,3,8,19,24,-5,12
FCSB,7258,1,9,5,0,27,11,16,32
CFR Cluj,7258,2,6,6,2,17,9,8,24
D Bucuresti,7258,3,4,4,6,18,23,-5,16
Concordia Ch,7258,4,4,2,8,23,22,1,14
Universitate,7258,5,3,5,6,14,23,-9,14
FC Botosani,7258,6,3,4,7,5,16,-11,13
FCSB,7259,1,8,5,1,24,11,13,29
CFR Cluj,7259,2,5,6,3,13,9,4,21
Universitate,7259,3,5,5,4,16,18,-2,20
D Bucuresti,7259,4,4,4,6,21,21,0,16
FC Botosani,7259,5,4,4,6,8,17,-9,16
Concordia Ch,7259,6,3,2,9,19,25,-6,11
FCSB,7260,1,8,6,0,27,12,15,30
CFR Cluj,7260,2,6,6,2,16,10,6,24
FC Botosani,7260,3,4,5,5,9,15,-6,17
D Bucuresti,7260,4,3,6,5,17,19,-2,15
Universitate,7260,5,3,6,5,15,21,-6,15
Concordia Ch,7260,6,2,3,9,17,24,-7,9
FCSB,7261,1,8,6,0,27,13,14,30
CFR Cluj,7261,2,5,6,3,14,12,2,21
D Bucuresti,7261,3,5,4,5,20,19,1,19
Universitate,7261,4,4,6,4,19,20,-1,18
FC Botosani,7261,5,3,4,7,6,15,-9,13
Concordia Ch,7261,6,3,2,9,16,23,-7,11
FCSB,7262,1,7,6,1,27,16,11,27
CFR Cluj,7262,2,6,7,1,17,9,8,25
Universitate,7262,3,4,5,5,18,22,-4,17
D Bucuresti,7262,4,4,4,6,20,20,0,16
Concordia Ch,7262,5,4,2,8,18,22,-4,14
FC Botosani,7262,6,3,4,7,5,16,-11,13
FCSB,7263,1,8,5,1,24,13,11,29
CFR Cluj,7263,2,5,7,2,13,8,5,22
Universitate,7263,3,4,6,4,17,18,-1,18
FC Botosani,7263,4,4,5,5,9,15,-6,17
D Bucuresti,7263,5,3,5,6,17,20,-3,14
Concordia Ch,7263,6,3,2,9,18,24,-6,11
FCSB,7264,1,8,5,1,28,15,13,29
CFR Cluj,7264,2,6,6,2,16,11,5,24
D Bucuresti,7264,3,4,5,5,20,21,-1,17
Universitate,7264,4,4,5,5,17,20,-3,17
FC Botosani,7264,5,4,5,5,8,13,-5,17
Concordia Ch,7264,6,2,2,10,17,26,-9,8
FCSB,7265,1,9,5,0,29,12,17,32
CFR Cluj,7265,2,5,7,2,14,11,3,22
D Bucuresti,7265,3,4,5,5,19,20,-1,17
Universitate,7265,4,3,6,5,17,22,-5,15
FC Botosani,7265,5,3,4,7,7,17,-10,13
Concordia Ch,7265,6,3,3,8,21,25,-4,12
FCSB,7266,1,7,7,0,25,12,13,28
CFR Cluj,7266,2,6,7,1,16,8,8,25
D Bucuresti,7266,3,5,4,5,20,18,2,19
Universitate,7266,4,3,6,5,15,21,-6,15
FC Botosani,7266,5,3,5,6,5,13,-8,14
Concordia Ch,7266,6,2,3,9,15,24,-9,9
FCSB,7267,1,8,6,0,25,10,15,30
CFR Cluj,7267,2,5,7,2,13,8,5,22
D Bucuresti,7267,3,4,5,5,18,19,-1,17
Universitate,7267,4,4,5,5,15,20,-5,17
FC Botosani,7267,5,3,5,6,5,14,-9,14
Concordia Ch,7267,6,3,2,9,18,23,-5,11
FCSB,7268,1,8,5,1,26,13,13,29
CFR Cluj,7268,2,6,6,2,14,8,6,24
D Bucuresti,7268,3,4,5,5,17,18,-1,17
Universitate,7268,4,4,5,5,17,21,-4,17
FC Botosani,7268,5,3,6,5,5,12,-7,15
Concordia Ch,7268,6,2,3,9,15,22,-7,9
FCSB,7269,1,7,6,1,24,12,12,27
CFR Cluj,7269,2,6,7,1,14,7,7,25
D Bucuresti,7269,3,4,5,5,20,21,-1,17
Universitate,7269,4,4,5,5,16,20,-4,17
FC Botosani,7269,5,3,6,5,6,13,-7,15
Concordia Ch,7269,6,2,3,9,17,24,-7,9
FCSB,7270,1,8,6,0,26,12,14,30
CFR Cluj,7270,2,5,8,1,15,9,6,23
D Bucuresti,7270,3,4,5,5,18,19,-1,17
FC Botosani,7270,4,4,5,5,9,13,-4,17
Universitate,7270,5,3,6,5,14,19,-5,15
Concordia Ch,7270,6,2,2,10,15,25,-10,8
FCSB,7271,1,8,6,0,25,11,14,30
CFR Cluj,7271,2,6,6,2,17,8,9,24
D Bucuresti,7271,3,4,4,6,18,19,-1,16
Universitate,7271,4,3,6,5,15,23,-8,15
FC Botosani,7271,5,3,5,6,6,15,-9,14
Concordia Ch,7271,6,3,3,8,17,22,-5,12
FCSB,7272,1,8,5,1,25,11,14,29
CFR Cluj,7272,2,5,7,2,13,9,4,22
Universitate,7272,3,4,6,4,15,18,-3,18
D Bucuresti,7272,4,4,5,5,17,18,-1,17
FC Botosani,7272,5,3,4,7,5,14,-9,13
Concordia Ch,7272,6,3,3,8,16,21,-5,12
FCSB,7273,1,7,7,0,23,10,13,28
CFR Cluj,7273,2,6,7,1,15,7,8,25
Universitate,7273,3,3,6,5,14,20,-6,15
FC Botosani,7273,4,3,6,5,8,15,-7,15
D Bucuresti,7273,5,3,5,6,18,21,-3,14
Concordia Ch,7273,6,3,3,8,17,22,-5,12
FCSB,7274,1,8,5,1,28,11,17,29
CFR Cluj,7274,2,5,7,2,14,13,1,22
Universitate,7274,3,4,6,4,16,19,-3,18
D Bucuresti,7274,4,4,4,6,18,20,-2,16
FC Botosani,7274,5,4,4,6,8,15,-7,16
Concordia Ch,7274,6,3,2,9,17,23,-6,11
FCSB,7275,1,9,5,0,26,11,15,32
CFR Cluj,7275,2,6,6,2,14,8,6,24
FC Botosani,7275,3,4,5,5,6,12,-6,17
Universitate,7275,4,3,5,6,15,21,-6,14
D Bucuresti,7275,5,3,4,7,16,20,-4,13
Concordia Ch,7275,6,3,3,8,16,21,-5,12
FCSB,7276,1,7,6,1,25,14,11,27
CFR Cluj,7276,2,6,7,1,16,8,8,25
D Bucuresti,7276,3,4,4,6,19,21,-2,16
Universitate,7276,4,3,7,4,17,21,-4,16
FC Botosani,7276,5,4,4,6,6,14,-8,16
Concordia Ch,7276,6,3,2,9,18,23,-5,11
FCSB,7277,1,8,6,0,28,13,15,30
CFR Cluj,7277,2,5,8,1,17,11,6,23
D Bucuresti,7277,3,4,4,6,18,21,-3,16
Universitate,7277,4,3,6,5,15,21,-6,15
FC Botosani,7277,5,3,5,6,6,15,-9,14
Concordia Ch,7277,6,3,3,8,19,22,-3,12
FCSB,7278,1,7,6,1,25,13,12,27
CFR Cluj,7278,2,6,7,1,14,7,7,25
D Bucuresti,7278,3,5,4,5,19,18,1,19
Universitate,7278,4,3,7,4,16,20,-4,16
FC Botosani,7278,5,3,4,7,5,14,-9,13
Concordia Ch,7278,6,3,2,9,16,23,-7,11
FCSB,7279,1,7,6,1,25,13,12,27
CFR Cluj,7279,2,5,8,1,16,10,6,23
Universitate,7279,3,4,6,4,16,19,-3,18
FC Botosani,7279,4,4,5,5,11,16,-5,17
D Bucuresti,7279,5,3,4,7,18,23,-5,13
Concordia Ch,7279,6,3,3,8,18,23,-5,12
FCSB,7280,1,7,5,2,24,16,8,26
CFR Cluj,7280,2,6,7,1,16,9,7,25
Universitate,7280,3,4,6,4,19,19,0,18
D Bucuresti,7280,4,4,4,6,18,19,-1,16
FC Botosani,7280,5,4,4,6,8,14,-6,16
Concordia Ch,7280,6,3,2,9,16,24,-8,11
FCSB,7281,1,9,5,0,27,11,16,32
CFR Cluj,7281,2,5,6,3,16,13,3,21
D Bucuresti,7281,3,4,5,5,19,19,0,17
Universitate,7281,4,4,5,5,18,22,-4,17
FC Botosani,7281,5,3,5,6,8,17,-9,14
Concordia Ch,7281,6,2,4,8,19,25,-6,10
FCSB,7282,1,8,5,1,25,12,13,29
CFR Cluj,7282,2,6,6,2,15,9,6,24
Universitate,7282,3,4,5,5,17,21,-4,17
D Bucuresti,7282,4,4,4,6,19,21,-2,16
Concordia Ch,7282,5,4,2,8,17,21,-4,14
FC Botosani,7282,6,3,4,7,7,16,-9,13
FCSB,7283,1,8,6,0,29,11,18,30
CFR Cluj,7283,2,6,6,2,15,12,3,24
Universitate,7283,3,3,6,5,15,21,-6,15
FC Botosani,7283,4,3,6,5,6,13,-7,15
D Bucuresti,7283,5,3,5,6,16,19,-3,14
Concordia Ch,7283,6,3,3,8,17,22,-5,12
FCSB,7284,1,8,6,0,26,11,15,30
CFR Cluj,7284,2,6,7,1,16,9,7,25
FC Botosani,7284,3,5,4,5,9,14,-5,19
Universitate,7284,4,3,5,6,15,22,-7,14
D Bucuresti,7284,5,3,4,7,19,27,-8,13
Concordia Ch,7284,6,3,2,9,23,25,-2,11
FCSB,7285,1,9,5,0,28,13,15,32
CFR Cluj,7285,2,5,7,2,17,12,5,22
D Bucuresti,7285,3,4,5,5,18,19,-1,17
FC Botosani,7285,4,4,4,6,9,14,-5,16
Universitate,7285,5,3,6,5,19,24,-5,15
Concordia Ch,7285,6,2,3,9,17,26,-9,9
FCSB,7286,1,8,6,0,25,11,14,30
CFR Cluj,7286,2,6,7,1,17,9,8,25
D Bucuresti,7286,3,4,4,6,19,21,-2,16
FC Botosani,7286,4,4,4,6,9,16,-7,16
Universitate,7286,5,3,5,6,15,22,-7,14
Concordia Ch,7286,6,3,2,9,19,25,-6,11
FCSB,7287,1,7,6,1,23,12,11,27
CFR Cluj,7287,2,5,7,2,13,9,4,22
Universitate,7287,3,5,5,4,18,18,0,20
D Bucuresti,7287,4,4,5,5,18,19,-1,17
FC Botosani,7287,5,3,6,5,7,14,-7,15
Concordia Ch,7287,6,2,3,9,16,23,-7,9
FCSB,7288,1,8,6,0,26,12,14,30
CFR Cluj,7288,2,6,7,1,15,8,7,25
D Bucuresti,7288,3,4,4,6,18,24,-6,16
FC Botosani,7288,4,4,4,6,9,16,-7,16
Universitate,7288,5,3,5,6,15,21,-6,14
Concordia Ch,7288,6,3,2,9,22,24,-2,11
FCSB,7289,1,8,5,1,26,12,14,29
CFR Cluj,7289,2,5,7,2,14,10,4,22
Universitate,7289,3,4,6,4,17,20,-3,18
D Bucuresti,7289,4,4,5,5,20,21,-1,17
FC Botosani,7289,5,3,5,6,7,15,-8,14
Concordia Ch,7289,6,2,4,8,18,24,-6,10
FCSB,7290,1,8,6,0,25,11,14,30
CFR Cluj,7290,2,6,7,1,15,8,7,25
D Bucuresti,7290,3,3,6,5,17,19,-2,15
FC Botosani,7290,4,3,6,5,5,12,-7,15
Universitate,7290,5,3,5,6,14,20,-6,14
Concordia Ch,7290,6,2,4,8,16,22,-6,10
FCSB,7291,1,8,5,1,24,12,12,29
CFR Cluj,7291,2,6,6,2,16,10,6,24
Universitate,7291,3,4,5,5,17,20,-3,17
D Bucuresti,7291,4,3,6,5,18,20,-2,15
FC Botosani,7291,5,3,6,5,8,15,-7,15
Concordia Ch,7291,6,2,4,8,18,24,-6,10
FCSB,7292,1,8,6,0,27,12,15,30
CFR Cluj,7292,2,5,7,2,15,11,4,22
D Bucuresti,7292,3,4,5,5,19,20,-1,17
Universitate,7292,4,3,7,4,16,20,-4,16
FC Botosani,7292,5,4,4,6,8,15,-7,16
Concordia Ch,7292,6,2,3,9,17,24,-7,9
FCSB,7293,1,8,5,1,25,12,13,29
CFR Cluj,7293,2,6,6,2,17,9,8,24
Universitate,7293,3,4,5,5,15,21,-6,17
FC Botosani,7293,4,3,6,5,7,14,-7,15
D Bucuresti,7293,5,3,5,6,18,21,-3,14
Concordia Ch,7293,6,3,3,8,18,23,-5,12
FCSB,7294,1,8,5,1,25,12,13,29
CFR Cluj,7294,2,6,6,2,15,10,5,24
D Bucuresti,7294,3,4,5,5,19,19,0,17
Universitate,7294,4,4,5,5,16,19,-3,17
FC Botosani,7294,5,3,5,6,6,15,-9,14
Concordia Ch,7294,6,2,4,8,17,23,-6,10
FCSB,7295,1,8,6,0,26,12,14,30
CFR Cluj,7295,2,6,7,1,18,10,8,25
D Bucuresti,7295,3,4,5,5,19,19,0,17
Universitate,7295,4,3,5,6,15,22,-7,14
FC Botosani,7295,5,3,5,6,5,14,-9,14
Concordia Ch,7295,6,2,4,8,16,22,-6,10
FCSB,7296,1,8,6,0,27,11,16,30
CFR Cluj,7296,2,6,7,1,15,8,7,25
D Bucuresti,7296,3,4,5,5,18,19,-1,17
Universitate,7296,4,3,5,6,14,22,-8,14
FC Botosani,7296,5,3,5,6,5,13,-8,14
Concordia Ch,7296,6,2,4,8,16,22,-6,10
FCSB,7297,1,8,5,1,25,14,11,29
CFR Cluj,7297,2,6,7,1,17,8,9,25
FC Botosani,7297,3,5,4,5,7,12,-5,19
Universitate,7297,4,3,6,5,16,21,-5,15
D Bucuresti,7297,5,3,4,7,16,20,-4,13
Concordia Ch,7297,6,3,2,9,16,22,-6,11
CFR Cluj,7298,1,7,6,1,16,8,8,27
FCSB,7298,2,7,5,2,25,14,11,26
D Bucuresti,7298,3,4,5,5,18,19,-1,17
Universitate,7298,4,4,5,5,16,20,-4,17
FC Botosani,7298,5,4,5,5,7,13,-6,17
Concordia Ch,7298,6,2,2,10,15,23,-8,8
FCSB,7299,1,7,6,1,24,12,12,27
CFR Cluj,7299,2,6,6,2,15,10,5,24
Universitate,7299,3,4,6,4,16,18,-2,18
D Bucuresti,7299,4,4,4,6,17,20,-3,16
FC Botosani,7299,5,4,4,6,8,13,-5,16
Concordia Ch,7299,6,3,2,9,17,24,-7,11
FCSB,7300,1,7,6,1,23,12,11,27
CFR Cluj,7300,2,6,7,1,16,7,9,25
D Bucuresti,7300,3,4,5,5,18,19,-1,17
Universitate,7300,4,4,5,5,16,21,-5,17
FC Botosani,7300,5,3,4,7,7,16,-9,13
Concordia Ch,7300,6,3,3,8,17,22,-5,12
FCSB,7301,1,8,5,1,26,13,13,29
CFR Cluj,7301,2,7,6,1,16,8,8,27
FC Botosani,7301,3,5,4,5,9,12,-3,19
Universitate,7301,4,3,5,6,17,23,-6,14
D Bucuresti,7301,5,3,4,7,16,23,-7,13
Concordia Ch,7301,6,3,2,9,17,22,-5,11
FCSB,7302,1,7,6,1,24,13,11,27
CFR Cluj,7302,2,5,8,1,15,9,6,23
Universitate,7302,3,4,6,4,17,19,-2,18
D Bucuresti,7302,4,4,5,5,21,22,-1,17
FC Botosani,7302,5,4,4,6,8,15,-7,16
Concordia Ch,7302,6,2,3,9,17,24,-7,9
FCSB,7303,1,7,7,0,26,13,13,28
CFR Cluj,7303,2,5,8,1,17,11,6,23
FC Botosani,7303,3,4,5,5,8,13,-5,17
Universitate,7303,4,3,7,4,17,21,-4,16
D Bucuresti,7303,5,3,5,6,16,21,-5,14
Concordia Ch,7303,6,3,2,9,19,24,-5,11
CFR Cluj,7304,1,7,6,1,18,8,10,27
FCSB,7304,2,7,5,2,24,16,8,26
D Bucuresti,7304,3,4,5,5,20,20,0,17
Universitate,7304,4,4,5,5,19,22,-3,17
FC Botosani,7304,5,3,5,6,5,14,-9,14
Concordia Ch,7304,6,2,4,8,17,23,-6,10
FCSB,7305,1,7,6,1,24,16,8,27
CFR Cluj,7305,2,6,7,1,16,9,7,25
Universitate,7305,3,4,5,5,20,20,0,17
D Bucuresti,7305,4,4,4,6,18,20,-2,16
FC Botosani,7305,5,3,5,6,8,16,-8,14
Concordia Ch,7305,6,3,3,8,18,23,-5,12
FCSB,7306,1,8,5,1,25,12,13,29
CFR Cluj,7306,2,6,6,2,17,10,7,24
D Bucuresti,7306,3,4,5,5,20,20,0,17
Universitate,7306,4,4,5,5,16,21,-5,17
FC Botosani,7306,5,4,5,5,7,13,-6,17
Concordia Ch,7306,6,2,2,10,16,25,-9,8
FCSB,7307,1,9,5,0,27,11,16,32
CFR Cluj,7307,2,5,7,2,13,9,4,22
Universitate,7307,3,3,6,5,15,20,-5,15
Concordia Ch,7307,4,4,2,8,19,21,-2,14
D Bucuresti,7307,5,3,5,6,16,21,-5,14
FC Botosani,7307,6,3,5,6,5,13,-8,14
FCSB,7308,1,8,5,1,24,13,11,29
CFR Cluj,7308,2,6,6,2,17,9,8,24
Universitate,7308,3,4,5,5,16,20,-4,17
D Bucuresti,7308,4,3,6,5,21,23,-2,15
FC Botosani,7308,5,3,6,5,6,13,-7,15
Concordia Ch,7308,6,2,4,8,21,27,-6,10
FCSB,7309,1,9,5,0,28,12,16,32
CFR Cluj,7309,2,5,6,3,15,13,2,21
FC Botosani,7309,3,5,4,5,8,13,-5,19
Universitate,7309,4,4,5,5,18,21,-3,17
D Bucuresti,7309,5,4,4,6,17,19,-2,16
Concordia Ch,7309,6,2,2,10,16,24,-8,8
FCSB,7310,1,7,7,0,23,10,13,28
CFR Cluj,7310,2,5,7,2,13,8,5,22
Universitate,7310,3,4,6,4,15,18,-3,18
FC Botosani,7310,4,3,6,5,6,13,-7,15
D Bucuresti,7310,5,3,5,6,19,22,-3,14
Concordia Ch,7310,6,3,3,8,18,23,-5,12
FCSB,7311,1,9,5,0,26,10,16,32
CFR Cluj,7311,2,6,6,2,16,9,7,24
D Bucuresti,7311,3,4,5,5,19,19,0,17
Universitate,7311,4,3,5,6,14,22,-8,14
FC Botosani,7311,5,3,5,6,6,14,-8,14
Concordia Ch,7311,6,3,2,9,16,23,-7,11
FCSB,7312,1,7,6,1,24,12,12,27
CFR Cluj,7312,2,7,6,1,15,7,8,27
FC Botosani,7312,3,4,5,5,8,14,-6,17
Universitate,7312,4,3,6,5,15,20,-5,15
D Bucuresti,7312,5,3,4,7,18,23,-5,13
Concordia Ch,7312,6,3,3,8,21,25,-4,12
FCSB,7313,1,7,6,1,23,12,11,27
CFR Cluj,7313,2,5,7,2,14,10,4,22
Universitate,7313,3,5,5,4,19,19,0,20
FC Botosani,7313,4,5,4,5,8,12,-4,19
D Bucuresti,7313,5,3,5,6,17,20,-3,14
Concordia Ch,7313,6,2,3,9,16,24,-8,9
FCSB,7314,1,8,6,0,25,11,14,30
CFR Cluj,7314,2,6,7,1,15,8,7,25
D Bucuresti,7314,3,3,5,6,16,19,-3,14
Concordia Ch,7314,4,4,2,8,17,21,-4,14
Universitate,7314,5,3,5,6,14,20,-6,14
FC Botosani,7314,6,3,5,6,5,13,-8,14
FCSB,7315,1,7,6,1,24,14,10,27
CFR Cluj,7315,2,6,7,1,15,8,7,25
Universitate,7315,3,4,5,5,17,19,-2,17
D Bucuresti,7315,4,4,4,6,18,19,-1,16
FC Botosani,7315,5,4,4,6,7,14,-7,16
Concordia Ch,7315,6,3,2,9,16,23,-7,11
FCSB,7316,1,9,5,0,27,11,16,32
CFR Cluj,7316,2,5,6,3,15,12,3,21
D Bucuresti,7316,3,4,5,5,18,19,-1,17
Universitate,7316,4,4,5,5,17,21,-4,17
FC Botosani,7316,5,3,5,6,8,17,-9,14
Concordia Ch,7316,6,3,2,9,19,24,-5,11
FCSB,7317,1,9,5,0,28,11,17,32
CFR Cluj,7317,2,6,6,2,15,11,4,24
FC Botosani,7317,3,5,4,5,8,12,-4,19
Universitate,7317,4,3,5,6,14,20,-6,14
D Bucuresti,7317,5,3,4,7,16,21,-5,13
Concordia Ch,7317,6,3,2,9,16,22,-6,11
FCSB,7318,1,9,5,0,28,10,18,32
CFR Cluj,7318,2,5,6,3,13,12,1,21
Universitate,7318,3,4,5,5,15,19,-4,17
FC Botosani,7318,4,3,6,5,6,13,-7,15
D Bucuresti,7318,5,3,5,6,18,21,-3,14
Concordia Ch,7318,6,3,3,8,17,22,-5,12
FCSB,7319,1,7,6,1,26,14,12,27
CFR Cluj,7319,2,6,7,1,14,7,7,25
D Bucuresti,7319,3,4,4,6,18,22,-4,16
Universitate,7319,4,3,7,4,17,21,-4,16
Concordia Ch,7319,5,4,2,8,21,23,-2,14
FC Botosani,7319,6,3,4,7,8,17,-9,13
CFR Cluj,7320,1,7,6,1,15,7,8,27
FCSB,7320,2,7,5,2,23,12,11,26
D Bucuresti,7320,3,4,5,5,20,21,-1,17
Universitate,7320,4,4,5,5,15,19,-4,17
FC Botosani,7320,5,3,4,7,6,15,-9,13
Concordia Ch,7320,6,3,3,8,18,23,-5,12
FCSB,7321,1,9,5,0,27,10,17,32
CFR Cluj,7321,2,5,6,3,14,11,3,21
Universitate,7321,3,4,5,5,17,22,-5,17
D Bucuresti,7321,4,4,4,6,18,21,-3,16
FC Botosani,7321,5,4,4,6,9,15,-6,16
Concordia Ch,7321,6,3,2,9,20,26,-6,11
CFR Cluj,7322,1,7,6,1,18,8,10,27
FCSB,7322,2,7,5,2,24,15,9,26
D Bucuresti,7322,3,4,5,5,19,18,1,17
Universitate,7322,4,4,5,5,17,21,-4,17
FC Botosani,7322,5,3,5,6,5,15,-10,14
Concordia Ch,7322,6,2,4,8,15,21,-6,10
FCSB,7323,1,8,6,0,26,11,15,30
CFR Cluj,7323,2,5,7,2,14,9,5,22
FC Botosani,7323,3,4,5,5,9,13,-4,17
Universitate,7323,4,4,5,5,15,20,-5,17
D Bucuresti,7323,5,3,5,6,17,21,-4,14
Concordia Ch,7323,6,3,2,9,17,24,-7,11
FCSB,7324,1,8,6,0,25,10,15,30
CFR Cluj,7324,2,5,7,2,13,8,5,22
Universitate,7324,3,4,5,5,15,20,-5,17
D Bucuresti,7324,4,4,4,6,19,22,-3,16
FC Botosani,7324,5,4,4,6,8,14,-6,16
Concordia Ch,7324,6,3,2,9,19,25,-6,11
FCSB,7325,1,8,5,1,26,13,13,29
CFR Cluj,7325,2,7,6,1,19,9,10,27
D Bucuresti,7325,3,3,5,6,17,20,-3,14
Concordia Ch,7325,4,4,2,8,18,22,-4,14
Universitate,7325,5,3,5,6,14,22,-8,14
FC Botosani,7325,6,3,5,6,5,13,-8,14
FCSB,7326,1,8,5,1,26,12,14,29
CFR Cluj,7326,2,5,7,2,13,9,4,22
Universitate,7326,3,4,6,4,16,19,-3,18
D Bucuresti,7326,4,4,4,6,19,20,-1,16
FC Botosani,7326,5,4,4,6,8,16,-8,16
Concordia Ch,7326,6,3,2,9,17,23,-6,11
FCSB,7327,1,7,5,2,24,15,9,26
CFR Cluj,7327,2,6,7,1,17,8,9,25
D Bucuresti,7327,3,5,4,5,18,18,0,19
Universitate,7327,4,4,6,4,17,20,-3,18
FC Botosani,7327,5,4,4,6,6,13,-7,16
Concordia Ch,7327,6,2,2,10,15,23,-8,8
FCSB,7328,1,8,5,1,25,13,12,29
CFR Cluj,7328,2,7,6,1,17,7,10,27
FC Botosani,7328,3,4,5,5,8,13,-5,17
Universitate,7328,4,3,5,6,14,21,-7,14
D Bucuresti,7328,5,3,4,7,17,24,-7,13
Concordia Ch,7328,6,3,3,8,18,21,-3,12
FCSB,7329,1,7,6,1,24,13,11,27
CFR Cluj,7329,2,5,7,2,15,10,5,22
Universitate,7329,3,5,5,4,18,19,-1,20
FC Botosani,7329,4,4,4,6,6,14,-8,16
Concordia Ch,7329,5,4,2,8,18,21,-3,14
D Bucuresti,7329,6,3,4,7,16,20,-4,13
FCSB,7330,1,9,5,0,26,10,16,32
CFR Cluj,7330,2,5,7,2,14,9,5,22
D Bucuresti,7330,3,3,6,5,17,19,-2,15
Universitate,7330,4,3,6,5,15,21,-6,15
FC Botosani,7330,5,3,6,5,6,13,-7,15
Concordia Ch,7330,6,2,4,8,15,21,-6,10
FCSB,7331,1,9,5,0,27,10,17,32
CFR Cluj,7331,2,5,6,3,14,11,3,21
D Bucuresti,7331,3,4,5,5,19,19,0,17
Universitate,7331,4,4,5,5,16,21,-5,17
FC Botosani,7331,5,4,4,6,7,15,-8,16
Concordia Ch,7331,6,2,3,9,15,22,-7,9
FCSB,7332,1,9,5,0,28,11,17,32
CFR Cluj,7332,2,6,6,2,15,11,4,24
FC Botosani,7332,3,5,4,5,7,12,-5,19
Universitate,7332,4,3,5,6,16,22,-6,14
D Bucuresti,7332,5,3,4,7,17,23,-6,13
Concordia Ch,7332,6,3,2,9,19,23,-4,11
FCSB,7333,1,8,6,0,25,10,15,30
CFR Cluj,7333,2,5,7,2,13,9,4,22
FC Botosani,7333,3,4,5,5,9,14,-5,17
Universitate,7333,4,3,7,4,14,18,-4,16
D Bucuresti,7333,5,3,4,7,17,23,-6,13
Concordia Ch,7333,6,3,3,8,18,22,-4,12
FCSB,7334,1,8,5,1,25,14,11,29
CFR Cluj,7334,2,6,6,2,15,9,6,24
Universitate,7334,3,4,5,5,18,20,-2,17
FC Botosani,7334,4,4,5,5,7,13,-6,17
D Bucuresti,7334,5,3,4,7,16,22,-6,13
Concordia Ch,7334,6,3,3,8,19,22,-3,12
FCSB,7335,1,8,6,0,26,12,14,30
CFR Cluj,7335,2,6,6,2,17,10,7,24
D Bucuresti,7335,3,4,4,6,19,22,-3,16
Universitate,7335,4,3,6,5,16,22,-6,15
FC Botosani,7335,5,3,5,6,5,14,-9,14
Concordia Ch,7335,6,3,3,8,19,22,-3,12
FCSB,7336,1,7,6,1,24,12,12,27
CFR Cluj,7336,2,6,7,1,15,8,7,25
Universitate,7336,3,4,5,5,15,19,-4,17
D Bucuresti,7336,4,4,4,6,17,21,-4,16
FC Botosani,7336,5,4,4,6,8,13,-5,16
Concordia Ch,7336,6,3,2,9,18,24,-6,11
FCSB,7337,1,9,5,0,25,10,15,32
CFR Cluj,7337,2,5,7,2,14,9,5,22
D Bucuresti,7337,3,5,4,5,19,19,0,19
FC Botosani,7337,4,4,4,6,9,14,-5,16
Universitate,7337,5,3,6,5,15,20,-5,15
Concordia Ch,7337,6,2,2,10,17,27,-10,8
FCSB,7338,1,8,5,1,26,12,14,29
CFR Cluj,7338,2,7,6,1,19,8,11,27
D Bucuresti,7338,3,5,4,5,19,19,0,19
FC Botosani,7338,4,4,4,6,7,14,-7,16
Universitate,7338,5,3,5,6,14,24,-10,14
Concordia Ch,7338,6,2,2,10,15,23,-8,8
FCSB,7339,1,9,5,0,28,10,18,32
CFR Cluj,7339,2,5,6,3,14,13,1,21
FC Botosani,7339,3,5,4,5,8,12,-4,19
Universitate,7339,4,4,5,5,16,20,-4,17
D Bucuresti,7339,5,3,4,7,16,21,-5,13
Concordia Ch,7339,6,3,2,9,17,23,-6,11
FCSB,7340,1,8,5,1,25,13,12,29
CFR Cluj,7340,2,6,6,2,14,8,6,24
Universitate,7340,3,4,5,5,17,20,-3,17
FC Botosani,7340,4,4,5,5,9,13,-4,17
D Bucuresti,7340,5,3,5,6,18,23,-5,14
Concordia Ch,7340,6,2,4,8,18,24,-6,10
FCSB,7341,1,8,5,1,25,13,12,29
CFR Cluj,7341,2,6,6,2,16,9,7,24
FC Botosani,7341,3,5,4,5,10,15,-5,19
Universitate,7341,4,4,5,5,16,20,-4,17
D Bucuresti,7341,5,4,4,6,19,20,-1,16
Concordia Ch,7341,6,2,2,10,17,26,-9,8
FCSB,7342,1,8,5,1,24,11,13,29
CFR Cluj,7342,2,6,6,2,14,9,5,24
Universitate,7342,3,4,5,5,16,19,-3,17
D Bucuresti,7342,4,4,4,6,17,19,-2,16
FC Botosani,7342,5,3,5,6,6,14,-8,14
Concordia Ch,7342,6,3,3,8,17,22,-5,12
FCSB,7343,1,8,5,1,29,14,15,29
CFR Cluj,7343,2,7,6,1,20,10,10,27
FC Botosani,7343,3,5,4,5,8,12,-4,19
D Bucuresti,7343,4,3,5,6,16,20,-4,14
Universitate,7343,5,3,5,6,15,25,-10,14
Concordia Ch,7343,6,2,3,9,15,22,-7,9
FCSB,7344,1,7,6,1,24,12,12,27
CFR Cluj,7344,2,6,7,1,16,9,7,25
D Bucuresti,7344,3,4,5,5,18,19,-1,17
Universitate,7344,4,3,7,4,15,19,-4,16
FC Botosani,7344,5,3,5,6,6,14,-8,14
Concordia Ch,7344,6,3,2,9,16,22,-6,11
CFR Cluj,7345,1,7,6,1,17,9,8,27
FCSB,7345,2,7,5,2,26,15,11,26
Universitate,7345,3,4,5,5,16,20,-4,17
D Bucuresti,7345,4,3,6,5,19,21,-2,15
FC Botosani,7345,5,3,6,5,7,14,-7,15
Concordia Ch,7345,6,2,4,8,18,24,-6,10
FCSB,7346,1,8,5,1,26,12,14,29
CFR Cluj,7346,2,5,6,3,13,10,3,21
Universitate,7346,3,5,5,4,17,19,-2,20
D Bucuresti,7346,4,4,4,6,22,21,1,16
Concordia Ch,7346,5,4,2,8,20,23,-3,14
FC Botosani,7346,6,3,4,7,5,18,-13,13
FCSB,7347,1,7,6,1,24,13,11,27
CFR Cluj,7347,2,6,7,1,17,9,8,25
D Bucuresti,7347,3,5,4,5,19,18,1,19
Universitate,7347,4,4,5,5,17,21,-4,17
FC Botosani,7347,5,3,4,7,5,15,-10,13
Concordia Ch,7347,6,3,2,9,16,22,-6,11
FCSB,7348,1,8,6,0,27,13,14,30
CFR Cluj,7348,2,6,6,2,15,9,6,24
D Bucuresti,7348,3,4,4,6,19,20,-1,16
Universitate,7348,4,3,6,5,16,21,-5,15
FC Botosani,7348,5,3,5,6,6,15,-9,14
Concordia Ch,7348,6,3,3,8,16,21,-5,12
FCSB,7349,1,8,5,1,25,14,11,29
CFR Cluj,7349,2,5,6,3,14,11,3,21
Universitate,7349,3,5,5,4,19,18,1,20
Concordia Ch,7349,4,4,2,8,19,21,-2,14
D Bucuresti,7349,5,3,5,6,17,22,-5,14
FC Botosani,7349,6,3,5,6,6,14,-8,14
CFR Cluj,7350,1,7,6,1,19,9,10,27
FCSB,7350,2,7,5,2,24,14,10,26
D Bucuresti,7350,3,5,4,5,20,18,2,19
Universitate,7350,4,4,5,5,16,21,-5,17
FC Botosani,7350,5,3,4,7,5,15,-10,13
Concordia Ch,7350,6,3,2,9,17,24,-7,11
FCSB,7351,1,8,5,1,28,13,15,29
CFR Cluj,7351,2,7,6,1,18,8,10,27
D Bucuresti,7351,3,4,5,5,20,19,1,17
FC Botosani,7351,4,3,5,6,5,14,-9,14
Universitate,7351,5,3,5,6,15,25,-10,14
Concordia Ch,7351,6,3,2,9,18,25,-7,11
FCSB,7352,1,8,6,0,24,10,14,30
CFR Cluj,7352,2,5,6,3,14,10,4,21
Universitate,7352,3,4,6,4,16,19,-3,18
FC Botosani,7352,4,4,4,6,7,14,-7,16
Concordia Ch,7352,5,4,2,8,18,21,-3,14
D Bucuresti,7352,6,3,4,7,16,21,-5,13
FCSB,7353,1,7,6,1,26,14,12,27
CFR Cluj,7353,2,6,7,1,17,10,7,25
D Bucuresti,7353,3,4,5,5,17,18,-1,17
Universitate,7353,4,3,7,4,16,20,-4,16
FC Botosani,7353,5,3,5,6,5,13,-8,14
Concordia Ch,7353,6,2,4,8,15,21,-6,10
FCSB,7354,1,7,7,0,24,11,13,28
CFR Cluj,7354,2,6,7,1,14,7,7,25
D Bucuresti,7354,3,4,5,5,18,19,-1,17
FC Botosani,7354,4,4,5,5,7,13,-6,17
Universitate,7354,5,3,6,5,15,20,-5,15
Concordia Ch,7354,6,2,2,10,15,23,-8,8
FCSB,7355,1,8,5,1,24,12,12,29
CFR Cluj,7355,2,7,6,1,16,7,9,27
D Bucuresti,7355,3,4,5,5,20,21,-1,17
FC Botosani,7355,4,4,4,6,8,15,-7,16
Universitate,7355,5,3,5,6,14,20,-6,14
Concordia Ch,7355,6,2,3,9,16,23,-7,9
FCSB,7356,1,7,7,0,23,10,13,28
CFR Cluj,7356,2,6,7,1,15,8,7,25
Universitate,7356,3,3,6,5,15,20,-5,15
D Bucuresti,7356,4,3,5,6,16,19,-3,14
Concordia Ch,7356,5,4,2,8,17,21,-4,14
FC Botosani,7356,6,3,5,6,5,13,-8,14
FCSB,7357,1,9,5,0,27,12,15,32
CFR Cluj,7357,2,5,6,3,15,11,4,21
Universitate,7357,3,4,5,5,17,21,-4,17
D Bucuresti,7357,4,4,4,6,18,22,-4,16
FC Botosani,7357,5,3,5,6,8,16,-8,14
Concordia Ch,7357,6,3,3,8,20,23,-3,12
FCSB,7358,1,7,6,1,23,12,11,27
CFR Cluj,7358,2,6,6,2,15,8,7,24
Universitate,7358,3,4,6,4,15,18,-3,18
D Bucuresti,7358,4,4,4,6,18,20,-2,16
Concordia Ch,7358,5,4,2,8,17,21,-4,14
FC Botosani,7358,6,3,4,7,6,15,-9,13
FCSB,7359,1,8,6,0,25,10,15,30
CFR Cluj,7359,2,6,7,1,15,8,7,25
D Bucuresti,7359,3,4,4,6,18,20,-2,16
Universitate,7359,4,3,5,6,15,22,-7,14
FC Botosani,7359,5,3,5,6,7,15,-8,14
Concordia Ch,7359,6,3,3,8,17,22,-5,12
FCSB,7360,1,8,6,0,26,12,14,30
CFR Cluj,7360,2,6,6,2,14,8,6,24
D Bucuresti,7360,3,4,5,5,19,19,0,17
FC Botosani,7360,4,4,5,5,7,12,-5,17
Universitate,7360,5,3,6,5,16,21,-5,15
Concordia Ch,7360,6,2,2,10,16,26,-10,8
FCSB,7361,1,9,5,0,32,11,21,32
CFR Cluj,7361,2,6,6,2,16,15,1,24
D Bucuresti,7361,3,4,5,5,19,19,0,17
FC Botosani,7361,4,4,4,6,9,14,-5,16
Universitate,7361,5,3,5,6,14,21,-7,14
Concordia Ch,7361,6,2,3,9,16,26,-10,9
FCSB,7362,1,8,6,0,26,10,16,30
CFR Cluj,7362,2,6,7,1,15,7,8,25
D Bucuresti,7362,3,3,6,5,17,19,-2,15
Universitate,7362,4,3,5,6,14,23,-9,14
FC Botosani,7362,5,3,5,6,6,16,-10,14
Concordia Ch,7362,6,3,3,8,20,23,-3,12
FCSB,7363,1,8,5,1,25,12,13,29
CFR Cluj,7363,2,6,6,2,17,9,8,24
D Bucuresti,7363,3,4,5,5,20,20,0,17
Universitate,7363,4,4,5,5,15,21,-6,17
FC Botosani,7363,5,3,6,5,7,14,-7,15
Concordia Ch,7363,6,2,3,9,17,25,-8,9
FCSB,7364,1,8,5,1,24,11,13,29
CFR Cluj,7364,2,5,7,2,15,10,5,22
Universitate,7364,3,4,6,4,17,20,-3,18
D Bucuresti,7364,4,4,4,6,19,20,-1,16
FC Botosani,7364,5,4,4,6,6,13,-7,16
Concordia Ch,7364,6,3,2,9,17,24,-7,11
FCSB,7365,1,8,6,0,27,13,14,30
CFR Cluj,7365,2,6,6,2,17,11,6,24
FC Botosani,7365,3,4,4,6,6,15,-9,16
Universitate,7365,4,3,6,5,18,23,-5,15
Concordia Ch,7365,5,4,2,8,19,21,-2,14
D Bucuresti,7365,6,3,4,7,16,20,-4,13
FCSB,7366,1,7,5,2,24,14,10,26
CFR Cluj,7366,2,6,7,1,15,8,7,25
Universitate,7366,3,4,6,4,18,20,-2,18
D Bucuresti,7366,4,3,6,5,18,20,-2,15
FC Botosani,7366,5,3,6,5,6,13,-7,15
Concordia Ch,7366,6,2,4,8,16,22,-6,10
FCSB,7367,1,9,5,0,29,10,19,32
CFR Cluj,7367,2,5,6,3,13,9,4,21
D Bucuresti,7367,3,5,4,5,19,18,1,19
Universitate,7367,4,4,5,5,15,23,-8,17
FC Botosani,7367,5,4,4,6,6,13,-7,16
Concordia Ch,7367,6,2,2,10,15,24,-9,8
FCSB,7368,1,8,5,1,27,13,14,29
CFR Cluj,7368,2,6,6,2,16,12,4,24
Universitate,7368,3,4,5,5,17,20,-3,17
D Bucuresti,7368,4,3,6,5,16,18,-2,15
FC Botosani,7368,5,3,6,5,6,13,-7,15
Concordia Ch,7368,6,2,4,8,16,22,-6,10
FCSB,7369,1,9,5,0,28,13,15,32
CFR Cluj,7369,2,6,6,2,15,9,6,24
D Bucuresti,7369,3,4,4,6,19,19,0,16
Concordia Ch,7369,4,4,2,8,18,22,-4,14
Universitate,7369,5,3,5,6,16,22,-6,14
FC Botosani,7369,6,3,4,7,6,17,-11,13
FCSB,7370,1,8,5,1,26,12,14,29
CFR Cluj,7370,2,5,7,2,14,10,4,22
Universitate,7370,3,4,6,4,17,20,-3,18
D Bucuresti,7370,4,4,4,6,19,21,-2,16
FC Botosani,7370,5,3,5,6,5,14,-9,14
Concordia Ch,7370,6,3,3,8,18,22,-4,12
FCSB,7371,1,9,5,0,27,12,15,32
CFR Cluj,7371,2,6,6,2,15,9,6,24
FC Botosani,7371,3,5,4,5,9,13,-4,19
Universitate,7371,4,3,5,6,15,21,-6,14
D Bucuresti,7371,5,3,4,7,18,23,-5,13
Concordia Ch,7371,6,3,2,9,17,23,-6,11
FCSB,7372,1,7,7,0,25,12,13,28
CFR Cluj,7372,2,6,7,1,16,8,8,25
FC Botosani,7372,3,5,4,5,8,12,-4,19
Universitate,7372,4,3,6,5,17,23,-6,15
D Bucuresti,7372,5,3,4,7,17,22,-5,13
Concordia Ch,7372,6,3,2,9,17,23,-6,11
FCSB,7373,1,7,7,0,25,12,13,28
CFR Cluj,7373,2,6,7,1,15,8,7,25
FC Botosani,7373,3,4,5,5,7,13,-6,17
Universitate,7373,4,3,6,5,15,20,-5,15
D Bucuresti,7373,5,3,5,6,17,21,-4,14
Concordia Ch,7373,6,3,2,9,17,22,-5,11
FCSB,7374,1,8,5,1,27,14,13,29
CFR Cluj,7374,2,6,6,2,16,10,6,24
Universitate,7374,3,4,5,5,18,22,-4,17
FC Botosani,7374,4,4,5,5,8,14,-6,17
D Bucuresti,7374,5,4,4,6,18,19,-1,16
Concordia Ch,7374,6,2,3,9,17,25,-8,9
FCSB,7375,1,7,7,0,24,11,13,28
CFR Cluj,7375,2,6,7,1,17,8,9,25
D Bucuresti,7375,3,4,5,5,18,19,-1,17
Universitate,7375,4,3,6,5,14,21,-7,15
FC Botosani,7375,5,3,6,5,7,14,-7,15
Concordia Ch,7375,6,2,3,9,16,23,-7,9
FCSB,7376,1,7,6,1,24,12,12,27
CFR Cluj,7376,2,6,7,1,15,7,8,25
Universitate,7376,3,4,5,5,16,21,-5,17
D Bucuresti,7376,4,4,4,6,18,21,-3,16
FC Botosani,7376,5,4,4,6,7,14,-7,16
Concordia Ch,7376,6,3,2,9,17,22,-5,11
FCSB,7377,1,8,5,1,26,11,15,29
CFR Cluj,7377,2,6,6,2,15,11,4,24
D Bucuresti,7377,3,4,5,5,18,19,-1,17
Universitate,7377,4,4,5,5,16,20,-4,17
FC Botosani,7377,5,4,5,5,7,13,-6,17
Concordia Ch,7377,6,2,2,10,17,25,-8,8
FCSB,7378,1,8,6,0,24,10,14,30
CFR Cluj,7378,2,6,7,1,16,7,9,25
D Bucuresti,7378,3,4,4,6,21,20,1,16
FC Botosani,7378,4,4,4,6,8,18,-10,16
Universitate,7378,5,3,5,6,14,22,-8,14
Concordia Ch,7378,6,3,2,9,19,25,-6,11
FCSB,7379,1,8,6,0,26,12,14,30
CFR Cluj,7379,2,5,8,1,15,9,6,23
D Bucuresti,7379,3,4,4,6,19,19,0,16
FC Botosani,7379,4,4,4,6,8,16,-8,16
Universitate,7379,5,3,6,5,16,21,-5,15
Concordia Ch,7379,6,3,2,9,17,24,-7,11
FCSB,7380,1,8,5,1,26,13,13,29
CFR Cluj,7380,2,7,6,1,19,8,11,27
D Bucuresti,7380,3,5,4,5,20,19,1,19
Universitate,7380,4,3,5,6,15,24,-9,14
FC Botosani,7380,5,3,4,7,6,16,-10,13
Concordia Ch,7380,6,3,2,9,18,24,-6,11
CFR Cluj,7381,1,7,6,1,15,7,8,27
FCSB,7381,2,7,5,2,23,12,11,26
FC Botosani,7381,3,5,4,5,8,13,-5,19
Universitate,7381,4,4,5,5,15,19,-4,17
D Bucuresti,7381,5,3,4,7,19,23,-4,13
Concordia Ch,7381,6,3,2,9,18,24,-6,11
FCSB,7382,1,7,6,1,27,15,12,27
CFR Cluj,7382,2,5,8,1,15,9,6,23
Universitate,7382,3,4,6,4,17,20,-3,18
D Bucuresti,7382,4,4,4,6,19,21,-2,16
Concordia Ch,7382,5,4,2,8,20,23,-3,14
FC Botosani,7382,6,3,4,7,7,17,-10,13
FCSB,7383,1,9,5,0,27,11,16,32
CFR Cluj,7383,2,5,6,3,14,10,4,21
Universitate,7383,3,4,5,5,15,20,-5,17
D Bucuresti,7383,4,4,4,6,19,20,-1,16
FC Botosani,7383,5,4,4,6,6,15,-9,16
Concordia Ch,7383,6,3,2,9,17,22,-5,11
FCSB,7384,1,8,5,1,26,12,14,29
CFR Cluj,7384,2,6,7,1,16,9,7,25
D Bucuresti,7384,3,4,4,6,19,21,-2,16
Universitate,7384,4,3,6,5,15,21,-6,15
FC Botosani,7384,5,3,5,6,7,15,-8,14
Concordia Ch,7384,6,3,3,8,18,23,-5,12
FCSB,7385,1,8,5,1,26,13,13,29
CFR Cluj,7385,2,6,6,2,15,9,6,24
Universitate,7385,3,4,5,5,16,20,-4,17
D Bucuresti,7385,4,3,6,5,16,18,-2,15
FC Botosani,7385,5,3,5,6,6,14,-8,14
Concordia Ch,7385,6,3,3,8,17,22,-5,12
FCSB,7386,1,9,5,0,26,11,15,32
CFR Cluj,7386,2,5,7,2,14,9,5,22
Universitate,7386,3,3,6,5,16,21,-5,15
D Bucuresti,7386,4,3,5,6,18,21,-3,14
Concordia Ch,7386,5,4,2,8,19,23,-4,14
FC Botosani,7386,6,3,5,6,7,15,-8,14
FCSB,7387,1,7,5,2,23,14,9,26
CFR Cluj,7387,2,6,6,2,14,9,5,24
Universitate,7387,3,5,5,4,19,18,1,20
FC Botosani,7387,4,3,6,5,5,12,-7,15
D Bucuresti,7387,5,3,5,6,18,21,-3,14
Concordia Ch,7387,6,3,3,8,18,23,-5,12
FCSB,7388,1,8,5,1,25,12,13,29
CFR Cluj,7388,2,6,6,2,17,10,7,24
D Bucuresti,7388,3,4,5,5,19,19,0,17
Universitate,7388,4,4,5,5,16,21,-5,17
FC Botosani,7388,5,3,4,7,5,16,-11,13
Concordia Ch,7388,6,3,3,8,18,22,-4,12
FCSB,7389,1,9,5,0,27,11,16,32
CFR Cluj,7389,2,6,6,2,16,11,5,24
D Bucuresti,7389,3,4,4,6,20,21,-1,16
FC Botosani,7389,4,4,4,6,8,15,-7,16
Universitate,7389,5,3,5,6,15,21,-6,14
Concordia Ch,7389,6,3,2,9,18,25,-7,11
FCSB,7390,1,8,5,1,24,12,12,29
CFR Cluj,7390,2,6,7,1,15,7,8,25
FC Botosani,7390,3,4,5,5,8,14,-6,17
Universitate,7390,4,3,6,5,14,19,-5,15
D Bucuresti,7390,5,3,4,7,16,22,-6,13
Concordia Ch,7390,6,3,3,8,20,23,-3,12
FCSB,7391,1,8,6,0,26,12,14,30
CFR Cluj,7391,2,5,7,2,16,11,5,22
D Bucuresti,7391,3,5,4,5,23,20,3,19
Universitate,7391,4,3,7,4,17,21,-4,16
FC Botosani,7391,5,4,4,6,8,16,-8,16
Concordia Ch,7391,6,2,2,10,17,27,-10,8
FCSB,7392,1,8,6,0,25,10,15,30
CFR Cluj,7392,2,5,8,1,13,7,6,23
D Bucuresti,7392,3,5,4,5,22,19,3,19
FC Botosani,7392,4,4,4,6,8,17,-9,16
Universitate,7392,5,3,6,5,14,20,-6,15
Concordia Ch,7392,6,2,2,10,16,25,-9,8
FCSB,7393,1,8,6,0,26,12,14,30
CFR Cluj,7393,2,5,7,2,16,11,5,22
D Bucuresti,7393,3,4,5,5,18,19,-1,17
Universitate,7393,4,3,7,4,19,23,-4,16
FC Botosani,7393,5,3,4,7,6,15,-9,13
Concordia Ch,7393,6,3,3,8,18,23,-5,12
FCSB,7394,1,8,6,0,27,13,14,30
CFR Cluj,7394,2,5,7,2,15,10,5,22
Universitate,7394,3,3,7,4,19,23,-4,16
FC Botosani,7394,4,4,4,6,6,14,-8,16
D Bucuresti,7394,5,3,5,6,16,19,-3,14
Concordia Ch,7394,6,3,3,8,17,21,-4,12
FCSB,7395,1,7,7,0,26,13,13,28
CFR Cluj,7395,2,5,8,1,16,10,6,23
D Bucuresti,7395,3,4,5,5,20,19,1,17
Universitate,7395,4,3,7,4,16,20,-4,16
FC Botosani,7395,5,3,5,6,5,14,-9,14
Concordia Ch,7395,6,3,2,9,18,25,-7,11
FCSB,7396,1,8,5,1,25,11,14,29
CFR Cluj,7396,2,6,6,2,16,9,7,24
D Bucuresti,7396,3,4,5,5,18,19,-1,17
Universitate,7396,4,4,5,5,15,21,-6,17
FC Botosani,7396,5,3,5,6,5,13,-8,14
Concordia Ch,7396,6,2,4,8,16,22,-6,10
FCSB,7397,1,8,5,1,25,12,13,29
CFR Cluj,7397,2,6,7,1,16,8,8,25
D Bucuresti,7397,3,3,6,5,20,22,-2,15
Universitate,7397,4,3,6,5,15,21,-6,15
FC Botosani,7397,5,3,6,5,8,15,-7,15
Concordia Ch,7397,6,2,4,8,18,24,-6,10
FCSB,7398,1,7,6,1,24,12,12,27
CFR Cluj,7398,2,6,7,1,16,8,8,25
Universitate,7398,3,4,5,5,15,20,-5,17
D Bucuresti,7398,4,4,4,6,18,21,-3,16
FC Botosani,7398,5,4,4,6,7,13,-6,16
Concordia Ch,7398,6,3,2,9,17,23,-6,11
FCSB,7399,1,8,6,0,25,11,14,30
CFR Cluj,7399,2,5,8,1,15,9,6,23
Universitate,7399,3,3,6,5,15,20,-5,15
Concordia Ch,7399,4,4,2,8,19,22,-3,14
D Bucuresti,7399,5,3,5,6,18,22,-4,14
FC Botosani,7399,6,3,5,6,6,14,-8,14
CFR Cluj,7400,1,7,6,1,16,7,9,27
FCSB,7400,2,7,5,2,23,12,11,26
Universitate,7400,3,4,5,5,15,20,-5,17
D Bucuresti,7400,4,4,4,6,17,20,-3,16
FC Botosani,7400,5,4,4,6,6,13,-7,16
Concordia Ch,7400,6,3,2,9,17,22,-5,11
FCSB,7401,1,8,5,1,26,11,15,29
CFR Cluj,7401,2,7,6,1,15,7,8,27
D Bucuresti,7401,3,4,4,6,22,23,-1,16
Universitate,7401,4,3,5,6,14,22,-8,14
FC Botosani,7401,5,3,5,6,7,17,-10,14
Concordia Ch,7401,6,3,3,8,18,22,-4,12
FCSB,7402,1,7,7,0,25,12,13,28
CFR Cluj,7402,2,5,7,2,14,9,5,22
Universitate,7402,3,4,6,4,16,19,-3,18
D Bucuresti,7402,4,3,6,5,16,18,-2,15
FC Botosani,7402,5,3,6,5,5,12,-7,15
Concordia Ch,7402,6,2,4,8,15,21,-6,10
FCSB,7403,1,8,5,1,26,13,13,29
CFR Cluj,7403,2,7,6,1,16,8,8,27
FC Botosani,7403,3,5,4,5,8,13,-5,19
Universitate,7403,4,3,5,6,17,23,-6,14
D Bucuresti,7403,5,3,4,7,17,22,-5,13
Concordia Ch,7403,6,3,2,9,17,22,-5,11
FCSB,7404,1,9,5,0,27,11,16,32
CFR Cluj,7404,2,6,6,2,15,9,6,24
D Bucuresti,7404,3,4,5,5,18,19,-1,17
FC Botosani,7404,4,4,4,6,7,14,-7,16
Universitate,7404,5,3,5,6,15,22,-7,14
Concordia Ch,7404,6,2,3,9,17,24,-7,9
FCSB,7405,1,8,5,1,26,13,13,29
CFR Cluj,7405,2,7,6,1,17,8,9,27
FC Botosani,7405,3,4,5,5,8,13,-5,17
Universitate,7405,4,3,5,6,15,22,-7,14
D Bucuresti,7405,5,3,4,7,17,22,-5,13
Concordia Ch,7405,6,3,3,8,16,21,-5,12
FCSB,7406,1,8,5,1,25,12,13,29
CFR Cluj,7406,2,5,6,3,14,10,4,21
Universitate,7406,3,5,5,4,16,18,-2,20
D Bucuresti,7406,4,4,4,6,19,21,-2,16
Concordia Ch,7406,5,4,2,8,18,22,-4,14
FC Botosani,7406,6,3,4,7,6,15,-9,13
FCSB,7407,1,9,5,0,29,12,17,32
CFR Cluj,7407,2,6,6,2,15,11,4,24
D Bucuresti,7407,3,4,4,6,21,20,1,16
Concordia Ch,7407,4,4,2,8,17,21,-4,14
Universitate,7407,5,3,5,6,15,21,-6,14
FC Botosani,7407,6,3,4,7,6,18,-12,13
FCSB,7408,1,8,5,1,28,14,14,29
CFR Cluj,7408,2,5,7,2,14,11,3,22
Universitate,7408,3,4,6,4,19,21,-2,18
FC Botosani,7408,4,4,4,6,7,14,-7,16
D Bucuresti,7408,5,3,5,6,19,23,-4,14
Concordia Ch,7408,6,3,3,8,20,24,-4,12
FCSB,7409,1,9,5,0,25,10,15,32
CFR Cluj,7409,2,5,6,3,13,9,4,21
D Bucuresti,7409,3,4,5,5,20,21,-1,17
Universitate,7409,4,4,5,5,15,19,-4,17
FC Botosani,7409,5,4,4,6,8,14,-6,16
Concordia Ch,7409,6,2,3,9,19,27,-8,9
FCSB,7410,1,8,5,1,27,13,14,29
CFR Cluj,7410,2,5,6,3,15,12,3,21
Universitate,7410,3,5,5,4,18,20,-2,20
D Bucuresti,7410,4,4,4,6,18,20,-2,16
FC Botosani,7410,5,4,4,6,10,15,-5,16
Concordia Ch,7410,6,3,2,9,17,25,-8,11
FCSB,7411,1,7,7,0,24,11,13,28
CFR Cluj,7411,2,6,7,1,16,8,8,25
D Bucuresti,7411,3,4,4,6,19,21,-2,16
FC Botosani,7411,4,4,4,6,7,14,-7,16
Universitate,7411,5,3,6,5,16,22,-6,15
Concordia Ch,7411,6,3,2,9,18,24,-6,11
FCSB,7412,1,8,5,1,25,13,12,29
CFR Cluj,7412,2,5,6,3,13,9,4,21
Universitate,7412,3,5,5,4,18,19,-1,20
FC Botosani,7412,4,5,4,5,9,13,-4,19
D Bucuresti,7412,5,3,4,7,17,23,-6,13
Concordia Ch,7412,6,3,2,9,17,22,-5,11
FCSB,7413,1,7,6,1,24,12,12,27
CFR Cluj,7413,2,7,6,1,15,7,8,27
D Bucuresti,7413,3,4,5,5,19,20,-1,17
FC Botosani,7413,4,4,5,5,8,13,-5,17
Universitate,7413,5,3,6,5,15,20,-5,15
Concordia Ch,7413,6,2,2,10,16,25,-9,8
FCSB,7414,1,8,5,1,24,13,11,29
CFR Cluj,7414,2,6,6,2,14,8,6,24
D Bucuresti,7414,3,4,5,5,19,20,-1,17
Universitate,7414,4,4,5,5,17,19,-2,17
FC Botosani,7414,5,4,5,5,8,14,-6,17
Concordia Ch,7414,6,2,2,10,15,23,-8,8
FCSB,7415,1,7,6,1,23,11,12,27
CFR Cluj,7415,2,6,7,1,15,7,8,25
Universitate,7415,3,4,5,5,15,20,-5,17
FC Botosani,7415,4,4,5,5,7,12,-5,17
D Bucuresti,7415,5,3,6,5,17,19,-2,15
Concordia Ch,7415,6,2,3,9,16,24,-8,9
FCSB,7416,1,7,6,1,24,12,12,27
CFR Cluj,7416,2,6,7,1,17,8,9,25
FC Botosani,7416,3,5,4,5,10,12,-2,19
Universitate,7416,4,4,5,5,15,21,-6,17
D Bucuresti,7416,5,3,4,7,17,22,-5,13
Concordia Ch,7416,6,3,2,9,18,26,-8,11
FCSB,7417,1,8,5,1,25,11,14,29
CFR Cluj,7417,2,7,6,1,15,7,8,27
FC Botosani,7417,3,5,4,5,10,13,-3,19
D Bucuresti,7417,4,4,4,6,17,21,-4,16
Universitate,7417,5,3,5,6,14,21,-7,14
Concordia Ch,7417,6,2,2,10,16,24,-8,8
FCSB,7418,1,7,7,0,27,14,13,28
CFR Cluj,7418,2,6,7,1,15,8,7,25
Universitate,7418,3,3,6,5,17,22,-5,15
FC Botosani,7418,4,3,6,5,6,13,-7,15
D Bucuresti,7418,5,3,5,6,18,21,-3,14
Concordia Ch,7418,6,3,3,8,17,22,-5,12
FCSB,7419,1,9,5,0,26,11,15,32
CFR Cluj,7419,2,6,6,2,17,9,8,24
D Bucuresti,7419,3,4,4,6,21,20,1,16
Concordia Ch,7419,4,4,2,8,19,23,-4,14
Universitate,7419,5,3,5,6,14,22,-8,14
FC Botosani,7419,6,3,4,7,6,18,-12,13
FCSB,7420,1,9,5,0,26,10,16,32
CFR Cluj,7420,2,5,7,2,13,9,4,22
FC Botosani,7420,3,5,4,5,10,14,-4,19
D Bucuresti,7420,4,4,4,6,20,23,-3,16
Universitate,7420,5,3,6,5,14,19,-5,15
Concordia Ch,7420,6,2,2,10,18,26,-8,8
FCSB,7421,1,9,5,0,26,11,15,32
CFR Cluj,7421,2,5,6,3,15,13,2,21
D Bucuresti,7421,3,4,5,5,19,20,-1,17
Universitate,7421,4,4,5,5,18,20,-2,17
FC Botosani,7421,5,3,4,7,6,15,-9,13
Concordia Ch,7421,6,3,3,8,17,22,-5,12
FCSB,7422,1,8,6,0,27,11,16,30
CFR Cluj,7422,2,5,8,1,15,9,6,23
D Bucuresti,7422,3,4,4,6,17,20,-3,16
FC Botosani,7422,4,4,4,6,8,13,-5,16
Universitate,7422,5,3,6,5,15,22,-7,15
Concordia Ch,7422,6,3,2,9,17,24,-7,11
FCSB,7423,1,7,6,1,24,12,12,27
CFR Cluj,7423,2,5,8,1,15,9,6,23
Universitate,7423,3,4,6,4,16,19,-3,18
FC Botosani,7423,4,4,5,5,7,13,-6,17
D Bucuresti,7423,5,3,5,6,18,22,-4,14
Concordia Ch,7423,6,3,2,9,18,23,-5,11
FCSB,7424,1,8,5,1,29,16,13,29
CFR Cluj,7424,2,6,6,2,16,10,6,24
FC Botosani,7424,3,5,4,5,10,14,-4,19
Universitate,7424,4,4,5,5,18,22,-4,17
D Bucuresti,7424,5,4,4,6,19,21,-2,16
Concordia Ch,7424,6,2,2,10,17,26,-9,8
FCSB,7425,1,8,5,1,27,13,14,29
CFR Cluj,7425,2,6,6,2,18,10,8,24
Universitate,7425,3,4,5,5,17,24,-7,17
D Bucuresti,7425,4,4,4,6,17,19,-2,16
FC Botosani,7425,5,4,4,6,6,13,-7,16
Concordia Ch,7425,6,3,2,9,16,22,-6,11
FCSB,7426,1,9,5,0,27,10,17,32
CFR Cluj,7426,2,5,6,3,13,12,1,21
D Bucuresti,7426,3,4,5,5,19,19,0,17
Universitate,7426,4,4,5,5,17,20,-3,17
FC Botosani,7426,5,4,4,6,8,15,-7,16
Concordia Ch,7426,6,2,3,9,15,23,-8,9
FCSB,7427,1,9,5,0,27,11,16,32
CFR Cluj,7427,2,5,7,2,14,10,4,22
D Bucuresti,7427,3,4,4,6,19,23,-4,16
FC Botosani,7427,4,4,4,6,6,13,-7,16
Universitate,7427,5,3,6,5,16,21,-5,15
Concordia Ch,7427,6,3,2,9,20,24,-4,11
FCSB,7428,1,7,6,1,25,13,12,27
CFR Cluj,7428,2,5,8,1,16,10,6,23
Universitate,7428,3,4,6,4,16,19,-3,18
D Bucuresti,7428,4,4,4,6,19,20,-1,16
Concordia Ch,7428,5,4,2,8,18,22,-4,14
FC Botosani,7428,6,3,4,7,5,15,-10,13
FCSB,7429,1,8,6,0,26,11,15,30
CFR Cluj,7429,2,5,6,3,13,10,3,21
Universitate,7429,3,4,6,4,16,19,-3,18
D Bucuresti,7429,4,4,5,5,19,20,-1,17
FC Botosani,7429,5,4,5,5,9,13,-4,17
Concordia Ch,7429,6,2,2,10,16,26,-10,8
FCSB,7430,1,7,6,1,24,12,12,27
CFR Cluj,7430,2,6,6,2,15,9,6,24
Universitate,7430,3,4,6,4,15,18,-3,18
D Bucuresti,7430,4,3,6,5,18,20,-2,15
FC Botosani,7430,5,3,5,6,7,17,-10,14
Concordia Ch,7430,6,3,3,8,20,23,-3,12
FCSB,7431,1,8,6,0,26,11,15,30
CFR Cluj,7431,2,5,7,2,13,9,4,22
Universitate,7431,3,3,7,4,15,19,-4,16
D Bucuresti,7431,4,3,6,5,18,20,-2,15
FC Botosani,7431,5,3,5,6,7,17,-10,14
Concordia Ch,7431,6,3,3,8,20,23,-3,12
FCSB,7432,1,8,5,1,27,13,14,29
CFR Cluj,7432,2,6,6,2,16,9,7,24
D Bucuresti,7432,3,4,5,5,20,19,1,17
Universitate,7432,4,4,5,5,15,21,-6,17
FC Botosani,7432,5,3,6,5,5,12,-7,15
Concordia Ch,7432,6,2,3,9,16,25,-9,9
FCSB,7433,1,8,5,1,25,16,9,29
CFR Cluj,7433,2,5,6,3,13,9,4,21
Universitate,7433,3,5,5,4,21,19,2,20
D Bucuresti,7433,4,5,4,5,20,20,0,19
FC Botosani,7433,5,3,5,6,8,16,-8,14
Concordia Ch,7433,6,2,3,9,16,23,-7,9
FCSB,7434,1,8,6,0,25,11,14,30
CFR Cluj,7434,2,6,6,2,15,9,6,24
D Bucuresti,7434,3,4,4,6,18,19,-1,16
FC Botosani,7434,4,4,4,6,6,14,-8,16
Universitate,7434,5,3,6,5,16,21,-5,15
Concordia Ch,7434,6,3,2,9,16,22,-6,11
CFR Cluj,7435,1,7,6,1,16,8,8,27
FCSB,7435,2,7,5,2,23,13,10,26
Universitate,7435,3,4,5,5,17,20,-3,17
D Bucuresti,7435,4,4,4,6,19,20,-1,16
FC Botosani,7435,5,3,5,6,5,14,-9,14
Concordia Ch,7435,6,3,3,8,17,22,-5,12
FCSB,7436,1,7,5,2,24,16,8,26
CFR Cluj,7436,2,6,6,2,15,8,7,24
Universitate,7436,3,5,5,4,19,19,0,20
D Bucuresti,7436,4,4,5,5,20,19,1,17
FC Botosani,7436,5,3,5,6,6,16,-10,14
Concordia Ch,7436,6,2,4,8,17,23,-6,10
FCSB,7437,1,7,6,1,24,13,11,27
CFR Cluj,7437,2,6,6,2,15,8,7,24
Universitate,7437,3,4,6,4,16,19,-3,18
D Bucuresti,7437,4,4,4,6,19,21,-2,16
Concordia Ch,7437,5,4,2,8,18,22,-4,14
FC Botosani,7437,6,3,4,7,6,15,-9,13
FCSB,7438,1,7,7,0,24,11,13,28
CFR Cluj,7438,2,5,7,2,14,9,5,22
Universitate,7438,3,4,6,4,15,18,-3,18
FC Botosani,7438,4,3,6,5,5,12,-7,15
D Bucuresti,7438,5,3,5,6,16,20,-4,14
Concordia Ch,7438,6,3,3,8,17,21,-4,12
FCSB,7439,1,8,6,0,28,13,15,30
CFR Cluj,7439,2,5,7,2,16,12,4,22
Universitate,7439,3,3,7,4,16,20,-4,16
Concordia Ch,7439,4,4,2,8,22,24,-2,14
D Bucuresti,7439,5,3,5,6,20,25,-5,14
FC Botosani,7439,6,3,5,6,8,16,-8,14
FCSB,7440,1,7,6,1,24,12,12,27
CFR Cluj,7440,2,7,6,1,16,8,8,27
D Bucuresti,7440,3,3,6,5,18,20,-2,15
Universitate,7440,4,3,6,5,16,21,-5,15
FC Botosani,7440,5,3,5,6,7,15,-8,14
Concordia Ch,7440,6,3,3,8,18,23,-5,12
FCSB,7441,1,7,7,0,25,12,13,28
CFR Cluj,7441,2,6,7,1,15,8,7,25
Universitate,7441,3,3,6,5,15,20,-5,15
D Bucuresti,7441,4,3,5,6,16,19,-3,14
Concordia Ch,7441,5,4,2,8,17,21,-4,14
FC Botosani,7441,6,3,5,6,5,13,-8,14
FCSB,7442,1,8,6,0,25,11,14,30
CFR Cluj,7442,2,6,7,1,17,9,8,25
D Bucuresti,7442,3,4,5,5,20,20,0,17
Universitate,7442,4,3,5,6,15,22,-7,14
FC Botosani,7442,5,3,4,7,5,15,-10,13
Concordia Ch,7442,6,3,3,8,18,23,-5,12
FCSB,7443,1,9,5,0,28,11,17,32
CFR Cluj,7443,2,6,6,2,15,11,4,24
D Bucuresti,7443,3,4,4,6,18,20,-2,16
Universitate,7443,4,3,5,6,14,20,-6,14
FC Botosani,7443,5,3,5,6,5,13,-8,14
Concordia Ch,7443,6,3,3,8,17,22,-5,12
FCSB,7444,1,7,6,1,24,12,12,27
CFR Cluj,7444,2,6,7,1,14,7,7,25
Universitate,7444,3,4,5,5,16,20,-4,17
D Bucuresti,7444,4,4,4,6,20,21,-1,16
Concordia Ch,7444,5,4,2,8,21,23,-2,14
FC Botosani,7444,6,3,4,7,5,17,-12,13
FCSB,7445,1,8,6,0,26,11,15,30
CFR Cluj,7445,2,5,6,3,15,12,3,21
Universitate,7445,3,4,6,4,18,21,-3,18
FC Botosani,7445,4,4,5,5,7,13,-6,17
D Bucuresti,7445,5,3,4,7,16,20,-4,13
Concordia Ch,7445,6,3,3,8,17,22,-5,12
FCSB,7446,1,7,5,2,23,13,10,26
CFR Cluj,7446,2,6,7,1,14,7,7,25
Universitate,7446,3,4,6,4,16,18,-2,18
D Bucuresti,7446,4,4,4,6,17,19,-2,16
FC Botosani,7446,5,4,4,6,7,14,-7,16
Concordia Ch,7446,6,3,2,9,17,23,-6,11
FCSB,7447,1,8,5,1,24,12,12,29
CFR Cluj,7447,2,6,6,2,14,8,6,24
FC Botosani,7447,3,5,4,5,8,13,-5,19
Universitate,7447,4,4,5,5,16,19,-3,17
D Bucuresti,7447,5,3,4,7,19,23,-4,13
Concordia Ch,7447,6,3,2,9,18,24,-6,11
FCSB,7448,1,7,6,1,23,12,11,27
CFR Cluj,7448,2,6,7,1,15,7,8,25
FC Botosani,7448,3,5,4,5,8,13,-5,19
Universitate,7448,4,3,7,4,14,18,-4,16
D Bucuresti,7448,5,3,4,7,17,21,-4,13
Concordia Ch,7448,6,3,2,9,18,24,-6,11
FCSB,7449,1,8,5,1,28,12,16,29
CFR Cluj,7449,2,5,7,2,13,11,2,22
Universitate,7449,3,4,6,4,16,19,-3,18
FC Botosani,7449,4,4,5,5,10,15,-5,17
D Bucuresti,7449,5,3,5,6,20,23,-3,14
Concordia Ch,7449,6,3,2,9,17,24,-7,11
FCSB,7450,1,8,5,1,26,12,14,29
CFR Cluj,7450,2,6,6,2,15,9,6,24
Universitate,7450,3,4,5,5,17,22,-5,17
D Bucuresti,7450,4,4,4,6,18,23,-5,16
FC Botosani,7450,5,4,4,6,8,14,-6,16
Concordia Ch,7450,6,3,2,9,19,23,-4,11
FCSB,7451,1,9,5,0,27,11,16,32
CFR Cluj,7451,2,6,6,2,15,9,6,24
D Bucuresti,7451,3,3,5,6,17,20,-3,14
Concordia Ch,7451,4,4,2,8,17,21,-4,14
Universitate,7451,5,3,5,6,15,22,-7,14
FC Botosani,7451,6,3,5,6,6,14,-8,14
FCSB,7452,1,9,5,0,26,10,16,32
CFR Cluj,7452,2,5,7,2,14,9,5,22
D Bucuresti,7452,3,4,4,6,18,20,-2,16
FC Botosani,7452,4,4,4,6,7,13,-6,16
Universitate,7452,5,3,6,5,15,21,-6,15
Concordia Ch,7452,6,3,2,9,17,24,-7,11
FCSB,7453,1,9,5,0,25,10,15,32
CFR Cluj,7453,2,5,7,2,16,11,5,22
D Bucuresti,7453,3,5,4,5,19,18,1,19
Universitate,7453,4,3,6,5,17,22,-5,15
FC Botosani,7453,5,3,5,6,6,14,-8,14
Concordia Ch,7453,6,2,3,9,16,24,-8,9
FCSB,7454,1,7,7,0,25,12,13,28
CFR Cluj,7454,2,5,8,1,14,8,6,23
D Bucuresti,7454,3,5,4,5,20,18,2,19
Universitate,7454,4,3,7,4,15,19,-4,16
FC Botosani,7454,5,3,4,7,5,15,-10,13
Concordia Ch,7454,6,3,2,9,16,23,-7,11
FCSB,7455,1,7,6,1,24,12,12,27
CFR Cluj,7455,2,5,7,2,13,8,5,22
Universitate,7455,3,5,5,4,17,19,-2,20
D Bucuresti,7455,4,5,4,5,22,19,3,19
FC Botosani,7455,5,3,5,6,5,16,-11,14
Concordia Ch,7455,6,2,3,9,16,23,-7,9
FCSB,7456,1,7,6,1,24,12,12,27
CFR Cluj,7456,2,7,6,1,15,7,8,27
D Bucuresti,7456,3,4,4,6,18,20,-2,16
Universitate,7456,4,3,6,5,15,20,-5,15
Concordia Ch,7456,5,4,2,8,20,21,-1,14
FC Botosani,7456,6,3,4,7,6,18,-12,13
FCSB,7457,1,7,6,1,23,11,12,27
CFR Cluj,7457,2,6,7,1,16,9,7,25
FC Botosani,7457,3,5,4,5,7,12,-5,19
Universitate,7457,4,3,7,4,16,20,-4,16
D Bucuresti,7457,5,3,4,7,16,21,-5,13
Concordia Ch,7457,6,3,2,9,17,22,-5,11
FCSB,7458,1,9,5,0,26,10,16,32
CFR Cluj,7458,2,6,6,2,14,9,5,24
D Bucuresti,7458,3,3,5,6,16,19,-3,14
Concordia Ch,7458,4,4,2,8,17,21,-4,14
Universitate,7458,5,3,5,6,14,20,-6,14
FC Botosani,7458,6,3,5,6,5,13,-8,14
FCSB,7459,1,7,6,1,23,11,12,27
CFR Cluj,7459,2,5,7,2,14,9,5,22
Universitate,7459,3,5,5,4,17,19,-2,20
FC Botosani,7459,4,4,5,5,8,13,-5,17
D Bucuresti,7459,5,3,5,6,17,21,-4,14
Concordia Ch,7459,6,3,2,9,17,23,-6,11
FCSB,7460,1,8,5,1,25,15,10,29
CFR Cluj,7460,2,5,7,2,14,9,5,22
Universitate,7460,3,4,6,4,18,18,0,18
D Bucuresti,7460,4,4,4,6,19,23,-4,16
FC Botosani,7460,5,4,4,6,8,15,-7,16
Concordia Ch,7460,6,3,2,9,18,22,-4,11
FCSB,7461,1,8,6,0,24,10,14,30
CFR Cluj,7461,2,5,7,2,15,10,5,22
D Bucuresti,7461,3,5,4,5,20,20,0,19
Universitate,7461,4,3,7,4,16,20,-4,16
FC Botosani,7461,5,4,4,6,9,15,-6,16
Concordia Ch,7461,6,2,2,10,15,24,-9,8
FCSB,7462,1,8,5,1,28,14,14,29
CFR Cluj,7462,2,6,6,2,16,11,5,24
D Bucuresti,7462,3,4,5,5,18,19,-1,17
Universitate,7462,4,4,5,5,18,22,-4,17
FC Botosani,7462,5,3,5,6,6,14,-8,14
Concordia Ch,7462,6,2,4,8,17,23,-6,10
FCSB,7463,1,7,6,1,24,13,11,27
CFR Cluj,7463,2,6,6,2,15,8,7,24
Universitate,7463,3,4,6,4,16,19,-3,18
FC Botosani,7463,4,4,5,5,7,13,-6,17
D Bucuresti,7463,5,3,5,6,16,19,-3,14
Concordia Ch,7463,6,3,2,9,17,23,-6,11
FCSB,7464,1,8,5,1,25,13,12,29
CFR Cluj,7464,2,6,6,2,16,9,7,24
Universitate,7464,3,4,5,5,17,21,-4,17
FC Botosani,7464,4,4,4,6,7,14,-7,16
Concordia Ch,7464,5,4,2,8,19,23,-4,14
D Bucuresti,7464,6,3,4,7,17,21,-4,13
FCSB,7465,1,7,7,0,23,10,13,28
CFR Cluj,7465,2,6,7,1,15,8,7,25
D Bucuresti,7465,3,4,4,6,23,23,0,16
FC Botosani,7465,4,4,4,6,7,17,-10,16
Universitate,7465,5,3,6,5,15,20,-5,15
Concordia Ch,7465,6,3,2,9,21,26,-5,11
FCSB,7466,1,8,5,1,27,13,14,29
CFR Cluj,7466,2,5,7,2,15,11,4,22
Universitate,7466,3,4,6,4,17,20,-3,18
D Bucuresti,7466,4,4,4,6,18,20,-2,16
FC Botosani,7466,5,4,4,6,6,13,-7,16
Concordia Ch,7466,6,3,2,9,17,23,-6,11
FCSB,7467,1,8,6,0,26,12,14,30
CFR Cluj,7467,2,5,8,1,16,10,6,23
D Bucuresti,7467,3,5,4,5,21,19,2,19
Universitate,7467,4,3,6,5,17,22,-5,15
FC Botosani,7467,5,3,4,7,6,16,-10,13
Concordia Ch,7467,6,3,2,9,17,24,-7,11
FCSB,7468,1,9,5,0,29,12,17,32
CFR Cluj,7468,2,6,6,2,17,10,7,24
D Bucuresti,7468,3,4,4,6,17,22,-5,16
FC Botosani,7468,4,4,4,6,7,13,-6,16
Universitate,7468,5,3,5,6,16,25,-9,14
Concordia Ch,7468,6,3,2,9,19,23,-4,11
FCSB,7469,1,8,6,0,29,14,15,30
CFR Cluj,7469,2,6,7,1,17,10,7,25
FC Botosani,7469,3,4,5,5,6,12,-6,17
D Bucuresti,7469,4,3,6,5,17,19,-2,15
Universitate,7469,5,3,5,6,17,24,-7,14
Concordia Ch,7469,6,2,3,9,16,23,-7,9
FCSB,7470,1,9,5,0,28,11,17,32
CFR Cluj,7470,2,5,7,2,15,11,4,22
FC Botosani,7470,3,4,5,5,8,13,-5,17
Universitate,7470,4,3,6,5,15,21,-6,15
D Bucuresti,7470,5,3,4,7,19,24,-5,13
Concordia Ch,7470,6,3,3,8,18,23,-5,12
FCSB,7471,1,9,5,0,26,10,16,32
CFR Cluj,7471,2,6,6,2,15,9,6,24
D Bucuresti,7471,3,5,4,5,21,19,2,19
FC Botosani,7471,4,4,4,6,7,14,-7,16
Universitate,7471,5,3,5,6,14,21,-7,14
Concordia Ch,7471,6,2,2,10,16,26,-10,8
FCSB,7472,1,7,6,1,24,12,12,27
CFR Cluj,7472,2,5,8,1,14,8,6,23
Universitate,7472,3,4,6,4,15,18,-3,18
Concordia Ch,7472,4,4,2,8,19,22,-3,14
D Bucuresti,7472,5,3,5,6,18,21,-3,14
FC Botosani,7472,6,3,5,6,6,15,-9,14
FCSB,7473,1,9,5,0,27,11,16,32
CFR Cluj,7473,2,5,6,3,14,11,3,21
D Bucuresti,7473,3,4,5,5,19,20,-1,17
Universitate,7473,4,4,5,5,15,19,-4,17
FC Botosani,7473,5,3,4,7,6,16,-10,13
Concordia Ch,7473,6,3,3,8,20,24,-4,12
FCSB,7474,1,8,5,1,25,12,13,29
CFR Cluj,7474,2,6,6,2,17,11,6,24
Universitate,7474,3,4,5,5,17,21,-4,17
FC Botosani,7474,4,4,5,5,8,14,-6,17
D Bucuresti,7474,5,3,6,5,19,21,-2,15
Concordia Ch,7474,6,2,3,9,18,25,-7,9
FCSB,7475,1,8,6,0,25,11,14,30
CFR Cluj,7475,2,6,7,1,16,8,8,25
D Bucuresti,7475,3,4,4,6,19,21,-2,16
Universitate,7475,4,3,5,6,14,21,-7,14
FC Botosani,7475,5,3,5,6,6,14,-8,14
Concordia Ch,7475,6,3,3,8,17,22,-5,12
FCSB,7476,1,9,5,0,28,12,16,32
CFR Cluj,7476,2,6,6,2,17,11,6,24
D Bucuresti,7476,3,5,4,5,22,18,4,19
Universitate,7476,4,3,5,6,15,22,-7,14
FC Botosani,7476,5,3,4,7,6,18,-12,13
Concordia Ch,7476,6,3,2,9,17,24,-7,11
FCSB,7477,1,7,6,1,24,12,12,27
CFR Cluj,7477,2,6,7,1,15,8,7,25
FC Botosani,7477,3,4,5,5,9,14,-5,17
Universitate,7477,4,3,7,4,14,18,-4,16
D Bucuresti,7477,5,3,5,6,18,22,-4,14
Concordia Ch,7477,6,2,4,8,15,21,-6,10
FCSB,7478,1,7,7,0,25,12,13,28
CFR Cluj,7478,2,6,7,1,17,8,9,25
D Bucuresti,7478,3,4,5,5,19,18,1,17
Universitate,7478,4,3,6,5,15,22,-7,15
FC Botosani,7478,5,3,4,7,5,18,-13,13
Concordia Ch,7478,6,3,3,8,18,21,-3,12
FCSB,7479,1,8,6,0,26,12,14,30
CFR Cluj,7479,2,6,7,1,19,9,10,25
D Bucuresti,7479,3,4,4,6,18,20,-2,16
FC Botosani,7479,4,3,5,6,9,17,-8,14
Universitate,7479,5,3,5,6,14,23,-9,14
Concordia Ch,7479,6,3,3,8,19,24,-5,12
FCSB,7480,1,7,6,1,24,13,11,27
CFR Cluj,7480,2,6,7,1,16,8,8,25
Universitate,7480,3,4,5,5,16,20,-4,17
D Bucuresti,7480,4,4,4,6,18,19,-1,16
FC Botosani,7480,5,3,5,6,6,15,-9,14
Concordia Ch,7480,6,3,3,8,17,22,-5,12
FCSB,7481,1,8,6,0,24,10,14,30
CFR Cluj,7481,2,6,7,1,17,8,9,25
D Bucuresti,7481,3,4,4,6,18,20,-2,16
FC Botosani,7481,4,4,4,6,7,14,-7,16
Universitate,7481,5,3,5,6,15,23,-8,14
Concordia Ch,7481,6,3,2,9,18,24,-6,11
FCSB,7482,1,7,6,1,24,14,10,27
CFR Cluj,7482,2,6,7,1,16,9,7,25
Universitate,7482,3,4,5,5,18,20,-2,17
D Bucuresti,7482,4,4,4,6,19,22,-3,16
FC Botosani,7482,5,3,5,6,7,15,-8,14
Concordia Ch,7482,6,3,3,8,19,23,-4,12
FCSB,7483,1,8,6,0,25,11,14,30
CFR Cluj,7483,2,6,6,2,16,9,7,24
D Bucuresti,7483,3,4,5,5,20,21,-1,17
FC Botosani,7483,4,4,5,5,13,15,-2,17
Universitate,7483,5,3,6,5,14,20,-6,15
Concordia Ch,7483,6,2,2,10,15,27,-12,8
FCSB,7484,1,8,5,1,26,13,13,29
CFR Cluj,7484,2,5,7,2,14,9,5,22
FC Botosani,7484,3,5,4,5,8,13,-5,19
Universitate,7484,4,4,6,4,16,19,-3,18
D Bucuresti,7484,5,4,4,6,17,19,-2,16
Concordia Ch,7484,6,2,2,10,16,24,-8,8
FCSB,7485,1,9,5,0,28,11,17,32
CFR Cluj,7485,2,6,6,2,18,11,7,24
D Bucuresti,7485,3,4,5,5,21,20,1,17
FC Botosani,7485,4,4,4,6,10,16,-6,16
Universitate,7485,5,3,5,6,15,24,-9,14
Concordia Ch,7485,6,2,3,9,18,28,-10,9
FCSB,7486,1,8,6,0,25,11,14,30
CFR Cluj,7486,2,5,6,3,13,9,4,21
Universitate,7486,3,4,6,4,16,19,-3,18
FC Botosani,7486,4,4,4,6,6,13,-7,16
Concordia Ch,7486,5,4,2,8,18,22,-4,14
D Bucuresti,7486,6,3,4,7,17,21,-4,13
FCSB,7487,1,8,6,0,27,11,16,30
CFR Cluj,7487,2,5,8,1,15,9,6,23
FC Botosani,7487,3,5,4,5,9,12,-3,19
Universitate,7487,4,3,6,5,15,22,-7,15
D Bucuresti,7487,5,3,4,7,17,21,-4,13
Concordia Ch,7487,6,3,2,9,17,25,-8,11
FCSB,7488,1,7,6,1,24,14,10,27
CFR Cluj,7488,2,6,7,1,16,9,7,25
D Bucuresti,7488,3,4,5,5,18,19,-1,17
Universitate,7488,4,4,5,5,18,20,-2,17
FC Botosani,7488,5,4,4,6,8,14,-6,16
Concordia Ch,7488,6,2,3,9,17,25,-8,9
FCSB,7489,1,8,6,0,25,11,14,30
CFR Cluj,7489,2,6,7,1,15,8,7,25
D Bucuresti,7489,3,4,5,5,19,19,0,17
FC Botosani,7489,4,4,4,6,9,16,-7,16
Universitate,7489,5,3,5,6,16,22,-6,14
Concordia Ch,7489,6,2,3,9,18,26,-8,9
FCSB,7490,1,7,6,1,23,11,12,27
CFR Cluj,7490,2,6,7,1,15,7,8,25
Universitate,7490,3,4,5,5,15,20,-5,17
D Bucuresti,7490,4,4,4,6,18,20,-2,16
FC Botosani,7490,5,3,5,6,6,14,-8,14
Concordia Ch,7490,6,3,3,8,18,23,-5,12
FCSB,7491,1,7,6,1,23,11,12,27
CFR Cluj,7491,2,6,6,2,14,9,5,24
Universitate,7491,3,4,6,4,16,18,-2,18
D Bucuresti,7491,4,4,4,6,19,21,-2,16
FC Botosani,7491,5,3,5,6,6,15,-9,14
Concordia Ch,7491,6,3,3,8,19,23,-4,12
CFR Cluj,7492,1,7,6,1,18,9,9,27
FCSB,7492,2,7,5,2,24,13,11,26
Universitate,7492,3,4,5,5,16,21,-5,17
D Bucuresti,7492,4,4,4,6,18,19,-1,16
FC Botosani,7492,5,4,4,6,6,13,-7,16
Concordia Ch,7492,6,3,2,9,16,23,-7,11
FCSB,7493,1,9,5,0,28,11,17,32
CFR Cluj,7493,2,6,6,2,16,9,7,24
FC Botosani,7493,3,4,5,5,8,14,-6,17
Universitate,7493,4,3,5,6,14,23,-9,14
D Bucuresti,7493,5,3,4,7,18,23,-5,13
Concordia Ch,7493,6,3,3,8,17,21,-4,12
FCSB,7494,1,8,5,1,26,13,13,29
CFR Cluj,7494,2,6,7,1,16,8,8,25
D Bucuresti,7494,3,5,4,5,19,19,0,19
Universitate,7494,4,3,6,5,16,22,-6,15
FC Botosani,7494,5,3,5,6,7,15,-8,14
Concordia Ch,7494,6,2,3,9,16,23,-7,9
FCSB,7495,1,7,6,1,26,14,12,27
CFR Cluj,7495,2,5,7,2,15,10,5,22
Universitate,7495,3,5,5,4,17,19,-2,20
D Bucuresti,7495,4,4,4,6,18,21,-3,16
FC Botosani,7495,5,4,4,6,7,15,-8,16
Concordia Ch,7495,6,3,2,9,19,23,-4,11
FCSB,7496,1,8,5,1,26,13,13,29
CFR Cluj,7496,2,6,6,2,14,8,6,24
Universitate,7496,3,4,5,5,17,21,-4,17
FC Botosani,7496,4,4,5,5,8,12,-4,17
D Bucuresti,7496,5,3,6,5,16,18,-2,15
Concordia Ch,7496,6,2,3,9,15,24,-9,9
FCSB,7497,1,9,5,0,26,10,16,32
CFR Cluj,7497,2,6,6,2,14,8,6,24
D Bucuresti,7497,3,5,4,5,21,20,1,19
Universitate,7497,4,3,5,6,14,21,-7,14
FC Botosani,7497,5,3,5,6,6,14,-8,14
Concordia Ch,7497,6,2,3,9,16,24,-8,9
FCSB,7498,1,8,5,1,27,13,14,29
CFR Cluj,7498,2,6,6,2,15,8,7,24
D Bucuresti,7498,3,4,5,5,20,18,2,17
Universitate,7498,4,4,5,5,16,22,-6,17
FC Botosani,7498,5,3,4,7,6,19,-13,13
Concordia Ch,7498,6,3,3,8,18,22,-4,12
FCSB,7499,1,8,5,1,26,13,13,29
CFR Cluj,7499,2,6,6,2,14,9,5,24
D Bucuresti,7499,3,4,5,5,19,20,-1,17
Universitate,7499,4,4,5,5,17,20,-3,17
FC Botosani,7499,5,4,5,5,8,12,-4,17
Concordia Ch,7499,6,2,2,10,17,27,-10,8
FCSB,7500,1,9,5,0,27,11,16,32
CFR Cluj,7500,2,6,6,2,16,10,6,24
D Bucuresti,7500,3,5,4,5,20,18,2,19
FC Botosani,7500,4,4,4,6,7,15,-8,16
Universitate,7500,5,3,5,6,17,24,-7,14
Concordia Ch,7500,6,2,2,10,16,25,-9,8
FCSB,7501,1,8,6,0,26,12,14,30
CFR Cluj,7501,2,5,6,3,13,9,4,21
D Bucuresti,7501,3,5,4,5,18,18,0,19
Universitate,7501,4,4,6,4,17,20,-3,18
FC Botosani,7501,5,3,4,7,6,16,-10,13
Concordia Ch,7501,6,3,2,9,18,23,-5,11
FCSB,7502,1,9,5,0,26,10,16,32
CFR Cluj,7502,2,5,6,3,14,10,4,21
D Bucuresti,7502,3,5,4,5,20,20,0,19
Universitate,7502,4,4,5,5,16,21,-5,17
FC Botosani,7502,5,3,4,7,6,15,-9,13
Concordia Ch,7502,6,3,2,9,17,23,-6,11
FCSB,7503,1,8,6,0,26,12,14,30
CFR Cluj,7503,2,6,6,2,16,9,7,24
FC Botosani,7503,3,4,5,5,8,14,-6,17
Universitate,7503,4,3,6,5,17,23,-6,15
D Bucuresti,7503,5,3,5,6,16,20,-4,14
Concordia Ch,7503,6,3,2,9,19,24,-5,11
FCSB,7504,1,8,5,1,24,12,12,29
CFR Cluj,7504,2,6,6,2,14,8,6,24
Universitate,7504,3,4,5,5,16,19,-3,17
FC Botosani,7504,4,3,6,5,7,14,-7,15
D Bucuresti,7504,5,3,5,6,18,21,-3,14
Concordia Ch,7504,6,3,3,8,18,23,-5,12
FCSB,7505,1,8,6,0,27,13,14,30
CFR Cluj,7505,2,6,7,1,15,8,7,25
FC Botosani,7505,3,3,6,5,9,16,-7,15
D Bucuresti,7505,4,3,5,6,17,20,-3,14
Universitate,7505,5,3,5,6,16,22,-6,14
Concordia Ch,7505,6,3,3,8,19,24,-5,12
FCSB,7506,1,8,5,1,27,13,14,29
CFR Cluj,7506,2,6,6,2,14,10,4,24
Universitate,7506,3,4,5,5,17,20,-3,17
FC Botosani,7506,4,4,5,5,7,13,-6,17
D Bucuresti,7506,5,3,4,7,18,25,-7,13
Concordia Ch,7506,6,3,3,8,22,24,-2,12
FCSB,7507,1,8,6,0,27,12,15,30
CFR Cluj,7507,2,6,7,1,19,10,9,25
D Bucuresti,7507,3,5,4,5,21,21,0,19
FC Botosani,7507,4,4,4,6,7,14,-7,16
Universitate,7507,5,3,5,6,17,26,-9,14
Concordia Ch,7507,6,2,2,10,17,25,-8,8
FCSB,7508,1,8,6,0,24,10,14,30
CFR Cluj,7508,2,6,7,1,18,7,11,25
FC Botosani,7508,3,4,5,5,7,13,-6,17
Universitate,7508,4,3,5,6,14,24,-10,14
D Bucuresti,7508,5,3,4,7,19,24,-5,13
Concordia Ch,7508,6,3,3,8,19,23,-4,12
FCSB,7509,1,9,5,0,29,12,17,32
CFR Cluj,7509,2,6,6,2,15,10,5,24
FC Botosani,7509,3,3,6,5,6,13,-7,15
D Bucuresti,7509,4,3,5,6,17,21,-4,14
Universitate,7509,5,3,5,6,15,22,-7,14
Concordia Ch,7509,6,3,3,8,17,21,-4,12
CFR Cluj,7510,1,7,6,1,19,7,12,27
FCSB,7510,2,7,6,1,25,16,9,27
D Bucuresti,7510,3,4,5,5,18,19,-1,17
Universitate,7510,4,3,6,5,16,22,-6,15
FC Botosani,7510,5,3,6,5,5,12,-7,15
Concordia Ch,7510,6,2,3,9,16,23,-7,9
FCSB,7511,1,8,6,0,26,12,14,30
CFR Cluj,7511,2,5,8,1,15,9,6,23
FC Botosani,7511,3,4,5,5,6,12,-6,17
Universitate,7511,4,3,6,5,16,21,-5,15
D Bucuresti,7511,5,3,5,6,17,20,-3,14
Concordia Ch,7511,6,2,4,8,16,22,-6,10
FCSB,7512,1,7,6,1,23,12,11,27
CFR Cluj,7512,2,7,6,1,18,8,10,27
D Bucuresti,7512,3,4,5,5,21,19,2,17
Universitate,7512,4,3,6,5,15,21,-6,15
FC Botosani,7512,5,3,5,6,5,16,-11,14
Concordia Ch,7512,6,2,4,8,16,22,-6,10
FCSB,7513,1,9,5,0,28,11,17,32
CFR Cluj,7513,2,5,7,2,16,13,3,22
FC Botosani,7513,3,4,5,5,7,12,-5,17
Universitate,7513,4,3,6,5,16,21,-5,15
D Bucuresti,7513,5,3,4,7,16,21,-5,13
Concordia Ch,7513,6,3,3,8,16,21,-5,12
FCSB,7514,1,8,5,1,25,11,14,29
CFR Cluj,7514,2,6,7,1,14,7,7,25
D Bucuresti,7514,3,4,4,6,18,19,-1,16
FC Botosani,7514,4,4,4,6,6,14,-8,16
Universitate,7514,5,3,6,5,14,20,-6,15
Concordia Ch,7514,6,3,2,9,16,22,-6,11
FCSB,7515,1,7,5,2,25,15,10,26
CFR Cluj,7515,2,6,7,1,17,10,7,25
Universitate,7515,3,4,6,4,17,19,-2,18
D Bucuresti,7515,4,4,4,6,20,19,1,16
FC Botosani,7515,5,4,4,6,6,13,-7,16
Concordia Ch,7515,6,3,2,9,16,25,-9,11
FCSB,7516,1,8,5,1,25,12,13,29
CFR Cluj,7516,2,5,6,3,14,10,4,21
Universitate,7516,3,5,5,4,18,20,-2,20
D Bucuresti,7516,4,3,6,5,18,20,-2,15
FC Botosani,7516,5,3,6,5,7,14,-7,15
Concordia Ch,7516,6,2,4,8,15,21,-6,10
FCSB,7517,1,7,5,2,24,14,10,26
CFR Cluj,7517,2,6,7,1,14,7,7,25
FC Botosani,7517,3,5,4,5,9,13,-4,19
Universitate,7517,4,4,6,4,17,19,-2,18
D Bucuresti,7517,5,3,5,6,18,21,-3,14
Concordia Ch,7517,6,2,3,9,16,24,-8,9
FCSB,7518,1,7,7,0,25,12,13,28
CFR Cluj,7518,2,5,8,1,15,9,6,23
D Bucuresti,7518,3,4,5,5,18,19,-1,17
Universitate,7518,4,3,7,4,16,20,-4,16
FC Botosani,7518,5,3,6,5,6,13,-7,15
Concordia Ch,7518,6,2,3,9,15,22,-7,9
FCSB,7519,1,8,6,0,24,10,14,30
CFR Cluj,7519,2,6,7,1,15,8,7,25
D Bucuresti,7519,3,4,4,6,20,21,-1,16
FC Botosani,7519,4,4,4,6,7,15,-8,16
Universitate,7519,5,3,5,6,15,21,-6,14
Concordia Ch,7519,6,3,2,9,17,23,-6,11
FCSB,7520,1,8,5,1,24,13,11,29
CFR Cluj,7520,2,6,6,2,15,8,7,24
Universitate,7520,3,4,5,5,17,20,-3,17
FC Botosani,7520,4,4,5,5,8,14,-6,17
D Bucuresti,7520,5,3,5,6,19,22,-3,14
Concordia Ch,7520,6,3,2,9,17,23,-6,11
FCSB,7521,1,7,6,1,25,13,12,27
CFR Cluj,7521,2,6,7,1,16,8,8,25
Universitate,7521,3,4,5,5,16,21,-5,17
D Bucuresti,7521,4,4,4,6,17,19,-2,16
FC Botosani,7521,5,4,4,6,8,14,-6,16
Concordia Ch,7521,6,3,2,9,17,24,-7,11
FCSB,7522,1,7,6,1,24,13,11,27
CFR Cluj,7522,2,6,6,2,15,8,7,24
Universitate,7522,3,4,6,4,16,19,-3,18
D Bucuresti,7522,4,4,5,5,19,20,-1,17
FC Botosani,7522,5,4,5,5,7,13,-6,17
Concordia Ch,7522,6,2,2,10,16,24,-8,8
FCSB,7523,1,8,6,0,27,12,15,30
CFR Cluj,7523,2,6,7,1,16,9,7,25
D Bucuresti,7523,3,3,6,5,19,21,-2,15
FC Botosani,7523,4,3,6,5,6,13,-7,15
Universitate,7523,5,3,5,6,14,21,-7,14
Concordia Ch,7523,6,2,4,8,17,23,-6,10
FCSB,7524,1,8,6,0,25,11,14,30
CFR Cluj,7524,2,6,7,1,14,7,7,25
FC Botosani,7524,3,4,4,6,10,15,-5,16
D Bucuresti,7524,4,3,5,6,19,24,-5,14
Universitate,7524,5,3,5,6,15,21,-6,14
Concordia Ch,7524,6,3,3,8,19,24,-5,12
FCSB,7525,1,9,5,0,28,11,17,32
CFR Cluj,7525,2,6,6,2,17,11,6,24
FC Botosani,7525,3,4,5,5,6,12,-6,17
D Bucuresti,7525,4,3,5,6,16,20,-4,14
Universitate,7525,5,3,5,6,16,24,-8,14
Concordia Ch,7525,6,3,2,9,17,22,-5,11
FCSB,7526,1,7,7,0,25,12,13,28
CFR Cluj,7526,2,6,7,1,15,8,7,25
FC Botosani,7526,3,4,5,5,6,12,-6,17
Universitate,7526,4,3,6,5,15,20,-5,15
D Bucuresti,7526,5,3,4,7,16,20,-4,13
Concordia Ch,7526,6,3,3,8,16,21,-5,12
FCSB,7527,1,8,5,1,24,12,12,29
CFR Cluj,7527,2,6,6,2,14,8,6,24
Universitate,7527,3,4,5,5,16,19,-3,17
FC Botosani,7527,4,4,5,5,6,12,-6,17
D Bucuresti,7527,5,3,5,6,17,21,-4,14
Concordia Ch,7527,6,3,2,9,18,23,-5,11
FCSB,7528,1,8,5,1,28,12,16,29
CFR Cluj,7528,2,6,6,2,15,11,4,24
D Bucuresti,7528,3,4,5,5,19,19,0,17
Universitate,7528,4,4,5,5,16,21,-5,17
FC Botosani,7528,5,3,4,7,5,15,-10,13
Concordia Ch,7528,6,3,3,8,17,22,-5,12
FCSB,7529,1,8,6,0,25,11,14,30
CFR Cluj,7529,2,5,6,3,14,10,4,21
Universitate,7529,3,4,6,4,15,18,-3,18
D Bucuresti,7529,4,4,5,5,19,20,-1,17
FC Botosani,7529,5,3,5,6,7,15,-8,14
Concordia Ch,7529,6,2,4,8,17,23,-6,10
FCSB,7530,1,8,5,1,24,11,13,29
CFR Cluj,7530,2,7,6,1,16,8,8,27
FC Botosani,7530,3,4,5,5,10,14,-4,17
D Bucuresti,7530,4,3,5,6,17,22,-5,14
Universitate,7530,5,3,5,6,15,21,-6,14
Concordia Ch,7530,6,2,4,8,16,22,-6,10
FCSB,7531,1,8,6,0,27,13,14,30
CFR Cluj,7531,2,6,6,2,17,10,7,24
D Bucuresti,7531,3,5,4,5,20,19,1,19
FC Botosani,7531,4,4,4,6,7,13,-6,16
Universitate,7531,5,3,6,5,15,21,-6,15
Concordia Ch,7531,6,2,2,10,16,26,-10,8
FCSB,7532,1,9,5,0,28,11,17,32
CFR Cluj,7532,2,6,6,2,15,9,6,24
D Bucuresti,7532,3,4,4,6,18,20,-2,16
Concordia Ch,7532,4,4,2,8,20,22,-2,14
Universitate,7532,5,3,5,6,16,24,-8,14
FC Botosani,7532,6,3,4,7,5,16,-11,13
FCSB,7533,1,8,5,1,26,13,13,29
CFR Cluj,7533,2,6,6,2,16,10,6,24
D Bucuresti,7533,3,5,4,5,21,19,2,19
Universitate,7533,4,4,5,5,17,21,-4,17
FC Botosani,7533,5,3,4,7,7,18,-11,13
Concordia Ch,7533,6,3,2,9,19,25,-6,11
FCSB,7534,1,8,5,1,24,12,12,29
CFR Cluj,7534,2,6,6,2,15,8,7,24
Universitate,7534,3,4,5,5,16,20,-4,17
Concordia Ch,7534,4,4,2,8,20,23,-3,14
D Bucuresti,7534,5,3,5,6,17,20,-3,14
FC Botosani,7534,6,3,5,6,6,15,-9,14
FCSB,7535,1,8,6,0,30,16,14,30
CFR Cluj,7535,2,6,6,2,15,9,6,24
D Bucuresti,7535,3,5,4,5,19,19,0,19
Universitate,7535,4,3,6,5,19,24,-5,15
FC Botosani,7535,5,3,4,7,7,16,-9,13
Concordia Ch,7535,6,3,2,9,17,23,-6,11
FCSB,7536,1,8,6,0,27,12,15,30
CFR Cluj,7536,2,5,8,1,16,10,6,23
FC Botosani,7536,3,4,5,5,7,13,-6,17
Universitate,7536,4,3,6,5,17,23,-6,15
D Bucuresti,7536,5,3,5,6,18,21,-3,14
Concordia Ch,7536,6,2,4,8,18,24,-6,10
FCSB,7537,1,7,7,0,25,12,13,28
CFR Cluj,7537,2,5,8,1,13,7,6,23
FC Botosani,7537,3,5,4,5,11,14,-3,19
Universitate,7537,4,3,7,4,16,20,-4,16
D Bucuresti,7537,5,3,5,6,20,25,-5,14
Concordia Ch,7537,6,2,3,9,19,26,-7,9
FCSB,7538,1,9,5,0,29,10,19,32
CFR Cluj,7538,2,5,7,2,14,13,1,22
D Bucuresti,7538,3,4,5,5,18,19,-1,17
Universitate,7538,4,3,6,5,15,20,-5,15
FC Botosani,7538,5,3,4,7,5,15,-10,13
Concordia Ch,7538,6,3,3,8,18,22,-4,12
FCSB,7539,1,7,7,0,24,11,13,28
CFR Cluj,7539,2,5,8,1,16,10,6,23
D Bucuresti,7539,3,4,4,6,17,19,-2,16
Universitate,7539,4,3,7,4,18,22,-4,16
Concordia Ch,7539,5,4,2,8,17,21,-4,14
FC Botosani,7539,6,3,4,7,5,14,-9,13
FCSB,7540,1,7,5,2,23,14,9,26
CFR Cluj,7540,2,6,7,1,14,7,7,25
D Bucuresti,7540,3,5,4,5,22,21,1,19
Universitate,7540,4,4,6,4,17,18,-1,18
FC Botosani,7540,5,4,4,6,8,16,-8,16
Concordia Ch,7540,6,2,2,10,20,28,-8,8
FCSB,7541,1,8,6,0,26,11,15,30
CFR Cluj,7541,2,5,7,2,14,10,4,22
D Bucuresti,7541,3,4,4,6,18,20,-2,16
Universitate,7541,4,3,7,4,16,20,-4,16
FC Botosani,7541,5,4,4,6,8,13,-5,16
Concordia Ch,7541,6,3,2,9,17,25,-8,11
FCSB,7542,1,8,6,0,27,12,15,30
CFR Cluj,7542,2,6,6,2,14,9,5,24
D Bucuresti,7542,3,4,5,5,19,20,-1,17
Universitate,7542,4,3,6,5,16,21,-5,15
FC Botosani,7542,5,3,5,6,5,13,-8,14
Concordia Ch,7542,6,3,2,9,18,24,-6,11
FCSB,7543,1,8,5,1,26,12,14,29
CFR Cluj,7543,2,7,6,1,18,8,10,27
D Bucuresti,7543,3,5,4,5,18,18,0,19
Universitate,7543,4,3,5,6,14,23,-9,14
FC Botosani,7543,5,3,4,7,5,15,-10,13
Concordia Ch,7543,6,3,2,9,17,22,-5,11
FCSB,7544,1,8,5,1,26,12,14,29
CFR Cluj,7544,2,6,7,1,16,8,8,25
FC Botosani,7544,3,5,4,5,8,13,-5,19
D Bucuresti,7544,4,4,4,6,19,21,-2,16
Universitate,7544,5,3,6,5,15,22,-7,15
Concordia Ch,7544,6,2,2,10,16,24,-8,8
FCSB,7545,1,9,5,0,27,11,16,32
CFR Cluj,7545,2,5,6,3,13,9,4,21
FC Botosani,7545,3,4,5,5,9,13,-4,17
Universitate,7545,4,4,5,5,16,21,-5,17
D Bucuresti,7545,5,3,4,7,17,29,-12,13
Concordia Ch,7545,6,3,3,8,22,21,1,12
FCSB,7546,1,7,6,1,24,13,11,27
CFR Cluj,7546,2,6,7,1,16,8,8,25
D Bucuresti,7546,3,4,4,6,19,19,0,16
Universitate,7546,4,3,7,4,14,18,-4,16
FC Botosani,7546,5,4,4,6,6,14,-8,16
Concordia Ch,7546,6,3,2,9,17,24,-7,11
FCSB,7547,1,8,5,1,27,12,15,29
CFR Cluj,7547,2,5,7,2,14,11,3,22
Universitate,7547,3,4,6,4,17,20,-3,18
D Bucuresti,7547,4,4,4,6,18,20,-2,16
FC Botosani,7547,5,4,4,6,7,15,-8,16
Concordia Ch,7547,6,3,2,9,17,22,-5,11
FCSB,7548,1,8,5,1,26,13,13,29
CFR Cluj,7548,2,6,6,2,17,9,8,24
Universitate,7548,3,4,5,5,18,24,-6,17
D Bucuresti,7548,4,4,4,6,19,20,-1,16
FC Botosani,7548,5,3,5,6,6,15,-9,14
Concordia Ch,7548,6,3,3,8,18,23,-5,12
FCSB,7549,1,8,5,1,24,11,13,29
CFR Cluj,7549,2,6,6,2,16,8,8,24
Universitate,7549,3,4,5,5,15,21,-6,17
D Bucuresti,7549,4,4,4,6,18,19,-1,16
FC Botosani,7549,5,4,4,6,6,14,-8,16
Concordia Ch,7549,6,3,2,9,17,23,-6,11
FCSB,7550,1,8,6,0,24,10,14,30
CFR Cluj,7550,2,6,6,2,16,8,8,24
Universitate,7550,3,3,6,5,14,21,-7,15
FC Botosani,7550,4,3,6,5,6,13,-7,15
D Bucuresti,7550,5,3,5,6,17,21,-4,14
Concordia Ch,7550,6,3,3,8,17,21,-4,12
FCSB,7551,1,9,5,0,27,12,15,32
CFR Cluj,7551,2,6,6,2,16,8,8,24
D Bucuresti,7551,3,4,4,6,18,20,-2,16
FC Botosani,7551,4,4,4,6,7,14,-7,16
Universitate,7551,5,3,5,6,16,24,-8,14
Concordia Ch,7551,6,3,2,9,16,22,-6,11
FCSB,7552,1,8,6,0,24,10,14,30
CFR Cluj,7552,2,5,7,2,14,9,5,22
D Bucuresti,7552,3,4,5,5,18,19,-1,17
Universitate,7552,4,3,7,4,15,19,-4,16
FC Botosani,7552,5,3,5,6,5,15,-10,14
Concordia Ch,7552,6,3,2,9,19,23,-4,11
FCSB,7553,1,7,6,1,26,15,11,27
CFR Cluj,7553,2,6,6,2,16,9,7,24
FC Botosani,7553,3,5,4,5,9,12,-3,19
Universitate,7553,4,4,6,4,17,20,-3,18
D Bucuresti,7553,5,3,4,7,16,21,-5,13
Concordia Ch,7553,6,3,2,9,17,24,-7,11
FCSB,7554,1,9,5,0,26,11,15,32
CFR Cluj,7554,2,5,6,3,13,10,3,21
Universitate,7554,3,4,5,5,17,20,-3,17
D Bucuresti,7554,4,4,4,6,20,22,-2,16
Concordia Ch,7554,5,4,2,8,20,24,-4,14
FC Botosani,7554,6,3,4,7,7,16,-9,13
FCSB,7555,1,7,6,1,24,12,12,27
CFR Cluj,7555,2,5,8,1,14,8,6,23
Universitate,7555,3,4,6,4,15,18,-3,18
D Bucuresti,7555,4,4,5,5,17,18,-1,17
FC Botosani,7555,5,3,5,6,7,15,-8,14
Concordia Ch,7555,6,3,2,9,18,24,-6,11
FCSB,7556,1,8,6,0,24,10,14,30
CFR Cluj,7556,2,5,6,3,14,13,1,21
D Bucuresti,7556,3,5,4,5,20,19,1,19
Universitate,7556,4,4,6,4,19,19,0,18
FC Botosani,7556,5,4,4,6,7,14,-7,16
Concordia Ch,7556,6,2,2,10,15,24,-9,8
FCSB,7557,1,8,6,0,24,10,14,30
CFR Cluj,7557,2,5,6,3,13,9,4,21
Universitate,7557,3,4,6,4,15,18,-3,18
D Bucuresti,7557,4,3,5,6,20,23,-3,14
Concordia Ch,7557,5,4,2,8,21,25,-4,14
FC Botosani,7557,6,3,5,6,7,15,-8,14
CFR Cluj,7558,1,7,6,1,17,7,10,27
FCSB,7558,2,7,5,2,23,15,8,26
Universitate,7558,3,4,5,5,17,20,-3,17
D Bucuresti,7558,4,4,4,6,20,20,0,16
Concordia Ch,7558,5,4,2,8,18,22,-4,14
FC Botosani,7558,6,3,4,7,5,16,-11,13
FCSB,7559,1,7,6,1,26,14,12,27
CFR Cluj,7559,2,7,6,1,18,9,9,27
FC Botosani,7559,3,4,5,5,7,13,-6,17
D Bucuresti,7559,4,3,6,5,17,19,-2,15
Universitate,7559,5,3,6,5,15,21,-6,15
Concordia Ch,7559,6,2,3,9,15,22,-7,9
FCSB,7560,1,7,6,1,24,12,12,27
CFR Cluj,7560,2,6,7,1,15,8,7,25
D Bucuresti,7560,3,4,4,6,19,19,0,16
Universitate,7560,4,3,7,4,16,20,-4,16
FC Botosani,7560,5,4,4,6,7,14,-7,16
Concordia Ch,7560,6,3,2,9,17,25,-8,11
FCSB,7561,1,8,5,1,28,15,13,29
CFR Cluj,7561,2,6,6,2,18,11,7,24
FC Botosani,7561,3,5,4,5,9,14,-5,19
Universitate,7561,4,4,5,5,18,23,-5,17
D Bucuresti,7561,5,3,4,7,17,24,-7,13
Concordia Ch,7561,6,3,2,9,20,23,-3,11
FCSB,7562,1,7,6,1,23,11,12,27
CFR Cluj,7562,2,5,7,2,14,11,3,22
Universitate,7562,3,5,5,4,19,19,0,20
FC Botosani,7562,4,3,6,5,5,12,-7,15
D Bucuresti,7562,5,3,5,6,17,20,-3,14
Concordia Ch,7562,6,3,3,8,17,22,-5,12
FCSB,7563,1,8,6,0,28,13,15,30
CFR Cluj,7563,2,6,6,2,16,11,5,24
D Bucuresti,7563,3,4,5,5,18,18,0,17
Universitate,7563,4,3,6,5,15,20,-5,15
FC Botosani,7563,5,3,4,7,6,16,-10,13
Concordia Ch,7563,6,3,3,8,17,22,-5,12
FCSB,7564,1,7,6,1,26,14,12,27
CFR Cluj,7564,2,6,7,1,17,8,9,25
Universitate,7564,3,4,5,5,17,23,-6,17
D Bucuresti,7564,4,4,4,6,23,22,1,16
FC Botosani,7564,5,3,5,6,6,17,-11,14
Concordia Ch,7564,6,3,3,8,18,23,-5,12
FCSB,7565,1,7,6,1,26,14,12,27
CFR Cluj,7565,2,7,6,1,17,9,8,27
D Bucuresti,7565,3,4,5,5,19,20,-1,17
Universitate,7565,4,3,6,5,15,20,-5,15
FC Botosani,7565,5,3,6,5,7,14,-7,15
Concordia Ch,7565,6,2,3,9,17,24,-7,9
FCSB,7566,1,7,6,1,24,12,12,27
CFR Cluj,7566,2,7,6,1,16,8,8,27
Universitate,7566,3,3,6,5,16,21,-5,15
Concordia Ch,7566,4,4,2,8,19,21,-2,14
D Bucuresti,7566,5,3,5,6,17,22,-5,14
FC Botosani,7566,6,3,5,6,6,14,-8,14
FCSB,7567,1,9,5,0,28,11,17,32
CFR Cluj,7567,2,6,6,2,15,11,4,24
D Bucuresti,7567,3,4,5,5,19,19,0,17
FC Botosani,7567,4,4,4,6,8,16,-8,16
Universitate,7567,5,3,5,6,14,20,-6,14
Concordia Ch,7567,6,2,3,9,16,23,-7,9
FCSB,7568,1,7,6,1,25,14,11,27
CFR Cluj,7568,2,5,7,2,14,10,4,22
Universitate,7568,3,5,5,4,19,19,0,20
FC Botosani,7568,4,4,5,5,6,12,-6,17
D Bucuresti,7568,5,4,4,6,18,19,-1,16
Concordia Ch,7568,6,2,3,9,15,23,-8,9
FCSB,7569,1,7,6,1,25,13,12,27
CFR Cluj,7569,2,6,7,1,16,9,7,25
D Bucuresti,7569,3,4,5,5,19,20,-1,17
Universitate,7569,4,4,5,5,15,19,-4,17
FC Botosani,7569,5,3,4,7,6,15,-9,13
Concordia Ch,7569,6,3,3,8,17,22,-5,12
FCSB,7570,1,8,5,1,26,12,14,29
CFR Cluj,7570,2,5,7,2,13,10,3,22
Universitate,7570,3,4,6,4,16,18,-2,18
D Bucuresti,7570,4,3,6,5,18,20,-2,15
FC Botosani,7570,5,3,6,5,6,13,-7,15
Concordia Ch,7570,6,2,4,8,16,22,-6,10
FCSB,7571,1,8,5,1,28,14,14,29
CFR Cluj,7571,2,5,7,2,16,13,3,22
Universitate,7571,3,4,6,4,17,19,-2,18
D Bucuresti,7571,4,4,4,6,19,22,-3,16
Concordia Ch,7571,5,4,2,8,22,25,-3,14
FC Botosani,7571,6,3,4,7,7,16,-9,13
FCSB,7572,1,7,6,1,25,13,12,27
CFR Cluj,7572,2,7,6,1,19,8,11,27
D Bucuresti,7572,3,5,4,5,20,18,2,19
FC Botosani,7572,4,4,4,6,7,15,-8,16
Universitate,7572,5,3,6,5,15,23,-8,15
Concordia Ch,7572,6,2,2,10,16,25,-9,8
FCSB,7573,1,7,5,2,23,13,10,26
CFR Cluj,7573,2,6,7,1,17,9,8,25
Universitate,7573,3,4,6,4,17,20,-3,18
FC Botosani,7573,4,4,5,5,8,14,-6,17
D Bucuresti,7573,5,3,5,6,17,20,-3,14
Concordia Ch,7573,6,3,2,9,17,23,-6,11
FCSB,7574,1,9,5,0,30,10,20,32
CFR Cluj,7574,2,5,6,3,13,9,4,21
FC Botosani,7574,3,4,5,5,7,13,-6,17
Universitate,7574,4,4,5,5,15,24,-9,17
D Bucuresti,7574,5,3,5,6,16,19,-3,14
Concordia Ch,7574,6,2,4,8,16,22,-6,10
FCSB,7575,1,8,6,0,26,12,14,30
CFR Cluj,7575,2,6,6,2,17,9,8,24
D Bucuresti,7575,3,4,5,5,18,19,-1,17
FC Botosani,7575,4,4,5,5,8,13,-5,17
Universitate,7575,5,3,6,5,15,22,-7,15
Concordia Ch,7575,6,2,2,10,15,24,-9,8
FCSB,7576,1,7,6,1,23,11,12,27
CFR Cluj,7576,2,6,7,1,17,7,10,25
FC Botosani,7576,3,4,5,5,6,12,-6,17
Universitate,7576,4,4,5,5,15,22,-7,17
D Bucuresti,7576,5,3,5,6,16,21,-5,14
Concordia Ch,7576,6,3,2,9,18,22,-4,11
FCSB,7577,1,7,6,1,23,11,12,27
CFR Cluj,7577,2,7,6,1,16,7,9,27
D Bucuresti,7577,3,4,4,6,18,20,-2,16
Universitate,7577,4,3,6,5,14,20,-6,15
FC Botosani,7577,5,3,5,6,7,15,-8,14
Concordia Ch,7577,6,3,3,8,17,22,-5,12
FCSB,7578,1,8,5,1,24,12,12,29
CFR Cluj,7578,2,6,6,2,15,8,7,24
Universitate,7578,3,4,5,5,15,19,-4,17
D Bucuresti,7578,4,4,4,6,17,20,-3,16
FC Botosani,7578,5,3,5,6,6,14,-8,14
Concordia Ch,7578,6,3,3,8,18,22,-4,12
FCSB,7579,1,7,5,2,23,12,11,26
CFR Cluj,7579,2,6,7,1,14,7,7,25
Universitate,7579,3,4,6,4,15,18,-3,18
D Bucuresti,7579,4,4,5,5,20,19,1,17
FC Botosani,7579,5,4,4,6,7,16,-9,16
Concordia Ch,7579,6,2,3,9,17,24,-7,9
FCSB,7580,1,7,6,1,25,13,12,27
CFR Cluj,7580,2,5,8,1,16,10,6,23
Universitate,7580,3,4,6,4,16,19,-3,18
FC Botosani,7580,4,3,6,5,8,15,-7,15
D Bucuresti,7580,5,3,5,6,18,22,-4,14
Concordia Ch,7580,6,3,3,8,18,22,-4,12
FCSB,7581,1,8,5,1,27,11,16,29
CFR Cluj,7581,2,6,7,1,16,9,7,25
D Bucuresti,7581,3,4,5,5,20,21,-1,17
Universitate,7581,4,3,6,5,16,24,-8,15
FC Botosani,7581,5,3,5,6,6,14,-8,14
Concordia Ch,7581,6,3,2,9,20,26,-6,11
FCSB,7582,1,9,5,0,29,14,15,32
CFR Cluj,7582,2,5,7,2,16,11,5,22
D Bucuresti,7582,3,4,5,5,20,21,-1,17
FC Botosani,7582,4,4,4,6,8,15,-7,16
Universitate,7582,5,3,6,5,15,20,-5,15
Concordia Ch,7582,6,2,3,9,16,23,-7,9
FCSB,7583,1,9,5,0,28,12,16,32
CFR Cluj,7583,2,6,6,2,16,11,5,24
D Bucuresti,7583,3,4,4,6,20,21,-1,16
FC Botosani,7583,4,4,4,6,8,15,-7,16
Universitate,7583,5,3,5,6,16,22,-6,14
Concordia Ch,7583,6,3,2,9,18,25,-7,11
FCSB,7584,1,8,5,1,24,12,12,29
CFR Cluj,7584,2,6,6,2,16,8,8,24
Universitate,7584,3,4,5,5,16,21,-5,17
D Bucuresti,7584,4,4,4,6,18,19,-1,16
Concordia Ch,7584,5,4,2,8,17,21,-4,14
FC Botosani,7584,6,3,4,7,5,15,-10,13
FCSB,7585,1,9,5,0,27,10,17,32
CFR Cluj,7585,2,5,7,2,13,9,4,22
FC Botosani,7585,3,4,5,5,9,15,-6,17
Universitate,7585,4,3,6,5,14,20,-6,15
D Bucuresti,7585,5,3,5,6,18,23,-5,14
Concordia Ch,7585,6,3,2,9,19,23,-4,11
FCSB,7586,1,7,6,1,25,13,12,27
CFR Cluj,7586,2,6,6,2,15,9,6,24
Universitate,7586,3,4,6,4,16,19,-3,18
D Bucuresti,7586,4,4,5,5,18,19,-1,17
FC Botosani,7586,5,3,4,7,5,16,-11,13
Concordia Ch,7586,6,3,3,8,19,22,-3,12
FCSB,7587,1,7,7,0,23,10,13,28
CFR Cluj,7587,2,5,7,2,13,8,5,22
Universitate,7587,3,4,6,4,15,18,-3,18
D Bucuresti,7587,4,4,5,5,17,18,-1,17
FC Botosani,7587,5,3,4,7,5,14,-9,13
Concordia Ch,7587,6,3,3,8,16,21,-5,12
FCSB,7588,1,8,6,0,27,12,15,30
CFR Cluj,7588,2,5,7,2,15,10,5,22
Universitate,7588,3,4,5,5,15,20,-5,17
D Bucuresti,7588,4,4,4,6,17,19,-2,16
FC Botosani,7588,5,4,4,6,7,13,-6,16
Concordia Ch,7588,6,3,2,9,16,23,-7,11
FCSB,7589,1,9,5,0,27,11,16,32
CFR Cluj,7589,2,5,6,3,14,11,3,21
Universitate,7589,3,4,5,5,16,20,-4,17
FC Botosani,7589,4,4,5,5,7,13,-6,17
D Bucuresti,7589,5,3,5,6,17,23,-6,14
Concordia Ch,7589,6,3,2,9,19,22,-3,11
FCSB,7590,1,8,6,0,25,11,14,30
CFR Cluj,7590,2,6,6,2,15,8,7,24
D Bucuresti,7590,3,5,4,5,18,18,0,19
Universitate,7590,4,3,6,5,15,21,-6,15
FC Botosani,7590,5,3,5,6,6,14,-8,14
Concordia Ch,7590,6,2,3,9,16,23,-7,9
FCSB,7591,1,8,5,1,28,12,16,29
CFR Cluj,7591,2,6,6,2,14,11,3,24
Universitate,7591,3,4,5,5,16,20,-4,17
D Bucuresti,7591,4,3,6,5,17,19,-2,15
FC Botosani,7591,5,3,6,5,6,13,-7,15
Concordia Ch,7591,6,2,4,8,15,21,-6,10
FCSB,7592,1,7,7,0,25,12,13,28
CFR Cluj,7592,2,5,8,1,14,8,6,23
D Bucuresti,7592,3,4,4,6,18,20,-2,16
Universitate,7592,4,3,7,4,17,21,-4,16
FC Botosani,7592,5,4,4,6,6,14,-8,16
Concordia Ch,7592,6,3,2,9,18,23,-5,11
FCSB,7593,1,8,5,1,25,13,12,29
CFR Cluj,7593,2,6,6,2,17,9,8,24
Universitate,7593,3,4,5,5,18,23,-5,17
D Bucuresti,7593,4,4,4,6,19,19,0,16
FC Botosani,7593,5,3,5,6,6,16,-10,14
Concordia Ch,7593,6,3,3,8,17,22,-5,12
FCSB,7594,1,8,6,0,27,12,15,30
CFR Cluj,7594,2,6,7,1,15,8,7,25
D Bucuresti,7594,3,4,4,6,22,22,0,16
Concordia Ch,7594,4,4,2,8,21,23,-2,14
Universitate,7594,5,3,5,6,15,22,-7,14
FC Botosani,7594,6,3,4,7,5,18,-13,13
CFR Cluj,7595,1,7,6,1,17,9,8,27
FCSB,7595,2,7,5,2,26,15,11,26
Universitate,7595,3,4,5,5,18,22,-4,17
FC Botosani,7595,4,4,5,5,6,12,-6,17
D Bucuresti,7595,5,3,5,6,18,21,-3,14
Concordia Ch,7595,6,2,4,8,17,23,-6,10
FCSB,7596,1,9,5,0,26,11,15,32
CFR Cluj,7596,2,5,7,2,14,9,5,22
FC Botosani,7596,3,4,4,6,7,14,-7,16
Universitate,7596,4,3,6,5,16,21,-5,15
D Bucuresti,7596,5,3,5,6,18,21,-3,14
Concordia Ch,7596,6,3,3,8,17,22,-5,12
FCSB,7597,1,7,6,1,24,13,11,27
CFR Cluj,7597,2,6,7,1,17,9,8,25
FC Botosani,7597,3,5,4,5,8,12,-4,19
Universitate,7597,4,4,5,5,17,21,-4,17
D Bucuresti,7597,5,3,5,6,18,21,-3,14
Concordia Ch,7597,6,2,3,9,17,25,-8,9
FCSB,7598,1,8,5,1,25,11,14,29
CFR Cluj,7598,2,7,6,1,16,7,9,27
D Bucuresti,7598,3,4,4,6,19,22,-3,16
Concordia Ch,7598,4,4,2,8,19,22,-3,14
Universitate,7598,5,3,5,6,14,22,-8,14
FC Botosani,7598,6,3,4,7,6,15,-9,13
FCSB,7599,1,9,5,0,25,10,15,32
CFR Cluj,7599,2,5,7,2,14,9,5,22
Universitate,7599,3,3,6,5,15,20,-5,15
Concordia Ch,7599,4,4,2,8,21,22,-1,14
D Bucuresti,7599,5,3,5,6,17,22,-5,14
FC Botosani,7599,6,3,5,6,5,14,-9,14
FCSB,7600,1,8,5,1,26,13,13,29
CFR Cluj,7600,2,7,6,1,19,8,11,27
D Bucuresti,7600,3,5,4,5,23,19,4,19
FC Botosani,7600,4,4,4,6,7,17,-10,16
Universitate,7600,5,3,5,6,14,23,-9,14
Concordia Ch,7600,6,2,2,10,15,24,-9,8
FCSB,7601,1,8,5,1,24,12,12,29
CFR Cluj,7601,2,7,6,1,17,7,10,27
FC Botosani,7601,3,5,4,5,7,12,-5,19
Universitate,7601,4,3,5,6,14,21,-7,14
D Bucuresti,7601,5,3,4,7,17,21,-4,13
Concordia Ch,7601,6,3,2,9,17,23,-6,11
FCSB,7602,1,8,6,0,24,10,14,30
CFR Cluj,7602,2,5,7,2,13,9,4,22
D Bucuresti,7602,3,4,5,5,20,20,0,17
Universitate,7602,4,4,5,5,16,19,-3,17
FC Botosani,7602,5,4,5,5,9,15,-6,17
Concordia Ch,7602,6,2,2,10,16,25,-9,8
FCSB,7603,1,7,6,1,25,17,8,27
CFR Cluj,7603,2,6,7,1,15,8,7,25
Universitate,7603,3,4,5,5,20,20,0,17
FC Botosani,7603,4,4,5,5,7,13,-6,17
D Bucuresti,7603,5,3,5,6,20,23,-3,14
Concordia Ch,7603,6,3,2,9,19,25,-6,11
FCSB,7604,1,8,5,1,25,14,11,29
CFR Cluj,7604,2,5,7,2,14,9,5,22
Universitate,7604,3,4,6,4,19,20,-1,18
FC Botosani,7604,4,3,6,5,6,13,-7,15
D Bucuresti,7604,5,3,5,6,17,21,-4,14
Concordia Ch,7604,6,3,3,8,19,23,-4,12
FCSB,7605,1,8,6,0,27,12,15,30
CFR Cluj,7605,2,6,7,1,18,10,8,25
D Bucuresti,7605,3,4,4,6,18,23,-5,16
Universitate,7605,4,3,5,6,15,23,-8,14
FC Botosani,7605,5,3,5,6,7,15,-8,14
Concordia Ch,7605,6,3,3,8,22,24,-2,12
FCSB,7606,1,9,5,0,28,11,17,32
CFR Cluj,7606,2,6,6,2,15,10,5,24
D Bucuresti,7606,3,5,4,5,19,19,0,19
FC Botosani,7606,4,4,4,6,7,14,-7,16
Universitate,7606,5,3,5,6,15,22,-7,14
Concordia Ch,7606,6,2,2,10,15,23,-8,8
FCSB,7607,1,8,5,1,25,11,14,29
CFR Cluj,7607,2,6,6,2,16,11,5,24
Universitate,7607,3,4,5,5,17,21,-4,17
Concordia Ch,7607,4,4,2,8,21,24,-3,14
D Bucuresti,7607,5,3,5,6,17,20,-3,14
FC Botosani,7607,6,3,5,6,7,16,-9,14
FCSB,7608,1,9,5,0,26,11,15,32
CFR Cluj,7608,2,6,6,2,15,8,7,24
FC Botosani,7608,3,4,5,5,11,16,-5,17
D Bucuresti,7608,4,3,6,5,20,22,-2,15
Universitate,7608,5,3,5,6,15,22,-7,14
Concordia Ch,7608,6,2,3,9,15,23,-8,9
FCSB,7609,1,8,6,0,27,13,14,30
CFR Cluj,7609,2,6,6,2,15,9,6,24
D Bucuresti,7609,3,4,4,6,18,20,-2,16
Universitate,7609,4,3,6,5,16,21,-5,15
FC Botosani,7609,5,3,5,6,7,15,-8,14
Concordia Ch,7609,6,3,3,8,17,22,-5,12
FCSB,7610,1,7,7,0,25,12,13,28
CFR Cluj,7610,2,6,7,1,15,8,7,25
D Bucuresti,7610,3,4,4,6,23,22,1,16
Universitate,7610,4,3,6,5,15,20,-5,15
FC Botosani,7610,5,3,5,6,7,18,-11,14
Concordia Ch,7610,6,3,3,8,17,22,-5,12
FCSB,7611,1,8,5,1,26,14,12,29
CFR Cluj,7611,2,5,6,3,13,12,1,21
Universitate,7611,3,5,5,4,21,19,2,20
D Bucuresti,7611,4,5,4,5,19,18,1,19
FC Botosani,7611,5,4,4,6,7,15,-8,16
Concordia Ch,7611,6,2,2,10,16,24,-8,8
FCSB,7612,1,8,6,0,25,10,15,30
CFR Cluj,7612,2,6,6,2,17,10,7,24
D Bucuresti,7612,3,4,5,5,18,19,-1,17
FC Botosani,7612,4,4,4,6,10,15,-5,16
Universitate,7612,5,3,6,5,15,22,-7,15
Concordia Ch,7612,6,2,3,9,16,25,-9,9
FCSB,7613,1,7,6,1,25,13,12,27
CFR Cluj,7613,2,7,6,1,17,9,8,27
FC Botosani,7613,3,4,4,6,6,13,-7,16
Universitate,7613,4,3,6,5,16,21,-5,15
Concordia Ch,7613,5,4,2,8,18,21,-3,14
D Bucuresti,7613,6,3,4,7,16,21,-5,13
FCSB,7614,1,7,5,2,23,12,11,26
CFR Cluj,7614,2,6,7,1,16,9,7,25
Universitate,7614,3,4,6,4,17,20,-3,18
FC Botosani,7614,4,4,4,6,6,13,-7,16
Concordia Ch,7614,5,4,2,8,17,21,-4,14
D Bucuresti,7614,6,3,4,7,16,20,-4,13
FCSB,7615,1,7,7,0,24,11,13,28
CFR Cluj,7615,2,5,7,2,14,9,5,22
Universitate,7615,3,4,6,4,15,18,-3,18
D Bucuresti,7615,4,4,5,5,20,20,0,17
FC Botosani,7615,5,4,4,6,7,14,-7,16
Concordia Ch,7615,6,2,3,9,17,25,-8,9
FCSB,7616,1,8,5,1,24,13,11,29
CFR Cluj,7616,2,6,6,2,15,8,7,24
D Bucuresti,7616,3,4,5,5,18,18,0,17
Universitate,7616,4,4,5,5,17,20,-3,17
FC Botosani,7616,5,4,4,6,6,14,-8,16
Concordia Ch,7616,6,2,3,9,15,22,-7,9
FCSB,7617,1,8,5,1,24,11,13,29
CFR Cluj,7617,2,7,6,1,16,8,8,27
D Bucuresti,7617,3,4,5,5,18,19,-1,17
FC Botosani,7617,4,3,6,5,6,13,-7,15
Universitate,7617,5,3,5,6,15,21,-6,14
Concordia Ch,7617,6,2,3,9,17,24,-7,9
FCSB,7618,1,8,5,1,25,11,14,29
CFR Cluj,7618,2,5,6,3,14,12,2,21
Universitate,7618,3,5,5,4,18,19,-1,20
D Bucuresti,7618,4,3,6,5,17,19,-2,15
FC Botosani,7618,5,3,5,6,6,15,-9,14
Concordia Ch,7618,6,3,3,8,17,21,-4,12
FCSB,7619,1,8,5,1,24,12,12,29
CFR Cluj,7619,2,5,7,2,15,10,5,22
FC Botosani,7619,3,5,4,5,8,13,-5,19
Universitate,7619,4,4,6,4,18,20,-2,18
D Bucuresti,7619,5,3,4,7,17,21,-4,13
Concordia Ch,7619,6,3,2,9,18,24,-6,11
FCSB,7620,1,7,5,2,25,15,10,26
CFR Cluj,7620,2,6,6,2,17,11,6,24
Universitate,7620,3,5,5,4,20,21,-1,20
FC Botosani,7620,4,4,5,5,9,14,-5,17
D Bucuresti,7620,5,3,4,7,16,21,-5,13
Concordia Ch,7620,6,3,3,8,18,23,-5,12
FCSB,7621,1,8,6,0,26,12,14,30
CFR Cluj,7621,2,5,7,2,14,9,5,22
D Bucuresti,7621,3,4,4,6,17,20,-3,16
Universitate,7621,4,3,7,4,15,19,-4,16
Concordia Ch,7621,5,4,2,8,20,23,-3,14
FC Botosani,7621,6,3,4,7,7,16,-9,13
FCSB,7622,1,9,5,0,26,11,15,32
CFR Cluj,7622,2,6,6,2,16,10,6,24
D Bucuresti,7622,3,4,4,6,18,21,-3,16
FC Botosani,7622,4,4,4,6,10,15,-5,16
Universitate,7622,5,3,5,6,15,21,-6,14
Concordia Ch,7622,6,3,2,9,18,25,-7,11
FCSB,7623,1,8,6,0,25,11,14,30
CFR Cluj,7623,2,5,7,2,15,10,5,22
D Bucuresti,7623,3,4,5,5,19,20,-1,17
Universitate,7623,4,4,5,5,16,20,-4,17
FC Botosani,7623,5,4,4,6,7,14,-7,16
Concordia Ch,7623,6,2,3,9,18,25,-7,9
FCSB,7624,1,8,6,0,26,11,15,30
CFR Cluj,7624,2,5,6,3,13,10,3,21
D Bucuresti,7624,3,5,4,5,22,19,3,19
Universitate,7624,4,4,6,4,16,19,-3,18
FC Botosani,7624,5,4,4,6,6,15,-9,16
Concordia Ch,7624,6,2,2,10,16,25,-9,8
FCSB,7625,1,7,5,2,24,14,10,26
CFR Cluj,7625,2,6,7,1,15,8,7,25
Universitate,7625,3,4,6,4,18,20,-2,18
D Bucuresti,7625,4,4,5,5,20,18,2,17
FC Botosani,7625,5,3,5,6,6,14,-8,14
Concordia Ch,7625,6,3,2,9,17,26,-9,11
FCSB,7626,1,9,5,0,29,10,19,32
CFR Cluj,7626,2,6,6,2,14,9,5,24
D Bucuresti,7626,3,3,6,5,17,19,-2,15
FC Botosani,7626,4,3,6,5,6,13,-7,15
Universitate,7626,5,3,5,6,14,23,-9,14
Concordia Ch,7626,6,2,4,8,15,21,-6,10
FCSB,7627,1,7,7,0,25,12,13,28
CFR Cluj,7627,2,5,7,2,13,8,5,22
Universitate,7627,3,4,6,4,17,20,-3,18
FC Botosani,7627,4,4,5,5,9,15,-6,17
D Bucuresti,7627,5,3,5,6,20,23,-3,14
Concordia Ch,7627,6,3,2,9,19,25,-6,11
FCSB,7628,1,8,6,0,26,12,14,30
CFR Cluj,7628,2,6,6,2,15,9,6,24
D Bucuresti,7628,3,4,4,6,17,19,-2,16
FC Botosani,7628,4,4,4,6,7,14,-7,16
Universitate,7628,5,3,6,5,15,20,-5,15
Concordia Ch,7628,6,3,2,9,17,23,-6,11
FCSB,7629,1,7,6,1,24,13,11,27
CFR Cluj,7629,2,6,7,1,16,8,8,25
D Bucuresti,7629,3,4,5,5,18,19,-1,17
Universitate,7629,4,4,5,5,16,20,-4,17
FC Botosani,7629,5,4,4,6,7,14,-7,16
Concordia Ch,7629,6,2,3,9,17,24,-7,9
FCSB,7630,1,7,6,1,25,13,12,27
CFR Cluj,7630,2,7,6,1,16,8,8,27
D Bucuresti,7630,3,4,4,6,20,20,0,16
FC Botosani,7630,4,4,4,6,6,16,-10,16
Universitate,7630,5,3,6,5,15,20,-5,15
Concordia Ch,7630,6,3,2,9,17,22,-5,11
FCSB,7631,1,8,6,0,25,11,14,30
CFR Cluj,7631,2,5,8,1,14,8,6,23
D Bucuresti,7631,3,4,4,6,19,19,0,16
Universitate,7631,4,3,6,5,16,21,-5,15
FC Botosani,7631,5,3,5,6,5,15,-10,14
Concordia Ch,7631,6,3,3,8,16,21,-5,12
FCSB,7632,1,8,6,0,25,10,15,30
CFR Cluj,7632,2,6,6,2,16,9,7,24
D Bucuresti,7632,3,4,4,6,17,19,-2,16
FC Botosani,7632,4,4,4,6,9,14,-5,16
Universitate,7632,5,3,6,5,14,21,-7,15
Concordia Ch,7632,6,3,2,9,17,25,-8,11
FCSB,7633,1,7,5,2,23,14,9,26
CFR Cluj,7633,2,6,7,1,15,8,7,25
FC Botosani,7633,3,5,4,5,12,14,-2,19
Universitate,7633,4,4,6,4,18,19,-1,18
D Bucuresti,7633,5,3,5,6,17,21,-4,14
Concordia Ch,7633,6,2,3,9,16,25,-9,9
FCSB,7634,1,8,6,0,27,13,14,30
CFR Cluj,7634,2,5,7,2,15,10,5,22
FC Botosani,7634,3,5,4,5,11,16,-5,19
Universitate,7634,4,3,7,4,19,23,-4,16
D Bucuresti,7634,5,3,5,6,18,21,-3,14
Concordia Ch,7634,6,2,3,9,19,26,-7,9
FCSB,7635,1,8,6,0,27,11,16,30
CFR Cluj,7635,2,6,7,1,16,9,7,25
FC Botosani,7635,3,4,5,5,7,13,-6,17
D Bucuresti,7635,4,3,6,5,17,19,-2,15
Universitate,7635,5,3,5,6,15,23,-8,14
Concordia Ch,7635,6,2,3,9,17,24,-7,9
FCSB,7636,1,7,6,1,25,14,11,27
CFR Cluj,7636,2,7,6,1,18,8,10,27
FC Botosani,7636,3,4,5,5,7,13,-6,17
Universitate,7636,4,3,6,5,15,21,-6,15
D Bucuresti,7636,5,3,5,6,16,19,-3,14
Concordia Ch,7636,6,3,2,9,17,23,-6,11
FCSB,7637,1,7,6,1,23,11,12,27
CFR Cluj,7637,2,5,8,1,14,8,6,23
FC Botosani,7637,3,5,4,5,9,13,-4,19
Universitate,7637,4,4,6,4,16,19,-3,18
D Bucuresti,7637,5,3,5,6,18,21,-3,14
Concordia Ch,7637,6,2,3,9,16,24,-8,9
CFR Cluj,7638,1,7,6,1,17,8,9,27
FCSB,7638,2,7,5,2,25,15,10,26
Universitate,7638,3,4,5,5,17,21,-4,17
D Bucuresti,7638,4,4,4,6,18,20,-2,16
FC Botosani,7638,5,4,4,6,9,16,-7,16
Concordia Ch,7638,6,3,2,9,18,24,-6,11
FCSB,7639,1,7,6,1,25,14,11,27
CFR Cluj,7639,2,6,7,1,15,8,7,25
Universitate,7639,3,4,5,5,19,22,-3,17
D Bucuresti,7639,4,4,4,6,22,23,-1,16
Concordia Ch,7639,5,4,2,8,21,24,-3,14
FC Botosani,7639,6,3,4,7,7,18,-11,13
FCSB,7640,1,8,5,1,24,11,13,29
CFR Cluj,7640,2,6,6,2,15,8,7,24
FC Botosani,7640,3,4,5,5,9,12,-3,17
Universitate,7640,4,4,5,5,15,20,-5,17
D Bucuresti,7640,5,3,6,5,17,19,-2,15
Concordia Ch,7640,6,2,3,9,16,26,-10,9
FCSB,7641,1,8,5,1,26,13,13,29
CFR Cluj,7641,2,7,6,1,16,7,9,27
FC Botosani,7641,3,5,4,5,8,12,-4,19
Universitate,7641,4,3,5,6,16,23,-7,14
D Bucuresti,7641,5,3,4,7,17,21,-4,13
Concordia Ch,7641,6,3,2,9,17,24,-7,11
FCSB,7642,1,8,6,0,25,11,14,30
CFR Cluj,7642,2,6,6,2,14,8,6,24
D Bucuresti,7642,3,4,4,6,18,21,-3,16
FC Botosani,7642,4,4,4,6,9,15,-6,16
Universitate,7642,5,3,6,5,15,20,-5,15
Concordia Ch,7642,6,3,2,9,20,26,-6,11
FCSB,7643,1,7,5,2,24,13,11,26
CFR Cluj,7643,2,6,7,1,16,9,7,25
D Bucuresti,7643,3,5,4,5,22,20,2,19
Universitate,7643,4,4,6,4,16,19,-3,18
FC Botosani,7643,5,4,4,6,10,15,-5,16
Concordia Ch,7643,6,2,2,10,17,29,-12,8
FCSB,7644,1,8,6,0,27,12,15,30
CFR Cluj,7644,2,5,7,2,15,11,4,22
D Bucuresti,7644,3,4,4,6,18,20,-2,16
Universitate,7644,4,3,7,4,16,20,-4,16
FC Botosani,7644,5,3,5,6,5,13,-8,14
Concordia Ch,7644,6,3,3,8,17,22,-5,12
FCSB,7645,1,8,5,1,25,12,13,29
CFR Cluj,7645,2,6,6,2,17,13,4,24
D Bucuresti,7645,3,5,4,5,20,18,2,19
Universitate,7645,4,4,5,5,19,21,-2,17
FC Botosani,7645,5,4,4,6,7,14,-7,16
Concordia Ch,7645,6,2,2,10,16,26,-10,8
FCSB,7646,1,7,6,1,23,11,12,27
CFR Cluj,7646,2,5,8,1,15,9,6,23
Universitate,7646,3,4,6,4,17,20,-3,18
D Bucuresti,7646,4,4,5,5,19,19,0,17
FC Botosani,7646,5,4,4,6,6,14,-8,16
Concordia Ch,7646,6,2,3,9,16,23,-7,9
FCSB,7647,1,8,6,0,27,13,14,30
CFR Cluj,7647,2,5,6,3,13,9,4,21
Universitate,7647,3,4,6,4,18,21,-3,18
D Bucuresti,7647,4,4,4,6,18,19,-1,16
FC Botosani,7647,5,4,4,6,7,15,-8,16
Concordia Ch,7647,6,3,2,9,17,23,-6,11
FCSB,7648,1,8,5,1,28,12,16,29
CFR Cluj,7648,2,5,7,2,13,11,2,22
D Bucuresti,7648,3,5,4,5,19,19,0,19
Universitate,7648,4,4,6,4,16,19,-3,18
FC Botosani,7648,5,3,5,6,7,15,-8,14
Concordia Ch,7648,6,2,3,9,16,23,-7,9
FCSB,7649,1,8,6,0,28,10,18,30
CFR Cluj,7649,2,6,7,1,15,7,8,25
FC Botosani,7649,3,5,4,5,7,12,-5,19
D Bucuresti,7649,4,4,4,6,19,21,-2,16
Universitate,7649,5,3,5,6,14,25,-11,14
Concordia Ch,7649,6,2,2,10,17,25,-8,8
FCSB,7650,1,8,5,1,25,12,13,29
CFR Cluj,7650,2,6,7,1,15,8,7,25
FC Botosani,7650,3,4,5,5,7,13,-6,17
Universitate,7650,4,3,6,5,14,19,-5,15
D Bucuresti,7650,5,3,5,6,17,20,-3,14
Concordia Ch,7650,6,3,2,9,16,22,-6,11
FCSB,7651,1,7,6,1,25,13,12,27
CFR Cluj,7651,2,5,7,2,13,10,3,22
Universitate,7651,3,5,5,4,20,20,0,20
D Bucuresti,7651,4,4,4,6,19,21,-2,16
FC Botosani,7651,5,3,5,6,5,13,-8,14
Concordia Ch,7651,6,3,3,8,18,23,-5,12
FCSB,7652,1,8,5,1,27,13,14,29
CFR Cluj,7652,2,7,6,1,16,8,8,27
D Bucuresti,7652,3,5,4,5,21,19,2,19
Universitate,7652,4,3,5,6,15,22,-7,14
FC Botosani,7652,5,3,5,6,7,17,-10,14
Concordia Ch,7652,6,2,3,9,18,25,-7,9
FCSB,7653,1,8,6,0,27,12,15,30
CFR Cluj,7653,2,6,7,1,17,10,7,25
D Bucuresti,7653,3,4,5,5,20,20,0,17
Universitate,7653,4,3,5,6,15,22,-7,14
FC Botosani,7653,5,3,5,6,6,15,-9,14
Concordia Ch,7653,6,2,4,8,16,22,-6,10
FCSB,7654,1,9,5,0,29,14,15,32
CFR Cluj,7654,2,5,6,3,15,11,4,21
Universitate,7654,3,4,5,5,17,21,-4,17
D Bucuresti,7654,4,3,5,6,19,22,-3,14
Concordia Ch,7654,5,4,2,8,21,25,-4,14
FC Botosani,7654,6,3,5,6,6,14,-8,14
FCSB,7655,1,8,5,1,25,12,13,29
CFR Cluj,7655,2,7,6,1,16,7,9,27
FC Botosani,7655,3,5,4,5,8,13,-5,19
D Bucuresti,7655,4,3,5,6,18,21,-3,14
Universitate,7655,5,3,5,6,15,22,-7,14
Concordia Ch,7655,6,2,3,9,18,25,-7,9
FCSB,7656,1,8,6,0,26,11,15,30
CFR Cluj,7656,2,6,6,2,15,10,5,24
Universitate,7656,3,3,6,5,16,21,-5,15
Concordia Ch,7656,4,4,2,8,21,22,-1,14
D Bucuresti,7656,5,3,5,6,19,25,-6,14
FC Botosani,7656,6,3,5,6,9,17,-8,14
FCSB,7657,1,8,5,1,24,11,13,29
CFR Cluj,7657,2,5,7,2,14,9,5,22
D Bucuresti,7657,3,5,4,5,20,20,0,19
Universitate,7657,4,4,6,4,16,19,-3,18
FC Botosani,7657,5,4,4,6,7,13,-6,16
Concordia Ch,7657,6,2,2,10,17,26,-9,8
FCSB,7658,1,8,6,0,26,10,16,30
CFR Cluj,7658,2,6,6,2,15,10,5,24
D Bucuresti,7658,3,5,4,5,18,18,0,19
Universitate,7658,4,3,6,5,14,20,-6,15
FC Botosani,7658,5,3,4,7,5,14,-9,13
Concordia Ch,7658,6,3,2,9,16,22,-6,11
FCSB,7659,1,8,6,0,27,13,14,30
CFR Cluj,7659,2,6,7,1,17,8,9,25
D Bucuresti,7659,3,5,4,5,19,19,0,19
Universitate,7659,4,3,5,6,16,24,-8,14
FC Botosani,7659,5,3,5,6,7,15,-8,14
Concordia Ch,7659,6,2,3,9,18,25,-7,9
FCSB,7660,1,7,5,2,24,14,10,26
CFR Cluj,7660,2,6,6,2,15,10,5,24
Universitate,7660,3,5,5,4,20,20,0,20
D Bucuresti,7660,4,4,4,6,19,22,-3,16
FC Botosani,7660,5,3,5,6,7,15,-8,14
Concordia Ch,7660,6,3,3,8,19,23,-4,12
FCSB,7661,1,9,5,0,28,10,18,32
CFR Cluj,7661,2,5,7,2,13,11,2,22
FC Botosani,7661,3,4,5,5,7,12,-5,17
Universitate,7661,4,3,6,5,14,19,-5,15
D Bucuresti,7661,5,3,5,6,17,21,-4,14
Concordia Ch,7661,6,3,2,9,18,24,-6,11
FCSB,7662,1,9,5,0,29,14,15,32
CFR Cluj,7662,2,6,6,2,19,11,8,24
D Bucuresti,7662,3,5,4,5,20,19,1,19
Universitate,7662,4,3,5,6,15,23,-8,14
FC Botosani,7662,5,3,4,7,6,16,-10,13
Concordia Ch,7662,6,3,2,9,16,22,-6,11
FCSB,7663,1,7,5,2,25,15,10,26
CFR Cluj,7663,2,6,6,2,15,9,6,24
Universitate,7663,3,5,5,4,18,19,-1,20
D Bucuresti,7663,4,4,5,5,19,20,-1,17
FC Botosani,7663,5,4,5,5,6,12,-6,17
Concordia Ch,7663,6,2,2,10,17,25,-8,8
FCSB,7664,1,8,5,1,27,14,13,29
CFR Cluj,7664,2,7,6,1,18,8,10,27
FC Botosani,7664,3,4,5,5,10,15,-5,17
D Bucuresti,7664,4,3,5,6,17,21,-4,14
Universitate,7664,5,3,5,6,15,23,-8,14
Concordia Ch,7664,6,3,2,9,19,25,-6,11
FCSB,7665,1,7,7,0,23,10,13,28
CFR Cluj,7665,2,6,7,1,15,7,8,25
FC Botosani,7665,3,4,4,6,8,13,-5,16
Universitate,7665,4,3,6,5,14,20,-6,15
D Bucuresti,7665,5,3,5,6,17,22,-5,14
Concordia Ch,7665,6,3,3,8,17,22,-5,12
FCSB,7666,1,8,6,0,27,13,14,30
CFR Cluj,7666,2,6,7,1,17,10,7,25
D Bucuresti,7666,3,5,4,5,22,20,2,19
Universitate,7666,4,3,5,6,14,20,-6,14
FC Botosani,7666,5,3,4,7,6,17,-11,13
Concordia Ch,7666,6,3,2,9,20,26,-6,11
FCSB,7667,1,8,5,1,25,12,13,29
CFR Cluj,7667,2,5,7,2,15,10,5,22
Universitate,7667,3,4,6,4,16,19,-3,18
D Bucuresti,7667,4,4,5,5,17,18,-1,17
FC Botosani,7667,5,3,5,6,6,14,-8,14
Concordia Ch,7667,6,2,4,8,16,22,-6,10
FCSB,7668,1,7,7,0,25,12,13,28
CFR Cluj,7668,2,6,7,1,16,8,8,25
FC Botosani,7668,3,4,4,6,6,13,-7,16
Universitate,7668,4,3,6,5,15,21,-6,15
Concordia Ch,7668,5,4,2,8,20,23,-3,14
D Bucuresti,7668,6,3,4,7,18,23,-5,13
FCSB,7669,1,9,5,0,32,13,19,32
CFR Cluj,7669,2,5,6,3,17,16,1,21
Universitate,7669,3,4,5,5,16,21,-5,17
FC Botosani,7669,4,4,5,5,8,14,-6,17
D Bucuresti,7669,5,3,5,6,18,21,-3,14
Concordia Ch,7669,6,3,2,9,16,22,-6,11
FCSB,7670,1,9,5,0,29,11,18,32
CFR Cluj,7670,2,6,6,2,16,10,6,24
D Bucuresti,7670,3,4,4,6,18,20,-2,16
Concordia Ch,7670,4,4,2,8,17,21,-4,14
Universitate,7670,5,3,5,6,14,23,-9,14
FC Botosani,7670,6,3,4,7,6,15,-9,13
FCSB,7671,1,9,5,0,26,11,15,32
CFR Cluj,7671,2,6,6,2,15,9,6,24
FC Botosani,7671,3,4,5,5,9,15,-6,17
Universitate,7671,4,3,5,6,16,22,-6,14
D Bucuresti,7671,5,3,4,7,17,24,-7,13
Concordia Ch,7671,6,3,3,8,21,23,-2,12
FCSB,7672,1,9,5,0,27,11,16,32
CFR Cluj,7672,2,6,6,2,17,10,7,24
FC Botosani,7672,3,4,5,5,8,13,-5,17
D Bucuresti,7672,4,3,5,6,18,24,-6,14
Universitate,7672,5,3,5,6,14,22,-8,14
Concordia Ch,7672,6,3,2,9,20,24,-4,11
FCSB,7673,1,9,5,0,28,11,17,32
CFR Cluj,7673,2,6,6,2,15,9,6,24
D Bucuresti,7673,3,4,4,6,17,20,-3,16
FC Botosani,7673,4,4,4,6,7,14,-7,16
Universitate,7673,5,3,5,6,14,22,-8,14
Concordia Ch,7673,6,3,2,9,18,23,-5,11
FCSB,7674,1,7,6,1,24,13,11,27
CFR Cluj,7674,2,6,7,1,17,9,8,25
D Bucuresti,7674,3,4,5,5,19,19,0,17
Universitate,7674,4,3,7,4,17,21,-4,16
FC Botosani,7674,5,4,4,6,7,15,-8,16
Concordia Ch,7674,6,2,3,9,17,24,-7,9
FCSB,7675,1,7,6,1,24,13,11,27
CFR Cluj,7675,2,5,8,1,15,9,6,23
Universitate,7675,3,4,6,4,17,19,-2,18
D Bucuresti,7675,4,4,5,5,19,20,-1,17
FC Botosani,7675,5,4,5,5,6,12,-6,17
Concordia Ch,7675,6,2,2,10,17,25,-8,8
FCSB,7676,1,7,5,2,24,13,11,26
CFR Cluj,7676,2,6,6,2,15,9,6,24
Universitate,7676,3,5,5,4,18,20,-2,20
D Bucuresti,7676,4,4,4,6,18,21,-3,16
FC Botosani,7676,5,4,4,6,8,14,-6,16
Concordia Ch,7676,6,3,2,9,18,24,-6,11
FCSB,7677,1,8,5,1,25,12,13,29
CFR Cluj,7677,2,5,6,3,14,11,3,21
Universitate,7677,3,5,5,4,17,18,-1,20
FC Botosani,7677,4,4,5,5,9,14,-5,17
D Bucuresti,7677,5,3,6,5,18,20,-2,15
Concordia Ch,7677,6,2,3,9,17,25,-8,9
FCSB,7678,1,8,6,0,26,11,15,30
CFR Cluj,7678,2,5,7,2,13,10,3,22
D Bucuresti,7678,3,5,4,5,22,21,1,19
Universitate,7678,4,4,5,5,18,21,-3,17
FC Botosani,7678,5,3,5,6,6,15,-9,14
Concordia Ch,7678,6,2,3,9,19,26,-7,9
FCSB,7679,1,8,5,1,24,11,13,29
CFR Cluj,7679,2,5,7,2,13,8,5,22
Universitate,7679,3,4,6,4,15,18,-3,18
D Bucuresti,7679,4,4,4,6,19,19,0,16
Concordia Ch,7679,5,4,2,8,17,21,-4,14
FC Botosani,7679,6,3,4,7,5,16,-11,13
FCSB,7680,1,9,5,0,28,13,15,32
CFR Cluj,7680,2,6,6,2,16,9,7,24
D Bucuresti,7680,3,5,4,5,23,20,3,19
Universitate,7680,4,3,5,6,16,23,-7,14
FC Botosani,7680,5,3,5,6,5,14,-9,14
Concordia Ch,7680,6,2,3,9,17,26,-9,9
FCSB,7681,1,9,5,0,27,11,16,32
CFR Cluj,7681,2,5,7,2,15,11,4,22
D Bucuresti,7681,3,4,5,5,19,20,-1,17
FC Botosani,7681,4,4,5,5,9,14,-5,17
Universitate,7681,5,3,6,5,17,22,-5,15
Concordia Ch,7681,6,2,2,10,15,24,-9,8
FCSB,7682,1,8,6,0,26,11,15,30
CFR Cluj,7682,2,5,7,2,15,11,4,22
Universitate,7682,3,3,7,4,17,21,-4,16
FC Botosani,7682,4,4,4,6,8,14,-6,16
Concordia Ch,7682,5,4,2,8,21,23,-2,14
D Bucuresti,7682,6,3,4,7,17,24,-7,13
FCSB,7683,1,7,6,1,25,15,10,27
CFR Cluj,7683,2,5,7,2,15,10,5,22
Universitate,7683,3,5,5,4,20,20,0,20
D Bucuresti,7683,4,4,5,5,19,20,-1,17
FC Botosani,7683,5,3,4,7,5,14,-9,13
Concordia Ch,7683,6,3,3,8,18,23,-5,12
FCSB,7684,1,8,6,0,24,10,14,30
CFR Cluj,7684,2,6,6,2,15,9,6,24
FC Botosani,7684,3,5,4,5,11,15,-4,19
Universitate,7684,4,3,6,5,15,20,-5,15
D Bucuresti,7684,5,3,5,6,21,24,-3,14
Concordia Ch,7684,6,2,3,9,19,27,-8,9
FCSB,7685,1,7,5,2,24,13,11,26
CFR Cluj,7685,2,6,7,1,14,7,7,25
Universitate,7685,3,4,6,4,16,19,-3,18
D Bucuresti,7685,4,4,4,6,18,20,-2,16
FC Botosani,7685,5,3,5,6,6,15,-9,14
Concordia Ch,7685,6,3,3,8,18,22,-4,12
FCSB,7686,1,7,6,1,25,14,11,27
CFR Cluj,7686,2,6,7,1,15,8,7,25
Universitate,7686,3,4,5,5,17,20,-3,17
FC Botosani,7686,4,4,4,6,6,15,-9,16
D Bucuresti,7686,5,3,5,6,18,21,-3,14
Concordia Ch,7686,6,3,3,8,20,23,-3,12
FCSB,7687,1,8,6,0,25,11,14,30
CFR Cluj,7687,2,6,7,1,14,7,7,25
FC Botosani,7687,3,3,6,5,8,15,-7,15
D Bucuresti,7687,4,3,5,6,18,21,-3,14
Universitate,7687,5,3,5,6,15,21,-6,14
Concordia Ch,7687,6,3,3,8,19,24,-5,12
FCSB,7688,1,8,5,1,27,12,15,29
CFR Cluj,7688,2,5,6,3,14,12,2,21
Universitate,7688,3,5,5,4,18,20,-2,20
D Bucuresti,7688,4,5,4,5,21,19,2,19
FC Botosani,7688,5,4,4,6,7,16,-9,16
Concordia Ch,7688,6,2,2,10,17,25,-8,8
FCSB,7689,1,8,6,0,26,11,15,30
CFR Cluj,7689,2,6,6,2,15,10,5,24
D Bucuresti,7689,3,4,4,6,19,19,0,16
FC Botosani,7689,4,4,4,6,6,15,-9,16
Universitate,7689,5,3,6,5,16,21,-5,15
Concordia Ch,7689,6,3,2,9,16,22,-6,11
FCSB,7690,1,7,6,1,25,14,11,27
CFR Cluj,7690,2,5,8,1,16,10,6,23
Universitate,7690,3,4,6,4,19,21,-2,18
D Bucuresti,7690,4,4,5,5,21,18,3,17
FC Botosani,7690,5,4,4,6,8,18,-10,16
Concordia Ch,7690,6,2,3,9,16,24,-8,9
FCSB,7691,1,8,5,1,28,14,14,29
CFR Cluj,7691,2,6,6,2,14,9,5,24
FC Botosani,7691,3,5,4,5,10,13,-3,19
Universitate,7691,4,4,5,5,18,22,-4,17
D Bucuresti,7691,5,3,4,7,19,25,-6,13
Concordia Ch,7691,6,3,2,9,20,26,-6,11
FCSB,7692,1,8,6,0,25,10,15,30
CFR Cluj,7692,2,5,6,3,13,12,1,21
FC Botosani,7692,3,5,4,5,8,13,-5,19
Universitate,7692,4,4,6,4,17,18,-1,18
D Bucuresti,7692,5,3,4,7,16,21,-5,13
Concordia Ch,7692,6,3,2,9,18,23,-5,11
FCSB,7693,1,8,5,1,29,16,13,29
CFR Cluj,7693,2,5,6,3,15,13,2,21
Universitate,7693,3,5,5,4,20,20,0,20
D Bucuresti,7693,4,4,4,6,17,21,-4,16
FC Botosani,7693,5,4,4,6,7,13,-6,16
Concordia Ch,7693,6,3,2,9,18,23,-5,11
FCSB,7694,1,8,6,0,27,12,15,30
CFR Cluj,7694,2,5,7,2,13,9,4,22
D Bucuresti,7694,3,4,5,5,21,21,0,17
Universitate,7694,4,3,7,4,16,20,-4,16
FC Botosani,7694,5,4,4,6,9,15,-6,16
Concordia Ch,7694,6,2,3,9,17,26,-9,9
FCSB,7695,1,7,5,2,24,15,9,26
CFR Cluj,7695,2,6,7,1,14,7,7,25
Universitate,7695,3,4,6,4,18,19,-1,18
FC Botosani,7695,4,4,5,5,8,14,-6,17
D Bucuresti,7695,5,3,5,6,17,20,-3,14
Concordia Ch,7695,6,2,4,8,18,24,-6,10
FCSB,7696,1,8,5,1,26,12,14,29
CFR Cluj,7696,2,6,6,2,14,10,4,24
Universitate,7696,3,4,5,5,16,19,-3,17
FC Botosani,7696,4,4,5,5,10,15,-5,17
D Bucuresti,7696,5,3,5,6,19,23,-4,14
Concordia Ch,7696,6,3,2,9,19,25,-6,11
CFR Cluj,7697,1,7,6,1,15,7,8,27
FCSB,7697,2,7,5,2,23,13,10,26
D Bucuresti,7697,3,4,5,5,18,19,-1,17
Universitate,7697,4,4,5,5,16,19,-3,17
FC Botosani,7697,5,3,6,5,8,15,-7,15
Concordia Ch,7697,6,2,3,9,17,24,-7,9
FCSB,7698,1,9,5,0,26,10,16,32
CFR Cluj,7698,2,5,7,2,13,9,4,22
D Bucuresti,7698,3,5,4,5,20,20,0,19
FC Botosani,7698,4,4,4,6,8,13,-5,16
Universitate,7698,5,3,6,5,14,19,-5,15
Concordia Ch,7698,6,2,2,10,17,27,-10,8
FCSB,7699,1,7,6,1,24,12,12,27
CFR Cluj,7699,2,7,6,1,16,7,9,27
FC Botosani,7699,3,4,4,6,7,14,-7,16
Universitate,7699,4,3,6,5,15,21,-6,15
Concordia Ch,7699,5,4,2,8,19,23,-4,14
D Bucuresti,7699,6,3,4,7,19,23,-4,13
FCSB,7700,1,9,5,0,26,10,16,32
CFR Cluj,7700,2,5,7,2,14,9,5,22
FC Botosani,7700,3,4,5,5,7,13,-6,17
Universitate,7700,4,3,6,5,15,21,-6,15
D Bucuresti,7700,5,3,4,7,17,23,-6,13
Concordia Ch,7700,6,3,3,8,18,21,-3,12
FCSB,7701,1,8,6,0,26,12,14,30
CFR Cluj,7701,2,6,6,2,15,9,6,24
D Bucuresti,7701,3,5,4,5,21,19,2,19
Universitate,7701,4,3,6,5,15,20,-5,15
FC Botosani,7701,5,3,5,6,5,15,-10,14
Concordia Ch,7701,6,2,3,9,16,23,-7,9
FCSB,7702,1,8,5,1,27,13,14,29
CFR Cluj,7702,2,7,6,1,16,7,9,27
FC Botosani,7702,3,4,4,6,8,14,-6,16
Concordia Ch,7702,4,4,2,8,17,21,-4,14
Universitate,7702,5,3,5,6,15,23,-8,14
D Bucuresti,7702,6,3,4,7,17,22,-5,13
FCSB,7703,1,8,6,0,26,11,15,30
CFR Cluj,7703,2,5,6,3,14,11,3,21
D Bucuresti,7703,3,5,4,5,21,19,2,19
Universitate,7703,4,4,6,4,17,20,-3,18
FC Botosani,7703,5,3,4,7,5,16,-11,13
Concordia Ch,7703,6,3,2,9,17,23,-6,11
FCSB,7704,1,8,6,0,24,10,14,30
CFR Cluj,7704,2,5,8,1,13,7,6,23
FC Botosani,7704,3,4,4,6,7,15,-8,16
Universitate,7704,4,3,6,5,14,19,-5,15
D Bucuresti,7704,5,3,5,6,18,21,-3,14
Concordia Ch,7704,6,3,3,8,18,22,-4,12
FCSB,7705,1,8,5,1,25,12,13,29
CFR Cluj,7705,2,6,6,2,15,9,6,24
Universitate,7705,3,4,5,5,17,21,-4,17
D Bucuresti,7705,4,4,4,6,17,20,-3,16
Concordia Ch,7705,5,4,2,8,18,21,-3,14
FC Botosani,7705,6,3,4,7,5,14,-9,13
FCSB,7706,1,8,6,0,25,10,15,30
CFR Cluj,7706,2,5,6,3,14,11,3,21
Universitate,7706,3,4,6,4,16,19,-3,18
D Bucuresti,7706,4,4,5,5,19,19,0,17
FC Botosani,7706,5,3,4,7,7,17,-10,13
Concordia Ch,7706,6,3,3,8,17,22,-5,12
FCSB,7707,1,7,6,1,23,11,12,27
CFR Cluj,7707,2,6,7,1,15,8,7,25
FC Botosani,7707,3,5,4,5,8,12,-4,19
D Bucuresti,7707,4,4,4,6,20,20,0,16
Universitate,7707,5,3,7,4,15,19,-4,16
Concordia Ch,7707,6,2,2,10,16,27,-11,8
FCSB,7708,1,7,6,1,24,12,12,27
CFR Cluj,7708,2,5,7,2,13,8,5,22
Universitate,7708,3,5,5,4,17,19,-2,20
Concordia Ch,7708,4,4,2,8,19,21,-2,14
D Bucuresti,7708,5,3,5,6,17,21,-4,14
FC Botosani,7708,6,3,5,6,6,15,-9,14
FCSB,7709,1,8,6,0,28,13,15,30
CFR Cluj,7709,2,6,7,1,17,10,7,25
FC Botosani,7709,3,5,4,5,7,12,-5,19
Universitate,7709,4,3,5,6,16,23,-7,14
D Bucuresti,7709,5,3,4,7,16,22,-6,13
Concordia Ch,7709,6,3,2,9,18,22,-4,11
FCSB,7710,1,8,5,1,27,15,12,29
CFR Cluj,7710,2,6,6,2,17,11,6,24
Universitate,7710,3,4,5,5,17,20,-3,17
Concordia Ch,7710,4,4,2,8,18,21,-3,14
D Bucuresti,7710,5,3,5,6,16,20,-4,14
FC Botosani,7710,6,3,5,6,5,13,-8,14
FCSB,7711,1,8,6,0,28,12,16,30
CFR Cluj,7711,2,6,6,2,15,10,5,24
D Bucuresti,7711,3,4,5,5,17,18,-1,17
FC Botosani,7711,4,4,5,5,7,12,-5,17
Universitate,7711,5,3,6,5,16,22,-6,15
Concordia Ch,7711,6,2,2,10,15,24,-9,8
FCSB,7712,1,9,5,0,26,11,15,32
CFR Cluj,7712,2,5,7,2,14,9,5,22
FC Botosani,7712,3,4,5,5,7,13,-6,17
D Bucuresti,7712,4,3,6,5,18,20,-2,15
Universitate,7712,5,3,6,5,16,21,-5,15
Concordia Ch,7712,6,2,3,9,16,23,-7,9
FCSB,7713,1,7,5,2,23,15,8,26
CFR Cluj,7713,2,6,7,1,17,9,8,25
Universitate,7713,3,4,6,4,19,20,-1,18
D Bucuresti,7713,4,4,5,5,18,18,0,17
FC Botosani,7713,5,3,6,5,6,13,-7,15
Concordia Ch,7713,6,2,3,9,16,24,-8,9
CFR Cluj,7714,1,7,6,1,16,8,8,27
FCSB,7714,2,7,5,2,25,15,10,26
D Bucuresti,7714,3,5,4,5,20,20,0,19
Universitate,7714,4,4,5,5,17,20,-3,17
FC Botosani,7714,5,3,5,6,7,15,-8,14
Concordia Ch,7714,6,2,3,9,17,24,-7,9
FCSB,7715,1,8,6,0,25,11,14,30
CFR Cluj,7715,2,6,6,2,15,9,6,24
FC Botosani,7715,3,4,5,5,8,13,-5,17
D Bucuresti,7715,4,4,4,6,20,20,0,16
Universitate,7715,5,3,6,5,16,21,-5,15
Concordia Ch,7715,6,2,3,9,16,26,-10,9
FCSB,7716,1,8,6,0,24,10,14,30
CFR Cluj,7716,2,5,8,1,13,7,6,23
D Bucuresti,7716,3,4,4,6,17,19,-2,16
FC Botosani,7716,4,4,4,6,7,13,-6,16
Universitate,7716,5,3,6,5,14,19,-5,15
Concordia Ch,7716,6,3,2,9,16,23,-7,11
FCSB,7717,1,8,6,0,26,10,16,30
CFR Cluj,7717,2,5,8,1,13,7,6,23
D Bucuresti,7717,3,5,4,5,20,19,1,19
FC Botosani,7717,4,4,4,6,7,15,-8,16
Universitate,7717,5,3,6,5,14,21,-7,15
Concordia Ch,7717,6,2,2,10,17,25,-8,8
FCSB,7718,1,8,5,1,27,12,15,29
CFR Cluj,7718,2,6,7,1,16,9,7,25
FC Botosani,7718,3,4,5,5,11,13,-2,17
Universitate,7718,4,3,6,5,15,22,-7,15
D Bucuresti,7718,5,3,5,6,16,21,-5,14
Concordia Ch,7718,6,3,2,9,19,27,-8,11
FCSB,7719,1,8,5,1,26,13,13,29
CFR Cluj,7719,2,7,6,1,17,8,9,27
D Bucuresti,7719,3,3,6,5,17,19,-2,15
Universitate,7719,4,3,5,6,15,22,-7,14
FC Botosani,7719,5,3,5,6,6,16,-10,14
Concordia Ch,7719,6,3,3,8,20,23,-3,12
FCSB,7720,1,8,6,0,26,10,16,30
CFR Cluj,7720,2,5,7,2,14,9,5,22
D Bucuresti,7720,3,4,5,5,20,21,-1,17
Universitate,7720,4,4,5,5,16,22,-6,17
FC Botosani,7720,5,3,5,6,7,15,-8,14
Concordia Ch,7720,6,2,4,8,18,24,-6,10
FCSB,7721,1,9,5,0,27,10,17,32
CFR Cluj,7721,2,6,6,2,14,10,4,24
D Bucuresti,7721,3,4,4,6,17,21,-4,16
Concordia Ch,7721,4,4,2,8,19,21,-2,14
Universitate,7721,5,3,5,6,14,20,-6,14
FC Botosani,7721,6,3,4,7,5,14,-9,13
FCSB,7722,1,8,5,1,24,13,11,29
CFR Cluj,7722,2,5,6,3,13,11,2,21
Universitate,7722,3,5,5,4,20,18,2,20
D Bucuresti,7722,4,5,4,5,19,19,0,19
FC Botosani,7722,5,3,5,6,6,14,-8,14
Concordia Ch,7722,6,2,3,9,17,24,-7,9
FCSB,7723,1,8,6,0,25,10,15,30
CFR Cluj,7723,2,5,6,3,13,10,3,21
Universitate,7723,3,4,6,4,15,18,-3,18
D Bucuresti,7723,4,3,6,5,16,18,-2,15
FC Botosani,7723,5,3,5,6,5,13,-8,14
Concordia Ch,7723,6,3,3,8,16,21,-5,12
FCSB,7724,1,9,5,0,30,13,17,32
CFR Cluj,7724,2,5,6,3,14,10,4,21
Universitate,7724,3,4,5,5,17,23,-6,17
FC Botosani,7724,4,4,4,6,8,14,-6,16
D Bucuresti,7724,5,3,5,6,18,22,-4,14
Concordia Ch,7724,6,3,3,8,17,22,-5,12
FCSB,7725,1,7,6,1,26,15,11,27
CFR Cluj,7725,2,7,6,1,17,8,9,27
D Bucuresti,7725,3,4,5,5,19,20,-1,17
Universitate,7725,4,3,6,5,16,21,-5,15
FC Botosani,7725,5,3,5,6,5,13,-8,14
Concordia Ch,7725,6,2,4,8,17,23,-6,10
FCSB,7726,1,8,5,1,25,14,11,29
CFR Cluj,7726,2,5,7,2,13,9,4,22
Universitate,7726,3,4,6,4,18,18,0,18
D Bucuresti,7726,4,4,4,6,19,22,-3,16
FC Botosani,7726,5,4,4,6,7,14,-7,16
Concordia Ch,7726,6,3,2,9,18,23,-5,11
FCSB,7727,1,7,5,2,24,13,11,26
CFR Cluj,7727,2,6,6,2,15,9,6,24
Universitate,7727,3,5,5,4,16,18,-2,20
FC Botosani,7727,4,5,4,5,8,12,-4,19
D Bucuresti,7727,5,4,4,6,17,20,-3,16
Concordia Ch,7727,6,2,2,10,15,23,-8,8
FCSB,7728,1,7,7,0,25,12,13,28
CFR Cluj,7728,2,5,7,2,15,10,5,22
Universitate,7728,3,4,6,4,19,22,-3,18
D Bucuresti,7728,4,4,4,6,18,21,-3,16
FC Botosani,7728,5,3,5,6,6,14,-8,14
Concordia Ch,7728,6,3,3,8,19,23,-4,12
FCSB,7729,1,8,6,0,25,11,14,30
CFR Cluj,7729,2,6,6,2,16,10,6,24
D Bucuresti,7729,3,4,4,6,22,24,-2,16
FC Botosani,7729,4,4,4,6,10,17,-7,16
Universitate,7729,5,3,6,5,15,20,-5,15
Concordia Ch,7729,6,3,2,9,18,24,-6,11
FCSB,7730,1,8,6,0,27,13,14,30
CFR Cluj,7730,2,6,6,2,17,11,6,24
D Bucuresti,7730,3,4,5,5,18,18,0,17
Universitate,7730,4,3,6,5,16,21,-5,15
FC Botosani,7730,5,3,5,6,5,13,-8,14
Concordia Ch,7730,6,3,2,9,16,23,-7,11
FCSB,7731,1,8,6,0,26,11,15,30
CFR Cluj,7731,2,5,7,2,13,9,4,22
D Bucuresti,7731,3,5,4,5,23,18,5,19
Universitate,7731,4,3,7,4,15,19,-4,16
FC Botosani,7731,5,3,4,7,5,17,-12,13
Concordia Ch,7731,6,3,2,9,16,24,-8,11
FCSB,7732,1,8,5,1,26,14,12,29
CFR Cluj,7732,2,5,7,2,14,9,5,22
Universitate,7732,3,4,6,4,19,21,-2,18
D Bucuresti,7732,4,4,5,5,21,20,1,17
FC Botosani,7732,5,4,5,5,7,13,-6,17
Concordia Ch,7732,6,2,2,10,16,26,-10,8
FCSB,7733,1,9,5,0,27,11,16,32
CFR Cluj,7733,2,6,6,2,17,10,7,24
D Bucuresti,7733,3,4,4,6,18,20,-2,16
FC Botosani,7733,4,4,4,6,6,14,-8,16
Universitate,7733,5,3,5,6,15,23,-8,14
Concordia Ch,7733,6,3,2,9,17,22,-5,11
FCSB,7734,1,7,6,1,24,12,12,27
CFR Cluj,7734,2,5,7,2,13,8,5,22
Universitate,7734,3,5,5,4,17,19,-2,20
D Bucuresti,7734,4,4,5,5,19,20,-1,17
FC Botosani,7734,5,4,4,6,9,13,-4,16
Concordia Ch,7734,6,2,3,9,17,27,-10,9
FCSB,7735,1,9,5,0,26,11,15,32
CFR Cluj,7735,2,6,6,2,15,9,6,24
FC Botosani,7735,3,4,4,6,7,13,-6,16
Concordia Ch,7735,4,4,2,8,17,21,-4,14
Universitate,7735,5,3,5,6,14,20,-6,14
D Bucuresti,7735,6,3,4,7,16,21,-5,13
FCSB,7736,1,9,5,0,28,12,16,32
CFR Cluj,7736,2,5,7,2,18,14,4,22
Universitate,7736,3,3,6,5,17,22,-5,15
Concordia Ch,7736,4,4,2,8,20,22,-2,14
D Bucuresti,7736,5,3,5,6,16,21,-5,14
FC Botosani,7736,6,3,5,6,6,14,-8,14
FCSB,7737,1,8,6,0,24,10,14,30
CFR Cluj,7737,2,6,7,1,16,7,9,25
D Bucuresti,7737,3,4,4,6,19,20,-1,16
Universitate,7737,4,3,5,6,14,22,-8,14
FC Botosani,7737,5,3,5,6,7,16,-9,14
Concordia Ch,7737,6,3,3,8,19,24,-5,12
FCSB,7738,1,8,5,1,25,12,13,29
CFR Cluj,7738,2,6,7,1,14,7,7,25
FC Botosani,7738,3,4,4,6,9,16,-7,16
Universitate,7738,4,3,6,5,15,20,-5,15
D Bucuresti,7738,5,3,5,6,19,23,-4,14
Concordia Ch,7738,6,3,3,8,18,22,-4,12
FCSB,7739,1,9,5,0,25,10,15,32
CFR Cluj,7739,2,6,6,2,15,8,7,24
Concordia Ch,7739,3,4,2,8,21,24,-3,14
D Bucuresti,7739,4,3,5,6,18,22,-4,14
Universitate,7739,5,3,5,6,14,21,-7,14
FC Botosani,7739,6,3,5,6,6,14,-8,14
FCSB,7740,1,7,5,2,24,15,9,26
CFR Cluj,7740,2,6,7,1,15,8,7,25
Universitate,7740,3,4,6,4,19,20,-1,18
FC Botosani,7740,4,4,5,5,8,13,-5,17
D Bucuresti,7740,5,3,5,6,18,21,-3,14
Concordia Ch,7740,6,3,2,9,19,26,-7,11
FCSB,7741,1,8,6,0,24,10,14,30
CFR Cluj,7741,2,6,7,1,15,7,8,25
FC Botosani,7741,3,4,5,5,9,15,-6,17
Universitate,7741,4,3,5,6,14,21,-7,14
D Bucuresti,7741,5,3,4,7,19,24,-5,13
Concordia Ch,7741,6,3,3,8,19,23,-4,12
FCSB,7742,1,8,5,1,26,13,13,29
CFR Cluj,7742,2,7,6,1,17,8,9,27
D Bucuresti,7742,3,3,6,5,17,19,-2,15
FC Botosani,7742,4,3,6,5,5,12,-7,15
Universitate,7742,5,3,5,6,14,21,-7,14
Concordia Ch,7742,6,2,4,8,16,22,-6,10
CFR Cluj,7743,1,7,6,1,16,8,8,27
FCSB,7743,2,7,5,2,24,13,11,26
Universitate,7743,3,4,5,5,15,19,-4,17
FC Botosani,7743,4,4,4,6,7,15,-8,16
D Bucuresti,7743,5,3,5,6,17,21,-4,14
Concordia Ch,7743,6,3,3,8,19,22,-3,12
FCSB,7744,1,7,6,1,24,12,12,27
CFR Cluj,7744,2,5,8,1,14,8,6,23
D Bucuresti,7744,3,5,4,5,22,19,3,19
Universitate,7744,4,4,6,4,17,20,-3,18
FC Botosani,7744,5,4,4,6,6,14,-8,16
Concordia Ch,7744,6,2,2,10,16,26,-10,8
CFR Cluj,7745,1,7,6,1,21,9,12,27
FCSB,7745,2,7,6,1,24,14,10,27
FC Botosani,7745,3,5,4,5,9,14,-5,19
Universitate,7745,4,3,6,5,15,22,-7,15
D Bucuresti,7745,5,3,4,7,18,23,-5,13
Concordia Ch,7745,6,3,2,9,17,22,-5,11
FCSB,7746,1,8,5,1,28,14,14,29
CFR Cluj,7746,2,6,7,1,16,8,8,25
D Bucuresti,7746,3,5,4,5,24,22,2,19
FC Botosani,7746,4,4,4,6,10,17,-7,16
Universitate,7746,5,3,6,5,15,22,-7,15
Concordia Ch,7746,6,2,2,10,17,27,-10,8
FCSB,7747,1,9,5,0,27,12,15,32
CFR Cluj,7747,2,6,6,2,17,10,7,24
FC Botosani,7747,3,5,4,5,9,14,-5,19
D Bucuresti,7747,4,4,4,6,19,21,-2,16
Universitate,7747,5,3,5,6,14,21,-7,14
Concordia Ch,7747,6,2,2,10,17,25,-8,8
FCSB,7748,1,8,5,1,25,11,14,29
CFR Cluj,7748,2,6,7,1,15,8,7,25
FC Botosani,7748,3,4,5,5,8,14,-6,17
D Bucuresti,7748,4,4,4,6,20,20,0,16
Universitate,7748,5,3,6,5,15,21,-6,15
Concordia Ch,7748,6,2,3,9,16,25,-9,9
CFR Cluj,7749,1,7,6,1,23,9,14,27
FCSB,7749,2,7,5,2,25,16,9,26
Universitate,7749,3,4,5,5,18,26,-8,17
D Bucuresti,7749,4,4,4,6,17,19,-2,16
FC Botosani,7749,5,4,4,6,6,14,-8,16
Concordia Ch,7749,6,3,2,9,17,22,-5,11
FCSB,7750,1,9,5,0,27,12,15,32
CFR Cluj,7750,2,5,7,2,15,10,5,22
D Bucuresti,7750,3,4,4,6,17,19,-2,16
FC Botosani,7750,4,4,4,6,7,14,-7,16
Universitate,7750,5,3,6,5,16,21,-5,15
Concordia Ch,7750,6,3,2,9,17,23,-6,11
FCSB,7751,1,7,6,1,25,13,12,27
CFR Cluj,7751,2,6,7,1,15,8,7,25
D Bucuresti,7751,3,5,4,5,19,18,1,19
Universitate,7751,4,4,5,5,16,20,-4,17
FC Botosani,7751,5,3,4,7,5,15,-10,13
Concordia Ch,7751,6,3,2,9,16,22,-6,11
FCSB,7752,1,7,6,1,27,16,11,27
CFR Cluj,7752,2,6,7,1,19,11,8,25
D Bucuresti,7752,3,4,5,5,20,19,1,17
Universitate,7752,4,4,5,5,18,22,-4,17
FC Botosani,7752,5,4,5,5,8,13,-5,17
Concordia Ch,7752,6,2,2,10,15,26,-11,8
FCSB,7753,1,8,6,0,26,11,15,30
CFR Cluj,7753,2,5,8,1,15,9,6,23
FC Botosani,7753,3,5,4,5,8,12,-4,19
Universitate,7753,4,3,6,5,15,21,-6,15
D Bucuresti,7753,5,3,5,6,17,20,-3,14
Concordia Ch,7753,6,2,3,9,16,24,-8,9
FCSB,7754,1,8,5,1,24,11,13,29
CFR Cluj,7754,2,6,6,2,14,8,6,24
D Bucuresti,7754,3,4,5,5,19,19,0,17
Universitate,7754,4,4,5,5,15,19,-4,17
FC Botosani,7754,5,4,5,5,7,13,-6,17
Concordia Ch,7754,6,2,2,10,15,24,-9,8
FCSB,7755,1,9,5,0,28,13,15,32
CFR Cluj,7755,2,6,6,2,17,11,6,24
D Bucuresti,7755,3,4,4,6,20,23,-3,16
FC Botosani,7755,4,4,4,6,9,16,-7,16
Universitate,7755,5,3,5,6,18,24,-6,14
Concordia Ch,7755,6,3,2,9,18,23,-5,11
FCSB,7756,1,9,5,0,30,13,17,32
CFR Cluj,7756,2,5,7,2,16,12,4,22
D Bucuresti,7756,3,5,4,5,21,19,2,19
Universitate,7756,4,3,6,5,16,22,-6,15
FC Botosani,7756,5,3,4,7,7,18,-11,13
Concordia Ch,7756,6,3,2,9,19,25,-6,11
FCSB,7757,1,8,6,0,27,11,16,30
CFR Cluj,7757,2,5,8,1,15,9,6,23
D Bucuresti,7757,3,4,4,6,17,19,-2,16
Universitate,7757,4,3,6,5,15,22,-7,15
Concordia Ch,7757,5,4,2,8,17,21,-4,14
FC Botosani,7757,6,3,4,7,5,14,-9,13
FCSB,7758,1,8,6,0,26,11,15,30
CFR Cluj,7758,2,6,6,2,15,9,6,24
D Bucuresti,7758,3,4,4,6,19,22,-3,16
FC Botosani,7758,4,4,4,6,8,14,-6,16
Universitate,7758,5,3,6,5,15,21,-6,15
Concordia Ch,7758,6,3,2,9,18,24,-6,11
FCSB,7759,1,7,7,0,25,12,13,28
CFR Cluj,7759,2,5,7,2,15,11,4,22
Universitate,7759,3,4,6,4,16,18,-2,18
D Bucuresti,7759,4,4,5,5,20,19,1,17
FC Botosani,7759,5,3,5,6,8,19,-11,14
Concordia Ch,7759,6,3,2,9,21,26,-5,11
FCSB,7760,1,7,5,2,24,14,10,26
CFR Cluj,7760,2,6,6,2,16,11,5,24
Universitate,7760,3,5,5,4,19,19,0,20
D Bucuresti,7760,4,5,4,5,21,20,1,19
FC Botosani,7760,5,3,4,7,7,16,-9,13
Concordia Ch,7760,6,3,2,9,16,23,-7,11
FCSB,7761,1,8,5,1,24,11,13,29
CFR Cluj,7761,2,5,7,2,13,8,5,22
D Bucuresti,7761,3,5,4,5,19,19,0,19
Universitate,7761,4,4,6,4,15,18,-3,18
FC Botosani,7761,5,3,4,7,6,15,-9,13
Concordia Ch,7761,6,3,2,9,16,22,-6,11
FCSB,7762,1,8,5,1,26,12,14,29
CFR Cluj,7762,2,6,6,2,14,9,5,24
Universitate,7762,3,4,5,5,16,20,-4,17
D Bucuresti,7762,4,4,4,6,17,20,-3,16
FC Botosani,7762,5,3,5,6,7,15,-8,14
Concordia Ch,7762,6,3,3,8,19,23,-4,12
FCSB,7763,1,7,6,1,24,13,11,27
CFR Cluj,7763,2,5,7,2,13,8,5,22
Universitate,7763,3,5,5,4,18,19,-1,20
D Bucuresti,7763,4,4,5,5,19,18,1,17
FC Botosani,7763,5,3,5,6,6,14,-8,14
Concordia Ch,7763,6,3,2,9,17,25,-8,11
FCSB,7764,1,8,5,1,26,12,14,29
CFR Cluj,7764,2,5,7,2,15,11,4,22
Universitate,7764,3,4,6,4,16,19,-3,18
D Bucuresti,7764,4,4,4,6,21,19,2,16
FC Botosani,7764,5,3,5,6,5,17,-12,14
Concordia Ch,7764,6,3,3,8,16,21,-5,12
FCSB,7765,1,9,5,0,27,11,16,32
CFR Cluj,7765,2,5,6,3,13,10,3,21
Universitate,7765,3,4,5,5,16,20,-4,17
Concordia Ch,7765,4,4,2,8,21,23,-2,14
D Bucuresti,7765,5,3,5,6,18,23,-5,14
FC Botosani,7765,6,3,5,6,5,13,-8,14
FCSB,7766,1,9,5,0,30,12,18,32
CFR Cluj,7766,2,5,6,3,15,12,3,21
Universitate,7766,3,4,5,5,17,23,-6,17
FC Botosani,7766,4,3,6,5,6,13,-7,15
D Bucuresti,7766,5,3,5,6,17,21,-4,14
Concordia Ch,7766,6,3,3,8,19,23,-4,12
FCSB,7767,1,7,6,1,24,13,11,27
CFR Cluj,7767,2,7,6,1,16,7,9,27
D Bucuresti,7767,3,4,4,6,18,23,-5,16
Universitate,7767,4,3,6,5,15,20,-5,15
FC Botosani,7767,5,3,5,6,5,13,-8,14
Concordia Ch,7767,6,3,3,8,20,22,-2,12
FCSB,7768,1,9,5,0,27,10,17,32
CFR Cluj,7768,2,5,6,3,14,11,3,21
D Bucuresti,7768,3,5,4,5,22,19,3,19
Universitate,7768,4,4,5,5,16,21,-5,17
FC Botosani,7768,5,3,5,6,5,14,-9,14
Concordia Ch,7768,6,2,3,9,16,25,-9,9
FCSB,7769,1,8,5,1,27,11,16,29
CFR Cluj,7769,2,6,6,2,16,11,5,24
Universitate,7769,3,4,5,5,15,21,-6,17
D Bucuresti,7769,4,4,4,6,17,19,-2,16
Concordia Ch,7769,5,4,2,8,17,21,-4,14
FC Botosani,7769,6,3,4,7,5,14,-9,13
FCSB,7770,1,7,5,2,25,15,10,26
CFR Cluj,7770,2,6,7,1,17,9,8,25
Universitate,7770,3,4,6,4,17,20,-3,18
D Bucuresti,7770,4,4,5,5,19,19,0,17
FC Botosani,7770,5,3,5,6,5,14,-9,14
Concordia Ch,7770,6,2,4,8,16,22,-6,10
FCSB,7771,1,8,6,0,26,12,14,30
CFR Cluj,7771,2,6,6,2,16,10,6,24
FC Botosani,7771,3,4,5,5,7,13,-6,17
D Bucuresti,7771,4,3,6,5,19,21,-2,15
Universitate,7771,5,3,6,5,16,21,-5,15
Concordia Ch,7771,6,2,3,9,17,24,-7,9
FCSB,7772,1,8,6,0,25,11,14,30
CFR Cluj,7772,2,5,7,2,13,8,5,22
FC Botosani,7772,3,5,4,5,10,14,-4,19
Universitate,7772,4,3,7,4,15,19,-4,16
D Bucuresti,7772,5,3,4,7,19,23,-4,13
Concordia Ch,7772,6,3,2,9,17,24,-7,11
FCSB,7773,1,7,6,1,23,12,11,27
CFR Cluj,7773,2,6,7,1,16,7,9,25
D Bucuresti,7773,3,4,5,5,18,19,-1,17
Universitate,7773,4,4,5,5,16,21,-5,17
FC Botosani,7773,5,3,5,6,7,15,-8,14
Concordia Ch,7773,6,2,4,8,18,24,-6,10
FCSB,7774,1,8,5,1,27,14,13,29
CFR Cluj,7774,2,6,6,2,15,12,3,24
D Bucuresti,7774,3,4,5,5,20,20,0,17
Universitate,7774,4,4,5,5,19,20,-1,17
FC Botosani,7774,5,3,5,6,7,16,-9,14
Concordia Ch,7774,6,2,4,8,17,23,-6,10
FCSB,7775,1,8,5,1,25,11,14,29
CFR Cluj,7775,2,6,7,1,14,7,7,25
FC Botosani,7775,3,5,4,5,7,12,-5,19
Universitate,7775,4,3,6,5,14,20,-6,15
D Bucuresti,7775,5,3,4,7,17,22,-5,13
Concordia Ch,7775,6,3,2,9,18,23,-5,11
FCSB,7776,1,8,5,1,27,14,13,29
CFR Cluj,7776,2,6,7,1,15,8,7,25
D Bucuresti,7776,3,4,5,5,18,18,0,17
FC Botosani,7776,4,4,5,5,6,12,-6,17
Universitate,7776,5,3,6,5,16,21,-5,15
Concordia Ch,7776,6,2,2,10,15,24,-9,8
FCSB,7777,1,9,5,0,29,11,18,32
CFR Cluj,7777,2,5,7,2,14,11,3,22
D Bucuresti,7777,3,4,4,6,19,21,-2,16
FC Botosani,7777,4,4,4,6,8,14,-6,16
Universitate,7777,5,3,6,5,14,20,-6,15
Concordia Ch,7777,6,3,2,9,17,24,-7,11
FCSB,7778,1,8,5,1,25,11,14,29
CFR Cluj,7778,2,6,7,1,16,9,7,25
FC Botosani,7778,3,5,4,5,7,12,-5,19
Universitate,7778,4,3,6,5,16,22,-6,15
D Bucuresti,7778,5,3,5,6,16,19,-3,14
Concordia Ch,7778,6,2,3,9,15,22,-7,9
FCSB,7779,1,7,6,1,24,12,12,27
CFR Cluj,7779,2,6,7,1,15,8,7,25
D Bucuresti,7779,3,4,5,5,18,19,-1,17
Universitate,7779,4,4,5,5,15,19,-4,17
FC Botosani,7779,5,3,6,5,7,14,-7,15
Concordia Ch,7779,6,2,3,9,16,23,-7,9
FCSB,7780,1,8,6,0,26,11,15,30
CFR Cluj,7780,2,5,7,2,13,9,4,22
D Bucuresti,7780,3,4,4,6,17,19,-2,16
Universitate,7780,4,3,7,4,15,19,-4,16
FC Botosani,7780,5,3,5,6,6,14,-8,14
Concordia Ch,7780,6,3,3,8,17,22,-5,12
FCSB,7781,1,7,6,1,24,12,12,27
CFR Cluj,7781,2,5,8,1,15,9,6,23
Universitate,7781,3,4,6,4,16,19,-3,18
D Bucuresti,7781,4,4,4,6,20,22,-2,16
Concordia Ch,7781,5,4,2,8,19,22,-3,14
FC Botosani,7781,6,3,4,7,7,17,-10,13
FCSB,7782,1,8,6,0,25,11,14,30
CFR Cluj,7782,2,6,6,2,14,8,6,24
D Bucuresti,7782,3,3,6,5,18,20,-2,15
Universitate,7782,4,3,6,5,15,20,-5,15
FC Botosani,7782,5,3,5,6,5,14,-9,14
Concordia Ch,7782,6,3,3,8,19,23,-4,12
FCSB,7783,1,8,6,0,24,10,14,30
CFR Cluj,7783,2,6,7,1,14,7,7,25
D Bucuresti,7783,3,4,5,5,18,19,-1,17
Universitate,7783,4,3,5,6,14,20,-6,14
FC Botosani,7783,5,3,5,6,6,14,-8,14
Concordia Ch,7783,6,2,4,8,17,23,-6,10
FCSB,7784,1,8,6,0,25,11,14,30
CFR Cluj,7784,2,6,7,1,14,7,7,25
D Bucuresti,7784,3,4,5,5,19,19,0,17
FC Botosani,7784,4,4,5,5,7,13,-6,17
Universitate,7784,5,3,5,6,15,21,-6,14
Concordia Ch,7784,6,2,2,10,17,26,-9,8
FCSB,7785,1,9,5,0,26,11,15,32
CFR Cluj,7785,2,5,7,2,14,9,5,22
FC Botosani,7785,3,4,4,6,6,13,-7,16
Universitate,7785,4,3,6,5,14,19,-5,15
Concordia Ch,7785,5,4,2,8,19,21,-2,14
D Bucuresti,7785,6,3,4,7,16,22,-6,13
FCSB,7786,1,8,5,1,25,12,13,29
CFR Cluj,7786,2,6,6,2,15,9,6,24
FC Botosani,7786,3,5,4,5,11,12,-1,19
Universitate,7786,4,4,5,5,15,19,-4,17
D Bucuresti,7786,5,3,5,6,17,20,-3,14
Concordia Ch,7786,6,2,3,9,16,27,-11,9
FCSB,7787,1,9,5,0,26,10,16,32
CFR Cluj,7787,2,5,6,3,14,11,3,21
D Bucuresti,7787,3,4,5,5,19,20,-1,17
Universitate,7787,4,4,5,5,16,20,-4,17
FC Botosani,7787,5,3,5,6,6,14,-8,14
Concordia Ch,7787,6,2,4,8,18,24,-6,10
FCSB,7788,1,7,7,0,24,11,13,28
CFR Cluj,7788,2,5,8,1,16,10,6,23
D Bucuresti,7788,3,4,4,6,20,21,-1,16
Universitate,7788,4,3,7,4,16,20,-4,16
Concordia Ch,7788,5,4,2,8,19,22,-3,14
FC Botosani,7788,6,3,4,7,6,17,-11,13
FCSB,7789,1,7,6,1,26,14,12,27
CFR Cluj,7789,2,6,7,1,17,8,9,25
D Bucuresti,7789,3,4,5,5,20,20,0,17
Universitate,7789,4,4,5,5,17,23,-6,17
FC Botosani,7789,5,3,5,6,7,16,-9,14
Concordia Ch,7789,6,3,2,9,17,23,-6,11
FCSB,7790,1,8,5,1,27,14,13,29
CFR Cluj,7790,2,7,6,1,17,7,10,27
D Bucuresti,7790,3,5,4,5,22,19,3,19
Universitate,7790,4,3,5,6,16,24,-8,14
FC Botosani,7790,5,3,5,6,6,15,-9,14
Concordia Ch,7790,6,2,3,9,15,24,-9,9
FCSB,7791,1,7,6,1,25,13,12,27
CFR Cluj,7791,2,6,7,1,16,9,7,25
Universitate,7791,3,3,7,4,16,20,-4,16
FC Botosani,7791,4,4,4,6,9,15,-6,16
Concordia Ch,7791,5,4,2,8,19,23,-4,14
D Bucuresti,7791,6,3,4,7,16,21,-5,13
FCSB,7792,1,9,5,0,29,12,17,32
CFR Cluj,7792,2,6,6,2,15,10,5,24
FC Botosani,7792,3,5,4,5,8,13,-5,19
D Bucuresti,7792,4,4,4,6,17,19,-2,16
Universitate,7792,5,3,5,6,15,22,-7,14
Concordia Ch,7792,6,2,2,10,16,24,-8,8
FCSB,7793,1,7,7,0,27,14,13,28
CFR Cluj,7793,2,5,8,1,14,8,6,23
D Bucuresti,7793,3,4,4,6,19,21,-2,16
Universitate,7793,4,3,7,4,17,21,-4,16
FC Botosani,7793,5,4,4,6,8,15,-7,16
Concordia Ch,7793,6,3,2,9,17,23,-6,11
FCSB,7794,1,7,7,0,26,13,13,28
CFR Cluj,7794,2,5,7,2,15,10,5,22
Universitate,7794,3,4,6,4,18,21,-3,18
D Bucuresti,7794,4,4,5,5,19,19,0,17
FC Botosani,7794,5,3,4,7,5,18,-13,13
Concordia Ch,7794,6,3,3,8,20,22,-2,12
FCSB,7795,1,8,5,1,27,13,14,29
CFR Cluj,7795,2,6,7,1,16,9,7,25
FC Botosani,7795,3,4,4,6,6,15,-9,16
Universitate,7795,4,3,6,5,16,22,-6,15
Concordia Ch,7795,5,4,2,8,19,21,-2,14
D Bucuresti,7795,6,3,4,7,16,20,-4,13
FCSB,7796,1,8,5,1,28,15,13,29
CFR Cluj,7796,2,6,6,2,15,10,5,24
D Bucuresti,7796,3,5,4,5,19,19,0,19
Universitate,7796,4,4,5,5,20,23,-3,17
FC Botosani,7796,5,3,5,6,8,16,-8,14
Concordia Ch,7796,6,2,3,9,17,24,-7,9
FCSB,7797,1,8,5,1,26,12,14,29
CFR Cluj,7797,2,7,6,1,18,9,9,27
FC Botosani,7797,3,5,4,5,8,13,-5,19
Universitate,7797,4,3,5,6,15,23,-8,14
D Bucuresti,7797,5,3,4,7,17,22,-5,13
Concordia Ch,7797,6,3,2,9,17,22,-5,11
FCSB,7798,1,7,7,0,23,10,13,28
CFR Cluj,7798,2,5,8,1,13,7,6,23
FC Botosani,7798,3,4,5,5,8,13,-5,17
Universitate,7798,4,3,7,4,14,18,-4,16
D Bucuresti,7798,5,3,5,6,17,21,-4,14
Concordia Ch,7798,6,2,4,8,17,23,-6,10
FCSB,7799,1,8,6,0,25,11,14,30
CFR Cluj,7799,2,5,7,2,14,9,5,22
D Bucuresti,7799,3,4,5,5,17,18,-1,17
Universitate,7799,4,4,5,5,15,19,-4,17
FC Botosani,7799,5,3,5,6,8,16,-8,14
Concordia Ch,7799,6,2,4,8,18,24,-6,10
FCSB,7800,1,8,6,0,25,11,14,30
CFR Cluj,7800,2,5,6,3,15,13,2,21
Universitate,7800,3,4,6,4,18,19,-1,18
FC Botosani,7800,4,4,5,5,8,13,-5,17
D Bucuresti,7800,5,3,5,6,17,21,-4,14
Concordia Ch,7800,6,3,2,9,17,23,-6,11
FCSB,7801,1,7,7,0,24,11,13,28
CFR Cluj,7801,2,5,8,1,14,8,6,23
D Bucuresti,7801,3,4,5,5,17,18,-1,17
Universitate,7801,4,3,7,4,16,20,-4,16
FC Botosani,7801,5,3,5,6,7,15,-8,14
Concordia Ch,7801,6,3,2,9,18,24,-6,11
FCSB,7802,1,7,6,1,24,13,11,27
CFR Cluj,7802,2,5,8,1,14,8,6,23
D Bucuresti,7802,3,5,4,5,19,18,1,19
Universitate,7802,4,4,6,4,16,18,-2,18
FC Botosani,7802,5,3,4,7,5,14,-9,13
Concordia Ch,7802,6,3,2,9,16,23,-7,11
FCSB,7803,1,8,6,0,25,11,14,30
CFR Cluj,7803,2,5,7,2,14,9,5,22
Universitate,7803,3,3,7,4,16,20,-4,16
D Bucuresti,7803,4,3,6,5,18,20,-2,15
FC Botosani,7803,5,3,6,5,7,14,-7,15
Concordia Ch,7803,6,2,4,8,17,23,-6,10
FCSB,7804,1,8,5,1,26,14,12,29
CFR Cluj,7804,2,6,6,2,17,9,8,24
FC Botosani,7804,3,5,4,5,12,15,-3,19
Universitate,7804,4,4,5,5,17,22,-5,17
D Bucuresti,7804,5,3,4,7,17,22,-5,13
Concordia Ch,7804,6,3,2,9,19,26,-7,11
FCSB,7805,1,7,6,1,27,15,12,27
CFR Cluj,7805,2,5,8,1,16,10,6,23
Universitate,7805,3,4,6,4,18,21,-3,18
D Bucuresti,7805,4,4,5,5,18,19,-1,17
FC Botosani,7805,5,3,5,6,6,15,-9,14
Concordia Ch,7805,6,3,2,9,17,22,-5,11
FCSB,7806,1,7,7,0,24,11,13,28
CFR Cluj,7806,2,6,7,1,16,8,8,25
D Bucuresti,7806,3,5,4,5,21,18,3,19
Universitate,7806,4,3,6,5,14,20,-6,15
FC Botosani,7806,5,3,5,6,6,17,-11,14
Concordia Ch,7806,6,2,3,9,16,23,-7,9
FCSB,7807,1,8,6,0,25,11,14,30
CFR Cluj,7807,2,5,7,2,15,10,5,22
Universitate,7807,3,4,5,5,16,20,-4,17
FC Botosani,7807,4,4,5,5,7,12,-5,17
D Bucuresti,7807,5,3,6,5,17,19,-2,15
Concordia Ch,7807,6,2,3,9,16,24,-8,9
FCSB,7808,1,8,6,0,30,13,17,30
CFR Cluj,7808,2,5,7,2,14,9,5,22
FC Botosani,7808,3,4,5,5,8,13,-5,17
Universitate,7808,4,4,5,5,17,24,-7,17
D Bucuresti,7808,5,3,5,6,18,21,-3,14
Concordia Ch,7808,6,3,2,9,17,24,-7,11
FCSB,7809,1,8,5,1,25,12,13,29
CFR Cluj,7809,2,6,6,2,17,10,7,24
D Bucuresti,7809,3,5,4,5,19,19,0,19
Universitate,7809,4,4,5,5,17,22,-5,17
FC Botosani,7809,5,3,4,7,6,16,-10,13
Concordia Ch,7809,6,3,2,9,17,22,-5,11
FCSB,7810,1,7,6,1,25,13,12,27
CFR Cluj,7810,2,7,6,1,17,9,8,27
D Bucuresti,7810,3,4,4,6,18,20,-2,16
FC Botosani,7810,4,4,4,6,9,17,-8,16
Universitate,7810,5,3,6,5,16,21,-5,15
Concordia Ch,7810,6,3,2,9,20,25,-5,11
FCSB,7811,1,8,5,1,26,14,12,29
CFR Cluj,7811,2,5,6,3,14,11,3,21
Universitate,7811,3,5,5,4,20,20,0,20
D Bucuresti,7811,4,4,4,6,25,25,0,16
FC Botosani,7811,5,4,4,6,9,17,-8,16
Concordia Ch,7811,6,3,2,9,21,28,-7,11
FCSB,7812,1,7,7,0,26,13,13,28
CFR Cluj,7812,2,6,7,1,16,8,8,25
D Bucuresti,7812,3,4,5,5,19,20,-1,17
Universitate,7812,4,3,6,5,16,22,-6,15
FC Botosani,7812,5,3,6,5,6,13,-7,15
Concordia Ch,7812,6,2,3,9,16,23,-7,9
FCSB,7813,1,7,6,1,25,13,12,27
CFR Cluj,7813,2,6,6,2,15,9,6,24
Universitate,7813,3,4,6,4,18,21,-3,18
FC Botosani,7813,4,4,5,5,6,12,-6,17
D Bucuresti,7813,5,3,4,7,16,23,-7,13
Concordia Ch,7813,6,3,3,8,19,21,-2,12
FCSB,7814,1,7,6,1,24,12,12,27
CFR Cluj,7814,2,7,6,1,15,7,8,27
D Bucuresti,7814,3,5,4,5,20,18,2,19
Universitate,7814,4,3,6,5,15,20,-5,15
FC Botosani,7814,5,3,5,6,5,14,-9,14
Concordia Ch,7814,6,2,3,9,15,23,-8,9
FCSB,7815,1,9,5,0,28,11,17,32
CFR Cluj,7815,2,6,6,2,15,10,5,24
FC Botosani,7815,3,4,5,5,7,13,-6,17
D Bucuresti,7815,4,4,4,6,19,21,-2,16
Universitate,7815,5,3,5,6,14,21,-7,14
Concordia Ch,7815,6,2,3,9,16,23,-7,9
FCSB,7816,1,7,5,2,23,13,10,26
CFR Cluj,7816,2,6,7,1,15,8,7,25
Universitate,7816,3,4,6,4,17,19,-2,18
Concordia Ch,7816,4,4,2,8,19,22,-3,14
D Bucuresti,7816,5,3,5,6,18,22,-4,14
FC Botosani,7816,6,3,5,6,6,14,-8,14
FCSB,7817,1,8,6,0,26,11,15,30
CFR Cluj,7817,2,6,6,2,14,9,5,24
D Bucuresti,7817,3,4,4,6,20,21,-1,16
FC Botosani,7817,4,4,4,6,6,14,-8,16
Universitate,7817,5,3,6,5,15,20,-5,15
Concordia Ch,7817,6,3,2,9,18,24,-6,11
FCSB,7818,1,9,5,0,26,11,15,32
CFR Cluj,7818,2,5,7,2,14,9,5,22
D Bucuresti,7818,3,4,4,6,18,19,-1,16
FC Botosani,7818,4,4,4,6,7,14,-7,16
Universitate,7818,5,3,6,5,16,21,-5,15
Concordia Ch,7818,6,3,2,9,16,23,-7,11
FCSB,7819,1,8,6,0,28,13,15,30
CFR Cluj,7819,2,6,7,1,17,9,8,25
D Bucuresti,7819,3,4,4,6,18,20,-2,16
Universitate,7819,4,3,5,6,15,23,-8,14
FC Botosani,7819,5,3,5,6,5,13,-8,14
Concordia Ch,7819,6,3,3,8,17,22,-5,12
FCSB,7820,1,8,5,1,28,13,15,29
CFR Cluj,7820,2,6,6,2,15,11,4,24
Universitate,7820,3,4,5,5,17,21,-4,17
D Bucuresti,7820,4,4,4,6,21,23,-2,16
FC Botosani,7820,5,3,5,6,7,17,-10,14
Concordia Ch,7820,6,3,3,8,20,23,-3,12
CFR Cluj,7821,1,7,6,1,18,7,11,27
FCSB,7821,2,7,5,2,23,14,9,26
Universitate,7821,3,4,5,5,15,20,-5,17
D Bucuresti,7821,4,4,4,6,20,21,-1,16
FC Botosani,7821,5,3,5,6,6,16,-10,14
Concordia Ch,7821,6,3,3,8,19,23,-4,12
FCSB,7822,1,7,6,1,25,13,12,27
CFR Cluj,7822,2,6,7,1,17,9,8,25
D Bucuresti,7822,3,5,4,5,19,18,1,19
Universitate,7822,4,4,5,5,15,20,-5,17
FC Botosani,7822,5,4,4,6,7,15,-8,16
Concordia Ch,7822,6,2,2,10,16,24,-8,8
FCSB,7823,1,9,5,0,27,11,16,32
CFR Cluj,7823,2,6,6,2,14,8,6,24
D Bucuresti,7823,3,4,5,5,19,20,-1,17
FC Botosani,7823,4,4,4,6,6,13,-7,16
Universitate,7823,5,3,5,6,15,22,-7,14
Concordia Ch,7823,6,2,3,9,17,24,-7,9
FCSB,7824,1,8,5,1,27,12,15,29
CFR Cluj,7824,2,6,6,2,14,9,5,24
Universitate,7824,3,4,5,5,17,22,-5,17
D Bucuresti,7824,4,3,5,6,18,21,-3,14
Concordia Ch,7824,5,4,2,8,20,24,-4,14
FC Botosani,7824,6,3,5,6,6,14,-8,14
CFR Cluj,7825,1,7,6,1,17,7,10,27
FCSB,7825,2,7,5,2,24,16,8,26
Universitate,7825,3,4,5,5,17,20,-3,17
D Bucuresti,7825,4,3,6,5,18,20,-2,15
FC Botosani,7825,5,3,6,5,7,14,-7,15
Concordia Ch,7825,6,2,4,8,19,25,-6,10
FCSB,7826,1,8,6,0,25,11,14,30
CFR Cluj,7826,2,5,7,2,13,8,5,22
Universitate,7826,3,4,5,5,16,20,-4,17
D Bucuresti,7826,4,4,4,6,18,22,-4,16
FC Botosani,7826,5,3,5,6,6,14,-8,14
Concordia Ch,7826,6,3,3,8,20,23,-3,12
FCSB,7827,1,9,5,0,26,11,15,32
CFR Cluj,7827,2,5,6,3,14,10,4,21
Universitate,7827,3,4,5,5,15,19,-4,17
FC Botosani,7827,4,4,5,5,10,14,-4,17
D Bucuresti,7827,5,4,4,6,18,22,-4,16
Concordia Ch,7827,6,2,3,9,18,25,-7,9
FCSB,7828,1,7,6,1,26,14,12,27
CFR Cluj,7828,2,6,7,1,18,11,7,25
D Bucuresti,7828,3,4,5,5,18,19,-1,17
FC Botosani,7828,4,4,5,5,8,14,-6,17
Universitate,7828,5,3,7,4,15,19,-4,16
Concordia Ch,7828,6,2,2,10,16,24,-8,8
FCSB,7829,1,9,5,0,26,11,15,32
CFR Cluj,7829,2,5,7,2,15,10,5,22
D Bucuresti,7829,3,5,4,5,19,19,0,19
FC Botosani,7829,4,4,4,6,7,13,-6,16
Universitate,7829,5,3,6,5,15,20,-5,15
Concordia Ch,7829,6,2,2,10,16,25,-9,8
FCSB,7830,1,7,7,0,24,11,13,28
CFR Cluj,7830,2,5,8,1,15,9,6,23
D Bucuresti,7830,3,4,4,6,17,21,-4,16
Universitate,7830,3,3,7,4,17,21,-4,16
FC Botosani,7830,5,4,4,6,6,13,-7,16
Concordia Ch,7830,6,3,2,9,18,22,-4,11
FCSB,7831,1,8,5,1,24,11,13,29
CFR Cluj,7831,2,6,6,2,14,11,3,24
D Bucuresti,7831,3,5,4,5,20,19,1,19
Universitate,7831,4,4,5,5,18,19,-1,17
FC Botosani,7831,5,3,4,7,6,15,-9,13
Concordia Ch,7831,6,3,2,9,18,25,-7,11
FCSB,7832,1,8,5,1,26,19,7,29
CFR Cluj,7832,2,6,7,1,20,7,13,25
D Bucuresti,7832,3,5,4,5,21,18,3,19
Universitate,7832,4,3,6,5,16,21,-5,15
FC Botosani,7832,5,3,5,6,6,15,-9,14
Concordia Ch,7832,6,2,3,9,16,25,-9,9
FCSB,7833,1,7,6,1,25,15,10,27
CFR Cluj,7833,2,5,8,1,16,10,6,23
D Bucuresti,7833,3,5,4,5,20,19,1,19
Universitate,7833,4,4,6,4,18,19,-1,18
FC Botosani,7833,5,3,4,7,5,16,-11,13
Concordia Ch,7833,6,3,2,9,18,23,-5,11
FCSB,7834,1,8,6,0,24,10,14,30
CFR Cluj,7834,2,5,7,2,14,10,4,22
Universitate,7834,3,4,5,5,17,20,-3,17
D Bucuresti,7834,4,4,4,6,19,20,-1,16
FC Botosani,7834,5,4,4,6,6,14,-8,16
Concordia Ch,7834,6,3,2,9,17,23,-6,11
FCSB,7835,1,8,5,1,28,13,15,29
CFR Cluj,7835,2,6,6,2,15,10,5,24
Universitate,7835,3,4,5,5,17,22,-5,17
D Bucuresti,7835,4,4,4,6,20,21,-1,16
FC Botosani,7835,5,4,4,6,10,15,-5,16
Concordia Ch,7835,6,3,2,9,17,26,-9,11
FCSB,7836,1,8,5,1,26,11,15,29
CFR Cluj,7836,2,7,6,1,17,7,10,27
D Bucuresti,7836,3,5,4,5,20,18,2,19
FC Botosani,7836,4,4,4,6,7,14,-7,16
Universitate,7836,5,3,5,6,14,24,-10,14
Concordia Ch,7836,6,2,2,10,15,25,-10,8
FCSB,7837,1,9,5,0,26,10,16,32
CFR Cluj,7837,2,5,7,2,16,11,5,22
FC Botosani,7837,3,4,4,6,8,18,-10,16
Universitate,7837,4,3,6,5,17,23,-6,15
Concordia Ch,7837,5,4,2,8,22,22,0,14
D Bucuresti,7837,6,3,4,7,17,22,-5,13
FCSB,7838,1,8,6,0,26,11,15,30
CFR Cluj,7838,2,5,7,2,14,9,5,22
Universitate,7838,3,4,5,5,15,20,-5,17
FC Botosani,7838,4,4,4,6,11,13,-2,16
D Bucuresti,7838,5,4,4,6,18,21,-3,16
Concordia Ch,7838,6,3,2,9,18,28,-10,11
FCSB,7839,1,7,7,0,25,12,13,28
CFR Cluj,7839,2,5,7,2,15,11,4,22
Universitate,7839,3,4,6,4,18,20,-2,18
D Bucuresti,7839,4,4,5,5,19,19,0,17
FC Botosani,7839,5,3,5,6,5,14,-9,14
Concordia Ch,7839,6,2,4,8,16,22,-6,10
FCSB,7840,1,8,6,0,26,12,14,30
CFR Cluj,7840,2,6,6,2,18,10,8,24
D Bucuresti,7840,3,4,4,6,17,19,-2,16
FC Botosani,7840,4,4,4,6,6,13,-7,16
Universitate,7840,5,3,6,5,16,23,-7,15
Concordia Ch,7840,6,3,2,9,16,22,-6,11
FCSB,7841,1,8,5,1,26,13,13,29
CFR Cluj,7841,2,7,6,1,18,9,9,27
D Bucuresti,7841,3,5,4,5,21,19,2,19
FC Botosani,7841,4,4,4,6,8,15,-7,16
Universitate,7841,5,3,5,6,16,23,-7,14
Concordia Ch,7841,6,2,2,10,16,26,-10,8
FCSB,7842,1,8,6,0,24,10,14,30
CFR Cluj,7842,2,5,7,2,13,8,5,22
Universitate,7842,3,3,7,4,14,18,-4,16
Concordia Ch,7842,4,4,2,8,18,21,-3,14
D Bucuresti,7842,5,3,5,6,16,19,-3,14
FC Botosani,7842,6,3,5,6,5,14,-9,14
FCSB,7843,1,7,5,2,24,14,10,26
CFR Cluj,7843,2,6,6,2,16,9,7,24
Universitate,7843,3,5,5,4,18,20,-2,20
D Bucuresti,7843,4,4,4,6,18,22,-4,16
FC Botosani,7843,5,4,4,6,8,15,-7,16
Concordia Ch,7843,6,3,2,9,19,23,-4,11
FCSB,7844,1,8,5,1,25,12,13,29
CFR Cluj,7844,2,7,6,1,16,7,9,27
D Bucuresti,7844,3,4,5,5,19,19,0,17
FC Botosani,7844,4,4,5,5,8,14,-6,17
Universitate,7844,5,3,5,6,15,22,-7,14
Concordia Ch,7844,6,2,2,10,16,25,-9,8
FCSB,7845,1,7,6,1,25,13,12,27
CFR Cluj,7845,2,5,8,1,15,9,6,23
Universitate,7845,3,4,6,4,15,18,-3,18
D Bucuresti,7845,4,4,5,5,18,19,-1,17
FC Botosani,7845,5,3,4,7,7,16,-9,13
Concordia Ch,7845,6,3,3,8,17,22,-5,12
FCSB,7846,1,9,5,0,28,10,18,32
CFR Cluj,7846,2,6,6,2,15,9,6,24
FC Botosani,7846,3,4,5,5,7,13,-6,17
D Bucuresti,7846,4,3,6,5,19,21,-2,15
Universitate,7846,5,3,5,6,15,24,-9,14
Concordia Ch,7846,6,2,3,9,17,24,-7,9
FCSB,7847,1,8,5,1,28,15,13,29
CFR Cluj,7847,2,6,6,2,18,12,6,24
Universitate,7847,3,4,5,5,17,21,-4,17
D Bucuresti,7847,4,4,4,6,19,22,-3,16
FC Botosani,7847,5,4,4,6,9,15,-6,16
Concordia Ch,7847,6,3,2,9,17,23,-6,11
FCSB,7848,1,7,6,1,25,13,12,27
CFR Cluj,7848,2,6,6,2,15,9,6,24
Universitate,7848,3,4,6,4,16,19,-3,18
D Bucuresti,7848,4,4,4,6,19,22,-3,16
FC Botosani,7848,5,3,5,6,5,14,-9,14
Concordia Ch,7848,6,3,3,8,19,22,-3,12
FCSB,7849,1,8,5,1,26,13,13,29
CFR Cluj,7849,2,6,6,2,18,9,9,24
D Bucuresti,7849,3,5,4,5,22,18,4,19
Universitate,7849,4,4,5,5,16,23,-7,17
FC Botosani,7849,5,3,4,7,5,18,-13,13
Concordia Ch,7849,6,3,2,9,16,22,-6,11
FCSB,7850,1,8,5,1,24,12,12,29
CFR Cluj,7850,2,5,6,3,13,9,4,21
Universitate,7850,3,5,5,4,17,18,-1,20
FC Botosani,7850,4,4,5,5,7,13,-6,17
D Bucuresti,7850,5,3,5,6,16,19,-3,14
Concordia Ch,7850,6,3,2,9,17,23,-6,11
FCSB,7851,1,8,6,0,25,11,14,30
CFR Cluj,7851,2,5,7,2,13,8,5,22
D Bucuresti,7851,3,4,5,5,22,20,2,17
Universitate,7851,4,4,5,5,16,20,-4,17
FC Botosani,7851,5,3,5,6,5,16,-11,14
Concordia Ch,7851,6,2,4,8,17,23,-6,10
FCSB,7852,1,8,5,1,26,12,14,29
CFR Cluj,7852,2,5,6,3,14,11,3,21
Universitate,7852,3,5,5,4,18,20,-2,20
D Bucuresti,7852,4,4,4,6,19,22,-3,16
Concordia Ch,7852,5,4,2,8,22,21,1,14
FC Botosani,7852,6,3,4,7,6,19,-13,13
FCSB,7853,1,8,5,1,28,14,14,29
CFR Cluj,7853,2,7,6,1,16,7,9,27
D Bucuresti,7853,3,4,5,5,20,21,-1,17
FC Botosani,7853,4,4,5,5,8,14,-6,17
Universitate,7853,5,3,5,6,17,25,-8,14
Concordia Ch,7853,6,2,2,10,16,24,-8,8
FCSB,7854,1,7,6,1,25,13,12,27
CFR Cluj,7854,2,7,6,1,16,7,9,27
D Bucuresti,7854,3,4,5,5,17,18,-1,17
FC Botosani,7854,4,4,5,5,6,12,-6,17
Universitate,7854,5,3,6,5,16,22,-6,15
Concordia Ch,7854,6,2,2,10,15,23,-8,8
FCSB,7855,1,7,7,0,25,12,13,28
CFR Cluj,7855,2,5,7,2,15,10,5,22
FC Botosani,7855,3,5,4,5,10,14,-4,19
Universitate,7855,4,4,6,4,17,20,-3,18
D Bucuresti,7855,5,3,4,7,17,23,-6,13
Concordia Ch,7855,6,3,2,9,18,23,-5,11
FCSB,7856,1,8,5,1,24,11,13,29
CFR Cluj,7856,2,5,6,3,13,9,4,21
Universitate,7856,3,5,5,4,16,18,-2,20
D Bucuresti,7856,4,5,4,5,20,19,1,19
FC Botosani,7856,5,4,4,6,8,13,-5,16
Concordia Ch,7856,6,2,2,10,16,27,-11,8
FCSB,7857,1,8,5,1,26,11,15,29
CFR Cluj,7857,2,5,7,2,14,11,3,22
Universitate,7857,3,4,6,4,16,19,-3,18
D Bucuresti,7857,4,4,5,5,17,18,-1,17
FC Botosani,7857,5,3,5,6,5,14,-9,14
Concordia Ch,7857,6,3,2,9,17,22,-5,11
FCSB,7858,1,9,5,0,25,10,15,32
CFR Cluj,7858,2,5,7,2,13,8,5,22
D Bucuresti,7858,3,4,5,5,20,20,0,17
Universitate,7858,4,3,6,5,14,19,-5,15
FC Botosani,7858,5,3,5,6,6,15,-9,14
Concordia Ch,7858,6,2,4,8,16,22,-6,10
FCSB,7859,1,8,6,0,26,12,14,30
CFR Cluj,7859,2,5,7,2,14,9,5,22
Universitate,7859,3,4,5,5,16,20,-4,17
FC Botosani,7859,4,4,5,5,8,14,-6,17
D Bucuresti,7859,5,3,4,7,17,22,-5,13
Concordia Ch,7859,6,3,3,8,18,22,-4,12
FCSB,7860,1,8,5,1,24,11,13,29
CFR Cluj,7860,2,6,6,2,16,8,8,24
FC Botosani,7860,3,5,4,5,10,13,-3,19
Universitate,7860,4,4,5,5,15,21,-6,17
D Bucuresti,7860,5,4,4,6,18,21,-3,16
Concordia Ch,7860,6,2,2,10,15,24,-9,8
FCSB,7861,1,9,5,0,27,11,16,32
CFR Cluj,7861,2,6,6,2,16,9,7,24
FC Botosani,7861,3,4,5,5,7,13,-6,17
D Bucuresti,7861,4,4,4,6,18,20,-2,16
Universitate,7861,5,3,5,6,16,24,-8,14
Concordia Ch,7861,6,2,3,9,17,24,-7,9
FCSB,7862,1,8,6,0,25,11,14,30
CFR Cluj,7862,2,5,8,1,14,8,6,23
D Bucuresti,7862,3,4,4,6,19,19,0,16
FC Botosani,7862,4,4,4,6,6,15,-9,16
Universitate,7862,5,3,6,5,14,19,-5,15
Concordia Ch,7862,6,3,2,9,16,22,-6,11
CFR Cluj,7863,1,7,6,1,15,7,8,27
FCSB,7863,2,7,5,2,24,14,10,26
D Bucuresti,7863,3,4,5,5,17,18,-1,17
Universitate,7863,4,4,5,5,17,20,-3,17
FC Botosani,7863,5,3,5,6,6,15,-9,14
Concordia Ch,7863,6,3,2,9,18,23,-5,11
FCSB,7864,1,8,6,0,26,12,14,30
CFR Cluj,7864,2,5,6,3,13,9,4,21
Universitate,7864,3,4,6,4,17,20,-3,18
D Bucuresti,7864,4,4,5,5,18,18,0,17
FC Botosani,7864,5,3,4,7,6,16,-10,13
Concordia Ch,7864,6,3,3,8,17,22,-5,12
FCSB,7865,1,8,5,1,25,12,13,29
CFR Cluj,7865,2,5,7,2,14,9,5,22
Universitate,7865,3,4,6,4,17,20,-3,18
D Bucuresti,7865,4,4,5,5,20,21,-1,17
FC Botosani,7865,5,3,5,6,8,16,-8,14
Concordia Ch,7865,6,2,4,8,19,25,-6,10
FCSB,7866,1,8,6,0,26,12,14,30
CFR Cluj,7866,2,5,7,2,15,10,5,22
D Bucuresti,7866,3,5,4,5,21,18,3,19
Universitate,7866,4,4,5,5,17,21,-4,17
FC Botosani,7866,5,3,4,7,5,16,-11,13
Concordia Ch,7866,6,3,2,9,17,24,-7,11
CFR Cluj,7867,1,7,6,1,16,7,9,27
FCSB,7867,2,7,5,2,23,14,9,26
Universitate,7867,3,4,5,5,17,20,-3,17
D Bucuresti,7867,4,4,4,6,19,21,-2,16
FC Botosani,7867,5,4,4,6,9,15,-6,16
Concordia Ch,7867,6,3,2,9,18,25,-7,11
FCSB,7868,1,8,6,0,30,13,17,30
CFR Cluj,7868,2,6,7,1,16,8,8,25
FC Botosani,7868,3,5,4,5,8,12,-4,19
Universitate,7868,4,3,5,6,16,26,-10,14
D Bucuresti,7868,5,3,4,7,16,20,-4,13
Concordia Ch,7868,6,3,2,9,16,23,-7,11
FCSB,7869,1,7,7,0,24,11,13,28
CFR Cluj,7869,2,6,7,1,15,8,7,25
Universitate,7869,3,3,6,5,14,19,-5,15
FC Botosani,7869,4,3,6,5,7,14,-7,15
D Bucuresti,7869,5,3,5,6,17,22,-5,14
Concordia Ch,7869,6,3,3,8,19,22,-3,12
FCSB,7870,1,9,5,0,29,13,16,32
CFR Cluj,7870,2,5,7,2,14,9,5,22
FC Botosani,7870,3,4,5,5,9,14,-5,17
Universitate,7870,4,3,6,5,16,22,-6,15
D Bucuresti,7870,5,3,4,7,17,23,-6,13
Concordia Ch,7870,6,3,3,8,20,24,-4,12
FCSB,7871,1,7,6,1,24,12,12,27
CFR Cluj,7871,2,6,7,1,18,10,8,25
D Bucuresti,7871,3,5,4,5,20,18,2,19
Universitate,7871,4,4,5,5,17,22,-5,17
FC Botosani,7871,5,3,4,7,5,14,-9,13
Concordia Ch,7871,6,3,2,9,16,24,-8,11
FCSB,7872,1,7,6,1,24,14,10,27
CFR Cluj,7872,2,5,7,2,15,10,5,22
Universitate,7872,3,5,5,4,19,19,0,20
D Bucuresti,7872,4,4,5,5,19,20,-1,17
FC Botosani,7872,5,4,5,5,10,14,-4,17
Concordia Ch,7872,6,2,2,10,17,27,-10,8
FCSB,7873,1,9,5,0,26,11,15,32
CFR Cluj,7873,2,5,7,2,15,10,5,22
FC Botosani,7873,3,4,5,5,8,13,-5,17
Universitate,7873,4,3,6,5,15,20,-5,15
D Bucuresti,7873,5,3,5,6,17,20,-3,14
Concordia Ch,7873,6,3,2,9,16,23,-7,11
FCSB,7874,1,8,6,0,25,11,14,30
CFR Cluj,7874,2,5,8,1,14,8,6,23
D Bucuresti,7874,3,4,4,6,20,21,-1,16
FC Botosani,7874,4,4,4,6,8,16,-8,16
Universitate,7874,5,3,6,5,16,21,-5,15
Concordia Ch,7874,6,3,2,9,18,24,-6,11
FCSB,7875,1,8,5,1,28,12,16,29
CFR Cluj,7875,2,6,6,2,15,12,3,24
Universitate,7875,3,4,5,5,17,21,-4,17
FC Botosani,7875,4,4,4,6,6,14,-8,16
D Bucuresti,7875,5,3,5,6,18,21,-3,14
Concordia Ch,7875,6,3,3,8,19,23,-4,12
FCSB,7876,1,8,6,0,28,13,15,30
CFR Cluj,7876,2,6,7,1,17,9,8,25
D Bucuresti,7876,3,5,4,5,19,18,1,19
Universitate,7876,4,3,5,6,15,23,-8,14
FC Botosani,7876,5,3,4,7,5,16,-11,13
Concordia Ch,7876,6,3,2,9,17,22,-5,11
FCSB,7877,1,8,6,0,26,11,15,30
CFR Cluj,7877,2,6,7,1,14,7,7,25
FC Botosani,7877,3,4,5,5,8,14,-6,17
D Bucuresti,7877,4,3,5,6,19,22,-3,14
Universitate,7877,5,3,5,6,15,22,-7,14
Concordia Ch,7877,6,3,2,9,17,23,-6,11
FCSB,7878,1,8,6,0,26,12,14,30
CFR Cluj,7878,2,5,7,2,13,8,5,22
FC Botosani,7878,3,5,4,5,8,13,-5,19
Universitate,7878,4,3,7,4,16,20,-4,16
D Bucuresti,7878,5,3,5,6,17,20,-3,14
Concordia Ch,7878,6,2,3,9,17,24,-7,9
FCSB,7879,1,7,6,1,25,13,12,27
CFR Cluj,7879,2,6,7,1,17,9,8,25
Universitate,7879,3,4,5,5,15,20,-5,17
D Bucuresti,7879,4,4,4,6,18,20,-2,16
FC Botosani,7879,5,3,5,6,6,14,-8,14
Concordia Ch,7879,6,3,3,8,18,23,-5,12
FCSB,7880,1,7,6,1,24,13,11,27
CFR Cluj,7880,2,6,7,1,16,8,8,25
Universitate,7880,3,4,5,5,18,22,-4,17
D Bucuresti,7880,4,4,4,6,20,21,-1,16
FC Botosani,7880,5,3,5,6,5,14,-9,14
Concordia Ch,7880,6,3,3,8,18,23,-5,12
FCSB,7881,1,9,5,0,27,11,16,32
CFR Cluj,7881,2,6,6,2,16,9,7,24
D Bucuresti,7881,3,4,4,6,22,24,-2,16
Concordia Ch,7881,4,4,2,8,20,24,-4,14
Universitate,7881,5,3,5,6,14,22,-8,14
FC Botosani,7881,6,3,4,7,9,18,-9,13
FCSB,7882,1,7,5,2,24,13,11,26
CFR Cluj,7882,2,6,7,1,16,9,7,25
Universitate,7882,3,4,6,4,16,19,-3,18
FC Botosani,7882,4,4,5,5,7,12,-5,17
D Bucuresti,7882,5,3,5,6,17,21,-4,14
Concordia Ch,7882,6,2,4,8,16,22,-6,10
FCSB,7883,1,7,6,1,23,11,12,27
CFR Cluj,7883,2,5,8,1,13,7,6,23
Universitate,7883,3,4,6,4,15,18,-3,18
D Bucuresti,7883,4,4,4,6,18,19,-1,16
Concordia Ch,7883,5,4,2,8,17,21,-4,14
FC Botosani,7883,6,3,4,7,5,15,-10,13
FCSB,7884,1,7,5,2,25,16,9,26
CFR Cluj,7884,2,6,7,1,18,10,8,25
Universitate,7884,3,4,6,4,19,21,-2,18
D Bucuresti,7884,4,4,4,6,19,20,-1,16
FC Botosani,7884,5,3,5,6,5,14,-9,14
Concordia Ch,7884,6,3,3,8,17,22,-5,12
FCSB,7885,1,8,5,1,26,13,13,29
CFR Cluj,7885,2,6,6,2,15,9,6,24
D Bucuresti,7885,3,4,5,5,19,20,-1,17
Universitate,7885,4,4,5,5,16,20,-4,17
FC Botosani,7885,5,3,5,6,7,15,-8,14
Concordia Ch,7885,6,2,4,8,17,23,-6,10
FCSB,7886,1,9,5,0,27,11,16,32
CFR Cluj,7886,2,5,6,3,14,10,4,21
Universitate,7886,3,4,5,5,15,20,-5,17
D Bucuresti,7886,4,4,4,6,19,20,-1,16
Concordia Ch,7886,5,4,2,8,18,22,-4,14
FC Botosani,7886,6,3,4,7,5,15,-10,13
FCSB,7887,1,9,5,0,26,10,16,32
CFR Cluj,7887,2,6,6,2,14,9,5,24
D Bucuresti,7887,3,4,5,5,21,20,1,17
FC Botosani,7887,4,4,5,5,7,13,-6,17
Universitate,7887,5,3,5,6,14,20,-6,14
Concordia Ch,7887,6,2,2,10,18,28,-10,8
FCSB,7888,1,8,6,0,25,11,14,30
CFR Cluj,7888,2,6,6,2,15,9,6,24
D Bucuresti,7888,3,5,4,5,21,19,2,19
FC Botosani,7888,4,4,4,6,6,15,-9,16
Universitate,7888,5,3,6,5,16,21,-5,15
Concordia Ch,7888,6,2,2,10,16,24,-8,8
FCSB,7889,1,9,5,0,27,11,16,32
CFR Cluj,7889,2,5,7,2,13,9,4,22
D Bucuresti,7889,3,4,4,6,20,21,-1,16
FC Botosani,7889,4,4,4,6,6,15,-9,16
Universitate,7889,5,3,6,5,15,20,-5,15
Concordia Ch,7889,6,3,2,9,18,23,-5,11
FCSB,7890,1,9,5,0,27,11,16,32
CFR Cluj,7890,2,5,7,2,14,9,5,22
FC Botosani,7890,3,5,4,5,8,13,-5,19
Universitate,7890,4,3,6,5,14,20,-6,15
D Bucuresti,7890,5,3,4,7,17,21,-4,13
Concordia Ch,7890,6,3,2,9,16,22,-6,11
FCSB,7891,1,7,6,1,25,13,12,27
CFR Cluj,7891,2,6,7,1,18,9,9,25
D Bucuresti,7891,3,4,5,5,19,20,-1,17
Universitate,7891,4,4,5,5,15,21,-6,17
FC Botosani,7891,5,4,4,6,6,13,-7,16
Concordia Ch,7891,6,2,3,9,17,24,-7,9
FCSB,7892,1,8,5,1,26,16,10,29
CFR Cluj,7892,2,7,6,1,19,8,11,27
D Bucuresti,7892,3,4,4,6,18,22,-4,16
FC Botosani,7892,4,4,4,6,10,15,-5,16
Universitate,7892,5,3,5,6,15,21,-6,14
Concordia Ch,7892,6,3,2,9,20,26,-6,11
FCSB,7893,1,7,7,0,25,12,13,28
CFR Cluj,7893,2,5,7,2,15,11,4,22
D Bucuresti,7893,3,5,4,5,19,19,0,19
Universitate,7893,4,4,6,4,16,18,-2,18
FC Botosani,7893,5,4,4,6,8,15,-7,16
Concordia Ch,7893,6,2,2,10,18,26,-8,8
FCSB,7894,1,8,5,1,26,14,12,29
CFR Cluj,7894,2,5,7,2,14,9,5,22
Universitate,7894,3,4,6,4,17,19,-2,18
D Bucuresti,7894,4,4,5,5,19,20,-1,17
FC Botosani,7894,5,3,4,7,6,15,-9,13
Concordia Ch,7894,6,3,3,8,19,24,-5,12
FCSB,7895,1,8,6,0,27,12,15,30
CFR Cluj,7895,2,5,6,3,13,13,0,21
Universitate,7895,3,4,6,4,20,20,0,18
FC Botosani,7895,4,4,5,5,8,14,-6,17
D Bucuresti,7895,5,4,4,6,19,21,-2,16
Concordia Ch,7895,6,2,3,9,17,24,-7,9
FCSB,7896,1,8,5,1,24,11,13,29
CFR Cluj,7896,2,6,6,2,15,9,6,24
FC Botosani,7896,3,5,4,5,7,12,-5,19
Universitate,7896,4,4,5,5,16,20,-4,17
D Bucuresti,7896,5,3,4,7,16,22,-6,13
Concordia Ch,7896,6,3,2,9,18,22,-4,11
FCSB,7897,1,8,6,0,24,10,14,30
CFR Cluj,7897,2,6,7,1,15,8,7,25
D Bucuresti,7897,3,4,4,6,20,21,-1,16
FC Botosani,7897,4,4,4,6,6,15,-9,16
Universitate,7897,5,3,5,6,15,21,-6,14
Concordia Ch,7897,6,3,2,9,18,23,-5,11
FCSB,7898,1,7,7,0,24,11,13,28
CFR Cluj,7898,2,5,8,1,14,8,6,23
D Bucuresti,7898,3,5,4,5,23,21,2,19
Universitate,7898,4,3,7,4,16,20,-4,16
FC Botosani,7898,5,4,4,6,9,15,-6,16
Concordia Ch,7898,6,2,2,10,17,28,-11,8
FCSB,7899,1,7,7,0,23,10,13,28
CFR Cluj,7899,2,5,7,2,13,9,4,22
Universitate,7899,3,4,6,4,16,18,-2,18
D Bucuresti,7899,4,4,5,5,18,19,-1,17
FC Botosani,7899,5,3,5,6,6,14,-8,14
Concordia Ch,7899,6,2,4,8,17,23,-6,10
FCSB,7900,1,7,5,2,23,12,11,26
CFR Cluj,7900,2,6,7,1,16,9,7,25
Universitate,7900,3,4,6,4,17,20,-3,18
FC Botosani,7900,4,4,5,5,9,14,-5,17
D Bucuresti,7900,5,3,5,6,18,21,-3,14
Concordia Ch,7900,6,3,2,9,16,23,-7,11
FCSB,7901,1,8,5,1,27,14,13,29
CFR Cluj,7901,2,5,6,3,13,9,4,21
Universitate,7901,3,5,5,4,19,21,-2,20
FC Botosani,7901,4,5,4,5,8,13,-5,19
D Bucuresti,7901,5,3,4,7,16,20,-4,13
Concordia Ch,7901,6,3,2,9,17,23,-6,11
FCSB,7902,1,8,5,1,25,13,12,29
CFR Cluj,7902,2,5,7,2,15,10,5,22
D Bucuresti,7902,3,5,4,5,19,19,0,19
Universitate,7902,4,4,6,4,17,19,-2,18
FC Botosani,7902,5,4,4,6,8,15,-7,16
Concordia Ch,7902,6,2,2,10,16,24,-8,8
FCSB,7903,1,8,6,0,26,11,15,30
CFR Cluj,7903,2,6,7,1,15,8,7,25
Concordia Ch,7903,3,4,2,8,20,23,-3,14
D Bucuresti,7903,4,3,5,6,21,25,-4,14
Universitate,7903,5,3,5,6,14,21,-7,14
FC Botosani,7903,6,3,5,6,10,18,-8,14
FCSB,7904,1,8,6,0,24,10,14,30
CFR Cluj,7904,2,6,6,2,17,9,8,24
D Bucuresti,7904,3,5,4,5,19,18,1,19
Universitate,7904,4,3,6,5,15,22,-7,15
FC Botosani,7904,5,3,4,7,6,16,-10,13
Concordia Ch,7904,6,3,2,9,17,23,-6,11
FCSB,7905,1,8,6,0,25,10,15,30
CFR Cluj,7905,2,6,6,2,15,9,6,24
D Bucuresti,7905,3,4,5,5,18,19,-1,17
Universitate,7905,4,3,6,5,14,20,-6,15
FC Botosani,7905,5,3,6,5,8,15,-7,15
Concordia Ch,7905,6,2,3,9,19,26,-7,9
FCSB,7906,1,8,5,1,26,13,13,29
CFR Cluj,7906,2,5,6,3,15,11,4,21
Universitate,7906,3,5,5,4,18,20,-2,20
FC Botosani,7906,4,5,4,5,9,14,-5,19
D Bucuresti,7906,5,3,4,7,17,24,-7,13
Concordia Ch,7906,6,3,2,9,20,23,-3,11
FCSB,7907,1,9,5,0,29,13,16,32
CFR Cluj,7907,2,6,6,2,17,10,7,24
FC Botosani,7907,3,4,5,5,7,13,-6,17
D Bucuresti,7907,4,4,4,6,19,20,-1,16
Universitate,7907,5,3,5,6,16,24,-8,14
Concordia Ch,7907,6,2,3,9,17,25,-8,9
FCSB,7908,1,8,5,1,25,15,10,29
CFR Cluj,7908,2,5,7,2,14,9,5,22
D Bucuresti,7908,3,5,4,5,18,18,0,19
Universitate,7908,4,4,6,4,18,18,0,18
FC Botosani,7908,5,4,4,6,6,13,-7,16
Concordia Ch,7908,6,2,2,10,15,23,-8,8
FCSB,7909,1,7,6,1,23,12,11,27
CFR Cluj,7909,2,6,7,1,16,7,9,25
Universitate,7909,3,4,5,5,16,21,-5,17
FC Botosani,7909,4,4,4,6,8,15,-7,16
Concordia Ch,7909,5,4,2,8,22,24,-2,14
D Bucuresti,7909,6,3,4,7,19,25,-6,13
FCSB,7910,1,8,6,0,26,11,15,30
CFR Cluj,7910,2,5,7,2,13,9,4,22
D Bucuresti,7910,3,4,5,5,19,20,-1,17
Universitate,7910,4,4,5,5,17,21,-4,17
FC Botosani,7910,5,3,4,7,6,16,-10,13
Concordia Ch,7910,6,3,3,8,20,24,-4,12
FCSB,7911,1,7,6,1,24,13,11,27
CFR Cluj,7911,2,7,6,1,17,8,9,27
D Bucuresti,7911,3,5,4,5,22,18,4,19
Universitate,7911,4,3,6,5,16,21,-5,15
FC Botosani,7911,5,3,4,7,5,15,-10,13
Concordia Ch,7911,6,3,2,9,16,25,-9,11
FCSB,7912,1,7,6,1,24,12,12,27
CFR Cluj,7912,2,5,8,1,14,8,6,23
Universitate,7912,3,4,6,4,15,18,-3,18
D Bucuresti,7912,4,4,4,6,22,25,-3,16
Concordia Ch,7912,5,4,2,8,22,24,-2,14
FC Botosani,7912,6,3,4,7,8,18,-10,13
FCSB,7913,1,8,5,1,27,13,14,29
CFR Cluj,7913,2,6,6,2,15,9,6,24
FC Botosani,7913,3,5,4,5,10,15,-5,19
Universitate,7913,4,4,5,5,17,22,-5,17
D Bucuresti,7913,5,4,4,6,18,20,-2,16
Concordia Ch,7913,6,2,2,10,17,25,-8,8
FCSB,7914,1,8,5,1,24,11,13,29
CFR Cluj,7914,2,5,6,3,13,9,4,21
Universitate,7914,3,5,5,4,16,18,-2,20
FC Botosani,7914,4,4,4,6,7,15,-8,16
D Bucuresti,7914,5,3,5,6,18,21,-3,14
Concordia Ch,7914,6,3,3,8,20,24,-4,12
FCSB,7915,1,8,6,0,24,10,14,30
CFR Cluj,7915,2,6,7,1,16,7,9,25
D Bucuresti,7915,3,4,5,5,20,21,-1,17
Universitate,7915,4,3,5,6,14,22,-8,14
FC Botosani,7915,5,3,5,6,6,14,-8,14
Concordia Ch,7915,6,2,4,8,17,23,-6,10
FCSB,7916,1,9,5,0,25,10,15,32
CFR Cluj,7916,2,5,6,3,13,9,4,21
FC Botosani,7916,3,5,4,5,9,13,-4,19
Universitate,7916,4,4,5,5,15,19,-4,17
D Bucuresti,7916,5,4,4,6,18,20,-2,16
Concordia Ch,7916,6,2,2,10,15,24,-9,8
FCSB,7917,1,8,6,0,26,11,15,30
CFR Cluj,7917,2,6,6,2,16,9,7,24
D Bucuresti,7917,3,4,5,5,21,21,0,17
Universitate,7917,4,3,6,5,15,22,-7,15
FC Botosani,7917,5,3,5,6,8,17,-9,14
Concordia Ch,7917,6,2,4,8,19,25,-6,10
FCSB,7918,1,8,5,1,25,12,13,29
CFR Cluj,7918,2,6,6,2,14,8,6,24
D Bucuresti,7918,3,4,5,5,21,19,2,17
Universitate,7918,4,4,5,5,16,20,-4,17
FC Botosani,7918,5,3,5,6,5,16,-11,14
Concordia Ch,7918,6,2,4,8,16,22,-6,10
FCSB,7919,1,7,6,1,24,12,12,27
CFR Cluj,7919,2,6,6,2,14,8,6,24
Universitate,7919,3,4,6,4,16,19,-3,18
Concordia Ch,7919,4,4,2,8,19,21,-2,14
D Bucuresti,7919,5,3,5,6,17,22,-5,14
FC Botosani,7919,6,3,5,6,6,14,-8,14
FCSB,7920,1,8,6,0,25,11,14,30
CFR Cluj,7920,2,5,8,1,15,9,6,23
D Bucuresti,7920,3,5,4,5,19,18,1,19
FC Botosani,7920,4,4,4,6,8,14,-6,16
Universitate,7920,5,3,6,5,15,20,-5,15
Concordia Ch,7920,6,2,2,10,15,25,-10,8
FCSB,7921,1,7,6,1,26,14,12,27
CFR Cluj,7921,2,6,6,2,16,11,5,24
Universitate,7921,3,4,6,4,17,19,-2,18
D Bucuresti,7921,4,4,5,5,19,19,0,17
FC Botosani,7921,5,3,4,7,6,16,-10,13
Concordia Ch,7921,6,3,3,8,16,21,-5,12
FCSB,7922,1,8,6,0,26,11,15,30
CFR Cluj,7922,2,6,6,2,16,9,7,24
FC Botosani,7922,3,5,4,5,9,13,-4,19
Universitate,7922,4,3,6,5,15,22,-7,15
D Bucuresti,7922,5,3,4,7,16,21,-5,13
Concordia Ch,7922,6,3,2,9,18,24,-6,11
CFR Cluj,7923,1,7,6,1,16,7,9,27
FCSB,7923,2,7,5,2,24,14,10,26
Universitate,7923,3,4,5,5,17,21,-4,17
D Bucuresti,7923,4,4,4,6,19,22,-3,16
FC Botosani,7923,5,4,4,6,10,17,-7,16
Concordia Ch,7923,6,3,2,9,18,23,-5,11
FCSB,7924,1,8,5,1,27,13,14,29
CFR Cluj,7924,2,5,7,2,14,10,4,22
Universitate,7924,3,4,6,4,16,19,-3,18
D Bucuresti,7924,4,4,4,6,18,21,-3,16
FC Botosani,7924,5,4,4,6,6,13,-7,16
Concordia Ch,7924,6,3,2,9,18,23,-5,11
FCSB,7925,1,7,6,1,25,14,11,27
CFR Cluj,7925,2,6,7,1,15,8,7,25
Universitate,7925,3,4,5,5,17,20,-3,17
FC Botosani,7925,4,4,4,6,7,13,-6,16
D Bucuresti,7925,5,3,5,6,17,21,-4,14
Concordia Ch,7925,6,3,3,8,17,22,-5,12
FCSB,7926,1,7,5,2,23,12,11,26
CFR Cluj,7926,2,6,6,2,14,9,5,24
Universitate,7926,3,5,5,4,17,18,-1,20
D Bucuresti,7926,4,5,4,5,19,19,0,19
FC Botosani,7926,5,4,4,6,8,13,-5,16
Concordia Ch,7926,6,2,2,10,16,26,-10,8
FCSB,7927,1,9,5,0,30,12,18,32
CFR Cluj,7927,2,5,6,3,15,14,1,21
Universitate,7927,3,4,5,5,15,19,-4,17
D Bucuresti,7927,4,3,6,5,20,22,-2,15
FC Botosani,7927,5,3,5,6,6,16,-10,14
Concordia Ch,7927,6,3,3,8,21,24,-3,12
FCSB,7928,1,7,6,1,24,12,12,27
CFR Cluj,7928,2,5,7,2,14,10,4,22
Universitate,7928,3,5,5,4,17,18,-1,20
D Bucuresti,7928,4,5,4,5,20,18,2,19
FC Botosani,7928,5,3,4,7,5,16,-11,13
Concordia Ch,7928,6,3,2,9,16,22,-6,11
CFR Cluj,7929,1,7,6,1,16,8,8,27
FCSB,7929,2,7,5,2,24,13,11,26
D Bucuresti,7929,3,5,4,5,23,20,3,19
Universitate,7929,4,4,5,5,17,21,-4,17
FC Botosani,7929,5,4,4,6,7,17,-10,16
Concordia Ch,7929,6,2,2,10,18,26,-8,8
FCSB,7930,1,7,5,2,23,13,10,26
CFR Cluj,7930,2,6,6,2,15,8,7,24
Universitate,7930,3,5,5,4,16,18,-2,20
FC Botosani,7930,4,4,5,5,8,14,-6,17
D Bucuresti,7930,5,3,5,6,18,21,-3,14
Concordia Ch,7930,6,2,4,8,19,25,-6,10
FCSB,7931,1,9,5,0,25,10,15,32
CFR Cluj,7931,2,6,6,2,16,8,8,24
D Bucuresti,7931,3,4,4,6,17,19,-2,16
Universitate,7931,4,3,5,6,14,22,-8,14
FC Botosani,7931,5,3,5,6,6,14,-8,14
Concordia Ch,7931,6,3,3,8,17,22,-5,12
FCSB,7932,1,8,5,1,27,12,15,29
CFR Cluj,7932,2,6,6,2,14,11,3,24
D Bucuresti,7932,3,4,5,5,19,20,-1,17
Universitate,7932,4,4,5,5,16,19,-3,17
FC Botosani,7932,5,3,5,6,7,15,-8,14
Concordia Ch,7932,6,3,2,9,16,22,-6,11
FCSB,7933,1,8,6,0,26,11,15,30
CFR Cluj,7933,2,6,6,2,17,10,7,24
D Bucuresti,7933,3,4,5,5,20,21,-1,17
FC Botosani,7933,4,4,4,6,8,14,-6,16
Universitate,7933,5,3,6,5,14,21,-7,15
Concordia Ch,7933,6,2,3,9,17,25,-8,9
FCSB,7934,1,8,5,1,26,14,12,29
CFR Cluj,7934,2,6,7,1,16,8,8,25
FC Botosani,7934,3,4,5,5,8,13,-5,17
Universitate,7934,4,3,6,5,17,22,-5,15
D Bucuresti,7934,5,3,5,6,17,20,-3,14
Concordia Ch,7934,6,3,2,9,16,23,-7,11
FCSB,7935,1,9,5,0,26,11,15,32
CFR Cluj,7935,2,5,7,2,17,12,5,22
D Bucuresti,7935,3,4,5,5,18,19,-1,17
FC Botosani,7935,4,4,4,6,9,16,-7,16
Universitate,7935,5,3,6,5,17,22,-5,15
Concordia Ch,7935,6,2,3,9,17,24,-7,9
FCSB,7936,1,8,5,1,26,13,13,29
CFR Cluj,7936,2,7,6,1,18,8,10,27
FC Botosani,7936,3,4,5,5,8,14,-6,17
D Bucuresti,7936,4,3,5,6,18,21,-3,14
Universitate,7936,5,3,5,6,14,22,-8,14
Concordia Ch,7936,6,3,2,9,18,24,-6,11
FCSB,7937,1,7,7,0,25,12,13,28
CFR Cluj,7937,2,5,8,1,15,9,6,23
D Bucuresti,7937,3,4,4,6,18,21,-3,16
Universitate,7937,4,3,7,4,16,20,-4,16
FC Botosani,7937,5,4,4,6,7,14,-7,16
Concordia Ch,7937,6,3,2,9,18,23,-5,11
FCSB,7938,1,8,5,1,25,11,14,29
CFR Cluj,7938,2,6,7,1,15,8,7,25
D Bucuresti,7938,3,4,5,5,19,19,0,17
FC Botosani,7938,4,4,5,5,8,14,-6,17
Universitate,7938,5,3,6,5,15,21,-6,15
Concordia Ch,7938,6,2,2,10,16,25,-9,8
FCSB,7939,1,9,5,0,30,11,19,32
CFR Cluj,7939,2,6,6,2,16,12,4,24
D Bucuresti,7939,3,4,5,5,18,18,0,17
Universitate,7939,4,3,5,6,14,22,-8,14
FC Botosani,7939,5,3,5,6,6,14,-8,14
Concordia Ch,7939,6,3,2,9,17,24,-7,11
FCSB,7940,1,9,5,0,27,10,17,32
CFR Cluj,7940,2,5,6,3,13,10,3,21
FC Botosani,7940,3,5,4,5,8,13,-5,19
Universitate,7940,4,4,5,5,15,20,-5,17
D Bucuresti,7940,5,3,4,7,18,24,-6,13
Concordia Ch,7940,6,3,2,9,19,23,-4,11
FCSB,7941,1,8,5,1,26,13,13,29
CFR Cluj,7941,2,6,7,1,14,7,7,25
D Bucuresti,7941,3,3,6,5,17,19,-2,15
Universitate,7941,4,3,6,5,16,21,-5,15
FC Botosani,7941,5,3,6,5,7,14,-7,15
Concordia Ch,7941,6,2,4,8,16,22,-6,10
FCSB,7942,1,8,6,0,29,14,15,30
CFR Cluj,7942,2,6,6,2,17,12,5,24
FC Botosani,7942,3,5,4,5,9,12,-3,19
Universitate,7942,4,3,6,5,17,22,-5,15
D Bucuresti,7942,5,3,4,7,16,22,-6,13
Concordia Ch,7942,6,3,2,9,17,23,-6,11
FCSB,7943,1,7,7,0,26,13,13,28
CFR Cluj,7943,2,6,7,1,16,9,7,25
FC Botosani,7943,3,4,4,6,7,15,-8,16
Universitate,7943,4,3,6,5,17,22,-5,15
Concordia Ch,7943,5,4,2,8,19,21,-2,14
D Bucuresti,7943,6,3,4,7,17,22,-5,13
FCSB,7944,1,7,7,0,26,13,13,28
CFR Cluj,7944,2,5,7,2,15,11,4,22
D Bucuresti,7944,3,5,4,5,20,19,1,19
Universitate,7944,4,4,6,4,17,19,-2,18
FC Botosani,7944,5,3,5,6,5,13,-8,14
Concordia Ch,7944,6,2,3,9,16,24,-8,9
FCSB,7945,1,7,7,0,24,11,13,28
CFR Cluj,7945,2,5,8,1,13,7,6,23
FC Botosani,7945,3,4,5,5,7,13,-6,17
D Bucuresti,7945,4,4,4,6,18,19,-1,16
Universitate,7945,5,3,7,4,15,19,-4,16
Concordia Ch,7945,6,2,3,9,16,24,-8,9
FCSB,7946,1,9,5,0,29,10,19,32
CFR Cluj,7946,2,5,7,2,13,11,2,22
Universitate,7946,3,3,6,5,14,20,-6,15
FC Botosani,7946,4,3,6,5,6,13,-7,15
D Bucuresti,7946,5,3,5,6,16,20,-4,14
Concordia Ch,7946,6,3,3,8,18,22,-4,12
FCSB,7947,1,9,5,0,30,11,19,32
CFR Cluj,7947,2,5,6,3,14,14,0,21
Universitate,7947,3,4,5,5,17,21,-4,17
FC Botosani,7947,4,4,5,5,6,12,-6,17
D Bucuresti,7947,5,3,4,7,16,22,-6,13
Concordia Ch,7947,6,3,3,8,18,21,-3,12
CFR Cluj,7948,1,7,6,1,19,7,12,27
FCSB,7948,2,7,5,2,23,12,11,26
FC Botosani,7948,3,5,4,5,9,14,-5,19
Universitate,7948,4,4,5,5,15,23,-8,17
D Bucuresti,7948,5,4,4,6,19,20,-1,16
Concordia Ch,7948,6,2,2,10,16,25,-9,8
CFR Cluj,7949,1,7,6,1,16,7,9,27
FCSB,7949,2,7,5,2,24,14,10,26
D Bucuresti,7949,3,4,5,5,20,20,0,17
Universitate,7949,4,4,5,5,16,20,-4,17
FC Botosani,7949,5,4,4,6,6,14,-8,16
Concordia Ch,7949,6,2,3,9,17,24,-7,9
FCSB,7950,1,8,6,0,26,12,14,30
CFR Cluj,7950,2,6,6,2,16,10,6,24
D Bucuresti,7950,3,5,4,5,19,18,1,19
FC Botosani,7950,4,4,4,6,7,15,-8,16
Universitate,7950,5,3,6,5,16,21,-5,15
Concordia Ch,7950,6,2,2,10,16,24,-8,8
FCSB,7951,1,9,5,0,31,12,19,32
CFR Cluj,7951,2,5,7,2,15,11,4,22
FC Botosani,7951,3,4,5,5,7,13,-6,17
Universitate,7951,4,3,6,5,16,24,-8,15
D Bucuresti,7951,5,3,5,6,16,19,-3,14
Concordia Ch,7951,6,3,2,9,17,23,-6,11
FCSB,7952,1,8,6,0,27,11,16,30
CFR Cluj,7952,2,5,7,2,13,8,5,22
Universitate,7952,3,4,5,5,16,22,-6,17
D Bucuresti,7952,4,4,4,6,21,21,0,16
FC Botosani,7952,5,3,5,6,7,17,-10,14
Concordia Ch,7952,6,3,3,8,18,23,-5,12
FCSB,7953,1,8,5,1,25,14,11,29
CFR Cluj,7953,2,6,6,2,15,9,6,24
D Bucuresti,7953,3,4,5,5,18,19,-1,17
Universitate,7953,4,4,5,5,17,19,-2,17
FC Botosani,7953,5,3,6,5,5,12,-7,15
Concordia Ch,7953,6,2,3,9,16,23,-7,9
FCSB,7954,1,9,5,0,27,10,17,32
CFR Cluj,7954,2,6,6,2,16,9,7,24
FC Botosani,7954,3,5,4,5,12,13,-1,19
D Bucuresti,7954,4,4,4,6,19,20,-1,16
Universitate,7954,5,3,5,6,14,23,-9,14
Concordia Ch,7954,6,2,2,10,15,28,-13,8
FCSB,7955,1,7,6,1,24,12,12,27
CFR Cluj,7955,2,6,7,1,17,10,7,25
D Bucuresti,7955,3,4,5,5,18,19,-1,17
Universitate,7955,4,3,7,4,16,20,-4,16
FC Botosani,7955,5,3,5,6,7,15,-8,14
Concordia Ch,7955,6,2,4,8,18,24,-6,10
FCSB,7956,1,7,7,0,26,13,13,28
CFR Cluj,7956,2,5,7,2,15,11,4,22
FC Botosani,7956,3,5,4,5,8,13,-5,19
Universitate,7956,4,4,6,4,19,21,-2,18
D Bucuresti,7956,5,3,4,7,17,21,-4,13
Concordia Ch,7956,6,3,2,9,18,24,-6,11
FCSB,7957,1,8,5,1,26,12,14,29
CFR Cluj,7957,2,7,6,1,15,7,8,27
FC Botosani,7957,3,5,4,5,9,14,-5,19
D Bucuresti,7957,4,3,5,6,17,20,-3,14
Universitate,7957,5,3,5,6,15,22,-7,14
Concordia Ch,7957,6,2,3,9,16,23,-7,9
FCSB,7958,1,7,6,1,24,12,12,27
CFR Cluj,7958,2,7,6,1,15,7,8,27
D Bucuresti,7958,3,4,5,5,18,18,0,17
FC Botosani,7958,4,4,5,5,7,12,-5,17
Universitate,7958,5,3,6,5,15,20,-5,15
Concordia Ch,7958,6,2,2,10,15,25,-10,8
FCSB,7959,1,8,6,0,25,11,14,30
CFR Cluj,7959,2,5,8,1,14,8,6,23
D Bucuresti,7959,3,4,4,6,18,20,-2,16
Universitate,7959,4,3,6,5,14,19,-5,15
FC Botosani,7959,5,3,5,6,5,13,-8,14
Concordia Ch,7959,6,3,3,8,17,22,-5,12
FCSB,7960,1,7,5,2,25,14,11,26
CFR Cluj,7960,2,6,6,2,16,10,6,24
Universitate,7960,3,5,5,4,18,20,-2,20
D Bucuresti,7960,4,4,5,5,19,19,0,17
FC Botosani,7960,5,3,5,6,5,14,-9,14
Concordia Ch,7960,6,2,4,8,16,22,-6,10
FCSB,7961,1,9,5,0,27,11,16,32
CFR Cluj,7961,2,6,6,2,15,9,6,24
FC Botosani,7961,3,5,4,5,9,13,-4,19
Universitate,7961,4,3,5,6,15,22,-7,14
D Bucuresti,7961,5,3,4,7,18,22,-4,13
Concordia Ch,7961,6,3,2,9,17,24,-7,11
FCSB,7962,1,8,6,0,26,12,14,30
CFR Cluj,7962,2,6,6,2,16,9,7,24
D Bucuresti,7962,3,4,4,6,18,20,-2,16
Universitate,7962,4,3,6,5,15,21,-6,15
FC Botosani,7962,5,3,5,6,6,15,-9,14
Concordia Ch,7962,6,3,3,8,18,22,-4,12
FCSB,7963,1,7,7,0,26,13,13,28
CFR Cluj,7963,2,5,8,1,15,9,6,23
D Bucuresti,7963,3,4,5,5,19,19,0,17
Universitate,7963,4,3,7,4,15,19,-4,16
FC Botosani,7963,5,4,4,6,7,14,-7,16
Concordia Ch,7963,6,2,3,9,16,24,-8,9
FCSB,7964,1,8,6,0,25,10,15,30
CFR Cluj,7964,2,6,7,1,15,8,7,25
D Bucuresti,7964,3,5,4,5,19,19,0,19
Universitate,7964,4,3,5,6,15,22,-7,14
FC Botosani,7964,5,3,4,7,5,14,-9,13
Concordia Ch,7964,6,3,2,9,17,23,-6,11
FCSB,7965,1,8,6,0,28,12,16,30
CFR Cluj,7965,2,6,6,2,14,10,4,24
FC Botosani,7965,3,4,5,5,8,13,-5,17
Universitate,7965,4,3,6,5,16,21,-5,15
D Bucuresti,7965,5,3,5,6,19,23,-4,14
Concordia Ch,7965,6,2,4,8,19,25,-6,10
FCSB,7966,1,7,6,1,24,12,12,27
CFR Cluj,7966,2,6,7,1,15,8,7,25
Universitate,7966,3,4,5,5,17,21,-4,17
D Bucuresti,7966,4,4,4,6,18,20,-2,16
FC Botosani,7966,5,3,5,6,8,16,-8,14
Concordia Ch,7966,6,3,3,8,18,23,-5,12
FCSB,7967,1,8,5,1,26,12,14,29
CFR Cluj,7967,2,5,6,3,14,12,2,21
Universitate,7967,3,5,5,4,18,19,-1,20
FC Botosani,7967,4,4,5,5,9,14,-5,17
D Bucuresti,7967,5,3,6,5,18,20,-2,15
Concordia Ch,7967,6,2,3,9,15,23,-8,9
FCSB,7968,1,7,6,1,23,12,11,27
CFR Cluj,7968,2,6,7,1,15,8,7,25
Universitate,7968,3,4,5,5,17,20,-3,17
D Bucuresti,7968,4,4,4,6,17,21,-4,16
FC Botosani,7968,5,3,5,6,7,15,-8,14
Concordia Ch,7968,6,3,3,8,20,23,-3,12
FCSB,7969,1,8,5,1,24,11,13,29
CFR Cluj,7969,2,5,6,3,13,9,4,21
Universitate,7969,3,5,5,4,16,18,-2,20
FC Botosani,7969,4,4,4,6,11,17,-6,16
Concordia Ch,7969,5,4,2,8,22,22,0,14
D Bucuresti,7969,6,3,4,7,18,27,-9,13
FCSB,7970,1,8,5,1,25,12,13,29
CFR Cluj,7970,2,6,6,2,14,9,5,24
Universitate,7970,3,4,5,5,16,19,-3,17
FC Botosani,7970,4,4,5,5,10,15,-5,17
D Bucuresti,7970,5,3,5,6,20,23,-3,14
Concordia Ch,7970,6,3,2,9,19,26,-7,11
FCSB,7971,1,8,5,1,30,13,17,29
CFR Cluj,7971,2,6,6,2,14,12,2,24
Universitate,7971,3,4,5,5,17,21,-4,17
FC Botosani,7971,4,4,5,5,8,13,-5,17
D Bucuresti,7971,5,3,6,5,17,19,-2,15
Concordia Ch,7971,6,2,3,9,15,23,-8,9
FCSB,7972,1,7,6,1,25,13,12,27
CFR Cluj,7972,2,6,7,1,15,8,7,25
Universitate,7972,3,4,5,5,16,20,-4,17
D Bucuresti,7972,4,4,4,6,19,21,-2,16
FC Botosani,7972,5,4,4,6,10,14,-4,16
Concordia Ch,7972,6,3,2,9,19,28,-9,11
FCSB,7973,1,9,5,0,26,11,15,32
CFR Cluj,7973,2,5,6,3,13,11,2,21
Universitate,7973,3,4,5,5,18,20,-2,17
FC Botosani,7973,4,4,5,5,7,12,-5,17
D Bucuresti,7973,5,3,6,5,16,18,-2,15
Concordia Ch,7973,6,2,3,9,15,23,-8,9
FCSB,7974,1,7,6,1,23,15,8,27
CFR Cluj,7974,2,5,8,1,14,8,6,23
Universitate,7974,3,4,6,4,20,19,1,18
FC Botosani,7974,4,4,5,5,9,15,-6,17
D Bucuresti,7974,5,3,5,6,20,23,-3,14
Concordia Ch,7974,6,2,4,8,18,24,-6,10
FCSB,7975,1,8,6,0,26,11,15,30
CFR Cluj,7975,2,6,7,1,16,8,8,25
D Bucuresti,7975,3,4,5,5,18,18,0,17
FC Botosani,7975,4,4,5,5,7,13,-6,17
Universitate,7975,5,3,5,6,14,22,-8,14
Concordia Ch,7975,6,2,2,10,16,25,-9,8
FCSB,7976,1,8,5,1,25,12,13,29
CFR Cluj,7976,2,5,7,2,14,9,5,22
Universitate,7976,3,4,6,4,17,20,-3,18
D Bucuresti,7976,4,4,5,5,20,20,0,17
FC Botosani,7976,5,3,5,6,5,14,-9,14
Concordia Ch,7976,6,2,4,8,17,23,-6,10
FCSB,7977,1,9,5,0,27,12,15,32
CFR Cluj,7977,2,6,6,2,14,8,6,24
FC Botosani,7977,3,4,4,6,8,16,-8,16
Concordia Ch,7977,4,4,2,8,19,21,-2,14
Universitate,7977,5,3,5,6,16,22,-6,14
D Bucuresti,7977,6,3,4,7,18,23,-5,13
FCSB,7978,1,8,6,0,25,11,14,30
CFR Cluj,7978,2,6,7,1,16,8,8,25
D Bucuresti,7978,3,3,6,5,21,23,-2,15
Universitate,7978,4,3,5,6,14,21,-7,14
FC Botosani,7978,5,3,5,6,9,18,-9,14
Concordia Ch,7978,6,3,3,8,18,22,-4,12
FCSB,7979,1,8,5,1,29,11,18,29
CFR Cluj,7979,2,6,6,2,16,13,3,24
Universitate,7979,3,4,5,5,15,21,-6,17
D Bucuresti,7979,4,4,4,6,18,21,-3,16
FC Botosani,7979,5,4,4,6,6,14,-8,16
Concordia Ch,7979,6,3,2,9,18,22,-4,11
FCSB,7980,1,7,7,0,25,12,13,28
CFR Cluj,7980,2,5,8,1,13,7,6,23
D Bucuresti,7980,3,4,5,5,19,20,-1,17
FC Botosani,7980,4,4,5,5,9,15,-6,17
Universitate,7980,5,3,7,4,16,20,-4,16
Concordia Ch,7980,6,2,2,10,18,26,-8,8
FCSB,7981,1,8,5,1,25,12,13,29
CFR Cluj,7981,2,5,6,3,14,11,3,21
Universitate,7981,3,5,5,4,19,20,-1,20
D Bucuresti,7981,4,4,4,6,19,22,-3,16
FC Botosani,7981,5,4,4,6,8,15,-7,16
Concordia Ch,7981,6,3,2,9,19,24,-5,11
FCSB,7982,1,8,6,0,25,11,14,30
CFR Cluj,7982,2,5,7,2,14,10,4,22
Universitate,7982,3,4,5,5,16,19,-3,17
FC Botosani,7982,4,4,5,5,7,13,-6,17
D Bucuresti,7982,5,3,5,6,18,21,-3,14
Concordia Ch,7982,6,3,2,9,19,25,-6,11
FCSB,7983,1,8,6,0,24,10,14,30
CFR Cluj,7983,2,5,8,1,14,8,6,23
D Bucuresti,7983,3,4,4,6,18,23,-5,16
FC Botosani,7983,4,4,4,6,9,16,-7,16
Universitate,7983,5,3,6,5,15,20,-5,15
Concordia Ch,7983,6,3,2,9,21,24,-3,11
FCSB,7984,1,8,6,0,24,10,14,30
CFR Cluj,7984,2,6,6,2,14,8,6,24
D Bucuresti,7984,3,4,4,6,19,24,-5,16
Universitate,7984,4,3,6,5,14,19,-5,15
FC Botosani,7984,5,3,5,6,6,15,-9,14
Concordia Ch,7984,6,3,3,8,20,21,-1,12
FCSB,7985,1,7,6,1,25,13,12,27
CFR Cluj,7985,2,6,6,2,16,10,6,24
Universitate,7985,3,4,6,4,17,20,-3,18
D Bucuresti,7985,4,4,4,6,18,21,-3,16
FC Botosani,7985,5,4,4,6,8,14,-6,16
Concordia Ch,7985,6,3,2,9,18,24,-6,11
FCSB,7986,1,9,5,0,27,11,16,32
CFR Cluj,7986,2,6,6,2,17,10,7,24
D Bucuresti,7986,3,4,5,5,17,18,-1,17
Universitate,7986,4,3,5,6,14,22,-8,14
FC Botosani,7986,5,3,5,6,6,14,-8,14
Concordia Ch,7986,6,2,4,8,16,22,-6,10
FCSB,7987,1,8,6,0,28,13,15,30
CFR Cluj,7987,2,5,6,3,14,12,2,21
Universitate,7987,3,4,6,4,18,20,-2,18
D Bucuresti,7987,4,4,5,5,21,20,1,17
FC Botosani,7987,5,3,6,5,7,14,-7,15
Concordia Ch,7987,6,2,3,9,15,24,-9,9
FCSB,7988,1,8,5,1,27,15,12,29
CFR Cluj,7988,2,5,7,2,16,11,5,22
Universitate,7988,3,4,6,4,16,18,-2,18
FC Botosani,7988,4,4,4,6,8,15,-7,16
Concordia Ch,7988,5,4,2,8,20,22,-2,14
D Bucuresti,7988,6,3,4,7,17,23,-6,13
FCSB,7989,1,8,5,1,24,11,13,29
CFR Cluj,7989,2,7,6,1,16,8,8,27
D Bucuresti,7989,3,4,4,6,19,20,-1,16
Universitate,7989,4,3,5,6,15,21,-6,14
FC Botosani,7989,5,3,5,6,5,14,-9,14
Concordia Ch,7989,6,3,3,8,17,22,-5,12
FCSB,7990,1,8,6,0,29,13,16,30
CFR Cluj,7990,2,5,8,1,15,9,6,23
D Bucuresti,7990,3,4,5,5,19,20,-1,17
FC Botosani,7990,4,4,4,6,8,14,-6,16
Universitate,7990,5,3,6,5,15,22,-7,15
Concordia Ch,7990,6,2,3,9,16,24,-8,9
CFR Cluj,7991,1,7,6,1,18,7,11,27
FCSB,7991,2,7,5,2,23,14,9,26
D Bucuresti,7991,3,4,5,5,18,19,-1,17
Universitate,7991,4,4,5,5,16,21,-5,17
FC Botosani,7991,5,3,6,5,6,13,-7,15
Concordia Ch,7991,6,2,3,9,15,22,-7,9
CFR Cluj,7992,1,7,6,1,16,7,9,27
FCSB,7992,2,7,5,2,23,12,11,26
D Bucuresti,7992,3,4,5,5,17,18,-1,17
Universitate,7992,4,4,5,5,15,20,-5,17
FC Botosani,7992,5,3,5,6,5,15,-10,14
Concordia Ch,7992,6,3,2,9,18,22,-4,11
FCSB,7993,1,8,5,1,25,13,12,29
CFR Cluj,7993,2,7,6,1,18,8,10,27
D Bucuresti,7993,3,5,4,5,21,18,3,19
Universitate,7993,4,3,5,6,15,22,-7,14
FC Botosani,7993,5,3,4,7,5,16,-11,13
Concordia Ch,7993,6,3,2,9,17,24,-7,11
FCSB,7994,1,8,6,0,25,11,14,30
CFR Cluj,7994,2,5,7,2,14,9,5,22
D Bucuresti,7994,3,4,4,6,19,22,-3,16
Universitate,7994,4,3,7,4,16,20,-4,16
FC Botosani,7994,5,4,4,6,7,14,-7,16
Concordia Ch,7994,6,3,2,9,18,23,-5,11
FCSB,7995,1,8,5,1,25,14,11,29
CFR Cluj,7995,2,6,7,1,16,7,9,25
Universitate,7995,3,3,6,5,15,20,-5,15
Concordia Ch,7995,4,4,2,8,18,21,-3,14
D Bucuresti,7995,5,3,5,6,17,21,-4,14
FC Botosani,7995,6,3,5,6,6,14,-8,14
FCSB,7996,1,8,5,1,25,11,14,29
CFR Cluj,7996,2,7,6,1,15,7,8,27
D Bucuresti,7996,3,3,6,5,18,20,-2,15
FC Botosani,7996,4,3,6,5,6,13,-7,15
Universitate,7996,5,3,5,6,14,21,-7,14
Concordia Ch,7996,6,2,4,8,18,24,-6,10
FCSB,7997,1,8,6,0,25,10,15,30
CFR Cluj,7997,2,5,6,3,13,11,2,21
Universitate,7997,3,4,6,4,16,18,-2,18
D Bucuresti,7997,4,4,4,6,18,20,-2,16
FC Botosani,7997,5,3,5,6,6,14,-8,14
Concordia Ch,7997,6,3,3,8,18,23,-5,12
FCSB,7998,1,8,5,1,26,15,11,29
CFR Cluj,7998,2,6,6,2,16,9,7,24
Universitate,7998,3,4,5,5,18,21,-3,17
FC Botosani,7998,4,4,5,5,8,14,-6,17
D Bucuresti,7998,5,3,4,7,17,21,-4,13
Concordia Ch,7998,6,3,3,8,17,22,-5,12
FCSB,7999,1,9,5,0,29,12,17,32
CFR Cluj,7999,2,5,6,3,14,12,2,21
Universitate,7999,3,4,5,5,18,22,-4,17
D Bucuresti,7999,4,3,5,6,17,20,-3,14
Concordia Ch,7999,5,4,2,8,18,22,-4,14
FC Botosani,7999,6,3,5,6,5,13,-8,14
FCSB,8000,1,8,5,1,27,12,15,29
CFR Cluj,8000,2,5,6,3,13,12,1,21
Universitate,8000,3,5,5,4,17,18,-1,20
FC Botosani,8000,4,5,4,5,9,13,-4,19
D Bucuresti,8000,5,3,4,7,17,22,-5,13
Concordia Ch,8000,6,3,2,9,17,23,-6,11
FCSB,8001,1,8,6,0,24,10,14,30
CFR Cluj,8001,2,6,6,2,15,8,7,24
D Bucuresti,8001,3,4,5,5,20,21,-1,17
Universitate,8001,4,3,6,5,14,20,-6,15
FC Botosani,8001,5,3,4,7,9,18,-9,13
Concordia Ch,8001,6,3,3,8,19,24,-5,12
FCSB,8002,1,9,5,0,27,10,17,32
CFR Cluj,8002,2,6,6,2,14,10,4,24
D Bucuresti,8002,3,3,6,5,20,22,-2,15
FC Botosani,8002,4,3,6,5,6,13,-7,15
Universitate,8002,5,3,5,6,14,20,-6,14
Concordia Ch,8002,6,2,4,8,18,24,-6,10
FCSB,8003,1,7,5,2,25,14,11,26
CFR Cluj,8003,2,6,6,2,14,8,6,24
Universitate,8003,3,5,5,4,18,20,-2,20
D Bucuresti,8003,4,4,5,5,18,19,-1,17
FC Botosani,8003,5,3,5,6,6,14,-8,14
Concordia Ch,8003,6,2,4,8,17,23,-6,10
FCSB,8004,1,7,5,2,24,13,11,26
CFR Cluj,8004,2,6,7,1,14,7,7,25
Universitate,8004,3,4,6,4,16,19,-3,18
FC Botosani,8004,4,4,4,6,8,14,-6,16
Concordia Ch,8004,5,4,2,8,20,22,-2,14
D Bucuresti,8004,6,3,4,7,16,23,-7,13
FCSB,8005,1,8,6,0,25,10,15,30
CFR Cluj,8005,2,5,7,2,13,9,4,22
FC Botosani,8005,3,5,4,5,9,12,-3,19
Universitate,8005,4,3,7,4,14,18,-4,16
D Bucuresti,8005,5,3,4,7,16,21,-5,13
Concordia Ch,8005,6,3,2,9,16,23,-7,11
FCSB,8006,1,8,5,1,26,13,13,29
CFR Cluj,8006,2,6,6,2,15,9,6,24
D Bucuresti,8006,3,4,5,5,22,21,1,17
Universitate,8006,4,4,5,5,17,21,-4,17
FC Botosani,8006,5,3,6,5,7,14,-7,15
Concordia Ch,8006,6,2,3,9,18,27,-9,9
FCSB,8007,1,9,5,0,28,13,15,32
CFR Cluj,8007,2,5,7,2,16,11,5,22
FC Botosani,8007,3,4,5,5,8,14,-6,17
Universitate,8007,4,3,6,5,16,21,-5,15
D Bucuresti,8007,5,3,5,6,18,22,-4,14
Concordia Ch,8007,6,3,2,9,19,24,-5,11
FCSB,8008,1,9,5,0,30,12,18,32
CFR Cluj,8008,2,6,6,2,14,10,4,24
D Bucuresti,8008,3,4,4,6,18,20,-2,16
Universitate,8008,4,3,5,6,16,23,-7,14
FC Botosani,8008,5,3,5,6,7,15,-8,14
Concordia Ch,8008,6,3,3,8,17,22,-5,12
FCSB,8009,1,9,5,0,26,10,16,32
CFR Cluj,8009,2,5,7,2,13,8,5,22
D Bucuresti,8009,3,4,4,6,18,20,-2,16
Universitate,8009,4,3,6,5,14,20,-6,15
FC Botosani,8009,5,3,5,6,7,15,-8,14
Concordia Ch,8009,6,3,3,8,17,22,-5,12
FCSB,8010,1,8,6,0,26,12,14,30
CFR Cluj,8010,2,6,6,2,15,9,6,24
D Bucuresti,8010,3,4,4,6,18,22,-4,16
Universitate,8010,4,3,6,5,15,20,-5,15
FC Botosani,8010,5,3,5,6,5,14,-9,14
Concordia Ch,8010,6,3,3,8,19,21,-2,12
FCSB,8011,1,8,5,1,27,14,13,29
CFR Cluj,8011,2,6,7,1,16,9,7,25
D Bucuresti,8011,3,4,4,6,20,21,-1,16
Universitate,8011,4,3,6,5,15,20,-5,15
FC Botosani,8011,5,3,5,6,6,15,-9,14
Concordia Ch,8011,6,3,3,8,17,22,-5,12
FCSB,8012,1,7,6,1,25,13,12,27
CFR Cluj,8012,2,6,7,1,17,8,9,25
Universitate,8012,3,4,5,5,16,22,-6,17
FC Botosani,8012,4,4,4,6,6,13,-7,16
Concordia Ch,8012,5,4,2,8,17,21,-4,14
D Bucuresti,8012,6,3,4,7,16,20,-4,13
FCSB,8013,1,8,5,1,24,13,11,29
CFR Cluj,8013,2,6,6,2,16,8,8,24
Universitate,8013,3,4,5,5,17,21,-4,17
D Bucuresti,8013,4,4,4,6,17,19,-2,16
FC Botosani,8013,5,4,4,6,6,14,-8,16
Concordia Ch,8013,6,3,2,9,17,22,-5,11
FCSB,8014,1,9,5,0,28,12,16,32
CFR Cluj,8014,2,6,6,2,15,9,6,24
D Bucuresti,8014,3,5,4,5,19,19,0,19
FC Botosani,8014,4,4,4,6,8,15,-7,16
Universitate,8014,5,3,5,6,17,24,-7,14
Concordia Ch,8014,6,2,2,10,18,26,-8,8
FCSB,8015,1,8,6,0,24,10,14,30
CFR Cluj,8015,2,6,6,2,14,8,6,24
D Bucuresti,8015,3,4,5,5,19,19,0,17
FC Botosani,8015,4,4,5,5,6,12,-6,17
Universitate,8015,5,3,6,5,14,19,-5,15
Concordia Ch,8015,6,2,2,10,16,25,-9,8
FCSB,8016,1,8,6,0,24,10,14,30
CFR Cluj,8016,2,5,6,3,13,10,3,21
Universitate,8016,3,4,6,4,16,18,-2,18
D Bucuresti,8016,4,4,4,6,20,22,-2,16
Concordia Ch,8016,5,4,2,8,19,22,-3,14
FC Botosani,8016,6,3,4,7,6,16,-10,13
FCSB,8017,1,9,5,0,25,10,15,32
CFR Cluj,8017,2,6,6,2,14,8,6,24
D Bucuresti,8017,3,5,4,5,20,19,1,19
Universitate,8017,4,3,5,6,14,20,-6,14
FC Botosani,8017,5,3,4,7,6,15,-9,13
Concordia Ch,8017,6,3,2,9,16,23,-7,11
FCSB,8018,1,7,6,1,23,12,11,27
CFR Cluj,8018,2,5,8,1,14,8,6,23
FC Botosani,8018,3,5,4,5,9,12,-3,19
Universitate,8018,4,4,6,4,17,19,-2,18
D Bucuresti,8018,5,3,4,7,16,25,-9,13
Concordia Ch,8018,6,3,2,9,19,22,-3,11
FCSB,8019,1,8,6,0,26,11,15,30
CFR Cluj,8019,2,6,7,1,16,8,8,25
D Bucuresti,8019,3,4,5,5,19,20,-1,17
Universitate,8019,4,3,5,6,14,22,-8,14
FC Botosani,8019,5,3,5,6,7,15,-8,14
Concordia Ch,8019,6,3,2,9,18,24,-6,11
FCSB,8020,1,8,5,1,25,12,13,29
CFR Cluj,8020,2,5,6,3,13,9,4,21
Universitate,8020,3,5,5,4,17,19,-2,20
D Bucuresti,8020,4,4,4,6,17,19,-2,16
FC Botosani,8020,5,4,4,6,7,13,-6,16
Concordia Ch,8020,6,3,2,9,16,23,-7,11
CFR Cluj,8021,1,7,6,1,19,8,11,27
FCSB,8021,2,7,5,2,24,15,9,26
D Bucuresti,8021,3,4,5,5,19,19,0,17
Universitate,8021,4,4,5,5,18,23,-5,17
FC Botosani,8021,5,3,4,7,7,18,-11,13
Concordia Ch,8021,6,3,3,8,20,24,-4,12
FCSB,8022,1,7,7,0,27,14,13,28
CFR Cluj,8022,2,6,7,1,20,10,10,25
Universitate,8022,3,3,6,5,17,25,-8,15
Concordia Ch,8022,4,4,2,8,18,21,-3,14
D Bucuresti,8022,5,3,5,6,16,20,-4,14
FC Botosani,8022,6,3,5,6,5,13,-8,14
FCSB,8023,1,8,6,0,24,10,14,30
CFR Cluj,8023,2,6,7,1,14,7,7,25
D Bucuresti,8023,3,5,4,5,21,19,2,19
Universitate,8023,4,3,5,6,14,20,-6,14
FC Botosani,8023,5,3,5,6,6,14,-8,14
Concordia Ch,8023,6,2,3,9,17,26,-9,9
FCSB,8024,1,8,5,1,26,12,14,29
CFR Cluj,8024,2,6,6,2,14,10,4,24
FC Botosani,8024,3,5,4,5,10,14,-4,19
Universitate,8024,4,4,5,5,16,19,-3,17
D Bucuresti,8024,5,3,4,7,16,21,-5,13
Concordia Ch,8024,6,3,2,9,19,25,-6,11
FCSB,8025,1,9,5,0,26,10,16,32
CFR Cluj,8025,2,6,6,2,15,9,6,24
D Bucuresti,8025,3,4,4,6,19,20,-1,16
FC Botosani,8025,4,4,4,6,8,15,-7,16
Universitate,8025,5,3,5,6,14,21,-7,14
Concordia Ch,8025,6,3,2,9,18,25,-7,11
FCSB,8026,1,7,6,1,24,12,12,27
CFR Cluj,8026,2,6,7,1,14,7,7,25
D Bucuresti,8026,3,5,4,5,20,19,1,19
Universitate,8026,4,4,5,5,16,20,-4,17
FC Botosani,8026,5,4,4,6,8,16,-8,16
Concordia Ch,8026,6,2,2,10,16,24,-8,8
FCSB,8027,1,9,5,0,25,10,15,32
CFR Cluj,8027,2,5,7,2,14,9,5,22
FC Botosani,8027,3,4,5,5,6,12,-6,17
D Bucuresti,8027,4,3,6,5,18,20,-2,15
Universitate,8027,5,3,6,5,15,20,-5,15
Concordia Ch,8027,6,2,3,9,17,24,-7,9
FCSB,8028,1,8,6,0,25,11,14,30
CFR Cluj,8028,2,5,7,2,13,8,5,22
D Bucuresti,8028,3,5,4,5,22,20,2,19
Universitate,8028,4,3,7,4,15,19,-4,16
FC Botosani,8028,5,3,4,7,5,16,-11,13
Concordia Ch,8028,6,3,2,9,18,24,-6,11
FCSB,8029,1,7,6,1,24,12,12,27
CFR Cluj,8029,2,6,7,1,14,7,7,25
D Bucuresti,8029,3,5,4,5,19,19,0,19
Universitate,8029,4,4,5,5,16,20,-4,17
FC Botosani,8029,5,3,4,7,7,17,-10,13
Concordia Ch,8029,6,3,2,9,20,25,-5,11
FCSB,8030,1,8,6,0,25,10,15,30
CFR Cluj,8030,2,6,6,2,16,9,7,24
D Bucuresti,8030,3,5,4,5,20,18,2,19
FC Botosani,8030,4,4,4,6,6,15,-9,16
Universitate,8030,5,3,6,5,14,21,-7,15
Concordia Ch,8030,6,2,2,10,15,23,-8,8
FCSB,8031,1,8,6,0,28,12,16,30
CFR Cluj,8031,2,5,7,2,14,11,3,22
D Bucuresti,8031,3,4,4,6,18,20,-2,16
Universitate,8031,4,3,7,4,15,19,-4,16
FC Botosani,8031,5,3,5,6,5,14,-9,14
Concordia Ch,8031,6,3,3,8,17,21,-4,12
FCSB,8032,1,8,5,1,28,13,15,29
CFR Cluj,8032,2,6,6,2,15,11,4,24
Universitate,8032,3,4,5,5,17,21,-4,17
FC Botosani,8032,4,3,6,5,8,15,-7,15
D Bucuresti,8032,5,3,5,6,19,24,-5,14
Concordia Ch,8032,6,3,3,8,20,23,-3,12
FCSB,8033,1,8,6,0,26,11,15,30
CFR Cluj,8033,2,5,7,2,14,10,4,22
Universitate,8033,3,3,7,4,16,20,-4,16
Concordia Ch,8033,4,4,2,8,19,21,-2,14
D Bucuresti,8033,5,3,5,6,16,19,-3,14
FC Botosani,8033,6,3,5,6,5,15,-10,14
FCSB,8034,1,7,7,0,25,12,13,28
CFR Cluj,8034,2,5,7,2,15,10,5,22
Universitate,8034,3,4,6,4,17,20,-3,18
Concordia Ch,8034,4,4,2,8,20,22,-2,14
D Bucuresti,8034,5,3,5,6,17,22,-5,14
FC Botosani,8034,6,3,5,6,5,13,-8,14
FCSB,8035,1,7,6,1,23,11,12,27
CFR Cluj,8035,2,6,7,1,16,7,9,25
FC Botosani,8035,3,4,5,5,7,12,-5,17
Universitate,8035,4,4,5,5,15,21,-6,17
D Bucuresti,8035,5,3,5,6,16,19,-3,14
Concordia Ch,8035,6,3,2,9,16,23,-7,11
FCSB,8036,1,8,6,0,26,10,16,30
CFR Cluj,8036,2,5,6,3,13,13,0,21
D Bucuresti,8036,3,5,4,5,20,18,2,19
Universitate,8036,4,4,6,4,17,18,-1,18
FC Botosani,8036,5,3,5,6,7,16,-9,14
Concordia Ch,8036,6,2,3,9,17,25,-8,9
FCSB,8037,1,8,6,0,26,12,14,30
CFR Cluj,8037,2,5,7,2,14,9,5,22
FC Botosani,8037,3,4,5,5,6,12,-6,17
Universitate,8037,4,3,7,4,15,19,-4,16
D Bucuresti,8037,5,3,5,6,16,19,-3,14
Concordia Ch,8037,6,2,4,8,15,21,-6,10
FCSB,8038,1,8,5,1,26,13,13,29
CFR Cluj,8038,2,5,6,3,14,10,4,21
Universitate,8038,3,5,5,4,17,19,-2,20
D Bucuresti,8038,4,4,5,5,17,18,-1,17
FC Botosani,8038,5,4,5,5,7,13,-6,17
Concordia Ch,8038,6,2,2,10,16,24,-8,8
FCSB,8039,1,8,5,1,26,14,12,29
CFR Cluj,8039,2,6,6,2,14,8,6,24
D Bucuresti,8039,3,5,4,5,20,19,1,19
Universitate,8039,4,4,5,5,18,21,-3,17
FC Botosani,8039,5,4,4,6,7,14,-7,16
Concordia Ch,8039,6,2,2,10,17,26,-9,8
FCSB,8040,1,7,5,2,26,15,11,26
CFR Cluj,8040,2,6,6,2,15,9,6,24
Universitate,8040,3,5,5,4,18,20,-2,20
D Bucuresti,8040,4,5,4,5,20,19,1,19
FC Botosani,8040,5,3,4,7,7,16,-9,13
Concordia Ch,8040,6,3,2,9,17,24,-7,11
FCSB,8041,1,8,5,1,26,11,15,29
CFR Cluj,8041,2,5,6,3,13,13,0,21
Universitate,8041,3,5,5,4,18,18,0,20
D Bucuresti,8041,4,3,6,5,19,21,-2,15
FC Botosani,8041,5,3,6,5,7,14,-7,15
Concordia Ch,8041,6,2,4,8,18,24,-6,10
FCSB,8042,1,8,6,0,26,11,15,30
CFR Cluj,8042,2,6,6,2,14,9,5,24
D Bucuresti,8042,3,3,6,5,19,21,-2,15
Universitate,8042,4,3,6,5,15,20,-5,15
FC Botosani,8042,5,3,5,6,6,15,-9,14
Concordia Ch,8042,6,3,3,8,19,23,-4,12
FCSB,8043,1,8,5,1,26,14,12,29
CFR Cluj,8043,2,5,7,2,13,8,5,22
D Bucuresti,8043,3,5,4,5,20,18,2,19
Universitate,8043,4,4,6,4,18,20,-2,18
FC Botosani,8043,5,4,4,6,6,13,-7,16
Concordia Ch,8043,6,2,2,10,15,25,-10,8
FCSB,8044,1,9,5,0,29,11,18,32
CFR Cluj,8044,2,5,6,3,13,12,1,21
Universitate,8044,3,4,5,5,18,22,-4,17
D Bucuresti,8044,4,4,4,6,18,19,-1,16
FC Botosani,8044,5,4,4,6,6,14,-8,16
Concordia Ch,8044,6,3,2,9,16,22,-6,11
FCSB,8045,1,8,6,0,28,14,14,30
CFR Cluj,8045,2,6,7,1,18,9,9,25
D Bucuresti,8045,3,4,5,5,20,20,0,17
Universitate,8045,4,3,5,6,16,24,-8,14
FC Botosani,8045,5,3,5,6,6,14,-8,14
Concordia Ch,8045,6,3,2,9,17,24,-7,11
FCSB,8046,1,7,6,1,25,13,12,27
CFR Cluj,8046,2,6,7,1,16,9,7,25
FC Botosani,8046,3,5,4,5,8,12,-4,19
Universitate,8046,4,3,7,4,16,20,-4,16
D Bucuresti,8046,5,3,5,6,17,21,-4,14
Concordia Ch,8046,6,2,3,9,16,23,-7,9
FCSB,8047,1,9,5,0,30,14,16,32
CFR Cluj,8047,2,5,7,2,16,12,4,22
D Bucuresti,8047,3,4,4,6,19,20,-1,16
Universitate,8047,4,3,6,5,17,22,-5,15
Concordia Ch,8047,5,4,2,8,19,22,-3,14
FC Botosani,8047,6,3,4,7,6,17,-11,13
FCSB,8048,1,9,5,0,28,12,16,32
CFR Cluj,8048,2,5,7,2,14,9,5,22
Universitate,8048,3,3,6,5,15,21,-6,15
FC Botosani,8048,4,3,6,5,6,13,-7,15
D Bucuresti,8048,5,3,5,6,17,21,-4,14
Concordia Ch,8048,6,3,3,8,19,23,-4,12
FCSB,8049,1,7,7,0,25,12,13,28
CFR Cluj,8049,2,6,7,1,15,7,8,25
D Bucuresti,8049,3,4,4,6,18,22,-4,16
FC Botosani,8049,4,4,4,6,9,16,-7,16
Universitate,8049,5,3,6,5,16,22,-6,15
Concordia Ch,8049,6,3,2,9,20,24,-4,11
FCSB,8050,1,8,6,0,27,11,16,30
CFR Cluj,8050,2,5,7,2,13,10,3,22
D Bucuresti,8050,3,4,4,6,18,20,-2,16
Universitate,8050,4,3,7,4,15,19,-4,16
FC Botosani,8050,5,3,5,6,6,14,-8,14
Concordia Ch,8050,6,3,3,8,16,21,-5,12
FCSB,8051,1,8,6,0,28,13,15,30
CFR Cluj,8051,2,5,7,2,15,11,4,22
Universitate,8051,3,4,5,5,17,21,-4,17
FC Botosani,8051,4,4,5,5,7,13,-6,17
D Bucuresti,8051,5,3,6,5,19,21,-2,15
Concordia Ch,8051,6,2,3,9,17,24,-7,9
FCSB,8052,1,7,6,1,23,11,12,27
CFR Cluj,8052,2,6,7,1,15,8,7,25
D Bucuresti,8052,3,4,5,5,17,18,-1,17
Universitate,8052,4,4,5,5,16,20,-4,17
FC Botosani,8052,5,3,4,7,5,14,-9,13
Concordia Ch,8052,6,3,3,8,16,21,-5,12
FCSB,8053,1,7,6,1,24,12,12,27
CFR Cluj,8053,2,6,7,1,17,8,9,25
Universitate,8053,3,4,5,5,17,23,-6,17
FC Botosani,8053,4,4,5,5,8,14,-6,17
D Bucuresti,8053,5,3,5,6,20,24,-4,14
Concordia Ch,8053,6,3,2,9,19,24,-5,11
FCSB,8054,1,7,6,1,24,13,11,27
CFR Cluj,8054,2,6,6,2,15,9,6,24
Universitate,8054,3,4,6,4,17,19,-2,18
D Bucuresti,8054,4,4,4,6,18,19,-1,16
FC Botosani,8054,5,4,4,6,6,13,-7,16
Concordia Ch,8054,6,3,2,9,16,23,-7,11
FCSB,8055,1,8,5,1,25,12,13,29
CFR Cluj,8055,2,6,6,2,15,9,6,24
Universitate,8055,3,4,5,5,17,21,-4,17
D Bucuresti,8055,4,4,4,6,19,20,-1,16
FC Botosani,8055,5,4,4,6,7,15,-8,16
Concordia Ch,8055,6,3,2,9,18,24,-6,11
FCSB,8056,1,8,5,1,25,12,13,29
CFR Cluj,8056,2,7,6,1,16,8,8,27
D Bucuresti,8056,3,4,4,6,20,20,0,16
Concordia Ch,8056,4,4,2,8,19,22,-3,14
Universitate,8056,5,3,5,6,14,20,-6,14
FC Botosani,8056,6,3,4,7,5,17,-12,13
CFR Cluj,8057,1,7,6,1,19,8,11,27
FCSB,8057,2,7,6,1,23,13,10,27
D Bucuresti,8057,3,4,4,6,19,20,-1,16
FC Botosani,8057,4,4,4,6,6,13,-7,16
Universitate,8057,5,3,6,5,15,21,-6,15
Concordia Ch,8057,6,3,2,9,17,24,-7,11
FCSB,8058,1,8,6,0,29,10,19,30
CFR Cluj,8058,2,6,6,2,15,14,1,24
D Bucuresti,8058,3,4,4,6,18,20,-2,16
FC Botosani,8058,4,4,4,6,8,13,-5,16
Universitate,8058,5,3,6,5,15,20,-5,15
Concordia Ch,8058,6,3,2,9,17,25,-8,11
FCSB,8059,1,7,7,0,27,14,13,28
CFR Cluj,8059,2,6,7,1,15,8,7,25
D Bucuresti,8059,3,4,4,6,17,19,-2,16
Universitate,8059,4,3,6,5,17,22,-5,15
FC Botosani,8059,5,3,5,6,5,13,-8,14
Concordia Ch,8059,6,3,3,8,16,21,-5,12
FCSB,8060,1,8,5,1,24,11,13,29
CFR Cluj,8060,2,5,7,2,14,9,5,22
Universitate,8060,3,4,6,4,16,19,-3,18
FC Botosani,8060,4,3,6,5,6,13,-7,15
D Bucuresti,8060,5,3,5,6,18,22,-4,14
Concordia Ch,8060,6,3,3,8,18,22,-4,12
FCSB,8061,1,8,6,0,25,11,14,30
CFR Cluj,8061,2,6,6,2,15,8,7,24
D Bucuresti,8061,3,4,5,5,18,19,-1,17
FC Botosani,8061,4,4,4,6,9,16,-7,16
Universitate,8061,5,3,6,5,15,21,-6,15
Concordia Ch,8061,6,2,3,9,17,24,-7,9
FCSB,8062,1,8,5,1,24,12,12,29
CFR Cluj,8062,2,5,6,3,13,10,3,21
Universitate,8062,3,5,5,4,18,18,0,20
D Bucuresti,8062,4,5,4,5,19,18,1,19
FC Botosani,8062,5,3,4,7,6,15,-9,13
Concordia Ch,8062,6,3,2,9,17,24,-7,11
FCSB,8063,1,8,5,1,25,12,13,29
CFR Cluj,8063,2,6,7,1,16,9,7,25
D Bucuresti,8063,3,5,4,5,19,18,1,19
FC Botosani,8063,4,4,4,6,6,13,-7,16
Universitate,8063,5,3,6,5,15,20,-5,15
Concordia Ch,8063,6,2,2,10,15,24,-9,8
FCSB,8064,1,7,7,0,26,13,13,28
CFR Cluj,8064,2,6,7,1,16,9,7,25
FC Botosani,8064,3,5,4,5,9,13,-4,19
D Bucuresti,8064,4,4,4,6,18,20,-2,16
Universitate,8064,5,3,6,5,17,22,-5,15
Concordia Ch,8064,6,2,2,10,17,26,-9,8
FCSB,8065,1,8,6,0,24,10,14,30
CFR Cluj,8065,2,6,6,2,14,8,6,24
D Bucuresti,8065,3,3,6,5,20,22,-2,15
Universitate,8065,4,3,6,5,14,19,-5,15
FC Botosani,8065,5,3,6,5,7,14,-7,15
Concordia Ch,8065,6,2,4,8,17,23,-6,10
FCSB,8066,1,8,6,0,24,10,14,30
CFR Cluj,8066,2,5,8,1,13,7,6,23
D Bucuresti,8066,3,3,6,5,18,20,-2,15
Universitate,8066,4,3,6,5,14,19,-5,15
FC Botosani,8066,5,3,5,6,8,18,-10,14
Concordia Ch,8066,6,3,3,8,19,22,-3,12
FCSB,8067,1,7,7,0,25,12,13,28
CFR Cluj,8067,2,6,7,1,14,7,7,25
D Bucuresti,8067,3,4,5,5,17,18,-1,17
Universitate,8067,4,3,6,5,16,21,-5,15
FC Botosani,8067,5,3,5,6,5,13,-8,14
Concordia Ch,8067,6,2,4,8,15,21,-6,10
CFR Cluj,8068,1,7,6,1,16,8,8,27
FCSB,8068,2,7,5,2,25,14,11,26
D Bucuresti,8068,3,4,5,5,20,20,0,17
Universitate,8068,4,4,5,5,16,20,-4,17
FC Botosani,8068,5,3,5,6,6,14,-8,14
Concordia Ch,8068,6,3,2,9,17,24,-7,11
FCSB,8069,1,8,5,1,25,12,13,29
CFR Cluj,8069,2,7,6,1,16,8,8,27
D Bucuresti,8069,3,5,4,5,23,20,3,19
FC Botosani,8069,4,4,4,6,8,16,-8,16
Universitate,8069,5,3,5,6,16,22,-6,14
Concordia Ch,8069,6,2,2,10,16,26,-10,8
FCSB,8070,1,9,5,0,27,11,16,32
CFR Cluj,8070,2,6,6,2,15,10,5,24
FC Botosani,8070,3,4,5,5,10,14,-4,17
D Bucuresti,8070,4,3,5,6,17,21,-4,14
Universitate,8070,5,3,5,6,16,22,-6,14
Concordia Ch,8070,6,3,2,9,18,25,-7,11
FCSB,8071,1,7,6,1,24,12,12,27
CFR Cluj,8071,2,7,6,1,15,7,8,27
FC Botosani,8071,3,4,5,5,9,12,-3,17
D Bucuresti,8071,4,3,6,5,17,19,-2,15
Universitate,8071,5,3,6,5,15,20,-5,15
Concordia Ch,8071,6,2,3,9,16,26,-10,9
FCSB,8072,1,8,5,1,28,14,14,29
CFR Cluj,8072,2,6,7,1,18,11,7,25
Universitate,8072,3,3,6,5,17,23,-6,15
Concordia Ch,8072,4,4,2,8,18,21,-3,14
D Bucuresti,8072,4,3,5,6,18,21,-3,14
FC Botosani,8072,6,3,5,6,7,16,-9,14
FCSB,8073,1,7,7,0,24,11,13,28
CFR Cluj,8073,2,5,7,2,13,9,4,22
D Bucuresti,8073,3,5,4,5,23,19,4,19
Universitate,8073,4,4,6,4,17,19,-2,18
FC Botosani,8073,5,3,4,7,6,16,-10,13
Concordia Ch,8073,6,3,2,9,17,26,-9,11
FCSB,8074,1,8,6,0,27,13,14,30
CFR Cluj,8074,2,5,8,1,14,8,6,23
FC Botosani,8074,3,4,4,6,8,14,-6,16
Universitate,8074,4,3,6,5,16,21,-5,15
D Bucuresti,8074,5,3,5,6,16,20,-4,14
Concordia Ch,8074,6,3,3,8,17,22,-5,12
FCSB,8075,1,8,5,1,25,13,12,29
CFR Cluj,8075,2,6,6,2,16,9,7,24
Universitate,8075,3,4,5,5,16,20,-4,17
D Bucuresti,8075,4,3,6,5,18,20,-2,15
FC Botosani,8075,5,3,6,5,7,14,-7,15
Concordia Ch,8075,6,2,4,8,17,23,-6,10
FCSB,8076,1,7,7,0,24,11,13,28
CFR Cluj,8076,2,5,8,1,13,7,6,23
D Bucuresti,8076,3,5,4,5,19,19,0,19
Universitate,8076,4,3,7,4,15,19,-4,16
FC Botosani,8076,5,3,5,6,8,16,-8,14
Concordia Ch,8076,6,2,3,9,17,24,-7,9
FCSB,8077,1,9,5,0,27,12,15,32
CFR Cluj,8077,2,6,6,2,18,9,9,24
D Bucuresti,8077,3,5,4,5,19,18,1,19
FC Botosani,8077,4,4,4,6,7,13,-6,16
Universitate,8077,5,3,5,6,17,26,-9,14
Concordia Ch,8077,6,2,2,10,15,25,-10,8
CFR Cluj,8078,1,7,6,1,17,8,9,27
FCSB,8078,2,7,5,2,25,15,10,26
Universitate,8078,3,4,5,5,17,21,-4,17
FC Botosani,8078,4,4,5,5,6,12,-6,17
D Bucuresti,8078,5,3,5,6,17,20,-3,14
Concordia Ch,8078,6,3,2,9,17,23,-6,11
CFR Cluj,8079,1,7,6,1,16,8,8,27
FCSB,8079,2,7,5,2,23,12,11,26
D Bucuresti,8079,3,4,5,5,17,18,-1,17
Universitate,8079,4,4,5,5,16,20,-4,17
FC Botosani,8079,5,3,5,6,5,13,-8,14
Concordia Ch,8079,6,3,2,9,16,22,-6,11
FCSB,8080,1,8,6,0,26,12,14,30
CFR Cluj,8080,2,6,6,2,16,9,7,24
D Bucuresti,8080,3,5,4,5,19,18,1,19
FC Botosani,8080,4,4,4,6,10,13,-3,16
Universitate,8080,5,3,6,5,15,21,-6,15
Concordia Ch,8080,6,2,2,10,15,28,-13,8
FCSB,8081,1,7,7,0,24,11,13,28
CFR Cluj,8081,2,6,7,1,15,8,7,25
FC Botosani,8081,3,4,5,5,8,13,-5,17
Universitate,8081,4,3,6,5,16,21,-5,15
D Bucuresti,8081,5,3,4,7,17,24,-7,13
Concordia Ch,8081,6,3,3,8,18,21,-3,12
FCSB,8082,1,7,6,1,26,16,10,27
CFR Cluj,8082,2,5,8,1,15,9,6,23
Universitate,8082,3,4,6,4,20,21,-1,18
D Bucuresti,8082,4,4,4,6,19,22,-3,16
FC Botosani,8082,5,3,5,6,6,15,-9,14
Concordia Ch,8082,6,3,3,8,18,21,-3,12
FCSB,8083,1,9,5,0,26,11,15,32
CFR Cluj,8083,2,6,6,2,14,8,6,24
D Bucuresti,8083,3,4,5,5,19,20,-1,17
FC Botosani,8083,4,4,4,6,6,13,-7,16
Universitate,8083,5,3,5,6,15,21,-6,14
Concordia Ch,8083,6,2,3,9,17,24,-7,9
FCSB,8084,1,9,5,0,25,10,15,32
CFR Cluj,8084,2,6,6,2,17,9,8,24
D Bucuresti,8084,3,3,6,5,17,19,-2,15
FC Botosani,8084,4,3,6,5,6,13,-7,15
Universitate,8084,5,3,5,6,15,23,-8,14
Concordia Ch,8084,6,2,4,8,17,23,-6,10
FCSB,8085,1,8,6,0,25,11,14,30
CFR Cluj,8085,2,6,7,1,17,9,8,25
FC Botosani,8085,3,5,4,5,9,12,-3,19
D Bucuresti,8085,4,3,5,6,17,20,-3,14
Universitate,8085,5,3,5,6,15,22,-7,14
Concordia Ch,8085,6,2,3,9,16,25,-9,9
FCSB,8086,1,7,6,1,26,14,12,27
CFR Cluj,8086,2,5,7,2,14,9,5,22
Universitate,8086,3,5,5,4,18,20,-2,20
FC Botosani,8086,4,4,5,5,6,12,-6,17
D Bucuresti,8086,5,3,6,5,17,19,-2,15
Concordia Ch,8086,6,2,3,9,16,23,-7,9
FCSB,8087,1,9,5,0,28,10,18,32
CFR Cluj,8087,2,6,6,2,16,8,8,24
D Bucuresti,8087,3,4,5,5,20,19,1,17
FC Botosani,8087,4,4,4,6,6,15,-9,16
Universitate,8087,5,3,5,6,14,25,-11,14
Concordia Ch,8087,6,2,3,9,16,23,-7,9
FCSB,8088,1,9,5,0,26,11,15,32
CFR Cluj,8088,2,6,6,2,16,10,6,24
D Bucuresti,8088,3,4,5,5,18,19,-1,17
FC Botosani,8088,4,4,5,5,8,13,-5,17
Universitate,8088,5,3,5,6,17,23,-6,14
Concordia Ch,8088,6,2,2,10,15,24,-9,8
FCSB,8089,1,9,5,0,28,12,16,32
CFR Cluj,8089,2,5,7,2,14,10,4,22
FC Botosani,8089,3,4,5,5,7,13,-6,17
Universitate,8089,4,3,6,5,15,20,-5,15
D Bucuresti,8089,5,3,5,6,17,20,-3,14
Concordia Ch,8089,6,2,4,8,15,21,-6,10
FCSB,8090,1,9,5,0,27,12,15,32
CFR Cluj,8090,2,6,6,2,15,9,6,24
FC Botosani,8090,3,4,4,6,7,14,-7,16
Concordia Ch,8090,4,4,2,8,21,23,-2,14
Universitate,8090,5,3,5,6,17,23,-6,14
D Bucuresti,8090,6,3,4,7,19,25,-6,13
FCSB,8091,1,7,6,1,23,12,11,27
CFR Cluj,8091,2,5,8,1,14,8,6,23
D Bucuresti,8091,3,5,4,5,23,20,3,19
Universitate,8091,4,4,6,4,17,19,-2,18
FC Botosani,8091,5,3,4,7,5,17,-12,13
Concordia Ch,8091,6,3,2,9,18,24,-6,11
FCSB,8092,1,8,6,0,27,12,15,30
CFR Cluj,8092,2,6,7,1,16,9,7,25
D Bucuresti,8092,3,5,4,5,20,19,1,19
Universitate,8092,4,3,5,6,16,23,-7,14
FC Botosani,8092,5,3,4,7,5,15,-10,13
Concordia Ch,8092,6,3,2,9,17,23,-6,11
FCSB,8093,1,7,5,2,24,17,7,26
CFR Cluj,8093,2,6,6,2,16,9,7,24
Universitate,8093,3,5,5,4,19,18,1,20
D Bucuresti,8093,4,4,5,5,17,18,-1,17
FC Botosani,8093,5,3,5,6,5,16,-11,14
Concordia Ch,8093,6,3,2,9,19,22,-3,11
FCSB,8094,1,8,6,0,27,13,14,30
CFR Cluj,8094,2,5,8,1,14,8,6,23
D Bucuresti,8094,3,5,4,5,20,19,1,19
Universitate,8094,4,3,6,5,16,21,-5,15
FC Botosani,8094,5,3,4,7,5,15,-10,13
Concordia Ch,8094,6,3,2,9,17,23,-6,11
FCSB,8095,1,8,6,0,25,10,15,30
CFR Cluj,8095,2,6,6,2,14,9,5,24
FC Botosani,8095,3,5,4,5,8,13,-5,19
Universitate,8095,4,3,6,5,14,19,-5,15
D Bucuresti,8095,5,3,4,7,16,20,-4,13
Concordia Ch,8095,6,3,2,9,17,23,-6,11
FCSB,8096,1,9,5,0,26,10,16,32
CFR Cluj,8096,2,6,6,2,15,8,7,24
FC Botosani,8096,3,4,5,5,7,13,-6,17
D Bucuresti,8096,4,3,5,6,17,20,-3,14
Universitate,8096,5,3,5,6,14,22,-8,14
Concordia Ch,8096,6,3,2,9,18,24,-6,11
FCSB,8097,1,8,5,1,25,12,13,29
CFR Cluj,8097,2,6,6,2,17,9,8,24
Universitate,8097,3,4,5,5,15,21,-6,17
FC Botosani,8097,4,4,5,5,7,13,-6,17
D Bucuresti,8097,5,3,5,6,16,20,-4,14
Concordia Ch,8097,6,3,2,9,18,23,-5,11
FCSB,8098,1,8,5,1,26,15,11,29
CFR Cluj,8098,2,5,7,2,15,10,5,22
Universitate,8098,3,4,6,4,17,18,-1,18
D Bucuresti,8098,4,4,4,6,17,19,-2,16
FC Botosani,8098,5,4,4,6,7,14,-7,16
Concordia Ch,8098,6,3,2,9,17,23,-6,11
FCSB,8099,1,8,5,1,26,13,13,29
CFR Cluj,8099,2,6,6,2,15,8,7,24
Universitate,8099,3,4,5,5,17,22,-5,17
D Bucuresti,8099,4,4,4,6,20,20,0,16
FC Botosani,8099,5,4,4,6,7,17,-10,16
Concordia Ch,8099,6,3,2,9,18,23,-5,11
FCSB,8100,1,8,6,0,24,10,14,30
CFR Cluj,8100,2,6,6,2,15,9,6,24
D Bucuresti,8100,3,5,4,5,20,20,0,19
FC Botosani,8100,4,4,4,6,8,14,-6,16
Universitate,8100,5,3,6,5,15,20,-5,15
Concordia Ch,8100,6,2,2,10,16,25,-9,8
FCSB,8101,1,7,5,2,23,13,10,26
CFR Cluj,8101,2,6,7,1,15,8,7,25
Universitate,8101,3,4,6,4,17,19,-2,18
D Bucuresti,8101,4,4,4,6,18,21,-3,16
Concordia Ch,8101,5,4,2,8,18,21,-3,14
FC Botosani,8101,6,3,4,7,6,15,-9,13
FCSB,8102,1,8,5,1,26,12,14,29
CFR Cluj,8102,2,5,6,3,13,10,3,21
Universitate,8102,3,5,5,4,17,19,-2,20
D Bucuresti,8102,4,4,5,5,18,19,-1,17
FC Botosani,8102,5,4,5,5,7,13,-6,17
Concordia Ch,8102,6,2,2,10,17,25,-8,8
CFR Cluj,8103,1,7,6,1,18,7,11,27
FCSB,8103,2,7,5,2,23,14,9,26
FC Botosani,8103,3,5,4,5,8,13,-5,19
Universitate,8103,4,4,5,5,15,20,-5,17
D Bucuresti,8103,5,3,4,7,17,21,-4,13
Concordia Ch,8103,6,3,2,9,18,24,-6,11
FCSB,8104,1,8,5,1,25,13,12,29
CFR Cluj,8104,2,7,6,1,17,8,9,27
D Bucuresti,8104,3,4,4,6,19,21,-2,16
FC Botosani,8104,4,4,4,6,9,16,-7,16
Universitate,8104,5,3,5,6,16,22,-6,14
Concordia Ch,8104,6,3,2,9,17,23,-6,11
FCSB,8105,1,8,5,1,26,14,12,29
CFR Cluj,8105,2,6,6,2,15,9,6,24
D Bucuresti,8105,3,5,4,5,18,18,0,19
Universitate,8105,4,4,5,5,19,22,-3,17
FC Botosani,8105,5,4,4,6,7,14,-7,16
Concordia Ch,8105,6,2,2,10,16,24,-8,8
FCSB,8106,1,7,6,1,24,12,12,27
CFR Cluj,8106,2,5,8,1,15,9,6,23
D Bucuresti,8106,3,5,4,5,19,18,1,19
Universitate,8106,4,4,6,4,16,19,-3,18
FC Botosani,8106,5,4,4,6,6,13,-7,16
Concordia Ch,8106,6,2,2,10,15,24,-9,8
FCSB,8107,1,8,5,1,27,14,13,29
CFR Cluj,8107,2,7,6,1,18,9,9,27
D Bucuresti,8107,3,4,5,5,20,20,0,17
Universitate,8107,4,3,5,6,15,22,-7,14
FC Botosani,8107,5,3,5,6,7,16,-9,14
Concordia Ch,8107,6,2,4,8,19,25,-6,10
FCSB,8108,1,8,5,1,25,12,13,29
CFR Cluj,8108,2,7,6,1,21,8,13,27
FC Botosani,8108,3,5,4,5,12,13,-1,19
D Bucuresti,8108,4,3,5,6,17,20,-3,14
Universitate,8108,5,3,5,6,15,26,-11,14
Concordia Ch,8108,6,2,3,9,15,26,-11,9
FCSB,8109,1,7,6,1,25,13,12,27
CFR Cluj,8109,2,6,6,2,15,10,5,24
D Bucuresti,8109,3,5,4,5,20,18,2,19
Universitate,8109,4,4,6,4,19,21,-2,18
FC Botosani,8109,5,4,4,6,7,13,-6,16
Concordia Ch,8109,6,2,2,10,15,26,-11,8
FCSB,8110,1,7,7,0,26,13,13,28
CFR Cluj,8110,2,6,7,1,16,8,8,25
Universitate,8110,3,3,6,5,16,22,-6,15
Concordia Ch,8110,4,4,2,8,18,21,-3,14
D Bucuresti,8110,5,3,5,6,16,20,-4,14
FC Botosani,8110,6,3,5,6,5,13,-8,14
FCSB,8111,1,8,5,1,26,11,15,29
CFR Cluj,8111,2,5,7,2,14,11,3,22
FC Botosani,8111,3,5,4,5,10,12,-2,19
Universitate,8111,4,4,6,4,16,19,-3,18
D Bucuresti,8111,5,4,4,6,17,19,-2,16
Concordia Ch,8111,6,2,2,10,15,26,-11,8
FCSB,8112,1,7,6,1,24,12,12,27
CFR Cluj,8112,2,5,8,1,16,10,6,23
Universitate,8112,3,4,6,4,17,20,-3,18
D Bucuresti,8112,4,4,5,5,20,19,1,17
FC Botosani,8112,5,4,4,6,7,16,-9,16
Concordia Ch,8112,6,2,3,9,17,24,-7,9
FCSB,8113,1,7,6,1,24,12,12,27
CFR Cluj,8113,2,5,8,1,14,8,6,23
Universitate,8113,3,4,6,4,15,18,-3,18
D Bucuresti,8113,4,4,4,6,17,19,-2,16
Concordia Ch,8113,5,4,2,8,17,21,-4,14
FC Botosani,8113,6,3,4,7,5,14,-9,13
FCSB,8114,1,7,6,1,24,12,12,27
CFR Cluj,8114,2,5,7,2,14,10,4,22
Universitate,8114,3,5,5,4,17,18,-1,20
D Bucuresti,8114,4,4,5,5,19,20,-1,17
FC Botosani,8114,5,3,6,5,8,15,-7,15
Concordia Ch,8114,6,2,3,9,16,23,-7,9
FCSB,8115,1,7,7,0,25,12,13,28
CFR Cluj,8115,2,6,7,1,17,9,8,25
FC Botosani,8115,3,4,5,5,8,14,-6,17
D Bucuresti,8115,4,4,4,6,19,21,-2,16
Universitate,8115,5,3,6,5,14,20,-6,15
Concordia Ch,8115,6,2,3,9,19,26,-7,9
FCSB,8116,1,8,6,0,27,11,16,30
CFR Cluj,8116,2,5,6,3,14,12,2,21
Universitate,8116,3,4,6,4,17,20,-3,18
FC Botosani,8116,4,4,5,5,8,14,-6,17
D Bucuresti,8116,5,3,6,5,18,20,-2,15
Concordia Ch,8116,6,2,3,9,17,24,-7,9
FCSB,8117,1,8,6,0,26,12,14,30
CFR Cluj,8117,2,5,7,2,13,12,1,22
FC Botosani,8117,3,5,4,5,10,14,-4,19
Universitate,8117,4,4,5,5,21,21,0,17
D Bucuresti,8117,5,3,5,6,18,22,-4,14
Concordia Ch,8117,6,2,3,9,19,26,-7,9
FCSB,8118,1,8,5,1,25,14,11,29
CFR Cluj,8118,2,5,6,3,13,9,4,21
Universitate,8118,3,5,5,4,19,19,0,20
D Bucuresti,8118,4,4,5,5,18,19,-1,17
FC Botosani,8118,5,3,5,6,6,14,-8,14
Concordia Ch,8118,6,2,4,8,17,23,-6,10
FCSB,8119,1,7,6,1,25,13,12,27
CFR Cluj,8119,2,5,8,1,14,8,6,23
Universitate,8119,3,4,6,4,18,21,-3,18
D Bucuresti,8119,4,4,5,5,19,20,-1,17
FC Botosani,8119,5,3,5,6,6,14,-8,14
Concordia Ch,8119,6,2,4,8,16,22,-6,10
FCSB,8120,1,8,5,1,26,13,13,29
CFR Cluj,8120,2,6,6,2,15,9,6,24
Universitate,8120,3,4,5,5,16,20,-4,17
FC Botosani,8120,4,4,5,5,8,12,-4,17
D Bucuresti,8120,5,3,5,6,16,20,-4,14
Concordia Ch,8120,6,3,2,9,17,24,-7,11
FCSB,8121,1,9,5,0,26,10,16,32
CFR Cluj,8121,2,6,6,2,15,9,6,24
D Bucuresti,8121,3,3,5,6,16,19,-3,14
Concordia Ch,8121,4,4,2,8,17,21,-4,14
Universitate,8121,5,3,5,6,14,21,-7,14
FC Botosani,8121,6,3,5,6,5,13,-8,14
FCSB,8122,1,7,5,2,25,19,6,26
CFR Cluj,8122,2,6,6,2,18,11,7,24
Universitate,8122,3,5,5,4,22,20,2,20
D Bucuresti,8122,4,4,5,5,18,18,0,17
FC Botosani,8122,5,4,4,6,9,14,-5,16
Concordia Ch,8122,6,2,3,9,15,25,-10,9
FCSB,8123,1,7,7,0,24,11,13,28
CFR Cluj,8123,2,5,8,1,13,7,6,23
FC Botosani,8123,3,4,5,5,8,14,-6,17
Universitate,8123,4,3,7,4,15,19,-4,16
D Bucuresti,8123,5,3,4,7,16,21,-5,13
Concordia Ch,8123,6,3,3,8,19,23,-4,12
FCSB,8124,1,9,5,0,29,11,18,32
CFR Cluj,8124,2,6,6,2,16,11,5,24
FC Botosani,8124,3,5,4,5,9,12,-3,19
Universitate,8124,4,3,5,6,14,22,-8,14
D Bucuresti,8124,5,3,4,7,16,23,-7,13
Concordia Ch,8124,6,3,2,9,17,22,-5,11
FCSB,8125,1,8,5,1,26,13,13,29
CFR Cluj,8125,2,5,6,3,16,12,4,21
Universitate,8125,3,5,5,4,19,21,-2,20
D Bucuresti,8125,4,4,4,6,18,21,-3,16
Concordia Ch,8125,5,4,2,8,19,21,-2,14
FC Botosani,8125,6,3,4,7,5,15,-10,13
FCSB,8126,1,7,7,0,25,12,13,28
CFR Cluj,8126,2,6,7,1,18,9,9,25
D Bucuresti,8126,3,4,5,5,17,18,-1,17
Universitate,8126,4,3,6,5,14,21,-7,15
FC Botosani,8126,5,3,6,5,5,12,-7,15
Concordia Ch,8126,6,2,3,9,15,22,-7,9
FCSB,8127,1,8,5,1,26,13,13,29
CFR Cluj,8127,2,6,6,2,15,9,6,24
Universitate,8127,3,4,5,5,16,20,-4,17
D Bucuresti,8127,4,4,4,6,17,21,-4,16
FC Botosani,8127,5,4,4,6,9,15,-6,16
Concordia Ch,8127,6,3,2,9,20,25,-5,11
FCSB,8128,1,8,6,0,28,12,16,30
CFR Cluj,8128,2,6,6,2,17,12,5,24
D Bucuresti,8128,3,4,5,5,18,19,-1,17
FC Botosani,8128,4,4,4,6,7,14,-7,16
Universitate,8128,5,3,6,5,16,22,-6,15
Concordia Ch,8128,6,2,3,9,17,24,-7,9
FCSB,8129,1,8,6,0,26,12,14,30
CFR Cluj,8129,2,6,7,1,14,7,7,25
D Bucuresti,8129,3,5,4,5,21,19,2,19
Universitate,8129,4,3,5,6,16,22,-6,14
FC Botosani,8129,5,3,5,6,8,17,-9,14
Concordia Ch,8129,6,2,3,9,17,25,-8,9
FCSB,8130,1,7,7,0,26,13,13,28
CFR Cluj,8130,2,5,8,1,16,10,6,23
D Bucuresti,8130,3,4,5,5,18,19,-1,17
FC Botosani,8130,4,4,5,5,8,14,-6,17
Universitate,8130,5,3,7,4,18,22,-4,16
Concordia Ch,8130,6,2,2,10,16,24,-8,8
FCSB,8131,1,9,5,0,26,11,15,32
CFR Cluj,8131,2,5,7,2,13,8,5,22
D Bucuresti,8131,3,4,4,6,20,22,-2,16
Universitate,8131,4,3,6,5,15,20,-5,15
Concordia Ch,8131,5,4,2,8,21,24,-3,14
FC Botosani,8131,6,3,4,7,6,16,-10,13
CFR Cluj,8132,1,7,6,1,15,7,8,27
FCSB,8132,2,7,5,2,24,13,11,26
Universitate,8132,3,4,5,5,16,20,-4,17
D Bucuresti,8132,4,4,4,6,18,20,-2,16
FC Botosani,8132,5,4,4,6,9,16,-7,16
Concordia Ch,8132,6,3,2,9,18,24,-6,11
FCSB,8133,1,7,6,1,25,14,11,27
CFR Cluj,8133,2,6,6,2,17,10,7,24
Universitate,8133,3,4,6,4,17,20,-3,18
D Bucuresti,8133,4,4,4,6,18,22,-4,16
FC Botosani,8133,5,3,5,6,7,15,-8,14
Concordia Ch,8133,6,3,3,8,19,22,-3,12
CFR Cluj,8134,1,7,6,1,18,7,11,27
FCSB,8134,2,7,5,2,25,17,8,26
Universitate,8134,3,4,5,5,17,21,-4,17
FC Botosani,8134,4,4,4,6,8,16,-8,16
Concordia Ch,8134,5,4,2,8,20,23,-3,14
D Bucuresti,8134,6,3,4,7,18,22,-4,13
FCSB,8135,1,9,5,0,29,10,19,32
CFR Cluj,8135,2,6,6,2,16,10,6,24
FC Botosani,8135,3,5,4,5,9,14,-5,19
D Bucuresti,8135,4,4,4,6,18,20,-2,16
Universitate,8135,5,3,5,6,15,25,-10,14
Concordia Ch,8135,6,2,2,10,18,26,-8,8
FCSB,8136,1,8,5,1,26,12,14,29
CFR Cluj,8136,2,7,6,1,16,7,9,27
D Bucuresti,8136,3,4,5,5,18,19,-1,17
FC Botosani,8136,4,4,4,6,6,13,-7,16
Universitate,8136,5,3,5,6,14,22,-8,14
Concordia Ch,8136,6,2,3,9,16,23,-7,9
FCSB,8137,1,9,5,0,26,11,15,32
CFR Cluj,8137,2,5,6,3,13,10,3,21
Universitate,8137,3,4,5,5,17,20,-3,17
D Bucuresti,8137,4,3,6,5,16,18,-2,15
FC Botosani,8137,5,3,5,6,5,15,-10,14
Concordia Ch,8137,6,3,3,8,18,21,-3,12
FCSB,8138,1,9,5,0,28,12,16,32
CFR Cluj,8138,2,6,6,2,15,10,5,24
D Bucuresti,8138,3,4,4,6,19,21,-2,16
Concordia Ch,8138,4,4,2,8,21,22,-1,14
Universitate,8138,5,3,5,6,15,21,-6,14
FC Botosani,8138,6,3,4,7,6,18,-12,13
FCSB,8139,1,9,5,0,28,11,17,32
CFR Cluj,8139,2,5,6,3,13,10,3,21
Universitate,8139,3,4,5,5,16,21,-5,17
D Bucuresti,8139,4,4,4,6,19,23,-4,16
FC Botosani,8139,5,3,5,6,5,14,-9,14
Concordia Ch,8139,6,3,3,8,20,22,-2,12
FCSB,8140,1,8,5,1,25,13,12,29
CFR Cluj,8140,2,6,6,2,15,9,6,24
D Bucuresti,8140,3,4,5,5,20,19,1,17
Universitate,8140,4,4,5,5,16,19,-3,17
FC Botosani,8140,5,4,5,5,8,14,-6,17
Concordia Ch,8140,6,2,2,10,16,26,-10,8
FCSB,8141,1,7,6,1,23,11,12,27
CFR Cluj,8141,2,6,6,2,14,9,5,24
Universitate,8141,3,4,6,4,16,18,-2,18
FC Botosani,8141,4,4,5,5,7,13,-6,17
D Bucuresti,8141,5,4,4,6,18,19,-1,16
Concordia Ch,8141,6,2,3,9,16,24,-8,9
FCSB,8142,1,8,6,0,25,10,15,30
CFR Cluj,8142,2,5,8,1,14,8,6,23
D Bucuresti,8142,3,3,6,5,19,21,-2,15
Universitate,8142,4,3,6,5,15,21,-6,15
FC Botosani,8142,5,3,6,5,7,14,-7,15
Concordia Ch,8142,6,2,4,8,18,24,-6,10
FCSB,8143,1,8,5,1,26,13,13,29
CFR Cluj,8143,2,6,6,2,15,9,6,24
FC Botosani,8143,3,5,4,5,9,12,-3,19
Universitate,8143,4,4,5,5,16,20,-4,17
D Bucuresti,8143,5,4,4,6,19,19,0,16
Concordia Ch,8143,6,2,2,10,15,27,-12,8
FCSB,8144,1,7,6,1,25,14,11,27
CFR Cluj,8144,2,6,7,1,15,8,7,25
Universitate,8144,3,4,5,5,17,20,-3,17
D Bucuresti,8144,4,3,6,5,17,19,-2,15
FC Botosani,8144,5,3,5,6,5,15,-10,14
Concordia Ch,8144,6,3,3,8,19,22,-3,12
FCSB,8145,1,7,6,1,23,11,12,27
CFR Cluj,8145,2,5,8,1,13,7,6,23
Universitate,8145,3,4,6,4,15,18,-3,18
D Bucuresti,8145,4,4,5,5,20,20,0,17
FC Botosani,8145,5,3,5,6,6,15,-9,14
Concordia Ch,8145,6,2,4,8,16,22,-6,10
FCSB,8146,1,9,5,0,28,10,18,32
CFR Cluj,8146,2,5,7,2,13,8,5,22
Universitate,8146,3,3,6,5,14,22,-8,15
D Bucuresti,8146,4,3,5,6,18,21,-3,14
Concordia Ch,8146,5,4,2,8,20,24,-4,14
FC Botosani,8146,6,3,5,6,6,14,-8,14
FCSB,8147,1,7,7,0,27,14,13,28
CFR Cluj,8147,2,5,8,1,15,9,6,23
FC Botosani,8147,3,4,5,5,7,13,-6,17
Universitate,8147,4,3,7,4,18,22,-4,16
D Bucuresti,8147,5,3,5,6,16,20,-4,14
Concordia Ch,8147,6,3,2,9,18,23,-5,11
FCSB,8148,1,8,5,1,24,11,13,29
CFR Cluj,8148,2,5,7,2,14,9,5,22
Universitate,8148,3,4,6,4,16,19,-3,18
FC Botosani,8148,4,4,5,5,7,13,-6,17
D Bucuresti,8148,5,3,4,7,17,22,-5,13
Concordia Ch,8148,6,3,3,8,19,23,-4,12
FCSB,8149,1,8,5,1,24,11,13,29
CFR Cluj,8149,2,5,6,3,15,11,4,21
Universitate,8149,3,5,5,4,18,20,-2,20
D Bucuresti,8149,4,4,5,5,20,21,-1,17
FC Botosani,8149,5,4,4,6,8,15,-7,16
Concordia Ch,8149,6,2,3,9,16,23,-7,9
FCSB,8150,1,9,5,0,26,11,15,32
CFR Cluj,8150,2,6,6,2,15,9,6,24
FC Botosani,8150,3,4,5,5,9,15,-6,17
D Bucuresti,8150,4,3,5,6,18,21,-3,14
Universitate,8150,5,3,5,6,16,22,-6,14
Concordia Ch,8150,6,2,4,8,20,26,-6,10
FCSB,8151,1,7,5,2,24,16,8,26
CFR Cluj,8151,2,6,6,2,15,9,6,24
Universitate,8151,3,5,5,4,19,18,1,20
D Bucuresti,8151,4,4,4,6,20,21,-1,16
FC Botosani,8151,5,3,5,6,7,16,-9,14
Concordia Ch,8151,6,3,3,8,18,23,-5,12
FCSB,8152,1,8,5,1,25,13,12,29
CFR Cluj,8152,2,6,6,2,14,8,6,24
D Bucuresti,8152,3,4,5,5,18,19,-1,17
Universitate,8152,4,4,5,5,17,20,-3,17
FC Botosani,8152,5,3,4,7,6,15,-9,13
Concordia Ch,8152,6,3,3,8,18,23,-5,12
FCSB,8153,1,8,5,1,27,15,12,29
CFR Cluj,8153,2,6,6,2,16,9,7,24
D Bucuresti,8153,3,4,5,5,19,18,1,17
Universitate,8153,4,4,5,5,18,22,-4,17
FC Botosani,8153,5,3,6,5,6,13,-7,15
Concordia Ch,8153,6,2,3,9,16,25,-9,9
FCSB,8154,1,8,6,0,26,11,15,30
CFR Cluj,8154,2,6,6,2,16,10,6,24
D Bucuresti,8154,3,4,4,6,18,20,-2,16
FC Botosani,8154,4,4,4,6,6,13,-7,16
Universitate,8154,5,3,6,5,14,20,-6,15
Concordia Ch,8154,6,3,2,9,17,23,-6,11
FCSB,8155,1,8,5,1,25,12,13,29
CFR Cluj,8155,2,7,6,1,16,7,9,27
D Bucuresti,8155,3,4,4,6,20,20,0,16
Concordia Ch,8155,4,4,2,8,18,21,-3,14
Universitate,8155,5,3,5,6,15,22,-7,14
FC Botosani,8155,6,3,4,7,5,17,-12,13
FCSB,8156,1,8,5,1,25,13,12,29
CFR Cluj,8156,2,6,6,2,15,8,7,24
Universitate,8156,3,4,5,5,16,20,-4,17
FC Botosani,8156,4,4,5,5,6,12,-6,17
D Bucuresti,8156,5,3,6,5,18,20,-2,15
Concordia Ch,8156,6,2,3,9,17,24,-7,9
FCSB,8157,1,7,7,0,24,11,13,28
CFR Cluj,8157,2,5,7,2,14,11,3,22
Universitate,8157,3,4,6,4,17,18,-1,18
D Bucuresti,8157,4,4,4,6,18,21,-3,16
Concordia Ch,8157,5,4,2,8,19,22,-3,14
FC Botosani,8157,6,3,4,7,5,14,-9,13
FCSB,8158,1,8,6,0,26,12,14,30
CFR Cluj,8158,2,6,6,2,17,9,8,24
D Bucuresti,8158,3,4,4,6,17,19,-2,16
FC Botosani,8158,4,4,4,6,6,13,-7,16
Universitate,8158,5,3,6,5,15,22,-7,15
Concordia Ch,8158,6,3,2,9,16,22,-6,11
FCSB,8159,1,7,7,0,26,13,13,28
CFR Cluj,8159,2,6,7,1,15,8,7,25
D Bucuresti,8159,3,4,4,6,18,20,-2,16
FC Botosani,8159,4,4,4,6,9,15,-6,16
Universitate,8159,5,3,6,5,18,23,-5,15
Concordia Ch,8159,6,3,2,9,17,24,-7,11
FCSB,8160,1,8,6,0,26,12,14,30
CFR Cluj,8160,2,6,6,2,15,9,6,24
Universitate,8160,3,3,6,5,15,20,-5,15
Concordia Ch,8160,4,4,2,8,19,22,-3,14
D Bucuresti,8160,5,3,5,6,19,23,-4,14
FC Botosani,8160,6,3,5,6,7,15,-8,14
FCSB,8161,1,7,6,1,25,14,11,27
CFR Cluj,8161,2,5,7,2,14,9,5,22
Universitate,8161,3,5,5,4,18,19,-1,20
FC Botosani,8161,4,5,4,5,7,12,-5,19
D Bucuresti,8161,5,3,4,7,16,21,-5,13
Concordia Ch,8161,6,3,2,9,17,22,-5,11
FCSB,8162,1,7,6,1,25,13,12,27
CFR Cluj,8162,2,7,6,1,16,7,9,27
FC Botosani,8162,3,4,5,5,6,12,-6,17
D Bucuresti,8162,4,3,6,5,16,18,-2,15
Universitate,8162,5,3,6,5,16,22,-6,15
Concordia Ch,8162,6,2,3,9,15,22,-7,9
FCSB,8163,1,8,5,1,25,12,13,29
CFR Cluj,8163,2,6,6,2,15,9,6,24
FC Botosani,8163,3,5,4,5,9,13,-4,19
Universitate,8163,4,4,5,5,15,19,-4,17
D Bucuresti,8163,5,3,4,7,16,21,-5,13
Concordia Ch,8163,6,3,2,9,18,24,-6,11
FCSB,8164,1,9,5,0,29,11,18,32
CFR Cluj,8164,2,5,6,3,14,12,2,21
D Bucuresti,8164,3,5,4,5,22,18,4,19
Universitate,8164,4,4,5,5,19,24,-5,17
FC Botosani,8164,5,3,4,7,5,16,-11,13
Concordia Ch,8164,6,3,2,9,16,24,-8,11
FCSB,8165,1,8,6,0,24,10,14,30
CFR Cluj,8165,2,6,7,1,14,7,7,25
FC Botosani,8165,3,4,5,5,7,13,-6,17
D Bucuresti,8165,4,3,6,5,19,21,-2,15
Universitate,8165,5,3,5,6,14,20,-6,14
Concordia Ch,8165,6,2,3,9,17,24,-7,9
FCSB,8166,1,8,6,0,25,11,14,30
CFR Cluj,8166,2,5,7,2,15,10,5,22
Universitate,8166,3,3,7,4,15,19,-4,16
FC Botosani,8166,4,4,4,6,7,14,-7,16
Concordia Ch,8166,5,4,2,8,18,22,-4,14
D Bucuresti,8166,6,3,4,7,16,20,-4,13
FCSB,8167,1,8,5,1,25,11,14,29
CFR Cluj,8167,2,6,7,1,16,9,7,25
D Bucuresti,8167,3,5,4,5,18,18,0,19
FC Botosani,8167,4,4,4,6,6,13,-7,16
Universitate,8167,5,3,6,5,16,22,-6,15
Concordia Ch,8167,6,2,2,10,15,23,-8,8
FCSB,8168,1,9,5,0,30,12,18,32
CFR Cluj,8168,2,5,7,2,15,11,4,22
FC Botosani,8168,3,5,4,5,8,13,-5,19
D Bucuresti,8168,4,4,4,6,21,23,-2,16
Universitate,8168,5,3,6,5,14,21,-7,15
Concordia Ch,8168,6,2,2,10,18,26,-8,8
FCSB,8169,1,8,6,0,27,12,15,30
CFR Cluj,8169,2,6,7,1,18,10,8,25
FC Botosani,8169,3,4,5,5,6,12,-6,17
D Bucuresti,8169,4,3,5,6,17,20,-3,14
Universitate,8169,5,3,5,6,15,23,-8,14
Concordia Ch,8169,6,3,2,9,17,23,-6,11
FCSB,8170,1,8,6,0,25,11,14,30
CFR Cluj,8170,2,6,6,2,17,10,7,24
D Bucuresti,8170,3,5,4,5,21,20,1,19
Universitate,8170,4,3,6,5,15,21,-6,15
FC Botosani,8170,5,3,4,7,6,17,-11,13
Concordia Ch,8170,6,3,2,9,18,23,-5,11
FCSB,8171,1,8,5,1,27,12,15,29
CFR Cluj,8171,2,7,6,1,16,7,9,27
FC Botosani,8171,3,3,6,5,5,12,-7,15
D Bucuresti,8171,4,3,5,6,17,21,-4,14
Universitate,8171,5,3,5,6,14,23,-9,14
Concordia Ch,8171,6,3,3,8,18,22,-4,12
FCSB,8172,1,8,5,1,27,14,13,29
CFR Cluj,8172,2,5,7,2,17,13,4,22
Universitate,8172,3,4,6,4,18,20,-2,18
D Bucuresti,8172,4,4,5,5,18,19,-1,17
FC Botosani,8172,5,3,5,6,8,16,-8,14
Concordia Ch,8172,6,2,4,8,17,23,-6,10
FCSB,8173,1,7,6,1,25,13,12,27
CFR Cluj,8173,2,5,7,2,13,9,4,22
Universitate,8173,3,5,5,4,19,20,-1,20
D Bucuresti,8173,4,4,4,6,18,19,-1,16
FC Botosani,8173,5,4,4,6,7,15,-8,16
Concordia Ch,8173,6,3,2,9,17,23,-6,11
FCSB,8174,1,8,6,0,30,10,20,30
CFR Cluj,8174,2,6,7,1,14,7,7,25
D Bucuresti,8174,3,4,4,6,19,19,0,16
FC Botosani,8174,4,4,4,6,6,15,-9,16
Universitate,8174,5,3,5,6,14,26,-12,14
Concordia Ch,8174,6,3,2,9,16,22,-6,11
FCSB,8175,1,7,5,2,24,17,7,26
CFR Cluj,8175,2,6,7,1,15,7,8,25
Universitate,8175,3,4,6,4,19,19,0,18
D Bucuresti,8175,4,4,4,6,17,19,-2,16
Concordia Ch,8175,5,4,2,8,18,21,-3,14
FC Botosani,8175,6,3,4,7,5,15,-10,13
FCSB,8176,1,8,6,0,26,11,15,30
CFR Cluj,8176,2,6,7,1,16,9,7,25
FC Botosani,8176,3,3,6,5,7,14,-7,15
D Bucuresti,8176,4,3,5,6,17,21,-4,14
Universitate,8176,5,3,5,6,15,22,-7,14
Concordia Ch,8176,6,3,3,8,18,22,-4,12
FCSB,8177,1,8,6,0,24,10,14,30
CFR Cluj,8177,2,5,8,1,13,7,6,23
D Bucuresti,8177,3,4,4,6,17,22,-5,16
FC Botosani,8177,4,4,4,6,6,13,-7,16
Universitate,8177,5,3,6,5,14,19,-5,15
Concordia Ch,8177,6,3,2,9,19,22,-3,11
FCSB,8178,1,8,5,1,27,11,16,29
CFR Cluj,8178,2,6,6,2,14,11,3,24
Universitate,8178,3,4,5,5,15,19,-4,17
D Bucuresti,8178,4,4,4,6,17,23,-6,16
FC Botosani,8178,5,4,4,6,7,14,-7,16
Concordia Ch,8178,6,3,2,9,21,23,-2,11
FCSB,8179,1,9,5,0,26,11,15,32
CFR Cluj,8179,2,5,6,3,15,11,4,21
Universitate,8179,3,4,5,5,16,20,-4,17
D Bucuresti,8179,4,3,6,5,19,21,-2,15
FC Botosani,8179,5,3,6,5,7,14,-7,15
Concordia Ch,8179,6,2,4,8,16,22,-6,10
FCSB,8180,1,8,5,1,26,13,13,29
CFR Cluj,8180,2,7,6,1,16,7,9,27
FC Botosani,8180,3,4,5,5,8,14,-6,17
D Bucuresti,8180,4,3,6,5,18,20,-2,15
Universitate,8180,5,3,5,6,15,22,-7,14
Concordia Ch,8180,6,2,3,9,15,22,-7,9
FCSB,8181,1,8,5,1,27,13,14,29
CFR Cluj,8181,2,5,6,3,13,10,3,21
Universitate,8181,3,5,5,4,18,20,-2,20
FC Botosani,8181,4,5,4,5,9,14,-5,19
D Bucuresti,8181,5,3,4,7,17,23,-6,13
Concordia Ch,8181,6,3,2,9,19,23,-4,11
FCSB,8182,1,7,7,0,24,11,13,28
CFR Cluj,8182,2,5,8,1,14,8,6,23
D Bucuresti,8182,3,4,5,5,17,18,-1,17
Universitate,8182,4,3,7,4,16,20,-4,16
FC Botosani,8182,5,3,4,7,5,14,-9,13
Concordia Ch,8182,6,3,3,8,16,21,-5,12
FCSB,8183,1,8,6,0,25,10,15,30
CFR Cluj,8183,2,5,7,2,14,10,4,22
Universitate,8183,3,3,7,4,15,19,-4,16
FC Botosani,8183,4,3,6,5,5,12,-7,15
D Bucuresti,8183,5,3,5,6,16,19,-3,14
Concordia Ch,8183,6,3,3,8,16,21,-5,12
FCSB,8184,1,8,5,1,28,16,12,29
CFR Cluj,8184,2,6,6,2,17,11,6,24
Universitate,8184,3,4,5,5,19,22,-3,17
D Bucuresti,8184,4,4,4,6,17,21,-4,16
FC Botosani,8184,5,3,5,6,5,13,-8,14
Concordia Ch,8184,6,3,3,8,18,21,-3,12
FCSB,8185,1,7,5,2,24,14,10,26
CFR Cluj,8185,2,6,7,1,15,8,7,25
Universitate,8185,3,4,6,4,16,18,-2,18
D Bucuresti,8185,4,4,4,6,18,20,-2,16
FC Botosani,8185,5,3,5,6,6,14,-8,14
Concordia Ch,8185,6,3,3,8,18,23,-5,12
FCSB,8186,1,7,6,1,26,15,11,27
CFR Cluj,8186,2,6,7,1,17,10,7,25
D Bucuresti,8186,3,4,5,5,19,19,0,17
Universitate,8186,4,4,5,5,18,21,-3,17
FC Botosani,8186,5,4,5,5,11,15,-4,17
Concordia Ch,8186,6,2,2,10,17,28,-11,8
FCSB,8187,1,8,5,1,24,12,12,29
CFR Cluj,8187,2,6,6,2,15,9,6,24
D Bucuresti,8187,3,4,5,5,19,20,-1,17
Universitate,8187,4,4,5,5,17,20,-3,17
FC Botosani,8187,5,3,5,6,5,13,-8,14
Concordia Ch,8187,6,2,4,8,17,23,-6,10
FCSB,8188,1,8,6,0,25,11,14,30
CFR Cluj,8188,2,6,7,1,14,7,7,25
D Bucuresti,8188,3,3,6,5,19,21,-2,15
FC Botosani,8188,4,3,6,5,8,15,-7,15
Universitate,8188,5,3,5,6,15,21,-6,14
Concordia Ch,8188,6,2,4,8,17,23,-6,10
FCSB,8189,1,7,6,1,26,16,10,27
CFR Cluj,8189,2,6,7,1,18,10,8,25
Universitate,8189,3,4,5,5,19,22,-3,17
FC Botosani,8189,4,4,5,5,8,13,-5,17
D Bucuresti,8189,5,3,6,5,19,21,-2,15
Concordia Ch,8189,6,2,3,9,17,25,-8,9
FCSB,8190,1,9,5,0,27,10,17,32
CFR Cluj,8190,2,6,6,2,15,10,5,24
D Bucuresti,8190,3,4,4,6,19,20,-1,16
Universitate,8190,4,3,5,6,14,21,-7,14
FC Botosani,8190,5,3,5,6,7,16,-9,14
Concordia Ch,8190,6,3,3,8,17,22,-5,12
FCSB,8191,1,9,5,0,26,10,16,32
CFR Cluj,8191,2,5,7,2,14,9,5,22
D Bucuresti,8191,3,4,4,6,18,21,-3,16
FC Botosani,8191,4,4,4,6,9,15,-6,16
Universitate,8191,5,3,6,5,15,21,-6,15
Concordia Ch,8191,6,3,2,9,18,24,-6,11
FCSB,8192,1,9,5,0,27,12,15,32
CFR Cluj,8192,2,6,6,2,16,9,7,24
D Bucuresti,8192,3,5,4,5,20,18,2,19
Universitate,8192,4,3,5,6,15,22,-7,14
FC Botosani,8192,5,3,5,6,5,14,-9,14
Concordia Ch,8192,6,2,3,9,15,23,-8,9
FCSB,8193,1,8,5,1,24,12,12,29
CFR Cluj,8193,2,5,7,2,14,9,5,22
D Bucuresti,8193,3,5,4,5,20,19,1,19
Universitate,8193,4,4,6,4,17,19,-2,18
FC Botosani,8193,5,4,4,6,7,14,-7,16
Concordia Ch,8193,6,2,2,10,15,24,-9,8
FCSB,8194,1,8,6,0,25,11,14,30
CFR Cluj,8194,2,6,6,2,16,9,7,24
FC Botosani,8194,3,4,5,5,6,12,-6,17
D Bucuresti,8194,4,4,4,6,19,19,0,16
Universitate,8194,5,3,6,5,16,22,-6,15
Concordia Ch,8194,6,2,3,9,15,24,-9,9
FCSB,8195,1,8,5,1,24,11,13,29
CFR Cluj,8195,2,6,6,2,16,9,7,24
FC Botosani,8195,3,5,4,5,11,13,-2,19
Universitate,8195,4,4,5,5,16,21,-5,17
D Bucuresti,8195,5,3,4,7,16,24,-8,13
Concordia Ch,8195,6,3,2,9,19,24,-5,11
FCSB,8196,1,8,5,1,25,11,14,29
CFR Cluj,8196,2,6,6,2,14,9,5,24
D Bucuresti,8196,3,4,5,5,19,20,-1,17
Universitate,8196,4,4,5,5,16,20,-4,17
FC Botosani,8196,5,4,4,6,8,14,-6,16
Concordia Ch,8196,6,2,3,9,16,24,-8,9
FCSB,8197,1,7,6,1,25,14,11,27
CFR Cluj,8197,2,5,8,1,14,8,6,23
Universitate,8197,3,4,6,4,17,19,-2,18
D Bucuresti,8197,4,4,4,6,21,20,1,16
Concordia Ch,8197,5,4,2,8,20,22,-2,14
FC Botosani,8197,6,3,4,7,5,19,-14,13
FCSB,8198,1,8,6,0,28,14,14,30
CFR Cluj,8198,2,6,6,2,18,10,8,24
D Bucuresti,8198,3,3,6,5,19,21,-2,15
Universitate,8198,4,3,6,5,16,23,-7,15
FC Botosani,8198,5,3,5,6,8,16,-8,14
Concordia Ch,8198,6,3,3,8,18,23,-5,12
FCSB,8199,1,7,5,2,24,14,10,26
CFR Cluj,8199,2,6,7,1,17,9,8,25
Universitate,8199,3,4,6,4,18,21,-3,18
FC Botosani,8199,4,4,5,5,6,12,-6,17
D Bucuresti,8199,5,4,4,6,19,21,-2,16
Concordia Ch,8199,6,2,3,9,17,24,-7,9
FCSB,8200,1,8,6,0,24,10,14,30
CFR Cluj,8200,2,5,7,2,13,8,5,22
D Bucuresti,8200,3,4,4,6,19,20,-1,16
Universitate,8200,4,3,7,4,14,18,-4,16
FC Botosani,8200,5,3,5,6,6,15,-9,14
Concordia Ch,8200,6,3,3,8,18,23,-5,12
FCSB,8201,1,7,7,0,26,13,13,28
CFR Cluj,8201,2,5,8,1,15,9,6,23
Universitate,8201,3,3,7,4,17,21,-4,16
FC Botosani,8201,4,4,4,6,6,13,-7,16
D Bucuresti,8201,5,3,5,6,16,19,-3,14
Concordia Ch,8201,6,3,3,8,16,21,-5,12
FCSB,8202,1,7,5,2,23,13,10,26
CFR Cluj,8202,2,6,6,2,16,10,6,24
Universitate,8202,3,5,5,4,18,19,-1,20
D Bucuresti,8202,4,4,4,6,21,21,0,16
FC Botosani,8202,5,4,4,6,8,17,-9,16
Concordia Ch,8202,6,3,2,9,21,27,-6,11
FCSB,8203,1,7,6,1,24,12,12,27
CFR Cluj,8203,2,5,8,1,13,7,6,23
D Bucuresti,8203,3,5,4,5,18,18,0,19
Universitate,8203,4,4,6,4,16,19,-3,18
FC Botosani,8203,5,3,4,7,5,15,-10,13
Concordia Ch,8203,6,3,2,9,17,22,-5,11
FCSB,8204,1,8,5,1,24,11,13,29
CFR Cluj,8204,2,6,6,2,15,9,6,24
Universitate,8204,3,4,5,5,16,20,-4,17
D Bucuresti,8204,4,4,4,6,18,22,-4,16
Concordia Ch,8204,5,4,2,8,19,21,-2,14
FC Botosani,8204,6,3,4,7,6,15,-9,13
FCSB,8205,1,9,5,0,27,11,16,32
CFR Cluj,8205,2,6,6,2,17,11,6,24
FC Botosani,8205,3,4,5,5,8,14,-6,17
D Bucuresti,8205,4,3,5,6,19,24,-5,14
Universitate,8205,5,3,5,6,16,23,-7,14
Concordia Ch,8205,6,3,2,9,19,23,-4,11
FCSB,8206,1,8,6,0,27,13,14,30
CFR Cluj,8206,2,6,6,2,15,8,7,24
D Bucuresti,8206,3,4,4,6,19,22,-3,16
FC Botosani,8206,4,4,4,6,8,16,-8,16
Universitate,8206,5,3,6,5,17,23,-6,15
Concordia Ch,8206,6,3,2,9,21,25,-4,11
FCSB,8207,1,8,5,1,26,14,12,29
CFR Cluj,8207,2,7,6,1,19,8,11,27
FC Botosani,8207,3,4,5,5,7,13,-6,17
D Bucuresti,8207,4,3,5,6,18,22,-4,14
Universitate,8207,5,3,5,6,14,22,-8,14
Concordia Ch,8207,6,3,2,9,18,23,-5,11
FCSB,8208,1,8,6,0,27,12,15,30
CFR Cluj,8208,2,6,7,1,15,8,7,25
D Bucuresti,8208,3,5,4,5,21,18,3,19
Universitate,8208,4,3,5,6,15,22,-7,14
FC Botosani,8208,5,3,4,7,5,17,-12,13
Concordia Ch,8208,6,3,2,9,16,22,-6,11
FCSB,8209,1,8,5,1,26,13,13,29
CFR Cluj,8209,2,7,6,1,17,9,8,27
D Bucuresti,8209,3,3,6,5,17,19,-2,15
FC Botosani,8209,4,3,6,5,7,14,-7,15
Universitate,8209,5,3,5,6,16,22,-6,14
Concordia Ch,8209,6,2,4,8,18,24,-6,10
FCSB,8210,1,8,6,0,26,11,15,30
CFR Cluj,8210,2,6,6,2,15,10,5,24
FC Botosani,8210,3,4,4,6,9,14,-5,16
Universitate,8210,4,3,6,5,14,19,-5,15
Concordia Ch,8210,5,4,2,8,19,22,-3,14
D Bucuresti,8210,6,3,4,7,16,23,-7,13
FCSB,8211,1,9,5,0,28,12,16,32
CFR Cluj,8211,2,5,6,3,15,11,4,21
D Bucuresti,8211,3,4,5,5,18,18,0,17
Universitate,8211,4,4,5,5,17,22,-5,17
FC Botosani,8211,5,3,5,6,5,14,-9,14
Concordia Ch,8211,6,2,4,8,15,21,-6,10
FCSB,8212,1,8,6,0,26,11,15,30
CFR Cluj,8212,2,6,6,2,15,9,6,24
D Bucuresti,8212,3,4,5,5,18,19,-1,17
FC Botosani,8212,4,4,5,5,7,13,-6,17
Universitate,8212,5,3,6,5,15,21,-6,15
Concordia Ch,8212,6,2,2,10,15,23,-8,8
FCSB,8213,1,7,5,2,25,15,10,26
CFR Cluj,8213,2,6,7,1,15,8,7,25
Universitate,8213,3,4,6,4,19,21,-2,18
FC Botosani,8213,4,4,5,5,6,12,-6,17
D Bucuresti,8213,5,4,4,6,20,20,0,16
Concordia Ch,8213,6,2,3,9,16,25,-9,9
FCSB,8214,1,8,5,1,29,17,12,29
CFR Cluj,8214,2,6,6,2,17,10,7,24
Universitate,8214,3,4,5,5,19,23,-4,17
FC Botosani,8214,4,4,5,5,9,15,-6,17
D Bucuresti,8214,5,4,4,6,19,21,-2,16
Concordia Ch,8214,6,2,3,9,16,23,-7,9
FCSB,8215,1,7,7,0,26,13,13,28
CFR Cluj,8215,2,6,7,1,17,10,7,25
FC Botosani,8215,3,5,4,5,9,13,-4,19
Universitate,8215,4,3,6,5,16,21,-5,15
D Bucuresti,8215,5,3,4,7,17,21,-4,13
Concordia Ch,8215,6,3,2,9,16,23,-7,11
FCSB,8216,1,8,5,1,26,14,12,29
CFR Cluj,8216,2,5,7,2,14,10,4,22
Universitate,8216,3,4,6,4,17,18,-1,18
D Bucuresti,8216,4,4,4,6,17,19,-2,16
FC Botosani,8216,5,3,5,6,5,13,-8,14
Concordia Ch,8216,6,3,3,8,16,21,-5,12
FCSB,8217,1,8,5,1,27,14,13,29
CFR Cluj,8217,2,5,7,2,15,10,5,22
Universitate,8217,3,4,6,4,18,21,-3,18
D Bucuresti,8217,4,4,5,5,19,20,-1,17
FC Botosani,8217,5,4,5,5,8,14,-6,17
Concordia Ch,8217,6,2,2,10,17,25,-8,8
FCSB,8218,1,9,5,0,28,12,16,32
CFR Cluj,8218,2,5,7,2,14,10,4,22
D Bucuresti,8218,3,5,4,5,20,19,1,19
FC Botosani,8218,4,4,4,6,7,14,-7,16
Universitate,8218,5,3,6,5,15,20,-5,15
Concordia Ch,8218,6,2,2,10,16,25,-9,8
FCSB,8219,1,8,6,0,26,11,15,30
CFR Cluj,8219,2,5,8,1,14,8,6,23
Universitate,8219,3,3,6,5,14,20,-6,15
Concordia Ch,8219,4,4,2,8,18,21,-3,14
D Bucuresti,8219,5,3,5,6,18,22,-4,14
FC Botosani,8219,6,3,5,6,7,15,-8,14
FCSB,8220,1,8,6,0,28,11,17,30
CFR Cluj,8220,2,6,6,2,14,11,3,24
D Bucuresti,8220,3,4,5,5,19,20,-1,17
FC Botosani,8220,4,4,4,6,10,16,-6,16
Universitate,8220,5,3,6,5,15,20,-5,15
Concordia Ch,8220,6,2,3,9,16,24,-8,9
FCSB,8221,1,9,5,0,26,10,16,32
CFR Cluj,8221,2,5,6,3,14,11,3,21
Universitate,8221,3,4,5,5,16,20,-4,17
D Bucuresti,8221,4,4,4,6,18,22,-4,16
Concordia Ch,8221,5,4,2,8,21,23,-2,14
FC Botosani,8221,6,3,4,7,6,15,-9,13
FCSB,8222,1,8,6,0,26,11,15,30
CFR Cluj,8222,2,6,6,2,16,9,7,24
FC Botosani,8222,3,4,5,5,8,13,-5,17
Universitate,8222,4,3,6,5,15,22,-7,15
D Bucuresti,8222,5,3,4,7,17,24,-7,13
Concordia Ch,8222,6,3,3,8,18,21,-3,12
FCSB,8223,1,8,5,1,27,14,13,29
CFR Cluj,8223,2,6,6,2,16,10,6,24
FC Botosani,8223,3,5,4,5,8,12,-4,19
Universitate,8223,4,4,5,5,16,20,-4,17
D Bucuresti,8223,5,3,5,6,16,19,-3,14
Concordia Ch,8223,6,2,3,9,15,23,-8,9
FCSB,8224,1,8,6,0,26,12,14,30
CFR Cluj,8224,2,5,6,3,13,9,4,21
D Bucuresti,8224,3,5,4,5,20,18,2,19
Universitate,8224,4,4,6,4,17,20,-3,18
FC Botosani,8224,5,3,4,7,5,15,-10,13
Concordia Ch,8224,6,3,2,9,17,24,-7,11
FCSB,8225,1,8,5,1,26,13,13,29
CFR Cluj,8225,2,5,7,2,15,11,4,22
Universitate,8225,3,4,6,4,17,19,-2,18
FC Botosani,8225,4,4,5,5,7,13,-6,17
D Bucuresti,8225,5,4,4,6,18,20,-2,16
Concordia Ch,8225,6,2,3,9,17,24,-7,9
FCSB,8226,1,8,6,0,26,11,15,30
CFR Cluj,8226,2,5,7,2,14,10,4,22
FC Botosani,8226,3,4,5,5,8,13,-5,17
Universitate,8226,4,3,7,4,16,20,-4,16
D Bucuresti,8226,5,3,4,7,17,22,-5,13
Concordia Ch,8226,6,3,3,8,18,23,-5,12
FCSB,8227,1,8,6,0,26,12,14,30
CFR Cluj,8227,2,5,6,3,15,12,3,21
Universitate,8227,3,4,6,4,16,18,-2,18
D Bucuresti,8227,4,4,4,6,18,20,-2,16
Concordia Ch,8227,5,4,2,8,18,22,-4,14
FC Botosani,8227,6,3,4,7,5,14,-9,13
FCSB,8228,1,7,7,0,26,13,13,28
CFR Cluj,8228,2,5,7,2,15,10,5,22
Universitate,8228,3,4,6,4,18,21,-3,18
D Bucuresti,8228,4,4,5,5,21,21,0,17
FC Botosani,8228,5,4,4,6,8,16,-8,16
Concordia Ch,8228,6,2,3,9,16,23,-7,9
FCSB,8229,1,9,5,0,30,11,19,32
CFR Cluj,8229,2,5,7,2,15,10,5,22
D Bucuresti,8229,3,5,4,5,20,19,1,19
FC Botosani,8229,4,4,4,6,7,14,-7,16
Universitate,8229,5,3,6,5,15,24,-9,15
Concordia Ch,8229,6,2,2,10,17,26,-9,8
FCSB,8230,1,8,6,0,26,12,14,30
CFR Cluj,8230,2,5,6,3,14,11,3,21
Universitate,8230,3,4,6,4,17,19,-2,18
D Bucuresti,8230,4,4,4,6,18,20,-2,16
FC Botosani,8230,5,4,4,6,7,14,-7,16
Concordia Ch,8230,6,3,2,9,18,24,-6,11
FCSB,8231,1,8,6,0,25,11,14,30
CFR Cluj,8231,2,5,8,1,17,11,6,23
D Bucuresti,8231,3,5,4,5,22,19,3,19
Universitate,8231,4,3,6,5,17,22,-5,15
FC Botosani,8231,5,3,4,7,5,14,-9,13
Concordia Ch,8231,6,3,2,9,17,26,-9,11
FCSB,8232,1,8,6,0,25,11,14,30
CFR Cluj,8232,2,5,6,3,14,11,3,21
Universitate,8232,3,4,6,4,16,18,-2,18
Concordia Ch,8232,4,4,2,8,19,21,-2,14
D Bucuresti,8232,5,3,5,6,17,22,-5,14
FC Botosani,8232,6,3,5,6,6,14,-8,14
FCSB,8233,1,7,6,1,25,13,12,27
CFR Cluj,8233,2,5,7,2,15,10,5,22
Universitate,8233,3,5,5,4,16,18,-2,20
D Bucuresti,8233,4,5,4,5,19,19,0,19
FC Botosani,8233,5,3,5,6,5,13,-8,14
Concordia Ch,8233,6,2,3,9,16,23,-7,9
FCSB,8234,1,8,5,1,26,12,14,29
CFR Cluj,8234,2,6,6,2,18,11,7,24
Universitate,8234,3,4,5,5,16,22,-6,17
D Bucuresti,8234,4,3,6,5,17,19,-2,15
FC Botosani,8234,5,3,6,5,5,12,-7,15
Concordia Ch,8234,6,2,4,8,16,22,-6,10
FCSB,8235,1,8,5,1,27,16,11,29
CFR Cluj,8235,2,5,6,3,14,11,3,21
Universitate,8235,3,5,5,4,20,19,1,20
D Bucuresti,8235,4,4,4,6,18,20,-2,16
FC Botosani,8235,5,3,5,6,6,15,-9,14
Concordia Ch,8235,6,3,3,8,18,22,-4,12
FCSB,8236,1,9,5,0,27,11,16,32
CFR Cluj,8236,2,6,6,2,16,10,6,24
D Bucuresti,8236,3,4,5,5,20,21,-1,17
FC Botosani,8236,4,4,5,5,10,16,-6,17
Universitate,8236,5,3,5,6,15,22,-7,14
Concordia Ch,8236,6,2,2,10,16,24,-8,8
FCSB,8237,1,8,6,0,27,12,15,30
CFR Cluj,8237,2,6,7,1,19,11,8,25
D Bucuresti,8237,3,5,4,5,20,19,1,19
FC Botosani,8237,4,4,4,6,7,14,-7,16
Universitate,8237,5,3,5,6,16,24,-8,14
Concordia Ch,8237,6,2,2,10,15,24,-9,8
FCSB,8238,1,7,6,1,23,14,9,27
CFR Cluj,8238,2,5,8,1,15,9,6,23
Universitate,8238,3,4,6,4,20,20,0,18
D Bucuresti,8238,4,4,4,6,18,20,-2,16
FC Botosani,8238,5,3,5,6,7,15,-8,14
Concordia Ch,8238,6,3,3,8,19,24,-5,12
FCSB,8239,1,7,5,2,24,13,11,26
CFR Cluj,8239,2,6,7,1,16,9,7,25
Universitate,8239,3,4,6,4,16,19,-3,18
D Bucuresti,8239,4,4,5,5,20,19,1,17
FC Botosani,8239,5,4,4,6,7,15,-8,16
Concordia Ch,8239,6,2,3,9,16,24,-8,9
FCSB,8240,1,7,6,1,26,15,11,27
CFR Cluj,8240,2,6,6,2,16,9,7,24
D Bucuresti,8240,3,5,4,5,21,19,2,19
Universitate,8240,4,4,6,4,19,22,-3,18
FC Botosani,8240,5,3,4,7,7,19,-12,13
Concordia Ch,8240,6,3,2,9,19,24,-5,11
FCSB,8241,1,7,7,0,25,12,13,28
CFR Cluj,8241,2,5,7,2,13,8,5,22
Universitate,8241,3,4,6,4,17,20,-3,18
FC Botosani,8241,4,3,6,5,7,14,-7,15
D Bucuresti,8241,5,3,5,6,18,22,-4,14
Concordia Ch,8241,6,3,3,8,17,21,-4,12
CFR Cluj,8242,1,7,6,1,18,10,8,27
FCSB,8242,2,7,5,2,27,17,10,26
Universitate,8242,3,4,5,5,19,22,-3,17
D Bucuresti,8242,4,4,4,6,17,19,-2,16
Concordia Ch,8242,5,4,2,8,17,21,-4,14
FC Botosani,8242,6,3,4,7,5,14,-9,13
FCSB,8243,1,7,6,1,26,14,12,27
CFR Cluj,8243,2,5,8,1,14,8,6,23
Universitate,8243,3,4,6,4,17,20,-3,18
FC Botosani,8243,4,4,5,5,6,12,-6,17
D Bucuresti,8243,5,3,6,5,17,19,-2,15
Concordia Ch,8243,6,2,3,9,16,23,-7,9
FCSB,8244,1,8,6,0,27,12,15,30
CFR Cluj,8244,2,5,7,2,14,10,4,22
Universitate,8244,3,3,7,4,15,19,-4,16
FC Botosani,8244,4,4,4,6,7,14,-7,16
Concordia Ch,8244,5,4,2,8,18,22,-4,14
D Bucuresti,8244,6,3,4,7,18,22,-4,13
FCSB,8245,1,7,6,1,27,15,12,27
CFR Cluj,8245,2,5,8,1,15,9,6,23
Universitate,8245,3,4,6,4,19,22,-3,18
FC Botosani,8245,4,4,5,5,8,14,-6,17
D Bucuresti,8245,5,3,6,5,19,21,-2,15
Concordia Ch,8245,6,2,3,9,16,23,-7,9
FCSB,8246,1,8,5,1,26,13,13,29
CFR Cluj,8246,2,5,6,3,13,9,4,21
Universitate,8246,3,5,5,4,18,20,-2,20
FC Botosani,8246,4,4,5,5,6,12,-6,17
D Bucuresti,8246,5,3,5,6,16,21,-5,14
Concordia Ch,8246,6,3,2,9,18,22,-4,11
CFR Cluj,8247,1,7,6,1,16,8,8,27
FCSB,8247,2,7,5,2,23,12,11,26
D Bucuresti,8247,3,4,5,5,21,18,3,17
Universitate,8247,4,4,5,5,16,20,-4,17
FC Botosani,8247,5,3,5,6,5,17,-12,14
Concordia Ch,8247,6,2,4,8,15,21,-6,10
FCSB,8248,1,7,6,1,25,15,10,27
CFR Cluj,8248,2,5,8,1,16,10,6,23
Universitate,8248,3,4,6,4,18,19,-1,18
D Bucuresti,8248,4,4,4,6,17,20,-3,16
Concordia Ch,8248,5,4,2,8,18,21,-3,14
FC Botosani,8248,6,3,4,7,5,14,-9,13
FCSB,8249,1,8,6,0,25,11,14,30
CFR Cluj,8249,2,6,7,1,16,9,7,25
D Bucuresti,8249,3,5,4,5,19,18,1,19
FC Botosani,8249,4,4,4,6,7,14,-7,16
Universitate,8249,5,3,5,6,15,21,-6,14
Concordia Ch,8249,6,2,2,10,15,24,-9,8
FCSB,8250,1,9,5,0,26,10,16,32
CFR Cluj,8250,2,6,6,2,14,9,5,24
FC Botosani,8250,3,4,5,5,6,12,-6,17
D Bucuresti,8250,4,3,5,6,16,21,-5,14
Universitate,8250,5,3,5,6,14,20,-6,14
Concordia Ch,8250,6,3,2,9,18,22,-4,11
CFR Cluj,8251,1,7,6,1,18,8,10,27
FCSB,8251,2,7,5,2,24,14,10,26
D Bucuresti,8251,3,5,4,5,21,21,0,19
Universitate,8251,4,4,5,5,15,20,-5,17
FC Botosani,8251,5,4,4,6,9,16,-7,16
Concordia Ch,8251,6,2,2,10,17,25,-8,8
FCSB,8252,1,7,6,1,23,12,11,27
CFR Cluj,8252,2,6,7,1,15,7,8,25
D Bucuresti,8252,3,4,5,5,18,19,-1,17
Universitate,8252,4,3,7,4,14,18,-4,16
FC Botosani,8252,5,4,4,6,7,13,-6,16
Concordia Ch,8252,6,2,3,9,16,24,-8,9
FCSB,8253,1,7,6,1,23,11,12,27
CFR Cluj,8253,2,6,7,1,16,8,8,25
Universitate,8253,3,4,5,5,16,21,-5,17
FC Botosani,8253,4,4,5,5,6,12,-6,17
D Bucuresti,8253,5,3,5,6,17,20,-3,14
Concordia Ch,8253,6,2,4,8,16,22,-6,10
FCSB,8254,1,9,5,0,27,12,15,32
CFR Cluj,8254,2,6,6,2,17,10,7,24
D Bucuresti,8254,3,4,4,6,20,20,0,16
FC Botosani,8254,4,4,4,6,6,15,-9,16
Universitate,8254,5,3,5,6,16,23,-7,14
Concordia Ch,8254,6,3,2,9,17,23,-6,11
FCSB,8255,1,7,7,0,25,12,13,28
CFR Cluj,8255,2,5,8,1,15,9,6,23
D Bucuresti,8255,3,4,4,6,19,21,-2,16
Universitate,8255,4,3,7,4,16,20,-4,16
FC Botosani,8255,5,4,4,6,8,15,-7,16
Concordia Ch,8255,6,3,2,9,18,24,-6,11
CFR Cluj,8256,1,7,6,1,18,9,9,27
FCSB,8256,2,7,5,2,24,13,11,26
FC Botosani,8256,3,5,4,5,7,12,-5,19
Universitate,8256,4,4,5,5,16,21,-5,17
D Bucuresti,8256,5,3,4,7,17,22,-5,13
Concordia Ch,8256,6,3,2,9,18,23,-5,11
FCSB,8257,1,8,6,0,25,11,14,30
CFR Cluj,8257,2,6,6,2,14,8,6,24
FC Botosani,8257,3,4,5,5,7,13,-6,17
Universitate,8257,4,3,6,5,15,20,-5,15
D Bucuresti,8257,5,3,4,7,17,22,-5,13
Concordia Ch,8257,6,3,3,8,17,21,-4,12
FCSB,8258,1,9,5,0,27,11,16,32
CFR Cluj,8258,2,6,6,2,14,9,5,24
D Bucuresti,8258,3,4,4,6,19,20,-1,16
FC Botosani,8258,4,4,4,6,7,16,-9,16
Universitate,8258,5,3,5,6,15,21,-6,14
Concordia Ch,8258,6,3,2,9,18,23,-5,11
FCSB,8259,1,7,6,1,23,12,11,27
CFR Cluj,8259,2,6,7,1,16,7,9,25
D Bucuresti,8259,3,4,5,5,19,20,-1,17
Universitate,8259,4,4,5,5,16,21,-5,17
FC Botosani,8259,5,4,4,6,8,14,-6,16
Concordia Ch,8259,6,2,3,9,18,26,-8,9
FCSB,8260,1,7,6,1,24,12,12,27
CFR Cluj,8260,2,7,6,1,17,9,8,27
D Bucuresti,8260,3,3,6,5,19,21,-2,15
Universitate,8260,4,3,6,5,17,22,-5,15
FC Botosani,8260,5,3,6,5,8,15,-7,15
Concordia Ch,8260,6,2,4,8,17,23,-6,10
FCSB,8261,1,8,6,0,25,11,14,30
CFR Cluj,8261,2,5,7,2,14,9,5,22
FC Botosani,8261,3,5,4,5,9,14,-5,19
Universitate,8261,4,4,5,5,15,19,-4,17
D Bucuresti,8261,5,3,4,7,17,21,-4,13
Concordia Ch,8261,6,3,2,9,19,25,-6,11
FCSB,8262,1,7,6,1,23,11,12,27
CFR Cluj,8262,2,6,6,2,15,9,6,24
Universitate,8262,3,4,6,4,16,19,-3,18
Concordia Ch,8262,4,4,2,8,20,21,-1,14
D Bucuresti,8262,5,3,5,6,17,22,-5,14
FC Botosani,8262,6,3,5,6,6,15,-9,14
FCSB,8263,1,9,5,0,30,12,18,32
CFR Cluj,8263,2,6,6,2,15,12,3,24
FC Botosani,8263,3,5,4,5,9,13,-4,19
Universitate,8263,4,3,5,6,15,21,-6,14
D Bucuresti,8263,5,3,4,7,16,21,-5,13
Concordia Ch,8263,6,3,2,9,17,23,-6,11
FCSB,8264,1,7,7,0,25,12,13,28
CFR Cluj,8264,2,5,7,2,14,9,5,22
FC Botosani,8264,3,5,4,5,10,13,-3,19
Universitate,8264,4,4,6,4,16,19,-3,18
D Bucuresti,8264,5,4,4,6,18,21,-3,16
Concordia Ch,8264,6,2,2,10,15,24,-9,8
FCSB,8265,1,7,6,1,23,13,10,27
CFR Cluj,8265,2,6,7,1,16,8,8,25
Universitate,8265,3,4,5,5,18,21,-3,17
D Bucuresti,8265,4,4,4,6,17,19,-2,16
FC Botosani,8265,5,4,4,6,7,13,-6,16
Concordia Ch,8265,6,3,2,9,16,23,-7,11
FCSB,8266,1,8,5,1,26,12,14,29
CFR Cluj,8266,2,7,6,1,17,9,8,27
D Bucuresti,8266,3,5,4,5,20,18,2,19
Universitate,8266,4,3,5,6,15,22,-7,14
FC Botosani,8266,5,3,4,7,6,18,-12,13
Concordia Ch,8266,6,3,2,9,18,23,-5,11
FCSB,8267,1,8,5,1,25,11,14,29
CFR Cluj,8267,2,5,6,3,14,13,1,21
Universitate,8267,3,5,5,4,19,19,0,20
FC Botosani,8267,4,5,4,5,10,14,-4,19
D Bucuresti,8267,5,4,4,6,19,20,-1,16
Concordia Ch,8267,6,2,2,10,16,26,-10,8
FCSB,8268,1,8,5,1,24,11,13,29
CFR Cluj,8268,2,5,6,3,13,9,4,21
Universitate,8268,3,5,5,4,16,18,-2,20
FC Botosani,8268,4,3,6,5,5,12,-7,15
D Bucuresti,8268,5,3,5,6,16,21,-5,14
Concordia Ch,8268,6,3,3,8,18,21,-3,12
FCSB,8269,1,8,6,0,26,12,14,30
CFR Cluj,8269,2,6,7,1,18,9,9,25
FC Botosani,8269,3,5,4,5,7,12,-5,19
Universitate,8269,4,3,5,6,16,24,-8,14
D Bucuresti,8269,5,3,4,7,16,22,-6,13
Concordia Ch,8269,6,3,2,9,18,22,-4,11
FCSB,8270,1,8,6,0,25,10,15,30
CFR Cluj,8270,2,5,8,1,15,9,6,23
D Bucuresti,8270,3,4,4,6,17,19,-2,16
Universitate,8270,4,3,6,5,16,22,-6,15
FC Botosani,8270,5,3,5,6,6,14,-8,14
Concordia Ch,8270,6,3,3,8,17,22,-5,12
FCSB,8271,1,7,6,1,24,13,11,27
CFR Cluj,8271,2,7,6,1,18,8,10,27
D Bucuresti,8271,3,4,5,5,18,18,0,17
Universitate,8271,4,3,6,5,16,22,-6,15
FC Botosani,8271,5,3,5,6,6,15,-9,14
Concordia Ch,8271,6,2,4,8,16,22,-6,10
FCSB,8272,1,7,6,1,26,14,12,27
CFR Cluj,8272,2,5,8,1,16,10,6,23
Universitate,8272,3,4,6,4,17,20,-3,18
D Bucuresti,8272,4,4,5,5,18,19,-1,17
FC Botosani,8272,5,4,4,6,6,13,-7,16
Concordia Ch,8272,6,2,3,9,16,23,-7,9
FCSB,8273,1,9,5,0,28,12,16,32
CFR Cluj,8273,2,5,6,3,13,11,2,21
D Bucuresti,8273,3,5,4,5,20,20,0,19
Universitate,8273,4,4,5,5,18,21,-3,17
FC Botosani,8273,5,3,5,6,6,14,-8,14
Concordia Ch,8273,6,2,3,9,16,23,-7,9
FCSB,8274,1,8,5,1,26,12,14,29
CFR Cluj,8274,2,5,7,2,13,9,4,22
FC Botosani,8274,3,5,4,5,7,12,-5,19
Universitate,8274,4,4,6,4,16,19,-3,18
D Bucuresti,8274,5,3,4,7,16,20,-4,13
Concordia Ch,8274,6,3,2,9,16,22,-6,11
FCSB,8275,1,7,7,0,24,11,13,28
CFR Cluj,8275,2,6,7,1,14,7,7,25
FC Botosani,8275,3,5,4,5,8,12,-4,19
Universitate,8275,4,3,6,5,15,20,-5,15
D Bucuresti,8275,5,3,4,7,18,23,-5,13
Concordia Ch,8275,6,3,2,9,18,24,-6,11
FCSB,8276,1,8,6,0,25,11,14,30
CFR Cluj,8276,2,5,7,2,13,8,5,22
D Bucuresti,8276,3,4,4,6,17,20,-3,16
Universitate,8276,4,3,7,4,15,19,-4,16
FC Botosani,8276,5,4,4,6,6,13,-7,16
Concordia Ch,8276,6,3,2,9,17,22,-5,11
FCSB,8277,1,9,5,0,27,12,15,32
CFR Cluj,8277,2,6,6,2,15,8,7,24
D Bucuresti,8277,3,4,4,6,20,23,-3,16
FC Botosani,8277,4,4,4,6,7,16,-9,16
Universitate,8277,5,3,5,6,16,23,-7,14
Concordia Ch,8277,6,3,2,9,19,22,-3,11
FCSB,8278,1,9,5,0,25,10,15,32
CFR Cluj,8278,2,6,6,2,14,8,6,24
D Bucuresti,8278,3,5,4,5,21,19,2,19
Universitate,8278,4,3,5,6,14,20,-6,14
FC Botosani,8278,5,3,4,7,6,18,-12,13
Concordia Ch,8278,6,3,2,9,20,25,-5,11
FCSB,8279,1,8,6,0,26,11,15,30
CFR Cluj,8279,2,5,7,2,16,12,4,22
D Bucuresti,8279,3,4,5,5,18,19,-1,17
Universitate,8279,4,3,7,4,16,20,-4,16
FC Botosani,8279,5,3,6,5,6,13,-7,15
Concordia Ch,8279,6,2,3,9,15,22,-7,9
FCSB,8280,1,9,5,0,26,10,16,32
CFR Cluj,8280,2,6,6,2,14,9,5,24
D Bucuresti,8280,3,4,4,6,18,20,-2,16
Concordia Ch,8280,4,4,2,8,19,22,-3,14
Universitate,8280,5,3,5,6,14,20,-6,14
FC Botosani,8280,6,3,4,7,7,17,-10,13
FCSB,8281,1,9,5,0,31,11,20,32
CFR Cluj,8281,2,6,6,2,16,12,4,24
FC Botosani,8281,3,4,5,5,8,13,-5,17
D Bucuresti,8281,4,3,6,5,19,21,-2,15
Universitate,8281,5,3,5,6,16,25,-9,14
Concordia Ch,8281,6,2,3,9,17,25,-8,9
FCSB,8282,1,7,7,0,25,12,13,28
CFR Cluj,8282,2,5,8,1,15,9,6,23
D Bucuresti,8282,3,5,4,5,22,21,1,19
Universitate,8282,4,3,7,4,16,20,-4,16
FC Botosani,8282,5,3,5,6,9,18,-9,14
Concordia Ch,8282,6,2,3,9,16,23,-7,9
FCSB,8283,1,7,6,1,26,14,12,27
CFR Cluj,8283,2,6,7,1,15,8,7,25
FC Botosani,8283,3,5,4,5,11,14,-3,19
Universitate,8283,4,3,7,4,16,20,-4,16
D Bucuresti,8283,5,3,4,7,18,22,-4,13
Concordia Ch,8283,6,3,2,9,18,26,-8,11
FCSB,8284,1,7,5,2,23,12,11,26
CFR Cluj,8284,2,6,7,1,15,8,7,25
Universitate,8284,3,4,6,4,16,19,-3,18
D Bucuresti,8284,4,4,4,6,17,19,-2,16
FC Botosani,8284,5,4,4,6,6,14,-8,16
Concordia Ch,8284,6,3,2,9,17,22,-5,11
FCSB,8285,1,8,5,1,27,15,12,29
CFR Cluj,8285,2,6,6,2,15,9,6,24
D Bucuresti,8285,3,4,5,5,19,20,-1,17
Universitate,8285,4,4,5,5,18,21,-3,17
FC Botosani,8285,5,4,4,6,8,14,-6,16
Concordia Ch,8285,6,2,3,9,16,24,-8,9
CFR Cluj,8286,1,7,6,1,17,7,10,27
FCSB,8286,2,7,5,2,23,14,9,26
D Bucuresti,8286,3,4,5,5,18,18,0,17
Universitate,8286,4,4,5,5,15,19,-4,17
FC Botosani,8286,5,3,4,7,5,18,-13,13
Concordia Ch,8286,6,3,3,8,19,21,-2,12
FCSB,8287,1,8,6,0,25,11,14,30
CFR Cluj,8287,2,5,7,2,14,9,5,22
FC Botosani,8287,3,4,5,5,8,13,-5,17
Universitate,8287,4,3,7,4,16,20,-4,16
D Bucuresti,8287,5,3,6,5,17,19,-2,15
Concordia Ch,8287,6,2,3,9,17,25,-8,9
FCSB,8288,1,8,5,1,24,13,11,29
CFR Cluj,8288,2,5,6,3,14,10,4,21
Universitate,8288,3,5,5,4,19,19,0,20
D Bucuresti,8288,4,4,4,6,18,20,-2,16
FC Botosani,8288,5,4,4,6,8,15,-7,16
Concordia Ch,8288,6,3,2,9,17,23,-6,11
FCSB,8289,1,9,5,0,28,11,17,32
CFR Cluj,8289,2,6,6,2,16,10,6,24
FC Botosani,8289,3,4,5,5,8,13,-5,17
D Bucuresti,8289,4,4,4,6,18,21,-3,16
Universitate,8289,5,3,5,6,14,22,-8,14
Concordia Ch,8289,6,2,3,9,15,22,-7,9
FCSB,8290,1,7,5,2,24,13,11,26
CFR Cluj,8290,2,6,6,2,15,9,6,24
Universitate,8290,3,5,5,4,16,18,-2,20
D Bucuresti,8290,4,4,4,6,21,22,-1,16
FC Botosani,8290,5,3,5,6,6,15,-9,14
Concordia Ch,8290,6,3,3,8,18,23,-5,12
FCSB,8291,1,8,6,0,26,12,14,30
CFR Cluj,8291,2,6,6,2,14,8,6,24
FC Botosani,8291,3,5,4,5,8,13,-5,19
Universitate,8291,4,3,6,5,16,21,-5,15
D Bucuresti,8291,5,3,5,6,19,22,-3,14
Concordia Ch,8291,6,2,3,9,17,24,-7,9
FCSB,8292,1,7,7,0,24,11,13,28
CFR Cluj,8292,2,6,7,1,18,8,10,25
FC Botosani,8292,3,4,4,6,6,14,-8,16
Universitate,8292,4,3,6,5,14,22,-8,15
Concordia Ch,8292,5,4,2,8,19,22,-3,14
D Bucuresti,8292,6,3,4,7,17,21,-4,13
FCSB,8293,1,7,7,0,25,12,13,28
CFR Cluj,8293,2,5,7,2,14,9,5,22
Universitate,8293,3,4,6,4,16,19,-3,18
FC Botosani,8293,4,4,4,6,7,14,-7,16
D Bucuresti,8293,5,3,5,6,16,20,-4,14
Concordia Ch,8293,6,3,3,8,17,21,-4,12
FCSB,8294,1,8,6,0,26,10,16,30
CFR Cluj,8294,2,5,7,2,14,9,5,22
D Bucuresti,8294,3,4,5,5,18,19,-1,17
Universitate,8294,4,4,5,5,16,22,-6,17
FC Botosani,8294,5,3,5,6,6,15,-9,14
Concordia Ch,8294,6,3,2,9,19,24,-5,11
FCSB,8295,1,7,6,1,24,12,12,27
CFR Cluj,8295,2,6,6,2,14,8,6,24
Universitate,8295,3,4,6,4,16,19,-3,18
D Bucuresti,8295,4,4,4,6,21,23,-2,16
Concordia Ch,8295,5,4,2,8,22,24,-2,14
FC Botosani,8295,6,3,4,7,8,19,-11,13
FCSB,8296,1,7,7,0,27,14,13,28
CFR Cluj,8296,2,6,7,1,17,8,9,25
D Bucuresti,8296,3,4,4,6,18,22,-4,16
Universitate,8296,4,3,6,5,17,24,-7,15
FC Botosani,8296,5,3,5,6,6,14,-8,14
Concordia Ch,8296,6,3,3,8,20,23,-3,12
FCSB,8297,1,8,6,0,25,11,14,30
CFR Cluj,8297,2,5,8,1,15,9,6,23
FC Botosani,8297,3,4,5,5,7,13,-6,17
Universitate,8297,4,3,6,5,17,22,-5,15
D Bucuresti,8297,5,3,5,6,17,20,-3,14
Concordia Ch,8297,6,3,2,9,18,24,-6,11
FCSB,8298,1,8,6,0,28,13,15,30
CFR Cluj,8298,2,6,6,2,16,10,6,24
FC Botosani,8298,3,5,4,5,9,12,-3,19
Universitate,8298,4,3,6,5,18,24,-6,15
D Bucuresti,8298,5,3,5,6,17,20,-3,14
Concordia Ch,8298,6,2,3,9,16,25,-9,9
FCSB,8299,1,8,6,0,25,10,15,30
CFR Cluj,8299,2,5,7,2,14,10,4,22
FC Botosani,8299,3,4,5,5,7,13,-6,17
Universitate,8299,4,3,7,4,15,19,-4,16
D Bucuresti,8299,5,3,6,5,16,18,-2,15
Concordia Ch,8299,6,2,3,9,16,23,-7,9
FCSB,8300,1,8,6,0,26,10,16,30
CFR Cluj,8300,2,5,8,1,14,8,6,23
D Bucuresti,8300,3,3,6,5,18,20,-2,15
Universitate,8300,4,3,6,5,15,22,-7,15
FC Botosani,8300,5,3,5,6,7,15,-8,14
Concordia Ch,8300,6,3,3,8,18,23,-5,12
FCSB,8301,1,7,7,0,25,12,13,28
CFR Cluj,8301,2,6,7,1,16,9,7,25
FC Botosani,8301,3,4,5,5,10,13,-3,17
Universitate,8301,4,3,6,5,16,21,-5,15
D Bucuresti,8301,5,3,5,6,17,22,-5,14
Concordia Ch,8301,6,3,2,9,18,25,-7,11
FCSB,8302,1,9,5,0,27,11,16,32
CFR Cluj,8302,2,6,6,2,15,8,7,24
D Bucuresti,8302,3,4,4,6,18,21,-3,16
Concordia Ch,8302,4,4,2,8,19,22,-3,14
Universitate,8302,5,3,5,6,15,23,-8,14
FC Botosani,8302,6,3,4,7,7,16,-9,13
FCSB,8303,1,8,5,1,25,12,13,29
CFR Cluj,8303,2,7,6,1,16,8,8,27
D Bucuresti,8303,3,4,4,6,20,20,0,16
Concordia Ch,8303,4,4,2,8,18,22,-4,14
Universitate,8303,5,3,5,6,16,22,-6,14
FC Botosani,8303,6,3,4,7,5,16,-11,13
FCSB,8304,1,9,5,0,26,11,15,32
CFR Cluj,8304,2,6,6,2,16,10,6,24
D Bucuresti,8304,3,5,4,5,20,19,1,19
Universitate,8304,4,3,5,6,15,21,-6,14
FC Botosani,8304,5,3,5,6,6,15,-9,14
Concordia Ch,8304,6,2,3,9,17,24,-7,9
FCSB,8305,1,8,6,0,26,12,14,30
CFR Cluj,8305,2,5,8,1,15,9,6,23
D Bucuresti,8305,3,3,6,5,19,21,-2,15
Universitate,8305,4,3,6,5,14,19,-5,15
FC Botosani,8305,5,3,6,5,6,13,-7,15
Concordia Ch,8305,6,2,4,8,17,23,-6,10
FCSB,8306,1,8,6,0,25,11,14,30
CFR Cluj,8306,2,5,7,2,14,9,5,22
FC Botosani,8306,3,5,4,5,8,12,-4,19
Universitate,8306,4,4,5,5,15,19,-4,17
D Bucuresti,8306,5,3,5,6,18,21,-3,14
Concordia Ch,8306,6,2,3,9,17,25,-8,9
FCSB,8307,1,8,5,1,24,13,11,29
CFR Cluj,8307,2,6,6,2,16,9,7,24
D Bucuresti,8307,3,5,4,5,20,19,1,19
Universitate,8307,4,4,5,5,18,21,-3,17
FC Botosani,8307,5,3,4,7,6,15,-9,13
Concordia Ch,8307,6,3,2,9,16,23,-7,11
FCSB,8308,1,8,6,0,25,10,15,30
CFR Cluj,8308,2,6,6,2,15,10,5,24
D Bucuresti,8308,3,4,4,6,17,20,-3,16
FC Botosani,8308,4,4,4,6,8,13,-5,16
Universitate,8308,5,3,6,5,15,20,-5,15
Concordia Ch,8308,6,3,2,9,17,24,-7,11
FCSB,8309,1,8,5,1,26,13,13,29
CFR Cluj,8309,2,5,6,3,14,10,4,21
Universitate,8309,3,5,5,4,19,21,-2,20
D Bucuresti,8309,4,4,4,6,21,25,-4,16
FC Botosani,8309,5,3,5,6,9,17,-8,14
Concordia Ch,8309,6,3,3,8,22,25,-3,12
FCSB,8310,1,7,6,1,24,12,12,27
CFR Cluj,8310,2,5,8,1,15,9,6,23
Universitate,8310,3,4,6,4,16,19,-3,18
D Bucuresti,8310,4,4,5,5,19,20,-1,17
FC Botosani,8310,5,3,5,6,8,16,-8,14
Concordia Ch,8310,6,2,4,8,20,26,-6,10
FCSB,8311,1,8,6,0,24,10,14,30
CFR Cluj,8311,2,5,7,2,14,9,5,22
D Bucuresti,8311,3,4,5,5,21,22,-1,17
FC Botosani,8311,4,4,5,5,9,14,-5,17
Universitate,8311,5,3,7,4,15,19,-4,16
Concordia Ch,8311,6,2,2,10,17,26,-9,8
FCSB,8312,1,7,5,2,24,15,9,26
CFR Cluj,8312,2,6,6,2,16,10,6,24
Universitate,8312,3,5,5,4,19,19,0,20
D Bucuresti,8312,4,5,4,5,23,21,2,19
FC Botosani,8312,5,3,5,6,8,17,-9,14
Concordia Ch,8312,6,2,3,9,19,27,-8,9
FCSB,8313,1,8,6,0,27,13,14,30
CFR Cluj,8313,2,6,7,1,17,9,8,25
D Bucuresti,8313,3,4,5,5,17,18,-1,17
Universitate,8313,4,3,5,6,15,22,-7,14
FC Botosani,8313,5,3,5,6,6,14,-8,14
Concordia Ch,8313,6,3,2,9,17,23,-6,11
FCSB,8314,1,8,6,0,28,14,14,30
CFR Cluj,8314,2,5,7,2,15,10,5,22
Universitate,8314,3,4,5,5,17,21,-4,17
D Bucuresti,8314,4,4,4,6,17,20,-3,16
FC Botosani,8314,5,4,4,6,6,13,-7,16
Concordia Ch,8314,6,3,2,9,17,22,-5,11
CFR Cluj,8315,1,7,6,1,18,8,10,27
FCSB,8315,2,7,5,2,23,12,11,26
FC Botosani,8315,3,4,5,5,9,14,-5,17
Universitate,8315,4,4,5,5,16,22,-6,17
D Bucuresti,8315,5,3,5,6,17,21,-4,14
Concordia Ch,8315,6,3,2,9,18,24,-6,11
FCSB,8316,1,8,5,1,26,15,11,29
CFR Cluj,8316,2,6,6,2,17,10,7,24
Universitate,8316,3,4,5,5,18,21,-3,17
D Bucuresti,8316,4,3,6,5,17,19,-2,15
FC Botosani,8316,5,3,5,6,5,13,-8,14
Concordia Ch,8316,6,3,3,8,17,22,-5,12
FCSB,8317,1,8,6,0,26,10,16,30
CFR Cluj,8317,2,5,7,2,13,8,5,22
Universitate,8317,3,4,5,5,15,21,-6,17
Concordia Ch,8317,4,4,2,8,21,21,0,14
D Bucuresti,8317,5,3,5,6,16,19,-3,14
FC Botosani,8317,6,3,5,6,5,17,-12,14
FCSB,8318,1,8,6,0,26,11,15,30
CFR Cluj,8318,2,5,8,1,16,10,6,23
FC Botosani,8318,3,5,4,5,8,13,-5,19
Universitate,8318,4,3,6,5,16,22,-6,15
D Bucuresti,8318,5,3,5,6,16,19,-3,14
Concordia Ch,8318,6,2,3,9,16,23,-7,9
FCSB,8319,1,7,6,1,23,13,10,27
CFR Cluj,8319,2,6,6,2,16,8,8,24
Universitate,8319,3,4,6,4,15,18,-3,18
D Bucuresti,8319,4,4,5,5,19,18,1,17
FC Botosani,8319,5,3,4,7,6,19,-13,13
Concordia Ch,8319,6,3,3,8,19,22,-3,12
FCSB,8320,1,8,6,0,28,13,15,30
CFR Cluj,8320,2,6,7,1,16,9,7,25
FC Botosani,8320,3,3,6,5,6,13,-7,15
D Bucuresti,8320,4,3,5,6,16,19,-3,14
Universitate,8320,5,3,5,6,15,22,-7,14
Concordia Ch,8320,6,3,3,8,17,22,-5,12
CFR Cluj,8321,1,7,6,1,17,8,9,27
FCSB,8321,2,7,5,2,24,13,11,26
D Bucuresti,8321,3,5,4,5,19,18,1,19
Universitate,8321,4,4,5,5,15,20,-5,17
FC Botosani,8321,5,3,4,7,5,15,-10,13
Concordia Ch,8321,6,3,2,9,17,23,-6,11
FCSB,8322,1,7,7,0,27,14,13,28
CFR Cluj,8322,2,6,7,1,17,10,7,25
D Bucuresti,8322,3,4,4,6,18,21,-3,16
FC Botosani,8322,4,4,4,6,6,14,-8,16
Universitate,8322,5,3,6,5,17,22,-5,15
Concordia Ch,8322,6,3,2,9,18,22,-4,11
FCSB,8323,1,7,5,2,23,13,10,26
CFR Cluj,8323,2,6,6,2,16,10,6,24
Universitate,8323,3,5,5,4,18,19,-1,20
D Bucuresti,8323,4,4,4,6,17,20,-3,16
Concordia Ch,8323,5,4,2,8,20,22,-2,14
FC Botosani,8323,6,3,4,7,6,16,-10,13
FCSB,8324,1,8,6,0,25,11,14,30
CFR Cluj,8324,2,5,7,2,14,9,5,22
FC Botosani,8324,3,5,4,5,8,12,-4,19
D Bucuresti,8324,4,4,4,6,19,20,-1,16
Universitate,8324,5,3,7,4,16,20,-4,16
Concordia Ch,8324,6,2,2,10,16,26,-10,8
FCSB,8325,1,7,7,0,26,13,13,28
CFR Cluj,8325,2,5,8,1,14,8,6,23
D Bucuresti,8325,3,5,4,5,19,19,0,19
Universitate,8325,4,3,7,4,16,20,-4,16
FC Botosani,8325,5,4,4,6,6,13,-7,16
Concordia Ch,8325,6,2,2,10,16,24,-8,8
FCSB,8326,1,8,5,1,26,11,15,29
CFR Cluj,8326,2,7,6,1,16,8,8,27
D Bucuresti,8326,3,4,5,5,20,19,1,17
Universitate,8326,4,3,5,6,15,23,-8,14
FC Botosani,8326,5,3,5,6,5,15,-10,14
Concordia Ch,8326,6,2,4,8,16,22,-6,10
FCSB,8327,1,7,6,1,25,13,12,27
CFR Cluj,8327,2,6,7,1,15,8,7,25
FC Botosani,8327,3,4,5,5,7,12,-5,17
Universitate,8327,4,3,7,4,15,19,-4,16
D Bucuresti,8327,5,3,5,6,16,19,-3,14
Concordia Ch,8327,6,3,2,9,16,23,-7,11
FCSB,8328,1,8,6,0,27,12,15,30
CFR Cluj,8328,2,5,8,1,16,10,6,23
FC Botosani,8328,3,4,5,5,7,13,-6,17
Universitate,8328,4,3,6,5,15,21,-6,15
D Bucuresti,8328,5,3,5,6,17,20,-3,14
Concordia Ch,8328,6,3,2,9,16,22,-6,11
FCSB,8329,1,9,5,0,27,10,17,32
CFR Cluj,8329,2,5,7,2,14,10,4,22
D Bucuresti,8329,3,4,4,6,18,20,-2,16
FC Botosani,8329,4,4,4,6,8,15,-7,16
Universitate,8329,5,3,6,5,15,21,-6,15
Concordia Ch,8329,6,3,2,9,17,23,-6,11
FCSB,8330,1,9,5,0,29,13,16,32
CFR Cluj,8330,2,6,6,2,16,11,5,24
FC Botosani,8330,3,4,4,6,7,15,-8,16
Concordia Ch,8330,4,4,2,8,21,22,-1,14
Universitate,8330,5,3,5,6,15,21,-6,14
D Bucuresti,8330,6,3,4,7,18,24,-6,13
FCSB,8331,1,7,6,1,24,14,10,27
CFR Cluj,8331,2,6,7,1,16,9,7,25
Universitate,8331,3,4,5,5,18,20,-2,17
D Bucuresti,8331,4,3,6,5,17,19,-2,15
FC Botosani,8331,5,3,6,5,6,13,-7,15
Concordia Ch,8331,6,2,4,8,17,23,-6,10
FCSB,8332,1,9,5,0,25,10,15,32
CFR Cluj,8332,2,6,6,2,16,10,6,24
D Bucuresti,8332,3,4,4,6,21,23,-2,16
FC Botosani,8332,4,4,4,6,8,16,-8,16
Universitate,8332,5,3,5,6,16,22,-6,14
Concordia Ch,8332,6,3,2,9,19,24,-5,11
FCSB,8333,1,9,5,0,28,10,18,32
CFR Cluj,8333,2,6,6,2,15,8,7,24
D Bucuresti,8333,3,4,4,6,18,21,-3,16
FC Botosani,8333,4,4,4,6,9,14,-5,16
Universitate,8333,5,3,5,6,14,24,-10,14
Concordia Ch,8333,6,3,2,9,19,26,-7,11
FCSB,8334,1,8,6,0,27,11,16,30
CFR Cluj,8334,2,6,6,2,16,12,4,24
D Bucuresti,8334,3,5,4,5,20,18,2,19
FC Botosani,8334,4,4,4,6,7,13,-6,16
Universitate,8334,5,3,6,5,17,22,-5,15
Concordia Ch,8334,6,2,2,10,15,26,-11,8
CFR Cluj,8335,1,7,6,1,16,8,8,27
FCSB,8335,2,7,5,2,23,12,11,26
D Bucuresti,8335,3,4,5,5,19,20,-1,17
Universitate,8335,4,4,5,5,16,20,-4,17
FC Botosani,8335,5,3,5,6,7,15,-8,14
Concordia Ch,8335,6,2,4,8,17,23,-6,10
FCSB,8336,1,7,7,0,26,13,13,28
CFR Cluj,8336,2,5,7,2,14,9,5,22
D Bucuresti,8336,3,5,4,5,20,19,1,19
Universitate,8336,4,4,6,4,17,20,-3,18
FC Botosani,8336,5,3,5,6,6,15,-9,14
Concordia Ch,8336,6,2,3,9,15,22,-7,9
FCSB,8337,1,9,5,0,27,12,15,32
CFR Cluj,8337,2,5,6,3,15,11,4,21
Universitate,8337,3,4,5,5,15,19,-4,17
D Bucuresti,8337,4,4,4,6,18,20,-2,16
FC Botosani,8337,5,4,4,6,7,13,-6,16
Concordia Ch,8337,6,3,2,9,17,24,-7,11
FCSB,8338,1,8,5,1,27,11,16,29
CFR Cluj,8338,2,6,6,2,15,12,3,24
Universitate,8338,3,4,5,5,16,20,-4,17
D Bucuresti,8338,4,4,4,6,18,20,-2,16
FC Botosani,8338,5,3,5,6,7,15,-8,14
Concordia Ch,8338,6,3,3,8,19,24,-5,12
CFR Cluj,8339,1,7,6,1,18,7,11,27
FCSB,8339,2,7,5,2,23,12,11,26
D Bucuresti,8339,3,5,4,5,19,18,1,19
Universitate,8339,4,4,5,5,15,22,-7,17
FC Botosani,8339,5,3,4,7,6,16,-10,13
Concordia Ch,8339,6,3,2,9,17,23,-6,11
FCSB,8340,1,9,5,0,26,10,16,32
CFR Cluj,8340,2,5,6,3,14,10,4,21
D Bucuresti,8340,3,4,5,5,20,19,1,17
Universitate,8340,4,4,5,5,16,21,-5,17
FC Botosani,8340,5,4,4,6,7,16,-9,16
Concordia Ch,8340,6,2,3,9,17,24,-7,9
FCSB,8341,1,8,6,0,25,11,14,30
CFR Cluj,8341,2,6,6,2,17,8,9,24
D Bucuresti,8341,3,4,4,6,19,23,-4,16
Universitate,8341,4,3,6,5,15,23,-8,15
Concordia Ch,8341,5,4,2,8,20,21,-1,14
FC Botosani,8341,6,3,4,7,6,16,-10,13
FCSB,8342,1,8,6,0,25,11,14,30
CFR Cluj,8342,2,5,8,1,13,7,6,23
Universitate,8342,3,3,6,5,15,20,-5,15
Concordia Ch,8342,4,4,2,8,20,22,-2,14
D Bucuresti,8342,5,3,5,6,17,20,-3,14
FC Botosani,8342,6,3,5,6,5,15,-10,14
FCSB,8343,1,8,6,0,25,11,14,30
CFR Cluj,8343,2,5,7,2,13,8,5,22
D Bucuresti,8343,3,4,4,6,19,20,-1,16
Universitate,8343,4,3,7,4,15,19,-4,16
FC Botosani,8343,5,4,4,6,6,14,-8,16
Concordia Ch,8343,6,3,2,9,17,23,-6,11
FCSB,8344,1,9,5,0,28,12,16,32
CFR Cluj,8344,2,5,6,3,15,12,3,21
D Bucuresti,8344,3,5,4,5,21,19,2,19
Universitate,8344,4,4,5,5,18,22,-4,17
FC Botosani,8344,5,3,4,7,5,15,-10,13
Concordia Ch,8344,6,3,2,9,17,24,-7,11
FCSB,8345,1,9,5,0,27,12,15,32
CFR Cluj,8345,2,5,7,2,14,9,5,22
D Bucuresti,8345,3,4,4,6,19,20,-1,16
Universitate,8345,4,3,6,5,15,20,-5,15
Concordia Ch,8345,5,4,2,8,20,21,-1,14
FC Botosani,8345,6,3,4,7,6,19,-13,13
CFR Cluj,8346,1,7,6,1,16,7,9,27
FCSB,8346,2,7,5,2,26,16,10,26
FC Botosani,8346,3,5,4,5,10,14,-4,19
Universitate,8346,4,4,5,5,19,23,-4,17
D Bucuresti,8346,5,3,4,7,19,24,-5,13
Concordia Ch,8346,6,3,2,9,17,23,-6,11
FCSB,8347,1,8,5,1,24,11,13,29
CFR Cluj,8347,2,6,7,1,14,7,7,25
D Bucuresti,8347,3,3,6,5,16,18,-2,15
Universitate,8347,4,3,6,5,14,19,-5,15
FC Botosani,8347,5,3,6,5,5,12,-7,15
Concordia Ch,8347,6,2,4,8,15,21,-6,10
FCSB,8348,1,8,5,1,24,11,13,29
CFR Cluj,8348,2,6,6,2,16,10,6,24
Universitate,8348,3,4,5,5,17,21,-4,17
D Bucuresti,8348,4,4,4,6,20,22,-2,16
FC Botosani,8348,5,4,4,6,8,16,-8,16
Concordia Ch,8348,6,3,2,9,18,23,-5,11
FCSB,8349,1,9,5,0,26,11,15,32
CFR Cluj,8349,2,6,6,2,16,8,8,24
D Bucuresti,8349,3,4,5,5,18,19,-1,17
Universitate,8349,4,3,5,6,15,23,-8,14
FC Botosani,8349,5,3,5,6,6,14,-8,14
Concordia Ch,8349,6,2,4,8,17,23,-6,10
FCSB,8350,1,8,6,0,24,10,14,30
CFR Cluj,8350,2,5,8,1,13,7,6,23
D Bucuresti,8350,3,5,4,5,21,19,2,19
FC Botosani,8350,4,4,4,6,6,13,-7,16
Universitate,8350,5,3,6,5,14,19,-5,15
Concordia Ch,8350,6,2,2,10,16,26,-10,8
FCSB,8351,1,8,5,1,25,12,13,29
CFR Cluj,8351,2,5,7,2,14,9,5,22
Universitate,8351,3,4,6,4,15,18,-3,18
D Bucuresti,8351,4,4,5,5,18,18,0,17
FC Botosani,8351,5,4,4,6,7,14,-7,16
Concordia Ch,8351,6,2,3,9,15,23,-8,9
FCSB,8352,1,7,6,1,23,11,12,27
CFR Cluj,8352,2,7,6,1,16,7,9,27
FC Botosani,8352,3,5,4,5,9,12,-3,19
D Bucuresti,8352,4,4,4,6,20,22,-2,16
Universitate,8352,5,3,6,5,14,20,-6,15
Concordia Ch,8352,6,2,2,10,17,27,-10,8
FCSB,8353,1,8,5,1,25,11,14,29
CFR Cluj,8353,2,6,7,1,14,7,7,25
D Bucuresti,8353,3,4,5,5,19,20,-1,17
FC Botosani,8353,4,4,5,5,7,13,-6,17
Universitate,8353,5,3,6,5,14,20,-6,15
Concordia Ch,8353,6,2,2,10,16,24,-8,8
FCSB,8354,1,9,5,0,26,10,16,32
CFR Cluj,8354,2,5,6,3,13,10,3,21
Universitate,8354,3,4,5,5,16,20,-4,17
FC Botosani,8354,4,4,5,5,7,13,-6,17
D Bucuresti,8354,5,4,4,6,20,19,1,16
Concordia Ch,8354,6,2,3,9,16,26,-10,9
FCSB,8355,1,8,6,0,28,13,15,30
CFR Cluj,8355,2,5,8,1,16,10,6,23
D Bucuresti,8355,3,4,4,6,18,20,-2,16
Universitate,8355,4,3,6,5,14,20,-6,15
FC Botosani,8355,5,3,5,6,6,14,-8,14
Concordia Ch,8355,6,3,3,8,18,23,-5,12
FCSB,8356,1,8,5,1,26,13,13,29
CFR Cluj,8356,2,6,6,2,18,11,7,24
Universitate,8356,3,4,5,5,18,23,-5,17
FC Botosani,8356,4,4,5,5,9,14,-5,17
D Bucuresti,8356,5,3,6,5,17,19,-2,15
Concordia Ch,8356,6,2,3,9,16,24,-8,9
FCSB,8357,1,8,6,0,25,11,14,30
CFR Cluj,8357,2,6,7,1,15,7,8,25
FC Botosani,8357,3,4,5,5,7,13,-6,17
D Bucuresti,8357,4,3,5,6,17,23,-6,14
Universitate,8357,5,3,5,6,15,22,-7,14
Concordia Ch,8357,6,3,2,9,19,22,-3,11
FCSB,8358,1,8,5,1,26,12,14,29
CFR Cluj,8358,2,6,6,2,16,10,6,24
D Bucuresti,8358,3,4,5,5,18,19,-1,17
Universitate,8358,4,4,5,5,17,22,-5,17
FC Botosani,8358,5,3,6,5,6,13,-7,15
Concordia Ch,8358,6,2,3,9,15,22,-7,9
FCSB,8359,1,7,6,1,23,11,12,27
CFR Cluj,8359,2,7,6,1,15,7,8,27
FC Botosani,8359,3,5,4,5,9,13,-4,19
Universitate,8359,4,3,6,5,14,19,-5,15
D Bucuresti,8359,5,3,4,7,18,23,-5,13
Concordia Ch,8359,6,3,2,9,18,24,-6,11
FCSB,8360,1,8,5,1,27,12,15,29
CFR Cluj,8360,2,5,6,3,13,11,2,21
Universitate,8360,3,5,5,4,17,19,-2,20
FC Botosani,8360,4,4,5,5,8,13,-5,17
D Bucuresti,8360,5,3,4,7,17,23,-6,13
Concordia Ch,8360,6,3,3,8,19,23,-4,12
FCSB,8361,1,9,5,0,26,10,16,32
CFR Cluj,8361,2,5,6,3,13,10,3,21
D Bucuresti,8361,3,4,5,5,21,20,1,17
Universitate,8361,4,4,5,5,16,20,-4,17
FC Botosani,8361,5,3,5,6,6,14,-8,14
Concordia Ch,8361,6,3,2,9,17,25,-8,11
FCSB,8362,1,7,6,1,24,13,11,27
CFR Cluj,8362,2,5,8,1,13,7,6,23
D Bucuresti,8362,3,5,4,5,20,19,1,19
Universitate,8362,4,4,6,4,17,19,-2,18
FC Botosani,8362,5,4,4,6,8,13,-5,16
Concordia Ch,8362,6,2,2,10,16,27,-11,8
FCSB,8363,1,9,5,0,28,12,16,32
CFR Cluj,8363,2,6,6,2,16,9,7,24
D Bucuresti,8363,3,5,4,5,21,19,2,19
FC Botosani,8363,4,4,4,6,9,16,-7,16
Universitate,8363,5,3,5,6,15,23,-8,14
Concordia Ch,8363,6,2,2,10,18,28,-10,8
FCSB,8364,1,8,5,1,26,16,10,29
CFR Cluj,8364,2,6,6,2,19,10,9,24
D Bucuresti,8364,3,4,5,5,20,21,-1,17
Universitate,8364,4,4,5,5,19,23,-4,17
FC Botosani,8364,5,3,5,6,6,14,-8,14
Concordia Ch,8364,6,2,4,8,17,23,-6,10
FCSB,8365,1,7,6,1,27,16,11,27
CFR Cluj,8365,2,6,7,1,17,9,8,25
FC Botosani,8365,3,5,4,5,8,12,-4,19
Universitate,8365,4,4,5,5,18,22,-4,17
D Bucuresti,8365,5,4,4,6,18,19,-1,16
Concordia Ch,8365,6,2,2,10,15,25,-10,8
FCSB,8366,1,8,5,1,27,14,13,29
CFR Cluj,8366,2,6,7,1,15,8,7,25
Universitate,8366,3,3,6,5,16,21,-5,15
FC Botosani,8366,4,3,6,5,7,14,-7,15
D Bucuresti,8366,5,3,5,6,19,23,-4,14
Concordia Ch,8366,6,3,3,8,18,22,-4,12
FCSB,8367,1,8,6,0,25,11,14,30
CFR Cluj,8367,2,5,7,2,13,8,5,22
D Bucuresti,8367,3,4,5,5,22,22,0,17
Universitate,8367,4,4,5,5,16,20,-4,17
FC Botosani,8367,5,3,5,6,8,17,-9,14
Concordia Ch,8367,6,3,2,9,18,24,-6,11
FCSB,8368,1,7,7,0,24,11,13,28
CFR Cluj,8368,2,5,7,2,17,12,5,22
Universitate,8368,3,4,6,4,18,21,-3,18
D Bucuresti,8368,4,4,5,5,21,22,-1,17
FC Botosani,8368,5,3,6,5,7,14,-7,15
Concordia Ch,8368,6,2,3,9,17,24,-7,9
FCSB,8369,1,7,7,0,24,11,13,28
CFR Cluj,8369,2,6,7,1,18,8,10,25
D Bucuresti,8369,3,4,4,6,20,22,-2,16
FC Botosani,8369,4,4,4,6,7,13,-6,16
Universitate,8369,5,3,6,5,16,24,-8,15
Concordia Ch,8369,6,3,2,9,18,25,-7,11
FCSB,8370,1,7,7,0,24,11,13,28
CFR Cluj,8370,2,6,7,1,16,7,9,25
FC Botosani,8370,3,5,4,5,8,13,-5,19
D Bucuresti,8370,4,4,4,6,20,19,1,16
Universitate,8370,5,3,6,5,15,22,-7,15
Concordia Ch,8370,6,2,2,10,16,27,-11,8
FCSB,8371,1,8,5,1,25,14,11,29
CFR Cluj,8371,2,6,6,2,14,8,6,24
Universitate,8371,3,4,5,5,18,20,-2,17
D Bucuresti,8371,4,4,4,6,18,19,-1,16
Concordia Ch,8371,5,4,2,8,18,21,-3,14
FC Botosani,8371,6,3,4,7,5,16,-11,13
FCSB,8372,1,8,6,0,24,10,14,30
CFR Cluj,8372,2,5,7,2,13,8,5,22
D Bucuresti,8372,3,4,5,5,19,19,0,17
Universitate,8372,4,4,5,5,15,19,-4,17
FC Botosani,8372,5,4,5,5,9,14,-5,17
Concordia Ch,8372,6,2,2,10,16,26,-10,8
FCSB,8373,1,7,7,0,24,11,13,28
CFR Cluj,8373,2,5,7,2,13,8,5,22
Universitate,8373,3,4,6,4,16,19,-3,18
D Bucuresti,8373,4,4,4,6,20,23,-3,16
FC Botosani,8373,5,4,4,6,8,13,-5,16
Concordia Ch,8373,6,3,2,9,18,25,-7,11
FCSB,8374,1,9,5,0,26,10,16,32
CFR Cluj,8374,2,5,6,3,14,10,4,21
Universitate,8374,3,4,5,5,16,21,-5,17
D Bucuresti,8374,4,3,5,6,17,20,-3,14
Concordia Ch,8374,5,4,2,8,17,21,-4,14
FC Botosani,8374,6,3,5,6,6,14,-8,14
FCSB,8375,1,9,5,0,30,11,19,32
CFR Cluj,8375,2,6,6,2,15,10,5,24
D Bucuresti,8375,3,4,5,5,18,19,-1,17
Universitate,8375,4,3,5,6,15,24,-9,14
FC Botosani,8375,5,3,4,7,5,14,-9,13
Concordia Ch,8375,6,3,3,8,17,22,-5,12
FCSB,8376,1,8,5,1,24,12,12,29
CFR Cluj,8376,2,7,6,1,16,7,9,27
D Bucuresti,8376,3,4,4,6,19,21,-2,16
Concordia Ch,8376,4,4,2,8,18,22,-4,14
Universitate,8376,5,3,5,6,14,20,-6,14
FC Botosani,8376,6,3,4,7,6,15,-9,13
FCSB,8377,1,9,5,0,25,10,15,32
CFR Cluj,8377,2,6,6,2,18,9,9,24
D Bucuresti,8377,3,4,4,6,21,22,-1,16
FC Botosani,8377,4,4,4,6,7,15,-8,16
Universitate,8377,5,3,5,6,15,24,-9,14
Concordia Ch,8377,6,3,2,9,20,26,-6,11
FCSB,8378,1,9,5,0,25,10,15,32
CFR Cluj,8378,2,5,6,3,13,9,4,21
Universitate,8378,3,4,5,5,15,19,-4,17
D Bucuresti,8378,4,4,4,6,19,21,-2,16
FC Botosani,8378,5,4,4,6,9,16,-7,16
Concordia Ch,8378,6,3,2,9,17,23,-6,11
FCSB,8379,1,8,6,0,25,11,14,30
CFR Cluj,8379,2,6,7,1,15,7,8,25
FC Botosani,8379,3,4,5,5,6,12,-6,17
Universitate,8379,4,3,5,6,15,22,-7,14
D Bucuresti,8379,5,3,4,7,16,21,-5,13
Concordia Ch,8379,6,3,3,8,17,21,-4,12
FCSB,8380,1,8,5,1,25,12,13,29
CFR Cluj,8380,2,7,6,1,15,7,8,27
D Bucuresti,8380,3,4,5,5,18,18,0,17
FC Botosani,8380,4,3,6,5,5,12,-7,15
Universitate,8380,5,3,5,6,15,21,-6,14
Concordia Ch,8380,6,2,3,9,15,23,-8,9
FCSB,8381,1,9,5,0,28,10,18,32
CFR Cluj,8381,2,6,6,2,17,9,8,24
D Bucuresti,8381,3,3,5,6,17,20,-3,14
Concordia Ch,8381,4,4,2,8,19,23,-4,14
FC Botosani,8381,5,3,5,6,6,14,-8,14
Universitate,8381,6,3,5,6,14,25,-11,14
FCSB,8382,1,7,6,1,26,14,12,27
CFR Cluj,8382,2,6,7,1,17,9,8,25
Universitate,8382,3,4,5,5,18,23,-5,17
FC Botosani,8382,4,4,4,6,9,16,-7,16
Concordia Ch,8382,5,4,2,8,19,23,-4,14
D Bucuresti,8382,6,3,4,7,17,21,-4,13
FCSB,8383,1,7,5,2,24,13,11,26
CFR Cluj,8383,2,6,7,1,15,8,7,25
Universitate,8383,3,4,6,4,17,20,-3,18
FC Botosani,8383,4,4,4,6,6,13,-7,16
Concordia Ch,8383,5,4,2,8,18,22,-4,14
D Bucuresti,8383,6,3,4,7,17,21,-4,13
FCSB,8384,1,8,5,1,24,11,13,29
CFR Cluj,8384,2,6,6,2,14,8,6,24
D Bucuresti,8384,3,4,5,5,17,18,-1,17
Universitate,8384,4,4,5,5,15,19,-4,17
FC Botosani,8384,5,3,5,6,6,14,-8,14
Concordia Ch,8384,6,2,4,8,16,22,-6,10
FCSB,8385,1,8,5,1,25,12,13,29
CFR Cluj,8385,2,5,6,3,15,11,4,21
Universitate,8385,3,5,5,4,17,19,-2,20
FC Botosani,8385,4,5,4,5,10,12,-2,19
D Bucuresti,8385,5,3,5,6,17,21,-4,14
Concordia Ch,8385,6,2,3,9,16,25,-9,9
FCSB,8386,1,7,7,0,26,13,13,28
CFR Cluj,8386,2,6,7,1,16,9,7,25
FC Botosani,8386,3,4,5,5,7,13,-6,17
Universitate,8386,4,3,6,5,15,20,-5,15
D Bucuresti,8386,5,3,4,7,17,22,-5,13
Concordia Ch,8386,6,3,3,8,19,23,-4,12
FCSB,8387,1,7,6,1,25,14,11,27
CFR Cluj,8387,2,7,6,1,18,9,9,27
D Bucuresti,8387,3,5,4,5,20,19,1,19
Universitate,8387,4,3,6,5,16,21,-5,15
FC Botosani,8387,5,3,5,6,7,16,-9,14
Concordia Ch,8387,6,2,3,9,16,23,-7,9
FCSB,8388,1,9,5,0,29,13,16,32
CFR Cluj,8388,2,6,6,2,16,10,6,24
D Bucuresti,8388,3,4,4,6,19,21,-2,16
Universitate,8388,4,3,5,6,15,22,-7,14
FC Botosani,8388,5,3,5,6,8,16,-8,14
Concordia Ch,8388,6,3,3,8,19,24,-5,12
FCSB,8389,1,7,5,2,24,14,10,26
CFR Cluj,8389,2,6,7,1,16,9,7,25
FC Botosani,8389,3,5,4,5,7,12,-5,19
Universitate,8389,4,4,6,4,17,19,-2,18
D Bucuresti,8389,5,4,4,6,18,19,-1,16
Concordia Ch,8389,6,2,2,10,15,24,-9,8
FCSB,8390,1,8,6,0,25,10,15,30
CFR Cluj,8390,2,6,7,1,16,8,8,25
D Bucuresti,8390,3,5,4,5,20,19,1,19
FC Botosani,8390,4,4,4,6,8,13,-5,16
Universitate,8390,5,3,5,6,15,23,-8,14
Concordia Ch,8390,6,2,2,10,16,27,-11,8
FCSB,8391,1,8,6,0,27,13,14,30
CFR Cluj,8391,2,6,6,2,16,8,8,24
FC Botosani,8391,3,4,5,5,9,14,-5,17
Universitate,8391,4,3,6,5,17,24,-7,15
D Bucuresti,8391,5,3,5,6,17,21,-4,14
Concordia Ch,8391,6,2,4,8,18,24,-6,10
FCSB,8392,1,9,5,0,25,10,15,32
CFR Cluj,8392,2,6,6,2,16,9,7,24
D Bucuresti,8392,3,4,5,5,17,18,-1,17
FC Botosani,8392,4,3,6,5,6,13,-7,15
Universitate,8392,5,3,5,6,15,22,-7,14
Concordia Ch,8392,6,2,3,9,16,23,-7,9
FCSB,8393,1,7,6,1,26,14,12,27
CFR Cluj,8393,2,6,7,1,15,8,7,25
Universitate,8393,3,4,5,5,17,21,-4,17
D Bucuresti,8393,4,4,4,6,20,21,-1,16
Concordia Ch,8393,5,4,2,8,20,21,-1,14
FC Botosani,8393,6,3,4,7,6,19,-13,13
FCSB,8394,1,8,5,1,25,11,14,29
CFR Cluj,8394,2,6,6,2,14,9,5,24
Universitate,8394,3,4,5,5,15,19,-4,17
D Bucuresti,8394,4,4,4,6,18,20,-2,16
FC Botosani,8394,5,4,4,6,7,13,-6,16
Concordia Ch,8394,6,3,2,9,17,24,-7,11
FCSB,8395,1,8,6,0,25,11,14,30
CFR Cluj,8395,2,5,6,3,13,9,4,21
Universitate,8395,3,4,6,4,16,19,-3,18
FC Botosani,8395,4,4,5,5,7,12,-5,17
D Bucuresti,8395,5,3,5,6,16,19,-3,14
Concordia Ch,8395,6,3,2,9,16,23,-7,11
FCSB,8396,1,8,5,1,29,12,17,29
CFR Cluj,8396,2,6,6,2,15,13,2,24
D Bucuresti,8396,3,5,4,5,21,20,1,19
Universitate,8396,4,4,5,5,16,20,-4,17
FC Botosani,8396,5,4,4,6,8,15,-7,16
Concordia Ch,8396,6,2,2,10,19,28,-9,8
FCSB,8397,1,8,5,1,25,12,13,29
CFR Cluj,8397,2,6,6,2,15,8,7,24
D Bucuresti,8397,3,5,4,5,20,18,2,19
Universitate,8397,4,4,5,5,15,20,-5,17
FC Botosani,8397,5,4,4,6,6,14,-8,16
Concordia Ch,8397,6,2,2,10,15,24,-9,8
FCSB,8398,1,9,5,0,27,12,15,32
CFR Cluj,8398,2,5,6,3,15,11,4,21
D Bucuresti,8398,3,5,4,5,19,19,0,19
Universitate,8398,4,4,5,5,17,21,-4,17
FC Botosani,8398,5,3,4,7,5,14,-9,13
Concordia Ch,8398,6,3,2,9,17,23,-6,11
FCSB,8399,1,8,5,1,26,11,15,29
CFR Cluj,8399,2,6,6,2,15,10,5,24
D Bucuresti,8399,3,4,5,5,21,22,-1,17
Universitate,8399,4,4,5,5,15,20,-5,17
FC Botosani,8399,5,4,4,6,8,15,-7,16
Concordia Ch,8399,6,2,3,9,17,24,-7,9
FCSB,8400,1,9,5,0,27,11,16,32
CFR Cluj,8400,2,5,6,3,14,12,2,21
Universitate,8400,3,4,5,5,16,19,-3,17
D Bucuresti,8400,4,4,4,6,18,21,-3,16
FC Botosani,8400,5,3,5,6,6,14,-8,14
Concordia Ch,8400,6,3,3,8,17,21,-4,12
FCSB,8401,1,8,5,1,24,12,12,29
CFR Cluj,8401,2,7,6,1,18,8,10,27
D Bucuresti,8401,3,4,5,5,20,19,1,17
FC Botosani,8401,4,4,4,6,7,16,-9,16
Universitate,8401,5,3,5,6,15,22,-7,14
Concordia Ch,8401,6,2,3,9,17,24,-7,9
FCSB,8402,1,8,6,0,27,12,15,30
CFR Cluj,8402,2,5,7,2,14,10,4,22
FC Botosani,8402,3,5,4,5,8,12,-4,19
Universitate,8402,4,3,7,4,17,21,-4,16
D Bucuresti,8402,5,3,4,7,16,20,-4,13
Concordia Ch,8402,6,3,2,9,16,23,-7,11
FCSB,8403,1,8,5,1,27,14,13,29
CFR Cluj,8403,2,7,6,1,17,8,9,27
D Bucuresti,8403,3,5,4,5,22,19,3,19
Universitate,8403,4,3,5,6,15,22,-7,14
FC Botosani,8403,5,3,5,6,6,15,-9,14
Concordia Ch,8403,6,2,3,9,17,26,-9,9
FCSB,8404,1,7,6,1,25,13,12,27
CFR Cluj,8404,2,6,7,1,17,8,9,25
Universitate,8404,3,4,5,5,16,22,-6,17
D Bucuresti,8404,4,4,4,6,19,19,0,16
Concordia Ch,8404,5,4,2,8,18,22,-4,14
FC Botosani,8404,6,3,4,7,6,17,-11,13
FCSB,8405,1,8,5,1,26,13,13,29
CFR Cluj,8405,2,5,7,2,16,11,5,22
Universitate,8405,3,4,6,4,16,19,-3,18
D Bucuresti,8405,4,4,4,6,20,19,1,16
FC Botosani,8405,5,4,4,6,8,16,-8,16
Concordia Ch,8405,6,3,2,9,16,24,-8,11
FCSB,8406,1,8,6,0,26,12,14,30
CFR Cluj,8406,2,6,7,1,18,10,8,25
D Bucuresti,8406,3,4,5,5,17,18,-1,17
Universitate,8406,4,3,5,6,15,22,-7,14
FC Botosani,8406,5,3,5,6,6,14,-8,14
Concordia Ch,8406,6,3,2,9,17,23,-6,11
FCSB,8407,1,7,6,1,23,13,10,27
CFR Cluj,8407,2,6,7,1,15,8,7,25
Universitate,8407,3,4,5,5,18,20,-2,17
D Bucuresti,8407,4,3,5,6,17,20,-3,14
Concordia Ch,8407,5,4,2,8,17,21,-4,14
FC Botosani,8407,6,3,5,6,6,14,-8,14
FCSB,8408,1,8,5,1,25,12,13,29
CFR Cluj,8408,2,6,6,2,15,9,6,24
Universitate,8408,3,4,5,5,17,21,-4,17
FC Botosani,8408,4,4,5,5,7,13,-6,17
D Bucuresti,8408,5,3,6,5,16,18,-2,15
Concordia Ch,8408,6,2,3,9,16,23,-7,9
FCSB,8409,1,9,5,0,26,11,15,32
CFR Cluj,8409,2,6,6,2,16,9,7,24
D Bucuresti,8409,3,4,5,5,18,19,-1,17
FC Botosani,8409,4,4,5,5,7,13,-6,17
Universitate,8409,5,3,5,6,16,23,-7,14
Concordia Ch,8409,6,2,2,10,15,23,-8,8
FCSB,8410,1,9,5,0,26,11,15,32
CFR Cluj,8410,2,5,7,2,14,9,5,22
FC Botosani,8410,3,4,5,5,7,13,-6,17
Universitate,8410,4,3,6,5,16,21,-5,15
D Bucuresti,8410,5,3,4,7,18,22,-4,13
Concordia Ch,8410,6,3,3,8,17,22,-5,12
FCSB,8411,1,8,6,0,26,12,14,30
CFR Cluj,8411,2,6,6,2,16,9,7,24
D Bucuresti,8411,3,5,4,5,23,21,2,19
Universitate,8411,4,3,6,5,15,21,-6,15
FC Botosani,8411,5,3,5,6,8,18,-10,14
Concordia Ch,8411,6,2,3,9,19,26,-7,9
FCSB,8412,1,9,5,0,26,10,16,32
CFR Cluj,8412,2,6,6,2,15,9,6,24
FC Botosani,8412,3,5,4,5,7,12,-5,19
D Bucuresti,8412,4,4,4,6,17,19,-2,16
Universitate,8412,5,3,5,6,15,22,-7,14
Concordia Ch,8412,6,2,2,10,15,23,-8,8
FCSB,8413,1,9,5,0,26,10,16,32
CFR Cluj,8413,2,6,6,2,15,9,6,24
D Bucuresti,8413,3,4,4,6,17,19,-2,16
Concordia Ch,8413,4,4,2,8,18,22,-4,14
Universitate,8413,5,3,5,6,15,22,-7,14
FC Botosani,8413,6,3,4,7,6,15,-9,13
FCSB,8414,1,7,6,1,23,11,12,27
CFR Cluj,8414,2,6,6,2,14,8,6,24
Universitate,8414,3,4,6,4,15,18,-3,18
FC Botosani,8414,4,3,6,5,5,12,-7,15
D Bucuresti,8414,5,3,5,6,17,20,-3,14
Concordia Ch,8414,6,3,3,8,17,22,-5,12
FCSB,8415,1,8,6,0,24,10,14,30
CFR Cluj,8415,2,5,6,3,14,10,4,21
Universitate,8415,3,4,6,4,16,19,-3,18
D Bucuresti,8415,4,4,4,6,19,21,-2,16
FC Botosani,8415,5,4,4,6,8,14,-6,16
Concordia Ch,8415,6,3,2,9,17,24,-7,11
CFR Cluj,8416,1,7,6,1,18,10,8,27
FCSB,8416,2,7,5,2,25,15,10,26
Universitate,8416,3,4,5,5,17,20,-3,17
FC Botosani,8416,4,3,6,5,6,13,-7,15
D Bucuresti,8416,5,3,5,6,17,21,-4,14
Concordia Ch,8416,6,3,3,8,17,21,-4,12
FCSB,8417,1,9,5,0,27,12,15,32
CFR Cluj,8417,2,6,6,2,16,10,6,24
D Bucuresti,8417,3,5,4,5,19,18,1,19
FC Botosani,8417,4,4,4,6,7,13,-6,16
Universitate,8417,5,3,5,6,14,20,-6,14
Concordia Ch,8417,6,2,2,10,15,25,-10,8
FCSB,8418,1,8,5,1,25,12,13,29
CFR Cluj,8418,2,5,7,2,13,9,4,22
Universitate,8418,3,4,6,4,16,18,-2,18
FC Botosani,8418,4,4,4,6,7,14,-7,16
D Bucuresti,8418,5,3,5,6,17,21,-4,14
Concordia Ch,8418,6,3,3,8,18,22,-4,12
CFR Cluj,8419,1,7,6,1,16,8,8,27
FCSB,8419,2,7,5,2,25,14,11,26
Universitate,8419,3,4,5,5,16,20,-4,17
D Bucuresti,8419,4,3,6,5,17,19,-2,15
FC Botosani,8419,5,3,5,6,6,14,-8,14
Concordia Ch,8419,6,3,3,8,16,21,-5,12
FCSB,8420,1,7,5,2,25,15,10,26
CFR Cluj,8420,2,6,7,1,16,9,7,25
FC Botosani,8420,3,5,4,5,8,12,-4,19
Universitate,8420,4,4,6,4,18,20,-2,18
D Bucuresti,8420,5,3,4,7,16,20,-4,13
Concordia Ch,8420,6,3,2,9,16,23,-7,11
FCSB,8421,1,8,6,0,26,11,15,30
CFR Cluj,8421,2,6,6,2,14,9,5,24
Universitate,8421,3,3,6,5,15,20,-5,15
Concordia Ch,8421,4,4,2,8,22,22,0,14
D Bucuresti,8421,5,3,5,6,17,21,-4,14
FC Botosani,8421,6,3,5,6,7,18,-11,14
FCSB,8422,1,7,6,1,23,11,12,27
CFR Cluj,8422,2,5,7,2,13,8,5,22
Universitate,8422,3,5,5,4,16,18,-2,20
D Bucuresti,8422,4,4,4,6,18,20,-2,16
Concordia Ch,8422,5,4,2,8,20,21,-1,14
FC Botosani,8422,6,3,4,7,5,17,-12,13
FCSB,8423,1,8,6,0,26,12,14,30
CFR Cluj,8423,2,6,7,1,18,8,10,25
D Bucuresti,8423,3,5,4,5,19,18,1,19
Universitate,8423,4,3,5,6,15,24,-9,14
FC Botosani,8423,5,3,4,7,6,17,-11,13
Concordia Ch,8423,6,3,2,9,19,24,-5,11
FCSB,8424,1,9,5,0,30,15,15,32
CFR Cluj,8424,2,5,6,3,15,11,4,21
D Bucuresti,8424,3,5,4,5,20,19,1,19
Universitate,8424,4,4,5,5,18,22,-4,17
FC Botosani,8424,5,3,5,6,6,15,-9,14
Concordia Ch,8424,6,2,3,9,15,22,-7,9
FCSB,8425,1,8,6,0,26,12,14,30
CFR Cluj,8425,2,5,7,2,13,8,5,22
D Bucuresti,8425,3,4,5,5,17,18,-1,17
Universitate,8425,4,3,7,4,16,20,-4,16
FC Botosani,8425,5,4,4,6,8,13,-5,16
Concordia Ch,8425,6,2,3,9,15,24,-9,9
FCSB,8426,1,8,5,1,26,12,14,29
CFR Cluj,8426,2,5,7,2,16,12,4,22
Universitate,8426,3,4,6,4,19,22,-3,18
D Bucuresti,8426,4,4,5,5,18,19,-1,17
FC Botosani,8426,5,3,5,6,6,14,-8,14
Concordia Ch,8426,6,2,4,8,17,23,-6,10
FCSB,8427,1,7,7,0,28,15,13,28
CFR Cluj,8427,2,6,7,1,18,11,7,25
D Bucuresti,8427,3,5,4,5,20,19,1,19
FC Botosani,8427,4,4,4,6,8,13,-5,16
Universitate,8427,5,3,6,5,17,22,-5,15
Concordia Ch,8427,6,2,2,10,16,27,-11,8
FCSB,8428,1,9,5,0,29,12,17,32
CFR Cluj,8428,2,5,7,2,15,10,5,22
Universitate,8428,3,3,6,5,14,21,-7,15
Concordia Ch,8428,4,4,2,8,23,24,-1,14
D Bucuresti,8428,5,3,5,6,18,24,-6,14
FC Botosani,8428,6,3,5,6,6,14,-8,14
CFR Cluj,8429,1,7,6,1,20,9,11,27
FCSB,8429,2,7,6,1,25,15,10,27
Universitate,8429,3,3,6,5,18,24,-6,15
FC Botosani,8429,4,3,6,5,6,13,-7,15
D Bucuresti,8429,5,3,5,6,17,20,-3,14
Concordia Ch,8429,6,3,3,8,16,21,-5,12
FCSB,8430,1,8,5,1,25,12,13,29
CFR Cluj,8430,2,6,6,2,17,11,6,24
Universitate,8430,3,4,5,5,17,21,-4,17
FC Botosani,8430,4,4,5,5,7,13,-6,17
D Bucuresti,8430,5,3,4,7,18,22,-4,13
Concordia Ch,8430,6,3,3,8,17,22,-5,12
FCSB,8431,1,7,6,1,25,13,12,27
CFR Cluj,8431,2,6,6,2,16,10,6,24
D Bucuresti,8431,3,5,4,5,21,20,1,19
Universitate,8431,4,4,6,4,15,18,-3,18
FC Botosani,8431,5,3,4,7,7,17,-10,13
Concordia Ch,8431,6,3,2,9,16,22,-6,11
FCSB,8432,1,9,5,0,28,11,17,32
CFR Cluj,8432,2,5,7,2,15,10,5,22
D Bucuresti,8432,3,5,4,5,22,20,2,19
FC Botosani,8432,4,4,4,6,7,15,-8,16
Universitate,8432,5,3,6,5,17,24,-7,15
Concordia Ch,8432,6,2,2,10,16,25,-9,8
FCSB,8433,1,7,6,1,25,14,11,27
CFR Cluj,8433,2,6,6,2,17,10,7,24
FC Botosani,8433,3,5,4,5,9,14,-5,19
Universitate,8433,4,4,6,4,17,20,-3,18
D Bucuresti,8433,5,4,4,6,19,21,-2,16
Concordia Ch,8433,6,2,2,10,17,25,-8,8
FCSB,8434,1,8,6,0,27,13,14,30
CFR Cluj,8434,2,5,7,2,15,10,5,22
D Bucuresti,8434,3,5,4,5,22,21,1,19
Universitate,8434,4,4,5,5,16,20,-4,17
FC Botosani,8434,5,3,4,7,6,16,-10,13
Concordia Ch,8434,6,3,2,9,18,24,-6,11
FCSB,8435,1,8,6,0,24,10,14,30
CFR Cluj,8435,2,6,6,2,14,8,6,24
D Bucuresti,8435,3,4,5,5,18,19,-1,17
FC Botosani,8435,4,4,5,5,11,14,-3,17
Universitate,8435,5,3,6,5,14,19,-5,15
Concordia Ch,8435,6,2,2,10,16,27,-11,8
FCSB,8436,1,9,5,0,28,11,17,32
CFR Cluj,8436,2,5,7,2,15,11,4,22
D Bucuresti,8436,3,4,4,6,18,19,-1,16
Universitate,8436,4,3,6,5,17,23,-6,15
FC Botosani,8436,5,3,5,6,5,14,-9,14
Concordia Ch,8436,6,3,3,8,16,21,-5,12
FCSB,8437,1,9,5,0,30,13,17,32
CFR Cluj,8437,2,5,6,3,15,12,3,21
D Bucuresti,8437,3,4,5,5,20,20,0,17
Universitate,8437,4,4,5,5,16,21,-5,17
FC Botosani,8437,5,3,5,6,6,15,-9,14
Concordia Ch,8437,6,2,4,8,18,24,-6,10
FCSB,8438,1,7,6,1,23,11,12,27
CFR Cluj,8438,2,7,6,1,15,7,8,27
FC Botosani,8438,3,5,4,5,9,13,-4,19
Universitate,8438,4,3,6,5,14,19,-5,15
D Bucuresti,8438,5,3,5,6,19,22,-3,14
Concordia Ch,8438,6,2,3,9,17,25,-8,9
FCSB,8439,1,7,6,1,25,13,12,27
CFR Cluj,8439,2,7,6,1,16,8,8,27
D Bucuresti,8439,3,4,5,5,19,18,1,17
FC Botosani,8439,4,4,5,5,6,12,-6,17
Universitate,8439,5,3,6,5,17,22,-5,15
Concordia Ch,8439,6,2,2,10,15,25,-10,8
FCSB,8440,1,7,7,0,24,11,13,28
CFR Cluj,8440,2,5,7,2,14,10,4,22
Universitate,8440,3,4,6,4,16,18,-2,18
D Bucuresti,8440,4,4,4,6,18,22,-4,16
FC Botosani,8440,5,4,4,6,6,14,-8,16
Concordia Ch,8440,6,3,2,9,19,22,-3,11
FCSB,8441,1,7,6,1,25,14,11,27
CFR Cluj,8441,2,7,6,1,21,10,11,27
FC Botosani,8441,3,4,5,5,8,14,-6,17
Universitate,8441,4,3,6,5,17,24,-7,15
D Bucuresti,8441,5,3,4,7,18,23,-5,13
Concordia Ch,8441,6,3,3,8,19,23,-4,12
FCSB,8442,1,8,5,1,29,13,16,29
CFR Cluj,8442,2,5,6,3,14,14,0,21
Universitate,8442,3,5,5,4,18,19,-1,20
FC Botosani,8442,4,5,4,5,8,12,-4,19
D Bucuresti,8442,5,3,4,7,17,21,-4,13
Concordia Ch,8442,6,3,2,9,17,24,-7,11
FCSB,8443,1,9,5,0,27,11,16,32
CFR Cluj,8443,2,6,6,2,15,8,7,24
FC Botosani,8443,3,3,6,5,5,12,-7,15
D Bucuresti,8443,4,3,5,6,18,21,-3,14
Universitate,8443,5,3,5,6,15,23,-8,14
Concordia Ch,8443,6,3,3,8,18,23,-5,12
FCSB,8444,1,8,5,1,25,12,13,29
CFR Cluj,8444,2,6,6,2,14,8,6,24
Universitate,8444,3,4,5,5,16,20,-4,17
FC Botosani,8444,4,4,5,5,7,13,-6,17
D Bucuresti,8444,5,3,6,5,17,19,-2,15
Concordia Ch,8444,6,2,3,9,17,24,-7,9
FCSB,8445,1,8,5,1,24,12,12,29
CFR Cluj,8445,2,6,6,2,15,9,6,24
Universitate,8445,3,4,5,5,17,20,-3,17
FC Botosani,8445,4,4,5,5,8,14,-6,17
D Bucuresti,8445,5,3,5,6,16,19,-3,14
Concordia Ch,8445,6,3,2,9,18,24,-6,11
FCSB,8446,1,8,6,0,26,12,14,30
CFR Cluj,8446,2,6,6,2,15,9,6,24
FC Botosani,8446,3,4,5,5,7,12,-5,17
D Bucuresti,8446,4,3,6,5,18,20,-2,15
Universitate,8446,5,3,6,5,17,22,-5,15
Concordia Ch,8446,6,2,3,9,17,25,-8,9
FCSB,8447,1,9,5,0,28,11,17,32
CFR Cluj,8447,2,5,7,2,14,10,4,22
FC Botosani,8447,3,4,5,5,9,13,-4,17
Universitate,8447,4,3,6,5,16,22,-6,15
D Bucuresti,8447,5,3,5,6,19,22,-3,14
Concordia Ch,8447,6,3,2,9,18,26,-8,11
FCSB,8448,1,8,5,1,25,12,13,29
CFR Cluj,8448,2,5,7,2,15,10,5,22
Universitate,8448,3,4,6,4,16,19,-3,18
Concordia Ch,8448,4,4,2,8,20,22,-2,14
D Bucuresti,8448,5,3,5,6,18,22,-4,14
FC Botosani,8448,6,3,5,6,6,15,-9,14
FCSB,8449,1,7,6,1,24,12,12,27
CFR Cluj,8449,2,6,7,1,15,8,7,25
FC Botosani,8449,3,5,4,5,11,14,-3,19
Universitate,8449,4,4,5,5,15,19,-4,17
D Bucuresti,8449,5,3,5,6,18,22,-4,14
Concordia Ch,8449,6,2,3,9,17,25,-8,9
FCSB,8450,1,7,6,1,26,14,12,27
CFR Cluj,8450,2,7,6,1,17,9,8,27
D Bucuresti,8450,3,5,4,5,20,18,2,19
Universitate,8450,4,3,6,5,17,22,-5,15
FC Botosani,8450,5,3,5,6,6,16,-10,14
Concordia Ch,8450,6,2,3,9,16,23,-7,9
FCSB,8451,1,8,5,1,25,11,14,29
CFR Cluj,8451,2,6,7,1,15,8,7,25
Universitate,8451,3,3,6,5,15,21,-6,15
Concordia Ch,8451,4,4,2,8,18,21,-3,14
D Bucuresti,8451,5,3,5,6,16,20,-4,14
FC Botosani,8451,6,3,5,6,5,13,-8,14
FCSB,8452,1,8,6,0,28,13,15,30
CFR Cluj,8452,2,6,7,1,18,11,7,25
D Bucuresti,8452,3,3,6,5,17,19,-2,15
FC Botosani,8452,4,3,6,5,7,14,-7,15
Universitate,8452,5,3,5,6,15,22,-7,14
Concordia Ch,8452,6,2,4,8,16,22,-6,10
FCSB,8453,1,8,6,0,27,11,16,30
CFR Cluj,8453,2,5,6,3,14,12,2,21
Universitate,8453,3,4,6,4,17,20,-3,18
D Bucuresti,8453,4,4,4,6,17,22,-5,16
FC Botosani,8453,5,4,4,6,7,14,-7,16
Concordia Ch,8453,6,3,2,9,20,23,-3,11
FCSB,8454,1,8,5,1,25,16,9,29
CFR Cluj,8454,2,5,7,2,15,10,5,22
FC Botosani,8454,3,5,4,5,8,13,-5,19
Universitate,8454,4,4,6,4,20,19,1,18
D Bucuresti,8454,5,3,4,7,17,23,-6,13
Concordia Ch,8454,6,3,2,9,20,24,-4,11
FCSB,8455,1,9,5,0,26,10,16,32
CFR Cluj,8455,2,6,6,2,16,10,6,24
FC Botosani,8455,3,4,5,5,7,13,-6,17
D Bucuresti,8455,4,3,5,6,17,20,-3,14
Universitate,8455,5,3,5,6,15,22,-7,14
Concordia Ch,8455,6,3,2,9,18,24,-6,11
FCSB,8456,1,7,7,0,24,11,13,28
CFR Cluj,8456,2,5,8,1,15,9,6,23
Universitate,8456,3,3,7,4,15,19,-4,16
FC Botosani,8456,4,3,6,5,5,12,-7,15
D Bucuresti,8456,5,3,5,6,16,19,-3,14
Concordia Ch,8456,6,3,3,8,16,21,-5,12
FCSB,8457,1,8,6,0,26,12,14,30
CFR Cluj,8457,2,6,7,1,15,8,7,25
D Bucuresti,8457,3,4,4,6,18,20,-2,16
Universitate,8457,4,3,5,6,15,21,-6,14
FC Botosani,8457,5,3,5,6,6,15,-9,14
Concordia Ch,8457,6,3,3,8,18,22,-4,12
FCSB,8458,1,8,6,0,27,12,15,30
CFR Cluj,8458,2,5,8,1,13,7,6,23
FC Botosani,8458,3,4,4,6,6,13,-7,16
Universitate,8458,4,3,6,5,16,22,-6,15
D Bucuresti,8458,5,3,5,6,16,19,-3,14
Concordia Ch,8458,6,3,3,8,16,21,-5,12
FCSB,8459,1,7,6,1,25,13,12,27
CFR Cluj,8459,2,6,7,1,15,8,7,25
D Bucuresti,8459,3,4,4,6,20,20,0,16
Universitate,8459,4,3,7,4,15,19,-4,16
FC Botosani,8459,5,4,4,6,9,15,-6,16
Concordia Ch,8459,6,3,2,9,17,26,-9,11
FCSB,8460,1,8,6,0,26,11,15,30
CFR Cluj,8460,2,5,8,1,14,8,6,23
D Bucuresti,8460,3,4,5,5,19,20,-1,17
FC Botosani,8460,4,4,5,5,10,15,-5,17
Universitate,8460,5,3,6,5,14,20,-6,15
Concordia Ch,8460,6,2,2,10,16,25,-9,8
FCSB,8461,1,8,6,0,27,13,14,30
CFR Cluj,8461,2,6,6,2,16,10,6,24
D Bucuresti,8461,3,5,4,5,19,19,0,19
Universitate,8461,4,3,6,5,15,20,-5,15
FC Botosani,8461,5,3,4,7,5,14,-9,13
Concordia Ch,8461,6,3,2,9,17,23,-6,11
FCSB,8462,1,8,6,0,25,11,14,30
CFR Cluj,8462,2,5,6,3,14,10,4,21
Universitate,8462,3,4,6,4,17,20,-3,18
D Bucuresti,8462,4,4,5,5,19,20,-1,17
FC Botosani,8462,5,3,4,7,6,15,-9,13
Concordia Ch,8462,6,3,3,8,17,22,-5,12
FCSB,8463,1,8,5,1,25,11,14,29
CFR Cluj,8463,2,6,6,2,14,9,5,24
D Bucuresti,8463,3,5,4,5,21,19,2,19
Universitate,8463,4,4,5,5,15,19,-4,17
FC Botosani,8463,5,4,4,6,8,16,-8,16
Concordia Ch,8463,6,2,2,10,15,24,-9,8
FCSB,8464,1,8,5,1,27,14,13,29
CFR Cluj,8464,2,5,6,3,14,10,4,21
Universitate,8464,3,5,5,4,18,20,-2,20
D Bucuresti,8464,4,4,5,5,20,20,0,17
FC Botosani,8464,5,4,4,6,7,15,-8,16
Concordia Ch,8464,6,2,3,9,16,23,-7,9
FCSB,8465,1,9,5,0,28,12,16,32
CFR Cluj,8465,2,5,6,3,15,11,4,21
Universitate,8465,3,4,5,5,17,22,-5,17
FC Botosani,8465,4,4,5,5,8,14,-6,17
D Bucuresti,8465,5,3,5,6,18,21,-3,14
Concordia Ch,8465,6,3,2,9,18,24,-6,11
FCSB,8466,1,8,5,1,26,13,13,29
CFR Cluj,8466,2,6,6,2,16,9,7,24
Universitate,8466,3,4,5,5,16,21,-5,17
D Bucuresti,8466,4,3,6,5,18,20,-2,15
FC Botosani,8466,5,3,6,5,9,16,-7,15
Concordia Ch,8466,6,2,4,8,19,25,-6,10
FCSB,8467,1,8,5,1,26,14,12,29
CFR Cluj,8467,2,5,6,3,14,11,3,21
Universitate,8467,3,5,5,4,18,18,0,20
D Bucuresti,8467,4,4,4,6,19,22,-3,16
FC Botosani,8467,5,3,5,6,8,16,-8,14
Concordia Ch,8467,6,3,3,8,20,24,-4,12
FCSB,8468,1,7,6,1,26,16,10,27
CFR Cluj,8468,2,6,6,2,16,9,7,24
Universitate,8468,3,4,6,4,19,21,-2,18
D Bucuresti,8468,4,4,5,5,19,19,0,17
FC Botosani,8468,5,4,5,5,7,13,-6,17
Concordia Ch,8468,6,2,2,10,15,24,-9,8
FCSB,8469,1,7,6,1,24,14,10,27
CFR Cluj,8469,2,5,8,1,14,8,6,23
D Bucuresti,8469,3,5,4,5,21,20,1,19
Universitate,8469,4,4,6,4,17,18,-1,18
FC Botosani,8469,5,3,4,7,6,17,-11,13
Concordia Ch,8469,6,3,2,9,19,24,-5,11
FCSB,8470,1,8,5,1,27,13,14,29
CFR Cluj,8470,2,6,6,2,16,11,5,24
FC Botosani,8470,3,5,4,5,10,12,-2,19
Universitate,8470,4,4,5,5,16,20,-4,17
D Bucuresti,8470,5,3,4,7,17,21,-4,13
Concordia Ch,8470,6,3,2,9,17,26,-9,11
FCSB,8471,1,8,5,1,25,12,13,29
CFR Cluj,8471,2,6,6,2,15,9,6,24
FC Botosani,8471,3,5,4,5,10,14,-4,19
Universitate,8471,4,4,5,5,17,21,-4,17
D Bucuresti,8471,5,3,5,6,18,21,-3,14
Concordia Ch,8471,6,2,3,9,15,23,-8,9
FCSB,8472,1,7,7,0,24,11,13,28
CFR Cluj,8472,2,6,7,1,16,8,8,25
FC Botosani,8472,3,4,5,5,8,14,-6,17
Universitate,8472,4,3,6,5,16,22,-6,15
D Bucuresti,8472,5,3,5,6,18,22,-4,14
Concordia Ch,8472,6,3,2,9,19,24,-5,11
FCSB,8473,1,7,6,1,24,12,12,27
CFR Cluj,8473,2,5,8,1,13,7,6,23
Universitate,8473,3,4,6,4,16,19,-3,18
D Bucuresti,8473,4,4,5,5,20,20,0,17
FC Botosani,8473,5,4,4,6,7,14,-7,16
Concordia Ch,8473,6,2,3,9,17,25,-8,9
FCSB,8474,1,8,5,1,28,12,16,29
CFR Cluj,8474,2,6,6,2,15,11,4,24
FC Botosani,8474,3,5,4,5,10,13,-3,19
Universitate,8474,4,4,5,5,17,22,-5,17
D Bucuresti,8474,5,4,4,6,18,20,-2,16
Concordia Ch,8474,6,2,2,10,16,26,-10,8
FCSB,8475,1,8,5,1,24,11,13,29
CFR Cluj,8475,2,5,6,3,13,10,3,21
Universitate,8475,3,5,5,4,17,18,-1,20
D Bucuresti,8475,4,5,4,5,21,19,2,19
FC Botosani,8475,5,3,5,6,6,16,-10,14
Concordia Ch,8475,6,2,3,9,17,24,-7,9
FCSB,8476,1,8,5,1,24,12,12,29
CFR Cluj,8476,2,6,6,2,15,8,7,24
Universitate,8476,3,4,5,5,16,20,-4,17
D Bucuresti,8476,4,4,4,6,17,19,-2,16
FC Botosani,8476,5,3,5,6,7,15,-8,14
Concordia Ch,8476,6,3,3,8,18,23,-5,12
FCSB,8477,1,8,6,0,25,11,14,30
CFR Cluj,8477,2,6,6,2,18,9,9,24
FC Botosani,8477,3,5,4,5,8,13,-5,19
Universitate,8477,4,3,6,5,14,22,-8,15
D Bucuresti,8477,5,3,4,7,17,22,-5,13
Concordia Ch,8477,6,3,2,9,17,22,-5,11
FCSB,8478,1,8,6,0,26,11,15,30
CFR Cluj,8478,2,6,6,2,16,10,6,24
Universitate,8478,3,3,6,5,16,22,-6,15
FC Botosani,8478,4,3,6,5,5,12,-7,15
D Bucuresti,8478,5,3,5,6,16,19,-3,14
Concordia Ch,8478,6,3,3,8,16,21,-5,12
FCSB,8479,1,8,5,1,24,11,13,29
CFR Cluj,8479,2,5,7,2,14,9,5,22
Universitate,8479,3,4,6,4,16,19,-3,18
FC Botosani,8479,4,4,4,6,8,15,-7,16
D Bucuresti,8479,5,3,5,6,17,20,-3,14
Concordia Ch,8479,6,3,3,8,17,22,-5,12
FCSB,8480,1,8,6,0,26,11,15,30
CFR Cluj,8480,2,5,8,1,15,9,6,23
D Bucuresti,8480,3,5,4,5,22,21,1,19
Universitate,8480,4,3,6,5,15,21,-6,15
FC Botosani,8480,5,3,5,6,8,16,-8,14
Concordia Ch,8480,6,2,3,9,17,25,-8,9
FCSB,8481,1,8,6,0,25,11,14,30
CFR Cluj,8481,2,6,7,1,16,9,7,25
D Bucuresti,8481,3,4,4,6,17,20,-3,16
FC Botosani,8481,4,4,4,6,7,13,-6,16
Universitate,8481,5,3,5,6,15,21,-6,14
Concordia Ch,8481,6,3,2,9,17,23,-6,11
FCSB,8482,1,9,5,0,28,11,17,32
CFR Cluj,8482,2,5,6,3,14,11,3,21
D Bucuresti,8482,3,4,5,5,21,21,0,17
Universitate,8482,4,4,5,5,15,20,-5,17
FC Botosani,8482,5,4,5,5,7,13,-6,17
Concordia Ch,8482,6,2,2,10,17,26,-9,8
FCSB,8483,1,8,5,1,26,13,13,29
CFR Cluj,8483,2,7,6,1,16,8,8,27
FC Botosani,8483,3,4,4,6,7,15,-8,16
D Bucuresti,8483,4,3,5,6,18,21,-3,14
Universitate,8483,5,3,5,6,15,21,-6,14
Concordia Ch,8483,6,3,3,8,20,24,-4,12
FCSB,8484,1,8,5,1,26,13,13,29
CFR Cluj,8484,2,6,7,1,15,7,8,25
D Bucuresti,8484,3,4,4,6,19,21,-2,16
FC Botosani,8484,4,4,4,6,8,16,-8,16
Universitate,8484,5,3,6,5,15,21,-6,15
Concordia Ch,8484,6,3,2,9,18,23,-5,11
FCSB,8485,1,9,5,0,28,13,15,32
CFR Cluj,8485,2,6,6,2,18,9,9,24
D Bucuresti,8485,3,4,5,5,19,20,-1,17
FC Botosani,8485,4,4,4,6,9,14,-5,16
Universitate,8485,5,3,5,6,16,25,-9,14
Concordia Ch,8485,6,2,3,9,16,25,-9,9
FCSB,8486,1,8,5,1,25,13,12,29
CFR Cluj,8486,2,7,6,1,18,8,10,27
D Bucuresti,8486,3,5,4,5,21,19,2,19
FC Botosani,8486,4,4,4,6,9,15,-6,16
Universitate,8486,5,3,5,6,15,22,-7,14
Concordia Ch,8486,6,2,2,10,16,27,-11,8
FCSB,8487,1,7,6,1,27,15,12,27
CFR Cluj,8487,2,6,7,1,18,10,8,25
Universitate,8487,3,4,5,5,18,23,-5,17
FC Botosani,8487,4,4,5,5,9,14,-5,17
D Bucuresti,8487,5,3,5,6,18,22,-4,14
Concordia Ch,8487,6,2,4,8,15,21,-6,10
FCSB,8488,1,8,5,1,26,12,14,29
CFR Cluj,8488,2,7,6,1,18,8,10,27
D Bucuresti,8488,3,4,4,6,18,21,-3,16
FC Botosani,8488,4,4,4,6,7,13,-6,16
Universitate,8488,5,3,5,6,14,23,-9,14
Concordia Ch,8488,6,3,2,9,17,23,-6,11
FCSB,8489,1,7,6,1,24,13,11,27
CFR Cluj,8489,2,6,7,1,15,7,8,25
D Bucuresti,8489,3,4,5,5,18,19,-1,17
FC Botosani,8489,4,4,5,5,12,15,-3,17
Universitate,8489,5,3,7,4,15,19,-4,16
Concordia Ch,8489,6,2,2,10,17,28,-11,8
FCSB,8490,1,8,5,1,25,11,14,29
CFR Cluj,8490,2,5,6,3,14,11,3,21
Universitate,8490,3,5,5,4,17,19,-2,20
D Bucuresti,8490,4,4,4,6,21,22,-1,16
Concordia Ch,8490,5,4,2,8,19,23,-4,14
FC Botosani,8490,6,3,4,7,8,18,-10,13
FCSB,8491,1,8,5,1,24,11,13,29
CFR Cluj,8491,2,6,6,2,14,8,6,24
FC Botosani,8491,3,5,4,5,9,12,-3,19
Universitate,8491,4,4,5,5,15,19,-4,17
D Bucuresti,8491,5,4,4,6,17,20,-3,16
Concordia Ch,8491,6,2,2,10,15,24,-9,8
FCSB,8492,1,7,6,1,24,12,12,27
CFR Cluj,8492,2,7,6,1,18,10,8,27
FC Botosani,8492,3,4,5,5,8,14,-6,17
D Bucuresti,8492,4,3,6,5,19,21,-2,15
Universitate,8492,5,3,6,5,18,23,-5,15
Concordia Ch,8492,6,2,3,9,18,25,-7,9
FCSB,8493,1,8,5,1,26,14,12,29
CFR Cluj,8493,2,6,6,2,16,9,7,24
FC Botosani,8493,3,5,4,5,9,12,-3,19
Universitate,8493,4,4,5,5,16,20,-4,17
D Bucuresti,8493,5,4,4,6,20,20,0,16
Concordia Ch,8493,6,2,2,10,16,28,-12,8
FCSB,8494,1,8,5,1,25,12,13,29
CFR Cluj,8494,2,6,6,2,15,10,5,24
Universitate,8494,3,4,5,5,16,19,-3,17
Concordia Ch,8494,4,4,2,8,19,21,-2,14
D Bucuresti,8494,5,3,5,6,17,21,-4,14
FC Botosani,8494,6,3,5,6,6,15,-9,14
FCSB,8495,1,8,6,0,27,13,14,30
CFR Cluj,8495,2,5,7,2,14,9,5,22
D Bucuresti,8495,3,4,5,5,21,21,0,17
Universitate,8495,4,3,7,4,18,22,-4,16
FC Botosani,8495,5,3,6,5,9,16,-7,15
Concordia Ch,8495,6,2,3,9,18,26,-8,9
FCSB,8496,1,7,6,1,24,12,12,27
CFR Cluj,8496,2,5,7,2,14,9,5,22
Universitate,8496,3,5,5,4,18,20,-2,20
D Bucuresti,8496,4,4,4,6,19,20,-1,16
FC Botosani,8496,5,3,5,6,6,15,-9,14
Concordia Ch,8496,6,3,3,8,18,23,-5,12
FCSB,8497,1,8,6,0,26,12,14,30
CFR Cluj,8497,2,5,8,1,14,8,6,23
FC Botosani,8497,3,4,5,5,10,15,-5,17
Universitate,8497,4,3,6,5,15,20,-5,15
D Bucuresti,8497,5,3,5,6,18,21,-3,14
Concordia Ch,8497,6,3,2,9,19,26,-7,11
FCSB,8498,1,7,5,2,23,14,9,26
CFR Cluj,8498,2,6,7,1,18,9,9,25
Universitate,8498,3,4,6,4,17,20,-3,18
FC Botosani,8498,4,3,6,5,6,13,-7,15
D Bucuresti,8498,5,3,5,6,18,21,-3,14
Concordia Ch,8498,6,3,3,8,17,22,-5,12
FCSB,8499,1,8,5,1,26,14,12,29
CFR Cluj,8499,2,6,6,2,16,11,5,24
D Bucuresti,8499,3,4,5,5,18,19,-1,17
Universitate,8499,4,4,5,5,20,22,-2,17
FC Botosani,8499,5,4,4,6,8,15,-7,16
Concordia Ch,8499,6,2,3,9,18,25,-7,9
FCSB,8500,1,8,6,0,25,11,14,30
CFR Cluj,8500,2,6,7,1,14,7,7,25
D Bucuresti,8500,3,4,4,6,20,21,-1,16
FC Botosani,8500,4,4,4,6,7,15,-8,16
Universitate,8500,5,3,5,6,15,21,-6,14
Concordia Ch,8500,6,3,2,9,19,25,-6,11
FCSB,8501,1,8,5,1,26,13,13,29
CFR Cluj,8501,2,6,6,2,17,9,8,24
D Bucuresti,8501,3,4,5,5,20,20,0,17
Universitate,8501,4,4,5,5,16,22,-6,17
FC Botosani,8501,5,3,5,6,6,15,-9,14
Concordia Ch,8501,6,3,2,9,18,24,-6,11
FCSB,8502,1,7,5,2,23,12,11,26
CFR Cluj,8502,2,6,7,1,15,8,7,25
Universitate,8502,3,4,6,4,16,19,-3,18
D Bucuresti,8502,4,4,5,5,20,19,1,17
FC Botosani,8502,5,3,5,6,6,16,-10,14
Concordia Ch,8502,6,2,4,8,17,23,-6,10
FCSB,8503,1,7,5,2,24,14,10,26
CFR Cluj,8503,2,6,7,1,15,8,7,25
D Bucuresti,8503,3,5,4,5,21,19,2,19
Universitate,8503,4,4,6,4,18,20,-2,18
FC Botosani,8503,5,4,4,6,6,14,-8,16
Concordia Ch,8503,6,2,2,10,16,25,-9,8
FCSB,8504,1,8,5,1,26,12,14,29
CFR Cluj,8504,2,5,6,3,13,11,2,21
Universitate,8504,3,5,5,4,18,19,-1,20
D Bucuresti,8504,4,5,4,5,21,18,3,19
FC Botosani,8504,5,3,5,6,6,15,-9,14
Concordia Ch,8504,6,2,3,9,16,25,-9,9
FCSB,8505,1,8,6,0,25,10,15,30
CFR Cluj,8505,2,5,6,3,14,11,3,21
D Bucuresti,8505,3,5,4,5,21,18,3,19
Universitate,8505,4,4,6,4,16,19,-3,18
FC Botosani,8505,5,4,4,6,6,14,-8,16
Concordia Ch,8505,6,2,2,10,15,25,-10,8
FCSB,8506,1,9,5,0,27,10,17,32
CFR Cluj,8506,2,5,6,3,14,11,3,21
Universitate,8506,3,4,5,5,16,21,-5,17
D Bucuresti,8506,4,4,4,6,18,20,-2,16
FC Botosani,8506,5,4,4,6,7,13,-6,16
Concordia Ch,8506,6,3,2,9,17,24,-7,11
FCSB,8507,1,8,5,1,27,15,12,29
CFR Cluj,8507,2,5,6,3,14,11,3,21
Universitate,8507,3,5,5,4,19,19,0,20
D Bucuresti,8507,4,4,4,6,18,20,-2,16
FC Botosani,8507,5,3,5,6,6,14,-8,14
Concordia Ch,8507,6,3,3,8,18,23,-5,12
FCSB,8508,1,9,5,0,26,11,15,32
CFR Cluj,8508,2,6,6,2,19,9,10,24
D Bucuresti,8508,3,4,5,5,18,19,-1,17
Universitate,8508,4,3,5,6,14,24,-10,14
FC Botosani,8508,5,3,4,7,5,16,-11,13
Concordia Ch,8508,6,3,3,8,19,22,-3,12
FCSB,8509,1,8,6,0,27,13,14,30
CFR Cluj,8509,2,6,7,1,19,10,9,25
D Bucuresti,8509,3,5,4,5,20,19,1,19
Universitate,8509,4,3,5,6,16,24,-8,14
FC Botosani,8509,5,3,4,7,5,14,-9,13
Concordia Ch,8509,6,3,2,9,17,24,-7,11
FCSB,8510,1,7,6,1,24,14,10,27
CFR Cluj,8510,2,7,6,1,19,9,10,27
FC Botosani,8510,3,4,5,5,10,15,-5,17
Universitate,8510,4,3,6,5,17,22,-5,15
D Bucuresti,8510,5,3,4,7,19,24,-5,13
Concordia Ch,8510,6,3,3,8,20,25,-5,12
FCSB,8511,1,7,6,1,24,12,12,27
CFR Cluj,8511,2,5,8,1,14,8,6,23
Universitate,8511,3,4,6,4,15,18,-3,18
D Bucuresti,8511,4,3,6,5,16,18,-2,15
FC Botosani,8511,5,3,6,5,6,13,-7,15
Concordia Ch,8511,6,2,4,8,16,22,-6,10
FCSB,8512,1,8,5,1,25,12,13,29
CFR Cluj,8512,2,6,7,1,15,7,8,25
Universitate,8512,3,3,6,5,14,20,-6,15
FC Botosani,8512,4,3,6,5,6,13,-7,15
D Bucuresti,8512,5,3,5,6,17,20,-3,14
Concordia Ch,8512,6,3,3,8,16,21,-5,12
FCSB,8513,1,8,6,0,26,12,14,30
CFR Cluj,8513,2,6,6,2,17,9,8,24
D Bucuresti,8513,3,4,5,5,21,20,1,17
FC Botosani,8513,4,4,4,6,8,15,-7,16
Universitate,8513,5,3,6,5,15,22,-7,15
Concordia Ch,8513,6,2,3,9,17,26,-9,9
FCSB,8514,1,7,7,0,23,10,13,28
CFR Cluj,8514,2,5,8,1,13,7,6,23
D Bucuresti,8514,3,4,4,6,18,19,-1,16
Universitate,8514,4,3,7,4,14,18,-4,16
FC Botosani,8514,5,4,4,6,6,14,-8,16
Concordia Ch,8514,6,3,2,9,16,22,-6,11
FCSB,8515,1,7,5,2,23,14,9,26
CFR Cluj,8515,2,6,6,2,14,8,6,24
Universitate,8515,3,5,5,4,18,18,0,20
D Bucuresti,8515,4,4,5,5,22,21,1,17
FC Botosani,8515,5,4,4,6,7,16,-9,16
Concordia Ch,8515,6,2,3,9,17,24,-7,9
FCSB,8516,1,9,5,0,26,11,15,32
CFR Cluj,8516,2,5,7,2,13,8,5,22
D Bucuresti,8516,3,4,4,6,21,20,1,16
Universitate,8516,4,3,6,5,15,20,-5,15
FC Botosani,8516,5,3,5,6,5,16,-11,14
Concordia Ch,8516,6,3,3,8,17,22,-5,12
FCSB,8517,1,8,6,0,27,12,15,30
CFR Cluj,8517,2,5,7,2,15,11,4,22
Universitate,8517,3,3,7,4,16,20,-4,16
FC Botosani,8517,4,4,4,6,8,14,-6,16
D Bucuresti,8517,5,3,5,6,18,22,-4,14
Concordia Ch,8517,6,3,3,8,19,24,-5,12
FCSB,8518,1,8,6,0,29,13,16,30
CFR Cluj,8518,2,5,7,2,15,12,3,22
D Bucuresti,8518,3,5,4,5,20,19,1,19
Universitate,8518,4,3,7,4,19,23,-4,16
FC Botosani,8518,5,3,4,7,7,17,-10,13
Concordia Ch,8518,6,3,2,9,19,25,-6,11
FCSB,8519,1,7,6,1,24,12,12,27
CFR Cluj,8519,2,6,7,1,14,7,7,25
Universitate,8519,3,4,5,5,16,20,-4,17
D Bucuresti,8519,4,4,4,6,18,20,-2,16
FC Botosani,8519,5,4,4,6,8,13,-5,16
Concordia Ch,8519,6,3,2,9,17,25,-8,11
FCSB,8520,1,7,5,2,23,14,9,26
CFR Cluj,8520,2,6,6,2,15,9,6,24
Universitate,8520,3,5,5,4,19,19,0,20
FC Botosani,8520,4,5,4,5,8,12,-4,19
D Bucuresti,8520,5,4,4,6,17,19,-2,16
Concordia Ch,8520,6,2,2,10,15,24,-9,8
FCSB,8521,1,9,5,0,31,13,18,32
CFR Cluj,8521,2,5,7,2,15,12,3,22
Universitate,8521,3,3,6,5,17,23,-6,15
FC Botosani,8521,4,3,6,5,5,12,-7,15
D Bucuresti,8521,5,3,5,6,18,21,-3,14
Concordia Ch,8521,6,3,3,8,18,23,-5,12
FCSB,8522,1,7,7,0,23,10,13,28
CFR Cluj,8522,2,5,7,2,14,10,4,22
Universitate,8522,3,4,6,4,17,19,-2,18
D Bucuresti,8522,4,3,6,5,17,19,-2,15
FC Botosani,8522,5,3,6,5,7,14,-7,15
Concordia Ch,8522,6,2,4,8,18,24,-6,10
CFR Cluj,8523,1,7,6,1,17,8,9,27
FCSB,8523,2,7,5,2,24,14,10,26
Universitate,8523,3,4,5,5,15,19,-4,17
D Bucuresti,8523,4,4,4,6,19,20,-1,16
Concordia Ch,8523,5,4,2,8,17,21,-4,14
FC Botosani,8523,6,3,4,7,6,16,-10,13
FCSB,8524,1,8,5,1,27,11,16,29
CFR Cluj,8524,2,6,6,2,15,11,4,24
D Bucuresti,8524,3,4,5,5,18,19,-1,17
Universitate,8524,4,4,5,5,15,20,-5,17
FC Botosani,8524,5,3,4,7,6,15,-9,13
Concordia Ch,8524,6,3,3,8,18,23,-5,12
FCSB,8525,1,7,5,2,24,16,8,26
CFR Cluj,8525,2,6,7,1,14,7,7,25
FC Botosani,8525,3,5,4,5,10,12,-2,19
Universitate,8525,4,4,6,4,19,19,0,18
D Bucuresti,8525,5,3,4,7,16,22,-6,13
Concordia Ch,8525,6,3,2,9,16,23,-7,11
FCSB,8526,1,7,7,0,25,12,13,28
CFR Cluj,8526,2,5,7,2,15,10,5,22
Universitate,8526,3,4,6,4,17,20,-3,18
FC Botosani,8526,4,4,4,6,8,15,-7,16
D Bucuresti,8526,5,3,5,6,18,21,-3,14
Concordia Ch,8526,6,3,3,8,18,23,-5,12
FCSB,8527,1,8,6,0,27,11,16,30
CFR Cluj,8527,2,5,7,2,14,11,3,22
D Bucuresti,8527,3,4,5,5,19,20,-1,17
Universitate,8527,4,3,7,4,16,20,-4,16
FC Botosani,8527,5,3,5,6,6,16,-10,14
Concordia Ch,8527,6,3,2,9,19,23,-4,11
FCSB,8528,1,7,6,1,23,15,8,27
CFR Cluj,8528,2,6,7,1,15,7,8,25
Universitate,8528,3,4,5,5,19,20,-1,17
D Bucuresti,8528,4,4,4,6,17,19,-2,16
FC Botosani,8528,5,4,4,6,7,14,-7,16
Concordia Ch,8528,6,3,2,9,17,23,-6,11
FCSB,8529,1,7,5,2,23,13,10,26
CFR Cluj,8529,2,6,7,1,15,8,7,25
Universitate,8529,3,4,6,4,17,19,-2,18
FC Botosani,8529,4,4,5,5,6,12,-6,17
D Bucuresti,8529,5,3,5,6,16,19,-3,14
Concordia Ch,8529,6,3,2,9,16,22,-6,11
FCSB,8530,1,8,6,0,24,10,14,30
CFR Cluj,8530,2,6,7,1,14,7,7,25
D Bucuresti,8530,3,4,4,6,20,20,0,16
Universitate,8530,4,3,5,6,14,20,-6,14
FC Botosani,8530,5,3,5,6,5,15,-10,14
Concordia Ch,8530,6,3,3,8,17,22,-5,12
FCSB,8531,1,8,6,0,26,11,15,30
CFR Cluj,8531,2,5,8,1,16,10,6,23
D Bucuresti,8531,3,5,4,5,20,19,1,19
Universitate,8531,4,3,6,5,16,22,-6,15
FC Botosani,8531,5,3,4,7,7,16,-9,13
Concordia Ch,8531,6,3,2,9,17,24,-7,11
FCSB,8532,1,8,6,0,25,11,14,30
CFR Cluj,8532,2,5,8,1,13,7,6,23
D Bucuresti,8532,3,5,4,5,21,20,1,19
FC Botosani,8532,4,4,4,6,8,16,-8,16
Universitate,8532,5,3,6,5,15,20,-5,15
Concordia Ch,8532,6,2,2,10,15,23,-8,8
FCSB,8533,1,8,5,1,28,14,14,29
CFR Cluj,8533,2,5,7,2,14,12,2,22
Universitate,8533,3,4,6,4,19,20,-1,18
D Bucuresti,8533,4,4,4,6,18,19,-1,16
FC Botosani,8533,5,3,5,6,5,14,-9,14
Concordia Ch,8533,6,3,3,8,16,21,-5,12
FCSB,8534,1,8,5,1,26,13,13,29
CFR Cluj,8534,2,5,7,2,16,11,5,22
Universitate,8534,3,4,6,4,18,21,-3,18
FC Botosani,8534,4,4,5,5,8,14,-6,17
D Bucuresti,8534,5,4,4,6,21,23,-2,16
Concordia Ch,8534,6,2,3,9,19,26,-7,9
FCSB,8535,1,8,5,1,26,13,13,29
CFR Cluj,8535,2,5,7,2,15,10,5,22
Universitate,8535,3,4,6,4,17,20,-3,18
D Bucuresti,8535,4,3,6,5,19,21,-2,15
FC Botosani,8535,5,3,5,6,7,15,-8,14
Concordia Ch,8535,6,3,3,8,19,24,-5,12
FCSB,8536,1,9,5,0,25,10,15,32
CFR Cluj,8536,2,5,7,2,14,9,5,22
D Bucuresti,8536,3,4,5,5,21,20,1,17
FC Botosani,8536,4,4,5,5,9,14,-5,17
Universitate,8536,5,3,6,5,15,20,-5,15
Concordia Ch,8536,6,2,2,10,15,26,-11,8
FCSB,8537,1,8,5,1,25,12,13,29
CFR Cluj,8537,2,6,6,2,15,9,6,24
Universitate,8537,3,4,5,5,17,21,-4,17
D Bucuresti,8537,4,3,6,5,17,19,-2,15
FC Botosani,8537,5,3,5,6,5,16,-11,14
Concordia Ch,8537,6,3,3,8,20,22,-2,12
FCSB,8538,1,8,5,1,26,11,15,29
CFR Cluj,8538,2,6,6,2,18,10,8,24
D Bucuresti,8538,3,4,5,5,18,19,-1,17
Universitate,8538,4,4,5,5,15,23,-8,17
FC Botosani,8538,5,3,5,6,6,15,-9,14
Concordia Ch,8538,6,3,2,9,19,24,-5,11
FCSB,8539,1,7,7,0,26,13,13,28
CFR Cluj,8539,2,5,7,2,17,12,5,22
Universitate,8539,3,4,6,4,20,23,-3,18
FC Botosani,8539,4,4,5,5,8,13,-5,17
D Bucuresti,8539,5,3,5,6,17,21,-4,14
Concordia Ch,8539,6,2,4,8,17,23,-6,10
CFR Cluj,8540,1,7,6,1,15,7,8,27
FCSB,8540,2,7,5,2,24,13,11,26
Universitate,8540,3,4,5,5,16,20,-4,17
FC Botosani,8540,4,3,6,5,7,14,-7,15
D Bucuresti,8540,5,3,5,6,17,21,-4,14
Concordia Ch,8540,6,3,3,8,18,22,-4,12
FCSB,8541,1,8,6,0,24,10,14,30
CFR Cluj,8541,2,6,7,1,16,7,9,25
FC Botosani,8541,3,4,5,5,7,12,-5,17
D Bucuresti,8541,4,3,5,6,16,20,-4,14
Universitate,8541,5,3,5,6,14,22,-8,14
Concordia Ch,8541,6,3,2,9,17,23,-6,11
FCSB,8542,1,9,5,0,27,12,15,32
CFR Cluj,8542,2,5,6,3,15,11,4,21
D Bucuresti,8542,3,4,5,5,17,18,-1,17
Universitate,8542,4,4,5,5,17,21,-4,17
FC Botosani,8542,5,3,6,5,5,12,-7,15
Concordia Ch,8542,6,2,3,9,15,22,-7,9
CFR Cluj,8543,1,7,6,1,18,8,10,27
FCSB,8543,2,7,5,2,24,15,9,26
D Bucuresti,8543,3,4,5,5,21,19,2,17
Universitate,8543,4,4,5,5,19,23,-4,17
FC Botosani,8543,5,4,4,6,6,16,-10,16
Concordia Ch,8543,6,2,3,9,16,23,-7,9
FCSB,8544,1,7,6,1,24,13,11,27
CFR Cluj,8544,2,6,6,2,15,8,7,24
FC Botosani,8544,3,5,4,5,9,13,-4,19
Universitate,8544,4,4,6,4,16,19,-3,18
D Bucuresti,8544,5,3,4,7,17,21,-4,13
Concordia Ch,8544,6,3,2,9,16,23,-7,11
FCSB,8545,1,8,6,0,24,10,14,30
CFR Cluj,8545,2,5,7,2,13,8,5,22
D Bucuresti,8545,3,5,4,5,19,18,1,19
Universitate,8545,4,3,7,4,14,18,-4,16
FC Botosani,8545,5,4,4,6,7,14,-7,16
Concordia Ch,8545,6,2,2,10,16,25,-9,8
FCSB,8546,1,9,5,0,29,13,16,32
CFR Cluj,8546,2,5,6,3,15,11,4,21
Universitate,8546,3,4,5,5,18,23,-5,17
D Bucuresti,8546,4,4,4,6,17,19,-2,16
FC Botosani,8546,5,4,4,6,6,13,-7,16
Concordia Ch,8546,6,3,2,9,16,22,-6,11
FCSB,8547,1,7,6,1,24,12,12,27
CFR Cluj,8547,2,5,8,1,15,9,6,23
Universitate,8547,3,4,6,4,18,21,-3,18
FC Botosani,8547,4,4,5,5,8,12,-4,17
D Bucuresti,8547,5,3,6,5,16,18,-2,15
Concordia Ch,8547,6,2,3,9,15,24,-9,9
FCSB,8548,1,8,5,1,25,12,13,29
CFR Cluj,8548,2,5,7,2,15,11,4,22
Universitate,8548,3,4,6,4,18,20,-2,18
D Bucuresti,8548,4,4,4,6,19,22,-3,16
Concordia Ch,8548,5,4,2,8,19,22,-3,14
FC Botosani,8548,6,3,4,7,6,15,-9,13
FCSB,8549,1,8,5,1,28,13,15,29
CFR Cluj,8549,2,6,6,2,14,11,3,24
D Bucuresti,8549,3,4,5,5,20,19,1,17
Universitate,8549,4,4,5,5,17,20,-3,17
FC Botosani,8549,5,3,5,6,6,16,-10,14
Concordia Ch,8549,6,2,4,8,17,23,-6,10
FCSB,8550,1,7,7,0,24,11,13,28
CFR Cluj,8550,2,5,7,2,15,10,5,22
Universitate,8550,3,4,6,4,16,19,-3,18
FC Botosani,8550,4,4,4,6,8,15,-7,16
Concordia Ch,8550,5,4,2,8,21,22,-1,14
D Bucuresti,8550,6,3,4,7,17,24,-7,13
FCSB,8551,1,8,5,1,26,14,12,29
CFR Cluj,8551,2,6,6,2,17,10,7,24
Universitate,8551,3,4,5,5,17,21,-4,17
FC Botosani,8551,4,4,5,5,7,13,-6,17
D Bucuresti,8551,5,4,4,6,18,20,-2,16
Concordia Ch,8551,6,2,3,9,17,24,-7,9
FCSB,8552,1,9,5,0,29,11,18,32
CFR Cluj,8552,2,6,6,2,16,10,6,24
FC Botosani,8552,3,4,4,6,8,15,-7,16
D Bucuresti,8552,4,3,5,6,19,22,-3,14
Universitate,8552,5,3,5,6,14,23,-9,14
Concordia Ch,8552,6,3,3,8,19,24,-5,12
FCSB,8553,1,7,6,1,23,11,12,27
CFR Cluj,8553,2,6,7,1,15,8,7,25
Universitate,8553,3,4,5,5,16,20,-4,17
D Bucuresti,8553,4,4,4,6,19,23,-4,16
Concordia Ch,8553,5,4,2,8,20,21,-1,14
FC Botosani,8553,6,3,4,7,6,16,-10,13
FCSB,8554,1,9,5,0,29,12,17,32
CFR Cluj,8554,2,6,6,2,17,12,5,24
D Bucuresti,8554,3,4,4,6,22,22,0,16
Universitate,8554,4,3,5,6,17,24,-7,14
FC Botosani,8554,5,3,5,6,7,18,-11,14
Concordia Ch,8554,6,3,3,8,17,21,-4,12
FCSB,8555,1,8,5,1,24,12,12,29
CFR Cluj,8555,2,5,7,2,14,9,5,22
Universitate,8555,3,4,6,4,17,19,-2,18
FC Botosani,8555,4,4,4,6,8,13,-5,16
D Bucuresti,8555,5,3,5,6,17,22,-5,14
Concordia Ch,8555,6,3,3,8,17,22,-5,12
FCSB,8556,1,8,6,0,27,13,14,30
CFR Cluj,8556,2,5,8,1,16,10,6,23
D Bucuresti,8556,3,3,6,5,21,23,-2,15
Universitate,8556,4,3,6,5,16,21,-5,15
FC Botosani,8556,5,3,5,6,7,16,-9,14
Concordia Ch,8556,6,3,3,8,20,24,-4,12
FCSB,8557,1,9,5,0,28,10,18,32
CFR Cluj,8557,2,6,6,2,14,10,4,24
D Bucuresti,8557,3,4,5,5,19,20,-1,17
FC Botosani,8557,4,3,6,5,6,13,-7,15
Universitate,8557,5,3,5,6,14,21,-7,14
Concordia Ch,8557,6,2,3,9,16,23,-7,9
FCSB,8558,1,9,5,0,28,12,16,32
CFR Cluj,8558,2,6,6,2,16,10,6,24
FC Botosani,8558,3,5,4,5,9,14,-5,19
D Bucuresti,8558,4,3,5,6,19,22,-3,14
Universitate,8558,5,3,5,6,15,22,-7,14
Concordia Ch,8558,6,2,3,9,18,25,-7,9
FCSB,8559,1,8,6,0,28,13,15,30
CFR Cluj,8559,2,5,8,1,14,8,6,23
FC Botosani,8559,3,4,5,5,9,15,-6,17
Universitate,8559,4,3,6,5,16,22,-6,15
D Bucuresti,8559,5,3,5,6,18,21,-3,14
Concordia Ch,8559,6,2,4,8,16,22,-6,10
FCSB,8560,1,7,6,1,26,14,12,27
CFR Cluj,8560,2,6,7,1,16,8,8,25
Universitate,8560,3,4,5,5,17,22,-5,17
FC Botosani,8560,4,4,5,5,6,12,-6,17
D Bucuresti,8560,5,3,6,5,17,19,-2,15
Concordia Ch,8560,6,2,3,9,16,23,-7,9
FCSB,8561,1,8,6,0,26,11,15,30
CFR Cluj,8561,2,6,6,2,17,10,7,24
D Bucuresti,8561,3,5,4,5,18,18,0,19
Universitate,8561,4,3,6,5,14,21,-7,15
FC Botosani,8561,5,3,5,6,5,13,-8,14
Concordia Ch,8561,6,2,3,9,15,22,-7,9
FCSB,8562,1,9,5,0,26,11,15,32
CFR Cluj,8562,2,5,7,2,16,11,5,22
D Bucuresti,8562,3,3,6,5,16,18,-2,15
Universitate,8562,4,3,6,5,16,21,-5,15
FC Botosani,8562,5,3,5,6,6,15,-9,14
Concordia Ch,8562,6,3,3,8,18,22,-4,12
FCSB,8563,1,9,5,0,27,10,17,32
CFR Cluj,8563,2,5,6,3,13,9,4,21
FC Botosani,8563,3,4,5,5,7,12,-5,17
Universitate,8563,4,4,5,5,15,21,-6,17
D Bucuresti,8563,5,3,5,6,16,21,-5,14
Concordia Ch,8563,6,3,2,9,18,23,-5,11
FCSB,8564,1,7,6,1,25,13,12,27
CFR Cluj,8564,2,6,6,2,14,8,6,24
Universitate,8564,3,4,6,4,17,20,-3,18
D Bucuresti,8564,4,4,5,5,17,18,-1,17
FC Botosani,8564,5,4,5,5,7,12,-5,17
Concordia Ch,8564,6,2,2,10,15,24,-9,8
FCSB,8565,1,7,7,0,25,12,13,28
CFR Cluj,8565,2,6,7,1,17,8,9,25
D Bucuresti,8565,3,5,4,5,24,21,3,19
FC Botosani,8565,4,4,4,6,9,16,-7,16
Universitate,8565,5,3,6,5,17,24,-7,15
Concordia Ch,8565,6,2,2,10,17,28,-11,8
FCSB,8566,1,9,5,0,27,11,16,32
CFR Cluj,8566,2,5,7,2,14,10,4,22
FC Botosani,8566,3,5,4,5,7,12,-5,19
D Bucuresti,8566,4,4,4,6,18,20,-2,16
Universitate,8566,5,3,6,5,14,19,-5,15
Concordia Ch,8566,6,2,2,10,16,24,-8,8
FCSB,8567,1,8,6,0,26,12,14,30
CFR Cluj,8567,2,5,7,2,15,10,5,22
Universitate,8567,3,4,5,5,15,19,-4,17
D Bucuresti,8567,4,3,6,5,18,20,-2,15
FC Botosani,8567,5,3,5,6,6,14,-8,14
Concordia Ch,8567,6,3,3,8,19,24,-5,12
FCSB,8568,1,8,5,1,26,13,13,29
CFR Cluj,8568,2,7,6,1,17,8,9,27
FC Botosani,8568,3,5,4,5,8,13,-5,19
D Bucuresti,8568,4,3,5,6,18,21,-3,14
Universitate,8568,5,3,5,6,15,22,-7,14
Concordia Ch,8568,6,2,3,9,16,23,-7,9
FCSB,8569,1,8,6,0,25,11,14,30
CFR Cluj,8569,2,5,8,1,15,9,6,23
D Bucuresti,8569,3,5,4,5,19,19,0,19
Universitate,8569,4,3,6,5,15,20,-5,15
FC Botosani,8569,5,3,5,6,7,15,-8,14
Concordia Ch,8569,6,2,3,9,16,23,-7,9
FCSB,8570,1,8,6,0,25,11,14,30
CFR Cluj,8570,2,5,6,3,14,12,2,21
Universitate,8570,3,4,6,4,19,20,-1,18
FC Botosani,8570,4,4,4,6,6,13,-7,16
D Bucuresti,8570,5,3,5,6,17,20,-3,14
Concordia Ch,8570,6,3,3,8,17,22,-5,12
FCSB,8571,1,8,5,1,26,12,14,29
CFR Cluj,8571,2,6,6,2,16,10,6,24
Universitate,8571,3,4,5,5,17,22,-5,17
D Bucuresti,8571,4,3,6,5,18,20,-2,15
FC Botosani,8571,5,3,5,6,5,14,-9,14
Concordia Ch,8571,6,3,3,8,19,23,-4,12
FCSB,8572,1,8,6,0,24,10,14,30
CFR Cluj,8572,2,6,6,2,16,9,7,24
D Bucuresti,8572,3,4,5,5,18,19,-1,17
FC Botosani,8572,4,4,5,5,8,13,-5,17
Universitate,8572,5,3,6,5,15,21,-6,15
Concordia Ch,8572,6,2,2,10,15,24,-9,8
FCSB,8573,1,7,6,1,25,13,12,27
CFR Cluj,8573,2,7,6,1,19,8,11,27
D Bucuresti,8573,3,3,6,5,18,20,-2,15
FC Botosani,8573,4,3,6,5,6,13,-7,15
Universitate,8573,5,3,6,5,15,23,-8,15
Concordia Ch,8573,6,2,4,8,16,22,-6,10
FCSB,8574,1,8,6,0,24,10,14,30
CFR Cluj,8574,2,5,8,1,15,9,6,23
D Bucuresti,8574,3,4,4,6,17,21,-4,16
FC Botosani,8574,4,4,4,6,6,13,-7,16
Universitate,8574,5,3,6,5,16,21,-5,15
Concordia Ch,8574,6,3,2,9,18,22,-4,11
FCSB,8575,1,8,5,1,27,13,14,29
CFR Cluj,8575,2,5,6,3,15,13,2,21
Universitate,8575,3,5,5,4,18,19,-1,20
D Bucuresti,8575,4,5,4,5,23,18,5,19
FC Botosani,8575,5,3,5,6,6,17,-11,14
Concordia Ch,8575,6,2,3,9,16,25,-9,9
FCSB,8576,1,8,5,1,24,12,12,29
CFR Cluj,8576,2,6,7,1,15,7,8,25
D Bucuresti,8576,3,4,4,6,19,20,-1,16
Universitate,8576,4,3,6,5,14,19,-5,15
FC Botosani,8576,5,3,5,6,6,15,-9,14
Concordia Ch,8576,6,3,3,8,16,21,-5,12
FCSB,8577,1,8,6,0,26,12,14,30
CFR Cluj,8577,2,5,7,2,16,11,5,22
D Bucuresti,8577,3,5,4,5,21,18,3,19
Universitate,8577,4,3,7,4,19,23,-4,16
FC Botosani,8577,5,3,5,6,5,15,-10,14
Concordia Ch,8577,6,2,3,9,15,23,-8,9
FCSB,8578,1,9,5,0,27,11,16,32
CFR Cluj,8578,2,6,6,2,18,10,8,24
D Bucuresti,8578,3,4,5,5,21,20,1,17
FC Botosani,8578,4,3,5,6,7,15,-8,14
Universitate,8578,5,3,5,6,14,23,-9,14
Concordia Ch,8578,6,3,2,9,16,24,-8,11
FCSB,8579,1,9,5,0,27,11,16,32
CFR Cluj,8579,2,6,6,2,14,8,6,24
D Bucuresti,8579,3,4,4,6,20,21,-1,16
Universitate,8579,4,3,5,6,15,22,-7,14
FC Botosani,8579,5,3,5,6,6,15,-9,14
Concordia Ch,8579,6,3,3,8,19,24,-5,12
FCSB,8580,1,8,5,1,28,15,13,29
CFR Cluj,8580,2,6,7,1,16,7,9,25
D Bucuresti,8580,3,5,4,5,18,18,0,19
Universitate,8580,4,3,6,5,16,23,-7,15
FC Botosani,8580,5,3,5,6,6,14,-8,14
Concordia Ch,8580,6,2,3,9,16,23,-7,9
FCSB,8581,1,8,6,0,27,12,15,30
CFR Cluj,8581,2,6,6,2,17,11,6,24
D Bucuresti,8581,3,5,4,5,21,19,2,19
FC Botosani,8581,4,4,4,6,9,16,-7,16
Universitate,8581,5,3,6,5,16,22,-6,15
Concordia Ch,8581,6,2,2,10,17,27,-10,8
FCSB,8582,1,7,6,1,28,19,9,27
CFR Cluj,8582,2,6,7,1,17,9,8,25
D Bucuresti,8582,3,5,4,5,20,18,2,19
Universitate,8582,4,4,5,5,21,23,-2,17
FC Botosani,8582,5,3,5,6,6,14,-8,14
Concordia Ch,8582,6,2,3,9,16,25,-9,9
FCSB,8583,1,7,6,1,25,14,11,27
CFR Cluj,8583,2,5,7,2,15,11,4,22
Universitate,8583,3,5,5,4,18,18,0,20
FC Botosani,8583,4,5,4,5,9,13,-4,19
D Bucuresti,8583,5,3,4,7,18,23,-5,13
Concordia Ch,8583,6,3,2,9,19,25,-6,11
FCSB,8584,1,8,5,1,28,14,14,29
CFR Cluj,8584,2,6,6,2,17,12,5,24
FC Botosani,8584,3,5,4,5,9,12,-3,19
Universitate,8584,4,4,5,5,17,21,-4,17
D Bucuresti,8584,5,3,4,7,16,23,-7,13
Concordia Ch,8584,6,3,2,9,18,23,-5,11
CFR Cluj,8585,1,7,6,1,19,8,11,27
FCSB,8585,2,7,5,2,24,17,7,26
D Bucuresti,8585,3,4,5,5,21,22,-1,17
Universitate,8585,4,4,5,5,18,21,-3,17
FC Botosani,8585,5,4,4,6,9,14,-5,16
Concordia Ch,8585,6,2,3,9,18,27,-9,9
FCSB,8586,1,8,5,1,27,12,15,29
CFR Cluj,8586,2,6,6,2,14,10,4,24
Universitate,8586,3,4,5,5,16,20,-4,17
FC Botosani,8586,4,4,5,5,6,12,-6,17
D Bucuresti,8586,5,3,6,5,16,18,-2,15
Concordia Ch,8586,6,2,3,9,15,22,-7,9
FCSB,8587,1,8,5,1,25,12,13,29
CFR Cluj,8587,2,5,6,3,14,11,3,21
Universitate,8587,3,5,5,4,17,18,-1,20
D Bucuresti,8587,4,4,4,6,17,19,-2,16
Concordia Ch,8587,5,4,2,8,17,21,-4,14
FC Botosani,8587,6,3,4,7,5,14,-9,13
FCSB,8588,1,8,5,1,31,15,16,29
CFR Cluj,8588,2,6,6,2,16,13,3,24
Universitate,8588,3,4,5,5,17,21,-4,17
FC Botosani,8588,4,4,4,6,7,14,-7,16
Concordia Ch,8588,5,4,2,8,17,21,-4,14
D Bucuresti,8588,6,3,4,7,17,21,-4,13
FCSB,8589,1,8,6,0,27,13,14,30
CFR Cluj,8589,2,6,6,2,15,9,6,24
FC Botosani,8589,3,4,5,5,10,15,-5,17
Universitate,8589,4,3,6,5,16,21,-5,15
D Bucuresti,8589,5,3,4,7,18,23,-5,13
Concordia Ch,8589,6,3,3,8,19,24,-5,12
FCSB,8590,1,7,6,1,24,12,12,27
CFR Cluj,8590,2,6,7,1,15,8,7,25
D Bucuresti,8590,3,4,5,5,18,19,-1,17
Universitate,8590,4,3,7,4,14,18,-4,16
FC Botosani,8590,5,3,6,5,6,13,-7,15
Concordia Ch,8590,6,2,3,9,17,24,-7,9
FCSB,8591,1,7,6,1,24,13,11,27
CFR Cluj,8591,2,7,6,1,16,7,9,27
D Bucuresti,8591,3,4,5,5,18,19,-1,17
FC Botosani,8591,4,4,4,6,6,13,-7,16
Universitate,8591,5,3,6,5,15,20,-5,15
Concordia Ch,8591,6,2,3,9,16,23,-7,9
FCSB,8592,1,7,6,1,24,12,12,27
CFR Cluj,8592,2,6,7,1,14,7,7,25
D Bucuresti,8592,3,4,5,5,18,18,0,17
Universitate,8592,4,3,7,4,15,19,-4,16
FC Botosani,8592,5,3,5,6,6,15,-9,14
Concordia Ch,8592,6,2,4,8,16,22,-6,10
FCSB,8593,1,7,5,2,24,14,10,26
CFR Cluj,8593,2,6,6,2,15,9,6,24
Universitate,8593,3,5,5,4,19,20,-1,20
D Bucuresti,8593,4,4,5,5,19,20,-1,17
FC Botosani,8593,5,3,4,7,6,15,-9,13
Concordia Ch,8593,6,3,3,8,17,22,-5,12
FCSB,8594,1,8,5,1,25,12,13,29
CFR Cluj,8594,2,7,6,1,16,7,9,27
D Bucuresti,8594,3,4,4,6,17,19,-2,16
FC Botosani,8594,4,4,4,6,9,13,-4,16
Universitate,8594,5,3,5,6,15,22,-7,14
Concordia Ch,8594,6,3,2,9,16,25,-9,11
FCSB,8595,1,8,5,1,26,13,13,29
CFR Cluj,8595,2,5,6,3,13,9,4,21
Universitate,8595,3,5,5,4,18,20,-2,20
FC Botosani,8595,4,4,5,5,8,13,-5,17
D Bucuresti,8595,5,4,4,6,19,21,-2,16
Concordia Ch,8595,6,2,3,9,15,23,-8,9
FCSB,8596,1,8,5,1,26,13,13,29
CFR Cluj,8596,2,5,6,3,13,11,2,21
Universitate,8596,3,5,5,4,19,19,0,20
D Bucuresti,8596,4,4,4,6,18,20,-2,16
FC Botosani,8596,5,4,4,6,9,15,-6,16
Concordia Ch,8596,6,3,2,9,19,26,-7,11
FCSB,8597,1,7,6,1,27,15,12,27
CFR Cluj,8597,2,6,7,1,17,9,8,25
Universitate,8597,3,4,5,5,17,22,-5,17
D Bucuresti,8597,4,4,4,6,17,19,-2,16
Concordia Ch,8597,5,4,2,8,17,21,-4,14
FC Botosani,8597,6,3,4,7,5,14,-9,13
FCSB,8598,1,9,5,0,30,12,18,32
CFR Cluj,8598,2,5,6,3,14,10,4,21
FC Botosani,8598,3,5,4,5,9,13,-4,19
Universitate,8598,4,4,5,5,16,23,-7,17
D Bucuresti,8598,5,3,4,7,18,23,-5,13
Concordia Ch,8598,6,3,2,9,18,24,-6,11
FCSB,8599,1,8,5,1,26,14,12,29
CFR Cluj,8599,2,5,6,3,15,11,4,21
Universitate,8599,3,5,5,4,19,20,-1,20
FC Botosani,8599,4,5,4,5,9,14,-5,19
D Bucuresti,8599,5,3,5,6,17,20,-3,14
Concordia Ch,8599,6,2,3,9,16,23,-7,9
FCSB,8600,1,9,5,0,27,10,17,32
CFR Cluj,8600,2,6,6,2,14,8,6,24
D Bucuresti,8600,3,4,5,5,18,19,-1,17
Universitate,8600,4,3,5,6,14,22,-8,14
FC Botosani,8600,5,3,4,7,5,15,-10,13
Concordia Ch,8600,6,3,3,8,18,22,-4,12
FCSB,8601,1,9,5,0,29,12,17,32
CFR Cluj,8601,2,5,7,2,13,10,3,22
D Bucuresti,8601,3,4,4,6,20,22,-2,16
FC Botosani,8601,4,4,4,6,7,15,-8,16
Universitate,8601,5,3,6,5,16,21,-5,15
Concordia Ch,8601,6,3,2,9,20,25,-5,11
FCSB,8602,1,8,6,0,28,14,14,30
CFR Cluj,8602,2,5,7,2,17,12,5,22
Universitate,8602,3,4,5,5,19,23,-4,17
FC Botosani,8602,4,3,6,5,6,13,-7,15
D Bucuresti,8602,5,3,5,6,17,21,-4,14
Concordia Ch,8602,6,3,3,8,17,21,-4,12
FCSB,8603,1,8,5,1,26,11,15,29
CFR Cluj,8603,2,5,7,2,14,11,3,22
Universitate,8603,3,4,6,4,16,19,-3,18
D Bucuresti,8603,4,4,5,5,19,20,-1,17
FC Botosani,8603,5,3,6,5,6,13,-7,15
Concordia Ch,8603,6,2,3,9,16,23,-7,9
FCSB,8604,1,7,6,1,25,13,12,27
CFR Cluj,8604,2,5,7,2,13,8,5,22
Universitate,8604,3,5,5,4,18,20,-2,20
FC Botosani,8604,4,5,4,5,7,12,-5,19
D Bucuresti,8604,5,3,4,7,16,20,-4,13
Concordia Ch,8604,6,3,2,9,16,22,-6,11
FCSB,8605,1,7,6,1,25,14,11,27
CFR Cluj,8605,2,5,8,1,15,9,6,23
Universitate,8605,3,4,6,4,18,20,-2,18
FC Botosani,8605,4,3,6,5,7,14,-7,15
D Bucuresti,8605,5,3,5,6,17,21,-4,14
Concordia Ch,8605,6,3,3,8,18,22,-4,12
FCSB,8606,1,9,5,0,26,11,15,32
CFR Cluj,8606,2,6,6,2,15,9,6,24
D Bucuresti,8606,3,3,6,5,19,21,-2,15
Universitate,8606,4,3,5,6,14,20,-6,14
FC Botosani,8606,5,3,5,6,6,15,-9,14
Concordia Ch,8606,6,3,3,8,19,23,-4,12
FCSB,8607,1,9,5,0,29,13,16,32
CFR Cluj,8607,2,6,6,2,16,11,5,24
D Bucuresti,8607,3,4,4,6,20,21,-1,16
Concordia Ch,8607,4,4,2,8,19,23,-4,14
Universitate,8607,5,3,5,6,15,21,-6,14
FC Botosani,8607,6,3,4,7,7,17,-10,13
FCSB,8608,1,7,6,1,23,11,12,27
CFR Cluj,8608,2,6,7,1,15,7,8,25
Universitate,8608,3,4,5,5,15,20,-5,17
D Bucuresti,8608,4,4,4,6,21,22,-1,16
Concordia Ch,8608,5,4,2,8,20,22,-2,14
FC Botosani,8608,6,3,4,7,5,17,-12,13
FCSB,8609,1,8,6,0,25,11,14,30
CFR Cluj,8609,2,5,7,2,14,9,5,22
D Bucuresti,8609,3,4,5,5,20,21,-1,17
Universitate,8609,4,4,5,5,15,19,-4,17
FC Botosani,8609,5,4,4,6,8,13,-5,16
Concordia Ch,8609,6,2,3,9,18,27,-9,9
FCSB,8610,1,8,5,1,26,13,13,29
CFR Cluj,8610,2,6,7,1,15,7,8,25
FC Botosani,8610,3,5,4,5,7,12,-5,19
D Bucuresti,8610,4,4,4,6,17,19,-2,16
Universitate,8610,5,3,6,5,15,21,-6,15
Concordia Ch,8610,6,2,2,10,15,23,-8,8
FCSB,8611,1,9,5,0,28,10,18,32
CFR Cluj,8611,2,6,6,2,14,10,4,24
D Bucuresti,8611,3,5,4,5,22,21,1,19
Universitate,8611,4,3,5,6,14,21,-7,14
FC Botosani,8611,5,3,4,7,7,18,-11,13
Concordia Ch,8611,6,3,2,9,18,23,-5,11
FCSB,8612,1,8,6,0,26,11,15,30
CFR Cluj,8612,2,5,8,1,16,10,6,23
FC Botosani,8612,3,5,4,5,8,12,-4,19
D Bucuresti,8612,4,4,4,6,17,19,-2,16
Universitate,8612,5,3,6,5,16,22,-6,15
Concordia Ch,8612,6,2,2,10,15,24,-9,8
FCSB,8613,1,7,6,1,24,13,11,27
CFR Cluj,8613,2,5,8,1,15,9,6,23
Universitate,8613,3,4,6,4,17,19,-2,18
D Bucuresti,8613,4,4,5,5,17,18,-1,17
FC Botosani,8613,5,3,5,6,5,13,-8,14
Concordia Ch,8613,6,3,2,9,16,22,-6,11
FCSB,8614,1,8,6,0,28,14,14,30
CFR Cluj,8614,2,5,6,3,15,11,4,21
Universitate,8614,3,4,6,4,19,22,-3,18
D Bucuresti,8614,4,4,4,6,17,21,-4,16
Concordia Ch,8614,5,4,2,8,20,22,-2,14
FC Botosani,8614,6,3,4,7,6,15,-9,13
CFR Cluj,8615,1,7,6,1,16,7,9,27
FCSB,8615,2,7,5,2,24,13,11,26
D Bucuresti,8615,3,4,5,5,19,19,0,17
FC Botosani,8615,4,4,5,5,8,12,-4,17
Universitate,8615,5,4,5,5,16,21,-5,17
Concordia Ch,8615,6,2,2,10,16,27,-11,8
FCSB,8616,1,8,5,1,25,13,12,29
CFR Cluj,8616,2,6,6,2,17,9,8,24
D Bucuresti,8616,3,4,5,5,21,22,-1,17
Universitate,8616,4,4,5,5,16,21,-5,17
FC Botosani,8616,5,4,5,5,9,14,-5,17
Concordia Ch,8616,6,2,2,10,17,26,-9,8
FCSB,8617,1,8,5,1,25,12,13,29
CFR Cluj,8617,2,6,6,2,14,8,6,24
FC Botosani,8617,3,5,4,5,7,12,-5,19
Universitate,8617,4,4,5,5,16,20,-4,17
D Bucuresti,8617,5,3,4,7,16,20,-4,13
Concordia Ch,8617,6,3,2,9,16,22,-6,11
FCSB,8618,1,7,6,1,25,13,12,27
CFR Cluj,8618,2,6,7,1,16,9,7,25
D Bucuresti,8618,3,4,5,5,17,18,-1,17
Universitate,8618,4,4,5,5,15,19,-4,17
FC Botosani,8618,5,3,6,5,6,13,-7,15
Concordia Ch,8618,6,2,3,9,16,23,-7,9
FCSB,8619,1,8,5,1,27,12,15,29
CFR Cluj,8619,2,7,6,1,17,9,8,27
FC Botosani,8619,3,4,5,5,8,13,-5,17
D Bucuresti,8619,4,3,5,6,17,20,-3,14
Universitate,8619,5,3,5,6,15,23,-8,14
Concordia Ch,8619,6,3,2,9,16,23,-7,11
FCSB,8620,1,8,6,0,26,11,15,30
CFR Cluj,8620,2,5,8,1,16,10,6,23
D Bucuresti,8620,3,4,4,6,20,21,-1,16
FC Botosani,8620,4,4,4,6,6,15,-9,16
Universitate,8620,5,3,6,5,16,22,-6,15
Concordia Ch,8620,6,3,2,9,18,23,-5,11
FCSB,8621,1,8,5,1,24,13,11,29
CFR Cluj,8621,2,6,6,2,14,8,6,24
Universitate,8621,3,4,5,5,17,19,-2,17
FC Botosani,8621,4,4,5,5,10,16,-6,17
D Bucuresti,8621,5,3,5,6,19,22,-3,14
Concordia Ch,8621,6,2,4,8,20,26,-6,10
FCSB,8622,1,9,5,0,25,10,15,32
CFR Cluj,8622,2,5,6,3,14,10,4,21
D Bucuresti,8622,3,4,5,5,18,19,-1,17
Universitate,8622,4,4,5,5,16,20,-4,17
FC Botosani,8622,5,4,5,5,9,13,-4,17
Concordia Ch,8622,6,2,2,10,15,25,-10,8
FCSB,8623,1,7,7,0,24,11,13,28
CFR Cluj,8623,2,6,7,1,16,7,9,25
FC Botosani,8623,3,4,5,5,6,12,-6,17
D Bucuresti,8623,4,4,4,6,19,20,-1,16
Universitate,8623,5,3,6,5,15,22,-7,15
Concordia Ch,8623,6,2,3,9,16,24,-8,9
FCSB,8624,1,8,5,1,25,12,13,29
CFR Cluj,8624,2,6,6,2,14,9,5,24
Universitate,8624,3,4,5,5,16,19,-3,17
FC Botosani,8624,4,4,5,5,7,13,-6,17
D Bucuresti,8624,5,3,5,6,17,21,-4,14
Concordia Ch,8624,6,3,2,9,19,24,-5,11
FCSB,8625,1,8,6,0,28,13,15,30
CFR Cluj,8625,2,5,7,2,16,12,4,22
D Bucuresti,8625,3,5,4,5,19,19,0,19
Universitate,8625,4,3,7,4,16,20,-4,16
FC Botosani,8625,5,3,4,7,5,14,-9,13
Concordia Ch,8625,6,3,2,9,17,23,-6,11
FCSB,8626,1,8,6,0,28,13,15,30
CFR Cluj,8626,2,5,8,1,15,9,6,23
D Bucuresti,8626,3,5,4,5,19,18,1,19
FC Botosani,8626,4,4,4,6,8,15,-7,16
Universitate,8626,5,3,6,5,17,23,-6,15
Concordia Ch,8626,6,2,2,10,16,25,-9,8
FCSB,8627,1,7,5,2,23,13,10,26
CFR Cluj,8627,2,6,7,1,14,7,7,25
Universitate,8627,3,4,6,4,16,18,-2,18
D Bucuresti,8627,4,4,4,6,18,23,-5,16
FC Botosani,8627,5,4,4,6,8,14,-6,16
Concordia Ch,8627,6,3,2,9,19,23,-4,11
FCSB,8628,1,8,5,1,25,12,13,29
CFR Cluj,8628,2,5,7,2,15,10,5,22
Universitate,8628,3,4,6,4,16,19,-3,18
D Bucuresti,8628,4,4,5,5,18,19,-1,17
FC Botosani,8628,5,4,4,6,6,13,-7,16
Concordia Ch,8628,6,2,3,9,16,23,-7,9
FCSB,8629,1,8,6,0,26,12,14,30
CFR Cluj,8629,2,6,7,1,16,9,7,25
D Bucuresti,8629,3,3,6,5,17,19,-2,15
FC Botosani,8629,4,3,6,5,6,13,-7,15
Universitate,8629,5,3,5,6,16,22,-6,14
Concordia Ch,8629,6,2,4,8,15,21,-6,10
FCSB,8630,1,8,6,0,26,12,14,30
CFR Cluj,8630,2,6,7,1,16,8,8,25
FC Botosani,8630,3,4,5,5,7,13,-6,17
D Bucuresti,8630,4,3,5,6,16,22,-6,14
Universitate,8630,5,3,5,6,15,22,-7,14
Concordia Ch,8630,6,3,2,9,20,23,-3,11
FCSB,8631,1,7,6,1,25,13,12,27
CFR Cluj,8631,2,5,7,2,14,10,4,22
Universitate,8631,3,5,5,4,18,19,-1,20
FC Botosani,8631,4,4,5,5,9,15,-6,17
D Bucuresti,8631,5,3,5,6,16,19,-3,14
Concordia Ch,8631,6,3,2,9,19,25,-6,11
FCSB,8632,1,9,5,0,27,12,15,32
CFR Cluj,8632,2,6,6,2,15,9,6,24
D Bucuresti,8632,3,4,5,5,18,19,-1,17
Universitate,8632,4,3,5,6,15,21,-6,14
FC Botosani,8632,5,3,4,7,6,15,-9,13
Concordia Ch,8632,6,3,3,8,18,23,-5,12
FCSB,8633,1,8,5,1,24,11,13,29
CFR Cluj,8633,2,6,6,2,15,8,7,24
Universitate,8633,3,4,5,5,15,20,-5,17
D Bucuresti,8633,4,4,4,6,20,21,-1,16
Concordia Ch,8633,5,4,2,8,21,22,-1,14
FC Botosani,8633,6,3,4,7,7,20,-13,13
FCSB,8634,1,9,5,0,28,11,17,32
CFR Cluj,8634,2,6,6,2,14,10,4,24
D Bucuresti,8634,3,5,4,5,21,20,1,19
Universitate,8634,4,3,5,6,15,21,-6,14
FC Botosani,8634,5,3,4,7,8,17,-9,13
Concordia Ch,8634,6,3,2,9,17,24,-7,11
CFR Cluj,8635,1,7,6,1,17,8,9,27
FCSB,8635,2,7,5,2,25,16,9,26
D Bucuresti,8635,3,5,4,5,22,19,3,19
Universitate,8635,4,4,5,5,17,20,-3,17
FC Botosani,8635,5,3,5,6,6,17,-11,14
Concordia Ch,8635,6,2,3,9,15,22,-7,9
FCSB,8636,1,8,5,1,24,12,12,29
CFR Cluj,8636,2,6,6,2,14,8,6,24
FC Botosani,8636,3,5,4,5,9,12,-3,19
Universitate,8636,4,4,5,5,16,19,-3,17
D Bucuresti,8636,5,3,4,7,18,26,-8,13
Concordia Ch,8636,6,3,2,9,21,25,-4,11
FCSB,8637,1,9,5,0,26,11,15,32
CFR Cluj,8637,2,5,7,2,14,9,5,22
FC Botosani,8637,3,4,5,5,7,13,-6,17
Universitate,8637,4,3,6,5,16,21,-5,15
D Bucuresti,8637,5,3,4,7,18,23,-5,13
Concordia Ch,8637,6,3,3,8,18,22,-4,12
FCSB,8638,1,8,5,1,25,11,14,29
CFR Cluj,8638,2,7,6,1,15,7,8,27
D Bucuresti,8638,3,4,4,6,17,19,-2,16
FC Botosani,8638,4,4,4,6,9,13,-4,16
Universitate,8638,5,3,5,6,14,21,-7,14
Concordia Ch,8638,6,3,2,9,16,25,-9,11
FCSB,8639,1,8,5,1,24,12,12,29
CFR Cluj,8639,2,5,6,3,14,11,3,21
Universitate,8639,3,5,5,4,19,19,0,20
D Bucuresti,8639,4,3,5,6,18,21,-3,14
Concordia Ch,8639,5,4,2,8,17,21,-4,14
FC Botosani,8639,6,3,5,6,7,15,-8,14
FCSB,8640,1,8,5,1,25,12,13,29
CFR Cluj,8640,2,6,6,2,16,10,6,24
Universitate,8640,3,4,5,5,16,20,-4,17
FC Botosani,8640,4,4,5,5,6,12,-6,17
D Bucuresti,8640,5,3,4,7,17,21,-4,13
Concordia Ch,8640,6,3,3,8,17,22,-5,12
FCSB,8641,1,8,5,1,26,14,12,29
CFR Cluj,8641,2,6,6,2,16,9,7,24
D Bucuresti,8641,3,4,5,5,19,20,-1,17
Universitate,8641,4,4,5,5,16,20,-4,17
FC Botosani,8641,5,4,4,6,7,14,-7,16
Concordia Ch,8641,6,2,3,9,16,23,-7,9
FCSB,8642,1,7,7,0,26,13,13,28
CFR Cluj,8642,2,6,7,1,16,9,7,25
D Bucuresti,8642,3,5,4,5,20,19,1,19
FC Botosani,8642,4,4,4,6,8,15,-7,16
Universitate,8642,5,3,6,5,15,20,-5,15
Concordia Ch,8642,6,2,2,10,16,25,-9,8
FCSB,8643,1,7,7,0,25,12,13,28
CFR Cluj,8643,2,5,8,1,14,8,6,23
D Bucuresti,8643,3,5,4,5,20,20,0,19
Universitate,8643,4,3,7,4,17,21,-4,16
FC Botosani,8643,5,4,4,6,8,15,-7,16
Concordia Ch,8643,6,2,2,10,17,25,-8,8
FCSB,8644,1,9,5,0,30,13,17,32
CFR Cluj,8644,2,6,6,2,17,10,7,24
FC Botosani,8644,3,4,5,5,7,13,-6,17
D Bucuresti,8644,4,3,5,6,18,21,-3,14
Universitate,8644,5,3,5,6,17,26,-9,14
Concordia Ch,8644,6,2,4,8,16,22,-6,10
FCSB,8645,1,9,5,0,26,10,16,32
CFR Cluj,8645,2,6,6,2,15,8,7,24
D Bucuresti,8645,3,5,4,5,19,18,1,19
Universitate,8645,4,3,5,6,14,22,-8,14
FC Botosani,8645,5,3,4,7,6,15,-9,13
Concordia Ch,8645,6,3,2,9,17,24,-7,11
FCSB,8646,1,8,5,1,27,14,13,29
CFR Cluj,8646,2,5,7,2,16,12,4,22
Universitate,8646,3,4,6,4,17,19,-2,18
D Bucuresti,8646,4,4,5,5,20,21,-1,17
FC Botosani,8646,5,3,5,6,8,16,-8,14
Concordia Ch,8646,6,3,2,9,18,24,-6,11
FCSB,8647,1,8,5,1,24,12,12,29
CFR Cluj,8647,2,6,6,2,16,9,7,24
D Bucuresti,8647,3,4,5,5,18,19,-1,17
Universitate,8647,4,4,5,5,16,20,-4,17
FC Botosani,8647,5,3,5,6,6,15,-9,14
Concordia Ch,8647,6,3,2,9,17,22,-5,11
FCSB,8648,1,7,6,1,24,12,12,27
CFR Cluj,8648,2,5,8,1,14,8,6,23
Universitate,8648,3,4,6,4,15,18,-3,18
D Bucuresti,8648,4,4,5,5,20,19,1,17
FC Botosani,8648,5,3,5,6,6,14,-8,14
Concordia Ch,8648,6,3,2,9,16,24,-8,11
FCSB,8649,1,9,5,0,31,14,17,32
CFR Cluj,8649,2,5,6,3,16,12,4,21
D Bucuresti,8649,3,4,5,5,20,20,0,17
Universitate,8649,4,4,5,5,16,22,-6,17
FC Botosani,8649,5,3,4,7,6,16,-10,13
Concordia Ch,8649,6,3,3,8,19,24,-5,12
FCSB,8650,1,7,5,2,23,13,10,26
CFR Cluj,8650,2,6,6,2,14,8,6,24
Universitate,8650,3,5,5,4,17,18,-1,20
FC Botosani,8650,4,4,5,5,9,13,-4,17
D Bucuresti,8650,5,4,4,6,17,21,-4,16
Concordia Ch,8650,6,2,3,9,16,23,-7,9
FCSB,8651,1,7,7,0,26,13,13,28
CFR Cluj,8651,2,6,7,1,15,8,7,25
FC Botosani,8651,3,5,4,5,10,13,-3,19
Universitate,8651,4,3,6,5,16,21,-5,15
D Bucuresti,8651,5,3,5,6,18,21,-3,14
Concordia Ch,8651,6,2,3,9,16,25,-9,9
FCSB,8652,1,8,5,1,27,15,12,29
CFR Cluj,8652,2,6,6,2,17,11,6,24
FC Botosani,8652,3,5,4,5,8,12,-4,19
Universitate,8652,4,4,5,5,18,21,-3,17
D Bucuresti,8652,5,3,4,7,18,23,-5,13
Concordia Ch,8652,6,3,2,9,19,25,-6,11
FCSB,8653,1,7,5,2,23,15,8,26
CFR Cluj,8653,2,6,7,1,17,8,9,25
Universitate,8653,3,4,6,4,17,19,-2,18
D Bucuresti,8653,4,4,4,6,20,23,-3,16
FC Botosani,8653,5,4,4,6,9,14,-5,16
Concordia Ch,8653,6,3,2,9,18,25,-7,11
FCSB,8654,1,9,5,0,28,12,16,32
CFR Cluj,8654,2,6,6,2,17,9,8,24
D Bucuresti,8654,3,4,4,6,18,22,-4,16
FC Botosani,8654,4,4,4,6,9,15,-6,16
Universitate,8654,5,3,5,6,15,24,-9,14
Concordia Ch,8654,6,3,2,9,19,24,-5,11
FCSB,8655,1,8,5,1,25,12,13,29
CFR Cluj,8655,2,6,6,2,15,9,6,24
D Bucuresti,8655,3,4,5,5,20,20,0,17
Universitate,8655,4,4,5,5,15,19,-4,17
FC Botosani,8655,5,3,6,5,9,16,-7,15
Concordia Ch,8655,6,2,3,9,17,25,-8,9
CFR Cluj,8656,1,7,6,1,17,7,10,27
FCSB,8656,2,7,5,2,24,13,11,26
Universitate,8656,3,4,5,5,16,22,-6,17
FC Botosani,8656,4,4,4,6,8,14,-6,16
Concordia Ch,8656,5,4,2,8,18,21,-3,14
D Bucuresti,8656,6,3,4,7,16,22,-6,13
FCSB,8657,1,8,6,0,26,10,16,30
CFR Cluj,8657,2,6,6,2,15,11,4,24
D Bucuresti,8657,3,4,5,5,20,19,1,17
Universitate,8657,4,3,6,5,15,20,-5,15
FC Botosani,8657,5,3,4,7,6,17,-11,13
Concordia Ch,8657,6,3,3,8,18,23,-5,12
FCSB,8658,1,8,5,1,25,14,11,29
CFR Cluj,8658,2,6,6,2,14,8,6,24
Universitate,8658,3,4,5,5,18,20,-2,17
D Bucuresti,8658,4,4,4,6,18,21,-3,16
FC Botosani,8658,5,3,5,6,9,17,-8,14
Concordia Ch,8658,6,3,3,8,20,24,-4,12
FCSB,8659,1,9,5,0,26,11,15,32
CFR Cluj,8659,2,5,6,3,13,9,4,21
Universitate,8659,3,4,5,5,16,20,-4,17
FC Botosani,8659,4,3,6,5,7,14,-7,15
D Bucuresti,8659,5,3,5,6,19,23,-4,14
Concordia Ch,8659,6,3,3,8,20,24,-4,12
FCSB,8660,1,8,5,1,26,13,13,29
CFR Cluj,8660,2,7,6,1,16,8,8,27
D Bucuresti,8660,3,4,5,5,19,20,-1,17
Universitate,8660,4,3,5,6,15,21,-6,14
FC Botosani,8660,5,3,5,6,7,18,-11,14
Concordia Ch,8660,6,3,2,9,19,22,-3,11
FCSB,8661,1,7,6,1,24,13,11,27
CFR Cluj,8661,2,5,7,2,15,10,5,22
Universitate,8661,3,5,5,4,18,19,-1,20
FC Botosani,8661,4,4,5,5,7,12,-5,17
D Bucuresti,8661,5,3,5,6,17,20,-3,14
Concordia Ch,8661,6,3,2,9,17,24,-7,11
FCSB,8662,1,8,6,0,26,12,14,30
CFR Cluj,8662,2,5,7,2,15,11,4,22
FC Botosani,8662,3,5,4,5,10,13,-3,19
Universitate,8662,4,4,5,5,16,19,-3,17
D Bucuresti,8662,5,4,4,6,18,20,-2,16
Concordia Ch,8662,6,2,2,10,15,25,-10,8
FCSB,8663,1,8,5,1,25,13,12,29
CFR Cluj,8663,2,6,6,2,16,8,8,24
Universitate,8663,3,4,5,5,17,22,-5,17
FC Botosani,8663,4,4,5,5,6,12,-6,17
D Bucuresti,8663,5,3,4,7,16,21,-5,13
Concordia Ch,8663,6,3,3,8,17,21,-4,12
FCSB,8664,1,8,6,0,25,11,14,30
CFR Cluj,8664,2,6,7,1,17,9,8,25
D Bucuresti,8664,3,4,4,6,18,19,-1,16
Concordia Ch,8664,4,4,2,8,19,21,-2,14
Universitate,8664,5,3,5,6,15,22,-7,14
FC Botosani,8664,6,3,4,7,5,17,-12,13
FCSB,8665,1,8,5,1,27,13,14,29
CFR Cluj,8665,2,6,6,2,16,11,5,24
Universitate,8665,3,4,5,5,17,21,-4,17
FC Botosani,8665,4,4,5,5,8,14,-6,17
D Bucuresti,8665,5,3,5,6,18,23,-5,14
Concordia Ch,8665,6,3,2,9,18,22,-4,11
FCSB,8666,1,8,5,1,25,14,11,29
CFR Cluj,8666,2,6,6,2,16,10,6,24
Universitate,8666,3,4,5,5,18,20,-2,17
FC Botosani,8666,4,3,6,5,6,13,-7,15
D Bucuresti,8666,5,3,5,6,17,20,-3,14
Concordia Ch,8666,6,3,3,8,18,23,-5,12
FCSB,8667,1,8,6,0,25,10,15,30
CFR Cluj,8667,2,6,6,2,15,10,5,24
D Bucuresti,8667,3,4,4,6,18,21,-3,16
Universitate,8667,4,3,6,5,15,20,-5,15
Concordia Ch,8667,5,4,2,8,19,21,-2,14
FC Botosani,8667,6,3,4,7,6,16,-10,13
FCSB,8668,1,8,5,1,25,11,14,29
CFR Cluj,8668,2,6,7,1,15,8,7,25
FC Botosani,8668,3,4,5,5,8,14,-6,17
Universitate,8668,4,3,6,5,15,21,-6,15
D Bucuresti,8668,5,3,4,7,16,20,-4,13
Concordia Ch,8668,6,3,3,8,18,23,-5,12
FCSB,8669,1,9,5,0,27,11,16,32
CFR Cluj,8669,2,6,6,2,16,10,6,24
FC Botosani,8669,3,3,6,5,6,13,-7,15
D Bucuresti,8669,4,3,5,6,16,21,-5,14
Universitate,8669,5,3,5,6,14,21,-7,14
Concordia Ch,8669,6,3,3,8,19,22,-3,12
FCSB,8670,1,8,6,0,25,11,14,30
CFR Cluj,8670,2,5,7,2,14,12,2,22
D Bucuresti,8670,3,4,5,5,18,19,-1,17
Universitate,8670,3,4,5,5,18,19,-1,17
FC Botosani,8670,5,3,5,6,6,14,-8,14
Concordia Ch,8670,6,2,4,8,17,23,-6,10
FCSB,8671,1,8,6,0,26,12,14,30
CFR Cluj,8671,2,6,6,2,16,10,6,24
FC Botosani,8671,3,5,4,5,11,13,-2,19
Universitate,8671,4,3,6,5,16,21,-5,15
D Bucuresti,8671,5,3,4,7,18,24,-6,13
Concordia Ch,8671,6,3,2,9,18,25,-7,11
FCSB,8672,1,7,5,2,24,14,10,26
CFR Cluj,8672,2,6,7,1,15,7,8,25
Universitate,8672,3,4,6,4,16,19,-3,18
FC Botosani,8672,4,4,5,5,8,14,-6,17
D Bucuresti,8672,5,3,6,5,19,21,-2,15
Concordia Ch,8672,6,2,3,9,16,23,-7,9
FCSB,8673,1,8,6,0,24,10,14,30
CFR Cluj,8673,2,6,7,1,15,8,7,25
FC Botosani,8673,3,5,4,5,9,12,-3,19
D Bucuresti,8673,4,3,5,6,17,21,-4,14
Universitate,8673,5,3,5,6,15,21,-6,14
Concordia Ch,8673,6,2,3,9,16,24,-8,9
CFR Cluj,8674,1,7,6,1,15,7,8,27
FCSB,8674,2,7,5,2,23,13,10,26
D Bucuresti,8674,3,5,4,5,18,18,0,19
Universitate,8674,4,4,5,5,16,19,-3,17
FC Botosani,8674,5,4,4,6,6,13,-7,16
Concordia Ch,8674,6,2,2,10,15,23,-8,8
FCSB,8675,1,7,6,1,24,13,11,27
CFR Cluj,8675,2,6,7,1,15,7,8,25
D Bucuresti,8675,3,4,5,5,20,19,1,17
Universitate,8675,4,3,7,4,15,19,-4,16
FC Botosani,8675,5,3,6,5,7,14,-7,15
Concordia Ch,8675,6,2,3,9,16,25,-9,9
FCSB,8676,1,8,6,0,25,10,15,30
CFR Cluj,8676,2,6,6,2,16,9,7,24
Universitate,8676,3,3,6,5,14,21,-7,15
FC Botosani,8676,4,3,6,5,7,14,-7,15
D Bucuresti,8676,5,3,5,6,19,22,-3,14
Concordia Ch,8676,6,3,3,8,19,24,-5,12
FCSB,8677,1,9,5,0,29,11,18,32
CFR Cluj,8677,2,5,7,2,14,11,3,22
FC Botosani,8677,3,5,4,5,8,12,-4,19
Universitate,8677,4,3,6,5,14,20,-6,15
D Bucuresti,8677,5,3,4,7,17,21,-4,13
Concordia Ch,8677,6,3,2,9,17,24,-7,11
CFR Cluj,8678,1,7,6,1,16,7,9,27
FCSB,8678,2,7,5,2,23,15,8,26
Universitate,8678,3,4,5,5,17,19,-2,17
FC Botosani,8678,4,4,4,6,6,13,-7,16
D Bucuresti,8678,5,3,5,6,18,21,-3,14
Concordia Ch,8678,6,3,3,8,18,23,-5,12
FCSB,8679,1,8,6,0,26,10,16,30
CFR Cluj,8679,2,5,6,3,13,12,1,21
Universitate,8679,3,4,6,4,16,18,-2,18
D Bucuresti,8679,4,4,5,5,20,20,0,17
FC Botosani,8679,5,4,4,6,7,15,-8,16
Concordia Ch,8679,6,2,3,9,16,23,-7,9
FCSB,8680,1,7,5,2,24,14,10,26
CFR Cluj,8680,2,6,7,1,14,7,7,25
Universitate,8680,3,4,6,4,17,19,-2,18
FC Botosani,8680,4,4,5,5,8,14,-6,17
D Bucuresti,8680,5,3,4,7,19,23,-4,13
Concordia Ch,8680,6,3,3,8,19,24,-5,12
FCSB,8681,1,7,6,1,25,13,12,27
CFR Cluj,8681,2,5,7,2,14,10,4,22
Universitate,8681,3,5,5,4,18,19,-1,20
D Bucuresti,8681,4,4,5,5,18,18,0,17
FC Botosani,8681,5,3,5,6,5,14,-9,14
Concordia Ch,8681,6,2,4,8,15,21,-6,10
FCSB,8682,1,8,5,1,26,12,14,29
CFR Cluj,8682,2,6,6,2,14,9,5,24
D Bucuresti,8682,3,4,5,5,20,20,0,17
Universitate,8682,4,4,5,5,16,20,-4,17
FC Botosani,8682,5,4,5,5,8,14,-6,17
Concordia Ch,8682,6,2,2,10,15,24,-9,8
FCSB,8683,1,8,6,0,28,14,14,30
CFR Cluj,8683,2,5,6,3,14,10,4,21
Universitate,8683,3,4,6,4,18,21,-3,18
D Bucuresti,8683,4,4,5,5,20,20,0,17
FC Botosani,8683,5,3,4,7,6,16,-10,13
Concordia Ch,8683,6,3,3,8,19,24,-5,12
FCSB,8684,1,8,5,1,26,14,12,29
CFR Cluj,8684,2,7,6,1,19,8,11,27
D Bucuresti,8684,3,4,5,5,18,19,-1,17
Universitate,8684,4,3,5,6,14,22,-8,14
FC Botosani,8684,5,3,5,6,5,13,-8,14
Concordia Ch,8684,6,2,4,8,16,22,-6,10
FCSB,8685,1,8,5,1,25,13,12,29
CFR Cluj,8685,2,5,7,2,15,10,5,22
FC Botosani,8685,3,5,4,5,11,12,-1,19
Universitate,8685,4,4,6,4,17,19,-2,18
D Bucuresti,8685,5,3,4,7,17,24,-7,13
Concordia Ch,8685,6,3,2,9,18,25,-7,11
FCSB,8686,1,8,5,1,24,12,12,29
CFR Cluj,8686,2,6,6,2,16,9,7,24
Universitate,8686,3,4,5,5,16,20,-4,17
FC Botosani,8686,4,3,6,5,8,15,-7,15
D Bucuresti,8686,5,3,5,6,19,22,-3,14
Concordia Ch,8686,6,3,3,8,20,25,-5,12
FCSB,8687,1,8,5,1,27,14,13,29
CFR Cluj,8687,2,5,7,2,14,9,5,22
Universitate,8687,3,4,6,4,17,20,-3,18
FC Botosani,8687,4,4,4,6,6,13,-7,16
D Bucuresti,8687,5,3,5,6,17,20,-3,14
Concordia Ch,8687,6,3,3,8,17,22,-5,12
FCSB,8688,1,8,5,1,26,14,12,29
CFR Cluj,8688,2,5,7,2,13,8,5,22
Universitate,8688,3,4,6,4,18,20,-2,18
FC Botosani,8688,4,4,5,5,7,13,-6,17
D Bucuresti,8688,5,3,5,6,17,22,-5,14
Concordia Ch,8688,6,3,2,9,20,24,-4,11
FCSB,8689,1,9,5,0,26,11,15,32
CFR Cluj,8689,2,6,6,2,14,8,6,24
D Bucuresti,8689,3,4,4,6,18,21,-3,16
Universitate,8689,4,3,5,6,15,21,-6,14
FC Botosani,8689,5,3,5,6,6,15,-9,14
Concordia Ch,8689,6,3,3,8,19,22,-3,12
FCSB,8690,1,7,6,1,25,13,12,27
CFR Cluj,8690,2,6,7,1,18,9,9,25
D Bucuresti,8690,3,4,5,5,17,18,-1,17
Universitate,8690,4,4,5,5,17,23,-6,17
FC Botosani,8690,5,3,5,6,5,13,-8,14
Concordia Ch,8690,6,3,2,9,16,22,-6,11
FCSB,8691,1,8,6,0,25,11,14,30
CFR Cluj,8691,2,6,7,1,16,8,8,25
FC Botosani,8691,3,5,4,5,9,13,-4,19
D Bucuresti,8691,4,4,4,6,18,21,-3,16
Universitate,8691,5,3,5,6,14,21,-7,14
Concordia Ch,8691,6,2,2,10,17,25,-8,8
FCSB,8692,1,8,6,0,25,11,14,30
CFR Cluj,8692,2,5,6,3,14,10,4,21
D Bucuresti,8692,3,5,4,5,20,19,1,19
Universitate,8692,4,4,6,4,15,18,-3,18
FC Botosani,8692,5,4,4,6,8,15,-7,16
Concordia Ch,8692,6,2,2,10,15,24,-9,8
FCSB,8693,1,9,5,0,28,10,18,32
CFR Cluj,8693,2,5,6,3,13,10,3,21
Universitate,8693,3,4,5,5,15,21,-6,17
D Bucuresti,8693,4,3,6,5,18,20,-2,15
FC Botosani,8693,5,3,6,5,7,14,-7,15
Concordia Ch,8693,6,2,4,8,17,23,-6,10
FCSB,8694,1,8,6,0,28,14,14,30
CFR Cluj,8694,2,5,7,2,14,9,5,22
D Bucuresti,8694,3,5,4,5,22,20,2,19
Universitate,8694,4,3,7,4,17,21,-4,16
FC Botosani,8694,5,3,5,6,6,16,-10,14
Concordia Ch,8694,6,2,3,9,18,25,-7,9
FCSB,8695,1,7,6,1,24,12,12,27
CFR Cluj,8695,2,6,7,1,15,8,7,25
D Bucuresti,8695,3,5,4,5,19,18,1,19
Universitate,8695,4,4,5,5,15,19,-4,17
FC Botosani,8695,5,3,4,7,7,16,-9,13
Concordia Ch,8695,6,3,2,9,18,25,-7,11
FCSB,8696,1,8,5,1,28,14,14,29
CFR Cluj,8696,2,6,6,2,17,12,5,24
Universitate,8696,3,4,5,5,19,23,-4,17
D Bucuresti,8696,4,4,4,6,18,20,-2,16
FC Botosani,8696,5,4,4,6,7,14,-7,16
Concordia Ch,8696,6,3,2,9,17,23,-6,11
FCSB,8697,1,7,6,1,26,14,12,27
CFR Cluj,8697,2,5,8,1,14,8,6,23
Universitate,8697,3,4,6,4,17,20,-3,18
D Bucuresti,8697,4,4,4,6,17,21,-4,16
FC Botosani,8697,5,4,4,6,8,13,-5,16
Concordia Ch,8697,6,3,2,9,18,24,-6,11
FCSB,8698,1,9,5,0,28,12,16,32
CFR Cluj,8698,2,6,6,2,15,10,5,24
D Bucuresti,8698,3,5,4,5,21,19,2,19
FC Botosani,8698,4,4,4,6,10,17,-7,16
Universitate,8698,5,3,5,6,15,21,-6,14
Concordia Ch,8698,6,2,2,10,17,27,-10,8
FCSB,8699,1,7,7,0,25,12,13,28
CFR Cluj,8699,2,6,7,1,16,9,7,25
D Bucuresti,8699,3,3,6,5,17,19,-2,15
Universitate,8699,4,3,6,5,16,21,-5,15
FC Botosani,8699,5,3,6,5,6,13,-7,15
Concordia Ch,8699,6,2,4,8,15,21,-6,10
FCSB,8700,1,9,5,0,26,11,15,32
CFR Cluj,8700,2,5,6,3,14,11,3,21
Universitate,8700,3,4,5,5,16,19,-3,17
FC Botosani,8700,4,4,4,6,8,15,-7,16
D Bucuresti,8700,5,3,5,6,18,21,-3,14
Concordia Ch,8700,6,3,3,8,20,25,-5,12
FCSB,8701,1,9,5,0,28,11,17,32
CFR Cluj,8701,2,6,6,2,16,9,7,24
D Bucuresti,8701,3,4,4,6,18,19,-1,16
FC Botosani,8701,4,4,4,6,6,14,-8,16
Universitate,8701,5,3,5,6,14,23,-9,14
Concordia Ch,8701,6,3,2,9,16,22,-6,11
FCSB,8702,1,7,7,0,25,12,13,28
CFR Cluj,8702,2,6,7,1,17,8,9,25
D Bucuresti,8702,3,4,4,6,18,20,-2,16
Universitate,8702,4,3,6,5,15,22,-7,15
Concordia Ch,8702,5,4,2,8,17,21,-4,14
FC Botosani,8702,6,3,4,7,6,15,-9,13
FCSB,8703,1,8,5,1,26,13,13,29
CFR Cluj,8703,2,7,6,1,18,10,8,27
D Bucuresti,8703,3,5,4,5,19,19,0,19
FC Botosani,8703,4,4,4,6,7,13,-6,16
Universitate,8703,5,3,5,6,17,23,-6,14
Concordia Ch,8703,6,2,2,10,16,25,-9,8
CFR Cluj,8704,1,7,6,1,17,8,9,27
FCSB,8704,2,7,5,2,24,14,10,26
Universitate,8704,3,4,5,5,15,19,-4,17
FC Botosani,8704,4,4,5,5,7,12,-5,17
D Bucuresti,8704,5,3,5,6,17,22,-5,14
Concordia Ch,8704,6,3,2,9,19,24,-5,11
FCSB,8705,1,9,5,0,27,10,17,32
CFR Cluj,8705,2,5,7,2,13,10,3,22
FC Botosani,8705,3,5,4,5,11,14,-3,19
Universitate,8705,4,3,6,5,14,19,-5,15
D Bucuresti,8705,5,3,4,7,17,22,-5,13
Concordia Ch,8705,6,3,2,9,18,25,-7,11
FCSB,8706,1,7,6,1,24,13,11,27
CFR Cluj,8706,2,6,7,1,17,9,8,25
FC Botosani,8706,3,4,5,5,7,13,-6,17
Universitate,8706,4,3,7,4,17,21,-4,16
D Bucuresti,8706,5,3,6,5,17,19,-2,15
Concordia Ch,8706,6,2,3,9,15,22,-7,9
FCSB,8707,1,7,5,2,24,14,10,26
CFR Cluj,8707,2,6,7,1,17,10,7,25
Universitate,8707,3,4,6,4,18,20,-2,18
D Bucuresti,8707,4,4,5,5,20,21,-1,17
FC Botosani,8707,5,3,4,7,6,15,-9,13
Concordia Ch,8707,6,3,3,8,18,23,-5,12
CFR Cluj,8708,1,7,6,1,17,8,9,27
FCSB,8708,2,7,5,2,24,13,11,26
Universitate,8708,3,4,5,5,17,22,-5,17
D Bucuresti,8708,4,4,4,6,22,23,-1,16
Concordia Ch,8708,5,4,2,8,21,23,-2,14
FC Botosani,8708,6,3,4,7,5,17,-12,13
FCSB,8709,1,7,6,1,24,13,11,27
CFR Cluj,8709,2,6,7,1,14,7,7,25
Universitate,8709,3,4,5,5,17,20,-3,17
D Bucuresti,8709,4,4,4,6,19,21,-2,16
FC Botosani,8709,5,3,5,6,7,17,-10,14
Concordia Ch,8709,6,3,3,8,20,23,-3,12
FCSB,8710,1,7,6,1,25,13,12,27
CFR Cluj,8710,2,6,7,1,15,8,7,25
D Bucuresti,8710,3,4,5,5,17,18,-1,17
Universitate,8710,4,3,7,4,15,19,-4,16
FC Botosani,8710,5,3,4,7,7,16,-9,13
Concordia Ch,8710,6,3,3,8,18,23,-5,12
FCSB,8711,1,9,5,0,29,13,16,32
CFR Cluj,8711,2,5,6,3,14,12,2,21
D Bucuresti,8711,3,4,5,5,17,18,-1,17
Universitate,8711,4,4,5,5,18,21,-3,17
FC Botosani,8711,5,4,4,6,6,13,-7,16
Concordia Ch,8711,6,2,3,9,15,22,-7,9
FCSB,8712,1,8,6,0,26,12,14,30
CFR Cluj,8712,2,6,7,1,17,9,8,25
D Bucuresti,8712,3,4,5,5,18,19,-1,17
Universitate,8712,4,3,5,6,14,21,-7,14
FC Botosani,8712,5,3,5,6,5,13,-8,14
Concordia Ch,8712,6,2,4,8,16,22,-6,10
FCSB,8713,1,7,6,1,24,13,11,27
CFR Cluj,8713,2,5,8,1,14,8,6,23
Universitate,8713,3,4,6,4,16,18,-2,18
FC Botosani,8713,4,4,4,6,9,14,-5,16
Concordia Ch,8713,5,4,2,8,19,23,-4,14
D Bucuresti,8713,6,3,4,7,17,23,-6,13
FCSB,8714,1,7,7,0,24,11,13,28
CFR Cluj,8714,2,5,8,1,14,8,6,23
FC Botosani,8714,3,4,5,5,7,13,-6,17
Universitate,8714,4,3,7,4,16,20,-4,16
D Bucuresti,8714,5,3,5,6,16,19,-3,14
Concordia Ch,8714,6,2,4,8,16,22,-6,10
FCSB,8715,1,9,5,0,27,11,16,32
CFR Cluj,8715,2,6,6,2,14,9,5,24
FC Botosani,8715,3,4,5,5,8,14,-6,17
D Bucuresti,8715,4,4,4,6,18,20,-2,16
Universitate,8715,5,3,5,6,15,21,-6,14
Concordia Ch,8715,6,2,3,9,18,25,-7,9
FCSB,8716,1,7,6,1,24,12,12,27
CFR Cluj,8716,2,6,6,2,14,8,6,24
Universitate,8716,3,4,6,4,16,19,-3,18
D Bucuresti,8716,4,4,5,5,19,18,1,17
FC Botosani,8716,5,4,4,6,7,16,-9,16
Concordia Ch,8716,6,2,3,9,16,23,-7,9
FCSB,8717,1,8,6,0,25,11,14,30
CFR Cluj,8717,2,5,7,2,14,9,5,22
D Bucuresti,8717,3,4,5,5,18,18,0,17
Universitate,8717,4,3,7,4,16,20,-4,16
FC Botosani,8717,5,3,6,5,5,12,-7,15
Concordia Ch,8717,6,2,3,9,15,23,-8,9
FCSB,8718,1,7,5,2,25,16,9,26
CFR Cluj,8718,2,6,6,2,15,9,6,24
Universitate,8718,3,5,5,4,19,19,0,20
FC Botosani,8718,4,4,4,6,6,13,-7,16
D Bucuresti,8718,5,3,5,6,18,21,-3,14
Concordia Ch,8718,6,3,3,8,18,23,-5,12
FCSB,8719,1,9,5,0,29,11,18,32
CFR Cluj,8719,2,5,7,2,13,10,3,22
D Bucuresti,8719,3,4,5,5,18,19,-1,17
Universitate,8719,4,3,6,5,15,21,-6,15
FC Botosani,8719,5,3,5,6,7,15,-8,14
Concordia Ch,8719,6,3,2,9,17,23,-6,11
FCSB,8720,1,9,5,0,28,11,17,32
CFR Cluj,8720,2,5,7,2,14,11,3,22
FC Botosani,8720,3,5,4,5,10,13,-3,19
Universitate,8720,4,3,6,5,14,19,-5,15
D Bucuresti,8720,5,3,4,7,18,22,-4,13
Concordia Ch,8720,6,3,2,9,17,25,-8,11
FCSB,8721,1,8,6,0,25,11,14,30
CFR Cluj,8721,2,6,7,1,17,9,8,25
D Bucuresti,8721,3,4,5,5,17,18,-1,17
Universitate,8721,4,3,5,6,15,22,-7,14
FC Botosani,8721,5,3,4,7,5,17,-12,13
Concordia Ch,8721,6,3,3,8,19,21,-2,12
FCSB,8722,1,9,5,0,27,12,15,32
CFR Cluj,8722,2,6,6,2,16,8,8,24
FC Botosani,8722,3,4,5,5,6,12,-6,17
D Bucuresti,8722,4,3,6,5,17,19,-2,15
Universitate,8722,5,3,5,6,16,24,-8,14
Concordia Ch,8722,6,2,3,9,16,23,-7,9
FCSB,8723,1,7,7,0,24,11,13,28
CFR Cluj,8723,2,5,8,1,13,7,6,23
D Bucuresti,8723,3,5,4,5,18,18,0,19
Universitate,8723,4,3,7,4,15,19,-4,16
FC Botosani,8723,5,4,4,6,7,13,-6,16
Concordia Ch,8723,6,2,2,10,15,24,-9,8
FCSB,8724,1,8,5,1,24,11,13,29
CFR Cluj,8724,2,6,6,2,14,8,6,24
D Bucuresti,8724,3,5,4,5,23,22,1,19
Universitate,8724,4,4,5,5,15,19,-4,17
FC Botosani,8724,5,3,5,6,7,15,-8,14
Concordia Ch,8724,6,2,3,9,19,27,-8,9
FCSB,8725,1,7,6,1,25,14,11,27
CFR Cluj,8725,2,5,8,1,16,10,6,23
FC Botosani,8725,3,5,4,5,8,12,-4,19
Universitate,8725,4,4,6,4,17,19,-2,18
D Bucuresti,8725,5,3,4,7,16,20,-4,13
Concordia Ch,8725,6,3,2,9,16,23,-7,11
FCSB,8726,1,7,6,1,24,12,12,27
CFR Cluj,8726,2,7,6,1,17,8,9,27
FC Botosani,8726,3,5,4,5,11,14,-3,19
Universitate,8726,4,3,6,5,14,20,-6,15
D Bucuresti,8726,5,3,4,7,17,21,-4,13
Concordia Ch,8726,6,3,2,9,17,25,-8,11
FCSB,8727,1,8,6,0,27,13,14,30
CFR Cluj,8727,2,6,7,1,20,9,11,25
D Bucuresti,8727,3,4,5,5,19,19,0,17
FC Botosani,8727,4,4,4,6,8,14,-6,16
Universitate,8727,5,3,5,6,15,25,-10,14
Concordia Ch,8727,6,2,3,9,16,25,-9,9
FCSB,8728,1,8,6,0,28,14,14,30
CFR Cluj,8728,2,5,7,2,15,10,5,22
D Bucuresti,8728,3,4,4,6,19,21,-2,16
Universitate,8728,4,3,7,4,16,20,-4,16
FC Botosani,8728,5,4,4,6,7,16,-9,16
Concordia Ch,8728,6,3,2,9,19,23,-4,11
FCSB,8729,1,9,5,0,27,10,17,32
CFR Cluj,8729,2,6,6,2,16,11,5,24
D Bucuresti,8729,3,3,6,5,17,19,-2,15
FC Botosani,8729,4,3,6,5,7,14,-7,15
Universitate,8729,5,3,5,6,16,23,-7,14
Concordia Ch,8729,6,2,4,8,16,22,-6,10
FCSB,8730,1,8,5,1,26,12,14,29
CFR Cluj,8730,2,6,6,2,17,11,6,24
D Bucuresti,8730,3,4,5,5,19,19,0,17
Universitate,8730,4,4,5,5,17,22,-5,17
FC Botosani,8730,5,3,6,5,7,14,-7,15
Concordia Ch,8730,6,2,3,9,16,24,-8,9
FCSB,8731,1,8,5,1,25,13,12,29
CFR Cluj,8731,2,5,7,2,14,9,5,22
Universitate,8731,3,4,6,4,16,18,-2,18
FC Botosani,8731,4,4,5,5,7,13,-6,17
D Bucuresti,8731,5,3,5,6,16,19,-3,14
Concordia Ch,8731,6,3,2,9,17,23,-6,11
FCSB,8732,1,7,6,1,24,13,11,27
CFR Cluj,8732,2,7,6,1,17,7,10,27
Universitate,8732,3,3,6,5,15,21,-6,15
FC Botosani,8732,4,3,6,5,5,12,-7,15
D Bucuresti,8732,5,3,5,6,16,22,-6,14
Concordia Ch,8732,6,3,3,8,19,21,-2,12
FCSB,8733,1,7,6,1,24,13,11,27
CFR Cluj,8733,2,7,6,1,17,7,10,27
D Bucuresti,8733,3,4,4,6,17,19,-2,16
FC Botosani,8733,4,4,4,6,7,14,-7,16
Universitate,8733,5,3,6,5,15,21,-6,15
Concordia Ch,8733,6,3,2,9,17,23,-6,11
FCSB,8734,1,8,5,1,26,12,14,29
CFR Cluj,8734,2,6,6,2,15,9,6,24
Universitate,8734,3,4,5,5,16,21,-5,17
D Bucuresti,8734,4,4,4,6,18,23,-5,16
Concordia Ch,8734,5,4,2,8,22,22,0,14
FC Botosani,8734,6,3,4,7,5,15,-10,13
FCSB,8735,1,8,5,1,25,13,12,29
CFR Cluj,8735,2,6,6,2,16,12,4,24
D Bucuresti,8735,3,4,5,5,20,19,1,17
Universitate,8735,4,4,5,5,20,21,-1,17
FC Botosani,8735,5,4,4,6,7,16,-9,16
Concordia Ch,8735,6,2,3,9,17,24,-7,9
FCSB,8736,1,8,5,1,25,11,14,29
CFR Cluj,8736,2,6,6,2,14,8,6,24
Universitate,8736,3,4,5,5,15,20,-5,17
D Bucuresti,8736,4,4,4,6,20,21,-1,16
Concordia Ch,8736,5,4,2,8,18,22,-4,14
FC Botosani,8736,6,3,4,7,6,16,-10,13
FCSB,8737,1,7,7,0,26,13,13,28
CFR Cluj,8737,2,5,8,1,15,9,6,23
D Bucuresti,8737,3,4,5,5,20,20,0,17
Universitate,8737,4,3,7,4,15,19,-4,16
FC Botosani,8737,5,3,6,5,6,13,-7,15
Concordia Ch,8737,6,2,3,9,16,24,-8,9
FCSB,8738,1,8,6,0,25,11,14,30
CFR Cluj,8738,2,5,7,2,14,10,4,22
D Bucuresti,8738,3,4,5,5,20,19,1,17
Universitate,8738,4,4,5,5,16,19,-3,17
FC Botosani,8738,5,4,4,6,7,15,-8,16
Concordia Ch,8738,6,2,3,9,16,24,-8,9
FCSB,8739,1,8,6,0,26,11,15,30
CFR Cluj,8739,2,6,6,2,16,10,6,24
FC Botosani,8739,3,5,4,5,9,14,-5,19
Universitate,8739,4,3,6,5,16,22,-6,15
D Bucuresti,8739,5,3,4,7,16,21,-5,13
Concordia Ch,8739,6,3,2,9,19,24,-5,11
FCSB,8740,1,8,5,1,27,12,15,29
CFR Cluj,8740,2,5,6,3,13,11,2,21
Universitate,8740,3,5,5,4,17,19,-2,20
D Bucuresti,8740,4,4,4,6,18,22,-4,16
FC Botosani,8740,5,3,5,6,7,15,-8,14
Concordia Ch,8740,6,3,3,8,19,22,-3,12
FCSB,8741,1,8,5,1,26,12,14,29
CFR Cluj,8741,2,5,6,3,13,10,3,21
Universitate,8741,3,5,5,4,17,19,-2,20
D Bucuresti,8741,4,5,4,5,24,21,3,19
FC Botosani,8741,5,4,4,6,8,16,-8,16
Concordia Ch,8741,6,2,2,10,16,26,-10,8
FCSB,8742,1,8,6,0,28,13,15,30
CFR Cluj,8742,2,5,7,2,15,11,4,22
FC Botosani,8742,3,5,4,5,9,14,-5,19
Universitate,8742,4,3,7,4,17,21,-4,16
D Bucuresti,8742,5,3,4,7,17,21,-4,13
Concordia Ch,8742,6,3,2,9,17,23,-6,11
FCSB,8743,1,7,5,2,23,14,9,26
CFR Cluj,8743,2,6,6,2,16,11,5,24
Universitate,8743,3,5,5,4,19,18,1,20
D Bucuresti,8743,4,4,5,5,19,19,0,17
FC Botosani,8743,5,3,4,7,7,17,-10,13
Concordia Ch,8743,6,3,3,8,17,22,-5,12
FCSB,8744,1,9,5,0,28,10,18,32
CFR Cluj,8744,2,6,6,2,15,10,5,24
D Bucuresti,8744,3,4,4,6,19,20,-1,16
Universitate,8744,4,3,5,6,14,22,-8,14
FC Botosani,8744,5,3,5,6,6,15,-9,14
Concordia Ch,8744,6,3,3,8,18,23,-5,12
CFR Cluj,8745,1,7,6,1,19,8,11,27
FCSB,8745,2,7,5,2,24,14,10,26
FC Botosani,8745,3,4,5,5,12,16,-4,17
Universitate,8745,4,4,5,5,16,22,-6,17
D Bucuresti,8745,5,3,5,6,21,25,-4,14
Concordia Ch,8745,6,3,2,9,20,27,-7,11
FCSB,8746,1,7,6,1,23,14,9,27
CFR Cluj,8746,2,5,8,1,15,9,6,23
D Bucuresti,8746,3,5,4,5,21,20,1,19
Universitate,8746,4,4,6,4,20,20,0,18
FC Botosani,8746,5,3,4,7,6,15,-9,13
Concordia Ch,8746,6,3,2,9,19,26,-7,11
FCSB,8747,1,8,5,1,24,11,13,29
CFR Cluj,8747,2,6,6,2,14,11,3,24
D Bucuresti,8747,3,5,4,5,18,18,0,19
Universitate,8747,4,4,5,5,18,19,-1,17
FC Botosani,8747,5,4,4,6,7,13,-6,16
Concordia Ch,8747,6,2,2,10,15,24,-9,8
FCSB,8748,1,8,6,0,25,10,15,30
CFR Cluj,8748,2,5,7,2,14,12,2,22
Universitate,8748,3,4,5,5,19,21,-2,17
D Bucuresti,8748,4,4,4,6,18,21,-3,16
FC Botosani,8748,5,4,4,6,8,14,-6,16
Concordia Ch,8748,6,3,2,9,19,25,-6,11
FCSB,8749,1,8,5,1,26,13,13,29
CFR Cluj,8749,2,6,6,2,15,10,5,24
D Bucuresti,8749,3,4,5,5,18,19,-1,17
Universitate,8749,4,4,5,5,19,22,-3,17
FC Botosani,8749,5,4,5,5,7,13,-6,17
Concordia Ch,8749,6,2,2,10,15,23,-8,8
FCSB,8750,1,8,6,0,26,12,14,30
CFR Cluj,8750,2,6,7,1,15,8,7,25
FC Botosani,8750,3,5,4,5,8,13,-5,19
Universitate,8750,4,3,5,6,15,21,-6,14
D Bucuresti,8750,5,3,4,7,17,24,-7,13
Concordia Ch,8750,6,3,2,9,21,24,-3,11
FCSB,8751,1,7,6,1,23,11,12,27
CFR Cluj,8751,2,6,7,1,14,7,7,25
D Bucuresti,8751,3,4,5,5,17,18,-1,17
Universitate,8751,4,3,7,4,14,18,-4,16
FC Botosani,8751,5,3,5,6,6,14,-8,14
Concordia Ch,8751,6,2,4,8,16,22,-6,10
FCSB,8752,1,8,5,1,25,11,14,29
CFR Cluj,8752,2,6,7,1,15,8,7,25
D Bucuresti,8752,3,4,5,5,19,19,0,17
FC Botosani,8752,4,4,4,6,7,14,-7,16
Universitate,8752,5,3,6,5,15,21,-6,15
Concordia Ch,8752,6,2,3,9,16,24,-8,9
FCSB,8753,1,8,5,1,26,13,13,29
CFR Cluj,8753,2,7,6,1,17,8,9,27
D Bucuresti,8753,3,4,4,6,19,22,-3,16
FC Botosani,8753,4,4,4,6,7,14,-7,16
Universitate,8753,5,3,5,6,15,22,-7,14
Concordia Ch,8753,6,3,2,9,18,23,-5,11
FCSB,8754,1,8,6,0,29,15,14,30
CFR Cluj,8754,2,6,7,1,19,10,9,25
D Bucuresti,8754,3,4,4,6,18,22,-4,16
FC Botosani,8754,4,4,4,6,8,15,-7,16
Universitate,8754,5,3,5,6,18,26,-8,14
Concordia Ch,8754,6,3,2,9,20,24,-4,11
FCSB,8755,1,7,6,1,25,16,9,27
CFR Cluj,8755,2,5,8,1,14,8,6,23
Universitate,8755,3,4,6,4,19,19,0,18
FC Botosani,8755,4,4,5,5,6,12,-6,17
D Bucuresti,8755,5,4,4,6,18,20,-2,16
Concordia Ch,8755,6,2,3,9,16,23,-7,9
FCSB,8756,1,8,5,1,26,12,14,29
CFR Cluj,8756,2,6,6,2,15,10,5,24
Universitate,8756,3,4,5,5,15,19,-4,17
FC Botosani,8756,4,4,5,5,6,12,-6,17
D Bucuresti,8756,5,3,5,6,16,19,-3,14
Concordia Ch,8756,6,2,4,8,15,21,-6,10
FCSB,8757,1,8,6,0,26,11,15,30
CFR Cluj,8757,2,5,7,2,14,10,4,22
Universitate,8757,3,3,7,4,16,20,-4,16
Concordia Ch,8757,4,4,2,8,20,23,-3,14
D Bucuresti,8757,5,3,5,6,20,24,-4,14
FC Botosani,8757,6,3,5,6,7,15,-8,14
FCSB,8758,1,7,7,0,25,12,13,28
CFR Cluj,8758,2,5,8,1,15,9,6,23
FC Botosani,8758,3,4,5,5,8,14,-6,17
Universitate,8758,4,3,7,4,16,20,-4,16
D Bucuresti,8758,5,3,5,6,17,21,-4,14
Concordia Ch,8758,6,3,2,9,18,23,-5,11
FCSB,8759,1,8,5,1,26,12,14,29
CFR Cluj,8759,2,6,6,2,14,9,5,24
D Bucuresti,8759,3,5,4,5,22,19,3,19
Universitate,8759,4,4,5,5,16,20,-4,17
FC Botosani,8759,5,4,4,6,7,14,-7,16
Concordia Ch,8759,6,2,2,10,17,28,-11,8
FCSB,8760,1,7,6,1,23,12,11,27
CFR Cluj,8760,2,7,6,1,17,7,10,27
FC Botosani,8760,3,4,5,5,6,12,-6,17
Universitate,8760,4,3,6,5,14,20,-6,15
D Bucuresti,8760,5,3,5,6,18,23,-5,14
Concordia Ch,8760,6,3,2,9,20,24,-4,11
CFR Cluj,8761,1,7,6,1,18,7,11,27
FCSB,8761,2,7,5,2,23,14,9,26
FC Botosani,8761,3,4,5,5,8,12,-4,17
Universitate,8761,4,4,5,5,17,22,-5,17
D Bucuresti,8761,5,3,4,7,16,22,-6,13
Concordia Ch,8761,6,3,3,8,16,21,-5,12
FCSB,8762,1,9,5,0,27,10,17,32
CFR Cluj,8762,2,5,7,2,13,9,4,22
D Bucuresti,8762,3,4,5,5,21,20,1,17
Universitate,8762,4,3,6,5,14,20,-6,15
FC Botosani,8762,5,3,4,7,6,17,-11,13
Concordia Ch,8762,6,3,3,8,17,22,-5,12
FCSB,8763,1,8,5,1,24,14,10,29
CFR Cluj,8763,2,6,6,2,15,9,6,24
Universitate,8763,3,4,5,5,19,20,-1,17
Concordia Ch,8763,4,4,2,8,19,22,-3,14
D Bucuresti,8763,5,3,5,6,18,21,-3,14
FC Botosani,8763,6,3,5,6,6,15,-9,14
FCSB,8764,1,8,6,0,28,12,16,30
CFR Cluj,8764,2,6,6,2,14,10,4,24
D Bucuresti,8764,3,4,5,5,20,21,-1,17
Universitate,8764,4,3,6,5,16,21,-5,15
FC Botosani,8764,5,3,6,5,6,13,-7,15
Concordia Ch,8764,6,2,3,9,17,24,-7,9
FCSB,8765,1,7,6,1,24,12,12,27
CFR Cluj,8765,2,6,7,1,14,7,7,25
Universitate,8765,3,4,5,5,16,20,-4,17
FC Botosani,8765,4,4,4,6,7,14,-7,16
Concordia Ch,8765,5,4,2,8,20,23,-3,14
D Bucuresti,8765,6,3,4,7,17,22,-5,13
FCSB,8766,1,7,7,0,25,12,13,28
CFR Cluj,8766,2,6,7,1,17,10,7,25
D Bucuresti,8766,3,4,4,6,20,19,1,16
Universitate,8766,4,3,6,5,15,20,-5,15
Concordia Ch,8766,5,4,2,8,17,21,-4,14
FC Botosani,8766,6,3,4,7,5,17,-12,13
FCSB,8767,1,8,5,1,25,12,13,29
CFR Cluj,8767,2,7,6,1,16,7,9,27
D Bucuresti,8767,3,5,4,5,18,18,0,19
Universitate,8767,4,3,5,6,15,22,-7,14
FC Botosani,8767,5,3,5,6,7,15,-8,14
Concordia Ch,8767,6,2,3,9,17,24,-7,9
FCSB,8768,1,8,6,0,25,11,14,30
CFR Cluj,8768,2,6,6,2,16,10,6,24
Universitate,8768,3,3,6,5,15,20,-5,15
Concordia Ch,8768,4,4,2,8,19,22,-3,14
D Bucuresti,8768,5,3,5,6,16,19,-3,14
FC Botosani,8768,6,3,5,6,6,15,-9,14
FCSB,8769,1,8,5,1,26,12,14,29
CFR Cluj,8769,2,5,7,2,13,10,3,22
Universitate,8769,3,4,6,4,16,18,-2,18
FC Botosani,8769,4,4,5,5,10,15,-5,17
D Bucuresti,8769,5,3,5,6,17,21,-4,14
Concordia Ch,8769,6,3,2,9,19,25,-6,11
FCSB,8770,1,8,5,1,28,14,14,29
CFR Cluj,8770,2,5,6,3,14,11,3,21
Universitate,8770,3,5,5,4,18,20,-2,20
D Bucuresti,8770,4,4,5,5,19,18,1,17
FC Botosani,8770,5,3,5,6,5,16,-11,14
Concordia Ch,8770,6,3,2,9,19,24,-5,11
FCSB,8771,1,8,5,1,24,11,13,29
CFR Cluj,8771,2,6,6,2,14,8,6,24
Universitate,8771,3,4,5,5,15,19,-4,17
D Bucuresti,8771,4,4,4,6,18,21,-3,16
FC Botosani,8771,5,4,4,6,9,14,-5,16
Concordia Ch,8771,6,3,2,9,17,24,-7,11
FCSB,8772,1,8,5,1,25,13,12,29
CFR Cluj,8772,2,7,6,1,18,8,10,27
D Bucuresti,8772,3,4,4,6,19,19,0,16
FC Botosani,8772,4,4,4,6,6,15,-9,16
Universitate,8772,5,3,5,6,16,23,-7,14
Concordia Ch,8772,6,3,2,9,16,22,-6,11
FCSB,8773,1,8,5,1,25,13,12,29
CFR Cluj,8773,2,6,6,2,15,9,6,24
D Bucuresti,8773,3,5,4,5,18,18,0,19
Universitate,8773,4,4,5,5,17,20,-3,17
FC Botosani,8773,5,4,4,6,6,13,-7,16
Concordia Ch,8773,6,2,2,10,15,23,-8,8
FCSB,8774,1,7,6,1,25,14,11,27
CFR Cluj,8774,2,6,7,1,16,8,8,25
Universitate,8774,3,4,5,5,17,21,-4,17
D Bucuresti,8774,4,4,4,6,19,21,-2,16
FC Botosani,8774,5,4,4,6,7,14,-7,16
Concordia Ch,8774,6,3,2,9,17,23,-6,11
FCSB,8775,1,8,6,0,27,13,14,30
CFR Cluj,8775,2,5,8,1,15,9,6,23
D Bucuresti,8775,3,4,4,6,17,19,-2,16
FC Botosani,8775,4,4,4,6,8,15,-7,16
Universitate,8775,5,3,6,5,17,22,-5,15
Concordia Ch,8775,6,3,2,9,18,24,-6,11
FCSB,8776,1,8,6,0,26,11,15,30
CFR Cluj,8776,2,6,6,2,16,10,6,24
D Bucuresti,8776,3,5,4,5,18,18,0,19
Universitate,8776,4,3,6,5,14,20,-6,15
FC Botosani,8776,5,3,4,7,6,15,-9,13
Concordia Ch,8776,6,3,2,9,17,23,-6,11
FCSB,8777,1,7,6,1,26,15,11,27
CFR Cluj,8777,2,6,7,1,17,10,7,25
D Bucuresti,8777,3,4,5,5,18,19,-1,17
Universitate,8777,4,4,5,5,18,21,-3,17
FC Botosani,8777,5,4,5,5,6,12,-6,17
Concordia Ch,8777,6,2,2,10,16,24,-8,8
FCSB,8778,1,8,5,1,26,13,13,29
CFR Cluj,8778,2,6,6,2,16,10,6,24
Universitate,8778,3,4,5,5,19,23,-4,17
FC Botosani,8778,4,4,4,6,6,13,-7,16
Concordia Ch,8778,5,4,2,8,18,22,-4,14
D Bucuresti,8778,6,3,4,7,17,21,-4,13
FCSB,8779,1,8,5,1,25,15,10,29
CFR Cluj,8779,2,6,6,2,15,9,6,24
Universitate,8779,3,4,5,5,18,19,-1,17
D Bucuresti,8779,4,3,5,6,17,20,-3,14
Concordia Ch,8779,5,4,2,8,18,22,-4,14
FC Botosani,8779,6,3,5,6,5,13,-8,14
FCSB,8780,1,9,5,0,26,11,15,32
CFR Cluj,8780,2,6,6,2,14,8,6,24
FC Botosani,8780,3,4,5,5,7,13,-6,17
D Bucuresti,8780,4,3,5,6,16,20,-4,14
Universitate,8780,5,3,5,6,15,21,-6,14
Concordia Ch,8780,6,3,2,9,18,23,-5,11
FCSB,8781,1,7,6,1,25,13,12,27
CFR Cluj,8781,2,6,7,1,16,9,7,25
D Bucuresti,8781,3,4,5,5,19,20,-1,17
Universitate,8781,4,3,7,4,18,22,-4,16
FC Botosani,8781,5,3,4,7,6,17,-11,13
Concordia Ch,8781,6,3,3,8,19,22,-3,12
FCSB,8782,1,8,6,0,26,12,14,30
CFR Cluj,8782,2,6,6,2,17,11,6,24
D Bucuresti,8782,3,4,5,5,20,21,-1,17
FC Botosani,8782,4,4,5,5,10,14,-4,17
Universitate,8782,5,3,6,5,15,20,-5,15
Concordia Ch,8782,6,2,2,10,16,26,-10,8
FCSB,8783,1,7,6,1,26,14,12,27
CFR Cluj,8783,2,5,8,1,15,9,6,23
FC Botosani,8783,3,5,4,5,7,12,-5,19
Universitate,8783,4,4,6,4,18,21,-3,18
D Bucuresti,8783,5,4,4,6,17,19,-2,16
Concordia Ch,8783,6,2,2,10,15,23,-8,8
FCSB,8784,1,9,5,0,28,11,17,32
CFR Cluj,8784,2,6,6,2,17,9,8,24
D Bucuresti,8784,3,4,4,6,19,24,-5,16
FC Botosani,8784,4,3,5,6,8,16,-8,14
Universitate,8784,5,3,5,6,14,24,-10,14
Concordia Ch,8784,6,3,3,8,20,22,-2,12
FCSB,8785,1,8,6,0,26,11,15,30
CFR Cluj,8785,2,6,6,2,15,9,6,24
FC Botosani,8785,3,4,5,5,7,13,-6,17
Universitate,8785,4,3,6,5,15,21,-6,15
D Bucuresti,8785,5,3,5,6,19,22,-3,14
Concordia Ch,8785,6,2,4,8,17,23,-6,10
FCSB,8786,1,7,5,2,24,13,11,26
CFR Cluj,8786,2,6,6,2,15,10,5,24
Universitate,8786,3,5,5,4,17,18,-1,20
FC Botosani,8786,4,4,5,5,8,13,-5,17
D Bucuresti,8786,5,3,5,6,18,22,-4,14
Concordia Ch,8786,6,3,2,9,18,24,-6,11
FCSB,8787,1,8,5,1,25,12,13,29
CFR Cluj,8787,2,7,6,1,18,7,11,27
D Bucuresti,8787,3,4,5,5,18,19,-1,17
FC Botosani,8787,4,4,5,5,7,12,-5,17
Universitate,8787,5,3,5,6,14,23,-9,14
Concordia Ch,8787,6,2,2,10,16,25,-9,8
FCSB,8788,1,8,5,1,25,12,13,29
CFR Cluj,8788,2,7,6,1,17,8,9,27
D Bucuresti,8788,3,4,5,5,21,19,2,17
Universitate,8788,4,3,5,6,14,21,-7,14
FC Botosani,8788,5,3,5,6,6,14,-8,14
Concordia Ch,8788,6,3,2,9,16,25,-9,11
FCSB,8789,1,8,5,1,26,12,14,29
CFR Cluj,8789,2,6,6,2,16,11,5,24
Universitate,8789,3,4,5,5,16,20,-4,17
D Bucuresti,8789,4,4,4,6,17,19,-2,16
FC Botosani,8789,5,3,5,6,5,13,-8,14
Concordia Ch,8789,6,3,3,8,16,21,-5,12
FCSB,8790,1,9,5,0,27,10,17,32
CFR Cluj,8790,2,6,6,2,14,9,5,24
FC Botosani,8790,3,4,5,5,6,12,-6,17
D Bucuresti,8790,4,4,4,6,19,19,0,16
Universitate,8790,5,3,5,6,14,21,-7,14
Concordia Ch,8790,6,2,3,9,15,24,-9,9
FCSB,8791,1,8,6,0,24,10,14,30
CFR Cluj,8791,2,5,7,2,13,8,5,22
D Bucuresti,8791,3,4,5,5,19,20,-1,17
FC Botosani,8791,4,4,5,5,8,13,-5,17
Universitate,8791,5,3,7,4,14,18,-4,16
Concordia Ch,8791,6,2,2,10,16,25,-9,8
FCSB,8792,1,7,6,1,24,12,12,27
CFR Cluj,8792,2,5,8,1,15,9,6,23
Universitate,8792,3,4,6,4,16,19,-3,18
FC Botosani,8792,4,4,5,5,7,13,-6,17
D Bucuresti,8792,5,3,4,7,17,23,-6,13
Concordia Ch,8792,6,3,3,8,18,21,-3,12
FCSB,8793,1,9,5,0,26,11,15,32
CFR Cluj,8793,2,5,6,3,14,11,3,21
Universitate,8793,3,4,5,5,16,19,-3,17
FC Botosani,8793,4,3,6,5,6,13,-7,15
D Bucuresti,8793,5,3,5,6,18,22,-4,14
Concordia Ch,8793,6,3,3,8,18,22,-4,12
FCSB,8794,1,8,5,1,24,12,12,29
CFR Cluj,8794,2,6,7,1,16,8,8,25
D Bucuresti,8794,3,3,6,5,17,19,-2,15
Universitate,8794,4,3,6,5,15,20,-5,15
FC Botosani,8794,5,3,6,5,6,13,-7,15
Concordia Ch,8794,6,2,4,8,17,23,-6,10
FCSB,8795,1,7,6,1,26,15,11,27
CFR Cluj,8795,2,6,7,1,17,9,8,25
FC Botosani,8795,3,4,5,5,7,13,-6,17
Universitate,8795,4,3,7,4,15,19,-4,16
D Bucuresti,8795,5,3,6,5,18,20,-2,15
Concordia Ch,8795,6,2,3,9,16,23,-7,9
FCSB,8796,1,8,5,1,25,12,13,29
CFR Cluj,8796,2,6,6,2,15,8,7,24
FC Botosani,8796,3,5,4,5,11,14,-3,19
Universitate,8796,4,4,5,5,16,21,-5,17
D Bucuresti,8796,5,3,4,7,17,22,-5,13
Concordia Ch,8796,6,3,2,9,20,27,-7,11
FCSB,8797,1,7,5,2,23,12,11,26
CFR Cluj,8797,2,6,6,2,15,9,6,24
Universitate,8797,3,5,5,4,17,19,-2,20
D Bucuresti,8797,4,4,5,5,18,18,0,17
FC Botosani,8797,5,4,4,6,6,14,-8,16
Concordia Ch,8797,6,2,3,9,15,22,-7,9
FCSB,8798,1,8,6,0,26,10,16,30
CFR Cluj,8798,2,6,7,1,14,7,7,25
D Bucuresti,8798,3,5,4,5,18,18,0,19
Universitate,8798,4,3,5,6,14,22,-8,14
FC Botosani,8798,5,3,5,6,5,13,-8,14
Concordia Ch,8798,6,2,3,9,15,22,-7,9
FCSB,8799,1,9,5,0,28,11,17,32
CFR Cluj,8799,2,6,6,2,17,10,7,24
D Bucuresti,8799,3,3,6,5,17,19,-2,15
FC Botosani,8799,4,3,5,6,6,14,-8,14
Universitate,8799,5,3,5,6,17,26,-9,14
Concordia Ch,8799,6,3,3,8,18,23,-5,12
FCSB,8800,1,8,6,0,27,13,14,30
CFR Cluj,8800,2,6,6,2,16,10,6,24
D Bucuresti,8800,3,4,5,5,17,18,-1,17
FC Botosani,8800,4,4,4,6,7,13,-6,16
Universitate,8800,5,3,6,5,15,20,-5,15
Concordia Ch,8800,6,2,3,9,15,23,-8,9
FCSB,8801,1,9,5,0,27,11,16,32
CFR Cluj,8801,2,5,6,3,13,11,2,21
Universitate,8801,3,4,5,5,17,20,-3,17
D Bucuresti,8801,4,3,6,5,19,21,-2,15
FC Botosani,8801,5,3,5,6,8,16,-8,14
Concordia Ch,8801,6,3,3,8,16,21,-5,12
FCSB,8802,1,8,6,0,28,11,17,30
CFR Cluj,8802,2,5,7,2,14,12,2,22
D Bucuresti,8802,3,4,5,5,21,20,1,17
Universitate,8802,4,3,7,4,16,20,-4,16
FC Botosani,8802,5,4,4,6,6,15,-9,16
Concordia Ch,8802,6,2,3,9,17,24,-7,9
FCSB,8803,1,8,5,1,25,12,13,29
CFR Cluj,8803,2,6,6,2,16,8,8,24
D Bucuresti,8803,3,4,5,5,19,19,0,17
Universitate,8803,4,4,5,5,16,22,-6,17
FC Botosani,8803,5,4,4,6,7,15,-8,16
Concordia Ch,8803,6,2,3,9,17,24,-7,9
FCSB,8804,1,9,5,0,26,11,15,32
CFR Cluj,8804,2,6,6,2,15,8,7,24
D Bucuresti,8804,3,5,4,5,20,19,1,19
FC Botosani,8804,4,4,4,6,7,14,-7,16
Universitate,8804,5,3,5,6,15,22,-7,14
Concordia Ch,8804,6,2,2,10,17,26,-9,8
FCSB,8805,1,8,6,0,28,13,15,30
CFR Cluj,8805,2,6,6,2,15,10,5,24
D Bucuresti,8805,3,5,4,5,20,19,1,19
FC Botosani,8805,4,4,4,6,9,16,-7,16
Universitate,8805,5,3,6,5,16,21,-5,15
Concordia Ch,8805,6,2,2,10,19,28,-9,8
FCSB,8806,1,7,6,1,24,12,12,27
CFR Cluj,8806,2,7,6,1,16,8,8,27
D Bucuresti,8806,3,5,4,5,22,21,1,19
Universitate,8806,4,3,6,5,14,19,-5,15
FC Botosani,8806,5,3,4,7,7,18,-11,13
Concordia Ch,8806,6,3,2,9,18,23,-5,11
FCSB,8807,1,8,5,1,26,13,13,29
CFR Cluj,8807,2,5,6,3,15,11,4,21
Universitate,8807,3,5,5,4,16,18,-2,20
D Bucuresti,8807,4,5,4,5,19,18,1,19
FC Botosani,8807,5,3,4,7,5,14,-9,13
Concordia Ch,8807,6,3,2,9,16,23,-7,11
FCSB,8808,1,7,5,2,24,13,11,26
CFR Cluj,8808,2,6,7,1,15,8,7,25
Universitate,8808,3,4,6,4,15,18,-3,18
D Bucuresti,8808,4,3,6,5,21,23,-2,15
FC Botosani,8808,5,3,5,6,7,15,-8,14
Concordia Ch,8808,6,3,3,8,21,26,-5,12
FCSB,8809,1,8,5,1,25,11,14,29
CFR Cluj,8809,2,7,6,1,15,7,8,27
D Bucuresti,8809,3,4,4,6,17,21,-4,16
Concordia Ch,8809,4,4,2,8,19,21,-2,14
Universitate,8809,5,3,5,6,14,21,-7,14
FC Botosani,8809,6,3,4,7,5,14,-9,13
FCSB,8810,1,8,5,1,27,12,15,29
CFR Cluj,8810,2,5,7,2,14,11,3,22
D Bucuresti,8810,3,5,4,5,20,18,2,19
Universitate,8810,4,4,6,4,17,20,-3,18
FC Botosani,8810,5,4,4,6,6,15,-9,16
Concordia Ch,8810,6,2,2,10,15,23,-8,8
FCSB,8811,1,9,5,0,28,11,17,32
CFR Cluj,8811,2,5,7,2,15,10,5,22
FC Botosani,8811,3,4,5,5,7,13,-6,17
Universitate,8811,4,3,6,5,15,22,-7,15
D Bucuresti,8811,5,3,4,7,17,21,-4,13
Concordia Ch,8811,6,3,3,8,18,23,-5,12
FCSB,8812,1,8,6,0,25,11,14,30
CFR Cluj,8812,2,6,6,2,15,8,7,24
D Bucuresti,8812,3,4,5,5,21,20,1,17
FC Botosani,8812,4,4,4,6,7,16,-9,16
Universitate,8812,5,3,6,5,15,21,-6,15
Concordia Ch,8812,6,2,3,9,18,25,-7,9
FCSB,8813,1,8,5,1,24,11,13,29
CFR Cluj,8813,2,6,6,2,14,8,6,24
Universitate,8813,3,4,5,5,15,19,-4,17
D Bucuresti,8813,4,4,4,6,17,19,-2,16
FC Botosani,8813,5,4,4,6,7,13,-6,16
Concordia Ch,8813,6,3,2,9,16,23,-7,11
FCSB,8814,1,9,5,0,26,10,16,32
CFR Cluj,8814,2,6,6,2,16,10,6,24
D Bucuresti,8814,3,4,4,6,17,21,-4,16
Concordia Ch,8814,4,4,2,8,21,23,-2,14
Universitate,8814,5,3,5,6,15,22,-7,14
FC Botosani,8814,6,3,4,7,7,16,-9,13
FCSB,8815,1,8,6,0,25,10,15,30
CFR Cluj,8815,2,6,7,1,15,8,7,25
FC Botosani,8815,3,4,4,6,9,15,-6,16
Concordia Ch,8815,4,4,2,8,20,22,-2,14
Universitate,8815,5,3,5,6,15,22,-7,14
D Bucuresti,8815,6,3,4,7,17,24,-7,13
FCSB,8816,1,8,6,0,26,12,14,30
CFR Cluj,8816,2,5,7,2,14,9,5,22
Universitate,8816,3,4,5,5,16,20,-4,17
D Bucuresti,8816,4,4,4,6,18,19,-1,16
FC Botosani,8816,5,4,4,6,6,14,-8,16
Concordia Ch,8816,6,3,2,9,16,22,-6,11
FCSB,8817,1,8,6,0,27,11,16,30
CFR Cluj,8817,2,6,6,2,14,10,4,24
D Bucuresti,8817,3,4,4,6,18,19,-1,16
Universitate,8817,4,3,6,5,15,20,-5,15
FC Botosani,8817,5,3,5,6,6,15,-9,14
Concordia Ch,8817,6,3,3,8,17,22,-5,12
FCSB,8818,1,9,5,0,27,10,17,32
CFR Cluj,8818,2,6,6,2,14,9,5,24
D Bucuresti,8818,3,4,4,6,18,19,-1,16
Universitate,8818,4,3,5,6,14,21,-7,14
FC Botosani,8818,5,3,5,6,7,16,-9,14
Concordia Ch,8818,6,3,3,8,18,23,-5,12
FCSB,8819,1,9,5,0,30,13,17,32
CFR Cluj,8819,2,5,6,3,14,11,3,21
D Bucuresti,8819,3,4,5,5,21,20,1,17
Universitate,8819,4,4,5,5,17,22,-5,17
FC Botosani,8819,5,3,5,6,5,15,-10,14
Concordia Ch,8819,6,2,4,8,17,23,-6,10
FCSB,8820,1,7,7,0,27,14,13,28
CFR Cluj,8820,2,5,7,2,14,9,5,22
Universitate,8820,3,4,6,4,18,21,-3,18
FC Botosani,8820,4,4,4,6,9,17,-8,16
D Bucuresti,8820,5,3,5,6,19,22,-3,14
Concordia Ch,8820,6,3,3,8,19,23,-4,12
FCSB,8821,1,8,6,0,29,13,16,30
CFR Cluj,8821,2,5,7,2,14,11,3,22
FC Botosani,8821,3,4,5,5,8,14,-6,17
Universitate,8821,4,3,7,4,18,22,-4,16
D Bucuresti,8821,5,3,4,7,17,22,-5,13
Concordia Ch,8821,6,3,3,8,20,24,-4,12
FCSB,8822,1,7,6,1,24,12,12,27
CFR Cluj,8822,2,7,6,1,16,8,8,27
FC Botosani,8822,3,4,5,5,6,12,-6,17
Universitate,8822,4,3,6,5,14,19,-5,15
D Bucuresti,8822,5,3,5,6,16,19,-3,14
Concordia Ch,8822,6,3,2,9,16,22,-6,11
FCSB,8823,1,8,5,1,25,11,14,29
CFR Cluj,8823,2,7,6,1,16,7,9,27
D Bucuresti,8823,3,4,5,5,19,20,-1,17
FC Botosani,8823,4,3,6,5,6,13,-7,15
Universitate,8823,5,3,5,6,14,22,-8,14
Concordia Ch,8823,6,2,3,9,16,23,-7,9
FCSB,8824,1,8,6,0,26,12,14,30
CFR Cluj,8824,2,5,7,2,14,9,5,22
Universitate,8824,3,4,5,5,16,20,-4,17
D Bucuresti,8824,4,4,4,6,20,21,-1,16
FC Botosani,8824,5,4,4,6,8,16,-8,16
Concordia Ch,8824,6,3,2,9,18,24,-6,11
FCSB,8825,1,8,5,1,25,11,14,29
CFR Cluj,8825,2,7,6,1,15,7,8,27
FC Botosani,8825,3,5,4,5,7,12,-5,19
Universitate,8825,4,3,5,6,14,21,-7,14
D Bucuresti,8825,5,3,4,7,17,21,-4,13
Concordia Ch,8825,6,3,2,9,17,23,-6,11
FCSB,8826,1,9,5,0,25,10,15,32
CFR Cluj,8826,2,6,6,2,14,8,6,24
D Bucuresti,8826,3,4,5,5,20,20,0,17
FC Botosani,8826,4,4,5,5,9,12,-3,17
Universitate,8826,5,3,5,6,14,20,-6,14
Concordia Ch,8826,6,2,2,10,17,29,-12,8
FCSB,8827,1,9,5,0,27,11,16,32
CFR Cluj,8827,2,5,7,2,13,9,4,22
D Bucuresti,8827,3,3,6,5,19,21,-2,15
Universitate,8827,4,3,6,5,15,20,-5,15
FC Botosani,8827,5,3,5,6,7,15,-8,14
Concordia Ch,8827,6,3,3,8,19,24,-5,12
FCSB,8828,1,9,5,0,26,10,16,32
CFR Cluj,8828,2,5,6,3,13,11,2,21
D Bucuresti,8828,3,5,4,5,24,21,3,19
Universitate,8828,4,4,5,5,16,19,-3,17
FC Botosani,8828,5,3,4,7,7,20,-13,13
Concordia Ch,8828,6,3,2,9,22,27,-5,11
FCSB,8829,1,8,6,0,25,11,14,30
CFR Cluj,8829,2,5,7,2,14,9,5,22
D Bucuresti,8829,3,4,4,6,20,22,-2,16
Universitate,8829,4,3,7,4,14,18,-4,16
FC Botosani,8829,5,4,4,6,7,14,-7,16
Concordia Ch,8829,6,3,2,9,19,25,-6,11
FCSB,8830,1,8,5,1,25,12,13,29
CFR Cluj,8830,2,6,6,2,15,9,6,24
D Bucuresti,8830,3,5,4,5,23,20,3,19
Universitate,8830,4,4,5,5,17,21,-4,17
FC Botosani,8830,5,3,4,7,5,18,-13,13
Concordia Ch,8830,6,3,2,9,19,24,-5,11
FCSB,8831,1,9,5,0,27,12,15,32
CFR Cluj,8831,2,5,6,3,13,11,2,21
FC Botosani,8831,3,5,4,5,13,14,-1,19
Universitate,8831,4,4,5,5,19,21,-2,17
D Bucuresti,8831,5,3,4,7,20,28,-8,13
Concordia Ch,8831,6,3,2,9,19,25,-6,11
FCSB,8832,1,8,5,1,27,14,13,29
CFR Cluj,8832,2,6,6,2,17,10,7,24
Universitate,8832,3,4,5,5,16,21,-5,17
FC Botosani,8832,4,3,6,5,5,12,-7,15
D Bucuresti,8832,5,3,5,6,16,20,-4,14
Concordia Ch,8832,6,3,3,8,17,21,-4,12
FCSB,8833,1,8,6,0,27,12,15,30
CFR Cluj,8833,2,6,7,1,16,9,7,25
D Bucuresti,8833,3,5,4,5,18,18,0,19
Universitate,8833,4,3,5,6,14,21,-7,14
FC Botosani,8833,5,3,5,6,6,14,-8,14
Concordia Ch,8833,6,2,3,9,16,23,-7,9
CFR Cluj,8834,1,7,6,1,19,9,10,27
FCSB,8834,2,7,5,2,24,14,10,26
Universitate,8834,3,4,5,5,18,23,-5,17
FC Botosani,8834,4,4,4,6,7,15,-8,16
D Bucuresti,8834,5,3,5,6,20,23,-3,14
Concordia Ch,8834,6,3,3,8,20,24,-4,12
FCSB,8835,1,8,5,1,26,12,14,29
CFR Cluj,8835,2,5,7,2,13,9,4,22
Universitate,8835,3,4,6,4,16,19,-3,18
D Bucuresti,8835,4,4,4,6,21,23,-2,16
FC Botosani,8835,5,4,4,6,8,16,-8,16
Concordia Ch,8835,6,3,2,9,20,25,-5,11
FCSB,8836,1,8,6,0,29,13,16,30
CFR Cluj,8836,2,5,8,1,16,10,6,23
FC Botosani,8836,3,5,4,5,9,12,-3,19
D Bucuresti,8836,4,4,4,6,18,20,-2,16
Universitate,8836,5,3,6,5,16,23,-7,15
Concordia Ch,8836,6,2,2,10,16,26,-10,8
FCSB,8837,1,9,5,0,26,11,15,32
CFR Cluj,8837,2,6,6,2,15,8,7,24
D Bucuresti,8837,3,4,5,5,22,22,0,17
FC Botosani,8837,4,4,4,6,7,15,-8,16
Universitate,8837,5,3,5,6,15,22,-7,14
Concordia Ch,8837,6,2,3,9,20,27,-7,9
FCSB,8838,1,8,5,1,28,15,13,29
CFR Cluj,8838,2,7,6,1,22,8,14,27
D Bucuresti,8838,3,4,5,5,19,20,-1,17
FC Botosani,8838,4,3,5,6,5,13,-8,14
Universitate,8838,5,3,5,6,14,26,-12,14
Concordia Ch,8838,6,3,2,9,18,24,-6,11
FCSB,8839,1,8,6,0,26,11,15,30
CFR Cluj,8839,2,6,7,1,15,8,7,25
D Bucuresti,8839,3,5,4,5,22,19,3,19
Universitate,8839,4,3,5,6,14,21,-7,14
FC Botosani,8839,5,3,5,6,7,18,-11,14
Concordia Ch,8839,6,2,3,9,18,25,-7,9
FCSB,8840,1,8,6,0,25,10,15,30
CFR Cluj,8840,2,6,7,1,14,7,7,25
D Bucuresti,8840,3,4,5,5,20,19,1,17
Universitate,8840,4,3,5,6,14,21,-7,14
FC Botosani,8840,5,3,5,6,6,16,-10,14
Concordia Ch,8840,6,2,4,8,17,23,-6,10
FCSB,8841,1,9,5,0,29,12,17,32
CFR Cluj,8841,2,5,6,3,15,12,3,21
Universitate,8841,3,4,5,5,17,22,-5,17
FC Botosani,8841,4,4,5,5,7,13,-6,17
D Bucuresti,8841,5,4,4,6,18,20,-2,16
Concordia Ch,8841,6,2,3,9,15,22,-7,9
FCSB,8842,1,9,5,0,28,10,18,32
CFR Cluj,8842,2,5,6,3,13,12,1,21
D Bucuresti,8842,3,4,5,5,18,19,-1,17
Universitate,8842,4,4,5,5,16,20,-4,17
FC Botosani,8842,5,4,4,6,7,14,-7,16
Concordia Ch,8842,6,2,3,9,17,24,-7,9
FCSB,8843,1,8,5,1,25,14,11,29
CFR Cluj,8843,2,5,6,3,14,11,3,21
Universitate,8843,3,5,5,4,21,20,1,20
D Bucuresti,8843,4,4,5,5,18,19,-1,17
FC Botosani,8843,5,4,4,6,7,14,-7,16
Concordia Ch,8843,6,2,3,9,17,24,-7,9
FCSB,8844,1,8,6,0,26,12,14,30
CFR Cluj,8844,2,6,6,2,15,8,7,24
D Bucuresti,8844,3,4,4,6,20,22,-2,16
Universitate,8844,4,3,6,5,16,22,-6,15
FC Botosani,8844,5,3,5,6,7,15,-8,14
Concordia Ch,8844,6,3,3,8,19,24,-5,12
FCSB,8845,1,7,6,1,24,12,12,27
CFR Cluj,8845,2,6,6,2,14,8,6,24
Universitate,8845,3,4,6,4,16,19,-3,18
FC Botosani,8845,4,4,5,5,7,13,-6,17
D Bucuresti,8845,5,3,5,6,18,21,-3,14
Concordia Ch,8845,6,2,4,8,16,22,-6,10
FCSB,8846,1,9,5,0,27,10,17,32
CFR Cluj,8846,2,6,6,2,15,8,7,24
D Bucuresti,8846,3,4,5,5,19,20,-1,17
FC Botosani,8846,4,4,4,6,8,15,-7,16
Universitate,8846,5,3,5,6,14,23,-9,14
Concordia Ch,8846,6,2,3,9,17,24,-7,9
FCSB,8847,1,7,6,1,24,12,12,27
CFR Cluj,8847,2,5,7,2,14,9,5,22
Universitate,8847,3,5,5,4,16,18,-2,20
D Bucuresti,8847,4,4,4,6,17,22,-5,16
FC Botosani,8847,5,3,5,6,5,13,-8,14
Concordia Ch,8847,6,3,3,8,19,21,-2,12
FCSB,8848,1,7,7,0,25,12,13,28
CFR Cluj,8848,2,5,8,1,15,9,6,23
D Bucuresti,8848,3,4,5,5,20,21,-1,17
Universitate,8848,4,3,7,4,18,22,-4,16
FC Botosani,8848,5,3,5,6,8,16,-8,14
Concordia Ch,8848,6,2,4,8,17,23,-6,10
FCSB,8849,1,8,6,0,26,12,14,30
CFR Cluj,8849,2,5,7,2,15,10,5,22
D Bucuresti,8849,3,4,4,6,18,20,-2,16
Universitate,8849,4,3,7,4,16,20,-4,16
FC Botosani,8849,5,3,5,6,8,16,-8,14
Concordia Ch,8849,6,3,3,8,18,23,-5,12
FCSB,8850,1,8,5,1,26,13,13,29
CFR Cluj,8850,2,6,7,1,16,9,7,25
D Bucuresti,8850,3,4,5,5,20,21,-1,17
Universitate,8850,4,3,6,5,16,21,-5,15
FC Botosani,8850,5,3,4,7,9,19,-10,13
Concordia Ch,8850,6,3,3,8,24,28,-4,12
FCSB,8851,1,8,5,1,24,11,13,29
CFR Cluj,8851,2,6,7,1,14,7,7,25
FC Botosani,8851,3,4,5,5,8,14,-6,17
Universitate,8851,4,3,6,5,14,19,-5,15
D Bucuresti,8851,5,3,5,6,18,21,-3,14
Concordia Ch,8851,6,2,4,8,17,23,-6,10
FCSB,8852,1,8,6,0,24,10,14,30
CFR Cluj,8852,2,5,6,3,13,9,4,21
Universitate,8852,3,4,6,4,15,18,-3,18
D Bucuresti,8852,4,4,5,5,20,18,2,17
FC Botosani,8852,5,4,5,5,7,12,-5,17
Concordia Ch,8852,6,2,2,10,15,27,-12,8
FCSB,8853,1,8,5,1,26,13,13,29
CFR Cluj,8853,2,6,6,2,16,9,7,24
Universitate,8853,3,4,5,5,16,21,-5,17
FC Botosani,8853,4,4,5,5,8,13,-5,17
D Bucuresti,8853,5,4,4,6,18,21,-3,16
Concordia Ch,8853,6,2,3,9,17,24,-7,9
FCSB,8854,1,8,6,0,29,12,17,30
CFR Cluj,8854,2,5,7,2,13,11,2,22
Universitate,8854,3,3,7,4,16,20,-4,16
FC Botosani,8854,4,4,4,6,6,13,-7,16
D Bucuresti,8854,5,3,5,6,17,20,-3,14
Concordia Ch,8854,6,3,3,8,17,22,-5,12
FCSB,8855,1,8,5,1,24,12,12,29
CFR Cluj,8855,2,6,6,2,15,8,7,24
D Bucuresti,8855,3,5,4,5,21,19,2,19
Universitate,8855,4,4,5,5,16,20,-4,17
FC Botosani,8855,5,4,4,6,8,17,-9,16
Concordia Ch,8855,6,2,2,10,16,24,-8,8
FCSB,8856,1,8,5,1,25,12,13,29
CFR Cluj,8856,2,7,6,1,16,7,9,27
FC Botosani,8856,3,3,6,5,7,14,-7,15
D Bucuresti,8856,4,3,5,6,18,22,-4,14
Universitate,8856,5,3,5,6,15,22,-7,14
Concordia Ch,8856,6,3,3,8,19,23,-4,12
FCSB,8857,1,8,6,0,24,10,14,30
CFR Cluj,8857,2,5,7,2,14,9,5,22
D Bucuresti,8857,3,4,4,6,18,21,-3,16
Universitate,8857,4,3,7,4,15,19,-4,16
FC Botosani,8857,5,4,4,6,8,14,-6,16
Concordia Ch,8857,6,3,2,9,16,22,-6,11
FCSB,8858,1,8,6,0,25,11,14,30
CFR Cluj,8858,2,5,7,2,15,10,5,22
Universitate,8858,3,3,7,4,15,19,-4,16
Concordia Ch,8858,4,4,2,8,20,22,-2,14
D Bucuresti,8858,5,3,5,6,16,19,-3,14
FC Botosani,8858,6,3,5,6,6,16,-10,14
FCSB,8859,1,7,5,2,25,16,9,26
CFR Cluj,8859,2,6,7,1,18,9,9,25
Universitate,8859,3,4,6,4,17,20,-3,18
D Bucuresti,8859,4,4,4,6,21,22,-1,16
FC Botosani,8859,5,4,4,6,8,16,-8,16
Concordia Ch,8859,6,3,2,9,20,26,-6,11
FCSB,8860,1,7,5,2,23,13,10,26
CFR Cluj,8860,2,6,7,1,15,8,7,25
Universitate,8860,3,4,6,4,17,19,-2,18
D Bucuresti,8860,4,4,5,5,18,19,-1,17
FC Botosani,8860,5,3,5,6,7,15,-8,14
Concordia Ch,8860,6,2,4,8,18,24,-6,10
FCSB,8861,1,7,5,2,24,13,11,26
CFR Cluj,8861,2,6,6,2,15,10,5,24
Universitate,8861,3,5,5,4,19,20,-1,20
FC Botosani,8861,4,4,5,5,8,13,-5,17
D Bucuresti,8861,5,3,6,5,17,19,-2,15
Concordia Ch,8861,6,2,3,9,17,25,-8,9
FCSB,8862,1,7,7,0,24,11,13,28
CFR Cluj,8862,2,5,8,1,13,7,6,23
D Bucuresti,8862,3,5,4,5,19,19,0,19
Universitate,8862,4,3,7,4,15,19,-4,16
FC Botosani,8862,5,4,4,6,6,13,-7,16
Concordia Ch,8862,6,2,2,10,16,24,-8,8
FCSB,8863,1,8,5,1,24,12,12,29
CFR Cluj,8863,2,6,6,2,15,8,7,24
Universitate,8863,3,4,5,5,15,19,-4,17
D Bucuresti,8863,4,4,4,6,18,20,-2,16
Concordia Ch,8863,5,4,2,8,20,23,-3,14
FC Botosani,8863,6,3,4,7,6,16,-10,13
FCSB,8864,1,7,6,1,23,11,12,27
CFR Cluj,8864,2,7,6,1,15,7,8,27
FC Botosani,8864,3,5,4,5,7,12,-5,19
D Bucuresti,8864,4,4,4,6,19,20,-1,16
Universitate,8864,5,3,6,5,14,19,-5,15
Concordia Ch,8864,6,2,2,10,16,25,-9,8
FCSB,8865,1,8,6,0,24,10,14,30
CFR Cluj,8865,2,6,7,1,15,7,8,25
FC Botosani,8865,3,4,4,6,8,14,-6,16
D Bucuresti,8865,4,3,5,6,16,20,-4,14
Universitate,8865,5,3,5,6,14,21,-7,14
Concordia Ch,8865,6,3,3,8,17,22,-5,12
FCSB,8866,1,8,5,1,25,11,14,29
CFR Cluj,8866,2,7,6,1,16,7,9,27
FC Botosani,8866,3,5,4,5,8,13,-5,19
Universitate,8866,4,3,5,6,14,22,-8,14
D Bucuresti,8866,5,3,4,7,17,21,-4,13
Concordia Ch,8866,6,3,2,9,16,22,-6,11
FCSB,8867,1,9,5,0,26,10,16,32
CFR Cluj,8867,2,6,6,2,14,8,6,24
FC Botosani,8867,3,4,5,5,7,13,-6,17
Universitate,8867,4,3,5,6,14,21,-7,14
D Bucuresti,8867,5,3,4,7,17,22,-5,13
Concordia Ch,8867,6,3,3,8,17,21,-4,12
FCSB,8868,1,8,5,1,26,14,12,29
CFR Cluj,8868,2,5,7,2,14,11,3,22
Universitate,8868,3,4,6,4,19,19,0,18
D Bucuresti,8868,4,4,4,6,23,21,2,16
Concordia Ch,8868,5,4,2,8,19,23,-4,14
FC Botosani,8868,6,3,4,7,5,18,-13,13
FCSB,8869,1,9,5,0,27,12,15,32
CFR Cluj,8869,2,6,6,2,16,9,7,24
D Bucuresti,8869,3,4,4,6,19,21,-2,16
FC Botosani,8869,4,4,4,6,9,16,-7,16
Universitate,8869,5,3,5,6,15,22,-7,14
Concordia Ch,8869,6,3,2,9,17,23,-6,11
FCSB,8870,1,9,5,0,25,10,15,32
CFR Cluj,8870,2,5,7,2,14,9,5,22
D Bucuresti,8870,3,4,5,5,19,20,-1,17
Universitate,8870,4,3,6,5,15,20,-5,15
FC Botosani,8870,5,3,5,6,7,15,-8,14
Concordia Ch,8870,6,2,4,8,17,23,-6,10
FCSB,8871,1,8,5,1,24,12,12,29
CFR Cluj,8871,2,6,6,2,16,8,8,24
D Bucuresti,8871,3,5,4,5,18,18,0,19
Universitate,8871,4,4,5,5,16,21,-5,17
FC Botosani,8871,5,3,5,6,6,14,-8,14
Concordia Ch,8871,6,2,3,9,16,23,-7,9
FCSB,8872,1,8,5,1,25,12,13,29
CFR Cluj,8872,2,5,7,2,13,8,5,22
FC Botosani,8872,3,5,4,5,7,12,-5,19
Universitate,8872,4,4,6,4,16,19,-3,18
D Bucuresti,8872,5,3,4,7,16,21,-5,13
Concordia Ch,8872,6,3,2,9,17,22,-5,11
FCSB,8873,1,8,5,1,25,14,11,29
CFR Cluj,8873,2,5,6,3,14,10,4,21
Universitate,8873,3,5,5,4,18,18,0,20
D Bucuresti,8873,4,4,5,5,17,18,-1,17
FC Botosani,8873,5,4,5,5,8,13,-5,17
Concordia Ch,8873,6,2,2,10,16,25,-9,8
FCSB,8874,1,9,5,0,29,13,16,32
CFR Cluj,8874,2,6,6,2,17,12,5,24
D Bucuresti,8874,3,4,5,5,21,21,0,17
FC Botosani,8874,4,4,4,6,9,16,-7,16
Universitate,8874,5,3,5,6,16,22,-6,14
Concordia Ch,8874,6,2,3,9,16,24,-8,9
FCSB,8875,1,9,5,0,29,11,18,32
CFR Cluj,8875,2,5,6,3,14,13,1,21
Universitate,8875,3,4,5,5,17,21,-4,17
D Bucuresti,8875,4,4,4,6,21,20,1,16
Concordia Ch,8875,5,4,2,8,20,23,-3,14
FC Botosani,8875,6,3,4,7,6,19,-13,13
FCSB,8876,1,7,5,2,25,14,11,26
CFR Cluj,8876,2,6,6,2,17,11,6,24
Universitate,8876,3,5,5,4,17,19,-2,20
FC Botosani,8876,4,4,5,5,8,13,-5,17
D Bucuresti,8876,5,3,6,5,18,20,-2,15
Concordia Ch,8876,6,2,3,9,16,24,-8,9
FCSB,8877,1,7,7,0,24,11,13,28
CFR Cluj,8877,2,5,7,2,14,9,5,22
Universitate,8877,3,4,6,4,15,18,-3,18
FC Botosani,8877,4,4,5,5,8,13,-5,17
D Bucuresti,8877,5,3,5,6,17,20,-3,14
Concordia Ch,8877,6,3,2,9,16,23,-7,11
FCSB,8878,1,8,5,1,25,12,13,29
CFR Cluj,8878,2,6,6,2,16,10,6,24
Universitate,8878,3,4,5,5,17,21,-4,17
Concordia Ch,8878,4,4,2,8,19,22,-3,14
D Bucuresti,8878,5,3,5,6,17,20,-3,14
FC Botosani,8878,6,3,5,6,5,14,-9,14
FCSB,8879,1,8,5,1,27,16,11,29
CFR Cluj,8879,2,5,7,2,15,11,4,22
Universitate,8879,3,4,6,4,20,20,0,18
D Bucuresti,8879,4,4,4,6,18,22,-4,16
FC Botosani,8879,5,3,5,6,6,14,-8,14
Concordia Ch,8879,6,3,3,8,18,21,-3,12
FCSB,8880,1,8,6,0,26,11,15,30
CFR Cluj,8880,2,5,7,2,14,10,4,22
D Bucuresti,8880,3,5,4,5,21,20,1,19
Universitate,8880,4,3,7,4,16,20,-4,16
FC Botosani,8880,5,4,4,6,9,17,-8,16
Concordia Ch,8880,6,2,2,10,16,24,-8,8
FCSB,8881,1,8,5,1,26,12,14,29
CFR Cluj,8881,2,5,6,3,13,10,3,21
Universitate,8881,3,5,5,4,17,19,-2,20
FC Botosani,8881,4,5,4,5,10,13,-3,19
D Bucuresti,8881,5,3,4,7,19,25,-6,13
Concordia Ch,8881,6,3,2,9,18,24,-6,11
FCSB,8882,1,7,5,2,23,13,10,26
CFR Cluj,8882,2,6,6,2,18,11,7,24
Universitate,8882,3,5,5,4,19,21,-2,20
D Bucuresti,8882,4,4,4,6,20,22,-2,16
FC Botosani,8882,5,4,4,6,7,14,-7,16
Concordia Ch,8882,6,3,2,9,18,24,-6,11
FCSB,8883,1,8,5,1,27,13,14,29
CFR Cluj,8883,2,6,6,2,17,12,5,24
Universitate,8883,3,4,5,5,16,20,-4,17
FC Botosani,8883,4,4,5,5,8,13,-5,17
D Bucuresti,8883,5,3,6,5,18,20,-2,15
Concordia Ch,8883,6,2,3,9,16,24,-8,9
FCSB,8884,1,8,6,0,26,11,15,30
CFR Cluj,8884,2,6,6,2,14,9,5,24
D Bucuresti,8884,3,5,4,5,19,18,1,19
Universitate,8884,4,3,6,5,15,20,-5,15
FC Botosani,8884,5,3,4,7,6,16,-10,13
Concordia Ch,8884,6,3,2,9,17,23,-6,11
FCSB,8885,1,8,5,1,27,13,14,29
CFR Cluj,8885,2,5,7,2,14,10,4,22
Universitate,8885,3,4,6,4,18,21,-3,18
D Bucuresti,8885,4,4,5,5,20,20,0,17
FC Botosani,8885,5,4,4,6,10,15,-5,16
Concordia Ch,8885,6,2,3,9,16,26,-10,9
FCSB,8886,1,9,5,0,28,12,16,32
CFR Cluj,8886,2,6,6,2,17,10,7,24
D Bucuresti,8886,3,4,5,5,18,19,-1,17
Universitate,8886,4,3,5,6,15,23,-8,14
FC Botosani,8886,5,3,5,6,5,13,-8,14
Concordia Ch,8886,6,2,4,8,16,22,-6,10
FCSB,8887,1,8,6,0,26,12,14,30
CFR Cluj,8887,2,5,7,2,14,10,4,22
FC Botosani,8887,3,5,4,5,9,14,-5,19
Universitate,8887,4,4,5,5,17,20,-3,17
D Bucuresti,8887,5,3,5,6,18,21,-3,14
Concordia Ch,8887,6,2,3,9,17,24,-7,9
FCSB,8888,1,7,6,1,23,12,11,27
CFR Cluj,8888,2,5,7,2,13,8,5,22
Universitate,8888,3,5,5,4,17,18,-1,20
FC Botosani,8888,4,5,4,5,10,12,-2,19
D Bucuresti,8888,5,4,4,6,17,21,-4,16
Concordia Ch,8888,6,2,2,10,15,24,-9,8
FCSB,8889,1,7,6,1,25,15,10,27
CFR Cluj,8889,2,6,7,1,18,9,9,25
Universitate,8889,3,3,7,4,18,22,-4,16
D Bucuresti,8889,4,3,6,5,19,21,-2,15
FC Botosani,8889,5,3,5,6,8,16,-8,14
Concordia Ch,8889,6,3,3,8,18,23,-5,12
FCSB,8890,1,7,6,1,23,11,12,27
CFR Cluj,8890,2,6,7,1,14,7,7,25
D Bucuresti,8890,3,4,5,5,17,18,-1,17
FC Botosani,8890,4,4,5,5,7,12,-5,17
Universitate,8890,5,3,7,4,14,18,-4,16
Concordia Ch,8890,6,2,2,10,15,24,-9,8
FCSB,8891,1,8,6,0,25,11,14,30
CFR Cluj,8891,2,6,6,2,16,8,8,24
FC Botosani,8891,3,4,5,5,7,13,-6,17
Universitate,8891,4,3,6,5,15,22,-7,15
D Bucuresti,8891,5,3,5,6,18,21,-3,14
Concordia Ch,8891,6,3,2,9,17,23,-6,11
FCSB,8892,1,7,5,2,23,12,11,26
CFR Cluj,8892,2,6,7,1,14,7,7,25
D Bucuresti,8892,3,5,4,5,21,18,3,19
Universitate,8892,4,4,6,4,15,18,-3,18
FC Botosani,8892,5,3,4,7,5,17,-12,13
Concordia Ch,8892,6,3,2,9,17,23,-6,11
FCSB,8893,1,9,5,0,28,12,16,32
CFR Cluj,8893,2,5,6,3,14,11,3,21
Universitate,8893,3,4,5,5,18,22,-4,17
FC Botosani,8893,4,4,5,5,9,15,-6,17
D Bucuresti,8893,5,4,4,6,20,20,0,16
Concordia Ch,8893,6,2,3,9,17,26,-9,9
FCSB,8894,1,8,6,0,29,14,15,30
CFR Cluj,8894,2,5,6,3,14,11,3,21
Universitate,8894,3,4,6,4,18,21,-3,18
FC Botosani,8894,4,3,6,5,6,13,-7,15
D Bucuresti,8894,5,3,5,6,16,21,-5,14
Concordia Ch,8894,6,3,3,8,19,22,-3,12
FCSB,8895,1,8,6,0,26,11,15,30
CFR Cluj,8895,2,6,6,2,15,9,6,24
D Bucuresti,8895,3,5,4,5,18,18,0,19
Universitate,8895,4,3,6,5,15,21,-6,15
FC Botosani,8895,5,3,4,7,6,16,-10,13
Concordia Ch,8895,6,3,2,9,18,23,-5,11
FCSB,8896,1,7,6,1,26,15,11,27
CFR Cluj,8896,2,7,6,1,18,8,10,27
D Bucuresti,8896,3,4,4,6,20,21,-1,16
FC Botosani,8896,4,4,4,6,9,16,-7,16
Universitate,8896,5,3,6,5,16,22,-6,15
Concordia Ch,8896,6,3,2,9,20,27,-7,11
FCSB,8897,1,8,6,0,25,11,14,30
CFR Cluj,8897,2,5,7,2,14,9,5,22
FC Botosani,8897,3,4,5,5,12,15,-3,17
Universitate,8897,4,3,7,4,14,18,-4,16
D Bucuresti,8897,5,3,6,5,21,23,-2,15
Concordia Ch,8897,6,2,3,9,19,29,-10,9
FCSB,8898,1,8,5,1,26,14,12,29
CFR Cluj,8898,2,5,6,3,14,10,4,21
Universitate,8898,3,5,5,4,18,19,-1,20
FC Botosani,8898,4,3,6,5,8,15,-7,15
D Bucuresti,8898,5,3,5,6,18,22,-4,14
Concordia Ch,8898,6,3,3,8,20,24,-4,12
FCSB,8899,1,9,5,0,27,10,17,32
CFR Cluj,8899,2,6,6,2,15,10,5,24
D Bucuresti,8899,3,4,4,6,17,22,-5,16
FC Botosani,8899,4,4,4,6,7,14,-7,16
Universitate,8899,5,3,5,6,15,22,-7,14
Concordia Ch,8899,6,3,2,9,20,23,-3,11
FCSB,8900,1,9,5,0,28,11,17,32
CFR Cluj,8900,2,5,7,2,14,11,3,22
D Bucuresti,8900,3,5,4,5,19,19,0,19
Universitate,8900,4,3,6,5,16,21,-5,15
FC Botosani,8900,5,3,5,6,7,15,-8,14
Concordia Ch,8900,6,2,3,9,18,25,-7,9
FCSB,8901,1,7,7,0,24,11,13,28
CFR Cluj,8901,2,6,7,1,15,8,7,25
D Bucuresti,8901,3,3,6,5,17,19,-2,15
Universitate,8901,4,3,6,5,16,21,-5,15
FC Botosani,8901,5,3,6,5,5,12,-7,15
Concordia Ch,8901,6,2,4,8,16,22,-6,10
FCSB,8902,1,7,7,0,25,12,13,28
CFR Cluj,8902,2,6,7,1,16,8,8,25
D Bucuresti,8902,3,4,4,6,19,23,-4,16
FC Botosani,8902,4,4,4,6,8,15,-7,16
Universitate,8902,5,3,6,5,15,21,-6,15
Concordia Ch,8902,6,3,2,9,19,23,-4,11
FCSB,8903,1,8,6,0,25,11,14,30
CFR Cluj,8903,2,6,6,2,15,9,6,24
D Bucuresti,8903,3,3,6,5,18,20,-2,15
Universitate,8903,4,3,6,5,14,19,-5,15
FC Botosani,8903,5,3,6,5,7,14,-7,15
Concordia Ch,8903,6,2,4,8,17,23,-6,10
FCSB,8904,1,8,5,1,24,13,11,29
CFR Cluj,8904,2,6,6,2,15,8,7,24
D Bucuresti,8904,3,5,4,5,20,19,1,19
Universitate,8904,4,4,5,5,17,20,-3,17
FC Botosani,8904,5,3,4,7,5,16,-11,13
Concordia Ch,8904,6,3,2,9,18,23,-5,11
FCSB,8905,1,9,5,0,28,10,18,32
CFR Cluj,8905,2,5,7,2,14,10,4,22
D Bucuresti,8905,3,4,5,5,19,20,-1,17
Universitate,8905,4,3,6,5,15,22,-7,15
FC Botosani,8905,5,3,4,7,6,15,-9,13
Concordia Ch,8905,6,3,3,8,17,22,-5,12
FCSB,8906,1,7,7,0,26,13,13,28
CFR Cluj,8906,2,6,7,1,17,10,7,25
FC Botosani,8906,3,4,4,6,8,13,-5,16
Universitate,8906,4,3,6,5,16,21,-5,15
D Bucuresti,8906,5,3,5,6,17,22,-5,14
Concordia Ch,8906,6,3,3,8,17,22,-5,12
FCSB,8907,1,7,6,1,24,12,12,27
CFR Cluj,8907,2,5,8,1,14,8,6,23
Universitate,8907,3,4,6,4,15,18,-3,18
D Bucuresti,8907,4,4,4,6,18,20,-2,16
Concordia Ch,8907,5,4,2,8,18,22,-4,14
FC Botosani,8907,6,3,4,7,5,14,-9,13
FCSB,8908,1,8,5,1,25,12,13,29
CFR Cluj,8908,2,5,7,2,14,9,5,22
Universitate,8908,3,4,6,4,17,20,-3,18
FC Botosani,8908,4,3,6,5,6,13,-7,15
D Bucuresti,8908,5,3,5,6,17,22,-5,14
Concordia Ch,8908,6,3,3,8,18,21,-3,12
FCSB,8909,1,9,5,0,29,12,17,32
CFR Cluj,8909,2,6,6,2,16,12,4,24
D Bucuresti,8909,3,3,6,5,18,20,-2,15
FC Botosani,8909,4,3,6,5,6,13,-7,15
Universitate,8909,5,3,5,6,16,22,-6,14
Concordia Ch,8909,6,2,4,8,16,22,-6,10
FCSB,8910,1,7,6,1,24,12,12,27
CFR Cluj,8910,2,7,6,1,16,8,8,27
D Bucuresti,8910,3,4,4,6,18,21,-3,16
Universitate,8910,4,3,6,5,14,19,-5,15
FC Botosani,8910,5,3,5,6,8,16,-8,14
Concordia Ch,8910,6,3,3,8,19,23,-4,12
FCSB,8911,1,7,6,1,24,13,11,27
CFR Cluj,8911,2,7,6,1,18,8,10,27
D Bucuresti,8911,3,4,5,5,17,18,-1,17
Universitate,8911,4,3,6,5,16,22,-6,15
FC Botosani,8911,5,3,5,6,5,13,-8,14
Concordia Ch,8911,6,2,4,8,15,21,-6,10
FCSB,8912,1,9,5,0,30,11,19,32
CFR Cluj,8912,2,6,6,2,15,10,5,24
D Bucuresti,8912,3,5,4,5,19,19,0,19
Universitate,8912,4,3,5,6,15,24,-9,14
FC Botosani,8912,5,3,4,7,7,16,-9,13
Concordia Ch,8912,6,3,2,9,17,23,-6,11
FCSB,8913,1,7,6,1,24,12,12,27
CFR Cluj,8913,2,5,7,2,13,8,5,22
Universitate,8913,3,5,5,4,17,19,-2,20
FC Botosani,8913,4,4,5,5,6,12,-6,17
D Bucuresti,8913,5,3,5,6,16,19,-3,14
Concordia Ch,8913,6,3,2,9,16,22,-6,11
FCSB,8914,1,7,7,0,27,14,13,28
CFR Cluj,8914,2,6,7,1,16,8,8,25
FC Botosani,8914,3,5,4,5,9,12,-3,19
Universitate,8914,4,3,6,5,17,23,-6,15
D Bucuresti,8914,5,3,5,6,16,19,-3,14
Concordia Ch,8914,6,2,3,9,15,24,-9,9
CFR Cluj,8915,1,7,6,1,17,9,8,27
FCSB,8915,2,7,5,2,25,16,9,26
D Bucuresti,8915,3,5,4,5,19,18,1,19
Universitate,8915,4,4,5,5,17,19,-2,17
FC Botosani,8915,5,3,4,7,6,16,-10,13
Concordia Ch,8915,6,3,2,9,17,23,-6,11
FCSB,8916,1,8,6,0,24,10,14,30
CFR Cluj,8916,2,5,7,2,13,10,3,22
Universitate,8916,3,4,5,5,17,19,-2,17
FC Botosani,8916,4,4,5,5,9,13,-4,17
D Bucuresti,8916,5,3,6,5,17,19,-2,15
Concordia Ch,8916,6,2,3,9,15,24,-9,9
FCSB,8917,1,8,6,0,25,11,14,30
CFR Cluj,8917,2,5,7,2,15,10,5,22
Universitate,8917,3,3,7,4,15,19,-4,16
FC Botosani,8917,4,3,6,5,9,16,-7,15
D Bucuresti,8917,5,3,5,6,18,21,-3,14
Concordia Ch,8917,6,3,3,8,20,25,-5,12
FCSB,8918,1,9,5,0,28,10,18,32
CFR Cluj,8918,2,6,6,2,16,11,5,24
D Bucuresti,8918,3,4,4,6,17,20,-3,16
FC Botosani,8918,4,4,4,6,7,14,-7,16
Universitate,8918,5,3,5,6,15,23,-8,14
Concordia Ch,8918,6,3,2,9,17,22,-5,11
FCSB,8919,1,8,6,0,26,11,15,30
CFR Cluj,8919,2,5,7,2,14,9,5,22
D Bucuresti,8919,3,5,4,5,20,20,0,19
Universitate,8919,4,4,5,5,15,20,-5,17
FC Botosani,8919,5,4,4,6,8,15,-7,16
Concordia Ch,8919,6,2,2,10,17,25,-8,8
FCSB,8920,1,9,5,0,26,11,15,32
CFR Cluj,8920,2,5,7,2,13,8,5,22
D Bucuresti,8920,3,5,4,5,20,18,2,19
Universitate,8920,4,3,6,5,15,20,-5,15
FC Botosani,8920,5,3,5,6,6,14,-8,14
Concordia Ch,8920,6,2,3,9,16,25,-9,9
FCSB,8921,1,8,5,1,24,12,12,29
CFR Cluj,8921,2,5,6,3,14,11,3,21
Universitate,8921,3,5,5,4,19,19,0,20
FC Botosani,8921,4,5,4,5,7,12,-5,19
D Bucuresti,8921,5,3,4,7,19,25,-6,13
Concordia Ch,8921,6,3,2,9,21,25,-4,11
FCSB,8922,1,8,6,0,27,13,14,30
CFR Cluj,8922,2,6,6,2,22,11,11,24
FC Botosani,8922,3,4,5,5,7,13,-6,17
Universitate,8922,4,3,6,5,16,26,-10,15
D Bucuresti,8922,5,3,5,6,16,19,-3,14
Concordia Ch,8922,6,3,2,9,17,23,-6,11
FCSB,8923,1,9,5,0,26,11,15,32
CFR Cluj,8923,2,6,6,2,14,8,6,24
D Bucuresti,8923,3,3,5,6,16,19,-3,14
Concordia Ch,8923,4,4,2,8,17,21,-4,14
Universitate,8923,5,3,5,6,15,21,-6,14
FC Botosani,8923,6,3,5,6,5,13,-8,14
FCSB,8924,1,8,6,0,25,10,15,30
CFR Cluj,8924,2,6,7,1,15,7,8,25
D Bucuresti,8924,3,3,6,5,18,20,-2,15
Universitate,8924,4,3,5,6,14,22,-8,14
FC Botosani,8924,5,3,5,6,6,15,-9,14
Concordia Ch,8924,6,3,3,8,18,22,-4,12
FCSB,8925,1,7,6,1,24,15,9,27
CFR Cluj,8925,2,5,8,1,16,10,6,23
Universitate,8925,3,4,6,4,20,20,0,18
D Bucuresti,8925,4,4,4,6,18,21,-3,16
Concordia Ch,8925,5,4,2,8,19,22,-3,14
FC Botosani,8925,6,3,4,7,7,16,-9,13
CFR Cluj,8926,1,7,6,1,16,8,8,27
FCSB,8926,2,7,5,2,24,13,11,26
FC Botosani,8926,3,5,4,5,9,12,-3,19
Universitate,8926,4,4,5,5,17,21,-4,17
D Bucuresti,8926,5,3,4,7,17,22,-5,13
Concordia Ch,8926,6,3,2,9,17,24,-7,11
FCSB,8927,1,7,7,0,25,12,13,28
CFR Cluj,8927,2,6,7,1,17,9,8,25
D Bucuresti,8927,3,4,4,6,19,19,0,16
FC Botosani,8927,4,4,4,6,7,15,-8,16
Universitate,8927,5,3,6,5,16,22,-6,15
Concordia Ch,8927,6,3,2,9,16,23,-7,11
FCSB,8928,1,8,6,0,26,12,14,30
CFR Cluj,8928,2,6,6,2,15,9,6,24
D Bucuresti,8928,3,4,4,6,19,20,-1,16
Universitate,8928,4,3,6,5,17,22,-5,15
FC Botosani,8928,5,3,5,6,7,16,-9,14
Concordia Ch,8928,6,3,3,8,17,22,-5,12
FCSB,8929,1,8,5,1,25,13,12,29
CFR Cluj,8929,2,7,6,1,19,7,12,27
FC Botosani,8929,3,5,4,5,10,13,-3,19
Universitate,8929,4,3,5,6,14,23,-9,14
D Bucuresti,8929,5,3,4,7,17,23,-6,13
Concordia Ch,8929,6,3,2,9,16,22,-6,11
CFR Cluj,8930,1,7,6,1,16,7,9,27
FCSB,8930,2,7,5,2,24,14,10,26
D Bucuresti,8930,3,4,5,5,19,20,-1,17
Universitate,8930,4,4,5,5,17,21,-4,17
FC Botosani,8930,5,4,4,6,6,13,-7,16
Concordia Ch,8930,6,2,3,9,17,24,-7,9
FCSB,8931,1,8,5,1,25,11,14,29
CFR Cluj,8931,2,7,6,1,17,7,10,27
FC Botosani,8931,3,5,4,5,10,14,-4,19
D Bucuresti,8931,4,3,5,6,20,23,-3,14
Universitate,8931,5,3,5,6,14,23,-9,14
Concordia Ch,8931,6,2,3,9,17,25,-8,9
FCSB,8932,1,7,6,1,25,15,10,27
CFR Cluj,8932,2,6,7,1,16,9,7,25
FC Botosani,8932,3,5,4,5,9,12,-3,19
Universitate,8932,4,4,5,5,19,21,-2,17
D Bucuresti,8932,5,4,4,6,18,20,-2,16
Concordia Ch,8932,6,2,2,10,15,25,-10,8
CFR Cluj,8933,1,7,6,1,18,7,11,27
FCSB,8933,2,7,5,2,25,15,10,26
Universitate,8933,3,4,5,5,17,23,-6,17
D Bucuresti,8933,4,4,4,6,19,22,-3,16
FC Botosani,8933,5,3,5,6,6,14,-8,14
Concordia Ch,8933,6,3,3,8,18,22,-4,12
FCSB,8934,1,7,6,1,23,12,11,27
CFR Cluj,8934,2,5,8,1,14,8,6,23
FC Botosani,8934,3,5,4,5,9,13,-4,19
Universitate,8934,4,4,6,4,17,19,-2,18
D Bucuresti,8934,5,3,4,7,17,22,-5,13
Concordia Ch,8934,6,3,2,9,17,23,-6,11
FCSB,8935,1,7,5,2,24,14,10,26
CFR Cluj,8935,2,6,6,2,14,8,6,24
Universitate,8935,3,5,5,4,18,19,-1,20
D Bucuresti,8935,4,4,5,5,22,19,3,17
FC Botosani,8935,5,3,4,7,5,18,-13,13
Concordia Ch,8935,6,3,3,8,17,22,-5,12
FCSB,8936,1,8,5,1,26,12,14,29
CFR Cluj,8936,2,7,6,1,16,8,8,27
D Bucuresti,8936,3,4,5,5,18,18,0,17
FC Botosani,8936,4,4,5,5,8,13,-5,17
Universitate,8936,5,3,5,6,16,23,-7,14
Concordia Ch,8936,6,2,2,10,16,26,-10,8
FCSB,8937,1,8,6,0,26,11,15,30
CFR Cluj,8937,2,5,8,1,15,9,6,23
FC Botosani,8937,3,4,5,5,9,15,-6,17
D Bucuresti,8937,4,4,4,6,20,22,-2,16
Universitate,8937,5,3,6,5,15,21,-6,15
Concordia Ch,8937,6,2,3,9,17,24,-7,9
FCSB,8938,1,7,7,0,25,12,13,28
CFR Cluj,8938,2,5,8,1,13,7,6,23
D Bucuresti,8938,3,4,5,5,20,21,-1,17
Universitate,8938,4,3,7,4,16,20,-4,16
FC Botosani,8938,5,3,5,6,5,13,-8,14
Concordia Ch,8938,6,3,2,9,19,25,-6,11
FCSB,8939,1,8,5,1,25,14,11,29
CFR Cluj,8939,2,6,6,2,16,10,6,24
D Bucuresti,8939,3,4,5,5,19,19,0,17
Universitate,8939,4,4,5,5,18,20,-2,17
FC Botosani,8939,5,3,5,6,6,15,-9,14
Concordia Ch,8939,6,2,4,8,17,23,-6,10
CFR Cluj,8940,1,7,6,1,18,8,10,27
FCSB,8940,2,7,5,2,23,12,11,26
D Bucuresti,8940,3,5,4,5,22,19,3,19
Universitate,8940,4,4,5,5,16,22,-6,17
FC Botosani,8940,5,4,4,6,7,17,-10,16
Concordia Ch,8940,6,2,2,10,17,25,-8,8
FCSB,8941,1,9,5,0,26,11,15,32
CFR Cluj,8941,2,5,7,2,14,9,5,22
D Bucuresti,8941,3,4,4,6,22,24,-2,16
Universitate,8941,4,3,6,5,14,19,-5,15
FC Botosani,8941,5,3,5,6,8,16,-8,14
Concordia Ch,8941,6,3,3,8,20,25,-5,12
FCSB,8942,1,8,5,1,27,14,13,29
CFR Cluj,8942,2,5,7,2,15,10,5,22
Universitate,8942,3,4,6,4,18,21,-3,18
D Bucuresti,8942,4,4,4,6,21,23,-2,16
FC Botosani,8942,5,4,4,6,8,15,-7,16
Concordia Ch,8942,6,3,2,9,18,24,-6,11
FCSB,8943,1,8,5,1,26,14,12,29
CFR Cluj,8943,2,6,6,2,16,9,7,24
D Bucuresti,8943,3,4,5,5,21,20,1,17
Universitate,8943,4,4,5,5,17,21,-4,17
FC Botosani,8943,5,3,4,7,5,16,-11,13
Concordia Ch,8943,6,3,3,8,18,23,-5,12
FCSB,8944,1,8,6,0,26,11,15,30
CFR Cluj,8944,2,6,6,2,16,9,7,24
D Bucuresti,8944,3,5,4,5,21,21,0,19
FC Botosani,8944,4,4,4,6,8,14,-6,16
Universitate,8944,5,3,6,5,15,22,-7,15
Concordia Ch,8944,6,2,2,10,19,28,-9,8
FCSB,8945,1,7,7,0,27,14,13,28
CFR Cluj,8945,2,5,8,1,17,11,6,23
Universitate,8945,3,3,7,4,16,20,-4,16
FC Botosani,8945,4,3,6,5,7,14,-7,15
D Bucuresti,8945,5,3,5,6,18,21,-3,14
Concordia Ch,8945,6,3,3,8,18,23,-5,12
FCSB,8946,1,7,6,1,23,11,12,27
CFR Cluj,8946,2,6,6,2,14,8,6,24
D Bucuresti,8946,3,5,4,5,21,20,1,19
Universitate,8946,4,4,6,4,15,18,-3,18
FC Botosani,8946,5,3,5,6,6,15,-9,14
Concordia Ch,8946,6,2,3,9,18,25,-7,9
FCSB,8947,1,7,6,1,23,12,11,27
CFR Cluj,8947,2,5,8,1,13,7,6,23
Universitate,8947,3,4,6,4,16,18,-2,18
D Bucuresti,8947,4,4,5,5,19,19,0,17
FC Botosani,8947,5,4,4,6,6,14,-8,16
Concordia Ch,8947,6,2,3,9,16,23,-7,9
FCSB,8948,1,7,6,1,24,12,12,27
CFR Cluj,8948,2,6,7,1,16,8,8,25
Universitate,8948,3,4,5,5,15,20,-5,17
FC Botosani,8948,4,4,5,5,8,13,-5,17
D Bucuresti,8948,5,3,5,6,16,20,-4,14
Concordia Ch,8948,6,2,4,8,16,22,-6,10
FCSB,8949,1,7,7,0,27,14,13,28
CFR Cluj,8949,2,6,7,1,16,8,8,25
D Bucuresti,8949,3,4,5,5,18,18,0,17
FC Botosani,8949,4,4,5,5,6,12,-6,17
Universitate,8949,5,3,6,5,17,23,-6,15
Concordia Ch,8949,6,2,2,10,15,24,-9,8
FCSB,8950,1,7,6,1,24,12,12,27
CFR Cluj,8950,2,7,6,1,15,7,8,27
FC Botosani,8950,3,5,4,5,8,13,-5,19
D Bucuresti,8950,4,4,4,6,19,21,-2,16
Universitate,8950,5,3,6,5,15,20,-5,15
Concordia Ch,8950,6,2,2,10,16,24,-8,8
FCSB,8951,1,9,5,0,27,11,16,32
CFR Cluj,8951,2,5,6,3,13,10,3,21
Universitate,8951,3,4,5,5,16,20,-4,17
FC Botosani,8951,4,4,5,5,8,13,-5,17
D Bucuresti,8951,5,3,4,7,17,24,-7,13
Concordia Ch,8951,6,3,3,8,18,21,-3,12
FCSB,8952,1,7,5,2,24,13,11,26
CFR Cluj,8952,2,6,7,1,16,9,7,25
Universitate,8952,3,4,6,4,16,19,-3,18
D Bucuresti,8952,4,4,4,6,19,21,-2,16
Concordia Ch,8952,5,4,2,8,19,22,-3,14
FC Botosani,8952,6,3,4,7,6,16,-10,13
FCSB,8953,1,7,6,1,23,11,12,27
CFR Cluj,8953,2,6,7,1,15,8,7,25
Universitate,8953,3,4,5,5,16,20,-4,17
D Bucuresti,8953,4,4,4,6,19,19,0,16
Concordia Ch,8953,5,4,2,8,19,21,-2,14
FC Botosani,8953,6,3,4,7,5,18,-13,13
FCSB,8954,1,8,6,0,26,12,14,30
CFR Cluj,8954,2,6,6,2,16,9,7,24
FC Botosani,8954,3,5,4,5,8,13,-5,19
Universitate,8954,4,3,6,5,17,23,-6,15
D Bucuresti,8954,5,3,4,7,16,20,-4,13
Concordia Ch,8954,6,3,2,9,17,23,-6,11
FCSB,8955,1,7,6,1,24,12,12,27
CFR Cluj,8955,2,5,8,1,15,9,6,23
Universitate,8955,3,4,6,4,16,19,-3,18
Concordia Ch,8955,4,4,2,8,19,22,-3,14
D Bucuresti,8955,5,3,5,6,16,20,-4,14
FC Botosani,8955,6,3,5,6,6,14,-8,14
FCSB,8956,1,8,6,0,26,11,15,30
CFR Cluj,8956,2,6,6,2,16,10,6,24
D Bucuresti,8956,3,4,5,5,19,19,0,17
Universitate,8956,4,3,6,5,16,22,-6,15
FC Botosani,8956,5,3,5,6,7,16,-9,14
Concordia Ch,8956,6,2,4,8,16,22,-6,10
FCSB,8957,1,7,6,1,25,14,11,27
CFR Cluj,8957,2,5,7,2,14,10,4,22
Universitate,8957,3,5,5,4,19,19,0,20
FC Botosani,8957,4,5,4,5,10,12,-2,19
D Bucuresti,8957,5,4,4,6,18,21,-3,16
Concordia Ch,8957,6,2,2,10,15,25,-10,8
FCSB,8958,1,7,6,1,25,13,12,27
CFR Cluj,8958,2,6,7,1,18,8,10,25
D Bucuresti,8958,3,5,4,5,19,19,0,19
Universitate,8958,4,4,5,5,16,23,-7,17
FC Botosani,8958,5,3,4,7,6,15,-9,13
Concordia Ch,8958,6,3,2,9,16,22,-6,11
FCSB,8959,1,7,6,1,25,13,12,27
CFR Cluj,8959,2,5,7,2,14,9,5,22
Universitate,8959,3,5,5,4,17,19,-2,20
D Bucuresti,8959,4,3,6,5,19,21,-2,15
FC Botosani,8959,5,3,6,5,8,15,-7,15
Concordia Ch,8959,6,2,4,8,17,23,-6,10
FCSB,8960,1,7,6,1,24,14,10,27
CFR Cluj,8960,2,6,7,1,17,8,9,25
D Bucuresti,8960,3,4,4,6,20,23,-3,16
Universitate,8960,4,3,7,4,14,18,-4,16
FC Botosani,8960,5,4,4,6,9,13,-4,16
Concordia Ch,8960,6,3,2,9,20,28,-8,11
FCSB,8961,1,8,5,1,28,14,14,29
CFR Cluj,8961,2,7,6,1,16,7,9,27
D Bucuresti,8961,3,4,4,6,20,23,-3,16
FC Botosani,8961,4,4,4,6,9,15,-6,16
Universitate,8961,5,3,5,6,16,24,-8,14
Concordia Ch,8961,6,3,2,9,20,26,-6,11
FCSB,8962,1,9,5,0,27,12,15,32
CFR Cluj,8962,2,5,6,3,14,12,2,21
Universitate,8962,3,4,5,5,18,20,-2,17
D Bucuresti,8962,4,3,6,5,18,20,-2,15
FC Botosani,8962,5,3,6,5,8,15,-7,15
Concordia Ch,8962,6,2,4,8,18,24,-6,10
FCSB,8963,1,8,5,1,25,12,13,29
CFR Cluj,8963,2,7,6,1,18,9,9,27
D Bucuresti,8963,3,4,4,6,17,21,-4,16
FC Botosani,8963,4,4,4,6,8,15,-7,16
Universitate,8963,5,3,5,6,17,24,-7,14
Concordia Ch,8963,6,3,2,9,20,24,-4,11
CFR Cluj,8964,1,7,6,1,17,7,10,27
FCSB,8964,2,7,5,2,23,13,10,26
D Bucuresti,8964,3,5,4,5,20,19,1,19
Universitate,8964,4,4,5,5,15,20,-5,17
FC Botosani,8964,5,3,5,6,6,15,-9,14
Concordia Ch,8964,6,2,3,9,15,22,-7,9
CFR Cluj,8965,1,7,6,1,16,7,9,27
FCSB,8965,2,7,5,2,24,14,10,26
Universitate,8965,3,4,5,5,17,21,-4,17
FC Botosani,8965,4,4,5,5,7,12,-5,17
D Bucuresti,8965,5,3,4,7,16,23,-7,13
Concordia Ch,8965,6,3,3,8,18,21,-3,12
FCSB,8966,1,8,6,0,25,11,14,30
CFR Cluj,8966,2,6,6,2,16,8,8,24
FC Botosani,8966,3,5,4,5,7,12,-5,19
D Bucuresti,8966,4,4,4,6,21,20,1,16
Universitate,8966,5,3,6,5,15,22,-7,15
Concordia Ch,8966,6,2,2,10,16,27,-11,8
FCSB,8967,1,7,6,1,23,11,12,27
CFR Cluj,8967,2,6,7,1,17,7,10,25
FC Botosani,8967,3,4,5,5,8,13,-5,17
Universitate,8967,4,4,5,5,15,22,-7,17
D Bucuresti,8967,5,4,4,6,19,21,-2,16
Concordia Ch,8967,6,2,3,9,17,25,-8,9
FCSB,8968,1,8,6,0,25,11,14,30
CFR Cluj,8968,2,5,7,2,15,10,5,22
D Bucuresti,8968,3,4,5,5,17,18,-1,17
Universitate,8968,4,4,5,5,16,20,-4,17
FC Botosani,8968,5,3,4,7,7,16,-9,13
Concordia Ch,8968,6,3,3,8,18,23,-5,12
FCSB,8969,1,8,6,0,28,13,15,30
CFR Cluj,8969,2,6,7,1,18,10,8,25
D Bucuresti,8969,3,4,4,6,22,22,0,16
FC Botosani,8969,4,4,4,6,8,17,-9,16
Universitate,8969,5,3,5,6,18,26,-8,14
Concordia Ch,8969,6,3,2,9,19,25,-6,11
FCSB,8970,1,8,6,0,26,12,14,30
CFR Cluj,8970,2,6,7,1,16,9,7,25
D Bucuresti,8970,3,5,4,5,21,20,1,19
Universitate,8970,4,3,5,6,14,20,-6,14
FC Botosani,8970,5,3,5,6,6,14,-8,14
Concordia Ch,8970,6,2,3,9,16,24,-8,9
FCSB,8971,1,7,5,2,25,16,9,26
CFR Cluj,8971,2,6,6,2,15,8,7,24
Universitate,8971,3,5,5,4,19,20,-1,20
D Bucuresti,8971,4,4,5,5,20,21,-1,17
FC Botosani,8971,5,4,4,6,8,14,-6,16
Concordia Ch,8971,6,2,3,9,17,25,-8,9
CFR Cluj,8972,1,7,6,1,15,7,8,27
FCSB,8972,2,7,5,2,23,12,11,26
D Bucuresti,8972,3,5,4,5,22,20,2,19
Universitate,8972,4,4,5,5,15,19,-4,17
FC Botosani,8972,5,3,5,6,7,17,-10,14
Concordia Ch,8972,6,2,3,9,17,24,-7,9
FCSB,8973,1,9,5,0,27,10,17,32
CFR Cluj,8973,2,6,6,2,14,10,4,24
D Bucuresti,8973,3,4,5,5,18,19,-1,17
FC Botosani,8973,4,3,6,5,5,12,-7,15
Universitate,8973,5,3,5,6,14,20,-6,14
Concordia Ch,8973,6,2,3,9,16,23,-7,9
FCSB,8974,1,8,5,1,25,13,12,29
CFR Cluj,8974,2,6,7,1,16,7,9,25
D Bucuresti,8974,3,5,4,5,21,20,1,19
FC Botosani,8974,4,4,4,6,6,14,-8,16
Universitate,8974,5,3,6,5,14,20,-6,15
Concordia Ch,8974,6,2,2,10,17,25,-8,8
FCSB,8975,1,8,6,0,25,11,14,30
CFR Cluj,8975,2,5,6,3,14,11,3,21
Universitate,8975,3,4,6,4,16,18,-2,18
D Bucuresti,8975,4,4,4,6,18,22,-4,16
FC Botosani,8975,5,3,5,6,5,13,-8,14
Concordia Ch,8975,6,3,3,8,19,22,-3,12
FCSB,8976,1,8,6,0,27,12,15,30
CFR Cluj,8976,2,5,8,1,15,9,6,23
FC Botosani,8976,3,4,4,6,8,15,-7,16
Universitate,8976,4,3,6,5,16,22,-6,15
Concordia Ch,8976,5,4,2,8,19,23,-4,14
D Bucuresti,8976,6,3,4,7,16,20,-4,13
FCSB,8977,1,8,5,1,26,13,13,29
CFR Cluj,8977,2,5,7,2,14,10,4,22
Universitate,8977,3,4,6,4,18,20,-2,18
D Bucuresti,8977,4,4,5,5,19,20,-1,17
FC Botosani,8977,5,3,6,5,7,14,-7,15
Concordia Ch,8977,6,2,3,9,15,22,-7,9
FCSB,8978,1,9,5,0,26,11,15,32
CFR Cluj,8978,2,6,6,2,15,9,6,24
FC Botosani,8978,3,4,5,5,9,13,-4,17
Universitate,8978,4,3,5,6,14,20,-6,14
D Bucuresti,8978,5,3,4,7,17,24,-7,13
Concordia Ch,8978,6,3,3,8,19,23,-4,12
FCSB,8979,1,8,5,1,26,13,13,29
CFR Cluj,8979,2,7,6,1,16,7,9,27
D Bucuresti,8979,3,4,4,6,18,20,-2,16
Universitate,8979,4,3,5,6,16,23,-7,14
FC Botosani,8979,5,3,5,6,7,15,-8,14
Concordia Ch,8979,6,3,3,8,17,22,-5,12
FCSB,8980,1,7,6,1,24,12,12,27
CFR Cluj,8980,2,7,6,1,16,8,8,27
D Bucuresti,8980,3,5,4,5,19,18,1,19
FC Botosani,8980,4,4,4,6,7,15,-8,16
Universitate,8980,5,3,6,5,14,19,-5,15
Concordia Ch,8980,6,2,2,10,16,24,-8,8
FCSB,8981,1,9,5,0,26,11,15,32
CFR Cluj,8981,2,5,7,2,15,10,5,22
D Bucuresti,8981,3,5,4,5,18,18,0,19
FC Botosani,8981,4,4,4,6,6,13,-7,16
Universitate,8981,5,3,6,5,15,20,-5,15
Concordia Ch,8981,6,2,2,10,15,23,-8,8
FCSB,8982,1,8,6,0,25,11,14,30
CFR Cluj,8982,2,5,7,2,13,8,5,22
FC Botosani,8982,3,4,5,5,9,13,-4,17
Universitate,8982,4,3,7,4,15,19,-4,16
D Bucuresti,8982,5,3,5,6,18,23,-5,14
Concordia Ch,8982,6,2,4,8,18,24,-6,10
FCSB,8983,1,8,5,1,24,11,13,29
CFR Cluj,8983,2,6,6,2,17,8,9,24
D Bucuresti,8983,3,5,4,5,19,18,1,19
Universitate,8983,4,4,5,5,15,22,-7,17
FC Botosani,8983,5,3,5,6,5,14,-9,14
Concordia Ch,8983,6,2,3,9,15,22,-7,9
FCSB,8984,1,8,6,0,28,13,15,30
CFR Cluj,8984,2,6,6,2,18,12,6,24
D Bucuresti,8984,3,4,4,6,18,19,-1,16
Universitate,8984,4,3,6,5,14,20,-6,15
Concordia Ch,8984,5,4,2,8,18,22,-4,14
FC Botosani,8984,6,3,4,7,6,16,-10,13
FCSB,8985,1,8,6,0,24,10,14,30
CFR Cluj,8985,2,5,7,2,15,10,5,22
Universitate,8985,3,3,7,4,16,20,-4,16
FC Botosani,8985,4,4,4,6,6,15,-9,16
Concordia Ch,8985,5,4,2,8,20,21,-1,14
D Bucuresti,8985,6,3,4,7,16,21,-5,13
FCSB,8986,1,9,5,0,28,13,15,32
CFR Cluj,8986,2,5,6,3,16,13,3,21
D Bucuresti,8986,3,4,5,5,18,19,-1,17
Universitate,8986,4,4,5,5,18,21,-3,17
FC Botosani,8986,5,4,4,6,7,13,-6,16
Concordia Ch,8986,6,2,3,9,16,24,-8,9
FCSB,8987,1,8,6,0,26,11,15,30
CFR Cluj,8987,2,5,6,3,13,11,2,21
Universitate,8987,3,4,6,4,17,19,-2,18
FC Botosani,8987,4,4,5,5,9,15,-6,17
D Bucuresti,8987,5,3,5,6,20,24,-4,14
Concordia Ch,8987,6,3,2,9,18,23,-5,11
FCSB,8988,1,8,5,1,26,14,12,29
CFR Cluj,8988,2,5,7,2,14,10,4,22
Universitate,8988,3,4,6,4,17,18,-1,18
D Bucuresti,8988,4,4,5,5,20,20,0,17
FC Botosani,8988,5,3,6,5,7,14,-7,15
Concordia Ch,8988,6,2,3,9,17,25,-8,9
FCSB,8989,1,7,7,0,26,13,13,28
CFR Cluj,8989,2,6,7,1,18,9,9,25
D Bucuresti,8989,3,4,5,5,19,18,1,17
Universitate,8989,4,3,6,5,17,24,-7,15
FC Botosani,8989,5,3,6,5,5,12,-7,15
Concordia Ch,8989,6,2,3,9,15,24,-9,9
FCSB,8990,1,8,6,0,25,11,14,30
CFR Cluj,8990,2,6,7,1,15,7,8,25
D Bucuresti,8990,3,4,4,6,18,20,-2,16
Universitate,8990,4,3,5,6,15,22,-7,14
FC Botosani,8990,5,3,5,6,6,14,-8,14
Concordia Ch,8990,6,3,3,8,16,21,-5,12
FCSB,8991,1,8,6,0,27,13,14,30
CFR Cluj,8991,2,5,7,2,13,8,5,22
FC Botosani,8991,3,5,4,5,8,13,-5,19
Universitate,8991,4,4,5,5,18,22,-4,17
D Bucuresti,8991,5,3,4,7,18,23,-5,13
Concordia Ch,8991,6,3,2,9,18,23,-5,11
FCSB,8992,1,8,5,1,25,11,14,29
CFR Cluj,8992,2,6,7,1,15,8,7,25
D Bucuresti,8992,3,4,5,5,20,21,-1,17
Universitate,8992,4,3,6,5,15,21,-6,15
FC Botosani,8992,5,3,5,6,8,16,-8,14
Concordia Ch,8992,6,2,4,8,17,23,-6,10
FCSB,8993,1,9,5,0,27,12,15,32
CFR Cluj,8993,2,5,7,2,13,8,5,22
D Bucuresti,8993,3,4,4,6,19,20,-1,16
Universitate,8993,4,3,6,5,16,21,-5,15
FC Botosani,8993,5,3,5,6,6,15,-9,14
Concordia Ch,8993,6,3,3,8,16,21,-5,12
FCSB,8994,1,7,6,1,23,11,12,27
CFR Cluj,8994,2,7,6,1,17,7,10,27
D Bucuresti,8994,3,4,5,5,20,20,0,17
FC Botosani,8994,4,4,5,5,8,14,-6,17
Universitate,8994,5,3,6,5,14,21,-7,15
Concordia Ch,8994,6,2,2,10,17,26,-9,8
FCSB,8995,1,7,6,1,23,11,12,27
CFR Cluj,8995,2,6,7,1,15,8,7,25
FC Botosani,8995,3,5,4,5,12,15,-3,19
Universitate,8995,4,3,7,4,15,19,-4,16
D Bucuresti,8995,5,3,5,6,17,20,-3,14
Concordia Ch,8995,6,2,3,9,19,28,-9,9
FCSB,8996,1,8,5,1,24,11,13,29
CFR Cluj,8996,2,7,6,1,16,8,8,27
D Bucuresti,8996,3,4,5,5,18,19,-1,17
Universitate,8996,4,3,5,6,15,21,-6,14
FC Botosani,8996,5,3,5,6,7,15,-8,14
Concordia Ch,8996,6,2,4,8,16,22,-6,10
FCSB,8997,1,8,6,0,27,12,15,30
CFR Cluj,8997,2,6,6,2,15,9,6,24
D Bucuresti,8997,3,4,5,5,18,18,0,17
Universitate,8997,4,3,6,5,16,22,-6,15
FC Botosani,8997,5,3,6,5,5,12,-7,15
Concordia Ch,8997,6,2,3,9,15,23,-8,9
FCSB,8998,1,8,6,0,29,11,18,30
CFR Cluj,8998,2,6,6,2,17,12,5,24
FC Botosani,8998,3,5,4,5,9,13,-4,19
Universitate,8998,4,3,6,5,15,23,-8,15
D Bucuresti,8998,5,3,4,7,17,23,-6,13
Concordia Ch,8998,6,3,2,9,19,24,-5,11
FCSB,8999,1,9,5,0,28,10,18,32
CFR Cluj,8999,2,6,6,2,15,9,6,24
FC Botosani,8999,3,4,5,5,6,12,-6,17
Universitate,8999,4,3,5,6,14,23,-9,14
D Bucuresti,8999,5,3,4,7,16,20,-4,13
Concordia Ch,8999,6,3,3,8,16,21,-5,12
FCSB,9000,1,7,7,0,24,11,13,28
CFR Cluj,9000,2,6,7,1,18,8,10,25
D Bucuresti,9000,3,4,5,5,18,18,0,17
FC Botosani,9000,4,4,5,5,6,12,-6,17
Universitate,9000,5,3,6,5,14,22,-8,15
Concordia Ch,9000,6,2,2,10,15,24,-9,8
FCSB,9001,1,9,5,0,26,11,15,32
CFR Cluj,9001,2,6,6,2,15,8,7,24
FC Botosani,9001,3,4,5,5,6,12,-6,17
Universitate,9001,4,3,5,6,15,22,-7,14
D Bucuresti,9001,5,3,4,7,16,20,-4,13
Concordia Ch,9001,6,3,3,8,16,21,-5,12
FCSB,9002,1,8,6,0,27,13,14,30
CFR Cluj,9002,2,5,7,2,15,10,5,22
Universitate,9002,3,4,5,5,18,22,-4,17
D Bucuresti,9002,4,4,4,6,19,21,-2,16
FC Botosani,9002,5,3,5,6,6,15,-9,14
Concordia Ch,9002,6,3,3,8,19,23,-4,12
FCSB,9003,1,7,5,2,25,16,9,26
CFR Cluj,9003,2,6,7,1,16,9,7,25
Universitate,9003,3,4,6,4,17,18,-1,18
D Bucuresti,9003,4,3,6,5,19,21,-2,15
FC Botosani,9003,5,3,6,5,6,13,-7,15
Concordia Ch,9003,6,2,4,8,17,23,-6,10
FCSB,9004,1,8,5,1,25,11,14,29
CFR Cluj,9004,2,5,7,2,13,9,4,22
D Bucuresti,9004,3,5,4,5,19,18,1,19
Universitate,9004,4,4,6,4,15,18,-3,18
FC Botosani,9004,5,4,4,6,8,14,-6,16
Concordia Ch,9004,6,2,2,10,16,26,-10,8
FCSB,9005,1,7,6,1,25,13,12,27
CFR Cluj,9005,2,6,7,1,15,8,7,25
D Bucuresti,9005,3,4,5,5,18,19,-1,17
Universitate,9005,4,4,5,5,16,20,-4,17
FC Botosani,9005,5,3,4,7,10,19,-9,13
Concordia Ch,9005,6,3,3,8,20,25,-5,12
FCSB,9006,1,7,6,1,25,13,12,27
CFR Cluj,9006,2,5,7,2,14,9,5,22
Universitate,9006,3,5,5,4,17,19,-2,20
FC Botosani,9006,4,4,5,5,8,13,-5,17
D Bucuresti,9006,5,3,4,7,18,24,-6,13
Concordia Ch,9006,6,3,3,8,18,22,-4,12
FCSB,9007,1,8,5,1,26,12,14,29
CFR Cluj,9007,2,6,6,2,16,9,7,24
Universitate,9007,3,4,5,5,16,22,-6,17
D Bucuresti,9007,4,3,6,5,21,23,-2,15
FC Botosani,9007,5,3,6,5,9,16,-7,15
Concordia Ch,9007,6,2,4,8,18,24,-6,10
FCSB,9008,1,9,5,0,26,10,16,32
CFR Cluj,9008,2,6,6,2,15,8,7,24
D Bucuresti,9008,3,4,4,6,19,20,-1,16
FC Botosani,9008,4,4,4,6,6,15,-9,16
Universitate,9008,5,3,5,6,14,22,-8,14
Concordia Ch,9008,6,3,2,9,19,24,-5,11
FCSB,9009,1,8,6,0,26,11,15,30
CFR Cluj,9009,2,5,8,1,16,10,6,23
D Bucuresti,9009,3,5,4,5,22,21,1,19
FC Botosani,9009,4,4,4,6,7,15,-8,16
Universitate,9009,5,3,6,5,16,22,-6,15
Concordia Ch,9009,6,2,2,10,17,25,-8,8
FCSB,9010,1,8,5,1,27,12,15,29
CFR Cluj,9010,2,6,7,1,15,8,7,25
D Bucuresti,9010,3,4,5,5,19,18,1,17
FC Botosani,9010,4,4,5,5,7,12,-5,17
Universitate,9010,5,3,6,5,14,21,-7,15
Concordia Ch,9010,6,2,2,10,15,26,-11,8
FCSB,9011,1,8,5,1,26,14,12,29
CFR Cluj,9011,2,6,6,2,18,12,6,24
Universitate,9011,3,4,5,5,19,22,-3,17
D Bucuresti,9011,4,4,4,6,19,21,-2,16
FC Botosani,9011,5,4,4,6,6,14,-8,16
Concordia Ch,9011,6,3,2,9,18,23,-5,11
FCSB,9012,1,8,6,0,26,11,15,30
CFR Cluj,9012,2,5,7,2,13,9,4,22
D Bucuresti,9012,3,5,4,5,21,19,2,19
Universitate,9012,4,3,7,4,15,19,-4,16
FC Botosani,9012,5,4,4,6,7,15,-8,16
Concordia Ch,9012,6,2,2,10,17,26,-9,8
CFR Cluj,9013,1,7,6,1,18,8,10,27
FCSB,9013,2,7,5,2,23,12,11,26
Universitate,9013,3,4,5,5,16,22,-6,17
D Bucuresti,9013,4,4,4,6,19,23,-4,16
FC Botosani,9013,5,3,5,6,7,15,-8,14
Concordia Ch,9013,6,3,3,8,20,23,-3,12
FCSB,9014,1,8,5,1,27,13,14,29
CFR Cluj,9014,2,5,6,3,15,12,3,21
Universitate,9014,3,5,5,4,20,22,-2,20
FC Botosani,9014,4,4,4,6,6,13,-7,16
Concordia Ch,9014,5,4,2,8,17,21,-4,14
D Bucuresti,9014,6,3,4,7,16,20,-4,13
FCSB,9015,1,8,6,0,24,10,14,30
CFR Cluj,9015,2,6,7,1,16,7,9,25
D Bucuresti,9015,3,5,4,5,21,19,2,19
FC Botosani,9015,4,4,4,6,9,14,-5,16
Universitate,9015,5,3,5,6,14,22,-8,14
Concordia Ch,9015,6,2,2,10,17,29,-12,8
FCSB,9016,1,8,5,1,26,12,14,29
CFR Cluj,9016,2,6,6,2,17,11,6,24
Universitate,9016,3,4,5,5,17,22,-5,17
FC Botosani,9016,4,4,5,5,8,13,-5,17
D Bucuresti,9016,5,3,5,6,17,20,-3,14
Concordia Ch,9016,6,3,2,9,16,23,-7,11
FCSB,9017,1,7,7,0,27,14,13,28
CFR Cluj,9017,2,5,8,1,17,11,6,23
FC Botosani,9017,3,4,5,5,6,12,-6,17
D Bucuresti,9017,4,4,4,6,17,19,-2,16
Universitate,9017,5,3,7,4,18,22,-4,16
Concordia Ch,9017,6,2,3,9,15,22,-7,9
FCSB,9018,1,8,5,1,25,12,13,29
CFR Cluj,9018,2,5,7,2,13,8,5,22
Universitate,9018,3,4,6,4,16,19,-3,18
Concordia Ch,9018,4,4,2,8,19,21,-2,14
D Bucuresti,9018,5,3,5,6,17,21,-4,14
FC Botosani,9018,6,3,5,6,6,15,-9,14
FCSB,9019,1,8,6,0,26,12,14,30
CFR Cluj,9019,2,6,6,2,14,8,6,24
D Bucuresti,9019,3,4,4,6,19,20,-1,16
Universitate,9019,4,3,6,5,16,21,-5,15
FC Botosani,9019,5,3,5,6,7,16,-9,14
Concordia Ch,9019,6,3,3,8,19,24,-5,12
FCSB,9020,1,7,6,1,24,12,12,27
CFR Cluj,9020,2,6,7,1,14,7,7,25
Universitate,9020,3,4,5,5,16,20,-4,17
FC Botosani,9020,4,4,5,5,8,14,-6,17
D Bucuresti,9020,5,3,5,6,18,21,-3,14
Concordia Ch,9020,6,3,2,9,16,22,-6,11
FCSB,9021,1,8,6,0,25,11,14,30
CFR Cluj,9021,2,6,6,2,15,9,6,24
D Bucuresti,9021,3,4,4,6,18,23,-5,16
Universitate,9021,4,3,6,5,16,21,-5,15
Concordia Ch,9021,5,4,2,8,21,22,-1,14
FC Botosani,9021,6,3,4,7,7,16,-9,13
FCSB,9022,1,8,6,0,25,11,14,30
CFR Cluj,9022,2,6,6,2,15,9,6,24
D Bucuresti,9022,3,4,4,6,19,20,-1,16
Universitate,9022,4,3,6,5,14,19,-5,15
FC Botosani,9022,5,3,5,6,5,15,-10,14
Concordia Ch,9022,6,3,3,8,17,21,-4,12
FCSB,9023,1,8,6,0,26,12,14,30
CFR Cluj,9023,2,6,7,1,16,9,7,25
FC Botosani,9023,3,3,6,5,5,12,-7,15
D Bucuresti,9023,4,3,5,6,16,19,-3,14
Universitate,9023,5,3,5,6,14,20,-6,14
Concordia Ch,9023,6,3,3,8,16,21,-5,12
FCSB,9024,1,8,5,1,25,11,14,29
CFR Cluj,9024,2,5,7,2,14,10,4,22
Universitate,9024,3,4,6,4,16,19,-3,18
D Bucuresti,9024,4,4,4,6,20,20,0,16
FC Botosani,9024,5,3,5,6,7,17,-10,14
Concordia Ch,9024,6,3,3,8,17,22,-5,12
FCSB,9025,1,9,5,0,26,11,15,32
CFR Cluj,9025,2,6,6,2,16,9,7,24
FC Botosani,9025,3,4,4,6,7,13,-6,16
Concordia Ch,9025,4,4,2,8,19,22,-3,14
Universitate,9025,5,3,5,6,14,21,-7,14
D Bucuresti,9025,6,3,4,7,17,23,-6,13
FCSB,9026,1,8,5,1,28,14,14,29
CFR Cluj,9026,2,6,6,2,17,11,6,24
Universitate,9026,3,4,5,5,17,22,-5,17
FC Botosani,9026,4,4,5,5,8,13,-5,17
D Bucuresti,9026,5,3,5,6,18,23,-5,14
Concordia Ch,9026,6,3,2,9,19,24,-5,11
FCSB,9027,1,8,5,1,25,12,13,29
CFR Cluj,9027,2,5,7,2,16,11,5,22
Universitate,9027,3,4,6,4,17,20,-3,18
D Bucuresti,9027,4,4,5,5,17,18,-1,17
FC Botosani,9027,5,4,5,5,6,12,-6,17
Concordia Ch,9027,6,2,2,10,15,23,-8,8
FCSB,9028,1,8,5,1,26,12,14,29
CFR Cluj,9028,2,5,7,2,14,10,4,22
D Bucuresti,9028,3,5,4,5,21,18,3,19
Universitate,9028,4,4,6,4,17,20,-3,18
FC Botosani,9028,5,3,5,6,5,15,-10,14
Concordia Ch,9028,6,2,3,9,15,23,-8,9
FCSB,9029,1,7,6,1,23,12,11,27
CFR Cluj,9029,2,5,8,1,14,8,6,23
D Bucuresti,9029,3,5,4,5,21,18,3,19
Universitate,9029,4,4,6,4,17,19,-2,18
FC Botosani,9029,5,4,4,6,7,14,-7,16
Concordia Ch,9029,6,2,2,10,16,27,-11,8
FCSB,9030,1,8,5,1,26,13,13,29
CFR Cluj,9030,2,5,6,3,15,12,3,21
Universitate,9030,3,5,5,4,18,19,-1,20
D Bucuresti,9030,4,4,4,6,19,21,-2,16
Concordia Ch,9030,5,4,2,8,19,22,-3,14
FC Botosani,9030,6,3,4,7,5,15,-10,13
FCSB,9031,1,9,5,0,27,11,16,32
CFR Cluj,9031,2,5,7,2,13,9,4,22
Universitate,9031,3,3,6,5,15,20,-5,15
FC Botosani,9031,4,3,6,5,6,13,-7,15
D Bucuresti,9031,5,3,5,6,18,21,-3,14
Concordia Ch,9031,6,3,3,8,19,24,-5,12
FCSB,9032,1,8,6,0,28,13,15,30
CFR Cluj,9032,2,6,7,1,17,9,8,25
FC Botosani,9032,3,5,4,5,8,13,-5,19
D Bucuresti,9032,4,4,4,6,22,22,0,16
Universitate,9032,5,3,5,6,15,23,-8,14
Concordia Ch,9032,6,2,2,10,17,27,-10,8
FCSB,9033,1,7,6,1,25,13,12,27
CFR Cluj,9033,2,7,6,1,16,8,8,27
D Bucuresti,9033,3,4,5,5,18,19,-1,17
Universitate,9033,4,3,6,5,17,22,-5,15
FC Botosani,9033,5,3,6,5,6,13,-7,15
Concordia Ch,9033,6,2,3,9,15,22,-7,9
FCSB,9034,1,7,6,1,25,13,12,27
CFR Cluj,9034,2,7,6,1,17,9,8,27
D Bucuresti,9034,3,4,4,6,18,20,-2,16
FC Botosani,9034,4,4,4,6,7,14,-7,16
Universitate,9034,5,3,6,5,16,21,-5,15
Concordia Ch,9034,6,3,2,9,18,24,-6,11
FCSB,9035,1,8,5,1,24,12,12,29
CFR Cluj,9035,2,6,6,2,14,8,6,24
D Bucuresti,9035,3,5,4,5,21,21,0,19
Universitate,9035,4,4,5,5,16,19,-3,17
FC Botosani,9035,5,3,4,7,7,17,-10,13
Concordia Ch,9035,6,3,2,9,20,25,-5,11
FCSB,9036,1,9,5,0,27,12,15,32
CFR Cluj,9036,2,5,6,3,15,11,4,21
Universitate,9036,3,4,5,5,17,21,-4,17
FC Botosani,9036,4,4,5,5,6,12,-6,17
D Bucuresti,9036,5,3,6,5,16,18,-2,15
Concordia Ch,9036,6,2,3,9,15,22,-7,9
FCSB,9037,1,9,5,0,29,12,17,32
CFR Cluj,9037,2,5,7,2,15,10,5,22
D Bucuresti,9037,3,4,5,5,20,21,-1,17
FC Botosani,9037,4,4,4,6,9,15,-6,16
Universitate,9037,5,3,6,5,16,23,-7,15
Concordia Ch,9037,6,2,3,9,18,26,-8,9
FCSB,9038,1,7,5,2,25,15,10,26
CFR Cluj,9038,2,6,7,1,16,8,8,25
Universitate,9038,3,4,6,4,16,19,-3,18
FC Botosani,9038,4,4,5,5,10,15,-5,17
D Bucuresti,9038,5,3,5,6,18,22,-4,14
Concordia Ch,9038,6,3,2,9,18,24,-6,11
FCSB,9039,1,8,5,1,27,14,13,29
CFR Cluj,9039,2,7,6,1,18,9,9,27
FC Botosani,9039,3,5,4,5,9,12,-3,19
Universitate,9039,4,3,5,6,16,23,-7,14
D Bucuresti,9039,5,3,4,7,16,21,-5,13
Concordia Ch,9039,6,3,2,9,17,24,-7,11
FCSB,9040,1,7,6,1,24,13,11,27
CFR Cluj,9040,2,7,6,1,16,7,9,27
D Bucuresti,9040,3,4,5,5,18,19,-1,17
FC Botosani,9040,4,4,5,5,8,13,-5,17
Universitate,9040,5,3,6,5,15,20,-5,15
Concordia Ch,9040,6,2,2,10,15,24,-9,8
FCSB,9041,1,8,5,1,26,13,13,29
CFR Cluj,9041,2,5,6,3,13,10,3,21
Universitate,9041,3,5,5,4,18,19,-1,20
D Bucuresti,9041,4,5,4,5,19,18,1,19
FC Botosani,9041,5,3,4,7,6,16,-10,13
Concordia Ch,9041,6,3,2,9,17,23,-6,11
FCSB,9042,1,8,6,0,27,12,15,30
CFR Cluj,9042,2,6,6,2,16,11,5,24
FC Botosani,9042,3,4,4,6,6,13,-7,16
Universitate,9042,4,3,6,5,16,21,-5,15
Concordia Ch,9042,5,4,2,8,17,21,-4,14
D Bucuresti,9042,6,3,4,7,16,20,-4,13
FCSB,9043,1,9,5,0,28,12,16,32
CFR Cluj,9043,2,6,6,2,15,10,5,24
D Bucuresti,9043,3,4,4,6,19,20,-1,16
FC Botosani,9043,4,4,4,6,6,13,-7,16
Universitate,9043,5,3,5,6,15,21,-6,14
Concordia Ch,9043,6,3,2,9,17,24,-7,11
FCSB,9044,1,8,5,1,25,12,13,29
CFR Cluj,9044,2,6,6,2,15,9,6,24
Universitate,9044,3,4,5,5,15,19,-4,17
Concordia Ch,9044,4,4,2,8,22,22,0,14
D Bucuresti,9044,5,3,5,6,16,23,-7,14
FC Botosani,9044,6,3,5,6,6,14,-8,14
FCSB,9045,1,7,6,1,24,13,11,27
CFR Cluj,9045,2,6,7,1,16,8,8,25
FC Botosani,9045,3,4,5,5,7,13,-6,17
Universitate,9045,4,3,7,4,16,20,-4,16
D Bucuresti,9045,5,3,6,5,18,20,-2,15
Concordia Ch,9045,6,2,3,9,18,25,-7,9
FCSB,9046,1,7,6,1,24,12,12,27
CFR Cluj,9046,2,7,6,1,16,8,8,27
FC Botosani,9046,3,5,4,5,8,13,-5,19
Universitate,9046,4,3,6,5,16,21,-5,15
D Bucuresti,9046,5,3,5,6,18,21,-3,14
Concordia Ch,9046,6,2,3,9,18,25,-7,9
FCSB,9047,1,8,6,0,25,11,14,30
CFR Cluj,9047,2,5,7,2,15,10,5,22
Universitate,9047,3,3,7,4,17,21,-4,16
D Bucuresti,9047,4,3,6,5,17,19,-2,15
FC Botosani,9047,5,3,5,6,6,15,-9,14
Concordia Ch,9047,6,3,3,8,17,21,-4,12
FCSB,9048,1,8,5,1,25,12,13,29
CFR Cluj,9048,2,5,7,2,13,9,4,22
D Bucuresti,9048,3,5,4,5,23,19,4,19
Universitate,9048,4,4,6,4,16,18,-2,18
FC Botosani,9048,5,4,4,6,8,16,-8,16
Concordia Ch,9048,6,2,2,10,17,28,-11,8
FCSB,9049,1,8,5,1,24,12,12,29
CFR Cluj,9049,2,6,6,2,14,8,6,24
D Bucuresti,9049,3,5,4,5,20,20,0,19
Universitate,9049,4,4,5,5,16,19,-3,17
FC Botosani,9049,5,3,4,7,7,17,-10,13
Concordia Ch,9049,6,3,2,9,19,24,-5,11
FCSB,9050,1,7,6,1,24,13,11,27
CFR Cluj,9050,2,6,7,1,14,7,7,25
Universitate,9050,3,4,5,5,17,20,-3,17
D Bucuresti,9050,4,4,4,6,19,20,-1,16
Concordia Ch,9050,5,4,2,8,21,23,-2,14
FC Botosani,9050,6,3,4,7,6,18,-12,13
FCSB,9051,1,8,6,0,26,12,14,30
CFR Cluj,9051,2,6,6,2,14,8,6,24
D Bucuresti,9051,3,5,4,5,20,19,1,19
Universitate,9051,4,3,6,5,16,21,-5,15
FC Botosani,9051,5,3,5,6,8,17,-9,14
Concordia Ch,9051,6,2,3,9,17,24,-7,9
FCSB,9052,1,8,5,1,25,12,13,29
CFR Cluj,9052,2,7,6,1,15,7,8,27
FC Botosani,9052,3,4,5,5,11,13,-2,17
D Bucuresti,9052,4,3,5,6,18,22,-4,14
Universitate,9052,5,3,5,6,15,21,-6,14
Concordia Ch,9052,6,3,2,9,18,27,-9,11
FCSB,9053,1,8,6,0,24,10,14,30
CFR Cluj,9053,2,5,7,2,14,9,5,22
D Bucuresti,9053,3,4,5,5,19,19,0,17
Universitate,9053,4,3,7,4,15,19,-4,16
FC Botosani,9053,5,3,5,6,5,14,-9,14
Concordia Ch,9053,6,3,2,9,18,24,-6,11
FCSB,9054,1,9,5,0,27,12,15,32
CFR Cluj,9054,2,5,6,3,15,11,4,21
Universitate,9054,3,4,5,5,15,19,-4,17
FC Botosani,9054,4,4,4,6,7,15,-8,16
Concordia Ch,9054,5,4,2,8,21,22,-1,14
D Bucuresti,9054,6,3,4,7,17,23,-6,13
FCSB,9055,1,8,5,1,25,12,13,29
CFR Cluj,9055,2,6,6,2,15,9,6,24
D Bucuresti,9055,3,4,5,5,19,19,0,17
Universitate,9055,4,4,5,5,15,19,-4,17
FC Botosani,9055,5,4,5,5,7,12,-5,17
Concordia Ch,9055,6,2,2,10,16,26,-10,8
FCSB,9056,1,9,5,0,27,11,16,32
CFR Cluj,9056,2,6,6,2,16,11,5,24
D Bucuresti,9056,3,4,4,6,19,21,-2,16
Concordia Ch,9056,4,4,2,8,18,22,-4,14
Universitate,9056,5,3,5,6,15,21,-6,14
FC Botosani,9056,6,3,4,7,6,15,-9,13
FCSB,9057,1,7,6,1,24,15,9,27
CFR Cluj,9057,2,5,8,1,14,8,6,23
Universitate,9057,3,4,6,4,20,20,0,18
D Bucuresti,9057,4,3,5,6,17,20,-3,14
Concordia Ch,9057,5,4,2,8,19,23,-4,14
FC Botosani,9057,6,3,5,6,6,14,-8,14
FCSB,9058,1,8,6,0,27,12,15,30
CFR Cluj,9058,2,6,7,1,15,8,7,25
FC Botosani,9058,3,4,5,5,8,14,-6,17
D Bucuresti,9058,4,3,6,5,18,20,-2,15
Universitate,9058,5,3,5,6,15,22,-7,14
Concordia Ch,9058,6,2,3,9,15,22,-7,9
FCSB,9059,1,8,5,1,25,12,13,29
CFR Cluj,9059,2,6,6,2,17,10,7,24
Universitate,9059,3,4,5,5,17,22,-5,17
Concordia Ch,9059,4,4,2,8,19,21,-2,14
D Bucuresti,9059,5,3,5,6,17,21,-4,14
FC Botosani,9059,6,3,5,6,6,15,-9,14
FCSB,9060,1,7,5,2,24,14,10,26
CFR Cluj,9060,2,6,7,1,15,8,7,25
Universitate,9060,3,4,6,4,16,18,-2,18
D Bucuresti,9060,4,4,4,6,18,19,-1,16
FC Botosani,9060,5,4,4,6,6,14,-8,16
Concordia Ch,9060,6,3,2,9,16,22,-6,11
FCSB,9061,1,8,5,1,26,12,14,29
CFR Cluj,9061,2,6,6,2,15,10,5,24
D Bucuresti,9061,3,4,5,5,18,19,-1,17
Universitate,9061,4,4,5,5,15,19,-4,17
FC Botosani,9061,5,3,4,7,6,15,-9,13
Concordia Ch,9061,6,3,3,8,16,21,-5,12
FCSB,9062,1,8,6,0,26,12,14,30
CFR Cluj,9062,2,6,6,2,17,10,7,24
D Bucuresti,9062,3,4,4,6,20,22,-2,16
Universitate,9062,4,3,6,5,16,22,-6,15
FC Botosani,9062,5,3,5,6,5,14,-9,14
Concordia Ch,9062,6,3,3,8,19,23,-4,12
FCSB,9063,1,7,7,0,25,12,13,28
CFR Cluj,9063,2,6,7,1,16,8,8,25
D Bucuresti,9063,3,3,6,5,17,19,-2,15
Universitate,9063,4,3,6,5,17,23,-6,15
FC Botosani,9063,5,3,6,5,6,13,-7,15
Concordia Ch,9063,6,2,4,8,17,23,-6,10
FCSB,9064,1,8,6,0,28,13,15,30
CFR Cluj,9064,2,6,7,1,16,8,8,25
FC Botosani,9064,3,4,5,5,9,14,-5,17
Universitate,9064,4,3,5,6,18,26,-8,14
D Bucuresti,9064,5,3,4,7,17,24,-7,13
Concordia Ch,9064,6,3,3,8,21,24,-3,12
FCSB,9065,1,7,6,1,23,14,9,27
CFR Cluj,9065,2,6,7,1,15,8,7,25
Universitate,9065,3,4,5,5,19,20,-1,17
D Bucuresti,9065,4,3,6,5,16,18,-2,15
FC Botosani,9065,5,3,6,5,5,12,-7,15
Concordia Ch,9065,6,2,4,8,15,21,-6,10
FCSB,9066,1,8,5,1,30,17,13,29
CFR Cluj,9066,2,6,6,2,17,11,6,24
Universitate,9066,3,4,5,5,19,23,-4,17
D Bucuresti,9066,4,4,4,6,19,21,-2,16
FC Botosani,9066,5,3,5,6,6,14,-8,14
Concordia Ch,9066,6,3,3,8,17,22,-5,12
FCSB,9067,1,8,6,0,26,12,14,30
CFR Cluj,9067,2,5,8,1,15,9,6,23
D Bucuresti,9067,3,4,5,5,20,21,-1,17
FC Botosani,9067,4,4,4,6,9,15,-6,16
Universitate,9067,5,3,6,5,14,19,-5,15
Concordia Ch,9067,6,2,3,9,16,24,-8,9
FCSB,9068,1,7,6,1,26,14,12,27
CFR Cluj,9068,2,7,6,1,16,7,9,27
D Bucuresti,9068,3,4,4,6,20,22,-2,16
Universitate,9068,4,3,6,5,17,23,-6,15
Concordia Ch,9068,5,4,2,8,20,21,-1,14
FC Botosani,9068,6,3,4,7,6,18,-12,13
FCSB,9069,1,8,6,0,25,11,14,30
CFR Cluj,9069,2,6,6,2,15,8,7,24
D Bucuresti,9069,3,4,5,5,19,20,-1,17
Universitate,9069,4,3,6,5,15,21,-6,15
FC Botosani,9069,5,3,5,6,6,14,-8,14
Concordia Ch,9069,6,2,4,8,16,22,-6,10
FCSB,9070,1,8,5,1,26,12,14,29
CFR Cluj,9070,2,7,6,1,18,7,11,27
D Bucuresti,9070,3,4,5,5,17,18,-1,17
Universitate,9070,4,3,5,6,14,24,-10,14
FC Botosani,9070,5,3,4,7,5,14,-9,13
Concordia Ch,9070,6,3,3,8,16,21,-5,12
FCSB,9071,1,7,6,1,25,13,12,27
CFR Cluj,9071,2,7,6,1,17,8,9,27
FC Botosani,9071,3,5,4,5,8,12,-4,19
Universitate,9071,4,3,6,5,15,21,-6,15
D Bucuresti,9071,5,3,4,7,18,25,-7,13
Concordia Ch,9071,6,3,2,9,20,24,-4,11
FCSB,9072,1,8,6,0,27,13,14,30
CFR Cluj,9072,2,5,8,1,17,11,6,23
D Bucuresti,9072,3,4,5,5,20,19,1,17
Universitate,9072,4,3,6,5,15,20,-5,15
FC Botosani,9072,5,3,5,6,7,17,-10,14
Concordia Ch,9072,6,2,4,8,18,24,-6,10
FCSB,9073,1,9,5,0,28,10,18,32
CFR Cluj,9073,2,5,6,3,13,10,3,21
Universitate,9073,3,4,5,5,15,21,-6,17
D Bucuresti,9073,4,4,4,6,19,20,-1,16
Concordia Ch,9073,5,4,2,8,20,23,-3,14
FC Botosani,9073,6,3,4,7,6,17,-11,13
FCSB,9074,1,9,5,0,26,11,15,32
CFR Cluj,9074,2,5,7,2,13,8,5,22
FC Botosani,9074,3,5,4,5,8,12,-4,19
Universitate,9074,4,3,6,5,15,20,-5,15
D Bucuresti,9074,5,3,5,6,16,20,-4,14
Concordia Ch,9074,6,2,3,9,15,22,-7,9
FCSB,9075,1,7,6,1,24,13,11,27
CFR Cluj,9075,2,5,7,2,15,10,5,22
Universitate,9075,3,5,5,4,18,19,-1,20
D Bucuresti,9075,4,5,4,5,19,19,0,19
FC Botosani,9075,5,4,4,6,6,13,-7,16
Concordia Ch,9075,6,2,2,10,16,24,-8,8
FCSB,9076,1,9,5,0,27,11,16,32
CFR Cluj,9076,2,6,6,2,17,9,8,24
D Bucuresti,9076,3,4,4,6,19,21,-2,16
Concordia Ch,9076,4,4,2,8,17,21,-4,14
Universitate,9076,5,3,5,6,14,23,-9,14
FC Botosani,9076,6,3,4,7,7,16,-9,13
FCSB,9077,1,8,6,0,26,10,16,30
CFR Cluj,9077,2,5,7,2,14,11,3,22
D Bucuresti,9077,3,4,5,5,18,19,-1,17
Universitate,9077,4,3,7,4,15,19,-4,16
FC Botosani,9077,5,3,5,6,7,15,-8,14
Concordia Ch,9077,6,2,4,8,16,22,-6,10
FCSB,9078,1,8,5,1,24,11,13,29
CFR Cluj,9078,2,6,6,2,15,8,7,24
D Bucuresti,9078,3,4,5,5,20,20,0,17
Universitate,9078,4,4,5,5,15,20,-5,17
FC Botosani,9078,5,4,5,5,8,14,-6,17
Concordia Ch,9078,6,2,2,10,15,24,-9,8
FCSB,9079,1,7,6,1,24,15,9,27
CFR Cluj,9079,2,6,6,2,17,8,9,24
Universitate,9079,3,4,6,4,16,19,-3,18
D Bucuresti,9079,4,4,4,6,18,22,-4,16
FC Botosani,9079,5,4,4,6,7,14,-7,16
Concordia Ch,9079,6,3,2,9,18,22,-4,11
FCSB,9080,1,8,5,1,25,11,14,29
CFR Cluj,9080,2,5,6,3,14,12,2,21
Universitate,9080,3,5,5,4,18,19,-1,20
D Bucuresti,9080,4,4,5,5,20,19,1,17
FC Botosani,9080,5,4,4,6,7,16,-9,16
Concordia Ch,9080,6,2,3,9,17,24,-7,9
FCSB,9081,1,7,5,2,23,14,9,26
CFR Cluj,9081,2,6,6,2,15,12,3,24
Universitate,9081,3,5,5,4,21,18,3,20
D Bucuresti,9081,4,3,5,6,17,20,-3,14
Concordia Ch,9081,5,4,2,8,17,21,-4,14
FC Botosani,9081,6,3,5,6,6,14,-8,14
FCSB,9082,1,7,7,0,25,12,13,28
CFR Cluj,9082,2,6,7,1,17,8,9,25
D Bucuresti,9082,3,5,4,5,21,20,1,19
Universitate,9082,4,3,6,5,15,22,-7,15
FC Botosani,9082,5,3,5,6,7,16,-9,14
Concordia Ch,9082,6,2,3,9,17,24,-7,9
FCSB,9083,1,7,6,1,24,12,12,27
CFR Cluj,9083,2,5,7,2,15,10,5,22
Universitate,9083,3,5,5,4,17,19,-2,20
FC Botosani,9083,4,4,4,6,10,14,-4,16
Concordia Ch,9083,5,4,2,8,19,23,-4,14
D Bucuresti,9083,6,3,4,7,17,24,-7,13
FCSB,9084,1,7,6,1,23,11,12,27
CFR Cluj,9084,2,7,6,1,15,7,8,27
D Bucuresti,9084,3,4,4,6,21,20,1,16
FC Botosani,9084,4,4,4,6,8,18,-10,16
Universitate,9084,5,3,6,5,14,19,-5,15
Concordia Ch,9084,6,3,2,9,19,25,-6,11
FCSB,9085,1,7,7,0,24,11,13,28
CFR Cluj,9085,2,5,7,2,13,8,5,22
Universitate,9085,3,4,6,4,16,19,-3,18
FC Botosani,9085,4,4,5,5,8,13,-5,17
D Bucuresti,9085,5,3,6,5,19,21,-2,15
Concordia Ch,9085,6,2,3,9,17,25,-8,9
FCSB,9086,1,7,7,0,26,13,13,28
CFR Cluj,9086,2,6,7,1,17,9,8,25
Universitate,9086,3,3,6,5,17,23,-6,15
FC Botosani,9086,4,3,6,5,6,13,-7,15
D Bucuresti,9086,5,3,5,6,16,19,-3,14
Concordia Ch,9086,6,3,3,8,17,22,-5,12
FCSB,9087,1,8,6,0,26,12,14,30
CFR Cluj,9087,2,6,6,2,15,8,7,24
FC Botosani,9087,3,4,5,5,7,12,-5,17
Universitate,9087,4,3,6,5,16,22,-6,15
D Bucuresti,9087,5,3,5,6,17,20,-3,14
Concordia Ch,9087,6,3,2,9,17,24,-7,11
FCSB,9088,1,8,5,1,25,12,13,29
CFR Cluj,9088,2,6,6,2,15,9,6,24
D Bucuresti,9088,3,4,5,5,18,19,-1,17
Universitate,9088,4,4,5,5,17,21,-4,17
FC Botosani,9088,5,4,5,5,7,12,-5,17
Concordia Ch,9088,6,2,2,10,16,25,-9,8
FCSB,9089,1,8,6,0,27,13,14,30
CFR Cluj,9089,2,5,7,2,15,10,5,22
Universitate,9089,3,3,7,4,17,21,-4,16
FC Botosani,9089,4,3,6,5,6,13,-7,15
D Bucuresti,9089,5,3,5,6,16,19,-3,14
Concordia Ch,9089,6,3,3,8,17,22,-5,12
FCSB,9090,1,7,7,0,24,11,13,28
CFR Cluj,9090,2,6,7,1,18,9,9,25
D Bucuresti,9090,3,4,4,6,21,21,0,16
Universitate,9090,4,3,6,5,15,22,-7,15
Concordia Ch,9090,5,4,2,8,18,22,-4,14
FC Botosani,9090,6,3,4,7,6,17,-11,13
FCSB,9091,1,8,6,0,26,11,15,30
CFR Cluj,9091,2,6,7,1,15,8,7,25
D Bucuresti,9091,3,4,4,6,17,20,-3,16
FC Botosani,9091,4,4,4,6,7,13,-6,16
Universitate,9091,5,3,5,6,14,21,-7,14
Concordia Ch,9091,6,3,2,9,17,23,-6,11
FCSB,9092,1,8,6,0,27,10,17,30
CFR Cluj,9092,2,5,7,2,15,13,2,22
D Bucuresti,9092,3,4,5,5,18,19,-1,17
Universitate,9092,4,3,7,4,16,20,-4,16
FC Botosani,9092,5,3,5,6,6,15,-9,14
Concordia Ch,9092,6,3,2,9,17,22,-5,11
FCSB,9093,1,8,6,0,26,11,15,30
CFR Cluj,9093,2,5,8,1,15,9,6,23
D Bucuresti,9093,3,4,5,5,19,19,0,17
Universitate,9093,4,3,6,5,15,21,-6,15
FC Botosani,9093,5,3,5,6,7,16,-9,14
Concordia Ch,9093,6,2,4,8,18,24,-6,10
FCSB,9094,1,9,5,0,26,11,15,32
CFR Cluj,9094,2,5,7,2,13,8,5,22
Universitate,9094,3,3,6,5,15,20,-5,15
FC Botosani,9094,4,3,6,5,6,13,-7,15
D Bucuresti,9094,5,3,5,6,18,21,-3,14
Concordia Ch,9094,6,3,3,8,17,22,-5,12
FCSB,9095,1,7,6,1,24,12,12,27
CFR Cluj,9095,2,5,7,2,15,11,4,22
Universitate,9095,3,5,5,4,18,19,-1,20
D Bucuresti,9095,4,4,4,6,19,23,-4,16
FC Botosani,9095,5,3,5,6,8,17,-9,14
Concordia Ch,9095,6,3,3,8,21,23,-2,12
FCSB,9096,1,8,5,1,26,11,15,29
CFR Cluj,9096,2,5,7,2,14,11,3,22
Universitate,9096,3,4,6,4,16,19,-3,18
D Bucuresti,9096,4,4,4,6,18,21,-3,16
Concordia Ch,9096,5,4,2,8,18,21,-3,14
FC Botosani,9096,6,3,4,7,6,15,-9,13
FCSB,9097,1,8,5,1,25,14,11,29
CFR Cluj,9097,2,6,7,1,16,7,9,25
D Bucuresti,9097,3,3,6,5,17,19,-2,15
Universitate,9097,4,3,6,5,15,20,-5,15
FC Botosani,9097,5,3,5,6,5,13,-8,14
Concordia Ch,9097,6,3,3,8,17,22,-5,12
FCSB,9098,1,7,6,1,27,16,11,27
CFR Cluj,9098,2,7,6,1,18,7,11,27
D Bucuresti,9098,3,5,4,5,19,19,0,19
FC Botosani,9098,4,4,4,6,6,13,-7,16
Universitate,9098,5,3,6,5,18,25,-7,15
Concordia Ch,9098,6,2,2,10,16,24,-8,8
FCSB,9099,1,9,5,0,27,12,15,32
CFR Cluj,9099,2,5,6,3,15,12,3,21
D Bucuresti,9099,3,4,5,5,17,18,-1,17
Universitate,9099,4,4,5,5,16,19,-3,17
FC Botosani,9099,5,4,5,5,6,12,-6,17
Concordia Ch,9099,6,2,2,10,15,23,-8,8
FCSB,9100,1,8,5,1,27,13,14,29
CFR Cluj,9100,2,6,7,1,14,7,7,25
D Bucuresti,9100,3,4,5,5,17,18,-1,17
FC Botosani,9100,4,4,5,5,6,12,-6,17
Universitate,9100,5,3,6,5,16,22,-6,15
Concordia Ch,9100,6,2,2,10,15,23,-8,8
FCSB,9101,1,8,5,1,24,11,13,29
CFR Cluj,9101,2,5,6,3,13,9,4,21
Universitate,9101,3,5,5,4,16,18,-2,20
D Bucuresti,9101,4,4,5,5,19,19,0,17
FC Botosani,9101,5,4,4,6,10,15,-5,16
Concordia Ch,9101,6,2,3,9,15,25,-10,9
FCSB,9102,1,7,7,0,24,11,13,28
CFR Cluj,9102,2,6,7,1,17,8,9,25
D Bucuresti,9102,3,4,4,6,21,20,1,16
Universitate,9102,4,3,6,5,14,21,-7,15
FC Botosani,9102,5,3,5,6,5,16,-11,14
Concordia Ch,9102,6,3,3,8,17,22,-5,12
FCSB,9103,1,8,6,0,25,10,15,30
CFR Cluj,9103,2,6,7,1,15,8,7,25
FC Botosani,9103,3,4,4,6,7,15,-8,16
D Bucuresti,9103,4,3,5,6,18,21,-3,14
Universitate,9103,5,3,5,6,15,22,-7,14
Concordia Ch,9103,6,3,3,8,20,24,-4,12
FCSB,9104,1,9,5,0,27,12,15,32
CFR Cluj,9104,2,5,7,2,14,9,5,22
FC Botosani,9104,3,5,4,5,9,14,-5,19
D Bucuresti,9104,4,4,4,6,21,20,1,16
Universitate,9104,5,3,6,5,17,22,-5,15
Concordia Ch,9104,6,2,2,10,16,27,-11,8
FCSB,9105,1,9,5,0,25,10,15,32
CFR Cluj,9105,2,5,7,2,14,9,5,22
FC Botosani,9105,3,4,5,5,7,13,-6,17
Universitate,9105,4,3,6,5,15,20,-5,15
D Bucuresti,9105,5,3,5,6,16,19,-3,14
Concordia Ch,9105,6,3,2,9,17,23,-6,11
FCSB,9106,1,8,5,1,24,11,13,29
CFR Cluj,9106,2,5,6,3,14,10,4,21
Universitate,9106,3,5,5,4,17,19,-2,20
FC Botosani,9106,4,4,5,5,7,13,-6,17
D Bucuresti,9106,5,3,5,6,18,22,-4,14
Concordia Ch,9106,6,3,2,9,18,23,-5,11
FCSB,9107,1,7,6,1,25,13,12,27
CFR Cluj,9107,2,6,7,1,18,9,9,25
FC Botosani,9107,3,5,4,5,8,13,-5,19
Universitate,9107,4,4,5,5,15,21,-6,17
D Bucuresti,9107,5,3,4,7,16,20,-4,13
Concordia Ch,9107,6,3,2,9,17,23,-6,11
FCSB,9108,1,8,6,0,24,10,14,30
CFR Cluj,9108,2,6,7,1,14,7,7,25
D Bucuresti,9108,3,5,4,5,23,18,5,19
Universitate,9108,4,3,5,6,14,20,-6,14
FC Botosani,9108,5,3,5,6,5,15,-10,14
Concordia Ch,9108,6,2,3,9,15,25,-10,9
FCSB,9109,1,9,5,0,26,10,16,32
CFR Cluj,9109,2,5,6,3,13,9,4,21
FC Botosani,9109,3,5,4,5,8,13,-5,19
Universitate,9109,4,4,5,5,15,20,-5,17
D Bucuresti,9109,5,3,4,7,18,22,-4,13
Concordia Ch,9109,6,3,2,9,17,23,-6,11
FCSB,9110,1,8,5,1,25,11,14,29
CFR Cluj,9110,2,7,6,1,16,7,9,27
FC Botosani,9110,3,5,4,5,9,13,-4,19
D Bucuresti,9110,4,4,4,6,21,24,-3,16
Universitate,9110,5,3,5,6,14,22,-8,14
Concordia Ch,9110,6,2,2,10,18,26,-8,8
FCSB,9111,1,7,6,1,26,14,12,27
CFR Cluj,9111,2,6,7,1,16,8,8,25
Universitate,9111,3,4,5,5,17,22,-5,17
D Bucuresti,9111,4,4,4,6,20,22,-2,16
FC Botosani,9111,5,4,4,6,8,15,-7,16
Concordia Ch,9111,6,3,2,9,17,23,-6,11
FCSB,9112,1,8,5,1,25,12,13,29
CFR Cluj,9112,2,5,6,3,13,9,4,21
Universitate,9112,3,5,5,4,17,19,-2,20
D Bucuresti,9112,4,4,5,5,21,22,-1,17
FC Botosani,9112,5,3,4,7,7,16,-9,13
Concordia Ch,9112,6,3,3,8,20,25,-5,12
FCSB,9113,1,9,5,0,26,11,15,32
CFR Cluj,9113,2,6,6,2,15,8,7,24
FC Botosani,9113,3,4,4,6,6,14,-8,16
D Bucuresti,9113,4,3,5,6,16,19,-3,14
Universitate,9113,5,3,5,6,15,22,-7,14
Concordia Ch,9113,6,3,3,8,17,21,-4,12
FCSB,9114,1,7,6,1,23,11,12,27
CFR Cluj,9114,2,7,6,1,17,7,10,27
FC Botosani,9114,3,4,5,5,7,13,-6,17
Universitate,9114,4,3,6,5,14,21,-7,15
D Bucuresti,9114,5,3,5,6,17,20,-3,14
Concordia Ch,9114,6,2,4,8,17,23,-6,10
FCSB,9115,1,9,5,0,29,11,18,32
CFR Cluj,9115,2,6,6,2,17,12,5,24
FC Botosani,9115,3,4,4,6,7,14,-7,16
D Bucuresti,9115,4,3,5,6,17,20,-3,14
Universitate,9115,5,3,5,6,17,25,-8,14
Concordia Ch,9115,6,3,3,8,16,21,-5,12
FCSB,9116,1,7,6,1,24,12,12,27
CFR Cluj,9116,2,6,7,1,17,8,9,25
Universitate,9116,3,4,5,5,17,23,-6,17
D Bucuresti,9116,4,4,4,6,19,21,-2,16
Concordia Ch,9116,5,4,2,8,19,23,-4,14
FC Botosani,9116,6,3,4,7,5,14,-9,13
FCSB,9117,1,8,6,0,26,11,15,30
CFR Cluj,9117,2,5,7,2,13,8,5,22
Universitate,9117,3,4,5,5,16,21,-5,17
D Bucuresti,9117,4,4,4,6,20,21,-1,16
FC Botosani,9117,5,4,4,6,7,15,-8,16
Concordia Ch,9117,6,3,2,9,18,24,-6,11
FCSB,9118,1,7,6,1,28,16,12,27
CFR Cluj,9118,2,6,7,1,16,9,7,25
D Bucuresti,9118,3,5,4,5,23,22,1,19
Universitate,9118,4,3,7,4,19,23,-4,16
FC Botosani,9118,5,3,5,6,7,16,-9,14
Concordia Ch,9118,6,2,3,9,19,26,-7,9
FCSB,9119,1,7,6,1,23,11,12,27
CFR Cluj,9119,2,6,7,1,15,8,7,25
Universitate,9119,3,4,5,5,16,20,-4,17
D Bucuresti,9119,4,4,4,6,18,19,-1,16
FC Botosani,9119,5,4,4,6,6,14,-8,16
Concordia Ch,9119,6,3,2,9,17,23,-6,11
FCSB,9120,1,8,5,1,25,12,13,29
CFR Cluj,9120,2,7,6,1,17,8,9,27
D Bucuresti,9120,3,3,6,5,20,22,-2,15
FC Botosani,9120,4,3,6,5,10,17,-7,15
Universitate,9120,5,3,5,6,14,21,-7,14
Concordia Ch,9120,6,2,4,8,18,24,-6,10
FCSB,9121,1,7,6,1,25,13,12,27
CFR Cluj,9121,2,5,7,2,14,9,5,22
Universitate,9121,3,5,5,4,19,21,-2,20
D Bucuresti,9121,4,4,4,6,18,22,-4,16
FC Botosani,9121,5,3,5,6,6,14,-8,14
Concordia Ch,9121,6,3,3,8,20,23,-3,12
FCSB,9122,1,9,5,0,26,11,15,32
CFR Cluj,9122,2,5,6,3,14,12,2,21
Universitate,9122,3,4,5,5,17,19,-2,17
FC Botosani,9122,4,4,5,5,9,14,-5,17
D Bucuresti,9122,5,4,4,6,19,21,-2,16
Concordia Ch,9122,6,2,3,9,18,26,-8,9
FCSB,9123,1,8,5,1,24,11,13,29
CFR Cluj,9123,2,6,6,2,14,8,6,24
Universitate,9123,3,4,5,5,15,19,-4,17
FC Botosani,9123,4,4,5,5,7,12,-5,17
D Bucuresti,9123,5,3,5,6,16,20,-4,14
Concordia Ch,9123,6,3,2,9,17,23,-6,11
FCSB,9124,1,8,5,1,26,13,13,29
CFR Cluj,9124,2,6,6,2,15,9,6,24
D Bucuresti,9124,3,4,5,5,18,18,0,17
Universitate,9124,4,4,5,5,16,20,-4,17
FC Botosani,9124,5,3,6,5,5,12,-7,15
Concordia Ch,9124,6,2,3,9,15,23,-8,9
FCSB,9125,1,8,5,1,26,12,14,29
CFR Cluj,9125,2,6,6,2,14,10,4,24
Universitate,9125,3,4,5,5,16,19,-3,17
FC Botosani,9125,4,4,5,5,8,14,-6,17
D Bucuresti,9125,5,3,5,6,17,20,-3,14
Concordia Ch,9125,6,2,4,8,18,24,-6,10
FCSB,9126,1,9,5,0,27,10,17,32
CFR Cluj,9126,2,5,6,3,15,15,0,21
Universitate,9126,3,4,5,5,20,22,-2,17
FC Botosani,9126,4,4,5,5,7,13,-6,17
D Bucuresti,9126,5,3,4,7,16,22,-6,13
Concordia Ch,9126,6,3,3,8,19,22,-3,12
FCSB,9127,1,7,5,2,24,15,9,26
CFR Cluj,9127,2,6,6,2,17,9,8,24
Universitate,9127,3,5,5,4,18,20,-2,20
FC Botosani,9127,4,5,4,5,8,13,-5,19
D Bucuresti,9127,5,3,5,6,16,19,-3,14
Concordia Ch,9127,6,2,3,9,16,23,-7,9
FCSB,9128,1,9,5,0,25,10,15,32
CFR Cluj,9128,2,6,6,2,16,9,7,24
D Bucuresti,9128,3,4,5,5,19,20,-1,17
FC Botosani,9128,4,4,4,6,7,14,-7,16
Universitate,9128,5,3,5,6,15,22,-7,14
Concordia Ch,9128,6,2,3,9,18,25,-7,9
FCSB,9129,1,7,6,1,26,14,12,27
CFR Cluj,9129,2,7,6,1,16,8,8,27
D Bucuresti,9129,3,4,5,5,21,19,2,17
Universitate,9129,4,3,6,5,16,21,-5,15
FC Botosani,9129,5,3,5,6,6,15,-9,14
Concordia Ch,9129,6,3,2,9,17,25,-8,11
FCSB,9130,1,8,5,1,26,13,13,29
CFR Cluj,9130,2,6,6,2,17,9,8,24
Universitate,9130,3,4,5,5,16,22,-6,17
FC Botosani,9130,4,4,4,6,7,14,-7,16
Concordia Ch,9130,5,4,2,8,19,22,-3,14
D Bucuresti,9130,6,3,4,7,16,21,-5,13
FCSB,9131,1,8,5,1,27,14,13,29
CFR Cluj,9131,2,6,6,2,15,9,6,24
Universitate,9131,3,4,5,5,17,21,-4,17
FC Botosani,9131,4,4,5,5,7,12,-5,17
D Bucuresti,9131,5,3,5,6,16,21,-5,14
Concordia Ch,9131,6,3,2,9,18,23,-5,11
FCSB,9132,1,7,6,1,24,13,11,27
CFR Cluj,9132,2,6,7,1,16,8,8,25
FC Botosani,9132,3,5,4,5,10,14,-4,19
Universitate,9132,4,3,7,4,16,20,-4,16
D Bucuresti,9132,5,3,4,7,17,22,-5,13
Concordia Ch,9132,6,3,2,9,18,24,-6,11
FCSB,9133,1,9,5,0,28,12,16,32
CFR Cluj,9133,2,5,7,2,14,9,5,22
D Bucuresti,9133,3,5,4,5,18,18,0,19
FC Botosani,9133,4,4,4,6,6,13,-7,16
Universitate,9133,5,3,6,5,17,23,-6,15
Concordia Ch,9133,6,2,2,10,15,23,-8,8
FCSB,9134,1,9,5,0,27,12,15,32
CFR Cluj,9134,2,5,6,3,14,13,1,21
Universitate,9134,3,4,5,5,19,20,-1,17
D Bucuresti,9134,4,4,4,6,19,21,-2,16
FC Botosani,9134,5,3,5,6,6,14,-8,14
Concordia Ch,9134,6,3,3,8,17,22,-5,12
FCSB,9135,1,9,5,0,29,12,17,32
CFR Cluj,9135,2,5,7,2,17,12,5,22
D Bucuresti,9135,3,4,5,5,18,19,-1,17
FC Botosani,9135,4,4,4,6,8,13,-5,16
Universitate,9135,5,3,6,5,20,27,-7,15
Concordia Ch,9135,6,2,3,9,16,25,-9,9
FCSB,9136,1,8,5,1,25,12,13,29
CFR Cluj,9136,2,6,7,1,16,8,8,25
D Bucuresti,9136,3,4,5,5,21,20,1,17
Universitate,9136,4,3,6,5,15,21,-6,15
FC Botosani,9136,5,3,4,7,5,17,-12,13
Concordia Ch,9136,6,3,3,8,19,23,-4,12
FCSB,9137,1,8,5,1,25,12,13,29
CFR Cluj,9137,2,7,6,1,17,8,9,27
D Bucuresti,9137,3,5,4,5,19,19,0,19
Universitate,9137,4,3,5,6,15,22,-7,14
FC Botosani,9137,5,3,4,7,6,18,-12,13
Concordia Ch,9137,6,3,2,9,19,22,-3,11
FCSB,9138,1,7,6,1,24,12,12,27
CFR Cluj,9138,2,7,6,1,17,7,10,27
D Bucuresti,9138,3,4,5,5,21,22,-1,17
Universitate,9138,4,3,6,5,15,22,-7,15
FC Botosani,9138,5,3,5,6,6,14,-8,14
Concordia Ch,9138,6,3,2,9,19,25,-6,11
FCSB,9139,1,8,6,0,28,12,16,30
CFR Cluj,9139,2,5,7,2,14,11,3,22
D Bucuresti,9139,3,5,4,5,22,20,2,19
Universitate,9139,4,3,7,4,17,21,-4,16
FC Botosani,9139,5,3,4,7,5,15,-10,13
Concordia Ch,9139,6,3,2,9,18,25,-7,11
FCSB,9140,1,8,5,1,26,14,12,29
CFR Cluj,9140,2,5,7,2,15,10,5,22
Universitate,9140,3,4,6,4,16,18,-2,18
D Bucuresti,9140,4,4,4,6,19,20,-1,16
Concordia Ch,9140,5,4,2,8,19,22,-3,14
FC Botosani,9140,6,3,4,7,5,16,-11,13
FCSB,9141,1,8,5,1,25,12,13,29
CFR Cluj,9141,2,7,6,1,17,8,9,27
D Bucuresti,9141,3,4,4,6,19,20,-1,16
FC Botosani,9141,4,4,4,6,6,14,-8,16
Universitate,9141,5,3,5,6,15,22,-7,14
Concordia Ch,9141,6,3,2,9,17,23,-6,11
FCSB,9142,1,8,5,1,24,11,13,29
CFR Cluj,9142,2,6,6,2,16,9,7,24
Universitate,9142,3,4,5,5,16,21,-5,17
D Bucuresti,9142,4,3,6,5,19,21,-2,15
FC Botosani,9142,5,3,6,5,8,15,-7,15
Concordia Ch,9142,6,2,4,8,19,25,-6,10
FCSB,9143,1,7,7,0,26,13,13,28
CFR Cluj,9143,2,6,7,1,18,9,9,25
D Bucuresti,9143,3,5,4,5,18,18,0,19
FC Botosani,9143,4,4,4,6,7,13,-6,16
Universitate,9143,5,3,6,5,15,22,-7,15
Concordia Ch,9143,6,2,2,10,15,24,-9,8
FCSB,9144,1,8,5,1,26,12,14,29
CFR Cluj,9144,2,6,6,2,15,9,6,24
D Bucuresti,9144,3,5,4,5,20,19,1,19
Universitate,9144,4,4,5,5,16,21,-5,17
FC Botosani,9144,5,3,4,7,7,17,-10,13
Concordia Ch,9144,6,3,2,9,19,25,-6,11
FCSB,9145,1,9,5,0,28,12,16,32
CFR Cluj,9145,2,5,7,2,14,9,5,22
D Bucuresti,9145,3,4,5,5,19,19,0,17
Universitate,9145,4,3,6,5,15,21,-6,15
FC Botosani,9145,5,3,4,7,6,16,-10,13
Concordia Ch,9145,6,3,3,8,16,21,-5,12
FCSB,9146,1,9,5,0,26,10,16,32
CFR Cluj,9146,2,5,7,2,14,9,5,22
D Bucuresti,9146,3,4,4,6,20,20,0,16
FC Botosani,9146,4,4,4,6,8,15,-7,16
Universitate,9146,5,3,6,5,15,21,-6,15
Concordia Ch,9146,6,3,2,9,17,25,-8,11
FCSB,9147,1,8,6,0,26,12,14,30
CFR Cluj,9147,2,6,6,2,18,9,9,24
D Bucuresti,9147,3,5,4,5,22,19,3,19
Universitate,9147,4,3,6,5,15,23,-8,15
FC Botosani,9147,5,3,5,6,6,17,-11,14
Concordia Ch,9147,6,2,3,9,15,22,-7,9
FCSB,9148,1,8,5,1,25,12,13,29
CFR Cluj,9148,2,5,6,3,14,10,4,21
Universitate,9148,3,5,5,4,16,18,-2,20
D Bucuresti,9148,4,4,4,6,20,21,-1,16
FC Botosani,9148,5,3,5,6,6,15,-9,14
Concordia Ch,9148,6,3,3,8,17,22,-5,12
FCSB,9149,1,9,5,0,27,11,16,32
CFR Cluj,9149,2,5,7,2,13,9,4,22
D Bucuresti,9149,3,4,5,5,17,18,-1,17
Universitate,9149,4,3,6,5,15,20,-5,15
FC Botosani,9149,5,3,6,5,7,14,-7,15
Concordia Ch,9149,6,2,3,9,17,24,-7,9
FCSB,9150,1,9,5,0,29,11,18,32
CFR Cluj,9150,2,5,6,3,14,12,2,21
D Bucuresti,9150,3,5,4,5,20,19,1,19
Universitate,9150,4,4,5,5,15,20,-5,17
FC Botosani,9150,5,4,4,6,10,15,-5,16
Concordia Ch,9150,6,2,2,10,16,27,-11,8
FCSB,9151,1,7,7,0,26,13,13,28
CFR Cluj,9151,2,5,8,1,14,8,6,23
D Bucuresti,9151,3,4,5,5,20,20,0,17
Universitate,9151,4,3,7,4,16,20,-4,16
FC Botosani,9151,5,3,4,7,6,17,-11,13
Concordia Ch,9151,6,3,3,8,20,24,-4,12
FCSB,9152,1,9,5,0,28,12,16,32
CFR Cluj,9152,2,6,6,2,16,9,7,24
FC Botosani,9152,3,4,5,5,7,13,-6,17
Universitate,9152,4,3,5,6,15,23,-8,14
D Bucuresti,9152,5,3,4,7,17,21,-4,13
Concordia Ch,9152,6,3,3,8,16,21,-5,12
CFR Cluj,9153,1,7,6,1,17,8,9,27
FCSB,9153,2,7,5,2,24,14,10,26
Universitate,9153,3,4,5,5,16,20,-4,17
FC Botosani,9153,4,4,5,5,6,12,-6,17
D Bucuresti,9153,5,3,6,5,19,21,-2,15
Concordia Ch,9153,6,2,3,9,18,25,-7,9
FCSB,9154,1,9,5,0,28,11,17,32
CFR Cluj,9154,2,6,6,2,16,11,5,24
FC Botosani,9154,3,5,4,5,9,14,-5,19
Universitate,9154,4,3,5,6,15,22,-7,14
D Bucuresti,9154,5,3,4,7,17,21,-4,13
Concordia Ch,9154,6,3,2,9,17,23,-6,11
FCSB,9155,1,8,6,0,25,10,15,30
CFR Cluj,9155,2,5,7,2,13,8,5,22
Universitate,9155,3,4,5,5,15,20,-5,17
FC Botosani,9155,4,4,4,6,6,14,-8,16
Concordia Ch,9155,5,4,2,8,19,21,-2,14
D Bucuresti,9155,6,3,4,7,16,21,-5,13
FCSB,9156,1,9,5,0,28,13,15,32
CFR Cluj,9156,2,5,7,2,14,9,5,22
D Bucuresti,9156,3,4,5,5,18,19,-1,17
Universitate,9156,4,3,6,5,16,21,-5,15
FC Botosani,9156,5,3,5,6,5,13,-8,14
Concordia Ch,9156,6,3,2,9,17,23,-6,11
FCSB,9157,1,8,6,0,28,12,16,30
CFR Cluj,9157,2,6,6,2,16,11,5,24
FC Botosani,9157,3,5,4,5,10,12,-2,19
Universitate,9157,4,3,6,5,15,21,-6,15
D Bucuresti,9157,5,3,5,6,18,21,-3,14
Concordia Ch,9157,6,2,3,9,17,27,-10,9
FCSB,9158,1,8,6,0,26,11,15,30
CFR Cluj,9158,2,6,7,1,15,8,7,25
FC Botosani,9158,3,5,4,5,9,13,-4,19
Universitate,9158,4,3,5,6,16,23,-7,14
D Bucuresti,9158,5,3,4,7,17,22,-5,13
Concordia Ch,9158,6,3,2,9,18,24,-6,11
FCSB,9159,1,9,5,0,27,11,16,32
CFR Cluj,9159,2,5,7,2,13,9,4,22
Universitate,9159,3,3,6,5,15,20,-5,15
FC Botosani,9159,4,3,6,5,7,14,-7,15
D Bucuresti,9159,5,3,5,6,19,22,-3,14
Concordia Ch,9159,6,3,3,8,19,24,-5,12
FCSB,9160,1,8,5,1,25,12,13,29
CFR Cluj,9160,2,6,6,2,16,9,7,24
Universitate,9160,3,4,5,5,16,21,-5,17
D Bucuresti,9160,4,4,4,6,18,19,-1,16
Concordia Ch,9160,5,4,2,8,18,21,-3,14
FC Botosani,9160,6,3,4,7,5,16,-11,13
FCSB,9161,1,8,5,1,25,12,13,29
CFR Cluj,9161,2,6,7,1,16,9,7,25
D Bucuresti,9161,3,4,4,6,17,19,-2,16
FC Botosani,9161,4,4,4,6,6,13,-7,16
Universitate,9161,5,3,6,5,15,20,-5,15
Concordia Ch,9161,6,3,2,9,16,22,-6,11
FCSB,9162,1,7,5,2,25,14,11,26
CFR Cluj,9162,2,6,6,2,16,11,5,24
Universitate,9162,3,5,5,4,19,20,-1,20
D Bucuresti,9162,4,3,6,5,18,20,-2,15
FC Botosani,9162,5,3,5,6,5,13,-8,14
Concordia Ch,9162,6,3,3,8,18,23,-5,12
FCSB,9163,1,8,5,1,26,11,15,29
CFR Cluj,9163,2,5,6,3,13,12,1,21
Universitate,9163,3,5,5,4,17,18,-1,20
D Bucuresti,9163,4,4,4,6,18,20,-2,16
FC Botosani,9163,5,3,5,6,6,14,-8,14
Concordia Ch,9163,6,3,3,8,16,21,-5,12
FCSB,9164,1,7,6,1,26,14,12,27
CFR Cluj,9164,2,6,7,1,15,8,7,25
D Bucuresti,9164,3,5,4,5,21,19,2,19
Universitate,9164,4,3,7,4,18,22,-4,16
FC Botosani,9164,5,3,5,6,6,16,-10,14
Concordia Ch,9164,6,2,3,9,17,24,-7,9
FCSB,9165,1,8,6,0,28,12,16,30
CFR Cluj,9165,2,6,6,2,15,10,5,24
D Bucuresti,9165,3,5,4,5,22,19,3,19
FC Botosani,9165,4,4,4,6,8,15,-7,16
Universitate,9165,5,3,6,5,16,22,-6,15
Concordia Ch,9165,6,2,2,10,16,27,-11,8
FCSB,9166,1,9,5,0,27,12,15,32
CFR Cluj,9166,2,5,6,3,14,10,4,21
Universitate,9166,3,4,5,5,16,20,-4,17
FC Botosani,9166,4,4,5,5,9,13,-4,17
D Bucuresti,9166,5,3,5,6,17,20,-3,14
Concordia Ch,9166,6,3,2,9,16,24,-8,11
FCSB,9167,1,8,6,0,26,12,14,30
CFR Cluj,9167,2,5,8,1,16,10,6,23
FC Botosani,9167,3,4,4,6,8,15,-7,16
Universitate,9167,4,3,6,5,17,22,-5,15
D Bucuresti,9167,5,3,5,6,17,20,-3,14
Concordia Ch,9167,6,3,3,8,17,22,-5,12
FCSB,9168,1,8,5,1,27,13,14,29
CFR Cluj,9168,2,5,6,3,16,13,3,21
Universitate,9168,3,5,5,4,19,21,-2,20
D Bucuresti,9168,4,5,4,5,18,18,0,19
FC Botosani,9168,5,3,5,6,5,13,-8,14
Concordia Ch,9168,6,2,3,9,15,22,-7,9
FCSB,9169,1,8,5,1,25,11,14,29
CFR Cluj,9169,2,5,6,3,13,11,2,21
Universitate,9169,3,5,5,4,17,18,-1,20
FC Botosani,9169,4,5,4,5,8,13,-5,19
D Bucuresti,9169,5,3,5,6,17,20,-3,14
Concordia Ch,9169,6,2,3,9,15,22,-7,9
FCSB,9170,1,8,5,1,25,14,11,29
CFR Cluj,9170,2,6,6,2,17,9,8,24
Universitate,9170,3,4,5,5,15,19,-4,17
D Bucuresti,9170,4,3,6,5,17,19,-2,15
FC Botosani,9170,5,3,6,5,6,13,-7,15
Concordia Ch,9170,6,2,4,8,15,21,-6,10
FCSB,9171,1,8,6,0,25,11,14,30
CFR Cluj,9171,2,5,7,2,14,9,5,22
D Bucuresti,9171,3,5,4,5,20,19,1,19
Universitate,9171,4,4,5,5,17,21,-4,17
FC Botosani,9171,5,3,4,7,5,16,-11,13
Concordia Ch,9171,6,3,2,9,18,23,-5,11
FCSB,9172,1,9,5,0,27,12,15,32
CFR Cluj,9172,2,6,6,2,16,10,6,24
D Bucuresti,9172,3,4,5,5,20,19,1,17
Universitate,9172,4,3,5,6,14,20,-6,14
FC Botosani,9172,5,3,4,7,6,20,-14,13
Concordia Ch,9172,6,3,3,8,21,23,-2,12
FCSB,9173,1,8,6,0,26,11,15,30
CFR Cluj,9173,2,6,6,2,14,9,5,24
Universitate,9173,3,3,6,5,15,20,-5,15
Concordia Ch,9173,4,4,2,8,20,21,-1,14
D Bucuresti,9173,5,3,5,6,17,22,-5,14
FC Botosani,9173,6,3,5,6,6,15,-9,14
FCSB,9174,1,7,6,1,25,13,12,27
CFR Cluj,9174,2,5,8,1,14,8,6,23
FC Botosani,9174,3,5,4,5,8,13,-5,19
Universitate,9174,4,4,6,4,16,19,-3,18
D Bucuresti,9174,5,3,4,7,18,23,-5,13
Concordia Ch,9174,6,3,2,9,18,23,-5,11
FCSB,9175,1,7,5,2,24,14,10,26
CFR Cluj,9175,2,6,6,2,15,9,6,24
Universitate,9175,3,5,5,4,17,18,-1,20
D Bucuresti,9175,4,4,4,6,21,22,-1,16
FC Botosani,9175,5,3,5,6,8,17,-9,14
Concordia Ch,9175,6,3,3,8,20,25,-5,12
FCSB,9176,1,8,5,1,25,12,13,29
CFR Cluj,9176,2,6,7,1,16,9,7,25
D Bucuresti,9176,3,4,4,6,19,21,-2,16
Universitate,9176,4,3,6,5,15,20,-5,15
FC Botosani,9176,5,3,5,6,7,15,-8,14
Concordia Ch,9176,6,3,3,8,18,23,-5,12
CFR Cluj,9177,1,7,6,1,17,8,9,27
FCSB,9177,2,7,5,2,23,13,10,26
D Bucuresti,9177,3,5,4,5,21,18,3,19
Universitate,9177,4,4,5,5,17,21,-4,17
FC Botosani,9177,5,3,5,6,5,16,-11,14
Concordia Ch,9177,6,2,3,9,15,22,-7,9
FCSB,9178,1,7,6,1,24,12,12,27
CFR Cluj,9178,2,6,6,2,14,10,4,24
D Bucuresti,9178,3,5,4,5,21,20,1,19
Universitate,9178,4,4,6,4,18,19,-1,18
FC Botosani,9178,5,3,4,7,5,15,-10,13
Concordia Ch,9178,6,3,2,9,18,24,-6,11
FCSB,9179,1,8,6,0,26,10,16,30
CFR Cluj,9179,2,6,7,1,15,8,7,25
D Bucuresti,9179,3,5,4,5,22,18,4,19
Universitate,9179,4,3,5,6,15,23,-8,14
FC Botosani,9179,5,3,5,6,6,17,-11,14
Concordia Ch,9179,6,2,3,9,16,24,-8,9
FCSB,9180,1,9,5,0,27,10,17,32
CFR Cluj,9180,2,5,6,3,14,11,3,21
D Bucuresti,9180,3,5,4,5,21,18,3,19
Universitate,9180,4,4,5,5,17,22,-5,17
FC Botosani,9180,5,3,5,6,5,14,-9,14
Concordia Ch,9180,6,2,3,9,15,24,-9,9
FCSB,9181,1,9,5,0,25,10,15,32
CFR Cluj,9181,2,6,6,2,15,8,7,24
FC Botosani,9181,3,4,5,5,9,15,-6,17
D Bucuresti,9181,4,3,5,6,18,21,-3,14
Universitate,9181,5,3,5,6,14,21,-7,14
Concordia Ch,9181,6,3,2,9,17,23,-6,11
FCSB,9182,1,8,5,1,24,13,11,29
CFR Cluj,9182,2,7,6,1,18,8,10,27
D Bucuresti,9182,3,5,4,5,23,21,2,19
FC Botosani,9182,4,4,4,6,8,15,-7,16
Universitate,9182,5,3,5,6,15,21,-6,14
Concordia Ch,9182,6,2,2,10,17,27,-10,8
FCSB,9183,1,7,6,1,27,16,11,27
CFR Cluj,9183,2,6,6,2,17,11,6,24
Universitate,9183,3,4,6,4,20,22,-2,18
FC Botosani,9183,4,4,5,5,6,12,-6,17
D Bucuresti,9183,5,3,5,6,16,19,-3,14
Concordia Ch,9183,6,3,2,9,16,22,-6,11
FCSB,9184,1,8,6,0,26,10,16,30
CFR Cluj,9184,2,5,7,2,13,8,5,22
D Bucuresti,9184,3,5,4,5,23,20,3,19
Universitate,9184,4,4,5,5,15,21,-6,17
FC Botosani,9184,5,4,4,6,9,19,-10,16
Concordia Ch,9184,6,2,2,10,18,26,-8,8
FCSB,9185,1,8,5,1,25,12,13,29
CFR Cluj,9185,2,6,6,2,15,9,6,24
D Bucuresti,9185,3,5,4,5,21,19,2,19
Universitate,9185,4,4,5,5,15,19,-4,17
FC Botosani,9185,5,3,5,6,6,16,-10,14
Concordia Ch,9185,6,2,3,9,17,24,-7,9
FCSB,9186,1,8,5,1,26,15,11,29
CFR Cluj,9186,2,6,6,2,15,9,6,24
Universitate,9186,3,4,5,5,18,20,-2,17
FC Botosani,9186,4,4,5,5,7,13,-6,17
D Bucuresti,9186,5,3,5,6,16,19,-3,14
Concordia Ch,9186,6,2,4,8,16,22,-6,10
FCSB,9187,1,8,5,1,26,11,15,29
CFR Cluj,9187,2,5,6,3,14,12,2,21
Universitate,9187,3,5,5,4,17,19,-2,20
D Bucuresti,9187,4,4,5,5,18,19,-1,17
FC Botosani,9187,5,3,6,5,6,13,-7,15
Concordia Ch,9187,6,2,3,9,15,22,-7,9
FCSB,9188,1,8,6,0,26,12,14,30
CFR Cluj,9188,2,6,7,1,15,8,7,25
D Bucuresti,9188,3,4,5,5,17,18,-1,17
Universitate,9188,4,3,5,6,15,21,-6,14
FC Botosani,9188,5,3,5,6,6,14,-8,14
Concordia Ch,9188,6,2,4,8,16,22,-6,10
FCSB,9189,1,8,5,1,24,11,13,29
CFR Cluj,9189,2,6,6,2,15,8,7,24
Universitate,9189,3,4,5,5,15,20,-5,17
D Bucuresti,9189,4,4,4,6,19,21,-2,16
FC Botosani,9189,5,3,5,6,8,16,-8,14
Concordia Ch,9189,6,3,3,8,19,24,-5,12
FCSB,9190,1,8,6,0,24,10,14,30
CFR Cluj,9190,2,6,6,2,14,8,6,24
D Bucuresti,9190,3,4,4,6,17,20,-3,16
Universitate,9190,4,3,6,5,14,19,-5,15
Concordia Ch,9190,5,4,2,8,19,22,-3,14
FC Botosani,9190,6,3,4,7,6,15,-9,13
FCSB,9191,1,8,5,1,27,14,13,29
CFR Cluj,9191,2,7,6,1,17,9,8,27
FC Botosani,9191,3,4,5,5,10,15,-5,17
D Bucuresti,9191,4,3,6,5,19,21,-2,15
Universitate,9191,5,3,5,6,17,23,-6,14
Concordia Ch,9191,6,2,3,9,17,25,-8,9
FCSB,9192,1,9,5,0,31,11,20,32
CFR Cluj,9192,2,5,7,2,13,10,3,22
D Bucuresti,9192,3,5,4,5,20,20,0,19
FC Botosani,9192,4,4,4,6,7,14,-7,16
Universitate,9192,5,3,6,5,15,23,-8,15
Concordia Ch,9192,6,2,2,10,18,26,-8,8
FCSB,9193,1,7,6,1,25,13,12,27
CFR Cluj,9193,2,7,6,1,20,9,11,27
FC Botosani,9193,3,4,4,6,7,15,-8,16
Universitate,9193,4,3,6,5,14,22,-8,15
Concordia Ch,9193,5,4,2,8,23,25,-2,14
D Bucuresti,9193,6,3,4,7,19,24,-5,13
FCSB,9194,1,9,5,0,26,10,16,32
CFR Cluj,9194,2,6,6,2,14,9,5,24
FC Botosani,9194,3,3,6,5,6,13,-7,15
D Bucuresti,9194,4,3,5,6,16,19,-3,14
Universitate,9194,5,3,5,6,14,20,-6,14
Concordia Ch,9194,6,3,3,8,17,22,-5,12
FCSB,9195,1,8,5,1,26,11,15,29
CFR Cluj,9195,2,5,7,2,14,11,3,22
Universitate,9195,3,4,6,4,16,19,-3,18
D Bucuresti,9195,4,4,4,6,18,22,-4,16
FC Botosani,9195,5,4,4,6,7,14,-7,16
Concordia Ch,9195,6,3,2,9,18,22,-4,11
FCSB,9196,1,7,7,0,26,13,13,28
CFR Cluj,9196,2,6,7,1,16,8,8,25
D Bucuresti,9196,3,4,5,5,18,18,0,17
Universitate,9196,4,3,6,5,16,22,-6,15
FC Botosani,9196,5,3,5,6,6,14,-8,14
Concordia Ch,9196,6,3,2,9,17,24,-7,11
FCSB,9197,1,8,6,0,25,11,14,30
CFR Cluj,9197,2,5,7,2,14,9,5,22
D Bucuresti,9197,3,5,4,5,20,20,0,19
Universitate,9197,4,4,5,5,15,19,-4,17
FC Botosani,9197,5,4,4,6,6,13,-7,16
Concordia Ch,9197,6,2,2,10,17,25,-8,8
FCSB,9198,1,8,5,1,29,15,14,29
CFR Cluj,9198,2,5,6,3,16,14,2,21
Universitate,9198,3,5,5,4,19,20,-1,20
D Bucuresti,9198,4,5,4,5,19,18,1,19
FC Botosani,9198,5,4,4,6,7,15,-8,16
Concordia Ch,9198,6,2,2,10,16,24,-8,8
FCSB,9199,1,7,7,0,25,12,13,28
CFR Cluj,9199,2,5,7,2,13,8,5,22
Universitate,9199,3,4,6,4,17,20,-3,18
D Bucuresti,9199,4,4,5,5,18,19,-1,17
FC Botosani,9199,5,3,5,6,6,14,-8,14
Concordia Ch,9199,6,2,4,8,15,21,-6,10
FCSB,9200,1,7,5,2,23,13,10,26
CFR Cluj,9200,2,6,7,1,14,7,7,25
Universitate,9200,3,4,6,4,16,18,-2,18
FC Botosani,9200,4,4,4,6,7,13,-6,16
Concordia Ch,9200,5,4,2,8,20,22,-2,14
D Bucuresti,9200,6,3,4,7,17,24,-7,13
CFR Cluj,9201,1,7,6,1,15,7,8,27
FCSB,9201,2,7,5,2,23,12,11,26
D Bucuresti,9201,3,5,4,5,20,19,1,19
Universitate,9201,4,4,5,5,15,19,-4,17
FC Botosani,9201,5,4,4,6,7,15,-8,16
Concordia Ch,9201,6,2,2,10,17,25,-8,8
FCSB,9202,1,8,6,0,25,11,14,30
CFR Cluj,9202,2,6,7,1,15,8,7,25
D Bucuresti,9202,3,4,5,5,21,18,3,17
Universitate,9202,4,3,5,6,16,22,-6,14
FC Botosani,9202,5,3,4,7,5,18,-13,13
Concordia Ch,9202,6,3,3,8,16,21,-5,12
FCSB,9203,1,7,5,2,25,15,10,26
CFR Cluj,9203,2,6,7,1,16,9,7,25
Universitate,9203,3,4,6,4,18,20,-2,18
FC Botosani,9203,4,4,4,6,6,13,-7,16
Concordia Ch,9203,5,4,2,8,20,24,-4,14
D Bucuresti,9203,6,3,4,7,19,23,-4,13
FCSB,9204,1,7,6,1,23,11,12,27
CFR Cluj,9204,2,7,6,1,16,8,8,27
D Bucuresti,9204,3,3,6,5,18,20,-2,15
Universitate,9204,4,3,6,5,15,20,-5,15
FC Botosani,9204,5,3,5,6,6,14,-8,14
Concordia Ch,9204,6,3,3,8,17,22,-5,12
FCSB,9205,1,8,6,0,26,11,15,30
CFR Cluj,9205,2,5,7,2,14,10,4,22
D Bucuresti,9205,3,5,4,5,21,21,0,19
Universitate,9205,4,3,7,4,16,20,-4,16
FC Botosani,9205,5,3,4,7,6,15,-9,13
Concordia Ch,9205,6,3,2,9,18,24,-6,11
FCSB,9206,1,8,6,0,26,12,14,30
CFR Cluj,9206,2,5,7,2,15,10,5,22
Universitate,9206,3,4,5,5,15,19,-4,17
D Bucuresti,9206,4,4,4,6,19,22,-3,16
Concordia Ch,9206,5,4,2,8,20,23,-3,14
FC Botosani,9206,6,3,4,7,7,16,-9,13
FCSB,9207,1,9,5,0,28,12,16,32
CFR Cluj,9207,2,5,6,3,14,11,3,21
D Bucuresti,9207,3,5,4,5,21,21,0,19
Universitate,9207,4,4,5,5,16,20,-4,17
FC Botosani,9207,5,4,4,6,7,14,-7,16
Concordia Ch,9207,6,2,2,10,17,25,-8,8
FCSB,9208,1,7,6,1,24,13,11,27
CFR Cluj,9208,2,6,7,1,18,7,11,25
D Bucuresti,9208,3,4,5,5,22,22,0,17
Universitate,9208,4,4,5,5,17,24,-7,17
FC Botosani,9208,5,3,6,5,9,16,-7,15
Concordia Ch,9208,6,2,3,9,17,25,-8,9
FCSB,9209,1,7,5,2,23,16,7,26
CFR Cluj,9209,2,6,6,2,17,9,8,24
Universitate,9209,3,5,5,4,18,18,0,20
D Bucuresti,9209,4,4,4,6,21,22,-1,16
FC Botosani,9209,5,3,5,6,7,16,-9,14
Concordia Ch,9209,6,3,3,8,21,26,-5,12
FCSB,9210,1,8,5,1,25,12,13,29
CFR Cluj,9210,2,5,6,3,13,11,2,21
Universitate,9210,3,5,5,4,18,18,0,20
D Bucuresti,9210,4,4,4,6,20,21,-1,16
FC Botosani,9210,5,3,5,6,5,16,-11,14
Concordia Ch,9210,6,3,3,8,18,21,-3,12
FCSB,9211,1,8,5,1,26,13,13,29
CFR Cluj,9211,2,6,6,2,16,10,6,24
Universitate,9211,3,4,5,5,16,20,-4,17
FC Botosani,9211,4,4,4,6,9,17,-8,16
D Bucuresti,9211,5,3,5,6,18,21,-3,14
Concordia Ch,9211,6,3,3,8,20,24,-4,12
FCSB,9212,1,8,6,0,24,10,14,30
CFR Cluj,9212,2,5,8,1,13,7,6,23
D Bucuresti,9212,3,3,6,5,19,21,-2,15
Universitate,9212,4,3,6,5,14,19,-5,15
FC Botosani,9212,5,3,5,6,6,15,-9,14
Concordia Ch,9212,6,3,3,8,19,23,-4,12
FCSB,9213,1,7,7,0,24,11,13,28
CFR Cluj,9213,2,5,7,2,15,10,5,22
Universitate,9213,3,4,6,4,16,19,-3,18
FC Botosani,9213,4,4,5,5,7,13,-6,17
D Bucuresti,9213,5,3,5,6,19,22,-3,14
Concordia Ch,9213,6,2,4,8,17,23,-6,10
FCSB,9214,1,7,6,1,26,14,12,27
CFR Cluj,9214,2,7,6,1,16,8,8,27
D Bucuresti,9214,3,4,5,5,20,20,0,17
Universitate,9214,4,3,6,5,16,21,-5,15
FC Botosani,9214,5,3,5,6,6,14,-8,14
Concordia Ch,9214,6,3,2,9,17,24,-7,11
FCSB,9215,1,9,5,0,25,10,15,32
CFR Cluj,9215,2,5,7,2,14,9,5,22
FC Botosani,9215,3,4,4,6,8,14,-6,16
Universitate,9215,4,3,6,5,15,20,-5,15
Concordia Ch,9215,5,4,2,8,17,21,-4,14
D Bucuresti,9215,6,3,4,7,17,22,-5,13
FCSB,9216,1,8,6,0,26,12,14,30
CFR Cluj,9216,2,6,6,2,16,9,7,24
D Bucuresti,9216,3,5,4,5,20,18,2,19
Universitate,9216,4,3,6,5,15,21,-6,15
FC Botosani,9216,5,3,5,6,6,16,-10,14
Concordia Ch,9216,6,2,3,9,16,23,-7,9
FCSB,9217,1,8,5,1,26,11,15,29
CFR Cluj,9217,2,6,7,1,14,7,7,25
D Bucuresti,9217,3,5,4,5,19,18,1,19
Universitate,9217,4,3,6,5,14,21,-7,15
FC Botosani,9217,5,3,4,7,5,16,-11,13
Concordia Ch,9217,6,3,2,9,18,23,-5,11
FCSB,9218,1,8,6,0,25,11,14,30
CFR Cluj,9218,2,6,6,2,16,8,8,24
D Bucuresti,9218,3,4,5,5,18,18,0,17
FC Botosani,9218,4,4,5,5,7,12,-5,17
Universitate,9218,5,3,6,5,15,22,-7,15
Concordia Ch,9218,6,2,2,10,15,25,-10,8
FCSB,9219,1,9,5,0,29,13,16,32
CFR Cluj,9219,2,6,6,2,16,10,6,24
D Bucuresti,9219,3,4,4,6,18,21,-3,16
FC Botosani,9219,4,4,4,6,8,14,-6,16
Universitate,9219,5,3,5,6,17,24,-7,14
Concordia Ch,9219,6,3,2,9,19,25,-6,11
FCSB,9220,1,8,5,1,24,11,13,29
CFR Cluj,9220,2,5,6,3,15,11,4,21
Universitate,9220,3,5,5,4,18,20,-2,20
D Bucuresti,9220,4,4,5,5,18,19,-1,17
FC Botosani,9220,5,4,5,5,8,12,-4,17
Concordia Ch,9220,6,2,2,10,16,26,-10,8
FCSB,9221,1,8,6,0,27,13,14,30
CFR Cluj,9221,2,5,8,1,18,12,6,23
FC Botosani,9221,3,4,4,6,8,15,-7,16
Universitate,9221,4,3,6,5,18,23,-5,15
D Bucuresti,9221,5,3,5,6,17,20,-3,14
Concordia Ch,9221,6,3,3,8,19,24,-5,12
FCSB,9222,1,9,5,0,26,11,15,32
CFR Cluj,9222,2,5,6,3,14,11,3,21
Universitate,9222,3,4,5,5,16,19,-3,17
FC Botosani,9222,4,4,5,5,7,13,-6,17
D Bucuresti,9222,5,4,4,6,18,20,-2,16
Concordia Ch,9222,6,2,3,9,17,24,-7,9
FCSB,9223,1,9,5,0,27,11,16,32
CFR Cluj,9223,2,5,6,3,13,10,3,21
D Bucuresti,9223,3,4,5,5,18,19,-1,17
Universitate,9223,4,4,5,5,16,20,-4,17
FC Botosani,9223,5,3,5,6,5,13,-8,14
Concordia Ch,9223,6,2,4,8,16,22,-6,10
FCSB,9224,1,8,6,0,24,10,14,30
CFR Cluj,9224,2,6,6,2,16,8,8,24
Universitate,9224,3,3,6,5,14,21,-7,15
FC Botosani,9224,4,3,6,5,5,12,-7,15
D Bucuresti,9224,5,3,5,6,17,20,-3,14
Concordia Ch,9224,6,3,3,8,17,22,-5,12
FCSB,9225,1,7,5,2,25,16,9,26
CFR Cluj,9225,2,6,7,1,14,7,7,25
Universitate,9225,3,4,6,4,19,20,-1,18
D Bucuresti,9225,4,4,4,6,19,22,-3,16
FC Botosani,9225,5,4,4,6,8,15,-7,16
Concordia Ch,9225,6,3,2,9,19,24,-5,11
FCSB,9226,1,7,6,1,24,13,11,27
CFR Cluj,9226,2,6,7,1,16,9,7,25
Universitate,9226,3,4,5,5,17,20,-3,17
D Bucuresti,9226,4,4,4,6,18,22,-4,16
FC Botosani,9226,5,3,5,6,5,13,-8,14
Concordia Ch,9226,6,3,3,8,19,22,-3,12
FCSB,9227,1,7,6,1,25,13,12,27
CFR Cluj,9227,2,6,6,2,15,9,6,24
D Bucuresti,9227,3,5,4,5,21,19,2,19
Universitate,9227,4,4,6,4,16,19,-3,18
FC Botosani,9227,5,4,4,6,8,17,-9,16
Concordia Ch,9227,6,2,2,10,16,24,-8,8
FCSB,9228,1,7,7,0,24,11,13,28
CFR Cluj,9228,2,6,7,1,15,7,8,25
D Bucuresti,9228,3,4,4,6,19,21,-2,16
FC Botosani,9228,4,4,4,6,8,15,-7,16
Universitate,9228,5,3,6,5,15,21,-6,15
Concordia Ch,9228,6,3,2,9,18,24,-6,11
FCSB,9229,1,7,6,1,23,12,11,27
CFR Cluj,9229,2,5,7,2,14,10,4,22
Universitate,9229,3,5,5,4,19,19,0,20
D Bucuresti,9229,4,4,4,6,18,20,-2,16
FC Botosani,9229,5,4,4,6,8,15,-7,16
Concordia Ch,9229,6,3,2,9,19,25,-6,11
FCSB,9230,1,8,6,0,26,11,15,30
CFR Cluj,9230,2,6,7,1,16,8,8,25
D Bucuresti,9230,3,3,6,5,18,20,-2,15
FC Botosani,9230,4,3,6,5,7,14,-7,15
Universitate,9230,5,3,5,6,14,22,-8,14
Concordia Ch,9230,6,2,4,8,17,23,-6,10
CFR Cluj,9231,1,7,6,1,17,8,9,27
FCSB,9231,2,7,5,2,25,14,11,26
Universitate,9231,3,4,5,5,16,21,-5,17
FC Botosani,9231,4,4,5,5,8,14,-6,17
D Bucuresti,9231,5,3,5,6,18,21,-3,14
Concordia Ch,9231,6,3,2,9,20,26,-6,11
FCSB,9232,1,7,7,0,25,12,13,28
CFR Cluj,9232,2,5,8,1,14,8,6,23
D Bucuresti,9232,3,5,4,5,19,18,1,19
Universitate,9232,4,3,7,4,15,19,-4,16
FC Botosani,9232,5,3,5,6,6,15,-9,14
Concordia Ch,9232,6,2,3,9,16,23,-7,9
FCSB,9233,1,8,5,1,25,14,11,29
CFR Cluj,9233,2,5,6,3,13,10,3,21
Universitate,9233,3,5,5,4,19,18,1,20
D Bucuresti,9233,4,4,5,5,19,19,0,17
FC Botosani,9233,5,3,5,6,7,16,-9,14
Concordia Ch,9233,6,2,4,8,18,24,-6,10
FCSB,9234,1,8,5,1,26,12,14,29
CFR Cluj,9234,2,6,6,2,14,9,5,24
D Bucuresti,9234,3,5,4,5,20,20,0,19
Universitate,9234,4,4,5,5,16,20,-4,17
FC Botosani,9234,5,3,5,6,7,15,-8,14
Concordia Ch,9234,6,2,3,9,15,22,-7,9
FCSB,9235,1,9,5,0,30,10,20,32
CFR Cluj,9235,2,6,6,2,15,11,4,24
D Bucuresti,9235,3,4,5,5,19,20,-1,17
Universitate,9235,4,3,5,6,15,24,-9,14
FC Botosani,9235,5,3,4,7,5,15,-10,13
Concordia Ch,9235,6,3,3,8,19,23,-4,12
FCSB,9236,1,8,5,1,31,17,14,29
CFR Cluj,9236,2,5,7,2,16,13,3,22
FC Botosani,9236,3,5,4,5,9,13,-4,19
Universitate,9236,4,4,6,4,20,22,-2,18
D Bucuresti,9236,5,3,4,7,18,23,-5,13
Concordia Ch,9236,6,3,2,9,17,23,-6,11
FCSB,9237,1,8,5,1,25,12,13,29
CFR Cluj,9237,2,5,6,3,13,10,3,21
Universitate,9237,3,5,5,4,17,18,-1,20
D Bucuresti,9237,4,4,4,6,18,19,-1,16
FC Botosani,9237,5,3,5,6,5,14,-9,14
Concordia Ch,9237,6,3,3,8,16,21,-5,12
FCSB,9238,1,9,5,0,26,10,16,32
CFR Cluj,9238,2,5,7,2,13,8,5,22
D Bucuresti,9238,3,4,4,6,17,21,-4,16
Universitate,9238,4,3,6,5,14,20,-6,15
Concordia Ch,9238,5,4,2,8,19,21,-2,14
FC Botosani,9238,6,3,4,7,5,14,-9,13
CFR Cluj,9239,1,7,6,1,18,8,10,27
FCSB,9239,2,7,5,2,23,13,10,26
D Bucuresti,9239,3,5,4,5,21,21,0,19
Universitate,9239,4,4,5,5,16,21,-5,17
FC Botosani,9239,5,3,5,6,6,14,-8,14
Concordia Ch,9239,6,2,3,9,17,24,-7,9
FCSB,9240,1,8,6,0,25,10,15,30
CFR Cluj,9240,2,6,7,1,15,8,7,25
D Bucuresti,9240,3,4,4,6,18,20,-2,16
Concordia Ch,9240,4,4,2,8,18,21,-3,14
Universitate,9240,5,3,5,6,15,22,-7,14
FC Botosani,9240,6,3,4,7,5,15,-10,13
FCSB,9241,1,7,6,1,24,12,12,27
CFR Cluj,9241,2,7,6,1,15,7,8,27
D Bucuresti,9241,3,4,4,6,20,22,-2,16
FC Botosani,9241,4,4,4,6,9,16,-7,16
Universitate,9241,5,3,6,5,15,20,-5,15
Concordia Ch,9241,6,3,2,9,18,24,-6,11
FCSB,9242,1,8,5,1,29,14,15,29
CFR Cluj,9242,2,5,7,2,14,11,3,22
Universitate,9242,3,4,6,4,17,20,-3,18
D Bucuresti,9242,4,3,6,5,16,18,-2,15
FC Botosani,9242,5,3,6,5,5,12,-7,15
Concordia Ch,9242,6,2,4,8,15,21,-6,10
FCSB,9243,1,8,5,1,26,13,13,29
CFR Cluj,9243,2,5,7,2,15,10,5,22
Universitate,9243,3,4,6,4,17,20,-3,18
FC Botosani,9243,4,4,5,5,7,13,-6,17
D Bucuresti,9243,5,3,5,6,19,22,-3,14
Concordia Ch,9243,6,3,2,9,18,24,-6,11
FCSB,9244,1,7,6,1,25,14,11,27
CFR Cluj,9244,2,5,8,1,16,10,6,23
Universitate,9244,3,4,6,4,17,19,-2,18
FC Botosani,9244,4,4,4,6,6,15,-9,16
D Bucuresti,9244,5,3,5,6,17,20,-3,14
Concordia Ch,9244,6,3,3,8,19,22,-3,12
FCSB,9245,1,7,6,1,24,12,12,27
CFR Cluj,9245,2,6,7,1,15,8,7,25
Universitate,9245,3,3,7,4,16,20,-4,16
Concordia Ch,9245,4,4,2,8,18,21,-3,14
D Bucuresti,9245,5,3,5,6,16,20,-4,14
FC Botosani,9245,6,3,5,6,5,13,-8,14
CFR Cluj,9246,1,7,6,1,18,7,11,27
FCSB,9246,2,7,5,2,24,15,9,26
FC Botosani,9246,3,5,4,5,9,14,-5,19
Universitate,9246,4,4,5,5,16,21,-5,17
D Bucuresti,9246,5,4,4,6,20,22,-2,16
Concordia Ch,9246,6,2,2,10,18,26,-8,8
FCSB,9247,1,9,5,0,25,10,15,32
CFR Cluj,9247,2,6,6,2,15,9,6,24
FC Botosani,9247,3,5,4,5,7,12,-5,19
D Bucuresti,9247,4,4,4,6,18,20,-2,16
Universitate,9247,5,3,5,6,15,21,-6,14
Concordia Ch,9247,6,2,2,10,16,24,-8,8
FCSB,9248,1,8,5,1,24,11,13,29
CFR Cluj,9248,2,7,6,1,15,7,8,27
D Bucuresti,9248,3,5,4,5,20,19,1,19
FC Botosani,9248,4,4,4,6,8,15,-7,16
Universitate,9248,5,3,5,6,14,20,-6,14
Concordia Ch,9248,6,2,2,10,16,25,-9,8
FCSB,9249,1,8,6,0,25,11,14,30
CFR Cluj,9249,2,6,7,1,17,7,10,25
D Bucuresti,9249,3,4,5,5,21,21,0,17
FC Botosani,9249,4,4,4,6,6,14,-8,16
Universitate,9249,5,3,5,6,15,24,-9,14
Concordia Ch,9249,6,2,3,9,18,25,-7,9
FCSB,9250,1,8,6,0,27,11,16,30
CFR Cluj,9250,2,6,6,2,15,10,5,24
D Bucuresti,9250,3,5,4,5,23,21,2,19
FC Botosani,9250,4,4,4,6,8,16,-8,16
Universitate,9250,5,3,6,5,15,21,-6,15
Concordia Ch,9250,6,2,2,10,20,29,-9,8
FCSB,9251,1,7,5,2,24,14,10,26
CFR Cluj,9251,2,6,6,2,15,8,7,24
Universitate,9251,3,5,5,4,17,19,-2,20
FC Botosani,9251,4,3,6,5,6,13,-7,15
D Bucuresti,9251,5,3,5,6,18,21,-3,14
Concordia Ch,9251,6,3,3,8,17,22,-5,12
FCSB,9252,1,8,6,0,24,10,14,30
CFR Cluj,9252,2,5,7,2,14,9,5,22
D Bucuresti,9252,3,4,4,6,19,21,-2,16
Universitate,9252,4,3,7,4,15,19,-4,16
FC Botosani,9252,5,4,4,6,6,13,-7,16
Concordia Ch,9252,6,3,2,9,18,24,-6,11
FCSB,9253,1,8,6,0,25,11,14,30
CFR Cluj,9253,2,6,7,1,17,8,9,25
D Bucuresti,9253,3,5,4,5,20,18,2,19
Universitate,9253,4,3,5,6,16,24,-8,14
FC Botosani,9253,5,3,4,7,5,17,-12,13
Concordia Ch,9253,6,3,2,9,17,22,-5,11
FCSB,9254,1,8,6,0,25,11,14,30
CFR Cluj,9254,2,6,7,1,14,7,7,25
FC Botosani,9254,3,4,4,6,7,15,-8,16
D Bucuresti,9254,4,3,5,6,18,21,-3,14
Universitate,9254,5,3,5,6,15,21,-6,14
Concordia Ch,9254,6,3,3,8,18,22,-4,12
FCSB,9255,1,7,6,1,24,13,11,27
CFR Cluj,9255,2,6,7,1,15,8,7,25
Universitate,9255,3,4,5,5,16,19,-3,17
D Bucuresti,9255,4,4,4,6,19,21,-2,16
FC Botosani,9255,5,3,5,6,7,15,-8,14
Concordia Ch,9255,6,3,3,8,18,23,-5,12
FCSB,9256,1,9,5,0,27,10,17,32
CFR Cluj,9256,2,5,7,2,14,9,5,22
D Bucuresti,9256,3,5,4,5,22,18,4,19
Universitate,9256,4,3,6,5,15,22,-7,15
FC Botosani,9256,5,3,5,6,6,16,-10,14
Concordia Ch,9256,6,2,3,9,16,25,-9,9
FCSB,9257,1,9,5,0,26,11,15,32
CFR Cluj,9257,2,5,7,2,14,9,5,22
FC Botosani,9257,3,4,5,5,7,13,-6,17
D Bucuresti,9257,4,3,6,5,19,21,-2,15
Universitate,9257,5,3,6,5,16,21,-5,15
Concordia Ch,9257,6,2,3,9,17,24,-7,9
FCSB,9258,1,8,5,1,25,12,13,29
CFR Cluj,9258,2,5,6,3,15,11,4,21
Universitate,9258,3,5,5,4,17,19,-2,20
D Bucuresti,9258,4,4,4,6,19,20,-1,16
FC Botosani,9258,5,4,4,6,6,14,-8,16
Concordia Ch,9258,6,3,2,9,17,23,-6,11
CFR Cluj,9259,1,7,6,1,18,9,9,27
FCSB,9259,2,7,5,2,24,14,10,26
Universitate,9259,3,4,5,5,16,20,-4,17
D Bucuresti,9259,4,4,4,6,19,21,-2,16
Concordia Ch,9259,5,4,2,8,19,21,-2,14
FC Botosani,9259,6,3,4,7,6,17,-11,13
FCSB,9260,1,7,6,1,23,11,12,27
CFR Cluj,9260,2,7,6,1,16,8,8,27
D Bucuresti,9260,3,4,5,5,19,20,-1,17
FC Botosani,9260,4,4,4,6,8,14,-6,16
Universitate,9260,5,3,6,5,15,20,-5,15
Concordia Ch,9260,6,2,3,9,16,24,-8,9
FCSB,9261,1,8,6,0,26,12,14,30
CFR Cluj,9261,2,6,6,2,17,10,7,24
FC Botosani,9261,3,4,5,5,8,14,-6,17
Universitate,9261,4,3,6,5,16,22,-6,15
D Bucuresti,9261,5,3,4,7,16,22,-6,13
Concordia Ch,9261,6,3,3,8,20,23,-3,12
FCSB,9262,1,8,6,0,25,10,15,30
CFR Cluj,9262,2,5,8,1,13,7,6,23
D Bucuresti,9262,3,4,4,6,22,22,0,16
Universitate,9262,4,3,6,5,14,20,-6,15
Concordia Ch,9262,5,4,2,8,20,24,-4,14
FC Botosani,9262,6,3,4,7,5,16,-11,13
FCSB,9263,1,9,5,0,28,11,17,32
CFR Cluj,9263,2,5,7,2,15,11,4,22
FC Botosani,9263,3,5,4,5,7,12,-5,19
Universitate,9263,4,3,6,5,15,21,-6,15
D Bucuresti,9263,5,3,5,6,17,20,-3,14
Concordia Ch,9263,6,2,3,9,16,23,-7,9
FCSB,9264,1,9,5,0,26,10,16,32
CFR Cluj,9264,2,6,6,2,17,10,7,24
Concordia Ch,9264,3,4,2,8,22,24,-2,14
D Bucuresti,9264,4,3,5,6,19,23,-4,14
Universitate,9264,5,3,5,6,15,23,-8,14
FC Botosani,9264,6,3,5,6,9,18,-9,14
CFR Cluj,9265,1,7,6,1,17,8,9,27
FCSB,9265,2,7,5,2,25,15,10,26
Universitate,9265,3,4,5,5,16,20,-4,17
Concordia Ch,9265,4,4,2,8,21,22,-1,14
D Bucuresti,9265,5,3,5,6,18,23,-5,14
FC Botosani,9265,6,3,5,6,6,15,-9,14
FCSB,9266,1,8,5,1,26,14,12,29
CFR Cluj,9266,2,6,6,2,16,9,7,24
Universitate,9266,3,4,5,5,17,21,-4,17
FC Botosani,9266,4,4,5,5,8,14,-6,17
D Bucuresti,9266,5,4,4,6,18,20,-2,16
Concordia Ch,9266,6,2,3,9,16,23,-7,9
FCSB,9267,1,8,6,0,27,11,16,30
CFR Cluj,9267,2,6,7,1,16,9,7,25
FC Botosani,9267,3,5,4,5,10,13,-3,19
Universitate,9267,4,3,5,6,15,23,-8,14
D Bucuresti,9267,5,3,4,7,16,22,-6,13
Concordia Ch,9267,6,3,2,9,17,23,-6,11
FCSB,9268,1,8,5,1,24,11,13,29
CFR Cluj,9268,2,6,7,1,15,8,7,25
FC Botosani,9268,3,5,4,5,8,12,-4,19
D Bucuresti,9268,4,4,4,6,18,20,-2,16
Universitate,9268,5,3,6,5,15,20,-5,15
Concordia Ch,9268,6,2,2,10,16,25,-9,8
FCSB,9269,1,9,5,0,29,13,16,32
CFR Cluj,9269,2,5,7,2,15,11,4,22
FC Botosani,9269,3,4,5,5,9,12,-3,17
D Bucuresti,9269,4,3,6,5,18,20,-2,15
Universitate,9269,5,3,6,5,15,20,-5,15
Concordia Ch,9269,6,2,3,9,17,27,-10,9
FCSB,9270,1,8,5,1,26,12,14,29
CFR Cluj,9270,2,6,7,1,15,8,7,25
FC Botosani,9270,3,4,4,6,6,13,-7,16
Universitate,9270,4,3,6,5,14,20,-6,15
Concordia Ch,9270,5,4,2,8,17,21,-4,14
D Bucuresti,9270,6,3,4,7,16,20,-4,13
FCSB,9271,1,7,6,1,23,12,11,27
CFR Cluj,9271,2,6,7,1,14,7,7,25
D Bucuresti,9271,3,5,4,5,20,19,1,19
Universitate,9271,4,4,5,5,16,19,-3,17
FC Botosani,9271,5,3,4,7,6,15,-9,13
Concordia Ch,9271,6,3,2,9,18,25,-7,11
FCSB,9272,1,8,5,1,26,14,12,29
CFR Cluj,9272,2,6,6,2,14,9,5,24
D Bucuresti,9272,3,4,5,5,18,19,-1,17
Universitate,9272,4,4,5,5,18,20,-2,17
FC Botosani,9272,5,3,4,7,5,14,-9,13
Concordia Ch,9272,6,3,3,8,17,22,-5,12
FCSB,9273,1,8,5,1,26,12,14,29
CFR Cluj,9273,2,6,6,2,16,10,6,24
D Bucuresti,9273,3,5,4,5,20,20,0,19
Universitate,9273,4,4,5,5,15,20,-5,17
FC Botosani,9273,5,3,5,6,6,14,-8,14
Concordia Ch,9273,6,2,3,9,16,23,-7,9
CFR Cluj,9274,1,7,6,1,18,9,9,27
FCSB,9274,2,7,5,2,26,17,9,26
Universitate,9274,3,4,5,5,17,20,-3,17
FC Botosani,9274,4,4,5,5,6,12,-6,17
D Bucuresti,9274,5,3,4,7,16,21,-5,13
Concordia Ch,9274,6,3,3,8,17,21,-4,12
FCSB,9275,1,8,5,1,24,12,12,29
CFR Cluj,9275,2,6,6,2,14,8,6,24
D Bucuresti,9275,3,5,4,5,19,18,1,19
Universitate,9275,4,4,5,5,16,19,-3,17
FC Botosani,9275,5,3,5,6,5,13,-8,14
Concordia Ch,9275,6,2,3,9,15,23,-8,9
FCSB,9276,1,8,5,1,24,12,12,29
CFR Cluj,9276,2,6,6,2,16,8,8,24
Universitate,9276,3,4,5,5,16,21,-5,17
D Bucuresti,9276,4,4,4,6,19,21,-2,16
Concordia Ch,9276,5,4,2,8,19,22,-3,14
FC Botosani,9276,6,3,4,7,5,15,-10,13
FCSB,9277,1,8,6,0,26,11,15,30
CFR Cluj,9277,2,6,7,1,15,8,7,25
D Bucuresti,9277,3,4,5,5,21,21,0,17
FC Botosani,9277,4,3,6,5,11,18,-7,15
Universitate,9277,5,3,5,6,14,21,-7,14
Concordia Ch,9277,6,2,3,9,18,26,-8,9
FCSB,9278,1,8,6,0,26,11,15,30
CFR Cluj,9278,2,6,6,2,17,10,7,24
FC Botosani,9278,3,5,4,5,11,13,-2,19
Universitate,9278,4,3,6,5,16,23,-7,15
D Bucuresti,9278,5,3,5,6,18,23,-5,14
Concordia Ch,9278,6,2,3,9,16,24,-8,9
FCSB,9279,1,8,5,1,25,11,14,29
CFR Cluj,9279,2,6,6,2,16,11,5,24
Universitate,9279,3,4,5,5,17,21,-4,17
D Bucuresti,9279,4,4,4,6,18,19,-1,16
Concordia Ch,9279,5,4,2,8,19,22,-3,14
FC Botosani,9279,6,3,4,7,6,17,-11,13
FCSB,9280,1,7,6,1,23,12,11,27
CFR Cluj,9280,2,7,6,1,18,8,10,27
FC Botosani,9280,3,4,5,5,7,12,-5,17
D Bucuresti,9280,4,3,6,5,18,20,-2,15
Universitate,9280,5,3,6,5,15,21,-6,15
Concordia Ch,9280,6,2,3,9,17,25,-8,9
FCSB,9281,1,9,5,0,26,11,15,32
CFR Cluj,9281,2,5,6,3,15,11,4,21
Universitate,9281,3,4,5,5,18,22,-4,17
D Bucuresti,9281,4,4,4,6,19,22,-3,16
FC Botosani,9281,5,3,5,6,6,14,-8,14
Concordia Ch,9281,6,3,3,8,18,22,-4,12
FCSB,9282,1,7,6,1,23,11,12,27
CFR Cluj,9282,2,6,7,1,15,7,8,25
D Bucuresti,9282,3,4,5,5,18,19,-1,17
Universitate,9282,4,4,5,5,15,20,-5,17
FC Botosani,9282,5,4,4,6,7,13,-6,16
Concordia Ch,9282,6,2,3,9,16,24,-8,9
CFR Cluj,9283,1,7,6,1,18,7,11,27
FCSB,9283,2,7,5,2,24,15,9,26
Universitate,9283,3,4,5,5,17,22,-5,17
FC Botosani,9283,4,4,5,5,8,13,-5,17
D Bucuresti,9283,5,3,5,6,17,21,-4,14
Concordia Ch,9283,6,2,4,8,17,23,-6,10
FCSB,9284,1,8,5,1,27,16,11,29
CFR Cluj,9284,2,6,7,1,19,10,9,25
D Bucuresti,9284,3,3,6,5,17,19,-2,15
Universitate,9284,4,3,6,5,16,21,-5,15
FC Botosani,9284,5,3,6,5,6,13,-7,15
Concordia Ch,9284,6,2,4,8,15,21,-6,10
FCSB,9285,1,7,6,1,24,12,12,27
CFR Cluj,9285,2,5,7,2,15,10,5,22
Universitate,9285,3,5,5,4,17,19,-2,20
D Bucuresti,9285,4,4,4,6,20,21,-1,16
Concordia Ch,9285,5,4,2,8,19,21,-2,14
FC Botosani,9285,6,3,4,7,7,19,-12,13
FCSB,9286,1,8,5,1,27,15,12,29
CFR Cluj,9286,2,5,6,3,17,13,4,21
Universitate,9286,3,5,5,4,20,21,-1,20
D Bucuresti,9286,4,5,4,5,19,19,0,19
FC Botosani,9286,5,3,4,7,7,16,-9,13
Concordia Ch,9286,6,3,2,9,17,23,-6,11
FCSB,9287,1,8,6,0,25,11,14,30
CFR Cluj,9287,2,5,7,2,14,9,5,22
D Bucuresti,9287,3,4,5,5,19,19,0,17
Universitate,9287,4,3,7,4,16,20,-4,16
FC Botosani,9287,5,4,4,6,8,15,-7,16
Concordia Ch,9287,6,2,3,9,17,25,-8,9
FCSB,9288,1,8,5,1,27,13,14,29
CFR Cluj,9288,2,6,7,1,17,8,9,25
D Bucuresti,9288,3,5,4,5,21,19,2,19
Universitate,9288,4,3,6,5,15,23,-8,15
FC Botosani,9288,5,3,5,6,6,15,-9,14
Concordia Ch,9288,6,2,3,9,17,25,-8,9
FCSB,9289,1,9,5,0,29,13,16,32
CFR Cluj,9289,2,6,6,2,17,10,7,24
FC Botosani,9289,3,4,5,5,9,14,-5,17
D Bucuresti,9289,4,3,5,6,18,25,-7,14
Universitate,9289,5,3,5,6,15,23,-8,14
Concordia Ch,9289,6,3,2,9,20,23,-3,11
FCSB,9290,1,8,5,1,25,12,13,29
CFR Cluj,9290,2,5,7,2,15,10,5,22
Universitate,9290,3,4,6,4,16,19,-3,18
D Bucuresti,9290,4,4,4,6,17,21,-4,16
FC Botosani,9290,5,3,5,6,6,14,-8,14
Concordia Ch,9290,6,3,3,8,19,22,-3,12
FCSB,9291,1,8,6,0,25,11,14,30
CFR Cluj,9291,2,5,7,2,13,8,5,22
D Bucuresti,9291,3,4,4,6,19,20,-1,16
Universitate,9291,4,3,7,4,15,19,-4,16
FC Botosani,9291,5,3,5,6,5,14,-9,14
Concordia Ch,9291,6,3,3,8,17,22,-5,12
FCSB,9292,1,8,6,0,24,10,14,30
CFR Cluj,9292,2,6,6,2,15,8,7,24
FC Botosani,9292,3,4,5,5,8,14,-6,17
Universitate,9292,4,3,6,5,14,20,-6,15
D Bucuresti,9292,5,3,5,6,19,22,-3,14
Concordia Ch,9292,6,2,4,8,18,24,-6,10
FCSB,9293,1,8,5,1,25,12,13,29
CFR Cluj,9293,2,5,6,3,14,11,3,21
Universitate,9293,3,5,5,4,17,18,-1,20
FC Botosani,9293,4,5,4,5,8,13,-5,19
D Bucuresti,9293,5,3,4,7,16,20,-4,13
Concordia Ch,9293,6,3,2,9,17,23,-6,11
FCSB,9294,1,8,5,1,27,12,15,29
CFR Cluj,9294,2,6,6,2,15,11,4,24
D Bucuresti,9294,3,4,5,5,18,19,-1,17
Universitate,9294,4,4,5,5,16,20,-4,17
FC Botosani,9294,5,3,5,6,5,13,-8,14
Concordia Ch,9294,6,3,2,9,17,23,-6,11
FCSB,9295,1,8,6,0,26,10,16,30
CFR Cluj,9295,2,6,7,1,14,7,7,25
FC Botosani,9295,3,4,5,5,7,13,-6,17
Universitate,9295,4,3,5,6,14,22,-8,14
D Bucuresti,9295,5,3,4,7,16,20,-4,13
Concordia Ch,9295,6,3,3,8,17,22,-5,12
FCSB,9296,1,7,7,0,25,12,13,28
CFR Cluj,9296,2,6,7,1,18,9,9,25
FC Botosani,9296,3,5,4,5,9,13,-4,19
D Bucuresti,9296,4,4,4,6,21,22,-1,16
Universitate,9296,5,3,6,5,16,23,-7,15
Concordia Ch,9296,6,2,2,10,18,28,-10,8
CFR Cluj,9297,1,7,6,1,19,11,8,27
FCSB,9297,2,7,5,2,26,15,11,26
Universitate,9297,3,4,5,5,18,22,-4,17
FC Botosani,9297,4,4,5,5,8,14,-6,17
D Bucuresti,9297,5,3,4,7,17,21,-4,13
Concordia Ch,9297,6,3,3,8,19,24,-5,12
FCSB,9298,1,7,6,1,23,12,11,27
CFR Cluj,9298,2,5,8,1,13,7,6,23
Universitate,9298,3,4,6,4,16,18,-2,18
D Bucuresti,9298,4,4,5,5,20,18,2,17
FC Botosani,9298,5,3,4,7,6,18,-12,13
Concordia Ch,9298,6,3,3,8,17,22,-5,12
FCSB,9299,1,8,5,1,28,13,15,29
CFR Cluj,9299,2,5,6,3,15,13,2,21
Universitate,9299,3,5,5,4,18,20,-2,20
D Bucuresti,9299,4,3,5,6,18,21,-3,14
Concordia Ch,9299,5,4,2,8,18,22,-4,14
FC Botosani,9299,6,3,5,6,6,14,-8,14
FCSB,9300,1,7,5,2,23,12,11,26
CFR Cluj,9300,2,6,6,2,14,10,4,24
Universitate,9300,3,5,5,4,18,18,0,20
D Bucuresti,9300,4,4,4,6,18,20,-2,16
Concordia Ch,9300,5,4,2,8,20,23,-3,14
FC Botosani,9300,6,3,4,7,6,16,-10,13
FCSB,9301,1,8,6,0,26,12,14,30
CFR Cluj,9301,2,5,8,1,16,10,6,23
FC Botosani,9301,3,4,4,6,9,16,-7,16
Universitate,9301,4,3,6,5,15,20,-5,15
Concordia Ch,9301,5,4,2,8,19,22,-3,14
D Bucuresti,9301,6,3,4,7,17,22,-5,13
FCSB,9302,1,9,5,0,26,11,15,32
CFR Cluj,9302,2,5,6,3,14,10,4,21
D Bucuresti,9302,3,5,4,5,23,21,2,19
Universitate,9302,4,4,5,5,15,19,-4,17
FC Botosani,9302,5,3,5,6,7,16,-9,14
Concordia Ch,9302,6,2,3,9,18,26,-8,9
FCSB,9303,1,7,6,1,24,14,10,27
CFR Cluj,9303,2,6,7,1,18,9,9,25
Universitate,9303,3,3,7,4,15,19,-4,16
D Bucuresti,9303,4,3,5,6,16,19,-3,14
Concordia Ch,9303,5,4,2,8,18,22,-4,14
FC Botosani,9303,6,3,5,6,6,14,-8,14
FCSB,9304,1,7,6,1,24,14,10,27
CFR Cluj,9304,2,5,8,1,15,9,6,23
D Bucuresti,9304,3,5,4,5,19,19,0,19
Universitate,9304,4,4,6,4,18,19,-1,18
FC Botosani,9304,5,3,4,7,5,16,-11,13
Concordia Ch,9304,6,3,2,9,19,23,-4,11
FCSB,9305,1,8,5,1,27,11,16,29
CFR Cluj,9305,2,6,6,2,16,11,5,24
D Bucuresti,9305,3,5,4,5,21,20,1,19
Universitate,9305,4,4,5,5,15,21,-6,17
FC Botosani,9305,5,4,4,6,7,15,-8,16
Concordia Ch,9305,6,2,2,10,16,24,-8,8
FCSB,9306,1,7,6,1,26,14,12,27
CFR Cluj,9306,2,6,7,1,15,8,7,25
FC Botosani,9306,3,5,4,5,7,12,-5,19
Universitate,9306,4,4,5,5,17,21,-4,17
D Bucuresti,9306,5,3,4,7,16,20,-4,13
Concordia Ch,9306,6,3,2,9,16,22,-6,11
CFR Cluj,9307,1,7,6,1,16,7,9,27
FCSB,9307,2,7,5,2,23,13,10,26
FC Botosani,9307,3,5,4,5,7,12,-5,19
Universitate,9307,4,4,5,5,16,20,-4,17
D Bucuresti,9307,5,3,4,7,16,20,-4,13
Concordia Ch,9307,6,3,2,9,16,22,-6,11
FCSB,9308,1,9,5,0,30,10,20,32
CFR Cluj,9308,2,5,7,2,14,11,3,22
FC Botosani,9308,3,5,4,5,7,12,-5,19
Universitate,9308,4,3,6,5,15,23,-8,15
D Bucuresti,9308,5,3,5,6,16,19,-3,14
Concordia Ch,9308,6,2,3,9,15,22,-7,9
FCSB,9309,1,8,6,0,28,12,16,30
CFR Cluj,9309,2,6,7,1,17,10,7,25
D Bucuresti,9309,3,5,4,5,22,19,3,19
Universitate,9309,4,3,5,6,15,23,-8,14
FC Botosani,9309,5,3,4,7,7,17,-10,13
Concordia Ch,9309,6,3,2,9,18,26,-8,11
FCSB,9310,1,7,6,1,23,11,12,27
CFR Cluj,9310,2,6,7,1,14,7,7,25
D Bucuresti,9310,3,5,4,5,20,19,1,19
Universitate,9310,4,4,5,5,15,19,-4,17
FC Botosani,9310,5,3,4,7,5,14,-9,13
Concordia Ch,9310,6,3,2,9,17,24,-7,11
FCSB,9311,1,9,5,0,27,11,16,32
CFR Cluj,9311,2,5,6,3,14,11,3,21
D Bucuresti,9311,3,5,4,5,20,19,1,19
Universitate,9311,4,4,5,5,16,20,-4,17
FC Botosani,9311,5,4,4,6,8,14,-6,16
Concordia Ch,9311,6,2,2,10,15,25,-10,8
FCSB,9312,1,8,6,0,27,13,14,30
CFR Cluj,9312,2,5,6,3,14,12,2,21
Universitate,9312,3,4,6,4,19,20,-1,18
D Bucuresti,9312,4,4,4,6,22,20,2,16
FC Botosani,9312,5,3,5,6,6,18,-12,14
Concordia Ch,9312,6,3,3,8,18,23,-5,12
FCSB,9313,1,8,6,0,27,12,15,30
CFR Cluj,9313,2,6,7,1,15,8,7,25
FC Botosani,9313,3,4,5,5,8,13,-5,17
D Bucuresti,9313,4,3,5,6,16,20,-4,14
Universitate,9313,5,3,5,6,15,22,-7,14
Concordia Ch,9313,6,2,4,8,16,22,-6,10
FCSB,9314,1,8,5,1,25,12,13,29
CFR Cluj,9314,2,5,6,3,14,10,4,21
Universitate,9314,3,5,5,4,18,20,-2,20
D Bucuresti,9314,4,4,5,5,17,18,-1,17
FC Botosani,9314,5,3,4,7,5,15,-10,13
Concordia Ch,9314,6,3,3,8,17,21,-4,12
FCSB,9315,1,8,6,0,32,11,21,30
CFR Cluj,9315,2,5,6,3,13,16,-3,21
Universitate,9315,3,4,6,4,16,19,-3,18
D Bucuresti,9315,4,4,5,5,18,18,0,17
FC Botosani,9315,5,4,4,6,8,14,-6,16
Concordia Ch,9315,6,2,3,9,15,24,-9,9
FCSB,9316,1,8,5,1,24,11,13,29
CFR Cluj,9316,2,5,7,2,13,8,5,22
Universitate,9316,3,4,6,4,15,18,-3,18
Concordia Ch,9316,4,4,2,8,19,22,-3,14
D Bucuresti,9316,5,3,5,6,16,19,-3,14
FC Botosani,9316,6,3,5,6,6,15,-9,14
FCSB,9317,1,8,6,0,27,13,14,30
CFR Cluj,9317,2,6,7,1,15,8,7,25
FC Botosani,9317,3,4,4,6,8,15,-7,16
D Bucuresti,9317,4,3,5,6,18,21,-3,14
Universitate,9317,5,3,5,6,18,24,-6,14
Concordia Ch,9317,6,3,3,8,18,23,-5,12
CFR Cluj,9318,1,7,6,1,20,8,12,27
FCSB,9318,2,7,5,2,24,13,11,26
Universitate,9318,3,4,5,5,15,23,-8,17
D Bucuresti,9318,4,4,4,6,18,20,-2,16
FC Botosani,9318,5,3,5,6,7,15,-8,14
Concordia Ch,9318,6,3,3,8,19,24,-5,12
FCSB,9319,1,7,5,2,23,13,10,26
CFR Cluj,9319,2,6,7,1,15,7,8,25
Universitate,9319,3,4,6,4,15,18,-3,18
D Bucuresti,9319,4,4,5,5,19,19,0,17
FC Botosani,9319,5,3,4,7,5,15,-10,13
Concordia Ch,9319,6,3,3,8,17,22,-5,12
FCSB,9320,1,7,7,0,24,11,13,28
CFR Cluj,9320,2,6,7,1,16,9,7,25
FC Botosani,9320,3,4,4,6,6,13,-7,16
Universitate,9320,4,3,6,5,15,20,-5,15
Concordia Ch,9320,5,4,2,8,19,23,-4,14
D Bucuresti,9320,6,3,4,7,18,22,-4,13
FCSB,9321,1,7,7,0,26,13,13,28
CFR Cluj,9321,2,6,7,1,17,9,8,25
FC Botosani,9321,3,4,5,5,8,14,-6,17
D Bucuresti,9321,4,4,4,6,20,20,0,16
Universitate,9321,5,3,6,5,15,21,-6,15
Concordia Ch,9321,6,2,3,9,16,25,-9,9
FCSB,9322,1,8,5,1,25,12,13,29
CFR Cluj,9322,2,5,7,2,15,10,5,22
Universitate,9322,3,4,6,4,18,21,-3,18
FC Botosani,9322,4,4,5,5,7,13,-6,17
D Bucuresti,9322,5,3,5,6,18,22,-4,14
Concordia Ch,9322,6,3,2,9,20,25,-5,11
FCSB,9323,1,9,5,0,27,12,15,32
CFR Cluj,9323,2,5,7,2,15,10,5,22
D Bucuresti,9323,3,4,4,6,18,19,-1,16
FC Botosani,9323,4,4,4,6,8,14,-6,16
Universitate,9323,5,3,6,5,16,21,-5,15
Concordia Ch,9323,6,3,2,9,16,24,-8,11
FCSB,9324,1,7,6,1,24,13,11,27
CFR Cluj,9324,2,6,7,1,16,7,9,25
FC Botosani,9324,3,5,4,5,9,13,-4,19
Universitate,9324,4,4,5,5,17,22,-5,17
D Bucuresti,9324,5,3,5,6,18,22,-4,14
Concordia Ch,9324,6,2,3,9,16,23,-7,9
FCSB,9325,1,8,5,1,25,12,13,29
CFR Cluj,9325,2,7,6,1,15,7,8,27
FC Botosani,9325,3,5,4,5,9,14,-5,19
Universitate,9325,4,3,5,6,15,21,-6,14
D Bucuresti,9325,5,3,4,7,17,24,-7,13
Concordia Ch,9325,6,3,2,9,20,23,-3,11
FCSB,9326,1,9,5,0,25,10,15,32
CFR Cluj,9326,2,6,6,2,16,8,8,24
D Bucuresti,9326,3,4,5,5,20,20,0,17
Universitate,9326,4,3,5,6,14,22,-8,14
FC Botosani,9326,5,3,5,6,6,15,-9,14
Concordia Ch,9326,6,2,4,8,18,24,-6,10
FCSB,9327,1,9,5,0,27,11,16,32
CFR Cluj,9327,2,6,6,2,16,9,7,24
FC Botosani,9327,3,5,4,5,7,12,-5,19
Universitate,9327,4,3,5,6,14,22,-8,14
D Bucuresti,9327,5,3,4,7,17,21,-4,13
Concordia Ch,9327,6,3,2,9,17,23,-6,11
FCSB,9328,1,8,5,1,25,11,14,29
CFR Cluj,9328,2,7,6,1,16,7,9,27
FC Botosani,9328,3,4,5,5,7,13,-6,17
D Bucuresti,9328,4,3,5,6,17,24,-7,14
Universitate,9328,5,3,5,6,14,22,-8,14
Concordia Ch,9328,6,3,2,9,20,22,-2,11
CFR Cluj,9329,1,7,6,1,15,7,8,27
FCSB,9329,2,7,5,2,23,13,10,26
FC Botosani,9329,3,5,4,5,10,14,-4,19
Universitate,9329,4,4,5,5,16,19,-3,17
D Bucuresti,9329,5,4,4,6,21,23,-2,16
Concordia Ch,9329,6,2,2,10,17,26,-9,8
FCSB,9330,1,7,6,1,27,15,12,27
CFR Cluj,9330,2,6,7,1,15,8,7,25
D Bucuresti,9330,3,4,5,5,18,19,-1,17
FC Botosani,9330,4,4,5,5,10,13,-3,17
Universitate,9330,5,4,5,5,18,22,-4,17
Concordia Ch,9330,6,2,2,10,15,26,-11,8
FCSB,9331,1,7,7,0,26,13,13,28
CFR Cluj,9331,2,6,7,1,16,9,7,25
D Bucuresti,9331,3,4,5,5,20,20,0,17
FC Botosani,9331,4,4,4,6,7,15,-8,16
Universitate,9331,5,3,6,5,17,22,-5,15
Concordia Ch,9331,6,2,3,9,16,23,-7,9
FCSB,9332,1,7,7,0,25,12,13,28
CFR Cluj,9332,2,6,7,1,16,9,7,25
FC Botosani,9332,3,5,4,5,9,12,-3,19
Universitate,9332,4,3,6,5,16,21,-5,15
D Bucuresti,9332,5,3,4,7,18,23,-5,13
Concordia Ch,9332,6,3,2,9,18,25,-7,11
FCSB,9333,1,9,5,0,26,11,15,32
CFR Cluj,9333,2,6,6,2,14,8,6,24
D Bucuresti,9333,3,5,4,5,22,19,3,19
FC Botosani,9333,4,4,4,6,7,16,-9,16
Universitate,9333,5,3,5,6,15,21,-6,14
Concordia Ch,9333,6,2,2,10,15,24,-9,8
FCSB,9334,1,9,5,0,28,11,17,32
CFR Cluj,9334,2,5,6,3,13,12,1,21
Universitate,9334,3,4,5,5,17,20,-3,17
D Bucuresti,9334,4,4,4,6,19,19,0,16
FC Botosani,9334,5,4,4,6,7,15,-8,16
Concordia Ch,9334,6,3,2,9,16,23,-7,11
FCSB,9335,1,8,5,1,27,12,15,29
CFR Cluj,9335,2,6,6,2,15,10,5,24
Universitate,9335,3,4,5,5,16,21,-5,17
D Bucuresti,9335,4,4,4,6,18,22,-4,16
FC Botosani,9335,5,4,4,6,8,15,-7,16
Concordia Ch,9335,6,3,2,9,19,23,-4,11
FCSB,9336,1,7,5,2,25,17,8,26
CFR Cluj,9336,2,6,7,1,19,9,10,25
D Bucuresti,9336,3,5,4,5,19,19,0,19
Universitate,9336,4,4,6,4,17,20,-3,18
FC Botosani,9336,5,3,5,6,6,14,-8,14
Concordia Ch,9336,6,2,3,9,15,22,-7,9
FCSB,9337,1,8,5,1,26,14,12,29
CFR Cluj,9337,2,6,6,2,14,10,4,24
D Bucuresti,9337,3,4,5,5,19,18,1,17
Universitate,9337,4,4,5,5,18,19,-1,17
FC Botosani,9337,5,3,6,5,5,12,-7,15
Concordia Ch,9337,6,2,3,9,15,24,-9,9
FCSB,9338,1,7,6,1,24,13,11,27
CFR Cluj,9338,2,6,6,2,15,8,7,24
D Bucuresti,9338,3,5,4,5,20,20,0,19
Universitate,9338,4,4,6,4,16,19,-3,18
FC Botosani,9338,5,4,4,6,9,15,-6,16
Concordia Ch,9338,6,2,2,10,15,24,-9,8
FCSB,9339,1,8,6,0,26,12,14,30
CFR Cluj,9339,2,6,6,2,15,8,7,24
Universitate,9339,3,3,6,5,16,22,-6,15
FC Botosani,9339,4,3,6,5,6,13,-7,15
D Bucuresti,9339,5,3,5,6,16,20,-4,14
Concordia Ch,9339,6,3,3,8,18,22,-4,12
FCSB,9340,1,8,6,0,26,11,15,30
CFR Cluj,9340,2,6,7,1,15,7,8,25
D Bucuresti,9340,3,3,6,5,17,19,-2,15
Universitate,9340,4,3,5,6,15,23,-8,14
FC Botosani,9340,5,3,5,6,7,16,-9,14
Concordia Ch,9340,6,3,3,8,18,22,-4,12
FCSB,9341,1,9,5,0,29,11,18,32
CFR Cluj,9341,2,6,6,2,15,10,5,24
D Bucuresti,9341,3,4,4,6,20,23,-3,16
FC Botosani,9341,4,4,4,6,8,14,-6,16
Universitate,9341,5,3,5,6,14,22,-8,14
Concordia Ch,9341,6,3,2,9,18,24,-6,11
FCSB,9342,1,8,6,0,26,12,14,30
CFR Cluj,9342,2,6,7,1,17,8,9,25
D Bucuresti,9342,3,4,4,6,19,21,-2,16
Concordia Ch,9342,4,4,2,8,18,22,-4,14
Universitate,9342,5,3,5,6,15,23,-8,14
FC Botosani,9342,6,3,4,7,6,15,-9,13
FCSB,9343,1,9,5,0,26,11,15,32
CFR Cluj,9343,2,5,6,3,13,10,3,21
Universitate,9343,3,4,5,5,17,20,-3,17
D Bucuresti,9343,4,4,4,6,20,23,-3,16
FC Botosani,9343,5,4,4,6,7,14,-7,16
Concordia Ch,9343,6,3,2,9,21,26,-5,11
FCSB,9344,1,8,6,0,27,10,17,30
CFR Cluj,9344,2,6,6,2,14,11,3,24
D Bucuresti,9344,3,4,5,5,21,21,0,17
Universitate,9344,4,3,6,5,14,19,-5,15
FC Botosani,9344,5,3,5,6,6,15,-9,14
Concordia Ch,9344,6,2,4,8,19,25,-6,10
CFR Cluj,9345,1,7,6,1,15,7,8,27
FCSB,9345,2,7,5,2,24,13,11,26
D Bucuresti,9345,3,4,5,5,18,19,-1,17
Universitate,9345,4,4,5,5,16,20,-4,17
FC Botosani,9345,5,3,5,6,6,14,-8,14
Concordia Ch,9345,6,2,4,8,17,23,-6,10
FCSB,9346,1,8,5,1,24,11,13,29
CFR Cluj,9346,2,5,6,3,13,10,3,21
Universitate,9346,3,5,5,4,17,18,-1,20
Concordia Ch,9346,4,4,2,8,19,21,-2,14
D Bucuresti,9346,5,3,5,6,17,21,-4,14
FC Botosani,9346,6,3,5,6,6,15,-9,14
FCSB,9347,1,8,5,1,28,13,15,29
CFR Cluj,9347,2,6,6,2,17,13,4,24
D Bucuresti,9347,3,4,5,5,20,19,1,17
Universitate,9347,4,4,5,5,16,20,-4,17
FC Botosani,9347,5,3,5,6,5,15,-10,14
Concordia Ch,9347,6,2,4,8,16,22,-6,10
FCSB,9348,1,7,6,1,23,11,12,27
CFR Cluj,9348,2,5,7,2,13,8,5,22
Universitate,9348,3,5,5,4,16,18,-2,20
FC Botosani,9348,4,4,5,5,11,14,-3,17
D Bucuresti,9348,5,3,4,7,16,23,-7,13
Concordia Ch,9348,6,3,3,8,18,23,-5,12
FCSB,9349,1,9,5,0,31,10,21,32
CFR Cluj,9349,2,6,6,2,16,13,3,24
D Bucuresti,9349,3,4,4,6,17,21,-4,16
FC Botosani,9349,4,3,5,6,6,14,-8,14
Universitate,9349,5,3,5,6,16,25,-9,14
Concordia Ch,9349,6,3,3,8,19,22,-3,12
FCSB,9350,1,9,5,0,31,11,20,32
CFR Cluj,9350,2,5,6,3,14,13,1,21
FC Botosani,9350,3,5,4,5,9,13,-4,19
Universitate,9350,4,4,5,5,15,21,-6,17
D Bucuresti,9350,5,3,4,7,17,22,-5,13
Concordia Ch,9350,6,3,2,9,19,25,-6,11
FCSB,9351,1,8,5,1,24,11,13,29
CFR Cluj,9351,2,6,6,2,14,9,5,24
Universitate,9351,3,4,5,5,16,19,-3,17
FC Botosani,9351,4,4,5,5,8,14,-6,17
D Bucuresti,9351,5,3,5,6,17,20,-3,14
Concordia Ch,9351,6,3,2,9,17,23,-6,11
FCSB,9352,1,8,5,1,28,13,15,29
CFR Cluj,9352,2,6,6,2,14,10,4,24
D Bucuresti,9352,3,4,5,5,20,19,1,17
Universitate,9352,4,4,5,5,17,21,-4,17
FC Botosani,9352,5,3,6,5,7,14,-7,15
Concordia Ch,9352,6,2,3,9,16,25,-9,9
CFR Cluj,9353,1,7,6,1,16,8,8,27
FCSB,9353,2,7,5,2,24,13,11,26
Universitate,9353,3,4,5,5,17,21,-4,17
D Bucuresti,9353,4,4,4,6,20,22,-2,16
FC Botosani,9353,5,4,4,6,6,14,-8,16
Concordia Ch,9353,6,3,2,9,19,24,-5,11
FCSB,9354,1,9,5,0,28,11,17,32
CFR Cluj,9354,2,6,6,2,15,10,5,24
FC Botosani,9354,3,5,4,5,9,13,-4,19
D Bucuresti,9354,4,3,5,6,19,22,-3,14
Universitate,9354,5,3,5,6,14,21,-7,14
Concordia Ch,9354,6,2,3,9,19,27,-8,9
FCSB,9355,1,7,6,1,23,11,12,27
CFR Cluj,9355,2,5,7,2,13,8,5,22
Universitate,9355,3,5,5,4,16,18,-2,20
D Bucuresti,9355,4,5,4,5,20,19,1,19
FC Botosani,9355,5,3,4,7,5,16,-11,13
Concordia Ch,9355,6,3,2,9,19,24,-5,11
FCSB,9356,1,8,6,0,25,10,15,30
CFR Cluj,9356,2,6,7,1,16,7,9,25
FC Botosani,9356,3,3,6,5,7,14,-7,15
D Bucuresti,9356,4,3,5,6,20,23,-3,14
Universitate,9356,5,3,5,6,14,23,-9,14
Concordia Ch,9356,6,3,3,8,18,23,-5,12
FCSB,9357,1,9,5,0,26,10,16,32
CFR Cluj,9357,2,6,6,2,15,9,6,24
D Bucuresti,9357,3,5,4,5,20,20,0,19
Universitate,9357,4,3,5,6,15,22,-7,14
FC Botosani,9357,5,3,4,7,6,16,-10,13
Concordia Ch,9357,6,3,2,9,18,23,-5,11
FCSB,9358,1,8,5,1,25,11,14,29
CFR Cluj,9358,2,5,6,3,13,11,2,21
Universitate,9358,3,5,5,4,17,18,-1,20
FC Botosani,9358,4,4,5,5,7,13,-6,17
D Bucuresti,9358,5,3,5,6,16,20,-4,14
Concordia Ch,9358,6,3,2,9,18,23,-5,11
FCSB,9359,1,9,5,0,26,10,16,32
CFR Cluj,9359,2,6,6,2,15,8,7,24
FC Botosani,9359,3,4,5,5,7,13,-6,17
Universitate,9359,4,3,5,6,14,22,-8,14
D Bucuresti,9359,5,3,4,7,18,22,-4,13
Concordia Ch,9359,6,3,3,8,19,24,-5,12
FCSB,9360,1,7,7,0,26,13,13,28
CFR Cluj,9360,2,5,7,2,16,11,5,22
D Bucuresti,9360,3,5,4,5,21,19,2,19
Universitate,9360,4,4,6,4,17,20,-3,18
FC Botosani,9360,5,3,5,6,6,16,-10,14
Concordia Ch,9360,6,2,3,9,17,24,-7,9
FCSB,9361,1,8,6,0,27,12,15,30
CFR Cluj,9361,2,5,7,2,16,11,5,22
Universitate,9361,3,4,5,5,16,21,-5,17
D Bucuresti,9361,4,4,4,6,18,21,-3,16
Concordia Ch,9361,5,4,2,8,19,22,-3,14
FC Botosani,9361,6,3,4,7,5,14,-9,13
FCSB,9362,1,8,5,1,25,12,13,29
CFR Cluj,9362,2,5,7,2,15,10,5,22
Universitate,9362,3,4,6,4,16,19,-3,18
D Bucuresti,9362,4,4,5,5,18,19,-1,17
FC Botosani,9362,5,4,4,6,10,14,-4,16
Concordia Ch,9362,6,2,3,9,15,25,-10,9
FCSB,9363,1,8,6,0,26,12,14,30
CFR Cluj,9363,2,6,6,2,16,9,7,24
Universitate,9363,3,3,6,5,15,21,-6,15
D Bucuresti,9363,4,3,5,6,19,22,-3,14
Concordia Ch,9363,5,4,2,8,19,23,-4,14
FC Botosani,9363,6,3,5,6,6,14,-8,14
FCSB,9364,1,8,5,1,27,13,14,29
CFR Cluj,9364,2,5,7,2,14,10,4,22
Universitate,9364,3,4,6,4,18,21,-3,18
FC Botosani,9364,4,4,4,6,7,14,-7,16
Concordia Ch,9364,5,4,2,8,18,21,-3,14
D Bucuresti,9364,6,3,4,7,17,22,-5,13
FCSB,9365,1,8,5,1,25,11,14,29
CFR Cluj,9365,2,6,6,2,17,9,8,24
D Bucuresti,9365,3,4,5,5,19,20,-1,17
Universitate,9365,4,4,5,5,15,22,-7,17
FC Botosani,9365,5,3,5,6,8,16,-8,14
Concordia Ch,9365,6,2,4,8,20,26,-6,10
FCSB,9366,1,8,6,0,27,13,14,30
CFR Cluj,9366,2,5,8,1,15,9,6,23
D Bucuresti,9366,3,4,4,6,21,25,-4,16
FC Botosani,9366,4,4,4,6,7,15,-8,16
Universitate,9366,5,3,6,5,15,20,-5,15
Concordia Ch,9366,6,3,2,9,21,24,-3,11
FCSB,9367,1,7,5,2,23,13,10,26
CFR Cluj,9367,2,6,7,1,15,7,8,25
Universitate,9367,3,4,6,4,15,18,-3,18
D Bucuresti,9367,4,3,6,5,17,19,-2,15
FC Botosani,9367,5,3,6,5,7,14,-7,15
Concordia Ch,9367,6,2,4,8,16,22,-6,10
FCSB,9368,1,9,5,0,26,10,16,32
CFR Cluj,9368,2,5,7,2,14,9,5,22
D Bucuresti,9368,3,5,4,5,19,18,1,19
Universitate,9368,4,3,6,5,15,21,-6,15
FC Botosani,9368,5,3,5,6,7,16,-9,14
Concordia Ch,9368,6,2,3,9,17,24,-7,9
FCSB,9369,1,9,5,0,27,10,17,32
CFR Cluj,9369,2,5,7,2,14,10,4,22
FC Botosani,9369,3,4,4,6,7,13,-6,16
Universitate,9369,4,3,6,5,15,21,-6,15
Concordia Ch,9369,5,4,2,8,19,22,-3,14
D Bucuresti,9369,6,3,4,7,17,23,-6,13
FCSB,9370,1,8,5,1,25,12,13,29
CFR Cluj,9370,2,7,6,1,17,8,9,27
D Bucuresti,9370,3,5,4,5,21,19,2,19
Universitate,9370,4,3,5,6,14,21,-7,14
FC Botosani,9370,5,3,5,6,6,15,-9,14
Concordia Ch,9370,6,2,3,9,17,25,-8,9
FCSB,9371,1,8,5,1,25,11,14,29
CFR Cluj,9371,2,6,6,2,14,9,5,24
Universitate,9371,3,4,5,5,16,20,-4,17
D Bucuresti,9371,4,4,4,6,19,21,-2,16
Concordia Ch,9371,5,4,2,8,18,22,-4,14
FC Botosani,9371,6,3,4,7,6,15,-9,13
FCSB,9372,1,8,5,1,25,12,13,29
CFR Cluj,9372,2,5,7,2,13,9,4,22
Universitate,9372,3,4,6,4,16,18,-2,18
Concordia Ch,9372,4,4,2,8,19,21,-2,14
D Bucuresti,9372,5,3,5,6,16,21,-5,14
FC Botosani,9372,6,3,5,6,5,13,-8,14
FCSB,9373,1,8,6,0,27,11,16,30
CFR Cluj,9373,2,5,7,2,15,10,5,22
Universitate,9373,3,4,5,5,16,22,-6,17
D Bucuresti,9373,4,4,4,6,20,21,-1,16
FC Botosani,9373,5,4,4,6,6,15,-9,16
Concordia Ch,9373,6,3,2,9,18,23,-5,11
FCSB,9374,1,8,6,0,25,11,14,30
CFR Cluj,9374,2,5,8,1,15,9,6,23
FC Botosani,9374,3,5,4,5,8,13,-5,19
Universitate,9374,4,3,6,5,15,20,-5,15
D Bucuresti,9374,5,3,5,6,18,21,-3,14
Concordia Ch,9374,6,2,3,9,16,23,-7,9
FCSB,9375,1,8,5,1,25,12,13,29
CFR Cluj,9375,2,6,6,2,16,10,6,24
Universitate,9375,3,4,5,5,16,20,-4,17
Concordia Ch,9375,4,4,2,8,19,22,-3,14
D Bucuresti,9375,5,3,5,6,17,21,-4,14
FC Botosani,9375,6,3,5,6,7,15,-8,14
FCSB,9376,1,8,6,0,29,13,16,30
CFR Cluj,9376,2,6,6,2,17,11,6,24
Universitate,9376,3,3,6,5,16,23,-7,15
FC Botosani,9376,4,3,6,5,8,15,-7,15
D Bucuresti,9376,5,3,5,6,18,21,-3,14
Concordia Ch,9376,6,3,3,8,17,22,-5,12
FCSB,9377,1,9,5,0,28,11,17,32
CFR Cluj,9377,2,6,6,2,15,10,5,24
D Bucuresti,9377,3,4,4,6,18,20,-2,16
Concordia Ch,9377,4,4,2,8,20,22,-2,14
Universitate,9377,5,3,5,6,14,21,-7,14
FC Botosani,9377,6,3,4,7,6,17,-11,13
FCSB,9378,1,8,5,1,26,13,13,29
CFR Cluj,9378,2,6,6,2,16,9,7,24
D Bucuresti,9378,3,5,4,5,19,18,1,19
Universitate,9378,4,4,5,5,17,22,-5,17
FC Botosani,9378,5,4,4,6,7,13,-6,16
Concordia Ch,9378,6,2,2,10,15,25,-10,8
FCSB,9379,1,9,5,0,29,11,18,32
CFR Cluj,9379,2,6,6,2,17,11,6,24
D Bucuresti,9379,3,5,4,5,21,20,1,19
FC Botosani,9379,4,4,4,6,8,16,-8,16
Universitate,9379,5,3,5,6,15,24,-9,14
Concordia Ch,9379,6,2,2,10,15,23,-8,8
FCSB,9380,1,8,5,1,25,11,14,29
CFR Cluj,9380,2,6,7,1,14,7,7,25
D Bucuresti,9380,3,5,4,5,22,21,1,19
Universitate,9380,4,3,6,5,14,20,-6,15
FC Botosani,9380,5,3,4,7,6,17,-11,13
Concordia Ch,9380,6,3,2,9,20,25,-5,11
FCSB,9381,1,8,5,1,26,13,13,29
CFR Cluj,9381,2,5,6,3,13,11,2,21
Universitate,9381,3,5,5,4,20,20,0,20
FC Botosani,9381,4,4,5,5,9,14,-5,17
D Bucuresti,9381,5,3,5,6,17,21,-4,14
Concordia Ch,9381,6,2,4,8,16,22,-6,10
FCSB,9382,1,9,5,0,27,11,16,32
CFR Cluj,9382,2,5,6,3,13,9,4,21
FC Botosani,9382,3,5,4,5,10,14,-4,19
Universitate,9382,4,4,5,5,16,21,-5,17
D Bucuresti,9382,5,3,4,7,18,22,-4,13
Concordia Ch,9382,6,3,2,9,16,23,-7,11
FCSB,9383,1,8,6,0,26,12,14,30
CFR Cluj,9383,2,5,7,2,15,10,5,22
D Bucuresti,9383,3,4,4,6,17,19,-2,16
Universitate,9383,4,3,7,4,16,20,-4,16
Concordia Ch,9383,5,4,2,8,18,22,-4,14
FC Botosani,9383,6,3,4,7,6,15,-9,13
FCSB,9384,1,9,5,0,28,12,16,32
CFR Cluj,9384,2,5,6,3,14,10,4,21
Universitate,9384,3,4,5,5,16,21,-5,17
D Bucuresti,9384,4,3,6,5,20,22,-2,15
FC Botosani,9384,5,3,5,6,5,13,-8,14
Concordia Ch,9384,6,3,3,8,20,25,-5,12
FCSB,9385,1,7,6,1,24,12,12,27
CFR Cluj,9385,2,7,6,1,17,8,9,27
FC Botosani,9385,3,4,5,5,6,12,-6,17
Universitate,9385,4,3,6,5,16,22,-6,15
D Bucuresti,9385,5,3,4,7,16,21,-5,13
Concordia Ch,9385,6,3,3,8,17,21,-4,12
FCSB,9386,1,8,6,0,25,11,14,30
CFR Cluj,9386,2,5,7,2,14,9,5,22
Universitate,9386,3,4,5,5,17,21,-4,17
FC Botosani,9386,4,4,5,5,9,13,-4,17
D Bucuresti,9386,5,3,6,5,18,20,-2,15
Concordia Ch,9386,6,2,3,9,16,25,-9,9
FCSB,9387,1,8,6,0,26,12,14,30
CFR Cluj,9387,2,5,8,1,15,9,6,23
D Bucuresti,9387,3,4,4,6,17,19,-2,16
Universitate,9387,4,3,6,5,14,19,-5,15
FC Botosani,9387,5,3,5,6,5,13,-8,14
Concordia Ch,9387,6,3,3,8,16,21,-5,12
FCSB,9388,1,8,6,0,26,12,14,30
CFR Cluj,9388,2,5,8,1,14,8,6,23
D Bucuresti,9388,3,4,5,5,20,21,-1,17
Universitate,9388,4,3,6,5,15,20,-5,15
FC Botosani,9388,5,3,5,6,8,16,-8,14
Concordia Ch,9388,6,3,2,9,18,24,-6,11
FCSB,9389,1,8,5,1,25,14,11,29
CFR Cluj,9389,2,6,6,2,18,9,9,24
Universitate,9389,3,4,5,5,17,22,-5,17
FC Botosani,9389,4,4,5,5,8,14,-6,17
D Bucuresti,9389,5,4,4,6,17,19,-2,16
Concordia Ch,9389,6,2,3,9,17,24,-7,9
FCSB,9390,1,8,6,0,28,12,16,30
CFR Cluj,9390,2,6,6,2,15,10,5,24
D Bucuresti,9390,3,5,4,5,19,19,0,19
FC Botosani,9390,4,4,4,6,8,15,-7,16
Universitate,9390,5,3,6,5,16,22,-6,15
Concordia Ch,9390,6,2,2,10,16,24,-8,8
FCSB,9391,1,8,5,1,27,11,16,29
CFR Cluj,9391,2,6,6,2,14,9,5,24
D Bucuresti,9391,3,5,4,5,19,19,0,19
Universitate,9391,4,4,5,5,16,22,-6,17
FC Botosani,9391,5,4,4,6,7,14,-7,16
Concordia Ch,9391,6,2,2,10,15,23,-8,8
FCSB,9392,1,8,5,1,24,11,13,29
CFR Cluj,9392,2,5,7,2,14,9,5,22
Universitate,9392,3,4,6,4,16,19,-3,18
D Bucuresti,9392,4,4,4,6,19,21,-2,16
FC Botosani,9392,5,3,5,6,6,14,-8,14
Concordia Ch,9392,6,3,3,8,17,22,-5,12
FCSB,9393,1,8,5,1,27,14,13,29
CFR Cluj,9393,2,6,6,2,16,9,7,24
D Bucuresti,9393,3,4,5,5,18,19,-1,17
Universitate,9393,4,4,5,5,17,22,-5,17
FC Botosani,9393,5,3,5,6,6,14,-8,14
Concordia Ch,9393,6,2,4,8,17,23,-6,10
FCSB,9394,1,7,7,0,24,11,13,28
CFR Cluj,9394,2,5,8,1,14,8,6,23
FC Botosani,9394,3,4,5,5,11,15,-4,17
Universitate,9394,4,3,7,4,14,18,-4,16
D Bucuresti,9394,5,3,6,5,19,21,-2,15
Concordia Ch,9394,6,2,3,9,17,26,-9,9
FCSB,9395,1,8,6,0,25,10,15,30
CFR Cluj,9395,2,5,7,2,14,9,5,22
D Bucuresti,9395,3,4,5,5,19,20,-1,17
Universitate,9395,4,4,5,5,16,21,-5,17
FC Botosani,9395,5,3,5,6,6,14,-8,14
Concordia Ch,9395,6,2,4,8,18,24,-6,10
FCSB,9396,1,7,6,1,26,14,12,27
CFR Cluj,9396,2,6,7,1,17,10,7,25
D Bucuresti,9396,3,5,4,5,22,20,2,19
Universitate,9396,4,4,5,5,17,21,-4,17
FC Botosani,9396,5,3,4,7,5,15,-10,13
Concordia Ch,9396,6,3,2,9,18,25,-7,11
FCSB,9397,1,8,6,0,24,10,14,30
CFR Cluj,9397,2,6,6,2,15,8,7,24
FC Botosani,9397,3,5,4,5,9,13,-4,19
D Bucuresti,9397,4,4,4,6,21,21,0,16
Universitate,9397,5,3,6,5,14,20,-6,15
Concordia Ch,9397,6,2,2,10,16,27,-11,8
FCSB,9398,1,8,6,0,27,12,15,30
CFR Cluj,9398,2,6,7,1,16,9,7,25
D Bucuresti,9398,3,5,4,5,20,18,2,19
Universitate,9398,4,3,5,6,16,23,-7,14
FC Botosani,9398,5,3,4,7,5,16,-11,13
Concordia Ch,9398,6,3,2,9,17,23,-6,11
FCSB,9399,1,8,5,1,27,12,15,29
CFR Cluj,9399,2,7,6,1,17,8,9,27
D Bucuresti,9399,3,4,4,6,17,19,-2,16
Concordia Ch,9399,4,4,2,8,18,22,-4,14
Universitate,9399,5,3,5,6,14,23,-9,14
FC Botosani,9399,6,3,4,7,6,15,-9,13
FCSB,9400,1,8,5,1,25,11,14,29
CFR Cluj,9400,2,5,6,3,14,11,3,21
Universitate,9400,3,5,5,4,17,19,-2,20
D Bucuresti,9400,4,4,4,6,19,21,-2,16
FC Botosani,9400,5,3,5,6,7,16,-9,14
Concordia Ch,9400,6,3,3,8,20,24,-4,12
FCSB,9401,1,8,6,0,25,10,15,30
CFR Cluj,9401,2,5,7,2,14,10,4,22
D Bucuresti,9401,3,4,5,5,18,19,-1,17
Universitate,9401,4,3,7,4,15,19,-4,16
FC Botosani,9401,5,4,4,6,6,13,-7,16
Concordia Ch,9401,6,2,3,9,16,23,-7,9
FCSB,9402,1,9,5,0,29,12,17,32
CFR Cluj,9402,2,5,7,2,16,12,4,22
D Bucuresti,9402,3,4,4,6,18,19,-1,16
FC Botosani,9402,4,4,4,6,8,15,-7,16
Universitate,9402,5,3,6,5,17,23,-6,15
Concordia Ch,9402,6,3,2,9,17,24,-7,11
CFR Cluj,9403,1,7,6,1,19,7,12,27
FCSB,9403,2,7,5,2,24,15,9,26
D Bucuresti,9403,3,5,4,5,20,20,0,19
Universitate,9403,4,4,5,5,18,24,-6,17
FC Botosani,9403,5,4,4,6,7,13,-6,16
Concordia Ch,9403,6,2,2,10,17,26,-9,8
FCSB,9404,1,9,5,0,28,13,15,32
CFR Cluj,9404,2,6,6,2,17,11,6,24
D Bucuresti,9404,3,4,4,6,17,19,-2,16
FC Botosani,9404,4,4,4,6,7,14,-7,16
Universitate,9404,5,3,5,6,14,20,-6,14
Concordia Ch,9404,6,3,2,9,17,23,-6,11
FCSB,9405,1,7,6,1,24,12,12,27
CFR Cluj,9405,2,6,6,2,14,8,6,24
Universitate,9405,3,4,6,4,16,19,-3,18
FC Botosani,9405,4,4,5,5,7,12,-5,17
D Bucuresti,9405,5,3,5,6,17,21,-4,14
Concordia Ch,9405,6,2,4,8,16,22,-6,10
FCSB,9406,1,7,5,2,26,15,11,26
CFR Cluj,9406,2,6,7,1,15,8,7,25
D Bucuresti,9406,3,5,4,5,21,20,1,19
Universitate,9406,4,4,6,4,19,22,-3,18
FC Botosani,9406,5,3,4,7,7,17,-10,13
Concordia Ch,9406,6,3,2,9,18,24,-6,11
FCSB,9407,1,8,5,1,24,11,13,29
CFR Cluj,9407,2,6,6,2,15,9,6,24
Universitate,9407,3,4,5,5,16,20,-4,17
D Bucuresti,9407,4,3,6,5,17,19,-2,15
FC Botosani,9407,5,3,6,5,6,13,-7,15
Concordia Ch,9407,6,2,4,8,15,21,-6,10
FCSB,9408,1,8,6,0,26,12,14,30
CFR Cluj,9408,2,5,7,2,15,11,4,22
Universitate,9408,3,4,5,5,16,19,-3,17
D Bucuresti,9408,4,4,4,6,19,20,-1,16
FC Botosani,9408,5,4,4,6,8,15,-7,16
Concordia Ch,9408,6,3,2,9,17,24,-7,11
FCSB,9409,1,7,7,0,24,11,13,28
CFR Cluj,9409,2,6,7,1,16,8,8,25
FC Botosani,9409,3,4,5,5,6,12,-6,17
D Bucuresti,9409,4,3,6,5,16,18,-2,15
Universitate,9409,5,3,6,5,16,22,-6,15
Concordia Ch,9409,6,2,3,9,15,22,-7,9
FCSB,9410,1,7,7,0,25,12,13,28
CFR Cluj,9410,2,5,7,2,14,9,5,22
Universitate,9410,3,4,6,4,16,19,-3,18
D Bucuresti,9410,4,4,5,5,19,19,0,17
FC Botosani,9410,5,4,4,6,6,14,-8,16
Concordia Ch,9410,6,2,3,9,16,23,-7,9
FCSB,9411,1,8,6,0,25,11,14,30
CFR Cluj,9411,2,5,6,3,13,9,4,21
Universitate,9411,3,4,6,4,16,19,-3,18
FC Botosani,9411,4,4,5,5,9,15,-6,17
D Bucuresti,9411,5,3,4,7,17,21,-4,13
Concordia Ch,9411,6,3,3,8,18,23,-5,12
FCSB,9412,1,8,6,0,28,12,16,30
CFR Cluj,9412,2,6,6,2,15,10,5,24
D Bucuresti,9412,3,4,5,5,18,19,-1,17
Universitate,9412,4,3,6,5,16,22,-6,15
FC Botosani,9412,5,3,5,6,6,15,-9,14
Concordia Ch,9412,6,3,2,9,17,22,-5,11
FCSB,9413,1,8,6,0,27,12,15,30
CFR Cluj,9413,2,5,6,3,14,11,3,21
Universitate,9413,3,4,6,4,16,19,-3,18
D Bucuresti,9413,4,4,5,5,20,21,-1,17
FC Botosani,9413,5,4,4,6,7,14,-7,16
Concordia Ch,9413,6,2,3,9,17,24,-7,9
FCSB,9414,1,8,6,0,24,10,14,30
CFR Cluj,9414,2,5,6,3,13,9,4,21
Universitate,9414,3,4,6,4,15,18,-3,18
D Bucuresti,9414,4,4,4,6,17,19,-2,16
FC Botosani,9414,5,4,4,6,7,13,-6,16
Concordia Ch,9414,6,3,2,9,16,23,-7,11
FCSB,9415,1,7,6,1,23,11,12,27
CFR Cluj,9415,2,6,6,2,14,8,6,24
Universitate,9415,3,4,6,4,15,18,-3,18
D Bucuresti,9415,4,4,5,5,21,19,2,17
FC Botosani,9415,5,3,5,6,6,17,-11,14
Concordia Ch,9415,6,2,4,8,17,23,-6,10
FCSB,9416,1,7,6,1,24,12,12,27
CFR Cluj,9416,2,6,7,1,17,10,7,25
FC Botosani,9416,3,5,4,5,9,13,-4,19
Universitate,9416,4,4,5,5,17,21,-4,17
D Bucuresti,9416,5,4,4,6,19,21,-2,16
Concordia Ch,9416,6,2,2,10,16,25,-9,8
FCSB,9417,1,7,7,0,26,13,13,28
CFR Cluj,9417,2,5,8,1,14,8,6,23
D Bucuresti,9417,3,4,5,5,19,20,-1,17
Universitate,9417,4,3,7,4,16,20,-4,16
FC Botosani,9417,5,3,4,7,7,17,-10,13
Concordia Ch,9417,6,3,3,8,19,23,-4,12
FCSB,9418,1,8,5,1,27,12,15,29
CFR Cluj,9418,2,5,7,2,13,10,3,22
Universitate,9418,3,4,6,4,16,19,-3,18
D Bucuresti,9418,4,4,4,6,18,20,-2,16
FC Botosani,9418,5,4,4,6,6,14,-8,16
Concordia Ch,9418,6,3,2,9,18,23,-5,11
FCSB,9419,1,8,6,0,27,13,14,30
CFR Cluj,9419,2,5,8,1,16,10,6,23
FC Botosani,9419,3,4,5,5,8,14,-6,17
Universitate,9419,4,3,6,5,18,23,-5,15
D Bucuresti,9419,5,3,4,7,18,22,-4,13
Concordia Ch,9419,6,3,3,8,18,23,-5,12
FCSB,9420,1,8,6,0,25,11,14,30
CFR Cluj,9420,2,6,6,2,18,9,9,24
FC Botosani,9420,3,5,4,5,8,13,-5,19
D Bucuresti,9420,4,4,4,6,18,20,-2,16
Universitate,9420,5,3,6,5,14,22,-8,15
Concordia Ch,9420,6,2,2,10,17,25,-8,8
FCSB,9421,1,8,6,0,25,11,14,30
CFR Cluj,9421,2,5,8,1,13,7,6,23
Universitate,9421,3,3,6,5,15,20,-5,15
D Bucuresti,9421,4,3,5,6,18,21,-3,14
Concordia Ch,9421,5,4,2,8,18,22,-4,14
FC Botosani,9421,6,3,5,6,6,14,-8,14
FCSB,9422,1,8,6,0,30,16,14,30
CFR Cluj,9422,2,6,7,1,20,11,9,25
D Bucuresti,9422,3,4,5,5,19,19,0,17
FC Botosani,9422,4,4,5,5,7,13,-6,17
Universitate,9422,5,3,5,6,16,24,-8,14
Concordia Ch,9422,6,2,2,10,15,24,-9,8
FCSB,9423,1,7,5,2,23,13,10,26
CFR Cluj,9423,2,6,6,2,16,11,5,24
Universitate,9423,3,5,5,4,19,19,0,20
FC Botosani,9423,4,4,5,5,8,14,-6,17
D Bucuresti,9423,5,3,4,7,16,20,-4,13
Concordia Ch,9423,6,3,3,8,18,23,-5,12
FCSB,9424,1,8,6,0,25,11,14,30
CFR Cluj,9424,2,6,6,2,14,8,6,24
D Bucuresti,9424,3,5,4,5,20,19,1,19
FC Botosani,9424,4,4,4,6,7,15,-8,16
Universitate,9424,5,3,6,5,15,20,-5,15
Concordia Ch,9424,6,2,2,10,17,25,-8,8
FCSB,9425,1,9,5,0,26,10,16,32
CFR Cluj,9425,2,6,6,2,15,8,7,24
Concordia Ch,9425,3,4,2,8,19,22,-3,14
D Bucuresti,9425,4,3,5,6,18,22,-4,14
Universitate,9425,5,3,5,6,14,22,-8,14
FC Botosani,9425,6,3,5,6,8,16,-8,14
FCSB,9426,1,7,5,2,24,15,9,26
CFR Cluj,9426,2,6,6,2,14,10,4,24
Universitate,9426,3,5,5,4,21,19,2,20
D Bucuresti,9426,4,4,4,6,19,21,-2,16
FC Botosani,9426,5,3,5,6,5,13,-8,14
Concordia Ch,9426,6,3,3,8,18,23,-5,12
FCSB,9427,1,8,5,1,25,13,12,29
CFR Cluj,9427,2,7,6,1,17,8,9,27
D Bucuresti,9427,3,4,4,6,21,21,0,16
Universitate,9427,4,3,5,6,14,20,-6,14
FC Botosani,9427,5,3,5,6,6,17,-11,14
Concordia Ch,9427,6,3,3,8,17,21,-4,12
FCSB,9428,1,8,6,0,27,11,16,30
CFR Cluj,9428,2,5,7,2,14,10,4,22
D Bucuresti,9428,3,4,5,5,18,19,-1,17
Universitate,9428,4,4,5,5,18,23,-5,17
FC Botosani,9428,5,3,5,6,6,14,-8,14
Concordia Ch,9428,6,2,4,8,17,23,-6,10
FCSB,9429,1,7,6,1,26,15,11,27
CFR Cluj,9429,2,6,6,2,16,10,6,24
FC Botosani,9429,3,5,4,5,9,12,-3,19
Universitate,9429,4,4,6,4,18,20,-2,18
D Bucuresti,9429,5,3,5,6,18,22,-4,14
Concordia Ch,9429,6,2,3,9,17,25,-8,9
FCSB,9430,1,9,5,0,25,10,15,32
CFR Cluj,9430,2,6,6,2,16,9,7,24
D Bucuresti,9430,3,4,5,5,18,19,-1,17
Universitate,9430,4,3,5,6,15,22,-7,14
FC Botosani,9430,5,3,5,6,6,14,-8,14
Concordia Ch,9430,6,2,4,8,17,23,-6,10
FCSB,9431,1,8,5,1,25,13,12,29
CFR Cluj,9431,2,6,6,2,15,9,6,24
Universitate,9431,3,4,5,5,16,19,-3,17
FC Botosani,9431,4,3,6,5,5,12,-7,15
D Bucuresti,9431,5,3,5,6,17,23,-6,14
Concordia Ch,9431,6,3,3,8,20,22,-2,12
CFR Cluj,9432,1,7,6,1,19,7,12,27
FCSB,9432,2,7,5,2,23,12,11,26
D Bucuresti,9432,3,5,4,5,20,20,0,19
Universitate,9432,4,4,5,5,15,23,-8,17
FC Botosani,9432,5,3,5,6,6,14,-8,14
Concordia Ch,9432,6,2,3,9,16,23,-7,9
FCSB,9433,1,9,5,0,28,12,16,32
CFR Cluj,9433,2,5,6,3,14,10,4,21
FC Botosani,9433,3,5,4,5,8,13,-5,19
Universitate,9433,4,4,5,5,16,21,-5,17
D Bucuresti,9433,5,4,4,6,18,20,-2,16
Concordia Ch,9433,6,2,2,10,15,23,-8,8
CFR Cluj,9434,1,7,6,1,18,10,8,27
FCSB,9434,2,7,5,2,25,15,10,26
Universitate,9434,3,4,5,5,17,20,-3,17
FC Botosani,9434,4,4,5,5,6,12,-6,17
D Bucuresti,9434,5,3,6,5,19,21,-2,15
Concordia Ch,9434,6,2,3,9,18,25,-7,9
FCSB,9435,1,7,7,0,25,12,13,28
CFR Cluj,9435,2,5,8,1,16,10,6,23
D Bucuresti,9435,3,4,4,6,18,19,-1,16
Universitate,9435,4,3,7,4,15,19,-4,16
Concordia Ch,9435,5,4,2,8,19,23,-4,14
FC Botosani,9435,6,3,4,7,7,17,-10,13
FCSB,9436,1,8,6,0,26,12,14,30
CFR Cluj,9436,2,5,6,3,14,10,4,21
Universitate,9436,3,4,6,4,16,19,-3,18
FC Botosani,9436,4,4,5,5,7,13,-6,17
D Bucuresti,9436,5,4,4,6,20,20,0,16
Concordia Ch,9436,6,2,3,9,15,24,-9,9
FCSB,9437,1,8,5,1,24,12,12,29
CFR Cluj,9437,2,5,7,2,14,9,5,22
Universitate,9437,3,4,6,4,17,19,-2,18
D Bucuresti,9437,4,4,5,5,20,21,-1,17
FC Botosani,9437,5,4,4,6,9,15,-6,16
Concordia Ch,9437,6,2,3,9,16,24,-8,9
FCSB,9438,1,9,5,0,28,12,16,32
CFR Cluj,9438,2,5,7,2,14,10,4,22
FC Botosani,9438,3,5,4,5,7,12,-5,19
Universitate,9438,4,3,6,5,17,22,-5,15
D Bucuresti,9438,5,3,4,7,17,21,-4,13
Concordia Ch,9438,6,3,2,9,17,23,-6,11
FCSB,9439,1,8,6,0,25,11,14,30
CFR Cluj,9439,2,5,7,2,14,9,5,22
D Bucuresti,9439,3,5,4,5,21,21,0,19
Universitate,9439,4,3,7,4,16,20,-4,16
FC Botosani,9439,5,3,5,6,7,15,-8,14
Concordia Ch,9439,6,2,3,9,16,23,-7,9
FCSB,9440,1,8,6,0,28,14,14,30
CFR Cluj,9440,2,6,6,2,18,12,6,24
D Bucuresti,9440,3,5,4,5,19,18,1,19
Universitate,9440,4,3,6,5,16,21,-5,15
FC Botosani,9440,5,3,5,6,5,14,-9,14
Concordia Ch,9440,6,2,3,9,15,22,-7,9
FCSB,9441,1,8,5,1,24,11,13,29
CFR Cluj,9441,2,5,7,2,15,10,5,22
Universitate,9441,3,4,6,4,17,20,-3,18
FC Botosani,9441,4,4,5,5,7,13,-6,17
D Bucuresti,9441,5,4,4,6,17,19,-2,16
Concordia Ch,9441,6,2,3,9,16,23,-7,9
FCSB,9442,1,7,6,1,24,12,12,27
CFR Cluj,9442,2,7,6,1,16,8,8,27
D Bucuresti,9442,3,5,4,5,20,19,1,19
Universitate,9442,4,3,6,5,16,21,-5,15
FC Botosani,9442,5,3,4,7,7,17,-10,13
Concordia Ch,9442,6,3,2,9,18,24,-6,11
FCSB,9443,1,8,6,0,25,11,14,30
CFR Cluj,9443,2,5,7,2,14,9,5,22
D Bucuresti,9443,3,4,4,6,21,21,0,16
Universitate,9443,4,3,7,4,14,18,-4,16
FC Botosani,9443,5,3,5,6,6,17,-11,14
Concordia Ch,9443,6,3,3,8,19,23,-4,12
FCSB,9444,1,8,6,0,26,10,16,30
CFR Cluj,9444,2,5,8,1,13,7,6,23
FC Botosani,9444,3,5,4,5,11,12,-1,19
Universitate,9444,4,3,6,5,14,21,-7,15
D Bucuresti,9444,5,3,5,6,17,21,-4,14
Concordia Ch,9444,6,2,3,9,16,26,-10,9
FCSB,9445,1,7,6,1,27,15,12,27
CFR Cluj,9445,2,6,7,1,17,9,8,25
Universitate,9445,3,4,5,5,17,22,-5,17
FC Botosani,9445,4,4,4,6,8,15,-7,16
Concordia Ch,9445,5,4,2,8,19,23,-4,14
D Bucuresti,9445,6,3,4,7,18,22,-4,13
FCSB,9446,1,9,5,0,28,10,18,32
CFR Cluj,9446,2,5,7,2,14,11,3,22
D Bucuresti,9446,3,4,4,6,18,21,-3,16
FC Botosani,9446,4,4,4,6,7,14,-7,16
Universitate,9446,5,3,6,5,15,21,-6,15
Concordia Ch,9446,6,3,2,9,19,24,-5,11
FCSB,9447,1,8,5,1,26,12,14,29
CFR Cluj,9447,2,5,6,3,14,11,3,21
Universitate,9447,3,5,5,4,18,20,-2,20
D Bucuresti,9447,4,5,4,5,19,19,0,19
FC Botosani,9447,5,3,5,6,7,15,-8,14
Concordia Ch,9447,6,2,3,9,18,25,-7,9
FCSB,9448,1,8,6,0,26,12,14,30
CFR Cluj,9448,2,5,6,3,14,10,4,21
D Bucuresti,9448,3,5,4,5,20,19,1,19
Universitate,9448,4,4,6,4,16,19,-3,18
FC Botosani,9448,5,3,4,7,5,15,-10,13
Concordia Ch,9448,6,3,2,9,18,24,-6,11
FCSB,9449,1,8,5,1,24,11,13,29
CFR Cluj,9449,2,5,7,2,15,10,5,22
Universitate,9449,3,4,6,4,17,20,-3,18
D Bucuresti,9449,4,4,5,5,19,18,1,17
FC Botosani,9449,5,4,4,6,6,15,-9,16
Concordia Ch,9449,6,2,3,9,15,22,-7,9
FCSB,9450,1,7,6,1,27,15,12,27
CFR Cluj,9450,2,5,7,2,15,10,5,22
Universitate,9450,3,5,5,4,18,20,-2,20
D Bucuresti,9450,4,4,5,5,17,18,-1,17
FC Botosani,9450,5,4,4,6,6,13,-7,16
Concordia Ch,9450,6,2,3,9,15,22,-7,9
FCSB,9451,1,8,5,1,25,13,12,29
CFR Cluj,9451,2,5,6,3,13,10,3,21
Universitate,9451,3,5,5,4,19,19,0,20
FC Botosani,9451,4,5,4,5,8,13,-5,19
D Bucuresti,9451,5,3,4,7,16,21,-5,13
Concordia Ch,9451,6,3,2,9,18,23,-5,11
FCSB,9452,1,8,5,1,26,13,13,29
CFR Cluj,9452,2,7,6,1,15,7,8,27
D Bucuresti,9452,3,4,5,5,18,18,0,17
Universitate,9452,4,3,5,6,16,22,-6,14
FC Botosani,9452,5,3,5,6,6,14,-8,14
Concordia Ch,9452,6,3,2,9,17,24,-7,11
FCSB,9453,1,8,6,0,26,12,14,30
CFR Cluj,9453,2,5,7,2,14,9,5,22
D Bucuresti,9453,3,4,4,6,19,21,-2,16
Universitate,9453,4,3,7,4,15,19,-4,16
Concordia Ch,9453,5,4,2,8,19,23,-4,14
FC Botosani,9453,6,3,4,7,7,16,-9,13
FCSB,9454,1,7,5,2,25,16,9,26
CFR Cluj,9454,2,6,7,1,17,10,7,25
Universitate,9454,3,4,6,4,20,21,-1,18
D Bucuresti,9454,4,4,4,6,18,20,-2,16
FC Botosani,9454,5,4,4,6,8,14,-6,16
Concordia Ch,9454,6,3,2,9,17,24,-7,11
FCSB,9455,1,7,6,1,23,11,12,27
CFR Cluj,9455,2,7,6,1,16,8,8,27
D Bucuresti,9455,3,5,4,5,19,18,1,19
Universitate,9455,4,3,6,5,15,20,-5,15
FC Botosani,9455,5,3,5,6,5,13,-8,14
Concordia Ch,9455,6,2,3,9,15,23,-8,9
FCSB,9456,1,7,6,1,24,13,11,27
CFR Cluj,9456,2,5,7,2,15,10,5,22
Universitate,9456,3,5,5,4,18,19,-1,20
D Bucuresti,9456,4,4,5,5,19,18,1,17
FC Botosani,9456,5,3,4,7,5,16,-11,13
Concordia Ch,9456,6,3,3,8,16,21,-5,12
FCSB,9457,1,7,7,0,28,15,13,28
CFR Cluj,9457,2,5,8,1,15,9,6,23
D Bucuresti,9457,3,4,5,5,19,20,-1,17
Universitate,9457,4,3,7,4,17,21,-4,16
FC Botosani,9457,5,3,5,6,6,16,-10,14
Concordia Ch,9457,6,3,2,9,21,25,-4,11
FCSB,9458,1,7,6,1,24,14,10,27
CFR Cluj,9458,2,6,7,1,15,8,7,25
FC Botosani,9458,3,5,4,5,8,12,-4,19
Universitate,9458,4,4,5,5,17,19,-2,17
D Bucuresti,9458,5,3,4,7,16,22,-6,13
Concordia Ch,9458,6,3,2,9,18,23,-5,11
FCSB,9459,1,8,6,0,27,12,15,30
CFR Cluj,9459,2,5,7,2,15,10,5,22
D Bucuresti,9459,3,5,4,5,21,18,3,19
Universitate,9459,4,4,5,5,17,22,-5,17
FC Botosani,9459,5,4,4,6,6,14,-8,16
Concordia Ch,9459,6,2,2,10,15,25,-10,8
CFR Cluj,9460,1,7,6,1,16,7,9,27
FCSB,9460,2,7,5,2,23,14,9,26
Universitate,9460,3,4,5,5,16,19,-3,17
FC Botosani,9460,4,4,4,6,8,15,-7,16
Concordia Ch,9460,5,4,2,8,21,25,-4,14
D Bucuresti,9460,6,3,4,7,20,24,-4,13
FCSB,9461,1,7,5,2,24,13,11,26
CFR Cluj,9461,2,6,6,2,14,8,6,24
Universitate,9461,3,5,5,4,17,19,-2,20
D Bucuresti,9461,4,4,5,5,20,21,-1,17
FC Botosani,9461,5,4,4,6,10,16,-6,16
Concordia Ch,9461,6,2,3,9,17,25,-8,9
FCSB,9462,1,8,6,0,27,12,15,30
CFR Cluj,9462,2,6,7,1,17,9,8,25
D Bucuresti,9462,3,4,5,5,19,20,-1,17
Universitate,9462,4,3,5,6,16,24,-8,14
FC Botosani,9462,5,3,5,6,6,14,-8,14
Concordia Ch,9462,6,3,2,9,17,23,-6,11
FCSB,9463,1,7,6,1,24,13,11,27
CFR Cluj,9463,2,6,7,1,16,8,8,25
FC Botosani,9463,3,5,4,5,10,14,-4,19
Universitate,9463,4,4,5,5,16,20,-4,17
D Bucuresti,9463,5,3,4,7,17,22,-5,13
Concordia Ch,9463,6,3,2,9,17,23,-6,11
FCSB,9464,1,7,5,2,24,20,4,26
CFR Cluj,9464,2,6,7,1,18,8,10,25
D Bucuresti,9464,3,5,4,5,18,18,0,19
Universitate,9464,4,4,6,4,21,20,1,18
FC Botosani,9464,5,3,5,6,8,16,-8,14
Concordia Ch,9464,6,2,3,9,18,25,-7,9
FCSB,9465,1,9,5,0,25,10,15,32
CFR Cluj,9465,2,6,6,2,16,8,8,24
D Bucuresti,9465,3,5,4,5,20,20,0,19
FC Botosani,9465,4,4,4,6,8,15,-7,16
Universitate,9465,5,3,5,6,14,22,-8,14
Concordia Ch,9465,6,2,2,10,15,23,-8,8
FCSB,9466,1,8,5,1,25,12,13,29
CFR Cluj,9466,2,6,6,2,15,9,6,24
Universitate,9466,3,4,5,5,17,21,-4,17
FC Botosani,9466,4,4,5,5,6,12,-6,17
D Bucuresti,9466,5,3,5,6,16,22,-6,14
Concordia Ch,9466,6,3,2,9,19,22,-3,11
FCSB,9467,1,7,7,0,25,12,13,28
CFR Cluj,9467,2,5,7,2,13,8,5,22
Universitate,9467,3,4,6,4,17,20,-3,18
D Bucuresti,9467,4,4,4,6,19,21,-2,16
FC Botosani,9467,5,4,4,6,8,15,-7,16
Concordia Ch,9467,6,3,2,9,17,23,-6,11
FCSB,9468,1,7,6,1,24,12,12,27
CFR Cluj,9468,2,6,6,2,15,11,4,24
Universitate,9468,3,4,6,4,19,20,-1,18
FC Botosani,9468,4,4,5,5,8,14,-6,17
D Bucuresti,9468,5,3,6,5,18,20,-2,15
Concordia Ch,9468,6,2,3,9,17,24,-7,9
FCSB,9469,1,8,5,1,24,11,13,29
CFR Cluj,9469,2,5,6,3,13,9,4,21
Universitate,9469,3,5,5,4,16,18,-2,20
D Bucuresti,9469,4,5,4,5,18,18,0,19
FC Botosani,9469,5,4,4,6,7,14,-7,16
Concordia Ch,9469,6,2,2,10,16,24,-8,8
FCSB,9470,1,8,6,0,28,12,16,30
CFR Cluj,9470,2,5,6,3,14,12,2,21
Universitate,9470,3,4,6,4,16,19,-3,18
D Bucuresti,9470,4,4,5,5,17,18,-1,17
FC Botosani,9470,5,4,5,5,8,12,-4,17
Concordia Ch,9470,6,2,2,10,15,25,-10,8
FCSB,9471,1,9,5,0,27,11,16,32
CFR Cluj,9471,2,6,6,2,15,10,5,24
FC Botosani,9471,3,4,5,5,10,15,-5,17
D Bucuresti,9471,4,4,4,6,18,21,-3,16
Universitate,9471,5,3,5,6,16,22,-6,14
Concordia Ch,9471,6,2,3,9,17,24,-7,9
FCSB,9472,1,8,5,1,26,12,14,29
CFR Cluj,9472,2,6,6,2,15,9,6,24
D Bucuresti,9472,3,4,5,5,18,19,-1,17
Universitate,9472,4,4,5,5,16,21,-5,17
FC Botosani,9472,5,3,6,5,5,12,-7,15
Concordia Ch,9472,6,2,3,9,16,23,-7,9
FCSB,9473,1,8,5,1,26,14,12,29
CFR Cluj,9473,2,5,6,3,13,10,3,21
Universitate,9473,3,5,5,4,20,20,0,20
D Bucuresti,9473,4,4,4,6,20,20,0,16
FC Botosani,9473,5,3,5,6,5,16,-11,14
Concordia Ch,9473,6,3,3,8,17,21,-4,12
FCSB,9474,1,7,6,1,24,13,11,27
CFR Cluj,9474,2,6,7,1,14,7,7,25
Universitate,9474,3,4,5,5,17,20,-3,17
FC Botosani,9474,4,4,5,5,7,12,-5,17
D Bucuresti,9474,5,4,4,6,17,20,-3,16
Concordia Ch,9474,6,2,3,9,15,22,-7,9
FCSB,9475,1,7,7,0,26,13,13,28
CFR Cluj,9475,2,5,7,2,15,11,4,22
Universitate,9475,3,4,6,4,17,19,-2,18
D Bucuresti,9475,4,3,6,5,21,23,-2,15
FC Botosani,9475,5,3,5,6,8,16,-8,14
Concordia Ch,9475,6,3,3,8,20,25,-5,12
FCSB,9476,1,7,6,1,23,13,10,27
CFR Cluj,9476,2,6,7,1,15,7,8,25
Universitate,9476,3,4,5,5,17,20,-3,17
FC Botosani,9476,4,4,5,5,8,14,-6,17
D Bucuresti,9476,5,3,6,5,19,21,-2,15
Concordia Ch,9476,6,2,3,9,16,23,-7,9
FCSB,9477,1,9,5,0,26,11,15,32
CFR Cluj,9477,2,5,7,2,14,9,5,22
Universitate,9477,3,3,6,5,14,19,-5,15
D Bucuresti,9477,4,3,5,6,19,22,-3,14
Concordia Ch,9477,5,4,2,8,18,22,-4,14
FC Botosani,9477,6,3,5,6,7,15,-8,14
FCSB,9478,1,9,5,0,26,11,15,32
CFR Cluj,9478,2,6,6,2,17,9,8,24
D Bucuresti,9478,3,4,5,5,19,18,1,17
FC Botosani,9478,4,4,4,6,6,15,-9,16
Universitate,9478,5,3,5,6,14,22,-8,14
Concordia Ch,9478,6,2,3,9,15,22,-7,9
FCSB,9479,1,8,6,0,28,12,16,30
CFR Cluj,9479,2,5,7,2,14,11,3,22
D Bucuresti,9479,3,4,4,6,21,21,0,16
Universitate,9479,4,3,7,4,15,19,-4,16
FC Botosani,9479,5,4,4,6,6,16,-10,16
Concordia Ch,9479,6,3,2,9,18,23,-5,11
FCSB,9480,1,9,5,0,29,12,17,32
CFR Cluj,9480,2,6,6,2,17,12,5,24
FC Botosani,9480,3,5,4,5,7,12,-5,19
D Bucuresti,9480,4,4,4,6,18,20,-2,16
Universitate,9480,5,3,5,6,18,25,-7,14
Concordia Ch,9480,6,2,2,10,16,24,-8,8
CFR Cluj,9481,1,7,6,1,18,8,10,27
FCSB,9481,2,7,5,2,23,14,9,26
D Bucuresti,9481,3,4,5,5,18,19,-1,17
Universitate,9481,4,4,5,5,16,20,-4,17
FC Botosani,9481,5,4,5,5,9,13,-4,17
Concordia Ch,9481,6,2,2,10,15,25,-10,8
FCSB,9482,1,7,7,0,24,11,13,28
CFR Cluj,9482,2,5,7,2,16,11,5,22
Universitate,9482,3,4,6,4,17,20,-3,18
D Bucuresti,9482,4,4,5,5,18,19,-1,17
FC Botosani,9482,5,4,4,6,7,14,-7,16
Concordia Ch,9482,6,2,3,9,15,22,-7,9
FCSB,9483,1,8,5,1,26,13,13,29
CFR Cluj,9483,2,7,6,1,17,8,9,27
D Bucuresti,9483,3,4,5,5,18,19,-1,17
Universitate,9483,4,3,5,6,15,22,-7,14
FC Botosani,9483,5,3,5,6,6,14,-8,14
Concordia Ch,9483,6,3,2,9,16,22,-6,11
FCSB,9484,1,7,6,1,25,14,11,27
CFR Cluj,9484,2,5,8,1,15,9,6,23
Universitate,9484,3,4,6,4,16,18,-2,18
FC Botosani,9484,4,4,5,5,9,15,-6,17
D Bucuresti,9484,5,3,5,6,20,23,-3,14
Concordia Ch,9484,6,2,4,8,18,24,-6,10
FCSB,9485,1,7,5,2,25,15,10,26
CFR Cluj,9485,2,6,6,2,16,9,7,24
Universitate,9485,3,5,5,4,17,19,-2,20
D Bucuresti,9485,4,4,4,6,17,19,-2,16
FC Botosani,9485,5,4,4,6,8,13,-5,16
Concordia Ch,9485,6,3,2,9,16,24,-8,11
FCSB,9486,1,9,5,0,27,10,17,32
CFR Cluj,9486,2,6,6,2,14,8,6,24
D Bucuresti,9486,3,5,4,5,22,19,3,19
Universitate,9486,4,3,5,6,14,22,-8,14
FC Botosani,9486,5,3,5,6,5,16,-11,14
Concordia Ch,9486,6,2,3,9,16,23,-7,9
FCSB,9487,1,8,5,1,26,13,13,29
CFR Cluj,9487,2,6,6,2,17,9,8,24
FC Botosani,9487,3,5,4,5,8,12,-4,19
Universitate,9487,4,4,5,5,16,22,-6,17
D Bucuresti,9487,5,4,4,6,17,19,-2,16
Concordia Ch,9487,6,2,2,10,15,24,-9,8
FCSB,9488,1,8,5,1,26,12,14,29
CFR Cluj,9488,2,5,6,3,13,11,2,21
Universitate,9488,3,5,5,4,17,18,-1,20
FC Botosani,9488,4,3,6,5,11,18,-7,15
D Bucuresti,9488,5,3,5,6,20,23,-3,14
Concordia Ch,9488,6,3,3,8,20,25,-5,12
FCSB,9489,1,7,6,1,25,13,12,27
CFR Cluj,9489,2,6,7,1,14,7,7,25
Universitate,9489,3,3,7,4,16,20,-4,16
D Bucuresti,9489,4,3,6,5,17,19,-2,15
FC Botosani,9489,5,3,5,6,5,13,-8,14
Concordia Ch,9489,6,3,3,8,17,22,-5,12
FCSB,9490,1,8,5,1,26,12,14,29
CFR Cluj,9490,2,6,6,2,16,10,6,24
FC Botosani,9490,3,5,4,5,8,12,-4,19
Universitate,9490,4,4,5,5,16,21,-5,17
D Bucuresti,9490,5,3,4,7,16,20,-4,13
Concordia Ch,9490,6,3,2,9,16,23,-7,11
FCSB,9491,1,9,5,0,27,11,16,32
CFR Cluj,9491,2,6,6,2,16,10,6,24
D Bucuresti,9491,3,4,4,6,17,19,-2,16
Concordia Ch,9491,4,4,2,8,18,22,-4,14
Universitate,9491,5,3,5,6,15,22,-7,14
FC Botosani,9491,6,3,4,7,6,15,-9,13
FCSB,9492,1,8,6,0,25,10,15,30
CFR Cluj,9492,2,6,7,1,14,7,7,25
D Bucuresti,9492,3,3,5,6,17,20,-3,14
Concordia Ch,9492,4,4,2,8,18,22,-4,14
Universitate,9492,5,3,5,6,14,21,-7,14
FC Botosani,9492,6,3,5,6,5,13,-8,14
FCSB,9493,1,8,6,0,30,12,18,30
CFR Cluj,9493,2,6,6,2,16,13,3,24
D Bucuresti,9493,3,5,4,5,18,18,0,19
FC Botosani,9493,4,4,4,6,8,14,-6,16
Universitate,9493,5,3,6,5,15,21,-6,15
Concordia Ch,9493,6,2,2,10,16,25,-9,8
FCSB,9494,1,9,5,0,27,10,17,32
CFR Cluj,9494,2,5,7,2,15,10,5,22
D Bucuresti,9494,3,4,5,5,19,20,-1,17
FC Botosani,9494,4,4,5,5,7,12,-5,17
Universitate,9494,5,3,6,5,16,23,-7,15
Concordia Ch,9494,6,2,2,10,17,26,-9,8
FCSB,9495,1,8,6,0,25,10,15,30
CFR Cluj,9495,2,6,6,2,14,9,5,24
D Bucuresti,9495,3,4,4,6,19,20,-1,16
Universitate,9495,4,3,6,5,14,19,-5,15
FC Botosani,9495,5,3,5,6,5,14,-9,14
Concordia Ch,9495,6,3,3,8,17,22,-5,12
FCSB,9496,1,9,5,0,26,10,16,32
CFR Cluj,9496,2,5,7,2,13,8,5,22
D Bucuresti,9496,3,4,5,5,18,18,0,17
Universitate,9496,4,3,6,5,14,20,-6,15
FC Botosani,9496,5,3,6,5,6,13,-7,15
Concordia Ch,9496,6,2,3,9,16,24,-8,9
FCSB,9497,1,9,5,0,27,12,15,32
CFR Cluj,9497,2,5,7,2,16,11,5,22
Universitate,9497,3,3,6,5,17,22,-5,15
Concordia Ch,9497,4,4,2,8,21,24,-3,14
D Bucuresti,9497,5,3,5,6,19,23,-4,14
FC Botosani,9497,6,3,5,6,9,17,-8,14
FCSB,9498,1,8,6,0,26,11,15,30
CFR Cluj,9498,2,6,6,2,14,9,5,24
FC Botosani,9498,3,4,5,5,7,13,-6,17
Universitate,9498,4,3,6,5,15,20,-5,15
D Bucuresti,9498,5,3,5,6,19,24,-5,14
Concordia Ch,9498,6,3,2,9,20,24,-4,11
FCSB,9499,1,8,5,1,27,14,13,29
CFR Cluj,9499,2,5,7,2,14,9,5,22
Universitate,9499,3,4,6,4,17,20,-3,18
D Bucuresti,9499,4,4,4,6,20,22,-2,16
Concordia Ch,9499,5,4,2,8,20,23,-3,14
FC Botosani,9499,6,3,4,7,6,16,-10,13
FCSB,9500,1,8,5,1,24,11,13,29
CFR Cluj,9500,2,7,6,1,15,7,8,27
D Bucuresti,9500,3,4,5,5,21,19,2,17
FC Botosani,9500,4,4,5,5,7,13,-6,17
Universitate,9500,5,3,5,6,14,20,-6,14
Concordia Ch,9500,6,2,2,10,15,26,-11,8
CFR Cluj,9501,1,7,6,1,19,8,11,27
FCSB,9501,2,7,6,1,24,14,10,27
D Bucuresti,9501,3,5,4,5,20,19,1,19
FC Botosani,9501,4,4,4,6,7,14,-7,16
Universitate,9501,5,3,6,5,14,20,-6,15
Concordia Ch,9501,6,2,2,10,16,25,-9,8
FCSB,9502,1,8,6,0,26,12,14,30
CFR Cluj,9502,2,5,8,1,15,9,6,23
D Bucuresti,9502,3,4,4,6,18,20,-2,16
Universitate,9502,4,3,6,5,14,19,-5,15
FC Botosani,9502,5,3,5,6,6,15,-9,14
Concordia Ch,9502,6,3,3,8,18,22,-4,12
FCSB,9503,1,8,5,1,24,12,12,29
CFR Cluj,9503,2,5,6,3,13,9,4,21
Universitate,9503,3,5,5,4,17,18,-1,20
D Bucuresti,9503,4,4,4,6,21,22,-1,16
FC Botosani,9503,5,4,4,6,7,14,-7,16
Concordia Ch,9503,6,3,2,9,19,26,-7,11
FCSB,9504,1,8,6,0,25,10,15,30
CFR Cluj,9504,2,5,7,2,13,8,5,22
Universitate,9504,3,4,5,5,15,20,-5,17
FC Botosani,9504,4,4,4,6,9,15,-6,16
Concordia Ch,9504,5,4,2,8,19,23,-4,14
D Bucuresti,9504,6,3,4,7,16,21,-5,13
FCSB,9505,1,8,5,1,26,14,12,29
CFR Cluj,9505,2,7,6,1,19,8,11,27
D Bucuresti,9505,3,4,5,5,17,18,-1,17
Universitate,9505,4,3,5,6,15,23,-8,14
FC Botosani,9505,5,3,5,6,5,13,-8,14
Concordia Ch,9505,6,3,2,9,16,22,-6,11
FCSB,9506,1,8,5,1,25,12,13,29
CFR Cluj,9506,2,6,6,2,14,8,6,24
FC Botosani,9506,3,5,4,5,10,15,-5,19
Universitate,9506,4,4,5,5,16,20,-4,17
D Bucuresti,9506,5,4,4,6,19,21,-2,16
Concordia Ch,9506,6,2,2,10,16,24,-8,8
FCSB,9507,1,8,6,0,27,12,15,30
CFR Cluj,9507,2,5,7,2,13,9,4,22
Universitate,9507,3,3,7,4,16,20,-4,16
D Bucuresti,9507,4,3,6,5,18,20,-2,15
FC Botosani,9507,5,3,6,5,8,15,-7,15
Concordia Ch,9507,6,2,4,8,16,22,-6,10
FCSB,9508,1,7,7,0,24,11,13,28
CFR Cluj,9508,2,6,7,1,15,8,7,25
D Bucuresti,9508,3,4,5,5,20,19,1,17
FC Botosani,9508,4,4,4,6,6,15,-9,16
Universitate,9508,5,3,6,5,16,21,-5,15
Concordia Ch,9508,6,2,3,9,16,23,-7,9
FCSB,9509,1,8,5,1,26,13,13,29
CFR Cluj,9509,2,5,6,3,14,11,3,21
Universitate,9509,3,5,5,4,18,19,-1,20
FC Botosani,9509,4,4,5,5,7,13,-6,17
D Bucuresti,9509,5,3,4,7,16,23,-7,13
Concordia Ch,9509,6,3,3,8,20,22,-2,12
FCSB,9510,1,8,5,1,25,13,12,29
CFR Cluj,9510,2,6,6,2,16,9,7,24
D Bucuresti,9510,3,4,5,5,19,18,1,17
Universitate,9510,4,4,5,5,15,19,-4,17
FC Botosani,9510,5,3,5,6,6,16,-10,14
Concordia Ch,9510,6,2,4,8,16,22,-6,10
FCSB,9511,1,8,5,1,25,12,13,29
CFR Cluj,9511,2,6,6,2,17,10,7,24
Universitate,9511,3,4,5,5,17,22,-5,17
D Bucuresti,9511,4,3,6,5,17,19,-2,15
FC Botosani,9511,5,3,5,6,6,14,-8,14
Concordia Ch,9511,6,3,3,8,18,23,-5,12
FCSB,9512,1,8,6,0,26,12,14,30
CFR Cluj,9512,2,5,8,1,14,8,6,23
FC Botosani,9512,3,5,4,5,9,13,-4,19
Universitate,9512,4,3,6,5,15,20,-5,15
D Bucuresti,9512,5,3,5,6,16,19,-3,14
Concordia Ch,9512,6,2,3,9,16,24,-8,9
FCSB,9513,1,8,6,0,29,13,16,30
CFR Cluj,9513,2,5,8,1,15,9,6,23
D Bucuresti,9513,3,4,4,6,17,20,-3,16
FC Botosani,9513,4,4,4,6,8,14,-6,16
Universitate,9513,5,3,6,5,15,22,-7,15
Concordia Ch,9513,6,3,2,9,17,23,-6,11
FCSB,9514,1,7,5,2,24,16,8,26
CFR Cluj,9514,2,6,6,2,16,9,7,24
Universitate,9514,3,5,5,4,20,20,0,20
D Bucuresti,9514,4,3,6,5,17,19,-2,15
FC Botosani,9514,5,3,5,6,5,14,-9,14
Concordia Ch,9514,6,3,3,8,18,22,-4,12
FCSB,9515,1,8,5,1,25,15,10,29
CFR Cluj,9515,2,5,7,2,16,11,5,22
Universitate,9515,3,4,6,4,22,22,0,18
D Bucuresti,9515,4,4,5,5,17,18,-1,17
FC Botosani,9515,5,4,4,6,8,14,-6,16
Concordia Ch,9515,6,2,3,9,16,24,-8,9
FCSB,9516,1,8,5,1,26,14,12,29
CFR Cluj,9516,2,6,7,1,17,9,8,25
FC Botosani,9516,3,5,4,5,9,14,-5,19
Universitate,9516,4,3,6,5,16,21,-5,15
D Bucuresti,9516,5,3,5,6,17,20,-3,14
Concordia Ch,9516,6,2,3,9,18,25,-7,9
FCSB,9517,1,9,5,0,28,11,17,32
CFR Cluj,9517,2,5,6,3,16,14,2,21
Universitate,9517,3,4,5,5,17,21,-4,17
FC Botosani,9517,4,4,5,5,7,13,-6,17
D Bucuresti,9517,5,3,5,6,18,21,-3,14
Concordia Ch,9517,6,3,2,9,17,23,-6,11
FCSB,9518,1,8,5,1,24,12,12,29
CFR Cluj,9518,2,7,6,1,17,8,9,27
FC Botosani,9518,3,4,5,5,8,14,-6,17
Universitate,9518,4,3,5,6,15,21,-6,14
D Bucuresti,9518,5,3,4,7,16,20,-4,13
Concordia Ch,9518,6,3,3,8,18,23,-5,12
FCSB,9519,1,9,5,0,27,11,16,32
CFR Cluj,9519,2,5,7,2,13,9,4,22
FC Botosani,9519,3,4,5,5,7,13,-6,17
D Bucuresti,9519,4,4,4,6,20,21,-1,16
Universitate,9519,5,3,6,5,15,20,-5,15
Concordia Ch,9519,6,2,3,9,16,24,-8,9
FCSB,9520,1,7,6,1,23,11,12,27
CFR Cluj,9520,2,5,7,2,13,8,5,22
Universitate,9520,3,5,5,4,16,18,-2,20
D Bucuresti,9520,4,4,5,5,17,18,-1,17
FC Botosani,9520,5,3,5,6,5,14,-9,14
Concordia Ch,9520,6,3,2,9,17,22,-5,11
FCSB,9521,1,9,5,0,26,10,16,32
CFR Cluj,9521,2,6,6,2,16,11,5,24
FC Botosani,9521,3,4,5,5,6,12,-6,17
Universitate,9521,4,3,5,6,16,22,-6,14
D Bucuresti,9521,5,3,4,7,17,21,-4,13
Concordia Ch,9521,6,3,3,8,17,22,-5,12
FCSB,9522,1,9,5,0,28,11,17,32
CFR Cluj,9522,2,5,6,3,14,10,4,21
D Bucuresti,9522,3,5,4,5,20,18,2,19
Universitate,9522,4,4,5,5,15,21,-6,17
FC Botosani,9522,5,4,4,6,8,13,-5,16
Concordia Ch,9522,6,2,2,10,15,27,-12,8
FCSB,9523,1,9,5,0,29,13,16,32
CFR Cluj,9523,2,6,6,2,15,9,6,24
D Bucuresti,9523,3,3,6,5,19,21,-2,15
Universitate,9523,4,3,5,6,16,23,-7,14
FC Botosani,9523,5,3,5,6,7,15,-8,14
Concordia Ch,9523,6,3,3,8,19,24,-5,12
FCSB,9524,1,8,5,1,25,12,13,29
CFR Cluj,9524,2,5,7,2,14,10,4,22
D Bucuresti,9524,3,5,4,5,21,21,0,19
Universitate,9524,4,4,6,4,17,19,-2,18
FC Botosani,9524,5,3,4,7,6,16,-10,13
Concordia Ch,9524,6,3,2,9,19,24,-5,11
FCSB,9525,1,8,6,0,29,14,15,30
CFR Cluj,9525,2,6,6,2,16,11,5,24
FC Botosani,9525,3,5,4,5,8,12,-4,19
D Bucuresti,9525,4,4,4,6,18,20,-2,16
Universitate,9525,5,3,6,5,16,21,-5,15
Concordia Ch,9525,6,2,2,10,16,25,-9,8
FCSB,9526,1,8,5,1,25,11,14,29
CFR Cluj,9526,2,6,6,2,15,10,5,24
Universitate,9526,3,4,5,5,16,20,-4,17
D Bucuresti,9526,4,4,4,6,17,19,-2,16
FC Botosani,9526,5,4,4,6,7,13,-6,16
Concordia Ch,9526,6,3,2,9,16,23,-7,11
FCSB,9527,1,8,6,0,24,10,14,30
CFR Cluj,9527,2,5,7,2,14,9,5,22
Universitate,9527,3,3,7,4,15,19,-4,16
D Bucuresti,9527,4,3,5,6,20,23,-3,14
Concordia Ch,9527,5,4,2,8,21,25,-4,14
FC Botosani,9527,6,3,5,6,7,15,-8,14
FCSB,9528,1,9,5,0,26,10,16,32
CFR Cluj,9528,2,5,7,2,14,10,4,22
FC Botosani,9528,3,4,5,5,8,14,-6,17
Universitate,9528,4,3,6,5,15,20,-5,15
D Bucuresti,9528,5,3,5,6,18,21,-3,14
Concordia Ch,9528,6,3,2,9,18,24,-6,11
FCSB,9529,1,7,6,1,24,12,12,27
CFR Cluj,9529,2,6,6,2,15,9,6,24
Universitate,9529,3,4,6,4,17,20,-3,18
FC Botosani,9529,4,4,4,6,7,14,-7,16
Concordia Ch,9529,5,4,2,8,20,22,-2,14
D Bucuresti,9529,6,3,4,7,16,22,-6,13
FCSB,9530,1,7,7,0,25,12,13,28
CFR Cluj,9530,2,5,8,1,15,9,6,23
Universitate,9530,3,3,7,4,16,20,-4,16
FC Botosani,9530,4,3,6,5,5,12,-7,15
D Bucuresti,9530,5,3,5,6,16,19,-3,14
Concordia Ch,9530,6,3,3,8,16,21,-5,12
FCSB,9531,1,7,5,2,24,15,9,26
CFR Cluj,9531,2,6,7,1,18,10,8,25
Universitate,9531,3,4,6,4,18,20,-2,18
FC Botosani,9531,4,4,5,5,8,14,-6,17
D Bucuresti,9531,5,3,5,6,19,22,-3,14
Concordia Ch,9531,6,3,2,9,17,23,-6,11
CFR Cluj,9532,1,7,6,1,16,7,9,27
FCSB,9532,2,7,5,2,25,15,10,26
D Bucuresti,9532,3,5,4,5,20,20,0,19
Universitate,9532,4,4,5,5,18,22,-4,17
FC Botosani,9532,5,3,5,6,6,14,-8,14
Concordia Ch,9532,6,2,3,9,16,23,-7,9
FCSB,9533,1,8,5,1,25,12,13,29
CFR Cluj,9533,2,6,7,1,14,7,7,25
D Bucuresti,9533,3,4,4,6,18,20,-2,16
FC Botosani,9533,4,4,4,6,6,14,-8,16
Universitate,9533,5,3,6,5,15,20,-5,15
Concordia Ch,9533,6,3,2,9,17,22,-5,11
FCSB,9534,1,8,6,0,26,10,16,30
CFR Cluj,9534,2,5,7,2,13,8,5,22
D Bucuresti,9534,3,5,4,5,21,21,0,19
Universitate,9534,4,4,5,5,15,21,-6,17
FC Botosani,9534,5,4,4,6,9,16,-7,16
Concordia Ch,9534,6,2,2,10,17,25,-8,8
FCSB,9535,1,8,6,0,29,13,16,30
CFR Cluj,9535,2,6,6,2,16,12,4,24
D Bucuresti,9535,3,4,4,6,19,19,0,16
FC Botosani,9535,4,4,4,6,7,15,-8,16
Universitate,9535,5,3,6,5,17,22,-5,15
Concordia Ch,9535,6,3,2,9,16,23,-7,11
FCSB,9536,1,7,5,2,24,14,10,26
CFR Cluj,9536,2,6,6,2,15,9,6,24
Universitate,9536,3,5,5,4,17,18,-1,20
FC Botosani,9536,4,4,5,5,9,15,-6,17
D Bucuresti,9536,5,3,5,6,18,21,-3,14
Concordia Ch,9536,6,3,2,9,17,23,-6,11
FCSB,9537,1,7,6,1,24,13,11,27
CFR Cluj,9537,2,6,7,1,15,8,7,25
D Bucuresti,9537,3,4,5,5,18,19,-1,17
Universitate,9537,4,4,5,5,16,19,-3,17
FC Botosani,9537,5,4,5,5,7,13,-6,17
Concordia Ch,9537,6,2,2,10,15,23,-8,8
FCSB,9538,1,8,5,1,24,14,10,29
CFR Cluj,9538,2,5,6,3,14,10,4,21
Universitate,9538,3,5,5,4,20,19,1,20
FC Botosani,9538,4,3,6,5,6,13,-7,15
D Bucuresti,9538,5,3,5,6,16,21,-5,14
Concordia Ch,9538,6,3,3,8,19,22,-3,12
FCSB,9539,1,9,5,0,27,11,16,32
CFR Cluj,9539,2,5,6,3,15,12,3,21
Universitate,9539,3,4,5,5,17,21,-4,17
D Bucuresti,9539,4,4,4,6,22,22,0,16
FC Botosani,9539,5,4,4,6,7,16,-9,16
Concordia Ch,9539,6,3,2,9,18,24,-6,11
FCSB,9540,1,7,6,1,24,12,12,27
CFR Cluj,9540,2,6,6,2,14,8,6,24
Universitate,9540,3,4,6,4,16,19,-3,18
D Bucuresti,9540,4,4,4,6,18,22,-4,16
Concordia Ch,9540,5,4,2,8,21,23,-2,14
FC Botosani,9540,6,3,4,7,6,15,-9,13
FCSB,9541,1,9,5,0,26,11,15,32
CFR Cluj,9541,2,5,7,2,13,8,5,22
FC Botosani,9541,3,4,4,6,7,14,-7,16
Universitate,9541,4,3,6,5,15,20,-5,15
Concordia Ch,9541,5,4,2,8,18,22,-4,14
D Bucuresti,9541,6,3,4,7,16,20,-4,13
FCSB,9542,1,8,6,0,29,13,16,30
CFR Cluj,9542,2,5,7,2,17,12,5,22
D Bucuresti,9542,3,5,4,5,21,20,1,19
Universitate,9542,4,4,5,5,18,24,-6,17
FC Botosani,9542,5,4,4,6,9,17,-8,16
Concordia Ch,9542,6,2,2,10,16,24,-8,8
CFR Cluj,9543,1,7,6,1,17,9,8,27
FCSB,9543,2,7,5,2,25,14,11,26
Universitate,9543,3,4,5,5,15,19,-4,17
FC Botosani,9543,4,4,5,5,6,12,-6,17
D Bucuresti,9543,5,3,5,6,17,21,-4,14
Concordia Ch,9543,6,3,2,9,18,23,-5,11
FCSB,9544,1,8,5,1,26,13,13,29
CFR Cluj,9544,2,5,6,3,14,11,3,21
Universitate,9544,3,5,5,4,18,19,-1,20
D Bucuresti,9544,4,4,5,5,21,21,0,17
FC Botosani,9544,5,4,4,6,7,14,-7,16
Concordia Ch,9544,6,2,3,9,18,26,-8,9
FCSB,9545,1,8,6,0,27,12,15,30
CFR Cluj,9545,2,5,8,1,16,10,6,23
D Bucuresti,9545,3,3,6,5,17,19,-2,15
Universitate,9545,4,3,6,5,15,21,-6,15
FC Botosani,9545,5,3,5,6,7,15,-8,14
Concordia Ch,9545,6,3,3,8,17,22,-5,12
FCSB,9546,1,7,6,1,26,15,11,27
CFR Cluj,9546,2,5,8,1,14,8,6,23
D Bucuresti,9546,3,5,4,5,21,18,3,19
Universitate,9546,4,4,6,4,18,20,-2,18
FC Botosani,9546,5,3,5,6,6,16,-10,14
Concordia Ch,9546,6,2,3,9,16,24,-8,9
FCSB,9547,1,9,5,0,26,11,15,32
CFR Cluj,9547,2,6,6,2,15,8,7,24
D Bucuresti,9547,3,4,4,6,18,20,-2,16
Concordia Ch,9547,4,4,2,8,17,21,-4,14
Universitate,9547,5,3,5,6,15,22,-7,14
FC Botosani,9547,6,3,4,7,6,15,-9,13
FCSB,9548,1,7,6,1,24,12,12,27
CFR Cluj,9548,2,5,8,1,15,9,6,23
Universitate,9548,3,4,6,4,16,19,-3,18
D Bucuresti,9548,4,4,4,6,18,21,-3,16
FC Botosani,9548,5,3,5,6,6,14,-8,14
Concordia Ch,9548,6,3,3,8,19,23,-4,12
FCSB,9549,1,7,6,1,25,13,12,27
CFR Cluj,9549,2,5,7,2,13,10,3,22
Universitate,9549,3,5,5,4,20,20,0,20
FC Botosani,9549,4,5,4,5,7,12,-5,19
D Bucuresti,9549,5,3,4,7,16,22,-6,13
Concordia Ch,9549,6,3,2,9,18,22,-4,11
FCSB,9550,1,7,6,1,24,12,12,27
CFR Cluj,9550,2,6,7,1,16,8,8,25
D Bucuresti,9550,3,4,5,5,18,19,-1,17
Universitate,9550,4,4,5,5,15,20,-5,17
FC Botosani,9550,5,3,5,6,6,14,-8,14
Concordia Ch,9550,6,3,2,9,16,22,-6,11
FCSB,9551,1,7,5,2,24,13,11,26
CFR Cluj,9551,2,6,6,2,15,9,6,24
Universitate,9551,3,5,5,4,18,20,-2,20
D Bucuresti,9551,4,4,5,5,18,19,-1,17
FC Botosani,9551,5,3,5,6,7,15,-8,14
Concordia Ch,9551,6,3,2,9,19,25,-6,11
FCSB,9552,1,7,6,1,24,13,11,27
CFR Cluj,9552,2,6,7,1,17,10,7,25
Universitate,9552,3,4,5,5,18,21,-3,17
FC Botosani,9552,4,4,5,5,10,15,-5,17
D Bucuresti,9552,5,3,4,7,18,24,-6,13
Concordia Ch,9552,6,3,3,8,20,24,-4,12
FCSB,9553,1,8,5,1,27,13,14,29
CFR Cluj,9553,2,5,6,3,14,12,2,21
Universitate,9553,3,5,5,4,19,20,-1,20
FC Botosani,9553,4,4,5,5,8,14,-6,17
D Bucuresti,9553,5,3,6,5,18,20,-2,15
Concordia Ch,9553,6,2,3,9,17,24,-7,9
FCSB,9554,1,8,5,1,27,12,15,29
CFR Cluj,9554,2,7,6,1,16,8,8,27
Concordia Ch,9554,3,4,2,8,20,23,-3,14
D Bucuresti,9554,4,3,5,6,19,23,-4,14
Universitate,9554,5,3,5,6,14,22,-8,14
FC Botosani,9554,6,3,5,6,6,14,-8,14
FCSB,9555,1,8,6,0,25,11,14,30
CFR Cluj,9555,2,5,7,2,14,9,5,22
D Bucuresti,9555,3,5,4,5,18,18,0,19
Universitate,9555,4,4,5,5,15,19,-4,17
FC Botosani,9555,5,4,4,6,6,13,-7,16
Concordia Ch,9555,6,2,2,10,15,23,-8,8
FCSB,9556,1,7,6,1,24,12,12,27
CFR Cluj,9556,2,6,7,1,16,8,8,25
Universitate,9556,3,4,5,5,17,22,-5,17
D Bucuresti,9556,4,4,4,6,17,19,-2,16
Concordia Ch,9556,5,4,2,8,17,21,-4,14
FC Botosani,9556,6,3,4,7,5,14,-9,13
FCSB,9557,1,7,7,0,25,12,13,28
CFR Cluj,9557,2,6,7,1,17,9,8,25
FC Botosani,9557,3,5,4,5,9,14,-5,19
Universitate,9557,4,3,6,5,14,20,-6,15
D Bucuresti,9557,5,3,4,7,17,21,-4,13
Concordia Ch,9557,6,3,2,9,17,23,-6,11
FCSB,9558,1,7,6,1,25,13,12,27
CFR Cluj,9558,2,7,6,1,19,7,12,27
FC Botosani,9558,3,5,4,5,9,14,-5,19
Universitate,9558,4,3,6,5,16,25,-9,15
D Bucuresti,9558,5,3,5,6,18,21,-3,14
Concordia Ch,9558,6,2,3,9,19,26,-7,9
FCSB,9559,1,9,5,0,27,11,16,32
CFR Cluj,9559,2,5,6,3,13,10,3,21
D Bucuresti,9559,3,5,4,5,22,22,0,19
Universitate,9559,4,4,5,5,16,20,-4,17
FC Botosani,9559,5,4,4,6,9,16,-7,16
Concordia Ch,9559,6,2,2,10,18,26,-8,8
FCSB,9560,1,8,5,1,28,12,16,29
CFR Cluj,9560,2,5,6,3,14,15,-1,21
Universitate,9560,3,5,5,4,20,20,0,20
D Bucuresti,9560,4,4,4,6,19,22,-3,16
FC Botosani,9560,5,4,4,6,9,15,-6,16
Concordia Ch,9560,6,3,2,9,18,24,-6,11
FCSB,9561,1,8,5,1,24,12,12,29
CFR Cluj,9561,2,5,6,3,13,10,3,21
Universitate,9561,3,5,5,4,18,18,0,20
D Bucuresti,9561,4,4,5,5,21,22,-1,17
FC Botosani,9561,5,4,5,5,8,14,-6,17
Concordia Ch,9561,6,2,2,10,19,27,-8,8
FCSB,9562,1,7,5,2,25,14,11,26
CFR Cluj,9562,2,6,7,1,16,9,7,25
D Bucuresti,9562,3,5,4,5,21,21,0,19
Universitate,9562,4,4,6,4,17,20,-3,18
FC Botosani,9562,5,3,4,7,7,16,-9,13
Concordia Ch,9562,6,3,2,9,17,23,-6,11
FCSB,9563,1,8,6,0,25,11,14,30
CFR Cluj,9563,2,6,7,1,17,8,9,25
D Bucuresti,9563,3,4,5,5,19,20,-1,17
FC Botosani,9563,4,4,5,5,9,14,-5,17
Universitate,9563,5,3,5,6,14,22,-8,14
Concordia Ch,9563,6,2,2,10,17,26,-9,8
FCSB,9564,1,8,5,1,26,14,12,29
CFR Cluj,9564,2,6,6,2,16,11,5,24
Universitate,9564,3,4,5,5,18,20,-2,17
D Bucuresti,9564,4,4,4,6,19,20,-1,16
Concordia Ch,9564,5,4,2,8,18,21,-3,14
FC Botosani,9564,6,3,4,7,5,16,-11,13
FCSB,9565,1,8,5,1,27,14,13,29
CFR Cluj,9565,2,6,6,2,15,10,5,24
FC Botosani,9565,3,5,4,5,7,12,-5,19
Universitate,9565,4,4,5,5,18,21,-3,17
D Bucuresti,9565,5,4,4,6,19,21,-2,16
Concordia Ch,9565,6,2,2,10,17,25,-8,8
FCSB,9566,1,9,5,0,27,10,17,32
CFR Cluj,9566,2,5,7,2,14,11,3,22
D Bucuresti,9566,3,4,5,5,18,18,0,17
FC Botosani,9566,4,4,4,6,7,14,-7,16
Universitate,9566,5,3,6,5,15,20,-5,15
Concordia Ch,9566,6,2,3,9,15,23,-8,9
FCSB,9567,1,8,5,1,28,14,14,29
CFR Cluj,9567,2,6,6,2,16,10,6,24
Universitate,9567,3,4,5,5,17,22,-5,17
FC Botosani,9567,4,4,5,5,8,14,-6,17
D Bucuresti,9567,5,3,4,7,18,24,-6,13
Concordia Ch,9567,6,3,3,8,22,25,-3,12
FCSB,9568,1,7,6,1,25,13,12,27
CFR Cluj,9568,2,6,7,1,15,8,7,25
FC Botosani,9568,3,5,4,5,11,13,-2,19
Universitate,9568,4,3,7,4,15,19,-4,16
D Bucuresti,9568,5,3,5,6,17,22,-5,14
Concordia Ch,9568,6,2,3,9,17,25,-8,9
FCSB,9569,1,9,5,0,26,10,16,32
CFR Cluj,9569,2,6,6,2,15,10,5,24
D Bucuresti,9569,3,3,6,5,18,20,-2,15
Universitate,9569,4,3,5,6,15,21,-6,14
FC Botosani,9569,5,3,5,6,8,16,-8,14
Concordia Ch,9569,6,3,3,8,19,24,-5,12
FCSB,9570,1,7,6,1,23,11,12,27
CFR Cluj,9570,2,6,6,2,14,8,6,24
Universitate,9570,3,4,6,4,15,18,-3,18
D Bucuresti,9570,4,4,4,6,19,20,-1,16
FC Botosani,9570,5,4,4,6,6,14,-8,16
Concordia Ch,9570,6,3,2,9,17,23,-6,11
FCSB,9571,1,8,5,1,26,13,13,29
CFR Cluj,9571,2,5,7,2,14,10,4,22
Universitate,9571,3,4,6,4,16,18,-2,18
FC Botosani,9571,4,4,4,6,7,13,-6,16
Concordia Ch,9571,5,4,2,8,18,22,-4,14
D Bucuresti,9571,6,3,4,7,17,22,-5,13
FCSB,9572,1,9,5,0,30,11,19,32
CFR Cluj,9572,2,6,6,2,16,9,7,24
FC Botosani,9572,3,4,5,5,10,15,-5,17
D Bucuresti,9572,4,3,5,6,18,21,-3,14
Universitate,9572,5,3,5,6,14,25,-11,14
Concordia Ch,9572,6,3,2,9,17,24,-7,11
FCSB,9573,1,7,7,0,24,11,13,28
CFR Cluj,9573,2,6,7,1,15,8,7,25
D Bucuresti,9573,3,4,5,5,18,19,-1,17
FC Botosani,9573,4,4,5,5,6,12,-6,17
Universitate,9573,5,3,6,5,16,21,-5,15
Concordia Ch,9573,6,2,2,10,16,24,-8,8
FCSB,9574,1,9,5,0,25,10,15,32
CFR Cluj,9574,2,5,7,2,15,10,5,22
FC Botosani,9574,3,4,5,5,7,13,-6,17
Universitate,9574,4,3,6,5,16,21,-5,15
D Bucuresti,9574,5,3,4,7,17,21,-4,13
Concordia Ch,9574,6,3,3,8,18,23,-5,12
FCSB,9575,1,8,5,1,25,13,12,29
CFR Cluj,9575,2,5,7,2,14,9,5,22
FC Botosani,9575,3,5,4,5,8,12,-4,19
Universitate,9575,4,4,6,4,16,18,-2,18
D Bucuresti,9575,5,4,4,6,18,19,-1,16
Concordia Ch,9575,6,2,2,10,15,25,-10,8
FCSB,9576,1,7,6,1,26,14,12,27
CFR Cluj,9576,2,5,8,1,15,9,6,23
Universitate,9576,3,4,6,4,16,19,-3,18
FC Botosani,9576,4,3,6,5,7,14,-7,15
D Bucuresti,9576,5,3,5,6,18,21,-3,14
Concordia Ch,9576,6,3,3,8,18,23,-5,12
FCSB,9577,1,8,5,1,26,12,14,29
CFR Cluj,9577,2,6,6,2,14,10,4,24
D Bucuresti,9577,3,5,4,5,21,19,2,19
Universitate,9577,4,4,5,5,16,19,-3,17
FC Botosani,9577,5,4,4,6,6,15,-9,16
Concordia Ch,9577,6,2,2,10,16,24,-8,8
FCSB,9578,1,8,6,0,25,11,14,30
CFR Cluj,9578,2,5,6,3,14,11,3,21
D Bucuresti,9578,3,5,4,5,20,19,1,19
Universitate,9578,4,4,6,4,18,20,-2,18
FC Botosani,9578,5,3,5,6,7,16,-9,14
Concordia Ch,9578,6,2,3,9,16,23,-7,9
FCSB,9579,1,8,6,0,26,12,14,30
CFR Cluj,9579,2,5,6,3,14,10,4,21
D Bucuresti,9579,3,5,4,5,20,20,0,19
Universitate,9579,4,4,6,4,16,19,-3,18
FC Botosani,9579,5,4,4,6,8,14,-6,16
Concordia Ch,9579,6,2,2,10,16,25,-9,8
FCSB,9580,1,7,6,1,25,13,12,27
CFR Cluj,9580,2,6,7,1,15,8,7,25
Universitate,9580,3,4,5,5,16,20,-4,17
FC Botosani,9580,4,4,5,5,8,14,-6,17
D Bucuresti,9580,5,3,5,6,16,19,-3,14
Concordia Ch,9580,6,3,2,9,18,24,-6,11
FCSB,9581,1,7,7,0,23,10,13,28
CFR Cluj,9581,2,5,8,1,14,8,6,23
Universitate,9581,3,3,7,4,15,19,-4,16
FC Botosani,9581,4,4,4,6,7,15,-8,16
D Bucuresti,9581,5,3,5,6,19,22,-3,14
Concordia Ch,9581,6,3,3,8,19,23,-4,12
FCSB,9582,1,8,5,1,25,12,13,29
CFR Cluj,9582,2,5,6,3,13,9,4,21
Universitate,9582,3,5,5,4,17,19,-2,20
D Bucuresti,9582,4,5,4,5,20,18,2,19
FC Botosani,9582,5,3,5,6,5,15,-10,14
Concordia Ch,9582,6,2,3,9,15,22,-7,9
FCSB,9583,1,8,5,1,24,12,12,29
CFR Cluj,9583,2,5,6,3,13,10,3,21
Universitate,9583,3,5,5,4,18,18,0,20
FC Botosani,9583,4,5,4,5,8,13,-5,19
D Bucuresti,9583,5,3,5,6,17,20,-3,14
Concordia Ch,9583,6,2,3,9,17,24,-7,9
FCSB,9584,1,9,5,0,30,11,19,32
CFR Cluj,9584,2,6,6,2,15,13,2,24
D Bucuresti,9584,3,4,4,6,18,20,-2,16
Concordia Ch,9584,4,4,2,8,19,22,-3,14
Universitate,9584,5,3,5,6,16,22,-6,14
FC Botosani,9584,6,3,4,7,5,15,-10,13
FCSB,9585,1,7,6,1,25,14,11,27
CFR Cluj,9585,2,6,7,1,16,9,7,25
Universitate,9585,3,4,5,5,16,19,-3,17
D Bucuresti,9585,4,4,4,6,17,20,-3,16
Concordia Ch,9585,5,4,2,8,19,21,-2,14
FC Botosani,9585,6,3,4,7,5,15,-10,13
FCSB,9586,1,8,6,0,24,10,14,30
CFR Cluj,9586,2,6,6,2,15,8,7,24
D Bucuresti,9586,3,4,5,5,22,20,2,17
Universitate,9586,4,3,6,5,14,20,-6,15
FC Botosani,9586,5,3,4,7,5,20,-15,13
Concordia Ch,9586,6,3,3,8,21,23,-2,12
FCSB,9587,1,8,6,0,27,12,15,30
CFR Cluj,9587,2,5,7,2,14,10,4,22
FC Botosani,9587,3,4,5,5,8,14,-6,17
D Bucuresti,9587,4,4,4,6,21,21,0,16
Universitate,9587,5,3,7,4,17,21,-4,16
Concordia Ch,9587,6,2,3,9,15,24,-9,9
FCSB,9588,1,7,7,0,25,12,13,28
CFR Cluj,9588,2,5,7,2,14,10,4,22
Universitate,9588,3,4,6,4,17,19,-2,18
D Bucuresti,9588,4,3,5,6,16,19,-3,14
Concordia Ch,9588,5,4,2,8,17,21,-4,14
FC Botosani,9588,6,3,5,6,5,13,-8,14
FCSB,9589,1,8,6,0,25,11,14,30
CFR Cluj,9589,2,6,6,2,16,9,7,24
FC Botosani,9589,3,4,4,6,6,14,-8,16
Universitate,9589,4,3,6,5,14,20,-6,15
D Bucuresti,9589,5,3,5,6,17,20,-3,14
Concordia Ch,9589,6,3,3,8,18,22,-4,12
FCSB,9590,1,7,7,0,25,12,13,28
CFR Cluj,9590,2,5,8,1,15,9,6,23
D Bucuresti,9590,3,5,4,5,20,18,2,19
Universitate,9590,4,3,7,4,16,20,-4,16
FC Botosani,9590,5,4,4,6,7,16,-9,16
Concordia Ch,9590,6,2,2,10,16,24,-8,8
FCSB,9591,1,8,5,1,28,13,15,29
CFR Cluj,9591,2,7,6,1,17,8,9,27
D Bucuresti,9591,3,4,5,5,18,19,-1,17
Universitate,9591,4,3,5,6,16,25,-9,14
FC Botosani,9591,5,3,4,7,5,14,-9,13
Concordia Ch,9591,6,3,3,8,17,22,-5,12
FCSB,9592,1,8,5,1,26,13,13,29
CFR Cluj,9592,2,5,7,2,17,13,4,22
Universitate,9592,3,4,6,4,19,21,-2,18
FC Botosani,9592,4,3,6,5,5,12,-7,15
D Bucuresti,9592,5,3,5,6,16,21,-5,14
Concordia Ch,9592,6,3,3,8,18,21,-3,12
FCSB,9593,1,9,5,0,27,10,17,32
CFR Cluj,9593,2,6,6,2,15,8,7,24
D Bucuresti,9593,3,4,5,5,18,19,-1,17
FC Botosani,9593,4,3,6,5,5,12,-7,15
Universitate,9593,5,3,5,6,14,23,-9,14
Concordia Ch,9593,6,2,3,9,16,23,-7,9
FCSB,9594,1,8,6,0,26,12,14,30
CFR Cluj,9594,2,5,8,1,15,9,6,23
D Bucuresti,9594,3,4,5,5,17,18,-1,17
FC Botosani,9594,4,4,5,5,6,12,-6,17
Universitate,9594,5,3,6,5,16,21,-5,15
Concordia Ch,9594,6,2,2,10,15,23,-8,8
FCSB,9595,1,9,5,0,29,10,19,32
CFR Cluj,9595,2,6,6,2,15,11,4,24
D Bucuresti,9595,3,4,5,5,17,18,-1,17
Universitate,9595,4,3,5,6,14,22,-8,14
FC Botosani,9595,5,3,5,6,5,13,-8,14
Concordia Ch,9595,6,3,2,9,16,22,-6,11
FCSB,9596,1,7,5,2,25,15,10,26
CFR Cluj,9596,2,6,7,1,17,9,8,25
FC Botosani,9596,3,5,4,5,12,16,-4,19
Universitate,9596,4,4,6,4,17,20,-3,18
D Bucuresti,9596,5,3,4,7,18,23,-5,13
Concordia Ch,9596,6,3,2,9,20,26,-6,11
FCSB,9597,1,9,5,0,26,10,16,32
CFR Cluj,9597,2,6,6,2,14,9,5,24
D Bucuresti,9597,3,3,6,5,19,21,-2,15
Universitate,9597,4,3,5,6,14,20,-6,14
FC Botosani,9597,5,3,5,6,7,15,-8,14
Concordia Ch,9597,6,3,3,8,17,22,-5,12
FCSB,9598,1,8,5,1,26,13,13,29
CFR Cluj,9598,2,6,6,2,16,10,6,24
Universitate,9598,3,4,5,5,17,21,-4,17
D Bucuresti,9598,4,3,6,5,19,21,-2,15
FC Botosani,9598,5,3,6,5,6,13,-7,15
Concordia Ch,9598,6,2,4,8,17,23,-6,10
FCSB,9599,1,8,6,0,27,10,17,30
CFR Cluj,9599,2,6,6,2,14,11,3,24
D Bucuresti,9599,3,4,4,6,17,19,-2,16
FC Botosani,9599,4,4,4,6,6,13,-7,16
Universitate,9599,5,3,6,5,14,19,-5,15
Concordia Ch,9599,6,3,2,9,16,22,-6,11
FCSB,9600,1,8,6,0,24,10,14,30
CFR Cluj,9600,2,5,7,2,13,8,5,22
D Bucuresti,9600,3,5,4,5,20,18,2,19
Universitate,9600,4,4,5,5,15,19,-4,17
FC Botosani,9600,5,4,4,6,6,14,-8,16
Concordia Ch,9600,6,2,2,10,15,24,-9,8
FCSB,9601,1,9,5,0,26,10,16,32
CFR Cluj,9601,2,5,6,3,13,11,2,21
Universitate,9601,3,4,5,5,16,19,-3,17
D Bucuresti,9601,4,4,4,6,18,20,-2,16
Concordia Ch,9601,5,4,2,8,20,23,-3,14
FC Botosani,9601,6,3,4,7,6,16,-10,13
FCSB,9602,1,7,6,1,24,12,12,27
CFR Cluj,9602,2,6,7,1,14,7,7,25
FC Botosani,9602,3,4,5,5,9,13,-4,17
Universitate,9602,4,3,7,4,15,19,-4,16
D Bucuresti,9602,5,3,5,6,17,20,-3,14
Concordia Ch,9602,6,3,2,9,16,24,-8,11
FCSB,9603,1,8,6,0,25,10,15,30
CFR Cluj,9603,2,5,7,2,13,9,4,22
Universitate,9603,3,4,5,5,16,20,-4,17
FC Botosani,9603,4,4,5,5,7,13,-6,17
D Bucuresti,9603,5,3,5,6,16,19,-3,14
Concordia Ch,9603,6,3,2,9,17,23,-6,11
FCSB,9604,1,7,6,1,23,11,12,27
CFR Cluj,9604,2,5,8,1,15,9,6,23
Universitate,9604,3,4,6,4,17,20,-3,18
D Bucuresti,9604,4,4,5,5,20,18,2,17
FC Botosani,9604,5,4,5,5,6,12,-6,17
Concordia Ch,9604,6,2,2,10,15,26,-11,8
FCSB,9605,1,7,6,1,25,13,12,27
CFR Cluj,9605,2,6,7,1,16,9,7,25
D Bucuresti,9605,3,5,4,5,19,18,1,19
Universitate,9605,4,4,5,5,15,19,-4,17
FC Botosani,9605,5,3,5,6,7,15,-8,14
Concordia Ch,9605,6,2,3,9,17,25,-8,9
FCSB,9606,1,7,7,0,26,13,13,28
CFR Cluj,9606,2,6,7,1,15,8,7,25
FC Botosani,9606,3,4,4,6,9,14,-5,16
Universitate,9606,4,3,6,5,16,21,-5,15
Concordia Ch,9606,5,4,2,8,17,21,-4,14
D Bucuresti,9606,6,3,4,7,17,23,-6,13
FCSB,9607,1,7,6,1,25,13,12,27
CFR Cluj,9607,2,6,7,1,15,8,7,25
D Bucuresti,9607,3,5,4,5,22,20,2,19
Universitate,9607,4,4,5,5,16,20,-4,17
FC Botosani,9607,5,3,4,7,6,17,-11,13
Concordia Ch,9607,6,3,2,9,19,25,-6,11
FCSB,9608,1,8,6,0,26,11,15,30
CFR Cluj,9608,2,5,6,3,14,12,2,21
Universitate,9608,3,4,6,4,16,18,-2,18
D Bucuresti,9608,4,4,4,6,20,21,-1,16
FC Botosani,9608,5,3,5,6,7,17,-10,14
Concordia Ch,9608,6,3,3,8,18,22,-4,12
FCSB,9609,1,8,6,0,25,11,14,30
CFR Cluj,9609,2,5,6,3,13,10,3,21
Universitate,9609,3,4,6,4,17,19,-2,18
FC Botosani,9609,4,4,4,6,7,17,-10,16
D Bucuresti,9609,5,3,5,6,18,22,-4,14
Concordia Ch,9609,6,3,3,8,22,23,-1,12
CFR Cluj,9610,1,7,6,1,20,8,12,27
FCSB,9610,2,7,6,1,23,14,9,27
FC Botosani,9610,3,4,4,6,8,13,-5,16
Universitate,9610,4,3,6,5,15,21,-6,15
Concordia Ch,9610,5,4,2,8,19,23,-4,14
D Bucuresti,9610,6,3,4,7,18,24,-6,13
FCSB,9611,1,8,6,0,25,11,14,30
CFR Cluj,9611,2,6,7,1,15,7,8,25
FC Botosani,9611,3,4,4,6,8,14,-6,16
D Bucuresti,9611,4,3,5,6,16,20,-4,14
Universitate,9611,5,3,5,6,15,22,-7,14
Concordia Ch,9611,6,3,3,8,17,22,-5,12
FCSB,9612,1,9,5,0,26,11,15,32
CFR Cluj,9612,2,6,6,2,14,8,6,24
D Bucuresti,9612,3,4,4,6,17,21,-4,16
FC Botosani,9612,4,4,4,6,8,14,-6,16
Universitate,9612,5,3,5,6,15,21,-6,14
Concordia Ch,9612,6,3,2,9,17,22,-5,11
FCSB,9613,1,8,6,0,26,12,14,30
CFR Cluj,9613,2,6,6,2,15,9,6,24
FC Botosani,9613,3,4,5,5,7,13,-6,17
Universitate,9613,4,3,6,5,17,22,-5,15
D Bucuresti,9613,5,3,4,7,18,22,-4,13
Concordia Ch,9613,6,3,3,8,19,24,-5,12
FCSB,9614,1,9,5,0,26,11,15,32
CFR Cluj,9614,2,5,7,2,13,8,5,22
FC Botosani,9614,3,4,5,5,9,15,-6,17
Universitate,9614,4,3,6,5,15,20,-5,15
D Bucuresti,9614,5,3,5,6,19,23,-4,14
Concordia Ch,9614,6,3,2,9,19,24,-5,11
FCSB,9615,1,8,5,1,27,12,15,29
CFR Cluj,9615,2,6,6,2,17,11,6,24
FC Botosani,9615,3,4,5,5,12,12,0,17
Universitate,9615,4,4,5,5,17,23,-6,17
D Bucuresti,9615,5,3,5,6,17,20,-3,14
Concordia Ch,9615,6,3,2,9,17,29,-12,11
FCSB,9616,1,7,6,1,24,12,12,27
CFR Cluj,9616,2,6,7,1,15,8,7,25
D Bucuresti,9616,3,5,4,5,21,19,2,19
Universitate,9616,4,3,7,4,16,20,-4,16
FC Botosani,9616,5,3,5,6,6,16,-10,14
Concordia Ch,9616,6,2,3,9,17,24,-7,9
FCSB,9617,1,7,5,2,24,14,10,26
CFR Cluj,9617,2,6,6,2,15,10,5,24
Universitate,9617,3,5,5,4,18,18,0,20
D Bucuresti,9617,4,4,4,6,19,21,-2,16
FC Botosani,9617,5,3,5,6,10,18,-8,14
Concordia Ch,9617,6,3,3,8,21,26,-5,12
FCSB,9618,1,8,6,0,26,12,14,30
CFR Cluj,9618,2,5,8,1,14,8,6,23
D Bucuresti,9618,3,4,5,5,22,20,2,17
FC Botosani,9618,4,4,5,5,8,13,-5,17
Universitate,9618,5,3,6,5,15,20,-5,15
Concordia Ch,9618,6,2,2,10,16,28,-12,8
FCSB,9619,1,8,5,1,28,13,15,29
CFR Cluj,9619,2,6,6,2,17,11,6,24
D Bucuresti,9619,3,4,5,5,18,19,-1,17
Universitate,9619,4,4,5,5,20,26,-6,17
FC Botosani,9619,5,4,4,6,6,13,-7,16
Concordia Ch,9619,6,2,3,9,16,23,-7,9
CFR Cluj,9620,1,7,6,1,18,9,9,27
FCSB,9620,2,7,5,2,25,16,9,26
Universitate,9620,3,4,5,5,19,22,-3,17
FC Botosani,9620,4,4,5,5,8,14,-6,17
D Bucuresti,9620,5,3,4,7,18,22,-4,13
Concordia Ch,9620,6,3,3,8,18,23,-5,12
FCSB,9621,1,7,7,0,25,12,13,28
CFR Cluj,9621,2,5,8,1,15,9,6,23
FC Botosani,9621,3,4,5,5,10,14,-4,17
Universitate,9621,4,3,7,4,16,20,-4,16
D Bucuresti,9621,5,3,4,7,17,23,-6,13
Concordia Ch,9621,6,3,3,8,17,22,-5,12
FCSB,9622,1,9,5,0,29,13,16,32
CFR Cluj,9622,2,6,6,2,18,10,8,24
FC Botosani,9622,3,4,5,5,9,13,-4,17
D Bucuresti,9622,4,3,5,6,17,20,-3,14
Universitate,9622,5,3,5,6,17,26,-9,14
Concordia Ch,9622,6,3,2,9,18,26,-8,11
FCSB,9623,1,8,6,0,27,12,15,30
CFR Cluj,9623,2,5,6,3,14,11,3,21
Universitate,9623,3,4,6,4,18,21,-3,18
FC Botosani,9623,4,4,5,5,9,15,-6,17
D Bucuresti,9623,5,3,5,6,21,24,-3,14
Concordia Ch,9623,6,3,2,9,18,24,-6,11
FCSB,9624,1,7,7,0,26,13,13,28
CFR Cluj,9624,2,6,7,1,18,10,8,25
Universitate,9624,3,3,6,5,16,22,-6,15
FC Botosani,9624,4,3,6,5,6,13,-7,15
D Bucuresti,9624,5,3,5,6,18,21,-3,14
Concordia Ch,9624,6,3,3,8,17,22,-5,12
FCSB,9625,1,7,7,0,24,11,13,28
CFR Cluj,9625,2,6,7,1,15,7,8,25
D Bucuresti,9625,3,3,6,5,17,19,-2,15
Universitate,9625,4,3,6,5,15,21,-6,15
FC Botosani,9625,5,3,6,5,5,12,-7,15
Concordia Ch,9625,6,2,4,8,16,22,-6,10
FCSB,9626,1,7,7,0,27,14,13,28
CFR Cluj,9626,2,5,8,1,17,11,6,23
FC Botosani,9626,3,5,4,5,10,13,-3,19
Universitate,9626,4,3,7,4,16,20,-4,16
D Bucuresti,9626,5,3,4,7,17,22,-5,13
Concordia Ch,9626,6,3,2,9,17,24,-7,11
FCSB,9627,1,8,6,0,24,10,14,30
CFR Cluj,9627,2,6,6,2,14,8,6,24
D Bucuresti,9627,3,4,5,5,22,20,2,17
FC Botosani,9627,4,4,5,5,10,14,-4,17
Universitate,9627,5,3,6,5,14,19,-5,15
Concordia Ch,9627,6,2,2,10,17,30,-13,8
FCSB,9628,1,9,5,0,27,11,16,32
CFR Cluj,9628,2,6,6,2,17,9,8,24
FC Botosani,9628,3,4,5,5,6,12,-6,17
D Bucuresti,9628,4,3,6,5,17,19,-2,15
Universitate,9628,5,3,5,6,15,24,-9,14
Concordia Ch,9628,6,2,3,9,16,23,-7,9
FCSB,9629,1,9,5,0,29,13,16,32
CFR Cluj,9629,2,6,6,2,17,9,8,24
D Bucuresti,9629,3,4,4,6,18,20,-2,16
Concordia Ch,9629,4,4,2,8,19,22,-3,14
Universitate,9629,5,3,5,6,18,27,-9,14
FC Botosani,9629,6,3,4,7,5,15,-10,13
FCSB,9630,1,8,6,0,26,11,15,30
CFR Cluj,9630,2,5,6,3,13,10,3,21
Universitate,9630,3,4,6,4,16,19,-3,18
FC Botosani,9630,4,4,5,5,9,15,-6,17
D Bucuresti,9630,5,3,4,7,17,21,-4,13
Concordia Ch,9630,6,3,3,8,20,25,-5,12
FCSB,9631,1,7,7,0,23,10,13,28
CFR Cluj,9631,2,5,8,1,13,7,6,23
Universitate,9631,3,3,7,4,14,18,-4,16
D Bucuresti,9631,4,3,6,5,16,18,-2,15
FC Botosani,9631,5,3,6,5,6,13,-7,15
Concordia Ch,9631,6,2,4,8,16,22,-6,10
FCSB,9632,1,7,7,0,25,12,13,28
CFR Cluj,9632,2,6,7,1,16,9,7,25
FC Botosani,9632,3,5,4,5,8,13,-5,19
D Bucuresti,9632,4,4,4,6,20,21,-1,16
Universitate,9632,5,3,6,5,14,19,-5,15
Concordia Ch,9632,6,2,2,10,16,25,-9,8
FCSB,9633,1,7,7,0,24,11,13,28
CFR Cluj,9633,2,5,8,1,14,8,6,23
FC Botosani,9633,3,4,5,5,7,13,-6,17
Universitate,9633,4,3,7,4,16,20,-4,16
D Bucuresti,9633,5,3,6,5,18,20,-2,15
Concordia Ch,9633,6,2,3,9,18,25,-7,9
FCSB,9634,1,8,6,0,24,10,14,30
CFR Cluj,9634,2,5,7,2,13,8,5,22
D Bucuresti,9634,3,4,5,5,19,19,0,17
Universitate,9634,4,3,7,4,14,18,-4,16
FC Botosani,9634,5,4,4,6,7,15,-8,16
Concordia Ch,9634,6,2,3,9,17,24,-7,9
FCSB,9635,1,9,5,0,27,11,16,32
CFR Cluj,9635,2,5,7,2,15,10,5,22
D Bucuresti,9635,3,4,4,6,17,21,-4,16
FC Botosani,9635,4,4,4,6,6,13,-7,16
Universitate,9635,5,3,6,5,15,21,-6,15
Concordia Ch,9635,6,3,2,9,18,22,-4,11
FCSB,9636,1,7,6,1,25,13,12,27
CFR Cluj,9636,2,6,6,2,16,11,5,24
Universitate,9636,3,4,6,4,16,18,-2,18
D Bucuresti,9636,4,4,5,5,19,19,0,17
FC Botosani,9636,5,3,5,6,6,14,-8,14
Concordia Ch,9636,6,3,2,9,16,23,-7,11
FCSB,9637,1,8,5,1,28,15,13,29
CFR Cluj,9637,2,6,6,2,19,11,8,24
D Bucuresti,9637,3,5,4,5,18,18,0,19
Universitate,9637,4,4,5,5,16,22,-6,17
FC Botosani,9637,5,3,5,6,5,13,-8,14
Concordia Ch,9637,6,2,3,9,15,22,-7,9
FCSB,9638,1,8,5,1,28,14,14,29
CFR Cluj,9638,2,6,6,2,17,10,7,24
FC Botosani,9638,3,5,4,5,8,13,-5,19
Universitate,9638,4,4,5,5,17,23,-6,17
D Bucuresti,9638,5,4,4,6,17,19,-2,16
Concordia Ch,9638,6,2,2,10,16,24,-8,8
FCSB,9639,1,8,5,1,25,12,13,29
CFR Cluj,9639,2,6,6,2,14,8,6,24
Universitate,9639,3,4,5,5,16,20,-4,17
D Bucuresti,9639,4,4,4,6,18,19,-1,16
Concordia Ch,9639,5,4,2,8,18,22,-4,14
FC Botosani,9639,6,3,4,7,6,16,-10,13
FCSB,9640,1,8,5,1,27,13,14,29
CFR Cluj,9640,2,6,6,2,17,10,7,24
D Bucuresti,9640,3,5,4,5,20,19,1,19
Universitate,9640,4,4,5,5,18,24,-6,17
FC Botosani,9640,5,3,4,7,6,15,-9,13
Concordia Ch,9640,6,3,2,9,16,23,-7,11
FCSB,9641,1,7,6,1,24,12,12,27
CFR Cluj,9641,2,7,6,1,18,9,9,27
D Bucuresti,9641,3,5,4,5,20,20,0,19
Universitate,9641,4,3,6,5,17,23,-6,15
FC Botosani,9641,5,3,4,7,5,15,-10,13
Concordia Ch,9641,6,3,2,9,19,24,-5,11
FCSB,9642,1,7,7,0,27,14,13,28
CFR Cluj,9642,2,6,7,1,19,11,8,25
D Bucuresti,9642,3,4,5,5,20,21,-1,17
FC Botosani,9642,4,4,5,5,12,15,-3,17
Universitate,9642,5,3,6,5,16,22,-6,15
Concordia Ch,9642,6,2,2,10,17,28,-11,8
FCSB,9643,1,7,6,1,26,15,11,27
CFR Cluj,9643,2,5,7,2,17,13,4,22
Universitate,9643,3,5,5,4,19,19,0,20
D Bucuresti,9643,4,4,5,5,17,18,-1,17
FC Botosani,9643,5,3,5,6,5,14,-9,14
Concordia Ch,9643,6,3,2,9,17,22,-5,11
FCSB,9644,1,8,5,1,26,12,14,29
CFR Cluj,9644,2,6,6,2,14,9,5,24
D Bucuresti,9644,3,4,5,5,19,19,0,17
Universitate,9644,4,4,5,5,16,20,-4,17
FC Botosani,9644,5,3,5,6,5,14,-9,14
Concordia Ch,9644,6,3,2,9,18,24,-6,11
CFR Cluj,9645,1,7,6,1,16,8,8,27
FCSB,9645,2,7,5,2,25,14,11,26
Universitate,9645,3,4,5,5,18,22,-4,17
D Bucuresti,9645,4,4,4,6,18,20,-2,16
Concordia Ch,9645,5,4,2,8,17,21,-4,14
FC Botosani,9645,6,3,4,7,6,15,-9,13
FCSB,9646,1,9,5,0,27,10,17,32
CFR Cluj,9646,2,5,7,2,13,10,3,22
D Bucuresti,9646,3,5,4,5,21,19,2,19
FC Botosani,9646,4,4,4,6,8,16,-8,16
Universitate,9646,5,3,6,5,14,19,-5,15
Concordia Ch,9646,6,2,2,10,18,27,-9,8
FCSB,9647,1,7,5,2,24,14,10,26
CFR Cluj,9647,2,6,6,2,16,9,7,24
Universitate,9647,3,5,5,4,18,20,-2,20
FC Botosani,9647,4,3,6,5,6,13,-7,15
D Bucuresti,9647,5,3,5,6,17,21,-4,14
Concordia Ch,9647,6,3,3,8,19,23,-4,12
FCSB,9648,1,8,5,1,27,16,11,29
CFR Cluj,9648,2,7,6,1,21,9,12,27
D Bucuresti,9648,3,4,4,6,18,19,-1,16
Concordia Ch,9648,4,4,2,8,19,22,-3,14
Universitate,9648,5,3,5,6,14,22,-8,14
FC Botosani,9648,6,3,4,7,6,17,-11,13
FCSB,9649,1,8,5,1,26,14,12,29
CFR Cluj,9649,2,7,6,1,18,7,11,27
D Bucuresti,9649,3,4,4,6,18,20,-2,16
FC Botosani,9649,4,4,4,6,7,14,-7,16
Universitate,9649,5,3,5,6,15,23,-8,14
Concordia Ch,9649,6,3,2,9,18,24,-6,11
FCSB,9650,1,9,5,0,28,10,18,32
CFR Cluj,9650,2,5,6,3,14,13,1,21
FC Botosani,9650,3,5,4,5,8,13,-5,19
Universitate,9650,4,4,5,5,16,20,-4,17
D Bucuresti,9650,5,3,4,7,18,23,-5,13
Concordia Ch,9650,6,3,2,9,20,25,-5,11
FCSB,9651,1,7,6,1,23,11,12,27
CFR Cluj,9651,2,7,6,1,15,7,8,27
D Bucuresti,9651,3,4,4,6,19,22,-3,16
Universitate,9651,4,3,6,5,14,19,-5,15
FC Botosani,9651,5,3,5,6,6,14,-8,14
Concordia Ch,9651,6,3,3,8,18,22,-4,12
FCSB,9652,1,7,7,0,26,13,13,28
CFR Cluj,9652,2,5,8,1,16,10,6,23
Universitate,9652,3,3,7,4,14,18,-4,16
D Bucuresti,9652,4,3,6,5,18,20,-2,15
FC Botosani,9652,5,3,6,5,7,14,-7,15
Concordia Ch,9652,6,2,4,8,17,23,-6,10
FCSB,9653,1,8,5,1,25,12,13,29
CFR Cluj,9653,2,5,6,3,14,12,2,21
Universitate,9653,3,5,5,4,18,18,0,20
D Bucuresti,9653,4,3,5,6,16,19,-3,14
Concordia Ch,9653,5,4,2,8,17,21,-4,14
FC Botosani,9653,6,3,5,6,5,13,-8,14
FCSB,9654,1,9,5,0,29,10,19,32
CFR Cluj,9654,2,5,6,3,13,12,1,21
Universitate,9654,3,4,5,5,15,20,-5,17
D Bucuresti,9654,4,4,4,6,19,20,-1,16
FC Botosani,9654,5,4,4,6,7,15,-8,16
Concordia Ch,9654,6,3,2,9,18,24,-6,11
FCSB,9655,1,7,5,2,24,14,10,26
CFR Cluj,9655,2,6,6,2,16,9,7,24
Universitate,9655,3,5,5,4,18,20,-2,20
D Bucuresti,9655,4,4,4,6,18,20,-2,16
Concordia Ch,9655,5,4,2,8,20,23,-3,14
FC Botosani,9655,6,3,4,7,8,18,-10,13
FCSB,9656,1,8,5,1,24,12,12,29
CFR Cluj,9656,2,6,6,2,14,8,6,24
Universitate,9656,3,4,5,5,16,19,-3,17
D Bucuresti,9656,4,4,4,6,17,19,-2,16
FC Botosani,9656,5,4,4,6,6,13,-7,16
Concordia Ch,9656,6,3,2,9,16,22,-6,11
FCSB,9657,1,9,5,0,28,10,18,32
CFR Cluj,9657,2,6,6,2,16,9,7,24
D Bucuresti,9657,3,4,4,6,19,22,-3,16
FC Botosani,9657,4,3,5,6,7,16,-9,14
Universitate,9657,5,3,5,6,14,24,-10,14
Concordia Ch,9657,6,3,3,8,21,24,-3,12
FCSB,9658,1,8,5,1,25,13,12,29
CFR Cluj,9658,2,5,7,2,17,12,5,22
Universitate,9658,3,4,6,4,19,21,-2,18
D Bucuresti,9658,4,4,5,5,18,19,-1,17
FC Botosani,9658,5,4,5,5,7,12,-5,17
Concordia Ch,9658,6,2,2,10,16,25,-9,8
FCSB,9659,1,8,5,1,26,13,13,29
CFR Cluj,9659,2,7,6,1,17,8,9,27
D Bucuresti,9659,3,5,4,5,24,19,5,19
Universitate,9659,4,3,5,6,17,24,-7,14
FC Botosani,9659,5,3,5,6,6,17,-11,14
Concordia Ch,9659,6,2,3,9,15,24,-9,9
FCSB,9660,1,7,6,1,23,13,10,27
CFR Cluj,9660,2,6,6,2,16,8,8,24
Universitate,9660,3,4,6,4,15,18,-3,18
FC Botosani,9660,4,4,5,5,6,12,-6,17
D Bucuresti,9660,5,3,5,6,16,19,-3,14
Concordia Ch,9660,6,2,4,8,15,21,-6,10
FCSB,9661,1,9,5,0,26,10,16,32
CFR Cluj,9661,2,6,6,2,14,8,6,24
D Bucuresti,9661,3,4,4,6,18,21,-3,16
Universitate,9661,4,3,5,6,14,21,-7,14
FC Botosani,9661,5,3,5,6,6,14,-8,14
Concordia Ch,9661,6,3,3,8,19,23,-4,12
FCSB,9662,1,7,6,1,25,13,12,27
CFR Cluj,9662,2,6,6,2,15,10,5,24
FC Botosani,9662,3,5,4,5,9,12,-3,19
Universitate,9662,4,4,6,4,17,19,-2,18
D Bucuresti,9662,5,3,4,7,17,24,-7,13
Concordia Ch,9662,6,3,2,9,20,25,-5,11
CFR Cluj,9663,1,7,6,1,18,9,9,27
FCSB,9663,2,7,5,2,25,14,11,26
D Bucuresti,9663,3,4,5,5,19,20,-1,17
Universitate,9663,4,4,5,5,17,22,-5,17
FC Botosani,9663,5,4,4,6,7,14,-7,16
Concordia Ch,9663,6,2,3,9,16,23,-7,9
FCSB,9664,1,9,5,0,29,12,17,32
CFR Cluj,9664,2,5,6,3,15,12,3,21
D Bucuresti,9664,3,4,5,5,21,21,0,17
Universitate,9664,4,4,5,5,17,22,-5,17
FC Botosani,9664,5,3,5,6,6,14,-8,14
Concordia Ch,9664,6,3,2,9,18,25,-7,11
FCSB,9665,1,8,5,1,27,13,14,29
CFR Cluj,9665,2,6,6,2,15,11,4,24
Universitate,9665,3,4,5,5,18,21,-3,17
D Bucuresti,9665,4,4,4,6,20,22,-2,16
FC Botosani,9665,5,4,4,6,6,14,-8,16
Concordia Ch,9665,6,3,2,9,19,24,-5,11
FCSB,9666,1,9,5,0,27,11,16,32
CFR Cluj,9666,2,6,6,2,16,9,7,24
D Bucuresti,9666,3,4,5,5,18,19,-1,17
Universitate,9666,4,3,5,6,15,23,-8,14
FC Botosani,9666,5,3,4,7,5,14,-9,13
Concordia Ch,9666,6,3,3,8,17,22,-5,12
FCSB,9667,1,7,6,1,24,12,12,27
CFR Cluj,9667,2,7,6,1,17,7,10,27
D Bucuresti,9667,3,5,4,5,21,20,1,19
Universitate,9667,4,3,6,5,15,22,-7,15
FC Botosani,9667,5,3,5,6,8,17,-9,14
Concordia Ch,9667,6,2,3,9,18,25,-7,9
FCSB,9668,1,7,6,1,24,12,12,27
CFR Cluj,9668,2,6,6,2,16,10,6,24
Universitate,9668,3,4,6,4,16,19,-3,18
D Bucuresti,9668,4,4,4,6,19,20,-1,16
Concordia Ch,9668,5,4,2,8,19,23,-4,14
FC Botosani,9668,6,3,4,7,6,16,-10,13
FCSB,9669,1,8,5,1,26,13,13,29
CFR Cluj,9669,2,7,6,1,18,8,10,27
D Bucuresti,9669,3,4,4,6,19,21,-2,16
FC Botosani,9669,4,4,4,6,6,13,-7,16
Universitate,9669,5,3,5,6,15,23,-8,14
Concordia Ch,9669,6,3,2,9,18,24,-6,11
FCSB,9670,1,7,5,2,24,13,11,26
CFR Cluj,9670,2,6,7,1,14,7,7,25
Universitate,9670,3,4,6,4,16,19,-3,18
D Bucuresti,9670,4,4,5,5,19,20,-1,17
FC Botosani,9670,5,3,4,7,5,15,-10,13
Concordia Ch,9670,6,3,3,8,19,23,-4,12
FCSB,9671,1,7,7,0,24,11,13,28
CFR Cluj,9671,2,5,8,1,13,7,6,23
FC Botosani,9671,3,4,5,5,8,14,-6,17
Universitate,9671,4,3,7,4,15,19,-4,16
D Bucuresti,9671,5,3,6,5,20,22,-2,15
Concordia Ch,9671,6,2,3,9,17,24,-7,9
FCSB,9672,1,7,7,0,26,13,13,28
CFR Cluj,9672,2,6,7,1,17,10,7,25
D Bucuresti,9672,3,4,4,6,19,22,-3,16
Universitate,9672,4,3,6,5,16,21,-5,15
FC Botosani,9672,5,3,5,6,6,14,-8,14
Concordia Ch,9672,6,3,3,8,18,22,-4,12
FCSB,9673,1,9,5,0,25,10,15,32
CFR Cluj,9673,2,5,7,2,14,9,5,22
D Bucuresti,9673,3,5,4,5,20,19,1,19
Universitate,9673,4,3,6,5,15,20,-5,15
FC Botosani,9673,5,3,4,7,6,15,-9,13
Concordia Ch,9673,6,3,2,9,18,25,-7,11
FCSB,9674,1,8,5,1,26,11,15,29
CFR Cluj,9674,2,5,7,2,15,12,3,22
Universitate,9674,3,4,6,4,17,20,-3,18
D Bucuresti,9674,4,4,4,6,18,21,-3,16
FC Botosani,9674,5,3,5,6,6,15,-9,14
Concordia Ch,9674,6,3,3,8,19,22,-3,12
FCSB,9675,1,7,5,2,24,13,11,26
CFR Cluj,9675,2,6,7,1,15,8,7,25
Universitate,9675,3,4,6,4,17,20,-3,18
D Bucuresti,9675,4,4,4,6,19,21,-2,16
FC Botosani,9675,5,4,4,6,8,15,-7,16
Concordia Ch,9675,6,3,2,9,19,25,-6,11
FCSB,9676,1,8,6,0,26,10,16,30
CFR Cluj,9676,2,5,8,1,15,9,6,23
FC Botosani,9676,3,4,4,6,6,13,-7,16
Universitate,9676,4,3,6,5,16,23,-7,15
D Bucuresti,9676,5,3,5,6,18,21,-3,14
Concordia Ch,9676,6,3,3,8,18,23,-5,12
FCSB,9677,1,8,5,1,26,12,14,29
CFR Cluj,9677,2,6,6,2,15,10,5,24
Universitate,9677,3,4,5,5,17,21,-4,17
D Bucuresti,9677,4,4,4,6,19,22,-3,16
FC Botosani,9677,5,3,5,6,7,15,-8,14
Concordia Ch,9677,6,3,3,8,17,21,-4,12
CFR Cluj,9678,1,7,6,1,16,7,9,27
FCSB,9678,2,7,5,2,23,12,11,26
D Bucuresti,9678,3,4,5,5,20,19,1,17
Universitate,9678,4,4,5,5,15,20,-5,17
FC Botosani,9678,5,3,5,6,5,13,-8,14
Concordia Ch,9678,6,3,2,9,17,25,-8,11
FCSB,9679,1,7,5,2,25,15,10,26
CFR Cluj,9679,2,6,6,2,15,8,7,24
Universitate,9679,3,5,5,4,18,20,-2,20
D Bucuresti,9679,4,4,5,5,17,18,-1,17
FC Botosani,9679,5,3,4,7,6,15,-9,13
Concordia Ch,9679,6,3,3,8,17,22,-5,12
FCSB,9680,1,8,6,0,26,12,14,30
CFR Cluj,9680,2,5,6,3,14,11,3,21
FC Botosani,9680,3,5,4,5,10,14,-4,19
Universitate,9680,4,4,6,4,17,19,-2,18
D Bucuresti,9680,5,4,4,6,18,20,-2,16
Concordia Ch,9680,6,2,2,10,16,25,-9,8
FCSB,9681,1,8,5,1,26,14,12,29
CFR Cluj,9681,2,5,7,2,14,10,4,22
Universitate,9681,3,4,6,4,17,18,-1,18
D Bucuresti,9681,4,4,5,5,20,21,-1,17
FC Botosani,9681,5,3,5,6,6,14,-8,14
Concordia Ch,9681,6,2,4,8,19,25,-6,10
FCSB,9682,1,7,5,2,24,14,10,26
CFR Cluj,9682,2,6,6,2,16,10,6,24
Universitate,9682,3,5,5,4,18,19,-1,20
D Bucuresti,9682,4,4,4,6,19,21,-2,16
FC Botosani,9682,5,4,4,6,6,15,-9,16
Concordia Ch,9682,6,3,2,9,18,22,-4,11
FCSB,9683,1,8,6,0,27,13,14,30
CFR Cluj,9683,2,5,6,3,14,10,4,21
Universitate,9683,3,4,6,4,17,20,-3,18
D Bucuresti,9683,4,4,5,5,19,20,-1,17
FC Botosani,9683,5,4,5,5,8,13,-5,17
Concordia Ch,9683,6,2,2,10,16,25,-9,8
FCSB,9684,1,7,6,1,24,13,11,27
CFR Cluj,9684,2,7,6,1,18,7,11,27
D Bucuresti,9684,3,4,4,6,20,22,-2,16
Universitate,9684,4,3,6,5,15,22,-7,15
Concordia Ch,9684,5,4,2,8,19,21,-2,14
FC Botosani,9684,6,3,4,7,7,18,-11,13
FCSB,9685,1,9,5,0,29,10,19,32
CFR Cluj,9685,2,6,6,2,14,10,4,24
D Bucuresti,9685,3,4,5,5,19,19,0,17
Universitate,9685,4,3,5,6,14,22,-8,14
FC Botosani,9685,5,3,5,6,8,17,-9,14
Concordia Ch,9685,6,2,4,8,19,25,-6,10
FCSB,9686,1,8,5,1,26,12,14,29
CFR Cluj,9686,2,6,7,1,14,7,7,25
D Bucuresti,9686,3,5,4,5,19,18,1,19
Universitate,9686,4,3,6,5,15,21,-6,15
FC Botosani,9686,5,3,5,6,6,14,-8,14
Concordia Ch,9686,6,2,3,9,16,24,-8,9
FCSB,9687,1,8,6,0,25,11,14,30
CFR Cluj,9687,2,5,7,2,14,9,5,22
Universitate,9687,3,4,5,5,15,19,-4,17
FC Botosani,9687,4,3,6,5,7,14,-7,15
D Bucuresti,9687,5,3,5,6,17,21,-4,14
Concordia Ch,9687,6,3,3,8,20,24,-4,12
CFR Cluj,9688,1,7,6,1,15,7,8,27
FCSB,9688,2,7,5,2,23,14,9,26
D Bucuresti,9688,3,4,5,5,18,18,0,17
Universitate,9688,4,4,5,5,17,19,-2,17
FC Botosani,9688,5,3,5,6,5,13,-8,14
Concordia Ch,9688,6,3,2,9,16,23,-7,11
FCSB,9689,1,7,5,2,24,13,11,26
CFR Cluj,9689,2,6,6,2,14,8,6,24
Universitate,9689,3,5,5,4,17,19,-2,20
FC Botosani,9689,4,4,5,5,7,13,-6,17
D Bucuresti,9689,5,4,4,6,17,19,-2,16
Concordia Ch,9689,6,2,3,9,16,23,-7,9
FCSB,9690,1,8,5,1,26,14,12,29
CFR Cluj,9690,2,6,6,2,16,10,6,24
Universitate,9690,3,4,5,5,17,20,-3,17
D Bucuresti,9690,4,4,4,6,18,21,-3,16
Concordia Ch,9690,5,4,2,8,18,21,-3,14
FC Botosani,9690,6,3,4,7,6,15,-9,13
FCSB,9691,1,7,6,1,26,15,11,27
CFR Cluj,9691,2,5,7,2,14,10,4,22
Universitate,9691,3,5,5,4,20,20,0,20
D Bucuresti,9691,4,5,4,5,21,21,0,19
FC Botosani,9691,5,3,4,7,7,16,-9,13
Concordia Ch,9691,6,3,2,9,19,25,-6,11
FCSB,9692,1,7,7,0,24,11,13,28
CFR Cluj,9692,2,5,8,1,15,9,6,23
FC Botosani,9692,3,4,5,5,9,15,-6,17
Universitate,9692,4,3,7,4,15,19,-4,16
D Bucuresti,9692,5,3,6,5,18,20,-2,15
Concordia Ch,9692,6,2,3,9,18,25,-7,9
FCSB,9693,1,9,5,0,27,10,17,32
CFR Cluj,9693,2,6,6,2,15,9,6,24
D Bucuresti,9693,3,4,5,5,18,19,-1,17
Universitate,9693,4,3,5,6,14,22,-8,14
FC Botosani,9693,5,3,5,6,7,16,-9,14
Concordia Ch,9693,6,3,2,9,18,23,-5,11
FCSB,9694,1,7,7,0,24,11,13,28
CFR Cluj,9694,2,6,7,1,17,8,9,25
D Bucuresti,9694,3,4,4,6,18,19,-1,16
FC Botosani,9694,4,4,4,6,6,14,-8,16
Universitate,9694,5,3,6,5,14,21,-7,15
Concordia Ch,9694,6,3,2,9,16,22,-6,11
FCSB,9695,1,9,5,0,26,10,16,32
CFR Cluj,9695,2,6,6,2,14,8,6,24
FC Botosani,9695,3,5,4,5,10,15,-5,19
Universitate,9695,4,3,5,6,14,21,-7,14
D Bucuresti,9695,5,3,4,7,19,24,-5,13
Concordia Ch,9695,6,3,2,9,19,24,-5,11
FCSB,9696,1,8,5,1,28,15,13,29
CFR Cluj,9696,2,5,7,2,14,11,3,22
Universitate,9696,3,4,6,4,18,19,-1,18
D Bucuresti,9696,4,4,5,5,17,18,-1,17
FC Botosani,9696,5,3,5,6,6,15,-9,14
Concordia Ch,9696,6,3,2,9,18,23,-5,11
CFR Cluj,9697,1,7,6,1,16,8,8,27
FCSB,9697,2,7,5,2,23,12,11,26
D Bucuresti,9697,3,4,5,5,17,18,-1,17
Universitate,9697,4,4,5,5,16,20,-4,17
FC Botosani,9697,5,3,4,7,6,15,-9,13
Concordia Ch,9697,6,3,3,8,17,22,-5,12
FCSB,9698,1,8,5,1,24,13,11,29
CFR Cluj,9698,2,6,6,2,16,10,6,24
D Bucuresti,9698,3,5,4,5,20,19,1,19
Universitate,9698,4,4,5,5,19,21,-2,17
FC Botosani,9698,5,3,5,6,5,13,-8,14
Concordia Ch,9698,6,2,3,9,16,24,-8,9
FCSB,9699,1,8,5,1,25,11,14,29
CFR Cluj,9699,2,6,6,2,15,10,5,24
Universitate,9699,3,4,5,5,16,20,-4,17
D Bucuresti,9699,4,4,4,6,18,22,-4,16
FC Botosani,9699,5,3,5,6,7,15,-8,14
Concordia Ch,9699,6,3,3,8,21,24,-3,12
FCSB,9700,1,7,7,0,23,10,13,28
CFR Cluj,9700,2,6,7,1,14,7,7,25
FC Botosani,9700,3,4,5,5,9,15,-6,17
Universitate,9700,4,3,6,5,14,19,-5,15
D Bucuresti,9700,5,3,5,6,18,21,-3,14
Concordia Ch,9700,6,3,2,9,17,23,-6,11
FCSB,9701,1,7,5,2,23,13,10,26
CFR Cluj,9701,2,6,7,1,14,7,7,25
Universitate,9701,3,4,6,4,16,18,-2,18
D Bucuresti,9701,4,3,6,5,16,18,-2,15
FC Botosani,9701,5,3,5,6,5,16,-11,14
Concordia Ch,9701,6,3,3,8,19,21,-2,12
FCSB,9702,1,8,5,1,26,13,13,29
CFR Cluj,9702,2,6,6,2,16,10,6,24
D Bucuresti,9702,3,5,4,5,20,19,1,19
Universitate,9702,4,4,5,5,15,19,-4,17
FC Botosani,9702,5,3,5,6,7,16,-9,14
Concordia Ch,9702,6,2,3,9,18,25,-7,9
FCSB,9703,1,8,6,0,24,10,14,30
CFR Cluj,9703,2,5,8,1,15,9,6,23
D Bucuresti,9703,3,4,5,5,19,20,-1,17
Universitate,9703,4,3,6,5,16,21,-5,15
FC Botosani,9703,5,3,5,6,5,13,-8,14
Concordia Ch,9703,6,2,4,8,17,23,-6,10
FCSB,9704,1,7,7,0,25,12,13,28
CFR Cluj,9704,2,5,7,2,13,8,5,22
Universitate,9704,3,4,6,4,17,20,-3,18
FC Botosani,9704,4,4,5,5,8,14,-6,17
D Bucuresti,9704,5,3,5,6,18,21,-3,14
Concordia Ch,9704,6,3,2,9,18,24,-6,11
FCSB,9705,1,8,6,0,26,12,14,30
CFR Cluj,9705,2,6,6,2,16,9,7,24
D Bucuresti,9705,3,4,5,5,19,19,0,17
FC Botosani,9705,4,4,4,6,6,14,-8,16
Universitate,9705,5,3,6,5,15,21,-6,15
Concordia Ch,9705,6,2,3,9,16,23,-7,9
FCSB,9706,1,7,6,1,23,12,11,27
CFR Cluj,9706,2,6,7,1,17,7,10,25
Universitate,9706,3,4,5,5,16,22,-6,17
D Bucuresti,9706,4,4,4,6,21,21,0,16
Concordia Ch,9706,5,4,2,8,19,21,-2,14
FC Botosani,9706,6,3,4,7,6,19,-13,13
FCSB,9707,1,8,5,1,25,11,14,29
CFR Cluj,9707,2,7,6,1,16,8,8,27
D Bucuresti,9707,3,4,5,5,20,20,0,17
Universitate,9707,4,3,5,6,15,22,-7,14
FC Botosani,9707,5,3,5,6,6,15,-9,14
Concordia Ch,9707,6,2,4,8,16,22,-6,10
FCSB,9708,1,7,6,1,25,13,12,27
CFR Cluj,9708,2,7,6,1,16,8,8,27
D Bucuresti,9708,3,4,5,5,20,19,1,17
FC Botosani,9708,4,4,5,5,9,14,-5,17
Universitate,9708,5,3,6,5,15,20,-5,15
Concordia Ch,9708,6,2,2,10,16,27,-11,8
FCSB,9709,1,9,5,0,27,11,16,32
CFR Cluj,9709,2,5,7,2,16,12,4,22
FC Botosani,9709,3,4,5,5,9,13,-4,17
D Bucuresti,9709,4,3,6,5,19,21,-2,15
Universitate,9709,5,3,6,5,16,21,-5,15
Concordia Ch,9709,6,2,3,9,17,26,-9,9
FCSB,9710,1,8,5,1,24,11,13,29
CFR Cluj,9710,2,6,6,2,16,8,8,24
D Bucuresti,9710,3,5,4,5,20,19,1,19
Universitate,9710,4,4,5,5,15,21,-6,17
FC Botosani,9710,5,4,4,6,11,15,-4,16
Concordia Ch,9710,6,2,2,10,16,28,-12,8
FCSB,9711,1,8,5,1,24,11,13,29
CFR Cluj,9711,2,7,6,1,15,7,8,27
D Bucuresti,9711,3,5,4,5,20,20,0,19
Universitate,9711,4,3,5,6,14,20,-6,14
FC Botosani,9711,5,3,5,6,5,13,-8,14
Concordia Ch,9711,6,2,3,9,17,24,-7,9
FCSB,9712,1,8,6,0,24,10,14,30
CFR Cluj,9712,2,5,8,1,13,7,6,23
D Bucuresti,9712,3,4,5,5,20,20,0,17
FC Botosani,9712,4,4,4,6,7,15,-8,16
Universitate,9712,5,3,6,5,14,19,-5,15
Concordia Ch,9712,6,2,3,9,18,25,-7,9
FCSB,9713,1,8,5,1,26,13,13,29
CFR Cluj,9713,2,6,6,2,15,9,6,24
Universitate,9713,3,4,5,5,17,21,-4,17
FC Botosani,9713,4,4,4,6,8,16,-8,16
Concordia Ch,9713,5,4,2,8,19,21,-2,14
D Bucuresti,9713,6,3,4,7,17,22,-5,13
FCSB,9714,1,9,5,0,26,10,16,32
CFR Cluj,9714,2,5,7,2,13,8,5,22
D Bucuresti,9714,3,5,4,5,20,19,1,19
Universitate,9714,4,3,6,5,14,20,-6,15
FC Botosani,9714,5,3,4,7,5,18,-13,13
Concordia Ch,9714,6,3,2,9,20,23,-3,11
FCSB,9715,1,8,6,0,27,13,14,30
CFR Cluj,9715,2,6,6,2,19,11,8,24
Universitate,9715,3,3,6,5,16,23,-7,15
FC Botosani,9715,4,3,6,5,7,14,-7,15
D Bucuresti,9715,5,3,5,6,17,20,-3,14
Concordia Ch,9715,6,3,3,8,17,22,-5,12
CFR Cluj,9716,1,7,6,1,15,7,8,27
FCSB,9716,2,7,5,2,23,15,8,26
Universitate,9716,3,4,5,5,18,19,-1,17
D Bucuresti,9716,4,4,4,6,18,20,-2,16
FC Botosani,9716,5,4,4,6,7,14,-7,16
Concordia Ch,9716,6,3,2,9,17,23,-6,11
FCSB,9717,1,7,7,0,25,12,13,28
CFR Cluj,9717,2,6,7,1,19,8,11,25
FC Botosani,9717,3,4,5,5,7,13,-6,17
D Bucuresti,9717,4,3,6,5,18,20,-2,15
Universitate,9717,5,3,6,5,15,24,-9,15
Concordia Ch,9717,6,2,3,9,18,25,-7,9
FCSB,9718,1,8,5,1,25,13,12,29
CFR Cluj,9718,2,7,6,1,17,7,10,27
FC Botosani,9718,3,4,5,5,7,12,-5,17
D Bucuresti,9718,4,3,5,6,16,20,-4,14
Universitate,9718,5,3,5,6,15,22,-7,14
Concordia Ch,9718,6,3,2,9,17,23,-6,11
FCSB,9719,1,9,5,0,29,10,19,32
CFR Cluj,9719,2,6,6,2,14,11,3,24
D Bucuresti,9719,3,5,4,5,21,18,3,19
FC Botosani,9719,4,4,4,6,7,17,-10,16
Universitate,9719,5,3,5,6,14,21,-7,14
Concordia Ch,9719,6,2,2,10,16,24,-8,8
FCSB,9720,1,8,6,0,28,12,16,30
CFR Cluj,9720,2,5,7,2,14,11,3,22
FC Botosani,9720,3,4,5,5,9,15,-6,17
Universitate,9720,4,3,7,4,17,21,-4,16
D Bucuresti,9720,5,3,4,7,18,22,-4,13
Concordia Ch,9720,6,3,3,8,19,24,-5,12
CFR Cluj,9721,1,7,6,1,16,8,8,27
FCSB,9721,2,7,5,2,23,14,9,26
D Bucuresti,9721,3,4,5,5,19,20,-1,17
Universitate,9721,4,4,5,5,18,20,-2,17
FC Botosani,9721,5,4,4,6,9,14,-5,16
Concordia Ch,9721,6,2,3,9,16,25,-9,9
FCSB,9722,1,7,5,2,23,13,10,26
CFR Cluj,9722,2,6,7,1,16,8,8,25
Universitate,9722,3,4,6,4,16,19,-3,18
D Bucuresti,9722,4,4,4,6,17,19,-2,16
Concordia Ch,9722,5,4,2,8,17,21,-4,14
FC Botosani,9722,6,3,4,7,5,14,-9,13
FCSB,9723,1,8,5,1,27,13,14,29
CFR Cluj,9723,2,5,7,2,14,10,4,22
D Bucuresti,9723,3,5,4,5,20,19,1,19
Universitate,9723,4,4,6,4,16,19,-3,18
FC Botosani,9723,5,3,4,7,6,15,-9,13
Concordia Ch,9723,6,3,2,9,18,25,-7,11
FCSB,9724,1,9,5,0,26,11,15,32
CFR Cluj,9724,2,6,6,2,15,8,7,24
FC Botosani,9724,3,4,5,5,9,14,-5,17
D Bucuresti,9724,4,4,4,6,19,21,-2,16
Universitate,9724,5,3,5,6,15,22,-7,14
Concordia Ch,9724,6,2,3,9,18,26,-8,9
FCSB,9725,1,9,5,0,29,12,17,32
CFR Cluj,9725,2,5,6,3,13,11,2,21
Universitate,9725,3,4,5,5,17,21,-4,17
FC Botosani,9725,4,4,5,5,9,15,-6,17
D Bucuresti,9725,5,3,5,6,16,19,-3,14
Concordia Ch,9725,6,2,4,8,18,24,-6,10
FCSB,9726,1,9,5,0,27,10,17,32
CFR Cluj,9726,2,6,6,2,16,9,7,24
FC Botosani,9726,3,3,6,5,8,15,-7,15
D Bucuresti,9726,4,3,5,6,18,21,-3,14
Universitate,9726,5,3,5,6,14,23,-9,14
Concordia Ch,9726,6,3,3,8,19,24,-5,12
FCSB,9727,1,8,5,1,27,12,15,29
CFR Cluj,9727,2,6,6,2,15,9,6,24
Universitate,9727,3,4,5,5,15,21,-6,17
FC Botosani,9727,4,4,5,5,6,12,-6,17
D Bucuresti,9727,5,3,5,6,17,20,-3,14
Concordia Ch,9727,6,3,2,9,17,23,-6,11
FCSB,9728,1,8,6,0,28,12,16,30
CFR Cluj,9728,2,5,6,3,15,13,2,21
D Bucuresti,9728,3,5,4,5,20,18,2,19
Universitate,9728,4,4,6,4,19,22,-3,18
FC Botosani,9728,5,3,5,6,5,15,-10,14
Concordia Ch,9728,6,2,3,9,15,22,-7,9
FCSB,9729,1,8,5,1,24,11,13,29
CFR Cluj,9729,2,5,7,2,14,9,5,22
Universitate,9729,3,4,6,4,16,19,-3,18
D Bucuresti,9729,4,4,5,5,18,19,-1,17
FC Botosani,9729,5,4,5,5,9,14,-5,17
Concordia Ch,9729,6,2,2,10,16,25,-9,8
FCSB,9730,1,8,5,1,24,14,10,29
CFR Cluj,9730,2,6,6,2,15,8,7,24
D Bucuresti,9730,3,4,5,5,20,20,0,17
Universitate,9730,4,4,5,5,18,20,-2,17
FC Botosani,9730,5,4,4,6,6,14,-8,16
Concordia Ch,9730,6,2,3,9,17,24,-7,9
FCSB,9731,1,8,5,1,28,13,15,29
CFR Cluj,9731,2,6,7,1,16,9,7,25
FC Botosani,9731,3,5,4,5,8,13,-5,19
Universitate,9731,4,3,6,5,14,21,-7,15
D Bucuresti,9731,5,3,4,7,17,21,-4,13
Concordia Ch,9731,6,3,2,9,16,22,-6,11
FCSB,9732,1,8,6,0,26,11,15,30
CFR Cluj,9732,2,6,7,1,16,9,7,25
FC Botosani,9732,3,4,4,6,8,15,-7,16
Concordia Ch,9732,4,4,2,8,20,23,-3,14
Universitate,9732,5,3,5,6,15,22,-7,14
D Bucuresti,9732,6,3,4,7,16,21,-5,13
FCSB,9733,1,8,6,0,28,13,15,30
CFR Cluj,9733,2,6,7,1,18,9,9,25
FC Botosani,9733,3,4,4,6,7,14,-7,16
D Bucuresti,9733,4,3,5,6,17,20,-3,14
Universitate,9733,5,3,5,6,15,24,-9,14
Concordia Ch,9733,6,3,3,8,16,21,-5,12
FCSB,9734,1,8,5,1,24,12,12,29
CFR Cluj,9734,2,5,6,3,14,10,4,21
Universitate,9734,3,5,5,4,18,19,-1,20
D Bucuresti,9734,4,4,4,6,18,20,-2,16
FC Botosani,9734,5,3,5,6,6,15,-9,14
Concordia Ch,9734,6,3,3,8,18,22,-4,12
FCSB,9735,1,8,6,0,28,12,16,30
CFR Cluj,9735,2,5,8,1,14,8,6,23
Universitate,9735,3,3,6,5,15,22,-7,15
D Bucuresti,9735,4,3,5,6,19,22,-3,14
Concordia Ch,9735,5,4,2,8,19,23,-4,14
FC Botosani,9735,6,3,5,6,6,14,-8,14
FCSB,9736,1,8,5,1,27,14,13,29
CFR Cluj,9736,2,6,7,1,17,10,7,25
D Bucuresti,9736,3,3,6,5,21,23,-2,15
Universitate,9736,4,3,6,5,16,21,-5,15
FC Botosani,9736,5,3,5,6,8,16,-8,14
Concordia Ch,9736,6,3,3,8,20,25,-5,12
FCSB,9737,1,8,6,0,24,10,14,30
CFR Cluj,9737,2,5,7,2,13,8,5,22
Universitate,9737,3,4,5,5,15,19,-4,17
D Bucuresti,9737,4,3,5,6,18,21,-3,14
Concordia Ch,9737,5,4,2,8,19,23,-4,14
FC Botosani,9737,6,3,5,6,9,17,-8,14
FCSB,9738,1,8,5,1,26,15,11,29
CFR Cluj,9738,2,7,6,1,19,8,11,27
FC Botosani,9738,3,5,4,5,8,12,-4,19
Universitate,9738,4,3,5,6,15,22,-7,14
D Bucuresti,9738,5,3,4,7,17,23,-6,13
Concordia Ch,9738,6,3,2,9,18,23,-5,11
FCSB,9739,1,7,5,2,24,15,9,26
CFR Cluj,9739,2,6,6,2,17,10,7,24
Universitate,9739,3,5,5,4,19,20,-1,20
D Bucuresti,9739,4,4,4,6,17,19,-2,16
Concordia Ch,9739,5,4,2,8,19,23,-4,14
FC Botosani,9739,6,3,4,7,7,16,-9,13
FCSB,9740,1,8,5,1,26,15,11,29
CFR Cluj,9740,2,5,7,2,14,10,4,22
Universitate,9740,3,4,6,4,18,18,0,18
D Bucuresti,9740,4,3,6,5,17,19,-2,15
FC Botosani,9740,5,3,5,6,6,14,-8,14
Concordia Ch,9740,6,3,3,8,18,23,-5,12
FCSB,9741,1,9,5,0,27,11,16,32
CFR Cluj,9741,2,5,6,3,14,11,3,21
D Bucuresti,9741,3,4,5,5,19,20,-1,17
Universitate,9741,4,4,5,5,15,19,-4,17
FC Botosani,9741,5,3,5,6,7,15,-8,14
Concordia Ch,9741,6,3,2,9,16,22,-6,11
FCSB,9742,1,7,7,0,24,11,13,28
CFR Cluj,9742,2,6,7,1,16,8,8,25
D Bucuresti,9742,3,4,5,5,20,19,1,17
FC Botosani,9742,4,4,5,5,8,14,-6,17
Universitate,9742,5,3,6,5,14,20,-6,15
Concordia Ch,9742,6,2,2,10,16,26,-10,8
FCSB,9743,1,7,7,0,23,10,13,28
CFR Cluj,9743,2,5,7,2,14,9,5,22
Universitate,9743,3,4,6,4,16,19,-3,18
D Bucuresti,9743,4,4,4,6,18,22,-4,16
FC Botosani,9743,5,4,4,6,7,14,-7,16
Concordia Ch,9743,6,3,2,9,20,24,-4,11
FCSB,9744,1,9,5,0,26,11,15,32
CFR Cluj,9744,2,5,7,2,14,9,5,22
FC Botosani,9744,3,4,4,6,6,15,-9,16
Universitate,9744,4,3,6,5,16,21,-5,15
D Bucuresti,9744,5,3,5,6,16,19,-3,14
Concordia Ch,9744,6,3,3,8,18,21,-3,12
FCSB,9745,1,8,5,1,24,11,13,29
CFR Cluj,9745,2,6,6,2,14,8,6,24
Universitate,9745,3,4,5,5,15,19,-4,17
D Bucuresti,9745,4,4,4,6,19,20,-1,16
FC Botosani,9745,5,3,5,6,6,15,-9,14
Concordia Ch,9745,6,3,3,8,18,23,-5,12
FCSB,9746,1,8,5,1,26,13,13,29
CFR Cluj,9746,2,6,7,1,17,9,8,25
FC Botosani,9746,3,4,5,5,6,12,-6,17
Universitate,9746,4,3,6,5,17,23,-6,15
D Bucuresti,9746,5,3,5,6,16,19,-3,14
Concordia Ch,9746,6,3,2,9,16,22,-6,11
FCSB,9747,1,8,5,1,25,12,13,29
CFR Cluj,9747,2,5,7,2,14,10,4,22
FC Botosani,9747,3,5,4,5,9,13,-4,19
Universitate,9747,4,4,6,4,17,19,-2,18
D Bucuresti,9747,5,4,4,6,17,19,-2,16
Concordia Ch,9747,6,2,2,10,16,25,-9,8
FCSB,9748,1,7,5,2,24,13,11,26
CFR Cluj,9748,2,6,6,2,14,9,5,24
Universitate,9748,3,5,5,4,18,19,-1,20
D Bucuresti,9748,4,5,4,5,21,19,2,19
FC Botosani,9748,5,3,5,6,6,16,-10,14
Concordia Ch,9748,6,2,3,9,17,24,-7,9
FCSB,9749,1,7,5,2,24,14,10,26
CFR Cluj,9749,2,6,6,2,16,9,7,24
Universitate,9749,3,5,5,4,16,18,-2,20
FC Botosani,9749,4,4,5,5,8,13,-5,17
D Bucuresti,9749,5,3,5,6,18,22,-4,14
Concordia Ch,9749,6,2,4,8,16,22,-6,10
FCSB,9750,1,8,6,0,25,11,14,30
CFR Cluj,9750,2,5,8,1,15,9,6,23
FC Botosani,9750,3,4,4,6,7,15,-8,16
Universitate,9750,4,3,6,5,15,20,-5,15
D Bucuresti,9750,5,3,5,6,17,20,-3,14
Concordia Ch,9750,6,3,3,8,19,23,-4,12
FCSB,9751,1,8,6,0,25,11,14,30
CFR Cluj,9751,2,5,7,2,14,9,5,22
D Bucuresti,9751,3,4,5,5,19,19,0,17
Universitate,9751,4,4,5,5,17,21,-4,17
FC Botosani,9751,5,4,4,6,8,15,-7,16
Concordia Ch,9751,6,2,3,9,15,23,-8,9
FCSB,9752,1,7,7,0,25,12,13,28
CFR Cluj,9752,2,5,8,1,15,9,6,23
D Bucuresti,9752,3,4,4,6,18,22,-4,16
Universitate,9752,4,3,7,4,14,18,-4,16
FC Botosani,9752,5,3,5,6,6,14,-8,14
Concordia Ch,9752,6,3,3,8,18,21,-3,12
CFR Cluj,9753,1,7,6,1,18,9,9,27
FCSB,9753,2,7,5,2,24,14,10,26
Universitate,9753,3,4,5,5,18,22,-4,17
D Bucuresti,9753,4,4,4,6,19,21,-2,16
FC Botosani,9753,5,4,4,6,8,15,-7,16
Concordia Ch,9753,6,3,2,9,17,23,-6,11
FCSB,9754,1,8,6,0,25,11,14,30
CFR Cluj,9754,2,6,6,2,15,9,6,24
D Bucuresti,9754,3,5,4,5,22,18,4,19
Universitate,9754,4,3,6,5,16,21,-5,15
FC Botosani,9754,5,3,4,7,7,20,-13,13
Concordia Ch,9754,6,3,2,9,19,25,-6,11
FCSB,9755,1,8,5,1,24,12,12,29
CFR Cluj,9755,2,5,7,2,15,10,5,22
Universitate,9755,3,4,6,4,18,20,-2,18
FC Botosani,9755,4,3,6,5,8,15,-7,15
D Bucuresti,9755,5,3,5,6,18,21,-3,14
Concordia Ch,9755,6,3,3,8,19,24,-5,12
FCSB,9756,1,7,7,0,27,14,13,28
CFR Cluj,9756,2,5,8,1,15,9,6,23
D Bucuresti,9756,3,4,4,6,18,20,-2,16
Universitate,9756,4,3,7,4,16,20,-4,16
FC Botosani,9756,5,3,5,6,6,15,-9,14
Concordia Ch,9756,6,3,3,8,18,22,-4,12
FCSB,9757,1,8,5,1,26,13,13,29
CFR Cluj,9757,2,7,6,1,20,9,11,27
FC Botosani,9757,3,3,6,5,7,14,-7,15
D Bucuresti,9757,4,3,5,6,17,22,-5,14
Universitate,9757,5,3,5,6,14,23,-9,14
Concordia Ch,9757,6,3,3,8,19,22,-3,12
FCSB,9758,1,7,7,0,24,11,13,28
CFR Cluj,9758,2,6,7,1,17,9,8,25
Universitate,9758,3,3,6,5,15,21,-6,15
D Bucuresti,9758,4,3,5,6,16,19,-3,14
Concordia Ch,9758,5,4,2,8,17,21,-4,14
FC Botosani,9758,6,3,5,6,5,13,-8,14
FCSB,9759,1,7,7,0,27,14,13,28
CFR Cluj,9759,2,5,7,2,17,12,5,22
Universitate,9759,3,4,6,4,17,20,-3,18
FC Botosani,9759,4,4,5,5,9,13,-4,17
D Bucuresti,9759,5,3,4,7,17,24,-7,13
Concordia Ch,9759,6,3,3,8,17,21,-4,12
FCSB,9760,1,8,6,0,25,11,14,30
CFR Cluj,9760,2,5,7,2,15,10,5,22
D Bucuresti,9760,3,4,5,5,19,20,-1,17
FC Botosani,9760,4,4,5,5,8,14,-6,17
Universitate,9760,5,3,7,4,17,21,-4,16
Concordia Ch,9760,6,2,2,10,15,23,-8,8
FCSB,9761,1,7,6,1,23,11,12,27
CFR Cluj,9761,2,5,7,2,14,9,5,22
Universitate,9761,3,5,5,4,17,19,-2,20
FC Botosani,9761,4,5,4,5,7,12,-5,19
D Bucuresti,9761,5,4,4,6,18,20,-2,16
Concordia Ch,9761,6,2,2,10,16,24,-8,8
FCSB,9762,1,8,6,0,27,13,14,30
CFR Cluj,9762,2,5,8,1,15,9,6,23
D Bucuresti,9762,3,3,6,5,17,19,-2,15
Universitate,9762,4,3,6,5,17,22,-5,15
FC Botosani,9762,5,3,6,5,5,12,-7,15
Concordia Ch,9762,6,2,4,8,16,22,-6,10
FCSB,9763,1,8,6,0,26,12,14,30
CFR Cluj,9763,2,5,6,3,13,9,4,21
Universitate,9763,3,4,6,4,17,20,-3,18
FC Botosani,9763,4,4,5,5,7,12,-5,17
D Bucuresti,9763,5,3,5,6,17,21,-4,14
Concordia Ch,9763,6,2,4,8,16,22,-6,10
CFR Cluj,9764,1,7,6,1,16,8,8,27
FCSB,9764,2,7,5,2,24,13,11,26
D Bucuresti,9764,3,4,5,5,19,20,-1,17
Universitate,9764,4,4,5,5,17,21,-4,17
FC Botosani,9764,5,3,4,7,6,15,-9,13
Concordia Ch,9764,6,3,3,8,19,24,-5,12
FCSB,9765,1,7,6,1,23,12,11,27
CFR Cluj,9765,2,6,6,2,16,9,7,24
D Bucuresti,9765,3,5,4,5,19,19,0,19
Universitate,9765,4,4,6,4,16,19,-3,18
FC Botosani,9765,5,4,4,6,7,14,-7,16
Concordia Ch,9765,6,2,2,10,17,25,-8,8
FCSB,9766,1,8,5,1,28,13,15,29
CFR Cluj,9766,2,6,6,2,15,12,3,24
D Bucuresti,9766,3,4,5,5,18,19,-1,17
Universitate,9766,4,4,5,5,16,19,-3,17
FC Botosani,9766,5,3,4,7,6,16,-10,13
Concordia Ch,9766,6,3,3,8,17,21,-4,12
FCSB,9767,1,8,6,0,25,11,14,30
CFR Cluj,9767,2,6,7,1,16,8,8,25
D Bucuresti,9767,3,4,4,6,17,19,-2,16
FC Botosani,9767,4,4,4,6,8,13,-5,16
Universitate,9767,5,3,5,6,16,23,-7,14
Concordia Ch,9767,6,3,2,9,16,24,-8,11
FCSB,9768,1,8,6,0,25,11,14,30
CFR Cluj,9768,2,6,6,2,15,8,7,24
D Bucuresti,9768,3,4,5,5,17,18,-1,17
Universitate,9768,4,3,6,5,15,21,-6,15
FC Botosani,9768,5,3,5,6,6,14,-8,14
Concordia Ch,9768,6,3,2,9,17,23,-6,11
FCSB,9769,1,9,5,0,28,11,17,32
CFR Cluj,9769,2,6,6,2,16,9,7,24
D Bucuresti,9769,3,4,4,6,18,21,-3,16
FC Botosani,9769,4,4,4,6,9,14,-5,16
Universitate,9769,5,3,5,6,15,24,-9,14
Concordia Ch,9769,6,3,2,9,17,24,-7,11
FCSB,9770,1,8,6,0,25,11,14,30
CFR Cluj,9770,2,5,7,2,14,9,5,22
Universitate,9770,3,4,5,5,15,19,-4,17
FC Botosani,9770,4,4,5,5,8,13,-5,17
D Bucuresti,9770,5,4,4,6,18,20,-2,16
Concordia Ch,9770,6,2,3,9,16,24,-8,9
FCSB,9771,1,8,6,0,25,11,14,30
CFR Cluj,9771,2,5,8,1,15,9,6,23
D Bucuresti,9771,3,3,6,5,17,19,-2,15
Universitate,9771,4,3,6,5,15,20,-5,15
FC Botosani,9771,5,3,6,5,5,12,-7,15
Concordia Ch,9771,6,2,4,8,16,22,-6,10
FCSB,9772,1,8,6,0,24,10,14,30
CFR Cluj,9772,2,5,7,2,14,9,5,22
FC Botosani,9772,3,5,4,5,9,13,-4,19
D Bucuresti,9772,4,4,4,6,18,20,-2,16
Universitate,9772,5,3,7,4,15,19,-4,16
Concordia Ch,9772,6,2,2,10,15,24,-9,8
FCSB,9773,1,7,5,2,23,16,7,26
CFR Cluj,9773,2,6,7,1,18,9,9,25
Universitate,9773,3,4,6,4,19,20,-1,18
FC Botosani,9773,4,4,5,5,7,13,-6,17
D Bucuresti,9773,5,3,5,6,19,22,-3,14
Concordia Ch,9773,6,3,2,9,18,24,-6,11
FCSB,9774,1,9,5,0,26,11,15,32
CFR Cluj,9774,2,5,6,3,13,10,3,21
D Bucuresti,9774,3,4,5,5,20,20,0,17
Universitate,9774,4,4,5,5,17,20,-3,17
FC Botosani,9774,5,4,5,5,9,14,-5,17
Concordia Ch,9774,6,2,2,10,17,27,-10,8
FCSB,9775,1,7,6,1,23,11,12,27
CFR Cluj,9775,2,7,6,1,18,8,10,27
D Bucuresti,9775,3,4,5,5,19,19,0,17
FC Botosani,9775,4,4,5,5,9,14,-5,17
Universitate,9775,5,3,6,5,15,22,-7,15
Concordia Ch,9775,6,2,2,10,16,26,-10,8
FCSB,9776,1,8,5,1,25,12,13,29
CFR Cluj,9776,2,6,7,1,16,8,8,25
Universitate,9776,3,3,6,5,15,21,-6,15
Concordia Ch,9776,4,4,2,8,20,22,-2,14
D Bucuresti,9776,5,3,5,6,16,21,-5,14
FC Botosani,9776,6,3,5,6,6,14,-8,14
FCSB,9777,1,8,6,0,26,11,15,30
CFR Cluj,9777,2,6,6,2,17,10,7,24
FC Botosani,9777,3,4,4,6,7,14,-7,16
Universitate,9777,4,3,6,5,14,21,-7,15
Concordia Ch,9777,5,4,2,8,20,23,-3,14
D Bucuresti,9777,6,3,4,7,17,22,-5,13
FCSB,9778,1,8,6,0,26,11,15,30
CFR Cluj,9778,2,6,6,2,15,10,5,24
FC Botosani,9778,3,4,4,6,6,13,-7,16
Universitate,9778,4,3,6,5,16,21,-5,15
Concordia Ch,9778,5,4,2,8,18,21,-3,14
D Bucuresti,9778,6,3,4,7,16,21,-5,13
FCSB,9779,1,9,5,0,28,10,18,32
CFR Cluj,9779,2,6,6,2,15,12,3,24
D Bucuresti,9779,3,4,5,5,21,21,0,17
FC Botosani,9779,4,4,4,6,8,16,-8,16
Universitate,9779,5,3,5,6,15,21,-6,14
Concordia Ch,9779,6,2,3,9,18,25,-7,9
FCSB,9780,1,7,6,1,24,14,10,27
CFR Cluj,9780,2,6,7,1,16,8,8,25
Universitate,9780,3,4,5,5,17,20,-3,17
FC Botosani,9780,4,4,4,6,6,13,-7,16
D Bucuresti,9780,5,3,5,6,18,21,-3,14
Concordia Ch,9780,6,3,3,8,18,23,-5,12
FCSB,9781,1,8,5,1,24,13,11,29
CFR Cluj,9781,2,5,7,2,14,9,5,22
Universitate,9781,3,4,6,4,18,19,-1,18
D Bucuresti,9781,4,4,4,6,19,21,-2,16
FC Botosani,9781,5,3,5,6,5,13,-8,14
Concordia Ch,9781,6,3,3,8,18,23,-5,12
FCSB,9782,1,7,6,1,23,11,12,27
CFR Cluj,9782,2,5,7,2,13,8,5,22
Universitate,9782,3,5,5,4,16,18,-2,20
D Bucuresti,9782,4,4,5,5,17,18,-1,17
FC Botosani,9782,5,3,5,6,6,15,-9,14
Concordia Ch,9782,6,3,2,9,18,23,-5,11
FCSB,9783,1,7,7,0,24,11,13,28
CFR Cluj,9783,2,5,8,1,13,7,6,23
D Bucuresti,9783,3,4,4,6,19,20,-1,16
Universitate,9783,4,3,7,4,15,19,-4,16
FC Botosani,9783,5,3,5,6,5,15,-10,14
Concordia Ch,9783,6,3,3,8,17,21,-4,12
FCSB,9784,1,7,6,1,26,14,12,27
CFR Cluj,9784,2,5,7,2,15,11,4,22
Universitate,9784,3,5,5,4,20,21,-1,20
D Bucuresti,9784,4,5,4,5,22,18,4,19
FC Botosani,9784,5,3,5,6,6,15,-9,14
Concordia Ch,9784,6,2,3,9,16,26,-10,9
FCSB,9785,1,8,6,0,24,10,14,30
CFR Cluj,9785,2,5,7,2,13,8,5,22
Universitate,9785,3,4,5,5,15,19,-4,17
FC Botosani,9785,4,3,6,5,5,12,-7,15
D Bucuresti,9785,5,3,5,6,17,20,-3,14
Concordia Ch,9785,6,3,3,8,17,22,-5,12
FCSB,9786,1,8,5,1,26,12,14,29
CFR Cluj,9786,2,6,6,2,15,9,6,24
D Bucuresti,9786,3,4,5,5,20,20,0,17
Universitate,9786,4,4,5,5,16,21,-5,17
FC Botosani,9786,5,3,5,6,7,16,-9,14
Concordia Ch,9786,6,3,2,9,17,23,-6,11
FCSB,9787,1,9,5,0,26,10,16,32
CFR Cluj,9787,2,5,6,3,14,11,3,21
Universitate,9787,3,4,5,5,16,20,-4,17
FC Botosani,9787,4,3,6,5,6,13,-7,15
D Bucuresti,9787,5,3,5,6,19,26,-7,14
Concordia Ch,9787,6,3,3,8,22,23,-1,12
FCSB,9788,1,8,6,0,26,10,16,30
CFR Cluj,9788,2,5,6,3,13,13,0,21
D Bucuresti,9788,3,5,4,5,20,19,1,19
Universitate,9788,4,4,6,4,17,18,-1,18
FC Botosani,9788,5,3,5,6,6,14,-8,14
Concordia Ch,9788,6,2,3,9,15,23,-8,9
FCSB,9789,1,8,6,0,27,13,14,30
CFR Cluj,9789,2,5,7,2,15,10,5,22
FC Botosani,9789,3,5,4,5,9,13,-4,19
Universitate,9789,4,3,7,4,17,21,-4,16
D Bucuresti,9789,5,3,4,7,17,22,-5,13
Concordia Ch,9789,6,3,2,9,16,22,-6,11
FCSB,9790,1,8,5,1,25,13,12,29
CFR Cluj,9790,2,6,6,2,16,8,8,24
D Bucuresti,9790,3,5,4,5,22,19,3,19
Universitate,9790,4,4,5,5,17,22,-5,17
FC Botosani,9790,5,3,4,7,6,16,-10,13
Concordia Ch,9790,6,3,2,9,18,26,-8,11
FCSB,9791,1,7,6,1,28,16,12,27
CFR Cluj,9791,2,6,7,1,17,10,7,25
FC Botosani,9791,3,4,5,5,10,14,-4,17
Universitate,9791,4,3,7,4,16,20,-4,16
D Bucuresti,9791,5,3,6,5,20,22,-2,15
Concordia Ch,9791,6,2,3,9,19,28,-9,9
FCSB,9792,1,7,6,1,24,14,10,27
CFR Cluj,9792,2,5,8,1,16,10,6,23
Universitate,9792,3,4,6,4,19,20,-1,18
D Bucuresti,9792,4,4,5,5,20,19,1,17
FC Botosani,9792,5,3,6,5,6,13,-7,15
Concordia Ch,9792,6,2,3,9,15,24,-9,9
FCSB,9793,1,8,6,0,27,11,16,30
CFR Cluj,9793,2,5,6,3,13,12,1,21
Universitate,9793,3,4,6,4,17,19,-2,18
D Bucuresti,9793,4,4,5,5,18,19,-1,17
FC Botosani,9793,5,3,5,6,7,16,-9,14
Concordia Ch,9793,6,3,2,9,18,23,-5,11
FCSB,9794,1,8,5,1,26,12,14,29
CFR Cluj,9794,2,6,7,1,14,7,7,25
D Bucuresti,9794,3,4,4,6,18,20,-2,16
Universitate,9794,4,3,6,5,15,21,-6,15
FC Botosani,9794,5,3,5,6,6,14,-8,14
Concordia Ch,9794,6,3,3,8,16,21,-5,12
FCSB,9795,1,8,5,1,26,13,13,29
CFR Cluj,9795,2,6,6,2,16,10,6,24
Universitate,9795,3,4,5,5,17,21,-4,17
D Bucuresti,9795,4,4,4,6,18,20,-2,16
FC Botosani,9795,5,4,4,6,6,15,-9,16
Concordia Ch,9795,6,3,2,9,19,23,-4,11
FCSB,9796,1,7,7,0,24,11,13,28
CFR Cluj,9796,2,5,7,2,14,9,5,22
Universitate,9796,3,4,6,4,15,18,-3,18
D Bucuresti,9796,4,4,4,6,18,19,-1,16
FC Botosani,9796,5,3,5,6,6,15,-9,14
Concordia Ch,9796,6,3,3,8,17,22,-5,12
FCSB,9797,1,8,6,0,28,12,16,30
CFR Cluj,9797,2,6,7,1,17,10,7,25
D Bucuresti,9797,3,4,5,5,18,19,-1,17
FC Botosani,9797,4,4,5,5,10,13,-3,17
Universitate,9797,5,3,5,6,15,23,-8,14
Concordia Ch,9797,6,2,2,10,15,26,-11,8
FCSB,9798,1,9,5,0,26,11,15,32
CFR Cluj,9798,2,6,6,2,16,8,8,24
D Bucuresti,9798,3,4,4,6,18,21,-3,16
Concordia Ch,9798,4,4,2,8,19,22,-3,14
Universitate,9798,5,3,5,6,15,23,-8,14
FC Botosani,9798,6,3,4,7,7,16,-9,13
CFR Cluj,9799,1,7,6,1,17,8,9,27
FCSB,9799,2,7,5,2,25,16,9,26
Universitate,9799,3,4,5,5,17,20,-3,17
FC Botosani,9799,4,4,5,5,10,14,-4,17
D Bucuresti,9799,5,3,5,6,18,22,-4,14
Concordia Ch,9799,6,3,2,9,19,26,-7,11
FCSB,9800,1,8,6,0,26,12,14,30
CFR Cluj,9800,2,5,7,2,14,9,5,22
D Bucuresti,9800,3,5,4,5,19,19,0,19
Universitate,9800,4,3,7,4,15,19,-4,16
FC Botosani,9800,5,3,5,6,6,14,-8,14
Concordia Ch,9800,6,2,3,9,15,22,-7,9
FCSB,9801,1,8,6,0,26,12,14,30
CFR Cluj,9801,2,5,8,1,15,9,6,23
FC Botosani,9801,3,5,4,5,9,14,-5,19
Universitate,9801,4,3,6,5,16,21,-5,15
D Bucuresti,9801,5,3,4,7,17,24,-7,13
Concordia Ch,9801,6,3,2,9,20,23,-3,11
FCSB,9802,1,8,5,1,25,12,13,29
CFR Cluj,9802,2,5,6,3,16,12,4,21
Universitate,9802,3,5,5,4,18,20,-2,20
D Bucuresti,9802,4,4,4,6,21,20,1,16
FC Botosani,9802,5,4,4,6,7,17,-10,16
Concordia Ch,9802,6,3,2,9,18,24,-6,11
FCSB,9803,1,7,6,1,24,12,12,27
CFR Cluj,9803,2,6,7,1,15,7,8,25
D Bucuresti,9803,3,4,5,5,19,19,0,17
Universitate,9803,4,4,5,5,16,21,-5,17
FC Botosani,9803,5,3,4,7,6,16,-10,13
Concordia Ch,9803,6,3,3,8,16,21,-5,12
FCSB,9804,1,8,5,1,24,11,13,29
CFR Cluj,9804,2,5,7,2,14,9,5,22
Universitate,9804,3,4,6,4,16,19,-3,18
FC Botosani,9804,4,4,4,6,7,13,-6,16
D Bucuresti,9804,5,3,5,6,18,22,-4,14
Concordia Ch,9804,6,3,3,8,18,23,-5,12
FCSB,9805,1,8,5,1,25,12,13,29
CFR Cluj,9805,2,5,6,3,15,11,4,21
Universitate,9805,3,5,5,4,17,19,-2,20
D Bucuresti,9805,4,4,5,5,20,19,1,17
FC Botosani,9805,5,4,4,6,7,16,-9,16
Concordia Ch,9805,6,2,3,9,17,24,-7,9
FCSB,9806,1,8,5,1,25,13,12,29
CFR Cluj,9806,2,5,7,2,15,10,5,22
Universitate,9806,3,4,6,4,17,19,-2,18
D Bucuresti,9806,4,4,4,6,18,22,-4,16
FC Botosani,9806,5,4,4,6,9,14,-5,16
Concordia Ch,9806,6,3,2,9,16,22,-6,11
FCSB,9807,1,9,5,0,29,11,18,32
CFR Cluj,9807,2,6,6,2,17,10,7,24
D Bucuresti,9807,3,4,4,6,18,19,-1,16
FC Botosani,9807,4,3,5,6,5,14,-9,14
Universitate,9807,5,3,5,6,14,24,-10,14
Concordia Ch,9807,6,3,3,8,16,21,-5,12
FCSB,9808,1,7,7,0,25,12,13,28
CFR Cluj,9808,2,5,8,1,14,8,6,23
D Bucuresti,9808,3,4,4,6,18,20,-2,16
Universitate,9808,4,3,7,4,17,21,-4,16
FC Botosani,9808,5,4,4,6,7,14,-7,16
Concordia Ch,9808,6,3,2,9,16,22,-6,11
FCSB,9809,1,7,7,0,24,11,13,28
CFR Cluj,9809,2,5,7,2,15,11,4,22
Universitate,9809,3,4,6,4,17,19,-2,18
D Bucuresti,9809,4,4,5,5,18,19,-1,17
FC Botosani,9809,5,3,6,5,7,14,-7,15
Concordia Ch,9809,6,2,3,9,16,23,-7,9
FCSB,9810,1,9,5,0,27,11,16,32
CFR Cluj,9810,2,5,7,2,14,9,5,22
FC Botosani,9810,3,4,4,6,8,15,-7,16
Universitate,9810,4,3,6,5,14,20,-6,15
Concordia Ch,9810,5,4,2,8,20,24,-4,14
D Bucuresti,9810,6,3,4,7,19,23,-4,13
FCSB,9811,1,9,5,0,26,11,15,32
CFR Cluj,9811,2,5,6,3,14,10,4,21
Universitate,9811,3,4,5,5,15,19,-4,17
D Bucuresti,9811,4,4,4,6,20,22,-2,16
Concordia Ch,9811,5,4,2,8,18,22,-4,14
FC Botosani,9811,6,3,4,7,7,16,-9,13
FCSB,9812,1,8,6,0,26,10,16,30
CFR Cluj,9812,2,5,7,2,14,11,3,22
FC Botosani,9812,3,5,4,5,11,15,-4,19
Universitate,9812,4,3,7,4,15,19,-4,16
D Bucuresti,9812,5,3,4,7,21,26,-5,13
Concordia Ch,9812,6,3,2,9,19,25,-6,11
FCSB,9813,1,7,5,2,24,16,8,26
CFR Cluj,9813,2,6,7,1,15,7,8,25
D Bucuresti,9813,3,5,4,5,21,19,2,19
Universitate,9813,4,4,6,4,18,19,-1,18
FC Botosani,9813,5,4,4,6,6,15,-9,16
Concordia Ch,9813,6,2,2,10,16,24,-8,8
FCSB,9814,1,8,6,0,26,12,14,30
CFR Cluj,9814,2,6,6,2,15,9,6,24
D Bucuresti,9814,3,4,4,6,18,20,-2,16
FC Botosani,9814,4,4,4,6,7,13,-6,16
Universitate,9814,5,3,6,5,17,22,-5,15
Concordia Ch,9814,6,3,2,9,16,23,-7,11
FCSB,9815,1,8,6,0,26,11,15,30
CFR Cluj,9815,2,6,7,1,15,8,7,25
FC Botosani,9815,3,5,4,5,8,12,-4,19
Universitate,9815,4,3,5,6,14,21,-7,14
D Bucuresti,9815,5,3,4,7,18,24,-6,13
Concordia Ch,9815,6,3,2,9,20,25,-5,11
FCSB,9816,1,8,6,0,26,12,14,30
CFR Cluj,9816,2,5,6,3,13,9,4,21
Universitate,9816,3,4,6,4,17,20,-3,18
D Bucuresti,9816,4,4,4,6,19,20,-1,16
FC Botosani,9816,5,4,4,6,6,14,-8,16
Concordia Ch,9816,6,3,2,9,17,23,-6,11
FCSB,9817,1,8,6,0,26,12,14,30
CFR Cluj,9817,2,6,7,1,16,8,8,25
FC Botosani,9817,3,3,6,5,6,13,-7,15
D Bucuresti,9817,4,3,5,6,16,19,-3,14
Universitate,9817,5,3,5,6,15,22,-7,14
Concordia Ch,9817,6,3,3,8,17,22,-5,12
FCSB,9818,1,7,5,2,26,17,9,26
CFR Cluj,9818,2,6,6,2,15,10,5,24
Universitate,9818,3,5,5,4,21,20,1,20
D Bucuresti,9818,4,4,5,5,18,18,0,17
FC Botosani,9818,5,3,4,7,6,16,-10,13
Concordia Ch,9818,6,3,3,8,17,22,-5,12
FCSB,9819,1,7,6,1,25,17,8,27
CFR Cluj,9819,2,6,7,1,16,9,7,25
Universitate,9819,3,4,5,5,21,21,0,17
D Bucuresti,9819,4,4,4,6,19,23,-4,16
Concordia Ch,9819,5,4,2,8,22,23,-1,14
FC Botosani,9819,6,3,4,7,7,17,-10,13
FCSB,9820,1,8,6,0,26,12,14,30
CFR Cluj,9820,2,5,7,2,15,10,5,22
Universitate,9820,3,4,5,5,17,21,-4,17
D Bucuresti,9820,4,4,4,6,21,22,-1,16
FC Botosani,9820,5,4,4,6,7,15,-8,16
Concordia Ch,9820,6,3,2,9,18,24,-6,11
FCSB,9821,1,8,6,0,28,12,16,30
CFR Cluj,9821,2,5,7,2,13,10,3,22
D Bucuresti,9821,3,4,4,6,19,20,-1,16
Universitate,9821,4,3,7,4,16,20,-4,16
FC Botosani,9821,5,4,4,6,7,16,-9,16
Concordia Ch,9821,6,3,2,9,18,23,-5,11
FCSB,9822,1,8,5,1,25,11,14,29
CFR Cluj,9822,2,6,7,1,14,7,7,25
D Bucuresti,9822,3,4,5,5,19,19,0,17
FC Botosani,9822,4,4,5,5,7,13,-6,17
Universitate,9822,5,3,6,5,14,20,-6,15
Concordia Ch,9822,6,2,2,10,15,24,-9,8
FCSB,9823,1,8,6,0,28,12,16,30
CFR Cluj,9823,2,5,7,2,13,10,3,22
D Bucuresti,9823,3,5,4,5,20,19,1,19
Universitate,9823,4,3,7,4,16,20,-4,16
FC Botosani,9823,5,3,5,6,8,17,-9,14
Concordia Ch,9823,6,2,3,9,17,24,-7,9
CFR Cluj,9824,1,7,6,1,16,7,9,27
FCSB,9824,2,7,5,2,23,13,10,26
FC Botosani,9824,3,5,4,5,8,12,-4,19
Universitate,9824,4,4,5,5,16,20,-4,17
D Bucuresti,9824,5,3,4,7,17,22,-5,13
Concordia Ch,9824,6,3,2,9,18,24,-6,11
CFR Cluj,9825,1,7,6,1,16,8,8,27
FCSB,9825,2,7,5,2,25,14,11,26
Universitate,9825,3,4,5,5,16,20,-4,17
D Bucuresti,9825,4,3,6,5,18,20,-2,15
FC Botosani,9825,5,3,6,5,9,16,-7,15
Concordia Ch,9825,6,2,4,8,19,25,-6,10
FCSB,9826,1,9,5,0,26,10,16,32
CFR Cluj,9826,2,6,6,2,16,11,5,24
D Bucuresti,9826,3,4,4,6,21,22,-1,16
Universitate,9826,4,3,5,6,16,22,-6,14
FC Botosani,9826,5,3,5,6,6,16,-10,14
Concordia Ch,9826,6,3,3,8,18,22,-4,12
FCSB,9827,1,8,5,1,26,14,12,29
CFR Cluj,9827,2,7,6,1,17,8,9,27
Concordia Ch,9827,3,4,2,8,19,22,-3,14
D Bucuresti,9827,4,3,5,6,17,21,-4,14
Universitate,9827,5,3,5,6,17,23,-6,14
FC Botosani,9827,6,3,5,6,5,13,-8,14
FCSB,9828,1,8,5,1,28,12,16,29
CFR Cluj,9828,2,6,6,2,17,12,5,24
FC Botosani,9828,3,4,5,5,10,13,-3,17
Universitate,9828,4,4,5,5,16,22,-6,17
D Bucuresti,9828,5,3,6,5,19,21,-2,15
Concordia Ch,9828,6,2,3,9,17,27,-10,9
FCSB,9829,1,8,5,1,24,12,12,29
CFR Cluj,9829,2,7,6,1,17,7,10,27
D Bucuresti,9829,3,4,4,6,19,22,-3,16
Concordia Ch,9829,4,4,2,8,19,22,-3,14
Universitate,9829,5,3,5,6,14,21,-7,14
FC Botosani,9829,6,3,4,7,6,15,-9,13
FCSB,9830,1,8,6,0,27,11,16,30
CFR Cluj,9830,2,6,6,2,17,10,7,24
D Bucuresti,9830,3,4,5,5,18,19,-1,17
FC Botosani,9830,4,4,4,6,7,14,-7,16
Universitate,9830,5,3,6,5,15,23,-8,15
Concordia Ch,9830,6,2,3,9,15,22,-7,9
FCSB,9831,1,7,7,0,23,10,13,28
CFR Cluj,9831,2,6,7,1,14,7,7,25
D Bucuresti,9831,3,4,4,6,17,20,-3,16
Universitate,9831,4,3,6,5,14,19,-5,15
FC Botosani,9831,5,3,5,6,6,14,-8,14
Concordia Ch,9831,6,3,3,8,18,22,-4,12
FCSB,9832,1,8,6,0,30,13,17,30
CFR Cluj,9832,2,5,6,3,14,16,-2,21
Universitate,9832,3,4,6,4,20,20,0,18
D Bucuresti,9832,4,4,5,5,19,18,1,17
FC Botosani,9832,5,3,5,6,6,16,-10,14
Concordia Ch,9832,6,2,4,8,16,22,-6,10
FCSB,9833,1,8,5,1,29,14,15,29
CFR Cluj,9833,2,5,6,3,14,12,2,21
Universitate,9833,3,5,5,4,20,22,-2,20
D Bucuresti,9833,4,3,6,5,19,21,-2,15
FC Botosani,9833,5,3,5,6,7,16,-9,14
Concordia Ch,9833,6,3,3,8,18,22,-4,12
FCSB,9834,1,9,5,0,27,11,16,32
CFR Cluj,9834,2,6,6,2,15,10,5,24
FC Botosani,9834,3,4,5,5,6,12,-6,17
Universitate,9834,4,3,5,6,14,20,-6,14
D Bucuresti,9834,5,3,5,6,16,23,-7,14
Concordia Ch,9834,6,3,2,9,20,22,-2,11
FCSB,9835,1,9,5,0,30,11,19,32
CFR Cluj,9835,2,5,7,2,15,14,1,22
D Bucuresti,9835,3,4,5,5,20,21,-1,17
Universitate,9835,4,3,6,5,17,22,-5,15
FC Botosani,9835,5,3,4,7,6,15,-9,13
Concordia Ch,9835,6,3,3,8,18,23,-5,12
FCSB,9836,1,8,5,1,25,12,13,29
CFR Cluj,9836,2,6,6,2,16,10,6,24
Universitate,9836,3,4,5,5,18,22,-4,17
D Bucuresti,9836,4,4,4,6,20,21,-1,16
FC Botosani,9836,5,4,4,6,7,15,-8,16
Concordia Ch,9836,6,3,2,9,17,23,-6,11
CFR Cluj,9837,1,7,6,1,18,7,11,27
FCSB,9837,2,7,6,1,24,14,10,27
D Bucuresti,9837,3,4,5,5,18,19,-1,17
FC Botosani,9837,4,4,5,5,7,13,-6,17
Universitate,9837,5,3,6,5,15,21,-6,15
Concordia Ch,9837,6,2,2,10,17,25,-8,8
FCSB,9838,1,8,6,0,26,12,14,30
CFR Cluj,9838,2,5,7,2,15,12,3,22
Universitate,9838,3,4,5,5,17,19,-2,17
FC Botosani,9838,4,4,5,5,6,12,-6,17
D Bucuresti,9838,5,4,4,6,18,19,-1,16
Concordia Ch,9838,6,2,3,9,15,23,-8,9
FCSB,9839,1,7,7,0,25,12,13,28
CFR Cluj,9839,2,6,7,1,15,7,8,25
D Bucuresti,9839,3,3,6,5,18,20,-2,15
Universitate,9839,4,3,6,5,16,22,-6,15
FC Botosani,9839,5,3,6,5,7,14,-7,15
Concordia Ch,9839,6,2,4,8,17,23,-6,10
FCSB,9840,1,7,6,1,26,15,11,27
CFR Cluj,9840,2,7,6,1,17,8,9,27
FC Botosani,9840,3,4,5,5,8,12,-4,17
Universitate,9840,4,3,6,5,16,21,-5,15
D Bucuresti,9840,5,3,5,6,17,20,-3,14
Concordia Ch,9840,6,3,2,9,17,25,-8,11
FCSB,9841,1,8,5,1,27,14,13,29
CFR Cluj,9841,2,6,7,1,18,11,7,25
D Bucuresti,9841,3,4,5,5,19,20,-1,17
FC Botosani,9841,4,4,4,6,7,14,-7,16
Universitate,9841,5,3,6,5,15,20,-5,15
Concordia Ch,9841,6,2,3,9,16,23,-7,9
FCSB,9842,1,7,6,1,25,13,12,27
CFR Cluj,9842,2,5,8,1,17,11,6,23
Universitate,9842,3,4,6,4,17,20,-3,18
D Bucuresti,9842,4,4,5,5,19,20,-1,17
FC Botosani,9842,5,4,4,6,6,13,-7,16
Concordia Ch,9842,6,2,3,9,17,24,-7,9
FCSB,9843,1,7,6,1,24,12,12,27
CFR Cluj,9843,2,5,7,2,15,10,5,22
Universitate,9843,3,5,5,4,17,19,-2,20
FC Botosani,9843,4,5,4,5,9,12,-3,19
D Bucuresti,9843,5,3,4,7,17,21,-4,13
Concordia Ch,9843,6,3,2,9,17,25,-8,11
FCSB,9844,1,8,6,0,28,11,17,30
CFR Cluj,9844,2,6,6,2,14,11,3,24
D Bucuresti,9844,3,4,5,5,19,20,-1,17
FC Botosani,9844,4,4,4,6,9,15,-6,16
Universitate,9844,5,3,6,5,15,20,-5,15
Concordia Ch,9844,6,2,3,9,17,25,-8,9
FCSB,9845,1,9,5,0,26,10,16,32
CFR Cluj,9845,2,5,7,2,14,10,4,22
D Bucuresti,9845,3,4,4,6,18,21,-3,16
Universitate,9845,4,3,6,5,15,20,-5,15
FC Botosani,9845,5,3,5,6,7,15,-8,14
Concordia Ch,9845,6,3,3,8,18,22,-4,12
FCSB,9846,1,9,5,0,27,10,17,32
CFR Cluj,9846,2,6,6,2,14,9,5,24
FC Botosani,9846,3,4,4,6,8,16,-8,16
Concordia Ch,9846,4,4,2,8,21,23,-2,14
Universitate,9846,5,3,5,6,14,21,-7,14
D Bucuresti,9846,6,3,4,7,17,22,-5,13
FCSB,9847,1,8,6,0,29,15,14,30
CFR Cluj,9847,2,5,7,2,14,9,5,22
Universitate,9847,3,3,7,4,18,22,-4,16
FC Botosani,9847,4,3,6,5,6,13,-7,15
D Bucuresti,9847,5,3,5,6,17,20,-3,14
Concordia Ch,9847,6,3,3,8,16,21,-5,12
FCSB,9848,1,8,6,0,27,13,14,30
CFR Cluj,9848,2,6,6,2,16,10,6,24
D Bucuresti,9848,3,4,4,6,18,20,-2,16
Universitate,9848,4,3,6,5,15,20,-5,15
Concordia Ch,9848,5,4,2,8,18,22,-4,14
FC Botosani,9848,6,3,4,7,5,14,-9,13
FCSB,9849,1,7,6,1,25,13,12,27
CFR Cluj,9849,2,6,7,1,15,8,7,25
Universitate,9849,3,4,5,5,16,20,-4,17
D Bucuresti,9849,4,4,4,6,18,20,-2,16
Concordia Ch,9849,5,4,2,8,18,22,-4,14
FC Botosani,9849,6,3,4,7,7,16,-9,13
FCSB,9850,1,8,6,0,28,13,15,30
CFR Cluj,9850,2,6,6,2,16,11,5,24
Universitate,9850,3,3,6,5,17,22,-5,15
FC Botosani,9850,4,3,6,5,6,13,-7,15
D Bucuresti,9850,5,3,5,6,17,22,-5,14
Concordia Ch,9850,6,3,3,8,20,23,-3,12
FCSB,9851,1,7,6,1,23,12,11,27
CFR Cluj,9851,2,6,7,1,15,7,8,25
Universitate,9851,3,4,5,5,16,20,-4,17
D Bucuresti,9851,4,4,4,6,20,21,-1,16
FC Botosani,9851,5,4,4,6,8,17,-9,16
Concordia Ch,9851,6,3,2,9,18,23,-5,11
FCSB,9852,1,8,6,0,28,12,16,30
CFR Cluj,9852,2,6,6,2,17,10,7,24
D Bucuresti,9852,3,4,5,5,19,18,1,17
FC Botosani,9852,4,3,6,5,5,12,-7,15
Universitate,9852,5,3,6,5,16,24,-8,15
Concordia Ch,9852,6,2,3,9,15,24,-9,9
FCSB,9853,1,8,6,0,28,10,18,30
CFR Cluj,9853,2,5,8,1,15,9,6,23
D Bucuresti,9853,3,5,4,5,20,19,1,19
Universitate,9853,4,3,6,5,16,25,-9,15
FC Botosani,9853,5,3,4,7,6,15,-9,13
Concordia Ch,9853,6,3,2,9,16,23,-7,11
FCSB,9854,1,8,5,1,27,13,14,29
CFR Cluj,9854,2,7,6,1,18,8,10,27
D Bucuresti,9854,3,4,5,5,19,20,-1,17
Universitate,9854,4,3,5,6,14,23,-9,14
FC Botosani,9854,5,3,4,7,7,16,-9,13
Concordia Ch,9854,6,3,3,8,18,23,-5,12
FCSB,9855,1,8,5,1,25,13,12,29
CFR Cluj,9855,2,5,6,3,15,11,4,21
Universitate,9855,3,5,5,4,18,19,-1,20
D Bucuresti,9855,4,4,5,5,18,19,-1,17
FC Botosani,9855,5,4,5,5,6,12,-6,17
Concordia Ch,9855,6,2,2,10,16,24,-8,8
FCSB,9856,1,8,5,1,26,11,15,29
CFR Cluj,9856,2,6,6,2,16,10,6,24
D Bucuresti,9856,3,4,5,5,19,19,0,17
Universitate,9856,4,4,5,5,15,21,-6,17
FC Botosani,9856,5,4,4,6,7,15,-8,16
Concordia Ch,9856,6,2,3,9,17,24,-7,9
FCSB,9857,1,9,5,0,27,11,16,32
CFR Cluj,9857,2,5,7,2,14,9,5,22
D Bucuresti,9857,3,4,4,6,18,21,-3,16
Universitate,9857,4,3,6,5,16,22,-6,15
FC Botosani,9857,5,3,5,6,5,13,-8,14
Concordia Ch,9857,6,3,3,8,18,22,-4,12
FCSB,9858,1,8,5,1,24,12,12,29
CFR Cluj,9858,2,5,6,3,13,9,4,21
Universitate,9858,3,5,5,4,17,18,-1,20
FC Botosani,9858,4,5,4,5,10,14,-4,19
D Bucuresti,9858,5,3,4,7,16,22,-6,13
Concordia Ch,9858,6,3,2,9,19,24,-5,11
FCSB,9859,1,9,5,0,27,11,16,32
CFR Cluj,9859,2,6,6,2,16,10,6,24
FC Botosani,9859,3,5,4,5,9,13,-4,19
D Bucuresti,9859,4,4,4,6,17,20,-3,16
Universitate,9859,5,3,5,6,15,22,-7,14
Concordia Ch,9859,6,2,2,10,16,24,-8,8
FCSB,9860,1,7,6,1,24,14,10,27
CFR Cluj,9860,2,7,6,1,18,8,10,27
FC Botosani,9860,3,4,5,5,8,14,-6,17
D Bucuresti,9860,4,3,6,5,20,22,-2,15
Universitate,9860,5,3,6,5,14,19,-5,15
Concordia Ch,9860,6,2,3,9,17,24,-7,9
CFR Cluj,9861,1,7,6,1,17,8,9,27
FCSB,9861,2,7,5,2,24,14,10,26
Universitate,9861,3,4,5,5,15,19,-4,17
D Bucuresti,9861,4,4,4,6,19,24,-5,16
Concordia Ch,9861,5,4,2,8,23,23,0,14
FC Botosani,9861,6,3,4,7,6,16,-10,13
FCSB,9862,1,9,5,0,27,12,15,32
CFR Cluj,9862,2,5,7,2,14,9,5,22
D Bucuresti,9862,3,4,5,5,18,19,-1,17
FC Botosani,9862,4,4,4,6,7,14,-7,16
Universitate,9862,5,3,6,5,15,20,-5,15
Concordia Ch,9862,6,2,3,9,17,24,-7,9
FCSB,9863,1,9,5,0,27,11,16,32
CFR Cluj,9863,2,6,6,2,14,8,6,24
Concordia Ch,9863,3,4,2,8,22,24,-2,14
D Bucuresti,9863,4,3,5,6,18,22,-4,14
Universitate,9863,5,3,5,6,15,22,-7,14
FC Botosani,9863,6,3,5,6,6,15,-9,14
FCSB,9864,1,7,6,1,24,12,12,27
CFR Cluj,9864,2,6,7,1,14,7,7,25
Universitate,9864,3,4,5,5,16,20,-4,17
FC Botosani,9864,4,4,5,5,9,15,-6,17
D Bucuresti,9864,5,3,6,5,19,21,-2,15
Concordia Ch,9864,6,2,3,9,17,24,-7,9
FCSB,9865,1,9,5,0,27,12,15,32
CFR Cluj,9865,2,6,6,2,15,9,6,24
FC Botosani,9865,3,3,6,5,5,12,-7,15
D Bucuresti,9865,4,3,5,6,17,20,-3,14
Universitate,9865,5,3,5,6,15,21,-6,14
Concordia Ch,9865,6,3,3,8,17,22,-5,12
FCSB,9866,1,8,5,1,27,14,13,29
CFR Cluj,9866,2,6,6,2,15,10,5,24
Universitate,9866,3,4,5,5,17,20,-3,17
D Bucuresti,9866,4,4,4,6,18,19,-1,16
FC Botosani,9866,5,3,5,6,6,15,-9,14
Concordia Ch,9866,6,3,3,8,17,22,-5,12
FCSB,9867,1,8,6,0,25,11,14,30
CFR Cluj,9867,2,5,7,2,14,10,4,22
Universitate,9867,3,4,5,5,18,21,-3,17
D Bucuresti,9867,4,4,4,6,20,21,-1,16
FC Botosani,9867,5,3,5,6,7,16,-9,14
Concordia Ch,9867,6,3,3,8,18,23,-5,12
FCSB,9868,1,7,6,1,26,15,11,27
CFR Cluj,9868,2,5,8,1,17,11,6,23
Universitate,9868,3,4,6,4,19,21,-2,18
D Bucuresti,9868,4,4,4,6,19,22,-3,16
FC Botosani,9868,5,3,5,6,6,14,-8,14
Concordia Ch,9868,6,3,3,8,18,22,-4,12
FCSB,9869,1,7,7,0,25,12,13,28
CFR Cluj,9869,2,5,7,2,15,10,5,22
Universitate,9869,3,4,6,4,17,20,-3,18
D Bucuresti,9869,4,4,4,6,17,20,-3,16
FC Botosani,9869,5,4,4,6,9,15,-6,16
Concordia Ch,9869,6,3,2,9,19,25,-6,11
FCSB,9870,1,8,6,0,27,12,15,30
CFR Cluj,9870,2,5,7,2,15,11,4,22
D Bucuresti,9870,3,4,5,5,18,19,-1,17
Universitate,9870,4,3,7,4,18,22,-4,16
FC Botosani,9870,5,3,6,5,6,13,-7,15
Concordia Ch,9870,6,2,3,9,17,24,-7,9
FCSB,9871,1,7,7,0,23,10,13,28
CFR Cluj,9871,2,5,7,2,14,9,5,22
Universitate,9871,3,4,6,4,16,19,-3,18
FC Botosani,9871,4,3,6,5,7,14,-7,15
D Bucuresti,9871,5,3,5,6,19,24,-5,14
Concordia Ch,9871,6,3,3,8,19,22,-3,12
FCSB,9872,1,8,5,1,27,12,15,29
CFR Cluj,9872,2,6,6,2,14,10,4,24
Universitate,9872,3,4,5,5,16,20,-4,17
Concordia Ch,9872,4,4,2,8,21,24,-3,14
D Bucuresti,9872,5,3,5,6,17,21,-4,14
FC Botosani,9872,6,3,5,6,7,15,-8,14
FCSB,9873,1,9,5,0,26,10,16,32
CFR Cluj,9873,2,6,6,2,16,10,6,24
D Bucuresti,9873,3,5,4,5,21,18,3,19
FC Botosani,9873,4,4,4,6,8,15,-7,16
Universitate,9873,5,3,5,6,16,23,-7,14
Concordia Ch,9873,6,2,2,10,16,27,-11,8
FCSB,9874,1,7,6,1,23,11,12,27
CFR Cluj,9874,2,7,6,1,15,7,8,27
D Bucuresti,9874,3,4,5,5,18,19,-1,17
FC Botosani,9874,4,4,4,6,8,13,-5,16
Universitate,9874,5,3,6,5,14,19,-5,15
Concordia Ch,9874,6,2,3,9,16,25,-9,9
FCSB,9875,1,9,5,0,30,12,18,32
CFR Cluj,9875,2,6,6,2,16,10,6,24
Concordia Ch,9875,3,4,2,8,19,22,-3,14
D Bucuresti,9875,4,3,5,6,17,21,-4,14
FC Botosani,9875,5,3,5,6,7,15,-8,14
Universitate,9875,6,3,5,6,15,24,-9,14
FCSB,9876,1,7,6,1,26,15,11,27
CFR Cluj,9876,2,6,7,1,17,9,8,25
FC Botosani,9876,3,4,5,5,8,14,-6,17
Universitate,9876,4,3,7,4,17,21,-4,16
D Bucuresti,9876,5,3,5,6,17,20,-3,14
Concordia Ch,9876,6,3,2,9,19,25,-6,11
FCSB,9877,1,7,7,0,25,12,13,28
CFR Cluj,9877,2,5,8,1,15,9,6,23
FC Botosani,9877,3,5,4,5,10,12,-2,19
Universitate,9877,4,3,7,4,16,20,-4,16
D Bucuresti,9877,5,3,5,6,18,22,-4,14
Concordia Ch,9877,6,2,3,9,17,26,-9,9
FCSB,9878,1,7,6,1,23,13,10,27
CFR Cluj,9878,2,6,7,1,17,8,9,25
Universitate,9878,3,3,7,4,15,19,-4,16
D Bucuresti,9878,4,3,6,5,17,19,-2,15
FC Botosani,9878,5,3,6,5,6,13,-7,15
Concordia Ch,9878,6,2,4,8,17,23,-6,10
FCSB,9879,1,9,5,0,27,11,16,32
CFR Cluj,9879,2,5,6,3,15,11,4,21
FC Botosani,9879,3,5,4,5,10,12,-2,19
Universitate,9879,4,4,5,5,16,21,-5,17
D Bucuresti,9879,5,3,5,6,17,20,-3,14
Concordia Ch,9879,6,2,3,9,16,26,-10,9
FCSB,9880,1,7,6,1,26,15,11,27
CFR Cluj,9880,2,6,7,1,17,9,8,25
FC Botosani,9880,3,5,4,5,11,15,-4,19
Universitate,9880,4,3,7,4,17,21,-4,16
D Bucuresti,9880,5,3,5,6,19,22,-3,14
Concordia Ch,9880,6,2,3,9,17,25,-8,9
FCSB,9881,1,9,5,0,29,13,16,32
CFR Cluj,9881,2,6,6,2,16,10,6,24
D Bucuresti,9881,3,4,5,5,17,18,-1,17
FC Botosani,9881,4,4,5,5,7,13,-6,17
Universitate,9881,5,3,5,6,17,24,-7,14
Concordia Ch,9881,6,2,2,10,16,24,-8,8
FCSB,9882,1,7,6,1,24,12,12,27
CFR Cluj,9882,2,7,6,1,18,9,9,27
D Bucuresti,9882,3,4,5,5,20,21,-1,17
FC Botosani,9882,4,4,5,5,9,14,-5,17
Universitate,9882,5,3,6,5,17,23,-6,15
Concordia Ch,9882,6,2,2,10,16,25,-9,8
FCSB,9883,1,8,6,0,26,11,15,30
CFR Cluj,9883,2,6,6,2,14,9,5,24
FC Botosani,9883,3,5,4,5,13,14,-1,19
Universitate,9883,4,3,6,5,15,20,-5,15
D Bucuresti,9883,5,3,4,7,17,24,-7,13
Concordia Ch,9883,6,3,2,9,18,25,-7,11
FCSB,9884,1,9,5,0,26,10,16,32
CFR Cluj,9884,2,6,6,2,15,10,5,24
D Bucuresti,9884,3,5,4,5,21,19,2,19
Universitate,9884,4,3,5,6,15,21,-6,14
FC Botosani,9884,5,3,5,6,6,15,-9,14
Concordia Ch,9884,6,2,3,9,15,23,-8,9
FCSB,9885,1,7,6,1,23,11,12,27
CFR Cluj,9885,2,6,7,1,14,7,7,25
Universitate,9885,3,4,5,5,15,19,-4,17
D Bucuresti,9885,4,3,6,5,19,21,-2,15
FC Botosani,9885,5,3,6,5,6,13,-7,15
Concordia Ch,9885,6,2,4,8,17,23,-6,10
FCSB,9886,1,8,6,0,28,12,16,30
CFR Cluj,9886,2,6,7,1,16,9,7,25
D Bucuresti,9886,3,4,5,5,19,19,0,17
FC Botosani,9886,4,4,4,6,9,16,-7,16
Universitate,9886,5,3,5,6,14,22,-8,14
Concordia Ch,9886,6,2,3,9,18,26,-8,9
FCSB,9887,1,8,6,0,27,11,16,30
CFR Cluj,9887,2,6,7,1,14,7,7,25
D Bucuresti,9887,3,4,5,5,21,21,0,17
FC Botosani,9887,4,4,5,5,9,14,-5,17
Universitate,9887,5,3,5,6,15,23,-8,14
Concordia Ch,9887,6,2,2,10,16,26,-10,8
FCSB,9888,1,9,5,0,29,12,17,32
CFR Cluj,9888,2,6,6,2,15,11,4,24
D Bucuresti,9888,3,4,4,6,21,21,0,16
Concordia Ch,9888,4,4,2,8,20,23,-3,14
Universitate,9888,5,3,5,6,15,21,-6,14
FC Botosani,9888,6,3,4,7,5,17,-12,13
FCSB,9889,1,8,5,1,25,12,13,29
CFR Cluj,9889,2,7,6,1,16,8,8,27
FC Botosani,9889,3,3,6,5,6,13,-7,15
Universitate,9889,4,3,5,6,14,20,-6,14
D Bucuresti,9889,5,3,5,6,17,24,-7,14
Concordia Ch,9889,6,3,3,8,20,21,-1,12
CFR Cluj,9890,1,7,6,1,19,7,12,27
FCSB,9890,2,7,5,2,23,13,10,26
FC Botosani,9890,3,5,4,5,8,12,-4,19
Universitate,9890,4,4,5,5,15,22,-7,17
D Bucuresti,9890,5,3,4,7,18,22,-4,13
Concordia Ch,9890,6,3,2,9,18,25,-7,11
FCSB,9891,1,7,6,1,25,15,10,27
CFR Cluj,9891,2,6,6,2,17,9,8,24
D Bucuresti,9891,3,5,4,5,20,19,1,19
Universitate,9891,4,4,6,4,18,21,-3,18
FC Botosani,9891,5,3,4,7,5,16,-11,13
Concordia Ch,9891,6,3,2,9,19,24,-5,11
FCSB,9892,1,7,6,1,24,16,8,27
CFR Cluj,9892,2,5,8,1,14,8,6,23
Universitate,9892,3,4,6,4,19,18,1,18
D Bucuresti,9892,4,4,5,5,19,19,0,17
FC Botosani,9892,5,4,4,6,8,15,-7,16
Concordia Ch,9892,6,2,3,9,17,25,-8,9
FCSB,9893,1,8,5,1,25,12,13,29
CFR Cluj,9893,2,6,7,1,15,8,7,25
D Bucuresti,9893,3,5,4,5,22,19,3,19
Universitate,9893,4,3,6,5,14,19,-5,15
FC Botosani,9893,5,3,4,7,5,15,-10,13
Concordia Ch,9893,6,3,2,9,17,25,-8,11
FCSB,9894,1,9,5,0,29,11,18,32
CFR Cluj,9894,2,6,6,2,15,9,6,24
D Bucuresti,9894,3,4,4,6,20,23,-3,16
Concordia Ch,9894,4,4,2,8,20,23,-3,14
Universitate,9894,5,3,5,6,15,24,-9,14
FC Botosani,9894,6,3,4,7,8,17,-9,13
FCSB,9895,1,8,6,0,26,11,15,30
CFR Cluj,9895,2,6,6,2,14,9,5,24
D Bucuresti,9895,3,4,5,5,21,20,1,17
FC Botosani,9895,4,4,5,5,9,13,-4,17
Universitate,9895,5,3,6,5,15,20,-5,15
Concordia Ch,9895,6,2,2,10,16,28,-12,8
FCSB,9896,1,7,6,1,25,13,12,27
CFR Cluj,9896,2,6,6,2,15,9,6,24
D Bucuresti,9896,3,5,4,5,18,18,0,19
Universitate,9896,4,4,6,4,18,21,-3,18
FC Botosani,9896,5,4,4,6,7,13,-6,16
Concordia Ch,9896,6,2,2,10,15,24,-9,8
FCSB,9897,1,9,5,0,27,11,16,32
CFR Cluj,9897,2,5,6,3,14,11,3,21
D Bucuresti,9897,3,4,5,5,20,19,1,17
Universitate,9897,4,4,5,5,16,20,-4,17
FC Botosani,9897,5,3,6,5,7,14,-7,15
Concordia Ch,9897,6,2,3,9,16,25,-9,9
FCSB,9898,1,8,6,0,25,10,15,30
CFR Cluj,9898,2,6,6,2,17,11,6,24
D Bucuresti,9898,3,4,5,5,18,18,0,17
FC Botosani,9898,4,4,5,5,6,12,-6,17
Universitate,9898,5,3,6,5,16,22,-6,15
Concordia Ch,9898,6,2,2,10,15,24,-9,8
FCSB,9899,1,9,5,0,25,10,15,32
CFR Cluj,9899,2,6,6,2,15,8,7,24
D Bucuresti,9899,3,3,6,5,16,18,-2,15
FC Botosani,9899,4,3,6,5,5,12,-7,15
Universitate,9899,5,3,5,6,14,21,-7,14
Concordia Ch,9899,6,2,4,8,15,21,-6,10
FCSB,9900,1,8,5,1,26,13,13,29
CFR Cluj,9900,2,6,6,2,16,11,5,24
D Bucuresti,9900,3,4,5,5,18,18,0,17
Universitate,9900,4,4,5,5,18,21,-3,17
FC Botosani,9900,5,3,4,7,6,17,-11,13
Concordia Ch,9900,6,3,3,8,18,22,-4,12
FCSB,9901,1,9,5,0,27,10,17,32
CFR Cluj,9901,2,6,6,2,14,8,6,24
D Bucuresti,9901,3,4,4,6,18,20,-2,16
FC Botosani,9901,4,4,4,6,7,16,-9,16
Universitate,9901,5,3,5,6,14,22,-8,14
Concordia Ch,9901,6,3,2,9,18,22,-4,11
FCSB,9902,1,8,5,1,26,12,14,29
CFR Cluj,9902,2,7,6,1,17,8,9,27
D Bucuresti,9902,3,4,5,5,18,19,-1,17
Universitate,9902,4,3,5,6,15,23,-8,14
FC Botosani,9902,5,3,5,6,6,14,-8,14
Concordia Ch,9902,6,2,4,8,17,23,-6,10
FCSB,9903,1,8,5,1,28,15,13,29
CFR Cluj,9903,2,6,6,2,16,10,6,24
Universitate,9903,3,4,5,5,17,21,-4,17
FC Botosani,9903,4,4,5,5,10,15,-5,17
D Bucuresti,9903,5,4,4,6,21,22,-1,16
Concordia Ch,9903,6,2,3,9,18,27,-9,9
FCSB,9904,1,8,5,1,26,12,14,29
CFR Cluj,9904,2,7,6,1,18,10,8,27
D Bucuresti,9904,3,4,4,6,19,19,0,16
FC Botosani,9904,4,4,4,6,6,15,-9,16
Universitate,9904,5,3,5,6,16,23,-7,14
Concordia Ch,9904,6,3,2,9,16,22,-6,11
FCSB,9905,1,7,6,1,23,11,12,27
CFR Cluj,9905,2,6,7,1,14,7,7,25
Universitate,9905,3,4,5,5,15,19,-4,17
FC Botosani,9905,4,4,5,5,9,13,-4,17
D Bucuresti,9905,5,3,5,6,17,21,-4,14
Concordia Ch,9905,6,3,2,9,17,24,-7,11
FCSB,9906,1,7,5,2,23,13,10,26
CFR Cluj,9906,2,6,6,2,14,8,6,24
Universitate,9906,3,5,5,4,17,18,-1,20
D Bucuresti,9906,4,3,5,6,17,20,-3,14
Concordia Ch,9906,5,4,2,8,17,21,-4,14
FC Botosani,9906,6,3,5,6,6,14,-8,14
FCSB,9907,1,7,7,0,26,13,13,28
CFR Cluj,9907,2,6,7,1,16,8,8,25
D Bucuresti,9907,3,4,4,6,18,19,-1,16
FC Botosani,9907,4,4,4,6,10,14,-4,16
Universitate,9907,5,3,6,5,16,22,-6,15
Concordia Ch,9907,6,3,2,9,16,26,-10,11
FCSB,9908,1,7,6,1,26,14,12,27
CFR Cluj,9908,2,5,7,2,15,11,4,22
Universitate,9908,3,5,5,4,18,19,-1,20
FC Botosani,9908,4,5,4,5,8,13,-5,19
D Bucuresti,9908,5,3,5,6,16,19,-3,14
Concordia Ch,9908,6,2,3,9,16,23,-7,9
FCSB,9909,1,7,7,0,24,11,13,28
CFR Cluj,9909,2,5,8,1,14,8,6,23
D Bucuresti,9909,3,4,4,6,18,21,-3,16
Universitate,9909,4,3,7,4,16,20,-4,16
FC Botosani,9909,5,4,4,6,7,13,-6,16
Concordia Ch,9909,6,3,2,9,18,24,-6,11
FCSB,9910,1,7,6,1,25,14,11,27
CFR Cluj,9910,2,5,8,1,15,9,6,23
FC Botosani,9910,3,5,4,5,11,14,-3,19
Universitate,9910,4,4,6,4,16,18,-2,18
D Bucuresti,9910,5,3,5,6,18,22,-4,14
Concordia Ch,9910,6,2,3,9,17,25,-8,9
FCSB,9911,1,7,6,1,26,15,11,27
CFR Cluj,9911,2,5,8,1,15,9,6,23
Universitate,9911,3,4,6,4,17,19,-2,18
D Bucuresti,9911,4,4,4,6,18,20,-2,16
FC Botosani,9911,5,3,5,6,6,14,-8,14
Concordia Ch,9911,6,3,3,8,18,23,-5,12
FCSB,9912,1,8,5,1,25,13,12,29
CFR Cluj,9912,2,7,6,1,17,8,9,27
FC Botosani,9912,3,4,5,5,8,13,-5,17
D Bucuresti,9912,4,3,5,6,16,20,-4,14
Universitate,9912,5,3,5,6,16,22,-6,14
Concordia Ch,9912,6,2,4,8,16,22,-6,10
CFR Cluj,9913,1,7,6,1,15,7,8,27
FCSB,9913,2,7,5,2,23,12,11,26
D Bucuresti,9913,3,5,4,5,19,19,0,19
Universitate,9913,4,4,5,5,15,19,-4,17
FC Botosani,9913,5,4,4,6,8,15,-7,16
Concordia Ch,9913,6,2,2,10,16,24,-8,8
FCSB,9914,1,8,5,1,26,12,14,29
CFR Cluj,9914,2,5,6,3,14,11,3,21
Universitate,9914,3,5,5,4,18,20,-2,20
D Bucuresti,9914,4,4,5,5,20,20,0,17
FC Botosani,9914,5,3,5,6,9,17,-8,14
Concordia Ch,9914,6,3,2,9,18,25,-7,11
FCSB,9915,1,8,5,1,25,11,14,29
CFR Cluj,9915,2,6,7,1,15,8,7,25
D Bucuresti,9915,3,5,4,5,20,18,2,19
Universitate,9915,4,3,6,5,15,21,-6,15
FC Botosani,9915,5,3,4,7,5,16,-11,13
Concordia Ch,9915,6,3,2,9,16,22,-6,11
FCSB,9916,1,8,6,0,25,11,14,30
CFR Cluj,9916,2,5,7,2,14,9,5,22
D Bucuresti,9916,3,4,5,5,18,19,-1,17
Universitate,9916,4,4,5,5,15,19,-4,17
FC Botosani,9916,5,3,4,7,5,14,-9,13
Concordia Ch,9916,6,3,3,8,17,22,-5,12
FCSB,9917,1,9,5,0,29,12,17,32
CFR Cluj,9917,2,5,6,3,15,11,4,21
Universitate,9917,3,4,5,5,15,21,-6,17
D Bucuresti,9917,4,3,6,5,18,20,-2,15
FC Botosani,9917,5,3,5,6,7,16,-9,14
Concordia Ch,9917,6,3,3,8,19,23,-4,12
FCSB,9918,1,7,6,1,24,14,10,27
CFR Cluj,9918,2,5,7,2,14,11,3,22
Universitate,9918,3,5,5,4,20,18,2,20
FC Botosani,9918,4,5,4,5,10,12,-2,19
D Bucuresti,9918,5,3,4,7,17,23,-6,13
Concordia Ch,9918,6,3,2,9,17,24,-7,11
FCSB,9919,1,8,5,1,26,13,13,29
CFR Cluj,9919,2,6,7,1,16,8,8,25
D Bucuresti,9919,3,5,4,5,19,18,1,19
FC Botosani,9919,4,4,4,6,7,15,-8,16
Universitate,9919,5,3,6,5,16,22,-6,15
Concordia Ch,9919,6,2,2,10,16,24,-8,8
FCSB,9920,1,8,5,1,28,13,15,29
CFR Cluj,9920,2,6,6,2,15,11,4,24
Universitate,9920,3,4,5,5,17,21,-4,17
D Bucuresti,9920,4,4,4,6,19,21,-2,16
Concordia Ch,9920,5,4,2,8,19,22,-3,14
FC Botosani,9920,6,3,4,7,6,16,-10,13
FCSB,9921,1,8,5,1,28,12,16,29
CFR Cluj,9921,2,5,6,3,13,13,0,21
Universitate,9921,3,5,5,4,17,18,-1,20
D Bucuresti,9921,4,4,4,6,19,21,-2,16
FC Botosani,9921,5,4,4,6,7,13,-6,16
Concordia Ch,9921,6,3,2,9,18,25,-7,11
FCSB,9922,1,8,6,0,26,11,15,30
CFR Cluj,9922,2,6,6,2,15,10,5,24
D Bucuresti,9922,3,4,5,5,18,19,-1,17
FC Botosani,9922,4,4,4,6,9,16,-7,16
Universitate,9922,5,3,6,5,14,19,-5,15
Concordia Ch,9922,6,2,3,9,19,26,-7,9
FCSB,9923,1,8,5,1,24,11,13,29
CFR Cluj,9923,2,7,6,1,17,7,10,27
D Bucuresti,9923,3,4,5,5,19,20,-1,17
Universitate,9923,4,3,5,6,14,22,-8,14
FC Botosani,9923,5,3,5,6,6,14,-8,14
Concordia Ch,9923,6,3,2,9,17,23,-6,11
FCSB,9924,1,8,5,1,29,13,16,29
CFR Cluj,9924,2,6,6,2,14,12,2,24
Universitate,9924,3,4,5,5,17,20,-3,17
D Bucuresti,9924,4,4,4,6,19,20,-1,16
FC Botosani,9924,5,4,4,6,8,15,-7,16
Concordia Ch,9924,6,3,2,9,16,23,-7,11
FCSB,9925,1,8,6,0,24,10,14,30
CFR Cluj,9925,2,5,7,2,13,8,5,22
D Bucuresti,9925,3,4,5,5,20,20,0,17
FC Botosani,9925,4,4,5,5,8,14,-6,17
Universitate,9925,5,3,7,4,14,18,-4,16
Concordia Ch,9925,6,2,2,10,17,26,-9,8
FCSB,9926,1,7,6,1,25,13,12,27
CFR Cluj,9926,2,5,8,1,15,9,6,23
Universitate,9926,3,4,6,4,17,20,-3,18
FC Botosani,9926,4,4,5,5,9,14,-5,17
D Bucuresti,9926,5,3,5,6,17,20,-3,14
Concordia Ch,9926,6,3,2,9,17,24,-7,11
FCSB,9927,1,9,5,0,26,11,15,32
CFR Cluj,9927,2,6,6,2,17,10,7,24
D Bucuresti,9927,3,4,4,6,17,19,-2,16
Universitate,9927,4,3,5,6,15,22,-7,14
FC Botosani,9927,5,3,5,6,7,15,-8,14
Concordia Ch,9927,6,3,3,8,18,23,-5,12
FCSB,9928,1,7,7,0,27,14,13,28
CFR Cluj,9928,2,5,8,1,17,11,6,23
FC Botosani,9928,3,4,5,5,7,13,-6,17
Universitate,9928,4,3,7,4,16,20,-4,16
D Bucuresti,9928,5,3,4,7,17,23,-6,13
Concordia Ch,9928,6,3,3,8,18,21,-3,12
CFR Cluj,9929,1,7,6,1,16,8,8,27
FCSB,9929,2,7,5,2,24,13,11,26
Universitate,9929,3,4,5,5,15,19,-4,17
FC Botosani,9929,4,4,5,5,8,14,-6,17
D Bucuresti,9929,5,3,6,5,17,19,-2,15
Concordia Ch,9929,6,2,3,9,16,23,-7,9
FCSB,9930,1,8,5,1,24,11,13,29
CFR Cluj,9930,2,6,6,2,16,8,8,24
D Bucuresti,9930,3,5,4,5,20,18,2,19
Universitate,9930,4,4,5,5,15,21,-6,17
FC Botosani,9930,5,4,4,6,6,14,-8,16
Concordia Ch,9930,6,2,2,10,15,24,-9,8
FCSB,9931,1,9,5,0,26,11,15,32
CFR Cluj,9931,2,6,6,2,14,8,6,24
D Bucuresti,9931,3,5,4,5,21,20,1,19
FC Botosani,9931,4,4,4,6,9,15,-6,16
Universitate,9931,5,3,5,6,15,21,-6,14
Concordia Ch,9931,6,2,2,10,16,26,-10,8
FCSB,9932,1,8,6,0,28,12,16,30
CFR Cluj,9932,2,6,6,2,16,11,5,24
FC Botosani,9932,3,5,4,5,7,12,-5,19
Universitate,9932,4,3,6,5,17,23,-6,15
D Bucuresti,9932,5,3,4,7,18,22,-4,13
Concordia Ch,9932,6,3,2,9,18,24,-6,11
FCSB,9933,1,8,6,0,26,11,15,30
CFR Cluj,9933,2,6,6,2,15,9,6,24
D Bucuresti,9933,3,4,5,5,21,22,-1,17
FC Botosani,9933,4,4,5,5,7,13,-6,17
Universitate,9933,5,3,6,5,15,21,-6,15
Concordia Ch,9933,6,2,2,10,18,26,-8,8
FCSB,9934,1,8,5,1,24,12,12,29
CFR Cluj,9934,2,7,6,1,18,7,11,27
D Bucuresti,9934,3,4,4,6,17,19,-2,16
FC Botosani,9934,4,4,4,6,9,13,-4,16
Universitate,9934,5,3,5,6,14,22,-8,14
Concordia Ch,9934,6,3,2,9,16,25,-9,11
FCSB,9935,1,8,6,0,25,11,14,30
CFR Cluj,9935,2,5,8,1,13,7,6,23
D Bucuresti,9935,3,4,5,5,19,19,0,17
Universitate,9935,4,3,6,5,15,20,-5,15
FC Botosani,9935,5,3,5,6,6,14,-8,14
Concordia Ch,9935,6,3,2,9,16,23,-7,11
FCSB,9936,1,7,6,1,24,14,10,27
CFR Cluj,9936,2,7,6,1,17,7,10,27
D Bucuresti,9936,3,4,5,5,20,20,0,17
FC Botosani,9936,4,4,4,6,8,15,-7,16
Universitate,9936,5,3,6,5,15,20,-5,15
Concordia Ch,9936,6,2,3,9,16,24,-8,9
FCSB,9937,1,8,6,0,27,12,15,30
CFR Cluj,9937,2,5,7,2,14,9,5,22
FC Botosani,9937,3,5,4,5,9,12,-3,19
Universitate,9937,4,4,5,5,16,21,-5,17
D Bucuresti,9937,5,4,4,6,18,21,-3,16
Concordia Ch,9937,6,2,2,10,16,25,-9,8
FCSB,9938,1,8,5,1,24,11,13,29
CFR Cluj,9938,2,6,6,2,15,9,6,24
Universitate,9938,3,4,5,5,16,20,-4,17
Concordia Ch,9938,4,4,2,8,20,23,-3,14
D Bucuresti,9938,5,3,5,6,18,22,-4,14
FC Botosani,9938,6,3,5,6,7,15,-8,14
CFR Cluj,9939,1,7,6,1,17,8,9,27
FCSB,9939,2,7,5,2,25,15,10,26
Universitate,9939,3,4,5,5,17,21,-4,17
D Bucuresti,9939,4,4,4,6,20,23,-3,16
Concordia Ch,9939,5,4,2,8,20,23,-3,14
FC Botosani,9939,6,3,4,7,8,17,-9,13
FCSB,9940,1,7,6,1,25,13,12,27
CFR Cluj,9940,2,7,6,1,17,8,9,27
FC Botosani,9940,3,4,5,5,7,13,-6,17
Universitate,9940,4,3,6,5,15,21,-6,15
D Bucuresti,9940,5,3,5,6,17,21,-4,14
Concordia Ch,9940,6,3,2,9,17,22,-5,11
FCSB,9941,1,7,6,1,28,17,11,27
CFR Cluj,9941,2,6,7,1,19,12,7,25
D Bucuresti,9941,3,4,5,5,19,19,0,17
Universitate,9941,4,4,5,5,18,21,-3,17
FC Botosani,9941,5,3,4,7,5,18,-13,13
Concordia Ch,9941,6,3,3,8,20,22,-2,12
FCSB,9942,1,8,6,0,26,12,14,30
CFR Cluj,9942,2,6,6,2,16,9,7,24
D Bucuresti,9942,3,4,5,5,18,19,-1,17
FC Botosani,9942,4,4,4,6,8,15,-7,16
Universitate,9942,5,3,6,5,17,23,-6,15
Concordia Ch,9942,6,2,3,9,18,25,-7,9
FCSB,9943,1,9,5,0,29,13,16,32
CFR Cluj,9943,2,6,6,2,19,11,8,24
FC Botosani,9943,3,4,5,5,9,14,-5,17
D Bucuresti,9943,4,3,6,5,17,19,-2,15
Universitate,9943,5,3,5,6,14,23,-9,14
Concordia Ch,9943,6,2,3,9,16,24,-8,9
FCSB,9944,1,7,5,2,24,14,10,26
CFR Cluj,9944,2,6,7,1,15,7,8,25
Universitate,9944,3,4,6,4,16,19,-3,18
D Bucuresti,9944,4,4,5,5,18,18,0,17
FC Botosani,9944,5,4,5,5,8,14,-6,17
Concordia Ch,9944,6,2,2,10,17,26,-9,8
FCSB,9945,1,8,5,1,26,12,14,29
CFR Cluj,9945,2,6,6,2,16,11,5,24
Universitate,9945,3,4,5,5,18,22,-4,17
D Bucuresti,9945,4,4,4,6,19,21,-2,16
FC Botosani,9945,5,4,4,6,8,15,-7,16
Concordia Ch,9945,6,3,2,9,18,24,-6,11
FCSB,9946,1,7,7,0,26,13,13,28
CFR Cluj,9946,2,6,7,1,17,9,8,25
FC Botosani,9946,3,4,5,5,7,12,-5,17
Universitate,9946,4,3,6,5,15,21,-6,15
D Bucuresti,9946,5,3,5,6,17,21,-4,14
Concordia Ch,9946,6,3,2,9,18,24,-6,11
FCSB,9947,1,8,5,1,26,12,14,29
CFR Cluj,9947,2,5,7,2,14,11,3,22
Universitate,9947,3,4,6,4,17,19,-2,18
D Bucuresti,9947,4,4,4,6,19,20,-1,16
Concordia Ch,9947,5,4,2,8,19,23,-4,14
FC Botosani,9947,6,3,4,7,6,16,-10,13
FCSB,9948,1,8,6,0,27,10,17,30
CFR Cluj,9948,2,5,7,2,14,12,2,22
D Bucuresti,9948,3,4,5,5,18,18,0,17
Universitate,9948,4,3,7,4,15,19,-4,16
FC Botosani,9948,5,4,4,6,9,15,-6,16
Concordia Ch,9948,6,2,3,9,16,25,-9,9
FCSB,9949,1,8,5,1,24,11,13,29
CFR Cluj,9949,2,6,6,2,16,10,6,24
Universitate,9949,3,4,5,5,17,21,-4,17
FC Botosani,9949,4,4,4,6,6,13,-7,16
Concordia Ch,9949,5,4,2,8,18,21,-3,14
D Bucuresti,9949,6,3,4,7,16,21,-5,13
FCSB,9950,1,7,6,1,24,12,12,27
CFR Cluj,9950,2,6,7,1,16,9,7,25
Universitate,9950,3,4,5,5,16,20,-4,17
D Bucuresti,9950,4,4,4,6,20,21,-1,16
FC Botosani,9950,5,4,4,6,8,16,-8,16
Concordia Ch,9950,6,3,2,9,18,24,-6,11
FCSB,9951,1,9,5,0,30,12,18,32
CFR Cluj,9951,2,5,7,2,13,8,5,22
FC Botosani,9951,3,4,4,6,8,13,-5,16
Universitate,9951,4,3,6,5,16,24,-8,15
D Bucuresti,9951,5,3,5,6,17,22,-5,14
Concordia Ch,9951,6,3,3,8,17,22,-5,12
FCSB,9952,1,7,7,0,23,10,13,28
CFR Cluj,9952,2,6,7,1,15,7,8,25
D Bucuresti,9952,3,4,5,5,17,18,-1,17
FC Botosani,9952,4,4,5,5,7,13,-6,17
Universitate,9952,5,3,6,5,14,20,-6,15
Concordia Ch,9952,6,2,2,10,16,24,-8,8
FCSB,9953,1,7,6,1,23,11,12,27
CFR Cluj,9953,2,5,8,1,13,7,6,23
Universitate,9953,3,4,6,4,15,18,-3,18
D Bucuresti,9953,4,4,5,5,19,19,0,17
FC Botosani,9953,5,3,4,7,5,15,-10,13
Concordia Ch,9953,6,3,3,8,17,22,-5,12
FCSB,9954,1,8,5,1,24,12,12,29
CFR Cluj,9954,2,6,6,2,15,8,7,24
D Bucuresti,9954,3,4,5,5,18,19,-1,17
Universitate,9954,4,4,5,5,16,20,-4,17
FC Botosani,9954,5,4,4,6,7,13,-6,16
Concordia Ch,9954,6,2,3,9,16,24,-8,9
FCSB,9955,1,9,5,0,29,12,17,32
CFR Cluj,9955,2,6,6,2,19,10,9,24
D Bucuresti,9955,3,4,4,6,19,20,-1,16
Concordia Ch,9955,4,4,2,8,19,23,-4,14
Universitate,9955,5,3,5,6,14,25,-11,14
FC Botosani,9955,6,3,4,7,6,16,-10,13
FCSB,9956,1,8,6,0,25,11,14,30
CFR Cluj,9956,2,6,6,2,14,8,6,24
D Bucuresti,9956,3,4,5,5,17,18,-1,17
FC Botosani,9956,4,4,5,5,8,13,-5,17
Universitate,9956,5,3,6,5,15,20,-5,15
Concordia Ch,9956,6,2,2,10,16,25,-9,8
FCSB,9957,1,7,7,0,24,11,13,28
CFR Cluj,9957,2,5,7,2,13,8,5,22
Universitate,9957,3,4,6,4,16,19,-3,18
D Bucuresti,9957,4,4,4,6,18,21,-3,16
FC Botosani,9957,5,4,4,6,9,16,-7,16
Concordia Ch,9957,6,3,2,9,19,24,-5,11
FCSB,9958,1,8,5,1,27,12,15,29
CFR Cluj,9958,2,7,6,1,16,8,8,27
D Bucuresti,9958,3,3,5,6,17,20,-3,14
Concordia Ch,9958,4,4,2,8,18,22,-4,14
Universitate,9958,5,3,5,6,14,22,-8,14
FC Botosani,9958,6,3,5,6,5,13,-8,14
CFR Cluj,9959,1,7,6,1,19,10,9,27
FCSB,9959,2,7,5,2,25,16,9,26
D Bucuresti,9959,3,4,5,5,20,20,0,17
Universitate,9959,4,4,5,5,19,22,-3,17
FC Botosani,9959,5,4,4,6,6,14,-8,16
Concordia Ch,9959,6,2,3,9,17,24,-7,9
CFR Cluj,9960,1,7,6,1,16,8,8,27
FCSB,9960,2,7,5,2,24,14,10,26
Universitate,9960,3,4,5,5,16,19,-3,17
D Bucuresti,9960,4,4,4,6,17,19,-2,16
FC Botosani,9960,5,3,5,6,5,13,-8,14
Concordia Ch,9960,6,3,3,8,16,21,-5,12
FCSB,9961,1,7,7,0,26,13,13,28
CFR Cluj,9961,2,6,7,1,14,7,7,25
FC Botosani,9961,3,4,5,5,7,12,-5,17
Universitate,9961,4,3,6,5,17,22,-5,15
D Bucuresti,9961,5,3,4,7,16,21,-5,13
Concordia Ch,9961,6,3,3,8,16,21,-5,12
FCSB,9962,1,7,5,2,23,12,11,26
CFR Cluj,9962,2,6,6,2,15,10,5,24
Universitate,9962,3,5,5,4,18,19,-1,20
FC Botosani,9962,4,4,4,6,7,14,-7,16
Concordia Ch,9962,5,4,2,8,18,22,-4,14
D Bucuresti,9962,6,3,4,7,18,22,-4,13
FCSB,9963,1,7,7,0,23,10,13,28
CFR Cluj,9963,2,6,7,1,14,7,7,25
D Bucuresti,9963,3,5,4,5,22,21,1,19
FC Botosani,9963,4,4,4,6,7,15,-8,16
Universitate,9963,5,3,6,5,14,19,-5,15
Concordia Ch,9963,6,2,2,10,19,27,-8,8
FCSB,9964,1,7,6,1,24,13,11,27
CFR Cluj,9964,2,7,6,1,16,7,9,27
FC Botosani,9964,3,5,4,5,12,13,-1,19
D Bucuresti,9964,4,4,4,6,19,22,-3,16
Universitate,9964,5,3,6,5,15,20,-5,15
Concordia Ch,9964,6,2,2,10,16,27,-11,8
FCSB,9965,1,8,6,0,25,11,14,30
CFR Cluj,9965,2,5,8,1,15,9,6,23
D Bucuresti,9965,3,5,4,5,19,18,1,19
FC Botosani,9965,4,4,4,6,6,14,-8,16
Universitate,9965,5,3,6,5,15,20,-5,15
Concordia Ch,9965,6,2,2,10,15,23,-8,8
FCSB,9966,1,8,5,1,27,12,15,29
CFR Cluj,9966,2,5,6,3,15,14,1,21
Universitate,9966,3,5,5,4,18,19,-1,20
D Bucuresti,9966,4,3,5,6,17,20,-3,14
Concordia Ch,9966,5,4,2,8,18,22,-4,14
FC Botosani,9966,6,3,5,6,5,13,-8,14
FCSB,9967,1,8,6,0,27,12,15,30
CFR Cluj,9967,2,6,6,2,15,10,5,24
D Bucuresti,9967,3,4,4,6,20,20,0,16
FC Botosani,9967,4,4,4,6,6,15,-9,16
Universitate,9967,5,3,6,5,15,20,-5,15
Concordia Ch,9967,6,3,2,9,17,23,-6,11
FCSB,9968,1,7,7,0,24,11,13,28
CFR Cluj,9968,2,5,7,2,13,8,5,22
Universitate,9968,3,4,6,4,16,19,-3,18
FC Botosani,9968,4,4,4,6,7,17,-10,16
D Bucuresti,9968,5,3,5,6,17,21,-4,14
Concordia Ch,9968,6,3,3,8,21,22,-1,12
FCSB,9969,1,8,5,1,26,12,14,29
CFR Cluj,9969,2,6,6,2,14,10,4,24
D Bucuresti,9969,3,5,4,5,19,18,1,19
Universitate,9969,4,4,5,5,16,19,-3,17
FC Botosani,9969,5,4,4,6,6,13,-7,16
Concordia Ch,9969,6,2,2,10,15,24,-9,8
FCSB,9970,1,7,6,1,24,12,12,27
CFR Cluj,9970,2,5,7,2,15,10,5,22
Universitate,9970,3,5,5,4,17,19,-2,20
FC Botosani,9970,4,5,4,5,7,12,-5,19
D Bucuresti,9970,5,3,4,7,17,22,-5,13
Concordia Ch,9970,6,3,2,9,18,23,-5,11
FCSB,9971,1,9,5,0,28,11,17,32
CFR Cluj,9971,2,5,7,2,14,9,5,22
D Bucuresti,9971,3,4,5,5,20,21,-1,17
Universitate,9971,4,3,6,5,14,21,-7,15
FC Botosani,9971,5,3,5,6,6,14,-8,14
Concordia Ch,9971,6,3,2,9,18,24,-6,11
FCSB,9972,1,8,5,1,26,14,12,29
CFR Cluj,9972,2,6,6,2,16,9,7,24
Universitate,9972,3,4,5,5,18,22,-4,17
FC Botosani,9972,4,4,5,5,7,13,-6,17
D Bucuresti,9972,5,4,4,6,20,20,0,16
Concordia Ch,9972,6,2,3,9,15,24,-9,9
FCSB,9973,1,7,6,1,26,15,11,27
CFR Cluj,9973,2,5,7,2,15,11,4,22
Universitate,9973,3,5,5,4,21,21,0,20
Concordia Ch,9973,4,4,2,8,18,21,-3,14
D Bucuresti,9973,5,3,5,6,17,20,-3,14
FC Botosani,9973,6,3,5,6,6,15,-9,14
FCSB,9974,1,8,6,0,26,11,15,30
CFR Cluj,9974,2,6,6,2,15,9,6,24
FC Botosani,9974,3,4,5,5,8,13,-5,17
Universitate,9974,4,3,6,5,15,21,-6,15
D Bucuresti,9974,5,3,5,6,17,20,-3,14
Concordia Ch,9974,6,3,2,9,18,25,-7,11
FCSB,9975,1,8,6,0,24,10,14,30
CFR Cluj,9975,2,5,6,3,14,11,3,21
Universitate,9975,3,4,6,4,17,19,-2,18
FC Botosani,9975,4,4,4,6,6,15,-9,16
Concordia Ch,9975,5,4,2,8,20,22,-2,14
D Bucuresti,9975,6,3,4,7,17,21,-4,13
FCSB,9976,1,9,5,0,25,10,15,32
CFR Cluj,9976,2,6,6,2,15,9,6,24
FC Botosani,9976,3,4,5,5,7,12,-5,17
D Bucuresti,9976,4,3,5,6,16,19,-3,14
Universitate,9976,5,3,5,6,15,21,-6,14
Concordia Ch,9976,6,3,2,9,16,23,-7,11
FCSB,9977,1,8,5,1,25,12,13,29
CFR Cluj,9977,2,6,6,2,16,10,6,24
Universitate,9977,3,4,5,5,17,21,-4,17
FC Botosani,9977,4,4,5,5,6,12,-6,17
D Bucuresti,9977,5,4,4,6,18,20,-2,16
Concordia Ch,9977,6,2,3,9,16,23,-7,9
FCSB,9978,1,8,5,1,26,15,11,29
CFR Cluj,9978,2,7,6,1,19,9,10,27
D Bucuresti,9978,3,5,4,5,19,19,0,19
FC Botosani,9978,4,4,4,6,9,14,-5,16
Universitate,9978,5,3,5,6,16,22,-6,14
Concordia Ch,9978,6,2,2,10,17,27,-10,8
FCSB,9979,1,8,6,0,25,11,14,30
CFR Cluj,9979,2,6,7,1,16,9,7,25
D Bucuresti,9979,3,4,4,6,18,20,-2,16
FC Botosani,9979,4,4,4,6,8,14,-6,16
Universitate,9979,5,3,5,6,15,21,-6,14
Concordia Ch,9979,6,3,2,9,16,23,-7,11
FCSB,9980,1,7,5,2,26,15,11,26
CFR Cluj,9980,2,6,6,2,15,9,6,24
Universitate,9980,3,5,5,4,18,20,-2,20
D Bucuresti,9980,4,5,4,5,23,21,2,19
FC Botosani,9980,5,4,4,6,8,15,-7,16
Concordia Ch,9980,6,2,2,10,16,26,-10,8
FCSB,9981,1,8,6,0,25,11,14,30
CFR Cluj,9981,2,6,7,1,16,7,9,25
D Bucuresti,9981,3,4,4,6,20,21,-1,16
Concordia Ch,9981,4,4,2,8,20,23,-3,14
Universitate,9981,5,3,5,6,15,23,-8,14
FC Botosani,9981,6,3,4,7,7,18,-11,13
FCSB,9982,1,8,5,1,27,15,12,29
CFR Cluj,9982,2,7,6,1,19,8,11,27
FC Botosani,9982,3,4,5,5,10,15,-5,17
D Bucuresti,9982,4,3,5,6,18,22,-4,14
Universitate,9982,5,3,5,6,16,24,-8,14
Concordia Ch,9982,6,3,2,9,18,24,-6,11
FCSB,9983,1,8,6,0,27,13,14,30
CFR Cluj,9983,2,5,7,2,15,10,5,22
D Bucuresti,9983,3,5,4,5,20,18,2,19
Universitate,9983,4,3,7,4,17,21,-4,16
FC Botosani,9983,5,3,4,7,6,16,-10,13
Concordia Ch,9983,6,3,2,9,17,24,-7,11
FCSB,9984,1,8,5,1,24,11,13,29
CFR Cluj,9984,2,6,6,2,14,8,6,24
Universitate,9984,3,4,5,5,15,19,-4,17
FC Botosani,9984,4,4,5,5,9,13,-4,17
D Bucuresti,9984,5,3,6,5,17,19,-2,15
Concordia Ch,9984,6,2,3,9,15,24,-9,9
FCSB,9985,1,8,6,0,25,11,14,30
CFR Cluj,9985,2,6,7,1,15,8,7,25
FC Botosani,9985,3,3,6,5,7,14,-7,15
D Bucuresti,9985,4,3,5,6,17,20,-3,14
Universitate,9985,5,3,5,6,16,22,-6,14
Concordia Ch,9985,6,3,3,8,17,22,-5,12
FCSB,9986,1,7,5,2,24,15,9,26
CFR Cluj,9986,2,6,6,2,17,10,7,24
Universitate,9986,3,5,5,4,18,19,-1,20
D Bucuresti,9986,4,5,4,5,20,19,1,19
FC Botosani,9986,5,4,4,6,6,13,-7,16
Concordia Ch,9986,6,2,2,10,16,25,-9,8
FCSB,9987,1,8,6,0,28,11,17,30
CFR Cluj,9987,2,5,7,2,14,11,3,22
Universitate,9987,3,4,5,5,17,22,-5,17
FC Botosani,9987,4,4,4,6,8,13,-5,16
Concordia Ch,9987,5,4,2,8,20,22,-2,14
D Bucuresti,9987,6,3,4,7,17,25,-8,13
FCSB,9988,1,8,6,0,27,12,15,30
CFR Cluj,9988,2,5,7,2,15,10,5,22
D Bucuresti,9988,3,5,4,5,20,18,2,19
Universitate,9988,4,4,5,5,15,20,-5,17
FC Botosani,9988,5,4,4,6,7,14,-7,16
Concordia Ch,9988,6,2,2,10,16,26,-10,8
FCSB,9989,1,8,6,0,26,11,15,30
CFR Cluj,9989,2,5,7,2,13,9,4,22
D Bucuresti,9989,3,5,4,5,23,21,2,19
Universitate,9989,4,3,7,4,15,19,-4,16
FC Botosani,9989,5,3,4,7,7,16,-9,13
Concordia Ch,9989,6,3,2,9,17,25,-8,11
FCSB,9990,1,8,6,0,26,11,15,30
CFR Cluj,9990,2,5,6,3,13,10,3,21
FC Botosani,9990,3,5,4,5,9,13,-4,19
Universitate,9990,4,4,6,4,16,19,-3,18
D Bucuresti,9990,5,3,4,7,17,21,-4,13
Concordia Ch,9990,6,3,2,9,16,23,-7,11
FCSB,9991,1,8,5,1,25,12,13,29
CFR Cluj,9991,2,7,6,1,15,7,8,27
D Bucuresti,9991,3,4,5,5,19,19,0,17
FC Botosani,9991,4,4,4,6,8,14,-6,16
Universitate,9991,5,3,5,6,15,21,-6,14
Concordia Ch,9991,6,2,3,9,16,25,-9,9
FCSB,9992,1,7,5,2,24,14,10,26
CFR Cluj,9992,2,6,6,2,15,9,6,24
Universitate,9992,3,5,5,4,18,19,-1,20
D Bucuresti,9992,4,5,4,5,18,18,0,19
FC Botosani,9992,5,4,4,6,7,14,-7,16
Concordia Ch,9992,6,2,2,10,16,24,-8,8
FCSB,9993,1,7,5,2,25,19,6,26
CFR Cluj,9993,2,6,7,1,17,9,8,25
Universitate,9993,3,4,6,4,21,20,1,18
D Bucuresti,9993,4,4,5,5,21,21,0,17
FC Botosani,9993,5,3,4,7,8,18,-10,13
Concordia Ch,9993,6,3,3,8,20,25,-5,12
FCSB,9994,1,8,6,0,25,11,14,30
CFR Cluj,9994,2,6,6,2,16,9,7,24
D Bucuresti,9994,3,5,4,5,22,20,2,19
Universitate,9994,4,3,6,5,14,20,-6,15
FC Botosani,9994,5,3,5,6,6,15,-9,14
Concordia Ch,9994,6,2,3,9,16,24,-8,9
FCSB,9995,1,7,7,0,25,12,13,28
CFR Cluj,9995,2,6,7,1,18,8,10,25
D Bucuresti,9995,3,4,5,5,19,19,0,17
FC Botosani,9995,4,4,4,6,7,15,-8,16
Universitate,9995,5,3,6,5,15,23,-8,15
Concordia Ch,9995,6,2,3,9,17,24,-7,9
FCSB,9996,1,7,5,2,23,12,11,26
CFR Cluj,9996,2,6,7,1,14,7,7,25
D Bucuresti,9996,3,5,4,5,21,20,1,19
Universitate,9996,4,4,6,4,15,18,-3,18
FC Botosani,9996,5,3,5,6,7,15,-8,14
Concordia Ch,9996,6,2,3,9,19,27,-8,9
FCSB,9997,1,8,6,0,25,11,14,30
CFR Cluj,9997,2,6,6,2,15,9,6,24
FC Botosani,9997,3,4,4,6,7,14,-7,16
Universitate,9997,4,3,6,5,14,19,-5,15
Concordia Ch,9997,5,4,2,8,19,22,-3,14
D Bucuresti,9997,6,3,4,7,17,22,-5,13
FCSB,9998,1,9,5,0,27,11,16,32
CFR Cluj,9998,2,6,6,2,14,9,5,24
D Bucuresti,9998,3,4,4,6,21,20,1,16
Universitate,9998,4,3,5,6,15,21,-6,14
FC Botosani,9998,5,3,5,6,8,19,-11,14
Concordia Ch,9998,6,3,3,8,20,25,-5,12
FCSB,9999,1,9,5,0,27,11,16,32
CFR Cluj,9999,2,5,6,3,14,10,4,21
FC Botosani,9999,3,5,4,5,9,12,-3,19
Universitate,9999,4,4,5,5,15,20,-5,17
D Bucuresti,9999,5,3,4,7,16,22,-6,13
Concordia Ch,9999,6,3,2,9,17,23,-6,11
