team,n,rank,w,d,l,gf,ga,gd,pts
Loko Moscow,0,1,11,6,3,31,15,16,39
Spart Moscow,0,2,11,5,4,41,27,14,38
CSKA Moscow,0,3,11,3,6,33,18,15,36
Zenit,0,4,8,9,3,23,14,9,33
Krasnodar,0,5,9,5,6,31,26,5,32
Terek Grozny,0,6,7,6,7,20,23,-3,27
FK Rubin,0,7,5,7,8,22,18,4,22
Din Moscow,0,8,5,7,8,17,23,-6,22
Rostov,0,9,4,6,10,10,19,-9,18
Amkar,0,10,4,5,11,11,26,-15,17
Anzhi,0,11,3,5,12,15,45,-30,14
Loko Moscow,1,1,11,6,3,30,14,16,39
CSKA Moscow,1,2,11,3,6,27,18,9,36
Spart Moscow,1,3,10,5,5,38,26,12,35
Zenit,1,4,9,8,3,24,13,11,35
Krasnodar,1,5,9,5,6,31,25,6,32
Terek Grozny,1,6,7,7,6,24,26,-2,28
Din Moscow,1,7,5,7,8,17,23,-6,22
FK Rubin,1,8,5,6,9,21,20,1,21
Rostov,1,9,5,6,9,11,17,-6,21
Amkar,1,10,4,5,11,12,28,-16,17
Anzhi,1,11,2,6,12,15,40,-25,12
Spart Moscow,2,1,11,5,4,43,26,17,38
Loko Moscow,2,2,11,5,4,30,15,15,38
CSKA Moscow,2,3,11,4,5,29,19,10,37
Zenit,2,4,8,9,3,23,13,10,33
Krasnodar,2,5,9,5,6,29,25,4,32
Terek Grozny,2,6,8,5,7,22,24,-2,29
FK Rubin,2,7,6,6,8,23,17,6,24
Din Moscow,2,8,5,6,9,17,26,-9,21
Amkar,2,9,5,4,11,12,26,-14,19
Rostov,2,10,4,6,10,10,21,-11,18
Anzhi,2,11,2,5,13,16,42,-26,11
Loko Moscow,3,1,12,6,2,33,14,19,42
CSKA Moscow,3,2,11,3,6,27,20,7,36
Zenit,3,3,8,8,4,24,15,9,32
Spart Moscow,3,4,8,6,6,35,29,6,30
Krasnodar,3,5,8,5,7,32,30,2,29
Terek Grozny,3,6,7,6,7,22,27,-5,27
FK Rubin,3,7,7,5,8,29,21,8,26
Din Moscow,3,8,5,7,8,19,26,-7,22
Amkar,3,9,6,4,10,13,22,-9,22
Rostov,3,10,5,6,9,12,18,-6,21
Anzhi,3,11,2,6,12,17,41,-24,12
Loko Moscow,4,1,12,5,3,31,14,17,41
CSKA Moscow,4,2,11,3,6,27,19,8,36
Zenit,4,3,8,8,4,24,16,8,32
Spart Moscow,4,4,9,5,6,36,29,7,32
Krasnodar,4,5,9,4,7,29,25,4,31
Terek Grozny,4,6,8,6,6,25,24,1,30
FK Rubin,4,7,7,5,8,24,17,7,26
Rostov,4,8,5,6,9,12,17,-5,21
Din Moscow,4,9,5,6,9,17,25,-8,21
Amkar,4,10,5,5,10,13,25,-12,20
Anzhi,4,11,2,5,13,14,41,-27,11
Loko Moscow,5,1,12,5,3,30,12,18,41
CSKA Moscow,5,2,11,4,5,29,20,9,37
Spart Moscow,5,3,10,6,4,37,27,10,36
Krasnodar,5,4,9,4,7,28,26,2,31
Zenit,5,5,7,8,5,22,16,6,29
Terek Grozny,5,6,8,5,7,22,24,-2,29
FK Rubin,5,7,7,5,8,26,19,7,26
Din Moscow,5,8,5,7,8,20,25,-5,22
Amkar,5,9,5,4,11,11,24,-13,19
Rostov,5,10,4,6,10,11,19,-8,18
Anzhi,5,11,2,6,12,16,40,-24,12
Loko Moscow,6,1,12,6,2,32,13,19,42
CSKA Moscow,6,2,11,3,6,27,20,7,36
Spart Moscow,6,3,10,5,5,40,28,12,35
Zenit,6,4,8,9,3,24,14,10,33
Krasnodar,6,5,8,5,7,28,26,2,29
Terek Grozny,6,6,8,5,7,22,23,-1,29
Din Moscow,6,7,6,7,7,21,24,-3,25
FK Rubin,6,8,5,7,8,22,18,4,22
Amkar,6,9,5,4,11,10,25,-15,19
Rostov,6,10,4,6,10,10,19,-9,18
Anzhi,6,11,2,5,13,15,41,-26,11
Loko Moscow,7,1,13,5,2,33,13,20,44
CSKA Moscow,7,2,12,3,5,31,20,11,39
Spart Moscow,7,3,9,5,6,38,31,7,32
Krasnodar,7,4,9,4,7,30,26,4,31
Zenit,7,5,7,8,5,23,17,6,29
Terek Grozny,7,6,7,6,7,21,25,-4,27
Din Moscow,7,7,6,6,8,20,24,-4,24
FK Rubin,7,8,6,5,9,22,19,3,23
Amkar,7,9,5,5,10,11,23,-12,20
Rostov,7,10,4,6,10,12,20,-8,18
Anzhi,7,11,3,5,12,18,41,-23,14
Loko Moscow,8,1,13,5,2,33,11,22,44
CSKA Moscow,8,2,12,3,5,29,17,12,39
Spart Moscow,8,3,11,5,4,43,28,15,38
Krasnodar,8,4,9,4,7,29,27,2,31
Zenit,8,5,7,8,5,21,16,5,29
Terek Grozny,8,6,7,6,7,21,24,-3,27
Din Moscow,8,7,6,6,8,19,24,-5,24
FK Rubin,8,8,5,5,10,22,20,2,20
Rostov,8,9,4,6,10,11,22,-11,18
Amkar,8,10,4,5,11,10,24,-14,17
Anzhi,8,11,3,5,12,16,41,-25,14
Loko Moscow,9,1,13,5,2,34,14,20,44
CSKA Moscow,9,2,12,3,5,33,19,14,39
Spart Moscow,9,3,10,6,4,40,27,13,36
Zenit,9,4,7,8,5,22,17,5,29
Krasnodar,9,5,8,5,7,30,28,2,29
Terek Grozny,9,6,8,5,7,22,24,-2,29
Din Moscow,9,7,6,7,7,23,22,1,25
FK Rubin,9,8,5,6,9,21,22,-1,21
Amkar,9,9,5,4,11,12,27,-15,19
Rostov,9,10,4,6,10,10,18,-8,18
Anzhi,9,11,2,5,13,15,44,-29,11
Loko Moscow,10,1,12,6,2,31,12,19,42
CSKA Moscow,10,2,11,3,6,27,19,8,36
Spart Moscow,10,3,10,5,5,40,30,10,35
Zenit,10,4,8,9,3,23,14,9,33
Terek Grozny,10,5,9,5,6,22,22,0,32
Krasnodar,10,6,8,5,7,27,25,2,29
FK Rubin,10,7,6,6,8,24,17,7,24
Din Moscow,10,8,6,6,8,19,25,-6,24
Rostov,10,9,4,6,10,12,20,-8,18
Amkar,10,10,4,4,12,10,26,-16,16
Anzhi,10,11,2,5,13,15,40,-25,11
Loko Moscow,11,1,12,5,3,33,15,18,41
CSKA Moscow,11,2,10,5,5,29,21,8,35
Spart Moscow,11,3,9,6,5,39,30,9,33
Zenit,11,4,8,9,3,24,15,9,33
Terek Grozny,11,5,8,5,7,22,24,-2,29
Krasnodar,11,6,8,4,8,29,28,1,28
Din Moscow,11,7,6,7,7,20,23,-3,25
FK Rubin,11,8,6,5,9,22,18,4,23
Amkar,11,9,6,4,10,13,24,-11,22
Rostov,11,10,4,6,10,11,20,-9,18
Anzhi,11,11,2,6,12,17,41,-24,12
Loko Moscow,12,1,12,5,3,31,14,17,41
Spart Moscow,12,2,10,6,4,41,27,14,36
CSKA Moscow,12,3,10,4,6,28,21,7,34
Krasnodar,12,4,10,4,6,32,26,6,34
Zenit,12,5,8,8,4,23,15,8,32
Terek Grozny,12,6,7,5,8,21,25,-4,26
FK Rubin,12,7,6,5,9,24,19,5,23
Din Moscow,12,8,5,6,9,17,25,-8,21
Rostov,12,9,4,7,9,12,19,-7,19
Amkar,12,10,5,4,11,11,27,-16,19
Anzhi,12,11,3,6,11,17,39,-22,15
Loko Moscow,13,1,12,5,3,32,15,17,41
CSKA Moscow,13,2,11,3,6,28,18,10,36
Zenit,13,3,9,8,3,25,14,11,35
Spart Moscow,13,4,10,5,5,38,29,9,35
Krasnodar,13,5,9,4,7,30,27,3,31
Terek Grozny,13,6,8,6,6,23,23,0,30
Din Moscow,13,7,6,6,8,18,23,-5,24
FK Rubin,13,8,5,5,10,22,20,2,20
Amkar,13,9,5,5,10,13,23,-10,20
Rostov,13,10,4,6,10,10,19,-9,18
Anzhi,13,11,2,5,13,15,43,-28,11
Loko Moscow,14,1,11,6,3,29,12,17,39
CSKA Moscow,14,2,12,3,5,31,17,14,39
Spart Moscow,14,3,9,6,5,35,27,8,33
Krasnodar,14,4,9,4,7,28,25,3,31
Zenit,14,5,7,9,4,21,16,5,30
Terek Grozny,14,6,7,6,7,21,27,-6,27
Din Moscow,14,7,6,7,7,19,22,-3,25
FK Rubin,14,8,6,5,9,23,19,4,23
Amkar,14,9,5,5,10,12,23,-11,20
Rostov,14,10,4,6,10,10,19,-9,18
Anzhi,14,11,3,5,12,18,40,-22,14
Loko Moscow,15,1,11,6,3,30,13,17,39
CSKA Moscow,15,2,11,3,6,30,20,10,36
Spart Moscow,15,3,9,7,4,35,26,9,34
Krasnodar,15,4,10,4,6,31,26,5,34
Zenit,15,5,8,9,3,23,14,9,33
Terek Grozny,15,6,7,6,7,20,23,-3,27
FK Rubin,15,7,6,5,9,24,20,4,23
Din Moscow,15,8,5,7,8,19,24,-5,22
Rostov,15,9,4,6,10,10,18,-8,18
Amkar,15,10,4,6,10,9,22,-13,18
Anzhi,15,11,3,5,12,16,41,-25,14
Loko Moscow,16,1,12,6,2,31,12,19,42
CSKA Moscow,16,2,10,4,6,28,21,7,34
Zenit,16,3,8,9,3,23,14,9,33
Spart Moscow,16,4,9,6,5,38,30,8,33
Krasnodar,16,5,8,5,7,30,28,2,29
Terek Grozny,16,6,7,5,8,20,24,-4,26
FK Rubin,16,7,6,6,8,24,19,5,24
Din Moscow,16,8,5,7,8,19,24,-5,22
Amkar,16,9,6,4,10,12,23,-11,22
Rostov,16,10,4,6,10,11,19,-8,18
Anzhi,16,11,3,6,11,17,39,-22,15
Loko Moscow,17,1,12,5,3,33,15,18,41
Zenit,17,2,9,8,3,26,15,11,35
CSKA Moscow,17,3,10,4,6,26,20,6,34
Terek Grozny,17,4,9,5,6,23,23,0,32
Spart Moscow,17,5,8,7,5,34,27,7,31
Krasnodar,17,6,8,5,7,29,27,2,29
FK Rubin,17,7,6,6,8,24,19,5,24
Din Moscow,17,8,5,7,8,19,24,-5,22
Rostov,17,9,4,7,9,10,17,-7,19
Amkar,17,10,5,4,11,10,23,-13,19
Anzhi,17,11,2,6,12,16,40,-24,12
Loko Moscow,18,1,11,6,3,31,16,15,39
Spart Moscow,18,2,10,6,4,39,26,13,36
Zenit,18,3,8,9,3,26,17,9,33
CSKA Moscow,18,4,10,3,7,29,23,6,33
Krasnodar,18,5,9,5,6,30,24,6,32
Terek Grozny,18,6,8,5,7,22,24,-2,29
FK Rubin,18,7,5,7,8,22,18,4,22
Din Moscow,18,8,5,7,8,18,23,-5,22
Rostov,18,9,4,6,10,10,21,-11,18
Amkar,18,10,4,5,11,11,25,-14,17
Anzhi,18,11,4,5,11,18,39,-21,17
Loko Moscow,19,1,11,5,4,29,14,15,38
Spart Moscow,19,2,11,5,4,41,27,14,38
CSKA Moscow,19,3,11,3,6,27,19,8,36
Zenit,19,4,9,8,3,24,13,11,35
Krasnodar,19,5,10,4,6,31,24,7,34
Terek Grozny,19,6,7,6,7,22,26,-4,27
Din Moscow,19,7,6,6,8,20,25,-5,24
FK Rubin,19,8,5,5,10,22,21,1,20
Amkar,19,9,5,4,11,12,24,-12,19
Rostov,19,10,4,6,10,10,20,-10,18
Anzhi,19,11,2,6,12,16,41,-25,12
Loko Moscow,20,1,12,6,2,31,12,19,42
CSKA Moscow,20,2,11,4,5,29,17,12,37
Spart Moscow,20,3,10,5,5,35,27,8,35
Zenit,20,4,7,10,3,22,14,8,31
Krasnodar,20,5,9,4,7,31,27,4,31
Terek Grozny,20,6,7,7,6,22,24,-2,28
Din Moscow,20,7,7,6,7,20,21,-1,27
FK Rubin,20,8,5,5,10,23,22,1,20
Rostov,20,9,4,6,10,10,18,-8,18
Amkar,20,10,4,5,11,10,24,-14,17
Anzhi,20,11,2,6,12,15,42,-27,12
Loko Moscow,21,1,11,5,4,31,18,13,38
CSKA Moscow,21,2,11,3,6,29,20,9,36
Zenit,21,3,9,8,3,27,15,12,35
Spart Moscow,21,4,9,6,5,38,32,6,33
Terek Grozny,21,5,9,5,6,26,23,3,32
Krasnodar,21,6,9,4,7,31,27,4,31
FK Rubin,21,7,7,5,8,24,18,6,26
Din Moscow,21,8,5,7,8,19,24,-5,22
Rostov,21,9,5,6,9,14,18,-4,21
Amkar,21,10,4,4,12,10,26,-16,16
Anzhi,21,11,2,5,13,16,44,-28,11
Loko Moscow,22,1,11,7,2,30,12,18,40
Spart Moscow,22,2,11,5,4,41,26,15,38
CSKA Moscow,22,3,11,3,6,27,19,8,36
Zenit,22,4,7,9,4,21,14,7,30
Krasnodar,22,5,8,6,6,30,27,3,30
Terek Grozny,22,6,7,6,7,21,24,-3,27
FK Rubin,22,7,6,6,8,25,19,6,24
Din Moscow,22,8,5,6,9,17,25,-8,21
Amkar,22,9,5,4,11,10,25,-15,19
Rostov,22,10,4,6,10,11,20,-9,18
Anzhi,22,11,3,6,11,17,39,-22,15
Loko Moscow,23,1,13,5,2,32,12,20,44
Spart Moscow,23,2,11,5,4,39,26,13,38
CSKA Moscow,23,3,11,3,6,29,21,8,36
Zenit,23,4,8,8,4,25,17,8,32
Krasnodar,23,5,9,4,7,29,26,3,31
Terek Grozny,23,6,8,5,7,23,25,-2,29
Din Moscow,23,7,6,6,8,19,24,-5,24
FK Rubin,23,8,5,5,10,22,20,2,20
Amkar,23,9,5,4,11,12,25,-13,19
Rostov,23,10,4,6,10,10,19,-9,18
Anzhi,23,11,2,5,13,15,40,-25,11
Loko Moscow,24,1,12,5,3,33,13,20,41
CSKA Moscow,24,2,12,3,5,30,17,13,39
Krasnodar,24,3,10,4,6,30,25,5,34
Spart Moscow,24,4,9,6,5,36,27,9,33
Terek Grozny,24,5,8,6,6,25,24,1,30
Zenit,24,6,7,8,5,21,18,3,29
FK Rubin,24,7,6,5,9,24,20,4,23
Din Moscow,24,8,5,6,9,19,26,-7,21
Amkar,24,9,5,5,10,11,23,-12,20
Rostov,24,10,4,7,9,11,18,-7,19
Anzhi,24,11,2,5,13,15,44,-29,11
Loko Moscow,25,1,12,5,3,33,12,21,41
CSKA Moscow,25,2,11,4,5,28,18,10,37
Spart Moscow,25,3,9,6,5,39,31,8,33
Krasnodar,25,4,9,4,7,29,30,-1,31
Terek Grozny,25,5,8,6,6,23,24,-1,30
Zenit,25,6,7,8,5,22,20,2,29
FK Rubin,25,7,6,6,8,29,20,9,24
Din Moscow,25,8,5,7,8,20,25,-5,22
Rostov,25,9,5,6,9,12,18,-6,21
Amkar,25,10,4,6,10,12,25,-13,18
Anzhi,25,11,2,6,12,16,40,-24,12
Loko Moscow,26,1,11,7,2,30,12,18,40
CSKA Moscow,26,2,11,4,5,27,17,10,37
Spart Moscow,26,3,10,5,5,37,29,8,35
Krasnodar,26,4,9,5,6,32,25,7,32
Zenit,26,5,7,10,3,21,13,8,31
Terek Grozny,26,6,8,6,6,23,23,0,30
Din Moscow,26,7,6,6,8,20,25,-5,24
FK Rubin,26,8,6,5,9,24,21,3,23
Rostov,26,9,4,6,10,11,19,-8,18
Amkar,26,10,4,4,12,9,25,-16,16
Anzhi,26,11,2,6,12,15,40,-25,12
Loko Moscow,27,1,11,6,3,30,13,17,39
CSKA Moscow,27,2,11,4,5,27,18,9,37
Spart Moscow,27,3,10,6,4,41,28,13,36
Terek Grozny,27,4,9,5,6,26,24,2,32
Zenit,27,5,7,10,3,22,14,8,31
Krasnodar,27,6,9,4,7,29,26,3,31
FK Rubin,27,7,7,5,8,25,18,7,26
Din Moscow,27,8,5,6,9,18,27,-9,21
Rostov,27,9,4,6,10,12,21,-9,18
Amkar,27,10,4,5,11,10,26,-16,17
Anzhi,27,11,2,5,13,16,41,-25,11
Loko Moscow,28,1,12,5,3,31,13,18,41
CSKA Moscow,28,2,11,4,5,27,18,9,37
Zenit,28,3,8,8,4,22,14,8,32
Spart Moscow,28,4,9,5,6,35,28,7,32
Krasnodar,28,5,8,4,8,28,28,0,28
Terek Grozny,28,6,7,7,6,22,24,-2,28
FK Rubin,28,7,7,5,8,26,18,8,26
Din Moscow,28,8,6,6,8,19,24,-5,24
Rostov,28,9,5,6,9,11,17,-6,21
Amkar,28,10,4,5,11,10,24,-14,17
Anzhi,28,11,2,7,11,17,40,-23,13
Loko Moscow,29,1,12,6,2,32,11,21,42
Spart Moscow,29,2,9,7,4,38,29,9,34
CSKA Moscow,29,3,10,4,6,27,23,4,34
Zenit,29,4,8,8,4,25,16,9,32
Terek Grozny,29,5,9,5,6,23,22,1,32
Krasnodar,29,6,8,5,7,28,26,2,29
FK Rubin,29,7,6,6,8,24,19,5,24
Din Moscow,29,8,5,7,8,19,24,-5,22
Rostov,29,9,4,7,9,11,18,-7,19
Amkar,29,10,4,5,11,11,25,-14,17
Anzhi,29,11,2,6,12,16,41,-25,12
CSKA Moscow,30,1,12,3,5,30,18,12,39
Loko Moscow,30,2,11,5,4,29,13,16,38
Krasnodar,30,3,10,4,6,31,24,7,34
Zenit,30,4,8,8,4,22,14,8,32
Spart Moscow,30,5,9,5,6,38,31,7,32
Terek Grozny,30,6,7,5,8,21,29,-8,26
FK Rubin,30,7,6,5,9,22,20,2,23
Amkar,30,8,6,4,10,15,22,-7,22
Rostov,30,9,5,6,9,13,19,-6,21
Din Moscow,30,10,5,6,9,18,25,-7,21
Anzhi,30,11,3,5,12,18,42,-24,14
Loko Moscow,31,1,12,5,3,32,15,17,41
CSKA Moscow,31,2,10,5,5,27,19,8,35
Spart Moscow,31,3,9,7,4,38,28,10,34
Krasnodar,31,4,9,4,7,31,27,4,31
Zenit,31,5,7,9,4,23,16,7,30
Terek Grozny,31,6,7,6,7,24,27,-3,27
Din Moscow,31,7,6,6,8,20,24,-4,24
FK Rubin,31,8,6,5,9,23,20,3,23
Amkar,31,9,5,5,10,15,27,-12,20
Rostov,31,10,4,7,9,10,17,-7,19
Anzhi,31,11,2,7,11,16,39,-23,13
Loko Moscow,32,1,11,7,2,30,12,18,40
CSKA Moscow,32,2,11,4,5,27,17,10,37
Spart Moscow,32,3,9,7,4,40,31,9,34
Krasnodar,32,4,9,5,6,29,25,4,32
Zenit,32,5,7,10,3,21,13,8,31
Terek Grozny,32,6,8,5,7,25,24,1,29
Din Moscow,32,7,6,7,7,21,24,-3,25
FK Rubin,32,8,5,5,10,22,20,2,20
Rostov,32,9,4,7,9,13,20,-7,19
Amkar,32,10,5,4,11,12,24,-12,19
Anzhi,32,11,2,5,13,14,44,-30,11
Loko Moscow,33,1,12,6,2,33,13,20,42
CSKA Moscow,33,2,11,4,5,30,20,10,37
Spart Moscow,33,3,9,5,6,34,27,7,32
Zenit,33,4,7,9,4,24,18,6,30
Krasnodar,33,5,8,5,7,28,26,2,29
Terek Grozny,33,6,7,7,6,21,23,-2,28
Din Moscow,33,7,6,7,7,19,22,-3,25
FK Rubin,33,8,6,6,8,23,18,5,24
Amkar,33,9,5,5,10,10,22,-12,20
Rostov,33,10,4,6,10,10,18,-8,18
Anzhi,33,11,2,6,12,16,41,-25,12
Loko Moscow,34,1,11,7,2,30,12,18,40
Spart Moscow,34,2,11,5,4,38,27,11,38
CSKA Moscow,34,3,11,4,5,27,17,10,37
Krasnodar,34,4,9,5,6,30,25,5,32
Zenit,34,5,7,10,3,22,14,8,31
Terek Grozny,34,6,8,5,7,25,27,-2,29
Din Moscow,34,7,5,7,8,19,24,-5,22
FK Rubin,34,8,5,6,9,23,21,2,21
Amkar,34,9,5,4,11,13,26,-13,19
Rostov,34,10,4,6,10,10,18,-8,18
Anzhi,34,11,2,5,13,16,42,-26,11
Loko Moscow,35,1,12,5,3,30,12,18,41
CSKA Moscow,35,2,11,4,5,29,19,10,37
Spart Moscow,35,3,10,5,5,38,29,9,35
Krasnodar,35,4,9,4,7,30,27,3,31
Zenit,35,5,7,8,5,21,16,5,29
Terek Grozny,35,6,8,5,7,22,24,-2,29
FK Rubin,35,7,7,5,8,26,19,7,26
Amkar,35,8,6,4,10,13,22,-9,22
Din Moscow,35,9,5,6,9,17,24,-7,21
Rostov,35,10,4,6,10,11,21,-10,18
Anzhi,35,11,2,6,12,17,41,-24,12
Loko Moscow,36,1,11,6,3,31,14,17,39
CSKA Moscow,36,2,11,3,6,28,20,8,36
Krasnodar,36,3,10,4,6,33,26,7,34
Zenit,36,4,8,9,3,24,15,9,33
Spart Moscow,36,5,9,5,6,36,29,7,32
Terek Grozny,36,6,7,6,7,22,25,-3,27
Din Moscow,36,7,5,7,8,19,24,-5,22
FK Rubin,36,8,5,6,9,22,21,1,21
Rostov,36,9,5,6,9,11,17,-6,21
Amkar,36,10,5,5,10,11,23,-12,20
Anzhi,36,11,3,5,12,17,40,-23,14
Loko Moscow,37,1,12,6,2,31,12,19,42
Spart Moscow,37,2,10,6,4,40,27,13,36
CSKA Moscow,37,3,10,4,6,27,21,6,34
Zenit,37,4,8,9,3,25,15,10,33
Krasnodar,37,5,9,4,7,31,26,5,31
Terek Grozny,37,6,7,6,7,20,24,-4,27
Din Moscow,37,7,5,7,8,18,26,-8,22
FK Rubin,37,8,5,6,9,23,22,1,21
Rostov,37,9,4,7,9,12,19,-7,19
Amkar,37,10,4,5,11,9,23,-14,17
Anzhi,37,11,3,6,11,17,38,-21,15
Loko Moscow,38,1,12,6,2,31,11,20,42
Spart Moscow,38,2,9,6,5,35,28,7,33
CSKA Moscow,38,3,10,3,7,26,22,4,33
Zenit,38,4,8,8,4,25,16,9,32
Krasnodar,38,5,8,5,7,27,25,2,29
Terek Grozny,38,6,7,6,7,21,24,-3,27
Din Moscow,38,7,6,6,8,19,22,-3,24
FK Rubin,38,8,6,5,9,22,19,3,23
Amkar,38,9,6,4,10,12,22,-10,22
Rostov,38,10,4,7,9,11,18,-7,19
Anzhi,38,11,3,6,11,16,38,-22,15
Loko Moscow,39,1,12,6,2,32,13,19,42
CSKA Moscow,39,2,11,3,6,29,20,9,36
Zenit,39,3,8,9,3,24,14,10,33
Spart Moscow,39,4,9,5,6,39,30,9,32
Krasnodar,39,5,9,4,7,31,27,4,31
Terek Grozny,39,6,8,5,7,23,25,-2,29
Din Moscow,39,7,7,6,7,21,23,-2,27
Amkar,39,8,6,4,10,14,25,-11,22
FK Rubin,39,9,5,5,10,23,22,1,20
Rostov,39,10,4,6,10,10,20,-10,18
Anzhi,39,11,2,5,13,16,43,-27,11
Loko Moscow,40,1,12,6,2,31,12,19,42
CSKA Moscow,40,2,12,3,5,31,20,11,39
Spart Moscow,40,3,9,5,6,34,28,6,32
Krasnodar,40,4,8,6,6,29,26,3,30
Zenit,40,5,7,8,5,22,16,6,29
Terek Grozny,40,6,7,6,7,22,25,-3,27
FK Rubin,40,7,5,7,8,23,19,4,22
Din Moscow,40,8,5,7,8,18,23,-5,22
Amkar,40,9,6,4,10,12,22,-10,22
Rostov,40,10,5,6,9,11,17,-6,21
Anzhi,40,11,2,6,12,18,43,-25,12
Loko Moscow,41,1,12,5,3,32,13,19,41
Spart Moscow,41,2,10,5,5,40,31,9,35
CSKA Moscow,41,3,10,5,5,29,21,8,35
Zenit,41,4,8,9,3,23,14,9,33
Terek Grozny,41,5,8,5,7,24,25,-1,29
Krasnodar,41,6,8,4,8,30,31,-1,28
FK Rubin,41,7,7,5,8,26,19,7,26
Amkar,41,8,6,4,10,15,24,-9,22
Din Moscow,41,9,5,6,9,18,25,-7,21
Rostov,41,10,4,6,10,11,20,-9,18
Anzhi,41,11,2,6,12,18,43,-25,12
Loko Moscow,42,1,13,5,2,31,11,20,44
Spart Moscow,42,2,11,5,4,42,26,16,38
CSKA Moscow,42,3,11,4,5,30,17,13,37
Krasnodar,42,4,9,4,7,31,26,5,31
Zenit,42,5,7,9,4,21,14,7,30
Terek Grozny,42,6,8,6,6,21,22,-1,30
FK Rubin,42,7,6,5,9,23,21,2,23
Din Moscow,42,8,5,6,9,18,25,-7,21
Rostov,42,9,4,6,10,10,21,-11,18
Amkar,42,10,4,5,11,9,24,-15,17
Anzhi,42,11,2,5,13,14,43,-29,11
Loko Moscow,43,1,12,6,2,32,13,19,42
CSKA Moscow,43,2,12,3,5,29,17,12,39
Spart Moscow,43,3,10,5,5,38,27,11,35
Krasnodar,43,4,9,5,6,30,26,4,32
Zenit,43,5,7,8,5,21,15,6,29
Terek Grozny,43,6,7,5,8,20,24,-4,26
Din Moscow,43,7,6,6,8,19,25,-6,24
Amkar,43,8,6,4,10,11,22,-11,22
FK Rubin,43,9,5,5,10,22,20,2,20
Rostov,43,10,4,6,10,11,19,-8,18
Anzhi,43,11,3,5,12,15,40,-25,14
Loko Moscow,44,1,12,5,3,30,12,18,41
Spart Moscow,44,2,10,6,4,40,26,14,36
CSKA Moscow,44,3,11,3,6,26,20,6,36
Krasnodar,44,4,10,4,6,30,25,5,34
Zenit,44,5,8,8,4,24,14,10,32
Terek Grozny,44,6,7,6,7,21,24,-3,27
Din Moscow,44,7,6,6,8,20,26,-6,24
FK Rubin,44,8,5,5,10,23,21,2,20
Rostov,44,9,4,6,10,10,20,-10,18
Amkar,44,10,4,6,10,9,22,-13,18
Anzhi,44,11,3,5,12,16,39,-23,14
Loko Moscow,45,1,11,7,2,30,12,18,40
Spart Moscow,45,2,11,5,4,40,26,14,38
CSKA Moscow,45,3,11,3,6,28,20,8,36
Zenit,45,4,8,9,3,22,13,9,33
Krasnodar,45,5,9,5,6,29,25,4,32
Terek Grozny,45,6,7,6,7,22,26,-4,27
Din Moscow,45,7,6,6,8,20,24,-4,24
FK Rubin,45,8,5,5,10,21,20,1,20
Rostov,45,9,4,6,10,10,19,-9,18
Amkar,45,10,4,5,11,9,24,-15,17
Anzhi,45,11,3,5,12,20,42,-22,14
Loko Moscow,46,1,12,5,3,30,12,18,41
Zenit,46,2,9,8,3,23,13,10,35
Spart Moscow,46,3,9,6,5,37,29,8,33
CSKA Moscow,46,4,10,3,7,26,20,6,33
Krasnodar,46,5,9,4,7,29,25,4,31
Terek Grozny,46,6,8,6,6,22,23,-1,30
Din Moscow,46,7,7,6,7,21,21,0,27
FK Rubin,46,8,5,5,10,21,22,-1,20
Rostov,46,9,4,6,10,11,19,-8,18
Amkar,46,10,4,6,10,12,25,-13,18
Anzhi,46,11,3,5,12,16,39,-23,14
Loko Moscow,47,1,13,5,2,34,12,22,44
CSKA Moscow,47,2,11,3,6,27,20,7,36
Zenit,47,3,8,8,4,25,16,9,32
Krasnodar,47,4,9,4,7,30,28,2,31
Spart Moscow,47,5,8,6,6,38,33,5,30
Terek Grozny,47,6,8,5,7,23,24,-1,29
Din Moscow,47,7,5,8,7,18,22,-4,23
FK Rubin,47,8,5,6,9,23,20,3,21
Rostov,47,9,5,6,9,14,20,-6,21
Amkar,47,10,5,4,11,12,25,-13,19
Anzhi,47,11,3,5,12,16,40,-24,14
Loko Moscow,48,1,11,6,3,30,13,17,39
CSKA Moscow,48,2,11,3,6,27,19,8,36
Spart Moscow,48,3,9,6,5,37,28,9,33
Zenit,48,4,8,8,4,22,14,8,32
Krasnodar,48,5,9,5,6,30,25,5,32
Terek Grozny,48,6,8,5,7,22,26,-4,29
FK Rubin,48,7,6,5,9,23,20,3,23
Amkar,48,8,6,4,10,14,22,-8,22
Din Moscow,48,9,5,6,9,18,26,-8,21
Rostov,48,10,4,7,9,11,18,-7,19
Anzhi,48,11,3,5,12,17,40,-23,14
Loko Moscow,49,1,11,6,3,31,14,17,39
CSKA Moscow,49,2,10,5,5,26,18,8,35
Spart Moscow,49,3,9,7,4,38,29,9,34
Zenit,49,4,8,9,3,22,13,9,33
Krasnodar,49,5,8,6,6,29,26,3,30
Terek Grozny,49,6,7,6,7,20,26,-6,27
FK Rubin,49,7,5,7,8,21,17,4,22
Din Moscow,49,8,5,7,8,18,23,-5,22
Rostov,49,9,4,7,9,12,19,-7,19
Amkar,49,10,4,6,10,10,23,-13,18
Anzhi,49,11,3,6,11,19,38,-19,15
Loko Moscow,50,1,12,6,2,33,13,20,42
Spart Moscow,50,2,11,5,4,39,27,12,38
CSKA Moscow,50,3,11,3,6,27,19,8,36
Krasnodar,50,4,9,5,6,29,24,5,32
Zenit,50,5,7,8,5,23,18,5,29
Terek Grozny,50,6,8,5,7,23,27,-4,29
FK Rubin,50,7,6,5,9,23,20,3,23
Din Moscow,50,8,5,6,9,18,24,-6,21
Amkar,50,9,5,4,11,12,24,-12,19
Rostov,50,10,4,6,10,12,20,-8,18
Anzhi,50,11,3,5,12,18,41,-23,14
Loko Moscow,51,1,12,5,3,30,12,18,41
CSKA Moscow,51,2,11,3,6,28,19,9,36
Krasnodar,51,3,10,4,6,29,24,5,34
Spart Moscow,51,4,9,6,5,39,30,9,33
Zenit,51,5,8,8,4,22,14,8,32
Terek Grozny,51,6,8,6,6,25,25,0,30
Din Moscow,51,7,7,6,7,21,23,-2,27
FK Rubin,51,8,5,5,10,21,19,2,20
Rostov,51,9,4,6,10,11,20,-9,18
Amkar,51,10,4,5,11,11,26,-15,17
Anzhi,51,11,2,6,12,17,42,-25,12
Loko Moscow,52,1,11,7,2,29,11,18,40
CSKA Moscow,52,2,11,3,6,29,19,10,36
Zenit,52,3,8,9,3,23,13,10,33
Spart Moscow,52,4,9,5,6,38,29,9,32
Krasnodar,52,5,9,5,6,30,26,4,32
Terek Grozny,52,6,8,5,7,22,24,-2,29
Din Moscow,52,7,7,6,7,22,24,-2,27
FK Rubin,52,8,5,5,10,24,22,2,20
Amkar,52,9,5,4,11,11,24,-13,19
Rostov,52,10,4,6,10,10,20,-10,18
Anzhi,52,11,3,5,12,15,41,-26,14
Loko Moscow,53,1,12,5,3,34,15,19,41
CSKA Moscow,53,2,11,4,5,28,17,11,37
Spart Moscow,53,3,9,6,5,38,28,10,33
Zenit,53,4,8,9,3,23,14,9,33
Krasnodar,53,5,9,4,7,31,29,2,31
Terek Grozny,53,6,7,6,7,21,25,-4,27
Din Moscow,53,7,6,7,7,19,22,-3,25
Amkar,53,8,6,4,10,14,24,-10,22
FK Rubin,53,9,5,5,10,22,20,2,20
Rostov,53,10,4,6,10,10,20,-10,18
Anzhi,53,11,2,6,12,14,40,-26,12
Loko Moscow,54,1,11,5,4,30,15,15,38
CSKA Moscow,54,2,11,4,5,28,18,10,37
Spart Moscow,54,3,9,7,4,40,29,11,34
Krasnodar,54,4,10,4,6,30,24,6,34
Zenit,54,5,8,9,3,24,14,10,33
Terek Grozny,54,6,7,6,7,22,25,-3,27
FK Rubin,54,7,6,5,9,24,19,5,23
Din Moscow,54,8,5,7,8,19,26,-7,22
Rostov,54,9,4,7,9,11,18,-7,19
Amkar,54,10,5,4,11,12,27,-15,19
Anzhi,54,11,2,6,12,16,41,-25,12
Loko Moscow,55,1,12,5,3,30,12,18,41
CSKA Moscow,55,2,11,4,5,29,20,9,37
Krasnodar,55,3,10,4,6,30,24,6,34
Spart Moscow,55,4,9,6,5,37,33,4,33
Zenit,55,5,7,9,4,22,15,7,30
Terek Grozny,55,6,8,5,7,22,24,-2,29
Din Moscow,55,7,5,8,7,20,24,-4,23
FK Rubin,55,8,5,6,9,22,20,2,21
Amkar,55,9,5,4,11,14,23,-9,19
Rostov,55,10,4,6,10,11,19,-8,18
Anzhi,55,11,3,5,12,18,41,-23,14
Loko Moscow,56,1,11,7,2,30,12,18,40
CSKA Moscow,56,2,11,4,5,31,22,9,37
Krasnodar,56,3,9,5,6,31,25,6,32
Zenit,56,4,7,10,3,23,15,8,31
Spart Moscow,56,5,8,5,7,36,31,5,29
Terek Grozny,56,6,7,7,6,21,23,-2,28
Din Moscow,56,7,7,6,7,21,23,-2,27
Rostov,56,8,5,6,9,11,17,-6,21
FK Rubin,56,9,5,5,10,22,22,0,20
Amkar,56,10,5,5,10,12,24,-12,20
Anzhi,56,11,2,6,12,18,42,-24,12
Loko Moscow,57,1,12,5,3,31,15,16,41
CSKA Moscow,57,2,12,3,5,28,17,11,39
Krasnodar,57,3,10,4,6,32,24,8,34
Spart Moscow,57,4,9,6,5,36,28,8,33
Zenit,57,5,7,8,5,22,16,6,29
Terek Grozny,57,6,8,5,7,22,25,-3,29
FK Rubin,57,7,6,5,9,23,20,3,23
Din Moscow,57,8,5,7,8,19,24,-5,22
Amkar,57,9,6,4,10,13,22,-9,22
Rostov,57,10,4,6,10,10,19,-9,18
Anzhi,57,11,2,5,13,15,41,-26,11
Loko Moscow,58,1,13,5,2,33,13,20,44
CSKA Moscow,58,2,11,4,5,27,17,10,37
Spart Moscow,58,3,9,5,6,37,29,8,32
Krasnodar,58,4,9,4,7,29,25,4,31
Zenit,58,5,7,9,4,23,16,7,30
Terek Grozny,58,6,8,5,7,24,25,-1,29
Din Moscow,58,7,7,6,7,20,22,-2,27
FK Rubin,58,8,5,5,10,21,20,1,20
Amkar,58,9,5,4,11,12,26,-14,19
Rostov,58,10,4,6,10,10,19,-9,18
Anzhi,58,11,3,5,12,16,40,-24,14
Loko Moscow,59,1,12,5,3,31,13,18,41
CSKA Moscow,59,2,10,5,5,27,19,8,35
Spart Moscow,59,3,9,7,4,43,31,12,34
Krasnodar,59,4,10,4,6,32,26,6,34
Zenit,59,5,7,9,4,22,15,7,30
Terek Grozny,59,6,8,6,6,23,23,0,30
FK Rubin,59,7,6,5,9,24,21,3,23
Din Moscow,59,8,5,7,8,22,27,-5,22
Rostov,59,9,4,7,9,12,19,-7,19
Amkar,59,10,4,4,12,10,29,-19,16
Anzhi,59,11,2,7,11,15,38,-23,13
Loko Moscow,60,1,12,6,2,32,13,19,42
CSKA Moscow,60,2,11,3,6,28,20,8,36
Zenit,60,3,8,8,4,25,15,10,32
Spart Moscow,60,4,8,7,5,36,29,7,31
Krasnodar,60,5,8,6,6,28,25,3,30
Terek Grozny,60,6,8,6,6,24,24,0,30
FK Rubin,60,7,6,6,8,22,17,5,24
Din Moscow,60,8,5,7,8,18,23,-5,22
Rostov,60,9,5,6,9,12,18,-6,21
Amkar,60,10,4,6,10,11,24,-13,18
Anzhi,60,11,2,5,13,15,43,-28,11
Loko Moscow,61,1,12,5,3,33,12,21,41
CSKA Moscow,61,2,11,3,6,32,20,12,36
Krasnodar,61,3,10,4,6,30,25,5,34
Spart Moscow,61,4,9,5,6,37,30,7,32
Zenit,61,5,8,8,4,23,18,5,32
Din Moscow,61,6,7,6,7,20,22,-2,27
Terek Grozny,61,7,7,6,7,23,26,-3,27
FK Rubin,61,8,5,5,10,22,20,2,20
Amkar,61,9,5,5,10,13,25,-12,20
Rostov,61,10,4,6,10,10,18,-8,18
Anzhi,61,11,3,5,12,18,45,-27,14
Loko Moscow,62,1,13,5,2,36,14,22,44
CSKA Moscow,62,2,12,3,5,30,18,12,39
Spart Moscow,62,3,11,5,4,42,27,15,38
Zenit,62,4,7,8,5,23,20,3,29
Terek Grozny,62,5,8,5,7,24,27,-3,29
Krasnodar,62,6,8,4,8,29,30,-1,28
FK Rubin,62,7,7,5,8,27,18,9,26
Din Moscow,62,8,5,6,9,18,26,-8,21
Amkar,62,9,5,4,11,14,27,-13,19
Rostov,62,10,4,6,10,11,21,-10,18
Anzhi,62,11,2,5,13,15,41,-26,11
Loko Moscow,63,1,12,6,2,32,13,19,42
CSKA Moscow,63,2,11,3,6,27,19,8,36
Spart Moscow,63,3,9,7,4,37,28,9,34
Zenit,63,4,8,9,3,23,13,10,33
Krasnodar,63,5,9,4,7,30,27,3,31
Terek Grozny,63,6,8,5,7,22,24,-2,29
Din Moscow,63,7,6,6,8,19,22,-3,24
FK Rubin,63,8,5,5,10,21,20,1,20
Amkar,63,9,5,5,10,12,23,-11,20
Rostov,63,10,4,7,9,12,19,-7,19
Anzhi,63,11,2,5,13,14,41,-27,11
Loko Moscow,64,1,12,6,2,31,12,19,42
CSKA Moscow,64,2,11,4,5,29,18,11,37
Spart Moscow,64,3,9,5,6,38,31,7,32
Zenit,64,4,7,9,4,22,15,7,30
Krasnodar,64,5,8,5,7,28,26,2,29
Terek Grozny,64,6,8,5,7,23,23,0,29
FK Rubin,64,7,6,6,8,22,17,5,24
Din Moscow,64,8,5,7,8,18,23,-5,22
Rostov,64,9,5,6,9,13,19,-6,21
Amkar,64,10,5,4,11,11,26,-15,19
Anzhi,64,11,3,5,12,15,40,-25,14
Loko Moscow,65,1,12,5,3,32,13,19,41
CSKA Moscow,65,2,11,4,5,27,18,9,37
Spart Moscow,65,3,9,6,5,36,27,9,33
Terek Grozny,65,4,9,5,6,26,24,2,32
Krasnodar,65,5,9,4,7,29,27,2,31
Zenit,65,6,7,8,5,21,16,5,29
FK Rubin,65,7,7,5,8,25,18,7,26
Din Moscow,65,8,5,7,8,19,24,-5,22
Amkar,65,9,5,4,11,10,23,-13,19
Rostov,65,10,4,6,10,10,19,-9,18
Anzhi,65,11,2,6,12,17,43,-26,12
Loko Moscow,66,1,12,6,2,30,11,19,42
Spart Moscow,66,2,9,7,4,38,29,9,34
CSKA Moscow,66,3,10,4,6,26,21,5,34
Krasnodar,66,4,9,5,6,29,25,4,32
Zenit,66,5,7,9,4,22,15,7,30
Terek Grozny,66,6,8,6,6,21,22,-1,30
Din Moscow,66,7,6,6,8,21,24,-3,24
FK Rubin,66,8,5,5,10,23,22,1,20
Rostov,66,9,4,7,9,12,19,-7,19
Amkar,66,10,4,5,11,10,24,-14,17
Anzhi,66,11,3,6,11,17,37,-20,15
Loko Moscow,67,1,12,5,3,32,13,19,41
CSKA Moscow,67,2,11,3,6,28,20,8,36
Zenit,67,3,9,8,3,25,14,11,35
Spart Moscow,67,4,8,7,5,34,27,7,31
Krasnodar,67,5,8,5,7,29,29,0,29
Terek Grozny,67,6,7,6,7,20,23,-3,27
Din Moscow,67,7,6,7,7,19,22,-3,25
FK Rubin,67,8,5,7,8,23,19,4,22
Rostov,67,9,4,7,9,10,17,-7,19
Amkar,67,10,4,6,10,9,22,-13,18
Anzhi,67,11,3,5,12,16,39,-23,14
Loko Moscow,68,1,13,5,2,32,11,21,44
Spart Moscow,68,2,10,6,4,37,26,11,36
CSKA Moscow,68,3,11,3,6,27,21,6,36
Terek Grozny,68,4,8,6,6,24,25,-1,30
Zenit,68,5,7,8,5,22,17,5,29
Krasnodar,68,6,8,5,7,28,26,2,29
Din Moscow,68,7,6,6,8,19,24,-5,24
FK Rubin,68,8,5,6,9,23,20,3,21
Rostov,68,9,4,6,10,10,18,-8,18
Amkar,68,10,4,5,11,10,24,-14,17
Anzhi,68,11,3,6,11,20,40,-20,15
Loko Moscow,69,1,11,5,4,30,14,16,38
CSKA Moscow,69,2,11,4,5,29,18,11,37
Krasnodar,69,3,10,4,6,29,24,5,34
Spart Moscow,69,4,9,5,6,38,29,9,32
Zenit,69,5,8,8,4,23,17,6,32
Terek Grozny,69,6,8,5,7,21,24,-3,29
Din Moscow,69,7,6,6,8,18,25,-7,24
Rostov,69,8,5,6,9,12,18,-6,21
FK Rubin,69,9,5,5,10,21,19,2,20
Amkar,69,10,5,4,11,11,23,-12,19
Anzhi,69,11,3,6,11,17,38,-21,15
Loko Moscow,70,1,12,5,3,31,13,18,41
CSKA Moscow,70,2,11,4,5,27,18,9,37
Krasnodar,70,3,10,4,6,31,25,6,34
Zenit,70,4,7,9,4,22,15,7,30
Spart Moscow,70,5,8,5,7,34,31,3,29
Terek Grozny,70,6,8,5,7,22,24,-2,29
Din Moscow,70,7,7,6,7,23,22,1,27
Rostov,70,8,5,6,9,11,17,-6,21
FK Rubin,70,9,5,5,10,22,23,-1,20
Amkar,70,10,5,4,11,12,24,-12,19
Anzhi,70,11,3,5,12,16,39,-23,14
Loko Moscow,71,1,12,5,3,31,15,16,41
CSKA Moscow,71,2,11,4,5,28,19,9,37
Zenit,71,3,8,8,4,25,14,11,32
Spart Moscow,71,4,9,5,6,36,29,7,32
Terek Grozny,71,5,9,5,6,25,23,2,32
Krasnodar,71,6,8,5,7,27,26,1,29
Din Moscow,71,7,7,6,7,22,24,-2,27
FK Rubin,71,8,5,6,9,24,21,3,21
Amkar,71,9,5,4,11,12,23,-11,19
Rostov,71,10,4,6,10,10,20,-10,18
Anzhi,71,11,2,6,12,17,43,-26,12
Loko Moscow,72,1,12,5,3,33,15,18,41
CSKA Moscow,72,2,11,3,6,27,19,8,36
Spart Moscow,72,3,9,5,6,35,31,4,32
Krasnodar,72,4,9,5,6,30,26,4,32
Zenit,72,5,7,8,5,22,16,6,29
Terek Grozny,72,6,7,6,7,21,24,-3,27
FK Rubin,72,7,6,6,8,22,17,5,24
Rostov,72,8,5,6,9,13,18,-5,21
Din Moscow,72,9,5,6,9,17,23,-6,21
Amkar,72,10,5,5,10,13,23,-10,20
Anzhi,72,11,4,5,11,17,38,-21,17
Loko Moscow,73,1,11,6,3,31,15,16,39
CSKA Moscow,73,2,11,4,5,29,18,11,37
Zenit,73,3,8,9,3,25,15,10,33
Krasnodar,73,4,9,5,6,30,26,4,32
Spart Moscow,73,5,8,6,6,35,31,4,30
Terek Grozny,73,6,8,6,6,24,25,-1,30
Din Moscow,73,7,7,6,7,21,23,-2,27
Rostov,73,8,5,6,9,13,17,-4,21
FK Rubin,73,9,5,5,10,23,21,2,20
Amkar,73,10,4,5,11,11,25,-14,17
Anzhi,73,11,2,6,12,16,42,-26,12
Loko Moscow,74,1,12,5,3,32,12,20,41
CSKA Moscow,74,2,11,3,6,36,18,18,36
Krasnodar,74,3,10,4,6,31,25,6,34
Spart Moscow,74,4,9,6,5,39,30,9,33
Zenit,74,5,8,8,4,22,16,6,32
Terek Grozny,74,6,7,6,7,21,24,-3,27
FK Rubin,74,7,6,5,9,24,20,4,23
Din Moscow,74,8,5,6,9,18,27,-9,21
Amkar,74,9,5,5,10,12,23,-11,20
Rostov,74,10,4,7,9,12,19,-7,19
Anzhi,74,11,3,5,12,15,48,-33,14
Loko Moscow,75,1,11,6,3,30,15,15,39
Spart Moscow,75,2,11,5,4,42,28,14,38
CSKA Moscow,75,3,11,4,5,30,21,9,37
Krasnodar,75,4,9,4,7,30,26,4,31
Zenit,75,5,7,9,4,24,17,7,30
Terek Grozny,75,6,8,6,6,23,24,-1,30
FK Rubin,75,7,6,6,8,25,19,6,24
Din Moscow,75,8,5,7,8,21,27,-6,22
Rostov,75,9,4,6,10,10,18,-8,18
Amkar,75,10,4,4,12,11,28,-17,16
Anzhi,75,11,2,7,11,17,40,-23,13
Loko Moscow,76,1,12,5,3,32,13,19,41
CSKA Moscow,76,2,11,3,6,29,21,8,36
Zenit,76,3,8,8,4,24,17,7,32
Spart Moscow,76,4,8,5,7,34,31,3,29
Krasnodar,76,5,8,5,7,30,29,1,29
Din Moscow,76,6,7,6,7,20,21,-1,27
Terek Grozny,76,7,7,6,7,20,23,-3,27
Amkar,76,8,6,4,10,13,23,-10,22
FK Rubin,76,9,5,6,9,23,21,2,21
Rostov,76,10,5,6,9,12,17,-5,21
Anzhi,76,11,3,6,11,16,37,-21,15
Loko Moscow,77,1,11,5,4,29,13,16,38
CSKA Moscow,77,2,11,4,5,27,18,9,37
Spart Moscow,77,3,9,7,4,39,30,9,34
Krasnodar,77,4,10,4,6,30,24,6,34
Zenit,77,5,8,9,3,23,14,9,33
Terek Grozny,77,6,8,5,7,23,25,-2,29
Din Moscow,77,7,6,6,8,20,24,-4,24
FK Rubin,77,8,5,5,10,21,20,1,20
Rostov,77,9,4,7,9,11,18,-7,19
Amkar,77,10,4,5,11,11,25,-14,17
Anzhi,77,11,3,5,12,17,40,-23,14
Loko Moscow,78,1,11,7,2,29,11,18,40
CSKA Moscow,78,2,12,3,5,29,17,12,39
Spart Moscow,78,3,9,6,5,37,28,9,33
Krasnodar,78,4,9,5,6,29,24,5,32
Zenit,78,5,7,9,4,21,14,7,30
Terek Grozny,78,6,8,6,6,22,22,0,30
FK Rubin,78,7,6,5,9,22,19,3,23
Rostov,78,8,5,6,9,11,17,-6,21
Din Moscow,78,9,5,6,9,17,24,-7,21
Amkar,78,10,4,6,10,11,24,-13,18
Anzhi,78,11,2,5,13,14,42,-28,11
Loko Moscow,79,1,11,6,3,30,15,15,39
Spart Moscow,79,2,11,5,4,41,26,15,38
CSKA Moscow,79,3,11,4,5,29,18,11,37
Krasnodar,79,4,9,5,6,30,24,6,32
Terek Grozny,79,5,9,5,6,25,25,0,32
Zenit,79,6,7,10,3,23,15,8,31
Din Moscow,79,7,6,6,8,19,23,-4,24
FK Rubin,79,8,5,6,9,21,19,2,21
Rostov,79,9,4,6,10,11,22,-11,18
Amkar,79,10,4,4,12,11,26,-15,16
Anzhi,79,11,2,5,13,15,42,-27,11
Loko Moscow,80,1,12,5,3,31,14,17,41
CSKA Moscow,80,2,11,3,6,27,19,8,36
Spart Moscow,80,3,10,5,5,38,29,9,35
Krasnodar,80,4,10,4,6,32,25,7,34
Zenit,80,5,8,8,4,23,15,8,32
Terek Grozny,80,6,8,5,7,22,24,-2,29
Din Moscow,80,7,6,6,8,21,25,-4,24
FK Rubin,80,8,6,5,9,24,20,4,23
Amkar,80,9,5,4,11,12,25,-13,19
Rostov,80,10,4,6,10,10,18,-8,18
Anzhi,80,11,2,5,13,14,40,-26,11
Loko Moscow,81,1,13,5,2,32,11,21,44
CSKA Moscow,81,2,11,4,5,27,18,9,37
Spart Moscow,81,3,9,5,6,37,30,7,32
Krasnodar,81,4,9,4,7,29,26,3,31
Zenit,81,5,7,8,5,21,15,6,29
Terek Grozny,81,6,8,5,7,21,23,-2,29
Din Moscow,81,7,5,7,8,19,24,-5,22
FK Rubin,81,8,5,6,9,21,19,2,21
Rostov,81,9,5,6,9,12,18,-6,21
Amkar,81,10,5,4,11,10,23,-13,19
Anzhi,81,11,3,6,11,16,38,-22,15
Loko Moscow,82,1,11,6,3,31,17,14,39
Spart Moscow,82,2,10,6,4,38,27,11,36
CSKA Moscow,82,3,11,3,6,26,18,8,36
Zenit,82,4,8,9,3,24,15,9,33
Krasnodar,82,5,9,4,7,31,25,6,31
Terek Grozny,82,6,8,5,7,21,23,-2,29
FK Rubin,82,7,7,5,8,24,18,6,26
Din Moscow,82,8,5,6,9,19,25,-6,21
Rostov,82,9,4,7,9,10,17,-7,19
Amkar,82,10,4,4,12,10,26,-16,16
Anzhi,82,11,3,5,12,15,38,-23,14
Loko Moscow,83,1,12,5,3,32,13,19,41
Spart Moscow,83,2,11,5,4,40,27,13,38
CSKA Moscow,83,3,10,4,6,26,19,7,34
Zenit,83,4,8,9,3,24,14,10,33
Terek Grozny,83,5,9,5,6,24,24,0,32
Krasnodar,83,6,8,4,8,27,28,-1,28
Din Moscow,83,7,6,6,8,19,23,-4,24
FK Rubin,83,8,6,5,9,23,19,4,23
Rostov,83,9,4,6,10,11,19,-8,18
Amkar,83,10,4,4,12,10,27,-17,16
Anzhi,83,11,3,5,12,17,40,-23,14
Loko Moscow,84,1,11,5,4,31,15,16,38
Spart Moscow,84,2,11,5,4,41,26,15,38
CSKA Moscow,84,3,11,3,6,32,20,12,36
Zenit,84,4,9,8,3,25,14,11,35
Terek Grozny,84,5,9,5,6,24,23,1,32
Krasnodar,84,6,9,4,7,30,28,2,31
Din Moscow,84,7,6,6,8,18,23,-5,24
FK Rubin,84,8,6,5,9,24,19,5,23
Rostov,84,9,4,6,10,10,18,-8,18
Amkar,84,10,4,4,12,11,29,-18,16
Anzhi,84,11,2,5,13,15,46,-31,11
Loko Moscow,85,1,11,6,3,30,14,16,39
Spart Moscow,85,2,9,7,4,40,29,11,34
CSKA Moscow,85,3,10,4,6,25,18,7,34
Zenit,85,4,8,9,3,22,13,9,33
Krasnodar,85,5,9,4,7,31,29,2,31
Terek Grozny,85,6,7,5,8,20,24,-4,26
FK Rubin,85,7,6,6,8,26,19,7,24
Din Moscow,85,8,5,7,8,19,26,-7,22
Amkar,85,9,5,5,10,12,24,-12,20
Rostov,85,10,4,7,9,11,18,-7,19
Anzhi,85,11,3,6,11,15,37,-22,15
Loko Moscow,86,1,12,5,3,32,14,18,41
CSKA Moscow,86,2,11,3,6,26,18,8,36
Spart Moscow,86,3,9,6,5,37,29,8,33
Zenit,86,4,8,8,4,23,16,7,32
Krasnodar,86,5,9,5,6,30,25,5,32
Terek Grozny,86,6,7,6,7,22,26,-4,27
FK Rubin,86,7,6,6,8,23,18,5,24
Din Moscow,86,8,6,6,8,20,22,-2,24
Rostov,86,9,4,7,9,11,18,-7,19
Amkar,86,10,4,5,11,10,26,-16,17
Anzhi,86,11,3,5,12,17,39,-22,14
Loko Moscow,87,1,13,5,2,35,12,23,44
CSKA Moscow,87,2,11,3,6,30,21,9,36
Krasnodar,87,3,9,4,7,29,29,0,31
Spart Moscow,87,4,8,6,6,33,27,6,30
Zenit,87,5,7,8,5,21,16,5,29
Terek Grozny,87,6,7,6,7,21,24,-3,27
Din Moscow,87,7,6,6,8,19,23,-4,24
FK Rubin,87,8,6,5,9,23,19,4,23
Amkar,87,9,5,5,10,10,22,-12,20
Rostov,87,10,4,7,9,10,17,-7,19
Anzhi,87,11,4,5,11,20,41,-21,17
Loko Moscow,88,1,11,6,3,31,14,17,39
CSKA Moscow,88,2,12,3,5,30,17,13,39
Spart Moscow,88,3,10,5,5,38,27,11,35
Krasnodar,88,4,10,4,6,30,25,5,34
Terek Grozny,88,5,9,5,6,25,23,2,32
Zenit,88,6,7,9,4,22,16,6,30
Din Moscow,88,7,6,6,8,19,23,-4,24
FK Rubin,88,8,5,5,10,21,19,2,20
Amkar,88,9,5,4,11,10,24,-14,19
Rostov,88,10,4,6,10,10,20,-10,18
Anzhi,88,11,2,5,13,15,43,-28,11
Loko Moscow,89,1,11,6,3,29,13,16,39
CSKA Moscow,89,2,12,3,5,29,17,12,39
Spart Moscow,89,3,10,5,5,40,28,12,35
Krasnodar,89,4,9,4,7,29,26,3,31
Zenit,89,5,7,9,4,21,15,6,30
Terek Grozny,89,6,8,5,7,21,26,-5,29
FK Rubin,89,7,6,6,8,23,17,6,24
Din Moscow,89,8,5,7,8,17,25,-8,22
Rostov,89,9,5,6,9,12,18,-6,21
Amkar,89,10,5,4,11,14,24,-10,19
Anzhi,89,11,2,5,13,14,40,-26,11
Loko Moscow,90,1,11,6,3,30,13,17,39
Spart Moscow,90,2,10,6,4,38,26,12,36
CSKA Moscow,90,3,11,3,6,30,20,10,36
Krasnodar,90,4,10,4,6,31,25,6,34
Zenit,90,5,8,9,3,25,15,10,33
Terek Grozny,90,6,8,5,7,22,24,-2,29
Din Moscow,90,7,5,8,7,19,23,-4,23
FK Rubin,90,8,5,6,9,23,21,2,21
Amkar,90,9,5,4,11,10,23,-13,19
Rostov,90,10,4,6,10,10,20,-10,18
Anzhi,90,11,2,5,13,15,43,-28,11
Loko Moscow,91,1,11,7,2,33,15,18,40
CSKA Moscow,91,2,12,3,5,31,20,11,39
Spart Moscow,91,3,9,6,5,39,31,8,33
Krasnodar,91,4,9,5,6,33,27,6,32
Zenit,91,5,7,9,4,24,17,7,30
Terek Grozny,91,6,7,6,7,24,27,-3,27
Din Moscow,91,7,6,6,8,19,24,-5,24
Rostov,91,8,5,6,9,13,18,-5,21
FK Rubin,91,9,5,5,10,21,21,0,20
Amkar,91,10,5,5,10,14,26,-12,20
Anzhi,91,11,2,6,12,17,42,-25,12
Loko Moscow,92,1,11,6,3,29,14,15,39
CSKA Moscow,92,2,11,3,6,27,19,8,36
Spart Moscow,92,3,9,7,4,36,27,9,34
Zenit,92,4,8,9,3,23,13,10,33
Krasnodar,92,5,9,5,6,30,24,6,32
Terek Grozny,92,6,7,5,8,23,27,-4,26
FK Rubin,92,7,6,6,8,23,17,6,24
Din Moscow,92,8,5,7,8,17,23,-6,22
Rostov,92,9,4,7,9,11,18,-7,19
Amkar,92,10,5,4,11,12,25,-13,19
Anzhi,92,11,3,5,12,17,41,-24,14
Loko Moscow,93,1,12,6,2,30,11,19,42
CSKA Moscow,93,2,11,3,6,29,20,9,36
Zenit,93,3,8,8,4,24,16,8,32
Spart Moscow,93,4,9,5,6,38,31,7,32
Krasnodar,93,5,8,6,6,28,25,3,30
Terek Grozny,93,6,8,5,7,24,25,-1,29
Din Moscow,93,7,7,6,7,19,21,-2,27
Amkar,93,8,6,4,10,14,22,-8,22
FK Rubin,93,9,5,6,9,22,19,3,21
Rostov,93,10,4,6,10,12,22,-10,18
Anzhi,93,11,2,5,13,15,43,-28,11
Loko Moscow,94,1,12,6,2,32,13,19,42
CSKA Moscow,94,2,11,3,6,28,19,9,36
Spart Moscow,94,3,10,5,5,38,28,10,35
Zenit,94,4,8,9,3,24,15,9,33
Krasnodar,94,5,8,5,7,29,27,2,29
Terek Grozny,94,6,8,5,7,21,23,-2,29
FK Rubin,94,7,5,7,8,24,20,4,22
Din Moscow,94,8,5,7,8,20,26,-6,22
Rostov,94,9,5,6,9,11,17,-6,21
Amkar,94,10,5,4,11,11,24,-13,19
Anzhi,94,11,2,5,13,14,40,-26,11
Loko Moscow,95,1,13,5,2,31,11,20,44
CSKA Moscow,95,2,11,4,5,30,18,12,37
Spart Moscow,95,3,9,6,5,38,31,7,33
Krasnodar,95,4,9,4,7,30,25,5,31
Zenit,95,5,7,9,4,22,15,7,30
Terek Grozny,95,6,8,5,7,21,23,-2,29
Din Moscow,95,7,7,6,7,21,21,0,27
FK Rubin,95,8,5,5,10,21,22,-1,20
Rostov,95,9,4,7,9,12,19,-7,19
Amkar,95,10,5,4,11,12,25,-13,19
Anzhi,95,11,2,5,13,14,42,-28,11
Loko Moscow,96,1,12,6,2,32,13,19,42
CSKA Moscow,96,2,11,4,5,27,18,9,37
Spart Moscow,96,3,10,6,4,41,29,12,36
Zenit,96,4,7,9,4,23,16,7,30
Krasnodar,96,5,8,5,7,29,28,1,29
Terek Grozny,96,6,7,6,7,23,26,-3,27
FK Rubin,96,7,7,5,8,27,20,7,26
Din Moscow,96,8,5,7,8,21,26,-5,22
Amkar,96,9,5,4,11,12,25,-13,19
Rostov,96,10,4,6,10,11,21,-10,18
Anzhi,96,11,2,6,12,16,40,-24,12
Loko Moscow,97,1,13,5,2,33,13,20,44
CSKA Moscow,97,2,12,3,5,28,17,11,39
Spart Moscow,97,3,10,5,5,37,26,11,35
Terek Grozny,97,4,8,6,6,21,22,-1,30
Zenit,97,5,7,8,5,21,15,6,29
Krasnodar,97,6,8,5,7,31,29,2,29
Din Moscow,97,7,6,6,8,18,24,-6,24
FK Rubin,97,8,5,6,9,23,20,3,21
Rostov,97,9,5,6,9,11,17,-6,21
Amkar,97,10,4,5,11,9,23,-14,17
Anzhi,97,11,2,5,13,14,40,-26,11
Loko Moscow,98,1,12,5,3,31,15,16,41
CSKA Moscow,98,2,11,4,5,31,18,13,37
Spart Moscow,98,3,10,5,5,38,30,8,35
Krasnodar,98,4,9,5,6,31,25,6,32
Zenit,98,5,7,9,4,23,16,7,30
Terek Grozny,98,6,7,5,8,21,27,-6,26
FK Rubin,98,7,5,7,8,22,18,4,22
Din Moscow,98,8,5,7,8,18,24,-6,22
Amkar,98,9,6,4,10,15,23,-8,22
Rostov,98,10,4,6,10,11,19,-8,18
Anzhi,98,11,3,5,12,16,42,-26,14
CSKA Moscow,99,1,12,3,5,32,19,13,39
Loko Moscow,99,2,11,5,4,29,14,15,38
Spart Moscow,99,3,10,5,5,37,27,10,35
Krasnodar,99,4,10,4,6,31,25,6,34
Zenit,99,5,8,8,4,22,16,6,32
Terek Grozny,99,6,8,5,7,21,23,-2,29
Din Moscow,99,7,7,6,7,22,23,-1,27
FK Rubin,99,8,5,5,10,23,22,1,20
Amkar,99,9,5,4,11,10,23,-13,19
Rostov,99,10,4,6,10,10,19,-9,18
Anzhi,99,11,2,5,13,16,42,-26,11
Loko Moscow,100,1,11,6,3,30,13,17,39
CSKA Moscow,100,2,11,3,6,27,18,9,36
Zenit,100,3,8,9,3,22,13,9,33
Spart Moscow,100,4,9,6,5,35,27,8,33
Krasnodar,100,5,9,5,6,30,26,4,32
Terek Grozny,100,6,7,6,7,21,24,-3,27
FK Rubin,100,7,6,6,8,24,19,5,24
Din Moscow,100,8,5,6,9,18,24,-6,21
Rostov,100,9,5,6,9,12,18,-6,21
Amkar,100,10,4,6,10,10,23,-13,18
Anzhi,100,11,3,5,12,15,39,-24,14
Loko Moscow,101,1,12,5,3,30,12,18,41
Spart Moscow,101,2,10,6,4,37,25,12,36
CSKA Moscow,101,3,11,3,6,27,19,8,36
Zenit,101,4,9,8,3,23,13,10,35
Krasnodar,101,5,9,4,7,29,26,3,31
Terek Grozny,101,6,8,5,7,22,23,-1,29
Din Moscow,101,7,6,6,8,19,22,-3,24
FK Rubin,101,8,5,5,10,22,21,1,20
Rostov,101,9,4,7,9,10,17,-7,19
Amkar,101,10,5,4,11,10,25,-15,19
Anzhi,101,11,2,5,13,15,41,-26,11
Loko Moscow,102,1,11,6,3,31,14,17,39
CSKA Moscow,102,2,10,5,5,27,19,8,35
Zenit,102,3,8,9,3,24,15,9,33
Spart Moscow,102,4,9,6,5,36,28,8,33
Krasnodar,102,5,8,6,6,28,25,3,30
Terek Grozny,102,6,8,6,6,22,23,-1,30
Din Moscow,102,7,6,7,7,19,22,-3,25
FK Rubin,102,8,5,6,9,21,18,3,21
Amkar,102,9,5,5,10,12,23,-11,20
Rostov,102,10,4,6,10,10,19,-9,18
Anzhi,102,11,2,6,12,15,39,-24,12
Loko Moscow,103,1,11,6,3,29,12,17,39
CSKA Moscow,103,2,12,3,5,32,18,14,39
Spart Moscow,103,3,10,5,5,38,28,10,35
Zenit,103,4,8,8,4,22,15,7,32
Krasnodar,103,5,9,5,6,30,26,4,32
Terek Grozny,103,6,9,5,6,26,22,4,32
Din Moscow,103,7,6,6,8,19,23,-4,24
FK Rubin,103,8,6,5,9,24,20,4,23
Rostov,103,9,4,6,10,11,19,-8,18
Amkar,103,10,4,4,12,9,27,-18,16
Anzhi,103,11,2,5,13,15,45,-30,11
Loko Moscow,104,1,12,5,3,32,14,18,41
CSKA Moscow,104,2,12,3,5,30,20,10,39
Krasnodar,104,3,10,4,6,33,25,8,34
Spart Moscow,104,4,9,6,5,37,30,7,33
Zenit,104,5,7,8,5,22,16,6,29
Terek Grozny,104,6,7,5,8,21,27,-6,26
Din Moscow,104,7,5,8,7,19,23,-4,23
Amkar,104,8,6,4,10,15,23,-8,22
FK Rubin,104,9,5,6,9,22,22,0,21
Rostov,104,10,4,6,10,11,20,-9,18
Anzhi,104,11,3,5,12,19,41,-22,14
Loko Moscow,105,1,11,7,2,33,15,18,40
CSKA Moscow,105,2,12,3,5,29,18,11,39
Spart Moscow,105,3,9,6,5,35,26,9,33
Krasnodar,105,4,9,5,6,30,26,4,32
Zenit,105,5,7,9,4,23,17,6,30
Terek Grozny,105,6,8,6,6,23,24,-1,30
Din Moscow,105,7,6,7,7,19,22,-3,25
FK Rubin,105,8,5,5,10,22,20,2,20
Amkar,105,9,5,4,11,11,24,-13,19
Rostov,105,10,4,6,10,10,19,-9,18
Anzhi,105,11,2,6,12,16,40,-24,12
Loko Moscow,106,1,12,6,2,32,12,20,42
Spart Moscow,106,2,9,7,4,38,27,11,34
CSKA Moscow,106,3,10,3,7,27,21,6,33
Zenit,106,4,8,8,4,23,16,7,32
Krasnodar,106,5,9,5,6,29,25,4,32
Terek Grozny,106,6,7,6,7,23,26,-3,27
Din Moscow,106,7,5,8,7,18,22,-4,23
FK Rubin,106,8,5,6,9,21,18,3,21
Rostov,106,9,4,7,9,11,18,-7,19
Amkar,106,10,4,5,11,10,26,-16,17
Anzhi,106,11,4,5,11,19,40,-21,17
Loko Moscow,107,1,11,7,2,30,12,18,40
Spart Moscow,107,2,10,5,5,40,29,11,35
CSKA Moscow,107,3,10,4,6,26,19,7,34
Zenit,107,4,8,9,3,23,14,9,33
Krasnodar,107,5,9,5,6,31,24,7,32
Terek Grozny,107,6,8,6,6,22,23,-1,30
Din Moscow,107,7,6,6,8,22,26,-4,24
FK Rubin,107,8,5,5,10,23,26,-3,20
Amkar,107,9,5,5,10,14,25,-11,20
Rostov,107,10,4,6,10,10,19,-9,18
Anzhi,107,11,2,6,12,15,39,-24,12
Loko Moscow,108,1,12,6,2,33,12,21,42
Spart Moscow,108,2,10,6,4,38,25,13,36
CSKA Moscow,108,3,10,4,6,27,20,7,34
Zenit,108,4,8,9,3,22,13,9,33
Krasnodar,108,5,9,4,7,30,28,2,31
Terek Grozny,108,6,8,6,6,22,23,-1,30
FK Rubin,108,7,6,5,9,23,20,3,23
Din Moscow,108,8,5,7,8,18,23,-5,22
Rostov,108,9,4,6,10,10,20,-10,18
Amkar,108,10,4,5,11,10,25,-15,17
Anzhi,108,11,2,6,12,16,40,-24,12
Loko Moscow,109,1,13,5,2,35,12,23,44
CSKA Moscow,109,2,11,4,5,28,18,10,37
Spart Moscow,109,3,10,5,5,39,29,10,35
Terek Grozny,109,4,8,6,6,24,22,2,30
Zenit,109,5,7,8,5,22,20,2,29
Krasnodar,109,6,8,4,8,28,27,1,28
FK Rubin,109,7,7,5,8,26,19,7,26
Din Moscow,109,8,5,6,9,18,26,-8,21
Amkar,109,9,5,4,11,12,28,-16,19
Rostov,109,10,4,6,10,11,19,-8,18
Anzhi,109,11,2,7,11,15,38,-23,13
Loko Moscow,110,1,12,6,2,32,12,20,42
CSKA Moscow,110,2,11,3,6,28,20,8,36
Spart Moscow,110,3,10,5,5,38,29,9,35
Zenit,110,4,8,8,4,24,16,8,32
Krasnodar,110,5,9,5,6,31,25,6,32
Terek Grozny,110,6,7,6,7,22,25,-3,27
Din Moscow,110,7,6,7,7,19,22,-3,25
FK Rubin,110,8,5,6,9,22,21,1,21
Rostov,110,9,4,6,10,11,19,-8,18
Amkar,110,10,4,5,11,13,27,-14,17
Anzhi,110,11,3,5,12,15,39,-24,14
Loko Moscow,111,1,11,6,3,29,12,17,39
CSKA Moscow,111,2,11,3,6,27,19,8,36
Krasnodar,111,3,10,4,6,32,24,8,34
Spart Moscow,111,4,9,6,5,36,28,8,33
Zenit,111,5,7,9,4,21,15,6,30
Terek Grozny,111,6,7,6,7,21,25,-4,27
Din Moscow,111,7,6,6,8,18,24,-6,24
FK Rubin,111,8,6,5,9,24,21,3,23
Rostov,111,9,4,6,10,11,19,-8,18
Amkar,111,10,4,6,10,11,24,-13,18
Anzhi,111,11,4,5,11,18,37,-19,17
Loko Moscow,112,1,11,7,2,31,13,18,40
CSKA Moscow,112,2,11,4,5,27,18,9,37
Spart Moscow,112,3,10,6,4,37,27,10,36
Krasnodar,112,4,9,5,6,31,26,5,32
Zenit,112,5,7,9,4,22,15,7,30
Terek Grozny,112,6,8,5,7,23,24,-1,29
FK Rubin,112,7,6,5,9,24,21,3,23
Din Moscow,112,8,5,7,8,19,24,-5,22
Rostov,112,9,4,6,10,11,19,-8,18
Amkar,112,10,4,4,12,9,26,-17,16
Anzhi,112,11,3,6,11,17,38,-21,15
Loko Moscow,113,1,12,6,2,31,11,20,42
Spart Moscow,113,2,10,6,4,40,29,11,36
CSKA Moscow,113,3,11,3,6,28,19,9,36
Zenit,113,4,8,8,4,23,15,8,32
Krasnodar,113,5,8,5,7,27,25,2,29
Terek Grozny,113,6,7,6,7,21,24,-3,27
FK Rubin,113,7,6,6,8,22,17,5,24
Din Moscow,113,8,5,7,8,17,23,-6,22
Amkar,113,9,5,5,10,12,24,-12,20
Rostov,113,10,4,6,10,12,20,-8,18
Anzhi,113,11,2,6,12,15,41,-26,12
Loko Moscow,114,1,12,5,3,34,16,18,41
Spart Moscow,114,2,11,5,4,37,25,12,38
CSKA Moscow,114,3,11,4,5,28,18,10,37
Krasnodar,114,4,10,4,6,34,29,5,34
Terek Grozny,114,5,9,5,6,24,23,1,32
Zenit,114,6,7,9,4,22,15,7,30
Din Moscow,114,7,6,6,8,18,22,-4,24
FK Rubin,114,8,5,5,10,23,21,2,20
Rostov,114,9,4,6,10,10,19,-9,18
Amkar,114,10,4,4,12,9,25,-16,16
Anzhi,114,11,2,5,13,16,42,-26,11
Spart Moscow,115,1,11,5,4,42,27,15,38
Loko Moscow,115,2,11,5,4,30,15,15,38
CSKA Moscow,115,3,11,3,6,30,19,11,36
Zenit,115,4,9,8,3,25,14,11,35
Krasnodar,115,5,10,4,6,33,24,9,34
Terek Grozny,115,6,7,6,7,21,26,-5,27
Din Moscow,115,7,5,7,8,18,25,-7,22
FK Rubin,115,8,5,6,9,22,23,-1,21
Rostov,115,9,4,6,10,11,21,-10,18
Amkar,115,10,4,5,11,11,25,-14,17
Anzhi,115,11,3,5,12,18,42,-24,14
Loko Moscow,116,1,11,6,3,31,14,17,39
CSKA Moscow,116,2,12,3,5,30,18,12,39
Spart Moscow,116,3,9,7,4,38,28,10,34
Zenit,116,4,8,8,4,24,16,8,32
Krasnodar,116,5,8,5,7,29,27,2,29
Terek Grozny,116,6,8,5,7,22,25,-3,29
Din Moscow,116,7,6,7,7,19,22,-3,25
FK Rubin,116,8,6,5,9,23,19,4,23
Amkar,116,9,5,5,10,12,23,-11,20
Rostov,116,10,4,6,10,11,20,-9,18
Anzhi,116,11,2,5,13,15,42,-27,11
Loko Moscow,117,1,12,5,3,31,13,18,41
CSKA Moscow,117,2,11,4,5,28,18,10,37
Krasnodar,117,3,10,4,6,32,25,7,34
Spart Moscow,117,4,9,6,5,38,30,8,33
Zenit,117,5,7,9,4,22,15,7,30
Din Moscow,117,6,7,6,7,23,23,0,27
Terek Grozny,117,7,7,6,7,21,25,-4,27
FK Rubin,117,8,5,5,10,23,24,-1,20
Rostov,117,9,4,7,9,11,18,-7,19
Amkar,117,10,5,4,11,12,25,-13,19
Anzhi,117,11,2,6,12,16,41,-25,12
Loko Moscow,118,1,12,5,3,33,16,17,41
Zenit,118,2,9,8,3,29,17,12,35
Spart Moscow,118,3,9,7,4,38,28,10,34
CSKA Moscow,118,4,10,4,6,28,21,7,34
Krasnodar,118,5,9,4,7,28,26,2,31
Terek Grozny,118,6,8,5,7,22,24,-2,29
Din Moscow,118,7,6,6,8,22,25,-3,24
FK Rubin,118,8,5,5,10,22,22,0,20
Rostov,118,9,4,7,9,11,18,-7,19
Amkar,118,10,4,5,11,11,25,-14,17
Anzhi,118,11,3,6,11,16,38,-22,15
Loko Moscow,119,1,11,6,3,31,17,14,39
Spart Moscow,119,2,11,5,4,42,28,14,38
CSKA Moscow,119,3,11,4,5,29,19,10,37
Krasnodar,119,4,9,5,6,32,25,7,32
Zenit,119,5,7,9,4,24,18,6,30
Terek Grozny,119,6,8,6,6,24,25,-1,30
Din Moscow,119,7,6,6,8,20,25,-5,24
FK Rubin,119,8,5,6,9,22,19,3,21
Rostov,119,9,4,6,10,10,20,-10,18
Amkar,119,10,4,4,12,12,27,-15,16
Anzhi,119,11,2,7,11,16,39,-23,13
Loko Moscow,120,1,11,5,4,29,16,13,38
CSKA Moscow,120,2,11,4,5,27,18,9,37
Spart Moscow,120,3,9,7,4,37,28,9,34
Krasnodar,120,4,10,4,6,31,25,6,34
Zenit,120,5,8,9,3,25,14,11,33
Terek Grozny,120,6,8,5,7,22,24,-2,29
Din Moscow,120,7,6,7,7,19,22,-3,25
FK Rubin,120,8,5,5,10,23,21,2,20
Amkar,120,9,5,5,10,12,24,-12,20
Rostov,120,10,4,6,10,12,20,-8,18
Anzhi,120,11,2,5,13,14,39,-25,11
Loko Moscow,121,1,11,6,3,30,13,17,39
CSKA Moscow,121,2,11,4,5,28,19,9,37
Krasnodar,121,3,10,4,6,31,24,7,34
Spart Moscow,121,4,9,5,6,36,28,8,32
Zenit,121,5,7,10,3,23,15,8,31
Terek Grozny,121,6,8,6,6,21,22,-1,30
Din Moscow,121,7,7,6,7,19,21,-2,27
FK Rubin,121,8,5,5,10,21,21,0,20
Amkar,121,9,5,5,10,10,22,-12,20
Rostov,121,10,4,6,10,11,20,-9,18
Anzhi,121,11,2,5,13,15,40,-25,11
Loko Moscow,122,1,11,5,4,29,17,12,38
Spart Moscow,122,2,10,5,5,39,30,9,35
CSKA Moscow,122,3,10,5,5,26,18,8,35
Zenit,122,4,8,9,3,25,14,11,33
Krasnodar,122,5,9,4,7,30,25,5,31
Terek Grozny,122,6,7,6,7,22,25,-3,27
FK Rubin,122,7,6,6,8,22,17,5,24
Din Moscow,122,8,5,7,8,20,26,-6,22
Rostov,122,9,5,6,9,12,17,-5,21
Amkar,122,10,4,5,11,10,24,-14,17
Anzhi,122,11,3,6,11,16,38,-22,15
Loko Moscow,123,1,12,6,2,32,13,19,42
CSKA Moscow,123,2,11,4,5,28,18,10,37
Krasnodar,123,3,9,5,6,31,25,6,32
Zenit,123,4,7,9,4,22,15,7,30
Spart Moscow,123,5,8,5,7,38,33,5,29
Terek Grozny,123,6,8,5,7,24,25,-1,29
Din Moscow,123,7,6,7,7,21,24,-3,25
Amkar,123,8,6,4,10,15,26,-11,22
FK Rubin,123,9,5,6,9,22,21,1,21
Rostov,123,10,5,6,9,12,18,-6,21
Anzhi,123,11,2,5,13,15,42,-27,11
Loko Moscow,124,1,12,6,2,31,12,19,42
CSKA Moscow,124,2,12,3,5,28,17,11,39
Spart Moscow,124,3,11,5,4,36,25,11,38
Terek Grozny,124,4,9,5,6,24,24,0,32
Krasnodar,124,5,9,4,7,30,27,3,31
Zenit,124,6,7,9,4,21,15,6,30
Din Moscow,124,7,6,6,8,19,22,-3,24
FK Rubin,124,8,5,5,10,22,21,1,20
Rostov,124,9,4,6,10,10,18,-8,18
Amkar,124,10,4,4,12,9,24,-15,16
Anzhi,124,11,2,5,13,16,41,-25,11
Loko Moscow,125,1,11,6,3,31,15,16,39
Spart Moscow,125,2,11,5,4,38,27,11,38
CSKA Moscow,125,3,11,4,5,29,20,9,37
Zenit,125,4,7,10,3,25,17,8,31
Krasnodar,125,5,9,4,7,29,25,4,31
Terek Grozny,125,6,8,6,6,23,24,-1,30
Din Moscow,125,7,6,6,8,20,24,-4,24
FK Rubin,125,8,6,5,9,23,19,4,23
Rostov,125,9,4,6,10,10,18,-8,18
Amkar,125,10,4,4,12,11,26,-15,16
Anzhi,125,11,2,6,12,16,40,-24,12
Loko Moscow,126,1,11,6,3,32,15,17,39
Spart Moscow,126,2,11,5,4,39,26,13,38
CSKA Moscow,126,3,11,3,6,29,19,10,36
Zenit,126,4,9,8,3,25,15,10,35
Krasnodar,126,5,8,5,7,29,27,2,29
FK Rubin,126,6,7,5,8,23,17,6,26
Terek Grozny,126,7,7,5,8,20,26,-6,26
Din Moscow,126,8,5,6,9,18,25,-7,21
Amkar,126,9,5,4,11,10,23,-13,19
Rostov,126,10,4,6,10,10,19,-9,18
Anzhi,126,11,3,5,12,17,40,-23,14
Loko Moscow,127,1,12,5,3,31,13,18,41
CSKA Moscow,127,2,11,4,5,28,17,11,37
Krasnodar,127,3,10,4,6,30,24,6,34
Spart Moscow,127,4,9,6,5,38,28,10,33
Zenit,127,5,7,9,4,22,15,7,30
Terek Grozny,127,6,8,6,6,23,23,0,30
Din Moscow,127,7,7,6,7,22,21,1,27
FK Rubin,127,8,5,5,10,21,23,-2,20
Rostov,127,9,4,7,9,12,19,-7,19
Amkar,127,10,4,5,11,10,26,-16,17
Anzhi,127,11,2,5,13,14,42,-28,11
Loko Moscow,128,1,12,5,3,32,13,19,41
CSKA Moscow,128,2,11,3,6,27,24,3,36
Zenit,128,3,9,8,3,28,13,15,35
Spart Moscow,128,4,10,5,5,37,29,8,35
Krasnodar,128,5,9,4,7,30,28,2,31
Terek Grozny,128,6,7,5,8,20,24,-4,26
Din Moscow,128,7,5,7,8,19,25,-6,22
FK Rubin,128,8,5,6,9,23,20,3,21
Rostov,128,9,5,6,9,13,17,-4,21
Amkar,128,10,5,4,11,10,23,-13,19
Anzhi,128,11,3,5,12,16,39,-23,14
Loko Moscow,129,1,12,6,2,31,12,19,42
CSKA Moscow,129,2,12,3,5,30,18,12,39
Krasnodar,129,3,9,4,7,30,27,3,31
Zenit,129,4,7,9,4,22,16,6,30
Spart Moscow,129,5,8,6,6,35,32,3,30
Terek Grozny,129,6,8,6,6,23,24,-1,30
Din Moscow,129,7,6,6,8,19,23,-4,24
FK Rubin,129,8,6,5,9,24,20,4,23
Amkar,129,9,5,5,10,14,23,-9,20
Rostov,129,10,4,7,9,11,18,-7,19
Anzhi,129,11,2,5,13,16,42,-26,11
Loko Moscow,130,1,11,6,3,29,12,17,39
CSKA Moscow,130,2,11,3,6,30,20,10,36
Krasnodar,130,3,10,4,6,30,25,5,34
Zenit,130,4,8,9,3,23,13,10,33
Spart Moscow,130,5,8,6,6,36,30,6,30
Terek Grozny,130,6,7,5,8,21,26,-5,26
Din Moscow,130,7,6,6,8,20,26,-6,24
FK Rubin,130,8,6,5,9,25,19,6,23
Amkar,130,9,6,4,10,11,22,-11,22
Rostov,130,10,4,7,9,11,18,-7,19
Anzhi,130,11,3,5,12,18,43,-25,14
Loko Moscow,131,1,12,6,2,30,11,19,42
CSKA Moscow,131,2,12,3,5,31,19,12,39
Spart Moscow,131,3,11,5,4,42,26,16,38
Zenit,131,4,7,8,5,23,18,5,29
Krasnodar,131,5,8,5,7,28,26,2,29
Terek Grozny,131,6,7,7,6,21,23,-2,28
FK Rubin,131,7,7,5,8,24,18,6,26
Din Moscow,131,8,5,6,9,18,24,-6,21
Rostov,131,9,4,6,10,10,18,-8,18
Amkar,131,10,4,5,11,10,29,-19,17
Anzhi,131,11,2,6,12,14,39,-25,12
Loko Moscow,132,1,12,6,2,32,13,19,42
CSKA Moscow,132,2,11,3,6,28,19,9,36
Zenit,132,3,8,9,3,24,15,9,33
Spart Moscow,132,4,9,5,6,36,29,7,32
Krasnodar,132,5,9,4,7,30,26,4,31
Din Moscow,132,6,7,6,7,20,21,-1,27
Terek Grozny,132,7,7,5,8,21,26,-5,26
Amkar,132,8,6,4,10,13,24,-11,22
FK Rubin,132,9,5,5,10,21,20,1,20
Rostov,132,10,4,6,10,10,19,-9,18
Anzhi,132,11,3,5,12,16,39,-23,14
Loko Moscow,133,1,11,7,2,30,12,18,40
CSKA Moscow,133,2,12,3,5,32,19,13,39
Spart Moscow,133,3,10,5,5,43,28,15,35
Zenit,133,4,7,9,4,22,17,5,30
Terek Grozny,133,5,8,6,6,23,24,-1,30
Krasnodar,133,6,8,5,7,27,26,1,29
Din Moscow,133,7,6,6,8,18,26,-8,24
FK Rubin,133,8,6,5,9,23,18,5,23
Amkar,133,9,5,5,10,14,26,-12,20
Rostov,133,10,4,6,10,10,20,-10,18
Anzhi,133,11,2,5,13,16,42,-26,11
Loko Moscow,134,1,12,6,2,33,13,20,42
Spart Moscow,134,2,11,5,4,42,26,16,38
CSKA Moscow,134,3,10,3,7,26,20,6,33
Zenit,134,4,8,8,4,24,17,7,32
Krasnodar,134,5,8,6,6,30,27,3,30
Terek Grozny,134,6,7,5,8,22,26,-4,26
Din Moscow,134,7,6,6,8,19,22,-3,24
FK Rubin,134,8,5,6,9,23,21,2,21
Amkar,134,9,5,4,11,12,29,-17,19
Rostov,134,10,4,6,10,10,19,-9,18
Anzhi,134,11,4,5,11,17,38,-21,17
Loko Moscow,135,1,13,5,2,36,11,25,44
Spart Moscow,135,2,11,5,4,38,25,13,38
CSKA Moscow,135,3,11,3,6,28,18,10,36
Zenit,135,4,8,8,4,22,15,7,32
Krasnodar,135,5,8,4,8,27,31,-4,28
Terek Grozny,135,6,7,6,7,23,26,-3,27
FK Rubin,135,7,7,5,8,26,17,9,26
Din Moscow,135,8,5,6,9,17,25,-8,21
Amkar,135,9,5,4,11,11,25,-14,19
Rostov,135,10,4,6,10,10,19,-9,18
Anzhi,135,11,2,6,12,16,42,-26,12
Loko Moscow,136,1,12,5,3,32,15,17,41
Spart Moscow,136,2,11,5,4,37,26,11,38
CSKA Moscow,136,3,11,3,6,27,19,8,36
Zenit,136,4,8,8,4,25,16,9,32
Krasnodar,136,5,9,4,7,29,25,4,31
Terek Grozny,136,6,7,5,8,22,30,-8,26
Din Moscow,136,7,6,6,8,20,24,-4,24
FK Rubin,136,8,6,5,9,23,19,4,23
Amkar,136,9,5,4,11,11,23,-12,19
Rostov,136,10,4,6,10,10,18,-8,18
Anzhi,136,11,3,5,12,20,41,-21,14
Loko Moscow,137,1,12,5,3,35,16,19,41
CSKA Moscow,137,2,10,5,5,28,20,8,35
Krasnodar,137,3,10,4,6,33,26,7,34
Spart Moscow,137,4,9,5,6,38,30,8,32
Zenit,137,5,7,9,4,24,19,5,30
Terek Grozny,137,6,8,5,7,21,25,-4,29
Din Moscow,137,7,6,6,8,19,24,-5,24
Amkar,137,8,6,4,10,15,23,-8,22
Rostov,137,9,5,6,9,12,18,-6,21
FK Rubin,137,10,5,5,10,21,21,0,20
Anzhi,137,11,2,6,12,15,39,-24,12
Loko Moscow,138,1,12,5,3,33,15,18,41
CSKA Moscow,138,2,12,3,5,29,18,11,39
Spart Moscow,138,3,10,6,4,36,26,10,36
Krasnodar,138,4,9,4,7,29,26,3,31
Terek Grozny,138,5,8,6,6,22,23,-1,30
Zenit,138,6,7,8,5,24,18,6,29
FK Rubin,138,7,6,6,8,23,18,5,24
Din Moscow,138,8,5,7,8,18,23,-5,22
Rostov,138,9,4,7,9,11,18,-7,19
Amkar,138,10,4,5,11,9,23,-14,17
Anzhi,138,11,2,5,13,15,41,-26,11
Loko Moscow,139,1,12,6,2,32,11,21,42
Spart Moscow,139,2,11,5,4,40,26,14,38
CSKA Moscow,139,3,11,3,6,28,20,8,36
Krasnodar,139,4,8,6,6,28,25,3,30
Zenit,139,5,7,8,5,22,18,4,29
Terek Grozny,139,6,7,6,7,21,26,-5,27
FK Rubin,139,7,6,6,8,23,18,5,24
Din Moscow,139,8,5,6,9,18,26,-8,21
Amkar,139,9,5,4,11,12,23,-11,19
Rostov,139,10,4,6,10,10,19,-9,18
Anzhi,139,11,3,6,11,17,39,-22,15
Loko Moscow,140,1,13,5,2,31,11,20,44
CSKA Moscow,140,2,11,3,6,27,18,9,36
Spart Moscow,140,3,8,8,4,37,29,8,32
Zenit,140,4,8,8,4,22,14,8,32
Krasnodar,140,5,9,4,7,29,26,3,31
Terek Grozny,140,6,7,6,7,21,25,-4,27
Din Moscow,140,7,6,7,7,20,23,-3,25
FK Rubin,140,8,5,5,10,22,20,2,20
Amkar,140,9,5,5,10,13,24,-11,20
Rostov,140,10,4,7,9,10,17,-7,19
Anzhi,140,11,2,6,12,15,40,-25,12
Loko Moscow,141,1,12,5,3,32,14,18,41
CSKA Moscow,141,2,11,3,6,30,19,11,36
Spart Moscow,141,3,10,5,5,40,27,13,35
Krasnodar,141,4,10,4,6,33,27,6,34
Zenit,141,5,8,8,4,23,14,9,32
Terek Grozny,141,6,8,6,6,23,23,0,30
Din Moscow,141,7,5,7,8,17,24,-7,22
FK Rubin,141,8,5,6,9,22,20,2,21
Rostov,141,9,5,6,9,12,18,-6,21
Amkar,141,10,4,4,12,9,27,-18,16
Anzhi,141,11,2,6,12,15,43,-28,12
Loko Moscow,142,1,12,5,3,31,13,18,41
Spart Moscow,142,2,10,6,4,39,27,12,36
CSKA Moscow,142,3,11,3,6,30,20,10,36
Zenit,142,4,8,8,4,23,15,8,32
Krasnodar,142,5,9,5,6,31,27,4,32
Terek Grozny,142,6,8,5,7,24,25,-1,29
FK Rubin,142,7,6,6,8,25,20,5,24
Din Moscow,142,8,5,6,9,18,24,-6,21
Amkar,142,9,5,5,10,12,23,-11,20
Rostov,142,10,4,6,10,11,21,-10,18
Anzhi,142,11,2,5,13,16,45,-29,11
Loko Moscow,143,1,11,6,3,30,13,17,39
Spart Moscow,143,2,11,5,4,38,25,13,38
CSKA Moscow,143,3,11,3,6,26,18,8,36
Zenit,143,4,9,8,3,23,13,10,35
Krasnodar,143,5,9,5,6,32,25,7,32
Terek Grozny,143,6,8,6,6,23,24,-1,30
Din Moscow,143,7,5,7,8,18,24,-6,22
FK Rubin,143,8,5,6,9,22,22,0,21
Rostov,143,9,4,6,10,10,19,-9,18
Amkar,143,10,4,5,11,11,25,-14,17
Anzhi,143,11,2,5,13,14,39,-25,11
Loko Moscow,144,1,11,6,3,29,13,16,39
Spart Moscow,144,2,11,5,4,42,26,16,38
CSKA Moscow,144,3,10,4,6,26,19,7,34
Krasnodar,144,4,10,4,6,31,25,6,34
Zenit,144,5,8,9,3,23,14,9,33
Terek Grozny,144,6,8,6,6,24,24,0,30
FK Rubin,144,7,6,5,9,23,19,4,23
Din Moscow,144,8,5,6,9,17,24,-7,21
Rostov,144,9,4,6,10,11,22,-11,18
Amkar,144,10,4,4,12,10,27,-17,16
Anzhi,144,11,2,7,11,15,38,-23,13
Loko Moscow,145,1,13,5,2,33,12,21,44
Spart Moscow,145,2,11,5,4,38,27,11,38
CSKA Moscow,145,3,10,5,5,26,18,8,35
Krasnodar,145,4,9,4,7,33,26,7,31
Zenit,145,5,7,9,4,22,15,7,30
Terek Grozny,145,6,7,6,7,21,24,-3,27
FK Rubin,145,7,6,5,9,25,24,1,23
Din Moscow,145,8,5,6,9,19,27,-8,21
Amkar,145,9,5,4,11,11,24,-13,19
Rostov,145,10,4,6,10,10,18,-8,18
Anzhi,145,11,2,7,11,16,39,-23,13
Loko Moscow,146,1,12,5,3,31,13,18,41
CSKA Moscow,146,2,12,3,5,32,21,11,39
Spart Moscow,146,3,10,6,4,38,28,10,36
Zenit,146,4,8,8,4,23,16,7,32
Krasnodar,146,5,8,4,8,30,30,0,28
Terek Grozny,146,6,7,6,7,21,24,-3,27
FK Rubin,146,7,6,6,8,26,20,6,24
Din Moscow,146,8,5,7,8,20,25,-5,22
Rostov,146,9,4,6,10,10,18,-8,18
Amkar,146,10,4,6,10,11,24,-13,18
Anzhi,146,11,3,5,12,18,41,-23,14
Loko Moscow,147,1,11,6,3,31,15,16,39
CSKA Moscow,147,2,10,4,6,26,21,5,34
Zenit,147,3,8,9,3,25,14,11,33
Krasnodar,147,4,9,5,6,30,25,5,32
Spart Moscow,147,5,8,7,5,33,26,7,31
Terek Grozny,147,6,7,6,7,21,24,-3,27
FK Rubin,147,7,6,6,8,22,17,5,24
Din Moscow,147,8,5,7,8,17,22,-5,22
Rostov,147,9,5,6,9,11,17,-6,21
Amkar,147,10,5,5,10,11,23,-12,20
Anzhi,147,11,2,7,11,15,38,-23,13
Loko Moscow,148,1,12,5,3,31,16,15,41
CSKA Moscow,148,2,11,3,6,27,19,8,36
Krasnodar,148,3,10,4,6,33,24,9,34
Zenit,148,4,8,8,4,22,15,7,32
Spart Moscow,148,5,8,6,6,35,30,5,30
Terek Grozny,148,6,7,5,8,20,24,-4,26
Din Moscow,148,7,5,8,7,18,22,-4,23
Amkar,148,8,6,4,10,11,22,-11,22
FK Rubin,148,9,5,6,9,21,18,3,21
Rostov,148,10,5,6,9,13,18,-5,21
Anzhi,148,11,3,5,12,16,39,-23,14
Loko Moscow,149,1,11,6,3,31,14,17,39
CSKA Moscow,149,2,11,3,6,29,20,9,36
Zenit,149,3,9,8,3,23,13,10,35
Terek Grozny,149,4,9,5,6,24,23,1,32
Spart Moscow,149,5,8,7,5,36,31,5,31
Krasnodar,149,6,8,5,7,29,27,2,29
FK Rubin,149,7,7,5,8,24,17,7,26
Din Moscow,149,8,5,7,8,18,24,-6,22
Rostov,149,9,5,6,9,14,18,-4,21
Amkar,149,10,4,5,11,10,25,-15,17
Anzhi,149,11,2,5,13,17,43,-26,11
Loko Moscow,150,1,12,5,3,30,14,16,41
Spart Moscow,150,2,10,5,5,38,27,11,35
CSKA Moscow,150,3,10,5,5,28,20,8,35
Krasnodar,150,4,10,4,6,34,26,8,34
Zenit,150,5,7,9,4,22,15,7,30
Terek Grozny,150,6,8,5,7,23,24,-1,29
Din Moscow,150,7,6,6,8,19,26,-7,24
FK Rubin,150,8,6,5,9,27,21,6,23
Rostov,150,9,4,6,10,10,20,-10,18
Amkar,150,10,4,4,12,10,26,-16,16
Anzhi,150,11,3,6,11,17,39,-22,15
Loko Moscow,151,1,12,6,2,31,11,20,42
CSKA Moscow,151,2,11,3,6,27,19,8,36
Spart Moscow,151,3,10,5,5,35,26,9,35
Zenit,151,4,8,9,3,22,13,9,33
Terek Grozny,151,5,8,6,6,23,24,-1,30
Krasnodar,151,6,8,4,8,27,27,0,28
Din Moscow,151,7,6,6,8,18,22,-4,24
FK Rubin,151,8,6,5,9,22,18,4,23
Amkar,151,9,5,5,10,11,23,-12,20
Rostov,151,10,4,6,10,10,18,-8,18
Anzhi,151,11,2,5,13,16,41,-25,11
Loko Moscow,152,1,12,5,3,32,12,20,41
CSKA Moscow,152,2,11,3,6,29,19,10,36
Zenit,152,3,9,8,3,24,13,11,35
Spart Moscow,152,4,10,5,5,37,27,10,35
Krasnodar,152,5,9,4,7,28,27,1,31
Terek Grozny,152,6,7,6,7,21,24,-3,27
FK Rubin,152,7,6,5,9,22,18,4,23
Din Moscow,152,8,5,6,9,17,24,-7,21
Amkar,152,9,5,5,10,10,22,-12,20
Rostov,152,10,4,6,10,11,19,-8,18
Anzhi,152,11,3,5,12,16,42,-26,14
Loko Moscow,153,1,13,5,2,34,11,23,44
Spart Moscow,153,2,11,5,4,39,27,12,38
CSKA Moscow,153,3,10,3,7,25,22,3,33
Zenit,153,4,8,8,4,23,15,8,32
Terek Grozny,153,5,9,5,6,25,24,1,32
Krasnodar,153,6,8,5,7,28,28,0,29
FK Rubin,153,7,6,6,8,23,18,5,24
Din Moscow,153,8,5,6,9,18,24,-6,21
Rostov,153,9,4,6,10,10,19,-9,18
Amkar,153,10,4,4,12,11,26,-15,16
Anzhi,153,11,3,5,12,18,40,-22,14
Loko Moscow,154,1,11,7,2,30,12,18,40
CSKA Moscow,154,2,11,3,6,28,20,8,36
Zenit,154,3,8,9,3,25,16,9,33
Spart Moscow,154,4,9,5,6,35,28,7,32
Terek Grozny,154,5,8,6,6,22,23,-1,30
Krasnodar,154,6,8,5,7,28,26,2,29
FK Rubin,154,7,7,5,8,24,18,6,26
Rostov,154,8,5,6,9,12,17,-5,21
Din Moscow,154,9,5,6,9,17,24,-7,21
Amkar,154,10,5,5,10,11,23,-12,20
Anzhi,154,11,2,5,13,14,39,-25,11
Loko Moscow,155,1,12,5,3,31,14,17,41
CSKA Moscow,155,2,11,4,5,28,19,9,37
Spart Moscow,155,3,9,6,5,35,27,8,33
Krasnodar,155,4,9,4,7,29,25,4,31
Zenit,155,5,7,8,5,23,17,6,29
Terek Grozny,155,6,8,5,7,22,27,-5,29
Din Moscow,155,7,6,6,8,18,22,-4,24
FK Rubin,155,8,6,5,9,22,18,4,23
Rostov,155,9,5,6,9,11,17,-6,21
Amkar,155,10,5,5,10,14,23,-9,20
Anzhi,155,11,2,6,12,16,40,-24,12
Loko Moscow,156,1,12,5,3,30,12,18,41
Spart Moscow,156,2,11,5,4,41,27,14,38
Zenit,156,3,9,8,3,24,14,10,35
CSKA Moscow,156,4,10,3,7,27,21,6,33
Krasnodar,156,5,9,4,7,30,26,4,31
Terek Grozny,156,6,7,7,6,20,22,-2,28
Din Moscow,156,7,6,6,8,19,23,-4,24
FK Rubin,156,8,5,5,10,22,21,1,20
Rostov,156,9,4,6,10,10,20,-10,18
Amkar,156,10,4,5,11,10,25,-15,17
Anzhi,156,11,3,6,11,16,38,-22,15
Loko Moscow,157,1,12,5,3,33,15,18,41
Zenit,157,2,9,8,3,24,14,10,35
CSKA Moscow,157,3,10,4,6,25,18,7,34
Spart Moscow,157,4,9,6,5,37,27,10,33
Krasnodar,157,5,9,4,7,30,27,3,31
Terek Grozny,157,6,8,5,7,22,25,-3,29
Din Moscow,157,7,6,6,8,20,24,-4,24
FK Rubin,157,8,6,5,9,23,19,4,23
Rostov,157,9,4,7,9,10,17,-7,19
Amkar,157,10,4,4,12,9,26,-17,16
Anzhi,157,11,3,6,11,17,38,-21,15
Loko Moscow,158,1,11,5,4,29,13,16,38
CSKA Moscow,158,2,11,3,6,27,21,6,36
Zenit,158,3,9,8,3,25,13,12,35
Spart Moscow,158,4,10,5,5,36,27,9,35
Krasnodar,158,5,10,4,6,31,25,6,34
Terek Grozny,158,6,8,5,7,23,24,-1,29
Din Moscow,158,7,6,6,8,18,22,-4,24
Amkar,158,8,6,4,10,12,22,-10,22
FK Rubin,158,9,5,5,10,22,21,1,20
Rostov,158,10,4,6,10,11,19,-8,18
Anzhi,158,11,2,5,13,15,42,-27,11
Loko Moscow,159,1,11,6,3,30,14,16,39
CSKA Moscow,159,2,12,3,5,31,17,14,39
Spart Moscow,159,3,10,5,5,40,29,11,35
Krasnodar,159,4,9,4,7,31,28,3,31
Zenit,159,5,7,9,4,22,15,7,30
Terek Grozny,159,6,7,7,6,23,25,-2,28
Din Moscow,159,7,6,6,8,21,27,-6,24
FK Rubin,159,8,6,5,9,26,22,4,23
Rostov,159,9,5,6,9,13,18,-5,21
Amkar,159,10,4,5,11,12,26,-14,17
Anzhi,159,11,2,6,12,14,42,-28,12
Loko Moscow,160,1,12,6,2,30,11,19,42
CSKA Moscow,160,2,11,3,6,26,18,8,36
Spart Moscow,160,3,9,6,5,40,30,10,33
Zenit,160,4,8,8,4,22,14,8,32
Krasnodar,160,5,9,5,6,28,24,4,32
Terek Grozny,160,6,8,6,6,22,23,-1,30
Din Moscow,160,7,5,7,8,18,25,-7,22
FK Rubin,160,8,5,6,9,21,18,3,21
Amkar,160,9,5,5,10,11,23,-12,20
Rostov,160,10,4,7,9,12,19,-7,19
Anzhi,160,11,2,5,13,15,40,-25,11
Loko Moscow,161,1,12,6,2,33,13,20,42
CSKA Moscow,161,2,11,4,5,29,18,11,37
Spart Moscow,161,3,10,5,5,35,27,8,35
Zenit,161,4,7,9,4,23,17,6,30
Krasnodar,161,5,8,6,6,29,26,3,30
Terek Grozny,161,6,7,6,7,20,24,-4,27
FK Rubin,161,7,5,7,8,23,19,4,22
Din Moscow,161,8,5,7,8,18,23,-5,22
Amkar,161,9,6,4,10,13,22,-9,22
Rostov,161,10,4,6,10,10,18,-8,18
Anzhi,161,11,2,6,12,14,40,-26,12
Loko Moscow,162,1,11,5,4,31,15,16,38
CSKA Moscow,162,2,11,4,5,29,18,11,37
Krasnodar,162,3,10,4,6,33,27,6,34
Spart Moscow,162,4,9,6,5,35,26,9,33
Zenit,162,5,8,8,4,23,17,6,32
Terek Grozny,162,6,8,6,6,22,23,-1,30
Din Moscow,162,7,5,7,8,19,25,-6,22
FK Rubin,162,8,5,6,9,25,23,2,21
Rostov,162,9,5,6,9,11,17,-6,21
Amkar,162,10,4,6,10,10,23,-13,18
Anzhi,162,11,2,6,12,15,39,-24,12
Loko Moscow,163,1,11,5,4,30,14,16,38
CSKA Moscow,163,2,10,5,5,28,20,8,35
Krasnodar,163,3,10,4,6,31,25,6,34
Zenit,163,4,8,9,3,23,14,9,33
Terek Grozny,163,5,8,6,6,22,23,-1,30
Spart Moscow,163,6,8,5,7,36,32,4,29
Din Moscow,163,7,6,7,7,21,24,-3,25
FK Rubin,163,8,5,6,9,22,20,2,21
Rostov,163,9,5,6,9,12,18,-6,21
Amkar,163,10,5,5,10,11,22,-11,20
Anzhi,163,11,2,6,12,17,41,-24,12
Loko Moscow,164,1,12,5,3,33,15,18,41
CSKA Moscow,164,2,11,4,5,29,20,9,37
Spart Moscow,164,3,10,6,4,41,27,14,36
Zenit,164,4,8,8,4,25,15,10,32
Krasnodar,164,5,9,4,7,30,29,1,31
Terek Grozny,164,6,7,7,6,24,26,-2,28
Din Moscow,164,7,5,7,8,19,27,-8,22
FK Rubin,164,8,5,6,9,24,21,3,21
Rostov,164,9,4,6,10,11,20,-9,18
Amkar,164,10,4,6,10,11,24,-13,18
Anzhi,164,11,2,7,11,19,42,-23,13
Loko Moscow,165,1,13,5,2,32,11,21,44
CSKA Moscow,165,2,12,3,5,31,21,10,39
Spart Moscow,165,3,9,6,5,37,30,7,33
Terek Grozny,165,4,8,6,6,23,23,0,30
Zenit,165,5,7,8,5,23,18,5,29
Krasnodar,165,6,8,5,7,28,26,2,29
Din Moscow,165,7,7,6,7,22,23,-1,27
FK Rubin,165,8,5,6,9,23,20,3,21
Rostov,165,9,4,7,9,12,19,-7,19
Amkar,165,10,4,4,12,9,25,-16,16
Anzhi,165,11,2,6,12,17,41,-24,12
Loko Moscow,166,1,12,6,2,31,12,19,42
CSKA Moscow,166,2,12,3,5,32,19,13,39
Spart Moscow,166,3,8,7,5,36,29,7,31
Krasnodar,166,4,9,4,7,30,27,3,31
Zenit,166,5,7,9,4,23,16,7,30
Terek Grozny,166,6,7,7,6,20,22,-2,28
FK Rubin,166,7,6,5,9,25,20,5,23
Din Moscow,166,8,5,7,8,19,25,-6,22
Amkar,166,9,5,5,10,11,23,-12,20
Rostov,166,10,4,7,9,11,18,-7,19
Anzhi,166,11,2,6,12,14,41,-27,12
Loko Moscow,167,1,11,7,2,32,14,18,40
CSKA Moscow,167,2,11,4,5,26,17,9,37
Terek Grozny,167,3,9,5,6,23,23,0,32
Zenit,167,4,7,10,3,23,15,8,31
Spart Moscow,167,5,8,6,6,33,30,3,30
Krasnodar,167,6,8,5,7,29,27,2,29
FK Rubin,167,7,6,6,8,24,19,5,24
Din Moscow,167,8,5,8,7,18,22,-4,23
Rostov,167,9,5,6,9,12,17,-5,21
Amkar,167,10,5,4,11,12,23,-11,19
Anzhi,167,11,2,5,13,15,40,-25,11
Loko Moscow,168,1,12,6,2,32,13,19,42
Spart Moscow,168,2,11,5,4,39,27,12,38
CSKA Moscow,168,3,10,4,6,25,18,7,34
Zenit,168,4,7,10,3,22,14,8,31
Krasnodar,168,5,9,4,7,30,27,3,31
Terek Grozny,168,6,7,6,7,21,24,-3,27
Din Moscow,168,7,6,6,8,21,24,-3,24
FK Rubin,168,8,5,5,10,23,23,0,20
Amkar,168,9,5,4,11,12,25,-13,19
Rostov,168,10,4,6,10,10,18,-8,18
Anzhi,168,11,3,6,11,16,38,-22,15
Loko Moscow,169,1,12,5,3,30,13,17,41
CSKA Moscow,169,2,11,3,6,27,19,8,36
Spart Moscow,169,3,10,5,5,37,26,11,35
Krasnodar,169,4,10,4,6,32,25,7,34
Zenit,169,5,8,8,4,23,15,8,32
Terek Grozny,169,6,8,6,6,22,23,-1,30
Din Moscow,169,7,5,7,8,18,23,-5,22
FK Rubin,169,8,5,6,9,23,21,2,21
Amkar,169,9,5,5,10,11,23,-12,20
Rostov,169,10,4,6,10,10,20,-10,18
Anzhi,169,11,2,5,13,14,39,-25,11
Loko Moscow,170,1,11,6,3,29,13,16,39
CSKA Moscow,170,2,10,4,6,25,18,7,34
Krasnodar,170,3,10,4,6,32,26,6,34
Spart Moscow,170,4,9,6,5,39,30,9,33
Zenit,170,5,7,10,3,21,13,8,31
Terek Grozny,170,6,8,6,6,23,24,-1,30
Din Moscow,170,7,6,6,8,21,24,-3,24
FK Rubin,170,8,6,5,9,25,21,4,23
Rostov,170,9,4,6,10,10,20,-10,18
Amkar,170,10,4,6,10,12,25,-13,18
Anzhi,170,11,3,5,12,16,39,-23,14
Loko Moscow,171,1,11,6,3,31,18,13,39
CSKA Moscow,171,2,12,3,5,28,17,11,39
Spart Moscow,171,3,9,7,4,36,26,10,34
Krasnodar,171,4,9,4,7,32,25,7,31
Zenit,171,5,7,9,4,23,16,7,30
Terek Grozny,171,6,8,5,7,22,25,-3,29
Din Moscow,171,7,6,7,7,21,22,-1,25
FK Rubin,171,8,6,5,9,22,20,2,23
Rostov,171,9,4,7,9,10,17,-7,19
Amkar,171,10,4,4,12,10,26,-16,16
Anzhi,171,11,3,5,12,16,39,-23,14
Loko Moscow,172,1,12,5,3,31,13,18,41
CSKA Moscow,172,2,12,3,5,30,18,12,39
Krasnodar,172,3,10,4,6,30,25,5,34
Spart Moscow,172,4,8,6,6,36,30,6,30
Zenit,172,5,7,8,5,21,15,6,29
Terek Grozny,172,6,8,5,7,21,26,-5,29
Din Moscow,172,7,6,7,7,20,23,-3,25
Amkar,172,8,6,4,10,15,23,-8,22
FK Rubin,172,9,5,6,9,21,18,3,21
Rostov,172,10,4,7,9,10,17,-7,19
Anzhi,172,11,2,5,13,15,42,-27,11
CSKA Moscow,173,1,12,3,5,28,17,11,39
Loko Moscow,173,2,11,5,4,29,14,15,38
Krasnodar,173,3,10,4,6,30,24,6,34
Spart Moscow,173,4,9,6,5,37,29,8,33
Zenit,173,5,8,8,4,23,14,9,32
Terek Grozny,173,6,7,6,7,21,25,-4,27
Din Moscow,173,7,6,6,8,18,23,-5,24
Amkar,173,8,6,4,10,14,23,-9,22
FK Rubin,173,9,5,5,10,21,20,1,20
Rostov,173,10,4,7,9,11,18,-7,19
Anzhi,173,11,2,6,12,15,40,-25,12
Loko Moscow,174,1,12,5,3,33,14,19,41
CSKA Moscow,174,2,10,4,6,27,21,6,34
Spart Moscow,174,3,9,6,5,36,28,8,33
Zenit,174,4,8,8,4,25,17,8,32
Krasnodar,174,5,9,5,6,30,26,4,32
Terek Grozny,174,6,8,6,6,21,22,-1,30
Din Moscow,174,7,6,7,7,21,22,-1,25
FK Rubin,174,8,5,6,9,22,21,1,21
Rostov,174,9,5,6,9,11,17,-6,21
Amkar,174,10,4,4,12,10,25,-15,16
Anzhi,174,11,2,7,11,15,38,-23,13
Loko Moscow,175,1,12,6,2,33,14,19,42
CSKA Moscow,175,2,11,3,6,27,18,9,36
Spart Moscow,175,3,9,5,6,37,28,9,32
Zenit,175,4,8,8,4,22,14,8,32
Terek Grozny,175,5,8,6,6,22,23,-1,30
Krasnodar,175,6,8,5,7,30,28,2,29
FK Rubin,175,7,6,6,8,23,18,5,24
Din Moscow,175,8,5,7,8,18,25,-7,22
Rostov,175,9,5,6,9,12,18,-6,21
Amkar,175,10,5,5,10,10,22,-12,20
Anzhi,175,11,2,5,13,15,41,-26,11
Loko Moscow,176,1,12,5,3,33,14,19,41
CSKA Moscow,176,2,11,3,6,29,19,10,36
Zenit,176,3,9,8,3,23,13,10,35
Spart Moscow,176,4,10,5,5,37,28,9,35
Krasnodar,176,5,8,4,8,30,30,0,28
Terek Grozny,176,6,7,7,6,22,24,-2,28
Din Moscow,176,7,6,6,8,20,23,-3,24
FK Rubin,176,8,6,5,9,23,20,3,23
Amkar,176,9,5,5,10,11,23,-12,20
Rostov,176,10,4,6,10,10,18,-8,18
Anzhi,176,11,2,6,12,17,43,-26,12
Loko Moscow,177,1,11,7,2,30,12,18,40
Spart Moscow,177,2,11,5,4,38,26,12,38
CSKA Moscow,177,3,11,4,5,30,19,11,37
Terek Grozny,177,4,9,5,6,24,23,1,32
Zenit,177,5,7,10,3,23,15,8,31
Krasnodar,177,6,8,6,6,29,26,3,30
FK Rubin,177,7,6,6,8,24,19,5,24
Din Moscow,177,8,5,6,9,19,25,-6,21
Rostov,177,9,4,6,10,10,18,-8,18
Amkar,177,10,4,4,12,10,27,-17,16
Anzhi,177,11,2,5,13,14,41,-27,11
Loko Moscow,178,1,12,6,2,31,12,19,42
CSKA Moscow,178,2,11,3,6,27,19,8,36
Spart Moscow,178,3,9,7,4,40,28,12,34
Zenit,178,4,8,9,3,23,14,9,33
Krasnodar,178,5,8,5,7,28,26,2,29
Terek Grozny,178,6,8,5,7,22,26,-4,29
FK Rubin,178,7,6,6,8,24,18,6,24
Din Moscow,178,8,5,6,9,19,29,-10,21
Rostov,178,9,4,7,9,10,17,-7,19
Amkar,178,10,4,5,11,12,26,-14,17
Anzhi,178,11,3,5,12,17,38,-21,14
Loko Moscow,179,1,12,5,3,31,14,17,41
Spart Moscow,179,2,10,6,4,39,26,13,36
CSKA Moscow,179,3,11,3,6,28,20,8,36
Zenit,179,4,8,8,4,24,15,9,32
Krasnodar,179,5,9,5,6,32,27,5,32
Terek Grozny,179,6,8,5,7,21,23,-2,29
FK Rubin,179,7,5,7,8,23,19,4,22
Din Moscow,179,8,5,7,8,17,23,-6,22
Amkar,179,9,5,5,10,10,22,-12,20
Rostov,179,10,4,6,10,11,21,-10,18
Anzhi,179,11,2,5,13,14,40,-26,11
Loko Moscow,180,1,11,6,3,30,13,17,39
CSKA Moscow,180,2,11,4,5,27,18,9,37
Zenit,180,3,8,9,3,23,14,9,33
Spart Moscow,180,4,9,5,6,38,29,9,32
Krasnodar,180,5,8,5,7,28,26,2,29
Din Moscow,180,6,7,6,7,20,21,-1,27
Terek Grozny,180,7,7,5,8,21,27,-6,26
FK Rubin,180,8,6,5,9,22,19,3,23
Amkar,180,9,6,4,10,15,24,-9,22
Rostov,180,10,4,6,10,10,20,-10,18
Anzhi,180,11,3,5,12,16,39,-23,14
Loko Moscow,181,1,11,6,3,32,15,17,39
Spart Moscow,181,2,9,7,4,36,27,9,34
CSKA Moscow,181,3,10,4,6,25,18,7,34
Zenit,181,4,8,9,3,22,13,9,33
Krasnodar,181,5,9,5,6,33,28,5,32
Terek Grozny,181,6,8,6,6,21,22,-1,30
Din Moscow,181,7,6,7,7,19,22,-3,25
FK Rubin,181,8,5,5,10,22,21,1,20
Rostov,181,9,4,7,9,10,17,-7,19
Amkar,181,10,4,4,12,10,25,-15,16
Anzhi,181,11,3,6,11,15,37,-22,15
Loko Moscow,182,1,13,5,2,34,14,20,44
CSKA Moscow,182,2,10,4,6,25,18,7,34
Spart Moscow,182,3,9,5,6,36,29,7,32
Zenit,182,4,7,9,4,23,16,7,30
Terek Grozny,182,5,8,5,7,22,26,-4,29
Krasnodar,182,6,8,4,8,28,27,1,28
Din Moscow,182,7,7,6,7,21,21,0,27
FK Rubin,182,8,6,5,9,22,19,3,23
Amkar,182,9,6,4,10,13,22,-9,22
Rostov,182,10,4,6,10,11,20,-9,18
Anzhi,182,11,3,5,12,16,39,-23,14
CSKA Moscow,183,1,12,3,5,31,21,10,39
Loko Moscow,183,2,11,5,4,30,15,15,38
Spart Moscow,183,3,11,5,4,40,28,12,38
Zenit,183,4,8,8,4,26,17,9,32
Krasnodar,183,5,9,4,7,30,28,2,31
Terek Grozny,183,6,8,6,6,22,23,-1,30
FK Rubin,183,7,7,5,8,27,20,7,26
Din Moscow,183,8,5,6,9,19,25,-6,21
Rostov,183,9,4,6,10,11,20,-9,18
Amkar,183,10,4,5,11,11,25,-14,17
Anzhi,183,11,2,5,13,16,41,-25,11
Loko Moscow,184,1,12,5,3,33,13,20,41
Spart Moscow,184,2,11,5,4,40,29,11,38
CSKA Moscow,184,3,11,3,6,26,19,7,36
Krasnodar,184,4,10,4,6,35,26,9,34
Zenit,184,5,8,8,4,23,16,7,32
Terek Grozny,184,6,8,6,6,23,24,-1,30
Din Moscow,184,7,6,6,8,19,22,-3,24
FK Rubin,184,8,5,5,10,22,25,-3,20
Rostov,184,9,4,6,10,11,19,-8,18
Amkar,184,10,4,5,11,13,27,-14,17
Anzhi,184,11,2,5,13,15,40,-25,11
Loko Moscow,185,1,12,5,3,31,13,18,41
CSKA Moscow,185,2,12,3,5,29,17,12,39
Spart Moscow,185,3,11,5,4,39,26,13,38
Krasnodar,185,4,10,4,6,32,26,6,34
Zenit,185,5,7,8,5,22,17,5,29
Terek Grozny,185,6,7,6,7,20,23,-3,27
FK Rubin,185,7,6,5,9,25,22,3,23
Din Moscow,185,8,5,6,9,18,25,-7,21
Rostov,185,9,4,6,10,11,19,-8,18
Amkar,185,10,4,5,11,9,24,-15,17
Anzhi,185,11,3,5,12,15,39,-24,14
Loko Moscow,186,1,11,6,3,30,14,16,39
CSKA Moscow,186,2,12,3,5,28,17,11,39
Spart Moscow,186,3,9,7,4,37,28,9,34
Zenit,186,4,8,8,4,23,15,8,32
Terek Grozny,186,5,8,6,6,23,23,0,30
Krasnodar,186,6,8,5,7,29,27,2,29
Din Moscow,186,7,6,6,8,21,25,-4,24
FK Rubin,186,8,6,5,9,24,20,4,23
Rostov,186,9,4,7,9,11,18,-7,19
Amkar,186,10,4,6,10,10,23,-13,18
Anzhi,186,11,2,5,13,14,40,-26,11
Loko Moscow,187,1,12,6,2,32,13,19,42
CSKA Moscow,187,2,11,3,6,27,19,8,36
Spart Moscow,187,3,9,6,5,39,29,10,33
Zenit,187,4,8,8,4,23,14,9,32
Krasnodar,187,5,9,5,6,31,27,4,32
Terek Grozny,187,6,8,5,7,24,24,0,29
Din Moscow,187,7,5,8,7,20,24,-4,23
Amkar,187,8,6,4,10,12,23,-11,22
FK Rubin,187,9,5,6,9,22,19,3,21
Rostov,187,10,4,6,10,10,20,-10,18
Anzhi,187,11,2,5,13,14,42,-28,11
Loko Moscow,188,1,13,5,2,31,11,20,44
CSKA Moscow,188,2,11,4,5,28,19,9,37
Spart Moscow,188,3,8,8,4,37,29,8,32
Terek Grozny,188,4,9,5,6,23,22,1,32
Zenit,188,5,7,9,4,22,15,7,30
Krasnodar,188,6,8,4,8,28,27,1,28
Din Moscow,188,7,6,7,7,20,23,-3,25
FK Rubin,188,8,6,5,9,23,19,4,23
Rostov,188,9,4,7,9,11,18,-7,19
Amkar,188,10,4,5,11,10,24,-14,17
Anzhi,188,11,2,5,13,15,41,-26,11
Loko Moscow,189,1,12,6,2,31,12,19,42
CSKA Moscow,189,2,11,3,6,27,21,6,36
Spart Moscow,189,3,10,5,5,36,27,9,35
Zenit,189,4,8,9,3,26,14,12,33
Krasnodar,189,5,9,4,7,28,25,3,31
Terek Grozny,189,6,7,6,7,22,26,-4,27
Din Moscow,189,7,6,7,7,18,21,-3,25
FK Rubin,189,8,5,6,9,21,18,3,21
Amkar,189,9,5,4,11,11,23,-12,19
Rostov,189,10,4,6,10,11,19,-8,18
Anzhi,189,11,2,6,12,16,41,-25,12
Loko Moscow,190,1,12,5,3,31,13,18,41
CSKA Moscow,190,2,11,4,5,33,18,15,37
Spart Moscow,190,3,9,7,4,34,25,9,34
Krasnodar,190,4,10,4,6,31,25,6,34
Zenit,190,5,7,9,4,21,15,6,30
Terek Grozny,190,6,8,5,7,21,23,-2,29
FK Rubin,190,7,6,5,9,24,19,5,23
Din Moscow,190,8,5,7,8,17,23,-6,22
Rostov,190,9,4,7,9,10,17,-7,19
Amkar,190,10,4,4,12,9,24,-15,16
Anzhi,190,11,3,5,12,16,45,-29,14
Loko Moscow,191,1,13,5,2,33,12,21,44
CSKA Moscow,191,2,10,4,6,25,19,6,34
Zenit,191,3,8,8,4,24,16,8,32
Spart Moscow,191,4,9,5,6,38,34,4,32
Terek Grozny,191,5,9,5,6,24,24,0,32
Krasnodar,191,6,8,5,7,28,26,2,29
Din Moscow,191,7,7,6,7,23,21,2,27
FK Rubin,191,8,5,6,9,22,19,3,21
Amkar,191,9,5,4,11,13,26,-13,19
Rostov,191,10,4,6,10,11,20,-9,18
Anzhi,191,11,2,6,12,15,39,-24,12
Loko Moscow,192,1,13,5,2,31,11,20,44
CSKA Moscow,192,2,11,4,5,33,19,14,37
Spart Moscow,192,3,9,6,5,35,27,8,33
Krasnodar,192,4,9,4,7,30,27,3,31
Zenit,192,5,7,9,4,22,15,7,30
Terek Grozny,192,6,7,5,8,21,27,-6,26
Din Moscow,192,7,6,7,7,20,22,-2,25
Amkar,192,8,6,4,10,12,22,-10,22
FK Rubin,192,9,5,5,10,23,22,1,20
Rostov,192,10,4,6,10,10,18,-8,18
Anzhi,192,11,3,5,12,18,45,-27,14
Loko Moscow,193,1,11,6,3,31,14,17,39
CSKA Moscow,193,2,12,3,5,30,17,13,39
Spart Moscow,193,3,9,6,5,36,28,8,33
Krasnodar,193,4,9,4,7,31,28,3,31
Zenit,193,5,7,9,4,22,15,7,30
Terek Grozny,193,6,8,5,7,22,24,-2,29
Din Moscow,193,7,6,6,8,23,25,-2,24
FK Rubin,193,8,6,5,9,26,24,2,23
Rostov,193,9,5,6,9,11,17,-6,21
Amkar,193,10,5,5,10,12,24,-12,20
Anzhi,193,11,2,5,13,14,42,-28,11
Loko Moscow,194,1,12,5,3,33,15,18,41
CSKA Moscow,194,2,11,3,6,26,20,6,36
Krasnodar,194,3,10,4,6,32,25,7,34
Spart Moscow,194,4,9,6,5,37,27,10,33
Zenit,194,5,7,8,5,23,17,6,29
Terek Grozny,194,6,7,6,7,24,27,-3,27
Din Moscow,194,7,6,7,7,19,22,-3,25
FK Rubin,194,8,5,6,9,21,20,1,21
Rostov,194,9,4,6,10,10,20,-10,18
Amkar,194,10,4,6,10,10,23,-13,18
Anzhi,194,11,4,5,11,21,40,-19,17
Loko Moscow,195,1,11,6,3,32,15,17,39
CSKA Moscow,195,2,12,3,5,32,18,14,39
Spart Moscow,195,3,9,5,6,37,29,8,32
Zenit,195,4,8,8,4,23,17,6,32
Krasnodar,195,5,9,5,6,31,26,5,32
Terek Grozny,195,6,7,6,7,20,23,-3,27
Din Moscow,195,7,6,6,8,19,24,-5,24
FK Rubin,195,8,6,5,9,24,20,4,23
Rostov,195,9,5,6,9,12,18,-6,21
Amkar,195,10,4,5,11,10,25,-15,17
Anzhi,195,11,3,5,12,16,41,-25,14
Loko Moscow,196,1,12,5,3,33,15,18,41
CSKA Moscow,196,2,11,3,6,26,18,8,36
Krasnodar,196,3,10,4,6,34,27,7,34
Spart Moscow,196,4,9,5,6,37,28,9,32
Zenit,196,5,7,8,5,22,16,6,29
Terek Grozny,196,6,7,6,7,23,26,-3,27
Din Moscow,196,7,6,7,7,19,22,-3,25
FK Rubin,196,8,5,6,9,22,21,1,21
Amkar,196,9,5,5,10,11,23,-12,20
Rostov,196,10,4,6,10,10,20,-10,18
Anzhi,196,11,4,5,11,18,39,-21,17
Loko Moscow,197,1,12,5,3,33,15,18,41
Spart Moscow,197,2,10,6,4,37,27,10,36
Krasnodar,197,3,10,4,6,33,26,7,34
CSKA Moscow,197,4,10,3,7,28,23,5,33
Zenit,197,5,8,8,4,25,18,7,32
Terek Grozny,197,6,8,6,6,21,22,-1,30
Din Moscow,197,7,6,6,8,20,23,-3,24
FK Rubin,197,8,5,5,10,21,21,0,20
Rostov,197,9,4,6,10,10,18,-8,18
Amkar,197,10,4,6,10,10,23,-13,18
Anzhi,197,11,3,5,12,16,38,-22,14
Loko Moscow,198,1,11,6,3,32,15,17,39
CSKA Moscow,198,2,12,3,5,27,17,10,39
Spart Moscow,198,3,9,7,4,36,27,9,34
Zenit,198,4,8,8,4,23,15,8,32
Krasnodar,198,5,9,5,6,30,26,4,32
Terek Grozny,198,6,8,5,7,23,23,0,29
Din Moscow,198,7,5,7,8,19,24,-5,22
FK Rubin,198,8,5,6,9,22,19,3,21
Amkar,198,9,5,5,10,11,23,-12,20
Rostov,198,10,4,7,9,10,17,-7,19
Anzhi,198,11,2,5,13,14,41,-27,11
Loko Moscow,199,1,12,6,2,32,13,19,42
Zenit,199,2,8,9,3,24,15,9,33
CSKA Moscow,199,3,10,3,7,26,20,6,33
Krasnodar,199,4,9,4,7,31,27,4,31
Spart Moscow,199,5,8,6,6,34,31,3,30
Din Moscow,199,6,7,6,7,24,24,0,27
Terek Grozny,199,7,7,5,8,21,25,-4,26
Amkar,199,8,6,4,10,12,22,-10,22
FK Rubin,199,9,5,5,10,25,24,1,20
Rostov,199,10,4,7,9,11,18,-7,19
Anzhi,199,11,4,5,11,17,38,-21,17
Loko Moscow,200,1,11,7,2,32,14,18,40
CSKA Moscow,200,2,11,4,5,27,18,9,37
Spart Moscow,200,3,9,5,6,38,30,8,32
Krasnodar,200,4,9,5,6,30,26,4,32
Zenit,200,5,7,10,3,23,15,8,31
Terek Grozny,200,6,8,6,6,21,22,-1,30
Din Moscow,200,7,7,6,7,19,21,-2,27
FK Rubin,200,8,5,5,10,21,19,2,20
Amkar,200,9,5,5,10,12,23,-11,20
Rostov,200,10,4,6,10,11,21,-10,18
Anzhi,200,11,2,5,13,14,39,-25,11
Loko Moscow,201,1,12,5,3,36,13,23,41
CSKA Moscow,201,2,12,3,5,31,19,12,39
Spart Moscow,201,3,9,6,5,40,31,9,33
Krasnodar,201,4,9,5,6,29,25,4,32
Terek Grozny,201,5,9,5,6,23,23,0,32
Zenit,201,6,7,8,5,22,21,1,29
Din Moscow,201,7,6,7,7,23,25,-2,25
FK Rubin,201,8,5,7,8,22,18,4,22
Rostov,201,9,4,7,9,10,17,-7,19
Amkar,201,10,4,4,12,11,28,-17,16
Anzhi,201,11,2,5,13,15,42,-27,11
CSKA Moscow,202,1,12,3,5,28,17,11,39
Loko Moscow,202,2,11,5,4,30,14,16,38
Spart Moscow,202,3,9,6,5,39,30,9,33
Zenit,202,4,8,8,4,22,14,8,32
Krasnodar,202,5,9,5,6,29,25,4,32
Terek Grozny,202,6,8,6,6,23,24,-1,30
Din Moscow,202,7,6,6,8,21,26,-5,24
FK Rubin,202,8,5,6,9,22,19,3,21
Amkar,202,9,5,5,10,12,24,-12,20
Rostov,202,10,4,7,9,11,18,-7,19
Anzhi,202,11,2,5,13,15,41,-26,11
Loko Moscow,203,1,12,5,3,33,13,20,41
CSKA Moscow,203,2,11,4,5,27,17,10,37
Spart Moscow,203,3,9,7,4,37,27,10,34
Krasnodar,203,4,9,4,7,30,26,4,31
Zenit,203,5,7,9,4,21,17,4,30
Terek Grozny,203,6,7,5,8,20,25,-5,26
Din Moscow,203,7,6,7,7,22,25,-3,25
FK Rubin,203,8,6,5,9,25,21,4,23
Rostov,203,9,4,7,9,10,17,-7,19
Amkar,203,10,5,4,11,11,24,-13,19
Anzhi,203,11,3,5,12,15,39,-24,14
Loko Moscow,204,1,11,6,3,31,14,17,39
Spart Moscow,204,2,11,5,4,44,28,16,38
CSKA Moscow,204,3,11,4,5,28,19,9,37
Zenit,204,4,8,8,4,25,17,8,32
Krasnodar,204,5,8,5,7,27,25,2,29
FK Rubin,204,6,7,5,8,24,17,7,26
Terek Grozny,204,7,7,5,8,22,28,-6,26
Din Moscow,204,8,5,6,9,18,25,-7,21
Amkar,204,9,5,4,11,14,28,-14,19
Rostov,204,10,4,6,10,11,22,-11,18
Anzhi,204,11,3,6,11,17,38,-21,15
Loko Moscow,205,1,11,7,2,31,13,18,40
CSKA Moscow,205,2,11,4,5,27,17,10,37
Spart Moscow,205,3,10,6,4,38,27,11,36
Zenit,205,4,7,10,3,22,14,8,31
Krasnodar,205,5,8,6,6,29,26,3,30
Terek Grozny,205,6,7,6,7,21,24,-3,27
FK Rubin,205,7,5,7,8,22,18,4,22
Din Moscow,205,8,5,7,8,18,23,-5,22
Amkar,205,9,5,5,10,11,23,-12,20
Rostov,205,10,4,6,10,10,19,-9,18
Anzhi,205,11,2,6,12,15,40,-25,12
Loko Moscow,206,1,11,6,3,29,13,16,39
CSKA Moscow,206,2,11,4,5,30,19,11,37
Zenit,206,3,8,9,3,25,15,10,33
Spart Moscow,206,4,9,5,6,37,31,6,32
Krasnodar,206,5,9,5,6,28,24,4,32
Terek Grozny,206,6,8,5,7,22,24,-2,29
Din Moscow,206,7,6,6,8,20,24,-4,24
FK Rubin,206,8,6,5,9,24,20,4,23
Rostov,206,9,5,6,9,14,17,-3,21
Amkar,206,10,5,4,11,12,27,-15,19
Anzhi,206,11,2,5,13,14,41,-27,11
Spart Moscow,207,1,11,5,4,41,29,12,38
Loko Moscow,207,2,11,5,4,30,18,12,38
Zenit,207,3,9,8,3,27,14,13,35
CSKA Moscow,207,4,10,3,7,26,22,4,33
Krasnodar,207,5,9,4,7,32,27,5,31
Terek Grozny,207,6,8,5,7,22,24,-2,29
Din Moscow,207,7,6,6,8,19,23,-4,24
FK Rubin,207,8,6,5,9,23,18,5,23
Rostov,207,9,4,6,10,11,19,-8,18
Anzhi,207,10,4,5,11,17,37,-20,17
Amkar,207,11,4,4,12,11,28,-17,16
Loko Moscow,208,1,12,5,3,31,15,16,41
CSKA Moscow,208,2,11,4,5,28,19,9,37
Krasnodar,208,3,10,4,6,32,25,7,34
Spart Moscow,208,4,9,6,5,39,31,8,33
Zenit,208,5,7,9,4,23,16,7,30
Terek Grozny,208,6,7,5,8,22,28,-6,26
Din Moscow,208,7,6,6,8,20,25,-5,24
FK Rubin,208,8,6,5,9,24,18,6,23
Rostov,208,9,4,7,9,11,18,-7,19
Amkar,208,10,5,4,11,15,27,-12,19
Anzhi,208,11,3,5,12,16,39,-23,14
Loko Moscow,209,1,11,6,3,30,15,15,39
CSKA Moscow,209,2,11,3,6,26,20,6,36
Spart Moscow,209,3,10,5,5,39,29,10,35
Zenit,209,4,8,8,4,25,15,10,32
Krasnodar,209,5,8,5,7,27,25,2,29
Terek Grozny,209,6,7,6,7,21,24,-3,27
Din Moscow,209,7,6,6,8,20,24,-4,24
FK Rubin,209,8,6,5,9,23,19,4,23
Rostov,209,9,5,6,9,13,19,-6,21
Amkar,209,10,4,5,11,10,25,-15,17
Anzhi,209,11,4,5,11,18,37,-19,17
Loko Moscow,210,1,11,5,4,30,14,16,38
Spart Moscow,210,2,11,5,4,39,27,12,38
CSKA Moscow,210,3,11,3,6,27,20,7,36
Zenit,210,4,9,8,3,26,14,12,35
Krasnodar,210,5,10,4,6,29,24,5,34
Terek Grozny,210,6,8,5,7,23,25,-2,29
FK Rubin,210,7,6,5,9,23,18,5,23
Din Moscow,210,8,5,6,9,17,25,-8,21
Amkar,210,9,5,4,11,10,23,-13,19
Rostov,210,10,4,6,10,12,20,-8,18
Anzhi,210,11,2,5,13,16,42,-26,11
Loko Moscow,211,1,12,5,3,33,13,20,41
CSKA Moscow,211,2,10,5,5,25,17,8,35
Krasnodar,211,3,9,5,6,31,27,4,32
Terek Grozny,211,4,9,5,6,24,23,1,32
Zenit,211,5,7,9,4,21,16,5,30
Spart Moscow,211,6,8,5,7,34,29,5,29
FK Rubin,211,7,6,6,8,24,19,5,24
Din Moscow,211,8,6,6,8,18,22,-4,24
Rostov,211,9,5,6,9,11,17,-6,21
Amkar,211,10,5,4,11,12,25,-13,19
Anzhi,211,11,2,6,12,14,39,-25,12
Loko Moscow,212,1,11,6,3,33,17,16,39
CSKA Moscow,212,2,11,4,5,27,18,9,37
Zenit,212,3,8,8,4,25,16,9,32
Spart Moscow,212,4,9,5,6,35,29,6,32
Krasnodar,212,5,8,6,6,30,27,3,30
Terek Grozny,212,6,7,7,6,22,24,-2,28
Din Moscow,212,7,7,6,7,22,21,1,27
FK Rubin,212,8,5,6,9,21,20,1,21
Amkar,212,9,5,5,10,12,24,-12,20
Rostov,212,10,4,6,10,10,18,-8,18
Anzhi,212,11,2,7,11,15,38,-23,13
Loko Moscow,213,1,11,6,3,31,14,17,39
Spart Moscow,213,2,10,5,5,37,26,11,35
CSKA Moscow,213,3,10,4,6,26,20,6,34
Zenit,213,4,7,10,3,23,15,8,31
Krasnodar,213,5,9,4,7,30,27,3,31
Terek Grozny,213,6,8,5,7,23,24,-1,29
FK Rubin,213,7,7,5,8,25,19,6,26
Din Moscow,213,8,5,6,9,18,24,-6,21
Amkar,213,9,5,4,11,10,25,-15,19
Rostov,213,10,4,6,10,10,20,-10,18
Anzhi,213,11,4,5,11,18,37,-19,17
Loko Moscow,214,1,12,5,3,32,12,20,41
CSKA Moscow,214,2,11,3,6,28,20,8,36
Zenit,214,3,8,8,4,22,14,8,32
Krasnodar,214,4,9,4,7,28,27,1,31
Spart Moscow,214,5,8,5,7,35,30,5,29
Terek Grozny,214,6,7,5,8,20,24,-4,26
Din Moscow,214,7,6,7,7,20,23,-3,25
Amkar,214,8,6,4,10,12,23,-11,22
FK Rubin,214,9,5,6,9,22,19,3,21
Rostov,214,10,5,6,9,11,17,-6,21
Anzhi,214,11,4,5,11,18,39,-21,17
Loko Moscow,215,1,12,6,2,31,12,19,42
CSKA Moscow,215,2,11,4,5,31,19,12,37
Spart Moscow,215,3,9,5,6,38,30,8,32
Krasnodar,215,4,9,5,6,30,25,5,32
Zenit,215,5,7,9,4,22,15,7,30
Terek Grozny,215,6,8,6,6,24,25,-1,30
FK Rubin,215,7,6,5,9,23,20,3,23
Rostov,215,8,5,6,9,13,19,-6,21
Din Moscow,215,9,5,6,9,18,25,-7,21
Amkar,215,10,5,5,10,13,25,-12,20
Anzhi,215,11,2,5,13,16,44,-28,11
Loko Moscow,216,1,11,6,3,30,13,17,39
CSKA Moscow,216,2,11,3,6,27,19,8,36
Zenit,216,3,9,8,3,25,14,11,35
Spart Moscow,216,4,9,6,5,37,29,8,33
Krasnodar,216,5,9,5,6,30,26,4,32
Terek Grozny,216,6,9,5,6,22,22,0,32
Din Moscow,216,7,6,7,7,23,23,0,25
FK Rubin,216,8,5,5,10,23,24,-1,20
Amkar,216,9,5,4,11,10,23,-13,19
Rostov,216,10,4,6,10,11,19,-8,18
Anzhi,216,11,2,5,13,14,40,-26,11
Loko Moscow,217,1,11,6,3,31,14,17,39
Spart Moscow,217,2,10,6,4,38,26,12,36
CSKA Moscow,217,3,10,5,5,27,19,8,35
Terek Grozny,217,4,9,5,6,24,23,1,32
Zenit,217,5,7,10,3,23,15,8,31
Krasnodar,217,6,9,4,7,29,27,2,31
Din Moscow,217,7,6,6,8,21,24,-3,24
FK Rubin,217,8,6,5,9,24,20,4,23
Rostov,217,9,4,6,10,10,20,-10,18
Amkar,217,10,4,5,11,9,23,-14,17
Anzhi,217,11,2,6,12,16,41,-25,12
Loko Moscow,218,1,11,6,3,30,13,17,39
CSKA Moscow,218,2,11,3,6,27,19,8,36
Zenit,218,3,9,8,3,24,13,11,35
Krasnodar,218,4,9,5,6,30,26,4,32
Terek Grozny,218,5,9,5,6,23,23,0,32
Spart Moscow,218,6,8,6,6,35,29,6,30
Din Moscow,218,7,7,6,7,21,21,0,27
Rostov,218,8,5,6,9,11,17,-6,21
FK Rubin,218,9,5,5,10,22,22,0,20
Amkar,218,10,4,5,11,12,26,-14,17
Anzhi,218,11,2,5,13,14,40,-26,11
Loko Moscow,219,1,11,6,3,32,15,17,39
CSKA Moscow,219,2,11,4,5,29,18,11,37
Spart Moscow,219,3,8,8,4,36,28,8,32
Zenit,219,4,7,10,3,24,16,8,31
Krasnodar,219,5,9,4,7,30,27,3,31
Terek Grozny,219,6,7,6,7,21,24,-3,27
FK Rubin,219,7,6,6,8,25,20,5,24
Din Moscow,219,8,5,8,7,20,24,-4,23
Amkar,219,9,5,5,10,11,23,-12,20
Rostov,219,10,4,7,9,11,18,-7,19
Anzhi,219,11,2,6,12,15,41,-26,12
Loko Moscow,220,1,11,6,3,30,14,16,39
Spart Moscow,220,2,11,5,4,38,26,12,38
CSKA Moscow,220,3,11,3,6,29,21,8,36
Zenit,220,4,8,9,3,26,15,11,33
Krasnodar,220,5,9,4,7,29,25,4,31
Terek Grozny,220,6,8,5,7,22,23,-1,29
FK Rubin,220,7,7,5,8,24,17,7,26
Din Moscow,220,8,5,6,9,18,26,-8,21
Rostov,220,9,4,6,10,10,18,-8,18
Amkar,220,10,4,4,12,9,25,-16,16
Anzhi,220,11,3,5,12,15,40,-25,14
Loko Moscow,221,1,11,7,2,32,14,18,40
Spart Moscow,221,2,10,6,4,38,26,12,36
CSKA Moscow,221,3,11,3,6,28,19,9,36
Zenit,221,4,8,9,3,23,14,9,33
Krasnodar,221,5,8,5,7,30,28,2,29
FK Rubin,221,6,7,5,8,26,19,7,26
Terek Grozny,221,7,7,5,8,20,25,-5,26
Din Moscow,221,8,5,6,9,18,25,-7,21
Amkar,221,9,5,5,10,11,23,-12,20
Rostov,221,10,4,6,10,10,20,-10,18
Anzhi,221,11,3,5,12,17,40,-23,14
Loko Moscow,222,1,12,5,3,31,14,17,41
CSKA Moscow,222,2,11,3,6,28,18,10,36
Zenit,222,3,9,8,3,24,13,11,35
Spart Moscow,222,4,8,6,6,36,34,2,30
Terek Grozny,222,5,8,5,7,23,24,-1,29
Krasnodar,222,6,8,4,8,28,27,1,28
Din Moscow,222,7,7,6,7,25,24,1,27
FK Rubin,222,8,6,5,9,24,20,4,23
Rostov,222,9,5,6,9,12,17,-5,21
Amkar,222,10,4,5,11,12,27,-15,17
Anzhi,222,11,3,5,12,15,40,-25,14
Loko Moscow,223,1,13,5,2,33,11,22,44
CSKA Moscow,223,2,11,3,6,27,19,8,36
Spart Moscow,223,3,10,5,5,38,29,9,35
Zenit,223,4,8,8,4,23,17,6,32
Krasnodar,223,5,8,4,8,27,26,1,28
Terek Grozny,223,6,7,7,6,23,25,-2,28
FK Rubin,223,7,7,5,8,24,18,6,26
Din Moscow,223,8,5,6,9,18,24,-6,21
Amkar,223,9,5,5,10,14,26,-12,20
Rostov,223,10,4,6,10,11,19,-8,18
Anzhi,223,11,2,6,12,15,39,-24,12
Loko Moscow,224,1,11,6,3,31,14,17,39
CSKA Moscow,224,2,11,3,6,30,20,10,36
Zenit,224,3,9,8,3,26,15,11,35
Spart Moscow,224,4,10,5,5,37,27,10,35
Krasnodar,224,5,8,6,6,29,26,3,30
Terek Grozny,224,6,7,7,6,22,24,-2,28
Din Moscow,224,7,6,6,8,18,22,-4,24
FK Rubin,224,8,5,6,9,22,19,3,21
Rostov,224,9,5,6,9,12,18,-6,21
Amkar,224,10,4,5,11,10,25,-15,17
Anzhi,224,11,2,6,12,15,42,-27,12
Loko Moscow,225,1,11,5,4,30,14,16,38
CSKA Moscow,225,2,11,3,6,27,19,8,36
Spart Moscow,225,3,10,5,5,39,29,10,35
Zenit,225,4,9,8,3,24,14,10,35
Krasnodar,225,5,9,4,7,31,28,3,31
Terek Grozny,225,6,7,6,7,20,24,-4,27
Din Moscow,225,7,6,6,8,19,23,-4,24
FK Rubin,225,8,6,5,9,25,21,4,23
Amkar,225,9,6,4,10,13,22,-9,22
Rostov,225,10,4,6,10,11,21,-10,18
Anzhi,225,11,2,6,12,15,39,-24,12
Loko Moscow,226,1,12,6,2,34,13,21,42
Spart Moscow,226,2,10,6,4,41,27,14,36
CSKA Moscow,226,3,11,3,6,26,18,8,36
Zenit,226,4,8,9,3,23,14,9,33
Terek Grozny,226,5,8,5,7,27,25,2,29
Krasnodar,226,6,8,4,8,29,30,-1,28
Din Moscow,226,7,6,6,8,21,27,-6,24
FK Rubin,226,8,6,5,9,25,21,4,23
Amkar,226,9,5,5,10,12,24,-12,20
Rostov,226,10,4,6,10,10,20,-10,18
Anzhi,226,11,2,5,13,15,44,-29,11
Loko Moscow,227,1,12,6,2,30,11,19,42
Spart Moscow,227,2,10,5,5,37,27,10,35
CSKA Moscow,227,3,10,4,6,27,20,7,34
Zenit,227,4,8,8,4,22,14,8,32
Krasnodar,227,5,9,5,6,28,24,4,32
Terek Grozny,227,6,8,5,7,21,24,-3,29
Din Moscow,227,7,6,7,7,18,21,-3,25
FK Rubin,227,8,5,6,9,21,18,3,21
Rostov,227,9,4,6,10,11,20,-9,18
Amkar,227,10,4,4,12,9,24,-15,16
Anzhi,227,11,3,6,11,18,39,-21,15
Loko Moscow,228,1,11,6,3,31,15,16,39
Spart Moscow,228,2,11,5,4,38,26,12,38
CSKA Moscow,228,3,11,4,5,29,19,10,37
Krasnodar,228,4,9,5,6,31,26,5,32
Zenit,228,5,7,10,3,23,15,8,31
Terek Grozny,228,6,8,5,7,21,23,-2,29
FK Rubin,228,7,6,6,8,23,18,5,24
Din Moscow,228,8,5,6,9,17,23,-6,21
Rostov,228,9,4,6,10,10,19,-9,18
Amkar,228,10,4,4,12,10,25,-15,16
Anzhi,228,11,3,5,12,16,40,-24,14
Loko Moscow,229,1,11,7,2,30,12,18,40
CSKA Moscow,229,2,11,3,6,27,19,8,36
Zenit,229,3,8,9,3,23,14,9,33
Spart Moscow,229,4,8,7,5,36,29,7,31
Krasnodar,229,5,8,5,7,28,26,2,29
Terek Grozny,229,6,7,6,7,21,24,-3,27
Din Moscow,229,7,6,7,7,21,23,-2,25
FK Rubin,229,8,6,5,9,22,19,3,23
Amkar,229,9,5,5,10,12,24,-12,20
Rostov,229,10,4,7,9,10,17,-7,19
Anzhi,229,11,3,5,12,15,38,-23,14
Loko Moscow,230,1,12,5,3,30,12,18,41
CSKA Moscow,230,2,11,4,5,26,17,9,37
Spart Moscow,230,3,9,6,5,36,28,8,33
Krasnodar,230,4,9,4,7,29,27,2,31
Zenit,230,5,7,9,4,21,14,7,30
Terek Grozny,230,6,8,5,7,24,27,-3,29
Din Moscow,230,7,6,7,7,19,22,-3,25
FK Rubin,230,8,6,6,8,25,19,6,24
Amkar,230,9,5,5,10,14,24,-10,20
Rostov,230,10,4,6,10,10,18,-8,18
Anzhi,230,11,2,5,13,16,42,-26,11
Loko Moscow,231,1,12,6,2,31,12,19,42
Spart Moscow,231,2,11,5,4,39,26,13,38
CSKA Moscow,231,3,10,4,6,26,19,7,34
Krasnodar,231,4,9,5,6,28,24,4,32
Zenit,231,5,7,9,4,23,16,7,30
Terek Grozny,231,6,8,6,6,23,24,-1,30
Din Moscow,231,7,6,6,8,19,24,-5,24
FK Rubin,231,8,5,5,10,22,20,2,20
Rostov,231,9,4,6,10,10,19,-9,18
Amkar,231,10,4,4,12,11,26,-15,16
Anzhi,231,11,3,6,11,16,38,-22,15
Loko Moscow,232,1,12,6,2,33,14,19,42
CSKA Moscow,232,2,11,3,6,28,21,7,36
Spart Moscow,232,3,9,6,5,37,30,7,33
Zenit,232,4,8,8,4,26,17,9,32
Krasnodar,232,5,8,5,7,29,27,2,29
Terek Grozny,232,6,8,5,7,22,24,-2,29
Din Moscow,232,7,7,6,7,22,22,0,27
FK Rubin,232,8,6,5,9,22,18,4,23
Rostov,232,9,4,7,9,11,18,-7,19
Amkar,232,10,5,4,11,11,25,-14,19
Anzhi,232,11,2,5,13,14,39,-25,11
Loko Moscow,233,1,12,5,3,33,15,18,41
CSKA Moscow,233,2,11,4,5,28,19,9,37
Spart Moscow,233,3,10,6,4,36,26,10,36
Zenit,233,4,8,9,3,25,16,9,33
Krasnodar,233,5,8,5,7,30,28,2,29
Terek Grozny,233,6,7,6,7,22,26,-4,27
Din Moscow,233,7,6,7,7,19,22,-3,25
FK Rubin,233,8,5,6,9,23,20,3,21
Amkar,233,9,5,4,11,11,23,-12,19
Rostov,233,10,4,6,10,10,18,-8,18
Anzhi,233,11,2,6,12,17,41,-24,12
Loko Moscow,234,1,12,6,2,31,12,19,42
CSKA Moscow,234,2,11,4,5,27,18,9,37
Spart Moscow,234,3,10,5,5,42,30,12,35
Terek Grozny,234,4,9,5,6,23,23,0,32
Zenit,234,5,7,9,4,21,14,7,30
Krasnodar,234,6,8,4,8,30,30,0,28
Din Moscow,234,7,6,6,8,21,25,-4,24
FK Rubin,234,8,6,5,9,26,21,5,23
Amkar,234,9,5,4,11,11,24,-13,19
Rostov,234,10,4,6,10,12,23,-11,18
Anzhi,234,11,2,6,12,15,39,-24,12
Loko Moscow,235,1,13,5,2,32,11,21,44
CSKA Moscow,235,2,12,3,5,28,18,10,39
Spart Moscow,235,3,10,5,5,36,26,10,35
Terek Grozny,235,4,9,5,6,22,22,0,32
Krasnodar,235,5,9,4,7,30,26,4,31
Zenit,235,6,7,8,5,22,17,5,29
Din Moscow,235,7,5,7,8,18,24,-6,22
FK Rubin,235,8,5,6,9,23,21,2,21
Amkar,235,9,5,4,11,10,23,-13,19
Rostov,235,10,4,6,10,10,18,-8,18
Anzhi,235,11,2,5,13,14,39,-25,11
Loko Moscow,236,1,11,6,3,29,13,16,39
CSKA Moscow,236,2,11,3,6,27,19,8,36
Zenit,236,3,8,9,3,23,13,10,33
Spart Moscow,236,4,9,6,5,36,29,7,33
Terek Grozny,236,5,9,5,6,24,23,1,32
Krasnodar,236,6,9,4,7,30,26,4,31
Din Moscow,236,7,6,6,8,18,22,-4,24
FK Rubin,236,8,6,5,9,23,19,4,23
Rostov,236,9,5,6,9,12,17,-5,21
Amkar,236,10,4,5,11,12,26,-14,17
Anzhi,236,11,2,5,13,14,41,-27,11
Loko Moscow,237,1,11,7,2,31,13,18,40
CSKA Moscow,237,2,11,4,5,28,19,9,37
Spart Moscow,237,3,8,8,4,37,29,8,32
Krasnodar,237,4,9,5,6,29,25,4,32
Zenit,237,5,7,10,3,23,15,8,31
Terek Grozny,237,6,8,5,7,24,26,-2,29
FK Rubin,237,7,6,5,9,23,19,4,23
Din Moscow,237,8,5,7,8,21,26,-5,22
Amkar,237,9,5,5,10,11,23,-12,20
Rostov,237,10,4,7,9,11,18,-7,19
Anzhi,237,11,2,5,13,17,42,-25,11
Loko Moscow,238,1,13,5,2,34,11,23,44
CSKA Moscow,238,2,11,4,5,28,19,9,37
Spart Moscow,238,3,9,6,5,38,29,9,33
Krasnodar,238,4,9,4,7,29,27,2,31
Zenit,238,5,7,8,5,21,17,4,29
Terek Grozny,238,6,7,7,6,23,25,-2,28
Din Moscow,238,7,6,6,8,22,28,-6,24
FK Rubin,238,8,6,5,9,28,21,7,23
Rostov,238,9,4,6,10,11,21,-10,18
Amkar,238,10,4,6,10,12,25,-13,18
Anzhi,238,11,2,7,11,16,39,-23,13
Loko Moscow,239,1,11,6,3,31,14,17,39
CSKA Moscow,239,2,12,3,5,29,17,12,39
Zenit,239,3,8,8,4,23,15,8,32
Terek Grozny,239,4,9,5,6,23,23,0,32
Spart Moscow,239,5,8,6,6,37,34,3,30
Krasnodar,239,6,8,6,6,28,25,3,30
Din Moscow,239,7,6,7,7,21,23,-2,25
FK Rubin,239,8,5,6,9,21,19,2,21
Rostov,239,9,5,6,9,14,18,-4,21
Amkar,239,10,5,4,11,12,24,-12,19
Anzhi,239,11,2,5,13,15,42,-27,11
Loko Moscow,240,1,13,5,2,32,11,21,44
Spart Moscow,240,2,11,5,4,40,27,13,38
CSKA Moscow,240,3,11,3,6,28,18,10,36
Zenit,240,4,8,8,4,22,14,8,32
Krasnodar,240,5,9,4,7,28,26,2,31
Terek Grozny,240,6,7,7,6,22,24,-2,28
Din Moscow,240,7,5,7,8,18,24,-6,22
FK Rubin,240,8,5,6,9,22,19,3,21
Rostov,240,9,4,6,10,11,19,-8,18
Amkar,240,10,4,5,11,11,26,-15,17
Anzhi,240,11,2,6,12,15,41,-26,12
Loko Moscow,241,1,12,6,2,31,11,20,42
CSKA Moscow,241,2,11,4,5,30,19,11,37
Spart Moscow,241,3,9,6,5,37,30,7,33
Terek Grozny,241,4,8,6,6,21,22,-1,30
Zenit,241,5,7,8,5,21,18,3,29
Krasnodar,241,6,8,5,7,27,27,0,29
Din Moscow,241,7,6,7,7,21,23,-2,25
FK Rubin,241,8,6,6,8,26,19,7,24
Rostov,241,9,4,6,10,11,19,-8,18
Amkar,241,10,4,5,11,11,25,-14,17
Anzhi,241,11,2,7,11,16,39,-23,13
Loko Moscow,242,1,12,5,3,30,12,18,41
Spart Moscow,242,2,11,5,4,39,27,12,38
CSKA Moscow,242,3,11,4,5,29,18,11,37
Krasnodar,242,4,10,4,6,33,25,8,34
Zenit,242,5,7,8,5,21,17,4,29
Terek Grozny,242,6,7,6,7,20,24,-4,27
Din Moscow,242,7,6,6,8,20,24,-4,24
FK Rubin,242,8,5,5,10,22,24,-2,20
Amkar,242,9,5,4,11,12,24,-12,19
Rostov,242,10,4,6,10,10,18,-8,18
Anzhi,242,11,2,7,11,15,38,-23,13
Loko Moscow,243,1,12,6,2,32,13,19,42
CSKA Moscow,243,2,11,4,5,27,18,9,37
Spart Moscow,243,3,9,6,5,35,28,7,33
Zenit,243,4,7,9,4,22,15,7,30
Terek Grozny,243,5,8,6,6,23,24,-1,30
Krasnodar,243,6,8,5,7,28,29,-1,29
FK Rubin,243,7,7,5,8,27,18,9,26
Din Moscow,243,8,6,6,8,20,23,-3,24
Rostov,243,9,4,6,10,11,19,-8,18
Amkar,243,10,4,5,11,10,24,-14,17
Anzhi,243,11,2,6,12,16,40,-24,12
Loko Moscow,244,1,11,6,3,31,14,17,39
Spart Moscow,244,2,9,7,4,36,27,9,34
CSKA Moscow,244,3,10,4,6,26,20,6,34
Krasnodar,244,4,10,4,6,31,26,5,34
Zenit,244,5,8,9,3,24,14,10,33
Terek Grozny,244,6,7,6,7,20,23,-3,27
FK Rubin,244,7,6,5,9,23,19,4,23
Din Moscow,244,8,5,7,8,17,22,-5,22
Amkar,244,9,5,5,10,10,22,-12,20
Rostov,244,10,4,6,10,12,20,-8,18
Anzhi,244,11,2,7,11,15,38,-23,13
Loko Moscow,245,1,11,7,2,31,13,18,40
CSKA Moscow,245,2,11,4,5,31,19,12,37
Spart Moscow,245,3,10,6,4,38,25,13,36
Zenit,245,4,7,9,4,22,18,4,30
Krasnodar,245,5,8,5,7,29,27,2,29
Terek Grozny,245,6,7,6,7,22,26,-4,27
Din Moscow,245,7,6,7,7,22,23,-1,25
FK Rubin,245,8,6,5,9,24,22,2,23
Amkar,245,9,5,4,11,11,23,-12,19
Rostov,245,10,4,6,10,10,21,-11,18
Anzhi,245,11,2,7,11,17,40,-23,13
Loko Moscow,246,1,12,5,3,32,13,19,41
CSKA Moscow,246,2,10,4,6,26,19,7,34
Spart Moscow,246,3,9,6,5,39,28,11,33
Zenit,246,4,8,8,4,23,16,7,32
Krasnodar,246,5,9,4,7,28,26,2,31
Terek Grozny,246,6,8,6,6,24,25,-1,30
FK Rubin,246,7,7,5,8,26,19,7,26
Din Moscow,246,8,6,6,8,20,24,-4,24
Rostov,246,9,4,6,10,12,23,-11,18
Amkar,246,10,4,5,11,9,23,-14,17
Anzhi,246,11,2,7,11,18,41,-23,13
Loko Moscow,247,1,12,6,2,31,11,20,42
CSKA Moscow,247,2,10,5,5,28,20,8,35
Spart Moscow,247,3,9,7,4,36,27,9,34
Zenit,247,4,7,10,3,22,14,8,31
Krasnodar,247,5,8,5,7,28,27,1,29
Terek Grozny,247,6,7,5,8,20,26,-6,26
Din Moscow,247,7,6,6,8,19,23,-4,24
FK Rubin,247,8,5,6,9,22,19,3,21
Amkar,247,9,5,5,10,10,22,-12,20
Rostov,247,10,4,7,9,11,18,-7,19
Anzhi,247,11,3,6,11,19,39,-20,15
Loko Moscow,248,1,12,6,2,32,13,19,42
CSKA Moscow,248,2,12,3,5,29,17,12,39
Spart Moscow,248,3,10,5,5,36,27,9,35
Zenit,248,4,7,8,5,22,17,5,29
Krasnodar,248,5,8,5,7,29,29,0,29
Terek Grozny,248,6,7,5,8,20,25,-5,26
FK Rubin,248,7,6,6,8,25,18,7,24
Din Moscow,248,8,5,7,8,17,22,-5,22
Rostov,248,9,5,6,9,12,18,-6,21
Amkar,248,10,5,4,11,11,23,-12,19
Anzhi,248,11,3,5,12,15,39,-24,14
Loko Moscow,249,1,12,5,3,30,13,17,41
Spart Moscow,249,2,10,6,4,38,26,12,36
CSKA Moscow,249,3,10,4,6,27,20,7,34
Krasnodar,249,4,10,4,6,30,24,6,34
Zenit,249,5,8,8,4,24,16,8,32
Terek Grozny,249,6,9,5,6,22,22,0,32
Din Moscow,249,7,5,7,8,18,23,-5,22
FK Rubin,249,8,5,6,9,21,18,3,21
Rostov,249,9,4,7,9,10,17,-7,19
Amkar,249,10,4,4,12,9,26,-17,16
Anzhi,249,11,2,6,12,14,38,-24,12
Loko Moscow,250,1,12,5,3,32,13,19,41
CSKA Moscow,250,2,12,3,5,28,17,11,39
Spart Moscow,250,3,9,7,4,37,27,10,34
Krasnodar,250,4,10,4,6,31,25,6,34
Terek Grozny,250,5,9,5,6,25,23,2,32
Zenit,250,6,7,8,5,21,16,5,29
Din Moscow,250,7,6,7,7,20,23,-3,25
FK Rubin,250,8,5,5,10,22,21,1,20
Rostov,250,9,4,7,9,11,18,-7,19
Amkar,250,10,4,4,12,9,27,-18,16
Anzhi,250,11,2,5,13,15,41,-26,11
Loko Moscow,251,1,11,5,4,29,15,14,38
CSKA Moscow,251,2,11,3,6,30,21,9,36
Zenit,251,3,9,8,3,25,15,10,35
Spart Moscow,251,4,10,5,5,37,28,9,35
Terek Grozny,251,5,9,5,6,22,22,0,32
Krasnodar,251,6,9,4,7,30,25,5,31
FK Rubin,251,7,7,5,8,24,18,6,26
Din Moscow,251,8,6,6,8,21,25,-4,24
Rostov,251,9,4,6,10,10,18,-8,18
Amkar,251,10,4,4,12,9,24,-15,16
Anzhi,251,11,2,5,13,15,41,-26,11
Loko Moscow,252,1,12,5,3,31,13,18,41
CSKA Moscow,252,2,11,4,5,26,17,9,37
Spart Moscow,252,3,10,6,4,35,25,10,36
Krasnodar,252,4,10,4,6,34,29,5,34
Zenit,252,5,7,9,4,21,14,7,30
Terek Grozny,252,6,8,6,6,23,23,0,30
Din Moscow,252,7,6,7,7,21,22,-1,25
FK Rubin,252,8,5,5,10,26,26,0,20
Rostov,252,9,4,6,10,10,18,-8,18
Amkar,252,10,4,4,12,10,26,-16,16
Anzhi,252,11,2,6,12,14,38,-24,12
Loko Moscow,253,1,11,7,2,30,12,18,40
CSKA Moscow,253,2,12,3,5,33,18,15,39
Spart Moscow,253,3,9,6,5,36,28,8,33
Krasnodar,253,4,9,5,6,32,25,7,32
Zenit,253,5,7,9,4,22,16,6,30
Terek Grozny,253,6,8,5,7,22,24,-2,29
FK Rubin,253,7,6,5,9,23,22,1,23
Din Moscow,253,8,5,6,9,19,25,-6,21
Rostov,253,9,4,7,9,11,18,-7,19
Amkar,253,10,5,4,11,10,24,-14,19
Anzhi,253,11,3,5,12,16,42,-26,14
Loko Moscow,254,1,13,5,2,34,13,21,44
CSKA Moscow,254,2,10,5,5,27,19,8,35
Spart Moscow,254,3,9,6,5,38,30,8,33
Terek Grozny,254,4,9,5,6,24,22,2,32
Zenit,254,5,7,9,4,23,16,7,30
Krasnodar,254,6,8,5,7,29,28,1,29
Din Moscow,254,7,6,6,8,20,23,-3,24
FK Rubin,254,8,5,6,9,22,20,2,21
Rostov,254,9,5,6,9,13,19,-6,21
Amkar,254,10,4,5,11,10,25,-15,17
Anzhi,254,11,2,6,12,15,40,-25,12
Loko Moscow,255,1,11,7,2,30,12,18,40
CSKA Moscow,255,2,11,3,6,27,18,9,36
Spart Moscow,255,3,10,5,5,41,29,12,35
Zenit,255,4,8,9,3,22,13,9,33
Krasnodar,255,5,8,6,6,30,27,3,30
Terek Grozny,255,6,8,6,6,23,24,-1,30
Din Moscow,255,7,6,6,8,19,26,-7,24
FK Rubin,255,8,5,6,9,23,21,2,21
Amkar,255,9,5,4,11,12,23,-11,19
Rostov,255,10,4,6,10,11,20,-9,18
Anzhi,255,11,2,6,12,16,41,-25,12
Loko Moscow,256,1,12,5,3,34,15,19,41
CSKA Moscow,256,2,12,3,5,28,18,10,39
Spart Moscow,256,3,9,5,6,36,29,7,32
Krasnodar,256,4,9,5,6,30,26,4,32
Zenit,256,5,7,8,5,24,19,5,29
Terek Grozny,256,6,8,5,7,25,28,-3,29
Din Moscow,256,7,6,7,7,19,22,-3,25
FK Rubin,256,8,5,7,8,22,18,4,22
Amkar,256,9,6,4,10,16,24,-8,22
Rostov,256,10,4,6,10,10,18,-8,18
Anzhi,256,11,2,5,13,15,42,-27,11
CSKA Moscow,257,1,12,3,5,31,17,14,39
Loko Moscow,257,2,11,6,3,31,21,10,39
Spart Moscow,257,3,10,5,5,39,27,12,35
Krasnodar,257,4,10,4,6,37,24,13,34
Zenit,257,5,7,9,4,23,19,4,30
Terek Grozny,257,6,7,6,7,21,24,-3,27
FK Rubin,257,7,6,5,9,24,20,4,23
Din Moscow,257,8,5,6,9,19,28,-9,21
Amkar,257,9,5,5,10,10,22,-12,20
Rostov,257,10,4,6,10,10,19,-9,18
Anzhi,257,11,3,5,12,16,40,-24,14
Loko Moscow,258,1,11,6,3,30,14,16,39
CSKA Moscow,258,2,12,3,5,32,19,13,39
Spart Moscow,258,3,10,5,5,37,27,10,35
Zenit,258,4,8,8,4,25,16,9,32
Krasnodar,258,5,9,5,6,31,26,5,32
Terek Grozny,258,6,8,5,7,21,23,-2,29
Din Moscow,258,7,5,7,8,18,23,-5,22
FK Rubin,258,8,5,6,9,23,21,2,21
Rostov,258,9,5,6,9,12,18,-6,21
Amkar,258,10,5,4,11,10,24,-14,19
Anzhi,258,11,2,5,13,14,42,-28,11
Loko Moscow,259,1,12,5,3,32,14,18,41
CSKA Moscow,259,2,12,3,5,30,18,12,39
Zenit,259,3,8,8,4,24,15,9,32
Spart Moscow,259,4,9,5,6,37,30,7,32
Krasnodar,259,5,8,5,7,28,27,1,29
Din Moscow,259,6,7,6,7,21,23,-2,27
Terek Grozny,259,7,7,6,7,20,23,-3,27
Amkar,259,8,6,4,10,12,23,-11,22
FK Rubin,259,9,5,6,9,24,21,3,21
Rostov,259,10,4,6,10,12,20,-8,18
Anzhi,259,11,2,6,12,15,41,-26,12
Loko Moscow,260,1,12,5,3,32,12,20,41
CSKA Moscow,260,2,11,3,6,29,18,11,36
Spart Moscow,260,3,10,5,5,38,28,10,35
Zenit,260,4,8,8,4,22,16,6,32
Krasnodar,260,5,9,4,7,29,26,3,31
Terek Grozny,260,6,8,6,6,22,22,0,30
Din Moscow,260,7,6,6,8,18,22,-4,24
FK Rubin,260,8,6,5,9,23,19,4,23
Rostov,260,9,5,6,9,13,19,-6,21
Amkar,260,10,4,5,11,9,24,-15,17
Anzhi,260,11,2,5,13,14,43,-29,11
Loko Moscow,261,1,11,6,3,31,15,16,39
CSKA Moscow,261,2,11,4,5,26,17,9,37
Spart Moscow,261,3,10,5,5,39,28,11,35
Zenit,261,4,8,8,4,24,15,9,32
Terek Grozny,261,5,8,6,6,24,24,0,30
Krasnodar,261,6,8,5,7,28,27,1,29
FK Rubin,261,7,6,6,8,23,17,6,24
Din Moscow,261,8,5,7,8,18,24,-6,22
Amkar,261,9,5,5,10,11,23,-12,20
Rostov,261,10,4,6,10,11,20,-9,18
Anzhi,261,11,2,6,12,15,40,-25,12
Loko Moscow,262,1,11,5,4,29,15,14,38
Spart Moscow,262,2,10,5,5,39,30,9,35
CSKA Moscow,262,3,10,5,5,26,18,8,35
Zenit,262,4,8,9,3,24,14,10,33
Krasnodar,262,5,9,4,7,30,26,4,31
Terek Grozny,262,6,7,6,7,23,27,-4,27
FK Rubin,262,7,6,6,8,24,19,5,24
Din Moscow,262,8,5,7,8,20,25,-5,22
Amkar,262,9,5,5,10,14,26,-12,20
Rostov,262,10,4,6,10,11,19,-8,18
Anzhi,262,11,3,6,11,16,37,-21,15
Loko Moscow,263,1,12,6,2,33,12,21,42
CSKA Moscow,263,2,10,4,6,26,19,7,34
Spart Moscow,263,3,9,5,6,37,31,6,32
Zenit,263,4,7,10,3,22,14,8,31
Terek Grozny,263,5,8,5,7,22,26,-4,29
Krasnodar,263,6,8,4,8,27,29,-2,28
Din Moscow,263,7,6,7,7,22,25,-3,25
FK Rubin,263,8,6,6,8,24,18,6,24
Rostov,263,9,5,6,9,12,17,-5,21
Amkar,263,10,5,4,11,12,23,-11,19
Anzhi,263,11,3,5,12,17,40,-23,14
Loko Moscow,264,1,11,6,3,32,15,17,39
Spart Moscow,264,2,11,5,4,44,28,16,38
Krasnodar,264,3,10,4,6,32,26,6,34
CSKA Moscow,264,4,10,4,6,27,21,6,34
Zenit,264,5,7,10,3,23,15,8,31
Terek Grozny,264,6,7,6,7,21,24,-3,27
FK Rubin,264,7,6,5,9,22,19,3,23
Din Moscow,264,8,5,6,9,18,28,-10,21
Rostov,264,9,4,6,10,11,19,-8,18
Amkar,264,10,4,5,11,10,25,-15,17
Anzhi,264,11,4,5,11,19,39,-20,17
Loko Moscow,265,1,12,6,2,32,13,19,42
CSKA Moscow,265,2,12,3,5,31,18,13,39
Spart Moscow,265,3,11,5,4,43,27,16,38
Zenit,265,4,7,8,5,21,17,4,29
Krasnodar,265,5,8,5,7,29,27,2,29
Terek Grozny,265,6,7,5,8,20,28,-8,26
Din Moscow,265,7,6,6,8,19,25,-6,24
FK Rubin,265,8,6,5,9,23,19,4,23
Amkar,265,9,5,4,11,12,24,-12,19
Rostov,265,10,4,6,10,11,22,-11,18
Anzhi,265,11,3,5,12,19,40,-21,14
Loko Moscow,266,1,12,5,3,30,12,18,41
CSKA Moscow,266,2,11,3,6,27,18,9,36
Zenit,266,3,8,8,4,22,14,8,32
Krasnodar,266,4,9,4,7,28,25,3,31
Spart Moscow,266,5,8,6,6,37,32,5,30
Terek Grozny,266,6,8,6,6,23,22,1,30
Din Moscow,266,7,6,7,7,19,22,-3,25
FK Rubin,266,8,6,5,9,22,18,4,23
Rostov,266,9,5,6,9,14,20,-6,21
Amkar,266,10,5,5,10,11,22,-11,20
Anzhi,266,11,2,5,13,14,42,-28,11
Loko Moscow,267,1,12,5,3,30,12,18,41
Spart Moscow,267,2,10,5,5,39,29,10,35
Krasnodar,267,3,10,4,6,32,24,8,34
CSKA Moscow,267,4,10,4,6,27,21,6,34
Zenit,267,5,8,8,4,24,15,9,32
Terek Grozny,267,6,8,6,6,24,25,-1,30
Din Moscow,267,7,6,6,8,19,23,-4,24
Rostov,267,8,5,6,9,13,19,-6,21
FK Rubin,267,9,5,5,10,22,23,-1,20
Amkar,267,10,4,5,11,11,26,-15,17
Anzhi,267,11,2,6,12,17,41,-24,12
Loko Moscow,268,1,12,5,3,31,13,18,41
CSKA Moscow,268,2,11,3,6,27,20,7,36
Spart Moscow,268,3,9,7,4,36,27,9,34
Krasnodar,268,4,10,4,6,32,25,7,34
Zenit,268,5,7,8,5,21,16,5,29
Terek Grozny,268,6,7,7,6,22,24,-2,28
Din Moscow,268,7,6,7,7,20,22,-2,25
FK Rubin,268,8,5,5,10,22,22,0,20
Rostov,268,9,4,7,9,11,18,-7,19
Amkar,268,10,4,5,11,9,23,-14,17
Anzhi,268,11,3,6,11,19,40,-21,15
Loko Moscow,269,1,12,6,2,34,15,19,42
CSKA Moscow,269,2,11,3,6,26,18,8,36
Spart Moscow,269,3,10,5,5,38,29,9,35
Zenit,269,4,8,9,3,24,15,9,33
Krasnodar,269,5,9,4,7,30,27,3,31
Terek Grozny,269,6,8,5,7,21,25,-4,29
FK Rubin,269,7,6,5,9,23,19,4,23
Amkar,269,8,6,4,10,15,23,-8,22
Din Moscow,269,9,5,6,9,19,26,-7,21
Rostov,269,10,4,6,10,10,18,-8,18
Anzhi,269,11,2,5,13,14,39,-25,11
Loko Moscow,270,1,13,5,2,36,14,22,44
Spart Moscow,270,2,11,5,4,38,27,11,38
CSKA Moscow,270,3,10,4,6,26,19,7,34
Zenit,270,4,8,8,4,25,18,7,32
Terek Grozny,270,5,8,6,6,23,24,-1,30
Krasnodar,270,6,8,5,7,28,27,1,29
FK Rubin,270,7,5,7,8,22,18,4,22
Din Moscow,270,8,5,7,8,19,24,-5,22
Rostov,270,9,4,6,10,11,19,-8,18
Amkar,270,10,4,4,12,10,25,-15,16
Anzhi,270,11,2,7,11,15,38,-23,13
CSKA Moscow,271,1,12,3,5,29,19,10,39
Loko Moscow,271,2,11,5,4,30,17,13,38
Spart Moscow,271,3,10,5,5,41,31,10,35
Zenit,271,4,8,8,4,25,16,9,32
Krasnodar,271,5,9,4,7,30,26,4,31
Terek Grozny,271,6,8,6,6,25,24,1,30
FK Rubin,271,7,7,5,8,25,18,7,26
Din Moscow,271,8,5,6,9,18,27,-9,21
Amkar,271,9,5,4,11,16,28,-12,19
Rostov,271,10,4,6,10,10,19,-9,18
Anzhi,271,11,2,6,12,16,40,-24,12
Loko Moscow,272,1,11,6,3,31,15,16,39
Spart Moscow,272,2,11,5,4,41,30,11,38
CSKA Moscow,272,3,10,5,5,26,18,8,35
Krasnodar,272,4,10,4,6,30,24,6,34
Zenit,272,5,7,10,3,24,16,8,31
Terek Grozny,272,6,7,6,7,22,25,-3,27
Din Moscow,272,7,5,7,8,19,24,-5,22
FK Rubin,272,8,5,6,9,21,18,3,21
Amkar,272,9,5,4,11,12,25,-13,19
Rostov,272,10,4,6,10,12,20,-8,18
Anzhi,272,11,2,7,11,15,38,-23,13
Loko Moscow,273,1,11,6,3,29,12,17,39
CSKA Moscow,273,2,11,3,6,30,22,8,36
Spart Moscow,273,3,9,6,5,40,30,10,33
Krasnodar,273,4,9,4,7,28,25,3,31
Zenit,273,5,7,9,4,22,15,7,30
Terek Grozny,273,6,8,5,7,22,25,-3,29
Din Moscow,273,7,6,7,7,20,23,-3,25
FK Rubin,273,8,6,5,9,22,18,4,23
Amkar,273,9,5,4,11,11,24,-13,19
Rostov,273,10,4,6,10,11,21,-10,18
Anzhi,273,11,4,5,11,21,41,-20,17
Loko Moscow,274,1,13,5,2,35,11,24,44
Spart Moscow,274,2,10,6,4,38,26,12,36
CSKA Moscow,274,3,11,3,6,31,20,11,36
Zenit,274,4,8,8,4,23,16,7,32
Krasnodar,274,5,8,4,8,29,32,-3,28
Terek Grozny,274,6,7,5,8,21,26,-5,26
Din Moscow,274,7,6,7,7,20,23,-3,25
FK Rubin,274,8,6,5,9,26,21,5,23
Amkar,274,9,5,4,11,11,25,-14,19
Rostov,274,10,4,6,10,10,19,-9,18
Anzhi,274,11,3,5,12,17,42,-25,14
Loko Moscow,275,1,11,6,3,32,16,16,39
Zenit,275,2,9,8,3,25,14,11,35
Spart Moscow,275,3,10,5,5,38,31,7,35
CSKA Moscow,275,4,10,4,6,26,19,7,34
Krasnodar,275,5,9,5,6,31,27,4,32
Terek Grozny,275,6,8,5,7,24,24,0,29
FK Rubin,275,7,6,5,9,24,20,4,23
Din Moscow,275,8,5,6,9,18,24,-6,21
Amkar,275,9,5,4,11,13,26,-13,19
Rostov,275,10,4,6,10,12,20,-8,18
Anzhi,275,11,3,6,11,17,39,-22,15
Loko Moscow,276,1,12,6,2,32,13,19,42
CSKA Moscow,276,2,11,4,5,29,19,10,37
Spart Moscow,276,3,9,5,6,36,30,6,32
Zenit,276,4,7,9,4,22,15,7,30
Krasnodar,276,5,8,6,6,29,26,3,30
Terek Grozny,276,6,8,6,6,22,23,-1,30
Din Moscow,276,7,7,6,7,21,22,-1,27
FK Rubin,276,8,5,6,9,22,20,2,21
Rostov,276,9,5,6,9,12,17,-5,21
Amkar,276,10,4,5,11,11,25,-14,17
Anzhi,276,11,2,5,13,16,42,-26,11
Loko Moscow,277,1,12,6,2,31,12,19,42
Spart Moscow,277,2,10,6,4,38,26,12,36
CSKA Moscow,277,3,10,4,6,26,19,7,34
Zenit,277,4,7,10,3,22,14,8,31
Krasnodar,277,5,8,4,8,27,28,-1,28
Terek Grozny,277,6,7,6,7,22,25,-3,27
Din Moscow,277,7,6,6,8,18,23,-5,24
FK Rubin,277,8,6,5,9,24,18,6,23
Amkar,277,9,5,5,10,11,23,-12,20
Rostov,277,10,4,6,10,10,19,-9,18
Anzhi,277,11,3,6,11,18,40,-22,15
Loko Moscow,278,1,11,5,4,29,14,15,38
CSKA Moscow,278,2,10,4,6,26,19,7,34
Zenit,278,3,8,9,3,23,14,9,33
Spart Moscow,278,4,9,5,6,35,30,5,32
Krasnodar,278,5,9,5,6,30,25,5,32
Terek Grozny,278,6,8,5,7,22,24,-2,29
Din Moscow,278,7,6,7,7,21,23,-2,25
FK Rubin,278,8,5,7,8,23,19,4,22
Amkar,278,9,6,4,10,13,22,-9,22
Rostov,278,10,4,6,10,10,18,-8,18
Anzhi,278,11,3,5,12,15,39,-24,14
Loko Moscow,279,1,13,5,2,33,12,21,44
Spart Moscow,279,2,10,6,4,39,27,12,36
CSKA Moscow,279,3,11,3,6,29,19,10,36
Zenit,279,4,8,8,4,23,14,9,32
Terek Grozny,279,5,8,6,6,25,26,-1,30
Krasnodar,279,6,8,4,8,29,29,0,28
FK Rubin,279,7,7,5,8,25,18,7,26
Din Moscow,279,8,5,6,9,17,26,-9,21
Rostov,279,9,4,6,10,11,19,-8,18
Amkar,279,10,4,6,10,12,25,-13,18
Anzhi,279,11,2,5,13,16,44,-28,11
Loko Moscow,280,1,11,5,4,30,15,15,38
CSKA Moscow,280,2,11,3,6,27,19,8,36
Zenit,280,3,9,8,3,25,14,11,35
Spart Moscow,280,4,9,6,5,39,30,9,33
Krasnodar,280,5,9,4,7,29,25,4,31
Terek Grozny,280,6,7,6,7,22,25,-3,27
FK Rubin,280,7,7,5,8,24,17,7,26
Din Moscow,280,8,5,6,9,17,25,-8,21
Amkar,280,9,5,5,10,13,25,-12,20
Rostov,280,10,4,7,9,12,19,-7,19
Anzhi,280,11,3,5,12,16,40,-24,14
Loko Moscow,281,1,11,7,2,32,14,18,40
Spart Moscow,281,2,9,7,4,38,29,9,34
Zenit,281,3,8,9,3,24,14,10,33
CSKA Moscow,281,4,10,3,7,25,20,5,33
Terek Grozny,281,5,9,5,6,22,22,0,32
Krasnodar,281,6,8,6,6,30,27,3,30
FK Rubin,281,7,6,6,8,23,18,5,24
Din Moscow,281,8,5,7,8,19,24,-5,22
Rostov,281,9,4,7,9,11,18,-7,19
Amkar,281,10,4,4,12,10,25,-15,16
Anzhi,281,11,3,5,12,15,38,-23,14
Loko Moscow,282,1,12,6,2,30,11,19,42
Spart Moscow,282,2,11,5,4,42,26,16,38
CSKA Moscow,282,3,11,4,5,28,19,9,37
Zenit,282,4,7,10,3,21,13,8,31
Terek Grozny,282,5,8,6,6,24,24,0,30
Krasnodar,282,6,8,5,7,28,26,2,29
Din Moscow,282,7,6,6,8,19,24,-5,24
FK Rubin,282,8,5,6,9,22,19,3,21
Rostov,282,9,4,6,10,10,20,-10,18
Amkar,282,10,4,5,11,11,27,-16,17
Anzhi,282,11,2,5,13,16,42,-26,11
Loko Moscow,283,1,12,6,2,34,14,20,42
CSKA Moscow,283,2,11,3,6,28,19,9,36
Spart Moscow,283,3,9,6,5,38,29,9,33
Zenit,283,4,8,8,4,23,16,7,32
Krasnodar,283,5,8,6,6,30,27,3,30
Terek Grozny,283,6,7,6,7,20,25,-5,27
Din Moscow,283,7,6,6,8,20,25,-5,24
FK Rubin,283,8,5,6,9,23,20,3,21
Amkar,283,9,5,5,10,11,23,-12,20
Rostov,283,10,4,7,9,11,18,-7,19
Anzhi,283,11,3,5,12,18,40,-22,14
Loko Moscow,284,1,12,5,3,33,14,19,41
Spart Moscow,284,2,10,5,5,40,27,13,35
CSKA Moscow,284,3,10,4,6,26,20,6,34
Zenit,284,4,8,8,4,25,18,7,32
Krasnodar,284,5,9,4,7,30,27,3,31
Terek Grozny,284,6,8,6,6,22,22,0,30
Din Moscow,284,7,6,6,8,20,27,-7,24
FK Rubin,284,8,6,5,9,25,21,4,23
Amkar,284,9,5,5,10,11,22,-11,20
Rostov,284,10,4,6,10,10,19,-9,18
Anzhi,284,11,2,6,12,14,39,-25,12
Loko Moscow,285,1,11,7,2,30,12,18,40
Spart Moscow,285,2,10,6,4,39,29,10,36
CSKA Moscow,285,3,10,4,6,25,19,6,34
Zenit,285,4,8,9,3,23,13,10,33
Krasnodar,285,5,8,6,6,30,27,3,30
Terek Grozny,285,6,7,6,7,22,27,-5,27
Din Moscow,285,7,6,7,7,23,24,-1,25
FK Rubin,285,8,5,6,9,24,23,1,21
Amkar,285,9,5,4,11,14,25,-11,19
Rostov,285,10,4,6,10,10,18,-8,18
Anzhi,285,11,2,7,11,16,39,-23,13
Loko Moscow,286,1,13,5,2,34,12,22,44
CSKA Moscow,286,2,11,3,6,27,20,7,36
Spart Moscow,286,3,9,6,5,37,30,7,33
Zenit,286,4,7,8,5,21,15,6,29
Krasnodar,286,5,8,4,8,28,32,-4,28
Terek Grozny,286,6,7,6,7,21,25,-4,27
FK Rubin,286,7,7,5,8,28,17,11,26
Din Moscow,286,8,6,6,8,21,26,-5,24
Rostov,286,9,4,6,10,11,19,-8,18
Amkar,286,10,4,6,10,10,23,-13,18
Anzhi,286,11,4,5,11,19,38,-19,17
CSKA Moscow,287,1,12,3,5,31,19,12,39
Loko Moscow,287,2,11,5,4,31,15,16,38
Spart Moscow,287,3,9,5,6,36,29,7,32
Zenit,287,4,8,8,4,24,17,7,32
Krasnodar,287,5,9,5,6,28,24,4,32
Terek Grozny,287,6,9,5,6,25,23,2,32
FK Rubin,287,7,6,6,8,22,17,5,24
Din Moscow,287,8,6,6,8,19,23,-4,24
Amkar,287,9,5,4,11,10,24,-14,19
Rostov,287,10,4,6,10,11,19,-8,18
Anzhi,287,11,2,5,13,17,44,-27,11
Loko Moscow,288,1,11,7,2,31,13,18,40
CSKA Moscow,288,2,11,3,6,29,20,9,36
Spart Moscow,288,3,9,6,5,39,30,9,33
Zenit,288,4,7,9,4,23,17,6,30
Krasnodar,288,5,8,5,7,28,27,1,29
Din Moscow,288,6,7,6,7,21,23,-2,27
Terek Grozny,288,7,7,6,7,22,26,-4,27
FK Rubin,288,8,6,5,9,24,19,5,23
Rostov,288,9,4,7,9,12,19,-7,19
Amkar,288,10,5,4,11,14,27,-13,19
Anzhi,288,11,3,6,11,16,38,-22,15
Loko Moscow,289,1,12,5,3,34,12,22,41
CSKA Moscow,289,2,11,3,6,28,20,8,36
Spart Moscow,289,3,9,7,4,37,28,9,34
Krasnodar,289,4,10,4,6,30,25,5,34
Zenit,289,5,8,8,4,23,19,4,32
Terek Grozny,289,6,7,6,7,21,24,-3,27
Din Moscow,289,7,6,6,8,19,23,-4,24
FK Rubin,289,8,5,5,10,23,21,2,20
Rostov,289,9,4,7,9,12,19,-7,19
Amkar,289,10,4,6,10,11,24,-13,18
Anzhi,289,11,3,5,12,16,39,-23,14
Loko Moscow,290,1,12,5,3,33,14,19,41
CSKA Moscow,290,2,11,3,6,27,21,6,36
Zenit,290,3,9,8,3,28,15,13,35
Spart Moscow,290,4,8,8,4,38,30,8,32
Krasnodar,290,5,9,4,7,30,28,2,31
Terek Grozny,290,6,8,6,6,23,24,-1,30
Din Moscow,290,7,5,8,7,19,23,-4,23
FK Rubin,290,8,5,6,9,22,20,2,21
Rostov,290,9,4,7,9,11,18,-7,19
Amkar,290,10,4,6,10,13,26,-13,18
Anzhi,290,11,2,5,13,14,39,-25,11
Loko Moscow,291,1,12,5,3,31,13,18,41
CSKA Moscow,291,2,11,4,5,29,17,12,37
Spart Moscow,291,3,10,5,5,39,27,12,35
Krasnodar,291,4,9,4,7,30,27,3,31
Zenit,291,5,7,9,4,21,14,7,30
Terek Grozny,291,6,7,5,8,20,26,-6,26
Din Moscow,291,7,6,7,7,19,22,-3,25
FK Rubin,291,8,6,6,8,23,18,5,24
Amkar,291,9,5,4,11,10,25,-15,19
Rostov,291,10,4,6,10,10,19,-9,18
Anzhi,291,11,3,5,12,17,41,-24,14
Loko Moscow,292,1,12,5,3,32,14,18,41
Spart Moscow,292,2,10,6,4,40,28,12,36
CSKA Moscow,292,3,10,5,5,27,19,8,35
Krasnodar,292,4,9,5,6,29,25,4,32
Zenit,292,5,7,9,4,23,16,7,30
Terek Grozny,292,6,7,5,8,21,26,-5,26
Din Moscow,292,7,6,6,8,18,24,-6,24
FK Rubin,292,8,5,6,9,21,18,3,21
Amkar,292,9,5,5,10,12,24,-12,20
Rostov,292,10,4,6,10,11,19,-8,18
Anzhi,292,11,3,6,11,18,39,-21,15
Loko Moscow,293,1,13,5,2,33,12,21,44
Spart Moscow,293,2,11,5,4,42,27,15,38
CSKA Moscow,293,3,11,4,5,31,19,12,37
Zenit,293,4,7,9,4,24,18,6,30
Terek Grozny,293,5,8,6,6,23,24,-1,30
Krasnodar,293,6,8,5,7,27,25,2,29
FK Rubin,293,7,5,7,8,22,18,4,22
Din Moscow,293,8,5,7,8,19,24,-5,22
Rostov,293,9,4,6,10,10,20,-10,18
Amkar,293,10,4,4,12,10,27,-17,16
Anzhi,293,11,2,6,12,16,43,-27,12
Loko Moscow,294,1,11,6,3,30,13,17,39
CSKA Moscow,294,2,12,3,5,30,17,13,39
Spart Moscow,294,3,10,6,4,36,26,10,36
Krasnodar,294,4,9,5,6,29,25,4,32
Zenit,294,5,7,9,4,22,16,6,30
Terek Grozny,294,6,7,6,7,22,25,-3,27
FK Rubin,294,7,6,6,8,24,19,5,24
Din Moscow,294,8,5,6,9,19,25,-6,21
Rostov,294,9,4,7,9,10,17,-7,19
Amkar,294,10,5,4,11,11,24,-13,19
Anzhi,294,11,2,6,12,15,41,-26,12
Loko Moscow,295,1,12,6,2,36,14,22,42
Spart Moscow,295,2,10,6,4,41,26,15,36
CSKA Moscow,295,3,11,3,6,28,19,9,36
Krasnodar,295,4,9,5,6,32,26,6,32
Zenit,295,5,8,8,4,24,19,5,32
Terek Grozny,295,6,9,5,6,23,23,0,32
FK Rubin,295,7,6,5,9,24,21,3,23
Din Moscow,295,8,5,6,9,17,26,-9,21
Rostov,295,9,4,6,10,10,21,-11,18
Amkar,295,10,4,5,11,10,24,-14,17
Anzhi,295,11,2,5,13,16,42,-26,11
Loko Moscow,296,1,12,5,3,32,13,19,41
CSKA Moscow,296,2,11,3,6,29,19,10,36
Krasnodar,296,3,10,4,6,31,26,5,34
Spart Moscow,296,4,9,5,6,37,28,9,32
Zenit,296,5,8,8,4,22,15,7,32
Din Moscow,296,6,7,6,7,20,22,-2,27
Terek Grozny,296,7,7,6,7,22,25,-3,27
Amkar,296,8,6,4,10,11,22,-11,22
FK Rubin,296,9,5,5,10,22,20,2,20
Rostov,296,10,4,6,10,10,20,-10,18
Anzhi,296,11,2,6,12,17,43,-26,12
Loko Moscow,297,1,12,6,2,30,11,19,42
CSKA Moscow,297,2,12,3,5,28,18,10,39
Spart Moscow,297,3,10,6,4,41,28,13,36
Terek Grozny,297,4,9,5,6,22,22,0,32
Krasnodar,297,5,9,4,7,29,25,4,31
Zenit,297,6,7,9,4,21,14,7,30
Din Moscow,297,7,6,6,8,18,23,-5,24
FK Rubin,297,8,5,5,10,21,20,1,20
Rostov,297,9,4,6,10,11,21,-10,18
Amkar,297,10,4,5,11,11,25,-14,17
Anzhi,297,11,2,5,13,15,40,-25,11
Loko Moscow,298,1,11,7,2,30,12,18,40
CSKA Moscow,298,2,11,4,5,26,17,9,37
Spart Moscow,298,3,10,5,5,39,30,9,35
Krasnodar,298,4,9,5,6,28,24,4,32
Zenit,298,5,7,9,4,22,15,7,30
Terek Grozny,298,6,8,5,7,25,26,-1,29
Din Moscow,298,7,6,6,8,22,24,-2,24
Amkar,298,8,6,4,10,13,24,-11,22
FK Rubin,298,9,5,5,10,21,21,0,20
Rostov,298,10,4,6,10,11,19,-8,18
Anzhi,298,11,2,6,12,16,41,-25,12
Loko Moscow,299,1,11,6,3,29,14,15,39
CSKA Moscow,299,2,11,4,5,27,18,9,37
Spart Moscow,299,3,9,6,5,38,28,10,33
Krasnodar,299,4,9,5,6,30,24,6,32
Zenit,299,5,7,10,3,21,13,8,31
Terek Grozny,299,6,7,7,6,20,22,-2,28
FK Rubin,299,7,5,7,8,21,17,4,22
Din Moscow,299,8,5,7,8,17,24,-7,22
Amkar,299,9,5,5,10,10,22,-12,20
Rostov,299,10,4,7,9,12,19,-7,19
Anzhi,299,11,2,6,12,15,39,-24,12
Loko Moscow,300,1,13,5,2,34,13,21,44
CSKA Moscow,300,2,12,3,5,29,19,10,39
Spart Moscow,300,3,9,6,5,38,29,9,33
Krasnodar,300,4,9,4,7,30,27,3,31
Terek Grozny,300,5,8,6,6,23,24,-1,30
Zenit,300,6,7,8,5,23,18,5,29
Din Moscow,300,7,5,7,8,17,23,-6,22
FK Rubin,300,8,5,6,9,21,18,3,21
Rostov,300,9,4,7,9,11,18,-7,19
Amkar,300,10,5,4,11,13,26,-13,19
Anzhi,300,11,2,6,12,15,39,-24,12
Loko Moscow,301,1,11,6,3,30,14,16,39
Spart Moscow,301,2,11,5,4,39,27,12,38
CSKA Moscow,301,3,11,4,5,30,18,12,37
Zenit,301,4,7,10,3,23,15,8,31
Krasnodar,301,5,9,4,7,29,25,4,31
Terek Grozny,301,6,8,5,7,21,23,-2,29
FK Rubin,301,7,6,6,8,23,18,5,24
Din Moscow,301,8,5,7,8,18,24,-6,22
Amkar,301,9,5,4,11,10,23,-13,19
Rostov,301,10,4,6,10,12,20,-8,18
Anzhi,301,11,2,5,13,14,42,-28,11
Loko Moscow,302,1,12,5,3,34,15,19,41
CSKA Moscow,302,2,12,3,5,29,17,12,39
Spart Moscow,302,3,11,5,4,39,25,14,38
Krasnodar,302,4,9,5,6,33,29,4,32
Zenit,302,5,7,8,5,21,17,4,29
Terek Grozny,302,6,7,5,8,21,25,-4,26
Din Moscow,302,7,6,6,8,18,24,-6,24
FK Rubin,302,8,5,6,9,23,20,3,21
Amkar,302,9,5,4,11,10,23,-13,19
Rostov,302,10,4,6,10,10,19,-9,18
Anzhi,302,11,3,5,12,16,40,-24,14
Loko Moscow,303,1,12,5,3,33,15,18,41
Spart Moscow,303,2,10,6,4,39,27,12,36
CSKA Moscow,303,3,11,3,6,27,20,7,36
Zenit,303,4,9,8,3,27,15,12,35
Terek Grozny,303,5,8,5,7,23,25,-2,29
Krasnodar,303,6,8,4,8,27,28,-1,28
Din Moscow,303,7,6,6,8,20,23,-3,24
FK Rubin,303,8,6,5,9,23,20,3,23
Rostov,303,9,4,6,10,11,20,-9,18
Amkar,303,10,4,5,11,10,24,-14,17
Anzhi,303,11,3,5,12,18,41,-23,14
Loko Moscow,304,1,12,5,3,32,13,19,41
CSKA Moscow,304,2,12,3,5,29,17,12,39
Spart Moscow,304,3,9,7,4,38,27,11,34
Krasnodar,304,4,10,4,6,30,25,5,34
Zenit,304,5,7,8,5,22,18,4,29
Terek Grozny,304,6,7,6,7,22,26,-4,27
Din Moscow,304,7,5,7,8,19,26,-7,22
FK Rubin,304,8,5,6,9,23,20,3,21
Rostov,304,9,4,7,9,10,17,-7,19
Amkar,304,10,4,6,10,12,25,-13,18
Anzhi,304,11,3,5,12,16,39,-23,14
Loko Moscow,305,1,12,5,3,31,13,18,41
CSKA Moscow,305,2,11,3,6,27,20,7,36
Krasnodar,305,3,10,4,6,32,27,5,34
Spart Moscow,305,4,9,6,5,39,31,8,33
Zenit,305,5,8,8,4,24,15,9,32
Terek Grozny,305,6,7,7,6,24,26,-2,28
Din Moscow,305,7,6,6,8,21,24,-3,24
FK Rubin,305,8,5,5,10,23,22,1,20
Amkar,305,9,5,5,10,13,25,-12,20
Rostov,305,10,4,7,9,13,20,-7,19
Anzhi,305,11,2,6,12,15,39,-24,12
Loko Moscow,306,1,12,6,2,31,12,19,42
CSKA Moscow,306,2,11,4,5,26,17,9,37
Spart Moscow,306,3,10,5,5,39,28,11,35
Krasnodar,306,4,9,5,6,29,25,4,32
Zenit,306,5,7,8,5,21,15,6,29
Terek Grozny,306,6,7,6,7,23,26,-3,27
Din Moscow,306,7,6,6,8,19,24,-5,24
Rostov,306,8,5,6,9,11,17,-6,21
FK Rubin,306,9,5,5,10,21,20,1,20
Amkar,306,10,4,5,11,12,26,-14,17
Anzhi,306,11,3,6,11,17,39,-22,15
Loko Moscow,307,1,12,5,3,30,14,16,41
Spart Moscow,307,2,11,5,4,40,26,14,38
CSKA Moscow,307,3,10,5,5,27,19,8,35
Krasnodar,307,4,10,4,6,32,24,8,34
Zenit,307,5,7,9,4,22,15,7,30
Terek Grozny,307,6,8,5,7,21,23,-2,29
Din Moscow,307,7,5,7,8,17,25,-8,22
FK Rubin,307,8,5,6,9,21,19,2,21
Amkar,307,9,5,4,11,11,24,-13,19
Rostov,307,10,4,6,10,10,18,-8,18
Anzhi,307,11,2,6,12,15,39,-24,12
Loko Moscow,308,1,11,6,3,31,14,17,39
CSKA Moscow,308,2,12,3,5,27,17,10,39
Krasnodar,308,3,10,4,6,32,26,6,34
Spart Moscow,308,4,9,6,5,38,29,9,33
Terek Grozny,308,5,9,5,6,23,23,0,32
Zenit,308,6,7,9,4,21,14,7,30
FK Rubin,308,7,6,5,9,24,20,4,23
Din Moscow,308,8,5,6,9,18,27,-9,21
Rostov,308,9,4,7,9,12,19,-7,19
Amkar,308,10,5,4,11,11,23,-12,19
Anzhi,308,11,2,5,13,15,40,-25,11
Loko Moscow,309,1,12,5,3,32,12,20,41
Spart Moscow,309,2,10,5,5,40,30,10,35
Zenit,309,3,9,8,3,23,13,10,35
CSKA Moscow,309,4,10,4,6,27,20,7,34
Krasnodar,309,5,9,4,7,29,28,1,31
Terek Grozny,309,6,8,6,6,22,23,-1,30
Din Moscow,309,7,6,6,8,18,24,-6,24
FK Rubin,309,8,5,5,10,22,20,2,20
Amkar,309,9,5,5,10,14,24,-10,20
Rostov,309,10,4,6,10,11,20,-9,18
Anzhi,309,11,2,6,12,16,40,-24,12
Loko Moscow,310,1,12,6,2,33,13,20,42
CSKA Moscow,310,2,11,3,6,28,18,10,36
Zenit,310,3,8,9,3,24,15,9,33
Spart Moscow,310,4,9,5,6,35,30,5,32
Terek Grozny,310,5,9,5,6,24,24,0,32
Krasnodar,310,6,8,5,7,28,27,1,29
FK Rubin,310,7,5,7,8,24,20,4,22
Din Moscow,310,8,5,7,8,20,25,-5,22
Rostov,310,9,5,6,9,12,17,-5,21
Amkar,310,10,5,4,11,11,23,-12,19
Anzhi,310,11,2,5,13,16,43,-27,11
Loko Moscow,311,1,11,6,3,31,14,17,39
CSKA Moscow,311,2,11,4,5,29,19,10,37
Spart Moscow,311,3,10,5,5,39,29,10,35
Krasnodar,311,4,10,4,6,32,26,6,34
Zenit,311,5,7,10,3,23,15,8,31
Terek Grozny,311,6,7,5,8,21,26,-5,26
Din Moscow,311,7,6,6,8,20,25,-5,24
Amkar,311,8,6,4,10,13,23,-10,22
FK Rubin,311,9,5,5,10,22,21,1,20
Rostov,311,10,4,6,10,11,19,-8,18
Anzhi,311,11,3,5,12,16,40,-24,14
Loko Moscow,312,1,11,6,3,31,14,17,39
Spart Moscow,312,2,11,5,4,41,26,15,38
Zenit,312,3,9,8,3,25,15,10,35
CSKA Moscow,312,4,10,3,7,26,20,6,33
Krasnodar,312,5,9,5,6,29,25,4,32
Terek Grozny,312,6,8,5,7,21,23,-2,29
FK Rubin,312,7,6,5,9,22,18,4,23
Din Moscow,312,8,5,6,9,17,24,-7,21
Amkar,312,9,5,4,11,11,25,-14,19
Rostov,312,10,4,6,10,10,20,-10,18
Anzhi,312,11,3,5,12,15,38,-23,14
Loko Moscow,313,1,11,5,4,31,17,14,38
CSKA Moscow,313,2,11,4,5,30,20,10,37
Spart Moscow,313,3,10,5,5,36,30,6,35
Zenit,313,4,8,8,4,25,18,7,32
Krasnodar,313,5,9,5,6,32,26,6,32
Terek Grozny,313,6,8,6,6,21,22,-1,30
FK Rubin,313,7,5,7,8,23,19,4,22
Din Moscow,313,8,5,7,8,18,23,-5,22
Rostov,313,9,5,6,9,14,17,-3,21
Amkar,313,10,4,5,11,9,23,-14,17
Anzhi,313,11,2,6,12,16,40,-24,12
Loko Moscow,314,1,11,6,3,29,14,15,39
CSKA Moscow,314,2,10,5,5,25,17,8,35
Spart Moscow,314,3,8,8,4,38,30,8,32
Terek Grozny,314,4,9,5,6,27,24,3,32
Zenit,314,5,7,10,3,21,13,8,31
Krasnodar,314,6,9,4,7,30,25,5,31
Din Moscow,314,7,6,7,7,20,22,-2,25
FK Rubin,314,8,6,5,9,22,19,3,23
Rostov,314,9,4,7,9,11,18,-7,19
Amkar,314,10,4,5,11,13,30,-17,17
Anzhi,314,11,2,6,12,15,39,-24,12
Loko Moscow,315,1,11,5,4,32,16,16,38
CSKA Moscow,315,2,11,3,6,27,20,7,36
Spart Moscow,315,3,10,5,5,39,28,11,35
Zenit,315,4,9,8,3,26,15,11,35
Krasnodar,315,5,10,4,6,32,26,6,34
Terek Grozny,315,6,7,5,8,20,25,-5,26
Din Moscow,315,7,6,6,8,20,23,-3,24
FK Rubin,315,8,6,5,9,23,20,3,23
Amkar,315,9,5,4,11,10,23,-13,19
Rostov,315,10,4,6,10,10,21,-11,18
Anzhi,315,11,3,5,12,17,39,-22,14
Loko Moscow,316,1,13,5,2,34,13,21,44
CSKA Moscow,316,2,11,3,6,29,21,8,36
Spart Moscow,316,3,9,5,6,38,30,8,32
Zenit,316,4,8,8,4,23,16,7,32
Krasnodar,316,5,8,4,8,29,29,0,28
Terek Grozny,316,6,7,6,7,20,23,-3,27
FK Rubin,316,7,7,5,8,26,19,7,26
Amkar,316,8,6,4,10,12,23,-11,22
Rostov,316,9,5,6,9,12,18,-6,21
Din Moscow,316,10,5,6,9,20,27,-7,21
Anzhi,316,11,2,6,12,16,40,-24,12
Loko Moscow,317,1,11,6,3,30,13,17,39
CSKA Moscow,317,2,11,3,6,29,18,11,36
Zenit,317,3,8,9,3,23,14,9,33
Spart Moscow,317,4,9,6,5,37,29,8,33
Krasnodar,317,5,9,4,7,28,26,2,31
Terek Grozny,317,6,8,6,6,23,24,-1,30
FK Rubin,317,7,7,5,8,25,18,7,26
Din Moscow,317,8,5,7,8,20,25,-5,22
Amkar,317,9,5,4,11,12,25,-13,19
Rostov,317,10,4,6,10,11,19,-8,18
Anzhi,317,11,2,6,12,14,41,-27,12
Loko Moscow,318,1,11,6,3,30,13,17,39
CSKA Moscow,318,2,11,3,6,28,20,8,36
Spart Moscow,318,3,10,5,5,37,26,11,35
Zenit,318,4,8,9,3,24,15,9,33
Terek Grozny,318,5,9,5,6,25,22,3,32
Krasnodar,318,6,9,4,7,28,25,3,31
FK Rubin,318,7,6,6,8,22,17,5,24
Din Moscow,318,8,5,7,8,17,22,-5,22
Amkar,318,9,5,4,11,10,26,-16,19
Rostov,318,10,4,6,10,10,20,-10,18
Anzhi,318,11,2,5,13,15,40,-25,11
Loko Moscow,319,1,13,5,2,34,12,22,44
Spart Moscow,319,2,9,6,5,37,32,5,33
CSKA Moscow,319,3,10,3,7,25,20,5,33
Zenit,319,4,8,8,4,23,16,7,32
Krasnodar,319,5,8,5,7,28,26,2,29
Terek Grozny,319,6,7,7,6,23,25,-2,28
FK Rubin,319,7,6,6,8,24,18,6,24
Din Moscow,319,8,5,7,8,20,26,-6,22
Amkar,319,9,5,5,10,15,23,-8,20
Rostov,319,10,4,6,10,10,19,-9,18
Anzhi,319,11,3,6,11,17,39,-22,15
Loko Moscow,320,1,12,5,3,31,14,17,41
Spart Moscow,320,2,10,6,4,40,27,13,36
CSKA Moscow,320,3,11,3,6,27,20,7,36
Krasnodar,320,4,10,4,6,34,24,10,34
Zenit,320,5,8,8,4,24,15,9,32
Terek Grozny,320,6,8,5,7,23,23,0,29
Din Moscow,320,7,5,7,8,19,26,-7,22
FK Rubin,320,8,5,6,9,23,23,0,21
Rostov,320,9,4,7,9,12,19,-7,19
Amkar,320,10,4,4,12,9,27,-18,16
Anzhi,320,11,3,5,12,15,39,-24,14
Loko Moscow,321,1,13,5,2,33,11,22,44
CSKA Moscow,321,2,10,4,6,25,20,5,34
Zenit,321,3,8,8,4,24,16,8,32
Spart Moscow,321,4,9,5,6,34,27,7,32
Krasnodar,321,5,9,4,7,32,26,6,31
Terek Grozny,321,6,7,6,7,20,23,-3,27
Din Moscow,321,7,6,7,7,19,22,-3,25
Amkar,321,8,6,4,10,11,22,-11,22
FK Rubin,321,9,5,6,9,23,23,0,21
Rostov,321,10,4,6,10,10,18,-8,18
Anzhi,321,11,2,7,11,14,37,-23,13
Loko Moscow,322,1,13,5,2,34,11,23,44
Spart Moscow,322,2,10,6,4,39,27,12,36
CSKA Moscow,322,3,10,4,6,29,22,7,34
Zenit,322,4,8,8,4,23,15,8,32
Krasnodar,322,5,9,4,7,31,28,3,31
Terek Grozny,322,6,8,5,7,22,24,-2,29
Din Moscow,322,7,6,7,7,23,24,-1,25
FK Rubin,322,8,5,5,10,22,25,-3,20
Rostov,322,9,4,6,10,10,18,-8,18
Amkar,322,10,4,4,12,9,27,-18,16
Anzhi,322,11,3,6,11,19,40,-21,15
Spart Moscow,323,1,11,5,4,42,27,15,38
Loko Moscow,323,2,11,5,4,30,16,14,38
CSKA Moscow,323,3,11,4,5,29,19,10,37
Krasnodar,323,4,10,4,6,33,24,9,34
Zenit,323,5,8,9,3,24,15,9,33
Terek Grozny,323,6,8,6,6,21,22,-1,30
Din Moscow,323,7,6,6,8,23,25,-2,24
FK Rubin,323,8,5,5,10,22,25,-3,20
Rostov,323,9,4,6,10,11,20,-9,18
Amkar,323,10,4,5,11,9,25,-16,17
Anzhi,323,11,2,5,13,15,41,-26,11
Loko Moscow,324,1,12,6,2,32,13,19,42
CSKA Moscow,324,2,12,3,5,29,17,12,39
Spart Moscow,324,3,9,5,6,34,28,6,32
Krasnodar,324,4,9,4,7,29,26,3,31
Zenit,324,5,7,9,4,22,15,7,30
Terek Grozny,324,6,8,5,7,22,25,-3,29
Din Moscow,324,7,7,6,7,21,22,-1,27
Amkar,324,8,6,4,10,14,23,-9,22
FK Rubin,324,9,5,5,10,22,21,1,20
Rostov,324,10,4,6,10,10,18,-8,18
Anzhi,324,11,2,5,13,14,41,-27,11
Loko Moscow,325,1,13,5,2,33,11,22,44
Spart Moscow,325,2,10,6,4,41,29,12,36
CSKA Moscow,325,3,11,3,6,28,18,10,36
Zenit,325,4,8,8,4,22,15,7,32
Krasnodar,325,5,8,5,7,27,26,1,29
Terek Grozny,325,6,7,5,8,21,26,-5,26
FK Rubin,325,7,6,6,8,23,18,5,24
Din Moscow,325,8,5,7,8,20,25,-5,22
Amkar,325,9,5,4,11,13,27,-14,19
Rostov,325,10,4,6,10,10,19,-9,18
Anzhi,325,11,3,5,12,16,40,-24,14
Loko Moscow,326,1,11,6,3,29,12,17,39
CSKA Moscow,326,2,12,3,5,31,19,12,39
Spart Moscow,326,3,11,5,4,40,25,15,38
Krasnodar,326,4,10,4,6,30,25,5,34
Zenit,326,5,7,9,4,21,15,6,30
Terek Grozny,326,6,8,5,7,25,28,-3,29
FK Rubin,326,7,6,5,9,23,19,4,23
Din Moscow,326,8,5,6,9,17,24,-7,21
Rostov,326,9,4,6,10,10,19,-9,18
Amkar,326,10,4,4,12,10,29,-19,16
Anzhi,326,11,3,5,12,21,42,-21,14
Loko Moscow,327,1,11,5,4,30,15,15,38
CSKA Moscow,327,2,11,4,5,28,18,10,37
Spart Moscow,327,3,9,7,4,37,28,9,34
Krasnodar,327,4,10,4,6,34,25,9,34
Zenit,327,5,8,9,3,23,14,9,33
Terek Grozny,327,6,9,5,6,24,23,1,32
Din Moscow,327,7,5,7,8,19,24,-5,22
FK Rubin,327,8,5,6,9,21,21,0,21
Rostov,327,9,4,7,9,10,17,-7,19
Amkar,327,10,4,5,11,11,26,-15,17
Anzhi,327,11,2,5,13,14,40,-26,11
Loko Moscow,328,1,12,5,3,31,14,17,41
Spart Moscow,328,2,10,6,4,39,28,11,36
Zenit,328,3,9,8,3,25,13,12,35
CSKA Moscow,328,4,10,3,7,27,22,5,33
Krasnodar,328,5,9,4,7,31,28,3,31
Terek Grozny,328,6,7,5,8,20,27,-7,26
FK Rubin,328,7,6,5,9,24,20,4,23
Din Moscow,328,8,5,7,8,19,24,-5,22
Amkar,328,9,5,4,11,10,23,-13,19
Rostov,328,10,4,6,10,11,20,-9,18
Anzhi,328,11,4,5,11,21,39,-18,17
Loko Moscow,329,1,12,5,3,33,15,18,41
CSKA Moscow,329,2,11,3,6,28,20,8,36
Spart Moscow,329,3,9,7,4,37,28,9,34
Krasnodar,329,4,10,4,6,31,26,5,34
Zenit,329,5,8,8,4,24,16,8,32
Terek Grozny,329,6,8,5,7,21,23,-2,29
FK Rubin,329,7,6,5,9,23,19,4,23
Din Moscow,329,8,5,6,9,19,25,-6,21
Amkar,329,9,5,5,10,11,23,-12,20
Rostov,329,10,4,7,9,11,18,-7,19
Anzhi,329,11,2,5,13,15,40,-25,11
Loko Moscow,330,1,12,5,3,31,13,18,41
Spart Moscow,330,2,9,6,5,37,29,8,33
CSKA Moscow,330,3,10,3,7,25,22,3,33
Zenit,330,4,8,8,4,24,14,10,32
Krasnodar,330,5,9,4,7,29,26,3,31
Terek Grozny,330,6,8,5,7,22,24,-2,29
Din Moscow,330,7,6,6,8,19,23,-4,24
FK Rubin,330,8,6,5,9,22,18,4,23
Rostov,330,9,5,6,9,12,18,-6,21
Amkar,330,10,4,5,11,11,25,-14,17
Anzhi,330,11,4,5,11,17,37,-20,17
Loko Moscow,331,1,12,5,3,31,13,18,41
Spart Moscow,331,2,11,5,4,41,28,13,38
Krasnodar,331,3,10,4,6,30,25,5,34
CSKA Moscow,331,4,10,3,7,27,23,4,33
Zenit,331,5,8,8,4,25,16,9,32
Terek Grozny,331,6,8,5,7,21,24,-3,29
Din Moscow,331,7,6,6,8,19,25,-6,24
FK Rubin,331,8,5,5,10,22,20,2,20
Rostov,331,9,4,6,10,11,19,-8,18
Anzhi,331,10,4,5,11,19,38,-19,17
Amkar,331,11,4,4,12,10,25,-15,16
Loko Moscow,332,1,12,6,2,31,12,19,42
CSKA Moscow,332,2,10,3,7,28,22,6,33
Zenit,332,3,8,8,4,24,16,8,32
Spart Moscow,332,4,9,5,6,39,32,7,32
Krasnodar,332,5,9,5,6,29,25,4,32
Terek Grozny,332,6,7,5,8,21,25,-4,26
Din Moscow,332,7,6,7,7,20,23,-3,25
Amkar,332,8,6,4,10,13,24,-11,22
FK Rubin,332,9,5,6,9,22,19,3,21
Rostov,332,10,4,6,10,12,20,-8,18
Anzhi,332,11,4,5,11,18,39,-21,17
Loko Moscow,333,1,13,5,2,33,12,21,44
Spart Moscow,333,2,11,5,4,39,26,13,38
CSKA Moscow,333,3,11,3,6,29,20,9,36
Zenit,333,4,8,8,4,23,15,8,32
Terek Grozny,333,5,8,6,6,24,22,2,30
Krasnodar,333,6,8,5,7,29,27,2,29
FK Rubin,333,7,5,7,8,22,18,4,22
Din Moscow,333,8,5,7,8,17,22,-5,22
Rostov,333,9,4,6,10,10,20,-10,18
Amkar,333,10,4,5,11,10,24,-14,17
Anzhi,333,11,2,5,13,15,45,-30,11
Loko Moscow,334,1,12,5,3,34,13,21,41
CSKA Moscow,334,2,10,5,5,27,19,8,35
Spart Moscow,334,3,9,7,4,36,25,11,34
Zenit,334,4,8,9,3,24,15,9,33
Krasnodar,334,5,8,4,8,27,29,-2,28
Terek Grozny,334,6,7,7,6,22,24,-2,28
Din Moscow,334,7,6,7,7,20,22,-2,25
FK Rubin,334,8,6,5,9,23,20,3,23
Rostov,334,9,4,7,9,10,17,-7,19
Amkar,334,10,4,5,11,9,25,-16,17
Anzhi,334,11,2,7,11,17,40,-23,13
Loko Moscow,335,1,12,5,3,31,13,18,41
Spart Moscow,335,2,10,6,4,38,27,11,36
CSKA Moscow,335,3,10,5,5,26,18,8,35
Zenit,335,4,8,9,3,23,14,9,33
Krasnodar,335,5,9,4,7,32,26,6,31
Terek Grozny,335,6,7,6,7,22,25,-3,27
Din Moscow,335,7,6,6,8,21,24,-3,24
FK Rubin,335,8,5,5,10,21,23,-2,20
Rostov,335,9,4,7,9,10,17,-7,19
Amkar,335,10,4,5,11,9,24,-15,17
Anzhi,335,11,3,6,11,17,39,-22,15
Loko Moscow,336,1,13,5,2,33,12,21,44
CSKA Moscow,336,2,11,3,6,29,21,8,36
Spart Moscow,336,3,9,5,6,37,30,7,32
Zenit,336,4,8,8,4,24,17,7,32
Krasnodar,336,5,9,4,7,30,27,3,31
Din Moscow,336,6,7,6,7,21,22,-1,27
Terek Grozny,336,7,7,5,8,20,25,-5,26
Amkar,336,8,6,4,10,13,22,-9,22
FK Rubin,336,9,5,5,10,22,21,1,20
Rostov,336,10,4,6,10,11,20,-9,18
Anzhi,336,11,3,5,12,16,39,-23,14
Loko Moscow,337,1,12,5,3,32,13,19,41
CSKA Moscow,337,2,12,3,5,32,19,13,39
Zenit,337,3,8,8,4,23,15,8,32
Krasnodar,337,4,9,4,7,31,28,3,31
Spart Moscow,337,5,8,6,6,35,31,4,30
Terek Grozny,337,6,8,5,7,22,24,-2,29
Din Moscow,337,7,6,7,7,22,24,-2,25
Amkar,337,8,6,4,10,12,22,-10,22
FK Rubin,337,9,5,6,9,24,22,2,21
Rostov,337,10,4,7,9,11,18,-7,19
Anzhi,337,11,2,5,13,16,44,-28,11
Loko Moscow,338,1,11,5,4,31,16,15,38
CSKA Moscow,338,2,11,4,5,31,19,12,37
Spart Moscow,338,3,10,6,4,39,26,13,36
Zenit,338,4,8,9,3,24,15,9,33
Terek Grozny,338,5,9,5,6,26,24,2,32
Krasnodar,338,6,9,4,7,30,26,4,31
Din Moscow,338,7,6,6,8,19,25,-6,24
FK Rubin,338,8,6,5,9,23,19,4,23
Rostov,338,9,4,6,10,11,20,-9,18
Amkar,338,10,4,5,11,9,24,-15,17
Anzhi,338,11,2,5,13,17,46,-29,11
Loko Moscow,339,1,11,5,4,29,14,15,38
Zenit,339,2,9,8,3,24,13,11,35
Spart Moscow,339,3,10,5,5,37,29,8,35
Krasnodar,339,4,10,4,6,31,25,6,34
CSKA Moscow,339,5,10,3,7,26,21,5,33
Terek Grozny,339,6,7,6,7,20,23,-3,27
Din Moscow,339,7,6,7,7,21,22,-1,25
FK Rubin,339,8,5,6,9,23,20,3,21
Rostov,339,9,4,6,10,10,19,-9,18
Amkar,339,10,4,5,11,10,24,-14,17
Anzhi,339,11,4,5,11,17,38,-21,17
Loko Moscow,340,1,12,5,3,30,12,18,41
CSKA Moscow,340,2,12,3,5,28,17,11,39
Spart Moscow,340,3,11,5,4,42,27,15,38
Krasnodar,340,4,10,4,6,32,25,7,34
Zenit,340,5,7,8,5,21,16,5,29
Terek Grozny,340,6,8,5,7,24,25,-1,29
Din Moscow,340,7,6,6,8,20,26,-6,24
FK Rubin,340,8,5,5,10,22,22,0,20
Amkar,340,9,5,4,11,12,26,-14,19
Rostov,340,10,4,6,10,10,18,-8,18
Anzhi,340,11,2,5,13,14,41,-27,11
Loko Moscow,341,1,11,7,2,31,13,18,40
CSKA Moscow,341,2,12,3,5,31,19,12,39
Spart Moscow,341,3,10,5,5,38,27,11,35
Zenit,341,4,7,9,4,23,17,6,30
Krasnodar,341,5,8,5,7,29,28,1,29
Terek Grozny,341,6,7,6,7,21,24,-3,27
FK Rubin,341,7,7,5,8,25,18,7,26
Rostov,341,8,5,6,9,12,18,-6,21
Din Moscow,341,9,5,6,9,17,24,-7,21
Amkar,341,10,5,4,11,10,24,-14,19
Anzhi,341,11,2,6,12,16,41,-25,12
Loko Moscow,342,1,13,5,2,32,11,21,44
CSKA Moscow,342,2,11,3,6,28,20,8,36
Spart Moscow,342,3,10,5,5,37,27,10,35
Zenit,342,4,8,8,4,23,16,7,32
Krasnodar,342,5,8,5,7,29,27,2,29
Terek Grozny,342,6,7,6,7,21,24,-3,27
FK Rubin,342,7,6,6,8,26,19,7,24
Amkar,342,8,6,4,10,11,22,-11,22
Din Moscow,342,9,5,6,9,17,26,-9,21
Rostov,342,10,4,6,10,11,19,-8,18
Anzhi,342,11,2,6,12,16,40,-24,12
Loko Moscow,343,1,12,6,2,33,13,20,42
CSKA Moscow,343,2,11,4,5,27,17,10,37
Zenit,343,3,7,10,3,22,14,8,31
Krasnodar,343,4,9,4,7,29,27,2,31
Spart Moscow,343,5,8,6,6,35,34,1,30
Terek Grozny,343,6,7,5,8,20,26,-6,26
Din Moscow,343,7,5,8,7,21,25,-4,23
Amkar,343,8,6,4,10,16,22,-6,22
FK Rubin,343,9,5,6,9,23,20,3,21
Rostov,343,10,5,6,9,13,17,-4,21
Anzhi,343,11,3,5,12,15,39,-24,14
Loko Moscow,344,1,12,6,2,35,13,22,42
CSKA Moscow,344,2,12,3,5,29,18,11,39
Spart Moscow,344,3,10,6,4,36,26,10,36
Krasnodar,344,4,9,5,6,31,26,5,32
Terek Grozny,344,5,8,6,6,22,23,-1,30
Zenit,344,6,7,8,5,22,19,3,29
Din Moscow,344,7,6,6,8,18,22,-4,24
FK Rubin,344,8,5,5,10,22,21,1,20
Rostov,344,9,4,7,9,10,17,-7,19
Amkar,344,10,4,5,11,11,25,-14,17
Anzhi,344,11,2,5,13,15,41,-26,11
Loko Moscow,345,1,11,6,3,30,13,17,39
CSKA Moscow,345,2,11,3,6,31,20,11,36
Zenit,345,3,9,8,3,24,14,10,35
Krasnodar,345,4,9,5,6,30,26,4,32
Terek Grozny,345,5,9,5,6,23,22,1,32
Spart Moscow,345,6,8,7,5,36,29,7,31
Din Moscow,345,7,6,7,7,21,24,-3,25
FK Rubin,345,8,5,6,9,23,20,3,21
Rostov,345,9,4,7,9,11,18,-7,19
Amkar,345,10,4,5,11,9,24,-15,17
Anzhi,345,11,2,5,13,15,43,-28,11
Loko Moscow,346,1,13,5,2,31,11,20,44
Spart Moscow,346,2,11,5,4,39,25,14,38
CSKA Moscow,346,3,11,3,6,27,19,8,36
Zenit,346,4,8,8,4,23,15,8,32
Krasnodar,346,5,9,4,7,29,26,3,31
Terek Grozny,346,6,7,5,8,20,24,-4,26
FK Rubin,346,7,6,5,9,24,19,5,23
Din Moscow,346,8,5,6,9,17,26,-9,21
Amkar,346,9,5,4,11,10,23,-13,19
Rostov,346,10,4,6,10,10,19,-9,18
Anzhi,346,11,3,5,12,15,38,-23,14
Loko Moscow,347,1,11,5,4,29,16,13,38
CSKA Moscow,347,2,11,3,6,30,22,8,36
Zenit,347,3,9,8,3,29,13,16,35
Spart Moscow,347,4,9,6,5,37,29,8,33
Krasnodar,347,5,9,4,7,30,27,3,31
Terek Grozny,347,6,8,6,6,24,23,1,30
FK Rubin,347,7,6,6,8,25,20,5,24
Din Moscow,347,8,5,7,8,19,24,-5,22
Amkar,347,9,5,5,10,11,23,-12,20
Rostov,347,10,4,7,9,11,18,-7,19
Anzhi,347,11,2,5,13,16,46,-30,11
Loko Moscow,348,1,11,5,4,29,15,14,38
Krasnodar,348,2,10,4,6,31,24,7,34
CSKA Moscow,348,3,10,4,6,26,19,7,34
Zenit,348,4,8,9,3,23,14,9,33
Spart Moscow,348,5,9,6,5,37,29,8,33
Terek Grozny,348,6,9,5,6,24,24,0,32
Din Moscow,348,7,6,6,8,20,24,-4,24
FK Rubin,348,8,6,5,9,24,19,5,23
Rostov,348,9,4,6,10,10,19,-9,18
Amkar,348,10,4,5,11,12,26,-14,17
Anzhi,348,11,3,5,12,16,39,-23,14
Loko Moscow,349,1,11,5,4,29,13,16,38
CSKA Moscow,349,2,11,3,6,31,20,11,36
Zenit,349,3,9,8,3,23,13,10,35
Spart Moscow,349,4,9,7,4,38,27,11,34
Krasnodar,349,5,10,4,6,29,24,5,34
Terek Grozny,349,6,8,6,6,24,24,0,30
FK Rubin,349,7,6,5,9,24,18,6,23
Din Moscow,349,8,5,6,9,17,27,-10,21
Rostov,349,9,4,7,9,11,18,-7,19
Amkar,349,10,4,6,10,11,24,-13,18
Anzhi,349,11,2,5,13,17,46,-29,11
Loko Moscow,350,1,11,6,3,31,14,17,39
CSKA Moscow,350,2,11,3,6,26,18,8,36
Spart Moscow,350,3,10,5,5,37,29,8,35
Zenit,350,4,8,9,3,23,14,9,33
Krasnodar,350,5,9,5,6,29,25,4,32
Terek Grozny,350,6,7,6,7,21,26,-5,27
FK Rubin,350,7,6,6,8,23,18,5,24
Rostov,350,8,5,6,9,12,17,-5,21
Din Moscow,350,9,5,6,9,20,26,-6,21
Amkar,350,10,5,4,11,12,23,-11,19
Anzhi,350,11,2,6,12,15,39,-24,12
Loko Moscow,351,1,13,5,2,34,11,23,44
CSKA Moscow,351,2,11,3,6,29,18,11,36
Spart Moscow,351,3,9,6,5,41,30,11,33
Zenit,351,4,8,8,4,22,15,7,32
Terek Grozny,351,5,7,7,6,21,23,-2,28
Krasnodar,351,6,8,4,8,28,31,-3,28
FK Rubin,351,7,7,5,8,27,19,8,26
Din Moscow,351,8,6,6,8,20,24,-4,24
Rostov,351,9,4,7,9,12,19,-7,19
Amkar,351,10,4,5,11,10,27,-17,17
Anzhi,351,11,2,6,12,15,42,-27,12
Loko Moscow,352,1,11,6,3,31,14,17,39
CSKA Moscow,352,2,11,3,6,28,18,10,36
Zenit,352,3,8,9,3,23,14,9,33
Spart Moscow,352,4,9,5,6,38,34,4,32
Krasnodar,352,5,9,5,6,30,26,4,32
Terek Grozny,352,6,8,5,7,21,23,-2,29
Din Moscow,352,7,6,6,8,21,25,-4,24
FK Rubin,352,8,5,6,9,23,20,3,21
Rostov,352,9,5,6,9,13,17,-4,21
Amkar,352,10,5,4,11,13,25,-12,19
Anzhi,352,11,3,5,12,15,40,-25,14
Loko Moscow,353,1,12,6,2,32,13,19,42
Spart Moscow,353,2,11,5,4,44,27,17,38
CSKA Moscow,353,3,11,3,6,29,18,11,36
Zenit,353,4,8,8,4,22,14,8,32
Krasnodar,353,5,9,5,6,31,27,4,32
Terek Grozny,353,6,8,5,7,23,23,0,29
Din Moscow,353,7,6,6,8,22,27,-5,24
FK Rubin,353,8,5,5,10,23,23,0,20
Amkar,353,9,5,4,11,11,25,-14,19
Rostov,353,10,4,6,10,10,20,-10,18
Anzhi,353,11,2,5,13,14,44,-30,11
Loko Moscow,354,1,11,7,2,31,13,18,40
CSKA Moscow,354,2,12,3,5,31,18,13,39
Spart Moscow,354,3,9,7,4,40,30,10,34
Zenit,354,4,7,9,4,23,18,5,30
Krasnodar,354,5,8,6,6,29,26,3,30
Terek Grozny,354,6,8,6,6,25,22,3,30
Din Moscow,354,7,5,8,7,21,25,-4,23
FK Rubin,354,8,5,7,8,22,18,4,22
Rostov,354,9,4,6,10,10,19,-9,18
Amkar,354,10,4,6,10,10,23,-13,18
Anzhi,354,11,2,5,13,14,44,-30,11
Loko Moscow,355,1,11,5,4,31,18,13,38
CSKA Moscow,355,2,11,3,6,27,18,9,36
Zenit,355,3,9,8,3,25,15,10,35
Spart Moscow,355,4,9,6,5,36,28,8,33
Krasnodar,355,5,9,5,6,32,25,7,32
Terek Grozny,355,6,8,6,6,24,24,0,30
Din Moscow,355,7,6,7,7,19,22,-3,25
FK Rubin,355,8,5,6,9,23,20,3,21
Amkar,355,9,5,5,10,12,23,-11,20
Rostov,355,10,4,6,10,11,20,-9,18
Anzhi,355,11,2,5,13,15,42,-27,11
Loko Moscow,356,1,13,5,2,33,12,21,44
Spart Moscow,356,2,9,6,5,40,31,9,33
CSKA Moscow,356,3,10,3,7,25,21,4,33
Zenit,356,4,8,8,4,24,15,9,32
Terek Grozny,356,5,8,6,6,24,23,1,30
Krasnodar,356,6,8,5,7,29,27,2,29
Din Moscow,356,7,6,7,7,20,22,-2,25
FK Rubin,356,8,5,6,9,22,20,2,21
Rostov,356,9,5,6,9,13,19,-6,21
Amkar,356,10,4,4,12,11,29,-18,16
Anzhi,356,11,3,6,11,16,38,-22,15
Loko Moscow,357,1,13,5,2,33,13,20,44
CSKA Moscow,357,2,11,4,5,28,19,9,37
Spart Moscow,357,3,8,7,5,36,29,7,31
Zenit,357,4,7,9,4,23,16,7,30
Krasnodar,357,5,8,4,8,29,29,0,28
Terek Grozny,357,6,7,7,6,23,25,-2,28
FK Rubin,357,7,7,5,8,26,19,7,26
Din Moscow,357,8,5,7,8,19,24,-5,22
Amkar,357,9,5,5,10,14,26,-12,20
Rostov,357,10,4,7,9,11,18,-7,19
Anzhi,357,11,2,6,12,15,39,-24,12
Loko Moscow,358,1,11,5,4,30,14,16,38
Spart Moscow,358,2,11,5,4,38,26,12,38
CSKA Moscow,358,3,11,4,5,29,19,10,37
Krasnodar,358,4,10,4,6,31,25,6,34
Zenit,358,5,8,9,3,22,13,9,33
Terek Grozny,358,6,9,5,6,24,24,0,32
Din Moscow,358,7,6,6,8,20,23,-3,24
FK Rubin,358,8,5,5,10,21,21,0,20
Rostov,358,9,4,6,10,10,19,-9,18
Amkar,358,10,4,4,12,10,25,-15,16
Anzhi,358,11,2,5,13,17,43,-26,11
Loko Moscow,359,1,12,6,2,31,12,19,42
CSKA Moscow,359,2,11,3,6,27,18,9,36
Zenit,359,3,8,9,3,23,14,9,33
Spart Moscow,359,4,9,5,6,35,28,7,32
Krasnodar,359,5,9,4,7,28,25,3,31
Terek Grozny,359,6,7,6,7,22,25,-3,27
Din Moscow,359,7,6,7,7,20,23,-3,25
FK Rubin,359,8,5,6,9,22,19,3,21
Amkar,359,9,5,5,10,11,23,-12,20
Rostov,359,10,4,6,10,10,18,-8,18
Anzhi,359,11,3,5,12,16,40,-24,14
Loko Moscow,360,1,12,5,3,31,13,18,41
CSKA Moscow,360,2,11,4,5,28,19,9,37
Spart Moscow,360,3,9,5,6,36,29,7,32
Krasnodar,360,4,9,4,7,29,26,3,31
Zenit,360,5,7,9,4,22,15,7,30
Terek Grozny,360,6,8,5,7,25,26,-1,29
Din Moscow,360,7,7,6,7,23,22,1,27
FK Rubin,360,8,6,5,9,23,21,2,23
Amkar,360,9,6,4,10,13,24,-11,22
Rostov,360,10,4,6,10,11,20,-9,18
Anzhi,360,11,2,5,13,16,42,-26,11
Loko Moscow,361,1,12,6,2,31,12,19,42
CSKA Moscow,361,2,12,3,5,29,18,11,39
Spart Moscow,361,3,9,6,5,38,27,11,33
Krasnodar,361,4,8,6,6,27,24,3,30
Zenit,361,5,7,8,5,23,18,5,29
Terek Grozny,361,6,8,5,7,22,24,-2,29
Din Moscow,361,7,7,6,7,22,24,-2,27
FK Rubin,361,8,5,6,9,23,20,3,21
Rostov,361,9,4,6,10,10,21,-11,18
Amkar,361,10,4,5,11,9,24,-15,17
Anzhi,361,11,3,5,12,16,38,-22,14
Loko Moscow,362,1,13,5,2,33,12,21,44
Spart Moscow,362,2,10,6,4,41,28,13,36
CSKA Moscow,362,3,11,3,6,28,20,8,36
Zenit,362,4,8,8,4,24,16,8,32
Krasnodar,362,5,8,4,8,27,28,-1,28
Terek Grozny,362,6,7,6,7,20,23,-3,27
FK Rubin,362,7,7,5,8,24,17,7,26
Din Moscow,362,8,5,6,9,18,25,-7,21
Amkar,362,9,5,5,10,10,22,-12,20
Rostov,362,10,4,6,10,12,22,-10,18
Anzhi,362,11,2,6,12,15,39,-24,12
Loko Moscow,363,1,11,6,3,31,15,16,39
CSKA Moscow,363,2,11,4,5,26,17,9,37
Spart Moscow,363,3,10,5,5,40,27,13,35
Zenit,363,4,8,9,3,24,14,10,33
Terek Grozny,363,5,8,6,6,22,23,-1,30
Krasnodar,363,6,8,5,7,29,27,2,29
Din Moscow,363,7,6,6,8,18,25,-7,24
FK Rubin,363,8,6,5,9,23,19,4,23
Amkar,363,9,5,5,10,11,23,-12,20
Rostov,363,10,4,6,10,10,19,-9,18
Anzhi,363,11,2,5,13,15,40,-25,11
Loko Moscow,364,1,12,5,3,31,12,19,41
Spart Moscow,364,2,10,6,4,36,25,11,36
CSKA Moscow,364,3,11,3,6,27,19,8,36
Zenit,364,4,9,8,3,24,13,11,35
Terek Grozny,364,5,8,6,6,22,23,-1,30
Krasnodar,364,6,8,5,7,27,26,1,29
Din Moscow,364,7,6,6,8,18,22,-4,24
FK Rubin,364,8,5,6,9,21,18,3,21
Rostov,364,9,4,6,10,10,19,-9,18
Amkar,364,10,4,6,10,9,22,-13,18
Anzhi,364,11,2,5,13,15,41,-26,11
Loko Moscow,365,1,12,5,3,31,13,18,41
CSKA Moscow,365,2,11,4,5,29,19,10,37
Krasnodar,365,3,10,4,6,33,25,8,34
Spart Moscow,365,4,9,6,5,40,28,12,33
Zenit,365,5,7,9,4,22,15,7,30
Terek Grozny,365,6,7,7,6,23,25,-2,28
Din Moscow,365,7,6,7,7,19,22,-3,25
FK Rubin,365,8,5,5,10,21,22,-1,20
Amkar,365,9,5,5,10,13,25,-12,20
Rostov,365,10,4,6,10,10,22,-12,18
Anzhi,365,11,2,6,12,16,41,-25,12
Loko Moscow,366,1,12,5,3,30,12,18,41
CSKA Moscow,366,2,10,5,5,27,19,8,35
Spart Moscow,366,3,9,7,4,37,28,9,34
Zenit,366,4,8,9,3,23,14,9,33
Krasnodar,366,5,9,4,7,29,25,4,31
Terek Grozny,366,6,8,5,7,21,24,-3,29
Din Moscow,366,7,6,7,7,22,23,-1,25
FK Rubin,366,8,5,5,10,21,22,-1,20
Rostov,366,9,4,7,9,10,17,-7,19
Amkar,366,10,4,4,12,10,25,-15,16
Anzhi,366,11,3,6,11,17,38,-21,15
Loko Moscow,367,1,12,6,2,32,12,20,42
CSKA Moscow,367,2,10,4,6,27,20,7,34
Zenit,367,3,7,10,3,24,16,8,31
Spart Moscow,367,4,8,7,5,36,31,5,31
Krasnodar,367,5,8,5,7,28,27,1,29
Terek Grozny,367,6,7,5,8,22,26,-4,26
Din Moscow,367,7,5,8,7,19,23,-4,23
FK Rubin,367,8,5,7,8,23,19,4,22
Amkar,367,9,6,4,10,15,24,-9,22
Rostov,367,10,4,7,9,11,18,-7,19
Anzhi,367,11,4,5,11,17,38,-21,17
Loko Moscow,368,1,11,5,4,29,14,15,38
Spart Moscow,368,2,10,6,4,42,27,15,36
Zenit,368,3,9,8,3,23,13,10,35
CSKA Moscow,368,4,10,3,7,26,20,6,33
Krasnodar,368,5,9,5,6,30,25,5,32
Terek Grozny,368,6,7,7,6,21,23,-2,28
Din Moscow,368,7,5,8,7,17,21,-4,23
FK Rubin,368,8,5,7,8,22,18,4,22
Rostov,368,9,4,6,10,11,23,-12,18
Amkar,368,10,4,5,11,10,25,-15,17
Anzhi,368,11,3,6,11,17,39,-22,15
Loko Moscow,369,1,11,6,3,29,13,16,39
CSKA Moscow,369,2,12,3,5,31,20,11,39
Zenit,369,3,8,8,4,25,16,9,32
Spart Moscow,369,4,8,6,6,36,30,6,30
Krasnodar,369,5,8,5,7,28,26,2,29
Terek Grozny,369,6,7,5,8,22,27,-5,26
FK Rubin,369,7,6,6,8,23,18,5,24
Din Moscow,369,8,5,8,7,19,23,-4,23
Amkar,369,9,6,4,10,13,23,-10,22
Rostov,369,10,5,6,9,12,18,-6,21
Anzhi,369,11,3,5,12,17,41,-24,14
Loko Moscow,370,1,13,5,2,32,12,20,44
CSKA Moscow,370,2,11,3,6,30,22,8,36
Spart Moscow,370,3,9,6,5,36,28,8,33
Zenit,370,4,8,8,4,24,15,9,32
Krasnodar,370,5,8,5,7,28,26,2,29
Terek Grozny,370,6,7,5,8,20,25,-5,26
FK Rubin,370,7,6,6,8,22,17,5,24
Din Moscow,370,8,6,6,8,20,23,-3,24
Rostov,370,9,4,7,9,10,17,-7,19
Amkar,370,10,5,4,11,11,24,-13,19
Anzhi,370,11,3,5,12,17,41,-24,14
Loko Moscow,371,1,12,6,2,31,12,19,42
Spart Moscow,371,2,11,5,4,42,29,13,38
CSKA Moscow,371,3,11,3,6,31,19,12,36
Zenit,371,4,8,8,4,23,14,9,32
Krasnodar,371,5,9,5,6,30,26,4,32
Terek Grozny,371,6,8,5,7,21,23,-2,29
Din Moscow,371,7,6,6,8,21,25,-4,24
FK Rubin,371,8,5,5,10,23,21,2,20
Rostov,371,9,4,6,10,12,20,-8,18
Amkar,371,10,4,4,12,9,26,-17,16
Anzhi,371,11,3,5,12,15,43,-28,14
Loko Moscow,372,1,12,5,3,32,13,19,41
CSKA Moscow,372,2,12,3,5,28,18,10,39
Spart Moscow,372,3,10,5,5,37,29,8,35
Krasnodar,372,4,10,4,6,31,24,7,34
Zenit,372,5,7,8,5,21,17,4,29
Terek Grozny,372,6,7,7,6,21,23,-2,28
Din Moscow,372,7,5,7,8,20,25,-5,22
FK Rubin,372,8,5,6,9,23,21,2,21
Amkar,372,9,5,5,10,11,22,-11,20
Rostov,372,10,4,6,10,11,19,-8,18
Anzhi,372,11,2,6,12,16,40,-24,12
Loko Moscow,373,1,12,5,3,32,15,17,41
Spart Moscow,373,2,10,6,4,40,26,14,36
CSKA Moscow,373,3,11,3,6,27,20,7,36
Zenit,373,4,9,8,3,28,15,13,35
Terek Grozny,373,5,8,5,7,22,25,-3,29
Krasnodar,373,6,8,4,8,27,26,1,28
Din Moscow,373,7,6,6,8,19,25,-6,24
FK Rubin,373,8,6,5,9,22,18,4,23
Amkar,373,9,5,5,10,12,23,-11,20
Rostov,373,10,4,6,10,10,20,-10,18
Anzhi,373,11,2,5,13,14,40,-26,11
Loko Moscow,374,1,12,5,3,34,17,17,41
Zenit,374,2,9,8,3,26,14,12,35
CSKA Moscow,374,3,10,4,6,27,21,6,34
Spart Moscow,374,4,9,6,5,35,27,8,33
Terek Grozny,374,5,9,5,6,25,24,1,32
Krasnodar,374,6,8,4,8,30,29,1,28
FK Rubin,374,7,7,5,8,23,17,6,26
Din Moscow,374,8,5,7,8,18,23,-5,22
Rostov,374,9,5,6,9,11,17,-6,21
Amkar,374,10,4,4,12,10,26,-16,16
Anzhi,374,11,2,6,12,17,41,-24,12
Loko Moscow,375,1,12,6,2,30,11,19,42
CSKA Moscow,375,2,12,3,5,28,17,11,39
Krasnodar,375,3,9,4,7,28,25,3,31
Zenit,375,4,7,9,4,21,14,7,30
Spart Moscow,375,5,8,5,7,34,30,4,29
Terek Grozny,375,6,8,5,7,22,24,-2,29
Din Moscow,375,7,6,7,7,19,22,-3,25
Amkar,375,8,6,4,10,12,22,-10,22
FK Rubin,375,9,5,6,9,22,19,3,21
Rostov,375,10,5,6,9,12,18,-6,21
Anzhi,375,11,2,5,13,15,41,-26,11
Loko Moscow,376,1,11,5,4,29,13,16,38
CSKA Moscow,376,2,11,3,6,27,18,9,36
Zenit,376,3,9,8,3,23,13,10,35
Krasnodar,376,4,10,4,6,30,25,5,34
Spart Moscow,376,5,9,6,5,35,27,8,33
Terek Grozny,376,6,8,5,7,25,27,-2,29
Din Moscow,376,7,5,7,8,18,23,-5,22
Amkar,376,8,6,4,10,12,22,-10,22
FK Rubin,376,9,5,6,9,22,19,3,21
Rostov,376,10,4,7,9,10,17,-7,19
Anzhi,376,11,2,5,13,17,44,-27,11
Loko Moscow,377,1,12,5,3,30,12,18,41
CSKA Moscow,377,2,11,4,5,27,17,10,37
Krasnodar,377,3,10,4,6,29,24,5,34
Spart Moscow,377,4,9,6,5,39,30,9,33
Zenit,377,5,7,9,4,21,14,7,30
Terek Grozny,377,6,7,6,7,20,26,-6,27
FK Rubin,377,7,6,5,9,23,19,4,23
Rostov,377,8,5,6,9,11,17,-6,21
Din Moscow,377,9,5,6,9,20,27,-7,21
Amkar,377,10,4,6,10,11,24,-13,18
Anzhi,377,11,3,5,12,18,39,-21,14
Loko Moscow,378,1,11,5,4,29,13,16,38
Spart Moscow,378,2,10,6,4,37,27,10,36
CSKA Moscow,378,3,11,3,6,30,21,9,36
Zenit,378,4,9,8,3,26,15,11,35
Krasnodar,378,5,9,5,6,28,24,4,32
Terek Grozny,378,6,7,6,7,20,24,-4,27
Din Moscow,378,7,6,6,8,18,22,-4,24
FK Rubin,378,8,5,6,9,21,18,3,21
Rostov,378,9,4,7,9,12,19,-7,19
Amkar,378,10,4,5,11,9,23,-14,17
Anzhi,378,11,3,5,12,16,40,-24,14
Loko Moscow,379,1,12,5,3,32,14,18,41
CSKA Moscow,379,2,11,3,6,28,20,8,36
Krasnodar,379,3,10,4,6,31,26,5,34
Zenit,379,4,8,8,4,23,14,9,32
Spart Moscow,379,5,9,5,6,37,33,4,32
Din Moscow,379,6,7,6,7,20,21,-1,27
Terek Grozny,379,7,7,6,7,21,24,-3,27
Amkar,379,8,6,4,10,14,23,-9,22
FK Rubin,379,9,5,5,10,21,19,2,20
Rostov,379,10,4,6,10,12,20,-8,18
Anzhi,379,11,2,6,12,16,41,-25,12
Loko Moscow,380,1,11,6,3,31,14,17,39
Spart Moscow,380,2,11,5,4,40,25,15,38
CSKA Moscow,380,3,11,3,6,28,19,9,36
Zenit,380,4,9,8,3,24,14,10,35
Krasnodar,380,5,9,5,6,30,26,4,32
Terek Grozny,380,6,8,5,7,23,24,-1,29
Din Moscow,380,7,5,7,8,18,25,-7,22
FK Rubin,380,8,5,6,9,23,20,3,21
Rostov,380,9,4,6,10,10,19,-9,18
Amkar,380,10,4,4,12,9,26,-17,16
Anzhi,380,11,3,5,12,17,41,-24,14
Loko Moscow,381,1,12,6,2,33,14,19,42
CSKA Moscow,381,2,11,4,5,28,17,11,37
Spart Moscow,381,3,10,5,5,40,29,11,35
Zenit,381,4,7,10,3,23,15,8,31
Krasnodar,381,5,9,4,7,34,27,7,31
Terek Grozny,381,6,8,6,6,21,22,-1,30
Din Moscow,381,7,6,6,8,20,23,-3,24
FK Rubin,381,8,6,5,9,24,23,1,23
Rostov,381,9,4,6,10,11,23,-12,18
Amkar,381,10,4,4,12,9,24,-15,16
Anzhi,381,11,2,6,12,14,40,-26,12
Loko Moscow,382,1,13,5,2,33,12,21,44
CSKA Moscow,382,2,11,4,5,29,20,9,37
Spart Moscow,382,3,9,7,4,34,25,9,34
Zenit,382,4,7,9,4,25,19,6,30
Terek Grozny,382,5,8,6,6,22,23,-1,30
Krasnodar,382,6,8,4,8,28,27,1,28
Din Moscow,382,7,6,7,7,18,21,-3,25
FK Rubin,382,8,6,5,9,23,19,4,23
Rostov,382,9,4,6,10,10,18,-8,18
Amkar,382,10,4,6,10,10,23,-13,18
Anzhi,382,11,2,5,13,14,39,-25,11
Loko Moscow,383,1,12,6,2,30,11,19,42
Spart Moscow,383,2,10,6,4,39,28,11,36
Zenit,383,3,8,9,3,22,13,9,33
CSKA Moscow,383,4,10,3,7,27,21,6,33
Krasnodar,383,5,9,4,7,29,26,3,31
Terek Grozny,383,6,7,6,7,21,24,-3,27
Din Moscow,383,7,5,7,8,18,24,-6,22
FK Rubin,383,8,5,6,9,23,20,3,21
Rostov,383,9,4,7,9,12,19,-7,19
Amkar,383,10,5,4,11,11,24,-13,19
Anzhi,383,11,3,6,11,18,40,-22,15
Loko Moscow,384,1,13,5,2,31,11,20,44
CSKA Moscow,384,2,12,3,5,29,17,12,39
Spart Moscow,384,3,8,7,5,36,29,7,31
Krasnodar,384,4,9,4,7,29,25,4,31
Zenit,384,5,7,8,5,21,15,6,29
Terek Grozny,384,6,7,6,7,22,25,-3,27
Din Moscow,384,7,5,8,7,19,23,-4,23
FK Rubin,384,8,5,6,9,22,20,2,21
Rostov,384,9,5,6,9,11,17,-6,21
Amkar,384,10,4,6,10,13,26,-13,18
Anzhi,384,11,3,5,12,15,40,-25,14
CSKA Moscow,385,1,12,3,5,29,19,10,39
Spart Moscow,385,2,11,5,4,43,26,17,38
Loko Moscow,385,3,11,5,4,30,15,15,38
Krasnodar,385,4,10,4,6,31,24,7,34
Zenit,385,5,8,8,4,23,15,8,32
Terek Grozny,385,6,8,6,6,22,23,-1,30
Din Moscow,385,7,5,7,8,18,26,-8,22
FK Rubin,385,8,5,6,9,21,19,2,21
Rostov,385,9,4,6,10,10,19,-9,18
Amkar,385,10,4,5,11,10,26,-16,17
Anzhi,385,11,2,5,13,16,41,-25,11
Loko Moscow,386,1,11,6,3,30,16,14,39
CSKA Moscow,386,2,12,3,5,30,17,13,39
Spart Moscow,386,3,9,6,5,39,30,9,33
Zenit,386,4,8,8,4,25,14,11,32
Krasnodar,386,5,8,6,6,29,26,3,30
Terek Grozny,386,6,8,5,7,21,24,-3,29
FK Rubin,386,7,6,6,8,23,18,5,24
Rostov,386,8,5,6,9,13,18,-5,21
Din Moscow,386,9,5,6,9,18,26,-8,21
Amkar,386,10,4,5,11,10,24,-14,17
Anzhi,386,11,3,5,12,16,41,-25,14
Loko Moscow,387,1,12,5,3,34,12,22,41
CSKA Moscow,387,2,11,3,6,31,19,12,36
Spart Moscow,387,3,10,5,5,41,29,12,35
Krasnodar,387,4,10,4,6,31,25,6,34
Zenit,387,5,8,8,4,23,19,4,32
Terek Grozny,387,6,8,5,7,24,26,-2,29
Din Moscow,387,7,7,6,7,21,23,-2,27
FK Rubin,387,8,5,5,10,22,21,1,20
Amkar,387,9,5,4,11,11,25,-14,19
Rostov,387,10,4,6,10,11,20,-9,18
Anzhi,387,11,2,5,13,16,46,-30,11
Loko Moscow,388,1,13,5,2,33,13,20,44
CSKA Moscow,388,2,11,3,6,29,19,10,36
Zenit,388,3,8,8,4,25,17,8,32
Spart Moscow,388,4,8,6,6,33,28,5,30
Krasnodar,388,5,8,5,7,27,25,2,29
Terek Grozny,388,6,7,6,7,22,26,-4,27
Din Moscow,388,7,6,7,7,19,21,-2,25
FK Rubin,388,8,5,7,8,21,17,4,22
Amkar,388,9,6,4,10,13,23,-10,22
Rostov,388,10,4,7,9,10,17,-7,19
Anzhi,388,11,2,6,12,15,41,-26,12
Loko Moscow,389,1,11,6,3,31,14,17,39
CSKA Moscow,389,2,11,3,6,27,19,8,36
Spart Moscow,389,3,10,5,5,38,28,10,35
Zenit,389,4,8,8,4,23,15,8,32
Terek Grozny,389,5,9,5,6,25,25,0,32
Krasnodar,389,6,8,5,7,29,27,2,29
Din Moscow,389,7,7,6,7,21,22,-1,27
FK Rubin,389,8,6,5,9,23,20,3,23
Rostov,389,9,4,6,10,10,18,-8,18
Amkar,389,10,4,4,12,12,28,-16,16
Anzhi,389,11,3,5,12,17,40,-23,14
Loko Moscow,390,1,12,6,2,32,12,20,42
CSKA Moscow,390,2,11,3,6,28,20,8,36
Spart Moscow,390,3,10,5,5,38,26,12,35
Zenit,390,4,8,8,4,24,16,8,32
Krasnodar,390,5,8,5,7,28,26,2,29
Terek Grozny,390,6,7,6,7,22,26,-4,27
FK Rubin,390,7,7,5,8,24,18,6,26
Din Moscow,390,8,5,6,9,17,26,-9,21
Amkar,390,9,5,5,10,12,24,-12,20
Rostov,390,10,4,6,10,10,18,-8,18
Anzhi,390,11,3,5,12,17,40,-23,14
Loko Moscow,391,1,11,6,3,30,15,15,39
CSKA Moscow,391,2,12,3,5,28,18,10,39
Spart Moscow,391,3,9,5,6,37,29,8,32
Krasnodar,391,4,9,5,6,31,25,6,32
Zenit,391,5,7,9,4,22,15,7,30
Din Moscow,391,6,7,6,7,21,23,-2,27
Terek Grozny,391,7,7,6,7,22,25,-3,27
FK Rubin,391,8,5,6,9,23,20,3,21
Amkar,391,9,5,5,10,13,25,-12,20
Rostov,391,10,4,6,10,10,19,-9,18
Anzhi,391,11,3,5,12,16,39,-23,14
Loko Moscow,392,1,12,5,3,31,13,18,41
CSKA Moscow,392,2,12,3,5,28,17,11,39
Krasnodar,392,3,10,4,6,32,27,5,34
Spart Moscow,392,4,9,5,6,37,29,8,32
Zenit,392,5,7,8,5,21,15,6,29
Terek Grozny,392,6,7,6,7,21,24,-3,27
Din Moscow,392,7,6,6,8,21,24,-3,24
FK Rubin,392,8,6,5,9,25,21,4,23
Rostov,392,9,5,6,9,11,17,-6,21
Amkar,392,10,5,4,11,11,26,-15,19
Anzhi,392,11,2,6,12,14,39,-25,12
Loko Moscow,393,1,12,6,2,30,11,19,42
CSKA Moscow,393,2,12,3,5,30,20,10,39
Spart Moscow,393,3,11,5,4,42,27,15,38
Krasnodar,393,4,9,5,6,29,25,4,32
Zenit,393,5,7,8,5,23,17,6,29
Terek Grozny,393,6,7,6,7,20,24,-4,27
Din Moscow,393,7,5,7,8,18,25,-7,22
FK Rubin,393,8,5,6,9,23,20,3,21
Rostov,393,9,4,6,10,11,20,-9,18
Amkar,393,10,4,5,11,10,25,-15,17
Anzhi,393,11,3,5,12,17,39,-22,14
Loko Moscow,394,1,12,6,2,32,12,20,42
Spart Moscow,394,2,11,5,4,39,26,13,38
CSKA Moscow,394,3,10,5,5,27,19,8,35
Zenit,394,4,7,10,3,22,14,8,31
Krasnodar,394,5,9,4,7,30,27,3,31
Terek Grozny,394,6,7,6,7,20,26,-6,27
Din Moscow,394,7,6,6,8,19,23,-4,24
FK Rubin,394,8,5,5,10,21,20,1,20
Rostov,394,9,4,6,10,10,19,-9,18
Amkar,394,10,4,5,11,9,24,-15,17
Anzhi,394,11,3,6,11,19,38,-19,15
CSKA Moscow,395,1,12,3,5,31,17,14,39
Loko Moscow,395,2,11,5,4,30,14,16,38
Krasnodar,395,3,10,4,6,30,24,6,34
Spart Moscow,395,4,9,6,5,41,28,13,33
Zenit,395,5,8,8,4,23,16,7,32
Terek Grozny,395,6,7,5,8,21,25,-4,26
Din Moscow,395,7,6,7,7,18,21,-3,25
Rostov,395,8,5,6,9,13,18,-5,21
FK Rubin,395,9,5,5,10,21,20,1,20
Amkar,395,10,5,4,11,10,29,-19,19
Anzhi,395,11,3,5,12,16,42,-26,14
Loko Moscow,396,1,12,5,3,30,13,17,41
CSKA Moscow,396,2,11,3,6,29,19,10,36
Spart Moscow,396,3,9,7,4,39,30,9,34
Krasnodar,396,4,10,4,6,31,24,7,34
Zenit,396,5,8,8,4,23,14,9,32
Terek Grozny,396,6,7,6,7,21,26,-5,27
Din Moscow,396,7,5,8,7,20,24,-4,23
FK Rubin,396,8,5,6,9,23,21,2,21
Amkar,396,9,5,5,10,14,24,-10,20
Rostov,396,10,4,6,10,12,20,-8,18
Anzhi,396,11,2,6,12,15,42,-27,12
Loko Moscow,397,1,12,6,2,34,13,21,42
CSKA Moscow,397,2,11,3,6,27,19,8,36
Spart Moscow,397,3,10,5,5,38,26,12,35
Zenit,397,4,8,9,3,25,16,9,33
Terek Grozny,397,5,9,5,6,23,22,1,32
Krasnodar,397,6,8,5,7,27,27,0,29
FK Rubin,397,7,6,6,8,23,18,5,24
Rostov,397,8,5,6,9,11,17,-6,21
Din Moscow,397,9,5,6,9,18,27,-9,21
Amkar,397,10,4,4,12,9,24,-15,16
Anzhi,397,11,2,5,13,14,40,-26,11
Loko Moscow,398,1,11,7,2,32,14,18,40
CSKA Moscow,398,2,11,3,6,30,19,11,36
Zenit,398,3,8,9,3,24,15,9,33
Spart Moscow,398,4,8,7,5,38,31,7,31
Krasnodar,398,5,8,6,6,30,27,3,30
Terek Grozny,398,6,7,5,8,21,29,-8,26
Din Moscow,398,7,6,7,7,20,23,-3,25
FK Rubin,398,8,5,6,9,22,19,3,21
Rostov,398,9,5,6,9,13,19,-6,21
Amkar,398,10,5,5,10,13,23,-10,20
Anzhi,398,11,3,5,12,18,42,-24,14
Loko Moscow,399,1,12,5,3,33,14,19,41
CSKA Moscow,399,2,12,3,5,29,19,10,39
Spart Moscow,399,3,10,5,5,40,32,8,35
Krasnodar,399,4,9,5,6,30,25,5,32
Terek Grozny,399,5,8,6,6,22,23,-1,30
Zenit,399,6,7,8,5,22,18,4,29
Din Moscow,399,7,6,6,8,19,23,-4,24
FK Rubin,399,8,5,6,9,21,18,3,21
Amkar,399,9,5,5,10,14,24,-10,20
Rostov,399,10,4,6,10,12,21,-9,18
Anzhi,399,11,2,5,13,15,40,-25,11
Loko Moscow,400,1,12,5,3,31,12,19,41
CSKA Moscow,400,2,12,3,5,29,17,12,39
Spart Moscow,400,3,9,7,4,36,27,9,34
Krasnodar,400,4,10,4,6,29,24,5,34
Terek Grozny,400,5,9,5,6,23,23,0,32
Zenit,400,6,7,8,5,21,16,5,29
FK Rubin,400,7,6,5,9,24,18,6,23
Din Moscow,400,8,5,7,8,18,25,-7,22
Rostov,400,9,4,6,10,11,19,-8,18
Amkar,400,10,4,5,11,9,23,-14,17
Anzhi,400,11,2,5,13,15,42,-27,11
Loko Moscow,401,1,12,5,3,32,14,18,41
Spart Moscow,401,2,11,5,4,39,27,12,38
CSKA Moscow,401,3,11,4,5,27,18,9,37
Krasnodar,401,4,9,5,6,29,25,4,32
Zenit,401,5,7,8,5,22,16,6,29
Terek Grozny,401,6,8,5,7,22,25,-3,29
FK Rubin,401,7,5,7,8,21,17,4,22
Din Moscow,401,8,5,7,8,18,24,-6,22
Amkar,401,9,5,4,11,13,25,-12,19
Rostov,401,10,4,6,10,10,18,-8,18
Anzhi,401,11,2,6,12,15,39,-24,12
Loko Moscow,402,1,12,5,3,31,13,18,41
CSKA Moscow,402,2,11,4,5,26,17,9,37
Krasnodar,402,3,10,4,6,32,25,7,34
Spart Moscow,402,4,9,6,5,36,28,8,33
Zenit,402,5,7,9,4,21,14,7,30
Terek Grozny,402,6,7,7,6,22,24,-2,28
Din Moscow,402,7,6,6,8,19,22,-3,24
FK Rubin,402,8,6,5,9,22,20,2,23
Rostov,402,9,4,7,9,10,17,-7,19
Amkar,402,10,4,5,11,11,26,-15,17
Anzhi,402,11,2,6,12,15,39,-24,12
Loko Moscow,403,1,12,6,2,35,14,21,42
CSKA Moscow,403,2,11,4,5,27,18,9,37
Spart Moscow,403,3,9,5,6,37,30,7,32
Krasnodar,403,4,9,5,6,31,27,4,32
Zenit,403,5,7,9,4,22,17,5,30
Terek Grozny,403,6,8,5,7,22,25,-3,29
FK Rubin,403,7,6,5,9,22,18,4,23
Amkar,403,8,6,4,10,14,24,-10,22
Din Moscow,403,9,5,6,9,17,23,-6,21
Rostov,403,10,5,6,9,12,18,-6,21
Anzhi,403,11,2,5,13,15,40,-25,11
Loko Moscow,404,1,13,5,2,34,12,22,44
Spart Moscow,404,2,11,5,4,41,27,14,38
CSKA Moscow,404,3,11,4,5,28,19,9,37
Zenit,404,4,7,9,4,23,18,5,30
Terek Grozny,404,5,8,6,6,25,23,2,30
Krasnodar,404,6,8,5,7,27,25,2,29
FK Rubin,404,7,6,6,8,22,17,5,24
Din Moscow,404,8,5,6,9,18,25,-7,21
Rostov,404,9,4,6,10,11,21,-10,18
Amkar,404,10,4,5,11,10,24,-14,17
Anzhi,404,11,2,5,13,15,43,-28,11
Loko Moscow,405,1,12,5,3,34,16,18,41
CSKA Moscow,405,2,11,4,5,26,17,9,37
Spart Moscow,405,3,10,5,5,37,26,11,35
Krasnodar,405,4,10,4,6,33,24,9,34
Terek Grozny,405,5,9,5,6,29,25,4,32
Zenit,405,6,7,8,5,23,19,4,29
Din Moscow,405,7,6,6,8,19,23,-4,24
FK Rubin,405,8,6,5,9,23,21,2,23
Rostov,405,9,4,6,10,10,19,-9,18
Amkar,405,10,4,4,12,10,29,-19,16
Anzhi,405,11,2,6,12,16,41,-25,12
Loko Moscow,406,1,11,6,3,30,14,16,39
CSKA Moscow,406,2,11,3,6,27,18,9,36
Zenit,406,3,9,8,3,24,13,11,35
Spart Moscow,406,4,9,5,6,38,31,7,32
Krasnodar,406,5,8,5,7,28,29,-1,29
Terek Grozny,406,6,7,7,6,21,23,-2,28
FK Rubin,406,7,6,6,8,25,17,8,24
Din Moscow,406,8,5,7,8,17,24,-7,22
Rostov,406,9,5,6,9,13,18,-5,21
Amkar,406,10,5,5,10,13,24,-11,20
Anzhi,406,11,2,6,12,14,39,-25,12
Loko Moscow,407,1,12,6,2,34,12,22,42
Spart Moscow,407,2,11,5,4,39,25,14,38
CSKA Moscow,407,3,10,3,7,28,22,6,33
Zenit,407,4,8,8,4,24,19,5,32
Krasnodar,407,5,9,5,6,30,26,4,32
Terek Grozny,407,6,7,6,7,22,25,-3,27
FK Rubin,407,7,6,5,9,23,19,4,23
Din Moscow,407,8,5,6,9,17,24,-7,21
Amkar,407,9,5,4,11,10,23,-13,19
Rostov,407,10,4,6,10,10,20,-10,18
Anzhi,407,11,3,6,11,18,40,-22,15
Loko Moscow,408,1,12,5,3,32,13,19,41
Spart Moscow,408,2,11,5,4,46,30,16,38
CSKA Moscow,408,3,11,3,6,29,20,9,36
Zenit,408,4,9,8,3,25,15,10,35
Terek Grozny,408,5,8,5,7,21,23,-2,29
Krasnodar,408,6,8,4,8,28,28,0,28
FK Rubin,408,7,6,6,8,23,18,5,24
Din Moscow,408,8,5,7,8,19,24,-5,22
Rostov,408,9,4,6,10,10,23,-13,18
Amkar,408,10,4,4,12,12,27,-15,16
Anzhi,408,11,3,5,12,16,40,-24,14
Loko Moscow,409,1,12,6,2,34,12,22,42
Spart Moscow,409,2,11,5,4,38,26,12,38
CSKA Moscow,409,3,11,3,6,29,19,10,36
Zenit,409,4,8,8,4,23,17,6,32
Terek Grozny,409,5,9,5,6,24,23,1,32
Krasnodar,409,6,8,5,7,29,27,2,29
FK Rubin,409,7,6,6,8,24,19,5,24
Din Moscow,409,8,5,7,8,18,24,-6,22
Rostov,409,9,4,6,10,10,18,-8,18
Amkar,409,10,4,4,12,11,26,-15,16
Anzhi,409,11,2,5,13,14,43,-29,11
Loko Moscow,410,1,11,5,4,30,14,16,38
CSKA Moscow,410,2,11,4,5,28,19,9,37
Krasnodar,410,3,10,4,6,30,25,5,34
Zenit,410,4,8,9,3,25,16,9,33
Spart Moscow,410,5,9,5,6,39,30,9,32
Terek Grozny,410,6,7,5,8,22,26,-4,26
Din Moscow,410,7,5,7,8,19,27,-8,22
Amkar,410,8,6,4,10,12,23,-11,22
FK Rubin,410,9,5,6,9,24,21,3,21
Rostov,410,10,5,6,9,13,18,-5,21
Anzhi,410,11,3,5,12,17,40,-23,14
Loko Moscow,411,1,11,7,2,31,13,18,40
CSKA Moscow,411,2,12,3,5,31,19,12,39
Spart Moscow,411,3,9,7,4,37,26,11,34
Zenit,411,4,7,9,4,22,17,5,30
Krasnodar,411,5,8,5,7,28,26,2,29
Terek Grozny,411,6,7,5,8,21,25,-4,26
Din Moscow,411,7,6,7,7,20,22,-2,25
FK Rubin,411,8,6,5,9,22,19,3,23
Amkar,411,9,5,5,10,11,23,-12,20
Rostov,411,10,4,6,10,10,20,-10,18
Anzhi,411,11,3,5,12,17,40,-23,14
Loko Moscow,412,1,12,5,3,32,12,20,41
CSKA Moscow,412,2,12,3,5,31,19,12,39
Krasnodar,412,3,10,4,6,30,24,6,34
Spart Moscow,412,4,8,6,6,35,30,5,30
Zenit,412,5,7,8,5,23,19,4,29
Terek Grozny,412,6,7,6,7,24,27,-3,27
Din Moscow,412,7,6,7,7,19,22,-3,25
Rostov,412,8,5,6,9,12,17,-5,21
FK Rubin,412,9,5,5,10,21,20,1,20
Amkar,412,10,5,5,10,14,26,-12,20
Anzhi,412,11,3,5,12,16,41,-25,14
Loko Moscow,413,1,12,5,3,35,13,22,41
CSKA Moscow,413,2,11,4,5,29,18,11,37
Spart Moscow,413,3,10,6,4,39,25,14,36
Krasnodar,413,4,10,4,6,33,24,9,34
Terek Grozny,413,5,9,5,6,24,23,1,32
Zenit,413,6,7,9,4,22,20,2,30
Din Moscow,413,7,6,6,8,19,24,-5,24
FK Rubin,413,8,5,5,10,21,23,-2,20
Rostov,413,9,4,6,10,10,20,-10,18
Amkar,413,10,4,5,11,9,24,-15,17
Anzhi,413,11,2,5,13,15,42,-27,11
Loko Moscow,414,1,12,6,2,34,14,20,42
CSKA Moscow,414,2,11,4,5,29,20,9,37
Spart Moscow,414,3,10,6,4,39,26,13,36
Zenit,414,4,7,9,4,24,18,6,30
Krasnodar,414,5,8,5,7,31,29,2,29
Terek Grozny,414,6,8,5,7,21,24,-3,29
Din Moscow,414,7,6,6,8,20,25,-5,24
FK Rubin,414,8,6,5,9,24,22,2,23
Rostov,414,9,4,7,9,11,18,-7,19
Amkar,414,10,5,4,11,11,23,-12,19
Anzhi,414,11,2,5,13,15,40,-25,11
Loko Moscow,415,1,12,6,2,32,13,19,42
CSKA Moscow,415,2,12,3,5,29,18,11,39
Krasnodar,415,3,9,5,6,31,26,5,32
Spart Moscow,415,4,8,6,6,34,28,6,30
Zenit,415,5,7,8,5,22,17,5,29
Din Moscow,415,6,7,6,7,20,22,-2,27
Terek Grozny,415,7,7,6,7,20,24,-4,27
Rostov,415,8,5,6,9,11,17,-6,21
FK Rubin,415,9,5,5,10,21,20,1,20
Amkar,415,10,5,5,10,11,22,-11,20
Anzhi,415,11,2,6,12,14,38,-24,12
Loko Moscow,416,1,12,6,2,32,13,19,42
Spart Moscow,416,2,11,5,4,37,26,11,38
CSKA Moscow,416,3,11,3,6,27,18,9,36
Zenit,416,4,8,8,4,22,14,8,32
Krasnodar,416,5,9,5,6,33,27,6,32
Terek Grozny,416,6,9,5,6,25,23,2,32
FK Rubin,416,7,6,5,9,24,22,2,23
Din Moscow,416,8,5,6,9,18,24,-6,21
Rostov,416,9,4,6,10,11,19,-8,18
Amkar,416,10,4,4,12,10,25,-15,16
Anzhi,416,11,2,5,13,14,42,-28,11
Loko Moscow,417,1,12,5,3,31,16,15,41
Krasnodar,417,2,10,4,6,32,24,8,34
CSKA Moscow,417,3,10,4,6,25,18,7,34
Zenit,417,4,8,8,4,23,15,8,32
Spart Moscow,417,5,8,6,6,37,31,6,30
Terek Grozny,417,6,8,6,6,22,23,-1,30
FK Rubin,417,7,6,5,9,24,19,5,23
Din Moscow,417,8,5,7,8,19,25,-6,22
Rostov,417,9,5,6,9,12,18,-6,21
Amkar,417,10,5,5,10,12,24,-12,20
Anzhi,417,11,2,6,12,15,39,-24,12
Loko Moscow,418,1,12,6,2,30,11,19,42
CSKA Moscow,418,2,11,3,6,27,19,8,36
Zenit,418,3,8,8,4,23,14,9,32
Spart Moscow,418,4,9,5,6,37,29,8,32
Krasnodar,418,5,8,5,7,27,28,-1,29
Terek Grozny,418,6,7,7,6,22,24,-2,28
Din Moscow,418,7,6,6,8,19,24,-5,24
FK Rubin,418,8,6,5,9,26,19,7,23
Rostov,418,9,5,6,9,12,18,-6,21
Amkar,418,10,5,5,10,12,24,-12,20
Anzhi,418,11,2,6,12,15,40,-25,12
Loko Moscow,419,1,12,5,3,30,12,18,41
CSKA Moscow,419,2,10,4,6,27,20,7,34
Spart Moscow,419,3,8,7,5,36,29,7,31
Krasnodar,419,4,9,4,7,28,27,1,31
Zenit,419,5,7,9,4,21,14,7,30
Terek Grozny,419,6,7,6,7,21,25,-4,27
Din Moscow,419,7,6,7,7,20,22,-2,25
FK Rubin,419,8,6,5,9,24,19,5,23
Rostov,419,9,5,6,9,12,18,-6,21
Amkar,419,10,5,5,10,12,23,-11,20
Anzhi,419,11,3,6,11,18,40,-22,15
Loko Moscow,420,1,11,6,3,31,14,17,39
Spart Moscow,420,2,10,6,4,38,26,12,36
Zenit,420,3,9,8,3,24,14,10,35
CSKA Moscow,420,4,10,4,6,28,21,7,34
Krasnodar,420,5,9,5,6,32,27,5,32
Terek Grozny,420,6,8,6,6,24,24,0,30
Din Moscow,420,7,5,7,8,17,24,-7,22
FK Rubin,420,8,5,6,9,22,20,2,21
Rostov,420,9,4,6,10,11,19,-8,18
Amkar,420,10,4,5,11,10,25,-15,17
Anzhi,420,11,2,7,11,17,40,-23,13
Loko Moscow,421,1,11,6,3,30,13,17,39
Spart Moscow,421,2,10,6,4,39,29,10,36
CSKA Moscow,421,3,11,3,6,26,19,7,36
Zenit,421,4,8,9,3,24,14,10,33
Krasnodar,421,5,9,4,7,28,25,3,31
Terek Grozny,421,6,8,6,6,22,23,-1,30
FK Rubin,421,7,7,5,8,24,17,7,26
Din Moscow,421,8,5,6,9,18,25,-7,21
Rostov,421,9,4,6,10,11,19,-8,18
Amkar,421,10,4,5,11,11,25,-14,17
Anzhi,421,11,2,6,12,15,39,-24,12
Loko Moscow,422,1,12,6,2,31,12,19,42
Spart Moscow,422,2,11,5,4,40,26,14,38
Zenit,422,3,8,9,3,22,13,9,33
CSKA Moscow,422,4,10,3,7,25,20,5,33
Terek Grozny,422,5,9,5,6,26,24,2,32
Krasnodar,422,6,8,4,8,28,27,1,28
Din Moscow,422,7,6,6,8,19,23,-4,24
FK Rubin,422,8,6,5,9,22,18,4,23
Rostov,422,9,4,6,10,10,18,-8,18
Amkar,422,10,4,4,12,9,29,-20,16
Anzhi,422,11,3,5,12,18,40,-22,14
Loko Moscow,423,1,11,6,3,30,13,17,39
CSKA Moscow,423,2,11,4,5,29,20,9,37
Krasnodar,423,3,10,4,6,31,25,6,34
Spart Moscow,423,4,9,6,5,35,30,5,33
Zenit,423,5,7,10,3,23,15,8,31
Terek Grozny,423,6,8,6,6,23,23,0,30
Din Moscow,423,7,7,6,7,25,22,3,27
FK Rubin,423,8,5,5,10,22,23,-1,20
Rostov,423,9,4,7,9,10,17,-7,19
Amkar,423,10,4,5,11,11,25,-14,17
Anzhi,423,11,2,5,13,15,41,-26,11
Loko Moscow,424,1,11,6,3,31,14,17,39
CSKA Moscow,424,2,12,3,5,28,18,10,39
Spart Moscow,424,3,10,5,5,38,29,9,35
Zenit,424,4,8,8,4,23,15,8,32
Krasnodar,424,5,9,5,6,31,27,4,32
Terek Grozny,424,6,8,5,7,23,25,-2,29
Din Moscow,424,7,6,6,8,22,24,-2,24
FK Rubin,424,8,6,5,9,25,21,4,23
Amkar,424,9,5,4,11,11,25,-14,19
Rostov,424,10,4,6,10,10,19,-9,18
Anzhi,424,11,2,5,13,16,41,-25,11
Loko Moscow,425,1,11,5,4,29,15,14,38
Zenit,425,2,9,8,3,26,15,11,35
CSKA Moscow,425,3,10,4,6,29,22,7,34
Krasnodar,425,4,10,4,6,31,25,6,34
Spart Moscow,425,5,9,6,5,38,29,9,33
Terek Grozny,425,6,9,5,6,25,25,0,32
FK Rubin,425,7,6,5,9,23,19,4,23
Din Moscow,425,8,5,6,9,17,24,-7,21
Rostov,425,9,4,7,9,12,19,-7,19
Amkar,425,10,5,4,11,12,25,-13,19
Anzhi,425,11,2,6,12,18,42,-24,12
Loko Moscow,426,1,12,5,3,31,14,17,41
Zenit,426,2,9,8,3,25,14,11,35
Spart Moscow,426,3,9,7,4,39,29,10,34
CSKA Moscow,426,4,10,3,7,27,22,5,33
Krasnodar,426,5,9,4,7,31,26,5,31
Terek Grozny,426,6,7,5,8,20,25,-5,26
FK Rubin,426,7,6,5,9,24,21,3,23
Din Moscow,426,8,5,7,8,19,25,-6,22
Rostov,426,9,4,7,9,12,19,-7,19
Amkar,426,10,5,4,11,11,25,-14,19
Anzhi,426,11,4,5,11,19,38,-19,17
Loko Moscow,427,1,11,5,4,29,17,12,38
CSKA Moscow,427,2,11,3,6,32,20,12,36
Zenit,427,3,9,8,3,26,14,12,35
Spart Moscow,427,4,10,5,5,38,28,10,35
Krasnodar,427,5,10,4,6,32,24,8,34
Terek Grozny,427,6,7,6,7,23,26,-3,27
FK Rubin,427,7,6,5,9,24,20,4,23
Amkar,427,8,6,4,10,13,24,-11,22
Din Moscow,427,9,5,6,9,19,26,-7,21
Rostov,427,10,4,6,10,10,19,-9,18
Anzhi,427,11,2,6,12,17,45,-28,12
Loko Moscow,428,1,12,5,3,32,14,18,41
Spart Moscow,428,2,10,5,5,38,27,11,35
Krasnodar,428,3,10,4,6,33,26,7,34
CSKA Moscow,428,4,10,4,6,25,18,7,34
Zenit,428,5,8,8,4,22,14,8,32
Terek Grozny,428,6,7,6,7,22,25,-3,27
Din Moscow,428,7,6,6,8,22,24,-2,24
Amkar,428,8,6,4,10,12,23,-11,22
FK Rubin,428,9,5,5,10,22,24,-2,20
Rostov,428,10,4,6,10,10,20,-10,18
Anzhi,428,11,2,7,11,15,38,-23,13
Loko Moscow,429,1,12,5,3,32,14,18,41
CSKA Moscow,429,2,11,4,5,30,18,12,37
Spart Moscow,429,3,10,5,5,38,28,10,35
Krasnodar,429,4,10,4,6,33,27,6,34
Zenit,429,5,7,9,4,21,15,6,30
Terek Grozny,429,6,8,5,7,23,23,0,29
FK Rubin,429,7,6,5,9,24,20,4,23
Amkar,429,8,6,4,10,12,22,-10,22
Din Moscow,429,9,5,6,9,17,25,-8,21
Rostov,429,10,4,6,10,11,19,-8,18
Anzhi,429,11,2,5,13,15,45,-30,11
Loko Moscow,430,1,13,5,2,32,12,20,44
Spart Moscow,430,2,10,6,4,39,26,13,36
CSKA Moscow,430,3,11,3,6,29,21,8,36
Zenit,430,4,7,8,5,24,18,6,29
Krasnodar,430,5,8,5,7,28,26,2,29
Terek Grozny,430,6,7,6,7,21,28,-7,27
FK Rubin,430,7,6,6,8,25,20,5,24
Din Moscow,430,8,5,6,9,19,28,-9,21
Rostov,430,9,4,7,9,10,17,-7,19
Amkar,430,10,5,4,11,15,24,-9,19
Anzhi,430,11,3,6,11,17,39,-22,15
Loko Moscow,431,1,12,6,2,31,12,19,42
Spart Moscow,431,2,9,6,5,35,27,8,33
CSKA Moscow,431,3,10,3,7,25,20,5,33
Zenit,431,4,8,8,4,23,14,9,32
Krasnodar,431,5,8,5,7,29,27,2,29
Terek Grozny,431,6,7,7,6,20,22,-2,28
FK Rubin,431,7,6,6,8,23,18,5,24
Din Moscow,431,8,5,7,8,17,22,-5,22
Rostov,431,9,5,6,9,12,18,-6,21
Amkar,431,10,4,6,10,9,22,-13,18
Anzhi,431,11,3,6,11,15,37,-22,15
Loko Moscow,432,1,13,5,2,31,11,20,44
Spart Moscow,432,2,11,5,4,40,27,13,38
CSKA Moscow,432,3,11,3,6,27,18,9,36
Terek Grozny,432,4,9,5,6,24,23,1,32
Krasnodar,432,5,9,4,7,30,26,4,31
Zenit,432,6,7,8,5,21,16,5,29
Din Moscow,432,7,6,6,8,19,24,-5,24
FK Rubin,432,8,5,5,10,22,21,1,20
Rostov,432,9,4,6,10,10,18,-8,18
Amkar,432,10,4,4,12,11,28,-17,16
Anzhi,432,11,3,5,12,15,38,-23,14
Loko Moscow,433,1,12,5,3,32,14,18,41
CSKA Moscow,433,2,10,5,5,25,17,8,35
Spart Moscow,433,3,9,5,6,35,28,7,32
Krasnodar,433,4,9,4,7,30,27,3,31
Zenit,433,5,7,9,4,21,15,6,30
Terek Grozny,433,6,7,5,8,20,24,-4,26
Din Moscow,433,7,6,7,7,19,21,-2,25
FK Rubin,433,8,6,6,8,23,17,6,24
Amkar,433,9,6,4,10,11,22,-11,22
Rostov,433,10,4,6,10,10,19,-9,18
Anzhi,433,11,3,6,11,15,37,-22,15
Loko Moscow,434,1,13,5,2,35,15,20,44
CSKA Moscow,434,2,11,4,5,32,19,13,37
Spart Moscow,434,3,10,5,5,37,28,9,35
Zenit,434,4,7,9,4,25,18,7,30
Krasnodar,434,5,8,4,8,29,29,0,28
Terek Grozny,434,6,7,5,8,21,25,-4,26
Din Moscow,434,7,6,6,8,19,23,-4,24
FK Rubin,434,8,6,5,9,23,19,4,23
Rostov,434,9,5,6,9,13,18,-5,21
Amkar,434,10,5,4,11,11,24,-13,19
Anzhi,434,11,3,5,12,15,42,-27,14
Loko Moscow,435,1,11,5,4,30,14,16,38
CSKA Moscow,435,2,11,3,6,27,19,8,36
Zenit,435,3,9,8,3,24,14,10,35
Spart Moscow,435,4,9,7,4,35,26,9,34
Krasnodar,435,5,9,4,7,29,28,1,31
Terek Grozny,435,6,8,5,7,22,23,-1,29
FK Rubin,435,7,6,6,8,26,19,7,24
Din Moscow,435,8,5,8,7,18,22,-4,23
Amkar,435,9,5,5,10,10,22,-12,20
Rostov,435,10,4,6,10,11,19,-8,18
Anzhi,435,11,2,5,13,15,41,-26,11
Loko Moscow,436,1,13,5,2,39,12,27,44
CSKA Moscow,436,2,11,4,5,29,19,10,37
Spart Moscow,436,3,9,5,6,36,30,6,32
Zenit,436,4,7,8,5,21,19,2,29
Krasnodar,436,5,8,4,8,28,33,-5,28
FK Rubin,436,6,7,5,8,25,17,8,26
Terek Grozny,436,7,7,5,8,20,25,-5,26
Din Moscow,436,8,6,6,8,20,23,-3,24
Amkar,436,9,6,4,10,12,22,-10,22
Rostov,436,10,4,6,10,10,19,-9,18
Anzhi,436,11,3,6,11,18,39,-21,15
Loko Moscow,437,1,11,5,4,30,15,15,38
CSKA Moscow,437,2,11,3,6,27,20,7,36
Zenit,437,3,9,8,3,25,13,12,35
Spart Moscow,437,4,10,5,5,37,27,10,35
Krasnodar,437,5,10,4,6,31,25,6,34
Terek Grozny,437,6,9,5,6,22,22,0,32
Din Moscow,437,7,7,6,7,21,21,0,27
FK Rubin,437,8,5,5,10,21,21,0,20
Rostov,437,9,4,6,10,11,19,-8,18
Amkar,437,10,4,4,12,9,25,-16,16
Anzhi,437,11,2,5,13,14,40,-26,11
Loko Moscow,438,1,11,6,3,31,16,15,39
CSKA Moscow,438,2,11,3,6,27,20,7,36
Zenit,438,3,8,9,3,24,14,10,33
Terek Grozny,438,4,9,5,6,23,23,0,32
Krasnodar,438,5,9,4,7,31,26,5,31
Spart Moscow,438,6,8,6,6,36,30,6,30
Din Moscow,438,7,7,6,7,21,22,-1,27
FK Rubin,438,8,6,5,9,22,19,3,23
Rostov,438,9,4,7,9,12,19,-7,19
Amkar,438,10,5,4,11,10,23,-13,19
Anzhi,438,11,2,5,13,16,41,-25,11
Loko Moscow,439,1,11,5,4,29,14,15,38
CSKA Moscow,439,2,11,3,6,27,19,8,36
Zenit,439,3,9,8,3,24,13,11,35
Krasnodar,439,4,10,4,6,32,25,7,34
Spart Moscow,439,5,8,8,4,37,29,8,32
Terek Grozny,439,6,7,6,7,20,24,-4,27
Din Moscow,439,7,6,7,7,21,23,-2,25
FK Rubin,439,8,5,5,10,22,23,-1,20
Amkar,439,9,5,5,10,13,24,-11,20
Rostov,439,10,4,7,9,10,17,-7,19
Anzhi,439,11,2,6,12,15,39,-24,12
Loko Moscow,440,1,11,7,2,30,12,18,40
CSKA Moscow,440,2,10,5,5,25,17,8,35
Spart Moscow,440,3,9,6,5,37,31,6,33
Zenit,440,4,7,10,3,21,13,8,31
Krasnodar,440,5,8,6,6,29,26,3,30
Terek Grozny,440,6,8,6,6,23,24,-1,30
FK Rubin,440,7,6,6,8,26,21,5,24
Din Moscow,440,8,5,7,8,21,26,-5,22
Amkar,440,9,5,4,11,13,24,-11,19
Rostov,440,10,4,6,10,11,19,-8,18
Anzhi,440,11,2,7,11,16,39,-23,13
Loko Moscow,441,1,12,5,3,30,12,18,41
CSKA Moscow,441,2,10,5,5,26,18,8,35
Spart Moscow,441,3,9,7,4,36,27,9,34
Krasnodar,441,4,10,4,6,30,24,6,34
Zenit,441,5,7,9,4,22,15,7,30
Terek Grozny,441,6,8,5,7,24,25,-1,29
FK Rubin,441,7,6,5,9,23,19,4,23
Din Moscow,441,8,5,7,8,17,23,-6,22
Amkar,441,9,5,5,10,13,24,-11,20
Rostov,441,10,4,6,10,11,19,-8,18
Anzhi,441,11,2,6,12,14,40,-26,12
Loko Moscow,442,1,13,5,2,32,11,21,44
CSKA Moscow,442,2,10,4,6,27,20,7,34
Spart Moscow,442,3,9,6,5,36,29,7,33
Zenit,442,4,8,8,4,22,14,8,32
Terek Grozny,442,5,8,5,7,21,25,-4,29
Krasnodar,442,6,8,4,8,27,27,0,28
FK Rubin,442,7,6,6,8,23,18,5,24
Din Moscow,442,8,5,8,7,20,24,-4,23
Rostov,442,9,5,6,9,12,17,-5,21
Amkar,442,10,5,4,11,12,23,-11,19
Anzhi,442,11,2,6,12,16,40,-24,12
Loko Moscow,443,1,11,7,2,31,13,18,40
CSKA Moscow,443,2,11,3,6,27,19,8,36
Zenit,443,3,8,9,3,24,14,10,33
Krasnodar,443,4,9,5,6,33,25,8,32
Spart Moscow,443,5,8,7,5,34,29,5,31
Terek Grozny,443,6,7,6,7,20,24,-4,27
Din Moscow,443,7,6,7,7,18,21,-3,25
FK Rubin,443,8,5,5,10,21,23,-2,20
Amkar,443,9,5,5,10,12,22,-10,20
Rostov,443,10,4,7,9,11,18,-7,19
Anzhi,443,11,3,5,12,16,39,-23,14
Loko Moscow,444,1,12,5,3,33,15,18,41
CSKA Moscow,444,2,12,3,5,29,17,12,39
Spart Moscow,444,3,10,6,4,38,27,11,36
Zenit,444,4,8,8,4,24,18,6,32
Krasnodar,444,5,9,4,7,30,27,3,31
Terek Grozny,444,6,7,5,8,22,29,-7,26
Din Moscow,444,7,6,6,8,21,24,-3,24
FK Rubin,444,8,5,5,10,22,22,0,20
Amkar,444,9,5,5,10,13,24,-11,20
Rostov,444,10,4,6,10,10,18,-8,18
Anzhi,444,11,3,5,12,18,39,-21,14
Loko Moscow,445,1,11,5,4,30,17,13,38
CSKA Moscow,445,2,11,4,5,28,19,9,37
Spart Moscow,445,3,10,5,5,39,26,13,35
Zenit,445,4,8,9,3,25,14,11,33
Krasnodar,445,5,9,5,6,29,24,5,32
Din Moscow,445,6,7,6,7,19,21,-2,27
Terek Grozny,445,7,7,6,7,21,26,-5,27
FK Rubin,445,8,5,6,9,21,18,3,21
Rostov,445,9,4,6,10,10,20,-10,18
Amkar,445,10,4,5,11,9,25,-16,17
Anzhi,445,11,3,5,12,20,41,-21,14
Loko Moscow,446,1,12,5,3,31,12,19,41
CSKA Moscow,446,2,11,3,6,31,20,11,36
Krasnodar,446,3,10,4,6,29,24,5,34
Spart Moscow,446,4,9,6,5,35,27,8,33
Zenit,446,5,8,8,4,23,16,7,32
Terek Grozny,446,6,7,7,6,22,24,-2,28
Din Moscow,446,7,5,7,8,17,22,-5,22
FK Rubin,446,8,5,6,9,21,18,3,21
Amkar,446,9,5,5,10,12,24,-12,20
Rostov,446,10,4,7,9,10,17,-7,19
Anzhi,446,11,2,6,12,16,43,-27,12
Loko Moscow,447,1,11,6,3,32,16,16,39
CSKA Moscow,447,2,12,3,5,34,20,14,39
Spart Moscow,447,3,11,5,4,40,28,12,38
Krasnodar,447,4,10,4,6,33,25,8,34
Zenit,447,5,7,9,4,26,21,5,30
Terek Grozny,447,6,7,6,7,21,24,-3,27
Din Moscow,447,7,6,6,8,22,26,-4,24
FK Rubin,447,8,5,5,10,23,23,0,20
Rostov,447,9,4,6,10,10,19,-9,18
Amkar,447,10,4,5,11,10,24,-14,17
Anzhi,447,11,3,5,12,16,41,-25,14
Loko Moscow,448,1,12,5,3,31,13,18,41
CSKA Moscow,448,2,11,4,5,28,19,9,37
Spart Moscow,448,3,10,6,4,38,26,12,36
Krasnodar,448,4,9,5,6,29,25,4,32
Terek Grozny,448,5,9,5,6,23,22,1,32
Zenit,448,6,7,9,4,23,16,7,30
Din Moscow,448,7,6,7,7,21,23,-2,25
FK Rubin,448,8,5,6,9,23,21,2,21
Rostov,448,9,4,6,10,10,20,-10,18
Amkar,448,10,4,4,12,9,24,-15,16
Anzhi,448,11,2,5,13,15,41,-26,11
Loko Moscow,449,1,13,5,2,33,12,21,44
Spart Moscow,449,2,10,5,5,35,26,9,35
CSKA Moscow,449,3,10,4,6,25,18,7,34
Zenit,449,4,8,8,4,23,16,7,32
Krasnodar,449,5,8,5,7,29,27,2,29
Terek Grozny,449,6,7,6,7,21,24,-3,27
FK Rubin,449,7,6,6,8,25,20,5,24
Din Moscow,449,8,6,6,8,19,23,-4,24
Rostov,449,9,4,6,10,10,18,-8,18
Amkar,449,10,4,5,11,9,23,-14,17
Anzhi,449,11,3,6,11,16,38,-22,15
Loko Moscow,450,1,11,5,4,29,13,16,38
CSKA Moscow,450,2,10,5,5,27,19,8,35
Krasnodar,450,3,10,4,6,29,24,5,34
Zenit,450,4,8,9,3,23,14,9,33
Spart Moscow,450,5,9,5,6,35,29,6,32
Terek Grozny,450,6,8,6,6,22,23,-1,30
Din Moscow,450,7,7,6,7,19,21,-2,27
FK Rubin,450,8,5,5,10,21,19,2,20
Amkar,450,9,5,4,11,11,23,-12,19
Rostov,450,10,4,6,10,11,19,-8,18
Anzhi,450,11,2,7,11,16,39,-23,13
Loko Moscow,451,1,11,7,2,31,13,18,40
CSKA Moscow,451,2,11,3,6,26,18,8,36
Spart Moscow,451,3,10,5,5,36,26,10,35
Zenit,451,4,8,9,3,24,15,9,33
Krasnodar,451,5,9,5,6,28,24,4,32
Terek Grozny,451,6,8,6,6,24,25,-1,30
Din Moscow,451,7,5,7,8,17,22,-5,22
FK Rubin,451,8,5,6,9,21,18,3,21
Amkar,451,9,5,5,10,11,23,-12,20
Rostov,451,10,4,6,10,10,19,-9,18
Anzhi,451,11,2,5,13,16,41,-25,11
Loko Moscow,452,1,12,5,3,32,13,19,41
Spart Moscow,452,2,11,5,4,42,27,15,38
Zenit,452,3,9,8,3,24,14,10,35
CSKA Moscow,452,4,10,3,7,27,21,6,33
Krasnodar,452,5,9,4,7,31,28,3,31
Terek Grozny,452,6,7,5,8,20,24,-4,26
Din Moscow,452,7,6,6,8,18,25,-7,24
FK Rubin,452,8,5,5,10,23,22,1,20
Amkar,452,9,5,4,11,11,25,-14,19
Rostov,452,10,4,6,10,11,19,-8,18
Anzhi,452,11,4,5,11,18,39,-21,17
Loko Moscow,453,1,12,5,3,32,12,20,41
CSKA Moscow,453,2,11,4,5,28,19,9,37
Spart Moscow,453,3,10,5,5,37,27,10,35
Krasnodar,453,4,9,4,7,28,25,3,31
Zenit,453,5,7,8,5,21,17,4,29
Terek Grozny,453,6,8,5,7,21,25,-4,29
Din Moscow,453,7,6,6,8,20,24,-4,24
FK Rubin,453,8,6,5,9,23,19,4,23
Amkar,453,9,5,4,11,10,23,-13,19
Rostov,453,10,4,6,10,10,19,-9,18
Anzhi,453,11,3,6,11,19,39,-20,15
CSKA Moscow,454,1,12,3,5,28,17,11,39
Loko Moscow,454,2,11,5,4,29,13,16,38
Spart Moscow,454,3,9,6,5,34,28,6,33
Zenit,454,4,8,8,4,22,14,8,32
Krasnodar,454,5,9,4,7,28,25,3,31
Terek Grozny,454,6,7,7,6,22,24,-2,28
Din Moscow,454,7,6,7,7,18,21,-3,25
FK Rubin,454,8,6,5,9,22,18,4,23
Amkar,454,9,5,5,10,14,24,-10,20
Rostov,454,10,4,6,10,10,18,-8,18
Anzhi,454,11,2,6,12,14,39,-25,12
Loko Moscow,455,1,13,5,2,35,12,23,44
CSKA Moscow,455,2,12,3,5,30,17,13,39
Spart Moscow,455,3,8,7,5,34,27,7,31
Terek Grozny,455,4,8,6,6,23,23,0,30
Krasnodar,455,5,8,5,7,30,28,2,29
Zenit,455,6,7,8,5,21,19,2,29
Din Moscow,455,7,6,7,7,20,22,-2,25
FK Rubin,455,8,5,6,9,24,22,2,21
Rostov,455,9,5,6,9,11,17,-6,21
Amkar,455,10,4,5,11,10,25,-15,17
Anzhi,455,11,2,6,12,15,41,-26,12
Loko Moscow,456,1,11,6,3,30,14,16,39
Spart Moscow,456,2,10,6,4,39,29,10,36
CSKA Moscow,456,3,11,3,6,26,19,7,36
Zenit,456,4,9,8,3,26,14,12,35
Krasnodar,456,5,8,6,6,27,24,3,30
Terek Grozny,456,6,7,6,7,21,24,-3,27
Din Moscow,456,7,6,6,8,20,23,-3,24
FK Rubin,456,8,5,6,9,21,19,2,21
Rostov,456,9,4,7,9,12,19,-7,19
Amkar,456,10,5,4,11,12,25,-13,19
Anzhi,456,11,2,6,12,14,38,-24,12
Loko Moscow,457,1,12,5,3,31,12,19,41
Spart Moscow,457,2,10,6,4,40,27,13,36
CSKA Moscow,457,3,11,3,6,30,23,7,36
Zenit,457,4,9,8,3,25,14,11,35
Krasnodar,457,5,8,5,7,27,26,1,29
Terek Grozny,457,6,7,5,8,24,29,-5,26
FK Rubin,457,7,5,7,8,22,18,4,22
Din Moscow,457,8,5,7,8,19,27,-8,22
Rostov,457,9,4,7,9,10,17,-7,19
Amkar,457,10,5,4,11,14,26,-12,19
Anzhi,457,11,3,5,12,20,43,-23,14
Loko Moscow,458,1,11,6,3,29,13,16,39
Spart Moscow,458,2,10,6,4,37,27,10,36
CSKA Moscow,458,3,11,3,6,28,20,8,36
Krasnodar,458,4,10,4,6,32,26,6,34
Zenit,458,5,7,9,4,21,14,7,30
Terek Grozny,458,6,7,6,7,23,26,-3,27
Din Moscow,458,7,5,7,8,18,23,-5,22
FK Rubin,458,8,5,6,9,23,20,3,21
Amkar,458,9,5,5,10,13,25,-12,20
Rostov,458,10,4,6,10,10,18,-8,18
Anzhi,458,11,3,6,11,18,40,-22,15
Spart Moscow,459,1,11,5,4,40,27,13,38
Loko Moscow,459,2,11,5,4,29,16,13,38
CSKA Moscow,459,3,11,4,5,30,19,11,37
Zenit,459,4,8,9,3,23,14,9,33
Krasnodar,459,5,9,5,6,31,24,7,32
Terek Grozny,459,6,7,5,8,20,25,-5,26
FK Rubin,459,7,5,7,8,21,17,4,22
Din Moscow,459,8,5,7,8,18,24,-6,22
Amkar,459,9,5,4,11,12,25,-13,19
Rostov,459,10,4,6,10,10,18,-8,18
Anzhi,459,11,3,5,12,16,41,-25,14
Loko Moscow,460,1,12,5,3,30,14,16,41
CSKA Moscow,460,2,12,3,5,29,19,10,39
Spart Moscow,460,3,10,5,5,38,29,9,35
Krasnodar,460,4,10,4,6,34,27,7,34
Zenit,460,5,7,8,5,22,16,6,29
Terek Grozny,460,6,8,5,7,23,25,-2,29
Din Moscow,460,7,7,6,7,21,22,-1,27
FK Rubin,460,8,5,5,10,24,23,1,20
Amkar,460,9,5,4,11,11,24,-13,19
Rostov,460,10,4,6,10,11,19,-8,18
Anzhi,460,11,2,5,13,17,42,-25,11
Loko Moscow,461,1,12,6,2,34,14,20,42
Spart Moscow,461,2,11,5,4,39,27,12,38
CSKA Moscow,461,3,11,4,5,27,18,9,37
Zenit,461,4,7,10,3,23,15,8,31
Krasnodar,461,5,8,5,7,29,28,1,29
Terek Grozny,461,6,7,7,6,21,23,-2,28
Din Moscow,461,7,6,6,8,20,23,-3,24
FK Rubin,461,8,5,6,9,23,21,2,21
Rostov,461,9,4,6,10,10,18,-8,18
Amkar,461,10,4,5,11,12,27,-15,17
Anzhi,461,11,2,6,12,15,39,-24,12
Loko Moscow,462,1,11,6,3,31,14,17,39
CSKA Moscow,462,2,12,3,5,33,20,13,39
Spart Moscow,462,3,9,5,6,35,30,5,32
Krasnodar,462,4,9,4,7,29,26,3,31
Zenit,462,5,7,9,4,23,16,7,30
FK Rubin,462,6,7,5,8,25,17,8,26
Terek Grozny,462,7,7,5,8,21,30,-9,26
Din Moscow,462,8,6,6,8,20,24,-4,24
Amkar,462,9,6,4,10,13,22,-9,22
Rostov,462,10,4,6,10,11,19,-8,18
Anzhi,462,11,3,5,12,21,44,-23,14
Loko Moscow,463,1,12,6,2,32,13,19,42
CSKA Moscow,463,2,11,4,5,27,18,9,37
Spart Moscow,463,3,8,7,5,35,28,7,31
Zenit,463,4,7,9,4,22,15,7,30
Krasnodar,463,5,8,5,7,30,29,1,29
Terek Grozny,463,6,8,5,7,23,25,-2,29
FK Rubin,463,7,6,6,8,26,20,6,24
Din Moscow,463,8,5,8,7,19,23,-4,23
Rostov,463,9,4,7,9,12,19,-7,19
Amkar,463,10,5,4,11,10,23,-13,19
Anzhi,463,11,3,5,12,17,40,-23,14
Loko Moscow,464,1,12,5,3,32,14,18,41
CSKA Moscow,464,2,12,3,5,34,19,15,39
Spart Moscow,464,3,9,6,5,38,28,10,33
Krasnodar,464,4,9,4,7,30,27,3,31
Zenit,464,5,7,8,5,24,19,5,29
Terek Grozny,464,6,7,7,6,22,24,-2,28
Din Moscow,464,7,6,6,8,20,27,-7,24
FK Rubin,464,8,6,5,9,25,21,4,23
Rostov,464,9,5,6,9,12,17,-5,21
Amkar,464,10,4,6,10,11,24,-13,18
Anzhi,464,11,2,6,12,15,43,-28,12
Loko Moscow,465,1,11,7,2,30,12,18,40
CSKA Moscow,465,2,11,3,6,29,19,10,36
Zenit,465,3,8,9,3,23,14,9,33
Krasnodar,465,4,9,5,6,31,26,5,32
Spart Moscow,465,5,8,6,6,33,30,3,30
Terek Grozny,465,6,8,5,7,22,23,-1,29
Din Moscow,465,7,7,6,7,22,21,1,27
Amkar,465,8,6,4,10,13,22,-9,22
FK Rubin,465,9,5,5,10,22,23,-1,20
Rostov,465,10,4,7,9,10,17,-7,19
Anzhi,465,11,2,5,13,14,42,-28,11
Loko Moscow,466,1,13,5,2,37,13,24,44
CSKA Moscow,466,2,11,4,5,29,18,11,37
Spart Moscow,466,3,9,5,6,40,30,10,32
Zenit,466,4,7,9,4,23,17,6,30
Terek Grozny,466,5,8,6,6,22,23,-1,30
Krasnodar,466,6,8,5,7,28,29,-1,29
Din Moscow,466,7,6,6,8,19,27,-8,24
FK Rubin,466,8,5,6,9,21,18,3,21
Rostov,466,9,5,6,9,11,17,-6,21
Amkar,466,10,5,4,11,12,24,-12,19
Anzhi,466,11,2,6,12,15,41,-26,12
Loko Moscow,467,1,11,6,3,31,14,17,39
Spart Moscow,467,2,11,5,4,40,27,13,38
Zenit,467,3,9,8,3,25,13,12,35
CSKA Moscow,467,4,10,4,6,27,22,5,34
Krasnodar,467,5,8,6,6,29,26,3,30
Terek Grozny,467,6,8,6,6,23,23,0,30
Din Moscow,467,7,6,6,8,21,24,-3,24
FK Rubin,467,8,5,6,9,21,20,1,21
Rostov,467,9,4,6,10,10,18,-8,18
Amkar,467,10,4,4,12,10,27,-17,16
Anzhi,467,11,2,7,11,17,40,-23,13
Loko Moscow,468,1,13,5,2,38,13,25,44
CSKA Moscow,468,2,11,4,5,27,18,9,37
Spart Moscow,468,3,9,5,6,38,32,6,32
Zenit,468,4,7,9,4,22,20,2,30
Terek Grozny,468,5,8,6,6,24,25,-1,30
Krasnodar,468,6,8,4,8,29,31,-2,28
Din Moscow,468,7,6,6,8,20,25,-5,24
FK Rubin,468,8,6,5,9,25,18,7,23
Rostov,468,9,5,6,9,13,17,-4,21
Amkar,468,10,5,4,11,12,25,-13,19
Anzhi,468,11,2,6,12,16,40,-24,12
Loko Moscow,469,1,12,6,2,30,11,19,42
Spart Moscow,469,2,10,6,4,41,28,13,36
CSKA Moscow,469,3,11,3,6,28,19,9,36
Zenit,469,4,8,8,4,23,15,8,32
Terek Grozny,469,5,9,5,6,25,23,2,32
Krasnodar,469,6,8,5,7,28,26,2,29
Din Moscow,469,7,6,6,8,22,25,-3,24
FK Rubin,469,8,6,5,9,24,22,2,23
Rostov,469,9,4,7,9,12,19,-7,19
Amkar,469,10,4,4,12,9,27,-18,16
Anzhi,469,11,2,5,13,15,42,-27,11
Loko Moscow,470,1,12,6,2,32,13,19,42
CSKA Moscow,470,2,11,4,5,27,17,10,37
Spart Moscow,470,3,9,6,5,40,29,11,33
Zenit,470,4,7,10,3,22,14,8,31
Krasnodar,470,5,8,5,7,28,26,2,29
Terek Grozny,470,6,8,5,7,21,25,-4,29
Din Moscow,470,7,6,7,7,19,22,-3,25
Amkar,470,8,6,4,10,15,23,-8,22
FK Rubin,470,9,5,6,9,21,18,3,21
Rostov,470,10,4,6,10,10,22,-12,18
Anzhi,470,11,2,5,13,14,40,-26,11
Loko Moscow,471,1,12,6,2,32,12,20,42
CSKA Moscow,471,2,12,3,5,27,17,10,39
Spart Moscow,471,3,10,5,5,40,28,12,35
Krasnodar,471,4,8,6,6,28,25,3,30
Zenit,471,5,7,8,5,21,16,5,29
Terek Grozny,471,6,8,5,7,21,23,-2,29
FK Rubin,471,7,6,6,8,22,17,5,24
Amkar,471,8,6,4,10,11,22,-11,22
Din Moscow,471,9,5,6,9,18,26,-8,21
Rostov,471,10,4,6,10,11,20,-9,18
Anzhi,471,11,2,5,13,14,39,-25,11
Loko Moscow,472,1,13,5,2,33,12,21,44
CSKA Moscow,472,2,12,3,5,30,18,12,39
Spart Moscow,472,3,9,7,4,40,31,9,34
Terek Grozny,472,4,9,5,6,22,22,0,32
Zenit,472,5,7,8,5,22,17,5,29
Krasnodar,472,6,8,4,8,28,27,1,28
FK Rubin,472,7,7,5,8,23,17,6,26
Din Moscow,472,8,5,7,8,18,23,-5,22
Rostov,472,9,4,7,9,11,18,-7,19
Amkar,472,10,4,4,12,13,28,-15,16
Anzhi,472,11,2,5,13,14,41,-27,11
Loko Moscow,473,1,12,6,2,32,11,21,42
Spart Moscow,473,2,11,5,4,39,26,13,38
CSKA Moscow,473,3,11,3,6,28,21,7,36
Zenit,473,4,8,8,4,24,17,7,32
Krasnodar,473,5,9,5,6,28,24,4,32
Terek Grozny,473,6,8,5,7,22,24,-2,29
Din Moscow,473,7,6,6,8,21,25,-4,24
FK Rubin,473,8,5,5,10,22,21,1,20
Amkar,473,9,5,4,11,10,24,-14,19
Rostov,473,10,4,6,10,10,18,-8,18
Anzhi,473,11,2,5,13,16,41,-25,11
Loko Moscow,474,1,11,6,3,30,16,14,39
CSKA Moscow,474,2,11,3,6,27,18,9,36
Krasnodar,474,3,10,4,6,35,25,10,34
Zenit,474,4,8,9,3,22,13,9,33
Terek Grozny,474,5,9,5,6,27,24,3,32
Spart Moscow,474,6,8,6,6,34,29,5,30
Din Moscow,474,7,6,7,7,20,22,-2,25
FK Rubin,474,8,5,6,9,21,20,1,21
Rostov,474,9,5,6,9,11,17,-6,21
Amkar,474,10,4,5,11,10,24,-14,17
Anzhi,474,11,2,5,13,15,44,-29,11
Loko Moscow,475,1,13,5,2,32,11,21,44
CSKA Moscow,475,2,12,3,5,30,18,12,39
Spart Moscow,475,3,9,5,6,35,29,6,32
Zenit,475,4,7,8,5,21,17,4,29
Krasnodar,475,5,8,5,7,30,28,2,29
Terek Grozny,475,6,7,7,6,20,22,-2,28
Din Moscow,475,7,7,6,7,20,21,-1,27
FK Rubin,475,8,5,6,9,24,21,3,21
Amkar,475,9,5,5,10,11,22,-11,20
Rostov,475,10,4,6,10,10,19,-9,18
Anzhi,475,11,2,6,12,15,40,-25,12
Loko Moscow,476,1,11,6,3,31,14,17,39
CSKA Moscow,476,2,10,5,5,28,20,8,35
Krasnodar,476,3,10,4,6,35,26,9,34
Spart Moscow,476,4,8,8,4,36,28,8,32
Zenit,476,5,7,10,3,23,15,8,31
Terek Grozny,476,6,8,5,7,22,24,-2,29
Din Moscow,476,7,6,7,7,19,21,-2,25
FK Rubin,476,8,5,5,10,21,24,-3,20
Amkar,476,9,5,5,10,11,23,-12,20
Rostov,476,10,4,7,9,12,19,-7,19
Anzhi,476,11,2,6,12,16,40,-24,12
Loko Moscow,477,1,12,6,2,33,11,22,42
Spart Moscow,477,2,11,5,4,41,25,16,38
CSKA Moscow,477,3,10,3,7,26,23,3,33
Zenit,477,4,8,8,4,25,17,8,32
Krasnodar,477,5,9,5,6,29,24,5,32
Terek Grozny,477,6,8,6,6,24,24,0,30
Din Moscow,477,7,6,6,8,20,25,-5,24
FK Rubin,477,8,5,5,10,22,22,0,20
Rostov,477,9,4,6,10,10,18,-8,18
Amkar,477,10,4,4,12,10,29,-19,16
Anzhi,477,11,3,6,11,17,39,-22,15
Loko Moscow,478,1,11,6,3,30,14,16,39
CSKA Moscow,478,2,12,3,5,29,17,12,39
Zenit,478,3,8,8,4,24,15,9,32
Spart Moscow,478,4,8,8,4,35,27,8,32
Krasnodar,478,5,9,5,6,28,24,4,32
Terek Grozny,478,6,7,6,7,21,24,-3,27
Din Moscow,478,7,5,8,7,18,22,-4,23
FK Rubin,478,8,5,6,9,22,19,3,21
Rostov,478,9,4,7,9,11,18,-7,19
Amkar,478,10,4,6,10,10,23,-13,18
Anzhi,478,11,3,5,12,16,41,-25,14
Loko Moscow,479,1,12,5,3,32,13,19,41
CSKA Moscow,479,2,11,3,6,30,22,8,36
Spart Moscow,479,3,9,6,5,40,29,11,33
Zenit,479,4,8,8,4,25,18,7,32
Krasnodar,479,5,9,5,6,29,25,4,32
Din Moscow,479,6,7,6,7,22,24,-2,27
Terek Grozny,479,7,7,6,7,21,26,-5,27
FK Rubin,479,8,5,6,9,23,20,3,21
Rostov,479,9,4,7,9,12,19,-7,19
Amkar,479,10,4,5,11,10,27,-17,17
Anzhi,479,11,3,5,12,18,39,-21,14
Loko Moscow,480,1,13,5,2,33,13,20,44
CSKA Moscow,480,2,11,4,5,26,17,9,37
Spart Moscow,480,3,10,6,4,37,26,11,36
Krasnodar,480,4,9,4,7,31,26,5,31
Zenit,480,5,7,8,5,22,16,6,29
Terek Grozny,480,6,7,6,7,22,25,-3,27
Din Moscow,480,7,6,6,8,19,22,-3,24
FK Rubin,480,8,5,5,10,21,22,-1,20
Amkar,480,9,5,5,10,12,24,-12,20
Rostov,480,10,4,6,10,10,19,-9,18
Anzhi,480,11,2,7,11,15,38,-23,13
Loko Moscow,481,1,12,6,2,31,12,19,42
Spart Moscow,481,2,11,5,4,41,26,15,38
CSKA Moscow,481,3,11,3,6,26,18,8,36
Zenit,481,4,8,8,4,22,14,8,32
Krasnodar,481,5,8,6,6,30,27,3,30
Terek Grozny,481,6,8,5,7,22,24,-2,29
Din Moscow,481,7,6,6,8,18,25,-7,24
FK Rubin,481,8,5,6,9,23,20,3,21
Amkar,481,9,5,4,11,11,24,-13,19
Rostov,481,10,4,6,10,10,19,-9,18
Anzhi,481,11,2,5,13,15,40,-25,11
Loko Moscow,482,1,12,5,3,33,14,19,41
Spart Moscow,482,2,10,5,5,39,28,11,35
CSKA Moscow,482,3,10,3,7,27,22,5,33
Zenit,482,4,8,8,4,24,16,8,32
Krasnodar,482,5,9,5,6,32,28,4,32
Terek Grozny,482,6,8,6,6,24,25,-1,30
FK Rubin,482,7,6,6,8,25,19,6,24
Rostov,482,8,5,6,9,12,18,-6,21
Din Moscow,482,9,5,6,9,18,25,-7,21
Amkar,482,10,4,4,12,10,27,-17,16
Anzhi,482,11,3,6,11,18,40,-22,15
Loko Moscow,483,1,12,6,2,32,13,19,42
CSKA Moscow,483,2,11,3,6,29,18,11,36
Spart Moscow,483,3,10,5,5,38,29,9,35
Zenit,483,4,8,9,3,23,14,9,33
Terek Grozny,483,5,8,6,6,24,24,0,30
Krasnodar,483,6,8,5,7,28,26,2,29
Din Moscow,483,7,6,6,8,20,23,-3,24
FK Rubin,483,8,5,6,9,21,19,2,21
Amkar,483,9,5,5,10,11,23,-12,20
Rostov,483,10,4,6,10,11,19,-8,18
Anzhi,483,11,2,5,13,16,45,-29,11
Loko Moscow,484,1,11,5,4,30,14,16,38
CSKA Moscow,484,2,10,4,6,26,21,5,34
Zenit,484,3,8,9,3,24,15,9,33
Krasnodar,484,4,9,4,7,30,28,2,31
Spart Moscow,484,5,8,6,6,35,30,5,30
Terek Grozny,484,6,8,5,7,23,25,-2,29
Din Moscow,484,7,6,7,7,20,22,-2,25
FK Rubin,484,8,6,5,9,25,21,4,23
Amkar,484,9,6,4,10,12,23,-11,22
Rostov,484,10,5,6,9,13,18,-5,21
Anzhi,484,11,3,5,12,18,39,-21,14
Loko Moscow,485,1,11,5,4,31,15,16,38
CSKA Moscow,485,2,11,4,5,27,18,9,37
Spart Moscow,485,3,10,5,5,40,28,12,35
Zenit,485,4,8,8,4,23,15,8,32
Krasnodar,485,5,9,5,6,30,26,4,32
Terek Grozny,485,6,9,5,6,24,23,1,32
FK Rubin,485,7,5,7,8,22,18,4,22
Din Moscow,485,8,5,7,8,17,22,-5,22
Amkar,485,9,5,4,11,11,25,-14,19
Rostov,485,10,4,6,10,11,22,-11,18
Anzhi,485,11,2,6,12,16,40,-24,12
Loko Moscow,486,1,12,6,2,30,11,19,42
CSKA Moscow,486,2,11,3,6,28,20,8,36
Spart Moscow,486,3,9,6,5,36,26,10,33
Zenit,486,4,8,9,3,24,15,9,33
Terek Grozny,486,5,8,5,7,22,24,-2,29
Krasnodar,486,6,8,4,8,28,27,1,28
Din Moscow,486,7,6,6,8,20,25,-5,24
FK Rubin,486,8,6,5,9,24,21,3,23
Rostov,486,9,5,6,9,11,17,-6,21
Amkar,486,10,5,5,10,11,23,-12,20
Anzhi,486,11,2,5,13,14,39,-25,11
Loko Moscow,487,1,12,5,3,30,12,18,41
CSKA Moscow,487,2,11,4,5,28,19,9,37
Zenit,487,3,8,9,3,23,14,9,33
Spart Moscow,487,4,8,7,5,35,28,7,31
Krasnodar,487,5,9,4,7,29,25,4,31
Terek Grozny,487,6,7,7,6,22,24,-2,28
FK Rubin,487,7,6,5,9,22,19,3,23
Din Moscow,487,8,5,7,8,17,22,-5,22
Rostov,487,9,5,6,9,12,18,-6,21
Amkar,487,10,4,6,10,11,24,-13,18
Anzhi,487,11,2,6,12,16,40,-24,12
Loko Moscow,488,1,12,5,3,31,13,18,41
CSKA Moscow,488,2,12,3,5,27,17,10,39
Spart Moscow,488,3,9,6,5,38,29,9,33
Krasnodar,488,4,9,4,7,29,26,3,31
Zenit,488,5,7,8,5,21,15,6,29
Terek Grozny,488,6,7,6,7,21,24,-3,27
FK Rubin,488,7,7,5,8,23,17,6,26
Rostov,488,8,5,6,9,13,19,-6,21
Din Moscow,488,9,5,6,9,17,24,-7,21
Amkar,488,10,5,5,10,12,24,-12,20
Anzhi,488,11,2,6,12,14,38,-24,12
Loko Moscow,489,1,13,5,2,31,11,20,44
CSKA Moscow,489,2,11,4,5,27,18,9,37
Spart Moscow,489,3,9,5,6,35,31,4,32
Zenit,489,4,7,9,4,22,15,7,30
Krasnodar,489,5,8,5,7,27,25,2,29
Terek Grozny,489,6,7,6,7,21,26,-5,27
Din Moscow,489,7,6,6,8,21,24,-3,24
FK Rubin,489,8,5,6,9,22,20,2,21
Rostov,489,9,5,6,9,12,17,-5,21
Amkar,489,10,5,5,10,12,22,-10,20
Anzhi,489,11,3,5,12,18,39,-21,14
Loko Moscow,490,1,13,5,2,36,11,25,44
CSKA Moscow,490,2,12,3,5,30,18,12,39
Spart Moscow,490,3,10,6,4,39,27,12,36
Zenit,490,4,7,8,5,22,20,2,29
Krasnodar,490,5,8,5,7,29,29,0,29
Terek Grozny,490,6,8,5,7,22,25,-3,29
FK Rubin,490,7,6,6,8,26,21,5,24
Din Moscow,490,8,5,6,9,20,27,-7,21
Amkar,490,9,5,5,10,12,23,-11,20
Rostov,490,10,4,6,10,10,19,-9,18
Anzhi,490,11,2,5,13,15,41,-26,11
Loko Moscow,491,1,12,5,3,32,13,19,41
CSKA Moscow,491,2,11,3,6,26,18,8,36
Spart Moscow,491,3,9,6,5,38,30,8,33
Zenit,491,4,8,8,4,22,15,7,32
Krasnodar,491,5,9,5,6,30,26,4,32
Terek Grozny,491,6,8,5,7,23,24,-1,29
Din Moscow,491,7,6,7,7,20,23,-3,25
Amkar,491,8,6,4,10,14,23,-9,22
FK Rubin,491,9,5,6,9,22,19,3,21
Rostov,491,10,4,6,10,10,19,-9,18
Anzhi,491,11,2,5,13,14,41,-27,11
Loko Moscow,492,1,11,6,3,30,13,17,39
CSKA Moscow,492,2,11,3,6,26,19,7,36
Zenit,492,3,8,9,3,24,14,10,33
Spart Moscow,492,4,9,6,5,37,29,8,33
Terek Grozny,492,5,9,5,6,23,23,0,32
Krasnodar,492,6,9,4,7,29,26,3,31
Din Moscow,492,7,6,6,8,21,25,-4,24
FK Rubin,492,8,6,5,9,24,20,4,23
Rostov,492,9,4,7,9,11,18,-7,19
Amkar,492,10,5,4,11,11,24,-13,19
Anzhi,492,11,2,5,13,14,39,-25,11
Loko Moscow,493,1,12,6,2,34,13,21,42
CSKA Moscow,493,2,10,4,6,26,19,7,34
Spart Moscow,493,3,9,6,5,35,27,8,33
Terek Grozny,493,4,9,5,6,25,22,3,32
Zenit,493,5,7,9,4,22,17,5,30
Krasnodar,493,6,8,5,7,28,26,2,29
Din Moscow,493,7,6,7,7,19,22,-3,25
FK Rubin,493,8,6,5,9,23,19,4,23
Amkar,493,9,5,4,11,10,23,-13,19
Rostov,493,10,4,6,10,11,19,-8,18
Anzhi,493,11,3,5,12,16,42,-26,14
Loko Moscow,494,1,12,6,2,31,11,20,42
CSKA Moscow,494,2,11,4,5,29,19,10,37
Zenit,494,3,7,10,3,22,14,8,31
Krasnodar,494,4,9,4,7,28,26,2,31
Spart Moscow,494,5,8,5,7,35,31,4,29
Terek Grozny,494,6,7,7,6,21,23,-2,28
Din Moscow,494,7,7,6,7,22,23,-1,27
Rostov,494,8,5,6,9,12,18,-6,21
FK Rubin,494,9,5,5,10,22,21,1,20
Amkar,494,10,5,5,10,12,23,-11,20
Anzhi,494,11,2,6,12,15,40,-25,12
Loko Moscow,495,1,12,6,2,34,15,19,42
Spart Moscow,495,2,11,5,4,39,26,13,38
CSKA Moscow,495,3,11,4,5,30,20,10,37
Zenit,495,4,7,10,3,24,16,8,31
Krasnodar,495,5,8,5,7,30,28,2,29
Terek Grozny,495,6,7,5,8,21,26,-5,26
FK Rubin,495,7,6,6,8,23,18,5,24
Din Moscow,495,8,5,6,9,18,24,-6,21
Amkar,495,9,5,4,11,11,24,-13,19
Rostov,495,10,4,6,10,10,19,-9,18
Anzhi,495,11,3,5,12,18,42,-24,14
Loko Moscow,496,1,11,5,4,31,16,15,38
CSKA Moscow,496,2,11,4,5,29,20,9,37
Spart Moscow,496,3,10,5,5,38,30,8,35
Krasnodar,496,4,10,4,6,31,25,6,34
Zenit,496,5,8,9,3,24,15,9,33
Terek Grozny,496,6,7,5,8,22,29,-7,26
Din Moscow,496,7,5,7,8,20,25,-5,22
Amkar,496,8,6,4,10,15,23,-8,22
FK Rubin,496,9,5,6,9,22,19,3,21
Rostov,496,10,4,6,10,11,19,-8,18
Anzhi,496,11,3,5,12,19,41,-22,14
Loko Moscow,497,1,11,6,3,31,15,16,39
Krasnodar,497,2,10,4,6,32,25,7,34
Spart Moscow,497,3,9,6,5,37,28,9,33
Zenit,497,4,8,9,3,25,16,9,33
CSKA Moscow,497,5,10,3,7,27,21,6,33
Terek Grozny,497,6,9,5,6,24,24,0,32
Din Moscow,497,7,7,6,7,19,21,-2,27
FK Rubin,497,8,5,5,10,22,21,1,20
Rostov,497,9,4,6,10,11,20,-9,18
Amkar,497,10,4,5,11,11,25,-14,17
Anzhi,497,11,3,5,12,17,40,-23,14
Loko Moscow,498,1,12,5,3,33,13,20,41
CSKA Moscow,498,2,11,4,5,29,20,9,37
Spart Moscow,498,3,10,6,4,39,27,12,36
Krasnodar,498,4,9,4,7,30,27,3,31
Zenit,498,5,7,9,4,21,16,5,30
Terek Grozny,498,6,8,6,6,24,24,0,30
FK Rubin,498,7,6,6,8,23,18,5,24
Din Moscow,498,8,5,7,8,18,25,-7,22
Rostov,498,9,4,6,10,10,18,-8,18
Amkar,498,10,4,5,11,10,25,-15,17
Anzhi,498,11,2,6,12,19,43,-24,12
Loko Moscow,499,1,12,6,2,33,12,21,42
CSKA Moscow,499,2,12,3,5,28,17,11,39
Krasnodar,499,3,9,4,7,28,27,1,31
Zenit,499,4,7,9,4,22,15,7,30
Spart Moscow,499,5,8,6,6,38,32,6,30
Terek Grozny,499,6,8,6,6,23,23,0,30
Din Moscow,499,7,6,6,8,21,25,-4,24
FK Rubin,499,8,6,5,9,23,19,4,23
Rostov,499,9,5,6,9,12,18,-6,21
Amkar,499,10,4,6,10,12,25,-13,18
Anzhi,499,11,2,5,13,14,41,-27,11
Loko Moscow,500,1,12,6,2,32,12,20,42
CSKA Moscow,500,2,11,4,5,27,18,9,37
Spart Moscow,500,3,9,6,5,36,28,8,33
Krasnodar,500,4,9,5,6,31,26,5,32
Zenit,500,5,7,9,4,21,15,6,30
Terek Grozny,500,6,7,6,7,22,25,-3,27
Din Moscow,500,7,6,6,8,19,23,-4,24
FK Rubin,500,8,6,5,9,24,20,4,23
Rostov,500,9,4,7,9,11,18,-7,19
Amkar,500,10,5,4,11,11,25,-14,19
Anzhi,500,11,2,6,12,16,40,-24,12
Loko Moscow,501,1,12,5,3,30,12,18,41
Spart Moscow,501,2,10,6,4,39,28,11,36
Zenit,501,3,9,8,3,23,13,10,35
CSKA Moscow,501,4,10,4,6,25,18,7,34
Krasnodar,501,5,9,4,7,28,25,3,31
Terek Grozny,501,6,8,6,6,25,26,-1,30
Din Moscow,501,7,5,7,8,19,24,-5,22
FK Rubin,501,8,5,6,9,21,18,3,21
Rostov,501,9,4,6,10,10,19,-9,18
Amkar,501,10,4,5,11,11,25,-14,17
Anzhi,501,11,2,7,11,17,40,-23,13
Loko Moscow,502,1,11,7,2,30,12,18,40
CSKA Moscow,502,2,11,3,6,28,21,7,36
Spart Moscow,502,3,9,7,4,36,26,10,34
Zenit,502,4,8,9,3,24,13,11,33
Krasnodar,502,5,8,5,7,30,28,2,29
Terek Grozny,502,6,7,6,7,22,25,-3,27
FK Rubin,502,7,6,6,8,24,19,5,24
Din Moscow,502,8,5,8,7,18,22,-4,23
Rostov,502,9,4,6,10,10,19,-9,18
Amkar,502,10,4,6,10,10,23,-13,18
Anzhi,502,11,3,5,12,17,41,-24,14
Loko Moscow,503,1,13,5,2,32,12,20,44
CSKA Moscow,503,2,10,5,5,26,18,8,35
Spart Moscow,503,3,9,6,5,36,28,8,33
Krasnodar,503,4,9,4,7,30,27,3,31
Zenit,503,5,7,9,4,22,15,7,30
Terek Grozny,503,6,7,5,8,22,27,-5,26
Din Moscow,503,7,6,7,7,21,24,-3,25
Amkar,503,8,6,4,10,13,24,-11,22
FK Rubin,503,9,5,5,10,24,22,2,20
Rostov,503,10,4,6,10,10,18,-8,18
Anzhi,503,11,3,6,11,17,38,-21,15
Loko Moscow,504,1,12,6,2,32,11,21,42
CSKA Moscow,504,2,10,4,6,27,21,6,34
Spart Moscow,504,3,9,6,5,37,30,7,33
Zenit,504,4,8,8,4,23,16,7,32
Krasnodar,504,5,8,6,6,29,26,3,30
Terek Grozny,504,6,8,5,7,22,26,-4,29
Din Moscow,504,7,6,6,8,18,22,-4,24
FK Rubin,504,8,5,6,9,23,20,3,21
Rostov,504,9,5,6,9,13,18,-5,21
Amkar,504,10,4,5,11,11,26,-15,17
Anzhi,504,11,3,6,11,20,39,-19,15
Loko Moscow,505,1,12,6,2,31,11,20,42
Spart Moscow,505,2,11,5,4,37,26,11,38
CSKA Moscow,505,3,10,3,7,27,21,6,33
Zenit,505,4,8,8,4,24,17,7,32
Krasnodar,505,5,9,5,6,29,25,4,32
Terek Grozny,505,6,7,6,7,22,26,-4,27
Din Moscow,505,7,6,6,8,19,22,-3,24
FK Rubin,505,8,5,5,10,22,21,1,20
Amkar,505,9,5,4,11,12,24,-12,19
Rostov,505,10,4,6,10,10,18,-8,18
Anzhi,505,11,3,6,11,17,39,-22,15
Loko Moscow,506,1,12,6,2,32,13,19,42
CSKA Moscow,506,2,12,3,5,30,18,12,39
Spart Moscow,506,3,9,5,6,35,28,7,32
Krasnodar,506,4,9,4,7,32,26,6,31
Zenit,506,5,7,9,4,22,16,6,30
Terek Grozny,506,6,8,5,7,23,25,-2,29
Din Moscow,506,7,5,7,8,19,24,-5,22
Amkar,506,8,6,4,10,13,24,-11,22
FK Rubin,506,9,5,6,9,22,22,0,21
Rostov,506,10,5,6,9,11,17,-6,21
Anzhi,506,11,2,5,13,15,41,-26,11
Loko Moscow,507,1,11,5,4,31,17,14,38
CSKA Moscow,507,2,11,4,5,27,18,9,37
Spart Moscow,507,3,10,5,5,38,31,7,35
Zenit,507,4,8,8,4,22,14,8,32
Krasnodar,507,5,9,4,7,32,27,5,31
Terek Grozny,507,6,7,6,7,22,25,-3,27
FK Rubin,507,7,7,5,8,24,17,7,26
Din Moscow,507,8,6,6,8,21,24,-3,24
Amkar,507,9,5,4,11,13,26,-13,19
Rostov,507,10,4,6,10,11,19,-8,18
Anzhi,507,11,2,7,11,15,38,-23,13
Loko Moscow,508,1,11,5,4,30,15,15,38
Zenit,508,2,9,8,3,24,14,10,35
Spart Moscow,508,3,9,7,4,36,26,10,34
CSKA Moscow,508,4,10,3,7,26,21,5,33
Krasnodar,508,5,9,4,7,32,28,4,31
Terek Grozny,508,6,8,5,7,21,23,-2,29
FK Rubin,508,7,7,5,8,25,19,6,26
Din Moscow,508,8,5,7,8,17,22,-5,22
Rostov,508,9,4,6,10,10,19,-9,18
Amkar,508,10,4,5,11,10,24,-14,17
Anzhi,508,11,4,5,11,17,37,-20,17
Loko Moscow,509,1,11,7,2,31,13,18,40
CSKA Moscow,509,2,10,4,6,26,21,5,34
Zenit,509,3,8,9,3,25,14,11,33
Spart Moscow,509,4,9,5,6,35,32,3,32
Krasnodar,509,5,8,6,6,28,25,3,30
Terek Grozny,509,6,8,5,7,22,23,-1,29
Din Moscow,509,7,6,7,7,21,21,0,25
FK Rubin,509,8,5,7,8,21,17,4,22
Amkar,509,9,6,4,10,13,23,-10,22
Rostov,509,10,4,6,10,10,18,-8,18
Anzhi,509,11,2,6,12,15,40,-25,12
Loko Moscow,510,1,11,6,3,32,15,17,39
CSKA Moscow,510,2,11,3,6,28,18,10,36
Spart Moscow,510,3,10,5,5,38,28,10,35
Zenit,510,4,9,8,3,25,15,10,35
Krasnodar,510,5,8,6,6,29,26,3,30
Terek Grozny,510,6,8,5,7,24,26,-2,29
FK Rubin,510,7,6,6,8,23,18,5,24
Din Moscow,510,8,5,6,9,17,23,-6,21
Rostov,510,9,5,6,9,13,19,-6,21
Amkar,510,10,5,4,11,11,25,-14,19
Anzhi,510,11,2,5,13,16,43,-27,11
Loko Moscow,511,1,12,5,3,30,13,17,41
CSKA Moscow,511,2,12,3,5,28,18,10,39
Spart Moscow,511,3,10,5,5,41,26,15,35
Zenit,511,4,8,8,4,23,14,9,32
Terek Grozny,511,5,9,5,6,23,22,1,32
Krasnodar,511,6,8,5,7,27,25,2,29
Din Moscow,511,7,7,6,7,21,23,-2,27
FK Rubin,511,8,5,6,9,23,20,3,21
Rostov,511,9,4,6,10,10,21,-11,18
Amkar,511,10,4,4,12,9,27,-18,16
Anzhi,511,11,2,5,13,15,41,-26,11
Loko Moscow,512,1,12,5,3,33,14,19,41
CSKA Moscow,512,2,11,3,6,27,18,9,36
Krasnodar,512,3,10,4,6,32,26,6,34
Spart Moscow,512,4,9,6,5,36,29,7,33
Zenit,512,5,8,8,4,22,16,6,32
Terek Grozny,512,6,9,5,6,23,23,0,32
Din Moscow,512,7,5,7,8,20,25,-5,22
FK Rubin,512,8,5,6,9,23,20,3,21
Rostov,512,9,5,6,9,12,17,-5,21
Amkar,512,10,4,5,11,10,24,-14,17
Anzhi,512,11,2,5,13,14,40,-26,11
Loko Moscow,513,1,11,6,3,32,15,17,39
CSKA Moscow,513,2,10,4,6,26,20,6,34
Zenit,513,3,8,9,3,26,16,10,33
Krasnodar,513,4,9,4,7,29,28,1,31
Spart Moscow,513,5,8,5,7,33,28,5,29
Terek Grozny,513,6,8,5,7,24,26,-2,29
Din Moscow,513,7,7,6,7,20,22,-2,27
FK Rubin,513,8,6,5,9,25,19,6,23
Amkar,513,9,6,4,10,13,24,-11,22
Rostov,513,10,5,6,9,11,17,-6,21
Anzhi,513,11,2,6,12,15,39,-24,12
Loko Moscow,514,1,12,5,3,30,14,16,41
CSKA Moscow,514,2,11,3,6,27,19,8,36
Spart Moscow,514,3,9,7,4,36,27,9,34
Zenit,514,4,8,8,4,24,15,9,32
Krasnodar,514,5,8,5,7,27,25,2,29
Terek Grozny,514,6,8,5,7,22,23,-1,29
Din Moscow,514,7,6,7,7,19,22,-3,25
FK Rubin,514,8,5,6,9,22,19,3,21
Rostov,514,9,4,7,9,12,19,-7,19
Anzhi,514,10,4,5,11,17,37,-20,17
Amkar,514,11,4,4,12,9,25,-16,16
Loko Moscow,515,1,11,7,2,31,13,18,40
Spart Moscow,515,2,11,5,4,43,27,16,38
CSKA Moscow,515,3,10,4,6,27,20,7,34
Zenit,515,4,8,9,3,23,14,9,33
Krasnodar,515,5,8,6,6,29,26,3,30
Terek Grozny,515,6,7,6,7,23,26,-3,27
Din Moscow,515,7,6,6,8,18,26,-8,24
FK Rubin,515,8,5,6,9,21,18,3,21
Rostov,515,9,4,6,10,11,19,-8,18
Amkar,515,10,4,5,11,12,27,-15,17
Anzhi,515,11,3,6,11,17,39,-22,15
Loko Moscow,516,1,11,6,3,30,13,17,39
Spart Moscow,516,2,11,5,4,41,26,15,38
Zenit,516,3,9,8,3,25,13,12,35
CSKA Moscow,516,4,10,4,6,26,21,5,34
Krasnodar,516,5,8,6,6,29,26,3,30
Terek Grozny,516,6,7,6,7,22,25,-3,27
FK Rubin,516,7,5,7,8,23,19,4,22
Din Moscow,516,8,5,7,8,18,27,-9,22
Amkar,516,9,5,4,11,10,23,-13,19
Rostov,516,10,4,6,10,11,19,-8,18
Anzhi,516,11,2,7,11,17,40,-23,13
Loko Moscow,517,1,12,6,2,31,11,20,42
CSKA Moscow,517,2,10,4,6,26,20,6,34
Spart Moscow,517,3,9,6,5,34,26,8,33
Zenit,517,4,8,8,4,24,16,8,32
Krasnodar,517,5,9,5,6,32,25,7,32
Terek Grozny,517,6,7,7,6,23,25,-2,28
FK Rubin,517,7,6,5,9,23,22,1,23
Din Moscow,517,8,5,7,8,17,22,-5,22
Amkar,517,9,5,5,10,12,24,-12,20
Rostov,517,10,4,6,10,10,18,-8,18
Anzhi,517,11,2,7,11,15,38,-23,13
Loko Moscow,518,1,12,5,3,32,13,19,41
CSKA Moscow,518,2,12,3,5,29,19,10,39
Krasnodar,518,3,10,4,6,30,24,6,34
Spart Moscow,518,4,8,7,5,36,29,7,31
Terek Grozny,518,5,8,6,6,23,24,-1,30
Zenit,518,6,7,8,5,23,18,5,29
Din Moscow,518,7,7,6,7,20,21,-1,27
FK Rubin,518,8,5,5,10,21,21,0,20
Rostov,518,9,4,7,9,12,19,-7,19
Amkar,518,10,4,5,11,11,25,-14,17
Anzhi,518,11,2,6,12,16,40,-24,12
Loko Moscow,519,1,12,5,3,32,13,19,41
CSKA Moscow,519,2,10,4,6,28,21,7,34
Zenit,519,3,8,9,3,24,15,9,33
Spart Moscow,519,4,9,6,5,35,27,8,33
Krasnodar,519,5,8,5,7,29,28,1,29
Terek Grozny,519,6,7,7,6,21,23,-2,28
Din Moscow,519,7,5,8,7,18,22,-4,23
FK Rubin,519,8,5,7,8,23,19,4,22
Amkar,519,9,5,5,10,10,22,-12,20
Rostov,519,10,4,6,10,11,19,-8,18
Anzhi,519,11,3,6,11,17,39,-22,15
Loko Moscow,520,1,11,6,3,30,13,17,39
CSKA Moscow,520,2,12,3,5,31,18,13,39
Spart Moscow,520,3,10,5,5,38,30,8,35
Krasnodar,520,4,10,4,6,31,25,6,34
Zenit,520,5,7,9,4,22,15,7,30
Terek Grozny,520,6,8,6,6,23,23,0,30
Din Moscow,520,7,5,7,8,17,23,-6,22
FK Rubin,520,8,5,6,9,21,19,2,21
Rostov,520,9,5,6,9,15,18,-3,21
Amkar,520,10,4,4,12,9,26,-17,16
Anzhi,520,11,2,6,12,15,42,-27,12
Loko Moscow,521,1,11,6,3,31,14,17,39
Zenit,521,2,9,8,3,25,14,11,35
CSKA Moscow,521,3,10,4,6,26,20,6,34
Spart Moscow,521,4,9,6,5,38,29,9,33
Krasnodar,521,5,8,6,6,29,26,3,30
Terek Grozny,521,6,8,6,6,24,25,-1,30
Din Moscow,521,7,5,8,7,19,23,-4,23
FK Rubin,521,8,5,7,8,22,18,4,22
Amkar,521,9,5,5,10,10,22,-12,20
Rostov,521,10,4,6,10,11,20,-9,18
Anzhi,521,11,2,6,12,18,42,-24,12
Loko Moscow,522,1,11,7,2,32,14,18,40
CSKA Moscow,522,2,10,5,5,27,19,8,35
Spart Moscow,522,3,9,7,4,39,29,10,34
Krasnodar,522,4,9,5,6,29,25,4,32
Zenit,522,5,7,10,3,24,16,8,31
Terek Grozny,522,6,7,5,8,21,25,-4,26
Din Moscow,522,7,5,8,7,20,24,-4,23
FK Rubin,522,8,5,6,9,23,20,3,21
Amkar,522,9,5,5,10,13,25,-12,20
Rostov,522,10,4,6,10,11,20,-9,18
Anzhi,522,11,3,6,11,16,38,-22,15
Loko Moscow,523,1,12,5,3,33,14,19,41
Spart Moscow,523,2,10,6,4,38,27,11,36
CSKA Moscow,523,3,10,5,5,27,19,8,35
Krasnodar,523,4,9,4,7,30,27,3,31
Zenit,523,5,7,9,4,23,17,6,30
Terek Grozny,523,6,8,6,6,25,25,0,30
FK Rubin,523,7,7,5,8,24,17,7,26
Din Moscow,523,8,5,6,9,17,25,-8,21
Rostov,523,9,4,6,10,10,18,-8,18
Amkar,523,10,4,6,10,13,26,-13,18
Anzhi,523,11,2,6,12,15,40,-25,12
Loko Moscow,524,1,12,5,3,30,12,18,41
Spart Moscow,524,2,10,6,4,40,27,13,36
CSKA Moscow,524,3,10,4,6,30,23,7,34
Krasnodar,524,4,10,4,6,30,25,5,34
Zenit,524,5,8,8,4,24,16,8,32
Terek Grozny,524,6,7,7,6,24,26,-2,28
FK Rubin,524,7,6,5,9,24,20,4,23
Din Moscow,524,8,5,6,9,19,26,-7,21
Rostov,524,9,4,6,10,10,20,-10,18
Amkar,524,10,4,6,10,12,25,-13,18
Anzhi,524,11,2,7,11,19,42,-23,13
Loko Moscow,525,1,12,5,3,30,12,18,41
Spart Moscow,525,2,9,7,4,35,26,9,34
CSKA Moscow,525,3,10,4,6,25,21,4,34
Krasnodar,525,4,9,5,6,29,25,4,32
Zenit,525,5,7,9,4,21,14,7,30
Terek Grozny,525,6,7,7,6,23,25,-2,28
Din Moscow,525,7,6,7,7,19,22,-3,25
FK Rubin,525,8,5,6,9,22,19,3,21
Rostov,525,9,4,7,9,10,17,-7,19
Amkar,525,10,4,5,11,11,25,-14,17
Anzhi,525,11,3,6,11,19,38,-19,15
Loko Moscow,526,1,12,5,3,31,13,18,41
Spart Moscow,526,2,10,6,4,37,27,10,36
CSKA Moscow,526,3,11,3,6,29,21,8,36
Krasnodar,526,4,10,4,6,29,24,5,34
Zenit,526,5,8,8,4,25,16,9,32
Terek Grozny,526,6,7,6,7,23,28,-5,27
Din Moscow,526,7,6,6,8,19,23,-4,24
FK Rubin,526,8,5,5,10,21,19,2,20
Amkar,526,9,5,5,10,14,24,-10,20
Rostov,526,10,4,6,10,11,19,-8,18
Anzhi,526,11,2,6,12,16,41,-25,12
Loko Moscow,527,1,13,5,2,37,12,25,44
Spart Moscow,527,2,9,7,4,34,25,9,34
CSKA Moscow,527,3,10,3,7,27,21,6,33
Zenit,527,4,8,8,4,24,20,4,32
Terek Grozny,527,5,9,5,6,23,22,1,32
Krasnodar,527,6,9,4,7,30,26,4,31
Din Moscow,527,7,6,7,7,19,21,-2,25
FK Rubin,527,8,5,5,10,21,22,-1,20
Rostov,527,9,4,7,9,10,17,-7,19
Amkar,527,10,4,4,12,9,24,-15,16
Anzhi,527,11,3,5,12,16,40,-24,14
Loko Moscow,528,1,12,6,2,31,12,19,42
CSKA Moscow,528,2,10,5,5,27,19,8,35
Zenit,528,3,7,10,3,22,14,8,31
Spart Moscow,528,4,8,7,5,37,30,7,31
Krasnodar,528,5,9,4,7,33,28,5,31
Terek Grozny,528,6,8,6,6,22,23,-1,30
Din Moscow,528,7,6,6,8,19,23,-4,24
FK Rubin,528,8,6,5,9,24,22,2,23
Rostov,528,9,4,7,9,12,19,-7,19
Amkar,528,10,4,6,10,10,23,-13,18
Anzhi,528,11,2,6,12,16,40,-24,12
Loko Moscow,529,1,12,5,3,30,12,18,41
CSKA Moscow,529,2,12,3,5,30,18,12,39
Spart Moscow,529,3,10,5,5,39,29,10,35
Zenit,529,4,8,8,4,22,14,8,32
Krasnodar,529,5,9,4,7,30,26,4,31
Terek Grozny,529,6,7,5,8,22,27,-5,26
Din Moscow,529,7,6,6,8,20,23,-3,24
Amkar,529,8,6,4,10,15,25,-10,22
FK Rubin,529,9,5,5,10,22,22,0,20
Rostov,529,10,4,6,10,10,19,-9,18
Anzhi,529,11,3,5,12,17,42,-25,14
Loko Moscow,530,1,13,5,2,32,11,21,44
CSKA Moscow,530,2,12,3,5,33,18,15,39
Spart Moscow,530,3,9,7,4,37,27,10,34
Terek Grozny,530,4,9,5,6,24,24,0,32
Zenit,530,5,7,8,5,21,16,5,29
Krasnodar,530,6,8,5,7,27,26,1,29
Din Moscow,530,7,6,7,7,20,21,-1,25
FK Rubin,530,8,5,6,9,21,20,1,21
Rostov,530,9,4,6,10,11,20,-9,18
Amkar,530,10,4,5,11,11,25,-14,17
Anzhi,530,11,2,5,13,16,45,-29,11
Loko Moscow,531,1,11,7,2,30,12,18,40
CSKA Moscow,531,2,11,4,5,26,17,9,37
Spart Moscow,531,3,10,5,5,39,28,11,35
Zenit,531,4,7,10,3,22,14,8,31
Krasnodar,531,5,8,6,6,28,25,3,30
Terek Grozny,531,6,7,6,7,21,24,-3,27
Din Moscow,531,7,6,6,8,19,24,-5,24
FK Rubin,531,8,5,6,9,22,20,2,21
Rostov,531,9,5,6,9,12,17,-5,21
Amkar,531,10,4,5,11,10,25,-15,17
Anzhi,531,11,3,5,12,16,39,-23,14
Loko Moscow,532,1,12,6,2,32,13,19,42
CSKA Moscow,532,2,11,4,5,27,18,9,37
Spart Moscow,532,3,10,6,4,38,26,12,36
Zenit,532,4,7,10,3,23,15,8,31
Krasnodar,532,5,9,4,7,31,26,5,31
Terek Grozny,532,6,8,5,7,21,24,-3,29
Din Moscow,532,7,6,6,8,19,25,-6,24
FK Rubin,532,8,5,5,10,21,21,0,20
Rostov,532,9,4,7,9,10,17,-7,19
Amkar,532,10,4,4,12,9,24,-15,16
Anzhi,532,11,3,5,12,16,38,-22,14
Loko Moscow,533,1,12,6,2,32,13,19,42
CSKA Moscow,533,2,11,3,6,26,19,7,36
Zenit,533,3,8,9,3,24,14,10,33
Krasnodar,533,4,9,4,7,31,27,4,31
Spart Moscow,533,5,8,6,6,37,32,5,30
Din Moscow,533,6,7,6,7,25,25,0,27
Terek Grozny,533,7,7,6,7,21,26,-5,27
Rostov,533,8,5,6,9,12,17,-5,21
FK Rubin,533,9,5,5,10,23,24,-1,20
Amkar,533,10,4,6,10,11,24,-13,18
Anzhi,533,11,3,5,12,17,38,-21,14
Loko Moscow,534,1,13,5,2,31,11,20,44
CSKA Moscow,534,2,12,3,5,27,17,10,39
Krasnodar,534,3,9,4,7,28,25,3,31
Spart Moscow,534,4,8,6,6,35,30,5,30
Zenit,534,5,7,8,5,21,15,6,29
Terek Grozny,534,6,7,5,8,22,27,-5,26
Din Moscow,534,7,6,7,7,20,23,-3,25
Amkar,534,8,6,4,10,13,23,-10,22
Rostov,534,9,5,6,9,12,17,-5,21
FK Rubin,534,10,5,5,10,21,19,2,20
Anzhi,534,11,3,5,12,16,39,-23,14
Loko Moscow,535,1,13,5,2,34,12,22,44
Spart Moscow,535,2,10,5,5,40,29,11,35
CSKA Moscow,535,3,10,4,6,26,20,6,34
Zenit,535,4,7,9,4,21,14,7,30
Terek Grozny,535,5,8,5,7,22,24,-2,29
Krasnodar,535,6,8,4,8,28,29,-1,28
FK Rubin,535,7,7,5,8,25,19,6,26
Amkar,535,8,6,4,10,13,23,-10,22
Din Moscow,535,9,5,6,9,19,28,-9,21
Rostov,535,10,4,6,10,11,19,-8,18
Anzhi,535,11,3,5,12,18,40,-22,14
Loko Moscow,536,1,12,5,3,33,14,19,41
Spart Moscow,536,2,10,6,4,37,26,11,36
CSKA Moscow,536,3,10,4,6,27,20,7,34
Zenit,536,4,8,8,4,22,15,7,32
Krasnodar,536,5,9,4,7,31,28,3,31
Terek Grozny,536,6,8,5,7,22,24,-2,29
FK Rubin,536,7,6,6,8,23,18,5,24
Din Moscow,536,8,5,8,7,17,21,-4,23
Amkar,536,9,5,4,11,12,26,-14,19
Rostov,536,10,4,6,10,10,18,-8,18
Anzhi,536,11,2,6,12,16,40,-24,12
Loko Moscow,537,1,11,6,3,30,13,17,39
CSKA Moscow,537,2,10,4,6,28,21,7,34
Zenit,537,3,8,9,3,25,16,9,33
Spart Moscow,537,4,8,7,5,36,31,5,31
Krasnodar,537,5,8,5,7,27,25,2,29
Terek Grozny,537,6,7,7,6,22,24,-2,28
Din Moscow,537,7,6,7,7,21,24,-3,25
FK Rubin,537,8,6,5,9,22,18,4,23
Amkar,537,9,5,5,10,13,23,-10,20
Rostov,537,10,4,7,9,10,17,-7,19
Anzhi,537,11,3,6,11,17,39,-22,15
Loko Moscow,538,1,12,5,3,31,12,19,41
Spart Moscow,538,2,10,6,4,41,30,11,36
CSKA Moscow,538,3,10,5,5,27,19,8,35
Krasnodar,538,4,9,5,6,29,25,4,32
Zenit,538,5,7,9,4,22,16,6,30
Terek Grozny,538,6,8,5,7,23,24,-1,29
Din Moscow,538,7,6,6,8,22,26,-4,24
FK Rubin,538,8,5,6,9,23,21,2,21
Rostov,538,9,4,6,10,13,21,-8,18
Amkar,538,10,4,5,11,9,25,-16,17
Anzhi,538,11,3,6,11,17,38,-21,15
Loko Moscow,539,1,11,6,3,31,14,17,39
CSKA Moscow,539,2,12,3,5,31,19,12,39
Spart Moscow,539,3,10,6,4,45,31,14,36
Zenit,539,4,8,8,4,23,16,7,32
Krasnodar,539,5,8,6,6,29,26,3,30
Terek Grozny,539,6,8,5,7,22,24,-2,29
Din Moscow,539,7,6,7,7,22,25,-3,25
FK Rubin,539,8,5,6,9,21,18,3,21
Amkar,539,9,5,4,11,12,27,-15,19
Rostov,539,10,4,6,10,11,21,-10,18
Anzhi,539,11,2,5,13,15,41,-26,11
Loko Moscow,540,1,13,5,2,31,11,20,44
CSKA Moscow,540,2,11,3,6,27,19,8,36
Spart Moscow,540,3,10,5,5,36,28,8,35
Zenit,540,4,7,8,5,22,16,6,29
Krasnodar,540,5,8,4,8,28,27,1,28
Din Moscow,540,6,7,6,7,21,22,-1,27
Terek Grozny,540,7,7,6,7,20,25,-5,27
FK Rubin,540,8,6,5,9,24,20,4,23
Rostov,540,9,4,6,10,11,19,-8,18
Amkar,540,10,4,5,11,9,23,-14,17
Anzhi,540,11,4,5,11,18,37,-19,17
Loko Moscow,541,1,12,6,2,31,12,19,42
Spart Moscow,541,2,10,6,4,36,26,10,36
CSKA Moscow,541,3,11,3,6,26,19,7,36
Krasnodar,541,4,9,5,6,30,25,5,32
Zenit,541,5,7,8,5,21,15,6,29
Terek Grozny,541,6,8,5,7,22,24,-2,29
Din Moscow,541,7,5,8,7,20,24,-4,23
FK Rubin,541,8,5,6,9,23,21,2,21
Rostov,541,9,4,6,10,10,18,-8,18
Anzhi,541,10,4,5,11,18,38,-20,17
Amkar,541,11,4,4,12,9,24,-15,16
Loko Moscow,542,1,11,7,2,32,14,18,40
CSKA Moscow,542,2,12,3,5,30,18,12,39
Spart Moscow,542,3,9,7,4,37,27,10,34
Krasnodar,542,4,9,5,6,31,27,4,32
Zenit,542,5,7,9,4,23,16,7,30
Terek Grozny,542,6,8,6,6,22,23,-1,30
Din Moscow,542,7,6,7,7,21,22,-1,25
FK Rubin,542,8,5,5,10,22,22,0,20
Rostov,542,9,4,7,9,11,18,-7,19
Amkar,542,10,4,5,11,10,25,-15,17
Anzhi,542,11,2,5,13,14,41,-27,11
Loko Moscow,543,1,12,6,2,34,13,21,42
Spart Moscow,543,2,10,6,4,42,31,11,36
CSKA Moscow,543,3,11,3,6,28,21,7,36
Zenit,543,4,8,9,3,26,15,11,33
Krasnodar,543,5,8,4,8,27,28,-1,28
Terek Grozny,543,6,7,7,6,20,22,-2,28
Din Moscow,543,7,6,7,7,20,23,-3,25
FK Rubin,543,8,6,5,9,22,18,4,23
Rostov,543,9,4,6,10,11,20,-9,18
Amkar,543,10,4,5,11,12,26,-14,17
Anzhi,543,11,2,6,12,15,40,-25,12
Loko Moscow,544,1,11,6,3,29,12,17,39
Zenit,544,2,9,8,3,24,13,11,35
CSKA Moscow,544,3,10,4,6,27,21,6,34
Spart Moscow,544,4,8,7,5,36,31,5,31
Krasnodar,544,5,8,6,6,27,24,3,30
Terek Grozny,544,6,7,5,8,23,27,-4,26
FK Rubin,544,7,6,6,8,23,18,5,24
Din Moscow,544,8,5,7,8,19,24,-5,22
Rostov,544,9,5,6,9,14,18,-4,21
Amkar,544,10,5,5,10,12,24,-12,20
Anzhi,544,11,3,6,11,19,41,-22,15
Loko Moscow,545,1,12,6,2,31,12,19,42
CSKA Moscow,545,2,11,3,6,28,24,4,36
Spart Moscow,545,3,9,7,4,37,28,9,34
Zenit,545,4,8,9,3,29,14,15,33
Krasnodar,545,5,9,4,7,29,25,4,31
Terek Grozny,545,6,8,5,7,25,24,1,29
Din Moscow,545,7,6,6,8,21,24,-3,24
FK Rubin,545,8,5,5,10,21,21,0,20
Amkar,545,9,5,5,10,10,22,-12,20
Rostov,545,10,4,7,9,11,18,-7,19
Anzhi,545,11,2,5,13,15,45,-30,11
Loko Moscow,546,1,11,6,3,30,13,17,39
CSKA Moscow,546,2,11,4,5,29,18,11,37
Spart Moscow,546,3,8,8,4,35,27,8,32
Krasnodar,546,4,9,5,6,28,24,4,32
Zenit,546,5,7,10,3,22,14,8,31
Terek Grozny,546,6,7,5,8,21,26,-5,26
Din Moscow,546,7,6,7,7,20,22,-2,25
FK Rubin,546,8,5,6,9,22,20,2,21
Amkar,546,9,5,5,10,11,23,-12,20
Rostov,546,10,4,7,9,11,18,-7,19
Anzhi,546,11,3,5,12,18,42,-24,14
Loko Moscow,547,1,11,6,3,31,15,16,39
CSKA Moscow,547,2,11,3,6,27,19,8,36
Zenit,547,3,8,9,3,23,14,9,33
Spart Moscow,547,4,8,8,4,37,29,8,32
Terek Grozny,547,5,9,5,6,25,23,2,32
Krasnodar,547,6,9,4,7,30,26,4,31
Din Moscow,547,7,6,7,7,19,22,-3,25
FK Rubin,547,8,6,5,9,23,19,4,23
Rostov,547,9,4,7,9,12,19,-7,19
Amkar,547,10,4,5,11,11,25,-14,17
Anzhi,547,11,2,5,13,16,43,-27,11
Loko Moscow,548,1,11,5,4,30,14,16,38
CSKA Moscow,548,2,10,5,5,27,19,8,35
Spart Moscow,548,3,9,7,4,36,27,9,34
Krasnodar,548,4,10,4,6,30,25,5,34
Zenit,548,5,8,9,3,23,14,9,33
Terek Grozny,548,6,8,5,7,21,23,-2,29
Din Moscow,548,7,5,8,7,19,23,-4,23
FK Rubin,548,8,5,6,9,22,19,3,21
Rostov,548,9,4,6,10,11,19,-8,18
Amkar,548,10,4,5,11,9,23,-14,17
Anzhi,548,11,3,6,11,16,38,-22,15
Loko Moscow,549,1,11,5,4,29,13,16,38
CSKA Moscow,549,2,11,3,6,26,18,8,36
Spart Moscow,549,3,9,6,5,35,28,7,33
Zenit,549,4,8,8,4,22,14,8,32
Krasnodar,549,5,9,4,7,28,27,1,31
Terek Grozny,549,6,8,5,7,23,26,-3,29
Din Moscow,549,7,6,6,8,20,24,-4,24
FK Rubin,549,8,6,5,9,25,19,6,23
Amkar,549,9,6,4,10,13,22,-9,22
Rostov,549,10,4,7,9,10,17,-7,19
Anzhi,549,11,3,5,12,17,40,-23,14
Loko Moscow,550,1,11,6,3,31,15,16,39
CSKA Moscow,550,2,11,3,6,26,20,6,36
Zenit,550,3,9,8,3,26,13,13,35
Spart Moscow,550,4,10,5,5,36,26,10,35
Terek Grozny,550,5,8,6,6,23,24,-1,30
Krasnodar,550,6,8,5,7,30,28,2,29
FK Rubin,550,7,7,5,8,25,19,6,26
Din Moscow,550,8,5,6,9,18,25,-7,21
Amkar,550,9,5,5,10,11,23,-12,20
Rostov,550,10,4,6,10,10,18,-8,18
Anzhi,550,11,2,5,13,15,40,-25,11
Loko Moscow,551,1,12,5,3,31,13,18,41
CSKA Moscow,551,2,11,3,6,29,19,10,36
Spart Moscow,551,3,10,5,5,35,28,7,35
Zenit,551,4,8,8,4,23,14,9,32
Krasnodar,551,5,9,4,7,29,26,3,31
Terek Grozny,551,6,7,6,7,22,25,-3,27
Din Moscow,551,7,6,6,8,18,22,-4,24
FK Rubin,551,8,6,5,9,22,18,4,23
Amkar,551,9,6,4,10,13,22,-9,22
Rostov,551,10,4,6,10,10,18,-8,18
Anzhi,551,11,2,6,12,16,43,-27,12
Loko Moscow,552,1,11,5,4,29,14,15,38
Spart Moscow,552,2,10,6,4,36,25,11,36
Zenit,552,3,9,8,3,25,14,11,35
CSKA Moscow,552,4,10,4,6,27,20,7,34
Krasnodar,552,5,9,4,7,28,25,3,31
Terek Grozny,552,6,7,6,7,21,25,-4,27
Din Moscow,552,7,6,6,8,18,23,-5,24
FK Rubin,552,8,6,5,9,22,18,4,23
Rostov,552,9,4,6,10,10,18,-8,18
Amkar,552,10,4,6,10,10,23,-13,18
Anzhi,552,11,3,6,11,17,38,-21,15
Loko Moscow,553,1,12,5,3,31,13,18,41
CSKA Moscow,553,2,11,4,5,28,19,9,37
Spart Moscow,553,3,9,7,4,36,25,11,34
Krasnodar,553,4,10,4,6,31,25,6,34
Zenit,553,5,7,9,4,22,16,6,30
Terek Grozny,553,6,8,5,7,21,25,-4,29
Din Moscow,553,7,5,7,8,18,25,-7,22
FK Rubin,553,8,5,6,9,23,20,3,21
Rostov,553,9,4,7,9,10,17,-7,19
Amkar,553,10,4,5,11,9,23,-14,17
Anzhi,553,11,3,5,12,18,39,-21,14
Loko Moscow,554,1,13,5,2,32,12,20,44
Spart Moscow,554,2,10,5,5,36,28,8,35
CSKA Moscow,554,3,10,4,6,27,20,7,34
Zenit,554,4,8,8,4,23,15,8,32
Terek Grozny,554,5,9,5,6,22,22,0,32
Krasnodar,554,6,8,5,7,28,26,2,29
Din Moscow,554,7,6,6,8,18,22,-4,24
FK Rubin,554,8,5,6,9,21,18,3,21
Amkar,554,9,5,4,11,11,23,-12,19
Rostov,554,10,4,6,10,11,19,-8,18
Anzhi,554,11,2,6,12,15,39,-24,12
Loko Moscow,555,1,11,5,4,29,19,10,38
CSKA Moscow,555,2,11,3,6,30,22,8,36
Zenit,555,3,9,8,3,31,15,16,35
Spart Moscow,555,4,9,7,4,37,26,11,34
Krasnodar,555,5,10,4,6,31,24,7,34
Terek Grozny,555,6,8,6,6,21,22,-1,30
FK Rubin,555,7,6,5,9,22,18,4,23
Din Moscow,555,8,5,6,9,17,25,-8,21
Rostov,555,9,4,7,9,10,17,-7,19
Amkar,555,10,4,6,10,10,23,-13,18
Anzhi,555,11,2,5,13,14,41,-27,11
Loko Moscow,556,1,11,6,3,30,14,16,39
Spart Moscow,556,2,10,6,4,39,27,12,36
CSKA Moscow,556,3,11,3,6,30,20,10,36
Zenit,556,4,8,9,3,25,15,10,33
Krasnodar,556,5,9,5,6,29,24,5,32
Terek Grozny,556,6,7,6,7,21,25,-4,27
Din Moscow,556,7,6,6,8,21,25,-4,24
FK Rubin,556,8,5,6,9,21,20,1,21
Amkar,556,9,5,5,10,12,23,-11,20
Rostov,556,10,4,6,10,10,18,-8,18
Anzhi,556,11,2,6,12,15,42,-27,12
Loko Moscow,557,1,13,5,2,32,12,20,44
CSKA Moscow,557,2,10,4,6,27,21,6,34
Zenit,557,3,8,8,4,23,14,9,32
Spart Moscow,557,4,8,8,4,36,28,8,32
Terek Grozny,557,5,8,6,6,22,23,-1,30
Krasnodar,557,6,8,5,7,28,26,2,29
Din Moscow,557,7,6,7,7,21,23,-2,25
FK Rubin,557,8,5,6,9,22,20,2,21
Rostov,557,9,4,7,9,11,18,-7,19
Amkar,557,10,4,6,10,10,23,-13,18
Anzhi,557,11,2,6,12,17,41,-24,12
Loko Moscow,558,1,11,5,4,29,15,14,38
Zenit,558,2,9,8,3,24,14,10,35
CSKA Moscow,558,3,10,4,6,28,21,7,34
Spart Moscow,558,4,9,5,6,38,29,9,32
Krasnodar,558,5,9,5,6,32,26,6,32
Terek Grozny,558,6,8,6,6,21,22,-1,30
Din Moscow,558,7,7,6,7,21,22,-1,27
FK Rubin,558,8,5,6,9,23,21,2,21
Amkar,558,9,5,5,10,11,22,-11,20
Rostov,558,10,4,6,10,10,21,-11,18
Anzhi,558,11,2,6,12,16,40,-24,12
Loko Moscow,559,1,12,5,3,32,15,17,41
Spart Moscow,559,2,10,5,5,38,31,7,35
CSKA Moscow,559,3,10,4,6,25,18,7,34
Zenit,559,4,8,8,4,23,16,7,32
Krasnodar,559,5,9,4,7,31,26,5,31
Terek Grozny,559,6,8,6,6,24,24,0,30
FK Rubin,559,7,6,6,8,25,20,5,24
Din Moscow,559,8,5,7,8,20,25,-5,22
Amkar,559,9,5,4,11,14,26,-12,19
Rostov,559,10,4,6,10,11,19,-8,18
Anzhi,559,11,2,7,11,15,38,-23,13
Loko Moscow,560,1,11,6,3,29,12,17,39
CSKA Moscow,560,2,12,3,5,29,17,12,39
Krasnodar,560,3,9,5,6,28,24,4,32
Spart Moscow,560,4,8,7,5,35,28,7,31
Zenit,560,5,7,9,4,21,15,6,30
Terek Grozny,560,6,7,5,8,21,25,-4,26
Din Moscow,560,7,6,7,7,20,22,-2,25
Amkar,560,8,6,4,10,12,23,-11,22
FK Rubin,560,9,5,6,9,22,20,2,21
Rostov,560,10,4,7,9,11,18,-7,19
Anzhi,560,11,3,5,12,16,40,-24,14
Loko Moscow,561,1,12,5,3,32,14,18,41
CSKA Moscow,561,2,11,3,6,27,21,6,36
Spart Moscow,561,3,9,5,6,40,32,8,32
Zenit,561,4,8,8,4,25,17,8,32
Krasnodar,561,5,9,5,6,30,24,6,32
Terek Grozny,561,6,8,5,7,22,23,-1,29
Din Moscow,561,7,6,6,8,20,26,-6,24
FK Rubin,561,8,5,6,9,21,18,3,21
Rostov,561,9,5,6,9,12,18,-6,21
Amkar,561,10,5,4,11,12,25,-13,19
Anzhi,561,11,3,5,12,15,38,-23,14
Loko Moscow,562,1,12,5,3,32,14,18,41
Zenit,562,2,9,8,3,25,15,10,35
CSKA Moscow,562,3,10,4,6,28,21,7,34
Spart Moscow,562,4,9,6,5,36,28,8,33
Terek Grozny,562,5,8,5,7,21,23,-2,29
Krasnodar,562,6,8,4,8,29,28,1,28
FK Rubin,562,7,7,5,8,24,17,7,26
Din Moscow,562,8,5,7,8,18,24,-6,22
Rostov,562,9,5,6,9,11,17,-6,21
Amkar,562,10,5,4,11,11,24,-13,19
Anzhi,562,11,2,6,12,15,39,-24,12
Loko Moscow,563,1,13,5,2,35,14,21,44
Spart Moscow,563,2,10,6,4,42,27,15,36
CSKA Moscow,563,3,11,3,6,27,18,9,36
Zenit,563,4,8,8,4,23,15,8,32
Terek Grozny,563,5,8,6,6,24,24,0,30
Krasnodar,563,6,8,5,7,30,29,1,29
Din Moscow,563,7,6,6,8,20,26,-6,24
FK Rubin,563,8,5,6,9,22,19,3,21
Rostov,563,9,4,7,9,10,17,-7,19
Amkar,563,10,4,5,11,11,28,-17,17
Anzhi,563,11,2,5,13,14,41,-27,11
Loko Moscow,564,1,11,6,3,29,13,16,39
CSKA Moscow,564,2,11,4,5,27,18,9,37
Spart Moscow,564,3,10,5,5,41,29,12,35
Zenit,564,4,8,9,3,23,13,10,33
Krasnodar,564,5,8,6,6,27,24,3,30
Terek Grozny,564,6,8,5,7,23,24,-1,29
FK Rubin,564,7,5,7,8,22,18,4,22
Din Moscow,564,8,5,7,8,19,26,-7,22
Rostov,564,9,5,6,9,12,17,-5,21
Amkar,564,10,5,4,11,11,26,-15,19
Anzhi,564,11,2,5,13,16,42,-26,11
Loko Moscow,565,1,11,6,3,29,12,17,39
Spart Moscow,565,2,11,5,4,40,27,13,38
CSKA Moscow,565,3,11,4,5,28,18,10,37
Zenit,565,4,8,9,3,22,13,9,33
Krasnodar,565,5,8,5,7,28,26,2,29
Terek Grozny,565,6,8,5,7,22,24,-2,29
Din Moscow,565,7,6,6,8,20,24,-4,24
FK Rubin,565,8,6,5,9,24,20,4,23
Amkar,565,9,5,4,11,11,25,-14,19
Rostov,565,10,4,6,10,11,20,-9,18
Anzhi,565,11,2,5,13,15,41,-26,11
Loko Moscow,566,1,11,5,4,29,13,16,38
Spart Moscow,566,2,11,5,4,40,27,13,38
CSKA Moscow,566,3,11,4,5,26,17,9,37
Zenit,566,4,8,9,3,22,13,9,33
Krasnodar,566,5,9,4,7,28,26,2,31
Terek Grozny,566,6,7,7,6,22,24,-2,28
FK Rubin,566,7,6,6,8,23,17,6,24
Din Moscow,566,8,5,7,8,18,25,-7,22
Rostov,566,9,4,6,10,10,18,-8,18
Amkar,566,10,4,5,11,11,25,-14,17
Anzhi,566,11,2,6,12,15,39,-24,12
Loko Moscow,567,1,11,7,2,30,12,18,40
Spart Moscow,567,2,10,6,4,39,28,11,36
CSKA Moscow,567,3,11,3,6,27,19,8,36
Zenit,567,4,8,9,3,24,15,9,33
Krasnodar,567,5,9,5,6,28,24,4,32
Terek Grozny,567,6,8,6,6,24,24,0,30
Din Moscow,567,7,6,6,8,21,25,-4,24
FK Rubin,567,8,5,5,10,21,20,1,20
Rostov,567,9,4,6,10,10,18,-8,18
Amkar,567,10,4,5,11,10,25,-15,17
Anzhi,567,11,2,6,12,16,40,-24,12
Loko Moscow,568,1,12,6,2,33,12,21,42
CSKA Moscow,568,2,11,4,5,27,17,10,37
Spart Moscow,568,3,10,5,5,39,30,9,35
Zenit,568,4,7,9,4,21,16,5,30
Krasnodar,568,5,8,6,6,30,27,3,30
Terek Grozny,568,6,7,7,6,25,27,-2,28
FK Rubin,568,7,6,6,8,24,19,5,24
Din Moscow,568,8,5,6,9,20,26,-6,21
Amkar,568,9,5,5,10,11,23,-12,20
Rostov,568,10,4,6,10,11,19,-8,18
Anzhi,568,11,2,6,12,18,43,-25,12
Loko Moscow,569,1,12,6,2,31,12,19,42
CSKA Moscow,569,2,11,4,5,26,17,9,37
Spart Moscow,569,3,10,5,5,41,29,12,35
Zenit,569,4,7,10,3,22,14,8,31
Terek Grozny,569,5,8,6,6,22,23,-1,30
Krasnodar,569,6,8,4,8,27,27,0,28
FK Rubin,569,7,7,5,8,24,17,7,26
Din Moscow,569,8,5,6,9,18,25,-7,21
Amkar,569,9,5,4,11,11,24,-13,19
Rostov,569,10,4,6,10,11,21,-10,18
Anzhi,569,11,2,6,12,15,39,-24,12
Loko Moscow,570,1,12,6,2,31,12,19,42
CSKA Moscow,570,2,11,3,6,27,19,8,36
Spart Moscow,570,3,9,6,5,40,31,9,33
Terek Grozny,570,4,8,6,6,22,23,-1,30
Zenit,570,5,7,8,5,23,17,6,29
Krasnodar,570,6,8,5,7,28,26,2,29
FK Rubin,570,7,7,5,8,25,19,6,26
Din Moscow,570,8,5,7,8,20,25,-5,22
Amkar,570,9,5,5,10,14,24,-10,20
Rostov,570,10,4,6,10,10,21,-11,18
Anzhi,570,11,3,5,12,15,38,-23,14
Loko Moscow,571,1,12,6,2,32,12,20,42
CSKA Moscow,571,2,11,3,6,29,21,8,36
Spart Moscow,571,3,9,6,5,38,28,10,33
Zenit,571,4,8,8,4,25,16,9,32
Krasnodar,571,5,9,5,6,29,25,4,32
Terek Grozny,571,6,8,6,6,22,23,-1,30
Din Moscow,571,7,7,6,7,19,21,-2,27
FK Rubin,571,8,5,5,10,21,19,2,20
Rostov,571,9,4,6,10,10,20,-10,18
Amkar,571,10,4,6,10,12,25,-13,18
Anzhi,571,11,2,5,13,14,41,-27,11
Loko Moscow,572,1,12,6,2,31,12,19,42
Spart Moscow,572,2,10,6,4,37,26,11,36
CSKA Moscow,572,3,11,3,6,28,19,9,36
Zenit,572,4,8,9,3,23,14,9,33
Terek Grozny,572,5,8,6,6,24,25,-1,30
Krasnodar,572,6,8,4,8,27,26,1,28
FK Rubin,572,7,6,6,8,22,17,5,24
Din Moscow,572,8,5,7,8,17,23,-6,22
Rostov,572,9,4,7,9,11,18,-7,19
Amkar,572,10,4,5,11,10,24,-14,17
Anzhi,572,11,2,5,13,17,43,-26,11
Loko Moscow,573,1,12,6,2,31,12,19,42
CSKA Moscow,573,2,12,3,5,29,19,10,39
Spart Moscow,573,3,9,6,5,36,27,9,33
Krasnodar,573,4,9,5,6,30,25,5,32
Zenit,573,5,7,8,5,23,17,6,29
Terek Grozny,573,6,8,5,7,22,25,-3,29
Din Moscow,573,7,7,6,7,22,23,-1,27
FK Rubin,573,8,5,5,10,22,22,0,20
Rostov,573,9,4,7,9,10,17,-7,19
Amkar,573,10,4,4,12,9,25,-16,16
Anzhi,573,11,3,5,12,17,39,-22,14
Loko Moscow,574,1,12,6,2,31,12,19,42
CSKA Moscow,574,2,11,4,5,28,18,10,37
Spart Moscow,574,3,9,6,5,37,30,7,33
Zenit,574,4,7,9,4,21,14,7,30
Krasnodar,574,5,8,5,7,29,27,2,29
Terek Grozny,574,6,7,5,8,21,25,-4,26
Din Moscow,574,7,6,7,7,20,22,-2,25
FK Rubin,574,8,6,6,8,23,18,5,24
Rostov,574,9,4,7,9,11,18,-7,19
Amkar,574,10,5,4,11,11,24,-13,19
Anzhi,574,11,3,5,12,17,41,-24,14
Loko Moscow,575,1,11,5,4,29,16,13,38
CSKA Moscow,575,2,11,3,6,28,19,9,36
Zenit,575,3,9,8,3,26,13,13,35
Spart Moscow,575,4,8,8,4,41,33,8,32
Krasnodar,575,5,9,5,6,30,26,4,32
Terek Grozny,575,6,8,6,6,24,24,0,30
Din Moscow,575,7,5,8,7,22,26,-4,23
FK Rubin,575,8,5,7,8,25,21,4,22
Rostov,575,9,4,7,9,12,19,-7,19
Amkar,575,10,4,5,11,12,27,-15,17
Anzhi,575,11,2,6,12,17,42,-25,12
Loko Moscow,576,1,12,5,3,34,16,18,41
CSKA Moscow,576,2,11,4,5,27,18,9,37
Spart Moscow,576,3,9,7,4,40,28,12,34
Zenit,576,4,8,8,4,24,16,8,32
Krasnodar,576,5,8,5,7,29,27,2,29
Terek Grozny,576,6,7,6,7,22,25,-3,27
FK Rubin,576,7,5,7,8,23,19,4,22
Din Moscow,576,8,5,7,8,20,28,-8,22
Rostov,576,9,4,7,9,11,18,-7,19
Amkar,576,10,4,6,10,11,24,-13,18
Anzhi,576,11,3,6,11,17,39,-22,15
Loko Moscow,577,1,12,5,3,32,13,19,41
CSKA Moscow,577,2,11,3,6,27,19,8,36
Spart Moscow,577,3,10,5,5,45,29,16,35
Krasnodar,577,4,9,5,6,28,24,4,32
Zenit,577,5,7,8,5,22,17,5,29
Terek Grozny,577,6,8,5,7,23,24,-1,29
Din Moscow,577,7,7,6,7,22,23,-1,27
FK Rubin,577,8,5,6,9,22,20,2,21
Rostov,577,9,4,6,10,11,23,-12,18
Anzhi,577,10,4,5,11,18,38,-20,17
Amkar,577,11,4,4,12,10,30,-20,16
Loko Moscow,578,1,12,6,2,34,13,21,42
CSKA Moscow,578,2,11,3,6,27,19,8,36
Spart Moscow,578,3,10,5,5,39,27,12,35
Krasnodar,578,4,9,5,6,33,26,7,32
Zenit,578,5,8,8,4,23,17,6,32
Terek Grozny,578,6,7,5,8,21,27,-6,26
Din Moscow,578,7,6,6,8,18,23,-5,24
Rostov,578,8,5,6,9,12,18,-6,21
FK Rubin,578,9,5,5,10,21,22,-1,20
Amkar,578,10,5,4,11,12,25,-13,19
Anzhi,578,11,3,5,12,16,39,-23,14
Loko Moscow,579,1,12,5,3,32,14,18,41
CSKA Moscow,579,2,11,3,6,27,19,8,36
Spart Moscow,579,3,9,6,5,41,32,9,33
Zenit,579,4,8,8,4,23,16,7,32
Krasnodar,579,5,9,4,7,30,29,1,31
Terek Grozny,579,6,8,6,6,24,24,0,30
FK Rubin,579,7,6,6,8,27,19,8,24
Din Moscow,579,8,5,7,8,18,25,-7,22
Rostov,579,9,5,6,9,15,20,-5,21
Amkar,579,10,4,5,11,11,26,-15,17
Anzhi,579,11,2,6,12,17,41,-24,12
Loko Moscow,580,1,12,5,3,32,13,19,41
CSKA Moscow,580,2,11,3,6,27,19,8,36
Spart Moscow,580,3,10,5,5,39,29,10,35
Zenit,580,4,8,8,4,24,16,8,32
Krasnodar,580,5,9,4,7,30,27,3,31
Terek Grozny,580,6,8,5,7,21,26,-5,29
Din Moscow,580,7,5,7,8,18,25,-7,22
FK Rubin,580,8,5,6,9,23,21,2,21
Amkar,580,9,5,4,11,12,23,-11,19
Rostov,580,10,4,6,10,11,20,-9,18
Anzhi,580,11,4,5,11,19,37,-18,17
Loko Moscow,581,1,11,6,3,29,13,16,39
CSKA Moscow,581,2,11,3,6,30,20,10,36
Zenit,581,3,9,8,3,25,14,11,35
Spart Moscow,581,4,8,6,6,35,29,6,30
Krasnodar,581,5,8,5,7,30,28,2,29
Terek Grozny,581,6,8,5,7,23,24,-1,29
FK Rubin,581,7,7,5,8,26,20,6,26
Din Moscow,581,8,6,6,8,18,22,-4,24
Rostov,581,9,5,6,9,13,19,-6,21
Amkar,581,10,5,5,10,11,23,-12,20
Anzhi,581,11,2,5,13,15,43,-28,11
Loko Moscow,582,1,12,6,2,33,12,21,42
CSKA Moscow,582,2,11,4,5,28,19,9,37
Spart Moscow,582,3,10,6,4,36,25,11,36
Zenit,582,4,7,10,3,24,16,8,31
Terek Grozny,582,5,8,6,6,22,23,-1,30
Krasnodar,582,6,8,5,7,27,27,0,29
FK Rubin,582,7,5,7,8,22,18,4,22
Din Moscow,582,8,5,7,8,18,23,-5,22
Rostov,582,9,4,6,10,10,19,-9,18
Amkar,582,10,4,5,11,10,24,-14,17
Anzhi,582,11,2,6,12,14,38,-24,12
Loko Moscow,583,1,12,6,2,32,12,20,42
CSKA Moscow,583,2,11,4,5,29,19,10,37
Spart Moscow,583,3,8,7,5,35,28,7,31
Zenit,583,4,7,9,4,23,17,6,30
Terek Grozny,583,5,8,6,6,22,23,-1,30
Krasnodar,583,6,8,5,7,29,27,2,29
FK Rubin,583,7,7,5,8,24,18,6,26
Din Moscow,583,8,5,7,8,18,23,-5,22
Rostov,583,9,5,6,9,11,17,-6,21
Amkar,583,10,4,5,11,11,25,-14,17
Anzhi,583,11,2,6,12,14,39,-25,12
Loko Moscow,584,1,11,6,3,31,14,17,39
CSKA Moscow,584,2,11,4,5,27,18,9,37
Spart Moscow,584,3,9,7,4,39,29,10,34
Krasnodar,584,4,10,4,6,33,26,7,34
Terek Grozny,584,5,9,5,6,22,22,0,32
Zenit,584,6,7,10,3,23,15,8,31
FK Rubin,584,7,6,5,9,24,22,2,23
Din Moscow,584,8,5,7,8,21,26,-5,22
Rostov,584,9,4,6,10,10,19,-9,18
Amkar,584,10,4,5,11,10,24,-14,17
Anzhi,584,11,2,5,13,14,39,-25,11
Loko Moscow,585,1,11,6,3,31,15,16,39
Zenit,585,2,9,8,3,24,13,11,35
CSKA Moscow,585,3,10,4,6,26,19,7,34
Spart Moscow,585,4,8,6,6,34,28,6,30
Krasnodar,585,5,8,6,6,31,28,3,30
Terek Grozny,585,6,8,6,6,25,24,1,30
FK Rubin,585,7,6,6,8,24,19,5,24
Din Moscow,585,8,6,6,8,18,22,-4,24
Amkar,585,9,5,5,10,10,22,-12,20
Rostov,585,10,4,7,9,11,18,-7,19
Anzhi,585,11,2,6,12,17,43,-26,12
Loko Moscow,586,1,12,5,3,33,17,16,41
CSKA Moscow,586,2,11,4,5,28,19,9,37
Zenit,586,3,8,9,3,26,14,12,33
Spart Moscow,586,4,9,6,5,38,29,9,33
Krasnodar,586,5,8,5,7,31,30,1,29
Terek Grozny,586,6,7,7,6,21,23,-2,28
Din Moscow,586,7,6,6,8,21,24,-3,24
FK Rubin,586,8,5,6,9,24,23,1,21
Rostov,586,9,5,6,9,13,19,-6,21
Amkar,586,10,4,6,10,11,24,-13,18
Anzhi,586,11,2,6,12,15,39,-24,12
Loko Moscow,587,1,11,6,3,32,17,15,39
CSKA Moscow,587,2,11,3,6,28,20,8,36
Spart Moscow,587,3,10,5,5,40,31,9,35
Zenit,587,4,8,9,3,24,14,10,33
Krasnodar,587,5,9,4,7,32,27,5,31
Terek Grozny,587,6,8,6,6,22,23,-1,30
FK Rubin,587,7,7,5,8,25,17,8,26
Din Moscow,587,8,6,6,8,20,25,-5,24
Rostov,587,9,4,6,10,11,19,-8,18
Amkar,587,10,4,4,12,11,27,-16,16
Anzhi,587,11,2,6,12,16,41,-25,12
Loko Moscow,588,1,11,6,3,31,15,16,39
CSKA Moscow,588,2,11,3,6,28,20,8,36
Zenit,588,3,9,8,3,26,15,11,35
Spart Moscow,588,4,9,6,5,36,27,9,33
Krasnodar,588,5,8,6,6,31,28,3,30
Terek Grozny,588,6,7,6,7,21,24,-3,27
Din Moscow,588,7,6,7,7,19,22,-3,25
Amkar,588,8,6,4,10,12,22,-10,22
FK Rubin,588,9,5,6,9,25,22,3,21
Rostov,588,10,4,6,10,10,20,-10,18
Anzhi,588,11,2,6,12,16,40,-24,12
Loko Moscow,589,1,12,5,3,32,12,20,41
Spart Moscow,589,2,11,5,4,45,26,19,38
CSKA Moscow,589,3,11,3,6,28,20,8,36
Zenit,589,4,9,8,3,24,13,11,35
Terek Grozny,589,5,8,6,6,24,25,-1,30
Krasnodar,589,6,8,5,7,27,27,0,29
Din Moscow,589,7,6,6,8,20,28,-8,24
FK Rubin,589,8,5,6,9,21,19,2,21
Rostov,589,9,4,6,10,10,20,-10,18
Amkar,589,10,4,5,11,11,26,-15,17
Anzhi,589,11,2,5,13,16,42,-26,11
Loko Moscow,590,1,12,6,2,31,12,19,42
CSKA Moscow,590,2,11,4,5,27,17,10,37
Spart Moscow,590,3,9,6,5,38,29,9,33
Krasnodar,590,4,9,5,6,29,25,4,32
Zenit,590,5,7,9,4,22,15,7,30
Terek Grozny,590,6,8,5,7,21,24,-3,29
FK Rubin,590,7,6,5,9,24,19,5,23
Din Moscow,590,8,5,7,8,18,24,-6,22
Amkar,590,9,5,4,11,11,23,-12,19
Rostov,590,10,4,6,10,11,21,-10,18
Anzhi,590,11,3,5,12,16,39,-23,14
Loko Moscow,591,1,11,5,4,30,17,13,38
CSKA Moscow,591,2,11,4,5,29,17,12,37
Spart Moscow,591,3,10,6,4,40,27,13,36
Zenit,591,4,8,9,3,22,13,9,33
Krasnodar,591,5,9,4,7,32,28,4,31
Terek Grozny,591,6,7,6,7,21,24,-3,27
FK Rubin,591,7,7,5,8,25,17,8,26
Din Moscow,591,8,5,7,8,19,24,-5,22
Rostov,591,9,4,6,10,10,20,-10,18
Amkar,591,10,4,5,11,9,24,-15,17
Anzhi,591,11,3,5,12,16,42,-26,14
Loko Moscow,592,1,12,6,2,34,13,21,42
CSKA Moscow,592,2,11,3,6,27,18,9,36
Zenit,592,3,8,9,3,23,14,9,33
Spart Moscow,592,4,9,6,5,35,28,7,33
Terek Grozny,592,5,9,5,6,27,22,5,32
Krasnodar,592,6,8,4,8,31,33,-2,28
FK Rubin,592,7,7,5,8,28,21,7,26
Din Moscow,592,8,5,7,8,19,24,-5,22
Amkar,592,9,5,4,11,11,26,-15,19
Rostov,592,10,4,6,10,10,18,-8,18
Anzhi,592,11,2,5,13,14,42,-28,11
Loko Moscow,593,1,11,6,3,30,14,16,39
CSKA Moscow,593,2,12,3,5,31,19,12,39
Spart Moscow,593,3,11,5,4,41,28,13,38
Krasnodar,593,4,9,5,6,30,25,5,32
Zenit,593,5,7,9,4,23,16,7,30
Terek Grozny,593,6,7,7,6,21,23,-2,28
Din Moscow,593,7,6,6,8,20,24,-4,24
FK Rubin,593,8,5,6,9,23,20,3,21
Rostov,593,9,4,6,10,12,20,-8,18
Amkar,593,10,4,5,11,9,25,-16,17
Anzhi,593,11,2,6,12,16,42,-26,12
Loko Moscow,594,1,12,5,3,31,13,18,41
CSKA Moscow,594,2,11,3,6,29,21,8,36
Spart Moscow,594,3,9,6,5,36,28,8,33
Zenit,594,4,8,8,4,26,15,11,32
Krasnodar,594,5,9,5,6,29,25,4,32
Terek Grozny,594,6,8,5,7,24,25,-1,29
Din Moscow,594,7,7,6,7,21,22,-1,27
FK Rubin,594,8,5,6,9,22,20,2,21
Amkar,594,9,5,5,10,12,24,-12,20
Rostov,594,10,4,6,10,10,18,-8,18
Anzhi,594,11,2,5,13,15,44,-29,11
Loko Moscow,595,1,11,7,2,31,13,18,40
Spart Moscow,595,2,11,5,4,39,26,13,38
CSKA Moscow,595,3,11,4,5,27,18,9,37
Zenit,595,4,7,9,4,23,16,7,30
Terek Grozny,595,5,8,6,6,21,22,-1,30
Krasnodar,595,6,8,5,7,28,26,2,29
FK Rubin,595,7,7,5,8,25,18,7,26
Din Moscow,595,8,5,6,9,18,25,-7,21
Rostov,595,9,4,6,10,10,18,-8,18
Amkar,595,10,4,5,11,9,25,-16,17
Anzhi,595,11,2,6,12,15,39,-24,12
Loko Moscow,596,1,11,5,4,29,13,16,38
CSKA Moscow,596,2,11,3,6,28,21,7,36
Zenit,596,3,9,8,3,26,14,12,35
Krasnodar,596,4,10,4,6,31,25,6,34
Spart Moscow,596,5,9,6,5,38,30,8,33
Terek Grozny,596,6,7,6,7,21,24,-3,27
Din Moscow,596,7,6,6,8,20,24,-4,24
Rostov,596,8,5,6,9,12,18,-6,21
FK Rubin,596,9,5,5,10,22,21,1,20
Amkar,596,10,4,6,10,11,24,-13,18
Anzhi,596,11,3,5,12,15,39,-24,14
Loko Moscow,597,1,11,5,4,29,14,15,38
Spart Moscow,597,2,10,6,4,37,26,11,36
CSKA Moscow,597,3,11,3,6,26,20,6,36
Zenit,597,4,9,8,3,25,13,12,35
Krasnodar,597,5,10,4,6,30,24,6,34
Terek Grozny,597,6,8,6,6,22,22,0,30
Din Moscow,597,7,6,7,7,19,22,-3,25
FK Rubin,597,8,5,5,10,21,19,2,20
Rostov,597,9,4,6,10,10,18,-8,18
Amkar,597,10,4,5,11,9,24,-15,17
Anzhi,597,11,2,5,13,14,40,-26,11
Loko Moscow,598,1,11,7,2,32,14,18,40
CSKA Moscow,598,2,11,4,5,28,18,10,37
Spart Moscow,598,3,10,5,5,38,28,10,35
Zenit,598,4,7,10,3,24,16,8,31
Krasnodar,598,5,8,6,6,29,26,3,30
Terek Grozny,598,6,7,5,8,20,25,-5,26
FK Rubin,598,7,6,6,8,23,18,5,24
Rostov,598,8,5,6,9,13,17,-4,21
Din Moscow,598,9,5,6,9,17,26,-9,21
Amkar,598,10,5,4,11,10,23,-13,19
Anzhi,598,11,3,5,12,16,39,-23,14
Loko Moscow,599,1,11,7,2,29,11,18,40
Spart Moscow,599,2,11,5,4,39,27,12,38
CSKA Moscow,599,3,10,4,6,28,21,7,34
Zenit,599,4,8,9,3,22,13,9,33
Terek Grozny,599,5,9,5,6,25,24,1,32
Krasnodar,599,6,8,6,6,28,25,3,30
Din Moscow,599,7,6,6,8,22,25,-3,24
FK Rubin,599,8,5,6,9,24,22,2,21
Rostov,599,9,4,6,10,10,19,-9,18
Amkar,599,10,4,4,12,11,26,-15,16
Anzhi,599,11,2,6,12,18,43,-25,12
Loko Moscow,600,1,12,5,3,31,12,19,41
CSKA Moscow,600,2,12,3,5,29,17,12,39
Spart Moscow,600,3,10,5,5,36,28,8,35
Krasnodar,600,4,10,4,6,29,24,5,34
Zenit,600,5,7,8,5,21,16,5,29
Terek Grozny,600,6,8,5,7,23,25,-2,29
Din Moscow,600,7,6,6,8,21,25,-4,24
FK Rubin,600,8,6,5,9,24,19,5,23
Rostov,600,9,4,6,10,10,18,-8,18
Amkar,600,10,4,4,12,10,25,-15,16
Anzhi,600,11,3,5,12,16,41,-25,14
Loko Moscow,601,1,11,5,4,30,14,16,38
Zenit,601,2,9,8,3,24,14,10,35
Spart Moscow,601,3,9,7,4,38,28,10,34
CSKA Moscow,601,4,10,4,6,27,20,7,34
Terek Grozny,601,5,9,5,6,23,23,0,32
Krasnodar,601,6,9,4,7,29,26,3,31
FK Rubin,601,7,6,6,8,23,18,5,24
Din Moscow,601,8,5,8,7,19,23,-4,23
Rostov,601,9,4,6,10,11,20,-9,18
Amkar,601,10,4,5,11,11,25,-14,17
Anzhi,601,11,2,6,12,15,39,-24,12
Loko Moscow,602,1,12,6,2,33,14,19,42
CSKA Moscow,602,2,12,3,5,28,17,11,39
Spart Moscow,602,3,9,6,5,35,27,8,33
Zenit,602,4,7,8,5,21,15,6,29
Krasnodar,602,5,8,5,7,31,30,1,29
Terek Grozny,602,6,8,5,7,22,25,-3,29
Din Moscow,602,7,7,6,7,22,22,0,27
FK Rubin,602,8,6,5,9,25,22,3,23
Amkar,602,9,5,5,10,13,23,-10,20
Rostov,602,10,4,6,10,10,18,-8,18
Anzhi,602,11,2,5,13,14,41,-27,11
Loko Moscow,603,1,12,5,3,31,15,16,41
CSKA Moscow,603,2,11,3,6,29,21,8,36
Zenit,603,3,8,8,4,26,16,10,32
Krasnodar,603,4,9,4,7,29,26,3,31
Spart Moscow,603,5,8,6,6,35,29,6,30
Terek Grozny,603,6,8,6,6,22,23,-1,30
Din Moscow,603,7,6,7,7,18,21,-3,25
FK Rubin,603,8,5,6,9,21,18,3,21
Rostov,603,9,5,6,9,12,18,-6,21
Amkar,603,10,4,5,11,10,24,-14,17
Anzhi,603,11,3,6,11,17,39,-22,15
Loko Moscow,604,1,13,5,2,35,13,22,44
Spart Moscow,604,2,11,5,4,40,26,14,38
CSKA Moscow,604,3,11,3,6,29,19,10,36
Zenit,604,4,8,8,4,24,15,9,32
Terek Grozny,604,5,8,6,6,23,23,0,30
Krasnodar,604,6,8,5,7,29,29,0,29
FK Rubin,604,7,5,7,8,23,19,4,22
Din Moscow,604,8,5,7,8,18,24,-6,22
Rostov,604,9,4,6,10,10,19,-9,18
Amkar,604,10,4,4,12,10,27,-17,16
Anzhi,604,11,2,6,12,15,42,-27,12
Loko Moscow,605,1,11,6,3,30,15,15,39
Spart Moscow,605,2,11,5,4,41,28,13,38
CSKA Moscow,605,3,11,4,5,28,19,9,37
Krasnodar,605,4,10,4,6,32,25,7,34
Zenit,605,5,7,10,3,23,15,8,31
Terek Grozny,605,6,7,6,7,20,25,-5,27
Din Moscow,605,7,6,6,8,22,24,-2,24
FK Rubin,605,8,5,5,10,23,23,0,20
Amkar,605,9,5,4,11,14,25,-11,19
Rostov,605,10,4,6,10,10,20,-10,18
Anzhi,605,11,2,6,12,15,39,-24,12
Loko Moscow,606,1,13,5,2,32,11,21,44
CSKA Moscow,606,2,12,3,5,27,17,10,39
Spart Moscow,606,3,10,5,5,35,27,8,35
Krasnodar,606,4,9,4,7,29,25,4,31
Terek Grozny,606,5,8,6,6,23,23,0,30
Zenit,606,6,7,8,5,21,16,5,29
Din Moscow,606,7,6,6,8,19,24,-5,24
FK Rubin,606,8,6,5,9,24,19,5,23
Rostov,606,9,4,6,10,10,18,-8,18
Amkar,606,10,4,5,11,10,24,-14,17
Anzhi,606,11,2,5,13,14,40,-26,11
Loko Moscow,607,1,12,5,3,32,13,19,41
CSKA Moscow,607,2,12,3,5,29,17,12,39
Spart Moscow,607,3,10,6,4,40,29,11,36
Krasnodar,607,4,10,4,6,31,26,5,34
Terek Grozny,607,5,9,5,6,24,23,1,32
Zenit,607,6,7,8,5,21,17,4,29
Din Moscow,607,7,5,8,7,18,22,-4,23
FK Rubin,607,8,5,6,9,22,19,3,21
Rostov,607,9,4,6,10,12,20,-8,18
Amkar,607,10,4,4,12,11,27,-16,16
Anzhi,607,11,2,5,13,14,41,-27,11
Loko Moscow,608,1,13,5,2,35,13,22,44
CSKA Moscow,608,2,11,3,6,28,20,8,36
Spart Moscow,608,3,9,7,4,38,28,10,34
Zenit,608,4,8,8,4,25,17,8,32
Krasnodar,608,5,8,4,8,29,30,-1,28
Terek Grozny,608,6,7,6,7,21,27,-6,27
FK Rubin,608,7,7,5,8,26,19,7,26
Din Moscow,608,8,5,7,8,19,25,-6,22
Rostov,608,9,4,6,10,10,19,-9,18
Amkar,608,10,4,6,10,12,25,-13,18
Anzhi,608,11,3,5,12,18,38,-20,14
Loko Moscow,609,1,12,6,2,31,11,20,42
CSKA Moscow,609,2,11,3,6,28,20,8,36
Spart Moscow,609,3,9,6,5,37,27,10,33
Zenit,609,4,8,8,4,22,15,7,32
Krasnodar,609,5,8,6,6,28,25,3,30
Terek Grozny,609,6,8,5,7,23,25,-2,29
Din Moscow,609,7,6,7,7,20,23,-3,25
Amkar,609,8,6,4,10,12,23,-11,22
FK Rubin,609,9,5,6,9,23,20,3,21
Rostov,609,10,4,6,10,10,20,-10,18
Anzhi,609,11,2,5,13,17,42,-25,11
Loko Moscow,610,1,13,5,2,31,11,20,44
Spart Moscow,610,2,11,5,4,39,26,13,38
CSKA Moscow,610,3,11,4,5,29,19,10,37
Krasnodar,610,4,9,4,7,29,25,4,31
Zenit,610,5,7,8,5,21,16,5,29
Terek Grozny,610,6,7,6,7,20,24,-4,27
Din Moscow,610,7,6,6,8,20,24,-4,24
FK Rubin,610,8,5,5,10,21,21,0,20
Rostov,610,9,4,6,10,10,19,-9,18
Amkar,610,10,4,5,11,9,23,-14,17
Anzhi,610,11,3,6,11,18,39,-21,15
Loko Moscow,611,1,12,5,3,33,12,21,41
CSKA Moscow,611,2,11,3,6,26,18,8,36
Krasnodar,611,3,10,4,6,29,24,5,34
Spart Moscow,611,4,9,6,5,38,28,10,33
Zenit,611,5,8,8,4,22,17,5,32
Terek Grozny,611,6,8,6,6,24,25,-1,30
Din Moscow,611,7,7,6,7,20,21,-1,27
FK Rubin,611,8,5,5,10,21,19,2,20
Rostov,611,9,4,6,10,10,21,-11,18
Amkar,611,10,4,6,10,11,24,-13,18
Anzhi,611,11,2,5,13,16,41,-25,11
CSKA Moscow,612,1,12,3,5,30,19,11,39
Loko Moscow,612,2,11,5,4,30,15,15,38
Spart Moscow,612,3,9,6,5,39,29,10,33
Zenit,612,4,8,8,4,25,16,9,32
Krasnodar,612,5,9,4,7,30,27,3,31
Terek Grozny,612,6,7,7,6,22,24,-2,28
Din Moscow,612,7,7,6,7,20,22,-2,27
FK Rubin,612,8,6,5,9,23,19,4,23
Rostov,612,9,4,6,10,11,21,-10,18
Amkar,612,10,4,6,10,11,24,-13,18
Anzhi,612,11,2,6,12,15,40,-25,12
Loko Moscow,613,1,13,5,2,35,11,24,44
CSKA Moscow,613,2,11,3,6,26,19,7,36
Zenit,613,3,8,8,4,23,17,6,32
Krasnodar,613,4,9,4,7,28,26,2,31
Spart Moscow,613,5,8,6,6,35,30,5,30
Terek Grozny,613,6,8,6,6,24,25,-1,30
Din Moscow,613,7,6,7,7,20,22,-2,25
FK Rubin,613,8,5,6,9,22,19,3,21
Amkar,613,9,5,5,10,12,24,-12,20
Rostov,613,10,4,7,9,11,18,-7,19
Anzhi,613,11,2,5,13,16,41,-25,11
Loko Moscow,614,1,12,5,3,30,13,17,41
Spart Moscow,614,2,11,5,4,45,28,17,38
CSKA Moscow,614,3,11,3,6,26,18,8,36
Zenit,614,4,9,8,3,24,13,11,35
Krasnodar,614,5,9,4,7,29,26,3,31
Terek Grozny,614,6,8,5,7,23,25,-2,29
FK Rubin,614,7,6,5,9,23,19,4,23
Din Moscow,614,8,5,6,9,18,26,-8,21
Rostov,614,9,4,6,10,11,21,-10,18
Amkar,614,10,4,4,12,10,27,-17,16
Anzhi,614,11,3,5,12,17,40,-23,14
Loko Moscow,615,1,12,6,2,33,12,21,42
CSKA Moscow,615,2,12,3,5,30,19,11,39
Spart Moscow,615,3,10,6,4,41,27,14,36
Krasnodar,615,4,9,5,6,30,25,5,32
Terek Grozny,615,5,8,6,6,23,22,1,30
Zenit,615,6,7,8,5,22,18,4,29
Din Moscow,615,7,6,7,7,23,25,-2,25
FK Rubin,615,8,5,5,10,23,23,0,20
Rostov,615,9,4,6,10,10,19,-9,18
Amkar,615,10,4,5,11,9,26,-17,17
Anzhi,615,11,2,5,13,15,43,-28,11
Loko Moscow,616,1,12,6,2,30,11,19,42
CSKA Moscow,616,2,11,4,5,30,18,12,37
Spart Moscow,616,3,10,5,5,42,29,13,35
Zenit,616,4,7,10,3,21,13,8,31
Terek Grozny,616,5,8,6,6,23,23,0,30
Krasnodar,616,6,8,4,8,27,26,1,28
Din Moscow,616,7,6,6,8,21,25,-4,24
FK Rubin,616,8,6,5,9,23,20,3,23
Amkar,616,9,5,5,10,12,23,-11,20
Rostov,616,10,4,6,10,11,23,-12,18
Anzhi,616,11,2,5,13,15,44,-29,11
Loko Moscow,617,1,11,6,3,29,13,16,39
CSKA Moscow,617,2,11,3,6,27,19,8,36
Spart Moscow,617,3,10,5,5,40,27,13,35
Zenit,617,4,9,8,3,24,13,11,35
Terek Grozny,617,5,9,5,6,24,22,2,32
Krasnodar,617,6,8,5,7,27,25,2,29
FK Rubin,617,7,7,5,8,23,17,6,26
Rostov,617,8,5,6,9,11,17,-6,21
Din Moscow,617,9,5,6,9,17,25,-8,21
Amkar,617,10,4,4,12,10,28,-18,16
Anzhi,617,11,2,5,13,15,41,-26,11
Loko Moscow,618,1,11,7,2,31,13,18,40
CSKA Moscow,618,2,12,3,5,29,18,11,39
Spart Moscow,618,3,9,6,5,42,31,11,33
Krasnodar,618,4,9,5,6,29,25,4,32
Terek Grozny,618,5,9,5,6,22,22,0,32
Zenit,618,6,7,9,4,22,15,7,30
FK Rubin,618,7,6,5,9,22,18,4,23
Din Moscow,618,8,5,7,8,18,23,-5,22
Amkar,618,9,5,4,11,13,26,-13,19
Rostov,618,10,4,6,10,11,22,-11,18
Anzhi,618,11,2,5,13,15,41,-26,11
Loko Moscow,619,1,13,5,2,32,11,21,44
CSKA Moscow,619,2,12,3,5,29,17,12,39
Spart Moscow,619,3,9,7,4,38,28,10,34
Terek Grozny,619,4,9,5,6,23,22,1,32
Zenit,619,5,7,8,5,21,16,5,29
Krasnodar,619,6,8,4,8,28,27,1,28
Din Moscow,619,7,6,6,8,21,26,-5,24
FK Rubin,619,8,6,5,9,25,21,4,23
Rostov,619,9,4,7,9,11,18,-7,19
Amkar,619,10,4,5,11,10,24,-14,17
Anzhi,619,11,2,5,13,14,42,-28,11
Loko Moscow,620,1,12,6,2,33,13,20,42
CSKA Moscow,620,2,11,3,6,31,23,8,36
Spart Moscow,620,3,9,6,5,40,32,8,33
Zenit,620,4,8,8,4,27,18,9,32
Krasnodar,620,5,8,6,6,29,26,3,30
Terek Grozny,620,6,7,7,6,21,23,-2,28
FK Rubin,620,7,6,6,8,24,19,5,24
Din Moscow,620,8,6,6,8,22,26,-4,24
Rostov,620,9,4,7,9,12,19,-7,19
Amkar,620,10,4,5,11,10,24,-14,17
Anzhi,620,11,2,6,12,16,42,-26,12
Loko Moscow,621,1,12,5,3,33,15,18,41
CSKA Moscow,621,2,11,3,6,26,21,5,36
Spart Moscow,621,3,9,6,5,37,29,8,33
Zenit,621,4,8,8,4,25,15,10,32
Krasnodar,621,5,9,5,6,32,27,5,32
Terek Grozny,621,6,8,6,6,21,22,-1,30
Din Moscow,621,7,7,6,7,20,22,-2,27
FK Rubin,621,8,5,6,9,22,19,3,21
Rostov,621,9,4,7,9,12,19,-7,19
Amkar,621,10,4,4,12,9,24,-15,16
Anzhi,621,11,2,6,12,14,38,-24,12
Loko Moscow,622,1,11,5,4,31,15,16,38
CSKA Moscow,622,2,11,3,6,28,19,9,36
Zenit,622,3,9,8,3,24,14,10,35
Krasnodar,622,4,10,4,6,31,26,5,34
Spart Moscow,622,5,9,5,6,36,32,4,32
Terek Grozny,622,6,7,6,7,22,25,-3,27
FK Rubin,622,7,6,5,9,24,20,4,23
Amkar,622,8,6,4,10,13,22,-9,22
Rostov,622,9,5,6,9,14,19,-5,21
Din Moscow,622,10,5,6,9,18,24,-6,21
Anzhi,622,11,2,6,12,17,42,-25,12
Loko Moscow,623,1,11,6,3,31,14,17,39
Spart Moscow,623,2,10,6,4,38,28,10,36
Zenit,623,3,9,8,3,26,14,12,35
CSKA Moscow,623,4,10,3,7,27,23,4,33
Krasnodar,623,5,9,5,6,31,27,4,32
Terek Grozny,623,6,7,5,8,21,25,-4,26
Din Moscow,623,7,6,7,7,21,23,-2,25
FK Rubin,623,8,5,5,10,23,22,1,20
Amkar,623,9,5,4,11,12,25,-13,19
Rostov,623,10,4,6,10,11,19,-8,18
Anzhi,623,11,4,5,11,17,38,-21,17
Loko Moscow,624,1,11,6,3,30,13,17,39
CSKA Moscow,624,2,11,4,5,28,19,9,37
Spart Moscow,624,3,9,6,5,35,27,8,33
Zenit,624,4,8,8,4,23,15,8,32
Krasnodar,624,5,9,5,6,29,24,5,32
Terek Grozny,624,6,8,5,7,22,24,-2,29
Din Moscow,624,7,6,6,8,19,23,-4,24
FK Rubin,624,8,6,5,9,22,19,3,23
Amkar,624,9,5,5,10,10,22,-12,20
Rostov,624,10,4,6,10,10,18,-8,18
Anzhi,624,11,2,6,12,17,41,-24,12
Loko Moscow,625,1,13,5,2,32,11,21,44
CSKA Moscow,625,2,11,4,5,28,18,10,37
Spart Moscow,625,3,10,6,4,39,26,13,36
Krasnodar,625,4,9,4,7,28,25,3,31
Zenit,625,5,7,8,5,21,17,4,29
Terek Grozny,625,6,8,5,7,23,24,-1,29
Din Moscow,625,7,5,7,8,18,25,-7,22
FK Rubin,625,8,5,6,9,22,19,3,21
Rostov,625,9,4,7,9,10,17,-7,19
Amkar,625,10,5,4,11,12,25,-13,19
Anzhi,625,11,2,6,12,15,41,-26,12
CSKA Moscow,626,1,12,3,5,28,17,11,39
Loko Moscow,626,2,11,5,4,30,14,16,38
Spart Moscow,626,3,9,6,5,35,27,8,33
Zenit,626,4,8,8,4,22,15,7,32
Krasnodar,626,5,9,5,6,30,26,4,32
Terek Grozny,626,6,7,6,7,20,23,-3,27
FK Rubin,626,7,6,6,8,27,19,8,24
Din Moscow,626,8,6,6,8,20,27,-7,24
Amkar,626,9,5,5,10,10,22,-12,20
Rostov,626,10,4,6,10,10,18,-8,18
Anzhi,626,11,2,6,12,14,38,-24,12
Loko Moscow,627,1,11,6,3,31,15,16,39
CSKA Moscow,627,2,11,3,6,30,20,10,36
Zenit,627,3,9,8,3,27,15,12,35
Spart Moscow,627,4,9,6,5,37,28,9,33
Terek Grozny,627,5,9,5,6,26,23,3,32
Krasnodar,627,6,8,5,7,30,28,2,29
FK Rubin,627,7,6,6,8,25,20,5,24
Din Moscow,627,8,5,7,8,18,24,-6,22
Rostov,627,9,4,7,9,12,19,-7,19
Amkar,627,10,5,4,11,11,24,-13,19
Anzhi,627,11,2,5,13,14,45,-31,11
Loko Moscow,628,1,11,5,4,29,14,15,38
CSKA Moscow,628,2,11,3,6,28,20,8,36
Zenit,628,3,9,8,3,24,14,10,35
Krasnodar,628,4,10,4,6,33,24,9,34
Spart Moscow,628,5,9,6,5,37,28,9,33
Terek Grozny,628,6,8,6,6,24,22,2,30
Din Moscow,628,7,6,7,7,20,22,-2,25
FK Rubin,628,8,5,6,9,22,22,0,21
Rostov,628,9,4,6,10,11,21,-10,18
Amkar,628,10,4,6,10,9,22,-13,18
Anzhi,628,11,2,5,13,15,43,-28,11
CSKA Moscow,629,1,12,3,5,27,17,10,39
Loko Moscow,629,2,11,5,4,31,17,14,38
Krasnodar,629,3,10,4,6,34,26,8,34
Zenit,629,4,8,8,4,23,14,9,32
Spart Moscow,629,5,9,5,6,35,28,7,32
Terek Grozny,629,6,8,5,7,23,24,-1,29
Din Moscow,629,7,6,7,7,19,22,-3,25
FK Rubin,629,8,5,6,9,22,21,1,21
Amkar,629,9,5,4,11,11,24,-13,19
Rostov,629,10,4,6,10,10,19,-9,18
Anzhi,629,11,3,5,12,16,39,-23,14
Loko Moscow,630,1,13,5,2,36,12,24,44
CSKA Moscow,630,2,11,4,5,27,18,9,37
Spart Moscow,630,3,8,8,4,37,29,8,32
Zenit,630,4,7,9,4,22,19,3,30
Terek Grozny,630,5,8,5,7,22,24,-2,29
Krasnodar,630,6,8,4,8,29,28,1,28
Din Moscow,630,7,6,7,7,21,24,-3,25
FK Rubin,630,8,6,5,9,24,20,4,23
Amkar,630,9,5,5,10,13,25,-12,20
Rostov,630,10,4,7,9,10,17,-7,19
Anzhi,630,11,2,5,13,14,39,-25,11
Loko Moscow,631,1,11,5,4,32,17,15,38
CSKA Moscow,631,2,11,4,5,28,19,9,37
Spart Moscow,631,3,10,6,4,40,27,13,36
Krasnodar,631,4,10,4,6,35,30,5,34
Zenit,631,5,8,8,4,23,14,9,32
Terek Grozny,631,6,9,5,6,23,22,1,32
Din Moscow,631,7,6,6,8,20,26,-6,24
FK Rubin,631,8,5,5,10,25,23,2,20
Rostov,631,9,4,7,9,11,18,-7,19
Amkar,631,10,4,4,12,9,25,-16,16
Anzhi,631,11,2,6,12,16,41,-25,12
Loko Moscow,632,1,12,5,3,30,14,16,41
CSKA Moscow,632,2,11,3,6,29,20,9,36
Zenit,632,3,9,8,3,27,13,14,35
Spart Moscow,632,4,9,7,4,36,26,10,34
Terek Grozny,632,5,9,5,6,23,23,0,32
Krasnodar,632,6,9,4,7,30,25,5,31
Din Moscow,632,7,6,7,7,19,22,-3,25
FK Rubin,632,8,5,5,10,21,21,0,20
Rostov,632,9,4,6,10,10,19,-9,18
Amkar,632,10,4,5,11,9,23,-14,17
Anzhi,632,11,2,5,13,15,43,-28,11
Loko Moscow,633,1,13,5,2,35,12,23,44
CSKA Moscow,633,2,10,3,7,27,21,6,33
Spart Moscow,633,3,9,5,6,37,29,8,32
Zenit,633,4,8,8,4,24,19,5,32
Krasnodar,633,5,9,4,7,31,28,3,31
Terek Grozny,633,6,7,6,7,20,24,-4,27
Din Moscow,633,7,6,6,8,19,23,-4,24
FK Rubin,633,8,6,5,9,24,20,4,23
Amkar,633,9,5,5,10,10,22,-12,20
Rostov,633,10,4,6,10,11,20,-9,18
Anzhi,633,11,4,5,11,17,37,-20,17
Loko Moscow,634,1,11,6,3,32,16,16,39
CSKA Moscow,634,2,12,3,5,30,18,12,39
Zenit,634,3,8,8,4,25,16,9,32
Spart Moscow,634,4,8,8,4,34,26,8,32
Krasnodar,634,5,8,6,6,29,26,3,30
Terek Grozny,634,6,7,6,7,24,27,-3,27
Din Moscow,634,7,6,7,7,18,21,-3,25
FK Rubin,634,8,5,6,9,21,18,3,21
Amkar,634,9,5,5,10,12,24,-12,20
Rostov,634,10,4,7,9,11,18,-7,19
Anzhi,634,11,2,6,12,16,42,-26,12
Loko Moscow,635,1,11,6,3,31,14,17,39
Spart Moscow,635,2,10,6,4,37,27,10,36
Zenit,635,3,8,9,3,25,14,11,33
CSKA Moscow,635,4,10,3,7,26,22,4,33
Krasnodar,635,5,9,4,7,30,27,3,31
Terek Grozny,635,6,7,5,8,20,25,-5,26
FK Rubin,635,7,6,6,8,23,18,5,24
Din Moscow,635,8,5,7,8,18,23,-5,22
Amkar,635,9,5,5,10,11,23,-12,20
Rostov,635,10,4,6,10,10,18,-8,18
Anzhi,635,11,4,5,11,18,38,-20,17
Loko Moscow,636,1,11,5,4,29,13,16,38
CSKA Moscow,636,2,11,4,5,26,17,9,37
Spart Moscow,636,3,10,6,4,38,27,11,36
Krasnodar,636,4,10,4,6,30,25,5,34
Zenit,636,5,8,9,3,22,13,9,33
Terek Grozny,636,6,7,6,7,20,23,-3,27
Din Moscow,636,7,6,6,8,19,23,-4,24
FK Rubin,636,8,5,5,10,23,21,2,20
Amkar,636,9,5,5,10,12,24,-12,20
Rostov,636,10,4,6,10,10,19,-9,18
Anzhi,636,11,2,6,12,14,38,-24,12
Loko Moscow,637,1,12,6,2,31,12,19,42
CSKA Moscow,637,2,11,3,6,27,20,7,36
Zenit,637,3,8,9,3,24,14,10,33
Spart Moscow,637,4,9,6,5,36,31,5,33
Krasnodar,637,5,8,5,7,30,28,2,29
Terek Grozny,637,6,8,5,7,22,24,-2,29
FK Rubin,637,7,6,6,8,25,19,6,24
Din Moscow,637,8,6,6,8,22,24,-2,24
Rostov,637,9,4,7,9,10,17,-7,19
Amkar,637,10,5,4,11,12,25,-13,19
Anzhi,637,11,2,5,13,14,39,-25,11
Loko Moscow,638,1,11,5,4,30,14,16,38
Spart Moscow,638,2,10,5,5,39,28,11,35
CSKA Moscow,638,3,10,5,5,27,19,8,35
Zenit,638,4,8,9,3,22,13,9,33
Krasnodar,638,5,9,5,6,30,26,4,32
Terek Grozny,638,6,8,6,6,22,23,-1,30
FK Rubin,638,7,6,6,8,23,18,5,24
Din Moscow,638,8,5,6,9,18,26,-8,21
Amkar,638,9,5,4,11,11,23,-12,19
Rostov,638,10,4,6,10,10,19,-9,18
Anzhi,638,11,2,7,11,17,40,-23,13
Loko Moscow,639,1,12,6,2,33,14,19,42
CSKA Moscow,639,2,11,3,6,27,21,6,36
Spart Moscow,639,3,9,6,5,36,28,8,33
Zenit,639,4,8,8,4,26,15,11,32
Krasnodar,639,5,8,6,6,30,27,3,30
Terek Grozny,639,6,8,5,7,22,25,-3,29
Din Moscow,639,7,6,7,7,20,23,-3,25
FK Rubin,639,8,5,7,8,22,18,4,22
Rostov,639,9,4,6,10,10,18,-8,18
Amkar,639,10,4,5,11,10,24,-14,17
Anzhi,639,11,3,5,12,16,39,-23,14
Loko Moscow,640,1,11,6,3,30,13,17,39
CSKA Moscow,640,2,11,4,5,27,17,10,37
Krasnodar,640,3,10,4,6,30,24,6,34
Spart Moscow,640,4,9,6,5,38,28,10,33
Zenit,640,5,7,10,3,22,14,8,31
Terek Grozny,640,6,7,6,7,21,24,-3,27
Din Moscow,640,7,5,8,7,20,24,-4,23
FK Rubin,640,8,5,6,9,22,20,2,21
Amkar,640,9,5,5,10,11,23,-12,20
Rostov,640,10,4,6,10,10,20,-10,18
Anzhi,640,11,3,5,12,15,39,-24,14
Loko Moscow,641,1,11,6,3,34,17,17,39
CSKA Moscow,641,2,11,4,5,27,18,9,37
Spart Moscow,641,3,10,6,4,37,27,10,36
Krasnodar,641,4,10,4,6,33,28,5,34
Zenit,641,5,7,9,4,23,16,7,30
Terek Grozny,641,6,8,5,7,21,23,-2,29
Din Moscow,641,7,6,6,8,18,22,-4,24
FK Rubin,641,8,5,5,10,22,20,2,20
Amkar,641,9,5,5,10,12,24,-12,20
Rostov,641,10,4,6,10,10,18,-8,18
Anzhi,641,11,2,6,12,15,39,-24,12
Loko Moscow,642,1,12,5,3,33,14,19,41
CSKA Moscow,642,2,12,3,5,29,18,11,39
Spart Moscow,642,3,10,5,5,35,26,9,35
Krasnodar,642,4,9,4,7,30,28,2,31
Zenit,642,5,7,8,5,21,16,5,29
Terek Grozny,642,6,8,5,7,22,23,-1,29
Din Moscow,642,7,6,6,8,20,23,-3,24
FK Rubin,642,8,6,5,9,24,20,4,23
Rostov,642,9,5,6,9,11,17,-6,21
Amkar,642,10,4,4,12,9,25,-16,16
Anzhi,642,11,3,5,12,16,40,-24,14
Loko Moscow,643,1,12,5,3,32,13,19,41
CSKA Moscow,643,2,11,3,6,26,18,8,36
Spart Moscow,643,3,9,6,5,36,27,9,33
Zenit,643,4,8,8,4,22,16,6,32
Krasnodar,643,5,9,4,7,30,26,4,31
Terek Grozny,643,6,8,6,6,22,23,-1,30
FK Rubin,643,7,7,5,8,25,18,7,26
Din Moscow,643,8,5,7,8,18,24,-6,22
Amkar,643,9,5,5,10,10,22,-12,20
Rostov,643,10,4,6,10,10,19,-9,18
Anzhi,643,11,2,5,13,15,40,-25,11
Loko Moscow,644,1,11,7,2,32,14,18,40
CSKA Moscow,644,2,11,3,6,28,22,6,36
Spart Moscow,644,3,9,7,4,37,28,9,34
Zenit,644,4,8,9,3,28,16,12,33
Krasnodar,644,5,9,5,6,30,26,4,32
Terek Grozny,644,6,9,5,6,23,22,1,32
FK Rubin,644,7,6,5,9,23,19,4,23
Din Moscow,644,8,5,7,8,18,23,-5,22
Rostov,644,9,4,6,10,12,20,-8,18
Amkar,644,10,4,5,11,9,23,-14,17
Anzhi,644,11,2,5,13,14,41,-27,11
Loko Moscow,645,1,13,5,2,32,12,20,44
CSKA Moscow,645,2,11,3,6,28,20,8,36
Spart Moscow,645,3,9,7,4,35,26,9,34
Zenit,645,4,8,8,4,24,14,10,32
Krasnodar,645,5,8,5,7,30,28,2,29
Terek Grozny,645,6,7,7,6,21,23,-2,28
FK Rubin,645,7,6,6,8,24,19,5,24
Din Moscow,645,8,5,6,9,17,23,-6,21
Rostov,645,9,4,7,9,11,18,-7,19
Amkar,645,10,4,6,10,9,22,-13,18
Anzhi,645,11,2,6,12,15,41,-26,12
Loko Moscow,646,1,11,6,3,32,15,17,39
CSKA Moscow,646,2,10,5,5,27,19,8,35
Zenit,646,3,8,9,3,23,14,9,33
Spart Moscow,646,4,9,6,5,38,31,7,33
Krasnodar,646,5,9,5,6,33,26,7,32
Terek Grozny,646,6,8,5,7,24,23,1,29
Din Moscow,646,7,7,6,7,22,22,0,27
FK Rubin,646,8,5,5,10,21,23,-2,20
Rostov,646,9,4,7,9,12,19,-7,19
Amkar,646,10,5,4,11,11,24,-13,19
Anzhi,646,11,2,6,12,16,43,-27,12
Loko Moscow,647,1,11,7,2,29,11,18,40
Spart Moscow,647,2,10,6,4,43,29,14,36
CSKA Moscow,647,3,11,3,6,29,21,8,36
Zenit,647,4,8,9,3,25,15,10,33
Krasnodar,647,5,9,5,6,29,25,4,32
Terek Grozny,647,6,9,5,6,26,22,4,32
FK Rubin,647,7,6,5,9,24,19,5,23
Din Moscow,647,8,5,6,9,17,28,-11,21
Rostov,647,9,4,7,9,12,19,-7,19
Amkar,647,10,4,4,12,11,28,-17,16
Anzhi,647,11,2,5,13,14,42,-28,11
Loko Moscow,648,1,11,6,3,30,13,17,39
Spart Moscow,648,2,10,6,4,36,25,11,36
CSKA Moscow,648,3,11,3,6,30,22,8,36
Zenit,648,4,9,8,3,26,15,11,35
Krasnodar,648,5,8,6,6,29,26,3,30
Terek Grozny,648,6,8,5,7,23,24,-1,29
FK Rubin,648,7,6,6,8,24,19,5,24
Din Moscow,648,8,5,6,9,17,24,-7,21
Rostov,648,9,4,6,10,10,18,-8,18
Amkar,648,10,4,5,11,9,24,-15,17
Anzhi,648,11,3,5,12,18,42,-24,14
Loko Moscow,649,1,12,6,2,34,14,20,42
CSKA Moscow,649,2,11,3,6,29,19,10,36
Spart Moscow,649,3,9,7,4,37,28,9,34
Zenit,649,4,8,9,3,23,14,9,33
Krasnodar,649,5,9,4,7,31,28,3,31
Terek Grozny,649,6,7,7,6,22,24,-2,28
FK Rubin,649,7,6,5,9,24,21,3,23
Din Moscow,649,8,5,6,9,20,26,-6,21
Rostov,649,9,4,7,9,10,17,-7,19
Amkar,649,10,4,6,10,12,25,-13,18
Anzhi,649,11,2,6,12,16,42,-26,12
Loko Moscow,650,1,11,6,3,29,12,17,39
CSKA Moscow,650,2,10,4,6,27,20,7,34
Zenit,650,3,8,9,3,23,14,9,33
Krasnodar,650,4,9,5,6,29,24,5,32
Spart Moscow,650,5,8,7,5,34,27,7,31
Terek Grozny,650,6,7,5,8,20,26,-6,26
FK Rubin,650,7,6,5,9,23,20,3,23
Din Moscow,650,8,5,7,8,19,24,-5,22
Amkar,650,9,6,4,10,11,22,-11,22
Rostov,650,10,4,7,9,10,17,-7,19
Anzhi,650,11,4,5,11,19,38,-19,17
Loko Moscow,651,1,13,5,2,34,12,22,44
Spart Moscow,651,2,10,6,4,38,27,11,36
CSKA Moscow,651,3,11,3,6,28,19,9,36
Zenit,651,4,8,8,4,23,16,7,32
Terek Grozny,651,5,7,7,6,22,24,-2,28
Krasnodar,651,6,8,4,8,28,31,-3,28
FK Rubin,651,7,7,5,8,26,17,9,26
Din Moscow,651,8,5,6,9,17,24,-7,21
Rostov,651,9,4,7,9,11,18,-7,19
Amkar,651,10,4,5,11,11,25,-14,17
Anzhi,651,11,2,6,12,15,40,-25,12
Loko Moscow,652,1,12,5,3,32,14,18,41
Spart Moscow,652,2,10,6,4,41,29,12,36
CSKA Moscow,652,3,11,3,6,27,20,7,36
Zenit,652,4,9,8,3,27,15,12,35
Krasnodar,652,5,9,4,7,29,27,2,31
Terek Grozny,652,6,8,6,6,22,23,-1,30
FK Rubin,652,7,6,5,9,23,19,4,23
Din Moscow,652,8,5,7,8,19,24,-5,22
Rostov,652,9,4,6,10,10,19,-9,18
Amkar,652,10,4,5,11,12,27,-15,17
Anzhi,652,11,2,5,13,14,39,-25,11
Loko Moscow,653,1,13,5,2,32,12,20,44
CSKA Moscow,653,2,12,3,5,29,17,12,39
Spart Moscow,653,3,9,5,6,36,29,7,32
Zenit,653,4,7,8,5,22,17,5,29
Krasnodar,653,5,8,4,8,27,26,1,28
Din Moscow,653,6,7,6,7,22,23,-1,27
Terek Grozny,653,7,7,6,7,20,24,-4,27
FK Rubin,653,8,6,5,9,23,19,4,23
Rostov,653,9,5,6,9,11,17,-6,21
Amkar,653,10,4,5,11,9,24,-15,17
Anzhi,653,11,3,5,12,16,39,-23,14
Loko Moscow,654,1,11,5,4,30,16,14,38
CSKA Moscow,654,2,11,4,5,27,17,10,37
Spart Moscow,654,3,9,5,6,38,28,10,32
Zenit,654,4,8,8,4,23,16,7,32
Krasnodar,654,5,9,4,7,30,25,5,31
Terek Grozny,654,6,8,5,7,21,25,-4,29
FK Rubin,654,7,7,5,8,24,17,7,26
Din Moscow,654,8,6,6,8,18,23,-5,24
Amkar,654,9,6,4,10,14,23,-9,22
Rostov,654,10,4,6,10,10,21,-11,18
Anzhi,654,11,2,6,12,14,38,-24,12
Loko Moscow,655,1,11,5,4,31,15,16,38
CSKA Moscow,655,2,10,5,5,28,20,8,35
Spart Moscow,655,3,9,7,4,35,26,9,34
Zenit,655,4,8,9,3,24,15,9,33
Terek Grozny,655,5,9,5,6,23,23,0,32
Krasnodar,655,6,9,4,7,31,28,3,31
Din Moscow,655,7,6,6,8,19,23,-4,24
FK Rubin,655,8,6,5,9,24,20,4,23
Rostov,655,9,4,7,9,10,17,-7,19
Amkar,655,10,4,5,11,11,25,-14,17
Anzhi,655,11,2,6,12,15,39,-24,12
Loko Moscow,656,1,11,7,2,32,14,18,40
CSKA Moscow,656,2,10,4,6,27,21,6,34
Zenit,656,3,8,9,3,24,14,10,33
Spart Moscow,656,4,9,6,5,36,27,9,33
Krasnodar,656,5,8,5,7,29,27,2,29
Terek Grozny,656,6,7,7,6,21,23,-2,28
FK Rubin,656,7,7,5,8,24,18,6,26
Rostov,656,8,5,6,9,11,17,-6,21
Din Moscow,656,9,5,6,9,18,25,-7,21
Amkar,656,10,4,6,10,11,24,-13,18
Anzhi,656,11,2,7,11,16,39,-23,13
Loko Moscow,657,1,11,5,4,30,14,16,38
Zenit,657,2,9,8,3,26,16,10,35
Spart Moscow,657,3,9,7,4,37,28,9,34
CSKA Moscow,657,4,10,4,6,28,21,7,34
Krasnodar,657,5,9,4,7,28,25,3,31
Terek Grozny,657,6,8,5,7,22,23,-1,29
FK Rubin,657,7,7,5,8,24,17,7,26
Din Moscow,657,8,5,7,8,18,24,-6,22
Rostov,657,9,4,7,9,11,18,-7,19
Amkar,657,10,4,4,12,10,26,-16,16
Anzhi,657,11,3,6,11,16,38,-22,15
Loko Moscow,658,1,11,7,2,33,15,18,40
CSKA Moscow,658,2,10,5,5,26,18,8,35
Spart Moscow,658,3,9,7,4,36,27,9,34
Zenit,658,4,7,10,3,23,15,8,31
Krasnodar,658,5,8,5,7,30,28,2,29
FK Rubin,658,6,7,5,8,26,20,6,26
Terek Grozny,658,7,7,5,8,20,25,-5,26
Din Moscow,658,8,5,7,8,20,25,-5,22
Rostov,658,9,4,7,9,10,17,-7,19
Amkar,658,10,5,4,11,12,24,-12,19
Anzhi,658,11,3,6,11,16,38,-22,15
Loko Moscow,659,1,11,6,3,32,15,17,39
CSKA Moscow,659,2,12,3,5,30,19,11,39
Spart Moscow,659,3,9,6,5,36,27,9,33
Terek Grozny,659,4,9,5,6,26,22,4,32
Krasnodar,659,5,9,4,7,29,26,3,31
Zenit,659,6,7,9,4,25,18,7,30
Din Moscow,659,7,6,7,7,19,22,-3,25
FK Rubin,659,8,6,6,8,22,17,5,24
Rostov,659,9,4,7,9,10,17,-7,19
Amkar,659,10,4,4,12,9,28,-19,16
Anzhi,659,11,2,5,13,14,41,-27,11
CSKA Moscow,660,1,12,3,5,28,17,11,39
Loko Moscow,660,2,11,5,4,29,13,16,38
Krasnodar,660,3,10,4,6,29,24,5,34
Spart Moscow,660,4,9,6,5,36,29,7,33
Zenit,660,5,8,8,4,22,14,8,32
Terek Grozny,660,6,7,6,7,22,25,-3,27
Din Moscow,660,7,5,8,7,19,23,-4,23
FK Rubin,660,8,5,6,9,22,19,3,21
Rostov,660,9,5,6,9,12,17,-5,21
Amkar,660,10,4,5,11,11,25,-14,17
Anzhi,660,11,3,5,12,16,40,-24,14
Loko Moscow,661,1,12,5,3,31,14,17,41
CSKA Moscow,661,2,12,3,5,27,17,10,39
Spart Moscow,661,3,9,5,6,35,31,4,32
Krasnodar,661,4,9,4,7,30,26,4,31
Terek Grozny,661,5,8,6,6,25,23,2,30
Zenit,661,6,7,8,5,21,15,6,29
Din Moscow,661,7,7,6,7,21,21,0,27
FK Rubin,661,8,6,5,9,22,19,3,23
Amkar,661,9,5,5,10,13,23,-10,20
Rostov,661,10,4,6,10,11,19,-8,18
Anzhi,661,11,2,5,13,14,42,-28,11
Loko Moscow,662,1,11,7,2,31,13,18,40
CSKA Moscow,662,2,12,3,5,33,20,13,39
Spart Moscow,662,3,10,5,5,37,29,8,35
Krasnodar,662,4,9,5,6,34,26,8,32
Zenit,662,5,7,9,4,21,16,5,30
Terek Grozny,662,6,8,5,7,23,25,-2,29
Din Moscow,662,7,5,7,8,18,23,-5,22
FK Rubin,662,8,5,6,9,21,22,-1,21
Rostov,662,9,5,6,9,12,17,-5,21
Amkar,662,10,5,4,11,13,24,-11,19
Anzhi,662,11,2,5,13,17,45,-28,11
Loko Moscow,663,1,11,6,3,30,13,17,39
Spart Moscow,663,2,10,6,4,40,28,12,36
Zenit,663,3,9,8,3,25,15,10,35
CSKA Moscow,663,4,10,4,6,27,20,7,34
Krasnodar,663,5,8,6,6,28,25,3,30
Terek Grozny,663,6,8,5,7,23,25,-2,29
Din Moscow,663,7,6,6,8,19,23,-4,24
FK Rubin,663,8,5,6,9,22,20,2,21
Rostov,663,9,4,7,9,11,18,-7,19
Amkar,663,10,4,4,12,12,28,-16,16
Anzhi,663,11,3,6,11,17,39,-22,15
Loko Moscow,664,1,13,5,2,35,12,23,44
Spart Moscow,664,2,10,6,4,39,26,13,36
CSKA Moscow,664,3,10,4,6,25,18,7,34
Zenit,664,4,7,9,4,21,16,5,30
Krasnodar,664,5,8,5,7,29,28,1,29
Terek Grozny,664,6,8,5,7,22,27,-5,29
FK Rubin,664,7,5,7,8,23,19,4,22
Din Moscow,664,8,5,7,8,18,25,-7,22
Rostov,664,9,4,6,10,11,20,-9,18
Amkar,664,10,4,5,11,9,23,-14,17
Anzhi,664,11,4,5,11,20,38,-18,17
Loko Moscow,665,1,12,6,2,31,12,19,42
CSKA Moscow,665,2,11,3,6,30,22,8,36
Spart Moscow,665,3,10,5,5,38,28,10,35
Zenit,665,4,8,9,3,25,14,11,33
Krasnodar,665,5,9,4,7,33,28,5,31
Terek Grozny,665,6,7,6,7,21,25,-4,27
FK Rubin,665,7,6,5,9,25,23,2,23
Amkar,665,8,6,4,10,12,22,-10,22
Din Moscow,665,9,5,6,9,19,25,-6,21
Rostov,665,10,4,6,10,11,20,-9,18
Anzhi,665,11,2,6,12,16,42,-26,12
Loko Moscow,666,1,11,6,3,31,14,17,39
Spart Moscow,666,2,10,6,4,37,27,10,36
CSKA Moscow,666,3,10,4,6,27,22,5,34
Zenit,666,4,8,9,3,24,15,9,33
Krasnodar,666,5,9,5,6,30,24,6,32
Terek Grozny,666,6,8,5,7,23,25,-2,29
Din Moscow,666,7,6,7,7,20,23,-3,25
FK Rubin,666,8,5,5,10,22,22,0,20
Rostov,666,9,4,6,10,10,18,-8,18
Anzhi,666,10,4,5,11,22,41,-19,17
Amkar,666,11,4,4,12,10,25,-15,16
Loko Moscow,667,1,13,5,2,33,12,21,44
CSKA Moscow,667,2,11,4,5,29,19,10,37
Spart Moscow,667,3,9,6,5,36,27,9,33
Terek Grozny,667,4,9,5,6,23,22,1,32
Krasnodar,667,5,9,4,7,30,27,3,31
Zenit,667,6,7,9,4,23,16,7,30
Din Moscow,667,7,5,7,8,19,25,-6,22
FK Rubin,667,8,5,6,9,23,21,2,21
Rostov,667,9,5,6,9,12,18,-6,21
Amkar,667,10,4,5,11,9,24,-15,17
Anzhi,667,11,2,5,13,14,40,-26,11
Loko Moscow,668,1,11,5,4,30,15,15,38
CSKA Moscow,668,2,11,3,6,30,21,9,36
Zenit,668,3,9,8,3,26,14,12,35
Spart Moscow,668,4,9,6,5,37,31,6,33
Krasnodar,668,5,9,4,7,28,25,3,31
Terek Grozny,668,6,7,7,6,22,24,-2,28
FK Rubin,668,7,7,5,8,24,17,7,26
Din Moscow,668,8,6,6,8,20,23,-3,24
Rostov,668,9,4,6,10,13,21,-8,18
Amkar,668,10,4,6,10,10,23,-13,18
Anzhi,668,11,2,6,12,17,43,-26,12
Loko Moscow,669,1,12,6,2,33,12,21,42
CSKA Moscow,669,2,11,3,6,29,18,11,36
Spart Moscow,669,3,9,6,5,38,27,11,33
Zenit,669,4,8,9,3,23,14,9,33
Krasnodar,669,5,8,4,8,28,29,-1,28
Terek Grozny,669,6,7,6,7,23,26,-3,27
FK Rubin,669,7,7,5,8,27,19,8,26
Din Moscow,669,8,6,6,8,19,25,-6,24
Rostov,669,9,4,6,10,10,21,-11,18
Amkar,669,10,4,6,10,12,25,-13,18
Anzhi,669,11,3,5,12,16,42,-26,14
Loko Moscow,670,1,12,5,3,32,15,17,41
CSKA Moscow,670,2,11,3,6,28,20,8,36
Spart Moscow,670,3,9,7,4,36,26,10,34
Zenit,670,4,8,8,4,23,15,8,32
Krasnodar,670,5,9,4,7,32,27,5,31
Terek Grozny,670,6,8,6,6,25,25,0,30
FK Rubin,670,7,7,5,8,26,19,7,26
Din Moscow,670,8,5,7,8,19,25,-6,22
Rostov,670,9,4,6,10,10,19,-9,18
Amkar,670,10,4,5,11,10,25,-15,17
Anzhi,670,11,2,6,12,17,42,-25,12
Loko Moscow,671,1,12,6,2,34,14,20,42
Spart Moscow,671,2,10,6,4,38,26,12,36
CSKA Moscow,671,3,11,3,6,28,21,7,36
Zenit,671,4,8,8,4,25,17,8,32
Krasnodar,671,5,9,5,6,31,27,4,32
Terek Grozny,671,6,9,5,6,24,24,0,32
Din Moscow,671,7,5,7,8,18,24,-6,22
FK Rubin,671,8,5,6,9,23,20,3,21
Rostov,671,9,4,6,10,10,19,-9,18
Amkar,671,10,4,5,11,11,25,-14,17
Anzhi,671,11,2,5,13,16,41,-25,11
Loko Moscow,672,1,12,5,3,30,13,17,41
Zenit,672,2,9,8,3,26,14,12,35
Spart Moscow,672,3,9,6,5,38,30,8,33
CSKA Moscow,672,4,10,3,7,28,23,5,33
Terek Grozny,672,5,8,5,7,24,25,-1,29
Krasnodar,672,6,8,4,8,28,27,1,28
Din Moscow,672,7,6,7,7,22,24,-2,25
FK Rubin,672,8,6,6,8,25,20,5,24
Amkar,672,9,5,5,10,12,24,-12,20
Rostov,672,10,4,6,10,11,20,-9,18
Anzhi,672,11,3,5,12,18,42,-24,14
Loko Moscow,673,1,11,5,4,29,14,15,38
Spart Moscow,673,2,10,6,4,41,29,12,36
Zenit,673,3,9,8,3,24,13,11,35
CSKA Moscow,673,4,10,4,6,27,20,7,34
Krasnodar,673,5,10,4,6,31,25,6,34
Terek Grozny,673,6,7,5,8,21,26,-5,26
Din Moscow,673,7,6,7,7,23,25,-2,25
FK Rubin,673,8,5,5,10,23,23,0,20
Amkar,673,9,5,4,11,12,27,-15,19
Rostov,673,10,4,6,10,10,18,-8,18
Anzhi,673,11,3,6,11,18,39,-21,15
Loko Moscow,674,1,12,5,3,32,13,19,41
CSKA Moscow,674,2,11,4,5,27,18,9,37
Krasnodar,674,3,10,4,6,32,24,8,34
Spart Moscow,674,4,8,6,6,34,28,6,30
Zenit,674,5,7,8,5,22,18,4,29
Terek Grozny,674,6,8,5,7,24,25,-1,29
Din Moscow,674,7,6,7,7,19,22,-3,25
FK Rubin,674,8,5,6,9,22,21,1,21
Rostov,674,9,4,7,9,10,17,-7,19
Amkar,674,10,5,4,11,11,25,-14,19
Anzhi,674,11,3,6,11,17,39,-22,15
Loko Moscow,675,1,13,5,2,35,12,23,44
CSKA Moscow,675,2,11,4,5,27,18,9,37
Spart Moscow,675,3,10,6,4,37,25,12,36
Zenit,675,4,7,9,4,22,17,5,30
Krasnodar,675,5,8,5,7,28,27,1,29
Terek Grozny,675,6,8,5,7,22,27,-5,29
Din Moscow,675,7,5,8,7,18,22,-4,23
FK Rubin,675,8,5,7,8,22,18,4,22
Amkar,675,9,5,4,11,13,24,-11,19
Rostov,675,10,4,6,10,10,19,-9,18
Anzhi,675,11,2,5,13,15,40,-25,11
Loko Moscow,676,1,13,5,2,34,14,20,44
Spart Moscow,676,2,10,5,5,42,30,12,35
CSKA Moscow,676,3,10,5,5,26,18,8,35
Krasnodar,676,4,9,4,7,32,28,4,31
Zenit,676,5,7,9,4,22,15,7,30
Terek Grozny,676,6,7,7,6,21,23,-2,28
FK Rubin,676,7,6,5,9,23,20,3,23
Rostov,676,8,5,6,9,12,18,-6,21
Din Moscow,676,9,5,6,9,18,25,-7,21
Amkar,676,10,4,5,11,11,27,-16,17
Anzhi,676,11,2,7,11,16,39,-23,13
Loko Moscow,677,1,11,5,4,29,14,15,38
CSKA Moscow,677,2,11,4,5,28,18,10,37
Krasnodar,677,3,10,4,6,30,24,6,34
Zenit,677,4,8,9,3,22,13,9,33
Spart Moscow,677,5,9,6,5,36,31,5,33
Terek Grozny,677,6,9,5,6,26,23,3,32
Din Moscow,677,7,6,7,7,21,22,-1,25
Rostov,677,8,5,6,9,14,17,-3,21
FK Rubin,677,9,5,5,10,21,21,0,20
Amkar,677,10,4,4,12,10,27,-17,16
Anzhi,677,11,2,5,13,16,43,-27,11
Loko Moscow,678,1,12,5,3,33,14,19,41
Spart Moscow,678,2,11,5,4,38,26,12,38
CSKA Moscow,678,3,11,4,5,27,18,9,37
Krasnodar,678,4,10,4,6,32,26,6,34
Terek Grozny,678,5,9,5,6,24,23,1,32
Zenit,678,6,7,9,4,22,16,6,30
FK Rubin,678,7,6,5,9,26,22,4,23
Din Moscow,678,8,5,6,9,20,27,-7,21
Rostov,678,9,4,6,10,10,19,-9,18
Amkar,678,10,4,4,12,10,25,-15,16
Anzhi,678,11,2,5,13,15,41,-26,11
Loko Moscow,679,1,12,6,2,32,13,19,42
CSKA Moscow,679,2,11,4,5,28,19,9,37
Spart Moscow,679,3,9,6,5,38,29,9,33
Terek Grozny,679,4,9,5,6,26,23,3,32
Zenit,679,5,7,8,5,22,16,6,29
Krasnodar,679,6,8,5,7,29,27,2,29
FK Rubin,679,7,7,5,8,23,17,6,26
Din Moscow,679,8,6,6,8,19,22,-3,24
Rostov,679,9,4,6,10,11,21,-10,18
Amkar,679,10,4,5,11,11,25,-14,17
Anzhi,679,11,2,6,12,15,42,-27,12
Loko Moscow,680,1,11,5,4,30,14,16,38
CSKA Moscow,680,2,11,4,5,30,20,10,37
Spart Moscow,680,3,10,6,4,38,27,11,36
Zenit,680,4,8,9,3,24,15,9,33
Krasnodar,680,5,9,4,7,28,25,3,31
FK Rubin,680,6,7,5,8,25,18,7,26
Terek Grozny,680,7,7,5,8,20,24,-4,26
Din Moscow,680,8,5,7,8,18,24,-6,22
Amkar,680,9,5,4,11,11,25,-14,19
Rostov,680,10,4,6,10,11,19,-8,18
Anzhi,680,11,3,5,12,17,41,-24,14
Loko Moscow,681,1,12,6,2,33,14,19,42
Spart Moscow,681,2,11,5,4,40,28,12,38
CSKA Moscow,681,3,11,4,5,28,18,10,37
Zenit,681,4,7,10,3,25,17,8,31
Krasnodar,681,5,9,4,7,29,26,3,31
Terek Grozny,681,6,7,6,7,21,24,-3,27
FK Rubin,681,7,6,5,9,23,19,4,23
Din Moscow,681,8,5,6,9,19,25,-6,21
Amkar,681,9,5,4,11,11,24,-13,19
Rostov,681,10,4,6,10,10,19,-9,18
Anzhi,681,11,2,6,12,15,40,-25,12
Loko Moscow,682,1,11,6,3,30,13,17,39
Spart Moscow,682,2,10,6,4,40,27,13,36
CSKA Moscow,682,3,11,3,6,28,18,10,36
Krasnodar,682,4,10,4,6,30,24,6,34
Zenit,682,5,8,9,3,23,14,9,33
Terek Grozny,682,6,9,5,6,25,22,3,32
FK Rubin,682,7,6,5,9,23,20,3,23
Din Moscow,682,8,5,6,9,18,26,-8,21
Rostov,682,9,4,7,9,11,18,-7,19
Amkar,682,10,4,4,12,10,26,-16,16
Anzhi,682,11,2,5,13,14,44,-30,11
Loko Moscow,683,1,12,6,2,30,11,19,42
CSKA Moscow,683,2,11,4,5,27,18,9,37
Spart Moscow,683,3,8,8,4,36,28,8,32
Zenit,683,4,7,9,4,21,14,7,30
Krasnodar,683,5,8,5,7,29,27,2,29
Terek Grozny,683,6,8,5,7,23,27,-4,29
Din Moscow,683,7,5,8,7,18,22,-4,23
FK Rubin,683,8,5,7,8,24,20,4,22
Rostov,683,9,4,7,9,13,20,-7,19
Amkar,683,10,4,5,11,10,24,-14,17
Anzhi,683,11,3,6,11,19,39,-20,15
Loko Moscow,684,1,11,5,4,32,21,11,38
CSKA Moscow,684,2,11,4,5,28,18,10,37
Spart Moscow,684,3,10,5,5,38,27,11,35
Zenit,684,4,8,9,3,26,13,13,33
Krasnodar,684,5,9,4,7,33,30,3,31
Terek Grozny,684,6,8,6,6,24,25,-1,30
FK Rubin,684,7,7,5,8,26,19,7,26
Din Moscow,684,8,5,6,9,18,26,-8,21
Amkar,684,9,5,4,11,12,24,-12,19
Rostov,684,10,4,6,10,10,19,-9,18
Anzhi,684,11,2,6,12,17,42,-25,12
Loko Moscow,685,1,12,6,2,31,12,19,42
CSKA Moscow,685,2,12,3,5,32,18,14,39
Spart Moscow,685,3,9,7,4,35,26,9,34
Krasnodar,685,4,8,6,6,28,25,3,30
Terek Grozny,685,5,8,6,6,22,22,0,30
Zenit,685,6,7,8,5,23,18,5,29
FK Rubin,685,7,6,6,8,23,18,5,24
Din Moscow,685,8,5,6,9,17,23,-6,21
Rostov,685,9,4,7,9,11,18,-7,19
Amkar,685,10,4,6,10,9,22,-13,18
Anzhi,685,11,2,5,13,14,43,-29,11
Loko Moscow,686,1,11,5,4,29,15,14,38
CSKA Moscow,686,2,11,4,5,31,21,10,37
Spart Moscow,686,3,10,6,4,39,27,12,36
Zenit,686,4,8,9,3,27,16,11,33
Krasnodar,686,5,9,5,6,31,27,4,32
Terek Grozny,686,6,7,7,6,21,23,-2,28
FK Rubin,686,7,5,7,8,25,21,4,22
Din Moscow,686,8,5,7,8,18,24,-6,22
Rostov,686,9,4,6,10,11,20,-9,18
Amkar,686,10,4,6,10,11,24,-13,18
Anzhi,686,11,2,6,12,15,40,-25,12
Loko Moscow,687,1,12,5,3,33,14,19,41
Spart Moscow,687,2,11,5,4,39,27,12,38
CSKA Moscow,687,3,11,4,5,30,18,12,37
Krasnodar,687,4,9,5,6,30,25,5,32
Zenit,687,5,7,9,4,22,17,5,30
Terek Grozny,687,6,8,5,7,23,24,-1,29
FK Rubin,687,7,5,7,8,22,18,4,22
Din Moscow,687,8,5,7,8,18,24,-6,22
Amkar,687,9,5,4,11,13,26,-13,19
Rostov,687,10,4,6,10,10,18,-8,18
Anzhi,687,11,2,5,13,14,43,-29,11
Loko Moscow,688,1,11,6,3,29,13,16,39
CSKA Moscow,688,2,10,4,6,25,19,6,34
Zenit,688,3,8,9,3,23,13,10,33
Spart Moscow,688,4,8,7,5,37,30,7,31
Krasnodar,688,5,9,4,7,30,28,2,31
Terek Grozny,688,6,8,6,6,24,25,-1,30
FK Rubin,688,7,7,5,8,26,18,8,26
Din Moscow,688,8,6,6,8,19,23,-4,24
Rostov,688,9,4,7,9,11,18,-7,19
Amkar,688,10,4,6,10,12,25,-13,18
Anzhi,688,11,2,6,12,16,40,-24,12
Loko Moscow,689,1,12,6,2,32,13,19,42
Spart Moscow,689,2,11,5,4,43,29,14,38
CSKA Moscow,689,3,11,4,5,29,18,11,37
Zenit,689,4,7,9,4,22,15,7,30
Krasnodar,689,5,8,5,7,32,30,2,29
Terek Grozny,689,6,7,5,8,21,25,-4,26
Din Moscow,689,7,6,6,8,23,27,-4,24
FK Rubin,689,8,6,5,9,25,23,2,23
Amkar,689,9,5,4,11,10,23,-13,19
Rostov,689,10,4,6,10,11,20,-9,18
Anzhi,689,11,3,5,12,16,41,-25,14
Loko Moscow,690,1,12,6,2,31,12,19,42
CSKA Moscow,690,2,11,4,5,30,19,11,37
Spart Moscow,690,3,9,7,4,38,28,10,34
Zenit,690,4,7,10,3,23,15,8,31
Terek Grozny,690,5,8,5,7,22,25,-3,29
Krasnodar,690,6,8,4,8,30,30,0,28
FK Rubin,690,7,6,6,8,27,21,6,24
Din Moscow,690,8,5,7,8,20,26,-6,22
Rostov,690,9,4,7,9,12,19,-7,19
Amkar,690,10,4,5,11,9,23,-14,17
Anzhi,690,11,3,5,12,17,41,-24,14
Loko Moscow,691,1,11,5,4,30,15,15,38
Spart Moscow,691,2,10,6,4,38,28,10,36
Zenit,691,3,9,8,3,24,13,11,35
Krasnodar,691,4,10,4,6,31,25,6,34
CSKA Moscow,691,5,10,4,6,26,20,6,34
Terek Grozny,691,6,7,6,7,22,25,-3,27
FK Rubin,691,7,6,5,9,25,18,7,23
Din Moscow,691,8,5,6,9,18,27,-9,21
Rostov,691,9,4,7,9,10,17,-7,19
Amkar,691,10,5,4,11,12,25,-13,19
Anzhi,691,11,2,7,11,17,40,-23,13
Loko Moscow,692,1,12,6,2,30,11,19,42
CSKA Moscow,692,2,11,3,6,26,19,7,36
Spart Moscow,692,3,10,5,5,39,28,11,35
Zenit,692,4,8,9,3,23,13,10,33
Krasnodar,692,5,8,5,7,30,28,2,29
Terek Grozny,692,6,8,5,7,21,23,-2,29
Din Moscow,692,7,7,6,7,24,23,1,27
FK Rubin,692,8,5,6,9,25,24,1,21
Rostov,692,9,4,6,10,10,19,-9,18
Amkar,692,10,4,4,12,9,26,-17,16
Anzhi,692,11,3,5,12,15,38,-23,14
Loko Moscow,693,1,11,6,3,31,14,17,39
CSKA Moscow,693,2,11,3,6,30,20,10,36
Zenit,693,3,9,8,3,25,14,11,35
Krasnodar,693,4,9,5,6,34,28,6,32
Terek Grozny,693,5,9,5,6,27,23,4,32
Spart Moscow,693,6,8,7,5,36,30,6,31
Din Moscow,693,7,6,7,7,19,21,-2,25
FK Rubin,693,8,5,6,9,23,22,1,21
Rostov,693,9,4,7,9,11,18,-7,19
Amkar,693,10,4,5,11,12,27,-15,17
Anzhi,693,11,2,5,13,14,45,-31,11
Loko Moscow,694,1,12,6,2,31,11,20,42
Spart Moscow,694,2,10,6,4,36,25,11,36
CSKA Moscow,694,3,11,3,6,30,19,11,36
Zenit,694,4,8,9,3,23,14,9,33
Terek Grozny,694,5,8,5,7,23,23,0,29
Krasnodar,694,6,8,4,8,29,29,0,28
FK Rubin,694,7,6,6,8,25,20,5,24
Din Moscow,694,8,5,7,8,18,24,-6,22
Rostov,694,9,4,6,10,10,18,-8,18
Amkar,694,10,4,5,11,9,25,-16,17
Anzhi,694,11,3,5,12,15,41,-26,14
Loko Moscow,695,1,11,6,3,29,13,16,39
CSKA Moscow,695,2,11,4,5,26,17,9,37
Spart Moscow,695,3,10,5,5,37,26,11,35
Krasnodar,695,4,9,4,7,30,26,4,31
Zenit,695,5,7,9,4,21,14,7,30
Terek Grozny,695,6,7,5,8,22,27,-5,26
FK Rubin,695,7,6,6,8,23,18,5,24
Din Moscow,695,8,5,7,8,17,24,-7,22
Amkar,695,9,6,4,10,13,23,-10,22
Rostov,695,10,4,6,10,10,18,-8,18
Anzhi,695,11,3,6,11,16,38,-22,15
Loko Moscow,696,1,12,6,2,31,12,19,42
Spart Moscow,696,2,9,7,4,40,26,14,34
CSKA Moscow,696,3,10,4,6,26,21,5,34
Zenit,696,4,8,9,3,24,13,11,33
Krasnodar,696,5,8,5,7,29,27,2,29
Terek Grozny,696,6,7,6,7,20,26,-6,27
FK Rubin,696,7,6,6,8,23,18,5,24
Din Moscow,696,8,5,7,8,17,22,-5,22
Amkar,696,9,4,6,10,10,23,-13,18
Rostov,696,9,4,6,10,10,23,-13,18
Anzhi,696,11,3,6,11,19,38,-19,15
Loko Moscow,697,1,11,7,2,32,14,18,40
CSKA Moscow,697,2,12,3,5,27,17,10,39
Spart Moscow,697,3,11,5,4,41,27,14,38
Krasnodar,697,4,9,5,6,30,26,4,32
Zenit,697,5,7,9,4,22,15,7,30
Terek Grozny,697,6,8,5,7,24,25,-1,29
FK Rubin,697,7,6,5,9,24,19,5,23
Din Moscow,697,8,5,6,9,18,27,-9,21
Rostov,697,9,4,6,10,11,20,-9,18
Amkar,697,10,4,4,12,10,27,-17,16
Anzhi,697,11,3,5,12,17,39,-22,14
Loko Moscow,698,1,12,6,2,31,12,19,42
CSKA Moscow,698,2,11,4,5,27,18,9,37
Spart Moscow,698,3,9,7,4,38,29,9,34
Zenit,698,4,7,10,3,22,14,8,31
Krasnodar,698,5,9,4,7,29,25,4,31
Terek Grozny,698,6,8,5,7,22,25,-3,29
Din Moscow,698,7,6,6,8,20,24,-4,24
FK Rubin,698,8,5,5,10,21,20,1,20
Amkar,698,9,5,5,10,12,23,-11,20
Rostov,698,10,4,7,9,11,18,-7,19
Anzhi,698,11,2,5,13,16,41,-25,11
Loko Moscow,699,1,12,5,3,32,14,18,41
CSKA Moscow,699,2,11,4,5,30,19,11,37
Spart Moscow,699,3,10,6,4,38,27,11,36
Krasnodar,699,4,10,4,6,29,24,5,34
Zenit,699,5,7,9,4,23,16,7,30
Terek Grozny,699,6,8,5,7,22,23,-1,29
Din Moscow,699,7,5,7,8,17,23,-6,22
FK Rubin,699,8,5,6,9,21,18,3,21
Rostov,699,9,4,6,10,11,19,-8,18
Amkar,699,10,4,5,11,10,25,-15,17
Anzhi,699,11,3,5,12,17,42,-25,14
Loko Moscow,700,1,13,5,2,32,12,20,44
CSKA Moscow,700,2,11,4,5,30,18,12,37
Spart Moscow,700,3,10,5,5,35,26,9,35
Zenit,700,4,7,9,4,23,16,7,30
Terek Grozny,700,5,8,5,7,23,26,-3,29
Krasnodar,700,6,8,4,8,27,28,-1,28
Din Moscow,700,7,6,6,8,19,22,-3,24
FK Rubin,700,8,6,5,9,24,19,5,23
Amkar,700,9,5,4,11,11,24,-13,19
Rostov,700,10,4,6,10,10,18,-8,18
Anzhi,700,11,3,5,12,17,42,-25,14
Loko Moscow,701,1,13,5,2,33,13,20,44
CSKA Moscow,701,2,11,4,5,28,19,9,37
Spart Moscow,701,3,9,5,6,37,30,7,32
Krasnodar,701,4,9,4,7,29,26,3,31
Zenit,701,5,7,9,4,23,16,7,30
Terek Grozny,701,6,8,5,7,22,24,-2,29
Din Moscow,701,7,6,7,7,19,22,-3,25
FK Rubin,701,8,5,6,9,22,19,3,21
Amkar,701,9,5,4,11,12,24,-12,19
Rostov,701,10,4,6,10,11,20,-9,18
Anzhi,701,11,3,5,12,17,40,-23,14
Loko Moscow,702,1,12,5,3,31,15,16,41
CSKA Moscow,702,2,12,3,5,30,19,11,39
Krasnodar,702,3,9,5,6,32,26,6,32
Spart Moscow,702,4,8,7,5,35,28,7,31
Zenit,702,5,7,8,5,22,17,5,29
Terek Grozny,702,6,8,5,7,22,24,-2,29
Din Moscow,702,7,6,7,7,20,22,-2,25
FK Rubin,702,8,5,6,9,22,20,2,21
Rostov,702,9,5,6,9,11,17,-6,21
Amkar,702,10,5,5,10,11,23,-12,20
Anzhi,702,11,2,5,13,16,41,-25,11
Loko Moscow,703,1,12,6,2,33,13,20,42
CSKA Moscow,703,2,11,4,5,27,18,9,37
Spart Moscow,703,3,10,6,4,41,27,14,36
Terek Grozny,703,4,9,5,6,23,23,0,32
Zenit,703,5,7,9,4,22,15,7,30
Krasnodar,703,6,8,5,7,29,28,1,29
Din Moscow,703,7,6,7,7,21,23,-2,25
FK Rubin,703,8,5,6,9,23,21,2,21
Rostov,703,9,4,6,10,11,22,-11,18
Amkar,703,10,4,4,12,9,25,-16,16
Anzhi,703,11,2,6,12,16,40,-24,12
Loko Moscow,704,1,12,5,3,30,13,17,41
CSKA Moscow,704,2,11,4,5,28,18,10,37
Spart Moscow,704,3,10,5,5,41,31,10,35
Krasnodar,704,4,10,4,6,32,24,8,34
Terek Grozny,704,5,8,6,6,22,23,-1,30
Zenit,704,6,7,8,5,21,16,5,29
FK Rubin,704,7,6,5,9,23,21,2,23
Rostov,704,8,5,6,9,12,18,-6,21
Din Moscow,704,9,5,6,9,20,27,-7,21
Amkar,704,10,4,4,12,11,26,-15,16
Anzhi,704,11,2,7,11,16,39,-23,13
Loko Moscow,705,1,11,7,2,32,14,18,40
CSKA Moscow,705,2,11,3,6,29,19,10,36
Spart Moscow,705,3,10,5,5,38,27,11,35
Zenit,705,4,8,9,3,24,15,9,33
Krasnodar,705,5,8,6,6,29,26,3,30
Terek Grozny,705,6,7,5,8,20,24,-4,26
Din Moscow,705,7,6,6,8,21,25,-4,24
Amkar,705,8,6,4,10,11,22,-11,22
FK Rubin,705,9,5,6,9,23,21,2,21
Rostov,705,10,4,6,10,10,19,-9,18
Anzhi,705,11,3,5,12,16,41,-25,14
Loko Moscow,706,1,12,6,2,30,11,19,42
CSKA Moscow,706,2,12,3,5,30,19,11,39
Spart Moscow,706,3,10,5,5,38,28,10,35
Krasnodar,706,4,8,6,6,27,24,3,30
Zenit,706,5,7,8,5,22,16,6,29
Terek Grozny,706,6,8,5,7,23,23,0,29
Din Moscow,706,7,7,6,7,23,23,0,27
FK Rubin,706,8,5,6,9,22,20,2,21
Amkar,706,9,5,4,11,10,24,-14,19
Rostov,706,10,4,6,10,10,19,-9,18
Anzhi,706,11,2,5,13,15,43,-28,11
Loko Moscow,707,1,12,6,2,35,13,22,42
Spart Moscow,707,2,11,5,4,40,25,15,38
CSKA Moscow,707,3,10,4,6,26,19,7,34
Zenit,707,4,8,9,3,23,14,9,33
Krasnodar,707,5,8,5,7,30,31,-1,29
Terek Grozny,707,6,7,7,6,24,26,-2,28
FK Rubin,707,7,5,7,8,23,19,4,22
Din Moscow,707,8,5,7,8,17,24,-7,22
Rostov,707,9,4,6,10,10,20,-10,18
Amkar,707,10,4,5,11,11,25,-14,17
Anzhi,707,11,2,7,11,17,40,-23,13
Loko Moscow,708,1,11,6,3,30,13,17,39
Spart Moscow,708,2,10,5,5,38,28,10,35
Krasnodar,708,3,10,4,6,30,24,6,34
Zenit,708,4,8,9,3,24,14,10,33
CSKA Moscow,708,5,10,3,7,26,21,5,33
Terek Grozny,708,6,9,5,6,23,23,0,32
FK Rubin,708,7,6,5,9,22,19,3,23
Rostov,708,8,5,6,9,12,17,-5,21
Din Moscow,708,9,5,6,9,17,25,-8,21
Amkar,708,10,4,4,12,10,25,-15,16
Anzhi,708,11,3,5,12,17,40,-23,14
Loko Moscow,709,1,11,7,2,30,12,18,40
Spart Moscow,709,2,10,6,4,38,26,12,36
CSKA Moscow,709,3,11,3,6,27,19,8,36
Zenit,709,4,8,9,3,24,15,9,33
Krasnodar,709,5,9,5,6,30,24,6,32
Terek Grozny,709,6,7,7,6,22,24,-2,28
FK Rubin,709,7,6,5,9,22,20,2,23
Din Moscow,709,8,5,6,9,17,25,-8,21
Rostov,709,9,4,6,10,10,18,-8,18
Amkar,709,10,4,6,10,10,23,-13,18
Anzhi,709,11,2,6,12,16,40,-24,12
Loko Moscow,710,1,11,5,4,30,14,16,38
CSKA Moscow,710,2,11,4,5,29,18,11,37
Krasnodar,710,3,10,4,6,29,24,5,34
Zenit,710,4,8,9,3,24,15,9,33
Spart Moscow,710,5,9,6,5,37,29,8,33
Terek Grozny,710,6,7,6,7,20,23,-3,27
Din Moscow,710,7,6,6,8,20,24,-4,24
FK Rubin,710,8,6,5,9,23,19,4,23
Amkar,710,9,5,5,10,12,24,-12,20
Rostov,710,10,4,6,10,10,18,-8,18
Anzhi,710,11,2,6,12,14,40,-26,12
Loko Moscow,711,1,11,6,3,31,14,17,39
Zenit,711,2,8,9,3,24,15,9,33
Spart Moscow,711,3,9,6,5,36,28,8,33
CSKA Moscow,711,4,10,3,7,28,22,6,33
Krasnodar,711,5,9,5,6,30,26,4,32
Din Moscow,711,6,7,6,7,21,22,-1,27
Terek Grozny,711,7,7,5,8,21,28,-7,26
FK Rubin,711,8,5,6,9,22,20,2,21
Amkar,711,9,5,5,10,13,24,-11,20
Rostov,711,10,4,6,10,10,18,-8,18
Anzhi,711,11,4,5,11,20,39,-19,17
Loko Moscow,712,1,12,5,3,30,13,17,41
CSKA Moscow,712,2,11,4,5,27,18,9,37
Zenit,712,3,8,9,3,23,13,10,33
Terek Grozny,712,4,9,5,6,24,24,0,32
Spart Moscow,712,5,8,6,6,34,29,5,30
Krasnodar,712,6,8,5,7,29,27,2,29
Din Moscow,712,7,6,7,7,20,22,-2,25
FK Rubin,712,8,5,6,9,23,21,2,21
Rostov,712,9,5,6,9,12,17,-5,21
Amkar,712,10,5,4,11,10,23,-13,19
Anzhi,712,11,2,5,13,17,42,-25,11
Loko Moscow,713,1,12,5,3,30,12,18,41
CSKA Moscow,713,2,11,4,5,27,18,9,37
Spart Moscow,713,3,9,6,5,35,27,8,33
Krasnodar,713,4,9,4,7,28,26,2,31
Zenit,713,5,7,9,4,21,14,7,30
Terek Grozny,713,6,8,5,7,24,25,-1,29
FK Rubin,713,7,6,6,8,25,19,6,24
Din Moscow,713,8,5,7,8,19,24,-5,22
Rostov,713,9,5,6,9,11,17,-6,21
Amkar,713,10,5,5,10,11,23,-12,20
Anzhi,713,11,2,5,13,17,43,-26,11
Loko Moscow,714,1,13,5,2,31,11,20,44
CSKA Moscow,714,2,11,4,5,29,18,11,37
Spart Moscow,714,3,10,5,5,40,29,11,35
Krasnodar,714,4,9,4,7,29,25,4,31
Zenit,714,5,7,9,4,22,15,7,30
Terek Grozny,714,6,8,5,7,23,24,-1,29
FK Rubin,714,7,6,5,9,23,19,4,23
Rostov,714,8,5,6,9,12,18,-6,21
Din Moscow,714,9,5,6,9,17,25,-8,21
Amkar,714,10,4,4,12,11,28,-17,16
Anzhi,714,11,3,5,12,16,41,-25,14
CSKA Moscow,715,1,12,3,5,31,19,12,39
Loko Moscow,715,2,11,5,4,30,14,16,38
Spart Moscow,715,3,9,6,5,36,28,8,33
Zenit,715,4,8,8,4,25,18,7,32
Krasnodar,715,5,9,5,6,28,24,4,32
Terek Grozny,715,6,8,5,7,22,24,-2,29
Din Moscow,715,7,6,7,7,22,25,-3,25
FK Rubin,715,8,5,6,9,23,20,3,21
Rostov,715,9,5,6,9,11,17,-6,21
Amkar,715,10,5,4,11,11,24,-13,19
Anzhi,715,11,2,5,13,14,40,-26,11
Loko Moscow,716,1,12,5,3,33,12,21,41
CSKA Moscow,716,2,12,3,5,31,17,14,39
Spart Moscow,716,3,10,6,4,37,27,10,36
Zenit,716,4,8,8,4,22,14,8,32
Krasnodar,716,5,8,4,8,27,29,-2,28
Terek Grozny,716,6,7,6,7,21,25,-4,27
FK Rubin,716,7,6,6,8,23,18,5,24
Din Moscow,716,8,5,8,7,18,22,-4,23
Rostov,716,9,4,6,10,10,18,-8,18
Amkar,716,10,4,5,11,11,25,-14,17
Anzhi,716,11,3,5,12,17,43,-26,14
Spart Moscow,717,1,11,5,4,41,26,15,38
Loko Moscow,717,2,11,5,4,30,16,14,38
CSKA Moscow,717,3,11,4,5,29,19,10,37
Zenit,717,4,8,9,3,23,14,9,33
Krasnodar,717,5,9,5,6,34,28,6,32
Terek Grozny,717,6,8,5,7,21,23,-2,29
Din Moscow,717,7,6,6,8,21,25,-4,24
FK Rubin,717,8,5,6,9,25,23,2,21
Rostov,717,9,4,6,10,10,20,-10,18
Amkar,717,10,4,4,12,9,25,-16,16
Anzhi,717,11,3,5,12,16,40,-24,14
Loko Moscow,718,1,11,6,3,30,13,17,39
CSKA Moscow,718,2,11,3,6,28,19,9,36
Krasnodar,718,3,10,4,6,29,24,5,34
Spart Moscow,718,4,9,6,5,39,30,9,33
Zenit,718,5,8,9,3,24,15,9,33
Terek Grozny,718,6,7,5,8,21,27,-6,26
Din Moscow,718,7,6,7,7,20,23,-3,25
Amkar,718,8,6,4,10,15,24,-9,22
FK Rubin,718,9,5,5,10,21,19,2,20
Rostov,718,10,4,6,10,11,20,-9,18
Anzhi,718,11,3,5,12,15,39,-24,14
Loko Moscow,719,1,12,6,2,34,13,21,42
CSKA Moscow,719,2,12,3,5,28,17,11,39
Spart Moscow,719,3,9,7,4,38,29,9,34
Terek Grozny,719,4,9,5,6,26,25,1,32
Zenit,719,5,7,9,4,22,16,6,30
Krasnodar,719,6,8,5,7,30,30,0,29
FK Rubin,719,7,6,6,8,24,19,5,24
Din Moscow,719,8,5,7,8,19,24,-5,22
Rostov,719,9,4,6,10,12,20,-8,18
Amkar,719,10,4,5,11,10,25,-15,17
Anzhi,719,11,2,5,13,16,41,-25,11
Loko Moscow,720,1,11,6,3,29,13,16,39
Spart Moscow,720,2,10,6,4,41,28,13,36
CSKA Moscow,720,3,11,3,6,27,19,8,36
Zenit,720,4,9,8,3,25,13,12,35
Krasnodar,720,5,9,5,6,28,24,4,32
Terek Grozny,720,6,7,6,7,23,27,-4,27
Din Moscow,720,7,5,7,8,19,26,-7,22
FK Rubin,720,8,5,6,9,21,18,3,21
Rostov,720,9,4,7,9,11,18,-7,19
Amkar,720,10,5,4,11,11,24,-13,19
Anzhi,720,11,2,6,12,17,42,-25,12
Loko Moscow,721,1,11,6,3,31,14,17,39
Spart Moscow,721,2,11,5,4,38,27,11,38
Krasnodar,721,3,10,4,6,30,25,5,34
Zenit,721,4,8,9,3,25,16,9,33
CSKA Moscow,721,5,10,3,7,26,20,6,33
Terek Grozny,721,6,8,5,7,22,24,-2,29
Din Moscow,721,7,6,6,8,20,23,-3,24
FK Rubin,721,8,5,5,10,22,21,1,20
Rostov,721,9,4,6,10,11,19,-8,18
Anzhi,721,10,4,5,11,17,38,-21,17
Amkar,721,11,4,4,12,9,24,-15,16
Loko Moscow,722,1,12,5,3,35,15,20,41
Zenit,722,2,9,8,3,27,17,10,35
CSKA Moscow,722,3,10,4,6,27,20,7,34
Spart Moscow,722,4,8,7,5,37,30,7,31
Krasnodar,722,5,9,4,7,30,29,1,31
Terek Grozny,722,6,8,6,6,21,22,-1,30
Din Moscow,722,7,6,7,7,21,24,-3,25
Rostov,722,8,5,6,9,11,17,-6,21
FK Rubin,722,9,5,5,10,23,21,2,20
Amkar,722,10,4,5,11,11,25,-14,17
Anzhi,722,11,2,7,11,14,37,-23,13
Loko Moscow,723,1,11,7,2,30,12,18,40
Spart Moscow,723,2,11,5,4,38,25,13,38
CSKA Moscow,723,3,11,3,6,27,19,8,36
Zenit,723,4,8,9,3,23,14,9,33
Krasnodar,723,5,9,5,6,31,25,6,32
Terek Grozny,723,6,8,5,7,21,23,-2,29
Din Moscow,723,7,5,7,8,17,22,-5,22
FK Rubin,723,8,5,6,9,21,20,1,21
Rostov,723,9,4,6,10,10,20,-10,18
Amkar,723,10,4,4,12,9,24,-15,16
Anzhi,723,11,3,5,12,15,38,-23,14
Loko Moscow,724,1,11,6,3,29,12,17,39
CSKA Moscow,724,2,11,4,5,30,20,10,37
Krasnodar,724,3,10,4,6,29,24,5,34
Spart Moscow,724,4,9,6,5,38,29,9,33
Zenit,724,5,7,9,4,22,16,6,30
Din Moscow,724,6,7,6,7,22,23,-1,27
Terek Grozny,724,7,7,6,7,20,24,-4,27
FK Rubin,724,8,5,5,10,21,20,1,20
Rostov,724,9,4,6,10,10,19,-9,18
Amkar,724,10,4,6,10,10,23,-13,18
Anzhi,724,11,3,6,11,18,39,-21,15
Loko Moscow,725,1,12,6,2,32,13,19,42
CSKA Moscow,725,2,11,3,6,28,18,10,36
Zenit,725,3,8,9,3,23,14,9,33
Krasnodar,725,4,9,4,7,31,28,3,31
Spart Moscow,725,5,8,6,6,34,29,5,30
Terek Grozny,725,6,8,5,7,24,26,-2,29
Din Moscow,725,7,6,6,8,20,23,-3,24
FK Rubin,725,8,6,5,9,24,20,4,23
Amkar,725,9,6,4,10,13,24,-11,22
Rostov,725,10,4,7,9,10,17,-7,19
Anzhi,725,11,2,5,13,15,42,-27,11
Loko Moscow,726,1,12,5,3,31,12,19,41
CSKA Moscow,726,2,11,4,5,29,20,9,37
Krasnodar,726,3,10,4,6,29,24,5,34
Spart Moscow,726,4,9,5,6,35,30,5,32
Zenit,726,5,7,9,4,23,17,6,30
Terek Grozny,726,6,8,5,7,21,24,-3,29
Din Moscow,726,7,7,6,7,21,22,-1,27
Amkar,726,8,6,4,10,14,22,-8,22
FK Rubin,726,9,5,5,10,21,20,1,20
Rostov,726,10,4,6,10,10,18,-8,18
Anzhi,726,11,2,5,13,15,40,-25,11
Loko Moscow,727,1,12,6,2,30,11,19,42
CSKA Moscow,727,2,11,4,5,29,20,9,37
Spart Moscow,727,3,9,7,4,35,26,9,34
Zenit,727,4,7,9,4,23,16,7,30
Krasnodar,727,5,8,6,6,28,25,3,30
Terek Grozny,727,6,8,6,6,21,22,-1,30
FK Rubin,727,7,5,7,8,23,19,4,22
Din Moscow,727,8,5,7,8,19,24,-5,22
Rostov,727,9,4,7,9,10,17,-7,19
Amkar,727,10,4,6,10,9,22,-13,18
Anzhi,727,11,2,5,13,15,40,-25,11
Loko Moscow,728,1,12,6,2,31,12,19,42
CSKA Moscow,728,2,11,4,5,29,17,12,37
Spart Moscow,728,3,10,5,5,40,29,11,35
Zenit,728,4,7,10,3,21,13,8,31
Krasnodar,728,5,9,4,7,31,27,4,31
Terek Grozny,728,6,8,6,6,24,24,0,30
FK Rubin,728,7,6,5,9,25,20,5,23
Rostov,728,8,5,6,9,14,18,-4,21
Din Moscow,728,9,5,6,9,17,27,-10,21
Amkar,728,10,4,5,11,11,27,-16,17
Anzhi,728,11,2,5,13,14,43,-29,11
Loko Moscow,729,1,11,6,3,30,13,17,39
Spart Moscow,729,2,10,6,4,40,28,12,36
CSKA Moscow,729,3,10,4,6,26,19,7,34
Krasnodar,729,4,10,4,6,29,24,5,34
Zenit,729,5,8,9,3,23,14,9,33
Terek Grozny,729,6,8,6,6,21,22,-1,30
FK Rubin,729,7,6,5,9,23,19,4,23
Din Moscow,729,8,5,6,9,20,26,-6,21
Rostov,729,9,4,6,10,10,20,-10,18
Amkar,729,10,4,6,10,10,23,-13,18
Anzhi,729,11,2,6,12,15,39,-24,12
Loko Moscow,730,1,12,6,2,31,11,20,42
CSKA Moscow,730,2,11,3,6,27,19,8,36
Spart Moscow,730,3,10,5,5,39,30,9,35
Zenit,730,4,8,8,4,23,15,8,32
Krasnodar,730,5,9,5,6,30,25,5,32
Terek Grozny,730,6,8,6,6,23,23,0,30
Din Moscow,730,7,5,7,8,19,24,-5,22
FK Rubin,730,8,5,6,9,23,21,2,21
Amkar,730,9,5,4,11,12,24,-12,19
Rostov,730,10,4,6,10,11,21,-10,18
Anzhi,730,11,2,6,12,15,40,-25,12
Loko Moscow,731,1,13,5,2,35,13,22,44
CSKA Moscow,731,2,12,3,5,29,17,12,39
Spart Moscow,731,3,9,6,5,36,28,8,33
Krasnodar,731,4,9,4,7,29,26,3,31
Zenit,731,5,7,8,5,22,18,4,29
Terek Grozny,731,6,7,6,7,21,24,-3,27
Din Moscow,731,7,6,6,8,19,24,-5,24
Amkar,731,8,6,4,10,12,22,-10,22
FK Rubin,731,9,5,5,10,22,20,2,20
Rostov,731,10,4,7,9,11,18,-7,19
Anzhi,731,11,2,6,12,15,41,-26,12
Loko Moscow,732,1,12,5,3,33,14,19,41
CSKA Moscow,732,2,11,3,6,30,18,12,36
Spart Moscow,732,3,9,7,4,35,26,9,34
Krasnodar,732,4,10,4,6,32,27,5,34
Zenit,732,5,8,8,4,22,15,7,32
Terek Grozny,732,6,8,5,7,21,23,-2,29
Din Moscow,732,7,6,6,8,21,24,-3,24
FK Rubin,732,8,5,5,10,23,22,1,20
Rostov,732,9,4,7,9,10,17,-7,19
Amkar,732,10,4,5,11,9,23,-14,17
Anzhi,732,11,3,5,12,15,42,-27,14
Loko Moscow,733,1,13,5,2,33,12,21,44
CSKA Moscow,733,2,12,3,5,29,18,11,39
Spart Moscow,733,3,9,5,6,36,30,6,32
Krasnodar,733,4,9,4,7,30,26,4,31
Zenit,733,5,7,8,5,21,16,5,29
Din Moscow,733,6,7,6,7,21,22,-1,27
Terek Grozny,733,7,7,6,7,20,23,-3,27
Amkar,733,8,6,4,10,11,22,-11,22
FK Rubin,733,9,5,5,10,21,20,1,20
Rostov,733,10,4,6,10,11,19,-8,18
Anzhi,733,11,2,6,12,15,40,-25,12
Loko Moscow,734,1,12,6,2,32,13,19,42
CSKA Moscow,734,2,11,4,5,28,19,9,37
Spart Moscow,734,3,9,5,6,35,28,7,32
Zenit,734,4,7,9,4,23,16,7,30
Krasnodar,734,5,8,5,7,28,27,1,29
Terek Grozny,734,6,8,5,7,22,25,-3,29
Din Moscow,734,7,6,7,7,20,22,-2,25
FK Rubin,734,8,6,6,8,24,18,6,24
Amkar,734,9,5,4,11,11,24,-13,19
Rostov,734,10,4,6,10,10,19,-9,18
Anzhi,734,11,3,5,12,17,39,-22,14
Loko Moscow,735,1,12,6,2,31,11,20,42
Spart Moscow,735,2,11,5,4,37,25,12,38
CSKA Moscow,735,3,11,4,5,28,18,10,37
Krasnodar,735,4,9,5,6,31,25,6,32
Zenit,735,5,7,8,5,21,17,4,29
Terek Grozny,735,6,7,6,7,22,25,-3,27
Din Moscow,735,7,5,7,8,18,23,-5,22
FK Rubin,735,8,5,6,9,23,22,1,21
Amkar,735,9,5,4,11,10,24,-14,19
Rostov,735,10,4,6,10,10,18,-8,18
Anzhi,735,11,2,7,11,17,40,-23,13
Loko Moscow,736,1,12,5,3,31,13,18,41
CSKA Moscow,736,2,11,4,5,28,18,10,37
Zenit,736,3,8,9,3,24,15,9,33
Spart Moscow,736,4,8,6,6,37,32,5,30
Krasnodar,736,5,8,5,7,28,26,2,29
Terek Grozny,736,6,8,5,7,21,23,-2,29
FK Rubin,736,7,6,6,8,24,19,5,24
Din Moscow,736,8,5,7,8,20,25,-5,22
Amkar,736,9,6,4,10,13,23,-10,22
Rostov,736,10,5,6,9,12,18,-6,21
Anzhi,736,11,2,5,13,14,40,-26,11
Loko Moscow,737,1,13,5,2,33,13,20,44
CSKA Moscow,737,2,11,4,5,28,18,10,37
Spart Moscow,737,3,10,5,5,38,30,8,35
Krasnodar,737,4,9,4,7,29,26,3,31
Zenit,737,5,7,8,5,23,18,5,29
Terek Grozny,737,6,8,5,7,22,25,-3,29
Din Moscow,737,7,5,7,8,19,24,-5,22
FK Rubin,737,8,5,6,9,22,19,3,21
Rostov,737,9,5,6,9,13,18,-5,21
Amkar,737,10,4,4,12,10,25,-15,16
Anzhi,737,11,3,6,11,17,38,-21,15
Loko Moscow,738,1,13,5,2,33,13,20,44
CSKA Moscow,738,2,12,3,5,32,19,13,39
Spart Moscow,738,3,10,5,5,40,30,10,35
Zenit,738,4,7,8,5,23,19,4,29
Krasnodar,738,5,8,5,7,28,26,2,29
Terek Grozny,738,6,7,5,8,20,24,-4,26
Din Moscow,738,7,6,6,8,18,23,-5,24
Amkar,738,8,6,4,10,13,24,-11,22
FK Rubin,738,9,5,6,9,21,18,3,21
Rostov,738,10,4,6,10,12,20,-8,18
Anzhi,738,11,3,5,12,16,40,-24,14
Loko Moscow,739,1,13,5,2,32,11,21,44
CSKA Moscow,739,2,11,4,5,31,18,13,37
Spart Moscow,739,3,10,6,4,44,30,14,36
Krasnodar,739,4,9,4,7,28,26,2,31
Zenit,739,5,7,9,4,22,15,7,30
Terek Grozny,739,6,8,5,7,22,23,-1,29
FK Rubin,739,7,6,5,9,24,19,5,23
Din Moscow,739,8,5,6,9,18,27,-9,21
Amkar,739,9,5,5,10,12,24,-12,20
Rostov,739,10,4,6,10,13,23,-10,18
Anzhi,739,11,2,5,13,14,44,-30,11
Loko Moscow,740,1,11,6,3,30,13,17,39
CSKA Moscow,740,2,11,3,6,27,19,8,36
Krasnodar,740,3,10,4,6,29,24,5,34
Terek Grozny,740,4,9,5,6,25,24,1,32
Spart Moscow,740,5,8,7,5,36,29,7,31
Zenit,740,6,7,9,4,22,15,7,30
Din Moscow,740,7,6,7,7,22,22,0,25
FK Rubin,740,8,5,5,10,21,22,-1,20
Rostov,740,9,4,7,9,11,18,-7,19
Amkar,740,10,5,4,11,12,26,-14,19
Anzhi,740,11,3,5,12,17,40,-23,14
Loko Moscow,741,1,13,5,2,33,13,20,44
CSKA Moscow,741,2,12,3,5,28,18,10,39
Spart Moscow,741,3,10,6,4,42,28,14,36
Krasnodar,741,4,9,4,7,31,27,4,31
Zenit,741,5,7,8,5,23,17,6,29
Terek Grozny,741,6,7,6,7,20,23,-3,27
FK Rubin,741,7,6,5,9,23,20,3,23
Din Moscow,741,8,5,6,9,19,27,-8,21
Rostov,741,9,4,6,10,10,20,-10,18
Amkar,741,10,4,6,10,10,23,-13,18
Anzhi,741,11,3,5,12,15,38,-23,14
Loko Moscow,742,1,11,5,4,31,17,14,38
Spart Moscow,742,2,11,5,4,39,26,13,38
Krasnodar,742,3,10,4,6,34,25,9,34
CSKA Moscow,742,4,10,4,6,26,19,7,34
Zenit,742,5,8,9,3,25,15,10,33
Terek Grozny,742,6,8,5,7,21,23,-2,29
Din Moscow,742,7,6,6,8,22,25,-3,24
FK Rubin,742,8,5,5,10,22,25,-3,20
Rostov,742,9,4,6,10,10,18,-8,18
Anzhi,742,10,4,5,11,16,37,-21,17
Amkar,742,11,4,4,12,9,25,-16,16
Loko Moscow,743,1,12,6,2,31,12,19,42
CSKA Moscow,743,2,10,4,6,26,19,7,34
Zenit,743,3,8,9,3,23,14,9,33
Spart Moscow,743,4,8,7,5,35,28,7,31
Krasnodar,743,5,8,5,7,31,29,2,29
Terek Grozny,743,6,7,5,8,21,25,-4,26
FK Rubin,743,7,6,6,8,26,21,5,24
Din Moscow,743,8,6,6,8,19,23,-4,24
Amkar,743,9,5,5,10,11,23,-12,20
Rostov,743,10,4,7,9,11,18,-7,19
Anzhi,743,11,3,6,11,16,38,-22,15
Loko Moscow,744,1,11,6,3,29,12,17,39
Spart Moscow,744,2,10,6,4,36,26,10,36
CSKA Moscow,744,3,11,3,6,28,21,7,36
Zenit,744,4,8,8,4,22,15,7,32
Terek Grozny,744,5,9,5,6,24,24,0,32
Krasnodar,744,6,8,5,7,28,27,1,29
FK Rubin,744,7,6,6,8,25,19,6,24
Din Moscow,744,8,5,8,7,18,22,-4,23
Rostov,744,9,4,6,10,10,18,-8,18
Amkar,744,10,4,4,12,10,25,-15,16
Anzhi,744,11,3,5,12,20,41,-21,14
Loko Moscow,745,1,12,5,3,32,16,16,41
CSKA Moscow,745,2,12,3,5,30,19,11,39
Spart Moscow,745,3,10,5,5,38,27,11,35
Krasnodar,745,4,9,5,6,32,26,6,32
Zenit,745,5,7,8,5,22,17,5,29
Terek Grozny,745,6,7,6,7,20,23,-3,27
Din Moscow,745,7,6,6,8,20,25,-5,24
Amkar,745,8,6,4,10,11,22,-11,22
FK Rubin,745,9,5,6,9,22,20,2,21
Rostov,745,10,4,6,10,10,18,-8,18
Anzhi,745,11,2,6,12,16,40,-24,12
Loko Moscow,746,1,12,6,2,30,11,19,42
CSKA Moscow,746,2,11,4,5,29,19,10,37
Zenit,746,3,7,9,4,22,15,7,30
Spart Moscow,746,4,8,6,6,35,29,6,30
Krasnodar,746,5,8,6,6,27,24,3,30
Terek Grozny,746,6,7,7,6,24,26,-2,28
Din Moscow,746,7,6,7,7,21,24,-3,25
FK Rubin,746,8,5,7,8,24,20,4,22
Amkar,746,9,5,5,10,13,25,-12,20
Rostov,746,10,4,7,9,11,18,-7,19
Anzhi,746,11,2,6,12,17,42,-25,12
Loko Moscow,747,1,12,6,2,32,13,19,42
Spart Moscow,747,2,10,6,4,41,30,11,36
CSKA Moscow,747,3,10,5,5,27,19,8,35
Zenit,747,4,7,9,4,23,16,7,30
Krasnodar,747,5,8,6,6,31,28,3,30
Terek Grozny,747,6,7,6,7,21,24,-3,27
FK Rubin,747,7,5,7,8,25,21,4,22
Din Moscow,747,8,5,7,8,19,24,-5,22
Rostov,747,9,4,6,10,11,20,-9,18
Amkar,747,10,4,6,10,13,26,-13,18
Anzhi,747,11,3,6,11,16,38,-22,15
Loko Moscow,748,1,12,6,2,31,12,19,42
CSKA Moscow,748,2,11,3,6,28,20,8,36
Zenit,748,3,8,8,4,23,15,8,32
Spart Moscow,748,4,9,5,6,34,29,5,32
Krasnodar,748,5,9,5,6,29,25,4,32
Terek Grozny,748,6,9,5,6,23,22,1,32
Din Moscow,748,7,6,6,8,21,23,-2,24
Rostov,748,8,5,6,9,13,17,-4,21
FK Rubin,748,9,5,5,10,23,23,0,20
Amkar,748,10,5,4,11,10,24,-14,19
Anzhi,748,11,2,5,13,16,41,-25,11
Loko Moscow,749,1,11,6,3,30,15,15,39
CSKA Moscow,749,2,11,4,5,30,20,10,37
Spart Moscow,749,3,10,5,5,38,30,8,35
Krasnodar,749,4,9,5,6,32,26,6,32
Zenit,749,5,7,9,4,22,16,6,30
Terek Grozny,749,6,7,5,8,21,28,-7,26
Din Moscow,749,7,6,6,8,20,24,-4,24
FK Rubin,749,8,5,6,9,24,21,3,21
Rostov,749,9,5,6,9,13,18,-5,21
Amkar,749,10,5,4,11,12,25,-13,19
Anzhi,749,11,3,6,11,21,40,-19,15
Loko Moscow,750,1,11,5,4,30,14,16,38
Zenit,750,2,9,8,3,23,13,10,35
Spart Moscow,750,3,9,7,4,34,25,9,34
CSKA Moscow,750,4,10,4,6,27,20,7,34
Krasnodar,750,5,10,4,6,31,25,6,34
Terek Grozny,750,6,7,7,6,23,25,-2,28
Din Moscow,750,7,6,6,8,19,22,-3,24
FK Rubin,750,8,5,5,10,21,21,0,20
Rostov,750,9,4,7,9,10,17,-7,19
Amkar,750,10,4,6,10,10,23,-13,18
Anzhi,750,11,2,7,11,18,41,-23,13
Loko Moscow,751,1,11,6,3,32,16,16,39
CSKA Moscow,751,2,11,4,5,27,17,10,37
Spart Moscow,751,3,10,6,4,37,27,10,36
Zenit,751,4,7,10,3,23,15,8,31
Krasnodar,751,5,9,4,7,31,28,3,31
Terek Grozny,751,6,8,5,7,24,25,-1,29
FK Rubin,751,7,6,6,8,25,19,6,24
Din Moscow,751,8,5,8,7,20,24,-4,23
Amkar,751,9,5,4,11,10,23,-13,19
Rostov,751,10,4,6,10,10,18,-8,18
Anzhi,751,11,2,5,13,16,43,-27,11
Loko Moscow,752,1,12,6,2,32,13,19,42
CSKA Moscow,752,2,11,4,5,29,19,10,37
Zenit,752,3,7,10,3,23,15,8,31
Spart Moscow,752,4,8,6,6,34,28,6,30
Terek Grozny,752,5,8,5,7,24,25,-1,29
Krasnodar,752,6,8,4,8,29,29,0,28
Din Moscow,752,7,7,6,7,19,21,-2,27
FK Rubin,752,8,6,5,9,24,19,5,23
Rostov,752,9,5,6,9,11,17,-6,21
Amkar,752,10,5,5,10,12,24,-12,20
Anzhi,752,11,2,5,13,16,43,-27,11
Loko Moscow,753,1,11,6,3,30,14,16,39
CSKA Moscow,753,2,11,3,6,30,19,11,36
Spart Moscow,753,3,9,6,5,42,30,12,33
Zenit,753,4,8,9,3,24,14,10,33
Krasnodar,753,5,9,4,7,30,26,4,31
Terek Grozny,753,6,8,6,6,24,24,0,30
FK Rubin,753,7,7,5,8,25,19,6,26
Rostov,753,8,5,6,9,13,18,-5,21
Din Moscow,753,9,5,6,9,18,29,-11,21
Amkar,753,10,4,5,11,11,26,-15,17
Anzhi,753,11,2,6,12,16,44,-28,12
CSKA Moscow,754,1,12,3,5,31,17,14,39
Loko Moscow,754,2,11,5,4,30,15,15,38
Spart Moscow,754,3,10,5,5,37,27,10,35
Krasnodar,754,4,10,4,6,30,25,5,34
Zenit,754,5,8,8,4,23,14,9,32
Terek Grozny,754,6,8,5,7,21,26,-5,29
FK Rubin,754,7,6,5,9,24,19,5,23
Amkar,754,8,6,4,10,15,23,-8,22
Din Moscow,754,9,5,6,9,18,26,-8,21
Rostov,754,10,4,6,10,10,18,-8,18
Anzhi,754,11,2,5,13,14,43,-29,11
Loko Moscow,755,1,13,5,2,32,11,21,44
Spart Moscow,755,2,11,5,4,40,25,15,38
CSKA Moscow,755,3,11,3,6,28,21,7,36
Zenit,755,4,8,8,4,24,16,8,32
Krasnodar,755,5,8,5,7,29,27,2,29
Terek Grozny,755,6,7,6,7,23,26,-3,27
Din Moscow,755,7,6,6,8,19,25,-6,24
FK Rubin,755,8,5,6,9,24,21,3,21
Amkar,755,9,5,4,11,11,26,-15,19
Rostov,755,10,4,6,10,10,18,-8,18
Anzhi,755,11,2,6,12,17,41,-24,12
Loko Moscow,756,1,12,6,2,31,12,19,42
CSKA Moscow,756,2,12,3,5,31,20,11,39
Spart Moscow,756,3,9,6,5,37,28,9,33
Zenit,756,4,7,9,4,24,17,7,30
Krasnodar,756,5,8,4,8,27,26,1,28
FK Rubin,756,6,7,5,8,24,17,7,26
Terek Grozny,756,7,7,5,8,21,26,-5,26
Amkar,756,8,6,4,10,13,23,-10,22
Din Moscow,756,9,5,6,9,18,26,-8,21
Rostov,756,10,4,7,9,10,17,-7,19
Anzhi,756,11,3,5,12,17,41,-24,14
Loko Moscow,757,1,13,5,2,35,13,22,44
CSKA Moscow,757,2,11,3,6,29,20,9,36
Spart Moscow,757,3,10,5,5,36,27,9,35
Zenit,757,4,8,8,4,23,15,8,32
Krasnodar,757,5,8,4,8,29,30,-1,28
Terek Grozny,757,6,7,6,7,23,26,-3,27
Din Moscow,757,7,6,7,7,20,23,-3,25
FK Rubin,757,8,6,6,8,24,19,5,24
Rostov,757,9,4,6,10,10,18,-8,18
Amkar,757,10,4,5,11,10,24,-14,17
Anzhi,757,11,3,5,12,19,43,-24,14
Loko Moscow,758,1,12,5,3,30,12,18,41
CSKA Moscow,758,2,11,3,6,30,20,10,36
Krasnodar,758,3,10,4,6,30,24,6,34
Spart Moscow,758,4,9,6,5,38,28,10,33
Zenit,758,5,8,8,4,23,15,8,32
Terek Grozny,758,6,8,5,7,22,23,-1,29
Din Moscow,758,7,6,6,8,19,24,-5,24
Amkar,758,8,6,4,10,12,23,-11,22
FK Rubin,758,9,5,5,10,21,21,0,20
Rostov,758,10,4,7,9,11,18,-7,19
Anzhi,758,11,2,5,13,15,43,-28,11
Loko Moscow,759,1,12,5,3,34,14,20,41
CSKA Moscow,759,2,11,4,5,28,18,10,37
Spart Moscow,759,3,9,5,6,36,29,7,32
Krasnodar,759,4,9,4,7,29,26,3,31
Zenit,759,5,7,9,4,22,17,5,30
Terek Grozny,759,6,8,6,6,22,23,-1,30
FK Rubin,759,7,7,5,8,23,17,6,26
Din Moscow,759,8,6,6,8,19,23,-4,24
Amkar,759,9,5,5,10,11,23,-12,20
Rostov,759,10,4,6,10,10,18,-8,18
Anzhi,759,11,2,5,13,16,42,-26,11
Loko Moscow,760,1,12,6,2,31,12,19,42
CSKA Moscow,760,2,11,4,5,29,18,11,37
Spart Moscow,760,3,9,6,5,39,28,11,33
Krasnodar,760,4,9,5,6,31,26,5,32
Zenit,760,5,7,9,4,22,15,7,30
Terek Grozny,760,6,8,6,6,23,23,0,30
Din Moscow,760,7,6,7,7,19,21,-2,25
FK Rubin,760,8,5,6,9,22,20,2,21
Rostov,760,9,4,6,10,10,22,-12,18
Amkar,760,10,4,6,10,11,24,-13,18
Anzhi,760,11,2,5,13,14,42,-28,11
Loko Moscow,761,1,12,6,2,32,12,20,42
Spart Moscow,761,2,11,5,4,43,28,15,38
CSKA Moscow,761,3,10,5,5,26,18,8,35
Zenit,761,4,7,10,3,22,14,8,31
Krasnodar,761,5,9,4,7,30,26,4,31
Terek Grozny,761,6,7,6,7,20,24,-4,27
Din Moscow,761,7,6,6,8,20,26,-6,24
FK Rubin,761,8,5,5,10,22,22,0,20
Amkar,761,9,5,4,11,11,24,-13,19
Rostov,761,10,4,6,10,12,21,-9,18
Anzhi,761,11,2,7,11,15,38,-23,13
Loko Moscow,762,1,12,5,3,31,13,18,41
Spart Moscow,762,2,10,6,4,41,26,15,36
CSKA Moscow,762,3,10,4,6,28,22,6,34
Zenit,762,4,8,9,3,22,13,9,33
Krasnodar,762,5,9,4,7,31,27,4,31
Terek Grozny,762,6,7,5,8,20,25,-5,26
Din Moscow,762,7,6,6,8,21,26,-5,24
FK Rubin,762,8,5,5,10,22,23,-1,20
Amkar,762,9,5,5,10,11,22,-11,20
Rostov,762,10,4,6,10,10,20,-10,18
Anzhi,762,11,4,5,11,20,40,-20,17
Loko Moscow,763,1,11,6,3,30,13,17,39
CSKA Moscow,763,2,12,3,5,29,17,12,39
Spart Moscow,763,3,10,6,4,38,28,10,36
Zenit,763,4,8,8,4,22,14,8,32
Terek Grozny,763,5,8,6,6,24,23,1,30
Krasnodar,763,6,8,5,7,28,26,2,29
FK Rubin,763,7,7,5,8,24,17,7,26
Din Moscow,763,8,5,7,8,18,24,-6,22
Rostov,763,9,4,6,10,11,19,-8,18
Amkar,763,10,4,4,12,11,28,-17,16
Anzhi,763,11,2,6,12,14,40,-26,12
Loko Moscow,764,1,13,5,2,34,12,22,44
CSKA Moscow,764,2,11,3,6,28,20,8,36
Spart Moscow,764,3,9,6,5,38,28,10,33
Zenit,764,4,8,8,4,24,15,9,32
Krasnodar,764,5,8,5,7,30,29,1,29
Terek Grozny,764,6,8,5,7,22,24,-2,29
FK Rubin,764,7,6,6,8,25,20,5,24
Din Moscow,764,8,5,7,8,18,23,-5,22
Rostov,764,9,5,6,9,13,19,-6,21
Amkar,764,10,5,4,11,10,25,-15,19
Anzhi,764,11,2,5,13,15,42,-27,11
Loko Moscow,765,1,12,5,3,32,13,19,41
CSKA Moscow,765,2,11,4,5,30,21,9,37
Zenit,765,3,8,9,3,24,15,9,33
Spart Moscow,765,4,9,5,6,38,34,4,32
Krasnodar,765,5,8,5,7,30,29,1,29
Terek Grozny,765,6,7,6,7,21,25,-4,27
Din Moscow,765,7,6,7,7,25,24,1,25
FK Rubin,765,8,5,7,8,27,23,4,22
Amkar,765,9,6,4,10,15,25,-10,22
Rostov,765,10,4,6,10,10,19,-9,18
Anzhi,765,11,2,6,12,18,42,-24,12
Loko Moscow,766,1,12,5,3,31,13,18,41
CSKA Moscow,766,2,12,3,5,29,18,11,39
Spart Moscow,766,3,11,5,4,40,26,14,38
Zenit,766,4,8,8,4,22,15,7,32
Krasnodar,766,5,9,4,7,30,26,4,31
Terek Grozny,766,6,8,5,7,22,23,-1,29
FK Rubin,766,7,6,5,9,25,20,5,23
Din Moscow,766,8,5,6,9,18,27,-9,21
Amkar,766,9,5,4,11,10,25,-15,19
Rostov,766,10,4,6,10,11,19,-8,18
Anzhi,766,11,2,5,13,15,41,-26,11
Loko Moscow,767,1,12,5,3,35,13,22,41
Spart Moscow,767,2,10,6,4,41,27,14,36
CSKA Moscow,767,3,11,3,6,33,22,11,36
Zenit,767,4,8,8,4,24,19,5,32
Krasnodar,767,5,9,5,6,29,25,4,32
Terek Grozny,767,6,8,6,6,22,22,0,30
FK Rubin,767,7,6,6,8,23,18,5,24
Din Moscow,767,8,5,6,9,18,28,-10,21
Rostov,767,9,4,6,10,10,18,-8,18
Amkar,767,10,4,5,11,11,26,-15,17
Anzhi,767,11,2,6,12,16,44,-28,12
Loko Moscow,768,1,12,6,2,31,12,19,42
Spart Moscow,768,2,10,5,5,37,27,10,35
CSKA Moscow,768,3,10,4,6,25,18,7,34
Zenit,768,4,7,10,3,21,13,8,31
Terek Grozny,768,5,8,6,6,22,22,0,30
Krasnodar,768,6,8,4,8,29,28,1,28
Din Moscow,768,7,6,7,7,21,24,-3,25
FK Rubin,768,8,6,6,8,25,20,5,24
Rostov,768,9,4,6,10,10,18,-8,18
Amkar,768,10,4,4,12,9,26,-17,16
Anzhi,768,11,3,6,11,15,37,-22,15
Loko Moscow,769,1,11,7,2,31,13,18,40
CSKA Moscow,769,2,12,3,5,29,18,11,39
Spart Moscow,769,3,9,6,5,37,27,10,33
Zenit,769,4,7,9,4,23,16,7,30
Krasnodar,769,5,8,5,7,28,26,2,29
Terek Grozny,769,6,7,7,6,21,23,-2,28
Din Moscow,769,7,6,6,8,20,26,-6,24
FK Rubin,769,8,6,5,9,23,19,4,23
Rostov,769,9,5,6,9,11,17,-6,21
Amkar,769,10,4,6,10,9,22,-13,18
Anzhi,769,11,2,6,12,15,40,-25,12
Loko Moscow,770,1,13,5,2,32,11,21,44
CSKA Moscow,770,2,12,3,5,27,17,10,39
Spart Moscow,770,3,11,5,4,42,28,14,38
Krasnodar,770,4,9,4,7,28,26,2,31
Zenit,770,5,7,8,5,21,15,6,29
Terek Grozny,770,6,7,6,7,21,24,-3,27
FK Rubin,770,7,6,5,9,23,18,5,23
Din Moscow,770,8,5,6,9,19,27,-8,21
Rostov,770,9,4,6,10,10,20,-10,18
Amkar,770,10,4,5,11,10,24,-14,17
Anzhi,770,11,3,5,12,16,39,-23,14
Loko Moscow,771,1,13,5,2,32,11,21,44
CSKA Moscow,771,2,11,4,5,28,18,10,37
Spart Moscow,771,3,10,5,5,41,30,11,35
Zenit,771,4,7,8,5,21,17,4,29
Krasnodar,771,5,8,4,8,30,29,1,28
Terek Grozny,771,6,7,7,6,21,23,-2,28
FK Rubin,771,7,7,5,8,27,20,7,26
Din Moscow,771,8,6,6,8,21,26,-5,24
Rostov,771,9,4,6,10,11,21,-10,18
Amkar,771,10,4,5,11,10,24,-14,17
Anzhi,771,11,2,7,11,15,38,-23,13
Loko Moscow,772,1,12,6,2,33,12,21,42
CSKA Moscow,772,2,12,3,5,32,19,13,39
Spart Moscow,772,3,11,5,4,41,27,14,38
Krasnodar,772,4,9,4,7,30,27,3,31
Zenit,772,5,7,9,4,23,17,6,30
Terek Grozny,772,6,7,6,7,20,23,-3,27
Din Moscow,772,7,5,7,8,19,25,-6,22
FK Rubin,772,8,5,6,9,22,21,1,21
Amkar,772,9,5,4,11,11,25,-14,19
Rostov,772,10,4,6,10,10,19,-9,18
Anzhi,772,11,2,6,12,15,41,-26,12
Loko Moscow,773,1,12,6,2,31,12,19,42
CSKA Moscow,773,2,11,3,6,28,20,8,36
Spart Moscow,773,3,8,8,4,37,29,8,32
Zenit,773,4,8,8,4,24,16,8,32
Krasnodar,773,5,9,5,6,29,25,4,32
Terek Grozny,773,6,7,5,8,21,25,-4,26
FK Rubin,773,7,6,5,9,22,18,4,23
Din Moscow,773,8,5,7,8,18,23,-5,22
Amkar,773,9,5,5,10,12,24,-12,20
Rostov,773,10,4,7,9,11,18,-7,19
Anzhi,773,11,3,5,12,16,39,-23,14
Loko Moscow,774,1,12,6,2,32,12,20,42
CSKA Moscow,774,2,10,4,6,26,19,7,34
Spart Moscow,774,3,8,8,4,37,29,8,32
Krasnodar,774,4,9,5,6,31,27,4,32
Zenit,774,5,7,9,4,21,15,6,30
Terek Grozny,774,6,7,6,7,21,24,-3,27
FK Rubin,774,7,6,5,9,25,21,4,23
Din Moscow,774,8,5,7,8,20,25,-5,22
Rostov,774,9,4,7,9,11,18,-7,19
Amkar,774,10,4,6,10,10,23,-13,18
Anzhi,774,11,4,5,11,18,39,-21,17
Loko Moscow,775,1,12,5,3,30,13,17,41
CSKA Moscow,775,2,11,3,6,28,21,7,36
Zenit,775,3,8,8,4,25,15,10,32
Spart Moscow,775,4,8,7,5,34,27,7,31
Krasnodar,775,5,9,4,7,29,27,2,31
Terek Grozny,775,6,7,6,7,23,26,-3,27
Din Moscow,775,7,6,7,7,18,21,-3,25
FK Rubin,775,8,6,5,9,24,18,6,23
Amkar,775,9,6,4,10,13,24,-11,22
Rostov,775,10,4,7,9,10,17,-7,19
Anzhi,775,11,2,6,12,16,41,-25,12
Loko Moscow,776,1,11,6,3,31,14,17,39
Zenit,776,2,9,8,3,24,14,10,35
Spart Moscow,776,3,10,5,5,36,28,8,35
CSKA Moscow,776,4,10,3,7,26,20,6,33
Krasnodar,776,5,8,6,6,29,26,3,30
Terek Grozny,776,6,7,6,7,20,23,-3,27
FK Rubin,776,7,5,7,8,22,18,4,22
Din Moscow,776,8,5,7,8,18,23,-5,22
Amkar,776,9,5,5,10,11,22,-11,20
Rostov,776,10,4,6,10,10,18,-8,18
Anzhi,776,11,4,5,11,17,38,-21,17
Loko Moscow,777,1,13,5,2,33,13,20,44
CSKA Moscow,777,2,11,3,6,29,22,7,36
Spart Moscow,777,3,10,5,5,37,28,9,35
Zenit,777,4,8,8,4,24,14,10,32
Terek Grozny,777,5,9,5,6,26,25,1,32
Krasnodar,777,6,9,4,7,32,28,4,31
Din Moscow,777,7,6,6,8,21,23,-2,24
FK Rubin,777,8,5,5,10,22,23,-1,20
Amkar,777,9,5,4,11,11,24,-13,19
Rostov,777,10,4,6,10,11,19,-8,18
Anzhi,777,11,2,5,13,18,45,-27,11
Loko Moscow,778,1,12,5,3,33,14,19,41
CSKA Moscow,778,2,11,4,5,27,18,9,37
Spart Moscow,778,3,10,6,4,37,25,12,36
Zenit,778,4,8,9,3,24,15,9,33
Krasnodar,778,5,8,5,7,29,28,1,29
Terek Grozny,778,6,7,5,8,22,26,-4,26
Din Moscow,778,7,6,7,7,18,21,-3,25
FK Rubin,778,8,5,6,9,22,19,3,21
Amkar,778,9,5,4,11,11,24,-13,19
Rostov,778,10,4,6,10,10,20,-10,18
Anzhi,778,11,3,5,12,16,39,-23,14
Loko Moscow,779,1,12,6,2,32,13,19,42
CSKA Moscow,779,2,11,4,5,29,18,11,37
Spart Moscow,779,3,10,5,5,42,28,14,35
Zenit,779,4,7,10,3,23,15,8,31
Krasnodar,779,5,8,4,8,28,27,1,28
Terek Grozny,779,6,7,7,6,21,23,-2,28
Din Moscow,779,7,6,6,8,18,26,-8,24
FK Rubin,779,8,6,5,9,22,18,4,23
Amkar,779,9,5,5,10,11,23,-12,20
Rostov,779,10,4,6,10,11,20,-9,18
Anzhi,779,11,2,6,12,15,41,-26,12
Loko Moscow,780,1,13,5,2,32,12,20,44
CSKA Moscow,780,2,11,4,5,27,18,9,37
Spart Moscow,780,3,9,6,5,36,29,7,33
Krasnodar,780,4,9,4,7,31,27,4,31
Zenit,780,5,7,8,5,21,15,6,29
Terek Grozny,780,6,7,5,8,21,26,-5,26
Din Moscow,780,7,5,8,7,18,22,-4,23
FK Rubin,780,8,5,6,9,23,21,2,21
Rostov,780,9,5,6,9,13,18,-5,21
Amkar,780,10,5,4,11,12,24,-12,19
Anzhi,780,11,3,6,11,17,39,-22,15
Loko Moscow,781,1,12,6,2,31,11,20,42
CSKA Moscow,781,2,12,3,5,28,18,10,39
Spart Moscow,781,3,10,6,4,38,26,12,36
Krasnodar,781,4,9,5,6,28,24,4,32
Zenit,781,5,7,8,5,22,17,5,29
Terek Grozny,781,6,7,6,7,23,27,-4,27
Din Moscow,781,7,5,8,7,17,21,-4,23
FK Rubin,781,8,5,6,9,21,18,3,21
Amkar,781,9,5,4,11,11,24,-13,19
Rostov,781,10,4,6,10,11,20,-9,18
Anzhi,781,11,2,6,12,17,41,-24,12
Loko Moscow,782,1,11,6,3,31,15,16,39
CSKA Moscow,782,2,11,4,5,29,20,9,37
Zenit,782,3,8,9,3,26,16,10,33
Spart Moscow,782,4,9,6,5,36,28,8,33
Krasnodar,782,5,9,5,6,30,26,4,32
Terek Grozny,782,6,7,5,8,22,28,-6,26
Din Moscow,782,7,6,7,7,19,22,-3,25
Amkar,782,8,6,4,10,14,24,-10,22
FK Rubin,782,9,5,5,10,22,20,2,20
Rostov,782,10,4,6,10,10,19,-9,18
Anzhi,782,11,3,5,12,18,39,-21,14
Loko Moscow,783,1,12,6,2,31,12,19,42
Zenit,783,2,8,9,3,25,15,10,33
CSKA Moscow,783,3,10,3,7,26,21,5,33
Spart Moscow,783,4,8,8,4,36,28,8,32
Krasnodar,783,5,9,4,7,28,25,3,31
Terek Grozny,783,6,8,5,7,21,24,-3,29
Din Moscow,783,7,6,7,7,18,21,-3,25
FK Rubin,783,8,5,5,10,21,19,2,20
Amkar,783,9,5,5,10,13,24,-11,20
Rostov,783,10,4,7,9,11,18,-7,19
Anzhi,783,11,3,5,12,15,38,-23,14
Loko Moscow,784,1,13,5,2,34,12,22,44
CSKA Moscow,784,2,11,4,5,27,18,9,37
Spart Moscow,784,3,9,7,4,36,26,10,34
Zenit,784,4,7,9,4,22,16,6,30
Krasnodar,784,5,8,5,7,28,27,1,29
Terek Grozny,784,6,7,6,7,21,26,-5,27
FK Rubin,784,7,6,6,8,22,17,5,24
Din Moscow,784,8,5,6,9,17,24,-7,21
Amkar,784,9,5,5,10,12,22,-10,20
Rostov,784,10,4,7,9,11,18,-7,19
Anzhi,784,11,2,6,12,15,39,-24,12
Loko Moscow,785,1,13,5,2,34,12,22,44
CSKA Moscow,785,2,10,4,6,26,19,7,34
Spart Moscow,785,3,8,7,5,37,30,7,31
Krasnodar,785,4,9,4,7,30,28,2,31
Zenit,785,5,7,9,4,22,16,6,30
Terek Grozny,785,6,7,6,7,21,25,-4,27
Din Moscow,785,7,6,7,7,20,23,-3,25
FK Rubin,785,8,5,5,10,23,21,2,20
Amkar,785,9,5,5,10,12,24,-12,20
Rostov,785,10,4,7,9,11,18,-7,19
Anzhi,785,11,4,5,11,18,38,-20,17
Loko Moscow,786,1,13,5,2,32,11,21,44
CSKA Moscow,786,2,12,3,5,28,18,10,39
Spart Moscow,786,3,10,5,5,39,29,10,35
Zenit,786,4,7,8,5,22,17,5,29
Krasnodar,786,5,8,4,8,29,30,-1,28
Terek Grozny,786,6,7,6,7,20,23,-3,27
FK Rubin,786,7,7,5,8,27,19,8,26
Rostov,786,8,5,6,9,13,19,-6,21
Din Moscow,786,9,5,6,9,17,24,-7,21
Amkar,786,10,4,5,11,10,24,-14,17
Anzhi,786,11,3,5,12,15,38,-23,14
Loko Moscow,787,1,11,7,2,29,11,18,40
Spart Moscow,787,2,10,5,5,49,33,16,35
CSKA Moscow,787,3,10,4,6,27,21,6,34
Zenit,787,4,8,9,3,24,14,10,33
Krasnodar,787,5,8,6,6,27,24,3,30
Terek Grozny,787,6,8,5,7,22,24,-2,29
FK Rubin,787,7,6,6,8,23,18,5,24
Din Moscow,787,8,5,6,9,19,30,-11,21
Amkar,787,9,5,4,11,14,28,-14,19
Rostov,787,10,4,6,10,12,22,-10,18
Anzhi,787,11,3,6,11,17,38,-21,15
Loko Moscow,788,1,13,5,2,34,11,23,44
CSKA Moscow,788,2,11,4,5,26,17,9,37
Spart Moscow,788,3,10,6,4,37,27,10,36
Krasnodar,788,4,9,4,7,29,28,1,31
Zenit,788,5,7,9,4,21,15,6,30
Terek Grozny,788,6,8,6,6,23,24,-1,30
Din Moscow,788,7,6,7,7,22,23,-1,25
FK Rubin,788,8,5,5,10,22,22,0,20
Rostov,788,9,4,6,10,10,18,-8,18
Amkar,788,10,4,5,11,10,24,-14,17
Anzhi,788,11,2,5,13,15,40,-25,11
Loko Moscow,789,1,11,5,4,30,16,14,38
Zenit,789,2,9,8,3,27,13,14,35
Krasnodar,789,3,10,4,6,30,25,5,34
CSKA Moscow,789,4,10,4,6,26,21,5,34
Spart Moscow,789,5,8,7,5,39,33,6,31
Terek Grozny,789,6,8,6,6,23,23,0,30
FK Rubin,789,7,6,5,9,22,18,4,23
Din Moscow,789,8,5,7,8,21,26,-5,22
Amkar,789,9,5,5,10,11,22,-11,20
Rostov,789,10,4,7,9,12,19,-7,19
Anzhi,789,11,2,6,12,16,41,-25,12
Loko Moscow,790,1,12,5,3,31,14,17,41
Spart Moscow,790,2,10,6,4,39,26,13,36
Krasnodar,790,3,10,4,6,32,24,8,34
CSKA Moscow,790,4,10,4,6,28,21,7,34
Zenit,790,5,7,9,4,23,17,6,30
Terek Grozny,790,6,8,5,7,21,24,-3,29
Din Moscow,790,7,6,6,8,19,25,-6,24
FK Rubin,790,8,5,5,10,21,21,0,20
Rostov,790,9,4,7,9,11,18,-7,19
Amkar,790,10,5,4,11,11,23,-12,19
Anzhi,790,11,3,5,12,16,39,-23,14
Loko Moscow,791,1,12,6,2,33,14,19,42
CSKA Moscow,791,2,11,4,5,28,17,11,37
Spart Moscow,791,3,10,5,5,40,27,13,35
Krasnodar,791,4,9,5,6,31,26,5,32
Terek Grozny,791,5,9,5,6,24,23,1,32
Zenit,791,6,7,8,5,22,18,4,29
Din Moscow,791,7,6,6,8,22,27,-5,24
FK Rubin,791,8,5,5,10,25,24,1,20
Amkar,791,9,5,4,11,11,25,-14,19
Rostov,791,10,4,6,10,10,21,-11,18
Anzhi,791,11,2,6,12,15,39,-24,12
Loko Moscow,792,1,11,5,4,29,14,15,38
CSKA Moscow,792,2,11,3,6,28,19,9,36
Krasnodar,792,3,10,4,6,30,24,6,34
Spart Moscow,792,4,9,6,5,38,35,3,33
Zenit,792,5,8,8,4,23,15,8,32
Terek Grozny,792,6,8,6,6,22,23,-1,30
Din Moscow,792,7,5,8,7,20,24,-4,23
FK Rubin,792,8,5,6,9,21,19,2,21
Amkar,792,9,5,4,11,15,23,-8,19
Rostov,792,10,4,6,10,11,19,-8,18
Anzhi,792,11,3,6,11,17,39,-22,15
Loko Moscow,793,1,12,6,2,32,13,19,42
CSKA Moscow,793,2,12,3,5,29,18,11,39
Spart Moscow,793,3,10,5,5,39,27,12,35
Zenit,793,4,7,9,4,21,15,6,30
Terek Grozny,793,5,8,6,6,23,24,-1,30
Krasnodar,793,6,8,5,7,29,27,2,29
FK Rubin,793,7,5,7,8,22,18,4,22
Din Moscow,793,8,5,7,8,18,25,-7,22
Rostov,793,9,5,6,9,11,17,-6,21
Amkar,793,10,4,5,11,11,26,-15,17
Anzhi,793,11,2,5,13,16,41,-25,11
Loko Moscow,794,1,13,5,2,33,11,22,44
CSKA Moscow,794,2,11,3,6,27,19,8,36
Spart Moscow,794,3,9,6,5,36,29,7,33
Krasnodar,794,4,9,4,7,30,25,5,31
Zenit,794,5,7,8,5,22,18,4,29
Din Moscow,794,6,7,6,7,21,22,-1,27
Terek Grozny,794,7,7,5,8,20,28,-8,26
FK Rubin,794,8,5,5,10,22,22,0,20
Rostov,794,9,4,7,9,12,19,-7,19
Amkar,794,10,5,4,11,10,23,-13,19
Anzhi,794,11,4,5,11,20,37,-17,17
Loko Moscow,795,1,12,5,3,31,12,19,41
CSKA Moscow,795,2,11,4,5,29,18,11,37
Spart Moscow,795,3,10,6,4,40,28,12,36
Krasnodar,795,4,9,5,6,29,25,4,32
Zenit,795,5,7,9,4,22,16,6,30
Terek Grozny,795,6,8,6,6,23,24,-1,30
FK Rubin,795,7,6,6,8,24,18,6,24
Din Moscow,795,8,5,6,9,19,26,-7,21
Rostov,795,9,4,7,9,11,18,-7,19
Amkar,795,10,4,4,12,10,27,-17,16
Anzhi,795,11,2,6,12,15,41,-26,12
Loko Moscow,796,1,11,6,3,30,14,16,39
Spart Moscow,796,2,11,5,4,39,28,11,38
CSKA Moscow,796,3,10,4,6,25,18,7,34
Zenit,796,4,8,9,3,23,13,10,33
Krasnodar,796,5,9,5,6,30,25,5,32
Terek Grozny,796,6,8,6,6,22,23,-1,30
Din Moscow,796,7,5,7,8,19,24,-5,22
FK Rubin,796,8,5,6,9,22,20,2,21
Rostov,796,9,4,6,10,11,19,-8,18
Amkar,796,10,4,5,11,10,24,-14,17
Anzhi,796,11,3,5,12,16,39,-23,14
Loko Moscow,797,1,12,5,3,32,15,17,41
CSKA Moscow,797,2,11,3,6,28,20,8,36
Krasnodar,797,3,10,4,6,33,25,8,34
Zenit,797,4,8,8,4,25,15,10,32
Spart Moscow,797,5,9,5,6,36,30,6,32
Terek Grozny,797,6,8,5,7,22,25,-3,29
Din Moscow,797,7,7,6,7,21,22,-1,27
Rostov,797,8,5,6,9,12,17,-5,21
FK Rubin,797,9,5,5,10,21,21,0,20
Amkar,797,10,5,4,11,11,24,-13,19
Anzhi,797,11,2,5,13,15,42,-27,11
Loko Moscow,798,1,12,5,3,32,15,17,41
Krasnodar,798,2,10,4,6,34,25,9,34
CSKA Moscow,798,3,10,4,6,28,21,7,34
Spart Moscow,798,4,9,6,5,35,27,8,33
Zenit,798,5,8,8,4,24,16,8,32
Terek Grozny,798,6,8,6,6,22,23,-1,30
FK Rubin,798,7,6,5,9,22,21,1,23
Din Moscow,798,8,5,6,9,17,23,-6,21
Rostov,798,9,5,6,9,11,17,-6,21
Amkar,798,10,4,5,11,10,24,-14,17
Anzhi,798,11,2,7,11,17,40,-23,13
Loko Moscow,799,1,12,6,2,34,13,21,42
Spart Moscow,799,2,10,6,4,37,26,11,36
CSKA Moscow,799,3,11,3,6,29,20,9,36
Zenit,799,4,8,9,3,25,15,10,33
Krasnodar,799,5,9,4,7,30,29,1,31
Terek Grozny,799,6,8,5,7,23,23,0,29
Din Moscow,799,7,6,7,7,19,22,-3,25
FK Rubin,799,8,5,5,10,22,20,2,20
Amkar,799,9,5,4,11,10,24,-14,19
Rostov,799,10,4,6,10,10,18,-8,18
Anzhi,799,11,2,5,13,14,43,-29,11
Loko Moscow,800,1,13,5,2,32,11,21,44
CSKA Moscow,800,2,12,3,5,31,18,13,39
Spart Moscow,800,3,10,6,4,37,26,11,36
Zenit,800,4,7,8,5,22,17,5,29
Krasnodar,800,5,8,5,7,29,27,2,29
Terek Grozny,800,6,7,6,7,23,26,-3,27
Din Moscow,800,7,6,6,8,19,22,-3,24
FK Rubin,800,8,5,6,9,23,21,2,21
Amkar,800,9,5,5,10,11,23,-12,20
Rostov,800,10,4,6,10,11,20,-9,18
Anzhi,800,11,2,6,12,16,43,-27,12
Loko Moscow,801,1,13,5,2,31,11,20,44
CSKA Moscow,801,2,10,3,7,26,20,6,33
Spart Moscow,801,3,9,5,6,36,28,8,32
Zenit,801,4,8,8,4,23,15,8,32
Krasnodar,801,5,9,4,7,31,27,4,31
Terek Grozny,801,6,8,6,6,23,24,-1,30
Din Moscow,801,7,6,6,8,19,23,-4,24
FK Rubin,801,8,6,5,9,24,21,3,23
Rostov,801,9,5,6,9,11,17,-6,21
Amkar,801,10,4,5,11,11,26,-15,17
Anzhi,801,11,3,5,12,15,38,-23,14
Loko Moscow,802,1,12,6,2,32,12,20,42
Zenit,802,2,8,9,3,24,14,10,33
CSKA Moscow,802,3,10,3,7,27,23,4,33
Spart Moscow,802,4,8,6,6,34,28,6,30
Terek Grozny,802,5,8,6,6,23,24,-1,30
Krasnodar,802,6,8,5,7,28,27,1,29
Din Moscow,802,7,6,7,7,18,21,-3,25
FK Rubin,802,8,5,7,8,22,18,4,22
Amkar,802,9,5,5,10,12,24,-12,20
Rostov,802,10,4,7,9,11,18,-7,19
Anzhi,802,11,3,5,12,18,40,-22,14
Loko Moscow,803,1,13,5,2,34,12,22,44
CSKA Moscow,803,2,11,3,6,30,22,8,36
Zenit,803,3,8,8,4,26,16,10,32
Spart Moscow,803,4,9,5,6,35,32,3,32
Krasnodar,803,5,8,5,7,28,26,2,29
Terek Grozny,803,6,7,7,6,20,22,-2,28
Din Moscow,803,7,7,6,7,20,21,-1,27
FK Rubin,803,8,5,6,9,21,18,3,21
Amkar,803,9,5,5,10,14,23,-9,20
Rostov,803,10,4,6,10,10,18,-8,18
Anzhi,803,11,2,6,12,14,42,-28,12
Loko Moscow,804,1,13,5,2,32,12,20,44
CSKA Moscow,804,2,12,3,5,30,18,12,39
Spart Moscow,804,3,10,5,5,36,28,8,35
Krasnodar,804,4,9,4,7,30,26,4,31
Terek Grozny,804,5,8,6,6,22,22,0,30
Zenit,804,6,7,8,5,21,16,5,29
FK Rubin,804,7,6,5,9,23,20,3,23
Din Moscow,804,8,5,6,9,18,24,-6,21
Amkar,804,9,5,5,10,12,23,-11,20
Rostov,804,10,4,6,10,10,18,-8,18
Anzhi,804,11,2,5,13,15,42,-27,11
Loko Moscow,805,1,12,6,2,31,12,19,42
CSKA Moscow,805,2,11,3,6,29,19,10,36
Spart Moscow,805,3,10,5,5,39,30,9,35
Zenit,805,4,8,8,4,22,14,8,32
Krasnodar,805,5,8,6,6,30,27,3,30
Terek Grozny,805,6,7,6,7,21,25,-4,27
FK Rubin,805,7,5,7,8,25,21,4,22
Din Moscow,805,8,5,7,8,21,28,-7,22
Amkar,805,9,6,4,10,14,22,-8,22
Rostov,805,10,4,6,10,10,18,-8,18
Anzhi,805,11,2,6,12,16,42,-26,12
Loko Moscow,806,1,12,6,2,32,13,19,42
Spart Moscow,806,2,10,6,4,36,25,11,36
CSKA Moscow,806,3,10,3,7,26,21,5,33
Zenit,806,4,8,8,4,22,14,8,32
Krasnodar,806,5,8,5,7,29,28,1,29
Terek Grozny,806,6,7,7,6,21,23,-2,28
Din Moscow,806,7,6,6,8,19,24,-5,24
FK Rubin,806,8,6,5,9,24,19,5,23
Rostov,806,9,4,6,10,10,18,-8,18
Amkar,806,10,4,6,10,10,23,-13,18
Anzhi,806,11,3,6,11,17,38,-21,15
Loko Moscow,807,1,13,5,2,36,14,22,44
CSKA Moscow,807,2,11,4,5,28,19,9,37
Spart Moscow,807,3,10,6,4,39,27,12,36
Zenit,807,4,7,8,5,22,17,5,29
Krasnodar,807,5,8,5,7,30,29,1,29
Terek Grozny,807,6,7,6,7,22,25,-3,27
Din Moscow,807,7,6,7,7,20,23,-3,25
FK Rubin,807,8,5,6,9,23,20,3,21
Rostov,807,9,4,6,10,10,19,-9,18
Amkar,807,10,4,5,11,10,25,-15,17
Anzhi,807,11,3,6,11,19,41,-22,15
Loko Moscow,808,1,11,5,4,30,15,15,38
CSKA Moscow,808,2,11,3,6,27,20,7,36
Krasnodar,808,3,10,4,6,31,26,5,34
Zenit,808,4,8,8,4,23,14,9,32
Spart Moscow,808,5,9,5,6,36,34,2,32
Terek Grozny,808,6,8,6,6,23,23,0,30
Din Moscow,808,7,6,6,8,23,23,0,24
FK Rubin,808,8,6,5,9,23,19,4,23
Rostov,808,9,5,6,9,12,17,-5,21
Amkar,808,10,4,5,11,11,25,-14,17
Anzhi,808,11,3,5,12,17,40,-23,14
Loko Moscow,809,1,11,6,3,30,13,17,39
CSKA Moscow,809,2,11,4,5,28,19,9,37
Spart Moscow,809,3,10,6,4,40,28,12,36
Zenit,809,4,8,9,3,23,14,9,33
Terek Grozny,809,5,8,6,6,22,23,-1,30
Krasnodar,809,6,8,5,7,29,29,0,29
FK Rubin,809,7,6,6,8,25,18,7,24
Din Moscow,809,8,5,7,8,17,24,-7,22
Rostov,809,9,4,6,10,10,18,-8,18
Amkar,809,10,4,6,10,12,25,-13,18
Anzhi,809,11,2,5,13,16,41,-25,11
Loko Moscow,810,1,11,6,3,32,15,17,39
Spart Moscow,810,2,10,6,4,39,28,11,36
CSKA Moscow,810,3,11,3,6,28,20,8,36
Zenit,810,4,8,9,3,24,15,9,33
Krasnodar,810,5,9,4,7,30,27,3,31
Terek Grozny,810,6,7,6,7,25,29,-4,27
FK Rubin,810,7,6,6,8,25,20,5,24
Din Moscow,810,8,5,8,7,21,25,-4,23
Amkar,810,9,5,4,11,14,26,-12,19
Rostov,810,10,4,6,10,10,19,-9,18
Anzhi,810,11,2,6,12,19,43,-24,12
Loko Moscow,811,1,11,5,4,30,14,16,38
CSKA Moscow,811,2,11,3,6,28,19,9,36
Zenit,811,3,9,8,3,25,15,10,35
Spart Moscow,811,4,9,7,4,38,29,9,34
Krasnodar,811,5,9,4,7,28,25,3,31
Terek Grozny,811,6,8,5,7,23,24,-1,29
FK Rubin,811,7,6,6,8,23,18,5,24
Din Moscow,811,8,5,7,8,20,25,-5,22
Amkar,811,9,5,5,10,12,23,-11,20
Rostov,811,10,4,7,9,11,18,-7,19
Anzhi,811,11,2,5,13,14,42,-28,11
CSKA Moscow,812,1,12,3,5,30,18,12,39
Loko Moscow,812,2,11,5,4,29,13,16,38
Spart Moscow,812,3,9,7,4,35,25,10,34
Krasnodar,812,4,10,4,6,30,25,5,34
Zenit,812,5,8,8,4,23,15,8,32
Terek Grozny,812,6,7,6,7,23,26,-3,27
FK Rubin,812,7,6,5,9,25,20,5,23
Din Moscow,812,8,5,7,8,18,24,-6,22
Amkar,812,9,5,5,10,11,23,-12,20
Rostov,812,10,4,6,10,10,19,-9,18
Anzhi,812,11,2,6,12,16,42,-26,12
Loko Moscow,813,1,12,5,3,34,15,19,41
Zenit,813,2,9,8,3,26,16,10,35
CSKA Moscow,813,3,10,4,6,28,21,7,34
Spart Moscow,813,4,9,6,5,37,30,7,33
Krasnodar,813,5,8,5,7,28,27,1,29
Terek Grozny,813,6,7,5,8,21,26,-5,26
FK Rubin,813,7,6,6,8,22,17,5,24
Din Moscow,813,8,6,6,8,20,22,-2,24
Amkar,813,9,5,5,10,12,23,-11,20
Rostov,813,10,4,6,10,11,20,-9,18
Anzhi,813,11,3,6,11,18,40,-22,15
Loko Moscow,814,1,11,6,3,30,13,17,39
Zenit,814,2,9,8,3,24,14,10,35
CSKA Moscow,814,3,10,4,6,27,20,7,34
Spart Moscow,814,4,9,6,5,38,31,7,33
Krasnodar,814,5,8,5,7,28,26,2,29
FK Rubin,814,6,7,5,8,24,18,6,26
Terek Grozny,814,7,7,5,8,20,25,-5,26
Amkar,814,8,6,4,10,12,22,-10,22
Din Moscow,814,9,5,6,9,19,25,-6,21
Rostov,814,10,4,7,9,13,20,-7,19
Anzhi,814,11,3,6,11,17,38,-21,15
Loko Moscow,815,1,12,5,3,30,13,17,41
Krasnodar,815,2,10,4,6,33,26,7,34
CSKA Moscow,815,3,10,3,7,26,20,6,33
Zenit,815,4,8,8,4,23,15,8,32
Spart Moscow,815,5,8,6,6,36,30,6,30
Terek Grozny,815,6,8,5,7,22,24,-2,29
Din Moscow,815,7,5,8,7,20,24,-4,23
FK Rubin,815,8,5,6,9,23,21,2,21
Rostov,815,9,5,6,9,11,17,-6,21
Amkar,815,10,5,4,11,11,24,-13,19
Anzhi,815,11,4,5,11,16,37,-21,17
Loko Moscow,816,1,12,5,3,32,14,18,41
Spart Moscow,816,2,10,5,5,39,29,10,35
Zenit,816,3,9,8,3,25,15,10,35
CSKA Moscow,816,4,10,3,7,26,21,5,33
Krasnodar,816,5,9,4,7,30,26,4,31
Terek Grozny,816,6,7,5,8,20,24,-4,26
FK Rubin,816,7,6,5,9,22,19,3,23
Amkar,816,8,6,4,10,13,22,-9,22
Din Moscow,816,9,5,6,9,17,26,-9,21
Rostov,816,10,4,6,10,11,19,-8,18
Anzhi,816,11,4,5,11,17,37,-20,17
Loko Moscow,817,1,12,5,3,31,13,18,41
CSKA Moscow,817,2,11,3,6,28,19,9,36
Spart Moscow,817,3,10,5,5,39,29,10,35
Krasnodar,817,4,9,5,6,29,25,4,32
Terek Grozny,817,5,8,6,6,22,22,0,30
Zenit,817,6,7,8,5,22,17,5,29
FK Rubin,817,7,5,7,8,22,18,4,22
Din Moscow,817,8,5,7,8,18,24,-6,22
Rostov,817,9,5,6,9,13,18,-5,21
Amkar,817,10,4,5,11,9,24,-15,17
Anzhi,817,11,3,5,12,16,40,-24,14
Loko Moscow,818,1,12,6,2,32,12,20,42
CSKA Moscow,818,2,11,4,5,29,19,10,37
Spart Moscow,818,3,10,5,5,37,27,10,35
Krasnodar,818,4,8,6,6,29,26,3,30
Zenit,818,5,7,8,5,23,19,4,29
Terek Grozny,818,6,8,5,7,21,23,-2,29
Din Moscow,818,7,7,6,7,23,24,-1,27
FK Rubin,818,8,5,6,9,25,23,2,21
Rostov,818,9,4,6,10,10,18,-8,18
Amkar,818,10,4,4,12,9,25,-16,16
Anzhi,818,11,3,6,11,16,38,-22,15
Loko Moscow,819,1,11,6,3,31,14,17,39
CSKA Moscow,819,2,11,4,5,29,19,10,37
Spart Moscow,819,3,10,5,5,37,27,10,35
Krasnodar,819,4,9,5,6,29,25,4,32
Zenit,819,5,7,10,3,23,15,8,31
Terek Grozny,819,6,7,7,6,21,23,-2,28
Din Moscow,819,7,6,6,8,18,22,-4,24
FK Rubin,819,8,5,6,9,21,18,3,21
Amkar,819,9,5,5,10,11,23,-12,20
Rostov,819,10,4,6,10,10,19,-9,18
Anzhi,819,11,2,6,12,16,41,-25,12
Loko Moscow,820,1,13,5,2,37,15,22,44
CSKA Moscow,820,2,12,3,5,29,19,10,39
Spart Moscow,820,3,9,7,4,40,29,11,34
Krasnodar,820,4,9,4,7,31,29,2,31
Zenit,820,5,7,8,5,22,17,5,29
Terek Grozny,820,6,8,5,7,23,27,-4,29
FK Rubin,820,7,6,5,9,23,18,5,23
Din Moscow,820,8,5,6,9,17,26,-9,21
Amkar,820,9,5,5,10,16,25,-9,20
Rostov,820,10,4,7,9,12,19,-7,19
Anzhi,820,11,2,5,13,16,42,-26,11
Loko Moscow,821,1,11,6,3,30,14,16,39
CSKA Moscow,821,2,11,3,6,27,19,8,36
Zenit,821,3,8,9,3,24,14,10,33
Spart Moscow,821,4,9,6,5,36,27,9,33
Krasnodar,821,5,9,5,6,29,24,5,32
Terek Grozny,821,6,8,6,6,22,23,-1,30
Din Moscow,821,7,6,6,8,18,23,-5,24
FK Rubin,821,8,5,6,9,21,18,3,21
Rostov,821,9,4,7,9,11,18,-7,19
Amkar,821,10,5,4,11,10,23,-13,19
Anzhi,821,11,2,6,12,15,40,-25,12
Loko Moscow,822,1,11,7,2,31,13,18,40
CSKA Moscow,822,2,11,4,5,28,18,10,37
Spart Moscow,822,3,9,6,5,37,30,7,33
Zenit,822,4,7,10,3,22,14,8,31
Krasnodar,822,5,8,5,7,30,29,1,29
Terek Grozny,822,6,7,6,7,21,24,-3,27
Din Moscow,822,7,6,6,8,19,23,-4,24
FK Rubin,822,8,6,5,9,25,20,5,23
Amkar,822,9,5,5,10,13,24,-11,20
Rostov,822,10,4,7,9,11,18,-7,19
Anzhi,822,11,3,5,12,16,40,-24,14
Loko Moscow,823,1,12,6,2,34,14,20,42
CSKA Moscow,823,2,11,3,6,30,19,11,36
Spart Moscow,823,3,9,6,5,35,28,7,33
Zenit,823,4,8,8,4,24,17,7,32
Krasnodar,823,5,8,5,7,29,27,2,29
Terek Grozny,823,6,7,6,7,21,25,-4,27
FK Rubin,823,7,6,6,8,22,17,5,24
Din Moscow,823,8,5,8,7,18,22,-4,23
Rostov,823,9,5,6,9,12,17,-5,21
Amkar,823,10,5,4,11,11,23,-12,19
Anzhi,823,11,2,6,12,15,42,-27,12
Loko Moscow,824,1,11,6,3,30,13,17,39
Spart Moscow,824,2,11,5,4,42,28,14,38
CSKA Moscow,824,3,11,4,5,28,17,11,37
Krasnodar,824,4,10,4,6,31,26,5,34
Zenit,824,5,7,10,3,21,13,8,31
Terek Grozny,824,6,8,5,7,22,24,-2,29
Din Moscow,824,7,5,7,8,19,25,-6,22
FK Rubin,824,8,5,6,9,24,21,3,21
Amkar,824,9,5,4,11,12,24,-12,19
Rostov,824,10,4,6,10,12,22,-10,18
Anzhi,824,11,2,5,13,14,42,-28,11
Loko Moscow,825,1,11,7,2,31,13,18,40
CSKA Moscow,825,2,11,3,6,31,22,9,36
Spart Moscow,825,3,9,7,4,38,28,10,34
Zenit,825,4,8,9,3,26,16,10,33
Krasnodar,825,5,8,6,6,29,26,3,30
Terek Grozny,825,6,8,5,7,24,26,-2,29
FK Rubin,825,7,5,7,8,23,19,4,22
Din Moscow,825,8,5,7,8,17,23,-6,22
Rostov,825,9,4,7,9,11,18,-7,19
Amkar,825,10,4,5,11,12,27,-15,17
Anzhi,825,11,3,5,12,19,43,-24,14
Loko Moscow,826,1,12,6,2,31,11,20,42
CSKA Moscow,826,2,11,3,6,27,19,8,36
Spart Moscow,826,3,10,5,5,36,28,8,35
Zenit,826,4,8,9,3,23,14,9,33
Krasnodar,826,5,9,4,7,28,26,2,31
Terek Grozny,826,6,7,6,7,21,25,-4,27
FK Rubin,826,7,6,5,9,22,18,4,23
Rostov,826,8,5,6,9,12,17,-5,21
Din Moscow,826,9,5,6,9,18,24,-6,21
Amkar,826,10,4,5,11,10,24,-14,17
Anzhi,826,11,3,5,12,16,38,-22,14
Loko Moscow,827,1,12,5,3,31,13,18,41
CSKA Moscow,827,2,11,4,5,26,17,9,37
Spart Moscow,827,3,10,5,5,41,28,13,35
Zenit,827,4,8,9,3,23,14,9,33
Krasnodar,827,5,8,5,7,29,27,2,29
Terek Grozny,827,6,8,5,7,22,25,-3,29
Din Moscow,827,7,6,6,8,19,27,-8,24
FK Rubin,827,8,5,6,9,23,21,2,21
Amkar,827,9,5,4,11,13,25,-12,19
Rostov,827,10,4,6,10,10,18,-8,18
Anzhi,827,11,3,5,12,16,38,-22,14
Loko Moscow,828,1,11,5,4,30,14,16,38
Spart Moscow,828,2,10,6,4,39,26,13,36
Zenit,828,3,9,8,3,24,14,10,35
CSKA Moscow,828,4,10,3,7,27,22,5,33
Krasnodar,828,5,9,5,6,30,26,4,32
Terek Grozny,828,6,7,6,7,22,25,-3,27
Din Moscow,828,7,6,6,8,20,23,-3,24
FK Rubin,828,8,5,6,9,22,21,1,21
Rostov,828,9,4,7,9,11,18,-7,19
Amkar,828,10,5,4,11,11,26,-15,19
Anzhi,828,11,3,6,11,18,39,-21,15
Loko Moscow,829,1,11,7,2,29,11,18,40
CSKA Moscow,829,2,12,3,5,28,18,10,39
Spart Moscow,829,3,9,6,5,38,30,8,33
Zenit,829,4,7,9,4,22,15,7,30
Krasnodar,829,5,8,6,6,27,24,3,30
Terek Grozny,829,6,7,6,7,22,25,-3,27
FK Rubin,829,7,5,7,8,21,17,4,22
Din Moscow,829,8,5,7,8,19,25,-6,22
Amkar,829,9,6,4,10,13,23,-10,22
Rostov,829,10,4,7,9,10,17,-7,19
Anzhi,829,11,2,6,12,16,40,-24,12
Loko Moscow,830,1,12,5,3,32,14,18,41
Spart Moscow,830,2,11,5,4,40,27,13,38
CSKA Moscow,830,3,11,3,6,28,20,8,36
Krasnodar,830,4,9,5,6,33,29,4,32
Zenit,830,5,7,8,5,21,15,6,29
Terek Grozny,830,6,7,6,7,21,24,-3,27
Din Moscow,830,7,6,6,8,18,23,-5,24
FK Rubin,830,8,5,6,9,24,21,3,21
Amkar,830,9,5,4,11,11,25,-14,19
Rostov,830,10,4,6,10,12,20,-8,18
Anzhi,830,11,3,6,11,17,39,-22,15
Loko Moscow,831,1,12,6,2,31,12,19,42
CSKA Moscow,831,2,11,4,5,27,18,9,37
Spart Moscow,831,3,9,7,4,37,28,9,34
Krasnodar,831,4,9,4,7,29,26,3,31
Zenit,831,5,7,9,4,21,14,7,30
Terek Grozny,831,6,8,6,6,25,22,3,30
Din Moscow,831,7,5,7,8,17,22,-5,22
FK Rubin,831,8,5,6,9,21,18,3,21
Rostov,831,9,4,7,9,11,18,-7,19
Amkar,831,10,4,6,10,11,24,-13,18
Anzhi,831,11,2,6,12,15,43,-28,12
Loko Moscow,832,1,11,6,3,32,15,17,39
CSKA Moscow,832,2,12,3,5,28,18,10,39
Spart Moscow,832,3,11,5,4,41,27,14,38
Krasnodar,832,4,10,4,6,33,26,7,34
Zenit,832,5,7,9,4,22,15,7,30
Terek Grozny,832,6,7,5,8,21,28,-7,26
Din Moscow,832,7,5,7,8,19,26,-7,22
FK Rubin,832,8,5,6,9,23,22,1,21
Amkar,832,9,5,4,11,12,24,-12,19
Rostov,832,10,4,6,10,12,20,-8,18
Anzhi,832,11,3,5,12,18,40,-22,14
Loko Moscow,833,1,11,6,3,32,16,16,39
Spart Moscow,833,2,10,5,5,43,29,14,35
CSKA Moscow,833,3,10,5,5,28,20,8,35
Zenit,833,4,7,10,3,24,16,8,31
Krasnodar,833,5,9,4,7,31,28,3,31
Terek Grozny,833,6,8,5,7,22,24,-2,29
FK Rubin,833,7,7,5,8,25,18,7,26
Din Moscow,833,8,5,6,9,17,26,-9,21
Amkar,833,9,5,4,11,12,25,-13,19
Rostov,833,10,4,6,10,11,22,-11,18
Anzhi,833,11,3,6,11,18,39,-21,15
Loko Moscow,834,1,13,5,2,34,14,20,44
Spart Moscow,834,2,10,6,4,38,27,11,36
CSKA Moscow,834,3,10,4,6,26,19,7,34
Zenit,834,4,8,8,4,23,15,8,32
Krasnodar,834,5,8,5,7,31,29,2,29
Terek Grozny,834,6,8,5,7,22,24,-2,29
FK Rubin,834,7,6,6,8,25,20,5,24
Din Moscow,834,8,5,7,8,19,24,-5,22
Rostov,834,9,4,6,10,10,19,-9,18
Amkar,834,10,4,4,12,11,26,-15,16
Anzhi,834,11,3,6,11,16,38,-22,15
Loko Moscow,835,1,12,6,2,32,13,19,42
CSKA Moscow,835,2,12,3,5,32,21,11,39
Spart Moscow,835,3,9,6,5,38,30,8,33
Krasnodar,835,4,9,5,6,30,26,4,32
Zenit,835,5,7,8,5,23,17,6,29
Terek Grozny,835,6,8,5,7,22,23,-1,29
Din Moscow,835,7,6,6,8,19,24,-5,24
FK Rubin,835,8,5,5,10,21,19,2,20
Rostov,835,9,4,7,9,11,18,-7,19
Amkar,835,10,5,4,11,12,25,-13,19
Anzhi,835,11,3,5,12,17,41,-24,14
Loko Moscow,836,1,13,5,2,34,11,23,44
Spart Moscow,836,2,11,5,4,42,27,15,38
CSKA Moscow,836,3,10,4,6,27,21,6,34
Zenit,836,4,8,8,4,24,17,7,32
Krasnodar,836,5,9,4,7,29,26,3,31
Terek Grozny,836,6,8,5,7,21,24,-3,29
FK Rubin,836,7,6,5,9,22,19,3,23
Din Moscow,836,8,5,6,9,18,26,-8,21
Rostov,836,9,4,6,10,11,20,-9,18
Amkar,836,10,4,4,12,9,25,-16,16
Anzhi,836,11,3,6,11,17,38,-21,15
Loko Moscow,837,1,11,7,2,33,15,18,40
CSKA Moscow,837,2,10,4,6,26,19,7,34
Spart Moscow,837,3,9,5,6,39,33,6,32
Zenit,837,4,7,10,3,22,14,8,31
Krasnodar,837,5,8,5,7,31,29,2,29
Terek Grozny,837,6,7,5,8,21,25,-4,26
Din Moscow,837,7,6,7,7,23,24,-1,25
FK Rubin,837,8,6,6,8,24,19,5,24
Amkar,837,9,6,4,10,12,23,-11,22
Rostov,837,10,4,6,10,11,20,-9,18
Anzhi,837,11,4,5,11,18,39,-21,17
Loko Moscow,838,1,12,5,3,35,19,16,41
CSKA Moscow,838,2,11,4,5,28,19,9,37
Krasnodar,838,3,10,4,6,34,26,8,34
Spart Moscow,838,4,9,5,6,39,29,10,32
Zenit,838,5,7,9,4,25,18,7,30
Terek Grozny,838,6,7,6,7,21,24,-3,27
FK Rubin,838,7,6,5,9,22,19,3,23
Rostov,838,8,5,6,9,11,17,-6,21
Din Moscow,838,9,5,6,9,17,26,-9,21
Amkar,838,10,5,5,10,13,25,-12,20
Anzhi,838,11,3,5,12,16,39,-23,14
Loko Moscow,839,1,13,5,2,34,13,21,44
Spart Moscow,839,2,10,6,4,38,28,10,36
CSKA Moscow,839,3,11,3,6,27,19,8,36
Zenit,839,4,8,8,4,24,17,7,32
Krasnodar,839,5,8,4,8,29,28,1,28
FK Rubin,839,6,7,5,8,25,18,7,26
Terek Grozny,839,7,7,5,8,21,25,-4,26
Din Moscow,839,8,5,6,9,19,26,-7,21
Rostov,839,9,4,7,9,11,18,-7,19
Amkar,839,10,5,4,11,10,23,-13,19
Anzhi,839,11,3,5,12,16,39,-23,14
Loko Moscow,840,1,11,6,3,29,15,14,39
Spart Moscow,840,2,11,5,4,39,27,12,38
CSKA Moscow,840,3,10,4,6,26,19,7,34
Zenit,840,4,8,9,3,23,14,9,33
Terek Grozny,840,5,9,5,6,23,22,1,32
Krasnodar,840,6,9,4,7,31,25,6,31
Din Moscow,840,7,6,6,8,20,24,-4,24
FK Rubin,840,8,6,5,9,22,18,4,23
Rostov,840,9,4,6,10,10,19,-9,18
Amkar,840,10,4,4,12,9,24,-15,16
Anzhi,840,11,2,6,12,14,39,-25,12
Loko Moscow,841,1,11,5,4,31,19,12,38
CSKA Moscow,841,2,11,3,6,27,20,7,36
Zenit,841,3,9,8,3,25,14,11,35
Krasnodar,841,4,10,4,6,35,25,10,34
Spart Moscow,841,5,9,6,5,39,30,9,33
Terek Grozny,841,6,7,7,6,22,24,-2,28
Din Moscow,841,7,5,7,8,18,24,-6,22
FK Rubin,841,8,5,6,9,21,19,2,21
Rostov,841,9,5,6,9,13,19,-6,21
Amkar,841,10,4,6,10,11,24,-13,18
Anzhi,841,11,2,6,12,16,40,-24,12
Loko Moscow,842,1,11,7,2,31,13,18,40
CSKA Moscow,842,2,10,5,5,28,20,8,35
Spart Moscow,842,3,9,7,4,36,27,9,34
Krasnodar,842,4,9,5,6,31,25,6,32
Zenit,842,5,7,10,3,23,15,8,31
Terek Grozny,842,6,8,6,6,22,23,-1,30
Din Moscow,842,7,6,7,7,20,22,-2,25
FK Rubin,842,8,5,5,10,21,22,-1,20
Rostov,842,9,4,7,9,10,17,-7,19
Amkar,842,10,4,4,12,10,25,-15,16
Anzhi,842,11,2,7,11,17,40,-23,13
Loko Moscow,843,1,13,5,2,33,11,22,44
Spart Moscow,843,2,11,5,4,38,25,13,38
CSKA Moscow,843,3,11,4,5,30,19,11,37
Krasnodar,843,4,9,4,7,28,25,3,31
Zenit,843,5,7,9,4,22,17,5,30
Terek Grozny,843,6,7,5,8,21,26,-5,26
Din Moscow,843,7,6,6,8,18,22,-4,24
FK Rubin,843,8,5,5,10,21,19,2,20
Amkar,843,9,5,4,11,10,24,-14,19
Rostov,843,10,4,6,10,10,19,-9,18
Anzhi,843,11,3,5,12,18,42,-24,14
CSKA Moscow,844,1,12,3,5,29,18,11,39
Loko Moscow,844,2,11,5,4,31,15,16,38
Spart Moscow,844,3,9,6,5,34,27,7,33
Zenit,844,4,8,8,4,23,16,7,32
Krasnodar,844,5,9,5,6,31,27,4,32
Terek Grozny,844,6,8,6,6,22,23,-1,30
FK Rubin,844,7,6,6,8,25,19,6,24
Din Moscow,844,8,5,6,9,18,25,-7,21
Rostov,844,9,4,7,9,10,17,-7,19
Amkar,844,10,5,4,11,11,23,-12,19
Anzhi,844,11,2,6,12,15,39,-24,12
Loko Moscow,845,1,12,6,2,33,14,19,42
CSKA Moscow,845,2,11,4,5,27,18,9,37
Spart Moscow,845,3,9,5,6,35,30,5,32
Terek Grozny,845,4,9,5,6,24,22,2,32
Zenit,845,5,7,10,3,23,15,8,31
Krasnodar,845,6,8,4,8,30,29,1,28
Din Moscow,845,7,7,6,7,21,21,0,27
FK Rubin,845,8,6,5,9,23,19,4,23
Rostov,845,9,5,6,9,12,18,-6,21
Amkar,845,10,4,4,12,9,24,-15,16
Anzhi,845,11,2,5,13,14,41,-27,11
Loko Moscow,846,1,11,6,3,30,13,17,39
CSKA Moscow,846,2,10,4,6,26,19,7,34
Zenit,846,3,8,9,3,22,13,9,33
Spart Moscow,846,4,8,6,6,35,31,4,30
Krasnodar,846,5,8,5,7,28,28,0,29
Terek Grozny,846,6,8,5,7,23,26,-3,29
FK Rubin,846,7,7,5,8,25,17,8,26
Din Moscow,846,8,5,7,8,17,22,-5,22
Amkar,846,9,6,4,10,15,23,-8,22
Rostov,846,10,5,6,9,13,19,-6,21
Anzhi,846,11,3,5,12,17,40,-23,14
Loko Moscow,847,1,11,6,3,29,13,16,39
Spart Moscow,847,2,10,5,5,38,27,11,35
Krasnodar,847,3,10,4,6,31,25,6,34
Zenit,847,4,8,9,3,24,14,10,33
CSKA Moscow,847,5,10,3,7,28,23,5,33
Terek Grozny,847,6,8,6,6,21,22,-1,30
Din Moscow,847,7,6,6,8,19,24,-5,24
FK Rubin,847,8,5,5,10,23,21,2,20
Amkar,847,9,5,5,10,11,23,-12,20
Rostov,847,10,4,6,10,10,19,-9,18
Anzhi,847,11,3,5,12,17,40,-23,14
Loko Moscow,848,1,11,6,3,31,14,17,39
CSKA Moscow,848,2,12,3,5,31,18,13,39
Krasnodar,848,3,10,4,6,31,26,5,34
Spart Moscow,848,4,9,6,5,35,28,7,33
Zenit,848,5,7,9,4,22,16,6,30
Terek Grozny,848,6,8,6,6,22,23,-1,30
Din Moscow,848,7,6,6,8,19,23,-4,24
FK Rubin,848,8,6,5,9,24,19,5,23
Rostov,848,9,4,7,9,11,18,-7,19
Amkar,848,10,4,5,11,10,24,-14,17
Anzhi,848,11,2,5,13,15,42,-27,11
Loko Moscow,849,1,12,6,2,30,11,19,42
Spart Moscow,849,2,10,6,4,41,27,14,36
CSKA Moscow,849,3,11,3,6,28,21,7,36
Zenit,849,4,8,9,3,25,13,12,33
Krasnodar,849,5,9,4,7,28,25,3,31
Terek Grozny,849,6,8,5,7,23,24,-1,29
Din Moscow,849,7,6,6,8,20,24,-4,24
FK Rubin,849,8,5,5,10,21,20,1,20
Amkar,849,9,5,5,10,12,23,-11,20
Rostov,849,10,4,6,10,10,21,-11,18
Anzhi,849,11,2,5,13,14,43,-29,11
Loko Moscow,850,1,12,6,2,32,13,19,42
CSKA Moscow,850,2,12,3,5,29,19,10,39
Spart Moscow,850,3,9,7,4,39,29,10,34
Krasnodar,850,4,9,5,6,31,24,7,32
Terek Grozny,850,5,8,6,6,24,24,0,30
Zenit,850,6,7,8,5,24,18,6,29
Din Moscow,850,7,6,6,8,21,26,-5,24
FK Rubin,850,8,5,5,10,23,24,-1,20
Rostov,850,9,4,7,9,12,19,-7,19
Amkar,850,10,4,6,10,11,24,-13,18
Anzhi,850,11,2,5,13,16,42,-26,11
Loko Moscow,851,1,11,5,4,30,15,15,38
CSKA Moscow,851,2,11,4,5,31,21,10,37
Krasnodar,851,3,10,4,6,30,24,6,34
Zenit,851,4,8,9,3,25,16,9,33
Spart Moscow,851,5,9,6,5,37,29,8,33
Terek Grozny,851,6,7,5,8,21,26,-5,26
Din Moscow,851,7,6,6,8,18,23,-5,24
Rostov,851,8,5,6,9,12,17,-5,21
FK Rubin,851,9,5,5,10,21,19,2,20
Amkar,851,10,5,5,10,13,24,-11,20
Anzhi,851,11,3,5,12,18,42,-24,14
Loko Moscow,852,1,11,6,3,30,14,16,39
CSKA Moscow,852,2,11,3,6,26,18,8,36
Krasnodar,852,3,10,4,6,30,24,6,34
Spart Moscow,852,4,9,6,5,37,29,8,33
Zenit,852,5,7,9,4,22,15,7,30
Terek Grozny,852,6,7,5,8,21,26,-5,26
Din Moscow,852,7,5,8,7,18,22,-4,23
Amkar,852,8,6,4,10,13,22,-9,22
FK Rubin,852,9,5,6,9,22,19,3,21
Rostov,852,10,4,6,10,12,21,-9,18
Anzhi,852,11,4,5,11,17,38,-21,17
Loko Moscow,853,1,12,5,3,30,12,18,41
Zenit,853,2,9,8,3,24,13,11,35
Spart Moscow,853,3,9,7,4,38,28,10,34
CSKA Moscow,853,4,10,4,6,27,21,6,34
Krasnodar,853,5,9,4,7,28,25,3,31
Terek Grozny,853,6,8,6,6,22,23,-1,30
Din Moscow,853,7,5,7,8,18,24,-6,22
FK Rubin,853,8,5,6,9,21,18,3,21
Rostov,853,9,4,7,9,11,18,-7,19
Amkar,853,10,4,6,10,11,24,-13,18
Anzhi,853,11,2,6,12,16,40,-24,12
Loko Moscow,854,1,12,5,3,31,14,17,41
CSKA Moscow,854,2,11,4,5,28,18,10,37
Spart Moscow,854,3,10,5,5,39,30,9,35
Zenit,854,4,8,9,3,25,15,10,33
Krasnodar,854,5,9,4,7,28,25,3,31
Terek Grozny,854,6,8,5,7,23,25,-2,29
Din Moscow,854,7,5,7,8,19,25,-6,22
FK Rubin,854,8,5,6,9,22,19,3,21
Rostov,854,9,5,6,9,14,18,-4,21
Amkar,854,10,5,4,11,11,25,-14,19
Anzhi,854,11,2,5,13,15,41,-26,11
Loko Moscow,855,1,12,6,2,33,13,20,42
Spart Moscow,855,2,11,5,4,39,26,13,38
CSKA Moscow,855,3,11,4,5,27,17,10,37
Zenit,855,4,7,10,3,22,14,8,31
Krasnodar,855,5,9,4,7,29,27,2,31
Terek Grozny,855,6,7,7,6,20,22,-2,28
FK Rubin,855,7,6,5,9,23,19,4,23
Din Moscow,855,8,5,6,9,18,25,-7,21
Rostov,855,9,4,6,10,11,20,-9,18
Amkar,855,10,4,5,11,9,23,-14,17
Anzhi,855,11,2,6,12,14,39,-25,12
Loko Moscow,856,1,11,7,2,30,12,18,40
CSKA Moscow,856,2,11,3,6,29,20,9,36
Spart Moscow,856,3,10,5,5,38,29,9,35
Zenit,856,4,8,9,3,25,14,11,33
Krasnodar,856,5,8,6,6,28,25,3,30
Terek Grozny,856,6,7,6,7,21,24,-3,27
Din Moscow,856,7,6,6,8,20,23,-3,24
FK Rubin,856,8,5,6,9,22,20,2,21
Rostov,856,9,5,6,9,11,17,-6,21
Amkar,856,10,5,4,11,12,25,-13,19
Anzhi,856,11,2,6,12,15,42,-27,12
Loko Moscow,857,1,12,6,2,33,12,21,42
Spart Moscow,857,2,10,6,4,39,28,11,36
CSKA Moscow,857,3,11,3,6,28,22,6,36
Zenit,857,4,8,9,3,27,15,12,33
Terek Grozny,857,5,9,5,6,25,24,1,32
Krasnodar,857,6,9,4,7,29,27,2,31
Din Moscow,857,7,6,7,7,20,23,-3,25
FK Rubin,857,8,5,5,10,22,21,1,20
Rostov,857,9,4,6,10,12,21,-9,18
Amkar,857,10,4,4,12,9,24,-15,16
Anzhi,857,11,2,5,13,16,43,-27,11
Loko Moscow,858,1,12,6,2,33,13,20,42
CSKA Moscow,858,2,11,3,6,30,20,10,36
Spart Moscow,858,3,10,5,5,38,27,11,35
Zenit,858,4,8,9,3,24,15,9,33
Krasnodar,858,5,8,5,7,29,28,1,29
Terek Grozny,858,6,7,6,7,20,26,-6,27
FK Rubin,858,7,6,6,8,23,18,5,24
Din Moscow,858,8,5,6,9,17,25,-8,21
Amkar,858,9,5,5,10,11,23,-12,20
Rostov,858,10,4,6,10,10,18,-8,18
Anzhi,858,11,3,5,12,19,41,-22,14
Loko Moscow,859,1,11,5,4,29,15,14,38
CSKA Moscow,859,2,11,3,6,27,19,8,36
Spart Moscow,859,3,10,5,5,45,32,13,35
Zenit,859,4,9,8,3,25,13,12,35
Krasnodar,859,5,9,5,6,29,24,5,32
Terek Grozny,859,6,7,7,6,22,24,-2,28
Din Moscow,859,7,6,6,8,22,28,-6,24
FK Rubin,859,8,5,6,9,21,19,2,21
Rostov,859,9,5,6,9,13,18,-5,21
Amkar,859,10,4,5,11,11,27,-16,17
Anzhi,859,11,2,6,12,15,40,-25,12
Loko Moscow,860,1,13,5,2,33,11,22,44
Spart Moscow,860,2,11,5,4,37,25,12,38
CSKA Moscow,860,3,11,3,6,28,22,6,36
Zenit,860,4,8,8,4,25,15,10,32
Krasnodar,860,5,9,4,7,28,26,2,31
Terek Grozny,860,6,7,5,8,20,25,-5,26
FK Rubin,860,7,6,5,9,23,19,4,23
Din Moscow,860,8,5,6,9,18,24,-6,21
Amkar,860,9,5,4,11,11,23,-12,19
Rostov,860,10,4,6,10,10,19,-9,18
Anzhi,860,11,3,5,12,16,40,-24,14
Loko Moscow,861,1,12,5,3,30,13,17,41
CSKA Moscow,861,2,11,4,5,27,18,9,37
Spart Moscow,861,3,10,5,5,39,28,11,35
Zenit,861,4,8,8,4,23,14,9,32
Krasnodar,861,5,8,5,7,29,27,2,29
Terek Grozny,861,6,7,5,8,20,25,-5,26
FK Rubin,861,7,5,7,8,23,19,4,22
Din Moscow,861,8,5,7,8,17,24,-7,22
Amkar,861,9,6,4,10,13,23,-10,22
Rostov,861,10,4,6,10,11,19,-8,18
Anzhi,861,11,3,6,11,16,38,-22,15
Loko Moscow,862,1,12,5,3,33,13,20,41
CSKA Moscow,862,2,11,4,5,28,19,9,37
Spart Moscow,862,3,9,6,5,37,28,9,33
Krasnodar,862,4,9,4,7,29,26,3,31
Zenit,862,5,7,8,5,21,17,4,29
Terek Grozny,862,6,7,6,7,22,25,-3,27
FK Rubin,862,7,6,6,8,22,17,5,24
Din Moscow,862,8,5,7,8,17,23,-6,22
Rostov,862,9,5,6,9,11,17,-6,21
Amkar,862,10,4,6,10,13,26,-13,18
Anzhi,862,11,3,6,11,17,39,-22,15
Loko Moscow,863,1,12,5,3,32,15,17,41
CSKA Moscow,863,2,12,3,5,28,17,11,39
Krasnodar,863,3,10,4,6,32,26,6,34
Spart Moscow,863,4,8,8,4,34,26,8,32
Terek Grozny,863,5,9,5,6,25,24,1,32
Zenit,863,6,7,8,5,22,16,6,29
Din Moscow,863,7,6,7,7,19,22,-3,25
FK Rubin,863,8,5,5,10,22,20,2,20
Rostov,863,9,4,7,9,10,17,-7,19
Amkar,863,10,4,5,11,11,25,-14,17
Anzhi,863,11,2,5,13,14,41,-27,11
Loko Moscow,864,1,12,5,3,33,15,18,41
CSKA Moscow,864,2,11,4,5,28,19,9,37
Zenit,864,3,8,9,3,23,14,9,33
Spart Moscow,864,4,9,6,5,35,31,4,33
Terek Grozny,864,5,8,5,7,22,24,-2,29
Krasnodar,864,6,8,4,8,29,29,0,28
FK Rubin,864,7,7,5,8,27,18,9,26
Amkar,864,8,6,4,10,16,23,-7,22
Din Moscow,864,9,5,6,9,18,26,-8,21
Rostov,864,10,4,7,9,11,18,-7,19
Anzhi,864,11,2,5,13,16,41,-25,11
Loko Moscow,865,1,11,7,2,31,13,18,40
CSKA Moscow,865,2,11,4,5,29,17,12,37
Spart Moscow,865,3,9,7,4,39,28,11,34
Zenit,865,4,7,10,3,22,14,8,31
Krasnodar,865,5,8,5,7,28,27,1,29
Terek Grozny,865,6,7,6,7,20,26,-6,27
Din Moscow,865,7,6,6,8,21,25,-4,24
FK Rubin,865,8,6,5,9,23,20,3,23
Rostov,865,9,4,7,9,11,18,-7,19
Amkar,865,10,4,6,10,10,23,-13,18
Anzhi,865,11,3,5,12,18,41,-23,14
Loko Moscow,866,1,11,7,2,30,12,18,40
CSKA Moscow,866,2,11,3,6,31,19,12,36
Spart Moscow,866,3,10,6,4,38,28,10,36
Zenit,866,4,8,9,3,24,15,9,33
Krasnodar,866,5,9,5,6,29,24,5,32
Terek Grozny,866,6,8,5,7,22,25,-3,29
Din Moscow,866,7,5,7,8,17,22,-5,22
FK Rubin,866,8,5,6,9,21,19,2,21
Rostov,866,9,4,6,10,13,21,-8,18
Amkar,866,10,4,5,11,10,24,-14,17
Anzhi,866,11,3,5,12,16,42,-26,14
Loko Moscow,867,1,12,5,3,31,12,19,41
CSKA Moscow,867,2,11,3,6,28,21,7,36
Krasnodar,867,3,10,4,6,30,24,6,34
Terek Grozny,867,4,9,5,6,23,22,1,32
Spart Moscow,867,5,8,7,5,35,28,7,31
Zenit,867,6,7,8,5,23,18,5,29
Din Moscow,867,7,5,8,7,17,21,-4,23
FK Rubin,867,8,5,6,9,21,19,2,21
Rostov,867,9,4,7,9,11,18,-7,19
Amkar,867,10,5,4,11,11,25,-14,19
Anzhi,867,11,3,5,12,16,38,-22,14
Loko Moscow,868,1,11,5,4,30,14,16,38
CSKA Moscow,868,2,11,4,5,27,18,9,37
Spart Moscow,868,3,9,7,4,36,27,9,34
Zenit,868,4,8,9,3,22,13,9,33
Krasnodar,868,5,9,4,7,29,26,3,31
Terek Grozny,868,6,7,6,7,21,24,-3,27
FK Rubin,868,7,6,6,8,23,18,5,24
Din Moscow,868,8,5,8,7,19,23,-4,23
Amkar,868,9,5,5,10,10,22,-12,20
Rostov,868,10,4,6,10,11,19,-8,18
Anzhi,868,11,2,6,12,16,40,-24,12
Loko Moscow,869,1,11,7,2,32,14,18,40
CSKA Moscow,869,2,11,3,6,29,19,10,36
Zenit,869,3,8,9,3,23,13,10,33
Spart Moscow,869,4,9,6,5,37,28,9,33
Krasnodar,869,5,9,5,6,32,28,4,32
Terek Grozny,869,6,7,6,7,21,25,-4,27
Din Moscow,869,7,6,7,7,21,24,-3,25
FK Rubin,869,8,5,5,10,24,22,2,20
Amkar,869,9,5,5,10,11,23,-12,20
Rostov,869,10,4,6,10,10,19,-9,18
Anzhi,869,11,3,5,12,17,42,-25,14
Loko Moscow,870,1,13,5,2,33,12,21,44
CSKA Moscow,870,2,11,4,5,30,20,10,37
Spart Moscow,870,3,9,5,6,36,30,6,32
Krasnodar,870,4,9,4,7,31,28,3,31
Zenit,870,5,7,9,4,21,14,7,30
Terek Grozny,870,6,8,6,6,22,23,-1,30
Din Moscow,870,7,6,7,7,19,22,-3,25
FK Rubin,870,8,5,6,9,23,21,2,21
Rostov,870,9,5,6,9,13,18,-5,21
Amkar,870,10,4,5,11,10,24,-14,17
Anzhi,870,11,2,5,13,18,44,-26,11
Loko Moscow,871,1,11,6,3,30,13,17,39
CSKA Moscow,871,2,11,4,5,29,19,10,37
Krasnodar,871,3,10,4,6,31,26,5,34
Spart Moscow,871,4,8,8,4,37,29,8,32
Zenit,871,5,7,10,3,23,15,8,31
Terek Grozny,871,6,8,5,7,21,23,-2,29
Din Moscow,871,7,5,8,7,19,23,-4,23
FK Rubin,871,8,5,6,9,22,19,3,21
Rostov,871,9,4,7,9,11,18,-7,19
Amkar,871,10,4,5,11,10,24,-14,17
Anzhi,871,11,3,5,12,15,39,-24,14
Loko Moscow,872,1,11,7,2,33,15,18,40
CSKA Moscow,872,2,11,4,5,30,18,12,37
Spart Moscow,872,3,10,5,5,38,28,10,35
Krasnodar,872,4,9,5,6,34,29,5,32
Zenit,872,5,7,10,3,23,15,8,31
Terek Grozny,872,6,8,5,7,22,25,-3,29
FK Rubin,872,7,6,5,9,24,21,3,23
Rostov,872,8,5,6,9,12,17,-5,21
Din Moscow,872,9,5,6,9,17,25,-8,21
Amkar,872,10,4,4,12,10,25,-15,16
Anzhi,872,11,3,5,12,17,42,-25,14
Loko Moscow,873,1,12,5,3,33,15,18,41
Krasnodar,873,2,10,4,6,33,25,8,34
CSKA Moscow,873,3,10,4,6,27,20,7,34
Spart Moscow,873,4,8,7,5,37,30,7,31
Zenit,873,5,7,9,4,23,17,6,30
Terek Grozny,873,6,8,5,7,22,25,-3,29
FK Rubin,873,7,6,5,9,22,20,2,23
Din Moscow,873,8,5,7,8,20,25,-5,22
Rostov,873,9,5,6,9,11,17,-6,21
Amkar,873,10,5,5,10,13,24,-11,20
Anzhi,873,11,3,5,12,16,39,-23,14
Loko Moscow,874,1,11,6,3,31,14,17,39
CSKA Moscow,874,2,11,3,6,29,20,9,36
Spart Moscow,874,3,9,6,5,38,28,10,33
Zenit,874,4,8,9,3,24,15,9,33
Krasnodar,874,5,9,4,7,30,27,3,31
Terek Grozny,874,6,7,6,7,24,27,-3,27
FK Rubin,874,7,7,5,8,25,18,7,26
Din Moscow,874,8,6,6,8,18,23,-5,24
Amkar,874,9,5,5,10,14,26,-12,20
Rostov,874,10,4,6,10,10,20,-10,18
Anzhi,874,11,2,6,12,17,42,-25,12
Loko Moscow,875,1,12,6,2,32,13,19,42
CSKA Moscow,875,2,11,4,5,28,19,9,37
Spart Moscow,875,3,9,6,5,35,28,7,33
Zenit,875,4,7,10,3,24,16,8,31
Krasnodar,875,5,9,4,7,29,26,3,31
Terek Grozny,875,6,7,6,7,23,26,-3,27
FK Rubin,875,7,6,5,9,24,19,5,23
Din Moscow,875,8,5,6,9,18,25,-7,21
Amkar,875,9,5,5,10,13,24,-11,20
Rostov,875,10,4,7,9,10,17,-7,19
Anzhi,875,11,3,5,12,17,40,-23,14
Loko Moscow,876,1,11,5,4,31,16,15,38
Spart Moscow,876,2,11,5,4,41,27,14,38
CSKA Moscow,876,3,11,3,6,27,19,8,36
Zenit,876,4,9,8,3,24,13,11,35
Terek Grozny,876,5,9,5,6,22,22,0,32
Krasnodar,876,6,9,4,7,31,27,4,31
Din Moscow,876,7,6,6,8,20,24,-4,24
FK Rubin,876,8,6,5,9,23,19,4,23
Rostov,876,9,4,6,10,10,18,-8,18
Amkar,876,10,4,4,12,10,28,-18,16
Anzhi,876,11,2,5,13,14,40,-26,11
Loko Moscow,877,1,11,5,4,31,15,16,38
CSKA Moscow,877,2,11,3,6,28,21,7,36
Zenit,877,3,9,8,3,26,14,12,35
Spart Moscow,877,4,9,7,4,37,28,9,34
Krasnodar,877,5,9,5,6,30,26,4,32
Terek Grozny,877,6,8,5,7,23,26,-3,29
FK Rubin,877,7,6,6,8,25,19,6,24
Din Moscow,877,8,5,7,8,20,26,-6,22
Amkar,877,9,5,5,10,12,23,-11,20
Rostov,877,10,4,6,10,11,19,-8,18
Anzhi,877,11,2,5,13,16,42,-26,11
Loko Moscow,878,1,12,5,3,32,15,17,41
CSKA Moscow,878,2,11,4,5,29,18,11,37
Krasnodar,878,3,10,4,6,35,25,10,34
Spart Moscow,878,4,9,6,5,37,30,7,33
Terek Grozny,878,5,9,5,6,23,22,1,32
Zenit,878,6,7,8,5,22,19,3,29
Din Moscow,878,7,6,6,8,19,23,-4,24
Rostov,878,8,5,6,9,14,19,-5,21
FK Rubin,878,9,5,5,10,21,22,-1,20
Amkar,878,10,4,5,11,9,24,-15,17
Anzhi,878,11,2,6,12,14,38,-24,12
Loko Moscow,879,1,12,5,3,30,13,17,41
Spart Moscow,879,2,10,5,5,39,29,10,35
CSKA Moscow,879,3,10,5,5,30,22,8,35
Krasnodar,879,4,9,5,6,29,24,5,32
Terek Grozny,879,5,9,5,6,22,22,0,32
Zenit,879,6,7,9,4,23,16,7,30
FK Rubin,879,7,5,7,8,21,17,4,22
Din Moscow,879,8,5,7,8,18,23,-5,22
Amkar,879,9,5,4,11,11,24,-13,19
Rostov,879,10,4,6,10,11,20,-9,18
Anzhi,879,11,2,6,12,17,41,-24,12
Loko Moscow,880,1,12,5,3,32,13,19,41
Spart Moscow,880,2,10,6,4,40,26,14,36
CSKA Moscow,880,3,11,3,6,26,19,7,36
Zenit,880,4,8,8,4,23,15,8,32
Krasnodar,880,5,9,5,6,30,26,4,32
Terek Grozny,880,6,7,6,7,20,23,-3,27
Din Moscow,880,7,6,6,8,18,26,-8,24
FK Rubin,880,8,5,6,9,22,19,3,21
Rostov,880,9,4,7,9,11,18,-7,19
Amkar,880,10,4,5,11,9,23,-14,17
Anzhi,880,11,3,5,12,15,38,-23,14
Loko Moscow,881,1,12,6,2,32,13,19,42
CSKA Moscow,881,2,12,3,5,29,17,12,39
Spart Moscow,881,3,9,6,5,40,28,12,33
Krasnodar,881,4,9,5,6,30,26,4,32
Zenit,881,5,7,8,5,22,16,6,29
Terek Grozny,881,6,7,7,6,22,24,-2,28
FK Rubin,881,7,6,5,9,24,19,5,23
Din Moscow,881,8,5,7,8,18,24,-6,22
Amkar,881,9,5,5,10,13,25,-12,20
Rostov,881,10,4,6,10,10,22,-12,18
Anzhi,881,11,2,6,12,14,40,-26,12
Loko Moscow,882,1,11,5,4,31,15,16,38
CSKA Moscow,882,2,11,3,6,32,25,7,36
Zenit,882,3,9,8,3,29,15,14,35
Spart Moscow,882,4,10,5,5,36,27,9,35
Krasnodar,882,5,9,5,6,30,26,4,32
Terek Grozny,882,6,8,5,7,24,25,-1,29
Din Moscow,882,7,7,6,7,19,21,-2,27
FK Rubin,882,8,5,6,9,22,19,3,21
Amkar,882,9,5,4,11,11,23,-12,19
Rostov,882,10,4,6,10,11,19,-8,18
Anzhi,882,11,2,5,13,17,47,-30,11
Loko Moscow,883,1,13,5,2,34,12,22,44
CSKA Moscow,883,2,10,4,6,28,21,7,34
Spart Moscow,883,3,9,5,6,37,29,8,32
Zenit,883,4,8,8,4,24,16,8,32
Krasnodar,883,5,9,4,7,28,27,1,31
Terek Grozny,883,6,8,6,6,22,23,-1,30
Din Moscow,883,7,7,6,7,21,23,-2,27
Rostov,883,8,5,6,9,11,17,-6,21
FK Rubin,883,9,5,5,10,21,19,2,20
Amkar,883,10,4,5,11,10,25,-15,17
Anzhi,883,11,2,6,12,16,40,-24,12
Loko Moscow,884,1,12,5,3,31,13,18,41
Spart Moscow,884,2,10,6,4,39,26,13,36
Krasnodar,884,3,10,4,6,31,24,7,34
CSKA Moscow,884,4,10,4,6,26,19,7,34
Zenit,884,5,8,8,4,22,15,7,32
Terek Grozny,884,6,7,7,6,21,23,-2,28
Din Moscow,884,7,5,7,8,19,27,-8,22
FK Rubin,884,8,5,6,9,23,21,2,21
Rostov,884,9,4,6,10,10,18,-8,18
Amkar,884,10,4,6,10,10,23,-13,18
Anzhi,884,11,2,7,11,16,39,-23,13
Loko Moscow,885,1,13,5,2,33,12,21,44
CSKA Moscow,885,2,12,3,5,29,18,11,39
Spart Moscow,885,3,11,5,4,40,27,13,38
Zenit,885,4,7,8,5,21,16,5,29
Krasnodar,885,5,8,5,7,29,27,2,29
Terek Grozny,885,6,8,5,7,23,25,-2,29
Din Moscow,885,7,6,6,8,20,23,-3,24
FK Rubin,885,8,5,6,9,22,20,2,21
Rostov,885,9,4,6,10,10,18,-8,18
Amkar,885,10,4,4,12,10,28,-18,16
Anzhi,885,11,3,5,12,18,41,-23,14
Loko Moscow,886,1,13,5,2,34,13,21,44
Spart Moscow,886,2,9,7,4,35,26,9,34
CSKA Moscow,886,3,10,3,7,25,19,6,33
Zenit,886,4,8,8,4,22,15,7,32
Krasnodar,886,5,9,4,7,31,27,4,31
Terek Grozny,886,6,7,6,7,23,26,-3,27
Din Moscow,886,7,5,7,8,18,23,-5,22
FK Rubin,886,8,5,6,9,21,19,2,21
Rostov,886,9,4,7,9,10,17,-7,19
Amkar,886,10,4,6,10,11,24,-13,18
Anzhi,886,11,4,5,11,17,38,-21,17
Loko Moscow,887,1,12,5,3,32,14,18,41
Spart Moscow,887,2,10,6,4,36,25,11,36
Krasnodar,887,3,10,4,6,32,26,6,34
CSKA Moscow,887,4,10,4,6,26,20,6,34
Zenit,887,5,8,8,4,23,14,9,32
Terek Grozny,887,6,8,5,7,25,24,1,29
Din Moscow,887,7,6,6,8,19,23,-4,24
FK Rubin,887,8,5,5,10,21,21,0,20
Amkar,887,9,5,5,10,10,22,-12,20
Rostov,887,10,4,6,10,10,18,-8,18
Anzhi,887,11,2,6,12,16,43,-27,12
Loko Moscow,888,1,11,6,3,30,13,17,39
Spart Moscow,888,2,10,6,4,41,28,13,36
CSKA Moscow,888,3,10,4,6,25,19,6,34
Krasnodar,888,4,10,4,6,30,25,5,34
Zenit,888,5,7,10,3,22,14,8,31
Terek Grozny,888,6,8,6,6,22,23,-1,30
Din Moscow,888,7,6,6,8,18,23,-5,24
FK Rubin,888,8,5,5,10,22,20,2,20
Rostov,888,9,4,7,9,11,18,-7,19
Amkar,888,10,4,5,11,11,27,-16,17
Anzhi,888,11,3,5,12,17,39,-22,14
Loko Moscow,889,1,12,6,2,33,14,19,42
CSKA Moscow,889,2,12,3,5,31,19,12,39
Terek Grozny,889,3,9,5,6,22,22,0,32
Spart Moscow,889,4,8,6,6,35,31,4,30
Krasnodar,889,5,8,6,6,30,27,3,30
Zenit,889,6,7,8,5,25,20,5,29
Din Moscow,889,7,5,8,7,19,23,-4,23
FK Rubin,889,8,5,7,8,23,19,4,22
Rostov,889,9,5,6,9,11,17,-6,21
Amkar,889,10,5,4,11,12,23,-11,19
Anzhi,889,11,2,5,13,14,40,-26,11
Loko Moscow,890,1,12,6,2,31,12,19,42
CSKA Moscow,890,2,11,4,5,27,18,9,37
Spart Moscow,890,3,8,7,5,37,30,7,31
Zenit,890,4,7,8,5,21,15,6,29
Krasnodar,890,5,8,5,7,29,27,2,29
Terek Grozny,890,6,7,7,6,23,25,-2,28
Din Moscow,890,7,6,7,7,20,23,-3,25
FK Rubin,890,8,6,5,9,24,20,4,23
Amkar,890,9,5,5,10,11,23,-12,20
Rostov,890,10,4,7,9,12,19,-7,19
Anzhi,890,11,2,7,11,18,41,-23,13
Loko Moscow,891,1,13,5,2,32,11,21,44
CSKA Moscow,891,2,11,4,5,29,17,12,37
Spart Moscow,891,3,10,5,5,39,27,12,35
Terek Grozny,891,4,9,5,6,24,23,1,32
Zenit,891,5,7,9,4,21,15,6,30
Krasnodar,891,6,8,5,7,27,25,2,29
FK Rubin,891,7,6,6,8,22,17,5,24
Din Moscow,891,8,5,6,9,17,23,-6,21
Rostov,891,9,5,6,9,12,18,-6,21
Amkar,891,10,4,4,12,9,27,-18,16
Anzhi,891,11,2,5,13,15,44,-29,11
Loko Moscow,892,1,12,6,2,32,12,20,42
Spart Moscow,892,2,10,6,4,42,28,14,36
CSKA Moscow,892,3,10,4,6,27,20,7,34
Zenit,892,4,7,9,4,22,16,6,30
Krasnodar,892,5,8,6,6,30,27,3,30
Terek Grozny,892,6,7,5,8,22,27,-5,26
Din Moscow,892,7,6,6,8,19,25,-6,24
FK Rubin,892,8,5,6,9,23,20,3,21
Amkar,892,9,5,5,10,14,25,-11,20
Rostov,892,10,4,6,10,10,20,-10,18
Anzhi,892,11,4,5,11,18,39,-21,17
Loko Moscow,893,1,12,5,3,31,13,18,41
Spart Moscow,893,2,10,5,5,40,27,13,35
Zenit,893,3,9,8,3,24,14,10,35
CSKA Moscow,893,4,10,4,6,27,20,7,34
Krasnodar,893,5,9,4,7,33,26,7,31
Terek Grozny,893,6,7,7,6,21,23,-2,28
Din Moscow,893,7,6,6,8,18,25,-7,24
Rostov,893,8,5,6,9,11,17,-6,21
FK Rubin,893,9,5,5,10,21,23,-2,20
Amkar,893,10,4,5,11,10,25,-15,17
Anzhi,893,11,2,7,11,16,39,-23,13
Loko Moscow,894,1,12,5,3,33,14,19,41
CSKA Moscow,894,2,12,3,5,30,19,11,39
Spart Moscow,894,3,10,5,5,38,29,9,35
Zenit,894,4,8,8,4,23,15,8,32
Krasnodar,894,5,9,4,7,31,29,2,31
Terek Grozny,894,6,8,5,7,22,24,-2,29
Din Moscow,894,7,6,6,8,20,24,-4,24
FK Rubin,894,8,6,5,9,25,20,5,23
Rostov,894,9,4,6,10,12,20,-8,18
Amkar,894,10,4,4,12,9,25,-16,16
Anzhi,894,11,3,5,12,17,41,-24,14
CSKA Moscow,895,1,12,3,5,29,18,11,39
Loko Moscow,895,2,11,5,4,29,14,15,38
Zenit,895,3,8,8,4,23,15,8,32
Spart Moscow,895,4,9,5,6,37,31,6,32
Krasnodar,895,5,9,5,6,30,25,5,32
Terek Grozny,895,6,8,5,7,23,25,-2,29
FK Rubin,895,7,6,6,8,24,19,5,24
Din Moscow,895,8,6,6,8,21,24,-3,24
Amkar,895,9,6,4,10,12,22,-10,22
Rostov,895,10,4,6,10,11,20,-9,18
Anzhi,895,11,2,5,13,16,42,-26,11
Loko Moscow,896,1,13,5,2,37,12,25,44
CSKA Moscow,896,2,11,3,6,27,19,8,36
Spart Moscow,896,3,10,5,5,40,28,12,35
Zenit,896,4,8,8,4,22,18,4,32
Terek Grozny,896,5,8,5,7,21,23,-2,29
Krasnodar,896,6,8,4,8,28,28,0,28
FK Rubin,896,7,6,6,8,22,17,5,24
Din Moscow,896,8,5,7,8,18,25,-7,22
Amkar,896,9,5,4,11,10,23,-13,19
Rostov,896,10,4,6,10,11,20,-9,18
Anzhi,896,11,3,5,12,16,39,-23,14
Loko Moscow,897,1,13,5,2,31,11,20,44
Spart Moscow,897,2,11,5,4,46,27,19,38
CSKA Moscow,897,3,11,3,6,28,21,7,36
Zenit,897,4,8,8,4,23,14,9,32
Krasnodar,897,5,8,5,7,28,26,2,29
Terek Grozny,897,6,7,5,8,21,26,-5,26
FK Rubin,897,7,6,6,8,23,18,5,24
Din Moscow,897,8,5,6,9,18,26,-8,21
Amkar,897,9,5,4,11,12,27,-15,19
Rostov,897,10,4,6,10,11,22,-11,18
Anzhi,897,11,3,5,12,17,40,-23,14
Loko Moscow,898,1,12,6,2,31,12,19,42
CSKA Moscow,898,2,11,4,5,29,19,10,37
Spart Moscow,898,3,10,5,5,42,33,9,35
Krasnodar,898,4,9,4,7,29,25,4,31
Zenit,898,5,7,9,4,22,16,6,30
Terek Grozny,898,6,7,5,8,20,24,-4,26
Din Moscow,898,7,6,6,8,25,25,0,24
Rostov,898,8,5,6,9,14,20,-6,21
FK Rubin,898,9,5,5,10,21,24,-3,20
Amkar,898,10,5,4,11,11,24,-13,19
Anzhi,898,11,3,6,11,17,39,-22,15
Loko Moscow,899,1,12,5,3,32,13,19,41
CSKA Moscow,899,2,11,3,6,27,20,7,36
Spart Moscow,899,3,10,5,5,36,27,9,35
Zenit,899,4,8,8,4,23,15,8,32
Krasnodar,899,5,8,5,7,28,27,1,29
Terek Grozny,899,6,7,5,8,21,27,-6,26
Din Moscow,899,7,6,6,8,18,23,-5,24
FK Rubin,899,8,5,6,9,21,18,3,21
Rostov,899,9,5,6,9,12,17,-5,21
Amkar,899,10,5,4,11,13,24,-11,19
Anzhi,899,11,4,5,11,17,37,-20,17
Loko Moscow,900,1,11,6,3,30,13,17,39
Spart Moscow,900,2,10,6,4,38,28,10,36
CSKA Moscow,900,3,10,5,5,25,17,8,35
Zenit,900,4,7,10,3,22,14,8,31
Krasnodar,900,5,9,4,7,28,26,2,31
Terek Grozny,900,6,8,6,6,21,22,-1,30
Din Moscow,900,7,6,6,8,23,24,-1,24
FK Rubin,900,8,6,5,9,23,21,2,23
Rostov,900,9,4,7,9,11,18,-7,19
Amkar,900,10,4,5,11,9,23,-14,17
Anzhi,900,11,2,6,12,14,38,-24,12
Loko Moscow,901,1,12,5,3,31,13,18,41
Spart Moscow,901,2,11,5,4,45,27,18,38
CSKA Moscow,901,3,10,5,5,27,19,8,35
Krasnodar,901,4,9,4,7,30,28,2,31
Zenit,901,5,7,9,4,21,14,7,30
Terek Grozny,901,6,7,6,7,22,25,-3,27
FK Rubin,901,7,6,6,8,24,18,6,24
Din Moscow,901,8,5,7,8,18,26,-8,22
Rostov,901,9,4,6,10,11,22,-11,18
Amkar,901,10,4,5,11,10,25,-15,17
Anzhi,901,11,3,6,11,18,40,-22,15
Loko Moscow,902,1,11,6,3,31,14,17,39
CSKA Moscow,902,2,11,4,5,27,18,9,37
Spart Moscow,902,3,9,7,4,35,25,10,34
Krasnodar,902,4,10,4,6,33,25,8,34
Zenit,902,5,7,9,4,23,16,7,30
Terek Grozny,902,6,8,6,6,24,24,0,30
Din Moscow,902,7,6,7,7,18,21,-3,25
FK Rubin,902,8,5,5,10,22,23,-1,20
Rostov,902,9,4,7,9,10,17,-7,19
Amkar,902,10,4,5,11,10,25,-15,17
Anzhi,902,11,2,6,12,16,41,-25,12
Loko Moscow,903,1,12,5,3,33,14,19,41
CSKA Moscow,903,2,11,3,6,29,19,10,36
Spart Moscow,903,3,10,5,5,38,28,10,35
Krasnodar,903,4,10,4,6,32,25,7,34
Zenit,903,5,8,8,4,24,18,6,32
Terek Grozny,903,6,8,6,6,24,24,0,30
Din Moscow,903,7,6,7,7,18,21,-3,25
FK Rubin,903,8,5,6,9,22,20,2,21
Rostov,903,9,4,6,10,11,20,-9,18
Amkar,903,10,4,5,11,12,26,-14,17
Anzhi,903,11,2,5,13,14,42,-28,11
Loko Moscow,904,1,11,7,2,30,12,18,40
CSKA Moscow,904,2,11,4,5,29,19,10,37
Spart Moscow,904,3,9,5,6,34,27,7,32
Krasnodar,904,4,9,5,6,30,26,4,32
Zenit,904,5,7,10,3,22,14,8,31
Terek Grozny,904,6,7,7,6,23,25,-2,28
Din Moscow,904,7,6,6,8,19,23,-4,24
FK Rubin,904,8,6,5,9,24,20,4,23
Amkar,904,9,5,5,10,11,23,-12,20
Rostov,904,10,4,6,10,10,18,-8,18
Anzhi,904,11,2,6,12,17,42,-25,12
Loko Moscow,905,1,11,7,2,30,12,18,40
Spart Moscow,905,2,10,5,5,39,28,11,35
CSKA Moscow,905,3,10,5,5,25,17,8,35
Terek Grozny,905,4,9,5,6,27,24,3,32
Zenit,905,5,7,10,3,21,13,8,31
Krasnodar,905,6,8,6,6,30,27,3,30
Din Moscow,905,7,6,6,8,19,24,-5,24
FK Rubin,905,8,5,6,9,23,21,2,21
Amkar,905,9,5,4,11,12,27,-15,19
Rostov,905,10,4,6,10,11,19,-8,18
Anzhi,905,11,2,6,12,15,40,-25,12
Loko Moscow,906,1,12,5,3,31,14,17,41
CSKA Moscow,906,2,11,3,6,28,19,9,36
Zenit,906,3,8,8,4,23,14,9,32
Krasnodar,906,4,9,5,6,30,25,5,32
Spart Moscow,906,5,8,6,6,35,29,6,30
Terek Grozny,906,6,7,6,7,20,23,-3,27
FK Rubin,906,7,6,6,8,23,18,5,24
Din Moscow,906,8,6,6,8,20,24,-4,24
Amkar,906,9,5,5,10,10,22,-12,20
Rostov,906,10,4,7,9,11,18,-7,19
Anzhi,906,11,3,5,12,15,40,-25,14
Loko Moscow,907,1,11,6,3,30,13,17,39
Spart Moscow,907,2,11,5,4,40,28,12,38
Zenit,907,3,9,8,3,25,15,10,35
CSKA Moscow,907,4,10,4,6,27,20,7,34
Krasnodar,907,5,8,5,7,28,26,2,29
Terek Grozny,907,6,7,5,8,20,26,-6,26
FK Rubin,907,7,6,6,8,23,18,5,24
Din Moscow,907,8,5,7,8,18,24,-6,22
Amkar,907,9,5,4,11,12,24,-12,19
Rostov,907,10,4,6,10,11,19,-8,18
Anzhi,907,11,3,6,11,17,38,-21,15
Loko Moscow,908,1,12,6,2,32,13,19,42
CSKA Moscow,908,2,11,3,6,28,18,10,36
Zenit,908,3,8,9,3,24,15,9,33
Krasnodar,908,4,9,4,7,28,25,3,31
Spart Moscow,908,5,8,5,7,35,31,4,29
Terek Grozny,908,6,8,5,7,22,25,-3,29
Din Moscow,908,7,6,7,7,19,22,-3,25
FK Rubin,908,8,5,6,9,21,18,3,21
Rostov,908,9,5,6,9,13,18,-5,21
Amkar,908,10,5,4,11,11,24,-13,19
Anzhi,908,11,3,5,12,16,40,-24,14
Loko Moscow,909,1,12,5,3,35,15,20,41
Spart Moscow,909,2,10,6,4,42,26,16,36
CSKA Moscow,909,3,10,5,5,26,18,8,35
Zenit,909,4,8,9,3,24,15,9,33
Krasnodar,909,5,8,4,8,30,31,-1,28
Terek Grozny,909,6,7,5,8,21,25,-4,26
FK Rubin,909,7,6,6,8,25,20,5,24
Din Moscow,909,8,5,7,8,19,27,-8,22
Amkar,909,9,5,5,10,11,23,-12,20
Rostov,909,10,4,6,10,10,21,-11,18
Anzhi,909,11,3,6,11,16,38,-22,15
Loko Moscow,910,1,12,6,2,30,11,19,42
CSKA Moscow,910,2,11,4,5,27,17,10,37
Spart Moscow,910,3,10,5,5,41,28,13,35
Terek Grozny,910,4,9,5,6,25,22,3,32
Zenit,910,5,7,10,3,21,13,8,31
Krasnodar,910,6,8,4,8,27,26,1,28
Din Moscow,910,7,6,6,8,18,26,-8,24
FK Rubin,910,8,6,5,9,22,18,4,23
Amkar,910,9,5,4,11,11,24,-13,19
Rostov,910,10,4,6,10,11,20,-9,18
Anzhi,910,11,2,5,13,14,42,-28,11
Loko Moscow,911,1,11,6,3,30,14,16,39
CSKA Moscow,911,2,11,3,6,28,20,8,36
Krasnodar,911,3,10,4,6,31,24,7,34
Zenit,911,4,8,9,3,25,15,10,33
Spart Moscow,911,5,8,8,4,33,25,8,32
Terek Grozny,911,6,8,6,6,24,23,1,30
FK Rubin,911,7,6,5,9,22,19,3,23
Din Moscow,911,8,5,7,8,17,22,-5,22
Rostov,911,9,4,7,9,10,17,-7,19
Amkar,911,10,4,5,11,9,25,-16,17
Anzhi,911,11,2,6,12,15,40,-25,12
Loko Moscow,912,1,11,6,3,29,12,17,39
CSKA Moscow,912,2,11,3,6,30,21,9,36
Krasnodar,912,3,10,4,6,32,25,7,34
Zenit,912,4,8,9,3,25,15,10,33
Spart Moscow,912,5,8,6,6,37,32,5,30
Terek Grozny,912,6,7,5,8,20,24,-4,26
FK Rubin,912,7,6,5,9,25,22,3,23
Din Moscow,912,8,5,7,8,19,25,-6,22
Amkar,912,9,6,4,10,15,25,-10,22
Rostov,912,10,5,6,9,11,17,-6,21
Anzhi,912,11,3,5,12,15,40,-25,14
Loko Moscow,913,1,11,6,3,30,13,17,39
CSKA Moscow,913,2,11,3,6,27,18,9,36
Zenit,913,3,9,8,3,24,14,10,35
Terek Grozny,913,4,9,5,6,22,22,0,32
Spart Moscow,913,5,8,7,5,39,32,7,31
Krasnodar,913,6,8,6,6,28,25,3,30
FK Rubin,913,7,6,6,8,24,19,5,24
Din Moscow,913,8,5,7,8,20,25,-5,22
Rostov,913,9,4,7,9,11,18,-7,19
Amkar,913,10,5,4,11,13,26,-13,19
Anzhi,913,11,2,5,13,14,40,-26,11
Loko Moscow,914,1,12,5,3,32,14,18,41
Spart Moscow,914,2,11,5,4,39,25,14,38
CSKA Moscow,914,3,11,4,5,26,17,9,37
Zenit,914,4,8,8,4,23,14,9,32
Terek Grozny,914,5,8,6,6,23,24,-1,30
Krasnodar,914,6,8,5,7,30,29,1,29
Din Moscow,914,7,6,6,8,20,23,-3,24
FK Rubin,914,8,5,6,9,23,22,1,21
Rostov,914,9,4,6,10,10,20,-10,18
Amkar,914,10,4,5,11,10,24,-14,17
Anzhi,914,11,2,6,12,15,39,-24,12
Loko Moscow,915,1,12,5,3,32,14,18,41
Spart Moscow,915,2,11,5,4,42,29,13,38
CSKA Moscow,915,3,10,5,5,27,19,8,35
Zenit,915,4,8,9,3,25,16,9,33
Krasnodar,915,5,9,4,7,29,26,3,31
Terek Grozny,915,6,7,5,8,21,27,-6,26
FK Rubin,915,7,6,5,9,24,19,5,23
Din Moscow,915,8,5,6,9,18,27,-9,21
Amkar,915,9,5,4,11,13,26,-13,19
Rostov,915,10,4,6,10,11,19,-8,18
Anzhi,915,11,3,6,11,18,38,-20,15
Loko Moscow,916,1,11,5,4,30,15,15,38
Zenit,916,2,9,8,3,24,13,11,35
Spart Moscow,916,3,10,5,5,39,31,8,35
CSKA Moscow,916,4,10,3,7,26,20,6,33
Krasnodar,916,5,9,4,7,29,26,3,31
Terek Grozny,916,6,7,6,7,21,24,-3,27
FK Rubin,916,7,7,5,8,23,17,6,26
Amkar,916,8,6,4,10,14,23,-9,22
Din Moscow,916,9,5,6,9,18,25,-7,21
Rostov,916,10,4,6,10,12,20,-8,18
Anzhi,916,11,3,6,11,16,38,-22,15
Loko Moscow,917,1,12,5,3,30,12,18,41
CSKA Moscow,917,2,10,4,6,27,21,6,34
Zenit,917,3,8,9,3,23,14,9,33
Spart Moscow,917,4,8,7,5,33,26,7,31
Terek Grozny,917,5,8,6,6,25,24,1,30
Krasnodar,917,6,8,4,8,29,28,1,28
Din Moscow,917,7,7,6,7,20,22,-2,27
FK Rubin,917,8,6,5,9,25,21,4,23
Rostov,917,9,4,7,9,10,17,-7,19
Amkar,917,10,4,6,10,10,23,-13,18
Anzhi,917,11,3,5,12,18,42,-24,14
Loko Moscow,918,1,12,5,3,33,14,19,41
CSKA Moscow,918,2,12,3,5,30,19,11,39
Spart Moscow,918,3,11,5,4,38,25,13,38
Krasnodar,918,4,9,4,7,29,27,2,31
Zenit,918,5,7,8,5,22,17,5,29
Terek Grozny,918,6,7,6,7,22,25,-3,27
FK Rubin,918,7,6,6,8,25,19,6,24
Din Moscow,918,8,5,7,8,19,25,-6,22
Amkar,918,9,5,4,11,10,23,-13,19
Rostov,918,10,4,6,10,10,19,-9,18
Anzhi,918,11,2,6,12,18,43,-25,12
Loko Moscow,919,1,11,6,3,29,12,17,39
CSKA Moscow,919,2,12,3,5,28,17,11,39
Spart Moscow,919,3,10,5,5,38,29,9,35
Zenit,919,4,8,8,4,22,14,8,32
Terek Grozny,919,5,9,5,6,22,22,0,32
Krasnodar,919,6,8,6,6,28,25,3,30
FK Rubin,919,7,5,7,8,23,19,4,22
Din Moscow,919,8,5,7,8,19,24,-5,22
Rostov,919,9,5,6,9,11,17,-6,21
Amkar,919,10,4,4,12,11,26,-15,16
Anzhi,919,11,2,5,13,14,40,-26,11
Loko Moscow,920,1,12,5,3,30,14,16,41
Spart Moscow,920,2,10,6,4,38,27,11,36
CSKA Moscow,920,3,11,3,6,27,19,8,36
Zenit,920,4,9,8,3,25,13,12,35
Krasnodar,920,5,8,4,8,27,26,1,28
Terek Grozny,920,6,7,6,7,22,25,-3,27
FK Rubin,920,7,7,5,8,24,18,6,26
Din Moscow,920,8,5,7,8,19,24,-5,22
Amkar,920,9,5,4,11,11,24,-13,19
Rostov,920,10,4,6,10,11,20,-9,18
Anzhi,920,11,2,6,12,16,40,-24,12
Loko Moscow,921,1,11,6,3,31,14,17,39
CSKA Moscow,921,2,11,3,6,27,18,9,36
Spart Moscow,921,3,10,5,5,41,33,8,35
Zenit,921,4,8,9,3,23,14,9,33
Krasnodar,921,5,9,5,6,30,26,4,32
Terek Grozny,921,6,9,5,6,25,24,1,32
FK Rubin,921,7,5,7,8,23,19,4,22
Din Moscow,921,8,5,7,8,21,26,-5,22
Rostov,921,9,5,6,9,15,18,-3,21
Amkar,921,10,4,4,12,11,29,-18,16
Anzhi,921,11,2,5,13,14,40,-26,11
Loko Moscow,922,1,12,5,3,31,13,18,41
CSKA Moscow,922,2,11,3,6,27,19,8,36
Spart Moscow,922,3,10,5,5,41,27,14,35
Krasnodar,922,4,10,4,6,31,25,6,34
Zenit,922,5,8,8,4,23,15,8,32
Terek Grozny,922,6,8,6,6,24,23,1,30
Din Moscow,922,7,7,6,7,21,22,-1,27
FK Rubin,922,8,5,5,10,22,22,0,20
Rostov,922,9,4,6,10,11,20,-9,18
Amkar,922,10,4,4,12,10,31,-21,16
Anzhi,922,11,2,6,12,14,38,-24,12
Loko Moscow,923,1,13,5,2,32,11,21,44
CSKA Moscow,923,2,11,4,5,29,19,10,37
Spart Moscow,923,3,9,6,5,37,29,8,33
Terek Grozny,923,4,9,5,6,25,22,3,32
Zenit,923,5,7,9,4,22,15,7,30
Krasnodar,923,6,8,5,7,27,26,1,29
Din Moscow,923,7,5,8,7,19,23,-4,23
FK Rubin,923,8,5,7,8,22,18,4,22
Amkar,923,9,5,4,11,11,24,-13,19
Rostov,923,10,4,6,10,11,19,-8,18
Anzhi,923,11,2,5,13,15,44,-29,11
Loko Moscow,924,1,11,6,3,31,15,16,39
CSKA Moscow,924,2,12,3,5,27,17,10,39
Krasnodar,924,3,10,4,6,30,24,6,34
Spart Moscow,924,4,9,6,5,36,28,8,33
Zenit,924,5,7,9,4,23,16,7,30
Terek Grozny,924,6,7,7,6,21,23,-2,28
Din Moscow,924,7,7,6,7,21,22,-1,27
FK Rubin,924,8,5,5,10,21,20,1,20
Rostov,924,9,4,7,9,10,17,-7,19
Amkar,924,10,4,5,11,10,24,-14,17
Anzhi,924,11,2,6,12,15,39,-24,12
Loko Moscow,925,1,11,5,4,29,16,13,38
CSKA Moscow,925,2,11,4,5,28,19,9,37
Krasnodar,925,3,10,4,6,32,24,8,34
Zenit,925,4,8,9,3,23,14,9,33
Spart Moscow,925,5,8,7,5,36,29,7,31
Terek Grozny,925,6,8,5,7,21,23,-2,29
Din Moscow,925,7,6,6,8,19,25,-6,24
FK Rubin,925,8,6,5,9,24,18,6,23
Rostov,925,9,4,7,9,10,17,-7,19
Amkar,925,10,4,5,11,11,25,-14,17
Anzhi,925,11,3,5,12,16,39,-23,14
Loko Moscow,926,1,12,6,2,32,13,19,42
CSKA Moscow,926,2,11,3,6,26,20,6,36
Zenit,926,3,8,9,3,25,14,11,33
Spart Moscow,926,4,9,6,5,39,30,9,33
Krasnodar,926,5,8,5,7,29,27,2,29
Terek Grozny,926,6,7,6,7,20,23,-3,27
Din Moscow,926,7,5,8,7,21,25,-4,23
FK Rubin,926,8,5,7,8,23,19,4,22
Amkar,926,9,5,5,10,11,22,-11,20
Rostov,926,10,4,6,10,10,20,-10,18
Anzhi,926,11,3,5,12,15,38,-23,14
Spart Moscow,927,1,11,5,4,41,27,14,38
Loko Moscow,927,2,11,5,4,31,17,14,38
CSKA Moscow,927,3,11,3,6,27,21,6,36
Zenit,927,4,9,8,3,28,16,12,35
Krasnodar,927,5,10,4,6,31,24,7,34
Terek Grozny,927,6,7,6,7,21,25,-4,27
Din Moscow,927,7,5,7,8,18,24,-6,22
FK Rubin,927,8,5,6,9,21,18,3,21
Rostov,927,9,4,6,10,10,20,-10,18
Amkar,927,10,4,5,11,10,24,-14,17
Anzhi,927,11,3,5,12,17,39,-22,14
Loko Moscow,928,1,12,5,3,31,13,18,41
CSKA Moscow,928,2,11,3,6,27,21,6,36
Spart Moscow,928,3,10,5,5,36,27,9,35
Krasnodar,928,4,10,4,6,31,24,7,34
Zenit,928,5,8,8,4,24,15,9,32
Terek Grozny,928,6,8,5,7,22,23,-1,29
Din Moscow,928,7,7,6,7,19,21,-2,27
FK Rubin,928,8,5,5,10,21,20,1,20
Rostov,928,9,4,6,10,10,18,-8,18
Amkar,928,10,4,4,12,10,26,-16,16
Anzhi,928,11,3,5,12,16,39,-23,14
Loko Moscow,929,1,13,5,2,34,12,22,44
CSKA Moscow,929,2,10,4,6,27,20,7,34
Spart Moscow,929,3,9,6,5,34,27,7,33
Zenit,929,4,8,8,4,22,15,7,32
Krasnodar,929,5,8,4,8,28,29,-1,28
Terek Grozny,929,6,7,6,7,21,24,-3,27
FK Rubin,929,7,6,6,8,24,18,6,24
Din Moscow,929,8,5,8,7,18,22,-4,23
Rostov,929,9,5,6,9,12,17,-5,21
Amkar,929,10,4,5,11,10,24,-14,17
Anzhi,929,11,3,6,11,17,39,-22,15
Loko Moscow,930,1,11,6,3,30,14,16,39
Zenit,930,2,9,8,3,27,15,12,35
CSKA Moscow,930,3,10,3,7,28,23,5,33
Spart Moscow,930,4,9,5,6,35,29,6,32
Terek Grozny,930,5,8,6,6,23,23,0,30
Krasnodar,930,6,8,5,7,28,26,2,29
FK Rubin,930,7,7,5,8,24,17,7,26
Din Moscow,930,8,6,6,8,18,23,-5,24
Rostov,930,9,5,6,9,13,18,-5,21
Amkar,930,10,4,5,11,10,24,-14,17
Anzhi,930,11,3,5,12,16,40,-24,14
Loko Moscow,931,1,12,6,2,33,14,19,42
Spart Moscow,931,2,10,6,4,38,26,12,36
CSKA Moscow,931,3,10,4,6,27,22,5,34
Krasnodar,931,4,9,5,6,30,26,4,32
Zenit,931,5,7,9,4,22,15,7,30
Terek Grozny,931,6,7,5,8,21,26,-5,26
FK Rubin,931,7,6,5,9,22,18,4,23
Din Moscow,931,8,5,6,9,18,25,-7,21
Rostov,931,9,4,7,9,10,17,-7,19
Amkar,931,10,5,4,11,10,24,-14,19
Anzhi,931,11,4,5,11,22,40,-18,17
Loko Moscow,932,1,12,6,2,32,13,19,42
Spart Moscow,932,2,11,5,4,38,25,13,38
CSKA Moscow,932,3,11,4,5,28,18,10,37
Krasnodar,932,4,9,5,6,32,27,5,32
Zenit,932,5,7,9,4,23,16,7,30
Terek Grozny,932,6,7,5,8,22,26,-4,26
Din Moscow,932,7,5,7,8,18,24,-6,22
FK Rubin,932,8,5,6,9,24,22,2,21
Amkar,932,9,5,4,11,12,26,-14,19
Rostov,932,10,4,6,10,10,18,-8,18
Anzhi,932,11,3,5,12,15,39,-24,14
Loko Moscow,933,1,13,5,2,33,11,22,44
CSKA Moscow,933,2,10,4,6,27,20,7,34
Spart Moscow,933,3,9,6,5,35,26,9,33
Zenit,933,4,8,8,4,22,15,7,32
Krasnodar,933,5,8,4,8,27,27,0,28
Terek Grozny,933,6,7,5,8,22,27,-5,26
Din Moscow,933,7,6,6,8,18,23,-5,24
FK Rubin,933,8,6,5,9,22,18,4,23
Rostov,933,9,5,6,9,11,17,-6,21
Amkar,933,10,5,5,10,11,23,-12,20
Anzhi,933,11,3,6,11,19,40,-21,15
CSKA Moscow,934,1,12,3,5,31,17,14,39
Loko Moscow,934,2,11,5,4,30,15,15,38
Spart Moscow,934,3,10,6,4,39,27,12,36
Zenit,934,4,8,8,4,23,15,8,32
Terek Grozny,934,5,9,5,6,24,23,1,32
Krasnodar,934,6,9,4,7,30,27,3,31
FK Rubin,934,7,6,6,8,24,19,5,24
Din Moscow,934,8,5,7,8,18,24,-6,22
Rostov,934,9,4,7,9,11,18,-7,19
Amkar,934,10,4,4,12,10,27,-17,16
Anzhi,934,11,2,5,13,15,43,-28,11
Loko Moscow,935,1,12,5,3,31,13,18,41
CSKA Moscow,935,2,11,4,5,28,18,10,37
Spart Moscow,935,3,10,6,4,38,26,12,36
Zenit,935,4,8,8,4,23,16,7,32
Krasnodar,935,5,9,4,7,30,27,3,31
Terek Grozny,935,6,8,6,6,22,23,-1,30
Din Moscow,935,7,5,7,8,17,22,-5,22
FK Rubin,935,8,5,6,9,23,20,3,21
Rostov,935,9,4,7,9,11,18,-7,19
Amkar,935,10,4,5,11,9,25,-16,17
Anzhi,935,11,2,6,12,16,40,-24,12
Loko Moscow,936,1,13,5,2,34,11,23,44
Spart Moscow,936,2,9,7,4,39,28,11,34
CSKA Moscow,936,3,10,3,7,26,20,6,33
Zenit,936,4,8,8,4,23,18,5,32
Krasnodar,936,5,8,5,7,29,27,2,29
Terek Grozny,936,6,8,5,7,22,24,-2,29
FK Rubin,936,7,6,6,8,24,19,5,24
Din Moscow,936,8,5,6,9,18,26,-8,21
Amkar,936,9,5,5,10,13,25,-12,20
Rostov,936,10,4,7,9,10,17,-7,19
Anzhi,936,11,3,5,12,15,38,-23,14
Loko Moscow,937,1,11,6,3,29,14,15,39
Spart Moscow,937,2,10,6,4,41,29,12,36
CSKA Moscow,937,3,11,3,6,27,20,7,36
Zenit,937,4,8,9,3,23,13,10,33
Krasnodar,937,5,9,4,7,30,27,3,31
FK Rubin,937,6,7,5,8,26,18,8,26
Terek Grozny,937,7,7,5,8,20,28,-8,26
Din Moscow,937,8,5,7,8,18,23,-5,22
Amkar,937,9,5,4,11,10,25,-15,19
Rostov,937,10,4,6,10,14,22,-8,18
Anzhi,937,11,3,5,12,20,39,-19,14
Loko Moscow,938,1,12,5,3,31,13,18,41
CSKA Moscow,938,2,12,3,5,29,18,11,39
Spart Moscow,938,3,10,5,5,38,28,10,35
Krasnodar,938,4,9,5,6,29,25,4,32
Zenit,938,5,7,8,5,23,17,6,29
Terek Grozny,938,6,7,5,8,20,24,-4,26
Din Moscow,938,7,6,6,8,19,24,-5,24
Amkar,938,8,6,4,10,13,23,-10,22
FK Rubin,938,9,5,6,9,23,20,3,21
Rostov,938,10,4,6,10,10,19,-9,18
Anzhi,938,11,3,5,12,15,39,-24,14
Loko Moscow,939,1,11,6,3,31,16,15,39
CSKA Moscow,939,2,12,3,5,28,17,11,39
Spart Moscow,939,3,11,5,4,40,28,12,38
Krasnodar,939,4,9,4,7,33,28,5,31
Zenit,939,5,7,9,4,22,16,6,30
Terek Grozny,939,6,8,6,6,24,24,0,30
FK Rubin,939,7,6,6,8,25,20,5,24
Din Moscow,939,8,5,7,8,18,23,-5,22
Rostov,939,9,4,6,10,11,20,-9,18
Amkar,939,10,4,5,11,12,26,-14,17
Anzhi,939,11,2,5,13,15,41,-26,11
Loko Moscow,940,1,11,6,3,30,13,17,39
CSKA Moscow,940,2,12,3,5,28,18,10,39
Spart Moscow,940,3,9,6,5,38,31,7,33
Terek Grozny,940,4,9,5,6,24,23,1,32
Krasnodar,940,5,9,4,7,30,27,3,31
Zenit,940,6,7,9,4,23,16,7,30
Din Moscow,940,7,6,6,8,19,23,-4,24
FK Rubin,940,8,6,5,9,24,20,4,23
Rostov,940,9,5,6,9,14,19,-5,21
Amkar,940,10,4,5,11,10,24,-14,17
Anzhi,940,11,2,5,13,15,41,-26,11
Loko Moscow,941,1,11,6,3,30,13,17,39
CSKA Moscow,941,2,11,3,6,30,22,8,36
Zenit,941,3,8,9,3,24,15,9,33
Spart Moscow,941,4,9,5,6,36,31,5,32
Krasnodar,941,5,9,4,7,28,26,2,31
Terek Grozny,941,6,8,6,6,24,23,1,30
FK Rubin,941,7,6,6,8,25,19,6,24
Din Moscow,941,8,5,7,8,20,25,-5,22
Rostov,941,9,5,6,9,12,18,-6,21
Amkar,941,10,5,5,10,13,23,-10,20
Anzhi,941,11,2,5,13,17,44,-27,11
Loko Moscow,942,1,13,5,2,35,14,21,44
Spart Moscow,942,2,10,6,4,37,25,12,36
CSKA Moscow,942,3,11,3,6,26,19,7,36
Zenit,942,4,8,8,4,23,14,9,32
Terek Grozny,942,5,8,6,6,24,24,0,30
Krasnodar,942,6,8,5,7,31,30,1,29
FK Rubin,942,7,5,7,8,22,18,4,22
Din Moscow,942,8,5,7,8,17,23,-6,22
Rostov,942,9,4,6,10,10,19,-9,18
Amkar,942,10,4,5,11,10,25,-15,17
Anzhi,942,11,2,6,12,15,39,-24,12
Loko Moscow,943,1,12,5,3,34,13,21,41
CSKA Moscow,943,2,12,3,5,29,19,10,39
Spart Moscow,943,3,11,5,4,37,26,11,38
Krasnodar,943,4,9,4,7,29,27,2,31
Zenit,943,5,7,8,5,21,18,3,29
FK Rubin,943,6,7,5,8,25,18,7,26
Terek Grozny,943,7,7,5,8,20,27,-7,26
Din Moscow,943,8,5,6,9,19,25,-6,21
Amkar,943,9,5,4,11,11,23,-12,19
Rostov,943,10,4,6,10,10,18,-8,18
Anzhi,943,11,3,5,12,19,40,-21,14
Loko Moscow,944,1,12,6,2,32,13,19,42
CSKA Moscow,944,2,11,3,6,27,19,8,36
Zenit,944,3,8,8,4,22,14,8,32
Spart Moscow,944,4,9,5,6,36,29,7,32
Krasnodar,944,5,9,5,6,31,26,5,32
Terek Grozny,944,6,8,5,7,22,24,-2,29
Din Moscow,944,7,6,7,7,19,22,-3,25
FK Rubin,944,8,5,6,9,22,20,2,21
Rostov,944,9,5,6,9,12,18,-6,21
Amkar,944,10,5,4,11,12,25,-13,19
Anzhi,944,11,2,5,13,15,40,-25,11
Loko Moscow,945,1,11,6,3,30,13,17,39
Zenit,945,2,9,8,3,25,14,11,35
Spart Moscow,945,3,10,5,5,36,26,10,35
CSKA Moscow,945,4,10,3,7,28,23,5,33
Krasnodar,945,5,9,5,6,31,27,4,32
Terek Grozny,945,6,8,5,7,23,24,-1,29
Din Moscow,945,7,6,7,7,20,23,-3,25
FK Rubin,945,8,5,6,9,25,22,3,21
Amkar,945,9,5,4,11,10,24,-14,19
Rostov,945,10,4,6,10,10,18,-8,18
Anzhi,945,11,3,5,12,18,42,-24,14
Loko Moscow,946,1,12,6,2,33,13,20,42
Spart Moscow,946,2,10,6,4,38,26,12,36
CSKA Moscow,946,3,11,3,6,29,19,10,36
Zenit,946,4,8,8,4,24,16,8,32
Terek Grozny,946,5,9,5,6,22,22,0,32
Krasnodar,946,6,8,6,6,29,26,3,30
FK Rubin,946,7,6,6,8,23,18,5,24
Din Moscow,946,8,5,7,8,17,22,-5,22
Rostov,946,9,4,6,10,10,20,-10,18
Amkar,946,10,4,4,12,10,25,-15,16
Anzhi,946,11,2,5,13,14,42,-28,11
Loko Moscow,947,1,11,6,3,30,13,17,39
CSKA Moscow,947,2,11,4,5,29,19,10,37
Spart Moscow,947,3,9,5,6,40,29,11,32
Terek Grozny,947,4,9,5,6,22,22,0,32
Krasnodar,947,5,9,4,7,29,27,2,31
Zenit,947,6,7,9,4,22,16,6,30
Din Moscow,947,7,6,7,7,19,22,-3,25
FK Rubin,947,8,6,6,8,25,19,6,24
Amkar,947,9,5,4,11,11,24,-13,19
Rostov,947,10,4,6,10,11,23,-12,18
Anzhi,947,11,2,6,12,16,40,-24,12
Loko Moscow,948,1,12,6,2,33,14,19,42
CSKA Moscow,948,2,12,3,5,30,19,11,39
Spart Moscow,948,3,10,6,4,38,27,11,36
Krasnodar,948,4,9,4,7,32,27,5,31
Zenit,948,5,7,9,4,23,16,7,30
Terek Grozny,948,6,8,6,6,23,24,-1,30
Din Moscow,948,7,5,7,8,19,24,-5,22
FK Rubin,948,8,5,6,9,22,21,1,21
Rostov,948,9,4,7,9,11,18,-7,19
Amkar,948,10,4,4,12,9,25,-16,16
Anzhi,948,11,2,6,12,17,42,-25,12
Loko Moscow,949,1,13,5,2,33,12,21,44
CSKA Moscow,949,2,10,4,6,26,19,7,34
Zenit,949,3,8,8,4,24,16,8,32
Spart Moscow,949,4,9,5,6,37,32,5,32
Krasnodar,949,5,8,5,7,27,26,1,29
Terek Grozny,949,6,7,5,8,20,24,-4,26
FK Rubin,949,7,5,7,8,22,18,4,22
Din Moscow,949,8,5,7,8,19,24,-5,22
Amkar,949,9,6,4,10,13,22,-9,22
Rostov,949,10,5,6,9,13,19,-6,21
Anzhi,949,11,3,6,11,15,37,-22,15
Loko Moscow,950,1,12,6,2,31,11,20,42
Spart Moscow,950,2,9,7,4,38,27,11,34
CSKA Moscow,950,3,10,4,6,27,22,5,34
Zenit,950,4,8,8,4,24,15,9,32
Krasnodar,950,5,9,5,6,29,25,4,32
Terek Grozny,950,6,8,6,6,22,23,-1,30
FK Rubin,950,7,6,5,9,26,21,5,23
Din Moscow,950,8,5,7,8,21,27,-6,22
Rostov,950,9,4,6,10,10,20,-10,18
Amkar,950,10,4,6,10,10,23,-13,18
Anzhi,950,11,2,6,12,16,40,-24,12
Loko Moscow,951,1,11,6,3,32,15,17,39
CSKA Moscow,951,2,11,3,6,27,19,8,36
Zenit,951,3,9,8,3,25,15,10,35
Spart Moscow,951,4,9,6,5,36,28,8,33
Krasnodar,951,5,8,5,7,30,28,2,29
Terek Grozny,951,6,8,5,7,23,24,-1,29
FK Rubin,951,7,6,6,8,24,19,5,24
Din Moscow,951,8,5,8,7,20,24,-4,23
Amkar,951,9,5,4,11,11,25,-14,19
Rostov,951,10,4,6,10,10,18,-8,18
Anzhi,951,11,3,5,12,15,38,-23,14
Loko Moscow,952,1,12,5,3,32,14,18,41
Krasnodar,952,2,10,4,6,30,25,5,34
CSKA Moscow,952,3,10,4,6,26,21,5,34
Zenit,952,4,8,8,4,25,15,10,32
Spart Moscow,952,5,8,7,5,38,31,7,31
Terek Grozny,952,6,7,7,6,23,25,-2,28
Din Moscow,952,7,5,8,7,19,23,-4,23
FK Rubin,952,8,5,6,9,21,18,3,21
Amkar,952,9,5,5,10,11,23,-12,20
Rostov,952,10,4,7,9,12,19,-7,19
Anzhi,952,11,2,7,11,18,41,-23,13
Loko Moscow,953,1,11,6,3,32,16,16,39
CSKA Moscow,953,2,11,3,6,27,18,9,36
Krasnodar,953,3,10,4,6,33,26,7,34
Zenit,953,4,8,9,3,23,14,9,33
Spart Moscow,953,5,8,6,6,35,29,6,30
Terek Grozny,953,6,8,6,6,25,24,1,30
Din Moscow,953,7,6,7,7,20,23,-3,25
FK Rubin,953,8,5,6,9,22,20,2,21
Amkar,953,9,5,5,10,13,25,-12,20
Rostov,953,10,4,7,9,10,17,-7,19
Anzhi,953,11,2,5,13,14,42,-28,11
Loko Moscow,954,1,11,6,3,30,13,17,39
Spart Moscow,954,2,10,6,4,40,29,11,36
CSKA Moscow,954,3,11,3,6,31,22,9,36
Krasnodar,954,4,10,4,6,30,24,6,34
Terek Grozny,954,5,9,5,6,25,23,2,32
Zenit,954,6,7,9,4,23,19,4,30
Din Moscow,954,7,6,7,7,20,22,-2,25
FK Rubin,954,8,5,5,10,21,21,0,20
Rostov,954,9,4,6,10,11,20,-9,18
Amkar,954,10,4,4,12,11,27,-16,16
Anzhi,954,11,3,5,12,19,41,-22,14
Loko Moscow,955,1,12,5,3,31,12,19,41
CSKA Moscow,955,2,11,3,6,27,21,6,36
Zenit,955,3,9,8,3,25,13,12,35
Spart Moscow,955,4,10,5,5,39,28,11,35
Terek Grozny,955,5,9,5,6,24,24,0,32
Krasnodar,955,6,8,5,7,29,28,1,29
FK Rubin,955,7,5,7,8,24,20,4,22
Din Moscow,955,8,5,7,8,18,24,-6,22
Rostov,955,9,5,6,9,12,17,-5,21
Amkar,955,10,4,4,12,11,28,-17,16
Anzhi,955,11,2,5,13,16,41,-25,11
Loko Moscow,956,1,11,6,3,30,15,15,39
CSKA Moscow,956,2,11,3,6,27,19,8,36
Krasnodar,956,3,10,4,6,33,25,8,34
Zenit,956,4,8,9,3,24,14,10,33
Spart Moscow,956,5,8,7,5,38,32,6,31
Terek Grozny,956,6,8,5,7,21,23,-2,29
Din Moscow,956,7,5,8,7,19,23,-4,23
FK Rubin,956,8,5,6,9,22,20,2,21
Rostov,956,9,4,7,9,12,19,-7,19
Amkar,956,10,5,4,11,12,24,-12,19
Anzhi,956,11,3,5,12,15,39,-24,14
Loko Moscow,957,1,12,6,2,32,13,19,42
CSKA Moscow,957,2,11,3,6,27,19,8,36
Spart Moscow,957,3,10,5,5,39,29,10,35
Zenit,957,4,8,9,3,23,14,9,33
Krasnodar,957,5,8,4,8,28,27,1,28
Terek Grozny,957,6,7,5,8,20,25,-5,26
Din Moscow,957,7,6,6,8,20,25,-5,24
FK Rubin,957,8,6,5,9,22,19,3,23
Amkar,957,9,6,4,10,13,22,-9,22
Rostov,957,10,4,6,10,11,19,-8,18
Anzhi,957,11,3,5,12,16,39,-23,14
Loko Moscow,958,1,11,6,3,29,13,16,39
CSKA Moscow,958,2,11,4,5,29,20,9,37
Spart Moscow,958,3,10,5,5,36,27,9,35
Zenit,958,4,8,8,4,24,15,9,32
Krasnodar,958,5,9,5,6,29,25,4,32
Terek Grozny,958,6,7,5,8,22,27,-5,26
Din Moscow,958,7,6,6,8,19,23,-4,24
FK Rubin,958,8,6,5,9,23,19,4,23
Amkar,958,9,5,4,11,11,24,-13,19
Rostov,958,10,4,6,10,10,18,-8,18
Anzhi,958,11,3,6,11,19,40,-21,15
Loko Moscow,959,1,12,5,3,33,16,17,41
CSKA Moscow,959,2,11,3,6,28,21,7,36
Spart Moscow,959,3,10,5,5,38,29,9,35
Krasnodar,959,4,10,4,6,34,25,9,34
Zenit,959,5,8,8,4,26,17,9,32
Din Moscow,959,6,7,6,7,20,21,-1,27
Terek Grozny,959,7,7,5,8,22,26,-4,26
FK Rubin,959,8,5,5,10,21,21,0,20
Amkar,959,9,5,4,11,12,25,-13,19
Rostov,959,10,4,6,10,10,19,-9,18
Anzhi,959,11,3,5,12,17,41,-24,14
Loko Moscow,960,1,12,5,3,32,12,20,41
CSKA Moscow,960,2,12,3,5,29,18,11,39
Spart Moscow,960,3,8,8,4,35,27,8,32
Zenit,960,4,8,8,4,22,14,8,32
Terek Grozny,960,5,8,6,6,21,22,-1,30
Krasnodar,960,6,8,4,8,28,30,-2,28
FK Rubin,960,7,7,5,8,26,19,7,26
Din Moscow,960,8,5,7,8,19,24,-5,22
Rostov,960,9,4,7,9,11,18,-7,19
Amkar,960,10,4,6,10,9,22,-13,18
Anzhi,960,11,2,5,13,15,41,-26,11
Loko Moscow,961,1,13,5,2,35,12,23,44
CSKA Moscow,961,2,11,4,5,27,17,10,37
Spart Moscow,961,3,10,5,5,36,28,8,35
Krasnodar,961,4,9,4,7,30,27,3,31
Zenit,961,5,7,8,5,21,18,3,29
Terek Grozny,961,6,7,7,6,22,24,-2,28
FK Rubin,961,7,6,5,9,23,19,4,23
Din Moscow,961,8,5,6,9,17,24,-7,21
Amkar,961,9,5,5,10,13,24,-11,20
Rostov,961,10,4,6,10,11,19,-8,18
Anzhi,961,11,2,7,11,14,37,-23,13
Loko Moscow,962,1,12,6,2,33,13,20,42
CSKA Moscow,962,2,11,4,5,26,17,9,37
Spart Moscow,962,3,9,6,5,37,29,8,33
Zenit,962,4,7,10,3,22,14,8,31
Krasnodar,962,5,9,4,7,31,27,4,31
Terek Grozny,962,6,7,6,7,21,24,-3,27
Din Moscow,962,7,6,6,8,20,25,-5,24
Amkar,962,8,6,4,10,13,23,-10,22
FK Rubin,962,9,5,5,10,22,22,0,20
Rostov,962,10,4,7,9,11,18,-7,19
Anzhi,962,11,2,6,12,14,38,-24,12
Loko Moscow,963,1,13,5,2,33,12,21,44
CSKA Moscow,963,2,10,5,5,27,19,8,35
Spart Moscow,963,3,9,7,4,36,26,10,34
Terek Grozny,963,4,9,5,6,26,23,3,32
Zenit,963,5,7,9,4,22,15,7,30
Krasnodar,963,6,8,5,7,29,28,1,29
FK Rubin,963,7,6,6,8,23,18,5,24
Din Moscow,963,8,5,7,8,17,22,-5,22
Rostov,963,9,4,7,9,10,17,-7,19
Amkar,963,10,4,4,12,11,28,-17,16
Anzhi,963,11,2,6,12,15,41,-26,12
Loko Moscow,964,1,11,7,2,31,13,18,40
Spart Moscow,964,2,10,6,4,37,26,11,36
CSKA Moscow,964,3,11,3,6,27,19,8,36
Zenit,964,4,8,9,3,23,14,9,33
Krasnodar,964,5,9,5,6,30,26,4,32
Terek Grozny,964,6,7,5,8,21,30,-9,26
Din Moscow,964,7,5,7,8,17,23,-6,22
FK Rubin,964,8,5,6,9,22,19,3,21
Amkar,964,9,5,5,10,11,23,-12,20
Rostov,964,10,4,6,10,10,18,-8,18
Anzhi,964,11,3,5,12,22,40,-18,14
Loko Moscow,965,1,12,6,2,30,11,19,42
CSKA Moscow,965,2,11,4,5,29,18,11,37
Spart Moscow,965,3,9,6,5,34,26,8,33
Zenit,965,4,7,9,4,21,16,5,30
Terek Grozny,965,5,8,6,6,23,23,0,30
Krasnodar,965,6,8,4,8,28,27,1,28
FK Rubin,965,7,7,5,8,25,18,7,26
Din Moscow,965,8,6,6,8,18,23,-5,24
Rostov,965,9,4,7,9,10,17,-7,19
Amkar,965,10,4,4,12,9,25,-16,16
Anzhi,965,11,2,7,11,16,39,-23,13
Loko Moscow,966,1,12,6,2,31,12,19,42
CSKA Moscow,966,2,12,3,5,29,17,12,39
Spart Moscow,966,3,9,6,5,36,28,8,33
Zenit,966,4,7,9,4,21,16,5,30
Krasnodar,966,5,8,5,7,28,26,2,29
Terek Grozny,966,6,7,7,6,20,22,-2,28
FK Rubin,966,7,5,7,8,22,18,4,22
Din Moscow,966,8,5,7,8,19,24,-5,22
Amkar,966,9,5,5,10,10,22,-12,20
Rostov,966,10,4,7,9,11,18,-7,19
Anzhi,966,11,2,6,12,14,38,-24,12
Loko Moscow,967,1,11,7,2,32,14,18,40
CSKA Moscow,967,2,12,3,5,29,18,11,39
Spart Moscow,967,3,9,5,6,38,32,6,32
Krasnodar,967,4,9,5,6,30,26,4,32
Zenit,967,5,7,9,4,23,16,7,30
Terek Grozny,967,6,8,5,7,24,26,-2,29
Din Moscow,967,7,6,7,7,19,22,-3,25
Amkar,967,8,6,4,10,17,27,-10,22
FK Rubin,967,9,5,6,9,22,19,3,21
Rostov,967,10,4,6,10,11,19,-8,18
Anzhi,967,11,2,5,13,15,41,-26,11
Loko Moscow,968,1,11,7,2,30,12,18,40
Spart Moscow,968,2,10,6,4,39,28,11,36
CSKA Moscow,968,3,11,3,6,28,22,6,36
Zenit,968,4,8,9,3,24,13,11,33
Krasnodar,968,5,9,5,6,29,25,4,32
Terek Grozny,968,6,9,5,6,24,23,1,32
Din Moscow,968,7,5,8,7,20,24,-4,23
FK Rubin,968,8,5,6,9,22,19,3,21
Rostov,968,9,4,6,10,10,19,-9,18
Amkar,968,10,4,4,12,11,27,-16,16
Anzhi,968,11,2,5,13,16,41,-25,11
Loko Moscow,969,1,12,6,2,32,12,20,42
CSKA Moscow,969,2,11,4,5,28,18,10,37
Krasnodar,969,3,9,5,6,31,27,4,32
Spart Moscow,969,4,8,7,5,35,29,6,31
Zenit,969,5,7,8,5,21,17,4,29
Terek Grozny,969,6,7,6,7,22,27,-5,27
Din Moscow,969,7,6,6,8,19,22,-3,24
FK Rubin,969,8,6,5,9,24,20,4,23
Amkar,969,9,5,5,10,14,24,-10,20
Rostov,969,10,4,7,9,10,17,-7,19
Anzhi,969,11,2,7,11,17,40,-23,13
Loko Moscow,970,1,11,6,3,31,15,16,39
CSKA Moscow,970,2,11,3,6,28,19,9,36
Zenit,970,3,9,8,3,26,14,12,35
Spart Moscow,970,4,9,6,5,40,30,10,33
Krasnodar,970,5,9,5,6,30,25,5,32
Terek Grozny,970,6,8,5,7,22,23,-1,29
Din Moscow,970,7,7,6,7,22,23,-1,27
FK Rubin,970,8,5,5,10,21,21,0,20
Amkar,970,9,5,5,10,12,24,-12,20
Rostov,970,10,4,6,10,10,20,-10,18
Anzhi,970,11,2,5,13,14,42,-28,11
Loko Moscow,971,1,13,5,2,31,11,20,44
CSKA Moscow,971,2,11,3,6,30,19,11,36
Spart Moscow,971,3,9,6,5,35,29,6,33
Zenit,971,4,8,8,4,23,15,8,32
Krasnodar,971,5,9,4,7,29,25,4,31
Terek Grozny,971,6,7,5,8,22,26,-4,26
Din Moscow,971,7,5,8,7,19,23,-4,23
Amkar,971,8,6,4,10,15,23,-8,22
FK Rubin,971,9,5,6,9,23,21,2,21
Rostov,971,10,4,6,10,10,19,-9,18
Anzhi,971,11,3,5,12,16,42,-26,14
Loko Moscow,972,1,11,7,2,31,13,18,40
CSKA Moscow,972,2,11,4,5,29,20,9,37
Spart Moscow,972,3,9,5,6,37,31,6,32
Krasnodar,972,4,9,5,6,30,26,4,32
Zenit,972,5,7,10,3,24,16,8,31
Terek Grozny,972,6,7,5,8,24,28,-4,26
Din Moscow,972,7,6,6,8,21,24,-3,24
Amkar,972,8,6,4,10,14,25,-11,22
Rostov,972,9,5,6,9,12,17,-5,21
FK Rubin,972,10,5,5,10,22,21,1,20
Anzhi,972,11,3,5,12,18,41,-23,14
Loko Moscow,973,1,11,7,2,29,11,18,40
CSKA Moscow,973,2,11,3,6,27,20,7,36
Zenit,973,3,8,9,3,23,13,10,33
Krasnodar,973,4,9,5,6,29,24,5,32
Terek Grozny,973,5,9,5,6,25,23,2,32
Spart Moscow,973,6,8,7,5,36,31,5,31
Din Moscow,973,7,5,8,7,19,23,-4,23
FK Rubin,973,8,5,6,9,21,19,2,21
Rostov,973,9,4,7,9,11,18,-7,19
Amkar,973,10,5,4,11,13,24,-11,19
Anzhi,973,11,2,5,13,15,42,-27,11
Loko Moscow,974,1,12,6,2,32,12,20,42
CSKA Moscow,974,2,11,3,6,31,21,10,36
Spart Moscow,974,3,9,7,4,38,28,10,34
Zenit,974,4,8,8,4,24,17,7,32
Krasnodar,974,5,8,5,7,27,25,2,29
Terek Grozny,974,6,7,6,7,22,27,-5,27
FK Rubin,974,7,6,6,8,24,19,5,24
Din Moscow,974,8,5,8,7,20,24,-4,23
Rostov,974,9,4,6,10,10,19,-9,18
Amkar,974,10,4,6,10,13,26,-13,18
Anzhi,974,11,3,5,12,19,42,-23,14
Loko Moscow,975,1,11,5,4,29,13,16,38
CSKA Moscow,975,2,11,3,6,28,20,8,36
Spart Moscow,975,3,10,5,5,38,27,11,35
Zenit,975,4,9,8,3,24,13,11,35
Krasnodar,975,5,9,4,7,29,27,2,31
Terek Grozny,975,6,8,5,7,22,24,-2,29
Din Moscow,975,7,7,6,7,20,22,-2,27
FK Rubin,975,8,6,5,9,25,20,5,23
Amkar,975,9,5,4,11,11,24,-13,19
Rostov,975,10,4,6,10,11,20,-9,18
Anzhi,975,11,2,5,13,15,42,-27,11
Loko Moscow,976,1,11,5,4,30,14,16,38
CSKA Moscow,976,2,11,3,6,28,19,9,36
Zenit,976,3,9,8,3,24,14,10,35
Krasnodar,976,4,10,4,6,31,26,5,34
Spart Moscow,976,5,9,6,5,35,27,8,33
Terek Grozny,976,6,9,5,6,24,23,1,32
Din Moscow,976,7,6,7,7,20,23,-3,25
FK Rubin,976,8,5,6,9,23,20,3,21
Rostov,976,9,4,6,10,10,18,-8,18
Amkar,976,10,4,5,11,10,24,-14,17
Anzhi,976,11,2,5,13,14,41,-27,11
Loko Moscow,977,1,12,6,2,32,13,19,42
CSKA Moscow,977,2,11,4,5,29,18,11,37
Spart Moscow,977,3,8,8,4,34,26,8,32
Zenit,977,4,7,10,3,23,15,8,31
Terek Grozny,977,5,8,6,6,22,22,0,30
Krasnodar,977,6,8,5,7,29,27,2,29
Din Moscow,977,7,6,7,7,19,21,-2,25
FK Rubin,977,8,5,6,9,22,20,2,21
Rostov,977,9,4,7,9,10,17,-7,19
Amkar,977,10,4,6,10,10,23,-13,18
Anzhi,977,11,2,5,13,14,42,-28,11
Loko Moscow,978,1,11,7,2,30,12,18,40
Spart Moscow,978,2,11,5,4,38,26,12,38
CSKA Moscow,978,3,11,3,6,28,19,9,36
Zenit,978,4,8,9,3,24,15,9,33
Krasnodar,978,5,8,5,7,27,25,2,29
Terek Grozny,978,6,7,6,7,21,26,-5,27
FK Rubin,978,7,7,5,8,23,17,6,26
Din Moscow,978,8,5,6,9,18,24,-6,21
Amkar,978,9,5,4,11,12,23,-11,19
Rostov,978,10,4,6,10,10,19,-9,18
Anzhi,978,11,2,6,12,15,40,-25,12
Loko Moscow,979,1,11,5,4,31,15,16,38
CSKA Moscow,979,2,11,3,6,27,18,9,36
Zenit,979,3,9,8,3,23,13,10,35
Krasnodar,979,4,9,5,6,30,26,4,32
Spart Moscow,979,5,8,5,7,37,34,3,29
Terek Grozny,979,6,8,5,7,25,26,-1,29
Din Moscow,979,7,7,6,7,21,23,-2,27
Amkar,979,8,6,4,10,15,26,-11,22
FK Rubin,979,9,5,6,9,21,18,3,21
Rostov,979,10,5,6,9,13,17,-4,21
Anzhi,979,11,2,5,13,15,42,-27,11
Loko Moscow,980,1,11,7,2,31,13,18,40
CSKA Moscow,980,2,11,4,5,31,20,11,37
Spart Moscow,980,3,9,7,4,37,28,9,34
Zenit,980,4,7,10,3,23,15,8,31
Krasnodar,980,5,8,6,6,30,27,3,30
Terek Grozny,980,6,7,7,6,22,24,-2,28
FK Rubin,980,7,6,6,8,24,18,6,24
Din Moscow,980,8,5,7,8,18,24,-6,22
Rostov,980,9,4,6,10,11,19,-8,18
Amkar,980,10,4,6,10,11,24,-13,18
Anzhi,980,11,2,6,12,16,42,-26,12
Loko Moscow,981,1,11,5,4,29,16,13,38
CSKA Moscow,981,2,11,3,6,27,18,9,36
Zenit,981,3,9,8,3,24,13,11,35
Krasnodar,981,4,9,4,7,30,28,2,31
Spart Moscow,981,5,8,6,6,36,30,6,30
Terek Grozny,981,6,8,5,7,21,23,-2,29
FK Rubin,981,7,7,5,8,27,17,10,26
Din Moscow,981,8,5,7,8,18,24,-6,22
Amkar,981,9,6,4,10,13,24,-11,22
Rostov,981,10,5,6,9,11,17,-6,21
Anzhi,981,11,2,5,13,14,40,-26,11
Loko Moscow,982,1,13,5,2,31,11,20,44
CSKA Moscow,982,2,12,3,5,29,19,10,39
Spart Moscow,982,3,9,6,5,36,28,8,33
Zenit,982,4,7,8,5,22,16,6,29
Krasnodar,982,5,8,5,7,27,25,2,29
Terek Grozny,982,6,7,6,7,21,25,-4,27
FK Rubin,982,7,5,7,8,21,17,4,22
Din Moscow,982,8,5,7,8,17,23,-6,22
Amkar,982,9,5,5,10,12,23,-11,20
Rostov,982,10,4,7,9,11,18,-7,19
Anzhi,982,11,3,5,12,17,39,-22,14
Loko Moscow,983,1,12,6,2,32,12,20,42
CSKA Moscow,983,2,12,3,5,28,17,11,39
Spart Moscow,983,3,8,8,4,36,28,8,32
Krasnodar,983,4,9,4,7,31,28,3,31
Zenit,983,5,7,9,4,21,15,6,30
Terek Grozny,983,6,8,5,7,21,23,-2,29
Din Moscow,983,7,6,7,7,21,23,-2,25
FK Rubin,983,8,5,5,10,22,22,0,20
Rostov,983,9,4,7,9,10,17,-7,19
Amkar,983,10,4,5,11,10,24,-14,17
Anzhi,983,11,3,5,12,15,38,-23,14
Loko Moscow,984,1,12,5,3,33,14,19,41
Spart Moscow,984,2,9,6,5,34,27,7,33
CSKA Moscow,984,3,10,3,7,25,20,5,33
Zenit,984,4,8,8,4,25,17,8,32
Krasnodar,984,5,9,4,7,29,27,2,31
Terek Grozny,984,6,8,6,6,22,23,-1,30
Din Moscow,984,7,6,7,7,18,21,-3,25
FK Rubin,984,8,6,5,9,24,19,5,23
Rostov,984,9,5,6,9,12,17,-5,21
Amkar,984,10,4,5,11,10,24,-14,17
Anzhi,984,11,3,5,12,15,38,-23,14
Loko Moscow,985,1,11,6,3,29,12,17,39
CSKA Moscow,985,2,12,3,5,30,18,12,39
Zenit,985,3,8,8,4,23,15,8,32
Spart Moscow,985,4,8,7,5,36,29,7,31
Krasnodar,985,5,8,5,7,27,25,2,29
Terek Grozny,985,6,7,7,6,23,25,-2,28
FK Rubin,985,7,7,5,8,24,18,6,26
Din Moscow,985,8,5,7,8,19,24,-5,22
Amkar,985,9,5,5,10,11,23,-12,20
Rostov,985,10,4,7,9,12,19,-7,19
Anzhi,985,11,2,6,12,16,42,-26,12
Loko Moscow,986,1,13,5,2,32,12,20,44
CSKA Moscow,986,2,11,4,5,27,18,9,37
Spart Moscow,986,3,10,6,4,37,27,10,36
Krasnodar,986,4,9,4,7,29,26,3,31
Zenit,986,5,7,8,5,22,16,6,29
Terek Grozny,986,6,7,5,8,20,27,-7,26
Din Moscow,986,7,6,6,8,20,23,-3,24
FK Rubin,986,8,5,5,10,23,22,1,20
Amkar,986,9,5,5,10,12,23,-11,20
Rostov,986,10,4,6,10,11,19,-8,18
Anzhi,986,11,3,6,11,18,38,-20,15
Loko Moscow,987,1,11,7,2,32,14,18,40
Spart Moscow,987,2,9,6,5,38,29,9,33
Zenit,987,3,8,9,3,25,16,9,33
CSKA Moscow,987,4,10,3,7,29,23,6,33
Krasnodar,987,5,9,5,6,31,26,5,32
Terek Grozny,987,6,8,5,7,22,24,-2,29
Din Moscow,987,7,5,7,8,18,26,-8,22
FK Rubin,987,8,5,6,9,22,20,2,21
Rostov,987,9,5,6,9,14,18,-4,21
Amkar,987,10,4,5,11,9,23,-14,17
Anzhi,987,11,4,5,11,19,40,-21,17
Loko Moscow,988,1,11,6,3,30,13,17,39
CSKA Moscow,988,2,11,3,6,28,20,8,36
Zenit,988,3,9,8,3,23,13,10,35
Spart Moscow,988,4,8,6,6,33,29,4,30
Krasnodar,988,5,8,5,7,28,27,1,29
Terek Grozny,988,6,8,5,7,23,25,-2,29
Din Moscow,988,7,7,6,7,20,22,-2,27
FK Rubin,988,8,6,5,9,24,19,5,23
Rostov,988,9,4,7,9,10,17,-7,19
Amkar,988,10,5,4,11,14,25,-11,19
Anzhi,988,11,3,5,12,17,40,-23,14
Loko Moscow,989,1,13,5,2,33,12,21,44
Spart Moscow,989,2,10,6,4,38,26,12,36
CSKA Moscow,989,3,11,3,6,27,19,8,36
Zenit,989,4,8,8,4,23,16,7,32
Krasnodar,989,5,8,5,7,28,26,2,29
Terek Grozny,989,6,7,5,8,22,27,-5,26
Din Moscow,989,7,5,8,7,19,23,-4,23
FK Rubin,989,8,5,7,8,23,19,4,22
Amkar,989,9,5,4,11,11,25,-14,19
Rostov,989,10,4,6,10,10,18,-8,18
Anzhi,989,11,3,5,12,18,41,-23,14
Loko Moscow,990,1,12,5,3,32,14,18,41
Spart Moscow,990,2,10,6,4,39,29,10,36
CSKA Moscow,990,3,11,3,6,28,20,8,36
Zenit,990,4,8,8,4,24,16,8,32
Krasnodar,990,5,9,5,6,28,24,4,32
Terek Grozny,990,6,8,5,7,23,25,-2,29
FK Rubin,990,7,6,6,8,23,18,5,24
Din Moscow,990,8,5,6,9,21,27,-6,21
Rostov,990,9,4,7,9,11,18,-7,19
Amkar,990,10,4,4,12,9,25,-16,16
Anzhi,990,11,3,5,12,19,41,-22,14
Loko Moscow,991,1,12,5,3,32,14,18,41
Spart Moscow,991,2,10,6,4,38,27,11,36
CSKA Moscow,991,3,11,3,6,27,19,8,36
Zenit,991,4,9,8,3,26,14,12,35
Krasnodar,991,5,9,4,7,29,27,2,31
Terek Grozny,991,6,7,5,8,21,25,-4,26
FK Rubin,991,7,6,5,9,23,19,4,23
Din Moscow,991,8,5,7,8,18,23,-5,22
Amkar,991,9,5,4,11,11,25,-14,19
Rostov,991,10,4,6,10,11,19,-8,18
Anzhi,991,11,3,5,12,15,39,-24,14
Loko Moscow,992,1,11,5,4,30,15,15,38
Zenit,992,2,9,8,3,25,14,11,35
CSKA Moscow,992,3,10,3,7,26,22,4,33
Krasnodar,992,4,9,5,6,30,25,5,32
Spart Moscow,992,5,8,7,5,36,29,7,31
Terek Grozny,992,6,7,5,8,22,26,-4,26
FK Rubin,992,7,6,6,8,24,19,5,24
Din Moscow,992,8,5,7,8,19,24,-5,22
Rostov,992,9,5,6,9,12,18,-6,21
Amkar,992,10,5,5,10,11,23,-12,20
Anzhi,992,11,4,5,11,20,40,-20,17
Loko Moscow,993,1,11,5,4,30,15,15,38
Spart Moscow,993,2,10,6,4,36,25,11,36
CSKA Moscow,993,3,10,5,5,25,17,8,35
Zenit,993,4,8,9,3,24,14,10,33
Krasnodar,993,5,9,5,6,29,25,4,32
Terek Grozny,993,6,8,6,6,25,25,0,30
FK Rubin,993,7,5,7,8,24,20,4,22
Din Moscow,993,8,5,7,8,19,24,-5,22
Rostov,993,9,4,7,9,10,17,-7,19
Amkar,993,10,4,5,11,10,25,-15,17
Anzhi,993,11,2,6,12,16,41,-25,12
Loko Moscow,994,1,12,5,3,31,12,19,41
Spart Moscow,994,2,10,5,5,40,32,8,35
CSKA Moscow,994,3,10,4,6,26,19,7,34
Krasnodar,994,4,10,4,6,30,25,5,34
Zenit,994,5,8,8,4,22,15,7,32
Terek Grozny,994,6,8,6,6,23,23,0,30
FK Rubin,994,7,6,5,9,26,19,7,23
Din Moscow,994,8,5,6,9,18,27,-9,21
Amkar,994,9,5,5,10,14,24,-10,20
Rostov,994,10,4,6,10,12,21,-9,18
Anzhi,994,11,2,6,12,15,40,-25,12
Loko Moscow,995,1,11,6,3,31,14,17,39
Spart Moscow,995,2,10,6,4,39,28,11,36
CSKA Moscow,995,3,10,4,6,26,19,7,34
Zenit,995,4,8,9,3,24,15,9,33
Krasnodar,995,5,8,6,6,30,27,3,30
Terek Grozny,995,6,7,5,8,23,27,-4,26
Din Moscow,995,7,6,7,7,20,23,-3,25
FK Rubin,995,8,5,6,9,23,20,3,21
Amkar,995,9,5,4,11,13,26,-13,19
Rostov,995,10,4,6,10,10,19,-9,18
Anzhi,995,11,4,5,11,17,38,-21,17
Loko Moscow,996,1,11,6,3,29,12,17,39
Spart Moscow,996,2,11,5,4,42,28,14,38
CSKA Moscow,996,3,11,3,6,26,19,7,36
Krasnodar,996,4,10,4,6,30,25,5,34
Zenit,996,5,8,9,3,23,13,10,33
Terek Grozny,996,6,9,5,6,23,22,1,32
FK Rubin,996,7,6,5,9,24,20,4,23
Din Moscow,996,8,5,6,9,19,27,-8,21
Rostov,996,9,4,6,10,11,20,-9,18
Amkar,996,10,4,4,12,10,26,-16,16
Anzhi,996,11,2,5,13,14,39,-25,11
CSKA Moscow,997,1,12,3,5,35,18,17,39
Loko Moscow,997,2,11,6,3,30,13,17,39
Spart Moscow,997,3,10,6,4,39,28,11,36
Zenit,997,4,8,8,4,23,16,7,32
Krasnodar,997,5,8,6,6,29,26,3,30
Terek Grozny,997,6,8,5,7,23,25,-2,29
FK Rubin,997,7,5,7,8,22,18,4,22
Din Moscow,997,8,5,7,8,17,23,-6,22
Amkar,997,9,5,5,10,14,25,-11,20
Rostov,997,10,4,6,10,11,19,-8,18
Anzhi,997,11,2,5,13,14,46,-32,11
Loko Moscow,998,1,12,6,2,32,12,20,42
CSKA Moscow,998,2,11,4,5,29,20,9,37
Spart Moscow,998,3,10,6,4,42,27,15,36
Zenit,998,4,7,10,3,25,17,8,31
Krasnodar,998,5,8,5,7,27,26,1,29
Terek Grozny,998,6,8,5,7,22,24,-2,29
FK Rubin,998,7,6,6,8,24,19,5,24
Din Moscow,998,8,5,6,9,19,27,-8,21
Amkar,998,9,5,5,10,12,24,-12,20
Rostov,998,10,4,6,10,11,22,-11,18
Anzhi,998,11,2,5,13,14,39,-25,11
Loko Moscow,999,1,12,5,3,31,12,19,41
CSKA Moscow,999,2,11,3,6,28,21,7,36
Zenit,999,3,9,8,3,26,15,11,35
Spart Moscow,999,4,9,6,5,34,26,8,33
Krasnodar,999,5,9,4,7,29,27,2,31
Terek Grozny,999,6,8,5,7,23,25,-2,29
Din Moscow,999,7,5,8,7,18,22,-4,23
FK Rubin,999,8,5,6,9,23,20,3,21
Amkar,999,9,5,4,11,11,24,-13,19
Rostov,999,10,4,6,10,10,18,-8,18
Anzhi,999,11,3,5,12,16,39,-23,14
Loko Moscow,1000,1,12,6,2,32,13,19,42
Spart Moscow,1000,2,10,6,4,42,27,15,36
CSKA Moscow,1000,3,10,5,5,26,18,8,35
Zenit,1000,4,7,10,3,22,14,8,31
Terek Grozny,1000,5,8,5,7,22,23,-1,29
Krasnodar,1000,6,8,4,8,28,27,1,28
Din Moscow,1000,7,6,6,8,21,23,-2,24
FK Rubin,1000,8,6,5,9,22,21,1,23
Amkar,1000,9,5,5,10,12,24,-12,20
Rostov,1000,10,4,6,10,10,22,-12,18
Anzhi,1000,11,2,6,12,15,40,-25,12
Loko Moscow,1001,1,12,6,2,34,15,19,42
Zenit,1001,2,8,9,3,26,15,11,33
CSKA Moscow,1001,3,10,3,7,27,23,4,33
Spart Moscow,1001,4,8,6,6,35,31,4,30
Krasnodar,1001,5,8,5,7,33,31,2,29
Terek Grozny,1001,6,8,5,7,22,24,-2,29
FK Rubin,1001,7,6,6,8,25,20,5,24
Din Moscow,1001,8,6,6,8,19,22,-3,24
Amkar,1001,9,6,4,10,14,24,-10,22
Rostov,1001,10,4,7,9,10,17,-7,19
Anzhi,1001,11,3,5,12,17,40,-23,14
Loko Moscow,1002,1,13,5,2,34,13,21,44
Spart Moscow,1002,2,9,7,4,35,25,10,34
CSKA Moscow,1002,3,10,4,6,26,21,5,34
Zenit,1002,4,8,8,4,26,16,10,32
Krasnodar,1002,5,8,4,8,28,28,0,28
Terek Grozny,1002,6,7,6,7,22,26,-4,27
FK Rubin,1002,7,6,6,8,23,18,5,24
Din Moscow,1002,8,5,7,8,17,23,-6,22
Amkar,1002,9,5,5,10,12,23,-11,20
Rostov,1002,10,4,7,9,10,17,-7,19
Anzhi,1002,11,2,7,11,16,39,-23,13
Loko Moscow,1003,1,11,6,3,31,14,17,39
Spart Moscow,1003,2,11,5,4,41,27,14,38
Krasnodar,1003,3,10,4,6,32,26,6,34
Zenit,1003,4,8,9,3,24,14,10,33
CSKA Moscow,1003,5,10,3,7,25,22,3,33
Terek Grozny,1003,6,8,5,7,22,23,-1,29
FK Rubin,1003,7,6,5,9,24,21,3,23
Din Moscow,1003,8,5,6,9,20,27,-7,21
Rostov,1003,9,4,6,10,10,19,-9,18
Anzhi,1003,10,4,5,11,18,37,-19,17
Amkar,1003,11,4,4,12,9,26,-17,16
Loko Moscow,1004,1,13,5,2,36,11,25,44
CSKA Moscow,1004,2,12,3,5,30,17,13,39
Spart Moscow,1004,3,9,6,5,36,28,8,33
Terek Grozny,1004,4,9,5,6,23,23,0,32
Krasnodar,1004,5,8,5,7,28,26,2,29
Zenit,1004,6,7,8,5,21,21,0,29
FK Rubin,1004,7,6,6,8,25,18,7,24
Din Moscow,1004,8,6,6,8,19,24,-5,24
Rostov,1004,9,4,6,10,10,19,-9,18
Amkar,1004,10,4,5,11,11,25,-14,17
Anzhi,1004,11,2,5,13,14,41,-27,11
Loko Moscow,1005,1,11,6,3,31,14,17,39
CSKA Moscow,1005,2,10,4,6,26,20,6,34
Zenit,1005,3,8,9,3,24,14,10,33
Spart Moscow,1005,4,9,5,6,39,32,7,32
Krasnodar,1005,5,9,4,7,31,28,3,31
Terek Grozny,1005,6,7,7,6,21,23,-2,28
FK Rubin,1005,7,7,5,8,26,19,7,26
Din Moscow,1005,8,6,6,8,20,25,-5,24
Amkar,1005,9,5,5,10,13,23,-10,20
Rostov,1005,10,4,6,10,10,20,-10,18
Anzhi,1005,11,2,7,11,16,39,-23,13
Loko Moscow,1006,1,13,5,2,32,12,20,44
Spart Moscow,1006,2,11,5,4,39,26,13,38
CSKA Moscow,1006,3,10,4,6,28,21,7,34
Zenit,1006,4,8,8,4,24,16,8,32
Terek Grozny,1006,5,8,5,7,22,25,-3,29
Krasnodar,1006,6,8,4,8,29,28,1,28
FK Rubin,1006,7,6,6,8,24,19,5,24
Din Moscow,1006,8,5,7,8,19,24,-5,22
Amkar,1006,9,5,4,11,12,24,-12,19
Rostov,1006,10,4,6,10,10,19,-9,18
Anzhi,1006,11,2,6,12,15,40,-25,12
Loko Moscow,1007,1,12,6,2,32,12,20,42
CSKA Moscow,1007,2,11,3,6,27,19,8,36
Spart Moscow,1007,3,10,5,5,35,27,8,35
Zenit,1007,4,8,9,3,23,13,10,33
Terek Grozny,1007,5,8,5,7,23,25,-2,29
Krasnodar,1007,6,8,4,8,29,29,0,28
Din Moscow,1007,7,6,6,8,19,22,-3,24
FK Rubin,1007,8,6,5,9,23,20,3,23
Rostov,1007,9,5,6,9,12,17,-5,21
Amkar,1007,10,5,4,11,11,24,-13,19
Anzhi,1007,11,2,5,13,15,41,-26,11
Loko Moscow,1008,1,11,7,2,31,13,18,40
CSKA Moscow,1008,2,11,4,5,28,19,9,37
Spart Moscow,1008,3,10,6,4,36,25,11,36
Zenit,1008,4,7,10,3,21,13,8,31
Krasnodar,1008,5,8,6,6,31,28,3,30
Terek Grozny,1008,6,7,6,7,22,26,-4,27
Din Moscow,1008,7,6,7,7,18,21,-3,25
FK Rubin,1008,8,5,6,9,23,20,3,21
Amkar,1008,9,5,4,11,12,24,-12,19
Rostov,1008,10,4,6,10,10,19,-9,18
Anzhi,1008,11,2,6,12,17,41,-24,12
Loko Moscow,1009,1,11,6,3,30,13,17,39
CSKA Moscow,1009,2,11,4,5,28,19,9,37
Spart Moscow,1009,3,9,6,5,37,28,9,33
Zenit,1009,4,8,9,3,24,15,9,33
Terek Grozny,1009,5,8,6,6,21,22,-1,30
Krasnodar,1009,6,8,5,7,29,27,2,29
Din Moscow,1009,7,6,6,8,20,25,-5,24
FK Rubin,1009,8,6,5,9,24,20,4,23
Amkar,1009,9,5,5,10,11,23,-12,20
Rostov,1009,10,4,7,9,10,17,-7,19
Anzhi,1009,11,2,5,13,14,39,-25,11
Loko Moscow,1010,1,12,5,3,32,15,17,41
CSKA Moscow,1010,2,11,3,6,27,21,6,36
Spart Moscow,1010,3,10,5,5,38,29,9,35
Zenit,1010,4,8,8,4,25,15,10,32
Krasnodar,1010,5,9,4,7,31,27,4,31
Terek Grozny,1010,6,7,6,7,21,24,-3,27
FK Rubin,1010,7,7,5,8,25,18,7,26
Din Moscow,1010,8,5,6,9,19,27,-8,21
Amkar,1010,9,5,5,10,13,24,-11,20
Rostov,1010,10,4,6,10,10,18,-8,18
Anzhi,1010,11,3,5,12,15,38,-23,14
CSKA Moscow,1011,1,12,3,5,29,18,11,39
Loko Moscow,1011,2,11,5,4,30,14,16,38
Spart Moscow,1011,3,9,7,4,38,27,11,34
Krasnodar,1011,4,10,4,6,31,25,6,34
Zenit,1011,5,8,8,4,22,14,8,32
Terek Grozny,1011,6,7,6,7,22,25,-3,27
FK Rubin,1011,7,6,5,9,22,19,3,23
Din Moscow,1011,8,5,6,9,17,25,-8,21
Rostov,1011,9,4,7,9,10,17,-7,19
Amkar,1011,10,4,6,10,12,25,-13,18
Anzhi,1011,11,3,5,12,17,41,-24,14
Loko Moscow,1012,1,12,6,2,32,13,19,42
Spart Moscow,1012,2,11,5,4,42,28,14,38
CSKA Moscow,1012,3,11,3,6,27,19,8,36
Zenit,1012,4,8,9,3,24,15,9,33
Terek Grozny,1012,5,8,6,6,24,25,-1,30
Krasnodar,1012,6,8,4,8,29,29,0,28
FK Rubin,1012,7,7,5,8,29,19,10,26
Din Moscow,1012,8,5,6,9,20,31,-11,21
Rostov,1012,9,4,6,10,10,19,-9,18
Amkar,1012,10,4,4,12,11,26,-15,16
Anzhi,1012,11,2,6,12,16,40,-24,12
Loko Moscow,1013,1,13,5,2,34,12,22,44
Spart Moscow,1013,2,10,5,5,36,26,10,35
CSKA Moscow,1013,3,10,3,7,27,24,3,33
Zenit,1013,4,8,8,4,24,16,8,32
Terek Grozny,1013,5,8,6,6,21,22,-1,30
Krasnodar,1013,6,8,5,7,29,27,2,29
FK Rubin,1013,7,6,6,8,26,20,6,24
Rostov,1013,8,5,6,9,11,17,-6,21
Din Moscow,1013,9,5,6,9,19,27,-8,21
Amkar,1013,10,4,4,12,9,24,-15,16
Anzhi,1013,11,3,6,11,18,39,-21,15
Loko Moscow,1014,1,12,5,3,31,13,18,41
CSKA Moscow,1014,2,11,3,6,27,18,9,36
Spart Moscow,1014,3,10,5,5,44,30,14,35
Zenit,1014,4,9,8,3,23,13,10,35
Terek Grozny,1014,5,9,5,6,22,22,0,32
Krasnodar,1014,6,9,4,7,29,26,3,31
Din Moscow,1014,7,6,6,8,22,26,-4,24
FK Rubin,1014,8,5,5,10,21,21,0,20
Amkar,1014,9,5,4,11,11,24,-13,19
Rostov,1014,10,4,6,10,11,22,-11,18
Anzhi,1014,11,2,5,13,14,40,-26,11
Loko Moscow,1015,1,12,5,3,31,13,18,41
CSKA Moscow,1015,2,11,3,6,28,22,6,36
Zenit,1015,3,9,8,3,25,13,12,35
Spart Moscow,1015,4,9,7,4,40,29,11,34
Krasnodar,1015,5,8,4,8,28,27,1,28
Terek Grozny,1015,6,7,6,7,20,23,-3,27
FK Rubin,1015,7,6,6,8,22,17,5,24
Din Moscow,1015,8,5,8,7,18,22,-4,23
Rostov,1015,9,4,6,10,11,21,-10,18
Amkar,1015,10,4,6,10,11,24,-13,18
Anzhi,1015,11,3,5,12,17,40,-23,14
Loko Moscow,1016,1,12,6,2,32,12,20,42
CSKA Moscow,1016,2,11,4,5,30,21,9,37
Spart Moscow,1016,3,9,6,5,34,27,7,33
Krasnodar,1016,4,8,6,6,29,26,3,30
Zenit,1016,5,7,8,5,21,16,5,29
Terek Grozny,1016,6,8,5,7,21,24,-3,29
Din Moscow,1016,7,6,7,7,18,21,-3,25
FK Rubin,1016,8,5,6,9,22,19,3,21
Rostov,1016,9,5,6,9,12,17,-5,21
Amkar,1016,10,4,4,12,9,24,-15,16
Anzhi,1016,11,3,6,11,20,41,-21,15
Loko Moscow,1017,1,12,6,2,32,13,19,42
CSKA Moscow,1017,2,11,4,5,26,17,9,37
Spart Moscow,1017,3,9,5,6,35,29,6,32
Zenit,1017,4,7,9,4,21,14,7,30
Krasnodar,1017,5,8,6,6,29,26,3,30
Terek Grozny,1017,6,8,6,6,24,23,1,30
FK Rubin,1017,7,6,6,8,22,17,5,24
Rostov,1017,8,5,6,9,12,17,-5,21
Din Moscow,1017,9,5,6,9,17,23,-6,21
Amkar,1017,10,5,4,11,11,26,-15,19
Anzhi,1017,11,2,6,12,15,39,-24,12
Loko Moscow,1018,1,12,6,2,32,13,19,42
Spart Moscow,1018,2,10,5,5,38,29,9,35
CSKA Moscow,1018,3,10,4,6,27,20,7,34
Zenit,1018,4,7,10,3,25,17,8,31
Terek Grozny,1018,5,8,6,6,23,24,-1,30
Krasnodar,1018,6,8,4,8,27,26,1,28
Din Moscow,1018,7,6,6,8,20,24,-4,24
FK Rubin,1018,8,6,5,9,23,19,4,23
Amkar,1018,9,5,5,10,12,24,-12,20
Rostov,1018,10,4,6,10,10,18,-8,18
Anzhi,1018,11,3,5,12,17,40,-23,14
Loko Moscow,1019,1,12,6,2,31,12,19,42
CSKA Moscow,1019,2,11,4,5,29,17,12,37
Zenit,1019,3,7,10,3,22,14,8,31
Spart Moscow,1019,4,8,7,5,36,29,7,31
Krasnodar,1019,5,8,5,7,28,26,2,29
Terek Grozny,1019,6,7,6,7,23,27,-4,27
Din Moscow,1019,7,6,7,7,21,24,-3,25
FK Rubin,1019,8,5,7,8,23,19,4,22
Rostov,1019,9,4,7,9,10,17,-7,19
Amkar,1019,10,4,6,10,10,23,-13,18
Anzhi,1019,11,3,5,12,19,44,-25,14
Loko Moscow,1020,1,12,6,2,32,13,19,42
CSKA Moscow,1020,2,10,5,5,27,19,8,35
Spart Moscow,1020,3,9,7,4,38,28,10,34
Zenit,1020,4,7,9,4,24,17,7,30
Krasnodar,1020,5,8,5,7,30,28,2,29
Terek Grozny,1020,6,7,6,7,21,24,-3,27
FK Rubin,1020,7,6,6,8,24,19,5,24
Din Moscow,1020,8,5,7,8,18,24,-6,22
Amkar,1020,9,5,5,10,11,23,-12,20
Rostov,1020,10,4,7,9,11,18,-7,19
Anzhi,1020,11,2,7,11,15,38,-23,13
Loko Moscow,1021,1,11,6,3,31,14,17,39
CSKA Moscow,1021,2,11,3,6,29,20,9,36
Zenit,1021,3,9,8,3,26,16,10,35
Spart Moscow,1021,4,10,5,5,38,31,7,35
Krasnodar,1021,5,8,5,7,29,28,1,29
Terek Grozny,1021,6,7,6,7,21,24,-3,27
Din Moscow,1021,7,6,6,8,18,24,-6,24
FK Rubin,1021,8,6,5,9,24,19,5,23
Amkar,1021,9,5,5,10,15,23,-8,20
Rostov,1021,10,4,6,10,10,18,-8,18
Anzhi,1021,11,3,5,12,16,40,-24,14
Loko Moscow,1022,1,13,5,2,34,14,20,44
CSKA Moscow,1022,2,12,3,5,31,17,14,39
Terek Grozny,1022,3,9,5,6,23,22,1,32
Spart Moscow,1022,4,8,6,6,35,29,6,30
Zenit,1022,5,7,8,5,24,18,6,29
Krasnodar,1022,6,8,4,8,27,26,1,28
Din Moscow,1022,7,6,7,7,19,22,-3,25
FK Rubin,1022,8,6,6,8,22,17,5,24
Rostov,1022,9,4,7,9,11,18,-7,19
Amkar,1022,10,5,4,11,10,23,-13,19
Anzhi,1022,11,2,5,13,14,44,-30,11
Loko Moscow,1023,1,11,5,4,29,14,15,38
Spart Moscow,1023,2,11,5,4,37,26,11,38
CSKA Moscow,1023,3,11,3,6,31,21,10,36
Zenit,1023,4,9,8,3,24,14,10,35
Krasnodar,1023,5,10,4,6,32,25,7,34
Terek Grozny,1023,6,9,5,6,23,22,1,32
FK Rubin,1023,7,6,5,9,25,22,3,23
Din Moscow,1023,8,5,6,9,19,25,-6,21
Rostov,1023,9,4,6,10,10,18,-8,18
Amkar,1023,10,4,4,12,10,26,-16,16
Anzhi,1023,11,2,5,13,16,43,-27,11
Loko Moscow,1024,1,12,5,3,34,16,18,41
CSKA Moscow,1024,2,12,3,5,30,20,10,39
Spart Moscow,1024,3,9,6,5,35,28,7,33
Krasnodar,1024,4,9,4,7,31,26,5,31
Zenit,1024,5,7,8,5,25,21,4,29
Terek Grozny,1024,6,8,5,7,23,25,-2,29
Din Moscow,1024,7,7,6,7,22,22,0,27
FK Rubin,1024,8,6,5,9,24,21,3,23
Rostov,1024,9,4,7,9,10,17,-7,19
Amkar,1024,10,5,4,11,11,24,-13,19
Anzhi,1024,11,2,5,13,17,42,-25,11
Loko Moscow,1025,1,12,5,3,30,12,18,41
CSKA Moscow,1025,2,12,3,5,28,17,11,39
Krasnodar,1025,3,10,4,6,31,24,7,34
Spart Moscow,1025,4,9,5,6,39,32,7,32
Zenit,1025,5,7,8,5,21,15,6,29
Terek Grozny,1025,6,7,6,7,21,24,-3,27
Din Moscow,1025,7,6,6,8,20,23,-3,24
Amkar,1025,8,6,4,10,16,27,-11,22
Rostov,1025,9,5,6,9,12,17,-5,21
FK Rubin,1025,10,5,5,10,21,23,-2,20
Anzhi,1025,11,2,6,12,14,39,-25,12
Loko Moscow,1026,1,12,5,3,33,14,19,41
Spart Moscow,1026,2,10,5,5,36,27,9,35
CSKA Moscow,1026,3,10,5,5,27,19,8,35
Terek Grozny,1026,4,9,5,6,25,23,2,32
Krasnodar,1026,5,9,4,7,31,28,3,31
Zenit,1026,6,7,9,4,22,16,6,30
Din Moscow,1026,7,6,6,8,18,22,-4,24
FK Rubin,1026,8,6,5,9,23,19,4,23
Amkar,1026,9,5,4,11,12,26,-14,19
Rostov,1026,10,4,6,10,10,18,-8,18
Anzhi,1026,11,2,6,12,15,40,-25,12
Loko Moscow,1027,1,11,7,2,29,11,18,40
CSKA Moscow,1027,2,11,4,5,29,17,12,37
Spart Moscow,1027,3,10,5,5,36,27,9,35
Krasnodar,1027,4,9,5,6,28,24,4,32
Zenit,1027,5,7,10,3,21,13,8,31
Terek Grozny,1027,6,7,6,7,21,24,-3,27
Din Moscow,1027,7,6,6,8,22,24,-2,24
FK Rubin,1027,8,5,5,10,22,22,0,20
Amkar,1027,9,5,5,10,11,23,-12,20
Rostov,1027,10,4,6,10,10,18,-8,18
Anzhi,1027,11,3,5,12,15,41,-26,14
Loko Moscow,1028,1,13,5,2,35,15,20,44
CSKA Moscow,1028,2,11,4,5,28,19,9,37
Spart Moscow,1028,3,10,6,4,40,28,12,36
Zenit,1028,4,7,9,4,24,17,7,30
Krasnodar,1028,5,8,4,8,31,32,-1,28
Terek Grozny,1028,6,7,5,8,20,25,-5,26
Din Moscow,1028,7,6,6,8,20,24,-4,24
FK Rubin,1028,8,6,5,9,25,20,5,23
Amkar,1028,9,5,5,10,11,23,-12,20
Rostov,1028,10,4,6,10,11,20,-9,18
Anzhi,1028,11,3,5,12,16,38,-22,14
Loko Moscow,1029,1,12,6,2,34,15,19,42
CSKA Moscow,1029,2,11,3,6,31,20,11,36
Spart Moscow,1029,3,9,7,4,36,27,9,34
Zenit,1029,4,8,9,3,26,17,9,33
Krasnodar,1029,5,8,5,7,30,28,2,29
Terek Grozny,1029,6,7,6,7,22,25,-3,27
FK Rubin,1029,7,6,6,8,23,18,5,24
Din Moscow,1029,8,5,6,9,19,25,-6,21
Amkar,1029,9,5,5,10,12,24,-12,20
Rostov,1029,10,4,7,9,10,17,-7,19
Anzhi,1029,11,2,6,12,14,41,-27,12
Loko Moscow,1030,1,12,6,2,33,13,20,42
CSKA Moscow,1030,2,10,4,6,25,20,5,34
Zenit,1030,3,8,9,3,25,14,11,33
Spart Moscow,1030,4,8,8,4,34,26,8,32
Terek Grozny,1030,5,8,6,6,22,22,0,30
Krasnodar,1030,6,8,4,8,28,29,-1,28
FK Rubin,1030,7,6,6,8,24,18,6,24
Din Moscow,1030,8,5,8,7,19,23,-4,23
Rostov,1030,9,4,7,9,10,17,-7,19
Amkar,1030,10,4,5,11,9,24,-15,17
Anzhi,1030,11,2,7,11,14,37,-23,13
Loko Moscow,1031,1,11,7,2,30,12,18,40
Zenit,1031,2,8,9,3,25,15,10,33
Spart Moscow,1031,3,9,6,5,37,29,8,33
CSKA Moscow,1031,4,10,3,7,26,21,5,33
Krasnodar,1031,5,8,6,6,27,24,3,30
Terek Grozny,1031,6,8,5,7,22,23,-1,29
Din Moscow,1031,7,7,6,7,20,22,-2,27
FK Rubin,1031,8,5,6,9,21,18,3,21
Rostov,1031,9,4,7,9,11,18,-7,19
Amkar,1031,10,5,4,11,11,24,-13,19
Anzhi,1031,11,3,5,12,15,39,-24,14
Loko Moscow,1032,1,11,6,3,30,15,15,39
CSKA Moscow,1032,2,12,3,5,29,17,12,39
Krasnodar,1032,3,10,4,6,32,25,7,34
Spart Moscow,1032,4,9,5,6,36,30,6,32
Zenit,1032,5,7,9,4,21,14,7,30
Terek Grozny,1032,6,7,5,8,22,27,-5,26
Din Moscow,1032,7,6,6,8,20,25,-5,24
Amkar,1032,8,6,4,10,16,24,-8,22
Rostov,1032,9,5,6,9,11,17,-6,21
FK Rubin,1032,10,5,5,10,22,20,2,20
Anzhi,1032,11,3,5,12,15,40,-25,14
Loko Moscow,1033,1,11,6,3,32,18,14,39
Spart Moscow,1033,2,10,6,4,40,26,14,36
CSKA Moscow,1033,3,10,5,5,27,19,8,35
Zenit,1033,4,7,10,3,23,15,8,31
Krasnodar,1033,5,9,4,7,34,28,6,31
Terek Grozny,1033,6,8,5,7,22,24,-2,29
FK Rubin,1033,7,6,6,8,24,19,5,24
Din Moscow,1033,8,5,7,8,18,26,-8,22
Rostov,1033,9,4,7,9,10,17,-7,19
Amkar,1033,10,4,4,12,10,26,-16,16
Anzhi,1033,11,3,6,11,17,39,-22,15
CSKA Moscow,1034,1,12,3,5,28,17,11,39
Loko Moscow,1034,2,11,5,4,31,16,15,38
Krasnodar,1034,3,10,4,6,32,26,6,34
Zenit,1034,4,8,8,4,23,15,8,32
Spart Moscow,1034,5,8,6,6,34,29,5,30
Terek Grozny,1034,6,7,7,6,25,27,-2,28
Din Moscow,1034,7,6,7,7,21,24,-3,25
FK Rubin,1034,8,5,6,9,25,22,3,21
Rostov,1034,9,5,6,9,12,17,-5,21
Amkar,1034,10,4,6,10,13,26,-13,18
Anzhi,1034,11,2,6,12,16,41,-25,12
Loko Moscow,1035,1,12,6,2,33,13,20,42
CSKA Moscow,1035,2,11,3,6,26,18,8,36
Spart Moscow,1035,3,9,6,5,41,30,11,33
Zenit,1035,4,8,8,4,23,16,7,32
Krasnodar,1035,5,9,5,6,31,27,4,32
Terek Grozny,1035,6,9,5,6,24,23,1,32
Din Moscow,1035,7,6,6,8,18,26,-8,24
FK Rubin,1035,8,5,5,10,23,21,2,20
Rostov,1035,9,4,7,9,12,19,-7,19
Amkar,1035,10,5,4,11,13,25,-12,19
Anzhi,1035,11,2,5,13,14,40,-26,11
Loko Moscow,1036,1,11,6,3,30,15,15,39
CSKA Moscow,1036,2,12,3,5,30,18,12,39
Spart Moscow,1036,3,9,6,5,36,29,7,33
Krasnodar,1036,4,9,5,6,32,26,6,32
Terek Grozny,1036,5,9,5,6,23,22,1,32
Zenit,1036,6,7,9,4,23,16,7,30
Din Moscow,1036,7,6,7,7,20,22,-2,25
FK Rubin,1036,8,5,7,8,23,19,4,22
Rostov,1036,9,4,7,9,11,18,-7,19
Amkar,1036,10,4,4,12,9,24,-15,16
Anzhi,1036,11,2,5,13,14,42,-28,11
Loko Moscow,1037,1,11,5,4,30,14,16,38
CSKA Moscow,1037,2,11,3,6,27,19,8,36
Zenit,1037,3,9,8,3,23,13,10,35
Spart Moscow,1037,4,9,6,5,35,26,9,33
Krasnodar,1037,5,9,4,7,29,26,3,31
FK Rubin,1037,6,7,5,8,24,18,6,26
Terek Grozny,1037,7,7,5,8,20,26,-6,26
Din Moscow,1037,8,5,7,8,18,23,-5,22
Amkar,1037,9,6,4,10,12,22,-10,22
Rostov,1037,10,4,6,10,10,19,-9,18
Anzhi,1037,11,3,5,12,17,39,-22,14
Loko Moscow,1038,1,12,5,3,30,12,18,41
CSKA Moscow,1038,2,11,3,6,26,18,8,36
Krasnodar,1038,3,10,4,6,30,24,6,34
Spart Moscow,1038,4,9,6,5,35,28,7,33
Zenit,1038,5,8,8,4,22,14,8,32
Terek Grozny,1038,6,8,5,7,23,25,-2,29
Din Moscow,1038,7,7,6,7,21,22,-1,27
FK Rubin,1038,8,5,5,10,21,20,1,20
Amkar,1038,9,5,5,10,11,23,-12,20
Rostov,1038,10,4,6,10,10,18,-8,18
Anzhi,1038,11,2,5,13,15,40,-25,11
Loko Moscow,1039,1,11,6,3,30,14,16,39
CSKA Moscow,1039,2,12,3,5,28,17,11,39
Spart Moscow,1039,3,10,6,4,39,26,13,36
Krasnodar,1039,4,10,4,6,30,24,6,34
Zenit,1039,5,7,9,4,22,16,6,30
Terek Grozny,1039,6,8,6,6,23,24,-1,30
Din Moscow,1039,7,6,7,7,19,21,-2,25
FK Rubin,1039,8,5,5,10,21,20,1,20
Rostov,1039,9,4,6,10,11,21,-10,18
Amkar,1039,10,4,5,11,10,25,-15,17
Anzhi,1039,11,2,5,13,15,40,-25,11
CSKA Moscow,1040,1,12,3,5,31,18,13,39
Loko Moscow,1040,2,11,5,4,33,17,16,38
Krasnodar,1040,3,10,4,6,34,29,5,34
Spart Moscow,1040,4,9,6,5,36,28,8,33
Zenit,1040,5,8,8,4,25,18,7,32
Terek Grozny,1040,6,8,5,7,23,27,-4,29
Din Moscow,1040,7,5,8,7,18,22,-4,23
Amkar,1040,8,6,4,10,15,23,-8,22
FK Rubin,1040,9,5,6,9,24,21,3,21
Rostov,1040,10,4,6,10,10,18,-8,18
Anzhi,1040,11,2,5,13,15,43,-28,11
Loko Moscow,1041,1,12,6,2,30,11,19,42
CSKA Moscow,1041,2,11,4,5,29,18,11,37
Spart Moscow,1041,3,10,6,4,37,26,11,36
Zenit,1041,4,7,10,3,22,14,8,31
Terek Grozny,1041,5,8,6,6,23,23,0,30
Krasnodar,1041,6,8,4,8,27,27,0,28
FK Rubin,1041,7,7,5,8,25,18,7,26
Din Moscow,1041,8,5,7,8,19,24,-5,22
Rostov,1041,9,4,6,10,10,18,-8,18
Amkar,1041,10,4,5,11,9,24,-15,17
Anzhi,1041,11,2,5,13,15,43,-28,11
Loko Moscow,1042,1,11,6,3,29,12,17,39
CSKA Moscow,1042,2,11,4,5,27,17,10,37
Spart Moscow,1042,3,9,6,5,37,31,6,33
Krasnodar,1042,4,9,5,6,29,25,4,32
Zenit,1042,5,7,10,3,21,13,8,31
Terek Grozny,1042,6,7,6,7,20,24,-4,27
FK Rubin,1042,7,6,6,8,23,18,5,24
Din Moscow,1042,8,6,6,8,22,23,-1,24
Rostov,1042,9,4,6,10,11,20,-9,18
Amkar,1042,10,4,6,10,9,22,-13,18
Anzhi,1042,11,3,5,12,16,39,-23,14
Loko Moscow,1043,1,11,6,3,30,13,17,39
CSKA Moscow,1043,2,11,4,5,27,17,10,37
Zenit,1043,3,7,10,3,22,14,8,31
Krasnodar,1043,4,9,4,7,28,25,3,31
Terek Grozny,1043,5,8,6,6,22,23,-1,30
Spart Moscow,1043,6,8,5,7,33,30,3,29
Din Moscow,1043,7,6,7,7,19,22,-3,25
FK Rubin,1043,8,6,6,8,23,18,5,24
Rostov,1043,9,5,6,9,12,17,-5,21
Amkar,1043,10,5,4,11,11,23,-12,19
Anzhi,1043,11,2,6,12,15,40,-25,12
Loko Moscow,1044,1,11,6,3,31,14,17,39
CSKA Moscow,1044,2,11,4,5,29,18,11,37
Krasnodar,1044,3,10,4,6,31,26,5,34
Spart Moscow,1044,4,9,5,6,36,31,5,32
Terek Grozny,1044,5,9,5,6,22,22,0,32
Zenit,1044,6,7,9,4,22,17,5,30
Din Moscow,1044,7,6,7,7,18,21,-3,25
FK Rubin,1044,8,5,6,9,22,19,3,21
Amkar,1044,9,5,4,11,12,23,-11,19
Rostov,1044,10,4,6,10,12,20,-8,18
Anzhi,1044,11,2,6,12,15,39,-24,12
Loko Moscow,1045,1,12,6,2,33,12,21,42
Spart Moscow,1045,2,10,6,4,37,26,11,36
CSKA Moscow,1045,3,10,3,7,26,21,5,33
Zenit,1045,4,8,8,4,25,18,7,32
Krasnodar,1045,5,8,6,6,28,25,3,30
Terek Grozny,1045,6,7,6,7,21,27,-6,27
FK Rubin,1045,7,6,6,8,24,18,6,24
Din Moscow,1045,8,5,6,9,18,25,-7,21
Rostov,1045,9,4,7,9,10,17,-7,19
Amkar,1045,10,4,5,11,10,25,-15,17
Anzhi,1045,11,4,5,11,19,37,-18,17
Loko Moscow,1046,1,11,6,3,31,17,14,39
Spart Moscow,1046,2,10,6,4,40,30,10,36
CSKA Moscow,1046,3,11,3,6,29,20,9,36
Krasnodar,1046,4,10,4,6,32,24,8,34
Zenit,1046,5,8,9,3,25,16,9,33
Terek Grozny,1046,6,8,5,7,25,25,0,29
Din Moscow,1046,7,5,7,8,20,25,-5,22
FK Rubin,1046,8,5,6,9,22,19,3,21
Rostov,1046,9,4,7,9,11,18,-7,19
Amkar,1046,10,5,4,11,14,27,-13,19
Anzhi,1046,11,2,5,13,15,43,-28,11
Loko Moscow,1047,1,11,6,3,32,15,17,39
CSKA Moscow,1047,2,11,3,6,26,18,8,36
Spart Moscow,1047,3,10,5,5,39,28,11,35
Krasnodar,1047,4,10,4,6,33,26,7,34
Zenit,1047,5,8,9,3,24,15,9,33
Terek Grozny,1047,6,7,6,7,22,25,-3,27
FK Rubin,1047,7,6,5,9,23,21,2,23
Din Moscow,1047,8,5,6,9,18,26,-8,21
Amkar,1047,9,5,5,10,12,24,-12,20
Rostov,1047,10,4,6,10,11,19,-8,18
Anzhi,1047,11,3,5,12,15,38,-23,14
Loko Moscow,1048,1,11,6,3,29,12,17,39
CSKA Moscow,1048,2,11,3,6,29,20,9,36
Zenit,1048,3,9,8,3,24,14,10,35
Krasnodar,1048,4,9,5,6,29,24,5,32
Spart Moscow,1048,5,8,6,6,36,31,5,30
Terek Grozny,1048,6,8,5,7,23,24,-1,29
FK Rubin,1048,7,6,5,9,22,19,3,23
Din Moscow,1048,8,5,7,8,18,23,-5,22
Amkar,1048,9,6,4,10,13,23,-10,22
Rostov,1048,10,5,6,9,12,18,-6,21
Anzhi,1048,11,2,5,13,16,43,-27,11
Loko Moscow,1049,1,11,7,2,31,13,18,40
Spart Moscow,1049,2,11,5,4,36,25,11,38
CSKA Moscow,1049,3,11,3,6,31,22,9,36
Zenit,1049,4,8,9,3,25,14,11,33
Krasnodar,1049,5,8,5,7,30,29,1,29
Terek Grozny,1049,6,7,7,6,22,24,-2,28
FK Rubin,1049,7,6,6,8,24,18,6,24
Din Moscow,1049,8,5,7,8,17,22,-5,22
Rostov,1049,9,4,6,10,10,18,-8,18
Amkar,1049,10,4,5,11,10,24,-14,17
Anzhi,1049,11,2,6,12,16,43,-27,12
Loko Moscow,1050,1,13,5,2,33,12,21,44
Spart Moscow,1050,2,11,5,4,39,26,13,38
CSKA Moscow,1050,3,11,4,5,26,17,9,37
Terek Grozny,1050,4,9,5,6,25,22,3,32
Krasnodar,1050,5,9,4,7,29,27,2,31
Zenit,1050,6,7,9,4,22,15,7,30
Din Moscow,1050,7,5,7,8,17,22,-5,22
FK Rubin,1050,8,5,6,9,22,19,3,21
Rostov,1050,9,4,6,10,11,20,-9,18
Amkar,1050,10,4,4,12,9,27,-18,16
Anzhi,1050,11,2,5,13,14,40,-26,11
Loko Moscow,1051,1,11,6,3,32,15,17,39
CSKA Moscow,1051,2,11,4,5,28,19,9,37
Spart Moscow,1051,3,10,5,5,35,26,9,35
Krasnodar,1051,4,10,4,6,31,26,5,34
Zenit,1051,5,7,9,4,23,16,7,30
Terek Grozny,1051,6,8,6,6,23,24,-1,30
Din Moscow,1051,7,6,7,7,18,21,-3,25
FK Rubin,1051,8,5,6,9,21,18,3,21
Rostov,1051,9,4,6,10,10,18,-8,18
Amkar,1051,10,4,4,12,10,25,-15,16
Anzhi,1051,11,2,7,11,16,39,-23,13
Loko Moscow,1052,1,13,5,2,32,12,20,44
CSKA Moscow,1052,2,11,3,6,27,20,7,36
Spart Moscow,1052,3,10,5,5,37,29,8,35
Zenit,1052,4,8,8,4,23,14,9,32
Terek Grozny,1052,5,8,6,6,23,24,-1,30
Krasnodar,1052,6,8,5,7,29,27,2,29
FK Rubin,1052,7,6,6,8,23,18,5,24
Rostov,1052,8,5,6,9,12,17,-5,21
Din Moscow,1052,9,5,6,9,19,25,-6,21
Amkar,1052,10,4,5,11,9,23,-14,17
Anzhi,1052,11,2,5,13,17,42,-25,11
Loko Moscow,1053,1,13,5,2,34,12,22,44
CSKA Moscow,1053,2,11,3,6,29,19,10,36
Spart Moscow,1053,3,9,6,5,35,28,7,33
Zenit,1053,4,8,8,4,24,17,7,32
Krasnodar,1053,5,8,4,8,27,27,0,28
Terek Grozny,1053,6,7,6,7,20,23,-3,27
FK Rubin,1053,7,6,6,8,25,20,5,24
Din Moscow,1053,8,5,8,7,21,25,-4,23
Amkar,1053,9,6,4,10,12,22,-10,22
Rostov,1053,10,4,6,10,10,18,-8,18
Anzhi,1053,11,2,6,12,14,40,-26,12
Loko Moscow,1054,1,11,6,3,32,15,17,39
CSKA Moscow,1054,2,11,4,5,27,17,10,37
Spart Moscow,1054,3,9,6,5,40,30,10,33
Zenit,1054,4,8,9,3,23,14,9,33
Terek Grozny,1054,5,9,5,6,23,22,1,32
Krasnodar,1054,6,8,6,6,30,27,3,30
FK Rubin,1054,7,6,6,8,23,18,5,24
Din Moscow,1054,8,5,7,8,19,24,-5,22
Amkar,1054,9,5,4,11,12,25,-13,19
Rostov,1054,10,4,6,10,10,20,-10,18
Anzhi,1054,11,2,5,13,14,41,-27,11
Loko Moscow,1055,1,12,5,3,33,16,17,41
CSKA Moscow,1055,2,12,3,5,29,17,12,39
Spart Moscow,1055,3,10,5,5,41,28,13,35
Krasnodar,1055,4,10,4,6,33,27,6,34
Terek Grozny,1055,5,8,6,6,21,22,-1,30
Zenit,1055,6,7,8,5,23,17,6,29
Din Moscow,1055,7,7,6,7,21,23,-2,27
FK Rubin,1055,8,5,5,10,24,22,2,20
Rostov,1055,9,4,6,10,11,22,-11,18
Amkar,1055,10,4,5,11,9,24,-15,17
Anzhi,1055,11,2,5,13,14,41,-27,11
Loko Moscow,1056,1,12,6,2,33,14,19,42
CSKA Moscow,1056,2,12,3,5,30,17,13,39
Spart Moscow,1056,3,11,5,4,40,26,14,38
Krasnodar,1056,4,9,4,7,33,28,5,31
Zenit,1056,5,7,9,4,22,16,6,30
Terek Grozny,1056,6,7,6,7,22,25,-3,27
Din Moscow,1056,7,5,7,8,18,23,-5,22
FK Rubin,1056,8,5,6,9,22,21,1,21
Amkar,1056,9,5,4,11,11,25,-14,19
Rostov,1056,10,4,6,10,10,20,-10,18
Anzhi,1056,11,2,6,12,15,41,-26,12
Loko Moscow,1057,1,13,5,2,33,11,22,44
CSKA Moscow,1057,2,11,3,6,29,22,7,36
Spart Moscow,1057,3,9,6,5,36,28,8,33
Zenit,1057,4,8,8,4,25,17,8,32
Terek Grozny,1057,5,8,6,6,21,22,-1,30
Krasnodar,1057,6,8,5,7,27,25,2,29
FK Rubin,1057,7,5,7,8,22,18,4,22
Din Moscow,1057,8,5,7,8,19,24,-5,22
Rostov,1057,9,4,7,9,11,18,-7,19
Amkar,1057,10,5,4,11,10,23,-13,19
Anzhi,1057,11,2,6,12,15,40,-25,12
Loko Moscow,1058,1,12,5,3,30,12,18,41
CSKA Moscow,1058,2,10,4,6,25,18,7,34
Zenit,1058,3,8,8,4,22,14,8,32
Krasnodar,1058,4,9,4,7,29,26,3,31
Spart Moscow,1058,5,8,6,6,35,30,5,30
Terek Grozny,1058,6,8,5,7,22,25,-3,29
Din Moscow,1058,7,6,7,7,21,24,-3,25
FK Rubin,1058,8,6,6,8,25,20,5,24
Rostov,1058,9,4,7,9,11,18,-7,19
Amkar,1058,10,5,4,11,12,24,-12,19
Anzhi,1058,11,3,6,11,16,37,-21,15
Loko Moscow,1059,1,12,5,3,32,12,20,41
CSKA Moscow,1059,2,11,3,6,27,19,8,36
Spart Moscow,1059,3,10,5,5,36,27,9,35
Zenit,1059,4,8,8,4,23,17,6,32
Krasnodar,1059,5,9,5,6,28,24,4,32
Terek Grozny,1059,6,8,5,7,23,24,-1,29
FK Rubin,1059,7,5,7,8,22,18,4,22
Din Moscow,1059,8,5,7,8,18,23,-5,22
Amkar,1059,9,6,4,10,13,23,-10,22
Rostov,1059,10,4,6,10,10,18,-8,18
Anzhi,1059,11,2,5,13,14,41,-27,11
Loko Moscow,1060,1,11,7,2,29,11,18,40
CSKA Moscow,1060,2,11,4,5,29,18,11,37
Spart Moscow,1060,3,10,5,5,35,26,9,35
Zenit,1060,4,7,10,3,22,14,8,31
Krasnodar,1060,5,8,6,6,28,25,3,30
Terek Grozny,1060,6,8,5,7,22,25,-3,29
FK Rubin,1060,7,6,6,8,23,18,5,24
Din Moscow,1060,8,5,6,9,17,23,-6,21
Rostov,1060,9,5,6,9,11,17,-6,21
Amkar,1060,10,4,4,12,10,25,-15,16
Anzhi,1060,11,3,5,12,16,40,-24,14
Loko Moscow,1061,1,12,5,3,32,14,18,41
CSKA Moscow,1061,2,11,4,5,29,18,11,37
Spart Moscow,1061,3,10,5,5,37,28,9,35
Krasnodar,1061,4,9,5,6,32,26,6,32
Zenit,1061,5,7,9,4,21,16,5,30
Terek Grozny,1061,6,7,5,8,20,25,-5,26
FK Rubin,1061,7,6,6,8,24,19,5,24
Amkar,1061,8,6,4,10,14,23,-9,22
Din Moscow,1061,9,5,6,9,17,24,-7,21
Rostov,1061,10,4,6,10,10,18,-8,18
Anzhi,1061,11,3,5,12,16,41,-25,14
Loko Moscow,1062,1,12,5,3,33,14,19,41
CSKA Moscow,1062,2,11,4,5,30,20,10,37
Spart Moscow,1062,3,10,5,5,40,31,9,35
Krasnodar,1062,4,9,4,7,29,26,3,31
Zenit,1062,5,7,8,5,23,19,4,29
Terek Grozny,1062,6,7,6,7,20,23,-3,27
Din Moscow,1062,7,6,6,8,20,23,-3,24
FK Rubin,1062,8,6,5,9,22,19,3,23
Amkar,1062,9,6,4,10,13,24,-11,22
Rostov,1062,10,4,6,10,12,20,-8,18
Anzhi,1062,11,2,7,11,16,39,-23,13
Loko Moscow,1063,1,12,6,2,31,11,20,42
CSKA Moscow,1063,2,11,3,6,26,21,5,36
Zenit,1063,3,8,9,3,25,13,12,33
Spart Moscow,1063,4,9,6,5,37,30,7,33
Terek Grozny,1063,5,9,5,6,22,22,0,32
Krasnodar,1063,6,9,4,7,30,27,3,31
Din Moscow,1063,7,6,7,7,20,22,-2,25
FK Rubin,1063,8,5,6,9,22,20,2,21
Rostov,1063,9,4,6,10,11,19,-8,18
Amkar,1063,10,4,5,11,10,24,-14,17
Anzhi,1063,11,2,5,13,14,39,-25,11
Loko Moscow,1064,1,12,6,2,31,12,19,42
CSKA Moscow,1064,2,11,3,6,28,18,10,36
Zenit,1064,3,8,9,3,23,14,9,33
Spart Moscow,1064,4,9,5,6,39,31,8,32
Krasnodar,1064,5,8,5,7,28,26,2,29
Terek Grozny,1064,6,7,7,6,23,25,-2,28
FK Rubin,1064,7,6,6,8,23,18,5,24
Din Moscow,1064,8,6,6,8,20,24,-4,24
Amkar,1064,9,5,5,10,13,25,-12,20
Rostov,1064,10,4,6,10,10,19,-9,18
Anzhi,1064,11,2,6,12,16,42,-26,12
Loko Moscow,1065,1,11,5,4,30,14,16,38
Spart Moscow,1065,2,10,5,5,43,30,13,35
Zenit,1065,3,9,8,3,24,14,10,35
CSKA Moscow,1065,4,10,4,6,26,19,7,34
Krasnodar,1065,5,9,4,7,28,25,3,31
Terek Grozny,1065,6,8,5,7,24,24,0,29
Din Moscow,1065,7,6,6,8,20,25,-5,24
FK Rubin,1065,8,6,5,9,23,19,4,23
Amkar,1065,9,6,4,10,15,25,-10,22
Rostov,1065,10,4,6,10,10,22,-12,18
Anzhi,1065,11,2,6,12,15,41,-26,12
Loko Moscow,1066,1,11,7,2,32,14,18,40
CSKA Moscow,1066,2,11,3,6,31,18,13,36
Zenit,1066,3,8,9,3,24,15,9,33
Spart Moscow,1066,4,8,8,4,35,27,8,32
Krasnodar,1066,5,9,5,6,32,26,6,32
Terek Grozny,1066,6,9,5,6,24,23,1,32
Din Moscow,1066,7,6,7,7,22,24,-2,25
FK Rubin,1066,8,5,5,10,23,24,-1,20
Rostov,1066,9,4,7,9,10,17,-7,19
Amkar,1066,10,4,5,11,10,24,-14,17
Anzhi,1066,11,2,5,13,14,45,-31,11
Loko Moscow,1067,1,11,6,3,29,12,17,39
CSKA Moscow,1067,2,11,4,5,27,18,9,37
Spart Moscow,1067,3,9,6,5,36,28,8,33
Krasnodar,1067,4,9,5,6,30,26,4,32
Zenit,1067,5,7,10,3,21,13,8,31
Terek Grozny,1067,6,8,6,6,24,25,-1,30
FK Rubin,1067,7,5,7,8,24,20,4,22
Din Moscow,1067,8,5,7,8,18,23,-5,22
Amkar,1067,9,5,5,10,14,26,-12,20
Rostov,1067,10,4,7,9,10,17,-7,19
Anzhi,1067,11,2,5,13,16,41,-25,11
Loko Moscow,1068,1,12,6,2,34,13,21,42
Spart Moscow,1068,2,10,6,4,38,27,11,36
CSKA Moscow,1068,3,10,4,6,27,21,6,34
Zenit,1068,4,7,9,4,23,18,5,30
Krasnodar,1068,5,8,5,7,28,26,2,29
Terek Grozny,1068,6,7,7,6,22,24,-2,28
Din Moscow,1068,7,6,6,8,20,23,-3,24
FK Rubin,1068,8,6,5,9,23,20,3,23
Rostov,1068,9,4,7,9,12,19,-7,19
Amkar,1068,10,4,5,11,10,25,-15,17
Anzhi,1068,11,3,6,11,18,39,-21,15
Loko Moscow,1069,1,11,6,3,30,13,17,39
CSKA Moscow,1069,2,11,4,5,26,17,9,37
Spart Moscow,1069,3,9,6,5,36,28,8,33
Krasnodar,1069,4,9,5,6,29,25,4,32
Zenit,1069,5,7,10,3,22,14,8,31
Terek Grozny,1069,6,7,5,8,21,25,-4,26
Din Moscow,1069,7,6,7,7,20,23,-3,25
FK Rubin,1069,8,5,6,9,23,20,3,21
Rostov,1069,9,5,6,9,12,17,-5,21
Amkar,1069,10,5,4,11,11,25,-14,19
Anzhi,1069,11,3,5,12,15,38,-23,14
Loko Moscow,1070,1,12,5,3,30,14,16,41
CSKA Moscow,1070,2,11,4,5,27,18,9,37
Spart Moscow,1070,3,10,5,5,37,28,9,35
Zenit,1070,4,8,9,3,25,14,11,33
Terek Grozny,1070,5,8,5,7,23,24,-1,29
Krasnodar,1070,6,8,4,8,27,28,-1,28
FK Rubin,1070,7,6,6,8,24,17,7,24
Din Moscow,1070,8,5,7,8,17,22,-5,22
Amkar,1070,9,5,4,11,12,26,-14,19
Rostov,1070,10,4,6,10,11,19,-8,18
Anzhi,1070,11,3,5,12,15,38,-23,14
Loko Moscow,1071,1,11,7,2,32,14,18,40
CSKA Moscow,1071,2,11,3,6,27,18,9,36
Spart Moscow,1071,3,10,5,5,40,28,12,35
Zenit,1071,4,8,9,3,24,15,9,33
Krasnodar,1071,5,8,5,7,28,26,2,29
Terek Grozny,1071,6,7,5,8,21,26,-5,26
FK Rubin,1071,7,6,6,8,23,18,5,24
Din Moscow,1071,8,5,7,8,18,27,-9,22
Rostov,1071,9,5,6,9,12,17,-5,21
Amkar,1071,10,5,4,11,12,24,-12,19
Anzhi,1071,11,3,5,12,16,40,-24,14
Loko Moscow,1072,1,12,5,3,32,14,18,41
CSKA Moscow,1072,2,12,3,5,30,18,12,39
Spart Moscow,1072,3,10,5,5,38,29,9,35
Krasnodar,1072,4,10,4,6,31,25,6,34
Terek Grozny,1072,5,8,6,6,21,22,-1,30
Zenit,1072,6,7,8,5,22,17,5,29
Din Moscow,1072,7,6,6,8,22,23,-1,24
Rostov,1072,8,5,6,9,12,18,-6,21
FK Rubin,1072,9,5,5,10,21,22,-1,20
Amkar,1072,10,4,5,11,10,24,-14,17
Anzhi,1072,11,2,5,13,14,41,-27,11
Loko Moscow,1073,1,13,5,2,33,12,21,44
CSKA Moscow,1073,2,11,4,5,28,18,10,37
Spart Moscow,1073,3,10,6,4,39,29,10,36
Zenit,1073,4,7,9,4,22,16,6,30
Krasnodar,1073,5,8,5,7,29,27,2,29
Terek Grozny,1073,6,7,6,7,22,26,-4,27
Din Moscow,1073,7,6,6,8,19,23,-4,24
FK Rubin,1073,8,5,6,9,22,19,3,21
Amkar,1073,9,5,5,10,12,23,-11,20
Rostov,1073,10,4,6,10,12,20,-8,18
Anzhi,1073,11,2,6,12,16,41,-25,12
Loko Moscow,1074,1,11,6,3,30,14,16,39
CSKA Moscow,1074,2,11,3,6,32,23,9,36
Spart Moscow,1074,3,10,5,5,38,29,9,35
Zenit,1074,4,8,9,3,25,16,9,33
Krasnodar,1074,5,9,4,7,29,25,4,31
Terek Grozny,1074,6,7,5,8,20,24,-4,26
FK Rubin,1074,7,6,6,8,23,18,5,24
Din Moscow,1074,8,5,7,8,19,24,-5,22
Amkar,1074,9,6,4,10,13,22,-9,22
Rostov,1074,10,4,6,10,10,20,-10,18
Anzhi,1074,11,3,5,12,18,42,-24,14
Loko Moscow,1075,1,11,6,3,30,13,17,39
CSKA Moscow,1075,2,11,4,5,32,21,11,37
Krasnodar,1075,3,10,4,6,31,25,6,34
Spart Moscow,1075,4,9,5,6,35,28,7,32
Zenit,1075,5,7,10,3,23,15,8,31
Terek Grozny,1075,6,8,5,7,23,24,-1,29
Din Moscow,1075,7,6,7,7,19,22,-3,25
FK Rubin,1075,8,5,6,9,21,19,2,21
Amkar,1075,9,5,4,11,10,24,-14,19
Rostov,1075,10,4,6,10,10,18,-8,18
Anzhi,1075,11,3,5,12,18,43,-25,14
Loko Moscow,1076,1,12,5,3,30,12,18,41
Spart Moscow,1076,2,11,5,4,39,25,14,38
CSKA Moscow,1076,3,11,4,5,27,18,9,37
Zenit,1076,4,8,8,4,22,14,8,32
Krasnodar,1076,5,8,5,7,28,26,2,29
Terek Grozny,1076,6,8,5,7,25,26,-1,29
FK Rubin,1076,7,5,7,8,22,18,4,22
Din Moscow,1076,8,5,7,8,17,25,-8,22
Rostov,1076,9,4,6,10,10,18,-8,18
Amkar,1076,10,4,4,12,10,26,-16,16
Anzhi,1076,11,3,6,11,18,40,-22,15
Loko Moscow,1077,1,12,6,2,33,14,19,42
CSKA Moscow,1077,2,11,4,5,28,18,10,37
Spart Moscow,1077,3,10,5,5,38,28,10,35
Zenit,1077,4,7,9,4,23,16,7,30
Krasnodar,1077,5,8,6,6,31,28,3,30
Terek Grozny,1077,6,8,5,7,23,25,-2,29
FK Rubin,1077,7,6,6,8,25,20,5,24
Amkar,1077,8,6,4,10,12,23,-11,22
Din Moscow,1077,9,5,6,9,18,25,-7,21
Rostov,1077,10,4,6,10,11,19,-8,18
Anzhi,1077,11,2,5,13,16,42,-26,11
Loko Moscow,1078,1,13,5,2,35,12,23,44
CSKA Moscow,1078,2,12,3,5,28,17,11,39
Spart Moscow,1078,3,9,5,6,41,33,8,32
Zenit,1078,4,7,8,5,22,18,4,29
Krasnodar,1078,5,8,5,7,27,26,1,29
Terek Grozny,1078,6,7,7,6,22,24,-2,28
FK Rubin,1078,7,5,7,8,22,18,4,22
Din Moscow,1078,8,5,7,8,18,26,-8,22
Rostov,1078,9,5,6,9,13,19,-6,21
Amkar,1078,10,5,5,10,16,26,-10,20
Anzhi,1078,11,2,6,12,14,39,-25,12
Loko Moscow,1079,1,12,5,3,34,16,18,41
CSKA Moscow,1079,2,11,3,6,28,20,8,36
Zenit,1079,3,8,8,4,24,16,8,32
Spart Moscow,1079,4,9,5,6,35,29,6,32
Krasnodar,1079,5,9,5,6,33,29,4,32
Terek Grozny,1079,6,8,6,6,23,23,0,30
Din Moscow,1079,7,7,6,7,21,22,-1,27
FK Rubin,1079,8,5,6,9,24,22,2,21
Amkar,1079,9,5,5,10,13,24,-11,20
Rostov,1079,10,4,6,10,10,18,-8,18
Anzhi,1079,11,2,5,13,15,41,-26,11
Loko Moscow,1080,1,11,6,3,30,14,16,39
Spart Moscow,1080,2,10,6,4,43,31,12,36
CSKA Moscow,1080,3,11,3,6,29,21,8,36
Zenit,1080,4,9,8,3,26,13,13,35
Krasnodar,1080,5,8,5,7,29,28,1,29
Terek Grozny,1080,6,7,7,6,22,24,-2,28
Din Moscow,1080,7,6,7,7,22,23,-1,25
FK Rubin,1080,8,6,5,9,24,21,3,23
Rostov,1080,9,4,6,10,13,23,-10,18
Amkar,1080,10,4,5,11,11,25,-14,17
Anzhi,1080,11,2,6,12,16,42,-26,12
Loko Moscow,1081,1,11,6,3,31,14,17,39
Spart Moscow,1081,2,10,6,4,40,29,11,36
CSKA Moscow,1081,3,10,5,5,29,21,8,35
Krasnodar,1081,4,10,4,6,30,24,6,34
Zenit,1081,5,7,10,3,26,18,8,31
Terek Grozny,1081,6,7,5,8,23,28,-5,26
FK Rubin,1081,7,6,5,9,24,20,4,23
Din Moscow,1081,8,5,7,8,18,24,-6,22
Amkar,1081,9,5,4,11,14,27,-13,19
Rostov,1081,10,4,6,10,12,20,-8,18
Anzhi,1081,11,3,6,11,18,40,-22,15
Loko Moscow,1082,1,13,5,2,31,11,20,44
CSKA Moscow,1082,2,11,3,6,28,19,9,36
Zenit,1082,3,8,8,4,22,14,8,32
Spart Moscow,1082,4,8,6,6,36,31,5,30
Terek Grozny,1082,5,8,6,6,23,24,-1,30
Krasnodar,1082,6,8,5,7,27,25,2,29
Din Moscow,1082,7,7,6,7,22,21,1,27
FK Rubin,1082,8,5,6,9,21,20,1,21
Amkar,1082,9,5,5,10,12,24,-12,20
Rostov,1082,10,4,7,9,12,19,-7,19
Anzhi,1082,11,2,5,13,16,42,-26,11
Loko Moscow,1083,1,11,6,3,30,13,17,39
Spart Moscow,1083,2,10,6,4,39,26,13,36
CSKA Moscow,1083,3,10,4,6,25,18,7,34
Krasnodar,1083,4,10,4,6,31,25,6,34
Zenit,1083,5,8,9,3,22,13,9,33
Terek Grozny,1083,6,7,7,6,21,23,-2,28
FK Rubin,1083,7,6,5,9,24,20,4,23
Din Moscow,1083,8,5,6,9,19,26,-7,21
Rostov,1083,9,4,6,10,10,21,-11,18
Amkar,1083,10,4,6,10,9,22,-13,18
Anzhi,1083,11,2,7,11,15,38,-23,13
Loko Moscow,1084,1,11,6,3,29,12,17,39
Spart Moscow,1084,2,10,5,5,38,30,8,35
CSKA Moscow,1084,3,10,5,5,27,19,8,35
Zenit,1084,4,8,9,3,22,13,9,33
Krasnodar,1084,5,8,6,6,29,26,3,30
Terek Grozny,1084,6,8,5,7,25,27,-2,29
FK Rubin,1084,7,5,7,8,23,19,4,22
Din Moscow,1084,8,5,7,8,19,24,-5,22
Amkar,1084,9,6,4,10,13,23,-10,22
Rostov,1084,10,4,6,10,11,19,-8,18
Anzhi,1084,11,2,6,12,19,43,-24,12
Loko Moscow,1085,1,11,6,3,30,13,17,39
Spart Moscow,1085,2,10,6,4,39,28,11,36
CSKA Moscow,1085,3,10,5,5,26,18,8,35
Zenit,1085,4,7,10,3,21,13,8,31
Krasnodar,1085,5,9,4,7,31,28,3,31
Terek Grozny,1085,6,8,6,6,25,26,-1,30
FK Rubin,1085,7,6,6,8,26,21,5,24
Din Moscow,1085,8,5,8,7,21,25,-4,23
Rostov,1085,9,4,6,10,10,19,-9,18
Amkar,1085,10,4,4,12,11,26,-15,16
Anzhi,1085,11,2,7,11,18,41,-23,13
Loko Moscow,1086,1,11,6,3,30,14,16,39
Krasnodar,1086,2,10,4,6,32,25,7,34
Zenit,1086,3,8,9,3,22,13,9,33
CSKA Moscow,1086,4,10,3,7,25,19,6,33
Spart Moscow,1086,5,8,7,5,34,27,7,31
Terek Grozny,1086,6,8,6,6,22,23,-1,30
FK Rubin,1086,7,6,5,9,22,19,3,23
Din Moscow,1086,8,5,7,8,18,23,-5,22
Rostov,1086,9,5,6,9,11,17,-6,21
Amkar,1086,10,4,5,11,9,23,-14,17
Anzhi,1086,11,3,6,11,16,38,-22,15
Loko Moscow,1087,1,12,5,3,31,13,18,41
CSKA Moscow,1087,2,11,3,6,28,19,9,36
Zenit,1087,3,9,8,3,25,13,12,35
Spart Moscow,1087,4,10,5,5,37,27,10,35
Terek Grozny,1087,5,9,5,6,24,22,2,32
Krasnodar,1087,6,8,4,8,29,30,-1,28
FK Rubin,1087,7,7,5,8,27,19,8,26
Din Moscow,1087,8,5,6,9,18,25,-7,21
Amkar,1087,9,5,4,11,10,23,-13,19
Rostov,1087,10,4,6,10,10,19,-9,18
Anzhi,1087,11,2,5,13,14,43,-29,11
Loko Moscow,1088,1,13,5,2,32,11,21,44
CSKA Moscow,1088,2,11,3,6,28,19,9,36
Spart Moscow,1088,3,9,6,5,35,27,8,33
Terek Grozny,1088,4,9,5,6,23,22,1,32
Zenit,1088,5,7,8,5,21,16,5,29
Krasnodar,1088,6,8,5,7,29,28,1,29
Din Moscow,1088,7,6,6,8,23,24,-1,24
FK Rubin,1088,8,5,6,9,24,25,-1,21
Rostov,1088,9,5,6,9,12,17,-5,21
Amkar,1088,10,4,5,11,9,23,-14,17
Anzhi,1088,11,3,5,12,16,40,-24,14
Loko Moscow,1089,1,12,5,3,34,18,16,41
CSKA Moscow,1089,2,12,3,5,34,18,16,39
Spart Moscow,1089,3,10,5,5,36,28,8,35
Krasnodar,1089,4,9,5,6,31,25,6,32
Terek Grozny,1089,5,8,6,6,21,22,-1,30
Zenit,1089,6,7,8,5,24,23,1,29
FK Rubin,1089,7,5,7,8,22,18,4,22
Din Moscow,1089,8,5,7,8,18,23,-5,22
Amkar,1089,9,5,5,10,12,23,-11,20
Rostov,1089,10,4,6,10,10,18,-8,18
Anzhi,1089,11,2,5,13,15,41,-26,11
Loko Moscow,1090,1,12,6,2,35,13,22,42
CSKA Moscow,1090,2,11,4,5,29,18,11,37
Spart Moscow,1090,3,10,6,4,37,26,11,36
Zenit,1090,4,7,9,4,23,19,4,30
Krasnodar,1090,5,8,5,7,29,28,1,29
Terek Grozny,1090,6,8,5,7,23,25,-2,29
FK Rubin,1090,7,6,6,8,24,18,6,24
Din Moscow,1090,8,5,7,8,17,23,-6,22
Rostov,1090,9,4,7,9,10,17,-7,19
Amkar,1090,10,5,4,11,12,25,-13,19
Anzhi,1090,11,2,5,13,15,42,-27,11
Loko Moscow,1091,1,11,7,2,31,13,18,40
Spart Moscow,1091,2,10,5,5,38,29,9,35
CSKA Moscow,1091,3,10,5,5,26,18,8,35
Zenit,1091,4,7,10,3,23,15,8,31
Krasnodar,1091,5,8,6,6,28,25,3,30
Terek Grozny,1091,6,8,6,6,24,25,-1,30
FK Rubin,1091,7,6,6,8,22,17,5,24
Din Moscow,1091,8,5,6,9,18,25,-7,21
Amkar,1091,9,5,5,10,14,25,-11,20
Rostov,1091,10,4,6,10,10,18,-8,18
Anzhi,1091,11,2,6,12,15,39,-24,12
Loko Moscow,1092,1,13,5,2,33,13,20,44
CSKA Moscow,1092,2,11,3,6,28,18,10,36
Spart Moscow,1092,3,9,7,4,36,27,9,34
Zenit,1092,4,8,8,4,24,16,8,32
Krasnodar,1092,5,9,4,7,30,25,5,31
Terek Grozny,1092,6,8,5,7,22,24,-2,29
Din Moscow,1092,7,5,7,8,18,23,-5,22
FK Rubin,1092,8,5,6,9,22,21,1,21
Amkar,1092,9,5,5,10,11,23,-12,20
Rostov,1092,10,4,7,9,11,18,-7,19
Anzhi,1092,11,2,5,13,15,42,-27,11
Loko Moscow,1093,1,12,5,3,31,15,16,41
Spart Moscow,1093,2,10,6,4,38,26,12,36
CSKA Moscow,1093,3,10,5,5,28,20,8,35
Krasnodar,1093,4,10,4,6,33,26,7,34
Zenit,1093,5,7,9,4,22,15,7,30
Terek Grozny,1093,6,7,5,8,20,24,-4,26
FK Rubin,1093,7,6,5,9,25,21,4,23
Din Moscow,1093,8,5,6,9,18,25,-7,21
Amkar,1093,9,5,5,10,11,23,-12,20
Rostov,1093,10,4,6,10,10,19,-9,18
Anzhi,1093,11,3,6,11,18,40,-22,15
Loko Moscow,1094,1,12,6,2,35,14,21,42
Spart Moscow,1094,2,11,5,4,38,26,12,38
CSKA Moscow,1094,3,11,3,6,29,21,8,36
Zenit,1094,4,8,8,4,24,17,7,32
Krasnodar,1094,5,8,6,6,29,26,3,30
Terek Grozny,1094,6,8,6,6,24,23,1,30
Din Moscow,1094,7,6,6,8,19,22,-3,24
FK Rubin,1094,8,5,6,9,21,19,2,21
Rostov,1094,9,4,6,10,10,19,-9,18
Amkar,1094,10,4,5,11,11,25,-14,17
Anzhi,1094,11,2,5,13,16,44,-28,11
Loko Moscow,1095,1,11,7,2,30,12,18,40
Spart Moscow,1095,2,10,6,4,41,28,13,36
CSKA Moscow,1095,3,11,3,6,26,18,8,36
Zenit,1095,4,8,9,3,22,13,9,33
Krasnodar,1095,5,8,5,7,28,26,2,29
Terek Grozny,1095,6,8,5,7,23,24,-1,29
FK Rubin,1095,7,6,6,8,22,17,5,24
Din Moscow,1095,8,5,7,8,17,23,-6,22
Rostov,1095,9,4,7,9,11,18,-7,19
Amkar,1095,10,5,4,11,12,27,-15,19
Anzhi,1095,11,2,5,13,15,41,-26,11
Loko Moscow,1096,1,13,5,2,32,11,21,44
Spart Moscow,1096,2,9,6,5,36,28,8,33
CSKA Moscow,1096,3,10,3,7,26,21,5,33
Zenit,1096,4,8,8,4,23,15,8,32
Terek Grozny,1096,5,8,6,6,22,23,-1,30
Krasnodar,1096,6,8,5,7,28,26,2,29
Din Moscow,1096,7,6,6,8,21,23,-2,24
FK Rubin,1096,8,5,6,9,23,22,1,21
Rostov,1096,9,5,6,9,12,18,-6,21
Amkar,1096,10,4,5,11,10,24,-14,17
Anzhi,1096,11,3,6,11,17,39,-22,15
Loko Moscow,1097,1,12,5,3,31,15,16,41
CSKA Moscow,1097,2,11,3,6,28,20,8,36
Spart Moscow,1097,3,9,6,5,38,33,5,33
Zenit,1097,4,8,8,4,24,15,9,32
Krasnodar,1097,5,9,5,6,31,25,6,32
Terek Grozny,1097,6,8,5,7,24,23,1,29
FK Rubin,1097,7,6,6,8,23,17,6,24
Rostov,1097,8,5,6,9,16,18,-2,21
Din Moscow,1097,9,5,6,9,18,26,-8,21
Amkar,1097,10,5,5,10,11,23,-12,20
Anzhi,1097,11,2,5,13,14,43,-29,11
Loko Moscow,1098,1,13,5,2,33,13,20,44
Spart Moscow,1098,2,10,5,5,38,31,7,35
CSKA Moscow,1098,3,10,3,7,27,21,6,33
Zenit,1098,4,8,8,4,23,15,8,32
Krasnodar,1098,5,8,4,8,28,27,1,28
Terek Grozny,1098,6,7,6,7,20,23,-3,27
Din Moscow,1098,7,6,6,8,20,24,-4,24
FK Rubin,1098,8,6,5,9,22,18,4,23
Amkar,1098,9,5,5,10,12,22,-10,20
Rostov,1098,10,4,6,10,11,19,-8,18
Anzhi,1098,11,4,5,11,18,39,-21,17
Loko Moscow,1099,1,11,6,3,30,13,17,39
CSKA Moscow,1099,2,11,4,5,28,18,10,37
Spart Moscow,1099,3,10,5,5,37,29,8,35
Zenit,1099,4,8,8,4,22,15,7,32
Krasnodar,1099,5,9,5,6,32,26,6,32
Terek Grozny,1099,6,7,5,8,22,27,-5,26
Din Moscow,1099,7,5,7,8,17,23,-6,22
Amkar,1099,8,6,4,10,15,23,-8,22
FK Rubin,1099,9,5,6,9,22,21,1,21
Rostov,1099,10,4,6,10,10,18,-8,18
Anzhi,1099,11,3,6,11,18,40,-22,15
Loko Moscow,1100,1,13,5,2,34,11,23,44
Spart Moscow,1100,2,10,6,4,41,29,12,36
CSKA Moscow,1100,3,11,3,6,27,19,8,36
Zenit,1100,4,8,8,4,23,16,7,32
Krasnodar,1100,5,9,4,7,28,26,2,31
Terek Grozny,1100,6,8,5,7,25,24,1,29
Din Moscow,1100,7,5,8,7,20,24,-4,23
FK Rubin,1100,8,5,6,9,22,19,3,21
Rostov,1100,9,4,6,10,11,21,-10,18
Amkar,1100,10,4,4,12,10,28,-18,16
Anzhi,1100,11,3,5,12,16,40,-24,14
Loko Moscow,1101,1,12,5,3,32,15,17,41
CSKA Moscow,1101,2,11,4,5,26,17,9,37
Spart Moscow,1101,3,9,5,6,36,30,6,32
Krasnodar,1101,4,9,4,7,31,27,4,31
Zenit,1101,5,7,9,4,22,15,7,30
Terek Grozny,1101,6,8,6,6,21,22,-1,30
Din Moscow,1101,7,6,7,7,20,22,-2,25
FK Rubin,1101,8,6,6,8,24,19,5,24
Amkar,1101,9,5,4,11,12,24,-12,19
Rostov,1101,10,4,6,10,10,19,-9,18
Anzhi,1101,11,2,6,12,14,38,-24,12
Loko Moscow,1102,1,12,6,2,33,14,19,42
CSKA Moscow,1102,2,11,3,6,26,19,7,36
Spart Moscow,1102,3,9,5,6,36,27,9,32
Zenit,1102,4,8,8,4,23,14,9,32
Krasnodar,1102,5,8,6,6,30,27,3,30
Terek Grozny,1102,6,8,6,6,23,23,0,30
Din Moscow,1102,7,7,6,7,22,23,-1,27
FK Rubin,1102,8,5,6,9,23,21,2,21
Amkar,1102,9,5,4,11,11,25,-14,19
Rostov,1102,10,4,6,10,10,20,-10,18
Anzhi,1102,11,2,6,12,14,38,-24,12
Loko Moscow,1103,1,12,5,3,31,15,16,41
CSKA Moscow,1103,2,10,5,5,27,19,8,35
Spart Moscow,1103,3,9,7,4,37,28,9,34
Krasnodar,1103,4,9,5,6,31,25,6,32
Zenit,1103,5,7,9,4,22,15,7,30
Terek Grozny,1103,6,8,5,7,24,26,-2,29
Din Moscow,1103,7,5,8,7,19,23,-4,23
FK Rubin,1103,8,5,7,8,22,18,4,22
Rostov,1103,9,4,6,10,10,18,-8,18
Amkar,1103,10,4,5,11,11,25,-14,17
Anzhi,1103,11,3,6,11,19,41,-22,15
Loko Moscow,1104,1,12,6,2,32,13,19,42
CSKA Moscow,1104,2,11,4,5,28,18,10,37
Spart Moscow,1104,3,10,5,5,37,27,10,35
Krasnodar,1104,4,9,5,6,31,26,5,32
Zenit,1104,5,7,9,4,21,14,7,30
Terek Grozny,1104,6,7,6,7,23,26,-3,27
FK Rubin,1104,7,6,5,9,25,21,4,23
Rostov,1104,8,5,6,9,11,17,-6,21
Din Moscow,1104,9,5,6,9,20,27,-7,21
Amkar,1104,10,5,4,11,12,26,-14,19
Anzhi,1104,11,2,6,12,16,41,-25,12
Loko Moscow,1105,1,12,5,3,31,15,16,41
CSKA Moscow,1105,2,10,4,6,26,20,6,34
Spart Moscow,1105,3,9,6,5,35,27,8,33
Terek Grozny,1105,4,9,5,6,25,23,2,32
Krasnodar,1105,5,9,4,7,31,27,4,31
Zenit,1105,6,7,9,4,22,15,7,30
Din Moscow,1105,7,6,6,8,19,23,-4,24
FK Rubin,1105,8,6,5,9,24,19,5,23
Rostov,1105,9,5,6,9,11,17,-6,21
Amkar,1105,10,4,5,11,10,26,-16,17
Anzhi,1105,11,3,5,12,17,39,-22,14
Loko Moscow,1106,1,12,6,2,31,12,19,42
CSKA Moscow,1106,2,11,3,6,31,23,8,36
Spart Moscow,1106,3,10,5,5,37,27,10,35
Zenit,1106,4,8,8,4,25,15,10,32
Terek Grozny,1106,5,8,6,6,24,23,1,30
Krasnodar,1106,6,8,5,7,28,26,2,29
FK Rubin,1106,7,7,5,8,24,17,7,26
Din Moscow,1106,8,5,6,9,17,25,-8,21
Amkar,1106,9,5,4,11,11,26,-15,19
Rostov,1106,10,4,6,10,10,18,-8,18
Anzhi,1106,11,2,6,12,17,43,-26,12
Loko Moscow,1107,1,11,7,2,29,11,18,40
Spart Moscow,1107,2,10,5,5,35,27,8,35
CSKA Moscow,1107,3,10,5,5,27,19,8,35
Krasnodar,1107,4,9,5,6,29,24,5,32
Zenit,1107,5,7,10,3,22,14,8,31
Terek Grozny,1107,6,7,6,7,21,26,-5,27
Din Moscow,1107,7,6,6,8,19,22,-3,24
Amkar,1107,8,6,4,10,14,22,-8,22
FK Rubin,1107,9,5,5,10,21,21,0,20
Rostov,1107,10,4,6,10,10,18,-8,18
Anzhi,1107,11,2,7,11,16,39,-23,13
Loko Moscow,1108,1,12,5,3,31,13,18,41
CSKA Moscow,1108,2,11,4,5,29,19,10,37
Krasnodar,1108,3,9,5,6,29,25,4,32
Spart Moscow,1108,4,8,7,5,36,29,7,31
Zenit,1108,5,7,9,4,23,16,7,30
Din Moscow,1108,6,7,6,7,19,21,-2,27
Terek Grozny,1108,7,7,6,7,22,25,-3,27
FK Rubin,1108,8,5,6,9,21,18,3,21
Rostov,1108,9,4,7,9,11,18,-7,19
Amkar,1108,10,4,6,10,13,26,-13,18
Anzhi,1108,11,3,5,12,15,39,-24,14
Loko Moscow,1109,1,12,5,3,33,15,18,41
CSKA Moscow,1109,2,11,4,5,29,19,10,37
Spart Moscow,1109,3,10,6,4,41,27,14,36
Krasnodar,1109,4,10,4,6,30,25,5,34
Zenit,1109,5,7,9,4,24,17,7,30
Terek Grozny,1109,6,8,5,7,23,24,-1,29
Din Moscow,1109,7,5,7,8,18,24,-6,22
FK Rubin,1109,8,5,6,9,22,19,3,21
Rostov,1109,9,4,6,10,11,22,-11,18
Amkar,1109,10,4,5,11,10,25,-15,17
Anzhi,1109,11,3,5,12,17,41,-24,14
Loko Moscow,1110,1,13,5,2,33,13,20,44
CSKA Moscow,1110,2,12,3,5,29,17,12,39
Spart Moscow,1110,3,9,7,4,35,26,9,34
Krasnodar,1110,4,9,4,7,33,28,5,31
Zenit,1110,5,7,8,5,22,16,6,29
Terek Grozny,1110,6,7,6,7,21,24,-3,27
FK Rubin,1110,7,6,5,9,25,23,2,23
Din Moscow,1110,8,5,6,9,18,24,-6,21
Rostov,1110,9,4,7,9,11,18,-7,19
Amkar,1110,10,4,6,10,9,22,-13,18
Anzhi,1110,11,3,5,12,16,41,-25,14
Loko Moscow,1111,1,12,5,3,31,13,18,41
Zenit,1111,2,9,8,3,28,14,14,35
Spart Moscow,1111,3,9,7,4,35,26,9,34
CSKA Moscow,1111,4,10,4,6,27,24,3,34
Krasnodar,1111,5,9,4,7,29,26,3,31
Terek Grozny,1111,6,7,6,7,20,23,-3,27
Din Moscow,1111,7,6,6,8,18,22,-4,24
FK Rubin,1111,8,5,5,10,21,19,2,20
Amkar,1111,9,5,5,10,11,23,-12,20
Rostov,1111,10,4,7,9,10,17,-7,19
Anzhi,1111,11,2,7,11,15,38,-23,13
Loko Moscow,1112,1,11,6,3,30,14,16,39
Spart Moscow,1112,2,10,6,4,40,26,14,36
CSKA Moscow,1112,3,11,3,6,27,19,8,36
Zenit,1112,4,8,9,3,23,14,9,33
Krasnodar,1112,5,9,5,6,31,26,5,32
Terek Grozny,1112,6,8,6,6,26,25,1,30
FK Rubin,1112,7,6,6,8,25,19,6,24
Din Moscow,1112,8,5,6,9,17,28,-11,21
Rostov,1112,9,4,6,10,11,19,-8,18
Amkar,1112,10,4,5,11,9,25,-16,17
Anzhi,1112,11,2,6,12,18,42,-24,12
Loko Moscow,1113,1,12,5,3,31,12,19,41
Spart Moscow,1113,2,10,6,4,37,27,10,36
CSKA Moscow,1113,3,11,3,6,28,20,8,36
Zenit,1113,4,9,8,3,23,13,10,35
Krasnodar,1113,5,9,4,7,30,26,4,31
Terek Grozny,1113,6,7,6,7,20,26,-6,27
FK Rubin,1113,7,6,5,9,23,21,2,23
Din Moscow,1113,8,5,6,9,18,24,-6,21
Rostov,1113,9,4,6,10,12,20,-8,18
Amkar,1113,10,4,6,10,9,22,-13,18
Anzhi,1113,11,3,5,12,20,40,-20,14
Loko Moscow,1114,1,11,7,2,30,12,18,40
CSKA Moscow,1114,2,12,3,5,32,18,14,39
Spart Moscow,1114,3,10,5,5,37,27,10,35
Krasnodar,1114,4,9,5,6,33,25,8,32
Zenit,1114,5,7,9,4,22,16,6,30
Terek Grozny,1114,6,7,7,6,22,24,-2,28
Din Moscow,1114,7,7,6,7,20,22,-2,27
FK Rubin,1114,8,5,5,10,22,24,-2,20
Rostov,1114,9,4,6,10,11,20,-9,18
Amkar,1114,10,4,5,11,9,23,-14,17
Anzhi,1114,11,2,6,12,16,43,-27,12
Loko Moscow,1115,1,12,6,2,31,11,20,42
Spart Moscow,1115,2,11,5,4,38,27,11,38
CSKA Moscow,1115,3,11,4,5,29,18,11,37
Zenit,1115,4,7,9,4,22,16,6,30
Terek Grozny,1115,5,8,6,6,25,25,0,30
Krasnodar,1115,6,8,5,7,27,26,1,29
FK Rubin,1115,7,7,5,8,25,18,7,26
Din Moscow,1115,8,5,6,9,18,24,-6,21
Rostov,1115,9,4,6,10,11,19,-8,18
Amkar,1115,10,4,4,12,11,27,-16,16
Anzhi,1115,11,2,6,12,16,42,-26,12
Loko Moscow,1116,1,12,5,3,34,14,20,41
CSKA Moscow,1116,2,11,4,5,29,19,10,37
Zenit,1116,3,8,9,3,24,15,9,33
Spart Moscow,1116,4,9,5,6,37,30,7,32
Krasnodar,1116,5,8,4,8,29,32,-3,28
Din Moscow,1116,6,7,6,7,22,22,0,27
Terek Grozny,1116,7,7,6,7,23,26,-3,27
FK Rubin,1116,8,6,5,9,25,21,4,23
Rostov,1116,9,5,6,9,11,17,-6,21
Amkar,1116,10,5,4,11,14,27,-13,19
Anzhi,1116,11,2,6,12,16,41,-25,12
Loko Moscow,1117,1,12,6,2,33,13,20,42
Spart Moscow,1117,2,11,5,4,37,26,11,38
Zenit,1117,3,8,9,3,25,15,10,33
CSKA Moscow,1117,4,10,3,7,25,21,4,33
Krasnodar,1117,5,9,4,7,31,27,4,31
Terek Grozny,1117,6,8,5,7,21,23,-2,29
Din Moscow,1117,7,5,7,8,18,23,-5,22
FK Rubin,1117,8,5,6,9,23,22,1,21
Amkar,1117,9,5,4,11,10,23,-13,19
Rostov,1117,10,4,6,10,11,19,-8,18
Anzhi,1117,11,3,5,12,16,38,-22,14
Loko Moscow,1118,1,12,6,2,31,12,19,42
CSKA Moscow,1118,2,11,4,5,26,17,9,37
Spart Moscow,1118,3,10,6,4,38,28,10,36
Zenit,1118,4,7,9,4,21,14,7,30
Krasnodar,1118,5,8,6,6,28,25,3,30
Terek Grozny,1118,6,7,7,6,21,23,-2,28
FK Rubin,1118,7,6,6,8,22,17,5,24
Din Moscow,1118,8,5,6,9,17,23,-6,21
Rostov,1118,9,4,7,9,12,19,-7,19
Amkar,1118,10,4,5,11,10,24,-14,17
Anzhi,1118,11,2,6,12,15,39,-24,12
Loko Moscow,1119,1,12,6,2,30,11,19,42
CSKA Moscow,1119,2,12,3,5,29,17,12,39
Terek Grozny,1119,3,9,5,6,24,23,1,32
Zenit,1119,4,7,9,4,21,14,7,30
Spart Moscow,1119,5,8,6,6,34,28,6,30
Krasnodar,1119,6,8,5,7,27,25,2,29
Din Moscow,1119,7,7,6,7,21,21,0,27
FK Rubin,1119,8,5,6,9,21,20,1,21
Rostov,1119,9,5,6,9,12,18,-6,21
Amkar,1119,10,4,5,11,9,23,-14,17
Anzhi,1119,11,2,5,13,15,43,-28,11
Loko Moscow,1120,1,11,6,3,31,14,17,39
CSKA Moscow,1120,2,11,3,6,27,19,8,36
Zenit,1120,3,8,9,3,24,14,10,33
Krasnodar,1120,4,9,5,6,29,25,4,32
Spart Moscow,1120,5,8,6,6,33,29,4,30
Terek Grozny,1120,6,8,6,6,21,22,-1,30
Din Moscow,1120,7,6,7,7,18,21,-3,25
FK Rubin,1120,8,5,6,9,21,18,3,21
Rostov,1120,9,5,6,9,12,17,-5,21
Amkar,1120,10,5,4,11,11,23,-12,19
Anzhi,1120,11,2,6,12,14,39,-25,12
Loko Moscow,1121,1,12,5,3,33,13,20,41
Spart Moscow,1121,2,10,5,5,40,30,10,35
Zenit,1121,3,9,8,3,24,14,10,35
CSKA Moscow,1121,4,10,4,6,28,21,7,34
Terek Grozny,1121,5,9,5,6,26,23,3,32
Krasnodar,1121,6,9,4,7,31,28,3,31
Din Moscow,1121,7,6,6,8,23,26,-3,24
FK Rubin,1121,8,5,5,10,23,24,-1,20
Amkar,1121,9,5,4,11,13,28,-15,19
Rostov,1121,10,4,6,10,10,19,-9,18
Anzhi,1121,11,2,6,12,16,41,-25,12
Loko Moscow,1122,1,13,5,2,33,12,21,44
CSKA Moscow,1122,2,11,3,6,28,20,8,36
Spart Moscow,1122,3,9,6,5,38,28,10,33
Zenit,1122,4,8,8,4,24,16,8,32
Krasnodar,1122,5,9,4,7,31,26,5,31
Terek Grozny,1122,6,8,5,7,23,25,-2,29
Din Moscow,1122,7,6,6,8,19,24,-5,24
FK Rubin,1122,8,5,5,10,21,22,-1,20
Rostov,1122,9,4,7,9,12,19,-7,19
Amkar,1122,10,5,4,11,11,24,-13,19
Anzhi,1122,11,3,5,12,16,40,-24,14
CSKA Moscow,1123,1,12,3,5,29,18,11,39
Loko Moscow,1123,2,11,5,4,32,17,15,38
Spart Moscow,1123,3,10,5,5,39,28,11,35
Zenit,1123,4,8,8,4,24,15,9,32
Krasnodar,1123,5,9,4,7,31,28,3,31
Terek Grozny,1123,6,8,6,6,21,22,-1,30
Din Moscow,1123,7,7,6,7,20,22,-2,27
FK Rubin,1123,8,6,5,9,22,18,4,23
Rostov,1123,9,4,6,10,10,20,-10,18
Amkar,1123,10,4,4,12,10,25,-15,16
Anzhi,1123,11,2,6,12,14,39,-25,12
Loko Moscow,1124,1,12,5,3,33,14,19,41
CSKA Moscow,1124,2,12,3,5,28,18,10,39
Spart Moscow,1124,3,9,6,5,37,30,7,33
Krasnodar,1124,4,9,5,6,30,26,4,32
Zenit,1124,5,7,8,5,21,16,5,29
Terek Grozny,1124,6,7,7,6,21,23,-2,28
FK Rubin,1124,7,6,6,8,22,17,5,24
Din Moscow,1124,8,6,6,8,20,23,-3,24
Rostov,1124,9,4,6,10,11,19,-8,18
Amkar,1124,10,4,6,10,10,23,-13,18
Anzhi,1124,11,2,6,12,16,40,-24,12
Loko Moscow,1125,1,11,6,3,29,16,13,39
CSKA Moscow,1125,2,11,3,6,30,21,9,36
Spart Moscow,1125,3,9,7,4,37,28,9,34
Zenit,1125,4,8,9,3,24,14,10,33
Krasnodar,1125,5,9,4,7,34,27,7,31
Terek Grozny,1125,6,7,5,8,20,26,-6,26
FK Rubin,1125,7,6,6,8,25,20,5,24
Din Moscow,1125,8,5,7,8,18,23,-5,22
Amkar,1125,9,5,5,10,13,23,-10,20
Rostov,1125,10,4,7,9,12,19,-7,19
Anzhi,1125,11,3,5,12,16,41,-25,14
Loko Moscow,1126,1,12,5,3,32,13,19,41
Spart Moscow,1126,2,10,5,5,40,27,13,35
CSKA Moscow,1126,3,10,4,6,25,19,6,34
Zenit,1126,4,8,8,4,23,15,8,32
Krasnodar,1126,5,9,5,6,31,27,4,32
Terek Grozny,1126,6,7,6,7,20,23,-3,27
FK Rubin,1126,7,6,6,8,26,19,7,24
Rostov,1126,8,5,6,9,12,18,-6,21
Din Moscow,1126,9,5,6,9,17,28,-11,21
Amkar,1126,10,4,5,11,9,24,-15,17
Anzhi,1126,11,3,6,11,15,37,-22,15
Loko Moscow,1127,1,12,5,3,32,12,20,41
CSKA Moscow,1127,2,11,4,5,28,18,10,37
Zenit,1127,3,8,9,3,23,14,9,33
Spart Moscow,1127,4,9,6,5,36,28,8,33
Krasnodar,1127,5,9,4,7,30,27,3,31
Terek Grozny,1127,6,8,5,7,23,24,-1,29
FK Rubin,1127,7,6,5,9,23,21,2,23
Din Moscow,1127,8,5,7,8,19,24,-5,22
Rostov,1127,9,5,6,9,11,17,-6,21
Amkar,1127,10,5,4,11,11,24,-13,19
Anzhi,1127,11,2,5,13,15,42,-27,11
Loko Moscow,1128,1,13,5,2,33,12,21,44
Spart Moscow,1128,2,10,6,4,38,27,11,36
CSKA Moscow,1128,3,11,3,6,27,18,9,36
Zenit,1128,4,8,8,4,22,14,8,32
Terek Grozny,1128,5,9,5,6,22,22,0,32
Krasnodar,1128,6,8,5,7,29,28,1,29
Din Moscow,1128,7,6,6,8,20,24,-4,24
FK Rubin,1128,8,5,6,9,23,21,2,21
Rostov,1128,9,4,6,10,11,19,-8,18
Amkar,1128,10,4,5,11,10,24,-14,17
Anzhi,1128,11,2,5,13,14,40,-26,11
Loko Moscow,1129,1,12,6,2,32,13,19,42
CSKA Moscow,1129,2,11,3,6,27,19,8,36
Spart Moscow,1129,3,10,5,5,37,27,10,35
Zenit,1129,4,8,8,4,24,15,9,32
Krasnodar,1129,5,8,5,7,28,27,1,29
Terek Grozny,1129,6,7,6,7,20,23,-3,27
Din Moscow,1129,7,6,6,8,19,24,-5,24
FK Rubin,1129,8,6,5,9,23,18,5,23
Rostov,1129,9,5,6,9,11,17,-6,21
Amkar,1129,10,5,4,11,10,23,-13,19
Anzhi,1129,11,2,6,12,14,39,-25,12
Loko Moscow,1130,1,12,5,3,32,14,18,41
CSKA Moscow,1130,2,11,4,5,29,19,10,37
Spart Moscow,1130,3,10,5,5,40,29,11,35
Zenit,1130,4,8,9,3,23,14,9,33
Terek Grozny,1130,5,9,5,6,24,23,1,32
Krasnodar,1130,6,8,5,7,28,26,2,29
FK Rubin,1130,7,6,6,8,23,18,5,24
Rostov,1130,8,5,6,9,13,19,-6,21
Din Moscow,1130,9,5,6,9,19,26,-7,21
Amkar,1130,10,4,4,12,9,26,-17,16
Anzhi,1130,11,2,5,13,17,43,-26,11
Loko Moscow,1131,1,12,5,3,32,12,20,41
Spart Moscow,1131,2,10,6,4,39,27,12,36
CSKA Moscow,1131,3,11,3,6,27,20,7,36
Zenit,1131,4,8,8,4,24,16,8,32
Krasnodar,1131,5,9,4,7,28,27,1,31
Terek Grozny,1131,6,8,6,6,23,24,-1,30
FK Rubin,1131,7,7,5,8,26,18,8,26
Din Moscow,1131,8,5,6,9,19,25,-6,21
Rostov,1131,9,4,6,10,10,20,-10,18
Amkar,1131,10,4,6,10,11,24,-13,18
Anzhi,1131,11,2,5,13,15,41,-26,11
Loko Moscow,1132,1,11,7,2,29,11,18,40
CSKA Moscow,1132,2,12,3,5,30,19,11,39
Spart Moscow,1132,3,10,5,5,38,26,12,35
Krasnodar,1132,4,9,5,6,29,24,5,32
Zenit,1132,5,7,9,4,22,16,6,30
Terek Grozny,1132,6,8,5,7,22,24,-2,29
Din Moscow,1132,7,5,7,8,18,25,-7,22
FK Rubin,1132,8,5,6,9,22,20,2,21
Amkar,1132,9,5,4,11,10,24,-14,19
Rostov,1132,10,4,6,10,10,19,-9,18
Anzhi,1132,11,3,5,12,17,39,-22,14
CSKA Moscow,1133,1,12,3,5,28,17,11,39
Loko Moscow,1133,2,11,5,4,30,14,16,38
Zenit,1133,3,8,8,4,22,14,8,32
Spart Moscow,1133,4,9,5,6,38,31,7,32
Krasnodar,1133,5,9,5,6,31,27,4,32
Terek Grozny,1133,6,7,7,6,22,24,-2,28
FK Rubin,1133,7,5,7,8,23,19,4,22
Din Moscow,1133,8,5,7,8,18,23,-5,22
Rostov,1133,9,5,6,9,12,18,-6,21
Amkar,1133,10,5,5,10,13,25,-12,20
Anzhi,1133,11,2,6,12,15,40,-25,12
Loko Moscow,1134,1,12,6,2,31,11,20,42
CSKA Moscow,1134,2,11,4,5,27,18,9,37
Spart Moscow,1134,3,9,7,4,36,27,9,34
Zenit,1134,4,7,10,3,21,13,8,31
Krasnodar,1134,5,9,4,7,29,27,2,31
Terek Grozny,1134,6,7,5,8,20,25,-5,26
Din Moscow,1134,7,6,7,7,20,23,-3,25
FK Rubin,1134,8,5,5,10,23,21,2,20
Amkar,1134,9,5,5,10,12,23,-11,20
Rostov,1134,10,4,6,10,10,18,-8,18
Anzhi,1134,11,3,5,12,16,39,-23,14
Loko Moscow,1135,1,12,6,2,33,14,19,42
CSKA Moscow,1135,2,12,3,5,31,19,12,39
Spart Moscow,1135,3,9,7,4,36,26,10,34
Zenit,1135,4,7,9,4,22,16,6,30
Krasnodar,1135,5,8,5,7,29,27,2,29
Terek Grozny,1135,6,7,6,7,23,26,-3,27
Din Moscow,1135,7,5,8,7,18,22,-4,23
FK Rubin,1135,8,5,7,8,21,17,4,22
Rostov,1135,9,4,7,9,10,17,-7,19
Amkar,1135,10,5,4,11,10,24,-14,19
Anzhi,1135,11,2,6,12,19,44,-25,12
Loko Moscow,1136,1,12,6,2,31,12,19,42
CSKA Moscow,1136,2,12,3,5,28,17,11,39
Spart Moscow,1136,3,9,6,5,36,30,6,33
Krasnodar,1136,4,9,5,6,30,25,5,32
Zenit,1136,5,7,8,5,21,15,6,29
Terek Grozny,1136,6,7,6,7,21,24,-3,27
FK Rubin,1136,7,6,5,9,23,19,4,23
Rostov,1136,8,5,6,9,14,17,-3,21
Din Moscow,1136,9,5,6,9,17,25,-8,21
Amkar,1136,10,5,5,10,11,23,-12,20
Anzhi,1136,11,2,6,12,15,40,-25,12
Loko Moscow,1137,1,13,5,2,36,13,23,44
Spart Moscow,1137,2,10,5,5,39,27,12,35
CSKA Moscow,1137,3,10,4,6,25,18,7,34
Zenit,1137,4,8,8,4,24,16,8,32
Krasnodar,1137,5,9,4,7,28,28,0,31
Terek Grozny,1137,6,7,6,7,22,25,-3,27
Din Moscow,1137,7,6,6,8,18,25,-7,24
Rostov,1137,8,5,6,9,12,18,-6,21
FK Rubin,1137,9,5,5,10,21,19,2,20
Amkar,1137,10,4,5,11,11,25,-14,17
Anzhi,1137,11,3,6,11,15,37,-22,15
Loko Moscow,1138,1,12,5,3,30,12,18,41
Spart Moscow,1138,2,11,5,4,39,26,13,38
CSKA Moscow,1138,3,11,4,5,30,19,11,37
Krasnodar,1138,4,9,4,7,28,25,3,31
Zenit,1138,5,7,9,4,23,16,7,30
Terek Grozny,1138,6,8,6,6,22,23,-1,30
FK Rubin,1138,7,7,5,8,24,18,6,26
Din Moscow,1138,8,5,6,9,18,24,-6,21
Rostov,1138,9,4,6,10,11,21,-10,18
Amkar,1138,10,4,4,12,10,25,-15,16
Anzhi,1138,11,2,6,12,14,40,-26,12
Loko Moscow,1139,1,12,5,3,30,12,18,41
Spart Moscow,1139,2,10,6,4,35,25,10,36
CSKA Moscow,1139,3,10,4,6,28,21,7,34
Krasnodar,1139,4,10,4,6,30,25,5,34
Zenit,1139,5,8,8,4,23,15,8,32
Terek Grozny,1139,6,8,6,6,23,24,-1,30
Din Moscow,1139,7,5,7,8,17,22,-5,22
FK Rubin,1139,8,5,6,9,22,19,3,21
Rostov,1139,9,4,6,10,10,18,-8,18
Amkar,1139,10,4,6,10,10,23,-13,18
Anzhi,1139,11,2,6,12,17,41,-24,12
Spart Moscow,1140,1,11,5,4,42,27,15,38
Loko Moscow,1140,2,11,5,4,30,16,14,38
CSKA Moscow,1140,3,11,4,5,29,20,9,37
Krasnodar,1140,4,10,4,6,33,26,7,34
Zenit,1140,5,8,8,4,25,17,8,32
Terek Grozny,1140,6,7,5,8,20,26,-6,26
Din Moscow,1140,7,6,6,8,18,23,-5,24
FK Rubin,1140,8,5,5,10,23,21,2,20
Amkar,1140,9,5,4,11,11,27,-16,19
Rostov,1140,10,4,6,10,11,19,-8,18
Anzhi,1140,11,3,6,11,18,38,-20,15
Loko Moscow,1141,1,11,7,2,30,12,18,40
CSKA Moscow,1141,2,12,3,5,30,19,11,39
Spart Moscow,1141,3,10,5,5,38,28,10,35
Krasnodar,1141,4,9,5,6,32,25,7,32
Zenit,1141,5,7,9,4,22,15,7,30
Terek Grozny,1141,6,8,5,7,23,23,0,29
Din Moscow,1141,7,6,6,8,20,26,-6,24
FK Rubin,1141,8,6,5,9,26,21,5,23
Amkar,1141,9,5,4,11,10,25,-15,19
Rostov,1141,10,4,6,10,10,19,-9,18
Anzhi,1141,11,2,5,13,15,43,-28,11
Loko Moscow,1142,1,13,5,2,33,12,21,44
Spart Moscow,1142,2,10,6,4,37,25,12,36
CSKA Moscow,1142,3,11,3,6,28,21,7,36
Zenit,1142,4,8,8,4,25,15,10,32
Krasnodar,1142,5,9,4,7,30,26,4,31
Terek Grozny,1142,6,7,7,6,21,23,-2,28
Din Moscow,1142,7,5,7,8,18,23,-5,22
FK Rubin,1142,8,5,6,9,22,20,2,21
Rostov,1142,9,4,7,9,10,17,-7,19
Amkar,1142,10,4,5,11,10,26,-16,17
Anzhi,1142,11,2,6,12,14,40,-26,12
Loko Moscow,1143,1,12,6,2,31,11,20,42
CSKA Moscow,1143,2,11,3,6,28,21,7,36
Spart Moscow,1143,3,10,5,5,40,29,11,35
Zenit,1143,4,8,9,3,23,13,10,33
Terek Grozny,1143,5,8,5,7,22,24,-2,29
Krasnodar,1143,6,8,4,8,28,29,-1,28
Din Moscow,1143,7,6,6,8,22,25,-3,24
FK Rubin,1143,8,6,5,9,24,21,3,23
Amkar,1143,9,6,4,10,12,23,-11,22
Rostov,1143,10,4,6,10,10,19,-9,18
Anzhi,1143,11,2,5,13,17,42,-25,11
Loko Moscow,1144,1,11,6,3,31,15,16,39
CSKA Moscow,1144,2,11,4,5,29,20,9,37
Spart Moscow,1144,3,9,7,4,37,28,9,34
Krasnodar,1144,4,10,4,6,33,25,8,34
Zenit,1144,5,7,10,3,23,15,8,31
Terek Grozny,1144,6,7,6,7,21,24,-3,27
FK Rubin,1144,7,6,5,9,23,20,3,23
Din Moscow,1144,8,5,7,8,18,24,-6,22
Amkar,1144,9,5,5,10,12,24,-12,20
Rostov,1144,10,4,6,10,11,19,-8,18
Anzhi,1144,11,2,6,12,16,40,-24,12
Loko Moscow,1145,1,12,5,3,31,13,18,41
Spart Moscow,1145,2,11,5,4,39,28,11,38
CSKA Moscow,1145,3,11,4,5,31,21,10,37
Zenit,1145,4,8,8,4,22,15,7,32
Krasnodar,1145,5,8,5,7,28,26,2,29
Terek Grozny,1145,6,7,7,6,23,25,-2,28
FK Rubin,1145,7,6,6,8,23,17,6,24
Din Moscow,1145,8,5,6,9,19,26,-7,21
Rostov,1145,9,4,6,10,11,19,-8,18
Amkar,1145,10,4,5,11,12,26,-14,17
Anzhi,1145,11,2,7,11,18,41,-23,13
Loko Moscow,1146,1,11,7,2,31,13,18,40
CSKA Moscow,1146,2,12,3,5,28,17,11,39
Spart Moscow,1146,3,9,6,5,38,29,9,33
Terek Grozny,1146,4,9,5,6,28,24,4,32
Zenit,1146,5,7,9,4,22,15,7,30
Krasnodar,1146,6,8,6,6,28,25,3,30
FK Rubin,1146,7,6,6,8,23,17,6,24
Din Moscow,1146,8,6,6,8,20,25,-5,24
Rostov,1146,9,4,7,9,11,18,-7,19
Amkar,1146,10,4,4,12,9,28,-19,16
Anzhi,1146,11,2,5,13,16,43,-27,11
Loko Moscow,1147,1,12,6,2,31,12,19,42
CSKA Moscow,1147,2,11,3,6,27,22,5,36
Zenit,1147,3,8,9,3,26,14,12,33
Spart Moscow,1147,4,9,6,5,36,28,8,33
Krasnodar,1147,5,8,5,7,27,25,2,29
Terek Grozny,1147,6,7,7,6,23,25,-2,28
Din Moscow,1147,7,6,6,8,19,22,-3,24
FK Rubin,1147,8,5,6,9,21,19,2,21
Rostov,1147,9,5,6,9,12,18,-6,21
Amkar,1147,10,4,6,10,11,24,-13,18
Anzhi,1147,11,2,6,12,17,41,-24,12
Loko Moscow,1148,1,11,5,4,29,14,15,38
Spart Moscow,1148,2,10,6,4,40,27,13,36
CSKA Moscow,1148,3,11,3,6,27,19,8,36
Zenit,1148,4,9,8,3,24,13,11,35
Krasnodar,1148,5,9,4,7,29,25,4,31
Terek Grozny,1148,6,8,6,6,24,24,0,30
Din Moscow,1148,7,6,7,7,22,22,0,25
FK Rubin,1148,8,6,5,9,22,21,1,23
Rostov,1148,9,4,6,10,11,20,-9,18
Amkar,1148,10,4,4,12,10,28,-18,16
Anzhi,1148,11,2,6,12,15,40,-25,12
Loko Moscow,1149,1,11,6,3,29,12,17,39
CSKA Moscow,1149,2,11,4,5,31,18,13,37
Zenit,1149,3,8,9,3,23,14,9,33
Spart Moscow,1149,4,8,5,7,33,28,5,29
Krasnodar,1149,5,8,5,7,27,25,2,29
Terek Grozny,1149,6,8,5,7,23,23,0,29
Din Moscow,1149,7,7,6,7,20,21,-1,27
FK Rubin,1149,8,6,5,9,22,19,3,23
Amkar,1149,9,6,4,10,11,22,-11,22
Rostov,1149,10,5,6,9,11,17,-6,21
Anzhi,1149,11,2,5,13,14,45,-31,11
Loko Moscow,1150,1,12,6,2,32,13,19,42
Spart Moscow,1150,2,11,5,4,39,27,12,38
CSKA Moscow,1150,3,11,3,6,27,19,8,36
Zenit,1150,4,8,9,3,24,14,10,33
Krasnodar,1150,5,9,4,7,30,26,4,31
Terek Grozny,1150,6,7,6,7,20,23,-3,27
FK Rubin,1150,7,6,5,9,22,19,3,23
Din Moscow,1150,8,5,6,9,18,24,-6,21
Rostov,1150,9,4,6,10,10,18,-8,18
Amkar,1150,10,4,5,11,10,25,-15,17
Anzhi,1150,11,3,5,12,15,39,-24,14
Loko Moscow,1151,1,11,5,4,29,15,14,38
Spart Moscow,1151,2,10,6,4,37,27,10,36
CSKA Moscow,1151,3,11,3,6,27,19,8,36
Zenit,1151,4,9,8,3,25,13,12,35
Krasnodar,1151,5,10,4,6,32,24,8,34
Terek Grozny,1151,6,8,6,6,21,22,-1,30
Din Moscow,1151,7,5,7,8,19,24,-5,22
FK Rubin,1151,8,5,6,9,22,21,1,21
Rostov,1151,9,4,6,10,11,19,-8,18
Amkar,1151,10,4,6,10,9,22,-13,18
Anzhi,1151,11,2,5,13,14,40,-26,11
Loko Moscow,1152,1,11,6,3,31,14,17,39
CSKA Moscow,1152,2,11,4,5,29,18,11,37
Spart Moscow,1152,3,9,6,5,35,27,8,33
Krasnodar,1152,4,9,5,6,29,25,4,32
Terek Grozny,1152,5,9,5,6,26,25,1,32
Zenit,1152,6,7,10,3,23,15,8,31
FK Rubin,1152,7,6,6,8,22,17,5,24
Din Moscow,1152,8,5,7,8,17,22,-5,22
Rostov,1152,9,5,6,9,11,17,-6,21
Amkar,1152,10,4,4,12,11,27,-16,16
Anzhi,1152,11,2,5,13,16,43,-27,11
Loko Moscow,1153,1,12,5,3,34,14,20,41
Spart Moscow,1153,2,10,6,4,36,26,10,36
CSKA Moscow,1153,3,10,4,6,30,23,7,34
Zenit,1153,4,8,8,4,25,20,5,32
Terek Grozny,1153,5,9,5,6,24,24,0,32
Krasnodar,1153,6,9,4,7,30,26,4,31
FK Rubin,1153,7,6,6,8,22,17,5,24
Din Moscow,1153,8,5,7,8,18,23,-5,22
Rostov,1153,9,4,6,10,10,18,-8,18
Amkar,1153,10,4,5,11,9,23,-14,17
Anzhi,1153,11,2,6,12,18,42,-24,12
Loko Moscow,1154,1,12,6,2,30,11,19,42
CSKA Moscow,1154,2,10,5,5,26,18,8,35
Spart Moscow,1154,3,9,7,4,38,28,10,34
Zenit,1154,4,7,9,4,21,14,7,30
Krasnodar,1154,5,8,6,6,29,26,3,30
Terek Grozny,1154,6,8,5,7,24,25,-1,29
Din Moscow,1154,7,6,7,7,19,22,-3,25
FK Rubin,1154,8,5,6,9,23,20,3,21
Rostov,1154,9,4,7,9,11,18,-7,19
Amkar,1154,10,5,4,11,13,27,-14,19
Anzhi,1154,11,2,6,12,15,40,-25,12
Loko Moscow,1155,1,11,6,3,32,15,17,39
CSKA Moscow,1155,2,11,4,5,28,18,10,37
Spart Moscow,1155,3,10,5,5,37,28,9,35
Krasnodar,1155,4,9,5,6,31,27,4,32
Zenit,1155,5,7,9,4,22,16,6,30
Terek Grozny,1155,6,8,5,7,24,26,-2,29
FK Rubin,1155,7,5,7,8,22,18,4,22
Din Moscow,1155,8,5,7,8,18,23,-5,22
Amkar,1155,9,5,4,11,13,25,-12,19
Rostov,1155,10,4,6,10,10,19,-9,18
Anzhi,1155,11,3,6,11,17,39,-22,15
Loko Moscow,1156,1,12,6,2,30,11,19,42
CSKA Moscow,1156,2,11,3,6,27,19,8,36
Zenit,1156,3,8,9,3,22,13,9,33
Spart Moscow,1156,4,8,7,5,37,30,7,31
Terek Grozny,1156,5,8,6,6,22,23,-1,30
Krasnodar,1156,6,8,4,8,28,27,1,28
Din Moscow,1156,7,7,6,7,19,21,-2,27
FK Rubin,1156,8,6,5,9,23,19,4,23
Rostov,1156,9,4,7,9,12,19,-7,19
Amkar,1156,10,4,6,10,12,25,-13,18
Anzhi,1156,11,2,5,13,15,40,-25,11
Loko Moscow,1157,1,11,6,3,31,15,16,39
CSKA Moscow,1157,2,11,3,6,27,19,8,36
Zenit,1157,3,9,8,3,25,14,11,35
Spart Moscow,1157,4,10,5,5,36,26,10,35
Krasnodar,1157,5,9,5,6,29,25,4,32
Terek Grozny,1157,6,8,5,7,22,25,-3,29
Din Moscow,1157,7,6,6,8,18,22,-4,24
FK Rubin,1157,8,6,5,9,22,18,4,23
Amkar,1157,9,5,4,11,12,24,-12,19
Rostov,1157,10,4,6,10,10,19,-9,18
Anzhi,1157,11,2,5,13,15,40,-25,11
Loko Moscow,1158,1,12,5,3,33,12,21,41
CSKA Moscow,1158,2,11,3,6,32,19,13,36
Krasnodar,1158,3,10,4,6,30,25,5,34
Spart Moscow,1158,4,9,5,6,37,29,8,32
Zenit,1158,5,8,8,4,23,18,5,32
Terek Grozny,1158,6,7,6,7,21,25,-4,27
Din Moscow,1158,7,5,7,8,18,25,-7,22
FK Rubin,1158,8,5,6,9,23,20,3,21
Rostov,1158,9,5,6,9,11,17,-6,21
Amkar,1158,10,5,5,10,13,24,-11,20
Anzhi,1158,11,3,5,12,16,43,-27,14
Loko Moscow,1159,1,11,5,4,30,17,13,38
Zenit,1159,2,9,8,3,27,13,14,35
Spart Moscow,1159,3,9,7,4,38,28,10,34
CSKA Moscow,1159,4,10,4,6,26,20,6,34
Krasnodar,1159,5,9,4,7,29,27,2,31
Terek Grozny,1159,6,8,6,6,22,23,-1,30
Din Moscow,1159,7,6,7,7,21,23,-2,25
FK Rubin,1159,8,6,5,9,23,19,4,23
Rostov,1159,9,4,6,10,11,20,-9,18
Amkar,1159,10,4,5,11,9,23,-14,17
Anzhi,1159,11,2,7,11,16,39,-23,13
Loko Moscow,1160,1,12,5,3,31,12,19,41
CSKA Moscow,1160,2,10,4,6,28,22,6,34
Spart Moscow,1160,3,9,6,5,37,29,8,33
Zenit,1160,4,8,8,4,23,15,8,32
Krasnodar,1160,5,9,4,7,28,26,2,31
Terek Grozny,1160,6,8,5,7,23,24,-1,29
Din Moscow,1160,7,6,7,7,19,22,-3,25
FK Rubin,1160,8,6,6,8,24,18,6,24
Rostov,1160,9,4,6,10,11,19,-8,18
Amkar,1160,10,4,5,11,11,26,-15,17
Anzhi,1160,11,3,6,11,19,41,-22,15
Loko Moscow,1161,1,11,6,3,30,13,17,39
Spart Moscow,1161,2,10,5,5,39,27,12,35
CSKA Moscow,1161,3,10,4,6,28,21,7,34
Zenit,1161,4,8,9,3,22,13,9,33
Krasnodar,1161,5,9,5,6,30,26,4,32
Terek Grozny,1161,6,7,6,7,21,27,-6,27
FK Rubin,1161,7,6,6,8,25,20,5,24
Rostov,1161,8,5,6,9,11,17,-6,21
Din Moscow,1161,9,5,6,9,19,28,-9,21
Amkar,1161,10,4,5,11,11,25,-14,17
Anzhi,1161,11,3,6,11,21,40,-19,15
Loko Moscow,1162,1,12,6,2,32,12,20,42
CSKA Moscow,1162,2,11,4,5,28,18,10,37
Spart Moscow,1162,3,10,5,5,37,26,11,35
Zenit,1162,4,7,10,3,23,15,8,31
Krasnodar,1162,5,8,5,7,28,27,1,29
Terek Grozny,1162,6,7,6,7,20,23,-3,27
Din Moscow,1162,7,6,6,8,20,23,-3,24
FK Rubin,1162,8,5,6,9,22,21,1,21
Amkar,1162,9,5,5,10,10,22,-12,20
Rostov,1162,10,4,6,10,10,19,-9,18
Anzhi,1162,11,3,5,12,15,39,-24,14
Loko Moscow,1163,1,12,5,3,31,12,19,41
CSKA Moscow,1163,2,11,3,6,27,19,8,36
Zenit,1163,3,9,8,3,23,13,10,35
Spart Moscow,1163,4,8,6,6,34,28,6,30
Krasnodar,1163,5,8,5,7,28,27,1,29
Terek Grozny,1163,6,7,5,8,22,26,-4,26
Din Moscow,1163,7,6,7,7,18,21,-3,25
FK Rubin,1163,8,5,7,8,22,18,4,22
Amkar,1163,9,6,4,10,13,24,-11,22
Rostov,1163,10,4,7,9,10,17,-7,19
Anzhi,1163,11,3,5,12,17,40,-23,14
Loko Moscow,1164,1,12,5,3,33,13,20,41
CSKA Moscow,1164,2,11,3,6,31,19,12,36
Zenit,1164,3,9,8,3,23,13,10,35
Spart Moscow,1164,4,8,8,4,36,28,8,32
Krasnodar,1164,5,8,5,7,29,29,0,29
Terek Grozny,1164,6,8,5,7,24,25,-1,29
FK Rubin,1164,7,6,6,8,26,20,6,24
Din Moscow,1164,8,5,7,8,20,26,-6,22
Amkar,1164,9,5,5,10,12,24,-12,20
Rostov,1164,10,4,7,9,11,18,-7,19
Anzhi,1164,11,2,5,13,16,46,-30,11
Loko Moscow,1165,1,12,5,3,31,16,15,41
CSKA Moscow,1165,2,11,4,5,26,17,9,37
Spart Moscow,1165,3,10,6,4,38,27,11,36
Zenit,1165,4,8,9,3,25,13,12,33
Krasnodar,1165,5,9,4,7,30,27,3,31
Terek Grozny,1165,6,7,7,6,22,24,-2,28
Din Moscow,1165,7,6,6,8,21,25,-4,24
FK Rubin,1165,8,5,5,10,23,22,1,20
Rostov,1165,9,4,7,9,11,18,-7,19
Amkar,1165,10,4,5,11,9,23,-14,17
Anzhi,1165,11,2,6,12,16,40,-24,12
Loko Moscow,1166,1,11,7,2,33,15,18,40
CSKA Moscow,1166,2,12,3,5,30,17,13,39
Terek Grozny,1166,3,9,5,6,26,25,1,32
Spart Moscow,1166,4,8,7,5,36,30,6,31
Zenit,1166,5,7,9,4,23,17,6,30
Krasnodar,1166,6,8,5,7,29,28,1,29
FK Rubin,1166,7,7,5,8,25,18,7,26
Din Moscow,1166,8,5,7,8,20,25,-5,22
Rostov,1166,9,5,6,9,12,17,-5,21
Amkar,1166,10,4,5,11,11,25,-14,17
Anzhi,1166,11,2,5,13,16,44,-28,11
Loko Moscow,1167,1,13,5,2,33,11,22,44
CSKA Moscow,1167,2,11,3,6,28,19,9,36
Spart Moscow,1167,3,10,5,5,38,28,10,35
Zenit,1167,4,8,8,4,23,16,7,32
Krasnodar,1167,5,8,4,8,29,29,0,28
Terek Grozny,1167,6,7,6,7,22,25,-3,27
Din Moscow,1167,7,6,6,8,20,23,-3,24
FK Rubin,1167,8,6,5,9,25,21,4,23
Amkar,1167,9,6,4,10,12,23,-11,22
Rostov,1167,10,4,6,10,10,19,-9,18
Anzhi,1167,11,2,6,12,16,42,-26,12
Loko Moscow,1168,1,13,5,2,32,12,20,44
CSKA Moscow,1168,2,12,3,5,31,19,12,39
Spart Moscow,1168,3,10,5,5,40,27,13,35
Zenit,1168,4,7,8,5,21,17,4,29
Krasnodar,1168,5,8,5,7,28,26,2,29
Terek Grozny,1168,6,7,6,7,22,26,-4,27
Din Moscow,1168,7,6,6,8,21,26,-5,24
FK Rubin,1168,8,5,6,9,22,21,1,21
Rostov,1168,9,5,6,9,11,17,-6,21
Amkar,1168,10,4,5,11,11,26,-15,17
Anzhi,1168,11,3,5,12,19,41,-22,14
Loko Moscow,1169,1,11,6,3,31,18,13,39
Spart Moscow,1169,2,11,5,4,43,31,12,38
CSKA Moscow,1169,3,10,5,5,28,20,8,35
Krasnodar,1169,4,10,4,6,34,25,9,34
Zenit,1169,5,7,10,3,23,15,8,31
Terek Grozny,1169,6,8,6,6,23,23,0,30
Din Moscow,1169,7,6,6,8,22,24,-2,24
FK Rubin,1169,8,5,5,10,21,21,0,20
Rostov,1169,9,4,6,10,13,21,-8,18
Amkar,1169,10,4,5,11,10,25,-15,17
Anzhi,1169,11,2,6,12,17,42,-25,12
Loko Moscow,1170,1,11,7,2,32,14,18,40
CSKA Moscow,1170,2,12,3,5,30,17,13,39
Zenit,1170,3,7,9,4,22,16,6,30
Krasnodar,1170,4,8,6,6,30,27,3,30
Spart Moscow,1170,5,8,5,7,36,32,4,29
Din Moscow,1170,6,7,6,7,20,22,-2,27
Terek Grozny,1170,7,7,6,7,22,26,-4,27
Amkar,1170,8,6,4,10,14,24,-10,22
FK Rubin,1170,9,5,6,9,22,19,3,21
Rostov,1170,10,5,6,9,13,18,-5,21
Anzhi,1170,11,2,6,12,15,41,-26,12
Loko Moscow,1171,1,12,6,2,34,15,19,42
CSKA Moscow,1171,2,12,3,5,29,17,12,39
Spart Moscow,1171,3,10,5,5,37,28,9,35
Zenit,1171,4,7,9,4,23,16,7,30
Terek Grozny,1171,5,8,5,7,22,24,-2,29
Krasnodar,1171,6,8,4,8,30,29,1,28
Din Moscow,1171,7,7,6,7,21,22,-1,27
FK Rubin,1171,8,6,5,9,23,19,4,23
Rostov,1171,9,4,6,10,10,19,-9,18
Amkar,1171,10,4,4,12,10,25,-15,16
Anzhi,1171,11,3,5,12,15,40,-25,14
Loko Moscow,1172,1,12,5,3,32,14,18,41
CSKA Moscow,1172,2,10,4,6,25,18,7,34
Zenit,1172,3,8,8,4,23,15,8,32
Spart Moscow,1172,4,8,7,5,37,30,7,31
Krasnodar,1172,5,9,4,7,30,28,2,31
Terek Grozny,1172,6,7,6,7,20,23,-3,27
FK Rubin,1172,7,6,6,8,24,18,6,24
Din Moscow,1172,8,5,8,7,19,23,-4,23
Amkar,1172,9,5,5,10,11,23,-12,20
Rostov,1172,10,4,7,9,11,18,-7,19
Anzhi,1172,11,3,6,11,15,37,-22,15
Loko Moscow,1173,1,12,6,2,33,13,20,42
Spart Moscow,1173,2,10,6,4,41,28,13,36
CSKA Moscow,1173,3,11,3,6,26,18,8,36
Zenit,1173,4,8,8,4,23,16,7,32
Krasnodar,1173,5,9,5,6,29,25,4,32
Terek Grozny,1173,6,7,6,7,22,27,-5,27
Din Moscow,1173,7,5,8,7,19,23,-4,23
FK Rubin,1173,8,5,6,9,21,18,3,21
Amkar,1173,9,5,4,11,12,23,-11,19
Rostov,1173,10,4,6,10,11,22,-11,18
Anzhi,1173,11,2,6,12,16,40,-24,12
Loko Moscow,1174,1,12,6,2,31,12,19,42
Spart Moscow,1174,2,10,6,4,42,28,14,36
CSKA Moscow,1174,3,11,3,6,27,19,8,36
Krasnodar,1174,4,9,4,7,30,27,3,31
Zenit,1174,5,7,9,4,23,16,7,30
Terek Grozny,1174,6,8,5,7,22,25,-3,29
Din Moscow,1174,7,6,6,8,19,23,-4,24
FK Rubin,1174,8,5,5,10,23,21,2,20
Amkar,1174,9,5,5,10,12,23,-11,20
Rostov,1174,10,4,6,10,11,23,-12,18
Anzhi,1174,11,3,5,12,16,39,-23,14
Loko Moscow,1175,1,11,5,4,30,15,15,38
CSKA Moscow,1175,2,11,3,6,27,21,6,36
Zenit,1175,3,9,8,3,28,14,14,35
Krasnodar,1175,4,10,4,6,30,25,5,34
Spart Moscow,1175,5,9,6,5,39,29,10,33
Terek Grozny,1175,6,8,5,7,21,24,-3,29
Din Moscow,1175,7,5,7,8,19,26,-7,22
Amkar,1175,8,6,4,10,12,22,-10,22
FK Rubin,1175,9,5,6,9,22,19,3,21
Rostov,1175,10,4,7,9,11,18,-7,19
Anzhi,1175,11,2,5,13,14,40,-26,11
Loko Moscow,1176,1,11,6,3,29,13,16,39
CSKA Moscow,1176,2,11,3,6,27,18,9,36
Zenit,1176,3,8,9,3,22,13,9,33
Krasnodar,1176,4,9,5,6,30,25,5,32
Terek Grozny,1176,5,9,5,6,26,25,1,32
Spart Moscow,1176,6,8,6,6,35,30,5,30
Din Moscow,1176,7,7,6,7,21,22,-1,27
FK Rubin,1176,8,5,6,9,22,20,2,21
Rostov,1176,9,4,7,9,11,18,-7,19
Amkar,1176,10,5,4,11,12,25,-13,19
Anzhi,1176,11,2,5,13,16,42,-26,11
Loko Moscow,1177,1,11,6,3,30,13,17,39
CSKA Moscow,1177,2,10,4,6,26,20,6,34
Spart Moscow,1177,3,9,6,5,37,28,9,33
Zenit,1177,4,8,9,3,23,14,9,33
Krasnodar,1177,5,9,5,6,28,24,4,32
Terek Grozny,1177,6,8,6,6,23,24,-1,30
Din Moscow,1177,7,6,6,8,21,25,-4,24
Rostov,1177,8,5,6,9,11,17,-6,21
FK Rubin,1177,9,5,5,10,22,21,1,20
Amkar,1177,10,4,6,10,11,24,-13,18
Anzhi,1177,11,3,5,12,18,40,-22,14
Loko Moscow,1178,1,11,6,3,30,15,15,39
CSKA Moscow,1178,2,11,3,6,28,19,9,36
Spart Moscow,1178,3,9,7,4,38,27,11,34
Krasnodar,1178,4,9,4,7,30,26,4,31
Zenit,1178,5,7,9,4,23,17,6,30
Terek Grozny,1178,6,8,5,7,22,24,-2,29
FK Rubin,1178,7,7,5,8,25,17,8,26
Din Moscow,1178,8,5,6,9,17,26,-9,21
Amkar,1178,9,5,5,10,12,24,-12,20
Rostov,1178,10,4,7,9,11,18,-7,19
Anzhi,1178,11,3,5,12,15,38,-23,14
Loko Moscow,1179,1,11,5,4,30,15,15,38
CSKA Moscow,1179,2,11,3,6,26,18,8,36
Zenit,1179,3,9,8,3,24,13,11,35
Spart Moscow,1179,4,9,7,4,37,28,9,34
Krasnodar,1179,5,10,4,6,32,26,6,34
Terek Grozny,1179,6,8,5,7,21,23,-2,29
Din Moscow,1179,7,5,8,7,19,23,-4,23
FK Rubin,1179,8,5,6,9,23,21,2,21
Rostov,1179,9,4,6,10,11,19,-8,18
Amkar,1179,10,4,5,11,10,24,-14,17
Anzhi,1179,11,3,5,12,15,38,-23,14
Loko Moscow,1180,1,12,5,3,30,12,18,41
Spart Moscow,1180,2,10,5,5,40,31,9,35
CSKA Moscow,1180,3,10,4,6,27,20,7,34
Krasnodar,1180,4,10,4,6,29,24,5,34
Zenit,1180,5,7,9,4,22,15,7,30
Terek Grozny,1180,6,7,5,8,21,27,-6,26
FK Rubin,1180,7,6,5,9,22,18,4,23
Amkar,1180,8,6,4,10,12,22,-10,22
Din Moscow,1180,9,5,6,9,20,26,-6,21
Rostov,1180,10,4,6,10,12,20,-8,18
Anzhi,1180,11,4,5,11,19,39,-20,17
Loko Moscow,1181,1,12,6,2,33,13,20,42
CSKA Moscow,1181,2,10,4,6,26,21,5,34
Zenit,1181,3,8,9,3,25,14,11,33
Spart Moscow,1181,4,9,5,6,40,31,9,32
Krasnodar,1181,5,9,4,7,31,28,3,31
Terek Grozny,1181,6,8,5,7,22,24,-2,29
Din Moscow,1181,7,6,6,8,18,24,-6,24
Rostov,1181,8,5,6,9,13,19,-6,21
FK Rubin,1181,9,5,5,10,22,21,1,20
Amkar,1181,10,5,4,11,13,26,-13,19
Anzhi,1181,11,3,6,11,16,38,-22,15
Loko Moscow,1182,1,11,5,4,29,14,15,38
CSKA Moscow,1182,2,11,3,6,28,22,6,36
Zenit,1182,3,9,8,3,27,14,13,35
Krasnodar,1182,4,10,4,6,30,24,6,34
Spart Moscow,1182,5,9,5,6,38,29,9,32
Terek Grozny,1182,6,9,5,6,25,24,1,32
Din Moscow,1182,7,6,6,8,18,25,-7,24
Rostov,1182,8,5,6,9,11,17,-6,21
FK Rubin,1182,9,5,5,10,21,19,2,20
Amkar,1182,10,5,4,11,13,26,-13,19
Anzhi,1182,11,2,5,13,15,41,-26,11
Loko Moscow,1183,1,12,5,3,32,14,18,41
CSKA Moscow,1183,2,11,4,5,26,17,9,37
Zenit,1183,3,8,8,4,23,15,8,32
Spart Moscow,1183,4,9,5,6,35,28,7,32
Krasnodar,1183,5,9,4,7,32,27,5,31
Terek Grozny,1183,6,8,5,7,25,23,2,29
Din Moscow,1183,7,6,7,7,19,22,-3,25
FK Rubin,1183,8,5,6,9,23,22,1,21
Rostov,1183,9,5,6,9,11,17,-6,21
Amkar,1183,10,4,4,12,10,29,-19,16
Anzhi,1183,11,3,6,11,15,37,-22,15
Loko Moscow,1184,1,12,6,2,31,12,19,42
Spart Moscow,1184,2,10,6,4,37,26,11,36
CSKA Moscow,1184,3,11,3,6,27,18,9,36
Zenit,1184,4,8,8,4,22,14,8,32
Krasnodar,1184,5,8,5,7,28,26,2,29
Terek Grozny,1184,6,8,5,7,24,24,0,29
Din Moscow,1184,7,6,7,7,19,22,-3,25
FK Rubin,1184,8,6,5,9,23,19,4,23
Amkar,1184,9,5,4,11,12,26,-14,19
Rostov,1184,10,4,6,10,10,18,-8,18
Anzhi,1184,11,2,5,13,14,42,-28,11
Loko Moscow,1185,1,13,5,2,32,12,20,44
CSKA Moscow,1185,2,12,3,5,29,18,11,39
Spart Moscow,1185,3,9,5,6,36,29,7,32
Zenit,1185,4,7,8,5,23,17,6,29
Krasnodar,1185,5,8,5,7,29,27,2,29
Terek Grozny,1185,6,7,5,8,21,25,-4,26
Din Moscow,1185,7,6,7,7,19,22,-3,25
FK Rubin,1185,8,5,7,8,24,20,4,22
Amkar,1185,9,6,4,10,11,22,-11,22
Rostov,1185,10,4,6,10,12,20,-8,18
Anzhi,1185,11,3,5,12,16,40,-24,14
Loko Moscow,1186,1,11,6,3,32,15,17,39
CSKA Moscow,1186,2,11,4,5,27,17,10,37
Spart Moscow,1186,3,9,7,4,39,26,13,34
Zenit,1186,4,8,9,3,23,14,9,33
Krasnodar,1186,5,8,6,6,30,27,3,30
Terek Grozny,1186,6,8,6,6,22,23,-1,30
Din Moscow,1186,7,6,6,8,19,26,-7,24
FK Rubin,1186,8,5,6,9,22,20,2,21
Rostov,1186,9,4,7,9,11,18,-7,19
Amkar,1186,10,4,5,11,9,23,-14,17
Anzhi,1186,11,2,6,12,15,40,-25,12
Loko Moscow,1187,1,11,7,2,31,13,18,40
CSKA Moscow,1187,2,11,4,5,29,20,9,37
Spart Moscow,1187,3,10,5,5,37,28,9,35
Zenit,1187,4,7,10,3,23,15,8,31
Krasnodar,1187,5,8,6,6,29,26,3,30
Terek Grozny,1187,6,8,6,6,22,23,-1,30
Din Moscow,1187,7,6,6,8,21,24,-3,24
FK Rubin,1187,8,5,6,9,22,20,2,21
Amkar,1187,9,5,5,10,11,23,-12,20
Rostov,1187,10,4,6,10,10,18,-8,18
Anzhi,1187,11,2,5,13,16,41,-25,11
Loko Moscow,1188,1,13,5,2,34,11,23,44
CSKA Moscow,1188,2,11,4,5,31,20,11,37
Spart Moscow,1188,3,10,6,4,38,27,11,36
Zenit,1188,4,7,9,4,22,15,7,30
Terek Grozny,1188,5,8,6,6,23,23,0,30
Krasnodar,1188,6,8,5,7,27,28,-1,29
FK Rubin,1188,7,6,6,8,23,18,5,24
Din Moscow,1188,8,5,6,9,18,24,-6,21
Rostov,1188,9,4,6,10,11,20,-9,18
Amkar,1188,10,4,6,10,10,23,-13,18
Anzhi,1188,11,2,5,13,17,45,-28,11
Loko Moscow,1189,1,12,5,3,32,13,19,41
CSKA Moscow,1189,2,11,4,5,29,17,12,37
Spart Moscow,1189,3,10,6,4,39,28,11,36
Krasnodar,1189,4,10,4,6,30,25,5,34
Zenit,1189,5,7,9,4,21,15,6,30
Terek Grozny,1189,6,7,6,7,21,24,-3,27
FK Rubin,1189,7,6,5,9,24,19,5,23
Din Moscow,1189,8,5,6,9,19,26,-7,21
Amkar,1189,9,5,5,10,11,23,-12,20
Rostov,1189,10,4,6,10,11,20,-9,18
Anzhi,1189,11,2,6,12,15,42,-27,12
Loko Moscow,1190,1,11,6,3,30,13,17,39
Spart Moscow,1190,2,10,6,4,41,25,16,36
CSKA Moscow,1190,3,11,3,6,30,20,10,36
Zenit,1190,4,9,8,3,26,14,12,35
Krasnodar,1190,5,9,5,6,29,25,4,32
Terek Grozny,1190,6,7,6,7,21,24,-3,27
FK Rubin,1190,7,6,5,9,23,19,4,23
Din Moscow,1190,8,5,6,9,17,24,-7,21
Rostov,1190,9,4,7,9,10,17,-7,19
Amkar,1190,10,5,4,11,11,29,-18,19
Anzhi,1190,11,2,6,12,14,42,-28,12
Loko Moscow,1191,1,13,5,2,33,13,20,44
CSKA Moscow,1191,2,11,3,6,27,18,9,36
Spart Moscow,1191,3,9,7,4,39,29,10,34
Zenit,1191,4,8,8,4,23,15,8,32
Krasnodar,1191,5,8,4,8,28,27,1,28
Terek Grozny,1191,6,7,6,7,20,23,-3,27
FK Rubin,1191,7,6,6,8,23,18,5,24
Din Moscow,1191,8,5,8,7,19,23,-4,23
Rostov,1191,9,4,7,9,13,20,-7,19
Amkar,1191,10,4,5,11,9,24,-15,17
Anzhi,1191,11,3,5,12,15,39,-24,14
Loko Moscow,1192,1,11,7,2,32,14,18,40
CSKA Moscow,1192,2,12,3,5,30,18,12,39
Spart Moscow,1192,3,10,6,4,38,28,10,36
Krasnodar,1192,4,9,5,6,30,26,4,32
Terek Grozny,1192,5,9,5,6,25,24,1,32
Zenit,1192,6,7,9,4,23,16,7,30
Din Moscow,1192,7,6,6,8,21,25,-4,24
FK Rubin,1192,8,5,5,10,22,20,2,20
Rostov,1192,9,4,7,9,11,18,-7,19
Amkar,1192,10,4,4,12,10,25,-15,16
Anzhi,1192,11,2,5,13,15,43,-28,11
Loko Moscow,1193,1,12,5,3,32,14,18,41
CSKA Moscow,1193,2,11,3,6,27,20,7,36
Spart Moscow,1193,3,9,6,5,38,31,7,33
Zenit,1193,4,8,8,4,24,15,9,32
Krasnodar,1193,5,9,4,7,31,28,3,31
Terek Grozny,1193,6,8,6,6,23,23,0,30
FK Rubin,1193,7,6,5,9,26,20,6,23
Din Moscow,1193,8,5,7,8,20,28,-8,22
Amkar,1193,9,5,4,11,12,25,-13,19
Rostov,1193,10,4,6,10,11,19,-8,18
Anzhi,1193,11,3,6,11,16,37,-21,15
Loko Moscow,1194,1,11,6,3,31,14,17,39
CSKA Moscow,1194,2,10,4,6,28,22,6,34
Zenit,1194,3,8,9,3,26,16,10,33
Krasnodar,1194,4,9,5,6,29,25,4,32
Terek Grozny,1194,5,9,5,6,22,22,0,32
Spart Moscow,1194,6,8,6,6,35,33,2,30
FK Rubin,1194,7,6,6,8,24,18,6,24
Din Moscow,1194,8,6,6,8,21,25,-4,24
Rostov,1194,9,5,6,9,14,17,-3,21
Amkar,1194,10,4,5,11,9,23,-14,17
Anzhi,1194,11,2,6,12,16,40,-24,12
Loko Moscow,1195,1,12,6,2,31,12,19,42
CSKA Moscow,1195,2,11,4,5,28,19,9,37
Spart Moscow,1195,3,9,6,5,37,28,9,33
Zenit,1195,4,7,10,3,23,15,8,31
Krasnodar,1195,5,8,4,8,27,26,1,28
FK Rubin,1195,6,7,5,8,24,17,7,26
Terek Grozny,1195,7,7,5,8,22,26,-4,26
Din Moscow,1195,8,6,6,8,19,23,-4,24
Amkar,1195,9,5,5,10,13,25,-12,20
Rostov,1195,10,4,6,10,10,20,-10,18
Anzhi,1195,11,3,5,12,16,39,-23,14
Loko Moscow,1196,1,11,6,3,29,12,17,39
Spart Moscow,1196,2,10,6,4,40,28,12,36
Krasnodar,1196,3,10,4,6,29,24,5,34
CSKA Moscow,1196,4,10,4,6,27,22,5,34
Zenit,1196,5,8,9,3,24,13,11,33
Terek Grozny,1196,6,8,5,7,21,23,-2,29
Din Moscow,1196,7,6,6,8,21,25,-4,24
FK Rubin,1196,8,5,5,10,21,21,0,20
Rostov,1196,9,4,6,10,11,19,-8,18
Amkar,1196,10,4,5,11,10,24,-14,17
Anzhi,1196,11,3,6,11,17,39,-22,15
Loko Moscow,1197,1,12,5,3,31,12,19,41
CSKA Moscow,1197,2,12,3,5,28,18,10,39
Spart Moscow,1197,3,10,6,4,39,27,12,36
Krasnodar,1197,4,10,4,6,29,24,5,34
Zenit,1197,5,7,8,5,22,17,5,29
Terek Grozny,1197,6,8,5,7,22,24,-2,29
Din Moscow,1197,7,6,6,8,20,23,-3,24
FK Rubin,1197,8,5,5,10,21,20,1,20
Rostov,1197,9,4,6,10,11,21,-10,18
Amkar,1197,10,4,5,11,10,24,-14,17
Anzhi,1197,11,3,5,12,15,38,-23,14
Loko Moscow,1198,1,12,6,2,33,14,19,42
Spart Moscow,1198,2,11,5,4,36,25,11,38
CSKA Moscow,1198,3,11,4,5,27,17,10,37
Zenit,1198,4,7,10,3,22,14,8,31
Krasnodar,1198,5,8,5,7,31,29,2,29
Terek Grozny,1198,6,8,5,7,22,24,-2,29
FK Rubin,1198,7,6,6,8,27,20,7,24
Din Moscow,1198,8,5,6,9,18,26,-8,21
Amkar,1198,9,5,4,11,10,23,-13,19
Rostov,1198,10,4,6,10,10,18,-8,18
Anzhi,1198,11,2,5,13,15,41,-26,11
Loko Moscow,1199,1,12,6,2,32,13,19,42
Spart Moscow,1199,2,10,6,4,38,28,10,36
CSKA Moscow,1199,3,11,3,6,28,20,8,36
Zenit,1199,4,8,9,3,24,15,9,33
Krasnodar,1199,5,8,5,7,29,27,2,29
Terek Grozny,1199,6,7,6,7,23,27,-4,27
Din Moscow,1199,7,6,6,8,20,23,-3,24
FK Rubin,1199,8,5,6,9,22,20,2,21
Rostov,1199,9,4,7,9,10,17,-7,19
Amkar,1199,10,5,4,11,15,27,-12,19
Anzhi,1199,11,2,6,12,16,40,-24,12
Loko Moscow,1200,1,12,5,3,33,16,17,41
CSKA Moscow,1200,2,11,3,6,26,20,6,36
Zenit,1200,3,9,8,3,27,14,13,35
Spart Moscow,1200,4,9,7,4,37,26,11,34
Terek Grozny,1200,5,8,6,6,21,22,-1,30
Krasnodar,1200,6,8,4,8,29,29,0,28
FK Rubin,1200,7,7,5,8,26,18,8,26
Din Moscow,1200,8,5,6,9,18,27,-9,21
Rostov,1200,9,4,7,9,11,18,-7,19
Amkar,1200,10,4,6,10,9,22,-13,18
Anzhi,1200,11,2,5,13,14,39,-25,11
Loko Moscow,1201,1,13,5,2,36,13,23,44
CSKA Moscow,1201,2,11,4,5,29,18,11,37
Krasnodar,1201,3,9,4,7,29,28,1,31
Zenit,1201,4,7,9,4,23,17,6,30
Spart Moscow,1201,5,8,6,6,34,30,4,30
Terek Grozny,1201,6,7,5,8,20,24,-4,26
Din Moscow,1201,7,6,7,7,20,22,-2,25
Amkar,1201,8,6,4,10,12,22,-10,22
FK Rubin,1201,9,5,6,9,22,19,3,21
Rostov,1201,10,4,7,9,11,18,-7,19
Anzhi,1201,11,3,5,12,15,40,-25,14
Loko Moscow,1202,1,12,6,2,32,12,20,42
Spart Moscow,1202,2,11,5,4,40,29,11,38
CSKA Moscow,1202,3,11,3,6,28,19,9,36
Zenit,1202,4,8,8,4,22,15,7,32
Krasnodar,1202,5,9,5,6,32,26,6,32
Terek Grozny,1202,6,8,5,7,22,24,-2,29
Din Moscow,1202,7,5,7,8,18,23,-5,22
FK Rubin,1202,8,5,6,9,22,21,1,21
Rostov,1202,9,4,6,10,11,19,-8,18
Amkar,1202,10,4,4,12,11,26,-15,16
Anzhi,1202,11,3,5,12,17,41,-24,14
Loko Moscow,1203,1,11,7,2,32,14,18,40
CSKA Moscow,1203,2,12,3,5,32,19,13,39
Spart Moscow,1203,3,10,5,5,37,27,10,35
Terek Grozny,1203,4,9,5,6,22,22,0,32
Zenit,1203,5,7,9,4,23,18,5,30
Krasnodar,1203,6,8,6,6,30,27,3,30
FK Rubin,1203,7,6,6,8,24,18,6,24
Din Moscow,1203,8,6,6,8,18,23,-5,24
Rostov,1203,9,4,6,10,11,20,-9,18
Amkar,1203,10,4,4,12,9,24,-15,16
Anzhi,1203,11,2,5,13,15,41,-26,11
Loko Moscow,1204,1,12,5,3,32,13,19,41
CSKA Moscow,1204,2,11,4,5,31,18,13,37
Spart Moscow,1204,3,10,5,5,40,30,10,35
Zenit,1204,4,8,9,3,24,15,9,33
Krasnodar,1204,5,8,5,7,27,26,1,29
Terek Grozny,1204,6,7,7,6,22,24,-2,28
FK Rubin,1204,7,5,7,8,21,17,4,22
Din Moscow,1204,8,5,7,8,18,24,-6,22
Rostov,1204,9,5,6,9,14,20,-6,21
Amkar,1204,10,4,5,11,9,23,-14,17
Anzhi,1204,11,2,6,12,16,44,-28,12
Loko Moscow,1205,1,12,6,2,32,12,20,42
CSKA Moscow,1205,2,11,4,5,30,21,9,37
Spart Moscow,1205,3,10,5,5,42,31,11,35
Krasnodar,1205,4,9,4,7,29,27,2,31
Zenit,1205,5,7,9,4,24,17,7,30
Terek Grozny,1205,6,7,6,7,21,24,-3,27
Din Moscow,1205,7,6,6,8,20,27,-7,24
Rostov,1205,8,5,6,9,12,17,-5,21
FK Rubin,1205,9,5,5,10,22,20,2,20
Amkar,1205,10,5,4,11,13,26,-13,19
Anzhi,1205,11,2,7,11,16,39,-23,13
Loko Moscow,1206,1,11,6,3,32,17,15,39
Spart Moscow,1206,2,10,6,4,38,26,12,36
Zenit,1206,3,9,8,3,29,15,14,35
CSKA Moscow,1206,4,10,4,6,27,22,5,34
Krasnodar,1206,5,8,6,6,30,27,3,30
Terek Grozny,1206,6,8,5,7,22,24,-2,29
FK Rubin,1206,7,5,7,8,23,19,4,22
Din Moscow,1206,8,5,7,8,18,24,-6,22
Amkar,1206,9,5,5,10,11,23,-12,20
Rostov,1206,10,4,6,10,10,19,-9,18
Anzhi,1206,11,2,6,12,16,40,-24,12
Loko Moscow,1207,1,11,6,3,31,15,16,39
CSKA Moscow,1207,2,11,3,6,27,21,6,36
Spart Moscow,1207,3,9,6,5,38,30,8,33
Zenit,1207,4,8,8,4,25,16,9,32
Krasnodar,1207,5,8,6,6,30,27,3,30
Terek Grozny,1207,6,8,6,6,22,23,-1,30
FK Rubin,1207,7,6,6,8,24,19,5,24
Din Moscow,1207,8,5,7,8,19,24,-5,22
Amkar,1207,9,5,5,10,12,24,-12,20
Rostov,1207,10,4,6,10,11,19,-8,18
Anzhi,1207,11,3,5,12,17,38,-21,14
Loko Moscow,1208,1,13,5,2,33,12,21,44
Spart Moscow,1208,2,11,5,4,38,27,11,38
CSKA Moscow,1208,3,11,3,6,28,20,8,36
Krasnodar,1208,4,9,4,7,35,27,8,31
Zenit,1208,5,7,8,5,22,18,4,29
Terek Grozny,1208,6,7,5,8,20,25,-5,26
Din Moscow,1208,7,6,6,8,21,23,-2,24
FK Rubin,1208,8,5,5,10,22,27,-5,20
Amkar,1208,9,5,4,11,11,24,-13,19
Rostov,1208,10,4,6,10,10,18,-8,18
Anzhi,1208,11,4,5,11,18,37,-19,17
Loko Moscow,1209,1,11,6,3,30,14,16,39
CSKA Moscow,1209,2,12,3,5,28,18,10,39
Krasnodar,1209,3,9,4,7,30,28,2,31
Zenit,1209,4,7,9,4,21,14,7,30
Spart Moscow,1209,5,8,6,6,35,29,6,30
Terek Grozny,1209,6,8,5,7,22,24,-2,29
FK Rubin,1209,7,6,6,8,25,18,7,24
Din Moscow,1209,8,5,8,7,19,23,-4,23
Amkar,1209,9,6,4,10,11,22,-11,22
Rostov,1209,10,5,6,9,12,18,-6,21
Anzhi,1209,11,2,5,13,16,41,-25,11
Loko Moscow,1210,1,11,7,2,30,12,18,40
Spart Moscow,1210,2,10,5,5,40,27,13,35
CSKA Moscow,1210,3,10,5,5,27,19,8,35
Krasnodar,1210,4,9,5,6,30,25,5,32
Terek Grozny,1210,5,9,5,6,23,22,1,32
Zenit,1210,6,7,10,3,23,15,8,31
FK Rubin,1210,7,6,5,9,24,20,4,23
Rostov,1210,8,5,6,9,12,18,-6,21
Din Moscow,1210,9,5,6,9,17,26,-9,21
Amkar,1210,10,4,4,12,9,27,-18,16
Anzhi,1210,11,2,6,12,15,39,-24,12
Loko Moscow,1211,1,11,7,2,30,12,18,40
CSKA Moscow,1211,2,12,3,5,28,17,11,39
Spart Moscow,1211,3,11,5,4,40,26,14,38
Zenit,1211,4,7,9,4,21,14,7,30
Krasnodar,1211,5,8,6,6,28,25,3,30
Terek Grozny,1211,6,7,6,7,22,25,-3,27
FK Rubin,1211,7,6,6,8,22,17,5,24
Din Moscow,1211,8,5,6,9,18,26,-8,21
Amkar,1211,9,5,4,11,11,25,-14,19
Rostov,1211,10,4,6,10,10,18,-8,18
Anzhi,1211,11,2,6,12,15,40,-25,12
Loko Moscow,1212,1,12,5,3,31,13,18,41
CSKA Moscow,1212,2,11,3,6,27,21,6,36
Spart Moscow,1212,3,9,7,4,38,29,9,34
Zenit,1212,4,8,8,4,24,14,10,32
Krasnodar,1212,5,9,5,6,29,25,4,32
Terek Grozny,1212,6,8,5,7,23,23,0,29
FK Rubin,1212,7,5,7,8,21,17,4,22
Din Moscow,1212,8,5,7,8,18,23,-5,22
Amkar,1212,9,5,5,10,11,23,-12,20
Rostov,1212,10,4,7,9,12,19,-7,19
Anzhi,1212,11,2,5,13,15,42,-27,11
Loko Moscow,1213,1,12,6,2,32,13,19,42
CSKA Moscow,1213,2,12,3,5,29,18,11,39
Spart Moscow,1213,3,11,5,4,42,27,15,38
Krasnodar,1213,4,8,6,6,27,24,3,30
Zenit,1213,5,7,8,5,24,18,6,29
Terek Grozny,1213,6,7,5,8,20,26,-6,26
Din Moscow,1213,7,6,6,8,19,23,-4,24
FK Rubin,1213,8,5,6,9,21,18,3,21
Amkar,1213,9,5,4,11,11,24,-13,19
Rostov,1213,10,4,6,10,11,22,-11,18
Anzhi,1213,11,3,5,12,16,39,-23,14
Loko Moscow,1214,1,12,6,2,33,11,22,42
CSKA Moscow,1214,2,12,3,5,28,18,10,39
Spart Moscow,1214,3,10,6,4,36,26,10,36
Krasnodar,1214,4,9,5,6,30,25,5,32
Zenit,1214,5,7,8,5,21,18,3,29
Terek Grozny,1214,6,7,6,7,21,24,-3,27
FK Rubin,1214,7,6,5,9,24,20,4,23
Din Moscow,1214,8,5,6,9,17,24,-7,21
Amkar,1214,9,5,5,10,11,23,-12,20
Rostov,1214,10,4,6,10,10,18,-8,18
Anzhi,1214,11,2,6,12,16,40,-24,12
Loko Moscow,1215,1,13,5,2,35,12,23,44
CSKA Moscow,1215,2,11,3,6,30,20,10,36
Spart Moscow,1215,3,10,5,5,38,31,7,35
Zenit,1215,4,8,8,4,24,19,5,32
Krasnodar,1215,5,9,4,7,30,27,3,31
Terek Grozny,1215,6,7,5,8,20,25,-5,26
Din Moscow,1215,7,6,6,8,22,24,-2,24
Amkar,1215,8,6,4,10,15,22,-7,22
FK Rubin,1215,9,5,5,10,22,22,0,20
Rostov,1215,10,4,6,10,10,19,-9,18
Anzhi,1215,11,3,5,12,15,40,-25,14
Loko Moscow,1216,1,11,5,4,30,15,15,38
CSKA Moscow,1216,2,11,4,5,33,19,14,37
Spart Moscow,1216,3,9,7,4,37,27,10,34
Zenit,1216,4,8,9,3,24,14,10,33
Krasnodar,1216,5,9,5,6,29,25,4,32
Terek Grozny,1216,6,9,5,6,24,22,2,32
Din Moscow,1216,7,6,7,7,18,21,-3,25
FK Rubin,1216,8,5,6,9,21,18,3,21
Rostov,1216,9,4,7,9,11,18,-7,19
Amkar,1216,10,4,4,12,10,26,-16,16
Anzhi,1216,11,2,5,13,15,47,-32,11
Loko Moscow,1217,1,11,7,2,29,11,18,40
Spart Moscow,1217,2,11,5,4,39,26,13,38
CSKA Moscow,1217,3,10,4,6,26,19,7,34
Terek Grozny,1217,4,9,5,6,25,23,2,32
Zenit,1217,5,7,10,3,22,14,8,31
Krasnodar,1217,6,8,6,6,28,25,3,30
FK Rubin,1217,7,5,7,8,22,18,4,22
Din Moscow,1217,8,5,7,8,18,24,-6,22
Rostov,1217,9,4,6,10,10,18,-8,18
Amkar,1217,10,4,4,12,10,27,-17,16
Anzhi,1217,11,3,5,12,15,39,-24,14
Loko Moscow,1218,1,13,5,2,34,13,21,44
Spart Moscow,1218,2,10,5,5,37,28,9,35
CSKA Moscow,1218,3,10,3,7,25,19,6,33
Zenit,1218,4,8,8,4,24,16,8,32
Krasnodar,1218,5,9,4,7,30,27,3,31
Terek Grozny,1218,6,7,5,8,21,25,-4,26
Din Moscow,1218,7,5,7,8,17,22,-5,22
Amkar,1218,8,6,4,10,13,24,-11,22
FK Rubin,1218,9,5,6,9,22,20,2,21
Rostov,1218,10,4,6,10,10,18,-8,18
Anzhi,1218,11,4,5,11,17,38,-21,17
Loko Moscow,1219,1,12,6,2,33,13,20,42
CSKA Moscow,1219,2,11,4,5,29,17,12,37
Zenit,1219,3,7,9,4,22,18,4,30
Spart Moscow,1219,4,8,5,7,34,30,4,29
Krasnodar,1219,5,8,4,8,29,30,-1,28
Din Moscow,1219,6,7,6,7,22,23,-1,27
Terek Grozny,1219,7,7,5,8,20,24,-4,26
FK Rubin,1219,8,6,5,9,25,21,4,23
Amkar,1219,9,6,4,10,11,22,-11,22
Rostov,1219,10,5,6,9,12,17,-5,21
Anzhi,1219,11,3,6,11,15,37,-22,15
Loko Moscow,1220,1,11,6,3,30,14,16,39
CSKA Moscow,1220,2,11,3,6,29,22,7,36
Spart Moscow,1220,3,9,6,5,39,31,8,33
Zenit,1220,4,8,8,4,23,15,8,32
Krasnodar,1220,5,9,5,6,31,26,5,32
Terek Grozny,1220,6,8,6,6,25,25,0,30
Din Moscow,1220,7,5,8,7,20,24,-4,23
FK Rubin,1220,8,5,6,9,23,21,2,21
Rostov,1220,9,5,6,9,12,18,-6,21
Amkar,1220,10,4,4,12,12,28,-16,16
Anzhi,1220,11,3,6,11,21,41,-20,15
Loko Moscow,1221,1,11,6,3,30,13,17,39
CSKA Moscow,1221,2,12,3,5,28,18,10,39
Spart Moscow,1221,3,10,5,5,39,31,8,35
Zenit,1221,4,8,8,4,23,15,8,32
Krasnodar,1221,5,9,5,6,29,25,4,32
Terek Grozny,1221,6,8,5,7,22,25,-3,29
Din Moscow,1221,7,5,7,8,18,23,-5,22
Amkar,1221,8,6,4,10,17,24,-7,22
FK Rubin,1221,9,5,6,9,21,18,3,21
Rostov,1221,10,4,6,10,10,20,-10,18
Anzhi,1221,11,2,5,13,14,39,-25,11
Loko Moscow,1222,1,13,5,2,33,12,21,44
CSKA Moscow,1222,2,11,4,5,28,18,10,37
Spart Moscow,1222,3,10,6,4,37,26,11,36
Zenit,1222,4,7,9,4,22,15,7,30
Krasnodar,1222,5,8,4,8,28,28,0,28
Terek Grozny,1222,6,7,6,7,20,24,-4,27
FK Rubin,1222,7,7,5,8,24,18,6,26
Din Moscow,1222,8,5,6,9,17,24,-7,21
Rostov,1222,9,4,6,10,10,18,-8,18
Amkar,1222,10,4,6,10,10,23,-13,18
Anzhi,1222,11,3,5,12,17,40,-23,14
Loko Moscow,1223,1,12,5,3,33,14,19,41
Spart Moscow,1223,2,10,6,4,39,25,14,36
CSKA Moscow,1223,3,11,3,6,27,18,9,36
Zenit,1223,4,9,8,3,24,14,10,35
Krasnodar,1223,5,9,4,7,31,29,2,31
Terek Grozny,1223,6,7,6,7,22,27,-5,27
FK Rubin,1223,7,6,5,9,25,21,4,23
Din Moscow,1223,8,5,6,9,18,25,-7,21
Rostov,1223,9,4,7,9,10,17,-7,19
Amkar,1223,10,5,4,11,12,26,-14,19
Anzhi,1223,11,2,6,12,16,41,-25,12
Loko Moscow,1224,1,12,5,3,32,14,18,41
CSKA Moscow,1224,2,12,3,5,32,22,10,39
Spart Moscow,1224,3,10,6,4,40,27,13,36
Krasnodar,1224,4,9,5,6,30,26,4,32
Zenit,1224,5,7,8,5,24,18,6,29
Terek Grozny,1224,6,7,6,7,21,25,-4,27
FK Rubin,1224,7,5,7,8,23,19,4,22
Din Moscow,1224,8,5,7,8,19,24,-5,22
Amkar,1224,9,5,5,10,13,24,-11,20
Rostov,1224,10,4,6,10,10,21,-11,18
Anzhi,1224,11,2,6,12,17,41,-24,12
Loko Moscow,1225,1,11,6,3,31,14,17,39
CSKA Moscow,1225,2,11,3,6,28,20,8,36
Krasnodar,1225,3,10,4,6,31,26,5,34
Spart Moscow,1225,4,9,6,5,40,30,10,33
Zenit,1225,5,8,9,3,23,14,9,33
Terek Grozny,1225,6,8,5,7,22,24,-2,29
Din Moscow,1225,7,5,8,7,19,23,-4,23
Amkar,1225,8,6,4,10,12,23,-11,22
FK Rubin,1225,9,5,6,9,22,19,3,21
Rostov,1225,10,4,6,10,12,22,-10,18
Anzhi,1225,11,2,5,13,16,41,-25,11
Loko Moscow,1226,1,11,6,3,30,13,17,39
CSKA Moscow,1226,2,12,3,5,28,17,11,39
Spart Moscow,1226,3,9,5,6,35,29,6,32
Krasnodar,1226,4,9,4,7,28,25,3,31
Zenit,1226,5,7,9,4,22,15,7,30
Terek Grozny,1226,6,8,6,6,23,22,1,30
Din Moscow,1226,7,6,7,7,20,21,-1,25
FK Rubin,1226,8,6,6,8,22,17,5,24
Amkar,1226,9,5,5,10,10,22,-12,20
Rostov,1226,10,4,6,10,10,19,-9,18
Anzhi,1226,11,2,5,13,14,42,-28,11
Loko Moscow,1227,1,12,5,3,32,14,18,41
Spart Moscow,1227,2,10,6,4,38,26,12,36
Zenit,1227,3,9,8,3,25,15,10,35
CSKA Moscow,1227,4,10,4,6,25,18,7,34
Terek Grozny,1227,5,9,5,6,23,22,1,32
Krasnodar,1227,6,8,5,7,27,25,2,29
FK Rubin,1227,7,5,7,8,21,17,4,22
Din Moscow,1227,8,5,7,8,17,24,-7,22
Rostov,1227,9,4,6,10,11,19,-8,18
Amkar,1227,10,4,5,11,9,24,-15,17
Anzhi,1227,11,2,6,12,14,38,-24,12
Loko Moscow,1228,1,12,6,2,32,13,19,42
CSKA Moscow,1228,2,11,3,6,27,19,8,36
Zenit,1228,3,8,8,4,24,15,9,32
Spart Moscow,1228,4,9,5,6,37,32,5,32
Terek Grozny,1228,5,8,6,6,26,24,2,30
Krasnodar,1228,6,8,5,7,29,29,0,29
FK Rubin,1228,7,7,5,8,28,19,9,26
Rostov,1228,8,5,6,9,13,17,-4,21
Din Moscow,1228,9,5,6,9,18,27,-9,21
Amkar,1228,10,5,4,11,13,27,-14,19
Anzhi,1228,11,2,6,12,16,41,-25,12
Loko Moscow,1229,1,12,5,3,31,13,18,41
CSKA Moscow,1229,2,11,3,6,28,22,6,36
Zenit,1229,3,9,8,3,27,14,13,35
Spart Moscow,1229,4,9,6,5,37,27,10,33
Krasnodar,1229,5,8,5,7,27,25,2,29
Terek Grozny,1229,6,7,5,8,22,26,-4,26
FK Rubin,1229,7,6,6,8,22,17,5,24
Amkar,1229,8,6,4,10,12,23,-11,22
Din Moscow,1229,9,5,6,9,17,25,-8,21
Rostov,1229,10,4,7,9,11,18,-7,19
Anzhi,1229,11,3,5,12,17,41,-24,14
Loko Moscow,1230,1,13,5,2,34,12,22,44
CSKA Moscow,1230,2,11,3,6,27,19,8,36
Spart Moscow,1230,3,10,5,5,41,29,12,35
Zenit,1230,4,8,8,4,23,15,8,32
Terek Grozny,1230,5,9,5,6,23,22,1,32
Krasnodar,1230,6,9,4,7,30,27,3,31
FK Rubin,1230,7,6,5,9,22,20,2,23
Din Moscow,1230,8,5,6,9,19,26,-7,21
Amkar,1230,9,5,4,11,10,24,-14,19
Rostov,1230,10,4,6,10,11,21,-10,18
Anzhi,1230,11,2,5,13,15,40,-25,11
Loko Moscow,1231,1,11,6,3,30,13,17,39
CSKA Moscow,1231,2,11,4,5,26,17,9,37
Spart Moscow,1231,3,10,5,5,38,28,10,35
Zenit,1231,4,8,9,3,22,13,9,33
Krasnodar,1231,5,9,5,6,29,25,4,32
Terek Grozny,1231,6,7,6,7,22,25,-3,27
Din Moscow,1231,7,6,7,7,18,21,-3,25
FK Rubin,1231,8,5,6,9,21,18,3,21
Rostov,1231,9,4,6,10,11,19,-8,18
Amkar,1231,10,4,5,11,11,26,-15,17
Anzhi,1231,11,3,5,12,16,39,-23,14
Loko Moscow,1232,1,12,6,2,32,13,19,42
Spart Moscow,1232,2,10,6,4,38,28,10,36
CSKA Moscow,1232,3,10,4,6,28,21,7,34
Krasnodar,1232,4,9,5,6,34,28,6,32
Zenit,1232,5,7,9,4,22,15,7,30
Terek Grozny,1232,6,8,6,6,25,25,0,30
FK Rubin,1232,7,6,5,9,26,22,4,23
Din Moscow,1232,8,5,6,9,19,27,-8,21
Rostov,1232,9,4,7,9,10,17,-7,19
Amkar,1232,10,4,4,12,11,27,-16,16
Anzhi,1232,11,3,6,11,19,41,-22,15
Loko Moscow,1233,1,12,6,2,30,11,19,42
CSKA Moscow,1233,2,12,3,5,29,18,11,39
Spart Moscow,1233,3,9,6,5,40,33,7,33
Krasnodar,1233,4,8,6,6,28,25,3,30
Zenit,1233,5,7,8,5,21,15,6,29
Terek Grozny,1233,6,7,6,7,20,24,-4,27
Din Moscow,1233,7,6,6,8,20,26,-6,24
Amkar,1233,8,6,4,10,15,22,-7,22
FK Rubin,1233,9,5,6,9,22,19,3,21
Rostov,1233,10,4,7,9,12,19,-7,19
Anzhi,1233,11,2,6,12,15,40,-25,12
Loko Moscow,1234,1,11,7,2,33,15,18,40
Spart Moscow,1234,2,10,6,4,38,26,12,36
CSKA Moscow,1234,3,11,3,6,28,19,9,36
Zenit,1234,4,8,9,3,23,14,9,33
Krasnodar,1234,5,8,6,6,31,28,3,30
Terek Grozny,1234,6,7,7,6,20,22,-2,28
FK Rubin,1234,7,5,7,8,22,18,4,22
Din Moscow,1234,8,5,7,8,18,24,-6,22
Rostov,1234,9,4,7,9,10,17,-7,19
Amkar,1234,10,4,5,11,9,24,-15,17
Anzhi,1234,11,2,6,12,15,40,-25,12
Loko Moscow,1235,1,11,6,3,31,15,16,39
CSKA Moscow,1235,2,11,4,5,28,19,9,37
Spart Moscow,1235,3,9,7,4,38,28,10,34
Zenit,1235,4,8,8,4,24,15,9,32
Terek Grozny,1235,5,8,6,6,22,22,0,30
Krasnodar,1235,6,8,5,7,28,27,1,29
FK Rubin,1235,7,6,6,8,23,17,6,24
Din Moscow,1235,8,5,8,7,18,22,-4,23
Rostov,1235,9,4,6,10,11,20,-9,18
Amkar,1235,10,4,6,10,10,23,-13,18
Anzhi,1235,11,2,6,12,16,41,-25,12
Loko Moscow,1236,1,13,5,2,34,13,21,44
Spart Moscow,1236,2,11,5,4,41,29,12,38
CSKA Moscow,1236,3,11,3,6,28,19,9,36
Zenit,1236,4,8,8,4,23,16,7,32
Terek Grozny,1236,5,9,5,6,24,24,0,32
Krasnodar,1236,6,9,4,7,31,27,4,31
Din Moscow,1236,7,6,6,8,21,25,-4,24
FK Rubin,1236,8,5,5,10,21,21,0,20
Rostov,1236,9,4,6,10,11,19,-8,18
Amkar,1236,10,4,4,12,12,27,-15,16
Anzhi,1236,11,2,5,13,14,40,-26,11
Loko Moscow,1237,1,11,7,2,29,11,18,40
CSKA Moscow,1237,2,11,3,6,29,21,8,36
Zenit,1237,3,8,9,3,24,15,9,33
Spart Moscow,1237,4,8,7,5,36,29,7,31
Krasnodar,1237,5,8,6,6,29,26,3,30
Terek Grozny,1237,6,8,5,7,22,26,-4,29
FK Rubin,1237,7,6,6,8,25,19,6,24
Din Moscow,1237,8,6,6,8,19,24,-5,24
Rostov,1237,9,4,7,9,11,18,-7,19
Amkar,1237,10,4,5,11,10,24,-14,17
Anzhi,1237,11,3,5,12,19,40,-21,14
Loko Moscow,1238,1,11,6,3,31,15,16,39
CSKA Moscow,1238,2,11,3,6,28,19,9,36
Krasnodar,1238,3,10,4,6,32,26,6,34
Spart Moscow,1238,4,9,6,5,36,27,9,33
Zenit,1238,5,8,9,3,24,15,9,33
Terek Grozny,1238,6,7,6,7,21,24,-3,27
FK Rubin,1238,7,6,5,9,25,21,4,23
Rostov,1238,8,5,6,9,11,17,-6,21
Din Moscow,1238,9,5,6,9,18,25,-7,21
Amkar,1238,10,4,6,10,11,24,-13,18
Anzhi,1238,11,3,5,12,16,40,-24,14
Loko Moscow,1239,1,11,5,4,32,19,13,38
CSKA Moscow,1239,2,11,4,5,30,19,11,37
Spart Moscow,1239,3,9,6,5,35,27,8,33
Zenit,1239,4,8,8,4,26,19,7,32
Krasnodar,1239,5,9,4,7,32,27,5,31
Terek Grozny,1239,6,8,5,7,23,25,-2,29
FK Rubin,1239,7,6,6,8,23,18,5,24
Din Moscow,1239,8,5,7,8,18,23,-5,22
Rostov,1239,9,5,6,9,11,17,-6,21
Amkar,1239,10,5,5,10,11,23,-12,20
Anzhi,1239,11,2,6,12,16,40,-24,12
Loko Moscow,1240,1,12,5,3,32,14,18,41
CSKA Moscow,1240,2,11,3,6,29,20,9,36
Zenit,1240,3,9,8,3,26,14,12,35
Spart Moscow,1240,4,8,6,6,35,29,6,30
Krasnodar,1240,5,8,5,7,28,26,2,29
Terek Grozny,1240,6,8,5,7,23,26,-3,29
Din Moscow,1240,7,7,6,7,21,21,0,27
FK Rubin,1240,8,5,6,9,21,20,1,21
Rostov,1240,9,5,6,9,12,18,-6,21
Amkar,1240,10,5,5,10,14,23,-9,20
Anzhi,1240,11,2,5,13,14,44,-30,11
Loko Moscow,1241,1,12,5,3,32,13,19,41
Krasnodar,1241,2,10,4,6,32,27,5,34
Spart Moscow,1241,3,9,6,5,36,28,8,33
CSKA Moscow,1241,4,10,3,7,25,20,5,33
Zenit,1241,5,8,8,4,23,15,8,32
Terek Grozny,1241,6,7,6,7,23,29,-6,27
Din Moscow,1241,7,5,7,8,18,23,-5,22
Amkar,1241,8,6,4,10,15,23,-8,22
FK Rubin,1241,9,5,6,9,23,20,3,21
Rostov,1241,10,4,7,9,10,17,-7,19
Anzhi,1241,11,3,6,11,18,40,-22,15
Loko Moscow,1242,1,13,5,2,34,11,23,44
Spart Moscow,1242,2,10,6,4,37,26,11,36
CSKA Moscow,1242,3,10,4,6,27,22,5,34
Zenit,1242,4,8,8,4,24,16,8,32
Krasnodar,1242,5,9,4,7,29,26,3,31
Terek Grozny,1242,6,8,5,7,21,23,-2,29
FK Rubin,1242,7,6,5,9,23,19,4,23
Din Moscow,1242,8,5,7,8,18,24,-6,22
Amkar,1242,9,5,4,11,10,24,-14,19
Rostov,1242,10,4,6,10,10,18,-8,18
Anzhi,1242,11,2,6,12,16,40,-24,12
Loko Moscow,1243,1,12,6,2,32,13,19,42
CSKA Moscow,1243,2,11,4,5,29,19,10,37
Spart Moscow,1243,3,10,6,4,42,32,10,36
Terek Grozny,1243,4,9,5,6,24,24,0,32
Zenit,1243,5,7,9,4,23,16,7,30
Krasnodar,1243,6,8,6,6,29,26,3,30
Din Moscow,1243,7,6,7,7,24,25,-1,25
FK Rubin,1243,8,5,6,9,24,23,1,21
Rostov,1243,9,4,6,10,12,20,-8,18
Amkar,1243,10,4,4,12,13,28,-15,16
Anzhi,1243,11,2,5,13,16,42,-26,11
Loko Moscow,1244,1,12,5,3,32,13,19,41
Spart Moscow,1244,2,10,6,4,41,28,13,36
CSKA Moscow,1244,3,11,3,6,28,19,9,36
Zenit,1244,4,8,8,4,22,15,7,32
Krasnodar,1244,5,9,4,7,30,27,3,31
Terek Grozny,1244,6,8,5,7,23,25,-2,29
FK Rubin,1244,7,6,6,8,23,18,5,24
Din Moscow,1244,8,5,8,7,17,21,-4,23
Amkar,1244,9,5,4,11,11,27,-16,19
Rostov,1244,10,4,6,10,12,20,-8,18
Anzhi,1244,11,2,5,13,17,43,-26,11
Loko Moscow,1245,1,12,5,3,30,15,15,41
Spart Moscow,1245,2,11,5,4,38,26,12,38
CSKA Moscow,1245,3,11,3,6,30,19,11,36
Zenit,1245,4,8,8,4,23,15,8,32
Krasnodar,1245,5,9,5,6,33,26,7,32
Terek Grozny,1245,6,9,5,6,25,22,3,32
Din Moscow,1245,7,6,6,8,19,24,-5,24
FK Rubin,1245,8,5,6,9,24,21,3,21
Rostov,1245,9,4,6,10,11,19,-8,18
Amkar,1245,10,4,4,12,9,25,-16,16
Anzhi,1245,11,2,5,13,14,44,-30,11
Loko Moscow,1246,1,11,6,3,31,14,17,39
CSKA Moscow,1246,2,11,3,6,27,19,8,36
Krasnodar,1246,3,10,4,6,30,25,5,34
Zenit,1246,4,8,9,3,24,15,9,33
Terek Grozny,1246,5,9,5,6,23,22,1,32
Spart Moscow,1246,6,8,6,6,35,29,6,30
Din Moscow,1246,7,7,6,7,20,22,-2,27
FK Rubin,1246,8,5,5,10,21,19,2,20
Rostov,1246,9,4,7,9,10,17,-7,19
Amkar,1246,10,5,4,11,11,24,-13,19
Anzhi,1246,11,2,5,13,14,40,-26,11
Loko Moscow,1247,1,12,5,3,31,13,18,41
CSKA Moscow,1247,2,11,3,6,27,18,9,36
Spart Moscow,1247,3,9,7,4,37,26,11,34
Zenit,1247,4,8,8,4,23,16,7,32
Krasnodar,1247,5,8,5,7,28,26,2,29
Terek Grozny,1247,6,7,6,7,21,26,-5,27
Din Moscow,1247,7,6,7,7,19,22,-3,25
FK Rubin,1247,8,5,6,9,22,19,3,21
Rostov,1247,9,4,7,9,10,17,-7,19
Amkar,1247,10,5,4,11,12,25,-13,19
Anzhi,1247,11,3,6,11,16,38,-22,15
Loko Moscow,1248,1,11,6,3,29,12,17,39
CSKA Moscow,1248,2,12,3,5,31,17,14,39
Spart Moscow,1248,3,10,6,4,41,28,13,36
Krasnodar,1248,4,9,5,6,30,26,4,32
Zenit,1248,5,7,9,4,21,14,7,30
Terek Grozny,1248,6,7,6,7,20,23,-3,27
Din Moscow,1248,7,5,8,7,19,23,-4,23
FK Rubin,1248,8,5,7,8,23,19,4,22
Rostov,1248,9,4,6,10,11,21,-10,18
Amkar,1248,10,4,5,11,9,24,-15,17
Anzhi,1248,11,3,5,12,15,42,-27,14
Loko Moscow,1249,1,11,6,3,32,16,16,39
CSKA Moscow,1249,2,12,3,5,29,18,11,39
Spart Moscow,1249,3,10,5,5,40,29,11,35
Zenit,1249,4,8,8,4,25,16,9,32
Krasnodar,1249,5,8,5,7,29,29,0,29
FK Rubin,1249,6,7,5,8,25,17,8,26
Terek Grozny,1249,7,7,5,8,21,26,-5,26
Amkar,1249,8,6,4,10,13,23,-10,22
Din Moscow,1249,9,5,6,9,19,27,-8,21
Rostov,1249,10,4,6,10,10,19,-9,18
Anzhi,1249,11,3,5,12,16,39,-23,14
Loko Moscow,1250,1,13,5,2,33,11,22,44
Spart Moscow,1250,2,10,5,5,39,27,12,35
CSKA Moscow,1250,3,10,3,7,26,22,4,33
Zenit,1250,4,8,8,4,22,15,7,32
Krasnodar,1250,5,9,4,7,30,27,3,31
Terek Grozny,1250,6,8,5,7,22,24,-2,29
FK Rubin,1250,7,6,5,9,24,20,4,23
Amkar,1250,8,6,4,10,12,23,-11,22
Din Moscow,1250,9,5,6,9,17,26,-9,21
Rostov,1250,10,4,6,10,10,19,-9,18
Anzhi,1250,11,3,5,12,19,40,-21,14
Loko Moscow,1251,1,12,6,2,34,13,21,42
Spart Moscow,1251,2,11,5,4,39,28,11,38
CSKA Moscow,1251,3,10,5,5,28,20,8,35
Krasnodar,1251,4,9,5,6,28,24,4,32
Zenit,1251,5,7,9,4,25,20,5,30
Terek Grozny,1251,6,7,6,7,21,25,-4,27
Din Moscow,1251,7,6,6,8,20,23,-3,24
FK Rubin,1251,8,5,5,10,21,20,1,20
Rostov,1251,9,4,6,10,11,19,-8,18
Amkar,1251,10,4,5,11,11,25,-14,17
Anzhi,1251,11,3,6,11,17,38,-21,15
Loko Moscow,1252,1,12,5,3,32,13,19,41
Spart Moscow,1252,2,10,6,4,35,25,10,36
CSKA Moscow,1252,3,10,5,5,26,18,8,35
Krasnodar,1252,4,10,4,6,33,25,8,34
Terek Grozny,1252,5,9,5,6,24,24,0,32
Zenit,1252,6,7,9,4,22,16,6,30
Din Moscow,1252,7,6,6,8,19,23,-4,24
FK Rubin,1252,8,5,5,10,22,23,-1,20
Rostov,1252,9,4,7,9,10,17,-7,19
Amkar,1252,10,4,4,12,10,25,-15,16
Anzhi,1252,11,2,6,12,15,39,-24,12
Loko Moscow,1253,1,12,6,2,33,13,20,42
CSKA Moscow,1253,2,11,4,5,28,19,9,37
Spart Moscow,1253,3,9,6,5,39,31,8,33
Krasnodar,1253,4,9,5,6,30,26,4,32
Zenit,1253,5,7,8,5,22,17,5,29
Terek Grozny,1253,6,7,5,8,21,26,-5,26
Din Moscow,1253,7,6,7,7,21,23,-2,25
FK Rubin,1253,8,5,6,9,22,19,3,21
Amkar,1253,9,5,5,10,14,25,-11,20
Rostov,1253,10,4,6,10,10,19,-9,18
Anzhi,1253,11,3,6,11,17,39,-22,15
Loko Moscow,1254,1,13,5,2,31,11,20,44
CSKA Moscow,1254,2,11,4,5,26,17,9,37
Zenit,1254,3,7,9,4,21,14,7,30
Spart Moscow,1254,4,8,6,6,37,32,5,30
Terek Grozny,1254,5,8,6,6,24,25,-1,30
Krasnodar,1254,6,8,5,7,27,25,2,29
Din Moscow,1254,7,6,7,7,22,24,-2,25
FK Rubin,1254,8,5,7,8,22,18,4,22
Rostov,1254,9,5,6,9,12,18,-6,21
Amkar,1254,10,4,6,10,11,24,-13,18
Anzhi,1254,11,2,5,13,16,41,-25,11
Loko Moscow,1255,1,12,6,2,32,12,20,42
CSKA Moscow,1255,2,11,4,5,28,19,9,37
Zenit,1255,3,7,10,3,23,15,8,31
Krasnodar,1255,4,9,4,7,28,26,2,31
Spart Moscow,1255,5,8,6,6,37,32,5,30
Terek Grozny,1255,6,8,5,7,23,25,-2,29
Din Moscow,1255,7,6,7,7,21,24,-3,25
Amkar,1255,8,6,4,10,13,23,-10,22
Rostov,1255,9,5,6,9,12,18,-6,21
FK Rubin,1255,10,5,5,10,21,19,2,20
Anzhi,1255,11,2,5,13,16,41,-25,11
Loko Moscow,1256,1,11,7,2,30,12,18,40
CSKA Moscow,1256,2,12,3,5,31,17,14,39
Spart Moscow,1256,3,10,5,5,37,27,10,35
Krasnodar,1256,4,9,5,6,29,25,4,32
Zenit,1256,5,7,9,4,22,15,7,30
Terek Grozny,1256,6,8,6,6,22,23,-1,30
Din Moscow,1256,7,7,6,7,20,22,-2,27
FK Rubin,1256,8,5,5,10,23,21,2,20
Rostov,1256,9,4,6,10,11,19,-8,18
Amkar,1256,10,4,5,11,9,24,-15,17
Anzhi,1256,11,2,5,13,15,44,-29,11
Loko Moscow,1257,1,11,5,4,30,15,15,38
CSKA Moscow,1257,2,11,4,5,31,21,10,37
Krasnodar,1257,3,10,4,6,30,24,6,34
Spart Moscow,1257,4,9,6,5,39,31,8,33
Zenit,1257,5,8,8,4,23,16,7,32
Terek Grozny,1257,6,9,5,6,23,22,1,32
FK Rubin,1257,7,6,5,9,23,19,4,23
Din Moscow,1257,8,5,6,9,20,26,-6,21
Rostov,1257,9,4,7,9,11,18,-7,19
Amkar,1257,10,5,4,11,12,26,-14,19
Anzhi,1257,11,2,6,12,18,42,-24,12
CSKA Moscow,1258,1,12,3,5,29,17,12,39
Loko Moscow,1258,2,11,5,4,29,16,13,38
Spart Moscow,1258,3,10,5,5,36,29,7,35
Zenit,1258,4,8,8,4,24,14,10,32
Krasnodar,1258,5,9,5,6,31,26,5,32
Terek Grozny,1258,6,7,6,7,20,25,-5,27
FK Rubin,1258,7,5,7,8,24,20,4,22
Din Moscow,1258,8,5,7,8,18,23,-5,22
Amkar,1258,9,6,4,10,15,22,-7,22
Rostov,1258,10,4,6,10,11,19,-8,18
Anzhi,1258,11,2,6,12,14,40,-26,12
Loko Moscow,1259,1,13,5,2,33,11,22,44
CSKA Moscow,1259,2,11,3,6,29,19,10,36
Spart Moscow,1259,3,9,6,5,37,29,8,33
Krasnodar,1259,4,9,4,7,30,27,3,31
Zenit,1259,5,7,8,5,21,17,4,29
Terek Grozny,1259,6,7,5,8,21,25,-4,26
Din Moscow,1259,7,6,6,8,19,23,-4,24
FK Rubin,1259,8,6,5,9,22,20,2,23
Rostov,1259,9,4,7,9,11,18,-7,19
Amkar,1259,10,5,4,11,11,24,-13,19
Anzhi,1259,11,4,5,11,18,39,-21,17
Loko Moscow,1260,1,12,6,2,33,13,20,42
CSKA Moscow,1260,2,12,3,5,31,17,14,39
Spart Moscow,1260,3,9,7,4,37,27,10,34
Zenit,1260,4,7,9,4,22,15,7,30
Krasnodar,1260,5,8,5,7,29,28,1,29
Terek Grozny,1260,6,7,7,6,21,23,-2,28
Din Moscow,1260,7,6,6,8,20,25,-5,24
FK Rubin,1260,8,5,6,9,23,20,3,21
Rostov,1260,9,4,7,9,10,17,-7,19
Amkar,1260,10,4,6,10,11,24,-13,18
Anzhi,1260,11,2,6,12,14,42,-28,12
Loko Moscow,1261,1,11,5,4,31,16,15,38
CSKA Moscow,1261,2,11,4,5,27,18,9,37
Spart Moscow,1261,3,10,5,5,41,29,12,35
Zenit,1261,4,8,8,4,24,15,9,32
Krasnodar,1261,5,9,5,6,31,27,4,32
Terek Grozny,1261,6,8,6,6,25,25,0,30
FK Rubin,1261,7,5,7,8,23,19,4,22
Din Moscow,1261,8,5,7,8,17,25,-8,22
Rostov,1261,9,5,6,9,12,18,-6,21
Amkar,1261,10,4,4,12,12,28,-16,16
Anzhi,1261,11,2,7,11,17,40,-23,13
Loko Moscow,1262,1,11,7,2,31,13,18,40
CSKA Moscow,1262,2,10,5,5,28,20,8,35
Spart Moscow,1262,3,9,5,6,37,30,7,32
Zenit,1262,4,7,10,3,25,17,8,31
Krasnodar,1262,5,8,6,6,29,26,3,30
Terek Grozny,1262,6,7,5,8,23,29,-6,26
FK Rubin,1262,7,6,6,8,27,20,7,24
Amkar,1262,8,6,4,10,13,23,-10,22
Rostov,1262,9,5,6,9,12,18,-6,21
Din Moscow,1262,10,5,6,9,19,27,-8,21
Anzhi,1262,11,3,6,11,20,41,-21,15
Loko Moscow,1263,1,12,5,3,31,13,18,41
CSKA Moscow,1263,2,12,3,5,29,18,11,39
Spart Moscow,1263,3,11,5,4,42,26,16,38
Zenit,1263,4,8,8,4,23,15,8,32
Krasnodar,1263,5,8,5,7,27,25,2,29
Terek Grozny,1263,6,8,5,7,23,25,-2,29
FK Rubin,1263,7,5,7,8,21,17,4,22
Din Moscow,1263,8,5,7,8,17,24,-7,22
Amkar,1263,9,5,4,11,11,26,-15,19
Rostov,1263,10,4,6,10,11,20,-9,18
Anzhi,1263,11,2,5,13,16,42,-26,11
Loko Moscow,1264,1,12,5,3,33,15,18,41
Spart Moscow,1264,2,11,5,4,42,27,15,38
CSKA Moscow,1264,3,10,4,6,26,19,7,34
Zenit,1264,4,8,9,3,25,16,9,33
Terek Grozny,1264,5,9,5,6,24,24,0,32
Krasnodar,1264,6,9,4,7,29,26,3,31
Din Moscow,1264,7,5,7,8,19,25,-6,22
FK Rubin,1264,8,5,6,9,22,19,3,21
Rostov,1264,9,4,6,10,10,19,-9,18
Amkar,1264,10,4,4,12,11,28,-17,16
Anzhi,1264,11,3,5,12,16,39,-23,14
Loko Moscow,1265,1,11,7,2,31,13,18,40
CSKA Moscow,1265,2,11,4,5,28,19,9,37
Spart Moscow,1265,3,9,5,6,38,29,9,32
Zenit,1265,4,7,10,3,21,13,8,31
Terek Grozny,1265,5,8,6,6,22,22,0,30
Krasnodar,1265,6,8,5,7,31,29,2,29
FK Rubin,1265,7,7,5,8,25,19,6,26
Rostov,1265,8,5,6,9,11,17,-6,21
Din Moscow,1265,9,5,6,9,17,26,-9,21
Amkar,1265,10,5,5,10,12,23,-11,20
Anzhi,1265,11,2,5,13,16,42,-26,11
Loko Moscow,1266,1,12,6,2,34,14,20,42
CSKA Moscow,1266,2,11,3,6,31,19,12,36
Spart Moscow,1266,3,10,5,5,35,27,8,35
Zenit,1266,4,8,8,4,23,16,7,32
Krasnodar,1266,5,9,5,6,31,27,4,32
Terek Grozny,1266,6,9,5,6,26,23,3,32
Din Moscow,1266,7,6,7,7,19,21,-2,25
FK Rubin,1266,8,5,6,9,21,18,3,21
Rostov,1266,9,4,6,10,10,18,-8,18
Amkar,1266,10,4,4,12,9,26,-17,16
Anzhi,1266,11,2,5,13,15,45,-30,11
Loko Moscow,1267,1,13,5,2,33,12,21,44
CSKA Moscow,1267,2,11,3,6,28,20,8,36
Spart Moscow,1267,3,9,7,4,37,28,9,34
Zenit,1267,4,8,8,4,23,15,8,32
Terek Grozny,1267,5,8,6,6,23,22,1,30
Krasnodar,1267,6,8,5,7,28,26,2,29
Din Moscow,1267,7,5,8,7,19,23,-4,23
FK Rubin,1267,8,5,7,8,22,18,4,22
Rostov,1267,9,4,6,10,10,18,-8,18
Amkar,1267,10,4,6,10,11,24,-13,18
Anzhi,1267,11,2,5,13,15,43,-28,11
Loko Moscow,1268,1,12,5,3,31,14,17,41
CSKA Moscow,1268,2,12,3,5,29,18,11,39
Spart Moscow,1268,3,11,5,4,38,27,11,38
Krasnodar,1268,4,9,5,6,31,26,5,32
Terek Grozny,1268,5,9,5,6,22,22,0,32
Zenit,1268,6,7,8,5,22,16,6,29
Din Moscow,1268,7,6,6,8,21,23,-2,24
FK Rubin,1268,8,5,6,9,23,22,1,21
Rostov,1268,9,4,6,10,10,18,-8,18
Amkar,1268,10,4,4,12,10,25,-15,16
Anzhi,1268,11,2,5,13,15,41,-26,11
Loko Moscow,1269,1,12,5,3,31,17,14,41
CSKA Moscow,1269,2,11,3,6,28,18,10,36
Zenit,1269,3,9,8,3,27,13,14,35
Spart Moscow,1269,4,8,6,6,35,29,6,30
Krasnodar,1269,5,8,4,8,28,27,1,28
Din Moscow,1269,6,7,6,7,23,23,0,27
Terek Grozny,1269,7,7,6,7,20,23,-3,27
FK Rubin,1269,8,6,5,9,22,20,2,23
Rostov,1269,9,5,6,9,11,17,-6,21
Amkar,1269,10,4,6,10,9,22,-13,18
Anzhi,1269,11,3,5,12,15,40,-25,14
Loko Moscow,1270,1,13,5,2,32,11,21,44
CSKA Moscow,1270,2,12,3,5,30,20,10,39
Spart Moscow,1270,3,10,6,4,42,28,14,36
Zenit,1270,4,7,8,5,22,17,5,29
Krasnodar,1270,5,8,4,8,27,27,0,28
Terek Grozny,1270,6,7,5,8,21,26,-5,26
FK Rubin,1270,7,6,6,8,24,18,6,24
Din Moscow,1270,8,5,7,8,19,25,-6,22
Rostov,1270,9,4,7,9,12,19,-7,19
Amkar,1270,10,5,4,11,12,27,-15,19
Anzhi,1270,11,3,5,12,17,40,-23,14
Loko Moscow,1271,1,12,6,2,33,12,21,42
CSKA Moscow,1271,2,10,4,6,26,19,7,34
Zenit,1271,3,8,9,3,24,15,9,33
Spart Moscow,1271,4,9,5,6,38,30,8,32
Krasnodar,1271,5,9,4,7,30,29,1,31
Terek Grozny,1271,6,7,7,6,22,24,-2,28
Din Moscow,1271,7,7,6,7,22,22,0,27
Rostov,1271,8,5,6,9,12,18,-6,21
FK Rubin,1271,9,5,5,10,24,23,1,20
Amkar,1271,10,4,5,11,11,27,-16,17
Anzhi,1271,11,2,7,11,15,38,-23,13
Loko Moscow,1272,1,13,5,2,32,11,21,44
CSKA Moscow,1272,2,10,4,6,28,21,7,34
Spart Moscow,1272,3,9,6,5,40,31,9,33
Krasnodar,1272,4,9,4,7,29,27,2,31
Zenit,1272,5,7,9,4,23,16,7,30
Terek Grozny,1272,6,7,7,6,22,24,-2,28
FK Rubin,1272,7,6,5,9,23,19,4,23
Din Moscow,1272,8,5,7,8,19,24,-5,22
Rostov,1272,9,5,6,9,13,18,-5,21
Amkar,1272,10,4,5,11,11,27,-16,17
Anzhi,1272,11,3,6,11,17,39,-22,15
Loko Moscow,1273,1,12,6,2,30,11,19,42
CSKA Moscow,1273,2,10,3,7,27,22,5,33
Zenit,1273,3,8,8,4,23,15,8,32
Spart Moscow,1273,4,8,7,5,35,28,7,31
Krasnodar,1273,5,8,6,6,29,26,3,30
Terek Grozny,1273,6,8,5,7,24,26,-2,29
Din Moscow,1273,7,5,8,7,19,23,-4,23
FK Rubin,1273,8,5,7,8,24,20,4,22
Rostov,1273,9,5,6,9,11,17,-6,21
Amkar,1273,10,5,5,10,12,24,-12,20
Anzhi,1273,11,3,5,12,19,41,-22,14
Loko Moscow,1274,1,11,6,3,32,16,16,39
Spart Moscow,1274,2,10,6,4,39,26,13,36
Zenit,1274,3,8,9,3,26,16,10,33
CSKA Moscow,1274,4,10,3,7,27,22,5,33
Krasnodar,1274,5,9,4,7,32,28,4,31
Terek Grozny,1274,6,8,5,7,24,26,-2,29
Din Moscow,1274,7,6,6,8,19,24,-5,24
FK Rubin,1274,8,6,5,9,25,21,4,23
Rostov,1274,9,4,7,9,10,17,-7,19
Anzhi,1274,10,4,5,11,19,39,-20,17
Amkar,1274,11,4,4,12,11,29,-18,16
Loko Moscow,1275,1,11,7,2,31,13,18,40
CSKA Moscow,1275,2,11,3,6,29,18,11,36
Zenit,1275,3,8,9,3,22,13,9,33
Krasnodar,1275,4,9,5,6,30,26,4,32
Terek Grozny,1275,5,9,5,6,23,22,1,32
Spart Moscow,1275,6,8,7,5,36,29,7,31
Din Moscow,1275,7,6,6,8,19,23,-4,24
FK Rubin,1275,8,6,5,9,22,18,4,23
Rostov,1275,9,4,7,9,11,18,-7,19
Amkar,1275,10,4,5,11,10,24,-14,17
Anzhi,1275,11,2,5,13,14,43,-29,11
Loko Moscow,1276,1,11,6,3,30,15,15,39
CSKA Moscow,1276,2,11,3,6,27,21,6,36
Zenit,1276,3,9,8,3,28,13,15,35
Spart Moscow,1276,4,9,6,5,37,29,8,33
Krasnodar,1276,5,9,5,6,31,25,6,32
Terek Grozny,1276,6,8,6,6,22,23,-1,30
Din Moscow,1276,7,6,6,8,20,23,-3,24
FK Rubin,1276,8,6,5,9,22,20,2,23
Rostov,1276,9,4,6,10,11,20,-9,18
Amkar,1276,10,4,6,10,10,23,-13,18
Anzhi,1276,11,2,5,13,14,40,-26,11
Loko Moscow,1277,1,12,6,2,31,12,19,42
CSKA Moscow,1277,2,11,4,5,30,20,10,37
Spart Moscow,1277,3,9,6,5,38,28,10,33
Zenit,1277,4,7,10,3,22,14,8,31
Krasnodar,1277,5,8,5,7,29,27,2,29
Terek Grozny,1277,6,8,5,7,22,26,-4,29
Din Moscow,1277,7,6,7,7,18,21,-3,25
FK Rubin,1277,8,5,7,8,22,18,4,22
Amkar,1277,9,5,5,10,13,23,-10,20
Rostov,1277,10,4,6,10,11,21,-10,18
Anzhi,1277,11,2,5,13,17,43,-26,11
Loko Moscow,1278,1,12,5,3,31,13,18,41
CSKA Moscow,1278,2,11,4,5,27,17,10,37
Spart Moscow,1278,3,10,6,4,38,26,12,36
Krasnodar,1278,4,10,4,6,31,26,5,34
Zenit,1278,5,7,9,4,22,15,7,30
Terek Grozny,1278,6,8,6,6,23,24,-1,30
Din Moscow,1278,7,5,7,8,18,23,-5,22
FK Rubin,1278,8,5,6,9,24,21,3,21
Rostov,1278,9,4,6,10,10,20,-10,18
Amkar,1278,10,4,6,10,11,24,-13,18
Anzhi,1278,11,2,5,13,15,41,-26,11
Loko Moscow,1279,1,11,7,2,32,14,18,40
CSKA Moscow,1279,2,12,3,5,29,18,11,39
Krasnodar,1279,3,9,5,6,32,25,7,32
Spart Moscow,1279,4,8,6,6,35,29,6,30
Zenit,1279,5,7,9,4,23,17,6,30
Terek Grozny,1279,6,7,7,6,21,23,-2,28
Din Moscow,1279,7,6,6,8,19,23,-4,24
FK Rubin,1279,8,6,5,9,23,22,1,23
Rostov,1279,9,5,6,9,12,18,-6,21
Amkar,1279,10,4,6,10,11,24,-13,18
Anzhi,1279,11,2,6,12,15,39,-24,12
Loko Moscow,1280,1,12,5,3,32,13,19,41
CSKA Moscow,1280,2,11,3,6,29,18,11,36
Krasnodar,1280,3,10,4,6,31,26,5,34
Spart Moscow,1280,4,9,6,5,37,29,8,33
Zenit,1280,5,8,8,4,22,15,7,32
Terek Grozny,1280,6,8,5,7,21,23,-2,29
Din Moscow,1280,7,6,7,7,19,21,-2,25
FK Rubin,1280,8,5,6,9,22,19,3,21
Rostov,1280,9,4,7,9,11,18,-7,19
Amkar,1280,10,4,4,12,10,26,-16,16
Anzhi,1280,11,3,5,12,15,41,-26,14
Loko Moscow,1281,1,12,5,3,34,15,19,41
CSKA Moscow,1281,2,11,3,6,28,19,9,36
Zenit,1281,3,9,8,3,24,14,10,35
Spart Moscow,1281,4,9,6,5,35,27,8,33
Krasnodar,1281,5,9,4,7,31,28,3,31
Terek Grozny,1281,6,8,6,6,22,23,-1,30
Din Moscow,1281,7,5,7,8,20,25,-5,22
FK Rubin,1281,8,5,6,9,24,22,2,21
Rostov,1281,9,5,6,9,11,17,-6,21
Amkar,1281,10,4,6,10,11,24,-13,18
Anzhi,1281,11,2,5,13,15,41,-26,11
Loko Moscow,1282,1,12,6,2,35,14,21,42
CSKA Moscow,1282,2,12,3,5,28,18,10,39
Spart Moscow,1282,3,10,5,5,39,29,10,35
Krasnodar,1282,4,9,5,6,32,27,5,32
Zenit,1282,5,7,8,5,22,18,4,29
Terek Grozny,1282,6,8,5,7,22,25,-3,29
Din Moscow,1282,7,6,6,8,18,22,-4,24
Rostov,1282,8,5,6,9,13,19,-6,21
FK Rubin,1282,9,5,5,10,22,21,1,20
Amkar,1282,10,5,4,11,13,26,-13,19
Anzhi,1282,11,2,5,13,15,40,-25,11
Loko Moscow,1283,1,12,6,2,31,11,20,42
CSKA Moscow,1283,2,11,4,5,27,18,9,37
Spart Moscow,1283,3,10,5,5,39,27,12,35
Zenit,1283,4,7,10,3,21,13,8,31
Krasnodar,1283,5,9,4,7,30,27,3,31
Terek Grozny,1283,6,7,7,6,23,25,-2,28
FK Rubin,1283,7,6,5,9,25,21,4,23
Din Moscow,1283,8,5,6,9,19,27,-8,21
Amkar,1283,9,5,5,10,11,23,-12,20
Rostov,1283,10,4,6,10,10,20,-10,18
Anzhi,1283,11,2,6,12,17,41,-24,12
Loko Moscow,1284,1,12,5,3,32,15,17,41
Spart Moscow,1284,2,10,6,4,38,26,12,36
CSKA Moscow,1284,3,11,3,6,31,19,12,36
Zenit,1284,4,8,8,4,23,15,8,32
Krasnodar,1284,5,9,5,6,31,26,5,32
Terek Grozny,1284,6,7,7,6,20,22,-2,28
Din Moscow,1284,7,6,7,7,19,22,-3,25
FK Rubin,1284,8,5,6,9,22,19,3,21
Rostov,1284,9,4,6,10,10,18,-8,18
Amkar,1284,10,4,5,11,9,25,-16,17
Anzhi,1284,11,2,6,12,15,43,-28,12
Loko Moscow,1285,1,12,5,3,33,17,16,41
CSKA Moscow,1285,2,11,3,6,26,19,7,36
Spart Moscow,1285,3,9,6,5,36,28,8,33
Zenit,1285,4,8,8,4,24,16,8,32
Terek Grozny,1285,5,9,5,6,22,22,0,32
Krasnodar,1285,6,9,4,7,33,27,6,31
FK Rubin,1285,7,6,6,8,23,18,5,24
Din Moscow,1285,8,5,7,8,17,22,-5,22
Rostov,1285,9,4,7,9,11,18,-7,19
Amkar,1285,10,5,4,11,11,24,-13,19
Anzhi,1285,11,2,5,13,14,39,-25,11
Loko Moscow,1286,1,12,5,3,33,14,19,41
CSKA Moscow,1286,2,11,4,5,28,18,10,37
Spart Moscow,1286,3,10,5,5,37,27,10,35
Zenit,1286,4,8,9,3,24,15,9,33
Terek Grozny,1286,5,9,5,6,23,23,0,32
Krasnodar,1286,6,8,4,8,29,29,0,28
Din Moscow,1286,7,6,6,8,19,24,-5,24
FK Rubin,1286,8,6,5,9,24,20,4,23
Amkar,1286,9,5,4,11,11,23,-12,19
Rostov,1286,10,4,6,10,10,19,-9,18
Anzhi,1286,11,2,5,13,15,41,-26,11
Loko Moscow,1287,1,12,6,2,31,12,19,42
CSKA Moscow,1287,2,11,4,5,26,17,9,37
Spart Moscow,1287,3,10,6,4,38,27,11,36
Krasnodar,1287,4,9,5,6,28,24,4,32
Zenit,1287,5,7,8,5,22,16,6,29
Terek Grozny,1287,6,7,6,7,21,24,-3,27
Din Moscow,1287,7,5,7,8,20,25,-5,22
FK Rubin,1287,8,5,6,9,23,20,3,21
Amkar,1287,9,5,5,10,11,23,-12,20
Rostov,1287,10,4,6,10,10,19,-9,18
Anzhi,1287,11,2,7,11,15,38,-23,13
Loko Moscow,1288,1,11,5,4,31,15,16,38
CSKA Moscow,1288,2,11,3,6,27,20,7,36
Zenit,1288,3,9,8,3,25,14,11,35
Krasnodar,1288,4,9,5,6,31,27,4,32
Spart Moscow,1288,5,8,6,6,35,29,6,30
Terek Grozny,1288,6,8,5,7,22,24,-2,29
Din Moscow,1288,7,5,8,7,18,22,-4,23
FK Rubin,1288,8,5,7,8,22,18,4,22
Amkar,1288,9,6,4,10,12,23,-11,22
Rostov,1288,10,5,6,9,12,18,-6,21
Anzhi,1288,11,2,5,13,14,39,-25,11
Loko Moscow,1289,1,13,5,2,34,12,22,44
CSKA Moscow,1289,2,12,3,5,30,19,11,39
Spart Moscow,1289,3,9,6,5,38,30,8,33
Zenit,1289,4,7,8,5,23,17,6,29
Krasnodar,1289,5,8,5,7,30,30,0,29
Terek Grozny,1289,6,8,5,7,24,26,-2,29
Din Moscow,1289,7,7,6,7,22,23,-1,27
FK Rubin,1289,8,5,6,9,24,21,3,21
Rostov,1289,9,4,6,10,11,20,-9,18
Amkar,1289,10,4,5,11,11,25,-14,17
Anzhi,1289,11,3,5,12,17,41,-24,14
Loko Moscow,1290,1,11,5,4,30,14,16,38
CSKA Moscow,1290,2,11,4,5,28,18,10,37
Zenit,1290,3,8,9,3,24,15,9,33
Krasnodar,1290,4,9,5,6,28,24,4,32
Spart Moscow,1290,5,8,7,5,36,29,7,31
Terek Grozny,1290,6,8,6,6,23,23,0,30
FK Rubin,1290,7,6,6,8,23,17,6,24
Din Moscow,1290,8,5,7,8,19,25,-6,22
Amkar,1290,9,5,5,10,11,23,-12,20
Rostov,1290,10,4,7,9,11,18,-7,19
Anzhi,1290,11,2,5,13,14,41,-27,11
Loko Moscow,1291,1,13,5,2,31,11,20,44
CSKA Moscow,1291,2,11,3,6,26,18,8,36
Spart Moscow,1291,3,9,7,4,36,26,10,34
Krasnodar,1291,4,9,4,7,30,27,3,31
Zenit,1291,5,7,8,5,21,15,6,29
Terek Grozny,1291,6,8,5,7,22,25,-3,29
Din Moscow,1291,7,6,6,8,19,24,-5,24
FK Rubin,1291,8,5,5,10,23,21,2,20
Rostov,1291,9,4,7,9,10,17,-7,19
Amkar,1291,10,4,5,11,10,24,-14,17
Anzhi,1291,11,4,5,11,17,37,-20,17
Loko Moscow,1292,1,12,5,3,32,12,20,41
CSKA Moscow,1292,2,10,5,5,27,19,8,35
Spart Moscow,1292,3,9,7,4,38,27,11,34
Krasnodar,1292,4,10,4,6,29,24,5,34
Zenit,1292,5,7,9,4,22,17,5,30
Terek Grozny,1292,6,7,6,7,23,26,-3,27
FK Rubin,1292,7,6,5,9,23,18,5,23
Din Moscow,1292,8,5,6,9,18,27,-9,21
Rostov,1292,9,4,7,9,10,17,-7,19
Amkar,1292,10,4,6,10,10,23,-13,18
Anzhi,1292,11,3,6,11,19,41,-22,15
Loko Moscow,1293,1,12,5,3,32,14,18,41
Spart Moscow,1293,2,11,5,4,41,26,15,38
CSKA Moscow,1293,3,10,4,6,27,20,7,34
Zenit,1293,4,8,8,4,26,18,8,32
Krasnodar,1293,5,9,5,6,30,26,4,32
Terek Grozny,1293,6,8,6,6,22,23,-1,30
FK Rubin,1293,7,5,7,8,23,19,4,22
Din Moscow,1293,8,5,7,8,17,22,-5,22
Rostov,1293,9,4,6,10,10,21,-11,18
Amkar,1293,10,4,5,11,11,26,-15,17
Anzhi,1293,11,2,6,12,14,38,-24,12
Loko Moscow,1294,1,11,5,4,30,14,16,38
CSKA Moscow,1294,2,11,4,5,29,20,9,37
Spart Moscow,1294,3,10,6,4,40,28,12,36
Zenit,1294,4,8,8,4,23,15,8,32
Krasnodar,1294,5,9,4,7,29,27,2,31
Terek Grozny,1294,6,8,6,6,24,25,-1,30
Din Moscow,1294,7,6,6,8,21,25,-4,24
FK Rubin,1294,8,6,5,9,23,19,4,23
Rostov,1294,9,4,6,10,10,19,-9,18
Amkar,1294,10,4,6,10,12,25,-13,18
Anzhi,1294,11,2,6,12,17,41,-24,12
Loko Moscow,1295,1,12,5,3,30,12,18,41
Spart Moscow,1295,2,10,6,4,36,26,10,36
CSKA Moscow,1295,3,11,3,6,26,19,7,36
Krasnodar,1295,4,10,4,6,30,24,6,34
Zenit,1295,5,8,8,4,23,14,9,32
Terek Grozny,1295,6,8,5,7,23,25,-2,29
FK Rubin,1295,7,6,5,9,23,20,3,23
Din Moscow,1295,8,5,6,9,19,25,-6,21
Rostov,1295,9,4,7,9,10,17,-7,19
Amkar,1295,10,5,4,11,12,25,-13,19
Anzhi,1295,11,2,5,13,14,39,-25,11
Loko Moscow,1296,1,12,6,2,32,13,19,42
CSKA Moscow,1296,2,12,3,5,27,17,10,39
Spart Moscow,1296,3,10,6,4,38,28,10,36
Zenit,1296,4,7,9,4,22,15,7,30
Krasnodar,1296,5,8,4,8,30,29,1,28
Terek Grozny,1296,6,7,6,7,21,25,-4,27
FK Rubin,1296,7,6,6,8,24,19,5,24
Din Moscow,1296,8,5,7,8,18,23,-5,22
Amkar,1296,9,5,5,10,12,23,-11,20
Rostov,1296,10,4,6,10,11,19,-8,18
Anzhi,1296,11,2,6,12,15,39,-24,12
Loko Moscow,1297,1,12,5,3,32,15,17,41
CSKA Moscow,1297,2,11,3,6,28,19,9,36
Spart Moscow,1297,3,10,5,5,37,30,7,35
Krasnodar,1297,4,9,4,7,31,27,4,31
Terek Grozny,1297,5,8,6,6,23,24,-1,30
Zenit,1297,6,7,8,5,22,17,5,29
Din Moscow,1297,7,7,6,7,24,23,1,27
FK Rubin,1297,8,6,5,9,25,21,4,23
Rostov,1297,9,4,6,10,10,19,-9,18
Amkar,1297,10,4,4,12,11,26,-15,16
Anzhi,1297,11,3,6,11,17,39,-22,15
Loko Moscow,1298,1,11,5,4,31,15,16,38
Spart Moscow,1298,2,11,5,4,40,25,15,38
Zenit,1298,3,9,8,3,24,13,11,35
CSKA Moscow,1298,4,10,4,6,27,21,6,34
Krasnodar,1298,5,10,4,6,32,27,5,34
Terek Grozny,1298,6,9,5,6,23,23,0,32
Din Moscow,1298,7,6,6,8,18,23,-5,24
FK Rubin,1298,8,5,5,10,22,20,2,20
Rostov,1298,9,4,6,10,10,21,-11,18
Amkar,1298,10,4,4,12,9,24,-15,16
Anzhi,1298,11,2,6,12,17,41,-24,12
Loko Moscow,1299,1,13,5,2,32,11,21,44
CSKA Moscow,1299,2,11,4,5,27,17,10,37
Spart Moscow,1299,3,8,8,4,36,28,8,32
Terek Grozny,1299,4,9,5,6,24,23,1,32
Krasnodar,1299,5,9,4,7,28,25,3,31
Zenit,1299,6,7,9,4,21,15,6,30
FK Rubin,1299,7,6,5,9,23,19,4,23
Din Moscow,1299,8,5,7,8,20,25,-5,22
Rostov,1299,9,4,7,9,10,17,-7,19
Amkar,1299,10,4,5,11,11,26,-15,17
Anzhi,1299,11,2,5,13,14,40,-26,11
Loko Moscow,1300,1,12,6,2,31,11,20,42
CSKA Moscow,1300,2,11,3,6,26,18,8,36
Zenit,1300,3,8,8,4,22,15,7,32
Spart Moscow,1300,4,8,6,6,35,29,6,30
Krasnodar,1300,5,8,5,7,27,25,2,29
Terek Grozny,1300,6,8,5,7,23,26,-3,29
FK Rubin,1300,7,7,5,8,25,19,6,26
Din Moscow,1300,8,6,6,8,21,25,-4,24
Rostov,1300,9,5,6,9,11,17,-6,21
Amkar,1300,10,5,5,10,13,24,-11,20
Anzhi,1300,11,2,5,13,15,40,-25,11
Loko Moscow,1301,1,12,6,2,32,13,19,42
CSKA Moscow,1301,2,10,4,6,26,22,4,34
Spart Moscow,1301,3,9,6,5,39,31,8,33
Zenit,1301,4,8,8,4,26,15,11,32
Krasnodar,1301,5,8,5,7,28,26,2,29
FK Rubin,1301,6,7,5,8,27,19,8,26
Terek Grozny,1301,7,7,5,8,21,26,-5,26
Din Moscow,1301,8,5,7,8,20,27,-7,22
Amkar,1301,9,6,4,10,13,24,-11,22
Rostov,1301,10,4,6,10,13,21,-8,18
Anzhi,1301,11,3,6,11,17,38,-21,15
Loko Moscow,1302,1,11,6,3,30,13,17,39
Spart Moscow,1302,2,11,5,4,39,27,12,38
CSKA Moscow,1302,3,11,4,5,27,18,9,37
Krasnodar,1302,4,10,4,6,29,24,5,34
Zenit,1302,5,7,10,3,23,15,8,31
Terek Grozny,1302,6,8,5,7,23,26,-3,29
FK Rubin,1302,7,6,5,9,22,18,4,23
Din Moscow,1302,8,5,6,9,17,24,-7,21
Amkar,1302,9,5,4,11,11,23,-12,19
Rostov,1302,10,4,6,10,12,20,-8,18
Anzhi,1302,11,2,5,13,16,41,-25,11
Loko Moscow,1303,1,12,6,2,31,12,19,42
CSKA Moscow,1303,2,11,4,5,28,18,10,37
Spart Moscow,1303,3,9,7,4,39,30,9,34
Zenit,1303,4,7,9,4,21,14,7,30
Krasnodar,1303,5,8,5,7,29,27,2,29
Terek Grozny,1303,6,7,6,7,21,25,-4,27
Din Moscow,1303,7,6,7,7,20,23,-3,25
FK Rubin,1303,8,6,5,9,24,20,4,23
Amkar,1303,9,5,5,10,13,24,-11,20
Rostov,1303,10,4,6,10,12,20,-8,18
Anzhi,1303,11,2,6,12,16,41,-25,12
Loko Moscow,1304,1,11,6,3,31,14,17,39
Spart Moscow,1304,2,10,5,5,40,28,12,35
CSKA Moscow,1304,3,10,4,6,27,20,7,34
Krasnodar,1304,4,10,4,6,31,26,5,34
Zenit,1304,5,8,9,3,24,15,9,33
Terek Grozny,1304,6,8,6,6,21,22,-1,30
Din Moscow,1304,7,7,6,7,22,24,-2,27
FK Rubin,1304,8,5,5,10,23,21,2,20
Rostov,1304,9,4,6,10,10,19,-9,18
Amkar,1304,10,4,5,11,9,25,-16,17
Anzhi,1304,11,2,6,12,15,39,-24,12
Loko Moscow,1305,1,11,5,4,29,13,16,38
CSKA Moscow,1305,2,11,4,5,28,19,9,37
Krasnodar,1305,3,10,4,6,32,24,8,34
Spart Moscow,1305,4,9,5,6,40,31,9,32
Zenit,1305,5,8,8,4,23,15,8,32
Terek Grozny,1305,6,7,7,6,21,23,-2,28
Din Moscow,1305,7,6,6,8,20,25,-5,24
FK Rubin,1305,8,6,5,9,23,21,2,23
Amkar,1305,9,5,5,10,11,23,-12,20
Rostov,1305,10,4,6,10,11,21,-10,18
Anzhi,1305,11,2,7,11,16,39,-23,13
Loko Moscow,1306,1,12,5,3,31,13,18,41
CSKA Moscow,1306,2,11,3,6,27,21,6,36
Spart Moscow,1306,3,10,5,5,37,28,9,35
Krasnodar,1306,4,10,4,6,31,25,6,34
Zenit,1306,5,8,8,4,25,15,10,32
Terek Grozny,1306,6,7,6,7,22,25,-3,27
Din Moscow,1306,7,6,6,8,19,23,-4,24
Amkar,1306,8,6,4,10,13,23,-10,22
FK Rubin,1306,9,5,5,10,21,20,1,20
Rostov,1306,10,4,6,10,10,19,-9,18
Anzhi,1306,11,2,6,12,15,39,-24,12
Loko Moscow,1307,1,12,6,2,32,12,20,42
CSKA Moscow,1307,2,11,3,6,29,21,8,36
Spart Moscow,1307,3,8,7,5,34,27,7,31
Zenit,1307,4,7,9,4,24,17,7,30
Terek Grozny,1307,5,8,6,6,25,26,-1,30
Krasnodar,1307,6,8,4,8,27,27,0,28
Din Moscow,1307,7,6,7,7,20,23,-3,25
FK Rubin,1307,8,6,5,9,23,19,4,23
Amkar,1307,9,5,5,10,11,23,-12,20
Rostov,1307,10,4,7,9,10,17,-7,19
Anzhi,1307,11,3,5,12,19,42,-23,14
Loko Moscow,1308,1,11,6,3,31,14,17,39
Spart Moscow,1308,2,11,5,4,40,27,13,38
CSKA Moscow,1308,3,11,4,5,29,20,9,37
Zenit,1308,4,8,8,4,23,15,8,32
Krasnodar,1308,5,8,6,6,30,27,3,30
Terek Grozny,1308,6,8,5,7,23,25,-2,29
FK Rubin,1308,7,6,6,8,26,19,7,24
Din Moscow,1308,8,5,6,9,18,26,-8,21
Amkar,1308,9,5,4,11,13,25,-12,19
Rostov,1308,10,4,6,10,10,19,-9,18
Anzhi,1308,11,2,6,12,17,43,-26,12
Loko Moscow,1309,1,12,5,3,33,13,20,41
Spart Moscow,1309,2,10,6,4,38,26,12,36
CSKA Moscow,1309,3,10,5,5,27,19,8,35
Krasnodar,1309,4,10,4,6,31,25,6,34
Zenit,1309,5,7,9,4,22,17,5,30
Terek Grozny,1309,6,8,6,6,26,25,1,30
Din Moscow,1309,7,6,6,8,22,25,-3,24
FK Rubin,1309,8,5,5,10,22,23,-1,20
Rostov,1309,9,4,6,10,10,19,-9,18
Amkar,1309,10,4,6,10,11,24,-13,18
Anzhi,1309,11,2,6,12,16,42,-26,12
Loko Moscow,1310,1,11,7,2,32,14,18,40
CSKA Moscow,1310,2,11,3,6,29,20,9,36
Spart Moscow,1310,3,9,7,4,38,29,9,34
Zenit,1310,4,8,9,3,24,14,10,33
Krasnodar,1310,5,9,5,6,30,26,4,32
Terek Grozny,1310,6,9,5,6,24,22,2,32
Din Moscow,1310,7,5,7,8,21,26,-5,22
FK Rubin,1310,8,5,6,9,24,21,3,21
Rostov,1310,9,4,7,9,11,18,-7,19
Amkar,1310,10,4,5,11,11,25,-14,17
Anzhi,1310,11,2,5,13,15,44,-29,11
Loko Moscow,1311,1,12,5,3,30,14,16,41
CSKA Moscow,1311,2,11,3,6,28,21,7,36
Spart Moscow,1311,3,9,7,4,35,26,9,34
Krasnodar,1311,4,10,4,6,33,25,8,34
Zenit,1311,5,8,8,4,24,14,10,32
Terek Grozny,1311,6,8,5,7,21,23,-2,29
Din Moscow,1311,7,5,8,7,18,22,-4,23
FK Rubin,1311,8,5,6,9,23,21,2,21
Amkar,1311,9,5,5,10,11,23,-12,20
Rostov,1311,10,4,6,10,10,18,-8,18
Anzhi,1311,11,2,5,13,15,41,-26,11
Loko Moscow,1312,1,13,5,2,33,13,20,44
CSKA Moscow,1312,2,10,4,6,26,20,6,34
Spart Moscow,1312,3,9,5,6,35,28,7,32
Zenit,1312,4,7,9,4,22,15,7,30
Krasnodar,1312,5,8,5,7,28,26,2,29
Terek Grozny,1312,6,8,5,7,21,23,-2,29
FK Rubin,1312,7,6,6,8,23,17,6,24
Din Moscow,1312,8,6,6,8,19,24,-5,24
Rostov,1312,9,5,6,9,11,17,-6,21
Anzhi,1312,10,4,5,11,18,38,-20,17
Amkar,1312,11,4,4,12,9,24,-15,16
Loko Moscow,1313,1,12,5,3,31,13,18,41
CSKA Moscow,1313,2,11,4,5,28,18,10,37
Spart Moscow,1313,3,10,6,4,38,28,10,36
Krasnodar,1313,4,10,4,6,30,25,5,34
Zenit,1313,5,7,8,5,23,18,5,29
Terek Grozny,1313,6,7,7,6,21,23,-2,28
Din Moscow,1313,7,5,7,8,18,23,-5,22
FK Rubin,1313,8,5,6,9,22,19,3,21
Rostov,1313,9,4,6,10,11,19,-8,18
Amkar,1313,10,4,6,10,11,24,-13,18
Anzhi,1313,11,2,7,11,14,37,-23,13
Loko Moscow,1314,1,12,6,2,32,13,19,42
CSKA Moscow,1314,2,12,3,5,28,18,10,39
Spart Moscow,1314,3,9,7,4,38,29,9,34
Terek Grozny,1314,4,9,5,6,26,25,1,32
Krasnodar,1314,5,9,4,7,31,27,4,31
Zenit,1314,6,7,9,4,22,15,7,30
Din Moscow,1314,7,5,8,7,21,25,-4,23
FK Rubin,1314,8,5,6,9,23,21,2,21
Rostov,1314,9,4,6,10,10,18,-8,18
Amkar,1314,10,4,5,11,10,25,-15,17
Anzhi,1314,11,2,5,13,18,43,-25,11
Loko Moscow,1315,1,13,5,2,31,11,20,44
CSKA Moscow,1315,2,11,3,6,32,20,12,36
Zenit,1315,3,8,8,4,24,15,9,32
Spart Moscow,1315,4,8,7,5,37,30,7,31
Krasnodar,1315,5,8,5,7,29,27,2,29
Terek Grozny,1315,6,7,6,7,20,24,-4,27
FK Rubin,1315,7,6,6,8,24,19,5,24
Din Moscow,1315,8,5,7,8,18,23,-5,22
Rostov,1315,9,5,6,9,12,18,-6,21
Amkar,1315,10,4,6,10,11,24,-13,18
Anzhi,1315,11,3,5,12,16,43,-27,14
Loko Moscow,1316,1,11,6,3,30,13,17,39
Spart Moscow,1316,2,10,5,5,37,27,10,35
Zenit,1316,3,8,9,3,23,13,10,33
CSKA Moscow,1316,4,10,3,7,25,20,5,33
Krasnodar,1316,5,9,5,6,30,26,4,32
Din Moscow,1316,6,7,6,7,20,22,-2,27
Terek Grozny,1316,7,7,6,7,21,24,-3,27
FK Rubin,1316,8,5,6,9,23,20,3,21
Amkar,1316,9,5,4,11,11,25,-14,19
Rostov,1316,10,4,6,10,11,19,-8,18
Anzhi,1316,11,3,6,11,15,37,-22,15
Loko Moscow,1317,1,11,6,3,29,13,16,39
Spart Moscow,1317,2,11,5,4,40,29,11,38
CSKA Moscow,1317,3,11,3,6,27,19,8,36
Zenit,1317,4,8,9,3,22,13,9,33
Krasnodar,1317,5,9,5,6,29,24,5,32
Terek Grozny,1317,6,8,5,7,21,24,-3,29
Din Moscow,1317,7,6,6,8,20,24,-4,24
FK Rubin,1317,8,5,6,9,22,19,3,21
Amkar,1317,9,5,4,11,13,25,-12,19
Rostov,1317,10,4,6,10,11,19,-8,18
Anzhi,1317,11,2,5,13,15,40,-25,11
Loko Moscow,1318,1,11,5,4,30,15,15,38
CSKA Moscow,1318,2,11,3,6,27,19,8,36
Zenit,1318,3,9,8,3,23,13,10,35
Spart Moscow,1318,4,9,6,5,34,27,7,33
Krasnodar,1318,5,9,4,7,31,27,4,31
Terek Grozny,1318,6,8,5,7,23,24,-1,29
Din Moscow,1318,7,7,6,7,23,22,1,27
FK Rubin,1318,8,6,5,9,24,22,2,23
Amkar,1318,9,5,5,10,10,22,-12,20
Rostov,1318,10,4,6,10,10,18,-8,18
Anzhi,1318,11,2,5,13,16,42,-26,11
Loko Moscow,1319,1,12,5,3,32,14,18,41
Spart Moscow,1319,2,9,7,4,39,29,10,34
CSKA Moscow,1319,3,10,4,6,26,21,5,34
Zenit,1319,4,8,8,4,25,15,10,32
Krasnodar,1319,5,9,5,6,31,27,4,32
Terek Grozny,1319,6,8,6,6,23,24,-1,30
Din Moscow,1319,7,5,8,7,18,22,-4,23
FK Rubin,1319,8,5,7,8,23,19,4,22
Rostov,1319,9,4,7,9,11,18,-7,19
Amkar,1319,10,4,5,11,11,26,-15,17
Anzhi,1319,11,2,6,12,17,41,-24,12
Loko Moscow,1320,1,12,5,3,32,15,17,41
CSKA Moscow,1320,2,10,4,6,28,21,7,34
Zenit,1320,3,8,8,4,23,16,7,32
Krasnodar,1320,4,9,5,6,31,25,6,32
Spart Moscow,1320,5,8,7,5,35,28,7,31
Terek Grozny,1320,6,8,5,7,22,24,-2,29
FK Rubin,1320,7,6,6,8,22,17,5,24
Din Moscow,1320,8,6,6,8,18,22,-4,24
Amkar,1320,9,5,5,10,12,23,-11,20
Rostov,1320,10,4,7,9,11,18,-7,19
Anzhi,1320,11,2,6,12,16,41,-25,12
Loko Moscow,1321,1,11,5,4,30,14,16,38
Spart Moscow,1321,2,10,5,5,41,31,10,35
CSKA Moscow,1321,3,10,4,6,27,21,6,34
Zenit,1321,4,8,9,3,25,16,9,33
Krasnodar,1321,5,9,5,6,28,24,4,32
Terek Grozny,1321,6,8,5,7,22,23,-1,29
FK Rubin,1321,7,6,6,8,24,17,7,24
Rostov,1321,8,5,6,9,13,19,-6,21
Din Moscow,1321,9,5,6,9,19,27,-8,21
Amkar,1321,10,5,4,11,11,25,-14,19
Anzhi,1321,11,3,5,12,16,39,-23,14
Loko Moscow,1322,1,12,6,2,33,12,21,42
CSKA Moscow,1322,2,12,3,5,30,18,12,39
Terek Grozny,1322,3,9,5,6,22,22,0,32
Spart Moscow,1322,4,8,7,5,35,28,7,31
Zenit,1322,5,7,8,5,21,17,4,29
Krasnodar,1322,6,8,5,7,29,27,2,29
Din Moscow,1322,7,7,6,7,20,21,-1,27
FK Rubin,1322,8,6,5,9,23,20,3,23
Rostov,1322,9,4,7,9,12,19,-7,19
Amkar,1322,10,4,5,11,9,23,-14,17
Anzhi,1322,11,2,5,13,15,42,-27,11
Loko Moscow,1323,1,12,5,3,32,12,20,41
CSKA Moscow,1323,2,11,3,6,28,19,9,36
Spart Moscow,1323,3,10,5,5,39,30,9,35
Zenit,1323,4,8,8,4,23,17,6,32
Krasnodar,1323,5,9,5,6,28,24,4,32
Terek Grozny,1323,6,9,5,6,23,23,0,32
Din Moscow,1323,7,6,6,8,20,23,-3,24
FK Rubin,1323,8,5,6,9,21,19,2,21
Rostov,1323,9,5,6,9,12,18,-6,21
Amkar,1323,10,4,4,12,12,27,-15,16
Anzhi,1323,11,2,5,13,14,40,-26,11
Loko Moscow,1324,1,13,5,2,33,13,20,44
Spart Moscow,1324,2,10,6,4,39,26,13,36
CSKA Moscow,1324,3,10,4,6,26,20,6,34
Zenit,1324,4,7,9,4,22,15,7,30
Krasnodar,1324,5,8,4,8,29,29,0,28
Terek Grozny,1324,6,7,6,7,20,25,-5,27
FK Rubin,1324,7,6,6,8,24,18,6,24
Din Moscow,1324,8,5,7,8,19,24,-5,22
Rostov,1324,9,4,6,10,10,21,-11,18
Amkar,1324,10,4,6,10,9,22,-13,18
Anzhi,1324,11,4,5,11,19,37,-18,17
Loko Moscow,1325,1,11,6,3,31,14,17,39
CSKA Moscow,1325,2,11,4,5,30,18,12,37
Spart Moscow,1325,3,10,5,5,39,27,12,35
Krasnodar,1325,4,9,5,6,32,28,4,32
Zenit,1325,5,7,10,3,21,13,8,31
Terek Grozny,1325,6,8,5,7,21,23,-2,29
Din Moscow,1325,7,6,6,8,19,26,-7,24
FK Rubin,1325,8,5,6,9,24,21,3,21
Amkar,1325,9,5,4,11,10,23,-13,19
Rostov,1325,10,4,6,10,11,19,-8,18
Anzhi,1325,11,3,5,12,16,42,-26,14
Loko Moscow,1326,1,12,6,2,33,14,19,42
CSKA Moscow,1326,2,11,4,5,27,18,9,37
Spart Moscow,1326,3,10,5,5,39,28,11,35
Terek Grozny,1326,4,9,5,6,23,22,1,32
Krasnodar,1326,5,9,4,7,31,28,3,31
Zenit,1326,6,7,9,4,23,16,7,30
Din Moscow,1326,7,6,6,8,19,22,-3,24
FK Rubin,1326,8,5,5,10,22,21,1,20
Amkar,1326,9,5,4,11,11,25,-14,19
Rostov,1326,10,4,6,10,11,21,-10,18
Anzhi,1326,11,2,6,12,14,38,-24,12
Loko Moscow,1327,1,12,5,3,32,15,17,41
Zenit,1327,2,9,8,3,26,15,11,35
CSKA Moscow,1327,3,10,4,6,26,19,7,34
Spart Moscow,1327,4,9,6,5,37,28,9,33
Krasnodar,1327,5,8,4,8,29,28,1,28
Din Moscow,1327,6,7,6,7,22,21,1,27
Terek Grozny,1327,7,7,6,7,20,23,-3,27
FK Rubin,1327,8,6,5,9,23,22,1,23
Rostov,1327,9,4,6,10,10,19,-9,18
Amkar,1327,10,4,6,10,11,24,-13,18
Anzhi,1327,11,3,6,11,15,37,-22,15
Loko Moscow,1328,1,11,6,3,30,13,17,39
CSKA Moscow,1328,2,11,4,5,26,17,9,37
Spart Moscow,1328,3,10,6,4,42,28,14,36
Zenit,1328,4,8,8,4,22,14,8,32
Krasnodar,1328,5,8,6,6,29,26,3,30
Terek Grozny,1328,6,7,5,8,21,25,-4,26
Din Moscow,1328,7,6,7,7,19,22,-3,25
FK Rubin,1328,8,5,6,9,22,19,3,21
Amkar,1328,9,5,4,11,12,27,-15,19
Rostov,1328,10,4,6,10,11,21,-10,18
Anzhi,1328,11,3,6,11,15,37,-22,15
Loko Moscow,1329,1,11,7,2,30,12,18,40
Spart Moscow,1329,2,10,6,4,36,26,10,36
CSKA Moscow,1329,3,11,3,6,30,22,8,36
Zenit,1329,4,8,9,3,27,15,12,33
Krasnodar,1329,5,8,5,7,29,27,2,29
Terek Grozny,1329,6,8,5,7,26,27,-1,29
FK Rubin,1329,7,7,5,8,26,19,7,26
Din Moscow,1329,8,5,6,9,17,24,-7,21
Rostov,1329,9,4,6,10,10,18,-8,18
Amkar,1329,10,4,5,11,11,27,-16,17
Anzhi,1329,11,3,5,12,18,43,-25,14
Loko Moscow,1330,1,11,7,2,30,12,18,40
CSKA Moscow,1330,2,11,3,6,28,19,9,36
Spart Moscow,1330,3,10,5,5,40,31,9,35
Zenit,1330,4,8,9,3,22,13,9,33
Krasnodar,1330,5,8,6,6,29,26,3,30
Terek Grozny,1330,6,7,7,6,23,25,-2,28
FK Rubin,1330,7,6,6,8,24,18,6,24
Din Moscow,1330,8,5,6,9,19,26,-7,21
Amkar,1330,9,5,5,10,14,26,-12,20
Rostov,1330,10,4,6,10,11,19,-8,18
Anzhi,1330,11,2,6,12,16,41,-25,12
Loko Moscow,1331,1,12,5,3,33,14,19,41
Spart Moscow,1331,2,11,5,4,38,26,12,38
CSKA Moscow,1331,3,11,4,5,29,19,10,37
Krasnodar,1331,4,10,4,6,35,25,10,34
Zenit,1331,5,7,8,5,22,19,3,29
Terek Grozny,1331,6,7,6,7,22,25,-3,27
Din Moscow,1331,7,6,6,8,20,23,-3,24
FK Rubin,1331,8,5,5,10,21,24,-3,20
Rostov,1331,9,4,6,10,10,18,-8,18
Amkar,1331,10,4,5,11,9,24,-15,17
Anzhi,1331,11,3,6,11,18,40,-22,15
Loko Moscow,1332,1,11,5,4,30,17,13,38
CSKA Moscow,1332,2,11,3,6,30,18,12,36
Zenit,1332,3,9,8,3,25,14,11,35
Krasnodar,1332,4,10,4,6,32,25,7,34
Spart Moscow,1332,5,9,6,5,36,28,8,33
Terek Grozny,1332,6,9,5,6,24,22,2,32
Din Moscow,1332,7,5,7,8,18,23,-5,22
FK Rubin,1332,8,5,6,9,23,20,3,21
Rostov,1332,9,5,6,9,13,19,-6,21
Amkar,1332,10,4,5,11,9,24,-15,17
Anzhi,1332,11,2,5,13,14,44,-30,11
Loko Moscow,1333,1,12,5,3,32,13,19,41
CSKA Moscow,1333,2,11,3,6,26,19,7,36
Zenit,1333,3,9,8,3,25,13,12,35
Spart Moscow,1333,4,9,6,5,37,27,10,33
Terek Grozny,1333,5,8,5,7,24,24,0,29
Krasnodar,1333,6,8,4,8,28,30,-2,28
FK Rubin,1333,7,7,5,8,25,18,7,26
Din Moscow,1333,8,5,7,8,17,22,-5,22
Rostov,1333,9,5,6,9,11,17,-6,21
Amkar,1333,10,5,4,11,12,27,-15,19
Anzhi,1333,11,2,5,13,14,41,-27,11
Loko Moscow,1334,1,11,5,4,31,17,14,38
Zenit,1334,2,9,8,3,27,15,12,35
Spart Moscow,1334,3,10,5,5,35,28,7,35
CSKA Moscow,1334,4,10,4,6,26,21,5,34
Krasnodar,1334,5,9,4,7,31,26,5,31
Terek Grozny,1334,6,8,6,6,21,22,-1,30
FK Rubin,1334,7,7,5,8,24,18,6,26
Din Moscow,1334,8,6,6,8,20,22,-2,24
Rostov,1334,9,4,6,10,10,18,-8,18
Amkar,1334,10,4,5,11,9,23,-14,17
Anzhi,1334,11,2,6,12,15,39,-24,12
Loko Moscow,1335,1,11,7,2,31,13,18,40
CSKA Moscow,1335,2,12,3,5,29,17,12,39
Spart Moscow,1335,3,9,6,5,35,27,8,33
Krasnodar,1335,4,9,5,6,30,26,4,32
Zenit,1335,5,7,9,4,22,15,7,30
Terek Grozny,1335,6,8,5,7,21,23,-2,29
Din Moscow,1335,7,6,6,8,21,23,-2,24
Rostov,1335,8,5,6,9,11,17,-6,21
FK Rubin,1335,9,5,5,10,22,22,0,20
Amkar,1335,10,5,5,10,10,22,-12,20
Anzhi,1335,11,2,5,13,14,41,-27,11
Loko Moscow,1336,1,11,6,3,30,15,15,39
Spart Moscow,1336,2,10,6,4,42,31,11,36
Krasnodar,1336,3,10,4,6,33,24,9,34
Zenit,1336,4,8,9,3,25,14,11,33
CSKA Moscow,1336,5,10,3,7,25,22,3,33
Terek Grozny,1336,6,8,5,7,24,25,-1,29
Din Moscow,1336,7,6,6,8,23,25,-2,24
FK Rubin,1336,8,5,5,10,21,23,-2,20
Rostov,1336,9,4,7,9,11,18,-7,19
Amkar,1336,10,5,4,11,14,28,-14,19
Anzhi,1336,11,3,5,12,16,39,-23,14
CSKA Moscow,1337,1,12,3,5,32,19,13,39
Loko Moscow,1337,2,11,5,4,31,18,13,38
Krasnodar,1337,3,10,4,6,35,27,8,34
Zenit,1337,4,8,8,4,24,15,9,32
Spart Moscow,1337,5,8,7,5,36,29,7,31
Terek Grozny,1337,6,7,6,7,22,25,-3,27
Din Moscow,1337,7,6,7,7,22,24,-2,25
FK Rubin,1337,8,5,5,10,23,23,0,20
Amkar,1337,9,5,5,10,12,24,-12,20
Rostov,1337,10,4,7,9,10,17,-7,19
Anzhi,1337,11,3,5,12,17,43,-26,14
Loko Moscow,1338,1,11,6,3,30,14,16,39
CSKA Moscow,1338,2,11,4,5,31,22,9,37
Spart Moscow,1338,3,10,5,5,39,30,9,35
Zenit,1338,4,8,9,3,24,14,10,33
Krasnodar,1338,5,8,5,7,28,26,2,29
Terek Grozny,1338,6,8,5,7,22,25,-3,29
FK Rubin,1338,7,7,5,8,25,17,8,26
Din Moscow,1338,8,6,6,8,20,26,-6,24
Rostov,1338,9,4,6,10,11,19,-8,18
Amkar,1338,10,4,4,12,10,26,-16,16
Anzhi,1338,11,3,5,12,21,42,-21,14
Loko Moscow,1339,1,11,5,4,30,16,14,38
CSKA Moscow,1339,2,11,3,6,28,20,8,36
Zenit,1339,3,9,8,3,26,15,11,35
Krasnodar,1339,4,9,4,7,30,26,4,31
Spart Moscow,1339,5,8,5,7,36,35,1,29
Din Moscow,1339,6,7,6,7,21,21,0,27
Terek Grozny,1339,7,7,6,7,23,27,-4,27
FK Rubin,1339,8,6,5,9,23,20,3,23
Rostov,1339,9,5,6,9,13,19,-6,21
Amkar,1339,10,5,5,10,16,25,-9,20
Anzhi,1339,11,3,5,12,18,40,-22,14
Loko Moscow,1340,1,11,7,2,30,12,18,40
Spart Moscow,1340,2,10,6,4,43,28,15,36
CSKA Moscow,1340,3,11,3,6,29,19,10,36
Zenit,1340,4,8,9,3,23,14,9,33
Krasnodar,1340,5,9,5,6,30,26,4,32
Terek Grozny,1340,6,9,5,6,22,22,0,32
Din Moscow,1340,7,5,8,7,18,22,-4,23
FK Rubin,1340,8,5,6,9,22,19,3,21
Rostov,1340,9,4,6,10,11,21,-10,18
Amkar,1340,10,4,4,12,10,28,-18,16
Anzhi,1340,11,2,5,13,14,41,-27,11
Loko Moscow,1341,1,13,5,2,33,11,22,44
CSKA Moscow,1341,2,11,3,6,28,19,9,36
Zenit,1341,3,8,8,4,23,16,7,32
Krasnodar,1341,4,9,4,7,29,26,3,31
Spart Moscow,1341,5,8,6,6,36,32,4,30
Terek Grozny,1341,6,7,7,6,21,23,-2,28
Din Moscow,1341,7,6,6,8,21,24,-3,24
FK Rubin,1341,8,6,5,9,24,20,4,23
Rostov,1341,9,5,6,9,13,18,-5,21
Amkar,1341,10,4,6,10,10,23,-13,18
Anzhi,1341,11,2,6,12,15,41,-26,12
Loko Moscow,1342,1,12,5,3,31,15,16,41
CSKA Moscow,1342,2,11,3,6,30,21,9,36
Spart Moscow,1342,3,10,5,5,38,26,12,35
Zenit,1342,4,8,8,4,25,15,10,32
Krasnodar,1342,5,9,5,6,32,26,6,32
Terek Grozny,1342,6,7,7,6,21,23,-2,28
Din Moscow,1342,7,6,6,8,19,22,-3,24
FK Rubin,1342,8,5,6,9,22,20,2,21
Amkar,1342,9,5,5,10,11,23,-12,20
Rostov,1342,10,4,6,10,10,21,-11,18
Anzhi,1342,11,2,6,12,14,41,-27,12
Loko Moscow,1343,1,12,5,3,31,14,17,41
CSKA Moscow,1343,2,11,4,5,28,19,9,37
Spart Moscow,1343,3,10,5,5,39,29,10,35
Krasnodar,1343,4,9,5,6,31,26,5,32
Terek Grozny,1343,5,8,6,6,24,25,-1,30
Zenit,1343,6,7,8,5,22,16,6,29
FK Rubin,1343,7,5,7,8,23,19,4,22
Din Moscow,1343,8,5,7,8,18,24,-6,22
Amkar,1343,9,5,5,10,13,25,-12,20
Rostov,1343,10,4,6,10,12,20,-8,18
Anzhi,1343,11,2,6,12,16,40,-24,12
Loko Moscow,1344,1,12,5,3,32,12,20,41
CSKA Moscow,1344,2,11,3,6,27,19,8,36
Zenit,1344,3,9,8,3,23,13,10,35
Spart Moscow,1344,4,9,7,4,38,25,13,34
Krasnodar,1344,5,8,4,8,28,29,-1,28
Terek Grozny,1344,6,7,5,8,20,25,-5,26
Din Moscow,1344,7,6,7,7,18,21,-3,25
FK Rubin,1344,8,6,5,9,23,19,4,23
Amkar,1344,9,5,5,10,11,22,-11,20
Rostov,1344,10,4,6,10,10,22,-12,18
Anzhi,1344,11,3,5,12,16,39,-23,14
Loko Moscow,1345,1,12,6,2,33,14,19,42
CSKA Moscow,1345,2,11,4,5,27,18,9,37
Spart Moscow,1345,3,10,6,4,39,26,13,36
Krasnodar,1345,4,9,5,6,30,25,5,32
Zenit,1345,5,7,8,5,23,17,6,29
Terek Grozny,1345,6,7,7,6,22,24,-2,28
Din Moscow,1345,7,5,7,8,18,23,-5,22
FK Rubin,1345,8,5,6,9,22,20,2,21
Rostov,1345,9,4,6,10,10,21,-11,18
Amkar,1345,10,4,6,10,11,24,-13,18
Anzhi,1345,11,2,7,11,16,39,-23,13
Loko Moscow,1346,1,12,6,2,31,12,19,42
CSKA Moscow,1346,2,11,3,6,27,19,8,36
Spart Moscow,1346,3,10,5,5,37,29,8,35
Zenit,1346,4,8,9,3,24,15,9,33
Terek Grozny,1346,5,8,5,7,23,24,-1,29
Krasnodar,1346,6,8,4,8,28,28,0,28
Din Moscow,1346,7,7,6,7,21,21,0,27
FK Rubin,1346,8,6,5,9,24,19,5,23
Rostov,1346,9,4,6,10,11,20,-9,18
Amkar,1346,10,4,4,12,9,25,-16,16
Anzhi,1346,11,3,5,12,16,39,-23,14
Loko Moscow,1347,1,13,5,2,33,11,22,44
CSKA Moscow,1347,2,11,3,6,29,20,9,36
Spart Moscow,1347,3,9,6,5,38,30,8,33
Zenit,1347,4,8,8,4,23,15,8,32
Terek Grozny,1347,5,8,6,6,23,24,-1,30
Krasnodar,1347,6,8,5,7,28,27,1,29
Din Moscow,1347,7,6,6,8,22,23,-1,24
FK Rubin,1347,8,5,6,9,22,22,0,21
Amkar,1347,9,5,5,10,12,24,-12,20
Rostov,1347,10,4,7,9,11,18,-7,19
Anzhi,1347,11,2,5,13,17,44,-27,11
Loko Moscow,1348,1,11,7,2,30,12,18,40
CSKA Moscow,1348,2,11,3,6,26,18,8,36
Spart Moscow,1348,3,9,6,5,38,29,9,33
Zenit,1348,4,7,9,4,22,15,7,30
Krasnodar,1348,5,8,6,6,28,25,3,30
Terek Grozny,1348,6,8,6,6,23,24,-1,30
FK Rubin,1348,7,5,7,8,23,19,4,22
Din Moscow,1348,8,5,7,8,18,24,-6,22
Amkar,1348,9,5,5,10,12,24,-12,20
Rostov,1348,10,4,7,9,12,19,-7,19
Anzhi,1348,11,3,5,12,16,39,-23,14
Loko Moscow,1349,1,13,5,2,32,12,20,44
CSKA Moscow,1349,2,11,4,5,28,18,10,37
Spart Moscow,1349,3,9,5,6,37,32,5,32
Zenit,1349,4,7,9,4,22,15,7,30
Krasnodar,1349,5,8,4,8,28,27,1,28
Terek Grozny,1349,6,7,7,6,22,24,-2,28
FK Rubin,1349,7,6,6,8,25,20,5,24
Din Moscow,1349,8,5,7,8,21,26,-5,22
Rostov,1349,9,5,6,9,12,18,-6,21
Amkar,1349,10,5,5,10,14,24,-10,20
Anzhi,1349,11,2,6,12,15,40,-25,12
Loko Moscow,1350,1,13,5,2,35,12,23,44
CSKA Moscow,1350,2,11,4,5,27,18,9,37
Spart Moscow,1350,3,10,5,5,41,30,11,35
Krasnodar,1350,4,9,4,7,30,26,4,31
Zenit,1350,5,7,8,5,22,19,3,29
Terek Grozny,1350,6,7,7,6,23,25,-2,28
FK Rubin,1350,7,6,5,9,24,20,4,23
Rostov,1350,8,5,6,9,11,17,-6,21
Din Moscow,1350,9,5,6,9,18,27,-9,21
Amkar,1350,10,4,5,11,13,27,-14,17
Anzhi,1350,11,2,7,11,17,40,-23,13
Loko Moscow,1351,1,11,7,2,34,16,18,40
Spart Moscow,1351,2,10,5,5,42,31,11,35
CSKA Moscow,1351,3,10,4,6,27,22,5,34
Zenit,1351,4,8,9,3,27,16,11,33
Krasnodar,1351,5,8,6,6,32,29,3,30
Terek Grozny,1351,6,7,5,8,21,26,-5,26
FK Rubin,1351,7,6,6,8,26,21,5,24
Amkar,1351,8,6,4,10,12,23,-11,22
Din Moscow,1351,9,5,6,9,20,28,-8,21
Rostov,1351,10,4,6,10,13,21,-8,18
Anzhi,1351,11,3,6,11,18,39,-21,15
Loko Moscow,1352,1,12,5,3,31,13,18,41
Spart Moscow,1352,2,10,6,4,38,28,10,36
CSKA Moscow,1352,3,11,3,6,27,20,7,36
Zenit,1352,4,8,8,4,24,15,9,32
Krasnodar,1352,5,9,4,7,28,29,-1,31
Terek Grozny,1352,6,8,5,7,21,23,-2,29
Din Moscow,1352,7,6,7,7,19,22,-3,25
FK Rubin,1352,8,6,5,9,26,18,8,23
Amkar,1352,9,5,4,11,11,24,-13,19
Rostov,1352,10,4,6,10,11,19,-8,18
Anzhi,1352,11,2,5,13,15,40,-25,11
Loko Moscow,1353,1,12,6,2,31,12,19,42
Spart Moscow,1353,2,10,5,5,39,28,11,35
CSKA Moscow,1353,3,10,4,6,27,21,6,34
Zenit,1353,4,7,10,3,23,15,8,31
Krasnodar,1353,5,9,4,7,29,26,3,31
Terek Grozny,1353,6,7,5,8,22,26,-4,26
Din Moscow,1353,7,5,7,8,19,26,-7,22
Amkar,1353,8,6,4,10,13,24,-11,22
FK Rubin,1353,9,5,6,9,22,19,3,21
Rostov,1353,10,4,6,10,10,18,-8,18
Anzhi,1353,11,4,5,11,18,38,-20,17
Loko Moscow,1354,1,11,6,3,32,16,16,39
CSKA Moscow,1354,2,11,4,5,29,20,9,37
Spart Moscow,1354,3,10,5,5,39,30,9,35
Zenit,1354,4,7,10,3,25,17,8,31
Krasnodar,1354,5,9,4,7,30,26,4,31
Terek Grozny,1354,6,7,6,7,20,24,-4,27
Din Moscow,1354,7,6,6,8,20,25,-5,24
FK Rubin,1354,8,6,5,9,22,19,3,23
Amkar,1354,9,6,4,10,15,23,-8,22
Rostov,1354,10,4,6,10,10,18,-8,18
Anzhi,1354,11,2,6,12,15,39,-24,12
Loko Moscow,1355,1,11,6,3,30,16,14,39
CSKA Moscow,1355,2,11,4,5,28,19,9,37
Spart Moscow,1355,3,9,6,5,40,30,10,33
Zenit,1355,4,8,8,4,26,15,11,32
Krasnodar,1355,5,9,5,6,29,25,4,32
Terek Grozny,1355,6,7,6,7,21,25,-4,27
FK Rubin,1355,7,6,5,9,22,18,4,23
Rostov,1355,8,5,6,9,12,17,-5,21
Din Moscow,1355,9,5,6,9,19,28,-9,21
Amkar,1355,10,4,6,10,11,24,-13,18
Anzhi,1355,11,3,6,11,17,38,-21,15
Loko Moscow,1356,1,12,5,3,31,13,18,41
CSKA Moscow,1356,2,11,3,6,29,19,10,36
Spart Moscow,1356,3,9,6,5,37,30,7,33
Zenit,1356,4,8,8,4,22,15,7,32
Krasnodar,1356,5,9,4,7,29,25,4,31
Terek Grozny,1356,6,7,7,6,20,22,-2,28
FK Rubin,1356,7,7,5,8,23,17,6,26
Din Moscow,1356,8,5,7,8,18,23,-5,22
Amkar,1356,9,5,5,10,11,22,-11,20
Rostov,1356,10,4,6,10,12,20,-8,18
Anzhi,1356,11,2,6,12,15,41,-26,12
Loko Moscow,1357,1,12,5,3,31,13,18,41
CSKA Moscow,1357,2,12,3,5,31,17,14,39
Krasnodar,1357,3,10,4,6,31,24,7,34
Spart Moscow,1357,4,9,5,6,36,27,9,32
Zenit,1357,5,7,8,5,22,17,5,29
Terek Grozny,1357,6,7,7,6,22,24,-2,28
FK Rubin,1357,7,6,5,9,22,20,2,23
Rostov,1357,8,5,6,9,11,17,-6,21
Din Moscow,1357,9,5,6,9,17,25,-8,21
Amkar,1357,10,5,5,10,11,23,-12,20
Anzhi,1357,11,2,6,12,15,42,-27,12
Loko Moscow,1358,1,12,6,2,35,13,22,42
CSKA Moscow,1358,2,11,4,5,27,18,9,37
Spart Moscow,1358,3,9,5,6,37,31,6,32
Krasnodar,1358,4,9,5,6,30,26,4,32
Zenit,1358,5,7,9,4,22,18,4,30
Terek Grozny,1358,6,8,6,6,22,23,-1,30
Din Moscow,1358,7,6,7,7,22,25,-3,25
FK Rubin,1358,8,5,6,9,23,20,3,21
Rostov,1358,9,5,6,9,12,17,-5,21
Amkar,1358,10,4,4,12,10,25,-15,16
Anzhi,1358,11,2,6,12,15,39,-24,12
Loko Moscow,1359,1,11,6,3,31,14,17,39
CSKA Moscow,1359,2,11,3,6,26,20,6,36
Zenit,1359,3,9,8,3,26,14,12,35
Spart Moscow,1359,4,9,5,6,37,30,7,32
Terek Grozny,1359,5,8,6,6,23,24,-1,30
Krasnodar,1359,6,8,5,7,29,27,2,29
Din Moscow,1359,7,7,6,7,20,22,-2,27
FK Rubin,1359,8,6,5,9,23,19,4,23
Rostov,1359,9,5,6,9,13,18,-5,21
Amkar,1359,10,4,5,11,10,25,-15,17
Anzhi,1359,11,2,5,13,15,40,-25,11
Loko Moscow,1360,1,12,6,2,32,13,19,42
CSKA Moscow,1360,2,11,4,5,28,18,10,37
Spart Moscow,1360,3,9,5,6,35,28,7,32
Krasnodar,1360,4,9,4,7,30,27,3,31
Zenit,1360,5,7,9,4,23,17,6,30
Din Moscow,1360,6,7,6,7,20,21,-1,27
Terek Grozny,1360,7,7,6,7,23,27,-4,27
Rostov,1360,8,5,6,9,11,17,-6,21
FK Rubin,1360,9,5,5,10,22,21,1,20
Amkar,1360,10,5,4,11,13,25,-12,19
Anzhi,1360,11,2,7,11,16,39,-23,13
Loko Moscow,1361,1,11,5,4,30,14,16,38
Spart Moscow,1361,2,9,7,4,37,28,9,34
CSKA Moscow,1361,3,10,4,6,26,19,7,34
Zenit,1361,4,8,9,3,24,15,9,33
Krasnodar,1361,5,9,5,6,29,25,4,32
Terek Grozny,1361,6,7,7,6,23,25,-2,28
FK Rubin,1361,7,6,6,8,26,18,8,24
Din Moscow,1361,8,5,6,9,18,27,-9,21
Rostov,1361,9,4,7,9,11,18,-7,19
Amkar,1361,10,4,6,10,12,25,-13,18
Anzhi,1361,11,3,6,11,16,38,-22,15
Loko Moscow,1362,1,12,5,3,31,12,19,41
CSKA Moscow,1362,2,11,3,6,27,22,5,36
Spart Moscow,1362,3,9,7,4,37,27,10,34
Zenit,1362,4,8,8,4,25,15,10,32
Krasnodar,1362,5,9,5,6,29,25,4,32
Terek Grozny,1362,6,8,5,7,23,24,-1,29
FK Rubin,1362,7,6,6,8,24,18,6,24
Din Moscow,1362,8,5,7,8,17,23,-6,22
Rostov,1362,9,4,7,9,12,19,-7,19
Amkar,1362,10,4,4,12,9,26,-17,16
Anzhi,1362,11,3,5,12,17,40,-23,14
Loko Moscow,1363,1,12,5,3,31,12,19,41
CSKA Moscow,1363,2,11,4,5,28,19,9,37
Krasnodar,1363,3,10,4,6,29,24,5,34
Zenit,1363,4,7,9,4,22,16,6,30
Spart Moscow,1363,5,8,5,7,33,29,4,29
Terek Grozny,1363,6,8,5,7,23,25,-2,29
Din Moscow,1363,7,6,6,8,18,25,-7,24
FK Rubin,1363,8,6,5,9,25,18,7,23
Amkar,1363,9,6,4,10,12,22,-10,22
Rostov,1363,10,5,6,9,12,17,-5,21
Anzhi,1363,11,2,5,13,16,42,-26,11
Loko Moscow,1364,1,13,5,2,33,11,22,44
CSKA Moscow,1364,2,11,4,5,28,19,9,37
Spart Moscow,1364,3,10,5,5,40,29,11,35
Krasnodar,1364,4,9,4,7,31,26,5,31
Zenit,1364,5,7,9,4,21,16,5,30
Terek Grozny,1364,6,7,5,8,20,24,-4,26
Din Moscow,1364,7,5,7,8,21,26,-5,22
Amkar,1364,8,6,4,10,13,24,-11,22
FK Rubin,1364,9,5,6,9,25,24,1,21
Rostov,1364,10,4,6,10,10,20,-10,18
Anzhi,1364,11,3,5,12,17,40,-23,14
Loko Moscow,1365,1,12,6,2,32,12,20,42
Zenit,1365,2,8,9,3,22,13,9,33
CSKA Moscow,1365,3,10,3,7,27,21,6,33
Spart Moscow,1365,4,8,6,6,35,31,4,30
Terek Grozny,1365,5,8,6,6,24,23,1,30
Krasnodar,1365,6,8,4,8,28,28,0,28
Din Moscow,1365,7,6,7,7,19,22,-3,25
FK Rubin,1365,8,6,6,8,22,17,5,24
Amkar,1365,9,5,5,10,13,23,-10,20
Rostov,1365,10,4,7,9,11,18,-7,19
Anzhi,1365,11,3,5,12,17,42,-25,14
Loko Moscow,1366,1,13,5,2,35,14,21,44
CSKA Moscow,1366,2,11,4,5,28,18,10,37
Spart Moscow,1366,3,10,6,4,37,26,11,36
Zenit,1366,4,7,9,4,23,17,6,30
Terek Grozny,1366,5,8,5,7,22,23,-1,29
Krasnodar,1366,6,8,4,8,28,29,-1,28
FK Rubin,1366,7,6,6,8,25,18,7,24
Din Moscow,1366,8,5,7,8,18,24,-6,22
Rostov,1366,9,4,7,9,11,18,-7,19
Amkar,1366,10,5,4,11,10,23,-13,19
Anzhi,1366,11,2,5,13,15,42,-27,11
Loko Moscow,1367,1,11,7,2,31,13,18,40
CSKA Moscow,1367,2,12,3,5,30,17,13,39
Spart Moscow,1367,3,11,5,4,37,26,11,38
Zenit,1367,4,7,9,4,22,15,7,30
Krasnodar,1367,5,8,5,7,29,27,2,29
Terek Grozny,1367,6,7,6,7,22,25,-3,27
FK Rubin,1367,7,7,5,8,27,21,6,26
Din Moscow,1367,8,5,6,9,21,27,-6,21
Rostov,1367,9,4,6,10,10,18,-8,18
Amkar,1367,10,4,5,11,10,24,-14,17
Anzhi,1367,11,3,5,12,16,42,-26,14
Loko Moscow,1368,1,12,6,2,34,13,21,42
CSKA Moscow,1368,2,12,3,5,31,17,14,39
Spart Moscow,1368,3,10,5,5,39,30,9,35
Krasnodar,1368,4,9,5,6,30,26,4,32
Terek Grozny,1368,5,8,6,6,23,24,-1,30
Zenit,1368,6,7,8,5,21,17,4,29
FK Rubin,1368,7,6,5,9,22,18,4,23
Din Moscow,1368,8,5,6,9,19,25,-6,21
Rostov,1368,9,5,6,9,12,18,-6,21
Amkar,1368,10,4,5,11,11,25,-14,17
Anzhi,1368,11,2,5,13,15,44,-29,11
Loko Moscow,1369,1,11,7,2,30,12,18,40
Spart Moscow,1369,2,11,5,4,38,27,11,38
CSKA Moscow,1369,3,11,4,5,30,21,9,37
Krasnodar,1369,4,9,5,6,31,24,7,32
Zenit,1369,5,7,10,3,23,15,8,31
Terek Grozny,1369,6,8,6,6,23,23,0,30
Din Moscow,1369,7,6,6,8,20,23,-3,24
FK Rubin,1369,8,5,5,10,21,23,-2,20
Rostov,1369,9,4,6,10,10,18,-8,18
Amkar,1369,10,4,4,12,10,26,-16,16
Anzhi,1369,11,2,6,12,18,42,-24,12
Loko Moscow,1370,1,12,6,2,30,11,19,42
CSKA Moscow,1370,2,12,3,5,31,20,11,39
Spart Moscow,1370,3,9,6,5,37,28,9,33
Zenit,1370,4,7,8,5,23,17,6,29
Krasnodar,1370,5,8,5,7,27,25,2,29
Terek Grozny,1370,6,8,5,7,22,23,-1,29
FK Rubin,1370,7,6,6,8,23,18,5,24
Din Moscow,1370,8,5,7,8,18,25,-7,22
Amkar,1370,9,6,4,10,12,22,-10,22
Rostov,1370,10,4,7,9,11,18,-7,19
Anzhi,1370,11,2,5,13,15,42,-27,11
Loko Moscow,1371,1,12,5,3,31,12,19,41
CSKA Moscow,1371,2,11,4,5,27,17,10,37
Spart Moscow,1371,3,10,5,5,40,28,12,35
Krasnodar,1371,4,9,5,6,28,24,4,32
Zenit,1371,5,7,9,4,21,15,6,30
Terek Grozny,1371,6,8,5,7,23,27,-4,29
FK Rubin,1371,7,6,6,8,25,19,6,24
Din Moscow,1371,8,5,6,9,19,27,-8,21
Amkar,1371,9,5,4,11,12,24,-12,19
Rostov,1371,10,4,6,10,11,22,-11,18
Anzhi,1371,11,3,5,12,18,40,-22,14
Loko Moscow,1372,1,11,6,3,31,15,16,39
CSKA Moscow,1372,2,10,4,6,25,18,7,34
Krasnodar,1372,3,10,4,6,31,25,6,34
Zenit,1372,4,8,9,3,23,14,9,33
Spart Moscow,1372,5,9,5,6,38,32,6,32
Terek Grozny,1372,6,8,6,6,23,24,-1,30
Din Moscow,1372,7,6,7,7,19,22,-3,25
FK Rubin,1372,8,5,6,9,21,18,3,21
Rostov,1372,9,5,6,9,13,18,-5,21
Amkar,1372,10,4,5,11,13,27,-14,17
Anzhi,1372,11,2,6,12,14,38,-24,12
Loko Moscow,1373,1,13,5,2,32,12,20,44
CSKA Moscow,1373,2,11,3,6,29,19,10,36
Spart Moscow,1373,3,9,6,5,37,28,9,33
Zenit,1373,4,8,8,4,24,16,8,32
Krasnodar,1373,5,8,5,7,28,26,2,29
Terek Grozny,1373,6,7,7,6,21,23,-2,28
FK Rubin,1373,7,6,6,8,24,18,6,24
Din Moscow,1373,8,6,6,8,19,24,-5,24
Rostov,1373,9,4,7,9,10,17,-7,19
Amkar,1373,10,4,5,11,11,26,-15,17
Anzhi,1373,11,2,6,12,14,40,-26,12
Loko Moscow,1374,1,11,5,4,29,14,15,38
CSKA Moscow,1374,2,11,3,6,27,18,9,36
Spart Moscow,1374,3,10,5,5,40,30,10,35
Zenit,1374,4,9,8,3,23,13,10,35
Krasnodar,1374,5,10,4,6,30,24,6,34
Terek Grozny,1374,6,8,5,7,24,25,-1,29
Din Moscow,1374,7,6,6,8,19,25,-6,24
Amkar,1374,8,6,4,10,14,24,-10,22
FK Rubin,1374,9,5,5,10,21,19,2,20
Rostov,1374,10,4,6,10,11,19,-8,18
Anzhi,1374,11,2,5,13,15,42,-27,11
Loko Moscow,1375,1,11,6,3,32,16,16,39
Zenit,1375,2,8,9,3,25,15,10,33
Spart Moscow,1375,3,9,6,5,39,31,8,33
CSKA Moscow,1375,4,10,3,7,25,21,4,33
Krasnodar,1375,5,9,4,7,30,26,4,31
Terek Grozny,1375,6,7,6,7,22,28,-6,27
FK Rubin,1375,7,7,5,8,25,17,8,26
Din Moscow,1375,8,6,6,8,22,27,-5,24
Rostov,1375,9,4,6,10,10,19,-9,18
Amkar,1375,10,4,6,10,12,25,-13,18
Anzhi,1375,11,4,5,11,20,37,-17,17
Loko Moscow,1376,1,12,6,2,32,13,19,42
Spart Moscow,1376,2,10,6,4,39,26,13,36
CSKA Moscow,1376,3,11,3,6,28,19,9,36
Zenit,1376,4,8,8,4,23,15,8,32
Krasnodar,1376,5,9,5,6,31,26,5,32
Terek Grozny,1376,6,8,5,7,24,26,-2,29
FK Rubin,1376,7,6,5,9,23,19,4,23
Din Moscow,1376,8,5,7,8,17,23,-6,22
Amkar,1376,9,5,4,11,11,26,-15,19
Rostov,1376,10,4,6,10,11,20,-9,18
Anzhi,1376,11,2,5,13,16,42,-26,11
Loko Moscow,1377,1,12,5,3,31,13,18,41
CSKA Moscow,1377,2,11,3,6,27,22,5,36
Spart Moscow,1377,3,10,5,5,40,28,12,35
Krasnodar,1377,4,10,4,6,32,26,6,34
Zenit,1377,5,8,8,4,26,14,12,32
Terek Grozny,1377,6,9,5,6,22,22,0,32
Din Moscow,1377,7,5,7,8,18,24,-6,22
FK Rubin,1377,8,5,6,9,23,21,2,21
Rostov,1377,9,5,6,9,13,19,-6,21
Amkar,1377,10,4,4,12,9,26,-17,16
Anzhi,1377,11,2,5,13,14,40,-26,11
Loko Moscow,1378,1,12,5,3,32,14,18,41
Krasnodar,1378,2,10,4,6,33,28,5,34
Spart Moscow,1378,3,9,6,5,36,28,8,33
CSKA Moscow,1378,4,10,3,7,28,26,2,33
Zenit,1378,5,8,8,4,27,15,12,32
Terek Grozny,1378,6,8,5,7,22,23,-1,29
Din Moscow,1378,7,6,6,8,19,24,-5,24
FK Rubin,1378,8,6,5,9,26,20,6,23
Amkar,1378,9,5,5,10,11,23,-12,20
Rostov,1378,10,4,6,10,10,19,-9,18
Anzhi,1378,11,3,5,12,17,41,-24,14
Loko Moscow,1379,1,11,6,3,30,13,17,39
Spart Moscow,1379,2,10,5,5,36,27,9,35
CSKA Moscow,1379,3,10,4,6,26,19,7,34
Zenit,1379,4,8,9,3,23,14,9,33
Krasnodar,1379,5,9,4,7,29,26,3,31
Terek Grozny,1379,6,8,5,7,23,25,-2,29
FK Rubin,1379,7,6,6,8,24,19,5,24
Din Moscow,1379,8,5,7,8,19,24,-5,22
Amkar,1379,9,6,4,10,12,22,-10,22
Rostov,1379,10,4,6,10,10,18,-8,18
Anzhi,1379,11,2,6,12,16,41,-25,12
Loko Moscow,1380,1,11,5,4,30,15,15,38
Zenit,1380,2,9,8,3,24,13,11,35
CSKA Moscow,1380,3,10,4,6,25,18,7,34
Krasnodar,1380,4,10,4,6,31,26,5,34
Spart Moscow,1380,5,9,6,5,36,27,9,33
Terek Grozny,1380,6,7,5,8,23,28,-5,26
Din Moscow,1380,7,6,6,8,19,24,-5,24
Amkar,1380,8,6,4,10,14,24,-10,22
FK Rubin,1380,9,5,5,10,23,21,2,20
Rostov,1380,10,4,7,9,10,17,-7,19
Anzhi,1380,11,3,6,11,17,39,-22,15
Loko Moscow,1381,1,12,6,2,30,11,19,42
Spart Moscow,1381,2,11,5,4,40,27,13,38
CSKA Moscow,1381,3,10,4,6,28,23,5,34
Zenit,1381,4,8,8,4,25,15,10,32
Krasnodar,1381,5,8,5,7,28,26,2,29
Terek Grozny,1381,6,7,6,7,21,24,-3,27
FK Rubin,1381,7,7,5,8,25,19,6,26
Din Moscow,1381,8,5,6,9,20,26,-6,21
Rostov,1381,9,4,6,10,10,18,-8,18
Amkar,1381,10,4,5,11,10,26,-16,17
Anzhi,1381,11,3,6,11,17,39,-22,15
Loko Moscow,1382,1,12,5,3,32,15,17,41
CSKA Moscow,1382,2,11,3,6,26,19,7,36
Zenit,1382,3,8,8,4,24,15,9,32
Spart Moscow,1382,4,9,5,6,35,30,5,32
Krasnodar,1382,5,9,4,7,33,29,4,31
FK Rubin,1382,6,7,5,8,28,21,7,26
Terek Grozny,1382,7,7,5,8,21,25,-4,26
Din Moscow,1382,8,6,6,8,21,24,-3,24
Amkar,1382,9,6,4,10,12,23,-11,22
Rostov,1382,10,4,6,10,11,19,-8,18
Anzhi,1382,11,3,5,12,15,38,-23,14
Loko Moscow,1383,1,12,5,3,31,12,19,41
CSKA Moscow,1383,2,11,4,5,28,17,11,37
Spart Moscow,1383,3,10,6,4,39,26,13,36
Zenit,1383,4,8,9,3,22,13,9,33
Terek Grozny,1383,5,9,5,6,24,24,0,32
Krasnodar,1383,6,8,4,8,27,28,-1,28
Din Moscow,1383,7,6,6,8,20,25,-5,24
FK Rubin,1383,8,6,5,9,23,20,3,23
Rostov,1383,9,4,6,10,11,19,-8,18
Amkar,1383,10,4,5,11,11,25,-14,17
Anzhi,1383,11,2,5,13,14,41,-27,11
Loko Moscow,1384,1,12,5,3,30,12,18,41
CSKA Moscow,1384,2,11,3,6,30,22,8,36
Spart Moscow,1384,3,9,7,4,35,26,9,34
Krasnodar,1384,4,10,4,6,34,25,9,34
Zenit,1384,5,8,8,4,23,14,9,32
Terek Grozny,1384,6,8,6,6,24,25,-1,30
Din Moscow,1384,7,6,7,7,19,22,-3,25
FK Rubin,1384,8,5,5,10,22,24,-2,20
Rostov,1384,9,4,6,10,10,18,-8,18
Amkar,1384,10,4,6,10,11,24,-13,18
Anzhi,1384,11,2,5,13,18,44,-26,11
Loko Moscow,1385,1,12,5,3,32,15,17,41
CSKA Moscow,1385,2,11,4,5,29,18,11,37
Spart Moscow,1385,3,9,5,6,35,28,7,32
Krasnodar,1385,4,9,5,6,30,25,5,32
Zenit,1385,5,7,9,4,23,16,7,30
Terek Grozny,1385,6,7,6,7,23,28,-5,27
FK Rubin,1385,7,5,7,8,21,17,4,22
Din Moscow,1385,8,5,7,8,17,23,-6,22
Amkar,1385,9,6,4,10,14,22,-8,22
Rostov,1385,10,5,6,9,11,17,-6,21
Anzhi,1385,11,2,6,12,17,43,-26,12
Loko Moscow,1386,1,12,6,2,33,13,20,42
CSKA Moscow,1386,2,11,4,5,29,18,11,37
Spart Moscow,1386,3,9,6,5,35,27,8,33
Krasnodar,1386,4,9,5,6,29,25,4,32
Zenit,1386,5,7,8,5,23,20,3,29
Terek Grozny,1386,6,7,5,8,21,26,-5,26
Din Moscow,1386,7,6,6,8,19,23,-4,24
Amkar,1386,8,6,4,10,12,22,-10,22
FK Rubin,1386,9,5,5,10,22,20,2,20
Rostov,1386,10,4,7,9,11,18,-7,19
Anzhi,1386,11,3,6,11,16,38,-22,15
Loko Moscow,1387,1,11,6,3,31,14,17,39
CSKA Moscow,1387,2,11,3,6,29,20,9,36
Zenit,1387,3,8,9,3,25,16,9,33
Spart Moscow,1387,4,9,6,5,38,30,8,33
Krasnodar,1387,5,9,5,6,29,25,4,32
Terek Grozny,1387,6,7,6,7,21,24,-3,27
Din Moscow,1387,7,6,6,8,21,25,-4,24
FK Rubin,1387,8,5,6,9,23,20,3,21
Amkar,1387,9,5,5,10,12,24,-12,20
Rostov,1387,10,4,7,9,11,18,-7,19
Anzhi,1387,11,3,5,12,16,40,-24,14
Loko Moscow,1388,1,12,5,3,31,14,17,41
CSKA Moscow,1388,2,12,3,5,35,19,16,39
Spart Moscow,1388,3,10,6,4,38,26,12,36
Terek Grozny,1388,4,9,5,6,26,24,2,32
Krasnodar,1388,5,9,4,7,30,26,4,31
Zenit,1388,6,7,8,5,23,17,6,29
Din Moscow,1388,7,6,6,8,20,24,-4,24
FK Rubin,1388,8,6,5,9,24,21,3,23
Rostov,1388,9,4,7,9,10,17,-7,19
Amkar,1388,10,4,4,12,11,28,-17,16
Anzhi,1388,11,2,5,13,16,48,-32,11
Loko Moscow,1389,1,13,5,2,33,11,22,44
CSKA Moscow,1389,2,11,3,6,27,20,7,36
Zenit,1389,3,8,8,4,24,16,8,32
Krasnodar,1389,4,9,4,7,29,26,3,31
Spart Moscow,1389,5,8,6,6,35,29,6,30
Terek Grozny,1389,6,8,5,7,23,23,0,29
Din Moscow,1389,7,6,7,7,19,22,-3,25
Amkar,1389,8,6,4,10,12,23,-11,22
Rostov,1389,9,5,6,9,11,17,-6,21
FK Rubin,1389,10,5,5,10,21,20,1,20
Anzhi,1389,11,2,5,13,14,41,-27,11
Loko Moscow,1390,1,11,5,4,30,19,11,38
CSKA Moscow,1390,2,11,4,5,28,19,9,37
Zenit,1390,3,8,9,3,24,15,9,33
Krasnodar,1390,4,9,5,6,33,24,9,32
Spart Moscow,1390,5,8,5,7,36,32,4,29
Din Moscow,1390,6,7,6,7,20,22,-2,27
Terek Grozny,1390,7,7,6,7,23,26,-3,27
Amkar,1390,8,6,4,10,14,24,-10,22
FK Rubin,1390,9,5,6,9,21,18,3,21
Rostov,1390,10,5,6,9,12,18,-6,21
Anzhi,1390,11,2,6,12,17,41,-24,12
Loko Moscow,1391,1,11,6,3,31,14,17,39
CSKA Moscow,1391,2,11,3,6,31,18,13,36
Zenit,1391,3,9,8,3,24,14,10,35
Spart Moscow,1391,4,9,5,6,39,30,9,32
Krasnodar,1391,5,8,6,6,29,26,3,30
Terek Grozny,1391,6,8,6,6,22,22,0,30
Din Moscow,1391,7,7,6,7,20,22,-2,27
FK Rubin,1391,8,5,6,9,22,19,3,21
Amkar,1391,9,5,5,10,11,23,-12,20
Rostov,1391,10,4,6,10,11,21,-10,18
Anzhi,1391,11,2,5,13,14,45,-31,11
Loko Moscow,1392,1,11,5,4,32,16,16,38
CSKA Moscow,1392,2,11,3,6,26,19,7,36
Zenit,1392,3,9,8,3,26,15,11,35
Krasnodar,1392,4,9,5,6,29,25,4,32
Spart Moscow,1392,5,8,7,5,37,30,7,31
Terek Grozny,1392,6,8,5,7,23,25,-2,29
FK Rubin,1392,7,6,6,8,24,18,6,24
Din Moscow,1392,8,5,7,8,20,26,-6,22
Rostov,1392,9,4,7,9,11,18,-7,19
Amkar,1392,10,5,4,11,11,26,-15,19
Anzhi,1392,11,3,5,12,17,38,-21,14
Loko Moscow,1393,1,13,5,2,34,11,23,44
CSKA Moscow,1393,2,11,3,6,29,22,7,36
Spart Moscow,1393,3,10,5,5,36,27,9,35
Zenit,1393,4,8,8,4,25,18,7,32
Krasnodar,1393,5,9,4,7,29,26,3,31
Terek Grozny,1393,6,7,7,6,22,24,-2,28
Din Moscow,1393,7,6,6,8,18,22,-4,24
FK Rubin,1393,8,6,5,9,23,19,4,23
Rostov,1393,9,4,6,10,11,19,-8,18
Amkar,1393,10,4,5,11,10,24,-14,17
Anzhi,1393,11,2,6,12,16,41,-25,12
Loko Moscow,1394,1,11,5,4,30,17,13,38
CSKA Moscow,1394,2,11,4,5,28,19,9,37
Spart Moscow,1394,3,10,6,4,39,26,13,36
Zenit,1394,4,8,9,3,24,14,10,33
Krasnodar,1394,5,9,5,6,32,26,6,32
Terek Grozny,1394,6,7,5,8,20,25,-5,26
FK Rubin,1394,7,5,7,8,23,19,4,22
Din Moscow,1394,8,5,7,8,18,26,-8,22
Rostov,1394,9,4,7,9,11,18,-7,19
Amkar,1394,10,5,4,11,11,23,-12,19
Anzhi,1394,11,3,5,12,16,39,-23,14
Loko Moscow,1395,1,12,5,3,30,12,18,41
CSKA Moscow,1395,2,11,4,5,28,19,9,37
Spart Moscow,1395,3,9,6,5,39,31,8,33
Zenit,1395,4,8,8,4,23,15,8,32
Terek Grozny,1395,5,8,6,6,22,23,-1,30
Krasnodar,1395,6,8,4,8,27,26,1,28
FK Rubin,1395,7,6,6,8,23,18,5,24
Din Moscow,1395,8,5,7,8,20,25,-5,22
Rostov,1395,9,5,6,9,13,19,-6,21
Amkar,1395,10,4,6,10,10,23,-13,18
Anzhi,1395,11,2,6,12,16,40,-24,12
Loko Moscow,1396,1,13,5,2,33,11,22,44
CSKA Moscow,1396,2,11,4,5,31,22,9,37
Spart Moscow,1396,3,8,7,5,35,28,7,31
Krasnodar,1396,4,9,4,7,29,27,2,31
Zenit,1396,5,7,8,5,23,17,6,29
Terek Grozny,1396,6,7,7,6,22,24,-2,28
Din Moscow,1396,7,6,7,7,18,21,-3,25
FK Rubin,1396,8,5,6,9,21,19,2,21
Rostov,1396,9,4,7,9,11,18,-7,19
Amkar,1396,10,4,6,10,11,24,-13,18
Anzhi,1396,11,2,7,11,18,41,-23,13
Loko Moscow,1397,1,11,7,2,30,12,18,40
CSKA Moscow,1397,2,11,3,6,26,19,7,36
Zenit,1397,3,8,9,3,23,13,10,33
Spart Moscow,1397,4,9,6,5,35,28,7,33
Krasnodar,1397,5,8,6,6,30,27,3,30
Terek Grozny,1397,6,7,5,8,21,27,-6,26
FK Rubin,1397,7,5,7,8,24,20,4,22
Din Moscow,1397,8,5,7,8,18,23,-5,22
Rostov,1397,9,5,6,9,12,17,-5,21
Amkar,1397,10,5,5,10,11,23,-12,20
Anzhi,1397,11,3,5,12,18,39,-21,14
Loko Moscow,1398,1,12,5,3,34,14,20,41
CSKA Moscow,1398,2,11,4,5,29,19,10,37
Spart Moscow,1398,3,10,5,5,39,28,11,35
Krasnodar,1398,4,9,4,7,30,27,3,31
Terek Grozny,1398,5,8,6,6,25,26,-1,30
Zenit,1398,6,7,8,5,22,19,3,29
Din Moscow,1398,7,6,6,8,19,23,-4,24
FK Rubin,1398,8,6,5,9,23,19,4,23
Amkar,1398,9,5,5,10,13,24,-11,20
Rostov,1398,10,4,6,10,10,21,-11,18
Anzhi,1398,11,2,6,12,18,42,-24,12
Loko Moscow,1399,1,11,7,2,31,13,18,40
Spart Moscow,1399,2,11,5,4,38,26,12,38
CSKA Moscow,1399,3,10,5,5,28,20,8,35
Zenit,1399,4,7,10,3,23,15,8,31
Terek Grozny,1399,5,8,6,6,23,24,-1,30
Krasnodar,1399,6,8,5,7,28,27,1,29
FK Rubin,1399,7,7,5,8,24,17,7,26
Din Moscow,1399,8,5,6,9,17,23,-6,21
Rostov,1399,9,4,6,10,11,20,-9,18
Amkar,1399,10,4,5,11,10,24,-14,17
Anzhi,1399,11,2,6,12,17,41,-24,12
Loko Moscow,1400,1,11,5,4,29,14,15,38
Spart Moscow,1400,2,10,6,4,42,27,15,36
CSKA Moscow,1400,3,11,3,6,28,20,8,36
Zenit,1400,4,9,8,3,24,13,11,35
Krasnodar,1400,5,9,5,6,30,25,5,32
Terek Grozny,1400,6,8,6,6,24,24,0,30
FK Rubin,1400,7,5,7,8,22,18,4,22
Din Moscow,1400,8,5,7,8,18,27,-9,22
Rostov,1400,9,4,6,10,10,19,-9,18
Amkar,1400,10,4,6,10,11,24,-13,18
Anzhi,1400,11,2,5,13,16,43,-27,11
Loko Moscow,1401,1,12,6,2,31,12,19,42
Spart Moscow,1401,2,10,5,5,38,28,10,35
CSKA Moscow,1401,3,10,4,6,26,20,6,34
Zenit,1401,4,7,10,3,22,14,8,31
Krasnodar,1401,5,8,5,7,29,27,2,29
Terek Grozny,1401,6,7,7,6,24,26,-2,28
FK Rubin,1401,7,6,6,8,25,20,5,24
Din Moscow,1401,8,5,6,9,19,25,-6,21
Amkar,1401,9,5,5,10,14,25,-11,20
Rostov,1401,10,4,6,10,10,20,-10,18
Anzhi,1401,11,3,6,11,18,39,-21,15
Loko Moscow,1402,1,11,7,2,29,11,18,40
Spart Moscow,1402,2,10,6,4,41,27,14,36
Zenit,1402,3,8,9,3,23,13,10,33
CSKA Moscow,1402,4,10,3,7,25,20,5,33
Krasnodar,1402,5,8,6,6,28,25,3,30
Terek Grozny,1402,6,7,6,7,22,26,-4,27
FK Rubin,1402,7,5,7,8,22,18,4,22
Din Moscow,1402,8,5,7,8,17,26,-9,22
Amkar,1402,9,5,5,10,13,24,-11,20
Rostov,1402,10,4,6,10,11,19,-8,18
Anzhi,1402,11,3,6,11,16,38,-22,15
Loko Moscow,1403,1,12,6,2,30,11,19,42
CSKA Moscow,1403,2,12,3,5,27,17,10,39
Spart Moscow,1403,3,9,6,5,39,32,7,33
Zenit,1403,4,7,9,4,21,14,7,30
Krasnodar,1403,5,8,5,7,27,25,2,29
Terek Grozny,1403,6,7,6,7,21,25,-4,27
Din Moscow,1403,7,6,6,8,20,24,-4,24
FK Rubin,1403,8,5,6,9,21,18,3,21
Amkar,1403,9,5,5,10,11,22,-11,20
Rostov,1403,10,4,7,9,13,20,-7,19
Anzhi,1403,11,3,5,12,17,39,-22,14
Loko Moscow,1404,1,12,6,2,32,13,19,42
CSKA Moscow,1404,2,11,3,6,28,21,7,36
Spart Moscow,1404,3,10,5,5,43,29,14,35
Krasnodar,1404,4,9,5,6,30,26,4,32
Zenit,1404,5,7,8,5,23,17,6,29
Terek Grozny,1404,6,7,5,8,21,26,-5,26
Din Moscow,1404,7,6,6,8,19,25,-6,24
Amkar,1404,8,6,4,10,13,24,-11,22
FK Rubin,1404,9,5,5,10,22,21,1,20
Rostov,1404,10,4,6,10,11,21,-10,18
Anzhi,1404,11,4,5,11,20,39,-19,17
Loko Moscow,1405,1,12,6,2,33,12,21,42
CSKA Moscow,1405,2,11,3,6,27,21,6,36
Zenit,1405,3,8,8,4,24,16,8,32
Spart Moscow,1405,4,8,6,6,37,31,6,30
Krasnodar,1405,5,8,6,6,29,26,3,30
Din Moscow,1405,6,7,6,7,20,22,-2,27
Terek Grozny,1405,7,7,6,7,20,25,-5,27
FK Rubin,1405,8,5,6,9,23,20,3,21
Amkar,1405,9,5,5,10,12,24,-12,20
Rostov,1405,10,4,7,9,12,19,-7,19
Anzhi,1405,11,3,5,12,18,39,-21,14
Loko Moscow,1406,1,11,6,3,32,15,17,39
CSKA Moscow,1406,2,11,4,5,30,21,9,37
Spart Moscow,1406,3,10,6,4,38,27,11,36
Zenit,1406,4,8,9,3,24,15,9,33
Terek Grozny,1406,5,8,6,6,22,22,0,30
Krasnodar,1406,6,8,5,7,29,29,0,29
Din Moscow,1406,7,6,6,8,22,26,-4,24
FK Rubin,1406,8,6,5,9,27,21,6,23
Rostov,1406,9,4,6,10,10,19,-9,18
Amkar,1406,10,4,6,10,10,23,-13,18
Anzhi,1406,11,2,5,13,17,43,-26,11
Loko Moscow,1407,1,12,6,2,31,12,19,42
Spart Moscow,1407,2,10,5,5,38,29,9,35
CSKA Moscow,1407,3,10,5,5,26,18,8,35
Zenit,1407,4,7,9,4,22,15,7,30
Krasnodar,1407,5,8,5,7,27,25,2,29
Terek Grozny,1407,6,8,5,7,21,23,-2,29
Din Moscow,1407,7,6,6,8,18,22,-4,24
FK Rubin,1407,8,6,5,9,22,18,4,23
Rostov,1407,9,5,6,9,13,19,-6,21
Amkar,1407,10,5,4,11,11,24,-13,19
Anzhi,1407,11,2,6,12,15,39,-24,12
Loko Moscow,1408,1,12,6,2,32,13,19,42
Spart Moscow,1408,2,10,6,4,38,28,10,36
CSKA Moscow,1408,3,10,5,5,30,22,8,35
Zenit,1408,4,7,10,3,23,15,8,31
Krasnodar,1408,5,8,5,7,29,27,2,29
Terek Grozny,1408,6,8,5,7,22,24,-2,29
FK Rubin,1408,7,5,7,8,22,18,4,22
Din Moscow,1408,8,5,7,8,18,23,-5,22
Rostov,1408,9,4,7,9,11,18,-7,19
Amkar,1408,10,4,4,12,11,26,-15,16
Anzhi,1408,11,3,6,11,19,41,-22,15
Loko Moscow,1409,1,11,6,3,30,16,14,39
CSKA Moscow,1409,2,11,4,5,27,17,10,37
Krasnodar,1409,3,10,4,6,35,27,8,34
Spart Moscow,1409,4,9,5,6,37,32,5,32
Zenit,1409,5,7,9,4,21,15,6,30
Terek Grozny,1409,6,8,5,7,22,24,-2,29
Din Moscow,1409,7,5,7,8,18,23,-5,22
Amkar,1409,8,6,4,10,14,23,-9,22
FK Rubin,1409,9,5,6,9,23,20,3,21
Rostov,1409,10,5,6,9,13,19,-6,21
Anzhi,1409,11,2,6,12,14,38,-24,12
Loko Moscow,1410,1,12,6,2,33,13,20,42
CSKA Moscow,1410,2,11,4,5,27,18,9,37
Spart Moscow,1410,3,8,8,4,37,29,8,32
Zenit,1410,4,7,10,3,23,15,8,31
Krasnodar,1410,5,9,4,7,28,26,2,31
Terek Grozny,1410,6,7,6,7,21,25,-4,27
Din Moscow,1410,7,5,8,7,20,24,-4,23
FK Rubin,1410,8,5,6,9,23,20,3,21
Rostov,1410,9,4,7,9,11,18,-7,19
Amkar,1410,10,4,6,10,11,24,-13,18
Anzhi,1410,11,3,5,12,18,40,-22,14
Loko Moscow,1411,1,12,5,3,34,15,19,41
CSKA Moscow,1411,2,11,3,6,28,19,9,36
Krasnodar,1411,3,10,4,6,32,25,7,34
Spart Moscow,1411,4,9,6,5,35,27,8,33
Zenit,1411,5,8,8,4,23,17,6,32
Terek Grozny,1411,6,8,6,6,23,24,-1,30
Din Moscow,1411,7,7,6,7,20,22,-2,27
FK Rubin,1411,8,5,5,10,21,20,1,20
Rostov,1411,9,4,6,10,10,18,-8,18
Amkar,1411,10,4,5,11,9,23,-14,17
Anzhi,1411,11,2,6,12,17,42,-25,12
Loko Moscow,1412,1,12,5,3,34,16,18,41
Spart Moscow,1412,2,10,5,5,37,28,9,35
Krasnodar,1412,3,10,4,6,33,27,6,34
CSKA Moscow,1412,4,10,4,6,27,21,6,34
Zenit,1412,5,8,8,4,24,15,9,32
Terek Grozny,1412,6,7,6,7,21,24,-3,27
FK Rubin,1412,7,6,5,9,22,19,3,23
Amkar,1412,8,6,4,10,12,23,-11,22
Din Moscow,1412,9,5,6,9,18,24,-6,21
Rostov,1412,10,4,6,10,10,18,-8,18
Anzhi,1412,11,2,7,11,17,40,-23,13
Loko Moscow,1413,1,12,6,2,31,12,19,42
CSKA Moscow,1413,2,11,3,6,27,19,8,36
Spart Moscow,1413,3,9,7,4,39,30,9,34
Zenit,1413,4,8,9,3,23,14,9,33
Krasnodar,1413,5,9,4,7,28,25,3,31
Terek Grozny,1413,6,7,6,7,21,25,-4,27
Din Moscow,1413,7,5,8,7,19,23,-4,23
FK Rubin,1413,8,5,6,9,22,19,3,21
Rostov,1413,9,4,6,10,11,19,-8,18
Amkar,1413,10,4,6,10,12,25,-13,18
Anzhi,1413,11,3,5,12,18,40,-22,14
Loko Moscow,1414,1,11,5,4,29,14,15,38
CSKA Moscow,1414,2,11,4,5,28,19,9,37
Krasnodar,1414,3,10,4,6,30,24,6,34
Zenit,1414,4,8,8,4,25,16,9,32
Spart Moscow,1414,5,9,5,6,36,29,7,32
Terek Grozny,1414,6,7,6,7,20,23,-3,27
Din Moscow,1414,7,6,6,8,19,24,-5,24
FK Rubin,1414,8,6,5,9,24,19,5,23
Amkar,1414,9,5,5,10,11,23,-12,20
Rostov,1414,10,4,6,10,10,19,-9,18
Anzhi,1414,11,3,6,11,15,37,-22,15
Loko Moscow,1415,1,12,6,2,30,11,19,42
Spart Moscow,1415,2,10,5,5,39,30,9,35
CSKA Moscow,1415,3,10,4,6,26,21,5,34
Zenit,1415,4,8,8,4,24,14,10,32
Terek Grozny,1415,5,8,6,6,22,23,-1,30
Krasnodar,1415,6,8,5,7,27,26,1,29
FK Rubin,1415,7,7,5,8,24,17,7,26
Din Moscow,1415,8,5,6,9,20,26,-6,21
Amkar,1415,9,5,4,11,11,24,-13,19
Rostov,1415,10,4,6,10,10,18,-8,18
Anzhi,1415,11,2,7,11,16,39,-23,13
Loko Moscow,1416,1,11,5,4,30,16,14,38
Spart Moscow,1416,2,10,6,4,39,27,12,36
CSKA Moscow,1416,3,11,3,6,27,19,8,36
Zenit,1416,4,9,8,3,25,15,10,35
Krasnodar,1416,5,9,5,6,32,26,6,32
Terek Grozny,1416,6,8,5,7,21,24,-3,29
FK Rubin,1416,7,5,7,8,24,20,4,22
Din Moscow,1416,8,5,7,8,18,25,-7,22
Rostov,1416,9,4,7,9,10,17,-7,19
Amkar,1416,10,5,4,11,13,25,-12,19
Anzhi,1416,11,2,5,13,14,39,-25,11
Loko Moscow,1417,1,12,6,2,30,11,19,42
CSKA Moscow,1417,2,11,3,6,27,19,8,36
Spart Moscow,1417,3,10,5,5,42,29,13,35
Zenit,1417,4,8,9,3,22,13,9,33
Krasnodar,1417,5,9,4,7,29,25,4,31
Terek Grozny,1417,6,7,7,6,22,24,-2,28
Din Moscow,1417,7,6,6,8,20,26,-6,24
FK Rubin,1417,8,5,5,10,23,22,1,20
Amkar,1417,9,5,5,10,13,25,-12,20
Rostov,1417,10,4,6,10,11,21,-10,18
Anzhi,1417,11,2,6,12,16,40,-24,12
Loko Moscow,1418,1,13,5,2,33,12,21,44
Spart Moscow,1418,2,11,5,4,39,28,11,38
CSKA Moscow,1418,3,10,4,6,27,22,5,34
Zenit,1418,4,8,8,4,24,15,9,32
Krasnodar,1418,5,8,5,7,28,26,2,29
Terek Grozny,1418,6,7,5,8,20,27,-7,26
FK Rubin,1418,7,6,6,8,22,17,5,24
Din Moscow,1418,8,5,6,9,19,25,-6,21
Amkar,1418,9,5,4,11,13,23,-10,19
Rostov,1418,10,4,6,10,11,19,-8,18
Anzhi,1418,11,3,6,11,17,39,-22,15
Loko Moscow,1419,1,11,6,3,31,14,17,39
CSKA Moscow,1419,2,11,3,6,29,21,8,36
Krasnodar,1419,3,10,4,6,32,24,8,34
Zenit,1419,4,8,9,3,26,15,11,33
Spart Moscow,1419,5,9,5,6,35,28,7,32
Terek Grozny,1419,6,7,5,8,21,29,-8,26
Din Moscow,1419,7,6,6,8,20,24,-4,24
FK Rubin,1419,8,6,5,9,23,22,1,23
Rostov,1419,9,5,6,9,11,17,-6,21
Amkar,1419,10,5,4,11,11,23,-12,19
Anzhi,1419,11,3,5,12,20,42,-22,14
Loko Moscow,1420,1,13,5,2,34,12,22,44
CSKA Moscow,1420,2,11,4,5,30,19,11,37
Spart Moscow,1420,3,9,5,6,35,31,4,32
Krasnodar,1420,4,9,4,7,30,26,4,31
Zenit,1420,5,7,9,4,22,17,5,30
Terek Grozny,1420,6,7,6,7,22,25,-3,27
FK Rubin,1420,7,6,5,9,23,19,4,23
Amkar,1420,8,6,4,10,12,23,-11,22
Rostov,1420,9,5,6,9,14,17,-3,21
Din Moscow,1420,10,5,6,9,18,25,-7,21
Anzhi,1420,11,2,6,12,16,42,-26,12
Loko Moscow,1421,1,11,6,3,32,15,17,39
CSKA Moscow,1421,2,12,3,5,31,18,13,39
Spart Moscow,1421,3,10,5,5,39,28,11,35
Krasnodar,1421,4,10,4,6,32,26,6,34
Zenit,1421,5,7,9,4,24,18,6,30
Terek Grozny,1421,6,7,5,8,20,25,-5,26
Din Moscow,1421,7,6,6,8,22,26,-4,24
Amkar,1421,8,6,4,10,12,22,-10,22
FK Rubin,1421,9,5,5,10,25,24,1,20
Rostov,1421,10,4,6,10,10,21,-11,18
Anzhi,1421,11,3,5,12,16,40,-24,14
Loko Moscow,1422,1,13,5,2,33,13,20,44
CSKA Moscow,1422,2,11,3,6,26,18,8,36
Spart Moscow,1422,3,9,6,5,38,26,12,33
Zenit,1422,4,8,8,4,22,14,8,32
Krasnodar,1422,5,8,4,8,29,28,1,28
Terek Grozny,1422,6,7,6,7,21,24,-3,27
FK Rubin,1422,7,7,5,8,23,17,6,26
Din Moscow,1422,8,5,7,8,17,22,-5,22
Amkar,1422,9,5,5,10,11,23,-12,20
Rostov,1422,10,4,6,10,10,22,-12,18
Anzhi,1422,11,3,5,12,15,38,-23,14
Loko Moscow,1423,1,13,5,2,33,12,21,44
CSKA Moscow,1423,2,11,4,5,30,20,10,37
Spart Moscow,1423,3,10,5,5,37,27,10,35
Terek Grozny,1423,4,8,6,6,24,23,1,30
Zenit,1423,5,7,8,5,24,19,5,29
Krasnodar,1423,6,8,4,8,28,29,-1,28
FK Rubin,1423,7,6,6,8,25,19,6,24
Din Moscow,1423,8,5,7,8,18,24,-6,22
Amkar,1423,9,5,5,10,10,22,-12,20
Rostov,1423,10,4,6,10,11,19,-8,18
Anzhi,1423,11,2,6,12,16,42,-26,12
Loko Moscow,1424,1,12,5,3,31,14,17,41
CSKA Moscow,1424,2,11,3,6,27,21,6,36
Spart Moscow,1424,3,9,6,5,38,30,8,33
Zenit,1424,4,8,8,4,26,15,11,32
Krasnodar,1424,5,9,4,7,29,27,2,31
Terek Grozny,1424,6,7,6,7,22,25,-3,27
Din Moscow,1424,7,6,7,7,19,22,-3,25
FK Rubin,1424,8,6,6,8,25,18,7,24
Amkar,1424,9,5,5,10,14,26,-12,20
Rostov,1424,10,4,6,10,11,19,-8,18
Anzhi,1424,11,2,6,12,15,40,-25,12
Loko Moscow,1425,1,12,5,3,31,14,17,41
Spart Moscow,1425,2,10,6,4,37,27,10,36
CSKA Moscow,1425,3,11,3,6,27,19,8,36
Zenit,1425,4,8,8,4,24,15,9,32
Krasnodar,1425,5,9,5,6,29,24,5,32
Terek Grozny,1425,6,7,5,8,20,24,-4,26
FK Rubin,1425,7,5,7,8,22,18,4,22
Din Moscow,1425,8,5,7,8,18,23,-5,22
Amkar,1425,9,5,5,10,12,24,-12,20
Rostov,1425,10,4,6,10,10,18,-8,18
Anzhi,1425,11,3,5,12,15,39,-24,14
Loko Moscow,1426,1,12,6,2,33,14,19,42
CSKA Moscow,1426,2,11,4,5,30,18,12,37
Spart Moscow,1426,3,10,5,5,41,27,14,35
Zenit,1426,4,7,9,4,24,17,7,30
Krasnodar,1426,5,8,6,6,29,26,3,30
Terek Grozny,1426,6,8,5,7,25,25,0,29
Din Moscow,1426,7,6,6,8,18,25,-7,24
Amkar,1426,8,6,4,10,13,23,-10,22
FK Rubin,1426,9,5,6,9,22,19,3,21
Rostov,1426,10,4,6,10,11,21,-10,18
Anzhi,1426,11,2,5,13,14,45,-31,11
Loko Moscow,1427,1,12,6,2,31,12,19,42
CSKA Moscow,1427,2,11,3,6,30,21,9,36
Spart Moscow,1427,3,10,5,5,38,27,11,35
Zenit,1427,4,8,9,3,24,15,9,33
Krasnodar,1427,5,9,4,7,29,26,3,31
Terek Grozny,1427,6,7,6,7,22,26,-4,27
Din Moscow,1427,7,5,7,8,17,22,-5,22
FK Rubin,1427,8,5,6,9,21,18,3,21
Amkar,1427,9,5,5,10,13,25,-12,20
Rostov,1427,10,4,6,10,10,20,-10,18
Anzhi,1427,11,3,5,12,17,40,-23,14
Loko Moscow,1428,1,12,6,2,34,15,19,42
CSKA Moscow,1428,2,10,4,6,27,20,7,34
Spart Moscow,1428,3,9,6,5,37,29,8,33
Zenit,1428,4,8,8,4,24,16,8,32
Krasnodar,1428,5,9,5,6,31,27,4,32
Terek Grozny,1428,6,7,5,8,21,26,-5,26
Din Moscow,1428,7,5,8,7,18,22,-4,23
Amkar,1428,8,6,4,10,14,24,-10,22
FK Rubin,1428,9,5,6,9,22,19,3,21
Rostov,1428,10,4,6,10,11,19,-8,18
Anzhi,1428,11,3,6,11,17,39,-22,15
Loko Moscow,1429,1,12,6,2,33,12,21,42
Spart Moscow,1429,2,11,5,4,41,29,12,38
CSKA Moscow,1429,3,10,3,7,26,23,3,33
Zenit,1429,4,8,8,4,26,17,9,32
Krasnodar,1429,5,8,6,6,28,25,3,30
Terek Grozny,1429,6,8,6,6,24,23,1,30
FK Rubin,1429,7,5,7,8,21,17,4,22
Din Moscow,1429,8,5,7,8,19,24,-5,22
Rostov,1429,9,4,6,10,10,19,-9,18
Amkar,1429,10,4,4,12,12,29,-17,16
Anzhi,1429,11,3,6,11,15,37,-22,15
Loko Moscow,1430,1,11,5,4,30,14,16,38
CSKA Moscow,1430,2,11,4,5,29,18,11,37
Spart Moscow,1430,3,10,6,4,39,27,12,36
Zenit,1430,4,8,8,4,23,17,6,32
Krasnodar,1430,5,9,4,7,30,28,2,31
Terek Grozny,1430,6,7,6,7,22,25,-3,27
Din Moscow,1430,7,6,6,8,19,23,-4,24
FK Rubin,1430,8,6,5,9,25,20,5,23
Rostov,1430,9,4,7,9,11,18,-7,19
Amkar,1430,10,4,5,11,10,26,-16,17
Anzhi,1430,11,3,6,11,17,39,-22,15
Loko Moscow,1431,1,13,5,2,32,11,21,44
CSKA Moscow,1431,2,10,5,5,27,19,8,35
Zenit,1431,3,7,9,4,23,17,6,30
Spart Moscow,1431,4,8,6,6,36,31,5,30
Krasnodar,1431,5,8,5,7,30,28,2,29
Terek Grozny,1431,6,7,6,7,21,25,-4,27
Din Moscow,1431,7,5,8,7,19,23,-4,23
FK Rubin,1431,8,5,7,8,24,20,4,22
Rostov,1431,9,5,6,9,11,17,-6,21
Amkar,1431,10,5,5,10,13,24,-11,20
Anzhi,1431,11,3,6,11,16,37,-21,15
Loko Moscow,1432,1,11,6,3,31,14,17,39
CSKA Moscow,1432,2,10,4,6,25,18,7,34
Krasnodar,1432,3,10,4,6,31,26,5,34
Zenit,1432,4,8,9,3,23,14,9,33
Spart Moscow,1432,5,9,6,5,37,29,8,33
Terek Grozny,1432,6,8,6,6,21,22,-1,30
Din Moscow,1432,7,6,7,7,20,23,-3,25
Rostov,1432,8,5,6,9,12,18,-6,21
FK Rubin,1432,9,5,5,10,23,21,2,20
Amkar,1432,10,4,4,12,10,25,-15,16
Anzhi,1432,11,2,7,11,14,37,-23,13
Loko Moscow,1433,1,11,6,3,30,13,17,39
Spart Moscow,1433,2,9,7,4,35,25,10,34
CSKA Moscow,1433,3,10,4,6,27,20,7,34
Terek Grozny,1433,4,9,5,6,26,23,3,32
Zenit,1433,5,7,10,3,24,16,8,31
Krasnodar,1433,6,9,4,7,28,26,2,31
FK Rubin,1433,7,7,5,8,24,17,7,26
Din Moscow,1433,8,5,7,8,17,22,-5,22
Rostov,1433,9,4,6,10,10,19,-9,18
Amkar,1433,10,4,5,11,10,26,-16,17
Anzhi,1433,11,3,5,12,15,39,-24,14
Loko Moscow,1434,1,11,5,4,29,14,15,38
CSKA Moscow,1434,2,11,3,6,27,19,8,36
Spart Moscow,1434,3,10,5,5,40,29,11,35
Zenit,1434,4,9,8,3,24,13,11,35
Krasnodar,1434,5,9,4,7,30,26,4,31
Terek Grozny,1434,6,8,5,7,25,27,-2,29
FK Rubin,1434,7,7,5,8,25,19,6,26
Din Moscow,1434,8,5,6,9,19,27,-8,21
Amkar,1434,9,5,4,11,14,28,-14,19
Rostov,1434,10,4,6,10,11,19,-8,18
Anzhi,1434,11,3,5,12,16,39,-23,14
Loko Moscow,1435,1,12,6,2,31,12,19,42
Spart Moscow,1435,2,10,6,4,40,28,12,36
CSKA Moscow,1435,3,10,4,6,26,20,6,34
Zenit,1435,4,8,9,3,23,13,10,33
Krasnodar,1435,5,9,4,7,29,26,3,31
Terek Grozny,1435,6,7,5,8,21,26,-5,26
Din Moscow,1435,7,6,6,8,19,24,-5,24
FK Rubin,1435,8,5,5,10,21,19,2,20
Amkar,1435,9,5,5,10,13,24,-11,20
Rostov,1435,10,4,6,10,11,20,-9,18
Anzhi,1435,11,3,6,11,16,38,-22,15
Loko Moscow,1436,1,13,5,2,32,12,20,44
Spart Moscow,1436,2,10,6,4,37,26,11,36
CSKA Moscow,1436,3,11,3,6,29,21,8,36
Zenit,1436,4,8,8,4,23,15,8,32
Terek Grozny,1436,5,8,5,7,24,25,-1,29
Krasnodar,1436,6,8,4,8,27,26,1,28
FK Rubin,1436,7,7,5,8,24,17,7,26
Din Moscow,1436,8,5,7,8,17,23,-6,22
Rostov,1436,9,4,6,10,11,19,-8,18
Amkar,1436,10,4,4,12,10,27,-17,16
Anzhi,1436,11,3,5,12,19,42,-23,14
Loko Moscow,1437,1,12,6,2,33,13,20,42
CSKA Moscow,1437,2,12,3,5,35,19,16,39
Spart Moscow,1437,3,9,6,5,35,27,8,33
Krasnodar,1437,4,9,5,6,29,25,4,32
Zenit,1437,5,7,8,5,23,19,4,29
Terek Grozny,1437,6,7,6,7,20,23,-3,27
Din Moscow,1437,7,6,6,8,18,22,-4,24
FK Rubin,1437,8,6,5,9,22,18,4,23
Rostov,1437,9,4,7,9,11,18,-7,19
Amkar,1437,10,4,5,11,9,23,-14,17
Anzhi,1437,11,3,5,12,16,44,-28,14
Loko Moscow,1438,1,13,5,2,34,12,22,44
Spart Moscow,1438,2,11,5,4,39,27,12,38
CSKA Moscow,1438,3,11,3,6,29,21,8,36
Zenit,1438,4,8,8,4,24,17,7,32
Krasnodar,1438,5,9,4,7,29,25,4,31
Terek Grozny,1438,6,7,7,6,23,25,-2,28
Din Moscow,1438,7,6,6,8,18,22,-4,24
FK Rubin,1438,8,5,5,10,21,20,1,20
Rostov,1438,9,4,6,10,11,19,-8,18
Amkar,1438,10,4,5,11,11,26,-15,17
Anzhi,1438,11,2,6,12,18,43,-25,12
Loko Moscow,1439,1,11,6,3,29,12,17,39
CSKA Moscow,1439,2,11,3,6,28,19,9,36
Spart Moscow,1439,3,10,5,5,40,28,12,35
Krasnodar,1439,4,10,4,6,29,24,5,34
Zenit,1439,5,8,9,3,23,14,9,33
Terek Grozny,1439,6,8,5,7,21,24,-3,29
Din Moscow,1439,7,7,6,7,21,23,-2,27
FK Rubin,1439,8,5,5,10,22,20,2,20
Amkar,1439,9,5,4,11,12,26,-14,19
Rostov,1439,10,4,6,10,10,19,-9,18
Anzhi,1439,11,2,5,13,14,40,-26,11
Loko Moscow,1440,1,11,6,3,31,14,17,39
CSKA Moscow,1440,2,11,4,5,29,18,11,37
Spart Moscow,1440,3,9,7,4,36,27,9,34
Zenit,1440,4,7,10,3,22,14,8,31
Krasnodar,1440,5,9,4,7,31,28,3,31
Terek Grozny,1440,6,7,6,7,21,24,-3,27
Din Moscow,1440,7,6,7,7,20,22,-2,25
FK Rubin,1440,8,6,5,9,24,21,3,23
Rostov,1440,9,4,7,9,11,18,-7,19
Amkar,1440,10,5,4,11,11,24,-13,19
Anzhi,1440,11,2,6,12,15,41,-26,12
Loko Moscow,1441,1,12,5,3,35,15,20,41
CSKA Moscow,1441,2,11,3,6,28,21,7,36
Zenit,1441,3,8,8,4,25,18,7,32
Spart Moscow,1441,4,9,5,6,36,31,5,32
Krasnodar,1441,5,9,4,7,31,27,4,31
Terek Grozny,1441,6,7,7,6,20,22,-2,28
Din Moscow,1441,7,6,7,7,20,22,-2,25
FK Rubin,1441,8,6,6,8,24,19,5,24
Amkar,1441,9,5,5,10,13,23,-10,20
Rostov,1441,10,4,6,10,10,19,-9,18
Anzhi,1441,11,2,6,12,15,40,-25,12
Loko Moscow,1442,1,11,5,4,29,15,14,38
Zenit,1442,2,9,8,3,24,13,11,35
Spart Moscow,1442,3,10,5,5,37,27,10,35
CSKA Moscow,1442,4,10,3,7,25,20,5,33
Krasnodar,1442,5,9,4,7,29,26,3,31
Terek Grozny,1442,6,8,6,6,21,22,-1,30
FK Rubin,1442,7,6,6,8,25,19,6,24
Din Moscow,1442,8,5,7,8,19,26,-7,22
Amkar,1442,9,5,4,11,11,23,-12,19
Rostov,1442,10,4,6,10,10,18,-8,18
Anzhi,1442,11,3,6,11,16,37,-21,15
Loko Moscow,1443,1,11,6,3,30,13,17,39
Zenit,1443,2,9,8,3,24,13,11,35
CSKA Moscow,1443,3,10,3,7,25,20,5,33
Spart Moscow,1443,4,9,5,6,35,28,7,32
Krasnodar,1443,5,8,6,6,29,26,3,30
Terek Grozny,1443,6,8,5,7,25,26,-1,29
Din Moscow,1443,7,6,6,8,18,22,-4,24
Amkar,1443,8,6,4,10,14,24,-10,22
FK Rubin,1443,9,5,6,9,22,19,3,21
Rostov,1443,10,5,6,9,12,18,-6,21
Anzhi,1443,11,3,5,12,15,40,-25,14
Loko Moscow,1444,1,11,7,2,30,12,18,40
CSKA Moscow,1444,2,11,3,6,27,21,6,36
Zenit,1444,3,8,9,3,25,14,11,33
Spart Moscow,1444,4,8,6,6,38,33,5,30
Krasnodar,1444,5,8,6,6,28,25,3,30
Terek Grozny,1444,6,8,6,6,22,22,0,30
Din Moscow,1444,7,6,7,7,21,24,-3,25
FK Rubin,1444,8,5,7,8,23,19,4,22
Amkar,1444,9,5,5,10,11,22,-11,20
Rostov,1444,10,4,7,9,13,20,-7,19
Anzhi,1444,11,2,5,13,15,41,-26,11
Loko Moscow,1445,1,12,6,2,30,11,19,42
CSKA Moscow,1445,2,11,4,5,26,17,9,37
Spart Moscow,1445,3,8,6,6,34,28,6,30
Terek Grozny,1445,4,8,6,6,23,24,-1,30
Zenit,1445,5,7,8,5,21,15,6,29
Krasnodar,1445,6,8,5,7,27,25,2,29
Din Moscow,1445,7,6,7,7,18,21,-3,25
FK Rubin,1445,8,6,6,8,22,17,5,24
Rostov,1445,9,5,6,9,11,17,-6,21
Amkar,1445,10,4,6,10,12,25,-13,18
Anzhi,1445,11,2,6,12,14,38,-24,12
Loko Moscow,1446,1,11,6,3,31,15,16,39
Spart Moscow,1446,2,10,6,4,38,27,11,36
Krasnodar,1446,3,10,4,6,33,27,6,34
Zenit,1446,4,8,9,3,23,14,9,33
CSKA Moscow,1446,5,10,3,7,26,20,6,33
Terek Grozny,1446,6,8,5,7,22,24,-2,29
Din Moscow,1446,7,6,6,8,19,23,-4,24
FK Rubin,1446,8,5,5,10,23,22,1,20
Amkar,1446,9,5,5,10,12,24,-12,20
Rostov,1446,10,4,6,10,10,18,-8,18
Anzhi,1446,11,3,5,12,17,40,-23,14
Loko Moscow,1447,1,11,6,3,30,13,17,39
CSKA Moscow,1447,2,11,3,6,26,19,7,36
Zenit,1447,3,9,8,3,24,13,11,35
Spart Moscow,1447,4,9,6,5,38,29,9,33
Krasnodar,1447,5,9,5,6,31,25,6,32
Terek Grozny,1447,6,8,6,6,22,23,-1,30
Din Moscow,1447,7,6,6,8,21,24,-3,24
FK Rubin,1447,8,6,5,9,23,21,2,23
Rostov,1447,9,4,6,10,10,20,-10,18
Amkar,1447,10,4,6,10,10,23,-13,18
Anzhi,1447,11,2,5,13,15,40,-25,11
Loko Moscow,1448,1,12,5,3,32,13,19,41
CSKA Moscow,1448,2,11,3,6,28,19,9,36
Spart Moscow,1448,3,9,6,5,36,28,8,33
Zenit,1448,4,8,8,4,22,15,7,32
Krasnodar,1448,5,9,5,6,29,25,4,32
Terek Grozny,1448,6,8,6,6,24,24,0,30
Din Moscow,1448,7,6,7,7,22,23,-1,25
FK Rubin,1448,8,5,6,9,21,20,1,21
Rostov,1448,9,5,6,9,11,17,-6,21
Amkar,1448,10,4,4,12,10,26,-16,16
Anzhi,1448,11,2,6,12,16,41,-25,12
Loko Moscow,1449,1,12,6,2,32,13,19,42
CSKA Moscow,1449,2,11,3,6,30,19,11,36
Zenit,1449,3,8,9,3,24,14,10,33
Spart Moscow,1449,4,8,6,6,34,28,6,30
Krasnodar,1449,5,8,4,8,28,27,1,28
FK Rubin,1449,6,7,5,8,24,17,7,26
Terek Grozny,1449,7,7,5,8,20,27,-7,26
Din Moscow,1449,8,6,6,8,18,23,-5,24
Amkar,1449,9,6,4,10,13,22,-9,22
Rostov,1449,10,4,7,9,11,18,-7,19
Anzhi,1449,11,3,5,12,16,42,-26,14
Loko Moscow,1450,1,11,6,3,29,13,16,39
CSKA Moscow,1450,2,12,3,5,28,18,10,39
Spart Moscow,1450,3,10,6,4,39,25,14,36
Zenit,1450,4,8,8,4,23,14,9,32
Krasnodar,1450,5,8,5,7,27,25,2,29
Terek Grozny,1450,6,8,5,7,22,25,-3,29
Din Moscow,1450,7,6,6,8,18,25,-7,24
FK Rubin,1450,8,6,5,9,22,18,4,23
Rostov,1450,9,4,6,10,10,19,-9,18
Amkar,1450,10,4,5,11,10,24,-14,17
Anzhi,1450,11,3,5,12,17,39,-22,14
Loko Moscow,1451,1,11,6,3,29,14,15,39
CSKA Moscow,1451,2,12,3,5,29,17,12,39
Spart Moscow,1451,3,9,6,5,34,26,8,33
Krasnodar,1451,4,9,4,7,31,26,5,31
Zenit,1451,5,7,9,4,21,15,6,30
Terek Grozny,1451,6,7,7,6,22,24,-2,28
FK Rubin,1451,7,7,5,8,24,18,6,26
Din Moscow,1451,8,6,6,8,18,22,-4,24
Rostov,1451,9,4,7,9,10,17,-7,19
Amkar,1451,10,4,5,11,11,25,-14,17
Anzhi,1451,11,2,6,12,14,39,-25,12
Loko Moscow,1452,1,12,5,3,31,13,18,41
CSKA Moscow,1452,2,12,3,5,28,18,10,39
Spart Moscow,1452,3,9,6,5,38,27,11,33
Zenit,1452,4,8,8,4,22,14,8,32
Terek Grozny,1452,5,8,6,6,23,24,-1,30
Krasnodar,1452,6,8,4,8,28,27,1,28
FK Rubin,1452,7,7,5,8,23,17,6,26
Rostov,1452,8,5,6,9,11,17,-6,21
Din Moscow,1452,9,5,6,9,17,26,-9,21
Amkar,1452,10,4,6,10,11,24,-13,18
Anzhi,1452,11,2,5,13,16,41,-25,11
Loko Moscow,1453,1,11,5,4,29,15,14,38
Spart Moscow,1453,2,10,5,5,44,29,15,35
Zenit,1453,3,9,8,3,25,13,12,35
CSKA Moscow,1453,4,10,3,7,26,22,4,33
Terek Grozny,1453,5,9,5,6,24,24,0,32
Krasnodar,1453,6,9,4,7,28,28,0,31
Din Moscow,1453,7,7,6,7,22,23,-1,27
FK Rubin,1453,8,6,5,9,25,19,6,23
Rostov,1453,9,4,6,10,10,22,-12,18
Amkar,1453,10,4,4,12,11,28,-17,16
Anzhi,1453,11,3,5,12,19,40,-21,14
Loko Moscow,1454,1,11,5,4,30,15,15,38
Spart Moscow,1454,2,11,5,4,41,27,14,38
CSKA Moscow,1454,3,11,4,5,27,18,9,37
Zenit,1454,4,8,8,4,23,15,8,32
Krasnodar,1454,5,9,4,7,30,26,4,31
Terek Grozny,1454,6,7,6,7,21,25,-4,27
Din Moscow,1454,7,6,6,8,20,26,-6,24
FK Rubin,1454,8,6,5,9,24,20,4,23
Rostov,1454,9,4,6,10,10,19,-9,18
Amkar,1454,10,4,5,11,11,25,-14,17
Anzhi,1454,11,3,6,11,17,38,-21,15
Loko Moscow,1455,1,11,7,2,32,14,18,40
CSKA Moscow,1455,2,11,3,6,27,19,8,36
Spart Moscow,1455,3,9,6,5,40,30,10,33
Zenit,1455,4,8,9,3,23,13,10,33
Krasnodar,1455,5,8,6,6,32,29,3,30
Terek Grozny,1455,6,7,5,8,20,25,-5,26
Din Moscow,1455,7,6,7,7,21,24,-3,25
Amkar,1455,8,6,4,10,14,24,-10,22
FK Rubin,1455,9,5,6,9,24,21,3,21
Rostov,1455,10,4,6,10,10,20,-10,18
Anzhi,1455,11,3,5,12,15,39,-24,14
Loko Moscow,1456,1,13,5,2,33,11,22,44
CSKA Moscow,1456,2,11,4,5,28,17,11,37
Spart Moscow,1456,3,10,5,5,40,31,9,35
Zenit,1456,4,7,9,4,21,14,7,30
Terek Grozny,1456,5,8,6,6,22,23,-1,30
Krasnodar,1456,6,8,5,7,28,28,0,29
FK Rubin,1456,7,5,7,8,22,18,4,22
Din Moscow,1456,8,5,7,8,18,23,-5,22
Amkar,1456,9,5,4,11,13,25,-12,19
Rostov,1456,10,4,6,10,12,21,-9,18
Anzhi,1456,11,2,6,12,14,40,-26,12
Loko Moscow,1457,1,12,5,3,31,13,18,41
Spart Moscow,1457,2,10,6,4,37,27,10,36
Krasnodar,1457,3,10,4,6,32,25,7,34
CSKA Moscow,1457,4,10,4,6,26,20,6,34
Zenit,1457,5,8,8,4,23,15,8,32
Terek Grozny,1457,6,8,5,7,21,23,-2,29
Din Moscow,1457,7,5,7,8,20,25,-5,22
FK Rubin,1457,8,5,6,9,24,22,2,21
Rostov,1457,9,4,7,9,10,17,-7,19
Amkar,1457,10,4,4,12,10,25,-15,16
Anzhi,1457,11,3,6,11,16,38,-22,15
Loko Moscow,1458,1,12,5,3,31,13,18,41
CSKA Moscow,1458,2,12,3,5,27,17,10,39
Krasnodar,1458,3,10,4,6,31,25,6,34
Spart Moscow,1458,4,9,6,5,36,27,9,33
Zenit,1458,5,7,8,5,21,15,6,29
Terek Grozny,1458,6,7,5,8,20,24,-4,26
Din Moscow,1458,7,6,7,7,21,24,-3,25
FK Rubin,1458,8,5,6,9,23,21,2,21
Rostov,1458,9,4,7,9,10,17,-7,19
Amkar,1458,10,5,4,11,10,24,-14,19
Anzhi,1458,11,3,5,12,15,38,-23,14
Loko Moscow,1459,1,11,6,3,29,13,16,39
CSKA Moscow,1459,2,10,4,6,27,20,7,34
Krasnodar,1459,3,10,4,6,31,25,6,34
Zenit,1459,4,8,9,3,23,14,9,33
Spart Moscow,1459,5,8,7,5,35,28,7,31
Terek Grozny,1459,6,8,5,7,23,24,-1,29
Din Moscow,1459,7,6,7,7,21,23,-2,25
FK Rubin,1459,8,5,5,10,22,21,1,20
Rostov,1459,9,4,7,9,10,17,-7,19
Amkar,1459,10,5,4,11,10,24,-14,19
Anzhi,1459,11,3,6,11,17,39,-22,15
Loko Moscow,1460,1,11,6,3,33,16,17,39
Zenit,1460,2,9,8,3,25,15,10,35
Spart Moscow,1460,3,9,6,5,37,29,8,33
CSKA Moscow,1460,4,10,3,7,27,21,6,33
Krasnodar,1460,5,8,6,6,32,29,3,30
Terek Grozny,1460,6,7,5,8,21,26,-5,26
Din Moscow,1460,7,6,7,7,20,23,-3,25
Amkar,1460,8,6,4,10,13,24,-11,22
FK Rubin,1460,9,5,6,9,23,20,3,21
Rostov,1460,10,4,6,10,10,18,-8,18
Anzhi,1460,11,4,5,11,18,38,-20,17
Loko Moscow,1461,1,12,6,2,32,12,20,42
CSKA Moscow,1461,2,11,4,5,27,18,9,37
Spart Moscow,1461,3,9,7,4,39,30,9,34
Krasnodar,1461,4,9,5,6,31,26,5,32
Zenit,1461,5,7,9,4,22,16,6,30
Terek Grozny,1461,6,8,6,6,25,24,1,30
FK Rubin,1461,7,6,5,9,23,20,3,23
Din Moscow,1461,8,5,6,9,19,25,-6,21
Rostov,1461,9,4,7,9,11,18,-7,19
Amkar,1461,10,4,6,10,11,24,-13,18
Anzhi,1461,11,2,5,13,16,43,-27,11
Loko Moscow,1462,1,12,5,3,30,14,16,41
CSKA Moscow,1462,2,10,5,5,28,20,8,35
Zenit,1462,3,8,9,3,26,15,11,33
Spart Moscow,1462,4,9,6,5,38,30,8,33
Krasnodar,1462,5,9,4,7,28,25,3,31
Terek Grozny,1462,6,8,5,7,21,25,-4,29
Din Moscow,1462,7,6,7,7,19,22,-3,25
FK Rubin,1462,8,5,5,10,21,19,2,20
Amkar,1462,9,5,4,11,12,25,-13,19
Rostov,1462,10,4,6,10,11,19,-8,18
Anzhi,1462,11,3,6,11,18,38,-20,15
Loko Moscow,1463,1,11,6,3,29,13,16,39
CSKA Moscow,1463,2,11,4,5,28,17,11,37
Spart Moscow,1463,3,10,6,4,40,27,13,36
Zenit,1463,4,7,10,3,21,13,8,31
Krasnodar,1463,5,9,4,7,29,27,2,31
Terek Grozny,1463,6,8,5,7,21,23,-2,29
FK Rubin,1463,7,6,6,8,24,17,7,24
Din Moscow,1463,8,5,7,8,18,24,-6,22
Rostov,1463,9,4,6,10,11,21,-10,18
Amkar,1463,10,4,5,11,9,23,-14,17
Anzhi,1463,11,3,5,12,15,40,-25,14
Loko Moscow,1464,1,12,6,2,34,13,21,42
CSKA Moscow,1464,2,11,3,6,31,22,9,36
Spart Moscow,1464,3,10,5,5,39,27,12,35
Zenit,1464,4,8,8,4,26,17,9,32
Krasnodar,1464,5,8,6,6,30,27,3,30
Terek Grozny,1464,6,8,6,6,22,23,-1,30
FK Rubin,1464,7,5,7,8,24,20,4,22
Din Moscow,1464,8,5,7,8,20,25,-5,22
Amkar,1464,9,5,5,10,10,22,-12,20
Rostov,1464,10,4,6,10,10,21,-11,18
Anzhi,1464,11,2,5,13,15,44,-29,11
Loko Moscow,1465,1,12,5,3,33,13,20,41
Spart Moscow,1465,2,11,5,4,39,25,14,38
CSKA Moscow,1465,3,10,5,5,27,19,8,35
Krasnodar,1465,4,9,5,6,29,25,4,32
Zenit,1465,5,7,9,4,22,17,5,30
Terek Grozny,1465,6,8,6,6,23,23,0,30
Din Moscow,1465,7,6,6,8,18,22,-4,24
FK Rubin,1465,8,5,6,9,21,18,3,21
Rostov,1465,9,4,6,10,10,21,-11,18
Amkar,1465,10,4,5,11,9,23,-14,17
Anzhi,1465,11,2,6,12,16,41,-25,12
Loko Moscow,1466,1,12,5,3,34,13,21,41
CSKA Moscow,1466,2,11,3,6,29,19,10,36
Krasnodar,1466,3,10,4,6,30,25,5,34
Zenit,1466,4,8,8,4,23,18,5,32
Spart Moscow,1466,5,8,5,7,35,32,3,29
Terek Grozny,1466,6,7,6,7,21,24,-3,27
Din Moscow,1466,7,6,6,8,19,24,-5,24
FK Rubin,1466,8,6,5,9,24,18,6,23
Rostov,1466,9,5,6,9,12,18,-6,21
Amkar,1466,10,5,5,10,12,23,-11,20
Anzhi,1466,11,3,5,12,16,41,-25,14
Loko Moscow,1467,1,11,6,3,29,12,17,39
CSKA Moscow,1467,2,12,3,5,29,17,12,39
Spart Moscow,1467,3,10,6,4,38,28,10,36
Krasnodar,1467,4,10,4,6,29,24,5,34
Zenit,1467,5,7,9,4,21,14,7,30
Terek Grozny,1467,6,7,6,7,23,30,-7,27
Din Moscow,1467,7,6,6,8,18,22,-4,24
FK Rubin,1467,8,5,5,10,21,19,2,20
Amkar,1467,9,5,5,10,15,23,-8,20
Rostov,1467,10,4,6,10,12,20,-8,18
Anzhi,1467,11,2,6,12,17,43,-26,12
Loko Moscow,1468,1,12,5,3,30,14,16,41
CSKA Moscow,1468,2,10,5,5,26,18,8,35
Spart Moscow,1468,3,9,5,6,36,29,7,32
Krasnodar,1468,4,9,4,7,31,26,5,31
Zenit,1468,5,7,9,4,21,14,7,30
Terek Grozny,1468,6,7,6,7,20,23,-3,27
FK Rubin,1468,7,7,5,8,24,18,6,26
Din Moscow,1468,8,5,6,9,19,25,-6,21
Rostov,1468,9,5,6,9,11,17,-6,21
Amkar,1468,10,5,5,10,10,22,-12,20
Anzhi,1468,11,3,6,11,16,38,-22,15
Loko Moscow,1469,1,13,5,2,32,12,20,44
CSKA Moscow,1469,2,10,4,6,26,20,6,34
Spart Moscow,1469,3,9,6,5,35,27,8,33
Zenit,1469,4,8,8,4,25,16,9,32
Krasnodar,1469,5,8,4,8,28,27,1,28
Din Moscow,1469,6,7,6,7,20,21,-1,27
Terek Grozny,1469,7,7,5,8,21,25,-4,26
FK Rubin,1469,8,6,5,9,23,20,3,23
Rostov,1469,9,4,7,9,10,17,-7,19
Amkar,1469,10,5,4,11,11,24,-13,19
Anzhi,1469,11,3,6,11,16,38,-22,15
Loko Moscow,1470,1,11,5,4,31,17,14,38
CSKA Moscow,1470,2,10,4,6,25,18,7,34
Krasnodar,1470,3,10,4,6,32,26,6,34
Zenit,1470,4,8,9,3,24,13,11,33
Spart Moscow,1470,5,9,6,5,37,29,8,33
Terek Grozny,1470,6,8,6,6,23,24,-1,30
Din Moscow,1470,7,6,6,8,22,26,-4,24
Rostov,1470,8,5,6,9,11,17,-6,21
FK Rubin,1470,9,5,5,10,22,21,1,20
Amkar,1470,10,4,6,10,9,22,-13,18
Anzhi,1470,11,3,5,12,17,40,-23,14
Loko Moscow,1471,1,12,6,2,32,12,20,42
CSKA Moscow,1471,2,11,4,5,29,19,10,37
Krasnodar,1471,3,9,4,7,28,26,2,31
Zenit,1471,4,7,9,4,22,16,6,30
Spart Moscow,1471,5,8,6,6,36,33,3,30
Terek Grozny,1471,6,7,6,7,21,25,-4,27
Din Moscow,1471,7,5,8,7,18,22,-4,23
Amkar,1471,8,6,4,10,17,24,-7,22
FK Rubin,1471,9,5,6,9,21,18,3,21
Rostov,1471,10,5,6,9,12,18,-6,21
Anzhi,1471,11,2,7,11,16,39,-23,13
Loko Moscow,1472,1,12,5,3,31,14,17,41
CSKA Moscow,1472,2,11,3,6,27,19,8,36
Spart Moscow,1472,3,9,5,6,35,27,8,32
Zenit,1472,4,8,8,4,23,15,8,32
Krasnodar,1472,5,9,4,7,30,26,4,31
Terek Grozny,1472,6,8,5,7,23,25,-2,29
FK Rubin,1472,7,7,5,8,27,18,9,26
Din Moscow,1472,8,6,6,8,19,25,-6,24
Rostov,1472,9,5,6,9,11,17,-6,21
Amkar,1472,10,4,4,12,11,27,-16,16
Anzhi,1472,11,3,5,12,15,39,-24,14
Loko Moscow,1473,1,12,5,3,31,16,15,41
CSKA Moscow,1473,2,10,5,5,27,19,8,35
Krasnodar,1473,3,10,4,6,34,24,10,34
Zenit,1473,4,7,9,4,24,17,7,30
Spart Moscow,1473,5,8,6,6,36,30,6,30
Terek Grozny,1473,6,7,6,7,21,25,-4,27
Din Moscow,1473,7,6,7,7,20,23,-3,25
FK Rubin,1473,8,5,6,9,21,20,1,21
Amkar,1473,9,5,5,10,10,22,-12,20
Rostov,1473,10,4,7,9,11,18,-7,19
Anzhi,1473,11,3,6,11,17,38,-21,15
CSKA Moscow,1474,1,12,3,5,29,18,11,39
Loko Moscow,1474,2,11,5,4,29,14,15,38
Spart Moscow,1474,3,10,5,5,41,28,13,35
Zenit,1474,4,8,8,4,23,14,9,32
Krasnodar,1474,5,9,4,7,29,26,3,31
Terek Grozny,1474,6,7,6,7,20,25,-5,27
FK Rubin,1474,7,7,5,8,26,18,8,26
Din Moscow,1474,8,5,6,9,17,25,-8,21
Amkar,1474,9,5,5,10,11,23,-12,20
Rostov,1474,10,4,6,10,11,23,-12,18
Anzhi,1474,11,3,5,12,18,40,-22,14
Loko Moscow,1475,1,11,7,2,31,13,18,40
Spart Moscow,1475,2,11,5,4,42,28,14,38
Zenit,1475,3,8,9,3,22,13,9,33
CSKA Moscow,1475,4,10,3,7,25,19,6,33
Krasnodar,1475,5,8,6,6,30,27,3,30
Terek Grozny,1475,6,8,5,7,24,25,-1,29
FK Rubin,1475,7,5,7,8,25,21,4,22
Din Moscow,1475,8,5,7,8,22,29,-7,22
Amkar,1475,9,5,4,11,11,25,-14,19
Rostov,1475,10,4,6,10,11,19,-8,18
Anzhi,1475,11,3,5,12,16,40,-24,14
Spart Moscow,1476,1,11,5,4,39,25,14,38
Loko Moscow,1476,2,11,5,4,30,19,11,38
CSKA Moscow,1476,3,11,3,6,28,19,9,36
Zenit,1476,4,9,8,3,25,13,12,35
Krasnodar,1476,5,10,4,6,33,25,8,34
Terek Grozny,1476,6,7,6,7,23,26,-3,27
FK Rubin,1476,7,6,5,9,23,18,5,23
Din Moscow,1476,8,5,6,9,17,24,-7,21
Rostov,1476,9,4,6,10,10,19,-9,18
Amkar,1476,10,4,5,11,10,26,-16,17
Anzhi,1476,11,3,5,12,18,42,-24,14
Loko Moscow,1477,1,12,5,3,30,12,18,41
CSKA Moscow,1477,2,11,3,6,27,18,9,36
Spart Moscow,1477,3,10,5,5,43,31,12,35
Zenit,1477,4,9,8,3,23,13,10,35
Terek Grozny,1477,5,8,6,6,21,22,-1,30
Krasnodar,1477,6,8,4,8,27,26,1,28
Din Moscow,1477,7,7,6,7,22,23,-1,27
FK Rubin,1477,8,6,5,9,22,19,3,23
Rostov,1477,9,4,6,10,10,21,-11,18
Amkar,1477,10,4,4,12,12,27,-15,16
Anzhi,1477,11,2,6,12,14,39,-25,12
Loko Moscow,1478,1,12,6,2,33,14,19,42
Spart Moscow,1478,2,11,5,4,43,29,14,38
CSKA Moscow,1478,3,11,4,5,27,17,10,37
Zenit,1478,4,7,9,4,23,16,7,30
Krasnodar,1478,5,8,6,6,28,25,3,30
Terek Grozny,1478,6,7,5,8,20,26,-6,26
FK Rubin,1478,7,6,6,8,22,17,5,24
Din Moscow,1478,8,5,6,9,19,28,-9,21
Amkar,1478,9,5,4,11,12,25,-13,19
Rostov,1478,10,4,6,10,10,18,-8,18
Anzhi,1478,11,3,5,12,17,39,-22,14
Loko Moscow,1479,1,12,5,3,32,14,18,41
Spart Moscow,1479,2,11,5,4,40,29,11,38
CSKA Moscow,1479,3,10,5,5,26,18,8,35
Krasnodar,1479,4,9,5,6,29,25,4,32
Zenit,1479,5,7,9,4,23,16,7,30
Terek Grozny,1479,6,8,6,6,24,25,-1,30
FK Rubin,1479,7,6,6,8,25,18,7,24
Din Moscow,1479,8,5,6,9,19,27,-8,21
Rostov,1479,9,4,6,10,11,19,-8,18
Amkar,1479,10,4,5,11,11,25,-14,17
Anzhi,1479,11,2,6,12,17,41,-24,12
Loko Moscow,1480,1,12,6,2,31,11,20,42
CSKA Moscow,1480,2,11,4,5,28,19,9,37
Spart Moscow,1480,3,9,5,6,35,28,7,32
Zenit,1480,4,7,9,4,21,14,7,30
Krasnodar,1480,5,8,5,7,29,28,1,29
Terek Grozny,1480,6,7,6,7,21,25,-4,27
FK Rubin,1480,7,6,6,8,25,20,5,24
Rostov,1480,8,5,6,9,11,17,-6,21
Din Moscow,1480,9,5,6,9,18,25,-7,21
Amkar,1480,10,5,5,10,11,22,-11,20
Anzhi,1480,11,3,6,11,19,40,-21,15
CSKA Moscow,1481,1,12,3,5,30,17,13,39
Loko Moscow,1481,2,11,5,4,29,14,15,38
Zenit,1481,3,8,8,4,22,16,6,32
Spart Moscow,1481,4,9,5,6,36,31,5,32
Krasnodar,1481,5,9,5,6,31,26,5,32
Terek Grozny,1481,6,9,5,6,23,23,0,32
Din Moscow,1481,7,6,6,8,20,24,-4,24
FK Rubin,1481,8,5,6,9,23,20,3,21
Rostov,1481,9,5,6,9,11,17,-6,21
Amkar,1481,10,5,4,11,13,24,-11,19
Anzhi,1481,11,2,5,13,14,40,-26,11
CSKA Moscow,1482,1,12,3,5,29,17,12,39
Loko Moscow,1482,2,11,5,4,32,17,15,38
Spart Moscow,1482,3,10,6,4,37,27,10,36
Zenit,1482,4,8,8,4,25,16,9,32
Krasnodar,1482,5,9,4,7,30,27,3,31
Terek Grozny,1482,6,7,6,7,20,23,-3,27
FK Rubin,1482,7,6,6,8,24,19,5,24
Din Moscow,1482,8,5,7,8,19,24,-5,22
Rostov,1482,9,4,6,10,10,18,-8,18
Amkar,1482,10,4,6,10,10,23,-13,18
Anzhi,1482,11,3,5,12,15,40,-25,14
Loko Moscow,1483,1,11,6,3,30,14,16,39
CSKA Moscow,1483,2,11,4,5,27,18,9,37
Spart Moscow,1483,3,10,6,4,38,28,10,36
Zenit,1483,4,8,9,3,24,14,10,33
Krasnodar,1483,5,9,5,6,31,27,4,32
Terek Grozny,1483,6,8,6,6,22,23,-1,30
Din Moscow,1483,7,6,7,7,21,24,-3,25
FK Rubin,1483,8,5,5,10,24,22,2,20
Rostov,1483,9,4,6,10,10,18,-8,18
Amkar,1483,10,4,4,12,10,25,-15,16
Anzhi,1483,11,2,6,12,15,39,-24,12
Loko Moscow,1484,1,11,6,3,30,13,17,39
CSKA Moscow,1484,2,11,4,5,31,20,11,37
Spart Moscow,1484,3,10,5,5,38,27,11,35
Zenit,1484,4,7,10,3,25,17,8,31
Krasnodar,1484,5,9,4,7,28,26,2,31
Terek Grozny,1484,6,7,7,6,25,27,-2,28
Din Moscow,1484,7,6,6,8,19,23,-4,24
FK Rubin,1484,8,6,5,9,24,19,5,23
Amkar,1484,9,5,5,10,13,24,-11,20
Rostov,1484,10,4,6,10,10,21,-11,18
Anzhi,1484,11,2,6,12,17,43,-26,12
Loko Moscow,1485,1,12,5,3,32,14,18,41
CSKA Moscow,1485,2,12,3,5,28,17,11,39
Spart Moscow,1485,3,10,5,5,40,26,14,35
Krasnodar,1485,4,9,4,7,31,27,4,31
Zenit,1485,5,7,8,5,21,16,5,29
Terek Grozny,1485,6,7,6,7,23,26,-3,27
Din Moscow,1485,7,6,6,8,19,25,-6,24
FK Rubin,1485,8,6,5,9,23,20,3,23
Rostov,1485,9,5,6,9,11,17,-6,21
Amkar,1485,10,5,4,11,12,27,-15,19
Anzhi,1485,11,2,6,12,15,40,-25,12
Loko Moscow,1486,1,13,5,2,32,12,20,44
CSKA Moscow,1486,2,11,4,5,31,20,11,37
Spart Moscow,1486,3,9,5,6,35,28,7,32
Terek Grozny,1486,4,9,5,6,24,23,1,32
Zenit,1486,5,7,9,4,23,16,7,30
Krasnodar,1486,6,8,5,7,29,27,2,29
Din Moscow,1486,7,6,7,7,19,22,-3,25
FK Rubin,1486,8,5,7,8,23,19,4,22
Rostov,1486,9,5,6,9,12,18,-6,21
Amkar,1486,10,4,4,12,9,25,-16,16
Anzhi,1486,11,2,5,13,16,43,-27,11
Loko Moscow,1487,1,12,6,2,31,11,20,42
CSKA Moscow,1487,2,12,3,5,31,18,13,39
Spart Moscow,1487,3,9,7,4,38,28,10,34
Zenit,1487,4,7,9,4,22,15,7,30
Krasnodar,1487,5,8,5,7,28,27,1,29
Terek Grozny,1487,6,8,5,7,24,27,-3,29
FK Rubin,1487,7,6,6,8,25,19,6,24
Din Moscow,1487,8,5,7,8,20,26,-6,22
Rostov,1487,9,4,6,10,10,19,-9,18
Amkar,1487,10,4,5,11,11,25,-14,17
Anzhi,1487,11,3,5,12,18,43,-25,14
Loko Moscow,1488,1,13,5,2,33,12,21,44
CSKA Moscow,1488,2,11,3,6,27,18,9,36
Spart Moscow,1488,3,10,5,5,39,28,11,35
Zenit,1488,4,8,8,4,23,15,8,32
Krasnodar,1488,5,9,4,7,30,26,4,31
Terek Grozny,1488,6,8,5,7,23,25,-2,29
Din Moscow,1488,7,6,6,8,19,25,-6,24
Amkar,1488,8,6,4,10,13,22,-9,22
FK Rubin,1488,9,5,5,10,21,22,-1,20
Rostov,1488,10,4,6,10,10,19,-9,18
Anzhi,1488,11,2,5,13,16,42,-26,11
Loko Moscow,1489,1,12,6,2,33,13,20,42
CSKA Moscow,1489,2,11,3,6,29,19,10,36
Spart Moscow,1489,3,9,5,6,35,28,7,32
Zenit,1489,4,8,8,4,24,17,7,32
Krasnodar,1489,5,8,5,7,28,26,2,29
Terek Grozny,1489,6,8,5,7,22,25,-3,29
FK Rubin,1489,7,7,5,8,24,18,6,26
Din Moscow,1489,8,6,6,8,20,24,-4,24
Rostov,1489,9,5,6,9,11,17,-6,21
Amkar,1489,10,5,4,11,12,23,-11,19
Anzhi,1489,11,2,5,13,14,42,-28,11
Loko Moscow,1490,1,12,5,3,31,13,18,41
CSKA Moscow,1490,2,11,4,5,28,17,11,37
Spart Moscow,1490,3,10,6,4,36,25,11,36
Terek Grozny,1490,4,9,5,6,27,24,3,32
Krasnodar,1490,5,9,4,7,29,25,4,31
Zenit,1490,6,7,8,5,21,18,3,29
FK Rubin,1490,7,7,5,8,24,18,6,26
Din Moscow,1490,8,5,6,9,18,24,-6,21
Rostov,1490,9,4,6,10,10,19,-9,18
Amkar,1490,10,4,5,11,10,26,-16,17
Anzhi,1490,11,2,6,12,15,40,-25,12
Loko Moscow,1491,1,12,6,2,32,13,19,42
CSKA Moscow,1491,2,11,3,6,28,19,9,36
Spart Moscow,1491,3,10,5,5,38,29,9,35
Zenit,1491,4,8,9,3,23,14,9,33
Krasnodar,1491,5,8,5,7,28,26,2,29
Terek Grozny,1491,6,7,5,8,21,26,-5,26
Din Moscow,1491,7,6,6,8,21,24,-3,24
Amkar,1491,8,6,4,10,12,22,-10,22
FK Rubin,1491,9,5,6,9,21,19,2,21
Rostov,1491,10,4,6,10,11,19,-8,18
Anzhi,1491,11,3,5,12,17,41,-24,14
Loko Moscow,1492,1,12,6,2,32,13,19,42
CSKA Moscow,1492,2,10,4,6,26,21,5,34
Zenit,1492,3,8,8,4,24,14,10,32
Spart Moscow,1492,4,8,8,4,38,30,8,32
Krasnodar,1492,5,9,5,6,32,26,6,32
Terek Grozny,1492,6,8,5,7,21,26,-5,29
FK Rubin,1492,7,6,5,9,24,20,4,23
Din Moscow,1492,8,5,7,8,18,25,-7,22
Rostov,1492,9,4,7,9,12,19,-7,19
Amkar,1492,10,4,5,11,11,25,-14,17
Anzhi,1492,11,3,6,11,19,38,-19,15
Loko Moscow,1493,1,11,5,4,29,14,15,38
Spart Moscow,1493,2,11,5,4,40,27,13,38
CSKA Moscow,1493,3,11,3,6,29,18,11,36
Zenit,1493,4,9,8,3,23,13,10,35
Krasnodar,1493,5,10,4,6,31,24,7,34
Terek Grozny,1493,6,8,5,7,22,24,-2,29
Din Moscow,1493,7,5,7,8,18,25,-7,22
FK Rubin,1493,8,5,6,9,21,19,2,21
Amkar,1493,9,5,4,11,12,24,-12,19
Rostov,1493,10,4,6,10,10,18,-8,18
Anzhi,1493,11,2,5,13,14,43,-29,11
Loko Moscow,1494,1,11,6,3,31,15,16,39
CSKA Moscow,1494,2,11,3,6,28,22,6,36
Spart Moscow,1494,3,9,7,4,37,27,10,34
Krasnodar,1494,4,10,4,6,32,26,6,34
Zenit,1494,5,8,9,3,25,14,11,33
Terek Grozny,1494,6,8,5,7,23,24,-1,29
Din Moscow,1494,7,5,8,7,19,23,-4,23
FK Rubin,1494,8,5,6,9,23,20,3,21
Amkar,1494,9,5,5,10,12,24,-12,20
Rostov,1494,10,4,6,10,10,19,-9,18
Anzhi,1494,11,2,5,13,16,42,-26,11
Loko Moscow,1495,1,12,5,3,32,14,18,41
CSKA Moscow,1495,2,11,4,5,28,19,9,37
Spart Moscow,1495,3,10,6,4,38,27,11,36
Krasnodar,1495,4,10,4,6,30,24,6,34
Terek Grozny,1495,5,9,5,6,24,23,1,32
Zenit,1495,6,7,9,4,23,17,6,30
FK Rubin,1495,7,6,5,9,23,18,5,23
Din Moscow,1495,8,5,6,9,17,25,-8,21
Rostov,1495,9,4,6,10,10,18,-8,18
Amkar,1495,10,4,5,11,11,26,-15,17
Anzhi,1495,11,2,5,13,16,41,-25,11
Loko Moscow,1496,1,13,5,2,34,14,20,44
CSKA Moscow,1496,2,11,3,6,28,18,10,36
Zenit,1496,3,8,8,4,25,17,8,32
Spart Moscow,1496,4,8,6,6,33,30,3,30
Terek Grozny,1496,5,8,5,7,23,24,-1,29
Krasnodar,1496,6,8,4,8,28,27,1,28
Din Moscow,1496,7,6,7,7,21,22,-1,25
FK Rubin,1496,8,6,6,8,24,19,5,24
Amkar,1496,9,6,4,10,12,22,-10,22
Rostov,1496,10,4,7,9,10,17,-7,19
Anzhi,1496,11,2,5,13,15,43,-28,11
Loko Moscow,1497,1,12,6,2,32,12,20,42
CSKA Moscow,1497,2,12,3,5,29,18,11,39
Spart Moscow,1497,3,10,5,5,39,28,11,35
Zenit,1497,4,7,9,4,23,16,7,30
Krasnodar,1497,5,8,4,8,27,27,0,28
Terek Grozny,1497,6,7,6,7,21,24,-3,27
FK Rubin,1497,7,6,6,8,23,18,5,24
Din Moscow,1497,8,5,7,8,19,25,-6,22
Rostov,1497,9,5,6,9,12,18,-6,21
Amkar,1497,10,4,5,11,9,24,-15,17
Anzhi,1497,11,3,5,12,16,40,-24,14
Loko Moscow,1498,1,12,6,2,30,11,19,42
CSKA Moscow,1498,2,11,3,6,27,19,8,36
Spart Moscow,1498,3,9,5,6,36,29,7,32
Krasnodar,1498,4,9,4,7,29,25,4,31
Zenit,1498,5,7,9,4,22,15,7,30
Terek Grozny,1498,6,8,5,7,22,25,-3,29
Din Moscow,1498,7,7,6,7,21,22,-1,27
Amkar,1498,8,6,4,10,14,23,-9,22
FK Rubin,1498,9,5,5,10,21,21,0,20
Rostov,1498,10,4,6,10,10,19,-9,18
Anzhi,1498,11,3,5,12,15,38,-23,14
Loko Moscow,1499,1,12,5,3,33,13,20,41
Spart Moscow,1499,2,10,6,4,39,29,10,36
CSKA Moscow,1499,3,11,3,6,29,20,9,36
Krasnodar,1499,4,10,4,6,30,25,5,34
Zenit,1499,5,8,8,4,23,17,6,32
Terek Grozny,1499,6,8,6,6,22,23,-1,30
FK Rubin,1499,7,6,5,9,23,18,5,23
Din Moscow,1499,8,5,7,8,19,25,-6,22
Rostov,1499,9,4,6,10,10,18,-8,18
Amkar,1499,10,4,5,11,12,26,-14,17
Anzhi,1499,11,2,5,13,15,41,-26,11
Loko Moscow,1500,1,12,5,3,33,16,17,41
Krasnodar,1500,2,10,4,6,33,25,8,34
CSKA Moscow,1500,3,10,4,6,26,19,7,34
Spart Moscow,1500,4,9,6,5,37,27,10,33
Zenit,1500,5,8,8,4,25,18,7,32
Terek Grozny,1500,6,8,6,6,24,24,0,30
Din Moscow,1500,7,7,6,7,21,22,-1,27
FK Rubin,1500,8,5,5,10,23,23,0,20
Rostov,1500,9,4,6,10,11,21,-10,18
Amkar,1500,10,4,6,10,10,23,-13,18
Anzhi,1500,11,2,6,12,15,40,-25,12
Loko Moscow,1501,1,12,6,2,33,14,19,42
CSKA Moscow,1501,2,11,3,6,29,20,9,36
Zenit,1501,3,8,8,4,23,14,9,32
Spart Moscow,1501,4,9,5,6,37,29,8,32
Krasnodar,1501,5,8,6,6,30,27,3,30
Terek Grozny,1501,6,8,5,7,22,23,-1,29
FK Rubin,1501,7,6,6,8,23,17,6,24
Amkar,1501,8,6,4,10,12,23,-11,22
Rostov,1501,9,5,6,9,11,17,-6,21
Din Moscow,1501,10,5,6,9,18,26,-8,21
Anzhi,1501,11,2,5,13,15,43,-28,11
Loko Moscow,1502,1,12,5,3,31,13,18,41
CSKA Moscow,1502,2,12,3,5,28,17,11,39
Spart Moscow,1502,3,10,6,4,37,27,10,36
Zenit,1502,4,8,8,4,22,14,8,32
Terek Grozny,1502,5,9,5,6,24,23,1,32
Krasnodar,1502,6,9,4,7,29,26,3,31
FK Rubin,1502,7,6,5,9,23,18,5,23
Din Moscow,1502,8,5,6,9,18,25,-7,21
Rostov,1502,9,4,6,10,10,18,-8,18
Amkar,1502,10,4,5,11,10,24,-14,17
Anzhi,1502,11,2,5,13,15,42,-27,11
Loko Moscow,1503,1,11,7,2,33,15,18,40
CSKA Moscow,1503,2,10,4,6,27,21,6,34
Zenit,1503,3,8,9,3,25,15,10,33
Spart Moscow,1503,4,9,6,5,37,29,8,33
Krasnodar,1503,5,8,6,6,29,26,3,30
Terek Grozny,1503,6,8,5,7,22,24,-2,29
FK Rubin,1503,7,6,6,8,23,18,5,24
Din Moscow,1503,8,5,6,9,19,25,-6,21
Rostov,1503,9,5,6,9,11,17,-6,21
Amkar,1503,10,4,5,11,11,26,-15,17
Anzhi,1503,11,3,6,11,18,39,-21,15
Loko Moscow,1504,1,11,6,3,32,15,17,39
Spart Moscow,1504,2,11,5,4,40,27,13,38
Krasnodar,1504,3,10,4,6,31,26,5,34
Zenit,1504,4,8,9,3,25,15,10,33
CSKA Moscow,1504,5,10,3,7,26,21,5,33
Terek Grozny,1504,6,9,5,6,22,22,0,32
FK Rubin,1504,7,6,5,9,23,19,4,23
Din Moscow,1504,8,5,6,9,17,24,-7,21
Rostov,1504,9,4,6,10,11,20,-9,18
Amkar,1504,10,4,4,12,10,25,-15,16
Anzhi,1504,11,3,5,12,16,39,-23,14
Loko Moscow,1505,1,12,6,2,31,11,20,42
CSKA Moscow,1505,2,10,4,6,27,20,7,34
Spart Moscow,1505,3,9,6,5,39,28,11,33
Zenit,1505,4,8,9,3,23,14,9,33
Krasnodar,1505,5,9,4,7,30,26,4,31
Terek Grozny,1505,6,8,5,7,24,28,-4,29
Din Moscow,1505,7,7,6,7,22,24,-2,27
FK Rubin,1505,8,5,5,10,23,23,0,20
Rostov,1505,9,4,6,10,10,21,-11,18
Amkar,1505,10,4,5,11,12,26,-14,17
Anzhi,1505,11,3,6,11,19,39,-20,15
Loko Moscow,1506,1,11,5,4,30,15,15,38
CSKA Moscow,1506,2,11,3,6,27,19,8,36
Spart Moscow,1506,3,10,5,5,38,26,12,35
Zenit,1506,4,9,8,3,23,13,10,35
Krasnodar,1506,5,9,4,7,30,27,3,31
Terek Grozny,1506,6,8,6,6,24,24,0,30
Din Moscow,1506,7,6,6,8,20,25,-5,24
FK Rubin,1506,8,6,5,9,24,20,4,23
Amkar,1506,9,5,5,10,12,24,-12,20
Rostov,1506,10,4,6,10,10,19,-9,18
Anzhi,1506,11,2,5,13,15,41,-26,11
Loko Moscow,1507,1,11,6,3,31,15,16,39
CSKA Moscow,1507,2,11,3,6,26,19,7,36
Zenit,1507,3,9,8,3,26,14,12,35
Spart Moscow,1507,4,9,6,5,37,27,10,33
Terek Grozny,1507,5,9,5,6,22,22,0,32
Krasnodar,1507,6,8,6,6,29,26,3,30
Din Moscow,1507,7,7,6,7,24,24,0,27
FK Rubin,1507,8,5,6,9,25,23,2,21
Rostov,1507,9,4,6,10,10,21,-11,18
Amkar,1507,10,4,5,11,9,23,-14,17
Anzhi,1507,11,2,5,13,14,39,-25,11
Loko Moscow,1508,1,12,5,3,32,13,19,41
Spart Moscow,1508,2,11,5,4,41,28,13,38
CSKA Moscow,1508,3,10,5,5,26,18,8,35
Krasnodar,1508,4,10,4,6,31,26,5,34
Zenit,1508,5,7,9,4,22,16,6,30
Terek Grozny,1508,6,8,6,6,21,22,-1,30
Din Moscow,1508,7,5,7,8,19,25,-6,22
FK Rubin,1508,8,5,6,9,23,20,3,21
Rostov,1508,9,4,6,10,11,20,-9,18
Amkar,1508,10,4,5,11,10,24,-14,17
Anzhi,1508,11,2,6,12,14,38,-24,12
Loko Moscow,1509,1,12,5,3,33,14,19,41
Spart Moscow,1509,2,11,5,4,39,27,12,38
CSKA Moscow,1509,3,11,3,6,27,19,8,36
Zenit,1509,4,9,8,3,24,13,11,35
Krasnodar,1509,5,8,5,7,31,30,1,29
Terek Grozny,1509,6,8,5,7,25,24,1,29
FK Rubin,1509,7,5,7,8,23,19,4,22
Din Moscow,1509,8,5,7,8,17,22,-5,22
Rostov,1509,9,4,6,10,10,19,-9,18
Amkar,1509,10,4,4,12,12,30,-18,16
Anzhi,1509,11,3,5,12,15,39,-24,14
Loko Moscow,1510,1,11,5,4,29,15,14,38
Spart Moscow,1510,2,10,6,4,37,27,10,36
CSKA Moscow,1510,3,11,3,6,27,19,8,36
Zenit,1510,4,9,8,3,24,13,11,35
Krasnodar,1510,5,9,4,7,31,28,3,31
Terek Grozny,1510,6,8,5,7,22,25,-3,29
FK Rubin,1510,7,7,5,8,27,20,7,26
Din Moscow,1510,8,5,6,9,18,24,-6,21
Rostov,1510,9,4,6,10,10,18,-8,18
Amkar,1510,10,4,5,11,11,25,-14,17
Anzhi,1510,11,3,5,12,18,40,-22,14
Loko Moscow,1511,1,12,6,2,30,11,19,42
Spart Moscow,1511,2,11,5,4,36,25,11,38
CSKA Moscow,1511,3,10,3,7,25,20,5,33
Zenit,1511,4,8,8,4,22,14,8,32
Krasnodar,1511,5,8,5,7,28,26,2,29
Terek Grozny,1511,6,7,7,6,22,24,-2,28
FK Rubin,1511,7,6,6,8,23,18,5,24
Din Moscow,1511,8,5,7,8,17,22,-5,22
Rostov,1511,9,4,6,10,10,18,-8,18
Amkar,1511,10,4,5,11,10,24,-14,17
Anzhi,1511,11,3,6,11,17,38,-21,15
Loko Moscow,1512,1,12,5,3,30,14,16,41
Krasnodar,1512,2,10,4,6,32,24,8,34
Spart Moscow,1512,3,9,6,5,36,29,7,33
CSKA Moscow,1512,4,10,3,7,26,20,6,33
Zenit,1512,5,8,8,4,22,14,8,32
Terek Grozny,1512,6,8,5,7,24,26,-2,29
FK Rubin,1512,7,6,5,9,23,20,3,23
Amkar,1512,8,6,4,10,14,22,-8,22
Din Moscow,1512,9,5,6,9,18,24,-6,21
Rostov,1512,10,4,7,9,12,19,-7,19
Anzhi,1512,11,3,5,12,17,42,-25,14
Loko Moscow,1513,1,13,5,2,32,12,20,44
CSKA Moscow,1513,2,12,3,5,30,20,10,39
Spart Moscow,1513,3,9,7,4,39,27,12,34
Krasnodar,1513,4,9,4,7,29,26,3,31
Zenit,1513,5,7,8,5,22,16,6,29
Terek Grozny,1513,6,7,7,6,26,28,-2,28
FK Rubin,1513,7,6,5,9,23,18,5,23
Din Moscow,1513,8,5,6,9,17,27,-10,21
Rostov,1513,9,4,7,9,11,18,-7,19
Amkar,1513,10,4,6,10,12,25,-13,18
Anzhi,1513,11,2,6,12,20,44,-24,12
Loko Moscow,1514,1,11,6,3,30,13,17,39
Spart Moscow,1514,2,10,5,5,37,27,10,35
Zenit,1514,3,8,9,3,23,14,9,33
CSKA Moscow,1514,4,10,3,7,26,20,6,33
Terek Grozny,1514,5,9,5,6,25,25,0,32
Krasnodar,1514,6,9,4,7,28,26,2,31
Din Moscow,1514,7,6,6,8,19,22,-3,24
FK Rubin,1514,8,6,5,9,23,19,4,23
Amkar,1514,9,5,4,11,12,24,-12,19
Rostov,1514,10,4,6,10,10,20,-10,18
Anzhi,1514,11,3,5,12,18,41,-23,14
Loko Moscow,1515,1,13,5,2,33,11,22,44
CSKA Moscow,1515,2,11,4,5,30,19,11,37
Spart Moscow,1515,3,10,6,4,36,26,10,36
Krasnodar,1515,4,8,5,7,28,26,2,29
Zenit,1515,5,7,8,5,21,19,2,29
Terek Grozny,1515,6,7,6,7,22,26,-4,27
Din Moscow,1515,7,6,6,8,19,22,-3,24
FK Rubin,1515,8,5,6,9,22,20,2,21
Rostov,1515,9,4,7,9,10,17,-7,19
Amkar,1515,10,4,5,11,12,26,-14,17
Anzhi,1515,11,3,6,11,18,39,-21,15
Loko Moscow,1516,1,11,6,3,30,15,15,39
Spart Moscow,1516,2,10,6,4,38,27,11,36
Krasnodar,1516,3,10,4,6,33,26,7,34
CSKA Moscow,1516,4,10,4,6,26,21,5,34
Zenit,1516,5,8,9,3,24,13,11,33
Terek Grozny,1516,6,7,6,7,21,25,-4,27
Din Moscow,1516,7,6,7,7,20,23,-3,25
FK Rubin,1516,8,5,5,10,22,20,2,20
Amkar,1516,9,5,4,11,11,24,-13,19
Rostov,1516,10,4,6,10,10,18,-8,18
Anzhi,1516,11,2,7,11,16,39,-23,13
Loko Moscow,1517,1,11,7,2,32,14,18,40
CSKA Moscow,1517,2,11,3,6,26,19,7,36
Zenit,1517,3,8,9,3,23,13,10,33
Krasnodar,1517,4,9,5,6,31,27,4,32
Spart Moscow,1517,5,8,7,5,35,28,7,31
Terek Grozny,1517,6,8,5,7,21,23,-2,29
FK Rubin,1517,7,6,5,9,22,18,4,23
Din Moscow,1517,8,5,7,8,19,24,-5,22
Rostov,1517,9,4,7,9,10,17,-7,19
Amkar,1517,10,5,4,11,10,23,-13,19
Anzhi,1517,11,3,5,12,15,38,-23,14
Loko Moscow,1518,1,12,6,2,32,13,19,42
CSKA Moscow,1518,2,12,3,5,29,17,12,39
Spart Moscow,1518,3,10,6,4,37,26,11,36
Krasnodar,1518,4,9,4,7,29,26,3,31
Zenit,1518,5,7,9,4,22,15,7,30
Terek Grozny,1518,6,7,7,6,22,24,-2,28
Din Moscow,1518,7,5,8,7,19,23,-4,23
FK Rubin,1518,8,5,6,9,23,20,3,21
Rostov,1518,9,4,6,10,11,19,-8,18
Amkar,1518,10,4,5,11,10,25,-15,17
Anzhi,1518,11,2,6,12,15,41,-26,12
Loko Moscow,1519,1,11,5,4,31,15,16,38
Spart Moscow,1519,2,10,6,4,38,27,11,36
CSKA Moscow,1519,3,11,3,6,27,19,8,36
Zenit,1519,4,9,8,3,24,14,10,35
Krasnodar,1519,5,9,4,7,29,26,3,31
Terek Grozny,1519,6,7,6,7,21,24,-3,27
FK Rubin,1519,7,7,5,8,23,17,6,26
Din Moscow,1519,8,5,6,9,17,24,-7,21
Rostov,1519,9,4,6,10,11,19,-8,18
Amkar,1519,10,4,6,10,11,24,-13,18
Anzhi,1519,11,3,5,12,16,39,-23,14
Loko Moscow,1520,1,12,5,3,31,14,17,41
Spart Moscow,1520,2,10,6,4,39,28,11,36
CSKA Moscow,1520,3,10,5,5,26,18,8,35
Zenit,1520,4,8,9,3,24,14,10,33
Krasnodar,1520,5,8,4,8,30,29,1,28
Terek Grozny,1520,6,7,6,7,21,24,-3,27
FK Rubin,1520,7,7,5,8,26,20,6,26
Din Moscow,1520,8,5,7,8,18,23,-5,22
Rostov,1520,9,4,6,10,11,20,-9,18
Amkar,1520,10,4,5,11,11,25,-14,17
Anzhi,1520,11,3,6,11,16,38,-22,15
Loko Moscow,1521,1,12,5,3,32,15,17,41
CSKA Moscow,1521,2,11,4,5,32,19,13,37
Spart Moscow,1521,3,10,6,4,41,30,11,36
Krasnodar,1521,4,9,5,6,32,27,5,32
Zenit,1521,5,7,9,4,22,15,7,30
Terek Grozny,1521,6,7,6,7,22,25,-3,27
FK Rubin,1521,7,6,6,8,25,20,5,24
Din Moscow,1521,8,5,6,9,20,26,-6,21
Amkar,1521,9,5,5,10,14,26,-12,20
Rostov,1521,10,4,6,10,10,19,-9,18
Anzhi,1521,11,2,6,12,17,45,-28,12
Loko Moscow,1522,1,11,7,2,31,13,18,40
CSKA Moscow,1522,2,11,3,6,27,20,7,36
Zenit,1522,3,8,9,3,25,15,10,33
Spart Moscow,1522,4,9,5,6,37,28,9,32
Krasnodar,1522,5,9,5,6,30,25,5,32
Terek Grozny,1522,6,8,5,7,25,26,-1,29
Din Moscow,1522,7,6,6,8,19,24,-5,24
Amkar,1522,8,6,4,10,13,24,-11,22
Rostov,1522,9,5,6,9,11,17,-6,21
FK Rubin,1522,10,5,5,10,21,21,0,20
Anzhi,1522,11,2,5,13,16,42,-26,11
Loko Moscow,1523,1,12,5,3,30,12,18,41
CSKA Moscow,1523,2,12,3,5,27,17,10,39
Spart Moscow,1523,3,10,5,5,42,30,12,35
Zenit,1523,4,8,8,4,22,14,8,32
Krasnodar,1523,5,8,5,7,27,25,2,29
Terek Grozny,1523,6,7,6,7,21,25,-4,27
FK Rubin,1523,7,5,7,8,22,18,4,22
Din Moscow,1523,8,5,7,8,19,24,-5,22
Amkar,1523,9,5,5,10,12,24,-12,20
Rostov,1523,10,4,6,10,11,22,-11,18
Anzhi,1523,11,3,5,12,17,39,-22,14
Loko Moscow,1524,1,11,6,3,32,15,17,39
CSKA Moscow,1524,2,10,5,5,27,19,8,35
Zenit,1524,3,8,9,3,24,15,9,33
Spart Moscow,1524,4,8,8,4,39,31,8,32
Terek Grozny,1524,5,9,5,6,23,22,1,32
Krasnodar,1524,6,8,5,7,29,28,1,29
FK Rubin,1524,7,6,6,8,23,17,6,24
Din Moscow,1524,8,5,8,7,18,22,-4,23
Rostov,1524,9,4,7,9,12,19,-7,19
Amkar,1524,10,4,5,11,12,26,-14,17
Anzhi,1524,11,2,6,12,15,40,-25,12
Loko Moscow,1525,1,12,6,2,36,13,23,42
CSKA Moscow,1525,2,11,3,6,31,19,12,36
Spart Moscow,1525,3,9,6,5,36,31,5,33
Krasnodar,1525,4,9,5,6,30,26,4,32
Zenit,1525,5,8,8,4,24,20,4,32
Terek Grozny,1525,6,8,6,6,23,23,0,30
Din Moscow,1525,7,6,7,7,20,23,-3,25
FK Rubin,1525,8,5,5,10,23,21,2,20
Amkar,1525,9,5,4,11,13,24,-11,19
Rostov,1525,10,4,6,10,11,19,-8,18
Anzhi,1525,11,2,6,12,15,43,-28,12
Loko Moscow,1526,1,12,5,3,32,16,16,41
CSKA Moscow,1526,2,12,3,5,31,19,12,39
Spart Moscow,1526,3,9,7,4,40,29,11,34
Krasnodar,1526,4,9,4,7,32,28,4,31
Zenit,1526,5,7,8,5,22,19,3,29
Terek Grozny,1526,6,7,6,7,21,24,-3,27
Din Moscow,1526,7,6,6,8,21,27,-6,24
FK Rubin,1526,8,6,5,9,25,19,6,23
Amkar,1526,9,5,5,10,11,23,-12,20
Rostov,1526,10,4,7,9,11,18,-7,19
Anzhi,1526,11,2,6,12,16,40,-24,12
Loko Moscow,1527,1,12,5,3,31,15,16,41
CSKA Moscow,1527,2,11,4,5,28,17,11,37
Spart Moscow,1527,3,10,6,4,39,26,13,36
Krasnodar,1527,4,9,4,7,30,27,3,31
Zenit,1527,5,7,9,4,22,15,7,30
Terek Grozny,1527,6,8,6,6,21,22,-1,30
FK Rubin,1527,7,7,5,8,26,17,9,26
Din Moscow,1527,8,5,7,8,18,24,-6,22
Rostov,1527,9,4,6,10,10,19,-9,18
Amkar,1527,10,4,5,11,9,25,-16,17
Anzhi,1527,11,2,5,13,14,41,-27,11
Loko Moscow,1528,1,12,5,3,33,13,20,41
CSKA Moscow,1528,2,10,4,6,26,19,7,34
Zenit,1528,3,8,9,3,23,14,9,33
Spart Moscow,1528,4,9,6,5,40,32,8,33
Terek Grozny,1528,5,8,5,7,22,24,-2,29
Krasnodar,1528,6,8,4,8,29,30,-1,28
FK Rubin,1528,7,7,5,8,24,18,6,26
Din Moscow,1528,8,5,6,9,18,25,-7,21
Rostov,1528,9,4,7,9,12,19,-7,19
Amkar,1528,10,5,4,11,13,26,-13,19
Anzhi,1528,11,4,5,11,17,37,-20,17
Loko Moscow,1529,1,11,5,4,33,19,14,38
CSKA Moscow,1529,2,11,4,5,29,19,10,37
Spart Moscow,1529,3,10,5,5,40,28,12,35
Krasnodar,1529,4,10,4,6,34,27,7,34
Zenit,1529,5,8,9,3,28,17,11,33
Terek Grozny,1529,6,8,6,6,24,23,1,30
Din Moscow,1529,7,5,7,8,18,26,-8,22
FK Rubin,1529,8,5,6,9,22,21,1,21
Amkar,1529,9,5,4,11,10,25,-15,19
Rostov,1529,10,4,6,10,11,19,-8,18
Anzhi,1529,11,2,6,12,15,40,-25,12
Loko Moscow,1530,1,11,6,3,30,15,15,39
CSKA Moscow,1530,2,11,3,6,28,21,7,36
Spart Moscow,1530,3,10,5,5,39,26,13,35
Krasnodar,1530,4,10,4,6,33,24,9,34
Zenit,1530,5,8,9,3,25,15,10,33
Terek Grozny,1530,6,8,5,7,23,26,-3,29
Din Moscow,1530,7,6,6,8,19,23,-4,24
FK Rubin,1530,8,6,5,9,23,21,2,23
Rostov,1530,9,4,6,10,10,22,-12,18
Amkar,1530,10,4,4,12,10,25,-15,16
Anzhi,1530,11,3,5,12,18,40,-22,14
Loko Moscow,1531,1,13,5,2,32,12,20,44
Spart Moscow,1531,2,10,5,5,38,27,11,35
CSKA Moscow,1531,3,10,5,5,27,19,8,35
Zenit,1531,4,7,9,4,22,15,7,30
Krasnodar,1531,5,8,4,8,29,28,1,28
Terek Grozny,1531,6,7,7,6,22,24,-2,28
FK Rubin,1531,7,6,6,8,24,19,5,24
Din Moscow,1531,8,5,7,8,19,25,-6,22
Rostov,1531,9,5,6,9,11,17,-6,21
Amkar,1531,10,4,5,11,10,25,-15,17
Anzhi,1531,11,2,7,11,16,39,-23,13
Loko Moscow,1532,1,12,5,3,32,13,19,41
Spart Moscow,1532,2,10,6,4,38,27,11,36
CSKA Moscow,1532,3,10,4,6,26,19,7,34
Zenit,1532,4,8,8,4,23,16,7,32
Krasnodar,1532,5,9,4,7,28,25,3,31
Terek Grozny,1532,6,8,5,7,22,25,-3,29
Din Moscow,1532,7,6,6,8,19,24,-5,24
FK Rubin,1532,8,6,5,9,23,19,4,23
Rostov,1532,9,4,7,9,12,19,-7,19
Amkar,1532,10,4,4,12,9,24,-15,16
Anzhi,1532,11,3,6,11,18,39,-21,15
Loko Moscow,1533,1,12,6,2,34,14,20,42
CSKA Moscow,1533,2,11,3,6,27,18,9,36
Spart Moscow,1533,3,10,5,5,37,29,8,35
Zenit,1533,4,8,8,4,22,15,7,32
Krasnodar,1533,5,9,5,6,31,27,4,32
Terek Grozny,1533,6,7,6,7,24,27,-3,27
Din Moscow,1533,7,5,7,8,18,23,-5,22
FK Rubin,1533,8,5,6,9,22,19,3,21
Amkar,1533,9,5,5,10,13,24,-11,20
Rostov,1533,10,4,6,10,12,20,-8,18
Anzhi,1533,11,3,5,12,17,41,-24,14
Loko Moscow,1534,1,11,6,3,31,14,17,39
Zenit,1534,2,8,9,3,25,15,10,33
CSKA Moscow,1534,3,10,3,7,26,21,5,33
Krasnodar,1534,4,9,5,6,30,26,4,32
Spart Moscow,1534,5,8,6,6,34,29,5,30
Terek Grozny,1534,6,8,5,7,23,24,-1,29
Din Moscow,1534,7,5,8,7,18,22,-4,23
FK Rubin,1534,8,5,7,8,23,19,4,22
Amkar,1534,9,6,4,10,12,22,-10,22
Rostov,1534,10,5,6,9,12,18,-6,21
Anzhi,1534,11,3,5,12,16,40,-24,14
Loko Moscow,1535,1,12,6,2,30,11,19,42
CSKA Moscow,1535,2,12,3,5,30,18,12,39
Spart Moscow,1535,3,10,6,4,39,27,12,36
Krasnodar,1535,4,9,4,7,28,25,3,31
Zenit,1535,5,7,9,4,21,16,5,30
Terek Grozny,1535,6,7,6,7,21,25,-4,27
Din Moscow,1535,7,6,6,8,21,24,-3,24
FK Rubin,1535,8,5,5,10,21,21,0,20
Rostov,1535,9,4,7,9,11,18,-7,19
Amkar,1535,10,5,4,11,11,24,-13,19
Anzhi,1535,11,2,6,12,16,40,-24,12
Loko Moscow,1536,1,12,6,2,34,14,20,42
CSKA Moscow,1536,2,11,4,5,29,19,10,37
Spart Moscow,1536,3,9,7,4,37,27,10,34
Zenit,1536,4,7,10,3,24,16,8,31
Krasnodar,1536,5,9,4,7,32,29,3,31
Terek Grozny,1536,6,8,5,7,22,25,-3,29
Din Moscow,1536,7,6,6,8,20,25,-5,24
FK Rubin,1536,8,5,5,10,23,22,1,20
Amkar,1536,9,5,5,10,11,22,-11,20
Rostov,1536,10,4,7,9,11,18,-7,19
Anzhi,1536,11,2,5,13,15,41,-26,11
Loko Moscow,1537,1,12,5,3,31,13,18,41
Spart Moscow,1537,2,10,5,5,38,28,10,35
CSKA Moscow,1537,3,10,5,5,25,17,8,35
Krasnodar,1537,4,9,4,7,29,26,3,31
Zenit,1537,5,7,9,4,21,14,7,30
Terek Grozny,1537,6,8,6,6,24,24,0,30
FK Rubin,1537,7,6,6,8,23,18,5,24
Din Moscow,1537,8,5,7,8,19,24,-5,22
Rostov,1537,9,5,6,9,12,18,-6,21
Amkar,1537,10,4,4,12,10,27,-17,16
Anzhi,1537,11,2,7,11,15,38,-23,13
Loko Moscow,1538,1,11,5,4,31,15,16,38
CSKA Moscow,1538,2,11,3,6,28,18,10,36
Spart Moscow,1538,3,10,5,5,40,28,12,35
Zenit,1538,4,9,8,3,23,13,10,35
Krasnodar,1538,5,10,4,6,31,26,5,34
Terek Grozny,1538,6,7,6,7,21,24,-3,27
FK Rubin,1538,7,6,5,9,23,19,4,23
Rostov,1538,8,5,6,9,12,18,-6,21
Din Moscow,1538,9,5,6,9,18,26,-8,21
Amkar,1538,10,4,5,11,10,25,-15,17
Anzhi,1538,11,3,5,12,16,41,-25,14
Loko Moscow,1539,1,11,6,3,30,14,16,39
Spart Moscow,1539,2,10,5,5,38,29,9,35
CSKA Moscow,1539,3,10,4,6,26,21,5,34
Krasnodar,1539,4,9,5,6,30,25,5,32
Zenit,1539,5,7,10,3,22,14,8,31
Terek Grozny,1539,6,8,6,6,21,22,-1,30
Din Moscow,1539,7,6,6,8,19,24,-5,24
FK Rubin,1539,8,5,6,9,21,18,3,21
Rostov,1539,9,5,6,9,13,18,-5,21
Amkar,1539,10,4,5,11,9,23,-14,17
Anzhi,1539,11,3,5,12,17,38,-21,14
Loko Moscow,1540,1,11,5,4,30,14,16,38
CSKA Moscow,1540,2,11,3,6,30,19,11,36
Zenit,1540,3,9,8,3,25,15,10,35
Spart Moscow,1540,4,9,7,4,38,25,13,34
Krasnodar,1540,5,10,4,6,30,25,5,34
Terek Grozny,1540,6,9,5,6,24,22,2,32
FK Rubin,1540,7,6,5,9,24,20,4,23
Din Moscow,1540,8,5,6,9,18,28,-10,21
Rostov,1540,9,4,7,9,10,17,-7,19
Amkar,1540,10,4,5,11,9,25,-16,17
Anzhi,1540,11,2,5,13,14,42,-28,11
Loko Moscow,1541,1,11,7,2,32,14,18,40
CSKA Moscow,1541,2,11,4,5,27,18,9,37
Spart Moscow,1541,3,9,6,5,38,31,7,33
Krasnodar,1541,4,9,5,6,32,26,6,32
Zenit,1541,5,7,10,3,23,15,8,31
Terek Grozny,1541,6,7,6,7,22,26,-4,27
FK Rubin,1541,7,6,5,9,22,20,2,23
Amkar,1541,8,6,4,10,13,22,-9,22
Din Moscow,1541,9,5,6,9,20,26,-6,21
Rostov,1541,10,4,7,9,11,18,-7,19
Anzhi,1541,11,2,6,12,16,40,-24,12
Loko Moscow,1542,1,12,5,3,34,16,18,41
Spart Moscow,1542,2,10,5,5,40,29,11,35
Krasnodar,1542,3,10,4,6,31,25,6,34
CSKA Moscow,1542,4,10,4,6,26,20,6,34
Zenit,1542,5,8,8,4,26,17,9,32
Terek Grozny,1542,6,8,6,6,25,23,2,30
Din Moscow,1542,7,6,6,8,20,23,-3,24
Rostov,1542,8,5,6,9,13,19,-6,21
FK Rubin,1542,9,5,5,10,21,21,0,20
Amkar,1542,10,4,5,11,9,25,-16,17
Anzhi,1542,11,2,6,12,16,43,-27,12
Loko Moscow,1543,1,13,5,2,31,11,20,44
CSKA Moscow,1543,2,11,3,6,28,19,9,36
Zenit,1543,3,8,8,4,23,15,8,32
Spart Moscow,1543,4,9,5,6,36,30,6,32
Krasnodar,1543,5,9,4,7,28,25,3,31
Terek Grozny,1543,6,8,6,6,21,22,-1,30
Din Moscow,1543,7,7,6,7,23,24,-1,27
FK Rubin,1543,8,5,5,10,23,21,2,20
Amkar,1543,9,5,5,10,10,22,-12,20
Rostov,1543,10,4,6,10,11,19,-8,18
Anzhi,1543,11,2,5,13,14,40,-26,11
Loko Moscow,1544,1,13,5,2,31,11,20,44
Spart Moscow,1544,2,10,6,4,39,29,10,36
CSKA Moscow,1544,3,11,3,6,29,20,9,36
Zenit,1544,4,8,8,4,24,16,8,32
Terek Grozny,1544,5,8,5,7,23,23,0,29
Krasnodar,1544,6,8,4,8,27,26,1,28
FK Rubin,1544,7,6,6,8,25,20,5,24
Din Moscow,1544,8,5,7,8,22,27,-5,22
Rostov,1544,9,4,7,9,12,19,-7,19
Amkar,1544,10,5,4,11,10,23,-13,19
Anzhi,1544,11,2,5,13,14,42,-28,11
Loko Moscow,1545,1,11,5,4,31,15,16,38
CSKA Moscow,1545,2,11,4,5,27,17,10,37
Krasnodar,1545,3,10,4,6,31,26,5,34
Zenit,1545,4,8,9,3,22,13,9,33
Spart Moscow,1545,5,8,7,5,36,30,6,31
Terek Grozny,1545,6,7,6,7,22,25,-3,27
FK Rubin,1545,7,6,5,9,24,18,6,23
Din Moscow,1545,8,5,7,8,17,24,-7,22
Rostov,1545,9,5,6,9,14,19,-5,21
Amkar,1545,10,4,6,10,11,24,-13,18
Anzhi,1545,11,3,5,12,16,40,-24,14
Loko Moscow,1546,1,12,6,2,32,13,19,42
Spart Moscow,1546,2,11,5,4,40,26,14,38
CSKA Moscow,1546,3,11,3,6,28,20,8,36
Zenit,1546,4,8,9,3,25,16,9,33
Terek Grozny,1546,5,8,6,6,23,24,-1,30
Krasnodar,1546,6,8,4,8,27,26,1,28
FK Rubin,1546,7,7,5,8,24,17,7,26
Din Moscow,1546,8,5,6,9,18,26,-8,21
Rostov,1546,9,4,6,10,10,19,-9,18
Amkar,1546,10,4,5,11,10,25,-15,17
Anzhi,1546,11,2,5,13,16,41,-25,11
Loko Moscow,1547,1,12,5,3,32,14,18,41
Spart Moscow,1547,2,10,6,4,38,28,10,36
CSKA Moscow,1547,3,10,5,5,27,19,8,35
Krasnodar,1547,4,10,4,6,30,25,5,34
Zenit,1547,5,7,9,4,22,15,7,30
Terek Grozny,1547,6,8,5,7,24,27,-3,29
FK Rubin,1547,7,6,5,9,23,19,4,23
Din Moscow,1547,8,5,6,9,21,27,-6,21
Rostov,1547,9,4,7,9,10,17,-7,19
Amkar,1547,10,5,4,11,13,25,-12,19
Anzhi,1547,11,2,6,12,17,41,-24,12
Loko Moscow,1548,1,11,6,3,31,14,17,39
CSKA Moscow,1548,2,12,3,5,28,18,10,39
Krasnodar,1548,3,9,5,6,30,26,4,32
Zenit,1548,4,7,9,4,21,14,7,30
Spart Moscow,1548,5,8,6,6,36,32,4,30
Terek Grozny,1548,6,7,5,8,20,25,-5,26
Din Moscow,1548,7,6,7,7,20,23,-3,25
Amkar,1548,8,6,4,10,13,22,-9,22
FK Rubin,1548,9,5,6,9,21,18,3,21
Rostov,1548,10,5,6,9,13,18,-5,21
Anzhi,1548,11,3,5,12,16,39,-23,14
Loko Moscow,1549,1,13,5,2,35,12,23,44
CSKA Moscow,1549,2,10,4,6,27,20,7,34
Zenit,1549,3,8,8,4,24,18,6,32
Spart Moscow,1549,4,8,7,5,35,28,7,31
Terek Grozny,1549,5,8,5,7,22,24,-2,29
Krasnodar,1549,6,8,4,8,27,27,0,28
FK Rubin,1549,7,7,5,8,23,17,6,26
Din Moscow,1549,8,6,6,8,18,22,-4,24
Rostov,1549,9,4,7,9,11,18,-7,19
Amkar,1549,10,4,5,11,11,25,-14,17
Anzhi,1549,11,3,6,11,16,38,-22,15
Loko Moscow,1550,1,13,5,2,32,12,20,44
CSKA Moscow,1550,2,12,3,5,29,17,12,39
Spart Moscow,1550,3,10,5,5,41,28,13,35
Krasnodar,1550,4,9,4,7,30,26,4,31
Zenit,1550,5,7,8,5,22,16,6,29
Terek Grozny,1550,6,7,7,6,21,23,-2,28
Din Moscow,1550,7,6,6,8,20,24,-4,24
FK Rubin,1550,8,5,5,10,22,22,0,20
Amkar,1550,9,5,5,10,12,24,-12,20
Rostov,1550,10,4,6,10,10,21,-11,18
Anzhi,1550,11,2,6,12,14,40,-26,12
Loko Moscow,1551,1,11,6,3,30,13,17,39
Spart Moscow,1551,2,11,5,4,38,26,12,38
CSKA Moscow,1551,3,10,4,6,27,21,6,34
Krasnodar,1551,4,10,4,6,31,26,5,34
Zenit,1551,5,8,9,3,25,15,10,33
Terek Grozny,1551,6,8,6,6,24,24,0,30
Din Moscow,1551,7,5,7,8,17,23,-6,22
FK Rubin,1551,8,5,6,9,23,20,3,21
Rostov,1551,9,4,6,10,11,19,-8,18
Amkar,1551,10,4,5,11,11,25,-14,17
Anzhi,1551,11,2,6,12,15,40,-25,12
Loko Moscow,1552,1,13,5,2,33,13,20,44
CSKA Moscow,1552,2,11,4,5,29,18,11,37
Spart Moscow,1552,3,10,5,5,38,27,11,35
Krasnodar,1552,4,9,4,7,30,27,3,31
Zenit,1552,5,7,9,4,22,15,7,30
Terek Grozny,1552,6,8,5,7,22,24,-2,29
Din Moscow,1552,7,6,6,8,18,24,-6,24
FK Rubin,1552,8,6,5,9,25,19,6,23
Rostov,1552,9,4,6,10,10,20,-10,18
Amkar,1552,10,4,4,12,11,26,-15,16
Anzhi,1552,11,3,5,12,16,41,-25,14
Loko Moscow,1553,1,13,5,2,33,12,21,44
CSKA Moscow,1553,2,11,4,5,27,18,9,37
Spart Moscow,1553,3,10,6,4,37,26,11,36
Krasnodar,1553,4,9,4,7,30,26,4,31
Zenit,1553,5,7,9,4,22,16,6,30
Terek Grozny,1553,6,8,5,7,23,23,0,29
Din Moscow,1553,7,6,7,7,20,23,-3,25
FK Rubin,1553,8,5,5,10,22,21,1,20
Rostov,1553,9,4,6,10,10,18,-8,18
Amkar,1553,10,4,4,12,9,27,-18,16
Anzhi,1553,11,3,5,12,15,38,-23,14
Loko Moscow,1554,1,11,6,3,29,13,16,39
CSKA Moscow,1554,2,10,4,6,26,19,7,34
Zenit,1554,3,8,9,3,23,13,10,33
Spart Moscow,1554,4,9,5,6,36,30,6,32
Terek Grozny,1554,5,9,5,6,24,23,1,32
Krasnodar,1554,6,8,6,6,27,24,3,30
Din Moscow,1554,7,7,6,7,22,22,0,27
FK Rubin,1554,8,5,6,9,21,20,1,21
Rostov,1554,9,5,6,9,12,17,-5,21
Amkar,1554,10,4,4,12,10,26,-16,16
Anzhi,1554,11,3,5,12,17,40,-23,14
Loko Moscow,1555,1,11,7,2,32,14,18,40
Spart Moscow,1555,2,11,5,4,41,28,13,38
CSKA Moscow,1555,3,11,3,6,28,21,7,36
Zenit,1555,4,8,9,3,24,14,10,33
Krasnodar,1555,5,8,5,7,29,28,1,29
Terek Grozny,1555,6,8,5,7,23,23,0,29
FK Rubin,1555,7,6,6,8,23,17,6,24
Din Moscow,1555,8,5,7,8,18,23,-5,22
Amkar,1555,9,5,4,11,11,25,-14,19
Rostov,1555,10,4,6,10,11,20,-9,18
Anzhi,1555,11,2,5,13,16,43,-27,11
Loko Moscow,1556,1,12,5,3,31,13,18,41
CSKA Moscow,1556,2,10,4,6,26,19,7,34
Krasnodar,1556,3,10,4,6,31,25,6,34
Spart Moscow,1556,4,9,6,5,37,30,7,33
Zenit,1556,5,8,8,4,23,15,8,32
Terek Grozny,1556,6,7,7,6,21,23,-2,28
FK Rubin,1556,7,6,5,9,23,20,3,23
Din Moscow,1556,8,5,7,8,19,24,-5,22
Amkar,1556,9,5,5,10,13,23,-10,20
Rostov,1556,10,4,6,10,11,20,-9,18
Anzhi,1556,11,2,7,11,14,37,-23,13
Loko Moscow,1557,1,12,6,2,31,12,19,42
CSKA Moscow,1557,2,11,4,5,28,18,10,37
Spart Moscow,1557,3,9,7,4,35,26,9,34
Zenit,1557,4,7,9,4,23,16,7,30
Krasnodar,1557,5,8,6,6,27,24,3,30
Terek Grozny,1557,6,7,5,8,20,24,-4,26
FK Rubin,1557,7,6,6,8,22,17,5,24
Din Moscow,1557,8,5,6,9,17,23,-6,21
Amkar,1557,9,5,5,10,11,23,-12,20
Rostov,1557,10,4,7,9,10,17,-7,19
Anzhi,1557,11,3,5,12,15,39,-24,14
Loko Moscow,1558,1,11,7,2,30,12,18,40
CSKA Moscow,1558,2,11,4,5,27,17,10,37
Zenit,1558,3,7,10,3,21,13,8,31
Spart Moscow,1558,4,8,7,5,36,29,7,31
Krasnodar,1558,5,8,5,7,28,26,2,29
Terek Grozny,1558,6,8,5,7,22,24,-2,29
FK Rubin,1558,7,6,6,8,23,18,5,24
Din Moscow,1558,8,5,8,7,19,23,-4,23
Rostov,1558,9,5,6,9,12,18,-6,21
Amkar,1558,10,4,5,11,11,25,-14,17
Anzhi,1558,11,3,5,12,15,39,-24,14
Loko Moscow,1559,1,12,6,2,32,13,19,42
Spart Moscow,1559,2,11,5,4,37,26,11,38
CSKA Moscow,1559,3,10,5,5,27,19,8,35
Krasnodar,1559,4,9,5,6,30,26,4,32
Zenit,1559,5,7,9,4,24,17,7,30
Terek Grozny,1559,6,8,5,7,22,27,-5,29
Din Moscow,1559,7,6,6,8,19,23,-4,24
FK Rubin,1559,8,5,5,10,22,20,2,20
Rostov,1559,9,4,6,10,10,18,-8,18
Amkar,1559,10,4,4,12,9,24,-15,16
Anzhi,1559,11,3,6,11,19,38,-19,15
Loko Moscow,1560,1,13,5,2,35,14,21,44
CSKA Moscow,1560,2,12,3,5,33,21,12,39
Spart Moscow,1560,3,10,5,5,39,28,11,35
Krasnodar,1560,4,9,4,7,32,29,3,31
Terek Grozny,1560,5,8,6,6,24,24,0,30
Zenit,1560,6,7,8,5,24,20,4,29
Din Moscow,1560,7,6,7,7,19,22,-3,25
FK Rubin,1560,8,5,6,9,23,21,2,21
Rostov,1560,9,4,6,10,10,20,-10,18
Amkar,1560,10,4,5,11,11,25,-14,17
Anzhi,1560,11,2,5,13,18,44,-26,11
Loko Moscow,1561,1,12,6,2,31,12,19,42
CSKA Moscow,1561,2,11,3,6,27,18,9,36
Spart Moscow,1561,3,10,5,5,43,29,14,35
Zenit,1561,4,8,8,4,22,14,8,32
Krasnodar,1561,5,8,5,7,28,26,2,29
Din Moscow,1561,6,7,6,7,19,21,-2,27
Terek Grozny,1561,7,7,6,7,21,24,-3,27
FK Rubin,1561,8,6,5,9,22,18,4,23
Rostov,1561,9,4,6,10,13,24,-11,18
Amkar,1561,10,4,5,11,9,25,-16,17
Anzhi,1561,11,3,5,12,16,40,-24,14
Loko Moscow,1562,1,11,6,3,29,12,17,39
Spart Moscow,1562,2,10,6,4,41,27,14,36
CSKA Moscow,1562,3,11,3,6,27,20,7,36
Zenit,1562,4,9,8,3,25,14,11,35
Krasnodar,1562,5,9,5,6,28,24,4,32
Terek Grozny,1562,6,7,6,7,21,24,-3,27
Din Moscow,1562,7,5,7,8,18,23,-5,22
FK Rubin,1562,8,5,6,9,21,18,3,21
Amkar,1562,9,5,5,10,11,23,-12,20
Rostov,1562,10,4,6,10,10,22,-12,18
Anzhi,1562,11,2,6,12,15,39,-24,12
Loko Moscow,1563,1,12,6,2,31,12,19,42
CSKA Moscow,1563,2,12,3,5,31,20,11,39
Spart Moscow,1563,3,11,5,4,41,28,13,38
Zenit,1563,4,7,9,4,24,17,7,30
Terek Grozny,1563,5,8,5,7,22,24,-2,29
Krasnodar,1563,6,8,4,8,29,28,1,28
Din Moscow,1563,7,6,6,8,21,24,-3,24
FK Rubin,1563,8,6,5,9,24,21,3,23
Rostov,1563,9,4,6,10,11,21,-10,18
Amkar,1563,10,4,4,12,10,25,-15,16
Anzhi,1563,11,3,5,12,16,40,-24,14
Loko Moscow,1564,1,12,6,2,32,13,19,42
CSKA Moscow,1564,2,12,3,5,30,17,13,39
Spart Moscow,1564,3,9,6,5,38,30,8,33
Krasnodar,1564,4,9,4,7,28,25,3,31
Zenit,1564,5,7,9,4,23,17,6,30
Terek Grozny,1564,6,8,6,6,24,23,1,30
FK Rubin,1564,7,6,5,9,22,18,4,23
Din Moscow,1564,8,5,7,8,19,24,-5,22
Rostov,1564,9,5,6,9,12,18,-6,21
Amkar,1564,10,4,5,11,11,25,-14,17
Anzhi,1564,11,2,5,13,14,43,-29,11
Loko Moscow,1565,1,12,5,3,31,13,18,41
Spart Moscow,1565,2,10,6,4,40,27,13,36
Zenit,1565,3,9,8,3,25,15,10,35
CSKA Moscow,1565,4,10,4,6,27,20,7,34
Krasnodar,1565,5,9,4,7,30,27,3,31
Terek Grozny,1565,6,8,5,7,22,24,-2,29
Din Moscow,1565,7,6,6,8,19,24,-5,24
FK Rubin,1565,8,5,5,10,24,22,2,20
Rostov,1565,9,4,7,9,12,19,-7,19
Amkar,1565,10,4,4,12,9,26,-17,16
Anzhi,1565,11,3,6,11,17,39,-22,15
Loko Moscow,1566,1,12,5,3,31,12,19,41
Spart Moscow,1566,2,11,5,4,42,28,14,38
CSKA Moscow,1566,3,10,5,5,28,20,8,35
Krasnodar,1566,4,9,5,6,30,26,4,32
Zenit,1566,5,7,9,4,22,16,6,30
Terek Grozny,1566,6,7,6,7,22,25,-3,27
FK Rubin,1566,7,6,6,8,24,19,5,24
Din Moscow,1566,8,5,6,9,18,25,-7,21
Rostov,1566,9,4,6,10,11,20,-9,18
Amkar,1566,10,4,5,11,11,26,-15,17
Anzhi,1566,11,3,6,11,18,40,-22,15
Loko Moscow,1567,1,11,5,4,31,15,16,38
CSKA Moscow,1567,2,11,4,5,27,18,9,37
Spart Moscow,1567,3,9,7,4,37,28,9,34
Zenit,1567,4,8,9,3,23,14,9,33
Krasnodar,1567,5,9,5,6,32,28,4,32
Terek Grozny,1567,6,8,5,7,21,23,-2,29
Din Moscow,1567,7,5,8,7,20,24,-4,23
FK Rubin,1567,8,5,7,8,24,20,4,22
Rostov,1567,9,4,6,10,10,18,-8,18
Amkar,1567,10,4,5,11,10,24,-14,17
Anzhi,1567,11,3,5,12,15,38,-23,14
Loko Moscow,1568,1,11,5,4,30,14,16,38
CSKA Moscow,1568,2,11,3,6,28,19,9,36
Zenit,1568,3,9,8,3,23,13,10,35
Krasnodar,1568,4,10,4,6,31,26,5,34
Spart Moscow,1568,5,9,6,5,38,29,9,33
Terek Grozny,1568,6,8,5,7,21,25,-4,29
Din Moscow,1568,7,7,6,7,21,22,-1,27
FK Rubin,1568,8,5,5,10,23,21,2,20
Rostov,1568,9,4,7,9,11,18,-7,19
Amkar,1568,10,5,4,11,13,26,-13,19
Anzhi,1568,11,2,5,13,15,41,-26,11
Loko Moscow,1569,1,11,7,2,30,12,18,40
CSKA Moscow,1569,2,12,3,5,28,18,10,39
Spart Moscow,1569,3,10,6,4,42,26,16,36
Zenit,1569,4,7,9,4,21,14,7,30
Krasnodar,1569,5,8,6,6,29,26,3,30
Terek Grozny,1569,6,8,6,6,22,23,-1,30
FK Rubin,1569,7,6,6,8,26,19,7,24
Din Moscow,1569,8,5,6,9,18,28,-10,21
Rostov,1569,9,4,6,10,10,22,-12,18
Amkar,1569,10,4,5,11,10,24,-14,17
Anzhi,1569,11,2,6,12,16,40,-24,12
Loko Moscow,1570,1,11,5,4,31,15,16,38
Spart Moscow,1570,2,11,5,4,41,26,15,38
CSKA Moscow,1570,3,11,3,6,28,19,9,36
Zenit,1570,4,9,8,3,24,14,10,35
Krasnodar,1570,5,10,4,6,32,26,6,34
Terek Grozny,1570,6,7,5,8,21,27,-6,26
FK Rubin,1570,7,6,5,9,23,19,4,23
Din Moscow,1570,8,5,6,9,18,27,-9,21
Amkar,1570,9,5,4,11,10,24,-14,19
Rostov,1570,10,4,6,10,10,19,-9,18
Anzhi,1570,11,3,5,12,18,40,-22,14
Loko Moscow,1571,1,12,5,3,32,13,19,41
Spart Moscow,1571,2,10,5,5,35,26,9,35
Krasnodar,1571,3,10,4,6,29,24,5,34
CSKA Moscow,1571,4,10,3,7,26,22,4,33
Zenit,1571,5,8,8,4,24,17,7,32
Terek Grozny,1571,6,7,5,8,21,29,-8,26
Din Moscow,1571,7,6,7,7,19,22,-3,25
FK Rubin,1571,8,5,6,9,22,19,3,21
Amkar,1571,9,5,4,11,11,23,-12,19
Rostov,1571,10,4,6,10,10,18,-8,18
Anzhi,1571,11,4,5,11,22,38,-16,17
Loko Moscow,1572,1,12,5,3,30,12,18,41
Zenit,1572,2,9,8,3,23,13,10,35
CSKA Moscow,1572,3,10,4,6,25,18,7,34
Spart Moscow,1572,4,9,6,5,37,28,9,33
Krasnodar,1572,5,9,4,7,29,26,3,31
Terek Grozny,1572,6,7,5,8,21,25,-4,26
Din Moscow,1572,7,6,7,7,19,21,-2,25
FK Rubin,1572,8,5,6,9,22,19,3,21
Amkar,1572,9,5,5,10,11,23,-12,20
Rostov,1572,10,4,6,10,10,20,-10,18
Anzhi,1572,11,3,6,11,16,38,-22,15
Loko Moscow,1573,1,12,5,3,33,14,19,41
Spart Moscow,1573,2,11,5,4,43,27,16,38
CSKA Moscow,1573,3,11,4,5,27,18,9,37
Krasnodar,1573,4,9,4,7,30,27,3,31
Zenit,1573,5,7,8,5,21,16,5,29
Terek Grozny,1573,6,8,5,7,21,24,-3,29
Din Moscow,1573,7,6,6,8,19,26,-7,24
FK Rubin,1573,8,6,5,9,22,18,4,23
Rostov,1573,9,4,6,10,10,20,-10,18
Amkar,1573,10,4,4,12,10,25,-15,16
Anzhi,1573,11,3,6,11,17,38,-21,15
Loko Moscow,1574,1,12,5,3,31,13,18,41
CSKA Moscow,1574,2,11,3,6,27,21,6,36
Spart Moscow,1574,3,10,5,5,39,29,10,35
Krasnodar,1574,4,10,4,6,29,24,5,34
Zenit,1574,5,8,8,4,26,15,11,32
Terek Grozny,1574,6,9,5,6,24,23,1,32
Din Moscow,1574,7,5,7,8,18,24,-6,22
FK Rubin,1574,8,5,6,9,21,18,3,21
Amkar,1574,9,5,4,11,11,25,-14,19
Rostov,1574,10,4,6,10,11,19,-8,18
Anzhi,1574,11,2,5,13,15,41,-26,11
Loko Moscow,1575,1,11,6,3,31,14,17,39
Spart Moscow,1575,2,11,5,4,37,26,11,38
CSKA Moscow,1575,3,11,3,6,28,20,8,36
Krasnodar,1575,4,9,4,7,30,28,2,31
Zenit,1575,5,7,9,4,23,16,7,30
Terek Grozny,1575,6,7,5,8,20,24,-4,26
FK Rubin,1575,7,6,6,8,24,18,6,24
Din Moscow,1575,8,5,7,8,18,23,-5,22
Amkar,1575,9,5,4,11,10,23,-13,19
Rostov,1575,10,4,6,10,10,18,-8,18
Anzhi,1575,11,4,5,11,17,38,-21,17
Loko Moscow,1576,1,12,6,2,31,11,20,42
CSKA Moscow,1576,2,11,4,5,30,19,11,37
Spart Moscow,1576,3,9,7,4,41,32,9,34
Krasnodar,1576,4,9,5,6,28,24,4,32
Terek Grozny,1576,5,8,6,6,22,22,0,30
Zenit,1576,6,7,8,5,22,19,3,29
Din Moscow,1576,7,6,7,7,21,24,-3,25
FK Rubin,1576,8,5,5,10,22,20,2,20
Rostov,1576,9,4,6,10,12,20,-8,18
Amkar,1576,10,4,6,10,12,25,-13,18
Anzhi,1576,11,2,6,12,15,40,-25,12
Loko Moscow,1577,1,13,5,2,35,12,23,44
Spart Moscow,1577,2,10,6,4,41,27,14,36
CSKA Moscow,1577,3,10,3,7,25,20,5,33
Zenit,1577,4,8,8,4,23,16,7,32
Krasnodar,1577,5,9,4,7,31,28,3,31
Terek Grozny,1577,6,7,6,7,21,26,-5,27
Din Moscow,1577,7,6,6,8,19,23,-4,24
FK Rubin,1577,8,5,5,10,22,21,1,20
Amkar,1577,9,5,5,10,13,23,-10,20
Rostov,1577,10,4,6,10,10,22,-12,18
Anzhi,1577,11,3,6,11,16,38,-22,15
Loko Moscow,1578,1,12,6,2,31,12,19,42
Spart Moscow,1578,2,10,6,4,38,28,10,36
CSKA Moscow,1578,3,10,5,5,27,19,8,35
Zenit,1578,4,7,10,3,23,15,8,31
Krasnodar,1578,5,8,5,7,28,26,2,29
Terek Grozny,1578,6,7,6,7,21,25,-4,27
Din Moscow,1578,7,6,7,7,20,23,-3,25
FK Rubin,1578,8,5,6,9,22,19,3,21
Rostov,1578,9,4,6,10,10,18,-8,18
Amkar,1578,10,4,5,11,11,25,-14,17
Anzhi,1578,11,3,6,11,17,38,-21,15
Loko Moscow,1579,1,11,6,3,32,16,16,39
Spart Moscow,1579,2,10,6,4,43,28,15,36
CSKA Moscow,1579,3,11,3,6,28,21,7,36
Krasnodar,1579,4,10,4,6,32,25,7,34
Zenit,1579,5,8,9,3,25,15,10,33
Terek Grozny,1579,6,8,5,7,23,24,-1,29
Din Moscow,1579,7,5,7,8,17,25,-8,22
FK Rubin,1579,8,5,6,9,21,19,2,21
Amkar,1579,9,5,5,10,12,24,-12,20
Rostov,1579,10,4,6,10,12,22,-10,18
Anzhi,1579,11,2,5,13,16,42,-26,11
Loko Moscow,1580,1,12,6,2,32,11,21,42
CSKA Moscow,1580,2,11,4,5,26,17,9,37
Spart Moscow,1580,3,10,6,4,37,27,10,36
Terek Grozny,1580,4,9,5,6,25,23,2,32
Zenit,1580,5,7,9,4,21,16,5,30
Krasnodar,1580,6,8,6,6,28,25,3,30
FK Rubin,1580,7,5,7,8,22,18,4,22
Din Moscow,1580,8,5,7,8,17,22,-5,22
Rostov,1580,9,4,7,9,11,18,-7,19
Amkar,1580,10,4,4,12,10,26,-16,16
Anzhi,1580,11,2,5,13,15,41,-26,11
Loko Moscow,1581,1,11,6,3,30,13,17,39
CSKA Moscow,1581,2,12,3,5,30,19,11,39
Spart Moscow,1581,3,9,6,5,38,30,8,33
Terek Grozny,1581,4,9,5,6,24,22,2,32
Krasnodar,1581,5,9,4,7,28,27,1,31
Zenit,1581,6,7,9,4,23,16,7,30
Din Moscow,1581,7,6,7,7,21,24,-3,25
FK Rubin,1581,8,6,5,9,25,19,6,23
Amkar,1581,9,5,4,11,11,23,-12,19
Rostov,1581,10,4,6,10,11,20,-9,18
Anzhi,1581,11,2,5,13,15,43,-28,11
Loko Moscow,1582,1,12,5,3,32,12,20,41
CSKA Moscow,1582,2,12,3,5,30,18,12,39
Spart Moscow,1582,3,10,6,4,39,27,12,36
Zenit,1582,4,8,8,4,23,15,8,32
Terek Grozny,1582,5,9,5,6,26,23,3,32
Krasnodar,1582,6,8,5,7,29,29,0,29
Din Moscow,1582,7,6,6,8,20,23,-3,24
FK Rubin,1582,8,5,6,9,23,21,2,21
Rostov,1582,9,4,6,10,10,20,-10,18
Amkar,1582,10,4,5,11,10,26,-16,17
Anzhi,1582,11,2,5,13,15,43,-28,11
Loko Moscow,1583,1,11,7,2,32,14,18,40
CSKA Moscow,1583,2,11,3,6,27,19,8,36
Spart Moscow,1583,3,10,5,5,41,28,13,35
Zenit,1583,4,8,9,3,25,16,9,33
Krasnodar,1583,5,9,5,6,30,25,5,32
Terek Grozny,1583,6,8,5,7,22,23,-1,29
FK Rubin,1583,7,6,5,9,23,20,3,23
Amkar,1583,8,6,4,10,12,23,-11,22
Din Moscow,1583,9,5,6,9,19,27,-8,21
Rostov,1583,10,4,6,10,10,20,-10,18
Anzhi,1583,11,2,5,13,14,40,-26,11
Loko Moscow,1584,1,11,6,3,30,14,16,39
Spart Moscow,1584,2,10,6,4,42,31,11,36
Zenit,1584,3,9,8,3,24,13,11,35
CSKA Moscow,1584,4,10,3,7,26,20,6,33
Krasnodar,1584,5,9,5,6,32,26,6,32
Terek Grozny,1584,6,8,6,6,24,24,0,30
FK Rubin,1584,7,6,5,9,23,21,2,23
Din Moscow,1584,8,5,7,8,19,24,-5,22
Rostov,1584,9,4,6,10,13,21,-8,18
Amkar,1584,10,4,5,11,11,26,-15,17
Anzhi,1584,11,3,5,12,17,41,-24,14
Loko Moscow,1585,1,12,5,3,31,13,18,41
Spart Moscow,1585,2,11,5,4,43,28,15,38
CSKA Moscow,1585,3,11,4,5,28,18,10,37
Krasnodar,1585,4,9,4,7,29,26,3,31
Zenit,1585,5,7,9,4,22,16,6,30
Terek Grozny,1585,6,7,7,6,20,22,-2,28
FK Rubin,1585,7,7,5,8,25,18,7,26
Din Moscow,1585,8,5,6,9,19,26,-7,21
Rostov,1585,9,4,6,10,11,21,-10,18
Amkar,1585,10,4,5,11,10,25,-15,17
Anzhi,1585,11,2,6,12,14,39,-25,12
Loko Moscow,1586,1,13,5,2,33,12,21,44
CSKA Moscow,1586,2,11,4,5,30,18,12,37
Spart Moscow,1586,3,9,5,6,36,31,5,32
Krasnodar,1586,4,9,4,7,31,27,4,31
Zenit,1586,5,7,9,4,22,15,7,30
Terek Grozny,1586,6,8,5,7,22,24,-2,29
Din Moscow,1586,7,5,7,8,18,23,-5,22
FK Rubin,1586,8,5,6,9,21,20,1,21
Rostov,1586,9,5,6,9,12,18,-6,21
Amkar,1586,10,5,4,11,12,23,-11,19
Anzhi,1586,11,3,5,12,16,42,-26,14
Loko Moscow,1587,1,11,6,3,31,14,17,39
Spart Moscow,1587,2,10,6,4,39,26,13,36
Zenit,1587,3,9,8,3,24,14,10,35
CSKA Moscow,1587,4,10,4,6,26,19,7,34
Krasnodar,1587,5,8,6,6,29,26,3,30
Terek Grozny,1587,6,7,6,7,21,25,-4,27
Din Moscow,1587,7,6,6,8,19,25,-6,24
FK Rubin,1587,8,5,6,9,22,19,3,21
Rostov,1587,9,4,7,9,10,17,-7,19
Amkar,1587,10,4,5,11,10,25,-15,17
Anzhi,1587,11,3,6,11,17,38,-21,15
Loko Moscow,1588,1,12,5,3,30,13,17,41
Spart Moscow,1588,2,10,6,4,41,27,14,36
CSKA Moscow,1588,3,11,3,6,27,19,8,36
Zenit,1588,4,8,8,4,23,14,9,32
Krasnodar,1588,5,9,5,6,29,24,5,32
Terek Grozny,1588,6,9,5,6,23,23,0,32
FK Rubin,1588,7,6,6,8,23,18,5,24
Din Moscow,1588,8,5,6,9,18,26,-8,21
Rostov,1588,9,4,6,10,10,20,-10,18
Amkar,1588,10,4,5,11,11,25,-14,17
Anzhi,1588,11,2,5,13,15,41,-26,11
Loko Moscow,1589,1,12,6,2,30,11,19,42
CSKA Moscow,1589,2,12,3,5,30,17,13,39
Spart Moscow,1589,3,9,6,5,35,27,8,33
Zenit,1589,4,7,9,4,21,14,7,30
Krasnodar,1589,5,8,4,8,27,28,-1,28
FK Rubin,1589,6,7,5,8,26,17,9,26
Terek Grozny,1589,7,7,5,8,21,25,-4,26
Din Moscow,1589,8,6,6,8,19,23,-4,24
Amkar,1589,9,5,5,10,10,22,-12,20
Rostov,1589,10,4,6,10,10,19,-9,18
Anzhi,1589,11,3,5,12,16,42,-26,14
Loko Moscow,1590,1,12,5,3,30,13,17,41
CSKA Moscow,1590,2,11,3,6,27,19,8,36
Zenit,1590,3,9,8,3,25,14,11,35
Spart Moscow,1590,4,9,6,5,39,32,7,33
Krasnodar,1590,5,9,4,7,28,25,3,31
Terek Grozny,1590,6,8,5,7,25,24,1,29
Din Moscow,1590,7,7,6,7,23,23,0,27
FK Rubin,1590,8,5,5,10,22,21,1,20
Rostov,1590,9,4,7,9,12,19,-7,19
Amkar,1590,10,5,4,11,12,25,-13,19
Anzhi,1590,11,2,5,13,15,43,-28,11
Loko Moscow,1591,1,11,6,3,29,12,17,39
CSKA Moscow,1591,2,11,4,5,27,18,9,37
Krasnodar,1591,3,10,4,6,30,25,5,34
Spart Moscow,1591,4,9,6,5,35,27,8,33
Zenit,1591,5,7,9,4,22,15,7,30
Terek Grozny,1591,6,8,6,6,24,24,0,30
Din Moscow,1591,7,6,6,8,19,23,-4,24
Rostov,1591,8,5,6,9,11,17,-6,21
FK Rubin,1591,9,5,5,10,23,21,2,20
Amkar,1591,10,4,6,10,11,24,-13,18
Anzhi,1591,11,2,6,12,15,40,-25,12
Loko Moscow,1592,1,12,5,3,33,14,19,41
Spart Moscow,1592,2,11,5,4,41,26,15,38
CSKA Moscow,1592,3,11,4,5,29,19,10,37
Zenit,1592,4,8,9,3,22,13,9,33
Krasnodar,1592,5,8,5,7,30,29,1,29
Terek Grozny,1592,6,7,6,7,20,23,-3,27
FK Rubin,1592,7,6,6,8,23,18,5,24
Din Moscow,1592,8,5,6,9,17,27,-10,21
Rostov,1592,9,4,6,10,10,18,-8,18
Amkar,1592,10,4,5,11,10,24,-14,17
Anzhi,1592,11,3,5,12,17,41,-24,14
Loko Moscow,1593,1,13,5,2,34,13,21,44
CSKA Moscow,1593,2,11,4,5,30,19,11,37
Spart Moscow,1593,3,9,6,5,38,28,10,33
Zenit,1593,4,7,9,4,23,17,6,30
Krasnodar,1593,5,8,4,8,29,28,1,28
Terek Grozny,1593,6,7,7,6,21,23,-2,28
FK Rubin,1593,7,6,6,8,23,18,5,24
Din Moscow,1593,8,5,7,8,18,25,-7,22
Rostov,1593,9,5,6,9,11,17,-6,21
Amkar,1593,10,4,6,10,11,24,-13,18
Anzhi,1593,11,2,6,12,15,41,-26,12
Loko Moscow,1594,1,11,6,3,32,16,16,39
Spart Moscow,1594,2,10,6,4,39,28,11,36
CSKA Moscow,1594,3,11,3,6,28,19,9,36
Zenit,1594,4,8,9,3,24,15,9,33
Krasnodar,1594,5,9,5,6,31,26,5,32
Terek Grozny,1594,6,7,5,8,22,27,-5,26
FK Rubin,1594,7,5,7,8,22,18,4,22
Din Moscow,1594,8,5,7,8,19,24,-5,22
Amkar,1594,9,5,5,10,11,23,-12,20
Rostov,1594,10,4,6,10,11,20,-9,18
Anzhi,1594,11,3,5,12,18,41,-23,14
Loko Moscow,1595,1,12,6,2,33,13,20,42
CSKA Moscow,1595,2,11,4,5,28,18,10,37
Spart Moscow,1595,3,10,5,5,41,32,9,35
Krasnodar,1595,4,9,4,7,31,29,2,31
Zenit,1595,5,7,9,4,21,15,6,30
Terek Grozny,1595,6,7,6,7,22,26,-4,27
Din Moscow,1595,7,6,7,7,22,25,-3,25
FK Rubin,1595,8,5,6,9,24,21,3,21
Rostov,1595,9,4,6,10,12,20,-8,18
Amkar,1595,10,4,5,11,12,26,-14,17
Anzhi,1595,11,3,6,11,18,39,-21,15
Loko Moscow,1596,1,11,5,4,29,14,15,38
Zenit,1596,2,9,8,3,27,13,14,35
Krasnodar,1596,3,10,4,6,29,24,5,34
CSKA Moscow,1596,4,10,4,6,26,22,4,34
Spart Moscow,1596,5,8,7,5,33,27,6,31
Terek Grozny,1596,6,7,7,6,22,24,-2,28
FK Rubin,1596,7,6,5,9,24,18,6,23
Din Moscow,1596,8,5,7,8,17,24,-7,22
Amkar,1596,9,5,5,10,13,24,-11,20
Rostov,1596,10,4,7,9,10,17,-7,19
Anzhi,1596,11,2,7,11,15,38,-23,13
Loko Moscow,1597,1,11,7,2,31,13,18,40
CSKA Moscow,1597,2,11,3,6,29,20,9,36
Zenit,1597,3,8,9,3,24,14,10,33
Krasnodar,1597,4,9,5,6,31,25,6,32
Spart Moscow,1597,5,8,7,5,33,28,5,31
Terek Grozny,1597,6,8,6,6,23,23,0,30
Din Moscow,1597,7,6,6,8,20,22,-2,24
FK Rubin,1597,8,6,5,9,22,20,2,23
Rostov,1597,9,4,7,9,10,17,-7,19
Amkar,1597,10,4,6,10,10,23,-13,18
Anzhi,1597,11,2,5,13,15,43,-28,11
Loko Moscow,1598,1,11,6,3,32,15,17,39
CSKA Moscow,1598,2,11,4,5,30,18,12,37
Spart Moscow,1598,3,10,5,5,38,28,10,35
Krasnodar,1598,4,9,5,6,30,26,4,32
Zenit,1598,5,7,10,3,23,15,8,31
Terek Grozny,1598,6,8,6,6,23,22,1,30
FK Rubin,1598,7,6,6,8,23,18,5,24
Din Moscow,1598,8,5,6,9,19,25,-6,21
Amkar,1598,9,5,5,10,11,23,-12,20
Rostov,1598,10,4,6,10,10,19,-9,18
Anzhi,1598,11,2,5,13,14,44,-30,11
Loko Moscow,1599,1,11,6,3,31,14,17,39
CSKA Moscow,1599,2,11,3,6,27,20,7,36
Spart Moscow,1599,3,10,5,5,38,29,9,35
Krasnodar,1599,4,10,4,6,31,25,6,34
Zenit,1599,5,8,9,3,25,14,11,33
Terek Grozny,1599,6,8,5,7,21,25,-4,29
Din Moscow,1599,7,6,6,8,18,22,-4,24
FK Rubin,1599,8,6,5,9,22,19,3,23
Rostov,1599,9,4,6,10,12,20,-8,18
Amkar,1599,10,4,4,12,10,25,-15,16
Anzhi,1599,11,3,5,12,17,39,-22,14
Loko Moscow,1600,1,12,5,3,33,16,17,41
CSKA Moscow,1600,2,12,3,5,30,17,13,39
Spart Moscow,1600,3,11,5,4,39,28,11,38
Krasnodar,1600,4,10,4,6,31,25,6,34
Zenit,1600,5,7,8,5,23,19,4,29
Terek Grozny,1600,6,8,5,7,22,24,-2,29
Din Moscow,1600,7,6,6,8,24,24,0,24
FK Rubin,1600,8,5,5,10,22,24,-2,20
Amkar,1600,9,5,4,11,12,25,-13,19
Rostov,1600,10,4,6,10,10,18,-8,18
Anzhi,1600,11,2,5,13,15,41,-26,11
Loko Moscow,1601,1,12,6,2,31,11,20,42
Spart Moscow,1601,2,11,5,4,43,29,14,38
CSKA Moscow,1601,3,11,3,6,31,20,11,36
Zenit,1601,4,8,9,3,24,13,11,33
Krasnodar,1601,5,8,5,7,27,26,1,29
Terek Grozny,1601,6,7,7,6,21,23,-2,28
FK Rubin,1601,7,6,6,8,23,18,5,24
Din Moscow,1601,8,5,6,9,19,27,-8,21
Rostov,1601,9,4,6,10,11,20,-9,18
Amkar,1601,10,4,5,11,11,25,-14,17
Anzhi,1601,11,2,6,12,15,44,-29,12
Loko Moscow,1602,1,13,5,2,34,12,22,44
Spart Moscow,1602,2,11,5,4,38,25,13,38
CSKA Moscow,1602,3,11,3,6,28,18,10,36
Zenit,1602,4,8,8,4,23,17,6,32
Krasnodar,1602,5,8,4,8,27,26,1,28
Terek Grozny,1602,6,7,7,6,23,25,-2,28
FK Rubin,1602,7,7,5,8,24,18,6,26
Din Moscow,1602,8,5,6,9,18,25,-7,21
Rostov,1602,9,4,6,10,10,19,-9,18
Amkar,1602,10,4,5,11,10,24,-14,17
Anzhi,1602,11,2,6,12,16,42,-26,12
Loko Moscow,1603,1,12,5,3,32,15,17,41
CSKA Moscow,1603,2,11,4,5,28,17,11,37
Zenit,1603,3,8,9,3,25,13,12,33
Spart Moscow,1603,4,8,6,6,37,31,6,30
Terek Grozny,1603,5,8,6,6,24,25,-1,30
Krasnodar,1603,6,8,5,7,27,27,0,29
Din Moscow,1603,7,6,7,7,21,24,-3,25
FK Rubin,1603,8,5,7,8,22,18,4,22
Rostov,1603,9,4,7,9,11,18,-7,19
Amkar,1603,10,5,4,11,13,26,-13,19
Anzhi,1603,11,2,6,12,15,41,-26,12
Loko Moscow,1604,1,11,6,3,30,13,17,39
CSKA Moscow,1604,2,12,3,5,32,18,14,39
Spart Moscow,1604,3,11,5,4,38,26,12,38
Zenit,1604,4,8,8,4,23,15,8,32
Krasnodar,1604,5,9,5,6,31,26,5,32
Terek Grozny,1604,6,9,5,6,23,23,0,32
Din Moscow,1604,7,6,6,8,20,24,-4,24
FK Rubin,1604,8,5,5,10,23,22,1,20
Rostov,1604,9,4,6,10,10,18,-8,18
Amkar,1604,10,4,4,12,10,26,-16,16
Anzhi,1604,11,2,5,13,14,43,-29,11
Loko Moscow,1605,1,12,6,2,34,14,20,42
CSKA Moscow,1605,2,12,3,5,31,19,12,39
Spart Moscow,1605,3,9,6,5,37,29,8,33
Krasnodar,1605,4,9,5,6,32,26,6,32
Terek Grozny,1605,5,8,6,6,23,24,-1,30
Zenit,1605,6,7,8,5,23,19,4,29
Din Moscow,1605,7,6,6,8,19,22,-3,24
FK Rubin,1605,8,6,5,9,22,20,2,23
Rostov,1605,9,4,7,9,11,18,-7,19
Amkar,1605,10,4,4,12,11,27,-16,16
Anzhi,1605,11,2,6,12,16,41,-25,12
Loko Moscow,1606,1,12,5,3,30,13,17,41
CSKA Moscow,1606,2,11,4,5,29,17,12,37
Spart Moscow,1606,3,9,6,5,35,27,8,33
Krasnodar,1606,4,9,5,6,30,25,5,32
Zenit,1606,5,7,9,4,21,14,7,30
Din Moscow,1606,6,7,6,7,21,23,-2,27
Terek Grozny,1606,7,7,6,7,21,26,-5,27
FK Rubin,1606,8,5,6,9,23,20,3,21
Amkar,1606,9,5,5,10,12,22,-10,20
Rostov,1606,10,4,6,10,10,18,-8,18
Anzhi,1606,11,2,6,12,15,42,-27,12
Loko Moscow,1607,1,11,6,3,30,13,17,39
CSKA Moscow,1607,2,12,3,5,31,17,14,39
Spart Moscow,1607,3,9,5,6,39,33,6,32
Zenit,1607,4,8,8,4,22,16,6,32
Krasnodar,1607,5,8,6,6,28,25,3,30
Terek Grozny,1607,6,7,6,7,22,25,-3,27
Din Moscow,1607,7,6,7,7,20,22,-2,25
FK Rubin,1607,8,5,7,8,21,17,4,22
Amkar,1607,9,5,5,10,11,23,-12,20
Rostov,1607,10,4,6,10,13,21,-8,18
Anzhi,1607,11,3,5,12,17,42,-25,14
Loko Moscow,1608,1,11,5,4,30,17,13,38
Spart Moscow,1608,2,10,6,4,40,27,13,36
CSKA Moscow,1608,3,11,3,6,28,19,9,36
Krasnodar,1608,4,10,4,6,29,24,5,34
Zenit,1608,5,8,8,4,27,17,10,32
Terek Grozny,1608,6,7,6,7,21,24,-3,27
Din Moscow,1608,7,6,6,8,19,26,-7,24
FK Rubin,1608,8,5,5,10,22,20,2,20
Amkar,1608,9,5,5,10,12,24,-12,20
Rostov,1608,10,4,6,10,11,19,-8,18
Anzhi,1608,11,3,6,11,15,37,-22,15
Loko Moscow,1609,1,12,6,2,31,12,19,42
Spart Moscow,1609,2,11,5,4,39,25,14,38
CSKA Moscow,1609,3,11,4,5,30,19,11,37
Zenit,1609,4,7,10,3,23,15,8,31
Krasnodar,1609,5,9,4,7,28,25,3,31
Terek Grozny,1609,6,7,5,8,23,27,-4,26
FK Rubin,1609,7,6,5,9,22,18,4,23
Din Moscow,1609,8,5,6,9,17,25,-8,21
Amkar,1609,9,5,4,11,11,25,-14,19
Rostov,1609,10,4,6,10,10,18,-8,18
Anzhi,1609,11,3,5,12,18,43,-25,14
Loko Moscow,1610,1,12,6,2,32,12,20,42
CSKA Moscow,1610,2,12,3,5,28,17,11,39
Spart Moscow,1610,3,11,5,4,39,26,13,38
Terek Grozny,1610,4,9,5,6,24,24,0,32
Zenit,1610,5,7,8,5,21,16,5,29
Krasnodar,1610,6,8,5,7,28,26,2,29
Din Moscow,1610,7,6,6,8,19,24,-5,24
FK Rubin,1610,8,6,5,9,23,19,4,23
Rostov,1610,9,4,6,10,10,19,-9,18
Amkar,1610,10,4,4,12,11,26,-15,16
Anzhi,1610,11,2,5,13,15,41,-26,11
CSKA Moscow,1611,1,12,3,5,29,19,10,39
Loko Moscow,1611,2,11,5,4,30,16,14,38
Krasnodar,1611,3,10,4,6,31,25,6,34
Zenit,1611,4,8,8,4,25,16,9,32
Spart Moscow,1611,5,8,6,6,36,31,5,30
Terek Grozny,1611,6,8,6,6,23,24,-1,30
Din Moscow,1611,7,6,7,7,21,24,-3,25
FK Rubin,1611,8,5,6,9,23,20,3,21
Rostov,1611,9,5,6,9,13,18,-5,21
Amkar,1611,10,4,6,10,10,23,-13,18
Anzhi,1611,11,2,5,13,16,41,-25,11
Loko Moscow,1612,1,11,5,4,29,13,16,38
Spart Moscow,1612,2,11,5,4,39,25,14,38
CSKA Moscow,1612,3,11,3,6,28,18,10,36
Zenit,1612,4,9,8,3,23,13,10,35
Krasnodar,1612,5,9,4,7,28,25,3,31
Terek Grozny,1612,6,8,5,7,25,26,-1,29
Din Moscow,1612,7,6,6,8,18,22,-4,24
FK Rubin,1612,8,6,5,9,22,18,4,23
Amkar,1612,9,5,4,11,12,25,-13,19
Rostov,1612,10,4,6,10,10,20,-10,18
Anzhi,1612,11,2,5,13,15,44,-29,11
Loko Moscow,1613,1,11,6,3,30,13,17,39
CSKA Moscow,1613,2,11,3,6,27,19,8,36
Spart Moscow,1613,3,10,5,5,38,29,9,35
Zenit,1613,4,8,9,3,23,14,9,33
Krasnodar,1613,5,9,4,7,28,25,3,31
Terek Grozny,1613,6,8,5,7,24,23,1,29
FK Rubin,1613,7,6,6,8,24,19,5,24
Din Moscow,1613,8,5,7,8,20,26,-6,22
Amkar,1613,9,6,4,10,13,23,-10,22
Rostov,1613,10,4,6,10,10,18,-8,18
Anzhi,1613,11,2,5,13,15,43,-28,11
Loko Moscow,1614,1,11,6,3,30,14,16,39
CSKA Moscow,1614,2,11,4,5,29,19,10,37
Krasnodar,1614,3,9,5,6,32,27,5,32
Spart Moscow,1614,4,9,5,6,36,32,4,32
Zenit,1614,5,7,10,3,23,15,8,31
Terek Grozny,1614,6,7,7,6,24,26,-2,28
FK Rubin,1614,7,6,6,8,25,20,5,24
Rostov,1614,8,5,6,9,13,17,-4,21
Din Moscow,1614,9,5,6,9,19,25,-6,21
Amkar,1614,10,5,5,10,15,26,-11,20
Anzhi,1614,11,2,6,12,15,40,-25,12
Loko Moscow,1615,1,12,5,3,30,13,17,41
CSKA Moscow,1615,2,12,3,5,29,18,11,39
Spart Moscow,1615,3,9,7,4,35,25,10,34
Krasnodar,1615,4,10,4,6,30,24,6,34
Zenit,1615,5,7,8,5,21,16,5,29
Terek Grozny,1615,6,7,5,8,21,28,-7,26
Din Moscow,1615,7,6,7,7,18,21,-3,25
FK Rubin,1615,8,5,5,10,21,19,2,20
Amkar,1615,9,5,5,10,10,22,-12,20
Rostov,1615,10,4,6,10,10,19,-9,18
Anzhi,1615,11,3,5,12,20,40,-20,14
Loko Moscow,1616,1,12,6,2,30,11,19,42
Spart Moscow,1616,2,10,6,4,41,28,13,36
CSKA Moscow,1616,3,11,3,6,27,20,7,36
Zenit,1616,4,8,9,3,23,13,10,33
Terek Grozny,1616,5,8,6,6,23,24,-1,30
Krasnodar,1616,6,8,4,8,27,26,1,28
FK Rubin,1616,7,7,5,8,23,17,6,26
Din Moscow,1616,8,5,7,8,18,23,-5,22
Rostov,1616,9,4,6,10,11,19,-8,18
Amkar,1616,10,4,4,12,10,28,-18,16
Anzhi,1616,11,2,6,12,17,41,-24,12
Loko Moscow,1617,1,11,6,3,31,15,16,39
CSKA Moscow,1617,2,12,3,5,28,18,10,39
Zenit,1617,3,8,8,4,23,14,9,32
Spart Moscow,1617,4,8,7,5,38,31,7,31
Krasnodar,1617,5,8,5,7,31,29,2,29
Terek Grozny,1617,6,7,6,7,21,25,-4,27
Din Moscow,1617,7,6,7,7,21,24,-3,25
FK Rubin,1617,8,6,6,8,25,20,5,24
Rostov,1617,9,4,7,9,12,19,-7,19
Amkar,1617,10,4,6,10,11,24,-13,18
Anzhi,1617,11,3,5,12,17,39,-22,14
Loko Moscow,1618,1,12,5,3,31,13,18,41
Spart Moscow,1618,2,10,5,5,37,28,9,35
CSKA Moscow,1618,3,10,4,6,25,18,7,34
Krasnodar,1618,4,10,4,6,32,26,6,34
Zenit,1618,5,8,8,4,22,14,8,32
Terek Grozny,1618,6,8,5,7,21,24,-3,29
Din Moscow,1618,7,6,6,8,18,22,-4,24
Rostov,1618,8,5,6,9,12,17,-5,21
FK Rubin,1618,9,5,5,10,22,21,1,20
Amkar,1618,10,4,4,12,10,26,-16,16
Anzhi,1618,11,3,6,11,16,37,-21,15
Loko Moscow,1619,1,11,6,3,31,15,16,39
CSKA Moscow,1619,2,11,3,6,27,21,6,36
Zenit,1619,3,8,9,3,25,14,11,33
Spart Moscow,1619,4,9,6,5,39,29,10,33
Terek Grozny,1619,5,9,5,6,23,23,0,32
Krasnodar,1619,6,9,4,7,31,27,4,31
FK Rubin,1619,7,6,6,8,25,20,5,24
Din Moscow,1619,8,5,8,7,20,24,-4,23
Amkar,1619,9,5,4,11,12,25,-13,19
Rostov,1619,10,4,6,10,11,21,-10,18
Anzhi,1619,11,2,5,13,15,40,-25,11
Loko Moscow,1620,1,11,6,3,30,13,17,39
Spart Moscow,1620,2,10,6,4,36,26,10,36
CSKA Moscow,1620,3,11,3,6,27,18,9,36
Zenit,1620,4,9,8,3,24,14,10,35
Krasnodar,1620,5,9,5,6,31,24,7,32
Terek Grozny,1620,6,7,6,7,22,25,-3,27
Din Moscow,1620,7,6,6,8,20,22,-2,24
FK Rubin,1620,8,5,5,10,21,24,-3,20
Amkar,1620,9,5,5,10,12,24,-12,20
Rostov,1620,10,4,6,10,10,18,-8,18
Anzhi,1620,11,2,6,12,15,40,-25,12
Loko Moscow,1621,1,11,6,3,31,14,17,39
CSKA Moscow,1621,2,12,3,5,32,18,14,39
Spart Moscow,1621,3,9,6,5,36,28,8,33
Zenit,1621,4,8,8,4,22,16,6,32
Krasnodar,1621,5,8,6,6,30,27,3,30
Terek Grozny,1621,6,8,5,7,23,24,-1,29
Din Moscow,1621,7,7,6,7,22,24,-2,27
FK Rubin,1621,8,5,6,9,24,21,3,21
Rostov,1621,9,4,6,10,10,18,-8,18
Amkar,1621,10,4,5,11,10,25,-15,17
Anzhi,1621,11,3,5,12,17,42,-25,14
Loko Moscow,1622,1,11,7,2,30,12,18,40
Spart Moscow,1622,2,9,7,4,40,26,14,34
Zenit,1622,3,8,9,3,25,15,10,33
CSKA Moscow,1622,4,10,3,7,28,23,5,33
Krasnodar,1622,5,9,5,6,33,27,6,32
Terek Grozny,1622,6,8,5,7,23,27,-4,29
Din Moscow,1622,7,5,8,7,19,23,-4,23
FK Rubin,1622,8,5,6,9,24,23,1,21
Amkar,1622,9,5,5,10,13,22,-9,20
Rostov,1622,10,4,6,10,10,23,-13,18
Anzhi,1622,11,3,5,12,17,41,-24,14
Loko Moscow,1623,1,13,5,2,33,12,21,44
CSKA Moscow,1623,2,11,4,5,28,18,10,37
Spart Moscow,1623,3,10,5,5,41,28,13,35
Krasnodar,1623,4,9,4,7,28,25,3,31
Zenit,1623,5,7,9,4,22,16,6,30
Terek Grozny,1623,6,7,6,7,22,25,-3,27
FK Rubin,1623,7,6,5,9,22,18,4,23
Amkar,1623,8,6,4,10,12,23,-11,22
Din Moscow,1623,9,5,6,9,18,28,-10,21
Rostov,1623,10,4,6,10,10,18,-8,18
Anzhi,1623,11,2,6,12,17,42,-25,12
Loko Moscow,1624,1,12,6,2,32,12,20,42
CSKA Moscow,1624,2,11,3,6,29,20,9,36
Spart Moscow,1624,3,9,7,4,37,28,9,34
Zenit,1624,4,8,8,4,24,16,8,32
Krasnodar,1624,5,8,6,6,30,27,3,30
Terek Grozny,1624,6,8,5,7,21,23,-2,29
FK Rubin,1624,7,5,7,8,27,23,4,22
Din Moscow,1624,8,5,7,8,20,25,-5,22
Rostov,1624,9,4,7,9,11,18,-7,19
Amkar,1624,10,4,5,11,11,25,-14,17
Anzhi,1624,11,3,5,12,16,41,-25,14
Loko Moscow,1625,1,11,7,2,30,12,18,40
CSKA Moscow,1625,2,12,3,5,29,19,10,39
Spart Moscow,1625,3,9,5,6,34,33,1,32
Zenit,1625,4,7,9,4,21,14,7,30
Krasnodar,1625,5,8,5,7,28,29,-1,29
Terek Grozny,1625,6,8,5,7,24,25,-1,29
Din Moscow,1625,7,6,7,7,20,21,-1,25
FK Rubin,1625,8,6,6,8,25,17,8,24
Amkar,1625,9,5,4,11,15,26,-11,19
Rostov,1625,10,4,6,10,10,18,-8,18
Anzhi,1625,11,3,5,12,18,40,-22,14
Loko Moscow,1626,1,11,6,3,31,14,17,39
CSKA Moscow,1626,2,11,3,6,31,20,11,36
Krasnodar,1626,3,10,4,6,31,25,6,34
Zenit,1626,4,8,9,3,23,14,9,33
Spart Moscow,1626,5,9,6,5,36,28,8,33
Terek Grozny,1626,6,8,5,7,21,23,-2,29
Din Moscow,1626,7,7,6,7,22,23,-1,27
FK Rubin,1626,8,5,5,10,21,21,0,20
Amkar,1626,9,5,5,10,10,22,-12,20
Rostov,1626,10,4,6,10,10,18,-8,18
Anzhi,1626,11,2,5,13,16,44,-28,11
Loko Moscow,1627,1,12,5,3,31,14,17,41
CSKA Moscow,1627,2,11,4,5,26,17,9,37
Spart Moscow,1627,3,9,7,4,39,27,12,34
Zenit,1627,4,8,9,3,24,13,11,33
Krasnodar,1627,5,9,4,7,31,27,4,31
Terek Grozny,1627,6,8,5,7,22,24,-2,29
Din Moscow,1627,7,6,7,7,21,22,-1,25
FK Rubin,1627,8,5,5,10,22,24,-2,20
Rostov,1627,9,4,7,9,11,18,-7,19
Amkar,1627,10,4,4,12,9,27,-18,16
Anzhi,1627,11,3,5,12,16,39,-23,14
Loko Moscow,1628,1,12,5,3,31,13,18,41
Spart Moscow,1628,2,11,5,4,39,25,14,38
CSKA Moscow,1628,3,10,4,6,25,18,7,34
Krasnodar,1628,4,9,4,7,30,27,3,31
Zenit,1628,5,7,9,4,21,14,7,30
Terek Grozny,1628,6,7,5,8,20,25,-5,26
FK Rubin,1628,7,6,6,8,25,20,5,24
Din Moscow,1628,8,5,7,8,19,24,-5,22
Amkar,1628,9,5,4,11,11,25,-14,19
Rostov,1628,10,4,6,10,10,19,-9,18
Anzhi,1628,11,4,5,11,16,37,-21,17
Loko Moscow,1629,1,13,5,2,34,12,22,44
CSKA Moscow,1629,2,10,4,6,25,18,7,34
Spart Moscow,1629,3,9,6,5,36,29,7,33
Zenit,1629,4,8,8,4,23,15,8,32
Krasnodar,1629,5,8,4,8,29,30,-1,28
Terek Grozny,1629,6,7,7,6,21,23,-2,28
Din Moscow,1629,7,7,6,7,20,21,-1,27
FK Rubin,1629,8,6,5,9,24,20,4,23
Rostov,1629,9,4,6,10,11,19,-8,18
Amkar,1629,10,4,6,10,10,23,-13,18
Anzhi,1629,11,2,7,11,15,38,-23,13
Loko Moscow,1630,1,12,5,3,30,15,15,41
CSKA Moscow,1630,2,11,4,5,29,19,10,37
Krasnodar,1630,3,10,4,6,33,24,9,34
Spart Moscow,1630,4,8,7,5,37,31,6,31
Zenit,1630,5,7,9,4,22,15,7,30
Terek Grozny,1630,6,8,6,6,22,23,-1,30
Din Moscow,1630,7,6,7,7,21,23,-2,25
FK Rubin,1630,8,5,6,9,22,20,2,21
Rostov,1630,9,4,7,9,11,18,-7,19
Amkar,1630,10,4,6,10,12,25,-13,18
Anzhi,1630,11,2,5,13,15,41,-26,11
Loko Moscow,1631,1,12,5,3,30,15,15,41
CSKA Moscow,1631,2,12,3,5,30,17,13,39
Spart Moscow,1631,3,9,7,4,38,28,10,34
Krasnodar,1631,4,10,4,6,33,25,8,34
Terek Grozny,1631,5,9,5,6,25,23,2,32
Zenit,1631,6,7,8,5,21,16,5,29
Din Moscow,1631,7,6,7,7,23,25,-2,25
FK Rubin,1631,8,5,5,10,24,23,1,20
Rostov,1631,9,4,7,9,11,18,-7,19
Amkar,1631,10,4,4,12,10,27,-17,16
Anzhi,1631,11,2,5,13,14,42,-28,11
Loko Moscow,1632,1,12,6,2,31,12,19,42
CSKA Moscow,1632,2,10,3,7,25,19,6,33
Zenit,1632,3,8,8,4,22,14,8,32
Spart Moscow,1632,4,8,6,6,34,28,6,30
Krasnodar,1632,5,8,6,6,28,25,3,30
Din Moscow,1632,6,7,6,7,21,22,-1,27
Terek Grozny,1632,7,7,6,7,21,24,-3,27
FK Rubin,1632,8,5,6,9,21,19,2,21
Amkar,1632,9,5,5,10,10,22,-12,20
Rostov,1632,10,4,7,9,10,17,-7,19
Anzhi,1632,11,4,5,11,17,38,-21,17
Loko Moscow,1633,1,12,5,3,31,14,17,41
Zenit,1633,2,9,8,3,24,13,11,35
Spart Moscow,1633,3,9,6,5,37,29,8,33
CSKA Moscow,1633,4,10,3,7,25,19,6,33
Terek Grozny,1633,5,9,5,6,23,23,0,32
Krasnodar,1633,6,8,4,8,30,29,1,28
FK Rubin,1633,7,6,6,8,25,20,5,24
Din Moscow,1633,8,5,7,8,18,25,-7,22
Rostov,1633,9,4,7,9,11,18,-7,19
Amkar,1633,10,5,4,11,12,23,-11,19
Anzhi,1633,11,3,5,12,16,39,-23,14
Loko Moscow,1634,1,12,5,3,31,14,17,41
CSKA Moscow,1634,2,10,4,6,26,19,7,34
Zenit,1634,3,8,8,4,22,14,8,32
Spart Moscow,1634,4,9,5,6,36,31,5,32
Krasnodar,1634,5,9,4,7,31,27,4,31
Din Moscow,1634,6,7,6,7,23,22,1,27
Terek Grozny,1634,7,7,6,7,21,24,-3,27
FK Rubin,1634,8,6,5,9,23,20,3,23
Amkar,1634,9,6,4,10,12,23,-11,22
Rostov,1634,10,4,6,10,10,18,-8,18
Anzhi,1634,11,2,7,11,16,39,-23,13
Loko Moscow,1635,1,11,6,3,30,14,16,39
Zenit,1635,2,9,8,3,26,14,12,35
CSKA Moscow,1635,3,10,4,6,26,20,6,34
Spart Moscow,1635,4,8,6,6,34,29,5,30
Krasnodar,1635,5,8,6,6,28,25,3,30
Terek Grozny,1635,6,8,6,6,24,25,-1,30
Din Moscow,1635,7,7,6,7,21,21,0,27
FK Rubin,1635,8,5,6,9,21,19,2,21
Rostov,1635,9,4,7,9,11,18,-7,19
Amkar,1635,10,5,4,11,12,25,-13,19
Anzhi,1635,11,2,7,11,15,38,-23,13
Loko Moscow,1636,1,11,5,4,31,15,16,38
CSKA Moscow,1636,2,11,4,5,27,18,9,37
Spart Moscow,1636,3,10,6,4,42,28,14,36
Krasnodar,1636,4,10,4,6,30,25,5,34
Zenit,1636,5,8,8,4,24,16,8,32
Terek Grozny,1636,6,9,5,6,24,24,0,32
Din Moscow,1636,7,5,7,8,17,25,-8,22
FK Rubin,1636,8,5,6,9,22,19,3,21
Rostov,1636,9,4,7,9,11,18,-7,19
Amkar,1636,10,4,4,12,12,28,-16,16
Anzhi,1636,11,2,6,12,16,40,-24,12
Loko Moscow,1637,1,12,6,2,32,13,19,42
CSKA Moscow,1637,2,11,3,6,26,19,7,36
Zenit,1637,3,8,8,4,23,14,9,32
Spart Moscow,1637,4,8,7,5,35,30,5,31
Krasnodar,1637,5,8,5,7,29,27,2,29
Terek Grozny,1637,6,7,6,7,22,26,-4,27
Din Moscow,1637,7,6,7,7,20,23,-3,25
FK Rubin,1637,8,6,5,9,23,19,4,23
Amkar,1637,9,6,4,10,15,23,-8,22
Rostov,1637,10,4,7,9,11,18,-7,19
Anzhi,1637,11,2,6,12,15,39,-24,12
Loko Moscow,1638,1,12,5,3,32,14,18,41
CSKA Moscow,1638,2,11,3,6,27,19,8,36
Zenit,1638,3,9,8,3,25,15,10,35
Spart Moscow,1638,4,9,7,4,37,28,9,34
Krasnodar,1638,5,8,5,7,28,26,2,29
Terek Grozny,1638,6,7,6,7,21,24,-3,27
Din Moscow,1638,7,5,8,7,18,22,-4,23
FK Rubin,1638,8,5,7,8,21,17,4,22
Amkar,1638,9,5,5,10,12,24,-12,20
Rostov,1638,10,4,6,10,10,18,-8,18
Anzhi,1638,11,2,6,12,15,39,-24,12
Loko Moscow,1639,1,12,6,2,32,13,19,42
CSKA Moscow,1639,2,11,4,5,29,19,10,37
Spart Moscow,1639,3,9,6,5,40,28,12,33
Krasnodar,1639,4,9,5,6,30,25,5,32
Zenit,1639,5,7,9,4,24,17,7,30
Terek Grozny,1639,6,8,6,6,22,22,0,30
FK Rubin,1639,7,6,5,9,23,19,4,23
Din Moscow,1639,8,5,6,9,17,28,-11,21
Amkar,1639,9,5,5,10,11,23,-12,20
Rostov,1639,10,4,7,9,11,18,-7,19
Anzhi,1639,11,2,5,13,14,41,-27,11
Loko Moscow,1640,1,11,6,3,30,13,17,39
CSKA Moscow,1640,2,11,3,6,27,19,8,36
Zenit,1640,3,9,8,3,24,14,10,35
Spart Moscow,1640,4,9,6,5,38,33,5,33
Krasnodar,1640,5,8,5,7,28,27,1,29
Terek Grozny,1640,6,7,6,7,22,25,-3,27
FK Rubin,1640,7,7,5,8,27,19,8,26
Din Moscow,1640,8,5,6,9,20,28,-8,21
Amkar,1640,9,5,5,10,15,23,-8,20
Rostov,1640,10,4,7,9,11,18,-7,19
Anzhi,1640,11,3,5,12,17,40,-23,14
Loko Moscow,1641,1,12,5,3,32,13,19,41
Spart Moscow,1641,2,10,5,5,39,30,9,35
CSKA Moscow,1641,3,10,5,5,30,22,8,35
Zenit,1641,4,8,9,3,25,16,9,33
Krasnodar,1641,5,8,5,7,28,27,1,29
Terek Grozny,1641,6,7,7,6,21,23,-2,28
FK Rubin,1641,7,5,7,8,23,19,4,22
Din Moscow,1641,8,5,7,8,20,25,-5,22
Rostov,1641,9,5,6,9,12,18,-6,21
Amkar,1641,10,4,5,11,10,24,-14,17
Anzhi,1641,11,2,7,11,18,41,-23,13
Loko Moscow,1642,1,11,6,3,32,17,15,39
Spart Moscow,1642,2,11,5,4,38,26,12,38
CSKA Moscow,1642,3,10,4,6,28,21,7,34
Krasnodar,1642,4,9,5,6,33,27,6,32
Zenit,1642,5,7,10,3,23,15,8,31
Terek Grozny,1642,6,7,5,8,20,27,-7,26
FK Rubin,1642,7,5,7,8,23,19,4,22
Din Moscow,1642,8,5,7,8,19,24,-5,22
Amkar,1642,9,5,4,11,10,23,-13,19
Rostov,1642,10,4,6,10,10,19,-9,18
Anzhi,1642,11,4,5,11,21,39,-18,17
Loko Moscow,1643,1,11,6,3,32,16,16,39
Zenit,1643,2,9,8,3,26,15,11,35
Spart Moscow,1643,3,10,5,5,38,28,10,35
CSKA Moscow,1643,4,10,4,6,28,21,7,34
Krasnodar,1643,5,8,6,6,29,26,3,30
Terek Grozny,1643,6,8,5,7,22,24,-2,29
Din Moscow,1643,7,6,6,8,19,24,-5,24
Amkar,1643,8,6,4,10,12,23,-11,22
FK Rubin,1643,9,5,6,9,22,19,3,21
Rostov,1643,10,4,6,10,11,19,-8,18
Anzhi,1643,11,2,6,12,17,41,-24,12
Loko Moscow,1644,1,12,5,3,31,12,19,41
CSKA Moscow,1644,2,11,4,5,26,17,9,37
Spart Moscow,1644,3,10,6,4,39,28,11,36
Zenit,1644,4,8,9,3,22,13,9,33
Krasnodar,1644,5,8,5,7,27,26,1,29
Terek Grozny,1644,6,7,5,8,21,26,-5,26
Din Moscow,1644,7,5,8,7,19,23,-4,23
FK Rubin,1644,8,5,7,8,21,17,4,22
Amkar,1644,9,5,4,11,10,23,-13,19
Rostov,1644,10,4,6,10,11,20,-9,18
Anzhi,1644,11,3,5,12,17,39,-22,14
Loko Moscow,1645,1,12,5,3,32,13,19,41
Spart Moscow,1645,2,10,6,4,38,28,10,36
CSKA Moscow,1645,3,11,3,6,28,20,8,36
Krasnodar,1645,4,10,4,6,30,25,5,34
Zenit,1645,5,8,8,4,23,16,7,32
Terek Grozny,1645,6,8,5,7,23,25,-2,29
Din Moscow,1645,7,6,6,8,20,24,-4,24
FK Rubin,1645,8,5,5,10,22,20,2,20
Amkar,1645,9,5,5,10,12,24,-12,20
Rostov,1645,10,4,6,10,11,19,-8,18
Anzhi,1645,11,2,5,13,16,41,-25,11
Loko Moscow,1646,1,13,5,2,32,12,20,44
Spart Moscow,1646,2,10,5,5,37,27,10,35
CSKA Moscow,1646,3,10,4,6,29,22,7,34
Zenit,1646,4,8,8,4,25,17,8,32
Krasnodar,1646,5,9,4,7,29,25,4,31
Terek Grozny,1646,6,8,5,7,23,26,-3,29
Din Moscow,1646,7,5,7,8,21,26,-5,22
FK Rubin,1646,8,5,6,9,25,23,2,21
Amkar,1646,9,5,4,11,12,25,-13,19
Rostov,1646,10,4,6,10,10,19,-9,18
Anzhi,1646,11,3,6,11,19,40,-21,15
Loko Moscow,1647,1,12,6,2,34,15,19,42
CSKA Moscow,1647,2,11,4,5,27,18,9,37
Krasnodar,1647,3,9,5,6,31,26,5,32
Spart Moscow,1647,4,8,7,5,35,30,5,31
Zenit,1647,5,7,8,5,23,17,6,29
Terek Grozny,1647,6,7,5,8,23,27,-4,26
Din Moscow,1647,7,6,7,7,21,22,-1,25
FK Rubin,1647,8,5,6,9,22,20,2,21
Amkar,1647,9,5,5,10,12,24,-12,20
Rostov,1647,10,4,7,9,11,18,-7,19
Anzhi,1647,11,3,6,11,18,40,-22,15
Loko Moscow,1648,1,11,6,3,29,14,15,39
CSKA Moscow,1648,2,11,3,6,26,19,7,36
Zenit,1648,3,8,9,3,23,13,10,33
Spart Moscow,1648,4,9,6,5,38,29,9,33
Krasnodar,1648,5,9,5,6,32,26,6,32
Terek Grozny,1648,6,8,6,6,22,22,0,30
Din Moscow,1648,7,6,7,7,19,22,-3,25
FK Rubin,1648,8,5,7,8,24,20,4,22
Rostov,1648,9,4,6,10,11,20,-9,18
Amkar,1648,10,4,6,10,11,24,-13,18
Anzhi,1648,11,2,5,13,14,40,-26,11
Loko Moscow,1649,1,12,5,3,31,13,18,41
CSKA Moscow,1649,2,12,3,5,28,17,11,39
Spart Moscow,1649,3,9,7,4,39,30,9,34
Krasnodar,1649,4,9,4,7,29,26,3,31
Zenit,1649,5,7,8,5,21,16,5,29
Terek Grozny,1649,6,8,5,7,23,26,-3,29
FK Rubin,1649,7,7,5,8,24,18,6,26
Din Moscow,1649,8,5,7,8,19,24,-5,22
Rostov,1649,9,4,6,10,11,19,-8,18
Amkar,1649,10,4,5,11,13,27,-14,17
Anzhi,1649,11,3,5,12,17,39,-22,14
Loko Moscow,1650,1,12,5,3,30,13,17,41
CSKA Moscow,1650,2,11,4,5,29,20,9,37
Zenit,1650,3,8,8,4,25,16,9,32
Terek Grozny,1650,4,9,5,6,28,23,5,32
Krasnodar,1650,5,9,4,7,30,25,5,31
Spart Moscow,1650,6,8,5,7,35,32,3,29
Din Moscow,1650,7,6,7,7,18,21,-3,25
FK Rubin,1650,8,5,6,9,21,20,1,21
Rostov,1650,9,5,6,9,13,18,-5,21
Amkar,1650,10,5,4,11,12,25,-13,19
Anzhi,1650,11,2,6,12,16,44,-28,12
Loko Moscow,1651,1,12,5,3,30,12,18,41
CSKA Moscow,1651,2,12,3,5,29,17,12,39
Spart Moscow,1651,3,9,6,5,37,29,8,33
Krasnodar,1651,4,9,4,7,28,25,3,31
Zenit,1651,5,7,8,5,21,16,5,29
Terek Grozny,1651,6,7,6,7,22,25,-3,27
FK Rubin,1651,7,7,5,8,23,17,6,26
Din Moscow,1651,8,5,6,9,17,23,-6,21
Amkar,1651,9,5,5,10,11,23,-12,20
Rostov,1651,10,4,7,9,12,19,-7,19
Anzhi,1651,11,3,5,12,17,41,-24,14
Loko Moscow,1652,1,12,5,3,31,14,17,41
CSKA Moscow,1652,2,11,4,5,27,18,9,37
Spart Moscow,1652,3,9,6,5,37,30,7,33
Krasnodar,1652,4,9,4,7,29,26,3,31
Zenit,1652,5,7,9,4,23,16,7,30
Terek Grozny,1652,6,7,6,7,21,24,-3,27
Din Moscow,1652,7,6,7,7,21,23,-2,25
FK Rubin,1652,8,6,6,8,24,18,6,24
Rostov,1652,9,4,6,10,12,20,-8,18
Amkar,1652,10,4,6,10,10,23,-13,18
Anzhi,1652,11,3,5,12,15,38,-23,14
Loko Moscow,1653,1,11,5,4,30,15,15,38
CSKA Moscow,1653,2,11,4,5,28,19,9,37
Krasnodar,1653,3,10,4,6,32,26,6,34
Spart Moscow,1653,4,9,6,5,39,29,10,33
Zenit,1653,5,8,9,3,23,14,9,33
Terek Grozny,1653,6,8,6,6,22,23,-1,30
Din Moscow,1653,7,6,7,7,20,23,-3,25
FK Rubin,1653,8,5,6,9,23,20,3,21
Rostov,1653,9,4,7,9,12,19,-7,19
Amkar,1653,10,4,5,11,9,25,-16,17
Anzhi,1653,11,2,5,13,16,41,-25,11
Loko Moscow,1654,1,12,6,2,32,11,21,42
CSKA Moscow,1654,2,11,4,5,27,18,9,37
Spart Moscow,1654,3,10,6,4,39,27,12,36
Krasnodar,1654,4,9,5,6,29,24,5,32
Zenit,1654,5,7,9,4,22,17,5,30
Terek Grozny,1654,6,7,6,7,21,27,-6,27
FK Rubin,1654,7,6,5,9,24,21,3,23
Din Moscow,1654,8,5,7,8,20,25,-5,22
Amkar,1654,9,5,4,11,13,23,-10,19
Rostov,1654,10,4,6,10,11,21,-10,18
Anzhi,1654,11,2,6,12,15,39,-24,12
Loko Moscow,1655,1,12,5,3,32,15,17,41
CSKA Moscow,1655,2,11,4,5,27,18,9,37
Krasnodar,1655,3,10,4,6,32,26,6,34
Spart Moscow,1655,4,9,6,5,37,30,7,33
Zenit,1655,5,7,9,4,23,16,7,30
Terek Grozny,1655,6,8,6,6,23,24,-1,30
FK Rubin,1655,7,6,5,9,25,21,4,23
Din Moscow,1655,8,5,7,8,20,25,-5,22
Amkar,1655,9,5,4,11,12,24,-12,19
Rostov,1655,10,4,6,10,11,19,-8,18
Anzhi,1655,11,2,6,12,16,40,-24,12
Loko Moscow,1656,1,12,5,3,31,12,19,41
Spart Moscow,1656,2,10,6,4,35,25,10,36
CSKA Moscow,1656,3,10,4,6,25,18,7,34
Zenit,1656,4,8,9,3,22,13,9,33
Krasnodar,1656,5,8,4,8,28,28,0,28
Terek Grozny,1656,6,7,7,6,22,24,-2,28
FK Rubin,1656,7,7,5,8,24,18,6,26
Din Moscow,1656,8,5,7,8,17,22,-5,22
Rostov,1656,9,4,6,10,10,18,-8,18
Amkar,1656,10,4,5,11,10,24,-14,17
Anzhi,1656,11,3,6,11,16,38,-22,15
Loko Moscow,1657,1,12,5,3,33,14,19,41
CSKA Moscow,1657,2,10,5,5,28,20,8,35
Zenit,1657,3,8,9,3,24,14,10,33
Spart Moscow,1657,4,9,6,5,35,27,8,33
Krasnodar,1657,5,9,4,7,30,29,1,31
Terek Grozny,1657,6,8,6,6,23,24,-1,30
Din Moscow,1657,7,6,6,8,19,22,-3,24
FK Rubin,1657,8,5,5,10,22,21,1,20
Amkar,1657,9,5,5,10,12,24,-12,20
Rostov,1657,10,4,7,9,10,17,-7,19
Anzhi,1657,11,2,6,12,17,41,-24,12
Loko Moscow,1658,1,12,5,3,33,15,18,41
CSKA Moscow,1658,2,12,3,5,31,18,13,39
Spart Moscow,1658,3,10,5,5,36,26,10,35
Krasnodar,1658,4,9,4,7,30,28,2,31
Terek Grozny,1658,5,8,6,6,21,22,-1,30
Zenit,1658,6,7,8,5,24,19,5,29
Din Moscow,1658,7,6,6,8,19,22,-3,24
FK Rubin,1658,8,6,5,9,24,20,4,23
Amkar,1658,9,5,5,10,10,22,-12,20
Rostov,1658,10,4,6,10,10,19,-9,18
Anzhi,1658,11,2,5,13,14,41,-27,11
Loko Moscow,1659,1,13,5,2,33,12,21,44
Spart Moscow,1659,2,11,5,4,39,26,13,38
CSKA Moscow,1659,3,11,4,5,30,20,10,37
Zenit,1659,4,7,8,5,22,17,5,29
Krasnodar,1659,5,8,5,7,30,29,1,29
Terek Grozny,1659,6,7,5,8,22,29,-7,26
Din Moscow,1659,7,6,6,8,20,24,-4,24
FK Rubin,1659,8,5,6,9,24,23,1,21
Amkar,1659,9,5,4,11,14,25,-11,19
Rostov,1659,10,4,6,10,10,18,-8,18
Anzhi,1659,11,3,6,11,20,41,-21,15
Loko Moscow,1660,1,12,5,3,30,12,18,41
Spart Moscow,1660,2,10,5,5,38,29,9,35
Krasnodar,1660,3,10,4,6,30,25,5,34
CSKA Moscow,1660,4,10,3,7,26,21,5,33
Zenit,1660,5,8,8,4,24,15,9,32
Terek Grozny,1660,6,7,6,7,21,25,-4,27
Din Moscow,1660,7,6,6,8,20,23,-3,24
Rostov,1660,8,5,6,9,11,17,-6,21
FK Rubin,1660,9,5,5,10,22,21,1,20
Amkar,1660,10,4,5,11,11,25,-14,17
Anzhi,1660,11,4,5,11,18,38,-20,17
Loko Moscow,1661,1,13,5,2,33,12,21,44
CSKA Moscow,1661,2,11,3,6,29,21,8,36
Spart Moscow,1661,3,9,6,5,35,29,6,33
Zenit,1661,4,8,8,4,24,15,9,32
Terek Grozny,1661,5,9,5,6,24,23,1,32
Krasnodar,1661,6,8,5,7,31,30,1,29
FK Rubin,1661,7,6,6,8,25,20,5,24
Din Moscow,1661,8,6,6,8,21,22,-1,24
Rostov,1661,9,4,7,9,10,17,-7,19
Amkar,1661,10,4,4,12,9,26,-17,16
Anzhi,1661,11,2,5,13,16,42,-26,11
Loko Moscow,1662,1,12,5,3,31,13,18,41
CSKA Moscow,1662,2,11,3,6,27,20,7,36
Krasnodar,1662,3,10,4,6,30,24,6,34
Spart Moscow,1662,4,9,6,5,35,27,8,33
Zenit,1662,5,8,8,4,24,15,9,32
Terek Grozny,1662,6,8,6,6,23,23,0,30
Din Moscow,1662,7,6,7,7,21,24,-3,25
FK Rubin,1662,8,5,6,9,23,21,2,21
Rostov,1662,9,4,6,10,10,18,-8,18
Amkar,1662,10,4,5,11,10,25,-15,17
Anzhi,1662,11,2,6,12,15,39,-24,12
Loko Moscow,1663,1,12,5,3,31,12,19,41
CSKA Moscow,1663,2,11,4,5,28,19,9,37
Spart Moscow,1663,3,10,6,4,39,27,12,36
Krasnodar,1663,4,10,4,6,30,25,5,34
Zenit,1663,5,7,9,4,22,16,6,30
Terek Grozny,1663,6,8,5,7,22,25,-3,29
Din Moscow,1663,7,6,6,8,20,24,-4,24
FK Rubin,1663,8,5,5,10,23,21,2,20
Rostov,1663,9,4,6,10,10,20,-10,18
Amkar,1663,10,4,5,11,10,24,-14,17
Anzhi,1663,11,3,5,12,18,40,-22,14
Loko Moscow,1664,1,11,7,2,31,13,18,40
Spart Moscow,1664,2,11,5,4,39,26,13,38
CSKA Moscow,1664,3,11,3,6,27,19,8,36
Krasnodar,1664,4,9,5,6,32,26,6,32
Zenit,1664,5,7,9,4,23,16,7,30
Terek Grozny,1664,6,7,6,7,22,26,-4,27
FK Rubin,1664,7,6,5,9,24,21,3,23
Din Moscow,1664,8,5,6,9,17,25,-8,21
Amkar,1664,9,5,4,11,11,23,-12,19
Rostov,1664,10,4,6,10,11,20,-9,18
Anzhi,1664,11,3,6,11,17,39,-22,15
Loko Moscow,1665,1,12,5,3,31,12,19,41
CSKA Moscow,1665,2,11,4,5,31,19,12,37
Spart Moscow,1665,3,10,6,4,42,28,14,36
Krasnodar,1665,4,9,5,6,29,25,4,32
Zenit,1665,5,7,9,4,22,16,6,30
Terek Grozny,1665,6,7,5,8,20,27,-7,26
FK Rubin,1665,7,6,6,8,24,19,5,24
Din Moscow,1665,8,5,6,9,19,26,-7,21
Amkar,1665,9,5,5,10,12,23,-11,20
Rostov,1665,10,4,6,10,11,22,-11,18
Anzhi,1665,11,3,5,12,18,42,-24,14
Loko Moscow,1666,1,12,6,2,34,14,20,42
CSKA Moscow,1666,2,11,3,6,26,20,6,36
Spart Moscow,1666,3,9,7,4,39,30,9,34
Krasnodar,1666,4,9,5,6,35,26,9,32
Zenit,1666,5,8,8,4,25,16,9,32
Terek Grozny,1666,6,8,6,6,24,23,1,30
FK Rubin,1666,7,6,5,9,22,23,-1,23
Din Moscow,1666,8,5,6,9,17,23,-6,21
Rostov,1666,9,4,7,9,13,20,-7,19
Amkar,1666,10,4,6,10,12,25,-13,18
Anzhi,1666,11,2,5,13,14,41,-27,11
Loko Moscow,1667,1,11,6,3,29,12,17,39
CSKA Moscow,1667,2,10,5,5,29,21,8,35
Spart Moscow,1667,3,9,6,5,37,29,8,33
Zenit,1667,4,7,10,3,22,14,8,31
Krasnodar,1667,5,9,4,7,28,25,3,31
Terek Grozny,1667,6,8,5,7,23,24,-1,29
FK Rubin,1667,7,7,5,8,25,17,8,26
Amkar,1667,8,6,4,10,14,24,-10,22
Din Moscow,1667,9,5,6,9,17,26,-9,21
Rostov,1667,10,4,7,9,10,17,-7,19
Anzhi,1667,11,2,6,12,18,43,-25,12
Loko Moscow,1668,1,11,7,2,33,15,18,40
CSKA Moscow,1668,2,11,4,5,28,19,9,37
Spart Moscow,1668,3,9,6,5,34,27,7,33
Zenit,1668,4,7,10,3,25,17,8,31
Krasnodar,1668,5,8,5,7,28,27,1,29
Terek Grozny,1668,6,7,5,8,20,24,-4,26
FK Rubin,1668,7,6,6,8,24,18,6,24
Din Moscow,1668,8,5,8,7,18,22,-4,23
Rostov,1668,9,5,6,9,12,17,-5,21
Amkar,1668,10,5,4,11,10,23,-13,19
Anzhi,1668,11,3,5,12,16,39,-23,14
CSKA Moscow,1669,1,12,3,5,29,19,10,39
Loko Moscow,1669,2,11,5,4,29,14,15,38
Spart Moscow,1669,3,11,5,4,41,27,14,38
Krasnodar,1669,4,10,4,6,30,24,6,34
Zenit,1669,5,8,8,4,23,15,8,32
Terek Grozny,1669,6,7,6,7,21,25,-4,27
Din Moscow,1669,7,6,6,8,20,24,-4,24
FK Rubin,1669,8,5,5,10,22,21,1,20
Rostov,1669,9,4,6,10,11,21,-10,18
Amkar,1669,10,4,5,11,11,25,-14,17
Anzhi,1669,11,3,5,12,17,39,-22,14
Loko Moscow,1670,1,13,5,2,32,12,20,44
CSKA Moscow,1670,2,11,3,6,28,20,8,36
Spart Moscow,1670,3,9,6,5,37,26,11,33
Zenit,1670,4,8,8,4,25,16,9,32
Terek Grozny,1670,5,9,5,6,26,22,4,32
Krasnodar,1670,6,9,4,7,29,25,4,31
Din Moscow,1670,7,6,6,8,18,25,-7,24
FK Rubin,1670,8,5,5,10,21,20,1,20
Rostov,1670,9,4,7,9,10,17,-7,19
Amkar,1670,10,5,4,11,10,27,-17,19
Anzhi,1670,11,2,5,13,14,40,-26,11
Loko Moscow,1671,1,11,6,3,30,14,16,39
CSKA Moscow,1671,2,12,3,5,30,20,10,39
Spart Moscow,1671,3,10,6,4,39,26,13,36
Krasnodar,1671,4,10,4,6,31,25,6,34
Zenit,1671,5,7,9,4,23,16,7,30
Terek Grozny,1671,6,8,5,7,23,29,-6,29
Din Moscow,1671,7,5,8,7,18,22,-4,23
FK Rubin,1671,8,5,6,9,22,19,3,21
Rostov,1671,9,4,6,10,10,21,-11,18
Amkar,1671,10,4,4,12,9,26,-17,16
Anzhi,1671,11,3,5,12,23,40,-17,14
Loko Moscow,1672,1,11,6,3,32,16,16,39
CSKA Moscow,1672,2,11,4,5,28,18,10,37
Spart Moscow,1672,3,10,6,4,36,26,10,36
Krasnodar,1672,4,9,5,6,32,27,5,32
Zenit,1672,5,7,10,3,24,16,8,31
Terek Grozny,1672,6,8,5,7,23,27,-4,29
Din Moscow,1672,7,6,7,7,19,22,-3,25
FK Rubin,1672,8,5,6,9,23,20,3,21
Amkar,1672,9,5,4,11,12,23,-11,19
Rostov,1672,10,4,6,10,10,18,-8,18
Anzhi,1672,11,2,5,13,16,42,-26,11
Loko Moscow,1673,1,12,5,3,31,14,17,41
CSKA Moscow,1673,2,11,4,5,28,18,10,37
Spart Moscow,1673,3,9,6,5,37,29,8,33
Zenit,1673,4,8,8,4,24,16,8,32
Krasnodar,1673,5,8,5,7,30,28,2,29
Terek Grozny,1673,6,8,5,7,22,24,-2,29
Din Moscow,1673,7,7,6,7,21,22,-1,27
FK Rubin,1673,8,5,6,9,23,21,2,21
Rostov,1673,9,4,7,9,11,18,-7,19
Amkar,1673,10,5,4,11,11,24,-13,19
Anzhi,1673,11,2,6,12,15,39,-24,12
Loko Moscow,1674,1,11,7,2,30,12,18,40
Spart Moscow,1674,2,11,5,4,40,27,13,38
CSKA Moscow,1674,3,11,4,5,28,19,9,37
Zenit,1674,4,7,9,4,22,15,7,30
Krasnodar,1674,5,8,6,6,29,26,3,30
Terek Grozny,1674,6,8,5,7,23,25,-2,29
FK Rubin,1674,7,5,7,8,24,20,4,22
Din Moscow,1674,8,5,7,8,19,24,-5,22
Amkar,1674,9,5,4,11,13,25,-12,19
Rostov,1674,10,4,6,10,10,20,-10,18
Anzhi,1674,11,2,6,12,16,41,-25,12
Loko Moscow,1675,1,12,6,2,33,12,21,42
CSKA Moscow,1675,2,11,3,6,29,19,10,36
Spart Moscow,1675,3,10,5,5,40,29,11,35
Krasnodar,1675,4,8,5,7,29,27,2,29
Zenit,1675,5,7,8,5,21,19,2,29
Terek Grozny,1675,6,7,7,6,20,22,-2,28
FK Rubin,1675,7,6,6,8,24,19,5,24
Din Moscow,1675,8,5,7,8,19,26,-7,22
Amkar,1675,9,5,5,10,12,24,-12,20
Rostov,1675,10,4,6,10,10,18,-8,18
Anzhi,1675,11,3,6,11,16,38,-22,15
Loko Moscow,1676,1,13,5,2,36,13,23,44
CSKA Moscow,1676,2,11,4,5,28,19,9,37
Spart Moscow,1676,3,9,6,5,37,28,9,33
Zenit,1676,4,7,9,4,22,16,6,30
Krasnodar,1676,5,8,5,7,29,29,0,29
Terek Grozny,1676,6,8,5,7,24,27,-3,29
FK Rubin,1676,7,6,6,8,23,18,5,24
Din Moscow,1676,8,6,6,8,19,23,-4,24
Rostov,1676,9,4,7,9,10,17,-7,19
Amkar,1676,10,5,4,11,13,26,-13,19
Anzhi,1676,11,2,5,13,18,43,-25,11
Loko Moscow,1677,1,12,6,2,31,12,19,42
CSKA Moscow,1677,2,11,4,5,29,18,11,37
Spart Moscow,1677,3,9,7,4,39,29,10,34
Zenit,1677,4,7,10,3,22,14,8,31
Krasnodar,1677,5,9,4,7,32,26,6,31
Terek Grozny,1677,6,8,5,7,21,24,-3,29
Din Moscow,1677,7,6,6,8,21,25,-4,24
FK Rubin,1677,8,5,5,10,22,24,-2,20
Amkar,1677,9,5,5,10,13,24,-11,20
Rostov,1677,10,4,7,9,11,18,-7,19
Anzhi,1677,11,2,5,13,14,41,-27,11
Loko Moscow,1678,1,11,7,2,32,14,18,40
CSKA Moscow,1678,2,11,4,5,31,21,10,37
Spart Moscow,1678,3,10,6,4,42,29,13,36
Terek Grozny,1678,4,9,5,6,25,23,2,32
Zenit,1678,5,7,10,3,26,18,8,31
Krasnodar,1678,6,8,5,7,29,27,2,29
Din Moscow,1678,7,6,6,8,21,24,-3,24
FK Rubin,1678,8,6,5,9,23,21,2,23
Rostov,1678,9,4,6,10,11,21,-10,18
Amkar,1678,10,4,5,11,12,27,-15,17
Anzhi,1678,11,2,5,13,15,42,-27,11
Loko Moscow,1679,1,13,5,2,35,14,21,44
Spart Moscow,1679,2,11,5,4,40,28,12,38
CSKA Moscow,1679,3,11,4,5,28,18,10,37
Krasnodar,1679,4,9,4,7,34,30,4,31
Terek Grozny,1679,5,8,6,6,21,22,-1,30
Zenit,1679,6,7,8,5,21,17,4,29
FK Rubin,1679,7,6,5,9,24,21,3,23
Din Moscow,1679,8,5,6,9,17,24,-7,21
Rostov,1679,9,4,6,10,10,18,-8,18
Amkar,1679,10,4,5,11,12,26,-14,17
Anzhi,1679,11,2,6,12,15,39,-24,12
Loko Moscow,1680,1,12,6,2,34,13,21,42
CSKA Moscow,1680,2,11,4,5,28,19,9,37
Spart Moscow,1680,3,10,5,5,39,28,11,35
Zenit,1680,4,7,9,4,22,17,5,30
Krasnodar,1680,5,8,6,6,30,27,3,30
Terek Grozny,1680,6,8,6,6,23,24,-1,30
Din Moscow,1680,7,6,6,8,18,24,-6,24
FK Rubin,1680,8,5,6,9,22,19,3,21
Amkar,1680,9,5,4,11,11,24,-13,19
Rostov,1680,10,4,6,10,12,20,-8,18
Anzhi,1680,11,2,6,12,16,40,-24,12
Loko Moscow,1681,1,12,5,3,32,15,17,41
CSKA Moscow,1681,2,12,3,5,31,18,13,39
Spart Moscow,1681,3,10,5,5,36,27,9,35
Zenit,1681,4,8,8,4,24,15,9,32
Krasnodar,1681,5,8,4,8,30,30,0,28
Terek Grozny,1681,6,7,7,6,21,23,-2,28
Din Moscow,1681,7,6,7,7,18,21,-3,25
FK Rubin,1681,8,6,6,8,24,18,6,24
Rostov,1681,9,4,6,10,11,19,-8,18
Amkar,1681,10,4,5,11,10,24,-14,17
Anzhi,1681,11,2,6,12,14,41,-27,12
Loko Moscow,1682,1,11,6,3,32,15,17,39
CSKA Moscow,1682,2,10,4,6,25,18,7,34
Krasnodar,1682,3,10,4,6,31,26,5,34
Zenit,1682,4,8,9,3,24,15,9,33
Spart Moscow,1682,5,8,6,6,36,31,5,30
Terek Grozny,1682,6,7,7,6,21,23,-2,28
Din Moscow,1682,7,6,7,7,18,21,-3,25
FK Rubin,1682,8,5,6,9,22,19,3,21
Rostov,1682,9,5,6,9,14,19,-5,21
Amkar,1682,10,4,6,10,11,24,-13,18
Anzhi,1682,11,2,7,11,14,37,-23,13
Loko Moscow,1683,1,12,5,3,30,13,17,41
Spart Moscow,1683,2,10,6,4,40,29,11,36
CSKA Moscow,1683,3,10,4,6,26,19,7,34
Zenit,1683,4,8,8,4,22,14,8,32
Krasnodar,1683,5,9,5,6,31,26,5,32
Terek Grozny,1683,6,7,5,8,21,26,-5,26
FK Rubin,1683,7,6,6,8,25,19,6,24
Din Moscow,1683,8,5,6,9,17,25,-8,21
Rostov,1683,9,4,7,9,12,19,-7,19
Amkar,1683,10,5,4,11,13,25,-12,19
Anzhi,1683,11,3,6,11,17,39,-22,15
Loko Moscow,1684,1,12,6,2,32,11,21,42
Spart Moscow,1684,2,11,5,4,38,27,11,38
Zenit,1684,3,8,9,3,22,13,9,33
CSKA Moscow,1684,4,10,3,7,25,19,6,33
Krasnodar,1684,5,8,4,8,28,29,-1,28
Terek Grozny,1684,6,7,7,6,21,23,-2,28
FK Rubin,1684,7,6,6,8,24,19,5,24
Din Moscow,1684,8,5,7,8,18,23,-5,22
Rostov,1684,9,4,6,10,11,19,-8,18
Amkar,1684,10,4,5,11,10,24,-14,17
Anzhi,1684,11,3,6,11,16,38,-22,15
Loko Moscow,1685,1,12,5,3,31,13,18,41
CSKA Moscow,1685,2,11,3,6,28,19,9,36
Zenit,1685,3,9,8,3,24,14,10,35
Spart Moscow,1685,4,9,6,5,38,30,8,33
Krasnodar,1685,5,9,4,7,29,26,3,31
Din Moscow,1685,6,7,6,7,24,22,2,27
Terek Grozny,1685,7,7,6,7,22,25,-3,27
FK Rubin,1685,8,5,5,10,21,23,-2,20
Rostov,1685,9,4,7,9,11,18,-7,19
Amkar,1685,10,5,4,11,13,26,-13,19
Anzhi,1685,11,2,6,12,15,40,-25,12
Loko Moscow,1686,1,12,5,3,30,13,17,41
Spart Moscow,1686,2,11,5,4,40,27,13,38
CSKA Moscow,1686,3,11,3,6,27,18,9,36
Krasnodar,1686,4,10,4,6,30,24,6,34
Zenit,1686,5,8,8,4,22,14,8,32
Terek Grozny,1686,6,8,6,6,21,22,-1,30
FK Rubin,1686,7,6,5,9,22,18,4,23
Din Moscow,1686,8,5,6,9,17,24,-7,21
Rostov,1686,9,4,6,10,11,19,-8,18
Amkar,1686,10,4,4,12,10,26,-16,16
Anzhi,1686,11,2,6,12,14,39,-25,12
Loko Moscow,1687,1,13,5,2,31,11,20,44
CSKA Moscow,1687,2,11,4,5,29,18,11,37
Spart Moscow,1687,3,10,5,5,37,29,8,35
Terek Grozny,1687,4,9,5,6,24,22,2,32
Zenit,1687,5,7,9,4,21,14,7,30
Krasnodar,1687,6,8,4,8,29,28,1,28
Din Moscow,1687,7,6,6,8,19,22,-3,24
FK Rubin,1687,8,6,5,9,24,21,3,23
Rostov,1687,9,5,6,9,13,18,-5,21
Amkar,1687,10,4,4,12,10,26,-16,16
Anzhi,1687,11,2,5,13,15,43,-28,11
Loko Moscow,1688,1,12,5,3,32,13,19,41
CSKA Moscow,1688,2,10,3,7,25,21,4,33
Spart Moscow,1688,3,9,5,6,39,30,9,32
Zenit,1688,4,8,8,4,22,16,6,32
Krasnodar,1688,5,9,4,7,30,27,3,31
Terek Grozny,1688,6,8,6,6,23,24,-1,30
FK Rubin,1688,7,7,5,8,27,18,9,26
Din Moscow,1688,8,6,6,8,20,26,-6,24
Amkar,1688,9,5,5,10,12,23,-11,20
Rostov,1688,10,4,6,10,10,21,-11,18
Anzhi,1688,11,3,5,12,18,39,-21,14
Loko Moscow,1689,1,13,5,2,35,12,23,44
CSKA Moscow,1689,2,12,3,5,29,18,11,39
Spart Moscow,1689,3,10,6,4,41,27,14,36
Zenit,1689,4,7,8,5,22,17,5,29
Krasnodar,1689,5,8,4,8,28,29,-1,28
Terek Grozny,1689,6,7,7,6,21,23,-2,28
FK Rubin,1689,7,7,5,8,26,19,7,26
Din Moscow,1689,8,5,7,8,20,26,-6,22
Rostov,1689,9,4,6,10,10,21,-11,18
Amkar,1689,10,4,5,11,10,25,-15,17
Anzhi,1689,11,2,6,12,15,40,-25,12
Loko Moscow,1690,1,11,6,3,32,16,16,39
CSKA Moscow,1690,2,12,3,5,31,18,13,39
Spart Moscow,1690,3,9,7,4,39,30,9,34
Krasnodar,1690,4,10,4,6,33,26,7,34
Zenit,1690,5,7,9,4,22,15,7,30
Terek Grozny,1690,6,8,5,7,22,25,-3,29
Din Moscow,1690,7,6,6,8,20,24,-4,24
FK Rubin,1690,8,5,5,10,21,20,1,20
Amkar,1690,9,5,5,10,12,23,-11,20
Rostov,1690,10,4,7,9,12,19,-7,19
Anzhi,1690,11,2,5,13,16,44,-28,11
Loko Moscow,1691,1,11,5,4,31,15,16,38
Spart Moscow,1691,2,11,5,4,38,26,12,38
CSKA Moscow,1691,3,11,4,5,30,17,13,37
Zenit,1691,4,8,9,3,22,13,9,33
Krasnodar,1691,5,9,4,7,30,27,3,31
Terek Grozny,1691,6,8,5,7,21,23,-2,29
Din Moscow,1691,7,6,6,8,20,22,-2,24
FK Rubin,1691,8,6,5,9,22,20,2,23
Rostov,1691,9,4,6,10,10,18,-8,18
Amkar,1691,10,4,4,12,10,26,-16,16
Anzhi,1691,11,3,5,12,15,42,-27,14
Loko Moscow,1692,1,12,5,3,34,16,18,41
CSKA Moscow,1692,2,12,3,5,29,19,10,39
Spart Moscow,1692,3,9,7,4,39,28,11,34
Krasnodar,1692,4,10,4,6,34,26,8,34
Zenit,1692,5,7,8,5,23,18,5,29
Terek Grozny,1692,6,7,6,7,20,23,-3,27
Din Moscow,1692,7,6,6,8,20,25,-5,24
FK Rubin,1692,8,5,5,10,21,22,-1,20
Rostov,1692,9,4,7,9,11,18,-7,19
Amkar,1692,10,4,6,10,10,23,-13,18
Anzhi,1692,11,3,5,12,16,39,-23,14
Loko Moscow,1693,1,12,5,3,30,12,18,41
CSKA Moscow,1693,2,12,3,5,31,18,13,39
Spart Moscow,1693,3,11,5,4,39,26,13,38
Zenit,1693,4,8,8,4,23,15,8,32
Terek Grozny,1693,5,8,5,7,21,23,-2,29
Krasnodar,1693,6,8,4,8,27,28,-1,28
Din Moscow,1693,7,6,6,8,18,24,-6,24
FK Rubin,1693,8,6,5,9,24,18,6,23
Rostov,1693,9,4,6,10,11,19,-8,18
Amkar,1693,10,4,4,12,9,24,-15,16
Anzhi,1693,11,3,5,12,15,41,-26,14
Loko Moscow,1694,1,13,5,2,33,13,20,44
CSKA Moscow,1694,2,10,5,5,27,19,8,35
Terek Grozny,1694,3,9,5,6,22,22,0,32
Krasnodar,1694,4,9,4,7,30,27,3,31
Zenit,1694,5,7,9,4,23,16,7,30
Spart Moscow,1694,6,8,6,6,37,32,5,30
Din Moscow,1694,7,6,6,8,20,24,-4,24
FK Rubin,1694,8,6,5,9,22,18,4,23
Rostov,1694,9,4,7,9,11,18,-7,19
Amkar,1694,10,5,4,11,12,24,-12,19
Anzhi,1694,11,2,6,12,14,38,-24,12
Loko Moscow,1695,1,11,6,3,31,14,17,39
CSKA Moscow,1695,2,11,4,5,31,19,12,37
Spart Moscow,1695,3,10,6,4,40,28,12,36
Zenit,1695,4,8,9,3,23,14,9,33
Krasnodar,1695,5,8,5,7,29,29,0,29
Terek Grozny,1695,6,7,7,6,20,22,-2,28
FK Rubin,1695,7,7,5,8,27,17,10,26
Din Moscow,1695,8,5,6,9,18,27,-9,21
Rostov,1695,9,4,6,10,10,19,-9,18
Amkar,1695,10,4,6,10,11,24,-13,18
Anzhi,1695,11,2,6,12,15,42,-27,12
Loko Moscow,1696,1,12,5,3,34,12,22,41
Spart Moscow,1696,2,10,6,4,39,26,13,36
CSKA Moscow,1696,3,11,3,6,28,18,10,36
Zenit,1696,4,9,8,3,23,13,10,35
Krasnodar,1696,5,9,4,7,29,29,0,31
Terek Grozny,1696,6,7,6,7,20,24,-4,27
Din Moscow,1696,7,5,7,8,20,27,-7,22
FK Rubin,1696,8,5,6,9,23,21,2,21
Rostov,1696,9,4,6,10,10,19,-9,18
Amkar,1696,10,4,6,10,9,22,-13,18
Anzhi,1696,11,3,5,12,16,40,-24,14
Loko Moscow,1697,1,12,6,2,32,13,19,42
Spart Moscow,1697,2,10,6,4,36,25,11,36
CSKA Moscow,1697,3,11,3,6,29,20,9,36
Zenit,1697,4,8,8,4,24,14,10,32
Krasnodar,1697,5,9,5,6,31,27,4,32
Terek Grozny,1697,6,7,7,6,21,23,-2,28
Din Moscow,1697,7,6,6,8,19,23,-4,24
FK Rubin,1697,8,5,5,10,23,21,2,20
Rostov,1697,9,4,6,10,10,19,-9,18
Amkar,1697,10,4,6,10,10,23,-13,18
Anzhi,1697,11,2,6,12,14,41,-27,12
Loko Moscow,1698,1,12,6,2,30,11,19,42
CSKA Moscow,1698,2,11,3,6,29,18,11,36
Spart Moscow,1698,3,10,5,5,40,27,13,35
Zenit,1698,4,8,8,4,22,14,8,32
Krasnodar,1698,5,9,5,6,28,24,4,32
Terek Grozny,1698,6,8,6,6,21,22,-1,30
FK Rubin,1698,7,6,5,9,23,19,4,23
Din Moscow,1698,8,5,6,9,19,25,-6,21
Rostov,1698,9,5,6,9,11,17,-6,21
Amkar,1698,10,4,4,12,9,28,-19,16
Anzhi,1698,11,2,6,12,14,41,-27,12
Loko Moscow,1699,1,12,6,2,32,13,19,42
CSKA Moscow,1699,2,11,4,5,27,18,9,37
Krasnodar,1699,3,9,5,6,30,25,5,32
Zenit,1699,4,7,9,4,23,16,7,30
Spart Moscow,1699,5,8,5,7,36,32,4,29
Terek Grozny,1699,6,7,6,7,23,26,-3,27
Din Moscow,1699,7,6,6,8,21,25,-4,24
FK Rubin,1699,8,6,5,9,23,20,3,23
Amkar,1699,9,6,4,10,13,24,-11,22
Rostov,1699,10,5,6,9,13,18,-5,21
Anzhi,1699,11,2,6,12,15,39,-24,12
Loko Moscow,1700,1,12,5,3,31,13,18,41
CSKA Moscow,1700,2,11,3,6,30,20,10,36
Krasnodar,1700,3,10,4,6,31,25,6,34
Zenit,1700,4,8,8,4,23,15,8,32
Spart Moscow,1700,5,9,5,6,35,29,6,32
Terek Grozny,1700,6,8,5,7,22,23,-1,29
Din Moscow,1700,7,6,6,8,18,22,-4,24
FK Rubin,1700,8,6,5,9,22,19,3,23
Amkar,1700,9,5,4,11,12,25,-13,19
Rostov,1700,10,4,6,10,10,18,-8,18
Anzhi,1700,11,3,5,12,16,41,-25,14
Loko Moscow,1701,1,13,5,2,32,11,21,44
CSKA Moscow,1701,2,11,3,6,29,21,8,36
Spart Moscow,1701,3,9,6,5,40,31,9,33
Zenit,1701,4,8,8,4,24,16,8,32
Terek Grozny,1701,5,9,5,6,26,24,2,32
Krasnodar,1701,6,8,4,8,28,28,0,28
FK Rubin,1701,7,7,5,8,28,20,8,26
Din Moscow,1701,8,6,6,8,21,26,-5,24
Rostov,1701,9,4,6,10,11,20,-9,18
Amkar,1701,10,4,5,11,13,28,-15,17
Anzhi,1701,11,2,5,13,16,43,-27,11
Loko Moscow,1702,1,12,5,3,31,12,19,41
CSKA Moscow,1702,2,11,4,5,30,18,12,37
Spart Moscow,1702,3,10,5,5,40,31,9,35
Krasnodar,1702,4,10,4,6,29,24,5,34
Zenit,1702,5,7,9,4,22,16,6,30
Terek Grozny,1702,6,8,5,7,22,24,-2,29
Din Moscow,1702,7,5,7,8,20,26,-6,22
Amkar,1702,8,6,4,10,14,24,-10,22
FK Rubin,1702,9,5,6,9,22,19,3,21
Rostov,1702,10,4,6,10,11,19,-8,18
Anzhi,1702,11,2,5,13,14,42,-28,11
Loko Moscow,1703,1,12,5,3,31,15,16,41
Spart Moscow,1703,2,10,5,5,38,28,10,35
CSKA Moscow,1703,3,10,5,5,27,19,8,35
Krasnodar,1703,4,9,5,6,32,25,7,32
Terek Grozny,1703,5,9,5,6,23,22,1,32
Zenit,1703,6,7,9,4,22,16,6,30
Din Moscow,1703,7,6,6,8,18,23,-5,24
FK Rubin,1703,8,5,6,9,22,19,3,21
Amkar,1703,9,5,4,11,12,26,-14,19
Rostov,1703,10,4,6,10,10,18,-8,18
Anzhi,1703,11,2,6,12,15,39,-24,12
Loko Moscow,1704,1,12,5,3,32,12,20,41
CSKA Moscow,1704,2,11,4,5,32,20,12,37
Zenit,1704,3,8,9,3,25,16,9,33
Spart Moscow,1704,4,9,6,5,35,30,5,33
Krasnodar,1704,5,9,4,7,29,27,2,31
Terek Grozny,1704,6,8,5,7,23,25,-2,29
Din Moscow,1704,7,5,8,7,17,21,-4,23
Amkar,1704,8,6,4,10,14,22,-8,22
FK Rubin,1704,9,5,6,9,21,19,2,21
Rostov,1704,10,4,6,10,11,19,-8,18
Anzhi,1704,11,2,5,13,16,44,-28,11
Loko Moscow,1705,1,12,6,2,31,12,19,42
CSKA Moscow,1705,2,11,4,5,26,17,9,37
Krasnodar,1705,3,9,5,6,34,26,8,32
Zenit,1705,4,7,9,4,21,14,7,30
Spart Moscow,1705,5,8,6,6,34,29,5,30
Terek Grozny,1705,6,8,5,7,21,23,-2,29
Din Moscow,1705,7,6,7,7,20,23,-3,25
FK Rubin,1705,8,5,6,9,23,24,-1,21
Rostov,1705,9,4,7,9,10,17,-7,19
Amkar,1705,10,5,4,11,11,23,-12,19
Anzhi,1705,11,3,5,12,15,38,-23,14
Loko Moscow,1706,1,11,6,3,31,14,17,39
Spart Moscow,1706,2,10,6,4,38,27,11,36
CSKA Moscow,1706,3,10,5,5,30,22,8,35
Zenit,1706,4,7,10,3,24,16,8,31
Krasnodar,1706,5,9,4,7,31,29,2,31
Terek Grozny,1706,6,7,7,6,21,23,-2,28
Din Moscow,1706,7,6,6,8,19,23,-4,24
FK Rubin,1706,8,6,5,9,26,21,5,23
Rostov,1706,9,4,7,9,12,19,-7,19
Amkar,1706,10,4,5,11,9,24,-15,17
Anzhi,1706,11,2,7,11,18,41,-23,13
Loko Moscow,1707,1,11,5,4,29,17,12,38
CSKA Moscow,1707,2,11,3,6,27,18,9,36
Zenit,1707,3,9,8,3,25,13,12,35
Spart Moscow,1707,4,10,5,5,40,30,10,35
Krasnodar,1707,5,10,4,6,32,25,7,34
Terek Grozny,1707,6,9,5,6,24,24,0,32
Din Moscow,1707,7,6,6,8,21,26,-5,24
Rostov,1707,8,5,6,9,13,17,-4,21
FK Rubin,1707,9,5,5,10,22,21,1,20
Amkar,1707,10,4,4,12,9,25,-16,16
Anzhi,1707,11,2,5,13,16,42,-26,11
Loko Moscow,1708,1,11,5,4,31,15,16,38
CSKA Moscow,1708,2,11,3,6,26,18,8,36
Zenit,1708,3,9,8,3,24,14,10,35
Krasnodar,1708,4,10,4,6,31,25,6,34
Spart Moscow,1708,5,9,6,5,36,27,9,33
Terek Grozny,1708,6,7,5,8,20,25,-5,26
Din Moscow,1708,7,5,7,8,18,24,-6,22
FK Rubin,1708,8,5,6,9,22,20,2,21
Rostov,1708,9,5,6,9,11,17,-6,21
Amkar,1708,10,5,5,10,11,23,-12,20
Anzhi,1708,11,3,5,12,16,38,-22,14
Loko Moscow,1709,1,12,6,2,31,12,19,42
CSKA Moscow,1709,2,11,4,5,26,17,9,37
Spart Moscow,1709,3,10,6,4,35,25,10,36
Zenit,1709,4,7,10,3,21,13,8,31
Krasnodar,1709,5,9,4,7,29,26,3,31
Terek Grozny,1709,6,7,5,8,21,26,-5,26
Din Moscow,1709,7,6,6,8,20,22,-2,24
FK Rubin,1709,8,5,5,10,21,21,0,20
Amkar,1709,9,5,5,10,11,22,-11,20
Rostov,1709,10,4,6,10,10,18,-8,18
Anzhi,1709,11,3,5,12,16,39,-23,14
Loko Moscow,1710,1,11,6,3,29,15,14,39
CSKA Moscow,1710,2,11,4,5,28,18,10,37
Spart Moscow,1710,3,10,5,5,38,30,8,35
Krasnodar,1710,4,9,5,6,32,25,7,32
Zenit,1710,5,7,10,3,21,13,8,31
Terek Grozny,1710,6,8,5,7,21,23,-2,29
Din Moscow,1710,7,6,6,8,20,25,-5,24
Amkar,1710,8,6,4,10,13,22,-9,22
FK Rubin,1710,9,5,6,9,23,20,3,21
Rostov,1710,10,4,6,10,11,19,-8,18
Anzhi,1710,11,2,5,13,15,41,-26,11
CSKA Moscow,1711,1,12,3,5,29,18,11,39
Loko Moscow,1711,2,11,5,4,31,18,13,38
Spart Moscow,1711,3,10,6,4,37,26,11,36
Krasnodar,1711,4,10,4,6,34,27,7,34
Zenit,1711,5,8,8,4,23,14,9,32
Terek Grozny,1711,6,7,6,7,21,24,-3,27
FK Rubin,1711,7,6,5,9,25,20,5,23
Din Moscow,1711,8,5,7,8,18,24,-6,22
Amkar,1711,9,5,4,11,10,24,-14,19
Rostov,1711,10,4,6,10,11,19,-8,18
Anzhi,1711,11,2,6,12,16,41,-25,12
Loko Moscow,1712,1,12,5,3,30,14,16,41
Zenit,1712,2,9,8,3,26,14,12,35
Spart Moscow,1712,3,10,5,5,36,27,9,35
CSKA Moscow,1712,4,10,4,6,27,20,7,34
Krasnodar,1712,5,9,4,7,29,25,4,31
Terek Grozny,1712,6,7,7,6,24,26,-2,28
Din Moscow,1712,7,5,7,8,17,23,-6,22
FK Rubin,1712,8,5,6,9,21,19,2,21
Amkar,1712,9,5,5,10,14,25,-11,20
Rostov,1712,10,4,6,10,10,18,-8,18
Anzhi,1712,11,2,7,11,16,39,-23,13
Loko Moscow,1713,1,11,7,2,31,13,18,40
CSKA Moscow,1713,2,11,3,6,28,19,9,36
Zenit,1713,3,8,9,3,24,14,10,33
Spart Moscow,1713,4,9,6,5,35,26,9,33
Krasnodar,1713,5,8,5,7,28,26,2,29
Terek Grozny,1713,6,7,6,7,21,25,-4,27
FK Rubin,1713,7,6,6,8,23,18,5,24
Din Moscow,1713,8,5,8,7,18,22,-4,23
Amkar,1713,9,5,5,10,11,23,-12,20
Rostov,1713,10,4,6,10,10,19,-9,18
Anzhi,1713,11,3,5,12,16,40,-24,14
Loko Moscow,1714,1,11,7,2,31,13,18,40
CSKA Moscow,1714,2,11,4,5,27,17,10,37
Spart Moscow,1714,3,8,8,4,38,30,8,32
Zenit,1714,4,7,10,3,21,13,8,31
Krasnodar,1714,5,8,6,6,30,27,3,30
Terek Grozny,1714,6,8,6,6,22,23,-1,30
Din Moscow,1714,7,5,8,7,18,22,-4,23
FK Rubin,1714,8,5,7,8,23,19,4,22
Rostov,1714,9,4,7,9,13,20,-7,19
Amkar,1714,10,4,6,10,12,25,-13,18
Anzhi,1714,11,2,5,13,14,40,-26,11
Loko Moscow,1715,1,12,6,2,32,13,19,42
Spart Moscow,1715,2,10,6,4,39,29,10,36
CSKA Moscow,1715,3,11,3,6,30,22,8,36
Zenit,1715,4,8,9,3,25,15,10,33
Terek Grozny,1715,5,8,6,6,24,25,-1,30
Krasnodar,1715,6,8,5,7,28,26,2,29
Din Moscow,1715,7,6,6,8,20,24,-4,24
FK Rubin,1715,8,5,6,9,21,18,3,21
Rostov,1715,9,4,7,9,11,18,-7,19
Amkar,1715,10,4,4,12,12,27,-15,16
Anzhi,1715,11,2,6,12,17,42,-25,12
Loko Moscow,1716,1,12,6,2,31,11,20,42
CSKA Moscow,1716,2,11,4,5,27,17,10,37
Spart Moscow,1716,3,9,6,5,36,30,6,33
Zenit,1716,4,7,9,4,21,15,6,30
Krasnodar,1716,5,8,6,6,28,25,3,30
Terek Grozny,1716,6,7,7,6,21,23,-2,28
FK Rubin,1716,7,6,6,8,23,18,5,24
Din Moscow,1716,8,5,7,8,18,23,-5,22
Amkar,1716,9,5,5,10,13,23,-10,20
Rostov,1716,10,4,6,10,11,19,-8,18
Anzhi,1716,11,2,6,12,14,39,-25,12
Loko Moscow,1717,1,13,5,2,31,11,20,44
CSKA Moscow,1717,2,12,3,5,28,18,10,39
Terek Grozny,1717,3,9,5,6,25,23,2,32
Spart Moscow,1717,4,8,7,5,37,32,5,31
Zenit,1717,5,7,8,5,22,16,6,29
Krasnodar,1717,6,8,4,8,28,27,1,28
Din Moscow,1717,7,6,7,7,23,24,-1,25
FK Rubin,1717,8,6,6,8,24,19,5,24
Rostov,1717,9,4,7,9,11,18,-7,19
Amkar,1717,10,4,5,11,10,26,-16,17
Anzhi,1717,11,2,5,13,15,40,-25,11
Loko Moscow,1718,1,12,6,2,30,11,19,42
CSKA Moscow,1718,2,12,3,5,27,17,10,39
Spart Moscow,1718,3,9,6,5,36,28,8,33
Krasnodar,1718,4,8,6,6,29,26,3,30
Zenit,1718,5,7,8,5,21,15,6,29
Terek Grozny,1718,6,8,5,7,27,28,-1,29
Din Moscow,1718,7,5,8,7,19,23,-4,23
FK Rubin,1718,8,5,7,8,25,21,4,22
Rostov,1718,9,5,6,9,11,17,-6,21
Amkar,1718,10,4,4,12,12,28,-16,16
Anzhi,1718,11,3,5,12,19,42,-23,14
Loko Moscow,1719,1,13,5,2,33,12,21,44
CSKA Moscow,1719,2,11,3,6,29,20,9,36
Spart Moscow,1719,3,9,6,5,37,29,8,33
Zenit,1719,4,8,8,4,24,16,8,32
Terek Grozny,1719,5,8,6,6,22,23,-1,30
Krasnodar,1719,6,8,4,8,27,26,1,28
FK Rubin,1719,7,6,6,8,23,18,5,24
Din Moscow,1719,8,5,7,8,18,23,-5,22
Rostov,1719,9,5,6,9,12,18,-6,21
Amkar,1719,10,4,5,11,11,25,-14,17
Anzhi,1719,11,2,6,12,16,42,-26,12
Loko Moscow,1720,1,12,5,3,31,13,18,41
CSKA Moscow,1720,2,12,3,5,31,18,13,39
Spart Moscow,1720,3,10,6,4,37,27,10,36
Krasnodar,1720,4,9,4,7,28,25,3,31
Zenit,1720,5,7,8,5,23,18,5,29
Terek Grozny,1720,6,7,6,7,21,24,-3,27
FK Rubin,1720,7,6,6,8,23,18,5,24
Din Moscow,1720,8,5,8,7,19,23,-4,23
Rostov,1720,9,4,6,10,11,19,-8,18
Amkar,1720,10,4,5,11,10,24,-14,17
Anzhi,1720,11,3,5,12,15,40,-25,14
Loko Moscow,1721,1,11,6,3,31,14,17,39
CSKA Moscow,1721,2,12,3,5,27,17,10,39
Zenit,1721,3,8,8,4,23,15,8,32
Spart Moscow,1721,4,9,5,6,37,30,7,32
Krasnodar,1721,5,9,5,6,31,26,5,32
Terek Grozny,1721,6,7,6,7,20,24,-4,27
Din Moscow,1721,7,6,6,8,19,23,-4,24
FK Rubin,1721,8,6,5,9,23,20,3,23
Amkar,1721,9,6,4,10,12,22,-10,22
Rostov,1721,10,4,6,10,12,20,-8,18
Anzhi,1721,11,2,6,12,14,38,-24,12
Loko Moscow,1722,1,12,6,2,30,11,19,42
CSKA Moscow,1722,2,12,3,5,27,17,10,39
Spart Moscow,1722,3,9,6,5,40,29,11,33
Zenit,1722,4,7,9,4,21,14,7,30
Krasnodar,1722,5,8,4,8,27,27,0,28
FK Rubin,1722,6,7,5,8,26,17,9,26
Terek Grozny,1722,7,7,5,8,22,27,-5,26
Din Moscow,1722,8,5,7,8,19,26,-7,22
Rostov,1722,9,5,6,9,12,17,-5,21
Amkar,1722,10,5,4,11,12,29,-17,19
Anzhi,1722,11,3,5,12,16,38,-22,14
CSKA Moscow,1723,1,12,3,5,30,19,11,39
Loko Moscow,1723,2,11,5,4,32,16,16,38
Spart Moscow,1723,3,10,6,4,37,26,11,36
Krasnodar,1723,4,10,4,6,33,27,6,34
Zenit,1723,5,8,8,4,22,15,7,32
Terek Grozny,1723,6,7,5,8,21,25,-4,26
FK Rubin,1723,7,6,5,9,23,19,4,23
Din Moscow,1723,8,5,6,9,17,24,-7,21
Amkar,1723,9,5,5,10,11,23,-12,20
Rostov,1723,10,4,6,10,11,20,-9,18
Anzhi,1723,11,3,5,12,17,40,-23,14
Loko Moscow,1724,1,13,5,2,34,13,21,44
CSKA Moscow,1724,2,10,4,6,25,18,7,34
Krasnodar,1724,3,9,4,7,32,29,3,31
Zenit,1724,4,7,9,4,22,15,7,30
Spart Moscow,1724,5,8,6,6,33,27,6,30
Terek Grozny,1724,6,8,6,6,23,24,-1,30
Din Moscow,1724,7,6,7,7,19,22,-3,25
FK Rubin,1724,8,5,6,9,24,22,2,21
Rostov,1724,9,5,6,9,11,17,-6,21
Amkar,1724,10,4,5,11,10,24,-14,17
Anzhi,1724,11,3,6,11,16,38,-22,15
Loko Moscow,1725,1,12,5,3,34,14,20,41
CSKA Moscow,1725,2,11,3,6,27,19,8,36
Spart Moscow,1725,3,9,7,4,37,28,9,34
Krasnodar,1725,4,10,4,6,30,25,5,34
Zenit,1725,5,8,8,4,23,17,6,32
Terek Grozny,1725,6,7,7,6,21,23,-2,28
FK Rubin,1725,7,6,5,9,22,18,4,23
Din Moscow,1725,8,5,7,8,19,24,-5,22
Rostov,1725,9,4,6,10,10,18,-8,18
Amkar,1725,10,4,6,10,10,23,-13,18
Anzhi,1725,11,2,6,12,16,40,-24,12
Loko Moscow,1726,1,13,5,2,34,12,22,44
Spart Moscow,1726,2,10,6,4,37,27,10,36
CSKA Moscow,1726,3,11,3,6,28,20,8,36
Zenit,1726,4,8,8,4,23,16,7,32
Terek Grozny,1726,5,8,6,6,22,23,-1,30
Krasnodar,1726,6,8,5,7,29,28,1,29
Din Moscow,1726,7,6,6,8,20,24,-4,24
FK Rubin,1726,8,5,6,9,23,20,3,21
Rostov,1726,9,4,7,9,10,17,-7,19
Amkar,1726,10,4,4,12,10,25,-15,16
Anzhi,1726,11,2,6,12,16,40,-24,12
Loko Moscow,1727,1,12,5,3,32,14,18,41
Spart Moscow,1727,2,9,7,4,37,28,9,34
CSKA Moscow,1727,3,10,4,6,26,20,6,34
Zenit,1727,4,8,9,3,24,15,9,33
Krasnodar,1727,5,8,5,7,28,26,2,29
Terek Grozny,1727,6,7,6,7,20,24,-4,27
FK Rubin,1727,7,6,6,8,24,17,7,24
Din Moscow,1727,8,5,6,9,17,25,-8,21
Amkar,1727,9,5,5,10,12,23,-11,20
Rostov,1727,10,4,7,9,12,19,-7,19
Anzhi,1727,11,3,6,11,16,37,-21,15
Loko Moscow,1728,1,13,5,2,34,12,22,44
CSKA Moscow,1728,2,11,4,5,29,18,11,37
Spart Moscow,1728,3,8,7,5,34,28,6,31
Krasnodar,1728,4,9,4,7,29,27,2,31
Zenit,1728,5,7,9,4,23,16,7,30
Terek Grozny,1728,6,7,6,7,20,23,-3,27
Din Moscow,1728,7,5,8,7,18,22,-4,23
FK Rubin,1728,8,5,6,9,22,20,2,21
Rostov,1728,9,5,6,9,12,17,-5,21
Amkar,1728,10,5,5,10,11,23,-12,20
Anzhi,1728,11,2,6,12,14,40,-26,12
Loko Moscow,1729,1,12,6,2,31,12,19,42
CSKA Moscow,1729,2,10,5,5,25,17,8,35
Spart Moscow,1729,3,9,6,5,37,31,6,33
Zenit,1729,4,7,10,3,21,13,8,31
Krasnodar,1729,5,8,5,7,29,27,2,29
Terek Grozny,1729,6,7,6,7,21,25,-4,27
FK Rubin,1729,7,6,6,8,24,18,6,24
Amkar,1729,8,6,4,10,14,22,-8,22
Din Moscow,1729,9,5,6,9,17,24,-7,21
Rostov,1729,10,4,7,9,13,20,-7,19
Anzhi,1729,11,2,7,11,15,38,-23,13
Loko Moscow,1730,1,11,6,3,31,14,17,39
Spart Moscow,1730,2,10,6,4,38,28,10,36
CSKA Moscow,1730,3,10,4,6,27,20,7,34
Zenit,1730,4,8,9,3,24,15,9,33
Krasnodar,1730,5,9,4,7,30,27,3,31
Terek Grozny,1730,6,8,6,6,21,22,-1,30
Din Moscow,1730,7,6,7,7,20,22,-2,25
FK Rubin,1730,8,6,5,9,23,20,3,23
Rostov,1730,9,4,6,10,11,19,-8,18
Amkar,1730,10,4,4,12,10,25,-15,16
Anzhi,1730,11,2,7,11,15,38,-23,13
Loko Moscow,1731,1,12,6,2,32,13,19,42
CSKA Moscow,1731,2,12,3,5,31,19,12,39
Spart Moscow,1731,3,9,6,5,38,28,10,33
Zenit,1731,4,7,9,4,23,17,6,30
Terek Grozny,1731,5,8,6,6,22,22,0,30
Krasnodar,1731,6,8,5,7,28,26,2,29
FK Rubin,1731,7,6,6,8,25,20,5,24
Din Moscow,1731,8,6,6,8,20,24,-4,24
Rostov,1731,9,4,6,10,11,21,-10,18
Amkar,1731,10,4,5,11,10,25,-15,17
Anzhi,1731,11,2,6,12,16,41,-25,12
Loko Moscow,1732,1,12,6,2,30,11,19,42
CSKA Moscow,1732,2,11,3,6,29,20,9,36
Spart Moscow,1732,3,9,6,5,37,29,8,33
Zenit,1732,4,8,8,4,24,16,8,32
Krasnodar,1732,5,9,5,6,29,25,4,32
Din Moscow,1732,6,7,6,7,22,22,0,27
Terek Grozny,1732,7,7,6,7,22,25,-3,27
FK Rubin,1732,8,5,5,10,22,21,1,20
Rostov,1732,9,4,6,10,10,19,-9,18
Amkar,1732,10,4,6,10,12,25,-13,18
Anzhi,1732,11,3,5,12,15,39,-24,14
Loko Moscow,1733,1,11,6,3,30,13,17,39
Spart Moscow,1733,2,11,5,4,40,27,13,38
CSKA Moscow,1733,3,11,3,6,28,23,5,36
Zenit,1733,4,8,9,3,25,13,12,33
Krasnodar,1733,5,9,4,7,29,26,3,31
Terek Grozny,1733,6,7,5,8,21,25,-4,26
Din Moscow,1733,7,6,6,8,19,23,-4,24
FK Rubin,1733,8,6,5,9,22,18,4,23
Amkar,1733,9,5,4,11,10,23,-13,19
Rostov,1733,10,4,6,10,11,21,-10,18
Anzhi,1733,11,3,5,12,18,41,-23,14
Loko Moscow,1734,1,12,6,2,32,12,20,42
CSKA Moscow,1734,2,11,4,5,26,17,9,37
Spart Moscow,1734,3,9,5,6,34,27,7,32
Zenit,1734,4,7,10,3,22,14,8,31
Terek Grozny,1734,5,8,6,6,25,26,-1,30
Krasnodar,1734,6,8,5,7,28,27,1,29
FK Rubin,1734,7,5,7,8,23,19,4,22
Din Moscow,1734,8,5,7,8,18,23,-5,22
Rostov,1734,9,5,6,9,11,17,-6,21
Amkar,1734,10,5,4,11,11,24,-13,19
Anzhi,1734,11,2,6,12,17,41,-24,12
Loko Moscow,1735,1,12,5,3,32,13,19,41
CSKA Moscow,1735,2,11,3,6,27,18,9,36
Spart Moscow,1735,3,9,6,5,38,29,9,33
Zenit,1735,4,8,8,4,22,15,7,32
Krasnodar,1735,5,9,5,6,29,25,4,32
Din Moscow,1735,6,7,6,7,20,21,-1,27
Terek Grozny,1735,7,7,6,7,21,25,-4,27
FK Rubin,1735,8,5,6,9,21,18,3,21
Amkar,1735,9,5,5,10,12,23,-11,20
Rostov,1735,10,4,6,10,11,21,-10,18
Anzhi,1735,11,2,6,12,15,40,-25,12
Loko Moscow,1736,1,12,6,2,31,12,19,42
CSKA Moscow,1736,2,11,4,5,27,17,10,37
Spart Moscow,1736,3,10,5,5,44,29,15,35
Zenit,1736,4,7,9,4,22,16,6,30
Terek Grozny,1736,5,8,6,6,22,23,-1,30
Krasnodar,1736,6,8,5,7,28,26,2,29
Din Moscow,1736,7,6,6,8,21,28,-7,24
FK Rubin,1736,8,5,6,9,22,21,1,21
Amkar,1736,9,5,4,11,11,24,-13,19
Rostov,1736,10,4,6,10,11,20,-9,18
Anzhi,1736,11,2,7,11,15,38,-23,13
Loko Moscow,1737,1,12,6,2,34,12,22,42
Spart Moscow,1737,2,10,6,4,36,26,10,36
CSKA Moscow,1737,3,10,4,6,26,20,6,34
Zenit,1737,4,7,9,4,22,18,4,30
Krasnodar,1737,5,8,5,7,28,26,2,29
Terek Grozny,1737,6,7,5,8,21,28,-7,26
Din Moscow,1737,7,6,7,7,23,22,1,25
FK Rubin,1737,8,6,5,9,22,22,0,23
Amkar,1737,9,5,4,11,12,24,-12,19
Rostov,1737,10,4,6,10,10,18,-8,18
Anzhi,1737,11,4,5,11,19,37,-18,17
Loko Moscow,1738,1,12,6,2,32,13,19,42
Spart Moscow,1738,2,9,7,4,37,28,9,34
CSKA Moscow,1738,3,10,4,6,27,20,7,34
Zenit,1738,4,8,9,3,24,15,9,33
Krasnodar,1738,5,9,4,7,30,27,3,31
Terek Grozny,1738,6,7,5,8,22,26,-4,26
Din Moscow,1738,7,5,8,7,19,23,-4,23
FK Rubin,1738,8,5,6,9,23,20,3,21
Amkar,1738,9,5,5,10,12,24,-12,20
Rostov,1738,10,4,6,10,11,19,-8,18
Anzhi,1738,11,3,6,11,17,39,-22,15
Loko Moscow,1739,1,12,6,2,30,11,19,42
CSKA Moscow,1739,2,11,4,5,28,19,9,37
Spart Moscow,1739,3,10,6,4,42,29,13,36
Krasnodar,1739,4,9,5,6,29,25,4,32
Zenit,1739,5,7,9,4,22,15,7,30
Terek Grozny,1739,6,8,5,7,22,23,-1,29
Din Moscow,1739,7,5,7,8,21,29,-8,22
FK Rubin,1739,8,5,6,9,24,21,3,21
Amkar,1739,9,5,5,10,11,23,-12,20
Rostov,1739,10,4,6,10,11,19,-8,18
Anzhi,1739,11,2,5,13,15,41,-26,11
Loko Moscow,1740,1,12,6,2,32,13,19,42
CSKA Moscow,1740,2,11,4,5,28,19,9,37
Spart Moscow,1740,3,10,6,4,39,27,12,36
Zenit,1740,4,7,9,4,23,16,7,30
Terek Grozny,1740,5,8,6,6,23,23,0,30
Krasnodar,1740,6,8,5,7,28,26,2,29
Din Moscow,1740,7,6,6,8,20,25,-5,24
FK Rubin,1740,8,6,5,9,23,19,4,23
Rostov,1740,9,4,7,9,10,17,-7,19
Amkar,1740,10,4,5,11,10,25,-15,17
Anzhi,1740,11,2,5,13,16,42,-26,11
Loko Moscow,1741,1,12,6,2,31,12,19,42
CSKA Moscow,1741,2,10,4,6,25,18,7,34
Spart Moscow,1741,3,9,6,5,36,28,8,33
Zenit,1741,4,8,8,4,23,15,8,32
Terek Grozny,1741,5,8,6,6,22,23,-1,30
Krasnodar,1741,6,8,5,7,28,26,2,29
Din Moscow,1741,7,6,6,8,18,22,-4,24
FK Rubin,1741,8,6,5,9,23,19,4,23
Rostov,1741,9,4,7,9,11,18,-7,19
Amkar,1741,10,5,4,11,11,24,-13,19
Anzhi,1741,11,2,7,11,15,38,-23,13
Loko Moscow,1742,1,11,6,3,29,12,17,39
Spart Moscow,1742,2,10,6,4,40,26,14,36
CSKA Moscow,1742,3,11,3,6,28,19,9,36
Zenit,1742,4,9,8,3,24,13,11,35
Krasnodar,1742,5,9,5,6,31,27,4,32
Terek Grozny,1742,6,8,5,7,23,23,0,29
FK Rubin,1742,7,6,5,9,27,23,4,23
Din Moscow,1742,8,5,6,9,19,27,-8,21
Amkar,1742,9,5,5,10,11,23,-12,20
Rostov,1742,10,4,6,10,10,20,-10,18
Anzhi,1742,11,2,5,13,14,43,-29,11
Loko Moscow,1743,1,12,5,3,34,14,20,41
CSKA Moscow,1743,2,12,3,5,32,18,14,39
Spart Moscow,1743,3,10,6,4,37,27,10,36
Zenit,1743,4,8,8,4,24,17,7,32
Terek Grozny,1743,5,9,5,6,23,23,0,32
Krasnodar,1743,6,8,5,7,29,29,0,29
FK Rubin,1743,7,6,6,8,24,19,5,24
Din Moscow,1743,8,5,7,8,18,23,-5,22
Rostov,1743,9,4,6,10,11,19,-8,18
Amkar,1743,10,4,4,12,10,25,-15,16
Anzhi,1743,11,2,5,13,15,43,-28,11
Loko Moscow,1744,1,11,6,3,31,16,15,39
CSKA Moscow,1744,2,11,4,5,33,19,14,37
Spart Moscow,1744,3,9,6,5,36,29,7,33
Zenit,1744,4,7,10,3,25,17,8,31
Krasnodar,1744,5,9,4,7,31,27,4,31
Terek Grozny,1744,6,8,6,6,22,23,-1,30
FK Rubin,1744,7,7,5,8,25,18,7,26
Din Moscow,1744,8,5,7,8,17,22,-5,22
Rostov,1744,9,5,6,9,13,18,-5,21
Amkar,1744,10,4,5,11,11,25,-14,17
Anzhi,1744,11,2,5,13,14,44,-30,11
Loko Moscow,1745,1,11,6,3,30,13,17,39
CSKA Moscow,1745,2,10,5,5,28,20,8,35
Krasnodar,1745,3,10,4,6,30,25,5,34
Spart Moscow,1745,4,9,6,5,40,29,11,33
Zenit,1745,5,7,10,3,21,13,8,31
Terek Grozny,1745,6,8,6,6,22,22,0,30
Din Moscow,1745,7,7,6,7,21,23,-2,27
FK Rubin,1745,8,5,5,10,21,19,2,20
Rostov,1745,9,4,6,10,10,21,-11,18
Amkar,1745,10,4,6,10,10,23,-13,18
Anzhi,1745,11,2,6,12,17,42,-25,12
Loko Moscow,1746,1,11,5,4,30,18,12,38
CSKA Moscow,1746,2,11,3,6,30,21,9,36
Zenit,1746,3,9,8,3,29,14,15,35
Krasnodar,1746,4,10,4,6,33,24,9,34
Spart Moscow,1746,5,9,5,6,37,29,8,32
Terek Grozny,1746,6,8,6,6,23,23,0,30
Din Moscow,1746,7,6,6,8,18,23,-5,24
FK Rubin,1746,8,6,5,9,23,20,3,23
Amkar,1746,9,5,5,10,12,23,-11,20
Rostov,1746,10,4,6,10,11,21,-10,18
Anzhi,1746,11,2,5,13,14,44,-30,11
Loko Moscow,1747,1,12,6,2,32,13,19,42
CSKA Moscow,1747,2,11,3,6,28,20,8,36
Spart Moscow,1747,3,9,7,4,37,27,10,34
Zenit,1747,4,8,9,3,23,14,9,33
Krasnodar,1747,5,8,5,7,29,27,2,29
Terek Grozny,1747,6,7,5,8,20,24,-4,26
FK Rubin,1747,7,5,7,8,23,19,4,22
Din Moscow,1747,8,5,7,8,18,24,-6,22
Amkar,1747,9,5,5,10,11,23,-12,20
Rostov,1747,10,4,7,9,11,18,-7,19
Anzhi,1747,11,3,5,12,17,40,-23,14
Loko Moscow,1748,1,11,7,2,29,11,18,40
CSKA Moscow,1748,2,12,3,5,29,18,11,39
Spart Moscow,1748,3,9,5,6,38,31,7,32
Krasnodar,1748,4,9,5,6,31,24,7,32
Zenit,1748,5,7,9,4,21,14,7,30
Terek Grozny,1748,6,8,6,6,24,22,2,30
Din Moscow,1748,7,6,6,8,18,22,-4,24
FK Rubin,1748,8,6,5,9,22,21,1,23
Amkar,1748,9,5,5,10,12,24,-12,20
Rostov,1748,10,4,6,10,12,20,-8,18
Anzhi,1748,11,2,5,13,15,44,-29,11
Loko Moscow,1749,1,12,5,3,31,16,15,41
Spart Moscow,1749,2,10,6,4,38,25,13,36
CSKA Moscow,1749,3,11,3,6,29,20,9,36
Zenit,1749,4,8,8,4,24,16,8,32
Krasnodar,1749,5,9,4,7,31,26,5,31
Terek Grozny,1749,6,8,6,6,22,23,-1,30
FK Rubin,1749,7,6,6,8,24,18,6,24
Din Moscow,1749,8,5,8,7,18,22,-4,23
Rostov,1749,9,4,6,10,10,20,-10,18
Amkar,1749,10,4,5,11,9,24,-15,17
Anzhi,1749,11,2,5,13,16,42,-26,11
Loko Moscow,1750,1,11,6,3,29,12,17,39
CSKA Moscow,1750,2,11,4,5,27,18,9,37
Spart Moscow,1750,3,9,6,5,36,27,9,33
Krasnodar,1750,4,9,5,6,28,24,4,32
Zenit,1750,5,7,10,3,21,13,8,31
Terek Grozny,1750,6,8,5,7,24,25,-1,29
Din Moscow,1750,7,6,7,7,20,22,-2,25
FK Rubin,1750,8,5,6,9,21,19,2,21
Rostov,1750,9,5,6,9,11,17,-6,21
Amkar,1750,10,4,4,12,9,26,-17,16
Anzhi,1750,11,3,5,12,18,41,-23,14
Loko Moscow,1751,1,13,5,2,32,11,21,44
CSKA Moscow,1751,2,11,3,6,27,19,8,36
Spart Moscow,1751,3,9,6,5,35,27,8,33
Zenit,1751,4,8,8,4,23,14,9,32
Krasnodar,1751,5,9,4,7,29,27,2,31
Terek Grozny,1751,6,7,5,8,22,26,-4,26
Din Moscow,1751,7,6,6,8,20,23,-3,24
Amkar,1751,8,6,4,10,12,23,-11,22
FK Rubin,1751,9,5,5,10,22,21,1,20
Rostov,1751,10,4,7,9,10,17,-7,19
Anzhi,1751,11,3,5,12,16,40,-24,14
Loko Moscow,1752,1,12,5,3,31,13,18,41
CSKA Moscow,1752,2,11,3,6,28,21,7,36
Krasnodar,1752,3,10,4,6,31,26,5,34
Zenit,1752,4,8,8,4,24,15,9,32
Spart Moscow,1752,5,8,7,5,37,32,5,31
Terek Grozny,1752,6,8,5,7,21,23,-2,29
Din Moscow,1752,7,6,7,7,21,24,-3,25
FK Rubin,1752,8,5,5,10,23,21,2,20
Rostov,1752,9,4,7,9,12,19,-7,19
Amkar,1752,10,5,4,11,12,23,-11,19
Anzhi,1752,11,3,5,12,16,39,-23,14
Loko Moscow,1753,1,12,6,2,31,12,19,42
CSKA Moscow,1753,2,12,3,5,30,18,12,39
Spart Moscow,1753,3,9,7,4,37,26,11,34
Krasnodar,1753,4,8,6,6,27,24,3,30
Zenit,1753,5,7,8,5,22,17,5,29
Terek Grozny,1753,6,7,6,7,20,23,-3,27
FK Rubin,1753,7,6,6,8,23,18,5,24
Din Moscow,1753,8,5,7,8,19,24,-5,22
Rostov,1753,9,4,7,9,10,17,-7,19
Amkar,1753,10,5,4,11,10,25,-15,19
Anzhi,1753,11,2,6,12,15,40,-25,12
Loko Moscow,1754,1,12,5,3,30,12,18,41
CSKA Moscow,1754,2,11,3,6,27,21,6,36
Spart Moscow,1754,3,9,7,4,37,28,9,34
Zenit,1754,4,8,8,4,24,14,10,32
Krasnodar,1754,5,9,5,6,30,26,4,32
Terek Grozny,1754,6,8,5,7,23,24,-1,29
Din Moscow,1754,7,6,7,7,20,22,-2,25
FK Rubin,1754,8,5,6,9,23,21,2,21
Rostov,1754,9,4,7,9,11,18,-7,19
Amkar,1754,10,5,4,11,12,25,-13,19
Anzhi,1754,11,2,5,13,15,41,-26,11
Loko Moscow,1755,1,12,6,2,34,14,20,42
CSKA Moscow,1755,2,12,3,5,30,17,13,39
Spart Moscow,1755,3,10,6,4,42,28,14,36
Krasnodar,1755,4,9,4,7,30,28,2,31
Zenit,1755,5,7,9,4,23,17,6,30
Terek Grozny,1755,6,7,6,7,22,27,-5,27
Din Moscow,1755,7,6,6,8,19,24,-5,24
FK Rubin,1755,8,5,5,10,22,20,2,20
Rostov,1755,9,4,7,9,12,19,-7,19
Amkar,1755,10,5,4,11,12,26,-14,19
Anzhi,1755,11,2,6,12,16,42,-26,12
Loko Moscow,1756,1,12,6,2,33,13,20,42
Zenit,1756,2,8,9,3,23,14,9,33
CSKA Moscow,1756,3,10,3,7,25,20,5,33
Spart Moscow,1756,4,9,5,6,38,30,8,32
Krasnodar,1756,5,9,4,7,32,27,5,31
Terek Grozny,1756,6,8,5,7,21,24,-3,29
Din Moscow,1756,7,6,7,7,20,23,-3,25
FK Rubin,1756,8,5,6,9,22,22,0,21
Rostov,1756,9,5,6,9,12,18,-6,21
Amkar,1756,10,5,4,11,12,25,-13,19
Anzhi,1756,11,3,5,12,16,38,-22,14
Loko Moscow,1757,1,12,6,2,32,13,19,42
Spart Moscow,1757,2,9,7,4,38,29,9,34
CSKA Moscow,1757,3,10,4,6,28,21,7,34
Zenit,1757,4,8,8,4,24,16,8,32
Krasnodar,1757,5,8,5,7,29,27,2,29
Terek Grozny,1757,6,7,6,7,21,25,-4,27
Din Moscow,1757,7,6,6,8,20,23,-3,24
FK Rubin,1757,8,6,5,9,22,19,3,23
Rostov,1757,9,4,7,9,13,20,-7,19
Amkar,1757,10,4,6,10,9,22,-13,18
Anzhi,1757,11,3,6,11,18,39,-21,15
Loko Moscow,1758,1,11,7,2,31,13,18,40
Spart Moscow,1758,2,11,5,4,38,26,12,38
Zenit,1758,3,8,9,3,23,14,9,33
CSKA Moscow,1758,4,10,3,7,26,20,6,33
Krasnodar,1758,5,9,5,6,30,26,4,32
Terek Grozny,1758,6,7,5,8,21,26,-5,26
Din Moscow,1758,7,6,6,8,20,23,-3,24
FK Rubin,1758,8,5,5,10,22,21,1,20
Amkar,1758,9,5,4,11,11,24,-13,19
Rostov,1758,10,4,6,10,10,19,-9,18
Anzhi,1758,11,4,5,11,18,38,-20,17
Loko Moscow,1759,1,11,5,4,30,15,15,38
CSKA Moscow,1759,2,11,3,6,26,18,8,36
Zenit,1759,3,9,8,3,24,13,11,35
Krasnodar,1759,4,10,4,6,32,26,6,34
Terek Grozny,1759,5,9,5,6,24,22,2,32
Spart Moscow,1759,6,8,7,5,37,33,4,31
FK Rubin,1759,7,6,5,9,24,21,3,23
Din Moscow,1759,8,5,7,8,19,24,-5,22
Rostov,1759,9,4,7,9,12,19,-7,19
Amkar,1759,10,5,4,11,14,26,-12,19
Anzhi,1759,11,2,5,13,14,39,-25,11
Loko Moscow,1760,1,12,5,3,31,13,18,41
Spart Moscow,1760,2,10,6,4,39,28,11,36
CSKA Moscow,1760,3,11,3,6,28,20,8,36
Zenit,1760,4,8,8,4,24,15,9,32
Krasnodar,1760,5,9,4,7,29,25,4,31
Terek Grozny,1760,6,7,7,6,20,22,-2,28
Din Moscow,1760,7,6,6,8,21,23,-2,24
FK Rubin,1760,8,6,5,9,22,20,2,23
Rostov,1760,9,4,6,10,11,20,-9,18
Amkar,1760,10,4,6,10,10,23,-13,18
Anzhi,1760,11,2,6,12,14,40,-26,12
Loko Moscow,1761,1,11,6,3,31,15,16,39
CSKA Moscow,1761,2,12,3,5,32,19,13,39
Spart Moscow,1761,3,10,6,4,35,25,10,36
Krasnodar,1761,4,10,4,6,30,24,6,34
Zenit,1761,5,7,9,4,24,17,7,30
Terek Grozny,1761,6,8,5,7,22,24,-2,29
Din Moscow,1761,7,5,8,7,17,21,-4,23
FK Rubin,1761,8,5,6,9,21,18,3,21
Rostov,1761,9,4,6,10,10,18,-8,18
Amkar,1761,10,4,4,12,10,25,-15,16
Anzhi,1761,11,3,5,12,16,42,-26,14
Loko Moscow,1762,1,11,6,3,32,15,17,39
CSKA Moscow,1762,2,12,3,5,28,17,11,39
Spart Moscow,1762,3,10,6,4,39,28,11,36
Krasnodar,1762,4,9,4,7,29,27,2,31
Zenit,1762,5,7,9,4,23,16,7,30
Terek Grozny,1762,6,8,6,6,23,24,-1,30
Din Moscow,1762,7,6,6,8,18,22,-4,24
FK Rubin,1762,8,6,5,9,23,18,5,23
Rostov,1762,9,4,7,9,12,19,-7,19
Amkar,1762,10,4,5,11,11,26,-15,17
Anzhi,1762,11,2,5,13,15,41,-26,11
Loko Moscow,1763,1,11,6,3,33,16,17,39
Spart Moscow,1763,2,11,5,4,41,26,15,38
CSKA Moscow,1763,3,11,4,5,28,18,10,37
Terek Grozny,1763,4,9,5,6,23,23,0,32
Zenit,1763,5,7,10,3,24,16,8,31
Krasnodar,1763,6,9,4,7,30,27,3,31
FK Rubin,1763,7,6,6,8,22,17,5,24
Din Moscow,1763,8,5,7,8,17,25,-8,22
Rostov,1763,9,4,6,10,10,18,-8,18
Amkar,1763,10,4,4,12,11,27,-16,16
Anzhi,1763,11,2,5,13,14,40,-26,11
Loko Moscow,1764,1,13,5,2,31,11,20,44
Spart Moscow,1764,2,11,5,4,43,27,16,38
CSKA Moscow,1764,3,10,4,6,25,18,7,34
Zenit,1764,4,7,9,4,21,14,7,30
Krasnodar,1764,5,8,4,8,27,26,1,28
Terek Grozny,1764,6,7,6,7,20,25,-5,27
Din Moscow,1764,7,6,6,8,19,25,-6,24
FK Rubin,1764,8,6,5,9,23,19,4,23
Amkar,1764,9,5,4,11,13,26,-13,19
Rostov,1764,10,4,6,10,11,20,-9,18
Anzhi,1764,11,3,6,11,15,37,-22,15
Loko Moscow,1765,1,13,5,2,32,12,20,44
CSKA Moscow,1765,2,11,4,5,26,17,9,37
Spart Moscow,1765,3,9,6,5,34,27,7,33
Zenit,1765,4,7,9,4,22,15,7,30
Terek Grozny,1765,5,8,5,7,23,23,0,29
Krasnodar,1765,6,8,4,8,27,26,1,28
Din Moscow,1765,7,6,6,8,19,22,-3,24
FK Rubin,1765,8,6,5,9,22,19,3,23
Amkar,1765,9,6,4,10,12,22,-10,22
Rostov,1765,10,4,7,9,10,17,-7,19
Anzhi,1765,11,2,5,13,14,41,-27,11
Loko Moscow,1766,1,13,5,2,33,11,22,44
CSKA Moscow,1766,2,12,3,5,29,19,10,39
Spart Moscow,1766,3,10,5,5,40,30,10,35
Krasnodar,1766,4,9,4,7,28,27,1,31
Zenit,1766,5,7,8,5,22,16,6,29
Terek Grozny,1766,6,7,7,6,22,24,-2,28
Din Moscow,1766,7,6,6,8,20,24,-4,24
FK Rubin,1766,8,5,5,10,21,20,1,20
Amkar,1766,9,5,5,10,14,25,-11,20
Rostov,1766,10,4,6,10,10,19,-9,18
Anzhi,1766,11,2,6,12,16,40,-24,12
Loko Moscow,1767,1,12,5,3,31,14,17,41
CSKA Moscow,1767,2,12,3,5,34,19,15,39
Krasnodar,1767,3,10,4,6,31,24,7,34
Spart Moscow,1767,4,9,6,5,39,28,11,33
Terek Grozny,1767,5,8,6,6,23,23,0,30
Zenit,1767,6,7,8,5,23,17,6,29
Din Moscow,1767,7,6,7,7,21,22,-1,25
FK Rubin,1767,8,5,5,10,21,22,-1,20
Amkar,1767,9,5,5,10,12,23,-11,20
Rostov,1767,10,4,6,10,10,22,-12,18
Anzhi,1767,11,2,5,13,15,46,-31,11
Loko Moscow,1768,1,12,5,3,31,13,18,41
Spart Moscow,1768,2,10,6,4,39,28,11,36
CSKA Moscow,1768,3,11,3,6,27,22,5,36
Krasnodar,1768,4,10,4,6,31,24,7,34
Zenit,1768,5,8,8,4,27,16,11,32
Terek Grozny,1768,6,9,5,6,25,24,1,32
Din Moscow,1768,7,6,7,7,19,22,-3,25
FK Rubin,1768,8,5,5,10,21,21,0,20
Rostov,1768,9,4,6,10,12,20,-8,18
Amkar,1768,10,4,4,12,9,26,-17,16
Anzhi,1768,11,2,5,13,16,41,-25,11
Loko Moscow,1769,1,11,6,3,30,14,16,39
CSKA Moscow,1769,2,11,4,5,29,18,11,37
Krasnodar,1769,3,10,4,6,32,26,6,34
Spart Moscow,1769,4,9,6,5,37,29,8,33
Zenit,1769,5,7,10,3,22,14,8,31
Terek Grozny,1769,6,8,6,6,21,22,-1,30
FK Rubin,1769,7,6,5,9,24,20,4,23
Din Moscow,1769,8,5,6,9,19,25,-6,21
Amkar,1769,9,5,5,10,11,23,-12,20
Rostov,1769,10,4,7,9,11,18,-7,19
Anzhi,1769,11,2,5,13,14,41,-27,11
Loko Moscow,1770,1,13,5,2,34,12,22,44
CSKA Moscow,1770,2,11,4,5,28,19,9,37
Spart Moscow,1770,3,9,6,5,35,27,8,33
Zenit,1770,4,7,9,4,24,18,6,30
Krasnodar,1770,5,8,5,7,27,26,1,29
Terek Grozny,1770,6,7,6,7,20,23,-3,27
FK Rubin,1770,7,6,6,8,23,17,6,24
Amkar,1770,8,6,4,10,11,22,-11,22
Din Moscow,1770,9,5,6,9,17,24,-7,21
Rostov,1770,10,4,7,9,11,18,-7,19
Anzhi,1770,11,2,6,12,14,38,-24,12
Loko Moscow,1771,1,12,6,2,30,11,19,42
CSKA Moscow,1771,2,11,4,5,30,20,10,37
Spart Moscow,1771,3,9,6,5,36,27,9,33
Terek Grozny,1771,4,9,5,6,25,23,2,32
Zenit,1771,5,7,9,4,23,16,7,30
Krasnodar,1771,6,8,5,7,28,26,2,29
Din Moscow,1771,7,6,7,7,19,21,-2,25
FK Rubin,1771,8,6,5,9,23,20,3,23
Amkar,1771,9,5,4,11,10,24,-14,19
Rostov,1771,10,4,6,10,11,20,-9,18
Anzhi,1771,11,2,5,13,16,43,-27,11
Loko Moscow,1772,1,11,6,3,31,14,17,39
CSKA Moscow,1772,2,11,3,6,30,24,6,36
Zenit,1772,3,9,8,3,27,15,12,35
Spart Moscow,1772,4,9,5,6,37,29,8,32
Krasnodar,1772,5,9,5,6,29,25,4,32
Terek Grozny,1772,6,7,5,8,20,24,-4,26
Din Moscow,1772,7,6,6,8,18,23,-5,24
Amkar,1772,8,6,4,10,13,24,-11,22
Rostov,1772,9,5,6,9,11,17,-6,21
FK Rubin,1772,10,5,5,10,21,19,2,20
Anzhi,1772,11,3,5,12,18,41,-23,14
Loko Moscow,1773,1,12,6,2,33,14,19,42
CSKA Moscow,1773,2,11,3,6,29,23,6,36
Spart Moscow,1773,3,10,5,5,40,30,10,35
Zenit,1773,4,8,9,3,27,16,11,33
Krasnodar,1773,5,9,4,7,30,27,3,31
Terek Grozny,1773,6,8,6,6,22,23,-1,30
Din Moscow,1773,7,6,6,8,21,25,-4,24
FK Rubin,1773,8,5,5,10,23,22,1,20
Amkar,1773,9,5,5,10,12,24,-12,20
Rostov,1773,10,4,6,10,12,20,-8,18
Anzhi,1773,11,2,5,13,16,41,-25,11
Loko Moscow,1774,1,11,6,3,30,16,14,39
CSKA Moscow,1774,2,11,4,5,28,17,11,37
Krasnodar,1774,3,10,4,6,32,24,8,34
Spart Moscow,1774,4,9,5,6,36,30,6,32
Zenit,1774,5,7,10,3,22,14,8,31
Terek Grozny,1774,6,7,6,7,22,25,-3,27
Din Moscow,1774,7,6,6,8,19,22,-3,24
Amkar,1774,8,6,4,10,14,24,-10,22
Rostov,1774,9,5,6,9,12,18,-6,21
FK Rubin,1774,10,5,5,10,21,20,1,20
Anzhi,1774,11,2,6,12,15,41,-26,12
Loko Moscow,1775,1,12,5,3,31,13,18,41
CSKA Moscow,1775,2,11,3,6,28,19,9,36
Spart Moscow,1775,3,10,5,5,38,26,12,35
Zenit,1775,4,8,8,4,23,16,7,32
Krasnodar,1775,5,9,4,7,30,27,3,31
Terek Grozny,1775,6,8,6,6,23,24,-1,30
Din Moscow,1775,7,6,6,8,19,23,-4,24
Rostov,1775,8,5,6,9,11,17,-6,21
FK Rubin,1775,9,5,5,10,23,22,1,20
Amkar,1775,10,4,4,12,9,26,-17,16
Anzhi,1775,11,3,6,11,18,40,-22,15
Loko Moscow,1776,1,12,5,3,31,13,18,41
CSKA Moscow,1776,2,11,4,5,28,19,9,37
Zenit,1776,3,8,8,4,24,15,9,32
Spart Moscow,1776,4,9,5,6,39,31,8,32
Krasnodar,1776,5,9,4,7,31,27,4,31
Terek Grozny,1776,6,7,5,8,21,26,-5,26
Din Moscow,1776,7,6,6,8,19,24,-5,24
Amkar,1776,8,6,4,10,14,25,-11,22
Rostov,1776,9,5,6,9,13,19,-6,21
FK Rubin,1776,10,5,5,10,23,23,0,20
Anzhi,1776,11,3,6,11,17,38,-21,15
Loko Moscow,1777,1,12,6,2,32,12,20,42
Spart Moscow,1777,2,10,6,4,39,28,11,36
CSKA Moscow,1777,3,10,3,7,25,19,6,33
Zenit,1777,4,8,8,4,22,15,7,32
Krasnodar,1777,5,8,5,7,28,27,1,29
Terek Grozny,1777,6,8,5,7,24,26,-2,29
Din Moscow,1777,7,6,6,8,21,23,-2,24
FK Rubin,1777,8,6,5,9,23,20,3,23
Rostov,1777,9,4,6,10,11,20,-9,18
Amkar,1777,10,4,5,11,12,26,-14,17
Anzhi,1777,11,4,5,11,17,38,-21,17
Loko Moscow,1778,1,11,6,3,31,15,16,39
CSKA Moscow,1778,2,11,4,5,29,20,9,37
Krasnodar,1778,3,10,4,6,33,26,7,34
Spart Moscow,1778,4,9,6,5,40,30,10,33
Zenit,1778,5,7,9,4,24,17,7,30
Terek Grozny,1778,6,7,6,7,22,25,-3,27
Din Moscow,1778,7,5,7,8,22,29,-7,22
Amkar,1778,8,6,4,10,12,23,-11,22
FK Rubin,1778,9,5,6,9,25,23,2,21
Rostov,1778,10,4,7,9,12,19,-7,19
Anzhi,1778,11,2,7,11,16,39,-23,13
Loko Moscow,1779,1,11,6,3,30,13,17,39
Spart Moscow,1779,2,10,5,5,36,29,7,35
Zenit,1779,3,8,9,3,23,14,9,33
CSKA Moscow,1779,4,10,3,7,26,20,6,33
Terek Grozny,1779,5,9,5,6,23,23,0,32
Krasnodar,1779,6,9,4,7,28,25,3,31
FK Rubin,1779,7,7,5,8,23,17,6,26
Din Moscow,1779,8,6,6,8,21,23,-2,24
Rostov,1779,9,4,6,10,10,18,-8,18
Amkar,1779,10,4,4,12,9,24,-15,16
Anzhi,1779,11,3,5,12,17,40,-23,14
Loko Moscow,1780,1,11,7,2,32,14,18,40
Spart Moscow,1780,2,11,5,4,40,28,12,38
CSKA Moscow,1780,3,10,4,6,26,20,6,34
Zenit,1780,4,8,9,3,25,15,10,33
Krasnodar,1780,5,8,6,6,28,25,3,30
Terek Grozny,1780,6,8,5,7,24,26,-2,29
Din Moscow,1780,7,6,6,8,20,23,-3,24
FK Rubin,1780,8,5,6,9,21,19,2,21
Amkar,1780,9,5,4,11,13,24,-11,19
Rostov,1780,10,4,6,10,12,21,-9,18
Anzhi,1780,11,2,6,12,15,41,-26,12
Loko Moscow,1781,1,11,7,2,30,12,18,40
CSKA Moscow,1781,2,11,3,6,26,19,7,36
Zenit,1781,3,8,9,3,23,13,10,33
Krasnodar,1781,4,9,5,6,31,26,5,32
Terek Grozny,1781,5,9,5,6,26,25,1,32
Spart Moscow,1781,6,8,6,6,35,29,6,30
Din Moscow,1781,7,6,7,7,19,22,-3,25
FK Rubin,1781,8,5,6,9,22,20,2,21
Rostov,1781,9,4,7,9,11,18,-7,19
Amkar,1781,10,5,4,11,11,24,-13,19
Anzhi,1781,11,2,5,13,16,42,-26,11
Loko Moscow,1782,1,13,5,2,34,11,23,44
CSKA Moscow,1782,2,11,4,5,26,17,9,37
Spart Moscow,1782,3,10,6,4,36,26,10,36
Zenit,1782,4,7,8,5,21,16,5,29
Terek Grozny,1782,5,8,5,7,23,24,-1,29
Krasnodar,1782,6,8,4,8,27,28,-1,28
Din Moscow,1782,7,6,7,7,19,22,-3,25
FK Rubin,1782,8,6,5,9,22,18,4,23
Amkar,1782,9,5,4,11,11,23,-12,19
Rostov,1782,10,4,6,10,10,18,-8,18
Anzhi,1782,11,2,6,12,14,40,-26,12
Loko Moscow,1783,1,12,6,2,32,12,20,42
CSKA Moscow,1783,2,11,4,5,29,19,10,37
Spart Moscow,1783,3,10,6,4,38,27,11,36
Zenit,1783,4,7,9,4,22,16,6,30
Terek Grozny,1783,5,8,5,7,22,25,-3,29
Krasnodar,1783,6,8,4,8,28,28,0,28
FK Rubin,1783,7,7,5,8,25,19,6,26
Din Moscow,1783,8,5,6,9,18,24,-6,21
Rostov,1783,9,4,6,10,11,20,-9,18
Amkar,1783,10,4,5,11,10,24,-14,17
Anzhi,1783,11,3,6,11,19,40,-21,15
Loko Moscow,1784,1,11,6,3,30,13,17,39
CSKA Moscow,1784,2,11,4,5,28,18,10,37
Spart Moscow,1784,3,10,6,4,40,27,13,36
Zenit,1784,4,8,9,3,22,13,9,33
Krasnodar,1784,5,8,6,6,28,25,3,30
Terek Grozny,1784,6,7,5,8,22,26,-4,26
Din Moscow,1784,7,6,7,7,19,22,-3,25
FK Rubin,1784,8,5,6,9,21,18,3,21
Amkar,1784,9,5,4,11,11,26,-15,19
Rostov,1784,10,4,6,10,10,19,-9,18
Anzhi,1784,11,3,5,12,18,42,-24,14
Loko Moscow,1785,1,12,5,3,32,12,20,41
CSKA Moscow,1785,2,11,4,5,27,18,9,37
Spart Moscow,1785,3,9,7,4,37,28,9,34
Zenit,1785,4,8,9,3,22,13,9,33
Terek Grozny,1785,5,8,6,6,21,22,-1,30
Krasnodar,1785,6,8,4,8,29,30,-1,28
FK Rubin,1785,7,6,6,8,25,20,5,24
Din Moscow,1785,8,5,7,8,18,23,-5,22
Rostov,1785,9,4,7,9,12,19,-7,19
Amkar,1785,10,4,5,11,10,24,-14,17
Anzhi,1785,11,2,6,12,15,39,-24,12
Loko Moscow,1786,1,12,6,2,31,12,19,42
Spart Moscow,1786,2,10,5,5,39,29,10,35
CSKA Moscow,1786,3,10,4,6,28,22,6,34
Zenit,1786,4,8,8,4,24,15,9,32
Krasnodar,1786,5,8,6,6,30,27,3,30
Terek Grozny,1786,6,8,6,6,22,22,0,30
FK Rubin,1786,7,6,6,8,25,20,5,24
Din Moscow,1786,8,5,6,9,18,26,-8,21
Amkar,1786,9,5,5,10,11,22,-11,20
Rostov,1786,10,4,6,10,12,20,-8,18
Anzhi,1786,11,2,6,12,16,41,-25,12
Loko Moscow,1787,1,11,6,3,31,17,14,39
CSKA Moscow,1787,2,11,4,5,28,19,9,37
Krasnodar,1787,3,10,4,6,36,27,9,34
Spart Moscow,1787,4,9,6,5,38,29,9,33
Zenit,1787,5,7,10,3,23,15,8,31
Din Moscow,1787,6,7,6,7,21,22,-1,27
Terek Grozny,1787,7,7,6,7,21,24,-3,27
FK Rubin,1787,8,5,5,10,23,22,1,20
Amkar,1787,9,5,5,10,10,22,-12,20
Rostov,1787,10,4,6,10,11,21,-10,18
Anzhi,1787,11,2,6,12,16,40,-24,12
Loko Moscow,1788,1,13,5,2,34,11,23,44
CSKA Moscow,1788,2,12,3,5,30,18,12,39
Spart Moscow,1788,3,10,6,4,39,29,10,36
Krasnodar,1788,4,9,4,7,28,26,2,31
Zenit,1788,5,7,8,5,21,19,2,29
Terek Grozny,1788,6,8,5,7,22,24,-2,29
Din Moscow,1788,7,5,8,7,19,23,-4,23
FK Rubin,1788,8,5,6,9,21,18,3,21
Rostov,1788,9,4,6,10,11,19,-8,18
Amkar,1788,10,4,4,12,10,25,-15,16
Anzhi,1788,11,3,5,12,17,40,-23,14
Loko Moscow,1789,1,12,5,3,31,13,18,41
CSKA Moscow,1789,2,11,3,6,26,19,7,36
Spart Moscow,1789,3,10,5,5,37,28,9,35
Zenit,1789,4,8,8,4,23,14,9,32
Krasnodar,1789,5,9,5,6,30,26,4,32
Terek Grozny,1789,6,7,5,8,20,26,-6,26
FK Rubin,1789,7,6,6,8,23,18,5,24
Din Moscow,1789,8,6,6,8,20,23,-3,24
Amkar,1789,9,5,4,11,11,24,-13,19
Rostov,1789,10,4,6,10,10,18,-8,18
Anzhi,1789,11,3,5,12,16,38,-22,14
Loko Moscow,1790,1,11,6,3,31,14,17,39
CSKA Moscow,1790,2,12,3,5,27,17,10,39
Spart Moscow,1790,3,11,5,4,45,27,18,38
Krasnodar,1790,4,10,4,6,33,27,6,34
Zenit,1790,5,7,9,4,22,15,7,30
Terek Grozny,1790,6,8,5,7,22,23,-1,29
FK Rubin,1790,7,6,5,9,25,22,3,23
Din Moscow,1790,8,5,6,9,19,26,-7,21
Amkar,1790,9,5,4,11,11,29,-18,19
Rostov,1790,10,4,6,10,10,19,-9,18
Anzhi,1790,11,2,5,13,14,40,-26,11
Loko Moscow,1791,1,12,5,3,30,13,17,41
Krasnodar,1791,2,10,4,6,32,24,8,34
CSKA Moscow,1791,3,10,4,6,26,22,4,34
Zenit,1791,4,8,8,4,25,14,11,32
Spart Moscow,1791,5,8,7,5,36,32,4,31
Terek Grozny,1791,6,7,6,7,20,23,-3,27
Din Moscow,1791,7,6,7,7,21,23,-2,25
FK Rubin,1791,8,5,5,10,21,22,-1,20
Amkar,1791,9,5,5,10,13,22,-9,20
Rostov,1791,10,4,7,9,11,18,-7,19
Anzhi,1791,11,3,6,11,16,38,-22,15
Loko Moscow,1792,1,11,6,3,30,13,17,39
CSKA Moscow,1792,2,11,3,6,29,19,10,36
Spart Moscow,1792,3,9,6,5,34,26,8,33
Krasnodar,1792,4,9,5,6,31,26,5,32
Zenit,1792,5,8,8,4,22,17,5,32
Terek Grozny,1792,6,8,5,7,22,25,-3,29
Din Moscow,1792,7,5,7,8,18,23,-5,22
FK Rubin,1792,8,5,6,9,23,21,2,21
Rostov,1792,9,5,6,9,11,17,-6,21
Amkar,1792,10,5,5,10,12,22,-10,20
Anzhi,1792,11,3,5,12,16,39,-23,14
Loko Moscow,1793,1,11,5,4,31,15,16,38
CSKA Moscow,1793,2,11,4,5,28,17,11,37
Zenit,1793,3,8,9,3,23,14,9,33
Spart Moscow,1793,4,9,5,6,36,30,6,32
Krasnodar,1793,5,9,5,6,31,27,4,32
Terek Grozny,1793,6,8,6,6,23,23,0,30
Din Moscow,1793,7,7,6,7,20,22,-2,27
FK Rubin,1793,8,5,6,9,23,20,3,21
Amkar,1793,9,5,5,10,13,23,-10,20
Rostov,1793,10,4,6,10,10,19,-9,18
Anzhi,1793,11,2,5,13,14,42,-28,11
Loko Moscow,1794,1,11,7,2,31,13,18,40
CSKA Moscow,1794,2,11,4,5,28,19,9,37
Krasnodar,1794,3,9,5,6,30,25,5,32
Terek Grozny,1794,4,9,5,6,23,23,0,32
Zenit,1794,5,7,10,3,23,15,8,31
Spart Moscow,1794,6,8,6,6,38,32,6,30
Din Moscow,1794,7,7,6,7,22,24,-2,27
Rostov,1794,8,5,6,9,12,18,-6,21
FK Rubin,1794,9,5,5,10,23,22,1,20
Amkar,1794,10,4,5,11,13,27,-14,17
Anzhi,1794,11,2,5,13,15,40,-25,11
Loko Moscow,1795,1,11,7,2,31,13,18,40
Spart Moscow,1795,2,10,6,4,37,27,10,36
CSKA Moscow,1795,3,10,4,6,26,24,2,34
Zenit,1795,4,8,9,3,27,13,14,33
Krasnodar,1795,5,8,5,7,29,30,-1,29
Terek Grozny,1795,6,7,5,8,21,25,-4,26
Din Moscow,1795,7,6,6,8,19,23,-4,24
FK Rubin,1795,8,6,5,9,25,18,7,23
Amkar,1795,9,5,5,10,11,23,-12,20
Rostov,1795,10,4,6,10,10,18,-8,18
Anzhi,1795,11,3,6,11,17,39,-22,15
Loko Moscow,1796,1,11,6,3,31,16,15,39
Spart Moscow,1796,2,10,6,4,37,26,11,36
CSKA Moscow,1796,3,10,5,5,26,18,8,35
Krasnodar,1796,4,10,4,6,33,26,7,34
Zenit,1796,5,7,10,3,23,15,8,31
Terek Grozny,1796,6,7,5,8,21,27,-6,26
FK Rubin,1796,7,6,5,9,24,19,5,23
Din Moscow,1796,8,5,6,9,17,24,-7,21
Rostov,1796,9,4,7,9,11,18,-7,19
Amkar,1796,10,5,4,11,12,25,-13,19
Anzhi,1796,11,3,6,11,16,37,-21,15
Loko Moscow,1797,1,12,6,2,32,13,19,42
CSKA Moscow,1797,2,11,4,5,28,18,10,37
Spart Moscow,1797,3,9,6,5,34,27,7,33
Zenit,1797,4,7,9,4,23,16,7,30
Krasnodar,1797,5,8,6,6,29,26,3,30
Terek Grozny,1797,6,7,6,7,20,26,-6,27
FK Rubin,1797,7,6,6,8,23,18,5,24
Din Moscow,1797,8,6,6,8,19,22,-3,24
Rostov,1797,9,4,6,10,10,18,-8,18
Amkar,1797,10,4,6,10,9,22,-13,18
Anzhi,1797,11,3,5,12,18,39,-21,14
Loko Moscow,1798,1,11,6,3,31,14,17,39
CSKA Moscow,1798,2,10,5,5,26,18,8,35
Zenit,1798,3,8,9,3,23,14,9,33
Spart Moscow,1798,4,9,6,5,34,26,8,33
Krasnodar,1798,5,8,5,7,29,27,2,29
Terek Grozny,1798,6,8,5,7,22,23,-1,29
Din Moscow,1798,7,6,6,8,19,22,-3,24
FK Rubin,1798,8,6,5,9,23,20,3,23
Amkar,1798,9,6,4,10,11,22,-11,22
Rostov,1798,10,4,7,9,10,17,-7,19
Anzhi,1798,11,2,6,12,15,40,-25,12
Loko Moscow,1799,1,11,6,3,30,13,17,39
Zenit,1799,2,9,8,3,24,13,11,35
CSKA Moscow,1799,3,10,3,7,25,21,4,33
Spart Moscow,1799,4,9,5,6,36,31,5,32
Krasnodar,1799,5,8,6,6,28,25,3,30
Terek Grozny,1799,6,7,6,7,23,26,-3,27
Din Moscow,1799,7,6,7,7,21,23,-2,25
FK Rubin,1799,8,5,7,8,22,18,4,22
Rostov,1799,9,5,6,9,13,18,-5,21
Amkar,1799,10,5,4,11,12,25,-13,19
Anzhi,1799,11,3,6,11,17,38,-21,15
Loko Moscow,1800,1,11,6,3,31,15,16,39
CSKA Moscow,1800,2,11,4,5,27,18,9,37
Spart Moscow,1800,3,9,7,4,39,28,11,34
Zenit,1800,4,8,9,3,24,14,10,33
Krasnodar,1800,5,9,5,6,30,25,5,32
Terek Grozny,1800,6,7,7,6,22,24,-2,28
FK Rubin,1800,7,6,5,9,22,19,3,23
Din Moscow,1800,8,5,6,9,18,26,-8,21
Rostov,1800,9,4,7,9,11,18,-7,19
Amkar,1800,10,4,6,10,10,23,-13,18
Anzhi,1800,11,2,6,12,17,41,-24,12
Loko Moscow,1801,1,13,5,2,32,12,20,44
CSKA Moscow,1801,2,12,3,5,29,18,11,39
Spart Moscow,1801,3,9,5,6,35,29,6,32
Terek Grozny,1801,4,9,5,6,25,24,1,32
Zenit,1801,5,7,8,5,21,15,6,29
Krasnodar,1801,6,8,5,7,28,26,2,29
FK Rubin,1801,7,6,6,8,22,17,5,24
Rostov,1801,8,5,6,9,12,17,-5,21
Din Moscow,1801,9,5,6,9,17,23,-6,21
Amkar,1801,10,5,4,11,12,26,-14,19
Anzhi,1801,11,2,5,13,16,42,-26,11
Loko Moscow,1802,1,13,5,2,32,12,20,44
CSKA Moscow,1802,2,11,3,6,28,20,8,36
Spart Moscow,1802,3,9,5,6,36,28,8,32
Zenit,1802,4,8,8,4,23,15,8,32
Krasnodar,1802,5,8,5,7,28,26,2,29
Terek Grozny,1802,6,8,5,7,24,25,-1,29
FK Rubin,1802,7,6,6,8,24,18,6,24
Din Moscow,1802,8,6,6,8,19,24,-5,24
Amkar,1802,9,6,4,10,14,24,-10,22
Rostov,1802,10,4,6,10,10,19,-9,18
Anzhi,1802,11,2,5,13,15,42,-27,11
Loko Moscow,1803,1,12,5,3,32,14,18,41
CSKA Moscow,1803,2,11,4,5,30,20,10,37
Zenit,1803,3,8,9,3,25,16,9,33
Spart Moscow,1803,4,8,5,7,34,31,3,29
Krasnodar,1803,5,8,4,8,28,27,1,28
Din Moscow,1803,6,7,6,7,22,23,-1,27
Terek Grozny,1803,7,7,5,8,22,27,-5,26
FK Rubin,1803,8,6,5,9,23,19,4,23
Amkar,1803,9,6,4,10,12,23,-11,22
Rostov,1803,10,5,6,9,12,17,-5,21
Anzhi,1803,11,3,5,12,18,41,-23,14
Loko Moscow,1804,1,12,6,2,32,12,20,42
CSKA Moscow,1804,2,11,3,6,27,20,7,36
Spart Moscow,1804,3,9,6,5,35,28,7,33
Zenit,1804,4,8,8,4,23,15,8,32
Krasnodar,1804,5,9,5,6,29,25,4,32
Terek Grozny,1804,6,9,5,6,23,22,1,32
Din Moscow,1804,7,5,8,7,18,22,-4,23
FK Rubin,1804,8,5,6,9,21,18,3,21
Amkar,1804,9,5,4,11,11,24,-13,19
Rostov,1804,10,4,6,10,10,18,-8,18
Anzhi,1804,11,2,5,13,15,40,-25,11
Loko Moscow,1805,1,12,6,2,32,13,19,42
CSKA Moscow,1805,2,11,3,6,26,20,6,36
Zenit,1805,3,8,8,4,26,16,10,32
Spart Moscow,1805,4,9,5,6,37,29,8,32
Krasnodar,1805,5,8,6,6,27,24,3,30
Terek Grozny,1805,6,8,5,7,23,23,0,29
Din Moscow,1805,7,6,7,7,20,22,-2,25
FK Rubin,1805,8,5,7,8,22,18,4,22
Rostov,1805,9,5,6,9,12,18,-6,21
Amkar,1805,10,4,4,12,9,28,-19,16
Anzhi,1805,11,3,5,12,15,38,-23,14
Loko Moscow,1806,1,13,5,2,34,11,23,44
CSKA Moscow,1806,2,12,3,5,32,17,15,39
Spart Moscow,1806,3,11,5,4,41,25,16,38
Terek Grozny,1806,4,9,5,6,22,22,0,32
Zenit,1806,5,7,8,5,21,19,2,29
Krasnodar,1806,6,8,4,8,27,27,0,28
FK Rubin,1806,7,6,6,8,23,18,5,24
Din Moscow,1806,8,5,7,8,18,27,-9,22
Rostov,1806,9,4,6,10,10,18,-8,18
Amkar,1806,10,4,4,12,9,25,-16,16
Anzhi,1806,11,2,5,13,14,42,-28,11
Loko Moscow,1807,1,12,5,3,32,14,18,41
Zenit,1807,2,9,8,3,26,15,11,35
CSKA Moscow,1807,3,10,3,7,25,20,5,33
Spart Moscow,1807,4,9,5,6,38,30,8,32
Krasnodar,1807,5,8,4,8,29,29,0,28
Terek Grozny,1807,6,7,7,6,21,23,-2,28
FK Rubin,1807,7,7,5,8,26,19,7,26
Din Moscow,1807,8,6,6,8,19,23,-4,24
Amkar,1807,9,5,5,10,12,24,-12,20
Rostov,1807,10,4,6,10,10,19,-9,18
Anzhi,1807,11,3,6,11,16,38,-22,15
Loko Moscow,1808,1,12,5,3,30,12,18,41
Spart Moscow,1808,2,11,5,4,41,25,16,38
CSKA Moscow,1808,3,11,4,5,30,18,12,37
Krasnodar,1808,4,9,5,6,29,25,4,32
Zenit,1808,5,7,9,4,22,15,7,30
Terek Grozny,1808,6,8,5,7,22,24,-2,29
Din Moscow,1808,7,6,6,8,19,26,-7,24
FK Rubin,1808,8,5,6,9,23,20,3,21
Amkar,1808,9,5,4,11,10,23,-13,19
Rostov,1808,10,4,6,10,10,20,-10,18
Anzhi,1808,11,2,5,13,15,43,-28,11
Loko Moscow,1809,1,12,6,2,30,11,19,42
Spart Moscow,1809,2,11,5,4,38,26,12,38
CSKA Moscow,1809,3,11,3,6,29,21,8,36
Zenit,1809,4,8,9,3,24,15,9,33
Krasnodar,1809,5,8,5,7,27,25,2,29
Terek Grozny,1809,6,7,5,8,20,27,-7,26
FK Rubin,1809,7,5,7,8,21,17,4,22
Din Moscow,1809,8,5,7,8,18,23,-5,22
Amkar,1809,9,5,4,11,13,23,-10,19
Rostov,1809,10,4,6,10,10,19,-9,18
Anzhi,1809,11,3,5,12,16,39,-23,14
Loko Moscow,1810,1,11,6,3,30,15,15,39
Spart Moscow,1810,2,10,6,4,38,27,11,36
CSKA Moscow,1810,3,11,3,6,27,20,7,36
Zenit,1810,4,8,9,3,24,14,10,33
Krasnodar,1810,5,9,5,6,32,26,6,32
Terek Grozny,1810,6,7,6,7,20,24,-4,27
Din Moscow,1810,7,6,6,8,19,24,-5,24
FK Rubin,1810,8,5,6,9,23,20,3,21
Rostov,1810,9,4,7,9,11,18,-7,19
Amkar,1810,10,5,4,11,11,23,-12,19
Anzhi,1810,11,2,6,12,15,39,-24,12
Loko Moscow,1811,1,12,6,2,32,12,20,42
CSKA Moscow,1811,2,11,3,6,27,19,8,36
Spart Moscow,1811,3,9,7,4,35,26,9,34
Zenit,1811,4,8,9,3,22,13,9,33
Terek Grozny,1811,5,9,5,6,23,23,0,32
Krasnodar,1811,6,9,4,7,34,28,6,31
Din Moscow,1811,7,6,7,7,19,22,-3,25
FK Rubin,1811,8,5,5,10,23,25,-2,20
Rostov,1811,9,4,7,9,11,18,-7,19
Amkar,1811,10,4,4,12,10,25,-15,16
Anzhi,1811,11,2,5,13,15,40,-25,11
Loko Moscow,1812,1,11,6,3,31,14,17,39
Spart Moscow,1812,2,10,6,4,39,27,12,36
CSKA Moscow,1812,3,11,3,6,26,19,7,36
Zenit,1812,4,8,9,3,25,15,10,33
Krasnodar,1812,5,9,4,7,28,25,3,31
Terek Grozny,1812,6,8,5,7,23,26,-3,29
Din Moscow,1812,7,6,6,8,18,22,-4,24
FK Rubin,1812,8,6,5,9,22,18,4,23
Rostov,1812,9,4,6,10,11,21,-10,18
Amkar,1812,10,4,5,11,10,25,-15,17
Anzhi,1812,11,3,5,12,18,39,-21,14
Loko Moscow,1813,1,12,5,3,31,14,17,41
Spart Moscow,1813,2,10,6,4,40,27,13,36
CSKA Moscow,1813,3,11,3,6,30,20,10,36
Zenit,1813,4,9,8,3,26,14,12,35
Terek Grozny,1813,5,8,5,7,22,24,-2,29
Krasnodar,1813,6,8,4,8,29,28,1,28
FK Rubin,1813,7,7,5,8,26,19,7,26
Din Moscow,1813,8,5,7,8,19,25,-6,22
Rostov,1813,9,4,6,10,11,20,-9,18
Amkar,1813,10,4,4,12,10,27,-17,16
Anzhi,1813,11,3,5,12,15,41,-26,14
Loko Moscow,1814,1,12,6,2,33,13,20,42
CSKA Moscow,1814,2,11,3,6,27,19,8,36
Zenit,1814,3,8,9,3,24,15,9,33
Spart Moscow,1814,4,9,5,6,36,28,8,32
Krasnodar,1814,5,8,5,7,29,28,1,29
Terek Grozny,1814,6,8,5,7,23,27,-4,29
FK Rubin,1814,7,5,7,8,23,19,4,22
Din Moscow,1814,8,5,7,8,18,25,-7,22
Amkar,1814,9,6,4,10,14,22,-8,22
Rostov,1814,10,5,6,9,11,17,-6,21
Anzhi,1814,11,2,5,13,16,41,-25,11
Loko Moscow,1815,1,13,5,2,32,12,20,44
CSKA Moscow,1815,2,12,3,5,29,17,12,39
Spart Moscow,1815,3,10,6,4,40,27,13,36
Krasnodar,1815,4,9,4,7,30,27,3,31
Zenit,1815,5,7,8,5,21,16,5,29
Terek Grozny,1815,6,8,5,7,22,23,-1,29
Din Moscow,1815,7,6,6,8,20,24,-4,24
FK Rubin,1815,8,5,5,10,22,21,1,20
Rostov,1815,9,4,7,9,11,18,-7,19
Amkar,1815,10,5,4,11,10,25,-15,19
Anzhi,1815,11,2,5,13,14,41,-27,11
Loko Moscow,1816,1,11,6,3,31,14,17,39
Spart Moscow,1816,2,10,5,5,40,28,12,35
Zenit,1816,3,9,8,3,25,14,11,35
CSKA Moscow,1816,4,10,3,7,26,21,5,33
Krasnodar,1816,5,9,5,6,30,25,5,32
Terek Grozny,1816,6,8,6,6,23,23,0,30
FK Rubin,1816,7,6,5,9,22,19,3,23
Rostov,1816,8,5,6,9,13,17,-4,21
Din Moscow,1816,9,5,6,9,17,24,-7,21
Amkar,1816,10,4,5,11,10,28,-18,17
Anzhi,1816,11,3,5,12,16,40,-24,14
Loko Moscow,1817,1,12,6,2,32,11,21,42
CSKA Moscow,1817,2,11,3,6,28,19,9,36
Spart Moscow,1817,3,9,6,5,39,28,11,33
Zenit,1817,4,8,8,4,23,17,6,32
Krasnodar,1817,5,9,5,6,29,24,5,32
Terek Grozny,1817,6,7,7,6,21,23,-2,28
Din Moscow,1817,7,6,7,7,22,23,-1,25
FK Rubin,1817,8,5,5,10,21,22,-1,20
Amkar,1817,9,5,5,10,11,23,-12,20
Rostov,1817,10,4,6,10,10,21,-11,18
Anzhi,1817,11,2,6,12,14,39,-25,12
Loko Moscow,1818,1,11,7,2,31,13,18,40
CSKA Moscow,1818,2,11,3,6,30,19,11,36
Zenit,1818,3,8,9,3,23,14,9,33
Spart Moscow,1818,4,8,6,6,36,31,5,30
Krasnodar,1818,5,8,5,7,28,26,2,29
Terek Grozny,1818,6,7,6,7,22,25,-3,27
FK Rubin,1818,7,7,5,8,23,17,6,26
Din Moscow,1818,8,6,6,8,20,23,-3,24
Rostov,1818,9,5,6,9,13,19,-6,21
Amkar,1818,10,4,6,10,10,23,-13,18
Anzhi,1818,11,3,5,12,17,43,-26,14
Loko Moscow,1819,1,13,5,2,32,11,21,44
CSKA Moscow,1819,2,11,4,5,27,18,9,37
Spart Moscow,1819,3,9,6,5,36,29,7,33
Krasnodar,1819,4,9,4,7,32,29,3,31
Zenit,1819,5,7,8,5,21,16,5,29
Terek Grozny,1819,6,7,6,7,20,23,-3,27
FK Rubin,1819,7,6,5,9,27,22,5,23
Amkar,1819,8,6,4,10,12,22,-10,22
Din Moscow,1819,9,5,6,9,17,24,-7,21
Rostov,1819,10,4,7,9,12,19,-7,19
Anzhi,1819,11,2,7,11,15,38,-23,13
Loko Moscow,1820,1,11,6,3,30,14,16,39
CSKA Moscow,1820,2,11,3,6,28,21,7,36
Spart Moscow,1820,3,9,6,5,38,26,12,33
Zenit,1820,4,8,9,3,25,13,12,33
Krasnodar,1820,5,9,5,6,31,26,5,32
Terek Grozny,1820,6,7,5,8,20,24,-4,26
Din Moscow,1820,7,6,6,8,18,26,-8,24
Amkar,1820,8,6,4,10,11,22,-11,22
FK Rubin,1820,9,5,6,9,22,19,3,21
Rostov,1820,10,4,7,9,10,17,-7,19
Anzhi,1820,11,3,5,12,15,40,-25,14
Loko Moscow,1821,1,11,7,2,31,13,18,40
CSKA Moscow,1821,2,11,3,6,30,20,10,36
Zenit,1821,3,8,9,3,25,15,10,33
Spart Moscow,1821,4,9,5,6,35,28,7,32
Krasnodar,1821,5,8,5,7,29,27,2,29
Terek Grozny,1821,6,7,7,6,23,25,-2,28
Din Moscow,1821,7,6,6,8,19,23,-4,24
FK Rubin,1821,8,6,5,9,23,19,4,23
Rostov,1821,9,5,6,9,11,17,-6,21
Amkar,1821,10,5,5,10,11,23,-12,20
Anzhi,1821,11,2,6,12,16,43,-27,12
Loko Moscow,1822,1,11,6,3,30,14,16,39
CSKA Moscow,1822,2,11,3,6,28,19,9,36
Zenit,1822,3,9,8,3,25,14,11,35
Spart Moscow,1822,4,10,5,5,37,28,9,35
Krasnodar,1822,5,8,5,7,29,27,2,29
Terek Grozny,1822,6,8,5,7,23,25,-2,29
Din Moscow,1822,7,6,6,8,19,22,-3,24
FK Rubin,1822,8,6,5,9,23,20,3,23
Amkar,1822,9,5,4,11,12,25,-13,19
Rostov,1822,10,4,6,10,11,19,-8,18
Anzhi,1822,11,3,5,12,16,40,-24,14
Loko Moscow,1823,1,12,5,3,31,13,18,41
CSKA Moscow,1823,2,12,3,5,29,17,12,39
Krasnodar,1823,3,10,4,6,30,25,5,34
Spart Moscow,1823,4,9,6,5,35,29,6,33
Zenit,1823,5,7,8,5,21,15,6,29
Terek Grozny,1823,6,7,5,8,21,25,-4,26
Din Moscow,1823,7,5,7,8,17,22,-5,22
FK Rubin,1823,8,5,6,9,21,18,3,21
Rostov,1823,9,5,6,9,13,17,-4,21
Amkar,1823,10,5,5,10,12,24,-12,20
Anzhi,1823,11,3,5,12,15,40,-25,14
Loko Moscow,1824,1,11,5,4,30,16,14,38
Spart Moscow,1824,2,10,5,5,41,27,14,35
Zenit,1824,3,9,8,3,25,13,12,35
Krasnodar,1824,4,10,4,6,31,25,6,34
CSKA Moscow,1824,5,10,3,7,25,20,5,33
Terek Grozny,1824,6,8,5,7,24,25,-1,29
Din Moscow,1824,7,6,6,8,18,27,-9,24
Rostov,1824,8,5,6,9,11,17,-6,21
FK Rubin,1824,9,5,5,10,21,19,2,20
Anzhi,1824,10,4,5,11,17,38,-21,17
Amkar,1824,11,4,4,12,11,27,-16,16
Loko Moscow,1825,1,11,7,2,32,14,18,40
Spart Moscow,1825,2,11,5,4,43,28,15,38
CSKA Moscow,1825,3,11,3,6,29,20,9,36
Zenit,1825,4,8,9,3,24,15,9,33
Terek Grozny,1825,5,8,6,6,23,24,-1,30
Krasnodar,1825,6,8,5,7,31,29,2,29
FK Rubin,1825,7,6,6,8,24,19,5,24
Din Moscow,1825,8,5,7,8,18,25,-7,22
Rostov,1825,9,4,6,10,11,20,-9,18
Amkar,1825,10,4,4,12,12,28,-16,16
Anzhi,1825,11,2,6,12,15,40,-25,12
Loko Moscow,1826,1,13,5,2,33,13,20,44
Spart Moscow,1826,2,10,6,4,39,28,11,36
CSKA Moscow,1826,3,11,3,6,29,20,9,36
Zenit,1826,4,8,8,4,24,15,9,32
Terek Grozny,1826,5,8,6,6,25,25,0,30
Krasnodar,1826,6,8,4,8,30,30,0,28
Din Moscow,1826,7,6,6,8,20,24,-4,24
FK Rubin,1826,8,6,5,9,24,20,4,23
Rostov,1826,9,4,6,10,10,18,-8,18
Amkar,1826,10,4,6,10,12,25,-13,18
Anzhi,1826,11,2,5,13,16,44,-28,11
Loko Moscow,1827,1,12,5,3,30,12,18,41
CSKA Moscow,1827,2,11,4,5,27,18,9,37
Krasnodar,1827,3,10,4,6,31,26,5,34
Spart Moscow,1827,4,9,6,5,38,29,9,33
Zenit,1827,5,7,9,4,22,15,7,30
Terek Grozny,1827,6,8,5,7,23,23,0,29
Din Moscow,1827,7,6,6,8,19,24,-5,24
Amkar,1827,8,6,4,10,13,24,-11,22
FK Rubin,1827,9,5,5,10,24,22,2,20
Rostov,1827,10,4,7,9,11,18,-7,19
Anzhi,1827,11,2,5,13,14,41,-27,11
Loko Moscow,1828,1,12,6,2,31,12,19,42
Spart Moscow,1828,2,10,6,4,39,25,14,36
CSKA Moscow,1828,3,11,3,6,30,18,12,36
Zenit,1828,4,8,8,4,22,14,8,32
Terek Grozny,1828,5,9,5,6,26,25,1,32
Krasnodar,1828,6,8,6,6,29,26,3,30
FK Rubin,1828,7,5,7,8,23,19,4,22
Din Moscow,1828,8,5,7,8,18,27,-9,22
Rostov,1828,9,4,6,10,10,18,-8,18
Amkar,1828,10,4,5,11,10,25,-15,17
Anzhi,1828,11,2,5,13,16,45,-29,11
Loko Moscow,1829,1,11,6,3,30,13,17,39
Spart Moscow,1829,2,10,6,4,38,27,11,36
CSKA Moscow,1829,3,11,3,6,31,23,8,36
Krasnodar,1829,4,10,4,6,29,24,5,34
Zenit,1829,5,8,9,3,25,15,10,33
Terek Grozny,1829,6,8,6,6,25,26,-1,30
Din Moscow,1829,7,6,6,8,18,23,-5,24
FK Rubin,1829,8,5,5,10,21,19,2,20
Rostov,1829,9,4,6,10,10,18,-8,18
Amkar,1829,10,4,6,10,14,27,-13,18
Anzhi,1829,11,2,5,13,18,44,-26,11
Loko Moscow,1830,1,12,5,3,34,15,19,41
Spart Moscow,1830,2,10,6,4,42,30,12,36
CSKA Moscow,1830,3,11,3,6,30,19,11,36
Zenit,1830,4,9,8,3,26,15,11,35
Krasnodar,1830,5,8,5,7,29,28,1,29
Terek Grozny,1830,6,7,5,8,21,27,-6,26
FK Rubin,1830,7,6,6,8,24,18,6,24
Din Moscow,1830,8,5,6,9,19,27,-8,21
Rostov,1830,9,4,7,9,11,18,-7,19
Amkar,1830,10,5,4,11,12,26,-14,19
Anzhi,1830,11,3,5,12,18,43,-25,14
Loko Moscow,1831,1,12,5,3,30,12,18,41
CSKA Moscow,1831,2,11,3,6,26,18,8,36
Zenit,1831,3,9,8,3,23,13,10,35
Spart Moscow,1831,4,9,6,5,39,32,7,33
Krasnodar,1831,5,9,4,7,31,26,5,31
Terek Grozny,1831,6,7,6,7,21,24,-3,27
Din Moscow,1831,7,5,7,8,19,25,-6,22
Amkar,1831,8,6,4,10,15,24,-9,22
FK Rubin,1831,9,5,6,9,23,22,1,21
Rostov,1831,10,4,7,9,12,19,-7,19
Anzhi,1831,11,2,6,12,14,38,-24,12
Spart Moscow,1832,1,11,5,4,45,28,17,38
Loko Moscow,1832,2,11,5,4,32,18,14,38
CSKA Moscow,1832,3,11,4,5,28,19,9,37
Krasnodar,1832,4,10,4,6,31,24,7,34
Zenit,1832,5,8,9,3,26,16,10,33
Terek Grozny,1832,6,7,5,8,22,27,-5,26
Din Moscow,1832,7,6,6,8,21,28,-7,24
FK Rubin,1832,8,5,5,10,23,23,0,20
Amkar,1832,9,5,4,11,14,26,-12,19
Rostov,1832,10,4,6,10,11,21,-10,18
Anzhi,1832,11,3,5,12,18,41,-23,14
Loko Moscow,1833,1,13,5,2,33,13,20,44
Spart Moscow,1833,2,10,6,4,41,26,15,36
CSKA Moscow,1833,3,11,3,6,32,19,13,36
Zenit,1833,4,8,8,4,23,15,8,32
Terek Grozny,1833,5,8,6,6,23,23,0,30
Krasnodar,1833,6,8,5,7,30,28,2,29
Din Moscow,1833,7,6,6,8,19,27,-8,24
FK Rubin,1833,8,5,6,9,23,20,3,21
Rostov,1833,9,4,6,10,10,19,-9,18
Amkar,1833,10,4,6,10,11,24,-13,18
Anzhi,1833,11,2,5,13,14,45,-31,11
Loko Moscow,1834,1,12,5,3,32,13,19,41
CSKA Moscow,1834,2,12,3,5,29,18,11,39
Spart Moscow,1834,3,9,6,5,37,29,8,33
Zenit,1834,4,8,8,4,23,15,8,32
Krasnodar,1834,5,9,4,7,28,26,2,31
Terek Grozny,1834,6,7,6,7,22,25,-3,27
Din Moscow,1834,7,6,6,8,19,24,-5,24
FK Rubin,1834,8,6,5,9,23,18,5,23
Rostov,1834,9,4,7,9,11,18,-7,19
Amkar,1834,10,5,4,11,12,25,-13,19
Anzhi,1834,11,2,6,12,16,41,-25,12
Loko Moscow,1835,1,11,7,2,31,13,18,40
Spart Moscow,1835,2,11,5,4,38,25,13,38
CSKA Moscow,1835,3,11,4,5,30,18,12,37
Krasnodar,1835,4,9,5,6,31,27,4,32
Zenit,1835,5,7,10,3,22,14,8,31
Terek Grozny,1835,6,8,6,6,25,26,-1,30
Din Moscow,1835,7,6,6,8,19,23,-4,24
FK Rubin,1835,8,5,5,10,24,22,2,20
Rostov,1835,9,4,6,10,10,19,-9,18
Amkar,1835,10,4,5,11,11,26,-15,17
Anzhi,1835,11,2,5,13,17,45,-28,11
Loko Moscow,1836,1,11,6,3,31,15,16,39
CSKA Moscow,1836,2,11,4,5,29,17,12,37
Spart Moscow,1836,3,9,5,6,38,30,8,32
Krasnodar,1836,4,9,5,6,32,27,5,32
Zenit,1836,5,7,10,3,21,13,8,31
Terek Grozny,1836,6,7,6,7,23,27,-4,27
FK Rubin,1836,7,5,7,8,22,18,4,22
Din Moscow,1836,8,5,7,8,17,24,-7,22
Rostov,1836,9,5,6,9,13,19,-6,21
Amkar,1836,10,5,5,10,13,24,-11,20
Anzhi,1836,11,3,5,12,17,42,-25,14
Loko Moscow,1837,1,11,5,4,30,14,16,38
CSKA Moscow,1837,2,11,3,6,31,19,12,36
Zenit,1837,3,9,8,3,24,14,10,35
Krasnodar,1837,4,10,4,6,31,24,7,34
Spart Moscow,1837,5,9,6,5,39,32,7,33
Terek Grozny,1837,6,7,5,8,20,24,-4,26
Din Moscow,1837,7,6,7,7,19,22,-3,25
Rostov,1837,8,5,6,9,13,18,-5,21
FK Rubin,1837,9,5,5,10,21,21,0,20
Amkar,1837,10,5,4,11,13,26,-13,19
Anzhi,1837,11,3,5,12,16,43,-27,14
Loko Moscow,1838,1,12,5,3,31,14,17,41
Zenit,1838,2,9,8,3,24,13,11,35
Spart Moscow,1838,3,9,7,4,37,27,10,34
CSKA Moscow,1838,4,10,3,7,27,21,6,33
Terek Grozny,1838,5,9,5,6,23,23,0,32
Krasnodar,1838,6,8,4,8,28,28,0,28
Din Moscow,1838,7,6,6,8,19,24,-5,24
FK Rubin,1838,8,6,5,9,24,19,5,23
Rostov,1838,9,4,7,9,12,19,-7,19
Amkar,1838,10,4,5,11,9,23,-14,17
Anzhi,1838,11,3,5,12,18,41,-23,14
Loko Moscow,1839,1,12,6,2,32,12,20,42
CSKA Moscow,1839,2,10,5,5,27,19,8,35
Spart Moscow,1839,3,9,6,5,36,29,7,33
Zenit,1839,4,7,9,4,21,15,6,30
Krasnodar,1839,5,8,6,6,28,25,3,30
Terek Grozny,1839,6,8,6,6,24,25,-1,30
Din Moscow,1839,7,6,7,7,20,23,-3,25
FK Rubin,1839,8,5,6,9,22,19,3,21
Amkar,1839,9,5,5,10,14,24,-10,20
Rostov,1839,10,4,6,10,10,19,-9,18
Anzhi,1839,11,2,6,12,17,41,-24,12
Loko Moscow,1840,1,12,6,2,32,13,19,42
Spart Moscow,1840,2,10,6,4,39,28,11,36
CSKA Moscow,1840,3,10,5,5,26,18,8,35
Krasnodar,1840,4,9,5,6,34,27,7,32
Zenit,1840,5,7,9,4,21,14,7,30
Terek Grozny,1840,6,8,6,6,22,22,0,30
Din Moscow,1840,7,6,6,8,20,25,-5,24
FK Rubin,1840,8,5,5,10,22,23,-1,20
Rostov,1840,9,4,6,10,10,18,-8,18
Amkar,1840,10,4,6,10,10,23,-13,18
Anzhi,1840,11,2,6,12,15,40,-25,12
Loko Moscow,1841,1,12,6,2,30,11,19,42
CSKA Moscow,1841,2,12,3,5,29,18,11,39
Spart Moscow,1841,3,10,5,5,35,27,8,35
Krasnodar,1841,4,8,6,6,28,25,3,30
Zenit,1841,5,7,8,5,21,15,6,29
Terek Grozny,1841,6,7,5,8,20,25,-5,26
Din Moscow,1841,7,6,6,8,21,22,-1,24
Amkar,1841,8,6,4,10,12,22,-10,22
FK Rubin,1841,9,5,6,9,22,22,0,21
Rostov,1841,10,4,6,10,10,18,-8,18
Anzhi,1841,11,3,5,12,17,40,-23,14
Loko Moscow,1842,1,12,5,3,30,12,18,41
Spart Moscow,1842,2,11,5,4,41,28,13,38
CSKA Moscow,1842,3,10,5,5,27,19,8,35
Zenit,1842,4,8,9,3,23,14,9,33
Krasnodar,1842,5,8,5,7,29,27,2,29
Terek Grozny,1842,6,7,5,8,21,27,-6,26
Din Moscow,1842,7,6,6,8,21,25,-4,24
FK Rubin,1842,8,5,6,9,23,21,2,21
Amkar,1842,9,5,4,11,13,26,-13,19
Rostov,1842,10,4,6,10,10,18,-8,18
Anzhi,1842,11,3,6,11,17,38,-21,15
Loko Moscow,1843,1,11,5,4,29,14,15,38
Spart Moscow,1843,2,10,5,5,40,28,12,35
Zenit,1843,3,9,8,3,26,16,10,35
CSKA Moscow,1843,4,10,4,6,29,22,7,34
Krasnodar,1843,5,9,4,7,30,26,4,31
Terek Grozny,1843,6,8,6,6,24,24,0,30
FK Rubin,1843,7,7,5,8,25,18,7,26
Din Moscow,1843,8,5,6,9,17,24,-7,21
Amkar,1843,9,5,4,11,13,27,-14,19
Rostov,1843,10,4,6,10,10,21,-11,18
Anzhi,1843,11,2,7,11,16,39,-23,13
Loko Moscow,1844,1,12,6,2,32,13,19,42
CSKA Moscow,1844,2,12,3,5,29,18,11,39
Spart Moscow,1844,3,9,5,6,39,31,8,32
Krasnodar,1844,4,8,6,6,29,26,3,30
Zenit,1844,5,7,8,5,23,18,5,29
Terek Grozny,1844,6,7,5,8,20,25,-5,26
Din Moscow,1844,7,6,6,8,19,26,-7,24
Amkar,1844,8,6,4,10,13,23,-10,22
FK Rubin,1844,9,5,6,9,22,19,3,21
Rostov,1844,10,5,6,9,12,17,-5,21
Anzhi,1844,11,3,5,12,16,38,-22,14
Loko Moscow,1845,1,11,7,2,32,14,18,40
CSKA Moscow,1845,2,11,3,6,27,18,9,36
Spart Moscow,1845,3,9,6,5,38,29,9,33
Zenit,1845,4,8,9,3,24,15,9,33
Krasnodar,1845,5,9,5,6,31,26,5,32
Terek Grozny,1845,6,7,6,7,20,23,-3,27
FK Rubin,1845,7,6,5,9,23,20,3,23
Din Moscow,1845,8,5,7,8,19,24,-5,22
Amkar,1845,9,5,5,10,11,22,-11,20
Rostov,1845,10,4,6,10,10,20,-10,18
Anzhi,1845,11,3,5,12,15,39,-24,14
Spart Moscow,1846,1,11,5,4,39,26,13,38
Loko Moscow,1846,2,11,5,4,29,17,12,38
CSKA Moscow,1846,3,10,5,5,27,19,8,35
Krasnodar,1846,4,10,4,6,32,24,8,34
Zenit,1846,5,8,9,3,24,14,10,33
Terek Grozny,1846,6,8,6,6,23,23,0,30
Din Moscow,1846,7,6,6,8,19,22,-3,24
FK Rubin,1846,8,5,5,10,21,20,1,20
Rostov,1846,9,4,6,10,10,20,-10,18
Amkar,1846,10,4,4,12,10,26,-16,16
Anzhi,1846,11,2,7,11,16,39,-23,13
Loko Moscow,1847,1,12,5,3,34,17,17,41
Zenit,1847,2,9,8,3,26,14,12,35
CSKA Moscow,1847,3,10,3,7,25,20,5,33
Terek Grozny,1847,4,9,5,6,23,22,1,32
Spart Moscow,1847,5,8,7,5,36,29,7,31
Krasnodar,1847,6,8,4,8,30,29,1,28
Din Moscow,1847,7,7,6,7,19,21,-2,27
FK Rubin,1847,8,6,5,9,22,18,4,23
Rostov,1847,9,4,7,9,12,19,-7,19
Amkar,1847,10,4,5,11,10,25,-15,17
Anzhi,1847,11,3,5,12,15,38,-23,14
Loko Moscow,1848,1,13,5,2,32,12,20,44
CSKA Moscow,1848,2,12,3,5,29,18,11,39
Spart Moscow,1848,3,11,5,4,41,28,13,38
Zenit,1848,4,7,8,5,22,17,5,29
Krasnodar,1848,5,8,5,7,28,26,2,29
Terek Grozny,1848,6,7,6,7,21,25,-4,27
Din Moscow,1848,7,6,6,8,19,24,-5,24
FK Rubin,1848,8,5,6,9,21,19,2,21
Amkar,1848,9,5,4,11,13,25,-12,19
Rostov,1848,10,4,6,10,11,19,-8,18
Anzhi,1848,11,2,6,12,15,39,-24,12
Loko Moscow,1849,1,12,6,2,32,13,19,42
CSKA Moscow,1849,2,10,4,6,27,20,7,34
Spart Moscow,1849,3,9,6,5,35,28,7,33
Zenit,1849,4,8,8,4,24,16,8,32
Krasnodar,1849,5,8,6,6,27,24,3,30
Terek Grozny,1849,6,8,6,6,23,23,0,30
FK Rubin,1849,7,6,6,8,22,17,5,24
Rostov,1849,8,5,6,9,13,18,-5,21
Din Moscow,1849,9,5,6,9,17,23,-6,21
Amkar,1849,10,4,5,11,9,24,-15,17
Anzhi,1849,11,2,7,11,17,40,-23,13
Loko Moscow,1850,1,12,5,3,33,13,20,41
Spart Moscow,1850,2,10,6,4,42,27,15,36
CSKA Moscow,1850,3,11,3,6,29,21,8,36
Krasnodar,1850,4,10,4,6,32,25,7,34
Zenit,1850,5,7,8,5,22,19,3,29
Terek Grozny,1850,6,7,5,8,23,28,-5,26
Din Moscow,1850,7,5,7,8,19,27,-8,22
FK Rubin,1850,8,5,6,9,23,22,1,21
Rostov,1850,9,4,7,9,12,19,-7,19
Amkar,1850,10,5,4,11,12,26,-14,19
Anzhi,1850,11,4,5,11,20,40,-20,17
Loko Moscow,1851,1,11,6,3,30,13,17,39
CSKA Moscow,1851,2,12,3,5,28,17,11,39
Spart Moscow,1851,3,10,6,4,37,27,10,36
Krasnodar,1851,4,9,5,6,31,27,4,32
Zenit,1851,5,7,9,4,21,14,7,30
Terek Grozny,1851,6,8,6,6,24,24,0,30
Din Moscow,1851,7,6,6,8,23,24,-1,24
FK Rubin,1851,8,5,6,9,24,24,0,21
Rostov,1851,9,4,7,9,11,18,-7,19
Amkar,1851,10,4,5,11,10,24,-14,17
Anzhi,1851,11,2,5,13,15,42,-27,11
Loko Moscow,1852,1,11,6,3,30,13,17,39
CSKA Moscow,1852,2,11,4,5,28,19,9,37
Spart Moscow,1852,3,10,6,4,41,26,15,36
Zenit,1852,4,8,9,3,23,14,9,33
Terek Grozny,1852,5,9,5,6,25,23,2,32
Krasnodar,1852,6,8,6,6,31,28,3,30
FK Rubin,1852,7,6,6,8,25,20,5,24
Din Moscow,1852,8,5,7,8,17,22,-5,22
Rostov,1852,9,4,6,10,10,21,-11,18
Amkar,1852,10,4,4,12,11,29,-18,16
Anzhi,1852,11,2,5,13,15,41,-26,11
Loko Moscow,1853,1,11,7,2,30,12,18,40
Spart Moscow,1853,2,11,5,4,41,26,15,38
CSKA Moscow,1853,3,10,4,6,27,20,7,34
Krasnodar,1853,4,9,5,6,31,25,6,32
Zenit,1853,5,7,10,3,24,16,8,31
Terek Grozny,1853,6,8,5,7,23,23,0,29
FK Rubin,1853,7,6,5,9,24,22,2,23
Din Moscow,1853,8,5,6,9,18,25,-7,21
Rostov,1853,9,4,6,10,10,18,-8,18
Anzhi,1853,10,4,5,11,16,37,-21,17
Amkar,1853,11,4,4,12,10,30,-20,16
Loko Moscow,1854,1,11,6,3,29,12,17,39
CSKA Moscow,1854,2,11,3,6,27,19,8,36
Krasnodar,1854,3,10,4,6,30,25,5,34
Zenit,1854,4,7,9,4,21,14,7,30
Spart Moscow,1854,5,8,6,6,36,32,4,30
Terek Grozny,1854,6,8,5,7,23,26,-3,29
Din Moscow,1854,7,6,7,7,19,21,-2,25
FK Rubin,1854,8,5,6,9,22,19,3,21
Rostov,1854,9,5,6,9,12,17,-5,21
Amkar,1854,10,5,5,10,15,26,-11,20
Anzhi,1854,11,3,5,12,17,40,-23,14
CSKA Moscow,1855,1,12,3,5,28,17,11,39
Loko Moscow,1855,2,11,5,4,30,16,14,38
Krasnodar,1855,3,10,4,6,30,25,5,34
Zenit,1855,4,8,8,4,24,14,10,32
Spart Moscow,1855,5,8,7,5,35,31,4,31
Terek Grozny,1855,6,8,5,7,23,24,-1,29
Din Moscow,1855,7,5,8,7,19,23,-4,23
FK Rubin,1855,8,5,6,9,22,19,3,21
Rostov,1855,9,5,6,9,14,17,-3,21
Amkar,1855,10,5,5,10,12,24,-12,20
Anzhi,1855,11,2,5,13,14,41,-27,11
Loko Moscow,1856,1,11,6,3,30,14,16,39
CSKA Moscow,1856,2,11,4,5,31,20,11,37
Spart Moscow,1856,3,10,6,4,39,27,12,36
Krasnodar,1856,4,9,5,6,30,25,5,32
Terek Grozny,1856,5,9,5,6,26,24,2,32
Zenit,1856,6,7,10,3,23,15,8,31
Din Moscow,1856,7,5,8,7,19,23,-4,23
FK Rubin,1856,8,5,7,8,23,19,4,22
Rostov,1856,9,4,6,10,11,20,-9,18
Amkar,1856,10,4,4,12,9,27,-18,16
Anzhi,1856,11,2,5,13,18,45,-27,11
Loko Moscow,1857,1,11,7,2,31,13,18,40
CSKA Moscow,1857,2,12,3,5,31,19,12,39
Spart Moscow,1857,3,9,5,6,34,29,5,32
Zenit,1857,4,7,9,4,23,17,6,30
Krasnodar,1857,5,8,6,6,29,26,3,30
Terek Grozny,1857,6,7,6,7,23,26,-3,27
Din Moscow,1857,7,6,7,7,19,21,-2,25
FK Rubin,1857,8,5,7,8,22,18,4,22
Amkar,1857,9,6,4,10,13,23,-10,22
Rostov,1857,10,4,6,10,10,18,-8,18
Anzhi,1857,11,2,6,12,17,42,-25,12
Loko Moscow,1858,1,11,6,3,29,14,15,39
Zenit,1858,2,9,8,3,27,14,13,35
CSKA Moscow,1858,3,10,4,6,27,21,6,34
Spart Moscow,1858,4,9,5,6,36,30,6,32
Terek Grozny,1858,5,8,6,6,24,24,0,30
Krasnodar,1858,6,8,5,7,27,25,2,29
Din Moscow,1858,7,6,7,7,19,22,-3,25
FK Rubin,1858,8,6,6,8,23,18,5,24
Rostov,1858,9,5,6,9,14,18,-4,21
Amkar,1858,10,4,4,12,11,28,-17,16
Anzhi,1858,11,2,7,11,15,38,-23,13
Loko Moscow,1859,1,11,6,3,30,15,15,39
CSKA Moscow,1859,2,11,3,6,27,19,8,36
Zenit,1859,3,9,8,3,25,13,12,35
Spart Moscow,1859,4,10,5,5,39,28,11,35
Krasnodar,1859,5,8,5,7,28,27,1,29
Terek Grozny,1859,6,8,5,7,25,24,1,29
Din Moscow,1859,7,6,7,7,20,23,-3,25
FK Rubin,1859,8,6,6,8,24,18,6,24
Rostov,1859,9,4,6,10,10,19,-9,18
Amkar,1859,10,4,4,12,10,29,-19,16
Anzhi,1859,11,3,5,12,17,40,-23,14
Loko Moscow,1860,1,11,5,4,30,15,15,38
CSKA Moscow,1860,2,11,3,6,29,20,9,36
Zenit,1860,3,9,8,3,25,14,11,35
Krasnodar,1860,4,10,4,6,31,26,5,34
Spart Moscow,1860,5,9,6,5,36,29,7,33
Terek Grozny,1860,6,7,5,8,20,27,-7,26
Din Moscow,1860,7,6,6,8,18,22,-4,24
Amkar,1860,8,6,4,10,13,22,-9,22
FK Rubin,1860,9,5,5,10,22,20,2,20
Rostov,1860,10,4,7,9,12,19,-7,19
Anzhi,1860,11,3,5,12,18,40,-22,14
Loko Moscow,1861,1,11,7,2,30,12,18,40
CSKA Moscow,1861,2,11,4,5,30,20,10,37
Spart Moscow,1861,3,9,6,5,39,30,9,33
Terek Grozny,1861,4,9,5,6,24,23,1,32
Zenit,1861,5,7,10,3,25,17,8,31
Krasnodar,1861,6,8,6,6,27,24,3,30
FK Rubin,1861,7,5,7,8,21,17,4,22
Din Moscow,1861,8,5,7,8,19,25,-6,22
Rostov,1861,9,4,7,9,11,18,-7,19
Amkar,1861,10,5,4,11,11,25,-14,19
Anzhi,1861,11,2,5,13,15,41,-26,11
Loko Moscow,1862,1,12,5,3,31,13,18,41
CSKA Moscow,1862,2,11,3,6,26,18,8,36
Krasnodar,1862,3,10,4,6,30,24,6,34
Spart Moscow,1862,4,9,6,5,36,29,7,33
Zenit,1862,5,8,8,4,23,15,8,32
Terek Grozny,1862,6,8,6,6,24,24,0,30
Din Moscow,1862,7,5,8,7,18,22,-4,23
FK Rubin,1862,8,5,6,9,21,19,2,21
Amkar,1862,9,5,4,11,12,25,-13,19
Rostov,1862,10,4,6,10,10,18,-8,18
Anzhi,1862,11,2,6,12,16,40,-24,12
Loko Moscow,1863,1,11,6,3,29,13,16,39
CSKA Moscow,1863,2,11,4,5,28,19,9,37
Zenit,1863,3,8,9,3,25,15,10,33
Spart Moscow,1863,4,9,6,5,41,34,7,33
Krasnodar,1863,5,8,6,6,28,25,3,30
Terek Grozny,1863,6,8,5,7,21,23,-2,29
Din Moscow,1863,7,6,6,8,23,27,-4,24
Amkar,1863,8,6,4,10,14,23,-9,22
FK Rubin,1863,9,5,6,9,23,21,2,21
Rostov,1863,10,4,7,9,12,19,-7,19
Anzhi,1863,11,2,5,13,14,39,-25,11
Loko Moscow,1864,1,11,5,4,30,15,15,38
CSKA Moscow,1864,2,11,4,5,28,19,9,37
Spart Moscow,1864,3,9,7,4,37,27,10,34
Krasnodar,1864,4,10,4,6,34,27,7,34
Zenit,1864,5,8,9,3,24,14,10,33
Terek Grozny,1864,6,8,6,6,21,22,-1,30
Din Moscow,1864,7,5,7,8,19,25,-6,22
FK Rubin,1864,8,5,6,9,24,23,1,21
Rostov,1864,9,4,7,9,10,17,-7,19
Amkar,1864,10,4,5,11,10,24,-14,17
Anzhi,1864,11,2,6,12,15,39,-24,12
Loko Moscow,1865,1,11,5,4,29,13,16,38
CSKA Moscow,1865,2,11,3,6,28,20,8,36
Zenit,1865,3,8,8,4,23,15,8,32
Krasnodar,1865,4,9,4,7,28,27,1,31
Spart Moscow,1865,5,8,6,6,35,32,3,30
Terek Grozny,1865,6,8,6,6,22,23,-1,30
FK Rubin,1865,7,7,5,8,26,18,8,26
Din Moscow,1865,8,6,6,8,21,24,-3,24
Amkar,1865,9,5,5,10,13,23,-10,20
Rostov,1865,10,4,7,9,11,18,-7,19
Anzhi,1865,11,3,5,12,16,39,-23,14
Loko Moscow,1866,1,12,6,2,33,12,21,42
CSKA Moscow,1866,2,12,3,5,28,18,10,39
Spart Moscow,1866,3,9,6,5,36,28,8,33
Krasnodar,1866,4,9,5,6,31,27,4,32
Zenit,1866,5,7,8,5,21,17,4,29
Terek Grozny,1866,6,7,5,8,21,27,-6,26
Din Moscow,1866,7,6,7,7,18,21,-3,25
FK Rubin,1866,8,5,6,9,23,20,3,21
Amkar,1866,9,5,5,10,14,24,-10,20
Rostov,1866,10,4,6,10,11,19,-8,18
Anzhi,1866,11,3,5,12,16,39,-23,14
Loko Moscow,1867,1,11,6,3,30,15,15,39
CSKA Moscow,1867,2,11,4,5,29,20,9,37
Spart Moscow,1867,3,10,6,4,42,28,14,36
Krasnodar,1867,4,10,4,6,32,24,8,34
Terek Grozny,1867,5,9,5,6,23,23,0,32
Zenit,1867,6,7,9,4,23,16,7,30
Din Moscow,1867,7,6,7,7,21,23,-2,25
FK Rubin,1867,8,5,5,10,21,21,0,20
Rostov,1867,9,4,6,10,10,20,-10,18
Amkar,1867,10,4,4,12,10,27,-17,16
Anzhi,1867,11,2,6,12,17,41,-24,12
Loko Moscow,1868,1,11,6,3,31,15,16,39
CSKA Moscow,1868,2,11,3,6,27,19,8,36
Krasnodar,1868,3,10,4,6,33,25,8,34
Spart Moscow,1868,4,9,6,5,39,29,10,33
Zenit,1868,5,8,9,3,23,14,9,33
Terek Grozny,1868,6,7,6,7,21,24,-3,27
FK Rubin,1868,7,6,5,9,23,21,2,23
Amkar,1868,8,6,4,10,14,24,-10,22
Din Moscow,1868,9,5,6,9,18,27,-9,21
Rostov,1868,10,4,7,9,11,18,-7,19
Anzhi,1868,11,2,6,12,15,39,-24,12
Loko Moscow,1869,1,13,5,2,34,14,20,44
CSKA Moscow,1869,2,11,4,5,28,18,10,37
Spart Moscow,1869,3,9,5,6,39,29,10,32
Krasnodar,1869,4,9,4,7,29,26,3,31
Zenit,1869,5,7,9,4,24,17,7,30
Terek Grozny,1869,6,8,5,7,21,23,-2,29
Din Moscow,1869,7,6,6,8,19,23,-4,24
FK Rubin,1869,8,6,5,9,22,18,4,23
Rostov,1869,9,5,6,9,12,18,-6,21
Amkar,1869,10,4,4,12,9,27,-18,16
Anzhi,1869,11,3,5,12,15,39,-24,14
Loko Moscow,1870,1,12,6,2,31,12,19,42
CSKA Moscow,1870,2,11,4,5,27,18,9,37
Spart Moscow,1870,3,10,6,4,39,26,13,36
Zenit,1870,4,7,10,3,21,13,8,31
Krasnodar,1870,5,9,4,7,30,27,3,31
Terek Grozny,1870,6,7,5,8,22,26,-4,26
FK Rubin,1870,7,6,5,9,23,19,4,23
Din Moscow,1870,8,5,7,8,18,23,-5,22
Amkar,1870,9,5,4,11,11,26,-15,19
Rostov,1870,10,4,6,10,10,19,-9,18
Anzhi,1870,11,3,5,12,17,40,-23,14
Loko Moscow,1871,1,12,5,3,33,12,21,41
CSKA Moscow,1871,2,11,3,6,29,19,10,36
Spart Moscow,1871,3,10,5,5,37,27,10,35
Zenit,1871,4,8,8,4,23,17,6,32
Krasnodar,1871,5,9,5,6,29,25,4,32
Terek Grozny,1871,6,7,6,7,23,26,-3,27
FK Rubin,1871,7,6,6,8,23,18,5,24
Amkar,1871,8,6,4,10,11,22,-11,22
Din Moscow,1871,9,5,6,9,18,25,-7,21
Rostov,1871,10,4,6,10,10,18,-8,18
Anzhi,1871,11,2,6,12,17,44,-27,12
Loko Moscow,1872,1,11,7,2,31,13,18,40
CSKA Moscow,1872,2,11,3,6,28,18,10,36
Spart Moscow,1872,3,9,6,5,38,27,11,33
Zenit,1872,4,8,9,3,22,13,9,33
Krasnodar,1872,5,8,5,7,30,29,1,29
Din Moscow,1872,6,7,6,7,20,22,-2,27
Terek Grozny,1872,7,7,5,8,20,27,-7,26
FK Rubin,1872,8,6,5,9,24,19,5,23
Rostov,1872,9,4,7,9,10,17,-7,19
Amkar,1872,10,5,4,11,13,26,-13,19
Anzhi,1872,11,3,5,12,15,40,-25,14
Loko Moscow,1873,1,11,6,3,31,14,17,39
Spart Moscow,1873,2,10,5,5,38,27,11,35
CSKA Moscow,1873,3,10,4,6,26,19,7,34
Krasnodar,1873,4,10,4,6,30,25,5,34
Zenit,1873,5,8,9,3,24,15,9,33
Terek Grozny,1873,6,9,5,6,23,23,0,32
FK Rubin,1873,7,6,5,9,23,19,4,23
Rostov,1873,8,5,6,9,12,18,-6,21
Din Moscow,1873,9,5,6,9,17,24,-7,21
Amkar,1873,10,4,4,12,9,25,-16,16
Anzhi,1873,11,2,6,12,16,40,-24,12
Loko Moscow,1874,1,12,6,2,32,11,21,42
Spart Moscow,1874,2,10,6,4,40,29,11,36
CSKA Moscow,1874,3,11,3,6,29,23,6,36
Zenit,1874,4,8,9,3,25,14,11,33
Terek Grozny,1874,5,8,5,7,22,23,-1,29
Krasnodar,1874,6,8,4,8,27,28,-1,28
FK Rubin,1874,7,6,6,8,23,18,5,24
Din Moscow,1874,8,5,7,8,18,23,-5,22
Rostov,1874,9,4,6,10,11,20,-9,18
Amkar,1874,10,4,5,11,12,27,-15,17
Anzhi,1874,11,3,5,12,17,40,-23,14
Loko Moscow,1875,1,11,5,4,30,14,16,38
CSKA Moscow,1875,2,11,3,6,27,20,7,36
Spart Moscow,1875,3,10,5,5,39,29,10,35
Zenit,1875,4,8,8,4,23,15,8,32
Krasnodar,1875,5,9,5,6,29,25,4,32
Terek Grozny,1875,6,8,6,6,24,24,0,30
Din Moscow,1875,7,6,7,7,19,22,-3,25
FK Rubin,1875,8,5,7,8,22,18,4,22
Rostov,1875,9,4,6,10,10,19,-9,18
Amkar,1875,10,4,5,11,12,26,-14,17
Anzhi,1875,11,3,5,12,18,41,-23,14
Loko Moscow,1876,1,11,6,3,31,14,17,39
CSKA Moscow,1876,2,11,3,6,29,18,11,36
Zenit,1876,3,9,8,3,24,14,10,35
Spart Moscow,1876,4,8,7,5,34,28,6,31
Krasnodar,1876,5,8,6,6,29,26,3,30
Terek Grozny,1876,6,8,5,7,21,23,-2,29
FK Rubin,1876,7,6,6,8,25,20,5,24
Din Moscow,1876,8,5,7,8,19,24,-5,22
Rostov,1876,9,5,6,9,12,17,-5,21
Amkar,1876,10,4,5,11,10,24,-14,17
Anzhi,1876,11,3,5,12,15,41,-26,14
Loko Moscow,1877,1,12,6,2,32,12,20,42
Spart Moscow,1877,2,11,5,4,39,26,13,38
CSKA Moscow,1877,3,10,4,6,26,19,7,34
Zenit,1877,4,8,8,4,22,15,7,32
Terek Grozny,1877,5,9,5,6,22,22,0,32
Krasnodar,1877,6,8,6,6,29,26,3,30
Din Moscow,1877,7,6,6,8,18,23,-5,24
FK Rubin,1877,8,5,6,9,22,19,3,21
Rostov,1877,9,4,6,10,11,19,-8,18
Amkar,1877,10,4,4,12,9,25,-16,16
Anzhi,1877,11,2,6,12,15,39,-24,12
Loko Moscow,1878,1,12,5,3,31,14,17,41
CSKA Moscow,1878,2,11,4,5,29,18,11,37
Spart Moscow,1878,3,10,6,4,39,25,14,36
Krasnodar,1878,4,9,4,7,30,26,4,31
Zenit,1878,5,7,9,4,23,16,7,30
Terek Grozny,1878,6,8,5,7,23,24,-1,29
FK Rubin,1878,7,6,6,8,23,18,5,24
Din Moscow,1878,8,5,7,8,17,26,-9,22
Amkar,1878,9,5,5,10,10,22,-12,20
Rostov,1878,10,4,6,10,10,18,-8,18
Anzhi,1878,11,2,5,13,15,43,-28,11
Loko Moscow,1879,1,12,6,2,30,11,19,42
CSKA Moscow,1879,2,11,4,5,29,18,11,37
Spart Moscow,1879,3,9,7,4,37,27,10,34
Zenit,1879,4,7,10,3,22,14,8,31
Terek Grozny,1879,5,8,6,6,21,22,-1,30
Krasnodar,1879,6,8,5,7,29,27,2,29
Din Moscow,1879,7,5,8,7,19,23,-4,23
FK Rubin,1879,8,5,7,8,24,20,4,22
Rostov,1879,9,4,6,10,10,19,-9,18
Amkar,1879,10,4,6,10,10,23,-13,18
Anzhi,1879,11,2,5,13,14,41,-27,11
Loko Moscow,1880,1,13,5,2,36,14,22,44
Spart Moscow,1880,2,9,6,5,36,27,9,33
CSKA Moscow,1880,3,10,3,7,26,24,2,33
Zenit,1880,4,8,8,4,25,16,9,32
Terek Grozny,1880,5,9,5,6,23,23,0,32
Krasnodar,1880,6,8,5,7,31,29,2,29
FK Rubin,1880,7,6,6,8,24,18,6,24
Din Moscow,1880,8,5,6,9,17,25,-8,21
Rostov,1880,9,4,7,9,11,18,-7,19
Amkar,1880,10,5,4,11,11,24,-13,19
Anzhi,1880,11,3,5,12,17,39,-22,14
Loko Moscow,1881,1,11,6,3,31,16,15,39
Spart Moscow,1881,2,10,6,4,40,30,10,36
CSKA Moscow,1881,3,11,3,6,28,18,10,36
Zenit,1881,4,8,8,4,25,17,8,32
Krasnodar,1881,5,8,5,7,29,29,0,29
FK Rubin,1881,6,7,5,8,27,18,9,26
Terek Grozny,1881,7,7,5,8,21,26,-5,26
Din Moscow,1881,8,5,6,9,19,26,-7,21
Amkar,1881,9,5,5,10,12,23,-11,20
Rostov,1881,10,4,6,10,12,20,-8,18
Anzhi,1881,11,4,5,11,17,38,-21,17
Loko Moscow,1882,1,12,5,3,30,14,16,41
Spart Moscow,1882,2,10,5,5,41,30,11,35
CSKA Moscow,1882,3,10,4,6,28,23,5,34
Zenit,1882,4,8,8,4,24,14,10,32
Krasnodar,1882,5,9,5,6,31,25,6,32
Terek Grozny,1882,6,7,5,8,20,24,-4,26
Din Moscow,1882,7,6,6,8,22,25,-3,24
FK Rubin,1882,8,5,6,9,23,21,2,21
Rostov,1882,9,5,6,9,12,18,-6,21
Amkar,1882,10,5,4,11,11,26,-15,19
Anzhi,1882,11,3,6,11,18,40,-22,15
Loko Moscow,1883,1,12,6,2,32,12,20,42
CSKA Moscow,1883,2,11,3,6,28,19,9,36
Spart Moscow,1883,3,9,6,5,39,30,9,33
Zenit,1883,4,8,8,4,24,17,7,32
Krasnodar,1883,5,8,6,6,28,25,3,30
Terek Grozny,1883,6,8,6,6,22,23,-1,30
Din Moscow,1883,7,5,8,7,20,24,-4,23
FK Rubin,1883,8,5,7,8,23,19,4,22
Amkar,1883,9,5,5,10,12,24,-12,20
Rostov,1883,10,4,6,10,11,20,-9,18
Anzhi,1883,11,2,5,13,14,40,-26,11
Loko Moscow,1884,1,11,6,3,31,16,15,39
CSKA Moscow,1884,2,11,3,6,29,20,9,36
Zenit,1884,3,9,8,3,26,14,12,35
Spart Moscow,1884,4,8,7,5,33,27,6,31
Krasnodar,1884,5,8,6,6,29,26,3,30
Terek Grozny,1884,6,8,5,7,22,23,-1,29
Din Moscow,1884,7,5,8,7,18,22,-4,23
FK Rubin,1884,8,5,7,8,22,18,4,22
Rostov,1884,9,5,6,9,12,17,-5,21
Amkar,1884,10,5,5,10,10,22,-12,20
Anzhi,1884,11,2,5,13,15,42,-27,11
Loko Moscow,1885,1,11,6,3,29,13,16,39
CSKA Moscow,1885,2,11,3,6,26,18,8,36
Zenit,1885,3,9,8,3,24,13,11,35
Spart Moscow,1885,4,9,6,5,36,28,8,33
Terek Grozny,1885,5,9,5,6,27,22,5,32
Krasnodar,1885,6,8,6,6,28,25,3,30
Din Moscow,1885,7,7,6,7,22,23,-1,27
FK Rubin,1885,8,5,6,9,23,21,2,21
Rostov,1885,9,4,6,10,11,19,-8,18
Amkar,1885,10,4,5,11,9,25,-16,17
Anzhi,1885,11,2,5,13,14,42,-28,11
Loko Moscow,1886,1,12,5,3,32,15,17,41
Spart Moscow,1886,2,11,5,4,40,27,13,38
Zenit,1886,3,9,8,3,27,14,13,35
CSKA Moscow,1886,4,10,3,7,25,21,4,33
Terek Grozny,1886,5,8,5,7,22,25,-3,29
Krasnodar,1886,6,8,4,8,28,27,1,28
FK Rubin,1886,7,6,6,8,23,18,5,24
Din Moscow,1886,8,5,7,8,19,24,-5,22
Rostov,1886,9,4,6,10,11,19,-8,18
Anzhi,1886,10,4,5,11,17,37,-20,17
Amkar,1886,11,4,4,12,10,27,-17,16
Loko Moscow,1887,1,12,5,3,35,15,20,41
CSKA Moscow,1887,2,11,3,6,28,20,8,36
Zenit,1887,3,9,8,3,28,18,10,35
Spart Moscow,1887,4,9,5,6,38,29,9,32
Terek Grozny,1887,5,9,5,6,25,22,3,32
Krasnodar,1887,6,9,4,7,30,27,3,31
Din Moscow,1887,7,6,6,8,21,27,-6,24
Rostov,1887,8,5,6,9,11,17,-6,21
FK Rubin,1887,9,5,5,10,22,22,0,20
Amkar,1887,10,5,4,11,10,25,-15,19
Anzhi,1887,11,2,5,13,14,40,-26,11
Loko Moscow,1888,1,13,5,2,34,11,23,44
CSKA Moscow,1888,2,11,4,5,28,19,9,37
Spart Moscow,1888,3,10,5,5,44,29,15,35
Terek Grozny,1888,4,8,6,6,21,22,-1,30
Zenit,1888,5,7,8,5,21,17,4,29
Krasnodar,1888,6,8,4,8,27,28,-1,28
FK Rubin,1888,7,7,5,8,26,17,9,26
Din Moscow,1888,8,6,6,8,20,25,-5,24
Rostov,1888,9,4,6,10,11,22,-11,18
Amkar,1888,10,4,5,11,9,27,-18,17
Anzhi,1888,11,2,6,12,16,40,-24,12
Loko Moscow,1889,1,12,5,3,31,13,18,41
CSKA Moscow,1889,2,11,3,6,26,18,8,36
Spart Moscow,1889,3,9,7,4,38,29,9,34
Krasnodar,1889,4,10,4,6,30,25,5,34
Zenit,1889,5,8,8,4,23,15,8,32
Terek Grozny,1889,6,9,5,6,24,24,0,32
Din Moscow,1889,7,6,7,7,22,24,-2,25
FK Rubin,1889,8,5,5,10,23,22,1,20
Rostov,1889,9,4,6,10,10,18,-8,18
Amkar,1889,10,4,5,11,12,26,-14,17
Anzhi,1889,11,2,5,13,15,40,-25,11
Loko Moscow,1890,1,11,6,3,30,13,17,39
Spart Moscow,1890,2,11,5,4,40,27,13,38
Krasnodar,1890,3,10,4,6,30,24,6,34
CSKA Moscow,1890,4,10,4,6,26,20,6,34
Zenit,1890,5,8,9,3,24,14,10,33
Terek Grozny,1890,6,8,5,7,22,25,-3,29
Din Moscow,1890,7,5,7,8,20,25,-5,22
FK Rubin,1890,8,5,6,9,22,20,2,21
Amkar,1890,9,5,4,11,11,25,-14,19
Rostov,1890,10,4,6,10,10,18,-8,18
Anzhi,1890,11,2,6,12,16,40,-24,12
Loko Moscow,1891,1,12,6,2,33,12,21,42
CSKA Moscow,1891,2,10,4,6,28,21,7,34
Spart Moscow,1891,3,9,6,5,38,29,9,33
Zenit,1891,4,7,10,3,24,16,8,31
Krasnodar,1891,5,9,4,7,29,27,2,31
Terek Grozny,1891,6,7,5,8,21,25,-4,26
Din Moscow,1891,7,5,7,8,19,26,-7,22
Amkar,1891,8,6,4,10,13,23,-10,22
FK Rubin,1891,9,5,6,9,22,20,2,21
Rostov,1891,10,4,7,9,11,18,-7,19
Anzhi,1891,11,4,5,11,17,38,-21,17
Loko Moscow,1892,1,13,5,2,33,12,21,44
CSKA Moscow,1892,2,12,3,5,28,18,10,39
Spart Moscow,1892,3,10,6,4,39,27,12,36
Terek Grozny,1892,4,8,6,6,22,23,-1,30
Zenit,1892,5,7,8,5,22,17,5,29
Krasnodar,1892,6,8,4,8,28,28,0,28
FK Rubin,1892,7,7,5,8,26,17,9,26
Din Moscow,1892,8,5,7,8,17,24,-7,22
Rostov,1892,9,4,6,10,11,19,-8,18
Amkar,1892,10,4,4,12,10,27,-17,16
Anzhi,1892,11,2,6,12,15,39,-24,12
Loko Moscow,1893,1,13,5,2,33,12,21,44
CSKA Moscow,1893,2,11,4,5,28,18,10,37
Spart Moscow,1893,3,9,5,6,38,33,5,32
Terek Grozny,1893,4,9,5,6,25,24,1,32
Zenit,1893,5,7,8,5,22,18,4,29
Krasnodar,1893,6,8,5,7,28,26,2,29
Din Moscow,1893,7,6,7,7,21,23,-2,25
FK Rubin,1893,8,5,7,8,23,19,4,22
Rostov,1893,9,5,6,9,13,17,-4,21
Amkar,1893,10,4,4,12,11,27,-16,16
Anzhi,1893,11,2,6,12,17,42,-25,12
Loko Moscow,1894,1,12,6,2,36,15,21,42
CSKA Moscow,1894,2,11,4,5,28,18,10,37
Spart Moscow,1894,3,10,5,5,42,29,13,35
Zenit,1894,4,7,8,5,21,18,3,29
Krasnodar,1894,5,8,5,7,31,30,1,29
Terek Grozny,1894,6,7,5,8,22,28,-6,26
Din Moscow,1894,7,6,6,8,18,26,-8,24
FK Rubin,1894,8,6,5,9,23,18,5,23
Amkar,1894,9,6,4,10,16,23,-7,22
Rostov,1894,10,4,6,10,10,21,-11,18
Anzhi,1894,11,3,6,11,18,39,-21,15
Loko Moscow,1895,1,11,6,3,33,16,17,39
Spart Moscow,1895,2,10,6,4,38,27,11,36
CSKA Moscow,1895,3,11,3,6,27,18,9,36
Zenit,1895,4,9,8,3,24,14,10,35
Krasnodar,1895,5,9,5,6,31,27,4,32
Terek Grozny,1895,6,7,5,8,20,25,-5,26
Din Moscow,1895,7,6,6,8,21,24,-3,24
FK Rubin,1895,8,5,5,10,22,21,1,20
Amkar,1895,9,5,5,10,10,22,-12,20
Rostov,1895,10,4,6,10,11,20,-9,18
Anzhi,1895,11,3,5,12,16,39,-23,14
Loko Moscow,1896,1,13,5,2,31,11,20,44
CSKA Moscow,1896,2,11,3,6,28,19,9,36
Spart Moscow,1896,3,9,5,6,34,27,7,32
Krasnodar,1896,4,9,4,7,28,25,3,31
Zenit,1896,5,7,8,5,22,17,5,29
Terek Grozny,1896,6,8,5,7,23,25,-2,29
Din Moscow,1896,7,6,7,7,19,22,-3,25
Amkar,1896,8,6,4,10,11,22,-11,22
FK Rubin,1896,9,5,6,9,22,19,3,21
Rostov,1896,10,4,6,10,10,18,-8,18
Anzhi,1896,11,3,5,12,17,40,-23,14
Loko Moscow,1897,1,13,5,2,34,12,22,44
Spart Moscow,1897,2,11,5,4,42,27,15,38
CSKA Moscow,1897,3,10,4,6,26,19,7,34
Zenit,1897,4,8,8,4,22,14,8,32
Terek Grozny,1897,5,9,5,6,24,23,1,32
Krasnodar,1897,6,8,5,7,29,29,0,29
FK Rubin,1897,7,5,7,8,23,19,4,22
Din Moscow,1897,8,5,7,8,19,25,-6,22
Rostov,1897,9,4,6,10,11,20,-9,18
Amkar,1897,10,4,4,12,9,26,-17,16
Anzhi,1897,11,2,6,12,16,41,-25,12
Loko Moscow,1898,1,12,5,3,33,15,18,41
CSKA Moscow,1898,2,11,4,5,28,18,10,37
Spart Moscow,1898,3,9,7,4,39,28,11,34
Krasnodar,1898,4,9,5,6,31,27,4,32
Terek Grozny,1898,5,9,5,6,25,23,2,32
Zenit,1898,6,7,8,5,23,18,5,29
FK Rubin,1898,7,6,6,8,25,19,6,24
Din Moscow,1898,8,5,7,8,18,24,-6,22
Rostov,1898,9,4,7,9,12,19,-7,19
Amkar,1898,10,4,4,12,9,27,-18,16
Anzhi,1898,11,2,6,12,16,41,-25,12
Loko Moscow,1899,1,11,7,2,31,13,18,40
CSKA Moscow,1899,2,12,3,5,28,17,11,39
Spart Moscow,1899,3,9,6,5,36,28,8,33
Zenit,1899,4,7,9,4,22,16,6,30
Terek Grozny,1899,5,8,6,6,22,23,-1,30
Krasnodar,1899,6,8,5,7,29,28,1,29
Din Moscow,1899,7,7,6,7,21,22,-1,27
FK Rubin,1899,8,6,5,9,24,20,4,23
Rostov,1899,9,4,6,10,11,19,-8,18
Amkar,1899,10,4,5,11,9,23,-14,17
Anzhi,1899,11,2,6,12,15,39,-24,12
Loko Moscow,1900,1,13,5,2,32,12,20,44
Spart Moscow,1900,2,10,6,4,37,25,12,36
CSKA Moscow,1900,3,11,3,6,28,20,8,36
Terek Grozny,1900,4,8,6,6,23,22,1,30
Zenit,1900,5,7,8,5,21,16,5,29
Krasnodar,1900,6,8,5,7,29,27,2,29
Din Moscow,1900,7,6,7,7,18,21,-3,25
FK Rubin,1900,8,5,6,9,22,19,3,21
Rostov,1900,9,4,6,10,10,18,-8,18
Amkar,1900,10,4,4,12,9,28,-19,16
Anzhi,1900,11,3,6,11,17,38,-21,15
Loko Moscow,1901,1,12,5,3,33,15,18,41
Zenit,1901,2,9,8,3,26,15,11,35
CSKA Moscow,1901,3,10,4,6,27,20,7,34
Spart Moscow,1901,4,9,5,6,34,28,6,32
Krasnodar,1901,5,9,4,7,29,27,2,31
Terek Grozny,1901,6,7,6,7,20,24,-4,27
Din Moscow,1901,7,6,6,8,19,24,-5,24
FK Rubin,1901,8,6,5,9,24,19,5,23
Amkar,1901,9,6,4,10,13,22,-9,22
Rostov,1901,10,4,6,10,10,18,-8,18
Anzhi,1901,11,2,7,11,15,38,-23,13
Loko Moscow,1902,1,11,7,2,31,13,18,40
CSKA Moscow,1902,2,11,3,6,27,19,8,36
Zenit,1902,3,8,9,3,23,13,10,33
Spart Moscow,1902,4,9,6,5,37,30,7,33
Krasnodar,1902,5,9,5,6,33,29,4,32
Terek Grozny,1902,6,7,5,8,20,24,-4,26
Din Moscow,1902,7,6,6,8,20,24,-4,24
Amkar,1902,8,6,4,10,12,22,-10,22
FK Rubin,1902,9,5,5,10,24,22,2,20
Rostov,1902,10,4,7,9,11,18,-7,19
Anzhi,1902,11,3,5,12,15,39,-24,14
Loko Moscow,1903,1,12,6,2,36,15,21,42
CSKA Moscow,1903,2,10,4,6,25,19,6,34
Spart Moscow,1903,3,9,5,6,38,31,7,32
Zenit,1903,4,7,10,3,22,14,8,31
Krasnodar,1903,5,9,4,7,33,32,1,31
Terek Grozny,1903,6,8,6,6,22,23,-1,30
Din Moscow,1903,7,6,7,7,20,23,-3,25
FK Rubin,1903,8,5,6,9,23,20,3,21
Rostov,1903,9,5,6,9,12,18,-6,21
Amkar,1903,10,4,5,11,10,24,-14,17
Anzhi,1903,11,3,5,12,17,39,-22,14
Loko Moscow,1904,1,12,6,2,32,13,19,42
Spart Moscow,1904,2,10,6,4,43,30,13,36
CSKA Moscow,1904,3,11,3,6,28,20,8,36
Zenit,1904,4,8,8,4,25,16,9,32
Krasnodar,1904,5,8,6,6,28,25,3,30
Terek Grozny,1904,6,7,6,7,23,26,-3,27
FK Rubin,1904,7,5,7,8,22,18,4,22
Din Moscow,1904,8,5,7,8,20,27,-7,22
Amkar,1904,9,5,5,10,13,25,-12,20
Rostov,1904,10,4,6,10,11,20,-9,18
Anzhi,1904,11,2,6,12,16,41,-25,12
Loko Moscow,1905,1,12,5,3,32,13,19,41
CSKA Moscow,1905,2,11,3,6,32,21,11,36
Spart Moscow,1905,3,9,7,4,36,26,10,34
Krasnodar,1905,4,10,4,6,31,25,6,34
Zenit,1905,5,8,8,4,24,16,8,32
Terek Grozny,1905,6,9,5,6,22,22,0,32
FK Rubin,1905,7,6,5,9,22,19,3,23
Din Moscow,1905,8,5,7,8,17,22,-5,22
Rostov,1905,9,4,6,10,10,19,-9,18
Amkar,1905,10,4,5,11,10,24,-14,17
Anzhi,1905,11,2,5,13,15,44,-29,11
Loko Moscow,1906,1,11,7,2,31,13,18,40
CSKA Moscow,1906,2,12,3,5,29,18,11,39
Spart Moscow,1906,3,9,6,5,38,28,10,33
Zenit,1906,4,7,9,4,22,15,7,30
Krasnodar,1906,5,8,6,6,29,26,3,30
Terek Grozny,1906,6,7,7,6,22,24,-2,28
FK Rubin,1906,7,6,6,8,23,18,5,24
Rostov,1906,8,5,6,9,12,18,-6,21
Din Moscow,1906,9,5,6,9,17,25,-8,21
Amkar,1906,10,4,6,10,11,24,-13,18
Anzhi,1906,11,2,6,12,16,41,-25,12
Loko Moscow,1907,1,11,6,3,29,12,17,39
CSKA Moscow,1907,2,11,3,6,26,20,6,36
Zenit,1907,3,9,8,3,25,13,12,35
Spart Moscow,1907,4,9,5,6,34,29,5,32
Terek Grozny,1907,5,8,5,7,27,26,1,29
Krasnodar,1907,6,8,5,7,28,28,0,29
FK Rubin,1907,7,6,6,8,26,19,7,24
Din Moscow,1907,8,5,7,8,18,23,-5,22
Amkar,1907,9,6,4,10,13,23,-10,22
Rostov,1907,10,5,6,9,12,17,-5,21
Anzhi,1907,11,2,5,13,16,44,-28,11
Loko Moscow,1908,1,12,5,3,32,13,19,41
Spart Moscow,1908,2,11,5,4,41,25,16,38
CSKA Moscow,1908,3,11,4,5,30,18,12,37
Krasnodar,1908,4,10,4,6,31,24,7,34
Zenit,1908,5,7,9,4,22,17,5,30
Terek Grozny,1908,6,7,5,8,20,24,-4,26
Din Moscow,1908,7,6,6,8,19,27,-8,24
FK Rubin,1908,8,5,5,10,22,21,1,20
Amkar,1908,9,5,4,11,10,24,-14,19
Rostov,1908,10,4,6,10,10,18,-8,18
Anzhi,1908,11,3,5,12,15,41,-26,14
Loko Moscow,1909,1,12,6,2,30,11,19,42
CSKA Moscow,1909,2,12,3,5,30,18,12,39
Spart Moscow,1909,3,9,6,5,38,30,8,33
Zenit,1909,4,7,8,5,22,18,4,29
Krasnodar,1909,5,8,5,7,28,26,2,29
Terek Grozny,1909,6,7,6,7,22,27,-5,27
FK Rubin,1909,7,6,6,8,24,19,5,24
Din Moscow,1909,8,5,7,8,18,24,-6,22
Amkar,1909,9,6,4,10,15,23,-8,22
Rostov,1909,10,4,7,9,13,20,-7,19
Anzhi,1909,11,2,6,12,15,39,-24,12
Loko Moscow,1910,1,12,5,3,31,15,16,41
CSKA Moscow,1910,2,11,3,6,27,18,9,36
Spart Moscow,1910,3,10,5,5,39,27,12,35
Krasnodar,1910,4,10,4,6,33,25,8,34
Zenit,1910,5,8,8,4,23,15,8,32
Terek Grozny,1910,6,8,5,7,23,25,-2,29
Din Moscow,1910,7,7,6,7,22,23,-1,27
FK Rubin,1910,8,5,5,10,24,24,0,20
Amkar,1910,9,5,4,11,11,25,-14,19
Rostov,1910,10,4,6,10,11,21,-10,18
Anzhi,1910,11,2,5,13,15,41,-26,11
Loko Moscow,1911,1,11,5,4,30,14,16,38
CSKA Moscow,1911,2,11,3,6,30,22,8,36
Zenit,1911,3,9,8,3,26,15,11,35
Spart Moscow,1911,4,10,5,5,37,27,10,35
Krasnodar,1911,5,9,5,6,29,25,4,32
Terek Grozny,1911,6,9,5,6,24,23,1,32
FK Rubin,1911,7,6,6,8,23,18,5,24
Din Moscow,1911,8,5,6,9,17,24,-7,21
Amkar,1911,9,5,4,11,10,24,-14,19
Rostov,1911,10,4,6,10,11,19,-8,18
Anzhi,1911,11,2,5,13,17,43,-26,11
Loko Moscow,1912,1,12,6,2,30,11,19,42
Spart Moscow,1912,2,10,5,5,38,26,12,35
CSKA Moscow,1912,3,10,4,6,27,20,7,34
Zenit,1912,4,8,9,3,22,13,9,33
Krasnodar,1912,5,9,4,7,28,25,3,31
Terek Grozny,1912,6,7,6,7,21,24,-3,27
Din Moscow,1912,7,6,6,8,20,24,-4,24
Amkar,1912,8,6,4,10,11,22,-11,22
FK Rubin,1912,9,5,5,10,21,21,0,20
Rostov,1912,10,4,6,10,10,19,-9,18
Anzhi,1912,11,2,7,11,17,40,-23,13
Loko Moscow,1913,1,11,6,3,32,16,16,39
CSKA Moscow,1913,2,11,4,5,28,18,10,37
Zenit,1913,3,7,10,3,24,16,8,31
Spart Moscow,1913,4,8,7,5,35,29,6,31
Krasnodar,1913,5,9,4,7,31,29,2,31
Terek Grozny,1913,6,8,5,7,24,24,0,29
Din Moscow,1913,7,7,6,7,24,22,2,27
FK Rubin,1913,8,6,5,9,25,22,3,23
Amkar,1913,9,5,5,10,12,24,-12,20
Rostov,1913,10,4,7,9,10,17,-7,19
Anzhi,1913,11,2,5,13,14,42,-28,11
Loko Moscow,1914,1,11,5,4,30,16,14,38
Spart Moscow,1914,2,10,6,4,40,27,13,36
CSKA Moscow,1914,3,11,3,6,30,19,11,36
Zenit,1914,4,9,8,3,24,13,11,35
Krasnodar,1914,5,9,4,7,30,28,2,31
Terek Grozny,1914,6,8,5,7,23,24,-1,29
Din Moscow,1914,7,6,6,8,20,23,-3,24
FK Rubin,1914,8,6,5,9,24,20,4,23
Rostov,1914,9,4,6,10,11,21,-10,18
Amkar,1914,10,4,5,11,11,26,-15,17
Anzhi,1914,11,3,5,12,16,42,-26,14
Loko Moscow,1915,1,12,6,2,31,12,19,42
CSKA Moscow,1915,2,11,4,5,29,20,9,37
Spart Moscow,1915,3,9,5,6,36,29,7,32
Krasnodar,1915,4,8,6,6,29,26,3,30
Terek Grozny,1915,5,8,6,6,22,23,-1,30
Zenit,1915,6,7,8,5,21,15,6,29
Din Moscow,1915,7,6,7,7,20,23,-3,25
FK Rubin,1915,8,5,7,8,23,19,4,22
Amkar,1915,9,5,5,10,11,23,-12,20
Rostov,1915,10,4,6,10,10,18,-8,18
Anzhi,1915,11,2,6,12,18,42,-24,12
Loko Moscow,1916,1,12,6,2,31,11,20,42
CSKA Moscow,1916,2,10,5,5,28,20,8,35
Spart Moscow,1916,3,9,7,4,37,26,11,34
Zenit,1916,4,7,10,3,23,15,8,31
Krasnodar,1916,5,8,5,7,27,26,1,29
Terek Grozny,1916,6,7,6,7,22,25,-3,27
Din Moscow,1916,7,5,8,7,19,23,-4,23
FK Rubin,1916,8,5,7,8,22,18,4,22
Amkar,1916,9,5,5,10,11,23,-12,20
Rostov,1916,10,4,6,10,10,20,-10,18
Anzhi,1916,11,2,7,11,16,39,-23,13
Loko Moscow,1917,1,12,6,2,30,11,19,42
CSKA Moscow,1917,2,11,4,5,28,18,10,37
Spart Moscow,1917,3,9,7,4,36,26,10,34
Krasnodar,1917,4,9,5,6,30,24,6,32
Terek Grozny,1917,5,9,5,6,26,24,2,32
Zenit,1917,6,7,9,4,21,14,7,30
FK Rubin,1917,7,6,5,9,22,20,2,23
Din Moscow,1917,8,5,7,8,17,22,-5,22
Rostov,1917,9,4,6,10,10,19,-9,18
Amkar,1917,10,4,5,11,11,26,-15,17
Anzhi,1917,11,2,5,13,16,43,-27,11
Loko Moscow,1918,1,13,5,2,33,12,21,44
Spart Moscow,1918,2,10,6,4,41,28,13,36
CSKA Moscow,1918,3,10,4,6,27,20,7,34
Zenit,1918,4,7,9,4,23,16,7,30
Terek Grozny,1918,5,8,5,7,25,23,2,29
Krasnodar,1918,6,8,4,8,28,28,0,28
Din Moscow,1918,7,6,6,8,20,24,-4,24
FK Rubin,1918,8,6,5,9,22,19,3,23
Rostov,1918,9,4,7,9,10,17,-7,19
Amkar,1918,10,5,4,11,12,27,-15,19
Anzhi,1918,11,3,5,12,15,42,-27,14
Loko Moscow,1919,1,12,5,3,34,14,20,41
CSKA Moscow,1919,2,11,3,6,28,19,9,36
Zenit,1919,3,8,8,4,23,16,7,32
Krasnodar,1919,4,9,4,7,30,27,3,31
Spart Moscow,1919,5,8,6,6,36,30,6,30
Din Moscow,1919,6,7,6,7,22,21,1,27
Terek Grozny,1919,7,7,6,7,21,28,-7,27
FK Rubin,1919,8,6,5,9,22,21,1,23
Amkar,1919,9,5,5,10,11,23,-12,20
Rostov,1919,10,4,7,9,13,20,-7,19
Anzhi,1919,11,3,5,12,19,40,-21,14
Loko Moscow,1920,1,11,6,3,31,14,17,39
CSKA Moscow,1920,2,12,3,5,31,18,13,39
Zenit,1920,3,8,8,4,22,14,8,32
Krasnodar,1920,4,9,5,6,31,27,4,32
Terek Grozny,1920,5,9,5,6,23,22,1,32
Spart Moscow,1920,6,8,7,5,37,30,7,31
Din Moscow,1920,7,6,7,7,21,24,-3,25
FK Rubin,1920,8,5,6,9,23,20,3,21
Rostov,1920,9,4,7,9,11,18,-7,19
Amkar,1920,10,4,5,11,10,24,-14,17
Anzhi,1920,11,2,5,13,15,44,-29,11
Loko Moscow,1921,1,12,5,3,32,15,17,41
CSKA Moscow,1921,2,11,4,5,30,20,10,37
Spart Moscow,1921,3,10,6,4,45,27,18,36
Zenit,1921,4,8,9,3,26,16,10,33
Krasnodar,1921,5,8,5,7,30,28,2,29
Terek Grozny,1921,6,7,6,7,20,24,-4,27
Din Moscow,1921,7,6,6,8,19,27,-8,24
FK Rubin,1921,8,5,6,9,22,20,2,21
Amkar,1921,9,5,5,10,13,24,-11,20
Rostov,1921,10,4,6,10,10,21,-11,18
Anzhi,1921,11,2,6,12,14,39,-25,12
Loko Moscow,1922,1,12,6,2,33,13,20,42
CSKA Moscow,1922,2,11,3,6,29,19,10,36
Zenit,1922,3,8,9,3,24,15,9,33
Terek Grozny,1922,4,9,5,6,25,23,2,32
Krasnodar,1922,5,9,4,7,30,28,2,31
Spart Moscow,1922,6,8,5,7,37,33,4,29
Din Moscow,1922,7,7,6,7,23,23,0,27
Rostov,1922,8,5,6,9,12,18,-6,21
FK Rubin,1922,9,5,5,10,22,22,0,20
Amkar,1922,10,5,4,11,13,26,-13,19
Anzhi,1922,11,2,5,13,14,42,-28,11
Loko Moscow,1923,1,11,7,2,30,12,18,40
CSKA Moscow,1923,2,11,4,5,27,17,10,37
Spart Moscow,1923,3,9,6,5,38,28,10,33
Zenit,1923,4,7,10,3,21,13,8,31
Terek Grozny,1923,5,8,6,6,24,25,-1,30
Krasnodar,1923,6,8,5,7,28,27,1,29
FK Rubin,1923,7,7,5,8,24,17,7,26
Din Moscow,1923,8,5,6,9,19,27,-8,21
Rostov,1923,9,4,7,9,10,17,-7,19
Amkar,1923,10,5,4,11,12,25,-13,19
Anzhi,1923,11,2,6,12,15,40,-25,12
Loko Moscow,1924,1,13,5,2,33,13,20,44
Spart Moscow,1924,2,9,6,5,37,29,8,33
CSKA Moscow,1924,3,10,3,7,25,19,6,33
Zenit,1924,4,8,8,4,23,15,8,32
Terek Grozny,1924,5,8,5,7,24,25,-1,29
Krasnodar,1924,6,8,4,8,28,28,0,28
FK Rubin,1924,7,7,5,8,24,17,7,26
Din Moscow,1924,8,6,6,8,19,23,-4,24
Amkar,1924,9,5,5,10,11,23,-12,20
Rostov,1924,10,4,6,10,11,19,-8,18
Anzhi,1924,11,3,5,12,17,41,-24,14
Loko Moscow,1925,1,11,5,4,31,15,16,38
CSKA Moscow,1925,2,11,4,5,29,19,10,37
Spart Moscow,1925,3,9,6,5,38,30,8,33
Zenit,1925,4,8,8,4,24,17,7,32
Krasnodar,1925,5,9,5,6,29,25,4,32
Terek Grozny,1925,6,7,7,6,22,24,-2,28
Din Moscow,1925,7,6,6,8,20,25,-5,24
FK Rubin,1925,8,5,6,9,22,20,2,21
Amkar,1925,9,5,5,10,14,24,-10,20
Rostov,1925,10,4,7,9,11,18,-7,19
Anzhi,1925,11,2,7,11,16,39,-23,13
Loko Moscow,1926,1,11,7,2,30,12,18,40
CSKA Moscow,1926,2,11,3,6,29,21,8,36
Zenit,1926,3,8,9,3,26,15,11,33
Spart Moscow,1926,4,9,6,5,38,30,8,33
Krasnodar,1926,5,9,5,6,28,24,4,32
Terek Grozny,1926,6,9,5,6,23,22,1,32
FK Rubin,1926,7,6,5,9,22,18,4,23
Din Moscow,1926,8,5,7,8,18,23,-5,22
Rostov,1926,9,5,6,9,14,19,-5,21
Amkar,1926,10,4,4,12,9,26,-17,16
Anzhi,1926,11,2,5,13,14,41,-27,11
Loko Moscow,1927,1,12,6,2,33,12,21,42
CSKA Moscow,1927,2,10,4,6,25,18,7,34
Zenit,1927,3,8,9,3,23,14,9,33
Spart Moscow,1927,4,9,6,5,35,29,6,33
Terek Grozny,1927,5,8,5,7,23,26,-3,29
Krasnodar,1927,6,8,4,8,27,28,-1,28
FK Rubin,1927,7,7,5,8,26,20,6,26
Din Moscow,1927,8,5,7,8,20,25,-5,22
Amkar,1927,9,6,4,10,15,23,-8,22
Rostov,1927,10,4,6,10,11,19,-8,18
Anzhi,1927,11,2,6,12,15,39,-24,12
Loko Moscow,1928,1,12,5,3,30,13,17,41
CSKA Moscow,1928,2,11,4,5,27,18,9,37
Spart Moscow,1928,3,10,6,4,40,28,12,36
Zenit,1928,4,8,9,3,24,14,10,33
Terek Grozny,1928,5,8,6,6,21,22,-1,30
Krasnodar,1928,6,8,4,8,27,27,0,28
Din Moscow,1928,7,6,6,8,21,27,-6,24
FK Rubin,1928,8,6,5,9,25,20,5,23
Rostov,1928,9,4,6,10,10,18,-8,18
Amkar,1928,10,4,6,10,11,24,-13,18
Anzhi,1928,11,2,5,13,14,39,-25,11
Loko Moscow,1929,1,12,5,3,31,15,16,41
CSKA Moscow,1929,2,11,4,5,28,19,9,37
Krasnodar,1929,3,10,4,6,32,24,8,34
Spart Moscow,1929,4,8,7,5,36,30,6,31
Zenit,1929,5,7,9,4,22,16,6,30
Terek Grozny,1929,6,8,5,7,22,25,-3,29
Din Moscow,1929,7,7,6,7,23,22,1,27
FK Rubin,1929,8,5,5,10,21,21,0,20
Rostov,1929,9,4,7,9,11,18,-7,19
Amkar,1929,10,4,5,11,11,25,-14,17
Anzhi,1929,11,3,5,12,17,39,-22,14
Loko Moscow,1930,1,12,5,3,32,15,17,41
CSKA Moscow,1930,2,11,4,5,29,18,11,37
Spart Moscow,1930,3,10,5,5,35,27,8,35
Terek Grozny,1930,4,9,5,6,26,22,4,32
Krasnodar,1930,5,9,4,7,30,26,4,31
Zenit,1930,6,7,9,4,23,16,7,30
FK Rubin,1930,7,7,5,8,26,18,8,26
Din Moscow,1930,8,5,6,9,17,25,-8,21
Amkar,1930,9,5,4,11,11,23,-12,19
Rostov,1930,10,4,6,10,10,18,-8,18
Anzhi,1930,11,2,5,13,15,46,-31,11
Loko Moscow,1931,1,11,6,3,30,13,17,39
CSKA Moscow,1931,2,10,5,5,25,17,8,35
Zenit,1931,3,8,9,3,22,13,9,33
Spart Moscow,1931,4,8,8,4,36,28,8,32
Krasnodar,1931,5,8,6,6,29,26,3,30
Terek Grozny,1931,6,7,6,7,21,24,-3,27
Din Moscow,1931,7,6,7,7,19,22,-3,25
FK Rubin,1931,8,5,6,9,22,19,3,21
Rostov,1931,9,4,7,9,11,18,-7,19
Amkar,1931,10,4,6,10,11,24,-13,18
Anzhi,1931,11,3,6,11,15,37,-22,15
Loko Moscow,1932,1,13,5,2,33,11,22,44
Spart Moscow,1932,2,10,6,4,39,25,14,36
CSKA Moscow,1932,3,10,4,6,26,19,7,34
Zenit,1932,4,8,8,4,23,16,7,32
Krasnodar,1932,5,8,5,7,28,27,1,29
Terek Grozny,1932,6,7,6,7,21,26,-5,27
Din Moscow,1932,7,6,6,8,19,25,-6,24
FK Rubin,1932,8,5,6,9,23,20,3,21
Amkar,1932,9,5,5,10,12,22,-10,20
Rostov,1932,10,4,6,10,10,20,-10,18
Anzhi,1932,11,2,7,11,15,38,-23,13
Loko Moscow,1933,1,11,6,3,30,14,16,39
CSKA Moscow,1933,2,11,3,6,28,21,7,36
Zenit,1933,3,9,8,3,26,14,12,35
Spart Moscow,1933,4,9,6,5,36,27,9,33
Krasnodar,1933,5,8,6,6,29,26,3,30
Terek Grozny,1933,6,8,5,7,21,25,-4,29
Din Moscow,1933,7,7,6,7,20,21,-1,27
FK Rubin,1933,8,5,6,9,22,20,2,21
Rostov,1933,9,4,6,10,10,19,-9,18
Amkar,1933,10,4,5,11,10,24,-14,17
Anzhi,1933,11,3,5,12,18,39,-21,14
Loko Moscow,1934,1,11,7,2,30,12,18,40
CSKA Moscow,1934,2,12,3,5,30,18,12,39
Spart Moscow,1934,3,10,5,5,38,28,10,35
Krasnodar,1934,4,9,5,6,30,24,6,32
Zenit,1934,5,7,9,4,22,15,7,30
Terek Grozny,1934,6,8,5,7,25,25,0,29
FK Rubin,1934,7,6,5,9,23,21,2,23
Amkar,1934,8,6,4,10,11,22,-11,22
Din Moscow,1934,9,5,6,9,19,26,-7,21
Rostov,1934,10,4,6,10,11,19,-8,18
Anzhi,1934,11,2,5,13,17,46,-29,11
Loko Moscow,1935,1,13,5,2,34,14,20,44
CSKA Moscow,1935,2,11,4,5,29,18,11,37
Spart Moscow,1935,3,9,7,4,38,28,10,34
Krasnodar,1935,4,9,4,7,31,28,3,31
Zenit,1935,5,7,9,4,23,16,7,30
Terek Grozny,1935,6,7,5,8,20,25,-5,26
FK Rubin,1935,7,6,5,9,25,21,4,23
Din Moscow,1935,8,5,6,9,19,26,-7,21
Amkar,1935,9,5,5,10,12,23,-11,20
Rostov,1935,10,4,7,9,11,18,-7,19
Anzhi,1935,11,3,5,12,16,41,-25,14
Loko Moscow,1936,1,13,5,2,33,12,21,44
CSKA Moscow,1936,2,11,4,5,32,18,14,37
Spart Moscow,1936,3,8,7,5,36,30,6,31
Zenit,1936,4,7,9,4,22,16,6,30
Krasnodar,1936,5,8,4,8,29,28,1,28
Terek Grozny,1936,6,7,5,8,20,27,-7,26
FK Rubin,1936,7,6,6,8,23,18,5,24
Din Moscow,1936,8,5,8,7,18,22,-4,23
Amkar,1936,9,6,4,10,12,22,-10,22
Rostov,1936,10,4,7,9,12,19,-7,19
Anzhi,1936,11,3,5,12,18,43,-25,14
Loko Moscow,1937,1,11,6,3,30,13,17,39
Spart Moscow,1937,2,11,5,4,45,26,19,38
CSKA Moscow,1937,3,11,3,6,31,19,12,36
Zenit,1937,4,8,9,3,24,14,10,33
Krasnodar,1937,5,9,4,7,28,27,1,31
Terek Grozny,1937,6,8,5,7,21,23,-2,29
Din Moscow,1937,7,6,6,8,20,26,-6,24
FK Rubin,1937,8,6,5,9,24,19,5,23
Amkar,1937,9,5,4,11,10,25,-15,19
Rostov,1937,10,4,6,10,10,21,-11,18
Anzhi,1937,11,2,5,13,14,44,-30,11
Loko Moscow,1938,1,11,6,3,30,14,16,39
CSKA Moscow,1938,2,11,3,6,28,19,9,36
Spart Moscow,1938,3,9,6,5,38,28,10,33
Zenit,1938,4,8,9,3,24,14,10,33
Krasnodar,1938,5,9,5,6,30,25,5,32
Terek Grozny,1938,6,8,5,7,23,24,-1,29
Din Moscow,1938,7,6,7,7,20,23,-3,25
FK Rubin,1938,8,5,7,8,23,19,4,22
Rostov,1938,9,4,7,9,11,18,-7,19
Amkar,1938,10,4,4,12,10,28,-18,16
Anzhi,1938,11,3,5,12,15,40,-25,14
Loko Moscow,1939,1,12,6,2,31,12,19,42
CSKA Moscow,1939,2,11,4,5,28,19,9,37
Spart Moscow,1939,3,10,6,4,39,27,12,36
Krasnodar,1939,4,9,5,6,30,25,5,32
Zenit,1939,5,7,9,4,23,16,7,30
Terek Grozny,1939,6,7,5,8,20,25,-5,26
Din Moscow,1939,7,6,7,7,20,22,-2,25
FK Rubin,1939,8,5,5,10,21,21,0,20
Amkar,1939,9,5,4,11,12,24,-12,19
Rostov,1939,10,4,6,10,10,20,-10,18
Anzhi,1939,11,3,5,12,15,38,-23,14
Loko Moscow,1940,1,12,6,2,32,12,20,42
CSKA Moscow,1940,2,11,4,5,27,18,9,37
Spart Moscow,1940,3,10,5,5,39,30,9,35
Terek Grozny,1940,4,9,5,6,23,23,0,32
Zenit,1940,5,7,9,4,21,15,6,30
Krasnodar,1940,6,8,6,6,29,26,3,30
FK Rubin,1940,7,5,7,8,23,19,4,22
Din Moscow,1940,8,5,7,8,18,23,-5,22
Amkar,1940,9,5,4,11,11,24,-13,19
Rostov,1940,10,4,6,10,13,21,-8,18
Anzhi,1940,11,2,5,13,16,41,-25,11
Loko Moscow,1941,1,12,5,3,32,14,18,41
Spart Moscow,1941,2,10,6,4,41,28,13,36
CSKA Moscow,1941,3,11,3,6,28,20,8,36
Zenit,1941,4,8,8,4,23,16,7,32
Krasnodar,1941,5,9,5,6,32,27,5,32
Terek Grozny,1941,6,8,6,6,22,23,-1,30
FK Rubin,1941,7,5,7,8,24,20,4,22
Din Moscow,1941,8,5,7,8,18,25,-7,22
Rostov,1941,9,4,6,10,10,19,-9,18
Amkar,1941,10,4,5,11,12,26,-14,17
Anzhi,1941,11,2,6,12,16,40,-24,12
Loko Moscow,1942,1,11,5,4,29,14,15,38
Spart Moscow,1942,2,10,6,4,37,26,11,36
CSKA Moscow,1942,3,11,3,6,30,19,11,36
Zenit,1942,4,9,8,3,25,13,12,35
Krasnodar,1942,5,9,5,6,29,25,4,32
Terek Grozny,1942,6,7,7,6,23,25,-2,28
Din Moscow,1942,7,6,6,8,20,24,-4,24
FK Rubin,1942,8,5,6,9,23,21,2,21
Rostov,1942,9,4,7,9,10,17,-7,19
Amkar,1942,10,4,5,11,11,25,-14,17
Anzhi,1942,11,2,6,12,16,44,-28,12
Loko Moscow,1943,1,12,5,3,33,15,18,41
CSKA Moscow,1943,2,11,4,5,26,17,9,37
Spart Moscow,1943,3,9,6,5,34,26,8,33
Krasnodar,1943,4,9,4,7,31,29,2,31
Zenit,1943,5,7,9,4,21,14,7,30
Terek Grozny,1943,6,8,5,7,26,27,-1,29
FK Rubin,1943,7,6,6,8,24,18,6,24
Din Moscow,1943,8,5,8,7,18,22,-4,23
Amkar,1943,9,6,4,10,14,24,-10,22
Rostov,1943,10,4,6,10,10,18,-8,18
Anzhi,1943,11,2,5,13,15,42,-27,11
Loko Moscow,1944,1,12,5,3,34,14,20,41
Spart Moscow,1944,2,10,5,5,42,29,13,35
Krasnodar,1944,3,10,4,6,31,24,7,34
CSKA Moscow,1944,4,10,4,6,26,19,7,34
Terek Grozny,1944,5,9,5,6,24,23,1,32
Zenit,1944,6,7,9,4,22,19,3,30
Din Moscow,1944,7,5,7,8,20,28,-8,22
FK Rubin,1944,8,5,6,9,23,20,3,21
Rostov,1944,9,5,6,9,12,18,-6,21
Amkar,1944,10,4,4,12,11,28,-17,16
Anzhi,1944,11,3,5,12,15,38,-23,14
Loko Moscow,1945,1,11,6,3,31,16,15,39
CSKA Moscow,1945,2,11,4,5,29,18,11,37
Spart Moscow,1945,3,9,6,5,35,27,8,33
Zenit,1945,4,7,10,3,23,15,8,31
Krasnodar,1945,5,9,4,7,32,27,5,31
Terek Grozny,1945,6,7,5,8,21,28,-7,26
Din Moscow,1945,7,6,7,7,18,21,-3,25
FK Rubin,1945,8,6,6,8,23,18,5,24
Amkar,1945,9,5,5,10,12,23,-11,20
Rostov,1945,10,4,6,10,10,18,-8,18
Anzhi,1945,11,3,5,12,18,41,-23,14
Loko Moscow,1946,1,12,6,2,31,12,19,42
CSKA Moscow,1946,2,11,4,5,28,19,9,37
Spart Moscow,1946,3,10,5,5,37,26,11,35
Zenit,1946,4,7,9,4,22,15,7,30
Terek Grozny,1946,5,8,6,6,22,22,0,30
Krasnodar,1946,6,8,5,7,28,26,2,29
FK Rubin,1946,7,6,6,8,23,18,5,24
Din Moscow,1946,8,5,7,8,18,24,-6,22
Amkar,1946,9,5,4,11,10,24,-14,19
Rostov,1946,10,4,6,10,10,19,-9,18
Anzhi,1946,11,2,6,12,15,39,-24,12
Loko Moscow,1947,1,12,6,2,34,15,19,42
CSKA Moscow,1947,2,10,5,5,27,19,8,35
Zenit,1947,3,7,10,3,24,16,8,31
Spart Moscow,1947,4,8,7,5,36,29,7,31
Krasnodar,1947,5,9,4,7,31,27,4,31
Terek Grozny,1947,6,8,6,6,22,23,-1,30
Din Moscow,1947,7,5,8,7,18,22,-4,23
FK Rubin,1947,8,5,6,9,21,19,2,21
Amkar,1947,9,5,5,10,11,23,-12,20
Rostov,1947,10,4,7,9,11,18,-7,19
Anzhi,1947,11,2,6,12,16,40,-24,12
Loko Moscow,1948,1,11,6,3,31,15,16,39
CSKA Moscow,1948,2,11,3,6,29,19,10,36
Zenit,1948,3,9,8,3,26,14,12,35
Spart Moscow,1948,4,9,6,5,38,30,8,33
Krasnodar,1948,5,8,5,7,28,26,2,29
Terek Grozny,1948,6,8,5,7,23,25,-2,29
Din Moscow,1948,7,7,6,7,21,21,0,27
FK Rubin,1948,8,6,5,9,22,19,3,23
Rostov,1948,9,4,6,10,11,20,-9,18
Amkar,1948,10,4,5,11,12,26,-14,17
Anzhi,1948,11,3,5,12,16,42,-26,14
Loko Moscow,1949,1,12,5,3,32,14,18,41
CSKA Moscow,1949,2,12,3,5,31,18,13,39
Spart Moscow,1949,3,9,6,5,36,28,8,33
Krasnodar,1949,4,9,5,6,29,25,4,32
Terek Grozny,1949,5,8,6,6,21,22,-1,30
Zenit,1949,6,7,8,5,23,18,5,29
Din Moscow,1949,7,5,8,7,19,23,-4,23
FK Rubin,1949,8,5,7,8,22,18,4,22
Amkar,1949,9,5,5,10,10,22,-12,20
Rostov,1949,10,4,6,10,10,18,-8,18
Anzhi,1949,11,2,5,13,15,42,-27,11
Loko Moscow,1950,1,13,5,2,33,12,21,44
CSKA Moscow,1950,2,12,3,5,29,19,10,39
Spart Moscow,1950,3,8,6,6,34,28,6,30
Zenit,1950,4,7,8,5,22,16,6,29
Krasnodar,1950,5,8,4,8,29,30,-1,28
Terek Grozny,1950,6,7,5,8,21,27,-6,26
Din Moscow,1950,7,6,7,7,18,21,-3,25
FK Rubin,1950,8,6,6,8,24,18,6,24
Amkar,1950,9,6,4,10,13,23,-10,22
Rostov,1950,10,4,7,9,11,18,-7,19
Anzhi,1950,11,3,5,12,17,39,-22,14
Loko Moscow,1951,1,13,5,2,32,11,21,44
Spart Moscow,1951,2,10,6,4,39,28,11,36
CSKA Moscow,1951,3,10,3,7,26,20,6,33
Zenit,1951,4,8,8,4,22,15,7,32
Krasnodar,1951,5,9,4,7,30,25,5,31
Terek Grozny,1951,6,7,6,7,21,24,-3,27
Din Moscow,1951,7,6,6,8,21,26,-5,24
FK Rubin,1951,8,5,5,10,24,24,0,20
Rostov,1951,9,4,7,9,12,19,-7,19
Amkar,1951,10,5,4,11,12,25,-13,19
Anzhi,1951,11,3,6,11,16,38,-22,15
Loko Moscow,1952,1,12,5,3,33,15,18,41
CSKA Moscow,1952,2,11,4,5,29,18,11,37
Spart Moscow,1952,3,10,5,5,37,27,10,35
Zenit,1952,4,8,9,3,25,16,9,33
Krasnodar,1952,5,8,4,8,28,28,0,28
Terek Grozny,1952,6,7,6,7,22,25,-3,27
FK Rubin,1952,7,6,6,8,23,17,6,24
Din Moscow,1952,8,5,7,8,17,22,-5,22
Rostov,1952,9,5,6,9,11,17,-6,21
Amkar,1952,10,4,5,11,11,26,-15,17
Anzhi,1952,11,3,5,12,16,41,-25,14
Loko Moscow,1953,1,12,6,2,32,13,19,42
Spart Moscow,1953,2,11,5,4,39,26,13,38
CSKA Moscow,1953,3,11,4,5,27,18,9,37
Terek Grozny,1953,4,9,5,6,25,23,2,32
Zenit,1953,5,7,10,3,23,15,8,31
Krasnodar,1953,6,8,5,7,30,28,2,29
FK Rubin,1953,7,5,7,8,25,21,4,22
Din Moscow,1953,8,5,7,8,19,26,-7,22
Rostov,1953,9,4,6,10,11,19,-8,18
Amkar,1953,10,4,4,12,9,25,-16,16
Anzhi,1953,11,2,5,13,15,41,-26,11
Loko Moscow,1954,1,12,5,3,30,13,17,41
Spart Moscow,1954,2,10,6,4,39,27,12,36
CSKA Moscow,1954,3,11,3,6,30,20,10,36
Krasnodar,1954,4,10,4,6,33,26,7,34
Zenit,1954,5,8,8,4,23,14,9,32
Terek Grozny,1954,6,8,5,7,23,23,0,29
FK Rubin,1954,7,6,5,9,25,21,4,23
Din Moscow,1954,8,5,6,9,17,25,-8,21
Rostov,1954,9,4,7,9,11,18,-7,19
Amkar,1954,10,5,4,11,11,25,-14,19
Anzhi,1954,11,2,5,13,15,45,-30,11
Loko Moscow,1955,1,12,5,3,32,13,19,41
CSKA Moscow,1955,2,11,3,6,27,19,8,36
Zenit,1955,3,9,8,3,23,13,10,35
Spart Moscow,1955,4,9,7,4,37,28,9,34
Krasnodar,1955,5,8,4,8,28,30,-2,28
Terek Grozny,1955,6,7,7,6,23,25,-2,28
Din Moscow,1955,7,6,6,8,19,22,-3,24
FK Rubin,1955,8,6,5,9,24,19,5,23
Rostov,1955,9,4,7,9,10,17,-7,19
Amkar,1955,10,4,6,10,13,26,-13,18
Anzhi,1955,11,2,6,12,17,41,-24,12
Loko Moscow,1956,1,13,5,2,32,12,20,44
CSKA Moscow,1956,2,10,4,6,28,21,7,34
Spart Moscow,1956,3,9,6,5,37,28,9,33
Krasnodar,1956,4,9,4,7,29,26,3,31
Zenit,1956,5,7,9,4,23,16,7,30
Terek Grozny,1956,6,8,6,6,24,25,-1,30
Din Moscow,1956,7,5,7,8,19,25,-6,22
FK Rubin,1956,8,5,6,9,21,18,3,21
Rostov,1956,9,4,7,9,10,17,-7,19
Amkar,1956,10,5,4,11,11,24,-13,19
Anzhi,1956,11,3,6,11,18,40,-22,15
Loko Moscow,1957,1,13,5,2,31,11,20,44
Spart Moscow,1957,2,10,5,5,41,29,12,35
CSKA Moscow,1957,3,10,4,6,27,20,7,34
Zenit,1957,4,8,8,4,23,15,8,32
Krasnodar,1957,5,9,4,7,30,26,4,31
Terek Grozny,1957,6,8,6,6,23,24,-1,30
Din Moscow,1957,7,6,7,7,21,23,-2,25
FK Rubin,1957,8,5,6,9,23,21,2,21
Rostov,1957,9,4,6,10,10,21,-11,18
Amkar,1957,10,4,4,12,11,27,-16,16
Anzhi,1957,11,2,7,11,16,39,-23,13
Loko Moscow,1958,1,12,5,3,31,13,18,41
CSKA Moscow,1958,2,11,3,6,29,20,9,36
Spart Moscow,1958,3,8,7,5,34,28,6,31
Krasnodar,1958,4,9,4,7,29,26,3,31
Terek Grozny,1958,5,8,6,6,22,23,-1,30
Zenit,1958,6,7,8,5,21,16,5,29
FK Rubin,1958,7,7,5,8,23,17,6,26
Din Moscow,1958,8,5,7,8,17,22,-5,22
Rostov,1958,9,5,6,9,12,17,-5,21
Amkar,1958,10,4,6,10,11,24,-13,18
Anzhi,1958,11,3,5,12,17,40,-23,14
Loko Moscow,1959,1,11,6,3,31,16,15,39
CSKA Moscow,1959,2,11,4,5,27,18,9,37
Krasnodar,1959,3,10,4,6,33,26,7,34
Spart Moscow,1959,4,9,5,6,36,29,7,32
Zenit,1959,5,7,9,4,22,15,7,30
Din Moscow,1959,6,7,6,7,20,22,-2,27
Terek Grozny,1959,7,7,6,7,21,24,-3,27
Rostov,1959,8,5,6,9,12,18,-6,21
FK Rubin,1959,9,5,5,10,23,21,2,20
Amkar,1959,10,5,4,11,11,24,-13,19
Anzhi,1959,11,2,7,11,16,39,-23,13
Loko Moscow,1960,1,11,6,3,31,16,15,39
Spart Moscow,1960,2,11,5,4,40,27,13,38
CSKA Moscow,1960,3,11,3,6,29,21,8,36
Zenit,1960,4,9,8,3,26,13,13,35
Krasnodar,1960,5,9,5,6,31,26,5,32
Terek Grozny,1960,6,7,6,7,20,25,-5,27
FK Rubin,1960,7,6,5,9,22,19,3,23
Din Moscow,1960,8,5,6,9,18,24,-6,21
Rostov,1960,9,4,6,10,10,20,-10,18
Amkar,1960,10,4,5,11,10,24,-14,17
Anzhi,1960,11,3,5,12,19,41,-22,14
Loko Moscow,1961,1,13,5,2,34,12,22,44
CSKA Moscow,1961,2,11,3,6,30,19,11,36
Spart Moscow,1961,3,10,5,5,39,27,12,35
Zenit,1961,4,8,8,4,23,15,8,32
Krasnodar,1961,5,9,4,7,31,29,2,31
Terek Grozny,1961,6,7,5,8,21,27,-6,26
Din Moscow,1961,7,6,6,8,19,23,-4,24
FK Rubin,1961,8,6,5,9,25,21,4,23
Amkar,1961,9,5,4,11,13,25,-12,19
Rostov,1961,10,4,6,10,10,21,-11,18
Anzhi,1961,11,3,5,12,16,42,-26,14
Loko Moscow,1962,1,11,5,4,31,17,14,38
Spart Moscow,1962,2,10,5,5,40,29,11,35
Zenit,1962,3,9,8,3,25,15,10,35
CSKA Moscow,1962,4,10,4,6,26,19,7,34
Krasnodar,1962,5,9,4,7,31,26,5,31
Din Moscow,1962,6,7,6,7,20,22,-2,27
Terek Grozny,1962,7,7,6,7,21,26,-5,27
FK Rubin,1962,8,6,5,9,22,18,4,23
Rostov,1962,9,4,6,10,12,21,-9,18
Amkar,1962,10,4,5,11,9,24,-15,17
Anzhi,1962,11,3,6,11,18,38,-20,15
Loko Moscow,1963,1,12,5,3,30,12,18,41
Spart Moscow,1963,2,10,6,4,41,29,12,36
CSKA Moscow,1963,3,11,3,6,27,18,9,36
Zenit,1963,4,9,8,3,23,13,10,35
Krasnodar,1963,5,8,4,8,29,28,1,28
Terek Grozny,1963,6,7,6,7,21,24,-3,27
FK Rubin,1963,7,7,5,8,26,20,6,26
Din Moscow,1963,8,5,6,9,19,26,-7,21
Rostov,1963,9,4,6,10,10,19,-9,18
Amkar,1963,10,4,6,10,13,26,-13,18
Anzhi,1963,11,3,5,12,15,39,-24,14
CSKA Moscow,1964,1,12,3,5,28,17,11,39
Loko Moscow,1964,2,11,5,4,30,15,15,38
Spart Moscow,1964,3,9,6,5,39,31,8,33
Zenit,1964,4,8,8,4,22,14,8,32
Krasnodar,1964,5,9,4,7,31,27,4,31
Terek Grozny,1964,6,8,5,7,23,23,0,29
Din Moscow,1964,7,6,6,8,20,23,-3,24
FK Rubin,1964,8,6,5,9,23,21,2,23
Rostov,1964,9,5,6,9,13,18,-5,21
Amkar,1964,10,5,5,10,13,25,-12,20
Anzhi,1964,11,2,5,13,14,42,-28,11
Loko Moscow,1965,1,12,6,2,33,14,19,42
Spart Moscow,1965,2,10,5,5,39,30,9,35
Zenit,1965,3,8,9,3,26,14,12,33
CSKA Moscow,1965,4,10,3,7,25,23,2,33
Krasnodar,1965,5,8,5,7,30,28,2,29
Terek Grozny,1965,6,8,5,7,23,25,-2,29
Din Moscow,1965,7,6,6,8,22,25,-3,24
FK Rubin,1965,8,5,6,9,23,21,2,21
Amkar,1965,9,5,4,11,12,26,-14,19
Rostov,1965,10,4,6,10,10,18,-8,18
Anzhi,1965,11,4,5,11,19,38,-19,17
Loko Moscow,1966,1,12,6,2,31,12,19,42
CSKA Moscow,1966,2,11,4,5,27,18,9,37
Spart Moscow,1966,3,8,8,4,36,28,8,32
Zenit,1966,4,7,9,4,21,14,7,30
Terek Grozny,1966,5,8,6,6,22,23,-1,30
Krasnodar,1966,6,8,5,7,29,27,2,29
Din Moscow,1966,7,5,8,7,19,23,-4,23
FK Rubin,1966,8,5,7,8,22,18,4,22
Rostov,1966,9,4,7,9,10,17,-7,19
Amkar,1966,10,4,5,11,10,24,-14,17
Anzhi,1966,11,2,7,11,16,39,-23,13
Loko Moscow,1967,1,12,6,2,32,12,20,42
CSKA Moscow,1967,2,12,3,5,29,17,12,39
Spart Moscow,1967,3,9,5,6,37,30,7,32
Krasnodar,1967,4,8,6,6,30,27,3,30
Terek Grozny,1967,5,8,6,6,22,23,-1,30
Zenit,1967,6,7,8,5,21,17,4,29
Din Moscow,1967,7,6,7,7,20,22,-2,25
FK Rubin,1967,8,5,7,8,24,20,4,22
Amkar,1967,9,5,4,11,13,25,-12,19
Rostov,1967,10,4,6,10,10,20,-10,18
Anzhi,1967,11,2,6,12,14,39,-25,12
Loko Moscow,1968,1,12,5,3,33,14,19,41
CSKA Moscow,1968,2,11,3,6,27,19,8,36
Zenit,1968,3,9,8,3,26,15,11,35
Spart Moscow,1968,4,8,7,5,35,28,7,31
Krasnodar,1968,5,8,4,8,28,29,-1,28
Terek Grozny,1968,6,7,6,7,20,23,-3,27
FK Rubin,1968,7,7,5,8,29,21,8,26
Din Moscow,1968,8,5,7,8,21,28,-7,22
Rostov,1968,9,5,6,9,11,17,-6,21
Amkar,1968,10,5,5,10,11,23,-12,20
Anzhi,1968,11,2,6,12,14,38,-24,12
Loko Moscow,1969,1,11,6,3,31,14,17,39
CSKA Moscow,1969,2,11,3,6,28,21,7,36
Zenit,1969,3,9,8,3,26,14,12,35
Spart Moscow,1969,4,10,5,5,39,29,10,35
Krasnodar,1969,5,8,6,6,29,26,3,30
Terek Grozny,1969,6,7,6,7,20,25,-5,27
Din Moscow,1969,7,6,6,8,20,26,-6,24
FK Rubin,1969,8,5,6,9,23,20,3,21
Amkar,1969,9,5,5,10,12,23,-11,20
Rostov,1969,10,4,6,10,10,18,-8,18
Anzhi,1969,11,3,5,12,18,40,-22,14
Loko Moscow,1970,1,11,6,3,32,15,17,39
CSKA Moscow,1970,2,12,3,5,31,18,13,39
Spart Moscow,1970,3,10,5,5,37,27,10,35
Krasnodar,1970,4,10,4,6,32,26,6,34
Zenit,1970,5,7,9,4,22,15,7,30
Terek Grozny,1970,6,8,6,6,24,25,-1,30
Din Moscow,1970,7,5,7,8,18,24,-6,22
FK Rubin,1970,8,5,6,9,21,19,2,21
Rostov,1970,9,5,6,9,11,17,-6,21
Amkar,1970,10,4,5,11,11,25,-14,17
Anzhi,1970,11,2,5,13,16,44,-28,11
Loko Moscow,1971,1,12,5,3,31,13,18,41
CSKA Moscow,1971,2,11,4,5,28,19,9,37
Zenit,1971,3,8,9,3,24,15,9,33
Spart Moscow,1971,4,8,7,5,34,27,7,31
Krasnodar,1971,5,9,4,7,29,25,4,31
Terek Grozny,1971,6,7,5,8,21,27,-6,26
Din Moscow,1971,7,5,8,7,17,21,-4,23
Amkar,1971,8,6,4,10,13,22,-9,22
FK Rubin,1971,9,5,6,9,21,19,2,21
Rostov,1971,10,4,7,9,11,18,-7,19
Anzhi,1971,11,3,5,12,17,40,-23,14
Loko Moscow,1972,1,12,5,3,30,13,17,41
CSKA Moscow,1972,2,11,3,6,29,20,9,36
Spart Moscow,1972,3,9,7,4,38,28,10,34
Krasnodar,1972,4,10,4,6,32,26,6,34
Zenit,1972,5,8,8,4,23,15,8,32
Terek Grozny,1972,6,7,6,7,21,25,-4,27
FK Rubin,1972,7,6,5,9,26,22,4,23
Din Moscow,1972,8,5,7,8,20,25,-5,22
Amkar,1972,9,5,5,10,12,23,-11,20
Rostov,1972,10,4,6,10,11,20,-9,18
Anzhi,1972,11,2,6,12,16,41,-25,12
Loko Moscow,1973,1,13,5,2,33,12,21,44
CSKA Moscow,1973,2,11,3,6,29,19,10,36
Spart Moscow,1973,3,9,6,5,36,27,9,33
Zenit,1973,4,8,8,4,23,15,8,32
Terek Grozny,1973,5,9,5,6,27,22,5,32
Krasnodar,1973,6,9,4,7,28,26,2,31
Din Moscow,1973,7,6,7,7,21,23,-2,25
Rostov,1973,8,5,6,9,11,17,-6,21
FK Rubin,1973,9,5,5,10,22,21,1,20
Amkar,1973,10,4,4,12,9,25,-16,16
Anzhi,1973,11,2,5,13,15,47,-32,11
Loko Moscow,1974,1,12,5,3,33,16,17,41
CSKA Moscow,1974,2,11,4,5,27,18,9,37
Krasnodar,1974,3,10,4,6,32,26,6,34
Spart Moscow,1974,4,9,6,5,39,31,8,33
Zenit,1974,5,7,9,4,23,16,7,30
Terek Grozny,1974,6,8,5,7,23,26,-3,29
Din Moscow,1974,7,6,6,8,20,23,-3,24
FK Rubin,1974,8,6,5,9,23,19,4,23
Amkar,1974,9,5,5,10,15,26,-11,20
Rostov,1974,10,4,6,10,10,19,-9,18
Anzhi,1974,11,2,5,13,16,41,-25,11
Loko Moscow,1975,1,13,5,2,34,14,20,44
CSKA Moscow,1975,2,11,3,6,30,20,10,36
Spart Moscow,1975,3,9,6,5,35,26,9,33
Zenit,1975,4,8,8,4,25,16,9,32
Krasnodar,1975,5,9,4,7,31,27,4,31
Terek Grozny,1975,6,8,5,7,22,25,-3,29
Din Moscow,1975,7,6,6,8,20,24,-4,24
Rostov,1975,8,5,6,9,11,17,-6,21
FK Rubin,1975,9,5,5,10,22,22,0,20
Amkar,1975,10,4,5,11,10,24,-14,17
Anzhi,1975,11,3,5,12,16,41,-25,14
Loko Moscow,1976,1,11,6,3,31,14,17,39
CSKA Moscow,1976,2,11,3,6,28,21,7,36
Spart Moscow,1976,3,9,7,4,39,29,10,34
Krasnodar,1976,4,10,4,6,32,26,6,34
Zenit,1976,5,8,9,3,25,13,12,33
Terek Grozny,1976,6,7,6,7,21,26,-5,27
FK Rubin,1976,7,6,5,9,22,19,3,23
Din Moscow,1976,8,5,6,9,18,25,-7,21
Rostov,1976,9,4,7,9,12,19,-7,19
Amkar,1976,10,4,6,10,10,23,-13,18
Anzhi,1976,11,3,5,12,18,41,-23,14
Loko Moscow,1977,1,12,6,2,32,13,19,42
CSKA Moscow,1977,2,11,3,6,28,20,8,36
Zenit,1977,3,7,9,4,23,16,7,30
Spart Moscow,1977,4,8,5,7,34,32,2,29
Krasnodar,1977,5,8,4,8,28,28,0,28
Terek Grozny,1977,6,7,7,6,21,23,-2,28
FK Rubin,1977,7,7,5,8,27,19,8,26
Din Moscow,1977,8,6,6,8,20,25,-5,24
Rostov,1977,9,5,6,9,12,17,-5,21
Amkar,1977,10,5,5,10,14,24,-10,20
Anzhi,1977,11,3,6,11,16,38,-22,15
Loko Moscow,1978,1,12,6,2,32,13,19,42
CSKA Moscow,1978,2,11,4,5,27,18,9,37
Spart Moscow,1978,3,9,5,6,35,29,6,32
Terek Grozny,1978,4,8,6,6,24,23,1,30
Zenit,1978,5,7,8,5,23,17,6,29
Krasnodar,1978,6,8,5,7,28,26,2,29
FK Rubin,1978,7,7,5,8,24,18,6,26
Din Moscow,1978,8,6,6,8,19,22,-3,24
Rostov,1978,9,5,6,9,12,17,-5,21
Amkar,1978,10,4,5,11,10,25,-15,17
Anzhi,1978,11,2,6,12,15,41,-26,12
Loko Moscow,1979,1,11,6,3,31,14,17,39
CSKA Moscow,1979,2,11,4,5,27,18,9,37
Spart Moscow,1979,3,10,5,5,38,29,9,35
Zenit,1979,4,8,8,4,22,14,8,32
Krasnodar,1979,5,8,5,7,30,28,2,29
FK Rubin,1979,6,7,5,8,25,19,6,26
Terek Grozny,1979,7,7,5,8,21,25,-4,26
Din Moscow,1979,8,6,6,8,21,25,-4,24
Amkar,1979,9,5,4,11,11,24,-13,19
Rostov,1979,10,4,6,10,11,19,-8,18
Anzhi,1979,11,3,6,11,16,38,-22,15
Loko Moscow,1980,1,11,6,3,30,14,16,39
Zenit,1980,2,9,8,3,25,13,12,35
Spart Moscow,1980,3,9,7,4,39,29,10,34
CSKA Moscow,1980,4,10,4,6,28,22,6,34
Krasnodar,1980,5,8,6,6,29,26,3,30
Terek Grozny,1980,6,8,5,7,22,23,-1,29
Din Moscow,1980,7,5,8,7,18,22,-4,23
FK Rubin,1980,8,5,7,8,22,18,4,22
Rostov,1980,9,4,7,9,13,20,-7,19
Amkar,1980,10,4,4,12,9,26,-17,16
Anzhi,1980,11,3,6,11,18,40,-22,15
Loko Moscow,1981,1,11,6,3,30,14,16,39
CSKA Moscow,1981,2,11,4,5,27,18,9,37
Spart Moscow,1981,3,10,6,4,40,26,14,36
Zenit,1981,4,8,8,4,23,14,9,32
Krasnodar,1981,5,8,5,7,28,27,1,29
Terek Grozny,1981,6,7,7,6,20,22,-2,28
Din Moscow,1981,7,6,6,8,21,26,-5,24
FK Rubin,1981,8,6,5,9,24,20,4,23
Rostov,1981,9,4,6,10,10,20,-10,18
Amkar,1981,10,4,6,10,9,22,-13,18
Anzhi,1981,11,2,7,11,15,38,-23,13
Loko Moscow,1982,1,12,6,2,33,13,20,42
Spart Moscow,1982,2,10,6,4,42,28,14,36
Zenit,1982,3,8,9,3,25,15,10,33
CSKA Moscow,1982,4,10,3,7,27,23,4,33
Krasnodar,1982,5,9,4,7,28,26,2,31
Terek Grozny,1982,6,7,6,7,21,26,-5,27
FK Rubin,1982,7,6,5,9,22,18,4,23
Din Moscow,1982,8,5,7,8,19,24,-5,22
Rostov,1982,9,4,6,10,10,20,-10,18
Amkar,1982,10,4,5,11,11,27,-16,17
Anzhi,1982,11,4,5,11,21,39,-18,17
Loko Moscow,1983,1,11,6,3,30,13,17,39
CSKA Moscow,1983,2,11,4,5,27,18,9,37
Spart Moscow,1983,3,10,6,4,36,26,10,36
Krasnodar,1983,4,9,5,6,29,25,4,32
Zenit,1983,5,7,10,3,23,15,8,31
Terek Grozny,1983,6,8,6,6,24,23,1,30
FK Rubin,1983,7,6,6,8,25,19,6,24
Din Moscow,1983,8,5,6,9,18,25,-7,21
Rostov,1983,9,4,6,10,10,18,-8,18
Amkar,1983,10,4,6,10,11,24,-13,18
Anzhi,1983,11,2,5,13,14,41,-27,11
Loko Moscow,1984,1,12,6,2,32,13,19,42
CSKA Moscow,1984,2,11,3,6,27,21,6,36
Spart Moscow,1984,3,9,7,4,38,28,10,34
Zenit,1984,4,8,9,3,27,15,12,33
Krasnodar,1984,5,9,4,7,28,25,3,31
Terek Grozny,1984,6,8,5,7,24,23,1,29
Din Moscow,1984,7,5,8,7,18,22,-4,23
FK Rubin,1984,8,5,6,9,21,18,3,21
Amkar,1984,9,5,5,10,11,23,-12,20
Rostov,1984,10,4,6,10,11,20,-9,18
Anzhi,1984,11,2,5,13,14,43,-29,11
Loko Moscow,1985,1,11,6,3,31,18,13,39
Spart Moscow,1985,2,11,5,4,38,26,12,38
CSKA Moscow,1985,3,11,4,5,26,17,9,37
Krasnodar,1985,4,9,5,6,34,26,8,32
Zenit,1985,5,7,10,3,23,15,8,31
Terek Grozny,1985,6,8,5,7,22,23,-1,29
Din Moscow,1985,7,6,6,8,20,24,-4,24
FK Rubin,1985,8,5,6,9,24,21,3,21
Rostov,1985,9,4,6,10,10,19,-9,18
Amkar,1985,10,4,4,12,9,25,-16,16
Anzhi,1985,11,3,5,12,15,38,-23,14
Loko Moscow,1986,1,13,5,2,33,11,22,44
CSKA Moscow,1986,2,11,4,5,28,18,10,37
Spart Moscow,1986,3,9,6,5,35,27,8,33
Zenit,1986,4,7,9,4,22,17,5,30
Terek Grozny,1986,5,8,6,6,22,23,-1,30
Krasnodar,1986,6,8,5,7,27,25,2,29
FK Rubin,1986,7,5,7,8,22,18,4,22
Din Moscow,1986,8,5,7,8,18,23,-5,22
Rostov,1986,9,5,6,9,12,18,-6,21
Amkar,1986,10,4,6,10,9,22,-13,18
Anzhi,1986,11,2,5,13,15,41,-26,11
Loko Moscow,1987,1,11,5,4,30,14,16,38
CSKA Moscow,1987,2,11,4,5,31,18,13,37
Zenit,1987,3,8,9,3,23,14,9,33
Spart Moscow,1987,4,8,8,4,35,27,8,32
Terek Grozny,1987,5,9,5,6,28,24,4,32
Krasnodar,1987,6,9,4,7,31,29,2,31
Din Moscow,1987,7,6,7,7,20,21,-1,25
FK Rubin,1987,8,6,5,9,25,22,3,23
Rostov,1987,9,4,7,9,10,17,-7,19
Amkar,1987,10,4,5,11,13,29,-16,17
Anzhi,1987,11,2,5,13,14,45,-31,11
Loko Moscow,1988,1,11,6,3,30,13,17,39
Spart Moscow,1988,2,10,5,5,40,29,11,35
Zenit,1988,3,8,9,3,25,15,10,33
CSKA Moscow,1988,4,10,3,7,26,21,5,33
Krasnodar,1988,5,9,4,7,28,25,3,31
Terek Grozny,1988,6,8,5,7,24,26,-2,29
FK Rubin,1988,7,7,5,8,24,17,7,26
Amkar,1988,8,6,4,10,14,24,-10,22
Din Moscow,1988,9,5,6,9,17,27,-10,21
Rostov,1988,10,4,6,10,12,20,-8,18
Anzhi,1988,11,3,5,12,16,39,-23,14
Loko Moscow,1989,1,11,6,3,32,16,16,39
CSKA Moscow,1989,2,12,3,5,30,19,11,39
Spart Moscow,1989,3,10,6,4,36,26,10,36
Krasnodar,1989,4,10,4,6,33,27,6,34
Zenit,1989,5,7,9,4,24,17,7,30
Terek Grozny,1989,6,8,5,7,21,24,-3,29
Din Moscow,1989,7,6,6,8,18,22,-4,24
FK Rubin,1989,8,5,5,10,22,20,2,20
Amkar,1989,9,5,5,10,12,23,-11,20
Rostov,1989,10,4,6,10,10,18,-8,18
Anzhi,1989,11,2,5,13,14,40,-26,11
Loko Moscow,1990,1,12,5,3,31,14,17,41
CSKA Moscow,1990,2,11,3,6,28,20,8,36
Spart Moscow,1990,3,10,5,5,37,28,9,35
Krasnodar,1990,4,10,4,6,32,26,6,34
Terek Grozny,1990,5,9,5,6,26,25,1,32
Zenit,1990,6,7,8,5,22,16,6,29
FK Rubin,1990,7,6,5,9,24,20,4,23
Din Moscow,1990,8,5,6,9,18,25,-7,21
Amkar,1990,9,5,4,11,11,24,-13,19
Rostov,1990,10,4,6,10,11,19,-8,18
Anzhi,1990,11,3,5,12,19,42,-23,14
Loko Moscow,1991,1,11,6,3,30,13,17,39
Zenit,1991,2,8,9,3,24,14,10,33
Spart Moscow,1991,3,9,6,5,38,30,8,33
CSKA Moscow,1991,4,10,3,7,26,21,5,33
Krasnodar,1991,5,9,5,6,29,25,4,32
Terek Grozny,1991,6,8,6,6,25,26,-1,30
FK Rubin,1991,7,6,6,8,24,19,5,24
Din Moscow,1991,8,5,6,9,19,25,-6,21
Rostov,1991,9,5,6,9,12,18,-6,21
Amkar,1991,10,4,6,10,12,25,-13,18
Anzhi,1991,11,3,5,12,19,42,-23,14
Loko Moscow,1992,1,12,6,2,33,14,19,42
Spart Moscow,1992,2,9,6,5,35,28,7,33
CSKA Moscow,1992,3,10,3,7,25,19,6,33
Zenit,1992,4,8,8,4,23,15,8,32
Krasnodar,1992,5,9,5,6,31,27,4,32
Terek Grozny,1992,6,8,5,7,21,23,-2,29
Din Moscow,1992,7,6,6,8,20,23,-3,24
FK Rubin,1992,8,6,5,9,24,20,4,23
Amkar,1992,9,5,5,10,10,22,-12,20
Rostov,1992,10,4,6,10,11,19,-8,18
Anzhi,1992,11,3,5,12,15,38,-23,14
Loko Moscow,1993,1,11,6,3,29,12,17,39
Spart Moscow,1993,2,11,5,4,40,27,13,38
CSKA Moscow,1993,3,11,3,6,26,18,8,36
Zenit,1993,4,9,8,3,23,13,10,35
Krasnodar,1993,5,9,5,6,28,24,4,32
Terek Grozny,1993,6,8,6,6,24,24,0,30
Din Moscow,1993,7,5,7,8,18,24,-6,22
FK Rubin,1993,8,5,6,9,21,18,3,21
Rostov,1993,9,4,6,10,10,18,-8,18
Amkar,1993,10,4,5,11,11,26,-15,17
Anzhi,1993,11,2,5,13,15,41,-26,11
Loko Moscow,1994,1,12,6,2,32,13,19,42
CSKA Moscow,1994,2,12,3,5,29,18,11,39
Spart Moscow,1994,3,10,5,5,38,28,10,35
Terek Grozny,1994,4,9,5,6,23,23,0,32
Zenit,1994,5,7,9,4,22,16,6,30
Krasnodar,1994,6,8,4,8,29,29,0,28
Din Moscow,1994,7,6,6,8,21,25,-4,24
FK Rubin,1994,8,6,5,9,26,21,5,23
Rostov,1994,9,5,6,9,12,18,-6,21
Amkar,1994,10,4,4,12,10,26,-16,16
Anzhi,1994,11,2,5,13,15,40,-25,11
Loko Moscow,1995,1,12,5,3,32,14,18,41
CSKA Moscow,1995,2,11,3,6,29,21,8,36
Krasnodar,1995,3,10,4,6,33,25,8,34
Spart Moscow,1995,4,9,6,5,41,32,9,33
Zenit,1995,5,8,8,4,23,17,6,32
Terek Grozny,1995,6,7,5,8,21,26,-5,26
Din Moscow,1995,7,6,7,7,21,24,-3,25
Amkar,1995,8,6,4,10,16,25,-9,22
FK Rubin,1995,9,5,5,10,23,22,1,20
Rostov,1995,10,4,6,10,10,20,-10,18
Anzhi,1995,11,3,5,12,18,41,-23,14
Loko Moscow,1996,1,12,6,2,34,13,21,42
Spart Moscow,1996,2,10,6,4,42,30,12,36
CSKA Moscow,1996,3,11,3,6,28,20,8,36
Zenit,1996,4,8,8,4,23,17,6,32
Krasnodar,1996,5,8,5,7,29,28,1,29
Terek Grozny,1996,6,8,5,7,22,26,-4,29
FK Rubin,1996,7,6,6,8,24,18,6,24
Din Moscow,1996,8,5,8,7,19,23,-4,23
Rostov,1996,9,4,6,10,12,20,-8,18
Amkar,1996,10,4,4,12,11,28,-17,16
Anzhi,1996,11,3,5,12,19,40,-21,14
Loko Moscow,1997,1,11,6,3,29,14,15,39
Spart Moscow,1997,2,11,5,4,40,28,12,38
CSKA Moscow,1997,3,11,3,6,27,19,8,36
Krasnodar,1997,4,10,4,6,33,25,8,34
Zenit,1997,5,8,9,3,23,13,10,33
Terek Grozny,1997,6,7,6,7,21,26,-5,27
Din Moscow,1997,7,5,7,8,19,25,-6,22
FK Rubin,1997,8,5,6,9,23,21,2,21
Amkar,1997,9,5,4,11,13,24,-11,19
Rostov,1997,10,4,6,10,11,19,-8,18
Anzhi,1997,11,2,6,12,15,40,-25,12
Loko Moscow,1998,1,11,7,2,31,13,18,40
CSKA Moscow,1998,2,11,3,6,29,21,8,36
Zenit,1998,3,8,9,3,24,14,10,33
Spart Moscow,1998,4,8,8,4,35,27,8,32
Krasnodar,1998,5,9,5,6,31,25,6,32
Terek Grozny,1998,6,7,6,7,20,24,-4,27
Din Moscow,1998,7,6,7,7,20,22,-2,25
FK Rubin,1998,8,5,5,10,21,22,-1,20
Rostov,1998,9,4,7,9,11,18,-7,19
Amkar,1998,10,4,6,10,9,22,-13,18
Anzhi,1998,11,3,5,12,18,41,-23,14
Loko Moscow,1999,1,12,6,2,33,14,19,42
Spart Moscow,1999,2,11,5,4,39,26,13,38
CSKA Moscow,1999,3,11,3,6,26,18,8,36
Zenit,1999,4,8,8,4,24,16,8,32
Krasnodar,1999,5,9,5,6,30,26,4,32
Terek Grozny,1999,6,8,5,7,25,24,1,29
Din Moscow,1999,7,5,7,8,21,26,-5,22
FK Rubin,1999,8,5,6,9,25,22,3,21
Rostov,1999,9,4,6,10,10,20,-10,18
Amkar,1999,10,4,4,12,9,27,-18,16
Anzhi,1999,11,3,5,12,16,39,-23,14
Loko Moscow,2000,1,11,6,3,29,13,16,39
CSKA Moscow,2000,2,12,3,5,29,18,11,39
Spart Moscow,2000,3,9,6,5,39,30,9,33
Zenit,2000,4,8,8,4,24,15,9,32
Terek Grozny,2000,5,9,5,6,23,23,0,32
Krasnodar,2000,6,8,6,6,27,24,3,30
Din Moscow,2000,7,6,7,7,21,22,-1,25
FK Rubin,2000,8,5,7,8,22,18,4,22
Rostov,2000,9,4,7,9,11,18,-7,19
Amkar,2000,10,4,4,12,10,28,-18,16
Anzhi,2000,11,2,5,13,15,41,-26,11
Loko Moscow,2001,1,11,7,2,32,14,18,40
CSKA Moscow,2001,2,12,3,5,29,19,10,39
Spart Moscow,2001,3,10,6,4,38,25,13,36
Zenit,2001,4,7,9,4,23,16,7,30
Krasnodar,2001,5,8,6,6,29,26,3,30
Terek Grozny,2001,6,8,5,7,23,24,-1,29
Din Moscow,2001,7,6,6,8,19,23,-4,24
FK Rubin,2001,8,5,6,9,23,20,3,21
Amkar,2001,9,5,5,10,11,22,-11,20
Rostov,2001,10,4,6,10,10,21,-11,18
Anzhi,2001,11,2,5,13,16,43,-27,11
Loko Moscow,2002,1,12,5,3,30,12,18,41
CSKA Moscow,2002,2,12,3,5,27,17,10,39
Spart Moscow,2002,3,9,6,5,39,28,11,33
Zenit,2002,4,8,8,4,22,14,8,32
Krasnodar,2002,5,8,5,7,28,26,2,29
Terek Grozny,2002,6,7,6,7,22,25,-3,27
Din Moscow,2002,7,6,7,7,19,22,-3,25
FK Rubin,2002,8,5,7,8,23,19,4,22
Rostov,2002,9,4,6,10,10,21,-11,18
Amkar,2002,10,4,6,10,12,25,-13,18
Anzhi,2002,11,3,5,12,16,39,-23,14
Loko Moscow,2003,1,12,5,3,32,13,19,41
Spart Moscow,2003,2,10,5,5,37,26,11,35
CSKA Moscow,2003,3,10,3,7,25,23,2,33
Zenit,2003,4,8,8,4,24,15,9,32
Krasnodar,2003,5,9,4,7,29,27,2,31
Terek Grozny,2003,6,7,5,8,21,25,-4,26
Din Moscow,2003,7,6,6,8,20,24,-4,24
FK Rubin,2003,8,6,5,9,24,20,4,23
Rostov,2003,9,5,6,9,11,17,-6,21
Amkar,2003,10,5,4,11,10,24,-14,19
Anzhi,2003,11,4,5,11,19,38,-19,17
Loko Moscow,2004,1,12,5,3,31,14,17,41
Spart Moscow,2004,2,10,6,4,37,27,10,36
CSKA Moscow,2004,3,11,3,6,27,19,8,36
Krasnodar,2004,4,10,4,6,32,24,8,34
Zenit,2004,5,8,8,4,22,15,7,32
Terek Grozny,2004,6,8,6,6,23,24,-1,30
FK Rubin,2004,7,6,5,9,24,21,3,23
Din Moscow,2004,8,5,6,9,19,25,-6,21
Rostov,2004,9,4,7,9,11,18,-7,19
Amkar,2004,10,4,4,12,11,26,-15,16
Anzhi,2004,11,2,6,12,16,40,-24,12
Loko Moscow,2005,1,12,5,3,33,13,20,41
CSKA Moscow,2005,2,12,3,5,32,17,15,39
Spart Moscow,2005,3,10,6,4,39,26,13,36
Krasnodar,2005,4,10,4,6,31,26,5,34
Zenit,2005,5,7,8,5,21,18,3,29
Terek Grozny,2005,6,7,6,7,21,25,-4,27
Din Moscow,2005,7,5,7,8,19,25,-6,22
FK Rubin,2005,8,5,6,9,24,21,3,21
Rostov,2005,9,4,7,9,10,17,-7,19
Amkar,2005,10,4,5,11,10,26,-16,17
Anzhi,2005,11,3,5,12,17,43,-26,14
Loko Moscow,2006,1,12,6,2,32,12,20,42
CSKA Moscow,2006,2,11,4,5,29,19,10,37
Spart Moscow,2006,3,9,7,4,36,27,9,34
Krasnodar,2006,4,9,5,6,30,25,5,32
Zenit,2006,5,7,9,4,23,17,6,30
Terek Grozny,2006,6,7,6,7,22,25,-3,27
FK Rubin,2006,7,6,5,9,23,20,3,23
Din Moscow,2006,8,5,7,8,19,24,-5,22
Rostov,2006,9,4,7,9,11,18,-7,19
Amkar,2006,10,4,5,11,9,23,-14,17
Anzhi,2006,11,3,5,12,17,41,-24,14
Loko Moscow,2007,1,12,5,3,31,13,18,41
CSKA Moscow,2007,2,11,3,6,30,21,9,36
Zenit,2007,3,9,8,3,25,14,11,35
Spart Moscow,2007,4,9,7,4,35,26,9,34
Krasnodar,2007,5,8,4,8,29,29,0,28
Terek Grozny,2007,6,7,5,8,20,25,-5,26
FK Rubin,2007,7,6,6,8,25,19,6,24
Din Moscow,2007,8,5,7,8,19,24,-5,22
Amkar,2007,9,5,5,10,11,22,-11,20
Rostov,2007,10,4,7,9,10,17,-7,19
Anzhi,2007,11,3,5,12,16,41,-25,14
Loko Moscow,2008,1,12,6,2,32,12,20,42
CSKA Moscow,2008,2,10,4,6,26,19,7,34
Spart Moscow,2008,3,9,5,6,41,31,10,32
Zenit,2008,4,8,8,4,24,17,7,32
Krasnodar,2008,5,8,6,6,28,25,3,30
Terek Grozny,2008,6,7,5,8,20,24,-4,26
Din Moscow,2008,7,6,7,7,20,23,-3,25
FK Rubin,2008,8,5,7,8,22,18,4,22
Amkar,2008,9,6,4,10,13,24,-11,22
Rostov,2008,10,4,6,10,10,21,-11,18
Anzhi,2008,11,3,6,11,15,37,-22,15
Loko Moscow,2009,1,13,5,2,33,12,21,44
Spart Moscow,2009,2,11,5,4,39,27,12,38
CSKA Moscow,2009,3,10,4,6,26,19,7,34
Zenit,2009,4,7,9,4,22,16,6,30
Terek Grozny,2009,5,8,5,7,24,25,-1,29
Krasnodar,2009,6,8,4,8,29,29,0,28
FK Rubin,2009,7,6,6,8,24,18,6,24
Din Moscow,2009,8,5,7,8,17,23,-6,22
Rostov,2009,9,4,6,10,10,18,-8,18
Anzhi,2009,10,4,5,11,18,39,-21,17
Amkar,2009,11,4,4,12,11,27,-16,16
Loko Moscow,2010,1,11,6,3,29,12,17,39
CSKA Moscow,2010,2,12,3,5,32,18,14,39
Spart Moscow,2010,3,10,5,5,37,26,11,35
Krasnodar,2010,4,10,4,6,30,25,5,34
Zenit,2010,5,7,9,4,21,16,5,30
Terek Grozny,2010,6,7,6,7,21,24,-3,27
FK Rubin,2010,7,6,5,9,23,19,4,23
Amkar,2010,8,6,4,10,12,23,-11,22
Din Moscow,2010,9,5,6,9,17,23,-6,21
Rostov,2010,10,4,6,10,10,20,-10,18
Anzhi,2010,11,2,6,12,15,41,-26,12
Loko Moscow,2011,1,13,5,2,33,12,21,44
CSKA Moscow,2011,2,11,4,5,29,20,9,37
Spart Moscow,2011,3,9,7,4,36,26,10,34
Terek Grozny,2011,4,9,5,6,24,23,1,32
Krasnodar,2011,5,9,4,7,30,28,2,31
Zenit,2011,6,7,8,5,22,16,6,29
FK Rubin,2011,7,6,5,9,25,19,6,23
Din Moscow,2011,8,5,6,9,17,26,-9,21
Rostov,2011,9,4,7,9,10,17,-7,19
Amkar,2011,10,4,5,11,11,26,-15,17
Anzhi,2011,11,2,6,12,16,40,-24,12
Loko Moscow,2012,1,12,5,3,30,12,18,41
CSKA Moscow,2012,2,11,4,5,28,19,9,37
Krasnodar,2012,3,10,4,6,31,24,7,34
Spart Moscow,2012,4,9,6,5,38,30,8,33
Zenit,2012,5,7,9,4,23,16,7,30
Terek Grozny,2012,6,8,6,6,24,23,1,30
Din Moscow,2012,7,6,6,8,22,26,-4,24
FK Rubin,2012,8,6,5,9,24,21,3,23
Rostov,2012,9,4,6,10,10,19,-9,18
Amkar,2012,10,4,6,10,11,24,-13,18
Anzhi,2012,11,2,5,13,14,41,-27,11
Loko Moscow,2013,1,12,5,3,32,14,18,41
CSKA Moscow,2013,2,10,5,5,28,20,8,35
Krasnodar,2013,3,10,4,6,31,26,5,34
Spart Moscow,2013,4,9,5,6,40,29,11,32
Zenit,2013,5,7,9,4,23,16,7,30
Terek Grozny,2013,6,8,5,7,23,26,-3,29
Din Moscow,2013,7,6,7,7,20,23,-3,25
Amkar,2013,8,6,4,10,12,22,-10,22
FK Rubin,2013,9,5,6,9,22,19,3,21
Rostov,2013,10,4,6,10,10,22,-12,18
Anzhi,2013,11,2,6,12,18,42,-24,12
Loko Moscow,2014,1,11,5,4,29,13,16,38
CSKA Moscow,2014,2,11,4,5,27,18,9,37
Spart Moscow,2014,3,9,7,4,42,29,13,34
Zenit,2014,4,8,9,3,22,13,9,33
Krasnodar,2014,5,9,5,6,28,24,4,32
Terek Grozny,2014,6,7,5,8,20,26,-6,26
Din Moscow,2014,7,5,8,7,19,23,-4,23
FK Rubin,2014,8,5,7,8,21,17,4,22
Amkar,2014,9,5,5,10,12,24,-12,20
Rostov,2014,10,4,6,10,10,22,-12,18
Anzhi,2014,11,3,5,12,18,39,-21,14
Loko Moscow,2015,1,13,5,2,32,12,20,44
Spart Moscow,2015,2,10,5,5,43,31,12,35
CSKA Moscow,2015,3,10,4,6,28,21,7,34
Zenit,2015,4,8,8,4,26,18,8,32
Krasnodar,2015,5,8,5,7,28,26,2,29
Terek Grozny,2015,6,7,5,8,20,24,-4,26
Din Moscow,2015,7,6,6,8,20,25,-5,24
Amkar,2015,8,6,4,10,13,24,-11,22
FK Rubin,2015,9,5,6,9,22,19,3,21
Rostov,2015,10,4,6,10,11,21,-10,18
Anzhi,2015,11,3,6,11,15,37,-22,15
Loko Moscow,2016,1,12,5,3,31,13,18,41
CSKA Moscow,2016,2,11,4,5,29,18,11,37
Spart Moscow,2016,3,9,6,5,38,29,9,33
Krasnodar,2016,4,9,5,6,30,25,5,32
Zenit,2016,5,7,9,4,22,16,6,30
Terek Grozny,2016,6,7,5,8,22,26,-4,26
Din Moscow,2016,7,6,6,8,18,23,-5,24
Amkar,2016,8,6,4,10,13,24,-11,22
FK Rubin,2016,9,5,6,9,22,19,3,21
Rostov,2016,10,4,7,9,12,19,-7,19
Anzhi,2016,11,3,5,12,16,41,-25,14
Loko Moscow,2017,1,12,5,3,33,14,19,41
CSKA Moscow,2017,2,11,3,6,27,19,8,36
Zenit,2017,3,8,8,4,22,16,6,32
Krasnodar,2017,4,9,5,6,30,25,5,32
Spart Moscow,2017,5,8,7,5,34,28,6,31
Terek Grozny,2017,6,8,5,7,22,25,-3,29
Din Moscow,2017,7,6,7,7,19,22,-3,25
FK Rubin,2017,8,5,6,9,21,18,3,21
Rostov,2017,9,5,6,9,12,17,-5,21
Amkar,2017,10,4,5,11,9,24,-15,17
Anzhi,2017,11,3,5,12,18,39,-21,14
Loko Moscow,2018,1,11,6,3,29,12,17,39
CSKA Moscow,2018,2,11,3,6,27,18,9,36
Spart Moscow,2018,3,9,5,6,35,28,7,32
Krasnodar,2018,4,9,4,7,28,27,1,31
Zenit,2018,5,7,9,4,21,15,6,30
Terek Grozny,2018,6,7,5,8,21,25,-4,26
Din Moscow,2018,7,6,6,8,20,22,-2,24
FK Rubin,2018,8,6,5,9,24,20,4,23
Amkar,2018,9,6,4,10,12,23,-11,22
Rostov,2018,10,5,6,9,11,17,-6,21
Anzhi,2018,11,4,5,11,17,38,-21,17
Loko Moscow,2019,1,12,5,3,32,14,18,41
CSKA Moscow,2019,2,11,4,5,27,18,9,37
Spart Moscow,2019,3,10,5,5,38,27,11,35
Krasnodar,2019,4,10,4,6,32,25,7,34
Zenit,2019,5,7,9,4,21,15,6,30
Terek Grozny,2019,6,7,5,8,21,26,-5,26
FK Rubin,2019,7,6,5,9,23,19,4,23
Amkar,2019,8,6,4,10,12,23,-11,22
Din Moscow,2019,9,5,6,9,17,25,-8,21
Rostov,2019,10,4,6,10,10,19,-9,18
Anzhi,2019,11,3,5,12,18,40,-22,14
Loko Moscow,2020,1,11,7,2,34,16,18,40
Spart Moscow,2020,2,11,5,4,38,26,12,38
CSKA Moscow,2020,3,11,3,6,29,20,9,36
Zenit,2020,4,8,9,3,27,18,9,33
Terek Grozny,2020,5,9,5,6,23,23,0,32
Krasnodar,2020,6,8,5,7,30,28,2,29
Din Moscow,2020,7,6,6,8,21,22,-1,24
FK Rubin,2020,8,6,5,9,23,22,1,23
Rostov,2020,9,4,6,10,10,19,-9,18
Amkar,2020,10,4,4,12,11,26,-15,16
Anzhi,2020,11,2,5,13,14,40,-26,11
Loko Moscow,2021,1,11,5,4,31,15,16,38
CSKA Moscow,2021,2,11,4,5,29,19,10,37
Spart Moscow,2021,3,10,5,5,37,27,10,35
Zenit,2021,4,8,9,3,25,16,9,33
Krasnodar,2021,5,9,5,6,28,24,4,32
Terek Grozny,2021,6,8,5,7,24,24,0,29
Din Moscow,2021,7,6,6,8,19,23,-4,24
Amkar,2021,8,6,4,10,11,22,-11,22
FK Rubin,2021,9,5,6,9,21,18,3,21
Rostov,2021,10,4,6,10,10,19,-9,18
Anzhi,2021,11,2,5,13,16,44,-28,11
Loko Moscow,2022,1,12,6,2,33,12,21,42
CSKA Moscow,2022,2,11,3,6,30,19,11,36
Spart Moscow,2022,3,9,7,4,37,26,11,34
Zenit,2022,4,8,8,4,24,18,6,32
Krasnodar,2022,5,8,5,7,30,28,2,29
Terek Grozny,2022,6,7,6,7,20,23,-3,27
FK Rubin,2022,7,6,6,8,25,20,5,24
Din Moscow,2022,8,5,7,8,17,24,-7,22
Rostov,2022,9,4,7,9,11,18,-7,19
Amkar,2022,10,4,6,10,9,22,-13,18
Anzhi,2022,11,3,5,12,15,41,-26,14
Loko Moscow,2023,1,11,6,3,29,13,16,39
CSKA Moscow,2023,2,11,4,5,29,20,9,37
Spart Moscow,2023,3,9,5,6,36,30,6,32
Zenit,2023,4,7,10,3,22,14,8,31
Krasnodar,2023,5,9,4,7,31,28,3,31
Terek Grozny,2023,6,7,7,6,21,23,-2,28
FK Rubin,2023,7,7,5,8,27,19,8,26
Rostov,2023,8,5,6,9,12,18,-6,21
Din Moscow,2023,9,5,6,9,17,25,-8,21
Amkar,2023,10,5,5,10,12,22,-10,20
Anzhi,2023,11,2,6,12,17,41,-24,12
Loko Moscow,2024,1,12,6,2,30,11,19,42
CSKA Moscow,2024,2,12,3,5,30,18,12,39
Spart Moscow,2024,3,9,7,4,36,26,10,34
Terek Grozny,2024,4,9,5,6,25,23,2,32
Zenit,2024,5,7,9,4,21,14,7,30
Krasnodar,2024,6,8,4,8,29,28,1,28
Din Moscow,2024,7,6,6,8,19,23,-4,24
FK Rubin,2024,8,6,5,9,24,21,3,23
Rostov,2024,9,4,7,9,10,17,-7,19
Amkar,2024,10,4,5,11,11,25,-14,17
Anzhi,2024,11,2,5,13,15,44,-29,11
Loko Moscow,2025,1,12,6,2,33,14,19,42
CSKA Moscow,2025,2,11,3,6,29,21,8,36
Spart Moscow,2025,3,9,5,6,38,29,9,32
Zenit,2025,4,7,9,4,24,17,7,30
Krasnodar,2025,5,8,4,8,30,29,1,28
FK Rubin,2025,6,7,5,8,24,18,6,26
Terek Grozny,2025,7,7,5,8,20,24,-4,26
Din Moscow,2025,8,6,6,8,20,23,-3,24
Amkar,2025,9,6,4,10,11,22,-11,22
Rostov,2025,10,4,6,10,11,22,-11,18
Anzhi,2025,11,4,5,11,16,37,-21,17
Loko Moscow,2026,1,12,5,3,32,14,18,41
Spart Moscow,2026,2,10,6,4,39,28,11,36
CSKA Moscow,2026,3,10,3,7,25,21,4,33
Zenit,2026,4,8,8,4,23,15,8,32
Krasnodar,2026,5,9,5,6,29,25,4,32
Terek Grozny,2026,6,7,6,7,20,24,-4,27
FK Rubin,2026,7,5,7,8,21,17,4,22
Din Moscow,2026,8,5,7,8,19,24,-5,22
Rostov,2026,9,4,7,9,11,18,-7,19
Amkar,2026,10,4,5,11,9,24,-15,17
Anzhi,2026,11,4,5,11,19,37,-18,17
Loko Moscow,2027,1,12,5,3,31,13,18,41
CSKA Moscow,2027,2,12,3,5,28,17,11,39
Spart Moscow,2027,3,9,6,5,38,30,8,33
Zenit,2027,4,8,8,4,22,14,8,32
Terek Grozny,2027,5,8,6,6,22,23,-1,30
Krasnodar,2027,6,8,4,8,28,27,1,28
Din Moscow,2027,7,6,7,7,21,24,-3,25
FK Rubin,2027,8,6,5,9,23,19,4,23
Amkar,2027,9,5,5,10,11,23,-12,20
Rostov,2027,10,4,6,10,12,20,-8,18
Anzhi,2027,11,2,5,13,14,40,-26,11
Loko Moscow,2028,1,12,5,3,31,14,17,41
CSKA Moscow,2028,2,12,3,5,28,18,10,39
Spart Moscow,2028,3,10,5,5,40,29,11,35
Krasnodar,2028,4,9,4,7,30,28,2,31
Zenit,2028,5,7,8,5,22,16,6,29
Terek Grozny,2028,6,8,5,7,24,27,-3,29
Din Moscow,2028,7,7,6,7,21,23,-2,27
FK Rubin,2028,8,6,5,9,25,19,6,23
Amkar,2028,9,5,4,11,13,26,-13,19
Rostov,2028,10,4,6,10,12,21,-9,18
Anzhi,2028,11,2,5,13,15,40,-25,11
Loko Moscow,2029,1,11,7,2,30,12,18,40
CSKA Moscow,2029,2,10,5,5,27,19,8,35
Zenit,2029,3,7,10,3,23,15,8,31
Spart Moscow,2029,4,8,7,5,35,28,7,31
Krasnodar,2029,5,8,6,6,29,26,3,30
Terek Grozny,2029,6,7,7,6,21,23,-2,28
Din Moscow,2029,7,5,8,7,18,22,-4,23
FK Rubin,2029,8,5,7,8,23,19,4,22
Amkar,2029,9,5,5,10,11,23,-12,20
Rostov,2029,10,4,7,9,10,17,-7,19
Anzhi,2029,11,2,7,11,16,39,-23,13
Loko Moscow,2030,1,11,6,3,31,14,17,39
Spart Moscow,2030,2,10,5,5,40,27,13,35
CSKA Moscow,2030,3,10,4,6,27,20,7,34
Krasnodar,2030,4,9,5,6,29,25,4,32
Zenit,2030,5,7,10,3,23,15,8,31
Terek Grozny,2030,6,7,6,7,21,24,-3,27
FK Rubin,2030,7,5,7,8,22,18,4,22
Din Moscow,2030,8,5,7,8,18,26,-8,22
Amkar,2030,9,5,5,10,11,22,-11,20
Rostov,2030,10,4,6,10,10,20,-10,18
Anzhi,2030,11,4,5,11,18,39,-21,17
Loko Moscow,2031,1,12,6,2,33,12,21,42
Spart Moscow,2031,2,11,5,4,40,27,13,38
CSKA Moscow,2031,3,11,3,6,28,19,9,36
Zenit,2031,4,8,9,3,23,14,9,33
Terek Grozny,2031,5,9,5,6,24,22,2,32
Krasnodar,2031,6,8,4,8,30,31,-1,28
Din Moscow,2031,7,6,6,8,20,24,-4,24
FK Rubin,2031,8,6,5,9,25,22,3,23
Rostov,2031,9,4,6,10,11,19,-8,18
Amkar,2031,10,4,4,12,9,25,-16,16
Anzhi,2031,11,2,5,13,15,43,-28,11
Loko Moscow,2032,1,11,5,4,29,14,15,38
CSKA Moscow,2032,2,11,3,6,29,19,10,36
Spart Moscow,2032,3,10,5,5,41,26,15,35
Zenit,2032,4,9,8,3,23,13,10,35
Krasnodar,2032,5,9,5,6,30,25,5,32
Terek Grozny,2032,6,8,6,6,24,24,0,30
FK Rubin,2032,7,5,7,8,23,19,4,22
Din Moscow,2032,8,5,7,8,18,27,-9,22
Amkar,2032,9,5,5,10,11,23,-12,20
Rostov,2032,10,4,6,10,10,20,-10,18
Anzhi,2032,11,2,5,13,16,44,-28,11
Loko Moscow,2033,1,12,5,3,31,14,17,41
CSKA Moscow,2033,2,12,3,5,29,17,12,39
Spart Moscow,2033,3,10,6,4,37,27,10,36
Zenit,2033,4,8,8,4,24,16,8,32
Krasnodar,2033,5,8,4,8,29,29,0,28
FK Rubin,2033,6,7,5,8,25,19,6,26
Terek Grozny,2033,7,7,5,8,22,26,-4,26
Din Moscow,2033,8,5,6,9,18,24,-6,21
Amkar,2033,9,5,5,10,11,23,-12,20
Rostov,2033,10,4,6,10,11,19,-8,18
Anzhi,2033,11,3,5,12,16,39,-23,14
Loko Moscow,2034,1,12,6,2,31,12,19,42
Spart Moscow,2034,2,10,6,4,38,26,12,36
CSKA Moscow,2034,3,10,5,5,26,18,8,35
Zenit,2034,4,7,10,3,21,13,8,31
Krasnodar,2034,5,8,5,7,29,27,2,29
Terek Grozny,2034,6,7,7,6,21,23,-2,28
Din Moscow,2034,7,6,6,8,20,24,-4,24
FK Rubin,2034,8,5,6,9,23,21,2,21
Rostov,2034,9,4,6,10,11,20,-9,18
Amkar,2034,10,4,6,10,9,22,-13,18
Anzhi,2034,11,2,7,11,16,39,-23,13
Loko Moscow,2035,1,12,5,3,31,14,17,41
CSKA Moscow,2035,2,12,3,5,32,18,14,39
Spart Moscow,2035,3,9,5,6,36,29,7,32
Zenit,2035,4,8,8,4,23,16,7,32
Terek Grozny,2035,5,9,5,6,24,22,2,32
Krasnodar,2035,6,8,5,7,28,26,2,29
Din Moscow,2035,7,7,6,7,21,22,-1,27
FK Rubin,2035,8,5,6,9,21,19,2,21
Amkar,2035,9,5,4,11,10,24,-14,19
Rostov,2035,10,4,6,10,11,19,-8,18
Anzhi,2035,11,2,5,13,15,43,-28,11
Loko Moscow,2036,1,12,6,2,33,12,21,42
CSKA Moscow,2036,2,11,4,5,27,18,9,37
Spart Moscow,2036,3,9,6,5,36,28,8,33
Krasnodar,2036,4,9,5,6,31,25,6,32
Terek Grozny,2036,5,9,5,6,23,23,0,32
Zenit,2036,6,7,9,4,22,17,5,30
Din Moscow,2036,7,7,6,7,21,23,-2,27
FK Rubin,2036,8,5,5,10,21,21,0,20
Rostov,2036,9,4,7,9,10,17,-7,19
Amkar,2036,10,4,4,12,9,24,-15,16
Anzhi,2036,11,2,5,13,15,40,-25,11
Loko Moscow,2037,1,11,6,3,30,13,17,39
CSKA Moscow,2037,2,11,4,5,28,19,9,37
Spart Moscow,2037,3,10,5,5,37,28,9,35
Krasnodar,2037,4,9,5,6,28,24,4,32
Zenit,2037,5,7,9,4,23,16,7,30
Din Moscow,2037,6,7,6,7,20,21,-1,27
Terek Grozny,2037,7,7,6,7,21,24,-3,27
FK Rubin,2037,8,5,6,9,21,18,3,21
Rostov,2037,9,4,6,10,10,18,-8,18
Amkar,2037,10,4,5,11,10,25,-15,17
Anzhi,2037,11,3,6,11,17,39,-22,15
Loko Moscow,2038,1,12,5,3,33,15,18,41
Spart Moscow,2038,2,11,5,4,39,27,12,38
CSKA Moscow,2038,3,11,3,6,28,20,8,36
Zenit,2038,4,8,8,4,25,16,9,32
Krasnodar,2038,5,9,4,7,31,30,1,31
Terek Grozny,2038,6,7,6,7,23,27,-4,27
FK Rubin,2038,7,6,6,8,28,21,7,24
Din Moscow,2038,8,5,7,8,21,27,-6,22
Rostov,2038,9,4,6,10,10,18,-8,18
Amkar,2038,10,4,5,11,11,25,-14,17
Anzhi,2038,11,3,5,12,18,41,-23,14
Loko Moscow,2039,1,11,6,3,31,14,17,39
CSKA Moscow,2039,2,11,4,5,29,18,11,37
Spart Moscow,2039,3,10,5,5,38,29,9,35
Zenit,2039,4,8,9,3,24,15,9,33
Krasnodar,2039,5,8,6,6,28,25,3,30
Terek Grozny,2039,6,8,6,6,23,24,-1,30
Din Moscow,2039,7,6,7,7,19,21,-2,25
FK Rubin,2039,8,5,7,8,21,17,4,22
Rostov,2039,9,4,6,10,11,19,-8,18
Amkar,2039,10,4,4,12,10,26,-16,16
Anzhi,2039,11,2,6,12,16,42,-26,12
Loko Moscow,2040,1,12,5,3,30,13,17,41
CSKA Moscow,2040,2,11,3,6,27,20,7,36
Spart Moscow,2040,3,10,5,5,38,28,10,35
Krasnodar,2040,4,10,4,6,30,24,6,34
Zenit,2040,5,8,8,4,24,14,10,32
Terek Grozny,2040,6,8,6,6,23,24,-1,30
Din Moscow,2040,7,5,7,8,17,22,-5,22
FK Rubin,2040,8,5,6,9,21,18,3,21
Amkar,2040,9,5,5,10,13,25,-12,20
Rostov,2040,10,4,6,10,10,19,-9,18
Anzhi,2040,11,2,5,13,15,41,-26,11
Loko Moscow,2041,1,11,5,4,30,14,16,38
Spart Moscow,2041,2,10,6,4,42,27,15,36
CSKA Moscow,2041,3,11,3,6,30,20,10,36
Zenit,2041,4,9,8,3,25,14,11,35
Krasnodar,2041,5,10,4,6,29,24,5,34
Terek Grozny,2041,6,7,5,8,21,28,-7,26
Din Moscow,2041,7,6,6,8,21,24,-3,24
FK Rubin,2041,8,5,5,10,21,21,0,20
Amkar,2041,9,5,5,10,13,23,-10,20
Rostov,2041,10,4,6,10,10,22,-12,18
Anzhi,2041,11,3,5,12,18,43,-25,14
Loko Moscow,2042,1,11,6,3,30,13,17,39
Spart Moscow,2042,2,10,5,5,37,28,9,35
Krasnodar,2042,3,10,4,6,30,24,6,34
CSKA Moscow,2042,4,10,4,6,26,20,6,34
Zenit,2042,5,7,10,3,23,15,8,31
Terek Grozny,2042,6,7,7,6,21,23,-2,28
Din Moscow,2042,7,6,6,8,19,23,-4,24
FK Rubin,2042,8,6,5,9,23,19,4,23
Rostov,2042,9,4,6,10,10,19,-9,18
Amkar,2042,10,4,5,11,10,24,-14,17
Anzhi,2042,11,3,6,11,17,38,-21,15
Loko Moscow,2043,1,11,5,4,31,15,16,38
Zenit,2043,2,9,8,3,25,14,11,35
Krasnodar,2043,3,10,4,6,31,25,6,34
CSKA Moscow,2043,4,10,4,6,27,21,6,34
Spart Moscow,2043,5,9,5,6,39,30,9,32
Terek Grozny,2043,6,7,6,7,20,23,-3,27
Din Moscow,2043,7,6,7,7,20,23,-3,25
FK Rubin,2043,8,5,6,9,21,19,2,21
Rostov,2043,9,5,6,9,11,17,-6,21
Amkar,2043,10,4,5,11,10,26,-16,17
Anzhi,2043,11,3,6,11,17,39,-22,15
Loko Moscow,2044,1,12,6,2,31,11,20,42
CSKA Moscow,2044,2,11,4,5,29,18,11,37
Spart Moscow,2044,3,10,5,5,36,26,10,35
Zenit,2044,4,7,10,3,22,14,8,31
Krasnodar,2044,5,8,4,8,28,29,-1,28
Terek Grozny,2044,6,7,6,7,21,24,-3,27
FK Rubin,2044,7,6,6,8,26,20,6,24
Din Moscow,2044,8,5,7,8,19,25,-6,22
Amkar,2044,9,5,5,10,11,23,-12,20
Rostov,2044,10,4,6,10,10,18,-8,18
Anzhi,2044,11,3,5,12,15,40,-25,14
Loko Moscow,2045,1,11,6,3,31,14,17,39
Spart Moscow,2045,2,11,5,4,38,25,13,38
Zenit,2045,3,9,8,3,26,15,11,35
CSKA Moscow,2045,4,10,4,6,29,23,6,34
Krasnodar,2045,5,9,5,6,32,26,6,32
Terek Grozny,2045,6,9,5,6,23,22,1,32
Din Moscow,2045,7,6,6,8,20,24,-4,24
FK Rubin,2045,8,5,5,10,21,23,-2,20
Rostov,2045,9,4,6,10,10,18,-8,18
Amkar,2045,10,4,4,12,9,25,-16,16
Anzhi,2045,11,2,6,12,16,40,-24,12
Loko Moscow,2046,1,12,5,3,31,14,17,41
CSKA Moscow,2046,2,10,4,6,26,21,5,34
Zenit,2046,3,8,8,4,25,15,10,32
Terek Grozny,2046,4,9,5,6,23,23,0,32
Krasnodar,2046,5,9,4,7,31,27,4,31
Spart Moscow,2046,6,8,6,6,36,31,5,30
Din Moscow,2046,7,6,7,7,20,23,-3,25
FK Rubin,2046,8,6,5,9,24,20,4,23
Rostov,2046,9,5,6,9,11,17,-6,21
Amkar,2046,10,5,4,11,12,24,-12,19
Anzhi,2046,11,2,6,12,16,40,-24,12
Loko Moscow,2047,1,13,5,2,34,13,21,44
CSKA Moscow,2047,2,11,4,5,28,19,9,37
Spart Moscow,2047,3,9,6,5,37,31,6,33
Krasnodar,2047,4,9,4,7,31,26,5,31
Zenit,2047,5,7,9,4,23,17,6,30
Terek Grozny,2047,6,7,5,8,23,29,-6,26
FK Rubin,2047,7,6,5,9,22,20,2,23
Din Moscow,2047,8,5,7,8,18,23,-5,22
Amkar,2047,9,6,4,10,15,23,-8,22
Rostov,2047,10,4,6,10,12,20,-8,18
Anzhi,2047,11,3,5,12,19,41,-22,14
Loko Moscow,2048,1,11,6,3,31,14,17,39
CSKA Moscow,2048,2,11,4,5,29,18,11,37
Spart Moscow,2048,3,8,7,5,35,28,7,31
Krasnodar,2048,4,9,4,7,29,26,3,31
Zenit,2048,5,7,9,4,22,17,5,30
Terek Grozny,2048,6,8,5,7,22,27,-5,29
FK Rubin,2048,7,7,5,8,26,20,6,26
Din Moscow,2048,8,6,6,8,21,25,-4,24
Rostov,2048,9,4,7,9,12,19,-7,19
Amkar,2048,10,4,5,11,9,23,-14,17
Anzhi,2048,11,3,6,11,20,39,-19,15
Loko Moscow,2049,1,11,6,3,33,16,17,39
CSKA Moscow,2049,2,11,4,5,26,17,9,37
Spart Moscow,2049,3,10,5,5,38,26,12,35
Krasnodar,2049,4,9,5,6,33,29,4,32
Zenit,2049,5,7,10,3,23,15,8,31
Terek Grozny,2049,6,7,7,6,24,26,-2,28
FK Rubin,2049,7,5,7,8,25,21,4,22
Din Moscow,2049,8,5,7,8,18,25,-7,22
Amkar,2049,9,5,5,10,11,23,-12,20
Rostov,2049,10,4,6,10,10,19,-9,18
Anzhi,2049,11,2,6,12,17,41,-24,12
Loko Moscow,2050,1,13,5,2,31,11,20,44
CSKA Moscow,2050,2,12,3,5,28,18,10,39
Spart Moscow,2050,3,10,5,5,43,30,13,35
Krasnodar,2050,4,9,4,7,28,25,3,31
Zenit,2050,5,7,8,5,21,15,6,29
Terek Grozny,2050,6,7,6,7,23,26,-3,27
Din Moscow,2050,7,6,6,8,20,24,-4,24
Rostov,2050,8,5,6,9,13,18,-5,21
FK Rubin,2050,9,5,5,10,22,20,2,20
Amkar,2050,10,4,5,11,11,30,-19,17
Anzhi,2050,11,3,5,12,18,41,-23,14
Loko Moscow,2051,1,12,6,2,33,12,21,42
CSKA Moscow,2051,2,11,4,5,29,20,9,37
Spart Moscow,2051,3,10,6,4,40,28,12,36
Krasnodar,2051,4,9,5,6,30,26,4,32
Terek Grozny,2051,5,8,6,6,23,24,-1,30
Zenit,2051,6,7,8,5,21,17,4,29
Din Moscow,2051,7,6,6,8,20,24,-4,24
FK Rubin,2051,8,5,5,10,23,21,2,20
Rostov,2051,9,4,7,9,11,18,-7,19
Amkar,2051,10,4,4,12,10,27,-17,16
Anzhi,2051,11,2,7,11,19,42,-23,13
Loko Moscow,2052,1,13,5,2,32,11,21,44
CSKA Moscow,2052,2,10,5,5,29,21,8,35
Spart Moscow,2052,3,10,5,5,36,29,7,35
Zenit,2052,4,7,9,4,22,16,6,30
Krasnodar,2052,5,8,4,8,28,27,1,28
Terek Grozny,2052,6,7,6,7,23,26,-3,27
Din Moscow,2052,7,6,6,8,19,23,-4,24
FK Rubin,2052,8,6,5,9,24,20,4,23
Amkar,2052,9,6,4,10,15,24,-9,22
Rostov,2052,10,4,6,10,11,19,-8,18
Anzhi,2052,11,2,7,11,18,41,-23,13
Loko Moscow,2053,1,12,5,3,32,13,19,41
Spart Moscow,2053,2,11,5,4,44,29,15,38
CSKA Moscow,2053,3,10,5,5,27,19,8,35
Krasnodar,2053,4,10,4,6,33,26,7,34
Zenit,2053,5,7,9,4,22,16,6,30
Terek Grozny,2053,6,8,5,7,24,24,0,29
FK Rubin,2053,7,6,5,9,26,23,3,23
Din Moscow,2053,8,5,6,9,22,29,-7,21
Rostov,2053,9,4,6,10,10,19,-9,18
Amkar,2053,10,4,4,12,10,30,-20,16
Anzhi,2053,11,3,6,11,17,39,-22,15
Loko Moscow,2054,1,12,6,2,33,13,20,42
Spart Moscow,2054,2,10,6,4,38,27,11,36
CSKA Moscow,2054,3,11,3,6,28,19,9,36
Zenit,2054,4,8,9,3,24,14,10,33
Terek Grozny,2054,5,8,6,6,22,23,-1,30
Krasnodar,2054,6,8,4,8,28,30,-2,28
FK Rubin,2054,7,7,5,8,26,17,9,26
Din Moscow,2054,8,5,7,8,18,24,-6,22
Rostov,2054,9,4,6,10,10,19,-9,18
Amkar,2054,10,4,5,11,10,24,-14,17
Anzhi,2054,11,2,5,13,15,42,-27,11
Loko Moscow,2055,1,12,5,3,30,13,17,41
CSKA Moscow,2055,2,11,4,5,28,19,9,37
Spart Moscow,2055,3,10,6,4,39,28,11,36
Terek Grozny,2055,4,9,5,6,23,22,1,32
Krasnodar,2055,5,9,4,7,29,25,4,31
Zenit,2055,6,7,9,4,23,16,7,30
Din Moscow,2055,7,6,6,8,23,23,0,24
FK Rubin,2055,8,6,5,9,22,22,0,23
Rostov,2055,9,4,6,10,10,19,-9,18
Amkar,2055,10,4,5,11,11,26,-15,17
Anzhi,2055,11,2,5,13,14,39,-25,11
Loko Moscow,2056,1,11,6,3,33,16,17,39
CSKA Moscow,2056,2,11,3,6,29,19,10,36
Zenit,2056,3,9,8,3,24,14,10,35
Spart Moscow,2056,4,9,6,5,36,29,7,33
Krasnodar,2056,5,9,5,6,34,27,7,32
Terek Grozny,2056,6,8,6,6,23,23,0,30
Din Moscow,2056,7,5,8,7,17,21,-4,23
FK Rubin,2056,8,5,6,9,21,21,0,21
Rostov,2056,9,5,6,9,13,17,-4,21
Amkar,2056,10,4,4,12,11,28,-17,16
Anzhi,2056,11,2,6,12,15,41,-26,12
Loko Moscow,2057,1,12,6,2,35,15,20,42
CSKA Moscow,2057,2,11,3,6,27,19,8,36
Krasnodar,2057,3,9,5,6,31,26,5,32
Spart Moscow,2057,4,8,6,6,35,29,6,30
Zenit,2057,5,7,8,5,24,19,5,29
Terek Grozny,2057,6,7,5,8,22,26,-4,26
FK Rubin,2057,7,6,5,9,22,19,3,23
Din Moscow,2057,8,5,7,8,18,23,-5,22
Amkar,2057,9,6,4,10,13,24,-11,22
Rostov,2057,10,5,6,9,11,17,-6,21
Anzhi,2057,11,4,5,11,17,38,-21,17
Loko Moscow,2058,1,11,6,3,31,14,17,39
CSKA Moscow,2058,2,11,4,5,26,17,9,37
Spart Moscow,2058,3,9,7,4,39,28,11,34
Krasnodar,2058,4,9,5,6,29,25,4,32
Zenit,2058,5,7,10,3,22,14,8,31
Terek Grozny,2058,6,8,5,7,22,26,-4,29
Din Moscow,2058,7,6,7,7,19,21,-2,25
FK Rubin,2058,8,5,6,9,21,19,2,21
Rostov,2058,9,4,7,9,12,19,-7,19
Amkar,2058,10,4,4,12,10,28,-18,16
Anzhi,2058,11,3,5,12,18,38,-20,14
Loko Moscow,2059,1,12,5,3,31,13,18,41
Spart Moscow,2059,2,10,5,5,40,28,12,35
CSKA Moscow,2059,3,10,4,6,26,20,6,34
Krasnodar,2059,4,9,5,6,30,26,4,32
Zenit,2059,5,7,9,4,21,14,7,30
Terek Grozny,2059,6,7,5,8,20,27,-7,26
Din Moscow,2059,7,6,7,7,18,21,-3,25
FK Rubin,2059,8,5,7,8,22,18,4,22
Amkar,2059,9,5,4,11,13,24,-11,19
Rostov,2059,10,4,6,10,11,22,-11,18
Anzhi,2059,11,4,5,11,19,38,-19,17
Loko Moscow,2060,1,13,5,2,33,13,20,44
CSKA Moscow,2060,2,10,4,6,27,21,6,34
Zenit,2060,3,8,8,4,24,15,9,32
Spart Moscow,2060,4,9,5,6,36,28,8,32
Terek Grozny,2060,5,8,6,6,23,23,0,30
Krasnodar,2060,6,8,5,7,29,27,2,29
Din Moscow,2060,7,7,6,7,19,21,-2,27
FK Rubin,2060,8,5,6,9,22,19,3,21
Amkar,2060,9,5,4,11,11,24,-13,19
Rostov,2060,10,4,6,10,10,20,-10,18
Anzhi,2060,11,2,7,11,17,40,-23,13
Loko Moscow,2061,1,12,6,2,31,12,19,42
CSKA Moscow,2061,2,12,3,5,28,18,10,39
Spart Moscow,2061,3,9,6,5,37,29,8,33
Zenit,2061,4,7,9,4,22,15,7,30
Terek Grozny,2061,5,8,5,7,24,24,0,29
Krasnodar,2061,6,8,4,8,27,26,1,28
FK Rubin,2061,7,7,5,8,24,18,6,26
Din Moscow,2061,8,5,7,8,19,24,-5,22
Rostov,2061,9,5,6,9,11,17,-6,21
Amkar,2061,10,5,4,11,12,25,-13,19
Anzhi,2061,11,2,5,13,16,43,-27,11
Loko Moscow,2062,1,12,5,3,33,13,20,41
CSKA Moscow,2062,2,11,3,6,29,19,10,36
Spart Moscow,2062,3,10,5,5,44,31,13,35
Krasnodar,2062,4,10,4,6,31,25,6,34
Zenit,2062,5,8,8,4,23,16,7,32
Terek Grozny,2062,6,8,6,6,24,23,1,30
FK Rubin,2062,7,6,5,9,22,19,3,23
Din Moscow,2062,8,5,6,9,19,28,-9,21
Amkar,2062,9,5,5,10,12,24,-12,20
Rostov,2062,10,4,6,10,12,21,-9,18
Anzhi,2062,11,2,5,13,14,44,-30,11
Loko Moscow,2063,1,13,5,2,31,11,20,44
Spart Moscow,2063,2,10,6,4,37,25,12,36
CSKA Moscow,2063,3,10,4,6,27,20,7,34
Zenit,2063,4,8,8,4,22,14,8,32
Krasnodar,2063,5,9,4,7,29,26,3,31
Terek Grozny,2063,6,8,5,7,21,23,-2,29
Din Moscow,2063,7,6,6,8,20,24,-4,24
FK Rubin,2063,8,5,5,10,24,22,2,20
Amkar,2063,9,5,5,10,10,22,-12,20
Rostov,2063,10,4,6,10,10,20,-10,18
Anzhi,2063,11,2,6,12,16,40,-24,12
Loko Moscow,2064,1,12,6,2,34,15,19,42
CSKA Moscow,2064,2,11,3,6,27,19,8,36
Spart Moscow,2064,3,10,5,5,37,27,10,35
Zenit,2064,4,8,8,4,25,17,8,32
Krasnodar,2064,5,9,5,6,30,26,4,32
Terek Grozny,2064,6,8,6,6,22,23,-1,30
Din Moscow,2064,7,7,6,7,20,21,-1,27
FK Rubin,2064,8,5,5,10,21,19,2,20
Rostov,2064,9,4,6,10,10,20,-10,18
Amkar,2064,10,4,4,12,10,25,-15,16
Anzhi,2064,11,2,6,12,14,38,-24,12
Loko Moscow,2065,1,12,6,2,33,13,20,42
Spart Moscow,2065,2,11,5,4,38,25,13,38
CSKA Moscow,2065,3,11,4,5,28,19,9,37
Zenit,2065,4,7,9,4,22,16,6,30
Krasnodar,2065,5,8,5,7,29,28,1,29
Terek Grozny,2065,6,7,7,6,23,25,-2,28
FK Rubin,2065,7,6,6,8,24,18,6,24
Din Moscow,2065,8,5,7,8,17,23,-6,22
Rostov,2065,9,4,6,10,10,19,-9,18
Amkar,2065,10,4,5,11,11,25,-14,17
Anzhi,2065,11,2,6,12,17,41,-24,12
Loko Moscow,2066,1,12,6,2,35,13,22,42
CSKA Moscow,2066,2,11,3,6,31,19,12,36
Spart Moscow,2066,3,10,6,4,37,27,10,36
Zenit,2066,4,8,9,3,25,16,9,33
Krasnodar,2066,5,9,4,7,31,31,0,31
Terek Grozny,2066,6,8,5,7,23,25,-2,29
FK Rubin,2066,7,6,5,9,27,22,5,23
Din Moscow,2066,8,5,6,9,18,25,-7,21
Rostov,2066,9,4,7,9,10,17,-7,19
Amkar,2066,10,4,4,12,12,27,-15,16
Anzhi,2066,11,3,5,12,16,43,-27,14
Loko Moscow,2067,1,12,5,3,30,13,17,41
CSKA Moscow,2067,2,11,3,6,28,18,10,36
Spart Moscow,2067,3,9,6,5,38,30,8,33
Zenit,2067,4,8,8,4,22,14,8,32
Krasnodar,2067,5,9,5,6,30,25,5,32
Terek Grozny,2067,6,8,5,7,21,24,-3,29
FK Rubin,2067,7,6,6,8,23,18,5,24
Din Moscow,2067,8,5,7,8,19,24,-5,22
Amkar,2067,9,5,4,11,12,24,-12,19
Rostov,2067,10,4,6,10,10,19,-9,18
Anzhi,2067,11,3,5,12,16,40,-24,14
Loko Moscow,2068,1,12,5,3,33,13,20,41
CSKA Moscow,2068,2,11,4,5,28,18,10,37
Spart Moscow,2068,3,9,5,6,36,29,7,32
Krasnodar,2068,4,9,5,6,28,24,4,32
Zenit,2068,5,7,8,5,22,19,3,29
Din Moscow,2068,6,7,6,7,19,21,-2,27
Terek Grozny,2068,7,7,6,7,25,28,-3,27
FK Rubin,2068,8,5,6,9,21,18,3,21
Rostov,2068,9,5,6,9,12,18,-6,21
Amkar,2068,10,5,4,11,15,28,-13,19
Anzhi,2068,11,2,7,11,16,39,-23,13
Loko Moscow,2069,1,12,6,2,32,12,20,42
CSKA Moscow,2069,2,11,3,6,30,20,10,36
Spart Moscow,2069,3,9,6,5,35,27,8,33
Zenit,2069,4,8,8,4,22,15,7,32
Krasnodar,2069,5,8,5,7,28,26,2,29
Terek Grozny,2069,6,8,5,7,22,25,-3,29
Din Moscow,2069,7,6,7,7,18,21,-3,25
FK Rubin,2069,8,6,5,9,22,18,4,23
Amkar,2069,9,6,4,10,13,23,-10,22
Rostov,2069,10,4,6,10,11,19,-8,18
Anzhi,2069,11,2,5,13,16,43,-27,11
Loko Moscow,2070,1,12,5,3,31,13,18,41
Spart Moscow,2070,2,9,7,4,37,27,10,34
CSKA Moscow,2070,3,10,4,6,25,18,7,34
Krasnodar,2070,4,10,4,6,29,24,5,34
Zenit,2070,5,8,8,4,23,15,8,32
Terek Grozny,2070,6,8,5,7,21,23,-2,29
Din Moscow,2070,7,6,7,7,19,22,-3,25
FK Rubin,2070,8,5,5,10,21,19,2,20
Rostov,2070,9,4,7,9,10,17,-7,19
Amkar,2070,10,4,4,12,10,26,-16,16
Anzhi,2070,11,3,6,11,15,37,-22,15
Loko Moscow,2071,1,12,6,2,31,12,19,42
CSKA Moscow,2071,2,12,3,5,28,17,11,39
Spart Moscow,2071,3,9,6,5,36,28,8,33
Krasnodar,2071,4,9,5,6,30,25,5,32
Terek Grozny,2071,5,8,6,6,23,23,0,30
Zenit,2071,6,7,8,5,21,16,5,29
Din Moscow,2071,7,6,6,8,18,23,-5,24
FK Rubin,2071,8,6,5,9,23,19,4,23
Rostov,2071,9,4,6,10,11,19,-8,18
Amkar,2071,10,4,5,11,10,25,-15,17
Anzhi,2071,11,2,6,12,15,39,-24,12
Loko Moscow,2072,1,12,6,2,32,12,20,42
CSKA Moscow,2072,2,12,3,5,28,18,10,39
Spart Moscow,2072,3,11,5,4,37,26,11,38
Krasnodar,2072,4,8,6,6,28,25,3,30
Zenit,2072,5,7,8,5,21,16,5,29
Terek Grozny,2072,6,7,7,6,21,23,-2,28
FK Rubin,2072,7,6,6,8,24,18,6,24
Din Moscow,2072,8,5,6,9,18,25,-7,21
Rostov,2072,9,4,6,10,11,19,-8,18
Amkar,2072,10,4,5,11,10,24,-14,17
Anzhi,2072,11,2,6,12,15,39,-24,12
Loko Moscow,2073,1,11,6,3,31,14,17,39
Zenit,2073,2,9,8,3,24,13,11,35
CSKA Moscow,2073,3,10,4,6,26,20,6,34
Krasnodar,2073,4,9,5,6,31,26,5,32
Spart Moscow,2073,5,8,7,5,36,29,7,31
Terek Grozny,2073,6,7,6,7,22,26,-4,27
FK Rubin,2073,7,6,5,9,22,19,3,23
Din Moscow,2073,8,5,7,8,18,23,-5,22
Amkar,2073,9,6,4,10,14,24,-10,22
Rostov,2073,10,4,7,9,11,18,-7,19
Anzhi,2073,11,2,7,11,16,39,-23,13
Loko Moscow,2074,1,13,5,2,33,13,20,44
CSKA Moscow,2074,2,11,4,5,27,18,9,37
Spart Moscow,2074,3,10,5,5,37,29,8,35
Krasnodar,2074,4,9,4,7,30,26,4,31
Zenit,2074,5,7,9,4,24,17,7,30
Terek Grozny,2074,6,8,6,6,24,23,1,30
Din Moscow,2074,7,7,6,7,23,21,2,27
FK Rubin,2074,8,5,5,10,22,24,-2,20
Rostov,2074,9,4,6,10,11,19,-8,18
Amkar,2074,10,4,5,11,10,24,-14,17
Anzhi,2074,11,2,5,13,15,42,-27,11
Loko Moscow,2075,1,12,6,2,32,12,20,42
Spart Moscow,2075,2,9,7,4,37,28,9,34
CSKA Moscow,2075,3,10,4,6,26,21,5,34
Zenit,2075,4,8,9,3,24,13,11,33
Krasnodar,2075,5,9,4,7,30,28,2,31
Terek Grozny,2075,6,8,6,6,23,22,1,30
Din Moscow,2075,7,6,6,8,22,25,-3,24
FK Rubin,2075,8,5,5,10,24,23,1,20
Rostov,2075,9,4,7,9,11,18,-7,19
Amkar,2075,10,4,6,10,10,23,-13,18
Anzhi,2075,11,2,6,12,15,41,-26,12
Loko Moscow,2076,1,11,5,4,30,15,15,38
Spart Moscow,2076,2,10,6,4,38,28,10,36
CSKA Moscow,2076,3,11,3,6,31,23,8,36
Zenit,2076,4,9,8,3,26,14,12,35
Krasnodar,2076,5,10,4,6,32,26,6,34
Terek Grozny,2076,6,8,6,6,22,22,0,30
FK Rubin,2076,7,6,5,9,25,20,5,23
Din Moscow,2076,8,5,6,9,19,26,-7,21
Rostov,2076,9,4,7,9,11,18,-7,19
Amkar,2076,10,4,5,11,10,24,-14,17
Anzhi,2076,11,2,5,13,16,44,-28,11
Loko Moscow,2077,1,13,5,2,33,11,22,44
CSKA Moscow,2077,2,10,4,6,26,20,6,34
Zenit,2077,3,8,8,4,24,15,9,32
Spart Moscow,2077,4,9,5,6,34,29,5,32
Krasnodar,2077,5,8,4,8,28,29,-1,28
Terek Grozny,2077,6,7,7,6,20,22,-2,28
Din Moscow,2077,7,7,6,7,20,22,-2,27
FK Rubin,2077,8,6,5,9,24,20,4,23
Amkar,2077,9,5,5,10,12,22,-10,20
Rostov,2077,10,4,6,10,10,18,-8,18
Anzhi,2077,11,2,7,11,14,37,-23,13
Loko Moscow,2078,1,12,6,2,32,11,21,42
CSKA Moscow,2078,2,12,3,5,27,17,10,39
Spart Moscow,2078,3,10,5,5,36,27,9,35
Zenit,2078,4,7,9,4,21,14,7,30
Krasnodar,2078,5,8,4,8,28,30,-2,28
Terek Grozny,2078,6,7,6,7,20,24,-4,27
FK Rubin,2078,7,7,5,8,25,18,7,26
Amkar,2078,8,6,4,10,12,22,-10,22
Din Moscow,2078,9,5,6,9,17,23,-6,21
Rostov,2078,10,4,6,10,11,19,-8,18
Anzhi,2078,11,2,6,12,14,38,-24,12
Loko Moscow,2079,1,12,6,2,34,11,23,42
CSKA Moscow,2079,2,11,4,5,27,18,9,37
Spart Moscow,2079,3,10,6,4,39,27,12,36
Terek Grozny,2079,4,9,5,6,23,22,1,32
Zenit,2079,5,7,10,3,22,14,8,31
Krasnodar,2079,6,8,4,8,27,30,-3,28
FK Rubin,2079,7,6,6,8,22,17,5,24
Din Moscow,2079,8,5,7,8,18,25,-7,22
Rostov,2079,9,4,6,10,10,18,-8,18
Amkar,2079,10,4,5,11,10,24,-14,17
Anzhi,2079,11,2,5,13,14,40,-26,11
Loko Moscow,2080,1,13,5,2,32,11,21,44
CSKA Moscow,2080,2,11,3,6,28,18,10,36
Spart Moscow,2080,3,9,7,4,37,28,9,34
Zenit,2080,4,8,8,4,22,15,7,32
Krasnodar,2080,5,8,4,8,28,27,1,28
Terek Grozny,2080,6,7,6,7,23,26,-3,27
FK Rubin,2080,7,7,5,8,24,18,6,26
Din Moscow,2080,8,5,7,8,18,23,-5,22
Amkar,2080,9,5,5,10,12,24,-12,20
Rostov,2080,10,4,6,10,11,19,-8,18
Anzhi,2080,11,2,6,12,16,42,-26,12
Loko Moscow,2081,1,12,5,3,30,14,16,41
CSKA Moscow,2081,2,11,3,6,28,19,9,36
Zenit,2081,3,9,8,3,25,13,12,35
Spart Moscow,2081,4,9,6,5,37,30,7,33
Krasnodar,2081,5,8,4,8,29,28,1,28
Terek Grozny,2081,6,7,7,6,21,23,-2,28
Din Moscow,2081,7,6,7,7,19,22,-3,25
FK Rubin,2081,8,6,5,9,24,20,4,23
Amkar,2081,9,5,5,10,12,23,-11,20
Rostov,2081,10,4,6,10,11,19,-8,18
Anzhi,2081,11,2,6,12,16,41,-25,12
Loko Moscow,2082,1,12,5,3,32,15,17,41
Spart Moscow,2082,2,11,5,4,40,27,13,38
CSKA Moscow,2082,3,11,3,6,27,19,8,36
Zenit,2082,4,8,8,4,23,15,8,32
Krasnodar,2082,5,9,5,6,31,26,5,32
Terek Grozny,2082,6,8,5,7,23,23,0,29
Din Moscow,2082,7,6,6,8,21,25,-4,24
FK Rubin,2082,8,5,6,9,23,22,1,21
Rostov,2082,9,4,6,10,11,19,-8,18
Amkar,2082,10,4,4,12,10,27,-17,16
Anzhi,2082,11,3,5,12,16,39,-23,14
Loko Moscow,2083,1,11,6,3,30,13,17,39
CSKA Moscow,2083,2,12,3,5,32,18,14,39
Spart Moscow,2083,3,10,5,5,36,28,8,35
Krasnodar,2083,4,9,4,7,29,26,3,31
Zenit,2083,5,7,9,4,22,15,7,30
Terek Grozny,2083,6,8,6,6,24,25,-1,30
FK Rubin,2083,7,6,6,8,23,18,5,24
Din Moscow,2083,8,5,7,8,17,22,-5,22
Amkar,2083,9,5,5,10,13,24,-11,20
Rostov,2083,10,4,6,10,11,19,-8,18
Anzhi,2083,11,2,5,13,16,45,-29,11
Loko Moscow,2084,1,11,6,3,30,14,16,39
Spart Moscow,2084,2,11,5,4,40,27,13,38
CSKA Moscow,2084,3,11,3,6,26,18,8,36
Zenit,2084,4,9,8,3,25,14,11,35
Krasnodar,2084,5,9,5,6,32,25,7,32
Terek Grozny,2084,6,9,5,6,24,24,0,32
Din Moscow,2084,7,5,7,8,18,23,-5,22
FK Rubin,2084,8,5,6,9,23,23,0,21
Rostov,2084,9,4,6,10,10,19,-9,18
Amkar,2084,10,4,4,12,12,28,-16,16
Anzhi,2084,11,2,5,13,15,40,-25,11
Loko Moscow,2085,1,11,7,2,31,13,18,40
Spart Moscow,2085,2,9,7,4,36,27,9,34
CSKA Moscow,2085,3,10,4,6,25,19,6,34
Zenit,2085,4,7,10,3,21,13,8,31
Krasnodar,2085,5,8,6,6,30,27,3,30
Terek Grozny,2085,6,7,6,7,21,24,-3,27
Din Moscow,2085,7,6,6,8,20,23,-3,24
FK Rubin,2085,8,5,6,9,23,21,2,21
Amkar,2085,9,5,5,10,11,23,-12,20
Rostov,2085,10,4,7,9,11,18,-7,19
Anzhi,2085,11,3,6,11,17,38,-21,15
Loko Moscow,2086,1,12,5,3,32,14,18,41
Spart Moscow,2086,2,11,5,4,41,26,15,38
CSKA Moscow,2086,3,11,4,5,29,17,12,37
Krasnodar,2086,4,10,4,6,30,25,5,34
Zenit,2086,5,7,9,4,22,15,7,30
Terek Grozny,2086,6,8,6,6,24,25,-1,30
FK Rubin,2086,7,6,5,9,22,18,4,23
Din Moscow,2086,8,5,6,9,17,25,-8,21
Rostov,2086,9,4,6,10,10,20,-10,18
Amkar,2086,10,4,4,12,11,26,-15,16
Anzhi,2086,11,2,6,12,16,43,-27,12
Loko Moscow,2087,1,12,5,3,30,12,18,41
CSKA Moscow,2087,2,11,3,6,26,18,8,36
Zenit,2087,3,8,8,4,22,14,8,32
Spart Moscow,2087,4,9,5,6,35,31,4,32
Krasnodar,2087,5,9,4,7,28,25,3,31
Terek Grozny,2087,6,7,6,7,21,24,-3,27
Din Moscow,2087,7,6,7,7,21,22,-1,25
FK Rubin,2087,8,6,6,8,23,18,5,24
Rostov,2087,9,5,6,9,13,17,-4,21
Amkar,2087,10,4,5,11,9,24,-15,17
Anzhi,2087,11,3,5,12,16,39,-23,14
Loko Moscow,2088,1,12,5,3,32,14,18,41
CSKA Moscow,2088,2,11,4,5,29,19,10,37
Spart Moscow,2088,3,10,5,5,36,26,10,35
Krasnodar,2088,4,10,4,6,30,25,5,34
Terek Grozny,2088,5,8,6,6,25,25,0,30
Zenit,2088,6,7,8,5,23,18,5,29
FK Rubin,2088,7,6,5,9,24,20,4,23
Rostov,2088,8,5,6,9,11,17,-6,21
Din Moscow,2088,9,5,6,9,19,26,-7,21
Amkar,2088,10,4,5,11,10,24,-14,17
Anzhi,2088,11,2,6,12,17,42,-25,12
Loko Moscow,2089,1,12,5,3,32,14,18,41
CSKA Moscow,2089,2,11,4,5,27,18,9,37
Spart Moscow,2089,3,10,5,5,38,27,11,35
Zenit,2089,4,8,9,3,24,15,9,33
Krasnodar,2089,5,9,4,7,32,27,5,31
Terek Grozny,2089,6,8,5,7,24,26,-2,29
Din Moscow,2089,7,6,7,7,19,21,-2,25
FK Rubin,2089,8,5,6,9,22,21,1,21
Amkar,2089,9,5,4,11,12,25,-13,19
Rostov,2089,10,4,6,10,10,19,-9,18
Anzhi,2089,11,2,5,13,15,42,-27,11
Loko Moscow,2090,1,12,5,3,31,13,18,41
CSKA Moscow,2090,2,11,4,5,26,17,9,37
Spart Moscow,2090,3,9,5,6,37,28,9,32
Krasnodar,2090,4,9,4,7,28,25,3,31
Zenit,2090,5,7,9,4,22,15,7,30
Terek Grozny,2090,6,8,6,6,22,23,-1,30
FK Rubin,2090,7,7,5,8,24,18,6,26
Din Moscow,2090,8,6,6,8,20,24,-4,24
Rostov,2090,9,5,6,9,11,17,-6,21
Amkar,2090,10,4,5,11,9,25,-16,17
Anzhi,2090,11,2,5,13,15,40,-25,11
Loko Moscow,2091,1,13,5,2,34,14,20,44
CSKA Moscow,2091,2,12,3,5,31,19,12,39
Spart Moscow,2091,3,9,5,6,40,29,11,32
Terek Grozny,2091,4,9,5,6,25,25,0,32
Krasnodar,2091,5,9,4,7,31,27,4,31
Zenit,2091,6,7,8,5,22,17,5,29
Din Moscow,2091,7,6,6,8,21,25,-4,24
FK Rubin,2091,8,6,5,9,23,20,3,23
Amkar,2091,9,5,4,11,12,25,-13,19
Rostov,2091,10,4,6,10,10,22,-12,18
Anzhi,2091,11,2,5,13,17,43,-26,11
Loko Moscow,2092,1,12,5,3,30,13,17,41
CSKA Moscow,2092,2,11,3,6,26,18,8,36
Zenit,2092,3,9,8,3,24,13,11,35
Spart Moscow,2092,4,10,5,5,36,27,9,35
Krasnodar,2092,5,9,4,7,31,26,5,31
Terek Grozny,2092,6,8,5,7,21,23,-2,29
Din Moscow,2092,7,5,7,8,18,23,-5,22
Amkar,2092,8,6,4,10,12,22,-10,22
FK Rubin,2092,9,5,6,9,23,22,1,21
Rostov,2092,10,4,6,10,10,19,-9,18
Anzhi,2092,11,2,5,13,14,39,-25,11
Loko Moscow,2093,1,12,5,3,31,15,16,41
CSKA Moscow,2093,2,11,4,5,30,19,11,37
Spart Moscow,2093,3,9,7,4,37,28,9,34
Zenit,2093,4,8,9,3,25,14,11,33
Krasnodar,2093,5,9,4,7,30,27,3,31
Terek Grozny,2093,6,7,6,7,21,26,-5,27
Din Moscow,2093,7,5,8,7,18,22,-4,23
FK Rubin,2093,8,5,6,9,22,19,3,21
Rostov,2093,9,4,7,9,11,18,-7,19
Amkar,2093,10,5,4,11,14,25,-11,19
Anzhi,2093,11,2,6,12,15,41,-26,12
Loko Moscow,2094,1,11,6,3,32,15,17,39
CSKA Moscow,2094,2,11,4,5,28,17,11,37
Spart Moscow,2094,3,9,5,6,38,32,6,32
Krasnodar,2094,4,9,5,6,31,27,4,32
Zenit,2094,5,7,10,3,22,14,8,31
Terek Grozny,2094,6,8,6,6,23,23,0,30
Din Moscow,2094,7,6,6,8,22,25,-3,24
FK Rubin,2094,8,5,6,9,23,22,1,21
Rostov,2094,9,5,6,9,11,17,-6,21
Amkar,2094,10,5,5,10,14,24,-10,20
Anzhi,2094,11,2,5,13,15,43,-28,11
Loko Moscow,2095,1,12,5,3,31,13,18,41
CSKA Moscow,2095,2,11,3,6,27,20,7,36
Zenit,2095,3,9,8,3,24,13,11,35
Spart Moscow,2095,4,9,6,5,37,30,7,33
Krasnodar,2095,5,9,4,7,33,26,7,31
Terek Grozny,2095,6,7,5,8,21,25,-4,26
Din Moscow,2095,7,6,6,8,20,23,-3,24
FK Rubin,2095,8,6,5,9,22,22,0,23
Rostov,2095,9,4,7,9,12,19,-7,19
Amkar,2095,10,5,4,11,10,23,-13,19
Anzhi,2095,11,3,5,12,17,40,-23,14
Loko Moscow,2096,1,11,6,3,29,12,17,39
CSKA Moscow,2096,2,12,3,5,29,19,10,39
Spart Moscow,2096,3,9,6,5,37,28,9,33
Zenit,2096,4,8,8,4,24,16,8,32
Krasnodar,2096,5,8,6,6,27,24,3,30
Terek Grozny,2096,6,8,6,6,22,23,-1,30
FK Rubin,2096,7,5,7,8,21,17,4,22
Din Moscow,2096,8,5,7,8,17,23,-6,22
Rostov,2096,9,5,6,9,13,19,-6,21
Amkar,2096,10,4,6,10,9,22,-13,18
Anzhi,2096,11,2,5,13,15,40,-25,11
Loko Moscow,2097,1,13,5,2,34,14,20,44
CSKA Moscow,2097,2,11,3,6,26,18,8,36
Spart Moscow,2097,3,9,6,5,38,28,10,33
Zenit,2097,4,8,8,4,24,16,8,32
Terek Grozny,2097,5,8,5,7,23,25,-2,29
Krasnodar,2097,6,8,4,8,29,28,1,28
FK Rubin,2097,7,7,5,8,26,18,8,26
Din Moscow,2097,8,6,6,8,19,25,-6,24
Rostov,2097,9,4,7,9,11,18,-7,19
Amkar,2097,10,5,4,11,12,27,-15,19
Anzhi,2097,11,2,5,13,14,39,-25,11
Loko Moscow,2098,1,11,5,4,30,14,16,38
Spart Moscow,2098,2,10,5,5,38,27,11,35
CSKA Moscow,2098,3,10,5,5,27,19,8,35
Zenit,2098,4,8,9,3,23,14,9,33
Krasnodar,2098,5,9,4,7,31,30,1,31
Terek Grozny,2098,6,8,5,7,22,24,-2,29
Din Moscow,2098,7,7,6,7,19,21,-2,27
FK Rubin,2098,8,6,5,9,26,20,6,23
Amkar,2098,9,5,4,11,11,26,-15,19
Rostov,2098,10,4,6,10,10,18,-8,18
Anzhi,2098,11,2,6,12,16,40,-24,12
Loko Moscow,2099,1,11,6,3,30,13,17,39
CSKA Moscow,2099,2,12,3,5,28,18,10,39
Spart Moscow,2099,3,9,7,4,37,28,9,34
Zenit,2099,4,8,8,4,22,14,8,32
Terek Grozny,2099,5,9,5,6,26,23,3,32
Krasnodar,2099,6,8,6,6,29,26,3,30
Din Moscow,2099,7,6,7,7,19,21,-2,25
FK Rubin,2099,8,5,6,9,22,20,2,21
Rostov,2099,9,4,7,9,12,19,-7,19
Amkar,2099,10,4,4,12,11,27,-16,16
Anzhi,2099,11,2,5,13,15,42,-27,11
Loko Moscow,2100,1,12,5,3,36,13,23,41
CSKA Moscow,2100,2,11,4,5,30,19,11,37
Spart Moscow,2100,3,10,5,5,37,28,9,35
Krasnodar,2100,4,9,4,7,30,28,2,31
Zenit,2100,5,7,9,4,22,20,2,30
Terek Grozny,2100,6,8,6,6,24,25,-1,30
FK Rubin,2100,7,6,6,8,24,18,6,24
Din Moscow,2100,8,5,7,8,18,24,-6,22
Amkar,2100,9,5,5,10,12,23,-11,20
Rostov,2100,10,4,6,10,10,18,-8,18
Anzhi,2100,11,2,5,13,17,44,-27,11
Loko Moscow,2101,1,11,6,3,30,15,15,39
CSKA Moscow,2101,2,12,3,5,29,18,11,39
Spart Moscow,2101,3,11,5,4,39,26,13,38
Zenit,2101,4,8,8,4,25,15,10,32
Krasnodar,2101,5,9,5,6,30,26,4,32
Terek Grozny,2101,6,8,6,6,24,25,-1,30
FK Rubin,2101,7,6,5,9,24,20,4,23
Din Moscow,2101,8,5,6,9,18,25,-7,21
Rostov,2101,9,4,6,10,10,19,-9,18
Amkar,2101,10,4,5,11,11,25,-14,17
Anzhi,2101,11,2,5,13,16,42,-26,11
Loko Moscow,2102,1,11,7,2,33,15,18,40
Spart Moscow,2102,2,9,7,4,35,26,9,34
Zenit,2102,3,8,9,3,26,15,11,33
CSKA Moscow,2102,4,10,3,7,27,23,4,33
Terek Grozny,2102,5,9,5,6,25,22,3,32
Krasnodar,2102,6,8,5,7,30,29,1,29
FK Rubin,2102,7,6,6,8,23,17,6,24
Din Moscow,2102,8,5,8,7,17,21,-4,23
Rostov,2102,9,4,7,9,11,18,-7,19
Amkar,2102,10,4,4,12,9,27,-18,16
Anzhi,2102,11,3,5,12,16,39,-23,14
Loko Moscow,2103,1,11,6,3,35,19,16,39
Spart Moscow,2103,2,10,6,4,40,28,12,36
CSKA Moscow,2103,3,11,3,6,28,18,10,36
Krasnodar,2103,4,10,4,6,35,27,8,34
Zenit,2103,5,8,9,3,25,16,9,33
Terek Grozny,2103,6,8,5,7,24,24,0,29
Din Moscow,2103,7,6,6,8,20,24,-4,24
FK Rubin,2103,8,5,5,10,21,21,0,20
Amkar,2103,9,5,5,10,12,24,-12,20
Rostov,2103,10,4,6,10,10,20,-10,18
Anzhi,2103,11,2,5,13,14,43,-29,11
Loko Moscow,2104,1,11,6,3,31,14,17,39
CSKA Moscow,2104,2,12,3,5,30,19,11,39
Spart Moscow,2104,3,10,6,4,41,27,14,36
Krasnodar,2104,4,10,4,6,32,24,8,34
Zenit,2104,5,7,9,4,25,19,6,30
Terek Grozny,2104,6,7,5,8,21,26,-5,26
FK Rubin,2104,7,6,5,9,22,21,1,23
Din Moscow,2104,8,5,6,9,18,27,-9,21
Amkar,2104,9,5,5,10,11,23,-12,20
Rostov,2104,10,4,6,10,11,20,-9,18
Anzhi,2104,11,3,5,12,16,38,-22,14
Loko Moscow,2105,1,11,5,4,29,13,16,38
CSKA Moscow,2105,2,11,4,5,29,20,9,37
Spart Moscow,2105,3,9,6,5,34,27,7,33
Zenit,2105,4,8,8,4,22,14,8,32
Krasnodar,2105,5,9,5,6,28,24,4,32
Terek Grozny,2105,6,9,5,6,26,23,3,32
FK Rubin,2105,7,6,6,8,24,18,6,24
Din Moscow,2105,8,5,6,9,18,25,-7,21
Rostov,2105,9,4,7,9,10,17,-7,19
Amkar,2105,10,5,4,11,11,24,-13,19
Anzhi,2105,11,2,6,12,18,44,-26,12
Loko Moscow,2106,1,11,6,3,30,13,17,39
CSKA Moscow,2106,2,11,3,6,32,21,11,36
Krasnodar,2106,3,10,4,6,31,26,5,34
Zenit,2106,4,8,9,3,25,14,11,33
Spart Moscow,2106,5,9,6,5,37,29,8,33
Terek Grozny,2106,6,8,6,6,22,23,-1,30
Din Moscow,2106,7,5,7,8,17,23,-6,22
FK Rubin,2106,8,5,6,9,23,20,3,21
Rostov,2106,9,5,6,9,13,18,-5,21
Amkar,2106,10,4,6,10,11,24,-13,18
Anzhi,2106,11,2,5,13,15,45,-30,11
Loko Moscow,2107,1,13,5,2,32,12,20,44
CSKA Moscow,2107,2,12,3,5,29,18,11,39
Spart Moscow,2107,3,8,8,4,35,27,8,32
Zenit,2107,4,7,8,5,21,15,6,29
Terek Grozny,2107,5,8,5,7,22,23,-1,29
Krasnodar,2107,6,8,4,8,28,27,1,28
Din Moscow,2107,7,6,7,7,19,21,-2,25
FK Rubin,2107,8,6,5,9,22,19,3,23
Rostov,2107,9,4,7,9,11,18,-7,19
Amkar,2107,10,4,5,11,10,25,-15,17
Anzhi,2107,11,3,5,12,16,40,-24,14
Loko Moscow,2108,1,13,5,2,31,11,20,44
CSKA Moscow,2108,2,11,3,6,28,20,8,36
Zenit,2108,3,8,8,4,23,15,8,32
Spart Moscow,2108,4,9,5,6,38,32,6,32
Krasnodar,2108,5,9,4,7,29,25,4,31
Terek Grozny,2108,6,7,7,6,21,23,-2,28
Din Moscow,2108,7,6,7,7,22,24,-2,25
FK Rubin,2108,8,5,6,9,22,20,2,21
Rostov,2108,9,5,6,9,12,18,-6,21
Amkar,2108,10,4,5,11,10,24,-14,17
Anzhi,2108,11,2,6,12,16,40,-24,12
Loko Moscow,2109,1,13,5,2,32,12,20,44
CSKA Moscow,2109,2,10,4,6,26,20,6,34
Zenit,2109,3,8,8,4,23,14,9,32
Spart Moscow,2109,4,9,5,6,34,28,6,32
Krasnodar,2109,5,8,5,7,29,27,2,29
Terek Grozny,2109,6,8,5,7,22,24,-2,29
Din Moscow,2109,7,6,7,7,19,22,-3,25
FK Rubin,2109,8,5,7,8,23,19,4,22
Amkar,2109,9,6,4,10,12,22,-10,22
Rostov,2109,10,4,6,10,10,18,-8,18
Anzhi,2109,11,2,6,12,16,40,-24,12
Loko Moscow,2110,1,11,6,3,30,14,16,39
CSKA Moscow,2110,2,11,3,6,28,19,9,36
Spart Moscow,2110,3,10,5,5,39,28,11,35
Krasnodar,2110,4,10,4,6,31,25,6,34
Zenit,2110,5,8,9,3,24,15,9,33
Terek Grozny,2110,6,8,6,6,23,24,-1,30
Din Moscow,2110,7,5,7,8,19,24,-5,22
FK Rubin,2110,8,5,6,9,23,20,3,21
Amkar,2110,9,5,4,11,10,23,-13,19
Rostov,2110,10,4,6,10,11,21,-10,18
Anzhi,2110,11,2,6,12,16,41,-25,12
Loko Moscow,2111,1,12,6,2,32,12,20,42
CSKA Moscow,2111,2,12,3,5,27,17,10,39
Spart Moscow,2111,3,10,6,4,38,27,11,36
Zenit,2111,4,7,9,4,22,15,7,30
Krasnodar,2111,5,8,5,7,28,27,1,29
Terek Grozny,2111,6,7,7,6,21,23,-2,28
Din Moscow,2111,7,5,8,7,17,21,-4,23
FK Rubin,2111,8,5,7,8,22,18,4,22
Rostov,2111,9,4,6,10,11,19,-8,18
Amkar,2111,10,4,5,11,10,25,-15,17
Anzhi,2111,11,2,6,12,15,39,-24,12
Loko Moscow,2112,1,12,5,3,32,15,17,41
CSKA Moscow,2112,2,12,3,5,30,19,11,39
Spart Moscow,2112,3,10,5,5,37,26,11,35
Krasnodar,2112,4,10,4,6,34,25,9,34
Terek Grozny,2112,5,8,6,6,22,22,0,30
Zenit,2112,6,7,8,5,23,19,4,29
Din Moscow,2112,7,5,7,8,18,24,-6,22
FK Rubin,2112,8,5,6,9,23,22,1,21
Amkar,2112,9,5,4,11,10,24,-14,19
Rostov,2112,10,4,6,10,10,19,-9,18
Anzhi,2112,11,2,6,12,15,39,-24,12
Loko Moscow,2113,1,12,6,2,32,13,19,42
Spart Moscow,2113,2,11,5,4,40,25,15,38
CSKA Moscow,2113,3,11,4,5,27,17,10,37
Zenit,2113,4,7,10,3,22,14,8,31
Terek Grozny,2113,5,8,6,6,24,24,0,30
Krasnodar,2113,6,8,4,8,28,28,0,28
FK Rubin,2113,7,6,6,8,23,17,6,24
Din Moscow,2113,8,5,7,8,17,22,-5,22
Rostov,2113,9,4,6,10,10,22,-12,18
Amkar,2113,10,4,5,11,10,24,-14,17
Anzhi,2113,11,2,5,13,15,42,-27,11
Loko Moscow,2114,1,11,7,2,30,12,18,40
CSKA Moscow,2114,2,10,5,5,28,20,8,35
Spart Moscow,2114,3,9,7,4,38,29,9,34
Zenit,2114,4,7,10,3,24,16,8,31
Krasnodar,2114,5,8,5,7,29,27,2,29
Terek Grozny,2114,6,8,5,7,23,24,-1,29
FK Rubin,2114,7,6,6,8,24,19,5,24
Din Moscow,2114,8,5,8,7,18,22,-4,23
Rostov,2114,9,4,7,9,11,18,-7,19
Amkar,2114,10,5,4,11,13,25,-12,19
Anzhi,2114,11,2,6,12,15,41,-26,12
Loko Moscow,2115,1,11,6,3,31,14,17,39
CSKA Moscow,2115,2,11,4,5,29,18,11,37
Spart Moscow,2115,3,9,7,4,39,29,10,34
Krasnodar,2115,4,10,4,6,30,25,5,34
Terek Grozny,2115,5,9,5,6,23,23,0,32
Zenit,2115,6,7,10,3,23,15,8,31
FK Rubin,2115,7,6,5,9,23,19,4,23
Din Moscow,2115,8,5,7,8,20,25,-5,22
Rostov,2115,9,4,6,10,11,20,-9,18
Amkar,2115,10,4,5,11,11,25,-14,17
Anzhi,2115,11,2,5,13,14,41,-27,11
Loko Moscow,2116,1,12,6,2,31,11,20,42
CSKA Moscow,2116,2,11,3,6,26,18,8,36
Spart Moscow,2116,3,9,5,6,38,31,7,32
Zenit,2116,4,8,8,4,22,15,7,32
Krasnodar,2116,5,9,5,6,30,26,4,32
Terek Grozny,2116,6,8,5,7,22,24,-2,29
Din Moscow,2116,7,5,7,8,19,25,-6,22
Amkar,2116,8,6,4,10,14,24,-10,22
FK Rubin,2116,9,5,6,9,24,21,3,21
Rostov,2116,10,5,6,9,12,18,-6,21
Anzhi,2116,11,2,5,13,14,39,-25,11
Loko Moscow,2117,1,13,5,2,35,13,22,44
CSKA Moscow,2117,2,12,3,5,31,19,12,39
Spart Moscow,2117,3,9,7,4,37,28,9,34
Terek Grozny,2117,4,8,6,6,25,25,0,30
Zenit,2117,5,7,8,5,23,17,6,29
Krasnodar,2117,6,8,4,8,28,30,-2,28
FK Rubin,2117,7,7,5,8,24,17,7,26
Din Moscow,2117,8,5,7,8,19,24,-5,22
Rostov,2117,9,4,7,9,11,18,-7,19
Amkar,2117,10,4,5,11,11,25,-14,17
Anzhi,2117,11,2,5,13,16,44,-28,11
Loko Moscow,2118,1,12,6,2,31,11,20,42
Spart Moscow,2118,2,10,5,5,37,28,9,35
CSKA Moscow,2118,3,10,4,6,26,20,6,34
Zenit,2118,4,8,8,4,24,16,8,32
Krasnodar,2118,5,8,6,6,29,26,3,30
Terek Grozny,2118,6,8,5,7,22,25,-3,29
FK Rubin,2118,7,6,6,8,24,19,5,24
Din Moscow,2118,8,6,6,8,19,23,-4,24
Rostov,2118,9,4,6,10,10,18,-8,18
Amkar,2118,10,4,4,12,11,26,-15,16
Anzhi,2118,11,3,6,11,16,37,-21,15
Loko Moscow,2119,1,11,7,2,30,12,18,40
CSKA Moscow,2119,2,11,3,6,27,19,8,36
Zenit,2119,3,8,9,3,23,14,9,33
Spart Moscow,2119,4,9,6,5,35,28,7,33
Krasnodar,2119,5,9,5,6,29,25,4,32
Terek Grozny,2119,6,8,5,7,22,24,-2,29
Din Moscow,2119,7,6,6,8,20,23,-3,24
FK Rubin,2119,8,6,5,9,23,19,4,23
Rostov,2119,9,4,7,9,10,17,-7,19
Amkar,2119,10,5,4,11,12,25,-13,19
Anzhi,2119,11,2,5,13,14,39,-25,11
Loko Moscow,2120,1,12,6,2,32,12,20,42
CSKA Moscow,2120,2,10,5,5,27,19,8,35
Spart Moscow,2120,3,8,8,4,38,30,8,32
Krasnodar,2120,4,9,5,6,31,26,5,32
Zenit,2120,5,7,9,4,23,17,6,30
Terek Grozny,2120,6,7,6,7,21,25,-4,27
Din Moscow,2120,7,6,7,7,20,23,-3,25
FK Rubin,2120,8,5,5,10,23,22,1,20
Amkar,2120,9,5,5,10,13,24,-11,20
Rostov,2120,10,4,7,9,12,19,-7,19
Anzhi,2120,11,2,7,11,15,38,-23,13
Loko Moscow,2121,1,12,5,3,31,14,17,41
CSKA Moscow,2121,2,11,3,6,28,21,7,36
Spart Moscow,2121,3,9,7,4,39,29,10,34
Zenit,2121,4,8,8,4,26,16,10,32
Krasnodar,2121,5,9,4,7,29,25,4,31
Terek Grozny,2121,6,7,6,7,20,23,-3,27
Din Moscow,2121,7,6,7,7,22,24,-2,25
FK Rubin,2121,8,6,5,9,23,20,3,23
Rostov,2121,9,4,6,10,10,19,-9,18
Amkar,2121,10,4,6,10,11,24,-13,18
Anzhi,2121,11,3,5,12,15,39,-24,14
Loko Moscow,2122,1,13,5,2,33,11,22,44
Spart Moscow,2122,2,11,5,4,39,25,14,38
CSKA Moscow,2122,3,10,5,5,29,21,8,35
Zenit,2122,4,7,9,4,24,19,5,30
Terek Grozny,2122,5,8,5,7,22,25,-3,29
Krasnodar,2122,6,8,4,8,28,27,1,28
FK Rubin,2122,7,7,5,8,26,18,8,26
Din Moscow,2122,8,5,6,9,17,25,-8,21
Rostov,2122,9,4,6,10,10,19,-9,18
Amkar,2122,10,4,4,12,9,27,-18,16
Anzhi,2122,11,3,6,11,18,38,-20,15
CSKA Moscow,2123,1,12,3,5,28,18,10,39
Loko Moscow,2123,2,11,5,4,32,16,16,38
Krasnodar,2123,3,10,4,6,29,24,5,34
Spart Moscow,2123,4,8,8,4,35,27,8,32
Zenit,2123,5,8,8,4,25,17,8,32
Terek Grozny,2123,6,8,6,6,22,23,-1,30
Din Moscow,2123,7,5,8,7,19,23,-4,23
FK Rubin,2123,8,5,6,9,23,20,3,21
Rostov,2123,9,4,7,9,11,18,-7,19
Amkar,2123,10,4,5,11,10,24,-14,17
Anzhi,2123,11,2,6,12,16,40,-24,12
Loko Moscow,2124,1,12,6,2,31,11,20,42
Spart Moscow,2124,2,9,7,4,40,28,12,34
CSKA Moscow,2124,3,10,4,6,25,18,7,34
Zenit,2124,4,8,8,4,22,15,7,32
Krasnodar,2124,5,8,6,6,28,25,3,30
Terek Grozny,2124,6,8,6,6,22,23,-1,30
Din Moscow,2124,7,6,6,8,18,25,-7,24
FK Rubin,2124,8,5,6,9,22,19,3,21
Rostov,2124,9,4,7,9,10,17,-7,19
Amkar,2124,10,4,6,10,12,25,-13,18
Anzhi,2124,11,2,6,12,15,39,-24,12
Loko Moscow,2125,1,12,5,3,30,12,18,41
CSKA Moscow,2125,2,11,4,5,28,19,9,37
Zenit,2125,3,8,8,4,23,15,8,32
Spart Moscow,2125,4,8,5,7,35,30,5,29
Terek Grozny,2125,5,8,5,7,23,25,-2,29
Krasnodar,2125,6,8,4,8,27,26,1,28
FK Rubin,2125,7,7,5,8,25,19,6,26
Din Moscow,2125,8,6,6,8,22,26,-4,24
Amkar,2125,9,6,4,10,12,23,-11,22
Rostov,2125,10,5,6,9,11,17,-6,21
Anzhi,2125,11,2,6,12,16,40,-24,12
Loko Moscow,2126,1,12,5,3,32,14,18,41
CSKA Moscow,2126,2,11,3,6,30,19,11,36
Krasnodar,2126,3,10,4,6,32,26,6,34
Spart Moscow,2126,4,9,6,5,38,29,9,33
Zenit,2126,5,8,8,4,23,14,9,32
Terek Grozny,2126,6,8,5,7,26,25,1,29
Din Moscow,2126,7,5,8,7,20,24,-4,23
Amkar,2126,8,6,4,10,12,23,-11,22
FK Rubin,2126,9,5,6,9,22,20,2,21
Rostov,2126,10,4,6,10,11,20,-9,18
Anzhi,2126,11,2,5,13,15,47,-32,11
Loko Moscow,2127,1,12,5,3,32,14,18,41
Spart Moscow,2127,2,11,5,4,42,27,15,38
CSKA Moscow,2127,3,11,3,6,26,18,8,36
Zenit,2127,4,8,8,4,22,15,7,32
Krasnodar,2127,5,9,5,6,30,25,5,32
Terek Grozny,2127,6,8,6,6,22,22,0,30
FK Rubin,2127,7,5,7,8,21,17,4,22
Din Moscow,2127,8,5,7,8,18,25,-7,22
Rostov,2127,9,4,6,10,10,20,-10,18
Amkar,2127,10,4,4,12,10,26,-16,16
Anzhi,2127,11,2,6,12,14,38,-24,12
Loko Moscow,2128,1,12,5,3,33,15,18,41
CSKA Moscow,2128,2,11,4,5,29,19,10,37
Spart Moscow,2128,3,10,6,4,36,26,10,36
Krasnodar,2128,4,9,4,7,32,27,5,31
Zenit,2128,5,7,9,4,22,18,4,30
Terek Grozny,2128,6,7,6,7,21,24,-3,27
FK Rubin,2128,7,6,6,8,25,19,6,24
Din Moscow,2128,8,5,8,7,19,23,-4,23
Rostov,2128,9,4,6,10,10,18,-8,18
Amkar,2128,10,4,5,11,10,24,-14,17
Anzhi,2128,11,3,5,12,16,40,-24,14
Loko Moscow,2129,1,11,5,4,30,14,16,38
Spart Moscow,2129,2,10,5,5,38,27,11,35
CSKA Moscow,2129,3,10,5,5,29,21,8,35
Zenit,2129,4,8,9,3,24,15,9,33
Krasnodar,2129,5,9,4,7,29,28,1,31
Terek Grozny,2129,6,8,6,6,24,24,0,30
FK Rubin,2129,7,7,5,8,25,17,8,26
Din Moscow,2129,8,5,6,9,17,24,-7,21
Amkar,2129,9,5,5,10,13,25,-12,20
Rostov,2129,10,4,6,10,10,19,-9,18
Anzhi,2129,11,2,6,12,16,41,-25,12
Loko Moscow,2130,1,11,7,2,32,14,18,40
CSKA Moscow,2130,2,12,3,5,28,18,10,39
Spart Moscow,2130,3,10,6,4,43,28,15,36
Krasnodar,2130,4,9,5,6,32,26,6,32
Zenit,2130,5,7,9,4,22,15,7,30
Terek Grozny,2130,6,8,6,6,24,23,1,30
FK Rubin,2130,7,6,5,9,23,21,2,23
Din Moscow,2130,8,5,7,8,20,25,-5,22
Rostov,2130,9,4,6,10,10,22,-12,18
Amkar,2130,10,4,4,12,10,28,-18,16
Anzhi,2130,11,2,6,12,16,40,-24,12
Loko Moscow,2131,1,12,6,2,34,14,20,42
Spart Moscow,2131,2,10,5,5,40,28,12,35
CSKA Moscow,2131,3,10,3,7,26,22,4,33
Zenit,2131,4,8,8,4,23,16,7,32
Terek Grozny,2131,5,8,6,6,23,22,1,30
Krasnodar,2131,6,8,5,7,30,28,2,29
Din Moscow,2131,7,6,7,7,21,24,-3,25
FK Rubin,2131,8,6,6,8,25,20,5,24
Rostov,2131,9,4,6,10,10,18,-8,18
Amkar,2131,10,4,5,11,10,27,-17,17
Anzhi,2131,11,3,5,12,18,41,-23,14
Loko Moscow,2132,1,11,5,4,31,15,16,38
CSKA Moscow,2132,2,11,4,5,28,19,9,37
Spart Moscow,2132,3,9,7,4,40,31,9,34
Krasnodar,2132,4,10,4,6,30,25,5,34
Zenit,2132,5,8,9,3,25,16,9,33
Terek Grozny,2132,6,7,7,6,23,25,-2,28
FK Rubin,2132,7,6,5,9,23,19,4,23
Din Moscow,2132,8,5,7,8,20,25,-5,22
Rostov,2132,9,4,6,10,13,21,-8,18
Amkar,2132,10,4,6,10,12,25,-13,18
Anzhi,2132,11,2,6,12,15,39,-24,12
Loko Moscow,2133,1,12,6,2,34,13,21,42
CSKA Moscow,2133,2,11,3,6,27,21,6,36
Zenit,2133,3,8,9,3,25,14,11,33
Spart Moscow,2133,4,9,6,5,39,29,10,33
Krasnodar,2133,5,9,4,7,30,29,1,31
Terek Grozny,2133,6,7,6,7,20,24,-4,27
Din Moscow,2133,7,6,6,8,20,26,-6,24
FK Rubin,2133,8,5,5,10,23,22,1,20
Amkar,2133,9,5,5,10,12,23,-11,20
Rostov,2133,10,4,7,9,11,18,-7,19
Anzhi,2133,11,3,5,12,17,39,-22,14
Loko Moscow,2134,1,11,7,2,31,13,18,40
CSKA Moscow,2134,2,11,3,6,28,21,7,36
Zenit,2134,3,8,9,3,25,14,11,33
Spart Moscow,2134,4,9,6,5,40,32,8,33
Krasnodar,2134,5,8,5,7,30,30,0,29
Din Moscow,2134,6,7,6,7,20,21,-1,27
Terek Grozny,2134,7,7,6,7,21,24,-3,27
FK Rubin,2134,8,6,5,9,25,19,6,23
Rostov,2134,9,4,7,9,13,20,-7,19
Amkar,2134,10,4,5,11,12,27,-15,17
Anzhi,2134,11,3,5,12,15,39,-24,14
Loko Moscow,2135,1,12,6,2,31,12,19,42
CSKA Moscow,2135,2,10,5,5,27,19,8,35
Spart Moscow,2135,3,9,6,5,37,30,7,33
Krasnodar,2135,4,9,5,6,30,26,4,32
Zenit,2135,5,7,9,4,22,15,7,30
Terek Grozny,2135,6,8,5,7,23,25,-2,29
Din Moscow,2135,7,5,8,7,21,25,-4,23
FK Rubin,2135,8,5,6,9,23,20,3,21
Rostov,2135,9,5,6,9,12,17,-5,21
Amkar,2135,10,4,4,12,9,25,-16,16
Anzhi,2135,11,3,6,11,18,39,-21,15
Loko Moscow,2136,1,13,5,2,31,11,20,44
Spart Moscow,2136,2,10,5,5,36,28,8,35
CSKA Moscow,2136,3,10,3,7,27,22,5,33
Zenit,2136,4,8,8,4,23,14,9,32
Krasnodar,2136,5,9,4,7,28,25,3,31
Terek Grozny,2136,6,8,5,7,21,23,-2,29
Din Moscow,2136,7,6,6,8,19,23,-4,24
FK Rubin,2136,8,5,5,10,21,19,2,20
Amkar,2136,9,5,4,11,11,23,-12,19
Rostov,2136,10,4,6,10,10,18,-8,18
Anzhi,2136,11,4,5,11,18,39,-21,17
Loko Moscow,2137,1,12,5,3,30,12,18,41
CSKA Moscow,2137,2,11,3,6,27,21,6,36
Zenit,2137,3,9,8,3,25,13,12,35
Spart Moscow,2137,4,9,7,4,36,26,10,34
Krasnodar,2137,5,8,4,8,27,26,1,28
Terek Grozny,2137,6,7,5,8,21,26,-5,26
FK Rubin,2137,7,6,6,8,23,18,5,24
Din Moscow,2137,8,5,7,8,18,24,-6,22
Amkar,2137,9,5,5,10,12,24,-12,20
Rostov,2137,10,4,7,9,10,17,-7,19
Anzhi,2137,11,3,5,12,17,39,-22,14
Loko Moscow,2138,1,12,5,3,31,13,18,41
Zenit,2138,2,9,8,3,26,13,13,35
Spart Moscow,2138,3,10,5,5,40,33,7,35
CSKA Moscow,2138,4,10,4,6,26,21,5,34
Terek Grozny,2138,5,9,5,6,25,24,1,32
Krasnodar,2138,6,8,5,7,28,27,1,29
FK Rubin,2138,7,5,7,8,23,19,4,22
Din Moscow,2138,8,5,7,8,20,26,-6,22
Amkar,2138,9,5,4,11,17,26,-9,19
Rostov,2138,10,4,6,10,10,19,-9,18
Anzhi,2138,11,2,6,12,15,40,-25,12
Loko Moscow,2139,1,11,5,4,30,16,14,38
Spart Moscow,2139,2,11,5,4,38,26,12,38
CSKA Moscow,2139,3,11,3,6,29,19,10,36
Zenit,2139,4,9,8,3,24,13,11,35
Krasnodar,2139,5,9,5,6,32,27,5,32
Terek Grozny,2139,6,7,6,7,20,24,-4,27
Din Moscow,2139,7,6,6,8,20,23,-3,24
FK Rubin,2139,8,5,6,9,23,21,2,21
Rostov,2139,9,4,6,10,10,19,-9,18
Amkar,2139,10,4,5,11,9,23,-14,17
Anzhi,2139,11,3,5,12,17,41,-24,14
Loko Moscow,2140,1,13,5,2,37,12,25,44
CSKA Moscow,2140,2,12,3,5,28,18,10,39
Spart Moscow,2140,3,8,7,5,36,30,6,31
Zenit,2140,4,7,8,5,21,16,5,29
Terek Grozny,2140,5,8,5,7,23,28,-5,29
Krasnodar,2140,6,8,4,8,29,32,-3,28
FK Rubin,2140,7,7,5,8,24,18,6,26
Din Moscow,2140,8,5,7,8,17,22,-5,22
Rostov,2140,9,4,7,9,11,18,-7,19
Amkar,2140,10,5,4,11,14,26,-12,19
Anzhi,2140,11,3,5,12,20,40,-20,14
Loko Moscow,2141,1,12,6,2,32,12,20,42
Spart Moscow,2141,2,10,5,5,45,32,13,35
CSKA Moscow,2141,3,10,4,6,26,19,7,34
Zenit,2141,4,8,8,4,22,15,7,32
Krasnodar,2141,5,8,6,6,31,28,3,30
Terek Grozny,2141,6,8,5,7,24,26,-2,29
Din Moscow,2141,7,7,6,7,23,24,-1,27
FK Rubin,2141,8,5,6,9,24,22,2,21
Amkar,2141,9,5,4,11,14,29,-15,19
Rostov,2141,10,4,6,10,11,20,-9,18
Anzhi,2141,11,2,6,12,16,41,-25,12
Loko Moscow,2142,1,12,6,2,30,11,19,42
Spart Moscow,2142,2,10,6,4,39,29,10,36
CSKA Moscow,2142,3,10,4,6,26,19,7,34
Zenit,2142,4,7,10,3,21,13,8,31
Krasnodar,2142,5,8,5,7,28,26,2,29
Terek Grozny,2142,6,8,5,7,22,24,-2,29
Din Moscow,2142,7,6,7,7,23,24,-1,25
FK Rubin,2142,8,5,6,9,23,22,1,21
Amkar,2142,9,5,4,11,11,23,-12,19
Rostov,2142,10,4,6,10,12,20,-8,18
Anzhi,2142,11,3,5,12,16,40,-24,14
Loko Moscow,2143,1,12,5,3,31,13,18,41
CSKA Moscow,2143,2,11,3,6,31,19,12,36
Spart Moscow,2143,3,9,7,4,35,26,9,34
Zenit,2143,4,8,8,4,23,19,4,32
Krasnodar,2143,5,9,4,7,30,26,4,31
Terek Grozny,2143,6,8,6,6,22,23,-1,30
FK Rubin,2143,7,6,5,9,24,21,3,23
Din Moscow,2143,8,5,7,8,18,23,-5,22
Rostov,2143,9,4,6,10,11,19,-8,18
Amkar,2143,10,4,5,11,9,23,-14,17
Anzhi,2143,11,3,6,11,17,39,-22,15
Loko Moscow,2144,1,12,6,2,30,11,19,42
Spart Moscow,2144,2,11,5,4,39,28,11,38
CSKA Moscow,2144,3,11,3,6,29,20,9,36
Zenit,2144,4,8,8,4,24,15,9,32
Krasnodar,2144,5,9,5,6,30,24,6,32
Terek Grozny,2144,6,8,5,7,24,26,-2,29
Din Moscow,2144,7,6,6,8,19,23,-4,24
FK Rubin,2144,8,5,5,10,21,21,0,20
Rostov,2144,9,4,6,10,10,18,-8,18
Amkar,2144,10,4,4,12,11,26,-15,16
Anzhi,2144,11,3,5,12,18,43,-25,14
Loko Moscow,2145,1,12,6,2,33,12,21,42
CSKA Moscow,2145,2,12,3,5,31,20,11,39
Spart Moscow,2145,3,10,5,5,39,28,11,35
Krasnodar,2145,4,9,5,6,29,25,4,32
Zenit,2145,5,7,8,5,23,19,4,29
Terek Grozny,2145,6,8,5,7,22,25,-3,29
FK Rubin,2145,7,6,5,9,24,18,6,23
Din Moscow,2145,8,5,6,9,17,27,-10,21
Amkar,2145,9,5,4,11,13,25,-12,19
Rostov,2145,10,4,6,10,10,19,-9,18
Anzhi,2145,11,3,5,12,17,40,-23,14
Loko Moscow,2146,1,11,5,4,31,17,14,38
CSKA Moscow,2146,2,10,5,5,25,17,8,35
Zenit,2146,3,8,9,3,23,13,10,33
Spart Moscow,2146,4,9,5,6,34,28,6,32
Krasnodar,2146,5,9,4,7,31,27,4,31
Terek Grozny,2146,6,8,5,7,25,27,-2,29
Din Moscow,2146,7,6,7,7,21,23,-2,25
FK Rubin,2146,8,6,6,8,24,19,5,24
Amkar,2146,9,6,4,10,13,22,-9,22
Rostov,2146,10,4,6,10,10,18,-8,18
Anzhi,2146,11,2,6,12,16,42,-26,12
Loko Moscow,2147,1,11,7,2,30,12,18,40
Spart Moscow,2147,2,10,6,4,40,29,11,36
CSKA Moscow,2147,3,11,3,6,26,19,7,36
Zenit,2147,4,8,9,3,23,13,10,33
Krasnodar,2147,5,9,5,6,30,25,5,32
Terek Grozny,2147,6,7,6,7,21,24,-3,27
Din Moscow,2147,7,5,8,7,17,21,-4,23
FK Rubin,2147,8,5,6,9,21,19,2,21
Rostov,2147,9,4,6,10,12,21,-9,18
Amkar,2147,10,4,5,11,12,26,-14,17
Anzhi,2147,11,3,5,12,15,38,-23,14
Loko Moscow,2148,1,12,6,2,30,11,19,42
Spart Moscow,2148,2,11,5,4,37,26,11,38
CSKA Moscow,2148,3,10,4,6,27,20,7,34
Zenit,2148,4,7,9,4,23,16,7,30
Terek Grozny,2148,5,8,6,6,22,23,-1,30
Krasnodar,2148,6,8,5,7,27,26,1,29
Din Moscow,2148,7,6,6,8,19,23,-4,24
FK Rubin,2148,8,6,5,9,24,19,5,23
Rostov,2148,9,4,6,10,10,18,-8,18
Amkar,2148,10,4,4,12,10,25,-15,16
Anzhi,2148,11,3,6,11,16,38,-22,15
Loko Moscow,2149,1,11,6,3,30,15,15,39
CSKA Moscow,2149,2,11,4,5,28,18,10,37
Spart Moscow,2149,3,9,6,5,37,28,9,33
Zenit,2149,4,7,10,3,22,14,8,31
Krasnodar,2149,5,9,4,7,31,26,5,31
Terek Grozny,2149,6,7,6,7,22,26,-4,27
FK Rubin,2149,7,7,5,8,25,18,7,26
Din Moscow,2149,8,5,7,8,20,26,-6,22
Rostov,2149,9,5,6,9,11,17,-6,21
Amkar,2149,10,4,5,11,10,25,-15,17
Anzhi,2149,11,3,5,12,17,40,-23,14
Loko Moscow,2150,1,12,5,3,33,15,18,41
CSKA Moscow,2150,2,11,4,5,29,19,10,37
Spart Moscow,2150,3,10,6,4,37,27,10,36
Zenit,2150,4,8,9,3,24,15,9,33
Krasnodar,2150,5,8,5,7,30,28,2,29
Terek Grozny,2150,6,7,5,8,20,24,-4,26
FK Rubin,2150,7,5,7,8,23,19,4,22
Din Moscow,2150,8,5,7,8,18,23,-5,22
Rostov,2150,9,4,7,9,12,19,-7,19
Amkar,2150,10,5,4,11,10,23,-13,19
Anzhi,2150,11,3,5,12,16,40,-24,14
Loko Moscow,2151,1,11,7,2,30,12,18,40
CSKA Moscow,2151,2,12,3,5,28,18,10,39
Spart Moscow,2151,3,10,6,4,40,27,13,36
Krasnodar,2151,4,9,5,6,30,25,5,32
Zenit,2151,5,7,9,4,22,15,7,30
Terek Grozny,2151,6,8,5,7,23,25,-2,29
Din Moscow,2151,7,5,7,8,18,24,-6,22
FK Rubin,2151,8,5,6,9,21,19,2,21
Rostov,2151,9,4,7,9,10,17,-7,19
Amkar,2151,10,5,4,11,12,26,-14,19
Anzhi,2151,11,2,5,13,15,41,-26,11
Loko Moscow,2152,1,11,5,4,29,13,16,38
CSKA Moscow,2152,2,11,3,6,26,20,6,36
Zenit,2152,3,9,8,3,25,13,12,35
Spart Moscow,2152,4,9,7,4,38,29,9,34
Krasnodar,2152,5,10,4,6,31,24,7,34
Terek Grozny,2152,6,7,6,7,23,26,-3,27
Din Moscow,2152,7,5,7,8,19,24,-5,22
FK Rubin,2152,8,5,6,9,22,21,1,21
Amkar,2152,9,5,5,10,13,25,-12,20
Rostov,2152,10,4,7,9,11,18,-7,19
Anzhi,2152,11,2,6,12,16,40,-24,12
Loko Moscow,2153,1,13,5,2,33,12,21,44
CSKA Moscow,2153,2,11,4,5,30,18,12,37
Spart Moscow,2153,3,10,5,5,37,27,10,35
Zenit,2153,4,7,9,4,23,17,6,30
Krasnodar,2153,5,8,4,8,27,27,0,28
Terek Grozny,2153,6,7,5,8,20,25,-5,26
Din Moscow,2153,7,6,6,8,19,23,-4,24
FK Rubin,2153,8,6,5,9,23,18,5,23
Amkar,2153,9,6,4,10,11,22,-11,22
Rostov,2153,10,4,6,10,10,19,-9,18
Anzhi,2153,11,3,5,12,16,41,-25,14
Loko Moscow,2154,1,11,6,3,31,14,17,39
CSKA Moscow,2154,2,11,3,6,28,20,8,36
Spart Moscow,2154,3,9,6,5,36,29,7,33
Zenit,2154,4,8,8,4,23,15,8,32
Krasnodar,2154,5,9,5,6,29,25,4,32
Terek Grozny,2154,6,8,6,6,26,24,2,30
Din Moscow,2154,7,6,6,8,19,23,-4,24
FK Rubin,2154,8,5,5,10,21,19,2,20
Rostov,2154,9,4,7,9,11,18,-7,19
Amkar,2154,10,5,4,11,11,26,-15,19
Anzhi,2154,11,3,6,11,19,41,-22,15
Loko Moscow,2155,1,11,7,2,30,12,18,40
CSKA Moscow,2155,2,12,3,5,30,17,13,39
Spart Moscow,2155,3,10,6,4,37,27,10,36
Krasnodar,2155,4,9,5,6,30,24,6,32
Zenit,2155,5,7,9,4,22,15,7,30
Terek Grozny,2155,6,8,5,7,25,27,-2,29
FK Rubin,2155,7,6,5,9,24,20,4,23
Din Moscow,2155,8,5,6,9,17,25,-8,21
Amkar,2155,9,5,5,10,14,26,-12,20
Rostov,2155,10,4,6,10,10,18,-8,18
Anzhi,2155,11,2,5,13,16,44,-28,11
Loko Moscow,2156,1,11,6,3,30,14,16,39
CSKA Moscow,2156,2,11,3,6,29,19,10,36
Zenit,2156,3,9,8,3,26,15,11,35
Spart Moscow,2156,4,9,6,5,36,29,7,33
Krasnodar,2156,5,8,6,6,27,24,3,30
Terek Grozny,2156,6,7,7,6,22,24,-2,28
Din Moscow,2156,7,6,7,7,20,23,-3,25
FK Rubin,2156,8,5,6,9,21,18,3,21
Rostov,2156,9,5,6,9,12,17,-5,21
Amkar,2156,10,4,5,11,11,25,-14,17
Anzhi,2156,11,2,6,12,14,40,-26,12
Loko Moscow,2157,1,11,7,2,30,12,18,40
Spart Moscow,2157,2,11,5,4,37,26,11,38
Zenit,2157,3,8,9,3,23,14,9,33
CSKA Moscow,2157,4,10,3,7,25,19,6,33
Krasnodar,2157,5,8,5,7,27,27,0,29
Terek Grozny,2157,6,7,5,8,21,25,-4,26
Din Moscow,2157,7,6,6,8,20,24,-4,24
FK Rubin,2157,8,6,5,9,25,19,6,23
Amkar,2157,9,5,4,11,10,23,-13,19
Rostov,2157,10,4,6,10,10,18,-8,18
Anzhi,2157,11,4,5,11,17,38,-21,17
Loko Moscow,2158,1,12,6,2,33,12,21,42
CSKA Moscow,2158,2,11,4,5,30,19,11,37
Spart Moscow,2158,3,9,6,5,34,26,8,33
Zenit,2158,4,7,10,3,24,16,8,31
Krasnodar,2158,5,9,4,7,29,28,1,31
Terek Grozny,2158,6,7,7,6,22,24,-2,28
Din Moscow,2158,7,7,6,7,20,22,-2,27
FK Rubin,2158,8,5,5,10,23,21,2,20
Rostov,2158,9,4,7,9,10,17,-7,19
Amkar,2158,10,4,5,11,10,24,-14,17
Anzhi,2158,11,2,6,12,15,41,-26,12
Loko Moscow,2159,1,11,5,4,29,13,16,38
Zenit,2159,2,9,8,3,24,14,10,35
CSKA Moscow,2159,3,10,3,7,28,22,6,33
Krasnodar,2159,4,9,4,7,28,26,2,31
Spart Moscow,2159,5,8,6,6,34,29,5,30
Terek Grozny,2159,6,7,6,7,23,28,-5,27
FK Rubin,2159,7,7,5,8,26,18,8,26
Din Moscow,2159,8,6,6,8,19,24,-5,24
Amkar,2159,9,6,4,10,15,23,-8,22
Rostov,2159,10,4,7,9,11,18,-7,19
Anzhi,2159,11,3,6,11,19,41,-22,15
Loko Moscow,2160,1,12,5,3,30,13,17,41
CSKA Moscow,2160,2,11,4,5,28,17,11,37
Spart Moscow,2160,3,10,6,4,39,27,12,36
Zenit,2160,4,8,9,3,23,13,10,33
Krasnodar,2160,5,9,4,7,28,25,3,31
Terek Grozny,2160,6,8,6,6,22,23,-1,30
FK Rubin,2160,7,6,5,9,25,20,5,23
Din Moscow,2160,8,5,6,9,20,28,-8,21
Rostov,2160,9,4,7,9,10,17,-7,19
Amkar,2160,10,4,5,11,11,26,-15,17
Anzhi,2160,11,2,5,13,14,41,-27,11
Loko Moscow,2161,1,11,6,3,30,13,17,39
CSKA Moscow,2161,2,11,3,6,28,18,10,36
Zenit,2161,3,9,8,3,23,13,10,35
Spart Moscow,2161,4,9,7,4,37,27,10,34
Krasnodar,2161,5,9,5,6,30,25,5,32
Terek Grozny,2161,6,8,6,6,24,25,-1,30
FK Rubin,2161,7,6,5,9,23,20,3,23
Din Moscow,2161,8,5,7,8,18,23,-5,22
Rostov,2161,9,4,6,10,12,21,-9,18
Amkar,2161,10,4,6,10,12,25,-13,18
Anzhi,2161,11,2,5,13,14,41,-27,11
Loko Moscow,2162,1,11,6,3,31,15,16,39
CSKA Moscow,2162,2,10,5,5,28,20,8,35
Zenit,2162,3,7,10,3,24,16,8,31
Krasnodar,2162,4,9,4,7,30,26,4,31
Spart Moscow,2162,5,8,5,7,35,30,5,29
Terek Grozny,2162,6,7,7,6,22,24,-2,28
FK Rubin,2162,7,7,5,8,23,17,6,26
Din Moscow,2162,8,6,6,8,19,23,-4,24
Rostov,2162,9,5,6,9,12,18,-6,21
Amkar,2162,10,5,5,10,11,23,-12,20
Anzhi,2162,11,2,7,11,16,39,-23,13
Loko Moscow,2163,1,12,6,2,34,13,21,42
CSKA Moscow,2163,2,11,3,6,28,21,7,36
Spart Moscow,2163,3,10,5,5,40,29,11,35
Zenit,2163,4,8,9,3,25,14,11,33
Krasnodar,2163,5,9,4,7,33,29,4,31
Terek Grozny,2163,6,8,6,6,24,24,0,30
Din Moscow,2163,7,6,6,8,19,25,-6,24
FK Rubin,2163,8,6,5,9,25,22,3,23
Rostov,2163,9,4,6,10,11,21,-10,18
Amkar,2163,10,4,4,12,10,26,-16,16
Anzhi,2163,11,2,6,12,17,42,-25,12
Loko Moscow,2164,1,12,6,2,32,13,19,42
CSKA Moscow,2164,2,11,3,6,28,19,9,36
Zenit,2164,3,8,9,3,24,15,9,33
Spart Moscow,2164,4,9,6,5,36,29,7,33
Krasnodar,2164,5,8,5,7,29,27,2,29
Terek Grozny,2164,6,7,6,7,22,26,-4,27
FK Rubin,2164,7,6,6,8,24,19,5,24
Rostov,2164,8,5,6,9,12,17,-5,21
Din Moscow,2164,9,5,6,9,18,24,-6,21
Amkar,2164,10,5,5,10,13,24,-11,20
Anzhi,2164,11,2,6,12,16,41,-25,12
Loko Moscow,2165,1,12,6,2,30,11,19,42
Spart Moscow,2165,2,10,5,5,40,27,13,35
CSKA Moscow,2165,3,10,4,6,26,19,7,34
Zenit,2165,4,7,9,4,22,15,7,30
Krasnodar,2165,5,8,5,7,29,27,2,29
Terek Grozny,2165,6,7,7,6,23,25,-2,28
FK Rubin,2165,7,6,6,8,25,20,5,24
Din Moscow,2165,8,5,7,8,18,26,-8,22
Amkar,2165,9,5,5,10,12,24,-12,20
Rostov,2165,10,4,6,10,11,20,-9,18
Anzhi,2165,11,3,6,11,16,38,-22,15
Loko Moscow,2166,1,11,5,4,29,13,16,38
CSKA Moscow,2166,2,11,3,6,27,19,8,36
Zenit,2166,3,9,8,3,24,13,11,35
Spart Moscow,2166,4,8,7,5,35,29,6,31
Krasnodar,2166,5,9,4,7,29,26,3,31
Terek Grozny,2166,6,8,6,6,23,22,1,30
FK Rubin,2166,7,7,5,8,25,19,6,26
Din Moscow,2166,8,6,6,8,20,23,-3,24
Rostov,2166,9,4,7,9,10,17,-7,19
Amkar,2166,10,4,6,10,11,24,-13,18
Anzhi,2166,11,2,5,13,14,42,-28,11
Loko Moscow,2167,1,11,6,3,29,12,17,39
Spart Moscow,2167,2,10,5,5,40,29,11,35
CSKA Moscow,2167,3,10,4,6,27,21,6,34
Zenit,2167,4,8,9,3,25,15,10,33
Krasnodar,2167,5,9,5,6,29,25,4,32
Terek Grozny,2167,6,9,5,6,25,23,2,32
Din Moscow,2167,7,6,6,8,19,23,-4,24
FK Rubin,2167,8,5,6,9,22,20,2,21
Amkar,2167,9,5,4,11,11,25,-14,19
Rostov,2167,10,4,6,10,12,21,-9,18
Anzhi,2167,11,2,6,12,15,40,-25,12
Loko Moscow,2168,1,13,5,2,33,12,21,44
CSKA Moscow,2168,2,11,4,5,29,19,10,37
Spart Moscow,2168,3,10,6,4,40,27,13,36
Terek Grozny,2168,4,9,5,6,23,22,1,32
Zenit,2168,5,7,9,4,24,17,7,30
Krasnodar,2168,6,8,4,8,27,27,0,28
FK Rubin,2168,7,7,5,8,25,17,8,26
Din Moscow,2168,8,5,6,9,18,28,-10,21
Rostov,2168,9,4,7,9,10,17,-7,19
Amkar,2168,10,4,4,12,10,26,-16,16
Anzhi,2168,11,2,5,13,14,41,-27,11
Loko Moscow,2169,1,11,7,2,29,11,18,40
Spart Moscow,2169,2,11,5,4,39,28,11,38
CSKA Moscow,2169,3,11,3,6,29,20,9,36
Zenit,2169,4,8,9,3,22,13,9,33
Krasnodar,2169,5,8,5,7,27,26,1,29
Terek Grozny,2169,6,8,5,7,24,25,-1,29
Din Moscow,2169,7,6,6,8,20,23,-3,24
FK Rubin,2169,8,6,5,9,23,19,4,23
Rostov,2169,9,4,6,10,10,18,-8,18
Amkar,2169,10,4,4,12,11,28,-17,16
Anzhi,2169,11,3,5,12,19,42,-23,14
Loko Moscow,2170,1,11,7,2,30,12,18,40
Spart Moscow,2170,2,10,6,4,42,29,13,36
CSKA Moscow,2170,3,10,4,6,27,20,7,34
Zenit,2170,4,8,9,3,23,14,9,33
Krasnodar,2170,5,8,6,6,29,26,3,30
Terek Grozny,2170,6,8,5,7,21,23,-2,29
FK Rubin,2170,7,5,7,8,23,19,4,22
Din Moscow,2170,8,5,7,8,19,26,-7,22
Amkar,2170,9,5,5,10,12,24,-12,20
Rostov,2170,10,4,6,10,11,20,-9,18
Anzhi,2170,11,2,6,12,15,39,-24,12
Loko Moscow,2171,1,12,6,2,31,12,19,42
Spart Moscow,2171,2,10,6,4,37,26,11,36
CSKA Moscow,2171,3,11,3,6,26,18,8,36
Zenit,2171,4,8,9,3,22,13,9,33
Terek Grozny,2171,5,8,5,7,23,27,-4,29
Krasnodar,2171,6,8,4,8,28,30,-2,28
Din Moscow,2171,7,6,7,7,18,21,-3,25
FK Rubin,2171,8,6,5,9,25,18,7,23
Amkar,2171,9,5,4,11,15,25,-10,19
Rostov,2171,10,4,6,10,10,19,-9,18
Anzhi,2171,11,2,5,13,14,40,-26,11
Loko Moscow,2172,1,11,5,4,29,13,16,38
Zenit,2172,2,9,8,3,25,15,10,35
Krasnodar,2172,3,10,4,6,30,24,6,34
CSKA Moscow,2172,4,10,3,7,27,21,6,33
Spart Moscow,2172,5,8,5,7,33,28,5,29
Terek Grozny,2172,6,7,7,6,22,24,-2,28
Din Moscow,2172,7,6,7,7,18,21,-3,25
FK Rubin,2172,8,5,6,9,21,19,2,21
Rostov,2172,9,5,6,9,11,17,-6,21
Amkar,2172,10,5,5,10,11,23,-12,20
Anzhi,2172,11,3,6,11,16,38,-22,15
CSKA Moscow,2173,1,12,3,5,30,19,11,39
Loko Moscow,2173,2,11,5,4,29,13,16,38
Krasnodar,2173,3,10,4,6,29,24,5,34
Zenit,2173,4,8,8,4,22,15,7,32
Terek Grozny,2173,5,9,5,6,23,23,0,32
Spart Moscow,2173,6,8,6,6,37,32,5,30
Din Moscow,2173,7,7,6,7,22,23,-1,27
Rostov,2173,8,5,6,9,11,17,-6,21
FK Rubin,2173,9,5,5,10,21,19,2,20
Amkar,2173,10,4,5,11,11,25,-14,17
Anzhi,2173,11,2,5,13,17,42,-25,11
Loko Moscow,2174,1,11,6,3,31,14,17,39
CSKA Moscow,2174,2,11,4,5,29,20,9,37
Spart Moscow,2174,3,9,5,6,36,29,7,32
Krasnodar,2174,4,9,4,7,29,27,2,31
Zenit,2174,5,7,9,4,23,16,7,30
Terek Grozny,2174,6,7,6,7,22,26,-4,27
FK Rubin,2174,7,7,5,8,24,17,7,26
Din Moscow,2174,8,6,6,8,19,23,-4,24
Rostov,2174,9,5,6,9,11,17,-6,21
Amkar,2174,10,4,5,11,11,25,-14,17
Anzhi,2174,11,3,6,11,19,40,-21,15
Loko Moscow,2175,1,12,6,2,33,13,20,42
CSKA Moscow,2175,2,11,4,5,31,18,13,37
Spart Moscow,2175,3,9,5,6,37,31,6,32
Zenit,2175,4,7,10,3,22,14,8,31
Krasnodar,2175,5,9,4,7,30,28,2,31
Din Moscow,2175,6,7,6,7,21,23,-2,27
Terek Grozny,2175,7,7,5,8,23,27,-4,26
Rostov,2175,8,5,6,9,13,18,-5,21
FK Rubin,2175,9,5,5,10,21,19,2,20
Amkar,2175,10,5,4,11,10,23,-13,19
Anzhi,2175,11,3,5,12,18,45,-27,14
Loko Moscow,2176,1,12,6,2,32,12,20,42
CSKA Moscow,2176,2,11,3,6,30,21,9,36
Zenit,2176,3,8,9,3,25,15,10,33
Spart Moscow,2176,4,9,5,6,42,33,9,32
Krasnodar,2176,5,8,5,7,28,27,1,29
Terek Grozny,2176,6,8,5,7,22,24,-2,29
FK Rubin,2176,7,6,6,8,23,18,5,24
Amkar,2176,8,6,4,10,14,24,-10,22
Rostov,2176,9,5,6,9,15,20,-5,21
Din Moscow,2176,10,5,6,9,17,27,-10,21
Anzhi,2176,11,2,5,13,15,42,-27,11
Loko Moscow,2177,1,12,5,3,33,13,20,41
CSKA Moscow,2177,2,11,4,5,29,19,10,37
Spart Moscow,2177,3,9,7,4,38,29,9,34
Krasnodar,2177,4,9,5,6,31,27,4,32
Terek Grozny,2177,5,9,5,6,25,23,2,32
Zenit,2177,6,7,9,4,22,17,5,30
FK Rubin,2177,7,5,7,8,25,21,4,22
Din Moscow,2177,8,5,7,8,19,24,-5,22
Rostov,2177,9,4,7,9,11,18,-7,19
Amkar,2177,10,4,5,11,13,27,-14,17
Anzhi,2177,11,2,5,13,15,43,-28,11
Loko Moscow,2178,1,12,5,3,31,12,19,41
CSKA Moscow,2178,2,11,4,5,29,19,10,37
Spart Moscow,2178,3,10,6,4,39,29,10,36
Krasnodar,2178,4,10,4,6,29,24,5,34
Terek Grozny,2178,5,9,5,6,24,23,1,32
Zenit,2178,6,7,9,4,22,16,6,30
Din Moscow,2178,7,5,7,8,19,24,-5,22
FK Rubin,2178,8,5,6,9,22,19,3,21
Rostov,2178,9,4,6,10,11,19,-8,18
Amkar,2178,10,4,5,11,12,26,-14,17
Anzhi,2178,11,2,5,13,15,42,-27,11
Loko Moscow,2179,1,12,5,3,30,13,17,41
Spart Moscow,2179,2,10,6,4,43,29,14,36
CSKA Moscow,2179,3,10,4,6,28,21,7,34
Krasnodar,2179,4,10,4,6,32,26,6,34
Zenit,2179,5,8,8,4,23,15,8,32
Terek Grozny,2179,6,8,6,6,23,22,1,30
Din Moscow,2179,7,6,6,8,21,28,-7,24
FK Rubin,2179,8,5,5,10,24,22,2,20
Rostov,2179,9,4,6,10,11,20,-9,18
Amkar,2179,10,4,6,10,10,23,-13,18
Anzhi,2179,11,2,6,12,16,42,-26,12
Loko Moscow,2180,1,11,6,3,30,14,16,39
CSKA Moscow,2180,2,11,4,5,27,18,9,37
Spart Moscow,2180,3,10,6,4,41,30,11,36
Zenit,2180,4,8,9,3,25,15,10,33
Krasnodar,2180,5,9,5,6,29,25,4,32
Terek Grozny,2180,6,8,6,6,26,24,2,30
FK Rubin,2180,7,6,5,9,23,19,4,23
Din Moscow,2180,8,5,6,9,19,26,-7,21
Rostov,2180,9,4,7,9,11,18,-7,19
Amkar,2180,10,4,5,11,13,27,-14,17
Anzhi,2180,11,2,5,13,14,42,-28,11
Loko Moscow,2181,1,12,6,2,32,13,19,42
CSKA Moscow,2181,2,11,4,5,26,17,9,37
Spart Moscow,2181,3,9,6,5,35,27,8,33
Terek Grozny,2181,4,9,5,6,25,22,3,32
Zenit,2181,5,7,9,4,22,15,7,30
Krasnodar,2181,6,8,5,7,29,27,2,29
FK Rubin,2181,7,6,6,8,24,19,5,24
Din Moscow,2181,8,5,6,9,18,24,-6,21
Rostov,2181,9,5,6,9,11,17,-6,21
Amkar,2181,10,4,5,11,10,27,-17,17
Anzhi,2181,11,2,6,12,14,38,-24,12
Loko Moscow,2182,1,11,6,3,30,13,17,39
CSKA Moscow,2182,2,12,3,5,27,17,10,39
Spart Moscow,2182,3,9,6,5,36,30,6,33
Zenit,2182,4,8,8,4,22,14,8,32
Terek Grozny,2182,5,9,5,6,23,23,0,32
Krasnodar,2182,6,8,6,6,28,25,3,30
FK Rubin,2182,7,6,6,8,23,18,5,24
Din Moscow,2182,8,6,6,8,21,23,-2,24
Rostov,2182,9,4,6,10,11,19,-8,18
Amkar,2182,10,4,5,11,11,25,-14,17
Anzhi,2182,11,2,5,13,14,39,-25,11
Loko Moscow,2183,1,12,6,2,33,13,20,42
CSKA Moscow,2183,2,12,3,5,33,17,16,39
Krasnodar,2183,3,9,5,6,31,25,6,32
Spart Moscow,2183,4,8,7,5,35,28,7,31
Zenit,2183,5,7,8,5,22,19,3,29
Terek Grozny,2183,6,7,6,7,21,24,-3,27
FK Rubin,2183,7,6,5,9,22,20,2,23
Din Moscow,2183,8,5,7,8,17,22,-5,22
Rostov,2183,9,5,6,9,11,17,-6,21
Amkar,2183,10,5,5,10,13,25,-12,20
Anzhi,2183,11,2,6,12,14,42,-28,12
Loko Moscow,2184,1,12,5,3,32,13,19,41
CSKA Moscow,2184,2,11,3,6,28,19,9,36
Zenit,2184,3,9,8,3,25,14,11,35
Spart Moscow,2184,4,10,5,5,36,26,10,35
Krasnodar,2184,5,8,5,7,29,29,0,29
Terek Grozny,2184,6,7,6,7,21,25,-4,27
FK Rubin,2184,7,5,7,8,24,20,4,22
Din Moscow,2184,8,5,7,8,18,23,-5,22
Amkar,2184,9,6,4,10,12,22,-10,22
Rostov,2184,10,4,6,10,10,19,-9,18
Anzhi,2184,11,2,6,12,15,40,-25,12
Loko Moscow,2185,1,12,6,2,32,12,20,42
Spart Moscow,2185,2,11,5,4,37,26,11,38
CSKA Moscow,2185,3,11,3,6,32,18,14,36
Zenit,2185,4,8,9,3,23,14,9,33
Krasnodar,2185,5,9,4,7,30,27,3,31
Terek Grozny,2185,6,8,5,7,21,23,-2,29
Din Moscow,2185,7,5,7,8,17,22,-5,22
FK Rubin,2185,8,5,6,9,22,20,2,21
Amkar,2185,9,5,4,11,11,24,-13,19
Rostov,2185,10,4,6,10,10,18,-8,18
Anzhi,2185,11,2,5,13,14,45,-31,11
Loko Moscow,2186,1,11,6,3,31,14,17,39
Spart Moscow,2186,2,11,5,4,39,26,13,38
CSKA Moscow,2186,3,11,3,6,27,20,7,36
Krasnodar,2186,4,10,4,6,30,25,5,34
Zenit,2186,5,8,9,3,24,14,10,33
Terek Grozny,2186,6,8,5,7,23,25,-2,29
Din Moscow,2186,7,5,7,8,17,23,-6,22
FK Rubin,2186,8,5,6,9,21,18,3,21
Amkar,2186,9,5,4,11,11,24,-13,19
Rostov,2186,10,4,6,10,10,19,-9,18
Anzhi,2186,11,2,5,13,17,42,-25,11
Loko Moscow,2187,1,11,6,3,31,16,15,39
Spart Moscow,2187,2,10,6,4,37,25,12,36
CSKA Moscow,2187,3,11,3,6,27,20,7,36
Zenit,2187,4,8,9,3,26,16,10,33
Krasnodar,2187,5,9,5,6,31,25,6,32
Terek Grozny,2187,6,9,5,6,23,22,1,32
Din Moscow,2187,7,6,6,8,19,23,-4,24
FK Rubin,2187,8,5,6,9,23,20,3,21
Rostov,2187,9,4,6,10,10,20,-10,18
Amkar,2187,10,4,5,11,9,24,-15,17
Anzhi,2187,11,2,5,13,14,39,-25,11
Loko Moscow,2188,1,13,5,2,34,12,22,44
CSKA Moscow,2188,2,12,3,5,33,21,12,39
Spart Moscow,2188,3,9,6,5,36,26,10,33
Krasnodar,2188,4,9,4,7,28,26,2,31
Zenit,2188,5,7,8,5,24,20,4,29
Terek Grozny,2188,6,8,5,7,22,24,-2,29
Din Moscow,2188,7,6,6,8,18,25,-7,24
FK Rubin,2188,8,6,5,9,25,18,7,23
Rostov,2188,9,4,6,10,10,20,-10,18
Amkar,2188,10,4,5,11,9,24,-15,17
Anzhi,2188,11,3,5,12,18,41,-23,14
Loko Moscow,2189,1,11,5,4,31,17,14,38
Zenit,2189,2,9,8,3,26,15,11,35
Spart Moscow,2189,3,9,6,5,36,28,8,33
CSKA Moscow,2189,4,10,3,7,27,21,6,33
Krasnodar,2189,5,9,5,6,30,25,5,32
Terek Grozny,2189,6,9,5,6,24,23,1,32
Din Moscow,2189,7,6,7,7,20,23,-3,25
FK Rubin,2189,8,5,6,9,22,19,3,21
Rostov,2189,9,5,6,9,12,18,-6,21
Amkar,2189,10,4,4,12,9,25,-16,16
Anzhi,2189,11,3,5,12,17,40,-23,14
Loko Moscow,2190,1,13,5,2,33,12,21,44
CSKA Moscow,2190,2,12,3,5,29,17,12,39
Zenit,2190,3,7,8,5,22,17,5,29
Spart Moscow,2190,4,8,5,7,35,31,4,29
Krasnodar,2190,5,8,5,7,27,25,2,29
Terek Grozny,2190,6,7,6,7,21,27,-6,27
Din Moscow,2190,7,6,7,7,18,21,-3,25
FK Rubin,2190,8,5,7,8,21,17,4,22
Rostov,2190,9,5,6,9,13,19,-6,21
Amkar,2190,10,5,5,10,11,22,-11,20
Anzhi,2190,11,3,5,12,19,41,-22,14
Loko Moscow,2191,1,13,5,2,32,11,21,44
CSKA Moscow,2191,2,11,3,6,30,19,11,36
Spart Moscow,2191,3,9,6,5,36,28,8,33
Zenit,2191,4,8,8,4,23,15,8,32
Terek Grozny,2191,5,8,5,7,23,26,-3,29
Krasnodar,2191,6,8,4,8,27,28,-1,28
Din Moscow,2191,7,7,6,7,21,22,-1,27
FK Rubin,2191,8,6,5,9,23,19,4,23
Rostov,2191,9,4,6,10,11,19,-8,18
Amkar,2191,10,4,5,11,10,24,-14,17
Anzhi,2191,11,3,5,12,17,42,-25,14
Loko Moscow,2192,1,12,6,2,32,12,20,42
CSKA Moscow,2192,2,10,4,6,25,18,7,34
Zenit,2192,3,8,8,4,22,15,7,32
Spart Moscow,2192,4,8,6,6,36,31,5,30
Krasnodar,2192,5,8,6,6,29,26,3,30
Terek Grozny,2192,6,8,6,6,23,23,0,30
Din Moscow,2192,7,5,8,7,21,25,-4,23
FK Rubin,2192,8,5,7,8,24,20,4,22
Rostov,2192,9,5,6,9,12,17,-5,21
Amkar,2192,10,5,5,10,11,23,-12,20
Anzhi,2192,11,2,6,12,15,40,-25,12
Loko Moscow,2193,1,12,5,3,32,12,20,41
Spart Moscow,2193,2,10,5,5,40,30,10,35
CSKA Moscow,2193,3,10,5,5,25,17,8,35
Krasnodar,2193,4,9,4,7,28,25,3,31
Zenit,2193,5,7,9,4,21,16,5,30
Terek Grozny,2193,6,8,6,6,25,25,0,30
FK Rubin,2193,7,7,5,8,24,17,7,26
Din Moscow,2193,8,6,6,8,20,25,-5,24
Rostov,2193,9,4,6,10,11,20,-9,18
Amkar,2193,10,4,5,11,11,25,-14,17
Anzhi,2193,11,2,6,12,16,41,-25,12
Loko Moscow,2194,1,13,5,2,33,12,21,44
CSKA Moscow,2194,2,11,3,6,26,18,8,36
Zenit,2194,3,8,8,4,23,15,8,32
Terek Grozny,2194,4,9,5,6,25,24,1,32
Spart Moscow,2194,5,8,6,6,38,36,2,30
Krasnodar,2194,6,8,5,7,28,27,1,29
FK Rubin,2194,7,6,6,8,23,18,5,24
Din Moscow,2194,8,5,7,8,20,25,-5,22
Rostov,2194,9,5,6,9,14,18,-4,21
Amkar,2194,10,5,4,11,13,25,-12,19
Anzhi,2194,11,2,5,13,16,41,-25,11
Loko Moscow,2195,1,12,5,3,31,13,18,41
CSKA Moscow,2195,2,10,5,5,25,17,8,35
Spart Moscow,2195,3,9,7,4,38,29,9,34
Krasnodar,2195,4,9,4,7,29,26,3,31
Zenit,2195,5,7,9,4,21,14,7,30
Terek Grozny,2195,6,8,6,6,21,22,-1,30
FK Rubin,2195,7,7,5,8,23,17,6,26
Din Moscow,2195,8,5,7,8,20,25,-5,22
Rostov,2195,9,4,7,9,10,17,-7,19
Amkar,2195,10,4,4,12,10,25,-15,16
Anzhi,2195,11,2,7,11,14,37,-23,13
Loko Moscow,2196,1,12,5,3,31,12,19,41
CSKA Moscow,2196,2,12,3,5,30,18,12,39
Spart Moscow,2196,3,9,6,5,37,29,8,33
Krasnodar,2196,4,9,4,7,32,29,3,31
Terek Grozny,2196,5,8,6,6,21,22,-1,30
Zenit,2196,6,7,8,5,22,18,4,29
FK Rubin,2196,7,6,6,8,26,21,5,24
Din Moscow,2196,8,5,8,7,19,23,-4,23
Amkar,2196,9,5,4,11,11,23,-12,19
Rostov,2196,10,4,6,10,10,19,-9,18
Anzhi,2196,11,2,6,12,14,39,-25,12
Loko Moscow,2197,1,12,5,3,32,14,18,41
CSKA Moscow,2197,2,11,4,5,27,17,10,37
Spart Moscow,2197,3,8,7,5,36,29,7,31
Krasnodar,2197,4,9,4,7,30,27,3,31
Zenit,2197,5,7,9,4,21,14,7,30
Din Moscow,2197,6,7,6,7,20,22,-2,27
Terek Grozny,2197,7,7,6,7,22,26,-4,27
FK Rubin,2197,8,6,5,9,23,19,4,23
Rostov,2197,9,4,7,9,12,19,-7,19
Amkar,2197,10,4,6,10,12,25,-13,18
Anzhi,2197,11,3,5,12,16,39,-23,14
Loko Moscow,2198,1,12,6,2,31,12,19,42
Spart Moscow,2198,2,11,5,4,37,26,11,38
CSKA Moscow,2198,3,11,4,5,29,19,10,37
Terek Grozny,2198,4,9,5,6,24,23,1,32
Zenit,2198,5,7,8,5,22,17,5,29
Krasnodar,2198,6,8,5,7,29,27,2,29
FK Rubin,2198,7,7,5,8,24,18,6,26
Din Moscow,2198,8,5,6,9,17,23,-6,21
Rostov,2198,9,4,6,10,10,18,-8,18
Amkar,2198,10,4,4,12,10,25,-15,16
Anzhi,2198,11,2,6,12,16,41,-25,12
Loko Moscow,2199,1,13,5,2,33,12,21,44
CSKA Moscow,2199,2,12,3,5,36,18,18,39
Spart Moscow,2199,3,10,6,4,36,26,10,36
Zenit,2199,4,7,8,5,23,18,5,29
Terek Grozny,2199,5,8,5,7,22,23,-1,29
Krasnodar,2199,6,8,4,8,27,26,1,28
FK Rubin,2199,7,7,5,8,23,17,6,26
Din Moscow,2199,8,5,7,8,17,22,-5,22
Amkar,2199,9,5,4,11,10,23,-13,19
Rostov,2199,10,4,6,10,11,19,-8,18
Anzhi,2199,11,2,5,13,14,48,-34,11
Loko Moscow,2200,1,12,5,3,31,14,17,41
CSKA Moscow,2200,2,11,3,6,28,19,9,36
Zenit,2200,3,9,8,3,26,14,12,35
Spart Moscow,2200,4,9,6,5,37,28,9,33
Krasnodar,2200,5,9,4,7,31,27,4,31
Terek Grozny,2200,6,7,7,6,22,24,-2,28
Din Moscow,2200,7,5,8,7,21,25,-4,23
FK Rubin,2200,8,5,6,9,25,23,2,21
Amkar,2200,9,5,5,10,11,23,-12,20
Rostov,2200,10,4,6,10,10,19,-9,18
Anzhi,2200,11,2,6,12,15,41,-26,12
Loko Moscow,2201,1,11,7,2,33,15,18,40
CSKA Moscow,2201,2,12,3,5,27,17,10,39
Spart Moscow,2201,3,10,6,4,42,28,14,36
Zenit,2201,4,7,9,4,23,16,7,30
Krasnodar,2201,5,8,6,6,30,27,3,30
Terek Grozny,2201,6,8,5,7,23,24,-1,29
FK Rubin,2201,7,6,6,8,26,18,8,24
Din Moscow,2201,8,5,7,8,19,27,-8,22
Amkar,2201,9,5,4,11,11,24,-13,19
Rostov,2201,10,4,6,10,10,22,-12,18
Anzhi,2201,11,2,5,13,15,41,-26,11
Loko Moscow,2202,1,12,6,2,30,11,19,42
Spart Moscow,2202,2,10,6,4,38,27,11,36
CSKA Moscow,2202,3,11,3,6,29,18,11,36
Zenit,2202,4,8,9,3,22,13,9,33
Krasnodar,2202,5,9,4,7,29,26,3,31
Terek Grozny,2202,6,8,5,7,22,24,-2,29
FK Rubin,2202,7,6,5,9,24,19,5,23
Din Moscow,2202,8,5,6,9,17,24,-7,21
Amkar,2202,9,5,5,10,12,24,-12,20
Rostov,2202,10,4,6,10,11,20,-9,18
Anzhi,2202,11,2,5,13,14,42,-28,11
Loko Moscow,2203,1,13,5,2,34,14,20,44
CSKA Moscow,2203,2,11,4,5,27,17,10,37
Terek Grozny,2203,3,9,5,6,25,24,1,32
Zenit,2203,4,7,9,4,23,16,7,30
Spart Moscow,2203,5,8,6,6,37,31,6,30
Krasnodar,2203,6,8,4,8,29,28,1,28
Din Moscow,2203,7,7,6,7,21,23,-2,27
FK Rubin,2203,8,6,5,9,24,20,4,23
Rostov,2203,9,4,7,9,13,20,-7,19
Amkar,2203,10,5,4,11,11,24,-13,19
Anzhi,2203,11,2,5,13,15,42,-27,11
Loko Moscow,2204,1,12,5,3,33,13,20,41
Spart Moscow,2204,2,11,5,4,39,25,14,38
CSKA Moscow,2204,3,11,3,6,31,22,9,36
Zenit,2204,4,8,8,4,23,18,5,32
Krasnodar,2204,5,9,4,7,29,26,3,31
Terek Grozny,2204,6,8,5,7,22,25,-3,29
FK Rubin,2204,7,6,6,8,25,19,6,24
Din Moscow,2204,8,5,7,8,19,26,-7,22
Amkar,2204,9,5,4,11,12,24,-12,19
Rostov,2204,10,4,6,10,10,18,-8,18
Anzhi,2204,11,2,5,13,17,44,-27,11
Loko Moscow,2205,1,12,6,2,31,12,19,42
CSKA Moscow,2205,2,11,4,5,27,18,9,37
Spart Moscow,2205,3,9,5,6,35,29,6,32
Krasnodar,2205,4,9,5,6,28,24,4,32
Terek Grozny,2205,5,8,6,6,24,25,-1,30
Zenit,2205,6,7,8,5,22,16,6,29
Din Moscow,2205,7,6,6,8,18,22,-4,24
Rostov,2205,8,5,6,9,12,17,-5,21
FK Rubin,2205,9,5,5,10,21,19,2,20
Amkar,2205,10,5,4,11,12,25,-13,19
Anzhi,2205,11,2,7,11,17,40,-23,13
Loko Moscow,2206,1,12,5,3,30,12,18,41
Krasnodar,2206,2,10,4,6,30,24,6,34
CSKA Moscow,2206,3,10,3,7,25,19,6,33
Zenit,2206,4,8,8,4,22,14,8,32
Spart Moscow,2206,5,8,5,7,33,31,2,29
Terek Grozny,2206,6,8,5,7,22,25,-3,29
Din Moscow,2206,7,6,6,8,18,22,-4,24
FK Rubin,2206,8,6,5,9,22,19,3,23
Rostov,2206,9,5,6,9,11,17,-6,21
Amkar,2206,10,5,4,11,14,24,-10,19
Anzhi,2206,11,4,5,11,17,37,-20,17
Loko Moscow,2207,1,12,5,3,30,14,16,41
CSKA Moscow,2207,2,12,3,5,31,21,10,39
Spart Moscow,2207,3,9,6,5,37,29,8,33
Zenit,2207,4,8,8,4,27,17,10,32
Krasnodar,2207,5,9,4,7,29,26,3,31
Terek Grozny,2207,6,7,6,7,20,24,-4,27
Din Moscow,2207,7,6,6,8,18,24,-6,24
Amkar,2207,8,6,4,10,14,22,-8,22
FK Rubin,2207,9,5,5,10,22,20,2,20
Rostov,2207,10,4,7,9,11,18,-7,19
Anzhi,2207,11,2,6,12,15,39,-24,12
Loko Moscow,2208,1,12,6,2,32,13,19,42
Spart Moscow,2208,2,11,5,4,47,27,20,38
CSKA Moscow,2208,3,11,3,6,28,19,9,36
Zenit,2208,4,8,8,4,23,14,9,32
Krasnodar,2208,5,9,5,6,31,26,5,32
Terek Grozny,2208,6,7,5,8,20,24,-4,26
Din Moscow,2208,7,6,6,8,19,30,-11,24
FK Rubin,2208,8,5,5,10,22,21,1,20
Amkar,2208,9,5,4,11,12,25,-13,19
Rostov,2208,10,4,6,10,10,20,-10,18
Anzhi,2208,11,3,5,12,15,40,-25,14
Loko Moscow,2209,1,12,5,3,33,14,19,41
CSKA Moscow,2209,2,11,3,6,27,21,6,36
Spart Moscow,2209,3,10,5,5,37,28,9,35
Krasnodar,2209,4,10,4,6,30,25,5,34
Zenit,2209,5,8,8,4,25,16,9,32
Terek Grozny,2209,6,8,5,7,21,23,-2,29
Din Moscow,2209,7,5,7,8,18,23,-5,22
FK Rubin,2209,8,5,6,9,21,18,3,21
Rostov,2209,9,5,6,9,12,18,-6,21
Amkar,2209,10,4,4,12,9,24,-15,16
Anzhi,2209,11,3,5,12,16,39,-23,14
Loko Moscow,2210,1,11,5,4,29,17,12,38
CSKA Moscow,2210,2,11,3,6,30,20,10,36
Zenit,2210,3,9,8,3,24,14,10,35
Spart Moscow,2210,4,9,5,6,39,30,9,32
Krasnodar,2210,5,9,4,7,32,27,5,31
Terek Grozny,2210,6,7,7,6,22,24,-2,28
Din Moscow,2210,7,6,6,8,20,26,-6,24
FK Rubin,2210,8,6,5,9,24,18,6,23
Rostov,2210,9,5,6,9,12,18,-6,21
Amkar,2210,10,5,5,10,11,23,-12,20
Anzhi,2210,11,2,6,12,16,42,-26,12
Loko Moscow,2211,1,11,6,3,32,18,14,39
CSKA Moscow,2211,2,10,4,6,27,23,4,34
Zenit,2211,3,8,9,3,28,16,12,33
Spart Moscow,2211,4,9,6,5,37,29,8,33
Terek Grozny,2211,5,9,5,6,26,24,2,32
Krasnodar,2211,6,9,4,7,34,29,5,31
FK Rubin,2211,7,7,5,8,27,19,8,26
Din Moscow,2211,8,6,6,8,20,25,-5,24
Rostov,2211,9,4,6,10,11,19,-8,18
Amkar,2211,10,4,5,11,11,27,-16,17
Anzhi,2211,11,2,6,12,15,39,-24,12
Loko Moscow,2212,1,12,5,3,32,15,17,41
CSKA Moscow,2212,2,11,3,6,30,20,10,36
Zenit,2212,3,9,8,3,27,16,11,35
Spart Moscow,2212,4,9,6,5,37,29,8,33
Krasnodar,2212,5,8,4,8,28,28,0,28
Terek Grozny,2212,6,7,6,7,21,24,-3,27
Din Moscow,2212,7,6,6,8,19,22,-3,24
FK Rubin,2212,8,6,5,9,23,19,4,23
Rostov,2212,9,5,6,9,12,18,-6,21
Amkar,2212,10,5,5,10,13,25,-12,20
Anzhi,2212,11,2,6,12,14,40,-26,12
Loko Moscow,2213,1,11,6,3,29,15,14,39
CSKA Moscow,2213,2,11,3,6,26,20,6,36
Zenit,2213,3,9,8,3,28,13,15,35
Spart Moscow,2213,4,10,5,5,37,27,10,35
Krasnodar,2213,5,8,6,6,28,25,3,30
Terek Grozny,2213,6,8,6,6,22,23,-1,30
Din Moscow,2213,7,6,6,8,19,24,-5,24
FK Rubin,2213,8,5,6,9,23,20,3,21
Amkar,2213,9,5,4,11,10,23,-13,19
Rostov,2213,10,4,6,10,11,19,-8,18
Anzhi,2213,11,2,6,12,15,39,-24,12
Loko Moscow,2214,1,12,5,3,32,14,18,41
CSKA Moscow,2214,2,12,3,5,30,18,12,39
Spart Moscow,2214,3,9,5,6,36,31,5,32
Krasnodar,2214,4,9,5,6,31,26,5,32
Zenit,2214,5,7,8,5,21,17,4,29
Terek Grozny,2214,6,8,5,7,23,25,-2,29
Din Moscow,2214,7,6,7,7,21,24,-3,25
FK Rubin,2214,8,5,7,8,24,20,4,22
Rostov,2214,9,5,6,9,14,17,-3,21
Amkar,2214,10,4,4,12,10,26,-16,16
Anzhi,2214,11,3,5,12,17,41,-24,14
Loko Moscow,2215,1,12,5,3,32,14,18,41
CSKA Moscow,2215,2,11,3,6,27,19,8,36
Krasnodar,2215,3,10,4,6,32,26,6,34
Spart Moscow,2215,4,8,8,4,38,30,8,32
Zenit,2215,5,8,8,4,23,15,8,32
Terek Grozny,2215,6,7,7,6,23,25,-2,28
Din Moscow,2215,7,6,7,7,23,26,-3,25
FK Rubin,2215,8,5,5,10,23,21,2,20
Rostov,2215,9,4,7,9,11,18,-7,19
Amkar,2215,10,4,6,10,12,25,-13,18
Anzhi,2215,11,2,6,12,14,39,-25,12
Loko Moscow,2216,1,13,5,2,32,11,21,44
CSKA Moscow,2216,2,10,3,7,26,20,6,33
Spart Moscow,2216,3,9,5,6,39,32,7,32
Zenit,2216,4,8,8,4,23,16,7,32
Krasnodar,2216,5,9,4,7,29,26,3,31
Terek Grozny,2216,6,8,5,7,25,24,1,29
Din Moscow,2216,7,6,6,8,19,23,-4,24
Amkar,2216,8,6,4,10,13,24,-11,22
Rostov,2216,9,5,6,9,14,19,-5,21
FK Rubin,2216,10,5,5,10,22,21,1,20
Anzhi,2216,11,3,5,12,16,42,-26,14
Loko Moscow,2217,1,12,5,3,31,14,17,41
CSKA Moscow,2217,2,12,3,5,28,17,11,39
Spart Moscow,2217,3,9,6,5,38,28,10,33
Krasnodar,2217,4,9,5,6,32,26,6,32
Zenit,2217,5,7,8,5,21,16,5,29
Terek Grozny,2217,6,7,5,8,20,27,-7,26
FK Rubin,2217,7,6,6,8,27,20,7,24
Rostov,2217,8,5,6,9,11,17,-6,21
Din Moscow,2217,9,5,6,9,18,28,-10,21
Amkar,2217,10,5,5,10,13,24,-11,20
Anzhi,2217,11,3,5,12,17,39,-22,14
Loko Moscow,2218,1,12,6,2,30,11,19,42
CSKA Moscow,2218,2,12,3,5,30,18,12,39
Spart Moscow,2218,3,9,6,5,35,27,8,33
Zenit,2218,4,7,9,4,21,15,6,30
Krasnodar,2218,5,8,4,8,27,27,0,28
Terek Grozny,2218,6,7,6,7,22,25,-3,27
FK Rubin,2218,7,7,5,8,24,17,7,26
Din Moscow,2218,8,5,7,8,17,22,-5,22
Amkar,2218,9,6,4,10,13,24,-11,22
Rostov,2218,10,4,6,10,10,18,-8,18
Anzhi,2218,11,2,6,12,16,41,-25,12
Loko Moscow,2219,1,12,5,3,30,12,18,41
CSKA Moscow,2219,2,10,4,6,28,22,6,34
Zenit,2219,3,8,8,4,23,14,9,32
Terek Grozny,2219,4,9,5,6,24,23,1,32
Spart Moscow,2219,5,8,7,5,36,31,5,31
Krasnodar,2219,6,9,4,7,28,25,3,31
FK Rubin,2219,7,7,5,8,24,18,6,26
Din Moscow,2219,8,5,7,8,19,24,-5,22
Rostov,2219,9,4,7,9,11,18,-7,19
Amkar,2219,10,5,4,11,13,24,-11,19
Anzhi,2219,11,2,6,12,18,43,-25,12
Loko Moscow,2220,1,11,5,4,29,14,15,38
Spart Moscow,2220,2,10,5,5,39,28,11,35
CSKA Moscow,2220,3,10,5,5,26,18,8,35
Zenit,2220,4,8,9,3,22,13,9,33
Krasnodar,2220,5,9,4,7,29,25,4,31
Terek Grozny,2220,6,8,6,6,22,23,-1,30
FK Rubin,2220,7,6,6,8,23,18,5,24
Din Moscow,2220,8,5,7,8,18,23,-5,22
Rostov,2220,9,5,6,9,13,18,-5,21
Amkar,2220,10,4,5,11,10,27,-17,17
Anzhi,2220,11,2,6,12,15,39,-24,12
Loko Moscow,2221,1,12,5,3,33,14,19,41
Spart Moscow,2221,2,11,5,4,38,27,11,38
CSKA Moscow,2221,3,11,3,6,27,21,6,36
Zenit,2221,4,9,8,3,27,15,12,35
Terek Grozny,2221,5,8,5,7,21,24,-3,29
Krasnodar,2221,6,8,4,8,28,29,-1,28
FK Rubin,2221,7,7,5,8,24,17,7,26
Din Moscow,2221,8,5,6,9,17,23,-6,21
Amkar,2221,9,5,4,11,12,24,-12,19
Rostov,2221,10,4,6,10,11,19,-8,18
Anzhi,2221,11,2,5,13,14,39,-25,11
Loko Moscow,2222,1,12,6,2,31,12,19,42
CSKA Moscow,2222,2,11,3,6,29,20,9,36
Zenit,2222,3,8,9,3,25,16,9,33
Spart Moscow,2222,4,9,6,5,39,32,7,33
Krasnodar,2222,5,8,5,7,27,25,2,29
Terek Grozny,2222,6,7,5,8,23,28,-5,26
FK Rubin,2222,7,6,6,8,23,18,5,24
Amkar,2222,8,6,4,10,16,25,-9,22
Din Moscow,2222,9,5,6,9,21,27,-6,21
Rostov,2222,10,4,7,9,10,17,-7,19
Anzhi,2222,11,3,5,12,17,41,-24,14
Loko Moscow,2223,1,11,6,3,31,14,17,39
CSKA Moscow,2223,2,10,4,6,26,20,6,34
Zenit,2223,3,8,9,3,24,15,9,33
Spart Moscow,2223,4,9,5,6,38,31,7,32
Krasnodar,2223,5,9,5,6,30,26,4,32
Terek Grozny,2223,6,8,5,7,23,24,-1,29
Din Moscow,2223,7,6,6,8,20,24,-4,24
Rostov,2223,8,5,6,9,12,18,-6,21
FK Rubin,2223,9,5,5,10,22,21,1,20
Amkar,2223,10,5,4,11,13,26,-13,19
Anzhi,2223,11,4,5,11,17,37,-20,17
Loko Moscow,2224,1,12,5,3,33,14,19,41
CSKA Moscow,2224,2,10,3,7,27,21,6,33
Zenit,2224,3,8,8,4,26,19,7,32
Krasnodar,2224,4,9,5,6,31,27,4,32
Spart Moscow,2224,5,8,7,5,35,28,7,31
Terek Grozny,2224,6,7,5,8,20,24,-4,26
Din Moscow,2224,7,5,8,7,19,23,-4,23
FK Rubin,2224,8,5,7,8,25,21,4,22
Rostov,2224,9,5,6,9,12,18,-6,21
Amkar,2224,10,5,5,10,10,22,-12,20
Anzhi,2224,11,4,5,11,16,37,-21,17
Loko Moscow,2225,1,11,7,2,31,13,18,40
CSKA Moscow,2225,2,11,4,5,29,19,10,37
Spart Moscow,2225,3,8,8,4,37,29,8,32
Zenit,2225,4,7,10,3,24,16,8,31
Krasnodar,2225,5,8,5,7,29,27,2,29
Terek Grozny,2225,6,8,5,7,23,24,-1,29
FK Rubin,2225,7,7,5,8,25,19,6,26
Din Moscow,2225,8,5,7,8,19,24,-5,22
Amkar,2225,9,5,5,10,11,23,-12,20
Rostov,2225,10,4,7,9,11,18,-7,19
Anzhi,2225,11,2,5,13,16,43,-27,11
Loko Moscow,2226,1,12,6,2,33,13,20,42
CSKA Moscow,2226,2,12,3,5,30,18,12,39
Krasnodar,2226,3,8,6,6,29,26,3,30
Zenit,2226,4,7,8,5,21,16,5,29
Spart Moscow,2226,5,8,5,7,35,31,4,29
Terek Grozny,2226,6,8,5,7,24,25,-1,29
FK Rubin,2226,7,6,6,8,23,18,5,24
Din Moscow,2226,8,6,6,8,20,24,-4,24
Amkar,2226,9,6,4,10,13,23,-10,22
Rostov,2226,10,5,6,9,12,17,-5,21
Anzhi,2226,11,2,5,13,16,45,-29,11
Loko Moscow,2227,1,12,5,3,35,17,18,41
Spart Moscow,2227,2,9,7,4,37,26,11,34
CSKA Moscow,2227,3,10,3,7,25,20,5,33
Zenit,2227,4,8,8,4,25,17,8,32
Krasnodar,2227,5,9,4,7,31,28,3,31
Terek Grozny,2227,6,7,5,8,21,28,-7,26
Din Moscow,2227,7,6,7,7,20,23,-3,25
FK Rubin,2227,8,6,5,9,24,19,5,23
Amkar,2227,9,5,5,10,12,22,-10,20
Rostov,2227,10,4,6,10,10,20,-10,18
Anzhi,2227,11,4,5,11,18,38,-20,17
Loko Moscow,2228,1,13,5,2,32,11,21,44
CSKA Moscow,2228,2,11,4,5,30,21,9,37
Spart Moscow,2228,3,10,5,5,37,28,9,35
Terek Grozny,2228,4,9,5,6,25,25,0,32
Zenit,2228,5,7,9,4,22,16,6,30
Krasnodar,2228,6,8,5,7,28,26,2,29
FK Rubin,2228,7,6,6,8,24,19,5,24
Din Moscow,2228,8,5,6,9,19,25,-6,21
Amkar,2228,9,5,4,11,10,23,-13,19
Rostov,2228,10,4,6,10,11,19,-8,18
Anzhi,2228,11,2,5,13,20,45,-25,11
Loko Moscow,2229,1,11,5,4,30,15,15,38
Spart Moscow,2229,2,10,6,4,39,27,12,36
Zenit,2229,3,9,8,3,24,13,11,35
CSKA Moscow,2229,4,10,4,6,27,21,6,34
Terek Grozny,2229,5,9,5,6,24,24,0,32
Krasnodar,2229,6,9,4,7,31,27,4,31
Din Moscow,2229,7,6,6,8,20,24,-4,24
FK Rubin,2229,8,6,5,9,24,21,3,23
Rostov,2229,9,4,6,10,11,20,-9,18
Amkar,2229,10,4,5,11,10,24,-14,17
Anzhi,2229,11,2,6,12,18,42,-24,12
Loko Moscow,2230,1,12,6,2,31,12,19,42
CSKA Moscow,2230,2,12,3,5,31,17,14,39
Spart Moscow,2230,3,10,5,5,38,26,12,35
Zenit,2230,4,7,9,4,21,17,4,30
Terek Grozny,2230,5,8,5,7,21,23,-2,29
Krasnodar,2230,6,8,4,8,29,28,1,28
FK Rubin,2230,7,7,5,8,25,18,7,26
Din Moscow,2230,8,5,6,9,17,27,-10,21
Amkar,2230,9,5,4,11,10,23,-13,19
Rostov,2230,10,4,6,10,10,18,-8,18
Anzhi,2230,11,3,5,12,15,39,-24,14
Loko Moscow,2231,1,12,6,2,35,15,20,42
CSKA Moscow,2231,2,12,3,5,29,17,12,39
Spart Moscow,2231,3,9,6,5,36,29,7,33
Terek Grozny,2231,4,8,6,6,22,23,-1,30
Zenit,2231,5,7,8,5,22,17,5,29
Krasnodar,2231,6,8,5,7,30,29,1,29
Din Moscow,2231,7,6,6,8,23,24,-1,24
FK Rubin,2231,8,6,5,9,25,23,2,23
Amkar,2231,9,5,5,10,12,23,-11,20
Rostov,2231,10,4,7,9,12,19,-7,19
Anzhi,2231,11,2,5,13,14,41,-27,11
Loko Moscow,2232,1,12,5,3,32,13,19,41
Zenit,2232,2,9,8,3,26,15,11,35
CSKA Moscow,2232,3,10,3,7,28,23,5,33
Spart Moscow,2232,4,9,5,6,36,29,7,32
Krasnodar,2232,5,9,4,7,30,28,2,31
Terek Grozny,2232,6,8,6,6,22,23,-1,30
FK Rubin,2232,7,6,5,9,25,20,5,23
Rostov,2232,8,5,6,9,12,17,-5,21
Din Moscow,2232,9,5,6,9,18,27,-9,21
Amkar,2232,10,5,5,10,11,22,-11,20
Anzhi,2232,11,3,5,12,17,40,-23,14
Loko Moscow,2233,1,11,6,3,30,14,16,39
CSKA Moscow,2233,2,11,3,6,26,19,7,36
Zenit,2233,3,9,8,3,25,13,12,35
Spart Moscow,2233,4,9,6,5,35,27,8,33
Krasnodar,2233,5,9,5,6,29,25,4,32
Terek Grozny,2233,6,8,6,6,24,25,-1,30
Din Moscow,2233,7,6,7,7,20,23,-3,25
FK Rubin,2233,8,5,6,9,22,19,3,21
Rostov,2233,9,4,6,10,10,18,-8,18
Amkar,2233,10,4,6,10,12,25,-13,18
Anzhi,2233,11,2,5,13,14,39,-25,11
Loko Moscow,2234,1,11,6,3,30,15,15,39
Spart Moscow,2234,2,10,5,5,36,26,10,35
CSKA Moscow,2234,3,10,4,6,25,18,7,34
Krasnodar,2234,4,9,5,6,31,25,6,32
Zenit,2234,5,7,10,3,21,13,8,31
Terek Grozny,2234,6,8,5,7,24,23,1,29
FK Rubin,2234,7,5,7,8,21,17,4,22
Din Moscow,2234,8,5,7,8,17,22,-5,22
Rostov,2234,9,5,6,9,11,17,-6,21
Amkar,2234,10,5,4,11,10,24,-14,19
Anzhi,2234,11,3,5,12,15,41,-26,14
Loko Moscow,2235,1,12,6,2,34,15,19,42
CSKA Moscow,2235,2,10,5,5,27,19,8,35
Spart Moscow,2235,3,9,7,4,34,25,9,34
Zenit,2235,4,7,9,4,24,17,7,30
Krasnodar,2235,5,8,5,7,30,30,0,29
Terek Grozny,2235,6,7,6,7,20,23,-3,27
Din Moscow,2235,7,6,7,7,19,21,-2,25
FK Rubin,2235,8,6,5,9,25,20,5,23
Rostov,2235,9,4,7,9,10,17,-7,19
Amkar,2235,10,4,5,11,9,23,-14,17
Anzhi,2235,11,3,6,11,16,38,-22,15
Loko Moscow,2236,1,12,6,2,30,11,19,42
CSKA Moscow,2236,2,11,3,6,30,20,10,36
Spart Moscow,2236,3,9,7,4,37,27,10,34
Zenit,2236,4,8,9,3,24,14,10,33
Krasnodar,2236,5,9,4,7,29,25,4,31
Terek Grozny,2236,6,7,6,7,21,26,-5,27
Din Moscow,2236,7,6,7,7,19,22,-3,25
FK Rubin,2236,8,5,5,10,21,20,1,20
Rostov,2236,9,4,7,9,11,18,-7,19
Amkar,2236,10,5,4,11,13,25,-12,19
Anzhi,2236,11,2,6,12,14,41,-27,12
Loko Moscow,2237,1,11,6,3,29,13,16,39
CSKA Moscow,2237,2,11,3,6,26,19,7,36
Zenit,2237,3,8,9,3,23,13,10,33
Spart Moscow,2237,4,9,6,5,35,28,7,33
Krasnodar,2237,5,9,4,7,29,26,3,31
Terek Grozny,2237,6,8,5,7,22,24,-2,29
FK Rubin,2237,7,6,6,8,25,19,6,24
Din Moscow,2237,8,5,7,8,20,25,-5,22
Rostov,2237,9,5,6,9,12,17,-5,21
Amkar,2237,10,5,5,10,11,23,-12,20
Anzhi,2237,11,2,5,13,14,39,-25,11
Loko Moscow,2238,1,12,6,2,31,12,19,42
Spart Moscow,2238,2,10,6,4,38,26,12,36
CSKA Moscow,2238,3,10,4,6,25,18,7,34
Zenit,2238,4,8,9,3,23,14,9,33
Krasnodar,2238,5,8,5,7,28,26,2,29
Terek Grozny,2238,6,7,5,8,22,27,-5,26
FK Rubin,2238,7,5,7,8,23,19,4,22
Din Moscow,2238,8,5,7,8,18,24,-6,22
Amkar,2238,9,5,5,10,13,24,-11,20
Rostov,2238,10,4,6,10,10,19,-9,18
Anzhi,2238,11,3,6,11,16,38,-22,15
Loko Moscow,2239,1,12,6,2,32,12,20,42
Spart Moscow,2239,2,11,5,4,45,29,16,38
CSKA Moscow,2239,3,11,3,6,29,18,11,36
Zenit,2239,4,8,9,3,22,13,9,33
Krasnodar,2239,5,9,4,7,31,27,4,31
Terek Grozny,2239,6,7,5,8,20,26,-6,26
Din Moscow,2239,7,5,7,8,19,27,-8,22
FK Rubin,2239,8,5,6,9,21,20,1,21
Amkar,2239,9,5,4,11,10,23,-13,19
Rostov,2239,10,4,6,10,12,22,-10,18
Anzhi,2239,11,3,5,12,17,41,-24,14
Loko Moscow,2240,1,11,6,3,30,13,17,39
Spart Moscow,2240,2,10,6,4,36,25,11,36
CSKA Moscow,2240,3,11,3,6,26,19,7,36
Krasnodar,2240,4,10,4,6,31,26,5,34
Zenit,2240,5,8,9,3,23,13,10,33
Terek Grozny,2240,6,8,6,6,24,24,0,30
Din Moscow,2240,7,6,7,7,18,21,-3,25
FK Rubin,2240,8,5,5,10,22,20,2,20
Rostov,2240,9,4,6,10,10,19,-9,18
Amkar,2240,10,4,4,12,9,25,-16,16
Anzhi,2240,11,2,6,12,16,40,-24,12
Loko Moscow,2241,1,13,5,2,34,11,23,44
CSKA Moscow,2241,2,11,4,5,27,18,9,37
Krasnodar,2241,3,9,4,7,29,29,0,31
Spart Moscow,2241,4,8,6,6,36,31,5,30
Zenit,2241,5,7,8,5,21,15,6,29
Terek Grozny,2241,6,7,6,7,23,26,-3,27
Din Moscow,2241,7,6,7,7,22,24,-2,25
Rostov,2241,8,5,6,9,11,17,-6,21
FK Rubin,2241,9,5,5,10,22,21,1,20
Amkar,2241,10,5,5,10,13,24,-11,20
Anzhi,2241,11,3,6,11,17,39,-22,15
Loko Moscow,2242,1,12,6,2,35,13,22,42
CSKA Moscow,2242,2,12,3,5,29,18,11,39
Spart Moscow,2242,3,11,5,4,41,27,14,38
Krasnodar,2242,4,9,5,6,29,25,4,32
Terek Grozny,2242,5,9,5,6,25,25,0,32
Zenit,2242,6,7,8,5,23,20,3,29
Din Moscow,2242,7,5,7,8,18,25,-7,22
FK Rubin,2242,8,5,6,9,22,19,3,21
Rostov,2242,9,4,6,10,11,19,-8,18
Amkar,2242,10,4,4,12,11,27,-16,16
Anzhi,2242,11,2,5,13,16,42,-26,11
Loko Moscow,2243,1,12,6,2,33,13,20,42
Spart Moscow,2243,2,10,6,4,39,28,11,36
CSKA Moscow,2243,3,11,3,6,29,18,11,36
Zenit,2243,4,8,8,4,23,16,7,32
Krasnodar,2243,5,9,5,6,30,26,4,32
Terek Grozny,2243,6,8,6,6,23,23,0,30
Din Moscow,2243,7,6,6,8,19,23,-4,24
FK Rubin,2243,8,5,5,10,22,21,1,20
Rostov,2243,9,4,6,10,11,19,-8,18
Amkar,2243,10,4,5,11,11,26,-15,17
Anzhi,2243,11,2,6,12,15,42,-27,12
Loko Moscow,2244,1,12,5,3,32,13,19,41
Spart Moscow,2244,2,10,6,4,40,28,12,36
CSKA Moscow,2244,3,11,3,6,29,18,11,36
Zenit,2244,4,9,8,3,24,14,10,35
Krasnodar,2244,5,8,4,8,27,27,0,28
Terek Grozny,2244,6,7,6,7,21,25,-4,27
Din Moscow,2244,7,6,7,7,20,23,-3,25
FK Rubin,2244,8,6,5,9,23,19,4,23
Rostov,2244,9,4,6,10,11,20,-9,18
Amkar,2244,10,4,5,11,10,25,-15,17
Anzhi,2244,11,3,5,12,17,42,-25,14
Loko Moscow,2245,1,12,6,2,33,13,20,42
CSKA Moscow,2245,2,11,4,5,27,17,10,37
Spart Moscow,2245,3,10,5,5,38,29,9,35
Zenit,2245,4,7,10,3,23,15,8,31
Krasnodar,2245,5,9,4,7,28,26,2,31
Terek Grozny,2245,6,7,7,6,24,26,-2,28
Din Moscow,2245,7,6,6,8,22,24,-2,24
FK Rubin,2245,8,6,5,9,23,19,4,23
Rostov,2245,9,4,6,10,10,20,-10,18
Amkar,2245,10,4,5,11,10,24,-14,17
Anzhi,2245,11,2,6,12,17,42,-25,12
Loko Moscow,2246,1,12,6,2,32,13,19,42
Spart Moscow,2246,2,11,5,4,40,29,11,38
CSKA Moscow,2246,3,11,4,5,26,17,9,37
Krasnodar,2246,4,9,5,6,29,25,4,32
Zenit,2246,5,7,9,4,22,15,7,30
Terek Grozny,2246,6,7,7,6,22,24,-2,28
FK Rubin,2246,7,6,5,9,22,18,4,23
Din Moscow,2246,8,5,6,9,19,25,-6,21
Rostov,2246,9,4,6,10,12,20,-8,18
Amkar,2246,10,4,5,11,9,23,-14,17
Anzhi,2246,11,2,6,12,16,40,-24,12
Loko Moscow,2247,1,11,7,2,30,12,18,40
CSKA Moscow,2247,2,12,3,5,32,18,14,39
Spart Moscow,2247,3,9,6,5,39,30,9,33
Krasnodar,2247,4,9,5,6,32,25,7,32
Zenit,2247,5,7,9,4,21,16,5,30
Terek Grozny,2247,6,7,6,7,22,26,-4,27
Din Moscow,2247,7,5,7,8,17,23,-6,22
FK Rubin,2247,8,5,6,9,21,21,0,21
Amkar,2247,9,5,5,10,14,26,-12,20
Rostov,2247,10,4,7,9,11,18,-7,19
Anzhi,2247,11,3,5,12,18,42,-24,14
Loko Moscow,2248,1,12,5,3,30,13,17,41
Spart Moscow,2248,2,11,5,4,44,27,17,38
CSKA Moscow,2248,3,11,3,6,28,20,8,36
Krasnodar,2248,4,10,4,6,32,24,8,34
Terek Grozny,2248,5,9,5,6,25,23,2,32
Zenit,2248,6,7,8,5,22,16,6,29
Din Moscow,2248,7,5,7,8,18,24,-6,22
FK Rubin,2248,8,5,6,9,22,21,1,21
Rostov,2248,9,4,6,10,12,22,-10,18
Amkar,2248,10,4,4,12,10,29,-19,16
Anzhi,2248,11,3,5,12,16,40,-24,14
Loko Moscow,2249,1,13,5,2,32,11,21,44
CSKA Moscow,2249,2,10,4,6,27,20,7,34
Zenit,2249,3,8,8,4,23,15,8,32
Spart Moscow,2249,4,9,5,6,37,32,5,32
Krasnodar,2249,5,8,4,8,27,28,-1,28
Terek Grozny,2249,6,7,6,7,23,28,-5,27
FK Rubin,2249,7,6,6,8,24,18,6,24
Amkar,2249,8,6,4,10,17,23,-6,22
Din Moscow,2249,9,5,7,8,19,26,-7,22
Rostov,2249,10,5,6,9,12,17,-5,21
Anzhi,2249,11,2,7,11,17,40,-23,13
Loko Moscow,2250,1,11,6,3,31,14,17,39
CSKA Moscow,2250,2,11,4,5,26,17,9,37
Spart Moscow,2250,3,10,6,4,37,26,11,36
Zenit,2250,4,8,9,3,22,13,9,33
Krasnodar,2250,5,9,5,6,31,27,4,32
Terek Grozny,2250,6,8,6,6,23,23,0,30
FK Rubin,2250,7,6,5,9,24,20,4,23
Din Moscow,2250,8,5,6,9,18,24,-6,21
Rostov,2250,9,4,7,9,11,18,-7,19
Amkar,2250,10,4,4,12,9,26,-17,16
Anzhi,2250,11,2,6,12,15,39,-24,12
Loko Moscow,2251,1,12,6,2,31,11,20,42
CSKA Moscow,2251,2,11,3,6,31,20,11,36
Spart Moscow,2251,3,9,6,5,35,27,8,33
Zenit,2251,4,8,8,4,23,16,7,32
Krasnodar,2251,5,8,5,7,27,26,1,29
Terek Grozny,2251,6,8,5,7,21,23,-2,29
Din Moscow,2251,7,7,6,7,19,21,-2,27
FK Rubin,2251,8,6,5,9,23,18,5,23
Rostov,2251,9,4,6,10,10,18,-8,18
Amkar,2251,10,4,5,11,10,24,-14,17
Anzhi,2251,11,3,5,12,16,42,-26,14
Loko Moscow,2252,1,12,5,3,31,14,17,41
CSKA Moscow,2252,2,11,4,5,28,18,10,37
Spart Moscow,2252,3,9,7,4,39,28,11,34
Krasnodar,2252,4,10,4,6,32,26,6,34
Zenit,2252,5,7,9,4,22,15,7,30
Terek Grozny,2252,6,8,5,7,22,24,-2,29
FK Rubin,2252,7,6,5,9,25,19,6,23
Din Moscow,2252,8,5,6,9,18,28,-10,21
Rostov,2252,9,4,7,9,11,18,-7,19
Amkar,2252,10,4,5,11,11,25,-14,17
Anzhi,2252,11,3,5,12,15,39,-24,14
Loko Moscow,2253,1,13,5,2,33,12,21,44
CSKA Moscow,2253,2,12,3,5,29,18,11,39
Spart Moscow,2253,3,9,6,5,37,28,9,33
Krasnodar,2253,4,9,4,7,29,26,3,31
Zenit,2253,5,7,8,5,22,16,6,29
Terek Grozny,2253,6,7,6,7,23,26,-3,27
FK Rubin,2253,7,6,5,9,24,20,4,23
Din Moscow,2253,8,5,7,8,19,25,-6,22
Rostov,2253,9,5,6,9,11,17,-6,21
Amkar,2253,10,4,5,11,12,27,-15,17
Anzhi,2253,11,3,5,12,17,41,-24,14
Loko Moscow,2254,1,12,6,2,31,12,19,42
CSKA Moscow,2254,2,11,4,5,26,17,9,37
Spart Moscow,2254,3,9,7,4,35,26,9,34
Zenit,2254,4,7,9,4,21,14,7,30
Krasnodar,2254,5,8,6,6,28,25,3,30
Terek Grozny,2254,6,8,5,7,24,23,1,29
Din Moscow,2254,7,6,7,7,20,23,-3,25
FK Rubin,2254,8,5,6,9,22,19,3,21
Rostov,2254,9,4,7,9,10,17,-7,19
Amkar,2254,10,5,4,11,10,23,-13,19
Anzhi,2254,11,2,5,13,14,42,-28,11
Loko Moscow,2255,1,13,5,2,37,12,25,44
CSKA Moscow,2255,2,12,3,5,32,17,15,39
Spart Moscow,2255,3,9,6,5,34,29,5,33
Zenit,2255,4,7,8,5,22,18,4,29
Krasnodar,2255,5,8,4,8,28,32,-4,28
Terek Grozny,2255,6,7,6,7,20,24,-4,27
FK Rubin,2255,7,7,5,8,28,19,9,26
Din Moscow,2255,8,5,7,8,18,25,-7,22
Amkar,2255,9,6,4,10,15,22,-7,22
Rostov,2255,10,4,6,10,10,18,-8,18
Anzhi,2255,11,2,6,12,14,42,-28,12
Loko Moscow,2256,1,11,5,4,30,16,14,38
CSKA Moscow,2256,2,11,4,5,28,18,10,37
Spart Moscow,2256,3,10,5,5,37,29,8,35
Krasnodar,2256,4,10,4,6,32,25,7,34
Zenit,2256,5,8,9,3,23,14,9,33
Terek Grozny,2256,6,8,5,7,24,24,0,29
Din Moscow,2256,7,5,7,8,21,26,-5,22
FK Rubin,2256,8,5,6,9,23,20,3,21
Rostov,2256,9,5,6,9,12,17,-5,21
Amkar,2256,10,4,4,12,10,27,-17,16
Anzhi,2256,11,3,5,12,15,39,-24,14
Loko Moscow,2257,1,13,5,2,34,12,22,44
Spart Moscow,2257,2,11,5,4,44,28,16,38
CSKA Moscow,2257,3,11,4,5,27,18,9,37
Krasnodar,2257,4,9,4,7,31,27,4,31
Zenit,2257,5,7,9,4,22,17,5,30
Terek Grozny,2257,6,8,5,7,23,25,-2,29
Din Moscow,2257,7,6,6,8,21,26,-5,24
FK Rubin,2257,8,5,5,10,23,23,0,20
Amkar,2257,9,5,4,11,12,25,-13,19
Rostov,2257,10,4,6,10,10,21,-11,18
Anzhi,2257,11,2,5,13,16,41,-25,11
Loko Moscow,2258,1,11,6,3,32,17,15,39
Spart Moscow,2258,2,10,6,4,38,27,11,36
CSKA Moscow,2258,3,11,3,6,28,19,9,36
Zenit,2258,4,9,8,3,27,14,13,35
Krasnodar,2258,5,9,5,6,30,26,4,32
Terek Grozny,2258,6,8,5,7,23,24,-1,29
FK Rubin,2258,7,6,5,9,22,18,4,23
Din Moscow,2258,8,5,6,9,17,23,-6,21
Rostov,2258,9,4,6,10,12,21,-9,18
Amkar,2258,10,4,5,11,9,24,-15,17
Anzhi,2258,11,3,5,12,16,41,-25,14
Loko Moscow,2259,1,13,5,2,31,11,20,44
Spart Moscow,2259,2,11,5,4,39,26,13,38
CSKA Moscow,2259,3,11,4,5,29,20,9,37
Terek Grozny,2259,4,8,6,6,23,22,1,30
Zenit,2259,5,7,8,5,22,16,6,29
Krasnodar,2259,6,8,5,7,27,25,2,29
Din Moscow,2259,7,6,6,8,21,25,-4,24
FK Rubin,2259,8,5,6,9,22,20,2,21
Rostov,2259,9,4,6,10,10,19,-9,18
Amkar,2259,10,4,5,11,9,23,-14,17
Anzhi,2259,11,2,6,12,16,42,-26,12
Loko Moscow,2260,1,11,6,3,32,15,17,39
CSKA Moscow,2260,2,11,4,5,29,17,12,37
Zenit,2260,3,8,9,3,24,15,9,33
Spart Moscow,2260,4,9,5,6,36,30,6,32
Krasnodar,2260,5,9,5,6,32,26,6,32
Terek Grozny,2260,6,8,6,6,23,23,0,30
Din Moscow,2260,7,5,7,8,17,22,-5,22
FK Rubin,2260,8,5,6,9,22,21,1,21
Rostov,2260,9,5,6,9,12,18,-6,21
Amkar,2260,10,5,5,10,12,23,-11,20
Anzhi,2260,11,2,5,13,15,44,-29,11
Loko Moscow,2261,1,12,5,3,31,13,18,41
CSKA Moscow,2261,2,12,3,5,28,18,10,39
Krasnodar,2261,3,10,4,6,31,25,6,34
Spart Moscow,2261,4,8,6,6,34,30,4,30
Zenit,2261,5,7,8,5,21,15,6,29
Terek Grozny,2261,6,7,5,8,20,24,-4,26
FK Rubin,2261,7,6,5,9,23,20,3,23
Din Moscow,2261,8,5,7,8,19,24,-5,22
Amkar,2261,9,6,4,10,11,22,-11,22
Rostov,2261,10,5,6,9,13,17,-4,21
Anzhi,2261,11,3,5,12,16,39,-23,14
Loko Moscow,2262,1,11,5,4,30,16,14,38
CSKA Moscow,2262,2,11,4,5,28,19,9,37
Spart Moscow,2262,3,10,5,5,38,28,10,35
Krasnodar,2262,4,10,4,6,34,26,8,34
Zenit,2262,5,8,8,4,25,15,10,32
Terek Grozny,2262,6,8,5,7,25,26,-1,29
FK Rubin,2262,7,6,5,9,25,24,1,23
Amkar,2262,8,6,4,10,12,23,-11,22
Din Moscow,2262,9,5,6,9,21,27,-6,21
Rostov,2262,10,4,6,10,10,19,-9,18
Anzhi,2262,11,2,6,12,17,42,-25,12
Loko Moscow,2263,1,13,5,2,34,12,22,44
CSKA Moscow,2263,2,11,3,6,27,19,8,36
Spart Moscow,2263,3,10,5,5,38,28,10,35
Zenit,2263,4,8,8,4,23,16,7,32
Krasnodar,2263,5,9,4,7,31,26,5,31
Terek Grozny,2263,6,7,6,7,21,24,-3,27
Din Moscow,2263,7,6,7,7,19,22,-3,25
FK Rubin,2263,8,5,6,9,21,20,1,21
Amkar,2263,9,5,4,11,10,23,-13,19
Rostov,2263,10,4,6,10,11,20,-9,18
Anzhi,2263,11,2,6,12,15,40,-25,12
Loko Moscow,2264,1,11,5,4,31,16,15,38
Zenit,2264,2,9,8,3,25,15,10,35
Spart Moscow,2264,3,9,6,5,37,28,9,33
CSKA Moscow,2264,4,10,3,7,26,21,5,33
Krasnodar,2264,5,9,5,6,31,26,5,32
Terek Grozny,2264,6,8,5,7,21,25,-4,29
Din Moscow,2264,7,6,7,7,20,23,-3,25
FK Rubin,2264,8,5,7,8,24,20,4,22
Rostov,2264,9,4,7,9,12,19,-7,19
Anzhi,2264,10,4,5,11,19,37,-18,17
Amkar,2264,11,4,4,12,9,25,-16,16
Loko Moscow,2265,1,11,7,2,32,14,18,40
CSKA Moscow,2265,2,11,4,5,29,19,10,37
Spart Moscow,2265,3,9,5,6,37,29,8,32
Krasnodar,2265,4,9,5,6,30,26,4,32
Zenit,2265,5,7,10,3,25,17,8,31
Terek Grozny,2265,6,8,5,7,22,23,-1,29
Din Moscow,2265,7,7,6,7,21,23,-2,27
Rostov,2265,8,5,6,9,12,18,-6,21
FK Rubin,2265,9,5,5,10,23,21,2,20
Amkar,2265,10,5,4,11,10,24,-14,19
Anzhi,2265,11,2,5,13,14,41,-27,11
Loko Moscow,2266,1,12,5,3,31,14,17,41
CSKA Moscow,2266,2,11,3,6,29,21,8,36
Zenit,2266,3,8,8,4,25,15,10,32
Krasnodar,2266,4,9,5,6,30,25,5,32
Spart Moscow,2266,5,8,6,6,36,32,4,30
Terek Grozny,2266,6,7,7,6,22,24,-2,28
Din Moscow,2266,7,6,7,7,19,22,-3,25
FK Rubin,2266,8,5,6,9,21,18,3,21
Rostov,2266,9,5,6,9,12,18,-6,21
Amkar,2266,10,5,5,10,13,23,-10,20
Anzhi,2266,11,2,6,12,16,42,-26,12
Loko Moscow,2267,1,13,5,2,36,12,24,44
CSKA Moscow,2267,2,12,3,5,29,17,12,39
Spart Moscow,2267,3,11,5,4,42,28,14,38
Terek Grozny,2267,4,8,6,6,21,22,-1,30
Zenit,2267,5,7,8,5,22,20,2,29
Krasnodar,2267,6,8,4,8,27,28,-1,28
FK Rubin,2267,7,7,5,8,25,17,8,26
Din Moscow,2267,8,5,6,9,18,26,-8,21
Rostov,2267,9,4,6,10,12,21,-9,18
Amkar,2267,10,4,5,11,9,24,-15,17
Anzhi,2267,11,2,5,13,14,40,-26,11
Loko Moscow,2268,1,12,6,2,31,12,19,42
CSKA Moscow,2268,2,11,3,6,30,19,11,36
Spart Moscow,2268,3,9,6,5,37,27,10,33
Zenit,2268,4,8,8,4,22,14,8,32
Krasnodar,2268,5,9,5,6,30,26,4,32
Terek Grozny,2268,6,7,5,8,22,26,-4,26
FK Rubin,2268,7,6,5,9,24,20,4,23
Din Moscow,2268,8,5,7,8,18,23,-5,22
Amkar,2268,9,6,4,10,12,23,-11,22
Rostov,2268,10,4,6,10,10,20,-10,18
Anzhi,2268,11,3,5,12,18,44,-26,14
Loko Moscow,2269,1,11,7,2,30,12,18,40
CSKA Moscow,2269,2,11,4,5,31,19,12,37
Spart Moscow,2269,3,9,6,5,37,27,10,33
Zenit,2269,4,7,10,3,23,15,8,31
Krasnodar,2269,5,8,5,7,27,26,1,29
Terek Grozny,2269,6,7,6,7,22,27,-5,27
Din Moscow,2269,7,6,7,7,18,21,-3,25
FK Rubin,2269,8,6,5,9,23,18,5,23
Amkar,2269,9,5,5,10,13,25,-12,20
Rostov,2269,10,4,6,10,10,20,-10,18
Anzhi,2269,11,3,5,12,18,42,-24,14
Loko Moscow,2270,1,11,6,3,29,13,16,39
CSKA Moscow,2270,2,11,4,5,30,18,12,37
Spart Moscow,2270,3,10,6,4,37,26,11,36
Zenit,2270,4,8,9,3,24,14,10,33
Krasnodar,2270,5,9,5,6,29,24,5,32
Terek Grozny,2270,6,8,6,6,22,22,0,30
Din Moscow,2270,7,5,8,7,18,22,-4,23
FK Rubin,2270,8,5,6,9,22,20,2,21
Rostov,2270,9,4,6,10,10,18,-8,18
Amkar,2270,10,4,5,11,10,25,-15,17
Anzhi,2270,11,2,5,13,14,43,-29,11
Loko Moscow,2271,1,11,7,2,33,15,18,40
Spart Moscow,2271,2,11,5,4,39,27,12,38
CSKA Moscow,2271,3,11,3,6,26,18,8,36
Zenit,2271,4,8,9,3,23,14,9,33
Krasnodar,2271,5,9,5,6,32,28,4,32
Terek Grozny,2271,6,8,5,7,23,24,-1,29
Din Moscow,2271,7,6,6,8,20,25,-5,24
FK Rubin,2271,8,5,5,10,23,21,2,20
Amkar,2271,9,5,4,11,12,25,-13,19
Rostov,2271,10,4,6,10,10,18,-8,18
Anzhi,2271,11,2,5,13,14,40,-26,11
Loko Moscow,2272,1,11,7,2,30,12,18,40
CSKA Moscow,2272,2,11,4,5,26,17,9,37
Zenit,2272,3,7,10,3,21,13,8,31
Terek Grozny,2272,4,8,6,6,21,22,-1,30
Spart Moscow,2272,5,8,5,7,35,33,2,29
Krasnodar,2272,6,8,5,7,28,26,2,29
FK Rubin,2272,7,7,5,8,24,17,7,26
Din Moscow,2272,8,6,6,8,21,24,-3,24
Rostov,2272,9,5,6,9,13,18,-5,21
Amkar,2272,10,5,5,10,10,22,-12,20
Anzhi,2272,11,2,5,13,14,39,-25,11
Loko Moscow,2273,1,12,5,3,32,14,18,41
Spart Moscow,2273,2,11,5,4,39,27,12,38
Zenit,2273,3,9,8,3,24,14,10,35
CSKA Moscow,2273,4,10,4,6,25,18,7,34
Krasnodar,2273,5,8,5,7,29,27,2,29
Terek Grozny,2273,6,7,6,7,22,25,-3,27
Din Moscow,2273,7,6,6,8,21,24,-3,24
FK Rubin,2273,8,5,6,9,22,20,2,21
Rostov,2273,9,4,6,10,10,19,-9,18
Amkar,2273,10,4,5,11,11,25,-14,17
Anzhi,2273,11,3,6,11,15,37,-22,15
Loko Moscow,2274,1,13,5,2,34,11,23,44
Spart Moscow,2274,2,10,6,4,39,26,13,36
CSKA Moscow,2274,3,11,3,6,31,21,10,36
Zenit,2274,4,8,8,4,24,16,8,32
Krasnodar,2274,5,8,4,8,27,29,-2,28
Terek Grozny,2274,6,7,6,7,20,24,-4,27
FK Rubin,2274,7,7,5,8,24,17,7,26
Din Moscow,2274,8,5,6,9,18,26,-8,21
Amkar,2274,9,5,5,10,11,22,-11,20
Rostov,2274,10,4,6,10,10,20,-10,18
Anzhi,2274,11,2,6,12,15,41,-26,12
Loko Moscow,2275,1,12,5,3,31,13,18,41
Spart Moscow,2275,2,11,5,4,40,29,11,38
CSKA Moscow,2275,3,10,4,6,26,19,7,34
Zenit,2275,4,8,8,4,22,14,8,32
Terek Grozny,2275,5,9,5,6,24,22,2,32
Krasnodar,2275,6,9,4,7,29,27,2,31
Din Moscow,2275,7,6,6,8,22,25,-3,24
FK Rubin,2275,8,6,5,9,23,19,4,23
Rostov,2275,9,4,6,10,11,19,-8,18
Amkar,2275,10,4,4,12,9,26,-17,16
Anzhi,2275,11,2,6,12,15,39,-24,12
Loko Moscow,2276,1,12,5,3,33,13,20,41
Spart Moscow,2276,2,10,5,5,37,27,10,35
CSKA Moscow,2276,3,10,5,5,25,17,8,35
Zenit,2276,4,8,9,3,22,13,9,33
Krasnodar,2276,5,8,5,7,29,29,0,29
Terek Grozny,2276,6,7,6,7,20,23,-3,27
FK Rubin,2276,7,6,6,8,25,19,6,24
Din Moscow,2276,8,6,6,8,20,25,-5,24
Rostov,2276,9,4,6,10,10,19,-9,18
Amkar,2276,10,4,5,11,9,23,-14,17
Anzhi,2276,11,3,6,11,15,37,-22,15
Loko Moscow,2277,1,11,5,4,32,18,14,38
Spart Moscow,2277,2,10,6,4,38,28,10,36
CSKA Moscow,2277,3,11,3,6,27,20,7,36
Zenit,2277,4,9,8,3,25,14,11,35
Krasnodar,2277,5,10,4,6,34,27,7,34
Terek Grozny,2277,6,8,6,6,22,22,0,30
Din Moscow,2277,7,6,6,8,21,24,-3,24
FK Rubin,2277,8,5,5,10,23,22,1,20
Rostov,2277,9,4,6,10,10,18,-8,18
Amkar,2277,10,4,6,10,11,24,-13,18
Anzhi,2277,11,2,5,13,15,41,-26,11
Loko Moscow,2278,1,11,6,3,32,15,17,39
Zenit,2278,2,9,8,3,26,14,12,35
Spart Moscow,2278,3,9,6,5,38,30,8,33
CSKA Moscow,2278,4,10,3,7,25,21,4,33
Krasnodar,2278,5,8,6,6,31,28,3,30
Terek Grozny,2278,6,8,5,7,23,25,-2,29
Din Moscow,2278,7,7,6,7,21,22,-1,27
FK Rubin,2278,8,5,6,9,23,21,2,21
Rostov,2278,9,4,6,10,12,20,-8,18
Amkar,2278,10,4,5,11,10,25,-15,17
Anzhi,2278,11,4,5,11,18,38,-20,17
Loko Moscow,2279,1,11,6,3,31,14,17,39
Spart Moscow,2279,2,11,5,4,41,26,15,38
CSKA Moscow,2279,3,11,3,6,29,19,10,36
Krasnodar,2279,4,10,4,6,31,25,6,34
Zenit,2279,5,8,9,3,24,15,9,33
Terek Grozny,2279,6,9,5,6,24,23,1,32
FK Rubin,2279,7,6,5,9,26,21,5,23
Din Moscow,2279,8,5,6,9,20,29,-9,21
Rostov,2279,9,4,6,10,10,21,-11,18
Amkar,2279,10,4,4,12,9,24,-15,16
Anzhi,2279,11,2,5,13,15,43,-28,11
Loko Moscow,2280,1,11,6,3,31,14,17,39
Spart Moscow,2280,2,10,6,4,41,30,11,36
CSKA Moscow,2280,3,11,3,6,30,20,10,36
Zenit,2280,4,9,8,3,25,15,10,35
Terek Grozny,2280,5,8,6,6,24,24,0,30
Krasnodar,2280,6,8,5,7,31,30,1,29
FK Rubin,2280,7,7,5,8,26,19,7,26
Din Moscow,2280,8,5,6,9,21,27,-6,21
Rostov,2280,9,4,6,10,10,19,-9,18
Amkar,2280,10,4,6,10,12,25,-13,18
Anzhi,2280,11,2,5,13,14,42,-28,11
Loko Moscow,2281,1,11,6,3,30,15,15,39
CSKA Moscow,2281,2,11,4,5,29,18,11,37
Krasnodar,2281,3,10,4,6,33,24,9,34
Spart Moscow,2281,4,9,6,5,37,27,10,33
Zenit,2281,5,7,10,3,23,15,8,31
Terek Grozny,2281,6,7,5,8,21,25,-4,26
Din Moscow,2281,7,6,6,8,20,25,-5,24
Rostov,2281,8,5,6,9,11,17,-6,21
FK Rubin,2281,9,5,5,10,22,23,-1,20
Amkar,2281,10,5,5,10,11,23,-12,20
Anzhi,2281,11,3,5,12,16,41,-25,14
Loko Moscow,2282,1,11,7,2,30,12,18,40
CSKA Moscow,2282,2,11,4,5,27,18,9,37
Spart Moscow,2282,3,9,5,6,36,28,8,32
Zenit,2282,4,7,10,3,23,15,8,31
Krasnodar,2282,5,8,6,6,28,25,3,30
Terek Grozny,2282,6,8,5,7,22,23,-1,29
FK Rubin,2282,7,6,6,8,23,18,5,24
Amkar,2282,8,6,4,10,12,22,-10,22
Rostov,2282,9,5,6,9,11,17,-6,21
Din Moscow,2282,10,5,6,9,17,25,-8,21
Anzhi,2282,11,2,5,13,14,40,-26,11
Loko Moscow,2283,1,11,7,2,31,13,18,40
CSKA Moscow,2283,2,11,3,6,30,19,11,36
Spart Moscow,2283,3,10,6,4,39,29,10,36
Zenit,2283,4,8,9,3,24,14,10,33
Krasnodar,2283,5,8,6,6,28,25,3,30
Terek Grozny,2283,6,8,5,7,22,24,-2,29
Din Moscow,2283,7,6,6,8,20,24,-4,24
FK Rubin,2283,8,5,6,9,22,19,3,21
Amkar,2283,9,5,5,10,12,23,-11,20
Rostov,2283,10,4,6,10,12,20,-8,18
Anzhi,2283,11,2,5,13,14,44,-30,11
Loko Moscow,2284,1,11,6,3,31,14,17,39
Zenit,2284,2,9,8,3,27,15,12,35
Spart Moscow,2284,3,9,6,5,37,30,7,33
CSKA Moscow,2284,4,10,3,7,27,23,4,33
Terek Grozny,2284,5,8,6,6,23,22,1,30
Krasnodar,2284,6,8,5,7,29,28,1,29
Din Moscow,2284,7,6,6,8,23,24,-1,24
FK Rubin,2284,8,6,5,9,24,22,2,23
Rostov,2284,9,5,6,9,12,17,-5,21
Amkar,2284,10,4,6,10,11,24,-13,18
Anzhi,2284,11,3,5,12,15,40,-25,14
Loko Moscow,2285,1,11,5,4,31,16,15,38
CSKA Moscow,2285,2,11,4,5,28,18,10,37
Spart Moscow,2285,3,10,5,5,38,30,8,35
Krasnodar,2285,4,10,4,6,34,27,7,34
Zenit,2285,5,8,9,3,22,13,9,33
Terek Grozny,2285,6,8,5,7,23,24,-1,29
Din Moscow,2285,7,5,7,8,21,26,-5,22
FK Rubin,2285,8,5,6,9,24,22,2,21
Rostov,2285,9,5,6,9,12,17,-5,21
Amkar,2285,10,4,4,12,10,26,-16,16
Anzhi,2285,11,3,5,12,17,41,-24,14
Loko Moscow,2286,1,13,5,2,34,13,21,44
Spart Moscow,2286,2,11,5,4,40,26,14,38
CSKA Moscow,2286,3,10,4,6,25,18,7,34
Zenit,2286,4,7,9,4,22,15,7,30
Terek Grozny,2286,5,8,6,6,22,23,-1,30
Krasnodar,2286,6,8,4,8,29,29,0,28
Din Moscow,2286,7,6,6,8,20,24,-4,24
FK Rubin,2286,8,6,5,9,24,20,4,23
Rostov,2286,9,4,6,10,10,20,-10,18
Amkar,2286,10,4,5,11,10,25,-15,17
Anzhi,2286,11,3,5,12,15,38,-23,14
Loko Moscow,2287,1,13,5,2,35,13,22,44
Spart Moscow,2287,2,10,6,4,38,25,13,36
CSKA Moscow,2287,3,10,4,6,26,19,7,34
Zenit,2287,4,8,8,4,23,17,6,32
Krasnodar,2287,5,9,4,7,31,27,4,31
Terek Grozny,2287,6,8,6,6,24,25,-1,30
FK Rubin,2287,7,6,5,9,26,20,6,23
Din Moscow,2287,8,5,6,9,18,30,-12,21
Rostov,2287,9,4,6,10,10,18,-8,18
Amkar,2287,10,4,5,11,9,23,-14,17
Anzhi,2287,11,2,7,11,17,40,-23,13
Loko Moscow,2288,1,13,5,2,33,11,22,44
CSKA Moscow,2288,2,12,3,5,32,19,13,39
Spart Moscow,2288,3,11,5,4,38,26,12,38
Krasnodar,2288,4,9,4,7,31,25,6,31
Zenit,2288,5,7,8,5,22,21,1,29
Terek Grozny,2288,6,7,6,7,21,24,-3,27
FK Rubin,2288,7,6,5,9,22,21,1,23
Din Moscow,2288,8,5,6,9,18,24,-6,21
Amkar,2288,9,5,4,11,10,24,-14,19
Rostov,2288,10,4,6,10,10,18,-8,18
Anzhi,2288,11,2,6,12,16,40,-24,12
Loko Moscow,2289,1,12,5,3,31,14,17,41
CSKA Moscow,2289,2,11,3,6,26,18,8,36
Krasnodar,2289,3,10,4,6,32,26,6,34
Spart Moscow,2289,4,9,6,5,36,28,8,33
Zenit,2289,5,8,8,4,23,15,8,32
Terek Grozny,2289,6,7,5,8,20,25,-5,26
Din Moscow,2289,7,6,7,7,20,22,-2,25
Amkar,2289,8,6,4,10,12,22,-10,22
FK Rubin,2289,9,5,5,10,23,22,1,20
Rostov,2289,10,4,6,10,11,19,-8,18
Anzhi,2289,11,3,5,12,15,38,-23,14
Loko Moscow,2290,1,12,6,2,33,13,20,42
CSKA Moscow,2290,2,11,4,5,27,17,10,37
Spart Moscow,2290,3,10,6,4,38,27,11,36
Zenit,2290,4,7,10,3,23,15,8,31
Terek Grozny,2290,5,8,5,7,24,24,0,29
Krasnodar,2290,6,8,4,8,27,27,0,28
Din Moscow,2290,7,6,6,8,18,23,-5,24
FK Rubin,2290,8,6,5,9,22,18,4,23
Amkar,2290,9,5,5,10,12,23,-11,20
Rostov,2290,10,4,6,10,11,19,-8,18
Anzhi,2290,11,2,5,13,14,43,-29,11
Loko Moscow,2291,1,12,5,3,33,14,19,41
Zenit,2291,2,9,8,3,26,15,11,35
CSKA Moscow,2291,3,10,3,7,27,24,3,33
Spart Moscow,2291,4,8,7,5,35,28,7,31
Terek Grozny,2291,5,8,5,7,22,24,-2,29
Krasnodar,2291,6,8,4,8,29,29,0,28
FK Rubin,2291,7,7,5,8,24,18,6,26
Din Moscow,2291,8,6,6,8,18,22,-4,24
Rostov,2291,9,4,7,9,12,19,-7,19
Amkar,2291,10,4,5,11,9,23,-14,17
Anzhi,2291,11,4,5,11,20,39,-19,17
Loko Moscow,2292,1,11,5,4,32,17,15,38
CSKA Moscow,2292,2,11,4,5,29,18,11,37
Spart Moscow,2292,3,10,5,5,38,26,12,35
Krasnodar,2292,4,10,4,6,32,26,6,34
Zenit,2292,5,8,9,3,24,15,9,33
Terek Grozny,2292,6,8,5,7,23,25,-2,29
Din Moscow,2292,7,6,6,8,18,24,-6,24
Rostov,2292,8,5,6,9,11,17,-6,21
FK Rubin,2292,9,5,5,10,22,20,2,20
Amkar,2292,10,4,4,12,10,26,-16,16
Anzhi,2292,11,3,5,12,17,42,-25,14
Loko Moscow,2293,1,12,5,3,33,16,17,41
CSKA Moscow,2293,2,11,3,6,28,19,9,36
Spart Moscow,2293,3,9,6,5,36,27,9,33
Zenit,2293,4,8,8,4,23,16,7,32
Krasnodar,2293,5,9,5,6,33,27,6,32
Terek Grozny,2293,6,7,5,8,21,26,-5,26
Din Moscow,2293,7,6,6,8,20,23,-3,24
FK Rubin,2293,8,5,6,9,23,22,1,21
Rostov,2293,9,5,6,9,11,17,-6,21
Amkar,2293,10,5,5,10,11,23,-12,20
Anzhi,2293,11,3,5,12,18,41,-23,14
Loko Moscow,2294,1,11,7,2,29,11,18,40
CSKA Moscow,2294,2,10,4,6,26,20,6,34
Spart Moscow,2294,3,9,5,6,37,30,7,32
Zenit,2294,4,7,10,3,21,13,8,31
Krasnodar,2294,5,8,6,6,28,25,3,30
Terek Grozny,2294,6,8,6,6,24,25,-1,30
Din Moscow,2294,7,6,7,7,20,23,-3,25
FK Rubin,2294,8,5,7,8,23,19,4,22
Amkar,2294,9,5,5,10,13,25,-12,20
Rostov,2294,10,4,6,10,10,18,-8,18
Anzhi,2294,11,3,5,12,19,41,-22,14
Loko Moscow,2295,1,13,5,2,33,11,22,44
Spart Moscow,2295,2,10,6,4,42,29,13,36
CSKA Moscow,2295,3,10,3,7,26,20,6,33
Zenit,2295,4,8,8,4,23,16,7,32
Terek Grozny,2295,5,8,6,6,23,24,-1,30
Krasnodar,2295,6,8,4,8,27,28,-1,28
FK Rubin,2295,7,6,6,8,24,18,6,24
Din Moscow,2295,8,5,7,8,19,26,-7,22
Rostov,2295,9,4,7,9,12,19,-7,19
Amkar,2295,10,4,4,12,10,26,-16,16
Anzhi,2295,11,3,6,11,17,39,-22,15
Loko Moscow,2296,1,11,7,2,30,12,18,40
CSKA Moscow,2296,2,11,3,6,27,19,8,36
Spart Moscow,2296,3,9,6,5,39,30,9,33
Zenit,2296,4,8,9,3,23,14,9,33
Krasnodar,2296,5,8,5,7,27,26,1,29
Terek Grozny,2296,6,7,5,8,21,27,-6,26
Din Moscow,2296,7,6,6,8,22,27,-5,24
FK Rubin,2296,8,6,5,9,24,19,5,23
Amkar,2296,9,6,4,10,13,23,-10,22
Rostov,2296,10,4,7,9,10,17,-7,19
Anzhi,2296,11,3,5,12,18,40,-22,14
Loko Moscow,2297,1,13,5,2,32,12,20,44
CSKA Moscow,2297,2,11,3,6,29,21,8,36
Spart Moscow,2297,3,10,5,5,36,26,10,35
Zenit,2297,4,8,8,4,25,15,10,32
Terek Grozny,2297,5,8,6,6,22,23,-1,30
Krasnodar,2297,6,8,4,8,29,28,1,28
Din Moscow,2297,7,6,6,8,18,23,-5,24
FK Rubin,2297,8,6,5,9,23,19,4,23
Amkar,2297,9,5,4,11,10,23,-13,19
Rostov,2297,10,4,6,10,10,18,-8,18
Anzhi,2297,11,2,6,12,15,41,-26,12
Loko Moscow,2298,1,12,6,2,31,11,20,42
Spart Moscow,2298,2,11,5,4,40,25,15,38
CSKA Moscow,2298,3,11,4,5,30,17,13,37
Terek Grozny,2298,4,9,5,6,23,23,0,32
Zenit,2298,5,7,10,3,21,13,8,31
Krasnodar,2298,6,9,4,7,30,28,2,31
Din Moscow,2298,7,6,6,8,19,24,-5,24
FK Rubin,2298,8,5,5,10,24,22,2,20
Rostov,2298,9,4,6,10,10,19,-9,18
Amkar,2298,10,4,4,12,9,26,-17,16
Anzhi,2298,11,2,5,13,15,44,-29,11
Loko Moscow,2299,1,11,5,4,30,15,15,38
CSKA Moscow,2299,2,11,3,6,29,19,10,36
Zenit,2299,3,9,8,3,24,14,10,35
Krasnodar,2299,4,10,4,6,30,24,6,34
Spart Moscow,2299,5,8,6,6,34,30,4,30
Terek Grozny,2299,6,8,5,7,22,24,-2,29
Din Moscow,2299,7,7,6,7,20,21,-1,27
FK Rubin,2299,8,5,5,10,21,19,2,20
Rostov,2299,9,4,7,9,10,17,-7,19
Amkar,2299,10,5,4,11,12,25,-13,19
Anzhi,2299,11,3,5,12,17,41,-24,14
Loko Moscow,2300,1,11,7,2,31,13,18,40
Spart Moscow,2300,2,11,5,4,43,25,18,38
CSKA Moscow,2300,3,11,3,6,28,21,7,36
Zenit,2300,4,8,9,3,24,14,10,33
Krasnodar,2300,5,9,5,6,30,26,4,32
Terek Grozny,2300,6,8,5,7,22,24,-2,29
Din Moscow,2300,7,6,6,8,24,25,-1,24
FK Rubin,2300,8,5,5,10,21,25,-4,20
Rostov,2300,9,4,6,10,10,21,-11,18
Amkar,2300,10,4,4,12,9,25,-16,16
Anzhi,2300,11,3,5,12,17,40,-23,14
Loko Moscow,2301,1,11,6,3,33,17,16,39
Spart Moscow,2301,2,10,6,4,38,26,12,36
Zenit,2301,3,9,8,3,25,14,11,35
CSKA Moscow,2301,4,10,3,7,26,20,6,33
Krasnodar,2301,5,9,5,6,32,27,5,32
Terek Grozny,2301,6,7,6,7,22,25,-3,27
Din Moscow,2301,7,6,7,7,19,22,-3,25
FK Rubin,2301,8,5,5,10,22,21,1,20
Rostov,2301,9,4,6,10,10,18,-8,18
Amkar,2301,10,4,5,11,11,27,-16,17
Anzhi,2301,11,4,5,11,18,39,-21,17
Loko Moscow,2302,1,12,5,3,31,13,18,41
Zenit,2302,2,9,8,3,24,14,10,35
CSKA Moscow,2302,3,10,4,6,26,19,7,34
Spart Moscow,2302,4,9,6,5,37,31,6,33
Terek Grozny,2302,5,8,5,7,23,27,-4,29
Krasnodar,2302,6,8,4,8,27,28,-1,28
FK Rubin,2302,7,6,6,8,26,19,7,24
Din Moscow,2302,8,5,8,7,21,25,-4,23
Amkar,2302,9,5,4,11,13,24,-11,19
Rostov,2302,10,4,6,10,11,19,-8,18
Anzhi,2302,11,3,6,11,19,39,-20,15
Loko Moscow,2303,1,13,5,2,34,13,21,44
Spart Moscow,2303,2,10,6,4,44,30,14,36
CSKA Moscow,2303,3,11,3,6,29,20,9,36
Zenit,2303,4,8,8,4,24,16,8,32
Krasnodar,2303,5,9,4,7,30,27,3,31
Terek Grozny,2303,6,8,5,7,22,23,-1,29
Din Moscow,2303,7,5,7,8,19,27,-8,22
FK Rubin,2303,8,5,6,9,22,19,3,21
Rostov,2303,9,4,7,9,12,19,-7,19
Amkar,2303,10,4,4,12,11,28,-17,16
Anzhi,2303,11,3,5,12,15,40,-25,14
Loko Moscow,2304,1,11,6,3,31,14,17,39
Spart Moscow,2304,2,11,5,4,40,25,15,38
CSKA Moscow,2304,3,11,3,6,28,21,7,36
Zenit,2304,4,8,9,3,26,15,11,33
Krasnodar,2304,5,9,4,7,30,28,2,31
Terek Grozny,2304,6,8,6,6,23,24,-1,30
FK Rubin,2304,7,7,5,8,26,18,8,26
Din Moscow,2304,8,5,6,9,17,25,-8,21
Rostov,2304,9,4,6,10,10,18,-8,18
Amkar,2304,10,4,4,12,10,28,-18,16
Anzhi,2304,11,2,6,12,15,40,-25,12
Loko Moscow,2305,1,11,5,4,30,14,16,38
Zenit,2305,2,9,8,3,24,14,10,35
Spart Moscow,2305,3,10,5,5,37,29,8,35
CSKA Moscow,2305,4,10,4,6,28,21,7,34
Krasnodar,2305,5,9,5,6,30,26,4,32
Terek Grozny,2305,6,8,6,6,23,24,-1,30
FK Rubin,2305,7,5,7,8,22,18,4,22
Din Moscow,2305,8,5,7,8,17,23,-6,22
Amkar,2305,9,5,5,10,13,23,-10,20
Rostov,2305,10,4,6,10,10,18,-8,18
Anzhi,2305,11,2,6,12,18,42,-24,12
Loko Moscow,2306,1,11,6,3,32,15,17,39
Spart Moscow,2306,2,10,6,4,37,27,10,36
CSKA Moscow,2306,3,11,3,6,28,19,9,36
Zenit,2306,4,9,8,3,24,14,10,35
Krasnodar,2306,5,8,5,7,29,27,2,29
Terek Grozny,2306,6,8,5,7,23,26,-3,29
Din Moscow,2306,7,6,6,8,19,23,-4,24
FK Rubin,2306,8,6,5,9,22,18,4,23
Amkar,2306,9,5,5,10,12,23,-11,20
Rostov,2306,10,4,6,10,10,18,-8,18
Anzhi,2306,11,2,5,13,17,43,-26,11
Loko Moscow,2307,1,11,6,3,29,14,15,39
CSKA Moscow,2307,2,11,4,5,28,19,9,37
Spart Moscow,2307,3,10,5,5,38,27,11,35
Krasnodar,2307,4,10,4,6,34,24,10,34
Zenit,2307,5,7,10,3,23,15,8,31
Terek Grozny,2307,6,8,6,6,24,24,0,30
Din Moscow,2307,7,5,7,8,17,24,-7,22
FK Rubin,2307,8,5,6,9,21,21,0,21
Rostov,2307,9,5,6,9,11,17,-6,21
Amkar,2307,10,4,5,11,11,25,-14,17
Anzhi,2307,11,2,5,13,15,41,-26,11
Loko Moscow,2308,1,12,6,2,31,12,19,42
CSKA Moscow,2308,2,11,4,5,27,17,10,37
Spart Moscow,2308,3,10,5,5,40,31,9,35
Zenit,2308,4,7,10,3,22,14,8,31
Krasnodar,2308,5,9,4,7,28,25,3,31
Terek Grozny,2308,6,7,6,7,21,25,-4,27
Din Moscow,2308,7,6,7,7,23,24,-1,25
FK Rubin,2308,8,5,6,9,22,19,3,21
Amkar,2308,9,5,4,11,12,24,-12,19
Rostov,2308,10,4,6,10,10,20,-10,18
Anzhi,2308,11,2,6,12,15,40,-25,12
Loko Moscow,2309,1,13,5,2,33,13,20,44
CSKA Moscow,2309,2,11,3,6,27,19,8,36
Spart Moscow,2309,3,10,5,5,39,28,11,35
Zenit,2309,4,8,8,4,23,15,8,32
Krasnodar,2309,5,9,4,7,30,27,3,31
Terek Grozny,2309,6,8,5,7,23,25,-2,29
Din Moscow,2309,7,6,6,8,20,25,-5,24
Amkar,2309,8,6,4,10,12,23,-11,22
FK Rubin,2309,9,5,5,10,22,20,2,20
Rostov,2309,10,4,6,10,10,19,-9,18
Anzhi,2309,11,2,5,13,16,41,-25,11
Loko Moscow,2310,1,13,5,2,33,11,22,44
CSKA Moscow,2310,2,12,3,5,27,17,10,39
Spart Moscow,2310,3,9,7,4,37,27,10,34
Zenit,2310,4,7,8,5,21,17,4,29
Krasnodar,2310,5,8,4,8,29,28,1,28
Terek Grozny,2310,6,7,6,7,21,24,-3,27
FK Rubin,2310,7,6,6,8,26,21,5,24
Din Moscow,2310,8,5,7,8,19,25,-6,22
Rostov,2310,9,4,7,9,11,18,-7,19
Amkar,2310,10,4,6,10,11,24,-13,18
Anzhi,2310,11,3,5,12,15,38,-23,14
Loko Moscow,2311,1,11,6,3,31,15,16,39
Spart Moscow,2311,2,10,6,4,40,26,14,36
CSKA Moscow,2311,3,11,3,6,27,19,8,36
Zenit,2311,4,9,8,3,25,14,11,35
Krasnodar,2311,5,9,5,6,33,27,6,32
Terek Grozny,2311,6,8,6,6,21,22,-1,30
FK Rubin,2311,7,6,5,9,24,21,3,23
Din Moscow,2311,8,5,6,9,17,27,-10,21
Rostov,2311,9,4,6,10,11,20,-9,18
Amkar,2311,10,4,5,11,9,23,-14,17
Anzhi,2311,11,2,6,12,14,38,-24,12
Loko Moscow,2312,1,12,5,3,33,14,19,41
CSKA Moscow,2312,2,11,3,6,28,19,9,36
Spart Moscow,2312,3,10,5,5,38,27,11,35
Krasnodar,2312,4,10,4,6,34,27,7,34
Zenit,2312,5,8,8,4,23,16,7,32
Terek Grozny,2312,6,8,5,7,22,27,-5,29
FK Rubin,2312,7,6,5,9,23,21,2,23
Din Moscow,2312,8,5,6,9,17,25,-8,21
Amkar,2312,9,5,4,11,11,24,-13,19
Rostov,2312,10,4,6,10,10,18,-8,18
Anzhi,2312,11,3,5,12,19,40,-21,14
Loko Moscow,2313,1,12,6,2,31,12,19,42
CSKA Moscow,2313,2,11,3,6,27,20,7,36
Spart Moscow,2313,3,10,5,5,36,27,9,35
Zenit,2313,4,8,8,4,23,14,9,32
Krasnodar,2313,5,8,6,6,30,27,3,30
Terek Grozny,2313,6,7,6,7,22,25,-3,27
Din Moscow,2313,7,6,6,8,18,22,-4,24
Amkar,2313,8,6,4,10,11,22,-11,22
FK Rubin,2313,9,5,6,9,23,20,3,21
Rostov,2313,10,4,6,10,11,19,-8,18
Anzhi,2313,11,2,6,12,17,41,-24,12
Loko Moscow,2314,1,11,5,4,31,16,15,38
Spart Moscow,2314,2,11,5,4,39,26,13,38
CSKA Moscow,2314,3,11,3,6,29,18,11,36
Zenit,2314,4,9,8,3,24,14,10,35
Krasnodar,2314,5,9,5,6,30,25,5,32
Terek Grozny,2314,6,8,6,6,22,23,-1,30
FK Rubin,2314,7,6,6,8,23,18,5,24
Din Moscow,2314,8,5,6,9,18,24,-6,21
Rostov,2314,9,4,6,10,10,19,-9,18
Amkar,2314,10,4,4,12,10,26,-16,16
Anzhi,2314,11,2,6,12,15,42,-27,12
Loko Moscow,2315,1,12,6,2,30,11,19,42
Spart Moscow,2315,2,10,5,5,40,26,14,35
CSKA Moscow,2315,3,10,4,6,27,21,6,34
Zenit,2315,4,8,8,4,24,15,9,32
Terek Grozny,2315,5,9,5,6,25,23,2,32
Krasnodar,2315,6,8,5,7,27,25,2,29
Din Moscow,2315,7,6,6,8,19,24,-5,24
FK Rubin,2315,8,6,5,9,22,19,3,23
Amkar,2315,9,5,4,11,11,24,-13,19
Rostov,2315,10,4,6,10,10,21,-11,18
Anzhi,2315,11,2,6,12,15,41,-26,12
Loko Moscow,2316,1,12,6,2,32,12,20,42
CSKA Moscow,2316,2,12,3,5,29,19,10,39
Spart Moscow,2316,3,9,5,6,35,32,3,32
Zenit,2316,4,7,9,4,22,15,7,30
Krasnodar,2316,5,8,5,7,28,27,1,29
Terek Grozny,2316,6,8,5,7,21,24,-3,29
FK Rubin,2316,7,6,6,8,23,18,5,24
Din Moscow,2316,8,6,6,8,21,22,-1,24
Amkar,2316,9,5,4,11,12,23,-11,19
Rostov,2316,10,4,6,10,10,19,-9,18
Anzhi,2316,11,3,5,12,18,40,-22,14
Loko Moscow,2317,1,11,6,3,29,13,16,39
CSKA Moscow,2317,2,11,3,6,27,19,8,36
Zenit,2317,3,9,8,3,24,13,11,35
Spart Moscow,2317,4,9,6,5,35,29,6,33
Krasnodar,2317,5,8,6,6,27,24,3,30
Terek Grozny,2317,6,7,7,6,21,23,-2,28
Din Moscow,2317,7,5,8,7,19,23,-4,23
FK Rubin,2317,8,5,7,8,22,18,4,22
Amkar,2317,9,5,5,10,13,23,-10,20
Rostov,2317,10,4,6,10,10,18,-8,18
Anzhi,2317,11,2,6,12,15,39,-24,12
Loko Moscow,2318,1,12,6,2,33,13,20,42
CSKA Moscow,2318,2,11,4,5,28,17,11,37
Krasnodar,2318,3,9,5,6,30,26,4,32
Zenit,2318,4,7,9,4,21,15,6,30
Spart Moscow,2318,5,8,6,6,36,33,3,30
Terek Grozny,2318,6,8,5,7,21,23,-2,29
Din Moscow,2318,7,5,8,7,18,22,-4,23
FK Rubin,2318,8,5,6,9,21,18,3,21
Rostov,2318,9,5,6,9,14,18,-4,21
Amkar,2318,10,5,4,11,12,24,-12,19
Anzhi,2318,11,3,5,12,15,40,-25,14
Loko Moscow,2319,1,12,5,3,33,15,18,41
CSKA Moscow,2319,2,11,4,5,29,17,12,37
Spart Moscow,2319,3,9,7,4,40,29,11,34
Krasnodar,2319,4,9,4,7,30,27,3,31
Zenit,2319,5,7,9,4,23,16,7,30
Terek Grozny,2319,6,8,5,7,22,24,-2,29
FK Rubin,2319,7,6,6,8,23,18,5,24
Din Moscow,2319,8,5,7,8,17,24,-7,22
Amkar,2319,9,5,5,10,11,23,-12,20
Rostov,2319,10,4,7,9,13,20,-7,19
Anzhi,2319,11,2,5,13,15,43,-28,11
Loko Moscow,2320,1,11,6,3,30,13,17,39
CSKA Moscow,2320,2,10,4,6,27,20,7,34
Zenit,2320,3,8,9,3,24,15,9,33
Spart Moscow,2320,4,9,6,5,36,29,7,33
Krasnodar,2320,5,9,5,6,28,24,4,32
Terek Grozny,2320,6,7,5,8,21,25,-4,26
FK Rubin,2320,7,6,6,8,24,18,6,24
Din Moscow,2320,8,5,7,8,18,24,-6,22
Amkar,2320,9,6,4,10,14,24,-10,22
Rostov,2320,10,4,6,10,11,19,-8,18
Anzhi,2320,11,3,6,11,16,38,-22,15
Loko Moscow,2321,1,13,5,2,36,15,21,44
CSKA Moscow,2321,2,10,5,5,29,21,8,35
Zenit,2321,3,7,9,4,25,18,7,30
Spart Moscow,2321,4,8,5,7,34,29,5,29
Krasnodar,2321,5,8,5,7,30,29,1,29
Din Moscow,2321,6,7,6,7,22,22,0,27
Terek Grozny,2321,7,7,5,8,21,25,-4,26
Amkar,2321,8,6,4,10,12,23,-11,22
FK Rubin,2321,9,5,6,9,22,21,1,21
Rostov,2321,10,5,6,9,11,17,-6,21
Anzhi,2321,11,3,6,11,17,39,-22,15
Loko Moscow,2322,1,12,6,2,33,12,21,42
CSKA Moscow,2322,2,11,4,5,28,19,9,37
Spart Moscow,2322,3,10,5,5,40,28,12,35
Zenit,2322,4,7,10,3,22,14,8,31
Terek Grozny,2322,5,8,6,6,24,24,0,30
Krasnodar,2322,6,8,4,8,29,30,-1,28
FK Rubin,2322,7,7,5,8,24,18,6,26
Din Moscow,2322,8,5,6,9,18,27,-9,21
Amkar,2322,9,5,4,11,10,24,-14,19
Rostov,2322,10,4,6,10,11,19,-8,18
Anzhi,2322,11,2,6,12,17,41,-24,12
Loko Moscow,2323,1,11,6,3,31,14,17,39
Zenit,2323,2,8,9,3,24,15,9,33
CSKA Moscow,2323,3,10,3,7,28,22,6,33
Spart Moscow,2323,4,8,8,4,36,28,8,32
Krasnodar,2323,5,9,5,6,31,27,4,32
Terek Grozny,2323,6,7,6,7,21,24,-3,27
Din Moscow,2323,7,6,7,7,21,24,-3,25
FK Rubin,2323,8,5,6,9,24,21,3,21
Amkar,2323,9,5,5,10,12,24,-12,20
Rostov,2323,10,4,7,9,10,17,-7,19
Anzhi,2323,11,3,6,11,17,39,-22,15
Loko Moscow,2324,1,11,6,3,32,16,16,39
CSKA Moscow,2324,2,12,3,5,31,18,13,39
Zenit,2324,3,8,8,4,24,16,8,32
Spart Moscow,2324,4,9,5,6,38,31,7,32
Krasnodar,2324,5,9,5,6,32,26,6,32
Terek Grozny,2324,6,7,5,8,20,24,-4,26
Din Moscow,2324,7,6,7,7,20,23,-3,25
FK Rubin,2324,8,5,6,9,22,21,1,21
Rostov,2324,9,5,6,9,13,19,-6,21
Amkar,2324,10,5,4,11,11,24,-13,19
Anzhi,2324,11,3,5,12,16,41,-25,14
Loko Moscow,2325,1,13,5,2,34,11,23,44
CSKA Moscow,2325,2,11,4,5,30,19,11,37
Spart Moscow,2325,3,8,6,6,34,29,5,30
Zenit,2325,4,7,9,4,22,18,4,30
Krasnodar,2325,5,8,5,7,28,26,2,29
Terek Grozny,2325,6,7,6,7,20,24,-4,27
Din Moscow,2325,7,6,7,7,20,22,-2,25
FK Rubin,2325,8,5,6,9,22,20,2,21
Rostov,2325,9,5,6,9,11,17,-6,21
Amkar,2325,10,5,5,10,11,22,-11,20
Anzhi,2325,11,3,5,12,17,41,-24,14
Loko Moscow,2326,1,13,5,2,31,11,20,44
CSKA Moscow,2326,2,11,4,5,28,17,11,37
Spart Moscow,2326,3,9,7,4,35,26,9,34
Zenit,2326,4,7,9,4,21,14,7,30
Krasnodar,2326,5,8,5,7,29,27,2,29
Terek Grozny,2326,6,8,5,7,22,24,-2,29
Din Moscow,2326,7,5,8,7,19,23,-4,23
FK Rubin,2326,8,5,7,8,25,21,4,22
Rostov,2326,9,4,6,10,11,19,-8,18
Amkar,2326,10,4,5,11,9,23,-14,17
Anzhi,2326,11,3,5,12,16,41,-25,14
Loko Moscow,2327,1,11,7,2,32,14,18,40
CSKA Moscow,2327,2,11,3,6,29,19,10,36
Spart Moscow,2327,3,9,6,5,38,29,9,33
Zenit,2327,4,8,9,3,24,15,9,33
Krasnodar,2327,5,8,5,7,29,27,2,29
Terek Grozny,2327,6,8,5,7,21,25,-4,29
Din Moscow,2327,7,6,7,7,20,23,-3,25
FK Rubin,2327,8,6,5,9,22,18,4,23
Amkar,2327,9,5,4,11,11,24,-13,19
Rostov,2327,10,4,6,10,10,19,-9,18
Anzhi,2327,11,3,5,12,17,40,-23,14
Loko Moscow,2328,1,12,6,2,31,12,19,42
CSKA Moscow,2328,2,11,4,5,28,18,10,37
Spart Moscow,2328,3,9,6,5,38,28,10,33
Zenit,2328,4,7,10,3,22,14,8,31
Krasnodar,2328,5,9,4,7,29,26,3,31
Terek Grozny,2328,6,8,6,6,25,25,0,30
Din Moscow,2328,7,7,6,7,21,22,-1,27
FK Rubin,2328,8,5,5,10,23,21,2,20
Rostov,2328,9,4,6,10,11,22,-11,18
Amkar,2328,10,4,5,11,9,24,-15,17
Anzhi,2328,11,2,6,12,18,43,-25,12
Loko Moscow,2329,1,11,6,3,30,13,17,39
CSKA Moscow,2329,2,11,3,6,27,19,8,36
Zenit,2329,3,9,8,3,25,14,11,35
Spart Moscow,2329,4,9,6,5,36,27,9,33
Krasnodar,2329,5,8,6,6,28,25,3,30
Terek Grozny,2329,6,7,6,7,22,25,-3,27
FK Rubin,2329,7,5,7,8,22,18,4,22
Din Moscow,2329,8,5,7,8,17,24,-7,22
Amkar,2329,9,6,4,10,13,23,-10,22
Rostov,2329,10,4,7,9,10,17,-7,19
Anzhi,2329,11,2,6,12,15,40,-25,12
Loko Moscow,2330,1,13,5,2,35,11,24,44
CSKA Moscow,2330,2,12,3,5,29,19,10,39
Spart Moscow,2330,3,8,7,5,33,26,7,31
Krasnodar,2330,4,9,4,7,29,27,2,31
Terek Grozny,2330,5,8,6,6,22,22,0,30
Zenit,2330,6,7,8,5,22,18,4,29
Din Moscow,2330,7,6,7,7,19,22,-3,25
FK Rubin,2330,8,5,5,10,22,21,1,20
Rostov,2330,9,4,7,9,10,17,-7,19
Amkar,2330,10,5,4,11,10,24,-14,19
Anzhi,2330,11,2,6,12,15,39,-24,12
Loko Moscow,2331,1,12,6,2,33,13,20,42
Spart Moscow,2331,2,10,6,4,38,27,11,36
CSKA Moscow,2331,3,11,3,6,27,19,8,36
Zenit,2331,4,8,8,4,23,16,7,32
Krasnodar,2331,5,8,5,7,28,26,2,29
Terek Grozny,2331,6,8,5,7,21,23,-2,29
FK Rubin,2331,7,7,5,8,24,18,6,26
Din Moscow,2331,8,5,6,9,19,26,-7,21
Rostov,2331,9,4,6,10,10,18,-8,18
Amkar,2331,10,4,5,11,10,24,-14,17
Anzhi,2331,11,3,5,12,16,39,-23,14
Loko Moscow,2332,1,11,7,2,30,12,18,40
CSKA Moscow,2332,2,12,3,5,29,18,11,39
Spart Moscow,2332,3,11,5,4,40,26,14,38
Krasnodar,2332,4,9,5,6,31,25,6,32
Zenit,2332,5,7,9,4,22,16,6,30
Terek Grozny,2332,6,8,5,7,23,25,-2,29
Din Moscow,2332,7,5,7,8,18,23,-5,22
FK Rubin,2332,8,5,6,9,22,21,1,21
Rostov,2332,9,4,6,10,10,21,-11,18
Amkar,2332,10,4,4,12,10,25,-15,16
Anzhi,2332,11,3,5,12,17,40,-23,14
Loko Moscow,2333,1,11,6,3,31,15,16,39
CSKA Moscow,2333,2,11,4,5,27,17,10,37
Krasnodar,2333,3,10,4,6,35,28,7,34
Spart Moscow,2333,4,9,5,6,36,29,7,32
Zenit,2333,5,7,10,3,21,13,8,31
Terek Grozny,2333,6,8,6,6,24,25,-1,30
Din Moscow,2333,7,7,6,7,20,22,-2,27
FK Rubin,2333,8,5,5,10,23,22,1,20
Amkar,2333,9,5,4,11,12,25,-13,19
Rostov,2333,10,4,6,10,11,19,-8,18
Anzhi,2333,11,2,6,12,15,40,-25,12
Loko Moscow,2334,1,12,5,3,30,12,18,41
CSKA Moscow,2334,2,11,3,6,29,22,7,36
Zenit,2334,3,9,8,3,27,14,13,35
Spart Moscow,2334,4,10,5,5,39,29,10,35
Krasnodar,2334,5,9,4,7,29,25,4,31
Din Moscow,2334,6,7,6,7,20,21,-1,27
Terek Grozny,2334,7,7,6,7,23,26,-3,27
FK Rubin,2334,8,5,5,10,21,20,1,20
Rostov,2334,9,4,6,10,12,21,-9,18
Amkar,2334,10,4,5,11,10,25,-15,17
Anzhi,2334,11,3,5,12,17,42,-25,14
Loko Moscow,2335,1,12,6,2,32,12,20,42
CSKA Moscow,2335,2,12,3,5,32,19,13,39
Spart Moscow,2335,3,11,5,4,39,27,12,38
Krasnodar,2335,4,9,5,6,31,26,5,32
Zenit,2335,5,7,8,5,21,16,5,29
Terek Grozny,2335,6,7,6,7,22,27,-5,27
FK Rubin,2335,7,6,5,9,23,20,3,23
Din Moscow,2335,8,5,6,9,18,24,-6,21
Rostov,2335,9,4,6,10,10,19,-9,18
Amkar,2335,10,4,5,11,12,26,-14,17
Anzhi,2335,11,3,5,12,19,43,-24,14
Loko Moscow,2336,1,11,6,3,30,16,14,39
CSKA Moscow,2336,2,11,3,6,27,19,8,36
Zenit,2336,3,9,8,3,27,13,14,35
Spart Moscow,2336,4,10,5,5,37,28,9,35
Krasnodar,2336,5,8,5,7,28,27,1,29
Terek Grozny,2336,6,7,6,7,21,24,-3,27
Din Moscow,2336,7,6,6,8,18,22,-4,24
FK Rubin,2336,8,6,5,9,23,18,5,23
Amkar,2336,9,5,5,10,11,23,-12,20
Rostov,2336,10,4,6,10,11,19,-8,18
Anzhi,2336,11,3,5,12,16,40,-24,14
Loko Moscow,2337,1,11,6,3,30,13,17,39
CSKA Moscow,2337,2,11,3,6,28,19,9,36
Zenit,2337,3,9,8,3,23,13,10,35
Spart Moscow,2337,4,8,8,4,35,27,8,32
Krasnodar,2337,5,8,5,7,29,27,2,29
Terek Grozny,2337,6,7,6,7,21,24,-3,27
FK Rubin,2337,7,7,5,8,25,18,7,26
Din Moscow,2337,8,5,7,8,17,23,-6,22
Amkar,2337,9,5,5,10,11,23,-12,20
Rostov,2337,10,4,7,9,11,18,-7,19
Anzhi,2337,11,2,6,12,16,41,-25,12
Loko Moscow,2338,1,12,6,2,31,12,19,42
Spart Moscow,2338,2,10,6,4,36,26,10,36
CSKA Moscow,2338,3,10,4,6,26,19,7,34
Krasnodar,2338,4,9,5,6,33,27,6,32
Zenit,2338,5,7,9,4,21,14,7,30
Terek Grozny,2338,6,8,6,6,22,23,-1,30
Din Moscow,2338,7,6,6,8,18,22,-4,24
FK Rubin,2338,8,5,5,10,23,23,0,20
Rostov,2338,9,4,7,9,11,18,-7,19
Amkar,2338,10,4,5,11,10,24,-14,17
Anzhi,2338,11,3,5,12,16,39,-23,14
Loko Moscow,2339,1,12,6,2,31,12,19,42
CSKA Moscow,2339,2,12,3,5,31,17,14,39
Spart Moscow,2339,3,10,5,5,40,29,11,35
Krasnodar,2339,4,8,6,6,29,26,3,30
Zenit,2339,5,7,8,5,21,17,4,29
Terek Grozny,2339,6,7,6,7,24,27,-3,27
FK Rubin,2339,7,5,7,8,24,20,4,22
Din Moscow,2339,8,5,7,8,19,24,-5,22
Amkar,2339,9,6,4,10,14,25,-11,22
Rostov,2339,10,4,6,10,12,22,-10,18
Anzhi,2339,11,2,6,12,16,42,-26,12
Loko Moscow,2340,1,12,6,2,30,11,19,42
CSKA Moscow,2340,2,11,4,5,28,17,11,37
Spart Moscow,2340,3,9,7,4,36,27,9,34
Krasnodar,2340,4,9,5,6,29,25,4,32
Terek Grozny,2340,5,9,5,6,25,22,3,32
Zenit,2340,6,7,9,4,21,14,7,30
Din Moscow,2340,7,5,8,7,17,21,-4,23
FK Rubin,2340,8,5,6,9,22,19,3,21
Rostov,2340,9,4,7,9,11,18,-7,19
Amkar,2340,10,4,4,12,10,26,-16,16
Anzhi,2340,11,2,5,13,14,43,-29,11
Loko Moscow,2341,1,12,5,3,30,13,17,41
CSKA Moscow,2341,2,11,4,5,28,19,9,37
Spart Moscow,2341,3,10,5,5,42,31,11,35
Krasnodar,2341,4,10,4,6,32,26,6,34
Zenit,2341,5,7,8,5,21,15,6,29
Terek Grozny,2341,6,7,6,7,21,25,-4,27
FK Rubin,2341,7,6,5,9,25,21,4,23
Rostov,2341,8,5,6,9,14,20,-6,21
Din Moscow,2341,9,5,6,9,19,27,-8,21
Amkar,2341,10,4,5,11,10,24,-14,17
Anzhi,2341,11,3,6,11,19,40,-21,15
Loko Moscow,2342,1,11,5,4,29,14,15,38
Zenit,2342,2,9,8,3,24,13,11,35
CSKA Moscow,2342,3,10,4,6,25,19,6,34
Spart Moscow,2342,4,8,7,5,35,29,6,31
Krasnodar,2342,5,9,4,7,30,26,4,31
Terek Grozny,2342,6,8,5,7,24,26,-2,29
FK Rubin,2342,7,7,5,8,25,19,6,26
Din Moscow,2342,8,5,7,8,19,24,-5,22
Rostov,2342,9,4,7,9,10,17,-7,19
Amkar,2342,10,5,4,11,13,25,-12,19
Anzhi,2342,11,3,6,11,17,39,-22,15
Loko Moscow,2343,1,13,5,2,31,11,20,44
CSKA Moscow,2343,2,11,3,6,26,19,7,36
Spart Moscow,2343,3,9,6,5,35,28,7,33
Zenit,2343,4,8,8,4,23,14,9,32
Krasnodar,2343,5,9,4,7,29,26,3,31
Terek Grozny,2343,6,7,5,8,20,26,-6,26
FK Rubin,2343,7,6,5,9,23,19,4,23
Din Moscow,2343,8,5,7,8,18,23,-5,22
Rostov,2343,9,5,6,9,12,17,-5,21
Amkar,2343,10,5,4,11,11,23,-12,19
Anzhi,2343,11,3,5,12,16,38,-22,14
Loko Moscow,2344,1,11,6,3,31,14,17,39
Spart Moscow,2344,2,10,6,4,40,28,12,36
CSKA Moscow,2344,3,11,3,6,30,20,10,36
Zenit,2344,4,8,9,3,25,16,9,33
Krasnodar,2344,5,9,5,6,30,26,4,32
Terek Grozny,2344,6,8,6,6,22,23,-1,30
FK Rubin,2344,7,5,7,8,25,21,4,22
Din Moscow,2344,8,5,7,8,21,26,-5,22
Rostov,2344,9,4,7,9,11,18,-7,19
Amkar,2344,10,4,5,11,11,27,-16,17
Anzhi,2344,11,2,5,13,14,41,-27,11
Loko Moscow,2345,1,12,6,2,34,15,19,42
CSKA Moscow,2345,2,11,4,5,26,17,9,37
Spart Moscow,2345,3,9,6,5,38,30,8,33
Krasnodar,2345,4,9,5,6,30,25,5,32
Zenit,2345,5,7,8,5,24,18,6,29
Terek Grozny,2345,6,8,5,7,23,25,-2,29
Din Moscow,2345,7,6,6,8,20,24,-4,24
FK Rubin,2345,8,6,5,9,23,20,3,23
Rostov,2345,9,4,7,9,10,17,-7,19
Amkar,2345,10,5,4,11,13,26,-13,19
Anzhi,2345,11,2,6,12,16,40,-24,12
Loko Moscow,2346,1,12,6,2,32,12,20,42
Spart Moscow,2346,2,10,6,4,36,25,11,36
CSKA Moscow,2346,3,11,3,6,26,19,7,36
Zenit,2346,4,8,8,4,23,15,8,32
Krasnodar,2346,5,9,5,6,32,25,7,32
Terek Grozny,2346,6,7,6,7,21,24,-3,27
Din Moscow,2346,7,5,7,8,19,25,-6,22
FK Rubin,2346,8,5,6,9,23,23,0,21
Rostov,2346,9,4,6,10,10,18,-8,18
Amkar,2346,10,4,6,10,10,23,-13,18
Anzhi,2346,11,3,5,12,15,38,-23,14
Loko Moscow,2347,1,12,6,2,31,12,19,42
CSKA Moscow,2347,2,11,3,6,26,18,8,36
Spart Moscow,2347,3,9,6,5,40,31,9,33
Zenit,2347,4,8,8,4,22,14,8,32
Krasnodar,2347,5,8,6,6,30,27,3,30
Terek Grozny,2347,6,7,5,8,20,25,-5,26
Din Moscow,2347,7,6,7,7,22,25,-3,25
FK Rubin,2347,8,5,7,8,24,20,4,22
Amkar,2347,9,5,5,10,12,23,-11,20
Rostov,2347,10,4,6,10,11,20,-9,18
Anzhi,2347,11,3,5,12,15,38,-23,14
Loko Moscow,2348,1,12,6,2,32,11,21,42
CSKA Moscow,2348,2,10,4,6,25,18,7,34
Zenit,2348,3,8,8,4,22,16,6,32
Krasnodar,2348,4,9,5,6,30,25,5,32
Spart Moscow,2348,5,8,7,5,39,33,6,31
Terek Grozny,2348,6,8,5,7,22,24,-2,29
Din Moscow,2348,7,6,7,7,22,25,-3,25
FK Rubin,2348,8,5,5,10,23,22,1,20
Rostov,2348,9,4,7,9,11,18,-7,19
Amkar,2348,10,5,4,11,13,25,-12,19
Anzhi,2348,11,3,6,11,16,38,-22,15
Loko Moscow,2349,1,13,5,2,31,11,20,44
Spart Moscow,2349,2,11,5,4,41,27,14,38
CSKA Moscow,2349,3,11,3,6,28,19,9,36
Zenit,2349,4,8,8,4,23,14,9,32
Krasnodar,2349,5,9,4,7,29,26,3,31
Terek Grozny,2349,6,8,6,6,25,23,2,30
Din Moscow,2349,7,6,6,8,21,26,-5,24
FK Rubin,2349,8,5,5,10,23,23,0,20
Rostov,2349,9,4,6,10,11,19,-8,18
Amkar,2349,10,4,4,12,11,29,-18,16
Anzhi,2349,11,2,6,12,14,40,-26,12
Loko Moscow,2350,1,13,5,2,34,11,23,44
CSKA Moscow,2350,2,10,4,6,25,19,6,34
Spart Moscow,2350,3,8,7,5,38,31,7,31
Krasnodar,2350,4,9,4,7,29,27,2,31
Zenit,2350,5,7,9,4,21,15,6,30
Terek Grozny,2350,6,7,5,8,22,26,-4,26
Din Moscow,2350,7,6,7,7,21,24,-3,25
Rostov,2350,8,5,6,9,12,18,-6,21
FK Rubin,2350,9,5,5,10,22,21,1,20
Amkar,2350,10,5,5,10,13,25,-12,20
Anzhi,2350,11,4,5,11,18,38,-20,17
Loko Moscow,2351,1,11,7,2,31,13,18,40
Zenit,2351,2,8,9,3,26,17,9,33
CSKA Moscow,2351,3,10,3,7,29,23,6,33
Spart Moscow,2351,4,9,5,6,34,29,5,32
Krasnodar,2351,5,9,5,6,29,25,4,32
Terek Grozny,2351,6,8,5,7,23,24,-1,29
FK Rubin,2351,7,6,5,9,22,18,4,23
Rostov,2351,8,5,6,9,13,17,-4,21
Din Moscow,2351,9,5,6,9,17,23,-6,21
Amkar,2351,10,5,4,11,10,24,-14,19
Anzhi,2351,11,4,5,11,18,39,-21,17
Loko Moscow,2352,1,13,5,2,31,11,20,44
CSKA Moscow,2352,2,11,4,5,26,17,9,37
Spart Moscow,2352,3,9,6,5,39,31,8,33
Krasnodar,2352,4,9,4,7,29,26,3,31
Zenit,2352,5,7,9,4,21,14,7,30
Terek Grozny,2352,6,8,5,7,25,25,0,29
FK Rubin,2352,7,6,5,9,25,20,5,23
Din Moscow,2352,8,5,7,8,18,24,-6,22
Amkar,2352,9,6,4,10,14,25,-11,22
Rostov,2352,10,4,6,10,13,21,-8,18
Anzhi,2352,11,2,5,13,15,42,-27,11
Loko Moscow,2353,1,13,5,2,32,12,20,44
CSKA Moscow,2353,2,11,3,6,27,19,8,36
Spart Moscow,2353,3,9,6,5,38,28,10,33
Zenit,2353,4,8,8,4,24,15,9,32
Terek Grozny,2353,5,8,5,7,21,24,-3,29
Krasnodar,2353,6,8,4,8,28,27,1,28
Din Moscow,2353,7,7,6,7,21,23,-2,27
FK Rubin,2353,8,6,5,9,25,21,4,23
Amkar,2353,9,5,5,10,12,23,-11,20
Rostov,2353,10,4,6,10,11,21,-10,18
Anzhi,2353,11,2,5,13,14,40,-26,11
Loko Moscow,2354,1,12,5,3,30,12,18,41
CSKA Moscow,2354,2,11,4,5,29,18,11,37
Spart Moscow,2354,3,9,7,4,37,28,9,34
Krasnodar,2354,4,10,4,6,31,24,7,34
Terek Grozny,2354,5,9,5,6,24,23,1,32
Zenit,2354,6,7,9,4,22,15,7,30
Din Moscow,2354,7,5,7,8,18,23,-5,22
FK Rubin,2354,8,5,6,9,21,20,1,21
Rostov,2354,9,4,7,9,12,19,-7,19
Amkar,2354,10,4,5,11,9,24,-15,17
Anzhi,2354,11,2,5,13,15,42,-27,11
Loko Moscow,2355,1,12,6,2,32,13,19,42
Spart Moscow,2355,2,10,6,4,40,27,13,36
CSKA Moscow,2355,3,10,3,7,27,23,4,33
Zenit,2355,4,8,8,4,24,16,8,32
Krasnodar,2355,5,9,5,6,29,25,4,32
Terek Grozny,2355,6,7,5,8,20,25,-5,26
Din Moscow,2355,7,6,6,8,19,24,-5,24
FK Rubin,2355,8,5,5,10,22,20,2,20
Amkar,2355,9,5,5,10,11,23,-12,20
Rostov,2355,10,4,6,10,11,21,-10,18
Anzhi,2355,11,4,5,11,20,38,-18,17
Loko Moscow,2356,1,12,6,2,35,12,23,42
CSKA Moscow,2356,2,11,3,6,27,20,7,36
Spart Moscow,2356,3,9,6,5,39,28,11,33
Zenit,2356,4,8,8,4,23,18,5,32
Terek Grozny,2356,5,9,5,6,25,23,2,32
Krasnodar,2356,6,8,6,6,29,26,3,30
Din Moscow,2356,7,6,7,7,19,22,-3,25
FK Rubin,2356,8,5,7,8,22,18,4,22
Rostov,2356,9,4,6,10,10,21,-11,18
Amkar,2356,10,4,5,11,11,25,-14,17
Anzhi,2356,11,2,5,13,15,42,-27,11
Loko Moscow,2357,1,11,7,2,32,14,18,40
Spart Moscow,2357,2,11,5,4,39,27,12,38
CSKA Moscow,2357,3,11,3,6,32,20,12,36
Zenit,2357,4,8,9,3,25,15,10,33
Terek Grozny,2357,5,8,6,6,24,25,-1,30
Krasnodar,2357,6,8,5,7,28,26,2,29
Din Moscow,2357,7,6,6,8,20,24,-4,24
FK Rubin,2357,8,6,5,9,22,19,3,23
Rostov,2357,9,4,6,10,10,18,-8,18
Amkar,2357,10,4,5,11,11,25,-14,17
Anzhi,2357,11,2,5,13,17,47,-30,11
Loko Moscow,2358,1,13,5,2,33,11,22,44
Spart Moscow,2358,2,11,5,4,41,25,16,38
CSKA Moscow,2358,3,11,3,6,29,20,9,36
Zenit,2358,4,8,8,4,23,15,8,32
Terek Grozny,2358,5,8,5,7,21,23,-2,29
Krasnodar,2358,6,8,4,8,28,29,-1,28
Din Moscow,2358,7,6,6,8,21,24,-3,24
FK Rubin,2358,8,6,5,9,24,22,2,23
Amkar,2358,9,5,4,11,10,24,-14,19
Rostov,2358,10,4,6,10,10,21,-11,18
Anzhi,2358,11,2,5,13,15,41,-26,11
Loko Moscow,2359,1,12,5,3,34,16,18,41
CSKA Moscow,2359,2,11,4,5,30,19,11,37
Spart Moscow,2359,3,10,5,5,37,27,10,35
Krasnodar,2359,4,9,5,6,34,29,5,32
Zenit,2359,5,7,9,4,23,17,6,30
Terek Grozny,2359,6,7,6,7,22,27,-5,27
Din Moscow,2359,7,6,7,7,19,22,-3,25
FK Rubin,2359,8,5,7,8,24,20,4,22
Amkar,2359,9,5,4,11,14,26,-12,19
Rostov,2359,10,4,6,10,10,18,-8,18
Anzhi,2359,11,2,6,12,15,41,-26,12
Loko Moscow,2360,1,12,5,3,32,14,18,41
Spart Moscow,2360,2,10,5,5,41,27,14,35
CSKA Moscow,2360,3,10,4,6,26,20,6,34
Krasnodar,2360,4,10,4,6,31,26,5,34
Zenit,2360,5,8,8,4,23,14,9,32
Terek Grozny,2360,6,8,6,6,23,23,0,30
FK Rubin,2360,7,6,5,9,22,18,4,23
Din Moscow,2360,8,5,6,9,17,27,-10,21
Amkar,2360,9,5,5,10,11,23,-12,20
Rostov,2360,10,4,6,10,10,19,-9,18
Anzhi,2360,11,2,6,12,16,41,-25,12
Loko Moscow,2361,1,11,6,3,30,13,17,39
CSKA Moscow,2361,2,11,3,6,27,19,8,36
Zenit,2361,3,9,8,3,24,14,10,35
Spart Moscow,2361,4,10,5,5,37,28,9,35
Terek Grozny,2361,5,8,6,6,23,22,1,30
Krasnodar,2361,6,8,5,7,29,28,1,29
FK Rubin,2361,7,7,5,8,26,18,8,26
Din Moscow,2361,8,5,6,9,18,25,-7,21
Amkar,2361,9,5,4,11,10,25,-15,19
Rostov,2361,10,4,6,10,11,19,-8,18
Anzhi,2361,11,2,6,12,14,38,-24,12
Loko Moscow,2362,1,12,6,2,31,12,19,42
Spart Moscow,2362,2,9,7,4,38,29,9,34
CSKA Moscow,2362,3,10,4,6,25,18,7,34
Zenit,2362,4,7,10,3,21,13,8,31
Krasnodar,2362,5,9,4,7,29,26,3,31
Terek Grozny,2362,6,7,6,7,20,27,-7,27
Din Moscow,2362,7,6,7,7,24,23,1,25
FK Rubin,2362,8,5,5,10,22,24,-2,20
Rostov,2362,9,4,7,9,12,19,-7,19
Amkar,2362,10,4,5,11,10,24,-14,17
Anzhi,2362,11,4,5,11,20,37,-17,17
Loko Moscow,2363,1,11,6,3,30,14,16,39
CSKA Moscow,2363,2,11,3,6,28,19,9,36
Zenit,2363,3,8,9,3,24,15,9,33
Krasnodar,2363,4,9,5,6,30,25,5,32
Spart Moscow,2363,5,8,6,6,34,28,6,30
Terek Grozny,2363,6,7,6,7,20,25,-5,27
FK Rubin,2363,7,6,6,8,24,18,6,24
Din Moscow,2363,8,5,7,8,17,23,-6,22
Amkar,2363,9,6,4,10,14,23,-9,22
Rostov,2363,10,5,6,9,11,17,-6,21
Anzhi,2363,11,2,6,12,14,39,-25,12
Loko Moscow,2364,1,12,5,3,30,12,18,41
CSKA Moscow,2364,2,11,4,5,29,19,10,37
Spart Moscow,2364,3,10,5,5,36,28,8,35
Krasnodar,2364,4,10,4,6,32,24,8,34
Terek Grozny,2364,5,9,5,6,23,23,0,32
Zenit,2364,6,7,8,5,22,17,5,29
FK Rubin,2364,7,6,5,9,22,21,1,23
Din Moscow,2364,8,5,6,9,18,24,-6,21
Amkar,2364,9,5,4,11,12,24,-12,19
Rostov,2364,10,4,6,10,10,18,-8,18
Anzhi,2364,11,2,6,12,15,39,-24,12
Loko Moscow,2365,1,12,6,2,30,11,19,42
Spart Moscow,2365,2,11,5,4,38,25,13,38
CSKA Moscow,2365,3,11,3,6,30,19,11,36
Zenit,2365,4,8,8,4,22,14,8,32
Krasnodar,2365,5,8,5,7,27,28,-1,29
Terek Grozny,2365,6,7,5,8,20,25,-5,26
FK Rubin,2365,7,6,6,8,26,18,8,24
Din Moscow,2365,8,5,7,8,18,24,-6,22
Amkar,2365,9,5,4,11,10,24,-14,19
Rostov,2365,10,4,6,10,10,18,-8,18
Anzhi,2365,11,3,5,12,17,42,-25,14
Loko Moscow,2366,1,11,5,4,29,14,15,38
CSKA Moscow,2366,2,10,5,5,26,18,8,35
Zenit,2366,3,8,9,3,23,14,9,33
Spart Moscow,2366,4,8,7,5,36,30,6,31
Krasnodar,2366,5,9,4,7,29,27,2,31
Terek Grozny,2366,6,8,5,7,22,24,-2,29
FK Rubin,2366,7,7,5,8,26,18,8,26
Din Moscow,2366,8,6,6,8,20,23,-3,24
Rostov,2366,9,4,7,9,12,19,-7,19
Amkar,2366,10,4,5,11,10,24,-14,17
Anzhi,2366,11,3,6,11,16,38,-22,15
Loko Moscow,2367,1,11,6,3,31,14,17,39
CSKA Moscow,2367,2,11,3,6,28,22,6,36
Zenit,2367,3,9,8,3,27,15,12,35
Terek Grozny,2367,4,9,5,6,25,25,0,32
Spart Moscow,2367,5,8,6,6,34,29,5,30
Krasnodar,2367,6,8,5,7,28,26,2,29
Din Moscow,2367,7,6,7,7,20,23,-3,25
FK Rubin,2367,8,6,5,9,24,20,4,23
Rostov,2367,9,5,6,9,12,17,-5,21
Amkar,2367,10,5,4,11,13,26,-13,19
Anzhi,2367,11,2,5,13,16,41,-25,11
Loko Moscow,2368,1,12,5,3,31,12,19,41
Zenit,2368,2,9,8,3,26,14,12,35
CSKA Moscow,2368,3,10,3,7,27,24,3,33
Spart Moscow,2368,4,8,6,6,34,29,5,30
Krasnodar,2368,5,8,4,8,28,29,-1,28
Din Moscow,2368,6,7,6,7,21,21,0,27
Terek Grozny,2368,7,7,6,7,23,27,-4,27
FK Rubin,2368,8,6,5,9,24,21,3,23
Amkar,2368,9,6,4,10,13,22,-9,22
Rostov,2368,10,4,7,9,11,18,-7,19
Anzhi,2368,11,3,6,11,20,41,-21,15
Loko Moscow,2369,1,11,5,4,30,15,15,38
CSKA Moscow,2369,2,11,3,6,28,21,7,36
Zenit,2369,3,9,8,3,25,14,11,35
Spart Moscow,2369,4,10,5,5,38,29,9,35
Krasnodar,2369,5,9,4,7,30,28,2,31
Terek Grozny,2369,6,8,6,6,24,24,0,30
Din Moscow,2369,7,6,7,7,19,22,-3,25
FK Rubin,2369,8,6,6,8,24,17,7,24
Rostov,2369,9,4,6,10,11,19,-8,18
Amkar,2369,10,4,4,12,10,26,-16,16
Anzhi,2369,11,2,6,12,17,41,-24,12
Loko Moscow,2370,1,11,7,2,32,14,18,40
Spart Moscow,2370,2,10,5,5,42,29,13,35
CSKA Moscow,2370,3,10,4,6,26,20,6,34
Zenit,2370,4,8,9,3,24,14,10,33
Krasnodar,2370,5,9,5,6,33,26,7,32
Terek Grozny,2370,6,9,5,6,24,22,2,32
FK Rubin,2370,7,6,5,9,22,21,1,23
Din Moscow,2370,8,5,6,9,18,24,-6,21
Amkar,2370,9,5,4,11,12,25,-13,19
Rostov,2370,10,4,6,10,10,22,-12,18
Anzhi,2370,11,2,6,12,15,41,-26,12
Loko Moscow,2371,1,11,7,2,30,12,18,40
CSKA Moscow,2371,2,11,4,5,30,19,11,37
Krasnodar,2371,3,9,5,6,31,25,6,32
Spart Moscow,2371,4,8,7,5,36,29,7,31
Zenit,2371,5,7,9,4,23,18,5,30
Terek Grozny,2371,6,8,6,6,21,22,-1,30
Din Moscow,2371,7,7,6,7,21,23,-2,27
FK Rubin,2371,8,5,5,10,23,23,0,20
Rostov,2371,9,4,7,9,11,18,-7,19
Amkar,2371,10,4,5,11,10,24,-14,17
Anzhi,2371,11,2,7,11,15,38,-23,13
Loko Moscow,2372,1,12,6,2,33,12,21,42
CSKA Moscow,2372,2,12,3,5,30,19,11,39
Spart Moscow,2372,3,10,6,4,38,28,10,36
Krasnodar,2372,4,9,4,7,34,28,6,31
Zenit,2372,5,7,9,4,22,15,7,30
Terek Grozny,2372,6,8,5,7,23,25,-2,29
FK Rubin,2372,7,6,5,9,22,23,-1,23
Din Moscow,2372,8,5,7,8,18,23,-5,22
Rostov,2372,9,4,6,10,12,20,-8,18
Amkar,2372,10,4,4,12,9,24,-15,16
Anzhi,2372,11,3,5,12,18,42,-24,14
Loko Moscow,2373,1,11,5,4,30,16,14,38
CSKA Moscow,2373,2,11,4,5,27,18,9,37
Krasnodar,2373,3,10,4,6,31,24,7,34
Zenit,2373,4,8,8,4,25,16,9,32
Spart Moscow,2373,5,9,5,6,38,32,6,32
Terek Grozny,2373,6,8,6,6,24,24,0,30
Din Moscow,2373,7,5,7,8,20,25,-5,22
FK Rubin,2373,8,5,6,9,23,21,2,21
Rostov,2373,9,5,6,9,14,19,-5,21
Amkar,2373,10,5,5,10,12,24,-12,20
Anzhi,2373,11,2,6,12,15,40,-25,12
Loko Moscow,2374,1,12,6,2,31,12,19,42
CSKA Moscow,2374,2,11,3,6,27,20,7,36
Spart Moscow,2374,3,9,6,5,40,29,11,33
Zenit,2374,4,8,8,4,23,14,9,32
Krasnodar,2374,5,8,6,6,28,25,3,30
Terek Grozny,2374,6,8,5,7,22,24,-2,29
FK Rubin,2374,7,6,6,8,22,17,5,24
Amkar,2374,8,6,4,10,12,23,-11,22
Din Moscow,2374,9,5,6,9,17,26,-9,21
Rostov,2374,10,4,7,9,13,20,-7,19
Anzhi,2374,11,2,5,13,15,40,-25,11
Loko Moscow,2375,1,12,6,2,32,12,20,42
CSKA Moscow,2375,2,12,3,5,31,18,13,39
Spart Moscow,2375,3,9,5,6,35,29,6,32
Krasnodar,2375,4,9,5,6,29,25,4,32
Zenit,2375,5,7,8,5,21,17,4,29
Terek Grozny,2375,6,8,5,7,24,25,-1,29
Din Moscow,2375,7,7,6,7,21,22,-1,27
Amkar,2375,8,6,4,10,13,24,-11,22
FK Rubin,2375,9,5,5,10,22,20,2,20
Rostov,2375,10,4,6,10,10,18,-8,18
Anzhi,2375,11,2,5,13,16,44,-28,11
Loko Moscow,2376,1,12,6,2,32,12,20,42
Spart Moscow,2376,2,10,5,5,40,30,10,35
CSKA Moscow,2376,3,10,4,6,26,21,5,34
Krasnodar,2376,4,9,5,6,32,26,6,32
Zenit,2376,5,7,9,4,22,16,6,30
Terek Grozny,2376,6,7,6,7,21,24,-3,27
FK Rubin,2376,7,6,5,9,25,22,3,23
Amkar,2376,8,6,4,10,13,24,-11,22
Din Moscow,2376,9,5,6,9,20,28,-8,21
Rostov,2376,10,4,6,10,10,18,-8,18
Anzhi,2376,11,3,6,11,18,38,-20,15
Loko Moscow,2377,1,11,7,2,32,14,18,40
Spart Moscow,2377,2,11,5,4,39,28,11,38
CSKA Moscow,2377,3,11,4,5,26,17,9,37
Krasnodar,2377,4,9,5,6,35,28,7,32
Zenit,2377,5,7,10,3,22,14,8,31
Terek Grozny,2377,6,8,5,7,21,24,-3,29
FK Rubin,2377,7,6,5,9,25,24,1,23
Din Moscow,2377,8,5,6,9,18,24,-6,21
Rostov,2377,9,4,6,10,11,19,-8,18
Amkar,2377,10,4,4,12,11,26,-15,16
Anzhi,2377,11,3,5,12,16,38,-22,14
Loko Moscow,2378,1,12,6,2,36,13,23,42
CSKA Moscow,2378,2,11,4,5,28,18,10,37
Spart Moscow,2378,3,10,5,5,40,31,9,35
Zenit,2378,4,7,9,4,22,19,3,30
Krasnodar,2378,5,8,5,7,29,27,2,29
Terek Grozny,2378,6,8,5,7,23,25,-2,29
FK Rubin,2378,7,7,5,8,23,17,6,26
Din Moscow,2378,8,5,6,9,19,25,-6,21
Amkar,2378,9,5,4,11,14,25,-11,19
Rostov,2378,10,4,6,10,10,20,-10,18
Anzhi,2378,11,3,5,12,16,40,-24,14
Loko Moscow,2379,1,11,6,3,31,17,14,39
CSKA Moscow,2379,2,11,4,5,29,19,10,37
Krasnodar,2379,3,10,4,6,36,26,10,34
Spart Moscow,2379,4,9,6,5,35,26,9,33
Zenit,2379,5,7,10,3,23,15,8,31
Terek Grozny,2379,6,8,5,7,22,24,-2,29
Din Moscow,2379,7,6,7,7,19,21,-2,25
Amkar,2379,8,6,4,10,12,22,-10,22
FK Rubin,2379,9,5,5,10,22,23,-1,20
Rostov,2379,10,4,6,10,10,19,-9,18
Anzhi,2379,11,2,5,13,15,42,-27,11
Loko Moscow,2380,1,11,5,4,31,15,16,38
CSKA Moscow,2380,2,11,3,6,27,19,8,36
Spart Moscow,2380,3,10,5,5,38,27,11,35
Zenit,2380,4,9,8,3,25,15,10,35
Krasnodar,2380,5,9,5,6,30,26,4,32
Terek Grozny,2380,6,8,6,6,23,23,0,30
Din Moscow,2380,7,6,6,8,20,26,-6,24
FK Rubin,2380,8,5,6,9,23,20,3,21
Amkar,2380,9,5,4,11,10,24,-14,19
Rostov,2380,10,4,6,10,10,18,-8,18
Anzhi,2380,11,2,6,12,15,39,-24,12
Loko Moscow,2381,1,11,6,3,33,16,17,39
CSKA Moscow,2381,2,11,3,6,28,19,9,36
Spart Moscow,2381,3,10,5,5,37,27,10,35
Zenit,2381,4,9,8,3,24,14,10,35
Krasnodar,2381,5,8,5,7,32,30,2,29
Din Moscow,2381,6,7,6,7,21,23,-2,27
Terek Grozny,2381,7,7,5,8,22,27,-5,26
FK Rubin,2381,8,6,5,9,24,20,4,23
Amkar,2381,9,5,4,11,11,23,-12,19
Rostov,2381,10,4,6,10,10,19,-9,18
Anzhi,2381,11,3,5,12,17,41,-24,14
Loko Moscow,2382,1,12,6,2,32,12,20,42
CSKA Moscow,2382,2,10,4,6,25,19,6,34
Zenit,2382,3,8,9,3,24,14,10,33
Spart Moscow,2382,4,9,6,5,38,32,6,33
Krasnodar,2382,5,9,4,7,28,26,2,31
Din Moscow,2382,6,7,6,7,22,22,0,27
Terek Grozny,2382,7,7,6,7,21,25,-4,27
FK Rubin,2382,8,5,5,10,21,19,2,20
Amkar,2382,9,5,5,10,13,24,-11,20
Rostov,2382,10,4,6,10,11,19,-8,18
Anzhi,2382,11,2,7,11,15,38,-23,13
Loko Moscow,2383,1,11,7,2,30,12,18,40
CSKA Moscow,2383,2,11,3,6,32,21,11,36
Spart Moscow,2383,3,10,5,5,38,27,11,35
Zenit,2383,4,8,9,3,25,16,9,33
Krasnodar,2383,5,9,5,6,28,24,4,32
Terek Grozny,2383,6,9,5,6,25,23,2,32
Din Moscow,2383,7,6,7,7,19,22,-3,25
FK Rubin,2383,8,5,6,9,22,19,3,21
Rostov,2383,9,4,6,10,10,18,-8,18
Amkar,2383,10,4,4,12,10,28,-18,16
Anzhi,2383,11,2,5,13,16,45,-29,11
Loko Moscow,2384,1,13,5,2,36,12,24,44
CSKA Moscow,2384,2,11,3,6,28,19,9,36
Spart Moscow,2384,3,10,5,5,41,30,11,35
Zenit,2384,4,8,8,4,23,16,7,32
Krasnodar,2384,5,9,4,7,30,29,1,31
Terek Grozny,2384,6,8,5,7,23,24,-1,29
Din Moscow,2384,7,6,6,8,23,26,-3,24
Amkar,2384,8,6,4,10,13,23,-10,22
FK Rubin,2384,9,5,5,10,21,24,-3,20
Rostov,2384,10,4,6,10,11,19,-8,18
Anzhi,2384,11,2,5,13,15,42,-27,11
Loko Moscow,2385,1,12,6,2,31,12,19,42
CSKA Moscow,2385,2,11,4,5,29,19,10,37
Zenit,2385,3,7,10,3,22,14,8,31
Spart Moscow,2385,4,8,7,5,35,28,7,31
Krasnodar,2385,5,9,4,7,30,27,3,31
Terek Grozny,2385,6,8,6,6,26,25,1,30
Din Moscow,2385,7,6,7,7,20,23,-3,25
Rostov,2385,8,5,6,9,11,17,-6,21
FK Rubin,2385,9,5,5,10,23,21,2,20
Amkar,2385,10,4,5,11,11,27,-16,17
Anzhi,2385,11,2,6,12,17,42,-25,12
Loko Moscow,2386,1,12,6,2,32,12,20,42
CSKA Moscow,2386,2,12,3,5,31,18,13,39
Spart Moscow,2386,3,9,5,6,36,31,5,32
Terek Grozny,2386,4,8,6,6,21,22,-1,30
Zenit,2386,5,7,8,5,22,19,3,29
Krasnodar,2386,6,8,5,7,28,27,1,29
Din Moscow,2386,7,6,6,8,19,23,-4,24
FK Rubin,2386,8,6,5,9,25,20,5,23
Rostov,2386,9,5,6,9,13,18,-5,21
Amkar,2386,10,5,5,10,12,23,-11,20
Anzhi,2386,11,2,5,13,15,41,-26,11
Loko Moscow,2387,1,11,6,3,31,15,16,39
CSKA Moscow,2387,2,11,3,6,28,20,8,36
Zenit,2387,3,9,8,3,25,13,12,35
Spart Moscow,2387,4,9,6,5,38,29,9,33
Krasnodar,2387,5,8,5,7,29,27,2,29
Terek Grozny,2387,6,8,5,7,23,24,-1,29
Din Moscow,2387,7,6,7,7,21,24,-3,25
FK Rubin,2387,8,6,5,9,23,19,4,23
Amkar,2387,9,5,4,11,10,24,-14,19
Rostov,2387,10,4,6,10,11,20,-9,18
Anzhi,2387,11,3,5,12,17,41,-24,14
Loko Moscow,2388,1,12,6,2,33,14,19,42
CSKA Moscow,2388,2,12,3,5,28,18,10,39
Spart Moscow,2388,3,10,5,5,39,28,11,35
Krasnodar,2388,4,9,4,7,31,28,3,31
Zenit,2388,5,7,9,4,22,15,7,30
Terek Grozny,2388,6,8,5,7,24,25,-1,29
Din Moscow,2388,7,6,6,8,21,24,-3,24
Amkar,2388,8,6,4,10,12,23,-11,22
FK Rubin,2388,9,5,5,10,23,23,0,20
Rostov,2388,10,4,6,10,11,20,-9,18
Anzhi,2388,11,2,5,13,17,43,-26,11
Loko Moscow,2389,1,13,5,2,32,11,21,44
Spart Moscow,2389,2,10,5,5,40,28,12,35
CSKA Moscow,2389,3,10,4,6,28,22,6,34
Zenit,2389,4,8,8,4,23,14,9,32
Krasnodar,2389,5,8,4,8,27,28,-1,28
Terek Grozny,2389,6,7,6,7,20,23,-3,27
Din Moscow,2389,7,6,6,8,21,25,-4,24
FK Rubin,2389,8,6,5,9,23,21,2,23
Amkar,2389,9,6,4,10,11,22,-11,22
Rostov,2389,10,4,6,10,12,20,-8,18
Anzhi,2389,11,2,7,11,17,40,-23,13
Loko Moscow,2390,1,13,5,2,32,11,21,44
CSKA Moscow,2390,2,11,3,6,27,19,8,36
Zenit,2390,3,8,8,4,22,14,8,32
Spart Moscow,2390,4,8,7,5,37,30,7,31
Krasnodar,2390,5,8,4,8,27,28,-1,28
Din Moscow,2390,6,7,6,7,21,22,-1,27
Terek Grozny,2390,7,7,6,7,21,24,-3,27
FK Rubin,2390,8,6,5,9,23,19,4,23
Rostov,2390,9,4,7,9,12,19,-7,19
Amkar,2390,10,4,6,10,11,24,-13,18
Anzhi,2390,11,3,5,12,16,39,-23,14
Loko Moscow,2391,1,12,6,2,31,11,20,42
Spart Moscow,2391,2,10,6,4,40,27,13,36
CSKA Moscow,2391,3,10,5,5,25,17,8,35
Krasnodar,2391,4,9,5,6,28,24,4,32
Zenit,2391,5,7,9,4,21,15,6,30
Terek Grozny,2391,6,8,6,6,23,23,0,30
Din Moscow,2391,7,5,7,8,18,24,-6,22
FK Rubin,2391,8,5,6,9,22,19,3,21
Rostov,2391,9,4,7,9,12,19,-7,19
Amkar,2391,10,4,5,11,9,25,-16,17
Anzhi,2391,11,2,6,12,15,40,-25,12
Loko Moscow,2392,1,12,6,2,34,13,21,42
Spart Moscow,2392,2,10,6,4,38,27,11,36
CSKA Moscow,2392,3,10,4,6,27,20,7,34
Zenit,2392,4,8,8,4,22,16,6,32
Krasnodar,2392,5,8,6,6,29,26,3,30
Terek Grozny,2392,6,7,5,8,20,25,-5,26
Din Moscow,2392,7,6,6,8,20,24,-4,24
FK Rubin,2392,8,5,6,9,22,20,2,21
Amkar,2392,9,5,5,10,11,22,-11,20
Rostov,2392,10,4,6,10,12,20,-8,18
Anzhi,2392,11,3,6,11,17,39,-22,15
Loko Moscow,2393,1,12,5,3,33,15,18,41
CSKA Moscow,2393,2,11,3,6,27,19,8,36
Spart Moscow,2393,3,10,5,5,40,29,11,35
Zenit,2393,4,8,8,4,24,16,8,32
Krasnodar,2393,5,9,5,6,32,28,4,32
Terek Grozny,2393,6,7,6,7,20,25,-5,27
FK Rubin,2393,7,6,6,8,25,20,5,24
Rostov,2393,8,5,6,9,13,18,-5,21
Din Moscow,2393,9,5,6,9,19,27,-8,21
Amkar,2393,10,5,4,11,12,24,-12,19
Anzhi,2393,11,2,6,12,14,38,-24,12
Loko Moscow,2394,1,13,5,2,35,12,23,44
Spart Moscow,2394,2,11,5,4,41,27,14,38
CSKA Moscow,2394,3,11,3,6,29,19,10,36
Zenit,2394,4,8,8,4,23,16,7,32
Terek Grozny,2394,5,9,5,6,22,22,0,32
Krasnodar,2394,6,8,4,8,28,28,0,28
FK Rubin,2394,7,6,6,8,22,17,5,24
Din Moscow,2394,8,5,7,8,18,24,-6,22
Rostov,2394,9,4,6,10,10,20,-10,18
Amkar,2394,10,4,4,12,10,25,-15,16
Anzhi,2394,11,2,5,13,14,42,-28,11
Loko Moscow,2395,1,11,6,3,31,14,17,39
CSKA Moscow,2395,2,11,4,5,27,18,9,37
Spart Moscow,2395,3,10,6,4,37,25,12,36
Zenit,2395,4,8,9,3,23,14,9,33
Krasnodar,2395,5,8,6,6,29,26,3,30
Terek Grozny,2395,6,8,6,6,24,23,1,30
FK Rubin,2395,7,5,7,8,23,19,4,22
Din Moscow,2395,8,5,7,8,18,25,-7,22
Rostov,2395,9,4,6,10,10,18,-8,18
Amkar,2395,10,4,6,10,10,23,-13,18
Anzhi,2395,11,2,5,13,15,42,-27,11
Loko Moscow,2396,1,12,5,3,31,13,18,41
CSKA Moscow,2396,2,12,3,5,28,17,11,39
Spart Moscow,2396,3,10,6,4,36,26,10,36
Krasnodar,2396,4,10,4,6,33,26,7,34
Terek Grozny,2396,5,9,5,6,25,22,3,32
Zenit,2396,6,7,8,5,21,15,6,29
Din Moscow,2396,7,6,7,7,20,21,-1,25
FK Rubin,2396,8,5,5,10,22,24,-2,20
Rostov,2396,9,4,6,10,11,19,-8,18
Amkar,2396,10,4,4,12,9,26,-17,16
Anzhi,2396,11,2,5,13,14,41,-27,11
Loko Moscow,2397,1,11,5,4,29,13,16,38
CSKA Moscow,2397,2,11,3,6,27,20,7,36
Spart Moscow,2397,3,10,5,5,40,29,11,35
Zenit,2397,4,9,8,3,25,14,11,35
Krasnodar,2397,5,10,4,6,30,25,5,34
Terek Grozny,2397,6,8,6,6,21,22,-1,30
Din Moscow,2397,7,5,7,8,19,25,-6,22
FK Rubin,2397,8,5,6,9,23,20,3,21
Amkar,2397,9,5,4,11,12,25,-13,19
Rostov,2397,10,4,6,10,10,19,-9,18
Anzhi,2397,11,2,6,12,14,38,-24,12
Loko Moscow,2398,1,12,5,3,31,13,18,41
CSKA Moscow,2398,2,11,3,6,29,19,10,36
Zenit,2398,3,9,8,3,25,14,11,35
Spart Moscow,2398,4,9,7,4,39,30,9,34
Krasnodar,2398,5,8,5,7,29,27,2,29
Terek Grozny,2398,6,8,5,7,24,26,-2,29
Din Moscow,2398,7,5,8,7,21,25,-4,23
FK Rubin,2398,8,5,7,8,25,21,4,22
Rostov,2398,9,4,6,10,11,19,-8,18
Amkar,2398,10,4,5,11,12,26,-14,17
Anzhi,2398,11,3,5,12,17,43,-26,14
Loko Moscow,2399,1,12,6,2,33,13,20,42
Zenit,2399,2,8,9,3,25,15,10,33
Spart Moscow,2399,3,9,6,5,37,28,9,33
CSKA Moscow,2399,4,10,3,7,25,20,5,33
Krasnodar,2399,5,8,5,7,27,26,1,29
Terek Grozny,2399,6,8,5,7,23,26,-3,29
Din Moscow,2399,7,6,6,8,20,26,-6,24
Amkar,2399,8,6,4,10,15,23,-8,22
FK Rubin,2399,9,5,6,9,23,20,3,21
Rostov,2399,10,4,7,9,10,17,-7,19
Anzhi,2399,11,3,5,12,16,40,-24,14
Loko Moscow,2400,1,13,5,2,34,13,21,44
CSKA Moscow,2400,2,11,4,5,27,18,9,37
Spart Moscow,2400,3,9,5,6,37,31,6,32
Krasnodar,2400,4,9,4,7,28,26,2,31
Zenit,2400,5,7,9,4,24,17,7,30
Terek Grozny,2400,6,7,6,7,22,26,-4,27
Din Moscow,2400,7,6,7,7,20,23,-3,25
FK Rubin,2400,8,5,6,9,21,18,3,21
Rostov,2400,9,5,6,9,13,18,-5,21
Amkar,2400,10,5,4,11,12,24,-12,19
Anzhi,2400,11,2,6,12,15,39,-24,12
Loko Moscow,2401,1,12,5,3,31,12,19,41
CSKA Moscow,2401,2,11,3,6,27,19,8,36
Krasnodar,2401,3,10,4,6,30,24,6,34
Zenit,2401,4,8,8,4,22,15,7,32
Spart Moscow,2401,5,8,7,5,35,28,7,31
Terek Grozny,2401,6,7,6,7,21,24,-3,27
FK Rubin,2401,7,6,5,9,24,20,4,23
Din Moscow,2401,8,5,7,8,19,25,-6,22
Amkar,2401,9,6,4,10,13,24,-11,22
Rostov,2401,10,4,7,9,10,17,-7,19
Anzhi,2401,11,2,6,12,15,39,-24,12
Loko Moscow,2402,1,11,6,3,33,16,17,39
CSKA Moscow,2402,2,11,3,6,26,18,8,36
Zenit,2402,3,8,8,4,23,15,8,32
Spart Moscow,2402,4,9,5,6,37,30,7,32
Krasnodar,2402,5,9,5,6,34,29,5,32
Terek Grozny,2402,6,8,5,7,23,25,-2,29
Din Moscow,2402,7,6,7,7,20,22,-2,25
FK Rubin,2402,8,5,6,9,23,21,2,21
Amkar,2402,9,5,4,11,11,23,-12,19
Rostov,2402,10,4,6,10,10,20,-10,18
Anzhi,2402,11,4,5,11,18,39,-21,17
Loko Moscow,2403,1,11,6,3,32,15,17,39
Spart Moscow,2403,2,10,6,4,41,28,13,36
CSKA Moscow,2403,3,11,3,6,28,20,8,36
Krasnodar,2403,4,10,4,6,32,26,6,34
Zenit,2403,5,7,9,4,22,16,6,30
Terek Grozny,2403,6,8,6,6,24,24,0,30
Din Moscow,2403,7,6,6,8,20,25,-5,24
FK Rubin,2403,8,5,5,10,22,21,1,20
Rostov,2403,9,4,6,10,10,20,-10,18
Amkar,2403,10,4,5,11,12,27,-15,17
Anzhi,2403,11,3,6,11,18,39,-21,15
Loko Moscow,2404,1,12,5,3,33,14,19,41
Spart Moscow,2404,2,11,5,4,40,26,14,38
CSKA Moscow,2404,3,11,3,6,29,20,9,36
Zenit,2404,4,9,8,3,25,14,11,35
Terek Grozny,2404,5,8,5,7,21,23,-2,29
Krasnodar,2404,6,8,4,8,30,31,-1,28
FK Rubin,2404,7,6,6,8,24,18,6,24
Din Moscow,2404,8,5,7,8,17,23,-6,22
Amkar,2404,9,5,4,11,10,23,-13,19
Rostov,2404,10,4,6,10,11,21,-10,18
Anzhi,2404,11,2,5,13,14,41,-27,11
Loko Moscow,2405,1,12,5,3,32,13,19,41
CSKA Moscow,2405,2,11,3,6,29,21,8,36
Spart Moscow,2405,3,10,5,5,37,27,10,35
Zenit,2405,4,8,8,4,24,18,6,32
Krasnodar,2405,5,9,5,6,30,25,5,32
Terek Grozny,2405,6,7,5,8,20,25,-5,26
FK Rubin,2405,7,5,7,8,22,18,4,22
Din Moscow,2405,8,5,7,8,17,23,-6,22
Rostov,2405,9,5,6,9,11,17,-6,21
Amkar,2405,10,5,4,11,11,24,-13,19
Anzhi,2405,11,3,5,12,17,39,-22,14
Loko Moscow,2406,1,12,6,2,33,13,20,42
CSKA Moscow,2406,2,11,3,6,30,22,8,36
Spart Moscow,2406,3,9,6,5,35,28,7,33
Zenit,2406,4,7,9,4,23,18,5,30
Krasnodar,2406,5,8,5,7,28,27,1,29
Terek Grozny,2406,6,7,6,7,22,26,-4,27
FK Rubin,2406,7,6,6,8,24,18,6,24
Din Moscow,2406,8,5,7,8,19,25,-6,22
Rostov,2406,9,5,6,9,12,17,-5,21
Amkar,2406,10,4,5,11,9,23,-14,17
Anzhi,2406,11,4,5,11,22,40,-18,17
Loko Moscow,2407,1,11,7,2,32,14,18,40
CSKA Moscow,2407,2,11,3,6,28,21,7,36
Krasnodar,2407,3,9,5,6,30,26,4,32
Zenit,2407,4,7,9,4,24,17,7,30
Spart Moscow,2407,5,8,5,7,35,32,3,29
Terek Grozny,2407,6,8,5,7,24,24,0,29
Din Moscow,2407,7,6,6,8,19,23,-4,24
FK Rubin,2407,8,6,5,9,24,20,4,23
Amkar,2407,9,6,4,10,14,23,-9,22
Rostov,2407,10,5,6,9,13,18,-5,21
Anzhi,2407,11,3,5,12,17,42,-25,14
Loko Moscow,2408,1,13,5,2,35,14,21,44
CSKA Moscow,2408,2,11,3,6,28,20,8,36
Spart Moscow,2408,3,9,6,5,36,28,8,33
Zenit,2408,4,8,8,4,24,15,9,32
Terek Grozny,2408,5,8,5,7,21,24,-3,29
Krasnodar,2408,6,8,4,8,30,30,0,28
FK Rubin,2408,7,6,6,8,24,19,5,24
Din Moscow,2408,8,5,7,8,18,24,-6,22
Amkar,2408,9,6,4,10,13,22,-9,22
Rostov,2408,10,4,7,9,11,18,-7,19
Anzhi,2408,11,2,5,13,15,41,-26,11
Loko Moscow,2409,1,13,5,2,32,11,21,44
Spart Moscow,2409,2,10,6,4,43,28,15,36
CSKA Moscow,2409,3,10,3,7,26,20,6,33
Zenit,2409,4,8,8,4,22,15,7,32
Krasnodar,2409,5,9,4,7,30,27,3,31
Terek Grozny,2409,6,8,5,7,23,23,0,29
Din Moscow,2409,7,6,6,8,20,28,-8,24
FK Rubin,2409,8,5,5,10,24,22,2,20
Amkar,2409,9,5,5,10,11,23,-12,20
Rostov,2409,10,4,6,10,11,20,-9,18
Anzhi,2409,11,3,5,12,16,41,-25,14
Loko Moscow,2410,1,11,7,2,32,14,18,40
Spart Moscow,2410,2,10,6,4,39,29,10,36
CSKA Moscow,2410,3,10,5,5,26,18,8,35
Krasnodar,2410,4,9,5,6,30,25,5,32
Zenit,2410,5,7,10,3,23,15,8,31
Terek Grozny,2410,6,8,5,7,22,23,-1,29
Din Moscow,2410,7,6,6,8,21,23,-2,24
FK Rubin,2410,8,5,5,10,21,22,-1,20
Rostov,2410,9,4,7,9,12,19,-7,19
Amkar,2410,10,5,4,11,11,24,-13,19
Anzhi,2410,11,2,6,12,15,40,-25,12
Loko Moscow,2411,1,12,6,2,32,13,19,42
Spart Moscow,2411,2,9,7,4,38,29,9,34
CSKA Moscow,2411,3,10,3,7,26,23,3,33
Zenit,2411,4,8,8,4,25,15,10,32
Krasnodar,2411,5,9,5,6,32,26,6,32
Terek Grozny,2411,6,8,5,7,23,24,-1,29
Din Moscow,2411,7,6,6,8,20,24,-4,24
FK Rubin,2411,8,5,5,10,21,21,0,20
Amkar,2411,9,5,5,10,12,24,-12,20
Rostov,2411,10,4,7,9,10,17,-7,19
Anzhi,2411,11,3,5,12,17,40,-23,14
Loko Moscow,2412,1,11,6,3,30,14,16,39
Spart Moscow,2412,2,11,5,4,41,28,13,38
CSKA Moscow,2412,3,10,5,5,27,19,8,35
Krasnodar,2412,4,9,5,6,30,25,5,32
Zenit,2412,5,7,10,3,23,15,8,31
Terek Grozny,2412,6,8,5,7,22,23,-1,29
Din Moscow,2412,7,6,6,8,19,24,-5,24
FK Rubin,2412,8,5,6,9,23,20,3,21
Rostov,2412,9,4,6,10,12,20,-8,18
Amkar,2412,10,4,4,12,10,27,-17,16
Anzhi,2412,11,3,6,11,16,38,-22,15
Loko Moscow,2413,1,12,5,3,32,14,18,41
CSKA Moscow,2413,2,11,4,5,30,19,11,37
Krasnodar,2413,3,10,4,6,32,26,6,34
Spart Moscow,2413,4,9,6,5,40,31,9,33
Zenit,2413,5,7,9,4,24,18,6,30
Terek Grozny,2413,6,8,5,7,22,25,-3,29
Din Moscow,2413,7,6,7,7,22,25,-3,25
Amkar,2413,8,6,4,10,13,23,-10,22
FK Rubin,2413,9,5,5,10,24,22,2,20
Rostov,2413,10,4,6,10,11,20,-9,18
Anzhi,2413,11,2,5,13,15,42,-27,11
Loko Moscow,2414,1,11,6,3,31,14,17,39
CSKA Moscow,2414,2,12,3,5,29,18,11,39
Spart Moscow,2414,3,9,7,4,38,29,9,34
Krasnodar,2414,4,10,4,6,32,25,7,34
Zenit,2414,5,7,9,4,23,17,6,30
Terek Grozny,2414,6,7,6,7,22,25,-3,27
Din Moscow,2414,7,5,7,8,18,23,-5,22
FK Rubin,2414,8,5,6,9,21,20,1,21
Rostov,2414,9,4,7,9,11,18,-7,19
Amkar,2414,10,4,6,10,11,24,-13,18
Anzhi,2414,11,3,5,12,17,40,-23,14
Loko Moscow,2415,1,12,5,3,31,14,17,41
CSKA Moscow,2415,2,11,4,5,29,20,9,37
Spart Moscow,2415,3,10,6,4,39,28,11,36
Zenit,2415,4,8,9,3,25,15,10,33
Krasnodar,2415,5,9,4,7,32,27,5,31
Terek Grozny,2415,6,7,6,7,20,23,-3,27
Din Moscow,2415,7,6,7,7,19,22,-3,25
FK Rubin,2415,8,5,5,10,22,22,0,20
Amkar,2415,9,5,4,11,12,25,-13,19
Rostov,2415,10,4,6,10,10,19,-9,18
Anzhi,2415,11,2,6,12,15,39,-24,12
Loko Moscow,2416,1,13,5,2,35,14,21,44
CSKA Moscow,2416,2,11,3,6,33,22,11,36
Spart Moscow,2416,3,9,6,5,35,27,8,33
Zenit,2416,4,8,8,4,28,20,8,32
Terek Grozny,2416,5,9,5,6,25,24,1,32
Krasnodar,2416,6,8,4,8,29,28,1,28
FK Rubin,2416,7,6,6,8,23,18,5,24
Din Moscow,2416,8,5,8,7,17,21,-4,23
Rostov,2416,9,5,6,9,12,18,-6,21
Amkar,2416,10,4,4,12,9,25,-16,16
Anzhi,2416,11,2,5,13,16,45,-29,11
Loko Moscow,2417,1,12,6,2,30,11,19,42
Spart Moscow,2417,2,10,6,4,41,28,13,36
CSKA Moscow,2417,3,11,3,6,28,24,4,36
Zenit,2417,4,8,8,4,26,14,12,32
Krasnodar,2417,5,8,5,7,28,26,2,29
Terek Grozny,2417,6,8,5,7,22,24,-2,29
FK Rubin,2417,7,6,6,8,24,19,5,24
Din Moscow,2417,8,5,8,7,19,23,-4,23
Amkar,2417,9,5,4,11,12,25,-13,19
Rostov,2417,10,4,6,10,10,21,-11,18
Anzhi,2417,11,2,5,13,17,42,-25,11
Loko Moscow,2418,1,12,5,3,32,13,19,41
CSKA Moscow,2418,2,11,3,6,29,20,9,36
Spart Moscow,2418,3,10,5,5,38,28,10,35
Krasnodar,2418,4,10,4,6,30,24,6,34
Zenit,2418,5,8,8,4,24,18,6,32
Terek Grozny,2418,6,8,5,7,22,25,-3,29
Din Moscow,2418,7,6,6,8,19,23,-4,24
Rostov,2418,8,5,6,9,12,17,-5,21
FK Rubin,2418,9,5,5,10,21,19,2,20
Amkar,2418,10,4,4,12,10,27,-17,16
Anzhi,2418,11,3,5,12,16,39,-23,14
Loko Moscow,2419,1,13,5,2,34,13,21,44
CSKA Moscow,2419,2,11,3,6,26,20,6,36
Zenit,2419,3,8,8,4,25,15,10,32
Spart Moscow,2419,4,9,5,6,38,31,7,32
Krasnodar,2419,5,9,4,7,33,29,4,31
Terek Grozny,2419,6,7,7,6,21,23,-2,28
Din Moscow,2419,7,6,6,8,20,24,-4,24
FK Rubin,2419,8,6,5,9,24,22,2,23
Amkar,2419,9,5,5,10,12,24,-12,20
Rostov,2419,10,4,6,10,11,19,-8,18
Anzhi,2419,11,2,6,12,14,38,-24,12
Loko Moscow,2420,1,11,6,3,29,12,17,39
CSKA Moscow,2420,2,11,4,5,29,19,10,37
Spart Moscow,2420,3,9,6,5,37,31,6,33
Krasnodar,2420,4,9,5,6,29,25,4,32
Zenit,2420,5,7,10,3,23,15,8,31
Terek Grozny,2420,6,7,6,7,21,25,-4,27
FK Rubin,2420,7,6,6,8,26,18,8,24
Din Moscow,2420,8,5,7,8,19,27,-8,22
Rostov,2420,9,5,6,9,13,17,-4,21
Amkar,2420,10,4,5,11,11,25,-14,17
Anzhi,2420,11,3,5,12,16,39,-23,14
Loko Moscow,2421,1,11,6,3,30,13,17,39
CSKA Moscow,2421,2,12,3,5,31,20,11,39
Spart Moscow,2421,3,10,5,5,39,28,11,35
Krasnodar,2421,4,9,4,7,28,26,2,31
Zenit,2421,5,7,9,4,24,17,7,30
Terek Grozny,2421,6,8,5,7,22,24,-2,29
FK Rubin,2421,7,7,5,8,25,17,8,26
Din Moscow,2421,8,6,6,8,19,24,-5,24
Amkar,2421,9,5,4,11,11,24,-13,19
Rostov,2421,10,4,6,10,10,20,-10,18
Anzhi,2421,11,2,5,13,16,42,-26,11
Loko Moscow,2422,1,12,6,2,34,12,22,42
CSKA Moscow,2422,2,10,3,7,26,22,4,33
Spart Moscow,2422,3,9,5,6,37,29,8,32
Zenit,2422,4,8,8,4,25,18,7,32
Krasnodar,2422,5,8,5,7,29,27,2,29
Terek Grozny,2422,6,8,5,7,23,25,-2,29
FK Rubin,2422,7,7,5,8,25,19,6,26
Amkar,2422,8,6,4,10,13,23,-10,22
Rostov,2422,9,5,6,9,11,17,-6,21
Din Moscow,2422,10,5,6,9,19,26,-7,21
Anzhi,2422,11,3,5,12,16,40,-24,14
Loko Moscow,2423,1,11,7,2,30,12,18,40
CSKA Moscow,2423,2,12,3,5,31,17,14,39
Spart Moscow,2423,3,10,6,4,38,28,10,36
Zenit,2423,4,7,9,4,22,15,7,30
Krasnodar,2423,5,8,6,6,28,25,3,30
Terek Grozny,2423,6,7,6,7,21,24,-3,27
Din Moscow,2423,7,6,7,7,20,23,-3,25
FK Rubin,2423,8,5,6,9,22,19,3,21
Rostov,2423,9,4,6,10,11,19,-8,18
Amkar,2423,10,4,5,11,9,23,-14,17
Anzhi,2423,11,3,5,12,16,43,-27,14
Loko Moscow,2424,1,11,6,3,31,14,17,39
CSKA Moscow,2424,2,11,4,5,28,19,9,37
Zenit,2424,3,8,9,3,22,13,9,33
Spart Moscow,2424,4,8,5,7,35,31,4,29
Krasnodar,2424,5,8,5,7,29,29,0,29
Terek Grozny,2424,6,8,5,7,22,24,-2,29
Din Moscow,2424,7,7,6,7,20,21,-1,27
FK Rubin,2424,8,6,5,9,24,18,6,23
Amkar,2424,9,6,4,10,12,23,-11,22
Rostov,2424,10,5,6,9,12,18,-6,21
Anzhi,2424,11,2,5,13,17,42,-25,11
Loko Moscow,2425,1,12,5,3,31,13,18,41
Krasnodar,2425,2,10,4,6,31,25,6,34
CSKA Moscow,2425,3,10,3,7,26,23,3,33
Zenit,2425,4,8,8,4,25,16,9,32
Spart Moscow,2425,5,8,6,6,34,29,5,30
Terek Grozny,2425,6,7,6,7,22,25,-3,27
FK Rubin,2425,7,6,5,9,23,19,4,23
Din Moscow,2425,8,5,7,8,17,22,-5,22
Rostov,2425,9,5,6,9,13,18,-5,21
Amkar,2425,10,5,5,10,11,23,-12,20
Anzhi,2425,11,4,5,11,18,38,-20,17
Loko Moscow,2426,1,12,5,3,32,14,18,41
Krasnodar,2426,2,10,4,6,32,25,7,34
CSKA Moscow,2426,3,10,4,6,27,21,6,34
Spart Moscow,2426,4,8,7,5,35,29,6,31
Zenit,2426,5,7,9,4,22,15,7,30
Terek Grozny,2426,6,7,6,7,22,25,-3,27
Din Moscow,2426,7,5,8,7,20,24,-4,23
Amkar,2426,8,6,4,10,13,23,-10,22
FK Rubin,2426,9,5,6,9,23,22,1,21
Rostov,2426,10,4,7,9,11,18,-7,19
Anzhi,2426,11,3,6,11,19,40,-21,15
Loko Moscow,2427,1,12,6,2,31,12,19,42
CSKA Moscow,2427,2,10,3,7,26,20,6,33
Zenit,2427,3,8,8,4,22,14,8,32
Spart Moscow,2427,4,8,6,6,34,28,6,30
Terek Grozny,2427,5,8,6,6,23,23,0,30
Krasnodar,2427,6,8,5,7,28,26,2,29
Din Moscow,2427,7,6,7,7,18,21,-3,25
FK Rubin,2427,8,6,6,8,22,17,5,24
Amkar,2427,9,5,5,10,12,24,-12,20
Rostov,2427,10,4,7,9,10,17,-7,19
Anzhi,2427,11,3,5,12,16,40,-24,14
Loko Moscow,2428,1,11,7,2,32,14,18,40
CSKA Moscow,2428,2,11,3,6,28,19,9,36
Spart Moscow,2428,3,8,7,5,36,30,6,31
Zenit,2428,4,7,9,4,22,16,6,30
Krasnodar,2428,5,8,6,6,31,28,3,30
Terek Grozny,2428,6,8,6,6,22,23,-1,30
FK Rubin,2428,7,6,6,8,26,20,6,24
Din Moscow,2428,8,6,6,8,21,25,-4,24
Rostov,2428,9,4,7,9,10,17,-7,19
Amkar,2428,10,4,5,11,11,25,-14,17
Anzhi,2428,11,3,6,11,17,39,-22,15
Loko Moscow,2429,1,12,6,2,32,13,19,42
CSKA Moscow,2429,2,11,4,5,27,17,10,37
Spart Moscow,2429,3,9,5,6,36,29,7,32
Zenit,2429,4,7,10,3,23,15,8,31
Terek Grozny,2429,5,8,5,7,24,25,-1,29
Krasnodar,2429,6,8,4,8,28,27,1,28
FK Rubin,2429,7,7,5,8,26,18,8,26
Rostov,2429,8,5,6,9,11,17,-6,21
Din Moscow,2429,9,5,6,9,19,27,-8,21
Amkar,2429,10,5,4,11,11,25,-14,19
Anzhi,2429,11,3,5,12,16,40,-24,14
Loko Moscow,2430,1,12,5,3,31,12,19,41
CSKA Moscow,2430,2,12,3,5,31,18,13,39
Spart Moscow,2430,3,10,6,4,40,28,12,36
Zenit,2430,4,8,8,4,23,16,7,32
Krasnodar,2430,5,8,5,7,28,27,1,29
Terek Grozny,2430,6,8,5,7,22,25,-3,29
Din Moscow,2430,7,6,6,8,22,27,-5,24
FK Rubin,2430,8,5,6,9,24,22,2,21
Amkar,2430,9,5,5,10,12,23,-11,20
Rostov,2430,10,4,6,10,11,19,-8,18
Anzhi,2430,11,2,5,13,15,42,-27,11
Loko Moscow,2431,1,11,6,3,31,14,17,39
Spart Moscow,2431,2,10,5,5,36,27,9,35
CSKA Moscow,2431,3,10,5,5,27,19,8,35
Zenit,2431,4,7,10,3,21,13,8,31
Krasnodar,2431,5,9,4,7,30,27,3,31
Terek Grozny,2431,6,8,6,6,21,22,-1,30
FK Rubin,2431,7,7,5,8,24,18,6,26
Din Moscow,2431,8,5,6,9,19,25,-6,21
Amkar,2431,9,5,5,10,10,22,-12,20
Rostov,2431,10,4,6,10,10,18,-8,18
Anzhi,2431,11,2,6,12,16,40,-24,12
Loko Moscow,2432,1,11,6,3,31,14,17,39
CSKA Moscow,2432,2,11,4,5,29,20,9,37
Spart Moscow,2432,3,10,5,5,36,29,7,35
Zenit,2432,4,7,10,3,25,17,8,31
Krasnodar,2432,5,9,4,7,28,25,3,31
Terek Grozny,2432,6,7,6,7,21,25,-4,27
Din Moscow,2432,7,6,6,8,19,23,-4,24
FK Rubin,2432,8,6,5,9,23,19,4,23
Amkar,2432,9,6,4,10,15,23,-8,22
Rostov,2432,10,4,6,10,11,19,-8,18
Anzhi,2432,11,2,6,12,15,39,-24,12
Loko Moscow,2433,1,11,7,2,31,13,18,40
CSKA Moscow,2433,2,11,4,5,28,18,10,37
Spart Moscow,2433,3,10,5,5,37,29,8,35
Krasnodar,2433,4,9,5,6,29,25,4,32
Zenit,2433,5,7,10,3,23,15,8,31
Terek Grozny,2433,6,8,5,7,21,24,-3,29
Din Moscow,2433,7,6,6,8,20,23,-3,24
FK Rubin,2433,8,5,5,10,21,20,1,20
Amkar,2433,9,5,4,11,11,23,-12,19
Rostov,2433,10,4,6,10,11,19,-8,18
Anzhi,2433,11,3,5,12,16,39,-23,14
Loko Moscow,2434,1,12,6,2,33,13,20,42
CSKA Moscow,2434,2,11,3,6,27,18,9,36
Spart Moscow,2434,3,10,5,5,41,31,10,35
Zenit,2434,4,8,9,3,23,14,9,33
Krasnodar,2434,5,9,4,7,31,29,2,31
Terek Grozny,2434,6,8,5,7,22,25,-3,29
FK Rubin,2434,7,6,5,9,25,20,5,23
Din Moscow,2434,8,5,6,9,21,28,-7,21
Amkar,2434,9,5,4,11,10,23,-13,19
Rostov,2434,10,4,6,10,11,20,-9,18
Anzhi,2434,11,3,5,12,17,40,-23,14
Loko Moscow,2435,1,12,5,3,31,15,16,41
CSKA Moscow,2435,2,12,3,5,31,19,12,39
Zenit,2435,3,8,8,4,26,15,11,32
Spart Moscow,2435,4,8,7,5,37,32,5,31
Krasnodar,2435,5,9,4,7,31,27,4,31
Terek Grozny,2435,6,8,6,6,22,23,-1,30
FK Rubin,2435,7,6,5,9,23,21,2,23
Din Moscow,2435,8,5,7,8,18,23,-5,22
Amkar,2435,9,5,5,10,13,23,-10,20
Rostov,2435,10,4,7,9,13,20,-7,19
Anzhi,2435,11,2,5,13,15,42,-27,11
Loko Moscow,2436,1,11,7,2,31,13,18,40
CSKA Moscow,2436,2,11,3,6,30,19,11,36
Spart Moscow,2436,3,9,7,4,40,29,11,34
Zenit,2436,4,8,9,3,24,15,9,33
Krasnodar,2436,5,9,5,6,29,25,4,32
Terek Grozny,2436,6,8,6,6,23,23,0,30
Din Moscow,2436,7,5,7,8,19,26,-7,22
FK Rubin,2436,8,5,6,9,21,18,3,21
Rostov,2436,9,4,7,9,12,19,-7,19
Amkar,2436,10,4,5,11,9,24,-15,17
Anzhi,2436,11,2,6,12,15,42,-27,12
Loko Moscow,2437,1,12,5,3,31,13,18,41
CSKA Moscow,2437,2,11,4,5,28,19,9,37
Spart Moscow,2437,3,10,5,5,40,32,8,35
Krasnodar,2437,4,10,4,6,30,24,6,34
Zenit,2437,5,7,8,5,23,17,6,29
Terek Grozny,2437,6,8,5,7,21,24,-3,29
Din Moscow,2437,7,6,6,8,21,24,-3,24
FK Rubin,2437,8,5,5,10,21,21,0,20
Amkar,2437,9,5,4,11,13,25,-12,19
Rostov,2437,10,4,6,10,11,19,-8,18
Anzhi,2437,11,3,6,11,17,38,-21,15
Loko Moscow,2438,1,12,6,2,30,11,19,42
CSKA Moscow,2438,2,11,3,6,26,19,7,36
Spart Moscow,2438,3,9,7,4,37,26,11,34
Zenit,2438,4,7,9,4,21,14,7,30
Terek Grozny,2438,5,8,5,7,24,26,-2,29
Krasnodar,2438,6,8,4,8,28,28,0,28
FK Rubin,2438,7,7,5,8,25,18,7,26
Din Moscow,2438,8,5,7,8,17,22,-5,22
Rostov,2438,9,4,7,9,11,18,-7,19
Amkar,2438,10,5,4,11,10,25,-15,19
Anzhi,2438,11,3,5,12,19,41,-22,14
Loko Moscow,2439,1,11,6,3,31,14,17,39
CSKA Moscow,2439,2,12,3,5,29,18,11,39
Spart Moscow,2439,3,11,5,4,45,25,20,38
Krasnodar,2439,4,9,5,6,30,26,4,32
Zenit,2439,5,7,9,4,22,16,6,30
Terek Grozny,2439,6,7,6,7,23,26,-3,27
FK Rubin,2439,7,5,7,8,23,19,4,22
Din Moscow,2439,8,5,7,8,18,24,-6,22
Amkar,2439,9,5,4,11,10,28,-18,19
Rostov,2439,10,4,6,10,10,21,-11,18
Anzhi,2439,11,2,6,12,18,42,-24,12
Loko Moscow,2440,1,12,5,3,34,14,20,41
CSKA Moscow,2440,2,12,3,5,30,17,13,39
Spart Moscow,2440,3,10,5,5,36,29,7,35
Krasnodar,2440,4,10,4,6,32,26,6,34
Terek Grozny,2440,5,8,6,6,23,24,-1,30
Zenit,2440,6,7,8,5,22,20,2,29
Din Moscow,2440,7,7,6,7,23,22,1,27
FK Rubin,2440,8,5,5,10,22,22,0,20
Rostov,2440,9,4,6,10,10,18,-8,18
Amkar,2440,10,4,5,11,10,24,-14,17
Anzhi,2440,11,2,5,13,15,41,-26,11
Loko Moscow,2441,1,11,6,3,30,13,17,39
CSKA Moscow,2441,2,12,3,5,31,20,11,39
Zenit,2441,3,8,8,4,25,17,8,32
Krasnodar,2441,4,9,5,6,29,25,4,32
Spart Moscow,2441,5,8,6,6,34,29,5,30
Terek Grozny,2441,6,8,6,6,24,23,1,30
Din Moscow,2441,7,5,8,7,20,24,-4,23
FK Rubin,2441,8,5,6,9,24,21,3,21
Rostov,2441,9,5,6,9,12,17,-5,21
Amkar,2441,10,5,5,10,11,23,-12,20
Anzhi,2441,11,2,5,13,15,43,-28,11
Loko Moscow,2442,1,13,5,2,31,11,20,44
Spart Moscow,2442,2,11,5,4,40,26,14,38
CSKA Moscow,2442,3,10,3,7,26,20,6,33
Zenit,2442,4,8,8,4,23,15,8,32
Krasnodar,2442,5,9,4,7,29,26,3,31
Terek Grozny,2442,6,8,6,6,22,23,-1,30
Din Moscow,2442,7,5,7,8,18,24,-6,22
FK Rubin,2442,8,5,6,9,23,20,3,21
Rostov,2442,9,4,6,10,10,20,-10,18
Amkar,2442,10,4,5,11,11,25,-14,17
Anzhi,2442,11,3,5,12,15,38,-23,14
Loko Moscow,2443,1,12,6,2,30,11,19,42
Spart Moscow,2443,2,10,6,4,39,26,13,36
CSKA Moscow,2443,3,10,4,6,26,21,5,34
Zenit,2443,4,8,9,3,24,13,11,33
Terek Grozny,2443,5,9,5,6,26,22,4,32
Krasnodar,2443,6,8,4,8,28,27,1,28
Din Moscow,2443,7,6,6,8,19,23,-4,24
FK Rubin,2443,8,6,5,9,23,20,3,23
Rostov,2443,9,4,6,10,10,20,-10,18
Amkar,2443,10,4,5,11,10,27,-17,17
Anzhi,2443,11,2,6,12,15,40,-25,12
Loko Moscow,2444,1,11,6,3,31,15,16,39
Spart Moscow,2444,2,11,5,4,40,25,15,38
CSKA Moscow,2444,3,11,3,6,28,18,10,36
Krasnodar,2444,4,10,4,6,31,24,7,34
Zenit,2444,5,8,9,3,24,15,9,33
Terek Grozny,2444,6,8,5,7,21,23,-2,29
FK Rubin,2444,7,6,5,9,23,19,4,23
Din Moscow,2444,8,5,6,9,17,26,-9,21
Amkar,2444,9,5,4,11,10,23,-13,19
Rostov,2444,10,4,6,10,10,20,-10,18
Anzhi,2444,11,2,5,13,14,41,-27,11
Loko Moscow,2445,1,12,6,2,33,13,20,42
CSKA Moscow,2445,2,11,3,6,29,19,10,36
Spart Moscow,2445,3,10,5,5,39,29,10,35
Zenit,2445,4,8,8,4,24,17,7,32
Krasnodar,2445,5,8,5,7,29,27,2,29
Terek Grozny,2445,6,8,5,7,22,24,-2,29
Din Moscow,2445,7,6,6,8,19,24,-5,24
FK Rubin,2445,8,6,5,9,23,19,4,23
Rostov,2445,9,5,6,9,12,18,-6,21
Amkar,2445,10,5,4,11,11,24,-13,19
Anzhi,2445,11,2,5,13,15,42,-27,11
Loko Moscow,2446,1,13,5,2,33,12,21,44
CSKA Moscow,2446,2,11,3,6,29,20,9,36
Zenit,2446,3,8,8,4,23,16,7,32
Spart Moscow,2446,4,8,7,5,33,27,6,31
Krasnodar,2446,5,8,5,7,29,27,2,29
Terek Grozny,2446,6,7,6,7,21,24,-3,27
Din Moscow,2446,7,5,8,7,17,21,-4,23
FK Rubin,2446,8,5,7,8,22,18,4,22
Amkar,2446,9,5,5,10,11,22,-11,20
Rostov,2446,10,4,7,9,10,17,-7,19
Anzhi,2446,11,3,5,12,17,41,-24,14
Loko Moscow,2447,1,12,6,2,31,12,19,42
Spart Moscow,2447,2,11,5,4,40,26,14,38
CSKA Moscow,2447,3,10,4,6,26,19,7,34
Zenit,2447,4,7,10,3,21,13,8,31
Terek Grozny,2447,5,8,6,6,24,25,-1,30
Krasnodar,2447,6,8,5,7,29,27,2,29
FK Rubin,2447,7,6,6,8,23,18,5,24
Din Moscow,2447,8,5,6,9,17,25,-8,21
Rostov,2447,9,4,6,10,11,19,-8,18
Amkar,2447,10,4,5,11,10,25,-15,17
Anzhi,2447,11,3,5,12,18,41,-23,14
Loko Moscow,2448,1,11,5,4,29,16,13,38
CSKA Moscow,2448,2,11,3,6,30,21,9,36
Zenit,2448,3,9,8,3,25,15,10,35
Spart Moscow,2448,4,10,5,5,37,28,9,35
Krasnodar,2448,5,10,4,6,34,24,10,34
Terek Grozny,2448,6,7,7,6,22,24,-2,28
Din Moscow,2448,7,5,7,8,18,24,-6,22
FK Rubin,2448,8,5,6,9,22,21,1,21
Amkar,2448,9,5,5,10,12,23,-11,20
Rostov,2448,10,4,6,10,11,19,-8,18
Anzhi,2448,11,2,6,12,16,41,-25,12
CSKA Moscow,2449,1,12,3,5,33,17,16,39
Loko Moscow,2449,2,11,6,3,30,15,15,39
Krasnodar,2449,3,9,5,6,31,25,6,32
Spart Moscow,2449,4,8,7,5,36,29,7,31
Zenit,2449,5,7,9,4,22,18,4,30
Terek Grozny,2449,6,8,5,7,26,25,1,29
Din Moscow,2449,7,5,8,7,18,22,-4,23
FK Rubin,2449,8,5,7,8,23,19,4,22
Rostov,2449,9,5,6,9,13,19,-6,21
Amkar,2449,10,5,5,10,13,25,-12,20
Anzhi,2449,11,2,5,13,14,45,-31,11
Loko Moscow,2450,1,13,5,2,31,11,20,44
CSKA Moscow,2450,2,12,3,5,27,17,10,39
Spart Moscow,2450,3,10,5,5,37,28,9,35
Zenit,2450,4,7,8,5,21,15,6,29
Terek Grozny,2450,5,8,5,7,21,25,-4,29
Krasnodar,2450,6,8,4,8,29,29,0,28
Din Moscow,2450,7,6,7,7,20,23,-3,25
FK Rubin,2450,8,6,6,8,26,20,6,24
Amkar,2450,9,5,4,11,13,24,-11,19
Rostov,2450,10,4,6,10,10,18,-8,18
Anzhi,2450,11,2,5,13,14,39,-25,11
Loko Moscow,2451,1,13,5,2,34,13,21,44
Spart Moscow,2451,2,10,6,4,36,25,11,36
CSKA Moscow,2451,3,10,3,7,28,23,5,33
Zenit,2451,4,8,8,4,26,18,8,32
Krasnodar,2451,5,8,5,7,28,26,2,29
Terek Grozny,2451,6,8,5,7,21,23,-2,29
FK Rubin,2451,7,6,6,8,25,19,6,24
Din Moscow,2451,8,5,6,9,19,27,-8,21
Amkar,2451,9,5,5,10,10,22,-12,20
Rostov,2451,10,4,6,10,10,18,-8,18
Anzhi,2451,11,3,5,12,16,39,-23,14
Loko Moscow,2452,1,12,6,2,32,13,19,42
CSKA Moscow,2452,2,11,4,5,27,18,9,37
Spart Moscow,2452,3,9,5,6,38,29,9,32
Krasnodar,2452,4,9,5,6,30,26,4,32
Terek Grozny,2452,5,8,6,6,21,22,-1,30
Zenit,2452,6,7,8,5,22,16,6,29
Din Moscow,2452,7,6,7,7,22,24,-2,25
FK Rubin,2452,8,5,6,9,24,21,3,21
Amkar,2452,9,5,4,11,10,23,-13,19
Rostov,2452,10,4,6,10,10,21,-11,18
Anzhi,2452,11,2,7,11,15,38,-23,13
Loko Moscow,2453,1,12,6,2,32,13,19,42
CSKA Moscow,2453,2,11,3,6,28,20,8,36
Zenit,2453,3,8,8,4,24,15,9,32
Spart Moscow,2453,4,9,5,6,36,28,8,32
Krasnodar,2453,5,9,5,6,35,27,8,32
Terek Grozny,2453,6,8,5,7,21,23,-2,29
Din Moscow,2453,7,7,6,7,21,22,-1,27
Amkar,2453,8,6,4,10,12,22,-10,22
FK Rubin,2453,9,5,5,10,23,26,-3,20
Rostov,2453,10,4,6,10,10,20,-10,18
Anzhi,2453,11,2,5,13,14,40,-26,11
Loko Moscow,2454,1,11,6,3,33,16,17,39
Zenit,2454,2,9,8,3,25,15,10,35
CSKA Moscow,2454,3,10,4,6,28,21,7,34
Spart Moscow,2454,4,8,8,4,37,29,8,32
Krasnodar,2454,5,9,5,6,30,26,4,32
Terek Grozny,2454,6,9,5,6,26,25,1,32
FK Rubin,2454,7,6,5,9,22,18,4,23
Din Moscow,2454,8,5,7,8,18,23,-5,22
Rostov,2454,9,4,7,9,12,19,-7,19
Amkar,2454,10,4,5,11,12,26,-14,17
Anzhi,2454,11,2,6,12,18,43,-25,12
Loko Moscow,2455,1,12,6,2,31,12,19,42
Spart Moscow,2455,2,10,6,4,38,27,11,36
CSKA Moscow,2455,3,10,5,5,27,19,8,35
Zenit,2455,4,7,10,3,21,13,8,31
Krasnodar,2455,5,9,4,7,30,26,4,31
Terek Grozny,2455,6,8,5,7,23,23,0,29
Din Moscow,2455,7,6,6,8,18,23,-5,24
FK Rubin,2455,8,5,5,10,21,20,1,20
Rostov,2455,9,4,7,9,11,18,-7,19
Amkar,2455,10,4,4,12,10,27,-17,16
Anzhi,2455,11,3,6,11,17,39,-22,15
Loko Moscow,2456,1,11,6,3,31,16,15,39
CSKA Moscow,2456,2,11,3,6,27,20,7,36
Krasnodar,2456,3,10,4,6,32,24,8,34
Zenit,2456,4,8,9,3,25,15,10,33
Spart Moscow,2456,5,8,7,5,37,32,5,31
Terek Grozny,2456,6,8,6,6,21,22,-1,30
FK Rubin,2456,7,6,5,9,22,19,3,23
Din Moscow,2456,8,5,7,8,19,24,-5,22
Rostov,2456,9,4,7,9,11,18,-7,19
Amkar,2456,10,5,4,11,13,24,-11,19
Anzhi,2456,11,2,6,12,15,39,-24,12
Loko Moscow,2457,1,12,6,2,32,13,19,42
Spart Moscow,2457,2,11,5,4,40,27,13,38
CSKA Moscow,2457,3,10,5,5,25,17,8,35
Krasnodar,2457,4,9,5,6,30,26,4,32
Zenit,2457,5,7,9,4,21,14,7,30
Terek Grozny,2457,6,7,7,6,22,24,-2,28
Din Moscow,2457,7,5,7,8,19,24,-5,22
FK Rubin,2457,8,5,6,9,22,19,3,21
Rostov,2457,9,4,6,10,10,19,-9,18
Amkar,2457,10,4,5,11,12,27,-15,17
Anzhi,2457,11,2,7,11,14,37,-23,13
Loko Moscow,2458,1,12,6,2,30,11,19,42
CSKA Moscow,2458,2,11,4,5,27,18,9,37
Spart Moscow,2458,3,9,6,5,38,28,10,33
Zenit,2458,4,7,9,4,21,14,7,30
Krasnodar,2458,5,8,5,7,28,26,2,29
Terek Grozny,2458,6,7,5,8,22,28,-6,26
Din Moscow,2458,7,6,7,7,20,22,-2,25
Amkar,2458,8,6,4,10,14,25,-11,22
FK Rubin,2458,9,5,6,9,22,20,2,21
Rostov,2458,10,4,6,10,10,20,-10,18
Anzhi,2458,11,3,6,11,18,38,-20,15
Loko Moscow,2459,1,12,6,2,33,13,20,42
CSKA Moscow,2459,2,12,3,5,31,18,13,39
Spart Moscow,2459,3,10,5,5,36,27,9,35
Krasnodar,2459,4,9,5,6,30,25,5,32
Zenit,2459,5,7,8,5,22,17,5,29
Terek Grozny,2459,6,7,7,6,21,23,-2,28
Din Moscow,2459,7,5,7,8,18,23,-5,22
FK Rubin,2459,8,5,6,9,22,20,2,21
Rostov,2459,9,5,6,9,12,17,-5,21
Amkar,2459,10,4,5,11,10,25,-15,17
Anzhi,2459,11,2,6,12,15,42,-27,12
Loko Moscow,2460,1,11,5,4,29,13,16,38
Spart Moscow,2460,2,10,6,4,40,28,12,36
Zenit,2460,3,9,8,3,24,14,10,35
CSKA Moscow,2460,4,10,4,6,28,21,7,34
Krasnodar,2460,5,10,4,6,30,25,5,34
Terek Grozny,2460,6,8,5,7,23,25,-2,29
FK Rubin,2460,7,6,5,9,24,19,5,23
Din Moscow,2460,8,5,6,9,18,25,-7,21
Amkar,2460,9,5,5,10,14,25,-11,20
Rostov,2460,10,4,6,10,10,20,-10,18
Anzhi,2460,11,2,6,12,16,41,-25,12
Loko Moscow,2461,1,12,5,3,31,14,17,41
CSKA Moscow,2461,2,11,4,5,28,18,10,37
Krasnodar,2461,3,9,4,7,29,25,4,31
Zenit,2461,4,7,8,5,22,17,5,29
Spart Moscow,2461,5,8,5,7,36,33,3,29
Terek Grozny,2461,6,8,5,7,22,26,-4,29
Din Moscow,2461,7,6,7,7,21,24,-3,25
FK Rubin,2461,8,6,6,8,23,18,5,24
Amkar,2461,9,6,4,10,15,23,-8,22
Rostov,2461,10,5,6,9,13,18,-5,21
Anzhi,2461,11,2,6,12,15,39,-24,12
Loko Moscow,2462,1,12,5,3,32,13,19,41
CSKA Moscow,2462,2,11,3,6,28,19,9,36
Spart Moscow,2462,3,9,6,5,39,31,8,33
Zenit,2462,4,8,8,4,23,15,8,32
Krasnodar,2462,5,9,4,7,29,27,2,31
Terek Grozny,2462,6,8,6,6,22,23,-1,30
Din Moscow,2462,7,6,6,8,22,24,-2,24
FK Rubin,2462,8,6,5,9,22,19,3,23
Rostov,2462,9,4,6,10,10,20,-10,18
Amkar,2462,10,4,5,11,10,24,-14,17
Anzhi,2462,11,3,6,11,17,39,-22,15
Loko Moscow,2463,1,12,5,3,33,15,18,41
CSKA Moscow,2463,2,11,4,5,28,18,10,37
Krasnodar,2463,3,10,4,6,32,26,6,34
Spart Moscow,2463,4,9,6,5,36,27,9,33
Zenit,2463,5,7,9,4,22,16,6,30
Terek Grozny,2463,6,7,5,8,22,27,-5,26
Din Moscow,2463,7,6,6,8,19,23,-4,24
FK Rubin,2463,8,6,5,9,22,18,4,23
Amkar,2463,9,5,5,10,11,22,-11,20
Rostov,2463,10,4,6,10,10,19,-9,18
Anzhi,2463,11,3,5,12,17,41,-24,14
Loko Moscow,2464,1,11,6,3,33,16,17,39
CSKA Moscow,2464,2,11,4,5,26,17,9,37
Spart Moscow,2464,3,10,5,5,37,27,10,35
Terek Grozny,2464,4,9,5,6,22,22,0,32
Zenit,2464,5,7,10,3,22,14,8,31
Krasnodar,2464,6,9,4,7,31,30,1,31
FK Rubin,2464,7,6,6,8,25,18,7,24
Din Moscow,2464,8,5,7,8,19,24,-5,22
Amkar,2464,9,5,4,11,10,23,-13,19
Rostov,2464,10,4,6,10,10,19,-9,18
Anzhi,2464,11,2,5,13,14,39,-25,11
Loko Moscow,2465,1,12,5,3,31,12,19,41
Krasnodar,2465,2,10,4,6,30,25,5,34
Spart Moscow,2465,3,9,6,5,37,31,6,33
CSKA Moscow,2465,4,10,3,7,27,22,5,33
Zenit,2465,5,8,8,4,24,16,8,32
Terek Grozny,2465,6,9,5,6,26,26,0,32
Din Moscow,2465,7,6,6,8,20,24,-4,24
FK Rubin,2465,8,5,5,10,22,20,2,20
Rostov,2465,9,4,7,9,11,18,-7,19
Amkar,2465,10,5,4,11,13,24,-11,19
Anzhi,2465,11,3,5,12,19,42,-23,14
Loko Moscow,2466,1,12,5,3,34,15,19,41
Spart Moscow,2466,2,10,6,4,41,30,11,36
CSKA Moscow,2466,3,11,3,6,28,19,9,36
Zenit,2466,4,8,8,4,24,16,8,32
Krasnodar,2466,5,9,4,7,32,29,3,31
Terek Grozny,2466,6,7,5,8,21,25,-4,26
FK Rubin,2466,7,6,6,8,24,19,5,24
Din Moscow,2466,8,5,7,8,19,25,-6,22
Rostov,2466,9,4,7,9,12,19,-7,19
Amkar,2466,10,5,4,11,12,25,-13,19
Anzhi,2466,11,3,5,12,15,40,-25,14
Loko Moscow,2467,1,12,5,3,33,14,19,41
CSKA Moscow,2467,2,12,3,5,29,18,11,39
Spart Moscow,2467,3,10,5,5,40,27,13,35
Krasnodar,2467,4,9,4,7,31,29,2,31
Zenit,2467,5,7,8,5,22,17,5,29
Terek Grozny,2467,6,7,6,7,21,26,-5,27
FK Rubin,2467,7,7,5,8,25,18,7,26
Rostov,2467,8,5,6,9,11,17,-6,21
Din Moscow,2467,9,5,6,9,18,26,-8,21
Amkar,2467,10,4,5,11,10,26,-16,17
Anzhi,2467,11,3,5,12,17,39,-22,14
Loko Moscow,2468,1,11,6,3,29,12,17,39
CSKA Moscow,2468,2,11,3,6,27,19,8,36
Zenit,2468,3,9,8,3,23,13,10,35
Spart Moscow,2468,4,10,5,5,36,27,9,35
Krasnodar,2468,5,9,5,6,30,26,4,32
Terek Grozny,2468,6,7,5,8,20,28,-8,26
FK Rubin,2468,7,6,5,9,26,21,5,23
Amkar,2468,8,6,4,10,13,22,-9,22
Din Moscow,2468,9,5,6,9,19,26,-7,21
Rostov,2468,10,4,6,10,10,18,-8,18
Anzhi,2468,11,3,5,12,18,39,-21,14
Loko Moscow,2469,1,12,5,3,32,14,18,41
CSKA Moscow,2469,2,11,4,5,27,17,10,37
Spart Moscow,2469,3,9,7,4,36,27,9,34
Zenit,2469,4,8,9,3,23,14,9,33
Krasnodar,2469,5,9,4,7,29,26,3,31
Terek Grozny,2469,6,7,6,7,22,25,-3,27
Din Moscow,2469,7,5,7,8,17,22,-5,22
FK Rubin,2469,8,5,6,9,21,18,3,21
Rostov,2469,9,4,7,9,11,18,-7,19
Amkar,2469,10,4,6,10,11,24,-13,18
Anzhi,2469,11,3,5,12,16,40,-24,14
Loko Moscow,2470,1,12,5,3,32,14,18,41
Spart Moscow,2470,2,10,5,5,41,27,14,35
CSKA Moscow,2470,3,10,5,5,26,18,8,35
Krasnodar,2470,4,10,4,6,32,25,7,34
Zenit,2470,5,7,9,4,21,16,5,30
Terek Grozny,2470,6,8,6,6,24,23,1,30
Din Moscow,2470,7,6,6,8,19,23,-4,24
FK Rubin,2470,8,6,5,9,23,19,4,23
Rostov,2470,9,4,6,10,10,22,-12,18
Amkar,2470,10,4,5,11,10,25,-15,17
Anzhi,2470,11,2,6,12,15,41,-26,12
Loko Moscow,2471,1,13,5,2,34,13,21,44
CSKA Moscow,2471,2,11,4,5,29,18,11,37
Spart Moscow,2471,3,9,6,5,39,28,11,33
Terek Grozny,2471,4,9,5,6,22,22,0,32
Zenit,2471,5,7,8,5,23,20,3,29
Krasnodar,2471,6,8,5,7,27,25,2,29
Din Moscow,2471,7,6,6,8,19,26,-7,24
FK Rubin,2471,8,5,6,9,21,18,3,21
Rostov,2471,9,5,6,9,11,17,-6,21
Amkar,2471,10,4,5,11,10,24,-14,17
Anzhi,2471,11,2,6,12,15,39,-24,12
Loko Moscow,2472,1,12,6,2,33,14,19,42
CSKA Moscow,2472,2,11,3,6,27,19,8,36
Spart Moscow,2472,3,9,6,5,36,28,8,33
Zenit,2472,4,8,8,4,24,16,8,32
Terek Grozny,2472,5,9,5,6,25,23,2,32
Krasnodar,2472,6,8,5,7,29,27,2,29
FK Rubin,2472,7,7,5,8,24,18,6,26
Din Moscow,2472,8,6,6,8,19,23,-4,24
Rostov,2472,9,4,6,10,10,18,-8,18
Amkar,2472,10,4,5,11,11,26,-15,17
Anzhi,2472,11,2,5,13,15,41,-26,11
Loko Moscow,2473,1,12,5,3,31,13,18,41
CSKA Moscow,2473,2,11,4,5,28,19,9,37
Spart Moscow,2473,3,10,6,4,35,25,10,36
Zenit,2473,4,8,8,4,22,14,8,32
Krasnodar,2473,5,9,4,7,30,27,3,31
Terek Grozny,2473,6,8,5,7,23,26,-3,29
Din Moscow,2473,7,6,6,8,18,22,-4,24
FK Rubin,2473,8,5,5,10,22,20,2,20
Amkar,2473,9,5,5,10,11,22,-11,20
Rostov,2473,10,4,6,10,10,18,-8,18
Anzhi,2473,11,2,6,12,18,42,-24,12
Loko Moscow,2474,1,12,6,2,34,13,21,42
CSKA Moscow,2474,2,11,3,6,27,19,8,36
Spart Moscow,2474,3,9,5,6,37,30,7,32
Zenit,2474,4,8,8,4,23,16,7,32
Krasnodar,2474,5,8,5,7,30,28,2,29
Terek Grozny,2474,6,7,6,7,23,26,-3,27
FK Rubin,2474,7,6,6,8,25,20,5,24
Din Moscow,2474,8,5,7,8,20,25,-5,22
Rostov,2474,9,5,6,9,12,18,-6,21
Amkar,2474,10,5,5,10,12,24,-12,20
Anzhi,2474,11,3,5,12,17,41,-24,14
Loko Moscow,2475,1,12,5,3,31,14,17,41
Spart Moscow,2475,2,11,5,4,43,27,16,38
Krasnodar,2475,3,10,4,6,31,24,7,34
CSKA Moscow,2475,4,10,4,6,26,20,6,34
Zenit,2475,5,8,8,4,24,15,9,32
Terek Grozny,2475,6,9,5,6,25,25,0,32
FK Rubin,2475,7,6,5,9,23,20,3,23
Din Moscow,2475,8,5,6,9,19,29,-10,21
Rostov,2475,9,4,6,10,11,19,-8,18
Amkar,2475,10,4,4,12,10,26,-16,16
Anzhi,2475,11,2,6,12,17,41,-24,12
Loko Moscow,2476,1,12,5,3,31,14,17,41
CSKA Moscow,2476,2,11,3,6,30,20,10,36
Zenit,2476,3,8,8,4,24,15,9,32
Spart Moscow,2476,4,9,5,6,37,29,8,32
Krasnodar,2476,5,9,5,6,31,25,6,32
Din Moscow,2476,6,7,6,7,21,23,-2,27
Terek Grozny,2476,7,7,6,7,22,25,-3,27
FK Rubin,2476,8,5,6,9,23,20,3,21
Rostov,2476,9,5,6,9,12,18,-6,21
Amkar,2476,10,5,4,11,10,24,-14,19
Anzhi,2476,11,2,6,12,16,44,-28,12
Loko Moscow,2477,1,11,5,4,29,15,14,38
Spart Moscow,2477,2,10,6,4,39,27,12,36
CSKA Moscow,2477,3,11,3,6,27,18,9,36
Krasnodar,2477,4,10,4,6,31,25,6,34
Zenit,2477,5,8,8,4,23,15,8,32
Terek Grozny,2477,6,8,5,7,21,25,-4,29
FK Rubin,2477,7,6,5,9,24,19,5,23
Din Moscow,2477,8,5,6,9,17,25,-8,21
Rostov,2477,9,4,7,9,11,18,-7,19
Anzhi,2477,10,4,5,11,18,37,-19,17
Amkar,2477,11,4,4,12,10,26,-16,16
Loko Moscow,2478,1,12,5,3,31,14,17,41
CSKA Moscow,2478,2,11,4,5,26,17,9,37
Zenit,2478,3,8,9,3,24,14,10,33
Spart Moscow,2478,4,9,5,6,35,30,5,32
Krasnodar,2478,5,9,4,7,31,25,6,31
Din Moscow,2478,6,7,6,7,20,22,-2,27
Terek Grozny,2478,7,7,5,8,20,26,-6,26
Rostov,2478,8,5,6,9,13,17,-4,21
FK Rubin,2478,9,5,5,10,22,23,-1,20
Amkar,2478,10,5,4,11,12,24,-12,19
Anzhi,2478,11,3,5,12,16,38,-22,14
Loko Moscow,2479,1,11,6,3,31,14,17,39
CSKA Moscow,2479,2,11,3,6,28,21,7,36
Spart Moscow,2479,3,10,5,5,36,27,9,35
Krasnodar,2479,4,10,4,6,34,27,7,34
Zenit,2479,5,8,9,3,24,14,10,33
Terek Grozny,2479,6,7,7,6,22,24,-2,28
Din Moscow,2479,7,6,7,7,20,23,-3,25
FK Rubin,2479,8,5,6,9,24,23,1,21
Rostov,2479,9,4,6,10,10,18,-8,18
Amkar,2479,10,4,5,11,10,24,-14,17
Anzhi,2479,11,2,6,12,17,41,-24,12
Loko Moscow,2480,1,11,5,4,29,14,15,38
CSKA Moscow,2480,2,11,4,5,27,18,9,37
Spart Moscow,2480,3,9,7,4,41,28,13,34
Zenit,2480,4,8,9,3,23,14,9,33
Terek Grozny,2480,5,9,5,6,24,24,0,32
Krasnodar,2480,6,9,4,7,30,26,4,31
Din Moscow,2480,7,6,7,7,21,24,-3,25
FK Rubin,2480,8,6,5,9,24,20,4,23
Rostov,2480,9,4,7,9,11,18,-7,19
Amkar,2480,10,4,4,12,10,29,-19,16
Anzhi,2480,11,2,5,13,15,40,-25,11
Loko Moscow,2481,1,13,5,2,35,13,22,44
CSKA Moscow,2481,2,11,4,5,27,17,10,37
Spart Moscow,2481,3,10,5,5,37,28,9,35
Zenit,2481,4,7,9,4,21,16,5,30
Krasnodar,2481,5,8,5,7,30,28,2,29
Terek Grozny,2481,6,7,7,6,21,23,-2,28
FK Rubin,2481,7,6,6,8,24,19,5,24
Din Moscow,2481,8,6,6,8,20,24,-4,24
Rostov,2481,9,4,6,10,10,18,-8,18
Amkar,2481,10,4,5,11,10,24,-14,17
Anzhi,2481,11,2,6,12,15,40,-25,12
Loko Moscow,2482,1,12,6,2,33,13,20,42
CSKA Moscow,2482,2,11,4,5,29,19,10,37
Spart Moscow,2482,3,10,6,4,38,26,12,36
Zenit,2482,4,7,10,3,24,16,8,31
Krasnodar,2482,5,9,4,7,29,26,3,31
Terek Grozny,2482,6,7,7,6,21,23,-2,28
Din Moscow,2482,7,6,6,8,19,25,-6,24
FK Rubin,2482,8,5,5,10,22,21,1,20
Rostov,2482,9,4,7,9,10,17,-7,19
Amkar,2482,10,4,5,11,10,24,-14,17
Anzhi,2482,11,2,6,12,16,41,-25,12
Loko Moscow,2483,1,12,6,2,31,12,19,42
CSKA Moscow,2483,2,10,5,5,27,19,8,35
Spart Moscow,2483,3,9,7,4,43,30,13,34
Zenit,2483,4,7,10,3,23,15,8,31
Krasnodar,2483,5,8,5,7,27,25,2,29
Terek Grozny,2483,6,7,5,8,20,26,-6,26
Din Moscow,2483,7,5,8,7,22,26,-4,23
FK Rubin,2483,8,5,7,8,22,18,4,22
Amkar,2483,9,5,5,10,13,23,-10,20
Rostov,2483,10,4,6,10,10,22,-12,18
Anzhi,2483,11,3,6,11,16,38,-22,15
Loko Moscow,2484,1,11,6,3,32,15,17,39
Spart Moscow,2484,2,9,7,4,37,28,9,34
CSKA Moscow,2484,3,10,4,6,26,19,7,34
Krasnodar,2484,4,9,5,6,31,27,4,32
Zenit,2484,5,7,10,3,23,15,8,31
Terek Grozny,2484,6,7,6,7,20,23,-3,27
FK Rubin,2484,7,6,6,8,26,20,6,24
Din Moscow,2484,8,5,7,8,20,26,-6,22
Rostov,2484,9,4,7,9,11,18,-7,19
Amkar,2484,10,4,5,11,9,23,-14,17
Anzhi,2484,11,4,5,11,17,38,-21,17
Loko Moscow,2485,1,13,5,2,31,11,20,44
Spart Moscow,2485,2,11,5,4,42,26,16,38
CSKA Moscow,2485,3,11,3,6,27,19,8,36
Zenit,2485,4,7,8,5,22,16,6,29
Terek Grozny,2485,5,8,5,7,24,24,0,29
Krasnodar,2485,6,8,4,8,27,26,1,28
FK Rubin,2485,7,6,6,8,23,18,5,24
Din Moscow,2485,8,5,7,8,18,23,-5,22
Rostov,2485,9,4,6,10,10,22,-12,18
Anzhi,2485,10,4,5,11,17,38,-21,17
Amkar,2485,11,4,4,12,10,28,-18,16
Loko Moscow,2486,1,13,5,2,33,12,21,44
CSKA Moscow,2486,2,10,4,6,26,20,6,34
Spart Moscow,2486,3,9,5,6,37,30,7,32
Krasnodar,2486,4,9,4,7,30,28,2,31
Zenit,2486,5,7,9,4,21,14,7,30
Terek Grozny,2486,6,8,6,6,22,23,-1,30
Din Moscow,2486,7,6,7,7,21,24,-3,25
FK Rubin,2486,8,5,6,9,23,20,3,21
Amkar,2486,9,5,5,10,10,22,-12,20
Rostov,2486,10,4,6,10,11,19,-8,18
Anzhi,2486,11,3,5,12,18,40,-22,14
Loko Moscow,2487,1,13,5,2,33,13,20,44
Spart Moscow,2487,2,11,5,4,40,26,14,38
CSKA Moscow,2487,3,11,4,5,32,19,13,37
Zenit,2487,4,7,9,4,24,17,7,30
Krasnodar,2487,5,8,4,8,28,27,1,28
Terek Grozny,2487,6,7,6,7,20,24,-4,27
Din Moscow,2487,7,6,6,8,20,25,-5,24
FK Rubin,2487,8,6,5,9,24,20,4,23
Amkar,2487,9,5,4,11,11,23,-12,19
Rostov,2487,10,4,6,10,10,20,-10,18
Anzhi,2487,11,2,6,12,15,43,-28,12
CSKA Moscow,2488,1,12,3,5,29,19,10,39
Spart Moscow,2488,2,11,5,4,42,27,15,38
Loko Moscow,2488,3,11,5,4,29,14,15,38
Zenit,2488,4,8,8,4,23,14,9,32
Krasnodar,2488,5,9,5,6,29,25,4,32
Terek Grozny,2488,6,8,6,6,23,24,-1,30
Din Moscow,2488,7,6,6,8,20,26,-6,24
FK Rubin,2488,8,5,6,9,23,20,3,21
Rostov,2488,9,4,6,10,10,20,-10,18
Amkar,2488,10,4,5,11,12,26,-14,17
Anzhi,2488,11,2,5,13,16,41,-25,11
Loko Moscow,2489,1,13,5,2,34,12,22,44
CSKA Moscow,2489,2,12,3,5,28,17,11,39
Krasnodar,2489,3,9,4,7,28,26,2,31
Spart Moscow,2489,4,8,5,7,36,32,4,29
Zenit,2489,5,7,8,5,22,18,4,29
Terek Grozny,2489,6,8,5,7,26,26,0,29
Din Moscow,2489,7,6,6,8,20,25,-5,24
FK Rubin,2489,8,6,5,9,23,18,5,23
Amkar,2489,9,6,4,10,12,23,-11,22
Rostov,2489,10,5,6,9,13,18,-5,21
Anzhi,2489,11,2,5,13,16,43,-27,11
Loko Moscow,2490,1,11,7,2,33,15,18,40
CSKA Moscow,2490,2,11,3,6,27,19,8,36
Spart Moscow,2490,3,10,5,5,39,27,12,35
Zenit,2490,4,8,9,3,25,15,10,33
Krasnodar,2490,5,8,6,6,29,26,3,30
Terek Grozny,2490,6,8,5,7,23,26,-3,29
FK Rubin,2490,7,6,6,8,22,17,5,24
Din Moscow,2490,8,5,6,9,17,26,-9,21
Amkar,2490,9,5,4,11,12,24,-12,19
Rostov,2490,10,4,6,10,10,19,-9,18
Anzhi,2490,11,3,5,12,17,40,-23,14
Loko Moscow,2491,1,11,5,4,30,21,9,38
Spart Moscow,2491,2,10,6,4,38,27,11,36
CSKA Moscow,2491,3,11,3,6,28,21,7,36
Zenit,2491,4,9,8,3,29,14,15,35
Krasnodar,2491,5,9,5,6,33,25,8,32
Terek Grozny,2491,6,8,5,7,22,23,-1,29
Din Moscow,2491,7,5,8,7,18,22,-4,23
FK Rubin,2491,8,5,7,8,23,19,4,22
Amkar,2491,9,5,4,11,10,23,-13,19
Rostov,2491,10,4,6,10,12,21,-9,18
Anzhi,2491,11,2,5,13,15,42,-27,11
Loko Moscow,2492,1,12,5,3,34,14,20,41
CSKA Moscow,2492,2,12,3,5,28,17,11,39
Krasnodar,2492,3,10,4,6,32,25,7,34
Spart Moscow,2492,4,9,6,5,36,28,8,33
Terek Grozny,2492,5,9,5,6,24,22,2,32
Zenit,2492,6,7,8,5,22,18,4,29
Din Moscow,2492,7,6,6,8,18,23,-5,24
Rostov,2492,8,5,6,9,12,17,-5,21
FK Rubin,2492,9,5,5,10,21,21,0,20
Amkar,2492,10,4,5,11,10,25,-15,17
Anzhi,2492,11,2,5,13,14,41,-27,11
Loko Moscow,2493,1,11,6,3,31,15,16,39
Spart Moscow,2493,2,10,6,4,43,27,16,36
CSKA Moscow,2493,3,11,3,6,27,20,7,36
Krasnodar,2493,4,10,4,6,31,25,6,34
Zenit,2493,5,8,9,3,24,14,10,33
Terek Grozny,2493,6,8,5,7,23,25,-2,29
FK Rubin,2493,7,6,5,9,22,18,4,23
Din Moscow,2493,8,5,6,9,18,27,-9,21
Rostov,2493,9,4,6,10,11,22,-11,18
Amkar,2493,10,4,5,11,9,23,-14,17
Anzhi,2493,11,3,5,12,18,41,-23,14
Loko Moscow,2494,1,12,5,3,31,13,18,41
Spart Moscow,2494,2,10,5,5,40,29,11,35
CSKA Moscow,2494,3,10,3,7,25,20,5,33
Zenit,2494,4,8,8,4,23,14,9,32
Krasnodar,2494,5,9,5,6,31,27,4,32
Terek Grozny,2494,6,8,6,6,24,25,-1,30
Din Moscow,2494,7,6,7,7,18,21,-3,25
FK Rubin,2494,8,5,7,8,23,19,4,22
Rostov,2494,9,4,6,10,12,21,-9,18
Amkar,2494,10,4,4,12,10,26,-16,16
Anzhi,2494,11,3,6,11,18,40,-22,15
Loko Moscow,2495,1,11,7,2,32,14,18,40
Spart Moscow,2495,2,10,6,4,41,28,13,36
CSKA Moscow,2495,3,10,4,6,25,18,7,34
Zenit,2495,4,7,10,3,22,14,8,31
Krasnodar,2495,5,8,6,6,30,27,3,30
Terek Grozny,2495,6,8,6,6,22,23,-1,30
Din Moscow,2495,7,6,6,8,22,26,-4,24
FK Rubin,2495,8,5,6,9,22,20,2,21
Rostov,2495,9,4,7,9,10,17,-7,19
Amkar,2495,10,4,4,12,9,26,-17,16
Anzhi,2495,11,3,6,11,16,38,-22,15
Loko Moscow,2496,1,12,5,3,30,13,17,41
Spart Moscow,2496,2,10,6,4,41,30,11,36
Krasnodar,2496,3,10,4,6,31,24,7,34
CSKA Moscow,2496,4,10,4,6,27,22,5,34
Zenit,2496,5,8,8,4,24,14,10,32
Terek Grozny,2496,6,7,6,7,21,25,-4,27
Din Moscow,2496,7,6,6,8,21,24,-3,24
FK Rubin,2496,8,5,5,10,21,21,0,20
Rostov,2496,9,4,6,10,11,20,-9,18
Amkar,2496,10,4,6,10,12,25,-13,18
Anzhi,2496,11,3,6,11,18,39,-21,15
Loko Moscow,2497,1,11,6,3,29,13,16,39
Spart Moscow,2497,2,10,6,4,38,25,13,36
CSKA Moscow,2497,3,11,3,6,30,21,9,36
Zenit,2497,4,8,9,3,23,14,9,33
Krasnodar,2497,5,9,4,7,30,26,4,31
Terek Grozny,2497,6,7,7,6,23,25,-2,28
FK Rubin,2497,7,6,6,8,23,18,5,24
Din Moscow,2497,8,5,7,8,17,22,-5,22
Rostov,2497,9,4,6,10,10,21,-11,18
Amkar,2497,10,4,6,10,10,23,-13,18
Anzhi,2497,11,2,6,12,18,43,-25,12
Loko Moscow,2498,1,13,5,2,34,11,23,44
CSKA Moscow,2498,2,11,4,5,28,19,9,37
Spart Moscow,2498,3,10,6,4,39,27,12,36
Zenit,2498,4,7,8,5,21,16,5,29
Terek Grozny,2498,5,8,5,7,21,23,-2,29
Krasnodar,2498,6,8,4,8,27,29,-2,28
FK Rubin,2498,7,7,5,8,26,18,8,26
Din Moscow,2498,8,5,6,9,19,28,-9,21
Rostov,2498,9,4,7,9,11,18,-7,19
Amkar,2498,10,5,4,11,10,23,-13,19
Anzhi,2498,11,2,6,12,16,40,-24,12
Loko Moscow,2499,1,12,6,2,31,11,20,42
Spart Moscow,2499,2,10,5,5,38,29,9,35
CSKA Moscow,2499,3,10,5,5,25,17,8,35
Zenit,2499,4,7,10,3,21,13,8,31
Krasnodar,2499,5,9,4,7,28,26,2,31
Terek Grozny,2499,6,8,5,7,22,23,-1,29
Din Moscow,2499,7,6,6,8,19,23,-4,24
Rostov,2499,8,5,6,9,12,18,-6,21
FK Rubin,2499,9,5,5,10,21,19,2,20
Amkar,2499,10,5,4,11,11,24,-13,19
Anzhi,2499,11,2,6,12,14,39,-25,12
Loko Moscow,2500,1,11,6,3,30,13,17,39
CSKA Moscow,2500,2,11,3,6,28,20,8,36
Spart Moscow,2500,3,9,6,5,37,31,6,33
Krasnodar,2500,4,9,5,6,29,25,4,32
Zenit,2500,5,7,9,4,23,16,7,30
Terek Grozny,2500,6,8,5,7,22,25,-3,29
FK Rubin,2500,7,6,6,8,25,18,7,24
Din Moscow,2500,8,6,6,8,21,25,-4,24
Amkar,2500,9,5,5,10,13,24,-11,20
Rostov,2500,10,4,6,10,11,19,-8,18
Anzhi,2500,11,3,5,12,16,39,-23,14
Loko Moscow,2501,1,11,6,3,30,14,16,39
CSKA Moscow,2501,2,11,3,6,29,19,10,36
Zenit,2501,3,8,9,3,23,14,9,33
Spart Moscow,2501,4,8,7,5,34,28,6,31
Krasnodar,2501,5,9,4,7,29,25,4,31
Terek Grozny,2501,6,7,6,7,21,24,-3,27
FK Rubin,2501,7,7,5,8,24,17,7,26
Din Moscow,2501,8,5,7,8,17,23,-6,22
Amkar,2501,9,5,5,10,12,23,-11,20
Rostov,2501,10,4,7,9,11,18,-7,19
Anzhi,2501,11,3,5,12,16,41,-25,14
Loko Moscow,2502,1,13,5,2,33,11,22,44
CSKA Moscow,2502,2,11,4,5,29,18,11,37
Spart Moscow,2502,3,9,6,5,38,27,11,33
Krasnodar,2502,4,9,4,7,29,26,3,31
Zenit,2502,5,7,9,4,21,15,6,30
Terek Grozny,2502,6,8,6,6,23,23,0,30
FK Rubin,2502,7,6,5,9,22,19,3,23
Din Moscow,2502,8,5,6,9,17,26,-9,21
Rostov,2502,9,4,7,9,10,17,-7,19
Amkar,2502,10,5,4,11,11,25,-14,19
Anzhi,2502,11,2,6,12,16,42,-26,12
Loko Moscow,2503,1,11,6,3,30,13,17,39
Spart Moscow,2503,2,11,5,4,39,27,12,38
Zenit,2503,3,8,9,3,25,13,12,33
CSKA Moscow,2503,4,10,3,7,25,23,2,33
Krasnodar,2503,5,9,4,7,30,29,1,31
Terek Grozny,2503,6,8,5,7,23,25,-2,29
FK Rubin,2503,7,6,6,8,27,20,7,24
Din Moscow,2503,8,5,7,8,21,26,-5,22
Amkar,2503,9,5,4,11,10,24,-14,19
Rostov,2503,10,4,6,10,10,18,-8,18
Anzhi,2503,11,3,5,12,18,40,-22,14
Loko Moscow,2504,1,11,6,3,30,13,17,39
Spart Moscow,2504,2,10,6,4,39,27,12,36
Zenit,2504,3,8,9,3,22,13,9,33
CSKA Moscow,2504,4,10,3,7,25,19,6,33
Krasnodar,2504,5,9,5,6,30,26,4,32
Terek Grozny,2504,6,7,6,7,20,23,-3,27
Din Moscow,2504,7,6,6,8,20,25,-5,24
FK Rubin,2504,8,5,6,9,23,21,2,21
Amkar,2504,9,5,5,10,11,23,-12,20
Rostov,2504,10,4,6,10,11,19,-8,18
Anzhi,2504,11,3,6,11,15,37,-22,15
Loko Moscow,2505,1,12,6,2,31,12,19,42
Spart Moscow,2505,2,11,5,4,42,26,16,38
CSKA Moscow,2505,3,10,4,6,26,19,7,34
Zenit,2505,4,8,8,4,23,15,8,32
Krasnodar,2505,5,9,5,6,30,26,4,32
Terek Grozny,2505,6,8,5,7,22,26,-4,29
Din Moscow,2505,7,6,6,8,18,25,-7,24
FK Rubin,2505,8,5,5,10,22,20,2,20
Amkar,2505,9,5,4,11,12,25,-13,19
Rostov,2505,10,4,6,10,11,19,-8,18
Anzhi,2505,11,2,6,12,15,39,-24,12
Loko Moscow,2506,1,11,7,2,29,11,18,40
CSKA Moscow,2506,2,12,3,5,28,18,10,39
Spart Moscow,2506,3,9,6,5,39,28,11,33
Krasnodar,2506,4,9,5,6,29,24,5,32
Zenit,2506,5,7,9,4,22,15,7,30
Terek Grozny,2506,6,8,5,7,24,25,-1,29
Din Moscow,2506,7,6,7,7,20,23,-3,25
FK Rubin,2506,8,5,6,9,22,20,2,21
Amkar,2506,9,5,5,10,12,24,-12,20
Rostov,2506,10,4,6,10,10,21,-11,18
Anzhi,2506,11,2,5,13,15,41,-26,11
Loko Moscow,2507,1,13,5,2,34,13,21,44
CSKA Moscow,2507,2,12,3,5,29,18,11,39
Spart Moscow,2507,3,10,6,4,40,27,13,36
Terek Grozny,2507,4,9,5,6,25,23,2,32
Krasnodar,2507,5,9,4,7,31,28,3,31
Zenit,2507,6,7,8,5,21,15,6,29
FK Rubin,2507,7,6,5,9,23,19,4,23
Din Moscow,2507,8,5,6,9,17,24,-7,21
Rostov,2507,9,4,7,9,12,19,-7,19
Amkar,2507,10,4,4,12,10,29,-19,16
Anzhi,2507,11,2,5,13,15,42,-27,11
Loko Moscow,2508,1,11,7,2,30,12,18,40
Spart Moscow,2508,2,9,7,4,38,28,10,34
Zenit,2508,3,8,9,3,23,14,9,33
CSKA Moscow,2508,4,10,3,7,27,21,6,33
Krasnodar,2508,5,9,5,6,32,26,6,32
Terek Grozny,2508,6,8,6,6,25,25,0,30
FK Rubin,2508,7,6,5,9,24,21,3,23
Din Moscow,2508,8,5,7,8,19,25,-6,22
Rostov,2508,9,4,6,10,11,20,-9,18
Amkar,2508,10,4,6,10,10,23,-13,18
Anzhi,2508,11,3,5,12,18,42,-24,14
Loko Moscow,2509,1,12,6,2,32,13,19,42
CSKA Moscow,2509,2,11,4,5,28,17,11,37
Spart Moscow,2509,3,9,6,5,36,27,9,33
Krasnodar,2509,4,9,5,6,32,27,5,32
Zenit,2509,5,7,8,5,21,17,4,29
Terek Grozny,2509,6,7,5,8,21,25,-4,26
Din Moscow,2509,7,5,7,8,18,24,-6,22
Amkar,2509,8,6,4,10,12,23,-11,22
FK Rubin,2509,9,5,6,9,23,21,2,21
Rostov,2509,10,4,7,9,11,18,-7,19
Anzhi,2509,11,3,6,11,15,37,-22,15
Loko Moscow,2510,1,12,5,3,32,14,18,41
CSKA Moscow,2510,2,11,4,5,29,18,11,37
Spart Moscow,2510,3,10,6,4,41,29,12,36
Krasnodar,2510,4,9,4,7,31,27,4,31
Zenit,2510,5,7,9,4,21,15,6,30
Terek Grozny,2510,6,8,6,6,21,22,-1,30
Din Moscow,2510,7,6,6,8,20,25,-5,24
FK Rubin,2510,8,6,5,9,23,20,3,23
Rostov,2510,9,4,6,10,12,20,-8,18
Amkar,2510,10,4,6,10,10,23,-13,18
Anzhi,2510,11,2,5,13,15,42,-27,11
Loko Moscow,2511,1,11,5,4,29,16,13,38
Spart Moscow,2511,2,9,7,4,37,27,10,34
CSKA Moscow,2511,3,10,4,6,27,20,7,34
Zenit,2511,4,8,9,3,24,15,9,33
Krasnodar,2511,5,9,4,7,31,27,4,31
Terek Grozny,2511,6,8,5,7,23,23,0,29
Din Moscow,2511,7,6,6,8,19,24,-5,24
FK Rubin,2511,8,6,5,9,24,18,6,23
Amkar,2511,9,5,5,10,10,22,-12,20
Rostov,2511,10,4,7,9,11,18,-7,19
Anzhi,2511,11,3,5,12,15,40,-25,14
Loko Moscow,2512,1,11,6,3,30,13,17,39
CSKA Moscow,2512,2,12,3,5,29,17,12,39
Spart Moscow,2512,3,9,6,5,38,30,8,33
Krasnodar,2512,4,9,5,6,30,26,4,32
Zenit,2512,5,7,9,4,21,14,7,30
Terek Grozny,2512,6,7,6,7,22,25,-3,27
FK Rubin,2512,7,5,7,8,23,19,4,22
Din Moscow,2512,8,5,7,8,18,25,-7,22
Rostov,2512,9,5,6,9,13,17,-4,21
Amkar,2512,10,5,5,10,14,26,-12,20
Anzhi,2512,11,2,6,12,14,40,-26,12
Loko Moscow,2513,1,13,5,2,35,11,24,44
Spart Moscow,2513,2,11,5,4,40,26,14,38
CSKA Moscow,2513,3,11,3,6,27,19,8,36
Zenit,2513,4,8,8,4,23,16,7,32
Terek Grozny,2513,5,9,5,6,26,23,3,32
Krasnodar,2513,6,8,5,7,28,28,0,29
FK Rubin,2513,7,6,6,8,24,18,6,24
Din Moscow,2513,8,5,6,9,18,25,-7,21
Rostov,2513,9,4,6,10,10,18,-8,18
Amkar,2513,10,4,4,12,9,29,-20,16
Anzhi,2513,11,2,5,13,15,42,-27,11
Loko Moscow,2514,1,11,6,3,29,14,15,39
Zenit,2514,2,9,8,3,25,13,12,35
Spart Moscow,2514,3,10,5,5,38,28,10,35
CSKA Moscow,2514,4,10,4,6,27,20,7,34
Krasnodar,2514,5,8,5,7,27,26,1,29
Terek Grozny,2514,6,7,5,8,20,27,-7,26
Din Moscow,2514,7,6,6,8,20,24,-4,24
FK Rubin,2514,8,6,5,9,23,18,5,23
Amkar,2514,9,6,4,10,13,22,-9,22
Rostov,2514,10,4,6,10,10,19,-9,18
Anzhi,2514,11,3,6,11,18,39,-21,15
Loko Moscow,2515,1,12,5,3,32,15,17,41
Spart Moscow,2515,2,10,5,5,41,29,12,35
CSKA Moscow,2515,3,10,5,5,27,19,8,35
Zenit,2515,4,8,9,3,26,16,10,33
Krasnodar,2515,5,8,4,8,29,28,1,28
FK Rubin,2515,6,7,5,8,27,20,7,26
Terek Grozny,2515,7,7,5,8,20,26,-6,26
Din Moscow,2515,8,6,6,8,19,24,-5,24
Amkar,2515,9,5,4,11,11,27,-16,19
Rostov,2515,10,4,6,10,12,20,-8,18
Anzhi,2515,11,3,6,11,18,38,-20,15
Loko Moscow,2516,1,12,5,3,31,15,16,41
CSKA Moscow,2516,2,12,3,5,30,17,13,39
Spart Moscow,2516,3,10,6,4,38,26,12,36
Krasnodar,2516,4,10,4,6,33,26,7,34
Zenit,2516,5,7,8,5,21,16,5,29
Terek Grozny,2516,6,7,5,8,20,25,-5,26
Din Moscow,2516,7,5,7,8,18,24,-6,22
FK Rubin,2516,8,5,6,9,23,20,3,21
Amkar,2516,9,5,5,10,12,23,-11,20
Rostov,2516,10,4,6,10,10,19,-9,18
Anzhi,2516,11,3,5,12,15,40,-25,14
Loko Moscow,2517,1,12,5,3,31,13,18,41
CSKA Moscow,2517,2,11,3,6,28,20,8,36
Spart Moscow,2517,3,10,5,5,40,28,12,35
Krasnodar,2517,4,10,4,6,32,25,7,34
Zenit,2517,5,7,8,5,22,17,5,29
Terek Grozny,2517,6,7,6,7,20,27,-7,27
Din Moscow,2517,7,6,6,8,21,26,-5,24
FK Rubin,2517,8,6,5,9,26,22,4,23
Amkar,2517,9,5,4,11,14,26,-12,19
Rostov,2517,10,4,6,10,11,19,-8,18
Anzhi,2517,11,3,6,11,16,38,-22,15
Loko Moscow,2518,1,12,6,2,31,12,19,42
Spart Moscow,2518,2,10,6,4,38,27,11,36
CSKA Moscow,2518,3,10,3,7,25,21,4,33
Zenit,2518,4,8,8,4,23,15,8,32
Krasnodar,2518,5,9,5,6,28,24,4,32
Terek Grozny,2518,6,7,5,8,21,27,-6,26
Din Moscow,2518,7,6,7,7,19,22,-3,25
FK Rubin,2518,8,5,5,10,21,19,2,20
Amkar,2518,9,5,4,11,13,25,-12,19
Rostov,2518,10,4,6,10,10,18,-8,18
Anzhi,2518,11,4,5,11,19,38,-19,17
Loko Moscow,2519,1,11,6,3,31,15,16,39
CSKA Moscow,2519,2,11,4,5,28,17,11,37
Spart Moscow,2519,3,9,7,4,37,26,11,34
Krasnodar,2519,4,10,4,6,31,25,6,34
Zenit,2519,5,7,10,3,22,14,8,31
Terek Grozny,2519,6,8,5,7,23,25,-2,29
Din Moscow,2519,7,5,8,7,18,22,-4,23
FK Rubin,2519,8,5,6,9,22,19,3,21
Rostov,2519,9,4,7,9,11,18,-7,19
Amkar,2519,10,4,4,12,9,26,-17,16
Anzhi,2519,11,3,5,12,17,42,-25,14
Loko Moscow,2520,1,11,6,3,31,14,17,39
CSKA Moscow,2520,2,11,3,6,28,18,10,36
Spart Moscow,2520,3,10,5,5,41,30,11,35
Zenit,2520,4,9,8,3,24,14,10,35
Krasnodar,2520,5,9,5,6,29,25,4,32
Terek Grozny,2520,6,8,5,7,21,23,-2,29
FK Rubin,2520,7,6,5,9,23,19,4,23
Din Moscow,2520,8,5,6,9,20,27,-7,21
Amkar,2520,9,5,4,11,12,25,-13,19
Rostov,2520,10,4,6,10,10,19,-9,18
Anzhi,2520,11,3,5,12,15,40,-25,14
Loko Moscow,2521,1,12,6,2,33,13,20,42
CSKA Moscow,2521,2,11,3,6,29,20,9,36
Spart Moscow,2521,3,9,6,5,37,26,11,33
Zenit,2521,4,8,8,4,22,15,7,32
Krasnodar,2521,5,8,6,6,29,26,3,30
Terek Grozny,2521,6,8,6,6,23,24,-1,30
FK Rubin,2521,7,6,6,8,22,17,5,24
Rostov,2521,8,5,6,9,11,17,-6,21
Din Moscow,2521,9,5,6,9,17,26,-9,21
Amkar,2521,10,4,6,10,9,22,-13,18
Anzhi,2521,11,2,5,13,18,44,-26,11
Loko Moscow,2522,1,12,5,3,33,15,18,41
CSKA Moscow,2522,2,11,4,5,28,18,10,37
Krasnodar,2522,3,10,4,6,36,27,9,34
Spart Moscow,2522,4,9,6,5,37,29,8,33
Zenit,2522,5,7,9,4,22,16,6,30
Terek Grozny,2522,6,7,6,7,20,24,-4,27
Din Moscow,2522,7,6,7,7,19,22,-3,25
FK Rubin,2522,8,5,6,9,23,23,0,21
Rostov,2522,9,4,7,9,11,18,-7,19
Amkar,2522,10,4,5,11,11,25,-14,17
Anzhi,2522,11,3,5,12,16,39,-23,14
Loko Moscow,2523,1,13,5,2,33,11,22,44
CSKA Moscow,2523,2,11,3,6,28,21,7,36
Spart Moscow,2523,3,10,5,5,37,27,10,35
Zenit,2523,4,8,8,4,24,17,7,32
Krasnodar,2523,5,9,4,7,28,25,3,31
Terek Grozny,2523,6,8,6,6,25,24,1,30
Din Moscow,2523,7,6,6,8,20,24,-4,24
Rostov,2523,8,5,6,9,11,17,-6,21
FK Rubin,2523,9,5,5,10,21,20,1,20
Amkar,2523,10,4,4,12,9,26,-17,16
Anzhi,2523,11,2,6,12,17,41,-24,12
CSKA Moscow,2524,1,12,3,5,29,18,11,39
Loko Moscow,2524,2,11,5,4,30,16,14,38
Krasnodar,2524,3,10,4,6,33,26,7,34
Zenit,2524,4,8,8,4,22,15,7,32
Spart Moscow,2524,5,8,7,5,38,31,7,31
Terek Grozny,2524,6,7,7,6,22,24,-2,28
Din Moscow,2524,7,7,6,7,21,22,-1,27
FK Rubin,2524,8,5,5,10,22,21,1,20
Rostov,2524,9,4,7,9,12,19,-7,19
Amkar,2524,10,4,6,10,12,25,-13,18
Anzhi,2524,11,2,6,12,16,40,-24,12
Loko Moscow,2525,1,13,5,2,33,11,22,44
CSKA Moscow,2525,2,12,3,5,28,17,11,39
Spart Moscow,2525,3,10,5,5,40,28,12,35
Terek Grozny,2525,4,8,6,6,23,24,-1,30
Zenit,2525,5,7,8,5,21,18,3,29
Krasnodar,2525,6,8,4,8,27,27,0,28
FK Rubin,2525,7,7,5,8,25,18,7,26
Rostov,2525,8,5,6,9,12,17,-5,21
Din Moscow,2525,9,5,6,9,18,28,-10,21
Amkar,2525,10,4,4,12,10,25,-15,16
Anzhi,2525,11,2,6,12,16,40,-24,12
Loko Moscow,2526,1,12,6,2,31,12,19,42
CSKA Moscow,2526,2,12,3,5,28,18,10,39
Spart Moscow,2526,3,11,5,4,44,26,18,38
Terek Grozny,2526,4,9,5,6,23,23,0,32
Zenit,2526,5,7,8,5,21,15,6,29
Krasnodar,2526,6,8,5,7,29,27,2,29
Din Moscow,2526,7,6,6,8,20,26,-6,24
FK Rubin,2526,8,6,5,9,23,20,3,23
Rostov,2526,9,4,6,10,10,20,-10,18
Amkar,2526,10,4,4,12,9,26,-17,16
Anzhi,2526,11,2,5,13,16,41,-25,11
Loko Moscow,2527,1,11,6,3,32,16,16,39
CSKA Moscow,2527,2,12,3,5,29,17,12,39
Spart Moscow,2527,3,9,7,4,35,25,10,34
Krasnodar,2527,4,10,4,6,31,25,6,34
Terek Grozny,2527,5,9,5,6,24,22,2,32
Zenit,2527,6,7,9,4,23,17,6,30
FK Rubin,2527,7,6,5,9,23,19,4,23
Din Moscow,2527,8,5,7,8,18,23,-5,22
Rostov,2527,9,4,6,10,10,19,-9,18
Amkar,2527,10,4,5,11,9,23,-14,17
Anzhi,2527,11,2,5,13,14,42,-28,11
Loko Moscow,2528,1,11,5,4,30,18,12,38
CSKA Moscow,2528,2,11,3,6,27,18,9,36
Zenit,2528,3,9,8,3,26,14,12,35
Spart Moscow,2528,4,9,6,5,37,29,8,33
Krasnodar,2528,5,9,4,7,31,26,5,31
Terek Grozny,2528,6,7,7,6,21,23,-2,28
FK Rubin,2528,7,7,5,8,26,19,7,26
Din Moscow,2528,8,6,6,8,20,25,-5,24
Rostov,2528,9,4,6,10,11,19,-8,18
Amkar,2528,10,4,6,10,10,23,-13,18
Anzhi,2528,11,2,6,12,15,40,-25,12
Loko Moscow,2529,1,11,5,4,29,15,14,38
CSKA Moscow,2529,2,11,4,5,28,19,9,37
Spart Moscow,2529,3,10,6,4,44,28,16,36
Zenit,2529,4,8,9,3,24,14,10,33
Krasnodar,2529,5,9,5,6,30,25,5,32
Terek Grozny,2529,6,8,6,6,24,25,-1,30
FK Rubin,2529,7,6,6,8,23,18,5,24
Din Moscow,2529,8,5,7,8,19,24,-5,22
Rostov,2529,9,4,6,10,10,20,-10,18
Amkar,2529,10,4,4,12,11,30,-19,16
Anzhi,2529,11,2,6,12,17,41,-24,12
Loko Moscow,2530,1,12,5,3,32,14,18,41
CSKA Moscow,2530,2,10,4,6,26,19,7,34
Spart Moscow,2530,3,9,6,5,36,28,8,33
Zenit,2530,4,8,8,4,23,16,7,32
Krasnodar,2530,5,9,5,6,32,27,5,32
Din Moscow,2530,6,7,6,7,22,23,-1,27
Terek Grozny,2530,7,7,5,8,20,26,-6,26
FK Rubin,2530,8,5,6,9,24,21,3,21
Rostov,2530,9,4,7,9,10,17,-7,19
Amkar,2530,10,5,4,11,11,24,-13,19
Anzhi,2530,11,3,6,11,16,37,-21,15
Loko Moscow,2531,1,11,6,3,30,14,16,39
Zenit,2531,2,8,9,3,24,14,10,33
CSKA Moscow,2531,3,10,3,7,25,20,5,33
Spart Moscow,2531,4,9,5,6,41,30,11,32
Krasnodar,2531,5,9,4,7,30,26,4,31
Terek Grozny,2531,6,8,5,7,22,24,-2,29
FK Rubin,2531,7,7,5,8,25,18,7,26
Amkar,2531,8,6,4,10,15,26,-11,22
Rostov,2531,9,5,6,9,11,17,-6,21
Din Moscow,2531,10,5,6,9,17,28,-11,21
Anzhi,2531,11,3,5,12,15,38,-23,14
Loko Moscow,2532,1,12,6,2,31,12,19,42
Spart Moscow,2532,2,10,6,4,38,27,11,36
CSKA Moscow,2532,3,11,3,6,28,20,8,36
Zenit,2532,4,8,8,4,25,17,8,32
Krasnodar,2532,5,9,5,6,30,25,5,32
Terek Grozny,2532,6,9,5,6,24,24,0,32
Din Moscow,2532,7,6,6,8,18,23,-5,24
FK Rubin,2532,8,5,5,10,22,21,1,20
Rostov,2532,9,4,7,9,11,18,-7,19
Amkar,2532,10,4,4,12,11,26,-15,16
Anzhi,2532,11,2,5,13,15,40,-25,11
Loko Moscow,2533,1,12,5,3,31,12,19,41
Zenit,2533,2,9,8,3,24,13,11,35
CSKA Moscow,2533,3,10,3,7,25,21,4,33
Krasnodar,2533,4,9,4,7,29,27,2,31
Spart Moscow,2533,5,8,6,6,36,32,4,30
Terek Grozny,2533,6,8,6,6,22,23,-1,30
FK Rubin,2533,7,6,5,9,24,20,4,23
Din Moscow,2533,8,5,7,8,20,25,-5,22
Rostov,2533,9,5,6,9,11,17,-6,21
Amkar,2533,10,5,5,10,14,24,-10,20
Anzhi,2533,11,3,5,12,16,38,-22,14
Loko Moscow,2534,1,11,5,4,30,16,14,38
CSKA Moscow,2534,2,10,5,5,27,19,8,35
Spart Moscow,2534,3,9,7,4,37,27,10,34
Krasnodar,2534,4,10,4,6,33,25,8,34
Zenit,2534,5,8,9,3,22,13,9,33
Terek Grozny,2534,6,7,6,7,21,24,-3,27
Din Moscow,2534,7,6,7,7,21,24,-3,25
FK Rubin,2534,8,5,5,10,22,21,1,20
Rostov,2534,9,4,6,10,10,19,-9,18
Amkar,2534,10,4,6,10,9,22,-13,18
Anzhi,2534,11,3,6,11,18,40,-22,15
Loko Moscow,2535,1,13,5,2,34,11,23,44
CSKA Moscow,2535,2,11,4,5,27,18,9,37
Spart Moscow,2535,3,10,6,4,39,27,12,36
Krasnodar,2535,4,9,4,7,31,27,4,31
Terek Grozny,2535,5,8,6,6,24,24,0,30
Zenit,2535,6,7,8,5,21,17,4,29
Din Moscow,2535,7,6,6,8,20,23,-3,24
FK Rubin,2535,8,5,5,10,23,24,-1,20
Rostov,2535,9,4,6,10,12,22,-10,18
Amkar,2535,10,4,5,11,10,25,-15,17
Anzhi,2535,11,2,7,11,16,39,-23,13
Loko Moscow,2536,1,11,7,2,30,12,18,40
CSKA Moscow,2536,2,12,3,5,31,19,12,39
Spart Moscow,2536,3,9,7,4,36,27,9,34
Krasnodar,2536,4,9,5,6,29,25,4,32
Zenit,2536,5,7,9,4,23,16,7,30
Terek Grozny,2536,6,7,7,6,22,24,-2,28
Din Moscow,2536,7,6,7,7,20,22,-2,25
FK Rubin,2536,8,5,5,10,21,20,1,20
Rostov,2536,9,4,6,10,10,18,-8,18
Amkar,2536,10,4,6,10,11,24,-13,18
Anzhi,2536,11,2,6,12,15,41,-26,12
Loko Moscow,2537,1,11,7,2,31,13,18,40
CSKA Moscow,2537,2,12,3,5,31,19,12,39
Spart Moscow,2537,3,9,6,5,36,27,9,33
Krasnodar,2537,4,9,5,6,29,25,4,32
Zenit,2537,5,7,9,4,24,18,6,30
Terek Grozny,2537,6,8,5,7,22,25,-3,29
Din Moscow,2537,7,5,7,8,17,23,-6,22
FK Rubin,2537,8,5,6,9,21,18,3,21
Rostov,2537,9,4,7,9,11,18,-7,19
Amkar,2537,10,5,4,11,11,24,-13,19
Anzhi,2537,11,3,5,12,16,39,-23,14
Loko Moscow,2538,1,13,5,2,34,14,20,44
CSKA Moscow,2538,2,10,3,7,25,22,3,33
Zenit,2538,3,8,8,4,27,16,11,32
Spart Moscow,2538,4,8,6,6,36,31,5,30
Krasnodar,2538,5,8,4,8,29,29,0,28
Terek Grozny,2538,6,7,7,6,22,24,-2,28
Din Moscow,2538,7,6,7,7,20,22,-2,25
FK Rubin,2538,8,6,6,8,25,19,6,24
Amkar,2538,9,5,5,10,12,24,-12,20
Rostov,2538,10,4,7,9,12,19,-7,19
Anzhi,2538,11,3,6,11,16,38,-22,15
Loko Moscow,2539,1,12,5,3,32,13,19,41
CSKA Moscow,2539,2,11,4,5,29,18,11,37
Spart Moscow,2539,3,10,5,5,40,30,10,35
Zenit,2539,4,8,9,3,23,14,9,33
Krasnodar,2539,5,8,4,8,28,29,-1,28
Terek Grozny,2539,6,7,6,7,21,25,-4,27
Din Moscow,2539,7,6,6,8,20,25,-5,24
FK Rubin,2539,8,6,5,9,24,20,4,23
Amkar,2539,9,5,5,10,13,23,-10,20
Rostov,2539,10,4,6,10,11,20,-9,18
Anzhi,2539,11,3,5,12,17,41,-24,14
Loko Moscow,2540,1,11,5,4,30,15,15,38
CSKA Moscow,2540,2,11,4,5,29,17,12,37
Krasnodar,2540,3,10,4,6,29,24,5,34
Zenit,2540,4,8,9,3,24,14,10,33
Spart Moscow,2540,5,8,7,5,35,29,6,31
Terek Grozny,2540,6,7,5,8,21,26,-5,26
Din Moscow,2540,7,6,6,8,19,23,-4,24
FK Rubin,2540,8,6,5,9,23,18,5,23
Amkar,2540,9,5,5,10,12,23,-11,20
Rostov,2540,10,4,7,9,11,18,-7,19
Anzhi,2540,11,3,5,12,16,42,-26,14
Loko Moscow,2541,1,12,5,3,34,17,17,41
CSKA Moscow,2541,2,11,3,6,28,20,8,36
Krasnodar,2541,3,9,4,7,32,28,4,31
Zenit,2541,4,7,8,5,23,18,5,29
Spart Moscow,2541,5,8,5,7,34,31,3,29
Terek Grozny,2541,6,7,5,8,21,27,-6,26
Din Moscow,2541,7,6,7,7,20,22,-2,25
FK Rubin,2541,8,6,6,8,24,18,6,24
Amkar,2541,9,6,4,10,15,24,-9,22
Rostov,2541,10,5,6,9,11,17,-6,21
Anzhi,2541,11,4,5,11,18,38,-20,17
Loko Moscow,2542,1,11,7,2,30,12,18,40
CSKA Moscow,2542,2,11,4,5,29,20,9,37
Zenit,2542,3,7,10,3,23,15,8,31
Spart Moscow,2542,4,8,6,6,35,30,5,30
Terek Grozny,2542,5,8,6,6,21,22,-1,30
Krasnodar,2542,6,8,5,7,27,25,2,29
FK Rubin,2542,7,7,5,8,26,19,7,26
Din Moscow,2542,8,5,7,8,21,27,-6,22
Rostov,2542,9,5,6,9,11,17,-6,21
Amkar,2542,10,5,4,11,11,23,-12,19
Anzhi,2542,11,2,6,12,16,40,-24,12
Loko Moscow,2543,1,11,6,3,32,15,17,39
Spart Moscow,2543,2,10,6,4,39,28,11,36
Zenit,2543,3,9,8,3,25,14,11,35
CSKA Moscow,2543,4,10,3,7,26,21,5,33
Krasnodar,2543,5,9,5,6,30,26,4,32
Terek Grozny,2543,6,8,5,7,24,24,0,29
Din Moscow,2543,7,6,6,8,21,24,-3,24
FK Rubin,2543,8,5,5,10,21,21,0,20
Rostov,2543,9,4,7,9,11,18,-7,19
Anzhi,2543,10,4,5,11,18,39,-21,17
Amkar,2543,11,4,4,12,10,27,-17,16
Loko Moscow,2544,1,11,6,3,30,14,16,39
CSKA Moscow,2544,2,11,4,5,27,17,10,37
Spart Moscow,2544,3,9,7,4,36,27,9,34
Krasnodar,2544,4,9,5,6,31,26,5,32
Terek Grozny,2544,5,9,5,6,23,23,0,32
Zenit,2544,6,7,10,3,22,14,8,31
FK Rubin,2544,7,6,6,8,25,20,5,24
Din Moscow,2544,8,5,7,8,18,23,-5,22
Rostov,2544,9,4,6,10,12,20,-8,18
Amkar,2544,10,4,5,11,9,23,-14,17
Anzhi,2544,11,2,5,13,15,41,-26,11
Loko Moscow,2545,1,13,5,2,34,12,22,44
CSKA Moscow,2545,2,12,3,5,28,17,11,39
Spart Moscow,2545,3,11,5,4,43,28,15,38
Terek Grozny,2545,4,8,6,6,23,23,0,30
Zenit,2545,5,7,8,5,22,18,4,29
Krasnodar,2545,6,8,4,8,28,27,1,28
Din Moscow,2545,7,6,6,8,19,25,-6,24
FK Rubin,2545,8,6,5,9,23,20,3,23
Rostov,2545,9,4,6,10,11,19,-8,18
Amkar,2545,10,4,5,11,11,26,-15,17
Anzhi,2545,11,2,5,13,15,42,-27,11
Loko Moscow,2546,1,13,5,2,34,13,21,44
CSKA Moscow,2546,2,11,3,6,26,20,6,36
Spart Moscow,2546,3,10,5,5,41,27,14,35
Zenit,2546,4,8,8,4,25,16,9,32
Krasnodar,2546,5,9,4,7,29,26,3,31
Terek Grozny,2546,6,7,6,7,22,25,-3,27
Din Moscow,2546,7,6,6,8,20,26,-6,24
FK Rubin,2546,8,5,5,10,22,20,2,20
Amkar,2546,9,5,5,10,10,22,-12,20
Rostov,2546,10,4,6,10,10,21,-11,18
Anzhi,2546,11,3,5,12,17,40,-23,14
Loko Moscow,2547,1,11,7,2,31,13,18,40
CSKA Moscow,2547,2,11,4,5,28,18,10,37
Spart Moscow,2547,3,9,7,4,38,27,11,34
Zenit,2547,4,7,10,3,23,15,8,31
Krasnodar,2547,5,8,6,6,29,26,3,30
Terek Grozny,2547,6,8,6,6,22,23,-1,30
FK Rubin,2547,7,6,6,8,23,18,5,24
Din Moscow,2547,8,5,7,8,19,24,-5,22
Rostov,2547,9,4,7,9,10,17,-7,19
Amkar,2547,10,4,5,11,10,26,-16,17
Anzhi,2547,11,2,5,13,14,40,-26,11
Loko Moscow,2548,1,12,5,3,35,17,18,41
CSKA Moscow,2548,2,11,3,6,32,19,13,36
Spart Moscow,2548,3,10,5,5,38,29,9,35
Zenit,2548,4,8,8,4,25,18,7,32
Krasnodar,2548,5,9,5,6,31,26,5,32
Terek Grozny,2548,6,8,5,7,22,24,-2,29
Din Moscow,2548,7,6,6,8,20,24,-4,24
Amkar,2548,8,6,4,10,12,22,-10,22
FK Rubin,2548,9,5,6,9,21,19,2,21
Rostov,2548,10,4,6,10,11,19,-8,18
Anzhi,2548,11,2,5,13,15,45,-30,11
Loko Moscow,2549,1,13,5,2,33,13,20,44
CSKA Moscow,2549,2,12,3,5,31,18,13,39
Spart Moscow,2549,3,9,7,4,38,27,11,34
Krasnodar,2549,4,9,4,7,31,27,4,31
Terek Grozny,2549,5,8,6,6,24,24,0,30
Zenit,2549,6,7,8,5,23,20,3,29
Din Moscow,2549,7,5,7,8,19,26,-7,22
FK Rubin,2549,8,5,6,9,24,22,2,21
Rostov,2549,9,4,7,9,11,18,-7,19
Amkar,2549,10,4,6,10,11,24,-13,18
Anzhi,2549,11,2,5,13,15,41,-26,11
Loko Moscow,2550,1,12,6,2,30,11,19,42
Spart Moscow,2550,2,10,6,4,39,26,13,36
CSKA Moscow,2550,3,10,4,6,26,19,7,34
Zenit,2550,4,8,8,4,22,14,8,32
Krasnodar,2550,5,9,5,6,28,24,4,32
Terek Grozny,2550,6,8,6,6,23,24,-1,30
FK Rubin,2550,7,6,5,9,22,18,4,23
Din Moscow,2550,8,5,6,9,17,26,-9,21
Rostov,2550,9,4,6,10,10,18,-8,18
Amkar,2550,10,4,5,11,10,24,-14,17
Anzhi,2550,11,2,7,11,17,40,-23,13
CSKA Moscow,2551,1,12,3,5,31,19,12,39
Loko Moscow,2551,2,11,5,4,29,14,15,38
Spart Moscow,2551,3,9,7,4,35,26,9,34
Zenit,2551,4,8,8,4,25,16,9,32
Krasnodar,2551,5,9,4,7,29,27,2,31
Terek Grozny,2551,6,8,6,6,23,23,0,30
FK Rubin,2551,7,6,6,8,25,19,6,24
Din Moscow,2551,8,5,7,8,19,24,-5,22
Rostov,2551,9,4,7,9,10,17,-7,19
Amkar,2551,10,4,6,10,10,23,-13,18
Anzhi,2551,11,2,5,13,14,42,-28,11
Loko Moscow,2552,1,11,6,3,33,16,17,39
CSKA Moscow,2552,2,11,3,6,27,19,8,36
Krasnodar,2552,3,10,4,6,32,27,5,34
Spart Moscow,2552,4,8,7,5,36,29,7,31
Zenit,2552,5,7,9,4,23,16,7,30
Terek Grozny,2552,6,8,6,6,23,22,1,30
FK Rubin,2552,7,6,5,9,25,20,5,23
Din Moscow,2552,8,5,7,8,20,26,-6,22
Rostov,2552,9,5,6,9,12,18,-6,21
Amkar,2552,10,4,6,10,9,22,-13,18
Anzhi,2552,11,3,5,12,16,41,-25,14
Loko Moscow,2553,1,11,5,4,31,16,15,38
CSKA Moscow,2553,2,11,3,6,30,21,9,36
Zenit,2553,3,9,8,3,24,14,10,35
Spart Moscow,2553,4,9,7,4,38,28,10,34
Krasnodar,2553,5,9,4,7,31,28,3,31
Terek Grozny,2553,6,7,6,7,20,23,-3,27
Din Moscow,2553,7,6,6,8,21,25,-4,24
FK Rubin,2553,8,6,5,9,23,19,4,23
Amkar,2553,9,5,5,10,11,23,-12,20
Rostov,2553,10,4,7,9,10,17,-7,19
Anzhi,2553,11,2,6,12,16,41,-25,12
Loko Moscow,2554,1,12,5,3,31,13,18,41
CSKA Moscow,2554,2,11,3,6,30,19,11,36
Zenit,2554,3,8,8,4,23,15,8,32
Krasnodar,2554,4,9,5,6,30,26,4,32
Terek Grozny,2554,5,9,5,6,23,22,1,32
Spart Moscow,2554,6,8,5,7,33,28,5,29
FK Rubin,2554,7,6,6,8,25,19,6,24
Din Moscow,2554,8,6,6,8,18,23,-5,24
Rostov,2554,9,5,6,9,11,17,-6,21
Amkar,2554,10,5,4,11,10,23,-13,19
Anzhi,2554,11,2,5,13,15,44,-29,11
Loko Moscow,2555,1,12,6,2,33,14,19,42
CSKA Moscow,2555,2,11,4,5,28,18,10,37
Spart Moscow,2555,3,9,6,5,36,28,8,33
Krasnodar,2555,4,9,5,6,33,28,5,32
Terek Grozny,2555,5,8,6,6,23,23,0,30
Zenit,2555,6,7,8,5,22,17,5,29
Din Moscow,2555,7,6,7,7,20,23,-3,25
FK Rubin,2555,8,5,5,10,23,22,1,20
Amkar,2555,9,5,5,10,10,22,-12,20
Rostov,2555,10,4,6,10,10,18,-8,18
Anzhi,2555,11,2,6,12,16,41,-25,12
Loko Moscow,2556,1,13,5,2,32,11,21,44
CSKA Moscow,2556,2,12,3,5,29,17,12,39
Spart Moscow,2556,3,9,7,4,39,28,11,34
Krasnodar,2556,4,9,4,7,28,25,3,31
Zenit,2556,5,7,8,5,21,17,4,29
Terek Grozny,2556,6,8,5,7,25,24,1,29
Din Moscow,2556,7,6,6,8,20,26,-6,24
FK Rubin,2556,8,5,5,10,22,20,2,20
Amkar,2556,9,5,5,10,11,23,-12,20
Rostov,2556,10,4,7,9,12,19,-7,19
Anzhi,2556,11,2,5,13,14,43,-29,11
Loko Moscow,2557,1,12,6,2,32,12,20,42
CSKA Moscow,2557,2,11,3,6,30,22,8,36
Zenit,2557,3,8,8,4,23,16,7,32
Spart Moscow,2557,4,8,7,5,35,28,7,31
Krasnodar,2557,5,8,5,7,29,27,2,29
FK Rubin,2557,6,7,5,8,25,18,7,26
Terek Grozny,2557,7,7,5,8,21,27,-6,26
Din Moscow,2557,8,5,7,8,17,23,-6,22
Rostov,2557,9,5,6,9,12,18,-6,21
Amkar,2557,10,5,5,10,13,24,-11,20
Anzhi,2557,11,3,5,12,19,41,-22,14
Loko Moscow,2558,1,12,6,2,32,12,20,42
Spart Moscow,2558,2,9,7,4,36,27,9,34
Zenit,2558,3,8,9,3,23,14,9,33
CSKA Moscow,2558,4,10,3,7,27,22,5,33
Krasnodar,2558,5,9,4,7,28,26,2,31
Terek Grozny,2558,6,8,5,7,23,24,-1,29
FK Rubin,2558,7,6,5,9,22,18,4,23
Din Moscow,2558,8,5,7,8,19,24,-5,22
Rostov,2558,9,4,6,10,10,18,-8,18
Amkar,2558,10,4,5,11,9,24,-15,17
Anzhi,2558,11,4,5,11,20,40,-20,17
Loko Moscow,2559,1,12,6,2,33,14,19,42
CSKA Moscow,2559,2,11,4,5,28,18,10,37
Spart Moscow,2559,3,8,7,5,34,27,7,31
Zenit,2559,4,7,8,5,21,16,5,29
Krasnodar,2559,5,8,5,7,31,29,2,29
Terek Grozny,2559,6,7,6,7,21,24,-3,27
FK Rubin,2559,7,7,5,8,26,19,7,26
Din Moscow,2559,8,5,7,8,18,24,-6,22
Rostov,2559,9,5,6,9,11,17,-6,21
Amkar,2559,10,5,5,10,11,23,-12,20
Anzhi,2559,11,2,7,11,16,39,-23,13
Loko Moscow,2560,1,13,5,2,36,12,24,44
CSKA Moscow,2560,2,10,5,5,27,19,8,35
Spart Moscow,2560,3,8,7,5,36,29,7,31
Zenit,2560,4,7,9,4,21,16,5,30
Terek Grozny,2560,5,8,5,7,21,23,-2,29
Krasnodar,2560,6,8,4,8,29,34,-5,28
Din Moscow,2560,7,6,7,7,20,23,-3,25
FK Rubin,2560,8,6,6,8,28,19,9,24
Rostov,2560,9,4,7,9,11,18,-7,19
Amkar,2560,10,4,5,11,10,24,-14,17
Anzhi,2560,11,3,6,11,17,39,-22,15
Loko Moscow,2561,1,12,6,2,32,11,21,42
CSKA Moscow,2561,2,10,4,6,26,21,5,34
Spart Moscow,2561,3,8,8,4,36,28,8,32
Zenit,2561,4,8,8,4,25,17,8,32
Terek Grozny,2561,5,8,6,6,23,23,0,30
Krasnodar,2561,6,8,5,7,27,25,2,29
Din Moscow,2561,7,6,7,7,20,21,-1,25
FK Rubin,2561,8,6,5,9,22,20,2,23
Rostov,2561,9,4,7,9,11,18,-7,19
Amkar,2561,10,4,6,10,11,24,-13,18
Anzhi,2561,11,2,6,12,15,40,-25,12
Loko Moscow,2562,1,11,7,2,30,12,18,40
CSKA Moscow,2562,2,11,3,6,27,19,8,36
Spart Moscow,2562,3,10,5,5,39,29,10,35
Zenit,2562,4,8,9,3,23,14,9,33
Krasnodar,2562,5,8,6,6,30,27,3,30
Terek Grozny,2562,6,8,5,7,21,24,-3,29
FK Rubin,2562,7,5,7,8,24,20,4,22
Din Moscow,2562,8,5,7,8,18,23,-5,22
Amkar,2562,9,5,4,11,13,25,-12,19
Rostov,2562,10,4,6,10,10,20,-10,18
Anzhi,2562,11,3,5,12,16,38,-22,14
Loko Moscow,2563,1,11,6,3,31,16,15,39
CSKA Moscow,2563,2,11,3,6,27,19,8,36
Zenit,2563,3,8,8,4,25,15,10,32
Spart Moscow,2563,4,9,5,6,36,30,6,32
Krasnodar,2563,5,8,6,6,28,25,3,30
Terek Grozny,2563,6,7,6,7,20,23,-3,27
FK Rubin,2563,7,6,6,8,22,17,5,24
Din Moscow,2563,8,6,6,8,20,23,-3,24
Amkar,2563,9,5,5,10,11,22,-11,20
Rostov,2563,10,4,6,10,10,19,-9,18
Anzhi,2563,11,4,5,11,17,38,-21,17
Loko Moscow,2564,1,11,6,3,31,14,17,39
Spart Moscow,2564,2,10,6,4,38,27,11,36
CSKA Moscow,2564,3,10,5,5,27,19,8,35
Zenit,2564,4,8,9,3,24,15,9,33
Krasnodar,2564,5,8,6,6,30,27,3,30
Terek Grozny,2564,6,7,6,7,20,23,-3,27
FK Rubin,2564,7,6,6,8,24,19,5,24
Din Moscow,2564,8,5,6,9,18,25,-7,21
Rostov,2564,9,4,7,9,11,18,-7,19
Amkar,2564,10,5,4,11,11,24,-13,19
Anzhi,2564,11,2,7,11,14,37,-23,13
Loko Moscow,2565,1,11,6,3,30,13,17,39
CSKA Moscow,2565,2,10,5,5,27,19,8,35
Krasnodar,2565,3,10,4,6,30,25,5,34
Spart Moscow,2565,4,9,5,6,37,30,7,32
Zenit,2565,5,7,10,3,22,14,8,31
Terek Grozny,2565,6,8,5,7,25,27,-2,29
Din Moscow,2565,7,6,6,8,18,23,-5,24
FK Rubin,2565,8,6,5,9,23,18,5,23
Amkar,2565,9,6,4,10,14,24,-10,22
Rostov,2565,10,4,6,10,12,20,-8,18
Anzhi,2565,11,2,6,12,17,42,-25,12
Loko Moscow,2566,1,13,5,2,32,12,20,44
CSKA Moscow,2566,2,12,3,5,29,17,12,39
Spart Moscow,2566,3,10,5,5,38,27,11,35
Terek Grozny,2566,4,9,5,6,24,24,0,32
Krasnodar,2566,5,9,4,7,30,27,3,31
Zenit,2566,6,7,8,5,21,15,6,29
Din Moscow,2566,7,7,6,7,20,22,-2,27
FK Rubin,2566,8,5,5,10,22,20,2,20
Rostov,2566,9,4,6,10,10,20,-10,18
Amkar,2566,10,4,4,12,11,26,-15,16
Anzhi,2566,11,2,5,13,14,41,-27,11
Loko Moscow,2567,1,12,6,2,32,13,19,42
CSKA Moscow,2567,2,12,3,5,32,18,14,39
Spart Moscow,2567,3,9,7,4,40,27,13,34
Terek Grozny,2567,4,9,5,6,25,23,2,32
Krasnodar,2567,5,9,4,7,29,26,3,31
Zenit,2567,6,7,9,4,23,16,7,30
Din Moscow,2567,7,6,7,7,19,22,-3,25
FK Rubin,2567,8,5,5,10,21,19,2,20
Rostov,2567,9,4,6,10,10,22,-12,18
Amkar,2567,10,4,5,11,11,25,-14,17
Anzhi,2567,11,2,5,13,14,45,-31,11
Loko Moscow,2568,1,11,5,4,29,13,16,38
Spart Moscow,2568,2,10,5,5,38,26,12,35
Zenit,2568,3,9,8,3,24,14,10,35
Krasnodar,2568,4,10,4,6,31,25,6,34
CSKA Moscow,2568,5,10,3,7,26,21,5,33
Terek Grozny,2568,6,8,6,6,25,26,-1,30
Din Moscow,2568,7,6,6,8,19,24,-5,24
Rostov,2568,8,5,6,9,11,17,-6,21
FK Rubin,2568,9,5,5,10,23,22,1,20
Amkar,2568,10,4,5,11,11,27,-16,17
Anzhi,2568,11,3,5,12,18,40,-22,14
Loko Moscow,2569,1,12,6,2,30,11,19,42
CSKA Moscow,2569,2,10,5,5,25,17,8,35
Spart Moscow,2569,3,9,6,5,36,29,7,33
Zenit,2569,4,7,10,3,21,13,8,31
Krasnodar,2569,5,9,4,7,29,26,3,31
Terek Grozny,2569,6,7,6,7,22,26,-4,27
Din Moscow,2569,7,5,8,7,19,23,-4,23
FK Rubin,2569,8,5,6,9,23,20,3,21
Rostov,2569,9,5,6,9,13,18,-5,21
Amkar,2569,10,4,5,11,10,24,-14,17
Anzhi,2569,11,3,6,11,17,38,-21,15
Loko Moscow,2570,1,12,6,2,30,11,19,42
CSKA Moscow,2570,2,10,5,5,29,21,8,35
Zenit,2570,3,7,10,3,22,14,8,31
Spart Moscow,2570,4,8,7,5,37,31,6,31
Krasnodar,2570,5,9,4,7,30,25,5,31
Terek Grozny,2570,6,8,5,7,21,24,-3,29
FK Rubin,2570,7,6,5,9,22,20,2,23
Din Moscow,2570,8,5,7,8,19,24,-5,22
Rostov,2570,9,5,6,9,12,17,-5,21
Amkar,2570,10,4,5,11,11,25,-14,17
Anzhi,2570,11,3,6,11,19,40,-21,15
Loko Moscow,2571,1,12,6,2,32,13,19,42
Spart Moscow,2571,2,10,6,4,40,25,15,36
CSKA Moscow,2571,3,10,3,7,26,20,6,33
Zenit,2571,4,8,8,4,23,15,8,32
Krasnodar,2571,5,8,5,7,29,29,0,29
Terek Grozny,2571,6,7,6,7,23,26,-3,27
Din Moscow,2571,7,6,7,7,21,23,-2,25
FK Rubin,2571,8,6,5,9,26,21,5,23
Amkar,2571,9,5,4,11,11,27,-16,19
Rostov,2571,10,4,6,10,10,20,-10,18
Anzhi,2571,11,3,6,11,17,39,-22,15
Loko Moscow,2572,1,11,6,3,30,13,17,39
CSKA Moscow,2572,2,11,3,6,27,19,8,36
Spart Moscow,2572,3,9,7,4,37,27,10,34
Krasnodar,2572,4,10,4,6,33,27,6,34
Zenit,2572,5,8,9,3,23,14,9,33
Terek Grozny,2572,6,9,5,6,23,23,0,32
FK Rubin,2572,7,6,5,9,26,21,5,23
Din Moscow,2572,8,5,7,8,18,25,-7,22
Rostov,2572,9,4,7,9,10,17,-7,19
Amkar,2572,10,4,4,12,11,27,-16,16
Anzhi,2572,11,2,5,13,14,39,-25,11
Loko Moscow,2573,1,11,6,3,31,14,17,39
CSKA Moscow,2573,2,11,4,5,28,17,11,37
Spart Moscow,2573,3,10,6,4,37,27,10,36
Krasnodar,2573,4,10,4,6,29,24,5,34
Zenit,2573,5,7,10,3,23,15,8,31
Terek Grozny,2573,6,8,5,7,23,25,-2,29
Din Moscow,2573,7,5,7,8,17,22,-5,22
FK Rubin,2573,8,5,6,9,21,18,3,21
Rostov,2573,9,4,6,10,11,19,-8,18
Amkar,2573,10,4,5,11,11,25,-14,17
Anzhi,2573,11,3,5,12,16,41,-25,14
Loko Moscow,2574,1,13,5,2,35,11,24,44
CSKA Moscow,2574,2,11,3,6,31,21,10,36
Spart Moscow,2574,3,10,5,5,37,30,7,35
Zenit,2574,4,8,8,4,24,17,7,32
Terek Grozny,2574,5,8,6,6,22,23,-1,30
Krasnodar,2574,6,8,4,8,28,30,-2,28
Din Moscow,2574,7,6,6,8,18,23,-5,24
FK Rubin,2574,8,6,5,9,23,19,4,23
Amkar,2574,9,5,5,10,13,22,-9,20
Rostov,2574,10,4,6,10,11,19,-8,18
Anzhi,2574,11,2,5,13,16,43,-27,11
Loko Moscow,2575,1,12,5,3,32,13,19,41
CSKA Moscow,2575,2,12,3,5,29,18,11,39
Spart Moscow,2575,3,9,5,6,36,28,8,32
Zenit,2575,4,8,8,4,23,16,7,32
Terek Grozny,2575,5,8,5,7,22,25,-3,29
Krasnodar,2575,6,8,4,8,27,28,-1,28
Din Moscow,2575,7,6,6,8,19,24,-5,24
FK Rubin,2575,8,6,5,9,23,18,5,23
Amkar,2575,9,6,4,10,13,23,-10,22
Rostov,2575,10,5,6,9,11,17,-6,21
Anzhi,2575,11,2,5,13,15,40,-25,11
Loko Moscow,2576,1,12,6,2,30,11,19,42
CSKA Moscow,2576,2,12,3,5,31,17,14,39
Spart Moscow,2576,3,10,5,5,36,28,8,35
Krasnodar,2576,4,8,6,6,28,25,3,30
Zenit,2576,5,7,8,5,21,15,6,29
Terek Grozny,2576,6,7,6,7,22,26,-4,27
Din Moscow,2576,7,6,6,8,19,23,-4,24
Amkar,2576,8,6,4,10,15,24,-9,22
FK Rubin,2576,9,5,6,9,23,20,3,21
Rostov,2576,10,4,6,10,10,18,-8,18
Anzhi,2576,11,2,6,12,15,43,-28,12
Loko Moscow,2577,1,12,5,3,31,12,19,41
Spart Moscow,2577,2,9,6,5,36,28,8,33
CSKA Moscow,2577,3,10,3,7,26,22,4,33
Zenit,2577,4,8,8,4,24,16,8,32
Krasnodar,2577,5,9,5,6,30,26,4,32
Terek Grozny,2577,6,8,6,6,21,22,-1,30
Din Moscow,2577,7,6,7,7,25,25,0,25
FK Rubin,2577,8,5,6,9,25,25,0,21
Amkar,2577,9,5,4,11,10,23,-13,19
Rostov,2577,10,4,6,10,10,18,-8,18
Anzhi,2577,11,3,6,11,16,37,-21,15
Loko Moscow,2578,1,12,6,2,32,13,19,42
CSKA Moscow,2578,2,11,4,5,28,19,9,37
Spart Moscow,2578,3,10,6,4,37,26,11,36
Zenit,2578,4,7,10,3,24,16,8,31
Krasnodar,2578,5,8,5,7,29,27,2,29
Terek Grozny,2578,6,7,6,7,20,24,-4,27
FK Rubin,2578,7,5,7,8,24,20,4,22
Din Moscow,2578,8,5,7,8,19,25,-6,22
Rostov,2578,9,4,6,10,10,18,-8,18
Amkar,2578,10,4,6,10,10,23,-13,18
Anzhi,2578,11,3,5,12,16,38,-22,14
Loko Moscow,2579,1,11,5,4,30,14,16,38
Spart Moscow,2579,2,10,6,4,36,25,11,36
Zenit,2579,3,9,8,3,24,14,10,35
CSKA Moscow,2579,4,10,4,6,26,19,7,34
Krasnodar,2579,5,9,5,6,30,26,4,32
Terek Grozny,2579,6,8,5,7,22,24,-2,29
FK Rubin,2579,7,6,6,8,25,19,6,24
Din Moscow,2579,8,5,6,9,17,25,-8,21
Rostov,2579,9,4,7,9,10,17,-7,19
Amkar,2579,10,4,4,12,10,25,-15,16
Anzhi,2579,11,3,6,11,16,38,-22,15
Loko Moscow,2580,1,12,6,2,31,12,19,42
CSKA Moscow,2580,2,11,3,6,27,19,8,36
Spart Moscow,2580,3,10,5,5,37,27,10,35
Zenit,2580,4,8,8,4,22,14,8,32
Krasnodar,2580,5,8,6,6,29,26,3,30
Terek Grozny,2580,6,7,5,8,21,27,-6,26
FK Rubin,2580,7,6,6,8,25,19,6,24
Din Moscow,2580,8,6,6,8,19,24,-5,24
Amkar,2580,9,5,4,11,12,24,-12,19
Rostov,2580,10,4,6,10,10,19,-9,18
Anzhi,2580,11,3,5,12,18,40,-22,14
Loko Moscow,2581,1,11,6,3,32,15,17,39
CSKA Moscow,2581,2,11,3,6,27,19,8,36
Spart Moscow,2581,3,9,7,4,38,27,11,34
Krasnodar,2581,4,10,4,6,33,27,6,34
Zenit,2581,5,8,9,3,23,14,9,33
Terek Grozny,2581,6,7,5,8,20,24,-4,26
Din Moscow,2581,7,6,7,7,20,22,-2,25
FK Rubin,2581,8,5,5,10,22,22,0,20
Rostov,2581,9,4,7,9,11,18,-7,19
Amkar,2581,10,5,4,11,10,25,-15,19
Anzhi,2581,11,3,5,12,16,39,-23,14
Loko Moscow,2582,1,11,5,4,31,18,13,38
CSKA Moscow,2582,2,11,4,5,26,17,9,37
Spart Moscow,2582,3,9,7,4,36,27,9,34
Zenit,2582,4,8,9,3,26,15,11,33
Krasnodar,2582,5,9,4,7,31,27,4,31
Terek Grozny,2582,6,8,5,7,23,25,-2,29
Din Moscow,2582,7,6,7,7,19,22,-3,25
FK Rubin,2582,8,6,5,9,24,20,4,23
Rostov,2582,9,4,6,10,10,18,-8,18
Amkar,2582,10,4,5,11,11,25,-14,17
Anzhi,2582,11,3,5,12,16,39,-23,14
Loko Moscow,2583,1,12,5,3,31,12,19,41
CSKA Moscow,2583,2,10,4,6,26,20,6,34
Spart Moscow,2583,3,9,6,5,36,27,9,33
Zenit,2583,4,8,9,3,22,13,9,33
Terek Grozny,2583,5,9,5,6,24,23,1,32
Krasnodar,2583,6,8,4,8,27,29,-2,28
Din Moscow,2583,7,6,7,7,18,21,-3,25
FK Rubin,2583,8,6,5,9,24,18,6,23
Amkar,2583,9,5,4,11,12,25,-13,19
Rostov,2583,10,4,6,10,10,20,-10,18
Anzhi,2583,11,3,5,12,17,39,-22,14
Loko Moscow,2584,1,13,5,2,31,11,20,44
Spart Moscow,2584,2,10,5,5,36,27,9,35
CSKA Moscow,2584,3,10,5,5,26,18,8,35
Terek Grozny,2584,4,9,5,6,27,25,2,32
Zenit,2584,5,7,9,4,21,14,7,30
Krasnodar,2584,6,8,5,7,28,26,2,29
FK Rubin,2584,7,6,6,8,24,18,6,24
Din Moscow,2584,8,6,6,8,18,23,-5,24
Rostov,2584,9,4,6,10,10,18,-8,18
Amkar,2584,10,4,4,12,12,28,-16,16
Anzhi,2584,11,2,6,12,16,41,-25,12
Loko Moscow,2585,1,11,6,3,31,14,17,39
CSKA Moscow,2585,2,11,3,6,29,20,9,36
Zenit,2585,3,9,8,3,25,14,11,35
Spart Moscow,2585,4,10,5,5,38,28,10,35
Krasnodar,2585,5,9,5,6,31,27,4,32
Terek Grozny,2585,6,8,6,6,22,22,0,30
Din Moscow,2585,7,6,6,8,19,24,-5,24
FK Rubin,2585,8,5,5,10,23,21,2,20
Amkar,2585,9,5,5,10,11,23,-12,20
Rostov,2585,10,4,6,10,11,19,-8,18
Anzhi,2585,11,2,5,13,14,42,-28,11
Loko Moscow,2586,1,12,5,3,31,13,18,41
CSKA Moscow,2586,2,11,4,5,31,21,10,37
Spart Moscow,2586,3,9,6,5,39,27,12,33
Zenit,2586,4,8,9,3,26,16,10,33
Terek Grozny,2586,5,8,5,7,21,23,-2,29
Krasnodar,2586,6,8,4,8,29,30,-1,28
Din Moscow,2586,7,7,6,7,20,22,-2,27
FK Rubin,2586,8,6,5,9,26,21,5,23
Rostov,2586,9,4,7,9,10,17,-7,19
Amkar,2586,10,4,4,12,10,29,-19,16
Anzhi,2586,11,3,5,12,16,40,-24,14
Loko Moscow,2587,1,12,6,2,33,13,20,42
CSKA Moscow,2587,2,11,3,6,27,22,5,36
Spart Moscow,2587,3,9,6,5,37,27,10,33
Zenit,2587,4,8,8,4,26,15,11,32
Krasnodar,2587,5,8,6,6,30,27,3,30
Terek Grozny,2587,6,8,6,6,22,23,-1,30
Din Moscow,2587,7,6,6,8,18,24,-6,24
FK Rubin,2587,8,5,6,9,22,19,3,21
Rostov,2587,9,5,6,9,11,17,-6,21
Amkar,2587,10,4,5,11,10,24,-14,17
Anzhi,2587,11,2,6,12,15,40,-25,12
Loko Moscow,2588,1,12,6,2,31,11,20,42
CSKA Moscow,2588,2,10,4,6,29,22,7,34
Spart Moscow,2588,3,9,6,5,42,32,10,33
Zenit,2588,4,8,9,3,25,16,9,33
Krasnodar,2588,5,8,5,7,28,27,1,29
Terek Grozny,2588,6,8,5,7,23,24,-1,29
Din Moscow,2588,7,6,6,8,20,26,-6,24
Amkar,2588,8,6,4,10,15,26,-11,22
FK Rubin,2588,9,5,6,9,23,20,3,21
Rostov,2588,10,4,7,9,12,19,-7,19
Anzhi,2588,11,2,6,12,15,40,-25,12
Loko Moscow,2589,1,11,6,3,29,13,16,39
CSKA Moscow,2589,2,12,3,5,30,17,13,39
Spart Moscow,2589,3,10,5,5,40,28,12,35
Krasnodar,2589,4,10,4,6,35,27,8,34
Terek Grozny,2589,5,9,5,6,26,24,2,32
Zenit,2589,6,7,9,4,21,16,5,30
Din Moscow,2589,7,5,7,8,17,23,-6,22
FK Rubin,2589,8,5,6,9,24,23,1,21
Amkar,2589,9,5,4,11,11,24,-13,19
Rostov,2589,10,4,6,10,11,21,-10,18
Anzhi,2589,11,2,5,13,16,44,-28,11
Loko Moscow,2590,1,12,5,3,32,16,16,41
CSKA Moscow,2590,2,12,3,5,27,17,10,39
Spart Moscow,2590,3,9,7,4,37,28,9,34
Krasnodar,2590,4,10,4,6,33,26,7,34
Terek Grozny,2590,5,8,6,6,23,22,1,30
Zenit,2590,6,7,8,5,22,16,6,29
Din Moscow,2590,7,6,7,7,21,23,-2,25
FK Rubin,2590,8,5,5,10,23,22,1,20
Rostov,2590,9,4,7,9,12,19,-7,19
Amkar,2590,10,4,5,11,9,23,-14,17
Anzhi,2590,11,2,5,13,14,41,-27,11
Loko Moscow,2591,1,11,7,2,31,13,18,40
CSKA Moscow,2591,2,11,4,5,29,18,11,37
Spart Moscow,2591,3,9,6,5,35,26,9,33
Krasnodar,2591,4,9,5,6,30,26,4,32
Zenit,2591,5,7,10,3,23,15,8,31
Terek Grozny,2591,6,8,6,6,22,23,-1,30
Din Moscow,2591,7,6,6,8,19,23,-4,24
FK Rubin,2591,8,5,5,10,22,21,1,20
Amkar,2591,9,5,5,10,10,22,-12,20
Rostov,2591,10,4,7,9,10,17,-7,19
Anzhi,2591,11,2,5,13,15,42,-27,11
Loko Moscow,2592,1,12,6,2,31,12,19,42
CSKA Moscow,2592,2,11,3,6,28,20,8,36
Spart Moscow,2592,3,10,5,5,41,31,10,35
Terek Grozny,2592,4,9,5,6,23,23,0,32
Zenit,2592,5,7,8,5,22,17,5,29
Krasnodar,2592,6,8,5,7,28,26,2,29
FK Rubin,2592,7,7,5,8,24,17,7,26
Din Moscow,2592,8,6,6,8,19,24,-5,24
Rostov,2592,9,4,6,10,14,22,-8,18
Amkar,2592,10,4,4,12,10,26,-16,16
Anzhi,2592,11,3,5,12,16,38,-22,14
Loko Moscow,2593,1,12,6,2,32,13,19,42
CSKA Moscow,2593,2,11,3,6,28,20,8,36
Zenit,2593,3,8,9,3,26,15,11,33
Spart Moscow,2593,4,9,6,5,37,29,8,33
Terek Grozny,2593,5,8,6,6,25,25,0,30
Krasnodar,2593,6,8,4,8,27,26,1,28
FK Rubin,2593,7,7,5,8,24,17,7,26
Din Moscow,2593,8,5,7,8,18,24,-6,22
Amkar,2593,9,5,5,10,13,24,-11,20
Rostov,2593,10,4,6,10,11,20,-9,18
Anzhi,2593,11,2,5,13,15,43,-28,11
Loko Moscow,2594,1,11,5,4,30,14,16,38
Spart Moscow,2594,2,11,5,4,37,26,11,38
CSKA Moscow,2594,3,11,3,6,26,18,8,36
Zenit,2594,4,9,8,3,23,13,10,35
Krasnodar,2594,5,9,5,6,29,25,4,32
Terek Grozny,2594,6,7,6,7,22,26,-4,27
FK Rubin,2594,7,6,6,8,23,17,6,24
Din Moscow,2594,8,5,6,9,17,24,-7,21
Amkar,2594,9,5,4,11,13,25,-12,19
Rostov,2594,10,4,6,10,10,18,-8,18
Anzhi,2594,11,2,6,12,15,39,-24,12
Loko Moscow,2595,1,11,6,3,32,15,17,39
CSKA Moscow,2595,2,11,4,5,27,18,9,37
Spart Moscow,2595,3,10,5,5,39,29,10,35
Krasnodar,2595,4,9,5,6,30,26,4,32
Terek Grozny,2595,5,9,5,6,23,23,0,32
Zenit,2595,6,7,10,3,23,15,8,31
FK Rubin,2595,7,6,6,8,24,19,5,24
Din Moscow,2595,8,6,6,8,21,25,-4,24
Rostov,2595,9,4,6,10,11,20,-9,18
Amkar,2595,10,4,4,12,9,24,-15,16
Anzhi,2595,11,2,5,13,16,41,-25,11
Loko Moscow,2596,1,12,6,2,32,13,19,42
CSKA Moscow,2596,2,10,3,7,26,22,4,33
Zenit,2596,3,8,8,4,25,15,10,32
Krasnodar,2596,4,9,5,6,30,26,4,32
Spart Moscow,2596,5,8,7,5,35,29,6,31
Terek Grozny,2596,6,8,5,7,23,28,-5,29
Din Moscow,2596,7,5,8,7,20,24,-4,23
Amkar,2596,8,6,4,10,16,22,-6,22
FK Rubin,2596,9,5,6,9,23,20,3,21
Rostov,2596,10,4,7,9,10,17,-7,19
Anzhi,2596,11,3,5,12,17,41,-24,14
Loko Moscow,2597,1,11,6,3,29,13,16,39
CSKA Moscow,2597,2,11,3,6,29,21,8,36
Spart Moscow,2597,3,10,5,5,41,28,13,35
Zenit,2597,4,8,9,3,23,14,9,33
Krasnodar,2597,5,9,4,7,29,26,3,31
Terek Grozny,2597,6,7,7,6,22,24,-2,28
FK Rubin,2597,7,7,5,8,25,17,8,26
Din Moscow,2597,8,6,6,8,20,25,-5,24
Rostov,2597,9,4,6,10,10,18,-8,18
Amkar,2597,10,4,5,11,9,27,-18,17
Anzhi,2597,11,2,6,12,18,42,-24,12
Loko Moscow,2598,1,13,5,2,35,12,23,44
Spart Moscow,2598,2,10,6,4,39,27,12,36
CSKA Moscow,2598,3,11,3,6,29,21,8,36
Zenit,2598,4,8,8,4,23,14,9,32
Krasnodar,2598,5,9,4,7,29,29,0,31
Terek Grozny,2598,6,8,6,6,22,23,-1,30
FK Rubin,2598,7,6,5,9,24,20,4,23
Din Moscow,2598,8,5,6,9,19,27,-8,21
Rostov,2598,9,4,7,9,12,19,-7,19
Amkar,2598,10,4,5,11,9,23,-14,17
Anzhi,2598,11,2,5,13,17,43,-26,11
Loko Moscow,2599,1,12,6,2,30,11,19,42
CSKA Moscow,2599,2,10,4,6,26,19,7,34
Zenit,2599,3,8,9,3,22,13,9,33
Krasnodar,2599,4,9,4,7,30,27,3,31
Spart Moscow,2599,5,8,6,6,36,31,5,30
Terek Grozny,2599,6,8,5,7,22,24,-2,29
Din Moscow,2599,7,6,7,7,20,22,-2,25
Amkar,2599,8,6,4,10,12,23,-11,22
Rostov,2599,9,5,6,9,13,18,-5,21
FK Rubin,2599,10,5,5,10,23,22,1,20
Anzhi,2599,11,2,6,12,16,40,-24,12
Loko Moscow,2600,1,11,7,2,32,14,18,40
Spart Moscow,2600,2,11,5,4,40,28,12,38
CSKA Moscow,2600,3,11,4,5,26,17,9,37
Zenit,2600,4,7,10,3,23,15,8,31
Krasnodar,2600,5,8,5,7,29,27,2,29
Terek Grozny,2600,6,8,5,7,23,25,-2,29
FK Rubin,2600,7,7,5,8,25,19,6,26
Din Moscow,2600,8,5,6,9,20,26,-6,21
Rostov,2600,9,4,6,10,11,19,-8,18
Amkar,2600,10,4,4,12,9,25,-16,16
Anzhi,2600,11,3,5,12,17,40,-23,14
Loko Moscow,2601,1,13,5,2,34,13,21,44
CSKA Moscow,2601,2,11,4,5,28,19,9,37
Spart Moscow,2601,3,10,6,4,37,27,10,36
Krasnodar,2601,4,9,4,7,31,28,3,31
Zenit,2601,5,7,9,4,22,15,7,30
Terek Grozny,2601,6,8,5,7,24,25,-1,29
FK Rubin,2601,7,6,5,9,23,19,4,23
Din Moscow,2601,8,5,6,9,17,24,-7,21
Rostov,2601,9,4,7,9,10,17,-7,19
Amkar,2601,10,5,4,11,13,26,-13,19
Anzhi,2601,11,2,5,13,16,42,-26,11
Loko Moscow,2602,1,11,5,4,31,15,16,38
CSKA Moscow,2602,2,11,3,6,29,19,10,36
Zenit,2602,3,9,8,3,24,14,10,35
Spart Moscow,2602,4,10,5,5,36,29,7,35
Krasnodar,2602,5,10,4,6,30,25,5,34
Terek Grozny,2602,6,7,5,8,20,26,-6,26
Din Moscow,2602,7,5,7,8,17,22,-5,22
Amkar,2602,8,6,4,10,14,22,-8,22
FK Rubin,2602,9,5,6,9,21,18,3,21
Rostov,2602,10,4,6,10,11,19,-8,18
Anzhi,2602,11,3,5,12,17,41,-24,14
Loko Moscow,2603,1,12,5,3,32,15,17,41
Spart Moscow,2603,2,10,6,4,38,25,13,36
CSKA Moscow,2603,3,11,3,6,30,21,9,36
Zenit,2603,4,9,8,3,27,15,12,35
Krasnodar,2603,5,9,4,7,30,28,2,31
Terek Grozny,2603,6,7,5,8,20,24,-4,26
FK Rubin,2603,7,6,5,9,24,20,4,23
Din Moscow,2603,8,5,6,9,18,26,-8,21
Amkar,2603,9,5,5,10,10,22,-12,20
Rostov,2603,10,4,6,10,10,19,-9,18
Anzhi,2603,11,3,5,12,16,40,-24,14
Loko Moscow,2604,1,11,6,3,30,14,16,39
CSKA Moscow,2604,2,10,5,5,27,19,8,35
Zenit,2604,3,8,9,3,23,13,10,33
Spart Moscow,2604,4,9,5,6,37,30,7,32
Terek Grozny,2604,5,8,6,6,22,23,-1,30
Krasnodar,2604,6,8,5,7,28,27,1,29
FK Rubin,2604,7,7,5,8,26,18,8,26
Rostov,2604,8,5,6,9,12,18,-6,21
Din Moscow,2604,9,5,6,9,18,25,-7,21
Amkar,2604,10,5,5,10,12,24,-12,20
Anzhi,2604,11,2,6,12,17,41,-24,12
Loko Moscow,2605,1,12,6,2,32,13,19,42
CSKA Moscow,2605,2,12,3,5,28,17,11,39
Spart Moscow,2605,3,10,5,5,39,28,11,35
Krasnodar,2605,4,8,6,6,30,27,3,30
Zenit,2605,5,7,8,5,21,15,6,29
Terek Grozny,2605,6,8,5,7,24,25,-1,29
FK Rubin,2605,7,6,6,8,23,18,5,24
Din Moscow,2605,8,5,6,9,17,25,-8,21
Amkar,2605,9,5,4,11,12,26,-14,19
Rostov,2605,10,4,6,10,10,18,-8,18
Anzhi,2605,11,3,5,12,17,41,-24,14
Loko Moscow,2606,1,12,6,2,32,11,21,42
Spart Moscow,2606,2,9,7,4,38,26,12,34
CSKA Moscow,2606,3,10,4,6,27,21,6,34
Zenit,2606,4,8,8,4,24,17,7,32
Krasnodar,2606,5,8,6,6,29,26,3,30
Terek Grozny,2606,6,8,5,7,23,23,0,29
Din Moscow,2606,7,6,7,7,19,21,-2,25
FK Rubin,2606,8,5,6,9,23,21,2,21
Amkar,2606,9,5,5,10,11,23,-12,20
Rostov,2606,10,4,6,10,10,21,-11,18
Anzhi,2606,11,2,6,12,15,41,-26,12
Loko Moscow,2607,1,12,5,3,34,14,20,41
Spart Moscow,2607,2,10,6,4,36,26,10,36
CSKA Moscow,2607,3,11,3,6,27,20,7,36
Zenit,2607,4,8,8,4,25,19,6,32
Krasnodar,2607,5,9,4,7,29,25,4,31
Terek Grozny,2607,6,7,6,7,21,24,-3,27
FK Rubin,2607,7,7,5,8,25,19,6,26
Din Moscow,2607,8,5,6,9,20,26,-6,21
Rostov,2607,9,4,7,9,10,17,-7,19
Amkar,2607,10,5,4,11,10,23,-13,19
Anzhi,2607,11,2,6,12,15,39,-24,12
Loko Moscow,2608,1,12,5,3,32,12,20,41
Spart Moscow,2608,2,11,5,4,43,30,13,38
CSKA Moscow,2608,3,10,4,6,27,20,7,34
Krasnodar,2608,4,10,4,6,30,24,6,34
Zenit,2608,5,7,9,4,22,17,5,30
Terek Grozny,2608,6,8,5,7,21,24,-3,29
FK Rubin,2608,7,6,5,9,24,21,3,23
Din Moscow,2608,8,5,6,9,20,28,-8,21
Amkar,2608,9,5,4,11,13,25,-12,19
Rostov,2608,10,4,6,10,12,20,-8,18
Anzhi,2608,11,3,5,12,16,39,-23,14
Loko Moscow,2609,1,11,5,4,31,15,16,38
CSKA Moscow,2609,2,11,3,6,29,21,8,36
Zenit,2609,3,9,8,3,27,15,12,35
Krasnodar,2609,4,10,4,6,30,25,5,34
Spart Moscow,2609,5,9,5,6,37,28,9,32
Terek Grozny,2609,6,8,5,7,21,23,-2,29
Din Moscow,2609,7,6,6,8,19,24,-5,24
Rostov,2609,8,5,6,9,12,18,-6,21
FK Rubin,2609,9,5,5,10,21,20,1,20
Amkar,2609,10,5,4,11,10,23,-13,19
Anzhi,2609,11,3,5,12,15,40,-25,14
Loko Moscow,2610,1,12,5,3,32,13,19,41
Spart Moscow,2610,2,11,5,4,42,25,17,38
Krasnodar,2610,3,10,4,6,30,24,6,34
CSKA Moscow,2610,4,10,3,7,25,20,5,33
Zenit,2610,5,8,8,4,24,16,8,32
Terek Grozny,2610,6,9,5,6,24,24,0,32
FK Rubin,2610,7,6,5,9,23,19,4,23
Din Moscow,2610,8,5,6,9,17,26,-9,21
Rostov,2610,9,4,6,10,10,22,-12,18
Amkar,2610,10,4,4,12,10,25,-15,16
Anzhi,2610,11,3,5,12,16,39,-23,14
Loko Moscow,2611,1,11,6,3,32,15,17,39
CSKA Moscow,2611,2,11,4,5,28,18,10,37
Spart Moscow,2611,3,10,5,5,38,28,10,35
Zenit,2611,4,8,8,4,24,17,7,32
Terek Grozny,2611,5,9,5,6,25,23,2,32
Krasnodar,2611,6,8,6,6,30,27,3,30
FK Rubin,2611,7,5,7,8,24,20,4,22
Din Moscow,2611,8,5,7,8,18,25,-7,22
Rostov,2611,9,5,6,9,12,17,-5,21
Amkar,2611,10,4,4,12,10,26,-16,16
Anzhi,2611,11,2,6,12,16,41,-25,12
Loko Moscow,2612,1,12,5,3,30,14,16,41
Spart Moscow,2612,2,11,5,4,44,31,13,38
CSKA Moscow,2612,3,10,4,6,26,19,7,34
Krasnodar,2612,4,9,4,7,30,25,5,31
Zenit,2612,5,7,9,4,22,15,7,30
Terek Grozny,2612,6,8,6,6,21,22,-1,30
FK Rubin,2612,7,6,6,8,23,18,5,24
Din Moscow,2612,8,5,7,8,21,28,-7,22
Rostov,2612,9,4,6,10,11,19,-8,18
Amkar,2612,10,4,5,11,11,25,-14,17
Anzhi,2612,11,3,5,12,15,38,-23,14
Loko Moscow,2613,1,12,5,3,31,14,17,41
CSKA Moscow,2613,2,10,4,6,26,19,7,34
Spart Moscow,2613,3,9,5,6,36,29,7,32
Krasnodar,2613,4,9,4,7,31,26,5,31
Zenit,2613,5,7,9,4,22,16,6,30
Terek Grozny,2613,6,8,5,7,24,24,0,29
Din Moscow,2613,7,7,6,7,20,21,-1,27
FK Rubin,2613,8,6,5,9,23,19,4,23
Amkar,2613,9,6,4,10,13,24,-11,22
Rostov,2613,10,4,6,10,10,19,-9,18
Anzhi,2613,11,3,5,12,15,40,-25,14
Loko Moscow,2614,1,11,7,2,31,13,18,40
Spart Moscow,2614,2,9,7,4,38,28,10,34
CSKA Moscow,2614,3,10,4,6,25,19,6,34
Krasnodar,2614,4,9,5,6,31,26,5,32
Zenit,2614,5,7,10,3,21,13,8,31
Terek Grozny,2614,6,8,6,6,22,23,-1,30
Din Moscow,2614,7,6,7,7,20,23,-3,25
FK Rubin,2614,8,5,5,10,21,20,1,20
Rostov,2614,9,4,7,9,11,18,-7,19
Amkar,2614,10,4,4,12,10,26,-16,16
Anzhi,2614,11,3,6,11,16,37,-21,15
Loko Moscow,2615,1,12,6,2,34,12,22,42
CSKA Moscow,2615,2,11,3,6,27,19,8,36
Spart Moscow,2615,3,10,5,5,36,26,10,35
Zenit,2615,4,7,9,4,22,15,7,30
Terek Grozny,2615,5,7,7,6,23,25,-2,28
Krasnodar,2615,6,8,4,8,29,32,-3,28
Din Moscow,2615,7,6,6,8,19,23,-4,24
FK Rubin,2615,8,6,5,9,25,21,4,23
Amkar,2615,9,5,5,10,11,23,-12,20
Rostov,2615,10,4,6,10,10,18,-8,18
Anzhi,2615,11,3,6,11,18,40,-22,15
Loko Moscow,2616,1,11,6,3,30,13,17,39
Spart Moscow,2616,2,11,5,4,39,27,12,38
CSKA Moscow,2616,3,11,4,5,28,17,11,37
Zenit,2616,4,7,10,3,21,13,8,31
Krasnodar,2616,5,9,4,7,29,28,1,31
Terek Grozny,2616,6,8,5,7,21,24,-3,29
FK Rubin,2616,7,7,5,8,25,17,8,26
Din Moscow,2616,8,5,6,9,17,24,-7,21
Amkar,2616,9,5,4,11,13,25,-12,19
Rostov,2616,10,4,6,10,10,18,-8,18
Anzhi,2616,11,2,5,13,14,41,-27,11
Loko Moscow,2617,1,13,5,2,32,11,21,44
Spart Moscow,2617,2,10,6,4,39,26,13,36
CSKA Moscow,2617,3,11,3,6,28,21,7,36
Zenit,2617,4,8,8,4,24,15,9,32
Krasnodar,2617,5,9,4,7,29,25,4,31
Terek Grozny,2617,6,8,6,6,25,25,0,30
Din Moscow,2617,7,5,7,8,19,26,-7,22
FK Rubin,2617,8,5,6,9,22,20,2,21
Rostov,2617,9,4,7,9,10,17,-7,19
Amkar,2617,10,4,5,11,12,27,-15,17
Anzhi,2617,11,2,5,13,15,42,-27,11
Loko Moscow,2618,1,11,5,4,29,14,15,38
CSKA Moscow,2618,2,11,3,6,27,19,8,36
Zenit,2618,3,9,8,3,24,13,11,35
Spart Moscow,2618,4,9,7,4,38,27,11,34
Krasnodar,2618,5,9,5,6,30,25,5,32
Terek Grozny,2618,6,8,6,6,24,25,-1,30
Din Moscow,2618,7,6,6,8,21,24,-3,24
FK Rubin,2618,8,5,6,9,22,22,0,21
Rostov,2618,9,4,7,9,10,17,-7,19
Amkar,2618,10,4,5,11,12,26,-14,17
Anzhi,2618,11,2,6,12,16,41,-25,12
Loko Moscow,2619,1,12,6,2,31,12,19,42
CSKA Moscow,2619,2,11,4,5,27,17,10,37
Spart Moscow,2619,3,10,6,4,40,28,12,36
Krasnodar,2619,4,9,5,6,31,25,6,32
Zenit,2619,5,7,9,4,21,14,7,30
Terek Grozny,2619,6,8,6,6,24,25,-1,30
FK Rubin,2619,7,6,5,9,22,20,2,23
Din Moscow,2619,8,5,6,9,17,25,-8,21
Rostov,2619,9,4,6,10,12,20,-8,18
Amkar,2619,10,4,5,11,11,25,-14,17
Anzhi,2619,11,2,6,12,16,41,-25,12
Loko Moscow,2620,1,11,7,2,30,12,18,40
Spart Moscow,2620,2,11,5,4,40,25,15,38
CSKA Moscow,2620,3,11,4,5,29,19,10,37
Zenit,2620,4,7,10,3,22,14,8,31
Krasnodar,2620,5,8,6,6,29,26,3,30
Terek Grozny,2620,6,8,6,6,24,23,1,30
FK Rubin,2620,7,5,7,8,23,19,4,22
Din Moscow,2620,8,5,7,8,18,24,-6,22
Rostov,2620,9,4,6,10,10,19,-9,18
Amkar,2620,10,4,5,11,10,26,-16,17
Anzhi,2620,11,2,5,13,15,43,-28,11
Loko Moscow,2621,1,12,6,2,31,12,19,42
CSKA Moscow,2621,2,11,4,5,30,20,10,37
Spart Moscow,2621,3,9,5,6,38,31,7,32
Zenit,2621,4,7,10,3,22,14,8,31
Krasnodar,2621,5,8,4,8,27,26,1,28
Terek Grozny,2621,6,7,6,7,23,26,-3,27
Din Moscow,2621,7,6,7,7,19,22,-3,25
FK Rubin,2621,8,6,6,8,22,17,5,24
Rostov,2621,9,5,6,9,14,19,-5,21
Amkar,2621,10,4,5,11,11,26,-15,17
Anzhi,2621,11,3,5,12,19,43,-24,14
Loko Moscow,2622,1,13,5,2,33,12,21,44
CSKA Moscow,2622,2,11,3,6,28,19,9,36
Spart Moscow,2622,3,10,5,5,40,30,10,35
Zenit,2622,4,8,8,4,22,14,8,32
Krasnodar,2622,5,9,4,7,31,28,3,31
Terek Grozny,2622,6,8,5,7,21,25,-4,29
FK Rubin,2622,7,6,5,9,25,20,5,23
Rostov,2622,8,5,6,9,14,18,-4,21
Din Moscow,2622,9,5,6,9,18,27,-9,21
Amkar,2622,10,5,4,11,12,25,-13,19
Anzhi,2622,11,2,5,13,15,41,-26,11
Loko Moscow,2623,1,12,6,2,32,13,19,42
CSKA Moscow,2623,2,12,3,5,28,17,11,39
Spart Moscow,2623,3,10,5,5,39,29,10,35
Zenit,2623,4,7,9,4,22,16,6,30
Krasnodar,2623,5,8,4,8,29,28,1,28
Terek Grozny,2623,6,7,6,7,24,28,-4,27
FK Rubin,2623,7,6,6,8,24,19,5,24
Din Moscow,2623,8,5,7,8,20,25,-5,22
Rostov,2623,9,5,6,9,12,18,-6,21
Amkar,2623,10,5,4,11,14,27,-13,19
Anzhi,2623,11,2,6,12,15,39,-24,12
Loko Moscow,2624,1,12,6,2,31,11,20,42
CSKA Moscow,2624,2,11,3,6,28,20,8,36
Zenit,2624,3,8,9,3,23,13,10,33
Spart Moscow,2624,4,9,5,6,36,30,6,32
Krasnodar,2624,5,8,4,8,27,28,-1,28
Terek Grozny,2624,6,7,6,7,21,24,-3,27
Din Moscow,2624,7,6,7,7,20,23,-3,25
FK Rubin,2624,8,6,6,8,25,19,6,24
Amkar,2624,9,5,5,10,12,23,-11,20
Rostov,2624,10,4,6,10,11,19,-8,18
Anzhi,2624,11,3,5,12,17,41,-24,14
Loko Moscow,2625,1,11,5,4,33,17,16,38
CSKA Moscow,2625,2,11,3,6,28,19,9,36
Zenit,2625,3,9,8,3,25,15,10,35
Spart Moscow,2625,4,10,5,5,37,29,8,35
Krasnodar,2625,5,10,4,6,34,28,6,34
Terek Grozny,2625,6,8,6,6,22,23,-1,30
Din Moscow,2625,7,6,6,8,19,24,-5,24
FK Rubin,2625,8,5,5,10,22,21,1,20
Amkar,2625,9,5,5,10,12,22,-10,20
Rostov,2625,10,4,6,10,10,18,-8,18
Anzhi,2625,11,2,5,13,15,41,-26,11
Loko Moscow,2626,1,12,6,2,32,12,20,42
CSKA Moscow,2626,2,12,3,5,34,19,15,39
Spart Moscow,2626,3,9,7,4,37,28,9,34
Krasnodar,2626,4,8,6,6,29,26,3,30
Zenit,2626,5,7,8,5,24,21,3,29
Terek Grozny,2626,6,7,5,8,22,28,-6,26
FK Rubin,2626,7,6,6,8,27,19,8,24
Din Moscow,2626,8,5,7,8,18,26,-8,22
Rostov,2626,9,4,7,9,11,18,-7,19
Amkar,2626,10,5,4,11,13,25,-12,19
Anzhi,2626,11,3,5,12,17,42,-25,14
Loko Moscow,2627,1,11,5,4,30,17,13,38
CSKA Moscow,2627,2,11,3,6,30,18,12,36
Spart Moscow,2627,3,10,5,5,41,30,11,35
Krasnodar,2627,4,10,4,6,32,25,7,34
Zenit,2627,5,8,8,4,24,18,6,32
Terek Grozny,2627,6,8,6,6,23,23,0,30
FK Rubin,2627,7,6,5,9,22,19,3,23
Din Moscow,2627,8,5,6,9,19,25,-6,21
Amkar,2627,9,5,5,10,12,24,-12,20
Rostov,2627,10,4,6,10,10,20,-10,18
Anzhi,2627,11,3,5,12,16,40,-24,14
Loko Moscow,2628,1,11,5,4,29,13,16,38
Spart Moscow,2628,2,10,6,4,38,27,11,36
CSKA Moscow,2628,3,11,3,6,26,18,8,36
Zenit,2628,4,9,8,3,23,13,10,35
Krasnodar,2628,5,9,5,6,28,24,4,32
Terek Grozny,2628,6,7,7,6,20,22,-2,28
Din Moscow,2628,7,6,6,8,18,22,-4,24
FK Rubin,2628,8,5,6,9,21,18,3,21
Rostov,2628,9,4,7,9,11,18,-7,19
Amkar,2628,10,4,5,11,10,25,-15,17
Anzhi,2628,11,2,6,12,14,38,-24,12
Loko Moscow,2629,1,11,6,3,31,14,17,39
CSKA Moscow,2629,2,11,4,5,28,18,10,37
Spart Moscow,2629,3,9,6,5,38,30,8,33
Zenit,2629,4,7,10,3,23,15,8,31
Krasnodar,2629,5,9,4,7,29,28,1,31
Terek Grozny,2629,6,8,6,6,21,22,-1,30
FK Rubin,2629,7,7,5,8,25,17,8,26
Din Moscow,2629,8,5,6,9,17,25,-8,21
Rostov,2629,9,4,7,9,12,19,-7,19
Amkar,2629,10,5,4,11,12,23,-11,19
Anzhi,2629,11,2,6,12,14,39,-25,12
Loko Moscow,2630,1,13,5,2,34,13,21,44
Spart Moscow,2630,2,10,6,4,38,26,12,36
CSKA Moscow,2630,3,10,5,5,27,19,8,35
Terek Grozny,2630,4,9,5,6,22,22,0,32
Zenit,2630,5,7,9,4,23,16,7,30
Krasnodar,2630,6,8,4,8,28,28,0,28
FK Rubin,2630,7,6,6,8,23,18,5,24
Din Moscow,2630,8,5,7,8,17,23,-6,22
Rostov,2630,9,4,7,9,11,18,-7,19
Amkar,2630,10,4,4,12,9,25,-16,16
Anzhi,2630,11,2,6,12,16,40,-24,12
Loko Moscow,2631,1,11,6,3,30,14,16,39
Spart Moscow,2631,2,11,5,4,36,25,11,38
CSKA Moscow,2631,3,11,4,5,26,17,9,37
Zenit,2631,4,8,9,3,23,13,10,33
Krasnodar,2631,5,9,5,6,30,25,5,32
Terek Grozny,2631,6,7,6,7,21,24,-3,27
Din Moscow,2631,7,5,7,8,19,24,-5,22
FK Rubin,2631,8,5,6,9,23,21,2,21
Amkar,2631,9,5,4,11,10,23,-13,19
Rostov,2631,10,4,6,10,10,18,-8,18
Anzhi,2631,11,2,6,12,15,39,-24,12
Loko Moscow,2632,1,11,7,2,32,14,18,40
Spart Moscow,2632,2,10,5,5,39,30,9,35
CSKA Moscow,2632,3,10,4,6,27,20,7,34
Zenit,2632,4,8,9,3,23,14,9,33
Krasnodar,2632,5,9,5,6,31,27,4,32
Terek Grozny,2632,6,8,5,7,21,26,-5,29
Din Moscow,2632,7,6,6,8,19,23,-4,24
Rostov,2632,8,5,6,9,13,18,-5,21
FK Rubin,2632,9,5,5,10,22,20,2,20
Amkar,2632,10,5,4,11,14,25,-11,19
Anzhi,2632,11,2,6,12,16,40,-24,12
Loko Moscow,2633,1,11,6,3,31,15,16,39
CSKA Moscow,2633,2,10,4,6,28,23,5,34
Zenit,2633,3,8,9,3,25,15,10,33
Spart Moscow,2633,4,9,5,6,38,31,7,32
Terek Grozny,2633,5,9,5,6,25,23,2,32
Krasnodar,2633,6,8,5,7,28,27,1,29
Din Moscow,2633,7,6,7,7,19,22,-3,25
FK Rubin,2633,8,6,6,8,24,18,6,24
Amkar,2633,9,5,4,11,13,27,-14,19
Rostov,2633,10,4,6,10,12,20,-8,18
Anzhi,2633,11,3,5,12,19,41,-22,14
Loko Moscow,2634,1,11,6,3,30,13,17,39
Zenit,2634,2,9,8,3,25,14,11,35
CSKA Moscow,2634,3,10,3,7,25,21,4,33
Krasnodar,2634,4,9,5,6,31,25,6,32
Spart Moscow,2634,5,8,7,5,36,29,7,31
Terek Grozny,2634,6,7,7,6,22,24,-2,28
Din Moscow,2634,7,5,8,7,17,21,-4,23
FK Rubin,2634,8,5,6,9,22,21,1,21
Amkar,2634,9,5,5,10,11,23,-12,20
Rostov,2634,10,4,7,9,13,20,-7,19
Anzhi,2634,11,3,6,11,17,38,-21,15
Loko Moscow,2635,1,11,7,2,32,14,18,40
CSKA Moscow,2635,2,11,3,6,29,18,11,36
Spart Moscow,2635,3,9,7,4,37,28,9,34
Zenit,2635,4,8,9,3,24,15,9,33
Krasnodar,2635,5,9,5,6,33,25,8,32
Terek Grozny,2635,6,7,6,7,21,26,-5,27
Din Moscow,2635,7,6,6,8,18,22,-4,24
FK Rubin,2635,8,5,5,10,21,23,-2,20
Amkar,2635,9,5,5,10,14,24,-10,20
Rostov,2635,10,4,7,9,11,18,-7,19
Anzhi,2635,11,2,6,12,15,42,-27,12
Loko Moscow,2636,1,11,6,3,30,13,17,39
CSKA Moscow,2636,2,11,4,5,29,20,9,37
Spart Moscow,2636,3,10,5,5,38,27,11,35
Zenit,2636,4,8,9,3,26,17,9,33
Krasnodar,2636,5,8,6,6,27,24,3,30
Terek Grozny,2636,6,8,6,6,24,23,1,30
Din Moscow,2636,7,6,6,8,20,22,-2,24
FK Rubin,2636,8,5,6,9,21,20,1,21
Amkar,2636,9,5,5,10,11,22,-11,20
Rostov,2636,10,4,6,10,10,21,-11,18
Anzhi,2636,11,2,5,13,15,42,-27,11
Loko Moscow,2637,1,11,7,2,33,15,18,40
CSKA Moscow,2637,2,10,5,5,27,19,8,35
Spart Moscow,2637,3,9,7,4,36,26,10,34
Zenit,2637,4,7,10,3,25,17,8,31
Krasnodar,2637,5,8,5,7,28,26,2,29
Terek Grozny,2637,6,7,6,7,23,27,-4,27
FK Rubin,2637,7,6,6,8,23,18,5,24
Din Moscow,2637,8,5,7,8,19,25,-6,22
Amkar,2637,9,5,5,10,12,23,-11,20
Rostov,2637,10,4,7,9,10,17,-7,19
Anzhi,2637,11,2,7,11,17,40,-23,13
Loko Moscow,2638,1,12,5,3,31,13,18,41
Spart Moscow,2638,2,10,6,4,42,32,10,36
CSKA Moscow,2638,3,10,4,6,26,19,7,34
Zenit,2638,4,8,9,3,23,13,10,33
Krasnodar,2638,5,8,5,7,28,27,1,29
Terek Grozny,2638,6,8,5,7,22,24,-2,29
Din Moscow,2638,7,6,6,8,21,25,-4,24
FK Rubin,2638,8,5,6,9,22,19,3,21
Rostov,2638,9,4,6,10,11,19,-8,18
Amkar,2638,10,4,5,11,13,27,-14,17
Anzhi,2638,11,4,5,11,17,38,-21,17
Loko Moscow,2639,1,12,5,3,30,12,18,41
CSKA Moscow,2639,2,11,3,6,26,19,7,36
Spart Moscow,2639,3,10,5,5,40,27,13,35
Zenit,2639,4,8,8,4,22,14,8,32
Krasnodar,2639,5,8,5,7,29,27,2,29
Din Moscow,2639,6,7,6,7,20,21,-1,27
Terek Grozny,2639,7,7,6,7,21,24,-3,27
FK Rubin,2639,8,5,6,9,23,21,2,21
Rostov,2639,9,4,6,10,11,22,-11,18
Amkar,2639,10,4,5,11,10,25,-15,17
Anzhi,2639,11,4,5,11,17,37,-20,17
Loko Moscow,2640,1,12,6,2,32,13,19,42
Spart Moscow,2640,2,11,5,4,40,26,14,38
CSKA Moscow,2640,3,11,4,5,28,18,10,37
Zenit,2640,4,7,9,4,23,16,7,30
Krasnodar,2640,5,8,6,6,28,25,3,30
Terek Grozny,2640,6,8,6,6,25,23,2,30
FK Rubin,2640,7,5,7,8,21,17,4,22
Din Moscow,2640,8,5,7,8,18,24,-6,22
Rostov,2640,9,4,6,10,10,19,-9,18
Amkar,2640,10,4,5,11,10,25,-15,17
Anzhi,2640,11,2,5,13,14,43,-29,11
Loko Moscow,2641,1,12,5,3,31,13,18,41
CSKA Moscow,2641,2,11,4,5,27,18,9,37
Krasnodar,2641,3,9,5,6,30,26,4,32
Zenit,2641,4,7,8,5,21,15,6,29
Spart Moscow,2641,5,8,5,7,35,34,1,29
Terek Grozny,2641,6,7,7,6,21,23,-2,28
Din Moscow,2641,7,6,7,7,22,22,0,25
FK Rubin,2641,8,5,7,8,22,18,4,22
Rostov,2641,9,5,6,9,13,18,-5,21
Amkar,2641,10,5,5,10,11,23,-12,20
Anzhi,2641,11,2,7,11,15,38,-23,13
Loko Moscow,2642,1,12,6,2,31,12,19,42
CSKA Moscow,2642,2,11,4,5,29,20,9,37
Spart Moscow,2642,3,10,6,4,38,28,10,36
Krasnodar,2642,4,9,5,6,30,25,5,32
Zenit,2642,5,7,9,4,23,16,7,30
Terek Grozny,2642,6,8,5,7,21,23,-2,29
Din Moscow,2642,7,5,7,8,19,24,-5,22
FK Rubin,2642,8,5,6,9,22,20,2,21
Rostov,2642,9,4,7,9,11,18,-7,19
Amkar,2642,10,4,4,12,10,25,-15,16
Anzhi,2642,11,3,5,12,16,39,-23,14
Loko Moscow,2643,1,11,5,4,29,14,15,38
CSKA Moscow,2643,2,11,4,5,27,17,10,37
Spart Moscow,2643,3,9,7,4,38,28,10,34
Zenit,2643,4,8,9,3,23,13,10,33
Krasnodar,2643,5,9,4,7,28,25,3,31
Terek Grozny,2643,6,8,5,7,23,24,-1,29
FK Rubin,2643,7,7,5,8,23,17,6,26
Din Moscow,2643,8,5,7,8,18,23,-5,22
Amkar,2643,9,5,5,10,12,23,-11,20
Rostov,2643,10,4,6,10,11,20,-9,18
Anzhi,2643,11,2,5,13,14,42,-28,11
Loko Moscow,2644,1,11,6,3,29,13,16,39
CSKA Moscow,2644,2,11,3,6,26,18,8,36
Zenit,2644,3,8,9,3,22,13,9,33
Spart Moscow,2644,4,8,7,5,34,28,6,31
Krasnodar,2644,5,9,4,7,30,28,2,31
Terek Grozny,2644,6,8,5,7,22,26,-4,29
FK Rubin,2644,7,6,6,8,27,20,7,24
Din Moscow,2644,8,5,8,7,19,23,-4,23
Rostov,2644,9,4,7,9,11,18,-7,19
Amkar,2644,10,5,4,11,11,23,-12,19
Anzhi,2644,11,3,5,12,18,39,-21,14
CSKA Moscow,2645,1,12,3,5,27,17,10,39
Loko Moscow,2645,2,11,5,4,30,17,13,38
Spart Moscow,2645,3,9,6,5,38,28,10,33
Zenit,2645,4,8,8,4,25,14,11,32
Krasnodar,2645,5,9,5,6,29,25,4,32
Terek Grozny,2645,6,7,7,6,23,25,-2,28
Din Moscow,2645,7,6,6,8,21,26,-5,24
FK Rubin,2645,8,5,6,9,22,20,2,21
Amkar,2645,9,5,5,10,11,23,-12,20
Rostov,2645,10,4,7,9,11,18,-7,19
Anzhi,2645,11,2,6,12,16,40,-24,12
Loko Moscow,2646,1,11,6,3,31,15,16,39
CSKA Moscow,2646,2,11,4,5,26,17,9,37
Spart Moscow,2646,3,10,5,5,38,27,11,35
Krasnodar,2646,4,9,5,6,31,26,5,32
Zenit,2646,5,7,9,4,22,15,7,30
Terek Grozny,2646,6,7,5,8,22,26,-4,26
FK Rubin,2646,7,6,6,8,25,18,7,24
Din Moscow,2646,8,6,6,8,18,24,-6,24
Amkar,2646,9,5,4,11,13,27,-14,19
Rostov,2646,10,4,6,10,10,19,-9,18
Anzhi,2646,11,3,6,11,15,37,-22,15
Loko Moscow,2647,1,13,5,2,35,12,23,44
CSKA Moscow,2647,2,11,3,6,27,21,6,36
Spart Moscow,2647,3,9,6,5,35,27,8,33
Zenit,2647,4,8,8,4,25,18,7,32
Krasnodar,2647,5,9,4,7,29,26,3,31
Terek Grozny,2647,6,8,5,7,23,26,-3,29
Din Moscow,2647,7,6,6,8,19,22,-3,24
FK Rubin,2647,8,5,5,10,21,20,1,20
Rostov,2647,9,4,7,9,11,18,-7,19
Amkar,2647,10,5,4,11,11,24,-13,19
Anzhi,2647,11,3,5,12,17,39,-22,14
Loko Moscow,2648,1,12,5,3,33,14,19,41
Spart Moscow,2648,2,11,5,4,41,25,16,38
CSKA Moscow,2648,3,11,3,6,27,19,8,36
Zenit,2648,4,8,8,4,24,17,7,32
Krasnodar,2648,5,9,5,6,30,26,4,32
Terek Grozny,2648,6,9,5,6,22,22,0,32
FK Rubin,2648,7,5,7,8,22,18,4,22
Din Moscow,2648,8,5,7,8,17,23,-6,22
Rostov,2648,9,4,6,10,10,20,-10,18
Amkar,2648,10,4,4,12,9,26,-17,16
Anzhi,2648,11,2,5,13,14,39,-25,11
Loko Moscow,2649,1,11,7,2,32,14,18,40
CSKA Moscow,2649,2,11,4,5,28,18,10,37
Spart Moscow,2649,3,9,6,5,38,29,9,33
Zenit,2649,4,7,10,3,22,14,8,31
Krasnodar,2649,5,8,6,6,31,28,3,30
Terek Grozny,2649,6,7,7,6,21,23,-2,28
FK Rubin,2649,7,5,7,8,23,19,4,22
Din Moscow,2649,8,5,7,8,17,24,-7,22
Amkar,2649,9,5,5,10,11,22,-11,20
Rostov,2649,10,4,7,9,12,19,-7,19
Anzhi,2649,11,2,6,12,16,41,-25,12
Loko Moscow,2650,1,12,6,2,32,12,20,42
Spart Moscow,2650,2,11,5,4,40,27,13,38
CSKA Moscow,2650,3,11,3,6,31,21,10,36
Zenit,2650,4,8,8,4,23,15,8,32
Krasnodar,2650,5,9,5,6,30,26,4,32
Terek Grozny,2650,6,7,6,7,21,25,-4,27
Din Moscow,2650,7,6,6,8,19,24,-5,24
FK Rubin,2650,8,5,5,10,23,21,2,20
Rostov,2650,9,4,6,10,11,20,-9,18
Amkar,2650,10,4,5,11,11,25,-14,17
Anzhi,2650,11,3,5,12,18,43,-25,14
Loko Moscow,2651,1,11,7,2,30,12,18,40
CSKA Moscow,2651,2,11,3,6,28,18,10,36
Zenit,2651,3,8,9,3,22,13,9,33
Spart Moscow,2651,4,9,5,6,35,32,3,32
Terek Grozny,2651,5,8,6,6,23,24,-1,30
Krasnodar,2651,6,8,5,7,28,26,2,29
Din Moscow,2651,7,6,6,8,20,23,-3,24
FK Rubin,2651,8,6,5,9,23,20,3,23
Rostov,2651,9,5,6,9,12,17,-5,21
Amkar,2651,10,5,5,10,15,24,-9,20
Anzhi,2651,11,2,5,13,15,42,-27,11
Loko Moscow,2652,1,13,5,2,32,12,20,44
CSKA Moscow,2652,2,12,3,5,32,18,14,39
Spart Moscow,2652,3,10,6,4,40,30,10,36
Zenit,2652,4,7,8,5,21,16,5,29
Krasnodar,2652,5,8,4,8,28,28,0,28
Terek Grozny,2652,6,7,6,7,22,25,-3,27
FK Rubin,2652,7,7,5,8,26,17,9,26
Din Moscow,2652,8,5,7,8,19,26,-7,22
Amkar,2652,9,5,4,11,12,25,-13,19
Rostov,2652,10,4,6,10,11,19,-8,18
Anzhi,2652,11,2,6,12,17,44,-27,12
Loko Moscow,2653,1,11,6,3,29,12,17,39
CSKA Moscow,2653,2,11,4,5,30,20,10,37
Zenit,2653,3,8,9,3,23,14,9,33
Krasnodar,2653,4,9,5,6,29,24,5,32
Spart Moscow,2653,5,8,7,5,35,29,6,31
Terek Grozny,2653,6,7,5,8,22,26,-4,26
Din Moscow,2653,7,6,7,7,20,23,-3,25
Amkar,2653,8,6,4,10,13,23,-10,22
FK Rubin,2653,9,5,5,10,21,20,1,20
Rostov,2653,10,4,7,9,10,17,-7,19
Anzhi,2653,11,3,5,12,18,42,-24,14
Loko Moscow,2654,1,11,6,3,31,14,17,39
CSKA Moscow,2654,2,12,3,5,28,18,10,39
Zenit,2654,3,8,8,4,22,14,8,32
Terek Grozny,2654,4,9,5,6,24,24,0,32
Spart Moscow,2654,5,8,7,5,35,29,6,31
Krasnodar,2654,6,8,5,7,30,28,2,29
FK Rubin,2654,7,7,5,8,25,18,7,26
Din Moscow,2654,8,5,7,8,17,23,-6,22
Rostov,2654,9,4,7,9,11,18,-7,19
Amkar,2654,10,5,4,11,14,26,-12,19
Anzhi,2654,11,2,5,13,15,40,-25,11
Loko Moscow,2655,1,13,5,2,32,12,20,44
Spart Moscow,2655,2,9,7,4,36,27,9,34
CSKA Moscow,2655,3,10,4,6,26,19,7,34
Zenit,2655,4,8,8,4,23,15,8,32
Krasnodar,2655,5,9,4,7,28,25,3,31
Terek Grozny,2655,6,8,5,7,22,25,-3,29
Din Moscow,2655,7,6,6,8,19,23,-4,24
FK Rubin,2655,8,5,5,10,21,19,2,20
Rostov,2655,9,4,7,9,10,17,-7,19
Amkar,2655,10,4,5,11,11,25,-14,17
Anzhi,2655,11,3,6,11,17,38,-21,15
Loko Moscow,2656,1,11,6,3,31,14,17,39
CSKA Moscow,2656,2,11,4,5,27,18,9,37
Spart Moscow,2656,3,9,7,4,38,28,10,34
Krasnodar,2656,4,9,5,6,30,26,4,32
Terek Grozny,2656,5,9,5,6,24,22,2,32
Zenit,2656,6,7,10,3,23,15,8,31
FK Rubin,2656,7,5,7,8,22,18,4,22
Din Moscow,2656,8,5,7,8,17,23,-6,22
Rostov,2656,9,4,7,9,11,18,-7,19
Amkar,2656,10,4,5,11,11,25,-14,17
Anzhi,2656,11,2,5,13,14,41,-27,11
Loko Moscow,2657,1,12,5,3,34,16,18,41
CSKA Moscow,2657,2,11,3,6,30,21,9,36
Zenit,2657,3,9,8,3,26,14,12,35
Spart Moscow,2657,4,9,6,5,35,27,8,33
Terek Grozny,2657,5,8,5,7,25,24,1,29
Krasnodar,2657,6,8,4,8,29,29,0,28
Din Moscow,2657,7,6,6,8,18,22,-4,24
FK Rubin,2657,8,6,5,9,22,18,4,23
Rostov,2657,9,5,6,9,11,17,-6,21
Amkar,2657,10,5,5,10,12,24,-12,20
Anzhi,2657,11,2,5,13,16,46,-30,11
Loko Moscow,2658,1,12,6,2,30,11,19,42
CSKA Moscow,2658,2,11,4,5,26,17,9,37
Spart Moscow,2658,3,9,5,6,37,31,6,32
Zenit,2658,4,7,9,4,21,14,7,30
Terek Grozny,2658,5,8,6,6,22,23,-1,30
Krasnodar,2658,6,8,4,8,28,27,1,28
Din Moscow,2658,7,6,7,7,20,23,-3,25
FK Rubin,2658,8,6,6,8,24,19,5,24
Amkar,2658,9,5,5,10,14,23,-9,20
Rostov,2658,10,4,6,10,10,20,-10,18
Anzhi,2658,11,2,6,12,14,38,-24,12
Loko Moscow,2659,1,13,5,2,34,12,22,44
CSKA Moscow,2659,2,11,3,6,29,20,9,36
Zenit,2659,3,8,8,4,23,16,7,32
Spart Moscow,2659,4,9,5,6,38,34,4,32
Krasnodar,2659,5,9,4,7,30,27,3,31
Terek Grozny,2659,6,8,6,6,23,23,0,30
Din Moscow,2659,7,7,6,7,22,23,-1,27
FK Rubin,2659,8,5,5,10,22,20,2,20
Amkar,2659,9,5,5,10,14,24,-10,20
Rostov,2659,10,4,6,10,11,19,-8,18
Anzhi,2659,11,2,5,13,15,43,-28,11
Loko Moscow,2660,1,12,5,3,33,13,20,41
CSKA Moscow,2660,2,12,3,5,29,17,12,39
Spart Moscow,2660,3,11,5,4,39,26,13,38
Krasnodar,2660,4,10,4,6,31,25,6,34
Zenit,2660,5,7,8,5,21,17,4,29
Terek Grozny,2660,6,7,6,7,25,28,-3,27
Din Moscow,2660,7,5,7,8,19,24,-5,22
FK Rubin,2660,8,5,6,9,22,20,2,21
Amkar,2660,9,5,4,11,11,26,-15,19
Rostov,2660,10,4,6,10,10,18,-8,18
Anzhi,2660,11,2,6,12,18,44,-26,12
Loko Moscow,2661,1,12,5,3,31,13,18,41
Spart Moscow,2661,2,10,5,5,36,26,10,35
CSKA Moscow,2661,3,10,5,5,27,19,8,35
Zenit,2661,4,8,9,3,23,14,9,33
Krasnodar,2661,5,8,4,8,30,29,1,28
Terek Grozny,2661,6,7,7,6,22,24,-2,28
FK Rubin,2661,7,7,5,8,26,20,6,26
Din Moscow,2661,8,5,6,9,18,25,-7,21
Amkar,2661,9,5,5,10,11,23,-12,20
Rostov,2661,10,4,6,10,10,18,-8,18
Anzhi,2661,11,2,7,11,16,39,-23,13
Loko Moscow,2662,1,13,5,2,32,11,21,44
CSKA Moscow,2662,2,12,3,5,28,17,11,39
Spart Moscow,2662,3,9,7,4,39,30,9,34
Zenit,2662,4,7,8,5,21,15,6,29
Krasnodar,2662,5,8,4,8,28,28,0,28
Terek Grozny,2662,6,7,6,7,20,23,-3,27
FK Rubin,2662,7,7,5,8,24,18,6,26
Din Moscow,2662,8,5,7,8,19,24,-5,22
Amkar,2662,9,5,5,10,13,25,-12,20
Rostov,2662,10,4,6,10,10,18,-8,18
Anzhi,2662,11,2,6,12,14,39,-25,12
Loko Moscow,2663,1,11,5,4,29,15,14,38
CSKA Moscow,2663,2,11,4,5,28,18,10,37
Spart Moscow,2663,3,10,5,5,38,27,11,35
Zenit,2663,4,8,9,3,22,13,9,33
Krasnodar,2663,5,9,5,6,31,25,6,32
Terek Grozny,2663,6,8,6,6,21,22,-1,30
FK Rubin,2663,7,6,6,8,23,18,5,24
Din Moscow,2663,8,5,6,9,17,23,-6,21
Amkar,2663,9,5,4,11,11,24,-13,19
Rostov,2663,10,4,6,10,10,20,-10,18
Anzhi,2663,11,2,6,12,15,40,-25,12
Loko Moscow,2664,1,12,5,3,32,15,17,41
CSKA Moscow,2664,2,12,3,5,32,19,13,39
Zenit,2664,3,8,8,4,26,16,10,32
Spart Moscow,2664,4,8,5,7,35,33,2,29
Krasnodar,2664,5,8,5,7,28,27,1,29
Din Moscow,2664,6,7,6,7,20,22,-2,27
Terek Grozny,2664,7,7,5,8,21,25,-4,26
Amkar,2664,8,6,4,10,12,22,-10,22
FK Rubin,2664,9,5,6,9,22,19,3,21
Rostov,2664,10,5,6,9,14,18,-4,21
Anzhi,2664,11,3,5,12,17,43,-26,14
Loko Moscow,2665,1,11,5,4,30,16,14,38
Spart Moscow,2665,2,10,6,4,39,28,11,36
CSKA Moscow,2665,3,11,3,6,26,18,8,36
Zenit,2665,4,9,8,3,24,13,11,35
Krasnodar,2665,5,10,4,6,32,25,7,34
Terek Grozny,2665,6,7,6,7,20,24,-4,27
FK Rubin,2665,7,6,5,9,23,20,3,23
Din Moscow,2665,8,5,6,9,18,24,-6,21
Rostov,2665,9,4,6,10,12,21,-9,18
Amkar,2665,10,4,6,10,10,23,-13,18
Anzhi,2665,11,3,5,12,16,38,-22,14
Loko Moscow,2666,1,11,6,3,29,12,17,39
Spart Moscow,2666,2,10,5,5,39,28,11,35
CSKA Moscow,2666,3,10,5,5,26,18,8,35
Krasnodar,2666,4,9,5,6,28,24,4,32
Zenit,2666,5,7,10,3,21,13,8,31
Terek Grozny,2666,6,8,5,7,22,23,-1,29
FK Rubin,2666,7,6,6,8,22,17,5,24
Din Moscow,2666,8,6,6,8,18,22,-4,24
Rostov,2666,9,4,6,10,11,21,-10,18
Amkar,2666,10,4,4,12,10,26,-16,16
Anzhi,2666,11,3,6,11,16,38,-22,15
Loko Moscow,2667,1,11,7,2,31,13,18,40
CSKA Moscow,2667,2,11,4,5,29,20,9,37
Spart Moscow,2667,3,10,5,5,37,26,11,35
Krasnodar,2667,4,9,5,6,30,25,5,32
Zenit,2667,5,7,9,4,23,16,7,30
Terek Grozny,2667,6,7,6,7,21,25,-4,27
Din Moscow,2667,7,5,7,8,17,24,-7,22
FK Rubin,2667,8,5,6,9,21,19,2,21
Amkar,2667,9,5,5,10,11,23,-12,20
Rostov,2667,10,4,6,10,10,18,-8,18
Anzhi,2667,11,3,6,11,18,39,-21,15
Loko Moscow,2668,1,12,5,3,33,14,19,41
Spart Moscow,2668,2,10,5,5,39,28,11,35
Krasnodar,2668,3,10,4,6,31,26,5,34
CSKA Moscow,2668,4,10,3,7,26,20,6,33
Zenit,2668,5,8,8,4,23,16,7,32
Terek Grozny,2668,6,7,7,6,21,23,-2,28
Din Moscow,2668,7,6,6,8,20,25,-5,24
Rostov,2668,8,5,6,9,11,17,-6,21
FK Rubin,2668,9,5,5,10,21,19,2,20
Amkar,2668,10,4,5,11,9,24,-15,17
Anzhi,2668,11,3,6,11,16,38,-22,15
Loko Moscow,2669,1,12,5,3,31,13,18,41
Spart Moscow,2669,2,11,5,4,38,25,13,38
CSKA Moscow,2669,3,11,3,6,26,18,8,36
Zenit,2669,4,8,8,4,22,14,8,32
Terek Grozny,2669,5,8,5,7,23,24,-1,29
Krasnodar,2669,6,8,4,8,28,27,1,28
FK Rubin,2669,7,7,5,8,24,18,6,26
Din Moscow,2669,8,5,6,9,18,25,-7,21
Rostov,2669,9,4,6,10,10,18,-8,18
Anzhi,2669,10,4,5,11,17,38,-21,17
Amkar,2669,11,4,4,12,9,26,-17,16
Loko Moscow,2670,1,11,7,2,33,15,18,40
Spart Moscow,2670,2,11,5,4,39,27,12,38
CSKA Moscow,2670,3,11,4,5,28,17,11,37
Zenit,2670,4,7,10,3,23,15,8,31
Krasnodar,2670,5,8,5,7,29,28,1,29
Terek Grozny,2670,6,7,7,6,23,25,-2,28
Din Moscow,2670,7,6,6,8,18,23,-5,24
FK Rubin,2670,8,6,5,9,23,18,5,23
Rostov,2670,9,4,6,10,11,19,-8,18
Amkar,2670,10,4,5,11,11,25,-14,17
Anzhi,2670,11,2,6,12,16,42,-26,12
Loko Moscow,2671,1,11,5,4,30,14,16,38
CSKA Moscow,2671,2,11,3,6,27,21,6,36
Spart Moscow,2671,3,10,5,5,40,27,13,35
Zenit,2671,4,9,8,3,25,13,12,35
Krasnodar,2671,5,9,5,6,29,25,4,32
Terek Grozny,2671,6,8,6,6,23,23,0,30
FK Rubin,2671,7,5,7,8,21,17,4,22
Din Moscow,2671,8,5,7,8,17,24,-7,22
Rostov,2671,9,5,6,9,12,17,-5,21
Amkar,2671,10,4,4,12,9,28,-19,16
Anzhi,2671,11,2,6,12,16,40,-24,12
Loko Moscow,2672,1,11,6,3,30,13,17,39
Zenit,2672,2,8,9,3,24,14,10,33
CSKA Moscow,2672,3,10,3,7,25,20,5,33
Krasnodar,2672,4,9,5,6,28,24,4,32
Terek Grozny,2672,5,9,5,6,26,23,3,32
Spart Moscow,2672,6,8,6,6,34,29,5,30
Din Moscow,2672,7,6,7,7,20,22,-2,25
FK Rubin,2672,8,5,6,9,21,19,2,21
Rostov,2672,9,5,6,9,11,17,-6,21
Amkar,2672,10,5,4,11,12,25,-13,19
Anzhi,2672,11,3,5,12,15,40,-25,14
Loko Moscow,2673,1,12,5,3,31,13,18,41
Spart Moscow,2673,2,10,5,5,38,28,10,35
CSKA Moscow,2673,3,10,4,6,27,20,7,34
Zenit,2673,4,8,8,4,22,15,7,32
Krasnodar,2673,5,9,5,6,30,25,5,32
Terek Grozny,2673,6,7,6,7,20,25,-5,27
FK Rubin,2673,7,6,6,8,25,18,7,24
Din Moscow,2673,8,6,6,8,19,24,-5,24
Rostov,2673,9,4,6,10,11,21,-10,18
Amkar,2673,10,4,5,11,9,23,-14,17
Anzhi,2673,11,3,6,11,19,39,-20,15
Loko Moscow,2674,1,11,5,4,30,15,15,38
Zenit,2674,2,9,8,3,24,13,11,35
CSKA Moscow,2674,3,10,4,6,25,18,7,34
Krasnodar,2674,4,10,4,6,31,26,5,34
Spart Moscow,2674,5,9,6,5,37,29,8,33
Terek Grozny,2674,6,8,5,7,22,24,-2,29
Din Moscow,2674,7,7,6,7,19,21,-2,27
FK Rubin,2674,8,5,5,10,22,20,2,20
Rostov,2674,9,4,6,10,11,19,-8,18
Amkar,2674,10,4,5,11,11,26,-15,17
Anzhi,2674,11,3,6,11,16,37,-21,15
Loko Moscow,2675,1,12,6,2,30,11,19,42
CSKA Moscow,2675,2,11,4,5,27,18,9,37
Spart Moscow,2675,3,10,5,5,36,27,9,35
Zenit,2675,4,7,9,4,22,15,7,30
Terek Grozny,2675,5,8,6,6,24,23,1,30
Krasnodar,2675,6,8,5,7,27,26,1,29
FK Rubin,2675,7,7,5,8,25,18,7,26
Din Moscow,2675,8,5,6,9,18,24,-6,21
Amkar,2675,9,5,5,10,11,23,-12,20
Rostov,2675,10,4,6,10,11,19,-8,18
Anzhi,2675,11,2,5,13,14,41,-27,11
Loko Moscow,2676,1,12,5,3,32,13,19,41
CSKA Moscow,2676,2,11,3,6,28,19,9,36
Spart Moscow,2676,3,9,7,4,41,30,11,34
Krasnodar,2676,4,10,4,6,31,24,7,34
Zenit,2676,5,8,8,4,23,16,7,32
Terek Grozny,2676,6,7,5,8,21,27,-6,26
Din Moscow,2676,7,5,7,8,18,25,-7,22
FK Rubin,2676,8,5,6,9,21,19,2,21
Amkar,2676,9,5,5,10,11,23,-12,20
Rostov,2676,10,4,7,9,13,20,-7,19
Anzhi,2676,11,3,5,12,18,41,-23,14
Loko Moscow,2677,1,11,5,4,32,16,16,38
CSKA Moscow,2677,2,10,5,5,27,19,8,35
Krasnodar,2677,3,10,4,6,32,26,6,34
Zenit,2677,4,8,9,3,23,14,9,33
Spart Moscow,2677,5,9,6,5,36,31,5,33
Terek Grozny,2677,6,8,6,6,22,23,-1,30
Din Moscow,2677,7,6,7,7,19,22,-3,25
FK Rubin,2677,8,5,5,10,21,20,1,20
Amkar,2677,9,5,5,10,14,23,-9,20
Rostov,2677,10,4,6,10,10,18,-8,18
Anzhi,2677,11,2,6,12,17,41,-24,12
Loko Moscow,2678,1,12,5,3,33,14,19,41
CSKA Moscow,2678,2,11,4,5,27,18,9,37
Zenit,2678,3,8,9,3,23,14,9,33
Spart Moscow,2678,4,8,8,4,34,26,8,32
Krasnodar,2678,5,8,4,8,29,31,-2,28
FK Rubin,2678,6,7,5,8,26,18,8,26
Terek Grozny,2678,7,7,5,8,20,25,-5,26
Din Moscow,2678,8,5,7,8,18,23,-5,22
Amkar,2678,9,5,5,10,11,22,-11,20
Rostov,2678,10,4,7,9,10,17,-7,19
Anzhi,2678,11,3,5,12,16,39,-23,14
Loko Moscow,2679,1,12,5,3,30,15,15,41
Spart Moscow,2679,2,10,5,5,41,30,11,35
CSKA Moscow,2679,3,10,3,7,25,19,6,33
Zenit,2679,4,8,8,4,22,14,8,32
Krasnodar,2679,5,9,4,7,31,26,5,31
Terek Grozny,2679,6,7,6,7,23,26,-3,27
Din Moscow,2679,7,6,6,8,21,26,-5,24
FK Rubin,2679,8,6,5,9,23,18,5,23
Amkar,2679,9,5,5,10,13,25,-12,20
Rostov,2679,10,4,6,10,10,19,-9,18
Anzhi,2679,11,4,5,11,17,38,-21,17
Loko Moscow,2680,1,12,6,2,33,14,19,42
CSKA Moscow,2680,2,12,3,5,28,18,10,39
Spart Moscow,2680,3,10,5,5,37,28,9,35
Krasnodar,2680,4,9,4,7,31,28,3,31
Zenit,2680,5,7,9,4,23,16,7,30
Terek Grozny,2680,6,8,5,7,24,26,-2,29
Din Moscow,2680,7,6,6,8,19,23,-4,24
FK Rubin,2680,8,6,5,9,25,20,5,23
Rostov,2680,9,4,6,10,11,20,-9,18
Amkar,2680,10,4,4,12,11,27,-16,16
Anzhi,2680,11,3,5,12,17,39,-22,14
Loko Moscow,2681,1,12,6,2,30,11,19,42
CSKA Moscow,2681,2,11,3,6,27,20,7,36
Zenit,2681,3,8,9,3,23,13,10,33
Spart Moscow,2681,4,9,6,5,38,31,7,33
Krasnodar,2681,5,9,4,7,28,25,3,31
Terek Grozny,2681,6,8,5,7,21,26,-5,29
Din Moscow,2681,7,5,8,7,19,23,-4,23
Amkar,2681,8,6,4,10,16,22,-6,22
FK Rubin,2681,9,5,6,9,21,18,3,21
Rostov,2681,10,4,6,10,11,20,-9,18
Anzhi,2681,11,2,5,13,15,40,-25,11
Loko Moscow,2682,1,12,6,2,33,13,20,42
Spart Moscow,2682,2,10,5,5,39,29,10,35
CSKA Moscow,2682,3,10,4,6,26,19,7,34
Zenit,2682,4,8,8,4,23,16,7,32
Krasnodar,2682,5,9,5,6,31,26,5,32
Terek Grozny,2682,6,8,6,6,22,23,-1,30
Din Moscow,2682,7,5,7,8,22,28,-6,22
FK Rubin,2682,8,5,6,9,26,24,2,21
Rostov,2682,9,5,6,9,12,18,-6,21
Amkar,2682,10,4,5,11,11,25,-14,17
Anzhi,2682,11,2,6,12,15,39,-24,12
Loko Moscow,2683,1,12,5,3,30,12,18,41
CSKA Moscow,2683,2,11,4,5,29,20,9,37
Spart Moscow,2683,3,9,7,4,40,28,12,34
Krasnodar,2683,4,9,5,6,29,25,4,32
Zenit,2683,5,7,9,4,23,16,7,30
Terek Grozny,2683,6,8,5,7,23,25,-2,29
FK Rubin,2683,7,5,7,8,23,19,4,22
Din Moscow,2683,8,5,7,8,18,26,-8,22
Rostov,2683,9,4,7,9,12,19,-7,19
Amkar,2683,10,4,5,11,10,26,-16,17
Anzhi,2683,11,3,5,12,18,39,-21,14
Loko Moscow,2684,1,12,5,3,32,12,20,41
CSKA Moscow,2684,2,12,3,5,32,18,14,39
Spart Moscow,2684,3,10,6,4,36,26,10,36
Krasnodar,2684,4,9,4,7,30,27,3,31
Zenit,2684,5,7,8,5,22,19,3,29
Terek Grozny,2684,6,7,7,6,20,22,-2,28
Din Moscow,2684,7,6,6,8,19,23,-4,24
FK Rubin,2684,8,6,5,9,24,20,4,23
Rostov,2684,9,4,7,9,10,17,-7,19
Amkar,2684,10,4,5,11,9,23,-14,17
Anzhi,2684,11,2,6,12,14,41,-27,12
Loko Moscow,2685,1,11,5,4,30,15,15,38
Zenit,2685,2,9,8,3,25,14,11,35
CSKA Moscow,2685,3,10,3,7,26,21,5,33
Spart Moscow,2685,4,9,5,6,35,30,5,32
Krasnodar,2685,5,9,5,6,29,25,4,32
Terek Grozny,2685,6,8,5,7,23,27,-4,29
Din Moscow,2685,7,6,6,8,22,25,-3,24
FK Rubin,2685,8,5,6,9,23,21,2,21
Rostov,2685,9,5,6,9,12,17,-5,21
Amkar,2685,10,5,4,11,12,24,-12,19
Anzhi,2685,11,4,5,11,20,38,-18,17
Loko Moscow,2686,1,11,6,3,31,14,17,39
CSKA Moscow,2686,2,11,4,5,27,18,9,37
Spart Moscow,2686,3,9,6,5,36,29,7,33
Krasnodar,2686,4,9,5,6,31,27,4,32
Zenit,2686,5,7,10,3,23,15,8,31
Terek Grozny,2686,6,8,5,7,23,24,-1,29
FK Rubin,2686,7,6,6,8,27,20,7,24
Amkar,2686,8,6,4,10,13,23,-10,22
Din Moscow,2686,9,5,6,9,19,27,-8,21
Rostov,2686,10,4,7,9,10,17,-7,19
Anzhi,2686,11,2,5,13,15,41,-26,11
Loko Moscow,2687,1,11,6,3,31,14,17,39
CSKA Moscow,2687,2,11,4,5,30,21,9,37
Spart Moscow,2687,3,9,6,5,36,26,10,33
Krasnodar,2687,4,9,4,7,29,26,3,31
Zenit,2687,5,7,9,4,23,16,7,30
Terek Grozny,2687,6,7,6,7,20,23,-3,27
FK Rubin,2687,7,7,5,8,24,18,6,26
Din Moscow,2687,8,5,6,9,18,26,-8,21
Amkar,2687,9,5,5,10,10,22,-12,20
Rostov,2687,10,4,7,9,10,17,-7,19
Anzhi,2687,11,3,6,11,18,40,-22,15
Loko Moscow,2688,1,11,6,3,30,14,16,39
CSKA Moscow,2688,2,11,3,6,31,20,11,36
Spart Moscow,2688,3,9,7,4,38,29,9,34
Krasnodar,2688,4,10,4,6,33,26,7,34
Zenit,2688,5,8,9,3,24,14,10,33
Terek Grozny,2688,6,8,6,6,22,23,-1,30
FK Rubin,2688,7,6,5,9,23,20,3,23
Din Moscow,2688,8,5,7,8,18,23,-5,22
Rostov,2688,9,4,6,10,10,18,-8,18
Amkar,2688,10,4,6,10,13,26,-13,18
Anzhi,2688,11,2,5,13,14,43,-29,11
Loko Moscow,2689,1,12,5,3,36,14,22,41
Spart Moscow,2689,2,10,6,4,36,26,10,36
CSKA Moscow,2689,3,10,4,6,29,22,7,34
Krasnodar,2689,4,9,5,6,29,25,4,32
Zenit,2689,5,8,8,4,24,20,4,32
Terek Grozny,2689,6,7,6,7,23,26,-3,27
FK Rubin,2689,7,6,6,8,22,17,5,24
Din Moscow,2689,8,5,6,9,18,24,-6,21
Rostov,2689,9,4,6,10,10,18,-8,18
Amkar,2689,10,4,6,10,11,24,-13,18
Anzhi,2689,11,3,6,11,19,41,-22,15
Loko Moscow,2690,1,12,6,2,33,14,19,42
CSKA Moscow,2690,2,12,3,5,29,17,12,39
Spart Moscow,2690,3,9,6,5,37,28,9,33
Krasnodar,2690,4,9,4,7,29,26,3,31
Zenit,2690,5,7,9,4,23,16,7,30
Terek Grozny,2690,6,7,6,7,21,24,-3,27
Din Moscow,2690,7,6,6,8,18,23,-5,24
Rostov,2690,8,5,6,9,13,19,-6,21
FK Rubin,2690,9,5,5,10,21,19,2,20
Amkar,2690,10,4,6,10,10,23,-13,18
Anzhi,2690,11,3,5,12,15,40,-25,14
Loko Moscow,2691,1,12,5,3,31,14,17,41
CSKA Moscow,2691,2,11,3,6,26,19,7,36
Spart Moscow,2691,3,10,5,5,38,26,12,35
Zenit,2691,4,8,8,4,24,15,9,32
Krasnodar,2691,5,9,4,7,30,27,3,31
Terek Grozny,2691,6,8,6,6,22,23,-1,30
Din Moscow,2691,7,7,6,7,21,22,-1,27
FK Rubin,2691,8,6,5,9,25,21,4,23
Rostov,2691,9,4,6,10,10,20,-10,18
Amkar,2691,10,4,4,12,10,26,-16,16
Anzhi,2691,11,2,6,12,14,38,-24,12
Loko Moscow,2692,1,12,5,3,32,13,19,41
Spart Moscow,2692,2,10,6,4,40,25,15,36
CSKA Moscow,2692,3,11,3,6,27,20,7,36
Krasnodar,2692,4,10,4,6,31,25,6,34
Zenit,2692,5,8,8,4,23,16,7,32
Terek Grozny,2692,6,8,6,6,24,24,0,30
FK Rubin,2692,7,6,5,9,23,19,4,23
Din Moscow,2692,8,5,6,9,17,24,-7,21
Rostov,2692,9,4,6,10,10,22,-12,18
Amkar,2692,10,4,6,10,11,24,-13,18
Anzhi,2692,11,2,5,13,15,41,-26,11
Loko Moscow,2693,1,12,6,2,32,12,20,42
CSKA Moscow,2693,2,11,3,6,30,23,7,36
Zenit,2693,3,8,8,4,26,15,11,32
Spart Moscow,2693,4,9,5,6,35,27,8,32
Krasnodar,2693,5,9,5,6,31,25,6,32
Terek Grozny,2693,6,7,7,6,22,24,-2,28
FK Rubin,2693,7,6,5,9,22,20,2,23
Rostov,2693,8,5,6,9,11,17,-6,21
Din Moscow,2693,9,5,6,9,17,24,-7,21
Amkar,2693,10,5,5,10,10,22,-12,20
Anzhi,2693,11,2,6,12,17,44,-27,12
Loko Moscow,2694,1,13,5,2,31,11,20,44
CSKA Moscow,2694,2,12,3,5,28,17,11,39
Spart Moscow,2694,3,9,6,5,37,30,7,33
Zenit,2694,4,7,8,5,21,15,6,29
Krasnodar,2694,5,8,5,7,29,27,2,29
Terek Grozny,2694,6,7,6,7,21,24,-3,27
Din Moscow,2694,7,6,7,7,22,23,-1,25
FK Rubin,2694,8,5,7,8,25,21,4,22
Amkar,2694,9,5,5,10,11,23,-12,20
Rostov,2694,10,4,6,10,11,20,-9,18
Anzhi,2694,11,2,6,12,15,40,-25,12
Loko Moscow,2695,1,12,6,2,34,14,20,42
CSKA Moscow,2695,2,11,3,6,28,19,9,36
Spart Moscow,2695,3,9,6,5,36,28,8,33
Zenit,2695,4,8,8,4,23,16,7,32
Krasnodar,2695,5,8,6,6,31,28,3,30
Terek Grozny,2695,6,8,5,7,22,23,-1,29
Din Moscow,2695,7,7,6,7,20,22,-2,27
FK Rubin,2695,8,5,6,9,22,19,3,21
Rostov,2695,9,4,7,9,11,18,-7,19
Amkar,2695,10,5,4,11,10,23,-13,19
Anzhi,2695,11,2,5,13,14,41,-27,11
Loko Moscow,2696,1,11,6,3,30,13,17,39
CSKA Moscow,2696,2,12,3,5,34,18,16,39
Spart Moscow,2696,3,9,6,5,35,27,8,33
Zenit,2696,4,8,8,4,22,16,6,32
Krasnodar,2696,5,8,5,7,28,28,0,29
Terek Grozny,2696,6,8,5,7,23,25,-2,29
Din Moscow,2696,7,7,6,7,21,21,0,27
FK Rubin,2696,8,6,5,9,24,20,4,23
Rostov,2696,9,4,6,10,11,19,-8,18
Amkar,2696,10,4,5,11,9,23,-14,17
Anzhi,2696,11,3,5,12,18,45,-27,14
Loko Moscow,2697,1,13,5,2,33,12,21,44
CSKA Moscow,2697,2,11,3,6,29,19,10,36
Spart Moscow,2697,3,10,5,5,39,29,10,35
Zenit,2697,4,8,8,4,23,15,8,32
Krasnodar,2697,5,9,4,7,32,27,5,31
Terek Grozny,2697,6,8,6,6,23,24,-1,30
Din Moscow,2697,7,6,7,7,21,23,-2,25
FK Rubin,2697,8,5,6,9,23,22,1,21
Rostov,2697,9,4,6,10,11,20,-9,18
Amkar,2697,10,4,4,12,10,26,-16,16
Anzhi,2697,11,2,6,12,15,42,-27,12
Loko Moscow,2698,1,12,5,3,32,14,18,41
Spart Moscow,2698,2,10,6,4,43,30,13,36
Krasnodar,2698,3,10,4,6,32,25,7,34
CSKA Moscow,2698,4,10,4,6,25,18,7,34
Zenit,2698,5,7,9,4,21,15,6,30
Terek Grozny,2698,6,7,6,7,21,24,-3,27
Din Moscow,2698,7,6,6,8,20,25,-5,24
FK Rubin,2698,8,5,5,10,21,20,1,20
Rostov,2698,9,4,6,10,12,22,-10,18
Amkar,2698,10,4,6,10,11,24,-13,18
Anzhi,2698,11,4,5,11,16,37,-21,17
Loko Moscow,2699,1,13,5,2,32,12,20,44
CSKA Moscow,2699,2,11,3,6,28,19,9,36
Spart Moscow,2699,3,10,5,5,37,30,7,35
Zenit,2699,4,8,8,4,24,15,9,32
Krasnodar,2699,5,9,4,7,29,25,4,31
Terek Grozny,2699,6,7,6,7,21,25,-4,27
FK Rubin,2699,7,6,5,9,23,19,4,23
Amkar,2699,8,6,4,10,16,23,-7,22
Din Moscow,2699,9,5,6,9,17,24,-7,21
Rostov,2699,10,4,6,10,10,19,-9,18
Anzhi,2699,11,2,6,12,15,41,-26,12
Loko Moscow,2700,1,13,5,2,33,13,20,44
CSKA Moscow,2700,2,11,3,6,27,20,7,36
Zenit,2700,3,8,8,4,25,15,10,32
Spart Moscow,2700,4,9,5,6,36,29,7,32
Krasnodar,2700,5,9,4,7,30,27,3,31
Din Moscow,2700,6,7,6,7,22,23,-1,27
Terek Grozny,2700,7,7,5,8,20,26,-6,26
Amkar,2700,8,6,4,10,12,23,-11,22
FK Rubin,2700,9,5,5,10,24,22,2,20
Rostov,2700,10,4,6,10,10,19,-9,18
Anzhi,2700,11,3,5,12,17,39,-22,14
Loko Moscow,2701,1,12,5,3,33,15,18,41
Spart Moscow,2701,2,11,5,4,41,29,12,38
CSKA Moscow,2701,3,10,5,5,27,19,8,35
Krasnodar,2701,4,9,5,6,31,27,4,32
Zenit,2701,5,7,9,4,22,15,7,30
Terek Grozny,2701,6,7,5,8,20,26,-6,26
Din Moscow,2701,7,6,6,8,20,24,-4,24
FK Rubin,2701,8,5,6,9,22,19,3,21
Amkar,2701,9,5,4,11,14,25,-11,19
Rostov,2701,10,4,6,10,10,19,-9,18
Anzhi,2701,11,3,6,11,17,39,-22,15
Loko Moscow,2702,1,12,5,3,31,14,17,41
CSKA Moscow,2702,2,12,3,5,28,17,11,39
Spart Moscow,2702,3,10,6,4,35,25,10,36
Krasnodar,2702,4,9,5,6,29,24,5,32
Terek Grozny,2702,5,8,6,6,22,23,-1,30
Zenit,2702,6,7,8,5,22,16,6,29
FK Rubin,2702,7,6,6,8,22,17,5,24
Din Moscow,2702,8,5,6,9,17,23,-6,21
Rostov,2702,9,4,6,10,10,18,-8,18
Amkar,2702,10,4,6,10,10,23,-13,18
Anzhi,2702,11,2,5,13,14,40,-26,11
Loko Moscow,2703,1,13,5,2,35,13,22,44
CSKA Moscow,2703,2,10,5,5,28,20,8,35
Spart Moscow,2703,3,9,5,6,37,30,7,32
Terek Grozny,2703,4,9,5,6,24,23,1,32
Zenit,2703,5,7,9,4,23,18,5,30
Krasnodar,2703,6,8,4,8,29,28,1,28
FK Rubin,2703,7,7,5,8,26,19,7,26
Din Moscow,2703,8,6,6,8,22,26,-4,24
Rostov,2703,9,5,6,9,11,17,-6,21
Amkar,2703,10,4,4,12,10,26,-16,16
Anzhi,2703,11,2,6,12,16,41,-25,12
Loko Moscow,2704,1,12,6,2,34,14,20,42
Spart Moscow,2704,2,11,5,4,39,25,14,38
CSKA Moscow,2704,3,11,3,6,27,19,8,36
Zenit,2704,4,7,9,4,23,16,7,30
Terek Grozny,2704,5,8,6,6,22,23,-1,30
Krasnodar,2704,6,8,5,7,29,28,1,29
Din Moscow,2704,7,6,6,8,20,22,-2,24
FK Rubin,2704,8,5,6,9,22,21,1,21
Rostov,2704,9,4,6,10,10,21,-11,18
Amkar,2704,10,4,5,11,9,23,-14,17
Anzhi,2704,11,3,5,12,17,40,-23,14
Loko Moscow,2705,1,12,6,2,32,13,19,42
Spart Moscow,2705,2,11,5,4,42,29,13,38
CSKA Moscow,2705,3,11,4,5,30,18,12,37
Zenit,2705,4,7,10,3,23,15,8,31
Krasnodar,2705,5,9,4,7,33,27,6,31
Terek Grozny,2705,6,7,5,8,20,25,-5,26
Din Moscow,2705,7,6,6,8,18,23,-5,24
FK Rubin,2705,8,5,5,10,22,23,-1,20
Amkar,2705,9,5,4,11,14,28,-14,19
Rostov,2705,10,4,6,10,10,18,-8,18
Anzhi,2705,11,3,5,12,16,41,-25,14
Loko Moscow,2706,1,12,6,2,30,11,19,42
CSKA Moscow,2706,2,11,3,6,28,20,8,36
Spart Moscow,2706,3,10,5,5,40,28,12,35
Zenit,2706,4,8,8,4,24,15,9,32
Krasnodar,2706,5,9,5,6,28,24,4,32
Terek Grozny,2706,6,7,6,7,20,24,-4,27
Din Moscow,2706,7,5,7,8,18,23,-5,22
FK Rubin,2706,8,5,6,9,21,18,3,21
Amkar,2706,9,5,5,10,10,22,-12,20
Rostov,2706,10,4,6,10,11,22,-11,18
Anzhi,2706,11,3,5,12,16,39,-23,14
Loko Moscow,2707,1,12,5,3,31,13,18,41
Spart Moscow,2707,2,11,5,4,38,26,12,38
CSKA Moscow,2707,3,11,4,5,28,18,10,37
Zenit,2707,4,8,9,3,23,14,9,33
Krasnodar,2707,5,8,4,8,27,26,1,28
Terek Grozny,2707,6,7,5,8,21,27,-6,26
FK Rubin,2707,7,6,6,8,24,19,5,24
Din Moscow,2707,8,5,7,8,19,25,-6,22
Amkar,2707,9,5,4,11,13,24,-11,19
Rostov,2707,10,4,6,10,10,18,-8,18
Anzhi,2707,11,3,5,12,17,41,-24,14
Loko Moscow,2708,1,12,6,2,34,15,19,42
CSKA Moscow,2708,2,11,4,5,26,17,9,37
Zenit,2708,3,7,9,4,22,15,7,30
Spart Moscow,2708,4,8,6,6,34,30,4,30
Krasnodar,2708,5,8,6,6,33,30,3,30
Terek Grozny,2708,6,8,5,7,24,26,-2,29
Din Moscow,2708,7,7,6,7,21,21,0,27
FK Rubin,2708,8,5,6,9,24,22,2,21
Rostov,2708,9,4,7,9,11,18,-7,19
Amkar,2708,10,5,4,11,11,25,-14,19
Anzhi,2708,11,3,5,12,18,39,-21,14
Loko Moscow,2709,1,11,5,4,29,16,13,38
Spart Moscow,2709,2,10,6,4,36,26,10,36
CSKA Moscow,2709,3,11,3,6,27,22,5,36
Zenit,2709,4,9,8,3,28,14,14,35
Krasnodar,2709,5,10,4,6,31,24,7,34
Terek Grozny,2709,6,7,6,7,20,24,-4,27
Din Moscow,2709,7,6,6,8,19,22,-3,24
FK Rubin,2709,8,5,5,10,21,20,1,20
Rostov,2709,9,4,7,9,11,18,-7,19
Amkar,2709,10,4,5,11,9,23,-14,17
Anzhi,2709,11,3,5,12,16,38,-22,14
Loko Moscow,2710,1,13,5,2,32,11,21,44
CSKA Moscow,2710,2,11,4,5,27,18,9,37
Spart Moscow,2710,3,9,5,6,37,31,6,32
Terek Grozny,2710,4,9,5,6,26,24,2,32
Krasnodar,2710,5,9,4,7,28,26,2,31
Zenit,2710,6,7,9,4,21,14,7,30
Din Moscow,2710,7,6,6,8,19,24,-5,24
Rostov,2710,8,5,6,9,13,18,-5,21
FK Rubin,2710,9,5,5,10,21,19,2,20
Amkar,2710,10,5,4,11,12,25,-13,19
Anzhi,2710,11,2,5,13,16,42,-26,11
Loko Moscow,2711,1,13,5,2,33,11,22,44
Spart Moscow,2711,2,10,6,4,36,25,11,36
CSKA Moscow,2711,3,11,3,6,31,21,10,36
Zenit,2711,4,8,8,4,24,17,7,32
Krasnodar,2711,5,8,5,7,30,28,2,29
Terek Grozny,2711,6,7,6,7,20,24,-4,27
FK Rubin,2711,7,6,6,8,27,21,6,24
Din Moscow,2711,8,5,6,9,18,26,-8,21
Rostov,2711,9,4,6,10,10,18,-8,18
Amkar,2711,10,4,6,10,9,22,-13,18
Anzhi,2711,11,3,5,12,17,42,-25,14
Loko Moscow,2712,1,11,6,3,31,14,17,39
CSKA Moscow,2712,2,12,3,5,33,17,16,39
Spart Moscow,2712,3,10,6,4,38,26,12,36
Krasnodar,2712,4,9,5,6,30,26,4,32
Zenit,2712,5,7,9,4,22,17,5,30
Terek Grozny,2712,6,7,5,8,21,27,-6,26
FK Rubin,2712,7,5,7,8,22,18,4,22
Din Moscow,2712,8,5,7,8,17,24,-7,22
Amkar,2712,9,5,5,10,12,23,-11,20
Rostov,2712,10,4,6,10,10,18,-8,18
Anzhi,2712,11,3,5,12,17,43,-26,14
Loko Moscow,2713,1,11,7,2,31,13,18,40
CSKA Moscow,2713,2,12,3,5,29,18,11,39
Spart Moscow,2713,3,9,5,6,35,28,7,32
Krasnodar,2713,4,9,5,6,28,24,4,32
Zenit,2713,5,7,9,4,23,16,7,30
Terek Grozny,2713,6,7,6,7,23,26,-3,27
Din Moscow,2713,7,6,6,8,19,23,-4,24
Amkar,2713,8,6,4,10,13,23,-10,22
Rostov,2713,9,5,6,9,11,17,-6,21
FK Rubin,2713,10,5,5,10,21,20,1,20
Anzhi,2713,11,2,6,12,17,42,-25,12
Loko Moscow,2714,1,12,5,3,32,13,19,41
CSKA Moscow,2714,2,11,4,5,29,20,9,37
Spart Moscow,2714,3,9,6,5,37,28,9,33
Zenit,2714,4,8,9,3,23,14,9,33
Krasnodar,2714,5,8,5,7,28,27,1,29
Din Moscow,2714,6,7,6,7,21,21,0,27
Terek Grozny,2714,7,7,6,7,20,23,-3,27
FK Rubin,2714,8,5,6,9,21,19,2,21
Rostov,2714,9,4,6,10,10,20,-10,18
Amkar,2714,10,4,6,10,10,23,-13,18
Anzhi,2714,11,3,5,12,17,40,-23,14
Loko Moscow,2715,1,11,6,3,30,14,16,39
CSKA Moscow,2715,2,11,3,6,28,18,10,36
Krasnodar,2715,3,10,4,6,30,24,6,34
Zenit,2715,4,8,9,3,23,14,9,33
Spart Moscow,2715,5,9,6,5,36,28,8,33
Terek Grozny,2715,6,7,5,8,23,28,-5,26
Din Moscow,2715,7,6,6,8,19,23,-4,24
FK Rubin,2715,8,6,5,9,23,19,4,23
Rostov,2715,9,4,7,9,12,19,-7,19
Amkar,2715,10,5,4,11,12,25,-13,19
Anzhi,2715,11,3,5,12,17,41,-24,14
Loko Moscow,2716,1,11,6,3,30,13,17,39
CSKA Moscow,2716,2,11,4,5,28,19,9,37
Spart Moscow,2716,3,9,6,5,39,29,10,33
Krasnodar,2716,4,9,5,6,29,25,4,32
Zenit,2716,5,7,9,4,23,16,7,30
Terek Grozny,2716,6,7,5,8,20,26,-6,26
FK Rubin,2716,7,6,6,8,24,19,5,24
Rostov,2716,8,5,6,9,13,19,-6,21
Din Moscow,2716,9,5,6,9,19,27,-8,21
Amkar,2716,10,5,5,10,12,22,-10,20
Anzhi,2716,11,3,6,11,16,38,-22,15
Loko Moscow,2717,1,12,6,2,31,12,19,42
CSKA Moscow,2717,2,12,3,5,29,17,12,39
Spart Moscow,2717,3,10,6,4,40,27,13,36
Zenit,2717,4,7,8,5,21,15,6,29
Krasnodar,2717,5,8,5,7,30,29,1,29
Terek Grozny,2717,6,7,5,8,21,27,-6,26
FK Rubin,2717,7,6,6,8,27,21,6,24
Din Moscow,2717,8,5,8,7,20,24,-4,23
Amkar,2717,9,5,4,11,13,24,-11,19
Rostov,2717,10,4,6,10,10,21,-11,18
Anzhi,2717,11,3,5,12,16,41,-25,14
Loko Moscow,2718,1,11,5,4,29,14,15,38
Zenit,2718,2,9,8,3,24,13,11,35
Krasnodar,2718,3,10,4,6,30,24,6,34
CSKA Moscow,2718,4,10,4,6,27,21,6,34
Spart Moscow,2718,5,9,6,5,37,29,8,33
Terek Grozny,2718,6,8,5,7,22,23,-1,29
FK Rubin,2718,7,6,5,9,23,19,4,23
Din Moscow,2718,8,5,6,9,18,24,-6,21
Rostov,2718,9,4,7,9,12,19,-7,19
Amkar,2718,10,5,4,11,11,25,-14,19
Anzhi,2718,11,3,6,11,17,39,-22,15
Loko Moscow,2719,1,12,5,3,32,14,18,41
Spart Moscow,2719,2,10,5,5,36,29,7,35
CSKA Moscow,2719,3,10,3,7,26,21,5,33
Zenit,2719,4,8,8,4,24,16,8,32
Krasnodar,2719,5,9,4,7,29,27,2,31
Terek Grozny,2719,6,7,7,6,21,23,-2,28
FK Rubin,2719,7,7,5,8,24,17,7,26
Din Moscow,2719,8,6,6,8,21,23,-2,24
Rostov,2719,9,4,6,10,10,18,-8,18
Amkar,2719,10,4,5,11,9,23,-14,17
Anzhi,2719,11,3,6,11,17,38,-21,15
Loko Moscow,2720,1,11,6,3,30,13,17,39
Spart Moscow,2720,2,10,6,4,41,26,15,36
CSKA Moscow,2720,3,11,3,6,27,21,6,36
Zenit,2720,4,8,9,3,26,15,11,33
Krasnodar,2720,5,9,4,7,28,25,3,31
Terek Grozny,2720,6,7,6,7,20,24,-4,27
FK Rubin,2720,7,7,5,8,24,17,7,26
Din Moscow,2720,8,5,7,8,18,24,-6,22
Rostov,2720,9,4,6,10,10,21,-11,18
Amkar,2720,10,4,5,11,9,25,-16,17
Anzhi,2720,11,3,5,12,16,38,-22,14
Loko Moscow,2721,1,12,5,3,33,13,20,41
CSKA Moscow,2721,2,11,3,6,28,21,7,36
Zenit,2721,3,9,8,3,25,14,11,35
Spart Moscow,2721,4,9,5,6,38,34,4,32
Krasnodar,2721,5,9,4,7,30,28,2,31
Terek Grozny,2721,6,7,6,7,22,25,-3,27
Din Moscow,2721,7,6,6,8,24,25,-1,24
FK Rubin,2721,8,6,5,9,24,21,3,23
Rostov,2721,9,5,6,9,13,19,-6,21
Amkar,2721,10,5,4,11,12,25,-13,19
Anzhi,2721,11,2,6,12,16,40,-24,12
Loko Moscow,2722,1,12,5,3,31,13,18,41
CSKA Moscow,2722,2,11,4,5,26,17,9,37
Spart Moscow,2722,3,10,5,5,37,28,9,35
Krasnodar,2722,4,9,5,6,30,25,5,32
Zenit,2722,5,7,8,5,21,16,5,29
Terek Grozny,2722,6,7,7,6,21,23,-2,28
FK Rubin,2722,7,6,6,8,26,18,8,24
Din Moscow,2722,8,5,6,9,18,27,-9,21
Amkar,2722,9,5,5,10,10,22,-12,20
Rostov,2722,10,4,6,10,11,19,-8,18
Anzhi,2722,11,2,7,11,15,38,-23,13
Loko Moscow,2723,1,11,7,2,32,14,18,40
Spart Moscow,2723,2,11,5,4,42,26,16,38
CSKA Moscow,2723,3,11,4,5,26,17,9,37
Zenit,2723,4,7,10,3,22,14,8,31
Krasnodar,2723,5,8,6,6,31,28,3,30
Terek Grozny,2723,6,7,7,6,21,23,-2,28
FK Rubin,2723,7,5,7,8,23,19,4,22
Din Moscow,2723,8,5,7,8,17,23,-6,22
Rostov,2723,9,4,6,10,10,21,-11,18
Amkar,2723,10,4,5,11,11,26,-15,17
Anzhi,2723,11,2,6,12,14,38,-24,12
Loko Moscow,2724,1,12,5,3,30,12,18,41
Spart Moscow,2724,2,11,5,4,40,27,13,38
CSKA Moscow,2724,3,10,4,6,26,19,7,34
Krasnodar,2724,4,10,4,6,29,24,5,34
Zenit,2724,5,8,8,4,23,15,8,32
Terek Grozny,2724,6,8,6,6,24,25,-1,30
Din Moscow,2724,7,5,7,8,18,24,-6,22
FK Rubin,2724,8,5,6,9,22,19,3,21
Rostov,2724,9,4,6,10,11,20,-9,18
Amkar,2724,10,4,5,11,11,25,-14,17
Anzhi,2724,11,2,6,12,16,40,-24,12
Loko Moscow,2725,1,12,6,2,31,12,19,42
CSKA Moscow,2725,2,10,4,6,25,19,6,34
Spart Moscow,2725,3,9,5,6,37,29,8,32
Zenit,2725,4,7,9,4,22,15,7,30
Krasnodar,2725,5,8,6,6,28,25,3,30
Terek Grozny,2725,6,8,6,6,24,24,0,30
Din Moscow,2725,7,6,6,8,20,27,-7,24
FK Rubin,2725,8,5,6,9,24,21,3,21
Rostov,2725,9,5,6,9,12,17,-5,21
Amkar,2725,10,5,5,10,12,23,-11,20
Anzhi,2725,11,3,5,12,17,40,-23,14
Loko Moscow,2726,1,12,6,2,34,15,19,42
CSKA Moscow,2726,2,11,3,6,29,20,9,36
Zenit,2726,3,8,9,3,25,16,9,33
Spart Moscow,2726,4,9,6,5,36,28,8,33
Terek Grozny,2726,5,8,5,7,22,26,-4,29
Krasnodar,2726,6,8,4,8,31,31,0,28
FK Rubin,2726,7,6,6,8,26,20,6,24
Din Moscow,2726,8,5,7,8,18,24,-6,22
Rostov,2726,9,4,7,9,11,18,-7,19
Amkar,2726,10,5,4,11,11,23,-12,19
Anzhi,2726,11,3,5,12,19,41,-22,14
Loko Moscow,2727,1,13,5,2,33,12,21,44
CSKA Moscow,2727,2,11,3,6,30,20,10,36
Spart Moscow,2727,3,9,5,6,38,33,5,32
Zenit,2727,4,7,8,5,21,17,4,29
Krasnodar,2727,5,8,4,8,28,29,-1,28
Terek Grozny,2727,6,7,7,6,21,23,-2,28
FK Rubin,2727,7,7,5,8,24,17,7,26
Din Moscow,2727,8,6,6,8,20,22,-2,24
Rostov,2727,9,5,6,9,13,19,-6,21
Amkar,2727,10,4,5,11,12,26,-14,17
Anzhi,2727,11,3,6,11,17,39,-22,15
Loko Moscow,2728,1,11,6,3,30,13,17,39
CSKA Moscow,2728,2,11,4,5,29,19,10,37
Spart Moscow,2728,3,10,5,5,36,27,9,35
Krasnodar,2728,4,10,4,6,30,24,6,34
Zenit,2728,5,7,10,3,24,16,8,31
Terek Grozny,2728,6,7,5,8,21,26,-5,26
Din Moscow,2728,7,6,6,8,20,23,-3,24
Amkar,2728,8,6,4,10,12,22,-10,22
FK Rubin,2728,9,5,5,10,21,21,0,20
Rostov,2728,10,4,6,10,10,18,-8,18
Anzhi,2728,11,3,5,12,16,40,-24,14
Loko Moscow,2729,1,11,6,3,30,13,17,39
CSKA Moscow,2729,2,12,3,5,29,18,11,39
Spart Moscow,2729,3,11,5,4,40,26,14,38
Zenit,2729,4,8,8,4,22,14,8,32
Krasnodar,2729,5,9,5,6,30,25,5,32
Terek Grozny,2729,6,8,5,7,23,24,-1,29
Din Moscow,2729,7,6,6,8,19,25,-6,24
FK Rubin,2729,8,5,5,10,21,20,1,20
Rostov,2729,9,4,6,10,10,19,-9,18
Amkar,2729,10,4,4,12,9,25,-16,16
Anzhi,2729,11,3,5,12,17,41,-24,14
Loko Moscow,2730,1,12,6,2,38,13,25,42
CSKA Moscow,2730,2,12,3,5,28,17,11,39
Zenit,2730,3,7,9,4,23,16,7,30
Spart Moscow,2730,4,8,6,6,33,30,3,30
Terek Grozny,2730,5,8,6,6,24,25,-1,30
Krasnodar,2730,6,8,4,8,27,32,-5,28
Din Moscow,2730,7,7,6,7,21,21,0,27
FK Rubin,2730,8,6,5,9,22,19,3,23
Rostov,2730,9,5,6,9,13,17,-4,21
Amkar,2730,10,4,5,11,9,23,-14,17
Anzhi,2730,11,2,6,12,17,42,-25,12
Loko Moscow,2731,1,13,5,2,35,13,22,44
Spart Moscow,2731,2,11,5,4,42,27,15,38
CSKA Moscow,2731,3,11,4,5,28,19,9,37
Zenit,2731,4,7,9,4,23,16,7,30
Krasnodar,2731,5,8,4,8,28,29,-1,28
Terek Grozny,2731,6,7,7,6,24,26,-2,28
Din Moscow,2731,7,6,6,8,19,24,-5,24
FK Rubin,2731,8,6,5,9,22,18,4,23
Rostov,2731,9,4,6,10,10,19,-9,18
Amkar,2731,10,4,5,11,13,29,-16,17
Anzhi,2731,11,2,6,12,16,40,-24,12
Loko Moscow,2732,1,11,6,3,31,14,17,39
CSKA Moscow,2732,2,12,3,5,29,17,12,39
Spart Moscow,2732,3,11,5,4,42,29,13,38
Krasnodar,2732,4,10,4,6,33,26,7,34
Terek Grozny,2732,5,9,5,6,23,23,0,32
Zenit,2732,6,7,9,4,21,15,6,30
Din Moscow,2732,7,5,7,8,20,26,-6,22
FK Rubin,2732,8,5,6,9,22,21,1,21
Rostov,2732,9,4,6,10,11,20,-9,18
Amkar,2732,10,4,4,12,10,25,-15,16
Anzhi,2732,11,2,5,13,15,41,-26,11
Loko Moscow,2733,1,12,5,3,31,12,19,41
Spart Moscow,2733,2,11,5,4,36,25,11,38
CSKA Moscow,2733,3,11,3,6,29,20,9,36
Krasnodar,2733,4,10,4,6,30,24,6,34
Zenit,2733,5,8,8,4,23,16,7,32
Terek Grozny,2733,6,7,6,7,21,25,-4,27
Din Moscow,2733,7,6,6,8,18,22,-4,24
FK Rubin,2733,8,5,5,10,21,20,1,20
Amkar,2733,9,5,4,11,11,23,-12,19
Rostov,2733,10,4,6,10,10,18,-8,18
Anzhi,2733,11,2,6,12,16,41,-25,12
Loko Moscow,2734,1,13,5,2,37,11,26,44
CSKA Moscow,2734,2,11,3,6,28,19,9,36
Spart Moscow,2734,3,9,6,5,38,30,8,33
Zenit,2734,4,8,8,4,23,18,5,32
Terek Grozny,2734,5,9,5,6,24,23,1,32
Krasnodar,2734,6,8,4,8,28,30,-2,28
FK Rubin,2734,7,7,5,8,26,20,6,26
Din Moscow,2734,8,6,6,8,21,24,-3,24
Rostov,2734,9,4,7,9,12,19,-7,19
Amkar,2734,10,4,4,12,10,27,-17,16
Anzhi,2734,11,2,5,13,15,41,-26,11
Loko Moscow,2735,1,13,5,2,33,12,21,44
CSKA Moscow,2735,2,11,3,6,31,21,10,36
Spart Moscow,2735,3,9,5,6,38,29,9,32
Zenit,2735,4,8,8,4,24,15,9,32
Krasnodar,2735,5,9,4,7,30,27,3,31
Din Moscow,2735,6,7,6,7,20,22,-2,27
Terek Grozny,2735,7,7,5,8,20,28,-8,26
Amkar,2735,8,6,4,10,16,23,-7,22
FK Rubin,2735,9,5,5,10,21,20,1,20
Rostov,2735,10,4,6,10,10,20,-10,18
Anzhi,2735,11,3,5,12,16,42,-26,14
Loko Moscow,2736,1,13,5,2,34,13,21,44
CSKA Moscow,2736,2,11,4,5,29,18,11,37
Spart Moscow,2736,3,10,6,4,39,28,11,36
Zenit,2736,4,7,9,4,22,15,7,30
Krasnodar,2736,5,8,5,7,28,27,1,29
Terek Grozny,2736,6,8,5,7,25,27,-2,29
Din Moscow,2736,7,6,6,8,21,23,-2,24
FK Rubin,2736,8,5,6,9,21,20,1,21
Amkar,2736,9,5,5,10,13,24,-11,20
Rostov,2736,10,4,6,10,11,20,-9,18
Anzhi,2736,11,2,5,13,17,45,-28,11
Loko Moscow,2737,1,11,6,3,31,14,17,39
CSKA Moscow,2737,2,12,3,5,30,18,12,39
Krasnodar,2737,3,10,4,6,30,25,5,34
Zenit,2737,4,7,9,4,22,16,6,30
Terek Grozny,2737,5,8,6,6,21,22,-1,30
Spart Moscow,2737,6,8,5,7,35,32,3,29
Din Moscow,2737,7,7,6,7,22,23,-1,27
Rostov,2737,8,5,6,9,13,18,-5,21
FK Rubin,2737,9,5,5,10,22,20,2,20
Amkar,2737,10,5,5,10,10,22,-12,20
Anzhi,2737,11,2,5,13,15,41,-26,11
CSKA Moscow,2738,1,12,3,5,32,18,14,39
Loko Moscow,2738,2,11,5,4,30,15,15,38
Spart Moscow,2738,3,9,7,4,39,28,11,34
Zenit,2738,4,8,8,4,23,15,8,32
Krasnodar,2738,5,9,4,7,30,27,3,31
Terek Grozny,2738,6,8,6,6,21,22,-1,30
Din Moscow,2738,7,6,7,7,20,23,-3,25
FK Rubin,2738,8,6,5,9,23,19,4,23
Rostov,2738,9,4,6,10,10,20,-10,18
Amkar,2738,10,4,6,10,10,23,-13,18
Anzhi,2738,11,2,5,13,15,43,-28,11
Loko Moscow,2739,1,12,6,2,32,13,19,42
CSKA Moscow,2739,2,11,4,5,26,17,9,37
Spart Moscow,2739,3,9,5,6,37,30,7,32
Zenit,2739,4,7,10,3,22,14,8,31
Krasnodar,2739,5,9,4,7,30,26,4,31
Terek Grozny,2739,6,7,7,6,20,22,-2,28
Din Moscow,2739,7,7,6,7,19,21,-2,27
FK Rubin,2739,8,5,5,10,21,20,1,20
Amkar,2739,9,5,5,10,12,24,-12,20
Rostov,2739,10,4,6,10,11,19,-8,18
Anzhi,2739,11,2,6,12,14,38,-24,12
Loko Moscow,2740,1,11,5,4,30,17,13,38
Spart Moscow,2740,2,10,6,4,37,26,11,36
CSKA Moscow,2740,3,11,3,6,28,20,8,36
Zenit,2740,4,9,8,3,27,13,14,35
Terek Grozny,2740,5,9,5,6,25,23,2,32
Krasnodar,2740,6,9,4,7,30,27,3,31
FK Rubin,2740,7,6,6,8,25,19,6,24
Din Moscow,2740,8,5,7,8,20,26,-6,22
Rostov,2740,9,4,6,10,10,18,-8,18
Amkar,2740,10,4,5,11,10,26,-16,17
Anzhi,2740,11,2,5,13,14,41,-27,11
Loko Moscow,2741,1,12,5,3,32,13,19,41
CSKA Moscow,2741,2,11,4,5,27,17,10,37
Spart Moscow,2741,3,10,6,4,42,28,14,36
Krasnodar,2741,4,9,5,6,32,28,4,32
Zenit,2741,5,7,9,4,21,15,6,30
Terek Grozny,2741,6,7,6,7,21,24,-3,27
Din Moscow,2741,7,6,6,8,21,26,-5,24
FK Rubin,2741,8,5,6,9,25,22,3,21
Amkar,2741,9,5,5,10,11,23,-12,20
Rostov,2741,10,4,6,10,10,21,-11,18
Anzhi,2741,11,2,6,12,15,40,-25,12
Loko Moscow,2742,1,11,7,2,33,15,18,40
CSKA Moscow,2742,2,11,4,5,29,18,11,37
Spart Moscow,2742,3,10,5,5,38,29,9,35
Zenit,2742,4,7,10,3,23,15,8,31
Terek Grozny,2742,5,8,6,6,25,26,-1,30
Krasnodar,2742,6,8,5,7,30,28,2,29
FK Rubin,2742,7,6,6,8,23,18,5,24
Din Moscow,2742,8,5,7,8,19,24,-5,22
Amkar,2742,9,5,4,11,13,25,-12,19
Rostov,2742,10,4,6,10,11,20,-9,18
Anzhi,2742,11,2,6,12,16,42,-26,12
Loko Moscow,2743,1,11,6,3,30,13,17,39
Spart Moscow,2743,2,10,6,4,41,31,10,36
CSKA Moscow,2743,3,11,3,6,27,18,9,36
Zenit,2743,4,9,8,3,24,14,10,35
Krasnodar,2743,5,9,5,6,28,24,4,32
Terek Grozny,2743,6,7,6,7,20,24,-4,27
FK Rubin,2743,7,6,5,9,22,18,4,23
Din Moscow,2743,8,5,6,9,19,25,-6,21
Rostov,2743,9,4,6,10,12,20,-8,18
Amkar,2743,10,4,6,10,11,24,-13,18
Anzhi,2743,11,3,5,12,16,39,-23,14
Loko Moscow,2744,1,12,5,3,32,13,19,41
CSKA Moscow,2744,2,11,3,6,26,20,6,36
Spart Moscow,2744,3,9,7,4,35,26,9,34
Krasnodar,2744,4,10,4,6,30,25,5,34
Zenit,2744,5,8,8,4,24,15,9,32
Terek Grozny,2744,6,7,6,7,20,23,-3,27
Din Moscow,2744,7,5,8,7,18,22,-4,23
FK Rubin,2744,8,5,6,9,21,18,3,21
Rostov,2744,9,4,6,10,10,18,-8,18
Amkar,2744,10,4,6,10,9,22,-13,18
Anzhi,2744,11,3,5,12,15,38,-23,14
Loko Moscow,2745,1,11,5,4,31,15,16,38
CSKA Moscow,2745,2,11,3,6,27,19,8,36
Zenit,2745,3,9,8,3,23,13,10,35
Spart Moscow,2745,4,9,7,4,35,26,9,34
Krasnodar,2745,5,9,5,6,30,26,4,32
Terek Grozny,2745,6,9,5,6,24,22,2,32
Din Moscow,2745,7,5,8,7,17,21,-4,23
FK Rubin,2745,8,5,7,8,21,17,4,22
Rostov,2745,9,4,7,9,10,17,-7,19
Amkar,2745,10,4,4,12,10,26,-16,16
Anzhi,2745,11,2,5,13,15,41,-26,11
Loko Moscow,2746,1,11,5,4,31,15,16,38
Spart Moscow,2746,2,11,5,4,42,27,15,38
CSKA Moscow,2746,3,11,4,5,28,19,9,37
Zenit,2746,4,8,9,3,26,17,9,33
Terek Grozny,2746,5,9,5,6,23,23,0,32
Krasnodar,2746,6,9,4,7,30,27,3,31
FK Rubin,2746,7,7,5,8,27,19,8,26
Din Moscow,2746,8,5,6,9,19,28,-9,21
Rostov,2746,9,4,6,10,10,20,-10,18
Amkar,2746,10,4,4,12,9,25,-16,16
Anzhi,2746,11,2,5,13,15,40,-25,11
Loko Moscow,2747,1,11,7,2,31,13,18,40
CSKA Moscow,2747,2,10,4,6,27,20,7,34
Spart Moscow,2747,3,9,5,6,39,31,8,32
Zenit,2747,4,7,10,3,22,14,8,31
Krasnodar,2747,5,8,6,6,30,27,3,30
Terek Grozny,2747,6,7,6,7,23,26,-3,27
Din Moscow,2747,7,6,7,7,22,25,-3,25
FK Rubin,2747,8,5,7,8,24,20,4,22
Rostov,2747,9,5,6,9,12,17,-5,21
Amkar,2747,10,5,4,11,13,28,-15,19
Anzhi,2747,11,3,6,11,17,39,-22,15
Loko Moscow,2748,1,11,6,3,31,14,17,39
Spart Moscow,2748,2,10,5,5,35,26,9,35
Krasnodar,2748,3,10,4,6,31,25,6,34
CSKA Moscow,2748,4,10,4,6,27,21,6,34
Zenit,2748,5,8,9,3,24,14,10,33
Terek Grozny,2748,6,8,6,6,23,24,-1,30
Din Moscow,2748,7,5,7,8,18,23,-5,22
FK Rubin,2748,8,5,6,9,22,20,2,21
Rostov,2748,9,5,6,9,11,17,-6,21
Amkar,2748,10,4,5,11,10,24,-14,17
Anzhi,2748,11,2,6,12,17,41,-24,12
Loko Moscow,2749,1,11,6,3,30,13,17,39
Spart Moscow,2749,2,10,6,4,38,26,12,36
CSKA Moscow,2749,3,11,3,6,29,20,9,36
Zenit,2749,4,8,8,4,23,17,6,32
Krasnodar,2749,5,8,5,7,28,27,1,29
Terek Grozny,2749,6,8,5,7,24,27,-3,29
FK Rubin,2749,7,6,6,8,24,18,6,24
Din Moscow,2749,8,5,7,8,18,25,-7,22
Rostov,2749,9,4,7,9,11,18,-7,19
Amkar,2749,10,5,4,11,13,24,-11,19
Anzhi,2749,11,3,5,12,17,40,-23,14
Loko Moscow,2750,1,11,6,3,30,15,15,39
CSKA Moscow,2750,2,11,4,5,29,19,10,37
Spart Moscow,2750,3,10,6,4,40,26,14,36
Zenit,2750,4,8,8,4,24,15,9,32
Krasnodar,2750,5,8,6,6,29,26,3,30
Terek Grozny,2750,6,7,6,7,20,23,-3,27
Din Moscow,2750,7,6,6,8,18,25,-7,24
FK Rubin,2750,8,5,6,9,22,19,3,21
Amkar,2750,9,5,5,10,10,22,-12,20
Rostov,2750,10,4,6,10,11,20,-9,18
Anzhi,2750,11,2,7,11,16,39,-23,13
Loko Moscow,2751,1,12,5,3,34,14,20,41
Spart Moscow,2751,2,11,5,4,40,26,14,38
CSKA Moscow,2751,3,11,4,5,32,18,14,37
Krasnodar,2751,4,9,5,6,31,27,4,32
Zenit,2751,5,7,9,4,22,17,5,30
Terek Grozny,2751,6,7,6,7,22,25,-3,27
Din Moscow,2751,7,6,6,8,20,23,-3,24
FK Rubin,2751,8,5,6,9,22,21,1,21
Amkar,2751,9,5,4,11,11,26,-15,19
Rostov,2751,10,4,6,10,11,19,-8,18
Anzhi,2751,11,2,6,12,15,44,-29,12
Loko Moscow,2752,1,12,5,3,31,13,18,41
CSKA Moscow,2752,2,11,4,5,28,18,10,37
Spart Moscow,2752,3,10,6,4,38,28,10,36
Krasnodar,2752,4,10,4,6,30,24,6,34
Zenit,2752,5,7,9,4,23,16,7,30
Terek Grozny,2752,6,8,5,7,22,24,-2,29
Din Moscow,2752,7,5,7,8,18,23,-5,22
FK Rubin,2752,8,5,6,9,21,19,2,21
Amkar,2752,9,5,5,10,12,24,-12,20
Rostov,2752,10,4,6,10,11,19,-8,18
Anzhi,2752,11,2,5,13,14,40,-26,11
Loko Moscow,2753,1,12,5,3,31,13,18,41
CSKA Moscow,2753,2,12,3,5,30,19,11,39
Spart Moscow,2753,3,11,5,4,38,25,13,38
Zenit,2753,4,8,8,4,22,14,8,32
Krasnodar,2753,5,8,4,8,28,28,0,28
Terek Grozny,2753,6,7,6,7,24,27,-3,27
FK Rubin,2753,7,7,5,8,25,17,8,26
Din Moscow,2753,8,5,6,9,17,25,-8,21
Amkar,2753,9,5,4,11,12,25,-13,19
Rostov,2753,10,4,6,10,10,19,-9,18
Anzhi,2753,11,2,6,12,18,43,-25,12
Loko Moscow,2754,1,12,5,3,33,14,19,41
CSKA Moscow,2754,2,11,4,5,29,20,9,37
Spart Moscow,2754,3,10,5,5,42,30,12,35
Krasnodar,2754,4,10,4,6,31,25,6,34
Zenit,2754,5,7,9,4,23,18,5,30
Terek Grozny,2754,6,8,6,6,22,23,-1,30
Din Moscow,2754,7,6,6,8,20,25,-5,24
FK Rubin,2754,8,6,5,9,23,18,5,23
Rostov,2754,9,4,6,10,11,22,-11,18
Amkar,2754,10,4,5,11,11,25,-14,17
Anzhi,2754,11,2,5,13,15,40,-25,11
Loko Moscow,2755,1,13,5,2,35,13,22,44
CSKA Moscow,2755,2,10,3,7,27,21,6,33
Spart Moscow,2755,3,8,8,4,37,29,8,32
Zenit,2755,4,8,8,4,24,16,8,32
Krasnodar,2755,5,9,4,7,30,28,2,31
Terek Grozny,2755,6,7,7,6,21,23,-2,28
Din Moscow,2755,7,6,7,7,19,22,-3,25
FK Rubin,2755,8,5,5,10,21,20,1,20
Rostov,2755,9,4,7,9,13,20,-7,19
Amkar,2755,10,4,6,10,9,22,-13,18
Anzhi,2755,11,3,6,11,17,39,-22,15
Loko Moscow,2756,1,12,6,2,30,11,19,42
Spart Moscow,2756,2,11,5,4,40,27,13,38
CSKA Moscow,2756,3,11,4,5,30,17,13,37
Zenit,2756,4,7,10,3,21,13,8,31
Krasnodar,2756,5,9,4,7,29,25,4,31
Terek Grozny,2756,6,7,6,7,21,24,-3,27
FK Rubin,2756,7,6,5,9,23,20,3,23
Din Moscow,2756,8,5,6,9,18,26,-8,21
Rostov,2756,9,4,6,10,11,19,-8,18
Amkar,2756,10,4,5,11,11,25,-14,17
Anzhi,2756,11,3,5,12,15,42,-27,14
Loko Moscow,2757,1,13,5,2,32,12,20,44
CSKA Moscow,2757,2,11,3,6,28,21,7,36
Spart Moscow,2757,3,9,6,5,37,29,8,33
Zenit,2757,4,8,8,4,24,15,9,32
Krasnodar,2757,5,8,4,8,28,28,0,28
Din Moscow,2757,6,7,6,7,21,22,-1,27
Terek Grozny,2757,7,7,5,8,20,26,-6,26
FK Rubin,2757,8,6,5,9,23,18,5,23
Amkar,2757,9,5,5,10,11,22,-11,20
Rostov,2757,10,4,6,10,11,20,-9,18
Anzhi,2757,11,3,5,12,17,39,-22,14
Loko Moscow,2758,1,12,5,3,31,14,17,41
CSKA Moscow,2758,2,12,3,5,29,18,11,39
Spart Moscow,2758,3,10,5,5,39,28,11,35
Krasnodar,2758,4,10,4,6,31,24,7,34
Terek Grozny,2758,5,9,5,6,24,23,1,32
Zenit,2758,6,7,8,5,23,17,6,29
Din Moscow,2758,7,6,6,8,20,24,-4,24
FK Rubin,2758,8,5,5,10,22,22,0,20
Amkar,2758,9,5,4,11,12,26,-14,19
Rostov,2758,10,4,6,10,11,20,-9,18
Anzhi,2758,11,2,5,13,14,40,-26,11
Loko Moscow,2759,1,13,5,2,32,11,21,44
CSKA Moscow,2759,2,10,4,6,27,20,7,34
Spart Moscow,2759,3,9,5,6,40,32,8,32
Zenit,2759,4,8,8,4,23,16,7,32
Krasnodar,2759,5,9,4,7,29,26,3,31
Terek Grozny,2759,6,8,6,6,24,22,2,30
Din Moscow,2759,7,6,6,8,22,25,-3,24
FK Rubin,2759,8,6,5,9,24,20,4,23
Amkar,2759,9,5,4,11,10,26,-16,19
Rostov,2759,10,4,6,10,12,22,-10,18
Anzhi,2759,11,2,7,11,15,38,-23,13
Loko Moscow,2760,1,11,7,2,30,12,18,40
Spart Moscow,2760,2,9,6,5,39,29,10,33
Zenit,2760,3,8,9,3,23,14,9,33
CSKA Moscow,2760,4,10,3,7,29,23,6,33
Krasnodar,2760,5,9,5,6,30,25,5,32
Terek Grozny,2760,6,7,7,6,23,25,-2,28
Din Moscow,2760,7,6,6,8,20,25,-5,24
FK Rubin,2760,8,5,5,10,21,21,0,20
Amkar,2760,9,5,5,10,12,24,-12,20
Rostov,2760,10,4,7,9,11,18,-7,19
Anzhi,2760,11,3,6,11,20,42,-22,15
Loko Moscow,2761,1,13,5,2,32,11,21,44
CSKA Moscow,2761,2,11,4,5,29,17,12,37
Spart Moscow,2761,3,8,7,5,33,26,7,31
Krasnodar,2761,4,9,4,7,28,25,3,31
Zenit,2761,5,7,9,4,21,15,6,30
Terek Grozny,2761,6,8,6,6,25,25,0,30
Din Moscow,2761,7,6,7,7,20,22,-2,25
FK Rubin,2761,8,5,5,10,22,21,1,20
Rostov,2761,9,4,7,9,10,17,-7,19
Amkar,2761,10,5,4,11,12,26,-14,19
Anzhi,2761,11,2,6,12,15,42,-27,12
Loko Moscow,2762,1,12,6,2,30,11,19,42
CSKA Moscow,2762,2,11,3,6,28,20,8,36
Spart Moscow,2762,3,10,5,5,39,28,11,35
Zenit,2762,4,8,9,3,23,14,9,33
Krasnodar,2762,5,9,4,7,28,25,3,31
Terek Grozny,2762,6,7,6,7,22,25,-3,27
FK Rubin,2762,7,6,5,9,23,18,5,23
Din Moscow,2762,8,5,6,9,17,26,-9,21
Amkar,2762,9,5,5,10,12,23,-11,20
Rostov,2762,10,4,6,10,11,20,-9,18
Anzhi,2762,11,3,5,12,17,40,-23,14
Loko Moscow,2763,1,11,7,2,30,12,18,40
CSKA Moscow,2763,2,11,4,5,30,20,10,37
Spart Moscow,2763,3,10,5,5,38,29,9,35
Zenit,2763,4,7,10,3,23,15,8,31
Krasnodar,2763,5,8,6,6,27,24,3,30
Terek Grozny,2763,6,8,5,7,23,25,-2,29
Din Moscow,2763,7,6,6,8,19,23,-4,24
Amkar,2763,8,6,4,10,13,23,-10,22
FK Rubin,2763,9,5,6,9,21,18,3,21
Rostov,2763,10,4,6,10,11,19,-8,18
Anzhi,2763,11,2,5,13,17,44,-27,11
Loko Moscow,2764,1,12,5,3,31,14,17,41
Spart Moscow,2764,2,10,6,4,39,28,11,36
CSKA Moscow,2764,3,10,3,7,26,21,5,33
Zenit,2764,4,8,8,4,24,15,9,32
Krasnodar,2764,5,9,5,6,30,25,5,32
Terek Grozny,2764,6,7,7,6,21,23,-2,28
FK Rubin,2764,7,6,6,8,26,19,7,24
Din Moscow,2764,8,5,6,9,19,27,-8,21
Rostov,2764,9,4,7,9,12,19,-7,19
Amkar,2764,10,4,5,11,10,25,-15,17
Anzhi,2764,11,3,6,11,16,38,-22,15
Loko Moscow,2765,1,11,6,3,29,13,16,39
Spart Moscow,2765,2,11,5,4,37,25,12,38
CSKA Moscow,2765,3,11,3,6,27,21,6,36
Krasnodar,2765,4,10,4,6,31,25,6,34
Zenit,2765,5,8,9,3,24,13,11,33
Terek Grozny,2765,6,7,5,8,21,26,-5,26
Din Moscow,2765,7,5,7,8,18,23,-5,22
FK Rubin,2765,8,5,6,9,23,20,3,21
Amkar,2765,9,5,4,11,10,24,-14,19
Rostov,2765,10,4,6,10,10,18,-8,18
Anzhi,2765,11,3,5,12,18,40,-22,14
Loko Moscow,2766,1,11,7,2,32,14,18,40
CSKA Moscow,2766,2,11,4,5,28,19,9,37
Spart Moscow,2766,3,10,6,4,43,28,15,36
Krasnodar,2766,4,9,5,6,30,26,4,32
Zenit,2766,5,7,10,3,23,15,8,31
Terek Grozny,2766,6,7,5,8,22,27,-5,26
Din Moscow,2766,7,6,6,8,20,26,-6,24
FK Rubin,2766,8,5,5,10,21,20,1,20
Amkar,2766,9,5,5,10,12,24,-12,20
Rostov,2766,10,4,6,10,11,21,-10,18
Anzhi,2766,11,3,5,12,18,40,-22,14
Loko Moscow,2767,1,13,5,2,34,13,21,44
CSKA Moscow,2767,2,11,4,5,26,17,9,37
Spart Moscow,2767,3,10,6,4,37,27,10,36
Zenit,2767,4,7,9,4,23,16,7,30
Krasnodar,2767,5,8,4,8,29,29,0,28
Terek Grozny,2767,6,7,6,7,20,24,-4,27
Din Moscow,2767,7,6,6,8,20,24,-4,24
FK Rubin,2767,8,6,5,9,25,21,4,23
Rostov,2767,9,4,6,10,11,19,-8,18
Amkar,2767,10,4,6,10,9,22,-13,18
Anzhi,2767,11,3,5,12,16,38,-22,14
Loko Moscow,2768,1,12,5,3,31,13,18,41
CSKA Moscow,2768,2,11,3,6,27,19,8,36
Spart Moscow,2768,3,9,7,4,36,27,9,34
Zenit,2768,4,8,8,4,22,15,7,32
Krasnodar,2768,5,9,4,7,29,25,4,31
Terek Grozny,2768,6,7,7,6,21,23,-2,28
Din Moscow,2768,7,6,6,8,20,23,-3,24
FK Rubin,2768,8,6,5,9,22,19,3,23
Rostov,2768,9,4,7,9,11,18,-7,19
Amkar,2768,10,4,6,10,10,23,-13,18
Anzhi,2768,11,2,6,12,15,39,-24,12
Loko Moscow,2769,1,12,5,3,31,12,19,41
CSKA Moscow,2769,2,11,4,5,31,19,12,37
Zenit,2769,3,8,9,3,23,14,9,33
Spart Moscow,2769,4,9,5,6,36,32,4,32
Krasnodar,2769,5,9,4,7,29,27,2,31
Terek Grozny,2769,6,8,5,7,21,23,-2,29
Din Moscow,2769,7,6,7,7,21,23,-2,25
Amkar,2769,8,6,4,10,13,22,-9,22
FK Rubin,2769,9,5,6,9,22,19,3,21
Rostov,2769,10,4,6,10,10,18,-8,18
Anzhi,2769,11,2,5,13,15,43,-28,11
Loko Moscow,2770,1,11,7,2,30,12,18,40
CSKA Moscow,2770,2,11,3,6,28,19,9,36
Spart Moscow,2770,3,10,5,5,38,27,11,35
Zenit,2770,4,8,9,3,24,14,10,33
Krasnodar,2770,5,9,5,6,31,25,6,32
Terek Grozny,2770,6,8,6,6,23,23,0,30
Din Moscow,2770,7,5,7,8,17,22,-5,22
FK Rubin,2770,8,5,6,9,22,21,1,21
Amkar,2770,9,5,5,10,10,22,-12,20
Rostov,2770,10,4,6,10,11,21,-10,18
Anzhi,2770,11,2,5,13,15,43,-28,11
Loko Moscow,2771,1,11,5,4,29,13,16,38
CSKA Moscow,2771,2,11,3,6,26,18,8,36
Zenit,2771,3,9,8,3,23,13,10,35
Spart Moscow,2771,4,10,5,5,35,26,9,35
Krasnodar,2771,5,9,4,7,28,26,2,31
Terek Grozny,2771,6,8,6,6,21,22,-1,30
FK Rubin,2771,7,7,5,8,25,17,8,26
Rostov,2771,8,5,6,9,11,17,-6,21
Din Moscow,2771,9,5,6,9,17,24,-7,21
Amkar,2771,10,4,5,11,9,23,-14,17
Anzhi,2771,11,2,5,13,14,39,-25,11
Loko Moscow,2772,1,12,5,3,31,13,18,41
CSKA Moscow,2772,2,11,4,5,29,18,11,37
Krasnodar,2772,3,10,4,6,31,26,5,34
Spart Moscow,2772,4,9,6,5,38,27,11,33
Terek Grozny,2772,5,9,5,6,23,23,0,32
Zenit,2772,6,7,9,4,21,14,7,30
Din Moscow,2772,7,5,8,7,17,21,-4,23
FK Rubin,2772,8,5,6,9,22,19,3,21
Amkar,2772,9,5,4,11,11,24,-13,19
Rostov,2772,10,4,6,10,10,21,-11,18
Anzhi,2772,11,2,5,13,16,43,-27,11
Loko Moscow,2773,1,11,6,3,31,15,16,39
Spart Moscow,2773,2,11,5,4,38,26,12,38
CSKA Moscow,2773,3,11,3,6,29,21,8,36
Krasnodar,2773,4,10,4,6,33,27,6,34
Zenit,2773,5,8,9,3,26,14,12,33
Terek Grozny,2773,6,7,6,7,20,23,-3,27
Din Moscow,2773,7,5,7,8,17,23,-6,22
FK Rubin,2773,8,5,6,9,23,20,3,21
Rostov,2773,9,4,6,10,11,19,-8,18
Amkar,2773,10,4,5,11,9,23,-14,17
Anzhi,2773,11,3,5,12,15,41,-26,14
Loko Moscow,2774,1,12,6,2,32,12,20,42
CSKA Moscow,2774,2,11,4,5,31,18,13,37
Spart Moscow,2774,3,10,6,4,37,26,11,36
Zenit,2774,4,7,10,3,23,15,8,31
Terek Grozny,2774,5,8,6,6,23,22,1,30
Krasnodar,2774,6,8,5,7,28,27,1,29
FK Rubin,2774,7,5,7,8,22,18,4,22
Din Moscow,2774,8,5,7,8,18,23,-5,22
Rostov,2774,9,4,6,10,10,19,-9,18
Amkar,2774,10,4,6,10,9,22,-13,18
Anzhi,2774,11,2,5,13,14,45,-31,11
Loko Moscow,2775,1,13,5,2,31,11,20,44
CSKA Moscow,2775,2,11,4,5,30,18,12,37
Spart Moscow,2775,3,9,7,4,38,27,11,34
Zenit,2775,4,7,9,4,22,15,7,30
Krasnodar,2775,5,8,5,7,28,26,2,29
Terek Grozny,2775,6,7,7,6,23,25,-2,28
FK Rubin,2775,7,6,6,8,24,19,5,24
Din Moscow,2775,8,5,6,9,19,27,-8,21
Rostov,2775,9,4,7,9,10,17,-7,19
Amkar,2775,10,4,6,10,12,25,-13,18
Anzhi,2775,11,2,6,12,15,42,-27,12
Loko Moscow,2776,1,11,6,3,29,12,17,39
Spart Moscow,2776,2,10,6,4,40,27,13,36
CSKA Moscow,2776,3,10,5,5,25,17,8,35
Krasnodar,2776,4,9,5,6,29,25,4,32
Zenit,2776,5,7,10,3,21,13,8,31
Terek Grozny,2776,6,8,5,7,23,25,-2,29
FK Rubin,2776,7,5,7,8,24,20,4,22
Din Moscow,2776,8,5,7,8,19,26,-7,22
Rostov,2776,9,4,6,10,11,20,-9,18
Amkar,2776,10,4,5,11,11,25,-14,17
Anzhi,2776,11,3,6,11,16,38,-22,15
Loko Moscow,2777,1,12,5,3,32,12,20,41
Spart Moscow,2777,2,10,6,4,39,27,12,36
CSKA Moscow,2777,3,11,3,6,28,20,8,36
Zenit,2777,4,9,8,3,25,13,12,35
Terek Grozny,2777,5,9,5,6,24,23,1,32
Krasnodar,2777,6,8,5,7,28,28,0,29
FK Rubin,2777,7,5,7,8,23,19,4,22
Din Moscow,2777,8,5,7,8,19,24,-5,22
Rostov,2777,9,4,6,10,10,20,-10,18
Amkar,2777,10,4,5,11,11,25,-14,17
Anzhi,2777,11,2,5,13,14,42,-28,11
Loko Moscow,2778,1,12,5,3,33,18,15,41
CSKA Moscow,2778,2,11,4,5,27,18,9,37
Zenit,2778,3,8,9,3,27,14,13,33
Terek Grozny,2778,4,9,5,6,24,24,0,32
Spart Moscow,2778,5,8,5,7,36,32,4,29
Krasnodar,2778,6,8,4,8,30,30,0,28
Din Moscow,2778,7,7,6,7,21,23,-2,27
FK Rubin,2778,8,6,5,9,24,20,4,23
Rostov,2778,9,5,6,9,12,17,-5,21
Amkar,2778,10,5,4,11,11,24,-13,19
Anzhi,2778,11,2,5,13,17,42,-25,11
Loko Moscow,2779,1,12,6,2,32,12,20,42
CSKA Moscow,2779,2,12,3,5,30,18,12,39
Spart Moscow,2779,3,9,6,5,37,29,8,33
Zenit,2779,4,7,9,4,21,15,6,30
Krasnodar,2779,5,8,5,7,29,28,1,29
Terek Grozny,2779,6,8,5,7,23,25,-2,29
FK Rubin,2779,7,6,6,8,24,19,5,24
Din Moscow,2779,8,6,6,8,20,24,-4,24
Amkar,2779,9,5,5,10,12,24,-12,20
Rostov,2779,10,4,6,10,10,18,-8,18
Anzhi,2779,11,2,5,13,17,43,-26,11
Loko Moscow,2780,1,12,6,2,32,13,19,42
Spart Moscow,2780,2,10,6,4,37,27,10,36
CSKA Moscow,2780,3,11,3,6,28,20,8,36
Zenit,2780,4,8,9,3,24,15,9,33
Krasnodar,2780,5,9,4,7,29,26,3,31
Terek Grozny,2780,6,7,7,6,22,24,-2,28
Din Moscow,2780,7,6,7,7,20,22,-2,25
FK Rubin,2780,8,5,5,10,21,20,1,20
Rostov,2780,9,4,6,10,11,19,-8,18
Amkar,2780,10,4,5,11,10,24,-14,17
Anzhi,2780,11,2,6,12,16,40,-24,12
Loko Moscow,2781,1,13,5,2,34,12,22,44
Spart Moscow,2781,2,10,5,5,39,28,11,35
CSKA Moscow,2781,3,10,5,5,27,19,8,35
Krasnodar,2781,4,9,4,7,33,26,7,31
Zenit,2781,5,7,9,4,22,17,5,30
Terek Grozny,2781,6,8,6,6,22,23,-1,30
Din Moscow,2781,7,6,7,7,20,22,-2,25
FK Rubin,2781,8,5,6,9,22,23,-1,21
Rostov,2781,9,4,6,10,10,19,-9,18
Amkar,2781,10,4,5,11,10,26,-16,17
Anzhi,2781,11,2,6,12,16,40,-24,12
Loko Moscow,2782,1,12,5,3,31,14,17,41
CSKA Moscow,2782,2,12,3,5,31,19,12,39
Zenit,2782,3,8,8,4,24,15,9,32
Spart Moscow,2782,4,9,5,6,36,32,4,32
Krasnodar,2782,5,8,5,7,28,27,1,29
Din Moscow,2782,6,7,6,7,24,22,2,27
Terek Grozny,2782,7,7,6,7,22,25,-3,27
FK Rubin,2782,8,5,6,9,22,20,2,21
Rostov,2782,9,5,6,9,11,17,-6,21
Amkar,2782,10,5,4,11,11,24,-13,19
Anzhi,2782,11,2,6,12,18,43,-25,12
Loko Moscow,2783,1,12,5,3,32,13,19,41
CSKA Moscow,2783,2,11,4,5,27,18,9,37
Zenit,2783,3,8,8,4,24,16,8,32
Spart Moscow,2783,4,9,5,6,35,28,7,32
Terek Grozny,2783,5,8,6,6,22,22,0,30
Krasnodar,2783,6,8,5,7,28,27,1,29
Din Moscow,2783,7,7,6,7,20,22,-2,27
FK Rubin,2783,8,5,6,9,22,19,3,21
Amkar,2783,9,5,5,10,10,22,-12,20
Rostov,2783,10,4,6,10,10,18,-8,18
Anzhi,2783,11,2,6,12,14,39,-25,12
Loko Moscow,2784,1,12,6,2,34,14,20,42
CSKA Moscow,2784,2,11,4,5,29,19,10,37
Spart Moscow,2784,3,9,6,5,38,27,11,33
Zenit,2784,4,7,10,3,24,16,8,31
Krasnodar,2784,5,9,4,7,29,27,2,31
Terek Grozny,2784,6,7,7,6,23,25,-2,28
Din Moscow,2784,7,6,6,8,18,22,-4,24
FK Rubin,2784,8,6,5,9,22,18,4,23
Rostov,2784,9,4,6,10,10,21,-11,18
Amkar,2784,10,4,6,10,11,24,-13,18
Anzhi,2784,11,2,6,12,17,42,-25,12
Loko Moscow,2785,1,12,6,2,33,13,20,42
CSKA Moscow,2785,2,11,3,6,29,20,9,36
Krasnodar,2785,3,9,4,7,28,26,2,31
Zenit,2785,4,7,9,4,24,18,6,30
Terek Grozny,2785,5,8,6,6,22,23,-1,30
Spart Moscow,2785,6,8,5,7,35,31,4,29
Din Moscow,2785,7,6,6,8,19,24,-5,24
FK Rubin,2785,8,6,5,9,23,18,5,23
Rostov,2785,9,5,6,9,12,17,-5,21
Amkar,2785,10,5,4,11,11,24,-13,19
Anzhi,2785,11,3,6,11,17,39,-22,15
Loko Moscow,2786,1,12,5,3,32,14,18,41
CSKA Moscow,2786,2,11,4,5,27,18,9,37
Spart Moscow,2786,3,10,5,5,37,28,9,35
Krasnodar,2786,4,9,4,7,30,28,2,31
Zenit,2786,5,7,9,4,22,15,7,30
Terek Grozny,2786,6,8,5,7,22,24,-2,29
Din Moscow,2786,7,6,6,8,18,24,-6,24
FK Rubin,2786,8,6,5,9,24,19,5,23
Amkar,2786,9,5,4,11,12,24,-12,19
Rostov,2786,10,4,6,10,10,18,-8,18
Anzhi,2786,11,3,5,12,17,39,-22,14
Loko Moscow,2787,1,11,6,3,31,15,16,39
CSKA Moscow,2787,2,11,4,5,27,17,10,37
Spart Moscow,2787,3,9,7,4,35,25,10,34
Zenit,2787,4,8,8,4,23,15,8,32
Krasnodar,2787,5,8,5,7,29,28,1,29
Terek Grozny,2787,6,8,5,7,22,24,-2,29
FK Rubin,2787,7,7,5,8,24,17,7,26
Din Moscow,2787,8,5,6,9,17,24,-7,21
Amkar,2787,9,5,5,10,11,23,-12,20
Rostov,2787,10,4,7,9,10,17,-7,19
Anzhi,2787,11,2,6,12,14,38,-24,12
Loko Moscow,2788,1,12,6,2,32,12,20,42
CSKA Moscow,2788,2,12,3,5,30,19,11,39
Spart Moscow,2788,3,9,5,6,36,31,5,32
Krasnodar,2788,4,9,4,7,29,26,3,31
Zenit,2788,5,7,9,4,22,15,7,30
Terek Grozny,2788,6,8,6,6,24,23,1,30
Din Moscow,2788,7,6,6,8,19,23,-4,24
Rostov,2788,8,5,6,9,12,17,-5,21
FK Rubin,2788,9,5,5,10,21,20,1,20
Amkar,2788,10,5,5,10,13,24,-11,20
Anzhi,2788,11,2,5,13,16,44,-28,11
Loko Moscow,2789,1,11,5,4,30,15,15,38
CSKA Moscow,2789,2,11,3,6,28,20,8,36
Zenit,2789,3,9,8,3,25,14,11,35
Spart Moscow,2789,4,8,8,4,37,29,8,32
Krasnodar,2789,5,9,4,7,30,28,2,31
Terek Grozny,2789,6,7,6,7,20,23,-3,27
FK Rubin,2789,7,6,6,8,28,21,7,24
Din Moscow,2789,8,5,8,7,21,25,-4,23
Amkar,2789,9,5,5,10,12,24,-12,20
Rostov,2789,10,4,7,9,11,18,-7,19
Anzhi,2789,11,2,6,12,15,40,-25,12
Loko Moscow,2790,1,13,5,2,34,12,22,44
CSKA Moscow,2790,2,11,4,5,32,18,14,37
Spart Moscow,2790,3,10,5,5,37,28,9,35
Krasnodar,2790,4,9,4,7,28,26,2,31
Zenit,2790,5,7,9,4,23,17,6,30
Terek Grozny,2790,6,8,5,7,23,23,0,29
Din Moscow,2790,7,6,6,8,20,24,-4,24
FK Rubin,2790,8,5,5,10,21,20,1,20
Amkar,2790,9,5,4,11,11,25,-14,19
Rostov,2790,10,4,6,10,10,18,-8,18
Anzhi,2790,11,3,5,12,15,43,-28,14
Loko Moscow,2791,1,12,5,3,34,15,19,41
CSKA Moscow,2791,2,11,4,5,29,19,10,37
Krasnodar,2791,3,10,4,6,34,25,9,34
Spart Moscow,2791,4,8,6,6,37,32,5,30
Zenit,2791,5,7,8,5,23,20,3,29
Terek Grozny,2791,6,7,7,6,22,24,-2,28
Din Moscow,2791,7,6,6,8,20,25,-5,24
FK Rubin,2791,8,6,5,9,23,21,2,23
Rostov,2791,9,5,6,9,12,17,-5,21
Amkar,2791,10,4,6,10,12,25,-13,18
Anzhi,2791,11,2,7,11,16,39,-23,13
Loko Moscow,2792,1,12,5,3,33,14,19,41
Krasnodar,2792,2,10,4,6,33,27,6,34
CSKA Moscow,2792,3,10,4,6,26,20,6,34
Spart Moscow,2792,4,9,6,5,37,30,7,33
Zenit,2792,5,7,9,4,21,15,6,30
Terek Grozny,2792,6,7,6,7,21,24,-3,27
Din Moscow,2792,7,5,7,8,18,23,-5,22
Amkar,2792,8,6,4,10,13,23,-10,22
FK Rubin,2792,9,5,6,9,22,20,2,21
Rostov,2792,10,4,7,9,11,18,-7,19
Anzhi,2792,11,3,6,11,18,39,-21,15
Loko Moscow,2793,1,12,5,3,30,14,16,41
CSKA Moscow,2793,2,12,3,5,27,17,10,39
Spart Moscow,2793,3,9,7,4,35,26,9,34
Krasnodar,2793,4,10,4,6,31,24,7,34
Terek Grozny,2793,5,8,6,6,24,22,2,30
Zenit,2793,6,7,8,5,21,15,6,29
Din Moscow,2793,7,5,7,8,19,24,-5,22
FK Rubin,2793,8,5,6,9,22,19,3,21
Rostov,2793,9,4,7,9,10,17,-7,19
Amkar,2793,10,4,6,10,9,22,-13,18
Anzhi,2793,11,2,5,13,14,42,-28,11
Loko Moscow,2794,1,11,5,4,31,18,13,38
CSKA Moscow,2794,2,11,3,6,31,23,8,36
Spart Moscow,2794,3,10,5,5,39,26,13,35
Zenit,2794,4,9,8,3,28,17,11,35
Krasnodar,2794,5,10,4,6,35,25,10,34
Terek Grozny,2794,6,8,5,7,22,25,-3,29
FK Rubin,2794,7,6,5,9,23,21,2,23
Amkar,2794,8,6,4,10,12,22,-10,22
Din Moscow,2794,9,5,6,9,17,25,-8,21
Rostov,2794,10,4,6,10,10,20,-10,18
Anzhi,2794,11,2,5,13,17,43,-26,11
Loko Moscow,2795,1,11,6,3,29,13,16,39
CSKA Moscow,2795,2,11,4,5,29,20,9,37
Spart Moscow,2795,3,10,5,5,38,28,10,35
Krasnodar,2795,4,9,5,6,30,25,5,32
Zenit,2795,5,7,9,4,22,15,7,30
Terek Grozny,2795,6,7,6,7,21,24,-3,27
Din Moscow,2795,7,6,7,7,20,23,-3,25
FK Rubin,2795,8,5,7,8,23,19,4,22
Rostov,2795,9,4,6,10,11,20,-9,18
Amkar,2795,10,4,5,11,9,23,-14,17
Anzhi,2795,11,3,6,11,18,40,-22,15
Loko Moscow,2796,1,12,6,2,34,13,21,42
CSKA Moscow,2796,2,11,3,6,29,22,7,36
Spart Moscow,2796,3,9,5,6,35,29,6,32
Zenit,2796,4,7,9,4,23,16,7,30
Terek Grozny,2796,5,8,5,7,21,24,-3,29
Krasnodar,2796,6,8,4,8,29,30,-1,28
Din Moscow,2796,7,6,7,7,19,22,-3,25
FK Rubin,2796,8,6,6,8,24,19,5,24
Rostov,2796,9,5,6,9,12,17,-5,21
Anzhi,2796,10,4,5,11,20,39,-19,17
Amkar,2796,11,4,4,12,10,25,-15,16
Loko Moscow,2797,1,11,5,4,29,15,14,38
CSKA Moscow,2797,2,11,3,6,27,19,8,36
Zenit,2797,3,9,8,3,25,14,11,35
Spart Moscow,2797,4,8,8,4,34,26,8,32
Krasnodar,2797,5,9,4,7,30,26,4,31
FK Rubin,2797,6,7,5,8,25,19,6,26
Terek Grozny,2797,7,7,5,8,21,28,-7,26
Din Moscow,2797,8,5,7,8,19,24,-5,22
Amkar,2797,9,5,5,10,11,22,-11,20
Rostov,2797,10,4,7,9,10,17,-7,19
Anzhi,2797,11,3,5,12,18,39,-21,14
Loko Moscow,2798,1,12,5,3,31,14,17,41
CSKA Moscow,2798,2,11,4,5,33,18,15,37
Spart Moscow,2798,3,10,6,4,41,28,13,36
Zenit,2798,4,8,9,3,25,15,10,33
Krasnodar,2798,5,9,4,7,28,25,3,31
Terek Grozny,2798,6,7,6,7,21,24,-3,27
FK Rubin,2798,7,6,5,9,22,18,4,23
Din Moscow,2798,8,5,6,9,19,25,-6,21
Rostov,2798,9,4,6,10,10,21,-11,18
Amkar,2798,10,4,6,10,10,23,-13,18
Anzhi,2798,11,3,5,12,16,45,-29,14
Loko Moscow,2799,1,11,7,2,30,12,18,40
CSKA Moscow,2799,2,11,4,5,28,19,9,37
Spart Moscow,2799,3,10,5,5,37,27,10,35
Krasnodar,2799,4,9,5,6,30,26,4,32
Zenit,2799,5,7,10,3,22,14,8,31
Terek Grozny,2799,6,8,6,6,22,23,-1,30
Din Moscow,2799,7,5,7,8,19,25,-6,22
FK Rubin,2799,8,5,6,9,23,20,3,21
Rostov,2799,9,5,6,9,11,17,-6,21
Amkar,2799,10,4,5,11,9,23,-14,17
Anzhi,2799,11,2,5,13,16,41,-25,11
Loko Moscow,2800,1,11,6,3,31,16,15,39
Krasnodar,2800,2,10,4,6,34,26,8,34
CSKA Moscow,2800,3,10,4,6,27,21,6,34
Spart Moscow,2800,4,9,6,5,36,29,7,33
Zenit,2800,5,7,10,3,23,15,8,31
Terek Grozny,2800,6,8,5,7,21,24,-3,29
Din Moscow,2800,7,6,6,8,20,24,-4,24
Amkar,2800,8,6,4,10,13,22,-9,22
FK Rubin,2800,9,5,5,10,23,22,1,20
Rostov,2800,10,4,7,9,12,19,-7,19
Anzhi,2800,11,3,5,12,16,38,-22,14
Loko Moscow,2801,1,11,6,3,29,13,16,39
Spart Moscow,2801,2,10,6,4,40,29,11,36
CSKA Moscow,2801,3,11,3,6,28,18,10,36
Zenit,2801,4,8,8,4,23,16,7,32
Krasnodar,2801,5,8,6,6,28,25,3,30
Terek Grozny,2801,6,7,6,7,21,24,-3,27
Din Moscow,2801,7,6,6,8,22,24,-2,24
FK Rubin,2801,8,5,6,9,23,23,0,21
Rostov,2801,9,4,7,9,12,19,-7,19
Amkar,2801,10,4,5,11,12,26,-14,17
Anzhi,2801,11,4,5,11,16,37,-21,17
Loko Moscow,2802,1,13,5,2,36,12,24,44
CSKA Moscow,2802,2,10,3,7,26,21,5,33
Zenit,2802,3,8,8,4,24,17,7,32
Spart Moscow,2802,4,9,5,6,35,29,6,32
Krasnodar,2802,5,8,5,7,29,29,0,29
Din Moscow,2802,6,7,6,7,19,21,-2,27
Terek Grozny,2802,7,7,6,7,21,24,-3,27
FK Rubin,2802,8,5,6,9,23,20,3,21
Amkar,2802,9,5,5,10,13,24,-11,20
Rostov,2802,10,4,6,10,10,18,-8,18
Anzhi,2802,11,4,5,11,17,38,-21,17
Loko Moscow,2803,1,11,6,3,31,14,17,39
CSKA Moscow,2803,2,11,4,5,27,18,9,37
Zenit,2803,3,8,9,3,24,15,9,33
Spart Moscow,2803,4,8,5,7,37,33,4,29
Krasnodar,2803,5,8,5,7,30,28,2,29
Terek Grozny,2803,6,8,5,7,21,26,-5,29
Din Moscow,2803,7,6,7,7,22,24,-2,25
FK Rubin,2803,8,6,6,8,25,20,5,24
Amkar,2803,9,6,4,10,15,23,-8,22
Rostov,2803,10,5,6,9,12,18,-6,21
Anzhi,2803,11,2,5,13,14,39,-25,11
Loko Moscow,2804,1,12,5,3,30,14,16,41
CSKA Moscow,2804,2,11,3,6,27,21,6,36
Zenit,2804,3,9,8,3,27,13,14,35
Spart Moscow,2804,4,10,5,5,40,27,13,35
Krasnodar,2804,5,9,4,7,28,25,3,31
Terek Grozny,2804,6,7,7,6,22,24,-2,28
Din Moscow,2804,7,5,7,8,19,25,-6,22
FK Rubin,2804,8,5,6,9,22,19,3,21
Amkar,2804,9,5,5,10,11,23,-12,20
Rostov,2804,10,4,6,10,10,21,-11,18
Anzhi,2804,11,2,6,12,16,40,-24,12
Loko Moscow,2805,1,11,6,3,31,15,16,39
CSKA Moscow,2805,2,11,4,5,28,19,9,37
Terek Grozny,2805,3,9,5,6,24,22,2,32
Zenit,2805,4,7,10,3,24,16,8,31
Spart Moscow,2805,5,8,7,5,38,31,7,31
Krasnodar,2805,6,9,4,7,30,27,3,31
FK Rubin,2805,7,6,6,8,23,17,6,24
Din Moscow,2805,8,5,8,7,19,23,-4,23
Rostov,2805,9,5,6,9,12,18,-6,21
Amkar,2805,10,4,5,11,11,27,-16,17
Anzhi,2805,11,2,5,13,14,39,-25,11
CSKA Moscow,2806,1,12,3,5,29,17,12,39
Loko Moscow,2806,2,11,5,4,29,16,13,38
Spart Moscow,2806,3,9,7,4,35,26,9,34
Zenit,2806,4,8,8,4,23,15,8,32
Krasnodar,2806,5,9,5,6,30,24,6,32
Terek Grozny,2806,6,7,7,6,21,23,-2,28
Din Moscow,2806,7,6,7,7,21,23,-2,25
FK Rubin,2806,8,5,6,9,22,20,2,21
Rostov,2806,9,4,6,10,10,18,-8,18
Amkar,2806,10,4,6,10,10,23,-13,18
Anzhi,2806,11,2,6,12,14,39,-25,12
Loko Moscow,2807,1,12,5,3,35,15,20,41
CSKA Moscow,2807,2,12,3,5,28,18,10,39
Spart Moscow,2807,3,11,5,4,39,25,14,38
Zenit,2807,4,8,8,4,25,17,8,32
Krasnodar,2807,5,8,4,8,27,28,-1,28
Terek Grozny,2807,6,7,5,8,22,26,-4,26
Din Moscow,2807,7,6,6,8,19,22,-3,24
FK Rubin,2807,8,6,5,9,22,19,3,23
Amkar,2807,9,5,4,11,10,24,-14,19
Rostov,2807,10,4,6,10,10,20,-10,18
Anzhi,2807,11,3,5,12,18,41,-23,14
Loko Moscow,2808,1,11,7,2,35,17,18,40
Spart Moscow,2808,2,11,5,4,38,26,12,38
CSKA Moscow,2808,3,11,4,5,29,17,12,37
Zenit,2808,4,7,10,3,22,14,8,31
Krasnodar,2808,5,8,5,7,33,31,2,29
Terek Grozny,2808,6,7,6,7,22,25,-3,27
FK Rubin,2808,7,7,5,8,26,20,6,26
Din Moscow,2808,8,5,6,9,19,25,-6,21
Amkar,2808,9,5,4,11,12,26,-14,19
Rostov,2808,10,4,6,10,10,18,-8,18
Anzhi,2808,11,2,6,12,15,42,-27,12
Loko Moscow,2809,1,12,6,2,31,12,19,42
CSKA Moscow,2809,2,11,3,6,30,21,9,36
Spart Moscow,2809,3,10,5,5,40,28,12,35
Zenit,2809,4,8,8,4,26,15,11,32
Krasnodar,2809,5,8,5,7,29,27,2,29
Terek Grozny,2809,6,7,6,7,21,24,-3,27
FK Rubin,2809,7,7,5,8,26,20,6,26
Amkar,2809,8,6,4,10,13,24,-11,22
Din Moscow,2809,9,5,6,9,19,28,-9,21
Rostov,2809,10,4,6,10,10,18,-8,18
Anzhi,2809,11,2,6,12,14,42,-28,12
Loko Moscow,2810,1,12,6,2,33,14,19,42
CSKA Moscow,2810,2,12,3,5,31,18,13,39
Spart Moscow,2810,3,11,5,4,37,26,11,38
Krasnodar,2810,4,8,6,6,28,25,3,30
Zenit,2810,5,7,8,5,24,18,6,29
Terek Grozny,2810,6,8,5,7,22,24,-2,29
FK Rubin,2810,7,6,6,8,22,17,5,24
Din Moscow,2810,8,5,6,9,18,24,-6,21
Rostov,2810,9,4,6,10,10,18,-8,18
Amkar,2810,10,4,4,12,9,24,-15,16
Anzhi,2810,11,3,5,12,16,42,-26,14
Loko Moscow,2811,1,12,6,2,30,11,19,42
CSKA Moscow,2811,2,11,4,5,30,19,11,37
Spart Moscow,2811,3,9,6,5,38,29,9,33
Zenit,2811,4,7,10,3,23,15,8,31
Krasnodar,2811,5,9,4,7,29,25,4,31
Terek Grozny,2811,6,8,6,6,22,23,-1,30
FK Rubin,2811,7,6,5,9,22,19,3,23
Din Moscow,2811,8,5,6,9,18,25,-7,21
Rostov,2811,9,4,7,9,11,18,-7,19
Amkar,2811,10,5,4,11,11,24,-13,19
Anzhi,2811,11,2,6,12,15,41,-26,12
Loko Moscow,2812,1,13,5,2,33,11,22,44
CSKA Moscow,2812,2,11,3,6,27,20,7,36
Spart Moscow,2812,3,9,6,5,38,30,8,33
Zenit,2812,4,8,8,4,23,14,9,32
Terek Grozny,2812,5,8,6,6,23,24,-1,30
Krasnodar,2812,6,8,4,8,27,28,-1,28
FK Rubin,2812,7,7,5,8,23,17,6,26
Din Moscow,2812,8,5,6,9,17,23,-6,21
Amkar,2812,9,5,5,10,14,26,-12,20
Rostov,2812,10,4,7,9,12,19,-7,19
Anzhi,2812,11,2,5,13,15,40,-25,11
Loko Moscow,2813,1,12,5,3,33,13,20,41
Spart Moscow,2813,2,10,6,4,39,26,13,36
CSKA Moscow,2813,3,10,4,6,26,20,6,34
Zenit,2813,4,8,9,3,23,14,9,33
Krasnodar,2813,5,8,4,8,28,29,-1,28
Terek Grozny,2813,6,7,6,7,20,23,-3,27
FK Rubin,2813,7,7,5,8,24,18,6,26
Din Moscow,2813,8,5,6,9,17,24,-7,21
Rostov,2813,9,4,7,9,11,18,-7,19
Amkar,2813,10,4,5,11,9,25,-16,17
Anzhi,2813,11,4,5,11,18,38,-20,17
Loko Moscow,2814,1,11,6,3,29,13,16,39
Spart Moscow,2814,2,11,5,4,41,26,15,38
CSKA Moscow,2814,3,10,5,5,27,19,8,35
Krasnodar,2814,4,10,4,6,31,24,7,34
Zenit,2814,5,7,10,3,22,14,8,31
Terek Grozny,2814,6,8,5,7,21,24,-3,29
Din Moscow,2814,7,5,7,8,19,27,-8,22
FK Rubin,2814,8,5,6,9,22,20,2,21
Rostov,2814,9,4,6,10,10,19,-9,18
Amkar,2814,10,4,4,12,9,24,-15,16
Anzhi,2814,11,3,6,11,17,38,-21,15
Loko Moscow,2815,1,11,6,3,31,14,17,39
CSKA Moscow,2815,2,11,4,5,28,18,10,37
Spart Moscow,2815,3,10,5,5,38,29,9,35
Zenit,2815,4,8,8,4,23,16,7,32
Krasnodar,2815,5,8,6,6,28,25,3,30
Terek Grozny,2815,6,8,6,6,22,23,-1,30
Din Moscow,2815,7,6,7,7,21,23,-2,25
FK Rubin,2815,8,5,7,8,22,18,4,22
Rostov,2815,9,4,6,10,10,19,-9,18
Amkar,2815,10,4,4,12,10,25,-15,16
Anzhi,2815,11,2,7,11,16,39,-23,13
Loko Moscow,2816,1,12,6,2,34,13,21,42
CSKA Moscow,2816,2,11,4,5,28,17,11,37
Spart Moscow,2816,3,9,5,6,37,32,5,32
Krasnodar,2816,4,9,5,6,28,24,4,32
Zenit,2816,5,7,9,4,23,18,5,30
Terek Grozny,2816,6,8,6,6,23,24,-1,30
Din Moscow,2816,7,5,7,8,17,23,-6,22
FK Rubin,2816,8,5,6,9,21,18,3,21
Rostov,2816,9,5,6,9,13,18,-5,21
Amkar,2816,10,5,4,11,14,25,-11,19
Anzhi,2816,11,2,6,12,15,41,-26,12
Loko Moscow,2817,1,12,6,2,32,13,19,42
CSKA Moscow,2817,2,11,3,6,27,20,7,36
Zenit,2817,3,8,9,3,25,15,10,33
Krasnodar,2817,4,9,4,7,30,27,3,31
Terek Grozny,2817,5,8,6,6,22,22,0,30
Spart Moscow,2817,6,8,5,7,35,31,4,29
Din Moscow,2817,7,6,7,7,19,21,-2,25
FK Rubin,2817,8,5,6,9,22,19,3,21
Rostov,2817,9,5,6,9,11,17,-6,21
Amkar,2817,10,5,5,10,12,24,-12,20
Anzhi,2817,11,2,5,13,14,40,-26,11
Loko Moscow,2818,1,11,6,3,32,15,17,39
CSKA Moscow,2818,2,11,3,6,27,19,8,36
Krasnodar,2818,3,10,4,6,31,26,5,34
Spart Moscow,2818,4,9,6,5,40,28,12,33
Zenit,2818,5,8,9,3,24,15,9,33
Terek Grozny,2818,6,9,5,6,26,22,4,32
Din Moscow,2818,7,5,7,8,18,27,-9,22
FK Rubin,2818,8,5,6,9,23,20,3,21
Rostov,2818,9,5,6,9,12,18,-6,21
Amkar,2818,10,4,5,11,10,27,-17,17
Anzhi,2818,11,2,5,13,15,41,-26,11
Loko Moscow,2819,1,11,7,2,30,12,18,40
CSKA Moscow,2819,2,11,3,6,27,21,6,36
Zenit,2819,3,8,9,3,25,13,12,33
Spart Moscow,2819,4,9,5,6,37,31,6,32
Krasnodar,2819,5,8,5,7,29,27,2,29
Terek Grozny,2819,6,8,5,7,23,24,-1,29
FK Rubin,2819,7,6,6,8,25,20,5,24
Din Moscow,2819,8,5,7,8,20,27,-7,22
Amkar,2819,9,6,4,10,15,22,-7,22
Rostov,2819,10,5,6,9,11,17,-6,21
Anzhi,2819,11,2,5,13,14,42,-28,11
Loko Moscow,2820,1,12,6,2,33,13,20,42
Spart Moscow,2820,2,10,6,4,38,26,12,36
CSKA Moscow,2820,3,11,3,6,26,18,8,36
Zenit,2820,4,8,9,3,23,14,9,33
Krasnodar,2820,5,9,4,7,30,27,3,31
Terek Grozny,2820,6,7,6,7,20,25,-5,27
Din Moscow,2820,7,6,6,8,20,23,-3,24
FK Rubin,2820,8,5,5,10,22,22,0,20
Amkar,2820,9,5,5,10,13,23,-10,20
Rostov,2820,10,4,6,10,10,20,-10,18
Anzhi,2820,11,2,6,12,14,38,-24,12
Loko Moscow,2821,1,13,5,2,35,15,20,44
CSKA Moscow,2821,2,10,4,6,25,18,7,34
Spart Moscow,2821,3,9,6,5,36,28,8,33
Krasnodar,2821,4,9,4,7,35,28,7,31
Zenit,2821,5,7,9,4,22,15,7,30
Terek Grozny,2821,6,8,6,6,21,22,-1,30
Din Moscow,2821,7,6,7,7,20,22,-2,25
FK Rubin,2821,8,5,5,10,21,24,-3,20
Amkar,2821,9,5,4,11,11,24,-13,19
Rostov,2821,10,4,6,10,10,18,-8,18
Anzhi,2821,11,3,6,11,15,37,-22,15
Loko Moscow,2822,1,11,6,3,30,14,16,39
CSKA Moscow,2822,2,11,4,5,28,17,11,37
Zenit,2822,3,7,10,3,22,14,8,31
Spart Moscow,2822,4,8,7,5,37,31,6,31
Krasnodar,2822,5,9,4,7,30,26,4,31
Terek Grozny,2822,6,8,5,7,21,23,-2,29
FK Rubin,2822,7,6,6,8,24,19,5,24
Din Moscow,2822,8,5,8,7,20,24,-4,23
Rostov,2822,9,5,6,9,13,18,-5,21
Amkar,2822,10,5,5,10,11,23,-12,20
Anzhi,2822,11,2,5,13,14,41,-27,11
Loko Moscow,2823,1,13,5,2,34,12,22,44
CSKA Moscow,2823,2,12,3,5,30,19,11,39
Spart Moscow,2823,3,10,5,5,40,28,12,35
Terek Grozny,2823,4,8,6,6,23,24,-1,30
Zenit,2823,5,7,8,5,22,18,4,29
Krasnodar,2823,6,8,5,7,28,26,2,29
Din Moscow,2823,7,7,6,7,20,22,-2,27
FK Rubin,2823,8,5,6,9,21,18,3,21
Rostov,2823,9,4,6,10,10,20,-10,18
Amkar,2823,10,4,5,11,11,26,-15,17
Anzhi,2823,11,2,5,13,16,42,-26,11
Loko Moscow,2824,1,11,6,3,29,12,17,39
Spart Moscow,2824,2,9,7,4,39,27,12,34
CSKA Moscow,2824,3,10,4,6,25,18,7,34
Krasnodar,2824,4,10,4,6,29,24,5,34
Zenit,2824,5,7,10,3,21,13,8,31
Terek Grozny,2824,6,8,6,6,23,24,-1,30
Din Moscow,2824,7,6,6,8,18,25,-7,24
FK Rubin,2824,8,5,5,10,21,19,2,20
Rostov,2824,9,4,7,9,11,18,-7,19
Amkar,2824,10,4,5,11,11,25,-14,17
Anzhi,2824,11,3,6,11,16,38,-22,15
Loko Moscow,2825,1,11,5,4,29,13,16,38
Spart Moscow,2825,2,10,6,4,39,26,13,36
CSKA Moscow,2825,3,10,5,5,26,18,8,35
Zenit,2825,4,8,9,3,22,13,9,33
Krasnodar,2825,5,9,4,7,29,27,2,31
Terek Grozny,2825,6,8,6,6,22,23,-1,30
Din Moscow,2825,7,6,6,8,20,25,-5,24
FK Rubin,2825,8,6,5,9,24,21,3,23
Rostov,2825,9,4,6,10,10,18,-8,18
Amkar,2825,10,4,5,11,10,24,-14,17
Anzhi,2825,11,2,7,11,16,39,-23,13
Loko Moscow,2826,1,11,6,3,30,13,17,39
CSKA Moscow,2826,2,11,3,6,27,19,8,36
Zenit,2826,3,9,8,3,23,13,10,35
Spart Moscow,2826,4,9,7,4,40,27,13,34
Krasnodar,2826,5,8,5,7,31,29,2,29
Terek Grozny,2826,6,7,7,6,22,24,-2,28
Din Moscow,2826,7,6,7,7,21,23,-2,25
FK Rubin,2826,8,6,5,9,26,23,3,23
Rostov,2826,9,4,6,10,10,22,-12,18
Amkar,2826,10,4,6,10,11,24,-13,18
Anzhi,2826,11,2,6,12,16,40,-24,12
Loko Moscow,2827,1,11,6,3,32,15,17,39
CSKA Moscow,2827,2,11,3,6,28,19,9,36
Zenit,2827,3,9,8,3,25,15,10,35
Spart Moscow,2827,4,8,5,7,38,33,5,29
Krasnodar,2827,5,8,5,7,29,28,1,29
Terek Grozny,2827,6,7,6,7,21,25,-4,27
Din Moscow,2827,7,6,7,7,19,22,-3,25
FK Rubin,2827,8,6,6,8,23,17,6,24
Rostov,2827,9,5,6,9,13,19,-6,21
Amkar,2827,10,5,5,10,13,25,-12,20
Anzhi,2827,11,3,5,12,16,39,-23,14
Loko Moscow,2828,1,11,7,2,32,14,18,40
CSKA Moscow,2828,2,11,4,5,30,19,11,37
Spart Moscow,2828,3,10,5,5,39,29,10,35
Krasnodar,2828,4,9,5,6,29,24,5,32
Zenit,2828,5,7,10,3,25,17,8,31
Terek Grozny,2828,6,7,5,8,23,27,-4,26
Din Moscow,2828,7,6,6,8,21,23,-2,24
Amkar,2828,8,6,4,10,12,23,-11,22
FK Rubin,2828,9,5,5,10,21,22,-1,20
Rostov,2828,10,4,6,10,12,21,-9,18
Anzhi,2828,11,3,5,12,18,43,-25,14
Loko Moscow,2829,1,11,7,2,32,14,18,40
CSKA Moscow,2829,2,11,3,6,31,22,9,36
Spart Moscow,2829,3,9,6,5,37,27,10,33
Zenit,2829,4,8,9,3,25,16,9,33
Terek Grozny,2829,5,8,6,6,23,24,-1,30
Krasnodar,2829,6,8,5,7,29,28,1,29
Din Moscow,2829,7,6,6,8,18,24,-6,24
FK Rubin,2829,8,6,5,9,23,18,5,23
Rostov,2829,9,4,7,9,10,17,-7,19
Amkar,2829,10,5,4,11,12,25,-13,19
Anzhi,2829,11,2,6,12,17,42,-25,12
Loko Moscow,2830,1,11,7,2,30,12,18,40
Spart Moscow,2830,2,10,6,4,40,29,11,36
Zenit,2830,3,8,9,3,23,13,10,33
CSKA Moscow,2830,4,10,3,7,26,21,5,33
Krasnodar,2830,5,9,5,6,30,26,4,32
Terek Grozny,2830,6,8,6,6,22,23,-1,30
Din Moscow,2830,7,5,7,8,18,23,-5,22
FK Rubin,2830,8,5,6,9,22,19,3,21
Rostov,2830,9,4,6,10,11,20,-9,18
Amkar,2830,10,4,5,11,11,25,-14,17
Anzhi,2830,11,3,6,11,17,39,-22,15
Loko Moscow,2831,1,12,6,2,30,11,19,42
Spart Moscow,2831,2,10,6,4,37,25,12,36
CSKA Moscow,2831,3,11,3,6,27,24,3,36
Zenit,2831,4,8,9,3,27,13,14,33
Terek Grozny,2831,5,9,5,6,22,22,0,32
Krasnodar,2831,6,9,4,7,29,25,4,31
FK Rubin,2831,7,6,5,9,24,21,3,23
Din Moscow,2831,8,5,6,9,19,26,-7,21
Rostov,2831,9,4,6,10,10,19,-9,18
Amkar,2831,10,4,5,11,9,23,-14,17
Anzhi,2831,11,2,5,13,15,40,-25,11
Loko Moscow,2832,1,11,6,3,29,12,17,39
CSKA Moscow,2832,2,11,4,5,31,21,10,37
Krasnodar,2832,3,9,5,6,29,25,4,32
Spart Moscow,2832,4,9,5,6,39,36,3,32
Zenit,2832,5,7,10,3,23,15,8,31
Terek Grozny,2832,6,7,6,7,21,24,-3,27
FK Rubin,2832,7,6,6,8,23,18,5,24
Din Moscow,2832,8,6,6,8,20,24,-4,24
Amkar,2832,9,6,4,10,15,22,-7,22
Rostov,2832,10,4,6,10,13,21,-8,18
Anzhi,2832,11,2,6,12,17,42,-25,12
Loko Moscow,2833,1,12,5,3,31,13,18,41
CSKA Moscow,2833,2,11,3,6,26,20,6,36
Zenit,2833,3,9,8,3,25,13,12,35
Spart Moscow,2833,4,9,5,6,37,30,7,32
Krasnodar,2833,5,8,5,7,29,27,2,29
Terek Grozny,2833,6,7,7,6,21,23,-2,28
FK Rubin,2833,7,6,6,8,24,19,5,24
Din Moscow,2833,8,6,6,8,21,24,-3,24
Amkar,2833,9,5,5,10,11,23,-12,20
Rostov,2833,10,4,6,10,10,19,-9,18
Anzhi,2833,11,2,6,12,15,39,-24,12
Loko Moscow,2834,1,12,5,3,30,13,17,41
CSKA Moscow,2834,2,12,3,5,29,17,12,39
Spart Moscow,2834,3,9,7,4,35,26,9,34
Zenit,2834,4,8,8,4,23,14,9,32
Krasnodar,2834,5,8,5,7,28,26,2,29
Terek Grozny,2834,6,8,5,7,23,23,0,29
FK Rubin,2834,7,5,7,8,22,18,4,22
Din Moscow,2834,8,5,7,8,18,23,-5,22
Rostov,2834,9,4,7,9,10,17,-7,19
Amkar,2834,10,4,5,11,9,25,-16,17
Anzhi,2834,11,3,5,12,15,40,-25,14
Loko Moscow,2835,1,13,5,2,31,11,20,44
CSKA Moscow,2835,2,11,4,5,27,18,9,37
Spart Moscow,2835,3,10,5,5,36,28,8,35
Terek Grozny,2835,4,9,5,6,23,22,1,32
Zenit,2835,5,7,9,4,21,14,7,30
Krasnodar,2835,6,8,4,8,28,27,1,28
Din Moscow,2835,7,6,6,8,21,22,-1,24
FK Rubin,2835,8,6,5,9,23,22,1,23
Rostov,2835,9,5,6,9,12,17,-5,21
Amkar,2835,10,4,4,12,10,25,-15,16
Anzhi,2835,11,2,5,13,15,41,-26,11
Loko Moscow,2836,1,12,6,2,30,11,19,42
CSKA Moscow,2836,2,11,3,6,26,18,8,36
Spart Moscow,2836,3,8,7,5,38,31,7,31
Krasnodar,2836,4,8,6,6,30,27,3,30
Zenit,2836,5,7,8,5,21,15,6,29
Terek Grozny,2836,6,8,5,7,21,23,-2,29
FK Rubin,2836,7,6,6,8,26,21,5,24
Din Moscow,2836,8,6,6,8,20,24,-4,24
Amkar,2836,9,5,5,10,11,23,-12,20
Rostov,2836,10,4,7,9,13,20,-7,19
Anzhi,2836,11,3,5,12,15,38,-23,14
Loko Moscow,2837,1,11,5,4,29,13,16,38
CSKA Moscow,2837,2,11,3,6,28,18,10,36
Zenit,2837,3,9,8,3,23,13,10,35
Spart Moscow,2837,4,10,5,5,36,27,9,35
Krasnodar,2837,5,10,4,6,31,26,5,34
Terek Grozny,2837,6,8,5,7,23,25,-2,29
Din Moscow,2837,7,6,6,8,18,22,-4,24
Amkar,2837,8,6,4,10,13,23,-10,22
FK Rubin,2837,9,5,5,10,23,21,2,20
Rostov,2837,10,4,6,10,10,19,-9,18
Anzhi,2837,11,2,5,13,15,42,-27,11
Loko Moscow,2838,1,11,6,3,29,13,16,39
CSKA Moscow,2838,2,11,4,5,27,18,9,37
Spart Moscow,2838,3,10,5,5,36,28,8,35
Zenit,2838,4,8,8,4,23,14,9,32
Krasnodar,2838,5,8,6,6,29,26,3,30
Terek Grozny,2838,6,8,5,7,23,24,-1,29
Din Moscow,2838,7,7,6,7,20,21,-1,27
FK Rubin,2838,8,5,6,9,23,20,3,21
Amkar,2838,9,5,4,11,11,24,-13,19
Rostov,2838,10,4,6,10,11,19,-8,18
Anzhi,2838,11,2,6,12,15,40,-25,12
Loko Moscow,2839,1,12,5,3,33,13,20,41
Spart Moscow,2839,2,10,6,4,35,25,10,36
CSKA Moscow,2839,3,10,5,5,28,20,8,35
Krasnodar,2839,4,10,4,6,31,25,6,34
Zenit,2839,5,7,9,4,24,19,5,30
Terek Grozny,2839,6,8,6,6,22,23,-1,30
Din Moscow,2839,7,5,8,7,19,23,-4,23
FK Rubin,2839,8,5,6,9,24,22,2,21
Rostov,2839,9,4,6,10,10,18,-8,18
Amkar,2839,10,4,4,12,10,25,-15,16
Anzhi,2839,11,2,7,11,15,38,-23,13
Loko Moscow,2840,1,12,6,2,30,11,19,42
CSKA Moscow,2840,2,12,3,5,30,19,11,39
Spart Moscow,2840,3,10,6,4,39,26,13,36
Krasnodar,2840,4,8,6,6,28,25,3,30
Terek Grozny,2840,5,8,6,6,21,22,-1,30
Zenit,2840,6,7,8,5,21,16,5,29
Din Moscow,2840,7,6,6,8,19,24,-5,24
FK Rubin,2840,8,5,6,9,23,20,3,21
Rostov,2840,9,4,6,10,10,20,-10,18
Amkar,2840,10,4,6,10,10,23,-13,18
Anzhi,2840,11,2,5,13,16,41,-25,11
Loko Moscow,2841,1,12,5,3,34,14,20,41
Spart Moscow,2841,2,10,6,4,38,25,13,36
CSKA Moscow,2841,3,10,5,5,31,23,8,35
Zenit,2841,4,8,9,3,25,16,9,33
Krasnodar,2841,5,8,5,7,28,28,0,29
Terek Grozny,2841,6,7,5,8,21,28,-7,26
FK Rubin,2841,7,6,6,8,22,17,5,24
Din Moscow,2841,8,5,6,9,17,24,-7,21
Amkar,2841,9,5,5,10,12,22,-10,20
Rostov,2841,10,4,6,10,10,20,-10,18
Anzhi,2841,11,3,6,11,21,42,-21,15
Loko Moscow,2842,1,11,5,4,29,14,15,38
CSKA Moscow,2842,2,11,4,5,27,17,10,37
Zenit,2842,3,8,9,3,23,13,10,33
Spart Moscow,2842,4,9,6,5,38,29,9,33
Krasnodar,2842,5,9,5,6,28,24,4,32
Terek Grozny,2842,6,7,5,8,20,25,-5,26
FK Rubin,2842,7,5,7,8,21,17,4,22
Din Moscow,2842,8,5,7,8,17,24,-7,22
Amkar,2842,9,6,4,10,15,24,-9,22
Rostov,2842,10,4,7,9,10,17,-7,19
Anzhi,2842,11,3,5,12,15,39,-24,14
Loko Moscow,2843,1,12,5,3,31,15,16,41
CSKA Moscow,2843,2,11,4,5,30,19,11,37
Spart Moscow,2843,3,10,6,4,36,26,10,36
Krasnodar,2843,4,9,5,6,33,27,6,32
Zenit,2843,5,7,9,4,22,15,7,30
Terek Grozny,2843,6,7,7,6,21,23,-2,28
FK Rubin,2843,7,6,6,8,24,19,5,24
Din Moscow,2843,8,5,6,9,18,24,-6,21
Rostov,2843,9,4,6,10,10,18,-8,18
Amkar,2843,10,4,6,10,9,22,-13,18
Anzhi,2843,11,2,6,12,16,42,-26,12
Loko Moscow,2844,1,11,6,3,32,15,17,39
CSKA Moscow,2844,2,11,3,6,28,19,9,36
Zenit,2844,3,8,9,3,25,16,9,33
Spart Moscow,2844,4,9,5,6,36,32,4,32
Krasnodar,2844,5,9,4,7,29,26,3,31
Din Moscow,2844,6,7,6,7,22,22,0,27
Terek Grozny,2844,7,7,6,7,21,25,-4,27
FK Rubin,2844,8,6,5,9,22,19,3,23
Amkar,2844,9,6,4,10,15,23,-8,22
Rostov,2844,10,4,6,10,11,19,-8,18
Anzhi,2844,11,2,6,12,14,39,-25,12
Loko Moscow,2845,1,12,6,2,33,12,21,42
CSKA Moscow,2845,2,10,5,5,26,18,8,35
Zenit,2845,3,7,10,3,23,15,8,31
Krasnodar,2845,4,9,4,7,31,29,2,31
Spart Moscow,2845,5,8,6,6,34,29,5,30
Terek Grozny,2845,6,8,6,6,22,22,0,30
Din Moscow,2845,7,6,6,8,19,24,-5,24
FK Rubin,2845,8,6,5,9,25,21,4,23
Rostov,2845,9,5,6,9,12,17,-5,21
Amkar,2845,10,4,6,10,9,22,-13,18
Anzhi,2845,11,2,6,12,14,39,-25,12
Loko Moscow,2846,1,12,6,2,31,11,20,42
CSKA Moscow,2846,2,11,3,6,27,19,8,36
Spart Moscow,2846,3,9,7,4,39,30,9,34
Zenit,2846,4,8,8,4,23,15,8,32
Krasnodar,2846,5,9,5,6,29,24,5,32
Terek Grozny,2846,6,9,5,6,25,24,1,32
Din Moscow,2846,7,6,7,7,20,23,-3,25
FK Rubin,2846,8,5,5,10,21,20,1,20
Rostov,2846,9,4,6,10,12,20,-8,18
Amkar,2846,10,4,5,11,11,25,-14,17
Anzhi,2846,11,2,5,13,15,42,-27,11
Loko Moscow,2847,1,12,5,3,30,12,18,41
CSKA Moscow,2847,2,11,3,6,31,19,12,36
Krasnodar,2847,3,10,4,6,32,26,6,34
Zenit,2847,4,8,8,4,23,15,8,32
Spart Moscow,2847,5,8,7,5,35,28,7,31
Terek Grozny,2847,6,8,6,6,22,22,0,30
FK Rubin,2847,7,6,5,9,24,21,3,23
Din Moscow,2847,8,5,7,8,18,23,-5,22
Amkar,2847,9,5,5,10,11,23,-12,20
Rostov,2847,10,4,7,9,10,17,-7,19
Anzhi,2847,11,2,5,13,14,44,-30,11
Loko Moscow,2848,1,11,6,3,30,13,17,39
Spart Moscow,2848,2,10,6,4,38,27,11,36
CSKA Moscow,2848,3,10,5,5,26,18,8,35
Krasnodar,2848,4,9,5,6,29,25,4,32
Zenit,2848,5,7,10,3,22,14,8,31
Terek Grozny,2848,6,8,5,7,26,24,2,29
Din Moscow,2848,7,6,7,7,19,22,-3,25
FK Rubin,2848,8,5,6,9,22,19,3,21
Amkar,2848,9,5,4,11,11,25,-14,19
Rostov,2848,10,4,6,10,11,19,-8,18
Anzhi,2848,11,2,6,12,15,43,-28,12
Loko Moscow,2849,1,13,5,2,35,14,21,44
Spart Moscow,2849,2,10,5,5,38,28,10,35
CSKA Moscow,2849,3,10,3,7,25,19,6,33
Zenit,2849,4,8,8,4,23,16,7,32
Krasnodar,2849,5,9,4,7,33,28,5,31
Terek Grozny,2849,6,8,5,7,22,23,-1,29
Din Moscow,2849,7,7,6,7,21,22,-1,27
FK Rubin,2849,8,5,5,10,22,23,-1,20
Rostov,2849,9,4,6,10,11,19,-8,18
Anzhi,2849,10,4,5,11,16,37,-21,17
Amkar,2849,11,4,4,12,9,26,-17,16
Loko Moscow,2850,1,11,5,4,29,13,16,38
CSKA Moscow,2850,2,11,3,6,28,20,8,36
Zenit,2850,3,9,8,3,24,13,11,35
Spart Moscow,2850,4,10,5,5,37,27,10,35
Krasnodar,2850,5,9,5,6,32,28,4,32
Terek Grozny,2850,6,7,7,6,23,25,-2,28
Din Moscow,2850,7,7,6,7,22,21,1,27
FK Rubin,2850,8,5,6,9,25,24,1,21
Rostov,2850,9,4,6,10,10,18,-8,18
Amkar,2850,10,4,5,11,10,26,-16,17
Anzhi,2850,11,2,6,12,17,42,-25,12
Loko Moscow,2851,1,12,5,3,33,14,19,41
CSKA Moscow,2851,2,11,3,6,29,20,9,36
Krasnodar,2851,3,10,4,6,33,26,7,34
Spart Moscow,2851,4,9,6,5,37,28,9,33
Zenit,2851,5,8,8,4,23,17,6,32
Terek Grozny,2851,6,7,7,6,21,23,-2,28
Din Moscow,2851,7,6,6,8,20,25,-5,24
FK Rubin,2851,8,5,5,10,23,22,1,20
Amkar,2851,9,5,5,10,10,22,-12,20
Rostov,2851,10,4,7,9,11,18,-7,19
Anzhi,2851,11,2,6,12,16,41,-25,12
Loko Moscow,2852,1,13,5,2,34,12,22,44
Spart Moscow,2852,2,11,5,4,39,26,13,38
CSKA Moscow,2852,3,11,3,6,28,19,9,36
Zenit,2852,4,8,8,4,23,15,8,32
Krasnodar,2852,5,8,4,8,28,30,-2,28
Terek Grozny,2852,6,7,5,8,22,27,-5,26
Din Moscow,2852,7,6,6,8,21,25,-4,24
FK Rubin,2852,8,6,5,9,25,20,5,23
Amkar,2852,9,5,4,11,10,24,-14,19
Rostov,2852,10,4,6,10,10,19,-9,18
Anzhi,2852,11,3,5,12,18,41,-23,14
Loko Moscow,2853,1,11,6,3,32,15,17,39
CSKA Moscow,2853,2,11,4,5,28,18,10,37
Krasnodar,2853,3,10,4,6,30,25,5,34
Zenit,2853,4,7,9,4,23,17,6,30
Spart Moscow,2853,5,8,6,6,35,30,5,30
Terek Grozny,2853,6,8,5,7,21,23,-2,29
Din Moscow,2853,7,7,6,7,22,22,0,27
Rostov,2853,8,5,6,9,12,18,-6,21
FK Rubin,2853,9,5,5,10,21,20,1,20
Amkar,2853,10,4,5,11,9,23,-14,17
Anzhi,2853,11,3,6,11,16,38,-22,15
Loko Moscow,2854,1,12,6,2,32,11,21,42
Spart Moscow,2854,2,11,5,4,40,29,11,38
CSKA Moscow,2854,3,11,4,5,29,19,10,37
Krasnodar,2854,4,9,4,7,28,27,1,31
Zenit,2854,5,7,9,4,22,16,6,30
Terek Grozny,2854,6,7,6,7,24,27,-3,27
Din Moscow,2854,7,5,7,8,21,26,-5,22
FK Rubin,2854,8,5,6,9,22,19,3,21
Amkar,2854,9,5,4,11,12,25,-13,19
Rostov,2854,10,4,6,10,11,19,-8,18
Anzhi,2854,11,2,7,11,17,40,-23,13
CSKA Moscow,2855,1,12,3,5,29,17,12,39
Loko Moscow,2855,2,11,5,4,31,16,15,38
Spart Moscow,2855,3,10,6,4,38,26,12,36
Zenit,2855,4,8,8,4,25,16,9,32
Krasnodar,2855,5,9,5,6,29,25,4,32
Terek Grozny,2855,6,8,5,7,23,24,-1,29
Din Moscow,2855,7,6,6,8,22,25,-3,24
FK Rubin,2855,8,5,6,9,23,22,1,21
Rostov,2855,9,4,7,9,10,17,-7,19
Amkar,2855,10,4,4,12,9,27,-18,16
Anzhi,2855,11,3,5,12,16,40,-24,14
Loko Moscow,2856,1,12,5,3,31,12,19,41
CSKA Moscow,2856,2,11,3,6,28,19,9,36
Zenit,2856,3,9,8,3,24,13,11,35
Spart Moscow,2856,4,8,7,5,37,30,7,31
Terek Grozny,2856,5,8,6,6,24,24,0,30
Krasnodar,2856,6,8,5,7,28,27,1,29
Din Moscow,2856,7,5,8,7,20,24,-4,23
FK Rubin,2856,8,5,7,8,23,19,4,22
Rostov,2856,9,5,6,9,12,18,-6,21
Amkar,2856,10,4,5,11,12,27,-15,17
Anzhi,2856,11,2,6,12,14,40,-26,12
Loko Moscow,2857,1,12,6,2,32,13,19,42
Spart Moscow,2857,2,11,5,4,40,28,12,38
CSKA Moscow,2857,3,11,3,6,30,20,10,36
Zenit,2857,4,8,9,3,26,17,9,33
Krasnodar,2857,5,9,4,7,28,25,3,31
Terek Grozny,2857,6,7,7,6,21,23,-2,28
Din Moscow,2857,7,5,7,8,18,23,-5,22
FK Rubin,2857,8,5,6,9,21,18,3,21
Rostov,2857,9,4,6,10,11,20,-9,18
Amkar,2857,10,4,5,11,11,25,-14,17
Anzhi,2857,11,2,6,12,14,40,-26,12
Loko Moscow,2858,1,11,6,3,29,13,16,39
Krasnodar,2858,2,10,4,6,31,24,7,34
CSKA Moscow,2858,3,10,4,6,29,22,7,34
Terek Grozny,2858,4,9,5,6,24,23,1,32
Zenit,2858,5,7,10,3,23,15,8,31
Spart Moscow,2858,6,8,6,6,36,30,6,30
Din Moscow,2858,7,6,7,7,19,22,-3,25
FK Rubin,2858,8,5,6,9,21,19,2,21
Rostov,2858,9,5,6,9,13,19,-6,21
Amkar,2858,10,4,5,11,9,23,-14,17
Anzhi,2858,11,3,5,12,18,42,-24,14
Loko Moscow,2859,1,12,6,2,34,13,21,42
CSKA Moscow,2859,2,11,3,6,29,21,8,36
Spart Moscow,2859,3,10,5,5,37,27,10,35
Zenit,2859,4,8,8,4,24,18,6,32
Krasnodar,2859,5,8,5,7,29,27,2,29
Terek Grozny,2859,6,8,5,7,22,25,-3,29
FK Rubin,2859,7,7,5,8,24,18,6,26
Din Moscow,2859,8,5,6,9,17,23,-6,21
Rostov,2859,9,5,6,9,11,17,-6,21
Amkar,2859,10,4,4,12,10,26,-16,16
Anzhi,2859,11,3,5,12,19,41,-22,14
Loko Moscow,2860,1,11,6,3,29,13,16,39
CSKA Moscow,2860,2,11,3,6,30,22,8,36
Spart Moscow,2860,3,10,5,5,41,28,13,35
Zenit,2860,4,9,8,3,27,15,12,35
Krasnodar,2860,5,9,5,6,29,25,4,32
Terek Grozny,2860,6,7,6,7,21,24,-3,27
FK Rubin,2860,7,6,5,9,24,19,5,23
Rostov,2860,8,5,6,9,12,18,-6,21
Din Moscow,2860,9,5,6,9,17,27,-10,21
Amkar,2860,10,4,5,11,11,26,-15,17
Anzhi,2860,11,3,5,12,16,40,-24,14
Loko Moscow,2861,1,13,5,2,35,11,24,44
CSKA Moscow,2861,2,12,3,5,30,17,13,39
Spart Moscow,2861,3,10,6,4,42,29,13,36
Zenit,2861,4,7,8,5,21,20,1,29
Krasnodar,2861,5,8,4,8,28,27,1,28
Terek Grozny,2861,6,7,5,8,22,27,-5,26
FK Rubin,2861,7,6,6,8,23,18,5,24
Din Moscow,2861,8,5,7,8,17,25,-8,22
Amkar,2861,9,5,5,10,13,24,-11,20
Rostov,2861,10,4,6,10,12,20,-8,18
Anzhi,2861,11,3,5,12,17,42,-25,14
Loko Moscow,2862,1,11,6,3,31,14,17,39
CSKA Moscow,2862,2,11,4,5,30,19,11,37
Spart Moscow,2862,3,9,7,4,37,27,10,34
Zenit,2862,4,8,8,4,23,17,6,32
Terek Grozny,2862,5,9,5,6,24,22,2,32
Krasnodar,2862,6,8,5,7,28,27,1,29
FK Rubin,2862,7,7,5,8,24,17,7,26
Din Moscow,2862,8,5,6,9,18,25,-7,21
Rostov,2862,9,4,7,9,11,18,-7,19
Amkar,2862,10,4,5,11,9,25,-16,17
Anzhi,2862,11,2,6,12,16,40,-24,12
Loko Moscow,2863,1,12,6,2,32,13,19,42
CSKA Moscow,2863,2,11,3,6,27,19,8,36
Spart Moscow,2863,3,9,6,5,37,28,9,33
Zenit,2863,4,8,8,4,22,14,8,32
Krasnodar,2863,5,8,5,7,30,28,2,29
Din Moscow,2863,6,7,6,7,22,23,-1,27
Terek Grozny,2863,7,7,6,7,21,24,-3,27
FK Rubin,2863,8,6,5,9,24,20,4,23
Amkar,2863,9,5,5,10,11,23,-12,20
Rostov,2863,10,4,6,10,10,20,-10,18
Anzhi,2863,11,2,6,12,15,39,-24,12
Loko Moscow,2864,1,13,5,2,31,11,20,44
CSKA Moscow,2864,2,11,4,5,27,18,9,37
Spart Moscow,2864,3,9,6,5,39,30,9,33
Krasnodar,2864,4,9,4,7,30,25,5,31
Zenit,2864,5,7,8,5,21,15,6,29
Terek Grozny,2864,6,8,5,7,22,24,-2,29
Din Moscow,2864,7,5,7,8,19,26,-7,22
FK Rubin,2864,8,5,6,9,22,21,1,21
Rostov,2864,9,5,6,9,13,18,-5,21
Amkar,2864,10,5,5,10,12,24,-12,20
Anzhi,2864,11,2,6,12,15,39,-24,12
Loko Moscow,2865,1,12,5,3,30,13,17,41
CSKA Moscow,2865,2,10,5,5,27,19,8,35
Krasnodar,2865,3,9,5,6,30,25,5,32
Spart Moscow,2865,4,8,7,5,35,28,7,31
Zenit,2865,5,7,9,4,22,15,7,30
Terek Grozny,2865,6,7,7,6,22,24,-2,28
Din Moscow,2865,7,6,7,7,20,22,-2,25
FK Rubin,2865,8,5,6,9,22,20,2,21
Amkar,2865,9,5,5,10,11,23,-12,20
Rostov,2865,10,4,7,9,11,18,-7,19
Anzhi,2865,11,2,7,11,16,39,-23,13
Loko Moscow,2866,1,11,5,4,30,15,15,38
Spart Moscow,2866,2,11,5,4,38,27,11,38
CSKA Moscow,2866,3,11,3,6,26,18,8,36
Zenit,2866,4,9,8,3,24,14,10,35
Krasnodar,2866,5,10,4,6,31,24,7,34
Terek Grozny,2866,6,8,5,7,23,25,-2,29
FK Rubin,2866,7,6,5,9,23,20,3,23
Din Moscow,2866,8,5,6,9,19,25,-6,21
Rostov,2866,9,4,6,10,11,19,-8,18
Amkar,2866,10,4,4,12,11,26,-15,16
Anzhi,2866,11,3,5,12,15,38,-23,14
Loko Moscow,2867,1,12,6,2,30,11,19,42
Spart Moscow,2867,2,11,5,4,39,27,12,38
CSKA Moscow,2867,3,11,3,6,29,19,10,36
Zenit,2867,4,8,8,4,23,14,9,32
Krasnodar,2867,5,8,6,6,28,25,3,30
Terek Grozny,2867,6,8,5,7,23,24,-1,29
FK Rubin,2867,7,6,6,8,23,18,5,24
Din Moscow,2867,8,5,6,9,17,23,-6,21
Amkar,2867,9,5,4,11,13,27,-14,19
Rostov,2867,10,4,6,10,10,18,-8,18
Anzhi,2867,11,2,5,13,14,43,-29,11
Loko Moscow,2868,1,12,6,2,31,12,19,42
CSKA Moscow,2868,2,12,3,5,28,18,10,39
Spart Moscow,2868,3,8,7,5,37,30,7,31
Zenit,2868,4,7,9,4,21,14,7,30
Terek Grozny,2868,5,8,6,6,21,22,-1,30
Krasnodar,2868,6,8,5,7,28,26,2,29
Din Moscow,2868,7,6,7,7,22,25,-3,25
FK Rubin,2868,8,5,6,9,22,19,3,21
Rostov,2868,9,5,6,9,11,17,-6,21
Amkar,2868,10,4,5,11,10,24,-14,17
Anzhi,2868,11,2,6,12,15,39,-24,12
Loko Moscow,2869,1,11,6,3,30,13,17,39
CSKA Moscow,2869,2,11,4,5,30,18,12,37
Spart Moscow,2869,3,10,5,5,38,28,10,35
Zenit,2869,4,8,9,3,24,15,9,33
Krasnodar,2869,5,9,5,6,28,24,4,32
Terek Grozny,2869,6,8,6,6,22,22,0,30
Din Moscow,2869,7,7,6,7,21,21,0,27
FK Rubin,2869,8,5,5,10,21,20,1,20
Rostov,2869,9,4,6,10,10,20,-10,18
Amkar,2869,10,4,4,12,10,26,-16,16
Anzhi,2869,11,2,6,12,14,41,-27,12
Loko Moscow,2870,1,11,6,3,33,16,17,39
CSKA Moscow,2870,2,11,4,5,29,18,11,37
Krasnodar,2870,3,10,4,6,33,27,6,34
Spart Moscow,2870,4,9,6,5,37,29,8,33
Zenit,2870,5,7,10,3,23,15,8,31
Terek Grozny,2870,6,7,6,7,21,25,-4,27
Din Moscow,2870,7,6,7,7,22,23,-1,25
FK Rubin,2870,8,5,5,10,21,22,-1,20
Amkar,2870,9,5,5,10,11,23,-12,20
Rostov,2870,10,4,6,10,11,19,-8,18
Anzhi,2870,11,3,5,12,16,40,-24,14
Loko Moscow,2871,1,12,6,2,31,12,19,42
CSKA Moscow,2871,2,11,3,6,26,19,7,36
Spart Moscow,2871,3,8,8,4,37,29,8,32
Zenit,2871,4,7,8,5,21,15,6,29
Krasnodar,2871,5,8,5,7,29,27,2,29
Terek Grozny,2871,6,8,5,7,22,26,-4,29
FK Rubin,2871,7,6,6,8,25,20,5,24
Din Moscow,2871,8,5,8,7,20,24,-4,23
Rostov,2871,9,4,7,9,11,18,-7,19
Amkar,2871,10,4,5,11,11,25,-14,17
Anzhi,2871,11,4,5,11,20,38,-18,17
Loko Moscow,2872,1,12,5,3,33,14,19,41
CSKA Moscow,2872,2,10,5,5,27,19,8,35
Spart Moscow,2872,3,9,7,4,36,27,9,34
Krasnodar,2872,4,10,4,6,31,25,6,34
Zenit,2872,5,7,9,4,22,16,6,30
Terek Grozny,2872,6,8,5,7,21,25,-4,29
Din Moscow,2872,7,6,7,7,20,22,-2,25
FK Rubin,2872,8,5,5,10,21,21,0,20
Rostov,2872,9,4,7,9,11,18,-7,19
Amkar,2872,10,5,4,11,12,23,-11,19
Anzhi,2872,11,2,6,12,16,40,-24,12
Loko Moscow,2873,1,11,6,3,32,16,16,39
CSKA Moscow,2873,2,11,4,5,27,18,9,37
Spart Moscow,2873,3,10,6,4,38,28,10,36
Zenit,2873,4,7,10,3,24,16,8,31
Krasnodar,2873,5,9,4,7,29,26,3,31
Terek Grozny,2873,6,7,5,8,20,24,-4,26
Din Moscow,2873,7,6,6,8,18,22,-4,24
FK Rubin,2873,8,6,5,9,23,18,5,23
Rostov,2873,9,4,7,9,12,19,-7,19
Amkar,2873,10,5,4,11,11,24,-13,19
Anzhi,2873,11,3,5,12,16,39,-23,14
Loko Moscow,2874,1,11,7,2,30,12,18,40
CSKA Moscow,2874,2,12,3,5,27,17,10,39
Spart Moscow,2874,3,9,6,5,35,27,8,33
Zenit,2874,4,7,9,4,21,14,7,30
Krasnodar,2874,5,8,5,7,29,29,0,29
FK Rubin,2874,6,7,5,8,27,19,8,26
Terek Grozny,2874,7,7,5,8,21,25,-4,26
Din Moscow,2874,8,5,7,8,18,23,-5,22
Rostov,2874,9,5,6,9,12,17,-5,21
Amkar,2874,10,5,4,11,11,25,-14,19
Anzhi,2874,11,3,5,12,15,38,-23,14
Loko Moscow,2875,1,11,6,3,30,13,17,39
CSKA Moscow,2875,2,12,3,5,29,17,12,39
Spart Moscow,2875,3,10,6,4,39,26,13,36
Krasnodar,2875,4,9,4,7,29,27,2,31
Zenit,2875,5,7,9,4,22,15,7,30
Terek Grozny,2875,6,8,6,6,22,23,-1,30
FK Rubin,2875,7,7,5,8,27,20,7,26
Din Moscow,2875,8,5,7,8,20,25,-5,22
Rostov,2875,9,4,6,10,10,21,-11,18
Amkar,2875,10,4,4,12,9,24,-15,16
Anzhi,2875,11,2,6,12,15,41,-26,12
Loko Moscow,2876,1,13,5,2,33,12,21,44
CSKA Moscow,2876,2,12,3,5,30,19,11,39
Terek Grozny,2876,3,9,5,6,23,22,1,32
Spart Moscow,2876,4,8,7,5,36,30,6,31
Zenit,2876,5,7,8,5,22,17,5,29
Krasnodar,2876,6,8,4,8,28,27,1,28
Din Moscow,2876,7,6,7,7,21,24,-3,25
FK Rubin,2876,8,6,5,9,24,20,4,23
Rostov,2876,9,5,6,9,12,17,-5,21
Amkar,2876,10,4,5,11,10,24,-14,17
Anzhi,2876,11,2,5,13,16,43,-27,11
Loko Moscow,2877,1,12,5,3,31,12,19,41
CSKA Moscow,2877,2,11,4,5,28,19,9,37
Spart Moscow,2877,3,9,6,5,36,29,7,33
Zenit,2877,4,8,8,4,22,14,8,32
Krasnodar,2877,5,9,4,7,28,26,2,31
Terek Grozny,2877,6,8,5,7,21,23,-2,29
Din Moscow,2877,7,7,6,7,21,22,-1,27
FK Rubin,2877,8,5,5,10,22,20,2,20
Rostov,2877,9,4,7,9,10,17,-7,19
Amkar,2877,10,5,4,11,12,25,-13,19
Anzhi,2877,11,2,6,12,16,40,-24,12
Loko Moscow,2878,1,11,7,2,29,11,18,40
CSKA Moscow,2878,2,12,3,5,31,18,13,39
Spart Moscow,2878,3,10,5,5,36,29,7,35
Krasnodar,2878,4,9,5,6,29,25,4,32
Terek Grozny,2878,5,9,5,6,24,24,0,32
Zenit,2878,6,7,9,4,22,15,7,30
Din Moscow,2878,7,6,6,8,20,24,-4,24
Rostov,2878,8,5,6,9,13,17,-4,21
FK Rubin,2878,9,5,5,10,23,21,2,20
Amkar,2878,10,4,4,12,10,25,-15,16
Anzhi,2878,11,2,5,13,15,43,-28,11
Loko Moscow,2879,1,13,5,2,38,14,24,44
CSKA Moscow,2879,2,12,3,5,36,20,16,39
Spart Moscow,2879,3,9,6,5,37,28,9,33
Zenit,2879,4,7,8,5,23,20,3,29
Krasnodar,2879,5,8,4,8,29,32,-3,28
Terek Grozny,2879,6,7,5,8,20,26,-6,26
FK Rubin,2879,7,6,6,8,24,19,5,24
Din Moscow,2879,8,5,7,8,19,25,-6,22
Amkar,2879,9,6,4,10,12,22,-10,22
Rostov,2879,10,4,7,9,11,18,-7,19
Anzhi,2879,11,3,5,12,19,44,-25,14
Loko Moscow,2880,1,12,6,2,31,12,19,42
Spart Moscow,2880,2,10,5,5,39,28,11,35
CSKA Moscow,2880,3,10,3,7,26,20,6,33
Zenit,2880,4,8,8,4,24,16,8,32
Krasnodar,2880,5,8,6,6,27,24,3,30
Terek Grozny,2880,6,8,6,6,23,24,-1,30
Din Moscow,2880,7,6,6,8,18,22,-4,24
FK Rubin,2880,8,5,6,9,21,18,3,21
Amkar,2880,9,5,4,11,11,24,-13,19
Rostov,2880,10,4,6,10,12,22,-10,18
Anzhi,2880,11,3,6,11,16,38,-22,15
Loko Moscow,2881,1,11,6,3,34,17,17,39
CSKA Moscow,2881,2,11,3,6,26,18,8,36
Zenit,2881,3,9,8,3,24,14,10,35
Spart Moscow,2881,4,10,5,5,35,26,9,35
Krasnodar,2881,5,9,5,6,35,29,6,32
Terek Grozny,2881,6,7,6,7,22,26,-4,27
Din Moscow,2881,7,5,7,8,19,24,-5,22
FK Rubin,2881,8,5,6,9,24,23,1,21
Rostov,2881,9,5,6,9,11,17,-6,21
Amkar,2881,10,4,5,11,11,25,-14,17
Anzhi,2881,11,3,5,12,16,38,-22,14
Loko Moscow,2882,1,11,6,3,30,13,17,39
Spart Moscow,2882,2,10,5,5,38,30,8,35
Krasnodar,2882,3,10,4,6,31,25,6,34
CSKA Moscow,2882,4,10,4,6,27,21,6,34
Zenit,2882,5,8,9,3,23,13,10,33
Terek Grozny,2882,6,8,6,6,22,23,-1,30
Din Moscow,2882,7,7,6,7,22,22,0,27
FK Rubin,2882,8,5,5,10,21,20,1,20
Rostov,2882,9,4,6,10,10,18,-8,18
Amkar,2882,10,4,4,12,11,27,-16,16
Anzhi,2882,11,2,7,11,16,39,-23,13
Loko Moscow,2883,1,12,5,3,30,14,16,41
CSKA Moscow,2883,2,11,3,6,27,19,8,36
Zenit,2883,3,9,8,3,25,13,12,35
Spart Moscow,2883,4,10,5,5,39,28,11,35
Krasnodar,2883,5,9,4,7,29,26,3,31
Terek Grozny,2883,6,7,6,7,20,23,-3,27
Din Moscow,2883,7,6,6,8,19,23,-4,24
FK Rubin,2883,8,6,5,9,23,19,4,23
Amkar,2883,9,5,4,11,10,24,-14,19
Rostov,2883,10,4,6,10,11,20,-9,18
Anzhi,2883,11,2,6,12,15,39,-24,12
Loko Moscow,2884,1,12,6,2,33,13,20,42
CSKA Moscow,2884,2,12,3,5,30,18,12,39
Spart Moscow,2884,3,10,5,5,37,27,10,35
Zenit,2884,4,7,8,5,23,18,5,29
Krasnodar,2884,5,8,5,7,28,26,2,29
Terek Grozny,2884,6,7,5,8,21,25,-4,26
Din Moscow,2884,7,6,6,8,18,23,-5,24
FK Rubin,2884,8,6,5,9,22,18,4,23
Amkar,2884,9,6,4,10,13,24,-11,22
Rostov,2884,10,4,6,10,10,18,-8,18
Anzhi,2884,11,3,5,12,15,40,-25,14
Loko Moscow,2885,1,11,7,2,33,15,18,40
Spart Moscow,2885,2,10,5,5,36,27,9,35
CSKA Moscow,2885,3,10,5,5,26,18,8,35
Zenit,2885,4,7,10,3,23,15,8,31
Terek Grozny,2885,5,8,6,6,22,22,0,30
Krasnodar,2885,6,8,5,7,29,27,2,29
Din Moscow,2885,7,6,6,8,19,23,-4,24
FK Rubin,2885,8,6,5,9,22,19,3,23
Amkar,2885,9,5,4,11,11,24,-13,19
Rostov,2885,10,4,6,10,10,18,-8,18
Anzhi,2885,11,2,7,11,15,38,-23,13
Loko Moscow,2886,1,12,5,3,31,14,17,41
CSKA Moscow,2886,2,12,3,5,32,18,14,39
Spart Moscow,2886,3,10,6,4,37,26,11,36
Zenit,2886,4,8,8,4,24,17,7,32
Krasnodar,2886,5,9,4,7,29,27,2,31
Terek Grozny,2886,6,7,5,8,20,25,-5,26
Din Moscow,2886,7,5,7,8,17,22,-5,22
FK Rubin,2886,8,5,6,9,22,19,3,21
Amkar,2886,9,5,5,10,11,23,-12,20
Rostov,2886,10,4,6,10,10,19,-9,18
Anzhi,2886,11,3,5,12,17,40,-23,14
Loko Moscow,2887,1,11,6,3,31,15,16,39
CSKA Moscow,2887,2,11,4,5,28,19,9,37
Spart Moscow,2887,3,9,7,4,39,30,9,34
Krasnodar,2887,4,10,4,6,31,25,6,34
Zenit,2887,5,7,9,4,23,16,7,30
Terek Grozny,2887,6,8,5,7,24,27,-3,29
Din Moscow,2887,7,6,7,7,19,21,-2,25
FK Rubin,2887,8,5,5,10,21,20,1,20
Rostov,2887,9,4,7,9,13,20,-7,19
Amkar,2887,10,4,4,12,11,26,-15,16
Anzhi,2887,11,3,6,11,20,41,-21,15
Loko Moscow,2888,1,11,5,4,29,16,13,38
CSKA Moscow,2888,2,11,4,5,31,21,10,37
Krasnodar,2888,3,10,4,6,34,25,9,34
Zenit,2888,4,8,9,3,26,15,11,33
Spart Moscow,2888,5,9,5,6,38,33,5,32
Terek Grozny,2888,6,8,6,6,22,23,-1,30
Din Moscow,2888,7,6,6,8,19,24,-5,24
Rostov,2888,8,5,6,9,15,18,-3,21
FK Rubin,2888,9,5,5,10,22,23,-1,20
Amkar,2888,10,5,4,11,11,24,-13,19
Anzhi,2888,11,2,6,12,17,42,-25,12
CSKA Moscow,2889,1,12,3,5,34,18,16,39
Loko Moscow,2889,2,11,5,4,30,16,14,38
Spart Moscow,2889,3,9,7,4,37,27,10,34
Zenit,2889,4,8,8,4,24,16,8,32
Krasnodar,2889,5,9,5,6,31,26,5,32
Terek Grozny,2889,6,8,6,6,24,24,0,30
Din Moscow,2889,7,6,7,7,19,22,-3,25
FK Rubin,2889,8,5,6,9,22,19,3,21
Rostov,2889,9,4,6,10,10,19,-9,18
Amkar,2889,10,4,5,11,11,26,-15,17
Anzhi,2889,11,2,6,12,15,44,-29,12
Loko Moscow,2890,1,11,6,3,31,14,17,39
CSKA Moscow,2890,2,10,4,6,27,20,7,34
Krasnodar,2890,3,10,4,6,31,26,5,34
Zenit,2890,4,8,9,3,24,15,9,33
Spart Moscow,2890,5,9,5,6,37,30,7,32
Din Moscow,2890,6,7,6,7,21,22,-1,27
Terek Grozny,2890,7,7,5,8,20,25,-5,26
Amkar,2890,8,6,4,10,13,23,-10,22
FK Rubin,2890,9,5,5,10,22,20,2,20
Rostov,2890,10,4,6,10,10,19,-9,18
Anzhi,2890,11,3,6,11,16,38,-22,15
Loko Moscow,2891,1,12,6,2,30,11,19,42
Spart Moscow,2891,2,10,5,5,41,29,12,35
CSKA Moscow,2891,3,10,4,6,28,21,7,34
Zenit,2891,4,7,9,4,23,16,7,30
Krasnodar,2891,5,8,6,6,28,25,3,30
Terek Grozny,2891,6,8,5,7,22,23,-1,29
FK Rubin,2891,7,5,7,8,22,18,4,22
Din Moscow,2891,8,5,7,8,18,24,-6,22
Amkar,2891,9,6,4,10,13,23,-10,22
Rostov,2891,10,4,6,10,10,21,-11,18
Anzhi,2891,11,3,5,12,16,40,-24,14
Loko Moscow,2892,1,12,6,2,32,12,20,42
CSKA Moscow,2892,2,11,4,5,29,20,9,37
Spart Moscow,2892,3,10,5,5,36,27,9,35
Krasnodar,2892,4,9,4,7,29,27,2,31
Zenit,2892,5,7,9,4,22,15,7,30
Terek Grozny,2892,6,7,5,8,21,25,-4,26
Din Moscow,2892,7,5,7,8,18,23,-5,22
Amkar,2892,8,6,4,10,11,22,-11,22
FK Rubin,2892,9,5,6,9,22,19,3,21
Rostov,2892,10,4,6,10,11,19,-8,18
Anzhi,2892,11,3,6,11,18,40,-22,15
Loko Moscow,2893,1,11,7,2,31,13,18,40
CSKA Moscow,2893,2,12,3,5,30,20,10,39
Spart Moscow,2893,3,9,7,4,38,28,10,34
Zenit,2893,4,7,9,4,24,17,7,30
Krasnodar,2893,5,8,5,7,29,27,2,29
Terek Grozny,2893,6,7,7,6,23,25,-2,28
Din Moscow,2893,7,6,7,7,19,22,-3,25
FK Rubin,2893,8,6,5,9,24,20,4,23
Rostov,2893,9,4,6,10,10,19,-9,18
Amkar,2893,10,4,6,10,13,26,-13,18
Anzhi,2893,11,2,6,12,17,41,-24,12
CSKA Moscow,2894,1,12,3,5,32,18,14,39
Loko Moscow,2894,2,11,5,4,29,13,16,38
Spart Moscow,2894,3,9,6,5,37,29,8,33
Zenit,2894,4,8,8,4,22,15,7,32
Krasnodar,2894,5,9,5,6,28,24,4,32
Terek Grozny,2894,6,7,7,6,21,23,-2,28
Din Moscow,2894,7,6,7,7,20,23,-3,25
FK Rubin,2894,8,5,7,8,21,17,4,22
Rostov,2894,9,4,7,9,11,18,-7,19
Amkar,2894,10,4,5,11,9,23,-14,17
Anzhi,2894,11,2,6,12,16,43,-27,12
CSKA Moscow,2895,1,12,3,5,29,18,11,39
Loko Moscow,2895,2,11,5,4,29,15,14,38
Krasnodar,2895,3,10,4,6,32,25,7,34
Zenit,2895,4,8,8,4,23,15,8,32
Spart Moscow,2895,5,8,7,5,37,31,6,31
Terek Grozny,2895,6,8,5,7,22,23,-1,29
Din Moscow,2895,7,6,7,7,21,23,-2,25
FK Rubin,2895,8,5,6,9,23,20,3,21
Amkar,2895,9,5,5,10,12,24,-12,20
Rostov,2895,10,4,7,9,11,18,-7,19
Anzhi,2895,11,2,5,13,14,41,-27,11
Loko Moscow,2896,1,13,5,2,33,12,21,44
CSKA Moscow,2896,2,11,3,6,29,19,10,36
Spart Moscow,2896,3,9,6,5,38,30,8,33
Zenit,2896,4,8,8,4,24,17,7,32
Krasnodar,2896,5,8,5,7,29,27,2,29
Terek Grozny,2896,6,7,7,6,20,22,-2,28
Din Moscow,2896,7,6,7,7,21,24,-3,25
FK Rubin,2896,8,5,6,9,23,20,3,21
Amkar,2896,9,5,5,10,11,22,-11,20
Rostov,2896,10,4,6,10,10,19,-9,18
Anzhi,2896,11,2,6,12,14,40,-26,12
Loko Moscow,2897,1,13,5,2,32,12,20,44
Spart Moscow,2897,2,10,6,4,37,26,11,36
CSKA Moscow,2897,3,11,3,6,27,19,8,36
Zenit,2897,4,8,8,4,23,15,8,32
Krasnodar,2897,5,9,4,7,29,26,3,31
Terek Grozny,2897,6,8,6,6,22,23,-1,30
Din Moscow,2897,7,6,7,7,19,22,-3,25
FK Rubin,2897,8,5,5,10,22,20,2,20
Rostov,2897,9,4,6,10,10,19,-9,18
Amkar,2897,10,4,4,12,9,24,-15,16
Anzhi,2897,11,2,6,12,16,40,-24,12
Loko Moscow,2898,1,12,6,2,36,15,21,42
Spart Moscow,2898,2,11,5,4,42,28,14,38
CSKA Moscow,2898,3,11,4,5,28,19,9,37
Krasnodar,2898,4,9,5,6,32,27,5,32
Zenit,2898,5,7,8,5,24,20,4,29
Terek Grozny,2898,6,7,7,6,22,24,-2,28
FK Rubin,2898,7,6,5,9,23,20,3,23
Din Moscow,2898,8,5,6,9,19,25,-6,21
Rostov,2898,9,4,6,10,11,22,-11,18
Amkar,2898,10,4,5,11,11,25,-14,17
Anzhi,2898,11,2,7,11,15,38,-23,13
Loko Moscow,2899,1,11,7,2,31,13,18,40
Spart Moscow,2899,2,11,5,4,39,27,12,38
CSKA Moscow,2899,3,11,4,5,29,18,11,37
Zenit,2899,4,7,10,3,22,14,8,31
Krasnodar,2899,5,8,6,6,30,27,3,30
Terek Grozny,2899,6,8,5,7,23,24,-1,29
Din Moscow,2899,7,6,6,8,18,22,-4,24
FK Rubin,2899,8,5,6,9,22,19,3,21
Amkar,2899,9,5,4,11,11,24,-13,19
Rostov,2899,10,4,6,10,11,20,-9,18
Anzhi,2899,11,2,5,13,15,43,-28,11
Loko Moscow,2900,1,12,5,3,32,14,18,41
Spart Moscow,2900,2,10,6,4,39,27,12,36
CSKA Moscow,2900,3,10,4,6,26,20,6,34
Zenit,2900,4,8,8,4,24,15,9,32
Krasnodar,2900,5,9,5,6,31,27,4,32
Terek Grozny,2900,6,8,5,7,22,24,-2,29
Din Moscow,2900,7,6,7,7,21,23,-2,25
FK Rubin,2900,8,5,6,9,23,21,2,21
Rostov,2900,9,4,6,10,10,19,-9,18
Amkar,2900,10,4,4,12,9,25,-16,16
Anzhi,2900,11,3,6,11,17,39,-22,15
CSKA Moscow,2901,1,12,3,5,29,19,10,39
Loko Moscow,2901,2,11,5,4,29,13,16,38
Spart Moscow,2901,3,11,5,4,40,25,15,38
Zenit,2901,4,8,8,4,23,15,8,32
Krasnodar,2901,5,9,5,6,29,25,4,32
Terek Grozny,2901,6,9,5,6,25,24,1,32
FK Rubin,2901,7,5,7,8,23,19,4,22
Din Moscow,2901,8,5,7,8,18,26,-8,22
Rostov,2901,9,4,6,10,10,19,-9,18
Amkar,2901,10,4,4,12,10,25,-15,16
Anzhi,2901,11,2,5,13,16,42,-26,11
Loko Moscow,2902,1,12,5,3,32,14,18,41
CSKA Moscow,2902,2,11,3,6,27,19,8,36
Spart Moscow,2902,3,9,7,4,37,28,9,34
Krasnodar,2902,4,10,4,6,31,25,6,34
Zenit,2902,5,8,8,4,25,17,8,32
Terek Grozny,2902,6,8,5,7,22,23,-1,29
Din Moscow,2902,7,6,6,8,21,25,-4,24
FK Rubin,2902,8,5,5,10,24,23,1,20
Amkar,2902,9,5,5,10,12,24,-12,20
Rostov,2902,10,4,7,9,10,17,-7,19
Anzhi,2902,11,2,5,13,14,40,-26,11
Loko Moscow,2903,1,13,5,2,32,11,21,44
CSKA Moscow,2903,2,11,3,6,27,18,9,36
Spart Moscow,2903,3,10,5,5,39,28,11,35
Zenit,2903,4,8,8,4,22,15,7,32
Krasnodar,2903,5,9,4,7,30,26,4,31
Terek Grozny,2903,6,8,6,6,23,23,0,30
Din Moscow,2903,7,6,6,8,19,22,-3,24
FK Rubin,2903,8,6,5,9,23,20,3,23
Rostov,2903,9,4,6,10,10,18,-8,18
Amkar,2903,10,4,4,12,10,29,-19,16
Anzhi,2903,11,2,6,12,15,40,-25,12
Loko Moscow,2904,1,11,5,4,32,16,16,38
CSKA Moscow,2904,2,11,4,5,27,17,10,37
Spart Moscow,2904,3,9,7,4,37,28,9,34
Krasnodar,2904,4,10,4,6,31,26,5,34
Zenit,2904,5,8,9,3,23,14,9,33
Terek Grozny,2904,6,7,5,8,20,24,-4,26
Din Moscow,2904,7,5,7,8,19,24,-5,22
FK Rubin,2904,8,5,6,9,22,19,3,21
Amkar,2904,9,5,5,10,11,23,-12,20
Rostov,2904,10,4,7,9,11,18,-7,19
Anzhi,2904,11,3,5,12,15,39,-24,14
Loko Moscow,2905,1,11,7,2,29,11,18,40
CSKA Moscow,2905,2,12,3,5,31,17,14,39
Spart Moscow,2905,3,9,6,5,36,28,8,33
Krasnodar,2905,4,9,5,6,29,24,5,32
Terek Grozny,2905,5,9,5,6,24,23,1,32
Zenit,2905,6,7,9,4,21,14,7,30
Din Moscow,2905,7,5,7,8,19,24,-5,22
FK Rubin,2905,8,5,6,9,22,20,2,21
Rostov,2905,9,4,7,9,10,17,-7,19
Amkar,2905,10,5,4,11,11,25,-14,19
Anzhi,2905,11,2,5,13,15,44,-29,11
Loko Moscow,2906,1,12,5,3,30,14,16,41
CSKA Moscow,2906,2,11,3,6,30,21,9,36
Krasnodar,2906,3,10,4,6,31,24,7,34
Zenit,2906,4,8,8,4,24,14,10,32
Spart Moscow,2906,5,9,5,6,36,30,6,32
Terek Grozny,2906,6,7,7,6,22,24,-2,28
Din Moscow,2906,7,6,6,8,18,22,-4,24
Rostov,2906,8,5,6,9,13,19,-6,21
FK Rubin,2906,9,5,5,10,21,19,2,20
Amkar,2906,10,5,5,10,12,23,-11,20
Anzhi,2906,11,2,6,12,16,43,-27,12
Loko Moscow,2907,1,11,6,3,29,13,16,39
Spart Moscow,2907,2,11,5,4,43,26,17,38
CSKA Moscow,2907,3,11,4,5,27,18,9,37
Krasnodar,2907,4,10,4,6,31,25,6,34
Terek Grozny,2907,5,9,5,6,25,23,2,32
Zenit,2907,6,7,10,3,22,14,8,31
FK Rubin,2907,7,6,5,9,24,20,4,23
Din Moscow,2907,8,5,6,9,18,28,-10,21
Rostov,2907,9,4,6,10,10,20,-10,18
Amkar,2907,10,4,4,12,10,27,-17,16
Anzhi,2907,11,2,5,13,15,40,-25,11
Loko Moscow,2908,1,12,5,3,32,14,18,41
Spart Moscow,2908,2,10,6,4,39,26,13,36
Zenit,2908,3,9,8,3,25,15,10,35
CSKA Moscow,2908,4,10,3,7,26,22,4,33
Krasnodar,2908,5,9,4,7,30,26,4,31
Terek Grozny,2908,6,8,6,6,24,23,1,30
Din Moscow,2908,7,6,6,8,18,25,-7,24
FK Rubin,2908,8,5,5,10,21,20,1,20
Rostov,2908,9,4,7,9,11,18,-7,19
Amkar,2908,10,4,4,12,9,26,-17,16
Anzhi,2908,11,3,6,11,18,38,-20,15
Loko Moscow,2909,1,12,5,3,31,14,17,41
Krasnodar,2909,2,10,4,6,33,24,9,34
CSKA Moscow,2909,3,10,4,6,26,21,5,34
Spart Moscow,2909,4,9,5,6,38,29,9,32
Zenit,2909,5,7,9,4,23,16,7,30
Terek Grozny,2909,6,7,5,8,20,26,-6,26
Din Moscow,2909,7,6,6,8,21,25,-4,24
Amkar,2909,8,6,4,10,13,23,-10,22
Rostov,2909,9,5,6,9,12,18,-6,21
FK Rubin,2909,10,5,5,10,22,25,-3,20
Anzhi,2909,11,4,5,11,19,37,-18,17
Loko Moscow,2910,1,12,5,3,33,14,19,41
Spart Moscow,2910,2,11,5,4,44,28,16,38
CSKA Moscow,2910,3,11,3,6,27,19,8,36
Krasnodar,2910,4,10,4,6,31,26,5,34
Zenit,2910,5,8,8,4,24,16,8,32
Terek Grozny,2910,6,7,7,6,20,22,-2,28
Din Moscow,2910,7,5,7,8,18,25,-7,22
FK Rubin,2910,8,5,6,9,23,20,3,21
Rostov,2910,9,4,6,10,11,21,-10,18
Amkar,2910,10,4,5,11,11,26,-15,17
Anzhi,2910,11,2,6,12,14,39,-25,12
Loko Moscow,2911,1,13,5,2,34,14,20,44
CSKA Moscow,2911,2,11,3,6,26,19,7,36
Spart Moscow,2911,3,9,6,5,38,28,10,33
Zenit,2911,4,8,8,4,25,16,9,32
Krasnodar,2911,5,8,5,7,29,27,2,29
Terek Grozny,2911,6,7,6,7,24,29,-5,27
FK Rubin,2911,7,6,6,8,24,19,5,24
Din Moscow,2911,8,5,6,9,18,26,-8,21
Amkar,2911,9,5,5,10,13,25,-12,20
Rostov,2911,10,4,7,9,10,17,-7,19
Anzhi,2911,11,3,5,12,20,41,-21,14
Loko Moscow,2912,1,12,6,2,33,13,20,42
Spart Moscow,2912,2,11,5,4,42,28,14,38
CSKA Moscow,2912,3,11,3,6,28,21,7,36
Zenit,2912,4,8,9,3,23,13,10,33
Terek Grozny,2912,5,9,5,6,27,24,3,32
Krasnodar,2912,6,9,4,7,33,29,4,31
FK Rubin,2912,7,6,5,9,23,21,2,23
Din Moscow,2912,8,5,6,9,17,25,-8,21
Rostov,2912,9,4,6,10,12,20,-8,18
Amkar,2912,10,4,4,12,10,29,-19,16
Anzhi,2912,11,2,5,13,18,43,-25,11
Loko Moscow,2913,1,12,6,2,34,15,19,42
Spart Moscow,2913,2,10,6,4,39,27,12,36
CSKA Moscow,2913,3,11,3,6,27,19,8,36
Zenit,2913,4,8,8,4,25,17,8,32
Krasnodar,2913,5,9,5,6,29,25,4,32
Terek Grozny,2913,6,7,7,6,23,25,-2,28
Din Moscow,2913,7,5,7,8,17,24,-7,22
FK Rubin,2913,8,5,6,9,21,18,3,21
Rostov,2913,9,4,6,10,12,20,-8,18
Amkar,2913,10,4,6,10,10,23,-13,18
Anzhi,2913,11,2,6,12,17,41,-24,12
Loko Moscow,2914,1,13,5,2,33,11,22,44
CSKA Moscow,2914,2,10,5,5,28,20,8,35
Spart Moscow,2914,3,9,6,5,38,30,8,33
Krasnodar,2914,4,9,4,7,29,28,1,31
Zenit,2914,5,7,9,4,23,16,7,30
Terek Grozny,2914,6,8,5,7,21,23,-2,29
FK Rubin,2914,7,6,5,9,26,21,5,23
Amkar,2914,8,6,4,10,11,22,-11,22
Din Moscow,2914,9,5,6,9,21,28,-7,21
Rostov,2914,10,4,7,9,12,19,-7,19
Anzhi,2914,11,2,6,12,15,39,-24,12
CSKA Moscow,2915,1,12,3,5,28,18,10,39
Loko Moscow,2915,2,11,5,4,29,15,14,38
Spart Moscow,2915,3,10,5,5,40,28,12,35
Krasnodar,2915,4,10,4,6,30,24,6,34
Zenit,2915,5,8,8,4,24,15,9,32
Terek Grozny,2915,6,9,5,6,23,23,0,32
Din Moscow,2915,7,6,6,8,18,24,-6,24
FK Rubin,2915,8,5,5,10,21,19,2,20
Amkar,2915,9,5,4,11,13,26,-13,19
Rostov,2915,10,4,6,10,10,19,-9,18
Anzhi,2915,11,2,5,13,14,39,-25,11
Loko Moscow,2916,1,12,5,3,30,13,17,41
Spart Moscow,2916,2,10,6,4,39,28,11,36
CSKA Moscow,2916,3,11,3,6,27,21,6,36
Krasnodar,2916,4,10,4,6,31,25,6,34
Zenit,2916,5,8,8,4,24,14,10,32
Terek Grozny,2916,6,7,7,6,22,24,-2,28
Din Moscow,2916,7,5,7,8,17,22,-5,22
FK Rubin,2916,8,5,6,9,22,19,3,21
Rostov,2916,9,4,6,10,11,20,-9,18
Amkar,2916,10,4,6,10,12,25,-13,18
Anzhi,2916,11,2,6,12,16,40,-24,12
Loko Moscow,2917,1,12,5,3,33,15,18,41
Spart Moscow,2917,2,11,5,4,39,26,13,38
CSKA Moscow,2917,3,11,4,5,28,19,9,37
Zenit,2917,4,8,9,3,24,15,9,33
Krasnodar,2917,5,8,4,8,29,28,1,28
Terek Grozny,2917,6,7,7,6,22,24,-2,28
Din Moscow,2917,7,6,6,8,19,23,-4,24
FK Rubin,2917,8,6,5,9,23,20,3,23
Rostov,2917,9,4,6,10,10,18,-8,18
Amkar,2917,10,4,5,11,11,26,-15,17
Anzhi,2917,11,2,6,12,17,41,-24,12
Loko Moscow,2918,1,12,6,2,31,11,20,42
CSKA Moscow,2918,2,11,4,5,31,17,14,37
Spart Moscow,2918,3,9,6,5,36,27,9,33
Zenit,2918,4,7,10,3,21,13,8,31
Krasnodar,2918,5,8,5,7,28,27,1,29
Terek Grozny,2918,6,8,5,7,22,24,-2,29
Din Moscow,2918,7,7,6,7,21,22,-1,27
FK Rubin,2918,8,5,6,9,22,20,2,21
Amkar,2918,9,5,5,10,10,22,-12,20
Rostov,2918,10,4,6,10,10,19,-9,18
Anzhi,2918,11,2,5,13,15,45,-30,11
Loko Moscow,2919,1,12,5,3,31,13,18,41
Spart Moscow,2919,2,11,5,4,39,26,13,38
CSKA Moscow,2919,3,10,4,6,29,22,7,34
Zenit,2919,4,8,8,4,24,16,8,32
Krasnodar,2919,5,9,4,7,28,25,3,31
Terek Grozny,2919,6,8,5,7,22,24,-2,29
FK Rubin,2919,7,7,5,8,24,18,6,26
Din Moscow,2919,8,5,6,9,18,26,-8,21
Amkar,2919,9,5,4,11,11,24,-13,19
Rostov,2919,10,4,6,10,11,19,-8,18
Anzhi,2919,11,2,6,12,17,41,-24,12
Loko Moscow,2920,1,11,7,2,31,13,18,40
CSKA Moscow,2920,2,10,4,6,26,21,5,34
Zenit,2920,3,8,9,3,24,13,11,33
Krasnodar,2920,4,9,5,6,31,27,4,32
Spart Moscow,2920,5,8,7,5,37,30,7,31
Terek Grozny,2920,6,8,5,7,24,25,-1,29
FK Rubin,2920,7,6,5,9,23,19,4,23
Din Moscow,2920,8,5,7,8,17,22,-5,22
Amkar,2920,9,6,4,10,15,26,-11,22
Rostov,2920,10,4,7,9,12,19,-7,19
Anzhi,2920,11,2,6,12,15,40,-25,12
Loko Moscow,2921,1,11,5,4,30,14,16,38
Zenit,2921,2,9,8,3,25,14,11,35
Krasnodar,2921,3,10,4,6,29,24,5,34
CSKA Moscow,2921,4,10,3,7,25,21,4,33
Spart Moscow,2921,5,8,8,4,39,31,8,32
Terek Grozny,2921,6,8,6,6,23,24,-1,30
Din Moscow,2921,7,6,7,7,20,22,-2,25
FK Rubin,2921,8,5,5,10,21,20,1,20
Rostov,2921,9,4,7,9,12,19,-7,19
Amkar,2921,10,4,5,11,13,27,-14,17
Anzhi,2921,11,3,6,11,17,38,-21,15
Loko Moscow,2922,1,11,5,4,29,14,15,38
Spart Moscow,2922,2,11,5,4,41,28,13,38
Zenit,2922,3,9,8,3,25,14,11,35
CSKA Moscow,2922,4,10,4,6,27,20,7,34
Krasnodar,2922,5,9,5,6,29,25,4,32
Terek Grozny,2922,6,9,5,6,25,24,1,32
FK Rubin,2922,7,5,7,8,22,18,4,22
Din Moscow,2922,8,5,7,8,18,24,-6,22
Rostov,2922,9,4,6,10,11,19,-8,18
Amkar,2922,10,4,4,12,11,27,-16,16
Anzhi,2922,11,2,6,12,16,41,-25,12
Loko Moscow,2923,1,11,6,3,31,14,17,39
CSKA Moscow,2923,2,10,5,5,26,18,8,35
Zenit,2923,3,8,9,3,23,14,9,33
Spart Moscow,2923,4,9,5,6,37,30,7,32
Krasnodar,2923,5,9,5,6,32,27,5,32
Terek Grozny,2923,6,7,5,8,21,25,-4,26
Din Moscow,2923,7,6,6,8,19,24,-5,24
Amkar,2923,8,6,4,10,13,23,-10,22
Rostov,2923,9,5,6,9,12,18,-6,21
FK Rubin,2923,10,5,5,10,23,22,1,20
Anzhi,2923,11,3,6,11,16,38,-22,15
Loko Moscow,2924,1,12,5,3,31,14,17,41
CSKA Moscow,2924,2,11,3,6,29,21,8,36
Spart Moscow,2924,3,10,5,5,38,28,10,35
Krasnodar,2924,4,10,4,6,30,24,6,34
Zenit,2924,5,8,8,4,24,16,8,32
Terek Grozny,2924,6,8,5,7,22,26,-4,29
Din Moscow,2924,7,6,6,8,19,25,-6,24
FK Rubin,2924,8,5,5,10,22,20,2,20
Amkar,2924,9,5,4,11,12,23,-11,19
Rostov,2924,10,4,6,10,10,19,-9,18
Anzhi,2924,11,3,5,12,20,41,-21,14
Loko Moscow,2925,1,12,5,3,31,13,18,41
Spart Moscow,2925,2,10,6,4,38,28,10,36
CSKA Moscow,2925,3,10,4,6,26,19,7,34
Zenit,2925,4,8,8,4,23,15,8,32
Krasnodar,2925,5,9,4,7,28,25,3,31
Terek Grozny,2925,6,7,7,6,21,23,-2,28
FK Rubin,2925,7,7,5,8,24,18,6,26
Din Moscow,2925,8,5,7,8,18,23,-5,22
Rostov,2925,9,4,6,10,12,20,-8,18
Amkar,2925,10,4,5,11,10,24,-14,17
Anzhi,2925,11,2,7,11,16,39,-23,13
Loko Moscow,2926,1,12,5,3,31,12,19,41
Spart Moscow,2926,2,11,5,4,37,25,12,38
Zenit,2926,3,9,8,3,24,14,10,35
CSKA Moscow,2926,4,10,4,6,27,20,7,34
Krasnodar,2926,5,9,4,7,30,26,4,31
Terek Grozny,2926,6,8,6,6,23,24,-1,30
Din Moscow,2926,7,6,6,8,18,23,-5,24
FK Rubin,2926,8,5,5,10,21,21,0,20
Rostov,2926,9,4,6,10,10,18,-8,18
Amkar,2926,10,4,5,11,10,24,-14,17
Anzhi,2926,11,2,6,12,16,40,-24,12
Loko Moscow,2927,1,12,6,2,32,12,20,42
CSKA Moscow,2927,2,11,3,6,27,18,9,36
Zenit,2927,3,8,8,4,23,16,7,32
Spart Moscow,2927,4,8,6,6,35,30,5,30
Krasnodar,2927,5,8,6,6,28,25,3,30
Terek Grozny,2927,6,8,5,7,22,25,-3,29
FK Rubin,2927,7,6,6,8,24,18,6,24
Din Moscow,2927,8,5,7,8,18,24,-6,22
Amkar,2927,9,6,4,10,12,22,-10,22
Rostov,2927,10,5,6,9,13,18,-5,21
Anzhi,2927,11,2,5,13,15,41,-26,11
CSKA Moscow,2928,1,12,3,5,32,18,14,39
Loko Moscow,2928,2,11,5,4,30,15,15,38
Spart Moscow,2928,3,10,5,5,37,27,10,35
Krasnodar,2928,4,10,4,6,32,25,7,34
Zenit,2928,5,8,8,4,23,18,5,32
Terek Grozny,2928,6,8,5,7,22,24,-2,29
Din Moscow,2928,7,7,6,7,22,23,-1,27
FK Rubin,2928,8,5,5,10,22,22,0,20
Amkar,2928,9,5,4,11,11,24,-13,19
Rostov,2928,10,4,6,10,10,19,-9,18
Anzhi,2928,11,2,5,13,14,40,-26,11
Loko Moscow,2929,1,12,5,3,31,16,15,41
CSKA Moscow,2929,2,12,3,5,29,19,10,39
Krasnodar,2929,3,9,5,6,32,25,7,32
Spart Moscow,2929,4,9,5,6,37,31,6,32
Zenit,2929,5,7,8,5,24,18,6,29
Terek Grozny,2929,6,8,5,7,23,25,-2,29
Din Moscow,2929,7,7,6,7,20,22,-2,27
Amkar,2929,8,6,4,10,16,24,-8,22
FK Rubin,2929,9,5,6,9,22,19,3,21
Rostov,2929,10,4,6,10,10,19,-9,18
Anzhi,2929,11,2,5,13,14,40,-26,11
Loko Moscow,2930,1,13,5,2,35,13,22,44
CSKA Moscow,2930,2,11,4,5,26,17,9,37
Spart Moscow,2930,3,10,6,4,37,26,11,36
Terek Grozny,2930,4,8,6,6,25,23,2,30
Zenit,2930,5,7,8,5,21,17,4,29
Krasnodar,2930,6,8,4,8,31,31,0,28
Din Moscow,2930,7,6,6,8,18,22,-4,24
FK Rubin,2930,8,6,5,9,25,20,5,23
Rostov,2930,9,4,6,10,10,19,-9,18
Amkar,2930,10,4,6,10,10,23,-13,18
Anzhi,2930,11,2,6,12,15,42,-27,12
Loko Moscow,2931,1,13,5,2,34,11,23,44
CSKA Moscow,2931,2,12,3,5,28,17,11,39
Spart Moscow,2931,3,9,6,5,39,32,7,33
Zenit,2931,4,7,8,5,21,17,4,29
Krasnodar,2931,5,8,5,7,28,27,1,29
Terek Grozny,2931,6,7,7,6,22,24,-2,28
Din Moscow,2931,7,6,7,7,19,22,-3,25
FK Rubin,2931,8,5,6,9,22,19,3,21
Amkar,2931,9,5,5,10,14,25,-11,20
Rostov,2931,10,4,6,10,12,20,-8,18
Anzhi,2931,11,2,6,12,15,40,-25,12
Loko Moscow,2932,1,11,5,4,29,14,15,38
CSKA Moscow,2932,2,11,3,6,29,21,8,36
Zenit,2932,3,9,8,3,24,14,10,35
Spart Moscow,2932,4,9,6,5,37,28,9,33
Krasnodar,2932,5,9,5,6,30,25,5,32
Terek Grozny,2932,6,7,6,7,22,26,-4,27
Din Moscow,2932,7,6,6,8,19,23,-4,24
Amkar,2932,8,6,4,10,13,23,-10,22
FK Rubin,2932,9,5,6,9,22,20,2,21
Rostov,2932,10,4,7,9,11,18,-7,19
Anzhi,2932,11,2,6,12,18,42,-24,12
Loko Moscow,2933,1,12,5,3,31,12,19,41
Spart Moscow,2933,2,11,5,4,39,26,13,38
CSKA Moscow,2933,3,11,3,6,27,19,8,36
Krasnodar,2933,4,10,4,6,29,24,5,34
Zenit,2933,5,8,8,4,22,15,7,32
Terek Grozny,2933,6,8,5,7,23,25,-2,29
Din Moscow,2933,7,6,6,8,18,22,-4,24
FK Rubin,2933,8,5,5,10,21,19,2,20
Rostov,2933,9,4,6,10,10,20,-10,18
Amkar,2933,10,4,4,12,11,26,-15,16
Anzhi,2933,11,3,5,12,17,40,-23,14
Loko Moscow,2934,1,12,5,3,33,12,21,41
CSKA Moscow,2934,2,11,3,6,26,19,7,36
Spart Moscow,2934,3,9,5,6,38,32,6,32
Krasnodar,2934,4,9,5,6,29,25,4,32
Terek Grozny,2934,5,9,5,6,24,23,1,32
Zenit,2934,6,7,8,5,21,18,3,29
FK Rubin,2934,7,5,7,8,23,19,4,22
Din Moscow,2934,8,5,7,8,19,25,-6,22
Rostov,2934,9,5,6,9,14,19,-5,21
Amkar,2934,10,5,4,11,12,25,-13,19
Anzhi,2934,11,3,5,12,16,38,-22,14
Loko Moscow,2935,1,11,6,3,30,13,17,39
CSKA Moscow,2935,2,11,4,5,28,19,9,37
Spart Moscow,2935,3,10,6,4,40,30,10,36
Zenit,2935,4,8,8,4,23,15,8,32
Terek Grozny,2935,5,8,6,6,23,24,-1,30
Krasnodar,2935,6,8,5,7,28,26,2,29
FK Rubin,2935,7,7,5,8,24,17,7,26
Din Moscow,2935,8,5,6,9,19,26,-7,21
Rostov,2935,9,4,7,9,11,18,-7,19
Amkar,2935,10,4,5,11,12,26,-14,17
Anzhi,2935,11,2,6,12,16,40,-24,12
Loko Moscow,2936,1,11,7,2,31,13,18,40
CSKA Moscow,2936,2,11,3,6,29,19,10,36
Zenit,2936,3,8,9,3,24,15,9,33
Spart Moscow,2936,4,8,6,6,35,29,6,30
Terek Grozny,2936,5,8,6,6,23,23,0,30
Krasnodar,2936,6,8,5,7,28,26,2,29
Din Moscow,2936,7,6,7,7,20,23,-3,25
FK Rubin,2936,8,6,6,8,23,18,5,24
Rostov,2936,9,4,7,9,10,17,-7,19
Amkar,2936,10,5,4,11,11,25,-14,19
Anzhi,2936,11,2,6,12,15,41,-26,12
Loko Moscow,2937,1,12,6,2,33,13,20,42
CSKA Moscow,2937,2,11,3,6,28,20,8,36
Spart Moscow,2937,3,10,5,5,36,27,9,35
Zenit,2937,4,8,8,4,23,15,8,32
Krasnodar,2937,5,9,5,6,32,27,5,32
Terek Grozny,2937,6,8,6,6,21,22,-1,30
Din Moscow,2937,7,5,7,8,19,24,-5,22
FK Rubin,2937,8,5,6,9,23,21,2,21
Amkar,2937,9,5,5,10,10,22,-12,20
Rostov,2937,10,4,6,10,10,18,-8,18
Anzhi,2937,11,2,5,13,15,41,-26,11
Loko Moscow,2938,1,12,6,2,34,12,22,42
CSKA Moscow,2938,2,12,3,5,29,18,11,39
Spart Moscow,2938,3,10,6,4,39,26,13,36
Krasnodar,2938,4,8,6,6,31,28,3,30
Zenit,2938,5,7,8,5,22,20,2,29
Terek Grozny,2938,6,8,5,7,21,23,-2,29
FK Rubin,2938,7,5,7,8,25,21,4,22
Din Moscow,2938,8,5,7,8,19,26,-7,22
Rostov,2938,9,4,7,9,10,17,-7,19
Amkar,2938,10,4,4,12,9,25,-16,16
Anzhi,2938,11,3,5,12,15,38,-23,14
Loko Moscow,2939,1,13,5,2,37,12,25,44
Spart Moscow,2939,2,11,5,4,40,25,15,38
CSKA Moscow,2939,3,11,3,6,31,18,13,36
Zenit,2939,4,8,8,4,22,16,6,32
Krasnodar,2939,5,9,4,7,31,30,1,31
Terek Grozny,2939,6,7,5,8,21,27,-6,26
Din Moscow,2939,7,5,7,8,17,22,-5,22
FK Rubin,2939,8,5,6,9,22,20,2,21
Amkar,2939,9,5,4,11,12,26,-14,19
Rostov,2939,10,4,6,10,10,19,-9,18
Anzhi,2939,11,3,5,12,16,44,-28,14
Loko Moscow,2940,1,11,5,4,30,15,15,38
CSKA Moscow,2940,2,11,3,6,28,20,8,36
Zenit,2940,3,8,8,4,26,17,9,32
Krasnodar,2940,4,9,5,6,29,25,4,32
Spart Moscow,2940,5,8,6,6,34,29,5,30
Terek Grozny,2940,6,8,5,7,23,25,-2,29
Din Moscow,2940,7,6,7,7,19,22,-3,25
FK Rubin,2940,8,5,6,9,22,19,3,21
Rostov,2940,9,5,6,9,12,17,-5,21
Amkar,2940,10,5,4,11,10,23,-13,19
Anzhi,2940,11,4,5,11,18,39,-21,17
Loko Moscow,2941,1,12,6,2,32,12,20,42
CSKA Moscow,2941,2,11,3,6,28,21,7,36
Spart Moscow,2941,3,9,6,5,37,29,8,33
Zenit,2941,4,8,8,4,26,18,8,32
Krasnodar,2941,5,8,5,7,28,26,2,29
Terek Grozny,2941,6,8,5,7,22,24,-2,29
Din Moscow,2941,7,6,6,8,20,24,-4,24
FK Rubin,2941,8,6,5,9,24,20,4,23
Amkar,2941,9,6,4,10,13,24,-11,22
Rostov,2941,10,4,7,9,11,18,-7,19
Anzhi,2941,11,2,5,13,14,39,-25,11
Loko Moscow,2942,1,12,6,2,34,15,19,42
CSKA Moscow,2942,2,11,3,6,28,20,8,36
Spart Moscow,2942,3,9,7,4,36,26,10,34
Zenit,2942,4,8,9,3,25,14,11,33
Terek Grozny,2942,5,9,5,6,25,22,3,32
Krasnodar,2942,6,9,4,7,32,29,3,31
FK Rubin,2942,7,6,5,9,23,19,4,23
Din Moscow,2942,8,5,7,8,17,22,-5,22
Rostov,2942,9,4,7,9,11,18,-7,19
Amkar,2942,10,4,4,12,9,25,-16,16
Anzhi,2942,11,2,5,13,14,44,-30,11
Loko Moscow,2943,1,11,7,2,30,12,18,40
CSKA Moscow,2943,2,11,4,5,28,18,10,37
Spart Moscow,2943,3,9,5,6,38,32,6,32
Zenit,2943,4,7,10,3,22,14,8,31
Krasnodar,2943,5,8,5,7,29,27,2,29
Terek Grozny,2943,6,7,6,7,22,26,-4,27
Din Moscow,2943,7,6,7,7,21,23,-2,25
FK Rubin,2943,8,6,6,8,24,19,5,24
Amkar,2943,9,5,5,10,15,26,-11,20
Rostov,2943,10,4,6,10,10,19,-9,18
Anzhi,2943,11,3,5,12,16,39,-23,14
Loko Moscow,2944,1,12,5,3,32,14,18,41
Spart Moscow,2944,2,11,5,4,39,26,13,38
CSKA Moscow,2944,3,11,3,6,28,20,8,36
Zenit,2944,4,8,8,4,23,15,8,32
Krasnodar,2944,5,9,4,7,30,30,0,31
Terek Grozny,2944,6,8,5,7,23,23,0,29
Din Moscow,2944,7,6,6,8,19,25,-6,24
FK Rubin,2944,8,6,5,9,25,18,7,23
Rostov,2944,9,4,6,10,10,18,-8,18
Amkar,2944,10,4,4,12,9,26,-17,16
Anzhi,2944,11,3,5,12,16,39,-23,14
Loko Moscow,2945,1,12,6,2,32,13,19,42
Spart Moscow,2945,2,11,5,4,40,28,12,38
CSKA Moscow,2945,3,11,3,6,29,21,8,36
Zenit,2945,4,8,9,3,23,14,9,33
Krasnodar,2945,5,9,4,7,30,27,3,31
Terek Grozny,2945,6,8,5,7,21,24,-3,29
Din Moscow,2945,7,6,6,8,20,24,-4,24
FK Rubin,2945,8,5,5,10,21,19,2,20
Amkar,2945,9,5,4,11,12,25,-13,19
Rostov,2945,10,4,6,10,10,18,-8,18
Anzhi,2945,11,2,5,13,16,41,-25,11
Loko Moscow,2946,1,13,5,2,34,11,23,44
CSKA Moscow,2946,2,11,3,6,32,19,13,36
Spart Moscow,2946,3,9,6,5,35,27,8,33
Zenit,2946,4,8,8,4,23,17,6,32
Krasnodar,2946,5,9,4,7,28,26,2,31
Terek Grozny,2946,6,8,5,7,21,23,-2,29
Din Moscow,2946,7,6,6,8,20,24,-4,24
FK Rubin,2946,8,5,5,10,22,20,2,20
Rostov,2946,9,4,7,9,10,17,-7,19
Amkar,2946,10,5,4,11,10,23,-13,19
Anzhi,2946,11,3,5,12,15,43,-28,14
Loko Moscow,2947,1,11,6,3,29,13,16,39
CSKA Moscow,2947,2,12,3,5,31,18,13,39
Spart Moscow,2947,3,10,6,4,41,28,13,36
Zenit,2947,4,8,8,4,23,16,7,32
Krasnodar,2947,5,8,5,7,27,25,2,29
Terek Grozny,2947,6,8,5,7,23,25,-2,29
FK Rubin,2947,7,7,5,8,24,17,7,26
Din Moscow,2947,8,5,6,9,18,28,-10,21
Rostov,2947,9,4,7,9,12,19,-7,19
Amkar,2947,10,4,4,12,10,25,-15,16
Anzhi,2947,11,3,5,12,17,41,-24,14
Loko Moscow,2948,1,11,5,4,30,15,15,38
CSKA Moscow,2948,2,11,3,6,28,19,9,36
Zenit,2948,3,8,8,4,24,16,8,32
Spart Moscow,2948,4,9,5,6,38,31,7,32
Krasnodar,2948,5,9,4,7,28,26,2,31
Terek Grozny,2948,6,7,6,7,24,27,-3,27
FK Rubin,2948,7,6,6,8,24,18,6,24
Din Moscow,2948,8,5,7,8,19,24,-5,22
Rostov,2948,9,5,6,9,13,19,-6,21
Amkar,2948,10,5,5,10,14,26,-12,20
Anzhi,2948,11,4,5,11,18,39,-21,17
Loko Moscow,2949,1,13,5,2,33,11,22,44
CSKA Moscow,2949,2,12,3,5,27,17,10,39
Spart Moscow,2949,3,9,7,4,38,27,11,34
Krasnodar,2949,4,9,4,7,28,25,3,31
Zenit,2949,5,7,8,5,21,17,4,29
Terek Grozny,2949,6,7,6,7,23,26,-3,27
Din Moscow,2949,7,6,6,8,21,25,-4,24
FK Rubin,2949,8,5,5,10,22,22,0,20
Amkar,2949,9,5,5,10,12,24,-12,20
Rostov,2949,10,4,7,9,11,18,-7,19
Anzhi,2949,11,2,6,12,16,40,-24,12
Loko Moscow,2950,1,12,6,2,32,12,20,42
Spart Moscow,2950,2,9,6,5,37,27,10,33
CSKA Moscow,2950,3,10,3,7,25,21,4,33
Zenit,2950,4,8,8,4,24,15,9,32
Krasnodar,2950,5,9,5,6,30,25,5,32
Terek Grozny,2950,6,8,5,7,22,24,-2,29
Din Moscow,2950,7,6,6,8,18,24,-6,24
Amkar,2950,8,6,4,10,11,22,-11,22
FK Rubin,2950,9,5,5,10,21,20,1,20
Rostov,2950,10,4,7,9,11,18,-7,19
Anzhi,2950,11,3,5,12,16,39,-23,14
Loko Moscow,2951,1,11,6,3,30,14,16,39
Spart Moscow,2951,2,10,5,5,38,27,11,35
CSKA Moscow,2951,3,10,4,6,26,20,6,34
Zenit,2951,4,8,9,3,24,14,10,33
Krasnodar,2951,5,9,4,7,29,26,3,31
Terek Grozny,2951,6,7,6,7,20,24,-4,27
Din Moscow,2951,7,6,6,8,19,24,-5,24
FK Rubin,2951,8,6,5,9,23,18,5,23
Amkar,2951,9,5,5,10,10,22,-12,20
Rostov,2951,10,4,6,10,10,19,-9,18
Anzhi,2951,11,3,6,11,17,38,-21,15
Loko Moscow,2952,1,12,5,3,30,12,18,41
Spart Moscow,2952,2,10,5,5,40,29,11,35
CSKA Moscow,2952,3,10,5,5,27,19,8,35
Krasnodar,2952,4,9,5,6,29,25,4,32
Zenit,2952,5,7,9,4,22,15,7,30
Terek Grozny,2952,6,7,5,8,20,24,-4,26
Din Moscow,2952,7,6,6,8,21,26,-5,24
FK Rubin,2952,8,5,6,9,24,21,3,21
Rostov,2952,9,5,6,9,13,17,-4,21
Amkar,2952,10,5,4,11,10,26,-16,19
Anzhi,2952,11,3,6,11,16,38,-22,15
Loko Moscow,2953,1,12,6,2,32,13,19,42
CSKA Moscow,2953,2,12,3,5,28,17,11,39
Spart Moscow,2953,3,9,7,4,39,27,12,34
Terek Grozny,2953,4,9,5,6,28,22,6,32
Zenit,2953,5,7,9,4,22,15,7,30
Krasnodar,2953,6,8,5,7,28,26,2,29
Din Moscow,2953,7,6,6,8,20,27,-7,24
FK Rubin,2953,8,5,6,9,22,19,3,21
Rostov,2953,9,4,7,9,10,17,-7,19
Amkar,2953,10,4,5,11,10,27,-17,17
Anzhi,2953,11,2,5,13,14,43,-29,11
Loko Moscow,2954,1,11,5,4,30,17,13,38
CSKA Moscow,2954,2,11,3,6,28,18,10,36
Spart Moscow,2954,3,10,5,5,46,28,18,35
Zenit,2954,4,9,8,3,26,14,12,35
Krasnodar,2954,5,10,4,6,32,26,6,34
Terek Grozny,2954,6,9,5,6,23,22,1,32
Din Moscow,2954,7,6,7,7,20,23,-3,25
FK Rubin,2954,8,5,6,9,25,22,3,21
Rostov,2954,9,4,6,10,11,27,-16,18
Amkar,2954,10,4,4,12,10,26,-16,16
Anzhi,2954,11,2,5,13,14,42,-28,11
Loko Moscow,2955,1,12,5,3,31,14,17,41
CSKA Moscow,2955,2,12,3,5,31,17,14,39
Zenit,2955,3,8,8,4,24,16,8,32
Terek Grozny,2955,4,9,5,6,24,23,1,32
Spart Moscow,2955,5,8,5,7,35,30,5,29
Krasnodar,2955,6,8,5,7,28,27,1,29
Din Moscow,2955,7,7,6,7,20,22,-2,27
FK Rubin,2955,8,5,6,9,22,19,3,21
Rostov,2955,9,5,6,9,11,17,-6,21
Amkar,2955,10,5,4,11,12,25,-13,19
Anzhi,2955,11,2,5,13,14,42,-28,11
Loko Moscow,2956,1,11,5,4,31,15,16,38
Spart Moscow,2956,2,10,6,4,39,26,13,36
Zenit,2956,3,9,8,3,24,14,10,35
CSKA Moscow,2956,4,10,4,6,27,20,7,34
Krasnodar,2956,5,10,4,6,31,25,6,34
Terek Grozny,2956,6,7,6,7,22,26,-4,27
Din Moscow,2956,7,6,7,7,21,24,-3,25
FK Rubin,2956,8,5,5,10,24,23,1,20
Rostov,2956,9,4,6,10,10,19,-9,18
Amkar,2956,10,4,5,11,11,27,-16,17
Anzhi,2956,11,3,6,11,19,40,-21,15
Loko Moscow,2957,1,11,6,3,29,13,16,39
Spart Moscow,2957,2,11,5,4,40,27,13,38
CSKA Moscow,2957,3,10,4,6,26,19,7,34
Zenit,2957,4,8,9,3,23,14,9,33
Krasnodar,2957,5,9,4,7,31,27,4,31
Terek Grozny,2957,6,7,7,6,22,24,-2,28
Din Moscow,2957,7,6,6,8,18,23,-5,24
FK Rubin,2957,8,6,5,9,24,20,4,23
Rostov,2957,9,4,6,10,10,18,-8,18
Amkar,2957,10,4,5,11,12,27,-15,17
Anzhi,2957,11,2,7,11,15,38,-23,13
Loko Moscow,2958,1,12,5,3,35,13,22,41
CSKA Moscow,2958,2,12,3,5,27,17,10,39
Spart Moscow,2958,3,9,7,4,35,25,10,34
Zenit,2958,4,8,8,4,23,15,8,32
Krasnodar,2958,5,9,4,7,29,29,0,31
Terek Grozny,2958,6,7,7,6,20,22,-2,28
FK Rubin,2958,7,6,5,9,22,19,3,23
Din Moscow,2958,8,5,7,8,17,22,-5,22
Rostov,2958,9,4,6,10,10,19,-9,18
Amkar,2958,10,4,6,10,9,22,-13,18
Anzhi,2958,11,2,6,12,14,38,-24,12
Loko Moscow,2959,1,11,7,2,31,13,18,40
CSKA Moscow,2959,2,12,3,5,30,19,11,39
Spart Moscow,2959,3,9,6,5,35,26,9,33
Krasnodar,2959,4,9,5,6,30,25,5,32
Terek Grozny,2959,5,9,5,6,24,22,2,32
Zenit,2959,6,7,9,4,22,16,6,30
Din Moscow,2959,7,7,6,7,20,22,-2,27
FK Rubin,2959,8,5,5,10,22,21,1,20
Rostov,2959,9,4,7,9,10,17,-7,19
Amkar,2959,10,4,4,12,9,25,-16,16
Anzhi,2959,11,2,5,13,16,43,-27,11
Loko Moscow,2960,1,12,5,3,32,16,16,41
CSKA Moscow,2960,2,12,3,5,29,17,12,39
Spart Moscow,2960,3,9,7,4,35,25,10,34
Krasnodar,2960,4,9,5,6,30,24,6,32
Terek Grozny,2960,5,8,6,6,23,22,1,30
Zenit,2960,6,7,8,5,23,17,6,29
FK Rubin,2960,7,6,6,8,24,18,6,24
Din Moscow,2960,8,5,6,9,18,26,-8,21
Rostov,2960,9,4,7,9,10,17,-7,19
Amkar,2960,10,4,6,10,9,22,-13,18
Anzhi,2960,11,2,5,13,14,43,-29,11
Loko Moscow,2961,1,11,6,3,32,15,17,39
CSKA Moscow,2961,2,11,4,5,27,17,10,37
Spart Moscow,2961,3,10,5,5,40,30,10,35
Krasnodar,2961,4,9,5,6,30,26,4,32
Zenit,2961,5,7,10,3,22,14,8,31
Terek Grozny,2961,6,8,5,7,22,25,-3,29
Din Moscow,2961,7,6,6,8,20,26,-6,24
FK Rubin,2961,8,5,6,9,21,18,3,21
Amkar,2961,9,5,4,11,11,23,-12,19
Rostov,2961,10,4,6,10,11,19,-8,18
Anzhi,2961,11,3,5,12,17,40,-23,14
Loko Moscow,2962,1,11,6,3,31,14,17,39
CSKA Moscow,2962,2,11,4,5,27,18,9,37
Spart Moscow,2962,3,10,5,5,40,27,13,35
Zenit,2962,4,8,9,3,22,13,9,33
Krasnodar,2962,5,9,5,6,31,26,5,32
Terek Grozny,2962,6,7,6,7,20,23,-3,27
Din Moscow,2962,7,5,7,8,19,26,-7,22
Amkar,2962,8,6,4,10,12,22,-10,22
FK Rubin,2962,9,5,6,9,23,21,2,21
Rostov,2962,10,4,6,10,10,21,-11,18
Anzhi,2962,11,2,6,12,15,39,-24,12
Loko Moscow,2963,1,11,6,3,31,15,16,39
CSKA Moscow,2963,2,12,3,5,30,17,13,39
Spart Moscow,2963,3,11,5,4,43,29,14,38
Krasnodar,2963,4,10,4,6,31,25,6,34
Zenit,2963,5,7,9,4,22,15,7,30
Terek Grozny,2963,6,7,6,7,20,23,-3,27
Din Moscow,2963,7,6,6,8,20,25,-5,24
FK Rubin,2963,8,5,5,10,21,19,2,20
Rostov,2963,9,4,6,10,12,22,-10,18
Amkar,2963,10,4,5,11,9,23,-14,17
Anzhi,2963,11,3,5,12,15,41,-26,14
Loko Moscow,2964,1,12,5,3,32,14,18,41
Spart Moscow,2964,2,10,6,4,38,26,12,36
CSKA Moscow,2964,3,11,3,6,28,19,9,36
Krasnodar,2964,4,10,4,6,31,26,5,34
Zenit,2964,5,8,8,4,24,16,8,32
Terek Grozny,2964,6,7,6,7,21,24,-3,27
Din Moscow,2964,7,6,6,8,18,23,-5,24
FK Rubin,2964,8,5,5,10,22,20,2,20
Rostov,2964,9,4,7,9,11,18,-7,19
Amkar,2964,10,5,4,11,10,24,-14,19
Anzhi,2964,11,2,6,12,15,40,-25,12
Loko Moscow,2965,1,11,6,3,31,14,17,39
CSKA Moscow,2965,2,11,3,6,26,18,8,36
Krasnodar,2965,3,10,4,6,29,24,5,34
Spart Moscow,2965,4,9,5,6,36,30,6,32
Zenit,2965,5,7,9,4,23,16,7,30
Din Moscow,2965,6,7,6,7,20,22,-2,27
Terek Grozny,2965,7,7,6,7,21,25,-4,27
FK Rubin,2965,8,5,5,10,21,19,2,20
Amkar,2965,9,5,5,10,13,24,-11,20
Rostov,2965,10,4,6,10,10,18,-8,18
Anzhi,2965,11,4,5,11,17,37,-20,17
Loko Moscow,2966,1,11,6,3,29,15,14,39
CSKA Moscow,2966,2,11,4,5,29,18,11,37
Spart Moscow,2966,3,10,5,5,38,30,8,35
Zenit,2966,4,7,10,3,22,14,8,31
Krasnodar,2966,5,9,4,7,32,27,5,31
Terek Grozny,2966,6,8,6,6,22,23,-1,30
FK Rubin,2966,7,7,5,8,26,18,8,26
Din Moscow,2966,8,5,6,9,19,26,-7,21
Amkar,2966,9,5,5,10,11,22,-11,20
Rostov,2966,10,4,6,10,11,19,-8,18
Anzhi,2966,11,2,5,13,15,42,-27,11
Loko Moscow,2967,1,11,6,3,31,14,17,39
CSKA Moscow,2967,2,11,4,5,26,17,9,37
Spart Moscow,2967,3,10,5,5,38,27,11,35
Zenit,2967,4,7,10,3,22,14,8,31
Krasnodar,2967,5,9,4,7,30,27,3,31
Terek Grozny,2967,6,8,6,6,23,23,0,30
Din Moscow,2967,7,6,6,8,21,23,-2,24
FK Rubin,2967,8,6,5,9,23,21,2,23
Amkar,2967,9,5,4,11,10,24,-14,19
Rostov,2967,10,4,6,10,10,20,-10,18
Anzhi,2967,11,2,6,12,15,39,-24,12
Loko Moscow,2968,1,11,5,4,29,16,13,38
Spart Moscow,2968,2,10,6,4,41,28,13,36
Zenit,2968,3,9,8,3,25,13,12,35
Krasnodar,2968,4,10,4,6,31,24,7,34
CSKA Moscow,2968,5,10,3,7,25,20,5,33
Terek Grozny,2968,6,8,6,6,23,24,-1,30
Din Moscow,2968,7,6,6,8,21,24,-3,24
FK Rubin,2968,8,5,5,10,22,22,0,20
Rostov,2968,9,4,6,10,13,23,-10,18
Amkar,2968,10,4,6,10,10,23,-13,18
Anzhi,2968,11,3,5,12,16,39,-23,14
Loko Moscow,2969,1,13,5,2,32,11,21,44
CSKA Moscow,2969,2,11,3,6,28,19,9,36
Spart Moscow,2969,3,9,6,5,36,28,8,33
Zenit,2969,4,8,8,4,23,16,7,32
Krasnodar,2969,5,9,4,7,31,26,5,31
Terek Grozny,2969,6,8,5,7,23,25,-2,29
Din Moscow,2969,7,6,6,8,21,23,-2,24
Rostov,2969,8,5,6,9,11,17,-6,21
FK Rubin,2969,9,5,5,10,22,24,-2,20
Amkar,2969,10,5,5,10,12,24,-12,20
Anzhi,2969,11,2,5,13,15,41,-26,11
Loko Moscow,2970,1,13,5,2,32,11,21,44
CSKA Moscow,2970,2,11,4,5,27,18,9,37
Spart Moscow,2970,3,9,7,4,35,26,9,34
Krasnodar,2970,4,9,4,7,29,26,3,31
Zenit,2970,5,7,9,4,21,14,7,30
Terek Grozny,2970,6,8,5,7,22,25,-3,29
FK Rubin,2970,7,6,5,9,23,20,3,23
Din Moscow,2970,8,5,7,8,18,23,-5,22
Rostov,2970,9,4,7,9,10,17,-7,19
Amkar,2970,10,4,4,12,11,26,-15,16
Anzhi,2970,11,3,5,12,17,39,-22,14
Loko Moscow,2971,1,12,6,2,30,11,19,42
Spart Moscow,2971,2,11,5,4,40,25,15,38
CSKA Moscow,2971,3,11,3,6,27,19,8,36
Krasnodar,2971,4,9,4,7,28,25,3,31
Zenit,2971,5,7,9,4,21,15,6,30
Terek Grozny,2971,6,7,6,7,22,27,-5,27
Din Moscow,2971,7,5,7,8,18,24,-6,22
FK Rubin,2971,8,5,6,9,22,19,3,21
Amkar,2971,9,5,4,11,14,27,-13,19
Rostov,2971,10,4,6,10,10,19,-9,18
Anzhi,2971,11,3,6,11,16,37,-21,15
Loko Moscow,2972,1,12,6,2,31,12,19,42
Spart Moscow,2972,2,9,7,4,38,28,10,34
CSKA Moscow,2972,3,10,4,6,27,20,7,34
Zenit,2972,4,8,9,3,24,15,9,33
Terek Grozny,2972,5,8,6,6,24,22,2,30
Krasnodar,2972,6,8,5,7,28,26,2,29
Din Moscow,2972,7,5,8,7,21,25,-4,23
FK Rubin,2972,8,5,7,8,24,20,4,22
Rostov,2972,9,4,7,9,11,18,-7,19
Amkar,2972,10,4,5,11,9,24,-15,17
Anzhi,2972,11,2,6,12,15,42,-27,12
Loko Moscow,2973,1,11,6,3,29,12,17,39
Zenit,2973,2,9,8,3,23,13,10,35
Spart Moscow,2973,3,9,6,5,37,28,9,33
CSKA Moscow,2973,4,10,3,7,26,20,6,33
Terek Grozny,2973,5,8,6,6,22,23,-1,30
Krasnodar,2973,6,8,5,7,27,26,1,29
Din Moscow,2973,7,6,6,8,20,24,-4,24
FK Rubin,2973,8,6,5,9,24,20,4,23
Amkar,2973,9,5,5,10,11,23,-12,20
Rostov,2973,10,4,7,9,12,19,-7,19
Anzhi,2973,11,3,5,12,16,39,-23,14
Loko Moscow,2974,1,12,6,2,31,12,19,42
CSKA Moscow,2974,2,12,3,5,28,17,11,39
Spart Moscow,2974,3,10,6,4,38,27,11,36
Krasnodar,2974,4,9,5,6,28,24,4,32
Zenit,2974,5,7,8,5,22,16,6,29
Terek Grozny,2974,6,7,7,6,20,22,-2,28
FK Rubin,2974,7,6,5,9,22,18,4,23
Din Moscow,2974,8,5,7,8,18,23,-5,22
Rostov,2974,9,4,6,10,10,18,-8,18
Amkar,2974,10,4,5,11,10,25,-15,17
Anzhi,2974,11,2,6,12,14,39,-25,12
Loko Moscow,2975,1,12,6,2,33,11,22,42
CSKA Moscow,2975,2,11,4,5,29,17,12,37
Spart Moscow,2975,3,8,8,4,35,27,8,32
Zenit,2975,4,7,10,3,21,13,8,31
Krasnodar,2975,5,8,5,7,28,29,-1,29
Terek Grozny,2975,6,7,6,7,21,24,-3,27
Din Moscow,2975,7,6,7,7,19,21,-2,25
FK Rubin,2975,8,5,6,9,22,20,2,21
Rostov,2975,9,4,7,9,10,17,-7,19
Amkar,2975,10,4,6,10,12,25,-13,18
Anzhi,2975,11,3,5,12,15,41,-26,14
Loko Moscow,2976,1,12,6,2,31,12,19,42
CSKA Moscow,2976,2,10,5,5,27,19,8,35
Spart Moscow,2976,3,9,6,5,38,29,9,33
Krasnodar,2976,4,9,5,6,31,25,6,32
Zenit,2976,5,7,9,4,22,15,7,30
Terek Grozny,2976,6,7,6,7,21,24,-3,27
Din Moscow,2976,7,6,6,8,20,23,-3,24
FK Rubin,2976,8,6,5,9,23,21,2,23
Amkar,2976,9,5,5,10,11,23,-12,20
Rostov,2976,10,4,6,10,11,21,-10,18
Anzhi,2976,11,2,7,11,16,39,-23,13
Loko Moscow,2977,1,12,5,3,31,12,19,41
Krasnodar,2977,2,10,4,6,33,24,9,34
CSKA Moscow,2977,3,10,4,6,26,19,7,34
Spart Moscow,2977,4,9,6,5,36,28,8,33
Zenit,2977,5,8,8,4,22,15,7,32
Terek Grozny,2977,6,9,5,6,24,22,2,32
FK Rubin,2977,7,6,5,9,23,22,1,23
Din Moscow,2977,8,5,6,9,17,24,-7,21
Rostov,2977,9,4,7,9,10,17,-7,19
Amkar,2977,10,5,4,11,12,26,-14,19
Anzhi,2977,11,2,6,12,15,40,-25,12
Loko Moscow,2978,1,13,5,2,32,11,21,44
CSKA Moscow,2978,2,12,3,5,28,17,11,39
Krasnodar,2978,3,9,4,7,29,27,2,31
Spart Moscow,2978,4,8,6,6,34,29,5,30
Zenit,2978,5,7,8,5,21,16,5,29
Terek Grozny,2978,6,7,6,7,22,27,-5,27
Din Moscow,2978,7,6,6,8,21,25,-4,24
FK Rubin,2978,8,6,5,9,25,20,5,23
Rostov,2978,9,5,6,9,11,17,-6,21
Amkar,2978,10,4,6,10,10,23,-13,18
Anzhi,2978,11,3,5,12,18,39,-21,14
Loko Moscow,2979,1,11,6,3,32,15,17,39
CSKA Moscow,2979,2,11,3,6,27,19,8,36
Spart Moscow,2979,3,10,5,5,41,29,12,35
Krasnodar,2979,4,10,4,6,32,27,5,34
Zenit,2979,5,8,9,3,23,14,9,33
Terek Grozny,2979,6,8,6,6,24,25,-1,30
Din Moscow,2979,7,6,6,8,18,24,-6,24
FK Rubin,2979,8,5,5,10,22,20,2,20
Amkar,2979,9,5,4,11,14,26,-12,19
Rostov,2979,10,4,6,10,10,20,-10,18
Anzhi,2979,11,2,6,12,17,41,-24,12
Loko Moscow,2980,1,12,6,2,31,12,19,42
Spart Moscow,2980,2,10,5,5,39,28,11,35
CSKA Moscow,2980,3,10,3,7,25,21,4,33
Zenit,2980,4,8,8,4,25,15,10,32
Krasnodar,2980,5,9,5,6,28,24,4,32
Terek Grozny,2980,6,8,5,7,21,23,-2,29
Din Moscow,2980,7,6,6,8,18,24,-6,24
FK Rubin,2980,8,5,5,10,21,19,2,20
Amkar,2980,9,5,4,11,12,25,-13,19
Rostov,2980,10,4,6,10,10,18,-8,18
Anzhi,2980,11,4,5,11,16,37,-21,17
Loko Moscow,2981,1,12,5,3,33,17,16,41
Spart Moscow,2981,2,10,5,5,37,27,10,35
CSKA Moscow,2981,3,10,3,7,26,22,4,33
Zenit,2981,4,8,8,4,26,16,10,32
Terek Grozny,2981,5,9,5,6,24,24,0,32
Krasnodar,2981,6,9,4,7,32,28,4,31
Din Moscow,2981,7,7,6,7,19,21,-2,27
FK Rubin,2981,8,6,5,9,24,19,5,23
Rostov,2981,9,4,6,10,11,19,-8,18
Amkar,2981,10,4,4,12,9,25,-16,16
Anzhi,2981,11,3,5,12,18,41,-23,14
Loko Moscow,2982,1,11,5,4,31,15,16,38
CSKA Moscow,2982,2,11,3,6,28,19,9,36
Zenit,2982,3,9,8,3,23,13,10,35
Spart Moscow,2982,4,9,7,4,38,29,9,34
Krasnodar,2982,5,9,4,7,32,29,3,31
Terek Grozny,2982,6,7,5,8,23,27,-4,26
Din Moscow,2982,7,6,6,8,18,22,-4,24
FK Rubin,2982,8,6,5,9,24,20,4,23
Amkar,2982,9,5,5,10,15,27,-12,20
Rostov,2982,10,4,7,9,11,18,-7,19
Anzhi,2982,11,3,5,12,17,41,-24,14
Loko Moscow,2983,1,12,6,2,31,11,20,42
CSKA Moscow,2983,2,11,3,6,27,19,8,36
Spart Moscow,2983,3,9,6,5,35,26,9,33
Zenit,2983,4,8,8,4,23,15,8,32
Krasnodar,2983,5,9,5,6,28,24,4,32
Terek Grozny,2983,6,7,7,6,20,22,-2,28
Din Moscow,2983,7,6,7,7,22,21,1,25
Rostov,2983,8,5,6,9,11,17,-6,21
FK Rubin,2983,9,5,5,10,21,23,-2,20
Amkar,2983,10,4,5,11,9,24,-15,17
Anzhi,2983,11,2,6,12,14,39,-25,12
Loko Moscow,2984,1,13,5,2,33,13,20,44
CSKA Moscow,2984,2,11,3,6,29,19,10,36
Spart Moscow,2984,3,10,5,5,39,30,9,35
Zenit,2984,4,8,8,4,25,16,9,32
Krasnodar,2984,5,9,4,7,28,25,3,31
Din Moscow,2984,6,7,6,7,21,23,-2,27
Terek Grozny,2984,7,7,6,7,22,25,-3,27
FK Rubin,2984,8,5,5,10,21,19,2,20
Rostov,2984,9,4,6,10,10,18,-8,18
Amkar,2984,10,4,5,11,13,27,-14,17
Anzhi,2984,11,3,5,12,15,41,-26,14
Loko Moscow,2985,1,12,5,3,31,13,18,41
CSKA Moscow,2985,2,11,3,6,27,18,9,36
Zenit,2985,3,9,8,3,23,13,10,35
Spart Moscow,2985,4,10,5,5,37,28,9,35
Terek Grozny,2985,5,8,6,6,23,24,-1,30
Krasnodar,2985,6,8,4,8,29,28,1,28
Din Moscow,2985,7,6,6,8,20,23,-3,24
FK Rubin,2985,8,6,5,9,23,20,3,23
Rostov,2985,9,5,6,9,12,17,-5,21
Amkar,2985,10,4,5,11,11,26,-15,17
Anzhi,2985,11,2,5,13,14,40,-26,11
Loko Moscow,2986,1,12,6,2,34,14,20,42
CSKA Moscow,2986,2,10,4,6,26,22,4,34
Zenit,2986,3,8,9,3,27,15,12,33
Spart Moscow,2986,4,8,6,6,35,29,6,30
Krasnodar,2986,5,8,5,7,28,27,1,29
Terek Grozny,2986,6,7,7,6,20,22,-2,28
Din Moscow,2986,7,6,7,7,20,22,-2,25
FK Rubin,2986,8,5,6,9,21,19,2,21
Rostov,2986,9,5,6,9,12,18,-6,21
Amkar,2986,10,5,5,10,10,22,-12,20
Anzhi,2986,11,2,7,11,15,38,-23,13
Loko Moscow,2987,1,11,6,3,32,15,17,39
Spart Moscow,2987,2,10,6,4,39,27,12,36
CSKA Moscow,2987,3,11,3,6,30,19,11,36
Zenit,2987,4,8,9,3,24,15,9,33
Krasnodar,2987,5,9,5,6,30,26,4,32
Terek Grozny,2987,6,8,6,6,24,23,1,30
FK Rubin,2987,7,6,6,8,24,17,7,24
Din Moscow,2987,8,5,7,8,17,24,-7,22
Rostov,2987,9,4,6,10,12,20,-8,18
Amkar,2987,10,4,4,12,9,28,-19,16
Anzhi,2987,11,2,6,12,15,42,-27,12
Loko Moscow,2988,1,13,5,2,32,12,20,44
CSKA Moscow,2988,2,11,3,6,30,22,8,36
Spart Moscow,2988,3,9,7,4,37,28,9,34
Terek Grozny,2988,4,9,5,6,22,22,0,32
Krasnodar,2988,5,9,4,7,29,26,3,31
Zenit,2988,6,7,8,5,22,16,6,29
Din Moscow,2988,7,6,6,8,19,23,-4,24
FK Rubin,2988,8,5,5,10,21,19,2,20
Rostov,2988,9,4,7,9,10,17,-7,19
Amkar,2988,10,4,5,11,11,25,-14,17
Anzhi,2988,11,3,5,12,18,41,-23,14
Loko Moscow,2989,1,11,7,2,31,13,18,40
CSKA Moscow,2989,2,12,3,5,28,17,11,39
Spart Moscow,2989,3,9,6,5,37,29,8,33
Zenit,2989,4,7,9,4,22,16,6,30
Krasnodar,2989,5,8,6,6,28,25,3,30
Terek Grozny,2989,6,7,5,8,21,25,-4,26
Din Moscow,2989,7,6,6,8,20,24,-4,24
Amkar,2989,8,6,4,10,12,23,-11,22
FK Rubin,2989,9,5,6,9,21,18,3,21
Rostov,2989,10,4,7,9,11,18,-7,19
Anzhi,2989,11,3,5,12,15,38,-23,14
Loko Moscow,2990,1,11,6,3,33,16,17,39
CSKA Moscow,2990,2,11,3,6,27,18,9,36
Zenit,2990,3,9,8,3,24,14,10,35
Spart Moscow,2990,4,10,5,5,37,29,8,35
Krasnodar,2990,5,9,5,6,32,27,5,32
Terek Grozny,2990,6,9,5,6,28,25,3,32
Din Moscow,2990,7,6,6,8,21,25,-4,24
FK Rubin,2990,8,5,5,10,22,22,0,20
Amkar,2990,9,5,4,11,15,27,-12,19
Rostov,2990,10,4,6,10,10,18,-8,18
Anzhi,2990,11,2,5,13,14,42,-28,11
Loko Moscow,2991,1,11,5,4,29,14,15,38
Spart Moscow,2991,2,11,5,4,39,26,13,38
CSKA Moscow,2991,3,11,3,6,26,18,8,36
Zenit,2991,4,9,8,3,23,13,10,35
Krasnodar,2991,5,9,5,6,30,25,5,32
Terek Grozny,2991,6,7,6,7,23,28,-5,27
FK Rubin,2991,7,6,6,8,24,19,5,24
Din Moscow,2991,8,5,6,9,19,25,-6,21
Rostov,2991,9,4,6,10,10,19,-9,18
Amkar,2991,10,4,5,11,11,26,-15,17
Anzhi,2991,11,3,5,12,18,39,-21,14
Loko Moscow,2992,1,11,7,2,32,14,18,40
CSKA Moscow,2992,2,12,3,5,28,17,11,39
Spart Moscow,2992,3,9,6,5,37,28,9,33
Zenit,2992,4,7,9,4,23,16,7,30
Krasnodar,2992,5,8,5,7,29,27,2,29
Terek Grozny,2992,6,8,5,7,23,25,-2,29
FK Rubin,2992,7,7,5,8,24,18,6,26
Din Moscow,2992,8,6,6,8,19,22,-3,24
Rostov,2992,9,4,7,9,10,17,-7,19
Amkar,2992,10,4,4,12,12,29,-17,16
Anzhi,2992,11,3,5,12,15,39,-24,14
Loko Moscow,2993,1,12,6,2,33,13,20,42
Spart Moscow,2993,2,9,7,4,37,28,9,34
Zenit,2993,3,8,9,3,24,15,9,33
CSKA Moscow,2993,4,10,3,7,27,22,5,33
Krasnodar,2993,5,9,4,7,29,27,2,31
Terek Grozny,2993,6,8,5,7,22,23,-1,29
Din Moscow,2993,7,5,8,7,19,23,-4,23
FK Rubin,2993,8,5,6,9,21,18,3,21
Amkar,2993,9,5,5,10,11,23,-12,20
Rostov,2993,10,4,6,10,10,18,-8,18
Anzhi,2993,11,3,5,12,17,40,-23,14
Loko Moscow,2994,1,12,5,3,32,12,20,41
Spart Moscow,2994,2,10,6,4,37,25,12,36
CSKA Moscow,2994,3,10,4,6,27,20,7,34
Krasnodar,2994,4,9,4,7,30,28,2,31
Zenit,2994,5,7,9,4,22,17,5,30
Terek Grozny,2994,6,7,6,7,21,24,-3,27
FK Rubin,2994,7,7,5,8,28,20,8,26
Din Moscow,2994,8,5,6,9,18,26,-8,21
Amkar,2994,9,5,5,10,11,23,-12,20
Rostov,2994,10,4,6,10,10,19,-9,18
Anzhi,2994,11,3,6,11,16,38,-22,15
Loko Moscow,2995,1,12,6,2,32,12,20,42
Spart Moscow,2995,2,10,5,5,39,28,11,35
CSKA Moscow,2995,3,10,4,6,26,19,7,34
Zenit,2995,4,8,9,3,24,15,9,33
Krasnodar,2995,5,9,4,7,28,26,2,31
Terek Grozny,2995,6,7,7,6,20,22,-2,28
Din Moscow,2995,7,6,6,8,18,23,-5,24
FK Rubin,2995,8,6,5,9,23,18,5,23
Rostov,2995,9,4,6,10,11,19,-8,18
Amkar,2995,10,4,5,11,10,26,-16,17
Anzhi,2995,11,2,7,11,14,37,-23,13
Loko Moscow,2996,1,12,6,2,31,12,19,42
CSKA Moscow,2996,2,12,3,5,31,17,14,39
Spart Moscow,2996,3,8,7,5,36,29,7,31
Zenit,2996,4,7,9,4,22,15,7,30
Krasnodar,2996,5,8,4,8,28,27,1,28
Terek Grozny,2996,6,7,6,7,22,27,-5,27
Din Moscow,2996,7,6,7,7,20,23,-3,25
FK Rubin,2996,8,6,5,9,23,19,4,23
Amkar,2996,9,6,4,10,14,23,-9,22
Rostov,2996,10,4,7,9,11,18,-7,19
Anzhi,2996,11,2,6,12,15,43,-28,12
Loko Moscow,2997,1,11,7,2,31,13,18,40
CSKA Moscow,2997,2,12,3,5,29,18,11,39
Spart Moscow,2997,3,9,7,4,36,27,9,34
Krasnodar,2997,4,9,5,6,31,27,4,32
Zenit,2997,5,7,9,4,21,15,6,30
Terek Grozny,2997,6,8,5,7,24,25,-1,29
Din Moscow,2997,7,6,6,8,19,23,-4,24
FK Rubin,2997,8,5,5,10,22,20,2,20
Rostov,2997,9,4,7,9,11,18,-7,19
Amkar,2997,10,4,5,11,10,26,-16,17
Anzhi,2997,11,3,5,12,17,39,-22,14
Loko Moscow,2998,1,12,5,3,33,14,19,41
Spart Moscow,2998,2,10,5,5,41,28,13,35
Krasnodar,2998,3,10,4,6,33,26,7,34
CSKA Moscow,2998,4,10,4,6,26,21,5,34
Zenit,2998,5,7,9,4,23,17,6,30
Terek Grozny,2998,6,7,5,8,20,24,-4,26
Din Moscow,2998,7,6,6,8,20,23,-3,24
Amkar,2998,8,6,4,10,12,23,-11,22
FK Rubin,2998,9,5,5,10,23,24,-1,20
Rostov,2998,10,4,6,10,10,22,-12,18
Anzhi,2998,11,4,5,11,19,38,-19,17
Loko Moscow,2999,1,11,6,3,31,15,16,39
Spart Moscow,2999,2,10,6,4,41,26,15,36
Zenit,2999,3,9,8,3,24,13,11,35
CSKA Moscow,2999,4,10,4,6,27,20,7,34
Krasnodar,2999,5,9,5,6,31,26,5,32
Terek Grozny,2999,6,7,5,8,22,27,-5,26
FK Rubin,2999,7,6,5,9,24,21,3,23
Din Moscow,2999,8,5,6,9,19,29,-10,21
Amkar,2999,9,5,5,10,13,24,-11,20
Rostov,2999,10,4,6,10,11,20,-9,18
Anzhi,2999,11,3,6,11,17,39,-22,15
Loko Moscow,3000,1,11,6,3,30,14,16,39
CSKA Moscow,3000,2,11,3,6,28,20,8,36
Spart Moscow,3000,3,10,5,5,39,28,11,35
Zenit,3000,4,8,9,3,23,14,9,33
Krasnodar,3000,5,9,5,6,30,25,5,32
Terek Grozny,3000,6,7,6,7,20,23,-3,27
Din Moscow,3000,7,6,6,8,18,23,-5,24
FK Rubin,3000,8,5,6,9,22,19,3,21
Rostov,3000,9,5,6,9,13,19,-6,21
Amkar,3000,10,4,5,11,9,24,-15,17
Anzhi,3000,11,3,5,12,17,40,-23,14
Loko Moscow,3001,1,12,5,3,32,13,19,41
CSKA Moscow,3001,2,11,3,6,28,18,10,36
Spart Moscow,3001,3,10,5,5,39,28,11,35
Zenit,3001,4,9,8,3,24,14,10,35
Krasnodar,3001,5,9,4,7,29,26,3,31
Din Moscow,3001,6,7,6,7,21,22,-1,27
Terek Grozny,3001,7,7,5,8,22,27,-5,26
FK Rubin,3001,8,5,5,10,21,21,0,20
Amkar,3001,9,5,4,11,12,25,-13,19
Rostov,3001,10,4,6,10,11,20,-9,18
Anzhi,3001,11,3,5,12,16,41,-25,14
Loko Moscow,3002,1,11,6,3,29,12,17,39
CSKA Moscow,3002,2,11,4,5,26,17,9,37
Spart Moscow,3002,3,10,6,4,41,30,11,36
Zenit,3002,4,7,10,3,21,13,8,31
Krasnodar,3002,5,9,4,7,28,25,3,31
Terek Grozny,3002,6,8,5,7,23,25,-2,29
Din Moscow,3002,7,6,6,8,19,23,-4,24
FK Rubin,3002,8,6,5,9,22,18,4,23
Rostov,3002,9,4,7,9,13,20,-7,19
Amkar,3002,10,4,4,12,10,26,-16,16
Anzhi,3002,11,3,5,12,17,40,-23,14
Loko Moscow,3003,1,12,6,2,33,13,20,42
CSKA Moscow,3003,2,12,3,5,28,17,11,39
Spart Moscow,3003,3,10,5,5,37,27,10,35
Zenit,3003,4,7,8,5,22,17,5,29
Krasnodar,3003,5,8,5,7,28,28,0,29
Terek Grozny,3003,6,7,6,7,22,25,-3,27
FK Rubin,3003,7,6,6,8,25,18,7,24
Din Moscow,3003,8,5,7,8,18,24,-6,22
Amkar,3003,9,6,4,10,13,24,-11,22
Rostov,3003,10,4,6,10,10,18,-8,18
Anzhi,3003,11,2,6,12,15,40,-25,12
Loko Moscow,3004,1,11,6,3,30,13,17,39
CSKA Moscow,3004,2,12,3,5,28,17,11,39
Spart Moscow,3004,3,9,5,6,36,32,4,32
Krasnodar,3004,4,9,4,7,29,26,3,31
Zenit,3004,5,7,9,4,22,16,6,30
Terek Grozny,3004,6,8,5,7,22,23,-1,29
Din Moscow,3004,7,6,6,8,20,24,-4,24
FK Rubin,3004,8,6,5,9,24,21,3,23
Amkar,3004,9,6,4,10,15,22,-7,22
Rostov,3004,10,5,6,9,12,18,-6,21
Anzhi,3004,11,2,5,13,14,40,-26,11
Loko Moscow,3005,1,11,6,3,31,14,17,39
Spart Moscow,3005,2,11,5,4,39,25,14,38
CSKA Moscow,3005,3,11,4,5,28,19,9,37
Krasnodar,3005,4,10,4,6,32,25,7,34
Zenit,3005,5,7,10,3,23,15,8,31
Terek Grozny,3005,6,7,7,6,21,23,-2,28
Din Moscow,3005,7,5,7,8,18,25,-7,22
FK Rubin,3005,8,5,6,9,22,21,1,21
Rostov,3005,9,4,6,10,10,18,-8,18
Amkar,3005,10,4,5,11,10,25,-15,17
Anzhi,3005,11,2,6,12,15,39,-24,12
Loko Moscow,3006,1,11,6,3,31,14,17,39
Spart Moscow,3006,2,10,5,5,40,29,11,35
Zenit,3006,3,9,8,3,24,14,10,35
CSKA Moscow,3006,4,10,4,6,25,18,7,34
Krasnodar,3006,5,9,5,6,31,26,5,32
Terek Grozny,3006,6,7,5,8,20,26,-6,26
Din Moscow,3006,7,6,6,8,20,24,-4,24
Amkar,3006,8,6,4,10,14,23,-9,22
FK Rubin,3006,9,5,5,10,22,22,0,20
Rostov,3006,10,4,6,10,11,20,-9,18
Anzhi,3006,11,3,6,11,15,37,-22,15
Loko Moscow,3007,1,13,5,2,33,13,20,44
CSKA Moscow,3007,2,11,3,6,31,20,11,36
Spart Moscow,3007,3,10,5,5,35,26,9,35
Zenit,3007,4,8,8,4,24,16,8,32
Terek Grozny,3007,5,9,5,6,23,23,0,32
Krasnodar,3007,6,8,4,8,29,28,1,28
Din Moscow,3007,7,6,6,8,19,23,-4,24
FK Rubin,3007,8,6,5,9,24,20,4,23
Amkar,3007,9,5,4,11,10,23,-13,19
Rostov,3007,10,4,6,10,10,18,-8,18
Anzhi,3007,11,2,5,13,16,44,-28,11
Loko Moscow,3008,1,11,7,2,30,12,18,40
CSKA Moscow,3008,2,11,3,6,27,21,6,36
Spart Moscow,3008,3,9,7,4,38,29,9,34
Zenit,3008,4,8,9,3,25,13,12,33
Krasnodar,3008,5,9,5,6,29,25,4,32
Terek Grozny,3008,6,9,5,6,24,23,1,32
Din Moscow,3008,7,5,7,8,18,23,-5,22
FK Rubin,3008,8,5,6,9,21,18,3,21
Rostov,3008,9,4,7,9,12,19,-7,19
Amkar,3008,10,4,5,11,11,25,-14,17
Anzhi,3008,11,2,5,13,14,41,-27,11
Loko Moscow,3009,1,13,5,2,35,12,23,44
Spart Moscow,3009,2,9,7,4,36,26,10,34
CSKA Moscow,3009,3,10,4,6,27,21,6,34
Zenit,3009,4,8,8,4,23,17,6,32
Krasnodar,3009,5,8,5,7,28,26,2,29
Terek Grozny,3009,6,8,5,7,22,24,-2,29
FK Rubin,3009,7,6,6,8,22,17,5,24
Din Moscow,3009,8,5,7,8,17,22,-5,22
Rostov,3009,9,4,7,9,11,18,-7,19
Amkar,3009,10,5,4,11,10,24,-14,19
Anzhi,3009,11,2,6,12,17,41,-24,12
Loko Moscow,3010,1,12,6,2,31,12,19,42
CSKA Moscow,3010,2,10,4,6,29,22,7,34
Zenit,3010,3,8,9,3,24,15,9,33
Spart Moscow,3010,4,9,6,5,35,29,6,33
Terek Grozny,3010,5,8,5,7,22,25,-3,29
Krasnodar,3010,6,8,4,8,29,28,1,28
FK Rubin,3010,7,6,6,8,23,18,5,24
Din Moscow,3010,8,5,8,7,17,21,-4,23
Amkar,3010,9,5,4,11,12,24,-12,19
Rostov,3010,10,4,6,10,11,19,-8,18
Anzhi,3010,11,3,6,11,19,39,-20,15
Loko Moscow,3011,1,12,5,3,32,12,20,41
CSKA Moscow,3011,2,12,3,5,30,18,12,39
Spart Moscow,3011,3,10,5,5,39,31,8,35
Krasnodar,3011,4,10,4,6,30,24,6,34
Terek Grozny,3011,5,8,6,6,26,24,2,30
Zenit,3011,6,7,8,5,21,19,2,29
Din Moscow,3011,7,6,6,8,19,23,-4,24
FK Rubin,3011,8,5,5,10,21,20,1,20
Amkar,3011,9,5,4,11,13,27,-14,19
Rostov,3011,10,4,6,10,11,20,-9,18
Anzhi,3011,11,2,6,12,17,41,-24,12
Loko Moscow,3012,1,13,5,2,33,12,21,44
CSKA Moscow,3012,2,10,5,5,27,19,8,35
Spart Moscow,3012,3,8,7,5,36,29,7,31
Zenit,3012,4,7,9,4,23,17,6,30
Krasnodar,3012,5,8,5,7,29,27,2,29
Terek Grozny,3012,6,7,6,7,21,24,-3,27
Din Moscow,3012,7,6,7,7,20,23,-3,25
FK Rubin,3012,8,5,7,8,23,19,4,22
Amkar,3012,9,5,5,10,11,23,-12,20
Rostov,3012,10,4,7,9,11,18,-7,19
Anzhi,3012,11,2,7,11,15,38,-23,13
Loko Moscow,3013,1,11,6,3,30,13,17,39
Spart Moscow,3013,2,10,6,4,37,26,11,36
CSKA Moscow,3013,3,10,4,6,26,20,6,34
Zenit,3013,4,8,9,3,24,14,10,33
Krasnodar,3013,5,9,4,7,28,25,3,31
Terek Grozny,3013,6,8,5,7,25,25,0,29
FK Rubin,3013,7,7,5,8,23,17,6,26
Din Moscow,3013,8,5,6,9,17,23,-6,21
Rostov,3013,9,4,6,10,11,20,-9,18
Amkar,3013,10,4,5,11,10,26,-16,17
Anzhi,3013,11,3,6,11,17,39,-22,15
Loko Moscow,3014,1,12,5,3,31,14,17,41
Spart Moscow,3014,2,11,5,4,41,26,15,38
CSKA Moscow,3014,3,11,3,6,27,19,8,36
Zenit,3014,4,8,8,4,23,14,9,32
Terek Grozny,3014,5,8,6,6,22,23,-1,30
Krasnodar,3014,6,8,5,7,29,27,2,29
FK Rubin,3014,7,5,7,8,22,18,4,22
Din Moscow,3014,8,5,7,8,17,24,-7,22
Rostov,3014,9,4,6,10,10,19,-9,18
Amkar,3014,10,4,4,12,11,27,-16,16
Anzhi,3014,11,3,6,11,16,38,-22,15
Loko Moscow,3015,1,12,5,3,30,12,18,41
CSKA Moscow,3015,2,11,4,5,28,19,9,37
Spart Moscow,3015,3,9,7,4,36,27,9,34
Krasnodar,3015,4,9,5,6,28,24,4,32
Zenit,3015,5,7,8,5,21,15,6,29
Terek Grozny,3015,6,7,7,6,20,22,-2,28
Din Moscow,3015,7,6,7,7,22,23,-1,25
FK Rubin,3015,8,5,6,9,21,20,1,21
Rostov,3015,9,4,7,9,10,17,-7,19
Amkar,3015,10,4,5,11,9,23,-14,17
Anzhi,3015,11,2,7,11,16,39,-23,13
Loko Moscow,3016,1,12,6,2,33,12,21,42
CSKA Moscow,3016,2,11,4,5,30,20,10,37
Spart Moscow,3016,3,10,6,4,36,25,11,36
Krasnodar,3016,4,9,5,6,28,24,4,32
Zenit,3016,5,7,9,4,22,17,5,30
Terek Grozny,3016,6,8,5,7,22,24,-2,29
Din Moscow,3016,7,6,6,8,18,22,-4,24
FK Rubin,3016,8,5,5,10,21,19,2,20
Rostov,3016,9,4,7,9,10,17,-7,19
Amkar,3016,10,4,4,12,9,26,-17,16
Anzhi,3016,11,3,5,12,19,42,-23,14
Loko Moscow,3017,1,13,5,2,31,11,20,44
Spart Moscow,3017,2,10,6,4,38,27,11,36
CSKA Moscow,3017,3,11,3,6,28,19,9,36
Zenit,3017,4,8,8,4,23,14,9,32
Krasnodar,3017,5,8,4,8,28,27,1,28
Terek Grozny,3017,6,7,6,7,21,25,-4,27
FK Rubin,3017,7,7,5,8,24,18,6,26
Din Moscow,3017,8,5,7,8,18,23,-5,22
Amkar,3017,9,5,4,11,11,23,-12,19
Rostov,3017,10,4,6,10,11,20,-9,18
Anzhi,3017,11,2,6,12,15,41,-26,12
Loko Moscow,3018,1,12,6,2,32,12,20,42
Spart Moscow,3018,2,11,5,4,42,27,15,38
CSKA Moscow,3018,3,10,5,5,26,18,8,35
Zenit,3018,4,7,9,4,22,16,6,30
Krasnodar,3018,5,8,5,7,28,27,1,29
FK Rubin,3018,6,7,5,8,24,17,7,26
Terek Grozny,3018,7,7,5,8,22,26,-4,26
Din Moscow,3018,8,5,6,9,17,26,-9,21
Amkar,3018,9,5,4,11,11,25,-14,19
Rostov,3018,10,4,6,10,11,19,-8,18
Anzhi,3018,11,3,6,11,17,39,-22,15
Loko Moscow,3019,1,11,6,3,31,16,15,39
CSKA Moscow,3019,2,11,4,5,29,19,10,37
Spart Moscow,3019,3,10,5,5,39,28,11,35
Zenit,3019,4,7,10,3,25,17,8,31
Krasnodar,3019,5,9,4,7,31,28,3,31
Terek Grozny,3019,6,8,5,7,23,25,-2,29
Din Moscow,3019,7,6,6,8,19,25,-6,24
FK Rubin,3019,8,6,5,9,25,19,6,23
Amkar,3019,9,5,4,11,11,24,-13,19
Rostov,3019,10,4,6,10,11,19,-8,18
Anzhi,3019,11,3,5,12,16,40,-24,14
Loko Moscow,3020,1,12,5,3,33,15,18,41
Spart Moscow,3020,2,11,5,4,40,28,12,38
CSKA Moscow,3020,3,10,4,6,27,21,6,34
Zenit,3020,4,8,8,4,25,17,8,32
Krasnodar,3020,5,9,4,7,32,28,4,31
Terek Grozny,3020,6,7,6,7,21,26,-5,27
FK Rubin,3020,7,6,6,8,23,18,5,24
Din Moscow,3020,8,5,7,8,18,23,-5,22
Rostov,3020,9,4,6,10,11,20,-9,18
Amkar,3020,10,4,5,11,11,25,-14,17
Anzhi,3020,11,3,6,11,17,37,-20,15
Loko Moscow,3021,1,12,6,2,34,12,22,42
Spart Moscow,3021,2,11,5,4,41,27,14,38
CSKA Moscow,3021,3,11,3,6,27,18,9,36
Zenit,3021,4,8,9,3,22,13,9,33
Krasnodar,3021,5,9,4,7,30,29,1,31
Terek Grozny,3021,6,8,6,6,26,26,0,30
Din Moscow,3021,7,6,6,8,19,23,-4,24
FK Rubin,3021,8,5,5,10,21,21,0,20
Rostov,3021,9,4,6,10,10,20,-10,18
Amkar,3021,10,4,5,11,12,26,-14,17
Anzhi,3021,11,2,5,13,17,44,-27,11
Loko Moscow,3022,1,12,5,3,32,14,18,41
CSKA Moscow,3022,2,11,4,5,26,17,9,37
Spart Moscow,3022,3,10,5,5,37,28,9,35
Krasnodar,3022,4,10,4,6,34,25,9,34
Zenit,3022,5,7,9,4,22,15,7,30
Terek Grozny,3022,6,8,5,7,21,24,-3,29
Din Moscow,3022,7,6,6,8,20,24,-4,24
Amkar,3022,8,6,4,10,12,22,-10,22
FK Rubin,3022,9,5,5,10,21,23,-2,20
Rostov,3022,10,4,6,10,10,18,-8,18
Anzhi,3022,11,2,5,13,14,39,-25,11
Loko Moscow,3023,1,13,5,2,33,12,21,44
Spart Moscow,3023,2,10,5,5,37,26,11,35
CSKA Moscow,3023,3,10,4,6,25,18,7,34
Krasnodar,3023,4,9,4,7,33,26,7,31
Zenit,3023,5,7,9,4,21,15,6,30
Terek Grozny,3023,6,7,6,7,21,24,-3,27
FK Rubin,3023,7,6,5,9,23,23,0,23
Din Moscow,3023,8,5,6,9,18,24,-6,21
Amkar,3023,9,5,5,10,10,22,-12,20
Rostov,3023,10,4,6,10,10,20,-10,18
Anzhi,3023,11,4,5,11,17,38,-21,17
Loko Moscow,3024,1,11,6,3,31,16,15,39
Spart Moscow,3024,2,10,6,4,38,26,12,36
Zenit,3024,3,9,8,3,26,13,13,35
CSKA Moscow,3024,4,10,3,7,26,21,5,33
Krasnodar,3024,5,8,6,6,30,27,3,30
Terek Grozny,3024,6,7,5,8,21,25,-4,26
Din Moscow,3024,7,6,6,8,19,24,-5,24
FK Rubin,3024,8,5,6,9,23,20,3,21
Rostov,3024,9,4,7,9,10,17,-7,19
Amkar,3024,10,5,4,11,12,26,-14,19
Anzhi,3024,11,4,5,11,17,38,-21,17
Loko Moscow,3025,1,11,7,2,30,12,18,40
CSKA Moscow,3025,2,12,3,5,28,18,10,39
Spart Moscow,3025,3,10,5,5,41,30,11,35
Krasnodar,3025,4,9,5,6,29,25,4,32
Zenit,3025,5,7,9,4,22,15,7,30
Terek Grozny,3025,6,7,7,6,21,23,-2,28
FK Rubin,3025,7,6,5,9,24,19,5,23
Din Moscow,3025,8,5,6,9,19,29,-10,21
Amkar,3025,9,5,5,10,13,24,-11,20
Rostov,3025,10,4,6,10,11,19,-8,18
Anzhi,3025,11,2,6,12,14,38,-24,12
Loko Moscow,3026,1,12,6,2,34,12,22,42
Spart Moscow,3026,2,11,5,4,41,26,15,38
CSKA Moscow,3026,3,10,5,5,27,19,8,35
Zenit,3026,4,7,10,3,23,15,8,31
Terek Grozny,3026,5,8,5,7,24,25,-1,29
Krasnodar,3026,6,8,4,8,27,30,-3,28
FK Rubin,3026,7,7,5,8,25,18,7,26
Din Moscow,3026,8,5,6,9,18,25,-7,21
Amkar,3026,9,5,4,11,12,27,-15,19
Rostov,3026,10,4,6,10,10,19,-9,18
Anzhi,3026,11,2,6,12,16,41,-25,12
Loko Moscow,3027,1,12,6,2,34,15,19,42
CSKA Moscow,3027,2,10,5,5,28,20,8,35
Spart Moscow,3027,3,9,6,5,36,27,9,33
Zenit,3027,4,7,9,4,24,17,7,30
Krasnodar,3027,5,8,6,6,31,28,3,30
Terek Grozny,3027,6,7,6,7,21,25,-4,27
FK Rubin,3027,7,6,6,8,23,18,5,24
Din Moscow,3027,8,6,6,8,19,23,-4,24
Amkar,3027,9,5,5,10,11,22,-11,20
Rostov,3027,10,4,6,10,10,19,-9,18
Anzhi,3027,11,2,7,11,16,39,-23,13
Loko Moscow,3028,1,12,5,3,30,12,18,41
CSKA Moscow,3028,2,11,4,5,28,18,10,37
Zenit,3028,3,8,9,3,23,14,9,33
Spart Moscow,3028,4,9,5,6,35,28,7,32
Terek Grozny,3028,5,9,5,6,22,22,0,32
Krasnodar,3028,6,8,4,8,29,29,0,28
FK Rubin,3028,7,6,6,8,26,20,6,24
Din Moscow,3028,8,5,7,8,18,23,-5,22
Rostov,3028,9,5,6,9,12,18,-6,21
Amkar,3028,10,5,4,11,10,23,-13,19
Anzhi,3028,11,2,5,13,14,40,-26,11
Loko Moscow,3029,1,13,5,2,31,11,20,44
CSKA Moscow,3029,2,10,4,6,27,20,7,34
Spart Moscow,3029,3,9,5,6,34,27,7,32
Zenit,3029,4,7,9,4,22,15,7,30
Krasnodar,3029,5,8,5,7,27,25,2,29
Terek Grozny,3029,6,8,5,7,23,26,-3,29
FK Rubin,3029,7,5,7,8,21,17,4,22
Din Moscow,3029,8,5,7,8,17,22,-5,22
Rostov,3029,9,5,6,9,11,17,-6,21
Amkar,3029,10,5,4,11,12,25,-13,19
Anzhi,3029,11,4,5,11,18,38,-20,17
Loko Moscow,3030,1,12,5,3,30,13,17,41
Krasnodar,3030,2,10,4,6,30,24,6,34
CSKA Moscow,3030,3,10,3,7,26,20,6,33
Zenit,3030,4,8,8,4,22,14,8,32
Spart Moscow,3030,5,8,6,6,39,33,6,30
Terek Grozny,3030,6,8,5,7,22,25,-3,29
Din Moscow,3030,7,7,6,7,22,24,-2,27
Amkar,3030,8,6,4,10,13,23,-10,22
FK Rubin,3030,9,5,5,10,21,19,2,20
Rostov,3030,10,4,7,9,13,20,-7,19
Anzhi,3030,11,3,5,12,16,39,-23,14
Loko Moscow,3031,1,11,6,3,30,13,17,39
Spart Moscow,3031,2,11,5,4,41,27,14,38
CSKA Moscow,3031,3,11,4,5,27,17,10,37
Zenit,3031,4,8,9,3,22,13,9,33
Krasnodar,3031,5,8,5,7,30,28,2,29
Terek Grozny,3031,6,8,5,7,22,26,-4,29
Din Moscow,3031,7,6,6,8,21,25,-4,24
FK Rubin,3031,8,6,5,9,25,22,3,23
Rostov,3031,9,4,6,10,10,19,-9,18
Amkar,3031,10,4,4,12,11,27,-16,16
Anzhi,3031,11,3,5,12,17,39,-22,14
Loko Moscow,3032,1,13,5,2,34,12,22,44
CSKA Moscow,3032,2,10,4,6,26,20,6,34
Zenit,3032,3,8,8,4,24,15,9,32
Krasnodar,3032,4,9,4,7,29,28,1,31
Spart Moscow,3032,5,8,6,6,34,29,5,30
Terek Grozny,3032,6,8,5,7,23,26,-3,29
Din Moscow,3032,7,6,7,7,18,21,-3,25
Amkar,3032,8,6,4,10,15,24,-9,22
FK Rubin,3032,9,5,6,9,22,19,3,21
Rostov,3032,10,4,7,9,11,18,-7,19
Anzhi,3032,11,2,6,12,15,39,-24,12
Loko Moscow,3033,1,12,6,2,34,15,19,42
CSKA Moscow,3033,2,12,3,5,30,19,11,39
Spart Moscow,3033,3,10,6,4,38,28,10,36
Krasnodar,3033,4,9,4,7,30,27,3,31
Zenit,3033,5,7,9,4,24,17,7,30
Terek Grozny,3033,6,8,5,7,23,25,-2,29
Din Moscow,3033,7,5,8,7,20,24,-4,23
FK Rubin,3033,8,5,6,9,23,20,3,21
Rostov,3033,9,4,6,10,10,18,-8,18
Amkar,3033,10,4,4,12,11,27,-16,16
Anzhi,3033,11,3,5,12,18,41,-23,14
Loko Moscow,3034,1,12,6,2,30,11,19,42
CSKA Moscow,3034,2,11,4,5,26,17,9,37
Spart Moscow,3034,3,10,5,5,40,29,11,35
Zenit,3034,4,7,10,3,21,13,8,31
Krasnodar,3034,5,9,4,7,30,25,5,31
Terek Grozny,3034,6,8,5,7,23,26,-3,29
Din Moscow,3034,7,6,6,8,20,24,-4,24
Rostov,3034,8,5,6,9,12,18,-6,21
FK Rubin,3034,9,5,5,10,21,23,-2,20
Amkar,3034,10,5,4,11,13,25,-12,19
Anzhi,3034,11,2,5,13,16,41,-25,11
Loko Moscow,3035,1,12,6,2,33,12,21,42
Spart Moscow,3035,2,10,6,4,38,27,11,36
CSKA Moscow,3035,3,11,3,6,27,19,8,36
Zenit,3035,4,8,9,3,22,13,9,33
Krasnodar,3035,5,9,4,7,29,28,1,31
Terek Grozny,3035,6,8,6,6,22,23,-1,30
FK Rubin,3035,7,6,5,9,22,18,4,23
Din Moscow,3035,8,5,6,9,17,23,-6,21
Rostov,3035,9,4,7,9,11,18,-7,19
Amkar,3035,10,4,5,11,10,25,-15,17
Anzhi,3035,11,2,5,13,16,41,-25,11
Loko Moscow,3036,1,11,5,4,30,14,16,38
Spart Moscow,3036,2,10,6,4,40,27,13,36
CSKA Moscow,3036,3,10,5,5,29,21,8,35
Krasnodar,3036,4,10,4,6,31,26,5,34
Zenit,3036,5,8,9,3,24,15,9,33
Terek Grozny,3036,6,7,5,8,20,25,-5,26
Din Moscow,3036,7,6,7,7,21,23,-2,25
FK Rubin,3036,8,5,5,10,23,22,1,20
Amkar,3036,9,5,4,11,12,24,-12,19
Rostov,3036,10,4,6,10,10,21,-11,18
Anzhi,3036,11,3,6,11,17,39,-22,15
Loko Moscow,3037,1,12,5,3,32,13,19,41
Zenit,3037,2,9,8,3,25,14,11,35
Spart Moscow,3037,3,9,6,5,35,29,6,33
CSKA Moscow,3037,4,10,3,7,25,22,3,33
Terek Grozny,3037,5,8,5,7,23,25,-2,29
Krasnodar,3037,6,8,4,8,28,28,0,28
Din Moscow,3037,7,6,7,7,19,22,-3,25
FK Rubin,3037,8,6,5,9,23,19,4,23
Amkar,3037,9,5,4,11,14,25,-11,19
Rostov,3037,10,4,6,10,10,18,-8,18
Anzhi,3037,11,4,5,11,18,37,-19,17
Loko Moscow,3038,1,12,6,2,32,13,19,42
Spart Moscow,3038,2,11,5,4,37,26,11,38
CSKA Moscow,3038,3,11,3,6,28,21,7,36
Zenit,3038,4,8,9,3,26,15,11,33
Krasnodar,3038,5,9,4,7,32,26,6,31
Terek Grozny,3038,6,8,6,6,25,25,0,30
Din Moscow,3038,7,6,6,8,20,23,-3,24
FK Rubin,3038,8,5,5,10,21,23,-2,20
Rostov,3038,9,4,6,10,10,18,-8,18
Amkar,3038,10,4,4,12,10,26,-16,16
Anzhi,3038,11,2,6,12,16,41,-25,12
Loko Moscow,3039,1,11,7,2,32,14,18,40
CSKA Moscow,3039,2,11,3,6,28,19,9,36
Zenit,3039,3,8,9,3,25,15,10,33
Spart Moscow,3039,4,9,6,5,35,27,8,33
Krasnodar,3039,5,8,6,6,30,27,3,30
Terek Grozny,3039,6,7,5,8,20,25,-5,26
FK Rubin,3039,7,5,7,8,23,19,4,22
Din Moscow,3039,8,5,7,8,17,22,-5,22
Rostov,3039,9,5,6,9,11,17,-6,21
Amkar,3039,10,5,5,10,11,23,-12,20
Anzhi,3039,11,3,5,12,16,40,-24,14
Loko Moscow,3040,1,12,5,3,32,14,18,41
CSKA Moscow,3040,2,12,3,5,29,17,12,39
Zenit,3040,3,8,8,4,22,14,8,32
Krasnodar,3040,4,9,4,7,31,28,3,31
Spart Moscow,3040,5,8,6,6,38,32,6,30
Terek Grozny,3040,6,8,6,6,21,22,-1,30
Din Moscow,3040,7,6,6,8,19,23,-4,24
FK Rubin,3040,8,6,5,9,23,19,4,23
Rostov,3040,9,5,6,9,13,19,-6,21
Amkar,3040,10,4,5,11,11,25,-14,17
Anzhi,3040,11,2,6,12,14,40,-26,12
Loko Moscow,3041,1,11,6,3,32,16,16,39
Spart Moscow,3041,2,10,6,4,38,27,11,36
CSKA Moscow,3041,3,11,3,6,29,20,9,36
Zenit,3041,4,8,9,3,24,15,9,33
Krasnodar,3041,5,9,5,6,30,25,5,32
Terek Grozny,3041,6,7,6,7,20,25,-5,27
Din Moscow,3041,7,6,6,8,19,23,-4,24
FK Rubin,3041,8,5,6,9,21,18,3,21
Rostov,3041,9,4,7,9,11,18,-7,19
Amkar,3041,10,5,4,11,12,24,-12,19
Anzhi,3041,11,2,6,12,16,41,-25,12
Loko Moscow,3042,1,12,5,3,30,12,18,41
CSKA Moscow,3042,2,11,3,6,26,19,7,36
Krasnodar,3042,3,10,4,6,30,25,5,34
Spart Moscow,3042,4,9,6,5,37,30,7,33
Zenit,3042,5,8,8,4,23,14,9,32
Terek Grozny,3042,6,7,6,7,20,24,-4,27
Din Moscow,3042,7,6,6,8,18,22,-4,24
Rostov,3042,8,5,6,9,12,17,-5,21
FK Rubin,3042,9,5,5,10,22,20,2,20
Amkar,3042,10,5,5,10,14,25,-11,20
Anzhi,3042,11,2,6,12,14,38,-24,12
Loko Moscow,3043,1,11,5,4,31,16,15,38
Zenit,3043,2,9,8,3,25,14,11,35
Krasnodar,3043,3,10,4,6,33,26,7,34
Spart Moscow,3043,4,9,6,5,37,26,11,33
CSKA Moscow,3043,5,10,3,7,27,22,5,33
Din Moscow,3043,6,7,6,7,21,22,-1,27
Terek Grozny,3043,7,7,6,7,21,25,-4,27
FK Rubin,3043,8,5,5,10,23,23,0,20
Rostov,3043,9,4,6,10,10,21,-11,18
Amkar,3043,10,4,6,10,10,23,-13,18
Anzhi,3043,11,4,5,11,19,39,-20,17
Loko Moscow,3044,1,11,7,2,31,13,18,40
CSKA Moscow,3044,2,12,3,5,29,19,10,39
Spart Moscow,3044,3,10,6,4,39,26,13,36
Krasnodar,3044,4,9,5,6,31,25,6,32
Zenit,3044,5,7,9,4,23,16,7,30
Terek Grozny,3044,6,7,7,6,21,23,-2,28
Din Moscow,3044,7,6,6,8,20,23,-3,24
FK Rubin,3044,8,5,5,10,21,23,-2,20
Rostov,3044,9,4,6,10,11,21,-10,18
Amkar,3044,10,4,6,10,9,22,-13,18
Anzhi,3044,11,2,6,12,16,40,-24,12
Loko Moscow,3045,1,11,5,4,30,14,16,38
CSKA Moscow,3045,2,10,4,6,25,18,7,34
Krasnodar,3045,3,10,4,6,31,25,6,34
Zenit,3045,4,8,9,3,22,13,9,33
Terek Grozny,3045,5,9,5,6,26,22,4,32
Spart Moscow,3045,6,8,7,5,35,28,7,31
Din Moscow,3045,7,6,6,8,19,23,-4,24
FK Rubin,3045,8,6,5,9,22,19,3,23
Rostov,3045,9,4,7,9,10,17,-7,19
Amkar,3045,10,4,5,11,10,27,-17,17
Anzhi,3045,11,3,5,12,15,39,-24,14
Loko Moscow,3046,1,11,6,3,30,13,17,39
CSKA Moscow,3046,2,11,3,6,27,19,8,36
Spart Moscow,3046,3,9,7,4,39,26,13,34
Krasnodar,3046,4,10,4,6,31,26,5,34
Zenit,3046,5,8,9,3,23,14,9,33
Terek Grozny,3046,6,8,5,7,24,23,1,29
FK Rubin,3046,7,6,5,9,24,19,5,23
Din Moscow,3046,8,5,6,9,17,28,-11,21
Amkar,3046,9,5,5,10,11,23,-12,20
Rostov,3046,10,4,7,9,10,17,-7,19
Anzhi,3046,11,2,5,13,14,42,-28,11
Loko Moscow,3047,1,13,5,2,33,11,22,44
CSKA Moscow,3047,2,10,4,6,27,21,6,34
Spart Moscow,3047,3,9,6,5,38,30,8,33
Zenit,3047,4,7,9,4,21,15,6,30
Terek Grozny,3047,5,8,6,6,21,22,-1,30
Krasnodar,3047,6,8,4,8,27,27,0,28
Din Moscow,3047,7,6,7,7,23,25,-2,25
FK Rubin,3047,8,6,5,9,23,20,3,23
Rostov,3047,9,5,6,9,11,17,-6,21
Amkar,3047,10,4,5,11,10,24,-14,17
Anzhi,3047,11,3,5,12,18,40,-22,14
Loko Moscow,3048,1,11,7,2,33,15,18,40
Spart Moscow,3048,2,11,5,4,39,26,13,38
CSKA Moscow,3048,3,10,4,6,28,21,7,34
Zenit,3048,4,8,9,3,26,17,9,33
Krasnodar,3048,5,8,6,6,30,27,3,30
Terek Grozny,3048,6,8,6,6,23,24,-1,30
Din Moscow,3048,7,6,6,8,18,23,-5,24
FK Rubin,3048,8,5,6,9,22,19,3,21
Rostov,3048,9,4,6,10,11,19,-8,18
Amkar,3048,10,4,5,11,10,25,-15,17
Anzhi,3048,11,2,6,12,16,40,-24,12
Loko Moscow,3049,1,12,6,2,32,13,19,42
CSKA Moscow,3049,2,11,3,6,29,20,9,36
Zenit,3049,3,8,9,3,23,14,9,33
Spart Moscow,3049,4,8,6,6,34,30,4,30
Krasnodar,3049,5,8,5,7,28,26,2,29
Terek Grozny,3049,6,7,5,8,21,25,-4,26
FK Rubin,3049,7,6,6,8,23,18,5,24
Din Moscow,3049,8,5,7,8,19,24,-5,22
Amkar,3049,9,6,4,10,14,23,-9,22
Rostov,3049,10,5,6,9,11,17,-6,21
Anzhi,3049,11,3,5,12,17,41,-24,14
Loko Moscow,3050,1,12,5,3,31,12,19,41
CSKA Moscow,3050,2,11,3,6,29,20,9,36
Zenit,3050,3,9,8,3,25,14,11,35
Spart Moscow,3050,4,9,6,5,37,30,7,33
Krasnodar,3050,5,8,5,7,27,26,1,29
Terek Grozny,3050,6,7,7,6,22,24,-2,28
Din Moscow,3050,7,6,7,7,20,21,-1,25
FK Rubin,3050,8,5,7,8,21,17,4,22
Rostov,3050,9,4,7,9,12,19,-7,19
Amkar,3050,10,4,5,11,9,24,-15,17
Anzhi,3050,11,2,6,12,16,42,-26,12
Loko Moscow,3051,1,11,6,3,31,15,16,39
CSKA Moscow,3051,2,11,4,5,28,18,10,37
Spart Moscow,3051,3,9,5,6,37,31,6,32
Zenit,3051,4,7,10,3,23,15,8,31
Krasnodar,3051,5,9,4,7,30,26,4,31
Terek Grozny,3051,6,8,5,7,22,25,-3,29
Din Moscow,3051,7,6,6,8,19,23,-4,24
FK Rubin,3051,8,6,5,9,22,19,3,23
Amkar,3051,9,6,4,10,14,22,-8,22
Rostov,3051,10,5,6,9,13,19,-6,21
Anzhi,3051,11,2,5,13,15,41,-26,11
Loko Moscow,3052,1,13,5,2,35,12,23,44
Spart Moscow,3052,2,10,5,5,41,30,11,35
CSKA Moscow,3052,3,10,4,6,25,19,6,34
Zenit,3052,4,8,8,4,23,14,9,32
Terek Grozny,3052,5,9,5,6,25,23,2,32
Krasnodar,3052,6,8,5,7,29,30,-1,29
FK Rubin,3052,7,6,6,8,24,18,6,24
Din Moscow,3052,8,5,6,9,18,26,-8,21
Amkar,3052,9,5,4,11,12,26,-14,19
Rostov,3052,10,4,6,10,12,21,-9,18
Anzhi,3052,11,2,6,12,14,39,-25,12
Loko Moscow,3053,1,13,5,2,34,13,21,44
CSKA Moscow,3053,2,11,4,5,28,18,10,37
Spart Moscow,3053,3,8,7,5,36,29,7,31
Zenit,3053,4,7,8,5,23,19,4,29
Krasnodar,3053,5,8,5,7,31,29,2,29
Terek Grozny,3053,6,7,5,8,20,27,-7,26
Din Moscow,3053,7,6,7,7,19,22,-3,25
FK Rubin,3053,8,5,6,9,24,21,3,21
Rostov,3053,9,5,6,9,13,19,-6,21
Amkar,3053,10,5,5,10,11,22,-11,20
Anzhi,3053,11,3,6,11,17,37,-20,15
Loko Moscow,3054,1,12,6,2,32,13,19,42
CSKA Moscow,3054,2,12,3,5,30,19,11,39
Spart Moscow,3054,3,10,5,5,39,27,12,35
Zenit,3054,4,7,8,5,24,18,6,29
Krasnodar,3054,5,8,5,7,27,25,2,29
Terek Grozny,3054,6,8,5,7,21,25,-4,29
FK Rubin,3054,7,6,6,8,22,17,5,24
Din Moscow,3054,8,5,7,8,17,23,-6,22
Amkar,3054,9,5,4,11,11,24,-13,19
Rostov,3054,10,4,6,10,10,20,-10,18
Anzhi,3054,11,3,5,12,18,40,-22,14
Loko Moscow,3055,1,12,6,2,32,12,20,42
CSKA Moscow,3055,2,11,3,6,30,21,9,36
Spart Moscow,3055,3,9,7,4,39,27,12,34
Zenit,3055,4,8,9,3,24,14,10,33
Krasnodar,3055,5,8,5,7,29,28,1,29
Terek Grozny,3055,6,8,5,7,22,24,-2,29
Din Moscow,3055,7,6,6,8,20,26,-6,24
FK Rubin,3055,8,5,6,9,23,21,2,21
Rostov,3055,9,4,7,9,12,19,-7,19
Amkar,3055,10,4,5,11,9,23,-14,17
Anzhi,3055,11,3,5,12,17,42,-25,14
Loko Moscow,3056,1,13,5,2,33,13,20,44
CSKA Moscow,3056,2,11,3,6,28,20,8,36
Spart Moscow,3056,3,9,6,5,36,27,9,33
Zenit,3056,4,7,8,5,23,17,6,29
Krasnodar,3056,5,8,4,8,31,30,1,28
Terek Grozny,3056,6,7,6,7,22,25,-3,27
FK Rubin,3056,7,6,6,8,25,20,5,24
Din Moscow,3056,8,5,8,7,18,22,-4,23
Amkar,3056,9,5,5,10,12,24,-12,20
Rostov,3056,10,4,6,10,10,19,-9,18
Anzhi,3056,11,4,5,11,17,38,-21,17
Loko Moscow,3057,1,12,6,2,32,12,20,42
Spart Moscow,3057,2,11,5,4,41,28,13,38
CSKA Moscow,3057,3,11,3,6,28,19,9,36
Zenit,3057,4,8,8,4,23,15,8,32
Krasnodar,3057,5,8,5,7,29,27,2,29
Terek Grozny,3057,6,8,5,7,22,25,-3,29
Din Moscow,3057,7,6,6,8,19,23,-4,24
FK Rubin,3057,8,6,5,9,23,19,4,23
Rostov,3057,9,4,6,10,12,20,-8,18
Amkar,3057,10,4,4,12,10,27,-17,16
Anzhi,3057,11,3,5,12,16,40,-24,14
Loko Moscow,3058,1,12,5,3,31,17,14,41
CSKA Moscow,3058,2,11,3,6,31,19,12,36
Spart Moscow,3058,3,9,6,5,39,31,8,33
Zenit,3058,4,8,8,4,24,15,9,32
Krasnodar,3058,5,9,4,7,33,27,6,31
Terek Grozny,3058,6,7,5,8,21,27,-6,26
FK Rubin,3058,7,6,6,8,25,19,6,24
Din Moscow,3058,8,5,8,7,21,25,-4,23
Rostov,3058,9,5,6,9,13,19,-6,21
Amkar,3058,10,5,4,11,11,24,-13,19
Anzhi,3058,11,3,5,12,17,43,-26,14
Loko Moscow,3059,1,12,6,2,33,14,19,42
Spart Moscow,3059,2,10,6,4,40,29,11,36
CSKA Moscow,3059,3,10,4,6,26,20,6,34
Zenit,3059,4,7,10,3,22,14,8,31
Krasnodar,3059,5,9,4,7,32,28,4,31
Terek Grozny,3059,6,8,5,7,22,24,-2,29
FK Rubin,3059,7,6,5,9,26,20,6,23
Din Moscow,3059,8,5,6,9,18,27,-9,21
Rostov,3059,9,4,7,9,12,19,-7,19
Amkar,3059,10,5,4,11,13,26,-13,19
Anzhi,3059,11,3,5,12,16,39,-23,14
Loko Moscow,3060,1,12,5,3,35,16,19,41
CSKA Moscow,3060,2,12,3,5,28,18,10,39
Spart Moscow,3060,3,9,5,6,40,32,8,32
Krasnodar,3060,4,9,4,7,32,29,3,31
Terek Grozny,3060,5,8,6,6,23,23,0,30
Zenit,3060,6,7,8,5,21,17,4,29
FK Rubin,3060,7,7,5,8,25,17,8,26
Din Moscow,3060,8,6,6,8,20,25,-5,24
Amkar,3060,9,5,4,11,10,24,-14,19
Rostov,3060,10,4,6,10,13,22,-9,18
Anzhi,3060,11,2,6,12,16,40,-24,12
Loko Moscow,3061,1,12,5,3,33,15,18,41
Spart Moscow,3061,2,11,5,4,40,26,14,38
CSKA Moscow,3061,3,11,4,5,28,17,11,37
Zenit,3061,4,8,9,3,24,15,9,33
Krasnodar,3061,5,8,5,7,28,26,2,29
Terek Grozny,3061,6,8,5,7,22,25,-3,29
Din Moscow,3061,7,6,6,8,19,24,-5,24
FK Rubin,3061,8,5,6,9,21,18,3,21
Rostov,3061,9,4,6,10,10,20,-10,18
Amkar,3061,10,4,4,12,10,25,-15,16
Anzhi,3061,11,3,5,12,16,40,-24,14
Loko Moscow,3062,1,12,5,3,30,12,18,41
CSKA Moscow,3062,2,11,3,6,28,18,10,36
Spart Moscow,3062,3,9,6,5,34,28,6,33
Zenit,3062,4,8,8,4,22,16,6,32
Terek Grozny,3062,5,9,5,6,22,22,0,32
Krasnodar,3062,6,8,4,8,27,26,1,28
FK Rubin,3062,7,7,5,8,24,18,6,26
Din Moscow,3062,8,6,6,8,21,23,-2,24
Rostov,3062,9,4,7,9,10,17,-7,19
Amkar,3062,10,4,4,12,9,24,-15,16
Anzhi,3062,11,3,5,12,15,38,-23,14
Loko Moscow,3063,1,12,6,2,31,12,19,42
Spart Moscow,3063,2,10,5,5,40,29,11,35
CSKA Moscow,3063,3,10,5,5,27,19,8,35
Terek Grozny,3063,4,9,5,6,24,23,1,32
Zenit,3063,5,7,10,3,23,15,8,31
Krasnodar,3063,6,8,4,8,29,28,1,28
FK Rubin,3063,7,7,5,8,26,19,7,26
Din Moscow,3063,8,5,6,9,18,26,-8,21
Amkar,3063,9,5,4,11,12,25,-13,19
Rostov,3063,10,4,6,10,11,20,-9,18
Anzhi,3063,11,2,6,12,15,40,-25,12
Loko Moscow,3064,1,11,6,3,29,13,16,39
CSKA Moscow,3064,2,11,4,5,27,18,9,37
Spart Moscow,3064,3,10,6,4,38,27,11,36
Krasnodar,3064,4,9,5,6,30,25,5,32
Zenit,3064,5,7,10,3,21,13,8,31
Terek Grozny,3064,6,8,5,7,23,27,-4,29
FK Rubin,3064,7,6,6,8,23,18,5,24
Din Moscow,3064,8,5,6,9,18,24,-6,21
Rostov,3064,9,4,7,9,10,17,-7,19
Amkar,3064,10,5,4,11,13,25,-12,19
Anzhi,3064,11,2,5,13,17,42,-25,11
Loko Moscow,3065,1,12,5,3,35,14,21,41
CSKA Moscow,3065,2,12,3,5,28,17,11,39
Krasnodar,3065,3,10,4,6,31,26,5,34
Spart Moscow,3065,4,9,6,5,38,29,9,33
Terek Grozny,3065,5,9,5,6,23,22,1,32
Zenit,3065,6,7,8,5,21,19,2,29
Din Moscow,3065,7,5,8,7,19,23,-4,23
FK Rubin,3065,8,5,6,9,22,19,3,21
Amkar,3065,9,5,4,11,11,24,-13,19
Rostov,3065,10,4,6,10,11,20,-9,18
Anzhi,3065,11,2,5,13,14,40,-26,11
Loko Moscow,3066,1,12,5,3,31,13,18,41
CSKA Moscow,3066,2,11,4,5,28,19,9,37
Spart Moscow,3066,3,9,6,5,39,31,8,33
Zenit,3066,4,8,8,4,23,15,8,32
Krasnodar,3066,5,9,4,7,33,27,6,31
Terek Grozny,3066,6,7,6,7,21,24,-3,27
Din Moscow,3066,7,6,6,8,20,25,-5,24
FK Rubin,3066,8,5,5,10,23,24,-1,20
Amkar,3066,9,5,5,10,12,23,-11,20
Rostov,3066,10,4,7,9,13,20,-7,19
Anzhi,3066,11,3,6,11,16,38,-22,15
Loko Moscow,3067,1,11,6,3,29,13,16,39
Spart Moscow,3067,2,11,5,4,38,26,12,38
CSKA Moscow,3067,3,11,4,5,29,19,10,37
Krasnodar,3067,4,10,4,6,31,24,7,34
Zenit,3067,5,7,10,3,22,14,8,31
Terek Grozny,3067,6,8,5,7,23,25,-2,29
Din Moscow,3067,7,5,7,8,19,24,-5,22
FK Rubin,3067,8,5,6,9,22,20,2,21
Amkar,3067,9,5,4,11,11,24,-13,19
Rostov,3067,10,4,6,10,10,19,-9,18
Anzhi,3067,11,2,5,13,16,42,-26,11
Loko Moscow,3068,1,11,6,3,30,14,16,39
Spart Moscow,3068,2,10,6,4,39,28,11,36
CSKA Moscow,3068,3,11,3,6,29,21,8,36
Krasnodar,3068,4,10,4,6,33,26,7,34
Zenit,3068,5,8,9,3,25,14,11,33
Terek Grozny,3068,6,8,5,7,23,23,0,29
Din Moscow,3068,7,6,7,7,20,23,-3,25
FK Rubin,3068,8,5,5,10,23,22,1,20
Amkar,3068,9,5,4,11,11,24,-13,19
Rostov,3068,10,4,6,10,10,19,-9,18
Anzhi,3068,11,2,5,13,15,44,-29,11
Loko Moscow,3069,1,13,5,2,34,11,23,44
CSKA Moscow,3069,2,11,4,5,26,17,9,37
Spart Moscow,3069,3,9,6,5,34,27,7,33
Zenit,3069,4,7,9,4,21,15,6,30
Krasnodar,3069,5,8,5,7,28,28,0,29
Terek Grozny,3069,6,7,5,8,22,28,-6,26
FK Rubin,3069,7,5,7,8,22,18,4,22
Din Moscow,3069,8,5,7,8,17,22,-5,22
Rostov,3069,9,5,6,9,12,17,-5,21
Amkar,3069,10,5,5,10,11,22,-11,20
Anzhi,3069,11,3,5,12,18,40,-22,14
Loko Moscow,3070,1,12,5,3,32,14,18,41
Spart Moscow,3070,2,10,6,4,37,26,11,36
CSKA Moscow,3070,3,10,4,6,25,19,6,34
Zenit,3070,4,8,9,3,22,13,9,33
Terek Grozny,3070,5,8,6,6,21,22,-1,30
Krasnodar,3070,6,8,5,7,29,27,2,29
Din Moscow,3070,7,6,6,8,18,23,-5,24
FK Rubin,3070,8,5,6,9,21,18,3,21
Rostov,3070,9,4,7,9,11,18,-7,19
Amkar,3070,10,4,5,11,9,23,-14,17
Anzhi,3070,11,3,5,12,16,38,-22,14
Loko Moscow,3071,1,13,5,2,34,11,23,44
CSKA Moscow,3071,2,12,3,5,27,17,10,39
Spart Moscow,3071,3,10,6,4,38,27,11,36
Krasnodar,3071,4,9,4,7,31,28,3,31
Terek Grozny,3071,5,8,6,6,23,23,0,30
Zenit,3071,6,7,8,5,21,17,4,29
Din Moscow,3071,7,5,7,8,17,22,-5,22
FK Rubin,3071,8,5,6,9,23,21,2,21
Rostov,3071,9,4,7,9,11,18,-7,19
Amkar,3071,10,4,5,11,11,26,-15,17
Anzhi,3071,11,2,5,13,14,40,-26,11
Loko Moscow,3072,1,11,7,2,31,13,18,40
CSKA Moscow,3072,2,11,3,6,29,18,11,36
Spart Moscow,3072,3,9,6,5,36,27,9,33
Zenit,3072,4,8,9,3,24,15,9,33
Krasnodar,3072,5,8,5,7,27,26,1,29
Terek Grozny,3072,6,7,5,8,23,28,-5,26
FK Rubin,3072,7,6,6,8,24,18,6,24
Din Moscow,3072,8,5,7,8,18,24,-6,22
Rostov,3072,9,5,6,9,11,17,-6,21
Amkar,3072,10,5,5,10,12,24,-12,20
Anzhi,3072,11,3,5,12,18,43,-25,14
Loko Moscow,3073,1,11,7,2,33,15,18,40
CSKA Moscow,3073,2,11,4,5,30,19,11,37
Spart Moscow,3073,3,9,6,5,37,29,8,33
Krasnodar,3073,4,9,5,6,30,26,4,32
Zenit,3073,5,7,10,3,25,17,8,31
Terek Grozny,3073,6,8,5,7,22,24,-2,29
FK Rubin,3073,7,6,5,9,22,18,4,23
Din Moscow,3073,8,5,7,8,18,23,-5,22
Amkar,3073,9,5,4,11,12,25,-13,19
Rostov,3073,10,4,6,10,10,18,-8,18
Anzhi,3073,11,3,5,12,16,41,-25,14
Loko Moscow,3074,1,12,5,3,30,14,16,41
Spart Moscow,3074,2,10,5,5,37,28,9,35
Krasnodar,3074,3,10,4,6,32,24,8,34
CSKA Moscow,3074,4,10,4,6,27,20,7,34
Zenit,3074,5,8,8,4,22,14,8,32
Terek Grozny,3074,6,8,6,6,23,24,-1,30
FK Rubin,3074,7,6,5,9,22,19,3,23
Din Moscow,3074,8,5,6,9,17,24,-7,21
Amkar,3074,9,5,4,11,11,23,-12,19
Rostov,3074,10,4,6,10,11,19,-8,18
Anzhi,3074,11,2,7,11,18,41,-23,13
Loko Moscow,3075,1,12,5,3,32,13,19,41
Spart Moscow,3075,2,11,5,4,40,25,15,38
CSKA Moscow,3075,3,10,4,6,27,20,7,34
Krasnodar,3075,4,9,4,7,30,27,3,31
Zenit,3075,5,7,9,4,23,17,6,30
Terek Grozny,3075,6,8,5,7,23,25,-2,29
FK Rubin,3075,7,7,5,8,26,20,6,26
Din Moscow,3075,8,5,6,9,18,25,-7,21
Amkar,3075,9,5,4,11,12,25,-13,19
Rostov,3075,10,4,6,10,10,21,-11,18
Anzhi,3075,11,3,5,12,16,39,-23,14
Loko Moscow,3076,1,11,7,2,31,13,18,40
Spart Moscow,3076,2,10,6,4,40,27,13,36
CSKA Moscow,3076,3,11,3,6,27,19,8,36
Zenit,3076,4,8,9,3,22,13,9,33
Krasnodar,3076,5,8,6,6,29,26,3,30
Terek Grozny,3076,6,8,6,6,24,24,0,30
Din Moscow,3076,7,6,6,8,21,26,-5,24
FK Rubin,3076,8,5,6,9,22,20,2,21
Rostov,3076,9,4,7,9,10,17,-7,19
Amkar,3076,10,4,4,12,10,27,-17,16
Anzhi,3076,11,2,6,12,17,41,-24,12
Loko Moscow,3077,1,12,6,2,32,11,21,42
CSKA Moscow,3077,2,11,3,6,28,20,8,36
Spart Moscow,3077,3,9,7,4,36,26,10,34
Krasnodar,3077,4,9,4,7,28,27,1,31
Zenit,3077,5,7,9,4,22,15,7,30
Terek Grozny,3077,6,7,6,7,21,25,-4,27
FK Rubin,3077,7,6,5,9,24,20,4,23
Din Moscow,3077,8,5,7,8,19,24,-5,22
Rostov,3077,9,4,6,10,11,20,-9,18
Amkar,3077,10,4,6,10,10,23,-13,18
Anzhi,3077,11,4,5,11,18,38,-20,17
Loko Moscow,3078,1,11,7,2,29,11,18,40
CSKA Moscow,3078,2,10,4,6,26,19,7,34
Spart Moscow,3078,3,9,5,6,39,33,6,32
Zenit,3078,4,7,10,3,21,13,8,31
Krasnodar,3078,5,8,6,6,27,24,3,30
Terek Grozny,3078,6,8,6,6,22,23,-1,30
Din Moscow,3078,7,6,7,7,19,21,-2,25
FK Rubin,3078,8,5,7,8,21,17,4,22
Amkar,3078,9,5,5,10,13,24,-11,20
Rostov,3078,10,4,6,10,12,21,-9,18
Anzhi,3078,11,3,5,12,17,40,-23,14
Loko Moscow,3079,1,13,5,2,33,13,20,44
CSKA Moscow,3079,2,11,3,6,29,19,10,36
Spart Moscow,3079,3,10,5,5,40,27,13,35
Zenit,3079,4,8,8,4,24,15,9,32
Krasnodar,3079,5,9,4,7,31,26,5,31
Terek Grozny,3079,6,7,7,6,21,23,-2,28
Din Moscow,3079,7,6,6,8,20,28,-8,24
Rostov,3079,8,5,6,9,11,17,-6,21
FK Rubin,3079,9,5,5,10,22,22,0,20
Amkar,3079,10,4,5,11,10,24,-14,17
Anzhi,3079,11,2,6,12,14,41,-27,12
Loko Moscow,3080,1,11,5,4,29,13,16,38
Spart Moscow,3080,2,10,6,4,37,27,10,36
CSKA Moscow,3080,3,10,4,6,26,20,6,34
Zenit,3080,4,8,9,3,23,14,9,33
Krasnodar,3080,5,9,5,6,29,25,4,32
Terek Grozny,3080,6,8,5,7,22,26,-4,29
Din Moscow,3080,7,6,6,8,18,22,-4,24
FK Rubin,3080,8,5,6,9,22,19,3,21
Rostov,3080,9,4,6,10,11,19,-8,18
Amkar,3080,10,4,5,11,10,25,-15,17
Anzhi,3080,11,4,5,11,20,37,-17,17
CSKA Moscow,3081,1,12,3,5,28,18,10,39
Loko Moscow,3081,2,11,5,4,30,14,16,38
Spart Moscow,3081,3,10,5,5,35,26,9,35
Zenit,3081,4,8,8,4,22,14,8,32
Krasnodar,3081,5,9,4,7,29,26,3,31
Terek Grozny,3081,6,8,6,6,21,22,-1,30
FK Rubin,3081,7,7,5,8,23,17,6,26
Din Moscow,3081,8,5,6,9,17,23,-6,21
Rostov,3081,9,5,6,9,11,17,-6,21
Amkar,3081,10,4,4,12,9,24,-15,16
Anzhi,3081,11,2,6,12,15,39,-24,12
Loko Moscow,3082,1,12,5,3,34,15,19,41
Spart Moscow,3082,2,10,5,5,38,27,11,35
Krasnodar,3082,3,10,4,6,36,27,9,34
CSKA Moscow,3082,4,10,4,6,25,18,7,34
Zenit,3082,5,8,8,4,22,16,6,32
Terek Grozny,3082,6,8,5,7,24,26,-2,29
FK Rubin,3082,7,6,5,9,24,22,2,23
Din Moscow,3082,8,5,6,9,17,26,-9,21
Amkar,3082,9,5,4,11,11,24,-13,19
Rostov,3082,10,4,6,10,11,19,-8,18
Anzhi,3082,11,3,6,11,17,39,-22,15
Loko Moscow,3083,1,12,5,3,33,13,20,41
CSKA Moscow,3083,2,12,3,5,28,18,10,39
Spart Moscow,3083,3,10,6,4,38,27,11,36
Krasnodar,3083,4,10,4,6,31,26,5,34
Terek Grozny,3083,5,9,5,6,23,22,1,32
Zenit,3083,6,7,8,5,21,17,4,29
Din Moscow,3083,7,5,8,7,20,24,-4,23
FK Rubin,3083,8,5,6,9,24,21,3,21
Rostov,3083,9,4,6,10,10,19,-9,18
Amkar,3083,10,4,4,12,10,25,-15,16
Anzhi,3083,11,2,5,13,15,41,-26,11
Loko Moscow,3084,1,12,5,3,32,15,17,41
Spart Moscow,3084,2,11,5,4,40,27,13,38
CSKA Moscow,3084,3,11,4,5,30,18,12,37
Krasnodar,3084,4,9,5,6,31,26,5,32
Zenit,3084,5,7,9,4,21,14,7,30
Terek Grozny,3084,6,8,6,6,21,22,-1,30
FK Rubin,3084,7,6,6,8,23,17,6,24
Din Moscow,3084,8,5,6,9,17,24,-7,21
Rostov,3084,9,4,6,10,11,20,-9,18
Amkar,3084,10,4,4,12,10,26,-16,16
Anzhi,3084,11,2,6,12,15,42,-27,12
Loko Moscow,3085,1,12,5,3,33,15,18,41
CSKA Moscow,3085,2,11,4,5,28,18,10,37
Zenit,3085,3,8,8,4,23,15,8,32
Spart Moscow,3085,4,8,6,6,33,27,6,30
Krasnodar,3085,5,8,4,8,29,30,-1,28
Din Moscow,3085,6,7,6,7,19,21,-2,27
Terek Grozny,3085,7,7,6,7,21,24,-3,27
FK Rubin,3085,8,6,5,9,23,18,5,23
Amkar,3085,9,5,5,10,11,23,-12,20
Rostov,3085,10,4,7,9,10,17,-7,19
Anzhi,3085,11,3,6,11,16,38,-22,15
Loko Moscow,3086,1,13,5,2,32,12,20,44
CSKA Moscow,3086,2,11,4,5,29,18,11,37
Spart Moscow,3086,3,9,7,4,39,28,11,34
Krasnodar,3086,4,9,4,7,31,26,5,31
Zenit,3086,5,7,9,4,22,15,7,30
Terek Grozny,3086,6,8,6,6,23,22,1,30
Din Moscow,3086,7,6,6,8,19,24,-5,24
FK Rubin,3086,8,5,5,10,21,22,-1,20
Rostov,3086,9,4,7,9,11,18,-7,19
Amkar,3086,10,4,5,11,11,27,-16,17
Anzhi,3086,11,2,6,12,14,40,-26,12
Loko Moscow,3087,1,13,5,2,34,14,20,44
CSKA Moscow,3087,2,11,4,5,28,19,9,37
Krasnodar,3087,3,9,4,7,29,26,3,31
Zenit,3087,4,7,9,4,24,17,7,30
Spart Moscow,3087,5,8,6,6,34,30,4,30
Din Moscow,3087,6,7,6,7,20,22,-2,27
Terek Grozny,3087,7,7,5,8,21,26,-5,26
Amkar,3087,8,6,4,10,13,22,-9,22
FK Rubin,3087,9,5,5,10,21,19,2,20
Rostov,3087,10,4,7,9,10,17,-7,19
Anzhi,3087,11,3,5,12,18,40,-22,14
Loko Moscow,3088,1,12,5,3,35,15,20,41
CSKA Moscow,3088,2,10,4,6,27,20,7,34
Zenit,3088,3,8,8,4,22,16,6,32
Terek Grozny,3088,4,9,5,6,22,22,0,32
Spart Moscow,3088,5,8,7,5,33,26,7,31
Krasnodar,3088,6,9,4,7,31,29,2,31
FK Rubin,3088,7,7,5,8,24,17,7,26
Din Moscow,3088,8,5,7,8,17,22,-5,22
Rostov,3088,9,4,7,9,10,17,-7,19
Amkar,3088,10,5,4,11,10,23,-13,19
Anzhi,3088,11,2,6,12,16,40,-24,12
Loko Moscow,3089,1,11,6,3,29,12,17,39
Spart Moscow,3089,2,11,5,4,41,28,13,38
CSKA Moscow,3089,3,11,3,6,27,19,8,36
Zenit,3089,4,8,9,3,23,14,9,33
Krasnodar,3089,5,9,5,6,29,25,4,32
Terek Grozny,3089,6,8,6,6,25,25,0,30
FK Rubin,3089,7,6,6,8,23,18,5,24
Din Moscow,3089,8,5,6,9,19,26,-7,21
Rostov,3089,9,4,6,10,10,19,-9,18
Amkar,3089,10,4,4,12,10,26,-16,16
Anzhi,3089,11,2,6,12,17,41,-24,12
Loko Moscow,3090,1,12,5,3,30,16,14,41
CSKA Moscow,3090,2,11,4,5,28,18,10,37
Spart Moscow,3090,3,9,7,4,37,28,9,34
Terek Grozny,3090,4,9,5,6,24,22,2,32
Krasnodar,3090,5,9,4,7,32,26,6,31
Zenit,3090,6,7,9,4,21,14,7,30
FK Rubin,3090,7,7,5,8,25,17,8,26
Din Moscow,3090,8,5,7,8,19,25,-6,22
Rostov,3090,9,4,7,9,11,18,-7,19
Amkar,3090,10,4,4,12,9,24,-15,16
Anzhi,3090,11,2,5,13,15,43,-28,11
Loko Moscow,3091,1,12,5,3,32,14,18,41
Spart Moscow,3091,2,11,5,4,38,27,11,38
CSKA Moscow,3091,3,11,4,5,27,17,10,37
Zenit,3091,4,8,9,3,24,14,10,33
Krasnodar,3091,5,9,4,7,29,27,2,31
Terek Grozny,3091,6,7,5,8,22,26,-4,26
Din Moscow,3091,7,6,6,8,18,22,-4,24
FK Rubin,3091,8,5,5,10,22,20,2,20
Amkar,3091,9,5,4,11,13,26,-13,19
Rostov,3091,10,4,6,10,10,18,-8,18
Anzhi,3091,11,3,5,12,16,40,-24,14
Loko Moscow,3092,1,13,5,2,34,14,20,44
CSKA Moscow,3092,2,11,4,5,29,20,9,37
Spart Moscow,3092,3,10,6,4,36,25,11,36
Terek Grozny,3092,4,9,5,6,24,24,0,32
Zenit,3092,5,7,8,5,23,17,6,29
Krasnodar,3092,6,8,4,8,29,28,1,28
Din Moscow,3092,7,6,6,8,19,23,-4,24
FK Rubin,3092,8,6,5,9,23,20,3,23
Rostov,3092,9,4,6,10,10,18,-8,18
Amkar,3092,10,4,5,11,9,23,-14,17
Anzhi,3092,11,2,6,12,19,43,-24,12
Loko Moscow,3093,1,12,5,3,32,13,19,41
CSKA Moscow,3093,2,11,3,6,26,19,7,36
Spart Moscow,3093,3,9,6,5,36,29,7,33
Zenit,3093,4,8,8,4,23,15,8,32
Krasnodar,3093,5,9,4,7,30,28,2,31
Terek Grozny,3093,6,7,6,7,21,25,-4,27
Din Moscow,3093,7,6,6,8,19,23,-4,24
FK Rubin,3093,8,6,5,9,24,19,5,23
Rostov,3093,9,5,6,9,13,18,-5,21
Amkar,3093,10,5,5,10,11,22,-11,20
Anzhi,3093,11,2,6,12,15,39,-24,12
Loko Moscow,3094,1,12,6,2,35,13,22,42
Spart Moscow,3094,2,10,6,4,41,28,13,36
CSKA Moscow,3094,3,11,3,6,28,20,8,36
Zenit,3094,4,8,8,4,23,17,6,32
Krasnodar,3094,5,9,5,6,30,26,4,32
Terek Grozny,3094,6,7,5,8,20,26,-6,26
Din Moscow,3094,7,6,6,8,19,24,-5,24
FK Rubin,3094,8,5,5,10,21,19,2,20
Amkar,3094,9,5,5,10,12,23,-11,20
Rostov,3094,10,4,6,10,11,21,-10,18
Anzhi,3094,11,3,5,12,17,40,-23,14
Loko Moscow,3095,1,11,6,3,30,14,16,39
Spart Moscow,3095,2,11,5,4,40,27,13,38
Krasnodar,3095,3,10,4,6,32,26,6,34
CSKA Moscow,3095,4,10,4,6,26,20,6,34
Zenit,3095,5,8,9,3,24,14,10,33
Terek Grozny,3095,6,8,5,7,24,25,-1,29
Din Moscow,3095,7,5,7,8,21,28,-7,22
FK Rubin,3095,8,5,6,9,24,21,3,21
Rostov,3095,9,4,6,10,10,18,-8,18
Amkar,3095,10,4,4,12,9,26,-17,16
Anzhi,3095,11,3,6,11,17,38,-21,15
Loko Moscow,3096,1,13,5,2,33,11,22,44
CSKA Moscow,3096,2,10,4,6,26,19,7,34
Zenit,3096,3,8,8,4,22,15,7,32
Spart Moscow,3096,4,8,6,6,35,29,6,30
Krasnodar,3096,5,8,5,7,28,27,1,29
Terek Grozny,3096,6,8,5,7,24,26,-2,29
Din Moscow,3096,7,7,6,7,19,21,-2,27
FK Rubin,3096,8,5,6,9,22,19,3,21
Rostov,3096,9,5,6,9,11,17,-6,21
Amkar,3096,10,4,5,11,12,26,-14,17
Anzhi,3096,11,3,6,11,18,40,-22,15
Loko Moscow,3097,1,12,6,2,32,13,19,42
CSKA Moscow,3097,2,11,4,5,29,19,10,37
Spart Moscow,3097,3,10,6,4,39,25,14,36
Krasnodar,3097,4,9,5,6,31,26,5,32
Zenit,3097,5,7,9,4,23,16,7,30
Terek Grozny,3097,6,8,6,6,25,24,1,30
Din Moscow,3097,7,5,7,8,17,24,-7,22
FK Rubin,3097,8,5,6,9,22,20,2,21
Rostov,3097,9,4,6,10,10,20,-10,18
Amkar,3097,10,4,5,11,10,26,-16,17
Anzhi,3097,11,2,6,12,16,41,-25,12
Loko Moscow,3098,1,11,6,3,30,15,15,39
CSKA Moscow,3098,2,11,4,5,27,18,9,37
Spart Moscow,3098,3,10,5,5,37,30,7,35
Krasnodar,3098,4,9,5,6,32,26,6,32
Zenit,3098,5,7,10,3,22,14,8,31
Terek Grozny,3098,6,8,5,7,21,24,-3,29
FK Rubin,3098,7,5,7,8,22,18,4,22
Din Moscow,3098,8,5,7,8,18,23,-5,22
Rostov,3098,9,5,6,9,13,17,-4,21
Amkar,3098,10,4,4,12,10,25,-15,16
Anzhi,3098,11,3,5,12,16,38,-22,14
Loko Moscow,3099,1,12,5,3,32,14,18,41
Spart Moscow,3099,2,11,5,4,38,27,11,38
CSKA Moscow,3099,3,11,4,5,28,18,10,37
Zenit,3099,4,8,8,4,24,16,8,32
Krasnodar,3099,5,8,5,7,28,27,1,29
Terek Grozny,3099,6,7,6,7,22,25,-3,27
Din Moscow,3099,7,6,6,8,18,22,-4,24
FK Rubin,3099,8,5,6,9,22,19,3,21
Rostov,3099,9,4,6,10,11,19,-8,18
Amkar,3099,10,4,5,11,11,25,-14,17
Anzhi,3099,11,3,6,11,17,39,-22,15
Loko Moscow,3100,1,13,5,2,34,13,21,44
CSKA Moscow,3100,2,11,4,5,28,17,11,37
Spart Moscow,3100,3,10,5,5,39,29,10,35
Zenit,3100,4,7,9,4,22,15,7,30
Krasnodar,3100,5,8,4,8,30,30,0,28
Terek Grozny,3100,6,7,6,7,21,24,-3,27
Din Moscow,3100,7,6,6,8,21,25,-4,24
FK Rubin,3100,8,6,5,9,26,23,3,23
Amkar,3100,9,6,4,10,14,25,-11,22
Rostov,3100,10,4,6,10,10,18,-8,18
Anzhi,3100,11,2,6,12,15,41,-26,12
Loko Moscow,3101,1,12,5,3,31,13,18,41
CSKA Moscow,3101,2,11,4,5,30,20,10,37
Spart Moscow,3101,3,10,6,4,37,26,11,36
Zenit,3101,4,8,9,3,25,16,9,33
Krasnodar,3101,5,8,5,7,27,25,2,29
Terek Grozny,3101,6,8,5,7,22,25,-3,29
FK Rubin,3101,7,5,7,8,22,18,4,22
Din Moscow,3101,8,5,7,8,18,24,-6,22
Amkar,3101,9,5,5,10,13,24,-11,20
Rostov,3101,10,4,6,10,10,18,-8,18
Anzhi,3101,11,2,5,13,15,41,-26,11
Loko Moscow,3102,1,11,6,3,31,15,16,39
Spart Moscow,3102,2,10,6,4,42,29,13,36
CSKA Moscow,3102,3,11,3,6,27,20,7,36
Zenit,3102,4,8,9,3,26,15,11,33
Krasnodar,3102,5,9,5,6,29,24,5,32
Terek Grozny,3102,6,8,5,7,23,24,-1,29
Din Moscow,3102,7,6,7,7,20,22,-2,25
FK Rubin,3102,8,5,6,9,21,19,2,21
Rostov,3102,9,4,6,10,10,21,-11,18
Amkar,3102,10,4,4,12,12,29,-17,16
Anzhi,3102,11,3,5,12,16,39,-23,14
Loko Moscow,3103,1,12,6,2,31,12,19,42
Spart Moscow,3103,2,10,6,4,37,26,11,36
Zenit,3103,3,8,9,3,25,14,11,33
CSKA Moscow,3103,4,10,3,7,26,22,4,33
Krasnodar,3103,5,8,4,8,27,27,0,28
Terek Grozny,3103,6,7,6,7,22,25,-3,27
Din Moscow,3103,7,6,7,7,19,22,-3,25
FK Rubin,3103,8,6,5,9,23,18,5,23
Rostov,3103,9,4,6,10,10,18,-8,18
Amkar,3103,10,4,5,11,9,24,-15,17
Anzhi,3103,11,4,5,11,19,40,-21,17
Loko Moscow,3104,1,11,5,4,31,15,16,38
Spart Moscow,3104,2,10,6,4,40,28,12,36
CSKA Moscow,3104,3,11,3,6,26,18,8,36
Zenit,3104,4,9,8,3,24,14,10,35
Krasnodar,3104,5,10,4,6,32,27,5,34
Terek Grozny,3104,6,7,6,7,22,25,-3,27
Din Moscow,3104,7,6,6,8,21,25,-4,24
FK Rubin,3104,8,5,5,10,24,22,2,20
Rostov,3104,9,4,6,10,10,20,-10,18
Amkar,3104,10,4,6,10,10,23,-13,18
Anzhi,3104,11,3,5,12,17,40,-23,14
Loko Moscow,3105,1,12,5,3,30,13,17,41
CSKA Moscow,3105,2,11,4,5,28,17,11,37
Krasnodar,3105,3,10,4,6,30,24,6,34
Spart Moscow,3105,4,9,6,5,38,29,9,33
Zenit,3105,5,7,9,4,21,14,7,30
Terek Grozny,3105,6,7,5,8,21,27,-6,26
FK Rubin,3105,7,6,5,9,24,20,4,23
Rostov,3105,8,5,6,9,12,18,-6,21
Din Moscow,3105,9,5,6,9,20,27,-7,21
Amkar,3105,10,5,5,10,12,24,-12,20
Anzhi,3105,11,3,5,12,17,40,-23,14
Loko Moscow,3106,1,13,5,2,33,11,22,44
Spart Moscow,3106,2,10,6,4,39,26,13,36
CSKA Moscow,3106,3,11,3,6,27,20,7,36
Zenit,3106,4,8,8,4,24,14,10,32
Krasnodar,3106,5,8,5,7,27,27,0,29
Terek Grozny,3106,6,7,7,6,21,23,-2,28
Din Moscow,3106,7,6,7,7,19,22,-3,25
FK Rubin,3106,8,5,6,9,22,19,3,21
Rostov,3106,9,4,6,10,11,20,-9,18
Amkar,3106,10,4,5,11,9,25,-16,17
Anzhi,3106,11,2,6,12,15,40,-25,12
Loko Moscow,3107,1,13,5,2,32,11,21,44
CSKA Moscow,3107,2,11,3,6,27,19,8,36
Spart Moscow,3107,3,9,6,5,38,28,10,33
Zenit,3107,4,8,8,4,23,16,7,32
Terek Grozny,3107,5,8,6,6,22,23,-1,30
Krasnodar,3107,6,8,4,8,27,27,0,28
Din Moscow,3107,7,7,6,7,21,23,-2,27
FK Rubin,3107,8,6,5,9,24,19,5,23
Rostov,3107,9,4,7,9,11,18,-7,19
Amkar,3107,10,4,4,12,9,26,-17,16
Anzhi,3107,11,2,6,12,15,39,-24,12
Loko Moscow,3108,1,11,6,3,30,16,14,39
CSKA Moscow,3108,2,10,5,5,26,18,8,35
Krasnodar,3108,3,10,4,6,33,25,8,34
Zenit,3108,4,7,10,3,21,13,8,31
Spart Moscow,3108,5,8,6,6,34,29,5,30
Terek Grozny,3108,6,8,5,7,22,24,-2,29
Din Moscow,3108,7,6,6,8,20,23,-3,24
FK Rubin,3108,8,6,5,9,22,18,4,23
Amkar,3108,9,6,4,10,11,22,-11,22
Rostov,3108,10,4,7,9,10,17,-7,19
Anzhi,3108,11,2,6,12,16,40,-24,12
Loko Moscow,3109,1,12,5,3,36,15,21,41
CSKA Moscow,3109,2,11,4,5,31,20,11,37
Krasnodar,3109,3,10,4,6,31,26,5,34
Spart Moscow,3109,4,9,6,5,35,27,8,33
Zenit,3109,5,7,9,4,25,21,4,30
Terek Grozny,3109,6,7,6,7,20,23,-3,27
Din Moscow,3109,7,6,6,8,19,23,-4,24
Rostov,3109,8,5,6,9,12,18,-6,21
FK Rubin,3109,9,5,5,10,22,20,2,20
Amkar,3109,10,4,6,10,9,22,-13,18
Anzhi,3109,11,3,5,12,15,40,-25,14
Loko Moscow,3110,1,11,5,4,33,17,16,38
CSKA Moscow,3110,2,10,5,5,27,19,8,35
Spart Moscow,3110,3,9,6,5,37,28,9,33
Zenit,3110,4,8,9,3,25,16,9,33
Krasnodar,3110,5,9,4,7,30,27,3,31
Terek Grozny,3110,6,7,6,7,20,23,-3,27
Din Moscow,3110,7,6,7,7,19,22,-3,25
FK Rubin,3110,8,6,5,9,22,18,4,23
Amkar,3110,9,5,5,10,11,23,-12,20
Rostov,3110,10,4,6,10,10,19,-9,18
Anzhi,3110,11,3,6,11,16,38,-22,15
Loko Moscow,3111,1,12,6,2,30,11,19,42
Zenit,3111,2,8,9,3,24,15,9,33
CSKA Moscow,3111,3,10,3,7,27,21,6,33
Spart Moscow,3111,4,9,5,6,39,30,9,32
Krasnodar,3111,5,8,5,7,29,27,2,29
Terek Grozny,3111,6,7,7,6,23,25,-2,28
Din Moscow,3111,7,7,6,7,21,21,0,27
FK Rubin,3111,8,5,6,9,23,21,2,21
Rostov,3111,9,5,6,9,13,19,-6,21
Amkar,3111,10,4,5,11,11,28,-17,17
Anzhi,3111,11,3,6,11,16,38,-22,15
Loko Moscow,3112,1,11,5,4,30,16,14,38
Spart Moscow,3112,2,10,6,4,37,27,10,36
CSKA Moscow,3112,3,11,3,6,29,21,8,36
Zenit,3112,4,9,8,3,26,14,12,35
Krasnodar,3112,5,9,5,6,31,25,6,32
Terek Grozny,3112,6,7,6,7,22,25,-3,27
Din Moscow,3112,7,6,7,7,22,24,-2,25
FK Rubin,3112,8,5,6,9,24,22,2,21
Amkar,3112,9,5,4,11,11,24,-13,19
Rostov,3112,10,4,6,10,10,18,-8,18
Anzhi,3112,11,2,6,12,17,43,-26,12
Loko Moscow,3113,1,11,6,3,31,14,17,39
Zenit,3113,2,9,8,3,26,14,12,35
CSKA Moscow,3113,3,10,4,6,26,21,5,34
Spart Moscow,3113,4,8,7,5,35,28,7,31
Krasnodar,3113,5,8,5,7,28,26,2,29
Terek Grozny,3113,6,8,5,7,22,24,-2,29
FK Rubin,3113,7,6,6,8,24,19,5,24
Din Moscow,3113,8,5,8,7,20,24,-4,23
Rostov,3113,9,5,6,9,11,17,-6,21
Amkar,3113,10,5,5,10,12,23,-11,20
Anzhi,3113,11,2,6,12,15,40,-25,12
Loko Moscow,3114,1,13,5,2,35,12,23,44
Spart Moscow,3114,2,10,6,4,38,27,11,36
CSKA Moscow,3114,3,10,3,7,25,20,5,33
Zenit,3114,4,8,8,4,24,16,8,32
Terek Grozny,3114,5,8,6,6,23,23,0,30
Krasnodar,3114,6,8,4,8,29,30,-1,28
FK Rubin,3114,7,7,5,8,25,19,6,26
Din Moscow,3114,8,5,6,9,18,24,-6,21
Rostov,3114,9,4,6,10,10,19,-9,18
Amkar,3114,10,4,6,10,10,23,-13,18
Anzhi,3114,11,3,5,12,16,40,-24,14
Loko Moscow,3115,1,13,5,2,34,13,21,44
CSKA Moscow,3115,2,12,3,5,29,17,12,39
Spart Moscow,3115,3,9,7,4,37,28,9,34
Terek Grozny,3115,4,8,6,6,22,22,0,30
Zenit,3115,5,7,8,5,21,16,5,29
Krasnodar,3115,6,8,5,7,29,27,2,29
Din Moscow,3115,7,5,8,7,20,24,-4,23
FK Rubin,3115,8,5,7,8,23,19,4,22
Rostov,3115,9,4,7,9,11,18,-7,19
Amkar,3115,10,4,4,12,10,26,-16,16
Anzhi,3115,11,2,6,12,14,40,-26,12
Loko Moscow,3116,1,12,5,3,32,14,18,41
CSKA Moscow,3116,2,11,3,6,28,20,8,36
Spart Moscow,3116,3,10,5,5,39,28,11,35
Zenit,3116,4,8,8,4,23,15,8,32
Krasnodar,3116,5,9,5,6,30,26,4,32
Terek Grozny,3116,6,7,5,8,20,24,-4,26
Din Moscow,3116,7,6,6,8,20,26,-6,24
FK Rubin,3116,8,5,6,9,22,19,3,21
Rostov,3116,9,5,6,9,11,17,-6,21
Amkar,3116,10,5,4,11,11,24,-13,19
Anzhi,3116,11,3,5,12,16,39,-23,14
Loko Moscow,3117,1,12,5,3,32,12,20,41
Spart Moscow,3117,2,11,5,4,38,26,12,38
CSKA Moscow,3117,3,11,4,5,26,17,9,37
Krasnodar,3117,4,9,5,6,29,25,4,32
Zenit,3117,5,7,9,4,21,16,5,30
Terek Grozny,3117,6,7,6,7,21,26,-5,27
FK Rubin,3117,7,5,7,8,23,19,4,22
Din Moscow,3117,8,5,7,8,18,23,-5,22
Rostov,3117,9,4,6,10,10,18,-8,18
Amkar,3117,10,4,5,11,11,26,-15,17
Anzhi,3117,11,3,5,12,17,38,-21,14
Loko Moscow,3118,1,12,5,3,30,12,18,41
Spart Moscow,3118,2,10,5,5,41,32,9,35
CSKA Moscow,3118,3,10,4,6,27,21,6,34
Krasnodar,3118,4,9,5,6,29,25,4,32
Zenit,3118,5,7,9,4,23,16,7,30
Terek Grozny,3118,6,8,5,7,22,25,-3,29
FK Rubin,3118,7,6,6,8,26,18,8,24
Rostov,3118,8,5,6,9,12,18,-6,21
Din Moscow,3118,9,5,6,9,19,28,-9,21
Amkar,3118,10,5,4,11,14,26,-12,19
Anzhi,3118,11,3,5,12,17,39,-22,14
Loko Moscow,3119,1,12,6,2,31,12,19,42
CSKA Moscow,3119,2,11,3,6,29,18,11,36
Zenit,3119,3,8,9,3,22,13,9,33
Spart Moscow,3119,4,9,6,5,35,28,7,33
Krasnodar,3119,5,9,4,7,30,27,3,31
Terek Grozny,3119,6,7,6,7,22,26,-4,27
Din Moscow,3119,7,6,6,8,21,26,-5,24
FK Rubin,3119,8,6,5,9,27,21,6,23
Rostov,3119,9,4,6,10,10,18,-8,18
Amkar,3119,10,4,6,10,11,24,-13,18
Anzhi,3119,11,3,5,12,17,42,-25,14
Loko Moscow,3120,1,11,6,3,30,13,17,39
Spart Moscow,3120,2,10,6,4,38,26,12,36
CSKA Moscow,3120,3,10,4,6,27,20,7,34
Krasnodar,3120,4,9,5,6,28,24,4,32
Zenit,3120,5,7,10,3,23,15,8,31
Terek Grozny,3120,6,8,6,6,23,23,0,30
FK Rubin,3120,7,6,6,8,25,18,7,24
Din Moscow,3120,8,5,6,9,19,27,-8,21
Rostov,3120,9,4,6,10,10,20,-10,18
Amkar,3120,10,4,5,11,9,24,-15,17
Anzhi,3120,11,3,6,11,17,39,-22,15
Loko Moscow,3121,1,11,6,3,31,14,17,39
Spart Moscow,3121,2,10,6,4,36,26,10,36
CSKA Moscow,3121,3,11,3,6,27,18,9,36
Zenit,3121,4,9,8,3,24,14,10,35
Krasnodar,3121,5,9,5,6,32,27,5,32
Terek Grozny,3121,6,7,5,8,21,28,-7,26
Din Moscow,3121,7,5,7,8,18,23,-5,22
FK Rubin,3121,8,5,6,9,23,21,2,21
Amkar,3121,9,5,5,10,12,22,-10,20
Rostov,3121,10,4,6,10,10,18,-8,18
Anzhi,3121,11,3,5,12,17,40,-23,14
Loko Moscow,3122,1,12,6,2,31,12,19,42
CSKA Moscow,3122,2,11,4,5,29,19,10,37
Spart Moscow,3122,3,10,5,5,39,30,9,35
Krasnodar,3122,4,9,5,6,31,26,5,32
Zenit,3122,5,7,9,4,22,15,7,30
Terek Grozny,3122,6,8,5,7,22,24,-2,29
Din Moscow,3122,7,6,6,8,20,24,-4,24
FK Rubin,3122,8,6,5,9,24,20,4,23
Amkar,3122,9,5,4,11,11,25,-14,19
Rostov,3122,10,4,6,10,11,19,-8,18
Anzhi,3122,11,2,5,13,16,42,-26,11
Loko Moscow,3123,1,13,5,2,34,12,22,44
Spart Moscow,3123,2,10,5,5,37,28,9,35
CSKA Moscow,3123,3,10,4,6,27,20,7,34
Krasnodar,3123,4,9,4,7,30,26,4,31
Zenit,3123,5,7,9,4,23,18,5,30
Terek Grozny,3123,6,7,5,8,20,26,-6,26
Din Moscow,3123,7,6,6,8,19,23,-4,24
FK Rubin,3123,8,6,5,9,22,19,3,23
Amkar,3123,9,5,4,11,12,23,-11,19
Rostov,3123,10,4,6,10,11,19,-8,18
Anzhi,3123,11,4,5,11,16,37,-21,17
Loko Moscow,3124,1,12,6,2,31,12,19,42
CSKA Moscow,3124,2,11,4,5,29,20,9,37
Spart Moscow,3124,3,9,6,5,38,27,11,33
Krasnodar,3124,4,9,5,6,32,24,8,32
Zenit,3124,5,7,9,4,24,17,7,30
Terek Grozny,3124,6,7,6,7,22,25,-3,27
Din Moscow,3124,7,6,6,8,22,26,-4,24
Amkar,3124,8,6,4,10,12,23,-11,22
FK Rubin,3124,9,5,5,10,21,26,-5,20
Rostov,3124,10,4,7,9,10,17,-7,19
Anzhi,3124,11,2,6,12,16,40,-24,12
Loko Moscow,3125,1,12,5,3,32,13,19,41
CSKA Moscow,3125,2,10,5,5,26,18,8,35
Krasnodar,3125,3,10,4,6,32,27,5,34
Zenit,3125,4,7,9,4,21,15,6,30
Spart Moscow,3125,5,8,6,6,35,32,3,30
Terek Grozny,3125,6,7,6,7,22,25,-3,27
Din Moscow,3125,7,6,6,8,19,24,-5,24
FK Rubin,3125,8,6,5,9,26,20,6,23
Amkar,3125,9,5,5,10,13,23,-10,20
Rostov,3125,10,4,7,9,12,19,-7,19
Anzhi,3125,11,3,6,11,17,39,-22,15
Loko Moscow,3126,1,11,7,2,32,14,18,40
CSKA Moscow,3126,2,11,4,5,27,18,9,37
Terek Grozny,3126,3,9,5,6,23,23,0,32
Zenit,3126,4,7,10,3,22,14,8,31
Spart Moscow,3126,5,8,7,5,33,27,6,31
Krasnodar,3126,6,8,6,6,30,27,3,30
FK Rubin,3126,7,6,6,8,25,18,7,24
Din Moscow,3126,8,5,7,8,17,24,-7,22
Rostov,3126,9,4,7,9,10,17,-7,19
Amkar,3126,10,5,4,11,11,23,-12,19
Anzhi,3126,11,2,5,13,16,41,-25,11
Loko Moscow,3127,1,11,6,3,30,14,16,39
CSKA Moscow,3127,2,11,4,5,30,20,10,37
Spart Moscow,3127,3,9,5,6,39,30,9,32
Zenit,3127,4,8,8,4,24,16,8,32
Krasnodar,3127,5,9,5,6,30,26,4,32
Terek Grozny,3127,6,8,6,6,22,23,-1,30
Din Moscow,3127,7,7,6,7,21,21,0,27
Rostov,3127,8,5,6,9,12,18,-6,21
FK Rubin,3127,9,5,5,10,22,20,2,20
Amkar,3127,10,4,5,11,9,27,-18,17
Anzhi,3127,11,2,6,12,17,41,-24,12
Loko Moscow,3128,1,12,6,2,30,11,19,42
CSKA Moscow,3128,2,11,3,6,27,19,8,36
Spart Moscow,3128,3,9,7,4,36,26,10,34
Zenit,3128,4,8,8,4,23,15,8,32
Krasnodar,3128,5,9,5,6,29,24,5,32
Terek Grozny,3128,6,7,6,7,20,23,-3,27
FK Rubin,3128,7,6,5,9,22,19,3,23
Din Moscow,3128,8,5,6,9,17,24,-7,21
Rostov,3128,9,4,7,9,11,18,-7,19
Amkar,3128,10,4,6,10,9,22,-13,18
Anzhi,3128,11,3,5,12,15,38,-23,14
Loko Moscow,3129,1,12,5,3,31,13,18,41
Spart Moscow,3129,2,10,6,4,38,28,10,36
CSKA Moscow,3129,3,10,4,6,25,19,6,34
Krasnodar,3129,4,10,4,6,30,25,5,34
Zenit,3129,5,8,8,4,24,15,9,32
Terek Grozny,3129,6,9,5,6,23,22,1,32
Din Moscow,3129,7,6,6,8,19,23,-4,24
FK Rubin,3129,8,5,5,10,22,20,2,20
Rostov,3129,9,4,6,10,11,19,-8,18
Amkar,3129,10,4,5,11,10,24,-14,17
Anzhi,3129,11,2,6,12,14,39,-25,12
Loko Moscow,3130,1,12,5,3,32,14,18,41
CSKA Moscow,3130,2,11,3,6,26,18,8,36
Zenit,3130,3,8,8,4,22,14,8,32
Krasnodar,3130,4,9,5,6,31,27,4,32
Spart Moscow,3130,5,8,5,7,36,32,4,29
Terek Grozny,3130,6,7,6,7,21,24,-3,27
FK Rubin,3130,7,6,6,8,23,18,5,24
Din Moscow,3130,8,6,6,8,20,23,-3,24
Rostov,3130,9,5,6,9,12,18,-6,21
Amkar,3130,10,5,5,10,11,23,-12,20
Anzhi,3130,11,3,5,12,16,39,-23,14
Loko Moscow,3131,1,12,6,2,31,12,19,42
CSKA Moscow,3131,2,11,4,5,29,20,9,37
Spart Moscow,3131,3,9,6,5,36,30,6,33
Terek Grozny,3131,4,9,5,6,25,25,0,32
Zenit,3131,5,7,10,3,23,15,8,31
Krasnodar,3131,6,8,5,7,28,26,2,29
Din Moscow,3131,7,6,7,7,18,21,-3,25
FK Rubin,3131,8,5,6,9,21,18,3,21
Amkar,3131,9,5,4,11,15,26,-11,19
Rostov,3131,10,4,6,10,11,19,-8,18
Anzhi,3131,11,2,5,13,16,41,-25,11
Loko Moscow,3132,1,11,6,3,31,14,17,39
CSKA Moscow,3132,2,11,3,6,29,21,8,36
Zenit,3132,3,9,8,3,26,14,12,35
Spart Moscow,3132,4,9,7,4,37,28,9,34
Krasnodar,3132,5,9,5,6,29,25,4,32
Terek Grozny,3132,6,8,5,7,21,24,-3,29
Din Moscow,3132,7,5,8,7,19,23,-4,23
FK Rubin,3132,8,5,6,9,22,19,3,21
Amkar,3132,9,5,5,10,12,23,-11,20
Rostov,3132,10,4,6,10,11,19,-8,18
Anzhi,3132,11,2,5,13,15,42,-27,11
Loko Moscow,3133,1,12,5,3,30,12,18,41
CSKA Moscow,3133,2,12,3,5,30,18,12,39
Krasnodar,3133,3,9,5,6,30,26,4,32
Spart Moscow,3133,4,8,6,6,37,32,5,30
Zenit,3133,5,7,8,5,21,15,6,29
Din Moscow,3133,6,7,6,7,22,23,-1,27
Terek Grozny,3133,7,7,6,7,23,26,-3,27
FK Rubin,3133,8,5,6,9,25,22,3,21
Rostov,3133,9,5,6,9,12,18,-6,21
Amkar,3133,10,5,5,10,15,27,-12,20
Anzhi,3133,11,2,6,12,16,42,-26,12
Loko Moscow,3134,1,12,5,3,30,12,18,41
Spart Moscow,3134,2,10,6,4,37,26,11,36
Krasnodar,3134,3,10,4,6,29,24,5,34
CSKA Moscow,3134,4,10,3,7,27,21,6,33
Zenit,3134,5,8,8,4,22,14,8,32
Terek Grozny,3134,6,7,5,8,21,28,-7,26
FK Rubin,3134,7,6,5,9,22,18,4,23
Din Moscow,3134,8,5,6,9,17,23,-6,21
Amkar,3134,9,5,5,10,13,23,-10,20
Rostov,3134,10,4,6,10,10,19,-9,18
Anzhi,3134,11,4,5,11,20,40,-20,17
Loko Moscow,3135,1,13,5,2,34,14,20,44
CSKA Moscow,3135,2,11,3,6,29,21,8,36
Spart Moscow,3135,3,9,6,5,38,29,9,33
Zenit,3135,4,8,8,4,25,16,9,32
Krasnodar,3135,5,8,5,7,30,28,2,29
Terek Grozny,3135,6,8,5,7,24,26,-2,29
Din Moscow,3135,7,6,6,8,20,25,-5,24
Amkar,3135,8,6,4,10,13,24,-11,22
FK Rubin,3135,9,5,6,9,23,20,3,21
Rostov,3135,10,4,7,9,12,19,-7,19
Anzhi,3135,11,2,5,13,16,42,-26,11
Loko Moscow,3136,1,11,6,3,30,14,16,39
Spart Moscow,3136,2,11,5,4,41,27,14,38
CSKA Moscow,3136,3,11,3,6,27,18,9,36
Krasnodar,3136,4,10,4,6,31,25,6,34
Zenit,3136,5,8,9,3,22,13,9,33
Terek Grozny,3136,6,9,5,6,23,22,1,32
FK Rubin,3136,7,6,5,9,22,18,4,23
Din Moscow,3136,8,5,6,9,18,25,-7,21
Rostov,3136,9,4,6,10,10,19,-9,18
Amkar,3136,10,4,4,12,10,26,-16,16
Anzhi,3136,11,2,5,13,14,41,-27,11
Loko Moscow,3137,1,12,6,2,33,12,21,42
CSKA Moscow,3137,2,12,3,5,31,19,12,39
Spart Moscow,3137,3,10,6,4,39,25,14,36
Terek Grozny,3137,4,9,5,6,26,25,1,32
Krasnodar,3137,5,9,4,7,28,27,1,31
Zenit,3137,6,7,9,4,23,16,7,30
Din Moscow,3137,7,6,6,8,19,24,-5,24
FK Rubin,3137,8,5,5,10,21,20,1,20
Rostov,3137,9,4,6,10,10,20,-10,18
Amkar,3137,10,4,5,11,10,24,-14,17
Anzhi,3137,11,2,5,13,17,45,-28,11
Loko Moscow,3138,1,11,7,2,31,13,18,40
CSKA Moscow,3138,2,11,4,5,30,20,10,37
Spart Moscow,3138,3,9,7,4,40,30,10,34
Zenit,3138,4,7,9,4,22,16,6,30
Terek Grozny,3138,5,8,6,6,21,22,-1,30
Krasnodar,3138,6,8,5,7,28,28,0,29
FK Rubin,3138,7,7,5,8,26,17,9,26
Din Moscow,3138,8,5,7,8,19,25,-6,22
Rostov,3138,9,4,6,10,12,21,-9,18
Amkar,3138,10,4,6,10,10,23,-13,18
Anzhi,3138,11,2,6,12,17,41,-24,12
Loko Moscow,3139,1,13,5,2,32,12,20,44
CSKA Moscow,3139,2,11,4,5,29,20,9,37
Spart Moscow,3139,3,10,6,4,41,29,12,36
Krasnodar,3139,4,9,4,7,29,26,3,31
Zenit,3139,5,7,9,4,23,16,7,30
Terek Grozny,3139,6,8,6,6,24,23,1,30
Din Moscow,3139,7,6,7,7,22,25,-3,25
FK Rubin,3139,8,5,5,10,22,20,2,20
Rostov,3139,9,4,6,10,11,19,-8,18
Amkar,3139,10,4,4,12,9,28,-19,16
Anzhi,3139,11,2,6,12,16,40,-24,12
Loko Moscow,3140,1,12,6,2,32,13,19,42
Spart Moscow,3140,2,9,7,4,38,29,9,34
Zenit,3140,3,8,9,3,25,14,11,33
CSKA Moscow,3140,4,10,3,7,25,22,3,33
Krasnodar,3140,5,8,5,7,30,28,2,29
Terek Grozny,3140,6,8,5,7,23,25,-2,29
Din Moscow,3140,7,6,7,7,20,22,-2,25
FK Rubin,3140,8,5,6,9,23,21,2,21
Rostov,3140,9,4,7,9,11,18,-7,19
Anzhi,3140,10,4,5,11,18,38,-20,17
Amkar,3140,11,4,4,12,12,27,-15,16
Loko Moscow,3141,1,13,5,2,33,13,20,44
Spart Moscow,3141,2,11,5,4,39,27,12,38
CSKA Moscow,3141,3,11,3,6,31,20,11,36
Zenit,3141,4,8,8,4,25,17,8,32
Krasnodar,3141,5,9,4,7,30,26,4,31
Terek Grozny,3141,6,8,6,6,21,22,-1,30
FK Rubin,3141,7,6,5,9,23,19,4,23
Din Moscow,3141,8,5,6,9,19,26,-7,21
Rostov,3141,9,4,6,10,10,19,-9,18
Amkar,3141,10,4,4,12,9,24,-15,16
Anzhi,3141,11,2,6,12,14,41,-27,12
Loko Moscow,3142,1,12,5,3,30,13,17,41
Krasnodar,3142,2,10,4,6,32,25,7,34
Spart Moscow,3142,3,9,6,5,36,27,9,33
CSKA Moscow,3142,4,10,3,7,27,22,5,33
Zenit,3142,5,8,8,4,24,15,9,32
Terek Grozny,3142,6,9,5,6,25,24,1,32
Din Moscow,3142,7,5,7,8,19,25,-6,22
FK Rubin,3142,8,5,6,9,24,22,2,21
Rostov,3142,9,4,7,9,11,18,-7,19
Amkar,3142,10,5,4,11,11,25,-14,19
Anzhi,3142,11,3,5,12,17,40,-23,14
Loko Moscow,3143,1,12,6,2,31,12,19,42
CSKA Moscow,3143,2,12,3,5,30,17,13,39
Spart Moscow,3143,3,10,6,4,39,28,11,36
Zenit,3143,4,7,8,5,21,16,5,29
Krasnodar,3143,5,8,5,7,30,28,2,29
Terek Grozny,3143,6,7,7,6,22,24,-2,28
FK Rubin,3143,7,7,5,8,26,20,6,26
Din Moscow,3143,8,5,6,9,19,26,-7,21
Rostov,3143,9,4,6,10,11,19,-8,18
Amkar,3143,10,4,6,10,11,24,-13,18
Anzhi,3143,11,2,6,12,15,41,-26,12
Loko Moscow,3144,1,11,6,3,30,15,15,39
CSKA Moscow,3144,2,11,3,6,31,20,11,36
Zenit,3144,3,9,8,3,27,15,12,35
Krasnodar,3144,4,8,6,6,28,25,3,30
Spart Moscow,3144,5,8,5,7,35,34,1,29
Terek Grozny,3144,6,7,5,8,21,25,-4,26
Din Moscow,3144,7,6,7,7,20,22,-2,25
FK Rubin,3144,8,5,7,8,22,18,4,22
Amkar,3144,9,6,4,10,13,23,-10,22
Rostov,3144,10,5,6,9,14,18,-4,21
Anzhi,3144,11,3,5,12,16,42,-26,14
Loko Moscow,3145,1,12,5,3,33,14,19,41
CSKA Moscow,3145,2,11,4,5,30,17,13,37
Spart Moscow,3145,3,10,5,5,39,28,11,35
Krasnodar,3145,4,9,5,6,32,27,5,32
Zenit,3145,5,7,9,4,21,16,5,30
Terek Grozny,3145,6,8,5,7,21,23,-2,29
Din Moscow,3145,7,6,6,8,19,23,-4,24
Amkar,3145,8,6,4,10,12,23,-11,22
FK Rubin,3145,9,5,6,9,23,21,2,21
Rostov,3145,10,4,6,10,11,20,-9,18
Anzhi,3145,11,2,5,13,14,43,-29,11
Loko Moscow,3146,1,12,5,3,34,14,20,41
CSKA Moscow,3146,2,11,4,5,27,18,9,37
Spart Moscow,3146,3,9,7,4,40,30,10,34
Zenit,3146,4,8,9,3,24,15,9,33
Terek Grozny,3146,5,9,5,6,22,22,0,32
Krasnodar,3146,6,8,5,7,29,29,0,29
FK Rubin,3146,7,6,6,8,23,18,5,24
Din Moscow,3146,8,5,7,8,19,24,-5,22
Rostov,3146,9,4,6,10,11,20,-9,18
Amkar,3146,10,4,5,11,11,25,-14,17
Anzhi,3146,11,2,5,13,14,39,-25,11
Loko Moscow,3147,1,12,5,3,31,13,18,41
Spart Moscow,3147,2,11,5,4,41,27,14,38
CSKA Moscow,3147,3,11,3,6,27,19,8,36
Zenit,3147,4,9,8,3,23,13,10,35
Krasnodar,3147,5,9,4,7,31,27,4,31
Terek Grozny,3147,6,7,6,7,20,23,-3,27
FK Rubin,3147,7,6,5,9,24,20,4,23
Din Moscow,3147,8,5,6,9,17,25,-8,21
Amkar,3147,9,5,4,11,12,25,-13,19
Rostov,3147,10,4,6,10,10,20,-10,18
Anzhi,3147,11,2,6,12,15,39,-24,12
Loko Moscow,3148,1,11,6,3,29,13,16,39
Spart Moscow,3148,2,11,5,4,39,26,13,38
CSKA Moscow,3148,3,11,3,6,31,18,13,36
Zenit,3148,4,8,9,3,22,13,9,33
Krasnodar,3148,5,9,5,6,29,24,5,32
Terek Grozny,3148,6,7,6,7,20,23,-3,27
FK Rubin,3148,7,6,6,8,23,18,5,24
Din Moscow,3148,8,5,6,9,18,26,-8,21
Amkar,3148,9,5,4,11,11,24,-13,19
Rostov,3148,10,4,6,10,10,18,-8,18
Anzhi,3148,11,2,6,12,14,43,-29,12
Loko Moscow,3149,1,12,6,2,30,11,19,42
CSKA Moscow,3149,2,11,3,6,29,19,10,36
Spart Moscow,3149,3,10,5,5,39,30,9,35
Zenit,3149,4,8,8,4,23,15,8,32
Krasnodar,3149,5,8,5,7,27,26,1,29
Terek Grozny,3149,6,7,7,6,21,23,-2,28
FK Rubin,3149,7,7,5,8,24,17,7,26
Din Moscow,3149,8,5,6,9,17,23,-6,21
Amkar,3149,9,5,5,10,13,23,-10,20
Rostov,3149,10,4,6,10,11,21,-10,18
Anzhi,3149,11,2,6,12,15,41,-26,12
Loko Moscow,3150,1,11,7,2,31,13,18,40
Spart Moscow,3150,2,10,6,4,36,26,10,36
CSKA Moscow,3150,3,11,3,6,29,19,10,36
Zenit,3150,4,8,9,3,25,15,10,33
Terek Grozny,3150,5,9,5,6,23,22,1,32
Krasnodar,3150,6,8,6,6,28,25,3,30
FK Rubin,3150,7,5,7,8,22,18,4,22
Din Moscow,3150,8,5,7,8,17,22,-5,22
Rostov,3150,9,4,6,10,10,18,-8,18
Amkar,3150,10,4,5,11,10,24,-14,17
Anzhi,3150,11,2,5,13,14,43,-29,11
Loko Moscow,3151,1,12,5,3,33,14,19,41
Spart Moscow,3151,2,10,5,5,38,29,9,35
CSKA Moscow,3151,3,10,4,6,27,20,7,34
Zenit,3151,4,8,8,4,24,17,7,32
Krasnodar,3151,5,9,5,6,28,24,4,32
Terek Grozny,3151,6,9,5,6,26,23,3,32
FK Rubin,3151,7,6,6,8,22,17,5,24
Din Moscow,3151,8,6,6,8,18,22,-4,24
Rostov,3151,9,4,6,10,11,19,-8,18
Amkar,3151,10,4,4,12,12,27,-15,16
Anzhi,3151,11,2,6,12,16,43,-27,12
Loko Moscow,3152,1,12,6,2,32,13,19,42
Spart Moscow,3152,2,10,6,4,37,27,10,36
CSKA Moscow,3152,3,10,4,6,26,19,7,34
Zenit,3152,4,7,9,4,23,16,7,30
Krasnodar,3152,5,8,5,7,28,27,1,29
Terek Grozny,3152,6,8,5,7,23,25,-2,29
Din Moscow,3152,7,6,6,8,19,23,-4,24
FK Rubin,3152,8,6,5,9,23,18,5,23
Rostov,3152,9,4,7,9,10,17,-7,19
Anzhi,3152,10,4,5,11,17,38,-21,17
Amkar,3152,11,4,4,12,11,26,-15,16
Loko Moscow,3153,1,12,6,2,30,11,19,42
CSKA Moscow,3153,2,12,3,5,29,18,11,39
Spart Moscow,3153,3,10,5,5,38,28,10,35
Krasnodar,3153,4,9,5,6,29,24,5,32
Terek Grozny,3153,5,8,6,6,22,23,-1,30
Zenit,3153,6,7,8,5,21,16,5,29
FK Rubin,3153,7,6,5,9,22,19,3,23
Din Moscow,3153,8,5,6,9,18,24,-6,21
Amkar,3153,9,5,4,11,12,25,-13,19
Rostov,3153,10,4,6,10,10,19,-9,18
Anzhi,3153,11,2,6,12,15,39,-24,12
Loko Moscow,3154,1,13,5,2,37,12,25,44
Spart Moscow,3154,2,10,5,5,42,29,13,35
CSKA Moscow,3154,3,10,4,6,26,19,7,34
Zenit,3154,4,8,8,4,22,18,4,32
Terek Grozny,3154,5,8,6,6,23,24,-1,30
Krasnodar,3154,6,8,4,8,30,30,0,28
FK Rubin,3154,7,6,6,8,25,20,5,24
Din Moscow,3154,8,5,7,8,19,25,-6,22
Amkar,3154,9,5,5,10,13,25,-12,20
Rostov,3154,10,4,6,10,10,21,-11,18
Anzhi,3154,11,2,6,12,16,40,-24,12
Loko Moscow,3155,1,11,5,4,30,15,15,38
CSKA Moscow,3155,2,11,4,5,27,18,9,37
Zenit,3155,3,8,9,3,23,14,9,33
Spart Moscow,3155,4,9,6,5,34,27,7,33
Krasnodar,3155,5,9,5,6,29,24,5,32
Terek Grozny,3155,6,8,5,7,22,25,-3,29
Din Moscow,3155,7,6,7,7,19,22,-3,25
FK Rubin,3155,8,5,6,9,22,19,3,21
Rostov,3155,9,5,6,9,12,17,-5,21
Amkar,3155,10,4,4,12,9,24,-15,16
Anzhi,3155,11,3,5,12,18,40,-22,14
Loko Moscow,3156,1,13,5,2,33,12,21,44
CSKA Moscow,3156,2,11,4,5,31,18,13,37
Spart Moscow,3156,3,10,6,4,41,28,13,36
Krasnodar,3156,4,9,4,7,29,27,2,31
Zenit,3156,5,7,9,4,23,16,7,30
Terek Grozny,3156,6,7,6,7,22,26,-4,27
FK Rubin,3156,7,6,5,9,25,20,5,23
Din Moscow,3156,8,5,6,9,19,29,-10,21
Amkar,3156,9,5,5,10,13,24,-11,20
Rostov,3156,10,4,6,10,11,19,-8,18
Anzhi,3156,11,2,6,12,15,43,-28,12
Loko Moscow,3157,1,13,5,2,33,13,20,44
CSKA Moscow,3157,2,11,4,5,28,18,10,37
Spart Moscow,3157,3,10,5,5,39,28,11,35
Krasnodar,3157,4,9,4,7,31,28,3,31
Zenit,3157,5,7,9,4,23,16,7,30
Terek Grozny,3157,6,8,5,7,23,25,-2,29
Din Moscow,3157,7,5,7,8,18,24,-6,22
FK Rubin,3157,8,5,6,9,23,20,3,21
Rostov,3157,9,5,6,9,11,17,-6,21
Amkar,3157,10,5,4,11,11,25,-14,19
Anzhi,3157,11,2,5,13,16,42,-26,11
Loko Moscow,3158,1,13,5,2,32,12,20,44
CSKA Moscow,3158,2,11,3,6,28,18,10,36
Spart Moscow,3158,3,10,5,5,40,29,11,35
Zenit,3158,4,8,8,4,22,14,8,32
Terek Grozny,3158,5,9,5,6,23,23,0,32
Krasnodar,3158,6,8,4,8,29,30,-1,28
FK Rubin,3158,7,7,5,8,28,18,10,26
Din Moscow,3158,8,6,6,8,20,26,-6,24
Rostov,3158,9,4,6,10,10,19,-9,18
Amkar,3158,10,4,4,12,11,27,-16,16
Anzhi,3158,11,2,5,13,14,41,-27,11
Loko Moscow,3159,1,12,5,3,32,14,18,41
CSKA Moscow,3159,2,11,3,6,29,20,9,36
Krasnodar,3159,3,10,4,6,35,26,9,34
Spart Moscow,3159,4,9,6,5,40,29,11,33
Zenit,3159,5,8,8,4,23,15,8,32
Terek Grozny,3159,6,8,6,6,21,22,-1,30
Din Moscow,3159,7,5,7,8,19,27,-8,22
FK Rubin,3159,8,5,6,9,22,23,-1,21
Rostov,3159,9,4,7,9,11,18,-7,19
Amkar,3159,10,5,4,11,11,24,-13,19
Anzhi,3159,11,2,6,12,15,40,-25,12
Loko Moscow,3160,1,11,5,4,29,13,16,38
CSKA Moscow,3160,2,11,3,6,26,19,7,36
Zenit,3160,3,9,8,3,24,13,11,35
Spart Moscow,3160,4,10,5,5,38,29,9,35
Krasnodar,3160,5,9,5,6,31,27,4,32
Terek Grozny,3160,6,8,5,7,23,25,-2,29
Din Moscow,3160,7,6,6,8,19,23,-4,24
FK Rubin,3160,8,5,6,9,24,21,3,21
Rostov,3160,9,5,6,9,13,18,-5,21
Amkar,3160,10,5,4,11,11,25,-14,19
Anzhi,3160,11,2,5,13,15,40,-25,11
Loko Moscow,3161,1,12,6,2,34,13,21,42
CSKA Moscow,3161,2,12,3,5,27,17,10,39
Spart Moscow,3161,3,10,5,5,37,30,7,35
Krasnodar,3161,4,9,4,7,30,29,1,31
Zenit,3161,5,7,9,4,22,15,7,30
Din Moscow,3161,6,7,6,7,22,22,0,27
Terek Grozny,3161,7,7,5,8,21,25,-4,26
FK Rubin,3161,8,5,5,10,23,21,2,20
Amkar,3161,9,5,4,11,12,25,-13,19
Rostov,3161,10,4,6,10,11,19,-8,18
Anzhi,3161,11,3,5,12,15,38,-23,14
Loko Moscow,3162,1,12,5,3,31,13,18,41
CSKA Moscow,3162,2,12,3,5,28,18,10,39
Spart Moscow,3162,3,9,5,6,35,27,8,32
Krasnodar,3162,4,9,5,6,29,25,4,32
Zenit,3162,5,7,8,5,23,17,6,29
Terek Grozny,3162,6,8,5,7,22,24,-2,29
FK Rubin,3162,7,5,7,8,24,20,4,22
Din Moscow,3162,8,5,7,8,19,25,-6,22
Rostov,3162,9,5,6,9,11,17,-6,21
Amkar,3162,10,5,4,11,10,23,-13,19
Anzhi,3162,11,3,5,12,16,39,-23,14
Loko Moscow,3163,1,11,6,3,31,14,17,39
Spart Moscow,3163,2,11,5,4,39,27,12,38
CSKA Moscow,3163,3,11,3,6,27,21,6,36
Zenit,3163,4,9,8,3,26,14,12,35
Krasnodar,3163,5,8,5,7,29,27,2,29
Terek Grozny,3163,6,8,5,7,22,23,-1,29
FK Rubin,3163,7,7,5,8,25,19,6,26
Din Moscow,3163,8,5,6,9,19,25,-6,21
Rostov,3163,9,4,6,10,10,18,-8,18
Amkar,3163,10,4,4,12,10,27,-17,16
Anzhi,3163,11,3,5,12,16,39,-23,14
Loko Moscow,3164,1,12,6,2,33,12,21,42
CSKA Moscow,3164,2,10,4,6,26,19,7,34
Spart Moscow,3164,3,9,6,5,36,28,8,33
Zenit,3164,4,7,10,3,23,15,8,31
Krasnodar,3164,5,8,4,8,28,29,-1,28
Terek Grozny,3164,6,7,6,7,22,25,-3,27
FK Rubin,3164,7,7,5,8,27,20,7,26
Din Moscow,3164,8,5,7,8,20,26,-6,22
Amkar,3164,9,6,4,10,12,22,-10,22
Rostov,3164,10,4,6,10,10,19,-9,18
Anzhi,3164,11,3,6,11,17,39,-22,15
Loko Moscow,3165,1,11,7,2,29,11,18,40
CSKA Moscow,3165,2,12,3,5,32,17,15,39
Spart Moscow,3165,3,9,6,5,36,27,9,33
Zenit,3165,4,7,9,4,21,15,6,30
Krasnodar,3165,5,8,5,7,28,26,2,29
Din Moscow,3165,6,7,6,7,21,21,0,27
Terek Grozny,3165,7,7,5,8,21,28,-7,26
FK Rubin,3165,8,6,5,9,23,20,3,23
Rostov,3165,9,4,7,9,10,17,-7,19
Amkar,3165,10,5,4,11,13,25,-12,19
Anzhi,3165,11,3,5,12,16,43,-27,14
Loko Moscow,3166,1,13,5,2,35,11,24,44
CSKA Moscow,3166,2,10,5,5,27,19,8,35
Spart Moscow,3166,3,9,7,4,38,29,9,34
Terek Grozny,3166,4,9,5,6,24,23,1,32
Zenit,3166,5,7,9,4,21,17,4,30
Krasnodar,3166,6,8,5,7,28,27,1,29
FK Rubin,3166,7,5,7,8,22,18,4,22
Din Moscow,3166,8,5,7,8,19,24,-5,22
Rostov,3166,9,4,7,9,11,18,-7,19
Amkar,3166,10,4,5,11,11,25,-14,17
Anzhi,3166,11,2,6,12,16,41,-25,12
Loko Moscow,3167,1,12,6,2,33,12,21,42
Spart Moscow,3167,2,10,5,5,39,27,12,35
CSKA Moscow,3167,3,10,5,5,28,20,8,35
Krasnodar,3167,4,9,5,6,30,25,5,32
Terek Grozny,3167,5,9,5,6,25,23,2,32
Zenit,3167,6,7,9,4,22,17,5,30
Din Moscow,3167,7,5,7,8,18,23,-5,22
FK Rubin,3167,8,5,6,9,21,19,2,21
Amkar,3167,9,5,4,11,11,25,-14,19
Rostov,3167,10,4,6,10,10,21,-11,18
Anzhi,3167,11,2,6,12,16,41,-25,12
Loko Moscow,3168,1,12,5,3,31,13,18,41
CSKA Moscow,3168,2,11,4,5,28,19,9,37
Krasnodar,3168,3,10,4,6,29,24,5,34
Spart Moscow,3168,4,9,6,5,37,28,9,33
Zenit,3168,5,7,9,4,23,16,7,30
Terek Grozny,3168,6,8,6,6,24,23,1,30
Din Moscow,3168,7,6,7,7,20,22,-2,25
FK Rubin,3168,8,5,5,10,21,20,1,20
Amkar,3168,9,5,4,11,11,26,-15,19
Rostov,3168,10,4,6,10,10,19,-9,18
Anzhi,3168,11,2,6,12,16,40,-24,12
Loko Moscow,3169,1,13,5,2,36,13,23,44
CSKA Moscow,3169,2,12,3,5,28,18,10,39
Spart Moscow,3169,3,10,6,4,39,28,11,36
Krasnodar,3169,4,9,4,7,33,28,5,31
Zenit,3169,5,7,8,5,23,19,4,29
Terek Grozny,3169,6,7,7,6,23,25,-2,28
Din Moscow,3169,7,6,6,8,19,24,-5,24
FK Rubin,3169,8,5,5,10,22,23,-1,20
Rostov,3169,9,4,6,10,12,20,-8,18
Amkar,3169,10,4,6,10,10,23,-13,18
Anzhi,3169,11,2,6,12,16,40,-24,12
Loko Moscow,3170,1,11,5,4,29,13,16,38
CSKA Moscow,3170,2,11,4,5,29,19,10,37
Spart Moscow,3170,3,10,6,4,38,25,13,36
Krasnodar,3170,4,10,4,6,30,24,6,34
Zenit,3170,5,8,9,3,22,13,9,33
Terek Grozny,3170,6,7,7,6,22,24,-2,28
FK Rubin,3170,7,6,5,9,22,19,3,23
Din Moscow,3170,8,5,6,9,17,24,-7,21
Rostov,3170,9,4,6,10,10,20,-10,18
Amkar,3170,10,4,6,10,10,23,-13,18
Anzhi,3170,11,2,6,12,17,42,-25,12
Loko Moscow,3171,1,12,6,2,30,11,19,42
Spart Moscow,3171,2,10,5,5,41,31,10,35
CSKA Moscow,3171,3,10,4,6,26,20,6,34
Zenit,3171,4,8,8,4,23,14,9,32
Krasnodar,3171,5,9,5,6,28,24,4,32
Terek Grozny,3171,6,7,5,8,22,27,-5,26
FK Rubin,3171,7,6,5,9,23,18,5,23
Amkar,3171,8,6,4,10,13,24,-11,22
Din Moscow,3171,9,5,6,9,18,25,-7,21
Rostov,3171,10,4,6,10,12,21,-9,18
Anzhi,3171,11,3,6,11,19,40,-21,15
Loko Moscow,3172,1,11,7,2,30,12,18,40
CSKA Moscow,3172,2,11,4,5,30,18,12,37
Spart Moscow,3172,3,9,5,6,34,27,7,32
Zenit,3172,4,7,10,3,23,15,8,31
Krasnodar,3172,5,8,6,6,28,25,3,30
Terek Grozny,3172,6,8,6,6,23,23,0,30
Din Moscow,3172,7,7,6,7,19,21,-2,27
FK Rubin,3172,8,5,6,9,22,19,3,21
Amkar,3172,9,5,4,11,10,24,-14,19
Rostov,3172,10,4,6,10,10,18,-8,18
Anzhi,3172,11,2,6,12,15,42,-27,12
Loko Moscow,3173,1,12,5,3,33,15,18,41
CSKA Moscow,3173,2,11,3,6,29,21,8,36
Spart Moscow,3173,3,9,6,5,36,27,9,33
Zenit,3173,4,8,8,4,24,15,9,32
Krasnodar,3173,5,9,5,6,33,28,5,32
Din Moscow,3173,6,7,6,7,21,22,-1,27
Terek Grozny,3173,7,7,6,7,21,24,-3,27
FK Rubin,3173,8,5,6,9,23,21,2,21
Rostov,3173,9,4,7,9,10,17,-7,19
Amkar,3173,10,4,5,11,10,25,-15,17
Anzhi,3173,11,3,5,12,16,41,-25,14
Loko Moscow,3174,1,12,5,3,35,13,22,41
CSKA Moscow,3174,2,11,4,5,27,17,10,37
Spart Moscow,3174,3,9,7,4,37,27,10,34
Krasnodar,3174,4,10,4,6,31,25,6,34
Zenit,3174,5,7,9,4,21,18,3,30
Terek Grozny,3174,6,8,5,7,23,24,-1,29
Din Moscow,3174,7,5,8,7,19,23,-4,23
FK Rubin,3174,8,5,6,9,23,21,2,21
Rostov,3174,9,4,6,10,10,19,-9,18
Amkar,3174,10,4,5,11,12,27,-15,17
Anzhi,3174,11,3,5,12,15,39,-24,14
Loko Moscow,3175,1,13,5,2,33,12,21,44
CSKA Moscow,3175,2,11,4,5,29,19,10,37
Spart Moscow,3175,3,10,6,4,38,27,11,36
Krasnodar,3175,4,9,4,7,28,26,2,31
Terek Grozny,3175,5,8,6,6,24,24,0,30
Zenit,3175,6,7,8,5,23,18,5,29
Din Moscow,3175,7,5,7,8,20,25,-5,22
FK Rubin,3175,8,5,6,9,22,19,3,21
Rostov,3175,9,4,7,9,10,17,-7,19
Amkar,3175,10,4,5,11,10,25,-15,17
Anzhi,3175,11,2,6,12,16,41,-25,12
Loko Moscow,3176,1,11,6,3,31,14,17,39
CSKA Moscow,3176,2,11,4,5,27,17,10,37
Zenit,3176,3,8,9,3,22,13,9,33
Spart Moscow,3176,4,9,6,5,38,30,8,33
Krasnodar,3176,5,9,5,6,31,27,4,32
Terek Grozny,3176,6,9,5,6,25,22,3,32
Din Moscow,3176,7,6,6,8,21,23,-2,24
FK Rubin,3176,8,6,5,9,24,20,4,23
Rostov,3176,9,4,6,10,10,20,-10,18
Amkar,3176,10,4,5,11,11,25,-14,17
Anzhi,3176,11,2,5,13,14,43,-29,11
Loko Moscow,3177,1,13,5,2,32,12,20,44
CSKA Moscow,3177,2,10,4,6,26,19,7,34
Spart Moscow,3177,3,9,6,5,38,29,9,33
Zenit,3177,4,8,8,4,23,15,8,32
Krasnodar,3177,5,8,4,8,28,27,1,28
Terek Grozny,3177,6,7,5,8,20,26,-6,26
FK Rubin,3177,7,6,6,8,24,19,5,24
Din Moscow,3177,8,5,7,8,18,25,-7,22
Rostov,3177,9,5,6,9,14,19,-5,21
Amkar,3177,10,5,5,10,10,22,-12,20
Anzhi,3177,11,3,6,11,18,38,-20,15
Loko Moscow,3178,1,11,6,3,29,15,14,39
CSKA Moscow,3178,2,11,3,6,30,19,11,36
Spart Moscow,3178,3,10,5,5,39,31,8,35
Zenit,3178,4,8,9,3,23,13,10,33
Krasnodar,3178,5,9,4,7,31,26,5,31
Terek Grozny,3178,6,7,6,7,22,26,-4,27
Din Moscow,3178,7,6,6,8,19,24,-5,24
FK Rubin,3178,8,6,5,9,23,18,5,23
Amkar,3178,9,5,5,10,13,23,-10,20
Rostov,3178,10,4,6,10,12,20,-8,18
Anzhi,3178,11,3,5,12,17,43,-26,14
Loko Moscow,3179,1,11,6,3,29,12,17,39
CSKA Moscow,3179,2,12,3,5,27,17,10,39
Spart Moscow,3179,3,10,5,5,36,27,9,35
Zenit,3179,4,8,8,4,22,14,8,32
Terek Grozny,3179,5,9,5,6,23,23,0,32
Krasnodar,3179,6,8,6,6,28,25,3,30
FK Rubin,3179,7,5,7,8,22,18,4,22
Din Moscow,3179,8,5,7,8,18,23,-5,22
Amkar,3179,9,5,4,11,11,24,-13,19
Rostov,3179,10,4,6,10,10,18,-8,18
Anzhi,3179,11,2,5,13,14,39,-25,11
Loko Moscow,3180,1,11,6,3,30,15,15,39
CSKA Moscow,3180,2,12,3,5,31,18,13,39
Spart Moscow,3180,3,10,6,4,40,26,14,36
Krasnodar,3180,4,9,5,6,31,25,6,32
Terek Grozny,3180,5,9,5,6,24,23,1,32
Zenit,3180,6,7,9,4,23,16,7,30
Din Moscow,3180,7,5,8,7,18,22,-4,23
FK Rubin,3180,8,5,7,8,23,19,4,22
Rostov,3180,9,4,6,10,11,21,-10,18
Amkar,3180,10,4,4,12,9,26,-17,16
Anzhi,3180,11,2,5,13,15,44,-29,11
Loko Moscow,3181,1,13,5,2,33,11,22,44
CSKA Moscow,3181,2,10,4,6,25,19,6,34
Zenit,3181,3,8,8,4,23,15,8,32
Spart Moscow,3181,4,8,7,5,34,29,5,31
Krasnodar,3181,5,8,4,8,27,27,0,28
Din Moscow,3181,6,7,6,7,21,21,0,27
Terek Grozny,3181,7,7,6,7,20,24,-4,27
FK Rubin,3181,8,6,5,9,22,18,4,23
Rostov,3181,9,4,7,9,11,18,-7,19
Amkar,3181,10,4,6,10,9,22,-13,18
Anzhi,3181,11,3,6,11,16,37,-21,15
Loko Moscow,3182,1,11,5,4,30,14,16,38
CSKA Moscow,3182,2,10,5,5,27,19,8,35
Zenit,3182,3,8,9,3,24,15,9,33
Spart Moscow,3182,4,9,5,6,35,28,7,32
Krasnodar,3182,5,9,4,7,30,28,2,31
Terek Grozny,3182,6,8,5,7,22,24,-2,29
FK Rubin,3182,7,7,5,8,25,18,7,26
Amkar,3182,8,6,4,10,12,23,-11,22
Din Moscow,3182,9,5,6,9,17,23,-6,21
Rostov,3182,10,5,6,9,12,18,-6,21
Anzhi,3182,11,2,6,12,14,38,-24,12
Loko Moscow,3183,1,13,5,2,35,13,22,44
Spart Moscow,3183,2,10,6,4,42,26,16,36
CSKA Moscow,3183,3,11,3,6,28,19,9,36
Zenit,3183,4,8,8,4,24,17,7,32
Terek Grozny,3183,5,9,5,6,24,23,1,32
Krasnodar,3183,6,9,4,7,29,27,2,31
Din Moscow,3183,7,6,6,8,20,25,-5,24
FK Rubin,3183,8,5,5,10,21,20,1,20
Rostov,3183,9,4,6,10,10,22,-12,18
Amkar,3183,10,4,5,11,9,24,-15,17
Anzhi,3183,11,2,5,13,15,41,-26,11
Loko Moscow,3184,1,11,6,3,29,12,17,39
CSKA Moscow,3184,2,11,3,6,30,19,11,36
Spart Moscow,3184,3,10,6,4,36,26,10,36
Zenit,3184,4,9,8,3,24,14,10,35
Krasnodar,3184,5,8,5,7,28,26,2,29
Terek Grozny,3184,6,7,6,7,21,26,-5,27
FK Rubin,3184,7,7,5,8,25,18,7,26
Din Moscow,3184,8,5,7,8,17,23,-6,22
Amkar,3184,9,5,4,11,13,24,-11,19
Rostov,3184,10,4,6,10,10,18,-8,18
Anzhi,3184,11,2,6,12,15,42,-27,12
Loko Moscow,3185,1,13,5,2,34,13,21,44
Spart Moscow,3185,2,10,6,4,40,27,13,36
CSKA Moscow,3185,3,11,3,6,27,18,9,36
Zenit,3185,4,8,8,4,24,17,7,32
Krasnodar,3185,5,8,5,7,29,27,2,29
Terek Grozny,3185,6,8,5,7,22,25,-3,29
FK Rubin,3185,7,6,6,8,27,21,6,24
Din Moscow,3185,8,5,6,9,19,27,-8,21
Rostov,3185,9,4,6,10,12,22,-10,18
Amkar,3185,10,4,5,11,9,24,-15,17
Anzhi,3185,11,3,5,12,17,39,-22,14
Loko Moscow,3186,1,13,5,2,37,11,26,44
CSKA Moscow,3186,2,11,4,5,27,18,9,37
Spart Moscow,3186,3,8,8,4,35,27,8,32
Zenit,3186,4,7,9,4,22,20,2,30
Krasnodar,3186,5,8,5,7,30,29,1,29
Terek Grozny,3186,6,7,5,8,22,27,-5,26
Din Moscow,3186,7,6,7,7,20,22,-2,25
FK Rubin,3186,8,5,6,9,25,23,2,21
Amkar,3186,9,5,5,10,13,25,-12,20
Rostov,3186,10,4,7,9,11,18,-7,19
Anzhi,3186,11,3,5,12,16,38,-22,14
Loko Moscow,3187,1,11,6,3,31,15,16,39
Zenit,3187,2,9,8,3,25,14,11,35
Spart Moscow,3187,3,9,7,4,38,28,10,34
CSKA Moscow,3187,4,10,4,6,27,20,7,34
Krasnodar,3187,5,9,5,6,32,26,6,32
Terek Grozny,3187,6,8,6,6,23,23,0,30
Din Moscow,3187,7,6,7,7,20,23,-3,25
FK Rubin,3187,8,5,5,10,21,21,0,20
Rostov,3187,9,4,6,10,10,19,-9,18
Amkar,3187,10,4,5,11,11,26,-15,17
Anzhi,3187,11,2,7,11,15,38,-23,13
Loko Moscow,3188,1,11,6,3,31,14,17,39
CSKA Moscow,3188,2,11,3,6,27,19,8,36
Spart Moscow,3188,3,9,6,5,39,29,10,33
Zenit,3188,4,8,9,3,23,14,9,33
Terek Grozny,3188,5,9,5,6,23,23,0,32
Krasnodar,3188,6,9,4,7,31,28,3,31
Din Moscow,3188,7,7,6,7,20,22,-2,27
FK Rubin,3188,8,6,5,9,24,20,4,23
Rostov,3188,9,4,6,10,11,21,-10,18
Amkar,3188,10,4,5,11,11,25,-14,17
Anzhi,3188,11,2,5,13,15,40,-25,11
Loko Moscow,3189,1,11,6,3,31,14,17,39
CSKA Moscow,3189,2,11,4,5,27,17,10,37
Krasnodar,3189,3,10,4,6,31,25,6,34
Spart Moscow,3189,4,9,6,5,39,30,9,33
Zenit,3189,5,7,10,3,22,14,8,31
Terek Grozny,3189,6,7,5,8,20,24,-4,26
Din Moscow,3189,7,6,6,8,18,23,-5,24
Amkar,3189,8,6,4,10,12,23,-11,22
FK Rubin,3189,9,5,5,10,21,20,1,20
Rostov,3189,10,4,7,9,13,20,-7,19
Anzhi,3189,11,3,5,12,15,39,-24,14
Loko Moscow,3190,1,12,5,3,32,14,18,41
CSKA Moscow,3190,2,11,4,5,30,18,12,37
Krasnodar,3190,3,10,4,6,29,24,5,34
Spart Moscow,3190,4,9,6,5,37,28,9,33
Zenit,3190,5,7,9,4,23,16,7,30
Terek Grozny,3190,6,8,5,7,22,24,-2,29
Din Moscow,3190,7,6,7,7,20,22,-2,25
Rostov,3190,8,5,6,9,12,18,-6,21
FK Rubin,3190,9,5,5,10,21,20,1,20
Amkar,3190,10,4,4,12,10,26,-16,16
Anzhi,3190,11,3,5,12,16,42,-26,14
Loko Moscow,3191,1,11,7,2,31,13,18,40
Spart Moscow,3191,2,10,6,4,42,30,12,36
CSKA Moscow,3191,3,10,4,6,25,19,6,34
Krasnodar,3191,4,9,5,6,30,26,4,32
Zenit,3191,5,7,10,3,22,14,8,31
Terek Grozny,3191,6,7,7,6,22,24,-2,28
Din Moscow,3191,7,5,7,8,21,26,-5,22
FK Rubin,3191,8,5,6,9,23,20,3,21
Rostov,3191,9,4,6,10,10,20,-10,18
Amkar,3191,10,4,6,10,13,26,-13,18
Anzhi,3191,11,3,6,11,16,37,-21,15
Loko Moscow,3192,1,12,5,3,30,15,15,41
Spart Moscow,3192,2,10,5,5,37,28,9,35
CSKA Moscow,3192,3,10,5,5,26,18,8,35
Krasnodar,3192,4,9,5,6,32,25,7,32
Zenit,3192,5,7,9,4,21,14,7,30
Terek Grozny,3192,6,7,5,8,21,26,-5,26
FK Rubin,3192,7,6,6,8,23,18,5,24
Amkar,3192,8,6,4,10,14,23,-9,22
Din Moscow,3192,9,5,6,9,17,23,-6,21
Rostov,3192,10,4,6,10,10,19,-9,18
Anzhi,3192,11,3,6,11,17,39,-22,15
Loko Moscow,3193,1,12,5,3,30,12,18,41
Spart Moscow,3193,2,10,6,4,39,27,12,36
CSKA Moscow,3193,3,11,3,6,28,21,7,36
Zenit,3193,4,8,8,4,23,14,9,32
Krasnodar,3193,5,9,4,7,28,25,3,31
Terek Grozny,3193,6,8,6,6,23,24,-1,30
Din Moscow,3193,7,6,7,7,20,23,-3,25
FK Rubin,3193,8,6,5,9,22,18,4,23
Rostov,3193,9,4,6,10,10,19,-9,18
Amkar,3193,10,4,4,12,10,26,-16,16
Anzhi,3193,11,2,6,12,17,41,-24,12
Loko Moscow,3194,1,11,5,4,30,15,15,38
CSKA Moscow,3194,2,11,3,6,29,19,10,36
Zenit,3194,3,9,8,3,24,14,10,35
Spart Moscow,3194,4,9,7,4,40,29,11,34
Krasnodar,3194,5,9,4,7,30,26,4,31
Terek Grozny,3194,6,8,5,7,22,24,-2,29
FK Rubin,3194,7,7,5,8,23,17,6,26
Din Moscow,3194,8,5,7,8,20,25,-5,22
Amkar,3194,9,5,5,10,11,23,-12,20
Rostov,3194,10,4,6,10,11,21,-10,18
Anzhi,3194,11,2,5,13,14,41,-27,11
Loko Moscow,3195,1,12,5,3,34,16,18,41
CSKA Moscow,3195,2,10,5,5,26,18,8,35
Zenit,3195,3,8,9,3,25,16,9,33
Krasnodar,3195,4,9,4,7,31,27,4,31
Spart Moscow,3195,5,8,5,7,34,31,3,29
Terek Grozny,3195,6,8,5,7,22,25,-3,29
Din Moscow,3195,7,6,7,7,21,22,-1,25
FK Rubin,3195,8,5,6,9,21,19,2,21
Rostov,3195,9,5,6,9,11,17,-6,21
Amkar,3195,10,5,4,11,10,23,-13,19
Anzhi,3195,11,3,6,11,17,38,-21,15
Loko Moscow,3196,1,11,6,3,29,12,17,39
CSKA Moscow,3196,2,11,4,5,31,18,13,37
Spart Moscow,3196,3,9,6,5,34,29,5,33
Krasnodar,3196,4,9,5,6,29,25,4,32
Zenit,3196,5,7,10,3,21,13,8,31
Terek Grozny,3196,6,7,6,7,22,25,-3,27
Din Moscow,3196,7,6,7,7,19,22,-3,25
Amkar,3196,8,6,4,10,15,23,-8,22
FK Rubin,3196,9,5,6,9,23,20,3,21
Rostov,3196,10,4,6,10,10,18,-8,18
Anzhi,3196,11,2,6,12,16,44,-28,12
Loko Moscow,3197,1,12,5,3,30,13,17,41
Spart Moscow,3197,2,11,5,4,43,29,14,38
CSKA Moscow,3197,3,10,5,5,25,17,8,35
Krasnodar,3197,4,9,4,7,29,25,4,31
Zenit,3197,5,7,9,4,21,14,7,30
Terek Grozny,3197,6,8,6,6,23,24,-1,30
FK Rubin,3197,7,7,5,8,24,18,6,26
Din Moscow,3197,8,5,6,9,20,26,-6,21
Rostov,3197,9,4,6,10,10,21,-11,18
Amkar,3197,10,4,4,12,11,26,-15,16
Anzhi,3197,11,2,7,11,16,39,-23,13
Loko Moscow,3198,1,11,6,3,33,16,17,39
Spart Moscow,3198,2,10,6,4,37,27,10,36
CSKA Moscow,3198,3,11,3,6,27,19,8,36
Zenit,3198,4,9,8,3,25,14,11,35
Krasnodar,3198,5,9,5,6,33,28,5,32
Terek Grozny,3198,6,7,6,7,21,24,-3,27
Din Moscow,3198,7,5,7,8,18,23,-5,22
FK Rubin,3198,8,5,6,9,22,20,2,21
Amkar,3198,9,5,5,10,12,24,-12,20
Rostov,3198,10,4,6,10,10,18,-8,18
Anzhi,3198,11,2,6,12,14,39,-25,12
Loko Moscow,3199,1,12,6,2,31,12,19,42
CSKA Moscow,3199,2,11,4,5,29,17,12,37
Spart Moscow,3199,3,10,5,5,38,27,11,35
Zenit,3199,4,7,9,4,21,14,7,30
Krasnodar,3199,5,8,5,7,29,27,2,29
Terek Grozny,3199,6,8,5,7,22,23,-1,29
FK Rubin,3199,7,6,6,8,23,18,5,24
Din Moscow,3199,8,5,7,8,17,23,-6,22
Amkar,3199,9,6,4,10,12,23,-11,22
Rostov,3199,10,4,6,10,10,19,-9,18
Anzhi,3199,11,2,5,13,14,43,-29,11
Loko Moscow,3200,1,11,6,3,30,15,15,39
Zenit,3200,2,9,8,3,25,13,12,35
CSKA Moscow,3200,3,10,4,6,26,19,7,34
Spart Moscow,3200,4,9,6,5,36,28,8,33
Terek Grozny,3200,5,9,5,6,24,22,2,32
Krasnodar,3200,6,8,6,6,28,25,3,30
Din Moscow,3200,7,7,6,7,22,23,-1,27
FK Rubin,3200,8,5,6,9,22,20,2,21
Rostov,3200,9,4,6,10,11,19,-8,18
Amkar,3200,10,4,5,11,9,23,-14,17
Anzhi,3200,11,2,6,12,15,41,-26,12
Loko Moscow,3201,1,11,6,3,30,13,17,39
CSKA Moscow,3201,2,10,5,5,28,20,8,35
Spart Moscow,3201,3,9,6,5,36,28,8,33
Krasnodar,3201,4,9,5,6,30,26,4,32
Zenit,3201,5,7,10,3,24,16,8,31
Terek Grozny,3201,6,8,5,7,21,26,-5,29
FK Rubin,3201,7,6,6,8,25,20,5,24
Din Moscow,3201,8,5,7,8,18,23,-5,22
Amkar,3201,9,5,4,11,11,24,-13,19
Rostov,3201,10,4,6,10,11,19,-8,18
Anzhi,3201,11,3,6,11,19,38,-19,15
CSKA Moscow,3202,1,12,3,5,30,19,11,39
Loko Moscow,3202,2,11,5,4,29,15,14,38
Spart Moscow,3202,3,10,5,5,35,26,9,35
Krasnodar,3202,4,10,4,6,29,24,5,34
Zenit,3202,5,8,8,4,24,14,10,32
Terek Grozny,3202,6,8,6,6,23,24,-1,30
Din Moscow,3202,7,5,7,8,17,22,-5,22
FK Rubin,3202,8,5,6,9,21,18,3,21
Amkar,3202,9,5,4,11,10,23,-13,19
Rostov,3202,10,4,6,10,10,18,-8,18
Anzhi,3202,11,2,6,12,18,43,-25,12
Loko Moscow,3203,1,11,5,4,33,17,16,38
CSKA Moscow,3203,2,11,3,6,29,20,9,36
Zenit,3203,3,9,8,3,26,16,10,35
Krasnodar,3203,4,9,4,7,29,26,3,31
Spart Moscow,3203,5,8,5,7,37,32,5,29
Terek Grozny,3203,6,7,7,6,21,23,-2,28
Din Moscow,3203,7,7,6,7,23,24,-1,27
FK Rubin,3203,8,6,5,9,24,21,3,23
Rostov,3203,9,5,6,9,13,19,-6,21
Amkar,3203,10,5,5,10,11,23,-12,20
Anzhi,3203,11,2,6,12,17,42,-25,12
Loko Moscow,3204,1,12,5,3,32,14,18,41
Spart Moscow,3204,2,11,5,4,41,28,13,38
CSKA Moscow,3204,3,11,4,5,28,18,10,37
Krasnodar,3204,4,10,4,6,30,24,6,34
Zenit,3204,5,7,8,5,23,19,4,29
Terek Grozny,3204,6,7,7,6,22,24,-2,28
Din Moscow,3204,7,6,6,8,21,24,-3,24
FK Rubin,3204,8,5,5,10,21,21,0,20
Rostov,3204,9,4,6,10,11,20,-9,18
Amkar,3204,10,4,5,11,11,25,-14,17
Anzhi,3204,11,2,7,11,15,38,-23,13
Loko Moscow,3205,1,11,6,3,30,13,17,39
CSKA Moscow,3205,2,11,3,6,27,18,9,36
Spart Moscow,3205,3,10,5,5,39,29,10,35
Krasnodar,3205,4,9,5,6,28,24,4,32
Zenit,3205,5,7,9,4,22,16,6,30
Terek Grozny,3205,6,7,6,7,21,24,-3,27
FK Rubin,3205,7,6,6,8,23,17,6,24
Din Moscow,3205,8,6,6,8,18,23,-5,24
Amkar,3205,9,5,4,11,12,25,-13,19
Rostov,3205,10,4,6,10,11,20,-9,18
Anzhi,3205,11,3,6,11,16,38,-22,15
Loko Moscow,3206,1,11,7,2,32,14,18,40
CSKA Moscow,3206,2,12,3,5,29,18,11,39
Spart Moscow,3206,3,11,5,4,44,26,18,38
Terek Grozny,3206,4,9,5,6,22,22,0,32
Zenit,3206,5,7,9,4,22,15,7,30
Krasnodar,3206,6,8,5,7,30,28,2,29
FK Rubin,3206,7,7,5,8,24,18,6,26
Din Moscow,3206,8,5,6,9,19,25,-6,21
Rostov,3206,9,4,6,10,10,20,-10,18
Amkar,3206,10,4,4,12,9,29,-20,16
Anzhi,3206,11,2,5,13,14,40,-26,11
Loko Moscow,3207,1,11,7,2,31,13,18,40
CSKA Moscow,3207,2,11,3,6,28,21,7,36
Zenit,3207,3,8,9,3,25,15,10,33
Spart Moscow,3207,4,8,8,4,37,29,8,32
Krasnodar,3207,5,8,6,6,29,26,3,30
Terek Grozny,3207,6,7,6,7,21,26,-5,27
Din Moscow,3207,7,5,8,7,18,22,-4,23
FK Rubin,3207,8,5,7,8,22,18,4,22
Rostov,3207,9,4,7,9,12,19,-7,19
Amkar,3207,10,4,6,10,11,24,-13,18
Anzhi,3207,11,3,5,12,18,39,-21,14
Loko Moscow,3208,1,12,6,2,32,11,21,42
CSKA Moscow,3208,2,11,4,5,27,18,9,37
Spart Moscow,3208,3,9,6,5,35,29,6,33
Zenit,3208,4,7,10,3,22,14,8,31
Krasnodar,3208,5,8,5,7,27,27,0,29
Terek Grozny,3208,6,8,5,7,23,25,-2,29
Din Moscow,3208,7,7,6,7,21,21,0,27
FK Rubin,3208,8,5,6,9,21,18,3,21
Amkar,3208,9,5,5,10,11,22,-11,20
Rostov,3208,10,4,6,10,11,19,-8,18
Anzhi,3208,11,2,5,13,15,41,-26,11
Loko Moscow,3209,1,12,6,2,33,14,19,42
CSKA Moscow,3209,2,11,3,6,28,19,9,36
Spart Moscow,3209,3,9,6,5,37,30,7,33
Krasnodar,3209,4,8,6,6,29,26,3,30
Zenit,3209,5,7,8,5,23,19,4,29
Terek Grozny,3209,6,7,5,8,20,25,-5,26
FK Rubin,3209,7,6,6,8,23,18,5,24
Din Moscow,3209,8,6,6,8,20,23,-3,24
Rostov,3209,9,4,7,9,12,19,-7,19
Amkar,3209,10,5,4,11,11,23,-12,19
Anzhi,3209,11,4,5,11,17,37,-20,17
Loko Moscow,3210,1,11,5,4,29,16,13,38
CSKA Moscow,3210,2,11,4,5,28,19,9,37
Spart Moscow,3210,3,10,5,5,39,27,12,35
Krasnodar,3210,4,10,4,6,33,25,8,34
Zenit,3210,5,8,8,4,23,15,8,32
Terek Grozny,3210,6,7,6,7,21,25,-4,27
Din Moscow,3210,7,6,6,8,20,24,-4,24
FK Rubin,3210,8,6,5,9,25,21,4,23
Rostov,3210,9,4,6,10,11,19,-8,18
Amkar,3210,10,4,5,11,10,27,-17,17
Anzhi,3210,11,3,6,11,17,38,-21,15
Loko Moscow,3211,1,12,5,3,32,14,18,41
CSKA Moscow,3211,2,11,3,6,30,23,7,36
Zenit,3211,3,8,8,4,26,17,9,32
Spart Moscow,3211,4,9,5,6,37,30,7,32
Krasnodar,3211,5,9,5,6,31,25,6,32
Terek Grozny,3211,6,7,6,7,21,24,-3,27
FK Rubin,3211,7,6,6,8,23,18,5,24
Din Moscow,3211,8,6,6,8,19,22,-3,24
Amkar,3211,9,5,5,10,12,23,-11,20
Rostov,3211,10,4,6,10,11,21,-10,18
Anzhi,3211,11,3,5,12,16,41,-25,14
Loko Moscow,3212,1,12,5,3,30,12,18,41
Spart Moscow,3212,2,10,6,4,39,26,13,36
CSKA Moscow,3212,3,11,3,6,28,20,8,36
Zenit,3212,4,8,8,4,23,15,8,32
Krasnodar,3212,5,9,5,6,28,24,4,32
Terek Grozny,3212,6,7,5,8,21,26,-5,26
FK Rubin,3212,7,6,6,8,23,18,5,24
Din Moscow,3212,8,5,7,8,19,24,-5,22
Amkar,3212,9,5,4,11,10,23,-13,19
Rostov,3212,10,4,6,10,10,21,-11,18
Anzhi,3212,11,3,5,12,18,40,-22,14
Loko Moscow,3213,1,11,7,2,29,11,18,40
CSKA Moscow,3213,2,11,3,6,29,19,10,36
Zenit,3213,3,8,9,3,22,13,9,33
Spart Moscow,3213,4,8,7,5,35,30,5,31
Terek Grozny,3213,5,8,6,6,23,24,-1,30
Krasnodar,3213,6,8,5,7,29,29,0,29
Din Moscow,3213,7,6,7,7,22,23,-1,25
FK Rubin,3213,8,6,6,8,28,21,7,24
Rostov,3213,9,4,7,9,11,18,-7,19
Amkar,3213,10,4,6,10,12,25,-13,18
Anzhi,3213,11,2,5,13,15,42,-27,11
Loko Moscow,3214,1,11,5,4,29,16,13,38
Spart Moscow,3214,2,10,6,4,40,27,13,36
CSKA Moscow,3214,3,11,3,6,30,20,10,36
Zenit,3214,4,9,8,3,25,15,10,35
Krasnodar,3214,5,9,4,7,32,26,6,31
Terek Grozny,3214,6,8,5,7,22,24,-2,29
FK Rubin,3214,7,7,5,8,25,19,6,26
Din Moscow,3214,8,5,6,9,18,27,-9,21
Rostov,3214,9,4,7,9,10,17,-7,19
Amkar,3214,10,4,4,12,11,26,-15,16
Anzhi,3214,11,3,5,12,16,41,-25,14
Loko Moscow,3215,1,13,5,2,35,12,23,44
CSKA Moscow,3215,2,11,4,5,28,19,9,37
Spart Moscow,3215,3,9,7,4,34,25,9,34
Zenit,3215,4,7,9,4,23,17,6,30
Krasnodar,3215,5,8,5,7,28,28,0,29
Terek Grozny,3215,6,7,6,7,21,25,-4,27
FK Rubin,3215,7,6,6,8,25,19,6,24
Din Moscow,3215,8,5,6,9,18,25,-7,21
Rostov,3215,9,4,7,9,10,17,-7,19
Amkar,3215,10,4,6,10,9,22,-13,18
Anzhi,3215,11,3,5,12,18,40,-22,14
Loko Moscow,3216,1,12,6,2,31,12,19,42
CSKA Moscow,3216,2,11,3,6,28,18,10,36
Spart Moscow,3216,3,10,5,5,41,27,14,35
Zenit,3216,4,8,8,4,22,14,8,32
Krasnodar,3216,5,8,6,6,28,25,3,30
Terek Grozny,3216,6,7,7,6,21,23,-2,28
FK Rubin,3216,7,6,6,8,22,17,5,24
Rostov,3216,8,5,6,9,12,17,-5,21
Din Moscow,3216,9,5,6,9,17,27,-10,21
Amkar,3216,10,4,5,11,9,25,-16,17
Anzhi,3216,11,2,6,12,15,41,-26,12
Loko Moscow,3217,1,12,5,3,32,13,19,41
CSKA Moscow,3217,2,12,3,5,29,18,11,39
Spart Moscow,3217,3,9,5,6,35,28,7,32
Zenit,3217,4,8,8,4,23,16,7,32
Krasnodar,3217,5,8,5,7,28,27,1,29
Terek Grozny,3217,6,7,6,7,20,24,-4,27
Din Moscow,3217,7,6,7,7,19,22,-3,25
FK Rubin,3217,8,5,7,8,23,19,4,22
Amkar,3217,9,6,4,10,13,22,-9,22
Rostov,3217,10,4,6,10,10,19,-9,18
Anzhi,3217,11,2,6,12,15,39,-24,12
Loko Moscow,3218,1,11,6,3,29,12,17,39
CSKA Moscow,3218,2,10,5,5,26,18,8,35
Spart Moscow,3218,3,9,7,4,41,31,10,34
Zenit,3218,4,8,9,3,23,14,9,33
Krasnodar,3218,5,9,5,6,28,24,4,32
Terek Grozny,3218,6,8,6,6,22,23,-1,30
Din Moscow,3218,7,6,6,8,20,25,-5,24
FK Rubin,3218,8,5,5,10,21,19,2,20
Rostov,3218,9,4,7,9,13,20,-7,19
Amkar,3218,10,4,5,11,11,25,-14,17
Anzhi,3218,11,2,7,11,14,37,-23,13
Loko Moscow,3219,1,12,5,3,33,13,20,41
CSKA Moscow,3219,2,10,5,5,25,17,8,35
Spart Moscow,3219,3,9,6,5,37,29,8,33
Krasnodar,3219,4,9,4,7,29,26,3,31
Zenit,3219,5,7,9,4,21,16,5,30
Terek Grozny,3219,6,8,5,7,21,23,-2,29
Din Moscow,3219,7,7,6,7,21,23,-2,27
FK Rubin,3219,8,6,5,9,23,19,4,23
Rostov,3219,9,4,6,10,11,19,-8,18
Amkar,3219,10,4,5,11,10,24,-14,17
Anzhi,3219,11,3,6,11,15,37,-22,15
Loko Moscow,3220,1,13,5,2,32,12,20,44
CSKA Moscow,3220,2,11,3,6,27,18,9,36
Spart Moscow,3220,3,10,5,5,37,27,10,35
Zenit,3220,4,8,8,4,22,14,8,32
Terek Grozny,3220,5,8,6,6,24,24,0,30
Krasnodar,3220,6,8,4,8,28,28,0,28
FK Rubin,3220,7,7,5,8,26,17,9,26
Din Moscow,3220,8,5,6,9,17,25,-8,21
Amkar,3220,9,5,5,10,12,24,-12,20
Rostov,3220,10,4,6,10,10,19,-9,18
Anzhi,3220,11,2,5,13,15,42,-27,11
Loko Moscow,3221,1,12,5,3,32,14,18,41
Spart Moscow,3221,2,10,5,5,39,29,10,35
CSKA Moscow,3221,3,10,4,6,27,20,7,34
Krasnodar,3221,4,9,4,7,29,26,3,31
Zenit,3221,5,7,9,4,23,16,7,30
Terek Grozny,3221,6,7,6,7,21,24,-3,27
Din Moscow,3221,7,6,6,8,20,24,-4,24
FK Rubin,3221,8,6,5,9,23,19,4,23
Amkar,3221,9,6,4,10,12,23,-11,22
Rostov,3221,10,4,6,10,11,20,-9,18
Anzhi,3221,11,3,6,11,17,39,-22,15
Loko Moscow,3222,1,12,5,3,31,13,18,41
CSKA Moscow,3222,2,12,3,5,28,18,10,39
Spart Moscow,3222,3,10,6,4,41,27,14,36
Zenit,3222,4,8,8,4,23,15,8,32
Krasnodar,3222,5,9,4,7,30,26,4,31
Terek Grozny,3222,6,7,7,6,20,22,-2,28
Din Moscow,3222,7,5,7,8,20,26,-6,22
FK Rubin,3222,8,5,6,9,23,21,2,21
Rostov,3222,9,4,7,9,11,18,-7,19
Amkar,3222,10,4,5,11,9,26,-17,17
Anzhi,3222,11,2,6,12,14,38,-24,12
Loko Moscow,3223,1,12,6,2,32,13,19,42
CSKA Moscow,3223,2,12,3,5,32,18,14,39
Spart Moscow,3223,3,9,5,6,37,29,8,32
Krasnodar,3223,4,8,6,6,30,27,3,30
Zenit,3223,5,7,8,5,23,18,5,29
Terek Grozny,3223,6,8,5,7,21,26,-5,29
FK Rubin,3223,7,6,6,8,24,19,5,24
Din Moscow,3223,8,6,6,8,19,23,-4,24
Amkar,3223,9,5,4,11,11,23,-12,19
Rostov,3223,10,4,6,10,10,20,-10,18
Anzhi,3223,11,3,5,12,18,41,-23,14
Loko Moscow,3224,1,12,5,3,33,13,20,41
CSKA Moscow,3224,2,11,4,5,27,18,9,37
Spart Moscow,3224,3,10,5,5,37,26,11,35
Zenit,3224,4,8,9,3,24,15,9,33
Terek Grozny,3224,5,9,5,6,24,24,0,32
Krasnodar,3224,6,8,4,8,27,28,-1,28
Din Moscow,3224,7,6,6,8,19,24,-5,24
FK Rubin,3224,8,6,5,9,22,19,3,23
Amkar,3224,9,5,4,11,12,25,-13,19
Rostov,3224,10,4,6,10,10,18,-8,18
Anzhi,3224,11,2,5,13,14,39,-25,11
Loko Moscow,3225,1,12,5,3,30,13,17,41
CSKA Moscow,3225,2,11,3,6,27,19,8,36
Krasnodar,3225,3,10,4,6,31,24,7,34
Zenit,3225,4,8,8,4,23,15,8,32
Spart Moscow,3225,5,9,5,6,37,30,7,32
Terek Grozny,3225,6,9,5,6,25,22,3,32
Din Moscow,3225,7,7,6,7,22,23,-1,27
FK Rubin,3225,8,5,5,10,22,22,0,20
Amkar,3225,9,5,4,11,11,25,-14,19
Rostov,3225,10,4,6,10,11,20,-9,18
Anzhi,3225,11,2,5,13,14,40,-26,11
Loko Moscow,3226,1,12,6,2,31,12,19,42
CSKA Moscow,3226,2,11,3,6,29,18,11,36
Spart Moscow,3226,3,9,7,4,38,28,10,34
Zenit,3226,4,8,8,4,23,15,8,32
Krasnodar,3226,5,9,5,6,30,24,6,32
Terek Grozny,3226,6,9,5,6,23,22,1,32
Din Moscow,3226,7,5,7,8,19,25,-6,22
FK Rubin,3226,8,5,6,9,22,21,1,21
Rostov,3226,9,4,7,9,10,17,-7,19
Amkar,3226,10,4,5,11,11,25,-14,17
Anzhi,3226,11,2,5,13,14,43,-29,11
Loko Moscow,3227,1,11,6,3,30,13,17,39
CSKA Moscow,3227,2,11,4,5,29,19,10,37
Spart Moscow,3227,3,10,5,5,37,29,8,35
Zenit,3227,4,7,10,3,23,15,8,31
Krasnodar,3227,5,9,4,7,29,26,3,31
Terek Grozny,3227,6,8,5,7,21,23,-2,29
Din Moscow,3227,7,6,6,8,19,23,-4,24
FK Rubin,3227,8,6,5,9,23,19,4,23
Amkar,3227,9,6,4,10,12,22,-10,22
Rostov,3227,10,4,6,10,11,19,-8,18
Anzhi,3227,11,2,5,13,15,41,-26,11
Loko Moscow,3228,1,12,5,3,31,14,17,41
Spart Moscow,3228,2,10,5,5,40,28,12,35
CSKA Moscow,3228,3,10,5,5,26,18,8,35
Krasnodar,3228,4,9,4,7,30,25,5,31
Zenit,3228,5,7,9,4,21,15,6,30
Terek Grozny,3228,6,8,6,6,23,23,0,30
Din Moscow,3228,7,7,6,7,23,22,1,27
FK Rubin,3228,8,6,5,9,22,20,2,23
Rostov,3228,9,4,6,10,10,21,-11,18
Amkar,3228,10,4,5,11,9,24,-15,17
Anzhi,3228,11,2,6,12,16,41,-25,12
Loko Moscow,3229,1,12,5,3,30,12,18,41
CSKA Moscow,3229,2,12,3,5,27,17,10,39
Zenit,3229,3,8,8,4,22,14,8,32
Spart Moscow,3229,4,8,7,5,34,27,7,31
Krasnodar,3229,5,9,4,7,28,25,3,31
Terek Grozny,3229,6,7,7,6,22,24,-2,28
Din Moscow,3229,7,6,6,8,18,24,-6,24
FK Rubin,3229,8,6,5,9,24,18,6,23
Rostov,3229,9,4,7,9,10,17,-7,19
Amkar,3229,10,4,6,10,11,24,-13,18
Anzhi,3229,11,2,6,12,15,39,-24,12
CSKA Moscow,3230,1,12,3,5,30,19,11,39
Loko Moscow,3230,2,11,5,4,29,15,14,38
Spart Moscow,3230,3,9,7,4,37,27,10,34
Zenit,3230,4,8,8,4,22,14,8,32
Krasnodar,3230,5,9,4,7,30,25,5,31
Terek Grozny,3230,6,7,5,8,21,28,-7,26
Din Moscow,3230,7,6,6,8,20,24,-4,24
FK Rubin,3230,8,6,5,9,22,19,3,23
Amkar,3230,9,5,5,10,13,22,-9,20
Rostov,3230,10,4,7,9,11,18,-7,19
Anzhi,3230,11,3,5,12,18,42,-24,14
Loko Moscow,3231,1,12,5,3,31,15,16,41
CSKA Moscow,3231,2,11,4,5,27,18,9,37
Spart Moscow,3231,3,9,6,5,39,31,8,33
Krasnodar,3231,4,9,4,7,32,28,4,31
Zenit,3231,5,7,9,4,21,14,7,30
Terek Grozny,3231,6,7,6,7,21,24,-3,27
Din Moscow,3231,7,6,7,7,22,23,-1,25
FK Rubin,3231,8,6,5,9,24,21,3,23
Rostov,3231,9,5,6,9,14,20,-6,21
Amkar,3231,10,5,4,11,10,23,-13,19
Anzhi,3231,11,2,6,12,16,40,-24,12
Loko Moscow,3232,1,13,5,2,33,13,20,44
CSKA Moscow,3232,2,11,3,6,27,19,8,36
Spart Moscow,3232,3,9,6,5,36,27,9,33
Zenit,3232,4,8,8,4,24,15,9,32
Krasnodar,3232,5,8,4,8,29,28,1,28
Terek Grozny,3232,6,7,6,7,21,24,-3,27
FK Rubin,3232,7,7,5,8,26,18,8,26
Din Moscow,3232,8,6,6,8,18,24,-6,24
Rostov,3232,9,4,6,10,11,20,-9,18
Amkar,3232,10,4,6,10,9,22,-13,18
Anzhi,3232,11,3,5,12,16,40,-24,14
Loko Moscow,3233,1,12,6,2,32,11,21,42
CSKA Moscow,3233,2,11,4,5,29,20,9,37
Spart Moscow,3233,3,10,5,5,39,29,10,35
Zenit,3233,4,7,9,4,22,15,7,30
Terek Grozny,3233,5,8,5,7,22,27,-5,29
Krasnodar,3233,6,8,4,8,27,29,-2,28
FK Rubin,3233,7,7,5,8,24,17,7,26
Din Moscow,3233,8,5,6,9,18,25,-7,21
Amkar,3233,9,5,4,11,12,25,-13,19
Rostov,3233,10,4,6,10,11,19,-8,18
Anzhi,3233,11,3,6,11,20,39,-19,15
Loko Moscow,3234,1,12,5,3,32,15,17,41
Spart Moscow,3234,2,10,6,4,39,25,14,36
CSKA Moscow,3234,3,10,5,5,27,19,8,35
Zenit,3234,4,8,9,3,25,14,11,33
Terek Grozny,3234,5,8,5,7,22,24,-2,29
Krasnodar,3234,6,8,4,8,27,28,-1,28
Din Moscow,3234,7,6,7,7,19,21,-2,25
FK Rubin,3234,8,6,5,9,23,19,4,23
Rostov,3234,9,4,6,10,10,20,-10,18
Amkar,3234,10,4,4,12,10,27,-17,16
Anzhi,3234,11,3,6,11,17,39,-22,15
CSKA Moscow,3235,1,12,3,5,30,18,12,39
Loko Moscow,3235,2,11,5,4,30,16,14,38
Krasnodar,3235,3,10,4,6,31,24,7,34
Zenit,3235,4,8,8,4,24,16,8,32
Spart Moscow,3235,5,9,5,6,35,28,7,32
Din Moscow,3235,6,7,6,7,19,21,-2,27
Terek Grozny,3235,7,7,6,7,20,24,-4,27
Rostov,3235,8,5,6,9,12,18,-6,21
FK Rubin,3235,9,5,5,10,21,19,2,20
Amkar,3235,10,5,4,11,11,23,-12,19
Anzhi,3235,11,2,6,12,14,40,-26,12
Loko Moscow,3236,1,12,6,2,34,13,21,42
CSKA Moscow,3236,2,12,3,5,29,18,11,39
Spart Moscow,3236,3,9,6,5,38,29,9,33
Terek Grozny,3236,4,9,5,6,24,22,2,32
Zenit,3236,5,7,9,4,24,17,7,30
Krasnodar,3236,6,8,5,7,27,27,0,29
Din Moscow,3236,7,6,6,8,20,25,-5,24
FK Rubin,3236,8,5,6,9,21,18,3,21
Rostov,3236,9,4,7,9,11,18,-7,19
Amkar,3236,10,5,4,11,10,24,-14,19
Anzhi,3236,11,2,5,13,14,41,-27,11
Loko Moscow,3237,1,12,6,2,32,13,19,42
CSKA Moscow,3237,2,11,3,6,28,21,7,36
Spart Moscow,3237,3,10,5,5,39,27,12,35
Zenit,3237,4,8,8,4,26,16,10,32
Krasnodar,3237,5,9,5,6,33,25,8,32
Terek Grozny,3237,6,8,6,6,22,23,-1,30
FK Rubin,3237,7,6,5,9,23,22,1,23
Din Moscow,3237,8,5,6,9,17,25,-8,21
Amkar,3237,9,5,4,11,12,25,-13,19
Rostov,3237,10,4,6,10,10,20,-10,18
Anzhi,3237,11,2,6,12,14,39,-25,12
Loko Moscow,3238,1,12,5,3,32,16,16,41
CSKA Moscow,3238,2,12,3,5,30,17,13,39
Spart Moscow,3238,3,11,5,4,39,26,13,38
Krasnodar,3238,4,9,4,7,31,26,5,31
Zenit,3238,5,7,8,5,22,16,6,29
FK Rubin,3238,6,7,5,8,23,17,6,26
Terek Grozny,3238,7,7,5,8,20,24,-4,26
Din Moscow,3238,8,5,6,9,17,24,-7,21
Amkar,3238,9,5,4,11,10,24,-14,19
Rostov,3238,10,4,6,10,11,19,-8,18
Anzhi,3238,11,3,5,12,15,41,-26,14
Loko Moscow,3239,1,12,5,3,30,12,18,41
Spart Moscow,3239,2,10,6,4,36,26,10,36
CSKA Moscow,3239,3,10,3,7,26,22,4,33
Zenit,3239,4,8,8,4,24,14,10,32
Krasnodar,3239,5,9,4,7,29,26,3,31
Terek Grozny,3239,6,7,6,7,22,26,-4,27
Din Moscow,3239,7,6,6,8,21,24,-3,24
FK Rubin,3239,8,6,5,9,24,21,3,23
Amkar,3239,9,5,5,10,11,22,-11,20
Rostov,3239,10,4,6,10,10,18,-8,18
Anzhi,3239,11,3,6,11,18,40,-22,15
Loko Moscow,3240,1,12,5,3,31,13,18,41
CSKA Moscow,3240,2,12,3,5,28,18,10,39
Spart Moscow,3240,3,9,6,5,39,29,10,33
Zenit,3240,4,8,8,4,23,15,8,32
Krasnodar,3240,5,9,4,7,29,26,3,31
Terek Grozny,3240,6,7,5,8,20,25,-5,26
Din Moscow,3240,7,6,6,8,19,23,-4,24
FK Rubin,3240,8,6,5,9,22,18,4,23
Rostov,3240,9,4,7,9,11,18,-7,19
Amkar,3240,10,5,4,11,11,26,-15,19
Anzhi,3240,11,3,5,12,16,38,-22,14
Loko Moscow,3241,1,13,5,2,34,12,22,44
CSKA Moscow,3241,2,12,3,5,29,18,11,39
Spart Moscow,3241,3,10,6,4,40,28,12,36
Terek Grozny,3241,4,9,5,6,24,23,1,32
Krasnodar,3241,5,9,4,7,29,27,2,31
Zenit,3241,6,7,8,5,22,17,5,29
Din Moscow,3241,7,5,8,7,19,23,-4,23
FK Rubin,3241,8,5,6,9,21,18,3,21
Rostov,3241,9,4,6,10,10,20,-10,18
Amkar,3241,10,4,4,12,11,26,-15,16
Anzhi,3241,11,2,5,13,14,41,-27,11
Loko Moscow,3242,1,12,5,3,32,14,18,41
CSKA Moscow,3242,2,12,3,5,30,19,11,39
Spart Moscow,3242,3,9,7,4,37,28,9,34
Krasnodar,3242,4,10,4,6,31,26,5,34
Zenit,3242,5,7,8,5,22,16,6,29
Terek Grozny,3242,6,8,5,7,24,27,-3,29
Din Moscow,3242,7,5,8,7,21,25,-4,23
FK Rubin,3242,8,5,6,9,22,19,3,21
Amkar,3242,9,5,5,10,14,23,-9,20
Rostov,3242,10,4,6,10,10,18,-8,18
Anzhi,3242,11,2,5,13,15,43,-28,11
Loko Moscow,3243,1,11,6,3,30,13,17,39
CSKA Moscow,3243,2,11,4,5,27,18,9,37
Spart Moscow,3243,3,10,5,5,39,27,12,35
Zenit,3243,4,8,9,3,23,14,9,33
Terek Grozny,3243,5,9,5,6,25,22,3,32
Krasnodar,3243,6,8,6,6,28,25,3,30
Din Moscow,3243,7,7,6,7,19,21,-2,27
FK Rubin,3243,8,5,6,9,21,18,3,21
Rostov,3243,9,4,6,10,10,21,-11,18
Amkar,3243,10,4,4,12,10,26,-16,16
Anzhi,3243,11,2,5,13,14,41,-27,11
Loko Moscow,3244,1,12,5,3,30,14,16,41
Spart Moscow,3244,2,9,7,4,38,27,11,34
CSKA Moscow,3244,3,10,4,6,27,21,6,34
Zenit,3244,4,8,8,4,24,15,9,32
Krasnodar,3244,5,9,5,6,30,24,6,32
Terek Grozny,3244,6,7,6,7,21,25,-4,27
FK Rubin,3244,7,6,6,8,22,17,5,24
Din Moscow,3244,8,5,7,8,17,22,-5,22
Rostov,3244,9,4,6,10,11,21,-10,18
Amkar,3244,10,4,6,10,11,24,-13,18
Anzhi,3244,11,3,6,11,17,38,-21,15
Loko Moscow,3245,1,12,5,3,30,12,18,41
CSKA Moscow,3245,2,12,3,5,28,18,10,39
Spart Moscow,3245,3,10,6,4,37,25,12,36
Krasnodar,3245,4,10,4,6,32,25,7,34
Terek Grozny,3245,5,9,5,6,26,23,3,32
Zenit,3245,6,7,8,5,22,16,6,29
FK Rubin,3245,7,6,5,9,23,21,2,23
Din Moscow,3245,8,5,6,9,17,24,-7,21
Rostov,3245,9,4,7,9,10,17,-7,19
Amkar,3245,10,4,4,12,10,26,-16,16
Anzhi,3245,11,2,5,13,14,42,-28,11
Loko Moscow,3246,1,11,6,3,29,14,15,39
CSKA Moscow,3246,2,11,4,5,29,18,11,37
Spart Moscow,3246,3,9,7,4,36,26,10,34
Zenit,3246,4,7,10,3,22,14,8,31
Krasnodar,3246,5,9,4,7,31,26,5,31
Terek Grozny,3246,6,7,6,7,20,23,-3,27
Din Moscow,3246,7,6,7,7,19,22,-3,25
FK Rubin,3246,8,6,5,9,24,20,4,23
Rostov,3246,9,4,7,9,11,18,-7,19
Amkar,3246,10,5,4,11,10,24,-14,19
Anzhi,3246,11,2,6,12,14,40,-26,12
Loko Moscow,3247,1,12,5,3,33,14,19,41
CSKA Moscow,3247,2,11,4,5,29,19,10,37
Zenit,3247,3,8,9,3,25,15,10,33
Spart Moscow,3247,4,9,6,5,37,29,8,33
Terek Grozny,3247,5,8,5,7,25,24,1,29
Krasnodar,3247,6,8,4,8,28,29,-1,28
FK Rubin,3247,7,7,5,8,23,17,6,26
Din Moscow,3247,8,5,6,9,18,25,-7,21
Rostov,3247,9,4,7,9,11,18,-7,19
Amkar,3247,10,5,4,11,11,26,-15,19
Anzhi,3247,11,3,5,12,16,40,-24,14
Loko Moscow,3248,1,12,6,2,33,13,20,42
CSKA Moscow,3248,2,11,4,5,28,18,10,37
Spart Moscow,3248,3,9,5,6,36,29,7,32
Krasnodar,3248,4,9,5,6,31,27,4,32
Zenit,3248,5,7,9,4,22,16,6,30
Terek Grozny,3248,6,7,7,6,26,28,-2,28
Din Moscow,3248,7,7,6,7,19,21,-2,27
FK Rubin,3248,8,5,5,10,22,20,2,20
Amkar,3248,9,5,5,10,13,24,-11,20
Rostov,3248,10,4,6,10,11,20,-9,18
Anzhi,3248,11,2,6,12,18,43,-25,12
CSKA Moscow,3249,1,12,3,5,30,19,11,39
Loko Moscow,3249,2,11,5,4,30,15,15,38
Spart Moscow,3249,3,10,5,5,38,28,10,35
Krasnodar,3249,4,10,4,6,32,25,7,34
Zenit,3249,5,8,8,4,23,15,8,32
Terek Grozny,3249,6,7,6,7,21,24,-3,27
Din Moscow,3249,7,6,7,7,18,21,-3,25
FK Rubin,3249,8,5,6,9,22,20,2,21
Rostov,3249,9,4,6,10,10,18,-8,18
Amkar,3249,10,4,5,11,12,27,-15,17
Anzhi,3249,11,3,5,12,17,41,-24,14
Loko Moscow,3250,1,12,5,3,32,13,19,41
CSKA Moscow,3250,2,11,4,5,28,18,10,37
Spart Moscow,3250,3,9,7,4,37,27,10,34
Krasnodar,3250,4,10,4,6,31,25,6,34
Zenit,3250,5,7,9,4,21,15,6,30
Terek Grozny,3250,6,7,7,6,21,23,-2,28
Din Moscow,3250,7,6,6,8,20,24,-4,24
FK Rubin,3250,8,5,5,10,22,22,0,20
Rostov,3250,9,4,7,9,11,18,-7,19
Amkar,3250,10,4,6,10,10,23,-13,18
Anzhi,3250,11,2,6,12,16,41,-25,12
Loko Moscow,3251,1,12,5,3,31,13,18,41
CSKA Moscow,3251,2,11,4,5,28,17,11,37
Spart Moscow,3251,3,10,5,5,42,27,15,35
Zenit,3251,4,8,9,3,23,14,9,33
Krasnodar,3251,5,8,5,7,29,27,2,29
Terek Grozny,3251,6,7,7,6,21,23,-2,28
Din Moscow,3251,7,6,6,8,18,24,-6,24
FK Rubin,3251,8,5,6,9,23,20,3,21
Rostov,3251,9,5,6,9,12,18,-6,21
Amkar,3251,10,4,5,11,9,27,-18,17
Anzhi,3251,11,2,6,12,15,41,-26,12
Loko Moscow,3252,1,12,5,3,31,14,17,41
Spart Moscow,3252,2,11,5,4,44,28,16,38
CSKA Moscow,3252,3,11,3,6,28,20,8,36
Krasnodar,3252,4,10,4,6,31,25,6,34
Zenit,3252,5,8,8,4,23,15,8,32
Terek Grozny,3252,6,7,6,7,24,30,-6,27
Din Moscow,3252,7,6,6,8,19,26,-7,24
FK Rubin,3252,8,5,5,10,21,19,2,20
Rostov,3252,9,4,6,10,10,18,-8,18
Amkar,3252,10,4,5,11,14,30,-16,17
Anzhi,3252,11,3,5,12,20,40,-20,14
Loko Moscow,3253,1,13,5,2,34,13,21,44
CSKA Moscow,3253,2,12,3,5,29,18,11,39
Spart Moscow,3253,3,9,5,6,36,29,7,32
Zenit,3253,4,7,8,5,22,17,5,29
Krasnodar,3253,5,8,5,7,28,26,2,29
Din Moscow,3253,6,7,6,7,22,21,1,27
Terek Grozny,3253,7,7,5,8,20,24,-4,26
Amkar,3253,8,6,4,10,11,22,-11,22
FK Rubin,3253,9,5,6,9,21,21,0,21
Rostov,3253,10,4,6,10,12,20,-8,18
Anzhi,3253,11,3,5,12,16,40,-24,14
Loko Moscow,3254,1,11,5,4,31,15,16,38
Spart Moscow,3254,2,11,5,4,41,28,13,38
CSKA Moscow,3254,3,11,3,6,26,18,8,36
Zenit,3254,4,9,8,3,23,13,10,35
Krasnodar,3254,5,9,4,7,31,28,3,31
Terek Grozny,3254,6,8,5,7,24,24,0,29
FK Rubin,3254,7,6,6,8,24,19,5,24
Din Moscow,3254,8,5,7,8,20,25,-5,22
Amkar,3254,9,5,4,11,12,26,-14,19
Rostov,3254,10,4,6,10,10,19,-9,18
Anzhi,3254,11,2,5,13,14,41,-27,11
Loko Moscow,3255,1,13,5,2,33,12,21,44
CSKA Moscow,3255,2,11,3,6,29,19,10,36
Spart Moscow,3255,3,10,5,5,40,29,11,35
Zenit,3255,4,8,8,4,23,16,7,32
Krasnodar,3255,5,9,4,7,31,28,3,31
Terek Grozny,3255,6,7,5,8,21,26,-5,26
FK Rubin,3255,7,6,5,9,24,20,4,23
Amkar,3255,8,6,4,10,14,24,-10,22
Din Moscow,3255,9,5,6,9,17,26,-9,21
Rostov,3255,10,4,6,10,11,19,-8,18
Anzhi,3255,11,3,5,12,16,40,-24,14
Loko Moscow,3256,1,11,6,3,30,13,17,39
Krasnodar,3256,2,10,4,6,31,25,6,34
CSKA Moscow,3256,3,10,4,6,26,20,6,34
Zenit,3256,4,8,9,3,23,13,10,33
Spart Moscow,3256,5,8,7,5,37,30,7,31
Terek Grozny,3256,6,7,5,8,21,26,-5,26
FK Rubin,3256,7,6,5,9,22,19,3,23
Din Moscow,3256,8,5,7,8,19,24,-5,22
Rostov,3256,9,5,6,9,12,18,-6,21
Amkar,3256,10,5,5,10,12,24,-12,20
Anzhi,3256,11,3,6,11,17,38,-21,15
Loko Moscow,3257,1,11,6,3,31,14,17,39
Spart Moscow,3257,2,11,5,4,43,30,13,38
CSKA Moscow,3257,3,11,3,6,29,20,9,36
Krasnodar,3257,4,10,4,6,32,24,8,34
Zenit,3257,5,8,9,3,25,16,9,33
Terek Grozny,3257,6,7,7,6,21,23,-2,28
Din Moscow,3257,7,6,6,8,21,25,-4,24
FK Rubin,3257,8,5,5,10,21,22,-1,20
Rostov,3257,9,4,6,10,11,19,-8,18
Amkar,3257,10,4,5,11,10,26,-16,17
Anzhi,3257,11,2,6,12,16,41,-25,12
Loko Moscow,3258,1,11,6,3,31,14,17,39
Spart Moscow,3258,2,10,6,4,38,27,11,36
CSKA Moscow,3258,3,10,5,5,26,18,8,35
Zenit,3258,4,8,9,3,23,14,9,33
Krasnodar,3258,5,8,6,6,28,25,3,30
Terek Grozny,3258,6,7,5,8,20,25,-5,26
Din Moscow,3258,7,5,8,7,18,22,-4,23
FK Rubin,3258,8,5,7,8,21,17,4,22
Amkar,3258,9,5,4,11,10,23,-13,19
Rostov,3258,10,4,6,10,11,20,-9,18
Anzhi,3258,11,3,6,11,17,38,-21,15
Loko Moscow,3259,1,11,6,3,29,13,16,39
Krasnodar,3259,2,10,4,6,31,24,7,34
CSKA Moscow,3259,3,10,4,6,27,21,6,34
Zenit,3259,4,8,9,3,24,14,10,33
Spart Moscow,3259,5,9,6,5,36,28,8,33
Terek Grozny,3259,6,8,6,6,25,25,0,30
Din Moscow,3259,7,6,6,8,19,23,-4,24
FK Rubin,3259,8,6,5,9,23,19,4,23
Rostov,3259,9,4,7,9,11,18,-7,19
Amkar,3259,10,4,4,12,11,28,-17,16
Anzhi,3259,11,2,7,11,16,39,-23,13
Loko Moscow,3260,1,12,6,2,34,14,20,42
CSKA Moscow,3260,2,12,3,5,31,17,14,39
Spart Moscow,3260,3,10,6,4,39,28,11,36
Zenit,3260,4,7,8,5,21,17,4,29
Krasnodar,3260,5,8,5,7,30,28,2,29
Terek Grozny,3260,6,8,5,7,21,24,-3,29
FK Rubin,3260,7,6,6,8,22,17,5,24
Din Moscow,3260,8,5,8,7,19,23,-4,23
Rostov,3260,9,4,6,10,11,19,-8,18
Amkar,3260,10,4,4,12,9,25,-16,16
Anzhi,3260,11,3,5,12,16,41,-25,14
Loko Moscow,3261,1,13,5,2,35,12,23,44
CSKA Moscow,3261,2,11,3,6,28,20,8,36
Spart Moscow,3261,3,9,5,6,36,31,5,32
Krasnodar,3261,4,9,4,7,31,28,3,31
Terek Grozny,3261,5,8,6,6,22,23,-1,30
Zenit,3261,6,7,8,5,22,18,4,29
Din Moscow,3261,7,6,6,8,19,23,-4,24
FK Rubin,3261,8,6,5,9,24,20,4,23
Rostov,3261,9,5,6,9,13,18,-5,21
Amkar,3261,10,4,5,11,11,25,-14,17
Anzhi,3261,11,3,5,12,16,39,-23,14
Loko Moscow,3262,1,13,5,2,34,14,20,44
CSKA Moscow,3262,2,11,3,6,28,21,7,36
Spart Moscow,3262,3,10,5,5,37,28,9,35
Zenit,3262,4,8,8,4,24,15,9,32
Krasnodar,3262,5,9,4,7,31,28,3,31
Terek Grozny,3262,6,7,7,6,22,24,-2,28
Din Moscow,3262,7,7,6,7,21,22,-1,27
FK Rubin,3262,8,5,5,10,23,22,1,20
Rostov,3262,9,4,6,10,11,19,-8,18
Amkar,3262,10,4,5,11,12,26,-14,17
Anzhi,3262,11,2,6,12,16,40,-24,12
Loko Moscow,3263,1,11,7,2,30,12,18,40
CSKA Moscow,3263,2,11,3,6,27,18,9,36
Zenit,3263,3,8,9,3,22,13,9,33
Krasnodar,3263,4,9,5,6,30,26,4,32
Spart Moscow,3263,5,8,6,6,35,30,5,30
Terek Grozny,3263,6,7,5,8,20,24,-4,26
Din Moscow,3263,7,5,8,7,19,23,-4,23
Amkar,3263,8,6,4,10,12,22,-10,22
FK Rubin,3263,9,5,6,9,23,20,3,21
Rostov,3263,10,5,6,9,12,18,-6,21
Anzhi,3263,11,3,5,12,15,39,-24,14
Loko Moscow,3264,1,11,5,4,29,14,15,38
Spart Moscow,3264,2,11,5,4,41,28,13,38
Zenit,3264,3,9,8,3,24,14,10,35
CSKA Moscow,3264,4,10,4,6,28,21,7,34
Krasnodar,3264,5,9,4,7,31,27,4,31
Terek Grozny,3264,6,7,5,8,20,25,-5,26
FK Rubin,3264,7,6,6,8,26,21,5,24
Din Moscow,3264,8,5,7,8,20,27,-7,22
Amkar,3264,9,5,4,11,13,25,-12,19
Rostov,3264,10,4,6,10,10,18,-8,18
Anzhi,3264,11,3,6,11,17,39,-22,15
Loko Moscow,3265,1,13,5,2,33,12,21,44
CSKA Moscow,3265,2,11,4,5,31,19,12,37
Spart Moscow,3265,3,10,6,4,37,27,10,36
Terek Grozny,3265,4,9,5,6,26,25,1,32
Krasnodar,3265,5,9,4,7,31,28,3,31
Zenit,3265,6,7,9,4,23,17,6,30
Din Moscow,3265,7,5,8,7,17,21,-4,23
FK Rubin,3265,8,5,6,9,23,20,3,21
Rostov,3265,9,4,6,10,10,18,-8,18
Amkar,3265,10,4,4,12,11,27,-16,16
Anzhi,3265,11,2,5,13,17,45,-28,11
Loko Moscow,3266,1,12,5,3,32,13,19,41
CSKA Moscow,3266,2,11,3,6,27,19,8,36
Zenit,3266,3,9,8,3,24,14,10,35
Spart Moscow,3266,4,9,6,5,36,29,7,33
Krasnodar,3266,5,8,5,7,28,27,1,29
Terek Grozny,3266,6,8,5,7,22,24,-2,29
FK Rubin,3266,7,6,6,8,22,17,5,24
Din Moscow,3266,8,5,7,8,18,23,-5,22
Amkar,3266,9,5,4,11,11,24,-13,19
Rostov,3266,10,4,6,10,11,19,-8,18
Anzhi,3266,11,3,5,12,16,38,-22,14
Loko Moscow,3267,1,12,6,2,33,14,19,42
CSKA Moscow,3267,2,11,3,6,30,19,11,36
Spart Moscow,3267,3,10,5,5,38,28,10,35
Zenit,3267,4,8,8,4,23,15,8,32
Krasnodar,3267,5,9,5,6,31,27,4,32
Terek Grozny,3267,6,7,6,7,21,26,-5,27
Din Moscow,3267,7,5,7,8,18,24,-6,22
Amkar,3267,8,6,4,10,13,22,-9,22
FK Rubin,3267,9,5,6,9,21,18,3,21
Rostov,3267,10,4,6,10,11,19,-8,18
Anzhi,3267,11,2,6,12,15,42,-27,12
Loko Moscow,3268,1,13,5,2,33,12,21,44
CSKA Moscow,3268,2,12,3,5,29,19,10,39
Spart Moscow,3268,3,10,6,4,38,25,13,36
Terek Grozny,3268,4,9,5,6,25,22,3,32
Krasnodar,3268,5,9,4,7,28,25,3,31
Zenit,3268,6,7,8,5,23,18,5,29
Din Moscow,3268,7,6,6,8,19,25,-6,24
FK Rubin,3268,8,5,5,10,22,20,2,20
Rostov,3268,9,4,6,10,10,19,-9,18
Amkar,3268,10,4,5,11,9,26,-17,17
Anzhi,3268,11,2,5,13,15,40,-25,11
Loko Moscow,3269,1,12,6,2,31,12,19,42
CSKA Moscow,3269,2,11,3,6,27,18,9,36
Spart Moscow,3269,3,9,7,4,39,29,10,34
Zenit,3269,4,8,9,3,23,14,9,33
Krasnodar,3269,5,9,4,7,28,25,3,31
Terek Grozny,3269,6,7,5,8,20,27,-7,26
Din Moscow,3269,7,5,8,7,18,22,-4,23
FK Rubin,3269,8,5,6,9,21,18,3,21
Amkar,3269,9,5,5,10,15,25,-10,20
Rostov,3269,10,4,6,10,10,19,-9,18
Anzhi,3269,11,3,5,12,16,39,-23,14
Loko Moscow,3270,1,11,6,3,30,13,17,39
Spart Moscow,3270,2,10,6,4,38,28,10,36
Zenit,3270,3,9,8,3,23,13,10,35
CSKA Moscow,3270,4,10,4,6,25,18,7,34
Krasnodar,3270,5,8,6,6,30,27,3,30
Terek Grozny,3270,6,8,6,6,23,24,-1,30
Din Moscow,3270,7,6,7,7,20,22,-2,25
FK Rubin,3270,8,5,6,9,23,21,2,21
Rostov,3270,9,4,6,10,11,19,-8,18
Amkar,3270,10,4,4,12,11,26,-15,16
Anzhi,3270,11,2,7,11,15,38,-23,13
Loko Moscow,3271,1,11,5,4,30,15,15,38
Spart Moscow,3271,2,10,6,4,36,26,10,36
CSKA Moscow,3271,3,10,5,5,28,20,8,35
Zenit,3271,4,8,9,3,25,15,10,33
Krasnodar,3271,5,9,4,7,28,26,2,31
Terek Grozny,3271,6,7,5,8,20,25,-5,26
Din Moscow,3271,7,6,6,8,20,24,-4,24
FK Rubin,3271,8,6,5,9,24,19,5,23
Rostov,3271,9,4,7,9,10,17,-7,19
Amkar,3271,10,5,4,11,11,23,-12,19
Anzhi,3271,11,3,6,11,17,39,-22,15
Loko Moscow,3272,1,11,6,3,31,15,16,39
CSKA Moscow,3272,2,11,4,5,29,18,11,37
Krasnodar,3272,3,9,5,6,31,26,5,32
Zenit,3272,4,7,10,3,23,15,8,31
Spart Moscow,3272,5,8,7,5,37,31,6,31
Terek Grozny,3272,6,7,5,8,21,27,-6,26
Din Moscow,3272,7,5,8,7,21,25,-4,23
FK Rubin,3272,8,5,7,8,24,20,4,22
Amkar,3272,9,6,4,10,15,23,-8,22
Rostov,3272,10,4,7,9,11,18,-7,19
Anzhi,3272,11,3,5,12,16,41,-25,14
Loko Moscow,3273,1,11,6,3,29,14,15,39
CSKA Moscow,3273,2,11,3,6,26,19,7,36
Krasnodar,3273,3,10,4,6,31,24,7,34
Zenit,3273,4,8,9,3,23,13,10,33
Spart Moscow,3273,5,9,6,5,41,34,7,33
Terek Grozny,3273,6,8,5,7,24,25,-1,29
Din Moscow,3273,7,6,6,8,22,25,-3,24
Amkar,3273,8,6,4,10,16,24,-8,22
FK Rubin,3273,9,5,5,10,21,21,0,20
Rostov,3273,10,4,7,9,12,19,-7,19
Anzhi,3273,11,2,5,13,15,42,-27,11
Loko Moscow,3274,1,12,5,3,31,13,18,41
CSKA Moscow,3274,2,11,4,5,28,19,9,37
Krasnodar,3274,3,9,5,6,31,27,4,32
Spart Moscow,3274,4,8,7,5,34,28,6,31
Zenit,3274,5,7,8,5,22,16,6,29
Terek Grozny,3274,6,8,5,7,21,24,-3,29
FK Rubin,3274,7,6,6,8,24,19,5,24
Din Moscow,3274,8,5,7,8,17,22,-5,22
Rostov,3274,9,4,7,9,11,18,-7,19
Amkar,3274,10,5,4,11,11,23,-12,19
Anzhi,3274,11,3,6,11,17,38,-21,15
Loko Moscow,3275,1,12,6,2,30,11,19,42
CSKA Moscow,3275,2,11,3,6,26,20,6,36
Spart Moscow,3275,3,10,5,5,38,27,11,35
Zenit,3275,4,8,8,4,24,14,10,32
Krasnodar,3275,5,9,5,6,28,24,4,32
Terek Grozny,3275,6,7,6,7,22,26,-4,27
FK Rubin,3275,7,6,5,9,23,18,5,23
Amkar,3275,8,6,4,10,14,24,-10,22
Din Moscow,3275,9,5,6,9,17,24,-7,21
Rostov,3275,10,4,6,10,10,20,-10,18
Anzhi,3275,11,2,6,12,15,39,-24,12
Loko Moscow,3276,1,11,7,2,32,14,18,40
CSKA Moscow,3276,2,12,3,5,30,18,12,39
Spart Moscow,3276,3,10,5,5,40,29,11,35
Zenit,3276,4,7,9,4,24,18,6,30
Krasnodar,3276,5,8,5,7,28,26,2,29
Terek Grozny,3276,6,7,6,7,21,24,-3,27
FK Rubin,3276,7,7,5,8,24,18,6,26
Din Moscow,3276,8,5,6,9,19,27,-8,21
Amkar,3276,9,5,5,10,13,24,-11,20
Rostov,3276,10,4,6,10,10,19,-9,18
Anzhi,3276,11,3,5,12,15,39,-24,14
Loko Moscow,3277,1,12,5,3,33,13,20,41
CSKA Moscow,3277,2,11,3,6,29,19,10,36
Spart Moscow,3277,3,9,6,5,35,26,9,33
Krasnodar,3277,4,9,4,7,29,26,3,31
Zenit,3277,5,7,8,5,21,19,2,29
Terek Grozny,3277,6,8,5,7,21,23,-2,29
Din Moscow,3277,7,6,7,7,18,21,-3,25
FK Rubin,3277,8,6,5,9,22,18,4,23
Amkar,3277,9,5,4,11,10,23,-13,19
Rostov,3277,10,4,6,10,10,19,-9,18
Anzhi,3277,11,4,5,11,17,38,-21,17
Loko Moscow,3278,1,11,7,2,31,13,18,40
Spart Moscow,3278,2,9,7,4,37,27,10,34
Zenit,3278,3,8,9,3,23,14,9,33
CSKA Moscow,3278,4,10,3,7,26,20,6,33
Krasnodar,3278,5,8,5,7,29,27,2,29
Terek Grozny,3278,6,7,6,7,20,24,-4,27
FK Rubin,3278,7,7,5,8,23,17,6,26
Din Moscow,3278,8,5,7,8,18,23,-5,22
Amkar,3278,9,5,5,10,12,23,-11,20
Rostov,3278,10,4,6,10,10,19,-9,18
Anzhi,3278,11,3,6,11,15,37,-22,15
Loko Moscow,3279,1,11,5,4,30,15,15,38
CSKA Moscow,3279,2,11,3,6,31,19,12,36
Zenit,3279,3,9,8,3,24,14,10,35
Krasnodar,3279,4,10,4,6,32,25,7,34
Spart Moscow,3279,5,9,5,6,36,33,3,32
Terek Grozny,3279,6,9,5,6,24,23,1,32
Din Moscow,3279,7,7,6,7,22,23,-1,27
FK Rubin,3279,8,5,5,10,21,20,1,20
Amkar,3279,9,5,4,11,14,24,-10,19
Rostov,3279,10,4,6,10,10,18,-8,18
Anzhi,3279,11,2,5,13,14,44,-30,11
Loko Moscow,3280,1,12,5,3,31,13,18,41
CSKA Moscow,3280,2,11,4,5,27,18,9,37
Spart Moscow,3280,3,10,5,5,37,27,10,35
Zenit,3280,4,8,9,3,23,14,9,33
Krasnodar,3280,5,8,4,8,28,27,1,28
Terek Grozny,3280,6,7,6,7,21,26,-5,27
Din Moscow,3280,7,6,6,8,19,23,-4,24
FK Rubin,3280,8,6,5,9,23,19,4,23
Amkar,3280,9,5,5,10,11,23,-12,20
Rostov,3280,10,4,6,10,10,19,-9,18
Anzhi,3280,11,3,5,12,18,39,-21,14
Loko Moscow,3281,1,11,6,3,32,15,17,39
CSKA Moscow,3281,2,12,3,5,28,18,10,39
Spart Moscow,3281,3,9,6,5,40,29,11,33
Krasnodar,3281,4,9,4,7,30,27,3,31
Zenit,3281,5,7,9,4,24,17,7,30
Terek Grozny,3281,6,8,6,6,25,25,0,30
FK Rubin,3281,7,7,5,8,24,18,6,26
Din Moscow,3281,8,6,6,8,19,23,-4,24
Rostov,3281,9,4,6,10,10,21,-11,18
Amkar,3281,10,4,6,10,12,25,-13,18
Anzhi,3281,11,2,5,13,16,42,-26,11
Loko Moscow,3282,1,12,5,3,34,15,19,41
CSKA Moscow,3282,2,11,3,6,28,20,8,36
Spart Moscow,3282,3,9,6,5,36,26,10,33
Zenit,3282,4,8,8,4,24,17,7,32
Krasnodar,3282,5,9,5,6,30,26,4,32
Terek Grozny,3282,6,8,6,6,22,23,-1,30
FK Rubin,3282,7,6,6,8,24,18,6,24
Rostov,3282,8,5,6,9,11,17,-6,21
Din Moscow,3282,9,5,6,9,18,27,-9,21
Amkar,3282,10,4,5,11,9,23,-14,17
Anzhi,3282,11,2,6,12,16,40,-24,12
Loko Moscow,3283,1,12,5,3,31,13,18,41
Spart Moscow,3283,2,11,5,4,41,26,15,38
Zenit,3283,3,9,8,3,25,15,10,35
CSKA Moscow,3283,4,10,4,6,27,20,7,34
Krasnodar,3283,5,9,4,7,29,25,4,31
Terek Grozny,3283,6,7,5,8,21,28,-7,26
Din Moscow,3283,7,6,6,8,18,23,-5,24
FK Rubin,3283,8,5,5,10,21,20,1,20
Amkar,3283,9,5,4,11,12,24,-12,19
Rostov,3283,10,4,6,10,11,21,-10,18
Anzhi,3283,11,3,6,11,18,39,-21,15
Loko Moscow,3284,1,11,5,4,30,15,15,38
Zenit,3284,2,9,8,3,25,14,11,35
CSKA Moscow,3284,3,10,3,7,26,23,3,33
Terek Grozny,3284,4,9,5,6,24,22,2,32
Krasnodar,3284,5,9,4,7,32,28,4,31
Spart Moscow,3284,6,8,5,7,36,31,5,29
Din Moscow,3284,7,7,6,7,20,22,-2,27
FK Rubin,3284,8,6,5,9,24,20,4,23
Rostov,3284,9,5,6,9,13,19,-6,21
Amkar,3284,10,5,4,11,10,24,-14,19
Anzhi,3284,11,3,5,12,17,39,-22,14
Loko Moscow,3285,1,12,5,3,31,12,19,41
CSKA Moscow,3285,2,10,5,5,27,19,8,35
Zenit,3285,3,8,9,3,22,13,9,33
Spart Moscow,3285,4,8,6,6,34,29,5,30
Krasnodar,3285,5,8,4,8,27,28,-1,28
Din Moscow,3285,6,7,6,7,20,22,-2,27
Terek Grozny,3285,7,7,6,7,21,24,-3,27
FK Rubin,3285,8,6,5,9,23,18,5,23
Amkar,3285,9,6,4,10,12,22,-10,22
Rostov,3285,10,4,7,9,10,17,-7,19
Anzhi,3285,11,2,7,11,17,40,-23,13
Loko Moscow,3286,1,12,6,2,31,12,19,42
CSKA Moscow,3286,2,11,4,5,29,19,10,37
Spart Moscow,3286,3,9,7,4,39,30,9,34
Zenit,3286,4,7,9,4,22,15,7,30
Krasnodar,3286,5,8,6,6,28,25,3,30
Terek Grozny,3286,6,7,7,6,23,25,-2,28
Din Moscow,3286,7,6,6,8,21,25,-4,24
FK Rubin,3286,8,5,6,9,22,19,3,21
Rostov,3286,9,4,7,9,12,19,-7,19
Amkar,3286,10,4,6,10,12,25,-13,18
Anzhi,3286,11,2,6,12,16,41,-25,12
Loko Moscow,3287,1,12,6,2,31,11,20,42
Spart Moscow,3287,2,11,5,4,39,27,12,38
CSKA Moscow,3287,3,11,4,5,27,17,10,37
Zenit,3287,4,7,10,3,21,13,8,31
Krasnodar,3287,5,9,4,7,29,27,2,31
Terek Grozny,3287,6,7,7,6,21,23,-2,28
Din Moscow,3287,7,6,6,8,20,25,-5,24
FK Rubin,3287,8,5,5,10,22,20,2,20
Rostov,3287,9,4,6,10,10,18,-8,18
Amkar,3287,10,4,5,11,10,24,-14,17
Anzhi,3287,11,2,6,12,14,39,-25,12
Loko Moscow,3288,1,13,5,2,34,13,21,44
CSKA Moscow,3288,2,10,4,6,25,18,7,34
Spart Moscow,3288,3,9,5,6,41,32,9,32
Zenit,3288,4,8,8,4,22,14,8,32
Krasnodar,3288,5,9,4,7,32,28,4,31
Terek Grozny,3288,6,8,5,7,22,24,-2,29
Din Moscow,3288,7,7,6,7,21,23,-2,27
FK Rubin,3288,8,5,5,10,21,21,0,20
Amkar,3288,9,5,4,11,13,26,-13,19
Rostov,3288,10,4,6,10,10,20,-10,18
Anzhi,3288,11,3,6,11,16,38,-22,15
Loko Moscow,3289,1,12,6,2,31,12,19,42
Spart Moscow,3289,2,9,7,4,36,26,10,34
CSKA Moscow,3289,3,10,3,7,25,21,4,33
Zenit,3289,4,8,8,4,24,14,10,32
Krasnodar,3289,5,9,5,6,30,26,4,32
Terek Grozny,3289,6,8,5,7,23,24,-1,29
Din Moscow,3289,7,6,7,7,18,21,-3,25
FK Rubin,3289,8,5,5,10,22,20,2,20
Amkar,3289,9,5,5,10,11,23,-12,20
Rostov,3289,10,4,6,10,10,19,-9,18
Anzhi,3289,11,3,5,12,16,40,-24,14
Loko Moscow,3290,1,12,5,3,32,14,18,41
CSKA Moscow,3290,2,12,3,5,28,17,11,39
Spart Moscow,3290,3,10,5,5,39,30,9,35
Zenit,3290,4,8,8,4,23,15,8,32
Krasnodar,3290,5,9,4,7,29,26,3,31
Din Moscow,3290,6,7,6,7,20,22,-2,27
Terek Grozny,3290,7,7,6,7,20,23,-3,27
FK Rubin,3290,8,5,5,10,21,19,2,20
Amkar,3290,9,5,4,11,12,25,-13,19
Rostov,3290,10,4,6,10,11,19,-8,18
Anzhi,3290,11,2,6,12,14,39,-25,12
Loko Moscow,3291,1,12,6,2,32,13,19,42
Spart Moscow,3291,2,11,5,4,39,26,13,38
CSKA Moscow,3291,3,10,4,6,26,20,6,34
Krasnodar,3291,4,9,5,6,31,25,6,32
Zenit,3291,5,7,9,4,23,16,7,30
Terek Grozny,3291,6,8,6,6,21,22,-1,30
Din Moscow,3291,7,6,6,8,21,24,-3,24
FK Rubin,3291,8,5,5,10,22,24,-2,20
Rostov,3291,9,4,6,10,11,20,-9,18
Amkar,3291,10,4,4,12,9,24,-15,16
Anzhi,3291,11,3,6,11,16,37,-21,15
Loko Moscow,3292,1,11,5,4,30,16,14,38
Zenit,3292,2,9,8,3,25,14,11,35
Spart Moscow,3292,3,10,5,5,37,27,10,35
CSKA Moscow,3292,4,10,3,7,26,20,6,33
Terek Grozny,3292,5,9,5,6,25,22,3,32
Krasnodar,3292,6,9,4,7,29,26,3,31
Din Moscow,3292,7,7,6,7,20,22,-2,27
FK Rubin,3292,8,6,5,9,24,19,5,23
Rostov,3292,9,4,6,10,10,19,-9,18
Amkar,3292,10,4,4,12,10,25,-15,16
Anzhi,3292,11,3,5,12,16,42,-26,14
Loko Moscow,3293,1,11,5,4,29,14,15,38
Spart Moscow,3293,2,11,5,4,38,27,11,38
CSKA Moscow,3293,3,10,4,6,27,20,7,34
Zenit,3293,4,8,9,3,24,15,9,33
Krasnodar,3293,5,9,4,7,31,27,4,31
Terek Grozny,3293,6,7,5,8,23,30,-7,26
Din Moscow,3293,7,6,6,8,18,22,-4,24
FK Rubin,3293,8,6,5,9,24,20,4,23
Amkar,3293,9,5,4,11,15,27,-12,19
Rostov,3293,10,4,6,10,10,18,-8,18
Anzhi,3293,11,4,5,11,19,38,-19,17
Loko Moscow,3294,1,12,6,2,35,14,21,42
CSKA Moscow,3294,2,11,3,6,28,20,8,36
Spart Moscow,3294,3,10,5,5,39,29,10,35
Zenit,3294,4,8,8,4,23,17,6,32
Krasnodar,3294,5,9,5,6,30,26,4,32
Terek Grozny,3294,6,7,6,7,23,26,-3,27
Din Moscow,3294,7,6,6,8,20,22,-2,24
FK Rubin,3294,8,6,5,9,22,18,4,23
Amkar,3294,9,5,4,11,11,27,-16,19
Rostov,3294,10,4,6,10,11,19,-8,18
Anzhi,3294,11,2,6,12,18,42,-24,12
Loko Moscow,3295,1,11,6,3,29,12,17,39
Spart Moscow,3295,2,11,5,4,41,27,14,38
CSKA Moscow,3295,3,11,3,6,27,19,8,36
Zenit,3295,4,8,8,4,22,14,8,32
Krasnodar,3295,5,8,6,6,30,27,3,30
Terek Grozny,3295,6,8,5,7,21,23,-2,29
FK Rubin,3295,7,6,6,8,29,21,8,24
Din Moscow,3295,8,5,6,9,19,28,-9,21
Rostov,3295,9,4,6,10,11,20,-9,18
Anzhi,3295,10,4,5,11,17,38,-21,17
Amkar,3295,11,4,4,12,9,26,-17,16
Loko Moscow,3296,1,12,6,2,32,13,19,42
CSKA Moscow,3296,2,12,3,5,29,18,11,39
Spart Moscow,3296,3,8,6,6,37,31,6,30
Zenit,3296,4,7,8,5,22,17,5,29
Krasnodar,3296,5,8,5,7,30,28,2,29
Terek Grozny,3296,6,7,7,6,22,24,-2,28
FK Rubin,3296,7,6,6,8,25,20,5,24
Din Moscow,3296,8,5,8,7,19,23,-4,23
Rostov,3296,9,5,6,9,12,18,-6,21
Amkar,3296,10,5,5,10,12,24,-12,20
Anzhi,3296,11,2,6,12,17,41,-24,12
Loko Moscow,3297,1,11,6,3,31,14,17,39
CSKA Moscow,3297,2,11,3,6,28,20,8,36
Krasnodar,3297,3,10,4,6,30,24,6,34
Spart Moscow,3297,4,9,6,5,38,29,9,33
Zenit,3297,5,8,9,3,24,15,9,33
Terek Grozny,3297,6,7,6,7,22,26,-4,27
Din Moscow,3297,7,5,7,8,18,24,-6,22
FK Rubin,3297,8,5,6,9,22,20,2,21
Rostov,3297,9,5,6,9,12,18,-6,21
Amkar,3297,10,5,5,10,14,25,-11,20
Anzhi,3297,11,2,6,12,17,41,-24,12
Loko Moscow,3298,1,12,6,2,31,11,20,42
Spart Moscow,3298,2,11,5,4,39,26,13,38
CSKA Moscow,3298,3,10,4,6,26,19,7,34
Zenit,3298,4,8,9,3,22,13,9,33
Krasnodar,3298,5,9,4,7,29,27,2,31
Terek Grozny,3298,6,8,5,7,22,24,-2,29
Din Moscow,3298,7,6,6,8,20,23,-3,24
FK Rubin,3298,8,5,5,10,22,21,1,20
Amkar,3298,9,5,4,11,11,25,-14,19
Rostov,3298,10,4,6,10,10,18,-8,18
Anzhi,3298,11,2,6,12,15,40,-25,12
Loko Moscow,3299,1,12,6,2,30,11,19,42
Spart Moscow,3299,2,11,5,4,39,25,14,38
CSKA Moscow,3299,3,10,4,6,28,21,7,34
Zenit,3299,4,8,9,3,23,14,9,33
Terek Grozny,3299,5,8,5,7,22,24,-2,29
Krasnodar,3299,6,8,4,8,28,27,1,28
FK Rubin,3299,7,7,5,8,27,19,8,26
Din Moscow,3299,8,5,6,9,18,26,-8,21
Amkar,3299,9,5,4,11,11,23,-12,19
Rostov,3299,10,4,6,10,10,21,-11,18
Anzhi,3299,11,2,6,12,16,41,-25,12
Loko Moscow,3300,1,12,5,3,31,13,18,41
CSKA Moscow,3300,2,11,3,6,29,22,7,36
Krasnodar,3300,3,10,4,6,32,27,5,34
Spart Moscow,3300,4,9,5,6,36,27,9,32
Terek Grozny,3300,5,8,6,6,22,23,-1,30
Zenit,3300,6,7,8,5,23,17,6,29
Din Moscow,3300,7,7,6,7,20,21,-1,27
Rostov,3300,8,5,6,9,11,17,-6,21
FK Rubin,3300,9,5,5,10,23,22,1,20
Amkar,3300,10,4,4,12,10,27,-17,16
Anzhi,3300,11,3,6,11,17,38,-21,15
Loko Moscow,3301,1,12,5,3,30,13,17,41
CSKA Moscow,3301,2,12,3,5,32,17,15,39
Krasnodar,3301,3,10,4,6,30,24,6,34
Spart Moscow,3301,4,9,6,5,37,27,10,33
Zenit,3301,5,7,8,5,21,17,4,29
Terek Grozny,3301,6,8,5,7,23,23,0,29
Din Moscow,3301,7,7,6,7,21,22,-1,27
FK Rubin,3301,8,5,5,10,21,20,1,20
Rostov,3301,9,4,7,9,10,17,-7,19
Amkar,3301,10,4,4,12,9,28,-19,16
Anzhi,3301,11,3,5,12,15,41,-26,14
Loko Moscow,3302,1,11,6,3,31,14,17,39
CSKA Moscow,3302,2,10,5,5,27,19,8,35
Zenit,3302,3,8,9,3,24,15,9,33
Spart Moscow,3302,4,9,6,5,37,30,7,33
Krasnodar,3302,5,8,6,6,29,26,3,30
Terek Grozny,3302,6,7,6,7,21,24,-3,27
FK Rubin,3302,7,5,7,8,22,18,4,22
Din Moscow,3302,8,5,7,8,18,23,-5,22
Rostov,3302,9,5,6,9,13,18,-5,21
Amkar,3302,10,4,6,10,10,23,-13,18
Anzhi,3302,11,3,6,11,17,39,-22,15
Loko Moscow,3303,1,12,6,2,31,12,19,42
CSKA Moscow,3303,2,11,4,5,29,20,9,37
Spart Moscow,3303,3,10,5,5,41,31,10,35
Zenit,3303,4,7,9,4,23,16,7,30
Krasnodar,3303,5,8,5,7,29,27,2,29
Din Moscow,3303,6,7,6,7,23,24,-1,27
Terek Grozny,3303,7,7,6,7,23,27,-4,27
FK Rubin,3303,8,6,5,9,24,21,3,23
Rostov,3303,9,4,6,10,13,21,-8,18
Amkar,3303,10,4,5,11,11,26,-15,17
Anzhi,3303,11,3,5,12,18,40,-22,14
Loko Moscow,3304,1,12,6,2,34,12,22,42
CSKA Moscow,3304,2,12,3,5,30,18,12,39
Spart Moscow,3304,3,9,5,6,39,27,12,32
Zenit,3304,4,7,9,4,22,16,6,30
Krasnodar,3304,5,8,4,8,27,30,-3,28
Din Moscow,3304,6,7,6,7,21,22,-1,27
Terek Grozny,3304,7,7,5,8,20,26,-6,26
FK Rubin,3304,8,6,5,9,24,20,4,23
Amkar,3304,9,6,4,10,11,22,-11,22
Rostov,3304,10,4,6,10,10,23,-13,18
Anzhi,3304,11,3,5,12,18,40,-22,14
Loko Moscow,3305,1,12,6,2,33,14,19,42
CSKA Moscow,3305,2,11,4,5,28,18,10,37
Spart Moscow,3305,3,9,7,4,39,27,12,34
Zenit,3305,4,7,10,3,23,15,8,31
Krasnodar,3305,5,9,4,7,32,27,5,31
Terek Grozny,3305,6,7,6,7,20,23,-3,27
Din Moscow,3305,7,5,8,7,19,23,-4,23
FK Rubin,3305,8,5,6,9,22,21,1,21
Rostov,3305,9,4,6,10,10,21,-11,18
Amkar,3305,10,4,6,10,10,23,-13,18
Anzhi,3305,11,3,5,12,15,39,-24,14
Loko Moscow,3306,1,12,6,2,30,11,19,42
Spart Moscow,3306,2,11,5,4,41,27,14,38
CSKA Moscow,3306,3,11,4,5,29,19,10,37
Zenit,3306,4,7,9,4,22,15,7,30
Krasnodar,3306,5,8,6,6,28,25,3,30
Terek Grozny,3306,6,7,6,7,20,23,-3,27
FK Rubin,3306,7,6,6,8,23,18,5,24
Din Moscow,3306,8,5,6,9,17,24,-7,21
Rostov,3306,9,4,6,10,11,19,-8,18
Amkar,3306,10,4,5,11,10,26,-16,17
Anzhi,3306,11,3,5,12,16,40,-24,14
Loko Moscow,3307,1,11,6,3,29,15,14,39
Spart Moscow,3307,2,11,5,4,44,28,16,38
CSKA Moscow,3307,3,10,5,5,26,18,8,35
Zenit,3307,4,8,9,3,25,13,12,33
Krasnodar,3307,5,8,5,7,27,25,2,29
Terek Grozny,3307,6,7,6,7,20,23,-3,27
FK Rubin,3307,7,7,5,8,23,17,6,26
Din Moscow,3307,8,5,6,9,18,25,-7,21
Rostov,3307,9,4,6,10,12,20,-8,18
Amkar,3307,10,4,5,11,9,27,-18,17
Anzhi,3307,11,3,6,11,16,38,-22,15
Loko Moscow,3308,1,11,6,3,31,14,17,39
Spart Moscow,3308,2,10,6,4,43,28,15,36
CSKA Moscow,3308,3,11,3,6,28,20,8,36
Zenit,3308,4,9,8,3,25,15,10,35
Krasnodar,3308,5,9,5,6,31,26,5,32
Terek Grozny,3308,6,7,6,7,20,23,-3,27
FK Rubin,3308,7,6,5,9,23,20,3,23
Din Moscow,3308,8,5,6,9,18,26,-8,21
Rostov,3308,9,4,7,9,12,19,-7,19
Amkar,3308,10,5,4,11,10,26,-16,19
Anzhi,3308,11,2,6,12,15,39,-24,12
Loko Moscow,3309,1,12,5,3,33,13,20,41
Spart Moscow,3309,2,10,6,4,39,28,11,36
CSKA Moscow,3309,3,10,5,5,26,18,8,35
Krasnodar,3309,4,10,4,6,30,25,5,34
Zenit,3309,5,7,9,4,22,17,5,30
Terek Grozny,3309,6,8,6,6,22,23,-1,30
Din Moscow,3309,7,6,6,8,21,23,-2,24
FK Rubin,3309,8,5,5,10,21,22,-1,20
Rostov,3309,9,4,6,10,11,19,-8,18
Amkar,3309,10,4,5,11,11,25,-14,17
Anzhi,3309,11,2,7,11,15,38,-23,13
Loko Moscow,3310,1,12,5,3,31,12,19,41
CSKA Moscow,3310,2,11,4,5,29,20,9,37
Krasnodar,3310,3,10,4,6,30,24,6,34
Spart Moscow,3310,4,8,7,5,36,29,7,31
Terek Grozny,3310,5,8,6,6,21,22,-1,30
Zenit,3310,6,7,8,5,22,17,5,29
Din Moscow,3310,7,6,7,7,21,23,-2,25
FK Rubin,3310,8,5,5,10,21,21,0,20
Amkar,3310,9,5,5,10,11,23,-12,20
Rostov,3310,10,4,7,9,10,17,-7,19
Anzhi,3310,11,2,6,12,16,40,-24,12
Loko Moscow,3311,1,12,6,2,31,12,19,42
CSKA Moscow,3311,2,11,3,6,28,21,7,36
Zenit,3311,3,8,9,3,24,14,10,33
Spart Moscow,3311,4,9,6,5,39,30,9,33
Krasnodar,3311,5,8,5,7,30,28,2,29
Terek Grozny,3311,6,8,5,7,24,25,-1,29
Din Moscow,3311,7,7,6,7,21,23,-2,27
FK Rubin,3311,8,5,6,9,24,21,3,21
Rostov,3311,9,4,7,9,12,19,-7,19
Amkar,3311,10,5,4,11,13,27,-14,19
Anzhi,3311,11,2,5,13,15,41,-26,11
Loko Moscow,3312,1,11,5,4,32,16,16,38
Spart Moscow,3312,2,10,6,4,39,28,11,36
CSKA Moscow,3312,3,11,3,6,28,20,8,36
Zenit,3312,4,9,8,3,26,15,11,35
Krasnodar,3312,5,9,4,7,30,27,3,31
Terek Grozny,3312,6,7,7,6,22,24,-2,28
Din Moscow,3312,7,6,7,7,21,23,-2,25
FK Rubin,3312,8,6,5,9,23,20,3,23
Rostov,3312,9,4,6,10,10,19,-9,18
Amkar,3312,10,4,5,11,12,26,-14,17
Anzhi,3312,11,2,6,12,15,40,-25,12
Loko Moscow,3313,1,13,5,2,34,13,21,44
CSKA Moscow,3313,2,11,3,6,28,18,10,36
Zenit,3313,3,8,8,4,22,14,8,32
Spart Moscow,3313,4,9,5,6,37,31,6,32
Terek Grozny,3313,5,8,5,7,22,23,-1,29
Krasnodar,3313,6,8,4,8,30,31,-1,28
Din Moscow,3313,7,6,6,8,20,23,-3,24
FK Rubin,3313,8,6,5,9,24,20,4,23
Amkar,3313,9,6,4,10,12,23,-11,22
Rostov,3313,10,5,6,9,13,18,-5,21
Anzhi,3313,11,2,5,13,14,42,-28,11
Loko Moscow,3314,1,12,5,3,31,13,18,41
CSKA Moscow,3314,2,11,3,6,29,19,10,36
Krasnodar,3314,3,10,4,6,32,26,6,34
Spart Moscow,3314,4,8,7,5,36,30,6,31
Terek Grozny,3314,5,8,6,6,25,25,0,30
Zenit,3314,6,7,8,5,22,19,3,29
Din Moscow,3314,7,6,6,8,20,23,-3,24
FK Rubin,3314,8,6,5,9,24,21,3,23
Rostov,3314,9,4,7,9,10,17,-7,19
Amkar,3314,10,4,6,10,13,26,-13,18
Anzhi,3314,11,3,5,12,17,40,-23,14
CSKA Moscow,3315,1,12,3,5,30,17,13,39
Loko Moscow,3315,2,11,5,4,29,15,14,38
Krasnodar,3315,3,10,4,6,30,25,5,34
Spart Moscow,3315,4,9,6,5,39,29,10,33
Zenit,3315,5,8,8,4,24,14,10,32
Terek Grozny,3315,6,8,6,6,23,23,0,30
Din Moscow,3315,7,6,6,8,20,26,-6,24
Rostov,3315,8,5,6,9,13,19,-6,21
FK Rubin,3315,9,5,5,10,24,22,2,20
Amkar,3315,10,4,6,10,11,24,-13,18
Anzhi,3315,11,2,5,13,14,43,-29,11
Loko Moscow,3316,1,11,6,3,31,17,14,39
CSKA Moscow,3316,2,11,4,5,28,17,11,37
Zenit,3316,3,8,9,3,26,14,12,33
Terek Grozny,3316,4,8,6,6,24,23,1,30
Spart Moscow,3316,5,8,5,7,33,29,4,29
Krasnodar,3316,6,8,5,7,28,26,2,29
Din Moscow,3316,7,7,6,7,22,22,0,27
FK Rubin,3316,8,6,5,9,23,21,2,23
Rostov,3316,9,5,6,9,11,17,-6,21
Amkar,3316,10,5,5,10,12,23,-11,20
Anzhi,3316,11,2,5,13,14,43,-29,11
Loko Moscow,3317,1,11,6,3,30,14,16,39
CSKA Moscow,3317,2,11,3,6,28,19,9,36
Zenit,3317,3,9,8,3,25,13,12,35
Krasnodar,3317,4,9,5,6,33,27,6,32
Terek Grozny,3317,5,9,5,6,27,23,4,32
Spart Moscow,3317,6,8,7,5,36,30,6,31
Din Moscow,3317,7,6,7,7,21,23,-2,25
FK Rubin,3317,8,5,5,10,23,24,-1,20
Rostov,3317,9,4,7,9,11,18,-7,19
Amkar,3317,10,5,4,11,12,24,-12,19
Anzhi,3317,11,2,5,13,14,45,-31,11
Loko Moscow,3318,1,13,5,2,34,13,21,44
Spart Moscow,3318,2,11,5,4,47,28,19,38
CSKA Moscow,3318,3,11,3,6,28,19,9,36
Zenit,3318,4,8,8,4,24,17,7,32
Terek Grozny,3318,5,9,5,6,24,24,0,32
Krasnodar,3318,6,8,4,8,29,29,0,28
Din Moscow,3318,7,6,6,8,19,27,-8,24
FK Rubin,3318,8,6,5,9,24,19,5,23
Rostov,3318,9,4,6,10,12,24,-12,18
Amkar,3318,10,4,4,12,10,25,-15,16
Anzhi,3318,11,2,5,13,15,41,-26,11
Loko Moscow,3319,1,12,5,3,33,13,20,41
CSKA Moscow,3319,2,12,3,5,31,19,12,39
Krasnodar,3319,3,10,4,6,31,25,6,34
Spart Moscow,3319,4,8,6,6,35,29,6,30
Zenit,3319,5,7,8,5,22,19,3,29
Terek Grozny,3319,6,8,5,7,21,23,-2,29
Din Moscow,3319,7,7,6,7,21,23,-2,27
Rostov,3319,8,5,6,9,12,18,-6,21
FK Rubin,3319,9,5,5,10,22,21,1,20
Amkar,3319,10,4,5,11,9,23,-14,17
Anzhi,3319,11,3,5,12,16,40,-24,14
Loko Moscow,3320,1,11,6,3,30,13,17,39
CSKA Moscow,3320,2,11,3,6,28,18,10,36
Spart Moscow,3320,3,9,7,4,34,25,9,34
Zenit,3320,4,8,9,3,23,14,9,33
Krasnodar,3320,5,9,4,7,28,26,2,31
Terek Grozny,3320,6,8,6,6,22,23,-1,30
FK Rubin,3320,7,7,5,8,25,18,7,26
Din Moscow,3320,8,5,7,8,18,23,-5,22
Rostov,3320,9,4,6,10,10,18,-8,18
Amkar,3320,10,4,6,10,10,23,-13,18
Anzhi,3320,11,2,5,13,14,41,-27,11
Loko Moscow,3321,1,11,7,2,33,15,18,40
CSKA Moscow,3321,2,12,3,5,30,18,12,39
Spart Moscow,3321,3,9,7,4,36,26,10,34
Zenit,3321,4,7,9,4,22,17,5,30
Krasnodar,3321,5,8,6,6,31,28,3,30
Terek Grozny,3321,6,8,5,7,22,25,-3,29
FK Rubin,3321,7,6,6,8,24,19,5,24
Din Moscow,3321,8,5,7,8,19,24,-5,22
Rostov,3321,9,4,6,10,10,19,-9,18
Amkar,3321,10,4,5,11,10,24,-14,17
Anzhi,3321,11,3,5,12,17,39,-22,14
Loko Moscow,3322,1,12,5,3,32,13,19,41
Spart Moscow,3322,2,10,6,4,40,26,14,36
Krasnodar,3322,3,10,4,6,32,27,5,34
CSKA Moscow,3322,4,10,4,6,27,22,5,34
Zenit,3322,5,8,8,4,24,15,9,32
Terek Grozny,3322,6,8,6,6,22,23,-1,30
Din Moscow,3322,7,5,7,8,18,25,-7,22
FK Rubin,3322,8,5,6,9,24,21,3,21
Rostov,3322,9,4,6,10,10,20,-10,18
Amkar,3322,10,4,5,11,11,25,-14,17
Anzhi,3322,11,2,7,11,16,39,-23,13
Loko Moscow,3323,1,11,6,3,31,14,17,39
CSKA Moscow,3323,2,12,3,5,30,18,12,39
Spart Moscow,3323,3,11,5,4,39,27,12,38
Zenit,3323,4,8,8,4,22,14,8,32
Krasnodar,3323,5,9,5,6,30,26,4,32
Terek Grozny,3323,6,7,7,6,21,23,-2,28
FK Rubin,3323,7,6,5,9,24,19,5,23
Din Moscow,3323,8,5,6,9,18,25,-7,21
Rostov,3323,9,4,6,10,11,19,-8,18
Amkar,3323,10,4,5,11,10,25,-15,17
Anzhi,3323,11,2,6,12,16,42,-26,12
Loko Moscow,3324,1,12,6,2,30,11,19,42
Spart Moscow,3324,2,11,5,4,41,25,16,38
CSKA Moscow,3324,3,11,4,5,28,17,11,37
Krasnodar,3324,4,9,5,6,29,24,5,32
Zenit,3324,5,7,9,4,21,14,7,30
Terek Grozny,3324,6,7,7,6,21,23,-2,28
Din Moscow,3324,7,5,7,8,17,25,-8,22
FK Rubin,3324,8,5,6,9,21,19,2,21
Rostov,3324,9,4,6,10,10,20,-10,18
Amkar,3324,10,4,5,11,9,23,-14,17
Anzhi,3324,11,2,6,12,15,41,-26,12
Loko Moscow,3325,1,11,6,3,31,14,17,39
CSKA Moscow,3325,2,12,3,5,29,18,11,39
Spart Moscow,3325,3,9,6,5,36,27,9,33
Krasnodar,3325,4,9,4,7,30,28,2,31
Zenit,3325,5,7,9,4,22,15,7,30
Terek Grozny,3325,6,7,6,7,23,26,-3,27
FK Rubin,3325,7,7,5,8,25,17,8,26
Din Moscow,3325,8,6,6,8,18,23,-5,24
Rostov,3325,9,4,7,9,11,18,-7,19
Amkar,3325,10,5,4,11,11,25,-14,19
Anzhi,3325,11,2,6,12,16,41,-25,12
Loko Moscow,3326,1,12,6,2,30,11,19,42
CSKA Moscow,3326,2,11,4,5,29,20,9,37
Spart Moscow,3326,3,9,6,5,40,28,12,33
Krasnodar,3326,4,9,5,6,29,24,5,32
Zenit,3326,5,7,9,4,23,16,7,30
Terek Grozny,3326,6,8,5,7,22,23,-1,29
Din Moscow,3326,7,6,6,8,18,26,-8,24
Rostov,3326,8,5,6,9,11,17,-6,21
FK Rubin,3326,9,5,5,10,21,20,1,20
Amkar,3326,10,4,5,11,11,26,-15,17
Anzhi,3326,11,3,5,12,16,39,-23,14
Loko Moscow,3327,1,11,5,4,29,14,15,38
Spart Moscow,3327,2,11,5,4,40,26,14,38
Zenit,3327,3,9,8,3,23,13,10,35
CSKA Moscow,3327,4,10,4,6,25,18,7,34
Krasnodar,3327,5,9,4,7,31,27,4,31
Terek Grozny,3327,6,8,6,6,23,24,-1,30
FK Rubin,3327,7,7,5,8,25,19,6,26
Din Moscow,3327,8,5,6,9,17,25,-8,21
Rostov,3327,9,4,6,10,10,19,-9,18
Amkar,3327,10,4,5,11,12,26,-14,17
Anzhi,3327,11,2,6,12,14,38,-24,12
Loko Moscow,3328,1,13,5,2,32,11,21,44
CSKA Moscow,3328,2,11,3,6,26,19,7,36
Krasnodar,3328,3,9,4,7,30,25,5,31
Spart Moscow,3328,4,8,6,6,36,30,6,30
Terek Grozny,3328,5,8,6,6,23,23,0,30
Zenit,3328,6,7,8,5,21,16,5,29
Din Moscow,3328,7,7,6,7,23,24,-1,27
Rostov,3328,8,5,6,9,12,18,-6,21
FK Rubin,3328,9,5,5,10,22,23,-1,20
Amkar,3328,10,4,5,11,10,25,-15,17
Anzhi,3328,11,3,6,11,16,37,-21,15
Loko Moscow,3329,1,12,6,2,32,13,19,42
CSKA Moscow,3329,2,11,4,5,31,19,12,37
Spart Moscow,3329,3,10,5,5,40,28,12,35
Zenit,3329,4,7,9,4,23,16,7,30
Krasnodar,3329,5,8,6,6,30,27,3,30
Terek Grozny,3329,6,8,5,7,23,25,-2,29
Din Moscow,3329,7,6,6,8,18,24,-6,24
FK Rubin,3329,8,5,6,9,23,20,3,21
Rostov,3329,9,5,6,9,12,17,-5,21
Amkar,3329,10,4,4,12,10,29,-19,16
Anzhi,3329,11,3,5,12,18,42,-24,14
Loko Moscow,3330,1,12,5,3,30,12,18,41
Spart Moscow,3330,2,10,6,4,40,29,11,36
CSKA Moscow,3330,3,10,3,7,25,22,3,33
Zenit,3330,4,8,8,4,23,14,9,32
Krasnodar,3330,5,9,4,7,28,25,3,31
Terek Grozny,3330,6,8,6,6,23,23,0,30
Din Moscow,3330,7,6,7,7,24,23,1,25
FK Rubin,3330,8,6,5,9,22,22,0,23
Rostov,3330,9,4,6,10,11,20,-9,18
Amkar,3330,10,4,4,12,10,26,-16,16
Anzhi,3330,11,3,6,11,18,38,-20,15
Loko Moscow,3331,1,11,5,4,30,14,16,38
Zenit,3331,2,9,8,3,23,13,10,35
Spart Moscow,3331,3,10,5,5,39,30,9,35
CSKA Moscow,3331,4,10,3,7,25,19,6,33
Krasnodar,3331,5,9,5,6,29,25,4,32
Terek Grozny,3331,6,7,6,7,22,25,-3,27
Din Moscow,3331,7,6,6,8,22,23,-1,24
Amkar,3331,8,6,4,10,14,25,-11,22
FK Rubin,3331,9,5,6,9,22,22,0,21
Rostov,3331,10,4,6,10,12,20,-8,18
Anzhi,3331,11,3,6,11,16,38,-22,15
Loko Moscow,3332,1,11,5,4,31,16,15,38
CSKA Moscow,3332,2,11,3,6,28,19,9,36
Zenit,3332,3,9,8,3,25,14,11,35
Spart Moscow,3332,4,10,5,5,38,28,10,35
Krasnodar,3332,5,10,4,6,31,25,6,34
Terek Grozny,3332,6,8,5,7,22,24,-2,29
Din Moscow,3332,7,5,7,8,18,24,-6,22
Amkar,3332,8,6,4,10,13,24,-11,22
FK Rubin,3332,9,5,6,9,21,18,3,21
Rostov,3332,10,4,6,10,10,18,-8,18
Anzhi,3332,11,2,5,13,14,41,-27,11
Loko Moscow,3333,1,11,7,2,31,13,18,40
Spart Moscow,3333,2,11,5,4,39,27,12,38
CSKA Moscow,3333,3,11,4,5,27,17,10,37
Zenit,3333,4,7,10,3,21,13,8,31
Krasnodar,3333,5,8,5,7,30,28,2,29
Terek Grozny,3333,6,7,7,6,21,23,-2,28
FK Rubin,3333,7,7,5,8,25,19,6,26
Din Moscow,3333,8,5,6,9,19,25,-6,21
Rostov,3333,9,4,6,10,10,19,-9,18
Amkar,3333,10,4,5,11,11,25,-14,17
Anzhi,3333,11,2,6,12,14,39,-25,12
Loko Moscow,3334,1,11,6,3,30,14,16,39
Spart Moscow,3334,2,10,6,4,41,30,11,36
CSKA Moscow,3334,3,11,3,6,26,18,8,36
Zenit,3334,4,8,9,3,22,13,9,33
Krasnodar,3334,5,9,4,7,30,27,3,31
Terek Grozny,3334,6,7,6,7,22,26,-4,27
FK Rubin,3334,7,7,5,8,26,19,7,26
Din Moscow,3334,8,5,7,8,21,26,-5,22
Rostov,3334,9,4,6,10,12,21,-9,18
Amkar,3334,10,4,5,11,12,26,-14,17
Anzhi,3334,11,3,5,12,16,38,-22,14
Loko Moscow,3335,1,12,5,3,32,13,19,41
CSKA Moscow,3335,2,10,4,6,26,19,7,34
Krasnodar,3335,3,10,4,6,31,26,5,34
Spart Moscow,3335,4,8,6,6,34,28,6,30
Zenit,3335,5,7,9,4,21,15,6,30
Terek Grozny,3335,6,8,6,6,23,24,-1,30
Din Moscow,3335,7,6,7,7,21,23,-2,25
Rostov,3335,8,5,6,9,11,17,-6,21
FK Rubin,3335,9,5,5,10,23,22,1,20
Amkar,3335,10,5,5,10,11,23,-12,20
Anzhi,3335,11,3,5,12,17,40,-23,14
Loko Moscow,3336,1,13,5,2,32,11,21,44
CSKA Moscow,3336,2,11,3,6,28,20,8,36
Spart Moscow,3336,3,10,5,5,39,28,11,35
Zenit,3336,4,8,8,4,23,16,7,32
Krasnodar,3336,5,9,4,7,29,26,3,31
Terek Grozny,3336,6,7,6,7,22,26,-4,27
Din Moscow,3336,7,6,6,8,19,24,-5,24
FK Rubin,3336,8,5,5,10,22,20,2,20
Amkar,3336,9,5,5,10,11,23,-12,20
Rostov,3336,10,4,6,10,11,20,-9,18
Anzhi,3336,11,3,5,12,18,40,-22,14
Loko Moscow,3337,1,12,6,2,32,13,19,42
CSKA Moscow,3337,2,11,4,5,28,17,11,37
Spart Moscow,3337,3,9,6,5,38,30,8,33
Zenit,3337,4,7,10,3,22,14,8,31
Krasnodar,3337,5,8,5,7,28,26,2,29
Terek Grozny,3337,6,7,6,7,22,26,-4,27
Din Moscow,3337,7,5,8,7,21,25,-4,23
FK Rubin,3337,8,5,7,8,23,19,4,22
Rostov,3337,9,5,6,9,12,18,-6,21
Amkar,3337,10,5,4,11,13,25,-12,19
Anzhi,3337,11,2,6,12,15,41,-26,12
Loko Moscow,3338,1,12,6,2,32,12,20,42
CSKA Moscow,3338,2,11,4,5,27,17,10,37
Spart Moscow,3338,3,10,5,5,39,30,9,35
Zenit,3338,4,7,10,3,22,14,8,31
Krasnodar,3338,5,8,4,8,27,28,-1,28
Terek Grozny,3338,6,7,6,7,22,26,-4,27
FK Rubin,3338,7,6,6,8,23,17,6,24
Din Moscow,3338,8,5,7,8,17,24,-7,22
Amkar,3338,9,5,5,10,14,24,-10,20
Rostov,3338,10,4,6,10,11,19,-8,18
Anzhi,3338,11,3,5,12,17,40,-23,14
Loko Moscow,3339,1,13,5,2,36,12,24,44
Spart Moscow,3339,2,9,7,4,39,29,10,34
CSKA Moscow,3339,3,10,3,7,26,22,4,33
Zenit,3339,4,8,8,4,25,18,7,32
Krasnodar,3339,5,9,4,7,29,28,1,31
Terek Grozny,3339,6,7,6,7,21,25,-4,27
Din Moscow,3339,7,5,8,7,21,25,-4,23
FK Rubin,3339,8,5,6,9,24,21,3,21
Amkar,3339,9,5,5,10,13,24,-11,20
Rostov,3339,10,4,6,10,10,19,-9,18
Anzhi,3339,11,3,6,11,17,38,-21,15
Loko Moscow,3340,1,11,6,3,32,16,16,39
CSKA Moscow,3340,2,11,3,6,31,21,10,36
Spart Moscow,3340,3,10,5,5,41,29,12,35
Krasnodar,3340,4,10,4,6,33,27,6,34
Zenit,3340,5,8,9,3,25,15,10,33
Terek Grozny,3340,6,9,5,6,24,23,1,32
Din Moscow,3340,7,5,7,8,19,24,-5,22
FK Rubin,3340,8,5,6,9,23,20,3,21
Amkar,3340,9,5,4,11,12,25,-13,19
Rostov,3340,10,4,6,10,10,21,-11,18
Anzhi,3340,11,2,5,13,16,45,-29,11
Loko Moscow,3341,1,12,5,3,32,12,20,41
CSKA Moscow,3341,2,12,3,5,30,18,12,39
Spart Moscow,3341,3,11,5,4,40,28,12,38
Krasnodar,3341,4,9,4,7,28,27,1,31
Zenit,3341,5,7,8,5,21,18,3,29
Terek Grozny,3341,6,7,6,7,21,24,-3,27
Din Moscow,3341,7,6,6,8,21,25,-4,24
FK Rubin,3341,8,6,5,9,25,19,6,23
Amkar,3341,9,5,4,11,12,26,-14,19
Rostov,3341,10,4,6,10,10,18,-8,18
Anzhi,3341,11,2,6,12,15,40,-25,12
Loko Moscow,3342,1,11,6,3,32,15,17,39
CSKA Moscow,3342,2,11,3,6,26,18,8,36
Spart Moscow,3342,3,10,5,5,39,27,12,35
Zenit,3342,4,9,8,3,24,14,10,35
Krasnodar,3342,5,9,5,6,31,26,5,32
Terek Grozny,3342,6,7,6,7,23,26,-3,27
Din Moscow,3342,7,5,7,8,18,23,-5,22
FK Rubin,3342,8,5,6,9,21,19,2,21
Amkar,3342,9,5,5,10,11,23,-12,20
Rostov,3342,10,4,6,10,10,21,-11,18
Anzhi,3342,11,3,5,12,17,40,-23,14
Loko Moscow,3343,1,11,6,3,32,15,17,39
Spart Moscow,3343,2,10,6,4,37,26,11,36
CSKA Moscow,3343,3,11,3,6,28,20,8,36
Zenit,3343,4,9,8,3,25,15,10,35
Krasnodar,3343,5,8,6,6,30,27,3,30
Terek Grozny,3343,6,7,6,7,22,26,-4,27
FK Rubin,3343,7,6,6,8,25,19,6,24
Din Moscow,3343,8,5,7,8,18,24,-6,22
Amkar,3343,9,5,4,11,12,24,-12,19
Rostov,3343,10,4,6,10,10,19,-9,18
Anzhi,3343,11,2,6,12,17,41,-24,12
Loko Moscow,3344,1,12,6,2,33,14,19,42
CSKA Moscow,3344,2,11,3,6,27,20,7,36
Spart Moscow,3344,3,10,5,5,38,28,10,35
Zenit,3344,4,8,8,4,23,14,9,32
Krasnodar,3344,5,9,5,6,32,28,4,32
Terek Grozny,3344,6,8,6,6,21,22,-1,30
Din Moscow,3344,7,6,7,7,19,22,-3,25
FK Rubin,3344,8,5,6,9,23,20,3,21
Rostov,3344,9,4,6,10,11,20,-9,18
Amkar,3344,10,4,4,12,10,25,-15,16
Anzhi,3344,11,2,6,12,15,39,-24,12
Loko Moscow,3345,1,13,5,2,34,11,23,44
Spart Moscow,3345,2,11,5,4,38,26,12,38
CSKA Moscow,3345,3,11,3,6,26,18,8,36
Zenit,3345,4,8,8,4,22,15,7,32
Terek Grozny,3345,5,8,6,6,23,23,0,30
Krasnodar,3345,6,8,5,7,27,27,0,29
FK Rubin,3345,7,5,7,8,21,17,4,22
Din Moscow,3345,8,5,7,8,18,23,-5,22
Rostov,3345,9,4,6,10,10,19,-9,18
Amkar,3345,10,4,4,12,9,25,-16,16
Anzhi,3345,11,2,6,12,15,39,-24,12
Loko Moscow,3346,1,12,5,3,32,14,18,41
Spart Moscow,3346,2,11,5,4,44,28,16,38
CSKA Moscow,3346,3,10,4,6,25,19,6,34
Zenit,3346,4,8,9,3,22,13,9,33
Terek Grozny,3346,5,8,5,7,25,25,0,29
Krasnodar,3346,6,8,4,8,29,29,0,28
FK Rubin,3346,7,6,6,8,24,18,6,24
Din Moscow,3346,8,5,7,8,19,28,-9,22
Amkar,3346,9,5,4,11,12,25,-13,19
Rostov,3346,10,4,6,10,10,19,-9,18
Anzhi,3346,11,3,5,12,18,42,-24,14
Loko Moscow,3347,1,11,7,2,31,13,18,40
Spart Moscow,3347,2,10,6,4,35,25,10,36
CSKA Moscow,3347,3,11,3,6,28,20,8,36
Zenit,3347,4,8,9,3,24,15,9,33
Krasnodar,3347,5,9,5,6,31,25,6,32
Terek Grozny,3347,6,7,6,7,20,23,-3,27
FK Rubin,3347,7,6,5,9,22,20,2,23
Din Moscow,3347,8,5,6,9,17,23,-6,21
Rostov,3347,9,4,7,9,10,17,-7,19
Amkar,3347,10,5,4,11,10,23,-13,19
Anzhi,3347,11,2,6,12,15,39,-24,12
Loko Moscow,3348,1,11,6,3,30,13,17,39
CSKA Moscow,3348,2,11,4,5,27,18,9,37
Spart Moscow,3348,3,9,7,4,35,26,9,34
Zenit,3348,4,8,8,4,23,15,8,32
Terek Grozny,3348,5,9,5,6,25,23,2,32
Krasnodar,3348,6,8,5,7,28,26,2,29
Din Moscow,3348,7,6,7,7,21,24,-3,25
FK Rubin,3348,8,6,5,9,25,21,4,23
Rostov,3348,9,4,7,9,10,17,-7,19
Amkar,3348,10,4,4,12,9,26,-17,16
Anzhi,3348,11,2,6,12,16,40,-24,12
Loko Moscow,3349,1,12,5,3,31,14,17,41
CSKA Moscow,3349,2,12,3,5,30,19,11,39
Spart Moscow,3349,3,11,5,4,40,27,13,38
Zenit,3349,4,8,8,4,24,16,8,32
Krasnodar,3349,5,8,5,7,29,27,2,29
Terek Grozny,3349,6,7,6,7,21,24,-3,27
FK Rubin,3349,7,6,6,8,23,18,5,24
Din Moscow,3349,8,5,6,9,17,24,-7,21
Amkar,3349,9,5,4,11,12,25,-13,19
Rostov,3349,10,4,6,10,10,19,-9,18
Anzhi,3349,11,2,6,12,16,40,-24,12
Loko Moscow,3350,1,11,6,3,30,14,16,39
CSKA Moscow,3350,2,12,3,5,29,18,11,39
Spart Moscow,3350,3,9,7,4,36,26,10,34
Krasnodar,3350,4,10,4,6,30,24,6,34
Zenit,3350,5,7,9,4,22,15,7,30
Terek Grozny,3350,6,7,5,8,21,25,-4,26
FK Rubin,3350,7,6,5,9,22,18,4,23
Din Moscow,3350,8,5,6,9,17,24,-7,21
Amkar,3350,9,5,5,10,10,22,-12,20
Rostov,3350,10,4,7,9,11,18,-7,19
Anzhi,3350,11,3,5,12,17,41,-24,14
Loko Moscow,3351,1,11,7,2,30,12,18,40
CSKA Moscow,3351,2,11,3,6,29,21,8,36
Spart Moscow,3351,3,9,7,4,38,28,10,34
Zenit,3351,4,7,9,4,23,16,7,30
Krasnodar,3351,5,8,5,7,29,28,1,29
Terek Grozny,3351,6,7,6,7,22,28,-6,27
Din Moscow,3351,7,6,7,7,23,23,0,25
FK Rubin,3351,8,6,5,9,24,22,2,23
Rostov,3351,9,4,6,10,10,19,-9,18
Amkar,3351,10,4,6,10,11,24,-13,18
Anzhi,3351,11,4,5,11,21,39,-18,17
Loko Moscow,3352,1,11,6,3,32,15,17,39
CSKA Moscow,3352,2,11,4,5,29,20,9,37
Spart Moscow,3352,3,10,5,5,41,29,12,35
Zenit,3352,4,8,8,4,24,16,8,32
Krasnodar,3352,5,9,5,6,34,29,5,32
Terek Grozny,3352,6,8,6,6,23,24,-1,30
Din Moscow,3352,7,5,7,8,19,28,-9,22
FK Rubin,3352,8,5,6,9,25,23,2,21
Amkar,3352,9,5,4,11,12,24,-12,19
Rostov,3352,10,4,6,10,12,20,-8,18
Anzhi,3352,11,2,7,11,16,39,-23,13
Loko Moscow,3353,1,12,6,2,32,13,19,42
CSKA Moscow,3353,2,12,3,5,27,17,10,39
Spart Moscow,3353,3,10,5,5,38,29,9,35
Krasnodar,3353,4,8,6,6,28,25,3,30
Terek Grozny,3353,5,8,6,6,26,26,0,30
Zenit,3353,6,7,8,5,22,16,6,29
Din Moscow,3353,7,6,6,8,20,23,-3,24
FK Rubin,3353,8,5,6,9,21,19,2,21
Rostov,3353,9,5,6,9,12,18,-6,21
Amkar,3353,10,4,5,11,12,26,-14,17
Anzhi,3353,11,2,5,13,16,42,-26,11
Loko Moscow,3354,1,13,5,2,33,11,22,44
CSKA Moscow,3354,2,11,3,6,28,19,9,36
Spart Moscow,3354,3,10,5,5,38,26,12,35
Zenit,3354,4,8,8,4,23,16,7,32
Krasnodar,3354,5,9,4,7,29,25,4,31
Terek Grozny,3354,6,8,5,7,25,25,0,29
Din Moscow,3354,7,6,6,8,18,22,-4,24
FK Rubin,3354,8,6,5,9,22,19,3,23
Amkar,3354,9,5,4,11,12,27,-15,19
Rostov,3354,10,4,6,10,10,19,-9,18
Anzhi,3354,11,2,5,13,14,43,-29,11
Loko Moscow,3355,1,11,7,2,32,14,18,40
CSKA Moscow,3355,2,10,4,6,27,20,7,34
Spart Moscow,3355,3,9,5,6,37,28,9,32
Zenit,3355,4,7,10,3,24,16,8,31
Krasnodar,3355,5,8,6,6,28,25,3,30
Terek Grozny,3355,6,7,6,7,22,26,-4,27
Din Moscow,3355,7,6,6,8,18,24,-6,24
FK Rubin,3355,8,5,6,9,21,18,3,21
Rostov,3355,9,5,6,9,11,17,-6,21
Amkar,3355,10,5,5,10,12,24,-12,20
Anzhi,3355,11,4,5,11,19,39,-20,17
Loko Moscow,3356,1,13,5,2,33,12,21,44
CSKA Moscow,3356,2,11,3,6,26,19,7,36
Spart Moscow,3356,3,9,7,4,37,28,9,34
Zenit,3356,4,8,8,4,24,15,9,32
Krasnodar,3356,5,8,5,7,28,27,1,29
Terek Grozny,3356,6,7,6,7,22,27,-5,27
Din Moscow,3356,7,6,7,7,20,23,-3,25
FK Rubin,3356,8,5,6,9,22,19,3,21
Rostov,3356,9,4,7,9,11,18,-7,19
Amkar,3356,10,4,5,11,11,25,-14,17
Anzhi,3356,11,3,5,12,17,38,-21,14
Loko Moscow,3357,1,12,6,2,32,13,19,42
CSKA Moscow,3357,2,10,4,6,26,19,7,34
Zenit,3357,3,8,9,3,23,14,9,33
Terek Grozny,3357,4,9,5,6,25,23,2,32
Spart Moscow,3357,5,8,6,6,36,31,5,30
Krasnodar,3357,6,8,4,8,28,27,1,28
FK Rubin,3357,7,7,5,8,25,17,8,26
Din Moscow,3357,8,6,6,8,20,25,-5,24
Rostov,3357,9,4,7,9,11,18,-7,19
Amkar,3357,10,5,4,11,11,24,-13,19
Anzhi,3357,11,2,6,12,16,42,-26,12
Loko Moscow,3358,1,12,5,3,32,15,17,41
CSKA Moscow,3358,2,11,4,5,28,19,9,37
Spart Moscow,3358,3,9,6,5,35,26,9,33
Krasnodar,3358,4,9,4,7,31,27,4,31
Zenit,3358,5,7,9,4,22,16,6,30
Terek Grozny,3358,6,8,6,6,23,23,0,30
FK Rubin,3358,7,6,6,8,23,17,6,24
Din Moscow,3358,8,5,7,8,17,23,-6,22
Amkar,3358,9,5,5,10,10,22,-12,20
Rostov,3358,10,4,7,9,10,17,-7,19
Anzhi,3358,11,2,5,13,16,42,-26,11
Loko Moscow,3359,1,11,5,4,29,15,14,38
CSKA Moscow,3359,2,11,3,6,27,18,9,36
Zenit,3359,3,9,8,3,23,13,10,35
Spart Moscow,3359,4,8,7,5,38,31,7,31
Krasnodar,3359,5,9,4,7,31,27,4,31
Terek Grozny,3359,6,7,6,7,21,24,-3,27
FK Rubin,3359,7,6,6,8,25,19,6,24
Din Moscow,3359,8,5,8,7,20,24,-4,23
Amkar,3359,9,5,5,10,12,24,-12,20
Rostov,3359,10,4,7,9,12,19,-7,19
Anzhi,3359,11,3,5,12,15,39,-24,14
Loko Moscow,3360,1,11,5,4,30,14,16,38
Spart Moscow,3360,2,10,6,4,36,26,10,36
CSKA Moscow,3360,3,10,4,6,25,18,7,34
Zenit,3360,4,8,9,3,23,14,9,33
Krasnodar,3360,5,9,5,6,28,24,4,32
Terek Grozny,3360,6,7,6,7,22,25,-3,27
FK Rubin,3360,7,6,6,8,23,17,6,24
Din Moscow,3360,8,5,6,9,17,24,-7,21
Rostov,3360,9,4,6,10,11,19,-8,18
Amkar,3360,10,4,6,10,10,23,-13,18
Anzhi,3360,11,4,5,11,17,38,-21,17
Loko Moscow,3361,1,11,5,4,29,15,14,38
CSKA Moscow,3361,2,11,4,5,28,18,10,37
Krasnodar,3361,3,10,4,6,32,24,8,34
Zenit,3361,4,8,9,3,23,14,9,33
Spart Moscow,3361,5,9,6,5,37,31,6,33
Terek Grozny,3361,6,8,6,6,21,22,-1,30
FK Rubin,3361,7,6,5,9,22,19,3,23
Din Moscow,3361,8,5,6,9,17,24,-7,21
Amkar,3361,9,5,5,10,13,22,-9,20
Rostov,3361,10,4,7,9,12,19,-7,19
Anzhi,3361,11,2,5,13,14,40,-26,11
Loko Moscow,3362,1,11,7,2,30,12,18,40
CSKA Moscow,3362,2,11,3,6,29,19,10,36
Spart Moscow,3362,3,10,5,5,40,28,12,35
Zenit,3362,4,7,9,4,22,17,5,30
Krasnodar,3362,5,8,6,6,29,26,3,30
Terek Grozny,3362,6,8,6,6,28,27,1,30
FK Rubin,3362,7,5,7,8,22,18,4,22
Din Moscow,3362,8,5,7,8,19,24,-5,22
Rostov,3362,9,5,6,9,11,17,-6,21
Amkar,3362,10,4,4,12,12,32,-20,16
Anzhi,3362,11,3,6,11,17,39,-22,15
Loko Moscow,3363,1,11,6,3,30,13,17,39
CSKA Moscow,3363,2,12,3,5,30,19,11,39
Spart Moscow,3363,3,9,6,5,38,29,9,33
Terek Grozny,3363,4,9,5,6,22,22,0,32
Krasnodar,3363,5,9,4,7,29,26,3,31
Zenit,3363,6,7,9,4,24,17,7,30
Din Moscow,3363,7,7,6,7,23,24,-1,27
FK Rubin,3363,8,6,5,9,25,21,4,23
Rostov,3363,9,4,6,10,10,20,-10,18
Amkar,3363,10,4,5,11,10,24,-14,17
Anzhi,3363,11,2,5,13,14,40,-26,11
Loko Moscow,3364,1,12,5,3,31,13,18,41
CSKA Moscow,3364,2,11,4,5,29,19,10,37
Krasnodar,3364,3,10,4,6,31,25,6,34
Spart Moscow,3364,4,8,7,5,35,30,5,31
Zenit,3364,5,7,9,4,22,16,6,30
Terek Grozny,3364,6,7,5,8,20,26,-6,26
Din Moscow,3364,7,6,7,7,20,23,-3,25
Rostov,3364,8,5,6,9,13,17,-4,21
FK Rubin,3364,9,5,5,10,23,21,2,20
Amkar,3364,10,5,5,10,11,23,-12,20
Anzhi,3364,11,3,5,12,18,40,-22,14
Loko Moscow,3365,1,13,5,2,31,11,20,44
CSKA Moscow,3365,2,11,4,5,28,18,10,37
Spart Moscow,3365,3,9,5,6,38,30,8,32
Zenit,3365,4,7,8,5,21,16,5,29
Krasnodar,3365,5,8,4,8,28,27,1,28
Terek Grozny,3365,6,7,7,6,20,22,-2,28
FK Rubin,3365,7,6,6,8,24,19,5,24
Din Moscow,3365,8,5,7,8,20,27,-7,22
Rostov,3365,9,5,6,9,11,17,-6,21
Amkar,3365,10,5,5,10,11,22,-11,20
Anzhi,3365,11,2,7,11,15,38,-23,13
Loko Moscow,3366,1,13,5,2,34,12,22,44
CSKA Moscow,3366,2,10,5,5,26,18,8,35
Spart Moscow,3366,3,9,7,4,37,27,10,34
Zenit,3366,4,7,9,4,23,16,7,30
Krasnodar,3366,5,8,4,8,27,28,-1,28
FK Rubin,3366,6,7,5,8,23,17,6,26
Terek Grozny,3366,7,7,5,8,22,27,-5,26
Din Moscow,3366,8,5,7,8,19,24,-5,22
Amkar,3366,9,5,5,10,10,22,-12,20
Rostov,3366,10,4,6,10,10,19,-9,18
Anzhi,3366,11,3,6,11,18,39,-21,15
Loko Moscow,3367,1,13,5,2,32,12,20,44
CSKA Moscow,3367,2,11,4,5,28,19,9,37
Spart Moscow,3367,3,10,5,5,38,28,10,35
Zenit,3367,4,7,8,5,21,15,6,29
Krasnodar,3367,5,8,4,8,29,28,1,28
FK Rubin,3367,6,7,5,8,25,18,7,26
Terek Grozny,3367,7,7,5,8,21,27,-6,26
Amkar,3367,8,6,4,10,14,22,-8,22
Din Moscow,3367,9,5,6,9,17,25,-8,21
Rostov,3367,10,4,6,10,10,20,-10,18
Anzhi,3367,11,3,6,11,19,40,-21,15
Loko Moscow,3368,1,12,5,3,31,13,18,41
CSKA Moscow,3368,2,12,3,5,29,17,12,39
Zenit,3368,3,8,8,4,22,15,7,32
Krasnodar,3368,4,9,4,7,30,27,3,31
Spart Moscow,3368,5,8,6,6,36,31,5,30
Terek Grozny,3368,6,8,5,7,22,27,-5,29
Din Moscow,3368,7,7,6,7,22,21,1,27
Rostov,3368,8,5,6,9,13,19,-6,21
FK Rubin,3368,9,5,5,10,22,22,0,20
Amkar,3368,10,4,5,11,11,25,-14,17
Anzhi,3368,11,3,5,12,18,39,-21,14
Loko Moscow,3369,1,12,5,3,31,13,18,41
CSKA Moscow,3369,2,10,5,5,28,20,8,35
Zenit,3369,3,8,9,3,23,13,10,33
Spart Moscow,3369,4,8,6,6,33,27,6,30
Krasnodar,3369,5,8,4,8,28,28,0,28
Terek Grozny,3369,6,7,7,6,20,22,-2,28
FK Rubin,3369,7,7,5,8,26,18,8,26
Din Moscow,3369,8,6,6,8,18,24,-6,24
Rostov,3369,9,5,6,9,11,17,-6,21
Amkar,3369,10,4,6,10,9,22,-13,18
Anzhi,3369,11,2,7,11,17,40,-23,13
Loko Moscow,3370,1,11,5,4,30,15,15,38
CSKA Moscow,3370,2,11,3,6,28,23,5,36
Zenit,3370,3,9,8,3,28,13,15,35
Krasnodar,3370,4,10,4,6,31,25,6,34
Spart Moscow,3370,5,8,6,6,35,29,6,30
Terek Grozny,3370,6,8,6,6,23,24,-1,30
FK Rubin,3370,7,6,5,9,23,20,3,23
Din Moscow,3370,8,5,7,8,19,24,-5,22
Rostov,3370,9,5,6,9,12,18,-6,21
Amkar,3370,10,5,5,10,10,22,-12,20
Anzhi,3370,11,2,5,13,17,43,-26,11
CSKA Moscow,3371,1,12,3,5,30,17,13,39
Loko Moscow,3371,2,11,5,4,29,15,14,38
Spart Moscow,3371,3,10,5,5,40,30,10,35
Krasnodar,3371,4,10,4,6,30,24,6,34
Zenit,3371,5,8,8,4,23,15,8,32
Terek Grozny,3371,6,8,6,6,24,25,-1,30
Din Moscow,3371,7,6,6,8,19,24,-5,24
Rostov,3371,8,5,6,9,13,19,-6,21
FK Rubin,3371,9,5,5,10,21,19,2,20
Amkar,3371,10,4,4,12,11,26,-15,16
Anzhi,3371,11,2,6,12,16,42,-26,12
Loko Moscow,3372,1,12,6,2,30,11,19,42
CSKA Moscow,3372,2,12,3,5,28,18,10,39
Terek Grozny,3372,3,9,5,6,26,25,1,32
Zenit,3372,4,7,9,4,21,14,7,30
Spart Moscow,3372,5,8,5,7,37,33,4,29
Krasnodar,3372,6,8,4,8,30,29,1,28
Din Moscow,3372,7,7,6,7,20,22,-2,27
FK Rubin,3372,8,6,5,9,25,21,4,23
Rostov,3372,9,5,6,9,12,17,-5,21
Amkar,3372,10,5,4,11,14,28,-14,19
Anzhi,3372,11,2,5,13,17,42,-25,11
CSKA Moscow,3373,1,12,3,5,30,17,13,39
Loko Moscow,3373,2,11,5,4,30,14,16,38
Spart Moscow,3373,3,9,6,5,38,30,8,33
Zenit,3373,4,8,8,4,22,16,6,32
Krasnodar,3373,5,9,5,6,29,25,4,32
Terek Grozny,3373,6,7,6,7,22,25,-3,27
Din Moscow,3373,7,6,7,7,22,25,-3,25
FK Rubin,3373,8,5,6,9,22,19,3,21
Rostov,3373,9,5,6,9,12,18,-6,21
Amkar,3373,10,5,4,11,10,23,-13,19
Anzhi,3373,11,2,6,12,16,41,-25,12
Loko Moscow,3374,1,11,6,3,30,14,16,39
CSKA Moscow,3374,2,11,3,6,33,21,12,36
Spart Moscow,3374,3,10,6,4,38,27,11,36
Zenit,3374,4,8,9,3,25,14,11,33
Krasnodar,3374,5,9,4,7,31,27,4,31
Terek Grozny,3374,6,7,5,8,21,26,-5,26
FK Rubin,3374,7,6,6,8,25,20,5,24
Din Moscow,3374,8,5,7,8,18,23,-5,22
Rostov,3374,9,4,7,9,12,19,-7,19
Amkar,3374,10,5,4,11,10,24,-14,19
Anzhi,3374,11,3,5,12,18,46,-28,14
Loko Moscow,3375,1,12,6,2,33,12,21,42
CSKA Moscow,3375,2,11,4,5,29,20,9,37
Spart Moscow,3375,3,10,6,4,39,28,11,36
Krasnodar,3375,4,9,4,7,32,27,5,31
Zenit,3375,5,7,9,4,22,15,7,30
Terek Grozny,3375,6,8,5,7,21,23,-2,29
Din Moscow,3375,7,5,8,7,20,24,-4,23
FK Rubin,3375,8,5,6,9,23,24,-1,21
Amkar,3375,9,5,4,11,10,23,-13,19
Rostov,3375,10,4,6,10,12,21,-9,18
Anzhi,3375,11,2,6,12,17,41,-24,12
Loko Moscow,3376,1,13,5,2,36,12,24,44
CSKA Moscow,3376,2,10,4,6,28,23,5,34
Spart Moscow,3376,3,9,6,5,38,29,9,33
Zenit,3376,4,8,8,4,24,18,6,32
Krasnodar,3376,5,8,5,7,29,27,2,29
Terek Grozny,3376,6,8,5,7,21,24,-3,29
FK Rubin,3376,7,6,6,8,23,18,5,24
Din Moscow,3376,8,6,6,8,19,23,-4,24
Rostov,3376,9,4,6,10,11,20,-9,18
Amkar,3376,10,4,5,11,10,24,-14,17
Anzhi,3376,11,3,6,11,19,40,-21,15
Loko Moscow,3377,1,12,6,2,33,14,19,42
CSKA Moscow,3377,2,11,3,6,28,21,7,36
Zenit,3377,3,8,9,3,24,13,11,33
Spart Moscow,3377,4,9,5,6,36,28,8,32
Terek Grozny,3377,5,8,6,6,23,23,0,30
Krasnodar,3377,6,8,5,7,31,29,2,29
Din Moscow,3377,7,6,7,7,19,22,-3,25
FK Rubin,3377,8,5,7,8,23,19,4,22
Rostov,3377,9,5,6,9,12,18,-6,21
Amkar,3377,10,4,4,12,10,27,-17,16
Anzhi,3377,11,2,6,12,15,40,-25,12
Loko Moscow,3378,1,12,5,3,32,16,16,41
CSKA Moscow,3378,2,11,4,5,28,18,10,37
Krasnodar,3378,3,10,4,6,35,27,8,34
Spart Moscow,3378,4,9,6,5,36,30,6,33
Zenit,3378,5,7,9,4,23,16,7,30
Terek Grozny,3378,6,7,5,8,21,27,-6,26
FK Rubin,3378,7,6,5,9,26,21,5,23
Amkar,3378,8,6,4,10,14,23,-9,22
Din Moscow,3378,9,5,6,9,18,26,-8,21
Rostov,3378,10,4,7,9,10,17,-7,19
Anzhi,3378,11,3,5,12,18,40,-22,14
Loko Moscow,3379,1,11,6,3,29,12,17,39
CSKA Moscow,3379,2,12,3,5,29,17,12,39
Spart Moscow,3379,3,9,6,5,35,29,6,33
Zenit,3379,4,8,8,4,22,14,8,32
Krasnodar,3379,5,8,6,6,28,25,3,30
Terek Grozny,3379,6,8,6,6,24,24,0,30
FK Rubin,3379,7,5,7,8,22,18,4,22
Din Moscow,3379,8,5,7,8,17,22,-5,22
Rostov,3379,9,4,7,9,11,18,-7,19
Amkar,3379,10,5,4,11,12,24,-12,19
Anzhi,3379,11,2,6,12,16,42,-26,12
CSKA Moscow,3380,1,12,3,5,30,18,12,39
Loko Moscow,3380,2,11,5,4,29,14,15,38
Spart Moscow,3380,3,10,6,4,39,26,13,36
Zenit,3380,4,8,8,4,23,15,8,32
Krasnodar,3380,5,9,4,7,30,27,3,31
Terek Grozny,3380,6,7,6,7,21,24,-3,27
FK Rubin,3380,7,7,5,8,25,18,7,26
Din Moscow,3380,8,5,7,8,18,23,-5,22
Rostov,3380,9,4,6,10,10,18,-8,18
Amkar,3380,10,4,5,11,9,26,-17,17
Anzhi,3380,11,3,5,12,16,41,-25,14
Loko Moscow,3381,1,12,6,2,33,12,21,42
CSKA Moscow,3381,2,10,4,6,26,19,7,34
Zenit,3381,3,8,9,3,22,13,9,33
Spart Moscow,3381,4,9,6,5,36,29,7,33
Terek Grozny,3381,5,8,6,6,21,22,-1,30
Krasnodar,3381,6,8,5,7,29,29,0,29
FK Rubin,3381,7,6,6,8,23,18,5,24
Din Moscow,3381,8,5,6,9,17,23,-6,21
Rostov,3381,9,4,7,9,11,18,-7,19
Amkar,3381,10,5,4,11,12,24,-12,19
Anzhi,3381,11,2,7,11,15,38,-23,13
Loko Moscow,3382,1,13,5,2,34,11,23,44
CSKA Moscow,3382,2,12,3,5,29,19,10,39
Spart Moscow,3382,3,9,7,4,37,26,11,34
Zenit,3382,4,7,8,5,22,19,3,29
Krasnodar,3382,5,8,4,8,27,27,0,28
Terek Grozny,3382,6,7,6,7,22,27,-5,27
FK Rubin,3382,7,7,5,8,24,17,7,26
Din Moscow,3382,8,5,6,9,17,25,-8,21
Rostov,3382,9,4,7,9,11,18,-7,19
Amkar,3382,10,4,6,10,11,24,-13,18
Anzhi,3382,11,3,5,12,18,39,-21,14
Loko Moscow,3383,1,12,5,3,31,13,18,41
CSKA Moscow,3383,2,11,3,6,27,18,9,36
Zenit,3383,3,8,8,4,22,15,7,32
Spart Moscow,3383,4,9,5,6,36,30,6,32
Krasnodar,3383,5,9,4,7,31,28,3,31
Terek Grozny,3383,6,7,5,8,21,26,-5,26
Din Moscow,3383,7,6,6,8,20,25,-5,24
FK Rubin,3383,8,6,5,9,26,21,5,23
Amkar,3383,9,6,4,10,14,23,-9,22
Rostov,3383,10,5,6,9,11,17,-6,21
Anzhi,3383,11,3,5,12,16,39,-23,14
Loko Moscow,3384,1,11,7,2,30,12,18,40
CSKA Moscow,3384,2,12,3,5,29,19,10,39
Spart Moscow,3384,3,11,5,4,37,25,12,38
Krasnodar,3384,4,9,5,6,30,26,4,32
Zenit,3384,5,7,9,4,22,15,7,30
Terek Grozny,3384,6,7,6,7,22,25,-3,27
Din Moscow,3384,7,6,6,8,20,23,-3,24
FK Rubin,3384,8,5,5,10,23,22,1,20
Amkar,3384,9,5,4,11,10,23,-13,19
Rostov,3384,10,4,6,10,10,19,-9,18
Anzhi,3384,11,2,6,12,17,41,-24,12
Loko Moscow,3385,1,12,6,2,33,13,20,42
CSKA Moscow,3385,2,12,3,5,30,17,13,39
Spart Moscow,3385,3,9,6,5,38,30,8,33
Krasnodar,3385,4,8,6,6,27,24,3,30
Zenit,3385,5,7,8,5,23,18,5,29
Din Moscow,3385,6,7,6,7,22,23,-1,27
Terek Grozny,3385,7,7,6,7,22,25,-3,27
FK Rubin,3385,8,5,6,9,22,19,3,21
Amkar,3385,9,5,5,10,12,24,-12,20
Rostov,3385,10,4,6,10,10,19,-9,18
Anzhi,3385,11,2,6,12,16,43,-27,12
Loko Moscow,3386,1,11,6,3,30,13,17,39
CSKA Moscow,3386,2,11,4,5,29,18,11,37
Spart Moscow,3386,3,9,7,4,38,28,10,34
Krasnodar,3386,4,10,4,6,29,24,5,34
Zenit,3386,5,7,10,3,23,15,8,31
Terek Grozny,3386,6,8,6,6,23,24,-1,30
Din Moscow,3386,7,5,8,7,20,24,-4,23
FK Rubin,3386,8,5,6,9,22,19,3,21
Rostov,3386,9,4,7,9,11,18,-7,19
Amkar,3386,10,4,4,12,10,26,-16,16
Anzhi,3386,11,2,6,12,15,41,-26,12
Loko Moscow,3387,1,12,5,3,31,13,18,41
CSKA Moscow,3387,2,11,3,6,27,21,6,36
Zenit,3387,3,9,8,3,25,13,12,35
Spart Moscow,3387,4,10,5,5,36,27,9,35
Krasnodar,3387,5,9,4,7,31,28,3,31
Terek Grozny,3387,6,8,5,7,22,25,-3,29
Din Moscow,3387,7,7,6,7,20,21,-1,27
FK Rubin,3387,8,5,5,10,23,21,2,20
Amkar,3387,9,5,4,11,11,24,-13,19
Rostov,3387,10,4,6,10,10,18,-8,18
Anzhi,3387,11,2,5,13,16,41,-25,11
Loko Moscow,3388,1,11,6,3,30,13,17,39
CSKA Moscow,3388,2,11,3,6,28,20,8,36
Krasnodar,3388,3,10,4,6,31,25,6,34
Zenit,3388,4,8,9,3,25,14,11,33
Spart Moscow,3388,5,9,5,6,37,31,6,32
Din Moscow,3388,6,7,6,7,23,22,1,27
Terek Grozny,3388,7,7,5,8,23,27,-4,26
Rostov,3388,8,5,6,9,12,18,-6,21
FK Rubin,3388,9,5,5,10,22,22,0,20
Amkar,3388,10,5,4,11,11,25,-14,19
Anzhi,3388,11,3,5,12,17,42,-25,14
Loko Moscow,3389,1,12,5,3,30,12,18,41
CSKA Moscow,3389,2,12,3,5,30,18,12,39
Krasnodar,3389,3,9,4,7,28,26,2,31
Spart Moscow,3389,4,8,6,6,34,31,3,30
Terek Grozny,3389,5,8,6,6,26,23,3,30
Zenit,3389,6,7,8,5,22,18,4,29
Din Moscow,3389,7,6,7,7,18,21,-3,25
FK Rubin,3389,8,6,6,8,23,17,6,24
Amkar,3389,9,5,5,10,14,23,-9,20
Rostov,3389,10,4,7,9,11,18,-7,19
Anzhi,3389,11,2,5,13,14,43,-29,11
Loko Moscow,3390,1,12,5,3,30,12,18,41
Spart Moscow,3390,2,10,5,5,37,27,10,35
Krasnodar,3390,3,10,4,6,30,25,5,34
CSKA Moscow,3390,4,10,4,6,25,20,5,34
Zenit,3390,5,7,9,4,21,14,7,30
Din Moscow,3390,6,7,6,7,20,21,-1,27
Terek Grozny,3390,7,7,6,7,20,24,-4,27
FK Rubin,3390,8,5,5,10,22,20,2,20
Rostov,3390,9,4,6,10,10,18,-8,18
Amkar,3390,10,4,5,11,9,25,-16,17
Anzhi,3390,11,4,5,11,19,37,-18,17
Loko Moscow,3391,1,12,5,3,31,13,18,41
Spart Moscow,3391,2,11,5,4,43,27,16,38
CSKA Moscow,3391,3,11,4,5,32,18,14,37
Krasnodar,3391,4,9,5,6,28,24,4,32
Terek Grozny,3391,5,9,5,6,23,22,1,32
Zenit,3391,6,7,9,4,23,16,7,30
FK Rubin,3391,7,6,6,8,23,18,5,24
Din Moscow,3391,8,5,6,9,19,27,-8,21
Rostov,3391,9,4,6,10,10,19,-9,18
Amkar,3391,10,4,4,12,10,28,-18,16
Anzhi,3391,11,2,5,13,14,44,-30,11
Loko Moscow,3392,1,12,5,3,31,15,16,41
Spart Moscow,3392,2,11,5,4,40,25,15,38
CSKA Moscow,3392,3,11,3,6,29,19,10,36
Zenit,3392,4,8,8,4,23,14,9,32
Krasnodar,3392,5,9,5,6,31,25,6,32
Terek Grozny,3392,6,7,6,7,22,27,-5,27
Din Moscow,3392,7,6,6,8,19,24,-5,24
FK Rubin,3392,8,5,6,9,21,19,2,21
Amkar,3392,9,5,4,11,12,25,-13,19
Rostov,3392,10,4,6,10,10,18,-8,18
Anzhi,3392,11,2,6,12,16,43,-27,12
Loko Moscow,3393,1,12,5,3,31,12,19,41
CSKA Moscow,3393,2,12,3,5,27,17,10,39
Spart Moscow,3393,3,9,6,5,35,28,7,33
Zenit,3393,4,8,8,4,22,14,8,32
Krasnodar,3393,5,9,4,7,29,26,3,31
Terek Grozny,3393,6,7,5,8,20,26,-6,26
Din Moscow,3393,7,6,7,7,20,22,-2,25
Amkar,3393,8,6,4,10,14,22,-8,22
FK Rubin,3393,9,5,5,10,21,21,0,20
Rostov,3393,10,4,6,10,10,18,-8,18
Anzhi,3393,11,3,5,12,15,38,-23,14
Loko Moscow,3394,1,12,6,2,31,11,20,42
CSKA Moscow,3394,2,12,3,5,29,18,11,39
Spart Moscow,3394,3,9,6,5,35,27,8,33
Zenit,3394,4,7,9,4,21,14,7,30
Terek Grozny,3394,5,8,6,6,26,25,1,30
Krasnodar,3394,6,8,4,8,27,28,-1,28
Din Moscow,3394,7,6,6,8,19,22,-3,24
FK Rubin,3394,8,6,5,9,23,19,4,23
Amkar,3394,9,5,5,10,13,25,-12,20
Rostov,3394,10,4,7,9,10,17,-7,19
Anzhi,3394,11,2,5,13,16,44,-28,11
Loko Moscow,3395,1,12,5,3,30,12,18,41
CSKA Moscow,3395,2,12,3,5,29,17,12,39
Krasnodar,3395,3,9,5,6,28,24,4,32
Terek Grozny,3395,4,9,5,6,26,24,2,32
Spart Moscow,3395,5,8,6,6,35,29,6,30
Zenit,3395,6,7,8,5,21,15,6,29
Din Moscow,3395,7,7,6,7,19,21,-2,27
FK Rubin,3395,8,5,6,9,21,18,3,21
Rostov,3395,9,4,7,9,11,18,-7,19
Amkar,3395,10,5,4,11,13,27,-14,19
Anzhi,3395,11,2,5,13,14,42,-28,11
Loko Moscow,3396,1,11,6,3,30,14,16,39
Spart Moscow,3396,2,11,5,4,38,26,12,38
CSKA Moscow,3396,3,11,3,6,27,19,8,36
Zenit,3396,4,9,8,3,25,13,12,35
Krasnodar,3396,5,8,5,7,28,26,2,29
FK Rubin,3396,6,7,5,8,24,17,7,26
Terek Grozny,3396,7,7,5,8,21,26,-5,26
Din Moscow,3396,8,5,6,9,17,24,-7,21
Amkar,3396,9,5,4,11,11,24,-13,19
Rostov,3396,10,4,6,10,10,19,-9,18
Anzhi,3396,11,3,5,12,17,40,-23,14
Loko Moscow,3397,1,13,5,2,33,11,22,44
CSKA Moscow,3397,2,11,3,6,30,21,9,36
Spart Moscow,3397,3,10,5,5,40,31,9,35
Zenit,3397,4,8,8,4,23,17,6,32
Krasnodar,3397,5,9,4,7,28,25,3,31
Terek Grozny,3397,6,7,6,7,21,24,-3,27
Din Moscow,3397,7,5,7,8,17,22,-5,22
FK Rubin,3397,8,5,6,9,21,18,3,21
Amkar,3397,9,5,5,10,14,25,-11,20
Rostov,3397,10,4,6,10,12,21,-9,18
Anzhi,3397,11,3,5,12,17,41,-24,14
Loko Moscow,3398,1,11,5,4,29,14,15,38
CSKA Moscow,3398,2,11,4,5,28,19,9,37
Spart Moscow,3398,3,10,5,5,37,32,5,35
Krasnodar,3398,4,10,4,6,32,25,7,34
Zenit,3398,5,8,9,3,24,15,9,33
Terek Grozny,3398,6,7,6,7,20,24,-4,27
Din Moscow,3398,7,6,6,8,25,25,0,24
FK Rubin,3398,8,6,5,9,25,22,3,23
Rostov,3398,9,4,6,10,10,18,-8,18
Amkar,3398,10,4,5,11,10,24,-14,17
Anzhi,3398,11,3,5,12,16,38,-22,14
Loko Moscow,3399,1,12,5,3,31,14,17,41
CSKA Moscow,3399,2,11,3,6,28,20,8,36
Spart Moscow,3399,3,9,7,4,39,28,11,34
Zenit,3399,4,8,8,4,22,14,8,32
Krasnodar,3399,5,9,4,7,30,27,3,31
Terek Grozny,3399,6,7,6,7,21,24,-3,27
FK Rubin,3399,7,7,5,8,27,17,10,26
Din Moscow,3399,8,5,6,9,17,28,-11,21
Amkar,3399,9,5,5,10,11,23,-12,20
Rostov,3399,10,4,7,9,12,19,-7,19
Anzhi,3399,11,2,6,12,17,41,-24,12
Loko Moscow,3400,1,11,5,4,32,17,15,38
Spart Moscow,3400,2,10,6,4,38,27,11,36
CSKA Moscow,3400,3,11,3,6,26,18,8,36
Zenit,3400,4,9,8,3,25,14,11,35
Krasnodar,3400,5,9,5,6,30,26,4,32
Terek Grozny,3400,6,9,5,6,23,22,1,32
FK Rubin,3400,7,6,6,8,22,17,5,24
Din Moscow,3400,8,5,6,9,17,24,-7,21
Rostov,3400,9,4,6,10,11,19,-8,18
Amkar,3400,10,4,5,11,10,25,-15,17
Anzhi,3400,11,2,5,13,14,39,-25,11
Loko Moscow,3401,1,12,6,2,33,12,21,42
CSKA Moscow,3401,2,11,3,6,26,18,8,36
Spart Moscow,3401,3,9,6,5,38,29,9,33
Zenit,3401,4,8,9,3,23,14,9,33
Terek Grozny,3401,5,8,6,6,22,23,-1,30
Krasnodar,3401,6,8,4,8,27,30,-3,28
FK Rubin,3401,7,6,6,8,25,18,7,24
Din Moscow,3401,8,5,8,7,19,23,-4,23
Amkar,3401,9,5,5,10,12,23,-11,20
Rostov,3401,10,4,6,10,11,21,-10,18
Anzhi,3401,11,2,5,13,14,39,-25,11
Loko Moscow,3402,1,12,5,3,31,13,18,41
CSKA Moscow,3402,2,11,3,6,26,19,7,36
Zenit,3402,3,9,8,3,25,13,12,35
Spart Moscow,3402,4,10,5,5,39,28,11,35
Krasnodar,3402,5,8,4,8,29,29,0,28
Terek Grozny,3402,6,7,7,6,23,25,-2,28
FK Rubin,3402,7,7,5,8,25,19,6,26
Rostov,3402,8,5,6,9,13,18,-5,21
Din Moscow,3402,9,5,6,9,17,26,-9,21
Amkar,3402,10,4,5,11,10,24,-14,17
Anzhi,3402,11,2,6,12,16,40,-24,12
Loko Moscow,3403,1,12,5,3,31,13,18,41
Spart Moscow,3403,2,11,5,4,41,29,12,38
CSKA Moscow,3403,3,11,3,6,28,20,8,36
Zenit,3403,4,9,8,3,25,15,10,35
Krasnodar,3403,5,8,5,7,28,26,2,29
Terek Grozny,3403,6,7,7,6,21,23,-2,28
FK Rubin,3403,7,5,7,8,22,18,4,22
Din Moscow,3403,8,5,7,8,17,22,-5,22
Rostov,3403,9,4,6,10,11,19,-8,18
Amkar,3403,10,4,5,11,13,28,-15,17
Anzhi,3403,11,2,6,12,15,39,-24,12
Loko Moscow,3404,1,13,5,2,36,16,20,44
CSKA Moscow,3404,2,12,3,5,29,17,12,39
Krasnodar,3404,3,9,4,7,33,30,3,31
Zenit,3404,4,7,8,5,22,16,6,29
Spart Moscow,3404,5,8,5,7,34,30,4,29
Terek Grozny,3404,6,7,6,7,22,25,-3,27
Din Moscow,3404,7,6,6,8,18,23,-5,24
FK Rubin,3404,8,6,5,9,24,19,5,23
Amkar,3404,9,6,4,10,14,24,-10,22
Rostov,3404,10,5,6,9,11,17,-6,21
Anzhi,3404,11,2,6,12,15,41,-26,12
Loko Moscow,3405,1,12,6,2,32,13,19,42
CSKA Moscow,3405,2,11,4,5,28,18,10,37
Spart Moscow,3405,3,10,5,5,40,28,12,35
Zenit,3405,4,7,9,4,23,17,6,30
Krasnodar,3405,5,8,5,7,28,26,2,29
Terek Grozny,3405,6,8,5,7,21,23,-2,29
FK Rubin,3405,7,6,6,8,22,17,5,24
Amkar,3405,8,6,4,10,12,22,-10,22
Din Moscow,3405,9,5,6,9,18,27,-9,21
Rostov,3405,10,4,6,10,10,19,-9,18
Anzhi,3405,11,2,6,12,14,38,-24,12
Loko Moscow,3406,1,12,5,3,31,15,16,41
Spart Moscow,3406,2,11,5,4,45,26,19,38
CSKA Moscow,3406,3,10,5,5,26,18,8,35
Zenit,3406,4,8,9,3,25,14,11,33
Krasnodar,3406,5,9,4,7,30,27,3,31
Terek Grozny,3406,6,7,6,7,22,26,-4,27
FK Rubin,3406,7,6,5,9,24,20,4,23
Din Moscow,3406,8,5,6,9,18,27,-9,21
Amkar,3406,9,5,4,11,12,29,-17,19
Rostov,3406,10,4,6,10,11,19,-8,18
Anzhi,3406,11,2,7,11,15,38,-23,13
Loko Moscow,3407,1,11,7,2,31,13,18,40
Spart Moscow,3407,2,10,6,4,40,25,15,36
CSKA Moscow,3407,3,10,5,5,26,18,8,35
Krasnodar,3407,4,9,5,6,34,26,8,32
Zenit,3407,5,7,10,3,22,14,8,31
Terek Grozny,3407,6,8,5,7,21,24,-3,29
Din Moscow,3407,7,5,7,8,19,27,-8,22
FK Rubin,3407,8,5,6,9,24,25,-1,21
Rostov,3407,9,4,6,10,10,20,-10,18
Amkar,3407,10,4,5,11,9,23,-14,17
Anzhi,3407,11,3,6,11,17,38,-21,15
Loko Moscow,3408,1,11,7,2,31,13,18,40
CSKA Moscow,3408,2,11,4,5,32,19,13,37
Spart Moscow,3408,3,10,6,4,36,25,11,36
Krasnodar,3408,4,9,5,6,31,26,5,32
Terek Grozny,3408,5,9,5,6,23,22,1,32
Zenit,3408,6,7,10,3,23,15,8,31
FK Rubin,3408,7,6,5,9,25,21,4,23
Din Moscow,3408,8,5,6,9,18,26,-8,21
Rostov,3408,9,4,7,9,10,17,-7,19
Amkar,3408,10,4,4,12,9,24,-15,16
Anzhi,3408,11,2,5,13,15,45,-30,11
Loko Moscow,3409,1,12,6,2,31,11,20,42
CSKA Moscow,3409,2,11,4,5,27,17,10,37
Spart Moscow,3409,3,10,6,4,38,25,13,36
Zenit,3409,4,7,10,3,21,13,8,31
Krasnodar,3409,5,9,4,7,28,26,2,31
Terek Grozny,3409,6,7,7,6,22,24,-2,28
Din Moscow,3409,7,5,8,7,17,21,-4,23
FK Rubin,3409,8,5,6,9,21,18,3,21
Rostov,3409,9,4,6,10,10,19,-9,18
Amkar,3409,10,4,5,11,11,27,-16,17
Anzhi,3409,11,2,6,12,14,39,-25,12
Loko Moscow,3410,1,11,7,2,30,12,18,40
CSKA Moscow,3410,2,11,4,5,29,19,10,37
Spart Moscow,3410,3,10,6,4,39,26,13,36
Krasnodar,3410,4,9,5,6,29,25,4,32
Zenit,3410,5,7,9,4,21,15,6,30
Terek Grozny,3410,6,8,6,6,24,25,-1,30
FK Rubin,3410,7,6,5,9,22,18,4,23
Din Moscow,3410,8,5,6,9,18,26,-8,21
Rostov,3410,9,4,6,10,10,19,-9,18
Amkar,3410,10,4,5,11,11,25,-14,17
Anzhi,3410,11,2,7,11,17,40,-23,13
Loko Moscow,3411,1,12,5,3,33,15,18,41
Spart Moscow,3411,2,11,5,4,37,25,12,38
CSKA Moscow,3411,3,11,4,5,28,18,10,37
Zenit,3411,4,8,9,3,25,16,9,33
Krasnodar,3411,5,9,4,7,30,27,3,31
Terek Grozny,3411,6,8,6,6,22,23,-1,30
Din Moscow,3411,7,6,6,8,20,23,-3,24
FK Rubin,3411,8,5,5,10,23,22,1,20
Rostov,3411,9,4,6,10,10,19,-9,18
Amkar,3411,10,4,4,12,9,24,-15,16
Anzhi,3411,11,2,6,12,15,40,-25,12
Loko Moscow,3412,1,13,5,2,34,11,23,44
Spart Moscow,3412,2,11,5,4,40,28,12,38
CSKA Moscow,3412,3,10,4,6,26,19,7,34
Zenit,3412,4,8,8,4,22,17,5,32
Krasnodar,3412,5,9,4,7,29,26,3,31
Terek Grozny,3412,6,7,6,7,22,26,-4,27
Din Moscow,3412,7,6,6,8,20,23,-3,24
FK Rubin,3412,8,5,5,10,22,21,1,20
Amkar,3412,9,5,4,11,13,25,-12,19
Rostov,3412,10,4,6,10,10,19,-9,18
Anzhi,3412,11,2,7,11,17,40,-23,13
Loko Moscow,3413,1,12,5,3,32,14,18,41
CSKA Moscow,3413,2,11,3,6,28,18,10,36
Spart Moscow,3413,3,9,6,5,38,29,9,33
Zenit,3413,4,8,8,4,23,16,7,32
Krasnodar,3413,5,9,5,6,31,26,5,32
Terek Grozny,3413,6,8,6,6,22,22,0,30
FK Rubin,3413,7,6,6,8,25,19,6,24
Din Moscow,3413,8,6,6,8,18,23,-5,24
Rostov,3413,9,4,6,10,11,20,-9,18
Amkar,3413,10,4,5,11,11,26,-15,17
Anzhi,3413,11,2,6,12,14,40,-26,12
Loko Moscow,3414,1,12,5,3,32,15,17,41
CSKA Moscow,3414,2,11,4,5,27,18,9,37
Spart Moscow,3414,3,10,6,4,40,29,11,36
Krasnodar,3414,4,9,5,6,31,26,5,32
Zenit,3414,5,7,9,4,23,16,7,30
Terek Grozny,3414,6,8,5,7,22,25,-3,29
FK Rubin,3414,7,6,6,8,23,18,5,24
Din Moscow,3414,8,5,7,8,17,22,-5,22
Rostov,3414,9,4,6,10,13,21,-8,18
Amkar,3414,10,4,4,12,10,26,-16,16
Anzhi,3414,11,3,5,12,17,39,-22,14
Loko Moscow,3415,1,13,5,2,34,12,22,44
CSKA Moscow,3415,2,11,4,5,28,19,9,37
Spart Moscow,3415,3,10,5,5,38,28,10,35
Zenit,3415,4,7,8,5,21,17,4,29
Krasnodar,3415,5,8,4,8,28,28,0,28
Terek Grozny,3415,6,7,5,8,21,26,-5,26
Din Moscow,3415,7,6,7,7,18,21,-3,25
FK Rubin,3415,8,6,6,8,23,17,6,24
Amkar,3415,9,5,4,11,12,25,-13,19
Rostov,3415,10,4,6,10,11,19,-8,18
Anzhi,3415,11,3,6,11,18,40,-22,15
Loko Moscow,3416,1,12,6,2,34,13,21,42
Spart Moscow,3416,2,11,5,4,44,25,19,38
CSKA Moscow,3416,3,10,4,6,26,20,6,34
Zenit,3416,4,8,8,4,23,16,7,32
Krasnodar,3416,5,8,6,6,30,27,3,30
Terek Grozny,3416,6,7,6,7,22,25,-3,27
FK Rubin,3416,7,5,7,8,23,19,4,22
Din Moscow,3416,8,5,7,8,18,23,-5,22
Amkar,3416,9,5,4,11,11,25,-14,19
Rostov,3416,10,4,6,10,10,25,-15,18
Anzhi,3416,11,2,7,11,16,39,-23,13
Loko Moscow,3417,1,12,5,3,31,14,17,41
CSKA Moscow,3417,2,11,4,5,28,18,10,37
Zenit,3417,3,8,9,3,25,14,11,33
Krasnodar,3417,4,9,4,7,29,27,2,31
Spart Moscow,3417,5,8,6,6,36,30,6,30
Din Moscow,3417,6,7,6,7,22,23,-1,27
Terek Grozny,3417,7,7,6,7,21,25,-4,27
Rostov,3417,8,5,6,9,12,18,-6,21
FK Rubin,3417,9,5,5,10,23,22,1,20
Amkar,3417,10,5,5,10,12,23,-11,20
Anzhi,3417,11,2,6,12,15,40,-25,12
Loko Moscow,3418,1,12,5,3,31,13,18,41
CSKA Moscow,3418,2,11,4,5,28,18,10,37
Zenit,3418,3,8,9,3,22,13,9,33
Spart Moscow,3418,4,9,6,5,40,32,8,33
Terek Grozny,3418,5,8,6,6,22,23,-1,30
Krasnodar,3418,6,8,4,8,28,27,1,28
FK Rubin,3418,7,7,5,8,23,17,6,26
Din Moscow,3418,8,6,6,8,20,23,-3,24
Rostov,3418,9,4,7,9,11,18,-7,19
Amkar,3418,10,4,4,12,13,29,-16,16
Anzhi,3418,11,2,6,12,15,40,-25,12
Loko Moscow,3419,1,13,5,2,37,11,26,44
CSKA Moscow,3419,2,12,3,5,32,17,15,39
Spart Moscow,3419,3,11,5,4,41,29,12,38
Zenit,3419,4,7,8,5,21,20,1,29
Krasnodar,3419,5,8,4,8,27,27,0,28
FK Rubin,3419,6,7,5,8,24,18,6,26
Terek Grozny,3419,7,7,5,8,21,26,-5,26
Din Moscow,3419,8,5,6,9,20,27,-7,21
Amkar,3419,9,5,4,11,12,25,-13,19
Rostov,3419,10,4,6,10,11,19,-8,18
Anzhi,3419,11,3,5,12,16,43,-27,14
Loko Moscow,3420,1,11,6,3,31,14,17,39
CSKA Moscow,3420,2,10,5,5,27,19,8,35
Krasnodar,3420,3,10,4,6,31,25,6,34
Zenit,3420,4,7,10,3,22,14,8,31
Spart Moscow,3420,5,8,6,6,35,31,4,30
Terek Grozny,3420,6,8,6,6,22,23,-1,30
Din Moscow,3420,7,6,6,8,20,24,-4,24
FK Rubin,3420,8,6,5,9,23,19,4,23
Rostov,3420,9,4,7,9,11,18,-7,19
Amkar,3420,10,5,4,11,11,23,-12,19
Anzhi,3420,11,2,7,11,17,40,-23,13
Loko Moscow,3421,1,13,5,2,35,12,23,44
CSKA Moscow,3421,2,11,3,6,27,20,7,36
Zenit,3421,3,8,8,4,23,15,8,32
Spart Moscow,3421,4,9,5,6,34,29,5,32
Krasnodar,3421,5,9,4,7,29,28,1,31
Terek Grozny,3421,6,8,5,7,25,26,-1,29
Din Moscow,3421,7,6,7,7,19,22,-3,25
FK Rubin,3421,8,5,6,9,22,19,3,21
Amkar,3421,9,5,4,11,14,26,-12,19
Rostov,3421,10,4,6,10,10,18,-8,18
Anzhi,3421,11,3,5,12,17,40,-23,14
Loko Moscow,3422,1,11,7,2,29,11,18,40
CSKA Moscow,3422,2,10,4,6,27,22,5,34
Zenit,3422,3,8,9,3,25,14,11,33
Spart Moscow,3422,4,8,6,6,36,30,6,30
Krasnodar,3422,5,8,6,6,28,25,3,30
Terek Grozny,3422,6,8,5,7,22,24,-2,29
Din Moscow,3422,7,7,6,7,21,22,-1,27
Amkar,3422,8,6,4,10,12,23,-11,22
FK Rubin,3422,9,5,6,9,22,20,2,21
Rostov,3422,10,4,7,9,12,19,-7,19
Anzhi,3422,11,2,6,12,15,39,-24,12
Loko Moscow,3423,1,12,6,2,31,11,20,42
Spart Moscow,3423,2,11,5,4,41,29,12,38
CSKA Moscow,3423,3,11,3,6,28,21,7,36
Zenit,3423,4,7,9,4,22,15,7,30
Krasnodar,3423,5,8,4,8,29,29,0,28
Terek Grozny,3423,6,7,6,7,21,24,-3,27
FK Rubin,3423,7,7,5,8,27,19,8,26
Din Moscow,3423,8,5,6,9,19,27,-8,21
Rostov,3423,9,4,6,10,10,19,-9,18
Amkar,3423,10,4,5,11,11,25,-14,17
Anzhi,3423,11,4,5,11,19,39,-20,17
Loko Moscow,3424,1,11,6,3,32,15,17,39
Spart Moscow,3424,2,10,5,5,42,28,14,35
CSKA Moscow,3424,3,10,4,6,26,22,4,34
Zenit,3424,4,8,9,3,26,14,12,33
Krasnodar,3424,5,9,5,6,31,27,4,32
Terek Grozny,3424,6,8,6,6,25,26,-1,30
FK Rubin,3424,7,6,6,8,24,18,6,24
Din Moscow,3424,8,6,6,8,19,24,-5,24
Rostov,3424,9,4,6,10,10,21,-11,18
Amkar,3424,10,4,4,12,11,28,-17,16
Anzhi,3424,11,2,7,11,18,41,-23,13
Loko Moscow,3425,1,11,5,4,30,17,13,38
Spart Moscow,3425,2,10,6,4,38,27,11,36
Zenit,3425,3,9,8,3,25,15,10,35
Krasnodar,3425,4,10,4,6,33,25,8,34
CSKA Moscow,3425,5,10,4,6,27,20,7,34
Terek Grozny,3425,6,7,6,7,21,24,-3,27
Din Moscow,3425,7,6,6,8,19,24,-5,24
FK Rubin,3425,8,5,5,10,22,20,2,20
Amkar,3425,9,5,5,10,11,23,-12,20
Rostov,3425,10,4,6,10,10,18,-8,18
Anzhi,3425,11,2,7,11,16,39,-23,13
Loko Moscow,3426,1,11,5,4,30,15,15,38
CSKA Moscow,3426,2,11,4,5,28,19,9,37
Zenit,3426,3,8,9,3,24,14,10,33
Spart Moscow,3426,4,9,5,6,36,30,6,32
Krasnodar,3426,5,9,5,6,30,26,4,32
Terek Grozny,3426,6,7,7,6,23,25,-2,28
Din Moscow,3426,7,6,6,8,20,23,-3,24
FK Rubin,3426,8,5,6,9,22,20,2,21
Rostov,3426,9,5,6,9,13,18,-5,21
Amkar,3426,10,5,5,10,12,24,-12,20
Anzhi,3426,11,2,6,12,16,40,-24,12
Loko Moscow,3427,1,11,7,2,33,15,18,40
CSKA Moscow,3427,2,11,3,6,27,19,8,36
Spart Moscow,3427,3,10,5,5,36,28,8,35
Zenit,3427,4,8,9,3,25,15,10,33
Krasnodar,3427,5,9,5,6,32,26,6,32
Terek Grozny,3427,6,7,6,7,22,25,-3,27
Din Moscow,3427,7,6,6,8,19,22,-3,24
Rostov,3427,8,5,6,9,12,17,-5,21
FK Rubin,3427,9,5,5,10,21,22,-1,20
Amkar,3427,10,4,5,11,11,25,-14,17
Anzhi,3427,11,3,5,12,16,40,-24,14
Loko Moscow,3428,1,12,6,2,33,14,19,42
CSKA Moscow,3428,2,11,3,6,28,20,8,36
Zenit,3428,3,8,8,4,23,15,8,32
Spart Moscow,3428,4,9,5,6,35,29,6,32
Terek Grozny,3428,5,9,5,6,25,24,1,32
Krasnodar,3428,6,8,5,7,30,28,2,29
FK Rubin,3428,7,7,5,8,24,18,6,26
Din Moscow,3428,8,6,6,8,20,23,-3,24
Amkar,3428,9,5,4,11,10,23,-13,19
Rostov,3428,10,4,6,10,10,18,-8,18
Anzhi,3428,11,2,5,13,18,44,-26,11
Loko Moscow,3429,1,11,6,3,31,17,14,39
CSKA Moscow,3429,2,11,3,6,28,19,9,36
Spart Moscow,3429,3,9,7,4,37,27,10,34
Zenit,3429,4,8,9,3,24,15,9,33
Krasnodar,3429,5,9,4,7,32,26,6,31
FK Rubin,3429,6,7,5,8,24,18,6,26
Terek Grozny,3429,7,7,5,8,22,26,-4,26
Din Moscow,3429,8,5,6,9,18,25,-7,21
Amkar,3429,9,5,5,10,13,25,-12,20
Rostov,3429,10,4,7,9,10,17,-7,19
Anzhi,3429,11,3,5,12,16,40,-24,14
Loko Moscow,3430,1,12,5,3,32,13,19,41
CSKA Moscow,3430,2,11,4,5,32,18,14,37
Zenit,3430,3,8,9,3,24,15,9,33
Spart Moscow,3430,4,9,5,6,39,30,9,32
Krasnodar,3430,5,8,4,8,27,28,-1,28
Terek Grozny,3430,6,7,7,6,21,23,-2,28
Din Moscow,3430,7,7,6,7,23,24,-1,27
FK Rubin,3430,8,6,5,9,25,20,5,23
Rostov,3430,9,5,6,9,11,17,-6,21
Amkar,3430,10,4,5,11,10,27,-17,17
Anzhi,3430,11,2,6,12,15,44,-29,12
Loko Moscow,3431,1,12,5,3,32,13,19,41
CSKA Moscow,3431,2,11,3,6,28,19,9,36
Krasnodar,3431,3,10,4,6,30,25,5,34
Spart Moscow,3431,4,9,6,5,38,31,7,33
Zenit,3431,5,8,8,4,23,16,7,32
Terek Grozny,3431,6,8,5,7,23,25,-2,29
Din Moscow,3431,7,6,7,7,19,22,-3,25
Rostov,3431,8,5,6,9,14,19,-5,21
FK Rubin,3431,9,5,5,10,21,19,2,20
Amkar,3431,10,5,4,11,13,26,-13,19
Anzhi,3431,11,2,5,13,14,40,-26,11
Loko Moscow,3432,1,12,5,3,30,12,18,41
CSKA Moscow,3432,2,11,3,6,28,19,9,36
Spart Moscow,3432,3,9,6,5,35,28,7,33
Zenit,3432,4,8,8,4,23,14,9,32
Krasnodar,3432,5,9,5,6,29,25,4,32
Terek Grozny,3432,6,8,6,6,24,24,0,30
Din Moscow,3432,7,6,7,7,18,21,-3,25
FK Rubin,3432,8,5,6,9,22,19,3,21
Amkar,3432,9,5,5,10,13,23,-10,20
Rostov,3432,10,4,6,10,10,19,-9,18
Anzhi,3432,11,2,5,13,15,43,-28,11
Loko Moscow,3433,1,11,6,3,29,12,17,39
Spart Moscow,3433,2,11,5,4,40,26,14,38
CSKA Moscow,3433,3,11,3,6,27,20,7,36
Krasnodar,3433,4,10,4,6,29,24,5,34
Zenit,3433,5,8,9,3,24,13,11,33
Terek Grozny,3433,6,8,6,6,25,24,1,30
FK Rubin,3433,7,6,5,9,24,18,6,23
Din Moscow,3433,8,5,6,9,18,26,-8,21
Rostov,3433,9,4,6,10,10,19,-9,18
Amkar,3433,10,4,4,12,9,28,-19,16
Anzhi,3433,11,2,6,12,16,41,-25,12
Loko Moscow,3434,1,12,6,2,34,13,21,42
CSKA Moscow,3434,2,11,3,6,29,22,7,36
Spart Moscow,3434,3,10,5,5,37,26,11,35
Zenit,3434,4,8,8,4,26,18,8,32
Krasnodar,3434,5,9,5,6,33,26,7,32
Terek Grozny,3434,6,8,5,7,24,24,0,29
Din Moscow,3434,7,6,6,8,18,24,-6,24
Amkar,3434,8,6,4,10,12,22,-10,22
FK Rubin,3434,9,5,5,10,21,22,-1,20
Rostov,3434,10,4,6,10,10,18,-8,18
Anzhi,3434,11,2,5,13,14,43,-29,11
Loko Moscow,3435,1,13,5,2,34,14,20,44
CSKA Moscow,3435,2,10,5,5,26,18,8,35
Spart Moscow,3435,3,9,6,5,40,30,10,33
Zenit,3435,4,7,9,4,22,15,7,30
Krasnodar,3435,5,8,4,8,30,31,-1,28
Terek Grozny,3435,6,7,7,6,22,24,-2,28
Din Moscow,3435,7,6,6,8,20,26,-6,24
FK Rubin,3435,8,6,5,9,25,19,6,23
Amkar,3435,9,5,5,10,13,25,-12,20
Rostov,3435,10,4,7,9,10,17,-7,19
Anzhi,3435,11,2,7,11,16,39,-23,13
Loko Moscow,3436,1,11,6,3,30,13,17,39
CSKA Moscow,3436,2,11,4,5,27,18,9,37
Zenit,3436,3,8,9,3,23,14,9,33
Spart Moscow,3436,4,9,6,5,35,27,8,33
Krasnodar,3436,5,9,5,6,32,25,7,32
Terek Grozny,3436,6,7,6,7,20,26,-6,27
Din Moscow,3436,7,6,7,7,19,22,-3,25
FK Rubin,3436,8,5,6,9,22,22,0,21
Rostov,3436,9,4,7,9,10,17,-7,19
Amkar,3436,10,4,5,11,10,24,-14,17
Anzhi,3436,11,3,5,12,18,38,-20,14
Loko Moscow,3437,1,11,6,3,29,15,14,39
CSKA Moscow,3437,2,11,3,6,27,19,8,36
Krasnodar,3437,3,10,4,6,33,24,9,34
Zenit,3437,4,8,9,3,22,13,9,33
Spart Moscow,3437,5,8,6,6,38,32,6,30
Terek Grozny,3437,6,8,5,7,21,23,-2,29
Din Moscow,3437,7,5,8,7,20,24,-4,23
FK Rubin,3437,8,5,6,9,22,20,2,21
Rostov,3437,9,5,6,9,12,18,-6,21
Amkar,3437,10,5,4,11,12,25,-13,19
Anzhi,3437,11,3,5,12,16,39,-23,14
Loko Moscow,3438,1,11,6,3,30,13,17,39
CSKA Moscow,3438,2,11,3,6,27,18,9,36
Spart Moscow,3438,3,9,6,5,39,28,11,33
Zenit,3438,4,8,9,3,23,14,9,33
Krasnodar,3438,5,9,5,6,29,25,4,32
Terek Grozny,3438,6,7,5,8,20,25,-5,26
FK Rubin,3438,7,6,6,8,24,19,5,24
Din Moscow,3438,8,5,7,8,20,25,-5,22
Amkar,3438,9,6,4,10,12,22,-10,22
Rostov,3438,10,4,6,10,10,21,-11,18
Anzhi,3438,11,3,5,12,15,39,-24,14
Loko Moscow,3439,1,12,5,3,32,14,18,41
CSKA Moscow,3439,2,10,5,5,28,20,8,35
Krasnodar,3439,3,10,4,6,35,28,7,34
Spart Moscow,3439,4,9,6,5,37,27,10,33
Zenit,3439,5,7,9,4,22,15,7,30
Terek Grozny,3439,6,8,5,7,21,24,-3,29
Din Moscow,3439,7,6,7,7,19,22,-3,25
FK Rubin,3439,8,5,6,9,24,23,1,21
Rostov,3439,9,4,6,10,10,20,-10,18
Amkar,3439,10,4,5,11,10,24,-14,17
Anzhi,3439,11,3,6,11,18,39,-21,15
Loko Moscow,3440,1,12,6,2,31,12,19,42
CSKA Moscow,3440,2,11,3,6,29,18,11,36
Spart Moscow,3440,3,9,7,4,37,28,9,34
Zenit,3440,4,8,8,4,22,14,8,32
Terek Grozny,3440,5,8,6,6,22,22,0,30
Krasnodar,3440,6,8,5,7,28,26,2,29
FK Rubin,3440,7,7,5,8,26,17,9,26
Din Moscow,3440,8,5,7,8,19,27,-8,22
Rostov,3440,9,4,7,9,10,17,-7,19
Amkar,3440,10,4,5,11,10,24,-14,17
Anzhi,3440,11,2,5,13,14,43,-29,11
Loko Moscow,3441,1,12,5,3,32,14,18,41
CSKA Moscow,3441,2,11,3,6,28,20,8,36
Zenit,3441,3,9,8,3,24,13,11,35
Spart Moscow,3441,4,8,6,6,35,29,6,30
Terek Grozny,3441,5,8,6,6,21,22,-1,30
Krasnodar,3441,6,8,5,7,30,28,2,29
FK Rubin,3441,7,6,6,8,26,18,8,24
Din Moscow,3441,8,5,7,8,17,25,-8,22
Rostov,3441,9,5,6,9,12,18,-6,21
Amkar,3441,10,5,5,10,11,23,-12,20
Anzhi,3441,11,2,5,13,15,41,-26,11
Loko Moscow,3442,1,12,6,2,32,13,19,42
CSKA Moscow,3442,2,11,3,6,31,19,12,36
Zenit,3442,3,8,9,3,23,13,10,33
Spart Moscow,3442,4,9,6,5,35,28,7,33
Krasnodar,3442,5,8,5,7,29,27,2,29
Terek Grozny,3442,6,7,6,7,21,24,-3,27
Din Moscow,3442,7,6,7,7,18,21,-3,25
FK Rubin,3442,8,5,6,9,21,18,3,21
Amkar,3442,9,5,5,10,12,22,-10,20
Rostov,3442,10,4,6,10,10,19,-9,18
Anzhi,3442,11,3,5,12,16,44,-28,14
Loko Moscow,3443,1,11,6,3,31,14,17,39
Zenit,3443,2,9,8,3,23,13,10,35
Spart Moscow,3443,3,9,7,4,37,27,10,34
CSKA Moscow,3443,4,10,4,6,25,18,7,34
Krasnodar,3443,5,9,5,6,30,26,4,32
Terek Grozny,3443,6,7,5,8,21,26,-5,26
FK Rubin,3443,7,6,5,9,23,18,5,23
Din Moscow,3443,8,5,7,8,18,24,-6,22
Amkar,3443,9,5,5,10,12,23,-11,20
Rostov,3443,10,4,6,10,10,19,-9,18
Anzhi,3443,11,3,6,11,16,38,-22,15
Loko Moscow,3444,1,12,5,3,31,13,18,41
CSKA Moscow,3444,2,11,3,6,27,18,9,36
Zenit,3444,3,8,8,4,23,15,8,32
Spart Moscow,3444,4,9,5,6,38,31,7,32
Krasnodar,3444,5,9,4,7,28,26,2,31
Terek Grozny,3444,6,8,5,7,21,25,-4,29
Din Moscow,3444,7,7,6,7,22,22,0,27
FK Rubin,3444,8,5,5,10,21,21,0,20
Amkar,3444,9,5,4,11,12,24,-12,19
Rostov,3444,10,4,6,10,11,20,-9,18
Anzhi,3444,11,4,5,11,18,37,-19,17
Loko Moscow,3445,1,11,6,3,29,12,17,39
Spart Moscow,3445,2,11,5,4,36,25,11,38
Zenit,3445,3,9,8,3,24,13,11,35
CSKA Moscow,3445,4,10,4,6,26,20,6,34
Krasnodar,3445,5,9,5,6,29,25,4,32
Terek Grozny,3445,6,8,5,7,21,23,-2,29
Din Moscow,3445,7,5,7,8,17,22,-5,22
FK Rubin,3445,8,5,6,9,22,19,3,21
Amkar,3445,9,5,4,11,10,23,-13,19
Rostov,3445,10,4,6,10,10,18,-8,18
Anzhi,3445,11,2,6,12,15,39,-24,12
Loko Moscow,3446,1,12,5,3,30,12,18,41
CSKA Moscow,3446,2,11,4,5,29,20,9,37
Spart Moscow,3446,3,9,5,6,38,31,7,32
Krasnodar,3446,4,9,5,6,29,25,4,32
Zenit,3446,5,7,8,5,23,17,6,29
Terek Grozny,3446,6,7,6,7,21,24,-3,27
Din Moscow,3446,7,6,7,7,23,26,-3,25
FK Rubin,3446,8,5,7,8,24,20,4,22
Amkar,3446,9,6,4,10,13,24,-11,22
Rostov,3446,10,4,6,10,10,18,-8,18
Anzhi,3446,11,2,7,11,15,38,-23,13
Loko Moscow,3447,1,12,6,2,31,11,20,42
CSKA Moscow,3447,2,12,3,5,29,18,11,39
Spart Moscow,3447,3,11,5,4,39,27,12,38
Krasnodar,3447,4,9,5,6,30,24,6,32
Terek Grozny,3447,5,8,6,6,22,23,-1,30
Zenit,3447,6,7,8,5,22,18,4,29
Din Moscow,3447,7,6,6,8,19,24,-5,24
FK Rubin,3447,8,5,5,10,22,22,0,20
Rostov,3447,9,4,6,10,10,18,-8,18
Amkar,3447,10,4,4,12,11,26,-15,16
Anzhi,3447,11,2,6,12,15,39,-24,12
Loko Moscow,3448,1,11,6,3,31,14,17,39
CSKA Moscow,3448,2,12,3,5,33,18,15,39
Spart Moscow,3448,3,9,5,6,38,31,7,32
Zenit,3448,4,8,8,4,23,16,7,32
Krasnodar,3448,5,9,5,6,32,26,6,32
Din Moscow,3448,6,7,6,7,23,25,-2,27
Terek Grozny,3448,7,7,6,7,21,25,-4,27
FK Rubin,3448,8,5,5,10,22,22,0,20
Amkar,3448,9,5,5,10,11,23,-12,20
Rostov,3448,10,4,6,10,10,18,-8,18
Anzhi,3448,11,3,5,12,17,43,-26,14
Loko Moscow,3449,1,11,7,2,31,13,18,40
CSKA Moscow,3449,2,11,4,5,28,18,10,37
Spart Moscow,3449,3,10,6,4,39,27,12,36
Krasnodar,3449,4,9,5,6,34,28,6,32
Zenit,3449,5,7,10,3,22,14,8,31
Terek Grozny,3449,6,7,6,7,20,24,-4,27
Din Moscow,3449,7,5,8,7,18,22,-4,23
FK Rubin,3449,8,5,6,9,23,22,1,21
Rostov,3449,9,4,6,10,11,20,-9,18
Amkar,3449,10,4,5,11,9,24,-15,17
Anzhi,3449,11,3,5,12,16,39,-23,14
Loko Moscow,3450,1,11,5,4,30,14,16,38
CSKA Moscow,3450,2,11,4,5,28,19,9,37
Krasnodar,3450,3,10,4,6,30,25,5,34
Zenit,3450,4,8,9,3,23,14,9,33
Spart Moscow,3450,5,9,5,6,36,28,8,32
Terek Grozny,3450,6,8,6,6,25,26,-1,30
Din Moscow,3450,7,6,6,8,18,23,-5,24
Rostov,3450,8,5,6,9,11,17,-6,21
FK Rubin,3450,9,5,5,10,22,20,2,20
Amkar,3450,10,5,5,10,13,25,-12,20
Anzhi,3450,11,2,5,13,18,43,-25,11
Loko Moscow,3451,1,12,6,2,33,14,19,42
CSKA Moscow,3451,2,11,4,5,30,19,11,37
Spart Moscow,3451,3,10,5,5,37,27,10,35
Zenit,3451,4,7,9,4,24,17,7,30
Krasnodar,3451,5,8,6,6,30,27,3,30
Terek Grozny,3451,6,8,6,6,22,23,-1,30
Din Moscow,3451,7,7,6,7,19,21,-2,27
FK Rubin,3451,8,5,6,9,22,19,3,21
Rostov,3451,9,4,6,10,10,19,-9,18
Amkar,3451,10,4,4,12,11,26,-15,16
Anzhi,3451,11,2,6,12,14,40,-26,12
Loko Moscow,3452,1,11,7,2,33,15,18,40
CSKA Moscow,3452,2,12,3,5,32,19,13,39
Spart Moscow,3452,3,9,6,5,38,31,7,33
Krasnodar,3452,4,9,5,6,31,26,5,32
Zenit,3452,5,7,9,4,23,18,5,30
Terek Grozny,3452,6,8,5,7,23,25,-2,29
FK Rubin,3452,7,6,5,9,22,19,3,23
Amkar,3452,8,6,4,10,15,24,-9,22
Din Moscow,3452,9,5,6,9,18,25,-7,21
Rostov,3452,10,4,7,9,11,18,-7,19
Anzhi,3452,11,2,5,13,17,43,-26,11
Loko Moscow,3453,1,12,5,3,32,14,18,41
Zenit,3453,2,9,8,3,27,15,12,35
Spart Moscow,3453,3,9,6,5,34,26,8,33
CSKA Moscow,3453,4,10,3,7,27,23,4,33
Krasnodar,3453,5,9,4,7,30,27,3,31
Terek Grozny,3453,6,7,5,8,22,29,-7,26
Din Moscow,3453,7,6,6,8,19,23,-4,24
Amkar,3453,8,6,4,10,13,22,-9,22
FK Rubin,3453,9,5,5,10,23,21,2,20
Rostov,3453,10,4,7,9,10,17,-7,19
Anzhi,3453,11,4,5,11,20,40,-20,17
Loko Moscow,3454,1,12,6,2,30,11,19,42
CSKA Moscow,3454,2,11,4,5,27,18,9,37
Spart Moscow,3454,3,9,5,6,34,27,7,32
Krasnodar,3454,4,9,5,6,31,24,7,32
Zenit,3454,5,7,9,4,21,14,7,30
Terek Grozny,3454,6,8,6,6,22,23,-1,30
Din Moscow,3454,7,7,6,7,19,21,-2,27
FK Rubin,3454,8,5,5,10,21,22,-1,20
Amkar,3454,9,5,4,11,10,23,-13,19
Rostov,3454,10,4,6,10,10,18,-8,18
Anzhi,3454,11,2,6,12,16,40,-24,12
Loko Moscow,3455,1,11,7,2,29,11,18,40
Spart Moscow,3455,2,10,6,4,38,26,12,36
CSKA Moscow,3455,3,11,3,6,30,19,11,36
Zenit,3455,4,8,9,3,23,14,9,33
Krasnodar,3455,5,9,5,6,31,26,5,32
Terek Grozny,3455,6,8,5,7,23,23,0,29
Din Moscow,3455,7,6,6,8,19,24,-5,24
FK Rubin,3455,8,5,5,10,23,23,0,20
Rostov,3455,9,4,7,9,11,18,-7,19
Amkar,3455,10,5,4,11,10,23,-13,19
Anzhi,3455,11,2,5,13,14,44,-30,11
Loko Moscow,3456,1,11,6,3,29,13,16,39
CSKA Moscow,3456,2,11,4,5,30,20,10,37
Zenit,3456,3,8,9,3,24,14,10,33
Spart Moscow,3456,4,8,8,4,38,30,8,32
Krasnodar,3456,5,9,5,6,31,24,7,32
Terek Grozny,3456,6,7,6,7,22,26,-4,27
Din Moscow,3456,7,6,7,7,20,23,-3,25
FK Rubin,3456,8,5,5,10,21,22,-1,20
Rostov,3456,9,4,7,9,11,18,-7,19
Amkar,3456,10,4,6,10,13,26,-13,18
Anzhi,3456,11,3,5,12,18,41,-23,14
Loko Moscow,3457,1,11,6,3,30,14,16,39
CSKA Moscow,3457,2,11,3,6,27,19,8,36
Zenit,3457,3,9,8,3,25,13,12,35
Spart Moscow,3457,4,10,5,5,37,29,8,35
Krasnodar,3457,5,8,5,7,28,26,2,29
Terek Grozny,3457,6,7,6,7,21,25,-4,27
FK Rubin,3457,7,7,5,8,24,17,7,26
Amkar,3457,8,6,4,10,14,23,-9,22
Din Moscow,3457,9,5,6,9,17,24,-7,21
Rostov,3457,10,4,6,10,11,19,-8,18
Anzhi,3457,11,2,6,12,15,40,-25,12
Loko Moscow,3458,1,12,6,2,31,12,19,42
Spart Moscow,3458,2,10,5,5,38,29,9,35
Zenit,3458,3,8,9,3,22,13,9,33
CSKA Moscow,3458,4,10,3,7,26,20,6,33
Terek Grozny,3458,5,8,6,6,22,23,-1,30
Krasnodar,3458,6,8,5,7,28,26,2,29
Din Moscow,3458,7,6,6,8,20,24,-4,24
FK Rubin,3458,8,5,6,9,22,19,3,21
Rostov,3458,9,5,6,9,12,18,-6,21
Amkar,3458,10,4,4,12,10,25,-15,16
Anzhi,3458,11,3,6,11,17,39,-22,15
Loko Moscow,3459,1,12,5,3,34,15,19,41
CSKA Moscow,3459,2,11,3,6,28,21,7,36
Spart Moscow,3459,3,9,5,6,38,31,7,32
Zenit,3459,4,8,8,4,26,19,7,32
Terek Grozny,3459,5,9,5,6,24,22,2,32
Krasnodar,3459,6,9,4,7,29,25,4,31
Din Moscow,3459,7,7,6,7,21,23,-2,27
FK Rubin,3459,8,6,5,9,23,19,4,23
Amkar,3459,9,5,4,11,12,23,-11,19
Rostov,3459,10,4,6,10,11,21,-10,18
Anzhi,3459,11,2,5,13,15,42,-27,11
Loko Moscow,3460,1,13,5,2,34,12,22,44
CSKA Moscow,3460,2,11,3,6,27,18,9,36
Spart Moscow,3460,3,10,5,5,39,28,11,35
Zenit,3460,4,8,8,4,22,16,6,32
Krasnodar,3460,5,9,4,7,30,26,4,31
Terek Grozny,3460,6,8,6,6,24,23,1,30
Din Moscow,3460,7,6,7,7,21,24,-3,25
FK Rubin,3460,8,5,6,9,23,21,2,21
Rostov,3460,9,4,6,10,10,20,-10,18
Amkar,3460,10,4,5,11,11,25,-14,17
Anzhi,3460,11,2,5,13,14,42,-28,11
Loko Moscow,3461,1,12,5,3,30,13,17,41
Spart Moscow,3461,2,11,5,4,45,30,15,38
Zenit,3461,3,9,8,3,24,13,11,35
CSKA Moscow,3461,4,10,4,6,26,19,7,34
Terek Grozny,3461,5,9,5,6,23,23,0,32
Krasnodar,3461,6,9,4,7,29,25,4,31
Din Moscow,3461,7,5,7,8,19,28,-9,22
FK Rubin,3461,8,5,6,9,22,20,2,21
Rostov,3461,9,4,6,10,11,19,-8,18
Amkar,3461,10,4,4,12,12,27,-15,16
Anzhi,3461,11,2,6,12,16,40,-24,12
Loko Moscow,3462,1,11,6,3,31,15,16,39
Spart Moscow,3462,2,9,7,4,38,28,10,34
CSKA Moscow,3462,3,10,4,6,28,21,7,34
Zenit,3462,4,8,9,3,25,15,10,33
Krasnodar,3462,5,9,5,6,30,26,4,32
Terek Grozny,3462,6,7,6,7,20,24,-4,27
Din Moscow,3462,7,6,7,7,20,23,-3,25
FK Rubin,3462,8,5,5,10,22,20,2,20
Amkar,3462,9,5,5,10,12,23,-11,20
Rostov,3462,10,4,6,10,10,19,-9,18
Anzhi,3462,11,3,6,11,17,39,-22,15
Loko Moscow,3463,1,12,5,3,32,14,18,41
CSKA Moscow,3463,2,12,3,5,29,17,12,39
Spart Moscow,3463,3,11,5,4,45,26,19,38
Zenit,3463,4,8,8,4,24,16,8,32
Krasnodar,3463,5,9,4,7,30,27,3,31
Terek Grozny,3463,6,7,7,6,21,23,-2,28
FK Rubin,3463,7,6,5,9,26,22,4,23
Din Moscow,3463,8,5,6,9,19,30,-11,21
Rostov,3463,9,4,6,10,10,22,-12,18
Amkar,3463,10,4,5,11,10,24,-14,17
Anzhi,3463,11,2,6,12,15,40,-25,12
Loko Moscow,3464,1,12,5,3,32,13,19,41
CSKA Moscow,3464,2,12,3,5,27,17,10,39
Spart Moscow,3464,3,11,5,4,38,27,11,38
Terek Grozny,3464,4,9,5,6,23,22,1,32
Krasnodar,3464,5,9,4,7,30,28,2,31
Zenit,3464,6,7,8,5,21,16,5,29
FK Rubin,3464,7,7,5,8,26,18,8,26
Din Moscow,3464,8,5,6,9,18,25,-7,21
Rostov,3464,9,4,6,10,10,18,-8,18
Amkar,3464,10,4,4,12,10,26,-16,16
Anzhi,3464,11,2,5,13,14,39,-25,11
Loko Moscow,3465,1,12,6,2,30,11,19,42
Spart Moscow,3465,2,9,7,4,39,28,11,34
CSKA Moscow,3465,3,10,4,6,25,18,7,34
Krasnodar,3465,4,9,5,6,31,25,6,32
Zenit,3465,5,7,9,4,21,14,7,30
Terek Grozny,3465,6,8,5,7,23,26,-3,29
FK Rubin,3465,7,6,5,9,24,21,3,23
Din Moscow,3465,8,5,7,8,18,24,-6,22
Amkar,3465,9,5,5,10,12,23,-11,20
Rostov,3465,10,4,6,10,11,21,-10,18
Anzhi,3465,11,3,5,12,17,40,-23,14
Loko Moscow,3466,1,11,7,2,31,13,18,40
Spart Moscow,3466,2,11,5,4,39,27,12,38
CSKA Moscow,3466,3,11,3,6,29,22,7,36
Zenit,3466,4,8,9,3,27,17,10,33
Krasnodar,3466,5,9,5,6,29,25,4,32
Terek Grozny,3466,6,8,5,7,23,25,-2,29
FK Rubin,3466,7,6,5,9,23,19,4,23
Din Moscow,3466,8,5,6,9,17,23,-6,21
Amkar,3466,9,5,4,11,12,24,-12,19
Rostov,3466,10,4,6,10,11,20,-9,18
Anzhi,3466,11,2,5,13,16,42,-26,11
Loko Moscow,3467,1,11,6,3,30,15,15,39
CSKA Moscow,3467,2,12,3,5,29,19,10,39
Zenit,3467,3,8,8,4,26,16,10,32
Krasnodar,3467,4,9,5,6,30,25,5,32
Spart Moscow,3467,5,8,6,6,35,29,6,30
Terek Grozny,3467,6,7,7,6,23,25,-2,28
Din Moscow,3467,7,6,7,7,20,23,-3,25
Rostov,3467,8,5,6,9,12,18,-6,21
FK Rubin,3467,9,5,5,10,22,21,1,20
Amkar,3467,10,5,5,10,11,23,-12,20
Anzhi,3467,11,2,6,12,16,40,-24,12
Loko Moscow,3468,1,11,6,3,29,12,17,39
CSKA Moscow,3468,2,11,4,5,27,18,9,37
Spart Moscow,3468,3,9,6,5,35,27,8,33
Krasnodar,3468,4,9,4,7,29,28,1,31
Zenit,3468,5,7,9,4,21,14,7,30
FK Rubin,3468,6,7,5,8,28,18,10,26
Terek Grozny,3468,7,7,5,8,22,28,-6,26
Din Moscow,3468,8,6,6,8,18,24,-6,24
Amkar,3468,9,5,5,10,13,23,-10,20
Rostov,3468,10,4,6,10,10,18,-8,18
Anzhi,3468,11,3,6,11,18,40,-22,15
Loko Moscow,3469,1,11,6,3,29,12,17,39
Zenit,3469,2,9,8,3,25,13,12,35
Spart Moscow,3469,3,10,5,5,37,28,9,35
CSKA Moscow,3469,4,10,4,6,26,21,5,34
Krasnodar,3469,5,8,6,6,29,26,3,30
Terek Grozny,3469,6,8,6,6,24,24,0,30
Din Moscow,3469,7,7,6,7,21,23,-2,27
FK Rubin,3469,8,5,6,9,23,20,3,21
Rostov,3469,9,4,6,10,10,18,-8,18
Amkar,3469,10,4,4,12,10,26,-16,16
Anzhi,3469,11,2,7,11,16,39,-23,13
Loko Moscow,3470,1,12,6,2,30,11,19,42
Spart Moscow,3470,2,11,5,4,39,26,13,38
Zenit,3470,3,8,9,3,24,13,11,33
CSKA Moscow,3470,4,10,3,7,26,22,4,33
Krasnodar,3470,5,8,4,8,27,28,-1,28
Terek Grozny,3470,6,7,7,6,23,25,-2,28
FK Rubin,3470,7,6,6,8,24,17,7,24
Din Moscow,3470,8,5,7,8,18,24,-6,22
Rostov,3470,9,4,6,10,10,18,-8,18
Amkar,3470,10,4,5,11,11,26,-15,17
Anzhi,3470,11,3,6,11,17,39,-22,15
Loko Moscow,3471,1,11,6,3,30,13,17,39
CSKA Moscow,3471,2,12,3,5,33,19,14,39
Krasnodar,3471,3,10,4,6,29,24,5,34
Spart Moscow,3471,4,9,5,6,36,28,8,32
Terek Grozny,3471,5,9,5,6,25,23,2,32
Zenit,3471,6,7,9,4,24,17,7,30
Din Moscow,3471,7,6,7,7,18,21,-3,25
FK Rubin,3471,8,5,6,9,21,18,3,21
Rostov,3471,9,5,6,9,11,17,-6,21
Amkar,3471,10,4,4,12,10,27,-17,16
Anzhi,3471,11,2,5,13,15,45,-30,11
Loko Moscow,3472,1,11,6,3,31,15,16,39
CSKA Moscow,3472,2,12,3,5,29,17,12,39
Spart Moscow,3472,3,10,5,5,40,28,12,35
Krasnodar,3472,4,10,4,6,30,24,6,34
Terek Grozny,3472,5,9,5,6,23,23,0,32
Zenit,3472,6,7,9,4,23,16,7,30
Din Moscow,3472,7,6,7,7,20,22,-2,25
FK Rubin,3472,8,5,6,9,22,19,3,21
Rostov,3472,9,4,6,10,11,20,-9,18
Amkar,3472,10,4,4,12,9,27,-18,16
Anzhi,3472,11,2,5,13,15,42,-27,11
Loko Moscow,3473,1,12,5,3,31,13,18,41
Spart Moscow,3473,2,10,6,4,40,29,11,36
CSKA Moscow,3473,3,11,3,6,31,20,11,36
Zenit,3473,4,9,8,3,26,15,11,35
Krasnodar,3473,5,8,5,7,27,25,2,29
Terek Grozny,3473,6,8,5,7,24,26,-2,29
FK Rubin,3473,7,5,7,8,22,18,4,22
Din Moscow,3473,8,5,7,8,18,24,-6,22
Rostov,3473,9,4,7,9,13,20,-7,19
Amkar,3473,10,5,4,11,11,24,-13,19
Anzhi,3473,11,2,5,13,17,46,-29,11
Loko Moscow,3474,1,12,5,3,32,14,18,41
CSKA Moscow,3474,2,11,3,6,29,20,9,36
Zenit,3474,3,9,8,3,24,14,10,35
Terek Grozny,3474,4,9,5,6,26,23,3,32
Spart Moscow,3474,5,8,7,5,35,28,7,31
Krasnodar,3474,6,9,4,7,31,28,3,31
Din Moscow,3474,7,6,7,7,18,21,-3,25
FK Rubin,3474,8,5,6,9,22,19,3,21
Rostov,3474,9,4,7,9,11,18,-7,19
Amkar,3474,10,4,5,11,11,26,-15,17
Anzhi,3474,11,2,5,13,15,43,-28,11
Loko Moscow,3475,1,12,5,3,33,14,19,41
CSKA Moscow,3475,2,12,3,5,28,18,10,39
Spart Moscow,3475,3,9,6,5,39,30,9,33
Zenit,3475,4,8,8,4,23,15,8,32
Krasnodar,3475,5,9,4,7,31,28,3,31
Terek Grozny,3475,6,8,5,7,22,25,-3,29
Din Moscow,3475,7,5,7,8,19,25,-6,22
FK Rubin,3475,8,5,6,9,22,20,2,21
Rostov,3475,9,4,7,9,11,18,-7,19
Amkar,3475,10,5,4,11,11,24,-13,19
Anzhi,3475,11,3,5,12,18,40,-22,14
Loko Moscow,3476,1,11,5,4,29,14,15,38
Spart Moscow,3476,2,10,5,5,38,29,9,35
CSKA Moscow,3476,3,10,4,6,26,19,7,34
Zenit,3476,4,8,9,3,23,14,9,33
Krasnodar,3476,5,9,4,7,29,25,4,31
Terek Grozny,3476,6,8,5,7,22,24,-2,29
Din Moscow,3476,7,7,6,7,26,25,1,27
FK Rubin,3476,8,6,5,9,24,22,2,23
Amkar,3476,9,5,4,11,11,25,-14,19
Rostov,3476,10,4,6,10,10,18,-8,18
Anzhi,3476,11,3,5,12,15,38,-23,14
Loko Moscow,3477,1,11,6,3,29,13,16,39
CSKA Moscow,3477,2,11,3,6,27,22,5,36
Zenit,3477,3,8,9,3,25,13,12,33
Spart Moscow,3477,4,9,5,6,36,29,7,32
Krasnodar,3477,5,9,5,6,30,25,5,32
Terek Grozny,3477,6,8,6,6,21,22,-1,30
FK Rubin,3477,7,6,6,8,25,20,5,24
Din Moscow,3477,8,6,6,8,20,24,-4,24
Amkar,3477,9,5,5,10,11,23,-12,20
Rostov,3477,10,4,6,10,11,19,-8,18
Anzhi,3477,11,2,5,13,15,40,-25,11
Loko Moscow,3478,1,11,6,3,31,14,17,39
CSKA Moscow,3478,2,11,3,6,27,19,8,36
Spart Moscow,3478,3,10,5,5,37,28,9,35
Krasnodar,3478,4,10,4,6,32,27,5,34
Zenit,3478,5,8,9,3,23,13,10,33
Terek Grozny,3478,6,9,5,6,26,24,2,32
Din Moscow,3478,7,6,6,8,20,23,-3,24
FK Rubin,3478,8,5,5,10,23,22,1,20
Amkar,3478,9,5,4,11,12,25,-13,19
Rostov,3478,10,4,6,10,10,19,-9,18
Anzhi,3478,11,2,5,13,16,43,-27,11
Loko Moscow,3479,1,13,5,2,39,14,25,44
Spart Moscow,3479,2,10,5,5,42,29,13,35
CSKA Moscow,3479,3,10,3,7,27,24,3,33
Zenit,3479,4,8,8,4,25,21,4,32
Terek Grozny,3479,5,8,6,6,23,24,-1,30
Krasnodar,3479,6,8,5,7,29,27,2,29
Din Moscow,3479,7,6,7,7,21,23,-2,25
FK Rubin,3479,8,5,7,8,22,18,4,22
Rostov,3479,9,4,6,10,11,22,-11,18
Amkar,3479,10,4,4,12,11,28,-17,16
Anzhi,3479,11,3,6,11,18,38,-20,15
Loko Moscow,3480,1,13,5,2,31,11,20,44
Spart Moscow,3480,2,9,7,4,38,27,11,34
CSKA Moscow,3480,3,10,3,7,27,24,3,33
Zenit,3480,4,8,8,4,25,15,10,32
Krasnodar,3480,5,9,4,7,28,25,3,31
Terek Grozny,3480,6,7,6,7,20,24,-4,27
Din Moscow,3480,7,5,8,7,18,22,-4,23
FK Rubin,3480,8,5,6,9,21,18,3,21
Amkar,3480,9,5,5,10,11,22,-11,20
Rostov,3480,10,4,6,10,11,21,-10,18
Anzhi,3480,11,3,6,11,17,38,-21,15
CSKA Moscow,3481,1,12,3,5,30,18,12,39
Loko Moscow,3481,2,11,5,4,31,17,14,38
Spart Moscow,3481,3,9,7,4,36,27,9,34
Krasnodar,3481,4,10,4,6,32,26,6,34
Zenit,3481,5,8,8,4,24,16,8,32
Terek Grozny,3481,6,8,5,7,23,26,-3,29
Din Moscow,3481,7,6,7,7,22,23,-1,25
FK Rubin,3481,8,5,5,10,22,22,0,20
Rostov,3481,9,4,6,10,11,19,-8,18
Amkar,3481,10,4,5,11,9,24,-15,17
Anzhi,3481,11,3,5,12,18,40,-22,14
Loko Moscow,3482,1,11,5,4,30,17,13,38
CSKA Moscow,3482,2,10,5,5,26,18,8,35
Krasnodar,3482,3,10,4,6,33,26,7,34
Zenit,3482,4,8,9,3,24,14,10,33
Terek Grozny,3482,5,9,5,6,24,22,2,32
Spart Moscow,3482,6,8,6,6,36,30,6,30
Din Moscow,3482,7,7,6,7,21,23,-2,27
Rostov,3482,8,5,6,9,11,17,-6,21
FK Rubin,3482,9,5,5,10,23,21,2,20
Amkar,3482,10,4,5,11,10,25,-15,17
Anzhi,3482,11,2,6,12,15,40,-25,12
CSKA Moscow,3483,1,12,3,5,28,18,10,39
Loko Moscow,3483,2,11,5,4,30,15,15,38
Spart Moscow,3483,3,11,5,4,42,29,13,38
Zenit,3483,4,8,8,4,24,15,9,32
Terek Grozny,3483,5,9,5,6,25,24,1,32
Krasnodar,3483,6,9,4,7,30,27,3,31
FK Rubin,3483,7,7,5,8,24,18,6,26
Din Moscow,3483,8,5,6,9,17,25,-8,21
Rostov,3483,9,4,6,10,12,20,-8,18
Amkar,3483,10,4,4,12,12,27,-15,16
Anzhi,3483,11,2,5,13,15,41,-26,11
CSKA Moscow,3484,1,12,3,5,31,18,13,39
Loko Moscow,3484,2,11,5,4,30,14,16,38
Zenit,3484,3,8,8,4,23,15,8,32
Spart Moscow,3484,4,8,7,5,35,30,5,31
Krasnodar,3484,5,9,4,7,29,26,3,31
Terek Grozny,3484,6,7,5,8,21,25,-4,26
FK Rubin,3484,7,6,6,8,22,17,5,24
Din Moscow,3484,8,5,8,7,18,22,-4,23
Amkar,3484,9,6,4,10,14,23,-9,22
Rostov,3484,10,4,7,9,10,17,-7,19
Anzhi,3484,11,3,5,12,16,42,-26,14
Loko Moscow,3485,1,12,5,3,32,13,19,41
CSKA Moscow,3485,2,11,4,5,29,19,10,37
Spart Moscow,3485,3,10,6,4,39,26,13,36
Zenit,3485,4,8,9,3,22,13,9,33
Krasnodar,3485,5,9,4,7,30,27,3,31
Terek Grozny,3485,6,8,6,6,22,22,0,30
Din Moscow,3485,7,6,6,8,19,24,-5,24
FK Rubin,3485,8,5,5,10,22,21,1,20
Rostov,3485,9,4,6,10,10,20,-10,18
Amkar,3485,10,4,5,11,10,25,-15,17
Anzhi,3485,11,2,6,12,16,41,-25,12
Loko Moscow,3486,1,11,6,3,31,15,16,39
CSKA Moscow,3486,2,12,3,5,28,18,10,39
Zenit,3486,3,8,8,4,23,14,9,32
Spart Moscow,3486,4,9,5,6,36,29,7,32
Krasnodar,3486,5,9,5,6,30,26,4,32
Terek Grozny,3486,6,9,5,6,23,23,0,32
Din Moscow,3486,7,6,7,7,19,22,-3,25
FK Rubin,3486,8,5,6,9,22,19,3,21
Rostov,3486,9,5,6,9,12,18,-6,21
Amkar,3486,10,4,4,12,10,25,-15,16
Anzhi,3486,11,2,5,13,16,41,-25,11
Loko Moscow,3487,1,12,6,2,34,13,21,42
CSKA Moscow,3487,2,11,4,5,27,18,9,37
Spart Moscow,3487,3,10,6,4,38,26,12,36
Zenit,3487,4,7,10,3,24,16,8,31
Krasnodar,3487,5,9,4,7,29,28,1,31
Terek Grozny,3487,6,8,6,6,22,23,-1,30
FK Rubin,3487,7,6,5,9,23,19,4,23
Din Moscow,3487,8,5,7,8,18,23,-5,22
Rostov,3487,9,4,6,10,10,18,-8,18
Amkar,3487,10,4,5,11,10,26,-16,17
Anzhi,3487,11,2,5,13,14,39,-25,11
Loko Moscow,3488,1,12,6,2,30,11,19,42
Spart Moscow,3488,2,9,7,4,40,29,11,34
CSKA Moscow,3488,3,10,4,6,27,20,7,34
Zenit,3488,4,8,8,4,23,15,8,32
Krasnodar,3488,5,9,5,6,31,25,6,32
Terek Grozny,3488,6,7,6,7,20,25,-5,27
FK Rubin,3488,7,6,5,9,25,21,4,23
Din Moscow,3488,8,5,7,8,18,25,-7,22
Rostov,3488,9,4,7,9,11,18,-7,19
Amkar,3488,10,5,4,11,14,27,-13,19
Anzhi,3488,11,2,7,11,15,38,-23,13
Loko Moscow,3489,1,11,5,4,32,17,15,38
Spart Moscow,3489,2,10,6,4,40,27,13,36
Zenit,3489,3,9,8,3,25,15,10,35
CSKA Moscow,3489,4,10,3,7,26,21,5,33
Krasnodar,3489,5,9,4,7,30,26,4,31
Terek Grozny,3489,6,8,5,7,21,25,-4,29
Din Moscow,3489,7,6,6,8,20,25,-5,24
FK Rubin,3489,8,6,5,9,22,19,3,23
Rostov,3489,9,4,6,10,11,20,-9,18
Amkar,3489,10,4,5,11,9,23,-14,17
Anzhi,3489,11,4,5,11,20,38,-18,17
Loko Moscow,3490,1,12,6,2,33,13,20,42
CSKA Moscow,3490,2,11,3,6,27,19,8,36
Spart Moscow,3490,3,9,6,5,37,28,9,33
Zenit,3490,4,8,8,4,22,15,7,32
Krasnodar,3490,5,9,5,6,32,27,5,32
Terek Grozny,3490,6,8,5,7,22,23,-1,29
FK Rubin,3490,7,6,5,9,24,20,4,23
Din Moscow,3490,8,5,7,8,18,24,-6,22
Amkar,3490,9,5,4,11,11,25,-14,19
Rostov,3490,10,4,6,10,10,19,-9,18
Anzhi,3490,11,3,5,12,16,39,-23,14
Loko Moscow,3491,1,13,5,2,34,11,23,44
CSKA Moscow,3491,2,10,4,6,27,20,7,34
Spart Moscow,3491,3,9,6,5,40,28,12,33
Zenit,3491,4,8,8,4,23,17,6,32
Terek Grozny,3491,5,8,6,6,22,22,0,30
Krasnodar,3491,6,8,4,8,28,30,-2,28
Din Moscow,3491,7,6,6,8,22,28,-6,24
FK Rubin,3491,8,6,5,9,26,22,4,23
Amkar,3491,9,5,5,10,10,22,-12,20
Rostov,3491,10,4,7,9,11,18,-7,19
Anzhi,3491,11,2,6,12,15,40,-25,12
Loko Moscow,3492,1,13,5,2,32,12,20,44
Spart Moscow,3492,2,11,5,4,38,26,12,38
CSKA Moscow,3492,3,11,3,6,26,18,8,36
Krasnodar,3492,4,9,4,7,31,26,5,31
Terek Grozny,3492,5,8,6,6,21,22,-1,30
Zenit,3492,6,7,8,5,21,15,6,29
Din Moscow,3492,7,5,7,8,17,22,-5,22
FK Rubin,3492,8,5,6,9,21,20,1,21
Rostov,3492,9,4,6,10,11,20,-9,18
Amkar,3492,10,4,5,11,9,23,-14,17
Anzhi,3492,11,3,5,12,15,38,-23,14
Loko Moscow,3493,1,13,5,2,34,13,21,44
CSKA Moscow,3493,2,11,4,5,31,18,13,37
Spart Moscow,3493,3,9,6,5,36,28,8,33
Zenit,3493,4,7,9,4,22,15,7,30
Terek Grozny,3493,5,8,6,6,22,23,-1,30
Krasnodar,3493,6,8,4,8,29,29,0,28
Din Moscow,3493,7,6,6,8,21,24,-3,24
FK Rubin,3493,8,6,5,9,22,19,3,23
Rostov,3493,9,5,6,9,11,17,-6,21
Amkar,3493,10,4,5,11,10,24,-14,17
Anzhi,3493,11,2,6,12,14,42,-28,12
Loko Moscow,3494,1,12,5,3,34,15,19,41
CSKA Moscow,3494,2,11,3,6,26,20,6,36
Spart Moscow,3494,3,10,5,5,41,29,12,35
Krasnodar,3494,4,10,4,6,33,25,8,34
Zenit,3494,5,8,8,4,25,17,8,32
Terek Grozny,3494,6,9,5,6,23,22,1,32
Din Moscow,3494,7,6,6,8,20,24,-4,24
FK Rubin,3494,8,5,5,10,21,21,0,20
Amkar,3494,9,5,4,11,11,24,-13,19
Rostov,3494,10,4,6,10,10,22,-12,18
Anzhi,3494,11,2,5,13,14,39,-25,11
Loko Moscow,3495,1,12,5,3,34,15,19,41
Spart Moscow,3495,2,11,5,4,40,28,12,38
Krasnodar,3495,3,10,4,6,32,27,5,34
CSKA Moscow,3495,4,10,3,7,26,22,4,33
Zenit,3495,5,8,8,4,27,18,9,32
Terek Grozny,3495,6,8,6,6,22,23,-1,30
Din Moscow,3495,7,6,6,8,19,23,-4,24
FK Rubin,3495,8,5,5,10,23,21,2,20
Rostov,3495,9,4,6,10,12,21,-9,18
Amkar,3495,10,4,5,11,10,24,-14,17
Anzhi,3495,11,3,5,12,15,38,-23,14
Loko Moscow,3496,1,12,5,3,31,13,18,41
Zenit,3496,2,9,8,3,24,14,10,35
CSKA Moscow,3496,3,10,4,6,26,19,7,34
Spart Moscow,3496,4,9,6,5,35,29,6,33
Krasnodar,3496,5,8,5,7,28,26,2,29
Terek Grozny,3496,6,8,5,7,22,24,-2,29
FK Rubin,3496,7,6,6,8,23,18,5,24
Rostov,3496,8,5,6,9,14,18,-4,21
Din Moscow,3496,9,5,6,9,17,23,-6,21
Amkar,3496,10,4,5,11,9,23,-14,17
Anzhi,3496,11,3,6,11,17,39,-22,15
Loko Moscow,3497,1,13,5,2,31,11,20,44
CSKA Moscow,3497,2,11,4,5,32,18,14,37
Spart Moscow,3497,3,9,6,5,40,32,8,33
Krasnodar,3497,4,9,4,7,29,25,4,31
Zenit,3497,5,7,9,4,22,15,7,30
Terek Grozny,3497,6,7,5,8,20,25,-5,26
Din Moscow,3497,7,6,6,8,22,26,-4,24
Amkar,3497,8,6,4,10,14,24,-10,22
FK Rubin,3497,9,5,5,10,22,21,1,20
Rostov,3497,10,4,7,9,11,18,-7,19
Anzhi,3497,11,3,5,12,15,43,-28,14
Loko Moscow,3498,1,13,5,2,33,12,21,44
CSKA Moscow,3498,2,11,3,6,30,20,10,36
Spart Moscow,3498,3,9,6,5,39,30,9,33
Zenit,3498,4,8,8,4,25,17,8,32
Terek Grozny,3498,5,8,6,6,23,24,-1,30
Krasnodar,3498,6,8,4,8,28,28,0,28
Din Moscow,3498,7,6,7,7,22,25,-3,25
FK Rubin,3498,8,6,5,9,25,21,4,23
Amkar,3498,9,5,5,10,11,23,-12,20
Rostov,3498,10,4,6,10,12,21,-9,18
Anzhi,3498,11,2,5,13,15,42,-27,11
Loko Moscow,3499,1,11,5,4,29,15,14,38
CSKA Moscow,3499,2,11,3,6,28,20,8,36
Zenit,3499,3,9,8,3,26,13,13,35
Spart Moscow,3499,4,9,6,5,38,28,10,33
Krasnodar,3499,5,9,4,7,29,26,3,31
Terek Grozny,3499,6,8,5,7,22,24,-2,29
FK Rubin,3499,7,6,6,8,24,18,6,24
Din Moscow,3499,8,5,8,7,19,23,-4,23
Rostov,3499,9,5,6,9,11,17,-6,21
Amkar,3499,10,5,4,11,12,27,-15,19
Anzhi,3499,11,2,5,13,14,41,-27,11
Loko Moscow,3500,1,11,5,4,32,16,16,38
CSKA Moscow,3500,2,11,3,6,27,19,8,36
Zenit,3500,3,9,8,3,25,15,10,35
Spart Moscow,3500,4,9,6,5,38,28,10,33
Krasnodar,3500,5,9,4,7,31,28,3,31
Terek Grozny,3500,6,7,7,6,22,24,-2,28
Din Moscow,3500,7,6,6,8,20,25,-5,24
FK Rubin,3500,8,6,5,9,24,21,3,23
Rostov,3500,9,5,6,9,12,18,-6,21
Amkar,3500,10,4,6,10,10,23,-13,18
Anzhi,3500,11,2,6,12,16,40,-24,12
CSKA Moscow,3501,1,12,3,5,29,19,10,39
Loko Moscow,3501,2,11,5,4,31,18,13,38
Spart Moscow,3501,3,10,6,4,39,27,12,36
Zenit,3501,4,8,8,4,22,14,8,32
Krasnodar,3501,5,9,4,7,33,29,4,31
Terek Grozny,3501,6,8,6,6,21,22,-1,30
Din Moscow,3501,7,6,7,7,20,22,-2,25
FK Rubin,3501,8,6,5,9,24,19,5,23
Rostov,3501,9,4,6,10,11,19,-8,18
Amkar,3501,10,4,5,11,9,25,-16,17
Anzhi,3501,11,2,5,13,16,41,-25,11
Loko Moscow,3502,1,11,5,4,32,16,16,38
CSKA Moscow,3502,2,11,3,6,27,19,8,36
Spart Moscow,3502,3,10,5,5,39,30,9,35
Zenit,3502,4,8,8,4,22,14,8,32
Krasnodar,3502,5,9,4,7,31,30,1,31
Terek Grozny,3502,6,7,6,7,21,24,-3,27
Din Moscow,3502,7,6,6,8,18,23,-5,24
FK Rubin,3502,8,6,5,9,24,18,6,23
Rostov,3502,9,5,6,9,13,18,-5,21
Amkar,3502,10,4,5,11,11,25,-14,17
Anzhi,3502,11,4,5,11,18,39,-21,17
Loko Moscow,3503,1,11,6,3,30,14,16,39
CSKA Moscow,3503,2,10,5,5,26,18,8,35
Krasnodar,3503,3,10,4,6,32,25,7,34
Spart Moscow,3503,4,9,5,6,36,29,7,32
Zenit,3503,5,7,10,3,22,14,8,31
Terek Grozny,3503,6,8,6,6,21,22,-1,30
Din Moscow,3503,7,6,7,7,21,24,-3,25
FK Rubin,3503,8,5,6,9,24,22,2,21
Rostov,3503,9,5,6,9,12,18,-6,21
Amkar,3503,10,4,4,12,9,24,-15,16
Anzhi,3503,11,2,7,11,15,38,-23,13
Loko Moscow,3504,1,11,6,3,31,17,14,39
CSKA Moscow,3504,2,11,3,6,30,20,10,36
Zenit,3504,3,8,9,3,25,16,9,33
Krasnodar,3504,4,9,4,7,32,26,6,31
Spart Moscow,3504,5,8,5,7,34,30,4,29
Terek Grozny,3504,6,8,5,7,24,23,1,29
Din Moscow,3504,7,7,6,7,20,22,-2,27
FK Rubin,3504,8,6,5,9,23,19,4,23
Amkar,3504,9,6,4,10,12,22,-10,22
Rostov,3504,10,5,6,9,12,18,-6,21
Anzhi,3504,11,2,5,13,14,44,-30,11
Loko Moscow,3505,1,11,6,3,30,13,17,39
Spart Moscow,3505,2,10,5,5,43,31,12,35
CSKA Moscow,3505,3,10,5,5,26,18,8,35
Zenit,3505,4,7,10,3,22,14,8,31
Krasnodar,3505,5,9,4,7,29,26,3,31
Terek Grozny,3505,6,8,5,7,24,24,0,29
Din Moscow,3505,7,6,6,8,21,24,-3,24
FK Rubin,3505,8,6,5,9,22,19,3,23
Amkar,3505,9,6,4,10,15,24,-9,22
Rostov,3505,10,4,6,10,10,23,-13,18
Anzhi,3505,11,2,6,12,14,40,-26,12
Loko Moscow,3506,1,11,6,3,29,12,17,39
CSKA Moscow,3506,2,11,3,6,28,20,8,36
Spart Moscow,3506,3,9,7,4,37,28,9,34
Zenit,3506,4,8,8,4,23,15,8,32
Krasnodar,3506,5,8,5,7,27,25,2,29
Terek Grozny,3506,6,7,6,7,21,24,-3,27
Din Moscow,3506,7,6,7,7,21,23,-2,25
FK Rubin,3506,8,6,5,9,23,20,3,23
Rostov,3506,9,4,7,9,11,18,-7,19
Amkar,3506,10,4,5,11,11,25,-14,17
Anzhi,3506,11,4,5,11,17,38,-21,17
Loko Moscow,3507,1,11,6,3,30,14,16,39
CSKA Moscow,3507,2,11,4,5,30,20,10,37
Krasnodar,3507,3,10,4,6,32,25,7,34
Spart Moscow,3507,4,9,6,5,40,32,8,33
Terek Grozny,3507,5,9,5,6,27,25,2,32
Zenit,3507,6,7,10,3,22,14,8,31
FK Rubin,3507,7,6,5,9,23,19,4,23
Din Moscow,3507,8,5,7,8,19,25,-6,22
Amkar,3507,9,5,4,11,13,26,-13,19
Rostov,3507,10,4,6,10,12,21,-9,18
Anzhi,3507,11,2,5,13,18,45,-27,11
Loko Moscow,3508,1,11,6,3,30,15,15,39
CSKA Moscow,3508,2,11,3,6,26,18,8,36
Spart Moscow,3508,3,10,5,5,38,26,12,35
Zenit,3508,4,8,8,4,25,15,10,32
Krasnodar,3508,5,8,5,7,27,26,1,29
Terek Grozny,3508,6,8,5,7,23,26,-3,29
Din Moscow,3508,7,6,7,7,19,22,-3,25
FK Rubin,3508,8,6,6,8,24,18,6,24
Rostov,3508,9,4,6,10,10,20,-10,18
Anzhi,3508,10,4,5,11,18,38,-20,17
Amkar,3508,11,4,4,12,10,26,-16,16
Loko Moscow,3509,1,12,6,2,33,14,19,42
CSKA Moscow,3509,2,12,3,5,28,17,11,39
Spart Moscow,3509,3,8,6,6,35,29,6,30
Zenit,3509,4,7,8,5,21,16,5,29
Krasnodar,3509,5,8,5,7,31,29,2,29
Terek Grozny,3509,6,8,5,7,21,23,-2,29
FK Rubin,3509,7,6,6,8,24,19,5,24
Din Moscow,3509,8,5,8,7,18,22,-4,23
Amkar,3509,9,6,4,10,13,24,-11,22
Rostov,3509,10,5,6,9,11,17,-6,21
Anzhi,3509,11,2,5,13,14,39,-25,11
Loko Moscow,3510,1,12,6,2,31,11,20,42
Spart Moscow,3510,2,10,5,5,39,28,11,35
CSKA Moscow,3510,3,10,4,6,26,19,7,34
Zenit,3510,4,8,9,3,22,13,9,33
Krasnodar,3510,5,8,5,7,28,27,1,29
Terek Grozny,3510,6,8,5,7,23,25,-2,29
FK Rubin,3510,7,5,7,8,22,18,4,22
Din Moscow,3510,8,5,7,8,18,25,-7,22
Rostov,3510,9,5,6,9,12,18,-6,21
Amkar,3510,10,5,4,11,10,23,-13,19
Anzhi,3510,11,2,6,12,17,41,-24,12
Loko Moscow,3511,1,11,6,3,29,13,16,39
CSKA Moscow,3511,2,11,4,5,33,20,13,37
Spart Moscow,3511,3,10,6,4,40,28,12,36
Terek Grozny,3511,4,9,5,6,24,24,0,32
Zenit,3511,5,7,10,3,23,15,8,31
Krasnodar,3511,6,9,4,7,29,28,1,31
Din Moscow,3511,7,6,6,8,18,22,-4,24
FK Rubin,3511,8,6,5,9,25,18,7,23
Rostov,3511,9,4,7,9,12,19,-7,19
Amkar,3511,10,4,4,12,12,29,-17,16
Anzhi,3511,11,2,5,13,15,44,-29,11
Loko Moscow,3512,1,12,6,2,31,12,19,42
CSKA Moscow,3512,2,11,4,5,28,18,10,37
Zenit,3512,3,7,10,3,22,14,8,31
Spart Moscow,3512,4,8,6,6,35,29,6,30
Terek Grozny,3512,5,8,5,7,22,25,-3,29
Krasnodar,3512,6,8,4,8,30,30,0,28
FK Rubin,3512,7,7,5,8,27,20,7,26
Din Moscow,3512,8,6,6,8,19,23,-4,24
Amkar,3512,9,6,4,10,13,23,-10,22
Rostov,3512,10,4,7,9,11,18,-7,19
Anzhi,3512,11,2,5,13,15,41,-26,11
Loko Moscow,3513,1,11,6,3,30,14,16,39
CSKA Moscow,3513,2,11,3,6,28,18,10,36
Krasnodar,3513,3,10,4,6,32,24,8,34
Spart Moscow,3513,4,9,6,5,38,29,9,33
Zenit,3513,5,8,9,3,23,14,9,33
Terek Grozny,3513,6,8,6,6,23,23,0,30
Din Moscow,3513,7,5,8,7,18,22,-4,23
FK Rubin,3513,8,5,6,9,22,21,1,21
Amkar,3513,9,5,5,10,13,25,-12,20
Rostov,3513,10,4,6,10,11,20,-9,18
Anzhi,3513,11,2,5,13,14,42,-28,11
Loko Moscow,3514,1,12,5,3,32,14,18,41
CSKA Moscow,3514,2,11,3,6,30,19,11,36
Spart Moscow,3514,3,10,6,4,36,26,10,36
Zenit,3514,4,9,8,3,25,13,12,35
Krasnodar,3514,5,8,5,7,28,27,1,29
Terek Grozny,3514,6,7,6,7,22,26,-4,27
FK Rubin,3514,7,6,6,8,25,19,6,24
Din Moscow,3514,8,5,6,9,20,27,-7,21
Rostov,3514,9,4,7,9,10,17,-7,19
Amkar,3514,10,5,4,11,12,24,-12,19
Anzhi,3514,11,2,6,12,15,43,-28,12
Loko Moscow,3515,1,12,6,2,31,12,19,42
Spart Moscow,3515,2,10,6,4,39,28,11,36
CSKA Moscow,3515,3,11,3,6,28,21,7,36
Zenit,3515,4,8,9,3,26,16,10,33
Krasnodar,3515,5,9,4,7,28,25,3,31
Terek Grozny,3515,6,8,6,6,25,24,1,30
Din Moscow,3515,7,5,7,8,18,24,-6,22
FK Rubin,3515,8,5,6,9,22,19,3,21
Rostov,3515,9,4,7,9,11,18,-7,19
Amkar,3515,10,4,5,11,12,26,-14,17
Anzhi,3515,11,2,5,13,15,42,-27,11
Loko Moscow,3516,1,13,5,2,33,12,21,44
CSKA Moscow,3516,2,11,4,5,29,20,9,37
Spart Moscow,3516,3,10,5,5,40,31,9,35
Terek Grozny,3516,4,9,5,6,25,22,3,32
Krasnodar,3516,5,9,4,7,29,26,3,31
Zenit,3516,6,7,8,5,22,17,5,29
Din Moscow,3516,7,5,7,8,19,26,-7,22
FK Rubin,3516,8,5,6,9,22,19,3,21
Rostov,3516,9,5,6,9,14,18,-4,21
Amkar,3516,10,4,4,12,10,25,-15,16
Anzhi,3516,11,2,6,12,16,43,-27,12
Loko Moscow,3517,1,12,5,3,31,16,15,41
CSKA Moscow,3517,2,11,3,6,28,20,8,36
Krasnodar,3517,3,10,4,6,32,24,8,34
Spart Moscow,3517,4,9,6,5,39,29,10,33
Terek Grozny,3517,5,9,5,6,25,22,3,32
Zenit,3517,6,7,8,5,23,17,6,29
Din Moscow,3517,7,6,7,7,20,23,-3,25
FK Rubin,3517,8,5,6,9,21,18,3,21
Rostov,3517,9,4,6,10,10,20,-10,18
Amkar,3517,10,4,5,11,10,26,-16,17
Anzhi,3517,11,3,5,12,16,40,-24,14
Loko Moscow,3518,1,13,5,2,34,14,20,44
CSKA Moscow,3518,2,11,3,6,28,20,8,36
Spart Moscow,3518,3,10,5,5,38,27,11,35
Zenit,3518,4,8,8,4,25,16,9,32
Terek Grozny,3518,5,8,6,6,21,22,-1,30
Krasnodar,3518,6,8,4,8,29,28,1,28
Din Moscow,3518,7,6,6,8,18,22,-4,24
FK Rubin,3518,8,6,5,9,22,18,4,23
Rostov,3518,9,5,6,9,12,18,-6,21
Amkar,3518,10,4,5,11,9,25,-16,17
Anzhi,3518,11,2,5,13,14,40,-26,11
Loko Moscow,3519,1,11,6,3,29,12,17,39
CSKA Moscow,3519,2,12,3,5,34,18,16,39
Spart Moscow,3519,3,9,7,4,36,27,9,34
Zenit,3519,4,8,8,4,22,17,5,32
Krasnodar,3519,5,8,6,6,27,24,3,30
Terek Grozny,3519,6,7,5,8,22,26,-4,26
Din Moscow,3519,7,6,7,7,21,22,-1,25
FK Rubin,3519,8,5,6,9,21,20,1,21
Amkar,3519,9,5,5,10,12,24,-12,20
Rostov,3519,10,4,6,10,10,18,-8,18
Anzhi,3519,11,3,5,12,17,43,-26,14
Loko Moscow,3520,1,12,6,2,32,13,19,42
Spart Moscow,3520,2,10,6,4,41,27,14,36
CSKA Moscow,3520,3,11,3,6,26,19,7,36
Zenit,3520,4,8,8,4,24,15,9,32
Krasnodar,3520,5,8,6,6,28,25,3,30
Terek Grozny,3520,6,8,6,6,24,25,-1,30
FK Rubin,3520,7,6,6,8,23,17,6,24
Din Moscow,3520,8,5,6,9,17,24,-7,21
Rostov,3520,9,4,6,10,11,23,-12,18
Amkar,3520,10,4,6,10,11,24,-13,18
Anzhi,3520,11,2,5,13,16,41,-25,11
Loko Moscow,3521,1,12,5,3,32,14,18,41
CSKA Moscow,3521,2,11,3,6,30,23,7,36
Krasnodar,3521,3,10,4,6,32,27,5,34
Zenit,3521,4,8,8,4,25,14,11,32
Spart Moscow,3521,5,8,8,4,38,30,8,32
Terek Grozny,3521,6,8,5,7,22,23,-1,29
Din Moscow,3521,7,6,7,7,22,25,-3,25
FK Rubin,3521,8,5,5,10,23,21,2,20
Amkar,3521,9,5,5,10,11,23,-12,20
Rostov,3521,10,4,7,9,11,18,-7,19
Anzhi,3521,11,2,5,13,16,44,-28,11
Loko Moscow,3522,1,12,5,3,31,13,18,41
CSKA Moscow,3522,2,10,4,6,27,20,7,34
Spart Moscow,3522,3,9,6,5,38,32,6,33
Zenit,3522,4,8,8,4,24,16,8,32
Krasnodar,3522,5,9,4,7,30,27,3,31
Terek Grozny,3522,6,7,6,7,20,23,-3,27
FK Rubin,3522,7,6,6,8,23,18,5,24
Din Moscow,3522,8,5,7,8,17,23,-6,22
Amkar,3522,9,6,4,10,15,23,-8,22
Rostov,3522,10,4,7,9,12,19,-7,19
Anzhi,3522,11,2,7,11,14,37,-23,13
Loko Moscow,3523,1,13,5,2,37,13,24,44
CSKA Moscow,3523,2,11,4,5,30,18,12,37
Spart Moscow,3523,3,9,6,5,38,28,10,33
Zenit,3523,4,7,9,4,24,17,7,30
Krasnodar,3523,5,8,5,7,29,31,-2,29
Terek Grozny,3523,6,7,6,7,20,23,-3,27
FK Rubin,3523,7,5,7,8,23,19,4,22
Din Moscow,3523,8,5,7,8,17,24,-7,22
Amkar,3523,9,5,5,10,11,23,-12,20
Rostov,3523,10,4,7,9,11,18,-7,19
Anzhi,3523,11,3,5,12,15,41,-26,14
Loko Moscow,3524,1,13,5,2,33,12,21,44
CSKA Moscow,3524,2,11,4,5,28,18,10,37
Spart Moscow,3524,3,9,7,4,37,26,11,34
Zenit,3524,4,7,9,4,23,16,7,30
Krasnodar,3524,5,8,4,8,30,30,0,28
Terek Grozny,3524,6,7,5,8,20,24,-4,26
FK Rubin,3524,7,6,6,8,26,21,5,24
Din Moscow,3524,8,5,7,8,18,25,-7,22
Amkar,3524,9,5,5,10,10,22,-12,20
Rostov,3524,10,4,7,9,11,18,-7,19
Anzhi,3524,11,3,5,12,15,39,-24,14
Loko Moscow,3525,1,12,6,2,32,12,20,42
CSKA Moscow,3525,2,12,3,5,30,18,12,39
Spart Moscow,3525,3,9,7,4,38,29,9,34
Krasnodar,3525,4,9,4,7,29,27,2,31
Zenit,3525,5,7,9,4,21,16,5,30
Terek Grozny,3525,6,8,6,6,21,22,-1,30
FK Rubin,3525,7,6,5,9,23,19,4,23
Din Moscow,3525,8,5,7,8,19,24,-5,22
Rostov,3525,9,4,6,10,10,18,-8,18
Amkar,3525,10,4,5,11,12,26,-14,17
Anzhi,3525,11,2,6,12,15,39,-24,12
Loko Moscow,3526,1,12,5,3,31,13,18,41
Spart Moscow,3526,2,10,6,4,41,28,13,36
CSKA Moscow,3526,3,11,3,6,27,19,8,36
Krasnodar,3526,4,9,4,7,29,27,2,31
Zenit,3526,5,7,8,5,22,16,6,29
Terek Grozny,3526,6,7,6,7,21,25,-4,27
FK Rubin,3526,7,7,5,8,24,17,7,26
Din Moscow,3526,8,5,6,9,17,25,-8,21
Rostov,3526,9,4,6,10,11,20,-9,18
Amkar,3526,10,4,6,10,12,25,-13,18
Anzhi,3526,11,4,5,11,17,37,-20,17
Loko Moscow,3527,1,11,5,4,30,14,16,38
CSKA Moscow,3527,2,11,4,5,28,19,9,37
Krasnodar,3527,3,10,4,6,31,24,7,34
Spart Moscow,3527,4,8,8,4,35,27,8,32
Zenit,3527,5,8,8,4,23,15,8,32
Terek Grozny,3527,6,7,5,8,23,27,-4,26
Din Moscow,3527,7,5,8,7,18,22,-4,23
FK Rubin,3527,8,5,6,9,21,20,1,21
Amkar,3527,9,5,5,10,12,24,-12,20
Rostov,3527,10,4,7,9,10,17,-7,19
Anzhi,3527,11,3,6,11,19,41,-22,15
Loko Moscow,3528,1,11,7,2,31,13,18,40
CSKA Moscow,3528,2,11,4,5,28,19,9,37
Spart Moscow,3528,3,9,5,6,37,29,8,32
Terek Grozny,3528,4,9,5,6,24,23,1,32
Zenit,3528,5,7,9,4,23,16,7,30
Krasnodar,3528,6,8,5,7,28,27,1,29
Din Moscow,3528,7,6,6,8,24,24,0,24
FK Rubin,3528,8,6,5,9,23,23,0,23
Rostov,3528,9,5,6,9,12,18,-6,21
Amkar,3528,10,5,4,11,11,24,-13,19
Anzhi,3528,11,2,6,12,15,40,-25,12
Loko Moscow,3529,1,12,5,3,31,14,17,41
CSKA Moscow,3529,2,12,3,5,28,17,11,39
Spart Moscow,3529,3,10,6,4,36,26,10,36
Krasnodar,3529,4,10,4,6,32,24,8,34
Terek Grozny,3529,5,9,5,6,24,22,2,32
Zenit,3529,6,7,8,5,21,17,4,29
FK Rubin,3529,7,6,5,9,23,20,3,23
Din Moscow,3529,8,5,6,9,18,24,-6,21
Rostov,3529,9,4,6,10,10,18,-8,18
Amkar,3529,10,4,5,11,10,25,-15,17
Anzhi,3529,11,2,5,13,14,40,-26,11
Loko Moscow,3530,1,12,5,3,30,12,18,41
CSKA Moscow,3530,2,10,5,5,27,19,8,35
Spart Moscow,3530,3,9,5,6,36,30,6,32
Krasnodar,3530,4,9,4,7,28,25,3,31
Zenit,3530,5,7,9,4,22,15,7,30
Terek Grozny,3530,6,7,6,7,21,24,-3,27
Din Moscow,3530,7,6,6,8,18,23,-5,24
FK Rubin,3530,8,6,5,9,22,18,4,23
Amkar,3530,9,6,4,10,12,23,-11,22
Rostov,3530,10,5,6,9,13,17,-4,21
Anzhi,3530,11,2,7,11,16,39,-23,13
Loko Moscow,3531,1,12,6,2,31,12,19,42
CSKA Moscow,3531,2,12,3,5,31,19,12,39
Spart Moscow,3531,3,9,7,4,38,28,10,34
Zenit,3531,4,7,9,4,22,16,6,30
Terek Grozny,3531,5,8,5,7,22,25,-3,29
Krasnodar,3531,6,8,4,8,30,29,1,28
FK Rubin,3531,7,6,6,8,25,20,5,24
Din Moscow,3531,8,5,8,7,19,23,-4,23
Amkar,3531,9,5,5,10,14,25,-11,20
Rostov,3531,10,4,6,10,10,19,-9,18
Anzhi,3531,11,2,5,13,15,41,-26,11
Loko Moscow,3532,1,12,5,3,31,13,18,41
CSKA Moscow,3532,2,11,4,5,26,17,9,37
Spart Moscow,3532,3,10,5,5,41,30,11,35
Krasnodar,3532,4,9,4,7,28,25,3,31
Zenit,3532,5,7,8,5,22,16,6,29
Terek Grozny,3532,6,8,5,7,22,25,-3,29
FK Rubin,3532,7,7,5,8,24,17,7,26
Rostov,3532,8,5,6,9,13,19,-6,21
Din Moscow,3532,9,5,6,9,19,27,-8,21
Amkar,3532,10,5,4,11,12,25,-13,19
Anzhi,3532,11,2,6,12,14,38,-24,12
Loko Moscow,3533,1,12,5,3,31,14,17,41
CSKA Moscow,3533,2,11,3,6,29,20,9,36
Spart Moscow,3533,3,9,6,5,35,26,9,33
Zenit,3533,4,8,8,4,23,15,8,32
Krasnodar,3533,5,9,5,6,31,26,5,32
Terek Grozny,3533,6,7,6,7,24,28,-4,27
Din Moscow,3533,7,6,7,7,20,23,-3,25
FK Rubin,3533,8,5,7,8,25,21,4,22
Rostov,3533,9,4,7,9,10,17,-7,19
Amkar,3533,10,4,5,11,12,27,-15,17
Anzhi,3533,11,3,5,12,19,42,-23,14
Loko Moscow,3534,1,13,5,2,32,11,21,44
Spart Moscow,3534,2,11,5,4,40,26,14,38
CSKA Moscow,3534,3,11,3,6,29,21,8,36
Zenit,3534,4,8,8,4,23,15,8,32
Krasnodar,3534,5,8,5,7,28,27,1,29
Terek Grozny,3534,6,7,6,7,20,23,-3,27
Din Moscow,3534,7,6,6,8,20,24,-4,24
FK Rubin,3534,8,5,6,9,23,20,3,21
Amkar,3534,9,5,4,11,10,26,-16,19
Rostov,3534,10,4,6,10,10,18,-8,18
Anzhi,3534,11,2,6,12,16,40,-24,12
Loko Moscow,3535,1,11,6,3,30,13,17,39
Spart Moscow,3535,2,10,6,4,41,30,11,36
CSKA Moscow,3535,3,11,3,6,28,21,7,36
Zenit,3535,4,8,9,3,25,15,10,33
Krasnodar,3535,5,9,5,6,28,24,4,32
Terek Grozny,3535,6,7,6,7,21,24,-3,27
Din Moscow,3535,7,6,6,8,23,26,-3,24
FK Rubin,3535,8,5,6,9,22,20,2,21
Rostov,3535,9,4,6,10,11,20,-9,18
Amkar,3535,10,4,6,10,10,23,-13,18
Anzhi,3535,11,3,5,12,17,40,-23,14
Loko Moscow,3536,1,12,6,2,33,14,19,42
CSKA Moscow,3536,2,11,3,6,26,18,8,36
Spart Moscow,3536,3,9,6,5,36,28,8,33
Zenit,3536,4,8,8,4,22,14,8,32
Krasnodar,3536,5,8,6,6,31,28,3,30
Terek Grozny,3536,6,7,5,8,21,25,-4,26
FK Rubin,3536,7,6,6,8,24,19,5,24
Din Moscow,3536,8,6,6,8,21,24,-3,24
Amkar,3536,9,5,5,10,10,22,-12,20
Rostov,3536,10,4,6,10,10,19,-9,18
Anzhi,3536,11,3,5,12,16,39,-23,14
Loko Moscow,3537,1,11,6,3,31,14,17,39
CSKA Moscow,3537,2,12,3,5,31,19,12,39
Krasnodar,3537,3,10,4,6,31,25,6,34
Spart Moscow,3537,4,9,5,6,37,31,6,32
Zenit,3537,5,7,9,4,23,16,7,30
Terek Grozny,3537,6,7,6,7,23,26,-3,27
Din Moscow,3537,7,6,7,7,22,24,-2,25
FK Rubin,3537,8,5,6,9,23,21,2,21
Amkar,3537,9,5,5,10,12,24,-12,20
Rostov,3537,10,4,6,10,12,20,-8,18
Anzhi,3537,11,3,5,12,17,42,-25,14
Loko Moscow,3538,1,12,6,2,32,13,19,42
CSKA Moscow,3538,2,11,4,5,28,17,11,37
Spart Moscow,3538,3,9,6,5,36,28,8,33
Zenit,3538,4,7,9,4,21,14,7,30
Krasnodar,3538,5,8,6,6,30,27,3,30
Terek Grozny,3538,6,7,5,8,20,25,-5,26
Din Moscow,3538,7,6,6,8,19,23,-4,24
FK Rubin,3538,8,5,6,9,22,19,3,21
Rostov,3538,9,5,6,9,11,17,-6,21
Amkar,3538,10,5,5,10,11,23,-12,20
Anzhi,3538,11,3,5,12,16,40,-24,14
Loko Moscow,3539,1,12,5,3,33,16,17,41
Spart Moscow,3539,2,10,6,4,42,27,15,36
CSKA Moscow,3539,3,11,3,6,28,19,9,36
Krasnodar,3539,4,10,4,6,33,26,7,34
Zenit,3539,5,8,8,4,24,16,8,32
Terek Grozny,3539,6,7,5,8,21,28,-7,26
Din Moscow,3539,7,6,7,7,24,23,1,25
FK Rubin,3539,8,5,5,10,22,24,-2,20
Amkar,3539,9,5,4,11,11,28,-17,19
Rostov,3539,10,4,6,10,10,19,-9,18
Anzhi,3539,11,3,5,12,18,40,-22,14
Loko Moscow,3540,1,11,6,3,30,14,16,39
CSKA Moscow,3540,2,12,3,5,30,18,12,39
Spart Moscow,3540,3,10,5,5,37,27,10,35
Krasnodar,3540,4,9,5,6,31,26,5,32
Zenit,3540,5,7,9,4,21,14,7,30
Terek Grozny,3540,6,8,5,7,23,25,-2,29
FK Rubin,3540,7,5,7,8,23,19,4,22
Din Moscow,3540,8,5,7,8,19,25,-6,22
Rostov,3540,9,5,6,9,11,17,-6,21
Amkar,3540,10,4,4,12,9,24,-15,16
Anzhi,3540,11,3,5,12,18,43,-25,14
Loko Moscow,3541,1,12,6,2,32,12,20,42
CSKA Moscow,3541,2,11,3,6,27,19,8,36
Spart Moscow,3541,3,10,5,5,39,31,8,35
Zenit,3541,4,8,8,4,22,15,7,32
Krasnodar,3541,5,9,5,6,30,26,4,32
Terek Grozny,3541,6,8,6,6,23,23,0,30
Din Moscow,3541,7,5,7,8,19,25,-6,22
FK Rubin,3541,8,5,6,9,23,20,3,21
Amkar,3541,9,5,5,10,14,24,-10,20
Rostov,3541,10,4,6,10,11,19,-8,18
Anzhi,3541,11,2,5,13,15,41,-26,11
Loko Moscow,3542,1,11,6,3,29,12,17,39
Spart Moscow,3542,2,10,6,4,39,27,12,36
CSKA Moscow,3542,3,11,3,6,27,19,8,36
Zenit,3542,4,9,8,3,24,13,11,35
Krasnodar,3542,5,8,5,7,27,26,1,29
Terek Grozny,3542,6,8,5,7,23,23,0,29
FK Rubin,3542,7,7,5,8,25,18,7,26
Din Moscow,3542,8,5,6,9,18,25,-7,21
Rostov,3542,9,4,7,9,11,18,-7,19
Amkar,3542,10,5,4,11,11,25,-14,19
Anzhi,3542,11,2,5,13,14,42,-28,11
Loko Moscow,3543,1,13,5,2,32,11,21,44
CSKA Moscow,3543,2,12,3,5,27,17,10,39
Spart Moscow,3543,3,11,5,4,40,27,13,38
Zenit,3543,4,7,8,5,21,16,5,29
Terek Grozny,3543,5,8,5,7,23,25,-2,29
Krasnodar,3543,6,8,4,8,27,26,1,28
FK Rubin,3543,7,7,5,8,23,17,6,26
Din Moscow,3543,8,5,6,9,18,25,-7,21
Rostov,3543,9,4,6,10,11,19,-8,18
Amkar,3543,10,4,4,12,9,25,-16,16
Anzhi,3543,11,3,5,12,17,40,-23,14
Loko Moscow,3544,1,11,6,3,31,14,17,39
Zenit,3544,2,9,8,3,25,14,11,35
Spart Moscow,3544,3,9,7,4,34,25,9,34
CSKA Moscow,3544,4,10,3,7,26,21,5,33
Krasnodar,3544,5,8,6,6,30,27,3,30
Terek Grozny,3544,6,7,6,7,22,25,-3,27
Din Moscow,3544,7,6,7,7,19,22,-3,25
FK Rubin,3544,8,5,6,9,24,21,3,21
Amkar,3544,9,5,5,10,11,23,-12,20
Rostov,3544,10,4,6,10,10,18,-8,18
Anzhi,3544,11,3,6,11,17,39,-22,15
Loko Moscow,3545,1,11,6,3,29,12,17,39
Spart Moscow,3545,2,10,6,4,38,27,11,36
Krasnodar,3545,3,10,4,6,30,25,5,34
CSKA Moscow,3545,4,10,4,6,27,23,4,34
Zenit,3545,5,8,9,3,25,13,12,33
Terek Grozny,3545,6,7,6,7,22,28,-6,27
FK Rubin,3545,7,6,5,9,23,19,4,23
Din Moscow,3545,8,5,6,9,17,24,-7,21
Rostov,3545,9,4,7,9,11,18,-7,19
Amkar,3545,10,5,4,11,15,25,-10,19
Anzhi,3545,11,2,7,11,17,40,-23,13
Loko Moscow,3546,1,13,5,2,32,12,20,44
CSKA Moscow,3546,2,12,3,5,35,19,16,39
Spart Moscow,3546,3,8,7,5,34,30,4,31
Krasnodar,3546,4,9,4,7,30,26,4,31
Terek Grozny,3546,5,8,6,6,22,22,0,30
Zenit,3546,6,7,8,5,22,16,6,29
Din Moscow,3546,7,5,8,7,20,24,-4,23
FK Rubin,3546,8,5,6,9,24,22,2,21
Rostov,3546,9,4,7,9,11,18,-7,19
Amkar,3546,10,5,4,11,13,24,-11,19
Anzhi,3546,11,2,6,12,15,45,-30,12
Loko Moscow,3547,1,12,5,3,32,15,17,41
CSKA Moscow,3547,2,12,3,5,28,18,10,39
Spart Moscow,3547,3,9,7,4,38,28,10,34
Zenit,3547,4,8,8,4,25,16,9,32
Terek Grozny,3547,5,8,6,6,23,24,-1,30
Krasnodar,3547,6,8,4,8,27,27,0,28
FK Rubin,3547,7,7,5,8,27,18,9,26
Din Moscow,3547,8,5,7,8,19,26,-7,22
Rostov,3547,9,4,6,10,11,20,-9,18
Amkar,3547,10,4,5,11,11,25,-14,17
Anzhi,3547,11,2,6,12,16,40,-24,12
Loko Moscow,3548,1,12,5,3,31,13,18,41
Spart Moscow,3548,2,10,5,5,36,26,10,35
Krasnodar,3548,3,10,4,6,31,25,6,34
CSKA Moscow,3548,4,10,3,7,26,20,6,33
Zenit,3548,5,8,8,4,22,14,8,32
Terek Grozny,3548,6,7,5,8,21,27,-6,26
FK Rubin,3548,7,6,5,9,23,20,3,23
Amkar,3548,8,6,4,10,13,23,-10,22
Din Moscow,3548,9,5,6,9,18,25,-7,21
Rostov,3548,10,4,6,10,10,18,-8,18
Anzhi,3548,11,4,5,11,18,38,-20,17
Loko Moscow,3549,1,12,6,2,31,12,19,42
CSKA Moscow,3549,2,11,3,6,32,19,13,36
Spart Moscow,3549,3,10,5,5,35,26,9,35
Zenit,3549,4,8,9,3,23,14,9,33
Terek Grozny,3549,5,9,5,6,22,22,0,32
Krasnodar,3549,6,9,4,7,29,26,3,31
Din Moscow,3549,7,7,6,7,19,21,-2,27
FK Rubin,3549,8,5,5,10,21,19,2,20
Rostov,3549,9,4,6,10,10,18,-8,18
Amkar,3549,10,4,4,12,9,24,-15,16
Anzhi,3549,11,2,5,13,14,44,-30,11
Loko Moscow,3550,1,13,5,2,31,11,20,44
CSKA Moscow,3550,2,10,4,6,27,20,7,34
Spart Moscow,3550,3,9,6,5,39,29,10,33
Zenit,3550,4,8,8,4,23,15,8,32
Krasnodar,3550,5,8,4,8,27,27,0,28
FK Rubin,3550,6,7,5,8,25,17,8,26
Terek Grozny,3550,7,7,5,8,21,27,-6,26
Din Moscow,3550,8,6,6,8,20,25,-5,24
Amkar,3550,9,5,5,10,13,23,-10,20
Rostov,3550,10,4,6,10,10,20,-10,18
Anzhi,3550,11,3,6,11,17,39,-22,15
Loko Moscow,3551,1,13,5,2,34,12,22,44
CSKA Moscow,3551,2,11,4,5,28,18,10,37
Spart Moscow,3551,3,10,6,4,38,28,10,36
Zenit,3551,4,7,9,4,22,17,5,30
Krasnodar,3551,5,8,4,8,28,29,-1,28
Terek Grozny,3551,6,7,6,7,20,25,-5,27
FK Rubin,3551,7,7,5,8,26,18,8,26
Din Moscow,3551,8,5,6,9,19,25,-6,21
Rostov,3551,9,4,6,10,10,18,-8,18
Amkar,3551,10,4,6,10,11,24,-13,18
Anzhi,3551,11,3,5,12,17,39,-22,14
Loko Moscow,3552,1,11,5,4,29,13,16,38
CSKA Moscow,3552,2,11,3,6,28,20,8,36
Zenit,3552,3,9,8,3,25,15,10,35
Spart Moscow,3552,4,9,6,5,39,29,10,33
Krasnodar,3552,5,9,5,6,28,24,4,32
Terek Grozny,3552,6,8,5,7,22,24,-2,29
Din Moscow,3552,7,5,8,7,18,22,-4,23
FK Rubin,3552,8,5,7,8,21,17,4,22
Amkar,3552,9,6,4,10,13,23,-10,22
Rostov,3552,10,4,6,10,11,21,-10,18
Anzhi,3552,11,2,5,13,14,40,-26,11
Loko Moscow,3553,1,13,5,2,38,15,23,44
Spart Moscow,3553,2,10,6,4,39,25,14,36
CSKA Moscow,3553,3,11,3,6,28,18,10,36
Zenit,3553,4,8,8,4,25,17,8,32
Terek Grozny,3553,5,9,5,6,24,22,2,32
Krasnodar,3553,6,8,4,8,29,31,-2,28
FK Rubin,3553,7,6,6,8,24,19,5,24
Din Moscow,3553,8,5,7,8,18,25,-7,22
Rostov,3553,9,4,7,9,10,17,-7,19
Amkar,3553,10,4,4,12,9,28,-19,16
Anzhi,3553,11,2,5,13,14,41,-27,11
Loko Moscow,3554,1,12,5,3,33,16,17,41
Spart Moscow,3554,2,10,5,5,41,30,11,35
CSKA Moscow,3554,3,10,5,5,26,18,8,35
Krasnodar,3554,4,9,4,7,31,27,4,31
Zenit,3554,5,7,9,4,23,16,7,30
Terek Grozny,3554,6,8,6,6,24,24,0,30
FK Rubin,3554,7,7,5,8,26,18,8,26
Rostov,3554,8,5,6,9,12,17,-5,21
Din Moscow,3554,9,5,6,9,20,30,-10,21
Amkar,3554,10,4,5,11,11,26,-15,17
Anzhi,3554,11,2,6,12,15,40,-25,12
Loko Moscow,3555,1,12,6,2,32,13,19,42
CSKA Moscow,3555,2,11,3,6,28,18,10,36
Spart Moscow,3555,3,9,6,5,40,31,9,33
Zenit,3555,4,8,8,4,23,15,8,32
Krasnodar,3555,5,9,5,6,30,25,5,32
Terek Grozny,3555,6,8,5,7,21,23,-2,29
FK Rubin,3555,7,6,5,9,24,20,4,23
Din Moscow,3555,8,5,7,8,21,27,-6,22
Rostov,3555,9,5,6,9,12,18,-6,21
Amkar,3555,10,4,4,12,10,26,-16,16
Anzhi,3555,11,3,5,12,15,40,-25,14
Loko Moscow,3556,1,12,5,3,31,13,18,41
CSKA Moscow,3556,2,11,4,5,28,17,11,37
Spart Moscow,3556,3,9,5,6,36,31,5,32
Krasnodar,3556,4,9,4,7,28,25,3,31
Zenit,3556,5,7,9,4,22,15,7,30
Terek Grozny,3556,6,8,6,6,25,24,1,30
FK Rubin,3556,7,6,6,8,23,18,5,24
Din Moscow,3556,8,5,7,8,19,24,-5,22
Rostov,3556,9,5,6,9,12,17,-5,21
Amkar,3556,10,5,4,11,12,26,-14,19
Anzhi,3556,11,2,6,12,16,42,-26,12
Loko Moscow,3557,1,11,6,3,30,13,17,39
CSKA Moscow,3557,2,11,4,5,30,18,12,37
Spart Moscow,3557,3,10,6,4,40,29,11,36
Krasnodar,3557,4,10,4,6,30,25,5,34
Zenit,3557,5,7,10,3,22,14,8,31
Terek Grozny,3557,6,7,7,6,20,22,-2,28
Din Moscow,3557,7,5,7,8,18,24,-6,22
FK Rubin,3557,8,5,6,9,21,18,3,21
Rostov,3557,9,4,6,10,13,21,-8,18
Amkar,3557,10,4,6,10,9,22,-13,18
Anzhi,3557,11,2,6,12,14,41,-27,12
Loko Moscow,3558,1,13,5,2,33,12,21,44
Spart Moscow,3558,2,9,6,5,38,31,7,33
CSKA Moscow,3558,3,10,3,7,25,20,5,33
Zenit,3558,4,8,8,4,23,15,8,32
Krasnodar,3558,5,8,5,7,29,27,2,29
Terek Grozny,3558,6,7,5,8,20,25,-5,26
FK Rubin,3558,7,6,6,8,25,18,7,24
Amkar,3558,8,6,4,10,14,22,-8,22
Din Moscow,3558,9,5,6,9,18,28,-10,21
Rostov,3558,10,4,7,9,11,18,-7,19
Anzhi,3558,11,4,5,11,17,37,-20,17
Loko Moscow,3559,1,11,6,3,30,14,16,39
CSKA Moscow,3559,2,11,3,6,28,22,6,36
Zenit,3559,3,9,8,3,26,13,13,35
Spart Moscow,3559,4,10,5,5,37,26,11,35
Krasnodar,3559,5,9,5,6,30,25,5,32
Terek Grozny,3559,6,9,5,6,22,22,0,32
FK Rubin,3559,7,6,5,9,22,19,3,23
Din Moscow,3559,8,5,6,9,17,25,-8,21
Amkar,3559,9,5,4,11,10,23,-13,19
Rostov,3559,10,4,6,10,10,18,-8,18
Anzhi,3559,11,2,5,13,16,41,-25,11
Loko Moscow,3560,1,12,6,2,32,12,20,42
CSKA Moscow,3560,2,12,3,5,29,18,11,39
Spart Moscow,3560,3,9,7,4,37,27,10,34
Krasnodar,3560,4,9,5,6,31,26,5,32
Terek Grozny,3560,5,8,6,6,22,23,-1,30
Zenit,3560,6,7,8,5,21,17,4,29
Din Moscow,3560,7,6,7,7,21,22,-1,25
FK Rubin,3560,8,5,5,10,22,23,-1,20
Rostov,3560,9,4,7,9,10,17,-7,19
Amkar,3560,10,4,5,11,11,26,-15,17
Anzhi,3560,11,2,5,13,15,40,-25,11
Loko Moscow,3561,1,12,5,3,30,12,18,41
CSKA Moscow,3561,2,12,3,5,29,19,10,39
Krasnodar,3561,3,9,4,7,28,25,3,31
Spart Moscow,3561,4,8,6,6,36,31,5,30
Zenit,3561,5,7,8,5,22,16,6,29
Terek Grozny,3561,6,8,5,7,22,25,-3,29
FK Rubin,3561,7,7,5,8,23,17,6,26
Din Moscow,3561,8,6,6,8,20,24,-4,24
Rostov,3561,9,5,6,9,12,17,-5,21
Amkar,3561,10,5,5,10,12,23,-11,20
Anzhi,3561,11,2,5,13,16,41,-25,11
Loko Moscow,3562,1,12,6,2,30,11,19,42
Spart Moscow,3562,2,11,5,4,38,26,12,38
CSKA Moscow,3562,3,11,4,5,31,18,13,37
Krasnodar,3562,4,9,5,6,30,25,5,32
Zenit,3562,5,7,9,4,22,15,7,30
Terek Grozny,3562,6,8,5,7,22,25,-3,29
Din Moscow,3562,7,6,6,8,19,22,-3,24
FK Rubin,3562,8,5,5,10,22,22,0,20
Amkar,3562,9,5,4,11,11,24,-13,19
Rostov,3562,10,4,6,10,11,19,-8,18
Anzhi,3562,11,2,5,13,15,44,-29,11
Loko Moscow,3563,1,11,6,3,29,16,13,39
Spart Moscow,3563,2,10,6,4,42,26,16,36
CSKA Moscow,3563,3,11,3,6,27,19,8,36
Zenit,3563,4,8,9,3,23,13,10,33
Terek Grozny,3563,5,9,5,6,23,23,0,32
Krasnodar,3563,6,9,4,7,33,26,7,31
Din Moscow,3563,7,6,6,8,19,26,-7,24
FK Rubin,3563,8,6,5,9,23,20,3,23
Rostov,3563,9,4,7,9,10,17,-7,19
Amkar,3563,10,4,4,12,11,28,-17,16
Anzhi,3563,11,2,5,13,14,40,-26,11
Loko Moscow,3564,1,11,7,2,30,12,18,40
CSKA Moscow,3564,2,11,4,5,27,17,10,37
Spart Moscow,3564,3,9,6,5,36,28,8,33
Krasnodar,3564,4,9,5,6,31,27,4,32
Zenit,3564,5,7,10,3,21,13,8,31
Terek Grozny,3564,6,8,5,7,24,24,0,29
Din Moscow,3564,7,6,6,8,20,23,-3,24
FK Rubin,3564,8,6,5,9,25,21,4,23
Amkar,3564,9,5,5,10,11,23,-12,20
Rostov,3564,10,4,6,10,10,19,-9,18
Anzhi,3564,11,2,5,13,15,43,-28,11
Loko Moscow,3565,1,12,5,3,31,13,18,41
CSKA Moscow,3565,2,11,3,6,32,21,11,36
Spart Moscow,3565,3,10,5,5,38,30,8,35
Zenit,3565,4,8,8,4,25,17,8,32
Krasnodar,3565,5,9,4,7,28,25,3,31
Terek Grozny,3565,6,8,6,6,23,24,-1,30
Din Moscow,3565,7,6,7,7,22,23,-1,25
FK Rubin,3565,8,6,6,8,23,18,5,24
Rostov,3565,9,4,6,10,11,19,-8,18
Amkar,3565,10,4,5,11,9,24,-15,17
Anzhi,3565,11,2,5,13,17,45,-28,11
Loko Moscow,3566,1,11,5,4,29,14,15,38
CSKA Moscow,3566,2,10,5,5,27,19,8,35
Krasnodar,3566,3,10,4,6,31,24,7,34
Zenit,3566,4,8,9,3,24,14,10,33
Spart Moscow,3566,5,9,5,6,36,30,6,32
Terek Grozny,3566,6,8,5,7,23,24,-1,29
Din Moscow,3566,7,6,6,8,18,24,-6,24
FK Rubin,3566,8,6,5,9,24,20,4,23
Amkar,3566,9,5,4,11,13,26,-13,19
Rostov,3566,10,4,6,10,11,19,-8,18
Anzhi,3566,11,3,6,11,16,38,-22,15
Loko Moscow,3567,1,11,5,4,29,14,15,38
CSKA Moscow,3567,2,10,5,5,27,19,8,35
Krasnodar,3567,3,10,4,6,30,25,5,34
Zenit,3567,4,8,9,3,23,13,10,33
Spart Moscow,3567,5,9,5,6,34,27,7,32
Terek Grozny,3567,6,7,6,7,21,25,-4,27
Din Moscow,3567,7,6,6,8,18,22,-4,24
FK Rubin,3567,8,6,5,9,23,19,4,23
Rostov,3567,9,5,6,9,11,17,-6,21
Amkar,3567,10,5,4,11,12,24,-12,19
Anzhi,3567,11,2,7,11,16,39,-23,13
Loko Moscow,3568,1,11,7,2,30,12,18,40
CSKA Moscow,3568,2,12,3,5,27,17,10,39
Spart Moscow,3568,3,9,5,6,40,32,8,32
Krasnodar,3568,4,9,5,6,30,25,5,32
Zenit,3568,5,7,9,4,21,14,7,30
Terek Grozny,3568,6,8,6,6,23,23,0,30
Din Moscow,3568,7,7,6,7,23,25,-2,27
FK Rubin,3568,8,5,5,10,23,22,1,20
Amkar,3568,9,5,5,10,12,23,-11,20
Rostov,3568,10,4,6,10,12,22,-10,18
Anzhi,3568,11,2,5,13,14,40,-26,11
Loko Moscow,3569,1,12,6,2,32,13,19,42
CSKA Moscow,3569,2,12,3,5,31,18,13,39
Spart Moscow,3569,3,10,5,5,39,28,11,35
Zenit,3569,4,7,9,4,21,14,7,30
Krasnodar,3569,5,8,5,7,30,28,2,29
Terek Grozny,3569,6,7,5,8,22,27,-5,26
FK Rubin,3569,7,6,6,8,23,18,5,24
Rostov,3569,8,5,6,9,12,18,-6,21
Din Moscow,3569,9,5,6,9,17,25,-8,21
Amkar,3569,10,5,4,11,14,26,-12,19
Anzhi,3569,11,3,5,12,16,42,-26,14
Loko Moscow,3570,1,11,5,4,30,15,15,38
CSKA Moscow,3570,2,11,4,5,27,18,9,37
Spart Moscow,3570,3,9,6,5,37,27,10,33
Zenit,3570,4,8,9,3,23,14,9,33
Krasnodar,3570,5,9,4,7,31,27,4,31
Terek Grozny,3570,6,8,5,7,23,24,-1,29
FK Rubin,3570,7,7,5,8,25,19,6,26
Din Moscow,3570,8,6,6,8,19,23,-4,24
Rostov,3570,9,4,7,9,11,18,-7,19
Amkar,3570,10,4,4,12,10,28,-18,16
Anzhi,3570,11,3,5,12,15,38,-23,14
Loko Moscow,3571,1,12,6,2,32,12,20,42
CSKA Moscow,3571,2,11,4,5,26,17,9,37
Spart Moscow,3571,3,10,5,5,36,29,7,35
Zenit,3571,4,7,8,5,21,16,5,29
Krasnodar,3571,5,8,5,7,28,26,2,29
Terek Grozny,3571,6,7,6,7,23,27,-4,27
FK Rubin,3571,7,6,6,8,22,17,5,24
Din Moscow,3571,8,5,7,8,18,23,-5,22
Rostov,3571,9,5,6,9,13,17,-4,21
Amkar,3571,10,5,4,11,11,23,-12,19
Anzhi,3571,11,2,7,11,17,40,-23,13
CSKA Moscow,3572,1,12,3,5,29,18,11,39
Loko Moscow,3572,2,11,5,4,29,13,16,38
Spart Moscow,3572,3,11,5,4,41,27,14,38
Krasnodar,3572,4,10,4,6,31,26,5,34
Zenit,3572,5,8,8,4,22,14,8,32
Terek Grozny,3572,6,7,6,7,22,26,-4,27
Din Moscow,3572,7,6,6,8,20,24,-4,24
FK Rubin,3572,8,5,5,10,24,23,1,20
Amkar,3572,9,5,4,11,11,25,-14,19
Rostov,3572,10,4,6,10,12,20,-8,18
Anzhi,3572,11,2,6,12,17,42,-25,12
Loko Moscow,3573,1,12,5,3,30,12,18,41
CSKA Moscow,3573,2,10,4,6,26,20,6,34
Zenit,3573,3,8,8,4,23,14,9,32
Spart Moscow,3573,4,8,7,5,37,30,7,31
Krasnodar,3573,5,9,4,7,29,28,1,31
Terek Grozny,3573,6,8,6,6,23,23,0,30
FK Rubin,3573,7,7,5,8,27,19,8,26
Din Moscow,3573,8,6,6,8,20,24,-4,24
Rostov,3573,9,4,7,9,12,19,-7,19
Amkar,3573,10,4,5,11,10,25,-15,17
Anzhi,3573,11,2,7,11,16,39,-23,13
Loko Moscow,3574,1,12,5,3,30,12,18,41
CSKA Moscow,3574,2,11,4,5,26,17,9,37
Spart Moscow,3574,3,10,5,5,36,26,10,35
Zenit,3574,4,8,9,3,22,13,9,33
Krasnodar,3574,5,8,4,8,28,27,1,28
Din Moscow,3574,6,7,6,7,19,21,-2,27
Terek Grozny,3574,7,7,6,7,21,27,-6,27
FK Rubin,3574,8,6,5,9,23,19,4,23
Rostov,3574,9,4,6,10,10,18,-8,18
Amkar,3574,10,4,5,11,10,25,-15,17
Anzhi,3574,11,3,5,12,18,38,-20,14
Loko Moscow,3575,1,12,6,2,32,13,19,42
CSKA Moscow,3575,2,11,3,6,27,19,8,36
Spart Moscow,3575,3,9,5,6,38,32,6,32
Krasnodar,3575,4,9,5,6,31,27,4,32
Zenit,3575,5,7,8,5,22,16,6,29
Terek Grozny,3575,6,7,6,7,20,24,-4,27
FK Rubin,3575,7,6,5,9,25,21,4,23
Rostov,3575,8,5,6,9,13,17,-4,21
Din Moscow,3575,9,5,6,9,19,28,-9,21
Amkar,3575,10,5,5,10,13,23,-10,20
Anzhi,3575,11,4,5,11,17,37,-20,17
Loko Moscow,3576,1,12,6,2,33,14,19,42
Spart Moscow,3576,2,10,5,5,40,31,9,35
CSKA Moscow,3576,3,10,4,6,28,21,7,34
Zenit,3576,4,7,10,3,26,18,8,31
Krasnodar,3576,5,8,4,8,28,29,-1,28
Terek Grozny,3576,6,7,5,8,21,26,-5,26
FK Rubin,3576,7,6,6,8,25,18,7,24
Din Moscow,3576,8,5,7,8,20,25,-5,22
Rostov,3576,9,5,6,9,13,18,-5,21
Amkar,3576,10,5,4,11,12,26,-14,19
Anzhi,3576,11,4,5,11,17,37,-20,17
Loko Moscow,3577,1,11,5,4,30,15,15,38
Spart Moscow,3577,2,9,7,4,39,29,10,34
CSKA Moscow,3577,3,10,4,6,27,20,7,34
Zenit,3577,4,8,9,3,23,14,9,33
Terek Grozny,3577,5,9,5,6,26,23,3,32
Krasnodar,3577,6,9,4,7,30,26,4,31
Din Moscow,3577,7,6,6,8,19,24,-5,24
FK Rubin,3577,8,6,5,9,22,18,4,23
Rostov,3577,9,4,7,9,11,18,-7,19
Amkar,3577,10,4,5,11,11,27,-16,17
Anzhi,3577,11,3,5,12,17,41,-24,14
Loko Moscow,3578,1,12,6,2,34,12,22,42
Spart Moscow,3578,2,10,6,4,40,26,14,36
CSKA Moscow,3578,3,11,3,6,27,18,9,36
Terek Grozny,3578,4,8,6,6,25,26,-1,30
Krasnodar,3578,5,8,5,7,29,27,2,29
Zenit,3578,6,7,8,5,21,19,2,29
FK Rubin,3578,7,7,5,8,25,18,7,26
Din Moscow,3578,8,5,6,9,17,28,-11,21
Rostov,3578,9,4,6,10,10,18,-8,18
Amkar,3578,10,4,5,11,12,26,-14,17
Anzhi,3578,11,3,6,11,17,39,-22,15
Loko Moscow,3579,1,13,5,2,32,11,21,44
Spart Moscow,3579,2,11,5,4,38,26,12,38
CSKA Moscow,3579,3,10,4,6,26,19,7,34
Zenit,3579,4,8,8,4,22,15,7,32
Krasnodar,3579,5,9,4,7,30,25,5,31
Terek Grozny,3579,6,7,6,7,20,23,-3,27
Din Moscow,3579,7,5,7,8,17,22,-5,22
FK Rubin,3579,8,5,6,9,21,20,1,21
Rostov,3579,9,4,6,10,10,19,-9,18
Amkar,3579,10,4,5,11,10,24,-14,17
Anzhi,3579,11,3,6,11,16,38,-22,15
Loko Moscow,3580,1,11,7,2,31,13,18,40
Zenit,3580,2,8,9,3,25,14,11,33
CSKA Moscow,3580,3,10,3,7,27,23,4,33
Krasnodar,3580,4,9,5,6,31,26,5,32
Terek Grozny,3580,5,8,6,6,22,23,-1,30
Spart Moscow,3580,6,8,5,7,33,29,4,29
Din Moscow,3580,7,6,7,7,21,23,-2,25
FK Rubin,3580,8,5,6,9,23,21,2,21
Rostov,3580,9,5,6,9,11,17,-6,21
Amkar,3580,10,5,4,11,10,23,-13,19
Anzhi,3580,11,3,6,11,17,39,-22,15
Loko Moscow,3581,1,11,5,4,29,14,15,38
CSKA Moscow,3581,2,11,3,6,27,18,9,36
Zenit,3581,3,9,8,3,23,13,10,35
Krasnodar,3581,4,9,4,7,29,26,3,31
Spart Moscow,3581,5,8,5,7,34,30,4,29
Din Moscow,3581,6,7,6,7,21,21,0,27
Terek Grozny,3581,7,7,6,7,21,27,-6,27
FK Rubin,3581,8,6,5,9,23,19,4,23
Rostov,3581,9,5,6,9,11,17,-6,21
Amkar,3581,10,5,5,10,12,24,-12,20
Anzhi,3581,11,3,5,12,18,39,-21,14
Loko Moscow,3582,1,11,6,3,30,17,13,39
CSKA Moscow,3582,2,11,3,6,29,20,9,36
Spart Moscow,3582,3,10,5,5,39,31,8,35
Zenit,3582,4,8,9,3,25,15,10,33
Krasnodar,3582,5,9,5,6,33,25,8,32
Terek Grozny,3582,6,8,5,7,23,24,-1,29
Din Moscow,3582,7,6,6,8,21,23,-2,24
FK Rubin,3582,8,5,6,9,22,21,1,21
Rostov,3582,9,5,6,9,13,18,-5,21
Amkar,3582,10,5,4,11,12,25,-13,19
Anzhi,3582,11,2,5,13,15,43,-28,11
Loko Moscow,3583,1,13,5,2,34,12,22,44
Spart Moscow,3583,2,10,6,4,40,30,10,36
CSKA Moscow,3583,3,10,5,5,25,17,8,35
Zenit,3583,4,7,9,4,22,16,6,30
Krasnodar,3583,5,8,4,8,27,31,-4,28
FK Rubin,3583,6,7,5,8,28,18,10,26
Terek Grozny,3583,7,7,5,8,21,26,-5,26
Din Moscow,3583,8,5,6,9,19,25,-6,21
Rostov,3583,9,4,7,9,12,19,-7,19
Amkar,3583,10,5,4,11,12,25,-13,19
Anzhi,3583,11,3,6,11,17,38,-21,15
Loko Moscow,3584,1,12,5,3,32,14,18,41
CSKA Moscow,3584,2,12,3,5,27,17,10,39
Spart Moscow,3584,3,10,5,5,37,28,9,35
Zenit,3584,4,8,8,4,23,15,8,32
Krasnodar,3584,5,9,4,7,30,26,4,31
Terek Grozny,3584,6,8,5,7,25,27,-2,29
FK Rubin,3584,7,6,5,9,22,19,3,23
Rostov,3584,8,5,6,9,13,17,-4,21
Din Moscow,3584,9,5,6,9,17,25,-8,21
Amkar,3584,10,4,4,12,10,26,-16,16
Anzhi,3584,11,3,5,12,18,40,-22,14
Loko Moscow,3585,1,12,5,3,31,13,18,41
CSKA Moscow,3585,2,11,4,5,30,18,12,37
Zenit,3585,3,8,9,3,24,14,10,33
Spart Moscow,3585,4,9,5,6,36,29,7,32
Terek Grozny,3585,5,8,5,7,24,24,0,29
Krasnodar,3585,6,8,4,8,28,28,0,28
Din Moscow,3585,7,6,7,7,20,23,-3,25
FK Rubin,3585,8,6,6,8,24,19,5,24
Amkar,3585,9,6,4,10,13,23,-10,22
Rostov,3585,10,4,6,10,10,19,-9,18
Anzhi,3585,11,2,5,13,14,44,-30,11
Loko Moscow,3586,1,12,6,2,31,11,20,42
CSKA Moscow,3586,2,12,3,5,27,17,10,39
Krasnodar,3586,3,9,5,6,29,24,5,32
Spart Moscow,3586,4,8,7,5,35,30,5,31
Zenit,3586,5,7,8,5,21,16,5,29
Terek Grozny,3586,6,7,6,7,22,26,-4,27
Din Moscow,3586,7,6,7,7,19,22,-3,25
Amkar,3586,8,6,4,10,15,23,-8,22
FK Rubin,3586,9,5,5,10,21,20,1,20
Rostov,3586,10,4,7,9,10,17,-7,19
Anzhi,3586,11,2,6,12,16,40,-24,12
Loko Moscow,3587,1,12,6,2,30,11,19,42
Spart Moscow,3587,2,11,5,4,41,26,15,38
CSKA Moscow,3587,3,11,3,6,29,21,8,36
Zenit,3587,4,8,8,4,23,14,9,32
Krasnodar,3587,5,9,5,6,28,24,4,32
Terek Grozny,3587,6,7,6,7,20,26,-6,27
Din Moscow,3587,7,5,7,8,19,28,-9,22
FK Rubin,3587,8,5,6,9,23,20,3,21
Rostov,3587,9,4,6,10,11,19,-8,18
Amkar,3587,10,4,5,11,9,23,-14,17
Anzhi,3587,11,3,5,12,20,41,-21,14
Loko Moscow,3588,1,12,5,3,30,13,17,41
CSKA Moscow,3588,2,11,4,5,27,17,10,37
Krasnodar,3588,3,10,4,6,31,24,7,34
Spart Moscow,3588,4,9,5,6,38,30,8,32
Terek Grozny,3588,5,9,5,6,25,22,3,32
Zenit,3588,6,7,8,5,21,16,5,29
Din Moscow,3588,7,6,7,7,21,22,-1,25
FK Rubin,3588,8,5,6,9,22,20,2,21
Amkar,3588,9,5,4,11,11,25,-14,19
Rostov,3588,10,4,6,10,10,21,-11,18
Anzhi,3588,11,2,6,12,14,40,-26,12
Loko Moscow,3589,1,12,5,3,32,14,18,41
CSKA Moscow,3589,2,11,3,6,26,18,8,36
Zenit,3589,3,9,8,3,24,14,10,35
Spart Moscow,3589,4,8,7,5,35,28,7,31
Terek Grozny,3589,5,8,6,6,24,23,1,30
Krasnodar,3589,6,8,5,7,30,28,2,29
Din Moscow,3589,7,6,7,7,19,22,-3,25
FK Rubin,3589,8,5,6,9,23,20,3,21
Rostov,3589,9,5,6,9,11,17,-6,21
Amkar,3589,10,4,5,11,10,26,-16,17
Anzhi,3589,11,2,6,12,15,39,-24,12
Loko Moscow,3590,1,12,6,2,32,11,21,42
CSKA Moscow,3590,2,11,3,6,27,19,8,36
Zenit,3590,3,8,9,3,23,13,10,33
Spart Moscow,3590,4,9,6,5,40,31,9,33
Krasnodar,3590,5,8,4,8,27,28,-1,28
Terek Grozny,3590,6,7,6,7,21,24,-3,27
FK Rubin,3590,7,7,5,8,25,17,8,26
Din Moscow,3590,8,5,7,8,19,26,-7,22
Amkar,3590,9,6,4,10,13,24,-11,22
Rostov,3590,10,4,6,10,12,21,-9,18
Anzhi,3590,11,2,6,12,14,39,-25,12
Loko Moscow,3591,1,12,6,2,32,13,19,42
CSKA Moscow,3591,2,10,4,6,28,24,4,34
Zenit,3591,3,8,8,4,27,16,11,32
Spart Moscow,3591,4,8,7,5,35,30,5,31
Terek Grozny,3591,5,8,6,6,22,23,-1,30
Krasnodar,3591,6,8,5,7,29,27,2,29
Din Moscow,3591,7,6,7,7,20,22,-2,25
FK Rubin,3591,8,6,5,9,23,20,3,23
Rostov,3591,9,4,7,9,11,18,-7,19
Amkar,3591,10,5,4,11,12,23,-11,19
Anzhi,3591,11,2,7,11,17,40,-23,13
Loko Moscow,3592,1,11,7,2,32,14,18,40
Spart Moscow,3592,2,10,6,4,36,26,10,36
CSKA Moscow,3592,3,10,5,5,25,17,8,35
Zenit,3592,4,7,10,3,22,14,8,31
Krasnodar,3592,5,8,6,6,29,26,3,30
Terek Grozny,3592,6,8,6,6,24,24,0,30
FK Rubin,3592,7,6,6,8,24,18,6,24
Din Moscow,3592,8,5,6,9,19,26,-7,21
Rostov,3592,9,4,6,10,10,18,-8,18
Amkar,3592,10,4,6,10,10,23,-13,18
Anzhi,3592,11,2,6,12,15,40,-25,12
Loko Moscow,3593,1,12,6,2,32,12,20,42
CSKA Moscow,3593,2,11,4,5,30,21,9,37
Spart Moscow,3593,3,10,5,5,41,29,12,35
Zenit,3593,4,7,10,3,23,15,8,31
Krasnodar,3593,5,9,4,7,33,27,6,31
Terek Grozny,3593,6,8,5,7,26,27,-1,29
Din Moscow,3593,7,6,6,8,21,25,-4,24
FK Rubin,3593,8,5,5,10,21,25,-4,20
Amkar,3593,9,5,4,11,12,27,-15,19
Rostov,3593,10,4,6,10,12,21,-9,18
Anzhi,3593,11,3,5,12,19,41,-22,14
Loko Moscow,3594,1,13,5,2,33,12,21,44
CSKA Moscow,3594,2,10,4,6,26,19,7,34
Spart Moscow,3594,3,8,8,4,38,30,8,32
Zenit,3594,4,7,9,4,22,16,6,30
Krasnodar,3594,5,8,5,7,28,26,2,29
Terek Grozny,3594,6,8,5,7,24,25,-1,29
Din Moscow,3594,7,5,8,7,20,24,-4,23
FK Rubin,3594,8,5,7,8,23,19,4,22
Rostov,3594,9,4,7,9,11,18,-7,19
Amkar,3594,10,4,5,11,11,28,-17,17
Anzhi,3594,11,4,5,11,19,38,-19,17
Loko Moscow,3595,1,12,6,2,33,12,21,42
CSKA Moscow,3595,2,10,4,6,25,19,6,34
Spart Moscow,3595,3,9,5,6,37,29,8,32
Zenit,3595,4,7,10,3,22,14,8,31
Terek Grozny,3595,5,8,6,6,25,24,1,30
Krasnodar,3595,6,8,4,8,27,28,-1,28
Din Moscow,3595,7,7,6,7,21,23,-2,27
FK Rubin,3595,8,6,5,9,23,19,4,23
Rostov,3595,9,5,6,9,12,18,-6,21
Amkar,3595,10,4,4,12,10,28,-18,16
Anzhi,3595,11,3,6,11,17,38,-21,15
Loko Moscow,3596,1,11,6,3,31,16,15,39
CSKA Moscow,3596,2,11,4,5,30,20,10,37
Zenit,3596,3,8,8,4,26,17,9,32
Krasnodar,3596,4,9,5,6,30,25,5,32
Spart Moscow,3596,5,8,7,5,36,31,5,31
Terek Grozny,3596,6,8,5,7,22,24,-2,29
Din Moscow,3596,7,6,7,7,20,23,-3,25
Amkar,3596,8,6,4,10,14,23,-9,22
FK Rubin,3596,9,5,5,10,22,21,1,20
Rostov,3596,10,4,7,9,12,19,-7,19
Anzhi,3596,11,2,6,12,16,40,-24,12
Loko Moscow,3597,1,11,6,3,32,15,17,39
CSKA Moscow,3597,2,12,3,5,30,17,13,39
Spart Moscow,3597,3,11,5,4,44,26,18,38
Zenit,3597,4,8,8,4,23,16,7,32
Krasnodar,3597,5,9,5,6,31,27,4,32
Terek Grozny,3597,6,8,5,7,22,24,-2,29
Din Moscow,3597,7,6,6,8,22,24,-2,24
FK Rubin,3597,8,5,5,10,22,24,-2,20
Amkar,3597,9,5,4,11,11,25,-14,19
Rostov,3597,10,4,6,10,11,22,-11,18
Anzhi,3597,11,2,5,13,14,42,-28,11
Loko Moscow,3598,1,12,6,2,33,13,20,42
CSKA Moscow,3598,2,11,3,6,29,19,10,36
Spart Moscow,3598,3,9,6,5,35,29,6,33
Zenit,3598,4,8,8,4,23,16,7,32
Krasnodar,3598,5,8,5,7,30,28,2,29
Terek Grozny,3598,6,8,5,7,23,24,-1,29
FK Rubin,3598,7,7,5,8,24,18,6,26
Din Moscow,3598,8,5,7,8,17,22,-5,22
Rostov,3598,9,5,6,9,14,18,-4,21
Amkar,3598,10,5,4,11,10,23,-13,19
Anzhi,3598,11,2,5,13,15,43,-28,11
Loko Moscow,3599,1,11,6,3,29,12,17,39
CSKA Moscow,3599,2,11,3,6,27,20,7,36
Zenit,3599,3,9,8,3,24,13,11,35
Spart Moscow,3599,4,9,6,5,35,28,7,33
Krasnodar,3599,5,8,6,6,28,25,3,30
Terek Grozny,3599,6,7,6,7,21,25,-4,27
FK Rubin,3599,7,5,7,8,22,18,4,22
Din Moscow,3599,8,5,7,8,17,22,-5,22
Rostov,3599,9,5,6,9,12,17,-5,21
Amkar,3599,10,4,6,10,11,24,-13,18
Anzhi,3599,11,3,5,12,17,39,-22,14
Loko Moscow,3600,1,12,6,2,34,14,20,42
Spart Moscow,3600,2,10,5,5,40,29,11,35
CSKA Moscow,3600,3,10,4,6,27,20,7,34
Zenit,3600,4,8,8,4,23,16,7,32
Krasnodar,3600,5,8,6,6,30,27,3,30
Terek Grozny,3600,6,8,6,6,22,22,0,30
Din Moscow,3600,7,6,6,8,19,25,-6,24
FK Rubin,3600,8,5,6,9,23,20,3,21
Amkar,3600,9,5,5,10,13,23,-10,20
Rostov,3600,10,4,6,10,10,20,-10,18
Anzhi,3600,11,2,6,12,16,41,-25,12
Loko Moscow,3601,1,12,5,3,33,14,19,41
Spart Moscow,3601,2,11,5,4,43,27,16,38
CSKA Moscow,3601,3,11,3,6,29,20,9,36
Zenit,3601,4,9,8,3,24,14,10,35
Krasnodar,3601,5,8,5,7,30,29,1,29
Terek Grozny,3601,6,7,5,8,20,25,-5,26
Din Moscow,3601,7,6,6,8,19,24,-5,24
FK Rubin,3601,8,5,6,9,23,20,3,21
Amkar,3601,9,5,4,11,13,28,-15,19
Rostov,3601,10,4,6,10,10,19,-9,18
Anzhi,3601,11,3,5,12,16,40,-24,14
Loko Moscow,3602,1,13,5,2,33,12,21,44
Spart Moscow,3602,2,10,6,4,37,26,11,36
CSKA Moscow,3602,3,11,3,6,28,21,7,36
Zenit,3602,4,8,8,4,24,15,9,32
Krasnodar,3602,5,9,4,7,32,26,6,31
Terek Grozny,3602,6,7,7,6,21,23,-2,28
Din Moscow,3602,7,6,6,8,19,23,-4,24
FK Rubin,3602,8,5,5,10,21,23,-2,20
Rostov,3602,9,4,7,9,11,18,-7,19
Amkar,3602,10,4,5,11,10,24,-14,17
Anzhi,3602,11,2,6,12,15,40,-25,12
Loko Moscow,3603,1,12,5,3,32,14,18,41
CSKA Moscow,3603,2,12,3,5,29,17,12,39
Spart Moscow,3603,3,10,6,4,37,26,11,36
Krasnodar,3603,4,10,4,6,32,25,7,34
Terek Grozny,3603,5,9,5,6,24,22,2,32
Zenit,3603,6,7,8,5,21,17,4,29
Din Moscow,3603,7,5,7,8,19,24,-5,22
FK Rubin,3603,8,5,6,9,23,21,2,21
Rostov,3603,9,4,7,9,11,18,-7,19
Amkar,3603,10,4,4,12,9,26,-17,16
Anzhi,3603,11,2,5,13,14,41,-27,11
Loko Moscow,3604,1,13,5,2,32,12,20,44
CSKA Moscow,3604,2,12,3,5,30,18,12,39
Spart Moscow,3604,3,8,8,4,35,27,8,32
Zenit,3604,4,7,8,5,22,16,6,29
Krasnodar,3604,5,8,4,8,28,27,1,28
Terek Grozny,3604,6,7,7,6,22,24,-2,28
FK Rubin,3604,7,6,6,8,23,18,5,24
Din Moscow,3604,8,5,8,7,18,22,-4,23
Rostov,3604,9,4,7,9,10,17,-7,19
Amkar,3604,10,4,6,10,12,25,-13,18
Anzhi,3604,11,2,6,12,15,41,-26,12
Loko Moscow,3605,1,12,6,2,33,14,19,42
CSKA Moscow,3605,2,11,4,5,27,18,9,37
Spart Moscow,3605,3,9,5,6,35,28,7,32
Zenit,3605,4,7,9,4,23,16,7,30
Terek Grozny,3605,5,8,6,6,23,23,0,30
Krasnodar,3605,6,8,4,8,29,29,0,28
Din Moscow,3605,7,7,6,7,19,21,-2,27
FK Rubin,3605,8,6,5,9,24,19,5,23
Rostov,3605,9,5,6,9,12,18,-6,21
Amkar,3605,10,4,5,11,10,24,-14,17
Anzhi,3605,11,2,6,12,15,40,-25,12
Loko Moscow,3606,1,11,5,4,29,13,16,38
CSKA Moscow,3606,2,11,3,6,30,19,11,36
Zenit,3606,3,9,8,3,24,14,10,35
Spart Moscow,3606,4,9,6,5,36,28,8,33
Krasnodar,3606,5,9,5,6,29,25,4,32
Terek Grozny,3606,6,7,6,7,21,25,-4,27
Din Moscow,3606,7,6,6,8,19,23,-4,24
FK Rubin,3606,8,5,6,9,23,20,3,21
Amkar,3606,9,5,5,10,11,23,-12,20
Rostov,3606,10,4,7,9,12,19,-7,19
Anzhi,3606,11,3,5,12,16,41,-25,14
Loko Moscow,3607,1,11,6,3,30,13,17,39
CSKA Moscow,3607,2,11,3,6,26,19,7,36
Zenit,3607,3,9,8,3,25,14,11,35
Krasnodar,3607,4,9,5,6,30,24,6,32
Spart Moscow,3607,5,8,7,5,34,27,7,31
Terek Grozny,3607,6,8,6,6,23,23,0,30
Din Moscow,3607,7,7,6,7,19,21,-2,27
FK Rubin,3607,8,5,5,10,21,21,0,20
Rostov,3607,9,4,7,9,11,18,-7,19
Amkar,3607,10,4,6,10,10,23,-13,18
Anzhi,3607,11,2,5,13,14,40,-26,11
Loko Moscow,3608,1,11,7,2,31,13,18,40
CSKA Moscow,3608,2,11,4,5,27,18,9,37
Spart Moscow,3608,3,10,5,5,38,26,12,35
Zenit,3608,4,7,10,3,21,13,8,31
Terek Grozny,3608,5,8,6,6,23,24,-1,30
Krasnodar,3608,6,8,5,7,30,28,2,29
Din Moscow,3608,7,6,6,8,20,25,-5,24
FK Rubin,3608,8,6,5,9,24,21,3,23
Amkar,3608,9,5,5,10,11,23,-12,20
Rostov,3608,10,4,6,10,10,19,-9,18
Anzhi,3608,11,2,5,13,16,41,-25,11
Loko Moscow,3609,1,13,5,2,33,12,21,44
CSKA Moscow,3609,2,11,3,6,27,20,7,36
Spart Moscow,3609,3,8,7,5,34,28,6,31
Terek Grozny,3609,4,8,6,6,21,22,-1,30
Zenit,3609,5,7,8,5,22,17,5,29
Krasnodar,3609,6,8,4,8,29,28,1,28
FK Rubin,3609,7,7,5,8,25,19,6,26
Din Moscow,3609,8,5,7,8,19,24,-5,22
Rostov,3609,9,4,7,9,10,17,-7,19
Amkar,3609,10,5,4,11,11,23,-12,19
Anzhi,3609,11,3,6,11,16,37,-21,15
Loko Moscow,3610,1,13,5,2,32,11,21,44
CSKA Moscow,3610,2,11,4,5,28,19,9,37
Spart Moscow,3610,3,9,6,5,37,29,8,33
Zenit,3610,4,7,9,4,21,15,6,30
Terek Grozny,3610,5,8,6,6,23,24,-1,30
Krasnodar,3610,6,8,5,7,28,26,2,29
Din Moscow,3610,7,6,7,7,23,23,0,25
FK Rubin,3610,8,5,6,9,22,22,0,21
Amkar,3610,9,5,4,11,13,26,-13,19
Rostov,3610,10,4,6,10,10,18,-8,18
Anzhi,3610,11,2,6,12,16,40,-24,12
Loko Moscow,3611,1,12,6,2,32,13,19,42
CSKA Moscow,3611,2,11,3,6,27,19,8,36
Spart Moscow,3611,3,10,5,5,39,29,10,35
Zenit,3611,4,8,9,3,23,14,9,33
Terek Grozny,3611,5,9,5,6,24,23,1,32
Krasnodar,3611,6,8,5,7,28,26,2,29
Din Moscow,3611,7,7,6,7,20,22,-2,27
FK Rubin,3611,8,5,6,9,21,18,3,21
Rostov,3611,9,4,6,10,11,19,-8,18
Amkar,3611,10,4,4,12,11,27,-16,16
Anzhi,3611,11,2,5,13,15,41,-26,11
Loko Moscow,3612,1,12,5,3,31,15,16,41
CSKA Moscow,3612,2,12,3,5,31,17,14,39
Krasnodar,3612,3,10,4,6,33,24,9,34
Spart Moscow,3612,4,9,5,6,36,29,7,32
Zenit,3612,5,7,8,5,21,18,3,29
Terek Grozny,3612,6,7,7,6,21,23,-2,28
Din Moscow,3612,7,5,7,8,17,23,-6,22
FK Rubin,3612,8,5,6,9,21,19,2,21
Rostov,3612,9,5,6,9,13,18,-5,21
Amkar,3612,10,5,5,10,10,22,-12,20
Anzhi,3612,11,2,6,12,15,41,-26,12
Loko Moscow,3613,1,12,5,3,30,13,17,41
Spart Moscow,3613,2,11,5,4,40,25,15,38
CSKA Moscow,3613,3,11,4,5,29,19,10,37
Krasnodar,3613,4,9,4,7,29,26,3,31
Zenit,3613,5,7,9,4,22,15,7,30
Terek Grozny,3613,6,7,5,8,20,25,-5,26
FK Rubin,3613,7,6,6,8,25,19,6,24
Din Moscow,3613,8,5,7,8,19,25,-6,22
Amkar,3613,9,5,4,11,10,24,-14,19
Rostov,3613,10,4,6,10,10,20,-10,18
Anzhi,3613,11,3,5,12,17,40,-23,14
Loko Moscow,3614,1,12,5,3,30,12,18,41
CSKA Moscow,3614,2,12,3,5,29,18,11,39
Spart Moscow,3614,3,9,7,4,35,26,9,34
Zenit,3614,4,8,8,4,22,14,8,32
Terek Grozny,3614,5,9,5,6,24,23,1,32
Krasnodar,3614,6,8,4,8,27,26,1,28
Din Moscow,3614,7,6,7,7,20,23,-3,25
FK Rubin,3614,8,6,5,9,23,19,4,23
Rostov,3614,9,4,7,9,10,17,-7,19
Amkar,3614,10,4,4,12,10,26,-16,16
Anzhi,3614,11,2,5,13,15,41,-26,11
Loko Moscow,3615,1,12,6,2,30,11,19,42
CSKA Moscow,3615,2,11,3,6,27,19,8,36
Zenit,3615,3,8,9,3,23,13,10,33
Spart Moscow,3615,4,9,6,5,36,28,8,33
Krasnodar,3615,5,9,4,7,28,25,3,31
Terek Grozny,3615,6,8,6,6,23,22,1,30
Din Moscow,3615,7,7,6,7,21,22,-1,27
FK Rubin,3615,8,5,5,10,21,20,1,20
Rostov,3615,9,4,6,10,10,18,-8,18
Amkar,3615,10,4,6,10,10,23,-13,18
Anzhi,3615,11,2,5,13,14,42,-28,11
Loko Moscow,3616,1,12,5,3,30,13,17,41
Spart Moscow,3616,2,10,6,4,40,27,13,36
CSKA Moscow,3616,3,11,3,6,28,19,9,36
Krasnodar,3616,4,10,4,6,31,24,7,34
Terek Grozny,3616,5,8,6,6,23,24,-1,30
Zenit,3616,6,7,8,5,21,16,5,29
FK Rubin,3616,7,6,5,9,22,19,3,23
Din Moscow,3616,8,5,7,8,18,23,-5,22
Rostov,3616,9,4,6,10,10,19,-9,18
Amkar,3616,10,4,5,11,10,26,-16,17
Anzhi,3616,11,3,5,12,18,41,-23,14
Loko Moscow,3617,1,11,5,4,29,14,15,38
CSKA Moscow,3617,2,11,3,6,27,19,8,36
Zenit,3617,3,9,8,3,23,13,10,35
Spart Moscow,3617,4,9,5,6,36,31,5,32
Krasnodar,3617,5,9,4,7,29,26,3,31
Terek Grozny,3617,6,7,6,7,20,23,-3,27
FK Rubin,3617,7,7,5,8,24,17,7,26
Rostov,3617,8,5,6,9,13,17,-4,21
Din Moscow,3617,9,5,6,9,18,24,-6,21
Amkar,3617,10,5,5,10,11,23,-12,20
Anzhi,3617,11,3,5,12,16,39,-23,14
Loko Moscow,3618,1,12,5,3,31,12,19,41
CSKA Moscow,3618,2,11,4,5,27,17,10,37
Spart Moscow,3618,3,10,5,5,39,30,9,35
Krasnodar,3618,4,10,4,6,29,24,5,34
Terek Grozny,3618,5,9,5,6,24,24,0,32
Zenit,3618,6,7,9,4,21,15,6,30
FK Rubin,3618,7,6,5,9,22,18,4,23
Din Moscow,3618,8,5,6,9,18,25,-7,21
Amkar,3618,9,5,4,11,13,25,-12,19
Rostov,3618,10,4,6,10,11,19,-8,18
Anzhi,3618,11,2,5,13,15,41,-26,11
Loko Moscow,3619,1,13,5,2,34,11,23,44
CSKA Moscow,3619,2,12,3,5,30,18,12,39
Spart Moscow,3619,3,9,6,5,38,33,5,33
Zenit,3619,4,7,8,5,22,19,3,29
Krasnodar,3619,5,8,5,7,28,26,2,29
Terek Grozny,3619,6,7,6,7,22,26,-4,27
FK Rubin,3619,7,5,7,8,23,19,4,22
Din Moscow,3619,8,5,7,8,19,25,-6,22
Rostov,3619,9,5,6,9,15,17,-2,21
Amkar,3619,10,5,5,10,14,25,-11,20
Anzhi,3619,11,2,6,12,15,41,-26,12
Loko Moscow,3620,1,12,6,2,31,12,19,42
CSKA Moscow,3620,2,11,3,6,28,20,8,36
Spart Moscow,3620,3,9,6,5,37,29,8,33
Zenit,3620,4,7,9,4,22,15,7,30
Krasnodar,3620,5,8,5,7,28,26,2,29
Din Moscow,3620,6,7,6,7,22,22,0,27
Terek Grozny,3620,7,7,6,7,20,23,-3,27
FK Rubin,3620,8,5,6,9,22,20,2,21
Rostov,3620,9,4,7,9,12,19,-7,19
Amkar,3620,10,4,5,11,9,24,-15,17
Anzhi,3620,11,4,5,11,17,38,-21,17
Loko Moscow,3621,1,11,6,3,30,13,17,39
CSKA Moscow,3621,2,11,4,5,28,19,9,37
Zenit,3621,3,8,9,3,24,15,9,33
Krasnodar,3621,4,9,5,6,29,25,4,32
Spart Moscow,3621,5,8,7,5,38,33,5,31
Terek Grozny,3621,6,8,6,6,23,23,0,30
Din Moscow,3621,7,5,8,7,20,24,-4,23
FK Rubin,3621,8,5,6,9,22,19,3,21
Rostov,3621,9,4,7,9,11,18,-7,19
Amkar,3621,10,5,4,11,14,26,-12,19
Anzhi,3621,11,2,6,12,15,39,-24,12
Loko Moscow,3622,1,13,5,2,32,12,20,44
CSKA Moscow,3622,2,11,4,5,27,18,9,37
Spart Moscow,3622,3,9,5,6,35,31,4,32
Zenit,3622,4,7,8,5,23,17,6,29
Krasnodar,3622,5,8,4,8,28,27,1,28
Terek Grozny,3622,6,7,7,6,25,27,-2,28
Din Moscow,3622,7,6,6,8,20,22,-2,24
FK Rubin,3622,8,6,5,9,23,21,2,23
Rostov,3622,9,5,6,9,15,18,-3,21
Amkar,3622,10,5,5,10,13,25,-12,20
Anzhi,3622,11,2,7,11,16,39,-23,13
Loko Moscow,3623,1,12,5,3,30,12,18,41
CSKA Moscow,3623,2,10,5,5,27,19,8,35
Krasnodar,3623,3,10,4,6,32,25,7,34
Spart Moscow,3623,4,9,6,5,40,32,8,33
Zenit,3623,5,7,9,4,23,16,7,30
Terek Grozny,3623,6,8,5,7,22,24,-2,29
Din Moscow,3623,7,6,7,7,23,24,-1,25
FK Rubin,3623,8,5,5,10,22,24,-2,20
Amkar,3623,9,5,4,11,12,25,-13,19
Rostov,3623,10,4,6,10,11,19,-8,18
Anzhi,3623,11,3,6,11,16,38,-22,15
Loko Moscow,3624,1,11,5,4,29,17,12,38
CSKA Moscow,3624,2,11,3,6,28,20,8,36
Zenit,3624,3,9,8,3,26,13,13,35
Spart Moscow,3624,4,9,6,5,37,29,8,33
Krasnodar,3624,5,9,4,7,31,25,6,31
Terek Grozny,3624,6,7,6,7,22,25,-3,27
Din Moscow,3624,7,6,7,7,21,24,-3,25
FK Rubin,3624,8,6,6,8,24,19,5,24
Amkar,3624,9,5,5,10,11,23,-12,20
Rostov,3624,10,4,6,10,12,20,-8,18
Anzhi,3624,11,2,6,12,15,41,-26,12
Loko Moscow,3625,1,11,6,3,31,16,15,39
CSKA Moscow,3625,2,11,3,6,30,21,9,36
Spart Moscow,3625,3,10,5,5,36,26,10,35
Krasnodar,3625,4,10,4,6,33,26,7,34
Zenit,3625,5,8,9,3,25,15,10,33
Terek Grozny,3625,6,7,6,7,22,25,-3,27
FK Rubin,3625,7,6,5,9,22,18,4,23
Amkar,3625,8,6,4,10,12,23,-11,22
Din Moscow,3625,9,5,6,9,17,23,-6,21
Rostov,3625,10,4,6,10,10,19,-9,18
Anzhi,3625,11,2,6,12,15,41,-26,12
Loko Moscow,3626,1,12,6,2,33,13,20,42
CSKA Moscow,3626,2,10,5,5,26,18,8,35
Spart Moscow,3626,3,9,7,4,37,28,9,34
Zenit,3626,4,7,10,3,24,16,8,31
Krasnodar,3626,5,9,4,7,30,27,3,31
Terek Grozny,3626,6,7,5,8,20,24,-4,26
Din Moscow,3626,7,5,8,7,19,23,-4,23
FK Rubin,3626,8,5,6,9,23,21,2,21
Amkar,3626,9,5,5,10,11,23,-12,20
Rostov,3626,10,4,6,10,11,19,-8,18
Anzhi,3626,11,3,6,11,15,37,-22,15
Loko Moscow,3627,1,12,5,3,33,14,19,41
CSKA Moscow,3627,2,12,3,5,28,18,10,39
Spart Moscow,3627,3,9,6,5,37,29,8,33
Zenit,3627,4,8,8,4,24,15,9,32
Krasnodar,3627,5,8,4,8,27,29,-2,28
Din Moscow,3627,6,7,6,7,20,22,-2,27
Terek Grozny,3627,7,7,6,7,21,26,-5,27
FK Rubin,3627,8,6,5,9,23,18,5,23
Rostov,3627,9,4,6,10,10,18,-8,18
Amkar,3627,10,4,6,10,12,25,-13,18
Anzhi,3627,11,3,5,12,18,39,-21,14
Loko Moscow,3628,1,11,6,3,31,15,16,39
Spart Moscow,3628,2,11,5,4,40,26,14,38
CSKA Moscow,3628,3,11,3,6,26,20,6,36
Krasnodar,3628,4,10,4,6,31,24,7,34
Zenit,3628,5,8,9,3,26,15,11,33
Terek Grozny,3628,6,8,5,7,22,25,-3,29
FK Rubin,3628,7,6,5,9,24,19,5,23
Din Moscow,3628,8,5,6,9,18,27,-9,21
Rostov,3628,9,4,6,10,10,18,-8,18
Amkar,3628,10,4,4,12,9,27,-18,16
Anzhi,3628,11,3,5,12,17,38,-21,14
Loko Moscow,3629,1,13,5,2,35,12,23,44
CSKA Moscow,3629,2,12,3,5,30,18,12,39
Spart Moscow,3629,3,9,7,4,39,26,13,34
Krasnodar,3629,4,9,4,7,29,28,1,31
Zenit,3629,5,7,8,5,21,17,4,29
Terek Grozny,3629,6,8,5,7,22,24,-2,29
FK Rubin,3629,7,6,5,9,22,18,4,23
Din Moscow,3629,8,5,7,8,17,22,-5,22
Rostov,3629,9,4,6,10,10,22,-12,18
Amkar,3629,10,4,5,11,11,25,-14,17
Anzhi,3629,11,3,5,12,16,40,-24,14
Loko Moscow,3630,1,12,6,2,31,12,19,42
Spart Moscow,3630,2,10,6,4,42,28,14,36
CSKA Moscow,3630,3,11,3,6,27,19,8,36
Krasnodar,3630,4,9,5,6,29,25,4,32
Zenit,3630,5,7,8,5,22,16,6,29
Terek Grozny,3630,6,7,6,7,22,28,-6,27
Din Moscow,3630,7,6,6,8,19,24,-5,24
FK Rubin,3630,8,5,5,10,22,20,2,20
Rostov,3630,9,4,7,9,13,20,-7,19
Amkar,3630,10,4,5,11,10,27,-17,17
Anzhi,3630,11,4,5,11,20,38,-18,17
Loko Moscow,3631,1,11,6,3,31,15,16,39
CSKA Moscow,3631,2,11,3,6,28,23,5,36
Krasnodar,3631,3,10,4,6,32,25,7,34
Zenit,3631,4,8,9,3,28,15,13,33
Spart Moscow,3631,5,9,6,5,38,28,10,33
Terek Grozny,3631,6,7,6,7,22,25,-3,27
Din Moscow,3631,7,6,6,8,19,25,-6,24
Amkar,3631,8,6,4,10,12,23,-11,22
FK Rubin,3631,9,5,5,10,21,20,1,20
Rostov,3631,10,4,7,9,11,18,-7,19
Anzhi,3631,11,2,6,12,15,40,-25,12
Loko Moscow,3632,1,12,5,3,37,16,21,41
Spart Moscow,3632,2,10,5,5,37,28,9,35
CSKA Moscow,3632,3,10,5,5,28,20,8,35
Krasnodar,3632,4,9,4,7,33,30,3,31
Zenit,3632,5,7,9,4,22,18,4,30
Terek Grozny,3632,6,7,7,6,22,24,-2,28
Din Moscow,3632,7,6,6,8,20,23,-3,24
FK Rubin,3632,8,6,5,9,23,20,3,23
Amkar,3632,9,5,5,10,13,24,-11,20
Rostov,3632,10,4,6,10,10,19,-9,18
Anzhi,3632,11,2,7,11,16,39,-23,13
Loko Moscow,3633,1,11,5,4,29,14,15,38
CSKA Moscow,3633,2,11,3,6,29,19,10,36
Spart Moscow,3633,3,10,5,5,39,27,12,35
Zenit,3633,4,9,8,3,23,13,10,35
Krasnodar,3633,5,10,4,6,34,26,8,34
Terek Grozny,3633,6,8,6,6,23,24,-1,30
Din Moscow,3633,7,6,6,8,18,23,-5,24
FK Rubin,3633,8,5,5,10,23,23,0,20
Amkar,3633,9,5,4,11,12,25,-13,19
Rostov,3633,10,4,6,10,10,20,-10,18
Anzhi,3633,11,2,6,12,16,42,-26,12
Loko Moscow,3634,1,12,6,2,30,11,19,42
CSKA Moscow,3634,2,12,3,5,31,17,14,39
Spart Moscow,3634,3,9,5,6,36,31,5,32
Krasnodar,3634,4,9,5,6,30,25,5,32
Terek Grozny,3634,5,9,5,6,24,22,2,32
Zenit,3634,6,7,8,5,21,18,3,29
Din Moscow,3634,7,6,6,8,19,23,-4,24
Rostov,3634,8,5,6,9,14,17,-3,21
FK Rubin,3634,9,5,5,10,22,22,0,20
Amkar,3634,10,5,4,11,11,25,-14,19
Anzhi,3634,11,2,5,13,14,41,-27,11
CSKA Moscow,3635,1,12,3,5,30,19,11,39
Loko Moscow,3635,2,11,5,4,30,14,16,38
Spart Moscow,3635,3,10,6,4,38,28,10,36
Krasnodar,3635,4,10,4,6,29,24,5,34
Zenit,3635,5,8,8,4,23,15,8,32
Terek Grozny,3635,6,7,6,7,20,24,-4,27
FK Rubin,3635,7,6,5,9,24,19,5,23
Din Moscow,3635,8,5,6,9,20,27,-7,21
Rostov,3635,9,4,6,10,10,18,-8,18
Amkar,3635,10,4,6,10,10,23,-13,18
Anzhi,3635,11,3,5,12,18,41,-23,14
Loko Moscow,3636,1,11,7,2,32,14,18,40
Spart Moscow,3636,2,9,7,4,36,27,9,34
CSKA Moscow,3636,3,10,4,6,25,19,6,34
Zenit,3636,4,8,9,3,25,15,10,33
Terek Grozny,3636,5,8,6,6,21,22,-1,30
Krasnodar,3636,6,8,5,7,31,29,2,29
Din Moscow,3636,7,6,6,8,20,24,-4,24
FK Rubin,3636,8,6,5,9,27,23,4,23
Rostov,3636,9,4,7,9,10,17,-7,19
Amkar,3636,10,4,6,10,11,24,-13,18
Anzhi,3636,11,2,6,12,14,38,-24,12
Loko Moscow,3637,1,12,6,2,32,13,19,42
CSKA Moscow,3637,2,11,4,5,28,18,10,37
Krasnodar,3637,3,9,5,6,29,25,4,32
Zenit,3637,4,7,9,4,23,16,7,30
Spart Moscow,3637,5,8,6,6,35,29,6,30
Terek Grozny,3637,6,8,6,6,24,24,0,30
Din Moscow,3637,7,7,6,7,19,21,-2,27
Rostov,3637,8,5,6,9,13,19,-6,21
FK Rubin,3637,9,5,5,10,21,19,2,20
Amkar,3637,10,4,5,11,9,24,-15,17
Anzhi,3637,11,2,6,12,16,41,-25,12
Loko Moscow,3638,1,11,7,2,31,13,18,40
CSKA Moscow,3638,2,11,4,5,27,17,10,37
Spart Moscow,3638,3,9,6,5,37,28,9,33
Krasnodar,3638,4,9,5,6,32,28,4,32
Zenit,3638,5,7,10,3,22,14,8,31
Terek Grozny,3638,6,7,6,7,21,24,-3,27
FK Rubin,3638,7,6,5,9,26,22,4,23
Din Moscow,3638,8,5,7,8,19,24,-5,22
Amkar,3638,9,5,5,10,10,22,-12,20
Rostov,3638,10,4,6,10,11,20,-9,18
Anzhi,3638,11,3,5,12,16,40,-24,14
Loko Moscow,3639,1,11,5,4,31,16,15,38
Spart Moscow,3639,2,11,5,4,37,26,11,38
CSKA Moscow,3639,3,11,3,6,28,20,8,36
Zenit,3639,4,8,8,4,23,15,8,32
Krasnodar,3639,5,9,4,7,31,27,4,31
Terek Grozny,3639,6,7,6,7,21,26,-5,27
Din Moscow,3639,7,6,6,8,19,23,-4,24
FK Rubin,3639,8,6,5,9,22,18,4,23
Amkar,3639,9,5,4,11,12,23,-11,19
Rostov,3639,10,4,6,10,10,18,-8,18
Anzhi,3639,11,3,6,11,17,39,-22,15
Loko Moscow,3640,1,12,5,3,33,14,19,41
CSKA Moscow,3640,2,12,3,5,30,17,13,39
Krasnodar,3640,3,10,4,6,32,26,6,34
Spart Moscow,3640,4,9,6,5,37,28,9,33
Terek Grozny,3640,5,9,5,6,25,22,3,32
Zenit,3640,6,7,8,5,21,16,5,29
FK Rubin,3640,7,6,5,9,25,22,3,23
Din Moscow,3640,8,5,7,8,20,25,-5,22
Amkar,3640,9,5,4,11,12,25,-13,19
Rostov,3640,10,4,6,10,10,19,-9,18
Anzhi,3640,11,2,5,13,14,45,-31,11
Loko Moscow,3641,1,13,5,2,34,14,20,44
CSKA Moscow,3641,2,12,3,5,29,18,11,39
Spart Moscow,3641,3,10,6,4,38,27,11,36
Zenit,3641,4,7,8,5,23,18,5,29
Krasnodar,3641,5,8,5,7,30,28,2,29
Terek Grozny,3641,6,7,6,7,22,25,-3,27
FK Rubin,3641,7,6,6,8,24,19,5,24
Din Moscow,3641,8,5,7,8,19,24,-5,22
Amkar,3641,9,5,4,11,10,23,-13,19
Rostov,3641,10,4,6,10,11,20,-9,18
Anzhi,3641,11,2,6,12,16,40,-24,12
Loko Moscow,3642,1,12,6,2,31,11,20,42
Spart Moscow,3642,2,10,6,4,38,27,11,36
CSKA Moscow,3642,3,10,5,5,25,17,8,35
Terek Grozny,3642,4,9,5,6,24,24,0,32
Zenit,3642,5,7,10,3,21,13,8,31
Krasnodar,3642,6,9,4,7,31,28,3,31
Din Moscow,3642,7,6,6,8,19,22,-3,24
FK Rubin,3642,8,5,5,10,23,23,0,20
Rostov,3642,9,4,7,9,11,18,-7,19
Amkar,3642,10,4,4,12,11,27,-16,16
Anzhi,3642,11,2,6,12,15,39,-24,12
Loko Moscow,3643,1,11,6,3,31,19,12,39
CSKA Moscow,3643,2,11,4,5,26,17,9,37
Spart Moscow,3643,3,10,6,4,37,27,10,36
Krasnodar,3643,4,10,4,6,34,24,10,34
Zenit,3643,5,7,10,3,23,15,8,31
Terek Grozny,3643,6,8,6,6,24,24,0,30
FK Rubin,3643,7,6,5,9,23,18,5,23
Din Moscow,3643,8,5,6,9,17,24,-7,21
Rostov,3643,9,4,6,10,10,18,-8,18
Amkar,3643,10,4,6,10,12,25,-13,18
Anzhi,3643,11,2,5,13,15,41,-26,11
Loko Moscow,3644,1,12,5,3,31,14,17,41
CSKA Moscow,3644,2,12,3,5,30,18,12,39
Spart Moscow,3644,3,10,5,5,38,28,10,35
Zenit,3644,4,8,8,4,25,16,9,32
Krasnodar,3644,5,8,4,8,27,28,-1,28
Terek Grozny,3644,6,7,5,8,20,25,-5,26
FK Rubin,3644,7,6,6,8,25,18,7,24
Din Moscow,3644,8,5,7,8,18,24,-6,22
Rostov,3644,9,5,6,9,12,18,-6,21
Amkar,3644,10,5,4,11,11,24,-13,19
Anzhi,3644,11,3,5,12,16,40,-24,14
Loko Moscow,3645,1,13,5,2,32,11,21,44
CSKA Moscow,3645,2,12,3,5,29,18,11,39
Spart Moscow,3645,3,9,5,6,36,29,7,32
Krasnodar,3645,4,9,4,7,33,27,6,31
Zenit,3645,5,7,8,5,21,16,5,29
Terek Grozny,3645,6,8,5,7,24,26,-2,29
Din Moscow,3645,7,7,6,7,20,22,-2,27
FK Rubin,3645,8,5,5,10,24,25,-1,20
Amkar,3645,9,5,4,11,12,25,-13,19
Rostov,3645,10,4,6,10,10,18,-8,18
Anzhi,3645,11,3,5,12,19,43,-24,14
Loko Moscow,3646,1,12,5,3,31,13,18,41
Zenit,3646,2,9,8,3,24,14,10,35
CSKA Moscow,3646,3,10,4,6,26,19,7,34
Spart Moscow,3646,4,9,6,5,37,30,7,33
Krasnodar,3646,5,9,4,7,31,26,5,31
Terek Grozny,3646,6,8,5,7,25,27,-2,29
FK Rubin,3646,7,6,5,9,23,20,3,23
Rostov,3646,8,5,6,9,12,17,-5,21
Din Moscow,3646,9,5,6,9,20,27,-7,21
Amkar,3646,10,5,5,10,12,24,-12,20
Anzhi,3646,11,2,6,12,16,40,-24,12
Loko Moscow,3647,1,12,6,2,31,11,20,42
Spart Moscow,3647,2,11,5,4,40,27,13,38
CSKA Moscow,3647,3,11,3,6,29,21,8,36
Zenit,3647,4,8,9,3,24,15,9,33
Krasnodar,3647,5,8,5,7,29,28,1,29
Terek Grozny,3647,6,8,5,7,22,24,-2,29
FK Rubin,3647,7,6,6,8,24,19,5,24
Din Moscow,3647,8,5,6,9,17,24,-7,21
Amkar,3647,9,5,4,11,12,24,-12,19
Rostov,3647,10,4,6,10,11,20,-9,18
Anzhi,3647,11,2,5,13,15,41,-26,11
Loko Moscow,3648,1,12,5,3,31,12,19,41
CSKA Moscow,3648,2,11,3,6,29,20,9,36
Spart Moscow,3648,3,10,5,5,38,30,8,35
Zenit,3648,4,8,8,4,23,15,8,32
Krasnodar,3648,5,9,5,6,29,25,4,32
Terek Grozny,3648,6,7,7,6,20,22,-2,28
FK Rubin,3648,7,5,7,8,22,18,4,22
Din Moscow,3648,8,5,7,8,17,24,-7,22
Amkar,3648,9,5,5,10,13,22,-9,20
Rostov,3648,10,4,6,10,11,19,-8,18
Anzhi,3648,11,2,6,12,15,41,-26,12
Loko Moscow,3649,1,11,6,3,30,13,17,39
CSKA Moscow,3649,2,11,4,5,29,19,10,37
Spart Moscow,3649,3,10,5,5,38,26,12,35
Krasnodar,3649,4,10,4,6,31,26,5,34
Zenit,3649,5,7,9,4,21,15,6,30
Terek Grozny,3649,6,8,5,7,21,23,-2,29
Din Moscow,3649,7,6,6,8,20,27,-7,24
FK Rubin,3649,8,5,5,10,24,22,2,20
Amkar,3649,9,5,4,11,10,23,-13,19
Rostov,3649,10,4,6,10,10,18,-8,18
Anzhi,3649,11,3,6,11,17,39,-22,15
Loko Moscow,3650,1,12,6,2,31,12,19,42
Spart Moscow,3650,2,10,6,4,41,28,13,36
CSKA Moscow,3650,3,11,3,6,27,19,8,36
Zenit,3650,4,8,9,3,23,14,9,33
Krasnodar,3650,5,9,4,7,29,26,3,31
Terek Grozny,3650,6,7,5,8,20,25,-5,26
Din Moscow,3650,7,6,6,8,19,25,-6,24
FK Rubin,3650,8,5,5,10,22,20,2,20
Rostov,3650,9,4,7,9,10,17,-7,19
Amkar,3650,10,5,4,11,13,26,-13,19
Anzhi,3650,11,3,5,12,16,39,-23,14
Loko Moscow,3651,1,13,5,2,35,11,24,44
CSKA Moscow,3651,2,11,4,5,27,18,9,37
Spart Moscow,3651,3,10,6,4,38,28,10,36
Zenit,3651,4,7,8,5,21,17,4,29
Krasnodar,3651,5,8,4,8,27,28,-1,28
Terek Grozny,3651,6,7,5,8,21,26,-5,26
Din Moscow,3651,7,6,6,8,20,24,-4,24
FK Rubin,3651,8,6,5,9,22,18,4,23
Amkar,3651,9,5,5,10,11,23,-12,20
Rostov,3651,10,4,6,10,10,18,-8,18
Anzhi,3651,11,3,6,11,18,39,-21,15
Loko Moscow,3652,1,13,5,2,32,11,21,44
CSKA Moscow,3652,2,12,3,5,29,18,11,39
Spart Moscow,3652,3,9,6,5,34,28,6,33
Zenit,3652,4,7,8,5,21,16,5,29
Krasnodar,3652,5,8,5,7,29,28,1,29
Terek Grozny,3652,6,8,5,7,22,24,-2,29
Din Moscow,3652,7,7,6,7,22,22,0,27
FK Rubin,3652,8,5,6,9,24,21,3,21
Rostov,3652,9,4,7,9,10,17,-7,19
Amkar,3652,10,5,4,11,11,24,-13,19
Anzhi,3652,11,2,5,13,15,40,-25,11
Loko Moscow,3653,1,11,6,3,29,12,17,39
Spart Moscow,3653,2,11,5,4,40,28,12,38
CSKA Moscow,3653,3,10,5,5,27,19,8,35
Zenit,3653,4,8,9,3,23,14,9,33
Krasnodar,3653,5,9,5,6,28,24,4,32
Terek Grozny,3653,6,8,6,6,24,24,0,30
Din Moscow,3653,7,5,7,8,17,22,-5,22
FK Rubin,3653,8,5,6,9,21,18,3,21
Rostov,3653,9,4,6,10,11,20,-9,18
Amkar,3653,10,4,5,11,13,27,-14,17
Anzhi,3653,11,2,6,12,15,40,-25,12
Loko Moscow,3654,1,12,5,3,32,15,17,41
CSKA Moscow,3654,2,11,4,5,27,18,9,37
Spart Moscow,3654,3,10,6,4,39,27,12,36
Krasnodar,3654,4,9,5,6,31,26,5,32
Zenit,3654,5,7,9,4,23,16,7,30
Terek Grozny,3654,6,7,6,7,21,25,-4,27
Din Moscow,3654,7,6,6,8,19,23,-4,24
FK Rubin,3654,8,5,6,9,22,20,2,21
Amkar,3654,9,5,5,10,13,24,-11,20
Rostov,3654,10,4,6,10,10,19,-9,18
Anzhi,3654,11,2,6,12,15,39,-24,12
Loko Moscow,3655,1,11,6,3,30,13,17,39
Spart Moscow,3655,2,11,5,4,38,26,12,38
CSKA Moscow,3655,3,11,3,6,30,18,12,36
Krasnodar,3655,4,10,4,6,30,25,5,34
Zenit,3655,5,8,9,3,23,14,9,33
Terek Grozny,3655,6,7,5,8,21,25,-4,26
Din Moscow,3655,7,5,7,8,17,22,-5,22
FK Rubin,3655,8,5,6,9,22,19,3,21
Amkar,3655,9,5,4,11,12,26,-14,19
Rostov,3655,10,4,6,10,10,18,-8,18
Anzhi,3655,11,3,5,12,15,42,-27,14
Loko Moscow,3656,1,13,5,2,32,11,21,44
Spart Moscow,3656,2,10,5,5,43,27,16,35
CSKA Moscow,3656,3,10,3,7,25,20,5,33
Zenit,3656,4,8,8,4,22,15,7,32
Krasnodar,3656,5,9,4,7,30,25,5,31
Terek Grozny,3656,6,7,7,6,23,25,-2,28
Din Moscow,3656,7,6,6,8,19,23,-4,24
FK Rubin,3656,8,6,5,9,22,20,2,23
Rostov,3656,9,4,6,10,10,23,-13,18
Amkar,3656,10,4,5,11,10,26,-16,17
Anzhi,3656,11,3,6,11,18,39,-21,15
CSKA Moscow,3657,1,12,3,5,30,17,13,39
Loko Moscow,3657,2,11,5,4,29,15,14,38
Spart Moscow,3657,3,10,6,4,43,28,15,36
Zenit,3657,4,8,8,4,22,16,6,32
Krasnodar,3657,5,9,4,7,31,26,5,31
Terek Grozny,3657,6,8,5,7,22,26,-4,29
FK Rubin,3657,7,6,6,8,23,18,5,24
Din Moscow,3657,8,5,7,8,18,24,-6,22
Rostov,3657,9,4,7,9,12,19,-7,19
Amkar,3657,10,4,4,12,10,29,-19,16
Anzhi,3657,11,3,5,12,17,39,-22,14
Loko Moscow,3658,1,13,5,2,33,12,21,44
CSKA Moscow,3658,2,12,3,5,28,18,10,39
Spart Moscow,3658,3,10,6,4,40,27,13,36
Krasnodar,3658,4,9,4,7,30,27,3,31
Terek Grozny,3658,5,8,6,6,24,24,0,30
Zenit,3658,6,7,8,5,22,17,5,29
Din Moscow,3658,7,6,6,8,19,26,-7,24
FK Rubin,3658,8,5,5,10,23,21,2,20
Rostov,3658,9,4,6,10,10,18,-8,18
Amkar,3658,10,4,5,11,11,26,-15,17
Anzhi,3658,11,2,6,12,16,40,-24,12
Loko Moscow,3659,1,11,7,2,31,13,18,40
CSKA Moscow,3659,2,11,3,6,27,18,9,36
Zenit,3659,3,8,9,3,23,14,9,33
Spart Moscow,3659,4,9,5,6,37,29,8,32
Krasnodar,3659,5,8,6,6,31,28,3,30
Terek Grozny,3659,6,8,6,6,22,23,-1,30
Din Moscow,3659,7,6,7,7,20,23,-3,25
FK Rubin,3659,8,5,7,8,25,21,4,22
Amkar,3659,9,5,5,10,11,23,-12,20
Rostov,3659,10,4,6,10,10,19,-9,18
Anzhi,3659,11,2,5,13,15,41,-26,11
Loko Moscow,3660,1,12,5,3,32,12,20,41
CSKA Moscow,3660,2,11,4,5,27,18,9,37
Spart Moscow,3660,3,9,5,6,36,29,7,32
Krasnodar,3660,4,9,5,6,30,26,4,32
Zenit,3660,5,7,9,4,22,17,5,30
Terek Grozny,3660,6,8,6,6,21,22,-1,30
Din Moscow,3660,7,6,7,7,22,25,-3,25
FK Rubin,3660,8,5,7,8,26,22,4,22
Amkar,3660,9,5,5,10,11,23,-12,20
Rostov,3660,10,4,6,10,10,18,-8,18
Anzhi,3660,11,2,5,13,14,39,-25,11
Loko Moscow,3661,1,11,6,3,29,14,15,39
Spart Moscow,3661,2,10,6,4,40,27,13,36
CSKA Moscow,3661,3,11,3,6,28,18,10,36
Zenit,3661,4,8,9,3,22,13,9,33
Krasnodar,3661,5,9,4,7,30,25,5,31
Terek Grozny,3661,6,8,6,6,23,24,-1,30
Din Moscow,3661,7,6,6,8,19,23,-4,24
FK Rubin,3661,8,6,5,9,22,18,4,23
Rostov,3661,9,4,7,9,11,18,-7,19
Amkar,3661,10,4,4,12,10,28,-18,16
Anzhi,3661,11,2,6,12,15,41,-26,12
Loko Moscow,3662,1,11,7,2,31,13,18,40
Spart Moscow,3662,2,10,5,5,38,29,9,35
Zenit,3662,3,8,9,3,23,14,9,33
CSKA Moscow,3662,4,10,3,7,26,21,5,33
Krasnodar,3662,5,8,5,7,29,27,2,29
Terek Grozny,3662,6,7,7,6,21,23,-2,28
FK Rubin,3662,7,7,5,8,24,18,6,26
Din Moscow,3662,8,5,6,9,18,25,-7,21
Amkar,3662,9,5,5,10,12,23,-11,20
Rostov,3662,10,4,6,10,12,20,-8,18
Anzhi,3662,11,3,6,11,16,37,-21,15
Loko Moscow,3663,1,11,5,4,31,17,14,38
CSKA Moscow,3663,2,11,3,6,29,21,8,36
Zenit,3663,3,9,8,3,26,15,11,35
Spart Moscow,3663,4,9,7,4,36,26,10,34
Krasnodar,3663,5,9,4,7,31,29,2,31
Terek Grozny,3663,6,7,6,7,21,24,-3,27
FK Rubin,3663,7,7,5,8,27,19,8,26
Din Moscow,3663,8,5,7,8,19,24,-5,22
Amkar,3663,9,5,5,10,10,22,-12,20
Rostov,3663,10,4,6,10,10,19,-9,18
Anzhi,3663,11,2,6,12,17,41,-24,12
Loko Moscow,3664,1,12,5,3,32,14,18,41
CSKA Moscow,3664,2,12,3,5,31,18,13,39
Krasnodar,3664,3,10,4,6,31,25,6,34
Spart Moscow,3664,4,9,6,5,37,29,8,33
Zenit,3664,5,7,8,5,23,19,4,29
Terek Grozny,3664,6,8,5,7,23,26,-3,29
FK Rubin,3664,7,6,5,9,22,19,3,23
Din Moscow,3664,8,5,6,9,17,23,-6,21
Rostov,3664,9,5,6,9,12,18,-6,21
Amkar,3664,10,5,5,10,15,26,-11,20
Anzhi,3664,11,2,5,13,14,40,-26,11
Loko Moscow,3665,1,11,6,3,31,14,17,39
Zenit,3665,2,9,8,3,27,16,11,35
CSKA Moscow,3665,3,10,3,7,30,25,5,33
Krasnodar,3665,4,9,5,6,29,25,4,32
Spart Moscow,3665,5,8,5,7,35,33,2,29
Terek Grozny,3665,6,7,6,7,21,24,-3,27
Din Moscow,3665,7,6,7,7,21,22,-1,25
FK Rubin,3665,8,5,6,9,22,19,3,21
Rostov,3665,9,5,6,9,12,18,-6,21
Amkar,3665,10,5,5,10,13,24,-11,20
Anzhi,3665,11,4,5,11,19,40,-21,17
Loko Moscow,3666,1,12,6,2,33,14,19,42
CSKA Moscow,3666,2,11,4,5,30,19,11,37
Spart Moscow,3666,3,9,5,6,36,29,7,32
Krasnodar,3666,4,8,6,6,30,27,3,30
Zenit,3666,5,7,8,5,21,17,4,29
Terek Grozny,3666,6,8,5,7,21,24,-3,29
Din Moscow,3666,7,7,6,7,20,22,-2,27
FK Rubin,3666,8,5,6,9,21,18,3,21
Amkar,3666,9,5,4,11,10,23,-13,19
Rostov,3666,10,4,6,10,11,19,-8,18
Anzhi,3666,11,3,6,11,18,39,-21,15
Loko Moscow,3667,1,12,6,2,32,13,19,42
CSKA Moscow,3667,2,12,3,5,27,17,10,39
Spart Moscow,3667,3,9,6,5,41,33,8,33
Zenit,3667,4,7,9,4,22,15,7,30
Terek Grozny,3667,5,8,6,6,25,24,1,30
Krasnodar,3667,6,8,5,7,29,27,2,29
Din Moscow,3667,7,5,8,7,21,25,-4,23
FK Rubin,3667,8,5,7,8,23,19,4,22
Rostov,3667,9,5,6,9,13,19,-6,21
Amkar,3667,10,4,4,12,12,29,-17,16
Anzhi,3667,11,2,6,12,15,39,-24,12
Loko Moscow,3668,1,11,6,3,29,13,16,39
CSKA Moscow,3668,2,11,4,5,31,20,11,37
Spart Moscow,3668,3,10,6,4,38,28,10,36
Krasnodar,3668,4,10,4,6,31,25,6,34
Zenit,3668,5,7,9,4,22,17,5,30
Terek Grozny,3668,6,7,5,8,21,27,-6,26
FK Rubin,3668,7,6,5,9,24,20,4,23
Din Moscow,3668,8,5,7,8,18,23,-5,22
Amkar,3668,9,5,4,11,14,25,-11,19
Rostov,3668,10,4,6,10,11,19,-8,18
Anzhi,3668,11,3,6,11,18,40,-22,15
Loko Moscow,3669,1,11,5,4,29,17,12,38
Zenit,3669,2,9,8,3,27,14,13,35
CSKA Moscow,3669,3,10,4,6,27,20,7,34
Spart Moscow,3669,4,9,5,6,36,29,7,32
Krasnodar,3669,5,9,5,6,31,26,5,32
Terek Grozny,3669,6,8,6,6,24,25,-1,30
FK Rubin,3669,7,6,6,8,25,19,6,24
Din Moscow,3669,8,6,6,8,19,24,-5,24
Amkar,3669,9,5,4,11,14,26,-12,19
Rostov,3669,10,4,6,10,10,19,-9,18
Anzhi,3669,11,2,7,11,15,38,-23,13
Loko Moscow,3670,1,12,6,2,30,11,19,42
CSKA Moscow,3670,2,11,4,5,26,17,9,37
Spart Moscow,3670,3,10,5,5,38,27,11,35
Zenit,3670,4,7,9,4,21,14,7,30
Krasnodar,3670,5,8,6,6,28,25,3,30
Terek Grozny,3670,6,8,6,6,22,23,-1,30
Din Moscow,3670,7,6,6,8,18,24,-6,24
FK Rubin,3670,8,5,6,9,22,19,3,21
Amkar,3670,9,5,4,11,11,24,-13,19
Rostov,3670,10,4,6,10,11,19,-8,18
Anzhi,3670,11,2,6,12,14,38,-24,12
Loko Moscow,3671,1,11,6,3,30,14,16,39
CSKA Moscow,3671,2,11,4,5,27,17,10,37
Spart Moscow,3671,3,9,6,5,37,27,10,33
Krasnodar,3671,4,9,5,6,32,27,5,32
Terek Grozny,3671,5,9,5,6,24,23,1,32
Zenit,3671,6,7,10,3,21,13,8,31
Din Moscow,3671,7,7,6,7,19,21,-2,27
FK Rubin,3671,8,5,6,9,23,20,3,21
Rostov,3671,9,4,6,10,10,20,-10,18
Amkar,3671,10,4,5,11,11,26,-15,17
Anzhi,3671,11,2,5,13,14,40,-26,11
Loko Moscow,3672,1,12,5,3,31,14,17,41
CSKA Moscow,3672,2,12,3,5,30,19,11,39
Spart Moscow,3672,3,9,7,4,36,27,9,34
Zenit,3672,4,8,8,4,24,15,9,32
Krasnodar,3672,5,9,4,7,30,26,4,31
Terek Grozny,3672,6,8,6,6,22,22,0,30
Din Moscow,3672,7,6,7,7,21,23,-2,25
FK Rubin,3672,8,5,5,10,22,22,0,20
Rostov,3672,9,4,6,10,11,19,-8,18
Amkar,3672,10,4,6,10,9,22,-13,18
Anzhi,3672,11,2,5,13,15,42,-27,11
Loko Moscow,3673,1,11,7,2,30,12,18,40
CSKA Moscow,3673,2,11,4,5,26,17,9,37
Spart Moscow,3673,3,9,6,5,37,29,8,33
Zenit,3673,4,7,10,3,22,14,8,31
Krasnodar,3673,5,8,5,7,28,26,2,29
Terek Grozny,3673,6,8,5,7,23,25,-2,29
FK Rubin,3673,7,6,6,8,23,18,5,24
Din Moscow,3673,8,5,8,7,17,21,-4,23
Amkar,3673,9,6,4,10,12,22,-10,22
Rostov,3673,10,4,6,10,12,21,-9,18
Anzhi,3673,11,2,5,13,16,41,-25,11
Loko Moscow,3674,1,12,5,3,32,12,20,41
Spart Moscow,3674,2,11,5,4,39,28,11,38
CSKA Moscow,3674,3,10,5,5,30,22,8,35
Zenit,3674,4,8,9,3,23,14,9,33
Krasnodar,3674,5,8,5,7,29,29,0,29
Terek Grozny,3674,6,7,5,8,20,24,-4,26
Din Moscow,3674,7,6,6,8,21,23,-2,24
FK Rubin,3674,8,5,6,9,23,22,1,21
Amkar,3674,9,5,4,11,12,25,-13,19
Rostov,3674,10,4,6,10,10,18,-8,18
Anzhi,3674,11,3,6,11,19,41,-22,15
Loko Moscow,3675,1,11,7,2,30,12,18,40
CSKA Moscow,3675,2,11,4,5,30,17,13,37
Spart Moscow,3675,3,10,5,5,38,30,8,35
Krasnodar,3675,4,9,5,6,28,24,4,32
Zenit,3675,5,7,10,3,22,14,8,31
Terek Grozny,3675,6,8,6,6,22,23,-1,30
Din Moscow,3675,7,6,6,8,21,25,-4,24
FK Rubin,3675,8,6,5,9,24,18,6,23
Rostov,3675,9,4,6,10,11,19,-8,18
Amkar,3675,10,4,4,12,9,25,-16,16
Anzhi,3675,11,2,6,12,15,43,-28,12
Loko Moscow,3676,1,12,5,3,33,14,19,41
CSKA Moscow,3676,2,11,4,5,29,18,11,37
Spart Moscow,3676,3,9,7,4,35,26,9,34
Krasnodar,3676,4,9,4,7,29,26,3,31
Zenit,3676,5,7,9,4,23,17,6,30
Terek Grozny,3676,6,8,5,7,23,23,0,29
Din Moscow,3676,7,6,6,8,19,22,-3,24
FK Rubin,3676,8,6,5,9,22,19,3,23
Amkar,3676,9,5,5,10,10,22,-12,20
Rostov,3676,10,4,7,9,11,18,-7,19
Anzhi,3676,11,2,5,13,14,43,-29,11
Loko Moscow,3677,1,11,6,3,31,14,17,39
CSKA Moscow,3677,2,11,3,6,27,20,7,36
Zenit,3677,3,9,8,3,25,14,11,35
Spart Moscow,3677,4,9,6,5,39,28,11,33
Terek Grozny,3677,5,8,6,6,22,23,-1,30
Krasnodar,3677,6,8,5,7,28,27,1,29
FK Rubin,3677,7,6,6,8,23,17,6,24
Din Moscow,3677,8,5,8,7,18,22,-4,23
Amkar,3677,9,5,5,10,10,22,-12,20
Rostov,3677,10,4,6,10,11,22,-11,18
Anzhi,3677,11,2,5,13,16,41,-25,11
Loko Moscow,3678,1,12,6,2,30,11,19,42
CSKA Moscow,3678,2,12,3,5,28,18,10,39
Spart Moscow,3678,3,8,8,4,38,30,8,32
Zenit,3678,4,7,8,5,21,15,6,29
Krasnodar,3678,5,8,5,7,29,27,2,29
FK Rubin,3678,6,7,5,8,26,20,6,26
Terek Grozny,3678,7,7,5,8,21,25,-4,26
Din Moscow,3678,8,5,7,8,20,25,-5,22
Amkar,3678,9,5,5,10,13,25,-12,20
Rostov,3678,10,4,7,9,11,18,-7,19
Anzhi,3678,11,3,5,12,16,39,-23,14
Loko Moscow,3679,1,12,5,3,33,12,21,41
CSKA Moscow,3679,2,11,4,5,28,19,9,37
Spart Moscow,3679,3,9,7,4,37,28,9,34
Zenit,3679,4,8,9,3,24,15,9,33
Krasnodar,3679,5,9,4,7,29,28,1,31
Terek Grozny,3679,6,7,6,7,21,24,-3,27
Din Moscow,3679,7,6,7,7,20,23,-3,25
FK Rubin,3679,8,5,5,10,22,21,1,20
Rostov,3679,9,4,7,9,11,18,-7,19
Amkar,3679,10,4,5,11,11,25,-14,17
Anzhi,3679,11,3,5,12,15,38,-23,14
Loko Moscow,3680,1,12,5,3,32,14,18,41
CSKA Moscow,3680,2,12,3,5,32,21,11,39
Zenit,3680,3,8,8,4,25,17,8,32
Terek Grozny,3680,4,9,5,6,25,22,3,32
Spart Moscow,3680,5,8,7,5,34,27,7,31
Krasnodar,3680,6,8,5,7,29,27,2,29
FK Rubin,3680,7,6,6,8,25,19,6,24
Din Moscow,3680,8,5,7,8,18,24,-6,22
Rostov,3680,9,5,6,9,11,17,-6,21
Amkar,3680,10,4,5,11,10,25,-15,17
Anzhi,3680,11,2,5,13,16,44,-28,11
Loko Moscow,3681,1,12,5,3,31,15,16,41
CSKA Moscow,3681,2,11,4,5,29,18,11,37
Spart Moscow,3681,3,9,6,5,35,28,7,33
Krasnodar,3681,4,9,5,6,31,25,6,32
Zenit,3681,5,7,9,4,23,16,7,30
Terek Grozny,3681,6,8,5,7,23,25,-2,29
FK Rubin,3681,7,5,7,8,22,18,4,22
Din Moscow,3681,8,5,7,8,17,22,-5,22
Amkar,3681,9,6,4,10,14,24,-10,22
Rostov,3681,10,4,7,9,11,18,-7,19
Anzhi,3681,11,2,5,13,14,41,-27,11
Loko Moscow,3682,1,11,6,3,30,14,16,39
CSKA Moscow,3682,2,11,3,6,28,19,9,36
Spart Moscow,3682,3,10,5,5,40,27,13,35
Zenit,3682,4,8,9,3,24,15,9,33
Krasnodar,3682,5,9,5,6,30,25,5,32
Terek Grozny,3682,6,9,5,6,23,22,1,32
Din Moscow,3682,7,6,6,8,18,23,-5,24
FK Rubin,3682,8,5,6,9,22,19,3,21
Amkar,3682,9,5,4,11,11,24,-13,19
Rostov,3682,10,4,6,10,10,21,-11,18
Anzhi,3682,11,2,5,13,14,41,-27,11
Loko Moscow,3683,1,13,5,2,35,13,22,44
CSKA Moscow,3683,2,11,4,5,28,19,9,37
Spart Moscow,3683,3,10,6,4,40,28,12,36
Zenit,3683,4,7,9,4,21,15,6,30
Krasnodar,3683,5,8,4,8,30,30,0,28
Terek Grozny,3683,6,7,6,7,20,23,-3,27
Din Moscow,3683,7,6,6,8,20,25,-5,24
FK Rubin,3683,8,6,5,9,24,20,4,23
Amkar,3683,9,5,5,10,12,24,-12,20
Rostov,3683,10,4,6,10,10,19,-9,18
Anzhi,3683,11,2,6,12,16,40,-24,12
Loko Moscow,3684,1,12,5,3,30,12,18,41
CSKA Moscow,3684,2,12,3,5,30,18,12,39
Spart Moscow,3684,3,10,5,5,37,26,11,35
Krasnodar,3684,4,10,4,6,32,26,6,34
Terek Grozny,3684,5,9,5,6,24,24,0,32
Zenit,3684,6,7,8,5,22,16,6,29
FK Rubin,3684,7,6,5,9,24,21,3,23
Din Moscow,3684,8,5,6,9,17,25,-8,21
Amkar,3684,9,5,4,11,11,24,-13,19
Rostov,3684,10,4,6,10,10,18,-8,18
Anzhi,3684,11,2,5,13,15,42,-27,11
Loko Moscow,3685,1,11,6,3,30,13,17,39
CSKA Moscow,3685,2,11,4,5,30,19,11,37
Spart Moscow,3685,3,9,7,4,41,27,14,34
Krasnodar,3685,4,9,5,6,30,26,4,32
Zenit,3685,5,7,9,4,21,16,5,30
Terek Grozny,3685,6,7,5,8,20,25,-5,26
Din Moscow,3685,7,6,6,8,18,27,-9,24
FK Rubin,3685,8,5,6,9,22,19,3,21
Amkar,3685,9,5,5,10,10,22,-12,20
Rostov,3685,10,4,7,9,12,19,-7,19
Anzhi,3685,11,3,6,11,18,39,-21,15
Loko Moscow,3686,1,12,6,2,32,12,20,42
CSKA Moscow,3686,2,11,3,6,28,19,9,36
Spart Moscow,3686,3,10,5,5,37,27,10,35
Zenit,3686,4,8,9,3,22,13,9,33
Terek Grozny,3686,5,8,5,7,25,24,1,29
Krasnodar,3686,6,8,4,8,28,28,0,28
Din Moscow,3686,7,6,6,8,19,22,-3,24
FK Rubin,3686,8,6,5,9,22,19,3,23
Rostov,3686,9,5,6,9,11,17,-6,21
Amkar,3686,10,5,4,11,11,25,-14,19
Anzhi,3686,11,2,5,13,16,45,-29,11
Loko Moscow,3687,1,12,6,2,33,14,19,42
CSKA Moscow,3687,2,11,4,5,28,19,9,37
Spart Moscow,3687,3,10,6,4,40,28,12,36
Terek Grozny,3687,4,9,5,6,25,25,0,32
Zenit,3687,5,7,9,4,23,16,7,30
Krasnodar,3687,6,8,4,8,29,28,1,28
FK Rubin,3687,7,6,6,8,23,18,5,24
Din Moscow,3687,8,5,7,8,18,25,-7,22
Rostov,3687,9,4,6,10,10,18,-8,18
Amkar,3687,10,4,5,11,12,26,-14,17
Anzhi,3687,11,2,6,12,18,42,-24,12
Loko Moscow,3688,1,11,7,2,30,12,18,40
Spart Moscow,3688,2,11,5,4,41,26,15,38
CSKA Moscow,3688,3,10,4,6,27,20,7,34
Zenit,3688,4,7,10,3,24,16,8,31
Krasnodar,3688,5,8,6,6,27,24,3,30
Terek Grozny,3688,6,8,6,6,24,24,0,30
FK Rubin,3688,7,5,7,8,22,18,4,22
Din Moscow,3688,8,5,7,8,18,24,-6,22
Rostov,3688,9,4,6,10,11,21,-10,18
Amkar,3688,10,4,4,12,9,26,-17,16
Anzhi,3688,11,3,6,11,17,39,-22,15
Loko Moscow,3689,1,13,5,2,32,12,20,44
CSKA Moscow,3689,2,11,4,5,32,18,14,37
Spart Moscow,3689,3,10,6,4,37,26,11,36
Krasnodar,3689,4,9,4,7,29,26,3,31
Zenit,3689,5,7,9,4,23,16,7,30
Terek Grozny,3689,6,8,6,6,22,23,-1,30
Din Moscow,3689,7,6,6,8,19,24,-5,24
FK Rubin,3689,8,5,5,10,23,21,2,20
Rostov,3689,9,4,6,10,10,18,-8,18
Amkar,3689,10,4,6,10,10,23,-13,18
Anzhi,3689,11,2,5,13,15,45,-30,11
Loko Moscow,3690,1,13,5,2,35,14,21,44
CSKA Moscow,3690,2,12,3,5,29,17,12,39
Spart Moscow,3690,3,10,5,5,35,27,8,35
Zenit,3690,4,7,8,5,21,16,5,29
Krasnodar,3690,5,8,5,7,31,30,1,29
Terek Grozny,3690,6,7,5,8,21,26,-5,26
FK Rubin,3690,7,6,6,8,25,18,7,24
Amkar,3690,8,6,4,10,12,22,-10,22
Din Moscow,3690,9,5,6,9,17,25,-8,21
Rostov,3690,10,4,6,10,10,18,-8,18
Anzhi,3690,11,3,5,12,17,40,-23,14
Loko Moscow,3691,1,12,6,2,31,12,19,42
Spart Moscow,3691,2,10,6,4,37,26,11,36
CSKA Moscow,3691,3,10,4,6,26,20,6,34
Zenit,3691,4,8,9,3,23,13,10,33
Krasnodar,3691,5,8,5,7,30,28,2,29
Terek Grozny,3691,6,7,5,8,21,26,-5,26
FK Rubin,3691,7,6,6,8,24,19,5,24
Din Moscow,3691,8,5,6,9,18,25,-7,21
Amkar,3691,9,5,5,10,10,22,-12,20
Rostov,3691,10,4,6,10,10,18,-8,18
Anzhi,3691,11,3,6,11,18,39,-21,15
Loko Moscow,3692,1,11,6,3,31,15,16,39
Spart Moscow,3692,2,10,5,5,37,27,10,35
CSKA Moscow,3692,3,10,4,6,28,21,7,34
Zenit,3692,4,8,9,3,25,15,10,33
Krasnodar,3692,5,8,6,6,30,27,3,30
Terek Grozny,3692,6,8,6,6,23,24,-1,30
FK Rubin,3692,7,6,6,8,25,20,5,24
Rostov,3692,8,5,6,9,12,18,-6,21
Din Moscow,3692,9,5,6,9,18,25,-7,21
Amkar,3692,10,4,4,12,10,25,-15,16
Anzhi,3692,11,3,6,11,18,40,-22,15
CSKA Moscow,3693,1,12,3,5,29,18,11,39
Loko Moscow,3693,2,11,5,4,31,15,16,38
Spart Moscow,3693,3,9,7,4,36,27,9,34
Zenit,3693,4,8,8,4,22,15,7,32
Krasnodar,3693,5,9,4,7,30,28,2,31
Terek Grozny,3693,6,7,6,7,21,24,-3,27
FK Rubin,3693,7,7,5,8,25,17,8,26
Din Moscow,3693,8,5,6,9,17,24,-7,21
Rostov,3693,9,4,7,9,11,18,-7,19
Amkar,3693,10,4,6,10,11,24,-13,18
Anzhi,3693,11,3,5,12,16,39,-23,14
Loko Moscow,3694,1,11,5,4,30,16,14,38
Spart Moscow,3694,2,10,6,4,40,30,10,36
CSKA Moscow,3694,3,11,3,6,28,19,9,36
Zenit,3694,4,9,8,3,25,14,11,35
Krasnodar,3694,5,9,5,6,32,27,5,32
Terek Grozny,3694,6,8,5,7,22,23,-1,29
FK Rubin,3694,7,5,7,8,23,19,4,22
Din Moscow,3694,8,5,7,8,20,25,-5,22
Amkar,3694,9,5,5,10,11,23,-12,20
Rostov,3694,10,4,6,10,11,19,-8,18
Anzhi,3694,11,2,5,13,14,41,-27,11
Loko Moscow,3695,1,13,5,2,34,12,22,44
CSKA Moscow,3695,2,11,3,6,32,20,12,36
Spart Moscow,3695,3,8,8,4,38,30,8,32
Zenit,3695,4,8,8,4,24,16,8,32
Krasnodar,3695,5,9,4,7,30,26,4,31
Terek Grozny,3695,6,8,5,7,21,24,-3,29
Din Moscow,3695,7,5,8,7,21,25,-4,23
FK Rubin,3695,8,5,6,9,23,21,2,21
Rostov,3695,9,4,7,9,12,19,-7,19
Amkar,3695,10,4,5,11,10,24,-14,17
Anzhi,3695,11,3,5,12,16,44,-28,14
Loko Moscow,3696,1,12,6,2,32,13,19,42
Spart Moscow,3696,2,10,6,4,42,29,13,36
CSKA Moscow,3696,3,10,4,6,26,21,5,34
Zenit,3696,4,8,8,4,24,14,10,32
Krasnodar,3696,5,9,5,6,31,26,5,32
Terek Grozny,3696,6,7,5,8,21,28,-7,26
Din Moscow,3696,7,5,7,8,19,27,-8,22
FK Rubin,3696,8,5,6,9,21,19,2,21
Amkar,3696,9,5,5,10,13,25,-12,20
Rostov,3696,10,4,6,10,10,18,-8,18
Anzhi,3696,11,3,6,11,19,38,-19,15
Loko Moscow,3697,1,12,6,2,33,12,21,42
CSKA Moscow,3697,2,11,4,5,27,18,9,37
Spart Moscow,3697,3,8,8,4,36,28,8,32
Zenit,3697,4,7,10,3,22,14,8,31
Krasnodar,3697,5,9,4,7,29,28,1,31
Terek Grozny,3697,6,8,6,6,23,24,-1,30
FK Rubin,3697,7,6,5,9,24,19,5,23
Din Moscow,3697,8,5,7,8,19,25,-6,22
Rostov,3697,9,4,7,9,10,17,-7,19
Amkar,3697,10,4,6,10,11,24,-13,18
Anzhi,3697,11,2,5,13,16,41,-25,11
Loko Moscow,3698,1,12,5,3,30,12,18,41
CSKA Moscow,3698,2,12,3,5,29,17,12,39
Spart Moscow,3698,3,10,6,4,40,27,13,36
Zenit,3698,4,8,8,4,22,16,6,32
Krasnodar,3698,5,9,4,7,28,25,3,31
Terek Grozny,3698,6,8,5,7,23,24,-1,29
FK Rubin,3698,7,6,5,9,22,18,4,23
Din Moscow,3698,8,5,6,9,17,23,-6,21
Amkar,3698,9,5,5,10,12,24,-12,20
Rostov,3698,10,4,6,10,11,22,-11,18
Anzhi,3698,11,2,5,13,14,40,-26,11
Loko Moscow,3699,1,12,5,3,30,15,15,41
Spart Moscow,3699,2,10,6,4,40,28,12,36
CSKA Moscow,3699,3,11,3,6,28,20,8,36
Krasnodar,3699,4,10,4,6,35,25,10,34
Zenit,3699,5,8,8,4,23,14,9,32
Terek Grozny,3699,6,7,5,8,21,26,-5,26
Din Moscow,3699,7,6,6,8,19,24,-5,24
FK Rubin,3699,8,5,5,10,22,23,-1,20
Rostov,3699,9,4,7,9,12,19,-7,19
Amkar,3699,10,5,4,11,12,25,-13,19
Anzhi,3699,11,3,5,12,17,40,-23,14
Loko Moscow,3700,1,13,5,2,32,12,20,44
Spart Moscow,3700,2,11,5,4,43,26,17,38
CSKA Moscow,3700,3,11,4,5,30,19,11,37
Terek Grozny,3700,4,8,6,6,22,23,-1,30
Zenit,3700,5,7,8,5,23,19,4,29
Krasnodar,3700,6,8,5,7,29,27,2,29
FK Rubin,3700,7,6,6,8,24,18,6,24
Din Moscow,3700,8,5,6,9,18,28,-10,21
Rostov,3700,9,4,6,10,10,21,-11,18
Amkar,3700,10,4,5,11,10,24,-14,17
Anzhi,3700,11,2,6,12,14,38,-24,12
Loko Moscow,3701,1,11,5,4,31,16,15,38
Zenit,3701,2,9,8,3,27,14,13,35
Spart Moscow,3701,3,10,5,5,35,27,8,35
CSKA Moscow,3701,4,10,3,7,25,22,3,33
Krasnodar,3701,5,9,5,6,30,26,4,32
Terek Grozny,3701,6,9,5,6,24,22,2,32
FK Rubin,3701,7,5,7,8,23,19,4,22
Din Moscow,3701,8,5,7,8,18,23,-5,22
Amkar,3701,9,5,4,11,11,24,-13,19
Rostov,3701,10,4,6,10,10,18,-8,18
Anzhi,3701,11,3,5,12,16,39,-23,14
Loko Moscow,3702,1,12,5,3,35,15,20,41
Spart Moscow,3702,2,9,7,4,37,27,10,34
Krasnodar,3702,3,10,4,6,35,28,7,34
CSKA Moscow,3702,4,10,4,6,27,20,7,34
Zenit,3702,5,8,8,4,22,17,5,32
Terek Grozny,3702,6,7,6,7,21,24,-3,27
Din Moscow,3702,7,6,7,7,20,23,-3,25
FK Rubin,3702,8,5,5,10,23,22,1,20
Rostov,3702,9,4,7,9,10,17,-7,19
Amkar,3702,10,5,4,11,10,24,-14,19
Anzhi,3702,11,2,7,11,17,40,-23,13
Loko Moscow,3703,1,12,5,3,31,12,19,41
CSKA Moscow,3703,2,11,4,5,27,18,9,37
Zenit,3703,3,8,9,3,22,13,9,33
Spart Moscow,3703,4,9,5,6,36,29,7,32
Krasnodar,3703,5,9,4,7,28,26,2,31
Terek Grozny,3703,6,8,5,7,22,24,-2,29
Din Moscow,3703,7,5,7,8,19,25,-6,22
FK Rubin,3703,8,5,6,9,23,20,3,21
Rostov,3703,9,5,6,9,11,17,-6,21
Amkar,3703,10,5,4,11,12,24,-12,19
Anzhi,3703,11,3,5,12,17,40,-23,14
Loko Moscow,3704,1,12,5,3,31,14,17,41
CSKA Moscow,3704,2,12,3,5,29,18,11,39
Spart Moscow,3704,3,10,5,5,40,30,10,35
Zenit,3704,4,8,8,4,25,15,10,32
Terek Grozny,3704,5,8,6,6,21,22,-1,30
Krasnodar,3704,6,8,4,8,27,28,-1,28
FK Rubin,3704,7,7,5,8,24,17,7,26
Rostov,3704,8,5,6,9,12,17,-5,21
Din Moscow,3704,9,5,6,9,17,24,-7,21
Amkar,3704,10,4,5,11,12,27,-15,17
Anzhi,3704,11,2,5,13,14,40,-26,11
Loko Moscow,3705,1,12,6,2,32,13,19,42
Spart Moscow,3705,2,11,5,4,39,27,12,38
CSKA Moscow,3705,3,11,3,6,26,18,8,36
Zenit,3705,4,8,8,4,23,15,8,32
Krasnodar,3705,5,9,5,6,29,25,4,32
Terek Grozny,3705,6,7,7,6,22,24,-2,28
Din Moscow,3705,7,6,6,8,20,24,-4,24
FK Rubin,3705,8,5,5,10,23,21,2,20
Rostov,3705,9,4,6,10,12,21,-9,18
Amkar,3705,10,4,5,11,10,24,-14,17
Anzhi,3705,11,2,6,12,15,39,-24,12
Loko Moscow,3706,1,11,7,2,32,14,18,40
Spart Moscow,3706,2,11,5,4,40,27,13,38
CSKA Moscow,3706,3,10,4,6,25,19,6,34
Zenit,3706,4,8,9,3,25,15,10,33
Krasnodar,3706,5,8,5,7,28,28,0,29
Terek Grozny,3706,6,7,6,7,22,25,-3,27
FK Rubin,3706,7,7,5,8,25,17,8,26
Din Moscow,3706,8,5,6,9,18,25,-7,21
Amkar,3706,9,5,4,11,10,24,-14,19
Rostov,3706,10,4,6,10,11,19,-8,18
Anzhi,3706,11,2,7,11,16,39,-23,13
Loko Moscow,3707,1,12,5,3,32,15,17,41
CSKA Moscow,3707,2,11,3,6,28,20,8,36
Spart Moscow,3707,3,10,5,5,38,29,9,35
Zenit,3707,4,8,8,4,23,15,8,32
Krasnodar,3707,5,9,5,6,33,28,5,32
Terek Grozny,3707,6,8,6,6,24,23,1,30
Din Moscow,3707,7,6,6,8,19,23,-4,24
FK Rubin,3707,8,5,6,9,23,20,3,21
Rostov,3707,9,5,6,9,13,18,-5,21
Amkar,3707,10,4,5,11,9,24,-15,17
Anzhi,3707,11,2,5,13,16,43,-27,11
Loko Moscow,3708,1,13,5,2,35,13,22,44
CSKA Moscow,3708,2,11,4,5,30,20,10,37
Zenit,3708,3,7,9,4,23,18,5,30
Spart Moscow,3708,4,8,5,7,34,31,3,29
Krasnodar,3708,5,8,5,7,30,28,2,29
Terek Grozny,3708,6,8,5,7,23,26,-3,29
FK Rubin,3708,7,6,6,8,24,18,6,24
Din Moscow,3708,8,6,6,8,19,24,-5,24
Amkar,3708,9,6,4,10,15,23,-8,22
Rostov,3708,10,5,6,9,12,17,-5,21
Anzhi,3708,11,2,5,13,15,42,-27,11
Loko Moscow,3709,1,13,5,2,35,13,22,44
CSKA Moscow,3709,2,11,3,6,29,21,8,36
Zenit,3709,3,8,8,4,24,17,7,32
Spart Moscow,3709,4,8,7,5,37,30,7,31
Terek Grozny,3709,5,8,5,7,22,24,-2,29
Krasnodar,3709,6,8,4,8,29,30,-1,28
Din Moscow,3709,7,6,7,7,19,22,-3,25
FK Rubin,3709,8,6,5,9,23,18,5,23
Rostov,3709,9,5,6,9,12,18,-6,21
Amkar,3709,10,4,5,11,12,26,-14,17
Anzhi,3709,11,3,5,12,16,39,-23,14
Loko Moscow,3710,1,12,5,3,30,12,18,41
Spart Moscow,3710,2,10,6,4,38,26,12,36
CSKA Moscow,3710,3,11,3,6,26,18,8,36
Krasnodar,3710,4,9,4,7,28,25,3,31
Zenit,3710,5,7,8,5,21,15,6,29
Terek Grozny,3710,6,7,5,8,20,24,-4,26
Din Moscow,3710,7,6,6,8,20,24,-4,24
FK Rubin,3710,8,6,5,9,23,19,4,23
Rostov,3710,9,4,7,9,10,17,-7,19
Amkar,3710,10,5,4,11,10,25,-15,19
Anzhi,3710,11,4,5,11,16,37,-21,17
Loko Moscow,3711,1,12,6,2,33,12,21,42
Spart Moscow,3711,2,10,6,4,37,26,11,36
CSKA Moscow,3711,3,10,4,6,27,20,7,34
Zenit,3711,4,8,8,4,24,18,6,32
Krasnodar,3711,5,9,5,6,30,25,5,32
Terek Grozny,3711,6,7,6,7,20,23,-3,27
Din Moscow,3711,7,5,7,8,19,25,-6,22
FK Rubin,3711,8,5,6,9,22,20,2,21
Rostov,3711,9,4,7,9,10,17,-7,19
Amkar,3711,10,4,5,11,9,23,-14,17
Anzhi,3711,11,3,6,11,15,37,-22,15
Loko Moscow,3712,1,11,5,4,30,15,15,38
CSKA Moscow,3712,2,11,4,5,28,18,10,37
Spart Moscow,3712,3,9,6,5,38,27,11,33
Zenit,3712,4,8,9,3,25,15,10,33
Terek Grozny,3712,5,9,5,6,23,23,0,32
Krasnodar,3712,6,9,4,7,28,25,3,31
FK Rubin,3712,7,6,6,8,22,17,5,24
Din Moscow,3712,8,5,7,8,17,25,-8,22
Rostov,3712,9,4,7,9,11,18,-7,19
Amkar,3712,10,5,4,11,10,23,-13,19
Anzhi,3712,11,2,5,13,15,41,-26,11
Loko Moscow,3713,1,11,7,2,30,12,18,40
CSKA Moscow,3713,2,11,4,5,28,18,10,37
Spart Moscow,3713,3,10,6,4,41,26,15,36
Zenit,3713,4,7,10,3,22,14,8,31
Krasnodar,3713,5,8,5,7,29,27,2,29
Terek Grozny,3713,6,8,5,7,23,26,-3,29
Din Moscow,3713,7,6,6,8,23,26,-3,24
FK Rubin,3713,8,6,5,9,25,23,2,23
Rostov,3713,9,4,6,10,10,22,-12,18
Amkar,3713,10,4,5,11,9,24,-15,17
Anzhi,3713,11,3,5,12,18,40,-22,14
Loko Moscow,3714,1,11,5,4,29,13,16,38
Zenit,3714,2,9,8,3,23,13,10,35
CSKA Moscow,3714,3,10,4,6,25,18,7,34
Krasnodar,3714,4,10,4,6,29,24,5,34
Spart Moscow,3714,5,9,6,5,36,27,9,33
Terek Grozny,3714,6,7,7,6,22,24,-2,28
Din Moscow,3714,7,5,7,8,18,24,-6,22
FK Rubin,3714,8,5,6,9,22,19,3,21
Rostov,3714,9,5,6,9,11,17,-6,21
Amkar,3714,10,4,6,10,11,24,-13,18
Anzhi,3714,11,2,7,11,15,38,-23,13
Loko Moscow,3715,1,12,6,2,32,12,20,42
CSKA Moscow,3715,2,12,3,5,30,18,12,39
Spart Moscow,3715,3,9,6,5,35,27,8,33
Krasnodar,3715,4,9,5,6,30,25,5,32
Zenit,3715,5,7,8,5,21,18,3,29
Terek Grozny,3715,6,7,6,7,22,26,-4,27
FK Rubin,3715,7,6,5,9,22,19,3,23
Din Moscow,3715,8,5,7,8,18,23,-5,22
Rostov,3715,9,5,6,9,11,17,-6,21
Amkar,3715,10,5,4,11,11,23,-12,19
Anzhi,3715,11,2,6,12,17,41,-24,12
Loko Moscow,3716,1,12,6,2,32,12,20,42
CSKA Moscow,3716,2,10,4,6,26,19,7,34
Zenit,3716,3,8,9,3,22,13,9,33
Spart Moscow,3716,4,9,6,5,38,30,8,33
Krasnodar,3716,5,8,4,8,28,28,0,28
Terek Grozny,3716,6,7,7,6,22,24,-2,28
Din Moscow,3716,7,6,6,8,22,23,-1,24
FK Rubin,3716,8,6,5,9,22,21,1,23
Rostov,3716,9,5,6,9,13,19,-6,21
Amkar,3716,10,4,6,10,11,24,-13,18
Anzhi,3716,11,2,7,11,16,39,-23,13
Loko Moscow,3717,1,12,6,2,34,13,21,42
Spart Moscow,3717,2,10,5,5,44,29,15,35
CSKA Moscow,3717,3,10,4,6,28,22,6,34
Zenit,3717,4,8,9,3,25,15,10,33
Krasnodar,3717,5,9,4,7,29,28,1,31
Terek Grozny,3717,6,8,5,7,23,26,-3,29
Din Moscow,3717,7,6,6,8,20,28,-8,24
FK Rubin,3717,8,5,5,10,23,21,2,20
Amkar,3717,9,5,4,11,13,26,-13,19
Rostov,3717,10,4,6,10,10,20,-10,18
Anzhi,3717,11,3,6,11,20,41,-21,15
Loko Moscow,3718,1,13,5,2,33,12,21,44
CSKA Moscow,3718,2,11,4,5,28,19,9,37
Spart Moscow,3718,3,10,5,5,39,28,11,35
Zenit,3718,4,7,9,4,23,16,7,30
Krasnodar,3718,5,8,5,7,27,26,1,29
Terek Grozny,3718,6,7,5,8,20,26,-6,26
FK Rubin,3718,7,5,7,8,21,17,4,22
Din Moscow,3718,8,5,7,8,17,23,-6,22
Amkar,3718,9,6,4,10,11,22,-11,22
Rostov,3718,10,4,6,10,12,21,-9,18
Anzhi,3718,11,3,5,12,18,39,-21,14
Loko Moscow,3719,1,12,5,3,31,13,18,41
CSKA Moscow,3719,2,11,4,5,30,18,12,37
Zenit,3719,3,8,9,3,23,14,9,33
Terek Grozny,3719,4,9,5,6,26,22,4,32
Spart Moscow,3719,5,8,5,7,34,29,5,29
Krasnodar,3719,6,8,4,8,29,28,1,28
Din Moscow,3719,7,7,6,7,21,23,-2,27
FK Rubin,3719,8,6,5,9,24,20,4,23
Rostov,3719,9,5,6,9,11,17,-6,21
Amkar,3719,10,5,4,11,10,24,-14,19
Anzhi,3719,11,2,5,13,14,45,-31,11
Loko Moscow,3720,1,11,5,4,31,15,16,38
Spart Moscow,3720,2,10,6,4,37,27,10,36
CSKA Moscow,3720,3,11,3,6,27,20,7,36
Zenit,3720,4,9,8,3,25,14,11,35
Krasnodar,3720,5,10,4,6,30,25,5,34
Terek Grozny,3720,6,7,6,7,22,26,-4,27
Din Moscow,3720,7,5,7,8,19,24,-5,22
FK Rubin,3720,8,5,6,9,22,19,3,21
Rostov,3720,9,4,7,9,11,18,-7,19
Amkar,3720,10,4,5,11,9,23,-14,17
Anzhi,3720,11,3,5,12,19,41,-22,14
Loko Moscow,3721,1,11,5,4,30,14,16,38
CSKA Moscow,3721,2,11,3,6,28,19,9,36
Spart Moscow,3721,3,10,5,5,40,27,13,35
Zenit,3721,4,9,8,3,24,13,11,35
Krasnodar,3721,5,10,4,6,32,25,7,34
Terek Grozny,3721,6,8,5,7,23,24,-1,29
Din Moscow,3721,7,6,6,8,19,24,-5,24
FK Rubin,3721,8,6,5,9,23,20,3,23
Amkar,3721,9,5,4,11,11,26,-15,19
Rostov,3721,10,4,6,10,10,20,-10,18
Anzhi,3721,11,2,5,13,14,42,-28,11
Loko Moscow,3722,1,11,5,4,30,14,16,38
CSKA Moscow,3722,2,11,4,5,28,18,10,37
Spart Moscow,3722,3,10,6,4,40,29,11,36
Krasnodar,3722,4,10,4,6,32,24,8,34
Zenit,3722,5,8,9,3,23,14,9,33
Terek Grozny,3722,6,7,6,7,22,25,-3,27
Din Moscow,3722,7,5,7,8,19,24,-5,22
FK Rubin,3722,8,5,6,9,21,21,0,21
Rostov,3722,9,4,6,10,11,20,-9,18
Amkar,3722,10,4,6,10,11,24,-13,18
Anzhi,3722,11,3,5,12,17,41,-24,14
Loko Moscow,3723,1,11,5,4,29,14,15,38
CSKA Moscow,3723,2,11,4,5,31,19,12,37
Spart Moscow,3723,3,9,6,5,39,30,9,33
Zenit,3723,4,8,9,3,23,14,9,33
Krasnodar,3723,5,9,4,7,29,26,3,31
Terek Grozny,3723,6,7,5,8,21,27,-6,26
FK Rubin,3723,7,6,6,8,24,18,6,24
Din Moscow,3723,8,5,7,8,18,25,-7,22
Rostov,3723,9,5,6,9,14,19,-5,21
Amkar,3723,10,5,5,10,12,23,-11,20
Anzhi,3723,11,3,5,12,18,43,-25,14
Loko Moscow,3724,1,12,6,2,33,12,21,42
Spart Moscow,3724,2,10,5,5,37,29,8,35
CSKA Moscow,3724,3,10,3,7,27,21,6,33
Zenit,3724,4,8,8,4,23,17,6,32
Krasnodar,3724,5,8,5,7,29,27,2,29
FK Rubin,3724,6,7,5,8,25,19,6,26
Terek Grozny,3724,7,7,5,8,21,29,-8,26
Amkar,3724,8,6,4,10,14,23,-9,22
Din Moscow,3724,9,5,6,9,20,26,-6,21
Rostov,3724,10,4,6,10,10,18,-8,18
Anzhi,3724,11,4,5,11,20,38,-18,17
Loko Moscow,3725,1,12,6,2,33,13,20,42
CSKA Moscow,3725,2,12,3,5,29,19,10,39
Spart Moscow,3725,3,10,6,4,38,27,11,36
Zenit,3725,4,7,8,5,22,17,5,29
Krasnodar,3725,5,8,5,7,30,28,2,29
Terek Grozny,3725,6,7,5,8,21,26,-5,26
FK Rubin,3725,7,6,6,8,25,20,5,24
Din Moscow,3725,8,5,7,8,20,25,-5,22
Amkar,3725,9,5,5,10,11,22,-11,20
Rostov,3725,10,4,6,10,11,20,-9,18
Anzhi,3725,11,3,5,12,17,40,-23,14
Loko Moscow,3726,1,12,6,2,33,12,21,42
Spart Moscow,3726,2,11,5,4,40,26,14,38
CSKA Moscow,3726,3,11,3,6,26,18,8,36
Zenit,3726,4,8,8,4,23,17,6,32
Krasnodar,3726,5,8,6,6,28,25,3,30
Terek Grozny,3726,6,7,7,6,22,24,-2,28
FK Rubin,3726,7,6,6,8,23,18,5,24
Din Moscow,3726,8,5,6,9,17,23,-6,21
Rostov,3726,9,4,6,10,10,18,-8,18
Amkar,3726,10,4,5,11,12,29,-17,17
Anzhi,3726,11,2,6,12,14,38,-24,12
Loko Moscow,3727,1,11,6,3,30,13,17,39
Spart Moscow,3727,2,11,5,4,40,28,12,38
CSKA Moscow,3727,3,11,3,6,26,19,7,36
Zenit,3727,4,9,8,3,24,13,11,35
Terek Grozny,3727,5,9,5,6,25,24,1,32
Krasnodar,3727,6,8,6,6,29,26,3,30
FK Rubin,3727,7,5,7,8,22,18,4,22
Din Moscow,3727,8,5,7,8,18,24,-6,22
Rostov,3727,9,4,6,10,11,19,-8,18
Amkar,3727,10,4,4,12,11,27,-16,16
Anzhi,3727,11,2,5,13,15,40,-25,11
Loko Moscow,3728,1,12,6,2,31,12,19,42
CSKA Moscow,3728,2,11,3,6,27,19,8,36
Spart Moscow,3728,3,10,5,5,40,30,10,35
Krasnodar,3728,4,9,4,7,30,26,4,31
Zenit,3728,5,7,9,4,21,14,7,30
Terek Grozny,3728,6,7,6,7,22,27,-5,27
FK Rubin,3728,7,6,5,9,24,20,4,23
Din Moscow,3728,8,5,6,9,19,27,-8,21
Amkar,3728,9,5,5,10,12,23,-11,20
Rostov,3728,10,4,6,10,11,20,-9,18
Anzhi,3728,11,4,5,11,21,40,-19,17
Loko Moscow,3729,1,12,5,3,32,16,16,41
CSKA Moscow,3729,2,11,4,5,31,22,9,37
Spart Moscow,3729,3,10,5,5,38,29,9,35
Krasnodar,3729,4,9,4,7,32,27,5,31
Zenit,3729,5,7,9,4,24,17,7,30
Terek Grozny,3729,6,8,6,6,24,24,0,30
FK Rubin,3729,7,7,5,8,24,18,6,26
Din Moscow,3729,8,5,6,9,18,24,-6,21
Amkar,3729,9,5,5,10,12,24,-12,20
Rostov,3729,10,4,6,10,11,19,-8,18
Anzhi,3729,11,2,5,13,18,44,-26,11
Loko Moscow,3730,1,12,6,2,32,13,19,42
CSKA Moscow,3730,2,12,3,5,31,20,11,39
Spart Moscow,3730,3,9,7,4,35,26,9,34
Terek Grozny,3730,4,8,6,6,23,24,-1,30
Zenit,3730,5,7,8,5,26,20,6,29
Krasnodar,3730,6,8,5,7,28,26,2,29
FK Rubin,3730,7,7,5,8,24,18,6,26
Din Moscow,3730,8,5,7,8,18,23,-5,22
Rostov,3730,9,4,6,10,10,18,-8,18
Amkar,3730,10,4,6,10,11,24,-13,18
Anzhi,3730,11,2,5,13,14,40,-26,11
Loko Moscow,3731,1,13,5,2,33,13,20,44
CSKA Moscow,3731,2,12,3,5,29,18,11,39
Spart Moscow,3731,3,10,5,5,39,29,10,35
Zenit,3731,4,7,8,5,23,17,6,29
Terek Grozny,3731,5,8,5,7,21,24,-3,29
Krasnodar,3731,6,8,4,8,28,28,0,28
Din Moscow,3731,7,6,6,8,19,23,-4,24
FK Rubin,3731,8,6,5,9,23,18,5,23
Amkar,3731,9,5,4,11,11,23,-12,19
Rostov,3731,10,4,6,10,11,21,-10,18
Anzhi,3731,11,3,5,12,16,39,-23,14
Loko Moscow,3732,1,12,6,2,35,14,21,42
CSKA Moscow,3732,2,12,3,5,31,19,12,39
Spart Moscow,3732,3,10,6,4,40,27,13,36
Terek Grozny,3732,4,9,5,6,24,22,2,32
Krasnodar,3732,5,9,4,7,30,29,1,31
Zenit,3732,6,7,9,4,24,17,7,30
Din Moscow,3732,7,6,6,8,19,26,-7,24
FK Rubin,3732,8,5,5,10,22,20,2,20
Rostov,3732,9,4,7,9,11,18,-7,19
Amkar,3732,10,4,4,12,9,25,-16,16
Anzhi,3732,11,2,5,13,15,43,-28,11
Loko Moscow,3733,1,11,6,3,33,16,17,39
CSKA Moscow,3733,2,11,4,5,28,18,10,37
Spart Moscow,3733,3,9,6,5,35,27,8,33
Krasnodar,3733,4,9,5,6,31,27,4,32
Zenit,3733,5,7,10,3,24,16,8,31
Din Moscow,3733,6,7,6,7,20,21,-1,27
Terek Grozny,3733,7,7,6,7,22,25,-3,27
FK Rubin,3733,8,5,6,9,22,19,3,21
Amkar,3733,9,5,5,10,11,23,-12,20
Rostov,3733,10,4,6,10,10,19,-9,18
Anzhi,3733,11,2,6,12,15,40,-25,12
Loko Moscow,3734,1,12,5,3,30,12,18,41
CSKA Moscow,3734,2,10,5,5,27,19,8,35
Spart Moscow,3734,3,9,7,4,37,28,9,34
Zenit,3734,4,8,9,3,23,14,9,33
Krasnodar,3734,5,8,5,7,28,26,2,29
Terek Grozny,3734,6,7,6,7,21,25,-4,27
Din Moscow,3734,7,6,7,7,19,22,-3,25
FK Rubin,3734,8,5,6,9,22,19,3,21
Rostov,3734,9,4,7,9,10,17,-7,19
Amkar,3734,10,4,5,11,12,26,-14,17
Anzhi,3734,11,3,6,11,17,38,-21,15
Loko Moscow,3735,1,11,6,3,31,14,17,39
CSKA Moscow,3735,2,11,3,6,27,19,8,36
Zenit,3735,3,8,9,3,24,15,9,33
Spart Moscow,3735,4,8,8,4,35,27,8,32
Krasnodar,3735,5,9,4,7,29,27,2,31
Terek Grozny,3735,6,7,6,7,20,23,-3,27
FK Rubin,3735,7,6,6,8,25,19,6,24
Din Moscow,3735,8,5,8,7,18,22,-4,23
Rostov,3735,9,4,7,9,11,18,-7,19
Amkar,3735,10,4,6,10,10,23,-13,18
Anzhi,3735,11,3,5,12,16,39,-23,14
Loko Moscow,3736,1,13,5,2,33,12,21,44
Spart Moscow,3736,2,10,6,4,40,26,14,36
CSKA Moscow,3736,3,10,4,6,26,19,7,34
Terek Grozny,3736,4,9,5,6,24,22,2,32
Zenit,3736,5,7,9,4,23,17,6,30
Krasnodar,3736,6,8,4,8,29,28,1,28
FK Rubin,3736,7,7,5,8,27,20,7,26
Din Moscow,3736,8,5,6,9,18,27,-9,21
Rostov,3736,9,4,6,10,10,20,-10,18
Amkar,3736,10,4,5,11,10,24,-14,17
Anzhi,3736,11,3,5,12,15,40,-25,14
Loko Moscow,3737,1,11,6,3,30,13,17,39
Zenit,3737,2,9,8,3,25,15,10,35
CSKA Moscow,3737,3,10,3,7,28,22,6,33
Spart Moscow,3737,4,9,5,6,36,27,9,32
Krasnodar,3737,5,9,5,6,30,25,5,32
Terek Grozny,3737,6,7,5,8,21,25,-4,26
Din Moscow,3737,7,6,7,7,19,22,-3,25
FK Rubin,3737,8,5,6,9,22,20,2,21
Rostov,3737,9,5,6,9,11,17,-6,21
Amkar,3737,10,5,4,11,11,26,-15,19
Anzhi,3737,11,4,5,11,17,38,-21,17
Loko Moscow,3738,1,12,5,3,31,15,16,41
Spart Moscow,3738,2,10,5,5,36,27,9,35
Krasnodar,3738,3,10,4,6,32,24,8,34
CSKA Moscow,3738,4,10,3,7,27,21,6,33
Zenit,3738,5,8,8,4,23,16,7,32
Terek Grozny,3738,6,8,5,7,23,24,-1,29
Din Moscow,3738,7,5,7,8,19,24,-5,22
FK Rubin,3738,8,5,6,9,23,20,3,21
Amkar,3738,9,5,4,11,11,25,-14,19
Rostov,3738,10,4,6,10,10,18,-8,18
Anzhi,3738,11,4,5,11,18,39,-21,17
Loko Moscow,3739,1,11,6,3,30,13,17,39
CSKA Moscow,3739,2,11,4,5,29,19,10,37
Zenit,3739,3,8,9,3,24,15,9,33
Spart Moscow,3739,4,8,6,6,35,29,6,30
Terek Grozny,3739,5,8,6,6,21,22,-1,30
Krasnodar,3739,6,8,5,7,28,26,2,29
Din Moscow,3739,7,6,7,7,19,22,-3,25
FK Rubin,3739,8,6,5,9,22,18,4,23
Rostov,3739,9,5,6,9,11,17,-6,21
Amkar,3739,10,5,5,10,11,23,-12,20
Anzhi,3739,11,2,5,13,14,40,-26,11
Loko Moscow,3740,1,12,5,3,32,12,20,41
CSKA Moscow,3740,2,11,4,5,28,17,11,37
Spart Moscow,3740,3,10,5,5,37,27,10,35
Krasnodar,3740,4,9,4,7,30,28,2,31
Zenit,3740,5,7,9,4,21,16,5,30
Terek Grozny,3740,6,8,6,6,24,25,-1,30
FK Rubin,3740,7,7,5,8,27,20,7,26
Din Moscow,3740,8,6,6,8,20,24,-4,24
Rostov,3740,9,4,6,10,10,19,-9,18
Amkar,3740,10,4,5,11,10,24,-14,17
Anzhi,3740,11,2,5,13,16,43,-27,11
Loko Moscow,3741,1,12,5,3,32,14,18,41
CSKA Moscow,3741,2,11,3,6,28,19,9,36
Spart Moscow,3741,3,10,5,5,35,26,9,35
Krasnodar,3741,4,10,4,6,29,24,5,34
Zenit,3741,5,8,8,4,24,16,8,32
Terek Grozny,3741,6,8,6,6,22,23,-1,30
Din Moscow,3741,7,5,7,8,18,23,-5,22
FK Rubin,3741,8,5,6,9,22,19,3,21
Amkar,3741,9,5,5,10,10,22,-12,20
Rostov,3741,10,4,6,10,10,18,-8,18
Anzhi,3741,11,2,5,13,16,42,-26,11
Loko Moscow,3742,1,11,5,4,30,15,15,38
CSKA Moscow,3742,2,11,4,5,26,17,9,37
Spart Moscow,3742,3,9,7,4,36,27,9,34
Zenit,3742,4,8,9,3,23,14,9,33
Krasnodar,3742,5,9,4,7,29,25,4,31
Terek Grozny,3742,6,7,7,6,24,26,-2,28
FK Rubin,3742,7,6,6,8,22,17,5,24
Din Moscow,3742,8,5,7,8,18,23,-5,22
Rostov,3742,9,4,7,9,10,17,-7,19
Amkar,3742,10,4,6,10,12,25,-13,18
Anzhi,3742,11,2,6,12,16,40,-24,12
Loko Moscow,3743,1,13,5,2,33,12,21,44
CSKA Moscow,3743,2,12,3,5,30,18,12,39
Spart Moscow,3743,3,9,6,5,37,29,8,33
Zenit,3743,4,7,8,5,23,18,5,29
Krasnodar,3743,5,8,4,8,28,29,-1,28
Terek Grozny,3743,6,7,6,7,20,24,-4,27
Din Moscow,3743,7,6,7,7,20,23,-3,25
FK Rubin,3743,8,6,5,9,24,19,5,23
Amkar,3743,9,6,4,10,12,22,-10,22
Rostov,3743,10,4,6,10,11,19,-8,18
Anzhi,3743,11,2,6,12,14,39,-25,12
Loko Moscow,3744,1,13,5,2,34,12,22,44
CSKA Moscow,3744,2,11,3,6,27,18,9,36
Zenit,3744,3,8,8,4,23,15,8,32
Spart Moscow,3744,4,9,5,6,36,30,6,32
Krasnodar,3744,5,9,4,7,32,28,4,31
Terek Grozny,3744,6,7,6,7,22,27,-5,27
Din Moscow,3744,7,5,7,8,18,23,-5,22
FK Rubin,3744,8,5,6,9,22,22,0,21
Rostov,3744,9,5,6,9,12,18,-6,21
Amkar,3744,10,5,5,10,12,23,-11,20
Anzhi,3744,11,3,5,12,18,40,-22,14
Loko Moscow,3745,1,11,5,4,31,16,15,38
Spart Moscow,3745,2,10,6,4,39,27,12,36
CSKA Moscow,3745,3,11,3,6,27,19,8,36
Zenit,3745,4,9,8,3,25,15,10,35
Krasnodar,3745,5,9,5,6,30,25,5,32
Terek Grozny,3745,6,8,5,7,21,25,-4,29
FK Rubin,3745,7,6,6,8,24,19,5,24
Din Moscow,3745,8,5,6,9,19,27,-8,21
Amkar,3745,9,5,5,10,14,24,-10,20
Rostov,3745,10,4,6,10,10,18,-8,18
Anzhi,3745,11,2,5,13,14,39,-25,11
Loko Moscow,3746,1,12,6,2,31,12,19,42
CSKA Moscow,3746,2,11,3,6,29,20,9,36
Zenit,3746,3,8,9,3,24,14,10,33
Spart Moscow,3746,4,8,6,6,36,31,5,30
Krasnodar,3746,5,8,5,7,29,27,2,29
Terek Grozny,3746,6,7,5,8,21,25,-4,26
Din Moscow,3746,7,6,7,7,20,22,-2,25
FK Rubin,3746,8,5,7,8,22,18,4,22
Rostov,3746,9,5,6,9,11,17,-6,21
Amkar,3746,10,5,5,10,12,24,-12,20
Anzhi,3746,11,3,5,12,16,41,-25,14
CSKA Moscow,3747,1,12,3,5,30,17,13,39
Loko Moscow,3747,2,11,5,4,31,16,15,38
Spart Moscow,3747,3,10,6,4,39,28,11,36
Zenit,3747,4,8,8,4,23,17,6,32
Krasnodar,3747,5,9,4,7,30,26,4,31
Terek Grozny,3747,6,7,7,6,21,23,-2,28
Din Moscow,3747,7,6,6,8,19,23,-4,24
FK Rubin,3747,8,6,5,9,23,19,4,23
Rostov,3747,9,4,6,10,11,20,-9,18
Amkar,3747,10,4,6,10,11,24,-13,18
Anzhi,3747,11,2,6,12,15,40,-25,12
Loko Moscow,3748,1,11,5,4,29,15,14,38
Spart Moscow,3748,2,10,6,4,38,27,11,36
CSKA Moscow,3748,3,10,5,5,27,19,8,35
Krasnodar,3748,4,10,4,6,31,25,6,34
Zenit,3748,5,8,9,3,24,14,10,33
Terek Grozny,3748,6,7,7,6,20,22,-2,28
FK Rubin,3748,7,6,5,9,24,19,5,23
Din Moscow,3748,8,5,6,9,17,25,-8,21
Rostov,3748,9,4,7,9,11,18,-7,19
Amkar,3748,10,4,5,11,10,24,-14,17
Anzhi,3748,11,2,7,11,15,38,-23,13
Loko Moscow,3749,1,12,6,2,33,11,22,42
Spart Moscow,3749,2,10,6,4,36,25,11,36
CSKA Moscow,3749,3,10,3,7,26,23,3,33
Zenit,3749,4,8,8,4,25,17,8,32
Krasnodar,3749,5,8,6,6,28,25,3,30
Terek Grozny,3749,6,7,5,8,21,28,-7,26
Din Moscow,3749,7,6,6,8,18,23,-5,24
FK Rubin,3749,8,5,6,9,22,19,3,21
Amkar,3749,9,5,5,10,10,22,-12,20
Rostov,3749,10,4,6,10,10,18,-8,18
Anzhi,3749,11,4,5,11,21,39,-18,17
Loko Moscow,3750,1,12,5,3,32,13,19,41
CSKA Moscow,3750,2,10,5,5,26,18,8,35
Krasnodar,3750,3,10,4,6,32,26,6,34
Spart Moscow,3750,4,9,5,6,35,30,5,32
Zenit,3750,5,7,9,4,21,15,6,30
Terek Grozny,3750,6,7,6,7,21,24,-3,27
Din Moscow,3750,7,5,7,8,17,22,-5,22
Amkar,3750,8,6,4,10,14,23,-9,22
FK Rubin,3750,9,5,6,9,22,20,2,21
Rostov,3750,10,5,6,9,11,17,-6,21
Anzhi,3750,11,2,7,11,16,39,-23,13
Loko Moscow,3751,1,12,6,2,34,14,20,42
Spart Moscow,3751,2,10,6,4,40,27,13,36
CSKA Moscow,3751,3,11,3,6,28,22,6,36
Zenit,3751,4,8,9,3,26,15,11,33
Krasnodar,3751,5,9,4,7,33,29,4,31
Terek Grozny,3751,6,8,6,6,26,26,0,30
FK Rubin,3751,7,6,5,9,24,21,3,23
Din Moscow,3751,8,5,7,8,18,24,-6,22
Rostov,3751,9,4,6,10,11,21,-10,18
Amkar,3751,10,4,4,12,10,27,-17,16
Anzhi,3751,11,2,6,12,18,42,-24,12
Loko Moscow,3752,1,11,6,3,29,12,17,39
CSKA Moscow,3752,2,11,3,6,28,19,9,36
Krasnodar,3752,3,10,4,6,30,25,5,34
Zenit,3752,4,8,9,3,22,13,9,33
Spart Moscow,3752,5,8,6,6,36,31,5,30
Terek Grozny,3752,6,7,6,7,21,24,-3,27
Din Moscow,3752,7,5,8,7,20,24,-4,23
Amkar,3752,8,6,4,10,12,22,-10,22
FK Rubin,3752,9,5,6,9,24,21,3,21
Rostov,3752,10,5,6,9,13,19,-6,21
Anzhi,3752,11,2,6,12,16,41,-25,12
Loko Moscow,3753,1,11,7,2,30,12,18,40
CSKA Moscow,3753,2,11,4,5,31,19,12,37
Spart Moscow,3753,3,10,6,4,44,28,16,36
Terek Grozny,3753,4,9,5,6,24,23,1,32
Zenit,3753,5,7,10,3,23,15,8,31
Krasnodar,3753,6,8,6,6,30,27,3,30
FK Rubin,3753,7,6,6,8,25,19,6,24
Din Moscow,3753,8,5,7,8,19,25,-6,22
Rostov,3753,9,4,6,10,11,19,-8,18
Amkar,3753,10,4,4,12,10,32,-22,16
Anzhi,3753,11,2,5,13,14,42,-28,11
Loko Moscow,3754,1,12,6,2,33,14,19,42
Spart Moscow,3754,2,10,6,4,38,25,13,36
CSKA Moscow,3754,3,11,3,6,28,18,10,36
Zenit,3754,4,8,9,3,23,14,9,33
Terek Grozny,3754,5,8,5,7,23,25,-2,29
Krasnodar,3754,6,8,4,8,30,30,0,28
FK Rubin,3754,7,7,5,8,26,19,7,26
Din Moscow,3754,8,5,6,9,18,27,-9,21
Amkar,3754,9,5,5,10,10,22,-12,20
Rostov,3754,10,4,6,10,10,18,-8,18
Anzhi,3754,11,2,5,13,16,43,-27,11
Loko Moscow,3755,1,13,5,2,34,14,20,44
CSKA Moscow,3755,2,11,3,6,27,20,7,36
Spart Moscow,3755,3,9,7,4,37,27,10,34
Zenit,3755,4,8,8,4,24,15,9,32
Krasnodar,3755,5,8,4,8,29,29,0,28
Terek Grozny,3755,6,7,6,7,21,24,-3,27
Din Moscow,3755,7,6,6,8,18,23,-5,24
FK Rubin,3755,8,6,5,9,23,18,5,23
Amkar,3755,9,5,5,10,12,24,-12,20
Rostov,3755,10,4,7,9,10,17,-7,19
Anzhi,3755,11,2,6,12,16,40,-24,12
Loko Moscow,3756,1,13,5,2,31,11,20,44
CSKA Moscow,3756,2,11,3,6,30,21,9,36
Spart Moscow,3756,3,10,5,5,39,27,12,35
Zenit,3756,4,8,8,4,24,16,8,32
Krasnodar,3756,5,9,4,7,28,25,3,31
Terek Grozny,3756,6,8,5,7,22,24,-2,29
Din Moscow,3756,7,6,6,8,21,24,-3,24
FK Rubin,3756,8,5,5,10,21,22,-1,20
Amkar,3756,9,5,4,11,12,24,-12,19
Rostov,3756,10,4,6,10,10,20,-10,18
Anzhi,3756,11,3,5,12,16,40,-24,14
Loko Moscow,3757,1,13,5,2,33,11,22,44
Spart Moscow,3757,2,11,5,4,41,26,15,38
CSKA Moscow,3757,3,11,3,6,28,19,9,36
Krasnodar,3757,4,9,4,7,31,26,5,31
Terek Grozny,3757,5,8,6,6,21,22,-1,30
Zenit,3757,6,7,8,5,21,17,4,29
Din Moscow,3757,7,6,6,8,19,27,-8,24
FK Rubin,3757,8,5,5,10,22,23,-1,20
Rostov,3757,9,4,6,10,10,18,-8,18
Amkar,3757,10,4,4,12,10,25,-15,16
Anzhi,3757,11,3,6,11,16,38,-22,15
Loko Moscow,3758,1,11,5,4,30,15,15,38
CSKA Moscow,3758,2,11,4,5,28,19,9,37
Spart Moscow,3758,3,10,6,4,40,27,13,36
Krasnodar,3758,4,10,4,6,31,24,7,34
Zenit,3758,5,8,9,3,25,16,9,33
Terek Grozny,3758,6,7,5,8,23,27,-4,26
Din Moscow,3758,7,6,6,8,20,25,-5,24
FK Rubin,3758,8,5,5,10,21,21,0,20
Amkar,3758,9,5,5,10,13,25,-12,20
Rostov,3758,10,4,6,10,10,19,-9,18
Anzhi,3758,11,3,5,12,16,39,-23,14
Loko Moscow,3759,1,11,5,4,31,15,16,38
Spart Moscow,3759,2,11,5,4,38,27,11,38
CSKA Moscow,3759,3,10,5,5,25,17,8,35
Krasnodar,3759,4,10,4,6,32,27,5,34
Zenit,3759,5,8,9,3,22,13,9,33
Terek Grozny,3759,6,7,6,7,22,25,-3,27
Din Moscow,3759,7,6,6,8,23,22,1,24
FK Rubin,3759,8,5,5,10,22,25,-3,20
Amkar,3759,9,5,4,11,11,24,-13,19
Rostov,3759,10,4,6,10,11,19,-8,18
Anzhi,3759,11,2,7,11,16,39,-23,13
Loko Moscow,3760,1,12,5,3,30,12,18,41
CSKA Moscow,3760,2,11,3,6,26,18,8,36
Spart Moscow,3760,3,9,7,4,36,27,9,34
Zenit,3760,4,8,8,4,22,14,8,32
Krasnodar,3760,5,9,4,7,28,25,3,31
Terek Grozny,3760,6,8,5,7,24,26,-2,29
Din Moscow,3760,7,6,7,7,19,22,-3,25
FK Rubin,3760,8,6,5,9,22,18,4,23
Rostov,3760,9,4,7,9,11,18,-7,19
Amkar,3760,10,4,4,12,10,25,-15,16
Anzhi,3760,11,3,5,12,17,40,-23,14
Loko Moscow,3761,1,11,6,3,31,15,16,39
CSKA Moscow,3761,2,11,4,5,28,19,9,37
Zenit,3761,3,8,9,3,24,14,10,33
Spart Moscow,3761,4,9,6,5,37,29,8,33
Krasnodar,3761,5,9,5,6,30,25,5,32
Terek Grozny,3761,6,7,6,7,20,23,-3,27
Din Moscow,3761,7,6,6,8,20,24,-4,24
FK Rubin,3761,8,6,5,9,22,19,3,23
Rostov,3761,9,4,7,9,11,18,-7,19
Amkar,3761,10,4,5,11,9,23,-14,17
Anzhi,3761,11,3,5,12,17,40,-23,14
Loko Moscow,3762,1,11,6,3,30,14,16,39
Spart Moscow,3762,2,11,5,4,42,29,13,38
CSKA Moscow,3762,3,10,5,5,26,18,8,35
Krasnodar,3762,4,10,4,6,30,24,6,34
Zenit,3762,5,7,10,3,23,15,8,31
Terek Grozny,3762,6,8,6,6,22,23,-1,30
Din Moscow,3762,7,5,7,8,20,25,-5,22
FK Rubin,3762,8,5,6,9,22,19,3,21
Rostov,3762,9,4,6,10,11,21,-10,18
Amkar,3762,10,4,5,11,10,24,-14,17
Anzhi,3762,11,2,6,12,15,39,-24,12
Loko Moscow,3763,1,13,5,2,32,12,20,44
CSKA Moscow,3763,2,11,4,5,29,18,11,37
Spart Moscow,3763,3,9,6,5,35,29,6,33
Krasnodar,3763,4,9,4,7,30,27,3,31
Zenit,3763,5,7,9,4,21,14,7,30
Terek Grozny,3763,6,7,6,7,22,25,-3,27
Din Moscow,3763,7,5,8,7,18,22,-4,23
FK Rubin,3763,8,5,6,9,22,19,3,21
Amkar,3763,9,5,5,10,13,23,-10,20
Rostov,3763,10,4,6,10,10,18,-8,18
Anzhi,3763,11,3,5,12,17,42,-25,14
Loko Moscow,3764,1,11,6,3,29,12,17,39
CSKA Moscow,3764,2,12,3,5,31,17,14,39
Spart Moscow,3764,3,9,7,4,37,27,10,34
Zenit,3764,4,8,8,4,22,16,6,32
Terek Grozny,3764,5,9,5,6,23,22,1,32
Krasnodar,3764,6,8,5,7,27,27,0,29
Din Moscow,3764,7,6,6,8,19,24,-5,24
FK Rubin,3764,8,6,5,9,24,18,6,23
Rostov,3764,9,4,7,9,10,17,-7,19
Amkar,3764,10,4,5,11,10,24,-14,17
Anzhi,3764,11,2,5,13,14,42,-28,11
Loko Moscow,3765,1,11,6,3,29,12,17,39
Zenit,3765,2,9,8,3,23,13,10,35
CSKA Moscow,3765,3,10,4,6,26,19,7,34
Spart Moscow,3765,4,9,6,5,37,28,9,33
Terek Grozny,3765,5,8,6,6,22,23,-1,30
Krasnodar,3765,6,8,5,7,29,27,2,29
FK Rubin,3765,7,6,6,8,25,20,5,24
Din Moscow,3765,8,5,8,7,19,23,-4,23
Amkar,3765,9,5,4,11,11,24,-13,19
Rostov,3765,10,4,6,10,10,19,-9,18
Anzhi,3765,11,2,7,11,16,39,-23,13
Loko Moscow,3766,1,12,5,3,30,12,18,41
CSKA Moscow,3766,2,11,4,5,29,18,11,37
Spart Moscow,3766,3,10,6,4,42,30,12,36
Zenit,3766,4,8,8,4,22,16,6,32
Terek Grozny,3766,5,9,5,6,24,24,0,32
Krasnodar,3766,6,9,4,7,31,25,6,31
FK Rubin,3766,7,6,5,9,22,21,1,23
Din Moscow,3766,8,5,7,8,19,24,-5,22
Rostov,3766,9,4,6,10,11,21,-10,18
Amkar,3766,10,4,4,12,12,27,-15,16
Anzhi,3766,11,2,6,12,16,40,-24,12
Loko Moscow,3767,1,11,6,3,29,13,16,39
Spart Moscow,3767,2,10,5,5,37,27,10,35
CSKA Moscow,3767,3,10,5,5,27,19,8,35
Zenit,3767,4,8,9,3,24,14,10,33
Krasnodar,3767,5,9,5,6,31,25,6,32
Terek Grozny,3767,6,8,5,7,22,24,-2,29
Din Moscow,3767,7,5,7,8,17,23,-6,22
FK Rubin,3767,8,5,6,9,22,21,1,21
Rostov,3767,9,5,6,9,12,18,-6,21
Amkar,3767,10,4,4,12,10,25,-15,16
Anzhi,3767,11,3,6,11,16,38,-22,15
Loko Moscow,3768,1,12,5,3,31,12,19,41
Zenit,3768,2,9,8,3,25,15,10,35
CSKA Moscow,3768,3,10,4,6,28,21,7,34
Spart Moscow,3768,4,9,6,5,34,26,8,33
Terek Grozny,3768,5,9,5,6,23,23,0,32
Krasnodar,3768,6,9,4,7,29,26,3,31
Din Moscow,3768,7,6,7,7,18,21,-3,25
FK Rubin,3768,8,5,5,10,21,20,1,20
Amkar,3768,9,5,4,11,10,23,-13,19
Rostov,3768,10,4,6,10,10,18,-8,18
Anzhi,3768,11,2,6,12,16,40,-24,12
Loko Moscow,3769,1,11,5,4,32,16,16,38
Spart Moscow,3769,2,11,5,4,36,25,11,38
CSKA Moscow,3769,3,11,3,6,26,18,8,36
Zenit,3769,4,9,8,3,25,15,10,35
Terek Grozny,3769,5,9,5,6,24,24,0,32
Krasnodar,3769,6,9,4,7,29,27,2,31
FK Rubin,3769,7,6,6,8,23,17,6,24
Din Moscow,3769,8,5,7,8,17,22,-5,22
Rostov,3769,9,4,6,10,10,18,-8,18
Amkar,3769,10,4,4,12,10,25,-15,16
Anzhi,3769,11,2,5,13,15,40,-25,11
Loko Moscow,3770,1,12,5,3,31,14,17,41
CSKA Moscow,3770,2,12,3,5,29,18,11,39
Spart Moscow,3770,3,10,6,4,39,29,10,36
Zenit,3770,4,8,8,4,24,15,9,32
Terek Grozny,3770,5,9,5,6,24,22,2,32
Krasnodar,3770,6,8,5,7,28,26,2,29
Din Moscow,3770,7,6,6,8,20,23,-3,24
FK Rubin,3770,8,5,6,9,22,20,2,21
Rostov,3770,9,4,6,10,12,20,-8,18
Amkar,3770,10,4,5,11,10,25,-15,17
Anzhi,3770,11,2,5,13,15,42,-27,11
Loko Moscow,3771,1,12,6,2,32,11,21,42
CSKA Moscow,3771,2,11,3,6,29,18,11,36
Spart Moscow,3771,3,9,7,4,37,28,9,34
Zenit,3771,4,8,8,4,22,16,6,32
Terek Grozny,3771,5,9,5,6,24,22,2,32
Krasnodar,3771,6,8,5,7,27,26,1,29
Din Moscow,3771,7,6,6,8,21,25,-4,24
FK Rubin,3771,8,6,5,9,24,19,5,23
Rostov,3771,9,4,7,9,10,17,-7,19
Amkar,3771,10,4,5,11,10,25,-15,17
Anzhi,3771,11,2,5,13,14,43,-29,11
Loko Moscow,3772,1,13,5,2,33,13,20,44
CSKA Moscow,3772,2,10,4,6,29,23,6,34
Zenit,3772,3,8,8,4,26,17,9,32
Spart Moscow,3772,4,9,5,6,36,30,6,32
Krasnodar,3772,5,8,4,8,29,29,0,28
Terek Grozny,3772,6,7,7,6,25,27,-2,28
FK Rubin,3772,7,7,5,8,25,18,7,26
Rostov,3772,8,5,6,9,13,17,-4,21
Din Moscow,3772,9,5,6,9,17,24,-7,21
Amkar,3772,10,5,5,10,13,25,-12,20
Anzhi,3772,11,2,7,11,19,42,-23,13
Loko Moscow,3773,1,11,6,3,31,14,17,39
CSKA Moscow,3773,2,11,3,6,28,18,10,36
Spart Moscow,3773,3,10,5,5,39,29,10,35
Zenit,3773,4,9,8,3,24,14,10,35
Krasnodar,3773,5,9,5,6,29,25,4,32
Terek Grozny,3773,6,7,5,8,21,28,-7,26
Din Moscow,3773,7,6,6,8,20,24,-4,24
Rostov,3773,8,5,6,9,13,18,-5,21
FK Rubin,3773,9,5,5,10,21,20,1,20
Amkar,3773,10,5,4,11,12,24,-12,19
Anzhi,3773,11,3,5,12,17,41,-24,14
Loko Moscow,3774,1,12,5,3,30,14,16,41
CSKA Moscow,3774,2,11,3,6,26,19,7,36
Zenit,3774,3,9,8,3,26,13,13,35
Terek Grozny,3774,4,9,5,6,23,23,0,32
Krasnodar,3774,5,9,4,7,29,26,3,31
Spart Moscow,3774,6,8,6,6,36,30,6,30
Din Moscow,3774,7,6,6,8,20,25,-5,24
FK Rubin,3774,8,6,5,9,25,20,5,23
Rostov,3774,9,5,6,9,11,17,-6,21
Amkar,3774,10,4,5,11,11,25,-14,17
Anzhi,3774,11,2,5,13,15,40,-25,11
Loko Moscow,3775,1,12,5,3,35,14,21,41
CSKA Moscow,3775,2,11,4,5,27,18,9,37
Spart Moscow,3775,3,10,6,4,40,26,14,36
Krasnodar,3775,4,9,4,7,30,27,3,31
Zenit,3775,5,7,9,4,21,17,4,30
Terek Grozny,3775,6,8,5,7,22,24,-2,29
FK Rubin,3775,7,7,5,8,25,18,7,26
Din Moscow,3775,8,5,6,9,18,27,-9,21
Rostov,3775,9,4,7,9,11,18,-7,19
Amkar,3775,10,5,4,11,11,26,-15,19
Anzhi,3775,11,2,5,13,15,40,-25,11
Loko Moscow,3776,1,12,6,2,32,11,21,42
CSKA Moscow,3776,2,12,3,5,30,18,12,39
Spart Moscow,3776,3,9,5,6,35,30,5,32
Zenit,3776,4,7,9,4,22,16,6,30
Terek Grozny,3776,5,8,5,7,21,25,-4,29
Krasnodar,3776,6,8,4,8,27,29,-2,28
FK Rubin,3776,7,7,5,8,27,19,8,26
Amkar,3776,8,6,4,10,16,22,-6,22
Rostov,3776,9,5,6,9,11,17,-6,21
Din Moscow,3776,10,5,6,9,19,27,-8,21
Anzhi,3776,11,2,5,13,14,40,-26,11
Loko Moscow,3777,1,12,5,3,32,13,19,41
Spart Moscow,3777,2,10,6,4,41,26,15,36
Zenit,3777,3,9,8,3,25,14,11,35
CSKA Moscow,3777,4,10,3,7,26,20,6,33
Krasnodar,3777,5,9,4,7,31,29,2,31
Terek Grozny,3777,6,8,5,7,21,23,-2,29
Din Moscow,3777,7,5,8,7,18,22,-4,23
FK Rubin,3777,8,5,6,9,23,21,2,21
Amkar,3777,9,5,4,11,10,25,-15,19
Rostov,3777,10,4,6,10,10,21,-11,18
Anzhi,3777,11,3,5,12,15,38,-23,14
Loko Moscow,3778,1,12,5,3,33,14,19,41
Zenit,3778,2,9,8,3,23,13,10,35
Spart Moscow,3778,3,9,7,4,37,27,10,34
CSKA Moscow,3778,4,10,4,6,27,20,7,34
Krasnodar,3778,5,9,4,7,32,29,3,31
Terek Grozny,3778,6,7,5,8,20,24,-4,26
Din Moscow,3778,7,6,7,7,19,22,-3,25
FK Rubin,3778,8,5,5,10,22,21,1,20
Amkar,3778,9,5,5,10,11,23,-12,20
Rostov,3778,10,4,6,10,10,19,-9,18
Anzhi,3778,11,3,6,11,17,39,-22,15
Loko Moscow,3779,1,11,5,4,31,15,16,38
Spart Moscow,3779,2,10,6,4,39,27,12,36
Zenit,3779,3,9,8,3,23,13,10,35
Krasnodar,3779,4,10,4,6,33,26,7,34
CSKA Moscow,3779,5,10,4,6,27,20,7,34
Terek Grozny,3779,6,7,7,6,22,24,-2,28
Din Moscow,3779,7,6,6,8,20,24,-4,24
FK Rubin,3779,8,5,5,10,21,22,-1,20
Rostov,3779,9,4,7,9,11,18,-7,19
Amkar,3779,10,4,5,11,10,25,-15,17
Anzhi,3779,11,2,7,11,17,40,-23,13
Loko Moscow,3780,1,12,5,3,31,15,16,41
CSKA Moscow,3780,2,12,3,5,28,17,11,39
Spart Moscow,3780,3,9,5,6,36,29,7,32
Krasnodar,3780,4,9,5,6,32,26,6,32
Zenit,3780,5,7,8,5,22,17,5,29
Terek Grozny,3780,6,8,5,7,24,24,0,29
Din Moscow,3780,7,6,7,7,18,21,-3,25
FK Rubin,3780,8,5,7,8,23,19,4,22
Amkar,3780,9,5,4,11,12,26,-14,19
Rostov,3780,10,4,6,10,10,19,-9,18
Anzhi,3780,11,3,5,12,16,39,-23,14
Loko Moscow,3781,1,11,5,4,29,15,14,38
Spart Moscow,3781,2,9,7,4,39,27,12,34
CSKA Moscow,3781,3,10,4,6,25,19,6,34
Zenit,3781,4,8,9,3,22,13,9,33
Krasnodar,3781,5,9,5,6,31,25,6,32
Terek Grozny,3781,6,8,6,6,21,22,-1,30
Din Moscow,3781,7,6,6,8,21,28,-7,24
FK Rubin,3781,8,5,6,9,25,22,3,21
Rostov,3781,9,4,7,9,11,18,-7,19
Amkar,3781,10,4,6,10,10,23,-13,18
Anzhi,3781,11,3,5,12,16,38,-22,14
Loko Moscow,3782,1,11,6,3,31,15,16,39
Spart Moscow,3782,2,11,5,4,39,26,13,38
Krasnodar,3782,3,10,4,6,31,25,6,34
Zenit,3782,4,8,9,3,25,15,10,33
CSKA Moscow,3782,5,10,3,7,25,20,5,33
Terek Grozny,3782,6,7,6,7,21,24,-3,27
Din Moscow,3782,7,5,7,8,17,22,-5,22
FK Rubin,3782,8,5,6,9,22,19,3,21
Rostov,3782,9,4,6,10,10,20,-10,18
Amkar,3782,10,4,5,11,10,24,-14,17
Anzhi,3782,11,4,5,11,17,38,-21,17
Loko Moscow,3783,1,13,5,2,33,12,21,44
CSKA Moscow,3783,2,11,3,6,28,20,8,36
Spart Moscow,3783,3,9,6,5,37,27,10,33
Zenit,3783,4,8,8,4,25,16,9,32
Krasnodar,3783,5,9,4,7,28,25,3,31
Terek Grozny,3783,6,8,5,7,24,25,-1,29
FK Rubin,3783,7,6,5,9,24,20,4,23
Din Moscow,3783,8,5,7,8,19,24,-5,22
Amkar,3783,9,6,4,10,13,23,-10,22
Rostov,3783,10,4,6,10,11,21,-10,18
Anzhi,3783,11,2,5,13,14,43,-29,11
Loko Moscow,3784,1,12,6,2,31,12,19,42
CSKA Moscow,3784,2,11,3,6,26,18,8,36
Spart Moscow,3784,3,8,8,4,38,30,8,32
Zenit,3784,4,8,8,4,22,14,8,32
Krasnodar,3784,5,9,5,6,30,25,5,32
Terek Grozny,3784,6,9,5,6,24,24,0,32
FK Rubin,3784,7,6,5,9,25,20,5,23
Din Moscow,3784,8,5,7,8,19,26,-7,22
Rostov,3784,9,4,7,9,11,18,-7,19
Amkar,3784,10,4,5,11,12,26,-14,17
Anzhi,3784,11,2,5,13,16,41,-25,11
Loko Moscow,3785,1,11,6,3,29,12,17,39
CSKA Moscow,3785,2,11,4,5,31,19,12,37
Spart Moscow,3785,3,10,5,5,42,30,12,35
Krasnodar,3785,4,10,4,6,30,25,5,34
Zenit,3785,5,7,10,3,23,15,8,31
Terek Grozny,3785,6,7,7,6,23,25,-2,28
Din Moscow,3785,7,6,6,8,20,25,-5,24
FK Rubin,3785,8,5,5,10,23,22,1,20
Amkar,3785,9,5,5,10,15,27,-12,20
Rostov,3785,10,4,6,10,11,20,-9,18
Anzhi,3785,11,2,6,12,15,42,-27,12
Loko Moscow,3786,1,11,5,4,32,18,14,38
CSKA Moscow,3786,2,11,4,5,28,19,9,37
Spart Moscow,3786,3,10,6,4,41,28,13,36
Krasnodar,3786,4,10,4,6,31,25,6,34
Zenit,3786,5,8,8,4,26,17,9,32
Terek Grozny,3786,6,8,5,7,22,24,-2,29
Din Moscow,3786,7,5,8,7,21,25,-4,23
FK Rubin,3786,8,5,6,9,23,20,3,21
Amkar,3786,9,5,4,11,11,25,-14,19
Rostov,3786,10,4,6,10,11,20,-9,18
Anzhi,3786,11,2,6,12,15,40,-25,12
Loko Moscow,3787,1,11,5,4,29,13,16,38
CSKA Moscow,3787,2,11,3,6,26,18,8,36
Zenit,3787,3,9,8,3,23,13,10,35
Krasnodar,3787,4,10,4,6,29,24,5,34
Spart Moscow,3787,5,9,6,5,35,27,8,33
Terek Grozny,3787,6,9,5,6,23,22,1,32
Din Moscow,3787,7,6,7,7,19,22,-3,25
Rostov,3787,8,5,6,9,11,17,-6,21
FK Rubin,3787,9,5,5,10,21,19,2,20
Amkar,3787,10,4,4,12,9,24,-15,16
Anzhi,3787,11,2,5,13,14,40,-26,11
Loko Moscow,3788,1,12,5,3,30,12,18,41
CSKA Moscow,3788,2,11,3,6,27,19,8,36
Spart Moscow,3788,3,10,5,5,39,28,11,35
Zenit,3788,4,8,8,4,23,14,9,32
Krasnodar,3788,5,9,5,6,29,25,4,32
Terek Grozny,3788,6,8,6,6,25,24,1,30
FK Rubin,3788,7,5,7,8,23,19,4,22
Din Moscow,3788,8,5,7,8,18,23,-5,22
Rostov,3788,9,5,6,9,13,19,-6,21
Amkar,3788,10,4,5,11,10,26,-16,17
Anzhi,3788,11,2,5,13,15,43,-28,11
Loko Moscow,3789,1,11,7,2,31,13,18,40
Spart Moscow,3789,2,11,5,4,37,26,11,38
CSKA Moscow,3789,3,11,3,6,29,20,9,36
Krasnodar,3789,4,9,5,6,29,25,4,32
Zenit,3789,5,7,9,4,22,16,6,30
Terek Grozny,3789,6,8,5,7,23,25,-2,29
Din Moscow,3789,7,5,7,8,20,25,-5,22
FK Rubin,3789,8,5,6,9,24,21,3,21
Rostov,3789,9,4,6,10,11,19,-8,18
Anzhi,3789,10,4,5,11,20,41,-21,17
Amkar,3789,11,4,4,12,9,24,-15,16
Loko Moscow,3790,1,12,6,2,30,11,19,42
CSKA Moscow,3790,2,12,3,5,28,18,10,39
Spart Moscow,3790,3,10,5,5,36,27,9,35
Krasnodar,3790,4,9,5,6,30,25,5,32
Terek Grozny,3790,5,9,5,6,26,25,1,32
Zenit,3790,6,7,8,5,22,16,6,29
FK Rubin,3790,7,6,5,9,24,21,3,23
Din Moscow,3790,8,5,6,9,18,24,-6,21
Rostov,3790,9,5,6,9,12,18,-6,21
Amkar,3790,10,4,4,12,9,25,-16,16
Anzhi,3790,11,2,5,13,17,42,-25,11
Loko Moscow,3791,1,12,5,3,31,13,18,41
Spart Moscow,3791,2,10,5,5,36,28,8,35
Krasnodar,3791,3,10,4,6,30,25,5,34
CSKA Moscow,3791,4,10,4,6,26,22,4,34
Zenit,3791,5,8,8,4,25,14,11,32
Terek Grozny,3791,6,8,5,7,23,28,-5,29
Din Moscow,3791,7,6,6,8,21,24,-3,24
Amkar,3791,8,6,4,10,15,22,-7,22
FK Rubin,3791,9,5,5,10,22,21,1,20
Rostov,3791,10,4,6,10,10,18,-8,18
Anzhi,3791,11,2,6,12,17,41,-24,12
Loko Moscow,3792,1,11,5,4,30,15,15,38
Zenit,3792,2,9,8,3,23,13,10,35
CSKA Moscow,3792,3,10,4,6,25,18,7,34
Krasnodar,3792,4,10,4,6,32,26,6,34
Spart Moscow,3792,5,9,6,5,38,30,8,33
Terek Grozny,3792,6,7,7,6,21,23,-2,28
Din Moscow,3792,7,6,7,7,21,24,-3,25
FK Rubin,3792,8,5,5,10,23,21,2,20
Amkar,3792,9,5,5,10,12,24,-12,20
Rostov,3792,10,4,6,10,11,19,-8,18
Anzhi,3792,11,2,7,11,14,37,-23,13
Loko Moscow,3793,1,13,5,2,32,11,21,44
Spart Moscow,3793,2,11,5,4,40,28,12,38
CSKA Moscow,3793,3,10,4,6,28,22,6,34
Krasnodar,3793,4,9,4,7,30,26,4,31
Zenit,3793,5,7,9,4,23,16,7,30
Terek Grozny,3793,6,8,6,6,24,24,0,30
FK Rubin,3793,7,6,5,9,23,20,3,23
Din Moscow,3793,8,5,6,9,17,25,-8,21
Rostov,3793,9,4,6,10,11,19,-8,18
Amkar,3793,10,4,4,12,11,27,-16,16
Anzhi,3793,11,3,6,11,19,40,-21,15
Loko Moscow,3794,1,12,5,3,31,13,18,41
Spart Moscow,3794,2,10,5,5,39,27,12,35
CSKA Moscow,3794,3,10,4,6,26,19,7,34
Zenit,3794,4,8,8,4,22,15,7,32
Krasnodar,3794,5,9,4,7,30,26,4,31
Terek Grozny,3794,6,8,6,6,23,24,-1,30
FK Rubin,3794,7,7,5,8,25,19,6,26
Din Moscow,3794,8,6,6,8,20,23,-3,24
Rostov,3794,9,4,6,10,10,21,-11,18
Amkar,3794,10,4,4,12,10,26,-16,16
Anzhi,3794,11,2,7,11,16,39,-23,13
Loko Moscow,3795,1,11,5,4,29,14,15,38
CSKA Moscow,3795,2,11,3,6,27,22,5,36
Zenit,3795,3,9,8,3,27,13,14,35
Spart Moscow,3795,4,10,5,5,38,28,10,35
Krasnodar,3795,5,10,4,6,29,24,5,34
Terek Grozny,3795,6,7,5,8,21,25,-4,26
Din Moscow,3795,7,6,6,8,20,25,-5,24
Amkar,3795,8,6,4,10,12,23,-11,22
FK Rubin,3795,9,5,5,10,22,20,2,20
Rostov,3795,10,4,6,10,10,18,-8,18
Anzhi,3795,11,3,5,12,17,40,-23,14
Loko Moscow,3796,1,12,5,3,34,16,18,41
CSKA Moscow,3796,2,12,3,5,30,19,11,39
Spart Moscow,3796,3,10,5,5,38,28,10,35
Krasnodar,3796,4,10,4,6,33,28,5,34
Zenit,3796,5,7,8,5,23,18,5,29
Terek Grozny,3796,6,8,5,7,22,25,-3,29
Din Moscow,3796,7,6,6,8,20,23,-3,24
FK Rubin,3796,8,5,5,10,23,22,1,20
Amkar,3796,9,5,4,11,13,25,-12,19
Rostov,3796,10,4,6,10,10,20,-10,18
Anzhi,3796,11,3,5,12,17,39,-22,14
Loko Moscow,3797,1,11,7,2,31,13,18,40
CSKA Moscow,3797,2,11,4,5,27,17,10,37
Spart Moscow,3797,3,10,5,5,40,28,12,35
Krasnodar,3797,4,9,5,6,29,25,4,32
Zenit,3797,5,7,9,4,23,17,6,30
Terek Grozny,3797,6,8,6,6,22,23,-1,30
Din Moscow,3797,7,5,7,8,18,26,-8,22
FK Rubin,3797,8,5,6,9,23,20,3,21
Amkar,3797,9,5,5,10,13,24,-11,20
Rostov,3797,10,4,6,10,10,19,-9,18
Anzhi,3797,11,2,6,12,14,38,-24,12
Loko Moscow,3798,1,13,5,2,33,12,21,44
CSKA Moscow,3798,2,11,4,5,27,18,9,37
Spart Moscow,3798,3,10,5,5,38,28,10,35
Zenit,3798,4,7,8,5,21,16,5,29
Krasnodar,3798,5,8,4,8,28,28,0,28
Terek Grozny,3798,6,7,7,6,22,24,-2,28
Din Moscow,3798,7,6,7,7,21,24,-3,25
FK Rubin,3798,8,6,6,8,24,18,6,24
Rostov,3798,9,4,6,10,10,18,-8,18
Amkar,3798,10,4,5,11,10,25,-15,17
Anzhi,3798,11,2,7,11,16,39,-23,13
Loko Moscow,3799,1,12,6,2,34,11,23,42
CSKA Moscow,3799,2,11,4,5,26,17,9,37
Spart Moscow,3799,3,9,6,5,37,28,9,33
Zenit,3799,4,7,9,4,21,14,7,30
Krasnodar,3799,5,8,4,8,27,30,-3,28
Din Moscow,3799,6,7,6,7,22,22,0,27
Terek Grozny,3799,7,7,6,7,22,26,-4,27
FK Rubin,3799,8,6,5,9,22,20,2,23
Amkar,3799,9,5,5,10,13,24,-11,20
Rostov,3799,10,4,6,10,10,19,-9,18
Anzhi,3799,11,2,7,11,15,38,-23,13
CSKA Moscow,3800,1,12,3,5,29,18,11,39
Loko Moscow,3800,2,11,5,4,29,16,13,38
Spart Moscow,3800,3,10,6,4,37,26,11,36
Krasnodar,3800,4,10,4,6,30,24,6,34
Zenit,3800,5,8,8,4,24,15,9,32
Terek Grozny,3800,6,8,6,6,22,23,-1,30
Din Moscow,3800,7,5,8,7,19,23,-4,23
FK Rubin,3800,8,5,6,9,22,19,3,21
Rostov,3800,9,4,6,10,10,18,-8,18
Amkar,3800,10,4,5,11,10,25,-15,17
Anzhi,3800,11,2,5,13,15,40,-25,11
Loko Moscow,3801,1,12,5,3,32,14,18,41
CSKA Moscow,3801,2,11,4,5,29,19,10,37
Zenit,3801,3,8,8,4,23,16,7,32
Spart Moscow,3801,4,8,7,5,37,31,6,31
Krasnodar,3801,5,8,5,7,28,26,2,29
Terek Grozny,3801,6,8,5,7,21,24,-3,29
Din Moscow,3801,7,5,8,7,19,23,-4,23
FK Rubin,3801,8,5,7,8,22,18,4,22
Rostov,3801,9,4,7,9,12,19,-7,19
Amkar,3801,10,5,4,11,12,24,-12,19
Anzhi,3801,11,3,6,11,18,39,-21,15
Loko Moscow,3802,1,12,5,3,33,13,20,41
CSKA Moscow,3802,2,11,3,6,27,20,7,36
Spart Moscow,3802,3,9,6,5,38,30,8,33
Zenit,3802,4,8,8,4,25,17,8,32
Krasnodar,3802,5,9,4,7,28,25,3,31
Terek Grozny,3802,6,7,7,6,23,25,-2,28
Din Moscow,3802,7,6,7,7,20,22,-2,25
FK Rubin,3802,8,6,5,9,22,19,3,23
Amkar,3802,9,5,5,10,12,23,-11,20
Rostov,3802,10,4,6,10,12,21,-9,18
Anzhi,3802,11,2,6,12,16,41,-25,12
Loko Moscow,3803,1,12,5,3,30,14,16,41
CSKA Moscow,3803,2,11,4,5,27,18,9,37
Spart Moscow,3803,3,10,5,5,37,28,9,35
Krasnodar,3803,4,10,4,6,32,25,7,34
Terek Grozny,3803,5,8,6,6,24,24,0,30
Zenit,3803,6,7,8,5,22,16,6,29
Din Moscow,3803,7,6,6,8,20,23,-3,24
FK Rubin,3803,8,5,5,10,22,21,1,20
Amkar,3803,9,5,5,10,12,23,-11,20
Rostov,3803,10,4,6,10,10,19,-9,18
Anzhi,3803,11,2,6,12,15,40,-25,12
Loko Moscow,3804,1,11,7,2,31,13,18,40
CSKA Moscow,3804,2,11,4,5,27,18,9,37
Spart Moscow,3804,3,9,6,5,39,31,8,33
Krasnodar,3804,4,9,5,6,29,25,4,32
Zenit,3804,5,7,10,3,24,16,8,31
Terek Grozny,3804,6,8,5,7,21,24,-3,29
Din Moscow,3804,7,6,7,7,21,24,-3,25
Amkar,3804,8,6,4,10,14,24,-10,22
FK Rubin,3804,9,5,5,10,23,21,2,20
Rostov,3804,10,4,6,10,11,19,-8,18
Anzhi,3804,11,2,5,13,14,39,-25,11
Loko Moscow,3805,1,12,6,2,34,12,22,42
CSKA Moscow,3805,2,11,3,6,29,21,8,36
Spart Moscow,3805,3,9,7,4,38,28,10,34
Zenit,3805,4,8,9,3,24,15,9,33
Terek Grozny,3805,5,9,5,6,25,24,1,32
Krasnodar,3805,6,9,4,7,29,28,1,31
Din Moscow,3805,7,6,7,7,19,22,-3,25
FK Rubin,3805,8,5,5,10,21,20,1,20
Rostov,3805,9,4,6,10,12,21,-9,18
Amkar,3805,10,4,5,11,9,24,-15,17
Anzhi,3805,11,2,5,13,18,43,-25,11
Loko Moscow,3806,1,11,7,2,31,13,18,40
CSKA Moscow,3806,2,11,3,6,29,19,10,36
Spart Moscow,3806,3,9,7,4,37,28,9,34
Zenit,3806,4,8,9,3,23,14,9,33
Krasnodar,3806,5,8,5,7,29,28,1,29
Terek Grozny,3806,6,8,5,7,23,23,0,29
FK Rubin,3806,7,7,5,8,26,18,8,26
Din Moscow,3806,8,5,6,9,17,24,-7,21
Rostov,3806,9,4,7,9,11,18,-7,19
Amkar,3806,10,4,5,11,11,27,-16,17
Anzhi,3806,11,3,5,12,16,41,-25,14
Loko Moscow,3807,1,11,6,3,31,15,16,39
CSKA Moscow,3807,2,11,3,6,31,20,11,36
Krasnodar,3807,3,10,4,6,33,26,7,34
Zenit,3807,4,8,9,3,25,15,10,33
Spart Moscow,3807,5,9,6,5,35,27,8,33
Terek Grozny,3807,6,8,6,6,22,23,-1,30
FK Rubin,3807,7,6,5,9,24,21,3,23
Din Moscow,3807,8,5,7,8,19,24,-5,22
Rostov,3807,9,5,6,9,11,17,-6,21
Amkar,3807,10,4,5,11,10,24,-14,17
Anzhi,3807,11,2,5,13,14,43,-29,11
Loko Moscow,3808,1,12,6,2,32,13,19,42
CSKA Moscow,3808,2,10,4,6,27,20,7,34
Spart Moscow,3808,3,9,6,5,39,31,8,33
Krasnodar,3808,4,9,5,6,31,26,5,32
Zenit,3808,5,7,9,4,22,15,7,30
Terek Grozny,3808,6,7,6,7,22,25,-3,27
Din Moscow,3808,7,6,6,8,20,24,-4,24
FK Rubin,3808,8,6,5,9,23,20,3,23
Rostov,3808,9,4,7,9,12,19,-7,19
Amkar,3808,10,4,5,11,12,26,-14,17
Anzhi,3808,11,4,5,11,18,39,-21,17
Loko Moscow,3809,1,13,5,2,33,13,20,44
CSKA Moscow,3809,2,11,3,6,29,22,7,36
Spart Moscow,3809,3,8,7,5,34,27,7,31
Krasnodar,3809,4,9,4,7,29,26,3,31
Zenit,3809,5,7,8,5,24,18,6,29
Terek Grozny,3809,6,8,5,7,22,23,-1,29
FK Rubin,3809,7,6,5,9,23,19,4,23
Din Moscow,3809,8,5,7,8,18,23,-5,22
Rostov,3809,9,5,6,9,11,17,-6,21
Amkar,3809,10,5,5,10,10,22,-12,20
Anzhi,3809,11,3,5,12,18,41,-23,14
Loko Moscow,3810,1,12,5,3,34,16,18,41
CSKA Moscow,3810,2,11,4,5,30,19,11,37
Spart Moscow,3810,3,10,6,4,40,29,11,36
Zenit,3810,4,8,9,3,25,15,10,33
Krasnodar,3810,5,9,4,7,31,28,3,31
Terek Grozny,3810,6,7,6,7,20,24,-4,27
Din Moscow,3810,7,5,7,8,19,24,-5,22
FK Rubin,3810,8,5,6,9,22,20,2,21
Amkar,3810,9,5,5,10,14,25,-11,20
Rostov,3810,10,4,6,10,10,19,-9,18
Anzhi,3810,11,2,6,12,15,41,-26,12
Loko Moscow,3811,1,11,6,3,31,14,17,39
Spart Moscow,3811,2,10,6,4,41,28,13,36
CSKA Moscow,3811,3,11,3,6,27,18,9,36
Krasnodar,3811,4,10,4,6,31,24,7,34
Zenit,3811,5,8,9,3,24,15,9,33
Terek Grozny,3811,6,7,6,7,22,28,-6,27
Din Moscow,3811,7,6,6,8,19,25,-6,24
FK Rubin,3811,8,5,5,10,21,21,0,20
Rostov,3811,9,4,7,9,11,18,-7,19
Amkar,3811,10,4,5,11,12,27,-15,17
Anzhi,3811,11,3,5,12,18,39,-21,14
Loko Moscow,3812,1,13,5,2,32,11,21,44
CSKA Moscow,3812,2,11,4,5,28,18,10,37
Spart Moscow,3812,3,10,6,4,40,29,11,36
Zenit,3812,4,7,8,5,21,16,5,29
Krasnodar,3812,5,8,5,7,27,26,1,29
Terek Grozny,3812,6,8,5,7,22,24,-2,29
FK Rubin,3812,7,6,6,8,24,17,7,24
Din Moscow,3812,8,5,6,9,19,28,-9,21
Rostov,3812,9,4,7,9,11,18,-7,19
Amkar,3812,10,4,4,12,11,26,-15,16
Anzhi,3812,11,3,6,11,16,38,-22,15
Loko Moscow,3813,1,12,5,3,32,14,18,41
CSKA Moscow,3813,2,12,3,5,32,17,15,39
Spart Moscow,3813,3,10,5,5,40,27,13,35
Krasnodar,3813,4,9,5,6,30,26,4,32
Terek Grozny,3813,5,8,6,6,21,22,-1,30
Zenit,3813,6,7,8,5,22,16,6,29
FK Rubin,3813,7,6,6,8,24,19,5,24
Din Moscow,3813,8,6,6,8,19,23,-4,24
Rostov,3813,9,4,6,10,11,20,-9,18
Amkar,3813,10,4,4,12,9,27,-18,16
Anzhi,3813,11,2,6,12,14,43,-29,12
Loko Moscow,3814,1,13,5,2,36,12,24,44
Spart Moscow,3814,2,11,5,4,38,26,12,38
CSKA Moscow,3814,3,11,4,5,29,20,9,37
Terek Grozny,3814,4,9,5,6,23,22,1,32
Krasnodar,3814,5,9,4,7,30,27,3,31
Zenit,3814,6,7,9,4,22,19,3,30
Din Moscow,3814,7,5,7,8,18,23,-5,22
FK Rubin,3814,8,5,6,9,23,20,3,21
Rostov,3814,9,4,6,10,10,18,-8,18
Amkar,3814,10,4,4,12,10,27,-17,16
Anzhi,3814,11,2,5,13,16,41,-25,11
Loko Moscow,3815,1,12,5,3,31,13,18,41
CSKA Moscow,3815,2,12,3,5,30,17,13,39
Zenit,3815,3,8,8,4,22,15,7,32
Spart Moscow,3815,4,8,6,6,35,30,5,30
Krasnodar,3815,5,8,5,7,31,29,2,29
Terek Grozny,3815,6,8,5,7,22,24,-2,29
Din Moscow,3815,7,7,6,7,20,21,-1,27
FK Rubin,3815,8,5,6,9,24,21,3,21
Rostov,3815,9,5,6,9,13,19,-6,21
Amkar,3815,10,5,5,10,11,23,-12,20
Anzhi,3815,11,2,5,13,14,41,-27,11
Loko Moscow,3816,1,11,5,4,31,15,16,38
CSKA Moscow,3816,2,11,3,6,31,20,11,36
Zenit,3816,3,9,8,3,26,14,12,35
Krasnodar,3816,4,9,4,7,29,26,3,31
Spart Moscow,3816,5,8,6,6,36,32,4,30
Terek Grozny,3816,6,8,5,7,21,23,-2,29
FK Rubin,3816,7,7,5,8,23,17,6,26
Din Moscow,3816,8,6,6,8,20,23,-3,24
Rostov,3816,9,5,6,9,13,18,-5,21
Amkar,3816,10,5,5,10,11,23,-12,20
Anzhi,3816,11,2,5,13,14,44,-30,11
Loko Moscow,3817,1,12,5,3,31,15,16,41
Spart Moscow,3817,2,11,5,4,41,27,14,38
Krasnodar,3817,3,10,4,6,33,25,8,34
CSKA Moscow,3817,4,10,3,7,27,21,6,33
Zenit,3817,5,8,8,4,22,14,8,32
Terek Grozny,3817,6,7,6,7,21,27,-6,27
Din Moscow,3817,7,5,7,8,18,23,-5,22
FK Rubin,3817,8,5,6,9,22,20,2,21
Rostov,3817,9,4,6,10,11,21,-10,18
Amkar,3817,10,4,5,11,11,26,-15,17
Anzhi,3817,11,4,5,11,21,39,-18,17
Loko Moscow,3818,1,11,6,3,29,12,17,39
CSKA Moscow,3818,2,11,3,6,26,18,8,36
Zenit,3818,3,9,8,3,23,13,10,35
Spart Moscow,3818,4,9,6,5,37,27,10,33
Krasnodar,3818,5,9,5,6,28,24,4,32
Terek Grozny,3818,6,7,7,6,22,24,-2,28
Din Moscow,3818,7,5,7,8,17,24,-7,22
FK Rubin,3818,8,5,6,9,21,18,3,21
Amkar,3818,9,5,5,10,10,22,-12,20
Rostov,3818,10,4,7,9,11,18,-7,19
Anzhi,3818,11,2,6,12,16,40,-24,12
Loko Moscow,3819,1,12,5,3,32,14,18,41
CSKA Moscow,3819,2,11,4,5,28,18,10,37
Krasnodar,3819,3,9,5,6,30,25,5,32
Zenit,3819,4,7,9,4,22,16,6,30
Spart Moscow,3819,5,8,5,7,35,32,3,29
Terek Grozny,3819,6,7,6,7,22,25,-3,27
FK Rubin,3819,7,6,6,8,23,18,5,24
Din Moscow,3819,8,6,6,8,21,25,-4,24
Amkar,3819,9,6,4,10,11,22,-11,22
Rostov,3819,10,5,6,9,13,17,-4,21
Anzhi,3819,11,2,6,12,16,41,-25,12
CSKA Moscow,3820,1,12,3,5,30,18,12,39
Loko Moscow,3820,2,11,5,4,32,16,16,38
Spart Moscow,3820,3,9,7,4,36,27,9,34
Zenit,3820,4,8,8,4,25,18,7,32
Krasnodar,3820,5,9,4,7,30,28,2,31
Terek Grozny,3820,6,8,6,6,25,23,2,30
FK Rubin,3820,7,7,5,8,26,19,7,26
Din Moscow,3820,8,5,7,8,19,24,-5,22
Rostov,3820,9,4,6,10,10,18,-8,18
Amkar,3820,10,4,6,10,11,24,-13,18
Anzhi,3820,11,2,5,13,14,43,-29,11
Loko Moscow,3821,1,11,5,4,31,16,15,38
CSKA Moscow,3821,2,11,3,6,30,23,7,36
Zenit,3821,3,9,8,3,28,14,14,35
Spart Moscow,3821,4,10,5,5,39,27,12,35
Krasnodar,3821,5,9,4,7,31,30,1,31
Terek Grozny,3821,6,7,6,7,21,24,-3,27
FK Rubin,3821,7,7,5,8,27,18,9,26
Amkar,3821,8,6,4,10,12,23,-11,22
Din Moscow,3821,9,5,6,9,17,26,-9,21
Rostov,3821,10,4,6,10,11,20,-9,18
Anzhi,3821,11,2,6,12,15,41,-26,12
Loko Moscow,3822,1,12,5,3,32,15,17,41
Spart Moscow,3822,2,10,6,4,38,26,12,36
CSKA Moscow,3822,3,11,3,6,28,20,8,36
Krasnodar,3822,4,10,4,6,33,25,8,34
Zenit,3822,5,8,8,4,24,15,9,32
Terek Grozny,3822,6,8,6,6,24,24,0,30
Din Moscow,3822,7,5,7,8,17,23,-6,22
FK Rubin,3822,8,5,6,9,21,20,1,21
Rostov,3822,9,4,6,10,10,19,-9,18
Amkar,3822,10,4,6,10,11,24,-13,18
Anzhi,3822,11,2,5,13,16,43,-27,11
Loko Moscow,3823,1,11,5,4,29,14,15,38
Spart Moscow,3823,2,9,7,4,38,29,9,34
Krasnodar,3823,3,10,4,6,31,24,7,34
CSKA Moscow,3823,4,10,4,6,27,20,7,34
Zenit,3823,5,8,9,3,23,14,9,33
Terek Grozny,3823,6,9,5,6,26,24,2,32
FK Rubin,3823,7,6,5,9,25,21,4,23
Din Moscow,3823,8,5,6,9,21,28,-7,21
Rostov,3823,9,4,7,9,11,18,-7,19
Amkar,3823,10,4,5,11,11,27,-16,17
Anzhi,3823,11,3,5,12,17,40,-23,14
Loko Moscow,3824,1,13,5,2,35,13,22,44
Spart Moscow,3824,2,10,6,4,38,27,11,36
CSKA Moscow,3824,3,11,3,6,27,20,7,36
Zenit,3824,4,8,8,4,24,17,7,32
Terek Grozny,3824,5,8,6,6,24,25,-1,30
Krasnodar,3824,6,8,5,7,29,27,2,29
FK Rubin,3824,7,6,6,8,23,18,5,24
Din Moscow,3824,8,5,6,9,19,25,-6,21
Rostov,3824,9,4,7,9,10,17,-7,19
Amkar,3824,10,4,5,11,11,26,-15,17
Anzhi,3824,11,2,5,13,16,41,-25,11
Loko Moscow,3825,1,12,6,2,32,13,19,42
CSKA Moscow,3825,2,11,4,5,31,19,12,37
Spart Moscow,3825,3,9,6,5,35,27,8,33
Zenit,3825,4,7,9,4,22,15,7,30
Krasnodar,3825,5,8,6,6,31,28,3,30
Terek Grozny,3825,6,8,5,7,22,25,-3,29
Din Moscow,3825,7,6,7,7,20,23,-3,25
FK Rubin,3825,8,5,6,9,24,21,3,21
Rostov,3825,9,5,6,9,11,17,-6,21
Amkar,3825,10,5,4,11,12,24,-12,19
Anzhi,3825,11,2,5,13,15,43,-28,11
Loko Moscow,3826,1,11,6,3,31,14,17,39
CSKA Moscow,3826,2,11,3,6,27,21,6,36
Krasnodar,3826,3,10,4,6,33,25,8,34
Zenit,3826,4,8,9,3,25,14,11,33
Spart Moscow,3826,5,9,6,5,37,29,8,33
Terek Grozny,3826,6,8,5,7,23,24,-1,29
Din Moscow,3826,7,5,8,7,19,23,-4,23
Amkar,3826,8,6,4,10,13,22,-9,22
FK Rubin,3826,9,5,6,9,23,23,0,21
Rostov,3826,10,4,6,10,11,21,-10,18
Anzhi,3826,11,2,5,13,16,42,-26,11
Loko Moscow,3827,1,13,5,2,33,11,22,44
CSKA Moscow,3827,2,11,3,6,26,18,8,36
Spart Moscow,3827,3,10,5,5,35,30,5,35
Zenit,3827,4,8,8,4,22,14,8,32
Krasnodar,3827,5,8,5,7,29,29,0,29
Terek Grozny,3827,6,8,5,7,22,24,-2,29
FK Rubin,3827,7,5,7,8,24,20,4,22
Din Moscow,3827,8,5,7,8,18,23,-5,22
Amkar,3827,9,5,4,11,14,23,-9,19
Rostov,3827,10,4,6,10,10,18,-8,18
Anzhi,3827,11,3,5,12,16,39,-23,14
Loko Moscow,3828,1,11,6,3,29,12,17,39
CSKA Moscow,3828,2,11,4,5,27,17,10,37
Spart Moscow,3828,3,9,5,6,36,29,7,32
Zenit,3828,4,7,10,3,21,13,8,31
Krasnodar,3828,5,9,4,7,28,25,3,31
Terek Grozny,3828,6,7,6,7,21,25,-4,27
FK Rubin,3828,7,6,6,8,23,18,5,24
Din Moscow,3828,8,5,7,8,18,24,-6,22
Rostov,3828,9,5,6,9,12,18,-6,21
Amkar,3828,10,5,5,10,11,22,-11,20
Anzhi,3828,11,3,5,12,17,40,-23,14
Loko Moscow,3829,1,11,7,2,32,14,18,40
CSKA Moscow,3829,2,12,3,5,29,17,12,39
Spart Moscow,3829,3,10,6,4,42,30,12,36
Krasnodar,3829,4,9,5,6,31,25,6,32
Zenit,3829,5,7,9,4,23,16,7,30
Terek Grozny,3829,6,8,5,7,23,24,-1,29
Din Moscow,3829,7,5,8,7,20,24,-4,23
FK Rubin,3829,8,5,6,9,22,21,1,21
Amkar,3829,9,5,4,11,11,24,-13,19
Rostov,3829,10,4,6,10,12,22,-10,18
Anzhi,3829,11,2,5,13,15,43,-28,11
Loko Moscow,3830,1,12,5,3,32,15,17,41
Spart Moscow,3830,2,11,5,4,38,26,12,38
CSKA Moscow,3830,3,11,3,6,27,18,9,36
Krasnodar,3830,4,10,4,6,33,24,9,34
Zenit,3830,5,7,8,5,23,18,5,29
Terek Grozny,3830,6,8,5,7,22,25,-3,29
Din Moscow,3830,7,5,7,8,18,23,-5,22
FK Rubin,3830,8,5,6,9,21,21,0,21
Amkar,3830,9,5,4,11,12,25,-13,19
Rostov,3830,10,4,6,10,10,18,-8,18
Anzhi,3830,11,3,5,12,15,38,-23,14
Loko Moscow,3831,1,12,6,2,32,13,19,42
CSKA Moscow,3831,2,11,3,6,29,21,8,36
Spart Moscow,3831,3,10,5,5,39,28,11,35
Zenit,3831,4,8,9,3,26,16,10,33
Krasnodar,3831,5,8,5,7,27,25,2,29
Terek Grozny,3831,6,7,7,6,21,23,-2,28
FK Rubin,3831,7,6,6,8,23,18,5,24
Din Moscow,3831,8,5,6,9,18,26,-8,21
Amkar,3831,9,5,5,10,11,23,-12,20
Rostov,3831,10,4,6,10,12,20,-8,18
Anzhi,3831,11,2,6,12,15,40,-25,12
Loko Moscow,3832,1,11,6,3,29,13,16,39
CSKA Moscow,3832,2,11,4,5,26,17,9,37
Spart Moscow,3832,3,10,6,4,39,28,11,36
Krasnodar,3832,4,10,4,6,34,24,10,34
Zenit,3832,5,7,9,4,21,14,7,30
Terek Grozny,3832,6,7,6,7,20,23,-3,27
Din Moscow,3832,7,5,7,8,19,25,-6,22
FK Rubin,3832,8,5,6,9,21,22,-1,21
Rostov,3832,9,4,6,10,10,18,-8,18
Amkar,3832,10,4,6,10,10,23,-13,18
Anzhi,3832,11,3,6,11,15,37,-22,15
Loko Moscow,3833,1,12,6,2,35,13,22,42
CSKA Moscow,3833,2,12,3,5,27,17,10,39
Spart Moscow,3833,3,11,5,4,40,28,12,38
Krasnodar,3833,4,9,5,6,31,27,4,32
Terek Grozny,3833,5,8,6,6,24,25,-1,30
Zenit,3833,6,7,8,5,21,18,3,29
FK Rubin,3833,7,6,5,9,25,20,5,23
Din Moscow,3833,8,5,6,9,20,27,-7,21
Rostov,3833,9,4,6,10,10,19,-9,18
Amkar,3833,10,4,4,12,11,26,-15,16
Anzhi,3833,11,2,6,12,16,40,-24,12
Loko Moscow,3834,1,13,5,2,33,11,22,44
CSKA Moscow,3834,2,11,4,5,27,18,9,37
Spart Moscow,3834,3,9,6,5,36,27,9,33
Krasnodar,3834,4,9,4,7,28,26,2,31
Zenit,3834,5,7,8,5,21,16,5,29
Terek Grozny,3834,6,7,7,6,20,22,-2,28
Din Moscow,3834,7,6,6,8,21,25,-4,24
Rostov,3834,8,5,6,9,11,17,-6,21
FK Rubin,3834,9,5,5,10,22,21,1,20
Amkar,3834,10,4,6,10,9,22,-13,18
Anzhi,3834,11,2,7,11,15,38,-23,13
Loko Moscow,3835,1,12,5,3,32,14,18,41
CSKA Moscow,3835,2,11,3,6,28,20,8,36
Zenit,3835,3,9,8,3,26,15,11,35
Spart Moscow,3835,4,10,5,5,39,29,10,35
Terek Grozny,3835,5,9,5,6,22,22,0,32
Krasnodar,3835,6,8,4,8,29,28,1,28
Din Moscow,3835,7,6,6,8,20,24,-4,24
FK Rubin,3835,8,6,5,9,23,19,4,23
Amkar,3835,9,5,4,11,11,24,-13,19
Rostov,3835,10,4,6,10,10,19,-9,18
Anzhi,3835,11,2,5,13,14,40,-26,11
Loko Moscow,3836,1,12,6,2,34,13,21,42
CSKA Moscow,3836,2,11,4,5,28,18,10,37
Spart Moscow,3836,3,9,7,4,37,28,9,34
Zenit,3836,4,7,10,3,24,16,8,31
Krasnodar,3836,5,9,4,7,30,28,2,31
Terek Grozny,3836,6,8,5,7,23,24,-1,29
Din Moscow,3836,7,5,8,7,21,25,-4,23
FK Rubin,3836,8,5,6,9,25,23,2,21
Rostov,3836,9,4,7,9,11,18,-7,19
Amkar,3836,10,4,4,12,10,26,-16,16
Anzhi,3836,11,3,5,12,16,40,-24,14
Loko Moscow,3837,1,11,7,2,30,12,18,40
CSKA Moscow,3837,2,10,4,6,25,18,7,34
Zenit,3837,3,8,9,3,22,13,9,33
Spart Moscow,3837,4,9,6,5,36,28,8,33
Krasnodar,3837,5,8,6,6,29,26,3,30
Terek Grozny,3837,6,8,6,6,24,25,-1,30
FK Rubin,3837,7,6,6,8,24,19,5,24
Din Moscow,3837,8,5,6,9,19,25,-6,21
Rostov,3837,9,4,7,9,11,18,-7,19
Amkar,3837,10,5,4,11,11,24,-13,19
Anzhi,3837,11,2,7,11,16,39,-23,13
Loko Moscow,3838,1,11,6,3,29,12,17,39
Spart Moscow,3838,2,11,5,4,43,26,17,38
CSKA Moscow,3838,3,11,4,5,29,18,11,37
Krasnodar,3838,4,10,4,6,31,25,6,34
Zenit,3838,5,7,10,3,21,13,8,31
Terek Grozny,3838,6,8,5,7,22,24,-2,29
FK Rubin,3838,7,6,5,9,23,20,3,23
Din Moscow,3838,8,5,6,9,17,24,-7,21
Rostov,3838,9,4,6,10,11,22,-11,18
Amkar,3838,10,4,4,12,10,27,-17,16
Anzhi,3838,11,3,5,12,16,41,-25,14
Loko Moscow,3839,1,12,5,3,33,14,19,41
Spart Moscow,3839,2,10,6,4,40,27,13,36
CSKA Moscow,3839,3,10,5,5,27,19,8,35
Krasnodar,3839,4,9,4,7,31,28,3,31
Zenit,3839,5,7,9,4,22,16,6,30
Terek Grozny,3839,6,8,6,6,22,23,-1,30
FK Rubin,3839,7,6,6,8,24,19,5,24
Din Moscow,3839,8,5,8,7,18,22,-4,23
Rostov,3839,9,4,6,10,11,19,-8,18
Amkar,3839,10,4,5,11,10,27,-17,17
Anzhi,3839,11,2,6,12,16,40,-24,12
Loko Moscow,3840,1,11,7,2,30,12,18,40
CSKA Moscow,3840,2,12,3,5,30,17,13,39
Spart Moscow,3840,3,9,5,6,36,30,6,32
Krasnodar,3840,4,9,5,6,28,24,4,32
Zenit,3840,5,7,9,4,22,17,5,30
Terek Grozny,3840,6,8,5,7,23,25,-2,29
Din Moscow,3840,7,6,6,8,20,25,-5,24
FK Rubin,3840,8,6,5,9,23,18,5,23
Rostov,3840,9,5,6,9,12,17,-5,21
Amkar,3840,10,5,4,11,10,23,-13,19
Anzhi,3840,11,2,5,13,16,42,-26,11
Loko Moscow,3841,1,12,5,3,32,13,19,41
CSKA Moscow,3841,2,11,4,5,28,17,11,37
Spart Moscow,3841,3,9,6,5,38,30,8,33
Zenit,3841,4,8,8,4,23,17,6,32
Krasnodar,3841,5,9,4,7,30,27,3,31
Terek Grozny,3841,6,8,6,6,24,24,0,30
Din Moscow,3841,7,6,6,8,22,26,-4,24
Rostov,3841,8,5,6,9,13,18,-5,21
FK Rubin,3841,9,5,5,10,24,24,0,20
Amkar,3841,10,4,5,11,10,25,-15,17
Anzhi,3841,11,2,7,11,16,39,-23,13
Loko Moscow,3842,1,12,5,3,31,12,19,41
Spart Moscow,3842,2,9,6,5,36,28,8,33
CSKA Moscow,3842,3,10,3,7,28,22,6,33
Zenit,3842,4,8,8,4,23,16,7,32
Krasnodar,3842,5,9,4,7,29,26,3,31
Terek Grozny,3842,6,8,5,7,21,24,-3,29
Din Moscow,3842,7,7,6,7,22,23,-1,27
FK Rubin,3842,8,6,5,9,25,21,4,23
Rostov,3842,9,4,7,9,11,18,-7,19
Anzhi,3842,10,4,5,11,19,39,-20,17
Amkar,3842,11,4,4,12,9,25,-16,16
Loko Moscow,3843,1,11,5,4,29,14,15,38
Zenit,3843,2,9,8,3,24,13,11,35
Krasnodar,3843,3,10,4,6,30,24,6,34
CSKA Moscow,3843,4,10,4,6,25,19,6,34
Spart Moscow,3843,5,9,6,5,37,30,7,33
Terek Grozny,3843,6,7,5,8,21,25,-4,26
FK Rubin,3843,7,6,5,9,23,18,5,23
Din Moscow,3843,8,5,7,8,19,25,-6,22
Amkar,3843,9,6,4,10,14,24,-10,22
Rostov,3843,10,4,6,10,10,18,-8,18
Anzhi,3843,11,3,6,11,15,37,-22,15
Loko Moscow,3844,1,12,5,3,31,13,18,41
Spart Moscow,3844,2,11,5,4,42,27,15,38
CSKA Moscow,3844,3,11,3,6,26,18,8,36
Zenit,3844,4,8,8,4,23,15,8,32
Krasnodar,3844,5,8,4,8,28,27,1,28
Terek Grozny,3844,6,7,5,8,22,26,-4,26
FK Rubin,3844,7,6,6,8,24,19,5,24
Din Moscow,3844,8,5,7,8,19,26,-7,22
Amkar,3844,9,5,4,11,11,24,-13,19
Rostov,3844,10,4,6,10,10,20,-10,18
Anzhi,3844,11,4,5,11,18,39,-21,17
Loko Moscow,3845,1,13,5,2,32,11,21,44
CSKA Moscow,3845,2,11,3,6,29,20,9,36
Spart Moscow,3845,3,9,6,5,37,28,9,33
Zenit,3845,4,8,8,4,22,15,7,32
Krasnodar,3845,5,8,4,8,27,27,0,28
Terek Grozny,3845,6,7,6,7,21,25,-4,27
FK Rubin,3845,7,7,5,8,25,18,7,26
Din Moscow,3845,8,5,7,8,18,23,-5,22
Rostov,3845,9,5,6,9,11,17,-6,21
Amkar,3845,10,4,5,11,12,27,-15,17
Anzhi,3845,11,3,5,12,18,41,-23,14
Loko Moscow,3846,1,12,6,2,31,12,19,42
CSKA Moscow,3846,2,12,3,5,28,18,10,39
Spart Moscow,3846,3,10,6,4,39,26,13,36
Krasnodar,3846,4,9,4,7,28,25,3,31
Zenit,3846,5,7,9,4,22,15,7,30
Terek Grozny,3846,6,8,6,6,21,22,-1,30
Din Moscow,3846,7,5,7,8,17,23,-6,22
FK Rubin,3846,8,5,6,9,21,18,3,21
Rostov,3846,9,4,6,10,11,21,-10,18
Amkar,3846,10,4,6,10,9,22,-13,18
Anzhi,3846,11,2,5,13,15,40,-25,11
Loko Moscow,3847,1,12,5,3,31,14,17,41
CSKA Moscow,3847,2,12,3,5,28,18,10,39
Spart Moscow,3847,3,9,6,5,39,30,9,33
Zenit,3847,4,8,8,4,24,15,9,32
Terek Grozny,3847,5,8,5,7,22,24,-2,29
Krasnodar,3847,6,8,4,8,28,27,1,28
Din Moscow,3847,7,6,7,7,22,24,-2,25
FK Rubin,3847,8,6,5,9,24,21,3,23
Amkar,3847,9,5,4,11,12,25,-13,19
Rostov,3847,10,4,6,10,11,20,-9,18
Anzhi,3847,11,3,5,12,16,39,-23,14
Loko Moscow,3848,1,12,6,2,30,11,19,42
Spart Moscow,3848,2,11,5,4,39,26,13,38
CSKA Moscow,3848,3,10,4,6,26,19,7,34
Zenit,3848,4,8,8,4,22,14,8,32
Krasnodar,3848,5,9,5,6,30,25,5,32
Terek Grozny,3848,6,7,7,6,23,25,-2,28
Din Moscow,3848,7,5,7,8,18,23,-5,22
FK Rubin,3848,8,5,6,9,23,21,2,21
Rostov,3848,9,4,6,10,10,20,-10,18
Amkar,3848,10,4,5,11,11,25,-14,17
Anzhi,3848,11,2,7,11,17,40,-23,13
Loko Moscow,3849,1,12,6,2,33,13,20,42
CSKA Moscow,3849,2,12,3,5,28,18,10,39
Spart Moscow,3849,3,9,5,6,35,28,7,32
Krasnodar,3849,4,9,5,6,31,26,5,32
Zenit,3849,5,7,8,5,22,17,5,29
Terek Grozny,3849,6,8,5,7,23,27,-4,29
Din Moscow,3849,7,7,6,7,20,22,-2,27
Rostov,3849,8,5,6,9,11,17,-6,21
FK Rubin,3849,9,5,5,10,22,21,1,20
Amkar,3849,10,4,4,12,10,25,-15,16
Anzhi,3849,11,3,5,12,19,40,-21,14
Loko Moscow,3850,1,11,6,3,30,15,15,39
Spart Moscow,3850,2,10,6,4,40,30,10,36
CSKA Moscow,3850,3,10,5,5,26,18,8,35
Krasnodar,3850,4,10,4,6,33,24,9,34
Terek Grozny,3850,5,9,5,6,23,22,1,32
Zenit,3850,6,7,10,3,23,15,8,31
FK Rubin,3850,7,6,5,9,23,20,3,23
Din Moscow,3850,8,5,6,9,20,27,-7,21
Rostov,3850,9,4,6,10,11,19,-8,18
Amkar,3850,10,4,5,11,10,24,-14,17
Anzhi,3850,11,2,6,12,14,39,-25,12
Loko Moscow,3851,1,13,5,2,31,11,20,44
CSKA Moscow,3851,2,11,4,5,31,17,14,37
Spart Moscow,3851,3,9,6,5,37,28,9,33
Zenit,3851,4,7,9,4,21,14,7,30
Krasnodar,3851,5,8,5,7,27,25,2,29
Terek Grozny,3851,6,8,5,7,23,25,-2,29
Din Moscow,3851,7,6,7,7,19,22,-3,25
FK Rubin,3851,8,5,6,9,21,18,3,21
Amkar,3851,9,5,4,11,12,24,-12,19
Rostov,3851,10,4,6,10,10,20,-10,18
Anzhi,3851,11,3,5,12,16,44,-28,14
Loko Moscow,3852,1,13,5,2,33,11,22,44
CSKA Moscow,3852,2,11,4,5,28,18,10,37
Spart Moscow,3852,3,9,5,6,35,29,6,32
Zenit,3852,4,7,9,4,21,15,6,30
Terek Grozny,3852,5,8,6,6,22,23,-1,30
Krasnodar,3852,6,8,5,7,28,27,1,29
FK Rubin,3852,7,5,7,8,22,18,4,22
Din Moscow,3852,8,5,7,8,17,22,-5,22
Rostov,3852,9,5,6,9,12,18,-6,21
Amkar,3852,10,5,5,10,12,23,-11,20
Anzhi,3852,11,2,5,13,15,41,-26,11
Loko Moscow,3853,1,11,6,3,31,16,15,39
CSKA Moscow,3853,2,11,3,6,27,19,8,36
Spart Moscow,3853,3,9,5,6,35,27,8,32
Krasnodar,3853,4,9,4,7,32,27,5,31
Zenit,3853,5,7,9,4,23,16,7,30
Terek Grozny,3853,6,8,6,6,23,23,0,30
Din Moscow,3853,7,6,6,8,19,23,-4,24
FK Rubin,3853,8,6,5,9,23,20,3,23
Rostov,3853,9,5,6,9,11,17,-6,21
Amkar,3853,10,5,5,10,11,23,-12,20
Anzhi,3853,11,3,5,12,15,39,-24,14
Loko Moscow,3854,1,11,6,3,31,14,17,39
CSKA Moscow,3854,2,12,3,5,31,20,11,39
Spart Moscow,3854,3,10,5,5,39,29,10,35
Krasnodar,3854,4,9,5,6,30,26,4,32
Zenit,3854,5,7,9,4,23,16,7,30
Terek Grozny,3854,6,7,5,8,21,27,-6,26
Din Moscow,3854,7,6,6,8,20,25,-5,24
FK Rubin,3854,8,5,6,9,23,21,2,21
Rostov,3854,9,5,6,9,14,18,-4,21
Amkar,3854,10,5,4,11,11,24,-13,19
Anzhi,3854,11,3,5,12,19,42,-23,14
Loko Moscow,3855,1,12,6,2,35,14,21,42
CSKA Moscow,3855,2,11,3,6,28,20,8,36
Spart Moscow,3855,3,9,5,6,38,31,7,32
Zenit,3855,4,7,9,4,26,19,7,30
Krasnodar,3855,5,8,5,7,28,28,0,29
Terek Grozny,3855,6,7,6,7,21,24,-3,27
FK Rubin,3855,7,6,6,8,24,19,5,24
Din Moscow,3855,8,6,6,8,21,25,-4,24
Amkar,3855,9,6,4,10,13,24,-11,22
Rostov,3855,10,4,6,10,11,19,-8,18
Anzhi,3855,11,3,6,11,15,37,-22,15
Loko Moscow,3856,1,11,6,3,31,17,14,39
CSKA Moscow,3856,2,12,3,5,30,20,10,39
Krasnodar,3856,3,10,4,6,35,26,9,34
Spart Moscow,3856,4,9,6,5,37,27,10,33
Zenit,3856,5,7,9,4,23,16,7,30
Terek Grozny,3856,6,7,5,8,20,25,-5,26
Din Moscow,3856,7,5,7,8,17,24,-7,22
Amkar,3856,8,6,4,10,11,22,-11,22
FK Rubin,3856,9,5,6,9,22,20,2,21
Rostov,3856,10,4,7,9,11,18,-7,19
Anzhi,3856,11,3,5,12,18,40,-22,14
CSKA Moscow,3857,1,12,3,5,28,17,11,39
Loko Moscow,3857,2,11,5,4,30,14,16,38
Spart Moscow,3857,3,10,6,4,41,27,14,36
Zenit,3857,4,8,8,4,23,16,7,32
Krasnodar,3857,5,9,5,6,29,25,4,32
Terek Grozny,3857,6,7,7,6,22,24,-2,28
Din Moscow,3857,7,6,6,8,21,27,-6,24
FK Rubin,3857,8,5,6,9,23,21,2,21
Rostov,3857,9,4,6,10,10,19,-9,18
Amkar,3857,10,4,6,10,12,25,-13,18
Anzhi,3857,11,2,6,12,14,38,-24,12
Loko Moscow,3858,1,13,5,2,34,12,22,44
CSKA Moscow,3858,2,11,4,5,29,19,10,37
Krasnodar,3858,3,9,4,7,30,28,2,31
Spart Moscow,3858,4,8,6,6,33,31,2,30
Zenit,3858,5,7,8,5,23,18,5,29
Din Moscow,3858,6,7,6,7,22,21,1,27
Terek Grozny,3858,7,7,5,8,21,25,-4,26
Rostov,3858,8,5,6,9,12,17,-5,21
FK Rubin,3858,9,5,5,10,22,21,1,20
Amkar,3858,10,5,5,10,10,22,-12,20
Anzhi,3858,11,3,6,11,17,39,-22,15
Loko Moscow,3859,1,12,6,2,31,12,19,42
CSKA Moscow,3859,2,12,3,5,30,19,11,39
Spart Moscow,3859,3,10,5,5,39,30,9,35
Zenit,3859,4,7,9,4,22,15,7,30
Terek Grozny,3859,5,8,5,7,23,26,-3,29
Krasnodar,3859,6,8,4,8,28,27,1,28
FK Rubin,3859,7,7,5,8,25,19,6,26
Amkar,3859,8,6,4,10,14,24,-10,22
Din Moscow,3859,9,5,6,9,20,26,-6,21
Rostov,3859,10,4,6,10,11,19,-8,18
Anzhi,3859,11,2,5,13,17,43,-26,11
Loko Moscow,3860,1,12,6,2,32,12,20,42
CSKA Moscow,3860,2,11,4,5,29,18,11,37
Spart Moscow,3860,3,10,6,4,40,26,14,36
Zenit,3860,4,7,10,3,22,14,8,31
Krasnodar,3860,5,8,4,8,27,27,0,28
Terek Grozny,3860,6,7,6,7,21,24,-3,27
FK Rubin,3860,7,7,5,8,23,17,6,26
Din Moscow,3860,8,5,6,9,17,25,-8,21
Rostov,3860,9,4,7,9,10,17,-7,19
Amkar,3860,10,4,5,11,10,26,-16,17
Anzhi,3860,11,3,5,12,17,42,-25,14
CSKA Moscow,3861,1,12,3,5,32,19,13,39
Loko Moscow,3861,2,11,5,4,29,14,15,38
Spart Moscow,3861,3,10,5,5,40,29,11,35
Krasnodar,3861,4,10,4,6,30,24,6,34
Zenit,3861,5,8,8,4,24,16,8,32
Terek Grozny,3861,6,7,6,7,22,26,-4,27
Din Moscow,3861,7,6,6,8,19,24,-5,24
FK Rubin,3861,8,5,5,10,21,20,1,20
Amkar,3861,9,5,5,10,13,25,-12,20
Rostov,3861,10,4,6,10,12,20,-8,18
Anzhi,3861,11,3,5,12,16,41,-25,14
Loko Moscow,3862,1,12,6,2,31,11,20,42
CSKA Moscow,3862,2,12,3,5,32,19,13,39
Spart Moscow,3862,3,10,5,5,38,29,9,35
Terek Grozny,3862,4,9,5,6,24,24,0,32
Zenit,3862,5,7,9,4,23,17,6,30
Krasnodar,3862,6,8,5,7,28,27,1,29
FK Rubin,3862,7,5,7,8,22,18,4,22
Din Moscow,3862,8,5,7,8,18,24,-6,22
Rostov,3862,9,5,6,9,13,18,-5,21
Amkar,3862,10,4,4,12,10,25,-15,16
Anzhi,3862,11,2,5,13,15,42,-27,11
Loko Moscow,3863,1,11,5,4,30,14,16,38
Zenit,3863,2,9,8,3,25,14,11,35
Spart Moscow,3863,3,9,7,4,37,26,11,34
CSKA Moscow,3863,4,10,3,7,26,21,5,33
Krasnodar,3863,5,9,4,7,29,27,2,31
Terek Grozny,3863,6,7,6,7,23,27,-4,27
FK Rubin,3863,7,7,5,8,26,18,8,26
Din Moscow,3863,8,5,7,8,17,23,-6,22
Rostov,3863,9,4,6,10,10,20,-10,18
Amkar,3863,10,4,6,10,13,26,-13,18
Anzhi,3863,11,4,5,11,18,38,-20,17
Loko Moscow,3864,1,11,7,2,32,14,18,40
Spart Moscow,3864,2,11,5,4,40,25,15,38
CSKA Moscow,3864,3,11,3,6,30,21,9,36
Zenit,3864,4,8,9,3,27,17,10,33
Terek Grozny,3864,5,9,5,6,24,22,2,32
Krasnodar,3864,6,8,6,6,30,27,3,30
FK Rubin,3864,7,5,7,8,23,19,4,22
Din Moscow,3864,8,5,7,8,17,24,-7,22
Rostov,3864,9,4,6,10,10,18,-8,18
Amkar,3864,10,4,4,12,9,27,-18,16
Anzhi,3864,11,2,5,13,14,42,-28,11
Loko Moscow,3865,1,11,7,2,29,11,18,40
CSKA Moscow,3865,2,11,3,6,29,20,9,36
Spart Moscow,3865,3,10,5,5,39,29,10,35
Zenit,3865,4,8,9,3,24,15,9,33
Krasnodar,3865,5,8,5,7,27,25,2,29
Terek Grozny,3865,6,8,5,7,22,24,-2,29
Din Moscow,3865,7,6,6,8,20,24,-4,24
FK Rubin,3865,8,6,5,9,22,19,3,23
Amkar,3865,9,5,4,11,13,25,-12,19
Rostov,3865,10,4,6,10,10,19,-9,18
Anzhi,3865,11,3,5,12,15,39,-24,14
Loko Moscow,3866,1,12,5,3,35,14,21,41
CSKA Moscow,3866,2,12,3,5,32,19,13,39
Spart Moscow,3866,3,9,7,4,37,26,11,34
Zenit,3866,4,8,8,4,24,19,5,32
Terek Grozny,3866,5,7,7,6,20,22,-2,28
Krasnodar,3866,6,8,4,8,28,31,-3,28
FK Rubin,3866,7,6,6,8,23,17,6,24
Din Moscow,3866,8,5,8,7,18,22,-4,23
Rostov,3866,9,4,6,10,10,20,-10,18
Amkar,3866,10,4,6,10,9,22,-13,18
Anzhi,3866,11,2,6,12,15,39,-24,12
Loko Moscow,3867,1,11,7,2,30,12,18,40
CSKA Moscow,3867,2,10,4,6,25,19,6,34
Zenit,3867,3,8,9,3,23,13,10,33
Spart Moscow,3867,4,9,6,5,36,27,9,33
Krasnodar,3867,5,8,6,6,30,27,3,30
Terek Grozny,3867,6,8,6,6,23,24,-1,30
FK Rubin,3867,7,6,6,8,26,20,6,24
Din Moscow,3867,8,5,7,8,19,25,-6,22
Amkar,3867,9,5,4,11,11,24,-13,19
Rostov,3867,10,4,6,10,10,19,-9,18
Anzhi,3867,11,2,7,11,15,38,-23,13
Loko Moscow,3868,1,11,6,3,31,14,17,39
CSKA Moscow,3868,2,11,3,6,28,20,8,36
Zenit,3868,3,9,8,3,24,14,10,35
Spart Moscow,3868,4,9,6,5,37,27,10,33
Krasnodar,3868,5,8,6,6,30,27,3,30
Terek Grozny,3868,6,8,6,6,26,23,3,30
FK Rubin,3868,7,6,6,8,25,18,7,24
Din Moscow,3868,8,5,7,8,17,24,-7,22
Rostov,3868,9,5,6,9,11,17,-6,21
Amkar,3868,10,4,5,11,11,27,-16,17
Anzhi,3868,11,2,5,13,15,44,-29,11
Loko Moscow,3869,1,12,5,3,31,13,18,41
Krasnodar,3869,2,10,4,6,34,24,10,34
CSKA Moscow,3869,3,10,4,6,25,18,7,34
Zenit,3869,4,8,8,4,22,15,7,32
Terek Grozny,3869,5,9,5,6,24,24,0,32
Spart Moscow,3869,6,8,6,6,37,31,6,30
Din Moscow,3869,7,6,7,7,21,24,-3,25
Rostov,3869,8,5,6,9,12,18,-6,21
FK Rubin,3869,9,5,5,10,22,24,-2,20
Amkar,3869,10,5,4,11,11,24,-13,19
Anzhi,3869,11,2,6,12,16,40,-24,12
Loko Moscow,3870,1,11,6,3,29,12,17,39
Spart Moscow,3870,2,11,5,4,43,30,13,38
CSKA Moscow,3870,3,11,4,5,27,17,10,37
Zenit,3870,4,8,8,4,22,15,7,32
Krasnodar,3870,5,8,5,7,27,25,2,29
Terek Grozny,3870,6,7,5,8,21,30,-9,26
Din Moscow,3870,7,6,6,8,22,24,-2,24
FK Rubin,3870,8,6,5,9,22,20,2,23
Amkar,3870,9,5,4,11,16,28,-12,19
Rostov,3870,10,4,6,10,10,19,-9,18
Anzhi,3870,11,3,6,11,18,37,-19,15
Loko Moscow,3871,1,13,5,2,37,12,25,44
CSKA Moscow,3871,2,11,3,6,26,19,7,36
Spart Moscow,3871,3,9,5,6,38,31,7,32
Zenit,3871,4,8,8,4,23,18,5,32
Terek Grozny,3871,5,9,5,6,24,22,2,32
Krasnodar,3871,6,9,4,7,32,28,4,31
Din Moscow,3871,7,5,7,8,19,25,-6,22
FK Rubin,3871,8,5,6,9,23,22,1,21
Rostov,3871,9,5,6,9,12,18,-6,21
Amkar,3871,10,5,4,11,12,25,-13,19
Anzhi,3871,11,2,5,13,14,40,-26,11
Loko Moscow,3872,1,12,5,3,32,14,18,41
Spart Moscow,3872,2,11,5,4,39,27,12,38
Krasnodar,3872,3,10,4,6,29,24,5,34
CSKA Moscow,3872,4,10,3,7,25,20,5,33
Zenit,3872,5,8,8,4,25,16,9,32
Terek Grozny,3872,6,9,5,6,25,22,3,32
Din Moscow,3872,7,6,6,8,19,23,-4,24
FK Rubin,3872,8,5,5,10,21,19,2,20
Rostov,3872,9,4,6,10,11,20,-9,18
Amkar,3872,10,4,4,12,9,26,-17,16
Anzhi,3872,11,3,5,12,15,39,-24,14
Loko Moscow,3873,1,11,5,4,32,16,16,38
CSKA Moscow,3873,2,11,4,5,26,17,9,37
Spart Moscow,3873,3,10,5,5,41,29,12,35
Zenit,3873,4,8,9,3,23,14,9,33
Krasnodar,3873,5,9,4,7,30,29,1,31
Terek Grozny,3873,6,7,6,7,22,25,-3,27
Din Moscow,3873,7,6,6,8,22,28,-6,24
FK Rubin,3873,8,6,5,9,27,21,6,23
Amkar,3873,9,6,4,10,12,23,-11,22
Rostov,3873,10,4,6,10,12,21,-9,18
Anzhi,3873,11,2,6,12,15,39,-24,12
Loko Moscow,3874,1,11,5,4,30,15,15,38
Zenit,3874,2,9,8,3,24,13,11,35
Spart Moscow,3874,3,10,5,5,38,28,10,35
CSKA Moscow,3874,4,10,4,6,26,19,7,34
Krasnodar,3874,5,9,5,6,30,26,4,32
Terek Grozny,3874,6,7,7,6,20,22,-2,28
FK Rubin,3874,7,6,6,8,23,18,5,24
Din Moscow,3874,8,5,6,9,17,23,-6,21
Amkar,3874,9,5,5,10,11,23,-12,20
Rostov,3874,10,4,6,10,11,20,-9,18
Anzhi,3874,11,2,7,11,15,38,-23,13
Loko Moscow,3875,1,13,5,2,33,12,21,44
CSKA Moscow,3875,2,12,3,5,31,18,13,39
Spart Moscow,3875,3,9,7,4,39,29,10,34
Zenit,3875,4,7,8,5,21,16,5,29
Krasnodar,3875,5,8,5,7,31,30,1,29
Terek Grozny,3875,6,7,6,7,21,24,-3,27
FK Rubin,3875,7,6,6,8,26,21,5,24
Din Moscow,3875,8,5,7,8,19,24,-5,22
Amkar,3875,9,5,5,10,13,25,-12,20
Rostov,3875,10,4,6,10,10,19,-9,18
Anzhi,3875,11,2,6,12,16,42,-26,12
Loko Moscow,3876,1,12,5,3,32,13,19,41
Spart Moscow,3876,2,11,5,4,42,29,13,38
CSKA Moscow,3876,3,10,5,5,26,18,8,35
Zenit,3876,4,8,9,3,24,15,9,33
Terek Grozny,3876,5,8,6,6,24,24,0,30
Krasnodar,3876,6,8,5,7,28,27,1,29
FK Rubin,3876,7,5,7,8,22,18,4,22
Din Moscow,3876,8,5,7,8,18,25,-7,22
Rostov,3876,9,4,6,10,11,19,-8,18
Amkar,3876,10,4,4,12,12,28,-16,16
Anzhi,3876,11,2,7,11,15,38,-23,13
Loko Moscow,3877,1,12,6,2,32,11,21,42
Spart Moscow,3877,2,10,6,4,38,26,12,36
CSKA Moscow,3877,3,10,4,6,25,21,4,34
Zenit,3877,4,8,8,4,25,16,9,32
Krasnodar,3877,5,8,5,7,28,26,2,29
Terek Grozny,3877,6,8,5,7,24,27,-3,29
FK Rubin,3877,7,6,6,8,23,18,5,24
Din Moscow,3877,8,5,8,7,18,22,-4,23
Amkar,3877,9,5,4,11,13,25,-12,19
Rostov,3877,10,4,6,10,10,20,-10,18
Anzhi,3877,11,2,6,12,15,39,-24,12
Loko Moscow,3878,1,13,5,2,31,11,20,44
CSKA Moscow,3878,2,11,4,5,29,19,10,37
Spart Moscow,3878,3,9,7,4,37,27,10,34
Krasnodar,3878,4,9,4,7,29,26,3,31
Zenit,3878,5,7,9,4,22,15,7,30
Terek Grozny,3878,6,8,5,7,22,24,-2,29
Din Moscow,3878,7,6,7,7,22,24,-2,25
FK Rubin,3878,8,5,5,10,23,22,1,20
Amkar,3878,9,5,5,10,11,22,-11,20
Rostov,3878,10,4,6,10,10,19,-9,18
Anzhi,3878,11,2,5,13,15,42,-27,11
Loko Moscow,3879,1,11,7,2,32,14,18,40
CSKA Moscow,3879,2,11,3,6,28,20,8,36
Zenit,3879,3,8,9,3,25,15,10,33
Spart Moscow,3879,4,9,5,6,35,29,6,32
Krasnodar,3879,5,8,6,6,30,27,3,30
Terek Grozny,3879,6,7,5,8,21,25,-4,26
FK Rubin,3879,7,6,6,8,24,19,5,24
Din Moscow,3879,8,6,6,8,19,22,-3,24
Rostov,3879,9,5,6,9,11,17,-6,21
Amkar,3879,10,5,4,11,12,25,-13,19
Anzhi,3879,11,3,5,12,16,40,-24,14
Loko Moscow,3880,1,12,6,2,31,12,19,42
CSKA Moscow,3880,2,11,3,6,28,20,8,36
Spart Moscow,3880,3,10,5,5,39,30,9,35
Zenit,3880,4,8,9,3,24,15,9,33
Terek Grozny,3880,5,8,6,6,23,24,-1,30
Krasnodar,3880,6,8,4,8,27,26,1,28
Din Moscow,3880,7,6,6,8,21,27,-6,24
FK Rubin,3880,8,6,5,9,24,20,4,23
Amkar,3880,9,5,4,11,13,24,-11,19
Rostov,3880,10,4,6,10,11,19,-8,18
Anzhi,3880,11,2,6,12,16,40,-24,12
Loko Moscow,3881,1,11,5,4,29,13,16,38
Spart Moscow,3881,2,11,5,4,38,26,12,38
CSKA Moscow,3881,3,11,3,6,29,20,9,36
Zenit,3881,4,9,8,3,25,15,10,35
Krasnodar,3881,5,9,5,6,30,26,4,32
Terek Grozny,3881,6,8,5,7,24,24,0,29
Din Moscow,3881,7,6,6,8,20,24,-4,24
FK Rubin,3881,8,5,6,9,24,21,3,21
Rostov,3881,9,4,6,10,10,19,-9,18
Amkar,3881,10,4,4,12,9,26,-17,16
Anzhi,3881,11,3,5,12,16,40,-24,14
Loko Moscow,3882,1,11,6,3,30,14,16,39
Spart Moscow,3882,2,11,5,4,41,26,15,38
CSKA Moscow,3882,3,10,4,6,26,19,7,34
Zenit,3882,4,8,9,3,24,14,10,33
Krasnodar,3882,5,8,6,6,30,27,3,30
Terek Grozny,3882,6,8,5,7,22,23,-1,29
FK Rubin,3882,7,5,7,8,24,20,4,22
Din Moscow,3882,8,5,7,8,19,26,-7,22
Amkar,3882,9,5,4,11,10,25,-15,19
Rostov,3882,10,4,6,10,10,18,-8,18
Anzhi,3882,11,3,5,12,15,39,-24,14
Loko Moscow,3883,1,13,5,2,33,12,21,44
CSKA Moscow,3883,2,12,3,5,31,19,12,39
Spart Moscow,3883,3,10,6,4,38,27,11,36
Zenit,3883,4,7,8,5,23,18,5,29
Krasnodar,3883,5,8,5,7,28,27,1,29
Terek Grozny,3883,6,7,5,8,20,27,-7,26
FK Rubin,3883,7,5,7,8,22,18,4,22
Din Moscow,3883,8,5,7,8,17,23,-6,22
Rostov,3883,9,4,7,9,10,17,-7,19
Amkar,3883,10,5,4,11,12,25,-13,19
Anzhi,3883,11,3,5,12,19,40,-21,14
Loko Moscow,3884,1,12,5,3,30,14,16,41
CSKA Moscow,3884,2,11,3,6,28,19,9,36
Krasnodar,3884,3,10,4,6,33,24,9,34
Spart Moscow,3884,4,9,6,5,38,28,10,33
Zenit,3884,5,8,8,4,23,15,8,32
Terek Grozny,3884,6,8,5,7,22,25,-3,29
Din Moscow,3884,7,6,6,8,21,25,-4,24
Rostov,3884,8,5,6,9,12,18,-6,21
FK Rubin,3884,9,5,5,10,21,23,-2,20
Amkar,3884,10,5,5,10,11,22,-11,20
Anzhi,3884,11,2,5,13,15,41,-26,11
Loko Moscow,3885,1,12,6,2,31,12,19,42
Spart Moscow,3885,2,11,5,4,41,28,13,38
CSKA Moscow,3885,3,11,3,6,28,18,10,36
Zenit,3885,4,8,9,3,22,13,9,33
Krasnodar,3885,5,9,4,7,32,26,6,31
Terek Grozny,3885,6,8,6,6,22,22,0,30
FK Rubin,3885,7,6,5,9,23,22,1,23
Din Moscow,3885,8,5,6,9,19,25,-6,21
Rostov,3885,9,4,6,10,12,22,-10,18
Amkar,3885,10,4,5,11,9,23,-14,17
Anzhi,3885,11,2,5,13,14,42,-28,11
Loko Moscow,3886,1,11,7,2,30,12,18,40
CSKA Moscow,3886,2,11,4,5,28,17,11,37
Krasnodar,3886,3,9,5,6,29,25,4,32
Zenit,3886,4,7,10,3,21,13,8,31
Spart Moscow,3886,5,8,6,6,34,31,3,30
Terek Grozny,3886,6,7,6,7,21,24,-3,27
Din Moscow,3886,7,6,7,7,21,23,-2,25
Amkar,3886,8,6,4,10,14,23,-9,22
FK Rubin,3886,9,5,6,9,23,20,3,21
Rostov,3886,10,4,7,9,11,18,-7,19
Anzhi,3886,11,2,6,12,14,40,-26,12
Loko Moscow,3887,1,11,6,3,31,15,16,39
CSKA Moscow,3887,2,11,3,6,28,19,9,36
Spart Moscow,3887,3,9,6,5,40,29,11,33
Zenit,3887,4,8,9,3,25,15,10,33
Krasnodar,3887,5,9,5,6,29,24,5,32
Terek Grozny,3887,6,8,5,7,24,26,-2,29
FK Rubin,3887,7,5,7,8,21,17,4,22
Din Moscow,3887,8,5,7,8,17,25,-8,22
Amkar,3887,9,6,4,10,13,24,-11,22
Rostov,3887,10,4,7,9,12,19,-7,19
Anzhi,3887,11,2,5,13,16,43,-27,11
Loko Moscow,3888,1,11,6,3,31,15,16,39
CSKA Moscow,3888,2,12,3,5,28,18,10,39
Spart Moscow,3888,3,10,6,4,39,28,11,36
Krasnodar,3888,4,10,4,6,34,25,9,34
Zenit,3888,5,7,9,4,22,15,7,30
Terek Grozny,3888,6,7,6,7,21,24,-3,27
Din Moscow,3888,7,5,8,7,22,26,-4,23
FK Rubin,3888,8,5,6,9,24,24,0,21
Rostov,3888,9,4,6,10,10,18,-8,18
Amkar,3888,10,4,5,11,11,26,-15,17
Anzhi,3888,11,3,5,12,16,39,-23,14
Loko Moscow,3889,1,12,5,3,31,13,18,41
CSKA Moscow,3889,2,10,4,6,26,21,5,34
Spart Moscow,3889,3,9,6,5,37,30,7,33
Zenit,3889,4,8,8,4,24,14,10,32
Krasnodar,3889,5,9,5,6,30,26,4,32
Terek Grozny,3889,6,8,6,6,22,22,0,30
FK Rubin,3889,7,6,6,8,24,19,5,24
Rostov,3889,8,5,6,9,12,17,-5,21
Din Moscow,3889,9,5,6,9,19,25,-6,21
Amkar,3889,10,4,6,10,11,24,-13,18
Anzhi,3889,11,2,6,12,15,40,-25,12
Loko Moscow,3890,1,13,5,2,32,11,21,44
CSKA Moscow,3890,2,11,4,5,30,19,11,37
Spart Moscow,3890,3,9,5,6,37,30,7,32
Terek Grozny,3890,4,9,5,6,22,22,0,32
Zenit,3890,5,7,9,4,23,17,6,30
Krasnodar,3890,6,8,4,8,27,27,0,28
Din Moscow,3890,7,7,6,7,22,24,-2,27
FK Rubin,3890,8,6,5,9,24,19,5,23
Rostov,3890,9,5,6,9,11,17,-6,21
Amkar,3890,10,4,4,12,10,25,-15,16
Anzhi,3890,11,2,5,13,14,41,-27,11
Loko Moscow,3891,1,12,5,3,30,12,18,41
CSKA Moscow,3891,2,11,3,6,27,21,6,36
Krasnodar,3891,3,10,4,6,30,25,5,34
Spart Moscow,3891,4,9,6,5,37,29,8,33
Zenit,3891,5,8,8,4,24,14,10,32
Terek Grozny,3891,6,8,5,7,22,24,-2,29
Din Moscow,3891,7,6,7,7,19,22,-3,25
Rostov,3891,8,5,6,9,12,18,-6,21
FK Rubin,3891,9,5,5,10,22,20,2,20
Amkar,3891,10,4,4,12,10,25,-15,16
Anzhi,3891,11,3,5,12,17,40,-23,14
Loko Moscow,3892,1,12,6,2,33,12,21,42
Spart Moscow,3892,2,10,6,4,38,28,10,36
CSKA Moscow,3892,3,11,3,6,29,20,9,36
Zenit,3892,4,8,9,3,24,14,10,33
Krasnodar,3892,5,9,4,7,31,28,3,31
Terek Grozny,3892,6,8,6,6,27,26,1,30
FK Rubin,3892,7,6,5,9,22,20,2,23
Din Moscow,3892,8,5,6,9,19,25,-6,21
Rostov,3892,9,4,6,10,10,18,-8,18
Amkar,3892,10,4,5,11,11,27,-16,17
Anzhi,3892,11,2,6,12,17,43,-26,12
Loko Moscow,3893,1,12,5,3,33,15,18,41
CSKA Moscow,3893,2,10,4,6,27,20,7,34
Zenit,3893,3,8,8,4,23,16,7,32
Krasnodar,3893,4,9,5,6,32,27,5,32
Spart Moscow,3893,5,8,6,6,37,31,6,30
Terek Grozny,3893,6,7,5,8,21,26,-5,26
Din Moscow,3893,7,6,7,7,24,24,0,25
Amkar,3893,8,6,4,10,11,22,-11,22
FK Rubin,3893,9,5,6,9,22,22,0,21
Rostov,3893,10,5,6,9,12,18,-6,21
Anzhi,3893,11,3,6,11,18,39,-21,15
Loko Moscow,3894,1,12,5,3,31,13,18,41
Spart Moscow,3894,2,11,5,4,40,28,12,38
CSKA Moscow,3894,3,11,4,5,27,18,9,37
Krasnodar,3894,4,9,4,7,30,27,3,31
Zenit,3894,5,7,9,4,21,14,7,30
Terek Grozny,3894,6,7,7,6,23,25,-2,28
FK Rubin,3894,7,7,5,8,24,18,6,26
Din Moscow,3894,8,5,6,9,18,24,-6,21
Rostov,3894,9,4,6,10,11,20,-9,18
Amkar,3894,10,4,5,11,10,24,-14,17
Anzhi,3894,11,2,6,12,18,42,-24,12
Loko Moscow,3895,1,12,5,3,31,16,15,41
CSKA Moscow,3895,2,11,3,6,27,22,5,36
Spart Moscow,3895,3,10,5,5,38,30,8,35
Zenit,3895,4,8,8,4,27,16,11,32
Krasnodar,3895,5,9,4,7,30,25,5,31
Terek Grozny,3895,6,7,7,6,22,24,-2,28
FK Rubin,3895,7,6,5,9,23,21,2,23
Din Moscow,3895,8,5,6,9,19,26,-7,21
Amkar,3895,9,5,5,10,13,23,-10,20
Rostov,3895,10,4,6,10,10,18,-8,18
Anzhi,3895,11,3,6,11,20,39,-19,15
Loko Moscow,3896,1,12,5,3,33,15,18,41
CSKA Moscow,3896,2,10,4,6,25,19,6,34
Spart Moscow,3896,3,9,6,5,36,29,7,33
Zenit,3896,4,8,8,4,24,16,8,32
Krasnodar,3896,5,9,5,6,31,26,5,32
Terek Grozny,3896,6,8,6,6,22,23,-1,30
FK Rubin,3896,7,6,6,8,25,18,7,24
Din Moscow,3896,8,5,6,9,17,25,-8,21
Rostov,3896,9,4,7,9,12,19,-7,19
Amkar,3896,10,5,4,11,11,23,-12,19
Anzhi,3896,11,2,7,11,15,38,-23,13
Loko Moscow,3897,1,12,5,3,31,13,18,41
CSKA Moscow,3897,2,11,3,6,28,20,8,36
Krasnodar,3897,3,10,4,6,31,24,7,34
Spart Moscow,3897,4,9,6,5,39,29,10,33
Terek Grozny,3897,5,8,6,6,23,22,1,30
Zenit,3897,6,7,8,5,21,16,5,29
Din Moscow,3897,7,6,7,7,20,23,-3,25
FK Rubin,3897,8,5,6,9,22,20,2,21
Rostov,3897,9,4,7,9,11,18,-7,19
Amkar,3897,10,4,4,12,10,29,-19,16
Anzhi,3897,11,3,6,11,17,39,-22,15
Loko Moscow,3898,1,13,5,2,35,12,23,44
Spart Moscow,3898,2,10,5,5,40,30,10,35
CSKA Moscow,3898,3,10,3,7,26,20,6,33
Zenit,3898,4,8,8,4,22,17,5,32
Terek Grozny,3898,5,9,5,6,25,24,1,32
Krasnodar,3898,6,8,5,7,29,27,2,29
Din Moscow,3898,7,6,6,8,18,24,-6,24
FK Rubin,3898,8,5,6,9,22,19,3,21
Amkar,3898,9,5,4,11,13,25,-12,19
Rostov,3898,10,4,6,10,11,20,-9,18
Anzhi,3898,11,3,5,12,18,41,-23,14
Loko Moscow,3899,1,13,5,2,35,13,22,44
CSKA Moscow,3899,2,11,3,6,27,18,9,36
Spart Moscow,3899,3,10,5,5,37,27,10,35
Zenit,3899,4,8,8,4,23,17,6,32
Terek Grozny,3899,5,9,5,6,26,24,2,32
Krasnodar,3899,6,8,4,8,30,30,0,28
Din Moscow,3899,7,7,6,7,21,21,0,27
FK Rubin,3899,8,6,5,9,25,22,3,23
Rostov,3899,9,4,6,10,11,19,-8,18
Amkar,3899,10,4,4,12,10,28,-18,16
Anzhi,3899,11,2,5,13,15,41,-26,11
Loko Moscow,3900,1,11,6,3,31,15,16,39
CSKA Moscow,3900,2,10,5,5,27,19,8,35
Spart Moscow,3900,3,9,5,6,37,31,6,32
Krasnodar,3900,4,9,5,6,32,27,5,32
Zenit,3900,5,7,10,3,22,14,8,31
Terek Grozny,3900,6,8,5,7,22,24,-2,29
FK Rubin,3900,7,6,6,8,24,19,5,24
Din Moscow,3900,8,6,6,8,20,23,-3,24
Amkar,3900,9,5,4,11,12,24,-12,19
Rostov,3900,10,4,6,10,11,20,-9,18
Anzhi,3900,11,3,6,11,17,39,-22,15
Loko Moscow,3901,1,12,5,3,30,14,16,41
CSKA Moscow,3901,2,11,3,6,27,20,7,36
Krasnodar,3901,3,10,4,6,31,24,7,34
Zenit,3901,4,8,8,4,24,14,10,32
Spart Moscow,3901,5,9,5,6,36,30,6,32
Terek Grozny,3901,6,9,5,6,25,22,3,32
Din Moscow,3901,7,6,6,8,19,23,-4,24
FK Rubin,3901,8,6,5,9,22,18,4,23
Rostov,3901,9,5,6,9,12,17,-5,21
Amkar,3901,10,4,4,12,10,25,-15,16
Anzhi,3901,11,2,5,13,14,43,-29,11
Loko Moscow,3902,1,11,5,4,29,15,14,38
CSKA Moscow,3902,2,11,4,5,29,19,10,37
Spart Moscow,3902,3,9,7,4,35,26,9,34
Zenit,3902,4,8,9,3,24,14,10,33
Krasnodar,3902,5,9,5,6,30,25,5,32
Terek Grozny,3902,6,8,5,7,22,23,-1,29
Din Moscow,3902,7,5,8,7,18,22,-4,23
FK Rubin,3902,8,5,7,8,22,18,4,22
Rostov,3902,9,4,6,10,10,18,-8,18
Amkar,3902,10,4,5,11,9,24,-15,17
Anzhi,3902,11,3,5,12,16,40,-24,14
Loko Moscow,3903,1,11,6,3,31,15,16,39
CSKA Moscow,3903,2,11,3,6,27,21,6,36
Zenit,3903,3,9,8,3,27,14,13,35
Spart Moscow,3903,4,9,7,4,36,27,9,34
Krasnodar,3903,5,8,5,7,28,28,0,29
Terek Grozny,3903,6,7,7,6,24,26,-2,28
FK Rubin,3903,7,7,5,8,26,17,9,26
Din Moscow,3903,8,5,7,8,17,23,-6,22
Rostov,3903,9,4,7,9,12,19,-7,19
Amkar,3903,10,4,5,11,10,24,-14,17
Anzhi,3903,11,2,6,12,18,42,-24,12
Loko Moscow,3904,1,11,5,4,31,15,16,38
Spart Moscow,3904,2,11,5,4,40,28,12,38
CSKA Moscow,3904,3,10,4,6,28,21,7,34
Zenit,3904,4,8,9,3,25,16,9,33
Krasnodar,3904,5,9,4,7,29,26,3,31
Terek Grozny,3904,6,8,5,7,22,23,-1,29
FK Rubin,3904,7,6,6,8,23,18,5,24
Din Moscow,3904,8,5,7,8,20,25,-5,22
Rostov,3904,9,4,6,10,10,19,-9,18
Anzhi,3904,10,4,5,11,17,38,-21,17
Amkar,3904,11,4,4,12,10,26,-16,16
Loko Moscow,3905,1,12,6,2,31,12,19,42
CSKA Moscow,3905,2,11,3,6,29,20,9,36
Zenit,3905,3,8,9,3,23,14,9,33
Spart Moscow,3905,4,8,6,6,33,27,6,30
Terek Grozny,3905,5,8,5,7,24,25,-1,29
Krasnodar,3905,6,8,4,8,28,27,1,28
Din Moscow,3905,7,6,7,7,19,22,-3,25
FK Rubin,3905,8,6,5,9,24,20,4,23
Amkar,3905,9,6,4,10,12,23,-11,22
Rostov,3905,10,5,6,9,11,17,-6,21
Anzhi,3905,11,2,5,13,17,44,-27,11
Loko Moscow,3906,1,12,5,3,32,13,19,41
CSKA Moscow,3906,2,11,4,5,31,19,12,37
Spart Moscow,3906,3,10,5,5,40,27,13,35
Zenit,3906,4,8,9,3,25,16,9,33
Terek Grozny,3906,5,8,6,6,27,24,3,30
Krasnodar,3906,6,8,4,8,28,28,0,28
Din Moscow,3906,7,6,7,7,20,23,-3,25
FK Rubin,3906,8,6,6,8,25,20,5,24
Rostov,3906,9,4,6,10,10,19,-9,18
Amkar,3906,10,4,4,12,11,33,-22,16
Anzhi,3906,11,2,6,12,15,42,-27,12
Loko Moscow,3907,1,11,6,3,30,13,17,39
CSKA Moscow,3907,2,10,5,5,26,18,8,35
Zenit,3907,3,8,9,3,23,14,9,33
Spart Moscow,3907,4,9,6,5,37,29,8,33
Krasnodar,3907,5,9,5,6,28,24,4,32
Terek Grozny,3907,6,7,6,7,21,24,-3,27
Din Moscow,3907,7,6,7,7,22,24,-2,25
Rostov,3907,8,5,6,9,11,17,-6,21
FK Rubin,3907,9,5,5,10,21,20,1,20
Amkar,3907,10,5,4,11,10,23,-13,19
Anzhi,3907,11,2,7,11,16,39,-23,13
Loko Moscow,3908,1,11,5,4,30,16,14,38
CSKA Moscow,3908,2,10,4,6,25,19,6,34
Krasnodar,3908,3,10,4,6,30,25,5,34
Zenit,3908,4,8,9,3,24,13,11,33
Spart Moscow,3908,5,9,5,6,40,31,9,32
Terek Grozny,3908,6,8,6,6,22,23,-1,30
Din Moscow,3908,7,6,6,8,21,27,-6,24
FK Rubin,3908,8,6,5,9,24,18,6,23
Amkar,3908,9,5,5,10,12,24,-12,20
Rostov,3908,10,4,6,10,10,20,-10,18
Anzhi,3908,11,3,5,12,16,38,-22,14
Loko Moscow,3909,1,12,5,3,31,13,18,41
CSKA Moscow,3909,2,11,4,5,31,20,11,37
Krasnodar,3909,3,10,4,6,32,24,8,34
Spart Moscow,3909,4,9,5,6,39,29,10,32
Terek Grozny,3909,5,9,5,6,25,24,1,32
Zenit,3909,6,7,9,4,23,16,7,30
Din Moscow,3909,7,7,6,7,20,22,-2,27
FK Rubin,3909,8,5,5,10,22,23,-1,20
Amkar,3909,9,5,4,11,11,24,-13,19
Rostov,3909,10,4,6,10,12,23,-11,18
Anzhi,3909,11,2,5,13,17,45,-28,11
Loko Moscow,3910,1,12,5,3,31,14,17,41
CSKA Moscow,3910,2,11,4,5,27,18,9,37
Spart Moscow,3910,3,10,6,4,37,27,10,36
Zenit,3910,4,8,9,3,24,14,10,33
Krasnodar,3910,5,9,4,7,32,28,4,31
Terek Grozny,3910,6,7,6,7,21,24,-3,27
Din Moscow,3910,7,5,7,8,20,25,-5,22
FK Rubin,3910,8,5,6,9,26,24,2,21
Rostov,3910,9,4,6,10,10,18,-8,18
Amkar,3910,10,4,6,10,12,25,-13,18
Anzhi,3910,11,3,5,12,15,38,-23,14
Loko Moscow,3911,1,12,5,3,30,12,18,41
CSKA Moscow,3911,2,11,4,5,28,18,10,37
Spart Moscow,3911,3,10,6,4,36,26,10,36
Zenit,3911,4,8,8,4,22,15,7,32
Krasnodar,3911,5,8,5,7,29,27,2,29
Terek Grozny,3911,6,8,5,7,23,25,-2,29
Din Moscow,3911,7,6,6,8,18,22,-4,24
FK Rubin,3911,8,5,6,9,23,20,3,21
Amkar,3911,9,5,5,10,12,24,-12,20
Rostov,3911,10,4,6,10,11,19,-8,18
Anzhi,3911,11,2,6,12,15,39,-24,12
Loko Moscow,3912,1,12,6,2,34,15,19,42
CSKA Moscow,3912,2,11,3,6,26,18,8,36
Spart Moscow,3912,3,9,7,4,39,30,9,34
Zenit,3912,4,8,8,4,24,16,8,32
Krasnodar,3912,5,8,6,6,29,26,3,30
Terek Grozny,3912,6,8,6,6,26,26,0,30
FK Rubin,3912,7,5,7,8,23,19,4,22
Din Moscow,3912,8,5,7,8,21,26,-5,22
Rostov,3912,9,4,7,9,10,17,-7,19
Amkar,3912,10,4,5,11,12,27,-15,17
Anzhi,3912,11,2,6,12,18,42,-24,12
Loko Moscow,3913,1,11,6,3,31,14,17,39
CSKA Moscow,3913,2,12,3,5,29,18,11,39
Spart Moscow,3913,3,9,6,5,35,28,7,33
Terek Grozny,3913,4,9,5,6,26,25,1,32
Krasnodar,3913,5,9,4,7,29,26,3,31
Zenit,3913,6,7,9,4,23,17,6,30
FK Rubin,3913,7,7,5,8,26,19,7,26
Din Moscow,3913,8,5,7,8,19,25,-6,22
Amkar,3913,9,5,4,11,13,25,-12,19
Rostov,3913,10,4,6,10,10,18,-8,18
Anzhi,3913,11,2,5,13,16,42,-26,11
Loko Moscow,3914,1,12,6,2,33,14,19,42
CSKA Moscow,3914,2,11,4,5,28,18,10,37
Spart Moscow,3914,3,9,6,5,36,28,8,33
Krasnodar,3914,4,9,5,6,31,26,5,32
Zenit,3914,5,7,9,4,23,16,7,30
Terek Grozny,3914,6,8,6,6,21,22,-1,30
FK Rubin,3914,7,6,5,9,22,19,3,23
Din Moscow,3914,8,5,7,8,18,23,-5,22
Amkar,3914,9,5,5,10,11,23,-12,20
Rostov,3914,10,4,6,10,10,18,-8,18
Anzhi,3914,11,2,5,13,14,40,-26,11
Loko Moscow,3915,1,12,5,3,30,13,17,41
Zenit,3915,2,9,8,3,26,13,13,35
Spart Moscow,3915,3,10,5,5,40,29,11,35
CSKA Moscow,3915,4,10,3,7,25,21,4,33
Krasnodar,3915,5,9,4,7,28,25,3,31
Terek Grozny,3915,6,7,6,7,21,24,-3,27
FK Rubin,3915,7,6,5,9,23,18,5,23
Rostov,3915,8,5,6,9,13,19,-6,21
Din Moscow,3915,9,5,6,9,17,26,-9,21
Amkar,3915,10,4,5,11,10,24,-14,17
Anzhi,3915,11,4,5,11,17,38,-21,17
Loko Moscow,3916,1,12,5,3,32,14,18,41
CSKA Moscow,3916,2,11,4,5,28,18,10,37
Spart Moscow,3916,3,9,7,4,38,29,9,34
Zenit,3916,4,8,8,4,24,17,7,32
Terek Grozny,3916,5,9,5,6,25,23,2,32
Krasnodar,3916,6,8,4,8,28,27,1,28
Din Moscow,3916,7,6,6,8,19,23,-4,24
FK Rubin,3916,8,6,5,9,22,18,4,23
Rostov,3916,9,4,7,9,12,19,-7,19
Amkar,3916,10,4,5,11,11,25,-14,17
Anzhi,3916,11,2,6,12,14,40,-26,12
Loko Moscow,3917,1,12,5,3,30,12,18,41
CSKA Moscow,3917,2,11,4,5,28,19,9,37
Terek Grozny,3917,3,9,5,6,24,23,1,32
Spart Moscow,3917,4,8,7,5,34,27,7,31
Krasnodar,3917,5,9,4,7,29,26,3,31
Zenit,3917,6,7,9,4,22,15,7,30
Din Moscow,3917,7,6,7,7,19,22,-3,25
FK Rubin,3917,8,6,6,8,24,19,5,24
Rostov,3917,9,4,7,9,10,17,-7,19
Amkar,3917,10,4,5,11,11,25,-14,17
Anzhi,3917,11,2,5,13,15,41,-26,11
Loko Moscow,3918,1,12,5,3,31,12,19,41
CSKA Moscow,3918,2,11,3,6,28,19,9,36
Krasnodar,3918,3,10,4,6,29,24,5,34
Spart Moscow,3918,4,8,8,4,35,27,8,32
Zenit,3918,5,8,8,4,23,16,7,32
Terek Grozny,3918,6,7,5,8,22,29,-7,26
Din Moscow,3918,7,5,8,7,19,23,-4,23
FK Rubin,3918,8,5,6,9,22,19,3,21
Amkar,3918,9,5,5,10,14,23,-9,20
Rostov,3918,10,4,7,9,11,18,-7,19
Anzhi,3918,11,3,5,12,16,40,-24,14
Loko Moscow,3919,1,12,5,3,32,14,18,41
Spart Moscow,3919,2,11,5,4,40,27,13,38
CSKA Moscow,3919,3,11,3,6,29,19,10,36
Zenit,3919,4,8,8,4,23,15,8,32
Krasnodar,3919,5,9,5,6,31,27,4,32
Terek Grozny,3919,6,9,5,6,25,25,0,32
Din Moscow,3919,7,6,6,8,21,25,-4,24
FK Rubin,3919,8,5,6,9,24,21,3,21
Rostov,3919,9,4,6,10,11,21,-10,18
Amkar,3919,10,4,4,12,10,25,-15,16
Anzhi,3919,11,2,5,13,16,43,-27,11
Loko Moscow,3920,1,12,6,2,31,11,20,42
CSKA Moscow,3920,2,10,4,6,27,22,5,34
Zenit,3920,3,8,9,3,25,14,11,33
Spart Moscow,3920,4,9,5,6,37,32,5,32
Krasnodar,3920,5,9,4,7,30,27,3,31
Terek Grozny,3920,6,8,5,7,21,24,-3,29
Din Moscow,3920,7,6,6,8,20,24,-4,24
FK Rubin,3920,8,6,5,9,24,21,3,23
Amkar,3920,9,5,4,11,13,23,-10,19
Rostov,3920,10,4,6,10,11,20,-9,18
Anzhi,3920,11,3,6,11,17,38,-21,15
Loko Moscow,3921,1,11,6,3,30,14,16,39
CSKA Moscow,3921,2,12,3,5,29,18,11,39
Spart Moscow,3921,3,9,7,4,38,29,9,34
Krasnodar,3921,4,9,4,7,29,27,2,31
Zenit,3921,5,7,9,4,23,17,6,30
Terek Grozny,3921,6,7,6,7,21,25,-4,27
FK Rubin,3921,7,7,5,8,26,18,8,26
Din Moscow,3921,8,5,7,8,19,24,-5,22
Amkar,3921,9,5,5,10,13,24,-11,20
Rostov,3921,10,4,6,10,11,19,-8,18
Anzhi,3921,11,2,6,12,15,39,-24,12
Loko Moscow,3922,1,11,5,4,32,16,16,38
CSKA Moscow,3922,2,11,3,6,31,20,11,36
Zenit,3922,3,9,8,3,26,16,10,35
Krasnodar,3922,4,10,4,6,34,28,6,34
Terek Grozny,3922,5,9,5,6,25,22,3,32
Spart Moscow,3922,6,8,6,6,35,29,6,30
Din Moscow,3922,7,6,7,7,21,24,-3,25
Rostov,3922,8,5,6,9,11,17,-6,21
FK Rubin,3922,9,5,5,10,24,23,1,20
Amkar,3922,10,5,4,11,10,26,-16,19
Anzhi,3922,11,2,5,13,14,42,-28,11
Loko Moscow,3923,1,11,7,2,30,12,18,40
CSKA Moscow,3923,2,11,3,6,29,20,9,36
Spart Moscow,3923,3,10,5,5,39,28,11,35
Krasnodar,3923,4,9,5,6,33,27,6,32
Zenit,3923,5,7,9,4,22,16,6,30
Terek Grozny,3923,6,8,5,7,23,25,-2,29
Din Moscow,3923,7,6,6,8,18,23,-5,24
FK Rubin,3923,8,6,5,9,25,22,3,23
Amkar,3923,9,5,4,11,11,25,-14,19
Rostov,3923,10,4,6,10,11,20,-9,18
Anzhi,3923,11,3,5,12,18,41,-23,14
Loko Moscow,3924,1,12,6,2,31,12,19,42
CSKA Moscow,3924,2,12,3,5,28,18,10,39
Spart Moscow,3924,3,10,6,4,36,26,10,36
Zenit,3924,4,7,9,4,21,14,7,30
Terek Grozny,3924,5,8,6,6,21,22,-1,30
Krasnodar,3924,6,8,4,8,29,28,1,28
FK Rubin,3924,7,6,6,8,23,18,5,24
Din Moscow,3924,8,5,7,8,17,22,-5,22
Rostov,3924,9,4,6,10,10,18,-8,18
Amkar,3924,10,4,6,10,10,23,-13,18
Anzhi,3924,11,2,5,13,15,40,-25,11
Loko Moscow,3925,1,11,6,3,31,14,17,39
Spart Moscow,3925,2,11,5,4,40,27,13,38
CSKA Moscow,3925,3,11,3,6,26,18,8,36
Krasnodar,3925,4,10,4,6,32,27,5,34
Zenit,3925,5,8,9,3,23,14,9,33
Terek Grozny,3925,6,8,6,6,24,25,-1,30
FK Rubin,3925,7,6,5,9,24,20,4,23
Din Moscow,3925,8,5,6,9,18,25,-7,21
Rostov,3925,9,4,6,10,10,18,-8,18
Amkar,3925,10,4,5,11,12,27,-15,17
Anzhi,3925,11,2,5,13,15,40,-25,11
Loko Moscow,3926,1,12,5,3,30,13,17,41
Spart Moscow,3926,2,10,5,5,41,29,12,35
Krasnodar,3926,3,10,4,6,31,25,6,34
CSKA Moscow,3926,4,10,4,6,25,19,6,34
Zenit,3926,5,8,8,4,23,14,9,32
Terek Grozny,3926,6,8,5,7,21,23,-2,29
Din Moscow,3926,7,5,7,8,19,24,-5,22
FK Rubin,3926,8,5,6,9,23,20,3,21
Amkar,3926,9,5,4,11,12,25,-13,19
Rostov,3926,10,4,6,10,10,21,-11,18
Anzhi,3926,11,3,6,11,15,37,-22,15
Loko Moscow,3927,1,12,5,3,31,13,18,41
CSKA Moscow,3927,2,11,4,5,28,18,10,37
Zenit,3927,3,8,9,3,23,14,9,33
Spart Moscow,3927,4,9,6,5,37,29,8,33
Krasnodar,3927,5,9,4,7,31,26,5,31
Terek Grozny,3927,6,8,5,7,23,25,-2,29
Din Moscow,3927,7,6,6,8,21,24,-3,24
Rostov,3927,8,5,6,9,13,19,-6,21
FK Rubin,3927,9,5,5,10,22,23,-1,20
Amkar,3927,10,5,5,10,12,22,-10,20
Anzhi,3927,11,2,5,13,14,42,-28,11
Loko Moscow,3928,1,12,5,3,31,15,16,41
CSKA Moscow,3928,2,12,3,5,28,18,10,39
Spart Moscow,3928,3,9,6,5,38,30,8,33
Zenit,3928,4,8,8,4,26,15,11,32
Terek Grozny,3928,5,8,5,7,23,27,-4,29
Krasnodar,3928,6,8,4,8,27,27,0,28
Din Moscow,3928,7,6,6,8,18,22,-4,24
FK Rubin,3928,8,6,5,9,22,18,4,23
Rostov,3928,9,4,7,9,13,20,-7,19
Amkar,3928,10,5,4,11,11,24,-13,19
Anzhi,3928,11,3,5,12,19,40,-21,14
Loko Moscow,3929,1,13,5,2,34,12,22,44
CSKA Moscow,3929,2,12,3,5,28,18,10,39
Spart Moscow,3929,3,10,5,5,39,30,9,35
Zenit,3929,4,7,8,5,22,17,5,29
Krasnodar,3929,5,8,5,7,29,28,1,29
Terek Grozny,3929,6,7,5,8,21,27,-6,26
Din Moscow,3929,7,6,6,8,19,22,-3,24
Amkar,3929,8,6,4,10,14,24,-10,22
FK Rubin,3929,9,5,6,9,23,21,2,21
Rostov,3929,10,4,6,10,12,21,-9,18
Anzhi,3929,11,3,5,12,18,39,-21,14
Loko Moscow,3930,1,12,6,2,32,13,19,42
Spart Moscow,3930,2,11,5,4,40,26,14,38
CSKA Moscow,3930,3,10,5,5,26,18,8,35
Zenit,3930,4,7,10,3,23,15,8,31
Krasnodar,3930,5,8,4,8,28,28,0,28
Terek Grozny,3930,6,7,5,8,20,25,-5,26
Din Moscow,3930,7,6,6,8,20,23,-3,24
FK Rubin,3930,8,6,5,9,23,20,3,23
Amkar,3930,9,5,4,11,11,25,-14,19
Rostov,3930,10,4,6,10,11,19,-8,18
Anzhi,3930,11,3,6,11,15,37,-22,15
Loko Moscow,3931,1,11,5,4,30,15,15,38
Spart Moscow,3931,2,10,6,4,40,30,10,36
CSKA Moscow,3931,3,11,3,6,27,20,7,36
Zenit,3931,4,9,8,3,26,14,12,35
Krasnodar,3931,5,9,5,6,29,25,4,32
Terek Grozny,3931,6,8,5,7,24,28,-4,29
FK Rubin,3931,7,5,7,8,23,19,4,22
Din Moscow,3931,8,5,7,8,20,25,-5,22
Rostov,3931,9,4,7,9,14,21,-7,19
Amkar,3931,10,5,4,11,14,24,-10,19
Anzhi,3931,11,2,5,13,15,41,-26,11
Loko Moscow,3932,1,13,5,2,32,11,21,44
CSKA Moscow,3932,2,11,3,6,27,18,9,36
Spart Moscow,3932,3,9,6,5,35,27,8,33
Zenit,3932,4,8,8,4,22,15,7,32
Krasnodar,3932,5,9,4,7,28,25,3,31
Terek Grozny,3932,6,8,6,6,25,24,1,30
Din Moscow,3932,7,5,7,8,19,24,-5,22
FK Rubin,3932,8,5,6,9,22,19,3,21
Rostov,3932,9,5,6,9,11,17,-6,21
Amkar,3932,10,4,6,10,11,24,-13,18
Anzhi,3932,11,2,5,13,14,42,-28,11
Loko Moscow,3933,1,11,7,2,32,14,18,40
CSKA Moscow,3933,2,10,4,6,27,20,7,34
Zenit,3933,3,8,9,3,23,14,9,33
Spart Moscow,3933,4,8,8,4,37,29,8,32
Krasnodar,3933,5,8,6,6,30,27,3,30
Terek Grozny,3933,6,8,6,6,24,25,-1,30
Din Moscow,3933,7,6,7,7,20,23,-3,25
FK Rubin,3933,8,5,6,9,23,20,3,21
Rostov,3933,9,4,7,9,12,19,-7,19
Amkar,3933,10,4,5,11,11,25,-14,17
Anzhi,3933,11,2,7,11,18,41,-23,13
Loko Moscow,3934,1,12,5,3,31,12,19,41
Spart Moscow,3934,2,10,5,5,39,29,10,35
CSKA Moscow,3934,3,10,5,5,26,18,8,35
Zenit,3934,4,8,9,3,22,13,9,33
Terek Grozny,3934,5,9,5,6,24,22,2,32
Krasnodar,3934,6,8,5,7,27,26,1,29
Din Moscow,3934,7,6,7,7,19,22,-3,25
FK Rubin,3934,8,5,7,8,22,18,4,22
Rostov,3934,9,4,6,10,12,20,-8,18
Amkar,3934,10,4,4,12,10,26,-16,16
Anzhi,3934,11,2,6,12,15,41,-26,12
Loko Moscow,3935,1,12,5,3,32,14,18,41
Spart Moscow,3935,2,11,5,4,42,25,17,38
CSKA Moscow,3935,3,11,4,5,29,19,10,37
Zenit,3935,4,8,9,3,26,15,11,33
Krasnodar,3935,5,9,4,7,29,28,1,31
Terek Grozny,3935,6,7,7,6,21,23,-2,28
Din Moscow,3935,7,5,7,8,19,27,-8,22
FK Rubin,3935,8,5,6,9,24,21,3,21
Rostov,3935,9,4,6,10,10,21,-11,18
Amkar,3935,10,4,5,11,9,23,-14,17
Anzhi,3935,11,2,6,12,15,40,-25,12
Loko Moscow,3936,1,11,6,3,31,14,17,39
Spart Moscow,3936,2,10,6,4,39,28,11,36
Zenit,3936,3,9,8,3,25,13,12,35
CSKA Moscow,3936,4,10,3,7,26,22,4,33
Krasnodar,3936,5,9,5,6,30,26,4,32
Terek Grozny,3936,6,8,6,6,25,25,0,30
Din Moscow,3936,7,5,7,8,19,25,-6,22
FK Rubin,3936,8,5,6,9,22,19,3,21
Rostov,3936,9,4,7,9,11,18,-7,19
Amkar,3936,10,4,5,11,11,25,-14,17
Anzhi,3936,11,3,5,12,18,42,-24,14
Loko Moscow,3937,1,11,5,4,29,13,16,38
CSKA Moscow,3937,2,11,3,6,27,19,8,36
Spart Moscow,3937,3,10,5,5,39,26,13,35
Zenit,3937,4,9,8,3,23,13,10,35
Krasnodar,3937,5,9,4,7,28,26,2,31
Terek Grozny,3937,6,7,6,7,20,23,-3,27
FK Rubin,3937,7,6,6,8,23,17,6,24
Din Moscow,3937,8,5,7,8,17,24,-7,22
Amkar,3937,9,6,4,10,11,22,-11,22
Rostov,3937,10,4,6,10,10,20,-10,18
Anzhi,3937,11,2,6,12,15,39,-24,12
Loko Moscow,3938,1,12,5,3,33,13,20,41
CSKA Moscow,3938,2,11,4,5,27,18,9,37
Spart Moscow,3938,3,10,5,5,38,29,9,35
Zenit,3938,4,8,8,4,22,14,8,32
Krasnodar,3938,5,9,4,7,30,29,1,31
Terek Grozny,3938,6,7,5,8,22,29,-7,26
Din Moscow,3938,7,6,6,8,19,22,-3,24
FK Rubin,3938,8,6,5,9,23,19,4,23
Amkar,3938,9,5,4,11,14,26,-12,19
Rostov,3938,10,4,6,10,11,19,-8,18
Anzhi,3938,11,3,6,11,18,39,-21,15
CSKA Moscow,3939,1,12,3,5,29,17,12,39
Loko Moscow,3939,2,11,5,4,32,16,16,38
Spart Moscow,3939,3,9,7,4,34,25,9,34
Krasnodar,3939,4,10,4,6,31,25,6,34
Zenit,3939,5,8,8,4,24,16,8,32
Terek Grozny,3939,6,7,5,8,20,25,-5,26
FK Rubin,3939,7,6,5,9,22,19,3,23
Din Moscow,3939,8,5,7,8,17,22,-5,22
Amkar,3939,9,5,5,10,10,22,-12,20
Rostov,3939,10,4,6,10,10,18,-8,18
Anzhi,3939,11,3,5,12,16,40,-24,14
Loko Moscow,3940,1,11,6,3,30,16,14,39
CSKA Moscow,3940,2,12,3,5,32,20,12,39
Spart Moscow,3940,3,11,5,4,41,27,14,38
Krasnodar,3940,4,9,4,7,32,26,6,31
Zenit,3940,5,7,9,4,24,17,7,30
Terek Grozny,3940,6,7,7,6,20,22,-2,28
FK Rubin,3940,7,6,6,8,24,19,5,24
Din Moscow,3940,8,5,7,8,18,24,-6,22
Rostov,3940,9,4,6,10,12,20,-8,18
Amkar,3940,10,4,5,11,9,25,-16,17
Anzhi,3940,11,2,6,12,15,41,-26,12
Loko Moscow,3941,1,11,6,3,30,14,16,39
CSKA Moscow,3941,2,11,4,5,27,18,9,37
Spart Moscow,3941,3,10,5,5,38,27,11,35
Krasnodar,3941,4,10,4,6,30,24,6,34
Zenit,3941,5,7,9,4,22,15,7,30
Terek Grozny,3941,6,7,6,7,22,26,-4,27
FK Rubin,3941,7,6,5,9,23,19,4,23
Rostov,3941,8,5,6,9,11,17,-6,21
Din Moscow,3941,9,5,6,9,19,27,-8,21
Amkar,3941,10,4,5,11,11,25,-14,17
Anzhi,3941,11,3,6,11,17,38,-21,15
Loko Moscow,3942,1,12,6,2,32,13,19,42
CSKA Moscow,3942,2,10,4,6,26,20,6,34
Zenit,3942,3,8,9,3,24,14,10,33
Terek Grozny,3942,4,9,5,6,25,24,1,32
Spart Moscow,3942,5,8,6,6,33,27,6,30
Krasnodar,3942,6,8,4,8,28,28,0,28
Din Moscow,3942,7,7,6,7,20,21,-1,27
FK Rubin,3942,8,6,5,9,23,19,4,23
Rostov,3942,9,5,6,9,11,17,-6,21
Amkar,3942,10,4,5,11,10,25,-15,17
Anzhi,3942,11,2,6,12,16,40,-24,12
Loko Moscow,3943,1,11,7,2,30,12,18,40
CSKA Moscow,3943,2,11,3,6,26,18,8,36
Spart Moscow,3943,3,9,6,5,39,28,11,33
Zenit,3943,4,8,9,3,23,14,9,33
Krasnodar,3943,5,8,5,7,27,26,1,29
Terek Grozny,3943,6,8,5,7,22,24,-2,29
Din Moscow,3943,7,6,6,8,19,27,-8,24
FK Rubin,3943,8,6,5,9,24,19,5,23
Rostov,3943,9,5,6,9,12,17,-5,21
Amkar,3943,10,4,5,11,10,24,-14,17
Anzhi,3943,11,3,5,12,16,39,-23,14
Loko Moscow,3944,1,12,5,3,30,12,18,41
CSKA Moscow,3944,2,11,4,5,28,18,10,37
Spart Moscow,3944,3,9,5,6,35,28,7,32
Krasnodar,3944,4,9,4,7,29,26,3,31
Zenit,3944,5,7,9,4,22,15,7,30
Terek Grozny,3944,6,8,5,7,23,24,-1,29
Din Moscow,3944,7,7,6,7,23,21,2,27
FK Rubin,3944,8,6,5,9,23,23,0,23
Rostov,3944,9,5,6,9,11,17,-6,21
Amkar,3944,10,5,4,11,12,25,-13,19
Anzhi,3944,11,2,5,13,14,41,-27,11
Loko Moscow,3945,1,12,5,3,31,14,17,41
Spart Moscow,3945,2,10,6,4,40,26,14,36
Zenit,3945,3,9,8,3,25,14,11,35
CSKA Moscow,3945,4,10,3,7,28,22,6,33
Krasnodar,3945,5,9,4,7,30,26,4,31
Terek Grozny,3945,6,7,6,7,22,26,-4,27
Din Moscow,3945,7,5,7,8,18,26,-8,22
FK Rubin,3945,8,5,6,9,22,20,2,21
Rostov,3945,9,4,6,10,11,20,-9,18
Amkar,3945,10,4,6,10,10,23,-13,18
Anzhi,3945,11,4,5,11,20,40,-20,17
Loko Moscow,3946,1,12,6,2,30,11,19,42
CSKA Moscow,3946,2,11,4,5,27,18,9,37
Spart Moscow,3946,3,9,5,6,36,30,6,32
Zenit,3946,4,7,10,3,21,13,8,31
Krasnodar,3946,5,9,4,7,29,26,3,31
Terek Grozny,3946,6,8,5,7,22,24,-2,29
Din Moscow,3946,7,7,6,7,20,21,-1,27
Rostov,3946,8,5,6,9,13,18,-5,21
FK Rubin,3946,9,5,5,10,22,21,1,20
Amkar,3946,10,5,4,11,11,24,-13,19
Anzhi,3946,11,2,5,13,16,41,-25,11
Loko Moscow,3947,1,11,5,4,30,15,15,38
CSKA Moscow,3947,2,11,4,5,27,17,10,37
Spart Moscow,3947,3,10,6,4,40,28,12,36
Zenit,3947,4,8,9,3,23,14,9,33
Krasnodar,3947,5,9,4,7,29,25,4,31
FK Rubin,3947,6,7,5,8,23,17,6,26
Terek Grozny,3947,7,7,5,8,22,28,-6,26
Din Moscow,3947,8,5,6,9,18,24,-6,21
Amkar,3947,9,5,5,10,13,24,-11,20
Rostov,3947,10,4,6,10,10,20,-10,18
Anzhi,3947,11,3,5,12,18,41,-23,14
Loko Moscow,3948,1,12,6,2,33,12,21,42
Spart Moscow,3948,2,10,6,4,37,27,10,36
CSKA Moscow,3948,3,11,3,6,28,19,9,36
Zenit,3948,4,8,8,4,24,18,6,32
Terek Grozny,3948,5,9,5,6,25,23,2,32
Krasnodar,3948,6,8,6,6,28,25,3,30
FK Rubin,3948,7,6,6,8,25,19,6,24
Din Moscow,3948,8,5,6,9,18,25,-7,21
Rostov,3948,9,4,6,10,11,19,-8,18
Amkar,3948,10,4,5,11,11,25,-14,17
Anzhi,3948,11,2,5,13,14,42,-28,11
Loko Moscow,3949,1,13,5,2,33,11,22,44
CSKA Moscow,3949,2,12,3,5,28,17,11,39
Spart Moscow,3949,3,10,6,4,36,25,11,36
Krasnodar,3949,4,9,4,7,28,26,2,31
Terek Grozny,3949,5,8,6,6,23,24,-1,30
Zenit,3949,6,7,8,5,21,17,4,29
Din Moscow,3949,7,5,7,8,18,24,-6,22
FK Rubin,3949,8,5,6,9,22,19,3,21
Rostov,3949,9,4,6,10,10,18,-8,18
Amkar,3949,10,4,5,11,10,24,-14,17
Anzhi,3949,11,2,6,12,15,39,-24,12
Loko Moscow,3950,1,13,5,2,35,13,22,44
CSKA Moscow,3950,2,12,3,5,31,18,13,39
Spart Moscow,3950,3,9,6,5,36,29,7,33
Terek Grozny,3950,4,9,5,6,23,23,0,32
Krasnodar,3950,5,9,4,7,31,28,3,31
Zenit,3950,6,7,8,5,21,19,2,29
Din Moscow,3950,7,6,7,7,18,21,-3,25
FK Rubin,3950,8,5,5,10,22,20,2,20
Amkar,3950,9,5,4,11,12,24,-12,19
Rostov,3950,10,4,6,10,12,20,-8,18
Anzhi,3950,11,2,5,13,15,41,-26,11
Loko Moscow,3951,1,11,6,3,30,13,17,39
CSKA Moscow,3951,2,12,3,5,28,17,11,39
Spart Moscow,3951,3,10,5,5,39,29,10,35
Krasnodar,3951,4,9,4,7,29,26,3,31
Zenit,3951,5,7,9,4,21,14,7,30
Terek Grozny,3951,6,7,6,7,23,27,-4,27
FK Rubin,3951,7,7,5,8,24,18,6,26
Din Moscow,3951,8,5,6,9,20,26,-6,21
Amkar,3951,9,5,5,10,13,25,-12,20
Rostov,3951,10,4,6,10,10,19,-9,18
Anzhi,3951,11,3,5,12,17,40,-23,14
Loko Moscow,3952,1,12,5,3,30,13,17,41
CSKA Moscow,3952,2,12,3,5,28,18,10,39
Spart Moscow,3952,3,10,6,4,37,27,10,36
Zenit,3952,4,8,8,4,23,14,9,32
Krasnodar,3952,5,8,5,7,30,28,2,29
Terek Grozny,3952,6,7,6,7,23,27,-4,27
FK Rubin,3952,7,6,6,8,26,21,5,24
Din Moscow,3952,8,5,7,8,20,25,-5,22
Amkar,3952,9,5,4,11,12,24,-12,19
Rostov,3952,10,4,6,10,10,18,-8,18
Anzhi,3952,11,2,6,12,17,41,-24,12
Loko Moscow,3953,1,12,6,2,32,11,21,42
CSKA Moscow,3953,2,11,4,5,31,20,11,37
Spart Moscow,3953,3,9,6,5,39,28,11,33
Zenit,3953,4,7,10,3,22,14,8,31
Krasnodar,3953,5,8,5,7,29,29,0,29
Terek Grozny,3953,6,8,5,7,22,26,-4,29
Din Moscow,3953,7,5,8,7,19,23,-4,23
FK Rubin,3953,8,5,7,8,24,20,4,22
Amkar,3953,9,6,4,10,14,23,-9,22
Rostov,3953,10,4,6,10,10,21,-11,18
Anzhi,3953,11,2,5,13,17,44,-27,11
Loko Moscow,3954,1,13,5,2,33,12,21,44
CSKA Moscow,3954,2,11,3,6,30,21,9,36
Spart Moscow,3954,3,9,6,5,37,27,10,33
Zenit,3954,4,8,8,4,25,17,8,32
Terek Grozny,3954,5,8,5,7,22,23,-1,29
Krasnodar,3954,6,8,4,8,28,28,0,28
FK Rubin,3954,7,7,5,8,25,19,6,26
Din Moscow,3954,8,6,6,8,19,23,-4,24
Amkar,3954,9,5,5,10,11,23,-12,20
Rostov,3954,10,4,6,10,10,20,-10,18
Anzhi,3954,11,2,5,13,15,42,-27,11
CSKA Moscow,3955,1,12,3,5,29,17,12,39
Loko Moscow,3955,2,11,5,4,31,18,13,38
Spart Moscow,3955,3,10,5,5,37,27,10,35
Zenit,3955,4,8,8,4,23,14,9,32
Krasnodar,3955,5,9,5,6,32,26,6,32
Terek Grozny,3955,6,7,7,6,20,22,-2,28
FK Rubin,3955,7,6,6,8,24,18,6,24
Rostov,3955,8,5,6,9,11,17,-6,21
Din Moscow,3955,9,5,6,9,19,26,-7,21
Amkar,3955,10,4,5,11,9,24,-15,17
Anzhi,3955,11,2,6,12,14,40,-26,12
Loko Moscow,3956,1,11,6,3,32,16,16,39
CSKA Moscow,3956,2,11,4,5,33,21,12,37
Spart Moscow,3956,3,10,6,4,37,26,11,36
Krasnodar,3956,4,9,5,6,32,27,5,32
Zenit,3956,5,7,10,3,25,17,8,31
Terek Grozny,3956,6,8,5,7,24,25,-1,29
Din Moscow,3956,7,6,7,7,18,21,-3,25
FK Rubin,3956,8,5,6,9,24,21,3,21
Amkar,3956,9,5,4,11,12,26,-14,19
Rostov,3956,10,4,6,10,11,19,-8,18
Anzhi,3956,11,2,5,13,17,46,-29,11
Loko Moscow,3957,1,13,5,2,33,11,22,44
Spart Moscow,3957,2,10,5,5,38,30,8,35
CSKA Moscow,3957,3,10,3,7,25,19,6,33
Zenit,3957,4,8,8,4,22,15,7,32
Terek Grozny,3957,5,9,5,6,23,22,1,32
Krasnodar,3957,6,8,4,8,28,29,-1,28
Din Moscow,3957,7,6,7,7,21,22,-1,25
FK Rubin,3957,8,6,6,8,24,18,6,24
Rostov,3957,9,4,6,10,11,20,-9,18
Amkar,3957,10,4,4,12,9,24,-15,16
Anzhi,3957,11,3,5,12,15,39,-24,14
Loko Moscow,3958,1,12,5,3,30,12,18,41
CSKA Moscow,3958,2,12,3,5,30,19,11,39
Spart Moscow,3958,3,9,7,4,39,30,9,34
Zenit,3958,4,8,8,4,23,15,8,32
Terek Grozny,3958,5,8,5,7,21,24,-3,29
Krasnodar,3958,6,8,4,8,28,27,1,28
Din Moscow,3958,7,6,6,8,19,23,-4,24
FK Rubin,3958,8,6,5,9,23,19,4,23
Amkar,3958,9,5,5,10,13,24,-11,20
Rostov,3958,10,4,7,9,12,19,-7,19
Anzhi,3958,11,2,5,13,15,41,-26,11
Loko Moscow,3959,1,12,5,3,31,12,19,41
CSKA Moscow,3959,2,12,3,5,30,18,12,39
Spart Moscow,3959,3,10,6,4,39,27,12,36
Krasnodar,3959,4,9,5,6,30,26,4,32
Zenit,3959,5,7,8,5,21,17,4,29
Terek Grozny,3959,6,7,6,7,21,24,-3,27
Din Moscow,3959,7,5,8,7,18,22,-4,23
FK Rubin,3959,8,5,7,8,23,19,4,22
Amkar,3959,9,5,4,11,10,24,-14,19
Rostov,3959,10,4,6,10,11,20,-9,18
Anzhi,3959,11,2,6,12,16,41,-25,12
Loko Moscow,3960,1,11,6,3,31,14,17,39
CSKA Moscow,3960,2,11,4,5,30,21,9,37
Spart Moscow,3960,3,10,6,4,41,30,11,36
Krasnodar,3960,4,10,4,6,30,25,5,34
Zenit,3960,5,7,9,4,22,15,7,30
Terek Grozny,3960,6,8,6,6,22,23,-1,30
FK Rubin,3960,7,6,5,9,22,18,4,23
Din Moscow,3960,8,5,6,9,20,27,-7,21
Rostov,3960,9,4,6,10,10,18,-8,18
Amkar,3960,10,4,6,10,11,24,-13,18
Anzhi,3960,11,2,6,12,19,43,-24,12
Loko Moscow,3961,1,11,6,3,32,15,17,39
Zenit,3961,2,8,9,3,24,15,9,33
Spart Moscow,3961,3,9,6,5,38,30,8,33
CSKA Moscow,3961,4,10,3,7,27,21,6,33
Krasnodar,3961,5,9,5,6,30,26,4,32
Terek Grozny,3961,6,8,6,6,23,24,-1,30
FK Rubin,3961,7,6,6,8,22,17,5,24
Din Moscow,3961,8,6,6,8,19,23,-4,24
Rostov,3961,9,4,6,10,11,19,-8,18
Amkar,3961,10,4,5,11,12,26,-14,17
Anzhi,3961,11,3,6,11,17,39,-22,15
Loko Moscow,3962,1,11,7,2,29,11,18,40
CSKA Moscow,3962,2,11,3,6,28,18,10,36
Zenit,3962,3,8,9,3,22,13,9,33
Krasnodar,3962,4,9,5,6,30,24,6,32
Spart Moscow,3962,5,8,7,5,34,29,5,31
Terek Grozny,3962,6,7,7,6,21,23,-2,28
Din Moscow,3962,7,7,6,7,21,21,0,27
FK Rubin,3962,8,5,5,10,21,21,0,20
Rostov,3962,9,4,7,9,10,17,-7,19
Amkar,3962,10,4,6,10,11,24,-13,18
Anzhi,3962,11,2,6,12,14,40,-26,12
Loko Moscow,3963,1,13,5,2,32,12,20,44
CSKA Moscow,3963,2,10,5,5,25,17,8,35
Spart Moscow,3963,3,9,5,6,35,30,5,32
Zenit,3963,4,7,9,4,21,14,7,30
Krasnodar,3963,5,8,5,7,29,27,2,29
Terek Grozny,3963,6,7,6,7,21,24,-3,27
FK Rubin,3963,7,6,6,8,24,18,6,24
Din Moscow,3963,8,6,6,8,21,24,-3,24
Rostov,3963,9,5,6,9,11,17,-6,21
Amkar,3963,10,5,4,11,10,23,-13,19
Anzhi,3963,11,2,7,11,15,38,-23,13
Loko Moscow,3964,1,11,7,2,30,12,18,40
CSKA Moscow,3964,2,11,4,5,27,18,9,37
Spart Moscow,3964,3,9,6,5,36,27,9,33
Zenit,3964,4,7,10,3,22,14,8,31
Krasnodar,3964,5,8,6,6,27,24,3,30
Terek Grozny,3964,6,8,6,6,25,23,2,30
FK Rubin,3964,7,5,7,8,23,19,4,22
Din Moscow,3964,8,5,7,8,19,26,-7,22
Amkar,3964,9,5,5,10,12,23,-11,20
Rostov,3964,10,4,7,9,10,17,-7,19
Anzhi,3964,11,2,5,13,15,43,-28,11
Loko Moscow,3965,1,13,5,2,35,12,23,44
Spart Moscow,3965,2,11,5,4,41,26,15,38
CSKA Moscow,3965,3,10,5,5,28,20,8,35
Terek Grozny,3965,4,9,5,6,24,23,1,32
Krasnodar,3965,5,9,4,7,29,29,0,31
Zenit,3965,6,7,9,4,23,16,7,30
Din Moscow,3965,7,5,7,8,18,23,-5,22
FK Rubin,3965,8,5,6,9,22,19,3,21
Rostov,3965,9,4,6,10,10,21,-11,18
Amkar,3965,10,4,4,12,11,28,-17,16
Anzhi,3965,11,2,6,12,15,39,-24,12
Loko Moscow,3966,1,12,5,3,32,15,17,41
CSKA Moscow,3966,2,12,3,5,30,20,10,39
Spart Moscow,3966,3,10,6,4,40,28,12,36
Krasnodar,3966,4,9,5,6,31,25,6,32
Zenit,3966,5,7,8,5,23,18,5,29
Terek Grozny,3966,6,7,7,6,22,24,-2,28
Din Moscow,3966,7,6,6,8,20,23,-3,24
FK Rubin,3966,8,5,6,9,21,19,2,21
Rostov,3966,9,4,7,9,11,18,-7,19
Amkar,3966,10,4,5,11,10,26,-16,17
Anzhi,3966,11,2,6,12,17,41,-24,12
Loko Moscow,3967,1,11,6,3,31,15,16,39
CSKA Moscow,3967,2,12,3,5,28,18,10,39
Spart Moscow,3967,3,9,7,4,40,28,12,34
Zenit,3967,4,8,8,4,23,14,9,32
Terek Grozny,3967,5,9,5,6,25,22,3,32
Krasnodar,3967,6,8,6,6,32,29,3,30
FK Rubin,3967,7,6,6,8,25,20,5,24
Din Moscow,3967,8,5,6,9,17,26,-9,21
Rostov,3967,9,4,7,9,12,19,-7,19
Amkar,3967,10,4,5,11,10,25,-15,17
Anzhi,3967,11,2,5,13,15,42,-27,11
Loko Moscow,3968,1,12,6,2,33,14,19,42
CSKA Moscow,3968,2,11,4,5,28,18,10,37
Spart Moscow,3968,3,10,6,4,38,26,12,36
Zenit,3968,4,7,10,3,24,16,8,31
Krasnodar,3968,5,9,4,7,34,27,7,31
Terek Grozny,3968,6,8,5,7,24,26,-2,29
Din Moscow,3968,7,5,7,8,17,24,-7,22
FK Rubin,3968,8,5,6,9,22,23,-1,21
Amkar,3968,9,5,5,10,13,24,-11,20
Rostov,3968,10,4,6,10,10,18,-8,18
Anzhi,3968,11,2,5,13,15,42,-27,11
Loko Moscow,3969,1,11,7,2,30,12,18,40
CSKA Moscow,3969,2,11,4,5,27,18,9,37
Spart Moscow,3969,3,10,5,5,39,30,9,35
Krasnodar,3969,4,9,5,6,30,26,4,32
Zenit,3969,5,7,9,4,22,15,7,30
Terek Grozny,3969,6,8,6,6,24,23,1,30
Din Moscow,3969,7,5,7,8,21,26,-5,22
FK Rubin,3969,8,5,6,9,23,20,3,21
Amkar,3969,9,5,4,11,10,25,-15,19
Rostov,3969,10,4,6,10,11,19,-8,18
Anzhi,3969,11,2,7,11,15,38,-23,13
Loko Moscow,3970,1,11,5,4,29,14,15,38
CSKA Moscow,3970,2,11,3,6,27,19,8,36
Spart Moscow,3970,3,10,5,5,37,26,11,35
Zenit,3970,4,9,8,3,23,13,10,35
Krasnodar,3970,5,10,4,6,33,24,9,34
Terek Grozny,3970,6,8,5,7,23,25,-2,29
FK Rubin,3970,7,6,5,9,23,22,1,23
Amkar,3970,8,6,4,10,12,23,-11,22
Din Moscow,3970,9,5,6,9,18,25,-7,21
Rostov,3970,10,4,6,10,10,19,-9,18
Anzhi,3970,11,2,5,13,16,41,-25,11
Loko Moscow,3971,1,11,6,3,31,14,17,39
CSKA Moscow,3971,2,11,4,5,26,17,9,37
Krasnodar,3971,3,10,4,6,31,25,6,34
Zenit,3971,4,7,10,3,22,14,8,31
Spart Moscow,3971,5,8,6,6,36,30,6,30
Terek Grozny,3971,6,8,5,7,23,25,-2,29
Din Moscow,3971,7,5,8,7,21,25,-4,23
Amkar,3971,8,6,4,10,11,22,-11,22
FK Rubin,3971,9,5,6,9,23,21,2,21
Rostov,3971,10,5,6,9,12,18,-6,21
Anzhi,3971,11,2,5,13,16,41,-25,11
Loko Moscow,3972,1,12,5,3,31,12,19,41
Spart Moscow,3972,2,10,6,4,40,29,11,36
CSKA Moscow,3972,3,11,3,6,28,19,9,36
Krasnodar,3972,4,10,4,6,30,25,5,34
Zenit,3972,5,7,8,5,22,18,4,29
Terek Grozny,3972,6,8,5,7,21,23,-2,29
Din Moscow,3972,7,5,8,7,19,23,-4,23
FK Rubin,3972,8,5,6,9,23,20,3,21
Rostov,3972,9,4,6,10,11,19,-8,18
Anzhi,3972,10,4,5,11,16,37,-21,17
Amkar,3972,11,4,4,12,11,27,-16,16
Loko Moscow,3973,1,12,6,2,32,13,19,42
CSKA Moscow,3973,2,11,4,5,26,17,9,37
Krasnodar,3973,3,9,5,6,34,26,8,32
Spart Moscow,3973,4,8,7,5,35,29,6,31
Terek Grozny,3973,5,8,6,6,21,22,-1,30
Zenit,3973,6,7,8,5,21,15,6,29
Din Moscow,3973,7,5,8,7,18,22,-4,23
FK Rubin,3973,8,5,6,9,22,23,-1,21
Amkar,3973,9,5,5,10,12,23,-11,20
Rostov,3973,10,4,7,9,11,18,-7,19
Anzhi,3973,11,2,6,12,14,38,-24,12
Loko Moscow,3974,1,11,7,2,31,13,18,40
CSKA Moscow,3974,2,12,3,5,30,18,12,39
Spart Moscow,3974,3,11,5,4,41,28,13,38
Zenit,3974,4,7,9,4,22,16,6,30
Krasnodar,3974,5,8,5,7,28,26,2,29
Terek Grozny,3974,6,8,5,7,22,26,-4,29
FK Rubin,3974,7,7,5,8,23,17,6,26
Din Moscow,3974,8,5,6,9,18,24,-6,21
Amkar,3974,9,5,4,11,12,23,-11,19
Rostov,3974,10,4,6,10,12,22,-10,18
Anzhi,3974,11,2,5,13,16,42,-26,11
Loko Moscow,3975,1,11,5,4,30,14,16,38
CSKA Moscow,3975,2,11,3,6,30,22,8,36
Zenit,3975,3,9,8,3,23,13,10,35
Krasnodar,3975,4,10,4,6,32,25,7,34
Spart Moscow,3975,5,9,5,6,36,30,6,32
Terek Grozny,3975,6,8,5,7,22,24,-2,29
Din Moscow,3975,7,6,6,8,19,23,-4,24
FK Rubin,3975,8,6,5,9,22,20,2,23
Rostov,3975,9,5,6,9,12,17,-5,21
Amkar,3975,10,4,4,12,11,26,-15,16
Anzhi,3975,11,3,5,12,19,42,-23,14
Loko Moscow,3976,1,11,5,4,29,15,14,38
CSKA Moscow,3976,2,11,3,6,26,18,8,36
Zenit,3976,3,9,8,3,23,13,10,35
Spart Moscow,3976,4,10,5,5,37,29,8,35
Krasnodar,3976,5,9,4,7,30,27,3,31
Terek Grozny,3976,6,7,7,6,21,23,-2,28
FK Rubin,3976,7,6,6,8,26,19,7,24
Din Moscow,3976,8,5,7,8,19,25,-6,22
Amkar,3976,9,5,5,10,12,22,-10,20
Rostov,3976,10,4,6,10,11,19,-8,18
Anzhi,3976,11,2,6,12,15,39,-24,12
Loko Moscow,3977,1,11,5,4,30,15,15,38
Spart Moscow,3977,2,10,6,4,36,26,10,36
CSKA Moscow,3977,3,11,3,6,26,18,8,36
Zenit,3977,4,9,8,3,23,13,10,35
Krasnodar,3977,5,9,4,7,30,26,4,31
Terek Grozny,3977,6,8,6,6,25,26,-1,30
FK Rubin,3977,7,6,6,8,22,17,5,24
Din Moscow,3977,8,5,7,8,17,22,-5,22
Rostov,3977,9,4,6,10,10,18,-8,18
Amkar,3977,10,4,6,10,12,25,-13,18
Anzhi,3977,11,2,5,13,16,41,-25,11
Loko Moscow,3978,1,12,5,3,33,14,19,41
Spart Moscow,3978,2,11,5,4,37,25,12,38
CSKA Moscow,3978,3,11,3,6,27,19,8,36
Krasnodar,3978,4,10,4,6,30,25,5,34
Zenit,3978,5,8,8,4,24,17,7,32
Terek Grozny,3978,6,8,5,7,23,26,-3,29
Din Moscow,3978,7,5,7,8,18,24,-6,22
FK Rubin,3978,8,5,6,9,22,19,3,21
Rostov,3978,9,4,6,10,10,18,-8,18
Amkar,3978,10,4,4,12,10,25,-15,16
Anzhi,3978,11,3,5,12,17,39,-22,14
Loko Moscow,3979,1,12,6,2,32,12,20,42
Spart Moscow,3979,2,10,6,4,35,25,10,36
CSKA Moscow,3979,3,11,3,6,29,20,9,36
Zenit,3979,4,8,8,4,24,15,9,32
Krasnodar,3979,5,9,5,6,32,25,7,32
Terek Grozny,3979,6,7,6,7,22,26,-4,27
Din Moscow,3979,7,6,6,8,21,24,-3,24
FK Rubin,3979,8,5,5,10,23,25,-2,20
Rostov,3979,9,4,6,10,10,18,-8,18
Amkar,3979,10,4,6,10,10,23,-13,18
Anzhi,3979,11,3,5,12,17,42,-25,14
Loko Moscow,3980,1,12,6,2,32,13,19,42
Spart Moscow,3980,2,11,5,4,42,28,14,38
CSKA Moscow,3980,3,10,4,6,26,19,7,34
Terek Grozny,3980,4,9,5,6,23,22,1,32
Zenit,3980,5,7,10,3,23,15,8,31
Krasnodar,3980,6,8,4,8,27,26,1,28
Din Moscow,3980,7,6,6,8,18,24,-6,24
FK Rubin,3980,8,6,5,9,22,18,4,23
Rostov,3980,9,4,6,10,11,20,-9,18
Amkar,3980,10,4,4,12,11,27,-16,16
Anzhi,3980,11,3,5,12,16,39,-23,14
Loko Moscow,3981,1,12,5,3,32,14,18,41
CSKA Moscow,3981,2,11,3,6,27,19,8,36
Zenit,3981,3,9,8,3,24,13,11,35
Spart Moscow,3981,4,9,6,5,37,28,9,33
Terek Grozny,3981,5,9,5,6,25,25,0,32
Krasnodar,3981,6,9,4,7,30,27,3,31
Din Moscow,3981,7,6,6,8,20,25,-5,24
Rostov,3981,8,5,6,9,11,17,-6,21
FK Rubin,3981,9,5,5,10,22,21,1,20
Amkar,3981,10,4,5,11,12,26,-14,17
Anzhi,3981,11,2,5,13,16,41,-25,11
Loko Moscow,3982,1,11,6,3,30,15,15,39
CSKA Moscow,3982,2,11,3,6,27,19,8,36
Krasnodar,3982,3,10,4,6,34,26,8,34
Zenit,3982,4,8,9,3,23,14,9,33
Spart Moscow,3982,5,9,6,5,36,29,7,33
Terek Grozny,3982,6,7,6,7,21,24,-3,27
Din Moscow,3982,7,6,7,7,20,23,-3,25
Amkar,3982,8,6,4,10,12,22,-10,22
FK Rubin,3982,9,5,5,10,23,22,1,20
Rostov,3982,10,4,6,10,10,18,-8,18
Anzhi,3982,11,2,6,12,16,40,-24,12
Loko Moscow,3983,1,13,5,2,32,11,21,44
Spart Moscow,3983,2,10,5,5,35,28,7,35
CSKA Moscow,3983,3,10,4,6,25,18,7,34
Zenit,3983,4,8,8,4,22,15,7,32
Krasnodar,3983,5,8,5,7,27,25,2,29
Terek Grozny,3983,6,7,6,7,21,25,-4,27
FK Rubin,3983,7,6,6,8,24,18,6,24
Rostov,3983,8,5,6,9,13,17,-4,21
Din Moscow,3983,9,5,6,9,18,25,-7,21
Amkar,3983,10,5,4,11,11,23,-12,19
Anzhi,3983,11,2,7,11,15,38,-23,13
Loko Moscow,3984,1,12,6,2,32,13,19,42
CSKA Moscow,3984,2,12,3,5,31,18,13,39
Spart Moscow,3984,3,9,6,5,38,32,6,33
Krasnodar,3984,4,9,4,7,31,27,4,31
Zenit,3984,5,7,9,4,23,18,5,30
Terek Grozny,3984,6,8,6,6,24,24,0,30
Din Moscow,3984,7,6,6,8,23,25,-2,24
FK Rubin,3984,8,6,5,9,25,22,3,23
Rostov,3984,9,4,6,10,11,19,-8,18
Amkar,3984,10,4,5,11,12,27,-15,17
Anzhi,3984,11,2,6,12,15,40,-25,12
Loko Moscow,3985,1,11,5,4,29,14,15,38
CSKA Moscow,3985,2,11,3,6,29,22,7,36
Zenit,3985,3,9,8,3,26,14,12,35
Spart Moscow,3985,4,9,7,4,38,26,12,34
Krasnodar,3985,5,9,5,6,29,24,5,32
Terek Grozny,3985,6,9,5,6,25,23,2,32
Din Moscow,3985,7,6,6,8,22,27,-5,24
FK Rubin,3985,8,5,6,9,22,21,1,21
Rostov,3985,9,4,7,9,10,17,-7,19
Amkar,3985,10,4,5,11,10,24,-14,17
Anzhi,3985,11,2,5,13,15,43,-28,11
Loko Moscow,3986,1,12,5,3,33,13,20,41
CSKA Moscow,3986,2,11,4,5,29,18,11,37
Spart Moscow,3986,3,10,6,4,38,28,10,36
Zenit,3986,4,8,9,3,24,14,10,33
Terek Grozny,3986,5,9,5,6,24,23,1,32
Krasnodar,3986,6,9,4,7,28,28,0,31
FK Rubin,3986,7,6,5,9,23,18,5,23
Din Moscow,3986,8,5,6,9,18,25,-7,21
Rostov,3986,9,4,6,10,11,19,-8,18
Amkar,3986,10,4,5,11,10,24,-14,17
Anzhi,3986,11,2,5,13,15,43,-28,11
Loko Moscow,3987,1,12,6,2,30,11,19,42
Spart Moscow,3987,2,10,5,5,37,28,9,35
CSKA Moscow,3987,3,10,4,6,28,21,7,34
Zenit,3987,4,8,9,3,23,14,9,33
Krasnodar,3987,5,9,4,7,28,25,3,31
Terek Grozny,3987,6,7,6,7,22,26,-4,27
FK Rubin,3987,7,6,5,9,23,19,4,23
Amkar,3987,8,6,4,10,14,22,-8,22
Din Moscow,3987,9,5,6,9,18,26,-8,21
Rostov,3987,10,4,6,10,10,18,-8,18
Anzhi,3987,11,2,7,11,18,41,-23,13
Loko Moscow,3988,1,12,6,2,32,13,19,42
CSKA Moscow,3988,2,11,3,6,26,19,7,36
Spart Moscow,3988,3,9,6,5,37,28,9,33
Zenit,3988,4,8,8,4,23,14,9,32
Krasnodar,3988,5,8,5,7,29,27,2,29
Din Moscow,3988,6,7,6,7,22,24,-2,27
Terek Grozny,3988,7,7,5,8,23,29,-6,26
FK Rubin,3988,8,6,5,9,23,19,4,23
Rostov,3988,9,4,7,9,10,17,-7,19
Amkar,3988,10,5,4,11,11,25,-14,19
Anzhi,3988,11,3,5,12,19,40,-21,14
Loko Moscow,3989,1,11,7,2,30,12,18,40
CSKA Moscow,3989,2,11,3,6,27,19,8,36
Spart Moscow,3989,3,9,7,4,41,30,11,34
Zenit,3989,4,8,9,3,23,14,9,33
Krasnodar,3989,5,9,5,6,30,26,4,32
Terek Grozny,3989,6,9,5,6,24,23,1,32
Din Moscow,3989,7,5,8,7,21,25,-4,23
FK Rubin,3989,8,5,6,9,23,20,3,21
Rostov,3989,9,4,6,10,11,21,-10,18
Amkar,3989,10,4,5,11,10,24,-14,17
Anzhi,3989,11,2,5,13,15,41,-26,11
Loko Moscow,3990,1,11,5,4,31,16,15,38
CSKA Moscow,3990,2,11,3,6,29,22,7,36
Spart Moscow,3990,3,9,6,5,40,32,8,33
Zenit,3990,4,8,8,4,26,18,8,32
Terek Grozny,3990,5,9,5,6,25,24,1,32
Krasnodar,3990,6,9,4,7,30,26,4,31
Din Moscow,3990,7,6,6,8,22,25,-3,24
FK Rubin,3990,8,6,5,9,23,21,2,23
Rostov,3990,9,5,6,9,13,18,-5,21
Amkar,3990,10,4,5,11,13,27,-14,17
Anzhi,3990,11,3,5,12,17,40,-23,14
Loko Moscow,3991,1,12,5,3,31,13,18,41
Spart Moscow,3991,2,9,7,4,39,30,9,34
CSKA Moscow,3991,3,10,3,7,26,22,4,33
Zenit,3991,4,8,8,4,24,15,9,32
Krasnodar,3991,5,9,4,7,29,26,3,31
Terek Grozny,3991,6,7,7,6,21,23,-2,28
FK Rubin,3991,7,7,5,8,25,18,7,26
Din Moscow,3991,8,5,7,8,21,27,-6,22
Rostov,3991,9,4,7,9,11,18,-7,19
Amkar,3991,10,4,5,11,9,23,-14,17
Anzhi,3991,11,3,6,11,18,39,-21,15
Loko Moscow,3992,1,12,6,2,32,12,20,42
Spart Moscow,3992,2,10,6,4,41,31,10,36
CSKA Moscow,3992,3,11,3,6,27,19,8,36
Zenit,3992,4,8,9,3,23,14,9,33
Terek Grozny,3992,5,8,6,6,23,23,0,30
Krasnodar,3992,6,8,4,8,29,29,0,28
FK Rubin,3992,7,6,6,8,25,20,5,24
Din Moscow,3992,8,5,7,8,21,26,-5,22
Rostov,3992,9,4,6,10,13,21,-8,18
Amkar,3992,10,4,5,11,10,25,-15,17
Anzhi,3992,11,2,6,12,15,39,-24,12
Loko Moscow,3993,1,11,6,3,30,14,16,39
CSKA Moscow,3993,2,11,3,6,26,18,8,36
Zenit,3993,3,9,8,3,24,13,11,35
Spart Moscow,3993,4,9,6,5,36,27,9,33
Krasnodar,3993,5,9,5,6,30,25,5,32
Terek Grozny,3993,6,7,5,8,20,25,-5,26
Din Moscow,3993,7,5,7,8,18,24,-6,22
FK Rubin,3993,8,5,6,9,22,20,2,21
Rostov,3993,9,5,6,9,11,17,-6,21
Amkar,3993,10,5,5,10,12,23,-11,20
Anzhi,3993,11,3,5,12,15,38,-23,14
Loko Moscow,3994,1,11,5,4,30,15,15,38
CSKA Moscow,3994,2,10,5,5,27,19,8,35
Krasnodar,3994,3,10,4,6,31,25,6,34
Spart Moscow,3994,4,9,6,5,40,28,12,33
Zenit,3994,5,8,9,3,24,15,9,33
Terek Grozny,3994,6,7,6,7,20,24,-4,27
Din Moscow,3994,7,6,6,8,19,23,-4,24
FK Rubin,3994,8,6,5,9,23,19,4,23
Amkar,3994,9,5,5,10,12,23,-11,20
Rostov,3994,10,4,6,10,10,22,-12,18
Anzhi,3994,11,2,7,11,15,38,-23,13
Loko Moscow,3995,1,11,6,3,30,13,17,39
CSKA Moscow,3995,2,12,3,5,30,18,12,39
Spart Moscow,3995,3,9,6,5,39,28,11,33
Zenit,3995,4,8,8,4,23,15,8,32
Krasnodar,3995,5,9,5,6,32,27,5,32
Terek Grozny,3995,6,8,5,7,21,24,-3,29
Din Moscow,3995,7,7,6,7,20,22,-2,27
FK Rubin,3995,8,5,5,10,23,22,1,20
Rostov,3995,9,4,7,9,11,18,-7,19
Amkar,3995,10,5,4,11,11,26,-15,19
Anzhi,3995,11,2,5,13,14,41,-27,11
Loko Moscow,3996,1,11,5,4,29,13,16,38
Zenit,3996,2,9,8,3,25,13,12,35
CSKA Moscow,3996,3,10,4,6,27,22,5,34
Krasnodar,3996,4,9,5,6,28,24,4,32
Terek Grozny,3996,5,9,5,6,24,22,2,32
Spart Moscow,3996,6,8,6,6,36,32,4,30
Din Moscow,3996,7,7,6,7,22,22,0,27
FK Rubin,3996,8,5,6,9,22,20,2,21
Rostov,3996,9,4,7,9,12,19,-7,19
Amkar,3996,10,5,4,11,12,25,-13,19
Anzhi,3996,11,2,6,12,16,41,-25,12
Loko Moscow,3997,1,11,7,2,32,14,18,40
CSKA Moscow,3997,2,10,5,5,28,20,8,35
Spart Moscow,3997,3,9,6,5,37,27,10,33
Terek Grozny,3997,4,9,5,6,23,22,1,32
Zenit,3997,5,7,10,3,24,16,8,31
Krasnodar,3997,6,8,6,6,29,26,3,30
Din Moscow,3997,7,7,6,7,20,21,-1,27
FK Rubin,3997,8,5,6,9,22,20,2,21
Rostov,3997,9,4,7,9,11,18,-7,19
Amkar,3997,10,4,4,12,9,26,-17,16
Anzhi,3997,11,2,6,12,16,41,-25,12
Loko Moscow,3998,1,11,5,4,30,15,15,38
Zenit,3998,2,9,8,3,25,13,12,35
Krasnodar,3998,3,10,4,6,32,26,6,34
CSKA Moscow,3998,4,10,4,6,26,21,5,34
Spart Moscow,3998,5,8,6,6,36,31,5,30
Terek Grozny,3998,6,8,5,7,21,24,-3,29
Din Moscow,3998,7,5,8,7,20,24,-4,23
FK Rubin,3998,8,5,6,9,23,20,3,21
Rostov,3998,9,5,6,9,12,17,-5,21
Amkar,3998,10,5,4,11,11,24,-13,19
Anzhi,3998,11,3,6,11,17,38,-21,15
Loko Moscow,3999,1,11,5,4,31,16,15,38
CSKA Moscow,3999,2,11,3,6,26,20,6,36
Zenit,3999,3,9,8,3,27,15,12,35
Krasnodar,3999,4,10,4,6,30,24,6,34
Spart Moscow,3999,5,8,6,6,36,31,5,30
Terek Grozny,3999,6,8,5,7,21,23,-2,29
FK Rubin,3999,7,6,5,9,24,20,4,23
Din Moscow,3999,8,5,7,8,21,26,-5,22
Rostov,3999,9,5,6,9,11,17,-6,21
Amkar,3999,10,5,4,11,12,24,-12,19
Anzhi,3999,11,3,5,12,15,38,-23,14
Loko Moscow,4000,1,13,5,2,32,12,20,44
CSKA Moscow,4000,2,11,3,6,34,18,16,36
Spart Moscow,4000,3,10,5,5,37,27,10,35
Zenit,4000,4,8,8,4,22,14,8,32
Krasnodar,4000,5,9,4,7,30,27,3,31
Terek Grozny,4000,6,8,5,7,21,23,-2,29
Din Moscow,4000,7,5,7,8,18,23,-5,22
Amkar,4000,8,6,4,10,12,22,-10,22
FK Rubin,4000,9,5,6,9,23,20,3,21
Rostov,4000,10,4,6,10,10,20,-10,18
Anzhi,4000,11,2,5,13,14,47,-33,11
Loko Moscow,4001,1,12,6,2,30,11,19,42
CSKA Moscow,4001,2,11,3,6,26,18,8,36
Spart Moscow,4001,3,9,7,4,39,30,9,34
Zenit,4001,4,8,8,4,22,14,8,32
Terek Grozny,4001,5,8,6,6,24,24,0,30
Krasnodar,4001,6,8,5,7,27,25,2,29
Din Moscow,4001,7,6,7,7,19,22,-3,25
FK Rubin,4001,8,6,5,9,22,18,4,23
Rostov,4001,9,4,7,9,11,18,-7,19
Amkar,4001,10,4,4,12,12,28,-16,16
Anzhi,4001,11,2,6,12,16,40,-24,12
Loko Moscow,4002,1,12,5,3,33,13,20,41
CSKA Moscow,4002,2,11,3,6,30,20,10,36
Spart Moscow,4002,3,9,6,5,36,28,8,33
Zenit,4002,4,8,8,4,24,17,7,32
Krasnodar,4002,5,9,5,6,31,27,4,32
Terek Grozny,4002,6,7,6,7,20,23,-3,27
FK Rubin,4002,7,6,6,8,25,20,5,24
Din Moscow,4002,8,5,7,8,19,24,-5,22
Amkar,4002,9,5,5,10,11,23,-12,20
Rostov,4002,10,4,6,10,10,18,-8,18
Anzhi,4002,11,3,5,12,15,41,-26,14
Loko Moscow,4003,1,12,6,2,30,11,19,42
CSKA Moscow,4003,2,12,3,5,28,18,10,39
Spart Moscow,4003,3,10,5,5,35,26,9,35
Krasnodar,4003,4,9,5,6,29,24,5,32
Terek Grozny,4003,5,9,5,6,26,22,4,32
Zenit,4003,6,7,8,5,21,15,6,29
Din Moscow,4003,7,6,6,8,19,23,-4,24
FK Rubin,4003,8,5,5,10,22,21,1,20
Amkar,4003,9,5,4,11,10,26,-16,19
Rostov,4003,10,4,6,10,10,18,-8,18
Anzhi,4003,11,2,5,13,15,41,-26,11
Loko Moscow,4004,1,12,5,3,30,12,18,41
CSKA Moscow,4004,2,11,4,5,27,17,10,37
Krasnodar,4004,3,10,4,6,31,25,6,34
Spart Moscow,4004,4,9,6,5,39,29,10,33
Zenit,4004,5,7,9,4,21,14,7,30
Terek Grozny,4004,6,8,6,6,22,23,-1,30
Din Moscow,4004,7,6,6,8,18,25,-7,24
FK Rubin,4004,8,5,5,10,22,21,1,20
Rostov,4004,9,4,7,9,11,18,-7,19
Amkar,4004,10,5,4,11,12,24,-12,19
Anzhi,4004,11,2,6,12,15,40,-25,12
Loko Moscow,4005,1,12,5,3,31,13,18,41
CSKA Moscow,4005,2,11,3,6,28,19,9,36
Spart Moscow,4005,3,10,5,5,37,28,9,35
Krasnodar,4005,4,10,4,6,31,26,5,34
Zenit,4005,5,8,8,4,24,15,9,32
Terek Grozny,4005,6,7,6,7,23,26,-3,27
Din Moscow,4005,7,6,7,7,18,21,-3,25
FK Rubin,4005,8,5,6,9,23,20,3,21
Rostov,4005,9,4,6,10,11,19,-8,18
Amkar,4005,10,4,5,11,12,26,-14,17
Anzhi,4005,11,3,5,12,16,41,-25,14
Loko Moscow,4006,1,12,6,2,34,12,22,42
CSKA Moscow,4006,2,12,3,5,28,18,10,39
Spart Moscow,4006,3,8,8,4,36,28,8,32
Terek Grozny,4006,4,9,5,6,26,23,3,32
Zenit,4006,5,7,8,5,21,18,3,29
Krasnodar,4006,6,8,5,7,28,27,1,29
FK Rubin,4006,7,6,6,8,23,17,6,24
Din Moscow,4006,8,5,8,7,18,22,-4,23
Rostov,4006,9,4,7,9,12,19,-7,19
Amkar,4006,10,4,5,11,10,24,-14,17
Anzhi,4006,11,2,5,13,15,43,-28,11
Loko Moscow,4007,1,13,5,2,35,11,24,44
CSKA Moscow,4007,2,11,3,6,30,22,8,36
Spart Moscow,4007,3,10,5,5,38,27,11,35
Zenit,4007,4,8,8,4,25,17,8,32
Krasnodar,4007,5,9,4,7,30,26,4,31
Terek Grozny,4007,6,8,6,6,23,23,0,30
Din Moscow,4007,7,6,6,8,21,22,-1,24
FK Rubin,4007,8,5,5,10,21,24,-3,20
Amkar,4007,9,5,5,10,12,24,-12,20
Rostov,4007,10,4,6,10,10,20,-10,18
Anzhi,4007,11,2,5,13,15,44,-29,11
Loko Moscow,4008,1,12,6,2,31,12,19,42
Spart Moscow,4008,2,11,5,4,41,26,15,38
CSKA Moscow,4008,3,11,4,5,27,18,9,37
Zenit,4008,4,7,9,4,21,14,7,30
Krasnodar,4008,5,8,6,6,30,27,3,30
Terek Grozny,4008,6,7,6,7,22,25,-3,27
Din Moscow,4008,7,6,6,8,20,25,-5,24
FK Rubin,4008,8,5,6,9,23,21,2,21
Amkar,4008,9,5,4,11,11,24,-13,19
Rostov,4008,10,4,6,10,10,20,-10,18
Anzhi,4008,11,2,6,12,16,40,-24,12
Loko Moscow,4009,1,11,5,4,31,16,15,38
CSKA Moscow,4009,2,11,4,5,30,18,12,37
Krasnodar,4009,3,10,4,6,31,26,5,34
Zenit,4009,4,8,9,3,25,15,10,33
Spart Moscow,4009,5,9,5,6,36,28,8,32
Terek Grozny,4009,6,9,5,6,24,23,1,32
Din Moscow,4009,7,5,7,8,17,23,-6,22
FK Rubin,4009,8,5,6,9,22,19,3,21
Rostov,4009,9,5,6,9,12,18,-6,21
Amkar,4009,10,5,4,11,11,24,-13,19
Anzhi,4009,11,2,5,13,14,43,-29,11
Loko Moscow,4010,1,12,5,3,33,17,16,41
CSKA Moscow,4010,2,11,3,6,30,21,9,36
Krasnodar,4010,3,10,4,6,34,27,7,34
Zenit,4010,4,8,8,4,25,17,8,32
Spart Moscow,4010,5,8,6,6,35,29,6,30
Terek Grozny,4010,6,8,6,6,23,24,-1,30
Din Moscow,4010,7,6,7,7,18,21,-3,25
FK Rubin,4010,8,5,6,9,22,19,3,21
Rostov,4010,9,5,6,9,12,18,-6,21
Amkar,4010,10,4,6,10,11,24,-13,18
Anzhi,4010,11,2,5,13,16,42,-26,11
Loko Moscow,4011,1,12,5,3,31,13,18,41
Spart Moscow,4011,2,11,5,4,40,28,12,38
CSKA Moscow,4011,3,10,4,6,26,19,7,34
Zenit,4011,4,8,9,3,24,14,10,33
Krasnodar,4011,5,9,4,7,32,27,5,31
Terek Grozny,4011,6,8,6,6,24,25,-1,30
FK Rubin,4011,7,6,5,9,23,22,1,23
Din Moscow,4011,8,5,6,9,17,23,-6,21
Rostov,4011,9,4,6,10,13,22,-9,18
Amkar,4011,10,4,4,12,10,25,-15,16
Anzhi,4011,11,3,6,11,17,39,-22,15
Loko Moscow,4012,1,11,7,2,31,13,18,40
CSKA Moscow,4012,2,11,4,5,29,18,11,37
Spart Moscow,4012,3,9,5,6,35,28,7,32
Zenit,4012,4,7,10,3,22,14,8,31
Krasnodar,4012,5,8,6,6,28,25,3,30
Terek Grozny,4012,6,7,7,6,20,22,-2,28
Din Moscow,4012,7,7,6,7,20,21,-1,27
FK Rubin,4012,8,5,6,9,21,18,3,21
Amkar,4012,9,5,5,10,10,22,-12,20
Rostov,4012,10,4,6,10,10,19,-9,18
Anzhi,4012,11,2,6,12,15,41,-26,12
Loko Moscow,4013,1,13,5,2,32,12,20,44
Spart Moscow,4013,2,11,5,4,43,28,15,38
CSKA Moscow,4013,3,10,3,7,26,21,5,33
Zenit,4013,4,8,8,4,23,15,8,32
Krasnodar,4013,5,8,5,7,29,27,2,29
Terek Grozny,4013,6,7,6,7,21,24,-3,27
FK Rubin,4013,7,5,7,8,23,19,4,22
Din Moscow,4013,8,5,7,8,18,24,-6,22
Rostov,4013,9,4,6,10,12,20,-8,18
Amkar,4013,10,4,5,11,10,27,-17,17
Anzhi,4013,11,4,5,11,18,38,-20,17
Loko Moscow,4014,1,11,5,4,29,15,14,38
Spart Moscow,4014,2,10,5,5,42,30,12,35
Zenit,4014,3,9,8,3,25,13,12,35
CSKA Moscow,4014,4,10,3,7,25,20,5,33
Krasnodar,4014,5,9,4,7,30,26,4,31
Terek Grozny,4014,6,8,5,7,24,25,-1,29
Din Moscow,4014,7,6,6,8,21,26,-5,24
FK Rubin,4014,8,6,5,9,23,20,3,23
Amkar,4014,9,6,4,10,12,23,-11,22
Rostov,4014,10,4,6,10,12,21,-9,18
Anzhi,4014,11,3,5,12,16,40,-24,14
Loko Moscow,4015,1,12,6,2,30,11,19,42
CSKA Moscow,4015,2,11,3,6,28,20,8,36
Zenit,4015,3,8,8,4,23,14,9,32
Spart Moscow,4015,4,9,5,6,39,31,8,32
Krasnodar,4015,5,8,6,6,28,25,3,30
Terek Grozny,4015,6,8,5,7,24,26,-2,29
FK Rubin,4015,7,6,6,8,23,18,5,24
Din Moscow,4015,8,6,6,8,22,25,-3,24
Amkar,4015,9,5,4,11,12,25,-13,19
Rostov,4015,10,4,6,10,10,20,-10,18
Anzhi,4015,11,3,5,12,17,41,-24,14
Loko Moscow,4016,1,12,6,2,32,12,20,42
CSKA Moscow,4016,2,11,4,5,27,18,9,37
Spart Moscow,4016,3,9,6,5,38,30,8,33
Terek Grozny,4016,4,9,5,6,28,22,6,32
Zenit,4016,5,7,10,3,22,14,8,31
Krasnodar,4016,6,9,4,7,29,26,3,31
Din Moscow,4016,7,6,6,8,20,22,-2,24
Rostov,4016,8,5,6,9,11,17,-6,21
FK Rubin,4016,9,5,5,10,21,22,-1,20
Amkar,4016,10,4,5,11,13,28,-15,17
Anzhi,4016,11,2,5,13,15,45,-30,11
Loko Moscow,4017,1,12,5,3,30,13,17,41
CSKA Moscow,4017,2,12,3,5,29,18,11,39
Spart Moscow,4017,3,10,6,4,39,26,13,36
Zenit,4017,4,8,8,4,23,15,8,32
Krasnodar,4017,5,9,4,7,28,25,3,31
Terek Grozny,4017,6,8,6,6,23,23,0,30
Din Moscow,4017,7,6,7,7,18,21,-3,25
FK Rubin,4017,8,5,5,10,21,19,2,20
Rostov,4017,9,4,6,10,10,21,-11,18
Amkar,4017,10,4,4,12,10,26,-16,16
Anzhi,4017,11,2,6,12,16,40,-24,12
Loko Moscow,4018,1,11,5,4,31,15,16,38
CSKA Moscow,4018,2,11,4,5,28,19,9,37
Krasnodar,4018,3,10,4,6,32,26,6,34
Spart Moscow,4018,4,9,6,5,37,31,6,33
Zenit,4018,5,8,8,4,23,15,8,32
Terek Grozny,4018,6,8,5,7,24,28,-4,29
Din Moscow,4018,7,5,8,7,18,22,-4,23
FK Rubin,4018,8,5,6,9,23,21,2,21
Amkar,4018,9,5,4,11,15,26,-11,19
Rostov,4018,10,4,6,10,11,19,-8,18
Anzhi,4018,11,3,6,11,21,41,-20,15
Loko Moscow,4019,1,12,5,3,31,13,18,41
Spart Moscow,4019,2,10,6,4,39,28,11,36
CSKA Moscow,4019,3,10,5,5,30,22,8,35
Zenit,4019,4,8,9,3,25,15,10,33
Krasnodar,4019,5,8,5,7,29,28,1,29
Terek Grozny,4019,6,7,5,8,20,25,-5,26
Din Moscow,4019,7,6,6,8,20,23,-3,24
FK Rubin,4019,8,5,6,9,23,21,2,21
Rostov,4019,9,4,7,9,12,19,-7,19
Amkar,4019,10,5,4,11,11,24,-13,19
Anzhi,4019,11,3,6,11,18,40,-22,15
CSKA Moscow,4020,1,12,3,5,30,19,11,39
Loko Moscow,4020,2,11,5,4,30,15,15,38
Spart Moscow,4020,3,9,7,4,36,27,9,34
Zenit,4020,4,8,8,4,25,17,8,32
Krasnodar,4020,5,9,4,7,29,25,4,31
Terek Grozny,4020,6,7,6,7,23,26,-3,27
FK Rubin,4020,7,7,5,8,23,17,6,26
Din Moscow,4020,8,5,7,8,17,22,-5,22
Rostov,4020,9,4,6,10,11,19,-8,18
Amkar,4020,10,4,6,10,12,25,-13,18
Anzhi,4020,11,3,5,12,16,40,-24,14
Loko Moscow,4021,1,12,5,3,31,13,18,41
CSKA Moscow,4021,2,12,3,5,27,17,10,39
Spart Moscow,4021,3,10,6,4,41,30,11,36
Zenit,4021,4,8,8,4,23,14,9,32
Terek Grozny,4021,5,8,5,7,22,24,-2,29
Krasnodar,4021,6,8,4,8,28,28,0,28
FK Rubin,4021,7,7,5,8,25,19,6,26
Din Moscow,4021,8,5,6,9,21,27,-6,21
Amkar,4021,9,5,5,10,11,23,-12,20
Rostov,4021,10,4,6,10,11,20,-9,18
Anzhi,4021,11,2,5,13,15,40,-25,11
Loko Moscow,4022,1,12,5,3,32,14,18,41
CSKA Moscow,4022,2,11,3,6,26,20,6,36
Zenit,4022,3,9,8,3,27,15,12,35
Spart Moscow,4022,4,9,6,5,41,31,10,33
Krasnodar,4022,5,8,5,7,29,27,2,29
Terek Grozny,4022,6,8,5,7,22,24,-2,29
FK Rubin,4022,7,6,6,8,24,19,5,24
Din Moscow,4022,8,6,6,8,19,23,-4,24
Rostov,4022,9,4,7,9,12,19,-7,19
Amkar,4022,10,5,4,11,13,28,-15,19
Anzhi,4022,11,2,5,13,14,39,-25,11
Loko Moscow,4023,1,11,6,3,30,13,17,39
CSKA Moscow,4023,2,11,3,6,27,19,8,36
Zenit,4023,3,8,9,3,24,14,10,33
Spart Moscow,4023,4,9,5,6,37,28,9,32
Krasnodar,4023,5,9,4,7,28,27,1,31
Terek Grozny,4023,6,8,5,7,23,24,-1,29
Din Moscow,4023,7,7,6,7,21,22,-1,27
FK Rubin,4023,8,6,5,9,24,19,5,23
Amkar,4023,9,5,4,11,10,24,-14,19
Rostov,4023,10,4,6,10,10,20,-10,18
Anzhi,4023,11,3,5,12,16,40,-24,14
Loko Moscow,4024,1,12,6,2,33,14,19,42
CSKA Moscow,4024,2,12,3,5,27,17,10,39
Spart Moscow,4024,3,9,6,5,41,29,12,33
Zenit,4024,4,7,9,4,22,15,7,30
Terek Grozny,4024,5,8,6,6,22,23,-1,30
Krasnodar,4024,6,8,5,7,30,28,2,29
Din Moscow,4024,7,6,6,8,18,26,-8,24
FK Rubin,4024,8,5,6,9,22,19,3,21
Amkar,4024,9,5,5,10,11,23,-12,20
Rostov,4024,10,4,7,9,12,19,-7,19
Anzhi,4024,11,2,5,13,15,40,-25,11
Loko Moscow,4025,1,11,6,3,32,16,16,39
Zenit,4025,2,9,8,3,26,14,12,35
Spart Moscow,4025,3,10,5,5,38,28,10,35
CSKA Moscow,4025,4,10,4,6,25,19,6,34
Krasnodar,4025,5,9,5,6,32,27,5,32
Terek Grozny,4025,6,9,5,6,24,23,1,32
Din Moscow,4025,7,6,6,8,19,24,-5,24
FK Rubin,4025,8,6,5,9,24,20,4,23
Rostov,4025,9,4,6,10,10,18,-8,18
Amkar,4025,10,4,4,12,10,26,-16,16
Anzhi,4025,11,2,6,12,15,40,-25,12
Loko Moscow,4026,1,12,5,3,33,15,18,41
CSKA Moscow,4026,2,11,4,5,29,19,10,37
Spart Moscow,4026,3,10,6,4,38,27,11,36
Zenit,4026,4,8,9,3,26,16,10,33
Krasnodar,4026,5,9,4,7,30,27,3,31
Terek Grozny,4026,6,7,5,8,21,25,-4,26
Din Moscow,4026,7,5,7,8,18,23,-5,22
FK Rubin,4026,8,5,6,9,21,19,2,21
Amkar,4026,9,5,5,10,11,23,-12,20
Rostov,4026,10,4,6,10,10,19,-9,18
Anzhi,4026,11,3,5,12,16,40,-24,14
Loko Moscow,4027,1,12,5,3,31,14,17,41
Spart Moscow,4027,2,9,7,4,37,28,9,34
CSKA Moscow,4027,3,10,3,7,26,22,4,33
Zenit,4027,4,8,8,4,25,16,9,32
Krasnodar,4027,5,9,4,7,29,26,3,31
Terek Grozny,4027,6,7,6,7,23,26,-3,27
Din Moscow,4027,7,6,7,7,20,23,-3,25
FK Rubin,4027,8,6,5,9,24,19,5,23
Amkar,4027,9,5,5,10,12,24,-12,20
Rostov,4027,10,4,6,10,11,19,-8,18
Anzhi,4027,11,3,6,11,18,39,-21,15
Loko Moscow,4028,1,11,5,4,30,16,14,38
Spart Moscow,4028,2,10,6,4,36,25,11,36
CSKA Moscow,4028,3,10,5,5,26,18,8,35
Krasnodar,4028,4,10,4,6,32,24,8,34
Zenit,4028,5,8,9,3,24,15,9,33
Terek Grozny,4028,6,7,6,7,20,25,-5,27
Din Moscow,4028,7,6,7,7,18,21,-3,25
FK Rubin,4028,8,5,5,10,21,20,1,20
Amkar,4028,9,5,4,11,12,23,-11,19
Rostov,4028,10,4,6,10,10,19,-9,18
Anzhi,4028,11,2,7,11,14,37,-23,13
Loko Moscow,4029,1,11,5,4,30,14,16,38
Spart Moscow,4029,2,10,6,4,42,29,13,36
CSKA Moscow,4029,3,11,3,6,27,20,7,36
Zenit,4029,4,9,8,3,24,13,11,35
Krasnodar,4029,5,10,4,6,30,25,5,34
Terek Grozny,4029,6,9,5,6,24,23,1,32
FK Rubin,4029,7,6,5,9,23,18,5,23
Din Moscow,4029,8,5,6,9,18,27,-9,21
Rostov,4029,9,4,7,9,13,20,-7,19
Amkar,4029,10,4,4,12,10,27,-17,16
Anzhi,4029,11,2,5,13,15,40,-25,11
Loko Moscow,4030,1,11,7,2,30,12,18,40
Spart Moscow,4030,2,10,6,4,44,29,15,36
CSKA Moscow,4030,3,11,3,6,29,20,9,36
Zenit,4030,4,8,9,3,23,14,9,33
Krasnodar,4030,5,8,6,6,29,26,3,30
Terek Grozny,4030,6,7,5,8,22,27,-5,26
FK Rubin,4030,7,5,7,8,23,19,4,22
Din Moscow,4030,8,5,7,8,18,27,-9,22
Amkar,4030,9,5,5,10,13,25,-12,20
Rostov,4030,10,4,6,10,11,20,-9,18
Anzhi,4030,11,3,5,12,19,42,-23,14
Loko Moscow,4031,1,12,5,3,31,12,19,41
Spart Moscow,4031,2,10,5,5,40,29,11,35
CSKA Moscow,4031,3,10,5,5,26,18,8,35
Krasnodar,4031,4,10,4,6,30,25,5,34
Zenit,4031,5,7,9,4,22,16,6,30
Terek Grozny,4031,6,7,6,7,21,24,-3,27
Din Moscow,4031,7,5,7,8,19,25,-6,22
FK Rubin,4031,8,5,6,9,24,21,3,21
Amkar,4031,9,5,5,10,13,25,-12,20
Rostov,4031,10,4,6,10,11,20,-9,18
Anzhi,4031,11,3,6,11,15,37,-22,15
Loko Moscow,4032,1,13,5,2,32,11,21,44
CSKA Moscow,4032,2,11,4,5,30,18,12,37
Spart Moscow,4032,3,10,5,5,36,27,9,35
Terek Grozny,4032,4,8,6,6,23,22,1,30
Zenit,4032,5,7,8,5,21,18,3,29
Krasnodar,4032,6,8,4,8,28,28,0,28
FK Rubin,4032,7,7,5,8,25,19,6,26
Din Moscow,4032,8,6,6,8,20,24,-4,24
Rostov,4032,9,4,6,10,10,18,-8,18
Amkar,4032,10,4,4,12,9,26,-17,16
Anzhi,4032,11,2,7,11,15,38,-23,13
Loko Moscow,4033,1,12,6,2,33,14,19,42
CSKA Moscow,4033,2,11,4,5,31,18,13,37
Spart Moscow,4033,3,10,6,4,40,28,12,36
Krasnodar,4033,4,9,5,6,32,25,7,32
Zenit,4033,5,7,9,4,24,17,7,30
Terek Grozny,4033,6,8,6,6,23,23,0,30
Din Moscow,4033,7,5,7,8,19,25,-6,22
FK Rubin,4033,8,5,6,9,22,22,0,21
Rostov,4033,9,4,7,9,12,19,-7,19
Amkar,4033,10,4,4,12,9,26,-17,16
Anzhi,4033,11,2,6,12,15,43,-28,12
Loko Moscow,4034,1,12,6,2,31,12,19,42
Spart Moscow,4034,2,11,5,4,40,26,14,38
CSKA Moscow,4034,3,11,4,5,28,19,9,37
Zenit,4034,4,7,9,4,23,16,7,30
Krasnodar,4034,5,8,6,6,28,25,3,30
Terek Grozny,4034,6,8,6,6,23,22,1,30
FK Rubin,4034,7,5,7,8,24,20,4,22
Din Moscow,4034,8,5,7,8,19,25,-6,22
Rostov,4034,9,4,6,10,10,20,-10,18
Amkar,4034,10,4,5,11,10,24,-14,17
Anzhi,4034,11,2,5,13,15,42,-27,11
Loko Moscow,4035,1,12,5,3,31,13,18,41
Spart Moscow,4035,2,10,6,4,40,26,14,36
CSKA Moscow,4035,3,11,3,6,28,19,9,36
Krasnodar,4035,4,10,4,6,31,25,6,34
Zenit,4035,5,8,8,4,22,14,8,32
Terek Grozny,4035,6,7,6,7,21,24,-3,27
Din Moscow,4035,7,6,6,8,20,27,-7,24
FK Rubin,4035,8,5,5,10,22,22,0,20
Rostov,4035,9,4,6,10,11,19,-8,18
Amkar,4035,10,4,6,10,10,23,-13,18
Anzhi,4035,11,3,5,12,16,40,-24,14
Loko Moscow,4036,1,12,5,3,31,13,18,41
Zenit,4036,2,9,8,3,23,13,10,35
Spart Moscow,4036,3,9,6,5,37,29,8,33
CSKA Moscow,4036,4,10,3,7,27,21,6,33
Terek Grozny,4036,5,9,5,6,24,23,1,32
Krasnodar,4036,6,9,4,7,29,26,3,31
Din Moscow,4036,7,5,8,7,18,22,-4,23
FK Rubin,4036,8,5,6,9,21,18,3,21
Amkar,4036,9,5,4,11,12,25,-13,19
Rostov,4036,10,4,6,10,11,19,-8,18
Anzhi,4036,11,3,5,12,17,41,-24,14
Loko Moscow,4037,1,12,6,2,30,11,19,42
CSKA Moscow,4037,2,11,3,6,30,20,10,36
Spart Moscow,4037,3,10,5,5,38,30,8,35
Krasnodar,4037,4,9,4,7,29,25,4,31
Zenit,4037,5,7,9,4,21,16,5,30
Terek Grozny,4037,6,8,6,6,23,23,0,30
Din Moscow,4037,7,6,6,8,21,23,-2,24
Rostov,4037,8,5,6,9,12,17,-5,21
FK Rubin,4037,9,5,5,10,21,22,-1,20
Amkar,4037,10,4,4,12,11,27,-16,16
Anzhi,4037,11,3,6,11,18,40,-22,15
Loko Moscow,4038,1,12,6,2,31,11,20,42
CSKA Moscow,4038,2,11,3,6,27,19,8,36
Spart Moscow,4038,3,9,7,4,38,28,10,34
Zenit,4038,4,8,9,3,22,13,9,33
Krasnodar,4038,5,9,4,7,29,26,3,31
Terek Grozny,4038,6,7,5,8,20,24,-4,26
FK Rubin,4038,7,6,5,9,24,20,4,23
Din Moscow,4038,8,5,6,9,18,26,-8,21
Amkar,4038,9,5,5,10,12,24,-12,20
Rostov,4038,10,4,7,9,11,18,-7,19
Anzhi,4038,11,3,5,12,16,39,-23,14
Loko Moscow,4039,1,13,5,2,34,11,23,44
CSKA Moscow,4039,2,10,4,6,26,20,6,34
Spart Moscow,4039,3,9,6,5,39,28,11,33
Zenit,4039,4,8,8,4,23,16,7,32
Terek Grozny,4039,5,8,6,6,23,23,0,30
Krasnodar,4039,6,8,4,8,28,29,-1,28
Din Moscow,4039,7,6,6,8,18,25,-7,24
FK Rubin,4039,8,6,5,9,24,19,5,23
Amkar,4039,9,5,5,10,12,24,-12,20
Rostov,4039,10,4,7,9,11,18,-7,19
Anzhi,4039,11,2,6,12,15,40,-25,12
Loko Moscow,4040,1,11,6,3,30,13,17,39
CSKA Moscow,4040,2,11,3,6,28,18,10,36
Zenit,4040,3,9,8,3,23,13,10,35
Spart Moscow,4040,4,9,7,4,38,29,9,34
Krasnodar,4040,5,8,5,7,29,28,1,29
Terek Grozny,4040,6,8,5,7,23,25,-2,29
Din Moscow,4040,7,6,6,8,23,27,-4,24
FK Rubin,4040,8,6,5,9,25,20,5,23
Amkar,4040,9,5,5,10,10,22,-12,20
Rostov,4040,10,4,7,9,10,17,-7,19
Anzhi,4040,11,2,5,13,16,43,-27,11
Loko Moscow,4041,1,12,5,3,31,13,18,41
CSKA Moscow,4041,2,12,3,5,31,20,11,39
Zenit,4041,3,8,8,4,24,16,8,32
Spart Moscow,4041,4,8,7,5,37,31,6,31
Terek Grozny,4041,5,8,6,6,23,23,0,30
Krasnodar,4041,6,8,4,8,27,26,1,28
Din Moscow,4041,7,6,7,7,23,23,0,25
FK Rubin,4041,8,6,5,9,22,21,1,23
Amkar,4041,9,5,5,10,12,23,-11,20
Rostov,4041,10,4,7,9,12,19,-7,19
Anzhi,4041,11,2,5,13,16,43,-27,11
Loko Moscow,4042,1,12,5,3,31,12,19,41
CSKA Moscow,4042,2,11,4,5,28,19,9,37
Zenit,4042,3,8,8,4,22,14,8,32
Spart Moscow,4042,4,9,5,6,35,29,6,32
Krasnodar,4042,5,8,4,8,27,27,0,28
Terek Grozny,4042,6,7,7,6,22,24,-2,28
Din Moscow,4042,7,7,6,7,21,22,-1,27
FK Rubin,4042,8,6,5,9,22,19,3,23
Amkar,4042,9,5,5,10,12,23,-11,20
Rostov,4042,10,4,6,10,10,18,-8,18
Anzhi,4042,11,2,7,11,17,40,-23,13
Loko Moscow,4043,1,12,6,2,31,12,19,42
CSKA Moscow,4043,2,11,3,6,28,20,8,36
Zenit,4043,3,8,9,3,23,13,10,33
Spart Moscow,4043,4,9,5,6,35,28,7,32
Terek Grozny,4043,5,8,5,7,22,23,-1,29
Krasnodar,4043,6,8,4,8,29,28,1,28
FK Rubin,4043,7,6,6,8,26,21,5,24
Din Moscow,4043,8,5,7,8,20,25,-5,22
Rostov,4043,9,5,6,9,12,18,-6,21
Amkar,4043,10,5,4,11,10,24,-14,19
Anzhi,4043,11,3,5,12,16,40,-24,14
Loko Moscow,4044,1,11,6,3,30,13,17,39
CSKA Moscow,4044,2,12,3,5,31,20,11,39
Spart Moscow,4044,3,10,5,5,37,27,10,35
Krasnodar,4044,4,10,4,6,30,25,5,34
Zenit,4044,5,7,9,4,25,18,7,30
Terek Grozny,4044,6,8,6,6,21,22,-1,30
Din Moscow,4044,7,5,7,8,19,24,-5,22
FK Rubin,4044,8,5,6,9,23,20,3,21
Amkar,4044,9,5,5,10,10,22,-12,20
Rostov,4044,10,4,6,10,10,19,-9,18
Anzhi,4044,11,2,5,13,14,40,-26,11
Loko Moscow,4045,1,11,5,4,30,14,16,38
CSKA Moscow,4045,2,11,4,5,29,19,10,37
Zenit,4045,3,8,9,3,24,15,9,33
Spart Moscow,4045,4,9,5,6,37,30,7,32
Krasnodar,4045,5,9,5,6,30,26,4,32
Terek Grozny,4045,6,8,5,7,22,24,-2,29
FK Rubin,4045,7,6,6,8,24,19,5,24
Din Moscow,4045,8,6,6,8,18,22,-4,24
Rostov,4045,9,5,6,9,12,18,-6,21
Amkar,4045,10,5,4,11,13,26,-13,19
Anzhi,4045,11,2,5,13,15,41,-26,11
Loko Moscow,4046,1,12,5,3,32,14,18,41
Spart Moscow,4046,2,11,5,4,44,27,17,38
CSKA Moscow,4046,3,11,4,5,28,19,9,37
Zenit,4046,4,8,8,4,24,15,9,32
Krasnodar,4046,5,8,5,7,28,27,1,29
Terek Grozny,4046,6,8,5,7,21,23,-2,29
FK Rubin,4046,7,5,7,8,23,19,4,22
Din Moscow,4046,8,5,7,8,19,26,-7,22
Rostov,4046,9,4,6,10,11,22,-11,18
Amkar,4046,10,4,4,12,10,26,-16,16
Anzhi,4046,11,3,6,11,16,38,-22,15
Loko Moscow,4047,1,11,6,3,31,14,17,39
Zenit,4047,2,9,8,3,26,14,12,35
Spart Moscow,4047,3,9,6,5,35,27,8,33
CSKA Moscow,4047,4,10,3,7,26,22,4,33
Krasnodar,4047,5,9,5,6,30,26,4,32
Terek Grozny,4047,6,8,5,7,25,24,1,29
FK Rubin,4047,7,6,5,9,23,19,4,23
Din Moscow,4047,8,5,7,8,18,23,-5,22
Rostov,4047,9,5,6,9,11,17,-6,21
Amkar,4047,10,5,4,11,11,24,-13,19
Anzhi,4047,11,3,5,12,16,42,-26,14
Loko Moscow,4048,1,12,6,2,31,12,19,42
Spart Moscow,4048,2,11,5,4,43,30,13,38
CSKA Moscow,4048,3,10,4,6,25,18,7,34
Zenit,4048,4,7,10,3,22,14,8,31
Krasnodar,4048,5,9,4,7,28,25,3,31
Terek Grozny,4048,6,8,5,7,22,24,-2,29
Din Moscow,4048,7,5,7,8,21,27,-6,22
FK Rubin,4048,8,5,6,9,23,20,3,21
Amkar,4048,9,5,4,11,12,26,-14,19
Rostov,4048,10,4,6,10,12,20,-8,18
Anzhi,4048,11,3,5,12,15,38,-23,14
Loko Moscow,4049,1,11,7,2,34,16,18,40
CSKA Moscow,4049,2,12,3,5,30,18,12,39
Spart Moscow,4049,3,9,6,5,36,28,8,33
Zenit,4049,4,7,9,4,24,19,5,30
Krasnodar,4049,5,8,5,7,29,27,2,29
Terek Grozny,4049,6,8,5,7,22,24,-2,29
Din Moscow,4049,7,6,6,8,21,24,-3,24
FK Rubin,4049,8,6,5,9,23,20,3,23
Rostov,4049,9,5,6,9,12,18,-6,21
Amkar,4049,10,5,5,10,11,23,-12,20
Anzhi,4049,11,2,5,13,15,40,-25,11
Loko Moscow,4050,1,13,5,2,34,12,22,44
CSKA Moscow,4050,2,12,3,5,29,17,12,39
Spart Moscow,4050,3,8,7,5,35,30,5,31
Zenit,4050,4,7,8,5,22,17,5,29
Krasnodar,4050,5,8,4,8,28,29,-1,28
Terek Grozny,4050,6,7,6,7,23,26,-3,27
Din Moscow,4050,7,6,7,7,20,22,-2,25
FK Rubin,4050,8,6,5,9,23,20,3,23
Amkar,4050,9,5,5,10,14,24,-10,20
Rostov,4050,10,4,7,9,11,18,-7,19
Anzhi,4050,11,3,5,12,16,40,-24,14
Loko Moscow,4051,1,13,5,2,31,11,20,44
CSKA Moscow,4051,2,12,3,5,27,17,10,39
Spart Moscow,4051,3,10,6,4,37,26,11,36
Krasnodar,4051,4,9,4,7,29,25,4,31
Zenit,4051,5,7,8,5,21,15,6,29
Terek Grozny,4051,6,8,5,7,21,23,-2,29
Din Moscow,4051,7,5,8,7,19,23,-4,23
FK Rubin,4051,8,5,6,9,23,21,2,21
Amkar,4051,9,5,4,11,11,25,-14,19
Rostov,4051,10,4,6,10,10,18,-8,18
Anzhi,4051,11,2,5,13,14,39,-25,11
Loko Moscow,4052,1,13,5,2,33,12,21,44
Spart Moscow,4052,2,10,5,5,38,28,10,35
CSKA Moscow,4052,3,10,5,5,29,21,8,35
Krasnodar,4052,4,9,4,7,31,26,5,31
Zenit,4052,5,7,9,4,22,16,6,30
Terek Grozny,4052,6,7,5,8,22,27,-5,26
FK Rubin,4052,7,6,5,9,26,21,5,23
Rostov,4052,8,5,6,9,11,17,-6,21
Din Moscow,4052,9,5,6,9,20,29,-9,21
Amkar,4052,10,5,4,11,10,24,-14,19
Anzhi,4052,11,3,6,11,21,42,-21,15
Loko Moscow,4053,1,11,5,4,30,18,12,38
CSKA Moscow,4053,2,11,4,5,29,19,10,37
Spart Moscow,4053,3,10,5,5,40,27,13,35
Krasnodar,4053,4,10,4,6,34,25,9,34
Zenit,4053,5,8,9,3,24,14,10,33
Terek Grozny,4053,6,7,5,8,20,24,-4,26
Din Moscow,4053,7,5,7,8,19,27,-8,22
Amkar,4053,8,6,4,10,12,23,-11,22
FK Rubin,4053,9,5,6,9,23,21,2,21
Rostov,4053,10,4,6,10,10,19,-9,18
Anzhi,4053,11,3,5,12,16,40,-24,14
Loko Moscow,4054,1,11,5,4,29,14,15,38
CSKA Moscow,4054,2,11,4,5,27,18,9,37
Spart Moscow,4054,3,10,6,4,38,28,10,36
Zenit,4054,4,8,8,4,24,15,9,32
Krasnodar,4054,5,9,4,7,28,25,3,31
Terek Grozny,4054,6,8,6,6,21,22,-1,30
Din Moscow,4054,7,6,6,8,21,24,-3,24
FK Rubin,4054,8,6,5,9,22,19,3,23
Rostov,4054,9,4,6,10,11,19,-8,18
Amkar,4054,10,4,6,10,9,22,-13,18
Anzhi,4054,11,2,6,12,14,38,-24,12
Loko Moscow,4055,1,12,5,3,31,13,18,41
Spart Moscow,4055,2,11,5,4,41,26,15,38
CSKA Moscow,4055,3,11,3,6,28,20,8,36
Krasnodar,4055,4,10,4,6,29,24,5,34
Zenit,4055,5,7,8,5,23,18,5,29
Terek Grozny,4055,6,7,6,7,21,24,-3,27
Din Moscow,4055,7,6,6,8,19,24,-5,24
FK Rubin,4055,8,5,5,10,21,20,1,20
Amkar,4055,9,5,4,11,11,24,-13,19
Rostov,4055,10,4,6,10,10,20,-10,18
Anzhi,4055,11,3,6,11,17,38,-21,15
Loko Moscow,4056,1,11,5,4,31,16,15,38
Spart Moscow,4056,2,10,6,4,43,29,14,36
CSKA Moscow,4056,3,10,4,6,26,19,7,34
Zenit,4056,4,8,9,3,23,14,9,33
Krasnodar,4056,5,9,5,6,30,25,5,32
Terek Grozny,4056,6,8,6,6,23,23,0,30
Din Moscow,4056,7,5,8,7,19,23,-4,23
FK Rubin,4056,8,5,7,8,22,18,4,22
Rostov,4056,9,4,6,10,12,21,-9,18
Amkar,4056,10,4,5,11,11,28,-17,17
Anzhi,4056,11,3,5,12,16,40,-24,14
Loko Moscow,4057,1,12,5,3,33,13,20,41
Spart Moscow,4057,2,11,5,4,38,27,11,38
CSKA Moscow,4057,3,11,3,6,26,20,6,36
Zenit,4057,4,9,8,3,26,14,12,35
Krasnodar,4057,5,8,5,7,30,30,0,29
Terek Grozny,4057,6,7,6,7,21,26,-5,27
Din Moscow,4057,7,6,6,8,19,23,-4,24
FK Rubin,4057,8,5,6,9,24,21,3,21
Amkar,4057,9,5,4,11,13,24,-11,19
Rostov,4057,10,4,6,10,10,18,-8,18
Anzhi,4057,11,2,6,12,15,39,-24,12
Loko Moscow,4058,1,11,5,4,29,14,15,38
CSKA Moscow,4058,2,11,3,6,27,20,7,36
Spart Moscow,4058,3,10,5,5,39,26,13,35
Zenit,4058,4,9,8,3,24,13,11,35
Krasnodar,4058,5,10,4,6,30,24,6,34
Terek Grozny,4058,6,8,6,6,24,25,-1,30
Din Moscow,4058,7,6,6,8,18,23,-5,24
FK Rubin,4058,8,5,5,10,21,19,2,20
Amkar,4058,9,5,5,10,11,23,-12,20
Rostov,4058,10,4,6,10,10,21,-11,18
Anzhi,4058,11,2,5,13,17,42,-25,11
CSKA Moscow,4059,1,12,3,5,29,19,10,39
Loko Moscow,4059,2,11,5,4,30,15,15,38
Spart Moscow,4059,3,11,5,4,41,27,14,38
Zenit,4059,4,8,8,4,24,16,8,32
Krasnodar,4059,5,9,5,6,29,24,5,32
Terek Grozny,4059,6,8,6,6,22,23,-1,30
Din Moscow,4059,7,6,6,8,20,24,-4,24
FK Rubin,4059,8,5,6,9,22,19,3,21
Rostov,4059,9,4,6,10,11,20,-9,18
Amkar,4059,10,4,5,11,10,26,-16,17
Anzhi,4059,11,2,5,13,15,40,-25,11
Loko Moscow,4060,1,12,5,3,31,12,19,41
Spart Moscow,4060,2,10,6,4,38,27,11,36
Zenit,4060,3,9,8,3,23,13,10,35
CSKA Moscow,4060,4,10,3,7,27,21,6,33
Krasnodar,4060,5,9,4,7,30,28,2,31
Terek Grozny,4060,6,8,5,7,23,26,-3,29
FK Rubin,4060,7,6,5,9,25,21,4,23
Din Moscow,4060,8,5,6,9,18,24,-6,21
Amkar,4060,9,5,5,10,14,25,-11,20
Rostov,4060,10,4,6,10,11,20,-9,18
Anzhi,4060,11,3,5,12,17,40,-23,14
Loko Moscow,4061,1,11,5,4,30,15,15,38
CSKA Moscow,4061,2,10,4,6,25,18,7,34
Zenit,4061,3,8,9,3,23,13,10,33
Spart Moscow,4061,4,9,5,6,38,31,7,32
Krasnodar,4061,5,9,5,6,31,27,4,32
Terek Grozny,4061,6,8,6,6,24,23,1,30
Din Moscow,4061,7,6,7,7,19,22,-3,25
FK Rubin,4061,8,5,7,8,23,19,4,22
Amkar,4061,9,5,5,10,14,24,-10,20
Rostov,4061,10,4,6,10,10,20,-10,18
Anzhi,4061,11,3,5,12,15,40,-25,14
Loko Moscow,4062,1,11,6,3,30,13,17,39
CSKA Moscow,4062,2,11,3,6,27,18,9,36
Spart Moscow,4062,3,10,5,5,39,29,10,35
Zenit,4062,4,9,8,3,23,13,10,35
Terek Grozny,4062,5,9,5,6,24,24,0,32
Krasnodar,4062,6,8,6,6,28,25,3,30
Din Moscow,4062,7,7,6,7,22,24,-2,27
FK Rubin,4062,8,5,6,9,21,18,3,21
Rostov,4062,9,4,6,10,10,19,-9,18
Amkar,4062,10,4,4,12,9,24,-15,16
Anzhi,4062,11,2,5,13,16,42,-26,11
Loko Moscow,4063,1,11,5,4,31,15,16,38
Spart Moscow,4063,2,10,6,4,38,27,11,36
Zenit,4063,3,9,8,3,24,14,10,35
CSKA Moscow,4063,4,10,3,7,25,20,5,33
Krasnodar,4063,5,9,4,7,29,28,1,31
Terek Grozny,4063,6,7,5,8,20,25,-5,26
Din Moscow,4063,7,6,6,8,18,22,-4,24
FK Rubin,4063,8,6,5,9,24,18,6,23
Rostov,4063,9,4,7,9,11,18,-7,19
Amkar,4063,10,5,4,11,12,25,-13,19
Anzhi,4063,11,4,5,11,17,37,-20,17
Loko Moscow,4064,1,12,6,2,31,12,19,42
CSKA Moscow,4064,2,12,3,5,31,17,14,39
Spart Moscow,4064,3,10,6,4,37,27,10,36
Krasnodar,4064,4,9,5,6,30,25,5,32
Terek Grozny,4064,5,8,6,6,26,26,0,30
Zenit,4064,6,7,8,5,21,16,5,29
Din Moscow,4064,7,6,6,8,19,23,-4,24
FK Rubin,4064,8,5,5,10,22,21,1,20
Rostov,4064,9,4,7,9,10,17,-7,19
Amkar,4064,10,4,5,11,13,27,-14,17
Anzhi,4064,11,2,5,13,16,45,-29,11
Loko Moscow,4065,1,11,6,3,31,14,17,39
CSKA Moscow,4065,2,11,4,5,29,19,10,37
Spart Moscow,4065,3,10,6,4,37,26,11,36
Krasnodar,4065,4,9,5,6,30,26,4,32
Zenit,4065,5,7,10,3,24,16,8,31
Terek Grozny,4065,6,8,6,6,22,23,-1,30
Din Moscow,4065,7,5,8,7,18,22,-4,23
FK Rubin,4065,8,5,7,8,22,18,4,22
Rostov,4065,9,4,6,10,10,18,-8,18
Amkar,4065,10,4,4,12,10,26,-16,16
Anzhi,4065,11,2,6,12,14,39,-25,12
Loko Moscow,4066,1,12,5,3,33,15,18,41
CSKA Moscow,4066,2,11,4,5,30,20,10,37
Spart Moscow,4066,3,10,5,5,38,29,9,35
Krasnodar,4066,4,10,4,6,34,26,8,34
Zenit,4066,5,7,9,4,24,18,6,30
Terek Grozny,4066,6,8,6,6,23,22,1,30
Din Moscow,4066,7,6,6,8,18,23,-5,24
FK Rubin,4066,8,6,5,9,24,21,3,23
Rostov,4066,9,4,6,10,10,18,-8,18
Amkar,4066,10,4,5,11,12,26,-14,17
Anzhi,4066,11,2,5,13,15,43,-28,11
CSKA Moscow,4067,1,12,3,5,29,18,11,39
Loko Moscow,4067,2,11,5,4,29,15,14,38
Spart Moscow,4067,3,9,7,4,38,27,11,34
Zenit,4067,4,8,8,4,24,15,9,32
Krasnodar,4067,5,9,4,7,29,25,4,31
Terek Grozny,4067,6,7,6,7,23,26,-3,27
FK Rubin,4067,7,6,6,8,24,19,5,24
Din Moscow,4067,8,5,8,7,20,24,-4,23
Amkar,4067,9,5,5,10,12,24,-12,20
Rostov,4067,10,4,6,10,10,20,-10,18
Anzhi,4067,11,2,6,12,16,41,-25,12
Loko Moscow,4068,1,12,6,2,30,11,19,42
CSKA Moscow,4068,2,11,4,5,28,18,10,37
Spart Moscow,4068,3,9,7,4,38,29,9,34
Zenit,4068,4,7,9,4,22,15,7,30
Krasnodar,4068,5,8,5,7,27,25,2,29
Terek Grozny,4068,6,7,7,6,20,22,-2,28
Din Moscow,4068,7,6,6,8,21,24,-3,24
FK Rubin,4068,8,6,5,9,23,20,3,23
Rostov,4068,9,4,7,9,11,18,-7,19
Amkar,4068,10,4,6,10,11,24,-13,18
Anzhi,4068,11,2,6,12,14,39,-25,12
Loko Moscow,4069,1,12,6,2,33,12,21,42
Spart Moscow,4069,2,10,6,4,38,27,11,36
CSKA Moscow,4069,3,11,3,6,26,20,6,36
Zenit,4069,4,8,9,3,25,14,11,33
Krasnodar,4069,5,8,5,7,27,27,0,29
Terek Grozny,4069,6,7,5,8,20,24,-4,26
FK Rubin,4069,7,5,7,8,22,18,4,22
Din Moscow,4069,8,5,7,8,18,24,-6,22
Amkar,4069,9,5,5,10,12,24,-12,20
Rostov,4069,10,4,6,10,10,18,-8,18
Anzhi,4069,11,3,5,12,15,38,-23,14
Loko Moscow,4070,1,11,6,3,30,13,17,39
CSKA Moscow,4070,2,11,3,6,26,18,8,36
Spart Moscow,4070,3,9,7,4,39,30,9,34
Krasnodar,4070,4,10,4,6,34,25,9,34
Zenit,4070,5,7,9,4,21,14,7,30
Terek Grozny,4070,6,7,5,8,22,26,-4,26
Din Moscow,4070,7,6,6,8,22,25,-3,24
FK Rubin,4070,8,5,5,10,21,24,-3,20
Amkar,4070,9,5,5,10,12,24,-12,20
Rostov,4070,10,4,7,9,10,17,-7,19
Anzhi,4070,11,4,5,11,18,39,-21,17
CSKA Moscow,4071,1,12,3,5,29,18,11,39
Loko Moscow,4071,2,11,5,4,30,15,15,38
Zenit,4071,3,8,8,4,24,16,8,32
Spart Moscow,4071,4,9,5,6,38,31,7,32
Krasnodar,4071,5,9,4,7,30,26,4,31
Terek Grozny,4071,6,7,6,7,20,24,-4,27
Din Moscow,4071,7,6,6,8,18,23,-5,24
FK Rubin,4071,8,6,5,9,23,19,4,23
Amkar,4071,9,6,4,10,15,24,-9,22
Rostov,4071,10,5,6,9,12,18,-6,21
Anzhi,4071,11,2,6,12,14,39,-25,12
Loko Moscow,4072,1,12,5,3,32,12,20,41
CSKA Moscow,4072,2,11,4,5,28,19,9,37
Spart Moscow,4072,3,10,5,5,42,29,13,35
Krasnodar,4072,4,9,4,7,28,25,3,31
Zenit,4072,5,7,8,5,22,18,4,29
Terek Grozny,4072,6,8,5,7,24,23,1,29
FK Rubin,4072,7,7,5,8,25,17,8,26
Din Moscow,4072,8,6,6,8,20,25,-5,24
Amkar,4072,9,5,4,11,10,24,-14,19
Rostov,4072,10,4,6,10,11,23,-12,18
Anzhi,4072,11,2,6,12,15,42,-27,12
Loko Moscow,4073,1,11,6,3,31,15,16,39
CSKA Moscow,4073,2,11,3,6,28,20,8,36
Zenit,4073,3,9,8,3,26,13,13,35
Spart Moscow,4073,4,10,5,5,38,28,10,35
Krasnodar,4073,5,8,6,6,30,27,3,30
Terek Grozny,4073,6,8,5,7,22,24,-2,29
Din Moscow,4073,7,6,6,8,19,22,-3,24
FK Rubin,4073,8,5,6,9,22,20,2,21
Rostov,4073,9,5,6,9,11,17,-6,21
Amkar,4073,10,5,4,11,12,26,-14,19
Anzhi,4073,11,2,5,13,15,42,-27,11
Loko Moscow,4074,1,12,5,3,31,13,18,41
CSKA Moscow,4074,2,11,4,5,29,17,12,37
Spart Moscow,4074,3,10,5,5,39,29,10,35
Zenit,4074,4,8,9,3,22,13,9,33
Terek Grozny,4074,5,8,5,7,22,25,-3,29
Krasnodar,4074,6,8,4,8,28,28,0,28
Din Moscow,4074,7,6,6,8,18,23,-5,24
FK Rubin,4074,8,6,5,9,23,18,5,23
Rostov,4074,9,5,6,9,12,18,-6,21
Amkar,4074,10,5,4,11,13,25,-12,19
Anzhi,4074,11,2,5,13,15,43,-28,11
Loko Moscow,4075,1,12,6,2,33,13,20,42
Spart Moscow,4075,2,11,5,4,44,30,14,38
CSKA Moscow,4075,3,11,4,5,29,19,10,37
Terek Grozny,4075,4,9,5,6,24,24,0,32
Zenit,4075,5,7,10,3,24,16,8,31
Krasnodar,4075,6,8,5,7,28,27,1,29
FK Rubin,4075,7,5,7,8,21,17,4,22
Din Moscow,4075,8,5,7,8,18,25,-7,22
Rostov,4075,9,4,6,10,12,21,-9,18
Amkar,4075,10,4,4,12,12,27,-15,16
Anzhi,4075,11,2,5,13,15,41,-26,11
Loko Moscow,4076,1,13,5,2,34,13,21,44
Spart Moscow,4076,2,10,6,4,38,26,12,36
CSKA Moscow,4076,3,10,4,6,27,21,6,34
Zenit,4076,4,8,8,4,24,16,8,32
Krasnodar,4076,5,9,4,7,30,27,3,31
Terek Grozny,4076,6,7,6,7,21,24,-3,27
FK Rubin,4076,7,6,5,9,25,19,6,23
Din Moscow,4076,8,5,7,8,17,24,-7,22
Amkar,4076,9,5,4,11,11,25,-14,19
Rostov,4076,10,4,6,10,10,19,-9,18
Anzhi,4076,11,2,7,11,17,40,-23,13
Loko Moscow,4077,1,12,5,3,34,15,19,41
CSKA Moscow,4077,2,10,4,6,26,20,6,34
Spart Moscow,4077,3,9,5,6,36,30,6,32
Krasnodar,4077,4,9,4,7,29,26,3,31
Zenit,4077,5,7,9,4,24,18,6,30
Terek Grozny,4077,6,8,6,6,22,23,-1,30
FK Rubin,4077,7,7,5,8,23,17,6,26
Din Moscow,4077,8,6,6,8,18,22,-4,24
Amkar,4077,9,5,5,10,12,23,-11,20
Rostov,4077,10,4,6,10,11,19,-8,18
Anzhi,4077,11,3,5,12,17,39,-22,14
Loko Moscow,4078,1,11,7,2,31,13,18,40
CSKA Moscow,4078,2,11,3,6,29,21,8,36
Spart Moscow,4078,3,10,5,5,40,29,11,35
Terek Grozny,4078,4,9,5,6,23,23,0,32
Zenit,4078,5,7,9,4,24,18,6,30
Krasnodar,4078,6,8,6,6,29,26,3,30
FK Rubin,4078,7,6,6,8,23,18,5,24
Din Moscow,4078,8,6,6,8,21,22,-1,24
Rostov,4078,9,4,6,10,10,20,-10,18
Amkar,4078,10,4,4,12,10,28,-18,16
Anzhi,4078,11,3,5,12,16,38,-22,14
Loko Moscow,4079,1,12,6,2,31,12,19,42
CSKA Moscow,4079,2,12,3,5,31,18,13,39
Spart Moscow,4079,3,9,6,5,35,27,8,33
Krasnodar,4079,4,8,6,6,29,26,3,30
Terek Grozny,4079,5,8,6,6,22,23,-1,30
Zenit,4079,6,7,8,5,22,16,6,29
Din Moscow,4079,7,5,8,7,17,21,-4,23
FK Rubin,4079,8,5,7,8,22,18,4,22
Amkar,4079,9,5,5,10,11,23,-12,20
Rostov,4079,10,4,6,10,10,18,-8,18
Anzhi,4079,11,2,5,13,15,43,-28,11
Loko Moscow,4080,1,11,6,3,30,13,17,39
CSKA Moscow,4080,2,10,5,5,27,19,8,35
Zenit,4080,3,8,9,3,23,14,9,33
Spart Moscow,4080,4,9,6,5,34,26,8,33
Terek Grozny,4080,5,9,5,6,23,23,0,32
Krasnodar,4080,6,8,5,7,29,27,2,29
FK Rubin,4080,7,7,5,8,24,18,6,26
Din Moscow,4080,8,6,6,8,18,22,-4,24
Rostov,4080,9,4,6,10,10,18,-8,18
Amkar,4080,10,4,5,11,9,23,-14,17
Anzhi,4080,11,2,6,12,16,40,-24,12
Loko Moscow,4081,1,12,6,2,32,13,19,42
CSKA Moscow,4081,2,11,3,6,26,19,7,36
Zenit,4081,3,8,8,4,24,15,9,32
Terek Grozny,4081,4,9,5,6,22,22,0,32
Krasnodar,4081,5,8,6,6,29,26,3,30
Spart Moscow,4081,6,8,5,7,33,32,1,29
Din Moscow,4081,7,7,6,7,20,21,-1,27
FK Rubin,4081,8,5,6,9,22,19,3,21
Rostov,4081,9,5,6,9,12,17,-5,21
Amkar,4081,10,5,4,11,12,23,-11,19
Anzhi,4081,11,2,5,13,14,39,-25,11
Loko Moscow,4082,1,12,6,2,30,11,19,42
CSKA Moscow,4082,2,12,3,5,33,18,15,39
Spart Moscow,4082,3,9,5,6,38,30,8,32
Krasnodar,4082,4,9,4,7,29,26,3,31
Zenit,4082,5,7,9,4,21,14,7,30
Din Moscow,4082,6,7,6,7,20,22,-2,27
Terek Grozny,4082,7,7,6,7,21,25,-4,27
FK Rubin,4082,8,5,5,10,22,20,2,20
Amkar,4082,9,5,5,10,12,24,-12,20
Rostov,4082,10,4,6,10,11,20,-9,18
Anzhi,4082,11,3,5,12,17,44,-27,14
Loko Moscow,4083,1,11,6,3,29,13,16,39
CSKA Moscow,4083,2,11,4,5,32,20,12,37
Spart Moscow,4083,3,10,5,5,37,27,10,35
Zenit,4083,4,8,9,3,25,15,10,33
Krasnodar,4083,5,9,5,6,28,24,4,32
Terek Grozny,4083,6,7,7,6,23,25,-2,28
Din Moscow,4083,7,5,7,8,18,25,-7,22
FK Rubin,4083,8,5,6,9,22,19,3,21
Rostov,4083,9,5,6,9,12,17,-5,21
Amkar,4083,10,4,5,11,11,25,-14,17
Anzhi,4083,11,2,6,12,16,43,-27,12
CSKA Moscow,4084,1,12,3,5,29,17,12,39
Loko Moscow,4084,2,11,5,4,31,15,16,38
Spart Moscow,4084,3,10,5,5,37,28,9,35
Zenit,4084,4,8,8,4,23,15,8,32
Krasnodar,4084,5,9,5,6,30,26,4,32
Terek Grozny,4084,6,7,6,7,20,26,-6,27
FK Rubin,4084,7,6,6,8,24,19,5,24
Din Moscow,4084,8,6,6,8,20,23,-3,24
Amkar,4084,9,5,4,11,14,24,-10,19
Rostov,4084,10,4,6,10,10,19,-9,18
Anzhi,4084,11,2,6,12,14,40,-26,12
Loko Moscow,4085,1,12,5,3,30,13,17,41
CSKA Moscow,4085,2,11,3,6,31,19,12,36
Zenit,4085,3,9,8,3,24,13,11,35
Spart Moscow,4085,4,9,7,4,39,28,11,34
Krasnodar,4085,5,9,4,7,29,26,3,31
Terek Grozny,4085,6,7,7,6,21,23,-2,28
FK Rubin,4085,7,6,5,9,23,19,4,23
Din Moscow,4085,8,5,7,8,17,22,-5,22
Rostov,4085,9,4,7,9,13,20,-7,19
Amkar,4085,10,4,5,11,9,25,-16,17
Anzhi,4085,11,2,6,12,16,44,-28,12
Loko Moscow,4086,1,11,6,3,33,17,16,39
CSKA Moscow,4086,2,11,3,6,27,19,8,36
Spart Moscow,4086,3,10,5,5,40,28,12,35
Zenit,4086,4,8,8,4,25,16,9,32
Krasnodar,4086,5,9,5,6,33,26,7,32
Terek Grozny,4086,6,7,6,7,22,26,-4,27
Din Moscow,4086,7,5,7,8,18,25,-7,22
FK Rubin,4086,8,5,6,9,21,21,0,21
Amkar,4086,9,5,5,10,12,24,-12,20
Rostov,4086,10,4,6,10,10,19,-9,18
Anzhi,4086,11,4,5,11,19,39,-20,17
Loko Moscow,4087,1,11,5,4,30,16,14,38
CSKA Moscow,4087,2,11,3,6,26,19,7,36
Spart Moscow,4087,3,10,5,5,36,28,8,35
Zenit,4087,4,8,8,4,24,15,9,32
Krasnodar,4087,5,9,4,7,29,25,4,31
Terek Grozny,4087,6,8,5,7,23,25,-2,29
FK Rubin,4087,7,7,5,8,23,17,6,26
Din Moscow,4087,8,6,6,8,20,22,-2,24
Rostov,4087,9,4,6,10,10,19,-9,18
Anzhi,4087,10,4,5,11,18,37,-19,17
Amkar,4087,11,4,4,12,10,26,-16,16
Loko Moscow,4088,1,11,7,2,32,14,18,40
Zenit,4088,2,8,9,3,24,15,9,33
CSKA Moscow,4088,3,10,3,7,25,19,6,33
Krasnodar,4088,4,9,5,6,29,25,4,32
Spart Moscow,4088,5,8,7,5,34,27,7,31
Terek Grozny,4088,6,8,6,6,22,23,-1,30
Din Moscow,4088,7,6,7,7,20,23,-3,25
FK Rubin,4088,8,5,5,10,23,21,2,20
Amkar,4088,9,5,5,10,11,23,-12,20
Rostov,4088,10,4,7,9,11,18,-7,19
Anzhi,4088,11,3,5,12,15,38,-23,14
Loko Moscow,4089,1,12,6,2,34,14,20,42
CSKA Moscow,4089,2,10,3,7,25,21,4,33
Zenit,4089,3,8,8,4,25,16,9,32
Spart Moscow,4089,4,8,7,5,36,29,7,31
Krasnodar,4089,5,8,5,7,29,28,1,29
Terek Grozny,4089,6,8,5,7,23,25,-2,29
FK Rubin,4089,7,7,5,8,25,17,8,26
Din Moscow,4089,8,6,6,8,19,24,-5,24
Amkar,4089,9,5,5,10,13,25,-12,20
Rostov,4089,10,4,7,9,11,18,-7,19
Anzhi,4089,11,3,5,12,15,38,-23,14
Loko Moscow,4090,1,11,5,4,29,14,15,38
CSKA Moscow,4090,2,11,3,6,28,20,8,36
Spart Moscow,4090,3,10,5,5,39,28,11,35
Zenit,4090,4,9,8,3,24,13,11,35
Krasnodar,4090,5,9,5,6,30,25,5,32
Terek Grozny,4090,6,8,5,7,22,24,-2,29
FK Rubin,4090,7,5,7,8,23,19,4,22
Din Moscow,4090,8,5,7,8,19,25,-6,22
Amkar,4090,9,6,4,10,12,23,-11,22
Rostov,4090,10,4,6,10,10,19,-9,18
Anzhi,4090,11,2,5,13,16,42,-26,11
Loko Moscow,4091,1,12,6,2,32,13,19,42
CSKA Moscow,4091,2,11,4,5,28,18,10,37
Spart Moscow,4091,3,10,6,4,35,25,10,36
Zenit,4091,4,7,9,4,22,15,7,30
Krasnodar,4091,5,8,6,6,30,27,3,30
Terek Grozny,4091,6,8,5,7,23,25,-2,29
Din Moscow,4091,7,5,8,7,17,21,-4,23
FK Rubin,4091,8,5,7,8,22,18,4,22
Amkar,4091,9,5,4,11,11,24,-13,19
Rostov,4091,10,4,6,10,10,18,-8,18
Anzhi,4091,11,2,5,13,15,41,-26,11
Loko Moscow,4092,1,12,5,3,31,15,16,41
CSKA Moscow,4092,2,11,4,5,28,18,10,37
Spart Moscow,4092,3,9,6,5,36,29,7,33
Krasnodar,4092,4,9,5,6,31,25,6,32
Zenit,4092,5,7,9,4,23,16,7,30
Terek Grozny,4092,6,7,7,6,20,22,-2,28
Din Moscow,4092,7,5,8,7,18,22,-4,23
FK Rubin,4092,8,5,7,8,23,19,4,22
Rostov,4092,9,5,6,9,14,18,-4,21
Amkar,4092,10,4,5,11,9,24,-15,17
Anzhi,4092,11,2,6,12,14,39,-25,12
Loko Moscow,4093,1,11,7,2,29,11,18,40
CSKA Moscow,4093,2,12,3,5,31,19,12,39
Spart Moscow,4093,3,9,6,5,37,29,8,33
Krasnodar,4093,4,9,5,6,30,24,6,32
Zenit,4093,5,7,9,4,23,16,7,30
Terek Grozny,4093,6,8,6,6,24,23,1,30
Din Moscow,4093,7,6,7,7,21,24,-3,25
FK Rubin,4093,8,5,5,10,23,23,0,20
Amkar,4093,9,5,5,10,13,25,-12,20
Rostov,4093,10,4,6,10,10,18,-8,18
Anzhi,4093,11,2,5,13,14,43,-29,11
Loko Moscow,4094,1,11,6,3,29,14,15,39
Spart Moscow,4094,2,10,6,4,35,25,10,36
CSKA Moscow,4094,3,11,3,6,28,19,9,36
Zenit,4094,4,8,9,3,23,14,9,33
Krasnodar,4094,5,9,4,7,31,26,5,31
Terek Grozny,4094,6,7,6,7,22,26,-4,27
Din Moscow,4094,7,6,7,7,18,21,-3,25
FK Rubin,4094,8,6,5,9,23,19,4,23
Rostov,4094,9,4,6,10,10,18,-8,18
Amkar,4094,10,4,5,11,10,24,-14,17
Anzhi,4094,11,3,5,12,17,40,-23,14
Loko Moscow,4095,1,11,7,2,31,13,18,40
CSKA Moscow,4095,2,10,4,6,26,19,7,34
Zenit,4095,3,8,9,3,24,15,9,33
Spart Moscow,4095,4,9,6,5,37,29,8,33
Krasnodar,4095,5,8,6,6,28,25,3,30
Terek Grozny,4095,6,8,5,7,24,24,0,29
Din Moscow,4095,7,5,8,7,20,24,-4,23
FK Rubin,4095,8,5,7,8,24,20,4,22
Rostov,4095,9,5,6,9,12,18,-6,21
Amkar,4095,10,5,4,11,11,24,-13,19
Anzhi,4095,11,2,6,12,16,42,-26,12
Loko Moscow,4096,1,12,6,2,33,13,20,42
Spart Moscow,4096,2,10,6,4,37,26,11,36
CSKA Moscow,4096,3,11,3,6,27,18,9,36
Zenit,4096,4,8,9,3,24,15,9,33
Krasnodar,4096,5,8,5,7,28,27,1,29
Terek Grozny,4096,6,7,6,7,21,24,-3,27
Din Moscow,4096,7,6,6,8,21,25,-4,24
FK Rubin,4096,8,5,6,9,24,21,3,21
Rostov,4096,9,4,7,9,10,17,-7,19
Amkar,4096,10,4,5,11,9,24,-15,17
Anzhi,4096,11,3,5,12,16,40,-24,14
Loko Moscow,4097,1,12,5,3,32,13,19,41
CSKA Moscow,4097,2,11,3,6,27,19,8,36
Zenit,4097,3,9,8,3,24,13,11,35
Spart Moscow,4097,4,9,6,5,37,29,8,33
Krasnodar,4097,5,8,4,8,27,28,-1,28
Terek Grozny,4097,6,7,6,7,21,25,-4,27
Din Moscow,4097,7,6,6,8,18,23,-5,24
FK Rubin,4097,8,6,5,9,22,18,4,23
Amkar,4097,9,5,5,10,12,23,-11,20
Rostov,4097,10,4,7,9,11,18,-7,19
Anzhi,4097,11,3,5,12,18,40,-22,14
Loko Moscow,4098,1,13,5,2,36,12,24,44
Spart Moscow,4098,2,10,6,4,39,29,10,36
CSKA Moscow,4098,3,10,4,6,26,19,7,34
Zenit,4098,4,8,8,4,23,16,7,32
Terek Grozny,4098,5,8,6,6,22,23,-1,30
Krasnodar,4098,6,8,5,7,29,30,-1,29
FK Rubin,4098,7,5,7,8,24,20,4,22
Din Moscow,4098,8,5,7,8,20,25,-5,22
Rostov,4098,9,4,7,9,11,18,-7,19
Amkar,4098,10,4,5,11,11,25,-14,17
Anzhi,4098,11,2,6,12,15,39,-24,12
CSKA Moscow,4099,1,12,3,5,30,17,13,39
Loko Moscow,4099,2,11,5,4,30,17,13,38
Spart Moscow,4099,3,10,5,5,41,30,11,35
Zenit,4099,4,8,8,4,24,15,9,32
Krasnodar,4099,5,9,5,6,31,26,5,32
Terek Grozny,4099,6,8,5,7,22,25,-3,29
FK Rubin,4099,7,6,6,8,25,19,6,24
Amkar,4099,8,6,4,10,15,24,-9,22
Din Moscow,4099,9,5,6,9,19,26,-7,21
Rostov,4099,10,4,6,10,10,21,-11,18
Anzhi,4099,11,2,5,13,15,42,-27,11
Loko Moscow,4100,1,12,5,3,31,13,18,41
CSKA Moscow,4100,2,11,3,6,28,19,9,36
Zenit,4100,3,9,8,3,25,14,11,35
Spart Moscow,4100,4,9,7,4,38,27,11,34
Terek Grozny,4100,5,9,5,6,25,22,3,32
Krasnodar,4100,6,8,4,8,27,26,1,28
FK Rubin,4100,7,7,5,8,25,18,7,26
Din Moscow,4100,8,5,7,8,19,25,-6,22
Rostov,4100,9,4,6,10,10,20,-10,18
Amkar,4100,10,4,5,11,10,25,-15,17
Anzhi,4100,11,2,5,13,14,43,-29,11
Loko Moscow,4101,1,13,5,2,33,11,22,44
CSKA Moscow,4101,2,12,3,5,29,18,11,39
Spart Moscow,4101,3,10,6,4,37,26,11,36
Zenit,4101,4,7,8,5,21,16,5,29
Krasnodar,4101,5,8,5,7,27,26,1,29
Terek Grozny,4101,6,7,6,7,21,25,-4,27
FK Rubin,4101,7,6,6,8,22,17,5,24
Din Moscow,4101,8,5,6,9,17,24,-7,21
Rostov,4101,9,4,6,10,10,18,-8,18
Amkar,4101,10,4,6,10,11,24,-13,18
Anzhi,4101,11,3,5,12,17,40,-23,14
Loko Moscow,4102,1,11,6,3,30,13,17,39
Spart Moscow,4102,2,10,6,4,40,28,12,36
Zenit,4102,3,8,9,3,23,13,10,33
CSKA Moscow,4102,4,10,3,7,26,22,4,33
Krasnodar,4102,5,9,4,7,30,29,1,31
Terek Grozny,4102,6,8,5,7,21,24,-3,29
FK Rubin,4102,7,6,6,8,27,20,7,24
Din Moscow,4102,8,5,7,8,21,27,-6,22
Amkar,4102,9,5,5,10,12,23,-11,20
Rostov,4102,10,4,6,10,10,19,-9,18
Anzhi,4102,11,3,5,12,17,39,-22,14
Loko Moscow,4103,1,11,5,4,31,18,13,38
CSKA Moscow,4103,2,11,3,6,28,20,8,36
Zenit,4103,3,9,8,3,29,15,14,35
Spart Moscow,4103,4,9,7,4,39,30,9,34
Krasnodar,4103,5,9,4,7,30,29,1,31
Terek Grozny,4103,6,8,6,6,22,23,-1,30
FK Rubin,4103,7,6,6,8,25,18,7,24
Din Moscow,4103,8,5,7,8,17,22,-5,22
Rostov,4103,9,4,7,9,13,20,-7,19
Amkar,4103,10,4,5,11,12,26,-14,17
Anzhi,4103,11,2,6,12,14,39,-25,12
Loko Moscow,4104,1,11,5,4,30,14,16,38
CSKA Moscow,4104,2,11,3,6,27,18,9,36
Zenit,4104,3,9,8,3,24,14,10,35
Spart Moscow,4104,4,10,5,5,36,27,9,35
Krasnodar,4104,5,9,4,7,28,27,1,31
FK Rubin,4104,6,7,5,8,27,18,9,26
Terek Grozny,4104,7,7,5,8,21,26,-5,26
Din Moscow,4104,8,6,6,8,19,24,-5,24
Amkar,4104,9,5,4,11,11,24,-13,19
Rostov,4104,10,4,6,10,10,18,-8,18
Anzhi,4104,11,3,5,12,17,40,-23,14
Loko Moscow,4105,1,11,5,4,31,17,14,38
CSKA Moscow,4105,2,10,4,6,26,19,7,34
Zenit,4105,3,8,9,3,23,14,9,33
Krasnodar,4105,4,9,5,6,33,27,6,32
Terek Grozny,4105,5,9,5,6,22,22,0,32
Spart Moscow,4105,6,8,7,5,34,27,7,31
Din Moscow,4105,7,5,8,7,18,22,-4,23
FK Rubin,4105,8,5,7,8,23,19,4,22
Rostov,4105,9,4,7,9,10,17,-7,19
Amkar,4105,10,5,4,11,10,23,-13,19
Anzhi,4105,11,3,5,12,16,39,-23,14
Loko Moscow,4106,1,11,5,4,30,15,15,38
CSKA Moscow,4106,2,11,3,6,28,18,10,36
Zenit,4106,3,9,8,3,24,14,10,35
Krasnodar,4106,4,9,5,6,31,26,5,32
Terek Grozny,4106,5,9,5,6,24,22,2,32
Spart Moscow,4106,6,8,5,7,36,32,4,29
FK Rubin,4106,7,6,6,8,25,20,5,24
Din Moscow,4106,8,6,6,8,20,23,-3,24
Rostov,4106,9,5,6,9,13,19,-6,21
Amkar,4106,10,5,4,11,11,25,-14,19
Anzhi,4106,11,2,5,13,14,42,-28,11
Loko Moscow,4107,1,12,5,3,32,13,19,41
CSKA Moscow,4107,2,11,4,5,28,18,10,37
Spart Moscow,4107,3,9,6,5,36,27,9,33
Krasnodar,4107,4,9,5,6,30,26,4,32
Zenit,4107,5,7,9,4,23,17,6,30
Terek Grozny,4107,6,7,6,7,20,23,-3,27
Din Moscow,4107,7,6,7,7,20,22,-2,25
Amkar,4107,8,6,4,10,11,22,-11,22
FK Rubin,4107,9,5,6,9,23,21,2,21
Rostov,4107,10,4,6,10,10,19,-9,18
Anzhi,4107,11,2,6,12,14,39,-25,12
Loko Moscow,4108,1,12,5,3,32,14,18,41
CSKA Moscow,4108,2,11,3,6,29,21,8,36
Spart Moscow,4108,3,9,5,6,37,29,8,32
Zenit,4108,4,8,8,4,25,17,8,32
Krasnodar,4108,5,9,4,7,28,25,3,31
Terek Grozny,4108,6,8,5,7,23,27,-4,29
Din Moscow,4108,7,6,7,7,20,23,-3,25
FK Rubin,4108,8,6,6,8,24,19,5,24
Rostov,4108,9,5,6,9,12,18,-6,21
Amkar,4108,10,4,4,12,11,28,-17,16
Anzhi,4108,11,3,5,12,20,40,-20,14
Loko Moscow,4109,1,12,6,2,32,13,19,42
CSKA Moscow,4109,2,11,3,6,30,20,10,36
Krasnodar,4109,3,9,5,6,30,25,5,32
Spart Moscow,4109,4,8,6,6,33,29,4,30
Zenit,4109,5,7,8,5,23,20,3,29
Terek Grozny,4109,6,7,5,8,20,27,-7,26
Din Moscow,4109,7,6,6,8,20,22,-2,24
FK Rubin,4109,8,6,5,9,22,19,3,23
Rostov,4109,9,5,6,9,11,17,-6,21
Amkar,4109,10,5,5,10,13,22,-9,20
Anzhi,4109,11,4,5,11,17,37,-20,17
Loko Moscow,4110,1,12,6,2,31,12,19,42
CSKA Moscow,4110,2,11,3,6,28,18,10,36
Spart Moscow,4110,3,9,6,5,36,28,8,33
Zenit,4110,4,8,8,4,22,14,8,32
Krasnodar,4110,5,8,6,6,29,26,3,30
Terek Grozny,4110,6,7,6,7,21,24,-3,27
FK Rubin,4110,7,5,7,8,23,19,4,22
Din Moscow,4110,8,5,7,8,18,23,-5,22
Amkar,4110,9,6,4,10,11,22,-11,22
Rostov,4110,10,4,7,9,12,19,-7,19
Anzhi,4110,11,2,6,12,15,41,-26,12
Loko Moscow,4111,1,12,6,2,31,12,19,42
Spart Moscow,4111,2,10,5,5,40,29,11,35
Zenit,4111,3,8,9,3,24,15,9,33
CSKA Moscow,4111,4,10,3,7,27,22,5,33
Krasnodar,4111,5,8,5,7,27,25,2,29
Terek Grozny,4111,6,8,5,7,26,25,1,29
Din Moscow,4111,7,7,6,7,19,21,-2,27
FK Rubin,4111,8,5,6,9,21,18,3,21
Rostov,4111,9,4,6,10,11,20,-9,18
Anzhi,4111,10,4,5,11,19,39,-20,17
Amkar,4111,11,4,4,12,12,31,-19,16
Loko Moscow,4112,1,11,6,3,30,13,17,39
CSKA Moscow,4112,2,10,4,6,27,21,6,34
Spart Moscow,4112,3,9,6,5,37,28,9,33
Zenit,4112,4,8,9,3,25,16,9,33
Krasnodar,4112,5,8,5,7,28,26,2,29
Terek Grozny,4112,6,8,5,7,24,24,0,29
Din Moscow,4112,7,6,7,7,19,22,-3,25
FK Rubin,4112,8,6,6,8,23,18,5,24
Rostov,4112,9,4,6,10,10,19,-9,18
Amkar,4112,10,4,5,11,10,27,-17,17
Anzhi,4112,11,4,5,11,18,37,-19,17
Loko Moscow,4113,1,12,6,2,31,11,20,42
CSKA Moscow,4113,2,12,3,5,29,17,12,39
Spart Moscow,4113,3,9,7,4,37,28,9,34
Zenit,4113,4,7,9,4,21,14,7,30
Krasnodar,4113,5,8,5,7,28,27,1,29
Terek Grozny,4113,6,8,5,7,22,23,-1,29
Din Moscow,4113,7,5,8,7,20,24,-4,23
FK Rubin,4113,8,5,7,8,23,19,4,22
Rostov,4113,9,4,7,9,11,18,-7,19
Amkar,4113,10,5,4,11,10,23,-13,19
Anzhi,4113,11,2,5,13,14,42,-28,11
Loko Moscow,4114,1,12,5,3,32,15,17,41
CSKA Moscow,4114,2,11,3,6,28,20,8,36
Spart Moscow,4114,3,9,6,5,40,32,8,33
Zenit,4114,4,8,8,4,24,16,8,32
Krasnodar,4114,5,9,4,7,30,26,4,31
Terek Grozny,4114,6,8,6,6,22,23,-1,30
Din Moscow,4114,7,6,7,7,20,23,-3,25
FK Rubin,4114,8,6,5,9,22,18,4,23
Amkar,4114,9,5,4,11,13,26,-13,19
Rostov,4114,10,4,6,10,12,20,-8,18
Anzhi,4114,11,2,6,12,15,39,-24,12
Loko Moscow,4115,1,11,7,2,29,11,18,40
CSKA Moscow,4115,2,11,3,6,28,18,10,36
Zenit,4115,3,8,9,3,22,13,9,33
Spart Moscow,4115,4,9,6,5,37,29,8,33
Krasnodar,4115,5,9,5,6,29,24,5,32
Terek Grozny,4115,6,8,5,7,23,25,-2,29
Din Moscow,4115,7,7,6,7,20,21,-1,27
FK Rubin,4115,8,5,5,10,21,20,1,20
Rostov,4115,9,4,6,10,11,20,-9,18
Amkar,4115,10,4,5,11,11,25,-14,17
Anzhi,4115,11,3,5,12,16,41,-25,14
Loko Moscow,4116,1,11,7,2,30,12,18,40
CSKA Moscow,4116,2,10,4,6,26,19,7,34
Spart Moscow,4116,3,9,6,5,36,27,9,33
Zenit,4116,4,8,9,3,22,13,9,33
Krasnodar,4116,5,8,5,7,28,26,2,29
Terek Grozny,4116,6,8,5,7,25,25,0,29
FK Rubin,4116,7,6,6,8,24,19,5,24
Din Moscow,4116,8,5,8,7,19,23,-4,23
Amkar,4116,9,5,4,11,12,27,-15,19
Rostov,4116,10,4,6,10,11,20,-9,18
Anzhi,4116,11,3,6,11,16,38,-22,15
Loko Moscow,4117,1,12,5,3,31,14,17,41
CSKA Moscow,4117,2,12,3,5,28,18,10,39
Spart Moscow,4117,3,11,5,4,37,25,12,38
Krasnodar,4117,4,10,4,6,31,25,6,34
Zenit,4117,5,7,8,5,23,17,6,29
Terek Grozny,4117,6,7,7,6,22,24,-2,28
Din Moscow,4117,7,6,6,8,19,23,-4,24
FK Rubin,4117,8,5,5,10,22,21,1,20
Rostov,4117,9,4,6,10,10,18,-8,18
Amkar,4117,10,4,5,11,10,24,-14,17
Anzhi,4117,11,2,6,12,15,39,-24,12
Loko Moscow,4118,1,12,6,2,32,13,19,42
Spart Moscow,4118,2,11,5,4,42,28,14,38
CSKA Moscow,4118,3,11,3,6,27,19,8,36
Zenit,4118,4,8,8,4,22,14,8,32
Krasnodar,4118,5,9,5,6,30,26,4,32
Terek Grozny,4118,6,8,6,6,24,24,0,30
Din Moscow,4118,7,6,6,8,20,24,-4,24
FK Rubin,4118,8,5,5,10,21,20,1,20
Rostov,4118,9,4,6,10,12,20,-8,18
Amkar,4118,10,4,5,11,10,26,-16,17
Anzhi,4118,11,2,5,13,16,42,-26,11
Loko Moscow,4119,1,12,6,2,31,12,19,42
CSKA Moscow,4119,2,11,3,6,27,20,7,36
Spart Moscow,4119,3,9,7,4,40,31,9,34
Zenit,4119,4,8,9,3,24,14,10,33
Krasnodar,4119,5,9,4,7,32,25,7,31
Terek Grozny,4119,6,7,6,7,20,23,-3,27
Din Moscow,4119,7,5,8,7,19,23,-4,23
FK Rubin,4119,8,5,6,9,21,22,-1,21
Rostov,4119,9,4,6,10,10,18,-8,18
Amkar,4119,10,4,6,10,13,26,-13,18
Anzhi,4119,11,3,5,12,16,39,-23,14
Loko Moscow,4120,1,12,5,3,32,14,18,41
CSKA Moscow,4120,2,11,3,6,27,18,9,36
Spart Moscow,4120,3,9,6,5,36,28,8,33
Zenit,4120,4,8,8,4,23,15,8,32
Krasnodar,4120,5,9,5,6,30,26,4,32
Terek Grozny,4120,6,9,5,6,23,23,0,32
Din Moscow,4120,7,6,7,7,19,22,-3,25
FK Rubin,4120,8,5,6,9,22,19,3,21
Rostov,4120,9,5,6,9,12,18,-6,21
Amkar,4120,10,4,4,12,9,24,-15,16
Anzhi,4120,11,2,5,13,15,41,-26,11
Loko Moscow,4121,1,13,5,2,35,15,20,44
CSKA Moscow,4121,2,11,4,5,28,18,10,37
Spart Moscow,4121,3,9,6,5,35,28,7,33
Zenit,4121,4,7,9,4,24,17,7,30
Terek Grozny,4121,5,8,6,6,24,25,-1,30
Krasnodar,4121,6,8,5,7,30,28,2,29
Din Moscow,4121,7,5,8,7,18,22,-4,23
FK Rubin,4121,8,5,7,8,22,18,4,22
Amkar,4121,9,5,4,11,13,25,-12,19
Rostov,4121,10,4,6,10,10,18,-8,18
Anzhi,4121,11,2,6,12,15,40,-25,12
Loko Moscow,4122,1,12,6,2,32,12,20,42
CSKA Moscow,4122,2,12,3,5,30,19,11,39
Spart Moscow,4122,3,10,5,5,37,28,9,35
Krasnodar,4122,4,8,6,6,28,25,3,30
Zenit,4122,5,7,8,5,22,18,4,29
Terek Grozny,4122,6,7,5,8,23,27,-4,26
FK Rubin,4122,7,6,6,8,23,18,5,24
Amkar,4122,8,6,4,10,13,24,-11,22
Din Moscow,4122,9,5,6,9,18,24,-6,21
Rostov,4122,10,4,6,10,11,19,-8,18
Anzhi,4122,11,3,5,12,18,41,-23,14
Loko Moscow,4123,1,11,6,3,31,16,15,39
CSKA Moscow,4123,2,11,4,5,28,19,9,37
Spart Moscow,4123,3,10,6,4,36,25,11,36
Krasnodar,4123,4,10,4,6,35,26,9,34
Terek Grozny,4123,5,9,5,6,25,22,3,32
Zenit,4123,6,7,10,3,24,16,8,31
FK Rubin,4123,7,6,5,9,25,21,4,23
Din Moscow,4123,8,5,6,9,17,26,-9,21
Rostov,4123,9,4,7,9,10,17,-7,19
Amkar,4123,10,4,4,12,9,24,-15,16
Anzhi,4123,11,2,5,13,14,42,-28,11
Loko Moscow,4124,1,11,5,4,30,14,16,38
Spart Moscow,4124,2,11,5,4,40,27,13,38
CSKA Moscow,4124,3,11,3,6,28,19,9,36
Zenit,4124,4,9,8,3,24,14,10,35
Krasnodar,4124,5,10,4,6,32,25,7,34
Terek Grozny,4124,6,8,6,6,23,24,-1,30
FK Rubin,4124,7,6,5,9,24,20,4,23
Din Moscow,4124,8,5,6,9,18,27,-9,21
Rostov,4124,9,4,6,10,11,20,-9,18
Amkar,4124,10,4,4,12,9,24,-15,16
Anzhi,4124,11,2,6,12,16,41,-25,12
Loko Moscow,4125,1,13,5,2,36,14,22,44
CSKA Moscow,4125,2,12,3,5,30,19,11,39
Spart Moscow,4125,3,9,6,5,36,29,7,33
Krasnodar,4125,4,9,4,7,32,30,2,31
Zenit,4125,5,7,8,5,22,17,5,29
Terek Grozny,4125,6,7,5,8,20,24,-4,26
Din Moscow,4125,7,5,7,8,18,23,-5,22
FK Rubin,4125,8,5,6,9,23,20,3,21
Rostov,4125,9,5,6,9,14,19,-5,21
Amkar,4125,10,5,5,10,10,22,-12,20
Anzhi,4125,11,3,5,12,16,40,-24,14
Loko Moscow,4126,1,12,5,3,31,13,18,41
CSKA Moscow,4126,2,12,3,5,28,17,11,39
Spart Moscow,4126,3,9,5,6,37,30,7,32
Krasnodar,4126,4,9,5,6,30,25,5,32
Terek Grozny,4126,5,8,6,6,23,22,1,30
Zenit,4126,6,7,8,5,21,17,4,29
FK Rubin,4126,7,6,6,8,24,19,5,24
Din Moscow,4126,8,6,6,8,21,24,-3,24
Amkar,4126,9,5,4,11,11,26,-15,19
Rostov,4126,10,4,6,10,10,19,-9,18
Anzhi,4126,11,2,6,12,14,38,-24,12
Loko Moscow,4127,1,11,6,3,32,15,17,39
CSKA Moscow,4127,2,11,4,5,30,19,11,37
Zenit,4127,3,8,9,3,24,15,9,33
Spart Moscow,4127,4,9,6,5,35,27,8,33
Krasnodar,4127,5,9,5,6,30,26,4,32
Terek Grozny,4127,6,7,5,8,21,26,-5,26
Din Moscow,4127,7,6,7,7,21,24,-3,25
Rostov,4127,8,5,6,9,11,17,-6,21
FK Rubin,4127,9,5,5,10,23,21,2,20
Amkar,4127,10,5,4,11,12,24,-12,19
Anzhi,4127,11,3,5,12,16,41,-25,14
Loko Moscow,4128,1,11,5,4,30,17,13,38
CSKA Moscow,4128,2,11,4,5,29,20,9,37
Zenit,4128,3,8,9,3,24,15,9,33
Spart Moscow,4128,4,9,6,5,38,31,7,33
Krasnodar,4128,5,9,5,6,31,24,7,32
Terek Grozny,4128,6,7,6,7,20,25,-5,27
FK Rubin,4128,7,6,6,8,24,19,5,24
Din Moscow,4128,8,6,6,8,21,24,-3,24
Amkar,4128,9,5,5,10,15,25,-10,20
Rostov,4128,10,4,6,10,11,19,-8,18
Anzhi,4128,11,2,6,12,16,40,-24,12
Loko Moscow,4129,1,12,6,2,32,13,19,42
CSKA Moscow,4129,2,11,4,5,27,17,10,37
Spart Moscow,4129,3,10,5,5,42,28,14,35
Krasnodar,4129,4,9,4,7,30,27,3,31
Zenit,4129,5,7,9,4,22,16,6,30
Terek Grozny,4129,6,7,6,7,23,28,-5,27
Din Moscow,4129,7,6,6,8,19,24,-5,24
FK Rubin,4129,8,6,5,9,24,19,5,23
Rostov,4129,9,4,6,10,10,23,-13,18
Amkar,4129,10,4,5,11,12,26,-14,17
Anzhi,4129,11,3,6,11,18,38,-20,15
Loko Moscow,4130,1,11,5,4,29,13,16,38
Spart Moscow,4130,2,10,6,4,38,28,10,36
Zenit,4130,3,9,8,3,24,13,11,35
CSKA Moscow,4130,4,10,3,7,28,23,5,33
Krasnodar,4130,5,9,5,6,29,25,4,32
Terek Grozny,4130,6,8,6,6,27,27,0,30
FK Rubin,4130,7,6,6,8,24,19,5,24
Din Moscow,4130,8,5,6,9,19,25,-6,21
Rostov,4130,9,4,7,9,12,19,-7,19
Amkar,4130,10,4,5,11,10,24,-14,17
Anzhi,4130,11,3,5,12,22,46,-24,14
Loko Moscow,4131,1,11,6,3,31,14,17,39
CSKA Moscow,4131,2,11,4,5,29,19,10,37
Zenit,4131,3,8,9,3,24,15,9,33
Spart Moscow,4131,4,8,6,6,35,30,5,30
Krasnodar,4131,5,8,6,6,29,26,3,30
Terek Grozny,4131,6,8,5,7,23,24,-1,29
FK Rubin,4131,7,6,6,8,25,20,5,24
Din Moscow,4131,8,5,7,8,19,24,-5,22
Amkar,4131,9,6,4,10,13,23,-10,22
Rostov,4131,10,5,6,9,12,17,-5,21
Anzhi,4131,11,2,5,13,16,44,-28,11
Loko Moscow,4132,1,12,5,3,32,13,19,41
Spart Moscow,4132,2,10,6,4,37,26,11,36
CSKA Moscow,4132,3,11,3,6,26,19,7,36
Zenit,4132,4,9,8,3,24,13,11,35
Terek Grozny,4132,5,8,6,6,21,22,-1,30
Krasnodar,4132,6,8,4,8,29,30,-1,28
Din Moscow,4132,7,6,6,8,20,24,-4,24
FK Rubin,4132,8,6,5,9,25,21,4,23
Rostov,4132,9,4,7,9,11,18,-7,19
Amkar,4132,10,4,5,11,9,23,-14,17
Anzhi,4132,11,2,5,13,14,39,-25,11
Loko Moscow,4133,1,12,5,3,31,13,18,41
Zenit,4133,2,9,8,3,23,13,10,35
CSKA Moscow,4133,3,10,3,7,27,21,6,33
Spart Moscow,4133,4,9,5,6,37,30,7,32
Krasnodar,4133,5,8,5,7,29,27,2,29
Terek Grozny,4133,6,8,5,7,22,24,-2,29
FK Rubin,4133,7,6,6,8,26,19,7,24
Din Moscow,4133,8,6,6,8,20,25,-5,24
Amkar,4133,9,6,4,10,13,23,-10,22
Rostov,4133,10,4,6,10,10,20,-10,18
Anzhi,4133,11,3,5,12,18,41,-23,14
Loko Moscow,4134,1,11,6,3,32,16,16,39
CSKA Moscow,4134,2,12,3,5,27,17,10,39
Spart Moscow,4134,3,10,6,4,38,28,10,36
Krasnodar,4134,4,9,4,7,33,29,4,31
Zenit,4134,5,7,9,4,23,16,7,30
Terek Grozny,4134,6,7,6,7,20,23,-3,27
Din Moscow,4134,7,6,6,8,21,24,-3,24
FK Rubin,4134,8,6,5,9,26,23,3,23
Rostov,4134,9,4,6,10,10,18,-8,18
Amkar,4134,10,4,6,10,11,24,-13,18
Anzhi,4134,11,3,5,12,15,38,-23,14
Loko Moscow,4135,1,11,7,2,32,14,18,40
CSKA Moscow,4135,2,11,4,5,28,18,10,37
Spart Moscow,4135,3,10,6,4,38,26,12,36
Terek Grozny,4135,4,9,5,6,24,23,1,32
Zenit,4135,5,7,10,3,23,15,8,31
Krasnodar,4135,6,8,5,7,30,28,2,29
Din Moscow,4135,7,6,6,8,19,24,-5,24
FK Rubin,4135,8,6,5,9,25,21,4,23
Rostov,4135,9,4,7,9,11,18,-7,19
Amkar,4135,10,4,4,12,9,26,-17,16
Anzhi,4135,11,2,5,13,16,42,-26,11
Loko Moscow,4136,1,11,7,2,31,13,18,40
CSKA Moscow,4136,2,11,3,6,27,18,9,36
Spart Moscow,4136,3,9,7,4,36,27,9,34
Zenit,4136,4,8,9,3,23,14,9,33
Terek Grozny,4136,5,9,5,6,22,22,0,32
Krasnodar,4136,6,8,5,7,28,26,2,29
FK Rubin,4136,7,6,6,8,23,18,5,24
Din Moscow,4136,8,5,7,8,19,24,-5,22
Rostov,4136,9,4,7,9,11,18,-7,19
Amkar,4136,10,4,5,11,9,23,-14,17
Anzhi,4136,11,2,5,13,14,40,-26,11
Loko Moscow,4137,1,13,5,2,32,12,20,44
CSKA Moscow,4137,2,12,3,5,28,17,11,39
Spart Moscow,4137,3,9,5,6,38,31,7,32
Zenit,4137,4,7,8,5,22,17,5,29
Terek Grozny,4137,5,8,5,7,21,23,-2,29
Krasnodar,4137,6,8,4,8,27,27,0,28
FK Rubin,4137,7,7,5,8,26,17,9,26
Din Moscow,4137,8,6,6,8,20,25,-5,24
Amkar,4137,9,5,4,11,11,23,-12,19
Rostov,4137,10,4,6,10,11,21,-10,18
Anzhi,4137,11,3,5,12,15,38,-23,14
Loko Moscow,4138,1,11,6,3,30,14,16,39
CSKA Moscow,4138,2,12,3,5,28,17,11,39
Spart Moscow,4138,3,10,5,5,40,30,10,35
Krasnodar,4138,4,9,5,6,30,25,5,32
Terek Grozny,4138,5,9,5,6,26,22,4,32
Zenit,4138,6,7,9,4,22,15,7,30
FK Rubin,4138,7,5,7,8,23,19,4,22
Din Moscow,4138,8,5,7,8,20,25,-5,22
Amkar,4138,9,5,4,11,11,25,-14,19
Rostov,4138,10,4,6,10,11,20,-9,18
Anzhi,4138,11,2,5,13,14,43,-29,11
Loko Moscow,4139,1,12,5,3,30,12,18,41
CSKA Moscow,4139,2,11,4,5,30,19,11,37
Zenit,4139,3,8,9,3,24,15,9,33
Krasnodar,4139,4,9,4,7,28,25,3,31
Spart Moscow,4139,5,8,6,6,35,31,4,30
Terek Grozny,4139,6,8,5,7,23,27,-4,29
Din Moscow,4139,7,6,6,8,20,23,-3,24
FK Rubin,4139,8,6,5,9,23,19,4,23
Rostov,4139,9,5,6,9,13,18,-5,21
Amkar,4139,10,5,5,10,14,24,-10,20
Anzhi,4139,11,2,5,13,15,42,-27,11
Loko Moscow,4140,1,11,6,3,30,14,16,39
CSKA Moscow,4140,2,11,4,5,28,19,9,37
Spart Moscow,4140,3,10,5,5,43,31,12,35
Krasnodar,4140,4,9,5,6,30,25,5,32
Zenit,4140,5,7,10,3,23,15,8,31
Terek Grozny,4140,6,7,6,7,20,24,-4,27
Din Moscow,4140,7,6,6,8,21,27,-6,24
FK Rubin,4140,8,5,6,9,23,20,3,21
Amkar,4140,9,5,5,10,12,23,-11,20
Rostov,4140,10,4,6,10,11,21,-10,18
Anzhi,4140,11,3,5,12,17,39,-22,14
Loko Moscow,4141,1,11,6,3,31,15,16,39
CSKA Moscow,4141,2,11,3,6,28,18,10,36
Zenit,4141,3,9,8,3,24,13,11,35
Krasnodar,4141,4,9,5,6,30,26,4,32
Spart Moscow,4141,5,8,7,5,36,29,7,31
Terek Grozny,4141,6,8,6,6,23,23,0,30
Din Moscow,4141,7,6,6,8,20,24,-4,24
FK Rubin,4141,8,6,5,9,23,19,4,23
Rostov,4141,9,4,7,9,11,18,-7,19
Amkar,4141,10,4,6,10,11,24,-13,18
Anzhi,4141,11,2,5,13,14,42,-28,11
Loko Moscow,4142,1,12,6,2,32,13,19,42
Spart Moscow,4142,2,10,6,4,38,27,11,36
Zenit,4142,3,8,9,3,26,15,11,33
CSKA Moscow,4142,4,10,3,7,25,21,4,33
Krasnodar,4142,5,9,4,7,29,26,3,31
Terek Grozny,4142,6,8,6,6,21,22,-1,30
Din Moscow,4142,7,6,6,8,21,24,-3,24
FK Rubin,4142,8,5,5,10,22,22,0,20
Rostov,4142,9,4,6,10,10,18,-8,18
Amkar,4142,10,4,5,11,10,24,-14,17
Anzhi,4142,11,3,6,11,15,37,-22,15
Loko Moscow,4143,1,11,6,3,31,14,17,39
CSKA Moscow,4143,2,11,4,5,27,17,10,37
Spart Moscow,4143,3,10,5,5,40,28,12,35
Krasnodar,4143,4,10,4,6,30,24,6,34
Zenit,4143,5,7,10,3,23,15,8,31
Terek Grozny,4143,6,7,5,8,21,25,-4,26
Din Moscow,4143,7,5,7,8,17,23,-6,22
Amkar,4143,8,6,4,10,11,22,-11,22
FK Rubin,4143,9,5,6,9,21,19,2,21
Rostov,4143,10,4,6,10,12,22,-10,18
Anzhi,4143,11,3,5,12,16,40,-24,14
Loko Moscow,4144,1,12,5,3,32,14,18,41
CSKA Moscow,4144,2,11,3,6,28,18,10,36
Zenit,4144,3,8,8,4,22,14,8,32
Krasnodar,4144,4,9,5,6,32,28,4,32
Spart Moscow,4144,5,8,5,7,33,28,5,29
Terek Grozny,4144,6,7,7,6,21,23,-2,28
Din Moscow,4144,7,6,7,7,18,21,-3,25
FK Rubin,4144,8,5,7,8,23,19,4,22
Rostov,4144,9,5,6,9,11,17,-6,21
Amkar,4144,10,5,5,10,10,22,-12,20
Anzhi,4144,11,2,6,12,15,41,-26,12
Loko Moscow,4145,1,12,6,2,34,13,21,42
CSKA Moscow,4145,2,12,3,5,27,17,10,39
Spart Moscow,4145,3,10,6,4,38,27,11,36
Zenit,4145,4,7,8,5,22,18,4,29
Krasnodar,4145,5,8,5,7,29,27,2,29
Terek Grozny,4145,6,8,5,7,22,24,-2,29
FK Rubin,4145,7,6,6,8,24,19,5,24
Din Moscow,4145,8,5,8,7,19,23,-4,23
Amkar,4145,9,5,4,11,12,24,-12,19
Rostov,4145,10,4,6,10,10,19,-9,18
Anzhi,4145,11,2,5,13,14,40,-26,11
Loko Moscow,4146,1,11,6,3,30,14,16,39
CSKA Moscow,4146,2,11,4,5,28,17,11,37
Spart Moscow,4146,3,10,6,4,40,28,12,36
Krasnodar,4146,4,10,4,6,34,24,10,34
Zenit,4146,5,7,10,3,22,14,8,31
Terek Grozny,4146,6,7,7,6,21,23,-2,28
Din Moscow,4146,7,5,7,8,19,26,-7,22
FK Rubin,4146,8,5,6,9,22,23,-1,21
Rostov,4146,9,4,7,9,11,18,-7,19
Amkar,4146,10,4,5,11,11,25,-14,17
Anzhi,4146,11,2,6,12,14,40,-26,12
Loko Moscow,4147,1,11,6,3,29,12,17,39
CSKA Moscow,4147,2,11,3,6,27,19,8,36
Zenit,4147,3,9,8,3,23,13,10,35
Spart Moscow,4147,4,8,7,5,35,28,7,31
Krasnodar,4147,5,8,6,6,29,26,3,30
Terek Grozny,4147,6,8,6,6,21,22,-1,30
Din Moscow,4147,7,6,7,7,19,22,-3,25
FK Rubin,4147,8,5,7,8,24,20,4,22
Rostov,4147,9,4,7,9,11,18,-7,19
Amkar,4147,10,4,6,10,10,23,-13,18
Anzhi,4147,11,2,5,13,15,40,-25,11
Loko Moscow,4148,1,12,5,3,31,13,18,41
CSKA Moscow,4148,2,11,3,6,28,19,9,36
Spart Moscow,4148,3,10,5,5,38,26,12,35
Zenit,4148,4,8,8,4,23,15,8,32
Krasnodar,4148,5,9,5,6,29,24,5,32
Terek Grozny,4148,6,9,5,6,28,24,4,32
FK Rubin,4148,7,5,7,8,21,17,4,22
Din Moscow,4148,8,5,7,8,17,22,-5,22
Rostov,4148,9,5,6,9,11,17,-6,21
Amkar,4148,10,4,4,12,10,30,-20,16
Anzhi,4148,11,2,5,13,15,44,-29,11
Loko Moscow,4149,1,12,5,3,32,14,18,41
CSKA Moscow,4149,2,11,4,5,29,19,10,37
Spart Moscow,4149,3,10,5,5,35,26,9,35
Krasnodar,4149,4,10,4,6,32,24,8,34
Zenit,4149,5,7,9,4,22,17,5,30
Terek Grozny,4149,6,8,5,7,23,24,-1,29
Din Moscow,4149,7,6,6,8,19,23,-4,24
FK Rubin,4149,8,6,5,9,23,20,3,23
Rostov,4149,9,4,6,10,10,18,-8,18
Amkar,4149,10,4,4,12,9,26,-17,16
Anzhi,4149,11,3,5,12,17,40,-23,14
Loko Moscow,4150,1,12,5,3,30,13,17,41
CSKA Moscow,4150,2,11,4,5,28,18,10,37
Zenit,4150,3,8,9,3,23,13,10,33
Spart Moscow,4150,4,9,6,5,36,28,8,33
Krasnodar,4150,5,8,5,7,28,26,2,29
Terek Grozny,4150,6,8,5,7,24,26,-2,29
Din Moscow,4150,7,6,6,8,18,23,-5,24
FK Rubin,4150,8,5,6,9,22,19,3,21
Rostov,4150,9,5,6,9,13,18,-5,21
Amkar,4150,10,4,5,11,10,24,-14,17
Anzhi,4150,11,3,5,12,18,42,-24,14
Loko Moscow,4151,1,12,5,3,32,12,20,41
CSKA Moscow,4151,2,11,3,6,28,18,10,36
Krasnodar,4151,3,10,4,6,29,24,5,34
Spart Moscow,4151,4,9,6,5,36,29,7,33
Zenit,4151,5,8,8,4,22,16,6,32
Terek Grozny,4151,6,7,6,7,21,25,-4,27
FK Rubin,4151,7,6,5,9,22,18,4,23
Din Moscow,4151,8,5,6,9,17,23,-6,21
Amkar,4151,9,5,5,10,11,22,-11,20
Rostov,4151,10,4,7,9,12,19,-7,19
Anzhi,4151,11,3,5,12,17,41,-24,14
Loko Moscow,4152,1,12,6,2,30,11,19,42
CSKA Moscow,4152,2,11,4,5,27,18,9,37
Spart Moscow,4152,3,10,5,5,36,28,8,35
Terek Grozny,4152,4,9,5,6,26,23,3,32
Zenit,4152,5,7,9,4,21,14,7,30
Krasnodar,4152,6,8,5,7,28,27,1,29
Din Moscow,4152,7,7,6,7,20,21,-1,27
FK Rubin,4152,8,6,5,9,24,19,5,23
Rostov,4152,9,4,6,10,11,19,-8,18
Amkar,4152,10,4,4,12,10,27,-17,16
Anzhi,4152,11,2,5,13,15,41,-26,11
Loko Moscow,4153,1,11,6,3,30,13,17,39
CSKA Moscow,4153,2,10,4,6,26,21,5,34
Zenit,4153,3,8,9,3,23,14,9,33
Spart Moscow,4153,4,9,6,5,36,30,6,33
Krasnodar,4153,5,9,5,6,33,26,7,32
Terek Grozny,4153,6,7,5,8,21,26,-5,26
Din Moscow,4153,7,5,8,7,18,22,-4,23
Amkar,4153,8,6,4,10,14,23,-9,22
FK Rubin,4153,9,5,6,9,23,23,0,21
Rostov,4153,10,4,6,10,12,20,-8,18
Anzhi,4153,11,4,5,11,19,37,-18,17
Loko Moscow,4154,1,12,6,2,32,12,20,42
CSKA Moscow,4154,2,11,3,6,29,20,9,36
Spart Moscow,4154,3,9,5,6,40,31,9,32
Zenit,4154,4,8,8,4,24,17,7,32
Krasnodar,4154,5,8,6,6,29,26,3,30
Terek Grozny,4154,6,8,6,6,23,24,-1,30
Din Moscow,4154,7,7,6,7,20,22,-2,27
FK Rubin,4154,8,5,6,9,22,19,3,21
Rostov,4154,9,5,6,9,13,19,-6,21
Amkar,4154,10,4,5,11,11,27,-16,17
Anzhi,4154,11,2,5,13,15,41,-26,11
Loko Moscow,4155,1,13,5,2,32,12,20,44
CSKA Moscow,4155,2,11,3,6,26,18,8,36
Spart Moscow,4155,3,10,5,5,37,26,11,35
Krasnodar,4155,4,9,4,7,30,27,3,31
Zenit,4155,5,7,8,5,21,15,6,29
Din Moscow,4155,6,7,6,7,19,21,-2,27
Terek Grozny,4155,7,7,6,7,20,24,-4,27
FK Rubin,4155,8,5,5,10,22,20,2,20
Rostov,4155,9,4,6,10,10,20,-10,18
Amkar,4155,10,4,5,11,9,23,-14,17
Anzhi,4155,11,4,5,11,17,37,-20,17
Loko Moscow,4156,1,12,5,3,32,15,17,41
Spart Moscow,4156,2,9,7,4,37,28,9,34
Krasnodar,4156,3,10,4,6,32,25,7,34
CSKA Moscow,4156,4,10,4,6,27,21,6,34
Zenit,4156,5,8,8,4,25,16,9,32
Terek Grozny,4156,6,8,5,7,22,24,-2,29
Din Moscow,4156,7,6,7,7,21,24,-3,25
FK Rubin,4156,8,5,5,10,22,21,1,20
Rostov,4156,9,4,6,10,10,18,-8,18
Amkar,4156,10,4,5,11,10,24,-14,17
Anzhi,4156,11,3,6,11,17,39,-22,15
Loko Moscow,4157,1,11,6,3,30,14,16,39
CSKA Moscow,4157,2,11,4,5,28,19,9,37
Spart Moscow,4157,3,9,6,5,36,28,8,33
Zenit,4157,4,8,8,4,24,15,9,32
Terek Grozny,4157,5,9,5,6,26,24,2,32
Krasnodar,4157,6,8,6,6,28,25,3,30
Din Moscow,4157,7,6,6,8,22,25,-3,24
FK Rubin,4157,8,5,6,9,24,22,2,21
Rostov,4157,9,5,6,9,11,17,-6,21
Amkar,4157,10,4,5,11,11,25,-14,17
Anzhi,4157,11,2,6,12,17,43,-26,12
Loko Moscow,4158,1,12,6,2,35,15,20,42
CSKA Moscow,4158,2,11,3,6,27,19,8,36
Zenit,4158,3,8,9,3,25,16,9,33
Spart Moscow,4158,4,9,6,5,36,29,7,33
Terek Grozny,4158,5,8,5,7,22,25,-3,29
Krasnodar,4158,6,8,4,8,28,29,-1,28
FK Rubin,4158,7,7,5,8,24,17,7,26
Din Moscow,4158,8,5,7,8,17,22,-5,22
Amkar,4158,9,6,4,10,14,23,-9,22
Rostov,4158,10,4,6,10,12,20,-8,18
Anzhi,4158,11,2,5,13,15,40,-25,11
Loko Moscow,4159,1,12,5,3,31,13,18,41
CSKA Moscow,4159,2,12,3,5,28,17,11,39
Spart Moscow,4159,3,9,6,5,38,28,10,33
Zenit,4159,4,8,8,4,22,15,7,32
Terek Grozny,4159,5,9,5,6,23,22,1,32
Krasnodar,4159,6,9,4,7,31,26,5,31
FK Rubin,4159,7,6,5,9,22,20,2,23
Din Moscow,4159,8,5,7,8,18,23,-5,22
Rostov,4159,9,5,6,9,11,17,-6,21
Amkar,4159,10,4,4,12,10,27,-17,16
Anzhi,4159,11,2,5,13,14,40,-26,11
Loko Moscow,4160,1,11,6,3,30,15,15,39
CSKA Moscow,4160,2,11,3,6,29,21,8,36
Zenit,4160,3,9,8,3,27,15,12,35
Spart Moscow,4160,4,9,5,6,34,28,6,32
Krasnodar,4160,5,8,6,6,30,27,3,30
Terek Grozny,4160,6,8,5,7,23,24,-1,29
FK Rubin,4160,7,5,7,8,24,20,4,22
Din Moscow,4160,8,5,7,8,18,23,-5,22
Amkar,4160,9,6,4,10,13,23,-10,22
Rostov,4160,10,5,6,9,11,17,-6,21
Anzhi,4160,11,2,5,13,15,41,-26,11
Loko Moscow,4161,1,11,7,2,30,12,18,40
Spart Moscow,4161,2,10,6,4,41,29,12,36
CSKA Moscow,4161,3,11,3,6,28,19,9,36
Zenit,4161,4,8,9,3,24,15,9,33
Krasnodar,4161,5,8,6,6,28,25,3,30
Terek Grozny,4161,6,7,6,7,22,26,-4,27
Din Moscow,4161,7,6,7,7,21,24,-3,25
FK Rubin,4161,8,5,6,9,22,19,3,21
Amkar,4161,9,5,4,11,14,27,-13,19
Rostov,4161,10,4,6,10,10,19,-9,18
Anzhi,4161,11,2,6,12,14,39,-25,12
Loko Moscow,4162,1,12,6,2,32,13,19,42
Spart Moscow,4162,2,10,6,4,40,27,13,36
CSKA Moscow,4162,3,11,3,6,27,22,5,36
Zenit,4162,4,8,9,3,27,14,13,33
Krasnodar,4162,5,9,4,7,31,27,4,31
Terek Grozny,4162,6,8,5,7,24,25,-1,29
Din Moscow,4162,7,6,6,8,18,24,-6,24
FK Rubin,4162,8,5,5,10,22,21,1,20
Rostov,4162,9,4,7,9,11,18,-7,19
Amkar,4162,10,4,4,12,11,28,-17,16
Anzhi,4162,11,3,5,12,16,40,-24,14
Loko Moscow,4163,1,13,5,2,31,11,20,44
CSKA Moscow,4163,2,12,3,5,28,17,11,39
Spart Moscow,4163,3,10,6,4,38,27,11,36
Zenit,4163,4,7,8,5,21,16,5,29
Krasnodar,4163,5,8,4,8,27,27,0,28
Terek Grozny,4163,6,7,6,7,20,23,-3,27
Din Moscow,4163,7,6,6,8,21,24,-3,24
FK Rubin,4163,8,6,5,9,24,20,4,23
Rostov,4163,9,4,7,9,11,18,-7,19
Amkar,4163,10,4,5,11,9,24,-15,17
Anzhi,4163,11,3,5,12,15,38,-23,14
Loko Moscow,4164,1,13,5,2,34,14,20,44
CSKA Moscow,4164,2,11,3,6,26,18,8,36
Spart Moscow,4164,3,9,6,5,38,30,8,33
Zenit,4164,4,7,8,5,22,16,6,29
Krasnodar,4164,5,8,4,8,29,28,1,28
Din Moscow,4164,6,7,6,7,20,22,-2,27
Terek Grozny,4164,7,7,6,7,21,25,-4,27
FK Rubin,4164,8,6,5,9,22,18,4,23
Rostov,4164,9,4,7,9,12,19,-7,19
Amkar,4164,10,4,5,11,11,25,-14,17
Anzhi,4164,11,4,5,11,17,37,-20,17
Loko Moscow,4165,1,12,6,2,32,13,19,42
CSKA Moscow,4165,2,11,3,6,29,20,9,36
Spart Moscow,4165,3,9,7,4,39,29,10,34
Zenit,4165,4,8,8,4,25,15,10,32
Krasnodar,4165,5,8,6,6,30,27,3,30
Terek Grozny,4165,6,8,6,6,21,22,-1,30
Din Moscow,4165,7,5,8,7,20,24,-4,23
FK Rubin,4165,8,5,7,8,24,20,4,22
Rostov,4165,9,4,6,10,10,19,-9,18
Amkar,4165,10,4,5,11,11,25,-14,17
Anzhi,4165,11,2,6,12,14,41,-27,12
Loko Moscow,4166,1,11,6,3,29,12,17,39
CSKA Moscow,4166,2,11,3,6,30,19,11,36
Spart Moscow,4166,3,10,5,5,36,27,9,35
Krasnodar,4166,4,10,4,6,29,24,5,34
Zenit,4166,5,8,9,3,23,13,10,33
Terek Grozny,4166,6,7,5,8,22,29,-7,26
Din Moscow,4166,7,6,6,8,19,23,-4,24
Amkar,4166,8,6,4,10,15,25,-10,22
FK Rubin,4166,9,5,5,10,22,20,2,20
Rostov,4166,10,4,6,10,10,18,-8,18
Anzhi,4166,11,3,5,12,17,42,-25,14
Loko Moscow,4167,1,11,5,4,30,15,15,38
Zenit,4167,2,9,8,3,24,14,10,35
CSKA Moscow,4167,3,10,4,6,26,19,7,34
Krasnodar,4167,4,9,5,6,30,25,5,32
Spart Moscow,4167,5,8,7,5,34,28,6,31
Terek Grozny,4167,6,8,5,7,24,23,1,29
Din Moscow,4167,7,6,7,7,20,22,-2,25
FK Rubin,4167,8,5,7,8,23,19,4,22
Amkar,4167,9,5,5,10,11,23,-12,20
Rostov,4167,10,4,7,9,10,17,-7,19
Anzhi,4167,11,2,6,12,15,42,-27,12
Loko Moscow,4168,1,12,5,3,31,12,19,41
CSKA Moscow,4168,2,12,3,5,29,18,11,39
Spart Moscow,4168,3,11,5,4,42,26,16,38
Krasnodar,4168,4,10,4,6,29,24,5,34
Terek Grozny,4168,5,8,6,6,23,23,0,30
Zenit,4168,6,7,8,5,21,17,4,29
FK Rubin,4168,7,6,5,9,24,19,5,23
Din Moscow,4168,8,5,6,9,19,26,-7,21
Rostov,4168,9,4,6,10,10,18,-8,18
Amkar,4168,10,4,4,12,9,30,-21,16
Anzhi,4168,11,2,6,12,16,40,-24,12
Loko Moscow,4169,1,12,6,2,33,14,19,42
CSKA Moscow,4169,2,10,4,6,27,20,7,34
Spart Moscow,4169,3,9,5,6,37,31,6,32
Zenit,4169,4,7,10,3,23,15,8,31
Terek Grozny,4169,5,8,6,6,24,23,1,30
Krasnodar,4169,6,8,5,7,29,27,2,29
Din Moscow,4169,7,7,6,7,21,22,-1,27
FK Rubin,4169,8,5,6,9,21,19,2,21
Amkar,4169,9,5,5,10,12,23,-11,20
Rostov,4169,10,4,6,10,12,20,-8,18
Anzhi,4169,11,3,5,12,16,41,-25,14
Loko Moscow,4170,1,13,5,2,34,13,21,44
CSKA Moscow,4170,2,12,3,5,27,17,10,39
Spart Moscow,4170,3,9,6,5,37,29,8,33
Krasnodar,4170,4,9,4,7,30,27,3,31
Zenit,4170,5,7,8,5,21,16,5,29
Terek Grozny,4170,6,8,5,7,21,24,-3,29
Din Moscow,4170,7,5,7,8,21,26,-5,22
Amkar,4170,8,6,4,10,13,23,-10,22
FK Rubin,4170,9,5,6,9,23,20,3,21
Rostov,4170,10,4,7,9,10,17,-7,19
Anzhi,4170,11,2,5,13,14,39,-25,11
Loko Moscow,4171,1,11,6,3,31,14,17,39
CSKA Moscow,4171,2,11,4,5,30,18,12,37
Spart Moscow,4171,3,10,5,5,38,29,9,35
Zenit,4171,4,8,9,3,23,14,9,33
Terek Grozny,4171,5,9,5,6,25,23,2,32
Krasnodar,4171,6,8,5,7,30,28,2,29
FK Rubin,4171,7,7,5,8,26,18,8,26
Din Moscow,4171,8,5,6,9,17,26,-9,21
Amkar,4171,9,5,4,11,12,24,-12,19
Rostov,4171,10,4,6,10,11,19,-8,18
Anzhi,4171,11,2,5,13,15,45,-30,11
Loko Moscow,4172,1,11,5,4,30,14,16,38
Spart Moscow,4172,2,10,6,4,37,26,11,36
Zenit,4172,3,9,8,3,24,13,11,35
Krasnodar,4172,4,10,4,6,32,25,7,34
CSKA Moscow,4172,5,10,3,7,25,20,5,33
Terek Grozny,4172,6,7,5,8,21,28,-7,26
Din Moscow,4172,7,5,8,7,19,23,-4,23
FK Rubin,4172,8,5,6,9,22,21,1,21
Amkar,4172,9,5,4,11,11,23,-12,19
Rostov,4172,10,4,6,10,10,19,-9,18
Anzhi,4172,11,4,5,11,19,38,-19,17
Loko Moscow,4173,1,13,5,2,32,11,21,44
CSKA Moscow,4173,2,10,3,7,27,22,5,33
Spart Moscow,4173,3,9,5,6,36,28,8,32
Zenit,4173,4,8,8,4,25,17,8,32
Krasnodar,4173,5,8,5,7,27,25,2,29
Terek Grozny,4173,6,7,6,7,21,24,-3,27
Din Moscow,4173,7,6,7,7,20,23,-3,25
FK Rubin,4173,8,5,7,8,23,19,4,22
Amkar,4173,9,5,5,10,11,22,-11,20
Rostov,4173,10,4,6,10,10,20,-10,18
Anzhi,4173,11,4,5,11,17,38,-21,17
Loko Moscow,4174,1,12,6,2,32,12,20,42
CSKA Moscow,4174,2,10,5,5,27,19,8,35
Spart Moscow,4174,3,9,6,5,38,29,9,33
Zenit,4174,4,7,10,3,23,15,8,31
Krasnodar,4174,5,9,4,7,30,26,4,31
Terek Grozny,4174,6,7,6,7,21,25,-4,27
FK Rubin,4174,7,6,5,9,22,20,2,23
Din Moscow,4174,8,5,7,8,18,23,-5,22
Amkar,4174,9,6,4,10,14,24,-10,22
Rostov,4174,10,4,6,10,10,19,-9,18
Anzhi,4174,11,2,7,11,16,39,-23,13
Loko Moscow,4175,1,12,5,3,31,13,18,41
Spart Moscow,4175,2,11,5,4,41,28,13,38
CSKA Moscow,4175,3,11,4,5,27,17,10,37
Krasnodar,4175,4,9,5,6,29,25,4,32
Zenit,4175,5,7,9,4,21,14,7,30
Terek Grozny,4175,6,7,5,8,21,26,-5,26
FK Rubin,4175,7,6,6,8,25,18,7,24
Din Moscow,4175,8,5,6,9,20,28,-8,21
Amkar,4175,9,5,4,11,11,25,-14,19
Rostov,4175,10,4,6,10,10,19,-9,18
Anzhi,4175,11,3,5,12,17,40,-23,14
Loko Moscow,4176,1,11,5,4,29,13,16,38
CSKA Moscow,4176,2,10,4,6,27,20,7,34
Zenit,4176,3,8,9,3,23,14,9,33
Spart Moscow,4176,4,9,6,5,38,30,8,33
Krasnodar,4176,5,9,5,6,28,24,4,32
Terek Grozny,4176,6,7,5,8,20,27,-7,26
Din Moscow,4176,7,6,6,8,20,24,-4,24
Amkar,4176,8,6,4,10,13,23,-10,22
FK Rubin,4176,9,5,6,9,21,19,2,21
Rostov,4176,10,4,7,9,11,18,-7,19
Anzhi,4176,11,4,5,11,20,38,-18,17
Loko Moscow,4177,1,13,5,2,33,12,21,44
CSKA Moscow,4177,2,12,3,5,29,19,10,39
Spart Moscow,4177,3,10,6,4,37,26,11,36
Krasnodar,4177,4,9,4,7,32,28,4,31
Zenit,4177,5,7,8,5,23,17,6,29
Terek Grozny,4177,6,8,5,7,21,23,-2,29
FK Rubin,4177,7,6,5,9,25,22,3,23
Din Moscow,4177,8,5,7,8,18,24,-6,22
Amkar,4177,9,5,4,11,10,23,-13,19
Rostov,4177,10,4,6,10,11,20,-9,18
Anzhi,4177,11,2,5,13,14,39,-25,11
Loko Moscow,4178,1,12,6,2,34,12,22,42
Spart Moscow,4178,2,10,6,4,38,27,11,36
CSKA Moscow,4178,3,10,4,6,28,21,7,34
Zenit,4178,4,7,10,3,22,14,8,31
Krasnodar,4178,5,8,4,8,28,32,-4,28
Terek Grozny,4178,6,7,5,8,22,26,-4,26
FK Rubin,4178,7,6,6,8,25,18,7,24
Din Moscow,4178,8,5,7,8,19,25,-6,22
Rostov,4178,9,4,7,9,10,17,-7,19
Amkar,4178,10,5,4,11,12,25,-13,19
Anzhi,4178,11,4,5,11,19,40,-21,17
Loko Moscow,4179,1,12,6,2,32,13,19,42
CSKA Moscow,4179,2,11,3,6,27,18,9,36
Zenit,4179,3,8,8,4,22,14,8,32
Terek Grozny,4179,4,9,5,6,27,23,4,32
Krasnodar,4179,5,8,6,6,30,27,3,30
Spart Moscow,4179,6,8,5,7,36,32,4,29
FK Rubin,4179,7,6,6,8,24,18,6,24
Din Moscow,4179,8,6,6,8,20,24,-4,24
Rostov,4179,9,5,6,9,11,17,-6,21
Amkar,4179,10,5,4,11,12,29,-17,19
Anzhi,4179,11,2,5,13,15,41,-26,11
Loko Moscow,4180,1,12,5,3,33,14,19,41
CSKA Moscow,4180,2,12,3,5,32,18,14,39
Spart Moscow,4180,3,9,7,4,36,26,10,34
Zenit,4180,4,8,8,4,23,16,7,32
Krasnodar,4180,5,8,4,8,28,28,0,28
Terek Grozny,4180,6,7,6,7,20,23,-3,27
FK Rubin,4180,7,6,6,8,24,19,5,24
Din Moscow,4180,8,5,7,8,19,25,-6,22
Amkar,4180,9,5,5,10,11,23,-12,20
Rostov,4180,10,4,7,9,10,17,-7,19
Anzhi,4180,11,2,6,12,15,42,-27,12
Loko Moscow,4181,1,12,5,3,33,13,20,41
Spart Moscow,4181,2,11,5,4,41,28,13,38
CSKA Moscow,4181,3,11,4,5,26,17,9,37
Zenit,4181,4,8,9,3,23,14,9,33
Terek Grozny,4181,5,8,6,6,22,23,-1,30
Krasnodar,4181,6,8,5,7,27,27,0,29
FK Rubin,4181,7,6,6,8,23,18,5,24
Din Moscow,4181,8,5,6,9,19,26,-7,21
Rostov,4181,9,4,6,10,11,20,-9,18
Amkar,4181,10,4,4,12,11,26,-15,16
Anzhi,4181,11,2,6,12,14,38,-24,12
Loko Moscow,4182,1,11,5,4,29,15,14,38
CSKA Moscow,4182,2,11,3,6,27,21,6,36
Zenit,4182,3,9,8,3,26,13,13,35
Spart Moscow,4182,4,9,6,5,35,27,8,33
Krasnodar,4182,5,9,5,6,29,24,5,32
Terek Grozny,4182,6,8,5,7,22,24,-2,29
FK Rubin,4182,7,6,6,8,22,17,5,24
Din Moscow,4182,8,5,7,8,18,23,-5,22
Amkar,4182,9,6,4,10,12,23,-11,22
Rostov,4182,10,4,6,10,10,18,-8,18
Anzhi,4182,11,2,5,13,15,40,-25,11
Loko Moscow,4183,1,12,6,2,30,11,19,42
CSKA Moscow,4183,2,10,4,6,25,18,7,34
Spart Moscow,4183,3,9,6,5,39,29,10,33
Zenit,4183,4,7,9,4,21,14,7,30
Krasnodar,4183,5,8,6,6,29,26,3,30
Terek Grozny,4183,6,8,5,7,23,26,-3,29
Din Moscow,4183,7,7,6,7,20,22,-2,27
FK Rubin,4183,8,5,6,9,23,20,3,21
Amkar,4183,9,5,5,10,13,23,-10,20
Rostov,4183,10,4,6,10,11,21,-10,18
Anzhi,4183,11,3,5,12,16,40,-24,14
Loko Moscow,4184,1,11,5,4,29,14,15,38
CSKA Moscow,4184,2,10,5,5,26,18,8,35
Zenit,4184,3,8,9,3,23,13,10,33
Krasnodar,4184,4,9,5,6,29,25,4,32
Spart Moscow,4184,5,8,7,5,36,29,7,31
Terek Grozny,4184,6,7,6,7,20,25,-5,27
FK Rubin,4184,7,6,6,8,24,19,5,24
Din Moscow,4184,8,5,7,8,19,24,-5,22
Amkar,4184,9,6,4,10,13,22,-9,22
Rostov,4184,10,4,7,9,12,19,-7,19
Anzhi,4184,11,2,7,11,15,38,-23,13
Loko Moscow,4185,1,12,6,2,33,13,20,42
CSKA Moscow,4185,2,11,3,6,28,20,8,36
Spart Moscow,4185,3,9,7,4,40,30,10,34
Zenit,4185,4,8,9,3,26,16,10,33
Terek Grozny,4185,5,8,6,6,22,23,-1,30
Krasnodar,4185,6,8,4,8,29,30,-1,28
Din Moscow,4185,7,6,7,7,23,25,-2,25
FK Rubin,4185,8,6,5,9,26,22,4,23
Rostov,4185,9,4,7,9,11,18,-7,19
Amkar,4185,10,4,5,11,11,26,-15,17
Anzhi,4185,11,2,5,13,14,40,-26,11
Loko Moscow,4186,1,12,6,2,34,15,19,42
CSKA Moscow,4186,2,11,3,6,30,19,11,36
Spart Moscow,4186,3,9,6,5,37,28,9,33
Zenit,4186,4,8,8,4,24,15,9,32
Krasnodar,4186,5,8,6,6,30,27,3,30
Terek Grozny,4186,6,8,6,6,24,24,0,30
Din Moscow,4186,7,6,6,8,20,25,-5,24
FK Rubin,4186,8,5,6,9,22,19,3,21
Rostov,4186,9,5,6,9,12,18,-6,21
Amkar,4186,10,4,6,10,10,23,-13,18
Anzhi,4186,11,2,5,13,15,45,-30,11
Loko Moscow,4187,1,11,7,2,31,13,18,40
CSKA Moscow,4187,2,12,3,5,31,20,11,39
Spart Moscow,4187,3,10,6,4,36,25,11,36
Zenit,4187,4,7,9,4,23,17,6,30
Krasnodar,4187,5,8,5,7,28,26,2,29
Terek Grozny,4187,6,7,5,8,22,27,-5,26
FK Rubin,4187,7,6,6,8,22,17,5,24
Din Moscow,4187,8,5,8,7,17,21,-4,23
Amkar,4187,9,5,4,11,12,25,-13,19
Rostov,4187,10,4,6,10,10,18,-8,18
Anzhi,4187,11,3,5,12,18,41,-23,14
Loko Moscow,4188,1,12,6,2,31,12,19,42
CSKA Moscow,4188,2,11,3,6,29,19,10,36
Zenit,4188,3,8,8,4,24,16,8,32
Krasnodar,4188,4,9,5,6,29,24,5,32
Terek Grozny,4188,5,9,5,6,23,23,0,32
Spart Moscow,4188,6,8,6,6,34,30,4,30
Din Moscow,4188,7,6,7,7,19,21,-2,25
FK Rubin,4188,8,5,6,9,21,19,2,21
Rostov,4188,9,5,6,9,12,17,-5,21
Amkar,4188,10,4,5,11,10,24,-14,17
Anzhi,4188,11,2,5,13,15,42,-27,11
Loko Moscow,4189,1,12,5,3,32,12,20,41
CSKA Moscow,4189,2,12,3,5,30,17,13,39
Krasnodar,4189,3,10,4,6,30,24,6,34
Spart Moscow,4189,4,9,6,5,38,27,11,33
Terek Grozny,4189,5,9,5,6,22,22,0,32
Zenit,4189,6,7,8,5,21,19,2,29
Din Moscow,4189,7,6,6,8,19,26,-7,24
FK Rubin,4189,8,5,5,10,22,21,1,20
Rostov,4189,9,4,7,9,11,18,-7,19
Amkar,4189,10,5,4,11,10,23,-13,19
Anzhi,4189,11,2,5,13,14,40,-26,11
Loko Moscow,4190,1,11,5,4,31,15,16,38
Zenit,4190,2,9,8,3,25,13,12,35
Spart Moscow,4190,3,9,7,4,35,26,9,34
Krasnodar,4190,4,10,4,6,31,26,5,34
CSKA Moscow,4190,5,10,4,6,26,21,5,34
Terek Grozny,4190,6,7,6,7,22,27,-5,27
Din Moscow,4190,7,5,8,7,19,23,-4,23
FK Rubin,4190,8,5,6,9,22,19,3,21
Amkar,4190,9,5,5,10,13,23,-10,20
Rostov,4190,10,4,6,10,10,18,-8,18
Anzhi,4190,11,2,7,11,16,39,-23,13
Loko Moscow,4191,1,13,5,2,36,14,22,44
CSKA Moscow,4191,2,12,3,5,29,19,10,39
Spart Moscow,4191,3,10,6,4,37,25,12,36
Krasnodar,4191,4,9,4,7,31,29,2,31
Zenit,4191,5,7,8,5,22,16,6,29
Terek Grozny,4191,6,8,5,7,23,26,-3,29
FK Rubin,4191,7,6,5,9,22,19,3,23
Din Moscow,4191,8,5,7,8,17,22,-5,22
Amkar,4191,9,5,4,11,11,23,-12,19
Rostov,4191,10,4,6,10,10,20,-10,18
Anzhi,4191,11,2,5,13,18,43,-25,11
Loko Moscow,4192,1,12,5,3,31,13,18,41
CSKA Moscow,4192,2,11,4,5,27,17,10,37
Spart Moscow,4192,3,9,6,5,39,28,11,33
Krasnodar,4192,4,9,5,6,30,26,4,32
Zenit,4192,5,7,9,4,22,15,7,30
Terek Grozny,4192,6,7,7,6,21,23,-2,28
Din Moscow,4192,7,5,8,7,19,23,-4,23
FK Rubin,4192,8,5,7,8,24,20,4,22
Amkar,4192,9,5,5,10,11,23,-12,20
Rostov,4192,10,4,6,10,10,21,-11,18
Anzhi,4192,11,2,6,12,15,40,-25,12
Loko Moscow,4193,1,11,6,3,29,14,15,39
CSKA Moscow,4193,2,11,4,5,30,19,11,37
Zenit,4193,3,8,9,3,25,14,11,33
Spart Moscow,4193,4,9,6,5,35,27,8,33
Krasnodar,4193,5,8,6,6,29,26,3,30
Terek Grozny,4193,6,8,5,7,24,26,-2,29
Din Moscow,4193,7,5,8,7,17,21,-4,23
FK Rubin,4193,8,5,7,8,23,19,4,22
Amkar,4193,9,5,4,11,11,23,-12,19
Rostov,4193,10,4,6,10,10,19,-9,18
Anzhi,4193,11,3,5,12,19,44,-25,14
Loko Moscow,4194,1,11,6,3,29,12,17,39
CSKA Moscow,4194,2,12,3,5,29,17,12,39
Spart Moscow,4194,3,9,5,6,38,32,6,32
Krasnodar,4194,4,9,5,6,28,24,4,32
Zenit,4194,5,7,9,4,21,14,7,30
Terek Grozny,4194,6,7,5,8,21,26,-5,26
FK Rubin,4194,7,6,6,8,24,17,7,24
Din Moscow,4194,8,6,6,8,19,25,-6,24
Amkar,4194,9,6,4,10,15,24,-9,22
Rostov,4194,10,4,6,10,11,20,-9,18
Anzhi,4194,11,3,5,12,16,40,-24,14
CSKA Moscow,4195,1,12,3,5,30,18,12,39
Loko Moscow,4195,2,11,5,4,31,15,16,38
Krasnodar,4195,3,10,4,6,31,26,5,34
Spart Moscow,4195,4,9,6,5,35,26,9,33
Zenit,4195,5,8,8,4,24,16,8,32
Terek Grozny,4195,6,7,6,7,22,27,-5,27
Din Moscow,4195,7,6,6,8,18,23,-5,24
Rostov,4195,8,5,6,9,11,17,-6,21
FK Rubin,4195,9,5,5,10,22,20,2,20
Amkar,4195,10,5,5,10,12,22,-10,20
Anzhi,4195,11,2,6,12,16,42,-26,12
Loko Moscow,4196,1,11,6,3,29,12,17,39
Spart Moscow,4196,2,11,5,4,40,27,13,38
CSKA Moscow,4196,3,11,4,5,30,18,12,37
Zenit,4196,4,7,10,3,22,14,8,31
Krasnodar,4196,5,9,4,7,29,26,3,31
Terek Grozny,4196,6,7,5,8,22,27,-5,26
FK Rubin,4196,7,6,6,8,23,18,5,24
Din Moscow,4196,8,5,7,8,17,23,-6,22
Amkar,4196,9,5,4,11,14,27,-13,19
Rostov,4196,10,4,6,10,10,19,-9,18
Anzhi,4196,11,3,5,12,16,41,-25,14
Loko Moscow,4197,1,11,7,2,31,13,18,40
Spart Moscow,4197,2,10,6,4,42,27,15,36
CSKA Moscow,4197,3,10,4,6,27,20,7,34
Zenit,4197,4,8,9,3,23,14,9,33
Krasnodar,4197,5,9,5,6,30,26,4,32
Terek Grozny,4197,6,7,6,7,23,27,-4,27
FK Rubin,4197,7,6,5,9,23,19,4,23
Din Moscow,4197,8,5,6,9,17,27,-10,21
Rostov,4197,9,4,6,10,11,20,-9,18
Amkar,4197,10,4,6,10,11,24,-13,18
Anzhi,4197,11,3,6,11,20,41,-21,15
Loko Moscow,4198,1,11,7,2,29,11,18,40
Spart Moscow,4198,2,10,6,4,37,26,11,36
CSKA Moscow,4198,3,11,3,6,29,18,11,36
Zenit,4198,4,8,9,3,22,13,9,33
Terek Grozny,4198,5,9,5,6,23,22,1,32
Krasnodar,4198,6,8,6,6,27,24,3,30
FK Rubin,4198,7,6,6,8,22,17,5,24
Din Moscow,4198,8,5,6,9,17,23,-6,21
Rostov,4198,9,4,7,9,11,18,-7,19
Amkar,4198,10,4,4,12,9,25,-16,16
Anzhi,4198,11,2,5,13,14,43,-29,11
Loko Moscow,4199,1,11,6,3,30,15,15,39
Spart Moscow,4199,2,11,5,4,39,27,12,38
CSKA Moscow,4199,3,11,3,6,27,19,8,36
Krasnodar,4199,4,9,4,7,30,26,4,31
Zenit,4199,5,7,9,4,22,16,6,30
Terek Grozny,4199,6,8,5,7,22,24,-2,29
Din Moscow,4199,7,6,6,8,22,25,-3,24
FK Rubin,4199,8,6,5,9,23,20,3,23
Amkar,4199,9,5,4,11,10,23,-13,19
Rostov,4199,10,4,6,10,10,18,-8,18
Anzhi,4199,11,3,5,12,17,39,-22,14
Loko Moscow,4200,1,11,6,3,30,14,16,39
CSKA Moscow,4200,2,12,3,5,29,17,12,39
Krasnodar,4200,3,10,4,6,34,26,8,34
Spart Moscow,4200,4,9,5,6,35,29,6,32
Terek Grozny,4200,5,9,5,6,25,23,2,32
Zenit,4200,6,7,9,4,21,14,7,30
Din Moscow,4200,7,6,7,7,20,23,-3,25
FK Rubin,4200,8,5,6,9,23,22,1,21
Amkar,4200,9,5,4,11,12,25,-13,19
Rostov,4200,10,4,6,10,10,18,-8,18
Anzhi,4200,11,2,5,13,14,42,-28,11
Loko Moscow,4201,1,11,6,3,30,15,15,39
CSKA Moscow,4201,2,11,3,6,26,18,8,36
Krasnodar,4201,3,10,4,6,31,24,7,34
Spart Moscow,4201,4,9,6,5,37,28,9,33
Zenit,4201,5,8,9,3,23,14,9,33
Terek Grozny,4201,6,7,7,6,22,24,-2,28
FK Rubin,4201,7,6,5,9,23,18,5,23
Din Moscow,4201,8,5,7,8,17,23,-6,22
Rostov,4201,9,5,6,9,13,19,-6,21
Amkar,4201,10,4,5,11,10,25,-15,17
Anzhi,4201,11,2,6,12,15,39,-24,12
Loko Moscow,4202,1,12,5,3,30,12,18,41
Spart Moscow,4202,2,11,5,4,42,27,15,38
CSKA Moscow,4202,3,11,3,6,30,21,9,36
Zenit,4202,4,9,8,3,25,13,12,35
Krasnodar,4202,5,9,4,7,29,26,3,31
Terek Grozny,4202,6,8,5,7,22,24,-2,29
FK Rubin,4202,7,6,5,9,24,19,5,23
Din Moscow,4202,8,5,6,9,18,27,-9,21
Amkar,4202,9,5,4,11,11,26,-15,19
Rostov,4202,10,4,6,10,10,18,-8,18
Anzhi,4202,11,2,5,13,16,44,-28,11
Loko Moscow,4203,1,12,5,3,33,14,19,41
Spart Moscow,4203,2,10,6,4,39,27,12,36
CSKA Moscow,4203,3,10,3,7,26,20,6,33
Zenit,4203,4,8,8,4,22,15,7,32
Krasnodar,4203,5,9,5,6,31,27,4,32
Terek Grozny,4203,6,7,6,7,21,26,-5,27
Din Moscow,4203,7,5,8,7,20,24,-4,23
FK Rubin,4203,8,5,7,8,24,20,4,22
Amkar,4203,9,5,4,11,12,25,-13,19
Rostov,4203,10,4,6,10,11,19,-8,18
Anzhi,4203,11,3,6,11,17,39,-22,15
Loko Moscow,4204,1,13,5,2,34,12,22,44
CSKA Moscow,4204,2,12,3,5,28,17,11,39
Spart Moscow,4204,3,10,6,4,37,26,11,36
Terek Grozny,4204,4,9,5,6,23,23,0,32
Zenit,4204,5,7,8,5,22,16,6,29
Krasnodar,4204,6,8,4,8,28,29,-1,28
FK Rubin,4204,7,6,6,8,25,20,5,24
Din Moscow,4204,8,5,7,8,19,25,-6,22
Rostov,4204,9,4,6,10,10,18,-8,18
Amkar,4204,10,4,5,11,10,24,-14,17
Anzhi,4204,11,2,5,13,15,41,-26,11
Loko Moscow,4205,1,12,5,3,33,16,17,41
Spart Moscow,4205,2,10,6,4,40,28,12,36
CSKA Moscow,4205,3,10,3,7,25,21,4,33
Zenit,4205,4,8,8,4,23,15,8,32
Krasnodar,4205,5,9,4,7,32,27,5,31
Terek Grozny,4205,6,7,5,8,21,25,-4,26
Din Moscow,4205,7,6,6,8,19,23,-4,24
FK Rubin,4205,8,6,5,9,22,18,4,23
Amkar,4205,9,5,5,10,12,24,-12,20
Rostov,4205,10,4,6,10,10,20,-10,18
Anzhi,4205,11,4,5,11,18,38,-20,17
Loko Moscow,4206,1,11,5,4,29,13,16,38
CSKA Moscow,4206,2,11,4,5,29,18,11,37
Zenit,4206,3,8,9,3,23,14,9,33
Spart Moscow,4206,4,9,6,5,38,30,8,33
Krasnodar,4206,5,9,5,6,30,26,4,32
Terek Grozny,4206,6,8,6,6,21,22,-1,30
Din Moscow,4206,7,6,6,8,20,24,-4,24
FK Rubin,4206,8,5,6,9,23,20,3,21
Amkar,4206,9,5,5,10,11,23,-12,20
Rostov,4206,10,4,7,9,11,18,-7,19
Anzhi,4206,11,2,5,13,14,41,-27,11
Loko Moscow,4207,1,12,6,2,34,12,22,42
CSKA Moscow,4207,2,11,3,6,28,18,10,36
Spart Moscow,4207,3,8,7,5,36,29,7,31
Zenit,4207,4,7,9,4,22,17,5,30
Krasnodar,4207,5,8,4,8,27,29,-2,28
Terek Grozny,4207,6,7,6,7,21,25,-4,27
Din Moscow,4207,7,6,7,7,21,22,-1,25
FK Rubin,4207,8,6,5,9,23,21,2,23
Rostov,4207,9,5,6,9,12,18,-6,21
Amkar,4207,10,5,5,10,13,24,-11,20
Anzhi,4207,11,3,6,11,16,38,-22,15
Loko Moscow,4208,1,12,5,3,31,13,18,41
Spart Moscow,4208,2,10,6,4,42,28,14,36
CSKA Moscow,4208,3,11,3,6,30,20,10,36
Zenit,4208,4,8,8,4,23,14,9,32
Krasnodar,4208,5,9,5,6,30,26,4,32
Terek Grozny,4208,6,8,5,7,23,25,-2,29
FK Rubin,4208,7,5,7,8,22,18,4,22
Din Moscow,4208,8,5,7,8,18,26,-8,22
Rostov,4208,9,4,7,9,12,19,-7,19
Amkar,4208,10,4,4,12,10,26,-16,16
Anzhi,4208,11,3,5,12,17,43,-26,14
Loko Moscow,4209,1,12,5,3,31,14,17,41
Spart Moscow,4209,2,10,6,4,39,28,11,36
CSKA Moscow,4209,3,11,3,6,26,18,8,36
Zenit,4209,4,8,8,4,22,14,8,32
Krasnodar,4209,5,9,4,7,31,27,4,31
Terek Grozny,4209,6,8,6,6,23,24,-1,30
Din Moscow,4209,7,6,6,8,20,24,-4,24
FK Rubin,4209,8,6,5,9,23,19,4,23
Rostov,4209,9,4,6,10,10,19,-9,18
Amkar,4209,10,4,5,11,10,24,-14,17
Anzhi,4209,11,2,6,12,16,40,-24,12
Loko Moscow,4210,1,12,6,2,32,12,20,42
CSKA Moscow,4210,2,11,3,6,30,19,11,36
Spart Moscow,4210,3,9,6,5,40,31,9,33
Zenit,4210,4,8,9,3,24,15,9,33
Terek Grozny,4210,5,8,6,6,25,24,1,30
Krasnodar,4210,6,8,4,8,27,27,0,28
FK Rubin,4210,7,6,6,8,22,17,5,24
Din Moscow,4210,8,5,8,7,20,24,-4,23
Rostov,4210,9,5,6,9,12,18,-6,21
Amkar,4210,10,4,5,11,11,26,-15,17
Anzhi,4210,11,2,5,13,15,45,-30,11
Loko Moscow,4211,1,12,6,2,32,12,20,42
CSKA Moscow,4211,2,12,3,5,31,19,12,39
Spart Moscow,4211,3,10,5,5,37,26,11,35
Krasnodar,4211,4,8,6,6,29,26,3,30
Zenit,4211,5,7,8,5,22,17,5,29
Terek Grozny,4211,6,7,6,7,22,25,-3,27
Din Moscow,4211,7,6,6,8,19,24,-5,24
FK Rubin,4211,8,5,6,9,23,20,3,21
Rostov,4211,9,5,6,9,11,17,-6,21
Amkar,4211,10,5,4,11,11,25,-14,19
Anzhi,4211,11,2,6,12,16,42,-26,12
Loko Moscow,4212,1,11,6,3,30,13,17,39
Spart Moscow,4212,2,11,5,4,39,27,12,38
CSKA Moscow,4212,3,11,3,6,26,18,8,36
Zenit,4212,4,8,9,3,23,14,9,33
Krasnodar,4212,5,9,5,6,29,25,4,32
Terek Grozny,4212,6,7,6,7,20,24,-4,27
FK Rubin,4212,7,5,7,8,22,18,4,22
Din Moscow,4212,8,5,7,8,17,23,-6,22
Amkar,4212,9,5,4,11,12,24,-12,19
Rostov,4212,10,4,6,10,11,19,-8,18
Anzhi,4212,11,2,6,12,14,38,-24,12
Loko Moscow,4213,1,11,7,2,32,14,18,40
CSKA Moscow,4213,2,11,3,6,26,19,7,36
Zenit,4213,3,8,9,3,25,15,10,33
Spart Moscow,4213,4,9,6,5,36,29,7,33
Krasnodar,4213,5,8,6,6,29,26,3,30
Din Moscow,4213,6,7,6,7,21,22,-1,27
Terek Grozny,4213,7,7,5,8,22,28,-6,26
FK Rubin,4213,8,5,6,9,22,19,3,21
Amkar,4213,9,5,5,10,14,24,-10,20
Rostov,4213,10,4,6,10,10,18,-8,18
Anzhi,4213,11,3,5,12,16,39,-23,14
Loko Moscow,4214,1,12,5,3,33,15,18,41
CSKA Moscow,4214,2,12,3,5,28,17,11,39
Krasnodar,4214,3,10,4,6,30,25,5,34
Spart Moscow,4214,4,9,5,6,36,27,9,32
Zenit,4214,5,7,8,5,23,17,6,29
Terek Grozny,4214,6,7,6,7,22,25,-3,27
Din Moscow,4214,7,6,6,8,18,23,-5,24
FK Rubin,4214,8,6,5,9,23,18,5,23
Amkar,4214,9,6,4,10,11,22,-11,22
Rostov,4214,10,4,6,10,10,20,-10,18
Anzhi,4214,11,2,6,12,16,41,-25,12
Loko Moscow,4215,1,12,5,3,33,13,20,41
Spart Moscow,4215,2,10,6,4,36,25,11,36
CSKA Moscow,4215,3,11,3,6,26,18,8,36
Zenit,4215,4,9,8,3,24,14,10,35
Terek Grozny,4215,5,8,6,6,24,24,0,30
Krasnodar,4215,6,8,5,7,29,29,0,29
FK Rubin,4215,7,5,7,8,24,20,4,22
Din Moscow,4215,8,5,7,8,18,23,-5,22
Rostov,4215,9,4,6,10,10,19,-9,18
Amkar,4215,10,4,5,11,10,25,-15,17
Anzhi,4215,11,2,6,12,15,39,-24,12
Loko Moscow,4216,1,11,6,3,29,12,17,39
CSKA Moscow,4216,2,12,3,5,30,20,10,39
Spart Moscow,4216,3,9,7,4,37,26,11,34
Krasnodar,4216,4,9,5,6,30,26,4,32
Zenit,4216,5,7,9,4,23,16,7,30
Terek Grozny,4216,6,7,5,8,22,26,-4,26
Din Moscow,4216,7,6,7,7,19,22,-3,25
FK Rubin,4216,8,5,6,9,24,21,3,21
Amkar,4216,9,5,5,10,12,24,-12,20
Rostov,4216,10,4,6,10,10,20,-10,18
Anzhi,4216,11,3,5,12,17,40,-23,14
Loko Moscow,4217,1,11,6,3,30,13,17,39
CSKA Moscow,4217,2,12,3,5,30,20,10,39
Spart Moscow,4217,3,10,6,4,38,28,10,36
Krasnodar,4217,4,9,5,6,29,25,4,32
Zenit,4217,5,7,9,4,23,16,7,30
Terek Grozny,4217,6,7,6,7,21,24,-3,27
Din Moscow,4217,7,6,6,8,20,24,-4,24
FK Rubin,4217,8,5,6,9,23,20,3,21
Rostov,4217,9,4,7,9,12,19,-7,19
Amkar,4217,10,5,4,11,10,23,-13,19
Anzhi,4217,11,2,6,12,17,41,-24,12
Loko Moscow,4218,1,11,5,4,33,17,16,38
Spart Moscow,4218,2,10,5,5,40,28,12,35
Zenit,4218,3,9,8,3,29,18,11,35
CSKA Moscow,4218,4,10,4,6,27,21,6,34
Krasnodar,4218,5,10,4,6,30,25,5,34
Terek Grozny,4218,6,8,6,6,25,24,1,30
FK Rubin,4218,7,6,5,9,24,19,5,23
Rostov,4218,8,5,6,9,11,17,-6,21
Din Moscow,4218,9,5,6,9,18,28,-10,21
Amkar,4218,10,4,5,11,11,25,-14,17
Anzhi,4218,11,2,6,12,16,42,-26,12
Loko Moscow,4219,1,11,7,2,30,12,18,40
CSKA Moscow,4219,2,11,4,5,29,18,11,37
Spart Moscow,4219,3,10,6,4,39,29,10,36
Zenit,4219,4,7,10,3,22,14,8,31
Krasnodar,4219,5,8,5,7,28,26,2,29
Terek Grozny,4219,6,7,6,7,22,25,-3,27
Din Moscow,4219,7,6,6,8,21,24,-3,24
FK Rubin,4219,8,6,5,9,23,20,3,23
Amkar,4219,9,5,5,10,11,23,-12,20
Rostov,4219,10,4,6,10,12,20,-8,18
Anzhi,4219,11,2,6,12,16,42,-26,12
Loko Moscow,4220,1,12,5,3,32,15,17,41
CSKA Moscow,4220,2,12,3,5,27,17,10,39
Spart Moscow,4220,3,9,7,4,35,26,9,34
Krasnodar,4220,4,10,4,6,32,25,7,34
Terek Grozny,4220,5,8,6,6,23,24,-1,30
Zenit,4220,6,7,8,5,22,16,6,29
FK Rubin,4220,7,6,5,9,22,19,3,23
Din Moscow,4220,8,5,7,8,17,22,-5,22
Rostov,4220,9,4,6,10,10,18,-8,18
Amkar,4220,10,4,5,11,11,25,-14,17
Anzhi,4220,11,2,6,12,15,39,-24,12
Loko Moscow,4221,1,12,5,3,32,14,18,41
CSKA Moscow,4221,2,11,4,5,28,18,10,37
Krasnodar,4221,3,10,4,6,31,25,6,34
Spart Moscow,4221,4,9,6,5,35,27,8,33
Terek Grozny,4221,5,8,6,6,25,26,-1,30
Zenit,4221,6,7,8,5,23,18,5,29
Din Moscow,4221,7,6,6,8,21,24,-3,24
FK Rubin,4221,8,5,5,10,22,23,-1,20
Rostov,4221,9,4,7,9,10,17,-7,19
Amkar,4221,10,5,4,11,12,24,-12,19
Anzhi,4221,11,2,7,11,17,40,-23,13
Loko Moscow,4222,1,11,5,4,31,15,16,38
Spart Moscow,4222,2,11,5,4,40,27,13,38
CSKA Moscow,4222,3,11,3,6,30,21,9,36
Zenit,4222,4,9,8,3,28,17,11,35
Krasnodar,4222,5,9,5,6,29,25,4,32
Terek Grozny,4222,6,8,5,7,22,24,-2,29
FK Rubin,4222,7,6,6,8,23,18,5,24
Din Moscow,4222,8,5,6,9,18,26,-8,21
Amkar,4222,9,5,4,11,10,23,-13,19
Rostov,4222,10,4,6,10,11,19,-8,18
Anzhi,4222,11,2,5,13,15,42,-27,11
Loko Moscow,4223,1,12,6,2,33,13,20,42
CSKA Moscow,4223,2,10,5,5,27,19,8,35
Spart Moscow,4223,3,8,6,6,36,30,6,30
Zenit,4223,4,7,9,4,23,17,6,30
Krasnodar,4223,5,8,5,7,30,28,2,29
Terek Grozny,4223,6,7,5,8,20,24,-4,26
Din Moscow,4223,7,6,7,7,20,22,-2,25
FK Rubin,4223,8,6,5,9,25,22,3,23
Amkar,4223,9,6,4,10,14,25,-11,22
Rostov,4223,10,5,6,9,11,17,-6,21
Anzhi,4223,11,3,6,11,16,38,-22,15
Loko Moscow,4224,1,12,5,3,30,13,17,41
CSKA Moscow,4224,2,11,3,6,28,21,7,36
Zenit,4224,3,8,8,4,24,15,9,32
Spart Moscow,4224,4,9,5,6,37,29,8,32
Krasnodar,4224,5,9,4,7,29,25,4,31
Terek Grozny,4224,6,8,5,7,25,27,-2,29
FK Rubin,4224,7,7,5,8,25,19,6,26
Amkar,4224,8,6,4,10,14,25,-11,22
Rostov,4224,9,5,6,9,12,18,-6,21
Din Moscow,4224,10,5,6,9,20,27,-7,21
Anzhi,4224,11,2,5,13,16,41,-25,11
Loko Moscow,4225,1,12,5,3,33,14,19,41
CSKA Moscow,4225,2,12,3,5,29,18,11,39
Krasnodar,4225,3,10,4,6,30,25,5,34
Spart Moscow,4225,4,9,5,6,34,27,7,32
Zenit,4225,5,7,8,5,22,18,4,29
Din Moscow,4225,6,7,6,7,20,22,-2,27
Terek Grozny,4225,7,7,6,7,20,23,-3,27
FK Rubin,4225,8,5,5,10,22,20,2,20
Amkar,4225,9,5,5,10,10,22,-12,20
Rostov,4225,10,4,6,10,10,18,-8,18
Anzhi,4225,11,3,5,12,16,39,-23,14
Loko Moscow,4226,1,11,6,3,31,14,17,39
Spart Moscow,4226,2,11,5,4,40,28,12,38
Zenit,4226,3,9,8,3,24,14,10,35
CSKA Moscow,4226,4,10,3,7,26,20,6,33
Krasnodar,4226,5,8,6,6,29,26,3,30
Terek Grozny,4226,6,7,7,6,22,24,-2,28
FK Rubin,4226,7,6,6,8,25,19,6,24
Din Moscow,4226,8,5,6,9,19,26,-7,21
Rostov,4226,9,4,6,10,11,19,-8,18
Amkar,4226,10,4,5,11,11,26,-15,17
Anzhi,4226,11,3,6,11,17,39,-22,15
Loko Moscow,4227,1,12,6,2,32,13,19,42
CSKA Moscow,4227,2,11,4,5,27,18,9,37
Spart Moscow,4227,3,10,5,5,37,26,11,35
Zenit,4227,4,7,9,4,22,15,7,30
Krasnodar,4227,5,8,5,7,30,28,2,29
Terek Grozny,4227,6,8,5,7,24,25,-1,29
FK Rubin,4227,7,5,7,8,23,19,4,22
Din Moscow,4227,8,5,7,8,17,22,-5,22
Amkar,4227,9,6,4,10,12,23,-11,22
Rostov,4227,10,4,6,10,10,20,-10,18
Anzhi,4227,11,2,6,12,16,41,-25,12
Loko Moscow,4228,1,11,5,4,29,14,15,38
CSKA Moscow,4228,2,11,4,5,28,19,9,37
Spart Moscow,4228,3,10,5,5,42,29,13,35
Krasnodar,4228,4,10,4,6,32,25,7,34
Zenit,4228,5,8,9,3,23,14,9,33
Terek Grozny,4228,6,7,6,7,21,26,-5,27
Din Moscow,4228,7,6,6,8,19,27,-8,24
Amkar,4228,8,6,4,10,16,24,-8,22
FK Rubin,4228,9,5,5,10,22,21,1,20
Rostov,4228,10,4,6,10,10,19,-9,18
Anzhi,4228,11,2,6,12,15,39,-24,12
Loko Moscow,4229,1,12,6,2,34,13,21,42
Spart Moscow,4229,2,11,5,4,40,28,12,38
CSKA Moscow,4229,3,11,4,5,27,18,9,37
Zenit,4229,4,7,9,4,22,17,5,30
Krasnodar,4229,5,8,6,6,29,26,3,30
Terek Grozny,4229,6,7,6,7,20,25,-5,27
FK Rubin,4229,7,6,6,8,24,19,5,24
Din Moscow,4229,8,5,6,9,21,27,-6,21
Rostov,4229,9,4,6,10,10,19,-9,18
Amkar,4229,10,4,5,11,10,24,-14,17
Anzhi,4229,11,3,5,12,17,38,-21,14
Loko Moscow,4230,1,11,5,4,29,14,15,38
CSKA Moscow,4230,2,10,5,5,26,18,8,35
Krasnodar,4230,3,10,4,6,33,27,6,34
Spart Moscow,4230,4,9,6,5,40,31,9,33
Zenit,4230,5,8,9,3,22,13,9,33
Terek Grozny,4230,6,8,6,6,22,23,-1,30
Din Moscow,4230,7,5,7,8,19,25,-6,22
FK Rubin,4230,8,5,6,9,24,21,3,21
Amkar,4230,9,5,5,10,13,25,-12,20
Rostov,4230,10,4,7,9,11,18,-7,19
Anzhi,4230,11,2,6,12,15,39,-24,12
Loko Moscow,4231,1,11,6,3,30,13,17,39
CSKA Moscow,4231,2,12,3,5,29,19,10,39
Spart Moscow,4231,3,11,5,4,40,27,13,38
Krasnodar,4231,4,10,4,6,29,24,5,34
Zenit,4231,5,7,9,4,23,16,7,30
Terek Grozny,4231,6,8,5,7,23,25,-2,29
Din Moscow,4231,7,5,7,8,18,23,-5,22
FK Rubin,4231,8,5,6,9,21,18,3,21
Amkar,4231,9,5,4,11,12,25,-13,19
Rostov,4231,10,4,6,10,10,20,-10,18
Anzhi,4231,11,2,5,13,16,41,-25,11
Loko Moscow,4232,1,12,5,3,33,14,19,41
Spart Moscow,4232,2,11,5,4,39,26,13,38
CSKA Moscow,4232,3,10,5,5,26,18,8,35
Krasnodar,4232,4,9,4,7,29,26,3,31
Zenit,4232,5,7,9,4,23,17,6,30
Terek Grozny,4232,6,8,5,7,24,25,-1,29
Din Moscow,4232,7,6,6,8,18,23,-5,24
FK Rubin,4232,8,6,5,9,23,19,4,23
Amkar,4232,9,5,4,11,11,24,-13,19
Rostov,4232,10,4,6,10,10,19,-9,18
Anzhi,4232,11,2,6,12,17,42,-25,12
Loko Moscow,4233,1,11,6,3,32,15,17,39
CSKA Moscow,4233,2,11,4,5,27,18,9,37
Spart Moscow,4233,3,10,5,5,39,32,7,35
Zenit,4233,4,8,9,3,24,15,9,33
Krasnodar,4233,5,9,5,6,30,25,5,32
Terek Grozny,4233,6,8,5,7,25,24,1,29
FK Rubin,4233,7,6,5,9,24,21,3,23
Amkar,4233,8,6,4,10,17,23,-6,22
Din Moscow,4233,9,5,6,9,20,28,-8,21
Rostov,4233,10,4,6,10,10,19,-9,18
Anzhi,4233,11,2,5,13,15,43,-28,11
Loko Moscow,4234,1,12,6,2,30,11,19,42
Spart Moscow,4234,2,10,5,5,40,29,11,35
CSKA Moscow,4234,3,10,5,5,26,18,8,35
Zenit,4234,4,7,9,4,21,14,7,30
Krasnodar,4234,5,8,6,6,27,24,3,30
Terek Grozny,4234,6,8,5,7,23,24,-1,29
FK Rubin,4234,7,6,6,8,25,17,8,24
Din Moscow,4234,8,6,6,8,19,26,-7,24
Amkar,4234,9,5,4,11,11,26,-15,19
Rostov,4234,10,4,6,10,11,19,-8,18
Anzhi,4234,11,2,6,12,16,41,-25,12
Loko Moscow,4235,1,12,5,3,30,12,18,41
CSKA Moscow,4235,2,12,3,5,28,17,11,39
Spart Moscow,4235,3,11,5,4,41,25,16,38
Krasnodar,4235,4,9,5,6,28,24,4,32
Terek Grozny,4235,5,8,6,6,23,23,0,30
Zenit,4235,6,7,8,5,21,15,6,29
FK Rubin,4235,7,6,6,8,24,18,6,24
Din Moscow,4235,8,5,6,9,18,27,-9,21
Rostov,4235,9,4,6,10,10,20,-10,18
Amkar,4235,10,4,5,11,10,25,-15,17
Anzhi,4235,11,2,5,13,14,41,-27,11
Loko Moscow,4236,1,13,5,2,33,12,21,44
Spart Moscow,4236,2,11,5,4,40,26,14,38
CSKA Moscow,4236,3,11,4,5,26,17,9,37
Terek Grozny,4236,4,8,6,6,22,23,-1,30
Zenit,4236,5,7,8,5,21,16,5,29
Krasnodar,4236,6,8,5,7,29,27,2,29
Din Moscow,4236,7,6,6,8,18,25,-7,24
FK Rubin,4236,8,5,6,9,22,19,3,21
Rostov,4236,9,4,6,10,11,19,-8,18
Amkar,4236,10,4,4,12,9,24,-15,16
Anzhi,4236,11,2,7,11,15,38,-23,13
Loko Moscow,4237,1,12,5,3,31,13,18,41
Spart Moscow,4237,2,10,6,4,40,28,12,36
Zenit,4237,3,9,8,3,23,13,10,35
CSKA Moscow,4237,4,10,4,6,26,19,7,34
Terek Grozny,4237,5,9,5,6,23,22,1,32
Krasnodar,4237,6,8,4,8,28,27,1,28
FK Rubin,4237,7,7,5,8,25,18,7,26
Din Moscow,4237,8,5,6,9,19,27,-8,21
Rostov,4237,9,4,6,10,11,20,-9,18
Amkar,4237,10,4,5,11,10,24,-14,17
Anzhi,4237,11,2,6,12,15,40,-25,12
Loko Moscow,4238,1,11,5,4,31,15,16,38
CSKA Moscow,4238,2,11,3,6,27,20,7,36
Zenit,4238,3,9,8,3,25,14,11,35
Spart Moscow,4238,4,9,6,5,35,27,8,33
Krasnodar,4238,5,9,5,6,31,27,4,32
Terek Grozny,4238,6,7,6,7,21,24,-3,27
Din Moscow,4238,7,6,7,7,20,23,-3,25
FK Rubin,4238,8,5,6,9,24,21,3,21
Rostov,4238,9,5,6,9,11,17,-6,21
Amkar,4238,10,5,4,11,10,23,-13,19
Anzhi,4238,11,2,6,12,16,40,-24,12
Loko Moscow,4239,1,11,5,4,29,15,14,38
Zenit,4239,2,9,8,3,23,13,10,35
CSKA Moscow,4239,3,10,4,6,27,20,7,34
Spart Moscow,4239,4,9,6,5,40,30,10,33
Krasnodar,4239,5,9,5,6,30,24,6,32
Terek Grozny,4239,6,7,7,6,20,22,-2,28
Din Moscow,4239,7,6,6,8,19,25,-6,24
FK Rubin,4239,8,5,6,9,21,18,3,21
Amkar,4239,9,5,5,10,11,23,-12,20
Rostov,4239,10,4,7,9,12,19,-7,19
Anzhi,4239,11,2,7,11,16,39,-23,13
Loko Moscow,4240,1,11,6,3,29,12,17,39
Spart Moscow,4240,2,10,6,4,39,26,13,36
CSKA Moscow,4240,3,11,3,6,30,20,10,36
Krasnodar,4240,4,10,4,6,29,24,5,34
Zenit,4240,5,8,9,3,24,13,11,33
Terek Grozny,4240,6,9,5,6,24,23,1,32
Din Moscow,4240,7,6,6,8,19,26,-7,24
FK Rubin,4240,8,5,5,10,22,20,2,20
Rostov,4240,9,4,7,9,10,17,-7,19
Amkar,4240,10,4,4,12,10,25,-15,16
Anzhi,4240,11,2,5,13,15,45,-30,11
Loko Moscow,4241,1,11,6,3,32,15,17,39
CSKA Moscow,4241,2,11,4,5,28,19,9,37
Spart Moscow,4241,3,10,5,5,42,31,11,35
Krasnodar,4241,4,9,5,6,32,28,4,32
Zenit,4241,5,7,10,3,22,14,8,31
Terek Grozny,4241,6,8,6,6,23,23,0,30
Din Moscow,4241,7,6,7,7,22,25,-3,25
FK Rubin,4241,8,5,7,8,23,19,4,22
Rostov,4241,9,4,6,10,12,20,-8,18
Amkar,4241,10,4,4,12,9,27,-18,16
Anzhi,4241,11,2,6,12,16,40,-24,12
Loko Moscow,4242,1,12,6,2,33,14,19,42
Spart Moscow,4242,2,10,6,4,36,25,11,36
CSKA Moscow,4242,3,10,4,6,26,19,7,34
Zenit,4242,4,8,9,3,24,15,9,33
Terek Grozny,4242,5,9,5,6,24,24,0,32
Krasnodar,4242,6,8,5,7,29,27,2,29
FK Rubin,4242,7,5,7,8,22,18,4,22
Din Moscow,4242,8,5,7,8,17,22,-5,22
Rostov,4242,9,4,7,9,10,17,-7,19
Amkar,4242,10,4,4,12,10,26,-16,16
Anzhi,4242,11,2,6,12,16,40,-24,12
Loko Moscow,4243,1,12,6,2,30,11,19,42
Spart Moscow,4243,2,9,7,4,38,28,10,34
CSKA Moscow,4243,3,10,4,6,25,18,7,34
Zenit,4243,4,8,8,4,22,14,8,32
Krasnodar,4243,5,9,5,6,30,25,5,32
Terek Grozny,4243,6,8,6,6,22,22,0,30
Din Moscow,4243,7,6,7,7,24,24,0,25
FK Rubin,4243,8,5,5,10,22,24,-2,20
Rostov,4243,9,4,6,10,10,19,-9,18
Amkar,4243,10,4,6,10,9,22,-13,18
Anzhi,4243,11,2,6,12,14,39,-25,12
Loko Moscow,4244,1,12,5,3,32,14,18,41
Krasnodar,4244,2,10,4,6,32,26,6,34
CSKA Moscow,4244,3,10,4,6,26,20,6,34
Spart Moscow,4244,4,9,6,5,37,28,9,33
Zenit,4244,5,8,8,4,23,14,9,32
Terek Grozny,4244,6,8,6,6,22,23,-1,30
FK Rubin,4244,7,6,5,9,22,19,3,23
Din Moscow,4244,8,5,7,8,18,23,-5,22
Rostov,4244,9,5,6,9,12,18,-6,21
Amkar,4244,10,4,5,11,10,25,-15,17
Anzhi,4244,11,2,6,12,15,39,-24,12
Loko Moscow,4245,1,12,6,2,32,12,20,42
Spart Moscow,4245,2,10,6,4,37,25,12,36
CSKA Moscow,4245,3,11,3,6,29,20,9,36
Zenit,4245,4,8,9,3,23,14,9,33
Terek Grozny,4245,5,8,5,7,22,24,-2,29
Krasnodar,4245,6,8,4,8,29,29,0,28
FK Rubin,4245,7,6,6,8,23,18,5,24
Din Moscow,4245,8,5,8,7,17,21,-4,23
Rostov,4245,9,4,6,10,10,20,-10,18
Amkar,4245,10,4,4,12,9,24,-15,16
Anzhi,4245,11,3,5,12,17,41,-24,14
Loko Moscow,4246,1,11,6,3,30,13,17,39
CSKA Moscow,4246,2,10,5,5,27,19,8,35
Spart Moscow,4246,3,9,7,4,38,28,10,34
Zenit,4246,4,8,9,3,23,14,9,33
Krasnodar,4246,5,9,5,6,31,25,6,32
Terek Grozny,4246,6,7,5,8,22,27,-5,26
Din Moscow,4246,7,5,7,8,17,23,-6,22
FK Rubin,4246,8,5,6,9,21,20,1,21
Amkar,4246,9,5,5,10,13,25,-12,20
Rostov,4246,10,4,7,9,12,19,-7,19
Anzhi,4246,11,3,6,11,17,38,-21,15
Loko Moscow,4247,1,11,6,3,30,14,16,39
CSKA Moscow,4247,2,11,3,6,27,18,9,36
Spart Moscow,4247,3,9,7,4,37,28,9,34
Krasnodar,4247,4,10,4,6,31,25,6,34
Zenit,4247,5,8,9,3,23,14,9,33
Terek Grozny,4247,6,9,5,6,25,25,0,32
FK Rubin,4247,7,6,5,9,23,19,4,23
Din Moscow,4247,8,5,7,8,17,22,-5,22
Rostov,4247,9,4,6,10,11,19,-8,18
Amkar,4247,10,4,5,11,12,26,-14,17
Anzhi,4247,11,2,5,13,16,42,-26,11
Loko Moscow,4248,1,11,6,3,32,15,17,39
CSKA Moscow,4248,2,10,4,6,25,18,7,34
Krasnodar,4248,3,10,4,6,30,25,5,34
Zenit,4248,4,8,9,3,24,15,9,33
Spart Moscow,4248,5,9,6,5,37,29,8,33
Terek Grozny,4248,6,7,6,7,21,26,-5,27
FK Rubin,4248,7,6,5,9,23,19,4,23
Din Moscow,4248,8,5,6,9,19,25,-6,21
Amkar,4248,9,5,5,10,13,25,-12,20
Rostov,4248,10,4,7,9,10,17,-7,19
Anzhi,4248,11,3,6,11,17,37,-20,15
Loko Moscow,4249,1,11,5,4,30,14,16,38
Zenit,4249,2,9,8,3,23,13,10,35
CSKA Moscow,4249,3,10,4,6,27,20,7,34
Krasnodar,4249,4,10,4,6,31,25,6,34
Spart Moscow,4249,5,9,5,6,35,29,6,32
Terek Grozny,4249,6,7,7,6,21,23,-2,28
Din Moscow,4249,7,6,6,8,18,23,-5,24
FK Rubin,4249,8,6,5,9,23,19,4,23
Rostov,4249,9,5,6,9,12,17,-5,21
Amkar,4249,10,4,5,11,10,24,-14,17
Anzhi,4249,11,2,7,11,17,40,-23,13
Loko Moscow,4250,1,12,5,3,34,13,21,41
Spart Moscow,4250,2,11,5,4,41,28,13,38
Krasnodar,4250,3,10,4,6,29,24,5,34
CSKA Moscow,4250,4,10,3,7,25,20,5,33
Zenit,4250,5,8,8,4,23,18,5,32
Terek Grozny,4250,6,7,6,7,21,26,-5,27
FK Rubin,4250,7,6,5,9,22,18,4,23
Din Moscow,4250,8,5,6,9,18,26,-8,21
Amkar,4250,9,5,4,11,13,24,-11,19
Rostov,4250,10,4,6,10,11,19,-8,18
Anzhi,4250,11,3,6,11,17,38,-21,15
CSKA Moscow,4251,1,12,3,5,31,19,12,39
Loko Moscow,4251,2,11,5,4,30,17,13,38
Zenit,4251,3,8,8,4,26,15,11,32
Spart Moscow,4251,4,8,7,5,35,29,6,31
Krasnodar,4251,5,9,4,7,29,28,1,31
Din Moscow,4251,6,7,6,7,22,21,1,27
Terek Grozny,4251,7,7,6,7,22,25,-3,27
FK Rubin,4251,8,6,5,9,24,20,4,23
Rostov,4251,9,4,7,9,11,18,-7,19
Amkar,4251,10,4,6,10,10,23,-13,18
Anzhi,4251,11,3,5,12,18,43,-25,14
Loko Moscow,4252,1,12,6,2,31,11,20,42
CSKA Moscow,4252,2,12,3,5,28,18,10,39
Spart Moscow,4252,3,8,7,5,36,29,7,31
Zenit,4252,4,7,9,4,21,14,7,30
Krasnodar,4252,5,8,4,8,27,27,0,28
Terek Grozny,4252,6,7,7,6,23,25,-2,28
Din Moscow,4252,7,6,7,7,19,22,-3,25
FK Rubin,4252,8,6,5,9,22,18,4,23
Amkar,4252,9,5,5,10,13,25,-12,20
Rostov,4252,10,4,7,9,11,18,-7,19
Anzhi,4252,11,2,6,12,16,40,-24,12
Loko Moscow,4253,1,12,6,2,30,11,19,42
CSKA Moscow,4253,2,12,3,5,33,21,12,39
Spart Moscow,4253,3,10,6,4,36,26,10,36
Krasnodar,4253,4,8,6,6,30,27,3,30
Terek Grozny,4253,5,8,6,6,22,23,-1,30
Zenit,4253,6,7,8,5,21,16,5,29
Din Moscow,4253,7,6,6,8,20,23,-3,24
FK Rubin,4253,8,5,6,9,24,22,2,21
Rostov,4253,9,4,6,10,10,18,-8,18
Amkar,4253,10,4,6,10,10,23,-13,18
Anzhi,4253,11,2,5,13,18,44,-26,11
Loko Moscow,4254,1,11,7,2,32,14,18,40
Spart Moscow,4254,2,11,5,4,40,27,13,38
CSKA Moscow,4254,3,10,5,5,28,20,8,35
Krasnodar,4254,4,9,5,6,32,27,5,32
Zenit,4254,5,7,10,3,22,14,8,31
Terek Grozny,4254,6,8,6,6,22,23,-1,30
Din Moscow,4254,7,5,7,8,20,26,-6,22
FK Rubin,4254,8,5,6,9,24,22,2,21
Rostov,4254,9,4,6,10,10,18,-8,18
Amkar,4254,10,4,5,11,11,26,-15,17
Anzhi,4254,11,2,6,12,17,41,-24,12
Loko Moscow,4255,1,13,5,2,34,12,22,44
Spart Moscow,4255,2,10,6,4,39,28,11,36
CSKA Moscow,4255,3,10,4,6,27,21,6,34
Zenit,4255,4,8,8,4,23,15,8,32
Krasnodar,4255,5,8,4,8,29,29,0,28
Terek Grozny,4255,6,7,6,7,21,25,-4,27
FK Rubin,4255,7,6,6,8,24,19,5,24
Din Moscow,4255,8,5,8,7,20,24,-4,23
Rostov,4255,9,4,6,10,10,19,-9,18
Amkar,4255,10,4,5,11,11,25,-14,17
Anzhi,4255,11,3,6,11,18,39,-21,15
Loko Moscow,4256,1,11,6,3,29,13,16,39
Spart Moscow,4256,2,10,6,4,38,28,10,36
CSKA Moscow,4256,3,11,3,6,27,20,7,36
Zenit,4256,4,9,8,3,26,14,12,35
Terek Grozny,4256,5,9,5,6,23,23,0,32
Krasnodar,4256,6,8,6,6,29,26,3,30
FK Rubin,4256,7,5,7,8,24,20,4,22
Din Moscow,4256,8,5,7,8,18,23,-5,22
Rostov,4256,9,4,6,10,12,20,-8,18
Amkar,4256,10,4,5,11,11,25,-14,17
Anzhi,4256,11,2,5,13,14,39,-25,11
Loko Moscow,4257,1,12,6,2,31,12,19,42
Spart Moscow,4257,2,11,5,4,39,26,13,38
CSKA Moscow,4257,3,11,3,6,29,20,9,36
Zenit,4257,4,8,9,3,25,15,10,33
Krasnodar,4257,5,9,4,7,29,26,3,31
Terek Grozny,4257,6,7,6,7,21,25,-4,27
FK Rubin,4257,7,6,5,9,25,19,6,23
Din Moscow,4257,8,5,6,9,17,26,-9,21
Amkar,4257,9,5,4,11,11,24,-13,19
Rostov,4257,10,4,6,10,11,19,-8,18
Anzhi,4257,11,2,6,12,15,41,-26,12
Loko Moscow,4258,1,11,6,3,31,16,15,39
Spart Moscow,4258,2,11,5,4,38,26,12,38
Krasnodar,4258,3,10,4,6,32,25,7,34
CSKA Moscow,4258,4,10,4,6,26,19,7,34
Zenit,4258,5,8,9,3,23,14,9,33
Terek Grozny,4258,6,9,5,6,26,25,1,32
FK Rubin,4258,7,6,5,9,22,18,4,23
Din Moscow,4258,8,5,6,9,18,24,-6,21
Rostov,4258,9,4,6,10,10,19,-9,18
Amkar,4258,10,4,4,12,10,25,-15,16
Anzhi,4258,11,2,6,12,17,42,-25,12
Loko Moscow,4259,1,11,7,2,30,12,18,40
CSKA Moscow,4259,2,11,3,6,31,19,12,36
Spart Moscow,4259,3,9,7,4,38,27,11,34
Zenit,4259,4,8,9,3,23,14,9,33
Terek Grozny,4259,5,9,5,6,24,22,2,32
Krasnodar,4259,6,8,5,7,27,25,2,29
FK Rubin,4259,7,7,5,8,25,18,7,26
Din Moscow,4259,8,5,6,9,19,28,-9,21
Rostov,4259,9,4,7,9,10,17,-7,19
Amkar,4259,10,4,5,11,10,24,-14,17
Anzhi,4259,11,2,5,13,15,46,-31,11
Loko Moscow,4260,1,12,6,2,33,14,19,42
CSKA Moscow,4260,2,11,4,5,29,18,11,37
Spart Moscow,4260,3,10,6,4,37,25,12,36
Zenit,4260,4,7,10,3,22,14,8,31
Krasnodar,4260,5,9,4,7,32,27,5,31
Terek Grozny,4260,6,7,6,7,20,23,-3,27
Din Moscow,4260,7,6,6,8,20,25,-5,24
FK Rubin,4260,8,5,5,10,22,23,-1,20
Amkar,4260,9,5,5,10,10,22,-12,20
Rostov,4260,10,4,6,10,10,18,-8,18
Anzhi,4260,11,2,6,12,15,41,-26,12
Loko Moscow,4261,1,11,6,3,32,15,17,39
CSKA Moscow,4261,2,11,4,5,29,20,9,37
Zenit,4261,3,8,9,3,24,15,9,33
Spart Moscow,4261,4,9,6,5,37,29,8,33
Krasnodar,4261,5,8,6,6,30,27,3,30
Terek Grozny,4261,6,8,6,6,23,23,0,30
FK Rubin,4261,7,6,6,8,24,18,6,24
Din Moscow,4261,8,5,7,8,18,24,-6,22
Rostov,4261,9,5,6,9,11,17,-6,21
Amkar,4261,10,4,5,11,11,25,-14,17
Anzhi,4261,11,2,5,13,17,43,-26,11
Loko Moscow,4262,1,11,6,3,30,13,17,39
CSKA Moscow,4262,2,10,5,5,28,20,8,35
Zenit,4262,3,8,9,3,25,16,9,33
Spart Moscow,4262,4,9,6,5,37,30,7,33
Krasnodar,4262,5,9,5,6,29,25,4,32
Terek Grozny,4262,6,8,5,7,24,25,-1,29
FK Rubin,4262,7,6,5,9,24,20,4,23
Din Moscow,4262,8,5,7,8,21,26,-5,22
Amkar,4262,9,5,4,11,12,26,-14,19
Rostov,4262,10,4,6,10,10,18,-8,18
Anzhi,4262,11,3,6,11,17,38,-21,15
Loko Moscow,4263,1,12,6,2,33,14,19,42
CSKA Moscow,4263,2,12,3,5,33,17,16,39
Spart Moscow,4263,3,9,6,5,36,27,9,33
Terek Grozny,4263,4,8,6,6,23,24,-1,30
Zenit,4263,5,7,8,5,22,17,5,29
Krasnodar,4263,6,8,5,7,29,27,2,29
Din Moscow,4263,7,6,7,7,19,21,-2,25
FK Rubin,4263,8,6,6,8,22,17,5,24
Rostov,4263,9,4,6,10,10,20,-10,18
Amkar,4263,10,4,5,11,10,24,-14,17
Anzhi,4263,11,2,6,12,15,44,-29,12
Loko Moscow,4264,1,11,6,3,30,14,16,39
CSKA Moscow,4264,2,11,4,5,30,21,9,37
Zenit,4264,3,8,8,4,26,17,9,32
Terek Grozny,4264,4,8,6,6,23,24,-1,30
Spart Moscow,4264,5,8,5,7,33,28,5,29
Krasnodar,4264,6,8,5,7,29,29,0,29
Din Moscow,4264,7,7,6,7,21,22,-1,27
FK Rubin,4264,8,6,5,9,26,21,5,23
Rostov,4264,9,5,6,9,11,17,-6,21
Amkar,4264,10,5,4,11,11,24,-13,19
Anzhi,4264,11,2,7,11,16,39,-23,13
Loko Moscow,4265,1,12,6,2,31,12,19,42
CSKA Moscow,4265,2,12,3,5,29,18,11,39
Spart Moscow,4265,3,9,5,6,39,31,8,32
Krasnodar,4265,4,9,5,6,28,24,4,32
Zenit,4265,5,7,8,5,23,18,5,29
Terek Grozny,4265,6,7,7,6,20,22,-2,28
Din Moscow,4265,7,6,6,8,19,25,-6,24
Rostov,4265,8,5,6,9,13,19,-6,21
FK Rubin,4265,9,5,5,10,22,20,2,20
Amkar,4265,10,5,5,10,12,23,-11,20
Anzhi,4265,11,2,6,12,14,38,-24,12
Loko Moscow,4266,1,13,5,2,33,12,21,44
CSKA Moscow,4266,2,11,3,6,28,18,10,36
Spart Moscow,4266,3,9,6,5,35,27,8,33
Zenit,4266,4,8,8,4,22,15,7,32
Krasnodar,4266,5,9,4,7,29,26,3,31
Terek Grozny,4266,6,7,5,8,20,25,-5,26
Din Moscow,4266,7,6,7,7,18,21,-3,25
Amkar,4266,8,6,4,10,12,23,-11,22
FK Rubin,4266,9,5,5,10,21,19,2,20
Rostov,4266,10,4,6,10,10,18,-8,18
Anzhi,4266,11,3,5,12,16,40,-24,14
Loko Moscow,4267,1,11,6,3,29,12,17,39
Spart Moscow,4267,2,11,5,4,39,27,12,38
Zenit,4267,3,8,9,3,23,14,9,33
CSKA Moscow,4267,4,10,3,7,27,24,3,33
Krasnodar,4267,5,9,5,6,29,25,4,32
Terek Grozny,4267,6,8,6,6,23,22,1,30
Din Moscow,4267,7,6,6,8,21,24,-3,24
FK Rubin,4267,8,5,6,9,22,20,2,21
Rostov,4267,9,4,6,10,10,19,-9,18
Amkar,4267,10,4,5,11,9,23,-14,17
Anzhi,4267,11,3,5,12,19,41,-22,14
Loko Moscow,4268,1,11,6,3,30,13,17,39
CSKA Moscow,4268,2,11,4,5,29,19,10,37
Zenit,4268,3,7,10,3,23,15,8,31
Krasnodar,4268,4,9,4,7,28,25,3,31
Spart Moscow,4268,5,8,6,6,34,29,5,30
Din Moscow,4268,6,7,6,7,20,22,-2,27
Terek Grozny,4268,7,7,6,7,20,24,-4,27
FK Rubin,4268,8,6,5,9,22,18,4,23
Amkar,4268,9,5,5,10,11,22,-11,20
Rostov,4268,10,4,7,9,10,17,-7,19
Anzhi,4268,11,3,5,12,17,40,-23,14
Loko Moscow,4269,1,11,6,3,31,15,16,39
CSKA Moscow,4269,2,10,5,5,28,20,8,35
Spart Moscow,4269,3,9,7,4,41,27,14,34
Terek Grozny,4269,4,9,5,6,23,23,0,32
Zenit,4269,5,7,10,3,23,15,8,31
Krasnodar,4269,6,9,4,7,31,27,4,31
FK Rubin,4269,7,6,6,8,23,18,5,24
Din Moscow,4269,8,5,7,8,19,29,-10,22
Rostov,4269,9,4,7,9,10,17,-7,19
Amkar,4269,10,4,5,11,10,24,-14,17
Anzhi,4269,11,2,6,12,16,40,-24,12
Loko Moscow,4270,1,11,6,3,32,15,17,39
CSKA Moscow,4270,2,11,4,5,28,19,9,37
Spart Moscow,4270,3,10,6,4,38,25,13,36
Zenit,4270,4,8,9,3,23,14,9,33
Krasnodar,4270,5,8,5,7,31,30,1,29
Terek Grozny,4270,6,7,6,7,22,25,-3,27
FK Rubin,4270,7,6,6,8,25,19,6,24
Din Moscow,4270,8,5,7,8,18,24,-6,22
Rostov,4270,9,4,7,9,10,17,-7,19
Amkar,4270,10,5,4,11,11,26,-15,19
Anzhi,4270,11,2,6,12,16,40,-24,12
Loko Moscow,4271,1,12,6,2,31,11,20,42
CSKA Moscow,4271,2,12,3,5,28,17,11,39
Spart Moscow,4271,3,10,5,5,37,28,9,35
Krasnodar,4271,4,9,4,7,29,27,2,31
Zenit,4271,5,7,9,4,21,15,6,30
Terek Grozny,4271,6,8,5,7,25,24,1,29
Din Moscow,4271,7,5,7,8,19,24,-5,22
FK Rubin,4271,8,5,6,9,23,20,3,21
Rostov,4271,9,5,6,9,11,17,-6,21
Amkar,4271,10,5,4,11,12,25,-13,19
Anzhi,4271,11,2,5,13,14,42,-28,11
Loko Moscow,4272,1,12,5,3,30,12,18,41
CSKA Moscow,4272,2,11,4,5,28,18,10,37
Spart Moscow,4272,3,10,5,5,38,28,10,35
Krasnodar,4272,4,10,4,6,33,26,7,34
Zenit,4272,5,7,9,4,22,15,7,30
Din Moscow,4272,6,7,6,7,22,23,-1,27
Terek Grozny,4272,7,7,6,7,20,23,-3,27
FK Rubin,4272,8,5,5,10,24,25,-1,20
Rostov,4272,9,4,6,10,11,20,-9,18
Amkar,4272,10,4,5,11,9,23,-14,17
Anzhi,4272,11,3,5,12,15,39,-24,14
Loko Moscow,4273,1,13,5,2,32,11,21,44
Spart Moscow,4273,2,10,6,4,38,27,11,36
CSKA Moscow,4273,3,10,3,7,26,23,3,33
Zenit,4273,4,8,8,4,23,14,9,32
Krasnodar,4273,5,9,4,7,29,26,3,31
Terek Grozny,4273,6,7,6,7,21,25,-4,27
Din Moscow,4273,7,5,7,8,19,25,-6,22
FK Rubin,4273,8,5,6,9,22,20,2,21
Amkar,4273,9,5,5,10,12,23,-11,20
Rostov,4273,10,4,6,10,10,18,-8,18
Anzhi,4273,11,3,6,11,19,39,-20,15
Loko Moscow,4274,1,11,7,2,31,13,18,40
CSKA Moscow,4274,2,11,4,5,28,19,9,37
Spart Moscow,4274,3,10,6,4,37,27,10,36
Krasnodar,4274,4,9,5,6,30,26,4,32
Zenit,4274,5,7,9,4,21,14,7,30
Terek Grozny,4274,6,8,6,6,23,24,-1,30
Din Moscow,4274,7,5,8,7,19,23,-4,23
FK Rubin,4274,8,5,6,9,22,19,3,21
Rostov,4274,9,4,6,10,10,18,-8,18
Amkar,4274,10,4,5,11,10,24,-14,17
Anzhi,4274,11,2,6,12,18,42,-24,12
Loko Moscow,4275,1,11,5,4,30,15,15,38
Spart Moscow,4275,2,10,5,5,37,28,9,35
Krasnodar,4275,3,10,4,6,31,24,7,34
CSKA Moscow,4275,4,10,4,6,26,19,7,34
Zenit,4275,5,8,9,3,23,14,9,33
Terek Grozny,4275,6,8,5,7,24,25,-1,29
FK Rubin,4275,7,6,5,9,22,19,3,23
Din Moscow,4275,8,5,6,9,18,24,-6,21
Rostov,4275,9,5,6,9,11,17,-6,21
Amkar,4275,10,5,4,11,12,25,-13,19
Anzhi,4275,11,3,5,12,17,41,-24,14
Loko Moscow,4276,1,13,5,2,32,12,20,44
CSKA Moscow,4276,2,11,4,5,29,18,11,37
Spart Moscow,4276,3,9,5,6,36,27,9,32
Krasnodar,4276,4,9,4,7,30,26,4,31
Zenit,4276,5,7,9,4,22,15,7,30
Terek Grozny,4276,6,8,5,7,21,25,-4,29
Din Moscow,4276,7,6,6,8,18,24,-6,24
Amkar,4276,8,6,4,10,13,22,-9,22
Rostov,4276,9,5,6,9,11,17,-6,21
FK Rubin,4276,10,5,5,10,22,21,1,20
Anzhi,4276,11,2,5,13,15,42,-27,11
Loko Moscow,4277,1,12,5,3,35,15,20,41
Spart Moscow,4277,2,10,6,4,38,28,10,36
CSKA Moscow,4277,3,11,3,6,26,18,8,36
Zenit,4277,4,9,8,3,25,15,10,35
Krasnodar,4277,5,9,4,7,30,28,2,31
Terek Grozny,4277,6,8,5,7,22,24,-2,29
Din Moscow,4277,7,5,7,8,19,24,-5,22
FK Rubin,4277,8,5,6,9,21,19,2,21
Rostov,4277,9,4,7,9,11,18,-7,19
Amkar,4277,10,4,4,12,9,24,-15,16
Anzhi,4277,11,3,5,12,16,39,-23,14
Loko Moscow,4278,1,11,5,4,30,14,16,38
CSKA Moscow,4278,2,11,4,5,30,17,13,37
Spart Moscow,4278,3,9,7,4,36,26,10,34
Krasnodar,4278,4,10,4,6,32,26,6,34
Zenit,4278,5,8,9,3,22,13,9,33
Terek Grozny,4278,6,8,6,6,23,22,1,30
Din Moscow,4278,7,5,7,8,20,26,-6,22
FK Rubin,4278,8,5,6,9,24,22,2,21
Rostov,4278,9,4,7,9,10,17,-7,19
Amkar,4278,10,4,6,10,9,22,-13,18
Anzhi,4278,11,2,5,13,14,45,-31,11
Loko Moscow,4279,1,12,5,3,32,14,18,41
CSKA Moscow,4279,2,10,5,5,26,18,8,35
Spart Moscow,4279,3,9,7,4,38,29,9,34
Zenit,4279,4,8,9,3,25,16,9,33
Terek Grozny,4279,5,8,6,6,22,23,-1,30
Krasnodar,4279,6,8,4,8,27,27,0,28
FK Rubin,4279,7,7,5,8,25,17,8,26
Din Moscow,4279,8,5,7,8,19,25,-6,22
Rostov,4279,9,4,6,10,10,18,-8,18
Amkar,4279,10,4,6,10,12,25,-13,18
Anzhi,4279,11,2,6,12,14,38,-24,12
Loko Moscow,4280,1,12,6,2,32,13,19,42
CSKA Moscow,4280,2,11,4,5,28,18,10,37
Spart Moscow,4280,3,10,6,4,38,26,12,36
Terek Grozny,4280,4,9,5,6,25,25,0,32
Zenit,4280,5,7,9,4,23,16,7,30
Krasnodar,4280,6,8,5,7,28,26,2,29
Din Moscow,4280,7,6,7,7,21,23,-2,25
FK Rubin,4280,8,6,5,9,23,20,3,23
Rostov,4280,9,4,6,10,10,20,-10,18
Amkar,4280,10,4,4,12,10,25,-15,16
Anzhi,4280,11,2,5,13,16,42,-26,11
Loko Moscow,4281,1,12,6,2,32,13,19,42
CSKA Moscow,4281,2,11,3,6,30,19,11,36
Spart Moscow,4281,3,10,5,5,38,28,10,35
Zenit,4281,4,8,9,3,23,14,9,33
Krasnodar,4281,5,8,5,7,29,27,2,29
Terek Grozny,4281,6,7,5,8,22,27,-5,26
Din Moscow,4281,7,6,6,8,19,24,-5,24
FK Rubin,4281,8,5,6,9,22,20,2,21
Rostov,4281,9,5,6,9,13,18,-5,21
Amkar,4281,10,5,4,11,12,24,-12,19
Anzhi,4281,11,3,5,12,17,43,-26,14
Loko Moscow,4282,1,11,5,4,29,13,16,38
Spart Moscow,4282,2,10,6,4,38,27,11,36
Zenit,4282,3,9,8,3,24,14,10,35
CSKA Moscow,4282,4,10,4,6,27,20,7,34
Krasnodar,4282,5,9,4,7,29,26,3,31
Terek Grozny,4282,6,7,6,7,21,24,-3,27
Din Moscow,4282,7,6,7,7,20,23,-3,25
FK Rubin,4282,8,6,5,9,24,20,4,23
Amkar,4282,9,5,4,11,11,24,-13,19
Rostov,4282,10,4,6,10,10,19,-9,18
Anzhi,4282,11,2,7,11,16,39,-23,13
Loko Moscow,4283,1,13,5,2,32,12,20,44
CSKA Moscow,4283,2,10,5,5,27,19,8,35
Spart Moscow,4283,3,8,8,4,38,30,8,32
Krasnodar,4283,4,9,4,7,31,26,5,31
Zenit,4283,5,7,9,4,22,15,7,30
Terek Grozny,4283,6,8,5,7,23,23,0,29
FK Rubin,4283,7,6,5,9,22,20,2,23
Din Moscow,4283,8,5,7,8,19,24,-5,22
Amkar,4283,9,5,5,10,11,23,-12,20
Rostov,4283,10,4,7,9,12,19,-7,19
Anzhi,4283,11,2,6,12,15,41,-26,12
Loko Moscow,4284,1,12,5,3,30,13,17,41
CSKA Moscow,4284,2,12,3,5,29,17,12,39
Spart Moscow,4284,3,9,6,5,38,30,8,33
Krasnodar,4284,4,9,5,6,30,25,5,32
Zenit,4284,5,7,8,5,21,15,6,29
Din Moscow,4284,6,7,6,7,21,22,-1,27
Terek Grozny,4284,7,7,5,8,20,25,-5,26
FK Rubin,4284,8,5,6,9,22,20,2,21
Amkar,4284,9,5,5,10,14,25,-11,20
Rostov,4284,10,4,6,10,10,18,-8,18
Anzhi,4284,11,3,5,12,15,40,-25,14
Loko Moscow,4285,1,12,5,3,31,12,19,41
Spart Moscow,4285,2,11,5,4,40,27,13,38
CSKA Moscow,4285,3,11,4,5,28,19,9,37
Zenit,4285,4,8,9,3,24,15,9,33
Terek Grozny,4285,5,8,6,6,22,23,-1,30
Krasnodar,4285,6,8,4,8,28,28,0,28
FK Rubin,4285,7,6,6,8,24,19,5,24
Din Moscow,4285,8,5,7,8,18,24,-6,22
Rostov,4285,9,4,6,10,10,18,-8,18
Amkar,4285,10,4,5,11,11,26,-15,17
Anzhi,4285,11,2,5,13,15,40,-25,11
Loko Moscow,4286,1,12,5,3,30,12,18,41
CSKA Moscow,4286,2,11,3,6,27,20,7,36
Spart Moscow,4286,3,9,6,5,34,26,8,33
Zenit,4286,4,8,8,4,23,14,9,32
Krasnodar,4286,5,9,5,6,28,24,4,32
Terek Grozny,4286,6,7,6,7,21,25,-4,27
Din Moscow,4286,7,6,7,7,19,22,-3,25
FK Rubin,4286,8,5,7,8,22,18,4,22
Rostov,4286,9,4,7,9,10,17,-7,19
Amkar,4286,10,4,5,11,10,24,-14,17
Anzhi,4286,11,3,5,12,17,39,-22,14
Loko Moscow,4287,1,12,5,3,30,12,18,41
CSKA Moscow,4287,2,11,3,6,26,19,7,36
Zenit,4287,3,9,8,3,24,13,11,35
Spart Moscow,4287,4,9,6,5,37,27,10,33
Krasnodar,4287,5,9,4,7,28,25,3,31
Terek Grozny,4287,6,7,5,8,21,26,-5,26
Din Moscow,4287,7,6,7,7,20,21,-1,25
Amkar,4287,8,6,4,10,13,24,-11,22
FK Rubin,4287,9,5,5,10,21,21,0,20
Rostov,4287,10,4,6,10,10,20,-10,18
Anzhi,4287,11,3,5,12,16,38,-22,14
Loko Moscow,4288,1,11,7,2,31,13,18,40
Spart Moscow,4288,2,10,5,5,36,27,9,35
CSKA Moscow,4288,3,10,5,5,27,19,8,35
Zenit,4288,4,7,10,3,22,14,8,31
Krasnodar,4288,5,8,5,7,30,28,2,29
Terek Grozny,4288,6,8,5,7,25,25,0,29
FK Rubin,4288,7,7,5,8,25,18,7,26
Din Moscow,4288,8,5,6,9,17,25,-8,21
Amkar,4288,9,5,4,11,12,26,-14,19
Rostov,4288,10,4,6,10,10,18,-8,18
Anzhi,4288,11,3,6,11,17,39,-22,15
Loko Moscow,4289,1,11,7,2,30,12,18,40
CSKA Moscow,4289,2,11,4,5,30,19,11,37
Spart Moscow,4289,3,10,5,5,41,27,14,35
Krasnodar,4289,4,9,5,6,28,24,4,32
Zenit,4289,5,7,9,4,23,18,5,30
Terek Grozny,4289,6,7,7,6,20,22,-2,28
Din Moscow,4289,7,6,6,8,19,24,-5,24
FK Rubin,4289,8,6,5,9,23,18,5,23
Rostov,4289,9,4,6,10,10,20,-10,18
Amkar,4289,10,4,5,11,9,26,-17,17
Anzhi,4289,11,2,7,11,15,38,-23,13
Loko Moscow,4290,1,11,7,2,31,13,18,40
Spart Moscow,4290,2,11,5,4,39,27,12,38
CSKA Moscow,4290,3,11,3,6,26,18,8,36
Zenit,4290,4,8,9,3,23,14,9,33
Terek Grozny,4290,5,9,5,6,26,24,2,32
Krasnodar,4290,6,8,5,7,29,28,1,29
Din Moscow,4290,7,6,6,8,19,23,-4,24
FK Rubin,4290,8,6,5,9,25,20,5,23
Rostov,4290,9,4,6,10,11,20,-9,18
Amkar,4290,10,4,4,12,11,28,-17,16
Anzhi,4290,11,2,5,13,15,40,-25,11
Loko Moscow,4291,1,12,6,2,33,13,20,42
CSKA Moscow,4291,2,11,4,5,27,17,10,37
Spart Moscow,4291,3,9,5,6,36,28,8,32
Zenit,4291,4,7,9,4,21,15,6,30
Krasnodar,4291,5,8,6,6,30,27,3,30
Terek Grozny,4291,6,8,6,6,23,24,-1,30
Din Moscow,4291,7,6,6,8,20,23,-3,24
FK Rubin,4291,8,5,6,9,22,21,1,21
Rostov,4291,9,5,6,9,12,18,-6,21
Amkar,4291,10,5,4,11,11,24,-13,19
Anzhi,4291,11,2,6,12,15,40,-25,12
Loko Moscow,4292,1,11,5,4,30,16,14,38
CSKA Moscow,4292,2,11,3,6,27,19,8,36
Spart Moscow,4292,3,10,5,5,40,29,11,35
Krasnodar,4292,4,10,4,6,33,25,8,34
Zenit,4292,5,8,8,4,24,16,8,32
Terek Grozny,4292,6,8,5,7,24,25,-1,29
Din Moscow,4292,7,6,7,7,21,23,-2,25
FK Rubin,4292,8,5,6,9,23,21,2,21
Amkar,4292,9,5,4,11,12,25,-13,19
Rostov,4292,10,4,6,10,10,20,-10,18
Anzhi,4292,11,3,5,12,16,41,-25,14
Loko Moscow,4293,1,12,5,3,32,15,17,41
CSKA Moscow,4293,2,11,3,6,27,19,8,36
Zenit,4293,3,9,8,3,24,13,11,35
Spart Moscow,4293,4,9,6,5,36,29,7,33
Krasnodar,4293,5,8,4,8,29,30,-1,28
Din Moscow,4293,6,7,6,7,21,21,0,27
Terek Grozny,4293,7,7,6,7,22,25,-3,27
FK Rubin,4293,8,6,5,9,24,18,6,23
Rostov,4293,9,4,7,9,11,18,-7,19
Amkar,4293,10,4,5,11,10,25,-15,17
Anzhi,4293,11,3,5,12,17,40,-23,14
Loko Moscow,4294,1,12,6,2,32,13,19,42
CSKA Moscow,4294,2,12,3,5,29,18,11,39
Spart Moscow,4294,3,9,6,5,39,29,10,33
Zenit,4294,4,7,8,5,24,18,6,29
Krasnodar,4294,5,8,5,7,27,26,1,29
Terek Grozny,4294,6,7,6,7,21,25,-4,27
FK Rubin,4294,7,7,5,8,25,18,7,26
Amkar,4294,8,6,4,10,13,23,-10,22
Din Moscow,4294,9,5,6,9,19,27,-8,21
Rostov,4294,10,4,7,9,11,18,-7,19
Anzhi,4294,11,2,6,12,15,40,-25,12
Loko Moscow,4295,1,13,5,2,34,14,20,44
Spart Moscow,4295,2,11,5,4,38,26,12,38
CSKA Moscow,4295,3,10,4,6,26,19,7,34
Zenit,4295,4,8,8,4,24,16,8,32
Terek Grozny,4295,5,9,5,6,23,22,1,32
Krasnodar,4295,6,8,5,7,30,28,2,29
FK Rubin,4295,7,6,6,8,25,19,6,24
Din Moscow,4295,8,5,6,9,17,24,-7,21
Rostov,4295,9,4,6,10,11,19,-8,18
Amkar,4295,10,4,4,12,9,26,-17,16
Anzhi,4295,11,2,6,12,15,39,-24,12
Loko Moscow,4296,1,11,6,3,29,12,17,39
CSKA Moscow,4296,2,11,3,6,28,19,9,36
Zenit,4296,3,9,8,3,24,14,10,35
Spart Moscow,4296,4,9,7,4,35,26,9,34
Krasnodar,4296,5,9,5,6,29,24,5,32
Terek Grozny,4296,6,7,7,6,22,24,-2,28
FK Rubin,4296,7,6,5,9,22,19,3,23
Din Moscow,4296,8,5,6,9,18,24,-6,21
Rostov,4296,9,4,7,9,10,17,-7,19
Amkar,4296,10,4,6,10,11,24,-13,18
Anzhi,4296,11,2,6,12,14,39,-25,12
Loko Moscow,4297,1,11,5,4,29,15,14,38
Spart Moscow,4297,2,10,6,4,37,25,12,36
CSKA Moscow,4297,3,11,3,6,26,18,8,36
Zenit,4297,4,9,8,3,24,13,11,35
Krasnodar,4297,5,9,4,7,29,27,2,31
Terek Grozny,4297,6,8,6,6,22,23,-1,30
Din Moscow,4297,7,6,6,8,19,23,-4,24
FK Rubin,4297,8,6,5,9,24,19,5,23
Rostov,4297,9,4,6,10,10,19,-9,18
Amkar,4297,10,4,5,11,10,24,-14,17
Anzhi,4297,11,2,6,12,14,38,-24,12
Loko Moscow,4298,1,11,5,4,30,14,16,38
CSKA Moscow,4298,2,11,4,5,28,19,9,37
Spart Moscow,4298,3,10,5,5,40,30,10,35
Zenit,4298,4,8,8,4,23,15,8,32
Krasnodar,4298,5,9,5,6,30,26,4,32
Terek Grozny,4298,6,8,5,7,21,23,-2,29
FK Rubin,4298,7,5,7,8,23,19,4,22
Din Moscow,4298,8,5,7,8,19,24,-5,22
Amkar,4298,9,5,4,11,11,24,-13,19
Rostov,4298,10,4,6,10,12,21,-9,18
Anzhi,4298,11,3,6,11,16,38,-22,15
Loko Moscow,4299,1,13,5,2,33,13,20,44
CSKA Moscow,4299,2,11,3,6,26,19,7,36
Spart Moscow,4299,3,10,5,5,40,28,12,35
Zenit,4299,4,8,8,4,23,14,9,32
Krasnodar,4299,5,8,5,7,30,28,2,29
Terek Grozny,4299,6,7,6,7,22,26,-4,27
Din Moscow,4299,7,6,6,8,21,24,-3,24
Amkar,4299,8,6,4,10,14,24,-10,22
FK Rubin,4299,9,5,6,9,23,21,2,21
Rostov,4299,10,4,6,10,10,21,-11,18
Anzhi,4299,11,2,6,12,15,39,-24,12
Loko Moscow,4300,1,12,6,2,32,11,21,42
CSKA Moscow,4300,2,10,5,5,28,20,8,35
Zenit,4300,3,7,10,3,23,15,8,31
Krasnodar,4300,4,9,4,7,29,27,2,31
Spart Moscow,4300,5,8,5,7,33,29,4,29
Terek Grozny,4300,6,7,5,8,20,27,-7,26
Din Moscow,4300,7,6,6,8,18,22,-4,24
FK Rubin,4300,8,6,5,9,22,19,3,23
Amkar,4300,9,6,4,10,12,22,-10,22
Rostov,4300,10,5,6,9,12,17,-5,21
Anzhi,4300,11,3,6,11,18,38,-20,15
Loko Moscow,4301,1,12,5,3,32,13,19,41
Spart Moscow,4301,2,11,5,4,40,27,13,38
CSKA Moscow,4301,3,11,3,6,29,21,8,36
Zenit,4301,4,9,8,3,25,14,11,35
Krasnodar,4301,5,8,4,8,27,28,-1,28
Terek Grozny,4301,6,7,5,8,21,26,-5,26
FK Rubin,4301,7,6,6,8,26,20,6,24
Din Moscow,4301,8,5,7,8,20,26,-6,22
Amkar,4301,9,5,4,11,12,26,-14,19
Rostov,4301,10,4,6,10,11,19,-8,18
Anzhi,4301,11,3,5,12,18,41,-23,14
Loko Moscow,4302,1,11,6,3,30,13,17,39
CSKA Moscow,4302,2,11,3,6,30,19,11,36
Spart Moscow,4302,3,10,5,5,36,27,9,35
Zenit,4302,4,8,9,3,23,14,9,33
Krasnodar,4302,5,9,5,6,29,25,4,32
Terek Grozny,4302,6,7,6,7,20,25,-5,27
Din Moscow,4302,7,6,6,8,19,23,-4,24
FK Rubin,4302,8,5,6,9,21,18,3,21
Rostov,4302,9,5,6,9,11,17,-6,21
Amkar,4302,10,5,4,11,12,23,-11,19
Anzhi,4302,11,2,6,12,14,41,-27,12
Loko Moscow,4303,1,11,5,4,30,14,16,38
CSKA Moscow,4303,2,11,4,5,27,18,9,37
Zenit,4303,3,8,9,3,23,14,9,33
Spart Moscow,4303,4,9,6,5,34,27,7,33
Krasnodar,4303,5,9,4,7,30,27,3,31
Terek Grozny,4303,6,8,5,7,25,26,-1,29
Din Moscow,4303,7,6,7,7,20,22,-2,25
FK Rubin,4303,8,6,6,8,24,19,5,24
Amkar,4303,9,5,5,10,12,23,-11,20
Rostov,4303,10,4,6,10,10,18,-8,18
Anzhi,4303,11,2,5,13,15,42,-27,11
Loko Moscow,4304,1,12,6,2,33,14,19,42
CSKA Moscow,4304,2,11,4,5,30,20,10,37
Spart Moscow,4304,3,10,6,4,39,27,12,36
Zenit,4304,4,7,9,4,25,18,7,30
Terek Grozny,4304,5,8,6,6,21,22,-1,30
Krasnodar,4304,6,8,5,7,29,27,2,29
FK Rubin,4304,7,7,5,8,26,19,7,26
Din Moscow,4304,8,5,7,8,19,25,-6,22
Rostov,4304,9,4,6,10,10,20,-10,18
Amkar,4304,10,4,4,12,9,24,-15,16
Anzhi,4304,11,2,6,12,16,41,-25,12
Loko Moscow,4305,1,11,5,4,31,15,16,38
CSKA Moscow,4305,2,11,3,6,27,18,9,36
Zenit,4305,3,8,8,4,23,16,7,32
Spart Moscow,4305,4,9,5,6,35,29,6,32
Krasnodar,4305,5,9,5,6,29,25,4,32
Din Moscow,4305,6,7,6,7,20,21,-1,27
Terek Grozny,4305,7,7,6,7,23,26,-3,27
FK Rubin,4305,8,5,6,9,21,18,3,21
Rostov,4305,9,5,6,9,11,17,-6,21
Amkar,4305,10,5,4,11,12,25,-13,19
Anzhi,4305,11,3,6,11,17,39,-22,15
Loko Moscow,4306,1,11,6,3,32,18,14,39
Spart Moscow,4306,2,10,6,4,36,25,11,36
CSKA Moscow,4306,3,11,3,6,28,18,10,36
Krasnodar,4306,4,10,4,6,38,26,12,34
Zenit,4306,5,8,9,3,23,14,9,33
Terek Grozny,4306,6,8,5,7,22,25,-3,29
FK Rubin,4306,7,6,5,9,24,23,1,23
Din Moscow,4306,8,5,6,9,18,26,-8,21
Rostov,4306,9,4,6,10,10,18,-8,18
Amkar,4306,10,4,5,11,10,24,-14,17
Anzhi,4306,11,3,5,12,16,40,-24,14
Loko Moscow,4307,1,13,5,2,33,11,22,44
CSKA Moscow,4307,2,10,4,6,26,19,7,34
Spart Moscow,4307,3,9,6,5,37,26,11,33
Zenit,4307,4,8,8,4,23,17,6,32
Terek Grozny,4307,5,8,6,6,23,23,0,30
Krasnodar,4307,6,8,4,8,28,27,1,28
Din Moscow,4307,7,6,6,8,20,27,-7,24
FK Rubin,4307,8,6,5,9,25,21,4,23
Rostov,4307,9,5,6,9,11,17,-6,21
Amkar,4307,10,4,5,11,9,24,-15,17
Anzhi,4307,11,2,7,11,15,38,-23,13
Loko Moscow,4308,1,11,6,3,30,13,17,39
Spart Moscow,4308,2,10,5,5,39,30,9,35
CSKA Moscow,4308,3,10,5,5,26,18,8,35
Zenit,4308,4,8,9,3,23,14,9,33
Terek Grozny,4308,5,8,6,6,22,23,-1,30
Krasnodar,4308,6,8,5,7,28,27,1,29
FK Rubin,4308,7,7,5,8,25,18,7,26
Din Moscow,4308,8,5,6,9,19,25,-6,21
Rostov,4308,9,5,6,9,12,18,-6,21
Amkar,4308,10,4,5,11,11,25,-14,17
Anzhi,4308,11,2,6,12,15,39,-24,12
Loko Moscow,4309,1,11,5,4,30,18,12,38
CSKA Moscow,4309,2,11,4,5,26,17,9,37
Spart Moscow,4309,3,10,6,4,38,26,12,36
Zenit,4309,4,8,9,3,23,13,10,33
Terek Grozny,4309,5,9,5,6,22,22,0,32
Krasnodar,4309,6,9,4,7,33,27,6,31
Din Moscow,4309,7,6,6,8,20,26,-6,24
FK Rubin,4309,8,6,5,9,25,21,4,23
Rostov,4309,9,4,6,10,10,18,-8,18
Amkar,4309,10,4,5,11,10,24,-14,17
Anzhi,4309,11,2,5,13,14,39,-25,11
Loko Moscow,4310,1,13,5,2,34,12,22,44
Spart Moscow,4310,2,11,5,4,41,26,15,38
CSKA Moscow,4310,3,10,4,6,26,19,7,34
Zenit,4310,4,8,8,4,22,16,6,32
Terek Grozny,4310,5,9,5,6,22,22,0,32
Krasnodar,4310,6,8,4,8,28,28,0,28
Din Moscow,4310,7,6,6,8,19,26,-7,24
FK Rubin,4310,8,6,5,9,24,19,5,23
Rostov,4310,9,4,6,10,11,20,-9,18
Amkar,4310,10,4,4,12,9,24,-15,16
Anzhi,4310,11,2,6,12,15,39,-24,12
Loko Moscow,4311,1,13,5,2,32,11,21,44
Spart Moscow,4311,2,10,5,5,40,27,13,35
CSKA Moscow,4311,3,10,5,5,25,17,8,35
Zenit,4311,4,7,9,4,21,15,6,30
Terek Grozny,4311,5,8,6,6,25,25,0,30
Krasnodar,4311,6,8,5,7,28,26,2,29
FK Rubin,4311,7,5,7,8,22,18,4,22
Din Moscow,4311,8,5,7,8,17,24,-7,22
Amkar,4311,9,5,4,11,11,25,-14,19
Rostov,4311,10,4,6,10,11,21,-10,18
Anzhi,4311,11,2,7,11,16,39,-23,13
CSKA Moscow,4312,1,12,3,5,34,22,12,39
Loko Moscow,4312,2,11,5,4,30,15,15,38
Spart Moscow,4312,3,9,6,5,35,28,7,33
Zenit,4312,4,8,8,4,26,18,8,32
Krasnodar,4312,5,9,4,7,30,27,3,31
Terek Grozny,4312,6,8,5,7,23,26,-3,29
FK Rubin,4312,7,7,5,8,25,18,7,26
Din Moscow,4312,8,5,7,8,18,24,-6,22
Amkar,4312,9,6,4,10,13,22,-9,22
Rostov,4312,10,4,6,10,10,18,-8,18
Anzhi,4312,11,2,5,13,18,44,-26,11
Loko Moscow,4313,1,13,5,2,33,12,21,44
CSKA Moscow,4313,2,11,4,5,26,17,9,37
Spart Moscow,4313,3,9,6,5,36,30,6,33
Zenit,4313,4,7,9,4,22,15,7,30
Terek Grozny,4313,5,8,6,6,22,23,-1,30
Krasnodar,4313,6,8,4,8,27,28,-1,28
Din Moscow,4313,7,6,7,7,20,22,-2,25
FK Rubin,4313,8,6,5,9,23,19,4,23
Amkar,4313,9,5,5,10,14,23,-9,20
Rostov,4313,10,4,6,10,10,19,-9,18
Anzhi,4313,11,2,5,13,14,39,-25,11
Loko Moscow,4314,1,13,5,2,32,11,21,44
CSKA Moscow,4314,2,11,4,5,29,17,12,37
Spart Moscow,4314,3,10,5,5,37,26,11,35
Zenit,4314,4,7,9,4,21,15,6,30
Terek Grozny,4314,5,8,5,7,23,24,-1,29
Krasnodar,4314,6,8,4,8,28,27,1,28
FK Rubin,4314,7,7,5,8,25,18,7,26
Amkar,4314,8,6,4,10,12,22,-10,22
Din Moscow,4314,9,5,6,9,17,26,-9,21
Rostov,4314,10,4,6,10,10,18,-8,18
Anzhi,4314,11,2,5,13,14,44,-30,11
Loko Moscow,4315,1,12,6,2,32,13,19,42
Spart Moscow,4315,2,11,5,4,40,27,13,38
CSKA Moscow,4315,3,11,4,5,27,17,10,37
Terek Grozny,4315,4,8,6,6,22,23,-1,30
Zenit,4315,5,7,8,5,22,17,5,29
Krasnodar,4315,6,8,5,7,29,27,2,29
Din Moscow,4315,7,6,6,8,21,26,-5,24
FK Rubin,4315,8,6,5,9,24,21,3,23
Rostov,4315,9,4,6,10,10,18,-8,18
Amkar,4315,10,4,5,11,11,25,-14,17
Anzhi,4315,11,2,6,12,14,38,-24,12
Loko Moscow,4316,1,12,6,2,31,12,19,42
CSKA Moscow,4316,2,12,3,5,28,18,10,39
Spart Moscow,4316,3,9,6,5,38,29,9,33
Krasnodar,4316,4,9,5,6,30,26,4,32
Zenit,4316,5,7,8,5,21,15,6,29
Terek Grozny,4316,6,7,5,8,20,27,-7,26
Din Moscow,4316,7,6,7,7,21,24,-3,25
Rostov,4316,8,5,6,9,13,19,-6,21
FK Rubin,4316,9,5,5,10,24,22,2,20
Amkar,4316,10,5,4,11,10,24,-14,19
Anzhi,4316,11,3,5,12,19,39,-20,14
Loko Moscow,4317,1,12,5,3,34,13,21,41
Spart Moscow,4317,2,11,5,4,45,26,19,38
CSKA Moscow,4317,3,11,4,5,27,17,10,37
Krasnodar,4317,4,10,4,6,31,26,5,34
Terek Grozny,4317,5,9,5,6,25,22,3,32
Zenit,4317,6,7,8,5,21,19,2,29
Din Moscow,4317,7,5,7,8,18,26,-8,22
FK Rubin,4317,8,5,6,9,22,19,3,21
Rostov,4317,9,4,6,10,10,22,-12,18
Amkar,4317,10,4,4,12,9,25,-16,16
Anzhi,4317,11,2,6,12,14,41,-27,12
Loko Moscow,4318,1,13,5,2,33,12,21,44
Spart Moscow,4318,2,11,5,4,41,27,14,38
CSKA Moscow,4318,3,11,3,6,28,19,9,36
Zenit,4318,4,8,8,4,23,16,7,32
Krasnodar,4318,5,8,5,7,29,27,2,29
Terek Grozny,4318,6,8,5,7,22,25,-3,29
FK Rubin,4318,7,6,6,8,23,18,5,24
Din Moscow,4318,8,5,6,9,17,25,-8,21
Amkar,4318,9,5,4,11,13,25,-12,19
Rostov,4318,10,4,6,10,11,19,-8,18
Anzhi,4318,11,2,5,13,14,41,-27,11
Loko Moscow,4319,1,11,5,4,30,15,15,38
CSKA Moscow,4319,2,11,4,5,28,19,9,37
Spart Moscow,4319,3,10,6,4,41,26,15,36
Krasnodar,4319,4,10,4,6,30,24,6,34
Zenit,4319,5,8,9,3,25,15,10,33
Terek Grozny,4319,6,7,6,7,21,25,-4,27
FK Rubin,4319,7,6,5,9,23,20,3,23
Din Moscow,4319,8,5,7,8,19,24,-5,22
Rostov,4319,9,4,6,10,10,20,-10,18
Amkar,4319,10,4,5,11,10,27,-17,17
Anzhi,4319,11,3,5,12,17,39,-22,14
Loko Moscow,4320,1,11,6,3,30,13,17,39
CSKA Moscow,4320,2,12,3,5,30,18,12,39
Spart Moscow,4320,3,10,6,4,39,28,11,36
Krasnodar,4320,4,9,5,6,30,26,4,32
Zenit,4320,5,7,9,4,22,17,5,30
Terek Grozny,4320,6,8,5,7,23,23,0,29
FK Rubin,4320,7,6,6,8,25,20,5,24
Din Moscow,4320,8,5,6,9,19,26,-7,21
Rostov,4320,9,4,6,10,12,20,-8,18
Amkar,4320,10,4,5,11,9,25,-16,17
Anzhi,4320,11,3,5,12,16,39,-23,14
Loko Moscow,4321,1,11,7,2,32,14,18,40
Spart Moscow,4321,2,11,5,4,42,26,16,38
CSKA Moscow,4321,3,11,4,5,27,17,10,37
Zenit,4321,4,7,9,4,23,17,6,30
Krasnodar,4321,5,8,6,6,28,25,3,30
Terek Grozny,4321,6,8,5,7,23,26,-3,29
Din Moscow,4321,7,6,6,8,18,25,-7,24
FK Rubin,4321,8,5,6,9,21,18,3,21
Amkar,4321,9,5,4,11,11,24,-13,19
Rostov,4321,10,4,6,10,11,20,-9,18
Anzhi,4321,11,2,6,12,16,40,-24,12
Loko Moscow,4322,1,12,5,3,30,12,18,41
Spart Moscow,4322,2,9,7,4,39,30,9,34
Krasnodar,4322,3,10,4,6,32,24,8,34
CSKA Moscow,4322,4,10,4,6,25,18,7,34
Zenit,4322,5,8,8,4,22,14,8,32
Terek Grozny,4322,6,8,6,6,22,23,-1,30
Din Moscow,4322,7,6,6,8,21,25,-4,24
FK Rubin,4322,8,5,5,10,22,23,-1,20
Rostov,4322,9,4,7,9,11,18,-7,19
Amkar,4322,10,4,5,11,11,25,-14,17
Anzhi,4322,11,2,7,11,15,38,-23,13
Loko Moscow,4323,1,12,5,3,30,13,17,41
Spart Moscow,4323,2,10,6,4,41,29,12,36
CSKA Moscow,4323,3,11,3,6,28,22,6,36
Zenit,4323,4,9,8,3,26,13,13,35
Krasnodar,4323,5,8,5,7,27,25,2,29
Terek Grozny,4323,6,7,6,7,21,24,-3,27
Din Moscow,4323,7,6,6,8,20,24,-4,24
FK Rubin,4323,8,5,6,9,21,18,3,21
Rostov,4323,9,4,7,9,11,18,-7,19
Amkar,4323,10,5,4,11,12,27,-15,19
Anzhi,4323,11,2,6,12,16,40,-24,12
Loko Moscow,4324,1,13,5,2,33,11,22,44
CSKA Moscow,4324,2,12,3,5,29,18,11,39
Spart Moscow,4324,3,10,5,5,42,28,14,35
Zenit,4324,4,7,8,5,21,18,3,29
Krasnodar,4324,5,8,5,7,29,27,2,29
Terek Grozny,4324,6,7,6,7,22,26,-4,27
Din Moscow,4324,7,6,6,8,20,27,-7,24
FK Rubin,4324,8,5,6,9,24,21,3,21
Amkar,4324,9,5,5,10,13,25,-12,20
Rostov,4324,10,4,6,10,10,20,-10,18
Anzhi,4324,11,3,5,12,17,39,-22,14
Loko Moscow,4325,1,11,6,3,30,13,17,39
CSKA Moscow,4325,2,10,4,6,28,21,7,34
Krasnodar,4325,3,10,4,6,31,26,5,34
Zenit,4325,4,8,9,3,25,16,9,33
Spart Moscow,4325,5,9,5,6,39,32,7,32
Terek Grozny,4325,6,7,6,7,21,24,-3,27
Din Moscow,4325,7,5,7,8,19,25,-6,22
FK Rubin,4325,8,5,6,9,24,21,3,21
Rostov,4325,9,5,6,9,12,18,-6,21
Amkar,4325,10,5,5,10,14,25,-11,20
Anzhi,4325,11,3,6,11,16,38,-22,15
Loko Moscow,4326,1,11,5,4,30,15,15,38
Spart Moscow,4326,2,11,5,4,39,25,14,38
CSKA Moscow,4326,3,11,3,6,28,20,8,36
Zenit,4326,4,9,8,3,24,14,10,35
Krasnodar,4326,5,9,4,7,31,27,4,31
Terek Grozny,4326,6,8,6,6,26,25,1,30
FK Rubin,4326,7,7,5,8,26,19,7,26
Din Moscow,4326,8,5,6,9,17,26,-9,21
Rostov,4326,9,4,6,10,10,18,-8,18
Amkar,4326,10,4,4,12,10,28,-18,16
Anzhi,4326,11,2,6,12,18,42,-24,12
Loko Moscow,4327,1,13,5,2,33,13,20,44
CSKA Moscow,4327,2,12,3,5,28,18,10,39
Spart Moscow,4327,3,10,6,4,38,27,11,36
Zenit,4327,4,7,8,5,22,16,6,29
Krasnodar,4327,5,8,5,7,30,28,2,29
Terek Grozny,4327,6,7,6,7,20,24,-4,27
Din Moscow,4327,7,6,6,8,19,23,-4,24
FK Rubin,4327,8,5,6,9,22,19,3,21
Rostov,4327,9,4,7,9,11,18,-7,19
Amkar,4327,10,4,5,11,9,24,-15,17
Anzhi,4327,11,3,5,12,16,38,-22,14
Loko Moscow,4328,1,12,5,3,32,13,19,41
CSKA Moscow,4328,2,11,4,5,29,18,11,37
Krasnodar,4328,3,10,4,6,30,25,5,34
Spart Moscow,4328,4,8,7,5,36,32,4,31
Zenit,4328,5,7,9,4,22,16,6,30
Terek Grozny,4328,6,8,5,7,22,24,-2,29
FK Rubin,4328,7,6,5,9,24,20,4,23
Din Moscow,4328,8,5,7,8,19,24,-5,22
Amkar,4328,9,6,4,10,14,22,-8,22
Rostov,4328,10,4,7,9,12,19,-7,19
Anzhi,4328,11,2,5,13,16,43,-27,11
Loko Moscow,4329,1,11,6,3,32,15,17,39
Spart Moscow,4329,2,10,6,4,38,27,11,36
CSKA Moscow,4329,3,11,3,6,28,20,8,36
Zenit,4329,4,9,8,3,25,14,11,35
Krasnodar,4329,5,9,5,6,31,26,5,32
Terek Grozny,4329,6,7,7,6,20,22,-2,28
Din Moscow,4329,7,5,8,7,18,22,-4,23
FK Rubin,4329,8,5,6,9,21,19,2,21
Rostov,4329,9,4,6,10,10,18,-8,18
Amkar,4329,10,4,5,11,10,25,-15,17
Anzhi,4329,11,2,6,12,15,40,-25,12
Loko Moscow,4330,1,13,5,2,34,13,21,44
CSKA Moscow,4330,2,11,4,5,27,17,10,37
Spart Moscow,4330,3,9,6,5,37,27,10,33
Krasnodar,4330,4,9,4,7,30,27,3,31
Zenit,4330,5,7,9,4,22,16,6,30
Terek Grozny,4330,6,8,6,6,22,22,0,30
Din Moscow,4330,7,6,6,8,19,24,-5,24
FK Rubin,4330,8,5,5,10,22,21,1,20
Amkar,4330,9,5,5,10,10,22,-12,20
Rostov,4330,10,4,7,9,11,18,-7,19
Anzhi,4330,11,2,5,13,14,41,-27,11
Loko Moscow,4331,1,12,5,3,32,14,18,41
CSKA Moscow,4331,2,12,3,5,31,17,14,39
Spart Moscow,4331,3,9,5,6,36,30,6,32
Zenit,4331,4,8,8,4,23,17,6,32
Terek Grozny,4331,5,9,5,6,24,22,2,32
Krasnodar,4331,6,8,4,8,29,29,0,28
Din Moscow,4331,7,7,6,7,25,26,-1,27
FK Rubin,4331,8,6,5,9,27,22,5,23
Rostov,4331,9,5,6,9,11,17,-6,21
Amkar,4331,10,4,4,12,9,24,-15,16
Anzhi,4331,11,2,5,13,14,43,-29,11
Loko Moscow,4332,1,12,6,2,32,12,20,42
Spart Moscow,4332,2,10,6,4,42,27,15,36
Zenit,4332,3,8,9,3,23,14,9,33
CSKA Moscow,4332,4,10,3,7,25,19,6,33
Krasnodar,4332,5,9,4,7,28,26,2,31
Terek Grozny,4332,6,8,6,6,21,22,-1,30
Din Moscow,4332,7,6,6,8,19,24,-5,24
FK Rubin,4332,8,5,5,10,21,20,1,20
Rostov,4332,9,4,7,9,12,19,-7,19
Amkar,4332,10,4,5,11,9,26,-17,17
Anzhi,4332,11,3,5,12,15,38,-23,14
Loko Moscow,4333,1,12,5,3,35,14,21,41
Zenit,4333,2,9,8,3,25,14,11,35
CSKA Moscow,4333,3,10,4,6,26,20,6,34
Spart Moscow,4333,4,9,6,5,37,29,8,33
Krasnodar,4333,5,8,4,8,30,33,-3,28
Terek Grozny,4333,6,7,6,7,20,24,-4,27
FK Rubin,4333,7,7,5,8,26,19,7,26
Din Moscow,4333,8,5,7,8,18,23,-5,22
Amkar,4333,9,5,5,10,11,23,-12,20
Rostov,4333,10,4,6,10,11,19,-8,18
Anzhi,4333,11,3,6,11,17,38,-21,15
Loko Moscow,4334,1,11,6,3,31,14,17,39
CSKA Moscow,4334,2,12,3,5,29,17,12,39
Zenit,4334,3,8,8,4,24,16,8,32
Spart Moscow,4334,4,9,5,6,36,29,7,32
Terek Grozny,4334,5,8,6,6,23,24,-1,30
Krasnodar,4334,6,8,5,7,27,25,2,29
Din Moscow,4334,7,7,6,7,20,21,-1,27
FK Rubin,4334,8,6,5,9,22,18,4,23
Amkar,4334,9,5,5,10,11,23,-12,20
Rostov,4334,10,4,6,10,10,19,-9,18
Anzhi,4334,11,2,5,13,16,43,-27,11
Loko Moscow,4335,1,12,6,2,31,12,19,42
CSKA Moscow,4335,2,11,3,6,26,18,8,36
Spart Moscow,4335,3,9,6,5,40,28,12,33
Krasnodar,4335,4,9,5,6,30,25,5,32
Zenit,4335,5,7,8,5,21,15,6,29
Terek Grozny,4335,6,7,6,7,22,25,-3,27
FK Rubin,4335,7,6,5,9,22,19,3,23
Din Moscow,4335,8,5,7,8,18,23,-5,22
Rostov,4335,9,5,6,9,12,18,-6,21
Amkar,4335,10,5,4,11,11,28,-17,19
Anzhi,4335,11,3,6,11,16,38,-22,15
Loko Moscow,4336,1,12,5,3,34,16,18,41
CSKA Moscow,4336,2,11,3,6,30,21,9,36
Spart Moscow,4336,3,10,5,5,40,28,12,35
Krasnodar,4336,4,10,4,6,32,26,6,34
Zenit,4336,5,8,8,4,24,17,7,32
Terek Grozny,4336,6,7,6,7,21,25,-4,27
Din Moscow,4336,7,5,7,8,19,26,-7,22
Amkar,4336,8,6,4,10,13,23,-10,22
FK Rubin,4336,9,5,6,9,22,19,3,21
Rostov,4336,10,4,6,10,10,19,-9,18
Anzhi,4336,11,2,6,12,17,42,-25,12
Loko Moscow,4337,1,12,5,3,32,14,18,41
CSKA Moscow,4337,2,11,4,5,29,19,10,37
Spart Moscow,4337,3,10,5,5,39,32,7,35
Krasnodar,4337,4,9,5,6,30,25,5,32
Zenit,4337,5,7,8,5,23,19,4,29
Terek Grozny,4337,6,7,6,7,21,25,-4,27
FK Rubin,4337,7,6,6,8,23,18,5,24
Amkar,4337,8,6,4,10,15,23,-8,22
Din Moscow,4337,9,5,6,9,19,25,-6,21
Rostov,4337,10,4,6,10,11,19,-8,18
Anzhi,4337,11,2,7,11,16,39,-23,13
Loko Moscow,4338,1,12,6,2,34,13,21,42
CSKA Moscow,4338,2,11,3,6,29,22,7,36
Spart Moscow,4338,3,8,8,4,36,28,8,32
Zenit,4338,4,8,8,4,24,17,7,32
Krasnodar,4338,5,9,5,6,31,25,6,32
Terek Grozny,4338,6,8,6,6,23,24,-1,30
Din Moscow,4338,7,5,8,7,20,24,-4,23
FK Rubin,4338,8,5,6,9,23,22,1,21
Rostov,4338,9,4,7,9,11,18,-7,19
Amkar,4338,10,4,5,11,10,24,-14,17
Anzhi,4338,11,2,6,12,19,43,-24,12
Loko Moscow,4339,1,12,5,3,31,13,18,41
CSKA Moscow,4339,2,11,4,5,30,19,11,37
Spart Moscow,4339,3,10,5,5,39,27,12,35
Krasnodar,4339,4,10,4,6,30,25,5,34
Terek Grozny,4339,5,9,5,6,23,23,0,32
Zenit,4339,6,7,9,4,22,15,7,30
Din Moscow,4339,7,5,7,8,17,23,-6,22
FK Rubin,4339,8,5,6,9,21,18,3,21
Amkar,4339,9,5,4,11,11,24,-13,19
Rostov,4339,10,4,6,10,10,20,-10,18
Anzhi,4339,11,2,5,13,16,43,-27,11
Loko Moscow,4340,1,11,6,3,32,15,17,39
CSKA Moscow,4340,2,11,4,5,27,17,10,37
Spart Moscow,4340,3,10,6,4,40,26,14,36
Zenit,4340,4,8,8,4,23,16,7,32
Krasnodar,4340,5,9,5,6,31,27,4,32
Terek Grozny,4340,6,8,6,6,25,24,1,30
Din Moscow,4340,7,5,7,8,18,26,-8,22
FK Rubin,4340,8,5,6,9,23,20,3,21
Rostov,4340,9,4,6,10,10,19,-9,18
Amkar,4340,10,4,5,11,10,26,-16,17
Anzhi,4340,11,2,7,11,16,39,-23,13
Loko Moscow,4341,1,12,6,2,31,12,19,42
Spart Moscow,4341,2,11,5,4,41,26,15,38
CSKA Moscow,4341,3,10,4,6,27,20,7,34
Zenit,4341,4,8,8,4,23,15,8,32
Krasnodar,4341,5,8,5,7,28,27,1,29
Terek Grozny,4341,6,7,6,7,20,24,-4,27
FK Rubin,4341,7,7,5,8,26,18,8,26
Din Moscow,4341,8,5,6,9,18,26,-8,21
Rostov,4341,9,4,6,10,10,21,-11,18
Amkar,4341,10,4,5,11,10,24,-14,17
Anzhi,4341,11,3,6,11,17,38,-21,15
Loko Moscow,4342,1,12,5,3,30,12,18,41
CSKA Moscow,4342,2,12,3,5,31,18,13,39
Spart Moscow,4342,3,10,5,5,41,28,13,35
Krasnodar,4342,4,9,4,7,28,26,2,31
Terek Grozny,4342,5,8,6,6,23,24,-1,30
Zenit,4342,6,7,8,5,21,15,6,29
FK Rubin,4342,7,6,6,8,24,18,6,24
Din Moscow,4342,8,5,7,8,19,25,-6,22
Rostov,4342,9,5,6,9,12,18,-6,21
Amkar,4342,10,4,5,11,10,27,-17,17
Anzhi,4342,11,2,5,13,16,44,-28,11
Loko Moscow,4343,1,12,5,3,32,13,19,41
CSKA Moscow,4343,2,12,3,5,31,18,13,39
Spart Moscow,4343,3,10,5,5,39,31,8,35
Krasnodar,4343,4,9,5,6,31,27,4,32
Zenit,4343,5,7,8,5,22,17,5,29
Terek Grozny,4343,6,7,7,6,22,24,-2,28
FK Rubin,4343,7,6,6,8,27,21,6,24
Din Moscow,4343,8,5,6,9,21,29,-8,21
Amkar,4343,9,5,5,10,14,24,-10,20
Rostov,4343,10,4,6,10,10,18,-8,18
Anzhi,4343,11,2,6,12,15,42,-27,12
Loko Moscow,4344,1,12,6,2,32,12,20,42
Spart Moscow,4344,2,10,6,4,36,26,10,36
CSKA Moscow,4344,3,10,5,5,27,19,8,35
Krasnodar,4344,4,9,5,6,30,25,5,32
Zenit,4344,5,7,9,4,23,17,6,30
Terek Grozny,4344,6,8,6,6,25,26,-1,30
Din Moscow,4344,7,6,7,7,21,23,-2,25
FK Rubin,4344,8,5,5,10,24,24,0,20
Rostov,4344,9,4,6,10,10,18,-8,18
Amkar,4344,10,4,5,11,13,27,-14,17
Anzhi,4344,11,2,6,12,16,40,-24,12
Loko Moscow,4345,1,11,5,4,30,16,14,38
Spart Moscow,4345,2,10,6,4,38,28,10,36
CSKA Moscow,4345,3,11,3,6,28,19,9,36
Zenit,4345,4,9,8,3,26,13,13,35
Krasnodar,4345,5,10,4,6,31,25,6,34
Terek Grozny,4345,6,7,6,7,22,25,-3,27
Din Moscow,4345,7,6,6,8,22,25,-3,24
FK Rubin,4345,8,5,5,10,22,22,0,20
Amkar,4345,9,5,5,10,11,23,-12,20
Rostov,4345,10,4,6,10,10,18,-8,18
Anzhi,4345,11,2,6,12,16,42,-26,12
Loko Moscow,4346,1,13,5,2,33,12,21,44
Spart Moscow,4346,2,10,6,4,39,28,11,36
CSKA Moscow,4346,3,11,3,6,31,20,11,36
Zenit,4346,4,8,8,4,25,16,9,32
Krasnodar,4346,5,9,4,7,32,27,5,31
Terek Grozny,4346,6,7,6,7,20,23,-3,27
Din Moscow,4346,7,6,7,7,19,22,-3,25
FK Rubin,4346,8,5,5,10,23,23,0,20
Rostov,4346,9,4,6,10,12,20,-8,18
Amkar,4346,10,4,5,11,9,24,-15,17
Anzhi,4346,11,3,5,12,15,43,-28,14
Loko Moscow,4347,1,11,7,2,33,15,18,40
Spart Moscow,4347,2,10,6,4,38,27,11,36
CSKA Moscow,4347,3,11,3,6,29,19,10,36
Zenit,4347,4,8,9,3,25,15,10,33
Krasnodar,4347,5,9,5,6,30,26,4,32
Terek Grozny,4347,6,7,5,8,20,26,-6,26
Din Moscow,4347,7,6,6,8,21,26,-5,24
FK Rubin,4347,8,5,5,10,23,21,2,20
Amkar,4347,9,5,5,10,13,23,-10,20
Rostov,4347,10,4,6,10,10,18,-8,18
Anzhi,4347,11,3,5,12,15,41,-26,14
Loko Moscow,4348,1,12,5,3,32,13,19,41
Spart Moscow,4348,2,10,5,5,42,29,13,35
CSKA Moscow,4348,3,10,4,6,26,20,6,34
Zenit,4348,4,8,8,4,23,15,8,32
Krasnodar,4348,5,9,5,6,30,26,4,32
Terek Grozny,4348,6,7,5,8,20,28,-8,26
Din Moscow,4348,7,6,6,8,22,28,-6,24
Amkar,4348,8,6,4,10,12,23,-11,22
FK Rubin,4348,9,5,6,9,23,21,2,21
Rostov,4348,10,4,6,10,10,19,-9,18
Anzhi,4348,11,3,6,11,20,38,-18,15
Loko Moscow,4349,1,11,7,2,31,13,18,40
CSKA Moscow,4349,2,11,4,5,26,17,9,37
Spart Moscow,4349,3,9,6,5,38,28,10,33
Zenit,4349,4,7,10,3,22,14,8,31
Krasnodar,4349,5,8,6,6,29,26,3,30
Terek Grozny,4349,6,8,5,7,22,24,-2,29
FK Rubin,4349,7,6,6,8,25,19,6,24
Din Moscow,4349,8,5,6,9,18,27,-9,21
Rostov,4349,9,4,7,9,12,19,-7,19
Amkar,4349,10,5,4,11,10,23,-13,19
Anzhi,4349,11,3,5,12,16,39,-23,14
Loko Moscow,4350,1,11,5,4,30,18,12,38
CSKA Moscow,4350,2,10,5,5,26,18,8,35
Spart Moscow,4350,3,9,7,4,37,26,11,34
Zenit,4350,4,8,9,3,26,13,13,33
Terek Grozny,4350,5,9,5,6,25,24,1,32
Krasnodar,4350,6,9,4,7,29,26,3,31
FK Rubin,4350,7,6,6,8,22,17,5,24
Din Moscow,4350,8,5,7,8,17,24,-7,22
Rostov,4350,9,4,7,9,11,18,-7,19
Amkar,4350,10,4,5,11,9,24,-15,17
Anzhi,4350,11,2,6,12,17,41,-24,12
Loko Moscow,4351,1,11,6,3,32,15,17,39
CSKA Moscow,4351,2,11,4,5,29,17,12,37
Spart Moscow,4351,3,10,6,4,42,28,14,36
Krasnodar,4351,4,10,4,6,32,26,6,34
Zenit,4351,5,7,10,3,22,14,8,31
Terek Grozny,4351,6,7,5,8,21,25,-4,26
Din Moscow,4351,7,6,6,8,19,26,-7,24
FK Rubin,4351,8,5,5,10,21,20,1,20
Amkar,4351,9,5,5,10,11,23,-12,20
Rostov,4351,10,4,6,10,11,20,-9,18
Anzhi,4351,11,3,5,12,16,42,-26,14
Loko Moscow,4352,1,11,5,4,29,15,14,38
CSKA Moscow,4352,2,11,4,5,29,18,11,37
Zenit,4352,3,8,9,3,23,14,9,33
Krasnodar,4352,4,9,4,7,32,28,4,31
Spart Moscow,4352,5,8,6,6,35,30,5,30
Terek Grozny,4352,6,8,6,6,23,24,-1,30
Din Moscow,4352,7,7,6,7,21,23,-2,27
FK Rubin,4352,8,6,5,9,26,21,5,23
Rostov,4352,9,5,6,9,12,17,-5,21
Amkar,4352,10,4,5,11,10,24,-14,17
Anzhi,4352,11,2,6,12,16,42,-26,12
Loko Moscow,4353,1,12,6,2,33,13,20,42
CSKA Moscow,4353,2,10,5,5,27,19,8,35
Spart Moscow,4353,3,9,7,4,38,27,11,34
Zenit,4353,4,7,9,4,22,16,6,30
Krasnodar,4353,5,8,5,7,29,27,2,29
Terek Grozny,4353,6,7,6,7,20,24,-4,27
FK Rubin,4353,7,6,6,8,23,18,5,24
Din Moscow,4353,8,5,8,7,18,22,-4,23
Amkar,4353,9,5,5,10,12,23,-11,20
Rostov,4353,10,4,6,10,11,21,-10,18
Anzhi,4353,11,2,7,11,15,38,-23,13
Loko Moscow,4354,1,13,5,2,33,12,21,44
CSKA Moscow,4354,2,12,3,5,30,18,12,39
Spart Moscow,4354,3,9,5,6,38,30,8,32
Krasnodar,4354,4,9,4,7,31,26,5,31
Zenit,4354,5,7,8,5,22,19,3,29
Terek Grozny,4354,6,7,7,6,21,23,-2,28
FK Rubin,4354,7,6,5,9,26,21,5,23
Rostov,4354,8,5,6,9,11,17,-6,21
Din Moscow,4354,9,5,6,9,17,27,-10,21
Amkar,4354,10,5,5,10,14,26,-12,20
Anzhi,4354,11,2,6,12,15,39,-24,12
Loko Moscow,4355,1,11,6,3,30,15,15,39
CSKA Moscow,4355,2,11,4,5,27,18,9,37
Spart Moscow,4355,3,10,6,4,36,25,11,36
Krasnodar,4355,4,10,4,6,35,27,8,34
Zenit,4355,5,7,9,4,21,14,7,30
Terek Grozny,4355,6,7,6,7,20,23,-3,27
Din Moscow,4355,7,5,7,8,17,23,-6,22
FK Rubin,4355,8,5,6,9,23,21,2,21
Amkar,4355,9,5,5,10,10,22,-12,20
Rostov,4355,10,4,6,10,10,18,-8,18
Anzhi,4355,11,2,7,11,15,38,-23,13
Loko Moscow,4356,1,11,6,3,31,14,17,39
CSKA Moscow,4356,2,12,3,5,31,19,12,39
Spart Moscow,4356,3,10,6,4,39,27,12,36
Krasnodar,4356,4,10,4,6,33,27,6,34
Zenit,4356,5,7,9,4,23,17,6,30
Terek Grozny,4356,6,8,6,6,24,23,1,30
Din Moscow,4356,7,6,6,8,21,24,-3,24
FK Rubin,4356,8,5,5,10,24,24,0,20
Rostov,4356,9,4,6,10,10,20,-10,18
Amkar,4356,10,4,6,10,11,24,-13,18
Anzhi,4356,11,2,5,13,15,43,-28,11
Loko Moscow,4357,1,11,7,2,30,12,18,40
CSKA Moscow,4357,2,12,3,5,31,21,10,39
Spart Moscow,4357,3,10,6,4,38,26,12,36
Zenit,4357,4,7,9,4,23,16,7,30
Krasnodar,4357,5,8,5,7,27,25,2,29
Terek Grozny,4357,6,7,7,6,22,24,-2,28
FK Rubin,4357,7,7,5,8,25,19,6,26
Din Moscow,4357,8,5,6,9,19,27,-8,21
Rostov,4357,9,4,6,10,10,18,-8,18
Amkar,4357,10,4,6,10,11,24,-13,18
Anzhi,4357,11,2,6,12,18,42,-24,12
Loko Moscow,4358,1,12,6,2,35,11,24,42
Spart Moscow,4358,2,11,5,4,39,26,13,38
CSKA Moscow,4358,3,11,3,6,27,19,8,36
Zenit,4358,4,8,9,3,23,14,9,33
Krasnodar,4358,5,9,4,7,28,30,-2,31
Terek Grozny,4358,6,8,6,6,22,23,-1,30
FK Rubin,4358,7,6,5,9,22,18,4,23
Din Moscow,4358,8,5,6,9,18,24,-6,21
Rostov,4358,9,4,6,10,10,19,-9,18
Amkar,4358,10,4,4,12,9,25,-16,16
Anzhi,4358,11,2,6,12,15,39,-24,12
Loko Moscow,4359,1,13,5,2,32,11,21,44
CSKA Moscow,4359,2,11,3,6,26,20,6,36
Spart Moscow,4359,3,9,6,5,35,28,7,33
Zenit,4359,4,8,8,4,24,15,9,32
Terek Grozny,4359,5,9,5,6,24,22,2,32
Krasnodar,4359,6,8,4,8,27,26,1,28
Din Moscow,4359,7,6,7,7,19,21,-2,25
FK Rubin,4359,8,6,5,9,22,19,3,23
Amkar,4359,9,5,4,11,11,25,-14,19
Rostov,4359,10,4,6,10,11,19,-8,18
Anzhi,4359,11,2,5,13,14,39,-25,11
Loko Moscow,4360,1,13,5,2,35,14,21,44
CSKA Moscow,4360,2,11,3,6,31,19,12,36
Zenit,4360,3,8,8,4,25,18,7,32
Spart Moscow,4360,4,9,5,6,38,33,5,32
Krasnodar,4360,5,8,4,8,29,29,0,28
Terek Grozny,4360,6,7,7,6,21,23,-2,28
FK Rubin,4360,7,7,5,8,26,18,8,26
Din Moscow,4360,8,6,6,8,21,24,-3,24
Rostov,4360,9,5,6,9,13,19,-6,21
Amkar,4360,10,4,5,11,11,25,-14,17
Anzhi,4360,11,2,6,12,14,42,-28,12
Loko Moscow,4361,1,12,6,2,33,13,20,42
Spart Moscow,4361,2,10,5,5,42,27,15,35
CSKA Moscow,4361,3,10,3,7,26,22,4,33
Zenit,4361,4,8,8,4,24,16,8,32
Krasnodar,4361,5,9,5,6,30,26,4,32
Terek Grozny,4361,6,8,5,7,24,24,0,29
Din Moscow,4361,7,5,7,8,18,26,-8,22
FK Rubin,4361,8,5,6,9,22,19,3,21
Rostov,4361,9,5,6,9,12,18,-6,21
Anzhi,4361,10,4,5,11,18,38,-20,17
Amkar,4361,11,4,4,12,9,29,-20,16
Spart Moscow,4362,1,11,5,4,40,25,15,38
Loko Moscow,4362,2,11,5,4,31,16,15,38
CSKA Moscow,4362,3,11,3,6,31,18,13,36
Zenit,4362,4,9,8,3,24,14,10,35
Krasnodar,4362,5,9,5,6,31,26,5,32
Terek Grozny,4362,6,8,6,6,23,23,0,30
FK Rubin,4362,7,5,7,8,22,18,4,22
Din Moscow,4362,8,5,7,8,17,25,-8,22
Rostov,4362,9,4,6,10,10,18,-8,18
Amkar,4362,10,4,4,12,10,27,-17,16
Anzhi,4362,11,2,6,12,14,43,-29,12
Loko Moscow,4363,1,11,6,3,29,14,15,39
CSKA Moscow,4363,2,11,4,5,27,17,10,37
Terek Grozny,4363,3,9,5,6,28,26,2,32
Zenit,4363,4,7,10,3,21,13,8,31
Spart Moscow,4363,5,8,7,5,34,29,5,31
Krasnodar,4363,6,9,4,7,30,25,5,31
FK Rubin,4363,7,7,5,8,24,17,7,26
Din Moscow,4363,8,5,7,8,18,24,-6,22
Rostov,4363,9,4,7,9,10,17,-7,19
Amkar,4363,10,5,4,11,13,25,-12,19
Anzhi,4363,11,2,5,13,17,44,-27,11
Loko Moscow,4364,1,13,5,2,32,12,20,44
CSKA Moscow,4364,2,11,3,6,26,19,7,36
Spart Moscow,4364,3,9,6,5,36,29,7,33
Terek Grozny,4364,4,8,6,6,23,23,0,30
Zenit,4364,5,7,8,5,22,16,6,29
Krasnodar,4364,6,8,5,7,28,26,2,29
FK Rubin,4364,7,6,6,8,23,18,5,24
Din Moscow,4364,8,6,6,8,19,22,-3,24
Rostov,4364,9,4,7,9,11,18,-7,19
Amkar,4364,10,4,5,11,10,24,-14,17
Anzhi,4364,11,3,5,12,17,40,-23,14
Loko Moscow,4365,1,11,6,3,30,14,16,39
CSKA Moscow,4365,2,11,4,5,27,18,9,37
Spart Moscow,4365,3,10,6,4,42,30,12,36
Zenit,4365,4,8,8,4,24,15,9,32
Krasnodar,4365,5,8,5,7,28,29,-1,29
Terek Grozny,4365,6,7,6,7,21,25,-4,27
Din Moscow,4365,7,6,7,7,20,23,-3,25
FK Rubin,4365,8,6,5,9,26,19,7,23
Rostov,4365,9,4,6,10,11,21,-10,18
Amkar,4365,10,4,5,11,12,26,-14,17
Anzhi,4365,11,3,6,11,17,38,-21,15
Loko Moscow,4366,1,12,5,3,32,13,19,41
Spart Moscow,4366,2,11,5,4,43,26,17,38
CSKA Moscow,4366,3,10,3,7,25,19,6,33
Zenit,4366,4,8,8,4,22,15,7,32
Krasnodar,4366,5,9,4,7,29,26,3,31
Terek Grozny,4366,6,8,5,7,21,24,-3,29
Din Moscow,4366,7,6,6,8,20,23,-3,24
FK Rubin,4366,8,6,5,9,22,19,3,23
Rostov,4366,9,4,6,10,10,23,-13,18
Anzhi,4366,10,4,5,11,17,37,-20,17
Amkar,4366,11,4,4,12,9,25,-16,16
Loko Moscow,4367,1,11,6,3,31,16,15,39
CSKA Moscow,4367,2,11,4,5,28,19,9,37
Zenit,4367,3,8,9,3,26,15,11,33
Krasnodar,4367,4,9,5,6,29,25,4,32
Spart Moscow,4367,5,8,6,6,36,30,6,30
Terek Grozny,4367,6,7,6,7,21,24,-3,27
Din Moscow,4367,7,6,7,7,20,23,-3,25
Amkar,4367,8,6,4,10,11,22,-11,22
FK Rubin,4367,9,5,6,9,21,18,3,21
Rostov,4367,10,4,7,9,11,18,-7,19
Anzhi,4367,11,2,6,12,16,40,-24,12
Loko Moscow,4368,1,11,6,3,30,14,16,39
Spart Moscow,4368,2,9,7,4,37,28,9,34
CSKA Moscow,4368,3,10,4,6,27,20,7,34
Zenit,4368,4,8,9,3,24,15,9,33
Krasnodar,4368,5,9,5,6,29,24,5,32
Terek Grozny,4368,6,7,6,7,22,26,-4,27
FK Rubin,4368,7,6,6,8,22,17,5,24
Din Moscow,4368,8,5,7,8,17,22,-5,22
Amkar,4368,9,5,5,10,12,23,-11,20
Rostov,4368,10,4,6,10,12,20,-8,18
Anzhi,4368,11,2,7,11,17,40,-23,13
Loko Moscow,4369,1,12,6,2,31,12,19,42
CSKA Moscow,4369,2,12,3,5,30,20,10,39
Spart Moscow,4369,3,10,5,5,39,30,9,35
Zenit,4369,4,7,9,4,23,16,7,30
Krasnodar,4369,5,8,5,7,30,28,2,29
Terek Grozny,4369,6,7,6,7,22,26,-4,27
FK Rubin,4369,7,5,7,8,24,20,4,22
Din Moscow,4369,8,5,7,8,19,24,-5,22
Amkar,4369,9,6,4,10,14,24,-10,22
Rostov,4369,10,4,6,10,11,19,-8,18
Anzhi,4369,11,2,6,12,17,41,-24,12
Loko Moscow,4370,1,12,5,3,33,17,16,41
Spart Moscow,4370,2,11,5,4,41,29,12,38
Krasnodar,4370,3,10,4,6,32,25,7,34
CSKA Moscow,4370,4,10,4,6,26,19,7,34
Zenit,4370,5,7,9,4,24,17,7,30
Terek Grozny,4370,6,7,5,8,22,26,-4,26
Din Moscow,4370,7,6,6,8,21,25,-4,24
FK Rubin,4370,8,5,5,10,22,21,1,20
Amkar,4370,9,5,4,11,12,25,-13,19
Rostov,4370,10,4,6,10,12,20,-8,18
Anzhi,4370,11,4,5,11,17,38,-21,17
Loko Moscow,4371,1,12,5,3,31,12,19,41
CSKA Moscow,4371,2,11,4,5,32,19,13,37
Spart Moscow,4371,3,10,6,4,40,28,12,36
Krasnodar,4371,4,10,4,6,30,25,5,34
Terek Grozny,4371,5,9,5,6,24,23,1,32
Zenit,4371,6,7,9,4,23,17,6,30
Din Moscow,4371,7,5,8,7,20,24,-4,23
FK Rubin,4371,8,5,6,9,24,21,3,21
Rostov,4371,9,4,6,10,11,20,-9,18
Amkar,4371,10,4,4,12,10,27,-17,16
Anzhi,4371,11,2,5,13,15,44,-29,11
Loko Moscow,4372,1,11,6,3,30,13,17,39
Spart Moscow,4372,2,10,6,4,39,27,12,36
CSKA Moscow,4372,3,11,3,6,29,18,11,36
Zenit,4372,4,8,9,3,23,14,9,33
Krasnodar,4372,5,9,4,7,29,26,3,31
Terek Grozny,4372,6,8,6,6,24,24,0,30
FK Rubin,4372,7,6,6,8,25,20,5,24
Din Moscow,4372,8,5,7,8,19,26,-7,22
Rostov,4372,9,4,7,9,12,19,-7,19
Amkar,4372,10,4,4,12,9,25,-16,16
Anzhi,4372,11,2,6,12,16,43,-27,12
Loko Moscow,4373,1,13,5,2,33,12,21,44
Spart Moscow,4373,2,10,5,5,38,28,10,35
CSKA Moscow,4373,3,10,5,5,26,18,8,35
Krasnodar,4373,4,9,4,7,31,29,2,31
Zenit,4373,5,7,9,4,21,14,7,30
Terek Grozny,4373,6,7,7,6,21,23,-2,28
Din Moscow,4373,7,5,7,8,17,23,-6,22
FK Rubin,4373,8,5,6,9,23,20,3,21
Amkar,4373,9,5,5,10,11,22,-11,20
Rostov,4373,10,4,6,10,11,20,-9,18
Anzhi,4373,11,2,7,11,16,39,-23,13
Loko Moscow,4374,1,12,5,3,30,14,16,41
Spart Moscow,4374,2,11,5,4,39,25,14,38
CSKA Moscow,4374,3,11,4,5,26,17,9,37
Krasnodar,4374,4,10,4,6,31,24,7,34
Zenit,4374,5,7,8,5,21,15,6,29
Terek Grozny,4374,6,8,5,7,22,24,-2,29
Din Moscow,4374,7,5,7,8,19,25,-6,22
FK Rubin,4374,8,5,6,9,23,20,3,21
Amkar,4374,9,5,4,11,10,23,-13,19
Rostov,4374,10,4,6,10,10,20,-10,18
Anzhi,4374,11,2,6,12,15,39,-24,12
Loko Moscow,4375,1,12,5,3,31,14,17,41
CSKA Moscow,4375,2,12,3,5,27,17,10,39
Spart Moscow,4375,3,9,7,4,38,27,11,34
Zenit,4375,4,8,8,4,23,14,9,32
Krasnodar,4375,5,9,4,7,31,27,4,31
Terek Grozny,4375,6,8,6,6,25,24,1,30
Din Moscow,4375,7,6,6,8,18,24,-6,24
FK Rubin,4375,8,5,5,10,22,21,1,20
Rostov,4375,9,4,7,9,11,18,-7,19
Amkar,4375,10,4,6,10,11,24,-13,18
Anzhi,4375,11,2,5,13,15,42,-27,11
Loko Moscow,4376,1,13,5,2,34,13,21,44
Spart Moscow,4376,2,10,6,4,39,27,12,36
CSKA Moscow,4376,3,11,3,6,26,19,7,36
Zenit,4376,4,8,8,4,23,15,8,32
Terek Grozny,4376,5,9,5,6,24,24,0,32
Krasnodar,4376,6,8,5,7,30,28,2,29
Din Moscow,4376,7,5,8,7,19,23,-4,23
FK Rubin,4376,8,5,7,8,23,19,4,22
Rostov,4376,9,4,6,10,10,18,-8,18
Amkar,4376,10,4,4,12,12,29,-17,16
Anzhi,4376,11,2,5,13,14,39,-25,11
Loko Moscow,4377,1,12,5,3,31,13,18,41
CSKA Moscow,4377,2,11,3,6,28,20,8,36
Zenit,4377,3,9,8,3,25,15,10,35
Spart Moscow,4377,4,9,6,5,34,26,8,33
Terek Grozny,4377,5,8,6,6,23,22,1,30
Krasnodar,4377,6,8,4,8,28,27,1,28
Din Moscow,4377,7,6,6,8,19,22,-3,24
FK Rubin,4377,8,6,5,9,23,20,3,23
Rostov,4377,9,5,6,9,11,17,-6,21
Amkar,4377,10,4,6,10,9,22,-13,18
Anzhi,4377,11,2,5,13,15,42,-27,11
Loko Moscow,4378,1,12,6,2,31,12,19,42
CSKA Moscow,4378,2,11,3,6,29,19,10,36
Zenit,4378,3,8,8,4,23,15,8,32
Spart Moscow,4378,4,9,5,6,36,30,6,32
Terek Grozny,4378,5,8,6,6,24,25,-1,30
Krasnodar,4378,6,8,5,7,28,27,1,29
FK Rubin,4378,7,6,6,8,24,18,6,24
Din Moscow,4378,8,5,7,8,18,24,-6,22
Rostov,4378,9,5,6,9,12,17,-5,21
Amkar,4378,10,5,5,10,15,26,-11,20
Anzhi,4378,11,2,5,13,14,41,-27,11
Loko Moscow,4379,1,12,5,3,30,13,17,41
Spart Moscow,4379,2,10,6,4,39,25,14,36
CSKA Moscow,4379,3,10,5,5,27,19,8,35
Krasnodar,4379,4,10,4,6,31,25,6,34
Zenit,4379,5,7,9,4,22,15,7,30
Terek Grozny,4379,6,7,5,8,21,26,-5,26
FK Rubin,4379,7,6,5,9,23,19,4,23
Din Moscow,4379,8,5,6,9,17,26,-9,21
Amkar,4379,9,5,5,10,11,22,-11,20
Rostov,4379,10,4,6,10,10,19,-9,18
Anzhi,4379,11,3,6,11,17,39,-22,15
Loko Moscow,4380,1,12,5,3,31,13,18,41
CSKA Moscow,4380,2,12,3,5,31,17,14,39
Spart Moscow,4380,3,9,7,4,41,31,10,34
Krasnodar,4380,4,9,5,6,31,26,5,32
Zenit,4380,5,7,8,5,21,17,4,29
Terek Grozny,4380,6,7,6,7,23,26,-3,27
FK Rubin,4380,7,5,7,8,23,19,4,22
Din Moscow,4380,8,5,7,8,20,26,-6,22
Rostov,4380,9,4,7,9,11,18,-7,19
Amkar,4380,10,4,6,10,12,25,-13,18
Anzhi,4380,11,3,5,12,17,43,-26,14
Loko Moscow,4381,1,11,5,4,29,15,14,38
CSKA Moscow,4381,2,11,4,5,30,19,11,37
Krasnodar,4381,3,10,4,6,32,25,7,34
Zenit,4381,4,8,9,3,23,14,9,33
Spart Moscow,4381,5,9,6,5,35,27,8,33
Terek Grozny,4381,6,7,6,7,22,25,-3,27
FK Rubin,4381,7,6,5,9,24,20,4,23
Din Moscow,4381,8,5,6,9,18,24,-6,21
Amkar,4381,9,5,5,10,10,22,-12,20
Rostov,4381,10,4,7,9,11,18,-7,19
Anzhi,4381,11,3,5,12,18,43,-25,14
Loko Moscow,4382,1,12,6,2,34,14,20,42
Zenit,4382,2,8,9,3,23,14,9,33
CSKA Moscow,4382,3,10,3,7,26,20,6,33
Spart Moscow,4382,4,8,6,6,35,32,3,30
Terek Grozny,4382,5,8,6,6,21,22,-1,30
Krasnodar,4382,6,8,4,8,30,31,-1,28
FK Rubin,4382,7,7,5,8,26,18,8,26
Din Moscow,4382,8,6,6,8,19,24,-5,24
Rostov,4382,9,4,7,9,10,17,-7,19
Amkar,4382,10,5,4,11,14,24,-10,19
Anzhi,4382,11,3,6,11,16,38,-22,15
Loko Moscow,4383,1,13,5,2,32,12,20,44
CSKA Moscow,4383,2,12,3,5,29,17,12,39
Spart Moscow,4383,3,10,5,5,37,27,10,35
Zenit,4383,4,7,8,5,22,16,6,29
Krasnodar,4383,5,8,5,7,27,25,2,29
Terek Grozny,4383,6,7,6,7,21,25,-4,27
Din Moscow,4383,7,6,7,7,18,21,-3,25
FK Rubin,4383,8,5,7,8,21,17,4,22
Rostov,4383,9,4,6,10,11,19,-8,18
Amkar,4383,10,4,5,11,10,25,-15,17
Anzhi,4383,11,3,5,12,16,40,-24,14
Loko Moscow,4384,1,12,5,3,30,12,18,41
CSKA Moscow,4384,2,11,3,6,28,19,9,36
Zenit,4384,3,9,8,3,24,13,11,35
Spart Moscow,4384,4,9,5,6,37,29,8,32
Terek Grozny,4384,5,9,5,6,26,24,2,32
Krasnodar,4384,6,9,4,7,28,25,3,31
Din Moscow,4384,7,6,6,8,21,24,-3,24
FK Rubin,4384,8,6,5,9,23,19,4,23
Amkar,4384,9,5,4,11,11,24,-13,19
Rostov,4384,10,4,6,10,10,20,-10,18
Anzhi,4384,11,2,5,13,15,44,-29,11
Loko Moscow,4385,1,12,5,3,30,13,17,41
CSKA Moscow,4385,2,10,5,5,26,18,8,35
Krasnodar,4385,3,10,4,6,32,25,7,34
Spart Moscow,4385,4,8,7,5,37,30,7,31
Zenit,4385,5,7,9,4,22,15,7,30
Terek Grozny,4385,6,8,6,6,22,23,-1,30
Din Moscow,4385,7,6,7,7,21,23,-2,25
FK Rubin,4385,8,5,5,10,22,22,0,20
Rostov,4385,9,4,7,9,11,18,-7,19
Amkar,4385,10,5,4,11,11,24,-13,19
Anzhi,4385,11,2,7,11,15,38,-23,13
Loko Moscow,4386,1,12,6,2,32,12,20,42
CSKA Moscow,4386,2,11,3,6,28,19,9,36
Spart Moscow,4386,3,10,5,5,40,30,10,35
Zenit,4386,4,8,9,3,23,14,9,33
Krasnodar,4386,5,8,5,7,28,27,1,29
Terek Grozny,4386,6,7,5,8,22,27,-5,26
Din Moscow,4386,7,6,6,8,21,24,-3,24
FK Rubin,4386,8,5,6,9,22,21,1,21
Rostov,4386,9,5,6,9,14,20,-6,21
Amkar,4386,10,5,4,11,11,24,-13,19
Anzhi,4386,11,3,5,12,18,41,-23,14
Loko Moscow,4387,1,12,5,3,33,13,20,41
CSKA Moscow,4387,2,10,4,6,25,20,5,34
Zenit,4387,3,8,8,4,24,16,8,32
Krasnodar,4387,4,9,4,7,29,26,3,31
Spart Moscow,4387,5,8,6,6,35,29,6,30
Terek Grozny,4387,6,8,6,6,25,23,2,30
FK Rubin,4387,7,7,5,8,23,17,6,26
Din Moscow,4387,8,5,7,8,18,23,-5,22
Rostov,4387,9,5,6,9,12,18,-6,21
Amkar,4387,10,5,5,10,11,23,-12,20
Anzhi,4387,11,2,6,12,14,41,-27,12
Loko Moscow,4388,1,11,7,2,31,13,18,40
CSKA Moscow,4388,2,11,4,5,27,18,9,37
Spart Moscow,4388,3,9,7,4,35,25,10,34
Krasnodar,4388,4,9,5,6,31,26,5,32
Zenit,4388,5,7,10,3,22,14,8,31
Terek Grozny,4388,6,8,5,7,21,25,-4,29
Din Moscow,4388,7,6,6,8,18,23,-5,24
FK Rubin,4388,8,5,5,10,22,21,1,20
Amkar,4388,9,5,5,10,12,22,-10,20
Rostov,4388,10,4,7,9,10,17,-7,19
Anzhi,4388,11,2,5,13,15,40,-25,11
Loko Moscow,4389,1,12,5,3,32,14,18,41
CSKA Moscow,4389,2,12,3,5,29,17,12,39
Spart Moscow,4389,3,10,5,5,38,28,10,35
Zenit,4389,4,8,8,4,22,14,8,32
Terek Grozny,4389,5,9,5,6,23,23,0,32
Krasnodar,4389,6,9,4,7,31,28,3,31
FK Rubin,4389,7,6,5,9,24,20,4,23
Din Moscow,4389,8,5,6,9,18,24,-6,21
Amkar,4389,9,5,4,11,11,23,-12,19
Rostov,4389,10,4,6,10,11,21,-10,18
Anzhi,4389,11,2,5,13,15,42,-27,11
Loko Moscow,4390,1,11,6,3,31,16,15,39
Spart Moscow,4390,2,11,5,4,43,27,16,38
Zenit,4390,3,8,9,3,24,15,9,33
CSKA Moscow,4390,4,10,3,7,26,20,6,33
Krasnodar,4390,5,9,5,6,31,25,6,32
Terek Grozny,4390,6,7,6,7,21,24,-3,27
Din Moscow,4390,7,6,6,8,20,27,-7,24
FK Rubin,4390,8,5,6,9,22,20,2,21
Rostov,4390,9,4,6,10,11,19,-8,18
Amkar,4390,10,4,5,11,10,25,-15,17
Anzhi,4390,11,4,5,11,17,38,-21,17
Loko Moscow,4391,1,13,5,2,31,11,20,44
CSKA Moscow,4391,2,10,5,5,28,20,8,35
Zenit,4391,3,7,9,4,22,15,7,30
Spart Moscow,4391,4,8,5,7,33,29,4,29
Krasnodar,4391,5,8,4,8,28,30,-2,28
Din Moscow,4391,6,7,6,7,20,21,-1,27
Terek Grozny,4391,7,7,5,8,21,25,-4,26
FK Rubin,4391,8,6,5,9,26,19,7,23
Amkar,4391,9,6,4,10,11,22,-11,22
Rostov,4391,10,5,6,9,11,17,-6,21
Anzhi,4391,11,3,6,11,18,40,-22,15
Loko Moscow,4392,1,13,5,2,32,11,21,44
CSKA Moscow,4392,2,10,3,7,26,20,6,33
Zenit,4392,3,8,8,4,23,15,8,32
Spart Moscow,4392,4,9,5,6,36,29,7,32
Krasnodar,4392,5,9,4,7,29,26,3,31
Din Moscow,4392,6,7,6,7,21,22,-1,27
Terek Grozny,4392,7,7,6,7,23,26,-3,27
Rostov,4392,8,5,6,9,12,18,-6,21
FK Rubin,4392,9,5,5,10,21,21,0,20
Amkar,4392,10,4,5,11,11,25,-14,17
Anzhi,4392,11,4,5,11,17,38,-21,17
Loko Moscow,4393,1,13,5,2,33,12,21,44
CSKA Moscow,4393,2,12,3,5,28,17,11,39
Spart Moscow,4393,3,10,5,5,39,29,10,35
Terek Grozny,4393,4,8,6,6,23,24,-1,30
Zenit,4393,5,7,8,5,22,18,4,29
Krasnodar,4393,6,8,5,7,28,26,2,29
Din Moscow,4393,7,6,6,8,21,23,-2,24
FK Rubin,4393,8,5,6,9,22,21,1,21
Amkar,4393,9,5,5,10,12,24,-12,20
Rostov,4393,10,4,6,10,11,20,-9,18
Anzhi,4393,11,2,5,13,15,40,-25,11
Loko Moscow,4394,1,12,6,2,34,12,22,42
CSKA Moscow,4394,2,12,3,5,29,17,12,39
Spart Moscow,4394,3,10,5,5,39,27,12,35
Zenit,4394,4,7,9,4,21,16,5,30
Krasnodar,4394,5,8,5,7,29,30,-1,29
Terek Grozny,4394,6,7,5,8,20,25,-5,26
Din Moscow,4394,7,6,6,8,19,23,-4,24
Amkar,4394,8,6,4,10,11,22,-11,22
FK Rubin,4394,9,5,6,9,22,19,3,21
Rostov,4394,10,4,6,10,10,21,-11,18
Anzhi,4394,11,3,5,12,16,38,-22,14
Loko Moscow,4395,1,13,5,2,33,12,21,44
CSKA Moscow,4395,2,11,3,6,27,20,7,36
Spart Moscow,4395,3,9,6,5,37,28,9,33
Zenit,4395,4,8,8,4,23,15,8,32
Krasnodar,4395,5,9,4,7,31,27,4,31
Terek Grozny,4395,6,7,5,8,21,25,-4,26
Din Moscow,4395,7,6,6,8,20,25,-5,24
FK Rubin,4395,8,6,5,9,26,21,5,23
Amkar,4395,9,5,5,10,11,23,-12,20
Rostov,4395,10,4,6,10,11,21,-10,18
Anzhi,4395,11,3,5,12,16,39,-23,14
Loko Moscow,4396,1,12,6,2,33,13,20,42
CSKA Moscow,4396,2,11,3,6,27,18,9,36
Spart Moscow,4396,3,10,5,5,36,28,8,35
Zenit,4396,4,8,8,4,22,15,7,32
Krasnodar,4396,5,9,5,6,30,26,4,32
Terek Grozny,4396,6,7,5,8,21,26,-5,26
Din Moscow,4396,7,5,7,8,18,23,-5,22
FK Rubin,4396,8,5,6,9,21,18,3,21
Rostov,4396,9,5,6,9,12,17,-5,21
Amkar,4396,10,5,4,11,10,23,-13,19
Anzhi,4396,11,3,5,12,17,40,-23,14
Loko Moscow,4397,1,13,5,2,33,12,21,44
Spart Moscow,4397,2,10,6,4,38,27,11,36
CSKA Moscow,4397,3,10,4,6,28,21,7,34
Zenit,4397,4,8,8,4,23,16,7,32
Krasnodar,4397,5,8,5,7,30,28,2,29
Terek Grozny,4397,6,7,7,6,21,23,-2,28
Din Moscow,4397,7,6,7,7,19,22,-3,25
FK Rubin,4397,8,5,6,9,23,20,3,21
Rostov,4397,9,4,6,10,11,19,-8,18
Amkar,4397,10,4,5,11,10,25,-15,17
Anzhi,4397,11,2,7,11,16,39,-23,13
Loko Moscow,4398,1,12,6,2,33,14,19,42
CSKA Moscow,4398,2,11,4,5,29,20,9,37
Spart Moscow,4398,3,9,7,4,35,25,10,34
Krasnodar,4398,4,9,5,6,31,26,5,32
Zenit,4398,5,7,9,4,25,18,7,30
Terek Grozny,4398,6,7,5,8,20,26,-6,26
Din Moscow,4398,7,6,6,8,18,23,-5,24
FK Rubin,4398,8,5,5,10,21,20,1,20
Amkar,4398,9,5,5,10,11,22,-11,20
Rostov,4398,10,4,7,9,10,17,-7,19
Anzhi,4398,11,3,5,12,16,38,-22,14
CSKA Moscow,4399,1,12,3,5,29,17,12,39
Loko Moscow,4399,2,11,5,4,30,16,14,38
Spart Moscow,4399,3,9,6,5,38,29,9,33
Zenit,4399,4,8,8,4,24,15,9,32
Krasnodar,4399,5,9,4,7,32,29,3,31
Terek Grozny,4399,6,7,7,6,21,23,-2,28
FK Rubin,4399,7,7,5,8,28,21,7,26
Din Moscow,4399,8,5,7,8,19,24,-5,22
Amkar,4399,9,5,5,10,13,24,-11,20
Rostov,4399,10,4,6,10,10,20,-10,18
Anzhi,4399,11,2,6,12,14,40,-26,12
Loko Moscow,4400,1,12,6,2,34,14,20,42
CSKA Moscow,4400,2,12,3,5,28,18,10,39
Spart Moscow,4400,3,10,5,5,39,28,11,35
Krasnodar,4400,4,9,5,6,33,29,4,32
Zenit,4400,5,7,8,5,22,17,5,29
Terek Grozny,4400,6,8,5,7,21,23,-2,29
Din Moscow,4400,7,6,6,8,19,22,-3,24
FK Rubin,4400,8,5,5,10,23,22,1,20
Amkar,4400,9,5,4,11,12,24,-12,19
Rostov,4400,10,4,6,10,10,21,-11,18
Anzhi,4400,11,3,5,12,15,38,-23,14
Loko Moscow,4401,1,12,5,3,31,14,17,41
CSKA Moscow,4401,2,12,3,5,30,18,12,39
Krasnodar,4401,3,10,4,6,31,25,6,34
Spart Moscow,4401,4,9,6,5,34,26,8,33
Zenit,4401,5,7,8,5,23,18,5,29
Din Moscow,4401,6,7,6,7,20,21,-1,27
Terek Grozny,4401,7,7,5,8,20,24,-4,26
FK Rubin,4401,8,5,5,10,22,21,1,20
Rostov,4401,9,4,7,9,10,17,-7,19
Amkar,4401,10,5,4,11,10,23,-13,19
Anzhi,4401,11,3,5,12,15,39,-24,14
Loko Moscow,4402,1,12,5,3,30,12,18,41
CSKA Moscow,4402,2,12,3,5,28,17,11,39
Spart Moscow,4402,3,10,5,5,38,27,11,35
Krasnodar,4402,4,10,4,6,29,24,5,34
Terek Grozny,4402,5,9,5,6,23,22,1,32
Zenit,4402,6,7,8,5,21,15,6,29
Din Moscow,4402,7,6,6,8,18,22,-4,24
FK Rubin,4402,8,5,5,10,21,19,2,20
Amkar,4402,9,5,4,11,11,25,-14,19
Rostov,4402,10,4,6,10,10,20,-10,18
Anzhi,4402,11,2,5,13,14,40,-26,11
Loko Moscow,4403,1,12,5,3,32,14,18,41
Spart Moscow,4403,2,10,5,5,43,31,12,35
Zenit,4403,3,9,8,3,25,14,11,35
CSKA Moscow,4403,4,10,4,6,27,20,7,34
Terek Grozny,4403,5,8,5,7,21,23,-2,29
Krasnodar,4403,6,8,4,8,28,28,0,28
Din Moscow,4403,7,6,6,8,21,29,-8,24
FK Rubin,4403,8,6,5,9,23,19,4,23
Rostov,4403,9,5,6,9,14,18,-4,21
Amkar,4403,10,5,4,11,10,24,-14,19
Anzhi,4403,11,2,6,12,15,39,-24,12
Loko Moscow,4404,1,11,5,4,30,14,16,38
CSKA Moscow,4404,2,11,3,6,31,19,12,36
Zenit,4404,3,9,8,3,24,14,10,35
Spart Moscow,4404,4,9,6,5,36,28,8,33
Krasnodar,4404,5,9,4,7,28,27,1,31
Terek Grozny,4404,6,8,6,6,22,23,-1,30
FK Rubin,4404,7,7,5,8,26,18,8,26
Din Moscow,4404,8,5,6,9,19,25,-6,21
Rostov,4404,9,4,7,9,10,17,-7,19
Amkar,4404,10,5,4,11,11,24,-13,19
Anzhi,4404,11,2,6,12,16,44,-28,12
Loko Moscow,4405,1,11,6,3,32,15,17,39
CSKA Moscow,4405,2,10,5,5,26,18,8,35
Zenit,4405,3,8,9,3,24,15,9,33
Spart Moscow,4405,4,9,6,5,36,28,8,33
Krasnodar,4405,5,8,6,6,29,26,3,30
Terek Grozny,4405,6,8,5,7,23,24,-1,29
FK Rubin,4405,7,5,7,8,22,18,4,22
Din Moscow,4405,8,5,7,8,18,23,-5,22
Rostov,4405,9,5,6,9,11,17,-6,21
Amkar,4405,10,4,5,11,11,26,-15,17
Anzhi,4405,11,3,6,11,16,38,-22,15
Loko Moscow,4406,1,12,5,3,32,13,19,41
CSKA Moscow,4406,2,11,4,5,30,19,11,37
Spart Moscow,4406,3,10,6,4,41,26,15,36
Krasnodar,4406,4,9,5,6,30,26,4,32
Terek Grozny,4406,5,9,5,6,24,23,1,32
Zenit,4406,6,7,9,4,23,17,6,30
Din Moscow,4406,7,6,6,8,20,24,-4,24
FK Rubin,4406,8,5,6,9,22,21,1,21
Rostov,4406,9,4,6,10,11,22,-11,18
Amkar,4406,10,4,5,11,10,24,-14,17
Anzhi,4406,11,2,5,13,14,42,-28,11
Loko Moscow,4407,1,11,7,2,30,12,18,40
Spart Moscow,4407,2,11,5,4,40,27,13,38
CSKA Moscow,4407,3,11,4,5,27,17,10,37
Zenit,4407,4,7,10,3,22,14,8,31
Krasnodar,4407,5,8,6,6,27,24,3,30
Terek Grozny,4407,6,8,6,6,22,23,-1,30
Din Moscow,4407,7,6,6,8,18,24,-6,24
FK Rubin,4407,8,5,6,9,21,18,3,21
Rostov,4407,9,4,6,10,11,19,-8,18
Amkar,4407,10,4,5,11,11,25,-14,17
Anzhi,4407,11,2,5,13,14,40,-26,11
Loko Moscow,4408,1,12,5,3,32,15,17,41
CSKA Moscow,4408,2,12,3,5,30,17,13,39
Spart Moscow,4408,3,10,6,4,41,28,13,36
Zenit,4408,4,8,8,4,24,14,10,32
Terek Grozny,4408,5,9,5,6,26,24,2,32
Krasnodar,4408,6,9,4,7,29,27,2,31
FK Rubin,4408,7,6,5,9,22,18,4,23
Din Moscow,4408,8,5,6,9,18,27,-9,21
Rostov,4408,9,4,7,9,11,18,-7,19
Amkar,4408,10,4,4,12,11,26,-15,16
Anzhi,4408,11,2,5,13,15,45,-30,11
Loko Moscow,4409,1,12,5,3,31,13,18,41
CSKA Moscow,4409,2,11,3,6,26,18,8,36
Zenit,4409,3,9,8,3,24,13,11,35
Spart Moscow,4409,4,9,6,5,37,29,8,33
Krasnodar,4409,5,8,4,8,27,27,0,28
Terek Grozny,4409,6,7,7,6,21,23,-2,28
Din Moscow,4409,7,6,7,7,23,25,-2,25
FK Rubin,4409,8,6,5,9,23,20,3,23
Amkar,4409,9,5,5,10,10,22,-12,20
Rostov,4409,10,4,6,10,10,18,-8,18
Anzhi,4409,11,2,6,12,15,39,-24,12
Loko Moscow,4410,1,12,5,3,31,13,18,41
CSKA Moscow,4410,2,11,4,5,26,17,9,37
Krasnodar,4410,3,10,4,6,32,25,7,34
Spart Moscow,4410,4,9,6,5,39,28,11,33
Zenit,4410,5,7,9,4,21,14,7,30
Terek Grozny,4410,6,7,7,6,22,24,-2,28
Din Moscow,4410,7,6,6,8,19,23,-4,24
FK Rubin,4410,8,6,5,9,22,20,2,23
Rostov,4410,9,4,6,10,10,21,-11,18
Amkar,4410,10,4,6,10,11,24,-13,18
Anzhi,4410,11,2,6,12,15,39,-24,12
CSKA Moscow,4411,1,12,3,5,29,18,11,39
Loko Moscow,4411,2,11,5,4,29,17,12,38
Zenit,4411,3,8,8,4,23,14,9,32
Spart Moscow,4411,4,9,5,6,38,31,7,32
Krasnodar,4411,5,9,4,7,31,27,4,31
Terek Grozny,4411,6,8,5,7,24,25,-1,29
Din Moscow,4411,7,7,6,7,22,22,0,27
FK Rubin,4411,8,6,5,9,24,18,6,23
Amkar,4411,9,6,4,10,14,25,-11,22
Rostov,4411,10,4,6,10,10,20,-10,18
Anzhi,4411,11,2,5,13,15,42,-27,11
Loko Moscow,4412,1,13,5,2,33,13,20,44
Spart Moscow,4412,2,11,5,4,37,25,12,38
CSKA Moscow,4412,3,11,3,6,29,20,9,36
Zenit,4412,4,8,8,4,24,15,9,32
Krasnodar,4412,5,8,5,7,29,27,2,29
Terek Grozny,4412,6,8,5,7,22,23,-1,29
FK Rubin,4412,7,5,7,8,23,19,4,22
Din Moscow,4412,8,5,7,8,18,23,-5,22
Rostov,4412,9,4,6,10,10,19,-9,18
Amkar,4412,10,4,4,12,9,25,-16,16
Anzhi,4412,11,3,5,12,16,41,-25,14
Loko Moscow,4413,1,11,5,4,30,14,16,38
CSKA Moscow,4413,2,11,3,6,26,18,8,36
Zenit,4413,3,9,8,3,23,13,10,35
Spart Moscow,4413,4,9,7,4,36,27,9,34
Krasnodar,4413,5,10,4,6,32,25,7,34
Terek Grozny,4413,6,8,5,7,22,24,-2,29
Din Moscow,4413,7,6,7,7,20,23,-3,25
FK Rubin,4413,8,5,5,10,21,21,0,20
Rostov,4413,9,4,7,9,10,17,-7,19
Amkar,4413,10,5,4,11,11,24,-13,19
Anzhi,4413,11,2,5,13,14,39,-25,11
Loko Moscow,4414,1,13,5,2,33,12,21,44
CSKA Moscow,4414,2,11,4,5,28,18,10,37
Spart Moscow,4414,3,10,5,5,42,28,14,35
Krasnodar,4414,4,9,4,7,29,26,3,31
Zenit,4414,5,7,9,4,22,16,6,30
Terek Grozny,4414,6,8,6,6,26,24,2,30
Din Moscow,4414,7,7,6,7,22,23,-1,27
FK Rubin,4414,8,5,5,10,22,21,1,20
Rostov,4414,9,4,6,10,10,22,-12,18
Amkar,4414,10,4,4,12,10,29,-19,16
Anzhi,4414,11,2,6,12,16,41,-25,12
Loko Moscow,4415,1,11,5,4,30,14,16,38
CSKA Moscow,4415,2,11,3,6,27,19,8,36
Krasnodar,4415,3,10,4,6,30,25,5,34
Spart Moscow,4415,4,9,6,5,38,29,9,33
Zenit,4415,5,8,8,4,23,15,8,32
Terek Grozny,4415,6,8,5,7,22,26,-4,29
Din Moscow,4415,7,7,6,7,21,23,-2,27
FK Rubin,4415,8,5,5,10,21,19,2,20
Amkar,4415,9,5,5,10,13,23,-10,20
Rostov,4415,10,4,6,10,10,19,-9,18
Anzhi,4415,11,3,5,12,16,39,-23,14
Loko Moscow,4416,1,11,5,4,29,14,15,38
Spart Moscow,4416,2,10,6,4,38,27,11,36
Zenit,4416,3,9,8,3,26,14,12,35
CSKA Moscow,4416,4,10,4,6,26,20,6,34
Krasnodar,4416,5,9,4,7,28,26,2,31
Terek Grozny,4416,6,7,7,6,23,25,-2,28
Din Moscow,4416,7,6,6,8,18,23,-5,24
FK Rubin,4416,8,6,5,9,23,18,5,23
Rostov,4416,9,4,7,9,10,17,-7,19
Amkar,4416,10,4,5,11,12,26,-14,17
Anzhi,4416,11,2,7,11,16,39,-23,13
Loko Moscow,4417,1,11,7,2,31,13,18,40
CSKA Moscow,4417,2,11,4,5,26,17,9,37
Zenit,4417,3,7,10,3,22,14,8,31
Spart Moscow,4417,4,8,7,5,34,27,7,31
Krasnodar,4417,5,8,6,6,29,26,3,30
Terek Grozny,4417,6,8,6,6,25,23,2,30
Din Moscow,4417,7,6,7,7,22,25,-3,25
FK Rubin,4417,8,5,6,9,25,22,3,21
Amkar,4417,9,5,5,10,11,23,-12,20
Rostov,4417,10,4,7,9,10,17,-7,19
Anzhi,4417,11,2,5,13,14,42,-28,11
Loko Moscow,4418,1,11,7,2,29,11,18,40
CSKA Moscow,4418,2,12,3,5,29,18,11,39
Spart Moscow,4418,3,10,6,4,38,26,12,36
Terek Grozny,4418,4,9,5,6,23,23,0,32
Zenit,4418,5,7,9,4,22,16,6,30
Krasnodar,4418,6,8,6,6,28,25,3,30
FK Rubin,4418,7,6,6,8,24,18,6,24
Din Moscow,4418,8,5,6,9,18,25,-7,21
Rostov,4418,9,4,6,10,10,20,-10,18
Amkar,4418,10,4,5,11,10,24,-14,17
Anzhi,4418,11,2,5,13,14,39,-25,11
Loko Moscow,4419,1,12,5,3,32,14,18,41
CSKA Moscow,4419,2,12,3,5,30,18,12,39
Spart Moscow,4419,3,11,5,4,38,26,12,38
Krasnodar,4419,4,10,4,6,32,25,7,34
Zenit,4419,5,7,8,5,22,16,6,29
Terek Grozny,4419,6,7,6,7,21,25,-4,27
FK Rubin,4419,7,6,5,9,24,20,4,23
Din Moscow,4419,8,5,6,9,17,25,-8,21
Rostov,4419,9,4,6,10,10,18,-8,18
Amkar,4419,10,4,5,11,11,26,-15,17
Anzhi,4419,11,3,5,12,17,41,-24,14
Loko Moscow,4420,1,11,6,3,30,14,16,39
CSKA Moscow,4420,2,12,3,5,27,17,10,39
Spart Moscow,4420,3,9,7,4,36,27,9,34
Krasnodar,4420,4,9,5,6,31,26,5,32
Zenit,4420,5,7,9,4,22,15,7,30
Terek Grozny,4420,6,7,6,7,21,25,-4,27
FK Rubin,4420,7,6,6,8,25,20,5,24
Din Moscow,4420,8,5,6,9,18,24,-6,21
Amkar,4420,9,5,5,10,12,23,-11,20
Rostov,4420,10,4,7,9,11,18,-7,19
Anzhi,4420,11,2,6,12,15,39,-24,12
Loko Moscow,4421,1,11,5,4,32,17,15,38
CSKA Moscow,4421,2,11,3,6,28,18,10,36
Zenit,4421,3,9,8,3,26,15,11,35
Krasnodar,4421,4,9,5,6,29,25,4,32
Spart Moscow,4421,5,8,7,5,35,28,7,31
Terek Grozny,4421,6,8,6,6,24,25,-1,30
FK Rubin,4421,7,6,6,8,25,18,7,24
Din Moscow,4421,8,5,7,8,18,25,-7,22
Rostov,4421,9,5,6,9,12,18,-6,21
Amkar,4421,10,4,5,11,12,26,-14,17
Anzhi,4421,11,2,6,12,15,41,-26,12
Loko Moscow,4422,1,12,6,2,33,13,20,42
Spart Moscow,4422,2,10,5,5,41,28,13,35
CSKA Moscow,4422,3,10,4,6,27,21,6,34
Krasnodar,4422,4,9,5,6,33,29,4,32
Zenit,4422,5,7,9,4,22,16,6,30
Terek Grozny,4422,6,8,6,6,23,24,-1,30
Din Moscow,4422,7,6,6,8,18,23,-5,24
FK Rubin,4422,8,5,5,10,24,22,2,20
Amkar,4422,9,5,5,10,12,23,-11,20
Rostov,4422,10,4,6,10,11,23,-12,18
Anzhi,4422,11,3,5,12,18,40,-22,14
Loko Moscow,4423,1,11,6,3,32,16,16,39
CSKA Moscow,4423,2,11,4,5,30,19,11,37
Zenit,4423,3,7,10,3,25,17,8,31
Spart Moscow,4423,4,8,7,5,36,29,7,31
Krasnodar,4423,5,9,4,7,30,26,4,31
Terek Grozny,4423,6,8,5,7,23,25,-2,29
FK Rubin,4423,7,7,5,8,24,18,6,26
Din Moscow,4423,8,5,7,8,18,23,-5,22
Rostov,4423,9,5,6,9,13,19,-6,21
Amkar,4423,10,5,5,10,11,23,-12,20
Anzhi,4423,11,2,5,13,16,43,-27,11
Loko Moscow,4424,1,11,5,4,30,16,14,38
CSKA Moscow,4424,2,11,4,5,30,18,12,37
Spart Moscow,4424,3,9,7,4,38,29,9,34
Krasnodar,4424,4,10,4,6,32,24,8,34
Zenit,4424,5,8,9,3,25,15,10,33
Terek Grozny,4424,6,7,7,6,24,26,-2,28
FK Rubin,4424,7,6,5,9,24,20,4,23
Din Moscow,4424,8,5,7,8,18,25,-7,22
Rostov,4424,9,4,7,9,11,18,-7,19
Amkar,4424,10,4,5,11,12,26,-14,17
Anzhi,4424,11,2,6,12,17,44,-27,12
Loko Moscow,4425,1,12,5,3,30,12,18,41
CSKA Moscow,4425,2,11,3,6,27,20,7,36
Spart Moscow,4425,3,10,5,5,36,27,9,35
Krasnodar,4425,4,10,4,6,32,24,8,34
Zenit,4425,5,8,8,4,24,14,10,32
Terek Grozny,4425,6,7,6,7,22,25,-3,27
FK Rubin,4425,7,6,5,9,24,21,3,23
Amkar,4425,8,6,4,10,13,23,-10,22
Din Moscow,4425,9,5,6,9,17,26,-9,21
Rostov,4425,10,4,6,10,10,18,-8,18
Anzhi,4425,11,2,6,12,15,40,-25,12
Loko Moscow,4426,1,12,6,2,32,13,19,42
Spart Moscow,4426,2,10,6,4,41,27,14,36
CSKA Moscow,4426,3,11,3,6,28,18,10,36
Zenit,4426,4,8,8,4,22,14,8,32
Krasnodar,4426,5,8,5,7,29,27,2,29
Terek Grozny,4426,6,8,5,7,24,25,-1,29
Din Moscow,4426,7,6,6,8,21,26,-5,24
FK Rubin,4426,8,6,5,9,22,20,2,23
Rostov,4426,9,4,6,10,10,19,-9,18
Amkar,4426,10,4,5,11,10,25,-15,17
Anzhi,4426,11,3,5,12,17,42,-25,14
Loko Moscow,4427,1,13,5,2,33,12,21,44
CSKA Moscow,4427,2,11,3,6,30,20,10,36
Spart Moscow,4427,3,9,5,6,40,28,12,32
Zenit,4427,4,8,8,4,23,16,7,32
Krasnodar,4427,5,9,4,7,29,26,3,31
Terek Grozny,4427,6,8,6,6,23,23,0,30
Din Moscow,4427,7,7,6,7,19,21,-2,27
FK Rubin,4427,8,5,5,10,21,19,2,20
Amkar,4427,9,5,5,10,11,23,-12,20
Rostov,4427,10,4,6,10,10,23,-13,18
Anzhi,4427,11,2,5,13,16,44,-28,11
Loko Moscow,4428,1,11,6,3,30,13,17,39
Spart Moscow,4428,2,9,7,4,35,26,9,34
CSKA Moscow,4428,3,10,4,6,27,20,7,34
Krasnodar,4428,4,9,5,6,29,25,4,32
Zenit,4428,5,7,10,3,23,15,8,31
Terek Grozny,4428,6,7,7,6,23,25,-2,28
Din Moscow,4428,7,5,8,7,18,22,-4,23
FK Rubin,4428,8,5,7,8,23,19,4,22
Rostov,4428,9,4,6,10,10,18,-8,18
Amkar,4428,10,4,6,10,12,25,-13,18
Anzhi,4428,11,3,6,11,17,39,-22,15
Loko Moscow,4429,1,11,6,3,30,13,17,39
CSKA Moscow,4429,2,12,3,5,30,18,12,39
Spart Moscow,4429,3,10,6,4,40,30,10,36
Zenit,4429,4,8,8,4,22,15,7,32
Krasnodar,4429,5,8,5,7,30,28,2,29
Terek Grozny,4429,6,7,6,7,21,24,-3,27
Din Moscow,4429,7,6,6,8,20,24,-4,24
FK Rubin,4429,8,6,5,9,25,21,4,23
Amkar,4429,9,5,5,10,13,25,-12,20
Rostov,4429,10,4,6,10,12,20,-8,18
Anzhi,4429,11,2,6,12,15,40,-25,12
Loko Moscow,4430,1,11,5,4,30,16,14,38
Spart Moscow,4430,2,10,6,4,36,25,11,36
CSKA Moscow,4430,3,10,5,5,28,20,8,35
Zenit,4430,4,8,9,3,22,13,9,33
Krasnodar,4430,5,9,5,6,34,28,6,32
Terek Grozny,4430,6,7,6,7,21,26,-5,27
Din Moscow,4430,7,6,6,8,18,23,-5,24
FK Rubin,4430,8,5,6,9,24,21,3,21
Rostov,4430,9,4,7,9,10,17,-7,19
Amkar,4430,10,5,4,11,12,23,-11,19
Anzhi,4430,11,2,7,11,18,41,-23,13
Loko Moscow,4431,1,11,6,3,31,14,17,39
CSKA Moscow,4431,2,11,4,5,27,18,9,37
Spart Moscow,4431,3,10,5,5,38,28,10,35
Krasnodar,4431,4,10,4,6,29,24,5,34
Zenit,4431,5,7,10,3,24,16,8,31
Terek Grozny,4431,6,8,6,6,25,25,0,30
FK Rubin,4431,7,6,5,9,22,18,4,23
Rostov,4431,8,5,6,9,12,18,-6,21
Din Moscow,4431,9,5,6,9,17,24,-7,21
Amkar,4431,10,4,5,11,12,26,-14,17
Anzhi,4431,11,2,5,13,15,41,-26,11
Loko Moscow,4432,1,11,6,3,30,15,15,39
CSKA Moscow,4432,2,12,3,5,28,17,11,39
Spart Moscow,4432,3,10,6,4,40,28,12,36
Krasnodar,4432,4,9,5,6,31,25,6,32
Zenit,4432,5,7,9,4,22,16,6,30
Terek Grozny,4432,6,7,5,8,21,25,-4,26
Din Moscow,4432,7,6,6,8,18,23,-5,24
FK Rubin,4432,8,5,6,9,22,19,3,21
Amkar,4432,9,5,5,10,11,23,-12,20
Rostov,4432,10,4,6,10,12,21,-9,18
Anzhi,4432,11,3,5,12,16,39,-23,14
Loko Moscow,4433,1,12,5,3,33,15,18,41
Spart Moscow,4433,2,10,5,5,37,26,11,35
Krasnodar,4433,3,10,4,6,34,27,7,34
CSKA Moscow,4433,4,10,3,7,28,22,6,33
Zenit,4433,5,8,8,4,24,17,7,32
Terek Grozny,4433,6,8,5,7,22,23,-1,29
FK Rubin,4433,7,6,5,9,23,20,3,23
Amkar,4433,8,6,4,10,11,22,-11,22
Din Moscow,4433,9,5,6,9,17,25,-8,21
Rostov,4433,10,4,6,10,10,18,-8,18
Anzhi,4433,11,3,5,12,16,40,-24,14
Loko Moscow,4434,1,12,6,2,32,12,20,42
CSKA Moscow,4434,2,11,4,5,26,17,9,37
Spart Moscow,4434,3,10,6,4,38,27,11,36
Krasnodar,4434,4,9,4,7,31,28,3,31
Zenit,4434,5,7,9,4,21,14,7,30
Terek Grozny,4434,6,8,6,6,23,23,0,30
FK Rubin,4434,7,6,5,9,23,20,3,23
Din Moscow,4434,8,5,6,9,18,25,-7,21
Rostov,4434,9,4,6,10,11,19,-8,18
Amkar,4434,10,4,5,11,10,25,-15,17
Anzhi,4434,11,2,7,11,14,37,-23,13
Loko Moscow,4435,1,12,5,3,31,13,18,41
CSKA Moscow,4435,2,11,3,6,27,21,6,36
Spart Moscow,4435,3,9,6,5,39,29,10,33
Zenit,4435,4,8,8,4,23,15,8,32
Krasnodar,4435,5,9,4,7,30,27,3,31
Terek Grozny,4435,6,8,5,7,21,23,-2,29
Din Moscow,4435,7,6,7,7,19,22,-3,25
FK Rubin,4435,8,5,6,9,22,19,3,21
Rostov,4435,9,4,6,10,11,21,-10,18
Amkar,4435,10,4,5,11,10,24,-14,17
Anzhi,4435,11,4,5,11,18,37,-19,17
Loko Moscow,4436,1,12,6,2,30,11,19,42
Spart Moscow,4436,2,10,6,4,42,31,11,36
CSKA Moscow,4436,3,11,3,6,28,22,6,36
Zenit,4436,4,8,9,3,26,14,12,33
Krasnodar,4436,5,8,5,7,27,25,2,29
Terek Grozny,4436,6,7,6,7,21,25,-4,27
FK Rubin,4436,7,5,7,8,22,18,4,22
Din Moscow,4436,8,5,7,8,20,26,-6,22
Rostov,4436,9,4,7,9,12,19,-7,19
Amkar,4436,10,5,4,11,13,25,-12,19
Anzhi,4436,11,2,6,12,15,40,-25,12
Loko Moscow,4437,1,11,7,2,33,15,18,40
CSKA Moscow,4437,2,12,3,5,31,18,13,39
Spart Moscow,4437,3,9,7,4,37,28,9,34
Zenit,4437,4,7,9,4,23,18,5,30
Krasnodar,4437,5,8,6,6,30,27,3,30
Terek Grozny,4437,6,7,6,7,21,24,-3,27
Din Moscow,4437,7,6,7,7,19,22,-3,25
FK Rubin,4437,8,5,6,9,22,19,3,21
Amkar,4437,9,5,5,10,12,24,-12,20
Rostov,4437,10,4,6,10,11,19,-8,18
Anzhi,4437,11,2,6,12,15,40,-25,12
Loko Moscow,4438,1,12,6,2,30,11,19,42
CSKA Moscow,4438,2,11,4,5,33,18,15,37
Spart Moscow,4438,3,10,6,4,38,26,12,36
Krasnodar,4438,4,9,5,6,28,24,4,32
Zenit,4438,5,7,9,4,22,15,7,30
Terek Grozny,4438,6,8,5,7,23,29,-6,29
Din Moscow,4438,7,6,6,8,19,22,-3,24
FK Rubin,4438,8,5,5,10,21,20,1,20
Rostov,4438,9,4,6,10,10,20,-10,18
Amkar,4438,10,4,5,11,11,26,-15,17
Anzhi,4438,11,3,5,12,20,44,-24,14
Loko Moscow,4439,1,12,5,3,30,13,17,41
Spart Moscow,4439,2,11,5,4,38,26,12,38
CSKA Moscow,4439,3,11,4,5,28,19,9,37
Krasnodar,4439,4,10,4,6,33,26,7,34
Zenit,4439,5,7,9,4,23,16,7,30
Terek Grozny,4439,6,8,5,7,21,23,-2,29
Din Moscow,4439,7,5,7,8,18,23,-5,22
FK Rubin,4439,8,5,6,9,23,21,2,21
Rostov,4439,9,4,6,10,10,19,-9,18
Amkar,4439,10,4,4,12,9,24,-15,16
Anzhi,4439,11,3,5,12,15,38,-23,14
Loko Moscow,4440,1,12,5,3,32,13,19,41
CSKA Moscow,4440,2,10,5,5,26,18,8,35
Zenit,4440,3,8,9,3,24,14,10,33
Spart Moscow,4440,4,8,6,6,34,30,4,30
Krasnodar,4440,5,8,5,7,28,28,0,29
Terek Grozny,4440,6,7,6,7,21,24,-3,27
FK Rubin,4440,7,6,6,8,24,18,6,24
Din Moscow,4440,8,6,6,8,19,23,-4,24
Rostov,4440,9,5,6,9,13,18,-5,21
Amkar,4440,10,5,5,10,10,22,-12,20
Anzhi,4440,11,2,7,11,15,38,-23,13
Loko Moscow,4441,1,12,5,3,31,13,18,41
CSKA Moscow,4441,2,11,3,6,28,19,9,36
Zenit,4441,3,9,8,3,23,13,10,35
Spart Moscow,4441,4,10,5,5,36,28,8,35
Krasnodar,4441,5,9,4,7,32,27,5,31
Terek Grozny,4441,6,8,6,6,23,24,-1,30
Din Moscow,4441,7,5,7,8,20,25,-5,22
FK Rubin,4441,8,5,6,9,24,23,1,21
Rostov,4441,9,5,6,9,12,17,-5,21
Amkar,4441,10,4,5,11,11,25,-14,17
Anzhi,4441,11,2,5,13,15,41,-26,11
Loko Moscow,4442,1,11,7,2,32,14,18,40
Spart Moscow,4442,2,11,5,4,43,25,18,38
CSKA Moscow,4442,3,11,4,5,28,18,10,37
Zenit,4442,4,7,10,3,23,15,8,31
Krasnodar,4442,5,8,6,6,31,28,3,30
Terek Grozny,4442,6,8,6,6,23,24,-1,30
FK Rubin,4442,7,6,6,8,24,19,5,24
Din Moscow,4442,8,5,6,9,17,26,-9,21
Rostov,4442,9,4,6,10,10,20,-10,18
Amkar,4442,10,4,4,12,10,27,-17,16
Anzhi,4442,11,2,6,12,15,40,-25,12
Loko Moscow,4443,1,12,5,3,32,14,18,41
CSKA Moscow,4443,2,11,4,5,29,20,9,37
Spart Moscow,4443,3,10,6,4,38,28,10,36
Zenit,4443,4,8,9,3,25,15,10,33
Krasnodar,4443,5,9,4,7,30,27,3,31
Terek Grozny,4443,6,7,6,7,21,24,-3,27
Din Moscow,4443,7,5,8,7,19,23,-4,23
FK Rubin,4443,8,5,6,9,22,20,2,21
Rostov,4443,9,4,6,10,11,19,-8,18
Amkar,4443,10,4,5,11,11,25,-14,17
Anzhi,4443,11,3,5,12,16,39,-23,14
Loko Moscow,4444,1,12,6,2,31,12,19,42
CSKA Moscow,4444,2,11,4,5,26,17,9,37
Spart Moscow,4444,3,9,6,5,38,29,9,33
Krasnodar,4444,4,9,4,7,30,27,3,31
Zenit,4444,5,7,9,4,21,14,7,30
Terek Grozny,4444,6,8,5,7,24,26,-2,29
Din Moscow,4444,7,7,6,7,21,23,-2,27
FK Rubin,4444,8,5,5,10,23,21,2,20
Rostov,4444,9,4,6,10,11,20,-9,18
Amkar,4444,10,4,5,11,11,25,-14,17
Anzhi,4444,11,3,6,11,17,39,-22,15
Loko Moscow,4445,1,12,6,2,33,14,19,42
CSKA Moscow,4445,2,12,3,5,28,17,11,39
Spart Moscow,4445,3,10,6,4,38,27,11,36
Zenit,4445,4,7,8,5,22,16,6,29
Krasnodar,4445,5,8,5,7,30,30,0,29
Terek Grozny,4445,6,7,7,6,22,24,-2,28
FK Rubin,4445,7,7,5,8,26,18,8,26
Din Moscow,4445,8,5,6,9,17,24,-7,21
Rostov,4445,9,4,6,10,12,20,-8,18
Amkar,4445,10,4,6,10,9,22,-13,18
Anzhi,4445,11,2,6,12,16,41,-25,12
Loko Moscow,4446,1,12,5,3,33,13,20,41
CSKA Moscow,4446,2,12,3,5,29,18,11,39
Spart Moscow,4446,3,10,6,4,38,27,11,36
Zenit,4446,4,8,8,4,24,15,9,32
Krasnodar,4446,5,9,4,7,28,28,0,31
Terek Grozny,4446,6,8,6,6,23,24,-1,30
FK Rubin,4446,7,6,5,9,23,19,4,23
Din Moscow,4446,8,5,6,9,19,26,-7,21
Rostov,4446,9,4,7,9,10,17,-7,19
Amkar,4446,10,4,5,11,11,25,-14,17
Anzhi,4446,11,2,5,13,15,41,-26,11
Loko Moscow,4447,1,11,6,3,31,14,17,39
CSKA Moscow,4447,2,11,3,6,26,18,8,36
Zenit,4447,3,9,8,3,23,13,10,35
Spart Moscow,4447,4,9,5,6,37,33,4,32
Krasnodar,4447,5,8,6,6,29,26,3,30
Terek Grozny,4447,6,7,6,7,20,25,-5,27
FK Rubin,4447,7,6,6,8,23,18,5,24
Din Moscow,4447,8,6,6,8,21,23,-2,24
Amkar,4447,9,6,4,10,15,23,-8,22
Rostov,4447,10,4,6,10,12,20,-8,18
Anzhi,4447,11,2,6,12,14,38,-24,12
Loko Moscow,4448,1,11,6,3,30,13,17,39
Spart Moscow,4448,2,10,6,4,37,27,10,36
CSKA Moscow,4448,3,11,3,6,27,20,7,36
Zenit,4448,4,8,9,3,24,13,11,33
Krasnodar,4448,5,9,5,6,30,26,4,32
Terek Grozny,4448,6,8,5,7,22,25,-3,29
Din Moscow,4448,7,6,7,7,21,23,-2,25
FK Rubin,4448,8,5,6,9,22,20,2,21
Rostov,4448,9,4,6,10,10,18,-8,18
Amkar,4448,10,4,4,12,10,25,-15,16
Anzhi,4448,11,3,5,12,16,39,-23,14
Loko Moscow,4449,1,11,5,4,29,13,16,38
Zenit,4449,2,9,8,3,25,13,12,35
Krasnodar,4449,3,10,4,6,29,24,5,34
CSKA Moscow,4449,4,10,4,6,26,21,5,34
Spart Moscow,4449,5,9,5,6,36,27,9,32
Terek Grozny,4449,6,8,6,6,22,22,0,30
Din Moscow,4449,7,6,6,8,18,24,-6,24
Rostov,4449,8,5,6,9,11,17,-6,21
FK Rubin,4449,9,5,5,10,21,19,2,20
Amkar,4449,10,5,5,10,10,22,-12,20
Anzhi,4449,11,2,6,12,15,40,-25,12
Loko Moscow,4450,1,11,7,2,32,14,18,40
CSKA Moscow,4450,2,11,4,5,29,18,11,37
Spart Moscow,4450,3,9,5,6,35,28,7,32
Krasnodar,4450,4,9,5,6,31,27,4,32
Terek Grozny,4450,5,9,5,6,24,24,0,32
Zenit,4450,6,7,10,3,24,16,8,31
Din Moscow,4450,7,6,7,7,20,22,-2,25
FK Rubin,4450,8,5,6,9,24,21,3,21
Amkar,4450,9,5,4,11,10,23,-13,19
Rostov,4450,10,4,6,10,10,19,-9,18
Anzhi,4450,11,2,5,13,16,43,-27,11
Loko Moscow,4451,1,12,6,2,31,11,20,42
CSKA Moscow,4451,2,11,3,6,28,20,8,36
Zenit,4451,3,8,9,3,24,14,10,33
Spart Moscow,4451,4,9,6,5,35,28,7,33
Krasnodar,4451,5,8,5,7,27,26,1,29
Terek Grozny,4451,6,7,6,7,21,24,-3,27
FK Rubin,4451,7,6,6,8,24,18,6,24
Din Moscow,4451,8,6,6,8,20,24,-4,24
Amkar,4451,9,5,5,10,10,22,-12,20
Rostov,4451,10,4,6,10,11,19,-8,18
Anzhi,4451,11,2,6,12,15,40,-25,12
Loko Moscow,4452,1,13,5,2,33,11,22,44
CSKA Moscow,4452,2,10,4,6,27,20,7,34
Krasnodar,4452,3,9,4,7,28,25,3,31
Spart Moscow,4452,4,8,6,6,36,31,5,30
Zenit,4452,5,7,9,4,22,17,5,30
Terek Grozny,4452,6,8,5,7,22,24,-2,29
Din Moscow,4452,7,7,6,7,24,22,2,27
Rostov,4452,8,5,6,9,12,18,-6,21
FK Rubin,4452,9,5,5,10,21,22,-1,20
Amkar,4452,10,4,5,11,11,25,-14,17
Anzhi,4452,11,4,5,11,17,38,-21,17
Loko Moscow,4453,1,12,6,2,31,12,19,42
Spart Moscow,4453,2,10,6,4,40,27,13,36
CSKA Moscow,4453,3,11,3,6,26,18,8,36
Zenit,4453,4,8,9,3,23,14,9,33
Terek Grozny,4453,5,8,6,6,26,27,-1,30
Krasnodar,4453,6,8,4,8,27,27,0,28
FK Rubin,4453,7,7,5,8,24,17,7,26
Din Moscow,4453,8,5,6,9,17,26,-9,21
Rostov,4453,9,4,7,9,10,17,-7,19
Amkar,4453,10,4,5,11,13,27,-14,17
Anzhi,4453,11,2,5,13,17,42,-25,11
Loko Moscow,4454,1,11,6,3,32,15,17,39
CSKA Moscow,4454,2,11,4,5,28,17,11,37
Zenit,4454,3,8,9,3,23,14,9,33
Krasnodar,4454,4,9,5,6,31,26,5,32
Spart Moscow,4454,5,8,6,6,36,31,5,30
Terek Grozny,4454,6,8,6,6,23,23,0,30
Din Moscow,4454,7,6,6,8,19,24,-5,24
FK Rubin,4454,8,6,5,9,23,19,4,23
Rostov,4454,9,5,6,9,13,18,-5,21
Amkar,4454,10,4,5,11,10,25,-15,17
Anzhi,4454,11,2,6,12,15,41,-26,12
Loko Moscow,4455,1,11,6,3,31,14,17,39
CSKA Moscow,4455,2,12,3,5,32,18,14,39
Krasnodar,4455,3,9,5,6,30,26,4,32
Terek Grozny,4455,4,9,5,6,24,23,1,32
Spart Moscow,4455,5,8,6,6,33,27,6,30
Zenit,4455,6,7,9,4,22,17,5,30
FK Rubin,4455,7,6,6,8,23,18,5,24
Din Moscow,4455,8,6,6,8,18,22,-4,24
Rostov,4455,9,4,7,9,10,17,-7,19
Amkar,4455,10,5,4,11,10,23,-13,19
Anzhi,4455,11,2,5,13,16,44,-28,11
Loko Moscow,4456,1,12,5,3,32,13,19,41
CSKA Moscow,4456,2,10,5,5,28,20,8,35
Spart Moscow,4456,3,9,7,4,38,27,11,34
Zenit,4456,4,8,9,3,24,15,9,33
Terek Grozny,4456,5,8,5,7,22,24,-2,29
Krasnodar,4456,6,8,4,8,28,28,0,28
Din Moscow,4456,7,6,7,7,22,25,-3,25
FK Rubin,4456,8,6,5,9,24,20,4,23
Amkar,4456,9,5,5,10,11,22,-11,20
Rostov,4456,10,4,6,10,10,20,-10,18
Anzhi,4456,11,2,6,12,15,40,-25,12
Loko Moscow,4457,1,12,5,3,31,13,18,41
CSKA Moscow,4457,2,12,3,5,30,19,11,39
Zenit,4457,3,8,8,4,23,16,7,32
Spart Moscow,4457,4,8,7,5,37,31,6,31
Krasnodar,4457,5,9,4,7,31,25,6,31
Terek Grozny,4457,6,8,5,7,25,24,1,29
FK Rubin,4457,7,6,5,9,22,21,1,23
Din Moscow,4457,8,5,7,8,17,22,-5,22
Amkar,4457,9,6,4,10,14,24,-10,22
Rostov,4457,10,4,7,9,13,20,-7,19
Anzhi,4457,11,2,5,13,16,44,-28,11
Loko Moscow,4458,1,11,5,4,29,13,16,38
CSKA Moscow,4458,2,11,4,5,27,18,9,37
Krasnodar,4458,3,10,4,6,36,25,11,34
Spart Moscow,4458,4,9,5,6,36,28,8,32
Zenit,4458,5,8,8,4,23,15,8,32
Terek Grozny,4458,6,7,6,7,21,25,-4,27
Din Moscow,4458,7,5,7,8,19,25,-6,22
Amkar,4458,8,6,4,10,12,22,-10,22
FK Rubin,4458,9,5,6,9,23,26,-3,21
Rostov,4458,10,5,6,9,11,17,-6,21
Anzhi,4458,11,2,7,11,15,38,-23,13
Loko Moscow,4459,1,12,6,2,35,15,20,42
CSKA Moscow,4459,2,11,4,5,27,17,10,37
Spart Moscow,4459,3,10,5,5,37,30,7,35
Terek Grozny,4459,4,9,5,6,25,24,1,32
Zenit,4459,5,7,8,5,23,19,4,29
Krasnodar,4459,6,8,5,7,29,27,2,29
Din Moscow,4459,7,6,6,8,21,23,-2,24
FK Rubin,4459,8,6,5,9,22,20,2,23
Amkar,4459,9,5,4,11,13,25,-12,19
Rostov,4459,10,4,6,10,11,19,-8,18
Anzhi,4459,11,2,6,12,15,39,-24,12
Loko Moscow,4460,1,12,6,2,30,11,19,42
CSKA Moscow,4460,2,11,3,6,26,18,8,36
Spart Moscow,4460,3,10,5,5,40,29,11,35
Zenit,4460,4,8,9,3,22,13,9,33
Krasnodar,4460,5,8,4,8,27,26,1,28
Terek Grozny,4460,6,7,6,7,22,26,-4,27
FK Rubin,4460,7,6,6,8,22,17,5,24
Din Moscow,4460,8,5,7,8,18,24,-6,22
Amkar,4460,9,6,4,10,13,23,-10,22
Rostov,4460,10,4,6,10,11,20,-9,18
Anzhi,4460,11,2,6,12,16,40,-24,12
Loko Moscow,4461,1,12,6,2,33,12,21,42
CSKA Moscow,4461,2,11,3,6,27,20,7,36
Spart Moscow,4461,3,9,5,6,39,30,9,32
Zenit,4461,4,8,8,4,23,16,7,32
Terek Grozny,4461,5,9,5,6,24,24,0,32
Krasnodar,4461,6,8,6,6,29,26,3,30
FK Rubin,4461,7,6,6,8,23,18,5,24
Din Moscow,4461,8,6,6,8,19,23,-4,24
Amkar,4461,9,5,4,11,13,25,-12,19
Rostov,4461,10,4,6,10,10,21,-11,18
Anzhi,4461,11,2,5,13,16,41,-25,11
Loko Moscow,4462,1,12,5,3,32,13,19,41
CSKA Moscow,4462,2,12,3,5,28,17,11,39
Spart Moscow,4462,3,10,6,4,38,26,12,36
Krasnodar,4462,4,9,4,7,30,29,1,31
Zenit,4462,5,7,8,5,21,16,5,29
Terek Grozny,4462,6,8,5,7,22,24,-2,29
FK Rubin,4462,7,7,5,8,27,19,8,26
Din Moscow,4462,8,5,6,9,18,24,-6,21
Rostov,4462,9,4,6,10,11,21,-10,18
Amkar,4462,10,4,5,11,9,24,-15,17
Anzhi,4462,11,3,5,12,16,39,-23,14
Loko Moscow,4463,1,12,6,2,33,14,19,42
CSKA Moscow,4463,2,11,3,6,31,19,12,36
Spart Moscow,4463,3,9,7,4,38,29,9,34
Zenit,4463,4,8,9,3,23,14,9,33
Krasnodar,4463,5,8,5,7,30,28,2,29
Terek Grozny,4463,6,7,6,7,21,25,-4,27
FK Rubin,4463,7,6,6,8,24,18,6,24
Din Moscow,4463,8,5,6,9,19,26,-7,21
Amkar,4463,9,5,5,10,11,22,-11,20
Rostov,4463,10,4,7,9,12,19,-7,19
Anzhi,4463,11,2,6,12,16,44,-28,12
Loko Moscow,4464,1,12,6,2,32,12,20,42
CSKA Moscow,4464,2,11,4,5,26,17,9,37
Spart Moscow,4464,3,10,5,5,39,29,10,35
Krasnodar,4464,4,9,5,6,31,25,6,32
Terek Grozny,4464,5,9,5,6,23,23,0,32
Zenit,4464,6,7,9,4,21,15,6,30
Din Moscow,4464,7,6,6,8,21,25,-4,24
FK Rubin,4464,8,6,5,9,23,20,3,23
Rostov,4464,9,4,6,10,10,20,-10,18
Amkar,4464,10,4,4,12,10,25,-15,16
Anzhi,4464,11,2,5,13,14,39,-25,11
Loko Moscow,4465,1,13,5,2,31,11,20,44
CSKA Moscow,4465,2,11,3,6,28,18,10,36
Zenit,4465,3,8,8,4,22,14,8,32
Spart Moscow,4465,4,9,5,6,38,32,6,32
Krasnodar,4465,5,8,5,7,28,26,2,29
Terek Grozny,4465,6,8,5,7,22,25,-3,29
FK Rubin,4465,7,6,6,8,24,19,5,24
Rostov,4465,8,5,6,9,15,20,-5,21
Din Moscow,4465,9,5,6,9,18,24,-6,21
Amkar,4465,10,5,4,11,12,25,-13,19
Anzhi,4465,11,3,5,12,16,40,-24,14
Loko Moscow,4466,1,12,6,2,31,12,19,42
CSKA Moscow,4466,2,12,3,5,28,17,11,39
Spart Moscow,4466,3,9,6,5,38,28,10,33
Krasnodar,4466,4,8,6,6,28,25,3,30
Zenit,4466,5,7,8,5,21,15,6,29
Din Moscow,4466,6,7,6,7,20,22,-2,27
Terek Grozny,4466,7,7,6,7,20,23,-3,27
FK Rubin,4466,8,5,6,9,21,18,3,21
Amkar,4466,9,5,5,10,11,23,-12,20
Rostov,4466,10,4,6,10,10,20,-10,18
Anzhi,4466,11,2,6,12,14,39,-25,12
Loko Moscow,4467,1,11,6,3,32,15,17,39
Spart Moscow,4467,2,10,5,5,36,27,9,35
CSKA Moscow,4467,3,10,5,5,28,20,8,35
Zenit,4467,4,8,9,3,25,16,9,33
Krasnodar,4467,5,8,5,7,29,27,2,29
Terek Grozny,4467,6,8,5,7,23,25,-2,29
Din Moscow,4467,7,6,6,8,19,24,-5,24
FK Rubin,4467,8,6,5,9,23,19,4,23
Amkar,4467,9,6,4,10,13,23,-10,22
Rostov,4467,10,4,6,10,10,18,-8,18
Anzhi,4467,11,2,6,12,16,40,-24,12
Loko Moscow,4468,1,11,7,2,29,11,18,40
CSKA Moscow,4468,2,11,3,6,26,19,7,36
Zenit,4468,3,8,9,3,23,13,10,33
Spart Moscow,4468,4,9,6,5,36,30,6,33
Krasnodar,4468,5,9,5,6,29,24,5,32
Terek Grozny,4468,6,7,7,6,22,24,-2,28
Din Moscow,4468,7,7,6,7,26,21,5,27
FK Rubin,4468,8,5,5,10,21,25,-4,20
Rostov,4468,9,4,7,9,11,18,-7,19
Amkar,4468,10,4,5,11,11,25,-14,17
Anzhi,4468,11,2,6,12,15,39,-24,12
Loko Moscow,4469,1,12,5,3,31,15,16,41
CSKA Moscow,4469,2,11,4,5,29,18,11,37
Spart Moscow,4469,3,10,6,4,37,26,11,36
Krasnodar,4469,4,10,4,6,31,24,7,34
Zenit,4469,5,7,9,4,22,15,7,30
Terek Grozny,4469,6,8,5,7,24,25,-1,29
FK Rubin,4469,7,6,5,9,23,18,5,23
Din Moscow,4469,8,5,7,8,18,24,-6,22
Amkar,4469,9,5,4,11,11,24,-13,19
Rostov,4469,10,4,6,10,10,18,-8,18
Anzhi,4469,11,2,5,13,16,45,-29,11
Loko Moscow,4470,1,11,6,3,31,14,17,39
CSKA Moscow,4470,2,11,4,5,27,18,9,37
Spart Moscow,4470,3,9,6,5,37,27,10,33
Zenit,4470,4,8,8,4,22,14,8,32
Terek Grozny,4470,5,8,6,6,23,23,0,30
Krasnodar,4470,6,8,5,7,30,29,1,29
Din Moscow,4470,7,6,7,7,21,23,-2,25
FK Rubin,4470,8,6,5,9,25,21,4,23
Amkar,4470,9,5,5,10,10,22,-12,20
Rostov,4470,10,4,6,10,10,20,-10,18
Anzhi,4470,11,2,6,12,16,41,-25,12
Loko Moscow,4471,1,13,5,2,33,11,22,44
CSKA Moscow,4471,2,12,3,5,29,18,11,39
Spart Moscow,4471,3,9,6,5,37,30,7,33
Krasnodar,4471,4,9,4,7,30,25,5,31
Zenit,4471,5,7,8,5,21,17,4,29
Terek Grozny,4471,6,7,7,6,22,24,-2,28
Din Moscow,4471,7,5,7,8,19,24,-5,22
FK Rubin,4471,8,5,6,9,22,21,1,21
Amkar,4471,9,5,5,10,12,23,-11,20
Rostov,4471,10,4,7,9,12,19,-7,19
Anzhi,4471,11,2,6,12,16,41,-25,12
Loko Moscow,4472,1,12,5,3,31,13,18,41
Spart Moscow,4472,2,10,6,4,40,30,10,36
CSKA Moscow,4472,3,10,4,6,27,21,6,34
Zenit,4472,4,8,8,4,23,15,8,32
Krasnodar,4472,5,9,5,6,30,25,5,32
Terek Grozny,4472,6,8,5,7,22,24,-2,29
Din Moscow,4472,7,6,6,8,22,26,-4,24
FK Rubin,4472,8,5,6,9,24,21,3,21
Rostov,4472,9,4,7,9,12,19,-7,19
Amkar,4472,10,5,4,11,12,25,-13,19
Anzhi,4472,11,2,6,12,16,40,-24,12
Loko Moscow,4473,1,12,5,3,30,12,18,41
CSKA Moscow,4473,2,11,4,5,29,19,10,37
Zenit,4473,3,8,9,3,23,14,9,33
Spart Moscow,4473,4,8,7,5,34,27,7,31
Terek Grozny,4473,5,8,6,6,22,23,-1,30
Krasnodar,4473,6,8,4,8,28,28,0,28
FK Rubin,4473,7,6,6,8,24,18,6,24
Din Moscow,4473,8,5,8,7,18,22,-4,23
Rostov,4473,9,5,6,9,11,17,-6,21
Amkar,4473,10,4,6,10,9,22,-13,18
Anzhi,4473,11,2,5,13,16,42,-26,11
Loko Moscow,4474,1,12,6,2,35,15,20,42
CSKA Moscow,4474,2,11,3,6,26,20,6,36
Spart Moscow,4474,3,10,5,5,39,29,10,35
Zenit,4474,4,7,9,4,22,15,7,30
Krasnodar,4474,5,8,5,7,30,29,1,29
Terek Grozny,4474,6,7,6,7,21,25,-4,27
Din Moscow,4474,7,6,7,7,20,22,-2,25
FK Rubin,4474,8,5,7,8,21,17,4,22
Rostov,4474,9,4,6,10,11,20,-9,18
Amkar,4474,10,4,5,11,10,25,-15,17
Anzhi,4474,11,4,5,11,19,37,-18,17
Loko Moscow,4475,1,11,5,4,30,15,15,38
Spart Moscow,4475,2,11,5,4,41,27,14,38
Zenit,4475,3,9,8,3,25,14,11,35
Krasnodar,4475,4,10,4,6,32,25,7,34
CSKA Moscow,4475,5,10,3,7,27,22,5,33
Terek Grozny,4475,6,7,5,8,20,24,-4,26
FK Rubin,4475,7,6,5,9,23,20,3,23
Din Moscow,4475,8,5,6,9,18,24,-6,21
Amkar,4475,9,5,4,11,11,25,-14,19
Rostov,4475,10,4,6,10,10,20,-10,18
Anzhi,4475,11,4,5,11,18,39,-21,17
Loko Moscow,4476,1,12,5,3,33,18,15,41
CSKA Moscow,4476,2,11,3,6,27,19,8,36
Zenit,4476,3,9,8,3,26,13,13,35
Spart Moscow,4476,4,9,6,5,35,28,7,33
Krasnodar,4476,5,8,5,7,31,29,2,29
Terek Grozny,4476,6,7,6,7,22,25,-3,27
Din Moscow,4476,7,5,8,7,18,22,-4,23
FK Rubin,4476,8,5,7,8,23,19,4,22
Rostov,4476,9,5,6,9,12,17,-5,21
Amkar,4476,10,5,4,11,12,25,-13,19
Anzhi,4476,11,2,6,12,16,40,-24,12
Loko Moscow,4477,1,12,5,3,31,13,18,41
Krasnodar,4477,2,10,4,6,33,26,7,34
CSKA Moscow,4477,3,10,3,7,26,21,5,33
Zenit,4477,4,8,8,4,23,15,8,32
Spart Moscow,4477,5,8,6,6,34,29,5,30
Terek Grozny,4477,6,8,5,7,22,24,-2,29
Din Moscow,4477,7,5,8,7,18,22,-4,23
FK Rubin,4477,8,5,6,9,23,21,2,21
Rostov,4477,9,5,6,9,11,17,-6,21
Amkar,4477,10,5,4,11,11,23,-12,19
Anzhi,4477,11,4,5,11,18,39,-21,17
Loko Moscow,4478,1,12,6,2,32,13,19,42
CSKA Moscow,4478,2,11,4,5,27,18,9,37
Spart Moscow,4478,3,9,7,4,39,29,10,34
Krasnodar,4478,4,9,5,6,31,25,6,32
Terek Grozny,4478,5,9,5,6,23,23,0,32
Zenit,4478,6,7,9,4,23,16,7,30
Din Moscow,4478,7,5,7,8,19,25,-6,22
FK Rubin,4478,8,5,6,9,23,22,1,21
Rostov,4478,9,4,7,9,13,20,-7,19
Amkar,4478,10,4,5,11,11,25,-14,17
Anzhi,4478,11,2,5,13,14,39,-25,11
Loko Moscow,4479,1,12,5,3,33,13,20,41
Spart Moscow,4479,2,9,6,5,37,29,8,33
CSKA Moscow,4479,3,10,3,7,25,20,5,33
Zenit,4479,4,8,8,4,23,16,7,32
Krasnodar,4479,5,9,4,7,29,26,3,31
Terek Grozny,4479,6,8,5,7,21,23,-2,29
FK Rubin,4479,7,7,5,8,23,17,6,26
Din Moscow,4479,8,6,6,8,18,22,-4,24
Rostov,4479,9,4,6,10,11,19,-8,18
Amkar,4479,10,4,5,11,11,25,-14,17
Anzhi,4479,11,4,5,11,16,37,-21,17
Loko Moscow,4480,1,11,7,2,31,13,18,40
CSKA Moscow,4480,2,11,4,5,27,18,9,37
Spart Moscow,4480,3,9,7,4,36,27,9,34
Krasnodar,4480,4,9,5,6,31,27,4,32
Zenit,4480,5,7,10,3,23,15,8,31
Terek Grozny,4480,6,7,7,6,22,24,-2,28
Din Moscow,4480,7,6,7,7,20,22,-2,25
FK Rubin,4480,8,5,5,10,23,22,1,20
Rostov,4480,9,4,6,10,11,19,-8,18
Amkar,4480,10,4,6,10,9,22,-13,18
Anzhi,4480,11,2,6,12,16,40,-24,12
Loko Moscow,4481,1,12,6,2,32,13,19,42
CSKA Moscow,4481,2,11,3,6,30,19,11,36
Spart Moscow,4481,3,9,6,5,36,27,9,33
Zenit,4481,4,8,9,3,24,15,9,33
Terek Grozny,4481,5,8,6,6,23,24,-1,30
Krasnodar,4481,6,8,5,7,28,26,2,29
FK Rubin,4481,7,6,6,8,22,17,5,24
Din Moscow,4481,8,5,7,8,17,22,-5,22
Rostov,4481,9,5,6,9,11,17,-6,21
Amkar,4481,10,4,4,12,11,27,-16,16
Anzhi,4481,11,2,6,12,15,42,-27,12
Loko Moscow,4482,1,12,6,2,30,11,19,42
CSKA Moscow,4482,2,11,3,6,32,20,12,36
Spart Moscow,4482,3,10,6,4,38,27,11,36
Zenit,4482,4,8,8,4,23,15,8,32
Krasnodar,4482,5,9,5,6,28,24,4,32
Terek Grozny,4482,6,9,5,6,25,25,0,32
Din Moscow,4482,7,6,6,8,20,23,-3,24
FK Rubin,4482,8,5,5,10,21,20,1,20
Rostov,4482,9,4,7,9,11,18,-7,19
Amkar,4482,10,4,4,12,9,25,-16,16
Anzhi,4482,11,2,5,13,18,47,-29,11
Loko Moscow,4483,1,13,5,2,33,13,20,44
CSKA Moscow,4483,2,11,3,6,27,18,9,36
Spart Moscow,4483,3,9,6,5,35,29,6,33
Zenit,4483,4,8,8,4,23,15,8,32
Terek Grozny,4483,5,9,5,6,22,22,0,32
Krasnodar,4483,6,8,4,8,28,28,0,28
FK Rubin,4483,7,7,5,8,25,17,8,26
Din Moscow,4483,8,6,6,8,20,23,-3,24
Rostov,4483,9,4,6,10,10,18,-8,18
Amkar,4483,10,4,5,11,10,24,-14,17
Anzhi,4483,11,2,5,13,14,40,-26,11
Loko Moscow,4484,1,13,5,2,33,12,21,44
CSKA Moscow,4484,2,11,4,5,28,19,9,37
Spart Moscow,4484,3,10,5,5,37,28,9,35
Krasnodar,4484,4,9,4,7,29,26,3,31
Zenit,4484,5,7,9,4,23,16,7,30
Terek Grozny,4484,6,8,6,6,24,25,-1,30
Din Moscow,4484,7,5,7,8,19,24,-5,22
FK Rubin,4484,8,5,6,9,22,20,2,21
Rostov,4484,9,5,6,9,11,17,-6,21
Amkar,4484,10,4,4,12,11,26,-15,16
Anzhi,4484,11,2,6,12,17,41,-24,12
Loko Moscow,4485,1,12,6,2,32,13,19,42
CSKA Moscow,4485,2,11,3,6,28,19,9,36
Spart Moscow,4485,3,9,6,5,38,29,9,33
Zenit,4485,4,8,9,3,23,14,9,33
Krasnodar,4485,5,8,5,7,29,27,2,29
Terek Grozny,4485,6,8,5,7,22,25,-3,29
Din Moscow,4485,7,6,7,7,19,21,-2,25
FK Rubin,4485,8,5,7,8,22,18,4,22
Rostov,4485,9,4,7,9,11,18,-7,19
Amkar,4485,10,5,4,11,13,26,-13,19
Anzhi,4485,11,2,5,13,15,42,-27,11
Loko Moscow,4486,1,12,6,2,31,12,19,42
Spart Moscow,4486,2,10,6,4,38,26,12,36
CSKA Moscow,4486,3,11,3,6,27,20,7,36
Zenit,4486,4,8,9,3,24,14,10,33
Krasnodar,4486,5,9,4,7,28,25,3,31
Terek Grozny,4486,6,8,5,7,21,23,-2,29
FK Rubin,4486,7,6,5,9,23,18,5,23
Din Moscow,4486,8,5,7,8,18,24,-6,22
Amkar,4486,9,5,4,11,10,25,-15,19
Rostov,4486,10,4,6,10,10,18,-8,18
Anzhi,4486,11,2,5,13,15,40,-25,11
Loko Moscow,4487,1,13,5,2,33,13,20,44
Spart Moscow,4487,2,9,7,4,38,29,9,34
CSKA Moscow,4487,3,10,4,6,26,20,6,34
Krasnodar,4487,4,9,4,7,34,28,6,31
Zenit,4487,5,7,9,4,23,16,7,30
Terek Grozny,4487,6,8,5,7,21,26,-5,29
FK Rubin,4487,7,6,5,9,24,23,1,23
Din Moscow,4487,8,5,7,8,17,22,-5,22
Rostov,4487,9,4,6,10,12,20,-8,18
Amkar,4487,10,4,5,11,11,25,-14,17
Anzhi,4487,11,4,5,11,20,37,-17,17
Loko Moscow,4488,1,11,6,3,30,16,14,39
CSKA Moscow,4488,2,12,3,5,30,18,12,39
Spart Moscow,4488,3,10,6,4,41,30,11,36
Krasnodar,4488,4,9,5,6,32,25,7,32
Zenit,4488,5,7,9,4,23,16,7,30
Terek Grozny,4488,6,8,6,6,22,22,0,30
Din Moscow,4488,7,6,6,8,21,26,-5,24
FK Rubin,4488,8,5,6,9,23,20,3,21
Rostov,4488,9,4,6,10,12,20,-8,18
Amkar,4488,10,4,6,10,10,23,-13,18
Anzhi,4488,11,2,5,13,14,42,-28,11
Loko Moscow,4489,1,11,6,3,33,18,15,39
CSKA Moscow,4489,2,11,3,6,28,21,7,36
Zenit,4489,3,8,8,4,26,17,9,32
Spart Moscow,4489,4,9,5,6,34,29,5,32
Krasnodar,4489,5,9,5,6,33,28,5,32
Terek Grozny,4489,6,7,5,8,22,27,-5,26
Din Moscow,4489,7,6,6,8,19,23,-4,24
FK Rubin,4489,8,6,5,9,24,20,4,23
Amkar,4489,9,6,4,10,14,23,-9,22
Rostov,4489,10,4,6,10,10,18,-8,18
Anzhi,4489,11,4,5,11,19,38,-19,17
CSKA Moscow,4490,1,12,3,5,31,17,14,39
Loko Moscow,4490,2,11,5,4,29,14,15,38
Spart Moscow,4490,3,9,7,4,36,27,9,34
Krasnodar,4490,4,10,4,6,31,25,6,34
Zenit,4490,5,8,8,4,22,17,5,32
Terek Grozny,4490,6,7,6,7,21,24,-3,27
Din Moscow,4490,7,5,8,7,20,24,-4,23
FK Rubin,4490,8,5,6,9,24,21,3,21
Rostov,4490,9,4,7,9,11,18,-7,19
Amkar,4490,10,4,5,11,9,23,-14,17
Anzhi,4490,11,3,5,12,16,40,-24,14
Loko Moscow,4491,1,12,6,2,30,11,19,42
CSKA Moscow,4491,2,11,3,6,28,19,9,36
Spart Moscow,4491,3,10,5,5,36,26,10,35
Zenit,4491,4,8,9,3,23,14,9,33
Krasnodar,4491,5,9,4,7,30,25,5,31
Terek Grozny,4491,6,8,6,6,21,22,-1,30
Din Moscow,4491,7,6,6,8,19,23,-4,24
FK Rubin,4491,8,5,5,10,22,22,0,20
Amkar,4491,9,5,4,11,10,23,-13,19
Rostov,4491,10,4,6,10,10,19,-9,18
Anzhi,4491,11,2,6,12,14,39,-25,12
Loko Moscow,4492,1,12,5,3,30,12,18,41
CSKA Moscow,4492,2,12,3,5,30,18,12,39
Spart Moscow,4492,3,10,6,4,37,27,10,36
Krasnodar,4492,4,9,5,6,29,25,4,32
Terek Grozny,4492,5,8,6,6,25,23,2,30
Zenit,4492,6,7,8,5,22,16,6,29
Din Moscow,4492,7,6,7,7,20,22,-2,25
FK Rubin,4492,8,5,6,9,22,20,2,21
Rostov,4492,9,4,6,10,10,18,-8,18
Amkar,4492,10,4,4,12,10,28,-18,16
Anzhi,4492,11,2,6,12,15,41,-26,12
Loko Moscow,4493,1,12,6,2,31,11,20,42
Spart Moscow,4493,2,10,6,4,38,27,11,36
CSKA Moscow,4493,3,11,3,6,29,21,8,36
Zenit,4493,4,8,9,3,23,13,10,33
Krasnodar,4493,5,9,4,7,29,26,3,31
Terek Grozny,4493,6,8,5,7,23,25,-2,29
FK Rubin,4493,7,6,5,9,22,19,3,23
Din Moscow,4493,8,5,6,9,17,24,-7,21
Rostov,4493,9,4,6,10,10,18,-8,18
Amkar,4493,10,4,5,11,12,26,-14,17
Anzhi,4493,11,3,5,12,18,42,-24,14
Loko Moscow,4494,1,13,5,2,31,11,20,44
CSKA Moscow,4494,2,11,3,6,30,21,9,36
Spart Moscow,4494,3,9,6,5,37,31,6,33
Terek Grozny,4494,4,9,5,6,24,24,0,32
Krasnodar,4494,5,9,4,7,28,25,3,31
Zenit,4494,6,7,8,5,22,17,5,29
FK Rubin,4494,7,6,5,9,22,18,4,23
Din Moscow,4494,8,5,7,8,18,23,-5,22
Amkar,4494,9,5,4,11,13,24,-11,19
Rostov,4494,10,4,6,10,12,20,-8,18
Anzhi,4494,11,3,5,12,18,41,-23,14
Loko Moscow,4495,1,12,5,3,30,12,18,41
Zenit,4495,2,9,8,3,23,13,10,35
CSKA Moscow,4495,3,10,3,7,25,22,3,33
Spart Moscow,4495,4,9,5,6,35,28,7,32
Krasnodar,4495,5,8,5,7,28,26,2,29
Terek Grozny,4495,6,7,5,8,20,25,-5,26
FK Rubin,4495,7,6,6,8,24,18,6,24
Din Moscow,4495,8,6,6,8,19,24,-5,24
Amkar,4495,9,6,4,10,11,22,-11,22
Rostov,4495,10,4,6,10,10,18,-8,18
Anzhi,4495,11,4,5,11,20,37,-17,17
Loko Moscow,4496,1,12,6,2,33,14,19,42
CSKA Moscow,4496,2,11,3,6,29,23,6,36
Zenit,4496,3,8,9,3,29,16,13,33
Spart Moscow,4496,4,9,5,6,38,29,9,32
Krasnodar,4496,5,8,5,7,29,27,2,29
Terek Grozny,4496,6,7,6,7,20,24,-4,27
FK Rubin,4496,7,6,6,8,24,18,6,24
Din Moscow,4496,8,6,6,8,19,24,-5,24
Amkar,4496,9,5,5,10,11,23,-12,20
Rostov,4496,10,4,6,10,10,20,-10,18
Anzhi,4496,11,3,5,12,16,40,-24,14
Loko Moscow,4497,1,12,5,3,30,13,17,41
CSKA Moscow,4497,2,11,4,5,30,18,12,37
Krasnodar,4497,3,10,4,6,31,24,7,34
Spart Moscow,4497,4,8,7,5,36,31,5,31
Zenit,4497,5,7,9,4,22,15,7,30
Terek Grozny,4497,6,7,6,7,21,24,-3,27
FK Rubin,4497,7,6,5,9,25,20,5,23
Din Moscow,4497,8,5,7,8,19,26,-7,22
Amkar,4497,9,5,5,10,13,23,-10,20
Rostov,4497,10,4,7,9,12,19,-7,19
Anzhi,4497,11,3,5,12,15,41,-26,14
Loko Moscow,4498,1,11,6,3,31,15,16,39
CSKA Moscow,4498,2,11,3,6,28,18,10,36
Spart Moscow,4498,3,9,7,4,34,25,9,34
Krasnodar,4498,4,10,4,6,32,25,7,34
Zenit,4498,5,8,9,3,24,15,9,33
Terek Grozny,4498,6,9,5,6,25,23,2,32
FK Rubin,4498,7,6,5,9,25,21,4,23
Din Moscow,4498,8,5,7,8,18,24,-6,22
Rostov,4498,9,4,7,9,10,17,-7,19
Amkar,4498,10,4,4,12,9,26,-17,16
Anzhi,4498,11,2,5,13,15,42,-27,11
Loko Moscow,4499,1,11,6,3,30,13,17,39
CSKA Moscow,4499,2,11,4,5,28,18,10,37
Zenit,4499,3,8,8,4,23,16,7,32
Spart Moscow,4499,4,9,5,6,37,32,5,32
Krasnodar,4499,5,8,6,6,29,26,3,30
Terek Grozny,4499,6,7,5,8,22,27,-5,26
FK Rubin,4499,7,6,6,8,23,18,5,24
Amkar,4499,8,6,4,10,14,23,-9,22
Din Moscow,4499,9,5,6,9,20,26,-6,21
Rostov,4499,10,5,6,9,11,17,-6,21
Anzhi,4499,11,3,6,11,17,38,-21,15
Loko Moscow,4500,1,12,5,3,33,14,19,41
Spart Moscow,4500,2,10,6,4,40,28,12,36
CSKA Moscow,4500,3,11,3,6,28,20,8,36
Zenit,4500,4,9,8,3,24,13,11,35
Krasnodar,4500,5,9,4,7,29,28,1,31
Terek Grozny,4500,6,7,7,6,20,22,-2,28
Din Moscow,4500,7,6,6,8,22,26,-4,24
FK Rubin,4500,8,5,5,10,22,21,1,20
Rostov,4500,9,4,6,10,10,19,-9,18
Amkar,4500,10,4,6,10,10,23,-13,18
Anzhi,4500,11,2,6,12,16,40,-24,12
Loko Moscow,4501,1,13,5,2,34,13,21,44
CSKA Moscow,4501,2,11,3,6,27,18,9,36
Spart Moscow,4501,3,9,6,5,36,29,7,33
Zenit,4501,4,8,8,4,23,15,8,32
Krasnodar,4501,5,9,4,7,29,27,2,31
Din Moscow,4501,6,7,6,7,21,21,0,27
Terek Grozny,4501,7,7,5,8,21,27,-6,26
FK Rubin,4501,8,5,5,10,21,20,1,20
Amkar,4501,9,5,5,10,13,23,-10,20
Rostov,4501,10,4,6,10,11,19,-8,18
Anzhi,4501,11,3,5,12,16,40,-24,14
Loko Moscow,4502,1,12,5,3,32,13,19,41
CSKA Moscow,4502,2,10,4,6,28,22,6,34
Zenit,4502,3,8,9,3,24,15,9,33
Spart Moscow,4502,4,9,5,6,38,30,8,32
Terek Grozny,4502,5,9,5,6,23,22,1,32
Krasnodar,4502,6,8,5,7,29,28,1,29
Din Moscow,4502,7,7,6,7,22,23,-1,27
FK Rubin,4502,8,5,6,9,23,21,2,21
Amkar,4502,9,5,4,11,10,24,-14,19
Rostov,4502,10,4,6,10,12,21,-9,18
Anzhi,4502,11,3,5,12,17,39,-22,14
Loko Moscow,4503,1,12,6,2,32,13,19,42
Spart Moscow,4503,2,10,5,5,39,27,12,35
CSKA Moscow,4503,3,10,5,5,30,22,8,35
Zenit,4503,4,7,10,3,23,15,8,31
Krasnodar,4503,5,8,4,8,29,28,1,28
Terek Grozny,4503,6,7,5,8,20,24,-4,26
FK Rubin,4503,7,6,6,8,24,19,5,24
Din Moscow,4503,8,5,7,8,19,27,-8,22
Amkar,4503,9,6,4,10,11,22,-11,22
Rostov,4503,10,4,6,10,10,18,-8,18
Anzhi,4503,11,3,6,11,19,41,-22,15
Loko Moscow,4504,1,11,5,4,30,16,14,38
CSKA Moscow,4504,2,11,3,6,27,20,7,36
Zenit,4504,3,9,8,3,26,14,12,35
Krasnodar,4504,4,10,4,6,32,26,6,34
Spart Moscow,4504,5,9,5,6,35,29,6,32
Terek Grozny,4504,6,9,5,6,27,23,4,32
Din Moscow,4504,7,6,6,8,18,23,-5,24
Rostov,4504,8,5,6,9,11,17,-6,21
FK Rubin,4504,9,5,5,10,22,20,2,20
Amkar,4504,10,5,4,11,12,25,-13,19
Anzhi,4504,11,2,5,13,15,42,-27,11
Loko Moscow,4505,1,11,6,3,31,14,17,39
CSKA Moscow,4505,2,11,3,6,26,19,7,36
Spart Moscow,4505,3,10,5,5,41,30,11,35
Zenit,4505,4,8,9,3,24,14,10,33
Krasnodar,4505,5,9,5,6,29,25,4,32
Terek Grozny,4505,6,8,6,6,25,26,-1,30
Din Moscow,4505,7,6,7,7,21,24,-3,25
FK Rubin,4505,8,5,7,8,22,18,4,22
Rostov,4505,9,4,6,10,10,20,-10,18
Amkar,4505,10,4,4,12,12,27,-15,16
Anzhi,4505,11,2,6,12,17,41,-24,12
Loko Moscow,4506,1,12,5,3,33,14,19,41
CSKA Moscow,4506,2,11,3,6,28,20,8,36
Spart Moscow,4506,3,9,6,5,38,31,7,33
Zenit,4506,4,8,8,4,25,16,9,32
Terek Grozny,4506,5,9,5,6,22,22,0,32
Krasnodar,4506,6,9,4,7,30,29,1,31
Din Moscow,4506,7,6,6,8,21,24,-3,24
FK Rubin,4506,8,6,5,9,26,21,5,23
Rostov,4506,9,4,7,9,12,19,-7,19
Amkar,4506,10,5,4,11,12,24,-12,19
Anzhi,4506,11,2,5,13,14,41,-27,11
Loko Moscow,4507,1,12,6,2,31,12,19,42
CSKA Moscow,4507,2,12,3,5,29,18,11,39
Spart Moscow,4507,3,10,6,4,36,26,10,36
Krasnodar,4507,4,8,6,6,30,27,3,30
Terek Grozny,4507,5,8,6,6,23,24,-1,30
Zenit,4507,6,7,8,5,22,16,6,29
Din Moscow,4507,7,6,6,8,18,22,-4,24
FK Rubin,4507,8,5,6,9,23,20,3,21
Rostov,4507,9,4,6,10,10,18,-8,18
Amkar,4507,10,4,5,11,11,25,-14,17
Anzhi,4507,11,2,6,12,15,40,-25,12
Loko Moscow,4508,1,11,7,2,29,11,18,40
Spart Moscow,4508,2,11,5,4,40,28,12,38
CSKA Moscow,4508,3,11,4,5,30,19,11,37
Krasnodar,4508,4,9,5,6,30,25,5,32
Zenit,4508,5,7,10,3,23,15,8,31
Terek Grozny,4508,6,7,6,7,22,25,-3,27
Din Moscow,4508,7,6,6,8,20,24,-4,24
FK Rubin,4508,8,5,5,10,22,22,0,20
Rostov,4508,9,4,6,10,10,18,-8,18
Amkar,4508,10,4,5,11,12,26,-14,17
Anzhi,4508,11,3,5,12,16,41,-25,14
CSKA Moscow,4509,1,12,3,5,32,19,13,39
Loko Moscow,4509,2,11,5,4,30,15,15,38
Spart Moscow,4509,3,10,6,4,43,29,14,36
Krasnodar,4509,4,10,4,6,30,24,6,34
Zenit,4509,5,8,8,4,26,17,9,32
Terek Grozny,4509,6,8,6,6,22,23,-1,30
Din Moscow,4509,7,6,6,8,18,26,-8,24
FK Rubin,4509,8,5,5,10,21,20,1,20
Rostov,4509,9,4,6,10,12,20,-8,18
Amkar,4509,10,4,5,11,11,25,-14,17
Anzhi,4509,11,2,6,12,15,42,-27,12
Loko Moscow,4510,1,11,7,2,29,11,18,40
CSKA Moscow,4510,2,11,3,6,28,19,9,36
Spart Moscow,4510,3,10,5,5,36,28,8,35
Zenit,4510,4,7,9,4,22,16,6,30
Krasnodar,4510,5,8,5,7,27,25,2,29
Terek Grozny,4510,6,8,5,7,22,24,-2,29
Din Moscow,4510,7,7,6,7,20,21,-1,27
FK Rubin,4510,8,6,5,9,22,18,4,23
Amkar,4510,9,5,4,11,10,23,-13,19
Rostov,4510,10,4,6,10,11,19,-8,18
Anzhi,4510,11,3,5,12,16,39,-23,14
Loko Moscow,4511,1,13,5,2,33,12,21,44
Spart Moscow,4511,2,11,5,4,39,26,13,38
CSKA Moscow,4511,3,11,3,6,30,19,11,36
Zenit,4511,4,8,8,4,24,16,8,32
Krasnodar,4511,5,9,4,7,30,27,3,31
Terek Grozny,4511,6,7,6,7,23,26,-3,27
Din Moscow,4511,7,6,6,8,19,23,-4,24
FK Rubin,4511,8,5,5,10,22,21,1,20
Amkar,4511,9,5,4,11,11,24,-13,19
Rostov,4511,10,4,6,10,10,20,-10,18
Anzhi,4511,11,2,6,12,16,43,-27,12
Loko Moscow,4512,1,11,6,3,31,14,17,39
CSKA Moscow,4512,2,11,3,6,26,19,7,36
Spart Moscow,4512,3,10,5,5,40,31,9,35
Zenit,4512,4,8,9,3,24,14,10,33
Krasnodar,4512,5,9,5,6,30,26,4,32
Terek Grozny,4512,6,8,6,6,25,26,-1,30
FK Rubin,4512,7,5,7,8,23,19,4,22
Din Moscow,4512,8,5,7,8,19,24,-5,22
Rostov,4512,9,5,6,9,12,18,-6,21
Amkar,4512,10,4,4,12,12,27,-15,16
Anzhi,4512,11,2,6,12,18,42,-24,12
Loko Moscow,4513,1,11,6,3,29,12,17,39
Spart Moscow,4513,2,11,5,4,37,25,12,38
CSKA Moscow,4513,3,11,3,6,29,20,9,36
Zenit,4513,4,9,8,3,24,13,11,35
Krasnodar,4513,5,8,6,6,28,25,3,30
Terek Grozny,4513,6,7,5,8,20,26,-6,26
FK Rubin,4513,7,6,6,8,23,18,5,24
Din Moscow,4513,8,5,6,9,17,24,-7,21
Amkar,4513,9,5,4,11,10,23,-13,19
Rostov,4513,10,4,6,10,10,18,-8,18
Anzhi,4513,11,3,5,12,18,41,-23,14
Loko Moscow,4514,1,11,6,3,32,15,17,39
Zenit,4514,2,9,8,3,27,15,12,35
Spart Moscow,4514,3,9,6,5,39,28,11,33
CSKA Moscow,4514,4,10,3,7,26,22,4,33
Krasnodar,4514,5,8,6,6,30,27,3,30
Terek Grozny,4514,6,8,5,7,23,24,-1,29
FK Rubin,4514,7,5,7,8,22,18,4,22
Din Moscow,4514,8,5,7,8,17,25,-8,22
Rostov,4514,9,5,6,9,12,18,-6,21
Amkar,4514,10,5,5,10,11,23,-12,20
Anzhi,4514,11,3,5,12,16,40,-24,14
Loko Moscow,4515,1,12,5,3,32,15,17,41
CSKA Moscow,4515,2,11,4,5,29,20,9,37
Spart Moscow,4515,3,9,6,5,40,30,10,33
Krasnodar,4515,4,9,5,6,31,25,6,32
Terek Grozny,4515,5,8,6,6,23,24,-1,30
Zenit,4515,6,7,8,5,23,18,5,29
FK Rubin,4515,7,5,7,8,24,20,4,22
Din Moscow,4515,8,5,7,8,19,26,-7,22
Rostov,4515,9,5,6,9,12,18,-6,21
Amkar,4515,10,4,5,11,13,27,-14,17
Anzhi,4515,11,2,7,11,17,40,-23,13
Loko Moscow,4516,1,11,6,3,33,16,17,39
CSKA Moscow,4516,2,11,4,5,29,19,10,37
Spart Moscow,4516,3,10,5,5,39,28,11,35
Krasnodar,4516,4,10,4,6,31,26,5,34
Zenit,4516,5,7,10,3,24,16,8,31
Terek Grozny,4516,6,7,7,6,22,24,-2,28
Din Moscow,4516,7,5,7,8,19,24,-5,22
FK Rubin,4516,8,5,6,9,22,19,3,21
Rostov,4516,9,5,6,9,12,18,-6,21
Amkar,4516,10,4,5,11,9,25,-16,17
Anzhi,4516,11,2,6,12,17,42,-25,12
Loko Moscow,4517,1,13,5,2,33,11,22,44
CSKA Moscow,4517,2,10,4,6,27,20,7,34
Spart Moscow,4517,3,9,6,5,36,27,9,33
Zenit,4517,4,8,8,4,23,16,7,32
Krasnodar,4517,5,8,5,7,28,27,1,29
Terek Grozny,4517,6,8,5,7,22,24,-2,29
Din Moscow,4517,7,6,7,7,19,22,-3,25
FK Rubin,4517,8,5,6,9,23,20,3,21
Amkar,4517,9,5,4,11,11,24,-13,19
Rostov,4517,10,4,6,10,10,20,-10,18
Anzhi,4517,11,3,6,11,17,38,-21,15
Loko Moscow,4518,1,13,5,2,33,13,20,44
CSKA Moscow,4518,2,10,5,5,26,18,8,35
Zenit,4518,3,7,9,4,22,15,7,30
Spart Moscow,4518,4,8,6,6,37,31,6,30
Krasnodar,4518,5,8,5,7,31,29,2,29
Din Moscow,4518,6,7,6,7,20,22,-2,27
Terek Grozny,4518,7,7,5,8,22,28,-6,26
FK Rubin,4518,8,5,6,9,23,20,3,21
Rostov,4518,9,5,6,9,12,18,-6,21
Amkar,4518,10,5,5,10,15,25,-10,20
Anzhi,4518,11,3,6,11,16,38,-22,15
Loko Moscow,4519,1,12,5,3,33,15,18,41
Zenit,4519,2,9,8,3,25,14,11,35
CSKA Moscow,4519,3,10,4,6,25,19,6,34
Krasnodar,4519,4,9,4,7,31,28,3,31
Spart Moscow,4519,5,8,6,6,37,32,5,30
Terek Grozny,4519,6,7,5,8,21,25,-4,26
Din Moscow,4519,7,6,6,8,21,24,-3,24
FK Rubin,4519,8,6,5,9,24,20,4,23
Rostov,4519,9,5,6,9,12,18,-6,21
Amkar,4519,10,5,5,10,13,25,-12,20
Anzhi,4519,11,3,6,11,15,37,-22,15
Loko Moscow,4520,1,12,5,3,32,15,17,41
CSKA Moscow,4520,2,11,4,5,28,17,11,37
Spart Moscow,4520,3,9,7,4,36,27,9,34
Krasnodar,4520,4,9,4,7,32,27,5,31
Zenit,4520,5,7,8,5,21,19,2,29
Terek Grozny,4520,6,8,5,7,25,27,-2,29
FK Rubin,4520,7,6,6,8,24,18,6,24
Din Moscow,4520,8,5,8,7,18,22,-4,23
Rostov,4520,9,4,6,10,10,18,-8,18
Amkar,4520,10,4,5,11,11,25,-14,17
Anzhi,4520,11,3,6,11,18,40,-22,15
Loko Moscow,4521,1,11,7,2,31,13,18,40
CSKA Moscow,4521,2,12,3,5,27,17,10,39
Spart Moscow,4521,3,10,6,4,39,27,12,36
Zenit,4521,4,7,9,4,23,16,7,30
Krasnodar,4521,5,8,5,7,28,26,2,29
Terek Grozny,4521,6,8,5,7,22,24,-2,29
Din Moscow,4521,7,6,7,7,20,23,-3,25
FK Rubin,4521,8,6,5,9,23,19,4,23
Amkar,4521,9,5,4,11,10,24,-14,19
Rostov,4521,10,4,6,10,10,19,-9,18
Anzhi,4521,11,2,5,13,15,40,-25,11
Loko Moscow,4522,1,11,5,4,31,19,12,38
CSKA Moscow,4522,2,11,3,6,27,20,7,36
Zenit,4522,3,9,8,3,29,16,13,35
Krasnodar,4522,4,10,4,6,31,24,7,34
Spart Moscow,4522,5,8,7,5,35,29,6,31
Terek Grozny,4522,6,8,5,7,23,25,-2,29
Din Moscow,4522,7,5,8,7,19,23,-4,23
FK Rubin,4522,8,5,6,9,22,19,3,21
Rostov,4522,9,4,7,9,11,18,-7,19
Amkar,4522,10,5,4,11,13,25,-12,19
Anzhi,4522,11,3,5,12,15,38,-23,14
Loko Moscow,4523,1,11,5,4,29,13,16,38
CSKA Moscow,4523,2,10,5,5,25,17,8,35
Zenit,4523,3,8,9,3,22,13,9,33
Spart Moscow,4523,4,9,6,5,38,30,8,33
Krasnodar,4523,5,9,5,6,30,26,4,32
Terek Grozny,4523,6,8,6,6,23,22,1,30
Din Moscow,4523,7,7,6,7,23,23,0,27
FK Rubin,4523,8,5,6,9,24,23,1,21
Rostov,4523,9,4,7,9,13,20,-7,19
Amkar,4523,10,4,5,11,9,23,-14,17
Anzhi,4523,11,2,6,12,14,40,-26,12
Loko Moscow,4524,1,12,5,3,31,12,19,41
CSKA Moscow,4524,2,11,4,5,27,17,10,37
Spart Moscow,4524,3,9,7,4,36,26,10,34
Zenit,4524,4,8,9,3,22,13,9,33
Krasnodar,4524,5,8,5,7,28,27,1,29
Terek Grozny,4524,6,7,7,6,23,25,-2,28
Din Moscow,4524,7,6,7,7,20,22,-2,25
FK Rubin,4524,8,5,6,9,22,20,2,21
Rostov,4524,9,4,7,9,10,17,-7,19
Amkar,4524,10,4,5,11,10,25,-15,17
Anzhi,4524,11,2,6,12,16,41,-25,12
Loko Moscow,4525,1,11,6,3,30,16,14,39
CSKA Moscow,4525,2,11,3,6,28,20,8,36
Zenit,4525,3,8,9,3,25,15,10,33
Spart Moscow,4525,4,9,6,5,37,29,8,33
Krasnodar,4525,5,9,4,7,31,26,5,31
Terek Grozny,4525,6,8,5,7,22,24,-2,29
Din Moscow,4525,7,7,6,7,21,22,-1,27
FK Rubin,4525,8,6,5,9,23,19,4,23
Rostov,4525,9,4,7,9,11,18,-7,19
Amkar,4525,10,5,4,11,11,24,-13,19
Anzhi,4525,11,2,5,13,15,41,-26,11
Loko Moscow,4526,1,11,6,3,30,16,14,39
CSKA Moscow,4526,2,11,3,6,27,19,8,36
Spart Moscow,4526,3,10,5,5,39,29,10,35
Krasnodar,4526,4,10,4,6,36,25,11,34
Zenit,4526,5,8,9,3,23,13,10,33
Terek Grozny,4526,6,8,5,7,22,25,-3,29
Din Moscow,4526,7,5,7,8,18,24,-6,22
FK Rubin,4526,8,5,6,9,21,21,0,21
Rostov,4526,9,5,6,9,12,17,-5,21
Amkar,4526,10,5,4,11,12,25,-13,19
Anzhi,4526,11,2,5,13,15,41,-26,11
Loko Moscow,4527,1,11,7,2,31,13,18,40
CSKA Moscow,4527,2,11,3,6,27,21,6,36
Zenit,4527,3,8,9,3,26,15,11,33
Terek Grozny,4527,4,9,5,6,24,24,0,32
Spart Moscow,4527,5,8,6,6,37,32,5,30
Krasnodar,4527,6,8,5,7,27,25,2,29
FK Rubin,4527,7,7,5,8,26,19,7,26
Din Moscow,4527,8,6,6,8,20,25,-5,24
Rostov,4527,9,5,6,9,14,19,-5,21
Amkar,4527,10,4,5,11,11,25,-14,17
Anzhi,4527,11,2,5,13,17,42,-25,11
Loko Moscow,4528,1,12,6,2,31,12,19,42
CSKA Moscow,4528,2,11,4,5,27,18,9,37
Spart Moscow,4528,3,10,5,5,38,29,9,35
Zenit,4528,4,7,9,4,21,14,7,30
Krasnodar,4528,5,8,5,7,29,27,2,29
Terek Grozny,4528,6,7,6,7,22,25,-3,27
FK Rubin,4528,7,5,7,8,23,19,4,22
Din Moscow,4528,8,5,7,8,19,25,-6,22
Rostov,4528,9,5,6,9,12,17,-5,21
Amkar,4528,10,4,5,11,12,26,-14,17
Anzhi,4528,11,3,6,11,16,38,-22,15
Loko Moscow,4529,1,11,7,2,32,14,18,40
CSKA Moscow,4529,2,11,3,6,26,18,8,36
Spart Moscow,4529,3,10,5,5,39,30,9,35
Zenit,4529,4,8,9,3,23,14,9,33
Krasnodar,4529,5,8,5,7,30,28,2,29
Terek Grozny,4529,6,8,5,7,22,23,-1,29
Din Moscow,4529,7,7,6,7,23,22,1,27
FK Rubin,4529,8,6,5,9,24,21,3,23
Amkar,4529,9,5,4,11,11,25,-14,19
Rostov,4529,10,4,6,10,11,20,-9,18
Anzhi,4529,11,2,5,13,14,40,-26,11
Loko Moscow,4530,1,11,6,3,30,13,17,39
CSKA Moscow,4530,2,11,4,5,30,19,11,37
Krasnodar,4530,3,10,4,6,31,26,5,34
Spart Moscow,4530,4,9,5,6,37,31,6,32
Zenit,4530,5,7,10,3,23,15,8,31
Terek Grozny,4530,6,8,6,6,21,22,-1,30
Din Moscow,4530,7,6,7,7,19,21,-2,25
FK Rubin,4530,8,5,6,9,22,19,3,21
Rostov,4530,9,5,6,9,13,19,-6,21
Amkar,4530,10,4,5,11,10,24,-14,17
Anzhi,4530,11,2,5,13,14,41,-27,11
Loko Moscow,4531,1,12,5,3,31,16,15,41
CSKA Moscow,4531,2,12,3,5,33,19,14,39
Spart Moscow,4531,3,10,5,5,40,29,11,35
Zenit,4531,4,8,8,4,25,17,8,32
Krasnodar,4531,5,8,5,7,30,28,2,29
Terek Grozny,4531,6,7,6,7,20,23,-3,27
Din Moscow,4531,7,6,6,8,19,25,-6,24
FK Rubin,4531,8,5,6,9,24,21,3,21
Rostov,4531,9,5,6,9,12,18,-6,21
Amkar,4531,10,4,5,11,11,25,-14,17
Anzhi,4531,11,3,5,12,17,41,-24,14
Loko Moscow,4532,1,13,5,2,33,12,21,44
CSKA Moscow,4532,2,11,3,6,26,19,7,36
Spart Moscow,4532,3,9,7,4,37,27,10,34
Zenit,4532,4,8,8,4,23,14,9,32
Krasnodar,4532,5,9,4,7,29,27,2,31
Terek Grozny,4532,6,7,7,6,21,23,-2,28
FK Rubin,4532,7,6,5,9,23,19,4,23
Din Moscow,4532,8,5,7,8,20,25,-5,22
Rostov,4532,9,4,7,9,10,17,-7,19
Amkar,4532,10,4,5,11,9,24,-15,17
Anzhi,4532,11,2,6,12,15,39,-24,12
CSKA Moscow,4533,1,12,3,5,30,19,11,39
Loko Moscow,4533,2,11,5,4,30,15,15,38
Spart Moscow,4533,3,10,6,4,38,28,10,36
Zenit,4533,4,8,8,4,23,16,7,32
Krasnodar,4533,5,9,4,7,30,26,4,31
Terek Grozny,4533,6,8,5,7,21,25,-4,29
Din Moscow,4533,7,6,7,7,21,24,-3,25
FK Rubin,4533,8,6,5,9,23,19,4,23
Rostov,4533,9,4,6,10,11,19,-8,18
Amkar,4533,10,4,4,12,9,24,-15,16
Anzhi,4533,11,3,5,12,18,39,-21,14
Loko Moscow,4534,1,12,5,3,31,13,18,41
CSKA Moscow,4534,2,11,4,5,30,19,11,37
Spart Moscow,4534,3,10,5,5,37,27,10,35
Zenit,4534,4,8,9,3,23,14,9,33
Krasnodar,4534,5,9,4,7,28,25,3,31
Terek Grozny,4534,6,8,5,7,21,23,-2,29
Din Moscow,4534,7,6,6,8,19,23,-4,24
Amkar,4534,8,6,4,10,12,23,-11,22
FK Rubin,4534,9,5,5,10,21,20,1,20
Rostov,4534,10,4,6,10,10,18,-8,18
Anzhi,4534,11,2,5,13,16,43,-27,11
Loko Moscow,4535,1,12,5,3,32,16,16,41
Zenit,4535,2,9,8,3,29,14,15,35
Spart Moscow,4535,3,9,7,4,36,27,9,34
CSKA Moscow,4535,4,10,4,6,25,21,4,34
Terek Grozny,4535,5,8,6,6,23,24,-1,30
Krasnodar,4535,6,8,5,7,29,27,2,29
Din Moscow,4535,7,6,7,7,18,21,-3,25
FK Rubin,4535,8,5,6,9,22,19,3,21
Rostov,4535,9,4,6,10,11,19,-8,18
Amkar,4535,10,4,5,11,11,25,-14,17
Anzhi,4535,11,2,7,11,15,38,-23,13
Loko Moscow,4536,1,13,5,2,34,13,21,44
CSKA Moscow,4536,2,11,4,5,28,19,9,37
Spart Moscow,4536,3,10,5,5,37,27,10,35
Krasnodar,4536,4,9,4,7,32,30,2,31
Zenit,4536,5,7,8,5,22,16,6,29
Terek Grozny,4536,6,7,6,7,22,25,-3,27
Din Moscow,4536,7,6,6,8,18,22,-4,24
FK Rubin,4536,8,6,5,9,24,20,4,23
Amkar,4536,9,5,4,11,12,26,-14,19
Rostov,4536,10,4,6,10,10,18,-8,18
Anzhi,4536,11,2,7,11,16,39,-23,13
Loko Moscow,4537,1,11,5,4,30,16,14,38
CSKA Moscow,4537,2,11,3,6,29,19,10,36
Zenit,4537,3,9,8,3,25,14,11,35
Krasnodar,4537,4,10,4,6,33,25,8,34
Spart Moscow,4537,5,9,6,5,38,29,9,33
Terek Grozny,4537,6,8,6,6,23,24,-1,30
Din Moscow,4537,7,6,7,7,20,23,-3,25
Rostov,4537,8,5,6,9,12,18,-6,21
FK Rubin,4537,9,5,5,10,21,21,0,20
Amkar,4537,10,4,5,11,11,26,-15,17
Anzhi,4537,11,2,5,13,14,41,-27,11
CSKA Moscow,4538,1,12,3,5,31,18,13,39
Loko Moscow,4538,2,11,5,4,29,14,15,38
Spart Moscow,4538,3,10,6,4,38,25,13,36
Krasnodar,4538,4,10,4,6,31,24,7,34
Zenit,4538,5,8,8,4,23,18,5,32
Terek Grozny,4538,6,7,5,8,22,27,-5,26
Din Moscow,4538,7,6,6,8,20,24,-4,24
FK Rubin,4538,8,5,5,10,21,22,-1,20
Rostov,4538,9,4,7,9,10,17,-7,19
Amkar,4538,10,5,4,11,11,25,-14,19
Anzhi,4538,11,3,5,12,17,39,-22,14
Loko Moscow,4539,1,12,5,3,32,15,17,41
CSKA Moscow,4539,2,11,4,5,28,19,9,37
Spart Moscow,4539,3,10,5,5,39,29,10,35
Krasnodar,4539,4,9,4,7,30,26,4,31
Zenit,4539,5,7,9,4,23,16,7,30
Terek Grozny,4539,6,8,5,7,21,24,-3,29
Din Moscow,4539,7,6,6,8,21,26,-5,24
FK Rubin,4539,8,6,5,9,22,18,4,23
Amkar,4539,9,5,4,11,10,23,-13,19
Rostov,4539,10,4,6,10,10,18,-8,18
Anzhi,4539,11,3,5,12,17,39,-22,14
Loko Moscow,4540,1,11,6,3,31,15,16,39
CSKA Moscow,4540,2,12,3,5,30,19,11,39
Spart Moscow,4540,3,10,6,4,39,27,12,36
Krasnodar,4540,4,9,5,6,32,27,5,32
Zenit,4540,5,7,9,4,22,15,7,30
Terek Grozny,4540,6,7,7,6,21,23,-2,28
FK Rubin,4540,7,5,7,8,22,18,4,22
Din Moscow,4540,8,5,7,8,18,25,-7,22
Rostov,4540,9,4,6,10,11,19,-8,18
Amkar,4540,10,4,6,10,10,23,-13,18
Anzhi,4540,11,2,6,12,15,40,-25,12
Loko Moscow,4541,1,11,6,3,32,16,16,39
CSKA Moscow,4541,2,12,3,5,29,17,12,39
Spart Moscow,4541,3,10,5,5,37,27,10,35
Krasnodar,4541,4,9,4,7,34,30,4,31
Zenit,4541,5,7,9,4,23,16,7,30
Terek Grozny,4541,6,7,6,7,24,27,-3,27
FK Rubin,4541,7,6,6,8,27,22,5,24
Din Moscow,4541,8,5,7,8,19,24,-5,22
Amkar,4541,9,5,5,10,11,23,-12,20
Rostov,4541,10,4,6,10,10,19,-9,18
Anzhi,4541,11,3,5,12,18,43,-25,14
Loko Moscow,4542,1,11,6,3,30,14,16,39
Spart Moscow,4542,2,10,6,4,40,26,14,36
CSKA Moscow,4542,3,11,3,6,28,21,7,36
Zenit,4542,4,9,8,3,25,13,12,35
Terek Grozny,4542,5,8,6,6,23,23,0,30
Krasnodar,4542,6,8,5,7,30,29,1,29
FK Rubin,4542,7,6,6,8,26,20,6,24
Din Moscow,4542,8,5,7,8,18,25,-7,22
Rostov,4542,9,4,6,10,10,20,-10,18
Amkar,4542,10,4,5,11,10,25,-15,17
Anzhi,4542,11,2,6,12,17,41,-24,12
Loko Moscow,4543,1,12,5,3,30,14,16,41
CSKA Moscow,4543,2,11,3,6,33,18,15,36
Spart Moscow,4543,3,9,7,4,38,27,11,34
Krasnodar,4543,4,10,4,6,32,24,8,34
Zenit,4543,5,8,8,4,22,14,8,32
Terek Grozny,4543,6,7,6,7,21,24,-3,27
FK Rubin,4543,7,6,5,9,26,21,5,23
Din Moscow,4543,8,5,6,9,19,29,-10,21
Amkar,4543,9,5,5,10,12,24,-12,20
Rostov,4543,10,4,7,9,11,18,-7,19
Anzhi,4543,11,2,6,12,14,45,-31,12
Loko Moscow,4544,1,13,5,2,34,12,22,44
CSKA Moscow,4544,2,11,3,6,29,20,9,36
Spart Moscow,4544,3,9,6,5,35,29,6,33
Zenit,4544,4,8,8,4,23,16,7,32
Krasnodar,4544,5,8,5,7,29,28,1,29
Terek Grozny,4544,6,8,5,7,22,25,-3,29
Din Moscow,4544,7,6,6,8,21,23,-2,24
FK Rubin,4544,8,5,6,9,22,21,1,21
Rostov,4544,9,4,7,9,10,17,-7,19
Amkar,4544,10,5,4,11,12,24,-12,19
Anzhi,4544,11,3,5,12,18,40,-22,14
Loko Moscow,4545,1,11,7,2,29,11,18,40
Spart Moscow,4545,2,10,6,4,40,27,13,36
CSKA Moscow,4545,3,10,4,6,25,21,4,34
Zenit,4545,4,8,9,3,25,13,12,33
Krasnodar,4545,5,9,5,6,28,24,4,32
Terek Grozny,4545,6,8,5,7,22,25,-3,29
Din Moscow,4545,7,6,7,7,20,22,-2,25
FK Rubin,4545,8,5,5,10,21,20,1,20
Amkar,4545,9,5,4,11,11,26,-15,19
Rostov,4545,10,4,6,10,11,19,-8,18
Anzhi,4545,11,2,6,12,15,39,-24,12
Loko Moscow,4546,1,11,6,3,30,14,16,39
CSKA Moscow,4546,2,12,3,5,32,19,13,39
Krasnodar,4546,3,10,4,6,30,24,6,34
Zenit,4546,4,7,9,4,24,17,7,30
Terek Grozny,4546,5,8,6,6,23,24,-1,30
Spart Moscow,4546,6,8,5,7,33,29,4,29
Din Moscow,4546,7,6,7,7,18,21,-3,25
FK Rubin,4546,8,5,6,9,21,18,3,21
Rostov,4546,9,5,6,9,12,17,-5,21
Amkar,4546,10,5,5,10,11,23,-12,20
Anzhi,4546,11,2,5,13,15,43,-28,11
Loko Moscow,4547,1,11,6,3,29,12,17,39
CSKA Moscow,4547,2,12,3,5,29,18,11,39
Spart Moscow,4547,3,11,5,4,39,27,12,38
Krasnodar,4547,4,10,4,6,30,24,6,34
Zenit,4547,5,7,9,4,21,14,7,30
Terek Grozny,4547,6,7,6,7,23,26,-3,27
Din Moscow,4547,7,5,7,8,18,24,-6,22
FK Rubin,4547,8,5,6,9,21,19,2,21
Amkar,4547,9,5,4,11,11,24,-13,19
Rostov,4547,10,4,6,10,11,19,-8,18
Anzhi,4547,11,2,6,12,17,42,-25,12
Loko Moscow,4548,1,12,5,3,32,15,17,41
Zenit,4548,2,9,8,3,25,13,12,35
Spart Moscow,4548,3,10,5,5,37,29,8,35
CSKA Moscow,4548,4,10,3,7,26,20,6,33
Krasnodar,4548,5,8,4,8,29,30,-1,28
Terek Grozny,4548,6,7,6,7,20,27,-7,27
Din Moscow,4548,7,6,6,8,20,23,-3,24
FK Rubin,4548,8,6,5,9,24,20,4,23
Rostov,4548,9,5,6,9,13,17,-4,21
Amkar,4548,10,4,5,11,9,24,-15,17
Anzhi,4548,11,4,5,11,21,38,-17,17
Loko Moscow,4549,1,13,5,2,33,12,21,44
CSKA Moscow,4549,2,12,3,5,29,19,10,39
Spart Moscow,4549,3,11,5,4,38,25,13,38
Zenit,4549,4,7,8,5,23,17,6,29
Krasnodar,4549,5,8,5,7,29,28,1,29
Terek Grozny,4549,6,7,7,6,22,24,-2,28
FK Rubin,4549,7,6,6,8,24,19,5,24
Din Moscow,4549,8,5,6,9,18,24,-6,21
Rostov,4549,9,4,6,10,10,20,-10,18
Amkar,4549,10,4,5,11,11,25,-14,17
Anzhi,4549,11,2,6,12,14,38,-24,12
Loko Moscow,4550,1,12,5,3,33,14,19,41
Spart Moscow,4550,2,10,6,4,40,28,12,36
CSKA Moscow,4550,3,11,3,6,28,20,8,36
Krasnodar,4550,4,10,4,6,32,26,6,34
Zenit,4550,5,8,8,4,24,16,8,32
Terek Grozny,4550,6,8,6,6,24,24,0,30
Din Moscow,4550,7,5,7,8,19,25,-6,22
FK Rubin,4550,8,5,6,9,22,20,2,21
Rostov,4550,9,4,7,9,11,18,-7,19
Amkar,4550,10,4,5,11,12,27,-15,17
Anzhi,4550,11,2,5,13,14,41,-27,11
Loko Moscow,4551,1,11,5,4,32,19,13,38
CSKA Moscow,4551,2,11,4,5,27,17,10,37
Zenit,4551,3,8,9,3,24,15,9,33
Krasnodar,4551,4,9,4,7,33,29,4,31
Spart Moscow,4551,5,8,6,6,34,29,5,30
Terek Grozny,4551,6,8,5,7,24,25,-1,29
Din Moscow,4551,7,6,7,7,20,23,-3,25
FK Rubin,4551,8,6,5,9,26,20,6,23
Rostov,4551,9,5,6,9,11,17,-6,21
Amkar,4551,10,5,4,11,12,25,-13,19
Anzhi,4551,11,3,5,12,16,40,-24,14
Loko Moscow,4552,1,11,5,4,30,14,16,38
CSKA Moscow,4552,2,11,3,6,30,22,8,36
Zenit,4552,3,9,8,3,24,14,10,35
Krasnodar,4552,4,10,4,6,29,24,5,34
Spart Moscow,4552,5,9,6,5,37,29,8,33
Terek Grozny,4552,6,7,5,8,21,26,-5,26
Din Moscow,4552,7,6,6,8,20,23,-3,24
FK Rubin,4552,8,6,5,9,22,18,4,23
Rostov,4552,9,4,7,9,11,18,-7,19
Amkar,4552,10,5,4,11,11,24,-13,19
Anzhi,4552,11,3,5,12,20,43,-23,14
Loko Moscow,4553,1,12,5,3,31,13,18,41
Spart Moscow,4553,2,11,5,4,37,25,12,38
CSKA Moscow,4553,3,10,4,6,25,21,4,34
Zenit,4553,4,8,8,4,25,15,10,32
Terek Grozny,4553,5,9,5,6,24,23,1,32
Krasnodar,4553,6,9,4,7,30,27,3,31
FK Rubin,4553,7,7,5,8,26,19,7,26
Din Moscow,4553,8,5,6,9,18,25,-7,21
Rostov,4553,9,4,6,10,10,18,-8,18
Amkar,4553,10,4,4,12,9,24,-15,16
Anzhi,4553,11,2,6,12,15,40,-25,12
Loko Moscow,4554,1,11,6,3,29,17,12,39
CSKA Moscow,4554,2,11,3,6,26,19,7,36
Krasnodar,4554,3,10,4,6,34,24,10,34
Spart Moscow,4554,4,9,6,5,39,28,11,33
Zenit,4554,5,8,9,3,23,13,10,33
Terek Grozny,4554,6,7,7,6,21,23,-2,28
Din Moscow,4554,7,6,7,7,19,21,-2,25
FK Rubin,4554,8,5,6,9,21,18,3,21
Rostov,4554,9,4,6,10,10,22,-12,18
Amkar,4554,10,4,6,10,11,24,-13,18
Anzhi,4554,11,2,6,12,14,38,-24,12
Loko Moscow,4555,1,11,6,3,30,13,17,39
CSKA Moscow,4555,2,11,3,6,28,20,8,36
Spart Moscow,4555,3,9,7,4,38,29,9,34
Zenit,4555,4,8,9,3,22,13,9,33
Krasnodar,4555,5,9,4,7,29,26,3,31
Terek Grozny,4555,6,7,7,6,21,23,-2,28
FK Rubin,4555,7,6,6,8,23,18,5,24
Din Moscow,4555,8,5,8,7,18,22,-4,23
Rostov,4555,9,4,7,9,13,20,-7,19
Amkar,4555,10,4,5,11,10,24,-14,17
Anzhi,4555,11,2,6,12,17,41,-24,12
Loko Moscow,4556,1,12,6,2,33,13,20,42
CSKA Moscow,4556,2,12,3,5,36,17,19,39
Spart Moscow,4556,3,9,7,4,37,27,10,34
Krasnodar,4556,4,8,6,6,29,26,3,30
Zenit,4556,5,7,8,5,22,22,0,29
Terek Grozny,4556,6,7,6,7,20,23,-3,27
FK Rubin,4556,7,6,6,8,24,19,5,24
Din Moscow,4556,8,5,6,9,18,25,-7,21
Rostov,4556,9,4,7,9,11,18,-7,19
Amkar,4556,10,4,6,10,10,23,-13,18
Anzhi,4556,11,3,5,12,15,42,-27,14
Loko Moscow,4557,1,13,5,2,32,12,20,44
CSKA Moscow,4557,2,11,4,5,28,18,10,37
Spart Moscow,4557,3,10,5,5,40,30,10,35
Zenit,4557,4,7,9,4,21,14,7,30
Krasnodar,4557,5,8,5,7,29,27,2,29
Terek Grozny,4557,6,7,5,8,20,25,-5,26
FK Rubin,4557,7,5,7,8,23,19,4,22
Din Moscow,4557,8,5,7,8,18,23,-5,22
Rostov,4557,9,5,6,9,13,19,-6,21
Amkar,4557,10,5,4,11,13,26,-13,19
Anzhi,4557,11,3,5,12,16,40,-24,14
Loko Moscow,4558,1,11,5,4,30,16,14,38
CSKA Moscow,4558,2,11,3,6,27,18,9,36
Spart Moscow,4558,3,10,5,5,40,28,12,35
Zenit,4558,4,9,8,3,23,13,10,35
Krasnodar,4558,5,9,4,7,31,26,5,31
Terek Grozny,4558,6,7,6,7,22,26,-4,27
FK Rubin,4558,7,7,5,8,23,17,6,26
Din Moscow,4558,8,5,6,9,17,26,-9,21
Amkar,4558,9,5,5,10,13,24,-11,20
Rostov,4558,10,4,6,10,11,20,-9,18
Anzhi,4558,11,3,5,12,16,39,-23,14
Loko Moscow,4559,1,12,6,2,35,13,22,42
Spart Moscow,4559,2,10,6,4,41,28,13,36
CSKA Moscow,4559,3,11,3,6,28,18,10,36
Zenit,4559,4,8,8,4,23,18,5,32
Krasnodar,4559,5,8,5,7,28,27,1,29
Terek Grozny,4559,6,7,6,7,22,25,-3,27
FK Rubin,4559,7,7,5,8,25,18,7,26
Din Moscow,4559,8,5,6,9,18,24,-6,21
Rostov,4559,9,4,6,10,11,22,-11,18
Amkar,4559,10,4,6,10,12,25,-13,18
Anzhi,4559,11,3,5,12,16,41,-25,14
Loko Moscow,4560,1,12,6,2,32,13,19,42
CSKA Moscow,4560,2,12,3,5,31,17,14,39
Spart Moscow,4560,3,11,5,4,40,28,12,38
Krasnodar,4560,4,9,5,6,31,26,5,32
Terek Grozny,4560,5,9,5,6,23,22,1,32
Zenit,4560,6,7,8,5,21,15,6,29
Din Moscow,4560,7,5,7,8,18,23,-5,22
FK Rubin,4560,8,5,6,9,21,19,2,21
Rostov,4560,9,4,6,10,10,19,-9,18
Amkar,4560,10,4,4,12,11,27,-16,16
Anzhi,4560,11,2,5,13,14,43,-29,11
Loko Moscow,4561,1,11,6,3,31,15,16,39
CSKA Moscow,4561,2,12,3,5,29,19,10,39
Spart Moscow,4561,3,9,6,5,38,29,9,33
Zenit,4561,4,8,8,4,25,16,9,32
Terek Grozny,4561,5,8,6,6,23,24,-1,30
Krasnodar,4561,6,8,5,7,28,27,1,29
Din Moscow,4561,7,6,6,8,18,23,-5,24
FK Rubin,4561,8,6,5,9,23,18,5,23
Amkar,4561,9,5,5,10,12,24,-12,20
Rostov,4561,10,4,7,9,12,19,-7,19
Anzhi,4561,11,2,5,13,16,41,-25,11
Loko Moscow,4562,1,12,5,3,32,13,19,41
CSKA Moscow,4562,2,11,4,5,29,18,11,37
Spart Moscow,4562,3,10,6,4,40,29,11,36
Zenit,4562,4,8,9,3,23,14,9,33
Terek Grozny,4562,5,8,5,7,23,24,-1,29
Krasnodar,4562,6,8,4,8,27,29,-2,28
FK Rubin,4562,7,6,6,8,25,18,7,24
Din Moscow,4562,8,5,7,8,21,26,-5,22
Rostov,4562,9,4,7,9,11,18,-7,19
Amkar,4562,10,5,4,11,10,24,-14,19
Anzhi,4562,11,2,5,13,16,44,-28,11
Loko Moscow,4563,1,11,6,3,30,13,17,39
Zenit,4563,2,9,8,3,24,14,10,35
Spart Moscow,4563,3,10,5,5,37,28,9,35
CSKA Moscow,4563,4,10,4,6,27,20,7,34
Krasnodar,4563,5,8,5,7,30,28,2,29
Din Moscow,4563,6,7,6,7,19,21,-2,27
Terek Grozny,4563,7,7,5,8,22,28,-6,26
FK Rubin,4563,8,6,5,9,24,20,4,23
Amkar,4563,9,5,4,11,13,25,-12,19
Rostov,4563,10,4,6,10,11,19,-8,18
Anzhi,4563,11,3,6,11,18,39,-21,15
Loko Moscow,4564,1,12,6,2,31,11,20,42
CSKA Moscow,4564,2,12,3,5,28,18,10,39
Spart Moscow,4564,3,9,7,4,36,26,10,34
Zenit,4564,4,7,9,4,21,14,7,30
Krasnodar,4564,5,8,4,8,27,28,-1,28
Terek Grozny,4564,6,7,5,8,20,24,-4,26
FK Rubin,4564,7,6,6,8,24,18,6,24
Din Moscow,4564,8,5,7,8,18,24,-6,22
Amkar,4564,9,5,5,10,10,22,-12,20
Rostov,4564,10,4,7,9,11,18,-7,19
Anzhi,4564,11,3,5,12,16,39,-23,14
Loko Moscow,4565,1,11,6,3,30,13,17,39
Spart Moscow,4565,2,10,5,5,35,26,9,35
CSKA Moscow,4565,3,10,5,5,26,18,8,35
Krasnodar,4565,4,9,5,6,28,24,4,32
Zenit,4565,5,7,10,3,22,14,8,31
Terek Grozny,4565,6,8,5,7,21,23,-2,29
Din Moscow,4565,7,6,6,8,18,22,-4,24
FK Rubin,4565,8,5,6,9,21,18,3,21
Amkar,4565,9,5,4,11,10,23,-13,19
Rostov,4565,10,4,6,10,10,18,-8,18
Anzhi,4565,11,3,6,11,16,38,-22,15
Loko Moscow,4566,1,12,5,3,32,13,19,41
CSKA Moscow,4566,2,10,4,6,26,20,6,34
Krasnodar,4566,3,10,4,6,31,26,5,34
Spart Moscow,4566,4,9,6,5,40,31,9,33
Zenit,4566,5,8,8,4,23,15,8,32
Terek Grozny,4566,6,7,7,6,21,23,-2,28
Din Moscow,4566,7,7,6,7,22,21,1,27
FK Rubin,4566,8,5,5,10,22,21,1,20
Rostov,4566,9,4,6,10,11,22,-11,18
Amkar,4566,10,4,6,10,11,24,-13,18
Anzhi,4566,11,2,7,11,16,39,-23,13
Loko Moscow,4567,1,12,6,2,31,11,20,42
CSKA Moscow,4567,2,12,3,5,29,19,10,39
Spart Moscow,4567,3,9,6,5,35,26,9,33
Krasnodar,4567,4,9,4,7,31,26,5,31
Zenit,4567,5,7,9,4,21,14,7,30
Terek Grozny,4567,6,8,5,7,22,24,-2,29
Din Moscow,4567,7,5,8,7,18,22,-4,23
FK Rubin,4567,8,5,6,9,22,22,0,21
Rostov,4567,9,5,6,9,11,17,-6,21
Amkar,4567,10,5,4,11,10,24,-14,19
Anzhi,4567,11,2,5,13,17,42,-25,11
Loko Moscow,4568,1,12,5,3,31,15,16,41
CSKA Moscow,4568,2,11,3,6,28,20,8,36
Spart Moscow,4568,3,9,6,5,36,29,7,33
Zenit,4568,4,8,8,4,25,16,9,32
Krasnodar,4568,5,9,5,6,32,26,6,32
Terek Grozny,4568,6,8,5,7,22,24,-2,29
FK Rubin,4568,7,6,6,8,26,21,5,24
Din Moscow,4568,8,5,7,8,21,26,-5,22
Rostov,4568,9,5,6,9,12,17,-5,21
Amkar,4568,10,5,4,11,10,23,-13,19
Anzhi,4568,11,2,5,13,15,41,-26,11
Loko Moscow,4569,1,13,5,2,33,13,20,44
CSKA Moscow,4569,2,11,4,5,27,17,10,37
Spart Moscow,4569,3,9,6,5,35,27,8,33
Krasnodar,4569,4,9,4,7,31,27,4,31
Zenit,4569,5,7,9,4,22,15,7,30
Terek Grozny,4569,6,7,7,6,23,25,-2,28
Din Moscow,4569,7,6,7,7,19,21,-2,25
FK Rubin,4569,8,5,5,10,22,22,0,20
Amkar,4569,9,5,5,10,13,24,-11,20
Rostov,4569,10,4,6,10,10,19,-9,18
Anzhi,4569,11,2,6,12,15,40,-25,12
Loko Moscow,4570,1,13,5,2,35,12,23,44
CSKA Moscow,4570,2,11,3,6,26,18,8,36
Spart Moscow,4570,3,9,6,5,38,27,11,33
Krasnodar,4570,4,9,4,7,29,28,1,31
Zenit,4570,5,7,8,5,21,16,5,29
Terek Grozny,4570,6,8,5,7,21,30,-9,29
Din Moscow,4570,7,6,6,8,18,25,-7,24
Rostov,4570,8,5,6,9,11,17,-6,21
FK Rubin,4570,9,5,5,10,21,19,2,20
Anzhi,4570,10,4,5,11,23,37,-14,17
Amkar,4570,11,4,5,11,10,24,-14,17
Loko Moscow,4571,1,12,5,3,32,16,16,41
CSKA Moscow,4571,2,11,4,5,28,19,9,37
Krasnodar,4571,3,10,4,6,32,24,8,34
Spart Moscow,4571,4,9,5,6,35,29,6,32
Zenit,4571,5,7,8,5,22,17,5,29
Terek Grozny,4571,6,7,6,7,21,24,-3,27
Din Moscow,4571,7,6,6,8,20,24,-4,24
FK Rubin,4571,8,6,5,9,23,19,4,23
Amkar,4571,9,5,5,10,11,22,-11,20
Rostov,4571,10,4,6,10,10,18,-8,18
Anzhi,4571,11,3,6,11,18,40,-22,15
Loko Moscow,4572,1,13,5,2,32,12,20,44
CSKA Moscow,4572,2,11,3,6,30,18,12,36
Spart Moscow,4572,3,9,7,4,36,26,10,34
Zenit,4572,4,8,8,4,22,14,8,32
Krasnodar,4572,5,9,4,7,29,26,3,31
Terek Grozny,4572,6,8,5,7,22,23,-1,29
Din Moscow,4572,7,5,7,8,19,25,-6,22
FK Rubin,4572,8,5,6,9,22,19,3,21
Amkar,4572,9,5,5,10,10,22,-12,20
Rostov,4572,10,4,7,9,10,17,-7,19
Anzhi,4572,11,2,5,13,14,44,-30,11
Loko Moscow,4573,1,12,6,2,34,12,22,42
CSKA Moscow,4573,2,10,4,6,28,21,7,34
Zenit,4573,3,8,9,3,25,16,9,33
Spart Moscow,4573,4,8,6,6,36,31,5,30
Krasnodar,4573,5,8,5,7,29,30,-1,29
Terek Grozny,4573,6,7,6,7,20,24,-4,27
Din Moscow,4573,7,6,7,7,21,23,-2,25
Amkar,4573,8,6,4,10,14,23,-9,22
FK Rubin,4573,9,5,6,9,24,22,2,21
Rostov,4573,10,5,6,9,12,18,-6,21
Anzhi,4573,11,2,7,11,15,38,-23,13
Loko Moscow,4574,1,12,6,2,30,11,19,42
CSKA Moscow,4574,2,11,4,5,28,19,9,37
Spart Moscow,4574,3,10,5,5,36,27,9,35
Krasnodar,4574,4,8,6,6,27,24,3,30
Zenit,4574,5,7,8,5,22,16,6,29
Terek Grozny,4574,6,7,5,8,20,24,-4,26
FK Rubin,4574,7,6,6,8,22,17,5,24
Amkar,4574,8,6,4,10,11,22,-11,22
Din Moscow,4574,9,5,6,9,18,24,-6,21
Rostov,4574,10,4,6,10,10,18,-8,18
Anzhi,4574,11,3,6,11,16,38,-22,15
Loko Moscow,4575,1,12,5,3,33,15,18,41
Spart Moscow,4575,2,11,5,4,47,27,20,38
CSKA Moscow,4575,3,11,3,6,27,19,8,36
Krasnodar,4575,4,10,4,6,34,27,7,34
Zenit,4575,5,8,8,4,23,16,7,32
Terek Grozny,4575,6,7,7,6,20,22,-2,28
Din Moscow,4575,7,6,6,8,19,28,-9,24
FK Rubin,4575,8,5,5,10,22,22,0,20
Rostov,4575,9,4,6,10,12,20,-8,18
Amkar,4575,10,4,5,11,9,26,-17,17
Anzhi,4575,11,2,6,12,14,38,-24,12
Loko Moscow,4576,1,12,5,3,33,14,19,41
CSKA Moscow,4576,2,11,3,6,30,22,8,36
Spart Moscow,4576,3,9,6,5,35,28,7,33
Zenit,4576,4,8,8,4,25,15,10,32
Krasnodar,4576,5,9,5,6,30,26,4,32
Terek Grozny,4576,6,8,5,7,21,24,-3,29
Din Moscow,4576,7,6,7,7,20,21,-1,25
FK Rubin,4576,8,5,6,9,21,20,1,21
Amkar,4576,9,5,4,11,12,23,-11,19
Rostov,4576,10,4,6,10,10,19,-9,18
Anzhi,4576,11,3,5,12,17,42,-25,14
Loko Moscow,4577,1,11,5,4,30,14,16,38
CSKA Moscow,4577,2,11,4,5,28,17,11,37
Krasnodar,4577,3,10,4,6,35,27,8,34
Zenit,4577,4,8,9,3,22,13,9,33
Spart Moscow,4577,5,9,5,6,36,31,5,32
Terek Grozny,4577,6,8,6,6,22,23,-1,30
Din Moscow,4577,7,7,6,7,19,21,-2,27
FK Rubin,4577,8,5,5,10,23,24,-1,20
Amkar,4577,9,5,4,11,14,23,-9,19
Rostov,4577,10,4,6,10,10,20,-10,18
Anzhi,4577,11,2,6,12,15,41,-26,12
Loko Moscow,4578,1,13,5,2,37,13,24,44
Spart Moscow,4578,2,10,6,4,36,26,10,36
CSKA Moscow,4578,3,11,3,6,28,19,9,36
Krasnodar,4578,4,9,4,7,31,27,4,31
Zenit,4578,5,7,8,5,21,20,1,29
Terek Grozny,4578,6,7,5,8,21,25,-4,26
Din Moscow,4578,7,6,6,8,19,23,-4,24
FK Rubin,4578,8,5,5,10,22,21,1,20
Rostov,4578,9,4,7,9,11,18,-7,19
Amkar,4578,10,5,4,11,10,23,-13,19
Anzhi,4578,11,4,5,11,18,39,-21,17
Loko Moscow,4579,1,13,5,2,32,11,21,44
Spart Moscow,4579,2,9,7,4,36,27,9,34
CSKA Moscow,4579,3,10,4,6,26,20,6,34
Terek Grozny,4579,4,9,5,6,26,24,2,32
Krasnodar,4579,5,9,4,7,28,25,3,31
Zenit,4579,6,7,9,4,22,16,6,30
Din Moscow,4579,7,6,7,7,21,23,-2,25
FK Rubin,4579,8,5,5,10,22,21,1,20
Rostov,4579,9,4,7,9,11,18,-7,19
Amkar,4579,10,4,4,12,9,26,-17,16
Anzhi,4579,11,3,5,12,18,40,-22,14
Loko Moscow,4580,1,13,5,2,34,13,21,44
CSKA Moscow,4580,2,12,3,5,32,17,15,39
Spart Moscow,4580,3,9,5,6,36,28,8,32
Terek Grozny,4580,4,9,5,6,24,24,0,32
Zenit,4580,5,7,8,5,22,18,4,29
Krasnodar,4580,6,8,5,7,29,27,2,29
Din Moscow,4580,7,6,7,7,19,22,-3,25
FK Rubin,4580,8,5,7,8,22,18,4,22
Rostov,4580,9,5,6,9,11,17,-6,21
Amkar,4580,10,4,4,12,9,25,-16,16
Anzhi,4580,11,2,5,13,16,45,-29,11
Loko Moscow,4581,1,11,6,3,30,13,17,39
CSKA Moscow,4581,2,11,4,5,27,18,9,37
Spart Moscow,4581,3,10,5,5,39,27,12,35
Krasnodar,4581,4,10,4,6,31,25,6,34
Zenit,4581,5,7,9,4,21,14,7,30
Terek Grozny,4581,6,8,5,7,23,24,-1,29
FK Rubin,4581,7,6,5,9,22,19,3,23
Din Moscow,4581,8,5,6,9,18,26,-8,21
Amkar,4581,9,5,4,11,10,25,-15,19
Rostov,4581,10,4,6,10,10,19,-9,18
Anzhi,4581,11,3,6,11,17,38,-21,15
Loko Moscow,4582,1,12,6,2,32,12,20,42
CSKA Moscow,4582,2,12,3,5,28,17,11,39
Spart Moscow,4582,3,9,6,5,36,27,9,33
Zenit,4582,4,7,8,5,21,16,5,29
Krasnodar,4582,5,8,5,7,28,26,2,29
Terek Grozny,4582,6,7,5,8,23,27,-4,26
Din Moscow,4582,7,6,7,7,19,22,-3,25
FK Rubin,4582,8,6,5,9,22,18,4,23
Rostov,4582,9,5,6,9,11,17,-6,21
Amkar,4582,10,5,4,11,12,26,-14,19
Anzhi,4582,11,3,5,12,16,40,-24,14
Loko Moscow,4583,1,11,6,3,32,15,17,39
CSKA Moscow,4583,2,12,3,5,28,17,11,39
Zenit,4583,3,8,8,4,24,17,7,32
Terek Grozny,4583,4,8,6,6,25,25,0,30
Spart Moscow,4583,5,8,5,7,34,31,3,29
Krasnodar,4583,6,8,5,7,28,26,2,29
Din Moscow,4583,7,6,7,7,20,22,-2,25
FK Rubin,4583,8,6,6,8,23,18,5,24
Rostov,4583,9,5,6,9,12,17,-5,21
Amkar,4583,10,5,4,11,13,27,-14,19
Anzhi,4583,11,2,6,12,15,39,-24,12
Loko Moscow,4584,1,11,6,3,30,14,16,39
CSKA Moscow,4584,2,11,4,5,28,18,10,37
Spart Moscow,4584,3,10,6,4,39,26,13,36
Zenit,4584,4,7,10,3,22,14,8,31
Krasnodar,4584,5,9,4,7,29,25,4,31
Terek Grozny,4584,6,8,6,6,23,23,0,30
Din Moscow,4584,7,6,6,8,20,24,-4,24
FK Rubin,4584,8,6,5,9,23,20,3,23
Rostov,4584,9,4,7,9,11,18,-7,19
Amkar,4584,10,4,5,11,9,25,-16,17
Anzhi,4584,11,2,5,13,16,43,-27,11
Loko Moscow,4585,1,13,5,2,36,13,23,44
CSKA Moscow,4585,2,10,4,6,25,19,6,34
Spart Moscow,4585,3,9,5,6,35,28,7,32
Zenit,4585,4,7,9,4,22,16,6,30
Terek Grozny,4585,5,8,6,6,21,22,-1,30
Krasnodar,4585,6,8,4,8,30,31,-1,28
Din Moscow,4585,7,7,6,7,19,21,-2,27
FK Rubin,4585,8,6,5,9,24,20,4,23
Amkar,4585,9,5,5,10,10,22,-12,20
Rostov,4585,10,4,6,10,11,19,-8,18
Anzhi,4585,11,3,5,12,16,38,-22,14
Loko Moscow,4586,1,12,6,2,35,14,21,42
CSKA Moscow,4586,2,11,4,5,31,20,11,37
Spart Moscow,4586,3,10,5,5,39,30,9,35
Terek Grozny,4586,4,9,5,6,25,23,2,32
Zenit,4586,5,7,10,3,26,18,8,31
Krasnodar,4586,6,8,5,7,27,27,0,29
FK Rubin,4586,7,5,7,8,21,17,4,22
Din Moscow,4586,8,5,7,8,19,24,-5,22
Amkar,4586,9,5,4,11,12,24,-12,19
Rostov,4586,10,4,6,10,11,20,-9,18
Anzhi,4586,11,2,5,13,15,44,-29,11
Loko Moscow,4587,1,11,5,4,30,17,13,38
CSKA Moscow,4587,2,11,3,6,28,19,9,36
Zenit,4587,3,9,8,3,25,14,11,35
Krasnodar,4587,4,10,4,6,33,26,7,34
Spart Moscow,4587,5,9,6,5,39,33,6,33
Terek Grozny,4587,6,8,5,7,24,24,0,29
Din Moscow,4587,7,6,7,7,21,22,-1,25
FK Rubin,4587,8,5,6,9,22,19,3,21
Rostov,4587,9,4,7,9,12,19,-7,19
Amkar,4587,10,5,4,11,13,26,-13,19
Anzhi,4587,11,2,5,13,14,42,-28,11
Loko Moscow,4588,1,11,6,3,31,14,17,39
Spart Moscow,4588,2,10,6,4,38,27,11,36
CSKA Moscow,4588,3,10,5,5,27,19,8,35
Zenit,4588,4,8,9,3,23,14,9,33
Krasnodar,4588,5,8,5,7,28,26,2,29
FK Rubin,4588,6,7,5,8,23,17,6,26
Terek Grozny,4588,7,7,5,8,22,26,-4,26
Din Moscow,4588,8,5,7,8,18,23,-5,22
Amkar,4588,9,5,4,11,13,26,-13,19
Rostov,4588,10,4,6,10,10,19,-9,18
Anzhi,4588,11,3,6,11,17,39,-22,15
Loko Moscow,4589,1,11,6,3,29,12,17,39
Spart Moscow,4589,2,10,6,4,38,25,13,36
CSKA Moscow,4589,3,11,3,6,26,19,7,36
Zenit,4589,4,8,8,4,22,14,8,32
Krasnodar,4589,5,9,5,6,28,24,4,32
Terek Grozny,4589,6,7,7,6,22,24,-2,28
Din Moscow,4589,7,5,7,8,19,27,-8,22
FK Rubin,4589,8,5,6,9,23,20,3,21
Rostov,4589,9,4,6,10,10,18,-8,18
Amkar,4589,10,4,6,10,10,23,-13,18
Anzhi,4589,11,3,6,11,17,38,-21,15
Loko Moscow,4590,1,11,6,3,30,15,15,39
Spart Moscow,4590,2,9,7,4,36,27,9,34
CSKA Moscow,4590,3,10,4,6,27,20,7,34
Zenit,4590,4,8,9,3,24,15,9,33
Krasnodar,4590,5,9,4,7,31,27,4,31
Terek Grozny,4590,6,7,6,7,21,24,-3,27
FK Rubin,4590,7,7,5,8,25,18,7,26
Din Moscow,4590,8,5,7,8,18,23,-5,22
Amkar,4590,9,5,5,10,11,23,-12,20
Rostov,4590,10,4,6,10,10,18,-8,18
Anzhi,4590,11,2,7,11,16,39,-23,13
Loko Moscow,4591,1,11,5,4,30,14,16,38
Zenit,4591,2,9,8,3,23,13,10,35
CSKA Moscow,4591,3,10,4,6,26,19,7,34
Spart Moscow,4591,4,9,5,6,38,32,6,32
Krasnodar,4591,5,9,5,6,30,26,4,32
Terek Grozny,4591,6,8,6,6,23,24,-1,30
FK Rubin,4591,7,6,6,8,24,18,6,24
Rostov,4591,8,5,6,9,11,17,-6,21
Din Moscow,4591,9,5,6,9,20,27,-7,21
Amkar,4591,10,5,5,10,13,24,-11,20
Anzhi,4591,11,2,6,12,16,40,-24,12
Loko Moscow,4592,1,12,5,3,33,15,18,41
CSKA Moscow,4592,2,12,3,5,33,19,14,39
Spart Moscow,4592,3,9,6,5,35,27,8,33
Krasnodar,4592,4,9,4,7,30,27,3,31
Terek Grozny,4592,5,8,6,6,23,22,1,30
Zenit,4592,6,7,8,5,25,19,6,29
FK Rubin,4592,7,7,5,8,25,19,6,26
Din Moscow,4592,8,6,6,8,20,23,-3,24
Rostov,4592,9,4,6,10,10,19,-9,18
Amkar,4592,10,4,6,10,9,22,-13,18
Anzhi,4592,11,2,5,13,14,45,-31,11
Loko Moscow,4593,1,12,5,3,30,12,18,41
Krasnodar,4593,2,10,4,6,29,24,5,34
Spart Moscow,4593,3,9,6,5,35,28,7,33
CSKA Moscow,4593,4,10,3,7,28,23,5,33
Zenit,4593,5,8,8,4,24,16,8,32
Terek Grozny,4593,6,9,5,6,25,22,3,32
Din Moscow,4593,7,6,6,8,20,23,-3,24
FK Rubin,4593,8,6,5,9,23,19,4,23
Rostov,4593,9,4,6,10,10,18,-8,18
Amkar,4593,10,4,5,11,10,24,-14,17
Anzhi,4593,11,3,5,12,17,42,-25,14
Loko Moscow,4594,1,12,6,2,31,12,19,42
Spart Moscow,4594,2,10,6,4,39,27,12,36
CSKA Moscow,4594,3,10,3,7,30,24,6,33
Zenit,4594,4,8,8,4,23,15,8,32
Krasnodar,4594,5,9,5,6,30,26,4,32
Terek Grozny,4594,6,7,6,7,20,24,-4,27
Din Moscow,4594,7,5,8,7,17,21,-4,23
FK Rubin,4594,8,5,6,9,22,19,3,21
Rostov,4594,9,4,6,10,10,18,-8,18
Amkar,4594,10,4,5,11,11,27,-16,17
Anzhi,4594,11,4,5,11,21,41,-20,17
Loko Moscow,4595,1,12,5,3,31,13,18,41
CSKA Moscow,4595,2,11,4,5,27,18,9,37
Zenit,4595,3,8,9,3,23,13,10,33
Spart Moscow,4595,4,9,5,6,35,35,0,32
Krasnodar,4595,5,8,4,8,27,27,0,28
Terek Grozny,4595,6,7,6,7,21,24,-3,27
Din Moscow,4595,7,6,7,7,21,22,-1,25
FK Rubin,4595,8,6,6,8,23,18,5,24
Amkar,4595,9,5,5,10,15,22,-7,20
Rostov,4595,10,4,6,10,11,19,-8,18
Anzhi,4595,11,3,5,12,17,40,-23,14
Loko Moscow,4596,1,11,7,2,30,12,18,40
CSKA Moscow,4596,2,11,3,6,28,18,10,36
Spart Moscow,4596,3,10,5,5,38,29,9,35
Zenit,4596,4,8,9,3,23,14,9,33
Krasnodar,4596,5,8,6,6,27,24,3,30
Terek Grozny,4596,6,7,7,6,23,25,-2,28
FK Rubin,4596,7,5,7,8,21,17,4,22
Din Moscow,4596,8,5,7,8,18,23,-5,22
Rostov,4596,9,5,6,9,12,18,-6,21
Amkar,4596,10,4,5,11,12,26,-14,17
Anzhi,4596,11,2,6,12,15,41,-26,12
Loko Moscow,4597,1,12,6,2,30,11,19,42
CSKA Moscow,4597,2,11,4,5,28,18,10,37
Terek Grozny,4597,3,9,5,6,24,22,2,32
Zenit,4597,4,7,9,4,21,14,7,30
Spart Moscow,4597,5,8,6,6,35,29,6,30
Krasnodar,4597,6,8,6,6,27,24,3,30
FK Rubin,4597,7,6,6,8,25,19,6,24
Din Moscow,4597,8,6,6,8,20,25,-5,24
Rostov,4597,9,5,6,9,12,18,-6,21
Amkar,4597,10,4,5,11,10,24,-14,17
Anzhi,4597,11,2,5,13,15,43,-28,11
Loko Moscow,4598,1,13,5,2,33,13,20,44
CSKA Moscow,4598,2,11,3,6,26,18,8,36
Spart Moscow,4598,3,10,5,5,36,27,9,35
Zenit,4598,4,7,8,5,22,16,6,29
Krasnodar,4598,5,8,5,7,28,26,2,29
Terek Grozny,4598,6,7,5,8,23,28,-5,26
FK Rubin,4598,7,6,6,8,25,18,7,24
Amkar,4598,8,6,4,10,13,24,-11,22
Din Moscow,4598,9,5,6,9,18,26,-8,21
Rostov,4598,10,4,6,10,11,19,-8,18
Anzhi,4598,11,4,5,11,18,38,-20,17
Loko Moscow,4599,1,13,5,2,32,12,20,44
Spart Moscow,4599,2,9,7,4,38,28,10,34
CSKA Moscow,4599,3,10,4,6,27,21,6,34
Zenit,4599,4,8,8,4,24,15,9,32
Terek Grozny,4599,5,8,6,6,21,22,-1,30
Krasnodar,4599,6,8,5,7,28,26,2,29
Din Moscow,4599,7,6,6,8,18,23,-5,24
FK Rubin,4599,8,5,6,9,22,19,3,21
Rostov,4599,9,4,7,9,11,18,-7,19
Amkar,4599,10,4,6,10,11,24,-13,18
Anzhi,4599,11,2,6,12,16,40,-24,12
Loko Moscow,4600,1,11,5,4,31,15,16,38
CSKA Moscow,4600,2,11,3,6,27,22,5,36
Zenit,4600,3,9,8,3,28,14,14,35
Krasnodar,4600,4,10,4,6,30,25,5,34
Terek Grozny,4600,5,9,5,6,26,25,1,32
Spart Moscow,4600,6,8,7,5,35,30,5,31
FK Rubin,4600,7,6,5,9,22,18,4,23
Din Moscow,4600,8,5,7,8,18,23,-5,22
Rostov,4600,9,4,7,9,11,18,-7,19
Amkar,4600,10,5,4,11,15,26,-11,19
Anzhi,4600,11,2,5,13,14,41,-27,11
Loko Moscow,4601,1,11,6,3,31,14,17,39
CSKA Moscow,4601,2,11,4,5,26,17,9,37
Krasnodar,4601,3,10,4,6,33,26,7,34
Spart Moscow,4601,4,9,6,5,37,28,9,33
Zenit,4601,5,7,9,4,21,14,7,30
Terek Grozny,4601,6,8,5,7,24,25,-1,29
Din Moscow,4601,7,6,7,7,19,21,-2,25
FK Rubin,4601,8,5,6,9,21,20,1,21
Amkar,4601,9,5,5,10,12,24,-12,20
Rostov,4601,10,4,6,10,10,20,-10,18
Anzhi,4601,11,2,6,12,15,40,-25,12
Loko Moscow,4602,1,11,7,2,30,12,18,40
CSKA Moscow,4602,2,12,3,5,30,18,12,39
Krasnodar,4602,3,9,5,6,32,26,6,32
Spart Moscow,4602,4,8,7,5,34,27,7,31
Zenit,4602,5,7,9,4,21,14,7,30
Terek Grozny,4602,6,7,6,7,23,26,-3,27
Din Moscow,4602,7,6,7,7,19,22,-3,25
FK Rubin,4602,8,5,6,9,23,22,1,21
Rostov,4602,9,4,7,9,10,17,-7,19
Amkar,4602,10,4,6,10,11,24,-13,18
Anzhi,4602,11,3,5,12,18,43,-25,14
Loko Moscow,4603,1,12,6,2,32,12,20,42
Spart Moscow,4603,2,11,5,4,39,26,13,38
CSKA Moscow,4603,3,10,3,7,26,21,5,33
Zenit,4603,4,8,8,4,23,16,7,32
Krasnodar,4603,5,9,5,6,29,25,4,32
Terek Grozny,4603,6,8,6,6,22,23,-1,30
FK Rubin,4603,7,6,5,9,24,19,5,23
Din Moscow,4603,8,5,6,9,18,26,-8,21
Rostov,4603,9,4,6,10,11,20,-9,18
Amkar,4603,10,4,5,11,9,23,-14,17
Anzhi,4603,11,3,5,12,17,39,-22,14
Loko Moscow,4604,1,11,5,4,30,15,15,38
CSKA Moscow,4604,2,11,4,5,28,18,10,37
Krasnodar,4604,3,10,4,6,32,26,6,34
Zenit,4604,4,8,8,4,24,16,8,32
Terek Grozny,4604,5,9,5,6,24,22,2,32
Spart Moscow,4604,6,8,7,5,37,30,7,31
Din Moscow,4604,7,5,8,7,19,23,-4,23
FK Rubin,4604,8,5,6,9,22,20,2,21
Rostov,4604,9,5,6,9,12,18,-6,21
Amkar,4604,10,4,5,11,10,25,-15,17
Anzhi,4604,11,2,6,12,14,39,-25,12
Loko Moscow,4605,1,12,5,3,32,14,18,41
CSKA Moscow,4605,2,12,3,5,30,20,10,39
Spart Moscow,4605,3,11,5,4,40,25,15,38
Krasnodar,4605,4,10,4,6,30,25,5,34
Terek Grozny,4605,5,9,5,6,25,24,1,32
Zenit,4605,6,7,8,5,23,17,6,29
FK Rubin,4605,7,6,5,9,23,18,5,23
Din Moscow,4605,8,5,6,9,17,26,-9,21
Rostov,4605,9,4,6,10,10,19,-9,18
Amkar,4605,10,4,4,12,10,26,-16,16
Anzhi,4605,11,2,5,13,17,43,-26,11
Loko Moscow,4606,1,12,6,2,30,11,19,42
Spart Moscow,4606,2,10,6,4,40,25,15,36
CSKA Moscow,4606,3,11,3,6,28,21,7,36
Zenit,4606,4,8,9,3,24,13,11,33
Krasnodar,4606,5,8,5,7,28,26,2,29
Terek Grozny,4606,6,7,7,6,22,24,-2,28
FK Rubin,4606,7,6,6,8,23,18,5,24
Din Moscow,4606,8,5,6,9,17,27,-10,21
Rostov,4606,9,4,6,10,10,19,-9,18
Amkar,4606,10,4,6,10,10,23,-13,18
Anzhi,4606,11,2,6,12,16,41,-25,12
Loko Moscow,4607,1,12,5,3,31,13,18,41
CSKA Moscow,4607,2,12,3,5,28,18,10,39
Zenit,4607,3,8,8,4,23,15,8,32
Spart Moscow,4607,4,8,7,5,36,29,7,31
Krasnodar,4607,5,9,4,7,28,25,3,31
Terek Grozny,4607,6,8,5,7,24,24,0,29
Din Moscow,4607,7,6,6,8,18,22,-4,24
FK Rubin,4607,8,6,5,9,22,18,4,23
Amkar,4607,9,5,5,10,12,24,-12,20
Rostov,4607,10,4,7,9,12,19,-7,19
Anzhi,4607,11,2,5,13,15,42,-27,11
Loko Moscow,4608,1,12,6,2,32,13,19,42
Spart Moscow,4608,2,11,5,4,39,27,12,38
CSKA Moscow,4608,3,11,3,6,30,20,10,36
Zenit,4608,4,8,8,4,24,16,8,32
Krasnodar,4608,5,9,5,6,30,25,5,32
Terek Grozny,4608,6,8,5,7,22,24,-2,29
FK Rubin,4608,7,6,5,9,23,19,4,23
Din Moscow,4608,8,5,6,9,17,25,-8,21
Rostov,4608,9,4,6,10,11,19,-8,18
Amkar,4608,10,4,4,12,10,25,-15,16
Anzhi,4608,11,3,5,12,17,42,-25,14
Loko Moscow,4609,1,11,6,3,31,15,16,39
CSKA Moscow,4609,2,11,3,6,27,23,4,36
Zenit,4609,3,8,9,3,28,14,14,33
Krasnodar,4609,4,9,5,6,31,26,5,32
Spart Moscow,4609,5,8,6,6,35,31,4,30
Terek Grozny,4609,6,8,5,7,21,24,-3,29
FK Rubin,4609,7,6,6,8,24,18,6,24
Din Moscow,4609,8,5,7,8,18,24,-6,22
Rostov,4609,9,5,6,9,12,17,-5,21
Amkar,4609,10,5,4,11,12,24,-12,19
Anzhi,4609,11,3,5,12,16,39,-23,14
Loko Moscow,4610,1,11,6,3,29,13,16,39
CSKA Moscow,4610,2,11,3,6,28,20,8,36
Spart Moscow,4610,3,10,5,5,40,27,13,35
Krasnodar,4610,4,10,4,6,31,25,6,34
Zenit,4610,5,8,9,3,24,13,11,33
Terek Grozny,4610,6,7,6,7,20,24,-4,27
Din Moscow,4610,7,6,6,8,20,24,-4,24
FK Rubin,4610,8,5,5,10,22,22,0,20
Amkar,4610,9,5,5,10,11,23,-12,20
Rostov,4610,10,4,6,10,10,20,-10,18
Anzhi,4610,11,3,5,12,16,40,-24,14
Loko Moscow,4611,1,12,6,2,32,12,20,42
CSKA Moscow,4611,2,11,4,5,31,19,12,37
Spart Moscow,4611,3,10,6,4,39,27,12,36
Zenit,4611,4,7,9,4,23,17,6,30
Krasnodar,4611,5,8,6,6,29,26,3,30
Terek Grozny,4611,6,8,6,6,22,23,-1,30
Din Moscow,4611,7,5,8,7,21,25,-4,23
FK Rubin,4611,8,5,7,8,25,21,4,22
Rostov,4611,9,4,6,10,10,19,-9,18
Amkar,4611,10,4,5,11,10,25,-15,17
Anzhi,4611,11,2,5,13,15,43,-28,11
Loko Moscow,4612,1,12,6,2,33,13,20,42
Spart Moscow,4612,2,9,7,4,37,28,9,34
CSKA Moscow,4612,3,10,4,6,29,22,7,34
Zenit,4612,4,8,9,3,26,17,9,33
Krasnodar,4612,5,9,4,7,30,28,2,31
Terek Grozny,4612,6,8,6,6,24,24,0,30
Din Moscow,4612,7,6,7,7,19,22,-3,25
FK Rubin,4612,8,5,5,10,22,20,2,20
Rostov,4612,9,4,6,10,11,19,-8,18
Amkar,4612,10,4,6,10,12,25,-13,18
Anzhi,4612,11,2,6,12,15,40,-25,12
Loko Moscow,4613,1,11,6,3,30,14,16,39
CSKA Moscow,4613,2,12,3,5,30,20,10,39
Spart Moscow,4613,3,10,5,5,38,28,10,35
Zenit,4613,4,8,8,4,24,15,9,32
Krasnodar,4613,5,8,6,6,28,25,3,30
Terek Grozny,4613,6,7,6,7,21,24,-3,27
FK Rubin,4613,7,5,7,8,22,18,4,22
Din Moscow,4613,8,5,7,8,19,26,-7,22
Amkar,4613,9,6,4,10,12,22,-10,22
Rostov,4613,10,4,6,10,10,18,-8,18
Anzhi,4613,11,2,6,12,17,41,-24,12
Loko Moscow,4614,1,13,5,2,31,11,20,44
CSKA Moscow,4614,2,11,3,6,28,20,8,36
Spart Moscow,4614,3,9,7,4,37,27,10,34
Zenit,4614,4,8,8,4,24,16,8,32
Krasnodar,4614,5,8,4,8,27,27,0,28
Terek Grozny,4614,6,7,6,7,21,24,-3,27
Din Moscow,4614,7,6,7,7,20,22,-2,25
FK Rubin,4614,8,6,5,9,23,19,4,23
Amkar,4614,9,5,5,10,11,23,-12,20
Rostov,4614,10,4,6,10,11,20,-9,18
Anzhi,4614,11,2,6,12,14,38,-24,12
Loko Moscow,4615,1,13,5,2,35,13,22,44
CSKA Moscow,4615,2,11,4,5,29,18,11,37
Spart Moscow,4615,3,9,5,6,34,27,7,32
Zenit,4615,4,7,9,4,23,16,7,30
Terek Grozny,4615,5,8,6,6,22,22,0,30
Krasnodar,4615,6,8,4,8,28,29,-1,28
Din Moscow,4615,7,7,6,7,20,22,-2,27
FK Rubin,4615,8,6,5,9,23,19,4,23
Amkar,4615,9,5,5,10,10,22,-12,20
Rostov,4615,10,4,6,10,10,18,-8,18
Anzhi,4615,11,2,5,13,14,42,-28,11
Loko Moscow,4616,1,13,5,2,33,12,21,44
CSKA Moscow,4616,2,11,3,6,28,21,7,36
Spart Moscow,4616,3,9,7,4,37,28,9,34
Zenit,4616,4,8,8,4,25,16,9,32
Krasnodar,4616,5,9,4,7,28,26,2,31
Terek Grozny,4616,6,7,7,6,23,25,-2,28
Din Moscow,4616,7,5,8,7,19,23,-4,23
FK Rubin,4616,8,5,6,9,21,18,3,21
Rostov,4616,9,4,6,10,10,18,-8,18
Amkar,4616,10,4,6,10,11,24,-13,18
Anzhi,4616,11,2,6,12,17,41,-24,12
Loko Moscow,4617,1,11,5,4,29,15,14,38
Spart Moscow,4617,2,11,5,4,39,27,12,38
CSKA Moscow,4617,3,11,3,6,27,20,7,36
Zenit,4617,4,9,8,3,24,13,11,35
Krasnodar,4617,5,10,4,6,33,24,9,34
Terek Grozny,4617,6,8,5,7,21,23,-2,29
Din Moscow,4617,7,5,7,8,18,23,-5,22
FK Rubin,4617,8,5,6,9,22,21,1,21
Amkar,4617,9,5,4,11,12,26,-14,19
Rostov,4617,10,4,6,10,10,18,-8,18
Anzhi,4617,11,2,5,13,15,40,-25,11
Loko Moscow,4618,1,11,6,3,32,15,17,39
CSKA Moscow,4618,2,11,4,5,26,17,9,37
Spart Moscow,4618,3,9,7,4,39,28,11,34
Zenit,4618,4,8,9,3,23,14,9,33
Krasnodar,4618,5,8,6,6,31,28,3,30
Terek Grozny,4618,6,8,6,6,24,25,-1,30
FK Rubin,4618,7,6,6,8,24,19,5,24
Din Moscow,4618,8,5,7,8,18,23,-5,22
Rostov,4618,9,4,6,10,11,21,-10,18
Amkar,4618,10,4,6,10,11,24,-13,18
Anzhi,4618,11,2,5,13,16,41,-25,11
Loko Moscow,4619,1,13,5,2,34,11,23,44
CSKA Moscow,4619,2,10,4,6,26,19,7,34
Spart Moscow,4619,3,9,6,5,36,28,8,33
Zenit,4619,4,8,8,4,23,16,7,32
Krasnodar,4619,5,8,5,7,28,28,0,29
Terek Grozny,4619,6,8,5,7,22,23,-1,29
Din Moscow,4619,7,7,6,7,20,22,-2,27
FK Rubin,4619,8,5,6,9,23,20,3,21
Rostov,4619,9,4,7,9,11,18,-7,19
Amkar,4619,10,5,4,11,11,24,-13,19
Anzhi,4619,11,2,6,12,14,39,-25,12
Loko Moscow,4620,1,12,5,3,32,14,18,41
CSKA Moscow,4620,2,12,3,5,30,17,13,39
Spart Moscow,4620,3,10,5,5,38,27,11,35
Krasnodar,4620,4,10,4,6,31,25,6,34
Terek Grozny,4620,5,8,6,6,22,23,-1,30
Zenit,4620,6,7,8,5,21,19,2,29
Din Moscow,4620,7,6,6,8,18,22,-4,24
FK Rubin,4620,8,6,5,9,22,18,4,23
Rostov,4620,9,4,6,10,11,20,-9,18
Amkar,4620,10,4,5,11,9,24,-15,17
Anzhi,4620,11,2,5,13,15,40,-25,11
Loko Moscow,4621,1,11,6,3,30,13,17,39
CSKA Moscow,4621,2,11,3,6,27,19,8,36
Krasnodar,4621,3,10,4,6,30,25,5,34
Zenit,4621,4,8,9,3,22,13,9,33
Spart Moscow,4621,5,8,6,6,34,30,4,30
Terek Grozny,4621,6,7,7,6,21,23,-2,28
Din Moscow,4621,7,7,6,7,21,21,0,27
Rostov,4621,8,5,6,9,12,18,-6,21
FK Rubin,4621,9,5,5,10,21,19,2,20
Amkar,4621,10,4,6,10,9,22,-13,18
Anzhi,4621,11,2,6,12,16,40,-24,12
Loko Moscow,4622,1,11,6,3,29,12,17,39
CSKA Moscow,4622,2,11,3,6,28,20,8,36
Zenit,4622,3,9,8,3,25,15,10,35
Spart Moscow,4622,4,9,5,6,37,29,8,32
Terek Grozny,4622,5,8,6,6,24,25,-1,30
Krasnodar,4622,6,8,5,7,29,28,1,29
FK Rubin,4622,7,7,5,8,27,19,8,26
Rostov,4622,8,5,6,9,11,17,-6,21
Din Moscow,4622,9,5,6,9,18,26,-8,21
Amkar,4622,10,5,4,11,12,25,-13,19
Anzhi,4622,11,2,6,12,16,40,-24,12
Loko Moscow,4623,1,12,6,2,31,12,19,42
Spart Moscow,4623,2,10,6,4,38,25,13,36
CSKA Moscow,4623,3,10,4,6,25,20,5,34
Zenit,4623,4,8,8,4,24,14,10,32
Krasnodar,4623,5,9,5,6,31,25,6,32
Terek Grozny,4623,6,8,6,6,22,22,0,30
Din Moscow,4623,7,5,7,8,19,25,-6,22
FK Rubin,4623,8,5,6,9,23,22,1,21
Rostov,4623,9,4,7,9,10,17,-7,19
Amkar,4623,10,4,5,11,9,25,-16,17
Anzhi,4623,11,2,6,12,14,39,-25,12
Loko Moscow,4624,1,13,5,2,34,11,23,44
Spart Moscow,4624,2,10,6,4,38,26,12,36
CSKA Moscow,4624,3,11,3,6,30,23,7,36
Zenit,4624,4,8,8,4,24,16,8,32
Krasnodar,4624,5,9,4,7,28,26,2,31
Terek Grozny,4624,6,7,5,8,20,24,-4,26
Din Moscow,4624,7,6,6,8,20,26,-6,24
FK Rubin,4624,8,5,5,10,23,21,2,20
Amkar,4624,9,5,5,10,11,23,-12,20
Rostov,4624,10,4,6,10,10,18,-8,18
Anzhi,4624,11,3,5,12,18,42,-24,14
Loko Moscow,4625,1,13,5,2,34,12,22,44
Spart Moscow,4625,2,10,5,5,43,34,9,35
CSKA Moscow,4625,3,10,3,7,25,24,1,33
Zenit,4625,4,8,8,4,25,16,9,32
Krasnodar,4625,5,9,4,7,29,26,3,31
Terek Grozny,4625,6,8,6,6,22,23,-1,30
Din Moscow,4625,7,6,6,8,22,25,-3,24
FK Rubin,4625,8,5,5,10,21,20,1,20
Amkar,4625,9,5,4,11,14,25,-11,19
Rostov,4625,10,4,6,10,11,21,-10,18
Anzhi,4625,11,3,6,11,18,38,-20,15
Loko Moscow,4626,1,11,6,3,31,14,17,39
Spart Moscow,4626,2,11,5,4,40,27,13,38
CSKA Moscow,4626,3,11,3,6,27,19,8,36
Zenit,4626,4,9,8,3,24,13,11,35
Krasnodar,4626,5,9,5,6,31,27,4,32
Terek Grozny,4626,6,7,5,8,22,26,-4,26
FK Rubin,4626,7,6,5,9,23,19,4,23
Din Moscow,4626,8,5,6,9,18,24,-6,21
Amkar,4626,9,5,4,11,12,26,-14,19
Rostov,4626,10,4,6,10,10,19,-9,18
Anzhi,4626,11,3,5,12,16,40,-24,14
Loko Moscow,4627,1,11,6,3,30,13,17,39
CSKA Moscow,4627,2,12,3,5,28,17,11,39
Zenit,4627,3,8,8,4,22,14,8,32
Spart Moscow,4627,4,8,6,6,35,30,5,30
Krasnodar,4627,5,8,6,6,29,26,3,30
Terek Grozny,4627,6,8,5,7,23,27,-4,29
Din Moscow,4627,7,6,7,7,21,23,-2,25
FK Rubin,4627,8,5,7,8,24,20,4,22
Amkar,4627,9,6,4,10,16,24,-8,22
Rostov,4627,10,4,7,9,10,17,-7,19
Anzhi,4627,11,2,5,13,15,42,-27,11
Loko Moscow,4628,1,11,5,4,30,14,16,38
Spart Moscow,4628,2,10,6,4,41,29,12,36
CSKA Moscow,4628,3,11,3,6,29,21,8,36
Zenit,4628,4,9,8,3,26,16,10,35
Krasnodar,4628,5,10,4,6,31,26,5,34
Terek Grozny,4628,6,7,6,7,20,23,-3,27
FK Rubin,4628,7,6,5,9,25,21,4,23
Din Moscow,4628,8,5,6,9,20,27,-7,21
Rostov,4628,9,4,7,9,11,18,-7,19
Amkar,4628,10,4,5,11,10,25,-15,17
Anzhi,4628,11,3,5,12,16,39,-23,14
Loko Moscow,4629,1,12,6,2,34,13,21,42
Spart Moscow,4629,2,11,5,4,38,25,13,38
CSKA Moscow,4629,3,11,4,5,28,18,10,37
Krasnodar,4629,4,9,5,6,31,25,6,32
Zenit,4629,5,7,9,4,23,18,5,30
Terek Grozny,4629,6,8,5,7,22,24,-2,29
FK Rubin,4629,7,6,5,9,23,21,2,23
Din Moscow,4629,8,5,6,9,18,24,-6,21
Amkar,4629,9,5,4,11,10,25,-15,19
Rostov,4629,10,4,6,10,10,18,-8,18
Anzhi,4629,11,2,5,13,15,41,-26,11
Loko Moscow,4630,1,11,6,3,30,13,17,39
Spart Moscow,4630,2,11,5,4,41,28,13,38
CSKA Moscow,4630,3,11,4,5,28,19,9,37
Krasnodar,4630,4,9,5,6,29,25,4,32
Zenit,4630,5,7,10,3,23,15,8,31
Terek Grozny,4630,6,8,6,6,24,24,0,30
FK Rubin,4630,7,6,6,8,23,18,5,24
Din Moscow,4630,8,5,6,9,19,25,-6,21
Rostov,4630,9,4,6,10,11,19,-8,18
Amkar,4630,10,4,4,12,10,28,-18,16
Anzhi,4630,11,2,6,12,16,40,-24,12
Loko Moscow,4631,1,11,5,4,29,16,13,38
Spart Moscow,4631,2,10,6,4,40,26,14,36
CSKA Moscow,4631,3,11,3,6,29,20,9,36
Zenit,4631,4,9,8,3,26,13,13,35
Krasnodar,4631,5,10,4,6,31,24,7,34
Terek Grozny,4631,6,7,6,7,20,24,-4,27
Din Moscow,4631,7,6,6,8,18,25,-7,24
FK Rubin,4631,8,5,5,10,21,19,2,20
Rostov,4631,9,4,7,9,11,18,-7,19
Amkar,4631,10,4,5,11,9,24,-15,17
Anzhi,4631,11,3,5,12,16,41,-25,14
Loko Moscow,4632,1,12,6,2,33,14,19,42
Spart Moscow,4632,2,10,5,5,42,29,13,35
CSKA Moscow,4632,3,10,4,6,28,21,7,34
Terek Grozny,4632,4,9,5,6,23,22,1,32
Zenit,4632,5,7,10,3,24,16,8,31
Krasnodar,4632,6,8,5,7,30,28,2,29
Din Moscow,4632,7,6,6,8,19,25,-6,24
FK Rubin,4632,8,5,6,9,22,20,2,21
Rostov,4632,9,5,6,9,12,18,-6,21
Amkar,4632,10,4,4,12,11,27,-16,16
Anzhi,4632,11,3,5,12,16,40,-24,14
Loko Moscow,4633,1,11,7,2,31,13,18,40
Spart Moscow,4633,2,10,6,4,41,26,15,36
CSKA Moscow,4633,3,11,3,6,26,19,7,36
Zenit,4633,4,8,9,3,24,14,10,33
Terek Grozny,4633,5,8,6,6,25,24,1,30
Krasnodar,4633,6,8,5,7,28,26,2,29
Din Moscow,4633,7,6,6,8,20,23,-3,24
FK Rubin,4633,8,6,5,9,22,20,2,23
Rostov,4633,9,4,6,10,11,23,-12,18
Amkar,4633,10,4,6,10,11,24,-13,18
Anzhi,4633,11,2,5,13,14,41,-27,11
Loko Moscow,4634,1,12,6,2,33,12,21,42
CSKA Moscow,4634,2,12,3,5,30,17,13,39
Spart Moscow,4634,3,10,6,4,38,27,11,36
Krasnodar,4634,4,9,4,7,32,29,3,31
Zenit,4634,5,7,9,4,21,15,6,30
Terek Grozny,4634,6,8,6,6,24,25,-1,30
Din Moscow,4634,7,6,7,7,20,23,-3,25
FK Rubin,4634,8,5,5,10,22,22,0,20
Rostov,4634,9,4,6,10,10,19,-9,18
Amkar,4634,10,4,4,12,11,26,-15,16
Anzhi,4634,11,2,6,12,15,41,-26,12
Loko Moscow,4635,1,12,5,3,31,13,18,41
CSKA Moscow,4635,2,12,3,5,29,17,12,39
Spart Moscow,4635,3,8,7,5,33,26,7,31
Krasnodar,4635,4,9,4,7,29,26,3,31
Zenit,4635,5,7,8,5,22,16,6,29
Terek Grozny,4635,6,7,7,6,20,22,-2,28
FK Rubin,4635,7,7,5,8,24,18,6,26
Din Moscow,4635,8,5,7,8,17,22,-5,22
Rostov,4635,9,5,6,9,11,17,-6,21
Amkar,4635,10,4,6,10,9,22,-13,18
Anzhi,4635,11,2,6,12,14,40,-26,12
Loko Moscow,4636,1,11,5,4,29,13,16,38
CSKA Moscow,4636,2,11,3,6,27,18,9,36
Spart Moscow,4636,3,10,5,5,38,28,10,35
Zenit,4636,4,9,8,3,23,13,10,35
Krasnodar,4636,5,10,4,6,29,24,5,34
Terek Grozny,4636,6,8,6,6,22,22,0,30
FK Rubin,4636,7,6,5,9,24,19,5,23
Rostov,4636,8,5,6,9,13,19,-6,21
Din Moscow,4636,9,5,6,9,18,25,-7,21
Amkar,4636,10,4,4,12,9,26,-17,16
Anzhi,4636,11,2,6,12,14,39,-25,12
Loko Moscow,4637,1,12,6,2,31,12,19,42
CSKA Moscow,4637,2,11,4,5,31,18,13,37
Spart Moscow,4637,3,9,6,5,36,28,8,33
Krasnodar,4637,4,9,5,6,30,26,4,32
Zenit,4637,5,7,9,4,22,15,7,30
Terek Grozny,4637,6,7,7,6,21,23,-2,28
Din Moscow,4637,7,6,7,7,18,21,-3,25
FK Rubin,4637,8,5,6,9,22,19,3,21
Rostov,4637,9,4,7,9,12,19,-7,19
Amkar,4637,10,4,5,11,10,24,-14,17
Anzhi,4637,11,2,6,12,14,42,-28,12
Loko Moscow,4638,1,11,6,3,30,14,16,39
Zenit,4638,2,9,8,3,27,14,13,35
CSKA Moscow,4638,3,10,4,6,26,21,5,34
Spart Moscow,4638,4,9,6,5,37,29,8,33
Krasnodar,4638,5,8,5,7,28,26,2,29
Terek Grozny,4638,6,8,5,7,23,23,0,29
FK Rubin,4638,7,7,5,8,23,17,6,26
Din Moscow,4638,8,5,7,8,17,22,-5,22
Amkar,4638,9,6,4,10,12,22,-10,22
Rostov,4638,10,4,6,10,12,21,-9,18
Anzhi,4638,11,2,6,12,14,40,-26,12
Loko Moscow,4639,1,12,6,2,34,14,20,42
Spart Moscow,4639,2,10,5,5,38,26,12,35
Zenit,4639,3,8,9,3,25,15,10,33
CSKA Moscow,4639,4,10,3,7,25,23,2,33
Krasnodar,4639,5,8,5,7,28,27,1,29
Terek Grozny,4639,6,8,5,7,23,24,-1,29
FK Rubin,4639,7,5,7,8,21,17,4,22
Din Moscow,4639,8,5,7,8,17,24,-7,22
Rostov,4639,9,5,6,9,11,17,-6,21
Amkar,4639,10,5,4,11,10,24,-14,19
Anzhi,4639,11,3,5,12,19,40,-21,14
Loko Moscow,4640,1,12,6,2,32,12,20,42
CSKA Moscow,4640,2,11,4,5,27,17,10,37
Spart Moscow,4640,3,9,6,5,38,30,8,33
Krasnodar,4640,4,9,5,6,31,25,6,32
Zenit,4640,5,7,9,4,21,15,6,30
Terek Grozny,4640,6,8,5,7,23,25,-2,29
Din Moscow,4640,7,6,7,7,19,22,-3,25
FK Rubin,4640,8,5,6,9,22,21,1,21
Rostov,4640,9,4,7,9,13,20,-7,19
Amkar,4640,10,5,4,11,12,25,-13,19
Anzhi,4640,11,2,5,13,15,41,-26,11
Loko Moscow,4641,1,13,5,2,34,12,22,44
CSKA Moscow,4641,2,11,3,6,28,23,5,36
Spart Moscow,4641,3,9,7,4,36,27,9,34
Zenit,4641,4,8,8,4,27,16,11,32
Krasnodar,4641,5,9,4,7,29,28,1,31
Terek Grozny,4641,6,7,7,6,21,23,-2,28
FK Rubin,4641,7,6,5,9,24,19,5,23
Din Moscow,4641,8,5,6,9,19,26,-7,21
Rostov,4641,9,4,7,9,10,17,-7,19
Amkar,4641,10,4,6,10,9,22,-13,18
Anzhi,4641,11,2,6,12,16,40,-24,12
Loko Moscow,4642,1,11,6,3,31,14,17,39
CSKA Moscow,4642,2,11,4,5,30,20,10,37
Zenit,4642,3,8,9,3,25,16,9,33
Spart Moscow,4642,4,9,5,6,37,29,8,32
Krasnodar,4642,5,9,5,6,32,27,5,32
Terek Grozny,4642,6,8,6,6,22,23,-1,30
Din Moscow,4642,7,5,7,8,18,25,-7,22
FK Rubin,4642,8,5,6,9,23,21,2,21
Rostov,4642,9,5,6,9,12,17,-5,21
Amkar,4642,10,5,4,11,12,25,-13,19
Anzhi,4642,11,2,6,12,14,39,-25,12
Loko Moscow,4643,1,12,6,2,32,12,20,42
CSKA Moscow,4643,2,11,3,6,27,18,9,36
Spart Moscow,4643,3,9,6,5,36,27,9,33
Zenit,4643,4,8,9,3,23,14,9,33
Krasnodar,4643,5,8,5,7,28,27,1,29
Terek Grozny,4643,6,7,6,7,20,23,-3,27
FK Rubin,4643,7,6,6,8,23,18,5,24
Din Moscow,4643,8,6,6,8,18,22,-4,24
Rostov,4643,9,4,6,10,10,19,-9,18
Amkar,4643,10,4,6,10,10,23,-13,18
Anzhi,4643,11,3,5,12,15,39,-24,14
Loko Moscow,4644,1,11,6,3,29,12,17,39
CSKA Moscow,4644,2,12,3,5,29,18,11,39
Spart Moscow,4644,3,9,5,6,37,28,9,32
Krasnodar,4644,4,9,4,7,28,27,1,31
Zenit,4644,5,7,9,4,21,14,7,30
Terek Grozny,4644,6,8,5,7,25,24,1,29
Din Moscow,4644,7,6,6,8,19,24,-5,24
FK Rubin,4644,8,6,5,9,24,19,5,23
Amkar,4644,9,6,4,10,11,22,-11,22
Rostov,4644,10,5,6,9,12,18,-6,21
Anzhi,4644,11,2,5,13,16,45,-29,11
Loko Moscow,4645,1,12,6,2,34,14,20,42
Spart Moscow,4645,2,10,6,4,39,29,10,36
CSKA Moscow,4645,3,11,3,6,28,21,7,36
Krasnodar,4645,4,8,6,6,30,27,3,30
Zenit,4645,5,7,8,5,23,18,5,29
Terek Grozny,4645,6,7,5,8,20,24,-4,26
FK Rubin,4645,7,6,6,8,24,18,6,24
Din Moscow,4645,8,5,7,8,18,24,-6,22
Amkar,4645,9,5,4,11,11,24,-13,19
Rostov,4645,10,4,6,10,12,20,-8,18
Anzhi,4645,11,4,5,11,18,38,-20,17
Loko Moscow,4646,1,11,5,4,32,16,16,38
CSKA Moscow,4646,2,11,3,6,31,20,11,36
Zenit,4646,3,9,8,3,25,14,11,35
Krasnodar,4646,4,10,4,6,32,26,6,34
Spart Moscow,4646,5,8,7,5,37,30,7,31
Terek Grozny,4646,6,8,5,7,26,25,1,29
Din Moscow,4646,7,5,8,7,19,23,-4,23
FK Rubin,4646,8,5,6,9,21,19,2,21
Rostov,4646,9,4,7,9,11,18,-7,19
Amkar,4646,10,5,4,11,11,28,-17,19
Anzhi,4646,11,3,5,12,18,44,-26,14
CSKA Moscow,4647,1,12,3,5,32,18,14,39
Loko Moscow,4647,2,11,5,4,31,16,15,38
Krasnodar,4647,3,10,4,6,33,26,7,34
Zenit,4647,4,8,8,4,24,16,8,32
Spart Moscow,4647,5,9,5,6,36,32,4,32
Terek Grozny,4647,6,8,5,7,25,26,-1,29
Din Moscow,4647,7,6,7,7,22,24,-2,25
FK Rubin,4647,8,5,6,9,23,21,2,21
Amkar,4647,9,5,4,11,14,26,-12,19
Rostov,4647,10,4,6,10,10,18,-8,18
Anzhi,4647,11,3,5,12,16,43,-27,14
Loko Moscow,4648,1,12,6,2,32,12,20,42
CSKA Moscow,4648,2,12,3,5,29,17,12,39
Spart Moscow,4648,3,9,6,5,38,28,10,33
Krasnodar,4648,4,8,6,6,28,25,3,30
Terek Grozny,4648,5,8,6,6,25,26,-1,30
Zenit,4648,6,7,8,5,21,17,4,29
Din Moscow,4648,7,6,6,8,18,24,-6,24
FK Rubin,4648,8,5,6,9,21,18,3,21
Rostov,4648,9,5,6,9,12,18,-6,21
Amkar,4648,10,4,5,11,13,27,-14,17
Anzhi,4648,11,2,6,12,15,40,-25,12
Loko Moscow,4649,1,11,6,3,31,15,16,39
CSKA Moscow,4649,2,10,4,6,28,22,6,34
Zenit,4649,3,8,9,3,24,14,10,33
Spart Moscow,4649,4,9,6,5,36,28,8,33
Krasnodar,4649,5,9,4,7,30,27,3,31
Terek Grozny,4649,6,8,5,7,23,25,-2,29
FK Rubin,4649,7,6,6,8,23,17,6,24
Din Moscow,4649,8,5,7,8,18,23,-5,22
Rostov,4649,9,5,6,9,11,17,-6,21
Amkar,4649,10,5,5,10,12,24,-12,20
Anzhi,4649,11,2,6,12,18,42,-24,12
Loko Moscow,4650,1,11,7,2,31,13,18,40
CSKA Moscow,4650,2,10,4,6,25,18,7,34
Spart Moscow,4650,3,9,6,5,37,26,11,33
Zenit,4650,4,8,9,3,23,14,9,33
Krasnodar,4650,5,8,5,7,28,26,2,29
Terek Grozny,4650,6,8,5,7,22,25,-3,29
FK Rubin,4650,7,7,5,8,24,17,7,26
Rostov,4650,8,5,6,9,11,17,-6,21
Din Moscow,4650,9,5,6,9,17,27,-10,21
Amkar,4650,10,5,5,10,11,22,-11,20
Anzhi,4650,11,2,6,12,15,39,-24,12
Loko Moscow,4651,1,12,5,3,32,12,20,41
CSKA Moscow,4651,2,11,4,5,30,18,12,37
Zenit,4651,3,8,9,3,22,13,9,33
Spart Moscow,4651,4,9,6,5,38,31,7,33
Krasnodar,4651,5,9,4,7,29,27,2,31
Terek Grozny,4651,6,8,5,7,21,24,-3,29
Din Moscow,4651,7,6,6,8,21,24,-3,24
Rostov,4651,8,5,6,9,13,18,-5,21
FK Rubin,4651,9,5,5,10,21,21,0,20
Amkar,4651,10,5,5,10,12,23,-11,20
Anzhi,4651,11,2,5,13,15,43,-28,11
Loko Moscow,4652,1,11,6,3,31,15,16,39
CSKA Moscow,4652,2,11,3,6,30,21,9,36
Krasnodar,4652,3,10,4,6,33,26,7,34
Spart Moscow,4652,4,9,6,5,37,29,8,33
Zenit,4652,5,7,9,4,23,17,6,30
Terek Grozny,4652,6,8,5,7,22,24,-2,29
Din Moscow,4652,7,7,6,7,20,21,-1,27
FK Rubin,4652,8,5,5,10,23,22,1,20
Amkar,4652,9,5,5,10,12,24,-12,20
Rostov,4652,10,4,6,10,10,19,-9,18
Anzhi,4652,11,3,5,12,19,42,-23,14
Loko Moscow,4653,1,11,6,3,30,13,17,39
Spart Moscow,4653,2,10,6,4,39,28,11,36
CSKA Moscow,4653,3,10,4,6,26,23,3,34
Zenit,4653,4,8,9,3,26,13,13,33
Krasnodar,4653,5,9,4,7,29,28,1,31
Terek Grozny,4653,6,8,5,7,22,24,-2,29
FK Rubin,4653,7,7,5,8,27,19,8,26
Din Moscow,4653,8,5,7,8,20,25,-5,22
Amkar,4653,9,5,4,11,13,25,-12,19
Rostov,4653,10,4,6,10,10,19,-9,18
Anzhi,4653,11,2,6,12,15,40,-25,12
Loko Moscow,4654,1,11,7,2,32,14,18,40
CSKA Moscow,4654,2,11,3,6,29,20,9,36
Spart Moscow,4654,3,8,6,6,34,28,6,30
Zenit,4654,4,7,9,4,22,17,5,30
Krasnodar,4654,5,8,5,7,29,28,1,29
Terek Grozny,4654,6,7,7,6,21,23,-2,28
Din Moscow,4654,7,6,7,7,19,21,-2,25
FK Rubin,4654,8,6,5,9,23,19,4,23
Rostov,4654,9,5,6,9,12,18,-6,21
Amkar,4654,10,5,5,10,10,22,-12,20
Anzhi,4654,11,3,6,11,18,39,-21,15
Loko Moscow,4655,1,12,5,3,33,15,18,41
CSKA Moscow,4655,2,11,3,6,27,19,8,36
Krasnodar,4655,3,10,4,6,32,26,6,34
Spart Moscow,4655,4,8,8,4,40,32,8,32
Zenit,4655,5,8,8,4,23,16,7,32
Terek Grozny,4655,6,8,5,7,21,23,-2,29
FK Rubin,4655,7,6,5,9,24,20,4,23
Din Moscow,4655,8,5,7,8,20,25,-5,22
Rostov,4655,9,4,7,9,12,19,-7,19
Amkar,4655,10,4,5,11,12,26,-14,17
Anzhi,4655,11,3,5,12,16,39,-23,14
Loko Moscow,4656,1,12,6,2,31,12,19,42
CSKA Moscow,4656,2,10,4,6,27,21,6,34
Zenit,4656,3,8,9,3,24,14,10,33
Spart Moscow,4656,4,9,5,6,38,32,6,32
Krasnodar,4656,5,8,4,8,28,28,0,28
Terek Grozny,4656,6,7,6,7,20,25,-5,27
FK Rubin,4656,7,7,5,8,24,17,7,26
Rostov,4656,8,5,6,9,13,18,-5,21
Din Moscow,4656,9,5,6,9,18,24,-6,21
Amkar,4656,10,5,5,10,12,24,-12,20
Anzhi,4656,11,3,6,11,18,38,-20,15
Loko Moscow,4657,1,13,5,2,35,14,21,44
CSKA Moscow,4657,2,11,4,5,29,19,10,37
Spart Moscow,4657,3,9,5,6,38,30,8,32
Krasnodar,4657,4,9,4,7,30,27,3,31
Zenit,4657,5,7,9,4,25,18,7,30
Terek Grozny,4657,6,7,7,6,22,24,-2,28
Din Moscow,4657,7,7,6,7,22,22,0,27
Rostov,4657,8,5,6,9,13,19,-6,21
FK Rubin,4657,9,5,5,10,22,23,-1,20
Amkar,4657,10,4,5,11,10,25,-15,17
Anzhi,4657,11,2,6,12,16,41,-25,12
Loko Moscow,4658,1,11,5,4,30,15,15,38
Spart Moscow,4658,2,11,5,4,41,27,14,38
CSKA Moscow,4658,3,11,4,5,28,19,9,37
Zenit,4658,4,8,9,3,25,15,10,33
Krasnodar,4658,5,9,5,6,31,27,4,32
Terek Grozny,4658,6,9,5,6,24,22,2,32
FK Rubin,4658,7,6,6,8,25,19,6,24
Din Moscow,4658,8,5,6,9,19,27,-8,21
Rostov,4658,9,4,6,10,10,19,-9,18
Amkar,4658,10,4,4,12,9,26,-17,16
Anzhi,4658,11,2,5,13,14,40,-26,11
Loko Moscow,4659,1,11,6,3,30,13,17,39
CSKA Moscow,4659,2,11,3,6,27,20,7,36
Spart Moscow,4659,3,9,7,4,38,29,9,34
Krasnodar,4659,4,10,4,6,30,25,5,34
Zenit,4659,5,8,9,3,23,13,10,33
Terek Grozny,4659,6,7,6,7,21,26,-5,27
Din Moscow,4659,7,6,7,7,18,21,-3,25
FK Rubin,4659,8,5,5,10,21,19,2,20
Rostov,4659,9,4,6,10,11,19,-8,18
Amkar,4659,10,4,6,10,13,26,-13,18
Anzhi,4659,11,3,5,12,18,39,-21,14
Loko Moscow,4660,1,11,6,3,29,14,15,39
CSKA Moscow,4660,2,12,3,5,29,17,12,39
Spart Moscow,4660,3,9,6,5,36,28,8,33
Zenit,4660,4,8,8,4,24,15,9,32
Terek Grozny,4660,5,8,6,6,25,25,0,30
Krasnodar,4660,6,8,5,7,28,26,2,29
FK Rubin,4660,7,7,5,8,24,18,6,26
Din Moscow,4660,8,6,6,8,20,23,-3,24
Rostov,4660,9,4,7,9,10,17,-7,19
Amkar,4660,10,4,4,12,10,27,-17,16
Anzhi,4660,11,2,6,12,16,41,-25,12
Loko Moscow,4661,1,13,5,2,33,13,20,44
CSKA Moscow,4661,2,12,3,5,30,18,12,39
Spart Moscow,4661,3,8,6,6,34,28,6,30
Terek Grozny,4661,4,8,6,6,23,23,0,30
Zenit,4661,5,7,8,5,22,17,5,29
Krasnodar,4661,6,8,4,8,28,28,0,28
Din Moscow,4661,7,6,7,7,19,22,-3,25
FK Rubin,4661,8,6,5,9,23,18,5,23
Rostov,4661,9,5,6,9,11,17,-6,21
Amkar,4661,10,5,5,10,10,22,-12,20
Anzhi,4661,11,2,5,13,16,43,-27,11
Loko Moscow,4662,1,12,5,3,31,17,14,41
CSKA Moscow,4662,2,11,4,5,28,18,10,37
Zenit,4662,3,8,9,3,27,14,13,33
Spart Moscow,4662,4,8,6,6,35,31,4,30
Terek Grozny,4662,5,8,6,6,21,22,-1,30
Krasnodar,4662,6,8,5,7,28,26,2,29
FK Rubin,4662,7,6,6,8,23,17,6,24
Din Moscow,4662,8,6,6,8,19,24,-5,24
Amkar,4662,9,5,5,10,12,22,-10,20
Rostov,4662,10,4,7,9,11,18,-7,19
Anzhi,4662,11,2,5,13,14,40,-26,11
Loko Moscow,4663,1,12,5,3,32,14,18,41
Spart Moscow,4663,2,10,6,4,38,27,11,36
CSKA Moscow,4663,3,11,3,6,29,19,10,36
Zenit,4663,4,8,8,4,23,15,8,32
Krasnodar,4663,5,9,4,7,30,27,3,31
Terek Grozny,4663,6,8,6,6,24,24,0,30
FK Rubin,4663,7,7,5,8,24,18,6,26
Din Moscow,4663,8,5,7,8,19,24,-5,22
Rostov,4663,9,4,6,10,10,19,-9,18
Amkar,4663,10,4,4,12,11,27,-16,16
Anzhi,4663,11,2,6,12,15,41,-26,12
Loko Moscow,4664,1,12,6,2,37,16,21,42
Spart Moscow,4664,2,10,6,4,39,28,11,36
Zenit,4664,3,8,9,3,26,17,9,33
CSKA Moscow,4664,4,10,3,7,26,22,4,33
Krasnodar,4664,5,9,4,7,31,29,2,31
Terek Grozny,4664,6,8,5,7,21,24,-3,29
Din Moscow,4664,7,6,6,8,18,23,-5,24
FK Rubin,4664,8,5,5,10,21,20,1,20
Amkar,4664,9,5,5,10,12,23,-11,20
Rostov,4664,10,4,6,10,12,20,-8,18
Anzhi,4664,11,3,5,12,17,38,-21,14
Loko Moscow,4665,1,13,5,2,35,12,23,44
CSKA Moscow,4665,2,12,3,5,31,18,13,39
Spart Moscow,4665,3,10,6,4,38,28,10,36
Krasnodar,4665,4,9,4,7,32,26,6,31
Zenit,4665,5,7,8,5,22,19,3,29
Terek Grozny,4665,6,7,6,7,21,24,-3,27
FK Rubin,4665,7,6,5,9,26,23,3,23
Din Moscow,4665,8,5,7,8,20,27,-7,22
Amkar,4665,9,5,4,11,10,23,-13,19
Rostov,4665,10,4,6,10,11,19,-8,18
Anzhi,4665,11,2,6,12,16,43,-27,12
Loko Moscow,4666,1,11,5,4,29,15,14,38
CSKA Moscow,4666,2,11,3,6,29,20,9,36
Zenit,4666,3,9,8,3,25,13,12,35
Krasnodar,4666,4,10,4,6,30,24,6,34
Spart Moscow,4666,5,9,5,6,40,33,7,32
Terek Grozny,4666,6,8,5,7,23,24,-1,29
Din Moscow,4666,7,6,7,7,21,24,-3,25
Amkar,4666,8,6,4,10,13,24,-11,22
FK Rubin,4666,9,5,6,9,21,18,3,21
Rostov,4666,10,4,6,10,11,19,-8,18
Anzhi,4666,11,2,5,13,16,44,-28,11
Loko Moscow,4667,1,13,5,2,33,11,22,44
CSKA Moscow,4667,2,11,3,6,26,18,8,36
Spart Moscow,4667,3,8,8,4,37,29,8,32
Zenit,4667,4,8,8,4,22,14,8,32
Krasnodar,4667,5,9,4,7,29,28,1,31
Terek Grozny,4667,6,7,6,7,21,25,-4,27
Din Moscow,4667,7,6,7,7,20,23,-3,25
FK Rubin,4667,8,5,5,10,23,21,2,20
Amkar,4667,9,5,5,10,12,23,-11,20
Rostov,4667,10,4,7,9,12,19,-7,19
Anzhi,4667,11,2,6,12,15,39,-24,12
Loko Moscow,4668,1,13,5,2,34,13,21,44
CSKA Moscow,4668,2,12,3,5,29,18,11,39
Spart Moscow,4668,3,9,7,4,35,26,9,34
Terek Grozny,4668,4,8,6,6,22,23,-1,30
Zenit,4668,5,7,8,5,22,16,6,29
Krasnodar,4668,6,8,5,7,28,27,1,29
FK Rubin,4668,7,6,6,8,26,19,7,24
Din Moscow,4668,8,5,6,9,19,27,-8,21
Rostov,4668,9,4,7,9,10,17,-7,19
Amkar,4668,10,4,5,11,11,25,-14,17
Anzhi,4668,11,2,6,12,15,40,-25,12
Loko Moscow,4669,1,12,5,3,32,13,19,41
CSKA Moscow,4669,2,12,3,5,30,19,11,39
Spart Moscow,4669,3,9,6,5,37,28,9,33
Terek Grozny,4669,4,9,5,6,23,23,0,32
Krasnodar,4669,5,9,4,7,29,26,3,31
Zenit,4669,6,7,8,5,21,17,4,29
FK Rubin,4669,7,7,5,8,24,17,7,26
Din Moscow,4669,8,5,6,9,17,25,-8,21
Rostov,4669,9,4,7,9,11,18,-7,19
Amkar,4669,10,5,4,11,11,24,-13,19
Anzhi,4669,11,2,5,13,17,42,-25,11
Spart Moscow,4670,1,11,5,4,40,26,14,38
Loko Moscow,4670,2,11,5,4,29,15,14,38
CSKA Moscow,4670,3,11,3,6,28,20,8,36
Zenit,4670,4,9,8,3,26,13,13,35
Terek Grozny,4670,5,9,5,6,23,22,1,32
Krasnodar,4670,6,9,4,7,30,27,3,31
FK Rubin,4670,7,7,5,8,26,18,8,26
Din Moscow,4670,8,5,6,9,17,26,-9,21
Rostov,4670,9,4,6,10,10,19,-9,18
Amkar,4670,10,4,4,12,10,26,-16,16
Anzhi,4670,11,2,5,13,14,41,-27,11
Loko Moscow,4671,1,12,5,3,31,13,18,41
CSKA Moscow,4671,2,12,3,5,30,20,10,39
Spart Moscow,4671,3,10,5,5,37,27,10,35
Krasnodar,4671,4,10,4,6,31,26,5,34
Zenit,4671,5,7,8,5,21,15,6,29
Terek Grozny,4671,6,8,5,7,23,26,-3,29
Din Moscow,4671,7,6,6,8,18,23,-5,24
FK Rubin,4671,8,6,5,9,24,19,5,23
Rostov,4671,9,4,6,10,11,19,-8,18
Amkar,4671,10,4,4,12,9,25,-16,16
Anzhi,4671,11,3,5,12,21,43,-22,14
Loko Moscow,4672,1,13,5,2,33,12,21,44
Spart Moscow,4672,2,10,6,4,39,26,13,36
CSKA Moscow,4672,3,10,3,7,25,21,4,33
Zenit,4672,4,8,8,4,24,15,9,32
Terek Grozny,4672,5,9,5,6,27,24,3,32
Krasnodar,4672,6,8,5,7,29,28,1,29
Din Moscow,4672,7,6,6,8,20,24,-4,24
FK Rubin,4672,8,5,6,9,23,21,2,21
Rostov,4672,9,4,6,10,10,20,-10,18
Amkar,4672,10,4,5,11,10,27,-17,17
Anzhi,4672,11,3,5,12,17,39,-22,14
Loko Moscow,4673,1,11,5,4,29,14,15,38
Spart Moscow,4673,2,11,5,4,42,29,13,38
CSKA Moscow,4673,3,11,3,6,30,20,10,36
Zenit,4673,4,9,8,3,25,14,11,35
Krasnodar,4673,5,10,4,6,30,24,6,34
Terek Grozny,4673,6,9,5,6,25,22,3,32
Din Moscow,4673,7,6,6,8,19,24,-5,24
FK Rubin,4673,8,5,5,10,22,21,1,20
Rostov,4673,9,4,6,10,11,19,-8,18
Amkar,4673,10,4,4,12,12,28,-16,16
Anzhi,4673,11,2,5,13,15,45,-30,11
CSKA Moscow,4674,1,12,3,5,34,20,14,39
Loko Moscow,4674,2,11,5,4,30,15,15,38
Spart Moscow,4674,3,9,5,6,35,28,7,32
Krasnodar,4674,4,9,5,6,29,24,5,32
Zenit,4674,5,8,8,4,23,18,5,32
Terek Grozny,4674,6,8,6,6,22,23,-1,30
Din Moscow,4674,7,6,7,7,19,22,-3,25
FK Rubin,4674,8,5,7,8,21,17,4,22
Amkar,4674,9,5,4,11,10,23,-13,19
Rostov,4674,10,4,6,10,10,18,-8,18
Anzhi,4674,11,2,6,12,18,43,-25,12
Loko Moscow,4675,1,12,6,2,30,11,19,42
CSKA Moscow,4675,2,11,4,5,27,17,10,37
Terek Grozny,4675,3,9,5,6,26,23,3,32
Zenit,4675,4,7,9,4,21,15,6,30
Spart Moscow,4675,5,8,5,7,35,35,0,29
Krasnodar,4675,6,8,4,8,27,26,1,28
Din Moscow,4675,7,7,6,7,24,22,2,27
FK Rubin,4675,8,6,5,9,23,20,3,23
Rostov,4675,9,5,6,9,11,17,-6,21
Amkar,4675,10,5,4,11,15,27,-12,19
Anzhi,4675,11,2,6,12,14,40,-26,12
Loko Moscow,4676,1,11,6,3,31,14,17,39
CSKA Moscow,4676,2,11,3,6,27,19,8,36
Zenit,4676,3,8,9,3,23,14,9,33
Krasnodar,4676,4,9,5,6,31,27,4,32
Spart Moscow,4676,5,8,5,7,33,31,2,29
Terek Grozny,4676,6,7,6,7,22,26,-4,27
FK Rubin,4676,7,6,6,8,25,19,6,24
Din Moscow,4676,8,6,6,8,18,23,-5,24
Rostov,4676,9,5,6,9,13,17,-4,21
Amkar,4676,10,5,5,10,12,23,-11,20
Anzhi,4676,11,3,5,12,18,40,-22,14
Loko Moscow,4677,1,12,5,3,32,13,19,41
Spart Moscow,4677,2,10,6,4,38,25,13,36
CSKA Moscow,4677,3,10,4,6,26,19,7,34
Zenit,4677,4,8,8,4,23,16,7,32
Krasnodar,4677,5,9,5,6,31,27,4,32
Terek Grozny,4677,6,7,7,6,21,23,-2,28
Din Moscow,4677,7,6,6,8,21,23,-2,24
FK Rubin,4677,8,5,6,9,24,24,0,21
Rostov,4677,9,4,6,10,10,20,-10,18
Amkar,4677,10,4,6,10,9,22,-13,18
Anzhi,4677,11,2,7,11,16,39,-23,13
Loko Moscow,4678,1,12,6,2,32,12,20,42
CSKA Moscow,4678,2,10,4,6,25,19,6,34
Zenit,4678,3,8,9,3,24,14,10,33
Spart Moscow,4678,4,9,6,5,38,30,8,33
Terek Grozny,4678,5,8,5,7,23,25,-2,29
Krasnodar,4678,6,8,4,8,28,28,0,28
FK Rubin,4678,7,7,5,8,25,19,6,26
Rostov,4678,8,5,6,9,12,17,-5,21
Din Moscow,4678,9,5,6,9,19,26,-7,21
Amkar,4678,10,5,5,10,14,25,-11,20
Anzhi,4678,11,2,6,12,14,39,-25,12
Loko Moscow,4679,1,12,6,2,32,13,19,42
Spart Moscow,4679,2,11,5,4,42,25,17,38
CSKA Moscow,4679,3,11,3,6,26,19,7,36
Zenit,4679,4,8,8,4,23,14,9,32
Krasnodar,4679,5,8,6,6,30,27,3,30
Terek Grozny,4679,6,7,6,7,21,25,-4,27
Din Moscow,4679,7,6,6,8,20,27,-7,24
FK Rubin,4679,8,5,6,9,22,21,1,21
Rostov,4679,9,4,6,10,10,19,-9,18
Amkar,4679,10,4,5,11,10,24,-14,17
Anzhi,4679,11,3,5,12,16,38,-22,14
Loko Moscow,4680,1,13,5,2,34,12,22,44
CSKA Moscow,4680,2,11,4,5,27,18,9,37
Spart Moscow,4680,3,9,7,4,37,26,11,34
Krasnodar,4680,4,9,4,7,30,27,3,31
Zenit,4680,5,7,9,4,22,17,5,30
Terek Grozny,4680,6,8,6,6,24,25,-1,30
Din Moscow,4680,7,6,6,8,18,24,-6,24
FK Rubin,4680,8,5,5,10,23,21,2,20
Rostov,4680,9,4,7,9,10,17,-7,19
Amkar,4680,10,4,6,10,12,25,-13,18
Anzhi,4680,11,2,5,13,16,41,-25,11
Loko Moscow,4681,1,11,5,4,30,15,15,38
Spart Moscow,4681,2,11,5,4,38,25,13,38
CSKA Moscow,4681,3,11,4,5,28,18,10,37
Krasnodar,4681,4,10,4,6,34,26,8,34
Zenit,4681,5,8,9,3,24,15,9,33
Terek Grozny,4681,6,8,5,7,21,24,-3,29
FK Rubin,4681,7,6,5,9,26,22,4,23
Din Moscow,4681,8,5,6,9,17,25,-8,21
Amkar,4681,9,5,4,11,11,23,-12,19
Rostov,4681,10,4,6,10,10,20,-10,18
Anzhi,4681,11,2,5,13,14,40,-26,11
Loko Moscow,4682,1,13,5,2,34,13,21,44
CSKA Moscow,4682,2,12,3,5,31,18,13,39
Spart Moscow,4682,3,10,6,4,38,26,12,36
Zenit,4682,4,7,8,5,23,20,3,29
Terek Grozny,4682,5,8,5,7,21,23,-2,29
Krasnodar,4682,6,8,4,8,28,28,0,28
FK Rubin,4682,7,6,6,8,23,18,5,24
Din Moscow,4682,8,5,7,8,19,25,-6,22
Rostov,4682,9,4,7,9,10,17,-7,19
Amkar,4682,10,4,4,12,9,25,-16,16
Anzhi,4682,11,3,5,12,15,38,-23,14
CSKA Moscow,4683,1,12,3,5,29,17,12,39
Loko Moscow,4683,2,11,5,4,29,15,14,38
Krasnodar,4683,3,10,4,6,30,24,6,34
Zenit,4683,4,8,8,4,24,14,10,32
Spart Moscow,4683,5,9,5,6,36,28,8,32
Terek Grozny,4683,6,7,6,7,22,25,-3,27
Din Moscow,4683,7,6,6,8,20,26,-6,24
FK Rubin,4683,8,6,5,9,25,20,5,23
Amkar,4683,9,6,4,10,12,23,-11,22
Rostov,4683,10,4,6,10,10,19,-9,18
Anzhi,4683,11,2,6,12,15,41,-26,12
Loko Moscow,4684,1,11,5,4,29,14,15,38
Spart Moscow,4684,2,11,5,4,41,27,14,38
CSKA Moscow,4684,3,11,3,6,29,19,10,36
Zenit,4684,4,9,8,3,25,13,12,35
Krasnodar,4684,5,10,4,6,30,25,5,34
Terek Grozny,4684,6,8,5,7,22,24,-2,29
Din Moscow,4684,7,6,6,8,19,24,-5,24
FK Rubin,4684,8,5,5,10,22,20,2,20
Rostov,4684,9,4,6,10,10,19,-9,18
Amkar,4684,10,4,4,12,10,26,-16,16
Anzhi,4684,11,3,5,12,16,42,-26,14
Loko Moscow,4685,1,12,6,2,35,12,23,42
Spart Moscow,4685,2,10,5,5,37,28,9,35
CSKA Moscow,4685,3,10,3,7,25,21,4,33
Zenit,4685,4,8,8,4,23,18,5,32
Krasnodar,4685,5,8,6,6,29,26,3,30
Terek Grozny,4685,6,8,6,6,22,23,-1,30
Din Moscow,4685,7,6,7,7,19,21,-2,25
FK Rubin,4685,8,5,7,8,22,18,4,22
Rostov,4685,9,4,6,10,10,19,-9,18
Amkar,4685,10,4,4,12,10,25,-15,16
Anzhi,4685,11,3,6,11,17,38,-21,15
Loko Moscow,4686,1,11,6,3,31,14,17,39
CSKA Moscow,4686,2,11,3,6,28,20,8,36
Krasnodar,4686,3,10,4,6,31,26,5,34
Zenit,4686,4,8,9,3,24,15,9,33
Spart Moscow,4686,5,8,8,4,36,28,8,32
Terek Grozny,4686,6,7,5,8,21,26,-5,26
FK Rubin,4686,7,6,5,9,24,19,5,23
Din Moscow,4686,8,5,7,8,18,24,-6,22
Amkar,4686,9,5,5,10,12,23,-11,20
Rostov,4686,10,4,7,9,11,18,-7,19
Anzhi,4686,11,3,5,12,17,40,-23,14
Loko Moscow,4687,1,11,6,3,31,14,17,39
Spart Moscow,4687,2,10,6,4,42,27,15,36
CSKA Moscow,4687,3,11,3,6,30,23,7,36
Zenit,4687,4,9,8,3,26,14,12,35
Krasnodar,4687,5,8,6,6,28,25,3,30
Terek Grozny,4687,6,8,5,7,23,24,-1,29
Din Moscow,4687,7,6,7,7,21,23,-2,25
FK Rubin,4687,8,5,6,9,21,19,2,21
Amkar,4687,9,5,4,11,11,26,-15,19
Rostov,4687,10,4,6,10,10,21,-11,18
Anzhi,4687,11,2,5,13,17,44,-27,11
Loko Moscow,4688,1,11,6,3,33,16,17,39
CSKA Moscow,4688,2,12,3,5,28,18,10,39
Spart Moscow,4688,3,11,5,4,42,29,13,38
Zenit,4688,4,8,8,4,23,15,8,32
Krasnodar,4688,5,9,5,6,31,27,4,32
Terek Grozny,4688,6,7,5,8,22,28,-6,26
Din Moscow,4688,7,5,7,8,19,25,-6,22
FK Rubin,4688,8,5,6,9,22,19,3,21
Amkar,4688,9,5,4,11,15,27,-12,19
Rostov,4688,10,4,6,10,11,19,-8,18
Anzhi,4688,11,3,5,12,17,40,-23,14
Loko Moscow,4689,1,11,6,3,30,14,16,39
Krasnodar,4689,2,10,4,6,33,25,8,34
CSKA Moscow,4689,3,10,4,6,25,21,4,34
Zenit,4689,4,8,9,3,25,13,12,33
Spart Moscow,4689,5,9,5,6,36,32,4,32
Din Moscow,4689,6,7,6,7,21,21,0,27
Terek Grozny,4689,7,7,5,8,23,29,-6,26
Amkar,4689,8,6,4,10,16,24,-8,22
FK Rubin,4689,9,5,5,10,21,22,-1,20
Rostov,4689,10,4,6,10,11,20,-9,18
Anzhi,4689,11,3,6,11,18,38,-20,15
Loko Moscow,4690,1,12,6,2,33,14,19,42
CSKA Moscow,4690,2,11,4,5,29,20,9,37
Spart Moscow,4690,3,9,6,5,37,29,8,33
Krasnodar,4690,4,9,4,7,33,27,6,31
Zenit,4690,5,7,9,4,23,16,7,30
Terek Grozny,4690,6,7,5,8,20,25,-5,26
FK Rubin,4690,7,6,5,9,23,21,2,23
Din Moscow,4690,8,5,7,8,18,24,-6,22
Amkar,4690,9,6,4,10,14,23,-9,22
Rostov,4690,10,4,6,10,10,19,-9,18
Anzhi,4690,11,3,6,11,17,39,-22,15
Loko Moscow,4691,1,11,6,3,31,14,17,39
CSKA Moscow,4691,2,11,4,5,31,19,12,37
Spart Moscow,4691,3,9,6,5,37,27,10,33
Zenit,4691,4,8,9,3,24,15,9,33
Krasnodar,4691,5,8,5,7,29,27,2,29
Terek Grozny,4691,6,8,5,7,23,26,-3,29
Din Moscow,4691,7,6,7,7,18,21,-3,25
FK Rubin,4691,8,6,6,8,23,18,5,24
Amkar,4691,9,5,5,10,13,24,-11,20
Rostov,4691,10,4,6,10,10,20,-10,18
Anzhi,4691,11,2,5,13,16,44,-28,11
Loko Moscow,4692,1,12,6,2,32,13,19,42
CSKA Moscow,4692,2,11,4,5,29,17,12,37
Spart Moscow,4692,3,9,6,5,37,28,9,33
Zenit,4692,4,7,10,3,21,13,8,31
Krasnodar,4692,5,8,4,8,29,29,0,28
Terek Grozny,4692,6,7,7,6,21,23,-2,28
FK Rubin,4692,7,6,6,8,24,18,6,24
Din Moscow,4692,8,5,7,8,18,24,-6,22
Amkar,4692,9,5,5,10,11,23,-12,20
Rostov,4692,10,4,7,9,11,18,-7,19
Anzhi,4692,11,2,6,12,15,42,-27,12
Loko Moscow,4693,1,11,7,2,32,14,18,40
CSKA Moscow,4693,2,11,4,5,28,18,10,37
Spart Moscow,4693,3,10,6,4,40,30,10,36
Zenit,4693,4,7,9,4,22,16,6,30
Krasnodar,4693,5,8,6,6,30,27,3,30
Terek Grozny,4693,6,7,6,7,22,26,-4,27
Din Moscow,4693,7,6,6,8,21,23,-2,24
FK Rubin,4693,8,5,6,9,22,21,1,21
Amkar,4693,9,5,5,10,13,24,-11,20
Rostov,4693,10,4,6,10,13,21,-8,18
Anzhi,4693,11,2,7,11,16,39,-23,13
Loko Moscow,4694,1,12,5,3,31,14,17,41
Spart Moscow,4694,2,11,5,4,38,26,12,38
CSKA Moscow,4694,3,11,4,5,30,19,11,37
Krasnodar,4694,4,10,4,6,31,24,7,34
Zenit,4694,5,7,9,4,23,16,7,30
Terek Grozny,4694,6,8,6,6,22,23,-1,30
FK Rubin,4694,7,6,5,9,24,19,5,23
Din Moscow,4694,8,5,6,9,18,26,-8,21
Rostov,4694,9,4,6,10,10,19,-9,18
Amkar,4694,10,4,4,12,9,24,-15,16
Anzhi,4694,11,2,6,12,16,42,-26,12
Loko Moscow,4695,1,11,6,3,34,17,17,39
CSKA Moscow,4695,2,12,3,5,29,17,12,39
Spart Moscow,4695,3,9,7,4,39,28,11,34
Zenit,4695,4,8,8,4,24,17,7,32
Krasnodar,4695,5,9,5,6,31,27,4,32
Terek Grozny,4695,6,7,7,6,20,22,-2,28
Din Moscow,4695,7,6,7,7,23,25,-2,25
FK Rubin,4695,8,5,5,10,23,22,1,20
Rostov,4695,9,4,7,9,10,17,-7,19
Amkar,4695,10,4,5,11,10,26,-16,17
Anzhi,4695,11,2,6,12,14,39,-25,12
Loko Moscow,4696,1,11,6,3,30,13,17,39
CSKA Moscow,4696,2,11,4,5,29,18,11,37
Zenit,4696,3,8,9,3,24,15,9,33
Spart Moscow,4696,4,8,5,7,33,30,3,29
Krasnodar,4696,5,8,5,7,29,27,2,29
Terek Grozny,4696,6,8,5,7,23,24,-1,29
Din Moscow,4696,7,7,6,7,20,22,-2,27
FK Rubin,4696,8,6,5,9,25,21,4,23
Rostov,4696,9,5,6,9,11,17,-6,21
Amkar,4696,10,5,4,11,13,25,-12,19
Anzhi,4696,11,3,5,12,15,40,-25,14
Loko Moscow,4697,1,12,5,3,32,14,18,41
CSKA Moscow,4697,2,12,3,5,31,19,12,39
Spart Moscow,4697,3,10,6,4,38,28,10,36
Terek Grozny,4697,4,9,5,6,24,22,2,32
Krasnodar,4697,5,9,4,7,29,26,3,31
Zenit,4697,6,7,8,5,22,16,6,29
Din Moscow,4697,7,6,7,7,22,25,-3,25
FK Rubin,4697,8,6,5,9,25,21,4,23
Rostov,4697,9,4,6,10,10,18,-8,18
Amkar,4697,10,4,4,12,11,26,-15,16
Anzhi,4697,11,2,5,13,16,45,-29,11
Loko Moscow,4698,1,13,5,2,33,13,20,44
CSKA Moscow,4698,2,11,3,6,27,19,8,36
Spart Moscow,4698,3,9,6,5,39,29,10,33
Zenit,4698,4,8,8,4,24,15,9,32
Krasnodar,4698,5,9,4,7,30,26,4,31
Terek Grozny,4698,6,8,5,7,23,24,-1,29
Din Moscow,4698,7,6,6,8,18,25,-7,24
Rostov,4698,8,5,6,9,12,17,-5,21
FK Rubin,4698,9,5,5,10,21,20,1,20
Amkar,4698,10,5,5,10,12,24,-12,20
Anzhi,4698,11,2,5,13,15,42,-27,11
Loko Moscow,4699,1,12,5,3,30,13,17,41
CSKA Moscow,4699,2,12,3,5,29,17,12,39
Krasnodar,4699,3,10,4,6,31,24,7,34
Spart Moscow,4699,4,9,6,5,36,28,8,33
Zenit,4699,5,7,8,5,21,15,6,29
Terek Grozny,4699,6,7,6,7,20,23,-3,27
Din Moscow,4699,7,5,8,7,18,22,-4,23
FK Rubin,4699,8,5,6,9,21,19,2,21
Amkar,4699,9,5,5,10,10,22,-12,20
Rostov,4699,10,4,6,10,11,19,-8,18
Anzhi,4699,11,3,5,12,15,40,-25,14
Loko Moscow,4700,1,13,5,2,32,12,20,44
Spart Moscow,4700,2,10,5,5,39,27,12,35
CSKA Moscow,4700,3,10,4,6,25,18,7,34
Zenit,4700,4,8,8,4,22,14,8,32
Terek Grozny,4700,5,8,5,7,23,23,0,29
Krasnodar,4700,6,8,4,8,29,30,-1,28
FK Rubin,4700,7,6,6,8,25,18,7,24
Din Moscow,4700,8,5,7,8,17,25,-8,22
Rostov,4700,9,5,6,9,11,17,-6,21
Amkar,4700,10,4,4,12,10,27,-17,16
Anzhi,4700,11,3,6,11,15,37,-22,15
Loko Moscow,4701,1,11,6,3,31,15,16,39
CSKA Moscow,4701,2,11,4,5,28,17,11,37
Spart Moscow,4701,3,10,6,4,38,28,10,36
Zenit,4701,4,8,9,3,24,14,10,33
Krasnodar,4701,5,9,5,6,29,25,4,32
Terek Grozny,4701,6,7,6,7,21,25,-4,27
Din Moscow,4701,7,6,6,8,21,23,-2,24
FK Rubin,4701,8,5,5,10,21,21,0,20
Rostov,4701,9,4,6,10,10,18,-8,18
Amkar,4701,10,4,6,10,12,25,-13,18
Anzhi,4701,11,3,5,12,16,40,-24,14
Loko Moscow,4702,1,12,5,3,31,13,18,41
CSKA Moscow,4702,2,11,4,5,28,19,9,37
Spart Moscow,4702,3,9,6,5,37,28,9,33
Krasnodar,4702,4,9,5,6,30,25,5,32
Zenit,4702,5,7,8,5,23,18,5,29
Terek Grozny,4702,6,8,5,7,21,24,-3,29
FK Rubin,4702,7,6,6,8,23,18,5,24
Din Moscow,4702,8,6,6,8,20,23,-3,24
Amkar,4702,9,5,5,10,11,22,-11,20
Rostov,4702,10,4,6,10,10,20,-10,18
Anzhi,4702,11,2,6,12,14,38,-24,12
Loko Moscow,4703,1,12,6,2,32,13,19,42
Spart Moscow,4703,2,11,5,4,39,26,13,38
CSKA Moscow,4703,3,11,3,6,28,20,8,36
Zenit,4703,4,7,9,4,23,16,7,30
Terek Grozny,4703,5,8,6,6,23,24,-1,30
Krasnodar,4703,6,8,5,7,29,27,2,29
FK Rubin,4703,7,5,7,8,22,18,4,22
Din Moscow,4703,8,5,7,8,18,23,-5,22
Rostov,4703,9,4,6,10,10,20,-10,18
Amkar,4703,10,4,5,11,9,23,-14,17
Anzhi,4703,11,3,5,12,18,41,-23,14
Spart Moscow,4704,1,11,5,4,41,26,15,38
Loko Moscow,4704,2,11,5,4,30,18,12,38
CSKA Moscow,4704,3,11,4,5,27,18,9,37
Krasnodar,4704,4,10,4,6,33,25,8,34
Zenit,4704,5,8,9,3,23,13,10,33
Terek Grozny,4704,6,7,7,6,20,22,-2,28
Din Moscow,4704,7,5,7,8,17,22,-5,22
FK Rubin,4704,8,5,6,9,21,18,3,21
Rostov,4704,9,4,6,10,10,21,-11,18
Amkar,4704,10,4,5,11,10,25,-15,17
Anzhi,4704,11,2,6,12,15,39,-24,12
Loko Moscow,4705,1,13,5,2,32,12,20,44
CSKA Moscow,4705,2,11,4,5,31,20,11,37
Spart Moscow,4705,3,9,7,4,41,30,11,34
Krasnodar,4705,4,9,4,7,31,26,5,31
Zenit,4705,5,7,9,4,23,16,7,30
Terek Grozny,4705,6,7,7,6,23,25,-2,28
FK Rubin,4705,7,6,5,9,24,22,2,23
Din Moscow,4705,8,5,6,9,21,29,-8,21
Rostov,4705,9,4,7,9,12,19,-7,19
Amkar,4705,10,4,6,10,11,24,-13,18
Anzhi,4705,11,2,6,12,17,43,-26,12
Loko Moscow,4706,1,12,5,3,31,13,18,41
CSKA Moscow,4706,2,11,3,6,28,19,9,36
Spart Moscow,4706,3,9,7,4,38,29,9,34
Zenit,4706,4,8,8,4,23,15,8,32
Krasnodar,4706,5,9,4,7,28,26,2,31
Terek Grozny,4706,6,8,5,7,23,24,-1,29
FK Rubin,4706,7,7,5,8,24,17,7,26
Din Moscow,4706,8,5,6,9,18,24,-6,21
Amkar,4706,9,5,5,10,13,25,-12,20
Rostov,4706,10,4,7,9,11,18,-7,19
Anzhi,4706,11,2,5,13,15,42,-27,11
Loko Moscow,4707,1,12,5,3,33,14,19,41
Spart Moscow,4707,2,10,6,4,42,31,11,36
Krasnodar,4707,3,10,4,6,31,25,6,34
CSKA Moscow,4707,4,10,3,7,28,22,6,33
Zenit,4707,5,8,8,4,25,19,6,32
Terek Grozny,4707,6,8,5,7,23,25,-2,29
FK Rubin,4707,7,6,5,9,23,19,4,23
Din Moscow,4707,8,5,6,9,19,25,-6,21
Amkar,4707,9,5,5,10,13,25,-12,20
Rostov,4707,10,4,6,10,11,20,-9,18
Anzhi,4707,11,3,5,12,18,41,-23,14
Loko Moscow,4708,1,13,5,2,34,11,23,44
CSKA Moscow,4708,2,10,4,6,27,22,5,34
Zenit,4708,3,8,8,4,25,17,8,32
Spart Moscow,4708,4,9,5,6,34,29,5,32
Krasnodar,4708,5,9,4,7,29,26,3,31
Terek Grozny,4708,6,8,5,7,23,24,-1,29
Din Moscow,4708,7,7,6,7,21,21,0,27
Amkar,4708,8,6,4,10,12,23,-11,22
FK Rubin,4708,9,5,5,10,21,20,1,20
Rostov,4708,10,4,6,10,10,18,-8,18
Anzhi,4708,11,2,6,12,15,40,-25,12
Loko Moscow,4709,1,11,6,3,30,14,16,39
CSKA Moscow,4709,2,11,3,6,28,19,9,36
Spart Moscow,4709,3,10,5,5,39,28,11,35
Krasnodar,4709,4,10,4,6,32,25,7,34
Terek Grozny,4709,5,9,5,6,25,23,2,32
Zenit,4709,6,7,9,4,22,16,6,30
Din Moscow,4709,7,6,6,8,19,25,-6,24
FK Rubin,4709,8,5,5,10,23,22,1,20
Amkar,4709,9,5,4,11,11,23,-12,19
Rostov,4709,10,4,6,10,11,20,-9,18
Anzhi,4709,11,3,5,12,17,42,-25,14
Loko Moscow,4710,1,11,6,3,31,16,15,39
Spart Moscow,4710,2,10,6,4,38,27,11,36
CSKA Moscow,4710,3,11,3,6,30,19,11,36
Krasnodar,4710,4,10,4,6,33,25,8,34
Zenit,4710,5,8,9,3,23,14,9,33
Terek Grozny,4710,6,8,6,6,22,23,-1,30
FK Rubin,4710,7,6,5,9,22,19,3,23
Din Moscow,4710,8,5,7,8,18,23,-5,22
Rostov,4710,9,4,6,10,10,18,-8,18
Amkar,4710,10,4,4,12,10,26,-16,16
Anzhi,4710,11,2,6,12,16,43,-27,12
Loko Moscow,4711,1,11,6,3,31,15,16,39
CSKA Moscow,4711,2,11,4,5,26,17,9,37
Spart Moscow,4711,3,9,6,5,43,31,12,33
Zenit,4711,4,8,9,3,24,14,10,33
Terek Grozny,4711,5,9,5,6,27,25,2,32
Krasnodar,4711,6,8,5,7,29,27,2,29
Din Moscow,4711,7,6,7,7,23,25,-2,25
FK Rubin,4711,8,6,5,9,24,21,3,23
Amkar,4711,9,5,4,11,13,26,-13,19
Rostov,4711,10,4,6,10,11,23,-12,18
Anzhi,4711,11,2,5,13,15,42,-27,11
Loko Moscow,4712,1,11,6,3,31,14,17,39
CSKA Moscow,4712,2,11,3,6,27,19,8,36
Zenit,4712,3,8,9,3,23,14,9,33
Spart Moscow,4712,4,9,6,5,34,27,7,33
Krasnodar,4712,5,9,5,6,30,26,4,32
Terek Grozny,4712,6,8,6,6,24,24,0,30
Din Moscow,4712,7,6,7,7,20,22,-2,25
FK Rubin,4712,8,5,6,9,23,21,2,21
Rostov,4712,9,5,6,9,12,17,-5,21
Amkar,4712,10,4,5,11,11,25,-14,17
Anzhi,4712,11,2,5,13,15,41,-26,11
Loko Moscow,4713,1,11,7,2,30,12,18,40
CSKA Moscow,4713,2,11,3,6,29,20,9,36
Spart Moscow,4713,3,9,6,5,34,26,8,33
Krasnodar,4713,4,9,5,6,29,24,5,32
Zenit,4713,5,7,9,4,22,16,6,30
Terek Grozny,4713,6,8,6,6,22,23,-1,30
Din Moscow,4713,7,7,6,7,21,22,-1,27
FK Rubin,4713,8,5,5,10,22,22,0,20
Rostov,4713,9,4,6,10,10,18,-8,18
Amkar,4713,10,4,5,11,9,23,-14,17
Anzhi,4713,11,3,6,11,18,40,-22,15
Loko Moscow,4714,1,11,5,4,30,14,16,38
CSKA Moscow,4714,2,11,4,5,27,18,9,37
Zenit,4714,3,8,9,3,22,13,9,33
Spart Moscow,4714,4,9,5,6,36,29,7,32
Krasnodar,4714,5,9,5,6,29,25,4,32
Terek Grozny,4714,6,8,6,6,22,23,-1,30
FK Rubin,4714,7,5,7,8,21,17,4,22
Din Moscow,4714,8,5,7,8,18,23,-5,22
Rostov,4714,9,5,6,9,11,17,-6,21
Amkar,4714,10,5,5,10,12,24,-12,20
Anzhi,4714,11,2,5,13,15,40,-25,11
Loko Moscow,4715,1,11,5,4,31,15,16,38
Spart Moscow,4715,2,10,6,4,38,28,10,36
CSKA Moscow,4715,3,10,5,5,27,19,8,35
Zenit,4715,4,8,9,3,24,15,9,33
Krasnodar,4715,5,9,5,6,30,26,4,32
Terek Grozny,4715,6,9,5,6,24,23,1,32
FK Rubin,4715,7,5,7,8,23,19,4,22
Din Moscow,4715,8,5,7,8,19,24,-5,22
Rostov,4715,9,4,6,10,11,19,-8,18
Amkar,4715,10,4,5,11,10,24,-14,17
Anzhi,4715,11,2,6,12,16,41,-25,12
Loko Moscow,4716,1,12,6,2,31,12,19,42
Spart Moscow,4716,2,9,7,4,36,26,10,34
CSKA Moscow,4716,3,10,4,6,27,20,7,34
Zenit,4716,4,8,9,3,24,15,9,33
Krasnodar,4716,5,8,5,7,27,25,2,29
Terek Grozny,4716,6,8,5,7,22,25,-3,29
FK Rubin,4716,7,6,6,8,22,17,5,24
Din Moscow,4716,8,5,6,9,17,24,-7,21
Rostov,4716,9,4,7,9,11,18,-7,19
Amkar,4716,10,4,5,11,9,23,-14,17
Anzhi,4716,11,3,6,11,18,39,-21,15
Loko Moscow,4717,1,13,5,2,31,11,20,44
Spart Moscow,4717,2,11,5,4,39,27,12,38
CSKA Moscow,4717,3,11,3,6,30,21,9,36
Zenit,4717,4,8,8,4,24,16,8,32
Krasnodar,4717,5,9,4,7,30,26,4,31
Terek Grozny,4717,6,8,5,7,24,26,-2,29
FK Rubin,4717,7,6,5,9,24,20,4,23
Din Moscow,4717,8,5,6,9,18,25,-7,21
Rostov,4717,9,4,6,10,11,20,-9,18
Amkar,4717,10,4,4,12,11,26,-15,16
Anzhi,4717,11,3,5,12,17,41,-24,14
Loko Moscow,4718,1,11,6,3,30,14,16,39
CSKA Moscow,4718,2,11,3,6,28,20,8,36
Krasnodar,4718,3,9,4,7,29,25,4,31
Zenit,4718,4,7,9,4,23,16,7,30
Spart Moscow,4718,5,8,6,6,34,29,5,30
Din Moscow,4718,6,7,6,7,23,22,1,27
Terek Grozny,4718,7,7,5,8,20,27,-7,26
FK Rubin,4718,8,6,5,9,22,20,2,23
Amkar,4718,9,6,4,10,14,22,-8,22
Rostov,4718,10,4,7,9,10,17,-7,19
Anzhi,4718,11,4,5,11,17,38,-21,17
Loko Moscow,4719,1,11,7,2,32,14,18,40
CSKA Moscow,4719,2,11,3,6,28,20,8,36
Zenit,4719,3,8,9,3,24,14,10,33
Spart Moscow,4719,4,9,6,5,38,29,9,33
Krasnodar,4719,5,9,5,6,31,27,4,32
Din Moscow,4719,6,7,6,7,21,22,-1,27
Terek Grozny,4719,7,7,6,7,23,26,-3,27
FK Rubin,4719,8,5,5,10,22,20,2,20
Rostov,4719,9,4,6,10,10,20,-10,18
Amkar,4719,10,4,6,10,11,24,-13,18
Anzhi,4719,11,3,5,12,18,42,-24,14
Loko Moscow,4720,1,11,6,3,31,14,17,39
CSKA Moscow,4720,2,12,3,5,32,17,15,39
Krasnodar,4720,3,10,4,6,29,24,5,34
Spart Moscow,4720,4,9,6,5,41,32,9,33
Zenit,4720,5,7,9,4,23,18,5,30
Din Moscow,4720,6,7,6,7,24,24,0,27
Terek Grozny,4720,7,7,6,7,20,23,-3,27
FK Rubin,4720,8,5,5,10,22,21,1,20
Rostov,4720,9,4,7,9,13,20,-7,19
Amkar,4720,10,5,4,11,10,25,-15,19
Anzhi,4720,11,2,6,12,14,41,-27,12
Loko Moscow,4721,1,11,6,3,30,14,16,39
CSKA Moscow,4721,2,11,4,5,29,20,9,37
Spart Moscow,4721,3,10,6,4,38,26,12,36
Krasnodar,4721,4,10,4,6,31,25,6,34
Zenit,4721,5,7,10,3,22,14,8,31
Terek Grozny,4721,6,7,6,7,21,25,-4,27
Din Moscow,4721,7,5,7,8,17,23,-6,22
FK Rubin,4721,8,5,6,9,21,18,3,21
Rostov,4721,9,4,6,10,11,20,-9,18
Amkar,4721,10,4,6,10,10,23,-13,18
Anzhi,4721,11,3,5,12,18,40,-22,14
Loko Moscow,4722,1,11,7,2,30,12,18,40
CSKA Moscow,4722,2,11,4,5,28,18,10,37
Spart Moscow,4722,3,10,5,5,38,26,12,35
Zenit,4722,4,7,10,3,22,14,8,31
Krasnodar,4722,5,8,6,6,28,25,3,30
Terek Grozny,4722,6,8,5,7,22,24,-2,29
FK Rubin,4722,7,5,7,8,22,18,4,22
Din Moscow,4722,8,5,7,8,17,23,-6,22
Amkar,4722,9,5,4,11,10,23,-13,19
Rostov,4722,10,4,6,10,10,20,-10,18
Anzhi,4722,11,3,5,12,17,41,-24,14
Loko Moscow,4723,1,11,6,3,31,14,17,39
CSKA Moscow,4723,2,11,3,6,27,19,8,36
Krasnodar,4723,3,10,4,6,30,25,5,34
Zenit,4723,4,8,9,3,23,14,9,33
Spart Moscow,4723,5,9,5,6,38,32,6,32
Terek Grozny,4723,6,7,6,7,21,25,-4,27
FK Rubin,4723,7,6,5,9,23,19,4,23
Amkar,4723,8,6,4,10,13,23,-10,22
Rostov,4723,9,5,6,9,13,18,-5,21
Din Moscow,4723,10,5,6,9,20,26,-6,21
Anzhi,4723,11,2,6,12,16,40,-24,12
Loko Moscow,4724,1,13,5,2,36,13,23,44
Spart Moscow,4724,2,9,7,4,36,27,9,34
CSKA Moscow,4724,3,10,4,6,26,19,7,34
Krasnodar,4724,4,9,4,7,31,29,2,31
Zenit,4724,5,7,9,4,23,17,6,30
Terek Grozny,4724,6,7,5,8,20,25,-5,26
Din Moscow,4724,7,6,7,7,18,21,-3,25
FK Rubin,4724,8,5,5,10,22,21,1,20
Rostov,4724,9,4,7,9,11,18,-7,19
Amkar,4724,10,5,4,11,12,24,-12,19
Anzhi,4724,11,4,5,11,16,37,-21,17
Loko Moscow,4725,1,13,5,2,32,11,21,44
Spart Moscow,4725,2,10,6,4,37,27,10,36
CSKA Moscow,4725,3,11,3,6,28,19,9,36
Zenit,4725,4,8,8,4,23,15,8,32
Terek Grozny,4725,5,9,5,6,24,24,0,32
Krasnodar,4725,6,8,4,8,27,27,0,28
Din Moscow,4725,7,6,7,7,19,22,-3,25
FK Rubin,4725,8,6,5,9,22,18,4,23
Rostov,4725,9,4,6,10,11,19,-8,18
Amkar,4725,10,4,4,12,9,24,-15,16
Anzhi,4725,11,2,5,13,16,42,-26,11
Loko Moscow,4726,1,12,6,2,37,16,21,42
CSKA Moscow,4726,2,12,3,5,30,19,11,39
Spart Moscow,4726,3,10,5,5,37,29,8,35
Zenit,4726,4,7,8,5,22,18,4,29
Krasnodar,4726,5,8,5,7,33,32,1,29
Terek Grozny,4726,6,7,5,8,21,25,-4,26
Din Moscow,4726,7,6,6,8,19,24,-5,24
FK Rubin,4726,8,6,5,9,25,20,5,23
Amkar,4726,9,6,4,10,13,22,-9,22
Rostov,4726,10,4,6,10,11,19,-8,18
Anzhi,4726,11,3,5,12,17,41,-24,14
Loko Moscow,4727,1,12,6,2,34,13,21,42
CSKA Moscow,4727,2,11,3,6,31,20,11,36
Zenit,4727,3,8,9,3,26,16,10,33
Spart Moscow,4727,4,8,6,6,33,30,3,30
Terek Grozny,4727,5,8,5,7,23,25,-2,29
Krasnodar,4727,6,8,4,8,27,28,-1,28
Din Moscow,4727,7,6,7,7,19,22,-3,25
FK Rubin,4727,8,6,5,9,23,19,4,23
Amkar,4727,9,6,4,10,11,22,-11,22
Rostov,4727,10,5,6,9,14,17,-3,21
Anzhi,4727,11,2,5,13,16,45,-29,11
Loko Moscow,4728,1,11,6,3,31,14,17,39
Spart Moscow,4728,2,11,5,4,39,26,13,38
CSKA Moscow,4728,3,11,3,6,29,19,10,36
Krasnodar,4728,4,10,4,6,31,26,5,34
Zenit,4728,5,8,9,3,23,14,9,33
Terek Grozny,4728,6,7,5,8,20,26,-6,26
Din Moscow,4728,7,5,7,8,19,25,-6,22
FK Rubin,4728,8,5,6,9,23,20,3,21
Amkar,4728,9,5,4,11,12,23,-11,19
Rostov,4728,10,4,6,10,10,19,-9,18
Anzhi,4728,11,3,5,12,16,41,-25,14
Loko Moscow,4729,1,11,6,3,31,14,17,39
CSKA Moscow,4729,2,11,3,6,29,19,10,36
Zenit,4729,3,9,8,3,25,15,10,35
Spart Moscow,4729,4,9,6,5,37,30,7,33
Terek Grozny,4729,5,9,5,6,24,22,2,32
Krasnodar,4729,6,8,6,6,29,26,3,30
FK Rubin,4729,7,6,6,8,23,18,5,24
Din Moscow,4729,8,5,7,8,19,24,-5,22
Amkar,4729,9,5,4,11,12,25,-13,19
Rostov,4729,10,4,6,10,10,18,-8,18
Anzhi,4729,11,2,5,13,14,42,-28,11
Loko Moscow,4730,1,13,5,2,33,12,21,44
Spart Moscow,4730,2,10,6,4,39,27,12,36
CSKA Moscow,4730,3,10,3,7,25,20,5,33
Zenit,4730,4,8,8,4,23,15,8,32
Terek Grozny,4730,5,9,5,6,23,23,0,32
Krasnodar,4730,6,9,4,7,28,26,2,31
FK Rubin,4730,7,6,5,9,23,19,4,23
Din Moscow,4730,8,5,6,9,18,26,-8,21
Rostov,4730,9,4,6,10,11,19,-8,18
Amkar,4730,10,4,5,11,11,25,-14,17
Anzhi,4730,11,3,5,12,16,38,-22,14
Loko Moscow,4731,1,11,6,3,29,12,17,39
CSKA Moscow,4731,2,11,3,6,27,19,8,36
Spart Moscow,4731,3,9,6,5,36,29,7,33
Zenit,4731,4,8,8,4,22,14,8,32
Krasnodar,4731,5,9,5,6,29,24,5,32
Terek Grozny,4731,6,8,5,7,23,27,-4,29
Din Moscow,4731,7,6,6,8,19,23,-4,24
FK Rubin,4731,8,5,5,10,21,20,1,20
Rostov,4731,9,4,7,9,10,17,-7,19
Amkar,4731,10,5,4,11,13,25,-12,19
Anzhi,4731,11,4,5,11,20,39,-19,17
Loko Moscow,4732,1,12,5,3,33,14,19,41
CSKA Moscow,4732,2,11,4,5,33,19,14,37
Spart Moscow,4732,3,9,5,6,38,33,5,32
Krasnodar,4732,4,9,4,7,30,26,4,31
Zenit,4732,5,7,9,4,23,18,5,30
Terek Grozny,4732,6,8,5,7,23,25,-2,29
Din Moscow,4732,7,6,6,8,20,24,-4,24
FK Rubin,4732,8,6,5,9,22,20,2,23
Amkar,4732,9,6,4,10,16,23,-7,22
Rostov,4732,10,5,6,9,13,18,-5,21
Anzhi,4732,11,2,5,13,15,46,-31,11
Loko Moscow,4733,1,12,5,3,31,13,18,41
Spart Moscow,4733,2,10,6,4,37,27,10,36
CSKA Moscow,4733,3,10,4,6,26,19,7,34
Krasnodar,4733,4,10,4,6,29,24,5,34
Zenit,4733,5,8,8,4,23,15,8,32
Terek Grozny,4733,6,7,5,8,23,29,-6,26
Din Moscow,4733,7,6,6,8,18,22,-4,24
FK Rubin,4733,8,5,5,10,21,19,2,20
Rostov,4733,9,4,7,9,12,19,-7,19
Amkar,4733,10,5,4,11,12,24,-12,19
Anzhi,4733,11,3,6,11,19,40,-21,15
Loko Moscow,4734,1,11,6,3,30,13,17,39
CSKA Moscow,4734,2,11,4,5,29,19,10,37
Spart Moscow,4734,3,10,5,5,36,29,7,35
Terek Grozny,4734,4,9,5,6,22,22,0,32
Zenit,4734,5,7,10,3,24,16,8,31
Krasnodar,4734,6,9,4,7,28,25,3,31
Din Moscow,4734,7,7,6,7,22,21,1,27
FK Rubin,4734,8,6,5,9,22,19,3,23
Rostov,4734,9,4,6,10,11,19,-8,18
Amkar,4734,10,4,4,12,9,24,-15,16
Anzhi,4734,11,2,5,13,14,40,-26,11
Loko Moscow,4735,1,12,6,2,31,12,19,42
CSKA Moscow,4735,2,12,3,5,33,17,16,39
Spart Moscow,4735,3,10,5,5,41,29,12,35
Krasnodar,4735,4,9,4,7,30,25,5,31
Zenit,4735,5,7,9,4,22,17,5,30
Terek Grozny,4735,6,7,7,6,20,22,-2,28
Din Moscow,4735,7,6,7,7,21,23,-2,25
FK Rubin,4735,8,5,6,9,21,20,1,21
Rostov,4735,9,4,6,10,10,21,-11,18
Amkar,4735,10,4,5,11,9,24,-15,17
Anzhi,4735,11,2,6,12,14,42,-28,12
Loko Moscow,4736,1,12,6,2,32,12,20,42
CSKA Moscow,4736,2,11,3,6,26,18,8,36
Zenit,4736,3,8,9,3,23,14,9,33
Spart Moscow,4736,4,9,6,5,34,27,7,33
Krasnodar,4736,5,9,4,7,28,26,2,31
Terek Grozny,4736,6,8,6,6,25,26,-1,30
FK Rubin,4736,7,6,5,9,23,18,5,23
Din Moscow,4736,8,5,6,9,17,24,-7,21
Amkar,4736,9,5,5,10,13,24,-11,20
Rostov,4736,10,4,7,9,10,17,-7,19
Anzhi,4736,11,2,5,13,16,41,-25,11
Loko Moscow,4737,1,13,5,2,33,11,22,44
CSKA Moscow,4737,2,12,3,5,31,19,12,39
Spart Moscow,4737,3,10,6,4,40,29,11,36
Krasnodar,4737,4,9,4,7,31,26,5,31
Terek Grozny,4737,5,8,6,6,24,24,0,30
Zenit,4737,6,7,8,5,23,19,4,29
FK Rubin,4737,7,6,5,9,23,21,2,23
Din Moscow,4737,8,5,6,9,17,24,-7,21
Rostov,4737,9,4,6,10,13,21,-8,18
Amkar,4737,10,4,6,10,12,25,-13,18
Anzhi,4737,11,2,5,13,14,42,-28,11
Loko Moscow,4738,1,13,5,2,34,13,21,44
CSKA Moscow,4738,2,11,3,6,30,19,11,36
Spart Moscow,4738,3,9,7,4,41,29,12,34
Zenit,4738,4,8,8,4,24,16,8,32
Terek Grozny,4738,5,9,5,6,27,25,2,32
Krasnodar,4738,6,8,5,7,29,28,1,29
Din Moscow,4738,7,5,8,7,19,23,-4,23
FK Rubin,4738,8,5,7,8,22,18,4,22
Rostov,4738,9,4,7,9,11,18,-7,19
Amkar,4738,10,4,4,12,12,30,-18,16
Anzhi,4738,11,2,5,13,15,45,-30,11
Loko Moscow,4739,1,12,6,2,32,11,21,42
CSKA Moscow,4739,2,11,4,5,28,19,9,37
Spart Moscow,4739,3,10,5,5,39,30,9,35
Terek Grozny,4739,4,9,5,6,24,24,0,32
Krasnodar,4739,5,9,4,7,30,28,2,31
Zenit,4739,6,7,9,4,21,14,7,30
FK Rubin,4739,7,6,5,9,23,20,3,23
Din Moscow,4739,8,5,6,9,18,24,-6,21
Rostov,4739,9,5,6,9,12,18,-6,21
Amkar,4739,10,4,4,12,11,26,-15,16
Anzhi,4739,11,2,6,12,18,42,-24,12
Loko Moscow,4740,1,12,5,3,33,14,19,41
CSKA Moscow,4740,2,11,3,6,29,21,8,36
Spart Moscow,4740,3,9,7,4,36,27,9,34
Krasnodar,4740,4,10,4,6,34,26,8,34
Zenit,4740,5,8,8,4,25,16,9,32
Terek Grozny,4740,6,9,5,6,23,22,1,32
Din Moscow,4740,7,5,8,7,18,22,-4,23
FK Rubin,4740,8,5,6,9,21,21,0,21
Rostov,4740,9,4,6,10,11,19,-8,18
Amkar,4740,10,4,5,11,9,23,-14,17
Anzhi,4740,11,2,5,13,14,42,-28,11
Loko Moscow,4741,1,12,5,3,31,12,19,41
CSKA Moscow,4741,2,12,3,5,29,19,10,39
Spart Moscow,4741,3,9,7,4,36,26,10,34
Krasnodar,4741,4,10,4,6,30,25,5,34
Zenit,4741,5,7,8,5,21,16,5,29
Terek Grozny,4741,6,8,5,7,22,24,-2,29
FK Rubin,4741,7,6,5,9,23,19,4,23
Din Moscow,4741,8,5,7,8,18,23,-5,22
Amkar,4741,9,5,5,10,11,23,-12,20
Rostov,4741,10,4,6,10,10,19,-9,18
Anzhi,4741,11,2,5,13,16,41,-25,11
Loko Moscow,4742,1,12,5,3,32,14,18,41
CSKA Moscow,4742,2,11,3,6,29,19,10,36
Spart Moscow,4742,3,10,5,5,39,30,9,35
Zenit,4742,4,8,8,4,24,15,9,32
Krasnodar,4742,5,9,5,6,29,25,4,32
Terek Grozny,4742,6,8,5,7,22,25,-3,29
Din Moscow,4742,7,7,6,7,22,21,1,27
FK Rubin,4742,8,5,6,9,21,19,2,21
Rostov,4742,9,4,6,10,11,19,-8,18
Amkar,4742,10,4,4,12,10,28,-18,16
Anzhi,4742,11,3,5,12,17,41,-24,14
Loko Moscow,4743,1,12,5,3,32,15,17,41
CSKA Moscow,4743,2,10,3,7,26,21,5,33
Zenit,4743,3,8,8,4,24,15,9,32
Spart Moscow,4743,4,8,7,5,34,27,7,31
Krasnodar,4743,5,9,4,7,31,27,4,31
Terek Grozny,4743,6,8,6,6,24,24,0,30
Din Moscow,4743,7,6,7,7,19,21,-2,25
FK Rubin,4743,8,6,5,9,23,20,3,23
Rostov,4743,9,5,6,9,11,17,-6,21
Amkar,4743,10,4,5,11,11,26,-15,17
Anzhi,4743,11,3,6,11,17,39,-22,15
Loko Moscow,4744,1,12,6,2,34,15,19,42
CSKA Moscow,4744,2,11,3,6,27,19,8,36
Spart Moscow,4744,3,10,5,5,41,30,11,35
Zenit,4744,4,8,8,4,23,15,8,32
Krasnodar,4744,5,9,5,6,32,27,5,32
Terek Grozny,4744,6,7,7,6,21,23,-2,28
Din Moscow,4744,7,6,6,8,23,26,-3,24
FK Rubin,4744,8,5,5,10,23,23,0,20
Amkar,4744,9,5,5,10,12,24,-12,20
Rostov,4744,10,4,6,10,11,21,-10,18
Anzhi,4744,11,2,6,12,15,39,-24,12
Loko Moscow,4745,1,12,5,3,31,13,18,41
CSKA Moscow,4745,2,12,3,5,27,17,10,39
Spart Moscow,4745,3,9,6,5,35,26,9,33
Krasnodar,4745,4,9,4,7,30,27,3,31
Zenit,4745,5,7,8,5,21,15,6,29
Terek Grozny,4745,6,8,5,7,23,24,-1,29
Din Moscow,4745,7,6,6,8,18,23,-5,24
FK Rubin,4745,8,6,5,9,23,19,4,23
Amkar,4745,9,6,4,10,12,23,-11,22
Rostov,4745,10,4,7,9,10,17,-7,19
Anzhi,4745,11,2,5,13,14,40,-26,11
Loko Moscow,4746,1,12,6,2,33,13,20,42
Spart Moscow,4746,2,10,6,4,37,26,11,36
CSKA Moscow,4746,3,11,3,6,27,20,7,36
Zenit,4746,4,8,9,3,26,16,10,33
Krasnodar,4746,5,9,4,7,28,26,2,31
Terek Grozny,4746,6,8,6,6,23,23,0,30
FK Rubin,4746,7,6,5,9,23,18,5,23
Din Moscow,4746,8,5,6,9,17,25,-8,21
Rostov,4746,9,4,7,9,11,18,-7,19
Amkar,4746,10,4,5,11,10,24,-14,17
Anzhi,4746,11,2,5,13,14,40,-26,11
Loko Moscow,4747,1,12,5,3,31,12,19,41
Spart Moscow,4747,2,10,6,4,41,28,13,36
CSKA Moscow,4747,3,10,4,6,26,20,6,34
Zenit,4747,4,8,8,4,23,15,8,32
Krasnodar,4747,5,9,4,7,28,25,3,31
Terek Grozny,4747,6,8,5,7,23,26,-3,29
Din Moscow,4747,7,6,6,8,21,25,-4,24
FK Rubin,4747,8,6,5,9,23,19,4,23
Rostov,4747,9,4,6,10,10,21,-11,18
Amkar,4747,10,4,5,11,10,25,-15,17
Anzhi,4747,11,3,6,11,19,39,-20,15
Loko Moscow,4748,1,12,6,2,33,13,20,42
CSKA Moscow,4748,2,11,4,5,29,18,11,37
Spart Moscow,4748,3,10,6,4,39,28,11,36
Zenit,4748,4,7,9,4,22,16,6,30
Krasnodar,4748,5,8,5,7,29,27,2,29
Terek Grozny,4748,6,8,5,7,23,24,-1,29
Din Moscow,4748,7,6,7,7,20,22,-2,25
FK Rubin,4748,8,6,5,9,22,19,3,23
Rostov,4748,9,4,6,10,11,19,-8,18
Amkar,4748,10,4,4,12,10,28,-18,16
Anzhi,4748,11,3,5,12,16,40,-24,14
CSKA Moscow,4749,1,12,3,5,28,17,11,39
Loko Moscow,4749,2,11,5,4,31,15,16,38
Spart Moscow,4749,3,10,5,5,42,26,16,35
Krasnodar,4749,4,10,4,6,30,25,5,34
Zenit,4749,5,8,8,4,24,16,8,32
Terek Grozny,4749,6,8,5,7,23,25,-2,29
Din Moscow,4749,7,7,6,7,20,21,-1,27
FK Rubin,4749,8,5,5,10,22,21,1,20
Rostov,4749,9,4,6,10,10,22,-12,18
Amkar,4749,10,4,4,12,10,28,-18,16
Anzhi,4749,11,3,5,12,16,40,-24,14
Loko Moscow,4750,1,13,5,2,33,12,21,44
Spart Moscow,4750,2,10,6,4,40,27,13,36
CSKA Moscow,4750,3,11,3,6,26,18,8,36
Terek Grozny,4750,4,9,5,6,25,22,3,32
Zenit,4750,5,7,8,5,21,16,5,29
Krasnodar,4750,6,8,5,7,28,26,2,29
Din Moscow,4750,7,6,6,8,19,25,-6,24
FK Rubin,4750,8,5,6,9,22,19,3,21
Rostov,4750,9,4,7,9,12,19,-7,19
Amkar,4750,10,4,4,12,9,26,-17,16
Anzhi,4750,11,3,5,12,15,40,-25,14
Loko Moscow,4751,1,11,6,3,33,16,17,39
CSKA Moscow,4751,2,11,4,5,27,17,10,37
Zenit,4751,3,8,9,3,24,15,9,33
Spart Moscow,4751,4,9,6,5,37,30,7,33
Terek Grozny,4751,5,8,6,6,22,23,-1,30
Krasnodar,4751,6,8,5,7,30,28,2,29
FK Rubin,4751,7,7,5,8,26,19,7,26
Din Moscow,4751,8,5,6,9,20,27,-7,21
Amkar,4751,9,5,5,10,12,23,-11,20
Rostov,4751,10,4,7,9,11,18,-7,19
Anzhi,4751,11,2,5,13,14,40,-26,11
Loko Moscow,4752,1,12,5,3,31,13,18,41
CSKA Moscow,4752,2,12,3,5,29,17,12,39
Spart Moscow,4752,3,10,5,5,36,26,10,35
Krasnodar,4752,4,10,4,6,31,24,7,34
Zenit,4752,5,7,8,5,22,16,6,29
Terek Grozny,4752,6,7,6,7,20,24,-4,27
Din Moscow,4752,7,6,6,8,18,22,-4,24
FK Rubin,4752,8,6,5,9,22,20,2,23
Amkar,4752,9,5,4,11,11,23,-12,19
Rostov,4752,10,4,6,10,10,19,-9,18
Anzhi,4752,11,2,6,12,14,40,-26,12
Loko Moscow,4753,1,12,6,2,31,12,19,42
Spart Moscow,4753,2,10,5,5,39,28,11,35
CSKA Moscow,4753,3,10,4,6,25,19,6,34
Zenit,4753,4,7,10,3,22,14,8,31
Krasnodar,4753,5,9,4,7,32,26,6,31
Terek Grozny,4753,6,8,6,6,22,23,-1,30
Din Moscow,4753,7,6,7,7,20,23,-3,25
FK Rubin,4753,8,5,6,9,23,23,0,21
Rostov,4753,9,4,6,10,11,21,-10,18
Amkar,4753,10,4,5,11,10,24,-14,17
Anzhi,4753,11,3,5,12,16,38,-22,14
Loko Moscow,4754,1,12,6,2,32,13,19,42
CSKA Moscow,4754,2,11,4,5,29,20,9,37
Spart Moscow,4754,3,9,7,4,36,27,9,34
Zenit,4754,4,7,10,3,24,16,8,31
Krasnodar,4754,5,8,4,8,28,30,-2,28
Terek Grozny,4754,6,7,7,6,21,23,-2,28
Din Moscow,4754,7,6,7,7,18,21,-3,25
FK Rubin,4754,8,6,5,9,25,18,7,23
Rostov,4754,9,4,6,10,11,19,-8,18
Amkar,4754,10,4,6,10,11,24,-13,18
Anzhi,4754,11,2,6,12,15,39,-24,12
Loko Moscow,4755,1,13,5,2,35,12,23,44
Spart Moscow,4755,2,10,6,4,40,26,14,36
CSKA Moscow,4755,3,11,3,6,27,22,5,36
Zenit,4755,4,8,8,4,26,16,10,32
Krasnodar,4755,5,9,4,7,33,27,6,31
Terek Grozny,4755,6,7,7,6,21,23,-2,28
Din Moscow,4755,7,6,6,8,19,23,-4,24
FK Rubin,4755,8,5,5,10,21,24,-3,20
Rostov,4755,9,4,6,10,10,21,-11,18
Amkar,4755,10,4,6,10,10,23,-13,18
Anzhi,4755,11,2,6,12,15,40,-25,12
Loko Moscow,4756,1,11,5,4,32,16,16,38
CSKA Moscow,4756,2,11,3,6,29,19,10,36
Zenit,4756,3,9,8,3,25,15,10,35
Spart Moscow,4756,4,10,5,5,36,27,9,35
Krasnodar,4756,5,9,5,6,31,27,4,32
Terek Grozny,4756,6,9,5,6,22,22,0,32
FK Rubin,4756,7,6,6,8,23,18,5,24
Din Moscow,4756,8,5,6,9,18,24,-6,21
Amkar,4756,9,5,4,11,10,23,-13,19
Rostov,4756,10,4,6,10,10,18,-8,18
Anzhi,4756,11,2,5,13,14,41,-27,11
Loko Moscow,4757,1,11,6,3,30,13,17,39
Spart Moscow,4757,2,10,5,5,39,27,12,35
CSKA Moscow,4757,3,10,5,5,25,17,8,35
Terek Grozny,4757,4,9,5,6,24,22,2,32
Zenit,4757,5,7,10,3,21,13,8,31
Krasnodar,4757,6,9,4,7,29,29,0,31
Din Moscow,4757,7,6,6,8,19,23,-4,24
FK Rubin,4757,8,6,5,9,26,19,7,23
Amkar,4757,9,5,4,11,10,25,-15,19
Rostov,4757,10,4,6,10,11,22,-11,18
Anzhi,4757,11,2,6,12,14,38,-24,12
Loko Moscow,4758,1,12,6,2,32,12,20,42
Spart Moscow,4758,2,9,7,4,37,28,9,34
CSKA Moscow,4758,3,10,4,6,26,19,7,34
Zenit,4758,4,7,9,4,22,16,6,30
Krasnodar,4758,5,8,6,6,28,25,3,30
Terek Grozny,4758,6,8,5,7,22,26,-4,29
Din Moscow,4758,7,6,6,8,21,24,-3,24
FK Rubin,4758,8,5,6,9,23,21,2,21
Amkar,4758,9,5,5,10,13,23,-10,20
Rostov,4758,10,4,7,9,11,18,-7,19
Anzhi,4758,11,3,5,12,17,40,-23,14
Loko Moscow,4759,1,13,5,2,34,14,20,44
CSKA Moscow,4759,2,11,3,6,27,19,8,36
Spart Moscow,4759,3,9,7,4,36,27,9,34
Zenit,4759,4,8,8,4,24,16,8,32
Krasnodar,4759,5,9,4,7,31,28,3,31
Terek Grozny,4759,6,7,5,8,21,25,-4,26
FK Rubin,4759,7,6,5,9,26,22,4,23
Din Moscow,4759,8,5,6,9,19,25,-6,21
Amkar,4759,9,5,5,10,12,24,-12,20
Rostov,4759,10,4,7,9,10,17,-7,19
Anzhi,4759,11,3,5,12,17,40,-23,14
Loko Moscow,4760,1,13,5,2,33,11,22,44
CSKA Moscow,4760,2,11,3,6,27,20,7,36
Spart Moscow,4760,3,10,5,5,41,27,14,35
Zenit,4760,4,8,8,4,24,15,9,32
Krasnodar,4760,5,9,4,7,30,27,3,31
Terek Grozny,4760,6,8,6,6,22,23,-1,30
FK Rubin,4760,7,6,5,9,24,21,3,23
Din Moscow,4760,8,5,6,9,19,27,-8,21
Amkar,4760,9,5,5,10,11,23,-12,20
Rostov,4760,10,4,6,10,10,22,-12,18
Anzhi,4760,11,2,5,13,14,39,-25,11
Loko Moscow,4761,1,12,5,3,33,13,20,41
Spart Moscow,4761,2,10,5,5,40,30,10,35
CSKA Moscow,4761,3,10,5,5,27,19,8,35
Krasnodar,4761,4,10,4,6,31,26,5,34
Zenit,4761,5,7,9,4,22,17,5,30
Terek Grozny,4761,6,8,5,7,22,25,-3,29
Din Moscow,4761,7,6,6,8,21,25,-4,24
Amkar,4761,8,6,4,10,14,24,-10,22
FK Rubin,4761,9,5,5,10,23,21,2,20
Rostov,4761,10,4,6,10,11,20,-9,18
Anzhi,4761,11,2,6,12,15,39,-24,12
Loko Moscow,4762,1,11,6,3,32,15,17,39
CSKA Moscow,4762,2,11,3,6,31,20,11,36
Spart Moscow,4762,3,10,5,5,39,28,11,35
Zenit,4762,4,8,9,3,24,15,9,33
Krasnodar,4762,5,9,5,6,31,27,4,32
Terek Grozny,4762,6,8,6,6,21,22,-1,30
Din Moscow,4762,7,7,6,7,20,22,-2,27
FK Rubin,4762,8,5,6,9,23,20,3,21
Rostov,4762,9,4,6,10,11,21,-10,18
Amkar,4762,10,4,5,11,10,24,-14,17
Anzhi,4762,11,2,5,13,15,43,-28,11
Loko Moscow,4763,1,12,5,3,30,14,16,41
Spart Moscow,4763,2,11,5,4,39,27,12,38
CSKA Moscow,4763,3,11,3,6,26,19,7,36
Zenit,4763,4,9,8,3,26,13,13,35
Krasnodar,4763,5,8,5,7,28,26,2,29
Terek Grozny,4763,6,7,7,6,22,24,-2,28
FK Rubin,4763,7,6,6,8,24,19,5,24
Din Moscow,4763,8,5,6,9,18,25,-7,21
Rostov,4763,9,4,6,10,11,19,-8,18
Amkar,4763,10,4,5,11,11,25,-14,17
Anzhi,4763,11,2,6,12,15,39,-24,12
Loko Moscow,4764,1,12,6,2,33,13,20,42
Spart Moscow,4764,2,10,6,4,41,26,15,36
Zenit,4764,3,8,9,3,24,14,10,33
CSKA Moscow,4764,4,10,3,7,25,20,5,33
Terek Grozny,4764,5,8,6,6,23,24,-1,30
Krasnodar,4764,6,8,5,7,29,28,1,29
Din Moscow,4764,7,6,6,8,21,25,-4,24
FK Rubin,4764,8,5,6,9,24,21,3,21
Rostov,4764,9,4,7,9,10,17,-7,19
Amkar,4764,10,4,4,12,10,30,-20,16
Anzhi,4764,11,3,6,11,16,38,-22,15
Loko Moscow,4765,1,12,6,2,34,13,21,42
CSKA Moscow,4765,2,12,3,5,28,17,11,39
Spart Moscow,4765,3,10,6,4,41,30,11,36
Krasnodar,4765,4,8,6,6,29,26,3,30
Zenit,4765,5,7,8,5,23,20,3,29
Terek Grozny,4765,6,7,6,7,20,23,-3,27
FK Rubin,4765,7,5,7,8,23,19,4,22
Din Moscow,4765,8,5,7,8,18,24,-6,22
Rostov,4765,9,4,7,9,14,21,-7,19
Amkar,4765,10,4,5,11,9,23,-14,17
Anzhi,4765,11,3,5,12,15,38,-23,14
Loko Moscow,4766,1,11,6,3,29,12,17,39
Spart Moscow,4766,2,10,6,4,39,29,10,36
CSKA Moscow,4766,3,10,4,6,27,20,7,34
Krasnodar,4766,4,10,4,6,30,24,6,34
Zenit,4766,5,8,9,3,23,14,9,33
Terek Grozny,4766,6,7,6,7,23,26,-3,27
Din Moscow,4766,7,6,7,7,21,23,-2,25
FK Rubin,4766,8,5,5,10,21,21,0,20
Amkar,4766,9,5,4,11,12,25,-13,19
Rostov,4766,10,4,6,10,12,20,-8,18
Anzhi,4766,11,2,7,11,16,39,-23,13
Loko Moscow,4767,1,12,5,3,32,12,20,41
Spart Moscow,4767,2,9,7,4,38,29,9,34
Krasnodar,4767,3,10,4,6,29,24,5,34
CSKA Moscow,4767,4,10,4,6,27,23,4,34
Zenit,4767,5,8,8,4,26,17,9,32
Terek Grozny,4767,6,8,6,6,22,23,-1,30
Din Moscow,4767,7,6,7,7,22,25,-3,25
FK Rubin,4767,8,5,5,10,23,21,2,20
Rostov,4767,9,4,6,10,10,18,-8,18
Amkar,4767,10,4,5,11,12,26,-14,17
Anzhi,4767,11,2,7,11,15,38,-23,13
Loko Moscow,4768,1,11,6,3,31,16,15,39
CSKA Moscow,4768,2,10,5,5,26,18,8,35
Spart Moscow,4768,3,9,5,6,34,29,5,32
Zenit,4768,4,7,10,3,22,14,8,31
Krasnodar,4768,5,9,4,7,31,27,4,31
Din Moscow,4768,6,7,6,7,19,21,-2,27
Terek Grozny,4768,7,7,5,8,23,27,-4,26
FK Rubin,4768,8,6,5,9,23,18,5,23
Rostov,4768,9,5,6,9,13,17,-4,21
Amkar,4768,10,5,4,11,11,24,-13,19
Anzhi,4768,11,3,6,11,18,40,-22,15
Loko Moscow,4769,1,12,6,2,32,12,20,42
CSKA Moscow,4769,2,12,3,5,31,18,13,39
Spart Moscow,4769,3,10,6,4,40,27,13,36
Krasnodar,4769,4,9,5,6,32,28,4,32
Zenit,4769,5,7,8,5,22,17,5,29
Terek Grozny,4769,6,7,7,6,22,24,-2,28
Din Moscow,4769,7,6,7,7,23,23,0,25
FK Rubin,4769,8,5,5,10,24,25,-1,20
Rostov,4769,9,4,6,10,10,19,-9,18
Amkar,4769,10,4,5,11,11,27,-16,17
Anzhi,4769,11,2,6,12,14,41,-27,12
CSKA Moscow,4770,1,12,3,5,30,17,13,39
Loko Moscow,4770,2,11,5,4,32,17,15,38
Spart Moscow,4770,3,10,6,4,36,25,11,36
Krasnodar,4770,4,10,4,6,33,26,7,34
Zenit,4770,5,8,8,4,23,15,8,32
Terek Grozny,4770,6,7,6,7,21,24,-3,27
Din Moscow,4770,7,6,7,7,20,23,-3,25
FK Rubin,4770,8,5,5,10,23,22,1,20
Rostov,4770,9,4,6,10,10,19,-9,18
Amkar,4770,10,4,5,11,9,23,-14,17
Anzhi,4770,11,3,5,12,16,42,-26,14
Loko Moscow,4771,1,11,6,3,29,12,17,39
Spart Moscow,4771,2,10,5,5,37,27,10,35
CSKA Moscow,4771,3,10,4,6,27,20,7,34
Zenit,4771,4,8,9,3,22,13,9,33
Krasnodar,4771,5,9,5,6,30,26,4,32
Terek Grozny,4771,6,9,5,6,23,22,1,32
FK Rubin,4771,7,5,7,8,23,19,4,22
Din Moscow,4771,8,5,7,8,17,23,-6,22
Amkar,4771,9,5,4,11,11,25,-14,19
Rostov,4771,10,4,6,10,10,18,-8,18
Anzhi,4771,11,2,6,12,16,40,-24,12
CSKA Moscow,4772,1,12,3,5,29,17,12,39
Loko Moscow,4772,2,11,5,4,30,17,13,38
Zenit,4772,3,8,8,4,24,17,7,32
Krasnodar,4772,4,9,5,6,31,25,6,32
Spart Moscow,4772,5,8,5,7,34,32,2,29
Terek Grozny,4772,6,7,6,7,22,26,-4,27
Din Moscow,4772,7,6,7,7,22,22,0,25
FK Rubin,4772,8,5,7,8,23,19,4,22
Rostov,4772,9,5,6,9,12,18,-6,21
Amkar,4772,10,5,5,10,11,23,-12,20
Anzhi,4772,11,3,5,12,17,39,-22,14
Loko Moscow,4773,1,12,6,2,33,14,19,42
CSKA Moscow,4773,2,11,4,5,28,18,10,37
Spart Moscow,4773,3,10,5,5,42,31,11,35
Zenit,4773,4,7,10,3,22,14,8,31
Krasnodar,4773,5,8,4,8,30,30,0,28
Terek Grozny,4773,6,7,7,6,21,23,-2,28
FK Rubin,4773,7,7,5,8,26,18,8,26
Din Moscow,4773,8,5,6,9,18,26,-8,21
Amkar,4773,9,5,5,10,12,24,-12,20
Rostov,4773,10,4,6,10,12,21,-9,18
Anzhi,4773,11,2,6,12,16,41,-25,12
Loko Moscow,4774,1,12,6,2,32,12,20,42
CSKA Moscow,4774,2,11,3,6,26,18,8,36
Zenit,4774,3,8,9,3,22,13,9,33
Krasnodar,4774,4,9,4,7,32,27,5,31
Terek Grozny,4774,5,8,6,6,21,22,-1,30
Spart Moscow,4774,6,8,5,7,34,29,5,29
Din Moscow,4774,7,6,7,7,20,23,-3,25
FK Rubin,4774,8,5,6,9,23,23,0,21
Rostov,4774,9,5,6,9,12,18,-6,21
Amkar,4774,10,5,5,10,10,22,-12,20
Anzhi,4774,11,2,5,13,14,39,-25,11
Loko Moscow,4775,1,12,5,3,31,14,17,41
Spart Moscow,4775,2,11,5,4,40,26,14,38
Krasnodar,4775,3,10,4,6,34,24,10,34
CSKA Moscow,4775,4,10,3,7,26,21,5,33
Zenit,4775,5,8,8,4,23,15,8,32
Terek Grozny,4775,6,8,5,7,22,24,-2,29
FK Rubin,4775,7,6,5,9,23,21,2,23
Din Moscow,4775,8,5,6,9,17,26,-9,21
Amkar,4775,9,5,4,11,12,24,-12,19
Rostov,4775,10,4,6,10,10,19,-9,18
Anzhi,4775,11,3,5,12,16,40,-24,14
Spart Moscow,4776,1,11,5,4,39,26,13,38
Loko Moscow,4776,2,11,5,4,30,17,13,38
CSKA Moscow,4776,3,11,3,6,29,19,10,36
Zenit,4776,4,9,8,3,25,14,11,35
Krasnodar,4776,5,10,4,6,32,24,8,34
Terek Grozny,4776,6,8,5,7,22,25,-3,29
FK Rubin,4776,7,6,5,9,24,20,4,23
Din Moscow,4776,8,5,6,9,18,25,-7,21
Amkar,4776,9,5,4,11,11,24,-13,19
Rostov,4776,10,4,6,10,11,20,-9,18
Anzhi,4776,11,2,5,13,16,43,-27,11
Loko Moscow,4777,1,13,5,2,32,11,21,44
CSKA Moscow,4777,2,11,3,6,27,19,8,36
Zenit,4777,3,8,8,4,23,15,8,32
Spart Moscow,4777,4,8,6,6,34,30,4,30
Terek Grozny,4777,5,8,6,6,24,24,0,30
Krasnodar,4777,6,8,5,7,28,27,1,29
Din Moscow,4777,7,6,7,7,21,22,-1,25
FK Rubin,4777,8,5,7,8,23,19,4,22
Amkar,4777,9,5,5,10,11,23,-12,20
Rostov,4777,10,4,7,9,11,18,-7,19
Anzhi,4777,11,2,5,13,15,41,-26,11
Loko Moscow,4778,1,11,6,3,30,13,17,39
Zenit,4778,2,9,8,3,24,13,11,35
CSKA Moscow,4778,3,10,4,6,26,20,6,34
Spart Moscow,4778,4,9,5,6,37,31,6,32
Krasnodar,4778,5,9,5,6,29,25,4,32
Terek Grozny,4778,6,8,6,6,22,23,-1,30
FK Rubin,4778,7,6,5,9,22,18,4,23
Rostov,4778,8,5,6,9,13,18,-5,21
Din Moscow,4778,9,5,6,9,18,25,-7,21
Amkar,4778,10,5,5,10,11,22,-11,20
Anzhi,4778,11,2,6,12,16,40,-24,12
Loko Moscow,4779,1,11,6,3,30,13,17,39
CSKA Moscow,4779,2,11,3,6,28,20,8,36
Spart Moscow,4779,3,9,7,4,37,28,9,34
Krasnodar,4779,4,10,4,6,32,25,7,34
Zenit,4779,5,7,9,4,21,15,6,30
Terek Grozny,4779,6,8,6,6,22,23,-1,30
Din Moscow,4779,7,5,8,7,19,23,-4,23
FK Rubin,4779,8,5,6,9,22,21,1,21
Rostov,4779,9,4,7,9,11,18,-7,19
Amkar,4779,10,4,4,12,10,25,-15,16
Anzhi,4779,11,3,6,11,18,39,-21,15
Loko Moscow,4780,1,11,6,3,30,13,17,39
Spart Moscow,4780,2,10,6,4,37,26,11,36
CSKA Moscow,4780,3,10,5,5,27,19,8,35
Zenit,4780,4,8,9,3,23,14,9,33
Krasnodar,4780,5,8,5,7,28,26,2,29
Terek Grozny,4780,6,7,6,7,20,23,-3,27
Din Moscow,4780,7,6,7,7,20,23,-3,25
FK Rubin,4780,8,6,5,9,23,19,4,23
Amkar,4780,9,5,4,11,10,24,-14,19
Rostov,4780,10,4,6,10,10,18,-8,18
Anzhi,4780,11,2,7,11,15,38,-23,13
Loko Moscow,4781,1,11,5,4,29,17,12,38
Spart Moscow,4781,2,10,6,4,41,28,13,36
Zenit,4781,3,9,8,3,24,13,11,35
CSKA Moscow,4781,4,10,4,6,27,21,6,34
Krasnodar,4781,5,9,5,6,34,26,8,32
Terek Grozny,4781,6,7,6,7,20,23,-3,27
FK Rubin,4781,7,6,6,8,24,19,5,24
Din Moscow,4781,8,5,7,8,19,24,-5,22
Rostov,4781,9,4,6,10,11,20,-9,18
Amkar,4781,10,4,5,11,9,25,-16,17
Anzhi,4781,11,3,6,11,17,39,-22,15
Loko Moscow,4782,1,13,5,2,33,11,22,44
CSKA Moscow,4782,2,12,3,5,28,17,11,39
Spart Moscow,4782,3,8,7,5,35,28,7,31
Zenit,4782,4,7,8,5,21,17,4,29
Krasnodar,4782,5,8,5,7,29,28,1,29
Terek Grozny,4782,6,8,5,7,23,24,-1,29
Din Moscow,4782,7,5,8,7,18,22,-4,23
FK Rubin,4782,8,5,7,8,23,19,4,22
Rostov,4782,9,5,6,9,11,17,-6,21
Amkar,4782,10,4,5,11,11,26,-15,17
Anzhi,4782,11,3,5,12,15,38,-23,14
Loko Moscow,4783,1,13,5,2,33,13,20,44
Spart Moscow,4783,2,10,6,4,38,27,11,36
CSKA Moscow,4783,3,11,3,6,28,21,7,36
Zenit,4783,4,8,8,4,25,15,10,32
Krasnodar,4783,5,9,4,7,30,27,3,31
Terek Grozny,4783,6,7,6,7,23,26,-3,27
Din Moscow,4783,7,6,6,8,19,23,-4,24
FK Rubin,4783,8,5,5,10,22,20,2,20
Rostov,4783,9,4,7,9,11,18,-7,19
Amkar,4783,10,5,4,11,11,25,-14,19
Anzhi,4783,11,2,6,12,17,42,-25,12
Loko Moscow,4784,1,11,5,4,29,14,15,38
CSKA Moscow,4784,2,11,4,5,29,18,11,37
Krasnodar,4784,3,10,4,6,30,25,5,34
Zenit,4784,4,8,9,3,23,13,10,33
Spart Moscow,4784,5,9,5,6,35,28,7,32
Terek Grozny,4784,6,7,7,6,25,27,-2,28
Din Moscow,4784,7,6,7,7,20,23,-3,25
FK Rubin,4784,8,5,6,9,23,20,3,21
Amkar,4784,9,5,5,10,11,23,-12,20
Rostov,4784,10,4,6,10,10,18,-8,18
Anzhi,4784,11,2,6,12,19,45,-26,12
Loko Moscow,4785,1,13,5,2,35,13,22,44
Spart Moscow,4785,2,9,7,4,36,26,10,34
CSKA Moscow,4785,3,10,3,7,26,21,5,33
Zenit,4785,4,8,8,4,22,16,6,32
Krasnodar,4785,5,9,4,7,30,27,3,31
Terek Grozny,4785,6,8,6,6,22,22,0,30
Din Moscow,4785,7,6,7,7,19,22,-3,25
FK Rubin,4785,8,5,5,10,21,19,2,20
Rostov,4785,9,4,6,10,10,19,-9,18
Amkar,4785,10,4,6,10,9,22,-13,18
Anzhi,4785,11,3,5,12,17,40,-23,14
Loko Moscow,4786,1,11,5,4,30,15,15,38
CSKA Moscow,4786,2,10,4,6,27,21,6,34
Zenit,4786,3,8,9,3,24,15,9,33
Terek Grozny,4786,4,9,5,6,23,23,0,32
Krasnodar,4786,5,9,4,7,30,26,4,31
Spart Moscow,4786,6,8,6,6,34,28,6,30
FK Rubin,4786,7,7,5,8,25,17,8,26
Din Moscow,4786,8,5,7,8,18,25,-7,22
Rostov,4786,9,5,6,9,11,17,-6,21
Amkar,4786,10,5,4,11,11,24,-13,19
Anzhi,4786,11,3,5,12,16,38,-22,14
Loko Moscow,4787,1,12,6,2,35,14,21,42
Spart Moscow,4787,2,11,5,4,39,26,13,38
CSKA Moscow,4787,3,11,3,6,30,21,9,36
Zenit,4787,4,8,8,4,25,19,6,32
Krasnodar,4787,5,9,5,6,30,26,4,32
Terek Grozny,4787,6,8,5,7,25,26,-1,29
FK Rubin,4787,7,6,5,9,24,18,6,23
Din Moscow,4787,8,5,6,9,18,27,-9,21
Amkar,4787,9,5,4,11,11,23,-12,19
Rostov,4787,10,4,6,10,10,19,-9,18
Anzhi,4787,11,2,5,13,17,45,-28,11
Loko Moscow,4788,1,12,5,3,32,14,18,41
CSKA Moscow,4788,2,11,4,5,26,17,9,37
Spart Moscow,4788,3,9,6,5,39,30,9,33
Zenit,4788,4,8,9,3,24,15,9,33
Terek Grozny,4788,5,9,5,6,23,23,0,32
Krasnodar,4788,6,8,4,8,29,29,0,28
FK Rubin,4788,7,6,6,8,26,20,6,24
Din Moscow,4788,8,5,7,8,18,24,-6,22
Rostov,4788,9,5,6,9,13,19,-6,21
Amkar,4788,10,4,5,11,12,26,-14,17
Anzhi,4788,11,2,5,13,14,39,-25,11
Loko Moscow,4789,1,12,6,2,33,14,19,42
Spart Moscow,4789,2,10,6,4,37,26,11,36
CSKA Moscow,4789,3,11,3,6,27,19,8,36
Zenit,4789,4,8,8,4,23,15,8,32
Krasnodar,4789,5,8,6,6,31,28,3,30
Terek Grozny,4789,6,7,7,6,22,24,-2,28
Din Moscow,4789,7,6,6,8,19,22,-3,24
FK Rubin,4789,8,5,6,9,23,21,2,21
Rostov,4789,9,4,6,10,10,19,-9,18
Amkar,4789,10,4,6,10,11,24,-13,18
Anzhi,4789,11,2,6,12,16,40,-24,12
Loko Moscow,4790,1,12,6,2,32,13,19,42
CSKA Moscow,4790,2,11,4,5,27,17,10,37
Spart Moscow,4790,3,9,5,6,35,28,7,32
Zenit,4790,4,7,10,3,22,14,8,31
Krasnodar,4790,5,9,4,7,30,26,4,31
Terek Grozny,4790,6,8,5,7,22,26,-4,29
Din Moscow,4790,7,7,6,7,19,21,-2,27
FK Rubin,4790,8,5,5,10,21,20,1,20
Amkar,4790,9,5,4,11,11,25,-14,19
Rostov,4790,10,4,6,10,10,18,-8,18
Anzhi,4790,11,3,5,12,18,39,-21,14
Loko Moscow,4791,1,13,5,2,37,14,23,44
Spart Moscow,4791,2,11,5,4,39,27,12,38
CSKA Moscow,4791,3,11,4,5,28,19,9,37
Zenit,4791,4,7,9,4,22,17,5,30
Krasnodar,4791,5,8,4,8,31,31,0,28
Terek Grozny,4791,6,7,5,8,22,28,-6,26
FK Rubin,4791,7,6,6,8,25,20,5,24
Din Moscow,4791,8,5,7,8,20,26,-6,22
Amkar,4791,9,5,4,11,13,24,-11,19
Rostov,4791,10,4,6,10,10,18,-8,18
Anzhi,4791,11,3,5,12,18,41,-23,14
Loko Moscow,4792,1,11,6,3,30,15,15,39
CSKA Moscow,4792,2,11,3,6,31,21,10,36
Spart Moscow,4792,3,9,7,4,38,28,10,34
Zenit,4792,4,8,9,3,26,16,10,33
Krasnodar,4792,5,9,4,7,31,28,3,31
Terek Grozny,4792,6,8,6,6,23,22,1,30
FK Rubin,4792,7,6,6,8,25,18,7,24
Din Moscow,4792,8,5,7,8,17,23,-6,22
Rostov,4792,9,4,7,9,11,18,-7,19
Amkar,4792,10,4,6,10,11,24,-13,18
Anzhi,4792,11,2,5,13,14,44,-30,11
Loko Moscow,4793,1,11,7,2,31,13,18,40
Spart Moscow,4793,2,10,5,5,39,26,13,35
Zenit,4793,3,8,9,3,26,16,10,33
CSKA Moscow,4793,4,10,3,7,27,22,5,33
Krasnodar,4793,5,8,5,7,29,27,2,29
Terek Grozny,4793,6,8,5,7,24,25,-1,29
FK Rubin,4793,7,6,6,8,24,19,5,24
Din Moscow,4793,8,5,7,8,18,24,-6,22
Amkar,4793,9,6,4,10,13,24,-11,22
Rostov,4793,10,4,6,10,10,21,-11,18
Anzhi,4793,11,3,5,12,15,39,-24,14
Loko Moscow,4794,1,11,6,3,30,13,17,39
CSKA Moscow,4794,2,12,3,5,28,18,10,39
Spart Moscow,4794,3,11,5,4,44,29,15,38
Krasnodar,4794,4,10,4,6,30,24,6,34
Terek Grozny,4794,5,9,5,6,24,22,2,32
Zenit,4794,6,7,9,4,22,15,7,30
FK Rubin,4794,7,6,5,9,24,21,3,23
Din Moscow,4794,8,5,6,9,21,28,-7,21
Rostov,4794,9,4,6,10,12,22,-10,18
Amkar,4794,10,4,4,12,9,25,-16,16
Anzhi,4794,11,2,5,13,15,42,-27,11
Loko Moscow,4795,1,12,6,2,31,12,19,42
CSKA Moscow,4795,2,12,3,5,30,20,10,39
Spart Moscow,4795,3,9,6,5,36,30,6,33
Terek Grozny,4795,4,9,5,6,24,23,1,32
Krasnodar,4795,5,9,4,7,31,26,5,31
Zenit,4795,6,7,9,4,22,15,7,30
Din Moscow,4795,7,6,6,8,22,24,-2,24
FK Rubin,4795,8,6,5,9,23,21,2,23
Rostov,4795,9,4,7,9,10,17,-7,19
Amkar,4795,10,4,4,12,11,26,-15,16
Anzhi,4795,11,2,5,13,16,42,-26,11
Loko Moscow,4796,1,11,5,4,31,15,16,38
Spart Moscow,4796,2,10,6,4,40,29,11,36
CSKA Moscow,4796,3,11,3,6,27,21,6,36
Zenit,4796,4,9,8,3,25,13,12,35
Krasnodar,4796,5,9,4,7,30,27,3,31
Terek Grozny,4796,6,7,7,6,21,23,-2,28
Din Moscow,4796,7,6,6,8,19,23,-4,24
FK Rubin,4796,8,6,5,9,23,19,4,23
Rostov,4796,9,4,7,9,12,19,-7,19
Amkar,4796,10,4,5,11,11,26,-15,17
Anzhi,4796,11,2,6,12,16,40,-24,12
Loko Moscow,4797,1,12,6,2,30,11,19,42
CSKA Moscow,4797,2,11,4,5,28,18,10,37
Krasnodar,4797,3,9,5,6,28,24,4,32
Spart Moscow,4797,4,8,7,5,35,28,7,31
Zenit,4797,5,7,9,4,22,15,7,30
Terek Grozny,4797,6,7,7,6,24,26,-2,28
Din Moscow,4797,7,6,7,7,20,22,-2,25
Rostov,4797,8,5,6,9,11,17,-6,21
FK Rubin,4797,9,5,5,10,21,20,1,20
Amkar,4797,10,4,6,10,12,25,-13,18
Anzhi,4797,11,2,6,12,16,41,-25,12
Loko Moscow,4798,1,12,5,3,32,15,17,41
CSKA Moscow,4798,2,10,4,6,25,18,7,34
Spart Moscow,4798,3,9,6,5,36,28,8,33
Zenit,4798,4,8,8,4,23,15,8,32
Krasnodar,4798,5,9,4,7,30,26,4,31
Din Moscow,4798,6,7,6,7,20,22,-2,27
Terek Grozny,4798,7,7,6,7,21,24,-3,27
FK Rubin,4798,8,6,5,9,22,18,4,23
Rostov,4798,9,4,6,10,10,18,-8,18
Amkar,4798,10,4,6,10,10,23,-13,18
Anzhi,4798,11,3,6,11,16,38,-22,15
Loko Moscow,4799,1,12,5,3,31,13,18,41
CSKA Moscow,4799,2,12,3,5,30,17,13,39
Spart Moscow,4799,3,10,6,4,39,26,13,36
Zenit,4799,4,8,8,4,22,14,8,32
Terek Grozny,4799,5,9,5,6,24,23,1,32
Krasnodar,4799,6,9,4,7,29,26,3,31
FK Rubin,4799,7,6,5,9,23,19,4,23
Din Moscow,4799,8,5,7,8,19,24,-5,22
Rostov,4799,9,4,6,10,10,20,-10,18
Amkar,4799,10,4,4,12,10,27,-17,16
Anzhi,4799,11,2,5,13,14,42,-28,11
CSKA Moscow,4800,1,12,3,5,31,18,13,39
Loko Moscow,4800,2,11,5,4,29,14,15,38
Spart Moscow,4800,3,10,5,5,38,29,9,35
Zenit,4800,4,8,8,4,23,16,7,32
Krasnodar,4800,5,9,4,7,29,25,4,31
Terek Grozny,4800,6,7,6,7,22,25,-3,27
Din Moscow,4800,7,6,7,7,19,22,-3,25
FK Rubin,4800,8,6,6,8,22,17,5,24
Amkar,4800,9,5,4,11,13,26,-13,19
Rostov,4800,10,4,6,10,11,19,-8,18
Anzhi,4800,11,2,6,12,14,40,-26,12
Loko Moscow,4801,1,12,6,2,33,14,19,42
CSKA Moscow,4801,2,11,3,6,28,20,8,36
Zenit,4801,3,8,8,4,24,15,9,32
Krasnodar,4801,4,9,5,6,34,30,4,32
Spart Moscow,4801,5,8,6,6,35,30,5,30
Terek Grozny,4801,6,8,5,7,22,24,-2,29
Din Moscow,4801,7,6,6,8,19,23,-4,24
FK Rubin,4801,8,6,5,9,26,22,4,23
Amkar,4801,9,6,4,10,13,22,-9,22
Rostov,4801,10,4,7,9,11,18,-7,19
Anzhi,4801,11,2,5,13,15,42,-27,11
Loko Moscow,4802,1,13,5,2,35,12,23,44
CSKA Moscow,4802,2,11,3,6,27,20,7,36
Spart Moscow,4802,3,9,5,6,37,30,7,32
Zenit,4802,4,8,8,4,23,17,6,32
Krasnodar,4802,5,8,4,8,28,27,1,28
Terek Grozny,4802,6,7,5,8,21,25,-4,26
Din Moscow,4802,7,6,7,7,21,24,-3,25
FK Rubin,4802,8,6,6,8,23,18,5,24
Amkar,4802,9,6,4,10,12,23,-11,22
Rostov,4802,10,4,6,10,11,19,-8,18
Anzhi,4802,11,3,5,12,16,39,-23,14
Loko Moscow,4803,1,11,6,3,30,13,17,39
Spart Moscow,4803,2,10,5,5,39,27,12,35
Zenit,4803,3,8,9,3,25,14,11,33
CSKA Moscow,4803,4,10,3,7,25,21,4,33
Krasnodar,4803,5,9,5,6,29,25,4,32
Din Moscow,4803,6,7,6,7,20,22,-2,27
Terek Grozny,4803,7,7,5,8,23,28,-5,26
FK Rubin,4803,8,5,6,9,22,19,3,21
Amkar,4803,9,5,4,11,10,23,-13,19
Rostov,4803,10,4,6,10,10,21,-11,18
Anzhi,4803,11,4,5,11,20,40,-20,17
Loko Moscow,4804,1,11,7,2,31,13,18,40
CSKA Moscow,4804,2,12,3,5,31,21,10,39
Spart Moscow,4804,3,9,6,5,37,28,9,33
Krasnodar,4804,4,9,5,6,31,26,5,32
Zenit,4804,5,7,9,4,23,16,7,30
Terek Grozny,4804,6,8,6,6,23,24,-1,30
FK Rubin,4804,7,6,5,9,23,20,3,23
Din Moscow,4804,8,5,7,8,19,24,-5,22
Amkar,4804,9,5,4,11,11,24,-13,19
Rostov,4804,10,4,6,10,10,19,-9,18
Anzhi,4804,11,2,6,12,18,42,-24,12
Loko Moscow,4805,1,12,6,2,32,13,19,42
CSKA Moscow,4805,2,11,3,6,26,18,8,36
Spart Moscow,4805,3,10,5,5,36,28,8,35
Krasnodar,4805,4,9,5,6,29,25,4,32
Terek Grozny,4805,5,8,6,6,22,22,0,30
Zenit,4805,6,7,8,5,23,17,6,29
FK Rubin,4805,7,6,5,9,26,20,6,23
Rostov,4805,8,5,6,9,13,18,-5,21
Din Moscow,4805,9,5,6,9,18,26,-8,21
Amkar,4805,10,4,4,12,9,25,-16,16
Anzhi,4805,11,3,6,11,15,37,-22,15
Loko Moscow,4806,1,12,6,2,34,15,19,42
CSKA Moscow,4806,2,11,4,5,26,17,9,37
Spart Moscow,4806,3,10,5,5,36,26,10,35
Terek Grozny,4806,4,9,5,6,23,23,0,32
Zenit,4806,5,7,9,4,23,16,7,30
Krasnodar,4806,6,8,5,7,30,29,1,29
FK Rubin,4806,7,6,6,8,25,19,6,24
Din Moscow,4806,8,5,7,8,18,24,-6,22
Rostov,4806,9,5,6,9,11,17,-6,21
Amkar,4806,10,4,4,12,9,24,-15,16
Anzhi,4806,11,2,5,13,15,40,-25,11
Loko Moscow,4807,1,12,5,3,33,14,19,41
CSKA Moscow,4807,2,11,3,6,26,18,8,36
Zenit,4807,3,8,8,4,22,14,8,32
Spart Moscow,4807,4,8,7,5,36,30,6,31
Terek Grozny,4807,5,8,5,7,23,25,-2,29
Krasnodar,4807,6,8,4,8,29,30,-1,28
Din Moscow,4807,7,6,7,7,22,22,0,25
FK Rubin,4807,8,6,5,9,23,21,2,23
Amkar,4807,9,6,4,10,14,23,-9,22
Rostov,4807,10,4,7,9,11,18,-7,19
Anzhi,4807,11,3,5,12,16,40,-24,14
Loko Moscow,4808,1,12,5,3,30,12,18,41
Spart Moscow,4808,2,9,7,4,39,28,11,34
CSKA Moscow,4808,3,10,4,6,27,21,6,34
Zenit,4808,4,8,8,4,24,15,9,32
Krasnodar,4808,5,9,5,6,30,26,4,32
Terek Grozny,4808,6,7,5,8,20,24,-4,26
Din Moscow,4808,7,6,7,7,20,22,-2,25
FK Rubin,4808,8,5,6,9,23,21,2,21
Amkar,4808,9,5,5,10,11,23,-12,20
Rostov,4808,10,4,6,10,11,21,-10,18
Anzhi,4808,11,3,6,11,16,38,-22,15
Loko Moscow,4809,1,12,6,2,32,11,21,42
CSKA Moscow,4809,2,10,5,5,29,21,8,35
Spart Moscow,4809,3,9,6,5,36,29,7,33
Terek Grozny,4809,4,9,5,6,28,26,2,32
Zenit,4809,5,7,10,3,22,14,8,31
Krasnodar,4809,6,8,4,8,27,29,-2,28
FK Rubin,4809,7,7,5,8,24,17,7,26
Din Moscow,4809,8,5,6,9,17,23,-6,21
Rostov,4809,9,4,7,9,11,18,-7,19
Amkar,4809,10,5,4,11,15,27,-12,19
Anzhi,4809,11,2,6,12,18,44,-26,12
Loko Moscow,4810,1,12,5,3,31,12,19,41
CSKA Moscow,4810,2,11,4,5,28,19,9,37
Spart Moscow,4810,3,9,6,5,36,27,9,33
Krasnodar,4810,4,9,5,6,29,25,4,32
Zenit,4810,5,7,9,4,22,16,6,30
Terek Grozny,4810,6,7,6,7,21,25,-4,27
FK Rubin,4810,7,6,6,8,25,18,7,24
Rostov,4810,8,5,6,9,11,17,-6,21
Din Moscow,4810,9,5,6,9,17,26,-9,21
Amkar,4810,10,5,5,10,12,23,-11,20
Anzhi,4810,11,2,6,12,16,40,-24,12
Loko Moscow,4811,1,12,5,3,31,14,17,41
CSKA Moscow,4811,2,11,3,6,27,18,9,36
Krasnodar,4811,3,10,4,6,31,24,7,34
Spart Moscow,4811,4,9,6,5,39,32,7,33
Zenit,4811,5,8,8,4,22,15,7,32
Terek Grozny,4811,6,7,6,7,21,24,-3,27
Din Moscow,4811,7,5,8,7,18,22,-4,23
FK Rubin,4811,8,5,6,9,21,18,3,21
Amkar,4811,9,5,5,10,12,23,-11,20
Rostov,4811,10,4,6,10,13,21,-8,18
Anzhi,4811,11,3,5,12,16,40,-24,14
Loko Moscow,4812,1,13,5,2,33,11,22,44
Spart Moscow,4812,2,11,5,4,40,28,12,38
CSKA Moscow,4812,3,10,3,7,25,19,6,33
Zenit,4812,4,8,8,4,22,15,7,32
Krasnodar,4812,5,8,5,7,27,26,1,29
Terek Grozny,4812,6,7,6,7,20,23,-3,27
Din Moscow,4812,7,6,6,8,21,24,-3,24
FK Rubin,4812,8,5,6,9,21,19,2,21
Rostov,4812,9,4,6,10,11,20,-9,18
Amkar,4812,10,4,5,11,9,23,-14,17
Anzhi,4812,11,4,5,11,16,37,-21,17
Loko Moscow,4813,1,12,6,2,33,13,20,42
CSKA Moscow,4813,2,11,4,5,29,18,11,37
Spart Moscow,4813,3,9,5,6,39,30,9,32
Zenit,4813,4,7,9,4,22,16,6,30
Terek Grozny,4813,5,8,6,6,22,23,-1,30
Krasnodar,4813,6,8,5,7,29,27,2,29
Din Moscow,4813,7,6,7,7,20,23,-3,25
FK Rubin,4813,8,6,6,8,22,17,5,24
Amkar,4813,9,5,4,11,10,23,-13,19
Rostov,4813,10,4,6,10,11,21,-10,18
Anzhi,4813,11,2,6,12,15,41,-26,12
Loko Moscow,4814,1,11,5,4,29,14,15,38
CSKA Moscow,4814,2,11,4,5,26,17,9,37
Spart Moscow,4814,3,10,5,5,40,32,8,35
Zenit,4814,4,8,9,3,22,13,9,33
Krasnodar,4814,5,9,5,6,29,24,5,32
Terek Grozny,4814,6,7,6,7,22,26,-4,27
Din Moscow,4814,7,6,6,8,22,25,-3,24
FK Rubin,4814,8,5,6,9,21,19,2,21
Amkar,4814,9,5,5,10,12,23,-11,20
Rostov,4814,10,4,6,10,11,19,-8,18
Anzhi,4814,11,3,5,12,18,40,-22,14
Loko Moscow,4815,1,12,6,2,31,11,20,42
CSKA Moscow,4815,2,11,4,5,29,19,10,37
Spart Moscow,4815,3,10,5,5,39,29,10,35
Zenit,4815,4,7,10,3,23,15,8,31
Krasnodar,4815,5,8,5,7,28,27,1,29
Terek Grozny,4815,6,7,6,7,21,24,-3,27
FK Rubin,4815,7,6,6,8,25,19,6,24
Din Moscow,4815,8,5,6,9,19,27,-8,21
Amkar,4815,9,5,5,10,11,23,-12,20
Rostov,4815,10,4,6,10,11,19,-8,18
Anzhi,4815,11,3,5,12,16,40,-24,14
Loko Moscow,4816,1,12,6,2,32,13,19,42
CSKA Moscow,4816,2,11,3,6,32,22,10,36
Spart Moscow,4816,3,10,5,5,36,28,8,35
Zenit,4816,4,8,9,3,25,16,9,33
Krasnodar,4816,5,8,5,7,28,26,2,29
Terek Grozny,4816,6,8,5,7,24,24,0,29
FK Rubin,4816,7,6,6,8,23,18,5,24
Rostov,4816,8,5,6,9,13,17,-4,21
Din Moscow,4816,9,5,6,9,18,25,-7,21
Amkar,4816,10,5,4,11,11,23,-12,19
Anzhi,4816,11,2,5,13,16,46,-30,11
Loko Moscow,4817,1,13,5,2,31,11,20,44
Spart Moscow,4817,2,10,6,4,39,28,11,36
CSKA Moscow,4817,3,10,4,6,25,18,7,34
Zenit,4817,4,7,9,4,21,14,7,30
Krasnodar,4817,5,8,4,8,27,27,0,28
Terek Grozny,4817,6,7,6,7,20,24,-4,27
FK Rubin,4817,7,6,6,8,23,17,6,24
Din Moscow,4817,8,5,8,7,18,22,-4,23
Rostov,4817,9,4,6,10,10,19,-9,18
Amkar,4817,10,4,5,11,11,25,-14,17
Anzhi,4817,11,4,5,11,17,37,-20,17
Loko Moscow,4818,1,12,5,3,33,15,18,41
CSKA Moscow,4818,2,11,4,5,28,19,9,37
Spart Moscow,4818,3,10,6,4,38,27,11,36
Zenit,4818,4,8,8,4,23,15,8,32
Krasnodar,4818,5,9,4,7,32,28,4,31
Terek Grozny,4818,6,7,6,7,22,25,-3,27
FK Rubin,4818,7,6,5,9,22,19,3,23
Din Moscow,4818,8,5,6,9,18,25,-7,21
Rostov,4818,9,4,7,9,11,18,-7,19
Amkar,4818,10,5,4,11,10,23,-13,19
Anzhi,4818,11,2,7,11,17,40,-23,13
Loko Moscow,4819,1,11,6,3,29,14,15,39
CSKA Moscow,4819,2,11,3,6,28,19,9,36
Zenit,4819,3,9,8,3,26,14,12,35
Krasnodar,4819,4,9,5,6,28,24,4,32
Spart Moscow,4819,5,8,6,6,38,32,6,30
Terek Grozny,4819,6,7,6,7,21,24,-3,27
FK Rubin,4819,7,6,5,9,23,19,4,23
Din Moscow,4819,8,5,7,8,20,25,-5,22
Amkar,4819,9,6,4,10,12,23,-11,22
Rostov,4819,10,5,6,9,13,19,-6,21
Anzhi,4819,11,2,6,12,15,40,-25,12
Loko Moscow,4820,1,11,7,2,32,14,18,40
Spart Moscow,4820,2,10,5,5,37,28,9,35
CSKA Moscow,4820,3,10,4,6,26,21,5,34
Zenit,4820,4,8,9,3,26,15,11,33
Krasnodar,4820,5,9,5,6,30,26,4,32
Terek Grozny,4820,6,8,6,6,23,23,0,30
Din Moscow,4820,7,6,6,8,20,23,-3,24
Rostov,4820,8,5,6,9,11,17,-6,21
FK Rubin,4820,9,5,5,10,21,20,1,20
Amkar,4820,10,4,4,12,10,26,-16,16
Anzhi,4820,11,2,7,11,15,38,-23,13
Loko Moscow,4821,1,13,5,2,32,12,20,44
Spart Moscow,4821,2,10,5,5,40,29,11,35
CSKA Moscow,4821,3,10,3,7,26,20,6,33
Zenit,4821,4,8,8,4,23,15,8,32
Krasnodar,4821,5,9,4,7,29,26,3,31
Terek Grozny,4821,6,7,6,7,23,27,-4,27
Din Moscow,4821,7,5,7,8,17,23,-6,22
FK Rubin,4821,8,5,6,9,22,19,3,21
Rostov,4821,9,5,6,9,13,18,-5,21
Amkar,4821,10,4,5,11,11,27,-16,17
Anzhi,4821,11,4,5,11,20,40,-20,17
Loko Moscow,4822,1,12,6,2,31,12,19,42
CSKA Moscow,4822,2,11,3,6,26,19,7,36
Spart Moscow,4822,3,9,7,4,38,28,10,34
Zenit,4822,4,8,8,4,24,15,9,32
Krasnodar,4822,5,9,5,6,29,25,4,32
Terek Grozny,4822,6,8,6,6,22,23,-1,30
Din Moscow,4822,7,6,6,8,19,24,-5,24
FK Rubin,4822,8,5,5,10,23,21,2,20
Rostov,4822,9,4,7,9,11,18,-7,19
Amkar,4822,10,4,5,11,11,25,-14,17
Anzhi,4822,11,2,6,12,15,39,-24,12
Loko Moscow,4823,1,13,5,2,32,11,21,44
CSKA Moscow,4823,2,11,3,6,27,18,9,36
Spart Moscow,4823,3,9,7,4,37,27,10,34
Zenit,4823,4,8,8,4,22,15,7,32
Terek Grozny,4823,5,8,6,6,24,23,1,30
Krasnodar,4823,6,8,4,8,28,28,0,28
Din Moscow,4823,7,6,7,7,19,22,-3,25
FK Rubin,4823,8,6,5,9,25,20,5,23
Rostov,4823,9,4,6,10,11,20,-9,18
Amkar,4823,10,4,5,11,10,26,-16,17
Anzhi,4823,11,2,6,12,15,40,-25,12
Loko Moscow,4824,1,12,5,3,31,14,17,41
CSKA Moscow,4824,2,10,4,6,26,19,7,34
Spart Moscow,4824,3,9,6,5,37,29,8,33
Krasnodar,4824,4,9,5,6,31,26,5,32
Zenit,4824,5,7,9,4,22,15,7,30
Terek Grozny,4824,6,8,5,7,22,24,-2,29
FK Rubin,4824,7,6,6,8,23,18,5,24
Din Moscow,4824,8,5,6,9,19,25,-6,21
Rostov,4824,9,4,7,9,11,18,-7,19
Amkar,4824,10,5,4,11,10,24,-14,19
Anzhi,4824,11,4,5,11,17,37,-20,17
Loko Moscow,4825,1,12,5,3,32,13,19,41
CSKA Moscow,4825,2,12,3,5,29,18,11,39
Spart Moscow,4825,3,9,7,4,41,31,10,34
Krasnodar,4825,4,9,4,7,29,27,2,31
Zenit,4825,5,7,8,5,22,17,5,29
Terek Grozny,4825,6,7,7,6,20,22,-2,28
FK Rubin,4825,7,6,6,8,24,18,6,24
Din Moscow,4825,8,5,8,7,21,25,-4,23
Rostov,4825,9,4,6,10,12,21,-9,18
Amkar,4825,10,4,6,10,10,23,-13,18
Anzhi,4825,11,2,6,12,14,39,-25,12
Loko Moscow,4826,1,12,5,3,32,13,19,41
CSKA Moscow,4826,2,11,3,6,27,20,7,36
Zenit,4826,3,9,8,3,25,14,11,35
Spart Moscow,4826,4,10,5,5,40,30,10,35
Krasnodar,4826,5,9,4,7,30,28,2,31
Terek Grozny,4826,6,7,6,7,20,23,-3,27
Din Moscow,4826,7,6,7,7,19,22,-3,25
FK Rubin,4826,8,5,6,9,22,19,3,21
Rostov,4826,9,4,6,10,11,19,-8,18
Amkar,4826,10,4,5,11,11,26,-15,17
Anzhi,4826,11,3,5,12,15,38,-23,14
Loko Moscow,4827,1,11,6,3,31,14,17,39
CSKA Moscow,4827,2,11,4,5,30,21,9,37
Spart Moscow,4827,3,10,5,5,38,31,7,35
Krasnodar,4827,4,9,5,6,29,25,4,32
Zenit,4827,5,7,10,3,25,17,8,31
Terek Grozny,4827,6,7,5,8,21,25,-4,26
FK Rubin,4827,7,6,6,8,23,18,5,24
Din Moscow,4827,8,6,6,8,21,23,-2,24
Amkar,4827,9,5,4,11,11,24,-13,19
Rostov,4827,10,4,6,10,12,20,-8,18
Anzhi,4827,11,3,5,12,17,40,-23,14
Loko Moscow,4828,1,11,6,3,30,14,16,39
CSKA Moscow,4828,2,12,3,5,30,18,12,39
Spart Moscow,4828,3,10,5,5,38,28,10,35
Krasnodar,4828,4,9,5,6,30,25,5,32
Zenit,4828,5,7,9,4,22,15,7,30
Terek Grozny,4828,6,7,7,6,22,24,-2,28
FK Rubin,4828,7,5,7,8,23,19,4,22
Din Moscow,4828,8,5,7,8,19,25,-6,22
Amkar,4828,9,5,5,10,11,23,-12,20
Rostov,4828,10,4,6,10,11,19,-8,18
Anzhi,4828,11,2,6,12,16,42,-26,12
Loko Moscow,4829,1,11,6,3,34,17,17,39
Spart Moscow,4829,2,10,6,4,38,26,12,36
CSKA Moscow,4829,3,11,3,6,26,20,6,36
Zenit,4829,4,8,9,3,26,15,11,33
Krasnodar,4829,5,9,4,7,32,29,3,31
Terek Grozny,4829,6,8,6,6,23,24,-1,30
FK Rubin,4829,7,6,6,8,23,18,5,24
Din Moscow,4829,8,5,8,7,18,22,-4,23
Rostov,4829,9,4,6,10,10,18,-8,18
Amkar,4829,10,4,5,11,10,26,-16,17
Anzhi,4829,11,2,5,13,15,40,-25,11
Loko Moscow,4830,1,12,6,2,31,12,19,42
CSKA Moscow,4830,2,11,4,5,30,19,11,37
Spart Moscow,4830,3,10,6,4,39,25,14,36
Zenit,4830,4,7,9,4,22,15,7,30
Krasnodar,4830,5,8,6,6,29,26,3,30
Terek Grozny,4830,6,8,5,7,24,24,0,29
FK Rubin,4830,7,5,7,8,23,19,4,22
Din Moscow,4830,8,5,7,8,18,25,-7,22
Amkar,4830,9,5,5,10,11,23,-12,20
Rostov,4830,10,4,6,10,10,20,-10,18
Anzhi,4830,11,2,5,13,15,44,-29,11
Loko Moscow,4831,1,13,5,2,35,12,23,44
CSKA Moscow,4831,2,12,3,5,32,18,14,39
Spart Moscow,4831,3,9,6,5,36,27,9,33
Zenit,4831,4,7,8,5,21,15,6,29
Terek Grozny,4831,5,8,5,7,23,25,-2,29
Krasnodar,4831,6,8,4,8,29,31,-2,28
FK Rubin,4831,7,7,5,8,25,19,6,26
Din Moscow,4831,8,5,7,8,19,24,-5,22
Rostov,4831,9,5,6,9,11,17,-6,21
Amkar,4831,10,5,4,11,11,24,-13,19
Anzhi,4831,11,2,5,13,16,46,-30,11
CSKA Moscow,4832,1,12,3,5,28,17,11,39
Loko Moscow,4832,2,11,5,4,30,15,15,38
Spart Moscow,4832,3,10,5,5,38,29,9,35
Zenit,4832,4,8,8,4,23,15,8,32
Krasnodar,4832,5,9,5,6,29,25,4,32
Terek Grozny,4832,6,8,5,7,21,24,-3,29
FK Rubin,4832,7,5,7,8,22,18,4,22
Din Moscow,4832,8,5,7,8,19,24,-5,22
Rostov,4832,9,5,6,9,11,17,-6,21
Amkar,4832,10,5,4,11,13,25,-12,19
Anzhi,4832,11,2,5,13,14,39,-25,11
Loko Moscow,4833,1,12,5,3,33,15,18,41
CSKA Moscow,4833,2,11,3,6,26,19,7,36
Zenit,4833,3,9,8,3,27,15,12,35
Spart Moscow,4833,4,8,8,4,36,28,8,32
Krasnodar,4833,5,8,5,7,28,27,1,29
Terek Grozny,4833,6,7,7,6,23,25,-2,28
Din Moscow,4833,7,6,7,7,20,23,-3,25
FK Rubin,4833,8,5,6,9,23,20,3,21
Rostov,4833,9,4,7,9,12,19,-7,19
Amkar,4833,10,4,6,10,12,25,-13,18
Anzhi,4833,11,2,6,12,14,38,-24,12
Loko Moscow,4834,1,11,5,4,30,14,16,38
Spart Moscow,4834,2,10,6,4,36,26,10,36
Zenit,4834,3,9,8,3,26,14,12,35
Krasnodar,4834,4,10,4,6,29,24,5,34
CSKA Moscow,4834,5,10,4,6,26,21,5,34
Terek Grozny,4834,6,9,5,6,23,22,1,32
FK Rubin,4834,7,6,5,9,23,18,5,23
Din Moscow,4834,8,5,6,9,18,25,-7,21
Rostov,4834,9,4,6,10,10,18,-8,18
Amkar,4834,10,4,5,11,9,23,-14,17
Anzhi,4834,11,2,6,12,15,40,-25,12
Loko Moscow,4835,1,12,5,3,32,12,20,41
CSKA Moscow,4835,2,11,4,5,27,17,10,37
Krasnodar,4835,3,9,5,6,30,26,4,32
Spart Moscow,4835,4,8,6,6,34,29,5,30
Zenit,4835,5,7,9,4,21,16,5,30
Terek Grozny,4835,6,8,6,6,24,24,0,30
Din Moscow,4835,7,7,6,7,22,21,1,27
FK Rubin,4835,8,5,6,9,23,23,0,21
Rostov,4835,9,5,6,9,12,17,-5,21
Amkar,4835,10,4,5,11,10,25,-15,17
Anzhi,4835,11,2,6,12,16,41,-25,12
Loko Moscow,4836,1,12,5,3,31,13,18,41
CSKA Moscow,4836,2,12,3,5,29,18,11,39
Zenit,4836,3,8,8,4,23,15,8,32
Spart Moscow,4836,4,9,5,6,36,29,7,32
Krasnodar,4836,5,9,4,7,30,28,2,31
Terek Grozny,4836,6,8,5,7,21,25,-4,29
Din Moscow,4836,7,6,6,8,19,24,-5,24
FK Rubin,4836,8,6,5,9,26,21,5,23
Rostov,4836,9,5,6,9,12,18,-6,21
Amkar,4836,10,4,4,12,10,25,-15,16
Anzhi,4836,11,3,5,12,18,39,-21,14
Loko Moscow,4837,1,11,7,2,31,13,18,40
CSKA Moscow,4837,2,11,3,6,28,20,8,36
Spart Moscow,4837,3,10,5,5,39,27,12,35
Zenit,4837,4,8,9,3,24,15,9,33
Krasnodar,4837,5,9,5,6,31,25,6,32
Terek Grozny,4837,6,8,5,7,21,23,-2,29
Din Moscow,4837,7,6,6,8,22,25,-3,24
Amkar,4837,8,6,4,10,12,23,-11,22
FK Rubin,4837,9,5,5,10,22,25,-3,20
Rostov,4837,10,4,6,10,10,19,-9,18
Anzhi,4837,11,2,5,13,15,40,-25,11
Loko Moscow,4838,1,11,7,2,29,11,18,40
CSKA Moscow,4838,2,11,4,5,29,19,10,37
Spart Moscow,4838,3,9,5,6,36,29,7,32
Krasnodar,4838,4,9,5,6,30,24,6,32
Zenit,4838,5,7,9,4,22,16,6,30
Terek Grozny,4838,6,8,6,6,22,23,-1,30
Din Moscow,4838,7,6,6,8,20,24,-4,24
FK Rubin,4838,8,6,5,9,24,22,2,23
Amkar,4838,9,5,4,11,10,23,-13,19
Rostov,4838,10,4,6,10,12,20,-8,18
Anzhi,4838,11,2,7,11,16,39,-23,13
Loko Moscow,4839,1,12,6,2,30,11,19,42
CSKA Moscow,4839,2,12,3,5,29,19,10,39
Spart Moscow,4839,3,10,6,4,36,25,11,36
Zenit,4839,4,7,9,4,22,15,7,30
Krasnodar,4839,5,8,4,8,27,26,1,28
Terek Grozny,4839,6,7,6,7,22,26,-4,27
Din Moscow,4839,7,6,6,8,21,24,-3,24
FK Rubin,4839,8,6,5,9,23,21,2,23
Rostov,4839,9,4,7,9,10,17,-7,19
Amkar,4839,10,5,4,11,12,24,-12,19
Anzhi,4839,11,2,6,12,16,40,-24,12
Loko Moscow,4840,1,12,6,2,31,12,19,42
CSKA Moscow,4840,2,12,3,5,28,17,11,39
Spart Moscow,4840,3,10,5,5,39,26,13,35
Zenit,4840,4,7,9,4,22,15,7,30
Terek Grozny,4840,5,8,5,7,22,26,-4,29
Krasnodar,4840,6,8,4,8,27,26,1,28
Din Moscow,4840,7,6,6,8,19,25,-6,24
FK Rubin,4840,8,6,5,9,23,19,4,23
Rostov,4840,9,5,6,9,11,17,-6,21
Amkar,4840,10,5,4,11,12,25,-13,19
Anzhi,4840,11,2,5,13,15,41,-26,11
Loko Moscow,4841,1,11,7,2,30,12,18,40
CSKA Moscow,4841,2,11,3,6,27,19,8,36
Spart Moscow,4841,3,10,5,5,39,27,12,35
Zenit,4841,4,8,9,3,23,14,9,33
Krasnodar,4841,5,8,6,6,28,25,3,30
Terek Grozny,4841,6,8,5,7,24,25,-1,29
Din Moscow,4841,7,7,6,7,21,23,-2,27
FK Rubin,4841,8,5,6,9,22,19,3,21
Amkar,4841,9,5,4,11,10,26,-16,19
Rostov,4841,10,4,6,10,10,18,-8,18
Anzhi,4841,11,2,5,13,16,42,-26,11
Loko Moscow,4842,1,12,5,3,33,14,19,41
CSKA Moscow,4842,2,11,4,5,29,19,10,37
Krasnodar,4842,3,10,4,6,31,25,6,34
Spart Moscow,4842,4,9,6,5,36,31,5,33
Zenit,4842,5,7,9,4,23,17,6,30
Terek Grozny,4842,6,7,5,8,21,25,-4,26
Din Moscow,4842,7,6,7,7,18,21,-3,25
Rostov,4842,8,5,6,9,15,18,-3,21
FK Rubin,4842,9,5,5,10,21,20,1,20
Amkar,4842,10,5,4,11,11,24,-13,19
Anzhi,4842,11,3,5,12,17,41,-24,14
Loko Moscow,4843,1,12,5,3,32,13,19,41
CSKA Moscow,4843,2,12,3,5,29,17,12,39
Spart Moscow,4843,3,9,5,6,36,28,8,32
Zenit,4843,4,8,8,4,23,17,6,32
Terek Grozny,4843,5,9,5,6,23,23,0,32
Krasnodar,4843,6,8,5,7,27,26,1,29
FK Rubin,4843,7,6,6,8,24,18,6,24
Din Moscow,4843,8,6,6,8,19,24,-5,24
Amkar,4843,9,5,4,11,11,24,-13,19
Rostov,4843,10,4,6,10,10,19,-9,18
Anzhi,4843,11,2,5,13,15,40,-25,11
Loko Moscow,4844,1,11,6,3,30,14,16,39
Spart Moscow,4844,2,10,5,5,36,27,9,35
CSKA Moscow,4844,3,10,4,6,28,21,7,34
Krasnodar,4844,4,10,4,6,32,26,6,34
Zenit,4844,5,7,10,3,23,15,8,31
Terek Grozny,4844,6,8,6,6,22,22,0,30
Din Moscow,4844,7,6,6,8,19,22,-3,24
FK Rubin,4844,8,5,5,10,22,21,1,20
Amkar,4844,9,5,4,11,11,25,-14,19
Rostov,4844,10,4,6,10,10,18,-8,18
Anzhi,4844,11,3,6,11,16,38,-22,15
Loko Moscow,4845,1,11,6,3,30,14,16,39
CSKA Moscow,4845,2,11,3,6,29,19,10,36
Spart Moscow,4845,3,10,5,5,38,27,11,35
Zenit,4845,4,9,8,3,25,14,11,35
Terek Grozny,4845,5,9,5,6,24,22,2,32
Krasnodar,4845,6,8,6,6,29,26,3,30
FK Rubin,4845,7,5,7,8,23,19,4,22
Din Moscow,4845,8,5,7,8,18,25,-7,22
Amkar,4845,9,5,4,11,11,23,-12,19
Rostov,4845,10,4,6,10,10,19,-9,18
Anzhi,4845,11,2,5,13,14,43,-29,11
Loko Moscow,4846,1,12,5,3,30,13,17,41
CSKA Moscow,4846,2,12,3,5,28,17,11,39
Spart Moscow,4846,3,11,5,4,43,26,17,38
Zenit,4846,4,8,8,4,23,14,9,32
Krasnodar,4846,5,8,5,7,27,25,2,29
Terek Grozny,4846,6,7,6,7,21,24,-3,27
FK Rubin,4846,7,5,7,8,21,17,4,22
Din Moscow,4846,8,5,7,8,17,28,-11,22
Rostov,4846,9,4,6,10,11,19,-8,18
Amkar,4846,10,4,5,11,10,24,-14,17
Anzhi,4846,11,3,5,12,15,39,-24,14
Loko Moscow,4847,1,11,6,3,29,13,16,39
CSKA Moscow,4847,2,11,4,5,28,18,10,37
Spart Moscow,4847,3,10,6,4,38,28,10,36
Krasnodar,4847,4,9,4,7,29,25,4,31
Zenit,4847,5,7,9,4,21,15,6,30
Terek Grozny,4847,6,7,6,7,20,24,-4,27
Din Moscow,4847,7,6,6,8,18,22,-4,24
FK Rubin,4847,8,6,5,9,22,18,4,23
Rostov,4847,9,4,6,10,11,19,-8,18
Amkar,4847,10,4,6,10,11,24,-13,18
Anzhi,4847,11,3,6,11,17,38,-21,15
Loko Moscow,4848,1,11,5,4,30,15,15,38
Zenit,4848,2,9,8,3,26,15,11,35
Krasnodar,4848,3,10,4,6,30,24,6,34
CSKA Moscow,4848,4,10,4,6,26,20,6,34
Spart Moscow,4848,5,8,5,7,33,28,5,29
Terek Grozny,4848,6,7,6,7,21,24,-3,27
Din Moscow,4848,7,6,6,8,18,22,-4,24
FK Rubin,4848,8,6,5,9,22,18,4,23
Rostov,4848,9,5,6,9,11,17,-6,21
Amkar,4848,10,5,5,10,10,22,-12,20
Anzhi,4848,11,3,6,11,16,38,-22,15
CSKA Moscow,4849,1,12,3,5,28,18,10,39
Loko Moscow,4849,2,11,5,4,30,15,15,38
Spart Moscow,4849,3,11,5,4,41,27,14,38
Zenit,4849,4,8,8,4,24,16,8,32
Krasnodar,4849,5,9,4,7,29,25,4,31
Terek Grozny,4849,6,8,6,6,24,24,0,30
FK Rubin,4849,7,7,5,8,24,17,7,26
Din Moscow,4849,8,5,6,9,17,24,-7,21
Rostov,4849,9,4,6,10,10,20,-10,18
Amkar,4849,10,4,4,12,13,30,-17,16
Anzhi,4849,11,2,6,12,14,38,-24,12
Loko Moscow,4850,1,11,5,4,31,16,15,38
CSKA Moscow,4850,2,11,3,6,26,18,8,36
Spart Moscow,4850,3,10,5,5,39,30,9,35
Zenit,4850,4,8,8,4,24,16,8,32
Krasnodar,4850,5,9,4,7,30,26,4,31
Terek Grozny,4850,6,8,5,7,22,25,-3,29
FK Rubin,4850,7,7,5,8,26,20,6,26
Din Moscow,4850,8,5,6,9,20,27,-7,21
Amkar,4850,9,5,4,11,12,24,-12,19
Rostov,4850,10,4,6,10,12,20,-8,18
Anzhi,4850,11,4,5,11,17,37,-20,17
Loko Moscow,4851,1,12,6,2,33,14,19,42
Spart Moscow,4851,2,11,5,4,41,26,15,38
CSKA Moscow,4851,3,11,3,6,26,19,7,36
Zenit,4851,4,8,9,3,25,15,10,33
Krasnodar,4851,5,9,4,7,29,26,3,31
Terek Grozny,4851,6,8,6,6,24,24,0,30
Din Moscow,4851,7,5,7,8,17,22,-5,22
FK Rubin,4851,8,5,6,9,21,18,3,21
Rostov,4851,9,4,6,10,10,20,-10,18
Amkar,4851,10,4,5,11,11,27,-16,17
Anzhi,4851,11,2,5,13,15,41,-26,11
Loko Moscow,4852,1,13,5,2,34,12,22,44
CSKA Moscow,4852,2,12,3,5,30,19,11,39
Spart Moscow,4852,3,10,5,5,39,27,12,35
Zenit,4852,4,7,8,5,23,18,5,29
Terek Grozny,4852,5,8,5,7,21,24,-3,29
Krasnodar,4852,6,8,4,8,29,30,-1,28
FK Rubin,4852,7,6,6,8,27,22,5,24
Din Moscow,4852,8,5,7,8,20,26,-6,22
Amkar,4852,9,6,4,10,13,22,-9,22
Rostov,4852,10,4,6,10,10,21,-11,18
Anzhi,4852,11,2,5,13,15,40,-25,11
Loko Moscow,4853,1,12,6,2,32,13,19,42
CSKA Moscow,4853,2,12,3,5,30,17,13,39
Spart Moscow,4853,3,8,7,5,35,28,7,31
Krasnodar,4853,4,8,6,6,27,24,3,30
Zenit,4853,5,7,8,5,23,19,4,29
Terek Grozny,4853,6,7,5,8,20,24,-4,26
Din Moscow,4853,7,5,8,7,18,22,-4,23
FK Rubin,4853,8,5,7,8,22,18,4,22
Amkar,4853,9,6,4,10,11,22,-11,22
Rostov,4853,10,4,7,9,12,19,-7,19
Anzhi,4853,11,3,5,12,15,39,-24,14
Loko Moscow,4854,1,12,5,3,30,12,18,41
CSKA Moscow,4854,2,11,3,6,26,19,7,36
Spart Moscow,4854,3,9,6,5,36,27,9,33
Zenit,4854,4,8,8,4,23,14,9,32
Krasnodar,4854,5,9,4,7,28,26,2,31
Terek Grozny,4854,6,8,5,7,23,26,-3,29
FK Rubin,4854,7,7,5,8,26,17,9,26
Din Moscow,4854,8,6,6,8,18,24,-6,24
Rostov,4854,9,4,7,9,11,18,-7,19
Amkar,4854,10,5,4,11,11,24,-13,19
Anzhi,4854,11,2,5,13,16,41,-25,11
CSKA Moscow,4855,1,12,3,5,28,17,11,39
Loko Moscow,4855,2,11,5,4,29,13,16,38
Spart Moscow,4855,3,10,5,5,39,28,11,35
Zenit,4855,4,8,8,4,22,15,7,32
Krasnodar,4855,5,9,4,7,28,25,3,31
Terek Grozny,4855,6,8,5,7,24,25,-1,29
Din Moscow,4855,7,6,6,8,19,24,-5,24
FK Rubin,4855,8,6,5,9,22,18,4,23
Amkar,4855,9,6,4,10,12,22,-10,22
Rostov,4855,10,4,6,10,11,20,-9,18
Anzhi,4855,11,2,5,13,15,42,-27,11
Loko Moscow,4856,1,12,6,2,35,13,22,42
CSKA Moscow,4856,2,11,4,5,29,18,11,37
Spart Moscow,4856,3,9,6,5,37,30,7,33
Krasnodar,4856,4,8,5,7,28,26,2,29
Zenit,4856,5,7,8,5,22,21,1,29
Terek Grozny,4856,6,8,5,7,22,25,-3,29
Din Moscow,4856,7,6,7,7,19,22,-3,25
FK Rubin,4856,8,6,5,9,22,18,4,23
Amkar,4856,9,5,4,11,12,25,-13,19
Rostov,4856,10,4,6,10,11,19,-8,18
Anzhi,4856,11,3,6,11,18,38,-20,15
Loko Moscow,4857,1,11,6,3,31,14,17,39
CSKA Moscow,4857,2,12,3,5,29,18,11,39
Spart Moscow,4857,3,10,5,5,39,28,11,35
Zenit,4857,4,8,8,4,23,15,8,32
Krasnodar,4857,5,8,5,7,28,28,0,29
Terek Grozny,4857,6,7,5,8,21,27,-6,26
Din Moscow,4857,7,6,6,8,22,25,-3,24
FK Rubin,4857,8,6,5,9,25,20,5,23
Amkar,4857,9,6,4,10,12,22,-10,22
Rostov,4857,10,4,6,10,10,20,-10,18
Anzhi,4857,11,3,5,12,18,41,-23,14
Loko Moscow,4858,1,11,6,3,32,16,16,39
Zenit,4858,2,9,8,3,25,14,11,35
CSKA Moscow,4858,3,10,4,6,26,19,7,34
Spart Moscow,4858,4,8,7,5,35,28,7,31
Krasnodar,4858,5,8,6,6,29,26,3,30
Terek Grozny,4858,6,8,5,7,22,25,-3,29
Din Moscow,4858,7,5,8,7,19,23,-4,23
FK Rubin,4858,8,5,7,8,22,18,4,22
Rostov,4858,9,4,7,9,10,17,-7,19
Amkar,4858,10,5,4,11,11,24,-13,19
Anzhi,4858,11,3,6,11,18,39,-21,15
Loko Moscow,4859,1,12,6,2,31,12,19,42
Spart Moscow,4859,2,11,5,4,39,27,12,38
CSKA Moscow,4859,3,11,3,6,27,18,9,36
Zenit,4859,4,8,9,3,22,13,9,33
Krasnodar,4859,5,9,4,7,29,26,3,31
Terek Grozny,4859,6,7,6,7,20,23,-3,27
Din Moscow,4859,7,5,7,8,20,26,-6,22
FK Rubin,4859,8,5,6,9,22,19,3,21
Amkar,4859,9,5,4,11,10,23,-13,19
Rostov,4859,10,4,6,10,10,18,-8,18
Anzhi,4859,11,2,6,12,14,39,-25,12
Loko Moscow,4860,1,11,7,2,32,14,18,40
CSKA Moscow,4860,2,11,4,5,27,18,9,37
Spart Moscow,4860,3,10,5,5,38,28,10,35
Krasnodar,4860,4,9,5,6,32,27,5,32
Zenit,4860,5,7,10,3,23,15,8,31
Terek Grozny,4860,6,7,6,7,22,25,-3,27
Din Moscow,4860,7,6,6,8,19,24,-5,24
Rostov,4860,8,5,6,9,11,17,-6,21
FK Rubin,4860,9,5,5,10,22,21,1,20
Amkar,4860,10,4,5,11,11,25,-14,17
Anzhi,4860,11,3,5,12,16,39,-23,14
Loko Moscow,4861,1,12,5,3,32,15,17,41
CSKA Moscow,4861,2,11,4,5,31,20,11,37
Krasnodar,4861,3,10,4,6,33,27,6,34
Spart Moscow,4861,4,9,6,5,37,27,10,33
Zenit,4861,5,7,9,4,23,16,7,30
Terek Grozny,4861,6,7,5,8,21,26,-5,26
Din Moscow,4861,7,5,7,8,17,24,-7,22
FK Rubin,4861,8,5,6,9,22,19,3,21
Rostov,4861,9,5,6,9,11,17,-6,21
Amkar,4861,10,5,5,10,12,24,-12,20
Anzhi,4861,11,3,5,12,17,41,-24,14
Loko Moscow,4862,1,13,5,2,33,11,22,44
CSKA Moscow,4862,2,11,3,6,28,18,10,36
Spart Moscow,4862,3,10,5,5,36,27,9,35
Zenit,4862,4,8,8,4,22,15,7,32
Terek Grozny,4862,5,8,6,6,24,24,0,30
Krasnodar,4862,6,8,5,7,29,28,1,29
FK Rubin,4862,7,6,6,8,24,19,5,24
Din Moscow,4862,8,5,6,9,17,23,-6,21
Amkar,4862,9,5,5,10,11,23,-12,20
Rostov,4862,10,4,6,10,11,19,-8,18
Anzhi,4862,11,2,5,13,15,43,-28,11
Loko Moscow,4863,1,11,6,3,31,15,16,39
CSKA Moscow,4863,2,12,3,5,33,18,15,39
Zenit,4863,3,8,8,4,24,15,9,32
Krasnodar,4863,4,9,5,6,32,28,4,32
Spart Moscow,4863,5,8,6,6,35,30,5,30
Terek Grozny,4863,6,7,6,7,21,24,-3,27
Din Moscow,4863,7,6,7,7,19,21,-2,25
FK Rubin,4863,8,5,6,9,23,20,3,21
Rostov,4863,9,5,6,9,12,18,-6,21
Amkar,4863,10,5,5,10,12,24,-12,20
Anzhi,4863,11,2,6,12,14,43,-29,12
Loko Moscow,4864,1,12,5,3,32,14,18,41
CSKA Moscow,4864,2,12,3,5,31,18,13,39
Zenit,4864,3,8,8,4,24,15,9,32
Spart Moscow,4864,4,8,6,6,37,31,6,30
Terek Grozny,4864,5,8,6,6,22,22,0,30
Krasnodar,4864,6,8,5,7,28,28,0,29
FK Rubin,4864,7,6,6,8,23,18,5,24
Din Moscow,4864,8,5,7,8,20,25,-5,22
Rostov,4864,9,5,6,9,11,17,-6,21
Amkar,4864,10,5,5,10,11,23,-12,20
Anzhi,4864,11,2,5,13,15,43,-28,11
Loko Moscow,4865,1,11,7,2,31,13,18,40
CSKA Moscow,4865,2,11,3,6,27,18,9,36
Spart Moscow,4865,3,10,5,5,36,27,9,35
Zenit,4865,4,8,9,3,22,13,9,33
Krasnodar,4865,5,8,6,6,29,26,3,30
Terek Grozny,4865,6,7,6,7,21,26,-5,27
FK Rubin,4865,7,6,6,8,23,17,6,24
Din Moscow,4865,8,6,6,8,18,23,-5,24
Amkar,4865,9,5,4,11,12,23,-11,19
Rostov,4865,10,4,6,10,11,19,-8,18
Anzhi,4865,11,2,6,12,15,40,-25,12
Loko Moscow,4866,1,11,6,3,30,13,17,39
CSKA Moscow,4866,2,10,5,5,25,17,8,35
Krasnodar,4866,3,10,4,6,32,25,7,34
Spart Moscow,4866,4,9,6,5,36,28,8,33
Zenit,4866,5,7,10,3,21,13,8,31
Terek Grozny,4866,6,8,6,6,23,23,0,30
FK Rubin,4866,7,6,5,9,24,20,4,23
Din Moscow,4866,8,5,7,8,17,24,-7,22
Rostov,4866,9,5,6,9,12,18,-6,21
Amkar,4866,10,4,4,12,10,26,-16,16
Anzhi,4866,11,2,7,11,15,38,-23,13
Loko Moscow,4867,1,12,6,2,31,12,19,42
CSKA Moscow,4867,2,11,4,5,28,18,10,37
Spart Moscow,4867,3,9,5,6,39,33,6,32
Krasnodar,4867,4,9,5,6,30,25,5,32
Zenit,4867,5,7,9,4,22,15,7,30
Terek Grozny,4867,6,8,6,6,24,24,0,30
Din Moscow,4867,7,6,6,8,24,28,-4,24
FK Rubin,4867,8,6,5,9,25,21,4,23
Amkar,4867,9,5,4,11,10,24,-14,19
Rostov,4867,10,4,6,10,12,20,-8,18
Anzhi,4867,11,2,6,12,16,41,-25,12
Loko Moscow,4868,1,11,7,2,30,12,18,40
CSKA Moscow,4868,2,12,3,5,27,17,10,39
Spart Moscow,4868,3,10,6,4,39,26,13,36
Zenit,4868,4,7,9,4,21,14,7,30
Krasnodar,4868,5,8,6,6,30,27,3,30
Terek Grozny,4868,6,7,6,7,24,27,-3,27
FK Rubin,4868,7,6,6,8,24,19,5,24
Din Moscow,4868,8,5,6,9,17,23,-6,21
Rostov,4868,9,4,7,9,10,17,-7,19
Amkar,4868,10,4,5,11,13,30,-17,17
Anzhi,4868,11,3,5,12,16,39,-23,14
Loko Moscow,4869,1,12,5,3,34,16,18,41
CSKA Moscow,4869,2,10,5,5,27,19,8,35
Krasnodar,4869,3,10,4,6,32,26,6,34
Spart Moscow,4869,4,9,6,5,37,27,10,33
Zenit,4869,5,7,9,4,23,16,7,30
Terek Grozny,4869,6,7,5,8,21,26,-5,26
Din Moscow,4869,7,5,8,7,18,22,-4,23
Amkar,4869,8,6,4,10,14,24,-10,22
FK Rubin,4869,9,5,6,9,22,20,2,21
Rostov,4869,10,4,6,10,10,20,-10,18
Anzhi,4869,11,3,6,11,17,39,-22,15
Loko Moscow,4870,1,11,6,3,31,14,17,39
CSKA Moscow,4870,2,11,4,5,27,18,9,37
Spart Moscow,4870,3,10,5,5,40,30,10,35
Zenit,4870,4,8,9,3,24,15,9,33
Krasnodar,4870,5,8,6,6,29,26,3,30
Terek Grozny,4870,6,8,6,6,23,22,1,30
FK Rubin,4870,7,5,7,8,24,20,4,22
Din Moscow,4870,8,5,7,8,20,26,-6,22
Rostov,4870,9,5,6,9,13,19,-6,21
Amkar,4870,10,4,5,11,10,24,-14,17
Anzhi,4870,11,2,5,13,14,41,-27,11
Loko Moscow,4871,1,13,5,2,33,12,21,44
CSKA Moscow,4871,2,11,4,5,27,18,9,37
Spart Moscow,4871,3,9,6,5,34,26,8,33
Krasnodar,4871,4,9,4,7,29,25,4,31
Zenit,4871,5,7,9,4,23,17,6,30
Terek Grozny,4871,6,7,7,6,22,24,-2,28
Din Moscow,4871,7,6,6,8,19,23,-4,24
Rostov,4871,8,5,6,9,11,17,-6,21
FK Rubin,4871,9,5,5,10,22,21,1,20
Amkar,4871,10,4,6,10,10,23,-13,18
Anzhi,4871,11,2,6,12,15,39,-24,12
Loko Moscow,4872,1,11,6,3,31,14,17,39
CSKA Moscow,4872,2,12,3,5,31,18,13,39
Spart Moscow,4872,3,9,6,5,37,29,8,33
Zenit,4872,4,8,8,4,24,17,7,32
Terek Grozny,4872,5,9,5,6,24,23,1,32
Krasnodar,4872,6,8,6,6,29,26,3,30
Din Moscow,4872,7,6,7,7,20,23,-3,25
FK Rubin,4872,8,5,7,8,24,20,4,22
Rostov,4872,9,4,6,10,12,20,-8,18
Amkar,4872,10,4,5,11,10,24,-14,17
Anzhi,4872,11,2,5,13,15,43,-28,11
Loko Moscow,4873,1,12,5,3,31,14,17,41
Spart Moscow,4873,2,11,5,4,38,26,12,38
CSKA Moscow,4873,3,11,4,5,29,18,11,37
Krasnodar,4873,4,10,4,6,34,25,9,34
Zenit,4873,5,7,9,4,22,15,7,30
Terek Grozny,4873,6,7,6,7,20,24,-4,27
Din Moscow,4873,7,6,6,8,19,23,-4,24
FK Rubin,4873,8,5,5,10,21,22,-1,20
Rostov,4873,9,4,6,10,10,19,-9,18
Amkar,4873,10,4,5,11,9,23,-14,17
Anzhi,4873,11,3,5,12,16,40,-24,14
Loko Moscow,4874,1,12,6,2,31,12,19,42
CSKA Moscow,4874,2,11,4,5,29,20,9,37
Zenit,4874,3,7,10,3,23,15,8,31
Spart Moscow,4874,4,8,6,6,35,31,4,30
Krasnodar,4874,5,8,5,7,27,25,2,29
Din Moscow,4874,6,7,6,7,21,21,0,27
Terek Grozny,4874,7,7,6,7,20,24,-4,27
Amkar,4874,8,6,4,10,13,23,-10,22
FK Rubin,4874,9,5,6,9,21,18,3,21
Rostov,4874,10,4,7,9,11,18,-7,19
Anzhi,4874,11,2,6,12,16,40,-24,12
Loko Moscow,4875,1,12,6,2,31,12,19,42
CSKA Moscow,4875,2,11,4,5,28,19,9,37
Spart Moscow,4875,3,9,5,6,37,28,9,32
Zenit,4875,4,7,9,4,23,16,7,30
Krasnodar,4875,5,8,5,7,28,26,2,29
Terek Grozny,4875,6,8,5,7,21,23,-2,29
FK Rubin,4875,7,5,7,8,23,19,4,22
Din Moscow,4875,8,5,7,8,18,25,-7,22
Amkar,4875,9,6,4,10,12,23,-11,22
Rostov,4875,10,5,6,9,11,17,-6,21
Anzhi,4875,11,2,6,12,15,39,-24,12
Loko Moscow,4876,1,11,5,4,30,16,14,38
CSKA Moscow,4876,2,11,3,6,30,19,11,36
Zenit,4876,3,9,8,3,25,13,12,35
Spart Moscow,4876,4,9,6,5,36,28,8,33
Krasnodar,4876,5,9,5,6,31,27,4,32
Terek Grozny,4876,6,8,5,7,23,23,0,29
FK Rubin,4876,7,5,7,8,23,19,4,22
Din Moscow,4876,8,5,7,8,18,24,-6,22
Rostov,4876,9,5,6,9,12,17,-5,21
Amkar,4876,10,5,5,10,10,22,-12,20
Anzhi,4876,11,2,5,13,15,45,-30,11
Loko Moscow,4877,1,12,5,3,32,15,17,41
CSKA Moscow,4877,2,11,3,6,27,19,8,36
Spart Moscow,4877,3,10,5,5,40,28,12,35
Krasnodar,4877,4,10,4,6,32,25,7,34
Zenit,4877,5,8,8,4,24,16,8,32
Din Moscow,4877,6,7,6,7,23,23,0,27
Terek Grozny,4877,7,7,6,7,22,26,-4,27
FK Rubin,4877,8,5,5,10,22,23,-1,20
Rostov,4877,9,4,6,10,10,19,-9,18
Amkar,4877,10,4,5,11,11,27,-16,17
Anzhi,4877,11,3,5,12,17,39,-22,14
Loko Moscow,4878,1,12,5,3,33,14,19,41
Spart Moscow,4878,2,10,6,4,41,27,14,36
CSKA Moscow,4878,3,11,3,6,27,20,7,36
Zenit,4878,4,8,8,4,23,16,7,32
Krasnodar,4878,5,9,5,6,32,27,5,32
Terek Grozny,4878,6,7,7,6,20,22,-2,28
Din Moscow,4878,7,6,6,8,18,24,-6,24
FK Rubin,4878,8,5,6,9,23,20,3,21
Rostov,4878,9,4,6,10,10,20,-10,18
Amkar,4878,10,4,6,10,11,24,-13,18
Anzhi,4878,11,2,6,12,15,39,-24,12
Loko Moscow,4879,1,11,6,3,32,15,17,39
CSKA Moscow,4879,2,11,4,5,30,19,11,37
Zenit,4879,3,7,10,3,24,16,8,31
Spart Moscow,4879,4,8,7,5,35,29,6,31
Krasnodar,4879,5,9,4,7,30,28,2,31
Terek Grozny,4879,6,7,6,7,21,24,-3,27
FK Rubin,4879,7,7,5,8,26,19,7,26
Din Moscow,4879,8,5,7,8,20,25,-5,22
Amkar,4879,9,6,4,10,12,22,-10,22
Rostov,4879,10,4,7,9,11,18,-7,19
Anzhi,4879,11,2,6,12,15,41,-26,12
Loko Moscow,4880,1,12,5,3,30,12,18,41
CSKA Moscow,4880,2,11,4,5,29,17,12,37
Zenit,4880,3,8,9,3,22,13,9,33
Spart Moscow,4880,4,9,5,6,37,30,7,32
Krasnodar,4880,5,9,4,7,29,25,4,31
Terek Grozny,4880,6,8,6,6,21,22,-1,30
Din Moscow,4880,7,7,6,7,22,23,-1,27
FK Rubin,4880,8,5,5,10,21,21,0,20
Amkar,4880,9,5,5,10,10,22,-12,20
Rostov,4880,10,4,6,10,11,19,-8,18
Anzhi,4880,11,2,5,13,14,42,-28,11
Loko Moscow,4881,1,11,7,2,33,15,18,40
CSKA Moscow,4881,2,11,4,5,31,20,11,37
Spart Moscow,4881,3,10,6,4,39,29,10,36
Krasnodar,4881,4,9,5,6,32,27,5,32
Zenit,4881,5,7,10,3,24,16,8,31
Terek Grozny,4881,6,8,6,6,22,23,-1,30
FK Rubin,4881,7,6,5,9,23,19,4,23
Din Moscow,4881,8,5,6,9,17,24,-7,21
Rostov,4881,9,4,6,10,11,19,-8,18
Amkar,4881,10,4,5,11,12,26,-14,17
Anzhi,4881,11,2,6,12,16,42,-26,12
Loko Moscow,4882,1,11,7,2,33,15,18,40
CSKA Moscow,4882,2,11,4,5,29,18,11,37
Spart Moscow,4882,3,10,5,5,37,26,11,35
Zenit,4882,4,7,10,3,23,15,8,31
Krasnodar,4882,5,8,6,6,31,28,3,30
Terek Grozny,4882,6,8,5,7,23,24,-1,29
Din Moscow,4882,7,6,7,7,19,22,-3,25
FK Rubin,4882,8,5,7,8,23,19,4,22
Amkar,4882,9,5,4,11,11,24,-13,19
Rostov,4882,10,4,6,10,10,20,-10,18
Anzhi,4882,11,2,5,13,14,42,-28,11
Loko Moscow,4883,1,11,6,3,30,13,17,39
Spart Moscow,4883,2,11,5,4,42,25,17,38
Zenit,4883,3,9,8,3,23,13,10,35
CSKA Moscow,4883,4,10,4,6,26,19,7,34
Krasnodar,4883,5,8,5,7,29,27,2,29
Terek Grozny,4883,6,8,5,7,22,24,-2,29
FK Rubin,4883,7,6,6,8,24,19,5,24
Din Moscow,4883,8,5,7,8,18,25,-7,22
Rostov,4883,9,4,6,10,10,21,-11,18
Amkar,4883,10,4,4,12,9,25,-16,16
Anzhi,4883,11,3,6,11,17,39,-22,15
Loko Moscow,4884,1,12,5,3,32,15,17,41
CSKA Moscow,4884,2,11,3,6,27,20,7,36
Krasnodar,4884,3,10,4,6,33,26,7,34
Spart Moscow,4884,4,9,5,6,37,29,8,32
Zenit,4884,5,8,8,4,24,16,8,32
Terek Grozny,4884,6,7,6,7,22,26,-4,27
Din Moscow,4884,7,5,7,8,19,25,-6,22
FK Rubin,4884,8,5,6,9,25,22,3,21
Rostov,4884,9,5,6,9,12,18,-6,21
Amkar,4884,10,5,5,10,12,24,-12,20
Anzhi,4884,11,3,5,12,18,40,-22,14
Loko Moscow,4885,1,12,5,3,32,16,16,41
CSKA Moscow,4885,2,12,3,5,29,17,12,39
Spart Moscow,4885,3,9,6,5,37,29,8,33
Krasnodar,4885,4,9,4,7,33,27,6,31
Zenit,4885,5,7,8,5,21,17,4,29
Terek Grozny,4885,6,7,6,7,21,24,-3,27
Din Moscow,4885,7,6,6,8,20,23,-3,24
FK Rubin,4885,8,6,5,9,23,20,3,23
Rostov,4885,9,5,6,9,12,18,-6,21
Amkar,4885,10,5,5,10,11,23,-12,20
Anzhi,4885,11,2,6,12,15,40,-25,12
Loko Moscow,4886,1,13,5,2,35,12,23,44
CSKA Moscow,4886,2,11,3,6,29,19,10,36
Spart Moscow,4886,3,9,6,5,37,30,7,33
Zenit,4886,4,7,8,5,23,19,4,29
Krasnodar,4886,5,8,5,7,28,29,-1,29
Terek Grozny,4886,6,8,5,7,23,25,-2,29
FK Rubin,4886,7,5,7,8,22,18,4,22
Din Moscow,4886,8,5,7,8,17,24,-7,22
Rostov,4886,9,4,7,9,10,17,-7,19
Amkar,4886,10,5,4,11,16,26,-10,19
Anzhi,4886,11,4,5,11,16,37,-21,17
Loko Moscow,4887,1,11,6,3,30,13,17,39
CSKA Moscow,4887,2,10,5,5,27,19,8,35
Spart Moscow,4887,3,9,6,5,40,29,11,33
Zenit,4887,4,8,9,3,24,15,9,33
Krasnodar,4887,5,9,5,6,32,26,6,32
Terek Grozny,4887,6,9,5,6,26,23,3,32
Din Moscow,4887,7,5,8,7,19,23,-4,23
FK Rubin,4887,8,5,6,9,23,22,1,21
Amkar,4887,9,5,4,11,12,28,-16,19
Rostov,4887,10,4,6,10,10,21,-11,18
Anzhi,4887,11,2,6,12,15,39,-24,12
Loko Moscow,4888,1,11,6,3,31,14,17,39
CSKA Moscow,4888,2,11,3,6,31,21,10,36
Zenit,4888,3,8,9,3,26,17,9,33
Spart Moscow,4888,4,8,8,4,37,29,8,32
Krasnodar,4888,5,9,5,6,28,24,4,32
Terek Grozny,4888,6,8,5,7,21,25,-4,29
Din Moscow,4888,7,6,7,7,21,24,-3,25
FK Rubin,4888,8,5,6,9,22,19,3,21
Amkar,4888,9,5,5,10,14,24,-10,20
Rostov,4888,10,4,7,9,10,17,-7,19
Anzhi,4888,11,2,5,13,15,42,-27,11
Loko Moscow,4889,1,11,6,3,31,14,17,39
CSKA Moscow,4889,2,12,3,5,32,20,12,39
Spart Moscow,4889,3,10,6,4,36,26,10,36
Zenit,4889,4,8,8,4,24,17,7,32
Krasnodar,4889,5,8,6,6,30,27,3,30
Terek Grozny,4889,6,8,5,7,22,25,-3,29
FK Rubin,4889,7,6,6,8,25,19,6,24
Din Moscow,4889,8,5,6,9,17,24,-7,21
Rostov,4889,9,4,6,10,10,18,-8,18
Amkar,4889,10,4,5,11,10,24,-14,17
Anzhi,4889,11,3,5,12,19,42,-23,14
Loko Moscow,4890,1,11,6,3,30,15,15,39
Spart Moscow,4890,2,10,6,4,40,26,14,36
CSKA Moscow,4890,3,10,5,5,27,19,8,35
Krasnodar,4890,4,9,5,6,32,26,6,32
Zenit,4890,5,7,10,3,23,15,8,31
Terek Grozny,4890,6,8,5,7,23,25,-2,29
FK Rubin,4890,7,5,7,8,24,20,4,22
Din Moscow,4890,8,5,7,8,18,26,-8,22
Rostov,4890,9,4,6,10,10,19,-9,18
Amkar,4890,10,4,5,11,10,24,-14,17
Anzhi,4890,11,3,6,11,18,40,-22,15
Loko Moscow,4891,1,11,5,4,30,15,15,38
Zenit,4891,2,9,8,3,26,15,11,35
CSKA Moscow,4891,3,10,4,6,27,21,6,34
Spart Moscow,4891,4,9,5,6,38,32,6,32
Krasnodar,4891,5,9,5,6,30,25,5,32
Terek Grozny,4891,6,8,5,7,22,25,-3,29
Din Moscow,4891,7,7,6,7,24,25,-1,27
Amkar,4891,8,6,4,10,14,24,-10,22
FK Rubin,4891,9,5,6,9,25,22,3,21
Rostov,4891,10,4,6,10,11,19,-8,18
Anzhi,4891,11,2,6,12,16,40,-24,12
Loko Moscow,4892,1,11,6,3,32,15,17,39
CSKA Moscow,4892,2,11,4,5,26,17,9,37
Spart Moscow,4892,3,10,5,5,36,27,9,35
Krasnodar,4892,4,10,4,6,30,25,5,34
Zenit,4892,5,7,10,3,23,15,8,31
Terek Grozny,4892,6,8,6,6,23,23,0,30
FK Rubin,4892,7,6,5,9,25,18,7,23
Rostov,4892,8,5,6,9,11,17,-6,21
Din Moscow,4892,9,5,6,9,18,27,-9,21
Amkar,4892,10,4,5,11,10,24,-14,17
Anzhi,4892,11,2,5,13,14,40,-26,11
Loko Moscow,4893,1,12,6,2,31,12,19,42
CSKA Moscow,4893,2,12,3,5,31,18,13,39
Spart Moscow,4893,3,10,6,4,37,25,12,36
Zenit,4893,4,7,9,4,22,18,4,30
Terek Grozny,4893,5,8,6,6,23,23,0,30
Krasnodar,4893,6,8,5,7,29,27,2,29
Din Moscow,4893,7,6,6,8,21,24,-3,24
FK Rubin,4893,8,5,6,9,23,23,0,21
Rostov,4893,9,4,6,10,10,18,-8,18
Amkar,4893,10,4,5,11,9,24,-15,17
Anzhi,4893,11,2,6,12,16,40,-24,12
Loko Moscow,4894,1,13,5,2,34,11,23,44
CSKA Moscow,4894,2,11,4,5,27,17,10,37
Spart Moscow,4894,3,10,6,4,38,27,11,36
Krasnodar,4894,4,9,4,7,28,27,1,31
Zenit,4894,5,7,9,4,21,15,6,30
Terek Grozny,4894,6,7,7,6,22,24,-2,28
Din Moscow,4894,7,6,6,8,20,24,-4,24
FK Rubin,4894,8,5,5,10,22,20,2,20
Rostov,4894,9,4,6,10,10,19,-9,18
Amkar,4894,10,4,6,10,11,24,-13,18
Anzhi,4894,11,2,6,12,15,40,-25,12
Loko Moscow,4895,1,11,5,4,32,16,16,38
Zenit,4895,2,9,8,3,27,16,11,35
Spart Moscow,4895,3,9,6,5,36,28,8,33
CSKA Moscow,4895,4,10,3,7,27,22,5,33
Krasnodar,4895,5,9,4,7,30,27,3,31
Terek Grozny,4895,6,8,5,7,24,24,0,29
FK Rubin,4895,7,7,5,8,25,19,6,26
Din Moscow,4895,8,5,6,9,19,25,-6,21
Rostov,4895,9,4,7,9,11,18,-7,19
Amkar,4895,10,5,4,11,10,25,-15,19
Anzhi,4895,11,4,5,11,18,39,-21,17
Loko Moscow,4896,1,12,5,3,30,12,18,41
Krasnodar,4896,2,10,4,6,31,25,6,34
Spart Moscow,4896,3,9,6,5,37,30,7,33
CSKA Moscow,4896,4,10,3,7,25,20,5,33
Zenit,4896,5,8,8,4,23,14,9,32
Terek Grozny,4896,6,9,5,6,24,23,1,32
Din Moscow,4896,7,7,6,7,20,21,-1,27
FK Rubin,4896,8,5,5,10,22,21,1,20
Rostov,4896,9,4,6,10,11,19,-8,18
Amkar,4896,10,4,5,11,11,25,-14,17
Anzhi,4896,11,3,5,12,16,40,-24,14
Loko Moscow,4897,1,11,6,3,30,14,16,39
CSKA Moscow,4897,2,11,4,5,29,19,10,37
Spart Moscow,4897,3,10,5,5,37,28,9,35
Krasnodar,4897,4,9,5,6,31,26,5,32
Zenit,4897,5,7,10,3,23,15,8,31
Terek Grozny,4897,6,8,6,6,23,24,-1,30
Din Moscow,4897,7,6,6,8,19,23,-4,24
FK Rubin,4897,8,5,6,9,22,19,3,21
Amkar,4897,9,5,4,11,11,24,-13,19
Rostov,4897,10,4,6,10,10,18,-8,18
Anzhi,4897,11,2,6,12,16,41,-25,12
Loko Moscow,4898,1,12,6,2,31,12,19,42
CSKA Moscow,4898,2,10,4,6,26,19,7,34
Spart Moscow,4898,3,9,6,5,39,29,10,33
Zenit,4898,4,8,9,3,23,14,9,33
Terek Grozny,4898,5,8,6,6,22,22,0,30
Krasnodar,4898,6,8,5,7,27,25,2,29
Din Moscow,4898,7,7,6,7,20,22,-2,27
FK Rubin,4898,8,5,6,9,21,18,3,21
Rostov,4898,9,4,6,10,11,21,-10,18
Amkar,4898,10,4,6,10,10,23,-13,18
Anzhi,4898,11,2,6,12,15,40,-25,12
Loko Moscow,4899,1,12,5,3,34,13,21,41
CSKA Moscow,4899,2,12,3,5,28,17,11,39
Spart Moscow,4899,3,10,5,5,37,28,9,35
Zenit,4899,4,8,8,4,23,16,7,32
Krasnodar,4899,5,9,4,7,28,28,0,31
Terek Grozny,4899,6,8,6,6,23,24,-1,30
Din Moscow,4899,7,6,6,8,18,22,-4,24
Rostov,4899,8,5,6,9,13,19,-6,21
FK Rubin,4899,9,5,5,10,21,19,2,20
Amkar,4899,10,4,5,11,10,24,-14,17
Anzhi,4899,11,2,5,13,15,40,-25,11
Loko Moscow,4900,1,11,7,2,30,12,18,40
CSKA Moscow,4900,2,10,5,5,28,20,8,35
Krasnodar,4900,3,9,5,6,29,25,4,32
Terek Grozny,4900,4,9,5,6,22,22,0,32
Zenit,4900,5,7,10,3,21,13,8,31
Spart Moscow,4900,6,8,6,6,34,32,2,30
FK Rubin,4900,7,6,5,9,23,18,5,23
Din Moscow,4900,8,5,7,8,18,24,-6,22
Rostov,4900,9,5,6,9,13,17,-4,21
Amkar,4900,10,5,4,11,12,23,-11,19
Anzhi,4900,11,2,6,12,17,41,-24,12
Loko Moscow,4901,1,11,5,4,30,14,16,38
Zenit,4901,2,9,8,3,25,14,11,35
Spart Moscow,4901,3,9,7,4,38,27,11,34
CSKA Moscow,4901,4,10,4,6,25,19,6,34
Krasnodar,4901,5,10,4,6,29,24,5,34
Terek Grozny,4901,6,7,6,7,21,24,-3,27
FK Rubin,4901,7,6,5,9,22,18,4,23
Din Moscow,4901,8,5,7,8,18,23,-5,22
Amkar,4901,9,5,5,10,10,22,-12,20
Rostov,4901,10,4,6,10,11,21,-10,18
Anzhi,4901,11,2,7,11,15,38,-23,13
Loko Moscow,4902,1,12,5,3,32,14,18,41
CSKA Moscow,4902,2,11,4,5,29,19,10,37
Spart Moscow,4902,3,9,6,5,38,28,10,33
Zenit,4902,4,8,9,3,22,13,9,33
Krasnodar,4902,5,8,5,7,29,27,2,29
Terek Grozny,4902,6,7,7,6,20,22,-2,28
Din Moscow,4902,7,5,8,7,19,23,-4,23
FK Rubin,4902,8,5,7,8,21,17,4,22
Rostov,4902,9,5,6,9,11,17,-6,21
Amkar,4902,10,4,5,11,9,25,-16,17
Anzhi,4902,11,2,6,12,16,41,-25,12
Loko Moscow,4903,1,13,5,2,33,12,21,44
CSKA Moscow,4903,2,10,3,7,26,20,6,33
Zenit,4903,3,8,8,4,22,14,8,32
Spart Moscow,4903,4,8,7,5,37,31,6,31
Terek Grozny,4903,5,8,6,6,23,24,-1,30
Krasnodar,4903,6,8,4,8,29,31,-2,28
FK Rubin,4903,7,7,5,8,26,18,8,26
Din Moscow,4903,8,5,7,8,20,25,-5,22
Rostov,4903,9,4,7,9,11,18,-7,19
Amkar,4903,10,5,4,11,12,24,-12,19
Anzhi,4903,11,3,6,11,17,39,-22,15
Loko Moscow,4904,1,12,5,3,32,13,19,41
Spart Moscow,4904,2,11,5,4,38,26,12,38
CSKA Moscow,4904,3,11,4,5,29,19,10,37
Zenit,4904,4,8,9,3,23,14,9,33
Krasnodar,4904,5,9,4,7,30,28,2,31
Terek Grozny,4904,6,7,6,7,22,26,-4,27
Din Moscow,4904,7,5,7,8,17,22,-5,22
FK Rubin,4904,8,5,6,9,22,19,3,21
Amkar,4904,9,5,4,11,11,23,-12,19
Rostov,4904,10,4,6,10,11,20,-9,18
Anzhi,4904,11,2,6,12,17,42,-25,12
Loko Moscow,4905,1,11,7,2,30,12,18,40
CSKA Moscow,4905,2,11,4,5,26,17,9,37
Zenit,4905,3,7,10,3,22,14,8,31
Spart Moscow,4905,4,8,7,5,36,29,7,31
Krasnodar,4905,5,8,5,7,27,26,1,29
Terek Grozny,4905,6,8,5,7,22,25,-3,29
Din Moscow,4905,7,6,7,7,20,23,-3,25
FK Rubin,4905,8,6,5,9,23,18,5,23
Rostov,4905,9,4,7,9,11,18,-7,19
Amkar,4905,10,5,4,11,10,23,-13,19
Anzhi,4905,11,3,5,12,17,39,-22,14
Loko Moscow,4906,1,11,6,3,31,15,16,39
CSKA Moscow,4906,2,11,3,6,27,18,9,36
Zenit,4906,3,9,8,3,24,13,11,35
Spart Moscow,4906,4,10,5,5,37,28,9,35
Krasnodar,4906,5,9,5,6,33,27,6,32
Terek Grozny,4906,6,8,5,7,22,23,-1,29
Din Moscow,4906,7,6,6,8,20,23,-3,24
Amkar,4906,8,6,4,10,13,23,-10,22
FK Rubin,4906,9,5,5,10,22,24,-2,20
Rostov,4906,10,4,6,10,10,18,-8,18
Anzhi,4906,11,2,5,13,14,41,-27,11
Loko Moscow,4907,1,12,5,3,31,13,18,41
CSKA Moscow,4907,2,11,3,6,30,20,10,36
Spart Moscow,4907,3,10,5,5,37,27,10,35
Zenit,4907,4,9,8,3,24,14,10,35
Krasnodar,4907,5,8,4,8,28,27,1,28
Terek Grozny,4907,6,7,6,7,21,24,-3,27
Din Moscow,4907,7,6,7,7,19,21,-2,25
FK Rubin,4907,8,6,6,8,22,17,5,24
Amkar,4907,9,5,4,11,10,24,-14,19
Rostov,4907,10,4,6,10,10,19,-9,18
Anzhi,4907,11,2,6,12,16,42,-26,12
Loko Moscow,4908,1,11,5,4,29,16,13,38
CSKA Moscow,4908,2,11,4,5,30,20,10,37
Spart Moscow,4908,3,10,5,5,35,26,9,35
Krasnodar,4908,4,10,4,6,32,24,8,34
Zenit,4908,5,8,9,3,23,14,9,33
Terek Grozny,4908,6,8,5,7,22,26,-4,29
Din Moscow,4908,7,5,7,8,17,22,-5,22
FK Rubin,4908,8,5,6,9,21,18,3,21
Rostov,4908,9,5,6,9,11,17,-6,21
Amkar,4908,10,5,4,11,13,24,-11,19
Anzhi,4908,11,2,5,13,16,42,-26,11
Loko Moscow,4909,1,13,5,2,33,11,22,44
CSKA Moscow,4909,2,11,3,6,32,21,11,36
Spart Moscow,4909,3,9,6,5,40,28,12,33
Zenit,4909,4,8,8,4,23,17,6,32
Terek Grozny,4909,5,8,5,7,22,25,-3,29
Krasnodar,4909,6,8,4,8,28,28,0,28
Din Moscow,4909,7,6,6,8,19,26,-7,24
FK Rubin,4909,8,6,5,9,24,20,4,23
Rostov,4909,9,4,7,9,12,19,-7,19
Amkar,4909,10,5,4,11,11,24,-13,19
Anzhi,4909,11,3,5,12,18,43,-25,14
Loko Moscow,4910,1,12,5,3,33,15,18,41
CSKA Moscow,4910,2,11,4,5,27,18,9,37
Spart Moscow,4910,3,10,6,4,37,27,10,36
Krasnodar,4910,4,10,4,6,33,27,6,34
Zenit,4910,5,7,9,4,22,15,7,30
Terek Grozny,4910,6,7,6,7,20,23,-3,27
Din Moscow,4910,7,6,6,8,20,24,-4,24
FK Rubin,4910,8,5,5,10,21,20,1,20
Rostov,4910,9,4,7,9,10,17,-7,19
Amkar,4910,10,4,5,11,9,23,-14,17
Anzhi,4910,11,3,5,12,15,38,-23,14
Loko Moscow,4911,1,12,5,3,32,14,18,41
CSKA Moscow,4911,2,11,3,6,27,18,9,36
Spart Moscow,4911,3,10,5,5,41,27,14,35
Krasnodar,4911,4,9,5,6,29,25,4,32
Zenit,4911,5,7,8,5,22,17,5,29
Terek Grozny,4911,6,7,6,7,20,24,-4,27
Din Moscow,4911,7,6,6,8,18,26,-8,24
Amkar,4911,8,6,4,10,13,23,-10,22
FK Rubin,4911,9,5,6,9,21,18,3,21
Rostov,4911,10,4,6,10,10,19,-9,18
Anzhi,4911,11,3,6,11,15,37,-22,15
Loko Moscow,4912,1,12,5,3,33,15,18,41
CSKA Moscow,4912,2,11,4,5,29,18,11,37
Spart Moscow,4912,3,9,6,5,38,31,7,33
Krasnodar,4912,4,9,4,7,30,28,2,31
Zenit,4912,5,7,9,4,23,16,7,30
Terek Grozny,4912,6,8,6,6,24,24,0,30
FK Rubin,4912,7,7,5,8,25,17,8,26
Din Moscow,4912,8,5,7,8,19,25,-6,22
Rostov,4912,9,5,6,9,13,18,-5,21
Amkar,4912,10,4,4,12,11,27,-16,16
Anzhi,4912,11,2,6,12,15,41,-26,12
Loko Moscow,4913,1,13,5,2,35,13,22,44
CSKA Moscow,4913,2,12,3,5,30,18,12,39
Spart Moscow,4913,3,9,6,5,37,28,9,33
Terek Grozny,4913,4,9,5,6,24,22,2,32
Krasnodar,4913,5,9,4,7,31,27,4,31
Zenit,4913,6,7,8,5,23,20,3,29
Din Moscow,4913,7,6,7,7,19,22,-3,25
FK Rubin,4913,8,5,5,10,22,21,1,20
Amkar,4913,9,5,4,11,10,25,-15,19
Rostov,4913,10,4,6,10,11,20,-9,18
Anzhi,4913,11,2,5,13,14,40,-26,11
Loko Moscow,4914,1,11,6,3,30,13,17,39
Spart Moscow,4914,2,11,5,4,42,27,15,38
Zenit,4914,3,9,8,3,24,14,10,35
CSKA Moscow,4914,4,10,4,6,26,19,7,34
Krasnodar,4914,5,8,5,7,28,27,1,29
Terek Grozny,4914,6,8,5,7,23,24,-1,29
FK Rubin,4914,7,6,6,8,25,19,6,24
Din Moscow,4914,8,5,7,8,20,27,-7,22
Rostov,4914,9,4,6,10,10,18,-8,18
Amkar,4914,10,4,4,12,11,29,-18,16
Anzhi,4914,11,3,6,11,15,37,-22,15
Loko Moscow,4915,1,12,5,3,30,12,18,41
Spart Moscow,4915,2,11,5,4,40,28,12,38
CSKA Moscow,4915,3,11,3,6,27,19,8,36
Krasnodar,4915,4,9,5,6,29,25,4,32
Zenit,4915,5,7,8,5,21,15,6,29
Terek Grozny,4915,6,7,6,7,21,24,-3,27
FK Rubin,4915,7,6,6,8,24,19,5,24
Din Moscow,4915,8,5,6,9,19,26,-7,21
Rostov,4915,9,4,6,10,12,20,-8,18
Amkar,4915,10,4,5,11,9,23,-14,17
Anzhi,4915,11,4,5,11,18,39,-21,17
Loko Moscow,4916,1,12,5,3,32,15,17,41
CSKA Moscow,4916,2,11,4,5,28,18,10,37
Spart Moscow,4916,3,10,5,5,39,29,10,35
Krasnodar,4916,4,9,5,6,32,25,7,32
Zenit,4916,5,7,9,4,22,17,5,30
Terek Grozny,4916,6,7,7,6,22,24,-2,28
FK Rubin,4916,7,5,7,8,23,19,4,22
Din Moscow,4916,8,5,7,8,18,24,-6,22
Rostov,4916,9,5,6,9,13,17,-4,21
Amkar,4916,10,4,5,11,11,27,-16,17
Anzhi,4916,11,2,6,12,15,40,-25,12
Loko Moscow,4917,1,12,5,3,32,17,15,41
Spart Moscow,4917,2,11,5,4,42,28,14,38
CSKA Moscow,4917,3,11,4,5,32,18,14,37
Krasnodar,4917,4,9,5,6,32,25,7,32
Zenit,4917,5,7,9,4,23,16,7,30
Terek Grozny,4917,6,7,7,6,22,24,-2,28
Din Moscow,4917,7,6,6,8,19,25,-6,24
FK Rubin,4917,8,5,6,9,21,18,3,21
Rostov,4917,9,4,6,10,10,19,-9,18
Amkar,4917,10,4,5,11,11,25,-14,17
Anzhi,4917,11,2,6,12,16,45,-29,12
Loko Moscow,4918,1,12,6,2,33,14,19,42
Spart Moscow,4918,2,10,6,4,38,28,10,36
CSKA Moscow,4918,3,10,5,5,27,19,8,35
Zenit,4918,4,7,10,3,23,15,8,31
Krasnodar,4918,5,8,4,8,29,30,-1,28
Terek Grozny,4918,6,7,7,6,21,23,-2,28
FK Rubin,4918,7,7,5,8,26,18,8,26
Din Moscow,4918,8,5,7,8,20,25,-5,22
Rostov,4918,9,4,6,10,10,18,-8,18
Amkar,4918,10,4,5,11,11,25,-14,17
Anzhi,4918,11,2,7,11,15,38,-23,13
Loko Moscow,4919,1,12,6,2,33,13,20,42
CSKA Moscow,4919,2,12,3,5,29,17,12,39
Spart Moscow,4919,3,10,6,4,39,26,13,36
Krasnodar,4919,4,9,5,6,29,25,4,32
Terek Grozny,4919,5,9,5,6,26,25,1,32
Zenit,4919,6,7,8,5,22,18,4,29
Din Moscow,4919,7,6,7,7,18,21,-3,25
FK Rubin,4919,8,5,5,10,21,19,2,20
Rostov,4919,9,4,6,10,11,20,-9,18
Amkar,4919,10,4,4,12,12,30,-18,16
Anzhi,4919,11,2,5,13,14,40,-26,11
Loko Moscow,4920,1,12,5,3,30,13,17,41
CSKA Moscow,4920,2,11,3,6,26,18,8,36
Spart Moscow,4920,3,9,6,5,36,29,7,33
Zenit,4920,4,8,8,4,22,14,8,32
Krasnodar,4920,5,9,5,6,29,24,5,32
Terek Grozny,4920,6,7,7,6,22,24,-2,28
FK Rubin,4920,7,6,6,8,23,18,5,24
Din Moscow,4920,8,5,6,9,18,24,-6,21
Amkar,4920,9,5,5,10,13,24,-11,20
Rostov,4920,10,4,7,9,11,18,-7,19
Anzhi,4920,11,2,6,12,15,39,-24,12
Loko Moscow,4921,1,12,6,2,32,13,19,42
CSKA Moscow,4921,2,12,3,5,27,17,10,39
Spart Moscow,4921,3,11,5,4,41,25,16,38
Krasnodar,4921,4,9,5,6,30,26,4,32
Terek Grozny,4921,5,8,6,6,23,23,0,30
Zenit,4921,6,7,8,5,22,16,6,29
FK Rubin,4921,7,6,5,9,25,20,5,23
Din Moscow,4921,8,5,6,9,18,28,-10,21
Rostov,4921,9,4,6,10,10,19,-9,18
Amkar,4921,10,4,5,11,9,24,-15,17
Anzhi,4921,11,2,5,13,15,41,-26,11
Loko Moscow,4922,1,12,6,2,32,13,19,42
CSKA Moscow,4922,2,10,5,5,30,22,8,35
Spart Moscow,4922,3,9,6,5,40,30,10,33
Krasnodar,4922,4,9,5,6,33,28,5,32
Terek Grozny,4922,5,9,5,6,23,23,0,32
Zenit,4922,6,7,9,4,24,17,7,30
FK Rubin,4922,7,6,5,9,27,21,6,23
Din Moscow,4922,8,5,6,9,18,29,-11,21
Rostov,4922,9,4,7,9,11,18,-7,19
Amkar,4922,10,5,4,11,13,26,-13,19
Anzhi,4922,11,2,6,12,16,40,-24,12
Loko Moscow,4923,1,11,6,3,32,15,17,39
CSKA Moscow,4923,2,11,3,6,28,20,8,36
Spart Moscow,4923,3,10,5,5,38,27,11,35
Zenit,4923,4,9,8,3,24,14,10,35
Krasnodar,4923,5,9,5,6,31,27,4,32
Terek Grozny,4923,6,9,5,6,26,23,3,32
Din Moscow,4923,7,6,6,8,19,24,-5,24
Rostov,4923,8,5,6,9,11,17,-6,21
FK Rubin,4923,9,5,5,10,22,20,2,20
Amkar,4923,10,4,4,12,9,27,-18,16
Anzhi,4923,11,2,5,13,17,43,-26,11
Loko Moscow,4924,1,12,6,2,31,12,19,42
CSKA Moscow,4924,2,11,3,6,28,24,4,36
Spart Moscow,4924,3,10,5,5,44,28,16,35
Zenit,4924,4,8,8,4,27,15,12,32
Krasnodar,4924,5,9,5,6,30,26,4,32
Terek Grozny,4924,6,7,5,8,22,27,-5,26
Din Moscow,4924,7,6,6,8,19,28,-9,24
Amkar,4924,8,6,4,10,12,22,-10,22
FK Rubin,4924,9,5,5,10,23,21,2,20
Rostov,4924,10,4,6,10,10,21,-11,18
Anzhi,4924,11,3,5,12,20,42,-22,14
Loko Moscow,4925,1,12,6,2,32,12,20,42
CSKA Moscow,4925,2,11,4,5,30,20,10,37
Spart Moscow,4925,3,9,6,5,38,28,10,33
Zenit,4925,4,7,9,4,24,18,6,30
Krasnodar,4925,5,8,6,6,27,24,3,30
Terek Grozny,4925,6,8,5,7,22,25,-3,29
FK Rubin,4925,7,5,7,8,23,19,4,22
Din Moscow,4925,8,5,7,8,20,27,-7,22
Rostov,4925,9,5,6,9,11,17,-6,21
Amkar,4925,10,5,5,10,12,23,-11,20
Anzhi,4925,11,2,5,13,16,42,-26,11
Loko Moscow,4926,1,12,5,3,32,13,19,41
CSKA Moscow,4926,2,12,3,5,29,17,12,39
Spart Moscow,4926,3,10,6,4,41,26,15,36
Zenit,4926,4,8,8,4,23,16,7,32
Terek Grozny,4926,5,8,5,7,21,24,-3,29
Krasnodar,4926,6,8,4,8,27,28,-1,28
FK Rubin,4926,7,6,6,8,24,18,6,24
Din Moscow,4926,8,5,8,7,18,22,-4,23
Amkar,4926,9,5,4,11,12,27,-15,19
Rostov,4926,10,4,6,10,10,20,-10,18
Anzhi,4926,11,2,5,13,14,40,-26,11
Loko Moscow,4927,1,12,5,3,32,13,19,41
Spart Moscow,4927,2,11,5,4,41,28,13,38
CSKA Moscow,4927,3,11,4,5,27,18,9,37
Krasnodar,4927,4,10,4,6,30,24,6,34
Zenit,4927,5,7,9,4,22,16,6,30
Terek Grozny,4927,6,7,7,6,23,25,-2,28
Din Moscow,4927,7,5,7,8,19,25,-6,22
FK Rubin,4927,8,5,6,9,21,19,2,21
Rostov,4927,9,4,6,10,10,19,-9,18
Amkar,4927,10,4,5,11,12,26,-14,17
Anzhi,4927,11,2,6,12,16,40,-24,12
Loko Moscow,4928,1,12,6,2,34,11,23,42
Spart Moscow,4928,2,10,6,4,40,28,12,36
CSKA Moscow,4928,3,11,3,6,28,21,7,36
Zenit,4928,4,8,8,4,25,19,6,32
Krasnodar,4928,5,9,5,6,29,25,4,32
Terek Grozny,4928,6,9,5,6,24,24,0,32
FK Rubin,4928,7,6,5,9,23,19,4,23
Din Moscow,4928,8,5,6,9,18,25,-7,21
Rostov,4928,9,4,6,10,10,19,-9,18
Amkar,4928,10,4,5,11,11,25,-14,17
Anzhi,4928,11,2,5,13,16,42,-26,11
Loko Moscow,4929,1,12,6,2,32,11,21,42
Spart Moscow,4929,2,10,5,5,38,27,11,35
CSKA Moscow,4929,3,10,3,7,26,22,4,33
Zenit,4929,4,8,8,4,25,17,8,32
Krasnodar,4929,5,8,6,6,28,25,3,30
Terek Grozny,4929,6,8,6,6,27,24,3,30
Din Moscow,4929,7,6,6,8,20,25,-5,24
FK Rubin,4929,8,5,6,9,23,21,2,21
Amkar,4929,9,5,4,11,12,29,-17,19
Rostov,4929,10,4,6,10,10,18,-8,18
Anzhi,4929,11,3,6,11,16,38,-22,15
Loko Moscow,4930,1,11,5,4,29,13,16,38
CSKA Moscow,4930,2,11,3,6,26,18,8,36
Zenit,4930,3,8,8,4,22,14,8,32
Spart Moscow,4930,4,9,5,6,36,30,6,32
Krasnodar,4930,5,9,5,6,28,24,4,32
Terek Grozny,4930,6,8,5,7,24,26,-2,29
Din Moscow,4930,7,6,7,7,19,22,-3,25
FK Rubin,4930,8,5,7,8,22,18,4,22
Rostov,4930,9,5,6,9,13,18,-5,21
Anzhi,4930,10,4,5,11,19,38,-19,17
Amkar,4930,11,4,4,12,10,27,-17,16
Loko Moscow,4931,1,12,6,2,31,12,19,42
Spart Moscow,4931,2,10,6,4,39,26,13,36
CSKA Moscow,4931,3,11,3,6,27,18,9,36
Zenit,4931,4,8,8,4,22,14,8,32
Krasnodar,4931,5,8,6,6,28,25,3,30
Terek Grozny,4931,6,7,6,7,20,23,-3,27
Din Moscow,4931,7,6,6,8,18,25,-7,24
FK Rubin,4931,8,5,6,9,21,18,3,21
Rostov,4931,9,4,7,9,11,18,-7,19
Amkar,4931,10,5,4,11,10,23,-13,19
Anzhi,4931,11,2,6,12,14,39,-25,12
Loko Moscow,4932,1,11,6,3,30,13,17,39
CSKA Moscow,4932,2,11,3,6,27,18,9,36
Spart Moscow,4932,3,9,6,5,39,30,9,33
Zenit,4932,4,8,9,3,23,14,9,33
Krasnodar,4932,5,9,4,7,29,26,3,31
Din Moscow,4932,6,7,6,7,23,25,-2,27
Terek Grozny,4932,7,7,6,7,20,23,-3,27
FK Rubin,4932,8,6,5,9,25,21,4,23
Rostov,4932,9,4,7,9,11,18,-7,19
Amkar,4932,10,4,5,11,10,25,-15,17
Anzhi,4932,11,3,5,12,15,39,-24,14
Loko Moscow,4933,1,12,5,3,33,13,20,41
CSKA Moscow,4933,2,11,4,5,27,17,10,37
Spart Moscow,4933,3,9,7,4,39,27,12,34
Krasnodar,4933,4,9,4,7,29,26,3,31
Zenit,4933,5,7,9,4,22,17,5,30
Terek Grozny,4933,6,8,6,6,23,24,-1,30
FK Rubin,4933,7,6,6,8,23,18,5,24
Din Moscow,4933,8,5,8,7,18,22,-4,23
Rostov,4933,9,4,6,10,11,22,-11,18
Amkar,4933,10,4,6,10,10,23,-13,18
Anzhi,4933,11,2,5,13,15,41,-26,11
Loko Moscow,4934,1,11,6,3,29,12,17,39
CSKA Moscow,4934,2,11,4,5,31,19,12,37
Spart Moscow,4934,3,10,5,5,39,29,10,35
Zenit,4934,4,7,10,3,22,14,8,31
Krasnodar,4934,5,9,4,7,29,26,3,31
Terek Grozny,4934,6,8,5,7,23,24,-1,29
FK Rubin,4934,7,6,6,8,23,18,5,24
Din Moscow,4934,8,5,7,8,18,24,-6,22
Rostov,4934,9,5,6,9,11,17,-6,21
Amkar,4934,10,4,4,12,11,28,-17,16
Anzhi,4934,11,3,5,12,17,42,-25,14
Loko Moscow,4935,1,11,6,3,30,13,17,39
CSKA Moscow,4935,2,11,4,5,30,21,9,37
Spart Moscow,4935,3,10,5,5,39,32,7,35
Zenit,4935,4,8,8,4,24,16,8,32
Terek Grozny,4935,5,8,6,6,23,22,1,30
Krasnodar,4935,6,8,5,7,27,27,0,29
FK Rubin,4935,7,7,5,8,26,17,9,26
Rostov,4935,8,5,6,9,15,18,-3,21
Din Moscow,4935,9,5,6,9,18,25,-7,21
Amkar,4935,10,4,4,12,10,28,-18,16
Anzhi,4935,11,2,7,11,17,40,-23,13
Loko Moscow,4936,1,12,5,3,33,13,20,41
CSKA Moscow,4936,2,12,3,5,30,18,12,39
Spart Moscow,4936,3,11,5,4,40,27,13,38
Zenit,4936,4,8,8,4,24,16,8,32
Terek Grozny,4936,5,9,5,6,22,22,0,32
Krasnodar,4936,6,9,4,7,28,27,1,31
Din Moscow,4936,7,6,6,8,21,26,-5,24
FK Rubin,4936,8,5,5,10,22,20,2,20
Rostov,4936,9,4,6,10,10,19,-9,18
Amkar,4936,10,4,4,12,9,24,-15,16
Anzhi,4936,11,2,5,13,14,41,-27,11
Loko Moscow,4937,1,12,5,3,32,15,17,41
CSKA Moscow,4937,2,11,3,6,27,19,8,36
Spart Moscow,4937,3,9,6,5,35,27,8,33
Zenit,4937,4,8,8,4,24,15,9,32
Terek Grozny,4937,5,8,6,6,24,23,1,30
Krasnodar,4937,6,8,5,7,28,26,2,29
Din Moscow,4937,7,6,7,7,18,21,-3,25
FK Rubin,4937,8,5,6,9,21,18,3,21
Amkar,4937,9,5,5,10,12,24,-12,20
Rostov,4937,10,4,6,10,10,18,-8,18
Anzhi,4937,11,3,5,12,16,41,-25,14
Loko Moscow,4938,1,11,7,2,33,15,18,40
CSKA Moscow,4938,2,11,3,6,27,18,9,36
Spart Moscow,4938,3,9,7,4,40,27,13,34
Zenit,4938,4,8,9,3,24,15,9,33
Krasnodar,4938,5,9,5,6,31,27,4,32
Terek Grozny,4938,6,9,5,6,25,23,2,32
Din Moscow,4938,7,6,7,7,19,22,-3,25
FK Rubin,4938,8,5,5,10,22,20,2,20
Rostov,4938,9,4,6,10,10,22,-12,18
Amkar,4938,10,4,5,11,11,26,-15,17
Anzhi,4938,11,2,5,13,14,41,-27,11
Loko Moscow,4939,1,11,5,4,30,16,14,38
CSKA Moscow,4939,2,11,3,6,28,20,8,36
Zenit,4939,3,9,8,3,25,14,11,35
Spart Moscow,4939,4,10,5,5,38,28,10,35
Krasnodar,4939,5,10,4,6,31,25,6,34
Terek Grozny,4939,6,7,6,7,21,24,-3,27
FK Rubin,4939,7,6,5,9,23,19,4,23
Amkar,4939,8,6,4,10,13,23,-10,22
Din Moscow,4939,9,5,6,9,18,25,-7,21
Rostov,4939,10,4,6,10,10,19,-9,18
Anzhi,4939,11,2,6,12,16,40,-24,12
Loko Moscow,4940,1,12,6,2,32,12,20,42
Spart Moscow,4940,2,11,5,4,39,25,14,38
CSKA Moscow,4940,3,11,3,6,32,21,11,36
Zenit,4940,4,8,8,4,25,18,7,32
Krasnodar,4940,5,8,5,7,29,27,2,29
FK Rubin,4940,6,7,5,8,25,19,6,26
Terek Grozny,4940,7,7,5,8,23,29,-6,26
Din Moscow,4940,8,5,6,9,18,24,-6,21
Amkar,4940,9,5,4,11,12,24,-12,19
Rostov,4940,10,4,6,10,10,20,-10,18
Anzhi,4940,11,3,5,12,18,44,-26,14
Loko Moscow,4941,1,11,7,2,30,12,18,40
CSKA Moscow,4941,2,11,3,6,26,18,8,36
Krasnodar,4941,3,9,5,6,30,25,5,32
Spart Moscow,4941,4,8,7,5,34,29,5,31
Zenit,4941,5,7,9,4,22,15,7,30
Terek Grozny,4941,6,8,5,7,22,24,-2,29
Din Moscow,4941,7,5,8,7,19,23,-4,23
Amkar,4941,8,6,4,10,13,22,-9,22
FK Rubin,4941,9,5,6,9,23,21,2,21
Rostov,4941,10,4,7,9,10,17,-7,19
Anzhi,4941,11,3,5,12,16,39,-23,14
Loko Moscow,4942,1,12,6,2,30,11,19,42
CSKA Moscow,4942,2,10,4,6,27,22,5,34
Zenit,4942,3,8,9,3,24,13,11,33
Krasnodar,4942,4,9,4,7,33,26,7,31
Spart Moscow,4942,5,8,6,6,35,32,3,30
Terek Grozny,4942,6,8,6,6,25,26,-1,30
Din Moscow,4942,7,6,7,7,22,23,-1,25
FK Rubin,4942,8,5,6,9,23,24,-1,21
Amkar,4942,9,5,5,10,13,24,-11,20
Rostov,4942,10,4,7,9,11,18,-7,19
Anzhi,4942,11,2,6,12,18,42,-24,12
Loko Moscow,4943,1,12,5,3,32,15,17,41
CSKA Moscow,4943,2,11,3,6,28,21,7,36
Zenit,4943,3,9,8,3,27,14,13,35
Spart Moscow,4943,4,9,6,5,38,30,8,33
Terek Grozny,4943,5,8,6,6,23,24,-1,30
Krasnodar,4943,6,8,5,7,29,28,1,29
Din Moscow,4943,7,6,7,7,21,23,-2,25
FK Rubin,4943,8,5,6,9,22,20,2,21
Amkar,4943,9,5,5,10,14,24,-10,20
Rostov,4943,10,4,6,10,10,20,-10,18
Anzhi,4943,11,2,5,13,15,40,-25,11
Loko Moscow,4944,1,12,5,3,34,15,19,41
Zenit,4944,2,9,8,3,25,15,10,35
CSKA Moscow,4944,3,10,4,6,29,22,7,34
Spart Moscow,4944,4,9,6,5,36,28,8,33
Krasnodar,4944,5,9,4,7,31,28,3,31
Terek Grozny,4944,6,8,6,6,22,22,0,30
Din Moscow,4944,7,7,6,7,22,22,0,27
FK Rubin,4944,8,5,5,10,21,22,-1,20
Rostov,4944,9,4,7,9,11,18,-7,19
Amkar,4944,10,4,4,12,9,25,-16,16
Anzhi,4944,11,2,7,11,17,40,-23,13
Loko Moscow,4945,1,13,5,2,31,11,20,44
CSKA Moscow,4945,2,11,4,5,28,18,10,37
Spart Moscow,4945,3,9,6,5,37,27,10,33
Krasnodar,4945,4,9,4,7,28,25,3,31
Zenit,4945,5,7,8,5,21,16,5,29
Terek Grozny,4945,6,8,5,7,24,25,-1,29
FK Rubin,4945,7,6,5,9,25,19,6,23
Rostov,4945,8,5,6,9,11,17,-6,21
Din Moscow,4945,9,5,6,9,19,29,-10,21
Amkar,4945,10,4,5,11,10,25,-15,17
Anzhi,4945,11,3,6,11,17,39,-22,15
Loko Moscow,4946,1,11,7,2,31,13,18,40
CSKA Moscow,4946,2,11,3,6,30,19,11,36
Zenit,4946,3,8,9,3,23,14,9,33
Krasnodar,4946,4,9,5,6,30,26,4,32
Spart Moscow,4946,5,8,7,5,36,29,7,31
Terek Grozny,4946,6,8,5,7,23,25,-2,29
Din Moscow,4946,7,7,6,7,21,22,-1,27
FK Rubin,4946,8,5,5,10,23,22,1,20
Rostov,4946,9,4,7,9,11,18,-7,19
Amkar,4946,10,4,5,11,12,26,-14,17
Anzhi,4946,11,3,5,12,17,43,-26,14
Loko Moscow,4947,1,11,5,4,30,16,14,38
CSKA Moscow,4947,2,11,4,5,28,18,10,37
Spart Moscow,4947,3,9,7,4,37,28,9,34
Zenit,4947,4,8,9,3,24,15,9,33
Krasnodar,4947,5,9,5,6,30,24,6,32
Terek Grozny,4947,6,8,6,6,25,24,1,30
FK Rubin,4947,7,6,6,8,22,17,5,24
Din Moscow,4947,8,5,6,9,18,24,-6,21
Rostov,4947,9,4,7,9,11,18,-7,19
Amkar,4947,10,4,6,10,12,25,-13,18
Anzhi,4947,11,2,5,13,14,42,-28,11
Loko Moscow,4948,1,12,6,2,32,13,19,42
CSKA Moscow,4948,2,11,3,6,27,18,9,36
Spart Moscow,4948,3,10,5,5,42,30,12,35
Zenit,4948,4,8,8,4,22,14,8,32
Krasnodar,4948,5,8,6,6,30,27,3,30
Terek Grozny,4948,6,7,6,7,22,25,-3,27
FK Rubin,4948,7,5,7,8,24,20,4,22
Din Moscow,4948,8,5,7,8,21,29,-8,22
Amkar,4948,9,5,5,10,12,24,-12,20
Rostov,4948,10,4,6,10,11,19,-8,18
Anzhi,4948,11,3,5,12,16,40,-24,14
Loko Moscow,4949,1,11,6,3,31,15,16,39
CSKA Moscow,4949,2,12,3,5,30,17,13,39
Spart Moscow,4949,3,10,6,4,40,27,13,36
Zenit,4949,4,8,8,4,25,17,8,32
Terek Grozny,4949,5,9,5,6,23,23,0,32
Krasnodar,4949,6,8,6,6,28,25,3,30
FK Rubin,4949,7,5,7,8,23,19,4,22
Din Moscow,4949,8,5,7,8,18,25,-7,22
Rostov,4949,9,4,7,9,12,19,-7,19
Amkar,4949,10,4,4,12,9,25,-16,16
Anzhi,4949,11,2,5,13,15,42,-27,11
Loko Moscow,4950,1,13,5,2,33,12,21,44
CSKA Moscow,4950,2,11,4,5,28,19,9,37
Spart Moscow,4950,3,10,6,4,39,27,12,36
Krasnodar,4950,4,9,4,7,30,27,3,31
Zenit,4950,5,7,9,4,24,17,7,30
Terek Grozny,4950,6,7,7,6,22,24,-2,28
FK Rubin,4950,7,6,5,9,25,22,3,23
Din Moscow,4950,8,5,6,9,20,26,-6,21
Rostov,4950,9,4,6,10,10,20,-10,18
Amkar,4950,10,4,6,10,11,24,-13,18
Anzhi,4950,11,2,6,12,15,39,-24,12
Loko Moscow,4951,1,13,5,2,34,13,21,44
CSKA Moscow,4951,2,12,3,5,29,17,12,39
Spart Moscow,4951,3,9,7,4,37,28,9,34
Terek Grozny,4951,4,8,6,6,22,23,-1,30
Zenit,4951,5,7,8,5,23,17,6,29
Krasnodar,4951,6,8,4,8,28,28,0,28
FK Rubin,4951,7,6,6,8,23,18,5,24
Din Moscow,4951,8,5,8,7,18,22,-4,23
Rostov,4951,9,4,7,9,11,18,-7,19
Amkar,4951,10,4,4,12,10,25,-15,16
Anzhi,4951,11,2,6,12,15,41,-26,12
Loko Moscow,4952,1,12,5,3,32,13,19,41
CSKA Moscow,4952,2,11,3,6,26,21,5,36
Krasnodar,4952,3,10,4,6,31,25,6,34
Zenit,4952,4,8,8,4,25,15,10,32
Spart Moscow,4952,5,9,5,6,36,31,5,32
Din Moscow,4952,6,7,6,7,22,22,0,27
Terek Grozny,4952,7,7,6,7,21,25,-4,27
Rostov,4952,8,5,6,9,12,18,-6,21
FK Rubin,4952,9,5,5,10,22,21,1,20
Amkar,4952,10,4,5,11,11,25,-14,17
Anzhi,4952,11,3,5,12,16,38,-22,14
Loko Moscow,4953,1,11,5,4,32,17,15,38
CSKA Moscow,4953,2,11,4,5,28,19,9,37
Zenit,4953,3,8,9,3,25,15,10,33
Spart Moscow,4953,4,9,6,5,35,26,9,33
Krasnodar,4953,5,9,5,6,30,26,4,32
Terek Grozny,4953,6,7,6,7,22,25,-3,27
FK Rubin,4953,7,6,6,8,24,19,5,24
Din Moscow,4953,8,6,6,8,20,24,-4,24
Rostov,4953,9,4,6,10,10,19,-9,18
Amkar,4953,10,4,6,10,10,23,-13,18
Anzhi,4953,11,3,5,12,17,40,-23,14
Loko Moscow,4954,1,12,6,2,32,12,20,42
CSKA Moscow,4954,2,11,3,6,29,20,9,36
Terek Grozny,4954,3,9,5,6,24,24,0,32
Spart Moscow,4954,4,8,7,5,36,29,7,31
Zenit,4954,5,7,9,4,21,16,5,30
Krasnodar,4954,6,8,4,8,29,29,0,28
FK Rubin,4954,7,7,5,8,25,19,6,26
Din Moscow,4954,8,5,7,8,19,24,-5,22
Rostov,4954,9,4,7,9,10,17,-7,19
Amkar,4954,10,5,4,11,12,25,-13,19
Anzhi,4954,11,3,5,12,19,41,-22,14
Loko Moscow,4955,1,12,6,2,30,11,19,42
CSKA Moscow,4955,2,11,3,6,27,19,8,36
Spart Moscow,4955,3,10,5,5,39,28,11,35
Zenit,4955,4,8,8,4,22,14,8,32
Krasnodar,4955,5,8,6,6,27,24,3,30
Terek Grozny,4955,6,7,5,8,23,28,-5,26
FK Rubin,4955,7,5,7,8,22,18,4,22
Din Moscow,4955,8,5,7,8,18,25,-7,22
Amkar,4955,9,6,4,10,14,23,-9,22
Rostov,4955,10,4,6,10,10,20,-10,18
Anzhi,4955,11,3,5,12,19,41,-22,14
Loko Moscow,4956,1,13,5,2,36,11,25,44
CSKA Moscow,4956,2,11,4,5,28,19,9,37
Spart Moscow,4956,3,10,5,5,39,29,10,35
Krasnodar,4956,4,9,4,7,28,26,2,31
Terek Grozny,4956,5,8,6,6,23,24,-1,30
Zenit,4956,6,7,8,5,22,20,2,29
FK Rubin,4956,7,6,5,9,23,18,5,23
Rostov,4956,8,5,6,9,12,18,-6,21
Din Moscow,4956,9,5,6,9,19,27,-8,21
Amkar,4956,10,4,4,12,9,24,-15,16
Anzhi,4956,11,2,7,11,17,40,-23,13
CSKA Moscow,4957,1,12,3,5,31,20,11,39
Loko Moscow,4957,2,11,5,4,29,13,16,38
Spart Moscow,4957,3,11,5,4,40,25,15,38
Krasnodar,4957,4,10,4,6,31,26,5,34
Zenit,4957,5,8,8,4,24,16,8,32
Terek Grozny,4957,6,7,5,8,20,24,-4,26
Din Moscow,4957,7,6,6,8,19,24,-5,24
FK Rubin,4957,8,5,5,10,23,22,1,20
Amkar,4957,9,5,4,11,10,23,-13,19
Rostov,4957,10,4,6,10,10,20,-10,18
Anzhi,4957,11,3,5,12,16,40,-24,14
Loko Moscow,4958,1,11,5,4,31,16,15,38
Spart Moscow,4958,2,10,5,5,40,28,12,35
Zenit,4958,3,9,8,3,25,13,12,35
CSKA Moscow,4958,4,10,4,6,27,21,6,34
Krasnodar,4958,5,9,4,7,30,27,3,31
Terek Grozny,4958,6,8,6,6,24,24,0,30
FK Rubin,4958,7,6,6,8,23,18,5,24
Din Moscow,4958,8,5,7,8,19,24,-5,22
Amkar,4958,9,5,5,10,11,23,-12,20
Rostov,4958,10,4,6,10,11,22,-11,18
Anzhi,4958,11,2,6,12,17,42,-25,12
Loko Moscow,4959,1,11,6,3,31,14,17,39
CSKA Moscow,4959,2,11,4,5,26,17,9,37
Spart Moscow,4959,3,9,5,6,35,28,7,32
Krasnodar,4959,4,9,4,7,29,26,3,31
Zenit,4959,5,7,9,4,22,15,7,30
Terek Grozny,4959,6,8,5,7,23,24,-1,29
Din Moscow,4959,7,6,7,7,19,22,-3,25
FK Rubin,4959,8,6,6,8,23,18,5,24
Amkar,4959,9,5,4,11,11,26,-15,19
Rostov,4959,10,4,6,10,10,18,-8,18
Anzhi,4959,11,3,6,11,16,37,-21,15
Loko Moscow,4960,1,11,6,3,30,16,14,39
CSKA Moscow,4960,2,11,3,6,27,18,9,36
Zenit,4960,3,8,9,3,23,14,9,33
Spart Moscow,4960,4,9,5,6,37,29,8,32
Terek Grozny,4960,5,9,5,6,27,25,2,32
Krasnodar,4960,6,9,4,7,31,25,6,31
Din Moscow,4960,7,6,7,7,20,23,-3,25
FK Rubin,4960,8,6,6,8,23,18,5,24
Rostov,4960,9,5,6,9,12,17,-5,21
Amkar,4960,10,4,4,12,11,28,-17,16
Anzhi,4960,11,2,5,13,15,43,-28,11
Loko Moscow,4961,1,11,6,3,31,15,16,39
CSKA Moscow,4961,2,11,3,6,29,19,10,36
Zenit,4961,3,9,8,3,25,14,11,35
Spart Moscow,4961,4,9,5,6,36,31,5,32
Terek Grozny,4961,5,8,6,6,22,23,-1,30
Krasnodar,4961,6,8,5,7,29,28,1,29
Din Moscow,4961,7,6,7,7,21,23,-2,25
FK Rubin,4961,8,6,6,8,25,19,6,24
Amkar,4961,9,5,5,10,12,23,-11,20
Rostov,4961,10,4,6,10,10,18,-8,18
Anzhi,4961,11,2,5,13,16,43,-27,11
Loko Moscow,4962,1,11,5,4,30,15,15,38
Spart Moscow,4962,2,10,6,4,40,27,13,36
CSKA Moscow,4962,3,11,3,6,28,19,9,36
Zenit,4962,4,9,8,3,24,13,11,35
Krasnodar,4962,5,9,4,7,30,28,2,31
Terek Grozny,4962,6,8,5,7,23,25,-2,29
FK Rubin,4962,7,6,6,8,25,18,7,24
Din Moscow,4962,8,5,7,8,19,27,-8,22
Amkar,4962,9,5,5,10,11,23,-12,20
Rostov,4962,10,4,6,10,11,19,-8,18
Anzhi,4962,11,2,5,13,15,42,-27,11
Loko Moscow,4963,1,11,6,3,31,14,17,39
CSKA Moscow,4963,2,10,5,5,26,18,8,35
Spart Moscow,4963,3,9,7,4,38,29,9,34
Zenit,4963,4,8,9,3,22,13,9,33
Krasnodar,4963,5,8,6,6,30,27,3,30
Terek Grozny,4963,6,8,5,7,22,24,-2,29
Din Moscow,4963,7,6,7,7,20,22,-2,25
FK Rubin,4963,8,5,6,9,22,20,2,21
Rostov,4963,9,4,7,9,11,18,-7,19
Amkar,4963,10,4,4,12,11,26,-15,16
Anzhi,4963,11,3,6,11,17,39,-22,15
Loko Moscow,4964,1,11,5,4,30,14,16,38
Zenit,4964,2,9,8,3,23,13,10,35
CSKA Moscow,4964,3,10,4,6,25,18,7,34
Spart Moscow,4964,4,9,6,5,37,29,8,33
Krasnodar,4964,5,9,4,7,29,26,3,31
Din Moscow,4964,6,7,6,7,21,22,-1,27
Terek Grozny,4964,7,7,6,7,23,26,-3,27
FK Rubin,4964,8,6,5,9,22,19,3,23
Rostov,4964,9,4,7,9,12,19,-7,19
Amkar,4964,10,5,4,11,10,23,-13,19
Anzhi,4964,11,2,7,11,17,40,-23,13
Loko Moscow,4965,1,12,5,3,30,12,18,41
CSKA Moscow,4965,2,10,3,7,26,20,6,33
Zenit,4965,3,8,8,4,23,15,8,32
Spart Moscow,4965,4,9,5,6,37,30,7,32
Krasnodar,4965,5,9,4,7,28,28,0,31
Terek Grozny,4965,6,7,7,6,22,24,-2,28
Din Moscow,4965,7,6,6,8,18,25,-7,24
FK Rubin,4965,8,6,5,9,25,18,7,23
Rostov,4965,9,5,6,9,12,17,-5,21
Amkar,4965,10,5,5,10,12,22,-10,20
Anzhi,4965,11,3,6,11,17,39,-22,15
CSKA Moscow,4966,1,12,3,5,29,17,12,39
Loko Moscow,4966,2,11,5,4,30,15,15,38
Spart Moscow,4966,3,10,6,4,41,29,12,36
Zenit,4966,4,8,8,4,22,14,8,32
Krasnodar,4966,5,9,4,7,32,29,3,31
Terek Grozny,4966,6,7,6,7,21,26,-5,27
Din Moscow,4966,7,6,7,7,21,24,-3,25
FK Rubin,4966,8,6,5,9,26,21,5,23
Rostov,4966,9,4,6,10,12,22,-10,18
Amkar,4966,10,4,5,11,10,24,-14,17
Anzhi,4966,11,3,5,12,17,40,-23,14
Loko Moscow,4967,1,12,5,3,31,15,16,41
CSKA Moscow,4967,2,11,4,5,28,19,9,37
Spart Moscow,4967,3,10,6,4,43,29,14,36
Krasnodar,4967,4,9,5,6,31,25,6,32
Zenit,4967,5,7,9,4,23,16,7,30
Terek Grozny,4967,6,8,5,7,24,27,-3,29
Din Moscow,4967,7,5,8,7,21,25,-4,23
FK Rubin,4967,8,5,7,8,24,20,4,22
Amkar,4967,9,5,4,11,15,26,-11,19
Rostov,4967,10,4,6,10,10,22,-12,18
Anzhi,4967,11,2,5,13,16,42,-26,11
Loko Moscow,4968,1,13,5,2,33,12,21,44
CSKA Moscow,4968,2,10,4,6,26,20,6,34
Zenit,4968,3,8,8,4,23,14,9,32
Spart Moscow,4968,4,8,6,6,35,30,5,30
Terek Grozny,4968,5,8,6,6,23,23,0,30
Krasnodar,4968,6,8,5,7,28,27,1,29
FK Rubin,4968,7,6,6,8,22,17,5,24
Din Moscow,4968,8,6,6,8,20,23,-3,24
Amkar,4968,9,5,5,10,11,23,-12,20
Rostov,4968,10,4,7,9,11,18,-7,19
Anzhi,4968,11,2,6,12,15,40,-25,12
Loko Moscow,4969,1,12,6,2,32,12,20,42
Spart Moscow,4969,2,11,5,4,43,26,17,38
CSKA Moscow,4969,3,10,5,5,27,19,8,35
Zenit,4969,4,7,10,3,23,15,8,31
Krasnodar,4969,5,9,4,7,30,27,3,31
Terek Grozny,4969,6,7,5,8,20,24,-4,26
Din Moscow,4969,7,5,7,8,18,26,-8,22
FK Rubin,4969,8,5,6,9,21,19,2,21
Amkar,4969,9,5,4,11,10,23,-13,19
Rostov,4969,10,4,6,10,10,21,-11,18
Anzhi,4969,11,3,6,11,15,37,-22,15
Loko Moscow,4970,1,11,6,3,32,15,17,39
Spart Moscow,4970,2,10,6,4,43,26,17,36
Zenit,4970,3,9,8,3,25,15,10,35
CSKA Moscow,4970,4,10,4,6,27,20,7,34
Krasnodar,4970,5,9,5,6,29,25,4,32
Terek Grozny,4970,6,7,5,8,20,25,-5,26
Din Moscow,4970,7,5,7,8,18,28,-10,22
FK Rubin,4970,8,5,6,9,22,19,3,21
Amkar,4970,9,5,5,10,10,22,-12,20
Rostov,4970,10,4,6,10,11,21,-10,18
Anzhi,4970,11,3,6,11,18,39,-21,15
Loko Moscow,4971,1,12,5,3,33,13,20,41
CSKA Moscow,4971,2,11,3,6,27,19,8,36
Spart Moscow,4971,3,9,6,5,38,30,8,33
Zenit,4971,4,8,8,4,24,16,8,32
Krasnodar,4971,5,8,5,7,28,28,0,29
Terek Grozny,4971,6,7,7,6,22,24,-2,28
FK Rubin,4971,7,6,6,8,24,19,5,24
Din Moscow,4971,8,5,6,9,19,25,-6,21
Amkar,4971,9,5,5,10,11,23,-12,20
Rostov,4971,10,4,7,9,13,20,-7,19
Anzhi,4971,11,3,6,11,16,38,-22,15
Loko Moscow,4972,1,13,5,2,33,13,20,44
CSKA Moscow,4972,2,11,3,6,27,19,8,36
Spart Moscow,4972,3,8,8,4,38,30,8,32
Terek Grozny,4972,4,8,6,6,24,23,1,30
Zenit,4972,5,7,8,5,22,16,6,29
Krasnodar,4972,6,8,4,8,29,28,1,28
Din Moscow,4972,7,6,7,7,22,24,-2,25
FK Rubin,4972,8,6,5,9,23,20,3,23
Rostov,4972,9,4,7,9,11,18,-7,19
Amkar,4972,10,4,5,11,10,26,-16,17
Anzhi,4972,11,3,6,11,17,39,-22,15
Loko Moscow,4973,1,11,5,4,29,13,16,38
Spart Moscow,4973,2,10,6,4,38,28,10,36
CSKA Moscow,4973,3,11,3,6,29,21,8,36
Zenit,4973,4,9,8,3,25,15,10,35
Krasnodar,4973,5,9,5,6,30,26,4,32
Terek Grozny,4973,6,8,6,6,23,24,-1,30
Din Moscow,4973,7,6,6,8,19,23,-4,24
FK Rubin,4973,8,5,6,9,23,20,3,21
Rostov,4973,9,4,7,9,10,17,-7,19
Amkar,4973,10,4,4,12,12,27,-15,16
Anzhi,4973,11,2,6,12,16,40,-24,12
Loko Moscow,4974,1,12,6,2,33,13,20,42
CSKA Moscow,4974,2,11,3,6,26,18,8,36
Spart Moscow,4974,3,9,7,4,38,28,10,34
Zenit,4974,4,8,8,4,23,16,7,32
Krasnodar,4974,5,9,5,6,29,25,4,32
Terek Grozny,4974,6,8,5,7,22,26,-4,29
FK Rubin,4974,7,6,5,9,24,18,6,23
Din Moscow,4974,8,5,6,9,17,26,-9,21
Amkar,4974,9,5,5,10,13,23,-10,20
Rostov,4974,10,4,7,9,12,19,-7,19
Anzhi,4974,11,2,5,13,15,40,-25,11
Loko Moscow,4975,1,11,6,3,30,13,17,39
CSKA Moscow,4975,2,11,3,6,28,20,8,36
Spart Moscow,4975,3,10,5,5,39,28,11,35
Zenit,4975,4,9,8,3,24,14,10,35
Krasnodar,4975,5,9,5,6,33,25,8,32
Terek Grozny,4975,6,8,6,6,24,24,0,30
Din Moscow,4975,7,5,7,8,18,25,-7,22
FK Rubin,4975,8,5,6,9,21,22,-1,21
Amkar,4975,9,5,4,11,12,26,-14,19
Rostov,4975,10,4,6,10,10,18,-8,18
Anzhi,4975,11,2,6,12,16,40,-24,12
Loko Moscow,4976,1,12,6,2,31,12,19,42
CSKA Moscow,4976,2,11,4,5,27,18,9,37
Spart Moscow,4976,3,10,5,5,37,28,9,35
Zenit,4976,4,7,10,3,22,14,8,31
Krasnodar,4976,5,9,4,7,29,26,3,31
Terek Grozny,4976,6,8,6,6,22,23,-1,30
FK Rubin,4976,7,6,5,9,23,19,4,23
Rostov,4976,8,5,6,9,12,17,-5,21
Din Moscow,4976,9,5,6,9,18,25,-7,21
Amkar,4976,10,4,4,12,9,24,-15,16
Anzhi,4976,11,2,6,12,16,40,-24,12
Loko Moscow,4977,1,11,7,2,30,12,18,40
Spart Moscow,4977,2,11,5,4,41,26,15,38
CSKA Moscow,4977,3,10,4,6,26,20,6,34
Zenit,4977,4,8,9,3,24,14,10,33
Krasnodar,4977,5,8,6,6,28,25,3,30
Terek Grozny,4977,6,7,5,8,23,29,-6,26
FK Rubin,4977,7,5,7,8,24,20,4,22
Din Moscow,4977,8,5,7,8,19,26,-7,22
Amkar,4977,9,5,4,11,14,26,-12,19
Rostov,4977,10,4,6,10,10,19,-9,18
Anzhi,4977,11,3,6,11,18,40,-22,15
Loko Moscow,4978,1,13,5,2,33,12,21,44
Spart Moscow,4978,2,10,6,4,38,26,12,36
CSKA Moscow,4978,3,11,3,6,27,19,8,36
Terek Grozny,4978,4,8,6,6,22,23,-1,30
Zenit,4978,5,7,8,5,22,16,6,29
Krasnodar,4978,6,8,5,7,29,28,1,29
Din Moscow,4978,7,6,6,8,19,23,-4,24
FK Rubin,4978,8,5,6,9,23,21,2,21
Rostov,4978,9,4,6,10,10,19,-9,18
Amkar,4978,10,4,6,10,10,23,-13,18
Anzhi,4978,11,3,5,12,17,40,-23,14
Loko Moscow,4979,1,12,6,2,30,11,19,42
CSKA Moscow,4979,2,12,3,5,33,18,15,39
Spart Moscow,4979,3,9,6,5,38,30,8,33
Zenit,4979,4,7,9,4,21,16,5,30
Krasnodar,4979,5,8,5,7,27,25,2,29
Terek Grozny,4979,6,7,6,7,20,24,-4,27
Din Moscow,4979,7,6,6,8,21,24,-3,24
FK Rubin,4979,8,5,6,9,21,19,2,21
Rostov,4979,9,5,6,9,12,18,-6,21
Amkar,4979,10,5,5,10,12,23,-11,20
Anzhi,4979,11,2,6,12,15,42,-27,12
Loko Moscow,4980,1,13,5,2,33,13,20,44
Spart Moscow,4980,2,11,5,4,39,26,13,38
CSKA Moscow,4980,3,11,4,5,30,20,10,37
Terek Grozny,4980,4,8,6,6,22,23,-1,30
Zenit,4980,5,7,8,5,24,19,5,29
Krasnodar,4980,6,8,5,7,29,27,2,29
FK Rubin,4980,7,6,6,8,24,19,5,24
Din Moscow,4980,8,5,6,9,18,26,-8,21
Rostov,4980,9,4,6,10,11,19,-8,18
Amkar,4980,10,4,4,12,9,24,-15,16
Anzhi,4980,11,2,7,11,16,39,-23,13
Loko Moscow,4981,1,12,5,3,34,15,19,41
CSKA Moscow,4981,2,12,3,5,32,20,12,39
Spart Moscow,4981,3,11,5,4,40,27,13,38
Krasnodar,4981,4,9,4,7,30,27,3,31
Zenit,4981,5,7,8,5,24,19,5,29
Terek Grozny,4981,6,7,5,8,20,24,-4,26
FK Rubin,4981,7,6,6,8,23,18,5,24
Din Moscow,4981,8,5,7,8,18,24,-6,22
Amkar,4981,9,5,4,11,11,25,-14,19
Rostov,4981,10,4,6,10,11,19,-8,18
Anzhi,4981,11,3,5,12,16,41,-25,14
Loko Moscow,4982,1,11,6,3,31,15,16,39
CSKA Moscow,4982,2,12,3,5,28,17,11,39
Spart Moscow,4982,3,9,7,4,38,29,9,34
Krasnodar,4982,4,9,5,6,31,26,5,32
Zenit,4982,5,7,9,4,23,17,6,30
Terek Grozny,4982,6,8,5,7,22,23,-1,29
FK Rubin,4982,7,5,7,8,23,19,4,22
Din Moscow,4982,8,5,7,8,18,23,-5,22
Amkar,4982,9,5,5,10,10,22,-12,20
Rostov,4982,10,4,7,9,13,20,-7,19
Anzhi,4982,11,2,5,13,14,40,-26,11
Loko Moscow,4983,1,11,7,2,32,14,18,40
CSKA Moscow,4983,2,11,3,6,28,20,8,36
Spart Moscow,4983,3,10,5,5,37,27,10,35
Zenit,4983,4,8,9,3,23,14,9,33
Krasnodar,4983,5,9,5,6,30,26,4,32
Terek Grozny,4983,6,7,5,8,20,24,-4,26
Din Moscow,4983,7,6,7,7,18,21,-3,25
FK Rubin,4983,8,5,6,9,21,18,3,21
Amkar,4983,9,5,4,11,10,24,-14,19
Rostov,4983,10,4,6,10,11,19,-8,18
Anzhi,4983,11,3,5,12,17,40,-23,14
Loko Moscow,4984,1,12,6,2,31,12,19,42
CSKA Moscow,4984,2,10,4,6,25,18,7,34
Spart Moscow,4984,3,8,7,5,36,29,7,31
Zenit,4984,4,7,9,4,22,15,7,30
Terek Grozny,4984,5,8,6,6,24,25,-1,30
Krasnodar,4984,6,8,5,7,27,25,2,29
Din Moscow,4984,7,7,6,7,22,23,-1,27
FK Rubin,4984,8,6,5,9,23,20,3,23
Rostov,4984,9,4,7,9,11,18,-7,19
Amkar,4984,10,4,6,10,11,24,-13,18
Anzhi,4984,11,3,5,12,17,40,-23,14
Loko Moscow,4985,1,12,5,3,32,15,17,41
Krasnodar,4985,2,10,4,6,32,26,6,34
CSKA Moscow,4985,3,10,4,6,26,20,6,34
Zenit,4985,4,8,8,4,23,14,9,32
Spart Moscow,4985,5,8,7,5,34,27,7,31
Terek Grozny,4985,6,7,5,8,21,25,-4,26
Din Moscow,4985,7,6,7,7,20,23,-3,25
Amkar,4985,8,6,4,10,12,23,-11,22
FK Rubin,4985,9,5,5,10,22,20,2,20
Rostov,4985,10,4,7,9,10,17,-7,19
Anzhi,4985,11,3,6,11,16,38,-22,15
Loko Moscow,4986,1,12,6,2,32,12,20,42
CSKA Moscow,4986,2,11,3,6,30,20,10,36
Spart Moscow,4986,3,9,6,5,36,30,6,33
Zenit,4986,4,8,8,4,25,18,7,32
Krasnodar,4986,5,8,6,6,28,25,3,30
Terek Grozny,4986,6,7,5,8,21,30,-9,26
FK Rubin,4986,7,6,6,8,23,18,5,24
Din Moscow,4986,8,5,7,8,18,23,-5,22
Amkar,4986,9,6,4,10,16,23,-7,22
Rostov,4986,10,4,6,10,11,19,-8,18
Anzhi,4986,11,3,5,12,18,40,-22,14
Loko Moscow,4987,1,12,5,3,33,14,19,41
CSKA Moscow,4987,2,11,3,6,28,20,8,36
Zenit,4987,3,9,8,3,24,13,11,35
Spart Moscow,4987,4,9,6,5,37,29,8,33
Krasnodar,4987,5,8,4,8,30,30,0,28
Terek Grozny,4987,6,7,6,7,20,24,-4,27
FK Rubin,4987,7,7,5,8,27,18,9,26
Din Moscow,4987,8,6,6,8,19,26,-7,24
Rostov,4987,9,4,7,9,12,19,-7,19
Amkar,4987,10,5,4,11,11,23,-12,19
Anzhi,4987,11,2,6,12,15,40,-25,12
Loko Moscow,4988,1,11,6,3,31,15,16,39
CSKA Moscow,4988,2,11,3,6,31,21,10,36
Krasnodar,4988,3,10,4,6,32,26,6,34
Spart Moscow,4988,4,8,7,5,36,29,7,31
Zenit,4988,5,7,9,4,23,18,5,30
Terek Grozny,4988,6,7,6,7,21,26,-5,27
FK Rubin,4988,7,6,5,9,25,21,4,23
Din Moscow,4988,8,5,7,8,20,25,-5,22
Amkar,4988,9,5,5,10,12,24,-12,20
Rostov,4988,10,4,7,9,11,18,-7,19
Anzhi,4988,11,4,5,11,20,39,-19,17
Loko Moscow,4989,1,12,5,3,31,13,18,41
Spart Moscow,4989,2,11,5,4,37,25,12,38
CSKA Moscow,4989,3,11,3,6,28,20,8,36
Zenit,4989,4,9,8,3,25,14,11,35
Krasnodar,4989,5,8,5,7,29,27,2,29
Terek Grozny,4989,6,8,5,7,22,26,-4,29
Din Moscow,4989,7,6,6,8,18,23,-5,24
FK Rubin,4989,8,5,6,9,22,19,3,21
Rostov,4989,9,4,6,10,10,18,-8,18
Amkar,4989,10,4,4,12,9,25,-16,16
Anzhi,4989,11,3,5,12,18,39,-21,14
Loko Moscow,4990,1,12,5,3,33,15,18,41
CSKA Moscow,4990,2,11,3,6,29,19,10,36
Krasnodar,4990,3,10,4,6,31,25,6,34
Spart Moscow,4990,4,9,6,5,37,32,5,33
Zenit,4990,5,8,8,4,24,17,7,32
Terek Grozny,4990,6,7,6,7,22,25,-3,27
FK Rubin,4990,7,6,5,9,24,18,6,23
Amkar,4990,8,6,4,10,16,22,-6,22
Din Moscow,4990,9,5,6,9,18,28,-10,21
Rostov,4990,10,4,7,9,10,17,-7,19
Anzhi,4990,11,2,6,12,16,42,-26,12
Loko Moscow,4991,1,11,6,3,32,15,17,39
Spart Moscow,4991,2,11,5,4,36,25,11,38
CSKA Moscow,4991,3,11,4,5,28,18,10,37
Krasnodar,4991,4,10,4,6,32,27,5,34
Zenit,4991,5,7,10,3,23,15,8,31
Terek Grozny,4991,6,8,5,7,24,26,-2,29
Din Moscow,4991,7,6,6,8,19,22,-3,24
FK Rubin,4991,8,5,5,10,23,22,1,20
Rostov,4991,9,4,6,10,10,18,-8,18
Amkar,4991,10,4,4,12,10,25,-15,16
Anzhi,4991,11,3,5,12,18,42,-24,14
Loko Moscow,4992,1,12,6,2,31,12,19,42
CSKA Moscow,4992,2,10,4,6,27,21,6,34
Zenit,4992,3,8,9,3,24,14,10,33
Spart Moscow,4992,4,9,5,6,37,32,5,32
Terek Grozny,4992,5,9,5,6,24,22,2,32
Krasnodar,4992,6,9,4,7,28,25,3,31
FK Rubin,4992,7,6,5,9,24,19,5,23
Rostov,4992,8,5,6,9,13,18,-5,21
Din Moscow,4992,9,5,6,9,20,27,-7,21
Amkar,4992,10,5,4,11,11,24,-13,19
Anzhi,4992,11,2,6,12,16,41,-25,12
Loko Moscow,4993,1,12,5,3,33,13,20,41
CSKA Moscow,4993,2,11,4,5,31,22,9,37
Spart Moscow,4993,3,9,7,4,37,27,10,34
Zenit,4993,4,8,9,3,25,16,9,33
Krasnodar,4993,5,8,4,8,28,29,-1,28
Terek Grozny,4993,6,7,5,8,20,26,-6,26
FK Rubin,4993,7,6,6,8,24,19,5,24
Din Moscow,4993,8,5,8,7,19,23,-4,23
Rostov,4993,9,4,7,9,11,18,-7,19
Amkar,4993,10,5,4,11,12,24,-12,19
Anzhi,4993,11,3,5,12,18,41,-23,14
Loko Moscow,4994,1,12,6,2,31,12,19,42
Spart Moscow,4994,2,11,5,4,39,27,12,38
CSKA Moscow,4994,3,11,3,6,28,19,9,36
Krasnodar,4994,4,9,4,7,29,26,3,31
Zenit,4994,5,7,9,4,21,15,6,30
Terek Grozny,4994,6,7,6,7,20,24,-4,27
FK Rubin,4994,7,6,5,9,25,19,6,23
Din Moscow,4994,8,5,6,9,20,28,-8,21
Rostov,4994,9,4,6,10,10,18,-8,18
Amkar,4994,10,4,5,11,9,24,-15,17
Anzhi,4994,11,4,5,11,18,38,-20,17
Loko Moscow,4995,1,13,5,2,34,12,22,44
CSKA Moscow,4995,2,10,5,5,26,18,8,35
Spart Moscow,4995,3,8,8,4,38,30,8,32
Krasnodar,4995,4,9,4,7,29,28,1,31
Zenit,4995,5,7,9,4,21,14,7,30
Terek Grozny,4995,6,8,6,6,23,24,-1,30
FK Rubin,4995,7,6,5,9,24,18,6,23
Din Moscow,4995,8,5,7,8,18,25,-7,22
Rostov,4995,9,4,7,9,10,17,-7,19
Amkar,4995,10,4,6,10,13,26,-13,18
Anzhi,4995,11,2,6,12,17,41,-24,12
Loko Moscow,4996,1,13,5,2,32,11,21,44
CSKA Moscow,4996,2,11,3,6,28,21,7,36
Spart Moscow,4996,3,9,5,6,40,29,11,32
Zenit,4996,4,8,8,4,23,14,9,32
Terek Grozny,4996,5,9,5,6,26,24,2,32
Krasnodar,4996,6,9,4,7,29,26,3,31
Din Moscow,4996,7,6,7,7,19,22,-3,25
FK Rubin,4996,8,5,6,9,21,19,2,21
Amkar,4996,9,5,4,11,12,25,-13,19
Rostov,4996,10,4,6,10,10,22,-12,18
Anzhi,4996,11,2,5,13,17,44,-27,11
Loko Moscow,4997,1,12,6,2,31,11,20,42
Spart Moscow,4997,2,10,5,5,36,27,9,35
CSKA Moscow,4997,3,10,3,7,26,21,5,33
Zenit,4997,4,8,8,4,23,16,7,32
Krasnodar,4997,5,8,6,6,29,26,3,30
Terek Grozny,4997,6,8,5,7,21,23,-2,29
Din Moscow,4997,7,7,6,7,23,22,1,27
FK Rubin,4997,8,5,6,9,23,23,0,21
Amkar,4997,9,5,4,11,10,23,-13,19
Rostov,4997,10,4,6,10,10,18,-8,18
Anzhi,4997,11,3,5,12,16,38,-22,14
Loko Moscow,4998,1,12,6,2,32,13,19,42
CSKA Moscow,4998,2,11,3,6,27,19,8,36
Spart Moscow,4998,3,9,6,5,38,29,9,33
Zenit,4998,4,8,8,4,24,16,8,32
Krasnodar,4998,5,8,5,7,28,26,2,29
Terek Grozny,4998,6,8,5,7,23,23,0,29
Din Moscow,4998,7,6,7,7,20,23,-3,25
FK Rubin,4998,8,6,5,9,23,19,4,23
Rostov,4998,9,5,6,9,11,17,-6,21
Amkar,4998,10,5,4,11,12,26,-14,19
Anzhi,4998,11,2,5,13,14,41,-27,11
Loko Moscow,4999,1,12,6,2,32,12,20,42
CSKA Moscow,4999,2,12,3,5,28,17,11,39
Spart Moscow,4999,3,11,5,4,43,27,16,38
Krasnodar,4999,4,9,5,6,30,24,6,32
Terek Grozny,4999,5,8,6,6,23,23,0,30
Zenit,4999,6,7,8,5,22,17,5,29
Din Moscow,4999,7,5,7,8,18,23,-5,22
FK Rubin,4999,8,5,6,9,22,21,1,21
Rostov,4999,9,4,6,10,11,21,-10,18
Amkar,4999,10,4,5,11,11,28,-17,17
Anzhi,4999,11,2,5,13,14,41,-27,11
Loko Moscow,5000,1,13,5,2,32,12,20,44
Spart Moscow,5000,2,11,5,4,40,26,14,38
CSKA Moscow,5000,3,11,3,6,30,23,7,36
Zenit,5000,4,8,8,4,25,15,10,32
Terek Grozny,5000,5,8,6,6,22,23,-1,30
Krasnodar,5000,6,8,4,8,30,29,1,28
Din Moscow,5000,7,6,6,8,19,24,-5,24
FK Rubin,5000,8,6,5,9,24,21,3,23
Rostov,5000,9,4,6,10,10,19,-9,18
Amkar,5000,10,4,5,11,11,25,-14,17
Anzhi,5000,11,2,5,13,16,42,-26,11
Loko Moscow,5001,1,13,5,2,32,12,20,44
CSKA Moscow,5001,2,11,4,5,28,18,10,37
Krasnodar,5001,3,9,4,7,29,25,4,31
Spart Moscow,5001,4,8,6,6,34,30,4,30
Terek Grozny,5001,5,8,6,6,22,23,-1,30
Zenit,5001,6,7,8,5,22,17,5,29
Din Moscow,5001,7,6,7,7,20,22,-2,25
FK Rubin,5001,8,5,6,9,22,20,2,21
Amkar,5001,9,5,5,10,12,23,-11,20
Rostov,5001,10,4,7,9,10,17,-7,19
Anzhi,5001,11,2,6,12,16,40,-24,12
Loko Moscow,5002,1,11,6,3,30,13,17,39
CSKA Moscow,5002,2,12,3,5,32,18,14,39
Zenit,5002,3,8,8,4,23,16,7,32
Spart Moscow,5002,4,8,7,5,37,31,6,31
Krasnodar,5002,5,8,6,6,29,26,3,30
Terek Grozny,5002,6,8,6,6,24,23,1,30
Din Moscow,5002,7,7,6,7,22,23,-1,27
FK Rubin,5002,8,5,6,9,24,21,3,21
Rostov,5002,9,4,7,9,11,18,-7,19
Amkar,5002,10,4,5,11,11,27,-16,17
Anzhi,5002,11,2,6,12,16,43,-27,12
Loko Moscow,5003,1,11,7,2,32,14,18,40
CSKA Moscow,5003,2,11,3,6,26,20,6,36
Spart Moscow,5003,3,10,5,5,36,27,9,35
Zenit,5003,4,8,9,3,26,15,11,33
Krasnodar,5003,5,8,5,7,28,26,2,29
Terek Grozny,5003,6,8,5,7,24,24,0,29
FK Rubin,5003,7,7,5,8,25,17,8,26
Din Moscow,5003,8,5,6,9,17,26,-9,21
Amkar,5003,9,5,4,11,12,26,-14,19
Rostov,5003,10,4,6,10,10,18,-8,18
Anzhi,5003,11,3,5,12,15,38,-23,14
Loko Moscow,5004,1,11,6,3,29,12,17,39
CSKA Moscow,5004,2,10,5,5,27,19,8,35
Zenit,5004,3,8,9,3,23,14,9,33
Spart Moscow,5004,4,8,7,5,35,32,3,31
Krasnodar,5004,5,8,5,7,27,25,2,29
Terek Grozny,5004,6,8,5,7,22,24,-2,29
FK Rubin,5004,7,7,5,8,23,17,6,26
Din Moscow,5004,8,5,7,8,18,23,-5,22
Rostov,5004,9,4,7,9,11,18,-7,19
Amkar,5004,10,5,4,11,14,23,-9,19
Anzhi,5004,11,3,6,11,17,39,-22,15
Loko Moscow,5005,1,12,6,2,33,14,19,42
CSKA Moscow,5005,2,11,3,6,27,19,8,36
Zenit,5005,3,8,9,3,24,15,9,33
Spart Moscow,5005,4,9,6,5,36,28,8,33
Terek Grozny,5005,5,8,6,6,23,24,-1,30
Krasnodar,5005,6,8,5,7,30,28,2,29
Din Moscow,5005,7,6,7,7,20,22,-2,25
FK Rubin,5005,8,5,6,9,23,21,2,21
Rostov,5005,9,5,6,9,12,18,-6,21
Amkar,5005,10,4,4,12,10,25,-15,16
Anzhi,5005,11,2,6,12,16,40,-24,12
Loko Moscow,5006,1,12,6,2,32,13,19,42
CSKA Moscow,5006,2,11,3,6,27,19,8,36
Zenit,5006,3,8,9,3,25,16,9,33
Spart Moscow,5006,4,8,7,5,36,30,6,31
Krasnodar,5006,5,8,5,7,28,26,2,29
Terek Grozny,5006,6,7,7,6,23,25,-2,28
FK Rubin,5006,7,6,6,8,25,18,7,24
Din Moscow,5006,8,5,7,8,19,26,-7,22
Amkar,5006,9,5,5,10,11,22,-11,20
Rostov,5006,10,4,7,9,11,18,-7,19
Anzhi,5006,11,2,6,12,17,41,-24,12
Loko Moscow,5007,1,12,5,3,32,14,18,41
CSKA Moscow,5007,2,12,3,5,28,18,10,39
Spart Moscow,5007,3,9,6,5,34,26,8,33
Zenit,5007,4,8,8,4,23,14,9,32
Terek Grozny,5007,5,9,5,6,25,22,3,32
Krasnodar,5007,6,8,5,7,29,28,1,29
FK Rubin,5007,7,5,7,8,23,19,4,22
Din Moscow,5007,8,5,7,8,18,23,-5,22
Rostov,5007,9,4,7,9,10,17,-7,19
Amkar,5007,10,5,4,11,10,25,-15,19
Anzhi,5007,11,2,5,13,15,41,-26,11
Loko Moscow,5008,1,12,5,3,30,13,17,41
Krasnodar,5008,2,10,4,6,30,24,6,34
Spart Moscow,5008,3,9,6,5,38,33,5,33
CSKA Moscow,5008,4,10,3,7,27,23,4,33
Zenit,5008,5,8,8,4,24,15,9,32
Terek Grozny,5008,6,9,5,6,23,22,1,32
Din Moscow,5008,7,5,8,7,21,25,-4,23
FK Rubin,5008,8,5,6,9,22,19,3,21
Amkar,5008,9,5,4,11,13,24,-11,19
Rostov,5008,10,4,6,10,11,19,-8,18
Anzhi,5008,11,3,5,12,17,39,-22,14
Loko Moscow,5009,1,11,5,4,29,15,14,38
CSKA Moscow,5009,2,11,4,5,29,20,9,37
Spart Moscow,5009,3,10,5,5,38,29,9,35
Zenit,5009,4,8,9,3,26,16,10,33
Krasnodar,5009,5,9,5,6,30,25,5,32
Terek Grozny,5009,6,8,5,7,24,27,-3,29
Din Moscow,5009,7,6,7,7,20,21,-1,25
FK Rubin,5009,8,5,7,8,22,18,4,22
Amkar,5009,9,5,4,11,15,24,-9,19
Rostov,5009,10,4,6,10,10,20,-10,18
Anzhi,5009,11,2,5,13,14,42,-28,11
Loko Moscow,5010,1,11,6,3,31,14,17,39
Spart Moscow,5010,2,11,5,4,43,27,16,38
CSKA Moscow,5010,3,11,3,6,30,21,9,36
Zenit,5010,4,9,8,3,25,15,10,35
Krasnodar,5010,5,9,5,6,33,26,7,32
Terek Grozny,5010,6,8,5,7,22,24,-2,29
Din Moscow,5010,7,6,6,8,18,24,-6,24
FK Rubin,5010,8,5,5,10,21,22,-1,20
Rostov,5010,9,4,6,10,12,20,-8,18
Amkar,5010,10,4,4,12,10,28,-18,16
Anzhi,5010,11,3,5,12,16,40,-24,14
Loko Moscow,5011,1,12,6,2,31,12,19,42
CSKA Moscow,5011,2,11,4,5,26,17,9,37
Spart Moscow,5011,3,10,6,4,38,26,12,36
Zenit,5011,4,7,9,4,22,15,7,30
Terek Grozny,5011,5,8,6,6,22,23,-1,30
Krasnodar,5011,6,8,4,8,29,30,-1,28
FK Rubin,5011,7,6,6,8,26,19,7,24
Din Moscow,5011,8,5,7,8,17,24,-7,22
Rostov,5011,9,4,7,9,11,18,-7,19
Amkar,5011,10,4,4,12,9,24,-15,16
Anzhi,5011,11,2,7,11,15,38,-23,13
Loko Moscow,5012,1,12,5,3,30,12,18,41
Spart Moscow,5012,2,11,5,4,42,25,17,38
CSKA Moscow,5012,3,11,3,6,30,20,10,36
Krasnodar,5012,4,10,4,6,30,25,5,34
Zenit,5012,5,8,8,4,24,16,8,32
Terek Grozny,5012,6,8,5,7,24,25,-1,29
Din Moscow,5012,7,5,7,8,18,26,-8,22
FK Rubin,5012,8,5,6,9,23,20,3,21
Amkar,5012,9,5,4,11,11,23,-12,19
Rostov,5012,10,4,6,10,10,21,-11,18
Anzhi,5012,11,2,5,13,15,44,-29,11
Loko Moscow,5013,1,11,5,4,29,13,16,38
CSKA Moscow,5013,2,11,4,5,28,19,9,37
Spart Moscow,5013,3,9,7,4,39,27,12,34
Zenit,5013,4,8,8,4,23,15,8,32
Krasnodar,5013,5,9,5,6,29,25,4,32
Terek Grozny,5013,6,7,6,7,20,23,-3,27
FK Rubin,5013,7,6,6,8,25,18,7,24
Din Moscow,5013,8,5,6,9,17,28,-11,21
Rostov,5013,9,4,7,9,11,18,-7,19
Amkar,5013,10,4,6,10,10,23,-13,18
Anzhi,5013,11,3,6,11,16,38,-22,15
Loko Moscow,5014,1,12,5,3,32,13,19,41
CSKA Moscow,5014,2,11,3,6,26,18,8,36
Krasnodar,5014,3,10,4,6,30,24,6,34
Spart Moscow,5014,4,9,6,5,37,31,6,33
Zenit,5014,5,8,8,4,22,16,6,32
Terek Grozny,5014,6,8,5,7,23,24,-1,29
Din Moscow,5014,7,5,8,7,18,22,-4,23
FK Rubin,5014,8,5,6,9,21,18,3,21
Rostov,5014,9,5,6,9,13,17,-4,21
Amkar,5014,10,4,4,12,11,27,-16,16
Anzhi,5014,11,3,5,12,16,39,-23,14
Loko Moscow,5015,1,13,5,2,32,11,21,44
CSKA Moscow,5015,2,11,3,6,29,20,9,36
Zenit,5015,3,8,8,4,22,14,8,32
Spart Moscow,5015,4,8,7,5,35,28,7,31
Krasnodar,5015,5,9,4,7,28,26,2,31
Terek Grozny,5015,6,7,5,8,20,24,-4,26
Din Moscow,5015,7,6,7,7,19,22,-3,25
Amkar,5015,8,6,4,10,11,22,-11,22
FK Rubin,5015,9,5,5,10,21,19,2,20
Rostov,5015,10,4,7,9,11,18,-7,19
Anzhi,5015,11,3,5,12,17,41,-24,14
Loko Moscow,5016,1,11,5,4,31,16,15,38
CSKA Moscow,5016,2,11,4,5,29,18,11,37
Spart Moscow,5016,3,9,7,4,35,26,9,34
Zenit,5016,4,8,9,3,24,15,9,33
Krasnodar,5016,5,9,5,6,32,27,5,32
Terek Grozny,5016,6,7,6,7,20,25,-5,27
Din Moscow,5016,7,5,8,7,19,23,-4,23
FK Rubin,5016,8,5,7,8,24,20,4,22
Rostov,5016,9,4,7,9,10,17,-7,19
Amkar,5016,10,4,5,11,9,23,-14,17
Anzhi,5016,11,3,5,12,17,40,-23,14
Loko Moscow,5017,1,13,5,2,33,13,20,44
CSKA Moscow,5017,2,10,3,7,28,22,6,33
Zenit,5017,3,8,8,4,24,16,8,32
Terek Grozny,5017,4,9,5,6,25,22,3,32
Spart Moscow,5017,5,8,5,7,34,30,4,29
Krasnodar,5017,6,8,4,8,31,30,1,28
Din Moscow,5017,7,6,7,7,20,23,-3,25
FK Rubin,5017,8,6,6,8,25,20,5,24
Rostov,5017,9,5,6,9,12,17,-5,21
Amkar,5017,10,5,4,11,10,25,-15,19
Anzhi,5017,11,3,5,12,16,40,-24,14
Loko Moscow,5018,1,13,5,2,31,11,20,44
CSKA Moscow,5018,2,11,4,5,28,19,9,37
Spart Moscow,5018,3,9,6,5,35,26,9,33
Zenit,5018,4,7,9,4,23,16,7,30
Krasnodar,5018,5,8,4,8,27,26,1,28
Terek Grozny,5018,6,7,7,6,20,22,-2,28
FK Rubin,5018,7,6,6,8,23,18,5,24
Din Moscow,5018,8,5,7,8,18,24,-6,22
Rostov,5018,9,5,6,9,11,17,-6,21
Amkar,5018,10,4,6,10,9,22,-13,18
Anzhi,5018,11,2,6,12,14,38,-24,12
Loko Moscow,5019,1,11,5,4,32,16,16,38
Spart Moscow,5019,2,11,5,4,40,27,13,38
CSKA Moscow,5019,3,11,4,5,29,20,9,37
Krasnodar,5019,4,10,4,6,30,25,5,34
Zenit,5019,5,8,9,3,26,17,9,33
Terek Grozny,5019,6,8,5,7,22,24,-2,29
FK Rubin,5019,7,6,5,9,23,18,5,23
Din Moscow,5019,8,5,6,9,18,25,-7,21
Amkar,5019,9,5,4,11,12,24,-12,19
Rostov,5019,10,4,6,10,10,20,-10,18
Anzhi,5019,11,2,5,13,15,41,-26,11
Loko Moscow,5020,1,12,5,3,32,13,19,41
CSKA Moscow,5020,2,10,4,6,27,20,7,34
Spart Moscow,5020,3,9,5,6,35,27,8,32
Krasnodar,5020,4,9,5,6,30,26,4,32
Zenit,5020,5,7,9,4,21,15,6,30
Terek Grozny,5020,6,8,5,7,23,25,-2,29
FK Rubin,5020,7,6,6,8,24,19,5,24
Din Moscow,5020,8,6,6,8,19,23,-4,24
Rostov,5020,9,5,6,9,11,17,-6,21
Anzhi,5020,10,4,5,11,20,40,-20,17
Amkar,5020,11,4,4,12,9,26,-17,16
Loko Moscow,5021,1,13,5,2,33,13,20,44
CSKA Moscow,5021,2,12,3,5,29,19,10,39
Krasnodar,5021,3,9,4,7,28,25,3,31
Spart Moscow,5021,4,8,6,6,36,30,6,30
Zenit,5021,5,7,8,5,23,17,6,29
Terek Grozny,5021,6,7,6,7,21,24,-3,27
Din Moscow,5021,7,5,8,7,19,23,-4,23
FK Rubin,5021,8,5,6,9,22,19,3,21
Rostov,5021,9,5,6,9,12,18,-6,21
Amkar,5021,10,5,5,10,12,24,-12,20
Anzhi,5021,11,3,5,12,17,40,-23,14
Loko Moscow,5022,1,11,6,3,32,15,17,39
Zenit,5022,2,9,8,3,25,14,11,35
CSKA Moscow,5022,3,10,4,6,26,20,6,34
Spart Moscow,5022,4,9,6,5,36,29,7,33
Krasnodar,5022,5,9,5,6,31,26,5,32
Din Moscow,5022,6,7,6,7,22,23,-1,27
Terek Grozny,5022,7,7,5,8,20,25,-5,26
FK Rubin,5022,8,5,5,10,22,21,1,20
Rostov,5022,9,4,7,9,11,18,-7,19
Amkar,5022,10,5,4,11,10,23,-13,19
Anzhi,5022,11,3,6,11,17,38,-21,15
Loko Moscow,5023,1,13,5,2,33,13,20,44
CSKA Moscow,5023,2,11,4,5,27,18,9,37
Spart Moscow,5023,3,9,6,5,36,28,8,33
Krasnodar,5023,4,9,4,7,32,27,5,31
Zenit,5023,5,7,9,4,23,16,7,30
Din Moscow,5023,6,7,6,7,19,21,-2,27
Terek Grozny,5023,7,7,6,7,21,24,-3,27
FK Rubin,5023,8,5,5,10,22,22,0,20
Rostov,5023,9,4,7,9,11,18,-7,19
Amkar,5023,10,5,4,11,11,24,-13,19
Anzhi,5023,11,2,6,12,15,39,-24,12
Loko Moscow,5024,1,12,6,2,32,13,19,42
CSKA Moscow,5024,2,11,3,6,29,18,11,36
Zenit,5024,3,8,9,3,24,15,9,33
Spart Moscow,5024,4,9,6,5,35,27,8,33
Krasnodar,5024,5,9,4,7,32,28,4,31
Terek Grozny,5024,6,8,5,7,22,27,-5,29
FK Rubin,5024,7,6,5,9,26,22,4,23
Din Moscow,5024,8,5,6,9,17,24,-7,21
Rostov,5024,9,4,7,9,11,18,-7,19
Amkar,5024,10,5,4,11,10,23,-13,19
Anzhi,5024,11,3,5,12,19,42,-23,14
Loko Moscow,5025,1,12,5,3,31,13,18,41
CSKA Moscow,5025,2,11,4,5,29,20,9,37
Krasnodar,5025,3,10,4,6,30,25,5,34
Spart Moscow,5025,4,9,6,5,37,30,7,33
Zenit,5025,5,7,9,4,22,15,7,30
Terek Grozny,5025,6,8,5,7,25,27,-2,29
Din Moscow,5025,7,6,6,8,20,24,-4,24
FK Rubin,5025,8,6,5,9,23,18,5,23
Amkar,5025,9,5,5,10,13,25,-12,20
Rostov,5025,10,4,6,10,10,18,-8,18
Anzhi,5025,11,2,5,13,19,44,-25,11
Loko Moscow,5026,1,11,6,3,29,12,17,39
CSKA Moscow,5026,2,12,3,5,29,18,11,39
Spart Moscow,5026,3,9,6,5,36,29,7,33
Zenit,5026,4,8,8,4,22,14,8,32
Krasnodar,5026,5,9,5,6,31,24,7,32
Terek Grozny,5026,6,8,5,7,21,23,-2,29
Din Moscow,5026,7,6,7,7,21,23,-2,25
FK Rubin,5026,8,5,5,10,21,23,-2,20
Amkar,5026,9,5,4,11,11,23,-12,19
Rostov,5026,10,4,6,10,10,18,-8,18
Anzhi,5026,11,3,5,12,16,40,-24,14
Loko Moscow,5027,1,11,6,3,29,13,16,39
CSKA Moscow,5027,2,12,3,5,31,19,12,39
Spart Moscow,5027,3,10,6,4,44,30,14,36
Krasnodar,5027,4,9,4,7,30,27,3,31
Zenit,5027,5,7,9,4,22,15,7,30
Terek Grozny,5027,6,8,5,7,23,26,-3,29
FK Rubin,5027,7,6,6,8,27,21,6,24
Din Moscow,5027,8,5,7,8,21,30,-9,22
Rostov,5027,9,4,6,10,12,20,-8,18
Amkar,5027,10,4,5,11,11,26,-15,17
Anzhi,5027,11,3,5,12,19,42,-23,14
Loko Moscow,5028,1,12,6,2,33,12,21,42
Spart Moscow,5028,2,10,6,4,38,27,11,36
CSKA Moscow,5028,3,10,4,6,26,19,7,34
Krasnodar,5028,4,9,5,6,29,25,4,32
Zenit,5028,5,7,9,4,21,16,5,30
Terek Grozny,5028,6,7,6,7,24,27,-3,27
Din Moscow,5028,7,5,7,8,19,24,-5,22
FK Rubin,5028,8,5,6,9,22,19,3,21
Rostov,5028,9,4,6,10,10,19,-9,18
Amkar,5028,10,4,6,10,13,26,-13,18
Anzhi,5028,11,4,5,11,18,39,-21,17
Loko Moscow,5029,1,11,5,4,32,17,15,38
Zenit,5029,2,9,8,3,27,17,10,35
CSKA Moscow,5029,3,10,4,6,30,23,7,34
Krasnodar,5029,4,10,4,6,32,26,6,34
Spart Moscow,5029,5,9,6,5,38,27,11,33
Terek Grozny,5029,6,7,6,7,22,25,-3,27
Din Moscow,5029,7,6,6,8,20,24,-4,24
FK Rubin,5029,8,6,5,9,23,19,4,23
Rostov,5029,9,4,7,9,10,17,-7,19
Amkar,5029,10,5,4,11,11,27,-16,19
Anzhi,5029,11,2,7,11,17,40,-23,13
Loko Moscow,5030,1,12,6,2,30,11,19,42
Spart Moscow,5030,2,11,5,4,39,26,13,38
CSKA Moscow,5030,3,11,4,5,28,19,9,37
Zenit,5030,4,7,10,3,21,13,8,31
Krasnodar,5030,5,9,4,7,28,25,3,31
Terek Grozny,5030,6,8,6,6,23,24,-1,30
Din Moscow,5030,7,5,7,8,18,23,-5,22
FK Rubin,5030,8,5,6,9,21,18,3,21
Rostov,5030,9,4,6,10,10,20,-10,18
Amkar,5030,10,4,5,11,10,24,-14,17
Anzhi,5030,11,2,5,13,17,42,-25,11
Loko Moscow,5031,1,12,5,3,32,14,18,41
CSKA Moscow,5031,2,12,3,5,31,20,11,39
Spart Moscow,5031,3,9,6,5,36,29,7,33
Krasnodar,5031,4,9,5,6,28,24,4,32
Zenit,5031,5,7,8,5,25,19,6,29
Terek Grozny,5031,6,7,6,7,21,24,-3,27
Din Moscow,5031,7,6,7,7,20,22,-2,25
FK Rubin,5031,8,5,7,8,22,18,4,22
Rostov,5031,9,4,7,9,12,19,-7,19
Amkar,5031,10,5,4,11,10,23,-13,19
Anzhi,5031,11,2,6,12,16,41,-25,12
Loko Moscow,5032,1,11,5,4,30,14,16,38
Zenit,5032,2,9,8,3,25,14,11,35
Krasnodar,5032,3,10,4,6,31,24,7,34
CSKA Moscow,5032,4,10,3,7,26,21,5,33
Spart Moscow,5032,5,8,7,5,34,27,7,31
Terek Grozny,5032,6,8,5,7,25,28,-3,29
Din Moscow,5032,7,5,8,7,17,21,-4,23
Amkar,5032,8,6,4,10,14,24,-10,22
FK Rubin,5032,9,5,6,9,21,20,1,21
Rostov,5032,10,4,7,9,11,18,-7,19
Anzhi,5032,11,3,5,12,18,41,-23,14
Loko Moscow,5033,1,11,6,3,33,16,17,39
CSKA Moscow,5033,2,11,3,6,29,19,10,36
Zenit,5033,3,9,8,3,26,15,11,35
Spart Moscow,5033,4,10,5,5,39,29,10,35
Krasnodar,5033,5,8,5,7,29,27,2,29
Terek Grozny,5033,6,7,6,7,21,24,-3,27
FK Rubin,5033,7,7,5,8,23,17,6,26
Amkar,5033,8,6,4,10,12,23,-11,22
Din Moscow,5033,9,5,6,9,19,25,-6,21
Rostov,5033,10,4,6,10,10,19,-9,18
Anzhi,5033,11,2,6,12,15,42,-27,12
Loko Moscow,5034,1,11,5,4,29,16,13,38
Zenit,5034,2,9,8,3,28,15,13,35
CSKA Moscow,5034,3,10,4,6,28,22,6,34
Spart Moscow,5034,4,9,6,5,37,31,6,33
Krasnodar,5034,5,9,5,6,31,26,5,32
Terek Grozny,5034,6,7,7,6,21,23,-2,28
FK Rubin,5034,7,5,7,8,24,20,4,22
Din Moscow,5034,8,5,7,8,19,25,-6,22
Amkar,5034,9,5,5,10,13,22,-9,20
Rostov,5034,10,4,7,9,11,18,-7,19
Anzhi,5034,11,2,7,11,16,39,-23,13
Loko Moscow,5035,1,11,5,4,31,15,16,38
CSKA Moscow,5035,2,11,3,6,27,18,9,36
Zenit,5035,3,9,8,3,24,14,10,35
Krasnodar,5035,4,10,4,6,30,25,5,34
Spart Moscow,5035,5,9,5,6,38,30,8,32
Terek Grozny,5035,6,8,5,7,25,26,-1,29
Din Moscow,5035,7,7,6,7,22,23,-1,27
FK Rubin,5035,8,5,5,10,22,21,1,20
Amkar,5035,9,5,4,11,13,27,-14,19
Rostov,5035,10,4,6,10,10,19,-9,18
Anzhi,5035,11,3,5,12,17,41,-24,14
Loko Moscow,5036,1,12,5,3,32,14,18,41
Spart Moscow,5036,2,10,5,5,41,28,13,35
Krasnodar,5036,3,10,4,6,31,25,6,34
CSKA Moscow,5036,4,10,4,6,25,19,6,34
Zenit,5036,5,8,8,4,23,15,8,32
Terek Grozny,5036,6,8,5,7,21,23,-2,29
FK Rubin,5036,7,6,5,9,22,18,4,23
Rostov,5036,8,5,6,9,11,17,-6,21
Din Moscow,5036,9,5,6,9,17,26,-9,21
Amkar,5036,10,4,4,12,11,27,-16,16
Anzhi,5036,11,3,6,11,15,37,-22,15
Loko Moscow,5037,1,13,5,2,34,13,21,44
CSKA Moscow,5037,2,11,4,5,30,17,13,37
Spart Moscow,5037,3,9,7,4,40,31,9,34
Krasnodar,5037,4,9,4,7,31,28,3,31
Zenit,5037,5,7,9,4,21,15,6,30
Terek Grozny,5037,6,7,5,8,20,26,-6,26
FK Rubin,5037,7,6,5,9,24,19,5,23
Din Moscow,5037,8,5,7,8,20,26,-6,22
Rostov,5037,9,4,7,9,10,17,-7,19
Amkar,5037,10,5,4,11,15,26,-11,19
Anzhi,5037,11,3,5,12,15,42,-27,14
Loko Moscow,5038,1,13,5,2,32,11,21,44
CSKA Moscow,5038,2,12,3,5,28,17,11,39
Spart Moscow,5038,3,11,5,4,42,27,15,38
Krasnodar,5038,4,9,4,7,28,25,3,31
Zenit,5038,5,7,8,5,21,16,5,29
Terek Grozny,5038,6,7,5,8,21,27,-6,26
Din Moscow,5038,7,6,6,8,18,24,-6,24
FK Rubin,5038,8,5,5,10,21,19,2,20
Amkar,5038,9,5,4,11,13,25,-12,19
Rostov,5038,10,4,6,10,11,20,-9,18
Anzhi,5038,11,3,5,12,16,40,-24,14
Loko Moscow,5039,1,13,5,2,33,11,22,44
CSKA Moscow,5039,2,11,3,6,30,19,11,36
Spart Moscow,5039,3,10,6,4,36,26,10,36
Zenit,5039,4,8,8,4,22,14,8,32
Terek Grozny,5039,5,8,6,6,21,22,-1,30
Krasnodar,5039,6,8,5,7,28,28,0,29
Din Moscow,5039,7,6,6,8,20,23,-3,24
FK Rubin,5039,8,5,6,9,23,21,2,21
Rostov,5039,9,4,6,10,10,18,-8,18
Amkar,5039,10,4,5,11,10,24,-14,17
Anzhi,5039,11,2,6,12,15,42,-27,12
Loko Moscow,5040,1,12,6,2,30,11,19,42
CSKA Moscow,5040,2,11,4,5,29,19,10,37
Spart Moscow,5040,3,10,6,4,40,26,14,36
Zenit,5040,4,7,9,4,23,16,7,30
Krasnodar,5040,5,8,6,6,27,24,3,30
Terek Grozny,5040,6,7,5,8,20,27,-7,26
Din Moscow,5040,7,6,6,8,20,22,-2,24
FK Rubin,5040,8,5,6,9,21,20,1,21
Amkar,5040,9,5,5,10,12,23,-11,20
Rostov,5040,10,4,6,10,10,22,-12,18
Anzhi,5040,11,3,5,12,17,39,-22,14
Loko Moscow,5041,1,12,5,3,32,14,18,41
Spart Moscow,5041,2,11,5,4,39,25,14,38
CSKA Moscow,5041,3,10,4,6,27,20,7,34
Krasnodar,5041,4,10,4,6,30,25,5,34
Zenit,5041,5,8,8,4,24,16,8,32
Terek Grozny,5041,6,8,5,7,22,23,-1,29
Din Moscow,5041,7,5,7,8,17,22,-5,22
FK Rubin,5041,8,5,6,9,21,18,3,21
Rostov,5041,9,4,6,10,10,18,-8,18
Amkar,5041,10,4,4,12,9,28,-19,16
Anzhi,5041,11,3,6,11,16,38,-22,15
Loko Moscow,5042,1,12,6,2,30,11,19,42
CSKA Moscow,5042,2,11,4,5,27,18,9,37
Spart Moscow,5042,3,9,6,5,37,30,7,33
Zenit,5042,4,7,10,3,22,14,8,31
Krasnodar,5042,5,9,4,7,29,26,3,31
Terek Grozny,5042,6,7,6,7,20,23,-3,27
Din Moscow,5042,7,6,6,8,19,23,-4,24
FK Rubin,5042,8,6,5,9,24,19,5,23
Rostov,5042,9,4,6,10,11,19,-8,18
Amkar,5042,10,4,6,10,11,24,-13,18
Anzhi,5042,11,3,5,12,15,38,-23,14
Loko Moscow,5043,1,12,6,2,32,11,21,42
CSKA Moscow,5043,2,11,3,6,27,20,7,36
Zenit,5043,3,8,9,3,23,13,10,33
Spart Moscow,5043,4,9,5,6,37,29,8,32
Krasnodar,5043,5,9,4,7,28,27,1,31
Terek Grozny,5043,6,7,6,7,21,24,-3,27
Din Moscow,5043,7,6,6,8,18,23,-5,24
FK Rubin,5043,8,6,5,9,23,18,5,23
Amkar,5043,9,6,4,10,13,24,-11,22
Rostov,5043,10,4,6,10,11,20,-9,18
Anzhi,5043,11,2,6,12,15,39,-24,12
Loko Moscow,5044,1,12,5,3,31,15,16,41
CSKA Moscow,5044,2,11,3,6,27,20,7,36
Krasnodar,5044,3,10,4,6,32,25,7,34
Spart Moscow,5044,4,9,6,5,38,30,8,33
Zenit,5044,5,8,8,4,24,15,9,32
Terek Grozny,5044,6,8,5,7,22,24,-2,29
Din Moscow,5044,7,6,6,8,21,25,-4,24
FK Rubin,5044,8,5,5,10,22,20,2,20
Rostov,5044,9,4,7,9,12,19,-7,19
Amkar,5044,10,5,4,11,11,24,-13,19
Anzhi,5044,11,3,5,12,15,38,-23,14
Loko Moscow,5045,1,12,5,3,30,12,18,41
Zenit,5045,2,9,8,3,23,13,10,35
CSKA Moscow,5045,3,10,4,6,25,18,7,34
Spart Moscow,5045,4,8,7,5,37,31,6,31
Krasnodar,5045,5,9,4,7,28,25,3,31
Terek Grozny,5045,6,8,6,6,26,22,4,30
Din Moscow,5045,7,6,7,7,20,22,-2,25
Rostov,5045,8,5,6,9,14,19,-5,21
FK Rubin,5045,9,5,5,10,21,20,1,20
Amkar,5045,10,4,5,11,10,29,-19,17
Anzhi,5045,11,2,7,11,14,37,-23,13
Loko Moscow,5046,1,12,6,2,31,12,19,42
CSKA Moscow,5046,2,11,4,5,28,19,9,37
Spart Moscow,5046,3,10,6,4,40,26,14,36
Zenit,5046,4,7,10,3,23,15,8,31
Krasnodar,5046,5,9,4,7,30,25,5,31
Terek Grozny,5046,6,7,7,6,23,25,-2,28
Din Moscow,5046,7,5,7,8,17,23,-6,22
FK Rubin,5046,8,5,6,9,21,20,1,21
Rostov,5046,9,4,6,10,10,21,-11,18
Amkar,5046,10,4,6,10,11,24,-13,18
Anzhi,5046,11,2,6,12,17,41,-24,12
Loko Moscow,5047,1,11,5,4,30,16,14,38
CSKA Moscow,5047,2,10,5,5,26,18,8,35
Krasnodar,5047,3,10,4,6,31,25,6,34
Zenit,5047,4,8,9,3,25,14,11,33
Spart Moscow,5047,5,9,6,5,37,29,8,33
Terek Grozny,5047,6,8,6,6,24,23,1,30
Din Moscow,5047,7,6,7,7,23,23,0,25
Rostov,5047,8,5,6,9,12,18,-6,21
FK Rubin,5047,9,5,5,10,23,25,-2,20
Amkar,5047,10,4,5,11,11,25,-14,17
Anzhi,5047,11,2,6,12,15,41,-26,12
Loko Moscow,5048,1,12,6,2,34,15,19,42
Spart Moscow,5048,2,10,5,5,38,28,10,35
CSKA Moscow,5048,3,10,5,5,26,18,8,35
Zenit,5048,4,7,10,3,23,15,8,31
Krasnodar,5048,5,9,4,7,30,27,3,31
Terek Grozny,5048,6,8,6,6,21,22,-1,30
Din Moscow,5048,7,6,7,7,18,21,-3,25
FK Rubin,5048,8,5,6,9,21,18,3,21
Rostov,5048,9,4,6,10,11,19,-8,18
Amkar,5048,10,4,5,11,10,25,-15,17
Anzhi,5048,11,2,6,12,15,39,-24,12
Loko Moscow,5049,1,12,6,2,31,11,20,42
Spart Moscow,5049,2,11,5,4,37,26,11,38
CSKA Moscow,5049,3,10,4,6,26,20,6,34
Zenit,5049,4,8,8,4,23,15,8,32
Krasnodar,5049,5,8,6,6,28,25,3,30
Terek Grozny,5049,6,8,6,6,21,22,-1,30
FK Rubin,5049,7,6,6,8,25,18,7,24
Din Moscow,5049,8,5,6,9,18,26,-8,21
Rostov,5049,9,4,6,10,10,18,-8,18
Amkar,5049,10,4,5,11,9,23,-14,17
Anzhi,5049,11,2,6,12,15,39,-24,12
Loko Moscow,5050,1,11,7,2,31,13,18,40
CSKA Moscow,5050,2,11,4,5,29,19,10,37
Spart Moscow,5050,3,9,5,6,37,31,6,32
Zenit,5050,4,7,10,3,25,17,8,31
Krasnodar,5050,5,8,5,7,27,26,1,29
Terek Grozny,5050,6,7,7,6,20,22,-2,28
FK Rubin,5050,7,7,5,8,24,17,7,26
Din Moscow,5050,8,6,6,8,19,23,-4,24
Amkar,5050,9,5,5,10,12,23,-11,20
Rostov,5050,10,4,6,10,11,19,-8,18
Anzhi,5050,11,2,6,12,14,39,-25,12
Loko Moscow,5051,1,11,5,4,29,13,16,38
Spart Moscow,5051,2,10,5,5,40,30,10,35
CSKA Moscow,5051,3,10,4,6,27,20,7,34
Krasnodar,5051,4,10,4,6,29,24,5,34
Zenit,5051,5,8,9,3,24,15,9,33
Terek Grozny,5051,6,7,6,7,23,26,-3,27
Din Moscow,5051,7,5,7,8,19,25,-6,22
FK Rubin,5051,8,5,6,9,21,18,3,21
Rostov,5051,9,5,6,9,12,18,-6,21
Amkar,5051,10,4,5,11,11,25,-14,17
Anzhi,5051,11,4,5,11,18,39,-21,17
Loko Moscow,5052,1,12,5,3,30,14,16,41
CSKA Moscow,5052,2,11,3,6,26,21,5,36
Krasnodar,5052,3,10,4,6,32,25,7,34
Zenit,5052,4,8,8,4,25,14,11,32
Spart Moscow,5052,5,8,6,6,35,29,6,30
Terek Grozny,5052,6,7,6,7,21,26,-5,27
Din Moscow,5052,7,6,6,8,21,26,-5,24
FK Rubin,5052,8,6,5,9,25,20,5,23
Amkar,5052,9,5,5,10,11,23,-12,20
Rostov,5052,10,4,7,9,10,17,-7,19
Anzhi,5052,11,3,5,12,17,38,-21,14
Loko Moscow,5053,1,12,6,2,31,12,19,42
Spart Moscow,5053,2,11,5,4,37,25,12,38
CSKA Moscow,5053,3,11,4,5,32,20,12,37
Zenit,5053,4,7,9,4,23,16,7,30
Krasnodar,5053,5,8,5,7,28,26,2,29
Terek Grozny,5053,6,7,6,7,22,25,-3,27
FK Rubin,5053,7,6,6,8,22,17,5,24
Din Moscow,5053,8,5,7,8,17,22,-5,22
Rostov,5053,9,4,6,10,10,18,-8,18
Amkar,5053,10,4,5,11,10,25,-15,17
Anzhi,5053,11,3,5,12,17,43,-26,14
Loko Moscow,5054,1,13,5,2,32,11,21,44
Spart Moscow,5054,2,11,5,4,41,27,14,38
CSKA Moscow,5054,3,10,3,7,27,22,5,33
Zenit,5054,4,8,8,4,25,17,8,32
Terek Grozny,5054,5,8,5,7,23,25,-2,29
Krasnodar,5054,6,8,4,8,28,27,1,28
FK Rubin,5054,7,7,5,8,25,19,6,26
Din Moscow,5054,8,5,6,9,19,25,-6,21
Amkar,5054,9,5,4,11,11,25,-14,19
Rostov,5054,10,4,6,10,10,20,-10,18
Anzhi,5054,11,3,5,12,17,40,-23,14
Loko Moscow,5055,1,12,5,3,30,13,17,41
CSKA Moscow,5055,2,12,3,5,29,19,10,39
Spart Moscow,5055,3,10,6,4,40,26,14,36
Krasnodar,5055,4,10,4,6,32,26,6,34
Zenit,5055,5,7,8,5,21,15,6,29
Terek Grozny,5055,6,8,5,7,21,24,-3,29
Din Moscow,5055,7,5,7,8,19,26,-7,22
FK Rubin,5055,8,5,6,9,24,21,3,21
Rostov,5055,9,4,6,10,10,20,-10,18
Amkar,5055,10,4,5,11,9,23,-14,17
Anzhi,5055,11,3,5,12,18,40,-22,14
Loko Moscow,5056,1,11,7,2,32,14,18,40
CSKA Moscow,5056,2,11,4,5,29,20,9,37
Spart Moscow,5056,3,9,7,4,39,28,11,34
Zenit,5056,4,7,10,3,22,14,8,31
Krasnodar,5056,5,8,5,7,32,30,2,29
Terek Grozny,5056,6,8,5,7,24,25,-1,29
FK Rubin,5056,7,6,6,8,25,20,5,24
Din Moscow,5056,8,5,7,8,18,25,-7,22
Rostov,5056,9,4,7,9,11,18,-7,19
Amkar,5056,10,4,5,11,11,26,-15,17
Anzhi,5056,11,3,5,12,19,42,-23,14
Loko Moscow,5057,1,12,5,3,32,12,20,41
CSKA Moscow,5057,2,11,4,5,31,18,13,37
Spart Moscow,5057,3,10,5,5,39,29,10,35
Krasnodar,5057,4,9,5,6,29,25,4,32
Zenit,5057,5,7,9,4,22,17,5,30
Terek Grozny,5057,6,8,5,7,21,24,-3,29
FK Rubin,5057,7,5,7,8,24,20,4,22
Din Moscow,5057,8,5,7,8,20,25,-5,22
Rostov,5057,9,5,6,9,12,18,-6,21
Amkar,5057,10,4,4,12,10,26,-16,16
Anzhi,5057,11,3,5,12,16,42,-26,14
Loko Moscow,5058,1,12,5,3,32,15,17,41
Zenit,5058,2,9,8,3,26,13,13,35
Spart Moscow,5058,3,9,6,5,38,29,9,33
CSKA Moscow,5058,4,10,3,7,26,21,5,33
Terek Grozny,5058,5,8,6,6,23,24,-1,30
Krasnodar,5058,6,8,5,7,30,29,1,29
FK Rubin,5058,7,6,6,8,25,20,5,24
Din Moscow,5058,8,5,7,8,19,24,-5,22
Rostov,5058,9,5,6,9,12,17,-5,21
Amkar,5058,10,4,5,11,11,27,-16,17
Anzhi,5058,11,3,5,12,17,40,-23,14
Loko Moscow,5059,1,11,6,3,31,15,16,39
CSKA Moscow,5059,2,12,3,5,29,17,12,39
Spart Moscow,5059,3,10,5,5,38,27,11,35
Krasnodar,5059,4,9,5,6,32,27,5,32
Zenit,5059,5,7,9,4,22,16,6,30
Terek Grozny,5059,6,8,5,7,21,24,-3,29
FK Rubin,5059,7,5,7,8,24,20,4,22
Din Moscow,5059,8,5,7,8,18,25,-7,22
Rostov,5059,9,5,6,9,11,17,-6,21
Amkar,5059,10,4,4,12,10,25,-15,16
Anzhi,5059,11,3,5,12,16,39,-23,14
Loko Moscow,5060,1,11,7,2,31,13,18,40
CSKA Moscow,5060,2,11,3,6,28,19,9,36
Spart Moscow,5060,3,10,5,5,37,27,10,35
Zenit,5060,4,8,9,3,24,14,10,33
Krasnodar,5060,5,9,5,6,31,27,4,32
Terek Grozny,5060,6,7,6,7,21,26,-5,27
Din Moscow,5060,7,6,6,8,19,24,-5,24
Rostov,5060,8,5,6,9,11,17,-6,21
FK Rubin,5060,9,5,5,10,23,21,2,20
Amkar,5060,10,5,4,11,12,23,-11,19
Anzhi,5060,11,2,6,12,15,41,-26,12
Loko Moscow,5061,1,13,5,2,35,11,24,44
CSKA Moscow,5061,2,11,3,6,27,20,7,36
Spart Moscow,5061,3,10,5,5,39,26,13,35
Zenit,5061,4,8,8,4,24,16,8,32
Krasnodar,5061,5,8,5,7,27,27,0,29
Terek Grozny,5061,6,7,5,8,23,27,-4,26
FK Rubin,5061,7,5,7,8,22,18,4,22
Din Moscow,5061,8,5,7,8,18,26,-8,22
Amkar,5061,9,6,4,10,13,24,-11,22
Rostov,5061,10,4,6,10,10,19,-9,18
Anzhi,5061,11,3,5,12,16,40,-24,14
Loko Moscow,5062,1,13,5,2,33,12,21,44
CSKA Moscow,5062,2,11,3,6,27,21,6,36
Spart Moscow,5062,3,9,6,5,37,29,8,33
Zenit,5062,4,8,8,4,26,17,9,32
Krasnodar,5062,5,8,5,7,27,25,2,29
Terek Grozny,5062,6,7,6,7,21,24,-3,27
Din Moscow,5062,7,6,6,8,21,25,-4,24
FK Rubin,5062,8,5,6,9,22,19,3,21
Rostov,5062,9,5,6,9,11,17,-6,21
Amkar,5062,10,4,6,10,10,23,-13,18
Anzhi,5062,11,3,5,12,16,39,-23,14
Loko Moscow,5063,1,11,6,3,29,13,16,39
CSKA Moscow,5063,2,11,4,5,26,17,9,37
Krasnodar,5063,3,10,4,6,31,25,6,34
Spart Moscow,5063,4,9,5,6,40,35,5,32
Zenit,5063,5,7,10,3,21,13,8,31
Din Moscow,5063,6,7,6,7,23,24,-1,27
Terek Grozny,5063,7,7,6,7,23,26,-3,27
Rostov,5063,8,5,6,9,15,20,-5,21
FK Rubin,5063,9,5,5,10,22,20,2,20
Amkar,5063,10,5,4,11,11,24,-13,19
Anzhi,5063,11,2,6,12,16,40,-24,12
Loko Moscow,5064,1,12,6,2,32,12,20,42
CSKA Moscow,5064,2,11,3,6,30,19,11,36
Spart Moscow,5064,3,10,5,5,37,29,8,35
Zenit,5064,4,8,9,3,23,13,10,33
Krasnodar,5064,5,8,5,7,30,29,1,29
Terek Grozny,5064,6,7,6,7,22,26,-4,27
FK Rubin,5064,7,5,7,8,24,20,4,22
Din Moscow,5064,8,5,7,8,20,25,-5,22
Amkar,5064,9,5,5,10,12,23,-11,20
Rostov,5064,10,4,6,10,10,18,-8,18
Anzhi,5064,11,3,5,12,17,43,-26,14
Loko Moscow,5065,1,13,5,2,33,11,22,44
CSKA Moscow,5065,2,11,3,6,28,18,10,36
Spart Moscow,5065,3,9,6,5,39,30,9,33
Krasnodar,5065,4,9,4,7,30,26,4,31
Terek Grozny,5065,5,8,6,6,22,23,-1,30
Zenit,5065,6,7,8,5,21,18,3,29
FK Rubin,5065,7,6,5,9,22,20,2,23
Din Moscow,5065,8,5,7,8,19,24,-5,22
Rostov,5065,9,5,6,9,11,17,-6,21
Amkar,5065,10,4,5,11,12,27,-15,17
Anzhi,5065,11,3,5,12,15,38,-23,14
Loko Moscow,5066,1,11,5,4,29,16,13,38
CSKA Moscow,5066,2,11,4,5,28,19,9,37
Spart Moscow,5066,3,10,5,5,38,28,10,35
Krasnodar,5066,4,10,4,6,31,24,7,34
Zenit,5066,5,8,8,4,23,14,9,32
Terek Grozny,5066,6,8,5,7,26,24,2,29
FK Rubin,5066,7,6,5,9,22,18,4,23
Rostov,5066,8,5,6,9,12,17,-5,21
Din Moscow,5066,9,5,6,9,17,24,-7,21
Amkar,5066,10,5,4,11,12,26,-14,19
Anzhi,5066,11,2,6,12,16,44,-28,12
Loko Moscow,5067,1,11,6,3,30,14,16,39
CSKA Moscow,5067,2,12,3,5,28,17,11,39
Spart Moscow,5067,3,10,5,5,40,33,7,35
Krasnodar,5067,4,9,5,6,29,24,5,32
Zenit,5067,5,7,9,4,22,16,6,30
Terek Grozny,5067,6,8,5,7,21,23,-2,29
FK Rubin,5067,7,5,7,8,23,19,4,22
Din Moscow,5067,8,5,7,8,21,26,-5,22
Amkar,5067,9,6,4,10,14,23,-9,22
Rostov,5067,10,4,6,10,12,20,-8,18
Anzhi,5067,11,2,5,13,14,39,-25,11
Loko Moscow,5068,1,12,6,2,32,12,20,42
CSKA Moscow,5068,2,11,3,6,30,23,7,36
Spart Moscow,5068,3,9,5,6,35,29,6,32
Krasnodar,5068,4,9,5,6,31,25,6,32
Zenit,5068,5,7,8,5,23,18,5,29
Terek Grozny,5068,6,7,6,7,21,24,-3,27
FK Rubin,5068,7,6,5,9,23,21,2,23
Rostov,5068,8,5,6,9,12,17,-5,21
Din Moscow,5068,9,5,6,9,18,24,-6,21
Amkar,5068,10,5,5,10,12,24,-12,20
Anzhi,5068,11,4,5,11,19,39,-20,17
Loko Moscow,5069,1,11,7,2,32,14,18,40
CSKA Moscow,5069,2,11,3,6,26,18,8,36
Spart Moscow,5069,3,10,5,5,39,29,10,35
Krasnodar,5069,4,9,5,6,29,25,4,32
Zenit,5069,5,7,9,4,23,16,7,30
Terek Grozny,5069,6,8,6,6,23,24,-1,30
FK Rubin,5069,7,6,5,9,24,19,5,23
Din Moscow,5069,8,5,6,9,19,28,-9,21
Amkar,5069,9,5,5,10,13,24,-11,20
Rostov,5069,10,4,6,10,11,19,-8,18
Anzhi,5069,11,3,5,12,15,38,-23,14
Loko Moscow,5070,1,12,5,3,31,13,18,41
Spart Moscow,5070,2,11,5,4,40,27,13,38
CSKA Moscow,5070,3,11,4,5,28,19,9,37
Krasnodar,5070,4,9,5,6,30,26,4,32
Zenit,5070,5,7,9,4,21,14,7,30
Terek Grozny,5070,6,8,5,7,24,25,-1,29
FK Rubin,5070,7,5,7,8,23,19,4,22
Din Moscow,5070,8,5,7,8,19,25,-6,22
Amkar,5070,9,5,4,11,11,24,-13,19
Rostov,5070,10,4,6,10,11,20,-9,18
Anzhi,5070,11,2,5,13,17,43,-26,11
Loko Moscow,5071,1,13,5,2,33,13,20,44
Spart Moscow,5071,2,11,5,4,41,28,13,38
CSKA Moscow,5071,3,10,4,6,26,20,6,34
Zenit,5071,4,8,8,4,25,16,9,32
Krasnodar,5071,5,9,4,7,30,27,3,31
Terek Grozny,5071,6,8,5,7,22,23,-1,29
Din Moscow,5071,7,6,6,8,21,24,-3,24
FK Rubin,5071,8,5,5,10,22,21,1,20
Rostov,5071,9,4,6,10,10,20,-10,18
Amkar,5071,10,4,4,12,10,26,-16,16
Anzhi,5071,11,3,6,11,15,37,-22,15
Loko Moscow,5072,1,13,5,2,36,11,25,44
Spart Moscow,5072,2,10,6,4,42,27,15,36
CSKA Moscow,5072,3,11,3,6,29,20,9,36
Zenit,5072,4,8,8,4,23,17,6,32
Krasnodar,5072,5,9,4,7,29,29,0,31
Terek Grozny,5072,6,8,5,7,22,23,-1,29
Din Moscow,5072,7,5,8,7,20,24,-4,23
FK Rubin,5072,8,5,6,9,23,20,3,21
Amkar,5072,9,5,4,11,10,25,-15,19
Rostov,5072,10,4,6,10,10,21,-11,18
Anzhi,5072,11,2,5,13,15,42,-27,11
Loko Moscow,5073,1,12,5,3,32,13,19,41
CSKA Moscow,5073,2,11,3,6,26,18,8,36
Krasnodar,5073,3,10,4,6,32,26,6,34
Spart Moscow,5073,4,9,6,5,39,30,9,33
Zenit,5073,5,8,8,4,22,15,7,32
Terek Grozny,5073,6,9,5,6,25,24,1,32
Din Moscow,5073,7,5,8,7,21,25,-4,23
FK Rubin,5073,8,5,6,9,23,21,2,21
Amkar,5073,9,5,4,11,11,24,-13,19
Rostov,5073,10,4,6,10,11,20,-9,18
Anzhi,5073,11,2,5,13,15,41,-26,11
Loko Moscow,5074,1,12,6,2,32,12,20,42
Spart Moscow,5074,2,10,6,4,42,31,11,36
CSKA Moscow,5074,3,10,4,6,27,20,7,34
Zenit,5074,4,8,9,3,22,13,9,33
Krasnodar,5074,5,8,4,8,28,28,0,28
Terek Grozny,5074,6,7,7,6,22,24,-2,28
FK Rubin,5074,7,7,5,8,24,18,6,26
Din Moscow,5074,8,5,6,9,20,27,-7,21
Rostov,5074,9,4,7,9,12,19,-7,19
Amkar,5074,10,4,5,11,12,26,-14,17
Anzhi,5074,11,2,7,11,17,40,-23,13
Loko Moscow,5075,1,12,5,3,31,12,19,41
CSKA Moscow,5075,2,11,3,6,26,18,8,36
Zenit,5075,3,9,8,3,23,13,10,35
Terek Grozny,5075,4,8,6,6,22,23,-1,30
Spart Moscow,5075,5,8,5,7,34,30,4,29
Krasnodar,5075,6,8,5,7,28,27,1,29
Din Moscow,5075,7,7,6,7,21,22,-1,27
FK Rubin,5075,8,5,6,9,23,20,3,21
Rostov,5075,9,5,6,9,11,17,-6,21
Amkar,5075,10,5,5,10,12,24,-12,20
Anzhi,5075,11,2,5,13,14,39,-25,11
Loko Moscow,5076,1,11,7,2,30,12,18,40
CSKA Moscow,5076,2,11,3,6,29,21,8,36
Zenit,5076,3,8,9,3,24,15,9,33
Spart Moscow,5076,4,9,6,5,38,30,8,33
Krasnodar,5076,5,8,5,7,28,26,2,29
Terek Grozny,5076,6,8,5,7,23,24,-1,29
Din Moscow,5076,7,6,7,7,19,22,-3,25
FK Rubin,5076,8,6,6,8,23,18,5,24
Rostov,5076,9,4,7,9,12,19,-7,19
Amkar,5076,10,4,4,12,10,26,-16,16
Anzhi,5076,11,3,5,12,18,41,-23,14
Loko Moscow,5077,1,12,5,3,31,13,18,41
Spart Moscow,5077,2,10,5,5,41,29,12,35
CSKA Moscow,5077,3,10,5,5,27,19,8,35
Krasnodar,5077,4,10,4,6,33,25,8,34
Zenit,5077,5,7,9,4,22,16,6,30
Terek Grozny,5077,6,7,5,8,20,24,-4,26
FK Rubin,5077,7,6,5,9,25,21,4,23
Rostov,5077,8,5,6,9,12,18,-6,21
Din Moscow,5077,9,5,6,9,17,28,-11,21
Amkar,5077,10,5,4,11,12,25,-13,19
Anzhi,5077,11,3,6,11,16,38,-22,15
Loko Moscow,5078,1,12,6,2,34,14,20,42
CSKA Moscow,5078,2,11,4,5,30,19,11,37
Spart Moscow,5078,3,10,6,4,43,31,12,36
Zenit,5078,4,7,10,3,23,15,8,31
Krasnodar,5078,5,8,4,8,30,30,0,28
Terek Grozny,5078,6,7,6,7,21,24,-3,27
Din Moscow,5078,7,6,6,8,21,25,-4,24
FK Rubin,5078,8,6,5,9,23,20,3,23
Amkar,5078,9,5,5,10,12,24,-12,20
Rostov,5078,10,4,6,10,12,21,-9,18
Anzhi,5078,11,2,6,12,16,42,-26,12
Loko Moscow,5079,1,12,6,2,32,12,20,42
CSKA Moscow,5079,2,12,3,5,30,19,11,39
Spart Moscow,5079,3,9,7,4,37,27,10,34
Krasnodar,5079,4,9,4,7,32,29,3,31
Zenit,5079,5,7,9,4,22,16,6,30
Terek Grozny,5079,6,8,6,6,26,23,3,30
Din Moscow,5079,7,6,7,7,20,23,-3,25
FK Rubin,5079,8,5,5,10,24,23,1,20
Rostov,5079,9,4,7,9,11,18,-7,19
Amkar,5079,10,4,5,11,10,25,-15,17
Anzhi,5079,11,2,5,13,15,44,-29,11
Loko Moscow,5080,1,12,6,2,32,12,20,42
CSKA Moscow,5080,2,12,3,5,30,19,11,39
Spart Moscow,5080,3,10,6,4,39,28,11,36
Zenit,5080,4,7,9,4,21,14,7,30
Krasnodar,5080,5,8,5,7,30,29,1,29
Terek Grozny,5080,6,8,5,7,21,26,-5,29
FK Rubin,5080,7,6,6,8,27,22,5,24
Din Moscow,5080,8,5,6,9,21,27,-6,21
Rostov,5080,9,4,7,9,11,18,-7,19
Amkar,5080,10,4,4,12,10,26,-16,16
Anzhi,5080,11,3,5,12,20,41,-21,14
Loko Moscow,5081,1,13,5,2,36,11,25,44
CSKA Moscow,5081,2,12,3,5,29,18,11,39
Spart Moscow,5081,3,10,6,4,37,27,10,36
Krasnodar,5081,4,9,4,7,30,27,3,31
Zenit,5081,5,7,8,5,21,19,2,29
Terek Grozny,5081,6,8,5,7,21,24,-3,29
Din Moscow,5081,7,6,7,7,18,21,-3,25
FK Rubin,5081,8,5,5,10,21,21,0,20
Amkar,5081,9,5,4,11,12,24,-12,19
Rostov,5081,10,4,6,10,11,19,-8,18
Anzhi,5081,11,2,5,13,15,40,-25,11
Loko Moscow,5082,1,12,5,3,32,15,17,41
Spart Moscow,5082,2,11,5,4,40,26,14,38
CSKA Moscow,5082,3,10,4,6,26,19,7,34
Krasnodar,5082,4,9,4,7,31,27,4,31
Zenit,5082,5,7,9,4,22,15,7,30
Terek Grozny,5082,6,7,7,6,21,23,-2,28
FK Rubin,5082,7,7,5,8,24,18,6,26
Din Moscow,5082,8,5,6,9,17,24,-7,21
Rostov,5082,9,4,6,10,10,19,-9,18
Amkar,5082,10,4,5,11,10,25,-15,17
Anzhi,5082,11,3,6,11,17,39,-22,15
Loko Moscow,5083,1,13,5,2,32,11,21,44
CSKA Moscow,5083,2,11,4,5,27,18,9,37
Spart Moscow,5083,3,9,6,5,40,29,11,33
Zenit,5083,4,7,9,4,22,16,6,30
Krasnodar,5083,5,8,4,8,27,27,0,28
Din Moscow,5083,6,7,6,7,21,23,-2,27
Terek Grozny,5083,7,7,6,7,22,26,-4,27
FK Rubin,5083,8,6,5,9,24,19,5,23
Rostov,5083,9,4,7,9,12,19,-7,19
Amkar,5083,10,4,5,11,11,28,-17,17
Anzhi,5083,11,3,5,12,16,38,-22,14
Loko Moscow,5084,1,11,6,3,30,14,16,39
CSKA Moscow,5084,2,11,4,5,29,20,9,37
Spart Moscow,5084,3,9,7,4,39,29,10,34
Zenit,5084,4,8,9,3,24,14,10,33
Krasnodar,5084,5,9,5,6,30,26,4,32
Terek Grozny,5084,6,8,5,7,23,24,-1,29
Din Moscow,5084,7,6,6,8,19,24,-5,24
FK Rubin,5084,8,5,5,10,22,20,2,20
Amkar,5084,9,5,5,10,11,23,-12,20
Rostov,5084,10,4,7,9,12,19,-7,19
Anzhi,5084,11,2,5,13,17,43,-26,11
Loko Moscow,5085,1,13,5,2,33,12,21,44
Spart Moscow,5085,2,10,5,5,36,28,8,35
CSKA Moscow,5085,3,10,5,5,28,20,8,35
Zenit,5085,4,7,9,4,23,17,6,30
Terek Grozny,5085,5,8,6,6,23,23,0,30
Krasnodar,5085,6,8,5,7,29,27,2,29
FK Rubin,5085,7,6,6,8,24,18,6,24
Din Moscow,5085,8,5,6,9,18,25,-7,21
Amkar,5085,9,5,5,10,11,22,-11,20
Rostov,5085,10,4,6,10,10,18,-8,18
Anzhi,5085,11,2,6,12,16,41,-25,12
Loko Moscow,5086,1,12,6,2,30,11,19,42
Spart Moscow,5086,2,10,5,5,39,27,12,35
CSKA Moscow,5086,3,10,4,6,26,20,6,34
Zenit,5086,4,8,8,4,23,14,9,32
Krasnodar,5086,5,8,6,6,28,25,3,30
Terek Grozny,5086,6,8,6,6,23,23,0,30
Din Moscow,5086,7,6,7,7,19,22,-3,25
FK Rubin,5086,8,5,7,8,23,19,4,22
Rostov,5086,9,4,6,10,10,20,-10,18
Amkar,5086,10,4,5,11,11,26,-15,17
Anzhi,5086,11,2,6,12,15,40,-25,12
Loko Moscow,5087,1,12,5,3,30,14,16,41
CSKA Moscow,5087,2,12,3,5,30,17,13,39
Spart Moscow,5087,3,10,6,4,38,27,11,36
Zenit,5087,4,8,8,4,24,14,10,32
Terek Grozny,5087,5,8,6,6,23,22,1,30
Krasnodar,5087,6,8,5,7,28,26,2,29
FK Rubin,5087,7,6,6,8,23,18,5,24
Din Moscow,5087,8,5,6,9,17,23,-6,21
Rostov,5087,9,4,7,9,11,18,-7,19
Amkar,5087,10,4,4,12,10,28,-18,16
Anzhi,5087,11,2,6,12,14,41,-27,12
Loko Moscow,5088,1,11,6,3,29,17,12,39
CSKA Moscow,5088,2,11,4,5,28,19,9,37
Zenit,5088,3,8,9,3,28,14,14,33
Spart Moscow,5088,4,9,6,5,36,30,6,33
Krasnodar,5088,5,8,6,6,28,25,3,30
Terek Grozny,5088,6,7,7,6,20,22,-2,28
Din Moscow,5088,7,5,8,7,20,24,-4,23
FK Rubin,5088,8,5,7,8,23,19,4,22
Amkar,5088,9,5,5,10,12,22,-10,20
Rostov,5088,10,4,6,10,10,18,-8,18
Anzhi,5088,11,2,6,12,15,39,-24,12
Loko Moscow,5089,1,12,5,3,30,13,17,41
CSKA Moscow,5089,2,11,3,6,27,18,9,36
Spart Moscow,5089,3,9,6,5,36,28,8,33
Zenit,5089,4,8,8,4,22,14,8,32
Krasnodar,5089,5,9,4,7,29,26,3,31
Terek Grozny,5089,6,7,5,8,22,28,-6,26
FK Rubin,5089,7,6,6,8,23,17,6,24
Din Moscow,5089,8,5,7,8,18,23,-5,22
Amkar,5089,9,6,4,10,14,25,-11,22
Rostov,5089,10,4,7,9,10,17,-7,19
Anzhi,5089,11,3,5,12,17,39,-22,14
Loko Moscow,5090,1,13,5,2,33,12,21,44
CSKA Moscow,5090,2,12,3,5,28,17,11,39
Krasnodar,5090,3,9,4,7,28,26,2,31
Spart Moscow,5090,4,8,6,6,37,31,6,30
Zenit,5090,5,7,8,5,22,16,6,29
Terek Grozny,5090,6,7,6,7,22,27,-5,27
Din Moscow,5090,7,5,8,7,19,23,-4,23
FK Rubin,5090,8,5,6,9,22,19,3,21
Rostov,5090,9,5,6,9,13,19,-6,21
Amkar,5090,10,5,5,10,11,23,-12,20
Anzhi,5090,11,3,5,12,19,41,-22,14
Loko Moscow,5091,1,12,6,2,31,11,20,42
Spart Moscow,5091,2,10,6,4,39,26,13,36
CSKA Moscow,5091,3,11,3,6,28,19,9,36
Zenit,5091,4,8,8,4,22,15,7,32
Krasnodar,5091,5,8,6,6,28,25,3,30
Terek Grozny,5091,6,7,6,7,21,24,-3,27
FK Rubin,5091,7,5,7,8,22,18,4,22
Din Moscow,5091,8,5,7,8,18,25,-7,22
Amkar,5091,9,5,5,10,10,22,-12,20
Rostov,5091,10,4,6,10,10,19,-9,18
Anzhi,5091,11,2,6,12,16,41,-25,12
Loko Moscow,5092,1,12,6,2,31,12,19,42
CSKA Moscow,5092,2,11,3,6,28,18,10,36
Spart Moscow,5092,3,9,6,5,36,28,8,33
Krasnodar,5092,4,9,5,6,33,25,8,32
Zenit,5092,5,8,8,4,22,14,8,32
Terek Grozny,5092,6,7,7,6,22,24,-2,28
Din Moscow,5092,7,7,6,7,21,23,-2,27
FK Rubin,5092,8,5,5,10,22,24,-2,20
Rostov,5092,9,4,7,9,10,17,-7,19
Amkar,5092,10,4,5,11,12,26,-14,17
Anzhi,5092,11,2,6,12,14,40,-26,12
Loko Moscow,5093,1,11,6,3,31,14,17,39
CSKA Moscow,5093,2,11,3,6,27,19,8,36
Spart Moscow,5093,3,10,5,5,43,30,13,35
Zenit,5093,4,9,8,3,25,15,10,35
Terek Grozny,5093,5,8,6,6,25,22,3,30
Krasnodar,5093,6,8,5,7,29,27,2,29
FK Rubin,5093,7,7,5,8,25,19,6,26
Rostov,5093,8,5,6,9,14,19,-5,21
Din Moscow,5093,9,5,6,9,19,27,-8,21
Amkar,5093,10,4,5,11,9,26,-17,17
Anzhi,5093,11,2,5,13,14,43,-29,11
Loko Moscow,5094,1,11,6,3,30,13,17,39
Spart Moscow,5094,2,10,6,4,39,28,11,36
Zenit,5094,3,8,9,3,23,13,10,33
CSKA Moscow,5094,4,10,3,7,26,21,5,33
Krasnodar,5094,5,9,5,6,29,25,4,32
Terek Grozny,5094,6,7,5,8,20,25,-5,26
FK Rubin,5094,7,6,6,8,22,17,5,24
Din Moscow,5094,8,5,7,8,19,24,-5,22
Amkar,5094,9,5,4,11,12,25,-13,19
Rostov,5094,10,4,6,10,10,18,-8,18
Anzhi,5094,11,4,5,11,17,38,-21,17
Loko Moscow,5095,1,13,5,2,34,13,21,44
CSKA Moscow,5095,2,12,3,5,28,17,11,39
Spart Moscow,5095,3,9,7,4,36,26,10,34
Zenit,5095,4,7,8,5,22,17,5,29
Krasnodar,5095,5,8,4,8,29,28,1,28
Terek Grozny,5095,6,7,6,7,21,25,-4,27
FK Rubin,5095,7,7,5,8,26,18,8,26
Din Moscow,5095,8,5,6,9,17,26,-9,21
Rostov,5095,9,4,7,9,11,18,-7,19
Amkar,5095,10,4,6,10,10,23,-13,18
Anzhi,5095,11,3,5,12,16,39,-23,14
Loko Moscow,5096,1,12,5,3,30,14,16,41
CSKA Moscow,5096,2,11,3,6,28,18,10,36
Spart Moscow,5096,3,9,7,4,37,27,10,34
Zenit,5096,4,8,8,4,22,14,8,32
Krasnodar,5096,5,9,5,6,31,25,6,32
Terek Grozny,5096,6,7,6,7,21,24,-3,27
Din Moscow,5096,7,5,8,7,18,22,-4,23
FK Rubin,5096,8,5,7,8,23,19,4,22
Rostov,5096,9,4,7,9,11,18,-7,19
Amkar,5096,10,5,4,11,11,25,-14,19
Anzhi,5096,11,2,6,12,15,41,-26,12
Loko Moscow,5097,1,12,5,3,31,14,17,41
Spart Moscow,5097,2,10,5,5,39,26,13,35
CSKA Moscow,5097,3,10,4,6,26,19,7,34
Krasnodar,5097,4,10,4,6,31,25,6,34
Zenit,5097,5,7,9,4,23,16,7,30
Terek Grozny,5097,6,7,5,8,21,25,-4,26
Din Moscow,5097,7,5,7,8,17,25,-8,22
Amkar,5097,8,6,4,10,11,22,-11,22
FK Rubin,5097,9,5,6,9,22,19,3,21
Rostov,5097,10,4,6,10,10,19,-9,18
Anzhi,5097,11,4,5,11,17,38,-21,17
Loko Moscow,5098,1,13,5,2,33,13,20,44
Spart Moscow,5098,2,10,6,4,40,28,12,36
CSKA Moscow,5098,3,10,5,5,26,18,8,35
Krasnodar,5098,4,9,4,7,31,28,3,31
Zenit,5098,5,7,9,4,23,16,7,30
Terek Grozny,5098,6,7,6,7,22,25,-3,27
Din Moscow,5098,7,5,7,8,20,27,-7,22
FK Rubin,5098,8,5,6,9,25,22,3,21
Rostov,5098,9,4,6,10,11,19,-8,18
Amkar,5098,10,4,6,10,11,24,-13,18
Anzhi,5098,11,3,6,11,16,38,-22,15
Loko Moscow,5099,1,11,6,3,30,13,17,39
CSKA Moscow,5099,2,11,3,6,28,20,8,36
Zenit,5099,3,9,8,3,24,14,10,35
Krasnodar,5099,4,9,5,6,29,24,5,32
Spart Moscow,5099,5,8,7,5,34,28,6,31
Terek Grozny,5099,6,8,5,7,23,25,-2,29
Din Moscow,5099,7,5,8,7,18,22,-4,23
FK Rubin,5099,8,5,6,9,22,20,2,21
Rostov,5099,9,5,6,9,12,17,-5,21
Amkar,5099,10,5,5,10,12,24,-12,20
Anzhi,5099,11,2,5,13,17,42,-25,11
Loko Moscow,5100,1,11,7,2,30,12,18,40
CSKA Moscow,5100,2,11,3,6,29,19,10,36
Zenit,5100,3,8,9,3,24,14,10,33
Terek Grozny,5100,4,8,6,6,22,23,-1,30
Krasnodar,5100,5,8,5,7,28,26,2,29
Spart Moscow,5100,6,8,5,7,34,33,1,29
Din Moscow,5100,7,6,7,7,20,21,-1,25
FK Rubin,5100,8,6,6,8,23,18,5,24
Rostov,5100,9,5,6,9,11,17,-6,21
Amkar,5100,10,5,4,11,14,25,-11,19
Anzhi,5100,11,2,6,12,14,41,-27,12
Loko Moscow,5101,1,12,6,2,31,12,19,42
CSKA Moscow,5101,2,12,3,5,29,17,12,39
Spart Moscow,5101,3,10,5,5,37,28,9,35
Krasnodar,5101,4,9,5,6,31,27,4,32
Terek Grozny,5101,5,9,5,6,24,24,0,32
Zenit,5101,6,7,8,5,21,17,4,29
FK Rubin,5101,7,6,5,9,26,21,5,23
Rostov,5101,8,5,6,9,11,17,-6,21
Din Moscow,5101,9,5,6,9,19,26,-7,21
Amkar,5101,10,4,4,12,11,26,-15,16
Anzhi,5101,11,2,5,13,15,40,-25,11
Loko Moscow,5102,1,12,5,3,33,14,19,41
Spart Moscow,5102,2,11,5,4,38,26,12,38
CSKA Moscow,5102,3,11,4,5,28,19,9,37
Terek Grozny,5102,4,9,5,6,24,23,1,32
Krasnodar,5102,5,9,4,7,30,27,3,31
Zenit,5102,6,7,9,4,23,17,6,30
FK Rubin,5102,7,6,6,8,24,19,5,24
Din Moscow,5102,8,5,7,8,19,24,-5,22
Rostov,5102,9,4,6,10,10,19,-9,18
Amkar,5102,10,4,4,12,10,26,-16,16
Anzhi,5102,11,2,5,13,15,40,-25,11
Loko Moscow,5103,1,11,7,2,30,12,18,40
Spart Moscow,5103,2,11,5,4,43,29,14,38
CSKA Moscow,5103,3,11,4,5,28,18,10,37
Zenit,5103,4,7,9,4,23,17,6,30
Krasnodar,5103,5,8,6,6,28,25,3,30
Terek Grozny,5103,6,8,5,7,22,25,-3,29
Din Moscow,5103,7,6,6,8,19,22,-3,24
FK Rubin,5103,8,5,6,9,22,20,2,21
Amkar,5103,9,5,4,11,14,27,-13,19
Rostov,5103,10,4,6,10,12,22,-10,18
Anzhi,5103,11,2,6,12,14,38,-24,12
Loko Moscow,5104,1,11,7,2,32,14,18,40
CSKA Moscow,5104,2,11,3,6,27,18,9,36
Zenit,5104,3,8,9,3,24,15,9,33
Spart Moscow,5104,4,9,5,6,34,28,6,32
Terek Grozny,5104,5,9,5,6,26,23,3,32
Krasnodar,5104,6,8,6,6,29,26,3,30
Din Moscow,5104,7,6,6,8,18,22,-4,24
FK Rubin,5104,8,5,6,9,22,19,3,21
Rostov,5104,9,5,6,9,11,17,-6,21
Amkar,5104,10,5,4,11,12,24,-12,19
Anzhi,5104,11,2,5,13,14,43,-29,11
Loko Moscow,5105,1,12,5,3,33,15,18,41
CSKA Moscow,5105,2,11,4,5,29,18,11,37
Spart Moscow,5105,3,10,6,4,37,25,12,36
Zenit,5105,4,8,8,4,23,17,6,32
Terek Grozny,5105,5,8,6,6,22,23,-1,30
Krasnodar,5105,6,8,4,8,29,28,1,28
FK Rubin,5105,7,6,6,8,22,17,5,24
Din Moscow,5105,8,5,8,7,17,21,-4,23
Rostov,5105,9,4,6,10,10,19,-9,18
Amkar,5105,10,4,5,11,10,25,-15,17
Anzhi,5105,11,2,6,12,15,39,-24,12
Loko Moscow,5106,1,12,6,2,31,12,19,42
CSKA Moscow,5106,2,11,3,6,28,20,8,36
Spart Moscow,5106,3,10,5,5,38,27,11,35
Zenit,5106,4,8,9,3,24,15,9,33
Krasnodar,5106,5,9,4,7,28,25,3,31
Terek Grozny,5106,6,8,5,7,21,24,-3,29
Din Moscow,5106,7,7,6,7,26,25,1,27
FK Rubin,5106,8,5,5,10,24,25,-1,20
Rostov,5106,9,4,6,10,10,18,-8,18
Amkar,5106,10,4,4,12,9,26,-17,16
Anzhi,5106,11,3,5,12,17,39,-22,14
Loko Moscow,5107,1,11,7,2,30,12,18,40
Spart Moscow,5107,2,10,6,4,39,26,13,36
CSKA Moscow,5107,3,11,3,6,29,21,8,36
Zenit,5107,4,7,9,4,22,15,7,30
Krasnodar,5107,5,8,5,7,28,26,2,29
Terek Grozny,5107,6,7,6,7,22,25,-3,27
FK Rubin,5107,7,6,6,8,23,18,5,24
Din Moscow,5107,8,5,7,8,18,25,-7,22
Amkar,5107,9,5,5,10,12,24,-12,20
Rostov,5107,10,4,6,10,10,19,-9,18
Anzhi,5107,11,3,6,11,18,40,-22,15
Loko Moscow,5108,1,13,5,2,34,12,22,44
CSKA Moscow,5108,2,10,3,7,25,22,3,33
Zenit,5108,3,8,8,4,24,15,9,32
Spart Moscow,5108,4,9,5,6,35,28,7,32
Krasnodar,5108,5,8,5,7,29,28,1,29
Terek Grozny,5108,6,7,7,6,22,24,-2,28
FK Rubin,5108,7,5,7,8,24,20,4,22
Din Moscow,5108,8,5,7,8,20,25,-5,22
Rostov,5108,9,5,6,9,11,17,-6,21
Amkar,5108,10,5,5,10,10,22,-12,20
Anzhi,5108,11,3,6,11,18,39,-21,15
Loko Moscow,5109,1,12,5,3,33,14,19,41
Spart Moscow,5109,2,11,5,4,39,28,11,38
CSKA Moscow,5109,3,10,4,6,27,20,7,34
Krasnodar,5109,4,10,4,6,32,27,5,34
Zenit,5109,5,7,9,4,22,16,6,30
Terek Grozny,5109,6,8,6,6,21,22,-1,30
FK Rubin,5109,7,6,5,9,23,19,4,23
Din Moscow,5109,8,5,6,9,18,24,-6,21
Rostov,5109,9,4,6,10,11,19,-8,18
Amkar,5109,10,4,5,11,10,24,-14,17
Anzhi,5109,11,3,5,12,16,39,-23,14
Loko Moscow,5110,1,11,7,2,30,12,18,40
CSKA Moscow,5110,2,11,4,5,31,19,12,37
Spart Moscow,5110,3,10,5,5,39,29,10,35
Zenit,5110,4,7,10,3,23,15,8,31
Krasnodar,5110,5,8,6,6,28,25,3,30
Terek Grozny,5110,6,7,7,6,20,22,-2,28
FK Rubin,5110,7,6,6,8,24,19,5,24
Din Moscow,5110,8,6,6,8,21,24,-3,24
Rostov,5110,9,4,6,10,10,20,-10,18
Amkar,5110,10,4,5,11,10,24,-14,17
Anzhi,5110,11,2,6,12,15,42,-27,12
Loko Moscow,5111,1,12,6,2,31,12,19,42
Spart Moscow,5111,2,10,6,4,35,25,10,36
CSKA Moscow,5111,3,11,3,6,28,20,8,36
Zenit,5111,4,8,9,3,25,15,10,33
Terek Grozny,5111,5,8,5,7,21,23,-2,29
Krasnodar,5111,6,8,4,8,27,27,0,28
Din Moscow,5111,7,6,6,8,18,22,-4,24
FK Rubin,5111,8,6,5,9,23,18,5,23
Amkar,5111,9,5,5,10,10,22,-12,20
Rostov,5111,10,4,6,10,10,18,-8,18
Anzhi,5111,11,2,5,13,14,40,-26,11
Loko Moscow,5112,1,11,6,3,30,13,17,39
CSKA Moscow,5112,2,10,5,5,27,19,8,35
Spart Moscow,5112,3,9,6,5,35,28,7,33
Krasnodar,5112,4,9,5,6,29,25,4,32
Zenit,5112,5,7,10,3,22,14,8,31
Terek Grozny,5112,6,8,5,7,22,24,-2,29
Din Moscow,5112,7,6,7,7,22,21,1,25
Amkar,5112,8,6,4,10,13,22,-9,22
FK Rubin,5112,9,5,6,9,21,22,-1,21
Rostov,5112,10,4,6,10,10,19,-9,18
Anzhi,5112,11,2,6,12,16,40,-24,12
Loko Moscow,5113,1,11,7,2,30,12,18,40
CSKA Moscow,5113,2,11,3,6,27,20,7,36
Spart Moscow,5113,3,9,7,4,38,28,10,34
Zenit,5113,4,8,9,3,24,13,11,33
Krasnodar,5113,5,8,5,7,29,27,2,29
Terek Grozny,5113,6,7,5,8,21,26,-5,26
Din Moscow,5113,7,6,7,7,21,24,-3,25
FK Rubin,5113,8,6,5,9,23,19,4,23
Rostov,5113,9,4,7,9,10,17,-7,19
Amkar,5113,10,5,4,11,11,24,-13,19
Anzhi,5113,11,3,5,12,16,40,-24,14
Loko Moscow,5114,1,11,6,3,31,14,17,39
CSKA Moscow,5114,2,11,3,6,28,18,10,36
Spart Moscow,5114,3,9,6,5,36,27,9,33
Zenit,5114,4,8,9,3,23,14,9,33
Krasnodar,5114,5,9,5,6,30,26,4,32
Terek Grozny,5114,6,7,6,7,21,25,-4,27
Din Moscow,5114,7,6,7,7,20,23,-3,25
FK Rubin,5114,8,5,6,9,23,20,3,21
Amkar,5114,9,5,5,10,11,23,-12,20
Rostov,5114,10,4,6,10,10,19,-9,18
Anzhi,5114,11,3,5,12,16,40,-24,14
Loko Moscow,5115,1,11,7,2,31,13,18,40
CSKA Moscow,5115,2,10,4,6,26,20,6,34
Zenit,5115,3,8,9,3,25,15,10,33
Spart Moscow,5115,4,9,6,5,38,29,9,33
Terek Grozny,5115,5,8,6,6,22,23,-1,30
Krasnodar,5115,6,8,5,7,28,26,2,29
Din Moscow,5115,7,6,7,7,20,23,-3,25
FK Rubin,5115,8,6,5,9,23,19,4,23
Rostov,5115,9,5,6,9,12,18,-6,21
Amkar,5115,10,4,4,12,10,26,-16,16
Anzhi,5115,11,2,7,11,15,38,-23,13
Loko Moscow,5116,1,12,6,2,32,13,19,42
Spart Moscow,5116,2,10,6,4,38,26,12,36
CSKA Moscow,5116,3,10,4,6,27,21,6,34
Zenit,5116,4,8,8,4,24,15,9,32
Krasnodar,5116,5,8,5,7,30,28,2,29
Terek Grozny,5116,6,7,6,7,23,26,-3,27
FK Rubin,5116,7,7,5,8,28,18,10,26
Din Moscow,5116,8,5,6,9,17,29,-12,21
Amkar,5116,9,5,5,10,11,23,-12,20
Rostov,5116,10,4,6,10,11,19,-8,18
Anzhi,5116,11,2,7,11,17,40,-23,13
Loko Moscow,5117,1,12,6,2,33,14,19,42
CSKA Moscow,5117,2,11,4,5,28,19,9,37
Spart Moscow,5117,3,9,6,5,37,31,6,33
Zenit,5117,4,7,10,3,24,16,8,31
Terek Grozny,5117,5,8,5,7,22,25,-3,29
Krasnodar,5117,6,8,4,8,30,29,1,28
FK Rubin,5117,7,7,5,8,25,19,6,26
Din Moscow,5117,8,5,6,9,18,25,-7,21
Rostov,5117,9,4,7,9,11,18,-7,19
Amkar,5117,10,5,4,11,13,23,-10,19
Anzhi,5117,11,3,5,12,18,40,-22,14
Loko Moscow,5118,1,11,5,4,30,16,14,38
CSKA Moscow,5118,2,11,3,6,28,19,9,36
Zenit,5118,3,9,8,3,25,15,10,35
Spart Moscow,5118,4,9,6,5,38,28,10,33
Krasnodar,5118,5,9,5,6,31,25,6,32
Terek Grozny,5118,6,7,6,7,21,24,-3,27
FK Rubin,5118,7,6,6,8,23,18,5,24
Amkar,5118,8,6,4,10,12,23,-11,22
Din Moscow,5118,9,5,6,9,18,26,-8,21
Rostov,5118,10,4,7,9,11,18,-7,19
Anzhi,5118,11,2,6,12,14,39,-25,12
Loko Moscow,5119,1,12,5,3,30,14,16,41
CSKA Moscow,5119,2,11,4,5,30,18,12,37
Spart Moscow,5119,3,10,5,5,42,28,14,35
Zenit,5119,4,8,9,3,25,14,11,33
Terek Grozny,5119,5,8,6,6,22,23,-1,30
Krasnodar,5119,6,8,5,7,28,26,2,29
FK Rubin,5119,7,6,6,8,24,19,5,24
Din Moscow,5119,8,5,6,9,18,27,-9,21
Amkar,5119,9,5,5,10,13,25,-12,20
Rostov,5119,10,4,6,10,10,20,-10,18
Anzhi,5119,11,2,5,13,14,42,-28,11
Loko Moscow,5120,1,11,7,2,30,12,18,40
Spart Moscow,5120,2,10,6,4,38,28,10,36
CSKA Moscow,5120,3,11,3,6,29,21,8,36
Zenit,5120,4,8,9,3,25,14,11,33
Krasnodar,5120,5,9,5,6,29,24,5,32
Terek Grozny,5120,6,8,5,7,23,25,-2,29
Din Moscow,5120,7,6,7,7,22,23,-1,25
FK Rubin,5120,8,5,5,10,21,22,-1,20
Amkar,5120,9,5,4,11,12,24,-12,19
Rostov,5120,10,4,6,10,11,19,-8,18
Anzhi,5120,11,2,5,13,15,43,-28,11
Loko Moscow,5121,1,12,5,3,32,15,17,41
CSKA Moscow,5121,2,12,3,5,29,17,12,39
Zenit,5121,3,8,8,4,24,16,8,32
Spart Moscow,5121,4,9,5,6,37,30,7,32
Krasnodar,5121,5,9,4,7,31,28,3,31
Terek Grozny,5121,6,8,6,6,24,24,0,30
Din Moscow,5121,7,7,6,7,21,22,-1,27
FK Rubin,5121,8,5,5,10,23,22,1,20
Amkar,5121,9,5,5,10,12,24,-12,20
Rostov,5121,10,4,6,10,11,19,-8,18
Anzhi,5121,11,2,5,13,15,42,-27,11
Loko Moscow,5122,1,12,5,3,31,14,17,41
CSKA Moscow,5122,2,11,4,5,28,18,10,37
Spart Moscow,5122,3,10,6,4,38,28,10,36
Zenit,5122,4,8,9,3,24,14,10,33
Terek Grozny,5122,5,8,6,6,24,23,1,30
Krasnodar,5122,6,8,4,8,28,28,0,28
FK Rubin,5122,7,6,6,8,23,17,6,24
Din Moscow,5122,8,5,7,8,17,22,-5,22
Rostov,5122,9,4,6,10,13,21,-8,18
Amkar,5122,10,4,6,10,9,22,-13,18
Anzhi,5122,11,2,5,13,15,43,-28,11
Loko Moscow,5123,1,12,6,2,30,11,19,42
Spart Moscow,5123,2,10,6,4,39,27,12,36
CSKA Moscow,5123,3,10,5,5,28,20,8,35
Terek Grozny,5123,4,9,5,6,23,23,0,32
Zenit,5123,5,7,10,3,23,15,8,31
Krasnodar,5123,6,8,5,7,28,26,2,29
FK Rubin,5123,7,6,6,8,23,18,5,24
Din Moscow,5123,8,5,6,9,17,24,-7,21
Rostov,5123,9,4,6,10,10,19,-9,18
Amkar,5123,10,4,5,11,11,25,-14,17
Anzhi,5123,11,2,6,12,16,40,-24,12
Loko Moscow,5124,1,12,6,2,30,11,19,42
Spart Moscow,5124,2,10,6,4,38,28,10,36
Zenit,5124,3,8,9,3,24,13,11,33
CSKA Moscow,5124,4,10,3,7,26,22,4,33
Krasnodar,5124,5,8,5,7,29,27,2,29
Terek Grozny,5124,6,8,5,7,22,24,-2,29
FK Rubin,5124,7,6,6,8,25,20,5,24
Din Moscow,5124,8,5,7,8,18,23,-5,22
Rostov,5124,9,4,6,10,12,20,-8,18
Anzhi,5124,10,4,5,11,18,39,-21,17
Amkar,5124,11,4,4,12,10,25,-15,16
Loko Moscow,5125,1,12,5,3,33,17,16,41
CSKA Moscow,5125,2,11,4,5,28,19,9,37
Spart Moscow,5125,3,9,7,4,40,29,11,34
Krasnodar,5125,4,9,4,7,32,29,3,31
Zenit,5125,5,7,9,4,24,17,7,30
Terek Grozny,5125,6,8,5,7,23,25,-2,29
Din Moscow,5125,7,6,7,7,19,22,-3,25
FK Rubin,5125,8,6,5,9,25,19,6,23
Amkar,5125,9,5,5,10,13,25,-12,20
Rostov,5125,10,4,6,10,11,21,-10,18
Anzhi,5125,11,2,5,13,16,41,-25,11
Loko Moscow,5126,1,11,6,3,31,15,16,39
Spart Moscow,5126,2,11,5,4,42,28,14,38
CSKA Moscow,5126,3,11,4,5,29,18,11,37
Zenit,5126,4,7,10,3,23,15,8,31
Krasnodar,5126,5,9,4,7,31,29,2,31
Terek Grozny,5126,6,7,6,7,23,26,-3,27
FK Rubin,5126,7,7,5,8,26,18,8,26
Din Moscow,5126,8,5,6,9,19,25,-6,21
Rostov,5126,9,4,6,10,11,20,-9,18
Amkar,5126,10,4,5,11,10,26,-16,17
Anzhi,5126,11,3,5,12,17,42,-25,14
Loko Moscow,5127,1,11,7,2,30,12,18,40
CSKA Moscow,5127,2,11,3,6,29,22,7,36
Spart Moscow,5127,3,9,7,4,39,29,10,34
Zenit,5127,4,8,9,3,24,13,11,33
Krasnodar,5127,5,9,5,6,29,25,4,32
Terek Grozny,5127,6,7,5,8,21,26,-5,26
Din Moscow,5127,7,5,8,7,21,25,-4,23
FK Rubin,5127,8,5,6,9,23,20,3,21
Amkar,5127,9,5,5,10,12,23,-11,20
Rostov,5127,10,4,6,10,11,20,-9,18
Anzhi,5127,11,3,5,12,18,42,-24,14
Loko Moscow,5128,1,11,7,2,30,12,18,40
CSKA Moscow,5128,2,11,4,5,29,20,9,37
Spart Moscow,5128,3,10,6,4,35,25,10,36
Zenit,5128,4,7,10,3,23,15,8,31
Krasnodar,5128,5,8,6,6,27,24,3,30
Terek Grozny,5128,6,7,6,7,21,24,-3,27
FK Rubin,5128,7,6,6,8,23,17,6,24
Din Moscow,5128,8,5,7,8,17,23,-6,22
Rostov,5128,9,4,6,10,10,18,-8,18
Amkar,5128,10,4,5,11,10,24,-14,17
Anzhi,5128,11,3,5,12,17,40,-23,14
Loko Moscow,5129,1,13,5,2,36,13,23,44
CSKA Moscow,5129,2,11,4,5,28,19,9,37
Spart Moscow,5129,3,9,6,5,37,30,7,33
Terek Grozny,5129,4,9,5,6,24,22,2,32
Zenit,5129,5,7,8,5,22,18,4,29
Krasnodar,5129,6,8,5,7,30,29,1,29
Din Moscow,5129,7,6,7,7,21,22,-1,25
FK Rubin,5129,8,5,6,9,22,21,1,21
Amkar,5129,9,5,4,11,13,25,-12,19
Rostov,5129,10,4,6,10,10,20,-10,18
Anzhi,5129,11,2,6,12,15,39,-24,12
Loko Moscow,5130,1,11,6,3,30,13,17,39
CSKA Moscow,5130,2,11,4,5,30,19,11,37
Spart Moscow,5130,3,9,7,4,39,30,9,34
Krasnodar,5130,4,9,5,6,30,26,4,32
Zenit,5130,5,7,10,3,22,14,8,31
Terek Grozny,5130,6,7,5,8,20,24,-4,26
Din Moscow,5130,7,6,7,7,21,24,-3,25
FK Rubin,5130,8,5,6,9,23,20,3,21
Amkar,5130,9,5,5,10,12,24,-12,20
Rostov,5130,10,4,6,10,11,19,-8,18
Anzhi,5130,11,3,5,12,16,41,-25,14
Loko Moscow,5131,1,12,6,2,32,13,19,42
Spart Moscow,5131,2,11,5,4,43,27,16,38
CSKA Moscow,5131,3,11,3,6,29,21,8,36
Zenit,5131,4,8,8,4,23,15,8,32
Krasnodar,5131,5,9,5,6,31,27,4,32
Terek Grozny,5131,6,8,5,7,22,24,-2,29
Din Moscow,5131,7,5,7,8,17,23,-6,22
FK Rubin,5131,8,5,6,9,22,19,3,21
Amkar,5131,9,5,4,11,11,24,-13,19
Rostov,5131,10,4,6,10,11,23,-12,18
Anzhi,5131,11,2,5,13,17,42,-25,11
Loko Moscow,5132,1,12,5,3,32,14,18,41
CSKA Moscow,5132,2,12,3,5,30,19,11,39
Spart Moscow,5132,3,10,6,4,37,26,11,36
Zenit,5132,4,8,8,4,24,16,8,32
Terek Grozny,5132,5,9,5,6,24,22,2,32
Krasnodar,5132,6,8,5,7,28,26,2,29
Din Moscow,5132,7,6,6,8,19,24,-5,24
FK Rubin,5132,8,5,6,9,22,19,3,21
Rostov,5132,9,4,7,9,10,17,-7,19
Amkar,5132,10,4,4,12,9,26,-17,16
Anzhi,5132,11,2,5,13,16,42,-26,11
Loko Moscow,5133,1,11,6,3,30,13,17,39
CSKA Moscow,5133,2,11,4,5,29,20,9,37
Zenit,5133,3,8,8,4,24,16,8,32
Krasnodar,5133,4,9,5,6,30,24,6,32
Terek Grozny,5133,5,9,5,6,25,23,2,32
Spart Moscow,5133,6,8,6,6,39,33,6,30
Din Moscow,5133,7,5,8,7,21,25,-4,23
FK Rubin,5133,8,5,6,9,23,22,1,21
Rostov,5133,9,5,6,9,13,19,-6,21
Amkar,5133,10,5,4,11,12,25,-13,19
Anzhi,5133,11,2,6,12,17,43,-26,12
Loko Moscow,5134,1,11,6,3,30,15,15,39
CSKA Moscow,5134,2,11,3,6,29,19,10,36
Spart Moscow,5134,3,9,6,5,35,26,9,33
Zenit,5134,4,8,9,3,23,14,9,33
Krasnodar,5134,5,9,5,6,32,26,6,32
Terek Grozny,5134,6,9,5,6,23,22,1,32
Din Moscow,5134,7,6,6,8,18,23,-5,24
FK Rubin,5134,8,5,6,9,22,19,3,21
Rostov,5134,9,5,6,9,11,17,-6,21
Amkar,5134,10,4,5,11,9,23,-14,17
Anzhi,5134,11,2,5,13,14,42,-28,11
Loko Moscow,5135,1,11,7,2,32,14,18,40
CSKA Moscow,5135,2,12,3,5,32,18,14,39
Spart Moscow,5135,3,9,6,5,40,29,11,33
Krasnodar,5135,4,9,5,6,30,26,4,32
Zenit,5135,5,7,9,4,23,16,7,30
Terek Grozny,5135,6,7,5,8,21,25,-4,26
Din Moscow,5135,7,6,7,7,19,22,-3,25
FK Rubin,5135,8,5,6,9,21,18,3,21
Amkar,5135,9,5,5,10,11,23,-12,20
Rostov,5135,10,4,6,10,11,22,-11,18
Anzhi,5135,11,3,5,12,16,43,-27,14
Loko Moscow,5136,1,12,6,2,31,12,19,42
Spart Moscow,5136,2,10,6,4,36,25,11,36
Zenit,5136,3,8,9,3,24,14,10,33
CSKA Moscow,5136,4,10,3,7,27,22,5,33
Krasnodar,5136,5,9,4,7,29,25,4,31
Terek Grozny,5136,6,8,5,7,22,24,-2,29
Din Moscow,5136,7,5,8,7,17,21,-4,23
FK Rubin,5136,8,5,6,9,21,19,2,21
Amkar,5136,9,5,4,11,10,23,-13,19
Rostov,5136,10,4,6,10,10,19,-9,18
Anzhi,5136,11,3,5,12,18,41,-23,14
Loko Moscow,5137,1,13,5,2,33,13,20,44
CSKA Moscow,5137,2,12,3,5,30,18,12,39
Spart Moscow,5137,3,9,6,5,35,28,7,33
Zenit,5137,4,7,8,5,22,16,6,29
Krasnodar,5137,5,8,4,8,29,28,1,28
Terek Grozny,5137,6,7,5,8,20,24,-4,26
Din Moscow,5137,7,6,7,7,20,22,-2,25
FK Rubin,5137,8,6,6,8,24,19,5,24
Amkar,5137,9,5,5,10,11,23,-12,20
Rostov,5137,10,4,6,10,10,18,-8,18
Anzhi,5137,11,3,5,12,16,41,-25,14
Loko Moscow,5138,1,11,7,2,30,12,18,40
Spart Moscow,5138,2,10,5,5,37,27,10,35
Zenit,5138,3,8,9,3,23,13,10,33
CSKA Moscow,5138,4,10,3,7,25,20,5,33
Krasnodar,5138,5,9,5,6,31,25,6,32
Terek Grozny,5138,6,7,7,6,22,24,-2,28
Din Moscow,5138,7,6,6,8,20,25,-5,24
FK Rubin,5138,8,5,5,10,22,22,0,20
Amkar,5138,9,5,5,10,11,23,-12,20
Rostov,5138,10,4,6,10,10,18,-8,18
Anzhi,5138,11,3,6,11,16,38,-22,15
Loko Moscow,5139,1,11,6,3,29,12,17,39
Spart Moscow,5139,2,10,6,4,37,27,10,36
CSKA Moscow,5139,3,11,3,6,27,19,8,36
Zenit,5139,4,8,9,3,23,14,9,33
Krasnodar,5139,5,9,5,6,30,26,4,32
Terek Grozny,5139,6,8,5,7,23,24,-1,29
FK Rubin,5139,7,6,6,8,26,19,7,24
Din Moscow,5139,8,5,7,8,18,25,-7,22
Amkar,5139,9,5,4,11,11,24,-13,19
Rostov,5139,10,4,6,10,10,18,-8,18
Anzhi,5139,11,2,5,13,15,41,-26,11
Loko Moscow,5140,1,11,7,2,29,11,18,40
CSKA Moscow,5140,2,11,3,6,27,18,9,36
Zenit,5140,3,8,9,3,22,13,9,33
Terek Grozny,5140,4,9,5,6,25,23,2,32
Spart Moscow,5140,5,8,6,6,35,29,6,30
Krasnodar,5140,6,8,6,6,28,25,3,30
Din Moscow,5140,7,7,6,7,20,22,-2,27
FK Rubin,5140,8,5,6,9,23,20,3,21
Rostov,5140,9,5,6,9,11,17,-6,21
Amkar,5140,10,4,5,11,12,27,-15,17
Anzhi,5140,11,2,5,13,14,41,-27,11
Loko Moscow,5141,1,13,5,2,33,12,21,44
CSKA Moscow,5141,2,11,3,6,29,20,9,36
Spart Moscow,5141,3,8,7,5,36,31,5,31
Terek Grozny,5141,4,8,6,6,23,22,1,30
Zenit,5141,5,7,8,5,21,17,4,29
Krasnodar,5141,6,8,4,8,29,29,0,28
Din Moscow,5141,7,6,7,7,21,22,-1,25
FK Rubin,5141,8,6,6,8,24,19,5,24
Rostov,5141,9,4,7,9,12,19,-7,19
Amkar,5141,10,4,6,10,10,23,-13,18
Anzhi,5141,11,3,5,12,17,41,-24,14
Loko Moscow,5142,1,11,7,2,31,13,18,40
CSKA Moscow,5142,2,11,3,6,27,21,6,36
Spart Moscow,5142,3,10,5,5,36,26,10,35
Zenit,5142,4,8,9,3,26,14,12,33
Krasnodar,5142,5,9,5,6,29,25,4,32
Terek Grozny,5142,6,8,5,7,22,23,-1,29
Din Moscow,5142,7,5,7,8,18,24,-6,22
FK Rubin,5142,8,5,6,9,22,19,3,21
Amkar,5142,9,5,4,11,10,24,-14,19
Rostov,5142,10,4,6,10,10,18,-8,18
Anzhi,5142,11,3,5,12,15,39,-24,14
Loko Moscow,5143,1,12,5,3,32,16,16,41
Spart Moscow,5143,2,10,6,4,37,26,11,36
CSKA Moscow,5143,3,11,3,6,27,20,7,36
Zenit,5143,4,8,8,4,24,14,10,32
Terek Grozny,5143,5,8,5,7,24,26,-2,29
Krasnodar,5143,6,8,4,8,29,29,0,28
FK Rubin,5143,7,6,6,8,24,18,6,24
Din Moscow,5143,8,5,7,8,19,25,-6,22
Amkar,5143,9,5,5,10,11,23,-12,20
Rostov,5143,10,4,6,10,10,18,-8,18
Anzhi,5143,11,3,5,12,19,41,-22,14
Loko Moscow,5144,1,12,6,2,33,13,20,42
Spart Moscow,5144,2,11,5,4,39,26,13,38
CSKA Moscow,5144,3,11,3,6,28,19,9,36
Zenit,5144,4,8,8,4,24,17,7,32
Terek Grozny,5144,5,8,6,6,23,24,-1,30
Krasnodar,5144,6,8,5,7,29,28,1,29
FK Rubin,5144,7,6,6,8,25,19,6,24
Din Moscow,5144,8,5,7,8,19,25,-6,22
Rostov,5144,9,4,6,10,10,18,-8,18
Amkar,5144,10,4,5,11,10,25,-15,17
Anzhi,5144,11,2,5,13,15,41,-26,11
Loko Moscow,5145,1,12,5,3,30,13,17,41
CSKA Moscow,5145,2,12,3,5,29,19,10,39
Spart Moscow,5145,3,9,7,4,37,27,10,34
Zenit,5145,4,8,8,4,25,16,9,32
Krasnodar,5145,5,9,4,7,28,25,3,31
Terek Grozny,5145,6,8,5,7,22,25,-3,29
Din Moscow,5145,7,5,7,8,19,25,-6,22
FK Rubin,5145,8,5,6,9,23,20,3,21
Amkar,5145,9,5,5,10,13,24,-11,20
Rostov,5145,10,4,7,9,11,18,-7,19
Anzhi,5145,11,2,5,13,14,39,-25,11
Loko Moscow,5146,1,12,6,2,32,13,19,42
CSKA Moscow,5146,2,10,4,6,27,20,7,34
Zenit,5146,3,8,8,4,23,15,8,32
Spart Moscow,5146,4,9,5,6,37,31,6,32
Krasnodar,5146,5,9,5,6,29,25,4,32
Terek Grozny,5146,6,8,5,7,21,24,-3,29
Din Moscow,5146,7,6,6,8,20,22,-2,24
FK Rubin,5146,8,6,5,9,22,18,4,23
Amkar,5146,9,6,4,10,13,22,-9,22
Rostov,5146,10,4,6,10,11,21,-10,18
Anzhi,5146,11,2,6,12,16,40,-24,12
Loko Moscow,5147,1,11,7,2,31,13,18,40
Spart Moscow,5147,2,10,5,5,36,27,9,35
CSKA Moscow,5147,3,10,5,5,27,19,8,35
Zenit,5147,4,7,10,3,23,15,8,31
Krasnodar,5147,5,8,6,6,29,26,3,30
Terek Grozny,5147,6,8,5,7,21,26,-5,29
Din Moscow,5147,7,7,6,7,19,21,-2,27
FK Rubin,5147,8,5,6,9,23,20,3,21
Amkar,5147,9,5,4,11,14,24,-10,19
Rostov,5147,10,4,6,10,10,18,-8,18
Anzhi,5147,11,2,6,12,16,40,-24,12
Loko Moscow,5148,1,11,6,3,31,15,16,39
CSKA Moscow,5148,2,12,3,5,32,18,14,39
Spart Moscow,5148,3,11,5,4,39,27,12,38
Zenit,5148,4,8,8,4,24,17,7,32
Krasnodar,5148,5,8,5,7,29,28,1,29
Terek Grozny,5148,6,8,5,7,23,24,-1,29
Din Moscow,5148,7,6,6,8,21,25,-4,24
FK Rubin,5148,8,6,5,9,25,20,5,23
Rostov,5148,9,4,6,10,10,19,-9,18
Amkar,5148,10,4,4,12,9,25,-16,16
Anzhi,5148,11,3,5,12,17,42,-25,14
Loko Moscow,5149,1,11,6,3,29,14,15,39
Spart Moscow,5149,2,11,5,4,37,25,12,38
CSKA Moscow,5149,3,11,3,6,27,20,7,36
Krasnodar,5149,4,10,4,6,31,24,7,34
Zenit,5149,5,8,9,3,24,13,11,33
Terek Grozny,5149,6,7,6,7,20,23,-3,27
Din Moscow,5149,7,6,6,8,19,22,-3,24
FK Rubin,5149,8,5,5,10,21,20,1,20
Rostov,5149,9,4,6,10,10,18,-8,18
Amkar,5149,10,4,5,11,9,24,-15,17
Anzhi,5149,11,3,5,12,15,39,-24,14
Loko Moscow,5150,1,12,6,2,32,13,19,42
CSKA Moscow,5150,2,12,3,5,32,19,13,39
Krasnodar,5150,3,9,5,6,34,27,7,32
Spart Moscow,5150,4,9,5,6,34,28,6,32
Terek Grozny,5150,5,8,6,6,24,25,-1,30
Zenit,5150,6,7,8,5,23,19,4,29
Din Moscow,5150,7,6,6,8,20,22,-2,24
Rostov,5150,8,5,6,9,12,17,-5,21
FK Rubin,5150,9,5,5,10,22,25,-3,20
Amkar,5150,10,5,4,11,11,24,-13,19
Anzhi,5150,11,2,6,12,16,41,-25,12
Loko Moscow,5151,1,11,6,3,29,14,15,39
Spart Moscow,5151,2,10,6,4,37,26,11,36
Krasnodar,5151,3,10,4,6,32,25,7,34
Zenit,5151,4,8,9,3,23,13,10,33
CSKA Moscow,5151,5,10,3,7,26,21,5,33
Terek Grozny,5151,6,7,6,7,23,27,-4,27
FK Rubin,5151,7,6,5,9,24,20,4,23
Din Moscow,5151,8,5,6,9,18,24,-6,21
Rostov,5151,9,4,7,9,10,17,-7,19
Amkar,5151,10,5,4,11,13,26,-13,19
Anzhi,5151,11,3,6,11,18,40,-22,15
Loko Moscow,5152,1,12,6,2,32,13,19,42
CSKA Moscow,5152,2,11,3,6,27,18,9,36
Spart Moscow,5152,3,9,7,4,35,26,9,34
Krasnodar,5152,4,9,5,6,31,27,4,32
Terek Grozny,5152,5,8,6,6,24,24,0,30
Zenit,5152,6,7,8,5,21,16,5,29
FK Rubin,5152,7,6,5,9,23,19,4,23
Din Moscow,5152,8,5,7,8,17,22,-5,22
Rostov,5152,9,4,6,10,11,19,-8,18
Amkar,5152,10,4,6,10,10,23,-13,18
Anzhi,5152,11,3,5,12,16,40,-24,14
Loko Moscow,5153,1,11,7,2,30,12,18,40
CSKA Moscow,5153,2,10,5,5,27,19,8,35
Spart Moscow,5153,3,9,6,5,36,30,6,33
Terek Grozny,5153,4,9,5,6,23,23,0,32
Zenit,5153,5,7,10,3,21,13,8,31
Krasnodar,5153,6,8,5,7,29,28,1,29
FK Rubin,5153,7,6,6,8,25,19,6,24
Din Moscow,5153,8,5,8,7,20,24,-4,23
Amkar,5153,9,5,4,11,13,24,-11,19
Rostov,5153,10,4,6,10,10,18,-8,18
Anzhi,5153,11,2,6,12,16,40,-24,12
Loko Moscow,5154,1,11,5,4,29,14,15,38
Spart Moscow,5154,2,10,6,4,44,31,13,36
CSKA Moscow,5154,3,11,3,6,31,20,11,36
Zenit,5154,4,9,8,3,23,13,10,35
Krasnodar,5154,5,9,5,6,30,25,5,32
Terek Grozny,5154,6,8,6,6,22,23,-1,30
FK Rubin,5154,7,6,6,8,24,19,5,24
Din Moscow,5154,8,5,6,9,21,27,-6,21
Rostov,5154,9,4,6,10,11,22,-11,18
Amkar,5154,10,4,6,10,11,24,-13,18
Anzhi,5154,11,2,5,13,17,45,-28,11
Loko Moscow,5155,1,12,6,2,33,13,20,42
Spart Moscow,5155,2,9,7,4,39,28,11,34
CSKA Moscow,5155,3,10,4,6,26,19,7,34
Terek Grozny,5155,4,9,5,6,28,25,3,32
Zenit,5155,5,7,10,3,22,14,8,31
Krasnodar,5155,6,8,5,7,32,31,1,29
Din Moscow,5155,7,5,8,7,19,23,-4,23
FK Rubin,5155,8,5,7,8,25,21,4,22
Rostov,5155,9,4,6,10,11,21,-10,18
Amkar,5155,10,4,5,11,10,26,-16,17
Anzhi,5155,11,3,5,12,18,42,-24,14
Loko Moscow,5156,1,12,6,2,31,12,19,42
CSKA Moscow,5156,2,12,3,5,31,18,13,39
Spart Moscow,5156,3,9,6,5,38,30,8,33
Krasnodar,5156,4,9,4,7,30,27,3,31
Zenit,5156,5,7,9,4,22,15,7,30
Terek Grozny,5156,6,7,5,8,20,26,-6,26
Din Moscow,5156,7,6,6,8,21,27,-6,24
FK Rubin,5156,8,6,5,9,26,19,7,23
Amkar,5156,9,5,5,10,12,22,-10,20
Rostov,5156,10,4,6,10,11,20,-9,18
Anzhi,5156,11,3,5,12,15,41,-26,14
Loko Moscow,5157,1,11,7,2,31,13,18,40
Spart Moscow,5157,2,11,5,4,39,27,12,38
Zenit,5157,3,8,9,3,23,13,10,33
CSKA Moscow,5157,4,10,3,7,26,21,5,33
Krasnodar,5157,5,8,5,7,29,27,2,29
Terek Grozny,5157,6,8,5,7,23,26,-3,29
FK Rubin,5157,7,6,6,8,23,18,5,24
Din Moscow,5157,8,5,7,8,19,25,-6,22
Amkar,5157,9,5,4,11,14,25,-11,19
Rostov,5157,10,4,6,10,10,18,-8,18
Anzhi,5157,11,3,5,12,16,40,-24,14
Loko Moscow,5158,1,13,5,2,36,11,25,44
CSKA Moscow,5158,2,11,3,6,27,18,9,36
Spart Moscow,5158,3,9,7,4,36,27,9,34
Zenit,5158,4,8,8,4,22,16,6,32
Krasnodar,5158,5,8,5,7,29,30,-1,29
Terek Grozny,5158,6,7,7,6,22,24,-2,28
FK Rubin,5158,7,5,7,8,24,20,4,22
Din Moscow,5158,8,5,7,8,19,24,-5,22
Rostov,5158,9,4,7,9,10,17,-7,19
Amkar,5158,10,4,6,10,11,24,-13,18
Anzhi,5158,11,2,6,12,15,40,-25,12
Loko Moscow,5159,1,12,6,2,31,12,19,42
CSKA Moscow,5159,2,11,4,5,28,18,10,37
Spart Moscow,5159,3,10,6,4,38,26,12,36
Krasnodar,5159,4,9,5,6,33,26,7,32
Zenit,5159,5,7,9,4,22,15,7,30
Terek Grozny,5159,6,8,5,7,21,23,-2,29
Din Moscow,5159,7,6,7,7,18,21,-3,25
FK Rubin,5159,8,5,5,10,22,23,-1,20
Amkar,5159,9,5,4,11,10,24,-14,19
Rostov,5159,10,4,6,10,11,20,-9,18
Anzhi,5159,11,2,5,13,14,40,-26,11
CSKA Moscow,5160,1,12,3,5,31,19,12,39
Loko Moscow,5160,2,11,5,4,29,13,16,38
Spart Moscow,5160,3,9,6,5,37,28,9,33
Zenit,5160,4,8,8,4,24,16,8,32
Krasnodar,5160,5,9,5,6,29,25,4,32
Terek Grozny,5160,6,9,5,6,25,25,0,32
FK Rubin,5160,7,6,6,8,23,18,5,24
Din Moscow,5160,8,5,7,8,18,23,-5,22
Rostov,5160,9,5,6,9,12,18,-6,21
Amkar,5160,10,4,4,12,10,26,-16,16
Anzhi,5160,11,2,5,13,16,43,-27,11
Loko Moscow,5161,1,12,5,3,33,17,16,41
CSKA Moscow,5161,2,11,4,5,28,19,9,37
Krasnodar,5161,3,10,4,6,34,26,8,34
Spart Moscow,5161,4,9,5,6,35,28,7,32
Zenit,5161,5,7,9,4,24,17,7,30
Terek Grozny,5161,6,8,6,6,25,23,2,30
Din Moscow,5161,7,7,6,7,20,22,-2,27
FK Rubin,5161,8,5,5,10,22,21,1,20
Amkar,5161,9,5,4,11,11,27,-16,19
Rostov,5161,10,4,6,10,11,19,-8,18
Anzhi,5161,11,2,6,12,14,38,-24,12
Loko Moscow,5162,1,13,5,2,32,11,21,44
CSKA Moscow,5162,2,11,3,6,27,19,8,36
Zenit,5162,3,8,8,4,22,15,7,32
Krasnodar,5162,4,8,5,7,27,25,2,29
Spart Moscow,5162,5,8,5,7,35,35,0,29
Terek Grozny,5162,6,7,5,8,21,26,-5,26
FK Rubin,5162,7,6,6,8,24,19,5,24
Din Moscow,5162,8,6,6,8,21,24,-3,24
Amkar,5162,9,6,4,10,16,24,-8,22
Rostov,5162,10,5,6,9,12,17,-5,21
Anzhi,5162,11,3,5,12,18,40,-22,14
Loko Moscow,5163,1,11,6,3,29,13,16,39
CSKA Moscow,5163,2,11,4,5,27,18,9,37
Terek Grozny,5163,3,9,5,6,24,22,2,32
Zenit,5163,4,7,10,3,22,14,8,31
Krasnodar,5163,5,9,4,7,31,28,3,31
Spart Moscow,5163,6,8,6,6,34,29,5,30
Din Moscow,5163,7,6,7,7,21,23,-2,25
FK Rubin,5163,8,6,5,9,26,22,4,23
Rostov,5163,9,5,6,9,12,17,-5,21
Amkar,5163,10,5,4,11,10,24,-14,19
Anzhi,5163,11,2,5,13,14,40,-26,11
Loko Moscow,5164,1,12,5,3,34,16,18,41
CSKA Moscow,5164,2,11,3,6,27,19,8,36
Krasnodar,5164,3,10,4,6,31,24,7,34
Spart Moscow,5164,4,9,6,5,36,29,7,33
Zenit,5164,5,8,8,4,25,18,7,32
Terek Grozny,5164,6,8,5,7,22,24,-2,29
FK Rubin,5164,7,6,5,9,23,19,4,23
Din Moscow,5164,8,5,7,8,18,24,-6,22
Amkar,5164,9,6,4,10,14,23,-9,22
Rostov,5164,10,4,6,10,10,18,-8,18
Anzhi,5164,11,2,5,13,15,41,-26,11
Loko Moscow,5165,1,12,6,2,31,12,19,42
CSKA Moscow,5165,2,11,3,6,28,19,9,36
Spart Moscow,5165,3,9,7,4,36,27,9,34
Zenit,5165,4,8,9,3,22,13,9,33
Krasnodar,5165,5,9,4,7,29,26,3,31
Terek Grozny,5165,6,7,6,7,22,26,-4,27
FK Rubin,5165,7,6,5,9,22,18,4,23
Din Moscow,5165,8,5,7,8,18,23,-5,22
Rostov,5165,9,4,6,10,10,18,-8,18
Amkar,5165,10,4,6,10,12,25,-13,18
Anzhi,5165,11,3,5,12,17,40,-23,14
Loko Moscow,5166,1,12,5,3,32,12,20,41
CSKA Moscow,5166,2,12,3,5,31,17,14,39
Zenit,5166,3,8,8,4,22,17,5,32
Spart Moscow,5166,4,8,7,5,35,29,6,31
Terek Grozny,5166,5,8,5,7,22,24,-2,29
Krasnodar,5166,6,8,4,8,27,28,-1,28
FK Rubin,5166,7,7,5,8,24,18,6,26
Din Moscow,5166,8,5,7,8,19,24,-5,22
Rostov,5166,9,5,6,9,12,17,-5,21
Amkar,5166,10,5,5,10,11,23,-12,20
Anzhi,5166,11,2,5,13,15,41,-26,11
Loko Moscow,5167,1,12,6,2,33,13,20,42
CSKA Moscow,5167,2,12,3,5,29,18,11,39
Spart Moscow,5167,3,8,8,4,36,28,8,32
Krasnodar,5167,4,8,6,6,31,28,3,30
Terek Grozny,5167,5,8,6,6,22,23,-1,30
Zenit,5167,6,7,8,5,21,17,4,29
Din Moscow,5167,7,5,8,7,18,22,-4,23
FK Rubin,5167,8,5,7,8,23,19,4,22
Rostov,5167,9,4,7,9,10,17,-7,19
Amkar,5167,10,4,5,11,11,25,-14,17
Anzhi,5167,11,2,6,12,16,40,-24,12
Loko Moscow,5168,1,11,7,2,31,13,18,40
CSKA Moscow,5168,2,11,4,5,29,20,9,37
Spart Moscow,5168,3,9,5,6,37,30,7,32
Krasnodar,5168,4,9,5,6,30,26,4,32
Zenit,5168,5,7,9,4,22,15,7,30
Terek Grozny,5168,6,8,6,6,23,23,0,30
Din Moscow,5168,7,7,6,7,19,21,-2,27
FK Rubin,5168,8,5,5,10,21,19,2,20
Amkar,5168,9,5,5,10,14,25,-11,20
Rostov,5168,10,4,6,10,10,19,-9,18
Anzhi,5168,11,2,6,12,16,41,-25,12
Loko Moscow,5169,1,11,7,2,30,12,18,40
CSKA Moscow,5169,2,11,3,6,30,21,9,36
Zenit,5169,3,8,9,3,23,14,9,33
Krasnodar,5169,4,9,5,6,29,25,4,32
Spart Moscow,5169,5,8,6,6,35,30,5,30
Terek Grozny,5169,6,7,6,7,21,28,-7,27
Din Moscow,5169,7,5,8,7,17,21,-4,23
FK Rubin,5169,8,5,6,9,21,18,3,21
Rostov,5169,9,5,6,9,11,17,-6,21
Amkar,5169,10,5,5,10,14,25,-11,20
Anzhi,5169,11,3,5,12,21,41,-20,14
Loko Moscow,5170,1,12,5,3,32,16,16,41
CSKA Moscow,5170,2,11,3,6,33,20,13,36
Spart Moscow,5170,3,9,7,4,37,27,10,34
Krasnodar,5170,4,10,4,6,35,28,7,34
Zenit,5170,5,8,8,4,24,16,8,32
Terek Grozny,5170,6,8,5,7,22,24,-2,29
Din Moscow,5170,7,6,7,7,19,21,-2,25
FK Rubin,5170,8,5,5,10,24,23,1,20
Rostov,5170,9,4,7,9,12,19,-7,19
Amkar,5170,10,4,4,12,9,25,-16,16
Anzhi,5170,11,3,5,12,17,45,-28,14
Loko Moscow,5171,1,12,5,3,30,13,17,41
CSKA Moscow,5171,2,11,3,6,30,20,10,36
Zenit,5171,3,9,8,3,25,13,12,35
Spart Moscow,5171,4,9,6,5,37,29,8,33
Krasnodar,5171,5,8,4,8,28,27,1,28
Terek Grozny,5171,6,7,7,6,21,23,-2,28
Din Moscow,5171,7,6,7,7,22,25,-3,25
FK Rubin,5171,8,6,5,9,24,20,4,23
Amkar,5171,9,5,5,10,11,23,-12,20
Rostov,5171,10,4,6,10,10,18,-8,18
Anzhi,5171,11,2,6,12,15,42,-27,12
Loko Moscow,5172,1,12,5,3,31,13,18,41
CSKA Moscow,5172,2,11,4,5,27,18,9,37
Spart Moscow,5172,3,10,5,5,37,29,8,35
Krasnodar,5172,4,9,4,7,29,26,3,31
Zenit,5172,5,7,9,4,23,16,7,30
Terek Grozny,5172,6,8,5,7,23,24,-1,29
Din Moscow,5172,7,6,7,7,21,23,-2,25
FK Rubin,5172,8,6,6,8,24,19,5,24
Rostov,5172,9,4,6,10,10,18,-8,18
Amkar,5172,10,4,4,12,11,27,-16,16
Anzhi,5172,11,3,5,12,15,38,-23,14
Loko Moscow,5173,1,13,5,2,33,11,22,44
CSKA Moscow,5173,2,12,3,5,34,17,17,39
Spart Moscow,5173,3,10,6,4,36,25,11,36
Zenit,5173,4,7,8,5,21,18,3,29
Krasnodar,5173,5,8,5,7,27,27,0,29
Terek Grozny,5173,6,8,5,7,23,23,0,29
Din Moscow,5173,7,6,7,7,18,21,-3,25
FK Rubin,5173,8,5,6,9,21,18,3,21
Rostov,5173,9,4,6,10,10,19,-9,18
Amkar,5173,10,4,4,12,9,26,-17,16
Anzhi,5173,11,3,5,12,15,42,-27,14
Loko Moscow,5174,1,12,5,3,33,12,21,41
Spart Moscow,5174,2,11,5,4,39,25,14,38
CSKA Moscow,5174,3,10,4,6,25,18,7,34
Zenit,5174,4,8,8,4,22,17,5,32
Krasnodar,5174,5,9,5,6,28,24,4,32
Terek Grozny,5174,6,7,7,6,21,23,-2,28
Din Moscow,5174,7,6,6,8,18,25,-7,24
FK Rubin,5174,8,5,6,9,21,18,3,21
Rostov,5174,9,4,6,10,10,18,-8,18
Amkar,5174,10,4,5,11,10,24,-14,17
Anzhi,5174,11,2,7,11,14,37,-23,13
Loko Moscow,5175,1,11,7,2,30,12,18,40
CSKA Moscow,5175,2,11,4,5,30,18,12,37
Spart Moscow,5175,3,10,6,4,37,25,12,36
Krasnodar,5175,4,9,5,6,28,24,4,32
Zenit,5175,5,7,10,3,23,15,8,31
Terek Grozny,5175,6,7,6,7,21,24,-3,27
Din Moscow,5175,7,6,6,8,18,23,-5,24
FK Rubin,5175,8,5,5,10,21,19,2,20
Rostov,5175,9,4,6,10,10,19,-9,18
Amkar,5175,10,4,6,10,10,23,-13,18
Anzhi,5175,11,3,5,12,15,41,-26,14
Loko Moscow,5176,1,12,5,3,32,13,19,41
CSKA Moscow,5176,2,11,3,6,29,18,11,36
Krasnodar,5176,3,10,4,6,31,26,5,34
Spart Moscow,5176,4,9,6,5,36,28,8,33
Zenit,5176,5,8,8,4,22,15,7,32
Terek Grozny,5176,6,7,6,7,22,25,-3,27
Din Moscow,5176,7,6,6,8,19,23,-4,24
FK Rubin,5176,8,5,5,10,23,21,2,20
Amkar,5176,9,5,5,10,14,26,-12,20
Rostov,5176,10,4,7,9,10,17,-7,19
Anzhi,5176,11,3,5,12,15,41,-26,14
Loko Moscow,5177,1,11,5,4,29,15,14,38
CSKA Moscow,5177,2,11,3,6,27,20,7,36
Zenit,5177,3,9,8,3,27,14,13,35
Spart Moscow,5177,4,8,8,4,36,28,8,32
Krasnodar,5177,5,9,5,6,29,25,4,32
Terek Grozny,5177,6,8,5,7,23,25,-2,29
Din Moscow,5177,7,6,7,7,20,22,-2,25
FK Rubin,5177,8,5,6,9,22,20,2,21
Amkar,5177,9,5,5,10,11,23,-12,20
Rostov,5177,10,4,7,9,11,18,-7,19
Anzhi,5177,11,2,5,13,16,41,-25,11
Loko Moscow,5178,1,12,6,2,30,11,19,42
CSKA Moscow,5178,2,10,5,5,28,20,8,35
Spart Moscow,5178,3,8,7,5,35,28,7,31
Zenit,5178,4,7,9,4,22,15,7,30
Krasnodar,5178,5,8,5,7,28,26,2,29
Terek Grozny,5178,6,7,6,7,21,25,-4,27
Din Moscow,5178,7,6,7,7,19,22,-3,25
FK Rubin,5178,8,6,5,9,23,19,4,23
Amkar,5178,9,5,5,10,11,23,-12,20
Rostov,5178,10,4,7,9,10,17,-7,19
Anzhi,5178,11,3,6,11,19,40,-21,15
Loko Moscow,5179,1,12,6,2,33,13,20,42
Spart Moscow,5179,2,10,6,4,40,26,14,36
CSKA Moscow,5179,3,11,3,6,28,19,9,36
Zenit,5179,4,8,9,3,23,14,9,33
Krasnodar,5179,5,9,4,7,29,27,2,31
Terek Grozny,5179,6,8,6,6,25,24,1,30
FK Rubin,5179,7,6,5,9,22,18,4,23
Din Moscow,5179,8,5,6,9,17,26,-9,21
Rostov,5179,9,4,6,10,10,19,-9,18
Amkar,5179,10,4,6,10,11,24,-13,18
Anzhi,5179,11,2,5,13,16,44,-28,11
Loko Moscow,5180,1,12,5,3,33,15,18,41
Spart Moscow,5180,2,10,6,4,36,26,10,36
CSKA Moscow,5180,3,11,3,6,29,22,7,36
Zenit,5180,4,8,8,4,25,15,10,32
Krasnodar,5180,5,9,4,7,30,28,2,31
Terek Grozny,5180,6,7,7,6,22,24,-2,28
FK Rubin,5180,7,6,6,8,23,17,6,24
Din Moscow,5180,8,5,7,8,17,22,-5,22
Rostov,5180,9,4,6,10,10,18,-8,18
Amkar,5180,10,4,6,10,11,24,-13,18
Anzhi,5180,11,2,6,12,17,42,-25,12
Loko Moscow,5181,1,12,6,2,33,13,20,42
CSKA Moscow,5181,2,11,3,6,31,24,7,36
Spart Moscow,5181,3,9,7,4,37,27,10,34
Zenit,5181,4,8,8,4,27,19,8,32
Krasnodar,5181,5,9,5,6,29,25,4,32
Terek Grozny,5181,6,8,5,7,22,28,-6,29
FK Rubin,5181,7,6,5,9,23,19,4,23
Din Moscow,5181,8,5,6,9,19,26,-7,21
Amkar,5181,9,5,5,10,14,22,-8,20
Rostov,5181,10,4,7,9,11,18,-7,19
Anzhi,5181,11,2,5,13,17,42,-25,11
Loko Moscow,5182,1,13,5,2,33,12,21,44
CSKA Moscow,5182,2,11,3,6,28,20,8,36
Krasnodar,5182,3,9,4,7,32,26,6,31
Zenit,5182,4,7,8,5,22,17,5,29
Spart Moscow,5182,5,8,5,7,34,30,4,29
Terek Grozny,5182,6,8,5,7,25,26,-1,29
Din Moscow,5182,7,6,6,8,19,22,-3,24
FK Rubin,5182,8,6,5,9,22,21,1,23
Rostov,5182,9,5,6,9,12,18,-6,21
Amkar,5182,10,5,4,11,11,25,-14,19
Anzhi,5182,11,4,5,11,19,40,-21,17
Loko Moscow,5183,1,12,5,3,31,13,18,41
CSKA Moscow,5183,2,11,4,5,28,18,10,37
Spart Moscow,5183,3,10,5,5,39,27,12,35
Zenit,5183,4,8,9,3,24,15,9,33
Krasnodar,5183,5,9,4,7,29,25,4,31
Terek Grozny,5183,6,7,5,8,21,28,-7,26
Din Moscow,5183,7,6,6,8,21,24,-3,24
Rostov,5183,8,5,6,9,12,18,-6,21
FK Rubin,5183,9,5,5,10,22,23,-1,20
Amkar,5183,10,5,4,11,13,25,-12,19
Anzhi,5183,11,3,5,12,16,40,-24,14
Loko Moscow,5184,1,12,5,3,35,13,22,41
Spart Moscow,5184,2,11,5,4,40,27,13,38
CSKA Moscow,5184,3,11,3,6,27,18,9,36
Zenit,5184,4,9,8,3,24,14,10,35
Terek Grozny,5184,5,8,5,7,22,23,-1,29
Krasnodar,5184,6,8,5,7,27,29,-2,29
FK Rubin,5184,7,5,7,8,23,19,4,22
Din Moscow,5184,8,5,7,8,20,27,-7,22
Rostov,5184,9,4,6,10,10,18,-8,18
Amkar,5184,10,4,4,12,10,26,-16,16
Anzhi,5184,11,3,5,12,15,39,-24,14
Loko Moscow,5185,1,12,5,3,33,14,19,41
Spart Moscow,5185,2,9,7,4,37,28,9,34
CSKA Moscow,5185,3,10,4,6,25,18,7,34
Zenit,5185,4,8,8,4,22,16,6,32
Krasnodar,5185,5,9,5,6,30,25,5,32
Terek Grozny,5185,6,8,5,7,22,25,-3,29
Din Moscow,5185,7,5,8,7,19,23,-4,23
FK Rubin,5185,8,5,7,8,21,17,4,22
Rostov,5185,9,4,6,10,10,18,-8,18
Amkar,5185,10,4,5,11,10,24,-14,17
Anzhi,5185,11,3,6,11,17,38,-21,15
Loko Moscow,5186,1,11,5,4,30,15,15,38
CSKA Moscow,5186,2,11,3,6,26,19,7,36
Zenit,5186,3,9,8,3,25,13,12,35
Spart Moscow,5186,4,9,6,5,36,29,7,33
Krasnodar,5186,5,9,4,7,30,27,3,31
Terek Grozny,5186,6,8,6,6,22,23,-1,30
Din Moscow,5186,7,6,7,7,19,22,-3,25
FK Rubin,5186,8,6,5,9,23,19,4,23
Rostov,5186,9,5,6,9,13,17,-4,21
Amkar,5186,10,4,5,11,9,24,-15,17
Anzhi,5186,11,2,5,13,15,40,-25,11
Loko Moscow,5187,1,11,6,3,32,15,17,39
CSKA Moscow,5187,2,11,4,5,28,19,9,37
Spart Moscow,5187,3,10,5,5,40,27,13,35
Krasnodar,5187,4,10,4,6,32,27,5,34
Zenit,5187,5,7,10,3,23,15,8,31
Terek Grozny,5187,6,8,6,6,22,23,-1,30
Din Moscow,5187,7,7,6,7,21,22,-1,27
FK Rubin,5187,8,5,5,10,22,21,1,20
Rostov,5187,9,4,6,10,10,22,-12,18
Amkar,5187,10,4,5,11,10,24,-14,17
Anzhi,5187,11,2,5,13,15,40,-25,11
Loko Moscow,5188,1,13,5,2,32,11,21,44
Spart Moscow,5188,2,10,5,5,38,28,10,35
CSKA Moscow,5188,3,10,4,6,26,19,7,34
Zenit,5188,4,8,8,4,23,15,8,32
Krasnodar,5188,5,8,5,7,29,28,1,29
Terek Grozny,5188,6,8,5,7,23,24,-1,29
FK Rubin,5188,7,6,6,8,26,19,7,24
Din Moscow,5188,8,5,6,9,17,25,-8,21
Amkar,5188,9,5,4,11,11,25,-14,19
Rostov,5188,10,4,6,10,11,20,-9,18
Anzhi,5188,11,3,6,11,16,38,-22,15
Loko Moscow,5189,1,11,6,3,29,12,17,39
Spart Moscow,5189,2,11,5,4,39,26,13,38
CSKA Moscow,5189,3,11,3,6,28,20,8,36
Zenit,5189,4,9,8,3,24,13,11,35
Krasnodar,5189,5,9,5,6,29,25,4,32
Terek Grozny,5189,6,8,5,7,23,24,-1,29
Din Moscow,5189,7,6,6,8,20,25,-5,24
FK Rubin,5189,8,5,5,10,22,21,1,20
Amkar,5189,9,5,4,11,11,24,-13,19
Rostov,5189,10,4,6,10,10,18,-8,18
Anzhi,5189,11,2,5,13,15,42,-27,11
Loko Moscow,5190,1,12,6,2,30,11,19,42
CSKA Moscow,5190,2,11,4,5,27,18,9,37
Terek Grozny,5190,3,9,5,6,23,23,0,32
Zenit,5190,4,7,10,3,22,14,8,31
Spart Moscow,5190,5,8,7,5,34,27,7,31
Krasnodar,5190,6,8,4,8,28,28,0,28
FK Rubin,5190,7,7,5,8,25,18,7,26
Din Moscow,5190,8,6,6,8,18,22,-4,24
Rostov,5190,9,4,7,9,11,18,-7,19
Amkar,5190,10,4,5,11,9,23,-14,17
Anzhi,5190,11,2,5,13,15,40,-25,11
Loko Moscow,5191,1,12,5,3,31,14,17,41
CSKA Moscow,5191,2,11,4,5,28,19,9,37
Krasnodar,5191,3,10,4,6,31,25,6,34
Zenit,5191,4,7,9,4,23,16,7,30
Spart Moscow,5191,5,8,6,6,34,30,4,30
Terek Grozny,5191,6,7,5,8,22,29,-7,26
FK Rubin,5191,7,6,5,9,24,20,4,23
Din Moscow,5191,8,5,7,8,19,24,-5,22
Amkar,5191,9,6,4,10,13,22,-9,22
Rostov,5191,10,5,6,9,12,17,-5,21
Anzhi,5191,11,3,5,12,20,41,-21,14
Loko Moscow,5192,1,12,5,3,31,13,18,41
Spart Moscow,5192,2,11,5,4,43,26,17,38
CSKA Moscow,5192,3,11,3,6,28,22,6,36
Zenit,5192,4,9,8,3,26,14,12,35
Terek Grozny,5192,5,9,5,6,25,24,1,32
Krasnodar,5192,6,8,5,7,29,27,2,29
FK Rubin,5192,7,5,7,8,22,18,4,22
Din Moscow,5192,8,5,7,8,18,26,-8,22
Rostov,5192,9,4,6,10,10,18,-8,18
Amkar,5192,10,4,4,12,10,29,-19,16
Anzhi,5192,11,2,5,13,16,41,-25,11
Loko Moscow,5193,1,12,6,2,34,13,21,42
CSKA Moscow,5193,2,11,3,6,29,21,8,36
Spart Moscow,5193,3,10,5,5,37,28,9,35
Zenit,5193,4,8,8,4,25,17,8,32
Terek Grozny,5193,5,9,5,6,23,22,1,32
Krasnodar,5193,6,8,6,6,28,25,3,30
Din Moscow,5193,7,6,6,8,19,24,-5,24
FK Rubin,5193,8,5,6,9,22,19,3,21
Rostov,5193,9,5,6,9,12,17,-5,21
Amkar,5193,10,4,4,12,10,26,-16,16
Anzhi,5193,11,2,5,13,15,42,-27,11
Loko Moscow,5194,1,12,5,3,31,14,17,41
CSKA Moscow,5194,2,11,3,6,27,21,6,36
Spart Moscow,5194,3,10,5,5,37,28,9,35
Zenit,5194,4,8,8,4,24,14,10,32
Krasnodar,5194,5,9,5,6,30,25,5,32
Terek Grozny,5194,6,7,6,7,21,26,-5,27
FK Rubin,5194,7,6,6,8,22,17,5,24
Din Moscow,5194,8,5,6,9,17,23,-6,21
Amkar,5194,9,5,5,10,12,23,-11,20
Rostov,5194,10,4,6,10,10,19,-9,18
Anzhi,5194,11,3,5,12,19,40,-21,14
Loko Moscow,5195,1,12,5,3,30,12,18,41
CSKA Moscow,5195,2,12,3,5,29,18,11,39
Zenit,5195,3,8,8,4,23,15,8,32
Krasnodar,5195,4,9,4,7,28,25,3,31
Spart Moscow,5195,5,8,6,6,34,30,4,30
Terek Grozny,5195,6,7,5,8,21,25,-4,26
FK Rubin,5195,7,6,5,9,23,18,5,23
Din Moscow,5195,8,5,7,8,17,23,-6,22
Amkar,5195,9,6,4,10,13,24,-11,22
Rostov,5195,10,5,6,9,13,17,-4,21
Anzhi,5195,11,3,5,12,15,39,-24,14
Loko Moscow,5196,1,11,6,3,32,16,16,39
CSKA Moscow,5196,2,10,4,6,27,21,6,34
Terek Grozny,5196,3,9,5,6,22,22,0,32
Zenit,5196,4,7,10,3,24,16,8,31
Spart Moscow,5196,5,8,7,5,34,27,7,31
Krasnodar,5196,6,9,4,7,31,27,4,31
Din Moscow,5196,7,6,7,7,20,23,-3,25
FK Rubin,5196,8,6,5,9,24,20,4,23
Rostov,5196,9,4,7,9,10,17,-7,19
Amkar,5196,10,5,4,11,10,23,-13,19
Anzhi,5196,11,3,5,12,17,39,-22,14
Loko Moscow,5197,1,12,5,3,30,13,17,41
CSKA Moscow,5197,2,11,3,6,29,20,9,36
Krasnodar,5197,3,10,4,6,30,24,6,34
Spart Moscow,5197,4,9,6,5,40,28,12,33
Zenit,5197,5,8,8,4,23,15,8,32
Terek Grozny,5197,6,8,5,7,23,25,-2,29
Din Moscow,5197,7,6,6,8,20,27,-7,24
FK Rubin,5197,8,5,5,10,21,20,1,20
Rostov,5197,9,4,7,9,11,18,-7,19
Amkar,5197,10,5,4,11,10,24,-14,19
Anzhi,5197,11,3,5,12,18,41,-23,14
Loko Moscow,5198,1,11,6,3,33,16,17,39
CSKA Moscow,5198,2,12,3,5,30,20,10,39
Spart Moscow,5198,3,11,5,4,37,25,12,38
Krasnodar,5198,4,9,4,7,29,26,3,31
Zenit,5198,5,7,9,4,27,20,7,30
Terek Grozny,5198,6,8,5,7,23,24,-1,29
Din Moscow,5198,7,6,6,8,19,22,-3,24
FK Rubin,5198,8,6,5,9,22,19,3,23
Amkar,5198,9,5,4,11,11,24,-13,19
Rostov,5198,10,4,6,10,10,19,-9,18
Anzhi,5198,11,2,5,13,14,40,-26,11
Loko Moscow,5199,1,12,6,2,31,12,19,42
CSKA Moscow,5199,2,11,4,5,26,17,9,37
Spart Moscow,5199,3,9,7,4,39,30,9,34
Zenit,5199,4,7,10,3,22,14,8,31
Krasnodar,5199,5,8,4,8,28,27,1,28
Terek Grozny,5199,6,7,6,7,22,26,-4,27
FK Rubin,5199,7,7,5,8,26,18,8,26
Din Moscow,5199,8,5,7,8,18,25,-7,22
Rostov,5199,9,4,6,10,11,19,-8,18
Amkar,5199,10,4,6,10,13,26,-13,18
Anzhi,5199,11,3,5,12,17,39,-22,14
Loko Moscow,5200,1,12,5,3,31,15,16,41
Spart Moscow,5200,2,10,5,5,40,30,10,35
CSKA Moscow,5200,3,10,4,6,28,21,7,34
Zenit,5200,4,8,8,4,24,16,8,32
Krasnodar,5200,5,9,4,7,31,26,5,31
Terek Grozny,5200,6,7,5,8,21,25,-4,26
Din Moscow,5200,7,6,6,8,20,26,-6,24
FK Rubin,5200,8,6,5,9,23,19,4,23
Rostov,5200,9,5,6,9,13,18,-5,21
Amkar,5200,10,5,4,11,11,24,-13,19
Anzhi,5200,11,3,6,11,17,39,-22,15
Loko Moscow,5201,1,12,6,2,31,11,20,42
CSKA Moscow,5201,2,11,3,6,28,18,10,36
Spart Moscow,5201,3,9,7,4,36,26,10,34
Zenit,5201,4,8,8,4,22,15,7,32
Krasnodar,5201,5,9,5,6,29,24,5,32
Terek Grozny,5201,6,8,5,7,22,25,-3,29
FK Rubin,5201,7,6,5,9,22,19,3,23
Din Moscow,5201,8,5,7,8,17,22,-5,22
Rostov,5201,9,4,7,9,11,18,-7,19
Amkar,5201,10,5,4,11,11,24,-13,19
Anzhi,5201,11,2,5,13,15,42,-27,11
CSKA Moscow,5202,1,12,3,5,34,18,16,39
Loko Moscow,5202,2,11,6,3,31,15,16,39
Spart Moscow,5202,3,9,6,5,36,29,7,33
Zenit,5202,4,8,8,4,24,15,9,32
Terek Grozny,5202,5,8,6,6,24,24,0,30
Krasnodar,5202,6,8,5,7,30,28,2,29
FK Rubin,5202,7,7,5,8,25,19,6,26
Din Moscow,5202,8,5,6,9,20,26,-6,21
Amkar,5202,9,5,5,10,13,24,-11,20
Rostov,5202,10,4,7,9,10,17,-7,19
Anzhi,5202,11,2,5,13,14,46,-32,11
Loko Moscow,5203,1,12,6,2,32,12,20,42
Spart Moscow,5203,2,9,7,4,40,30,10,34
CSKA Moscow,5203,3,10,4,6,27,21,6,34
Zenit,5203,4,8,9,3,26,16,10,33
Terek Grozny,5203,5,8,6,6,23,23,0,30
Krasnodar,5203,6,8,4,8,27,28,-1,28
Din Moscow,5203,7,6,6,8,20,25,-5,24
FK Rubin,5203,8,6,5,9,24,19,5,23
Rostov,5203,9,4,7,9,13,20,-7,19
Amkar,5203,10,4,5,11,10,25,-15,17
Anzhi,5203,11,2,7,11,15,38,-23,13
Loko Moscow,5204,1,13,5,2,32,11,21,44
CSKA Moscow,5204,2,11,3,6,29,21,8,36
Spart Moscow,5204,3,9,6,5,41,30,11,33
Zenit,5204,4,8,8,4,24,14,10,32
Krasnodar,5204,5,9,4,7,30,26,4,31
Terek Grozny,5204,6,8,5,7,21,23,-2,29
Din Moscow,5204,7,6,6,8,21,26,-5,24
FK Rubin,5204,8,6,5,9,23,20,3,23
Rostov,5204,9,4,7,9,11,18,-7,19
Amkar,5204,10,5,4,11,10,26,-16,19
Anzhi,5204,11,2,5,13,15,42,-27,11
Loko Moscow,5205,1,12,5,3,31,14,17,41
CSKA Moscow,5205,2,11,3,6,27,19,8,36
Spart Moscow,5205,3,10,5,5,40,28,12,35
Zenit,5205,4,9,8,3,26,15,11,35
Terek Grozny,5205,5,8,6,6,23,24,-1,30
Krasnodar,5205,6,8,5,7,29,27,2,29
FK Rubin,5205,7,6,6,8,26,21,5,24
Din Moscow,5205,8,5,6,9,20,27,-7,21
Amkar,5205,9,5,5,10,13,25,-12,20
Rostov,5205,10,4,6,10,10,20,-10,18
Anzhi,5205,11,2,5,13,14,39,-25,11
Loko Moscow,5206,1,11,5,4,29,13,16,38
CSKA Moscow,5206,2,11,4,5,29,19,10,37
Spart Moscow,5206,3,10,5,5,37,27,10,35
Zenit,5206,4,8,9,3,23,14,9,33
Krasnodar,5206,5,9,5,6,28,24,4,32
Terek Grozny,5206,6,7,6,7,21,25,-4,27
Din Moscow,5206,7,6,6,8,20,22,-2,24
FK Rubin,5206,8,5,6,9,21,20,1,21
Amkar,5206,9,5,5,10,11,23,-12,20
Rostov,5206,10,4,6,10,11,20,-9,18
Anzhi,5206,11,3,5,12,17,40,-23,14
Loko Moscow,5207,1,12,5,3,30,12,18,41
Spart Moscow,5207,2,10,6,4,38,26,12,36
Zenit,5207,3,9,8,3,25,14,11,35
CSKA Moscow,5207,4,10,3,7,26,23,3,33
Krasnodar,5207,5,8,5,7,27,25,2,29
Terek Grozny,5207,6,8,5,7,22,23,-1,29
Din Moscow,5207,7,6,6,8,19,24,-5,24
FK Rubin,5207,8,5,6,9,21,19,2,21
Rostov,5207,9,4,6,10,10,18,-8,18
Amkar,5207,10,4,5,11,10,25,-15,17
Anzhi,5207,11,4,5,11,18,37,-19,17
Loko Moscow,5208,1,11,5,4,31,17,14,38
Zenit,5208,2,9,8,3,26,15,11,35
Krasnodar,5208,3,10,4,6,31,24,7,34
CSKA Moscow,5208,4,10,4,6,27,21,6,34
Spart Moscow,5208,5,9,5,6,36,30,6,32
Terek Grozny,5208,6,8,5,7,25,27,-2,29
Din Moscow,5208,7,6,6,8,20,24,-4,24
Amkar,5208,8,6,4,10,15,25,-10,22
Rostov,5208,9,5,6,9,11,17,-6,21
FK Rubin,5208,10,5,5,10,21,19,2,20
Anzhi,5208,11,2,6,12,17,41,-24,12
Loko Moscow,5209,1,12,5,3,32,13,19,41
Spart Moscow,5209,2,11,5,4,43,28,15,38
Zenit,5209,3,9,8,3,25,13,12,35
CSKA Moscow,5209,4,10,3,7,25,21,4,33
Terek Grozny,5209,5,9,5,6,23,22,1,32
Krasnodar,5209,6,8,5,7,29,28,1,29
FK Rubin,5209,7,5,7,8,23,19,4,22
Din Moscow,5209,8,5,7,8,20,26,-6,22
Rostov,5209,9,4,6,10,10,20,-10,18
Amkar,5209,10,4,4,12,10,26,-16,16
Anzhi,5209,11,3,5,12,15,39,-24,14
Loko Moscow,5210,1,13,5,2,32,11,21,44
Spart Moscow,5210,2,11,5,4,41,27,14,38
CSKA Moscow,5210,3,10,4,6,26,19,7,34
Krasnodar,5210,4,9,4,7,28,25,3,31
Zenit,5210,5,7,9,4,22,16,6,30
Terek Grozny,5210,6,8,5,7,22,24,-2,29
FK Rubin,5210,7,6,5,9,23,18,5,23
Din Moscow,5210,8,5,6,9,17,27,-10,21
Rostov,5210,9,4,6,10,11,19,-8,18
Anzhi,5210,10,4,5,11,17,37,-20,17
Amkar,5210,11,4,4,12,10,26,-16,16
Loko Moscow,5211,1,12,5,3,30,12,18,41
Spart Moscow,5211,2,10,6,4,36,25,11,36
Krasnodar,5211,3,10,4,6,29,24,5,34
CSKA Moscow,5211,4,10,4,6,26,21,5,34
Zenit,5211,5,8,8,4,24,14,10,32
Terek Grozny,5211,6,8,5,7,26,26,0,29
FK Rubin,5211,7,6,5,9,24,18,6,23
Din Moscow,5211,8,5,6,9,17,26,-9,21
Amkar,5211,9,5,5,10,12,23,-11,20
Rostov,5211,10,4,6,10,10,18,-8,18
Anzhi,5211,11,2,6,12,16,43,-27,12
Loko Moscow,5212,1,11,6,3,31,16,15,39
Spart Moscow,5212,2,11,5,4,40,27,13,38
CSKA Moscow,5212,3,10,4,6,26,21,5,34
Zenit,5212,4,7,10,3,23,15,8,31
Krasnodar,5212,5,9,4,7,32,27,5,31
Terek Grozny,5212,6,7,6,7,21,24,-3,27
FK Rubin,5212,7,6,6,8,24,19,5,24
Din Moscow,5212,8,5,7,8,19,24,-5,22
Rostov,5212,9,4,6,10,10,18,-8,18
Amkar,5212,10,4,5,11,10,26,-16,17
Anzhi,5212,11,4,5,11,19,38,-19,17
Loko Moscow,5213,1,12,6,2,31,12,19,42
Spart Moscow,5213,2,11,5,4,41,26,15,38
CSKA Moscow,5213,3,11,3,6,29,20,9,36
Zenit,5213,4,8,9,3,24,15,9,33
Krasnodar,5213,5,8,5,7,28,26,2,29
Terek Grozny,5213,6,7,5,8,20,24,-4,26
Din Moscow,5213,7,6,6,8,18,23,-5,24
FK Rubin,5213,8,5,6,9,22,19,3,21
Amkar,5213,9,5,4,11,11,26,-15,19
Rostov,5213,10,4,6,10,10,19,-9,18
Anzhi,5213,11,3,5,12,16,40,-24,14
Loko Moscow,5214,1,12,6,2,31,12,19,42
Spart Moscow,5214,2,11,5,4,40,25,15,38
CSKA Moscow,5214,3,10,4,6,26,20,6,34
Zenit,5214,4,8,9,3,24,14,10,33
Terek Grozny,5214,5,9,5,6,23,23,0,32
Krasnodar,5214,6,8,4,8,27,26,1,28
FK Rubin,5214,7,6,6,8,23,18,5,24
Din Moscow,5214,8,5,7,8,18,25,-7,22
Rostov,5214,9,4,6,10,10,20,-10,18
Amkar,5214,10,4,4,12,10,25,-15,16
Anzhi,5214,11,2,6,12,15,39,-24,12
Loko Moscow,5215,1,11,5,4,30,15,15,38
Spart Moscow,5215,2,9,7,4,37,27,10,34
CSKA Moscow,5215,3,10,4,6,27,20,7,34
Zenit,5215,4,8,9,3,23,14,9,33
Krasnodar,5215,5,9,5,6,31,26,5,32
Terek Grozny,5215,6,9,5,6,24,23,1,32
Din Moscow,5215,7,6,6,8,19,23,-4,24
FK Rubin,5215,8,5,6,9,22,20,2,21
Rostov,5215,9,4,7,9,11,18,-7,19
Amkar,5215,10,4,5,11,11,26,-15,17
Anzhi,5215,11,3,5,12,16,39,-23,14
Loko Moscow,5216,1,12,5,3,30,12,18,41
CSKA Moscow,5216,2,10,3,7,26,22,4,33
Zenit,5216,3,8,8,4,24,14,10,32
Krasnodar,5216,4,9,5,6,30,26,4,32
Spart Moscow,5216,5,8,7,5,36,31,5,31
Terek Grozny,5216,6,8,5,7,23,24,-1,29
Din Moscow,5216,7,6,7,7,20,21,-1,25
FK Rubin,5216,8,5,7,8,23,19,4,22
Amkar,5216,9,5,5,10,10,22,-12,20
Rostov,5216,10,4,7,9,13,20,-7,19
Anzhi,5216,11,3,5,12,17,41,-24,14
Loko Moscow,5217,1,12,5,3,32,13,19,41
CSKA Moscow,5217,2,11,4,5,32,19,13,37
Spart Moscow,5217,3,10,6,4,39,27,12,36
Zenit,5217,4,8,9,3,25,16,9,33
Terek Grozny,5217,5,8,6,6,22,23,-1,30
Krasnodar,5217,6,8,5,7,28,27,1,29
FK Rubin,5217,7,6,6,8,23,18,5,24
Din Moscow,5217,8,5,6,9,17,24,-7,21
Rostov,5217,9,4,6,10,10,19,-9,18
Amkar,5217,10,4,6,10,12,25,-13,18
Anzhi,5217,11,2,5,13,14,43,-29,11
Loko Moscow,5218,1,12,5,3,31,13,18,41
CSKA Moscow,5218,2,11,3,6,29,22,7,36
Zenit,5218,3,8,8,4,25,15,10,32
Spart Moscow,5218,4,8,8,4,34,26,8,32
Terek Grozny,5218,5,9,5,6,24,23,1,32
Krasnodar,5218,6,9,4,7,29,26,3,31
FK Rubin,5218,7,7,5,8,27,19,8,26
Din Moscow,5218,8,5,7,8,18,25,-7,22
Rostov,5218,9,4,7,9,10,17,-7,19
Amkar,5218,10,4,5,11,11,26,-15,17
Anzhi,5218,11,2,5,13,16,42,-26,11
Loko Moscow,5219,1,13,5,2,34,12,22,44
CSKA Moscow,5219,2,11,4,5,28,17,11,37
Spart Moscow,5219,3,9,5,6,37,28,9,32
Zenit,5219,4,7,9,4,21,15,6,30
Terek Grozny,5219,5,8,5,7,21,24,-3,29
Krasnodar,5219,6,8,4,8,28,28,0,28
Din Moscow,5219,7,7,6,7,20,22,-2,27
FK Rubin,5219,8,6,5,9,23,19,4,23
Rostov,5219,9,5,6,9,11,17,-6,21
Amkar,5219,10,5,4,11,12,26,-14,19
Anzhi,5219,11,2,5,13,14,41,-27,11
Loko Moscow,5220,1,11,7,2,32,14,18,40
CSKA Moscow,5220,2,11,3,6,28,19,9,36
Zenit,5220,3,8,9,3,23,14,9,33
Krasnodar,5220,4,9,5,6,31,27,4,32
Terek Grozny,5220,5,9,5,6,25,25,0,32
Spart Moscow,5220,6,8,7,5,37,30,7,31
FK Rubin,5220,7,6,5,9,24,18,6,23
Din Moscow,5220,8,5,7,8,19,26,-7,22
Rostov,5220,9,4,7,9,11,18,-7,19
Amkar,5220,10,5,4,11,11,24,-13,19
Anzhi,5220,11,2,5,13,17,43,-26,11
Loko Moscow,5221,1,13,5,2,32,11,21,44
Spart Moscow,5221,2,10,6,4,36,26,10,36
CSKA Moscow,5221,3,10,5,5,28,20,8,35
Krasnodar,5221,4,9,4,7,31,26,5,31
Zenit,5221,5,7,9,4,22,16,6,30
Terek Grozny,5221,6,8,6,6,22,23,-1,30
Din Moscow,5221,7,5,7,8,20,25,-5,22
FK Rubin,5221,8,5,6,9,24,23,1,21
Rostov,5221,9,4,6,10,10,18,-8,18
Amkar,5221,10,4,5,11,9,23,-14,17
Anzhi,5221,11,2,7,11,17,40,-23,13
Loko Moscow,5222,1,12,6,2,32,12,20,42
CSKA Moscow,5222,2,11,4,5,31,20,11,37
Spart Moscow,5222,3,9,6,5,36,26,10,33
Zenit,5222,4,7,10,3,23,15,8,31
Krasnodar,5222,5,9,4,7,33,28,5,31
Terek Grozny,5222,6,8,5,7,23,25,-2,29
Din Moscow,5222,7,6,6,8,19,25,-6,24
Rostov,5222,8,5,6,9,11,17,-6,21
FK Rubin,5222,9,5,5,10,23,24,-1,20
Amkar,5222,10,5,5,10,10,22,-12,20
Anzhi,5222,11,2,5,13,17,44,-27,11
Loko Moscow,5223,1,12,5,3,30,12,18,41
Spart Moscow,5223,2,11,5,4,38,27,11,38
CSKA Moscow,5223,3,11,4,5,30,21,9,37
Krasnodar,5223,4,9,4,7,28,25,3,31
Zenit,5223,5,7,9,4,24,17,7,30
Terek Grozny,5223,6,8,6,6,22,23,-1,30
FK Rubin,5223,7,7,5,8,23,17,6,26
Din Moscow,5223,8,5,6,9,19,25,-6,21
Rostov,5223,9,4,6,10,10,18,-8,18
Amkar,5223,10,4,4,12,10,25,-15,16
Anzhi,5223,11,2,6,12,15,39,-24,12
Loko Moscow,5224,1,12,6,2,31,12,19,42
CSKA Moscow,5224,2,11,3,6,29,19,10,36
Spart Moscow,5224,3,10,5,5,36,27,9,35
Zenit,5224,4,8,8,4,23,15,8,32
Krasnodar,5224,5,9,5,6,31,26,5,32
Terek Grozny,5224,6,8,5,7,23,24,-1,29
Din Moscow,5224,7,6,6,8,20,24,-4,24
Amkar,5224,8,6,4,10,11,22,-11,22
FK Rubin,5224,9,5,5,10,23,22,1,20
Rostov,5224,10,4,6,10,10,18,-8,18
Anzhi,5224,11,2,5,13,15,43,-28,11
Loko Moscow,5225,1,11,6,3,32,16,16,39
CSKA Moscow,5225,2,11,3,6,30,20,10,36
Spart Moscow,5225,3,10,5,5,37,27,10,35
Krasnodar,5225,4,10,4,6,32,26,6,34
Zenit,5225,5,8,9,3,26,16,10,33
Terek Grozny,5225,6,9,5,6,26,24,2,32
Din Moscow,5225,7,6,6,8,19,23,-4,24
FK Rubin,5225,8,5,5,10,22,20,2,20
Amkar,5225,9,5,4,11,11,25,-14,19
Rostov,5225,10,4,6,10,10,19,-9,18
Anzhi,5225,11,2,5,13,15,44,-29,11
Loko Moscow,5226,1,12,5,3,31,13,18,41
CSKA Moscow,5226,2,12,3,5,32,17,15,39
Spart Moscow,5226,3,9,7,4,37,28,9,34
Krasnodar,5226,4,9,4,7,29,26,3,31
Zenit,5226,5,7,8,5,21,16,5,29
Terek Grozny,5226,6,8,5,7,23,25,-2,29
FK Rubin,5226,7,6,6,8,23,18,5,24
Din Moscow,5226,8,5,7,8,19,24,-5,22
Rostov,5226,9,4,7,9,11,18,-7,19
Amkar,5226,10,4,5,11,11,25,-14,17
Anzhi,5226,11,3,5,12,16,43,-27,14
Loko Moscow,5227,1,13,5,2,33,13,20,44
CSKA Moscow,5227,2,11,4,5,27,17,10,37
Spart Moscow,5227,3,9,7,4,39,28,11,34
Krasnodar,5227,4,9,4,7,30,26,4,31
Zenit,5227,5,7,9,4,22,15,7,30
Terek Grozny,5227,6,8,5,7,22,26,-4,29
Din Moscow,5227,7,6,7,7,21,23,-2,25
FK Rubin,5227,8,5,5,10,21,21,0,20
Amkar,5227,9,5,5,10,13,23,-10,20
Rostov,5227,10,4,6,10,10,20,-10,18
Anzhi,5227,11,2,5,13,15,41,-26,11
Loko Moscow,5228,1,11,5,4,32,18,14,38
CSKA Moscow,5228,2,11,4,5,27,17,10,37
Spart Moscow,5228,3,10,6,4,42,28,14,36
Zenit,5228,4,8,9,3,25,16,9,33
Krasnodar,5228,5,9,4,7,30,26,4,31
Terek Grozny,5228,6,8,5,7,23,28,-5,29
FK Rubin,5228,7,7,5,8,24,17,7,26
Din Moscow,5228,8,5,6,9,18,24,-6,21
Amkar,5228,9,5,5,10,15,24,-9,20
Rostov,5228,10,4,6,10,11,23,-12,18
Anzhi,5228,11,2,5,13,15,41,-26,11
Loko Moscow,5229,1,11,5,4,29,14,15,38
Zenit,5229,2,9,8,3,24,13,11,35
CSKA Moscow,5229,3,10,4,6,26,19,7,34
Krasnodar,5229,4,10,4,6,30,24,6,34
Spart Moscow,5229,5,9,6,5,39,30,9,33
Terek Grozny,5229,6,8,5,7,22,24,-2,29
FK Rubin,5229,7,6,5,9,23,19,4,23
Din Moscow,5229,8,5,7,8,19,25,-6,22
Amkar,5229,9,6,4,10,14,24,-10,22
Rostov,5229,10,4,6,10,10,19,-9,18
Anzhi,5229,11,2,6,12,15,40,-25,12
Loko Moscow,5230,1,13,5,2,31,11,20,44
Spart Moscow,5230,2,11,5,4,38,25,13,38
CSKA Moscow,5230,3,11,4,5,29,17,12,37
Zenit,5230,4,7,9,4,21,14,7,30
Terek Grozny,5230,5,8,5,7,24,24,0,29
Krasnodar,5230,6,8,4,8,27,28,-1,28
Din Moscow,5230,7,6,6,8,18,22,-4,24
FK Rubin,5230,8,6,5,9,24,18,6,23
Amkar,5230,9,5,4,11,10,25,-15,19
Rostov,5230,10,4,6,10,10,18,-8,18
Anzhi,5230,11,2,5,13,15,45,-30,11
Loko Moscow,5231,1,11,5,4,33,17,16,38
Spart Moscow,5231,2,10,5,5,40,28,12,35
Zenit,5231,3,9,8,3,25,15,10,35
CSKA Moscow,5231,4,10,4,6,27,20,7,34
Krasnodar,5231,5,10,4,6,31,26,5,34
Terek Grozny,5231,6,7,5,8,21,28,-7,26
Din Moscow,5231,7,6,6,8,21,25,-4,24
Amkar,5231,8,6,4,10,14,24,-10,22
FK Rubin,5231,9,5,5,10,22,22,0,20
Rostov,5231,10,4,6,10,11,20,-9,18
Anzhi,5231,11,3,6,11,19,39,-20,15
Loko Moscow,5232,1,12,6,2,33,13,20,42
Spart Moscow,5232,2,10,6,4,38,26,12,36
CSKA Moscow,5232,3,11,3,6,27,21,6,36
Zenit,5232,4,8,9,3,26,15,11,33
Krasnodar,5232,5,8,5,7,27,26,1,29
Terek Grozny,5232,6,8,5,7,22,24,-2,29
Din Moscow,5232,7,6,6,8,21,26,-5,24
FK Rubin,5232,8,5,6,9,23,21,2,21
Rostov,5232,9,4,7,9,11,18,-7,19
Amkar,5232,10,4,4,12,10,25,-15,16
Anzhi,5232,11,3,5,12,16,39,-23,14
Loko Moscow,5233,1,12,6,2,33,13,20,42
CSKA Moscow,5233,2,11,3,6,28,21,7,36
Spart Moscow,5233,3,9,7,4,41,30,11,34
Zenit,5233,4,8,8,4,23,15,8,32
Krasnodar,5233,5,8,6,6,29,26,3,30
Terek Grozny,5233,6,8,5,7,23,23,0,29
Din Moscow,5233,7,6,7,7,21,23,-2,25
FK Rubin,5233,8,5,6,9,21,19,2,21
Amkar,5233,9,5,5,10,12,24,-12,20
Rostov,5233,10,4,6,10,11,21,-10,18
Anzhi,5233,11,2,5,13,16,43,-27,11
Loko Moscow,5234,1,12,5,3,31,12,19,41
Spart Moscow,5234,2,11,5,4,41,27,14,38
Zenit,5234,3,9,8,3,23,13,10,35
CSKA Moscow,5234,4,10,4,6,26,19,7,34
Krasnodar,5234,5,8,5,7,27,26,1,29
Terek Grozny,5234,6,7,5,8,21,25,-4,26
FK Rubin,5234,7,6,6,8,23,18,5,24
Din Moscow,5234,8,5,6,9,19,26,-7,21
Amkar,5234,9,5,4,11,11,24,-13,19
Rostov,5234,10,4,6,10,10,20,-10,18
Anzhi,5234,11,3,6,11,17,39,-22,15
Loko Moscow,5235,1,13,5,2,36,14,22,44
CSKA Moscow,5235,2,11,3,6,26,19,7,36
Spart Moscow,5235,3,8,8,4,33,25,8,32
Zenit,5235,4,8,8,4,24,17,7,32
Krasnodar,5235,5,9,4,7,31,28,3,31
Terek Grozny,5235,6,8,6,6,22,23,-1,30
Din Moscow,5235,7,6,7,7,20,21,-1,25
FK Rubin,5235,8,5,5,10,22,22,0,20
Rostov,5235,9,4,7,9,10,17,-7,19
Amkar,5235,10,4,5,11,9,23,-14,17
Anzhi,5235,11,2,6,12,15,39,-24,12
Loko Moscow,5236,1,11,5,4,30,17,13,38
CSKA Moscow,5236,2,11,3,6,27,19,8,36
Zenit,5236,3,9,8,3,26,14,12,35
Krasnodar,5236,4,9,4,7,30,28,2,31
Spart Moscow,5236,5,8,6,6,35,32,3,30
Terek Grozny,5236,6,8,6,6,22,23,-1,30
Din Moscow,5236,7,7,6,7,20,21,-1,27
FK Rubin,5236,8,6,5,9,25,18,7,23
Rostov,5236,9,4,7,9,11,18,-7,19
Amkar,5236,10,5,4,11,14,25,-11,19
Anzhi,5236,11,2,6,12,14,39,-25,12
Loko Moscow,5237,1,12,6,2,31,11,20,42
CSKA Moscow,5237,2,11,4,5,29,18,11,37
Spart Moscow,5237,3,10,5,5,37,29,8,35
Zenit,5237,4,7,9,4,22,16,6,30
Terek Grozny,5237,5,8,6,6,22,22,0,30
Krasnodar,5237,6,8,5,7,28,27,1,29
FK Rubin,5237,7,7,5,8,25,18,7,26
Rostov,5237,8,5,6,9,13,17,-4,21
Din Moscow,5237,9,5,6,9,17,24,-7,21
Amkar,5237,10,4,4,12,10,26,-16,16
Anzhi,5237,11,2,6,12,14,40,-26,12
Loko Moscow,5238,1,12,6,2,31,11,20,42
CSKA Moscow,5238,2,10,3,7,25,19,6,33
Spart Moscow,5238,3,9,5,6,38,30,8,32
Zenit,5238,4,8,8,4,22,15,7,32
Terek Grozny,5238,5,8,6,6,22,22,0,30
Krasnodar,5238,6,8,5,7,27,26,1,29
FK Rubin,5238,7,7,5,8,25,18,7,26
Din Moscow,5238,8,6,6,8,20,24,-4,24
Rostov,5238,9,5,6,9,12,18,-6,21
Amkar,5238,10,4,5,11,10,25,-15,17
Anzhi,5238,11,3,5,12,15,39,-24,14
Loko Moscow,5239,1,11,6,3,30,13,17,39
CSKA Moscow,5239,2,11,3,6,27,20,7,36
Zenit,5239,3,8,9,3,24,14,10,33
Spart Moscow,5239,4,8,7,5,38,32,6,31
Krasnodar,5239,5,9,4,7,29,26,3,31
FK Rubin,5239,6,7,5,8,24,18,6,26
Terek Grozny,5239,7,7,5,8,21,27,-6,26
Din Moscow,5239,8,5,7,8,20,25,-5,22
Amkar,5239,9,6,4,10,16,24,-8,22
Rostov,5239,10,4,7,9,11,18,-7,19
Anzhi,5239,11,3,5,12,16,39,-23,14
Loko Moscow,5240,1,13,5,2,33,12,21,44
CSKA Moscow,5240,2,11,3,6,27,19,8,36
Spart Moscow,5240,3,9,6,5,39,30,9,33
Zenit,5240,4,8,8,4,22,14,8,32
Krasnodar,5240,5,9,4,7,30,27,3,31
Terek Grozny,5240,6,7,5,8,20,24,-4,26
Din Moscow,5240,7,6,6,8,19,23,-4,24
FK Rubin,5240,8,6,5,9,22,19,3,23
Amkar,5240,9,5,5,10,12,24,-12,20
Rostov,5240,10,4,6,10,11,20,-9,18
Anzhi,5240,11,3,5,12,16,39,-23,14
Loko Moscow,5241,1,11,5,4,30,14,16,38
Spart Moscow,5241,2,10,6,4,38,27,11,36
CSKA Moscow,5241,3,11,3,6,27,19,8,36
Zenit,5241,4,9,8,3,25,14,11,35
Krasnodar,5241,5,10,4,6,30,24,6,34
Terek Grozny,5241,6,9,5,6,23,23,0,32
Din Moscow,5241,7,5,8,7,19,23,-4,23
FK Rubin,5241,8,5,6,9,22,20,2,21
Rostov,5241,9,4,6,10,10,18,-8,18
Amkar,5241,10,4,4,12,10,26,-16,16
Anzhi,5241,11,2,5,13,15,41,-26,11
CSKA Moscow,5242,1,12,3,5,30,17,13,39
Loko Moscow,5242,2,11,5,4,29,14,15,38
Spart Moscow,5242,3,9,6,5,34,26,8,33
Zenit,5242,4,8,8,4,22,14,8,32
Krasnodar,5242,5,9,5,6,30,25,5,32
Terek Grozny,5242,6,9,5,6,24,24,0,32
FK Rubin,5242,7,5,7,8,23,19,4,22
Din Moscow,5242,8,5,7,8,18,23,-5,22
Rostov,5242,9,5,6,9,11,17,-6,21
Amkar,5242,10,4,5,11,10,24,-14,17
Anzhi,5242,11,2,5,13,15,43,-28,11
Loko Moscow,5243,1,11,6,3,30,14,16,39
CSKA Moscow,5243,2,10,5,5,27,19,8,35
Spart Moscow,5243,3,9,6,5,36,29,7,33
Krasnodar,5243,4,9,5,6,29,24,5,32
Zenit,5243,5,7,10,3,23,15,8,31
Terek Grozny,5243,6,8,6,6,23,24,-1,30
FK Rubin,5243,7,5,7,8,21,17,4,22
Din Moscow,5243,8,5,7,8,18,23,-5,22
Amkar,5243,9,5,5,10,13,24,-11,20
Rostov,5243,10,4,7,9,10,17,-7,19
Anzhi,5243,11,2,6,12,16,40,-24,12
Loko Moscow,5244,1,11,7,2,31,13,18,40
Spart Moscow,5244,2,10,5,5,37,28,9,35
CSKA Moscow,5244,3,10,4,6,28,23,5,34
Zenit,5244,4,8,9,3,27,16,11,33
Krasnodar,5244,5,8,6,6,28,25,3,30
Terek Grozny,5244,6,8,5,7,25,25,0,29
FK Rubin,5244,7,5,7,8,22,18,4,22
Din Moscow,5244,8,5,7,8,19,24,-5,22
Amkar,5244,9,6,4,10,13,24,-11,22
Rostov,5244,10,4,6,10,10,18,-8,18
Anzhi,5244,11,2,6,12,16,42,-26,12
Loko Moscow,5245,1,12,6,2,34,14,20,42
CSKA Moscow,5245,2,11,4,5,28,17,11,37
Spart Moscow,5245,3,8,6,6,35,29,6,30
Zenit,5245,4,7,9,4,21,15,6,30
Krasnodar,5245,5,8,5,7,31,31,0,29
Terek Grozny,5245,6,8,5,7,23,25,-2,29
FK Rubin,5245,7,7,5,8,27,19,8,26
Din Moscow,5245,8,6,6,8,19,23,-4,24
Rostov,5245,9,4,7,9,12,19,-7,19
Amkar,5245,10,5,4,11,11,25,-14,19
Anzhi,5245,11,3,5,12,16,40,-24,14
Loko Moscow,5246,1,12,5,3,31,14,17,41
CSKA Moscow,5246,2,11,3,6,30,22,8,36
Spart Moscow,5246,3,9,6,5,36,28,8,33
Zenit,5246,4,8,8,4,24,16,8,32
Krasnodar,5246,5,9,5,6,31,26,5,32
Terek Grozny,5246,6,8,5,7,22,24,-2,29
FK Rubin,5246,7,6,6,8,25,18,7,24
Din Moscow,5246,8,6,6,8,18,24,-6,24
Rostov,5246,9,4,6,10,10,18,-8,18
Amkar,5246,10,4,5,11,11,25,-14,17
Anzhi,5246,11,3,5,12,18,41,-23,14
Loko Moscow,5247,1,11,7,2,29,11,18,40
CSKA Moscow,5247,2,11,3,6,31,20,11,36
Spart Moscow,5247,3,10,5,5,41,29,12,35
Zenit,5247,4,8,9,3,24,15,9,33
Krasnodar,5247,5,8,5,7,28,28,0,29
FK Rubin,5247,6,7,5,8,27,18,9,26
Terek Grozny,5247,7,7,5,8,21,25,-4,26
Rostov,5247,8,5,6,9,13,19,-6,21
Din Moscow,5247,9,5,6,9,17,27,-10,21
Amkar,5247,10,5,4,11,11,24,-13,19
Anzhi,5247,11,3,5,12,16,42,-26,14
Loko Moscow,5248,1,13,5,2,32,11,21,44
CSKA Moscow,5248,2,10,3,7,26,21,5,33
Zenit,5248,3,8,8,4,24,15,9,32
Spart Moscow,5248,4,8,8,4,37,29,8,32
Terek Grozny,5248,5,9,5,6,25,24,1,32
Krasnodar,5248,6,9,4,7,29,26,3,31
FK Rubin,5248,7,6,5,9,23,19,4,23
Din Moscow,5248,8,5,7,8,18,24,-6,22
Rostov,5248,9,4,7,9,12,19,-7,19
Amkar,5248,10,4,5,11,10,25,-15,17
Anzhi,5248,11,3,5,12,17,40,-23,14
Loko Moscow,5249,1,12,6,2,33,12,21,42
Spart Moscow,5249,2,11,5,4,41,28,13,38
CSKA Moscow,5249,3,11,4,5,28,19,9,37
Zenit,5249,4,7,10,3,22,14,8,31
Krasnodar,5249,5,9,4,7,31,28,3,31
Terek Grozny,5249,6,7,6,7,20,24,-4,27
Din Moscow,5249,7,6,6,8,21,25,-4,24
FK Rubin,5249,8,5,5,10,22,22,0,20
Amkar,5249,9,5,4,11,12,25,-13,19
Rostov,5249,10,4,6,10,10,19,-9,18
Anzhi,5249,11,2,6,12,15,39,-24,12
Loko Moscow,5250,1,12,6,2,34,14,20,42
CSKA Moscow,5250,2,11,4,5,26,17,9,37
Spart Moscow,5250,3,10,5,5,41,28,13,35
Zenit,5250,4,7,9,4,22,16,6,30
Krasnodar,5250,5,8,5,7,31,30,1,29
Terek Grozny,5250,6,7,6,7,21,24,-3,27
FK Rubin,5250,7,7,5,8,26,19,7,26
Din Moscow,5250,8,5,6,9,18,24,-6,21
Rostov,5250,9,5,6,9,12,18,-6,21
Amkar,5250,10,5,4,11,10,27,-17,19
Anzhi,5250,11,2,6,12,15,39,-24,12
Loko Moscow,5251,1,12,6,2,32,13,19,42
CSKA Moscow,5251,2,11,3,6,26,21,5,36
Spart Moscow,5251,3,9,7,4,37,28,9,34
Zenit,5251,4,8,9,3,26,14,12,33
Terek Grozny,5251,5,8,6,6,21,22,-1,30
Krasnodar,5251,6,8,4,8,29,28,1,28
FK Rubin,5251,7,6,6,8,23,18,5,24
Din Moscow,5251,8,5,8,7,18,22,-4,23
Rostov,5251,9,4,6,10,11,19,-8,18
Amkar,5251,10,4,6,10,10,23,-13,18
Anzhi,5251,11,2,5,13,14,39,-25,11
Loko Moscow,5252,1,11,6,3,31,14,17,39
Spart Moscow,5252,2,10,6,4,40,28,12,36
CSKA Moscow,5252,3,11,3,6,27,19,8,36
Zenit,5252,4,8,9,3,24,14,10,33
Krasnodar,5252,5,9,4,7,30,27,3,31
Terek Grozny,5252,6,8,6,6,22,23,-1,30
FK Rubin,5252,7,6,6,8,23,18,5,24
Din Moscow,5252,8,5,8,7,18,22,-4,23
Rostov,5252,9,4,6,10,12,20,-8,18
Amkar,5252,10,4,5,11,9,25,-16,17
Anzhi,5252,11,2,5,13,15,41,-26,11
Loko Moscow,5253,1,12,5,3,30,12,18,41
CSKA Moscow,5253,2,11,4,5,29,20,9,37
Spart Moscow,5253,3,10,6,4,35,25,10,36
Krasnodar,5253,4,10,4,6,30,25,5,34
Zenit,5253,5,7,9,4,22,15,7,30
Terek Grozny,5253,6,8,5,7,22,24,-2,29
Din Moscow,5253,7,6,6,8,20,22,-2,24
FK Rubin,5253,8,5,5,10,22,22,0,20
Rostov,5253,9,4,6,10,10,18,-8,18
Amkar,5253,10,4,5,11,9,24,-15,17
Anzhi,5253,11,3,5,12,18,40,-22,14
Loko Moscow,5254,1,12,6,2,32,13,19,42
CSKA Moscow,5254,2,11,4,5,28,18,10,37
Spart Moscow,5254,3,9,6,5,37,27,10,33
Zenit,5254,4,7,9,4,23,16,7,30
Krasnodar,5254,5,8,6,6,29,26,3,30
Terek Grozny,5254,6,7,6,7,20,24,-4,27
FK Rubin,5254,7,6,6,8,23,18,5,24
Din Moscow,5254,8,6,6,8,19,23,-4,24
Amkar,5254,9,5,5,10,11,22,-11,20
Rostov,5254,10,4,6,10,10,20,-10,18
Anzhi,5254,11,2,6,12,14,39,-25,12
Loko Moscow,5255,1,12,6,2,34,15,19,42
CSKA Moscow,5255,2,10,5,5,28,20,8,35
Spart Moscow,5255,3,9,6,5,37,29,8,33
Krasnodar,5255,4,9,5,6,34,29,5,32
Zenit,5255,5,7,9,4,24,17,7,30
Terek Grozny,5255,6,8,5,7,24,25,-1,29
FK Rubin,5255,7,6,5,9,25,22,3,23
Din Moscow,5255,8,5,6,9,20,26,-6,21
Rostov,5255,9,4,7,9,11,18,-7,19
Amkar,5255,10,5,4,11,10,24,-14,19
Anzhi,5255,11,3,6,11,18,40,-22,15
Loko Moscow,5256,1,12,5,3,31,13,18,41
Spart Moscow,5256,2,10,6,4,42,29,13,36
Krasnodar,5256,3,10,4,6,30,24,6,34
CSKA Moscow,5256,4,10,4,6,27,22,5,34
Zenit,5256,5,8,8,4,25,16,9,32
Terek Grozny,5256,6,8,5,7,23,23,0,29
Din Moscow,5256,7,5,8,7,18,22,-4,23
FK Rubin,5256,8,5,6,9,21,18,3,21
Amkar,5256,9,5,4,11,13,26,-13,19
Rostov,5256,10,4,6,10,10,21,-11,18
Anzhi,5256,11,2,6,12,15,41,-26,12
Loko Moscow,5257,1,12,5,3,31,13,18,41
Spart Moscow,5257,2,11,5,4,39,26,13,38
CSKA Moscow,5257,3,10,5,5,25,17,8,35
Zenit,5257,4,8,9,3,23,13,10,33
Krasnodar,5257,5,8,5,7,29,28,1,29
Terek Grozny,5257,6,7,5,8,23,28,-5,26
FK Rubin,5257,7,5,7,8,23,19,4,22
Din Moscow,5257,8,5,7,8,18,24,-6,22
Amkar,5257,9,5,4,11,10,23,-13,19
Rostov,5257,10,4,6,10,10,19,-9,18
Anzhi,5257,11,3,6,11,19,40,-21,15
Loko Moscow,5258,1,11,7,2,31,13,18,40
CSKA Moscow,5258,2,11,4,5,28,19,9,37
Spart Moscow,5258,3,10,6,4,39,27,12,36
Zenit,5258,4,7,10,3,21,13,8,31
Krasnodar,5258,5,8,5,7,29,28,1,29
Terek Grozny,5258,6,8,5,7,24,23,1,29
Din Moscow,5258,7,6,6,8,18,23,-5,24
FK Rubin,5258,8,6,5,9,23,18,5,23
Amkar,5258,9,5,5,10,12,24,-12,20
Rostov,5258,10,4,6,10,10,19,-9,18
Anzhi,5258,11,2,5,13,16,44,-28,11
Loko Moscow,5259,1,11,7,2,29,11,18,40
Spart Moscow,5259,2,10,6,4,39,27,12,36
CSKA Moscow,5259,3,11,3,6,28,19,9,36
Zenit,5259,4,8,9,3,23,14,9,33
Krasnodar,5259,5,9,5,6,31,27,4,32
Terek Grozny,5259,6,8,6,6,24,24,0,30
Din Moscow,5259,7,6,7,7,20,22,-2,25
FK Rubin,5259,8,5,5,10,24,23,1,20
Rostov,5259,9,4,6,10,11,20,-9,18
Amkar,5259,10,4,4,12,10,27,-17,16
Anzhi,5259,11,2,6,12,15,40,-25,12
Loko Moscow,5260,1,11,7,2,34,16,18,40
CSKA Moscow,5260,2,11,3,6,26,18,8,36
Spart Moscow,5260,3,9,7,4,35,26,9,34
Krasnodar,5260,4,9,5,6,34,30,4,32
Zenit,5260,5,7,9,4,23,16,7,30
Terek Grozny,5260,6,8,5,7,23,25,-2,29
FK Rubin,5260,7,6,5,9,25,21,4,23
Din Moscow,5260,8,5,7,8,18,23,-5,22
Amkar,5260,9,5,5,10,11,22,-11,20
Rostov,5260,10,4,6,10,10,18,-8,18
Anzhi,5260,11,3,5,12,16,40,-24,14
Loko Moscow,5261,1,11,7,2,30,12,18,40
Spart Moscow,5261,2,11,5,4,42,27,15,38
CSKA Moscow,5261,3,11,4,5,31,19,12,37
Zenit,5261,4,7,10,3,22,14,8,31
Krasnodar,5261,5,8,5,7,28,26,2,29
Terek Grozny,5261,6,8,5,7,21,26,-5,29
Din Moscow,5261,7,6,6,8,19,25,-6,24
FK Rubin,5261,8,6,5,9,22,18,4,23
Amkar,5261,9,5,4,11,14,25,-11,19
Rostov,5261,10,4,6,10,10,19,-9,18
Anzhi,5261,11,2,5,13,15,43,-28,11
Loko Moscow,5262,1,12,5,3,31,14,17,41
CSKA Moscow,5262,2,11,3,6,27,20,7,36
Krasnodar,5262,3,10,4,6,34,26,8,34
Spart Moscow,5262,4,9,6,5,38,30,8,33
Zenit,5262,5,8,8,4,24,14,10,32
Terek Grozny,5262,6,8,6,6,25,23,2,30
Din Moscow,5262,7,6,7,7,21,24,-3,25
FK Rubin,5262,8,5,6,9,23,22,1,21
Rostov,5262,9,4,6,10,10,18,-8,18
Amkar,5262,10,4,6,10,12,25,-13,18
Anzhi,5262,11,2,5,13,14,43,-29,11
Loko Moscow,5263,1,12,5,3,30,12,18,41
CSKA Moscow,5263,2,11,3,6,29,20,9,36
Zenit,5263,3,9,8,3,25,14,11,35
Spart Moscow,5263,4,9,6,5,35,27,8,33
Terek Grozny,5263,5,8,6,6,24,24,0,30
Krasnodar,5263,6,8,4,8,30,29,1,28
Din Moscow,5263,7,6,7,7,20,23,-3,25
FK Rubin,5263,8,6,5,9,26,22,4,23
Rostov,5263,9,5,6,9,11,17,-6,21
Amkar,5263,10,4,5,11,10,24,-14,17
Anzhi,5263,11,2,5,13,15,43,-28,11
Loko Moscow,5264,1,13,5,2,31,11,20,44
Spart Moscow,5264,2,11,5,4,41,26,15,38
CSKA Moscow,5264,3,10,5,5,27,19,8,35
Krasnodar,5264,4,9,4,7,30,26,4,31
Zenit,5264,5,7,9,4,22,15,7,30
Terek Grozny,5264,6,7,6,7,22,25,-3,27
Din Moscow,5264,7,6,6,8,18,25,-7,24
FK Rubin,5264,8,5,5,10,22,21,1,20
Amkar,5264,9,5,4,11,11,25,-14,19
Rostov,5264,10,4,6,10,11,19,-8,18
Anzhi,5264,11,2,7,11,16,39,-23,13
Loko Moscow,5265,1,12,5,3,33,16,17,41
CSKA Moscow,5265,2,11,3,6,27,19,8,36
Zenit,5265,3,8,8,4,22,17,5,32
Krasnodar,5265,4,9,4,7,33,26,7,31
Spart Moscow,5265,5,8,5,7,33,29,4,29
Terek Grozny,5265,6,7,6,7,20,24,-4,27
FK Rubin,5265,7,7,5,8,24,18,6,26
Din Moscow,5265,8,6,6,8,18,22,-4,24
Rostov,5265,9,5,6,9,12,17,-5,21
Amkar,5265,10,5,5,10,10,22,-12,20
Anzhi,5265,11,3,5,12,17,39,-22,14
Loko Moscow,5266,1,11,6,3,31,14,17,39
CSKA Moscow,5266,2,11,3,6,28,19,9,36
Spart Moscow,5266,3,10,5,5,40,29,11,35
Zenit,5266,4,9,8,3,24,14,10,35
Krasnodar,5266,5,9,5,6,31,25,6,32
Din Moscow,5266,6,7,6,7,21,23,-2,27
Terek Grozny,5266,7,7,5,8,21,25,-4,26
FK Rubin,5266,8,5,5,10,22,22,0,20
Amkar,5266,9,5,4,11,10,23,-13,19
Rostov,5266,10,4,6,10,12,22,-10,18
Anzhi,5266,11,3,5,12,17,41,-24,14
Loko Moscow,5267,1,11,7,2,32,14,18,40
Spart Moscow,5267,2,11,5,4,40,29,11,38
CSKA Moscow,5267,3,11,3,6,26,22,4,36
Zenit,5267,4,8,9,3,26,13,13,33
Terek Grozny,5267,5,9,5,6,23,22,1,32
Krasnodar,5267,6,8,5,7,30,28,2,29
FK Rubin,5267,7,7,5,8,24,18,6,26
Din Moscow,5267,8,5,6,9,20,26,-6,21
Rostov,5267,9,4,6,10,12,20,-8,18
Amkar,5267,10,4,4,12,9,24,-15,16
Anzhi,5267,11,2,5,13,14,40,-26,11
Loko Moscow,5268,1,13,5,2,36,12,24,44
CSKA Moscow,5268,2,11,4,5,28,19,9,37
Krasnodar,5268,3,9,4,7,31,30,1,31
Spart Moscow,5268,4,8,6,6,35,29,6,30
Zenit,5268,5,7,9,4,22,16,6,30
Terek Grozny,5268,6,8,6,6,23,24,-1,30
Din Moscow,5268,7,6,6,8,19,23,-4,24
FK Rubin,5268,8,6,5,9,23,20,3,23
Amkar,5268,9,5,5,10,12,24,-12,20
Rostov,5268,10,4,7,9,10,17,-7,19
Anzhi,5268,11,2,5,13,16,41,-25,11
Loko Moscow,5269,1,11,7,2,32,14,18,40
CSKA Moscow,5269,2,11,3,6,29,18,11,36
Spart Moscow,5269,3,10,5,5,37,27,10,35
Zenit,5269,4,8,9,3,23,14,9,33
Krasnodar,5269,5,8,5,7,29,27,2,29
FK Rubin,5269,6,7,5,8,24,17,7,26
Terek Grozny,5269,7,7,5,8,21,27,-6,26
Rostov,5269,8,5,6,9,12,18,-6,21
Din Moscow,5269,9,5,6,9,17,24,-7,21
Amkar,5269,10,5,4,11,12,24,-12,19
Anzhi,5269,11,3,5,12,16,42,-26,14
Loko Moscow,5270,1,11,6,3,30,14,16,39
CSKA Moscow,5270,2,11,3,6,29,20,9,36
Zenit,5270,3,9,8,3,25,13,12,35
Spart Moscow,5270,4,8,7,5,36,29,7,31
Krasnodar,5270,5,8,5,7,29,28,1,29
Terek Grozny,5270,6,8,5,7,23,26,-3,29
FK Rubin,5270,7,7,5,8,25,18,7,26
Din Moscow,5270,8,5,7,8,18,23,-5,22
Rostov,5270,9,5,6,9,12,18,-6,21
Amkar,5270,10,4,5,11,10,24,-14,17
Anzhi,5270,11,3,5,12,19,43,-24,14
Loko Moscow,5271,1,12,6,2,33,14,19,42
Spart Moscow,5271,2,11,5,4,39,28,11,38
CSKA Moscow,5271,3,10,4,6,26,19,7,34
Zenit,5271,4,7,10,3,22,14,8,31
Krasnodar,5271,5,8,5,7,30,28,2,29
Terek Grozny,5271,6,8,5,7,22,25,-3,29
FK Rubin,5271,7,6,6,8,24,19,5,24
Din Moscow,5271,8,5,6,9,19,25,-6,21
Amkar,5271,9,5,4,11,12,24,-12,19
Rostov,5271,10,4,6,10,11,19,-8,18
Anzhi,5271,11,3,5,12,17,40,-23,14
Loko Moscow,5272,1,11,7,2,30,12,18,40
Spart Moscow,5272,2,10,6,4,41,30,11,36
Zenit,5272,3,8,9,3,23,14,9,33
CSKA Moscow,5272,4,10,3,7,26,22,4,33
Krasnodar,5272,5,8,5,7,28,26,2,29
Terek Grozny,5272,6,7,6,7,21,24,-3,27
Din Moscow,5272,7,6,7,7,21,24,-3,25
FK Rubin,5272,8,6,5,9,23,19,4,23
Amkar,5272,9,5,4,11,11,25,-14,19
Rostov,5272,10,4,6,10,12,20,-8,18
Anzhi,5272,11,3,6,11,18,38,-20,15
Loko Moscow,5273,1,11,6,3,30,14,16,39
CSKA Moscow,5273,2,10,5,5,27,19,8,35
Spart Moscow,5273,3,9,7,4,36,27,9,34
Zenit,5273,4,8,9,3,24,14,10,33
Krasnodar,5273,5,8,6,6,28,25,3,30
Terek Grozny,5273,6,7,6,7,22,26,-4,27
Din Moscow,5273,7,6,6,8,21,24,-3,24
FK Rubin,5273,8,5,6,9,21,19,2,21
Amkar,5273,9,5,5,10,11,22,-11,20
Rostov,5273,10,4,7,9,10,17,-7,19
Anzhi,5273,11,2,7,11,17,40,-23,13
Loko Moscow,5274,1,13,5,2,33,13,20,44
CSKA Moscow,5274,2,11,4,5,29,19,10,37
Spart Moscow,5274,3,8,8,4,37,29,8,32
Zenit,5274,4,7,9,4,24,17,7,30
Terek Grozny,5274,5,8,5,7,21,24,-3,29
Krasnodar,5274,6,8,4,8,30,29,1,28
FK Rubin,5274,7,6,6,8,25,20,5,24
Din Moscow,5274,8,5,8,7,20,24,-4,23
Amkar,5274,9,5,5,10,12,23,-11,20
Rostov,5274,10,4,7,9,11,18,-7,19
Anzhi,5274,11,2,5,13,14,40,-26,11
Loko Moscow,5275,1,11,5,4,31,18,13,38
Spart Moscow,5275,2,11,5,4,38,26,12,38
CSKA Moscow,5275,3,11,3,6,27,19,8,36
Zenit,5275,4,8,8,4,24,16,8,32
Krasnodar,5275,5,9,5,6,32,25,7,32
Terek Grozny,5275,6,7,5,8,21,26,-5,26
FK Rubin,5275,7,5,7,8,22,18,4,22
Din Moscow,5275,8,5,7,8,19,24,-5,22
Amkar,5275,9,5,4,11,11,23,-12,19
Rostov,5275,10,4,6,10,10,19,-9,18
Anzhi,5275,11,4,5,11,17,38,-21,17
Loko Moscow,5276,1,11,7,2,31,13,18,40
CSKA Moscow,5276,2,11,3,6,32,21,11,36
Zenit,5276,3,8,9,3,26,16,10,33
Spart Moscow,5276,4,9,6,5,37,28,9,33
Krasnodar,5276,5,8,5,7,30,28,2,29
Terek Grozny,5276,6,7,5,8,20,27,-7,26
Din Moscow,5276,7,6,7,7,20,23,-3,25
FK Rubin,5276,8,6,5,9,25,21,4,23
Rostov,5276,9,5,6,9,12,18,-6,21
Amkar,5276,10,5,4,11,11,24,-13,19
Anzhi,5276,11,3,5,12,17,42,-25,14
Loko Moscow,5277,1,11,7,2,31,13,18,40
CSKA Moscow,5277,2,11,3,6,30,19,11,36
Spart Moscow,5277,3,10,5,5,40,26,14,35
Zenit,5277,4,8,9,3,24,15,9,33
Krasnodar,5277,5,9,5,6,32,25,7,32
Terek Grozny,5277,6,9,5,6,23,23,0,32
Din Moscow,5277,7,5,7,8,17,23,-6,22
FK Rubin,5277,8,5,6,9,21,21,0,21
Rostov,5277,9,5,6,9,11,17,-6,21
Amkar,5277,10,4,4,12,10,29,-19,16
Anzhi,5277,11,2,5,13,14,42,-28,11
Loko Moscow,5278,1,12,6,2,34,13,21,42
CSKA Moscow,5278,2,12,3,5,28,18,10,39
Spart Moscow,5278,3,10,6,4,38,26,12,36
Krasnodar,5278,4,9,4,7,29,28,1,31
Zenit,5278,5,7,9,4,22,15,7,30
Terek Grozny,5278,6,7,5,8,21,27,-6,26
Din Moscow,5278,7,5,8,7,18,22,-4,23
FK Rubin,5278,8,5,6,9,21,18,3,21
Amkar,5278,9,5,4,11,11,24,-13,19
Rostov,5278,10,4,6,10,10,19,-9,18
Anzhi,5278,11,3,5,12,18,40,-22,14
Loko Moscow,5279,1,11,6,3,31,15,16,39
CSKA Moscow,5279,2,11,3,6,28,20,8,36
Zenit,5279,3,9,8,3,26,13,13,35
Spart Moscow,5279,4,9,6,5,37,28,9,33
Terek Grozny,5279,5,8,6,6,22,23,-1,30
Krasnodar,5279,6,8,5,7,29,30,-1,29
FK Rubin,5279,7,6,6,8,25,17,8,24
Din Moscow,5279,8,5,8,7,18,22,-4,23
Amkar,5279,9,5,5,10,12,24,-12,20
Rostov,5279,10,4,6,10,10,19,-9,18
Anzhi,5279,11,2,5,13,14,41,-27,11
Loko Moscow,5280,1,11,7,2,30,12,18,40
Spart Moscow,5280,2,11,5,4,38,27,11,38
CSKA Moscow,5280,3,11,3,6,26,18,8,36
Zenit,5280,4,8,9,3,23,14,9,33
Krasnodar,5280,5,9,5,6,29,24,5,32
Terek Grozny,5280,6,8,6,6,21,22,-1,30
Din Moscow,5280,7,6,6,8,19,23,-4,24
FK Rubin,5280,8,5,5,10,22,21,1,20
Rostov,5280,9,4,6,10,10,18,-8,18
Amkar,5280,10,4,5,11,11,25,-14,17
Anzhi,5280,11,2,5,13,14,39,-25,11
Loko Moscow,5281,1,13,5,2,34,13,21,44
CSKA Moscow,5281,2,11,3,6,27,22,5,36
Spart Moscow,5281,3,9,7,4,38,29,9,34
Zenit,5281,4,8,8,4,26,15,11,32
Krasnodar,5281,5,8,4,8,29,30,-1,28
Terek Grozny,5281,6,7,7,6,23,25,-2,28
FK Rubin,5281,7,7,5,8,25,18,7,26
Din Moscow,5281,8,5,7,8,20,25,-5,22
Rostov,5281,9,4,6,10,10,18,-8,18
Amkar,5281,10,4,6,10,11,24,-13,18
Anzhi,5281,11,2,6,12,17,41,-24,12
Loko Moscow,5282,1,12,6,2,33,14,19,42
CSKA Moscow,5282,2,11,4,5,30,17,13,37
Spart Moscow,5282,3,8,7,5,35,28,7,31
Zenit,5282,4,7,9,4,21,14,7,30
Terek Grozny,5282,5,8,6,6,25,26,-1,30
Krasnodar,5282,6,8,5,7,31,29,2,29
FK Rubin,5282,7,6,6,8,23,18,5,24
Din Moscow,5282,8,5,8,7,17,21,-4,23
Rostov,5282,9,5,6,9,12,18,-6,21
Amkar,5282,10,4,6,10,12,25,-13,18
Anzhi,5282,11,2,5,13,16,45,-29,11
Loko Moscow,5283,1,12,5,3,31,13,18,41
Spart Moscow,5283,2,10,6,4,38,26,12,36
CSKA Moscow,5283,3,11,3,6,26,18,8,36
Krasnodar,5283,4,9,4,7,29,26,3,31
Zenit,5283,5,7,8,5,21,15,6,29
Terek Grozny,5283,6,8,5,7,22,24,-2,29
FK Rubin,5283,7,7,5,8,24,17,7,26
Din Moscow,5283,8,5,6,9,17,26,-9,21
Amkar,5283,9,5,5,10,12,24,-12,20
Rostov,5283,10,4,6,10,10,18,-8,18
Anzhi,5283,11,3,5,12,15,38,-23,14
Loko Moscow,5284,1,12,5,3,30,13,17,41
CSKA Moscow,5284,2,11,4,5,27,18,9,37
Krasnodar,5284,3,10,4,6,32,25,7,34
Spart Moscow,5284,4,8,6,6,35,30,5,30
Terek Grozny,5284,5,8,6,6,23,23,0,30
Zenit,5284,6,7,8,5,21,15,6,29
Din Moscow,5284,7,6,6,8,18,23,-5,24
FK Rubin,5284,8,6,5,9,24,20,4,23
Rostov,5284,9,5,6,9,12,17,-5,21
Amkar,5284,10,4,5,11,11,26,-15,17
Anzhi,5284,11,2,7,11,16,39,-23,13
Loko Moscow,5285,1,12,6,2,31,12,19,42
CSKA Moscow,5285,2,12,3,5,33,18,15,39
Spart Moscow,5285,3,10,6,4,41,26,15,36
Krasnodar,5285,4,9,4,7,32,26,6,31
Zenit,5285,5,7,9,4,21,16,5,30
Terek Grozny,5285,6,8,5,7,22,24,-2,29
Din Moscow,5285,7,6,6,8,19,27,-8,24
FK Rubin,5285,8,5,5,10,22,23,-1,20
Rostov,5285,9,4,7,9,10,17,-7,19
Amkar,5285,10,5,4,11,11,25,-14,19
Anzhi,5285,11,2,5,13,16,44,-28,11
Loko Moscow,5286,1,12,5,3,31,13,18,41
CSKA Moscow,5286,2,11,4,5,27,17,10,37
Spart Moscow,5286,3,10,5,5,38,27,11,35
Zenit,5286,4,8,9,3,23,14,9,33
Krasnodar,5286,5,9,4,7,29,26,3,31
Terek Grozny,5286,6,7,6,7,20,23,-3,27
Din Moscow,5286,7,5,7,8,17,24,-7,22
Amkar,5286,8,6,4,10,11,22,-11,22
FK Rubin,5286,9,5,6,9,22,19,3,21
Rostov,5286,10,4,6,10,11,19,-8,18
Anzhi,5286,11,2,6,12,14,39,-25,12
Loko Moscow,5287,1,12,5,3,32,14,18,41
CSKA Moscow,5287,2,12,3,5,29,17,12,39
Krasnodar,5287,3,10,4,6,32,26,6,34
Spart Moscow,5287,4,8,6,6,34,29,5,30
Terek Grozny,5287,5,8,6,6,25,24,1,30
Zenit,5287,6,7,8,5,22,19,3,29
Din Moscow,5287,7,6,7,7,19,22,-3,25
Rostov,5287,8,5,6,9,11,17,-6,21
FK Rubin,5287,9,5,5,10,23,21,2,20
Amkar,5287,10,5,5,10,13,24,-11,20
Anzhi,5287,11,2,5,13,14,41,-27,11
Loko Moscow,5288,1,12,5,3,31,13,18,41
Spart Moscow,5288,2,10,6,4,38,27,11,36
CSKA Moscow,5288,3,10,5,5,26,18,8,35
Krasnodar,5288,4,9,4,7,29,26,3,31
Zenit,5288,5,7,9,4,22,15,7,30
Terek Grozny,5288,6,7,6,7,24,27,-3,27
FK Rubin,5288,7,6,6,8,25,20,5,24
Din Moscow,5288,8,5,7,8,21,26,-5,22
Amkar,5288,9,5,5,10,13,25,-12,20
Rostov,5288,10,4,6,10,10,19,-9,18
Anzhi,5288,11,2,7,11,16,39,-23,13
Loko Moscow,5289,1,12,6,2,32,11,21,42
CSKA Moscow,5289,2,11,3,6,28,22,6,36
Zenit,5289,3,8,9,3,25,14,11,33
Spart Moscow,5289,4,9,6,5,39,30,9,33
Krasnodar,5289,5,8,5,7,28,28,0,29
Terek Grozny,5289,6,7,5,8,20,26,-6,26
FK Rubin,5289,7,5,7,8,23,19,4,22
Din Moscow,5289,8,5,7,8,19,26,-7,22
Amkar,5289,9,6,4,10,14,23,-9,22
Rostov,5289,10,4,7,9,11,18,-7,19
Anzhi,5289,11,3,5,12,17,39,-22,14
Loko Moscow,5290,1,11,7,2,33,15,18,40
CSKA Moscow,5290,2,11,3,6,29,19,10,36
Zenit,5290,3,8,9,3,23,14,9,33
Spart Moscow,5290,4,8,6,6,35,31,4,30
Krasnodar,5290,5,8,5,7,31,29,2,29
Terek Grozny,5290,6,7,5,8,22,26,-4,26
Din Moscow,5290,7,6,7,7,20,22,-2,25
FK Rubin,5290,8,6,6,8,24,19,5,24
Rostov,5290,9,5,6,9,12,17,-5,21
Amkar,5290,10,5,5,10,13,25,-12,20
Anzhi,5290,11,3,5,12,17,42,-25,14
Loko Moscow,5291,1,11,6,3,31,15,16,39
CSKA Moscow,5291,2,12,3,5,28,18,10,39
Spart Moscow,5291,3,10,6,4,40,28,12,36
Krasnodar,5291,4,10,4,6,32,25,7,34
Zenit,5291,5,7,9,4,22,15,7,30
Terek Grozny,5291,6,8,5,7,22,25,-3,29
Din Moscow,5291,7,5,7,8,18,23,-5,22
FK Rubin,5291,8,5,6,9,21,19,2,21
Rostov,5291,9,4,7,9,11,18,-7,19
Amkar,5291,10,4,4,12,10,27,-17,16
Anzhi,5291,11,3,5,12,18,40,-22,14
Loko Moscow,5292,1,12,5,3,32,13,19,41
CSKA Moscow,5292,2,11,3,6,28,19,9,36
Spart Moscow,5292,3,9,6,5,37,28,9,33
Zenit,5292,4,8,8,4,23,15,8,32
Krasnodar,5292,5,9,5,6,30,26,4,32
Terek Grozny,5292,6,7,5,8,21,26,-5,26
FK Rubin,5292,7,6,6,8,23,18,5,24
Amkar,5292,8,6,4,10,13,24,-11,22
Din Moscow,5292,9,5,6,9,18,25,-7,21
Rostov,5292,10,4,7,9,10,17,-7,19
Anzhi,5292,11,3,5,12,16,40,-24,14
Loko Moscow,5293,1,12,6,2,33,14,19,42
Spart Moscow,5293,2,10,6,4,36,26,10,36
CSKA Moscow,5293,3,10,4,6,25,18,7,34
Zenit,5293,4,7,10,3,23,15,8,31
Krasnodar,5293,5,9,4,7,29,26,3,31
Terek Grozny,5293,6,8,5,7,23,25,-2,29
Din Moscow,5293,7,6,7,7,21,24,-3,25
FK Rubin,5293,8,5,5,10,23,21,2,20
Amkar,5293,9,5,4,11,11,23,-12,19
Rostov,5293,10,4,6,10,10,18,-8,18
Anzhi,5293,11,3,5,12,16,40,-24,14
Loko Moscow,5294,1,11,6,3,31,14,17,39
Spart Moscow,5294,2,10,5,5,40,26,14,35
CSKA Moscow,5294,3,10,5,5,28,20,8,35
Terek Grozny,5294,4,9,5,6,24,23,1,32
Zenit,5294,5,7,10,3,25,17,8,31
Krasnodar,5294,6,9,4,7,28,27,1,31
FK Rubin,5294,7,6,6,8,25,18,7,24
Din Moscow,5294,8,5,7,8,18,26,-8,22
Amkar,5294,9,5,4,11,10,23,-13,19
Rostov,5294,10,4,6,10,10,20,-10,18
Anzhi,5294,11,2,6,12,16,41,-25,12
Loko Moscow,5295,1,11,6,3,31,14,17,39
CSKA Moscow,5295,2,12,3,5,29,18,11,39
Spart Moscow,5295,3,10,5,5,37,27,10,35
Krasnodar,5295,4,9,4,7,31,28,3,31
Zenit,5295,5,7,9,4,23,16,7,30
Terek Grozny,5295,6,8,6,6,22,22,0,30
Din Moscow,5295,7,7,6,7,20,22,-2,27
FK Rubin,5295,8,6,5,9,25,21,4,23
Rostov,5295,9,4,6,10,10,19,-9,18
Amkar,5295,10,4,4,12,10,26,-16,16
Anzhi,5295,11,2,6,12,14,39,-25,12
Loko Moscow,5296,1,13,5,2,33,11,22,44
CSKA Moscow,5296,2,10,4,6,27,20,7,34
Zenit,5296,3,8,8,4,23,15,8,32
Spart Moscow,5296,4,9,5,6,34,27,7,32
Terek Grozny,5296,5,9,5,6,26,23,3,32
Krasnodar,5296,6,9,4,7,28,27,1,31
Din Moscow,5296,7,5,7,8,18,23,-5,22
FK Rubin,5296,8,5,6,9,22,19,3,21
Rostov,5296,9,5,6,9,11,17,-6,21
Amkar,5296,10,5,4,11,10,25,-15,19
Anzhi,5296,11,2,6,12,16,41,-25,12
Loko Moscow,5297,1,12,6,2,33,13,20,42
Spart Moscow,5297,2,10,6,4,38,26,12,36
CSKA Moscow,5297,3,10,4,6,26,19,7,34
Zenit,5297,4,8,9,3,24,15,9,33
Krasnodar,5297,5,8,5,7,28,27,1,29
Terek Grozny,5297,6,7,5,8,21,25,-4,26
Din Moscow,5297,7,6,6,8,18,24,-6,24
FK Rubin,5297,8,5,6,9,22,19,3,21
Amkar,5297,9,5,5,10,12,24,-12,20
Rostov,5297,10,4,6,10,10,18,-8,18
Anzhi,5297,11,3,6,11,16,38,-22,15
Loko Moscow,5298,1,12,6,2,30,11,19,42
Spart Moscow,5298,2,11,5,4,38,26,12,38
CSKA Moscow,5298,3,10,3,7,26,21,5,33
Zenit,5298,4,8,8,4,23,14,9,32
Krasnodar,5298,5,9,5,6,29,24,5,32
Terek Grozny,5298,6,7,5,8,21,26,-5,26
Din Moscow,5298,7,6,6,8,18,23,-5,24
FK Rubin,5298,8,5,5,10,21,20,1,20
Amkar,5298,9,5,4,11,11,24,-13,19
Rostov,5298,10,4,6,10,11,19,-8,18
Anzhi,5298,11,4,5,11,18,38,-20,17
Loko Moscow,5299,1,11,6,3,29,12,17,39
CSKA Moscow,5299,2,11,4,5,26,17,9,37
Spart Moscow,5299,3,10,5,5,37,28,9,35
Zenit,5299,4,8,9,3,22,13,9,33
Krasnodar,5299,5,9,5,6,29,25,4,32
Terek Grozny,5299,6,8,6,6,22,23,-1,30
Din Moscow,5299,7,6,7,7,20,23,-3,25
FK Rubin,5299,8,5,6,9,23,20,3,21
Rostov,5299,9,4,6,10,10,18,-8,18
Amkar,5299,10,4,5,11,11,25,-14,17
Anzhi,5299,11,2,5,13,14,39,-25,11
Loko Moscow,5300,1,12,5,3,30,12,18,41
Spart Moscow,5300,2,11,5,4,41,27,14,38
CSKA Moscow,5300,3,10,4,6,26,19,7,34
Zenit,5300,4,8,8,4,23,15,8,32
Krasnodar,5300,5,9,4,7,28,25,3,31
FK Rubin,5300,6,7,5,8,23,17,6,26
Terek Grozny,5300,7,7,5,8,21,25,-4,26
Din Moscow,5300,8,5,6,9,17,25,-8,21
Amkar,5300,9,5,4,11,12,25,-13,19
Rostov,5300,10,4,6,10,11,20,-9,18
Anzhi,5300,11,3,6,11,15,37,-22,15
Loko Moscow,5301,1,13,5,2,35,12,23,44
Spart Moscow,5301,2,9,7,4,38,27,11,34
CSKA Moscow,5301,3,10,4,6,28,22,6,34
Zenit,5301,4,8,8,4,25,19,6,32
Krasnodar,5301,5,9,4,7,29,25,4,31
Terek Grozny,5301,6,8,6,6,27,25,2,30
FK Rubin,5301,7,6,5,9,23,20,3,23
Din Moscow,5301,8,5,7,8,19,24,-5,22
Rostov,5301,9,4,7,9,10,17,-7,19
Amkar,5301,10,4,5,11,12,28,-16,17
Anzhi,5301,11,2,6,12,17,44,-27,12
Loko Moscow,5302,1,11,5,4,31,16,15,38
CSKA Moscow,5302,2,11,4,5,27,18,9,37
Zenit,5302,3,8,9,3,24,14,10,33
Spart Moscow,5302,4,9,6,5,35,27,8,33
Krasnodar,5302,5,9,4,7,30,29,1,31
Terek Grozny,5302,6,8,5,7,21,24,-3,29
Din Moscow,5302,7,6,7,7,18,21,-3,25
FK Rubin,5302,8,6,5,9,24,18,6,23
Amkar,5302,9,5,4,11,11,23,-12,19
Rostov,5302,10,4,6,10,10,19,-9,18
Anzhi,5302,11,3,5,12,16,38,-22,14
Loko Moscow,5303,1,11,6,3,29,13,16,39
Spart Moscow,5303,2,11,5,4,40,26,14,38
CSKA Moscow,5303,3,11,4,5,28,19,9,37
Krasnodar,5303,4,10,4,6,31,24,7,34
Zenit,5303,5,7,10,3,22,14,8,31
Terek Grozny,5303,6,8,6,6,22,22,0,30
Din Moscow,5303,7,6,6,8,18,22,-4,24
FK Rubin,5303,8,5,5,10,21,20,1,20
Rostov,5303,9,4,6,10,10,21,-11,18
Amkar,5303,10,4,5,11,10,24,-14,17
Anzhi,5303,11,2,5,13,15,41,-26,11
Loko Moscow,5304,1,12,5,3,30,12,18,41
CSKA Moscow,5304,2,10,4,6,26,19,7,34
Zenit,5304,3,8,8,4,22,14,8,32
Spart Moscow,5304,4,8,7,5,36,29,7,31
Krasnodar,5304,5,9,4,7,28,25,3,31
Din Moscow,5304,6,7,6,7,22,23,-1,27
Terek Grozny,5304,7,7,5,8,20,25,-5,26
FK Rubin,5304,8,6,5,9,22,19,3,23
Amkar,5304,9,5,5,10,10,22,-12,20
Rostov,5304,10,4,7,9,11,18,-7,19
Anzhi,5304,11,3,6,11,17,38,-21,15
Loko Moscow,5305,1,11,5,4,30,18,12,38
Spart Moscow,5305,2,10,6,4,41,28,13,36
CSKA Moscow,5305,3,11,3,6,27,18,9,36
Zenit,5305,4,9,8,3,27,14,13,35
Krasnodar,5305,5,9,4,7,29,25,4,31
Terek Grozny,5305,6,8,5,7,21,23,-2,29
FK Rubin,5305,7,7,5,8,24,17,7,26
Din Moscow,5305,8,5,6,9,18,26,-8,21
Rostov,5305,9,4,7,9,12,19,-7,19
Amkar,5305,10,5,4,11,10,25,-15,19
Anzhi,5305,11,2,5,13,14,40,-26,11
Loko Moscow,5306,1,13,5,2,33,12,21,44
CSKA Moscow,5306,2,10,4,6,26,21,5,34
Spart Moscow,5306,3,9,6,5,36,28,8,33
Zenit,5306,4,8,8,4,24,14,10,32
Terek Grozny,5306,5,8,5,7,21,25,-4,29
Krasnodar,5306,6,8,4,8,28,29,-1,28
Din Moscow,5306,7,7,6,7,23,22,1,27
FK Rubin,5306,8,6,5,9,24,21,3,23
Rostov,5306,9,4,6,10,10,19,-9,18
Amkar,5306,10,4,5,11,10,24,-14,17
Anzhi,5306,11,3,6,11,18,38,-20,15
Loko Moscow,5307,1,12,6,2,31,12,19,42
CSKA Moscow,5307,2,11,4,5,27,17,10,37
Spart Moscow,5307,3,10,6,4,36,25,11,36
Zenit,5307,4,7,10,3,22,14,8,31
Terek Grozny,5307,5,8,6,6,23,22,1,30
Krasnodar,5307,6,8,4,8,27,26,1,28
Din Moscow,5307,7,6,6,8,19,22,-3,24
FK Rubin,5307,8,6,5,9,22,19,3,23
Rostov,5307,9,4,6,10,10,19,-9,18
Amkar,5307,10,4,6,10,9,22,-13,18
Anzhi,5307,11,2,5,13,14,42,-28,11
Loko Moscow,5308,1,12,5,3,33,15,18,41
CSKA Moscow,5308,2,11,4,5,30,20,10,37
Krasnodar,5308,3,10,4,6,32,25,7,34
Terek Grozny,5308,4,9,5,6,25,22,3,32
Spart Moscow,5308,5,8,7,5,38,31,7,31
Zenit,5308,6,7,9,4,23,18,5,30
Din Moscow,5308,7,6,7,7,19,22,-3,25
Rostov,5308,8,5,6,9,13,19,-6,21
FK Rubin,5308,9,5,5,10,21,19,2,20
Amkar,5308,10,4,5,11,11,26,-15,17
Anzhi,5308,11,2,5,13,15,43,-28,11
Loko Moscow,5309,1,12,6,2,31,12,19,42
CSKA Moscow,5309,2,10,4,6,28,21,7,34
Spart Moscow,5309,3,9,5,6,37,31,6,32
Krasnodar,5309,4,9,5,6,30,26,4,32
Zenit,5309,5,7,9,4,23,16,7,30
Terek Grozny,5309,6,8,5,7,26,26,0,29
FK Rubin,5309,7,6,5,9,23,19,4,23
Rostov,5309,8,5,6,9,13,19,-6,21
Din Moscow,5309,9,5,6,9,17,24,-7,21
Amkar,5309,10,5,4,11,12,26,-14,19
Anzhi,5309,11,4,5,11,20,40,-20,17
Loko Moscow,5310,1,12,6,2,30,11,19,42
CSKA Moscow,5310,2,11,3,6,29,21,8,36
Spart Moscow,5310,3,9,6,5,36,28,8,33
Zenit,5310,4,8,8,4,24,15,9,32
Krasnodar,5310,5,9,5,6,29,25,4,32
Terek Grozny,5310,6,9,5,6,25,23,2,32
Din Moscow,5310,7,5,8,7,18,22,-4,23
FK Rubin,5310,8,5,6,9,22,19,3,21
Amkar,5310,9,5,4,11,10,25,-15,19
Rostov,5310,10,4,6,10,11,19,-8,18
Anzhi,5310,11,2,5,13,16,42,-26,11
Loko Moscow,5311,1,11,6,3,30,13,17,39
CSKA Moscow,5311,2,11,3,6,28,19,9,36
Spart Moscow,5311,3,10,5,5,40,28,12,35
Krasnodar,5311,4,9,4,7,28,25,3,31
Zenit,5311,5,7,9,4,23,17,6,30
Terek Grozny,5311,6,8,5,7,21,23,-2,29
Din Moscow,5311,7,6,7,7,19,22,-3,25
FK Rubin,5311,8,6,6,8,22,17,5,24
Amkar,5311,9,5,4,11,10,25,-15,19
Rostov,5311,10,4,6,10,11,20,-9,18
Anzhi,5311,11,3,5,12,15,38,-23,14
Loko Moscow,5312,1,12,5,3,33,13,20,41
Spart Moscow,5312,2,10,5,5,37,28,9,35
CSKA Moscow,5312,3,10,3,7,27,22,5,33
Zenit,5312,4,8,8,4,23,17,6,32
Krasnodar,5312,5,9,4,7,29,26,3,31
Terek Grozny,5312,6,8,6,6,22,23,-1,30
Din Moscow,5312,7,6,6,8,21,22,-1,24
FK Rubin,5312,8,6,5,9,22,21,1,23
Amkar,5312,9,5,4,11,11,24,-13,19
Rostov,5312,10,4,6,10,11,19,-8,18
Anzhi,5312,11,3,6,11,18,39,-21,15
Loko Moscow,5313,1,11,5,4,30,17,13,38
Spart Moscow,5313,2,10,6,4,37,27,10,36
CSKA Moscow,5313,3,11,3,6,30,20,10,36
Zenit,5313,4,9,8,3,27,14,13,35
Krasnodar,5313,5,9,4,7,29,26,3,31
FK Rubin,5313,6,7,5,8,25,17,8,26
Terek Grozny,5313,7,7,5,8,20,27,-7,26
Din Moscow,5313,8,5,6,9,17,25,-8,21
Amkar,5313,9,5,5,10,12,23,-11,20
Rostov,5313,10,4,6,10,11,19,-8,18
Anzhi,5313,11,3,5,12,18,41,-23,14
Loko Moscow,5314,1,12,5,3,32,13,19,41
Spart Moscow,5314,2,10,6,4,40,29,11,36
CSKA Moscow,5314,3,11,3,6,27,19,8,36
Zenit,5314,4,9,8,3,24,14,10,35
Terek Grozny,5314,5,8,6,6,23,23,0,30
Krasnodar,5314,6,8,5,7,28,27,1,29
Din Moscow,5314,7,6,6,8,19,24,-5,24
FK Rubin,5314,8,5,6,9,22,19,3,21
Rostov,5314,9,4,7,9,11,18,-7,19
Amkar,5314,10,4,4,12,12,28,-16,16
Anzhi,5314,11,2,6,12,15,39,-24,12
Loko Moscow,5315,1,11,6,3,31,16,15,39
CSKA Moscow,5315,2,11,4,5,27,17,10,37
Spart Moscow,5315,3,10,5,5,39,26,13,35
Krasnodar,5315,4,9,5,6,33,27,6,32
Zenit,5315,5,7,9,4,22,16,6,30
Terek Grozny,5315,6,8,5,7,23,24,-1,29
FK Rubin,5315,7,6,6,8,25,20,5,24
Rostov,5315,8,5,6,9,11,17,-6,21
Din Moscow,5315,9,5,6,9,18,26,-8,21
Amkar,5315,10,5,4,11,11,26,-15,19
Anzhi,5315,11,2,6,12,14,39,-25,12
Loko Moscow,5316,1,12,6,2,33,11,22,42
CSKA Moscow,5316,2,11,3,6,28,19,9,36
Zenit,5316,3,8,9,3,23,13,10,33
Spart Moscow,5316,4,8,8,4,35,27,8,32
Krasnodar,5316,5,9,4,7,30,28,2,31
Terek Grozny,5316,6,7,7,6,21,23,-2,28
Din Moscow,5316,7,5,8,7,19,23,-4,23
FK Rubin,5316,8,5,6,9,22,21,1,21
Rostov,5316,9,4,7,9,10,17,-7,19
Amkar,5316,10,4,6,10,10,23,-13,18
Anzhi,5316,11,2,6,12,15,41,-26,12
Loko Moscow,5317,1,11,7,2,30,12,18,40
Spart Moscow,5317,2,10,6,4,38,27,11,36
CSKA Moscow,5317,3,10,5,5,27,19,8,35
Krasnodar,5317,4,9,5,6,32,26,6,32
Zenit,5317,5,7,10,3,22,14,8,31
Terek Grozny,5317,6,8,5,7,23,26,-3,29
Din Moscow,5317,7,5,7,8,17,23,-6,22
FK Rubin,5317,8,5,6,9,22,21,1,21
Amkar,5317,9,5,5,10,12,23,-11,20
Rostov,5317,10,4,6,10,12,20,-8,18
Anzhi,5317,11,2,6,12,16,40,-24,12
Loko Moscow,5318,1,13,5,2,34,12,22,44
Spart Moscow,5318,2,11,5,4,42,25,17,38
CSKA Moscow,5318,3,11,4,5,31,19,12,37
Zenit,5318,4,7,9,4,23,16,7,30
Terek Grozny,5318,5,7,7,6,21,23,-2,28
Krasnodar,5318,6,8,4,8,28,32,-4,28
FK Rubin,5318,7,6,6,8,26,18,8,24
Din Moscow,5318,8,5,7,8,18,24,-6,22
Rostov,5318,9,4,6,10,10,21,-11,18
Amkar,5318,10,4,5,11,9,25,-16,17
Anzhi,5318,11,2,6,12,15,42,-27,12
Loko Moscow,5319,1,11,5,4,29,13,16,38
Zenit,5319,2,9,8,3,25,14,11,35
CSKA Moscow,5319,3,10,4,6,27,21,6,34
Spart Moscow,5319,4,9,6,5,35,27,8,33
Krasnodar,5319,5,9,5,6,29,25,4,32
Terek Grozny,5319,6,7,6,7,22,25,-3,27
Din Moscow,5319,7,6,7,7,18,21,-3,25
FK Rubin,5319,8,5,7,8,22,18,4,22
Amkar,5319,9,5,5,10,11,23,-12,20
Rostov,5319,10,4,6,10,10,18,-8,18
Anzhi,5319,11,2,7,11,17,40,-23,13
Loko Moscow,5320,1,11,6,3,30,13,17,39
CSKA Moscow,5320,2,11,3,6,31,18,13,36
Krasnodar,5320,3,10,4,6,29,24,5,34
Zenit,5320,4,8,9,3,23,14,9,33
Spart Moscow,5320,5,9,5,6,36,30,6,32
Terek Grozny,5320,6,9,5,6,22,22,0,32
Din Moscow,5320,7,7,6,7,20,21,-1,27
FK Rubin,5320,8,5,5,10,21,19,2,20
Amkar,5320,9,5,4,11,12,24,-12,19
Rostov,5320,10,4,6,10,10,19,-9,18
Anzhi,5320,11,2,5,13,14,44,-30,11
Loko Moscow,5321,1,12,6,2,31,11,20,42
CSKA Moscow,5321,2,12,3,5,33,18,15,39
Spart Moscow,5321,3,10,5,5,36,28,8,35
Krasnodar,5321,4,8,6,6,29,26,3,30
Terek Grozny,5321,5,8,6,6,23,23,0,30
Zenit,5321,6,7,8,5,22,17,5,29
Din Moscow,5321,7,6,6,8,18,22,-4,24
FK Rubin,5321,8,5,6,9,23,20,3,21
Amkar,5321,9,5,4,11,12,25,-13,19
Rostov,5321,10,4,6,10,10,18,-8,18
Anzhi,5321,11,2,6,12,15,44,-29,12
Loko Moscow,5322,1,12,6,2,32,13,19,42
CSKA Moscow,5322,2,11,4,5,30,17,13,37
Spart Moscow,5322,3,10,6,4,39,29,10,36
Zenit,5322,4,7,9,4,22,15,7,30
Krasnodar,5322,5,8,6,6,29,26,3,30
Terek Grozny,5322,6,7,7,6,22,24,-2,28
FK Rubin,5322,7,6,6,8,24,19,5,24
Din Moscow,5322,8,5,6,9,20,26,-6,21
Rostov,5322,9,4,6,10,10,18,-8,18
Amkar,5322,10,4,6,10,13,26,-13,18
Anzhi,5322,11,2,6,12,14,42,-28,12
Loko Moscow,5323,1,11,7,2,32,14,18,40
CSKA Moscow,5323,2,11,4,5,28,19,9,37
Spart Moscow,5323,3,10,6,4,39,28,11,36
Terek Grozny,5323,4,9,5,6,22,22,0,32
Zenit,5323,5,7,10,3,23,15,8,31
Krasnodar,5323,6,8,6,6,30,27,3,30
FK Rubin,5323,7,5,7,8,22,18,4,22
Din Moscow,5323,8,5,7,8,19,25,-6,22
Rostov,5323,9,4,7,9,11,18,-7,19
Amkar,5323,10,4,4,12,9,24,-15,16
Anzhi,5323,11,2,5,13,15,40,-25,11
Loko Moscow,5324,1,13,5,2,34,12,22,44
CSKA Moscow,5324,2,12,3,5,30,17,13,39
Spart Moscow,5324,3,11,5,4,43,25,18,38
Terek Grozny,5324,4,9,5,6,25,23,2,32
Krasnodar,5324,5,9,4,7,31,26,5,31
Zenit,5324,6,7,8,5,21,17,4,29
Din Moscow,5324,7,5,7,8,18,25,-7,22
FK Rubin,5324,8,5,6,9,22,21,1,21
Rostov,5324,9,4,6,10,10,21,-11,18
Amkar,5324,10,4,4,12,10,27,-17,16
Anzhi,5324,11,2,5,13,14,44,-30,11
Loko Moscow,5325,1,12,5,3,31,13,18,41
CSKA Moscow,5325,2,11,4,5,30,19,11,37
Spart Moscow,5325,3,10,5,5,37,29,8,35
Zenit,5325,4,8,9,3,25,15,10,33
Terek Grozny,5325,5,8,5,7,22,26,-4,29
Krasnodar,5325,6,8,4,8,28,28,0,28
FK Rubin,5325,7,6,6,8,25,20,5,24
Din Moscow,5325,8,5,7,8,20,25,-5,22
Rostov,5325,9,5,6,9,13,18,-5,21
Amkar,5325,10,5,4,11,13,24,-11,19
Anzhi,5325,11,2,5,13,14,41,-27,11
CSKA Moscow,5326,1,12,3,5,29,18,11,39
Loko Moscow,5326,2,11,5,4,29,13,16,38
Krasnodar,5326,3,10,4,6,31,25,6,34
Zenit,5326,4,8,8,4,22,14,8,32
Spart Moscow,5326,5,8,7,5,35,28,7,31
Terek Grozny,5326,6,7,6,7,20,24,-4,27
Din Moscow,5326,7,6,7,7,19,22,-3,25
FK Rubin,5326,8,5,5,10,23,22,1,20
Amkar,5326,9,5,5,10,10,22,-12,20
Rostov,5326,10,4,7,9,12,19,-7,19
Anzhi,5326,11,3,5,12,17,40,-23,14
Loko Moscow,5327,1,12,6,2,30,11,19,42
Spart Moscow,5327,2,10,6,4,37,26,11,36
CSKA Moscow,5327,3,11,3,6,29,19,10,36
Zenit,5327,4,8,9,3,23,14,9,33
Krasnodar,5327,5,9,4,7,29,25,4,31
Terek Grozny,5327,6,8,6,6,25,26,-1,30
Din Moscow,5327,7,6,6,8,19,22,-3,24
FK Rubin,5327,8,5,5,10,21,21,0,20
Rostov,5327,9,4,6,10,11,20,-9,18
Amkar,5327,10,4,6,10,11,24,-13,18
Anzhi,5327,11,2,5,13,16,43,-27,11
Loko Moscow,5328,1,11,7,2,30,12,18,40
CSKA Moscow,5328,2,10,5,5,29,21,8,35
Zenit,5328,3,7,10,3,23,15,8,31
Spart Moscow,5328,4,8,7,5,33,27,6,31
Krasnodar,5328,5,8,6,6,29,26,3,30
Din Moscow,5328,6,7,6,7,22,21,1,27
Terek Grozny,5328,7,7,5,8,21,25,-4,26
FK Rubin,5328,8,5,6,9,22,21,1,21
Amkar,5328,9,5,5,10,10,22,-12,20
Rostov,5328,10,4,7,9,10,17,-7,19
Anzhi,5328,11,3,6,11,18,40,-22,15
Loko Moscow,5329,1,12,5,3,32,12,20,41
CSKA Moscow,5329,2,11,4,5,26,17,9,37
Spart Moscow,5329,3,9,5,6,37,30,7,32
Krasnodar,5329,4,9,5,6,29,25,4,32
Zenit,5329,5,7,9,4,21,16,5,30
Terek Grozny,5329,6,8,5,7,21,26,-5,29
FK Rubin,5329,7,6,6,8,25,18,7,24
Din Moscow,5329,8,6,6,8,18,24,-6,24
Amkar,5329,9,5,4,11,12,25,-13,19
Rostov,5329,10,4,6,10,11,19,-8,18
Anzhi,5329,11,3,5,12,18,38,-20,14
Loko Moscow,5330,1,11,6,3,31,14,17,39
CSKA Moscow,5330,2,11,4,5,28,19,9,37
Spart Moscow,5330,3,9,6,5,39,30,9,33
Zenit,5330,4,8,8,4,24,16,8,32
Krasnodar,5330,5,9,5,6,30,25,5,32
Terek Grozny,5330,6,8,5,7,23,25,-2,29
FK Rubin,5330,7,6,5,9,22,19,3,23
Din Moscow,5330,8,5,7,8,20,25,-5,22
Amkar,5330,9,6,4,10,13,23,-10,22
Rostov,5330,10,4,6,10,10,20,-10,18
Anzhi,5330,11,2,6,12,16,40,-24,12
Loko Moscow,5331,1,12,6,2,31,12,19,42
Spart Moscow,5331,2,10,5,5,41,32,9,35
Zenit,5331,3,8,9,3,24,14,10,33
CSKA Moscow,5331,4,10,3,7,25,20,5,33
Krasnodar,5331,5,8,5,7,27,25,2,29
Terek Grozny,5331,6,7,6,7,22,26,-4,27
FK Rubin,5331,7,6,6,8,23,17,6,24
Din Moscow,5331,8,5,6,9,18,27,-9,21
Amkar,5331,9,5,5,10,15,24,-9,20
Rostov,5331,10,4,6,10,11,20,-9,18
Anzhi,5331,11,4,5,11,18,38,-20,17
Loko Moscow,5332,1,12,5,3,30,13,17,41
Krasnodar,5332,2,10,4,6,31,24,7,34
Spart Moscow,5332,3,9,6,5,36,28,8,33
CSKA Moscow,5332,4,10,3,7,27,23,4,33
Zenit,5332,5,8,8,4,24,14,10,32
Terek Grozny,5332,6,9,5,6,23,23,0,32
FK Rubin,5332,7,6,5,9,22,19,3,23
Din Moscow,5332,8,5,6,9,17,23,-6,21
Rostov,5332,9,5,6,9,12,18,-6,21
Amkar,5332,10,4,5,11,10,24,-14,17
Anzhi,5332,11,3,5,12,18,41,-23,14
Loko Moscow,5333,1,11,5,4,30,15,15,38
Zenit,5333,2,9,8,3,24,13,11,35
Spart Moscow,5333,3,10,5,5,38,29,9,35
Krasnodar,5333,4,10,4,6,33,26,7,34
CSKA Moscow,5333,5,10,4,6,26,20,6,34
Din Moscow,5333,6,7,6,7,21,21,0,27
Terek Grozny,5333,7,7,6,7,21,24,-3,27
FK Rubin,5333,8,5,5,10,22,22,0,20
Rostov,5333,9,4,6,10,10,18,-8,18
Amkar,5333,10,4,5,11,12,27,-15,17
Anzhi,5333,11,3,6,11,16,38,-22,15
Loko Moscow,5334,1,12,6,2,34,14,20,42
CSKA Moscow,5334,2,12,3,5,29,19,10,39
Spart Moscow,5334,3,9,6,5,38,28,10,33
Zenit,5334,4,7,8,5,23,18,5,29
Krasnodar,5334,5,8,5,7,29,28,1,29
Terek Grozny,5334,6,8,5,7,22,25,-3,29
FK Rubin,5334,7,7,5,8,27,19,8,26
Din Moscow,5334,8,6,6,8,21,26,-5,24
Rostov,5334,9,4,7,9,11,18,-7,19
Amkar,5334,10,4,4,12,9,26,-17,16
Anzhi,5334,11,3,5,12,18,40,-22,14
Loko Moscow,5335,1,13,5,2,33,11,22,44
CSKA Moscow,5335,2,11,4,5,29,19,10,37
Spart Moscow,5335,3,10,6,4,40,29,11,36
Terek Grozny,5335,4,8,6,6,22,23,-1,30
Zenit,5335,5,7,8,5,21,17,4,29
Krasnodar,5335,6,8,4,8,27,29,-2,28
FK Rubin,5335,7,6,6,8,24,17,7,24
Din Moscow,5335,8,5,8,7,19,23,-4,23
Rostov,5335,9,4,6,10,12,21,-9,18
Amkar,5335,10,4,4,12,10,25,-15,16
Anzhi,5335,11,2,7,11,16,39,-23,13
Loko Moscow,5336,1,12,5,3,30,12,18,41
Spart Moscow,5336,2,10,6,4,37,26,11,36
CSKA Moscow,5336,3,11,3,6,28,20,8,36
Zenit,5336,4,9,8,3,24,13,11,35
Terek Grozny,5336,5,8,6,6,22,23,-1,30
Krasnodar,5336,6,8,4,8,27,27,0,28
Din Moscow,5336,7,6,6,8,19,23,-4,24
FK Rubin,5336,8,6,5,9,23,19,4,23
Rostov,5336,9,4,6,10,10,18,-8,18
Amkar,5336,10,4,6,10,10,23,-13,18
Anzhi,5336,11,2,5,13,16,42,-26,11
Loko Moscow,5337,1,13,5,2,33,12,21,44
CSKA Moscow,5337,2,11,4,5,27,18,9,37
Spart Moscow,5337,3,9,5,6,38,31,7,32
Terek Grozny,5337,4,9,5,6,23,23,0,32
Krasnodar,5337,5,9,4,7,29,26,3,31
Zenit,5337,6,7,9,4,23,16,7,30
FK Rubin,5337,7,6,5,9,22,19,3,23
Din Moscow,5337,8,5,6,9,19,25,-6,21
Rostov,5337,9,5,6,9,12,18,-6,21
Amkar,5337,10,5,4,11,12,25,-13,19
Anzhi,5337,11,2,5,13,14,39,-25,11
Loko Moscow,5338,1,12,6,2,31,12,19,42
CSKA Moscow,5338,2,10,4,6,26,19,7,34
Zenit,5338,3,8,8,4,23,15,8,32
Krasnodar,5338,4,9,5,6,29,25,4,32
Spart Moscow,5338,5,8,7,5,35,28,7,31
Terek Grozny,5338,6,8,6,6,23,24,-1,30
FK Rubin,5338,7,6,5,9,22,18,4,23
Din Moscow,5338,8,5,7,8,18,23,-5,22
Amkar,5338,9,5,5,10,10,22,-12,20
Rostov,5338,10,4,7,9,11,18,-7,19
Anzhi,5338,11,2,6,12,16,40,-24,12
Loko Moscow,5339,1,11,7,2,29,11,18,40
CSKA Moscow,5339,2,11,3,6,27,19,8,36
Spart Moscow,5339,3,9,7,4,36,26,10,34
Zenit,5339,4,8,9,3,23,14,9,33
Krasnodar,5339,5,9,5,6,28,24,4,32
Terek Grozny,5339,6,7,5,8,22,26,-4,26
Din Moscow,5339,7,5,8,7,18,22,-4,23
FK Rubin,5339,8,5,6,9,22,19,3,21
Amkar,5339,9,5,5,10,12,24,-12,20
Rostov,5339,10,4,6,10,10,19,-9,18
Anzhi,5339,11,3,5,12,16,39,-23,14
Loko Moscow,5340,1,11,6,3,30,13,17,39
CSKA Moscow,5340,2,12,3,5,30,19,11,39
Spart Moscow,5340,3,9,7,4,38,29,9,34
Zenit,5340,4,8,8,4,23,16,7,32
Krasnodar,5340,5,8,5,7,29,27,2,29
Terek Grozny,5340,6,7,6,7,22,25,-3,27
Din Moscow,5340,7,6,7,7,22,24,-2,25
FK Rubin,5340,8,6,5,9,24,21,3,23
Amkar,5340,9,5,5,10,12,24,-12,20
Rostov,5340,10,4,6,10,10,18,-8,18
Anzhi,5340,11,2,6,12,17,41,-24,12
Loko Moscow,5341,1,12,6,2,33,13,20,42
CSKA Moscow,5341,2,11,4,5,28,19,9,37
Spart Moscow,5341,3,10,5,5,37,27,10,35
Krasnodar,5341,4,9,4,7,30,27,3,31
Zenit,5341,5,7,9,4,23,16,7,30
Terek Grozny,5341,6,8,5,7,21,23,-2,29
Din Moscow,5341,7,6,6,8,18,23,-5,24
FK Rubin,5341,8,6,5,9,23,19,4,23
Rostov,5341,9,4,6,10,11,19,-8,18
Amkar,5341,10,4,4,12,9,25,-16,16
Anzhi,5341,11,3,6,11,16,38,-22,15
Loko Moscow,5342,1,11,5,4,29,14,15,38
CSKA Moscow,5342,2,11,4,5,27,18,9,37
Spart Moscow,5342,3,10,6,4,38,28,10,36
Krasnodar,5342,4,10,4,6,31,24,7,34
Zenit,5342,5,8,8,4,22,14,8,32
Terek Grozny,5342,6,7,7,6,22,24,-2,28
Din Moscow,5342,7,6,7,7,19,22,-3,25
FK Rubin,5342,8,5,5,10,21,20,1,20
Rostov,5342,9,4,6,10,12,20,-8,18
Amkar,5342,10,4,5,11,9,23,-14,17
Anzhi,5342,11,2,7,11,17,40,-23,13
Loko Moscow,5343,1,12,6,2,30,11,19,42
CSKA Moscow,5343,2,11,3,6,26,19,7,36
Zenit,5343,3,8,8,4,23,14,9,32
Spart Moscow,5343,4,9,5,6,36,28,8,32
Krasnodar,5343,5,9,5,6,31,26,5,32
Terek Grozny,5343,6,7,6,7,23,27,-4,27
FK Rubin,5343,7,6,5,9,24,21,3,23
Amkar,5343,8,6,4,10,13,23,-10,22
Rostov,5343,9,5,6,9,11,17,-6,21
Din Moscow,5343,10,5,6,9,17,24,-7,21
Anzhi,5343,11,2,6,12,17,41,-24,12
Loko Moscow,5344,1,12,6,2,33,13,20,42
CSKA Moscow,5344,2,11,3,6,28,21,7,36
Zenit,5344,3,8,9,3,24,14,10,33
Spart Moscow,5344,4,8,5,7,34,29,5,29
Terek Grozny,5344,5,8,5,7,22,24,-2,29
Krasnodar,5344,6,8,4,8,29,30,-1,28
Din Moscow,5344,7,7,6,7,20,22,-2,27
FK Rubin,5344,8,6,5,9,24,19,5,23
Rostov,5344,9,5,6,9,11,17,-6,21
Amkar,5344,10,5,4,11,10,23,-13,19
Anzhi,5344,11,3,5,12,18,41,-23,14
Loko Moscow,5345,1,11,5,4,29,13,16,38
CSKA Moscow,5345,2,11,4,5,29,19,10,37
Krasnodar,5345,3,10,4,6,31,24,7,34
Zenit,5345,4,8,9,3,23,14,9,33
Spart Moscow,5345,5,9,5,6,38,28,10,32
Terek Grozny,5345,6,8,6,6,22,23,-1,30
Din Moscow,5345,7,6,6,8,20,26,-6,24
Rostov,5345,8,5,6,9,12,18,-6,21
FK Rubin,5345,9,5,5,10,22,23,-1,20
Amkar,5345,10,5,5,10,10,22,-12,20
Anzhi,5345,11,2,5,13,16,42,-26,11
Loko Moscow,5346,1,12,6,2,33,14,19,42
CSKA Moscow,5346,2,12,3,5,29,17,12,39
Krasnodar,5346,3,9,4,7,32,27,5,31
Zenit,5346,4,7,9,4,22,17,5,30
Spart Moscow,5346,5,8,6,6,36,32,4,30
Terek Grozny,5346,6,8,6,6,25,26,-1,30
Din Moscow,5346,7,7,6,7,21,21,0,27
Rostov,5346,8,5,6,9,12,18,-6,21
FK Rubin,5346,9,5,5,10,21,21,0,20
Amkar,5346,10,4,5,11,12,26,-14,17
Anzhi,5346,11,2,6,12,17,41,-24,12
Loko Moscow,5347,1,12,5,3,30,13,17,41
Spart Moscow,5347,2,10,5,5,38,28,10,35
CSKA Moscow,5347,3,10,4,6,27,20,7,34
Zenit,5347,4,8,8,4,23,15,8,32
Krasnodar,5347,5,9,5,6,30,25,5,32
Terek Grozny,5347,6,8,5,7,22,27,-5,29
Din Moscow,5347,7,7,6,7,21,22,-1,27
FK Rubin,5347,8,5,6,9,22,19,3,21
Rostov,5347,9,4,6,10,10,19,-9,18
Amkar,5347,10,4,4,12,10,26,-16,16
Anzhi,5347,11,3,6,11,19,38,-19,15
Loko Moscow,5348,1,11,5,4,30,15,15,38
CSKA Moscow,5348,2,11,3,6,28,21,7,36
Zenit,5348,3,9,8,3,27,15,12,35
Krasnodar,5348,4,10,4,6,32,26,6,34
Spart Moscow,5348,5,9,6,5,37,29,8,33
Terek Grozny,5348,6,8,6,6,22,23,-1,30
Din Moscow,5348,7,6,6,8,19,24,-5,24
FK Rubin,5348,8,5,5,10,23,22,1,20
Amkar,5348,9,5,5,10,12,23,-11,20
Rostov,5348,10,4,7,9,11,18,-7,19
Anzhi,5348,11,2,5,13,15,40,-25,11
Loko Moscow,5349,1,11,5,4,30,14,16,38
Spart Moscow,5349,2,10,6,4,41,27,14,36
CSKA Moscow,5349,3,11,3,6,26,18,8,36
Zenit,5349,4,9,8,3,23,13,10,35
Krasnodar,5349,5,10,4,6,32,26,6,34
Terek Grozny,5349,6,8,6,6,23,23,0,30
Din Moscow,5349,7,5,7,8,19,27,-8,22
FK Rubin,5349,8,5,6,9,22,20,2,21
Rostov,5349,9,4,6,10,10,19,-9,18
Amkar,5349,10,4,5,11,9,24,-15,17
Anzhi,5349,11,2,6,12,15,39,-24,12
Loko Moscow,5350,1,12,5,3,31,13,18,41
CSKA Moscow,5350,2,11,4,5,30,18,12,37
Zenit,5350,3,8,9,3,23,14,9,33
Spart Moscow,5350,4,9,6,5,34,26,8,33
Krasnodar,5350,5,9,4,7,30,26,4,31
Terek Grozny,5350,6,8,5,7,21,23,-2,29
Din Moscow,5350,7,5,8,7,18,22,-4,23
Amkar,5350,8,6,4,10,11,22,-11,22
FK Rubin,5350,9,5,6,9,22,20,2,21
Rostov,5350,10,4,6,10,10,18,-8,18
Anzhi,5350,11,2,5,13,14,42,-28,11
Loko Moscow,5351,1,11,5,4,31,16,15,38
CSKA Moscow,5351,2,11,4,5,26,17,9,37
Spart Moscow,5351,3,9,7,4,36,27,9,34
Zenit,5351,4,8,9,3,23,14,9,33
Terek Grozny,5351,5,9,5,6,24,24,0,32
Krasnodar,5351,6,9,4,7,31,28,3,31
FK Rubin,5351,7,7,5,8,25,18,7,26
Din Moscow,5351,8,5,6,9,17,23,-6,21
Rostov,5351,9,4,7,9,11,18,-7,19
Amkar,5351,10,4,5,11,11,25,-14,17
Anzhi,5351,11,2,5,13,15,40,-25,11
Loko Moscow,5352,1,11,7,2,32,14,18,40
CSKA Moscow,5352,2,11,4,5,29,19,10,37
Spart Moscow,5352,3,10,6,4,35,25,10,36
Krasnodar,5352,4,9,5,6,31,26,5,32
Zenit,5352,5,7,10,3,23,15,8,31
Terek Grozny,5352,6,8,5,7,22,24,-2,29
FK Rubin,5352,7,6,5,9,23,19,4,23
Din Moscow,5352,8,5,6,9,17,24,-7,21
Rostov,5352,9,4,7,9,10,17,-7,19
Amkar,5352,10,4,4,12,9,25,-16,16
Anzhi,5352,11,3,5,12,17,40,-23,14
Loko Moscow,5353,1,11,7,2,31,13,18,40
Spart Moscow,5353,2,11,5,4,40,28,12,38
CSKA Moscow,5353,3,10,4,6,25,18,7,34
Zenit,5353,4,8,9,3,22,13,9,33
Krasnodar,5353,5,8,6,6,29,26,3,30
Terek Grozny,5353,6,8,5,7,22,24,-2,29
FK Rubin,5353,7,6,6,8,23,18,5,24
Din Moscow,5353,8,5,6,9,18,25,-7,21
Rostov,5353,9,4,6,10,11,19,-8,18
Amkar,5353,10,4,4,12,11,27,-16,16
Anzhi,5353,11,3,6,11,16,37,-21,15
Loko Moscow,5354,1,12,5,3,32,15,17,41
Spart Moscow,5354,2,11,5,4,45,29,16,38
CSKA Moscow,5354,3,11,4,5,27,18,9,37
Krasnodar,5354,4,9,5,6,31,26,5,32
Terek Grozny,5354,5,9,5,6,25,23,2,32
Zenit,5354,6,7,9,4,21,14,7,30
Din Moscow,5354,7,6,6,8,19,25,-6,24
FK Rubin,5354,8,5,6,9,22,19,3,21
Rostov,5354,9,4,6,10,12,23,-11,18
Amkar,5354,10,4,4,12,11,28,-17,16
Anzhi,5354,11,2,5,13,16,41,-25,11
Loko Moscow,5355,1,12,6,2,37,13,24,42
CSKA Moscow,5355,2,10,5,5,30,22,8,35
Spart Moscow,5355,3,9,6,5,36,28,8,33
Krasnodar,5355,4,9,5,6,30,26,4,32
Zenit,5355,5,7,9,4,24,22,2,30
Terek Grozny,5355,6,7,6,7,20,24,-4,27
Din Moscow,5355,7,6,6,8,18,24,-6,24
FK Rubin,5355,8,6,5,9,25,19,6,23
Rostov,5355,9,4,6,10,10,18,-8,18
Amkar,5355,10,4,6,10,11,24,-13,18
Anzhi,5355,11,3,6,11,19,40,-21,15
Loko Moscow,5356,1,12,5,3,33,16,17,41
CSKA Moscow,5356,2,11,3,6,26,20,6,36
Spart Moscow,5356,3,9,7,4,36,27,9,34
Zenit,5356,4,8,8,4,26,16,10,32
Krasnodar,5356,5,9,5,6,32,27,5,32
Terek Grozny,5356,6,7,6,7,23,26,-3,27
FK Rubin,5356,7,6,6,8,24,19,5,24
Din Moscow,5356,8,5,7,8,19,24,-5,22
Amkar,5356,9,5,5,10,11,23,-12,20
Rostov,5356,10,4,6,10,10,18,-8,18
Anzhi,5356,11,2,6,12,16,40,-24,12
Loko Moscow,5357,1,11,7,2,31,13,18,40
CSKA Moscow,5357,2,11,4,5,29,19,10,37
Zenit,5357,3,7,10,3,24,16,8,31
Spart Moscow,5357,4,8,7,5,34,27,7,31
Krasnodar,5357,5,8,5,7,28,28,0,29
Terek Grozny,5357,6,7,7,6,20,22,-2,28
Din Moscow,5357,7,6,7,7,20,23,-3,25
FK Rubin,5357,8,6,5,9,25,19,6,23
Amkar,5357,9,5,5,10,10,22,-12,20
Rostov,5357,10,4,7,9,10,17,-7,19
Anzhi,5357,11,2,6,12,14,39,-25,12
Loko Moscow,5358,1,12,5,3,30,13,17,41
CSKA Moscow,5358,2,11,4,5,30,20,10,37
Zenit,5358,3,8,9,3,24,14,10,33
Spart Moscow,5358,4,8,8,4,36,28,8,32
Terek Grozny,5358,5,9,5,6,23,22,1,32
Krasnodar,5358,6,9,4,7,29,25,4,31
FK Rubin,5358,7,6,5,9,22,19,3,23
Din Moscow,5358,8,5,7,8,18,23,-5,22
Rostov,5358,9,4,7,9,11,18,-7,19
Amkar,5358,10,4,5,11,10,25,-15,17
Anzhi,5358,11,2,5,13,16,42,-26,11
Loko Moscow,5359,1,12,6,2,32,13,19,42
CSKA Moscow,5359,2,11,4,5,31,20,11,37
Spart Moscow,5359,3,9,6,5,37,28,9,33
Zenit,5359,4,7,9,4,24,17,7,30
Krasnodar,5359,5,8,5,7,28,27,1,29
Terek Grozny,5359,6,7,6,7,20,25,-5,27
FK Rubin,5359,7,7,5,8,24,17,7,26
Din Moscow,5359,8,5,7,8,18,23,-5,22
Amkar,5359,9,5,5,10,11,23,-12,20
Rostov,5359,10,4,6,10,10,19,-9,18
Anzhi,5359,11,3,5,12,18,41,-23,14
Loko Moscow,5360,1,12,5,3,32,14,18,41
CSKA Moscow,5360,2,11,3,6,29,20,9,36
Spart Moscow,5360,3,9,5,6,35,27,8,32
Zenit,5360,4,8,8,4,25,17,8,32
Terek Grozny,5360,5,9,5,6,24,24,0,32
Krasnodar,5360,6,9,4,7,29,25,4,31
Din Moscow,5360,7,7,6,7,20,22,-2,27
FK Rubin,5360,8,6,5,9,23,19,4,23
Amkar,5360,9,5,4,11,11,24,-13,19
Rostov,5360,10,4,6,10,10,19,-9,18
Anzhi,5360,11,2,5,13,15,42,-27,11
Loko Moscow,5361,1,12,6,2,32,12,20,42
CSKA Moscow,5361,2,11,3,6,28,22,6,36
Zenit,5361,3,8,8,4,25,16,9,32
Spart Moscow,5361,4,8,6,6,33,27,6,30
Krasnodar,5361,5,8,6,6,27,24,3,30
Terek Grozny,5361,6,8,5,7,23,25,-2,29
FK Rubin,5361,7,6,6,8,24,17,7,24
Din Moscow,5361,8,5,7,8,17,24,-7,22
Amkar,5361,9,6,4,10,12,23,-11,22
Rostov,5361,10,5,6,9,11,17,-6,21
Anzhi,5361,11,2,5,13,17,42,-25,11
Loko Moscow,5362,1,12,5,3,32,14,18,41
Spart Moscow,5362,2,10,6,4,38,27,11,36
CSKA Moscow,5362,3,10,5,5,26,18,8,35
Krasnodar,5362,4,9,4,7,29,26,3,31
Zenit,5362,5,7,9,4,23,16,7,30
Terek Grozny,5362,6,7,6,7,21,24,-3,27
FK Rubin,5362,7,6,6,8,22,17,5,24
Din Moscow,5362,8,5,7,8,18,23,-5,22
Amkar,5362,9,5,5,10,11,23,-12,20
Rostov,5362,10,4,6,10,10,19,-9,18
Anzhi,5362,11,2,7,11,15,38,-23,13
Loko Moscow,5363,1,12,6,2,32,13,19,42
CSKA Moscow,5363,2,11,3,6,29,19,10,36
Spart Moscow,5363,3,9,7,4,36,26,10,34
Zenit,5363,4,8,8,4,24,16,8,32
Krasnodar,5363,5,9,5,6,31,26,5,32
Terek Grozny,5363,6,8,6,6,21,22,-1,30
Din Moscow,5363,7,5,8,7,18,22,-4,23
FK Rubin,5363,8,5,6,9,23,21,2,21
Rostov,5363,9,4,6,10,10,19,-9,18
Amkar,5363,10,4,6,10,10,23,-13,18
Anzhi,5363,11,2,5,13,14,41,-27,11
Loko Moscow,5364,1,11,5,4,30,15,15,38
CSKA Moscow,5364,2,11,3,6,28,20,8,36
Krasnodar,5364,3,10,4,6,32,26,6,34
Zenit,5364,4,8,8,4,23,15,8,32
Spart Moscow,5364,5,8,7,5,35,29,6,31
Terek Grozny,5364,6,8,6,6,23,23,0,30
Din Moscow,5364,7,5,8,7,20,24,-4,23
FK Rubin,5364,8,5,6,9,23,20,3,21
Rostov,5364,9,4,7,9,10,17,-7,19
Amkar,5364,10,5,4,11,11,24,-13,19
Anzhi,5364,11,3,6,11,17,39,-22,15
Loko Moscow,5365,1,11,6,3,31,14,17,39
Spart Moscow,5365,2,11,5,4,40,27,13,38
CSKA Moscow,5365,3,11,3,6,27,18,9,36
Zenit,5365,4,8,9,3,23,14,9,33
Krasnodar,5365,5,9,5,6,30,26,4,32
Terek Grozny,5365,6,8,5,7,23,24,-1,29
Din Moscow,5365,7,6,6,8,21,23,-2,24
FK Rubin,5365,8,5,6,9,22,21,1,21
Rostov,5365,9,4,6,10,11,20,-9,18
Amkar,5365,10,4,4,12,9,26,-17,16
Anzhi,5365,11,3,5,12,16,40,-24,14
Loko Moscow,5366,1,12,6,2,31,12,19,42
CSKA Moscow,5366,2,11,3,6,32,22,10,36
Zenit,5366,3,8,9,3,25,14,11,33
Spart Moscow,5366,4,9,5,6,36,30,6,32
Krasnodar,5366,5,9,4,7,28,25,3,31
Terek Grozny,5366,6,8,5,7,22,24,-2,29
Din Moscow,5366,7,6,6,8,19,23,-4,24
FK Rubin,5366,8,6,5,9,23,18,5,23
Amkar,5366,9,6,4,10,13,22,-9,22
Rostov,5366,10,4,6,10,11,20,-9,18
Anzhi,5366,11,2,5,13,16,46,-30,11
Loko Moscow,5367,1,12,6,2,32,13,19,42
CSKA Moscow,5367,2,11,3,6,31,20,11,36
Spart Moscow,5367,3,10,5,5,37,28,9,35
Zenit,5367,4,8,8,4,26,18,8,32
Krasnodar,5367,5,8,6,6,28,25,3,30
Terek Grozny,5367,6,8,6,6,24,25,-1,30
FK Rubin,5367,7,6,6,8,24,19,5,24
Din Moscow,5367,8,5,6,9,19,25,-6,21
Rostov,5367,9,5,6,9,11,17,-6,21
Amkar,5367,10,4,4,12,11,26,-15,16
Anzhi,5367,11,2,6,12,16,43,-27,12
Loko Moscow,5368,1,12,5,3,31,13,18,41
CSKA Moscow,5368,2,12,3,5,27,17,10,39
Krasnodar,5368,3,10,4,6,31,26,5,34
Spart Moscow,5368,4,9,5,6,41,32,9,32
Terek Grozny,5368,5,8,6,6,24,23,1,30
Zenit,5368,6,7,8,5,22,16,6,29
FK Rubin,5368,7,6,5,9,25,21,4,23
Rostov,5368,8,5,6,9,13,19,-6,21
Din Moscow,5368,9,5,6,9,18,27,-9,21
Amkar,5368,10,5,5,10,14,25,-11,20
Anzhi,5368,11,2,5,13,14,41,-27,11
Loko Moscow,5369,1,12,5,3,30,13,17,41
CSKA Moscow,5369,2,11,3,6,28,18,10,36
Spart Moscow,5369,3,9,6,5,36,28,8,33
Krasnodar,5369,4,9,4,7,30,26,4,31
Terek Grozny,5369,5,8,6,6,23,24,-1,30
Zenit,5369,6,7,8,5,21,17,4,29
Din Moscow,5369,7,6,7,7,20,23,-3,25
FK Rubin,5369,8,6,5,9,24,20,4,23
Amkar,5369,9,5,5,10,11,23,-12,20
Rostov,5369,10,4,6,10,11,19,-8,18
Anzhi,5369,11,3,5,12,16,39,-23,14
Loko Moscow,5370,1,12,6,2,32,12,20,42
CSKA Moscow,5370,2,11,3,6,27,21,6,36
Spart Moscow,5370,3,9,7,4,39,27,12,34
Zenit,5370,4,8,9,3,26,14,12,33
Krasnodar,5370,5,9,4,7,29,27,2,31
Terek Grozny,5370,6,7,6,7,21,25,-4,27
Din Moscow,5370,7,6,6,8,19,25,-6,24
FK Rubin,5370,8,5,5,10,22,21,1,20
Amkar,5370,9,5,5,10,13,24,-11,20
Rostov,5370,10,4,7,9,10,17,-7,19
Anzhi,5370,11,2,6,12,15,40,-25,12
Loko Moscow,5371,1,11,7,2,30,12,18,40
CSKA Moscow,5371,2,12,3,5,28,18,10,39
Spart Moscow,5371,3,9,7,4,39,30,9,34
Zenit,5371,4,7,9,4,22,15,7,30
Krasnodar,5371,5,8,6,6,29,26,3,30
Terek Grozny,5371,6,8,5,7,21,25,-4,29
Din Moscow,5371,7,5,8,7,18,22,-4,23
FK Rubin,5371,8,5,7,8,22,18,4,22
Rostov,5371,9,4,7,9,13,20,-7,19
Amkar,5371,10,4,4,12,10,25,-15,16
Anzhi,5371,11,3,5,12,17,38,-21,14
Loko Moscow,5372,1,11,5,4,29,14,15,38
CSKA Moscow,5372,2,11,3,6,28,18,10,36
Zenit,5372,3,9,8,3,23,13,10,35
Krasnodar,5372,4,9,5,6,32,27,5,32
Terek Grozny,5372,5,9,5,6,23,23,0,32
Spart Moscow,5372,6,8,6,6,35,29,6,30
Din Moscow,5372,7,7,6,7,22,22,0,27
FK Rubin,5372,8,5,6,9,24,23,1,21
Rostov,5372,9,5,6,9,12,18,-6,21
Amkar,5372,10,4,5,11,10,24,-14,17
Anzhi,5372,11,2,5,13,14,41,-27,11
Loko Moscow,5373,1,12,6,2,30,11,19,42
CSKA Moscow,5373,2,11,4,5,28,19,9,37
Spart Moscow,5373,3,10,5,5,37,28,9,35
Zenit,5373,4,7,10,3,22,14,8,31
Krasnodar,5373,5,8,5,7,28,26,2,29
Terek Grozny,5373,6,7,6,7,21,24,-3,27
Din Moscow,5373,7,6,7,7,19,22,-3,25
FK Rubin,5373,8,5,7,8,22,18,4,22
Amkar,5373,9,5,4,11,10,23,-13,19
Rostov,5373,10,4,6,10,11,19,-8,18
Anzhi,5373,11,2,6,12,16,40,-24,12
Loko Moscow,5374,1,11,5,4,29,13,16,38
Zenit,5374,2,9,8,3,25,15,10,35
CSKA Moscow,5374,3,10,4,6,28,21,7,34
Krasnodar,5374,4,10,4,6,30,24,6,34
Terek Grozny,5374,5,9,5,6,25,24,1,32
Spart Moscow,5374,6,8,6,6,37,31,6,30
FK Rubin,5374,7,6,5,9,22,19,3,23
Din Moscow,5374,8,5,7,8,19,24,-5,22
Rostov,5374,9,5,6,9,12,18,-6,21
Amkar,5374,10,5,4,11,13,27,-14,19
Anzhi,5374,11,2,6,12,15,39,-24,12
Loko Moscow,5375,1,12,6,2,32,13,19,42
CSKA Moscow,5375,2,11,4,5,28,19,9,37
Spart Moscow,5375,3,9,6,5,37,30,7,33
Krasnodar,5375,4,9,5,6,30,24,6,32
Zenit,5375,5,7,9,4,24,17,7,30
Terek Grozny,5375,6,7,5,8,22,27,-5,26
Din Moscow,5375,7,6,7,7,21,23,-2,25
FK Rubin,5375,8,5,6,9,22,21,1,21
Amkar,5375,9,5,5,10,13,24,-11,20
Rostov,5375,10,4,6,10,11,19,-8,18
Anzhi,5375,11,3,5,12,17,40,-23,14
Loko Moscow,5376,1,12,5,3,34,13,21,41
CSKA Moscow,5376,2,11,4,5,26,17,9,37
Krasnodar,5376,3,10,4,6,31,26,5,34
Spart Moscow,5376,4,8,8,4,34,26,8,32
Zenit,5376,5,7,9,4,21,17,4,30
Terek Grozny,5376,6,8,6,6,23,23,0,30
Din Moscow,5376,7,5,8,7,17,21,-4,23
FK Rubin,5376,8,5,6,9,22,19,3,21
Rostov,5376,9,4,7,9,10,17,-7,19
Amkar,5376,10,4,5,11,10,25,-15,17
Anzhi,5376,11,2,6,12,15,39,-24,12
Loko Moscow,5377,1,12,5,3,32,13,19,41
CSKA Moscow,5377,2,12,3,5,29,18,11,39
Spart Moscow,5377,3,10,5,5,41,30,11,35
Krasnodar,5377,4,9,4,7,29,25,4,31
Zenit,5377,5,7,8,5,21,18,3,29
Terek Grozny,5377,6,8,5,7,22,26,-4,29
Din Moscow,5377,7,6,6,8,19,25,-6,24
FK Rubin,5377,8,6,5,9,23,19,4,23
Amkar,5377,9,5,4,11,14,26,-12,19
Rostov,5377,10,4,6,10,11,20,-9,18
Anzhi,5377,11,3,5,12,18,39,-21,14
Loko Moscow,5378,1,12,5,3,32,14,18,41
CSKA Moscow,5378,2,11,4,5,26,17,9,37
Spart Moscow,5378,3,9,7,4,36,26,10,34
Krasnodar,5378,4,10,4,6,31,25,6,34
Zenit,5378,5,7,8,5,22,16,6,29
Terek Grozny,5378,6,7,6,7,22,25,-3,27
Din Moscow,5378,7,6,6,8,18,23,-5,24
FK Rubin,5378,8,5,5,10,21,20,1,20
Amkar,5378,9,5,5,10,12,24,-12,20
Rostov,5378,10,4,7,9,10,17,-7,19
Anzhi,5378,11,2,7,11,15,38,-23,13
Loko Moscow,5379,1,13,5,2,33,12,21,44
CSKA Moscow,5379,2,11,4,5,28,18,10,37
Krasnodar,5379,3,9,4,7,30,28,2,31
Zenit,5379,4,7,9,4,22,15,7,30
Spart Moscow,5379,5,8,6,6,35,29,6,30
Terek Grozny,5379,6,8,6,6,22,22,0,30
Din Moscow,5379,7,6,6,8,21,25,-4,24
FK Rubin,5379,8,6,5,9,25,21,4,23
Rostov,5379,9,4,7,9,11,18,-7,19
Amkar,5379,10,5,4,11,10,24,-14,19
Anzhi,5379,11,2,6,12,14,39,-25,12
Loko Moscow,5380,1,12,6,2,32,12,20,42
Spart Moscow,5380,2,10,6,4,40,27,13,36
CSKA Moscow,5380,3,11,3,6,27,20,7,36
Zenit,5380,4,8,8,4,23,15,8,32
Krasnodar,5380,5,8,6,6,29,26,3,30
Terek Grozny,5380,6,7,7,6,22,24,-2,28
FK Rubin,5380,7,5,7,8,23,19,4,22
Din Moscow,5380,8,5,7,8,18,25,-7,22
Rostov,5380,9,4,6,10,10,19,-9,18
Amkar,5380,10,4,6,10,12,25,-13,18
Anzhi,5380,11,2,6,12,16,40,-24,12
Loko Moscow,5381,1,12,5,3,32,13,19,41
Spart Moscow,5381,2,10,5,5,44,27,17,35
CSKA Moscow,5381,3,10,5,5,27,19,8,35
Zenit,5381,4,8,9,3,23,14,9,33
Terek Grozny,5381,5,9,5,6,23,23,0,32
Krasnodar,5381,6,9,4,7,30,28,2,31
Din Moscow,5381,7,5,7,8,18,27,-9,22
FK Rubin,5381,8,5,6,9,23,20,3,21
Amkar,5381,9,5,4,11,10,23,-13,19
Rostov,5381,10,4,6,10,11,23,-12,18
Anzhi,5381,11,2,6,12,16,40,-24,12
Loko Moscow,5382,1,12,5,3,30,12,18,41
Spart Moscow,5382,2,9,7,4,36,27,9,34
CSKA Moscow,5382,3,10,4,6,27,20,7,34
Zenit,5382,4,8,9,3,23,14,9,33
Krasnodar,5382,5,8,5,7,28,26,2,29
Terek Grozny,5382,6,7,5,8,21,25,-4,26
Din Moscow,5382,7,5,8,7,17,21,-4,23
FK Rubin,5382,8,5,7,8,22,18,4,22
Amkar,5382,9,5,5,10,12,24,-12,20
Rostov,5382,10,4,6,10,11,19,-8,18
Anzhi,5382,11,4,5,11,17,38,-21,17
Loko Moscow,5383,1,12,6,2,32,11,21,42
CSKA Moscow,5383,2,11,3,6,26,18,8,36
Spart Moscow,5383,3,10,5,5,38,26,12,35
Zenit,5383,4,8,8,4,22,16,6,32
Krasnodar,5383,5,8,6,6,28,25,3,30
Din Moscow,5383,6,7,6,7,21,21,0,27
Terek Grozny,5383,7,7,5,8,21,28,-7,26
FK Rubin,5383,8,5,6,9,22,21,1,21
Amkar,5383,9,5,4,11,11,25,-14,19
Rostov,5383,10,4,6,10,10,19,-9,18
Anzhi,5383,11,3,5,12,18,39,-21,14
Loko Moscow,5384,1,12,5,3,32,15,17,41
CSKA Moscow,5384,2,11,4,5,27,18,9,37
Krasnodar,5384,3,10,4,6,35,27,8,34
Zenit,5384,4,7,9,4,22,16,6,30
Terek Grozny,5384,5,8,6,6,23,24,-1,30
Spart Moscow,5384,6,8,5,7,35,34,1,29
Din Moscow,5384,7,6,6,8,21,23,-2,24
FK Rubin,5384,8,6,5,9,25,22,3,23
Rostov,5384,9,5,6,9,13,18,-5,21
Amkar,5384,10,5,5,10,12,23,-11,20
Anzhi,5384,11,2,5,13,16,41,-25,11
Loko Moscow,5385,1,12,6,2,34,14,20,42
CSKA Moscow,5385,2,11,3,6,30,21,9,36
Spart Moscow,5385,3,9,6,5,36,28,8,33
Zenit,5385,4,8,8,4,26,18,8,32
Krasnodar,5385,5,9,5,6,32,27,5,32
Terek Grozny,5385,6,8,5,7,21,23,-2,29
FK Rubin,5385,7,6,5,9,27,21,6,23
Din Moscow,5385,8,5,6,9,17,26,-9,21
Rostov,5385,9,4,7,9,11,18,-7,19
Amkar,5385,10,5,4,11,11,24,-13,19
Anzhi,5385,11,3,5,12,16,41,-25,14
Loko Moscow,5386,1,11,5,4,29,13,16,38
Spart Moscow,5386,2,11,5,4,41,27,14,38
CSKA Moscow,5386,3,11,3,6,27,20,7,36
Zenit,5386,4,9,8,3,25,13,12,35
Krasnodar,5386,5,9,5,6,29,25,4,32
Terek Grozny,5386,6,8,6,6,22,23,-1,30
Din Moscow,5386,7,6,6,8,19,25,-6,24
FK Rubin,5386,8,5,6,9,23,20,3,21
Rostov,5386,9,4,6,10,11,20,-9,18
Amkar,5386,10,4,5,11,11,25,-14,17
Anzhi,5386,11,2,5,13,14,40,-26,11
Loko Moscow,5387,1,13,5,2,33,12,21,44
CSKA Moscow,5387,2,11,3,6,29,20,9,36
Spart Moscow,5387,3,9,6,5,36,30,6,33
Zenit,5387,4,8,8,4,25,17,8,32
Krasnodar,5387,5,8,5,7,29,28,1,29
Terek Grozny,5387,6,7,6,7,22,25,-3,27
FK Rubin,5387,7,6,6,8,27,20,7,24
Din Moscow,5387,8,5,7,8,20,27,-7,22
Amkar,5387,9,5,5,10,13,23,-10,20
Rostov,5387,10,4,6,10,10,18,-8,18
Anzhi,5387,11,3,5,12,16,40,-24,14
Loko Moscow,5388,1,11,5,4,30,17,13,38
CSKA Moscow,5388,2,11,4,5,27,18,9,37
Krasnodar,5388,3,10,4,6,32,25,7,34
Spart Moscow,5388,4,9,6,5,36,29,7,33
Zenit,5388,5,8,8,4,23,14,9,32
Terek Grozny,5388,6,8,5,7,23,25,-2,29
FK Rubin,5388,7,6,5,9,23,19,4,23
Din Moscow,5388,8,5,7,8,20,25,-5,22
Amkar,5388,9,5,4,11,13,25,-12,19
Rostov,5388,10,4,6,10,10,18,-8,18
Anzhi,5388,11,3,6,11,16,38,-22,15
Loko Moscow,5389,1,11,6,3,29,12,17,39
CSKA Moscow,5389,2,11,3,6,26,21,5,36
Spart Moscow,5389,3,9,7,4,35,26,9,34
Krasnodar,5389,4,10,4,6,29,24,5,34
Zenit,5389,5,8,9,3,25,13,12,33
Terek Grozny,5389,6,8,5,7,22,25,-3,29
Din Moscow,5389,7,6,7,7,21,22,-1,25
FK Rubin,5389,8,5,5,10,21,21,0,20
Rostov,5389,9,4,6,10,10,18,-8,18
Amkar,5389,10,4,5,11,9,23,-14,17
Anzhi,5389,11,3,5,12,17,39,-22,14
Loko Moscow,5390,1,11,7,2,31,13,18,40
Spart Moscow,5390,2,10,6,4,39,27,12,36
CSKA Moscow,5390,3,11,3,6,28,20,8,36
Zenit,5390,4,8,9,3,26,16,10,33
Krasnodar,5390,5,8,6,6,28,25,3,30
Terek Grozny,5390,6,7,6,7,21,27,-6,27
Din Moscow,5390,7,6,7,7,19,22,-3,25
FK Rubin,5390,8,5,6,9,22,19,3,21
Rostov,5390,9,4,6,10,10,19,-9,18
Amkar,5390,10,4,5,11,11,26,-15,17
Anzhi,5390,11,3,5,12,18,39,-21,14
Loko Moscow,5391,1,12,6,2,30,11,19,42
CSKA Moscow,5391,2,11,3,6,26,18,8,36
Spart Moscow,5391,3,10,5,5,38,28,10,35
Zenit,5391,4,8,9,3,22,13,9,33
Krasnodar,5391,5,8,4,8,29,28,1,28
Terek Grozny,5391,6,7,5,8,20,24,-4,26
Din Moscow,5391,7,6,6,8,20,23,-3,24
FK Rubin,5391,8,6,5,9,24,21,3,23
Rostov,5391,9,5,6,9,12,17,-5,21
Amkar,5391,10,5,4,11,10,25,-15,19
Anzhi,5391,11,3,5,12,15,38,-23,14
Loko Moscow,5392,1,12,5,3,33,15,18,41
CSKA Moscow,5392,2,12,3,5,29,19,10,39
Krasnodar,5392,3,10,4,6,35,27,8,34
Spart Moscow,5392,4,9,5,6,35,29,6,32
Zenit,5392,5,7,8,5,23,18,5,29
Terek Grozny,5392,6,7,6,7,22,25,-3,27
FK Rubin,5392,7,6,5,9,23,21,2,23
Amkar,5392,8,6,4,10,11,22,-11,22
Rostov,5392,9,5,6,9,12,17,-5,21
Din Moscow,5392,10,5,6,9,18,24,-6,21
Anzhi,5392,11,2,6,12,16,40,-24,12
Loko Moscow,5393,1,12,6,2,32,11,21,42
Spart Moscow,5393,2,10,6,4,39,26,13,36
CSKA Moscow,5393,3,10,4,6,27,20,7,34
Zenit,5393,4,7,10,3,21,13,8,31
Krasnodar,5393,5,9,4,7,29,28,1,31
Terek Grozny,5393,6,7,6,7,20,27,-7,27
Din Moscow,5393,7,5,7,8,18,25,-7,22
FK Rubin,5393,8,5,6,9,23,20,3,21
Rostov,5393,9,4,7,9,10,17,-7,19
Amkar,5393,10,4,5,11,10,25,-15,17
Anzhi,5393,11,4,5,11,22,39,-17,17
Loko Moscow,5394,1,12,5,3,30,14,16,41
Spart Moscow,5394,2,11,5,4,43,25,18,38
CSKA Moscow,5394,3,11,3,6,29,20,9,36
Zenit,5394,4,8,8,4,24,15,9,32
Krasnodar,5394,5,9,4,7,30,25,5,31
Terek Grozny,5394,6,8,6,6,23,24,-1,30
FK Rubin,5394,7,7,5,8,24,18,6,26
Din Moscow,5394,8,5,6,9,18,28,-10,21
Rostov,5394,9,4,6,10,10,20,-10,18
Amkar,5394,10,4,4,12,9,25,-16,16
Anzhi,5394,11,2,6,12,16,42,-26,12
Loko Moscow,5395,1,11,6,3,30,13,17,39
Spart Moscow,5395,2,9,7,4,38,28,10,34
CSKA Moscow,5395,3,10,4,6,27,20,7,34
Zenit,5395,4,8,9,3,23,14,9,33
Krasnodar,5395,5,9,5,6,30,25,5,32
Terek Grozny,5395,6,9,5,6,22,22,0,32
Din Moscow,5395,7,6,7,7,21,23,-2,25
FK Rubin,5395,8,5,5,10,21,21,0,20
Rostov,5395,9,4,6,10,10,19,-9,18
Amkar,5395,10,4,5,11,10,24,-14,17
Anzhi,5395,11,3,5,12,16,39,-23,14
Loko Moscow,5396,1,11,6,3,31,15,16,39
CSKA Moscow,5396,2,11,4,5,27,17,10,37
Spart Moscow,5396,3,10,6,4,38,28,10,36
Krasnodar,5396,4,10,4,6,33,24,9,34
Zenit,5396,5,7,10,3,23,15,8,31
Terek Grozny,5396,6,8,6,6,23,23,0,30
Din Moscow,5396,7,5,7,8,20,25,-5,22
FK Rubin,5396,8,5,6,9,23,23,0,21
Rostov,5396,9,4,6,10,11,19,-8,18
Amkar,5396,10,4,5,11,10,25,-15,17
Anzhi,5396,11,2,6,12,15,40,-25,12
Loko Moscow,5397,1,11,6,3,32,16,16,39
CSKA Moscow,5397,2,11,3,6,28,18,10,36
Spart Moscow,5397,3,10,5,5,40,30,10,35
Krasnodar,5397,4,10,4,6,34,26,8,34
Zenit,5397,5,8,9,3,23,14,9,33
Terek Grozny,5397,6,7,7,6,20,22,-2,28
Din Moscow,5397,7,6,6,8,21,25,-4,24
Rostov,5397,8,5,6,9,13,18,-5,21
FK Rubin,5397,9,5,5,10,21,22,-1,20
Amkar,5397,10,4,5,11,9,24,-15,17
Anzhi,5397,11,2,6,12,14,40,-26,12
Loko Moscow,5398,1,12,6,2,32,12,20,42
CSKA Moscow,5398,2,12,3,5,29,18,11,39
Spart Moscow,5398,3,10,5,5,37,28,9,35
Zenit,5398,4,7,9,4,21,14,7,30
Terek Grozny,5398,5,8,6,6,23,24,-1,30
Krasnodar,5398,6,8,5,7,29,28,1,29
FK Rubin,5398,7,6,6,8,24,18,6,24
Din Moscow,5398,8,5,6,9,17,26,-9,21
Amkar,5398,9,5,5,10,12,22,-10,20
Rostov,5398,10,4,6,10,10,18,-8,18
Anzhi,5398,11,2,5,13,17,43,-26,11
Loko Moscow,5399,1,11,5,4,30,14,16,38
CSKA Moscow,5399,2,10,5,5,27,19,8,35
Zenit,5399,3,8,9,3,23,14,9,33
Krasnodar,5399,4,9,5,6,30,26,4,32
Spart Moscow,5399,5,8,7,5,36,29,7,31
Terek Grozny,5399,6,7,6,7,21,25,-4,27
FK Rubin,5399,7,6,6,8,24,19,5,24
Din Moscow,5399,8,5,7,8,20,25,-5,22
Amkar,5399,9,6,4,10,14,24,-10,22
Rostov,5399,10,4,7,9,10,17,-7,19
Anzhi,5399,11,2,7,11,15,38,-23,13
Loko Moscow,5400,1,12,6,2,33,13,20,42
CSKA Moscow,5400,2,11,3,6,28,20,8,36
Spart Moscow,5400,3,10,5,5,39,28,11,35
Zenit,5400,4,8,9,3,24,15,9,33
Terek Grozny,5400,5,8,6,6,23,23,0,30
Krasnodar,5400,6,8,5,7,27,26,1,29
FK Rubin,5400,7,6,6,8,22,17,5,24
Din Moscow,5400,8,5,6,9,17,25,-8,21
Amkar,5400,9,5,5,10,12,24,-12,20
Rostov,5400,10,4,6,10,11,19,-8,18
Anzhi,5400,11,2,5,13,16,42,-26,11
Loko Moscow,5401,1,12,5,3,30,13,17,41
Zenit,5401,2,9,8,3,26,13,13,35
Spart Moscow,5401,3,9,6,5,37,31,6,33
CSKA Moscow,5401,4,10,3,7,25,23,2,33
Terek Grozny,5401,5,9,5,6,24,23,1,32
Krasnodar,5401,6,8,4,8,27,27,0,28
FK Rubin,5401,7,7,5,8,24,17,7,26
Din Moscow,5401,8,5,6,9,18,24,-6,21
Rostov,5401,9,4,7,9,11,18,-7,19
Amkar,5401,10,5,4,11,13,25,-12,19
Anzhi,5401,11,3,5,12,18,39,-21,14
Loko Moscow,5402,1,12,6,2,33,14,19,42
CSKA Moscow,5402,2,11,4,5,27,17,10,37
Spart Moscow,5402,3,10,5,5,38,29,9,35
Zenit,5402,4,7,10,3,22,14,8,31
Krasnodar,5402,5,9,4,7,33,28,5,31
Terek Grozny,5402,6,8,5,7,24,24,0,29
Din Moscow,5402,7,6,6,8,21,24,-3,24
FK Rubin,5402,8,6,5,9,24,21,3,23
Rostov,5402,9,4,6,10,10,20,-10,18
Amkar,5402,10,4,4,12,9,26,-17,16
Anzhi,5402,11,3,5,12,16,40,-24,14
Loko Moscow,5403,1,12,6,2,33,11,22,42
CSKA Moscow,5403,2,11,4,5,28,18,10,37
Spart Moscow,5403,3,10,6,4,41,28,13,36
Krasnodar,5403,4,9,5,6,29,25,4,32
Zenit,5403,5,7,9,4,22,18,4,30
Terek Grozny,5403,6,8,5,7,22,25,-3,29
Din Moscow,5403,7,6,6,8,21,26,-5,24
FK Rubin,5403,8,5,5,10,23,22,1,20
Amkar,5403,9,5,5,10,12,23,-11,20
Rostov,5403,10,4,6,10,11,20,-9,18
Anzhi,5403,11,2,5,13,15,41,-26,11
Loko Moscow,5404,1,12,6,2,31,12,19,42
CSKA Moscow,5404,2,11,3,6,26,20,6,36
Spart Moscow,5404,3,9,6,5,34,26,8,33
Zenit,5404,4,8,8,4,25,15,10,32
Krasnodar,5404,5,9,5,6,28,24,4,32
Terek Grozny,5404,6,7,7,6,21,23,-2,28
Din Moscow,5404,7,6,6,8,18,22,-4,24
FK Rubin,5404,8,6,5,9,22,18,4,23
Rostov,5404,9,4,6,10,10,18,-8,18
Amkar,5404,10,4,6,10,9,22,-13,18
Anzhi,5404,11,2,6,12,15,39,-24,12
Loko Moscow,5405,1,12,5,3,32,14,18,41
CSKA Moscow,5405,2,11,3,6,29,21,8,36
Spart Moscow,5405,3,10,5,5,37,27,10,35
Zenit,5405,4,9,8,3,25,15,10,35
Krasnodar,5405,5,9,4,7,30,27,3,31
Terek Grozny,5405,6,7,5,8,20,26,-6,26
FK Rubin,5405,7,6,5,9,23,18,5,23
Amkar,5405,8,6,4,10,11,22,-11,22
Din Moscow,5405,9,5,6,9,18,26,-8,21
Rostov,5405,10,4,6,10,10,18,-8,18
Anzhi,5405,11,3,5,12,18,39,-21,14
Loko Moscow,5406,1,13,5,2,34,12,22,44
CSKA Moscow,5406,2,10,5,5,27,19,8,35
Krasnodar,5406,3,9,4,7,30,26,4,31
Zenit,5406,4,7,9,4,22,17,5,30
Spart Moscow,5406,5,8,5,7,33,28,5,29
Din Moscow,5406,6,7,6,7,20,22,-2,27
Terek Grozny,5406,7,7,5,8,21,25,-4,26
Amkar,5406,8,6,4,10,11,22,-11,22
Rostov,5406,9,5,6,9,11,17,-6,21
FK Rubin,5406,10,5,5,10,22,21,1,20
Anzhi,5406,11,3,6,11,17,39,-22,15
Loko Moscow,5407,1,12,6,2,33,13,20,42
CSKA Moscow,5407,2,11,4,5,27,18,9,37
Spart Moscow,5407,3,9,7,4,37,28,9,34
Zenit,5407,4,7,9,4,22,15,7,30
Terek Grozny,5407,5,8,6,6,23,24,-1,30
Krasnodar,5407,6,8,4,8,29,29,0,28
FK Rubin,5407,7,7,5,8,25,18,7,26
Din Moscow,5407,8,5,6,9,17,24,-7,21
Rostov,5407,9,4,7,9,12,19,-7,19
Amkar,5407,10,4,6,10,11,24,-13,18
Anzhi,5407,11,2,6,12,16,40,-24,12
Loko Moscow,5408,1,12,6,2,33,13,20,42
CSKA Moscow,5408,2,11,4,5,28,19,9,37
Spart Moscow,5408,3,10,5,5,37,29,8,35
Krasnodar,5408,4,9,5,6,29,25,4,32
Zenit,5408,5,7,9,4,22,16,6,30
Terek Grozny,5408,6,8,5,7,23,23,0,29
Din Moscow,5408,7,5,7,8,21,26,-5,22
Amkar,5408,8,6,4,10,12,22,-10,22
FK Rubin,5408,9,5,6,9,23,20,3,21
Rostov,5408,10,4,6,10,10,18,-8,18
Anzhi,5408,11,2,5,13,16,43,-27,11
Loko Moscow,5409,1,12,5,3,31,13,18,41
CSKA Moscow,5409,2,11,4,5,28,19,9,37
Krasnodar,5409,3,9,5,6,28,24,4,32
Terek Grozny,5409,4,9,5,6,25,22,3,32
Zenit,5409,5,7,9,4,23,16,7,30
Spart Moscow,5409,6,8,6,6,35,31,4,30
Din Moscow,5409,7,5,8,7,18,22,-4,23
FK Rubin,5409,8,5,7,8,22,18,4,22
Rostov,5409,9,5,6,9,13,18,-5,21
Amkar,5409,10,5,4,11,12,25,-13,19
Anzhi,5409,11,2,5,13,15,42,-27,11
Loko Moscow,5410,1,12,5,3,32,13,19,41
CSKA Moscow,5410,2,11,4,5,27,18,9,37
Spart Moscow,5410,3,10,6,4,39,27,12,36
Krasnodar,5410,4,9,5,6,31,27,4,32
Zenit,5410,5,7,8,5,21,16,5,29
Terek Grozny,5410,6,8,5,7,23,23,0,29
Din Moscow,5410,7,5,8,7,19,23,-4,23
FK Rubin,5410,8,5,7,8,24,20,4,22
Amkar,5410,9,5,4,11,10,24,-14,19
Rostov,5410,10,4,6,10,11,20,-9,18
Anzhi,5410,11,2,6,12,15,41,-26,12
Loko Moscow,5411,1,12,5,3,30,12,18,41
CSKA Moscow,5411,2,11,4,5,28,17,11,37
Krasnodar,5411,3,10,4,6,29,24,5,34
Zenit,5411,4,7,9,4,21,14,7,30
Spart Moscow,5411,5,8,6,6,36,30,6,30
Terek Grozny,5411,6,8,5,7,23,27,-4,29
Din Moscow,5411,7,5,8,7,20,24,-4,23
FK Rubin,5411,8,5,6,9,22,19,3,21
Rostov,5411,9,5,6,9,12,18,-6,21
Amkar,5411,10,5,4,11,10,23,-13,19
Anzhi,5411,11,3,5,12,19,42,-23,14
Loko Moscow,5412,1,12,5,3,31,14,17,41
CSKA Moscow,5412,2,11,4,5,28,19,9,37
Krasnodar,5412,3,10,4,6,30,24,6,34
Spart Moscow,5412,4,9,6,5,37,27,10,33
Terek Grozny,5412,5,9,5,6,24,22,2,32
Zenit,5412,6,7,9,4,23,16,7,30
Din Moscow,5412,7,5,8,7,18,22,-4,23
FK Rubin,5412,8,5,6,9,21,18,3,21
Amkar,5412,9,5,4,11,10,25,-15,19
Rostov,5412,10,4,6,10,10,20,-10,18
Anzhi,5412,11,2,5,13,15,40,-25,11
Loko Moscow,5413,1,11,6,3,29,12,17,39
Spart Moscow,5413,2,11,5,4,40,27,13,38
Zenit,5413,3,9,8,3,23,13,10,35
CSKA Moscow,5413,4,10,4,6,28,21,7,34
Krasnodar,5413,5,9,5,6,31,24,7,32
Terek Grozny,5413,6,8,5,7,22,24,-2,29
FK Rubin,5413,7,6,5,9,22,21,1,23
Din Moscow,5413,8,5,6,9,18,25,-7,21
Amkar,5413,9,5,4,11,12,25,-13,19
Rostov,5413,10,4,6,10,10,19,-9,18
Anzhi,5413,11,2,6,12,17,41,-24,12
Loko Moscow,5414,1,11,6,3,32,19,13,39
CSKA Moscow,5414,2,11,3,6,26,18,8,36
Zenit,5414,3,9,8,3,28,14,14,35
Spart Moscow,5414,4,10,5,5,40,28,12,35
Krasnodar,5414,5,8,5,7,30,28,2,29
Terek Grozny,5414,6,8,5,7,22,25,-3,29
Din Moscow,5414,7,6,6,8,19,25,-6,24
FK Rubin,5414,8,6,5,9,23,20,3,23
Amkar,5414,9,6,4,10,14,23,-9,22
Rostov,5414,10,4,6,10,11,19,-8,18
Anzhi,5414,11,2,5,13,14,40,-26,11
Loko Moscow,5415,1,12,6,2,31,12,19,42
Spart Moscow,5415,2,10,6,4,38,27,11,36
CSKA Moscow,5415,3,10,3,7,27,22,5,33
Zenit,5415,4,8,8,4,25,16,9,32
Krasnodar,5415,5,9,5,6,28,24,4,32
Terek Grozny,5415,6,8,5,7,22,24,-2,29
Din Moscow,5415,7,6,7,7,21,24,-3,25
FK Rubin,5415,8,5,5,10,22,20,2,20
Amkar,5415,9,5,4,11,11,24,-13,19
Rostov,5415,10,4,6,10,10,19,-9,18
Anzhi,5415,11,3,5,12,16,39,-23,14
Loko Moscow,5416,1,11,7,2,30,12,18,40
Spart Moscow,5416,2,10,6,4,36,26,10,36
CSKA Moscow,5416,3,10,5,5,27,19,8,35
Krasnodar,5416,4,9,5,6,28,24,4,32
Zenit,5416,5,7,10,3,22,14,8,31
Terek Grozny,5416,6,8,6,6,25,23,2,30
Din Moscow,5416,7,5,7,8,17,22,-5,22
FK Rubin,5416,8,5,6,9,21,18,3,21
Rostov,5416,9,4,7,9,11,18,-7,19
Amkar,5416,10,4,5,11,9,23,-14,17
Anzhi,5416,11,2,6,12,17,44,-27,12
Loko Moscow,5417,1,12,5,3,30,15,15,41
Spart Moscow,5417,2,10,6,4,41,28,13,36
CSKA Moscow,5417,3,11,3,6,27,20,7,36
Krasnodar,5417,4,9,4,7,32,26,6,31
Terek Grozny,5417,5,8,6,6,22,23,-1,30
Zenit,5417,6,7,8,5,21,16,5,29
FK Rubin,5417,7,6,6,8,23,18,5,24
Din Moscow,5417,8,5,7,8,17,23,-6,22
Rostov,5417,9,4,7,9,12,19,-7,19
Amkar,5417,10,4,4,12,10,27,-17,16
Anzhi,5417,11,3,6,11,18,38,-20,15
Loko Moscow,5418,1,13,5,2,32,11,21,44
CSKA Moscow,5418,2,12,3,5,35,20,15,39
Spart Moscow,5418,3,8,7,5,36,29,7,31
Zenit,5418,4,7,8,5,22,17,5,29
Krasnodar,5418,5,8,5,7,27,26,1,29
Terek Grozny,5418,6,7,6,7,21,25,-4,27
Din Moscow,5418,7,6,7,7,21,22,-1,25
FK Rubin,5418,8,5,6,9,22,21,1,21
Amkar,5418,9,5,5,10,12,24,-12,20
Rostov,5418,10,4,7,9,12,19,-7,19
Anzhi,5418,11,3,5,12,18,44,-26,14
Loko Moscow,5419,1,12,6,2,33,14,19,42
Spart Moscow,5419,2,10,6,4,38,28,10,36
CSKA Moscow,5419,3,11,3,6,26,19,7,36
Zenit,5419,4,8,8,4,24,15,9,32
Krasnodar,5419,5,8,6,6,29,26,3,30
Terek Grozny,5419,6,7,7,6,22,24,-2,28
FK Rubin,5419,7,6,6,8,22,17,5,24
Din Moscow,5419,8,5,7,8,19,24,-5,22
Rostov,5419,9,4,6,10,10,18,-8,18
Amkar,5419,10,4,5,11,11,25,-14,17
Anzhi,5419,11,2,6,12,15,39,-24,12
Loko Moscow,5420,1,13,5,2,32,12,20,44
Spart Moscow,5420,2,10,5,5,38,29,9,35
CSKA Moscow,5420,3,10,4,6,28,21,7,34
Krasnodar,5420,4,9,4,7,29,26,3,31
Zenit,5420,5,7,9,4,23,16,7,30
Terek Grozny,5420,6,8,5,7,22,24,-2,29
Din Moscow,5420,7,6,6,8,20,24,-4,24
Amkar,5420,8,6,4,10,14,24,-10,22
FK Rubin,5420,9,5,5,10,22,20,2,20
Rostov,5420,10,4,6,10,10,19,-9,18
Anzhi,5420,11,3,5,12,16,39,-23,14
Loko Moscow,5421,1,11,6,3,30,13,17,39
CSKA Moscow,5421,2,11,3,6,27,20,7,36
Zenit,5421,3,8,9,3,24,14,10,33
Spart Moscow,5421,4,9,5,6,35,28,7,32
Krasnodar,5421,5,9,5,6,30,26,4,32
Terek Grozny,5421,6,8,6,6,24,24,0,30
FK Rubin,5421,7,6,6,8,25,19,6,24
Din Moscow,5421,8,6,6,8,18,23,-5,24
Rostov,5421,9,5,6,9,12,18,-6,21
Amkar,5421,10,4,5,11,11,25,-14,17
Anzhi,5421,11,2,5,13,15,41,-26,11
Loko Moscow,5422,1,11,7,2,31,13,18,40
CSKA Moscow,5422,2,11,3,6,28,18,10,36
Zenit,5422,3,8,9,3,23,14,9,33
Spart Moscow,5422,4,9,6,5,35,28,7,33
Krasnodar,5422,5,9,5,6,31,26,5,32
Terek Grozny,5422,6,8,5,7,22,24,-2,29
FK Rubin,5422,7,6,5,9,23,20,3,23
Din Moscow,5422,8,5,7,8,18,23,-5,22
Amkar,5422,9,5,4,11,12,24,-12,19
Rostov,5422,10,4,6,10,10,18,-8,18
Anzhi,5422,11,3,5,12,15,40,-25,14
Loko Moscow,5423,1,12,5,3,32,12,20,41
CSKA Moscow,5423,2,11,3,6,28,19,9,36
Zenit,5423,3,9,8,3,24,13,11,35
Spart Moscow,5423,4,10,5,5,37,27,10,35
Krasnodar,5423,5,8,5,7,28,28,0,29
Din Moscow,5423,6,7,6,7,20,21,-1,27
Terek Grozny,5423,7,7,6,7,21,24,-3,27
FK Rubin,5423,8,5,6,9,22,20,2,21
Rostov,5423,9,4,6,10,10,19,-9,18
Amkar,5423,10,4,5,11,11,25,-14,17
Anzhi,5423,11,3,5,12,15,40,-25,14
Loko Moscow,5424,1,11,5,4,30,14,16,38
CSKA Moscow,5424,2,11,4,5,27,17,10,37
Krasnodar,5424,3,10,4,6,31,26,5,34
Zenit,5424,4,8,9,3,22,13,9,33
Spart Moscow,5424,5,9,5,6,35,29,6,32
Terek Grozny,5424,6,8,5,7,23,23,0,29
Din Moscow,5424,7,7,6,7,21,22,-1,27
Amkar,5424,8,6,4,10,12,22,-10,22
FK Rubin,5424,9,5,5,10,22,21,1,20
Rostov,5424,10,4,6,10,10,18,-8,18
Anzhi,5424,11,2,5,13,14,42,-28,11
Loko Moscow,5425,1,11,6,3,29,13,16,39
CSKA Moscow,5425,2,11,3,6,28,20,8,36
Zenit,5425,3,9,8,3,25,14,11,35
Spart Moscow,5425,4,9,6,5,37,28,9,33
Krasnodar,5425,5,9,5,6,28,24,4,32
Terek Grozny,5425,6,8,5,7,21,23,-2,29
Din Moscow,5425,7,5,8,7,17,21,-4,23
Amkar,5425,8,6,4,10,13,23,-10,22
FK Rubin,5425,9,5,6,9,21,18,3,21
Rostov,5425,10,4,6,10,10,20,-10,18
Anzhi,5425,11,2,5,13,15,40,-25,11
Loko Moscow,5426,1,11,6,3,30,14,16,39
CSKA Moscow,5426,2,11,4,5,28,18,10,37
Spart Moscow,5426,3,9,7,4,35,25,10,34
Krasnodar,5426,4,10,4,6,34,25,9,34
Zenit,5426,5,7,10,3,21,13,8,31
Terek Grozny,5426,6,7,5,8,20,26,-6,26
Din Moscow,5426,7,5,8,7,17,21,-4,23
FK Rubin,5426,8,5,6,9,21,21,0,21
Amkar,5426,9,5,5,10,12,22,-10,20
Rostov,5426,10,4,6,10,10,19,-9,18
Anzhi,5426,11,3,5,12,16,40,-24,14
Loko Moscow,5427,1,11,6,3,29,12,17,39
CSKA Moscow,5427,2,12,3,5,32,18,14,39
Spart Moscow,5427,3,11,5,4,41,26,15,38
Krasnodar,5427,4,9,4,7,29,26,3,31
Zenit,5427,5,7,9,4,22,15,7,30
Terek Grozny,5427,6,7,6,7,20,24,-4,27
Din Moscow,5427,7,6,6,8,20,25,-5,24
FK Rubin,5427,8,6,5,9,24,21,3,23
Rostov,5427,9,4,6,10,10,20,-10,18
Amkar,5427,10,4,5,11,10,24,-14,17
Anzhi,5427,11,3,5,12,16,42,-26,14
Loko Moscow,5428,1,12,5,3,31,15,16,41
Spart Moscow,5428,2,10,6,4,35,25,10,36
CSKA Moscow,5428,3,11,3,6,30,21,9,36
Zenit,5428,4,9,8,3,27,15,12,35
Krasnodar,5428,5,9,4,7,30,27,3,31
Terek Grozny,5428,6,8,5,7,25,24,1,29
Din Moscow,5428,7,5,7,8,18,23,-5,22
FK Rubin,5428,8,5,6,9,23,20,3,21
Rostov,5428,9,4,6,10,10,18,-8,18
Amkar,5428,10,4,5,11,10,27,-17,17
Anzhi,5428,11,3,5,12,16,40,-24,14
Loko Moscow,5429,1,13,5,2,35,12,23,44
CSKA Moscow,5429,2,11,4,5,26,17,9,37
Krasnodar,5429,3,9,4,7,30,27,3,31
Spart Moscow,5429,4,8,6,6,36,32,4,30
Terek Grozny,5429,5,8,6,6,22,23,-1,30
Zenit,5429,6,7,8,5,22,18,4,29
Din Moscow,5429,7,6,7,7,22,23,-1,25
FK Rubin,5429,8,5,6,9,23,21,2,21
Rostov,5429,9,5,6,9,12,18,-6,21
Amkar,5429,10,4,5,11,10,24,-14,17
Anzhi,5429,11,2,7,11,15,38,-23,13
Loko Moscow,5430,1,12,5,3,30,12,18,41
CSKA Moscow,5430,2,11,3,6,26,19,7,36
Spart Moscow,5430,3,9,6,5,37,33,4,33
Zenit,5430,4,8,8,4,23,14,9,32
Terek Grozny,5430,5,9,5,6,23,23,0,32
Krasnodar,5430,6,9,4,7,28,25,3,31
FK Rubin,5430,7,7,5,8,25,17,8,26
Din Moscow,5430,8,5,7,8,20,27,-7,22
Amkar,5430,9,5,4,11,14,23,-9,19
Rostov,5430,10,4,6,10,10,18,-8,18
Anzhi,5430,11,2,5,13,15,40,-25,11
Loko Moscow,5431,1,11,6,3,30,16,14,39
CSKA Moscow,5431,2,12,3,5,29,17,12,39
Spart Moscow,5431,3,9,6,5,38,28,10,33
Krasnodar,5431,4,9,4,7,31,25,6,31
Zenit,5431,5,7,9,4,22,15,7,30
Terek Grozny,5431,6,8,6,6,23,24,-1,30
FK Rubin,5431,7,6,6,8,23,18,5,24
Din Moscow,5431,8,5,7,8,18,25,-7,22
Rostov,5431,9,4,7,9,11,18,-7,19
Amkar,5431,10,5,4,11,11,24,-13,19
Anzhi,5431,11,2,6,12,16,42,-26,12
Loko Moscow,5432,1,12,5,3,30,12,18,41
CSKA Moscow,5432,2,11,3,6,27,20,7,36
Zenit,5432,3,8,8,4,24,15,9,32
Spart Moscow,5432,4,8,8,4,39,31,8,32
Krasnodar,5432,5,9,4,7,29,28,1,31
Terek Grozny,5432,6,8,5,7,25,26,-1,29
FK Rubin,5432,7,7,5,8,28,20,8,26
Din Moscow,5432,8,5,7,8,21,26,-5,22
Amkar,5432,9,5,5,10,13,24,-11,20
Rostov,5432,10,4,7,9,13,20,-7,19
Anzhi,5432,11,2,5,13,15,42,-27,11
Loko Moscow,5433,1,12,5,3,33,16,17,41
CSKA Moscow,5433,2,11,3,6,26,20,6,36
Krasnodar,5433,3,10,4,6,35,28,7,34
Zenit,5433,4,8,8,4,24,15,9,32
Spart Moscow,5433,5,9,5,6,35,31,4,32
Terek Grozny,5433,6,7,6,7,20,25,-5,27
Din Moscow,5433,7,6,7,7,23,23,0,25
FK Rubin,5433,8,5,6,9,25,22,3,21
Amkar,5433,9,5,5,10,11,22,-11,20
Rostov,5433,10,4,6,10,10,19,-9,18
Anzhi,5433,11,3,5,12,17,38,-21,14
Loko Moscow,5434,1,11,6,3,31,14,17,39
CSKA Moscow,5434,2,11,3,6,31,20,11,36
Spart Moscow,5434,3,9,7,4,38,29,9,34
Zenit,5434,4,8,9,3,25,16,9,33
Krasnodar,5434,5,9,4,7,28,26,2,31
Terek Grozny,5434,6,8,6,6,22,23,-1,30
FK Rubin,5434,7,6,6,8,23,17,6,24
Din Moscow,5434,8,5,7,8,18,23,-5,22
Rostov,5434,9,4,7,9,11,18,-7,19
Amkar,5434,10,4,6,10,12,25,-13,18
Anzhi,5434,11,2,5,13,15,43,-28,11
Loko Moscow,5435,1,11,6,3,31,14,17,39
Spart Moscow,5435,2,11,5,4,42,27,15,38
Zenit,5435,3,9,8,3,24,14,10,35
CSKA Moscow,5435,4,10,4,6,27,20,7,34
Terek Grozny,5435,5,9,5,6,24,24,0,32
Krasnodar,5435,6,8,6,6,29,26,3,30
FK Rubin,5435,7,5,7,8,22,18,4,22
Din Moscow,5435,8,5,7,8,17,25,-8,22
Rostov,5435,9,4,6,10,11,19,-8,18
Amkar,5435,10,4,4,12,11,27,-16,16
Anzhi,5435,11,2,6,12,17,41,-24,12
Loko Moscow,5436,1,12,5,3,31,13,18,41
Spart Moscow,5436,2,11,5,4,40,27,13,38
CSKA Moscow,5436,3,11,3,6,29,21,8,36
Zenit,5436,4,9,8,3,25,14,11,35
Krasnodar,5436,5,8,4,8,29,28,1,28
Terek Grozny,5436,6,7,7,6,22,24,-2,28
Din Moscow,5436,7,6,6,8,18,22,-4,24
FK Rubin,5436,8,6,5,9,23,19,4,23
Rostov,5436,9,4,6,10,10,19,-9,18
Amkar,5436,10,4,5,11,12,27,-15,17
Anzhi,5436,11,2,6,12,16,41,-25,12
Loko Moscow,5437,1,13,5,2,34,13,21,44
CSKA Moscow,5437,2,11,4,5,28,19,9,37
Spart Moscow,5437,3,10,5,5,39,27,12,35
Terek Grozny,5437,4,8,6,6,25,25,0,30
Zenit,5437,5,7,8,5,23,18,5,29
Krasnodar,5437,6,8,5,7,29,27,2,29
FK Rubin,5437,7,6,6,8,23,18,5,24
Din Moscow,5437,8,6,6,8,18,22,-4,24
Rostov,5437,9,4,6,10,11,20,-9,18
Amkar,5437,10,4,4,12,11,29,-18,16
Anzhi,5437,11,2,7,11,16,39,-23,13
Loko Moscow,5438,1,11,6,3,29,13,16,39
Spart Moscow,5438,2,10,6,4,39,27,12,36
CSKA Moscow,5438,3,11,3,6,28,18,10,36
Zenit,5438,4,8,9,3,22,13,9,33
Krasnodar,5438,5,9,4,7,29,25,4,31
Terek Grozny,5438,6,8,6,6,22,23,-1,30
FK Rubin,5438,7,7,5,8,24,17,7,26
Din Moscow,5438,8,5,6,9,18,25,-7,21
Rostov,5438,9,4,7,9,10,17,-7,19
Amkar,5438,10,4,5,11,11,27,-16,17
Anzhi,5438,11,2,5,13,14,41,-27,11
Loko Moscow,5439,1,12,6,2,32,12,20,42
CSKA Moscow,5439,2,11,4,5,29,19,10,37
Spart Moscow,5439,3,9,6,5,36,27,9,33
Zenit,5439,4,7,9,4,22,16,6,30
Krasnodar,5439,5,8,5,7,28,26,2,29
Terek Grozny,5439,6,8,5,7,23,24,-1,29
FK Rubin,5439,7,6,6,8,23,18,5,24
Din Moscow,5439,8,5,7,8,19,25,-6,22
Amkar,5439,9,6,4,10,12,23,-11,22
Rostov,5439,10,4,7,9,10,17,-7,19
Anzhi,5439,11,2,5,13,15,42,-27,11
Loko Moscow,5440,1,12,6,2,33,13,20,42
CSKA Moscow,5440,2,11,4,5,29,19,10,37
Spart Moscow,5440,3,9,6,5,37,28,9,33
Krasnodar,5440,4,9,5,6,30,26,4,32
Zenit,5440,5,7,8,5,22,18,4,29
Terek Grozny,5440,6,8,5,7,21,23,-2,29
Din Moscow,5440,7,7,6,7,20,21,-1,27
FK Rubin,5440,8,5,5,10,21,19,2,20
Amkar,5440,9,5,5,10,11,23,-12,20
Rostov,5440,10,4,6,10,10,20,-10,18
Anzhi,5440,11,2,6,12,15,39,-24,12
Loko Moscow,5441,1,11,6,3,31,14,17,39
CSKA Moscow,5441,2,12,3,5,30,19,11,39
Spart Moscow,5441,3,9,5,6,37,31,6,32
Krasnodar,5441,4,9,5,6,29,25,4,32
Zenit,5441,5,7,9,4,24,17,7,30
Terek Grozny,5441,6,8,6,6,25,24,1,30
Din Moscow,5441,7,7,6,7,24,22,2,27
FK Rubin,5441,8,5,6,9,23,23,0,21
Amkar,5441,9,5,5,10,14,26,-12,20
Rostov,5441,10,4,6,10,11,19,-8,18
Anzhi,5441,11,2,5,13,15,43,-28,11
Loko Moscow,5442,1,12,5,3,31,13,18,41
CSKA Moscow,5442,2,10,4,6,25,18,7,34
Krasnodar,5442,3,10,4,6,30,25,5,34
Spart Moscow,5442,4,9,6,5,37,28,9,33
Zenit,5442,5,8,8,4,22,14,8,32
Din Moscow,5442,6,7,6,7,20,21,-1,27
Terek Grozny,5442,7,7,6,7,21,25,-4,27
FK Rubin,5442,8,5,5,10,21,19,2,20
Rostov,5442,9,4,6,10,10,20,-10,18
Amkar,5442,10,4,6,10,10,23,-13,18
Anzhi,5442,11,3,6,11,17,38,-21,15
Loko Moscow,5443,1,12,6,2,31,12,19,42
CSKA Moscow,5443,2,12,3,5,30,17,13,39
Spart Moscow,5443,3,9,6,5,39,29,10,33
Krasnodar,5443,4,9,4,7,29,26,3,31
Zenit,5443,5,7,9,4,21,15,6,30
Terek Grozny,5443,6,8,5,7,22,23,-1,29
Din Moscow,5443,7,6,6,8,19,24,-5,24
FK Rubin,5443,8,6,5,9,23,18,5,23
Amkar,5443,9,5,5,10,12,24,-12,20
Rostov,5443,10,4,6,10,10,20,-10,18
Anzhi,5443,11,2,5,13,14,42,-28,11
Loko Moscow,5444,1,12,6,2,33,14,19,42
CSKA Moscow,5444,2,10,4,6,26,19,7,34
Spart Moscow,5444,3,9,6,5,36,28,8,33
Zenit,5444,4,8,8,4,23,15,8,32
Terek Grozny,5444,5,8,6,6,23,23,0,30
Krasnodar,5444,6,8,5,7,29,28,1,29
Din Moscow,5444,7,6,7,7,21,24,-3,25
FK Rubin,5444,8,6,5,9,24,19,5,23
Rostov,5444,9,5,6,9,11,17,-6,21
Amkar,5444,10,4,4,12,10,26,-16,16
Anzhi,5444,11,2,7,11,15,38,-23,13
Loko Moscow,5445,1,12,6,2,32,13,19,42
CSKA Moscow,5445,2,11,3,6,29,20,9,36
Spart Moscow,5445,3,10,5,5,38,27,11,35
Zenit,5445,4,8,8,4,25,15,10,32
Krasnodar,5445,5,8,5,7,29,27,2,29
Terek Grozny,5445,6,7,7,6,22,24,-2,28
FK Rubin,5445,7,6,6,8,23,18,5,24
Din Moscow,5445,8,5,7,8,17,24,-7,22
Rostov,5445,9,5,6,9,11,17,-6,21
Amkar,5445,10,4,5,11,11,25,-14,17
Anzhi,5445,11,2,6,12,15,42,-27,12
Loko Moscow,5446,1,12,6,2,33,13,20,42
CSKA Moscow,5446,2,12,3,5,29,18,11,39
Krasnodar,5446,3,9,5,6,29,25,4,32
Spart Moscow,5446,4,8,7,5,36,29,7,31
Zenit,5446,5,7,8,5,22,18,4,29
Terek Grozny,5446,6,8,5,7,22,27,-5,29
Din Moscow,5446,7,6,7,7,20,23,-3,25
Rostov,5446,8,5,6,9,11,17,-6,21
FK Rubin,5446,9,5,5,10,21,19,2,20
Amkar,5446,10,4,5,11,10,24,-14,17
Anzhi,5446,11,3,5,12,20,40,-20,14
Loko Moscow,5447,1,11,6,3,31,14,17,39
Zenit,5447,2,9,8,3,26,15,11,35
CSKA Moscow,5447,3,10,3,7,27,22,5,33
Spart Moscow,5447,4,9,5,6,36,29,7,32
Krasnodar,5447,5,8,5,7,29,27,2,29
Terek Grozny,5447,6,7,6,7,21,28,-7,27
FK Rubin,5447,7,7,5,8,24,18,6,26
Din Moscow,5447,8,6,6,8,18,22,-4,24
Amkar,5447,9,6,4,10,17,23,-6,22
Rostov,5447,10,4,6,10,10,19,-9,18
Anzhi,5447,11,3,6,11,17,39,-22,15
Loko Moscow,5448,1,12,6,2,32,13,19,42
Spart Moscow,5448,2,11,5,4,39,28,11,38
CSKA Moscow,5448,3,10,4,6,26,22,4,34
Zenit,5448,4,8,8,4,26,15,11,32
Terek Grozny,5448,5,9,5,6,24,23,1,32
Krasnodar,5448,6,8,6,6,28,25,3,30
FK Rubin,5448,7,5,7,8,21,17,4,22
Din Moscow,5448,8,5,7,8,17,22,-5,22
Rostov,5448,9,4,6,10,12,20,-8,18
Amkar,5448,10,4,4,12,10,26,-16,16
Anzhi,5448,11,2,6,12,16,40,-24,12
Loko Moscow,5449,1,11,5,4,31,16,15,38
CSKA Moscow,5449,2,11,4,5,30,19,11,37
Zenit,5449,3,8,9,3,25,16,9,33
Spart Moscow,5449,4,9,6,5,36,29,7,33
Krasnodar,5449,5,9,4,7,30,26,4,31
Terek Grozny,5449,6,8,5,7,22,27,-5,29
FK Rubin,5449,7,7,5,8,24,18,6,26
Din Moscow,5449,8,6,6,8,20,23,-3,24
Rostov,5449,9,4,6,10,11,19,-8,18
Amkar,5449,10,4,5,11,11,25,-14,17
Anzhi,5449,11,3,5,12,18,40,-22,14
Loko Moscow,5450,1,12,5,3,33,16,17,41
CSKA Moscow,5450,2,10,4,6,26,20,6,34
Spart Moscow,5450,3,8,8,4,35,27,8,32
Zenit,5450,4,8,8,4,24,17,7,32
Krasnodar,5450,5,9,4,7,31,26,5,31
Terek Grozny,5450,6,7,5,8,20,24,-4,26
Din Moscow,5450,7,6,7,7,21,22,-1,25
FK Rubin,5450,8,6,5,9,23,20,3,23
Amkar,5450,9,5,5,10,11,23,-12,20
Rostov,5450,10,4,7,9,10,17,-7,19
Anzhi,5450,11,3,6,11,16,38,-22,15
Loko Moscow,5451,1,11,6,3,31,15,16,39
CSKA Moscow,5451,2,11,3,6,30,21,9,36
Zenit,5451,3,9,8,3,26,15,11,35
Spart Moscow,5451,4,10,5,5,36,29,7,35
Krasnodar,5451,5,8,5,7,30,28,2,29
Terek Grozny,5451,6,8,5,7,21,27,-6,29
FK Rubin,5451,7,6,6,8,23,18,5,24
Din Moscow,5451,8,5,7,8,17,23,-6,22
Amkar,5451,9,5,4,11,13,23,-10,19
Rostov,5451,10,4,6,10,10,18,-8,18
Anzhi,5451,11,3,5,12,20,40,-20,14
Loko Moscow,5452,1,12,6,2,33,14,19,42
CSKA Moscow,5452,2,11,4,5,30,18,12,37
Spart Moscow,5452,3,9,5,6,36,30,6,32
Zenit,5452,4,7,10,3,24,16,8,31
Krasnodar,5452,5,8,4,8,29,28,1,28
Terek Grozny,5452,6,7,6,7,20,26,-6,27
Din Moscow,5452,7,6,6,8,19,23,-4,24
FK Rubin,5452,8,6,5,9,23,19,4,23
Rostov,5452,9,5,6,9,11,17,-6,21
Amkar,5452,10,5,5,10,12,23,-11,20
Anzhi,5452,11,3,5,12,18,41,-23,14
Loko Moscow,5453,1,12,5,3,31,12,19,41
Spart Moscow,5453,2,10,6,4,41,27,14,36
CSKA Moscow,5453,3,11,3,6,30,20,10,36
Zenit,5453,4,8,8,4,24,16,8,32
Krasnodar,5453,5,9,4,7,29,26,3,31
Terek Grozny,5453,6,7,6,7,21,24,-3,27
FK Rubin,5453,7,6,6,8,24,19,5,24
Din Moscow,5453,8,5,8,7,19,23,-4,23
Rostov,5453,9,4,6,10,10,21,-11,18
Amkar,5453,10,4,5,11,11,26,-15,17
Anzhi,5453,11,3,5,12,15,41,-26,14
Loko Moscow,5454,1,11,6,3,29,12,17,39
CSKA Moscow,5454,2,12,3,5,32,18,14,39
Spart Moscow,5454,3,9,7,4,36,27,9,34
Zenit,5454,4,8,8,4,23,15,8,32
Krasnodar,5454,5,8,6,6,27,24,3,30
Terek Grozny,5454,6,7,5,8,21,26,-5,26
Din Moscow,5454,7,6,7,7,20,22,-2,25
FK Rubin,5454,8,5,6,9,21,19,2,21
Rostov,5454,9,4,7,9,11,18,-7,19
Amkar,5454,10,5,4,11,10,23,-13,19
Anzhi,5454,11,3,5,12,17,43,-26,14
Loko Moscow,5455,1,13,5,2,31,11,20,44
CSKA Moscow,5455,2,11,4,5,30,19,11,37
Spart Moscow,5455,3,9,7,4,39,30,9,34
Terek Grozny,5455,4,9,5,6,22,22,0,32
Zenit,5455,5,7,9,4,23,16,7,30
Krasnodar,5455,6,8,5,7,29,27,2,29
FK Rubin,5455,7,5,7,8,24,20,4,22
Din Moscow,5455,8,5,7,8,19,24,-5,22
Rostov,5455,9,4,7,9,11,18,-7,19
Amkar,5455,10,4,5,11,12,26,-14,17
Anzhi,5455,11,2,5,13,14,41,-27,11
Loko Moscow,5456,1,13,5,2,33,13,20,44
Spart Moscow,5456,2,11,5,4,42,27,15,38
CSKA Moscow,5456,3,10,5,5,27,19,8,35
Krasnodar,5456,4,9,4,7,29,26,3,31
Zenit,5456,5,7,9,4,24,17,7,30
Terek Grozny,5456,6,8,5,7,21,24,-3,29
Din Moscow,5456,7,6,6,8,20,26,-6,24
FK Rubin,5456,8,5,5,10,22,20,2,20
Rostov,5456,9,4,6,10,10,20,-10,18
Amkar,5456,10,4,4,12,9,24,-15,16
Anzhi,5456,11,3,6,11,17,38,-21,15
Loko Moscow,5457,1,12,6,2,32,12,20,42
CSKA Moscow,5457,2,11,3,6,27,19,8,36
Spart Moscow,5457,3,9,7,4,38,29,9,34
Zenit,5457,4,8,8,4,22,15,7,32
Krasnodar,5457,5,8,6,6,29,26,3,30
Terek Grozny,5457,6,8,5,7,23,25,-2,29
FK Rubin,5457,7,6,6,8,24,19,5,24
Din Moscow,5457,8,5,7,8,20,25,-5,22
Rostov,5457,9,4,6,10,12,20,-8,18
Amkar,5457,10,4,5,11,9,24,-15,17
Anzhi,5457,11,3,5,12,18,40,-22,14
Loko Moscow,5458,1,12,5,3,30,13,17,41
Spart Moscow,5458,2,10,6,4,41,27,14,36
CSKA Moscow,5458,3,10,5,5,29,21,8,35
Krasnodar,5458,4,10,4,6,31,24,7,34
Zenit,5458,5,7,9,4,23,16,7,30
Terek Grozny,5458,6,8,5,7,21,23,-2,29
Din Moscow,5458,7,6,6,8,20,26,-6,24
FK Rubin,5458,8,5,5,10,22,22,0,20
Rostov,5458,9,4,6,10,11,20,-9,18
Amkar,5458,10,4,5,11,10,24,-14,17
Anzhi,5458,11,3,6,11,17,39,-22,15
Loko Moscow,5459,1,12,5,3,31,13,18,41
CSKA Moscow,5459,2,11,4,5,29,18,11,37
Zenit,5459,3,8,9,3,23,14,9,33
Spart Moscow,5459,4,8,7,5,36,31,5,31
Krasnodar,5459,5,8,5,7,28,26,2,29
Terek Grozny,5459,6,7,7,6,23,25,-2,28
FK Rubin,5459,7,6,6,8,23,18,5,24
Din Moscow,5459,8,6,6,8,21,23,-2,24
Rostov,5459,9,4,7,9,11,18,-7,19
Amkar,5459,10,4,6,10,12,25,-13,18
Anzhi,5459,11,2,6,12,16,42,-26,12
Loko Moscow,5460,1,12,5,3,31,12,19,41
Spart Moscow,5460,2,10,6,4,40,30,10,36
CSKA Moscow,5460,3,11,3,6,30,21,9,36
Zenit,5460,4,9,8,3,25,15,10,35
Krasnodar,5460,5,9,4,7,28,26,2,31
Terek Grozny,5460,6,7,6,7,22,26,-4,27
Din Moscow,5460,7,6,6,8,22,24,-2,24
FK Rubin,5460,8,5,5,10,21,21,0,20
Rostov,5460,9,4,7,9,12,19,-7,19
Amkar,5460,10,4,5,11,11,25,-14,17
Anzhi,5460,11,3,5,12,18,41,-23,14
Loko Moscow,5461,1,12,5,3,33,15,18,41
CSKA Moscow,5461,2,11,3,6,27,18,9,36
Zenit,5461,3,8,8,4,24,17,7,32
Spart Moscow,5461,4,9,5,6,36,31,5,32
Krasnodar,5461,5,9,4,7,30,26,4,31
Terek Grozny,5461,6,8,6,6,24,24,0,30
Din Moscow,5461,7,6,6,8,19,22,-3,24
FK Rubin,5461,8,6,5,9,22,19,3,23
Amkar,5461,9,5,4,11,12,25,-13,19
Rostov,5461,10,4,6,10,11,19,-8,18
Anzhi,5461,11,3,6,11,17,39,-22,15
Loko Moscow,5462,1,11,6,3,30,13,17,39
CSKA Moscow,5462,2,11,3,6,27,24,3,36
Zenit,5462,3,9,8,3,28,13,15,35
Spart Moscow,5462,4,9,7,4,35,25,10,34
Krasnodar,5462,5,9,5,6,29,25,4,32
Terek Grozny,5462,6,7,6,7,21,25,-4,27
Din Moscow,5462,7,6,6,8,19,24,-5,24
FK Rubin,5462,8,5,5,10,22,20,2,20
Amkar,5462,9,5,5,10,11,22,-11,20
Rostov,5462,10,4,7,9,10,17,-7,19
Anzhi,5462,11,2,6,12,16,40,-24,12
Loko Moscow,5463,1,11,7,2,30,12,18,40
Spart Moscow,5463,2,10,5,5,38,27,11,35
CSKA Moscow,5463,3,10,5,5,28,20,8,35
Zenit,5463,4,7,10,3,22,14,8,31
Terek Grozny,5463,5,8,6,6,23,24,-1,30
Krasnodar,5463,6,8,5,7,28,26,2,29
Din Moscow,5463,7,6,6,8,20,23,-3,24
FK Rubin,5463,8,6,5,9,22,20,2,23
Amkar,5463,9,5,5,10,12,24,-12,20
Rostov,5463,10,4,6,10,10,19,-9,18
Anzhi,5463,11,2,6,12,17,41,-24,12
Loko Moscow,5464,1,13,5,2,33,13,20,44
CSKA Moscow,5464,2,11,4,5,28,18,10,37
Spart Moscow,5464,3,10,6,4,39,26,13,36
Terek Grozny,5464,4,9,5,6,29,24,5,32
Zenit,5464,5,7,8,5,22,17,5,29
Krasnodar,5464,6,8,4,8,28,27,1,28
FK Rubin,5464,7,7,5,8,24,17,7,26
Din Moscow,5464,8,5,6,9,17,27,-10,21
Rostov,5464,9,4,6,10,11,19,-8,18
Amkar,5464,10,4,5,11,11,26,-15,17
Anzhi,5464,11,2,6,12,15,43,-28,12
Loko Moscow,5465,1,12,5,3,35,15,20,41
Spart Moscow,5465,2,11,5,4,38,27,11,38
CSKA Moscow,5465,3,11,3,6,28,18,10,36
Zenit,5465,4,8,8,4,23,17,6,32
Krasnodar,5465,5,9,5,6,32,28,4,32
Terek Grozny,5465,6,8,6,6,22,22,0,30
FK Rubin,5465,7,5,7,8,24,20,4,22
Din Moscow,5465,8,5,7,8,18,23,-5,22
Rostov,5465,9,4,6,10,11,19,-8,18
Amkar,5465,10,4,4,12,10,26,-16,16
Anzhi,5465,11,2,6,12,14,40,-26,12
Loko Moscow,5466,1,11,6,3,29,12,17,39
CSKA Moscow,5466,2,12,3,5,29,17,12,39
Spart Moscow,5466,3,9,6,5,39,30,9,33
Krasnodar,5466,4,9,5,6,28,24,4,32
Terek Grozny,5466,5,9,5,6,25,24,1,32
Zenit,5466,6,7,9,4,21,15,6,30
Din Moscow,5466,7,7,6,7,23,21,2,27
FK Rubin,5466,8,5,6,9,21,21,0,21
Rostov,5466,9,4,7,9,12,19,-7,19
Amkar,5466,10,4,4,12,10,28,-18,16
Anzhi,5466,11,2,5,13,16,42,-26,11
Loko Moscow,5467,1,13,5,2,32,12,20,44
CSKA Moscow,5467,2,12,3,5,30,19,11,39
Spart Moscow,5467,3,11,5,4,40,26,14,38
Zenit,5467,4,7,8,5,24,18,6,29
Krasnodar,5467,5,8,4,8,29,28,1,28
FK Rubin,5467,6,7,5,8,27,20,7,26
Terek Grozny,5467,7,7,5,8,20,24,-4,26
Din Moscow,5467,8,5,6,9,19,26,-7,21
Amkar,5467,9,5,4,11,10,23,-13,19
Rostov,5467,10,4,6,10,10,21,-11,18
Anzhi,5467,11,3,5,12,15,39,-24,14
Loko Moscow,5468,1,13,5,2,31,11,20,44
CSKA Moscow,5468,2,11,4,5,29,20,9,37
Zenit,5468,3,7,9,4,22,15,7,30
Spart Moscow,5468,4,8,6,6,35,30,5,30
Terek Grozny,5468,5,8,6,6,23,24,-1,30
Krasnodar,5468,6,8,4,8,28,27,1,28
FK Rubin,5468,7,6,6,8,25,20,5,24
Din Moscow,5468,8,5,8,7,21,25,-4,23
Rostov,5468,9,5,6,9,12,17,-5,21
Amkar,5468,10,5,4,11,11,24,-13,19
Anzhi,5468,11,2,6,12,17,41,-24,12
Loko Moscow,5469,1,12,6,2,33,14,19,42
CSKA Moscow,5469,2,11,3,6,26,18,8,36
Zenit,5469,3,8,8,4,23,15,8,32
Krasnodar,5469,4,9,5,6,30,26,4,32
Spart Moscow,5469,5,8,6,6,34,28,6,30
Terek Grozny,5469,6,8,6,6,22,23,-1,30
Din Moscow,5469,7,6,7,7,19,22,-3,25
FK Rubin,5469,8,5,6,9,22,19,3,21
Rostov,5469,9,5,6,9,11,17,-6,21
Amkar,5469,10,4,6,10,11,24,-13,18
Anzhi,5469,11,2,5,13,14,39,-25,11
Loko Moscow,5470,1,13,5,2,36,13,23,44
CSKA Moscow,5470,2,12,3,5,33,17,16,39
Spart Moscow,5470,3,9,5,6,37,31,6,32
Krasnodar,5470,4,9,4,7,34,30,4,31
Zenit,5470,5,7,8,5,21,19,2,29
Terek Grozny,5470,6,7,6,7,22,25,-3,27
FK Rubin,5470,7,6,5,9,25,22,3,23
Rostov,5470,8,5,6,9,12,17,-5,21
Din Moscow,5470,9,5,6,9,17,25,-8,21
Amkar,5470,10,5,5,10,14,24,-10,20
Anzhi,5470,11,3,5,12,16,44,-28,14
Loko Moscow,5471,1,11,6,3,29,12,17,39
CSKA Moscow,5471,2,11,3,6,30,19,11,36
Spart Moscow,5471,3,9,7,4,38,28,10,34
Krasnodar,5471,4,10,4,6,30,24,6,34
Zenit,5471,5,8,9,3,23,14,9,33
Terek Grozny,5471,6,7,6,7,21,25,-4,27
Din Moscow,5471,7,5,7,8,19,25,-6,22
FK Rubin,5471,8,5,6,9,22,20,2,21
Rostov,5471,9,4,7,9,11,18,-7,19
Amkar,5471,10,4,6,10,11,24,-13,18
Anzhi,5471,11,3,5,12,16,41,-25,14
Loko Moscow,5472,1,12,5,3,32,14,18,41
CSKA Moscow,5472,2,11,3,6,28,18,10,36
Zenit,5472,3,9,8,3,24,13,11,35
Spart Moscow,5472,4,9,7,4,39,30,9,34
Krasnodar,5472,5,9,4,7,30,28,2,31
Terek Grozny,5472,6,7,5,8,20,26,-6,26
Din Moscow,5472,7,6,6,8,20,23,-3,24
FK Rubin,5472,8,5,5,10,22,21,1,20
Amkar,5472,9,5,5,10,13,24,-11,20
Rostov,5472,10,4,7,9,12,19,-7,19
Anzhi,5472,11,3,5,12,16,40,-24,14
Loko Moscow,5473,1,11,6,3,29,12,17,39
Spart Moscow,5473,2,10,6,4,39,28,11,36
CSKA Moscow,5473,3,10,4,6,26,22,4,34
Zenit,5473,4,8,9,3,25,13,12,33
Krasnodar,5473,5,9,5,6,29,25,4,32
Terek Grozny,5473,6,8,5,7,22,24,-2,29
Din Moscow,5473,7,6,6,8,19,24,-5,24
FK Rubin,5473,8,5,6,9,23,20,3,21
Amkar,5473,9,5,5,10,12,24,-12,20
Rostov,5473,10,4,6,10,12,20,-8,18
Anzhi,5473,11,2,6,12,15,39,-24,12
Loko Moscow,5474,1,13,5,2,31,11,20,44
CSKA Moscow,5474,2,12,3,5,28,18,10,39
Spart Moscow,5474,3,9,5,6,34,27,7,32
Terek Grozny,5474,4,9,5,6,22,22,0,32
Zenit,5474,5,7,8,5,21,15,6,29
Krasnodar,5474,6,8,4,8,27,26,1,28
FK Rubin,5474,7,7,5,8,23,17,6,26
Din Moscow,5474,8,6,6,8,18,22,-4,24
Amkar,5474,9,5,4,11,10,23,-13,19
Rostov,5474,10,4,6,10,10,18,-8,18
Anzhi,5474,11,2,5,13,15,40,-25,11
Loko Moscow,5475,1,12,5,3,32,16,16,41
CSKA Moscow,5475,2,11,4,5,28,18,10,37
Spart Moscow,5475,3,9,6,5,39,30,9,33
Terek Grozny,5475,4,9,5,6,25,22,3,32
Krasnodar,5475,5,9,4,7,32,27,5,31
Zenit,5475,6,7,9,4,22,15,7,30
Din Moscow,5475,7,6,7,7,19,22,-3,25
FK Rubin,5475,8,6,5,9,22,18,4,23
Amkar,5475,9,5,4,11,13,27,-14,19
Rostov,5475,10,4,6,10,10,20,-10,18
Anzhi,5475,11,2,5,13,14,41,-27,11
Loko Moscow,5476,1,11,6,3,31,14,17,39
Spart Moscow,5476,2,10,5,5,37,28,9,35
CSKA Moscow,5476,3,10,4,6,26,19,7,34
Zenit,5476,4,8,9,3,23,14,9,33
Krasnodar,5476,5,9,5,6,29,25,4,32
Terek Grozny,5476,6,8,5,7,22,24,-2,29
Din Moscow,5476,7,6,6,8,21,24,-3,24
FK Rubin,5476,8,5,5,10,22,21,1,20
Amkar,5476,9,5,4,11,12,25,-13,19
Rostov,5476,10,4,6,10,10,18,-8,18
Anzhi,5476,11,4,5,11,17,38,-21,17
Loko Moscow,5477,1,12,5,3,31,14,17,41
CSKA Moscow,5477,2,11,4,5,30,19,11,37
Spart Moscow,5477,3,9,6,5,43,31,12,33
Krasnodar,5477,4,9,5,6,31,25,6,32
Zenit,5477,5,7,9,4,22,16,6,30
Terek Grozny,5477,6,8,5,7,21,24,-3,29
Din Moscow,5477,7,5,8,7,23,27,-4,23
FK Rubin,5477,8,5,7,8,25,21,4,22
Amkar,5477,9,5,4,11,10,23,-13,19
Rostov,5477,10,4,6,10,12,24,-12,18
Anzhi,5477,11,3,5,12,17,41,-24,14
Loko Moscow,5478,1,12,6,2,33,12,21,42
CSKA Moscow,5478,2,11,3,6,29,23,6,36
Zenit,5478,3,8,9,3,25,14,11,33
Spart Moscow,5478,4,8,7,5,35,28,7,31
Krasnodar,5478,5,9,4,7,29,28,1,31
Terek Grozny,5478,6,8,5,7,21,23,-2,29
Din Moscow,5478,7,6,7,7,19,22,-3,25
Amkar,5478,8,6,4,10,11,22,-11,22
FK Rubin,5478,9,5,5,10,23,21,2,20
Rostov,5478,10,4,7,9,12,19,-7,19
Anzhi,5478,11,2,5,13,17,42,-25,11
Loko Moscow,5479,1,11,7,2,31,13,18,40
CSKA Moscow,5479,2,10,4,6,25,18,7,34
Zenit,5479,3,8,9,3,23,14,9,33
Spart Moscow,5479,4,9,6,5,36,30,6,33
Krasnodar,5479,5,8,6,6,29,26,3,30
Terek Grozny,5479,6,8,5,7,21,24,-3,29
FK Rubin,5479,7,6,6,8,24,18,6,24
Din Moscow,5479,8,5,7,8,19,25,-6,22
Amkar,5479,9,6,4,10,14,22,-8,22
Rostov,5479,10,4,6,10,10,18,-8,18
Anzhi,5479,11,2,6,12,14,38,-24,12
Loko Moscow,5480,1,12,6,2,34,12,22,42
Spart Moscow,5480,2,10,6,4,40,28,12,36
CSKA Moscow,5480,3,10,4,6,26,20,6,34
Krasnodar,5480,4,9,5,6,32,26,6,32
Zenit,5480,5,7,9,4,22,18,4,30
Terek Grozny,5480,6,8,6,6,22,22,0,30
Din Moscow,5480,7,6,7,7,21,24,-3,25
FK Rubin,5480,8,5,5,10,23,23,0,20
Rostov,5480,9,4,6,10,10,20,-10,18
Amkar,5480,10,4,4,12,10,26,-16,16
Anzhi,5480,11,3,6,11,16,37,-21,15
Loko Moscow,5481,1,12,5,3,31,15,16,41
Spart Moscow,5481,2,10,6,4,36,25,11,36
CSKA Moscow,5481,3,11,3,6,28,21,7,36
Zenit,5481,4,8,8,4,25,15,10,32
Krasnodar,5481,5,9,5,6,30,24,6,32
Terek Grozny,5481,6,8,5,7,22,24,-2,29
FK Rubin,5481,7,6,6,8,23,17,6,24
Din Moscow,5481,8,5,6,9,17,24,-7,21
Amkar,5481,9,5,5,10,10,22,-12,20
Rostov,5481,10,4,6,10,10,19,-9,18
Anzhi,5481,11,2,5,13,16,42,-26,11
Loko Moscow,5482,1,12,6,2,33,14,19,42
CSKA Moscow,5482,2,12,3,5,29,17,12,39
Spart Moscow,5482,3,9,7,4,36,27,9,34
Krasnodar,5482,4,8,6,6,29,26,3,30
Terek Grozny,5482,5,8,6,6,21,22,-1,30
Zenit,5482,6,7,8,5,22,16,6,29
Din Moscow,5482,7,6,7,7,19,21,-2,25
FK Rubin,5482,8,5,6,9,21,19,2,21
Rostov,5482,9,4,7,9,11,18,-7,19
Amkar,5482,10,4,5,11,10,24,-14,17
Anzhi,5482,11,2,5,13,14,41,-27,11
Loko Moscow,5483,1,12,6,2,32,13,19,42
CSKA Moscow,5483,2,12,3,5,28,18,10,39
Spart Moscow,5483,3,9,7,4,38,27,11,34
Krasnodar,5483,4,9,4,7,30,25,5,31
Zenit,5483,5,7,9,4,24,17,7,30
Terek Grozny,5483,6,7,6,7,22,25,-3,27
Din Moscow,5483,7,6,6,8,19,25,-6,24
FK Rubin,5483,8,5,5,10,22,22,0,20
Amkar,5483,9,5,5,10,12,24,-12,20
Rostov,5483,10,4,7,9,11,18,-7,19
Anzhi,5483,11,2,6,12,15,39,-24,12
Loko Moscow,5484,1,12,5,3,34,16,18,41
CSKA Moscow,5484,2,11,3,6,29,20,9,36
Zenit,5484,3,9,8,3,27,15,12,35
Spart Moscow,5484,4,9,6,5,35,26,9,33
Krasnodar,5484,5,8,5,7,31,29,2,29
Terek Grozny,5484,6,7,6,7,21,26,-5,27
Din Moscow,5484,7,5,8,7,19,23,-4,23
FK Rubin,5484,8,5,7,8,25,21,4,22
Rostov,5484,9,5,6,9,11,17,-6,21
Amkar,5484,10,4,5,11,9,24,-15,17
Anzhi,5484,11,3,5,12,18,42,-24,14
Loko Moscow,5485,1,12,6,2,31,11,20,42
Spart Moscow,5485,2,11,5,4,39,28,11,38
CSKA Moscow,5485,3,11,4,5,30,18,12,37
Krasnodar,5485,4,9,5,6,29,24,5,32
Zenit,5485,5,7,9,4,22,16,6,30
Terek Grozny,5485,6,8,6,6,21,22,-1,30
Din Moscow,5485,7,5,7,8,19,24,-5,22
FK Rubin,5485,8,5,6,9,21,19,2,21
Rostov,5485,9,4,6,10,10,18,-8,18
Amkar,5485,10,4,5,11,10,24,-14,17
Anzhi,5485,11,2,5,13,14,42,-28,11
Loko Moscow,5486,1,11,6,3,30,14,16,39
CSKA Moscow,5486,2,11,3,6,29,19,10,36
Krasnodar,5486,3,10,4,6,31,25,6,34
Zenit,5486,4,8,9,3,23,14,9,33
Spart Moscow,5486,5,8,8,4,38,30,8,32
Terek Grozny,5486,6,7,6,7,21,24,-3,27
FK Rubin,5486,7,6,5,9,24,19,5,23
Din Moscow,5486,8,5,7,8,18,24,-6,22
Amkar,5486,9,5,5,10,13,25,-12,20
Rostov,5486,10,4,7,9,12,19,-7,19
Anzhi,5486,11,2,6,12,15,41,-26,12
Loko Moscow,5487,1,12,5,3,30,12,18,41
CSKA Moscow,5487,2,11,3,6,26,18,8,36
Spart Moscow,5487,3,9,7,4,38,29,9,34
Zenit,5487,4,8,8,4,22,14,8,32
Krasnodar,5487,5,9,5,6,28,24,4,32
Terek Grozny,5487,6,7,6,7,22,26,-4,27
FK Rubin,5487,7,5,7,8,24,20,4,22
Din Moscow,5487,8,5,7,8,22,27,-5,22
Amkar,5487,9,5,5,10,12,23,-11,20
Rostov,5487,10,4,7,9,11,18,-7,19
Anzhi,5487,11,2,6,12,16,40,-24,12
Loko Moscow,5488,1,12,5,3,33,15,18,41
CSKA Moscow,5488,2,12,3,5,32,20,12,39
Spart Moscow,5488,3,9,6,5,40,31,9,33
Zenit,5488,4,8,8,4,25,17,8,32
Terek Grozny,5488,5,9,5,6,24,23,1,32
Krasnodar,5488,6,9,4,7,31,27,4,31
Din Moscow,5488,7,7,6,7,22,24,-2,27
FK Rubin,5488,8,5,5,10,21,22,-1,20
Rostov,5488,9,4,7,9,11,18,-7,19
Amkar,5488,10,4,4,12,10,26,-16,16
Anzhi,5488,11,2,5,13,18,44,-26,11
Loko Moscow,5489,1,12,5,3,31,13,18,41
CSKA Moscow,5489,2,11,4,5,29,19,10,37
Krasnodar,5489,3,10,4,6,30,25,5,34
Spart Moscow,5489,4,9,6,5,40,29,11,33
Terek Grozny,5489,5,9,5,6,24,24,0,32
Zenit,5489,6,7,9,4,23,16,7,30
Din Moscow,5489,7,7,6,7,21,23,-2,27
FK Rubin,5489,8,5,5,10,23,21,2,20
Rostov,5489,9,4,6,10,10,21,-11,18
Amkar,5489,10,4,5,11,12,26,-14,17
Anzhi,5489,11,2,5,13,16,42,-26,11
Loko Moscow,5490,1,12,5,3,31,13,18,41
Zenit,5490,2,9,8,3,25,13,12,35
Spart Moscow,5490,3,10,5,5,37,30,7,35
CSKA Moscow,5490,4,10,4,6,26,21,5,34
Krasnodar,5490,5,9,4,7,30,26,4,31
Terek Grozny,5490,6,8,5,7,22,24,-2,29
Din Moscow,5490,7,5,7,8,19,24,-5,22
FK Rubin,5490,8,5,6,9,22,20,2,21
Rostov,5490,9,5,6,9,13,17,-4,21
Amkar,5490,10,5,4,11,11,24,-13,19
Anzhi,5490,11,2,6,12,16,40,-24,12
Loko Moscow,5491,1,12,5,3,31,13,18,41
Spart Moscow,5491,2,11,5,4,38,27,11,38
CSKA Moscow,5491,3,11,3,6,33,21,12,36
Krasnodar,5491,4,10,4,6,30,24,6,34
Zenit,5491,5,8,8,4,24,16,8,32
Terek Grozny,5491,6,8,6,6,25,25,0,30
FK Rubin,5491,7,6,5,9,22,18,4,23
Din Moscow,5491,8,5,6,9,17,23,-6,21
Rostov,5491,9,4,6,10,11,19,-8,18
Amkar,5491,10,4,4,12,11,27,-16,16
Anzhi,5491,11,2,6,12,17,46,-29,12
Loko Moscow,5492,1,13,5,2,31,11,20,44
CSKA Moscow,5492,2,11,3,6,29,20,9,36
Spart Moscow,5492,3,9,6,5,35,28,7,33
Zenit,5492,4,8,8,4,23,15,8,32
Krasnodar,5492,5,8,5,7,27,25,2,29
Terek Grozny,5492,6,8,5,7,22,24,-2,29
FK Rubin,5492,7,5,7,8,21,17,4,22
Din Moscow,5492,8,5,7,8,18,23,-5,22
Amkar,5492,9,6,4,10,13,23,-10,22
Rostov,5492,10,4,7,9,10,17,-7,19
Anzhi,5492,11,2,5,13,15,41,-26,11
Loko Moscow,5493,1,11,5,4,33,18,15,38
CSKA Moscow,5493,2,11,3,6,27,19,8,36
Spart Moscow,5493,3,9,7,4,39,29,10,34
Zenit,5493,4,8,8,4,24,16,8,32
Krasnodar,5493,5,9,5,6,33,28,5,32
Terek Grozny,5493,6,7,6,7,20,23,-3,27
FK Rubin,5493,7,5,7,8,23,19,4,22
Din Moscow,5493,8,5,7,8,19,25,-6,22
Rostov,5493,9,4,7,9,10,17,-7,19
Amkar,5493,10,4,6,10,11,24,-13,18
Anzhi,5493,11,4,5,11,17,38,-21,17
Loko Moscow,5494,1,11,6,3,30,13,17,39
CSKA Moscow,5494,2,11,4,5,29,19,10,37
Spart Moscow,5494,3,9,6,5,38,30,8,33
Krasnodar,5494,4,9,5,6,30,26,4,32
Terek Grozny,5494,5,9,5,6,24,22,2,32
Zenit,5494,6,7,9,4,23,17,6,30
Din Moscow,5494,7,6,6,8,21,25,-4,24
FK Rubin,5494,8,5,6,9,23,20,3,21
Rostov,5494,9,4,7,9,12,19,-7,19
Amkar,5494,10,5,4,11,10,24,-14,19
Anzhi,5494,11,2,6,12,14,39,-25,12
Loko Moscow,5495,1,11,7,2,29,11,18,40
CSKA Moscow,5495,2,12,3,5,30,17,13,39
Spart Moscow,5495,3,10,5,5,37,26,11,35
Zenit,5495,4,7,9,4,21,15,6,30
Krasnodar,5495,5,8,6,6,29,26,3,30
Terek Grozny,5495,6,7,5,8,21,27,-6,26
FK Rubin,5495,7,5,7,8,25,21,4,22
Din Moscow,5495,8,5,7,8,19,26,-7,22
Rostov,5495,9,5,6,9,11,17,-6,21
Amkar,5495,10,5,4,11,11,24,-13,19
Anzhi,5495,11,3,5,12,17,40,-23,14
Loko Moscow,5496,1,12,6,2,30,11,19,42
CSKA Moscow,5496,2,10,5,5,26,18,8,35
Zenit,5496,3,7,10,3,21,13,8,31
Krasnodar,5496,4,9,4,7,29,26,3,31
Spart Moscow,5496,5,8,6,6,34,28,6,30
Terek Grozny,5496,6,8,5,7,25,26,-1,29
Din Moscow,5496,7,6,6,8,19,23,-4,24
FK Rubin,5496,8,6,5,9,23,19,4,23
Amkar,5496,9,6,4,10,13,22,-9,22
Rostov,5496,10,4,7,9,10,17,-7,19
Anzhi,5496,11,2,6,12,16,43,-27,12
Loko Moscow,5497,1,11,6,3,31,14,17,39
Spart Moscow,5497,2,10,5,5,43,29,14,35
CSKA Moscow,5497,3,10,4,6,26,20,6,34
Zenit,5497,4,8,9,3,24,14,10,33
Krasnodar,5497,5,9,4,7,30,27,3,31
Terek Grozny,5497,6,8,5,7,23,25,-2,29
Din Moscow,5497,7,6,6,8,21,28,-7,24
FK Rubin,5497,8,6,5,9,23,21,2,23
Amkar,5497,9,6,4,10,15,24,-9,22
Rostov,5497,10,4,6,10,10,18,-8,18
Anzhi,5497,11,2,6,12,15,41,-26,12
Loko Moscow,5498,1,13,5,2,34,12,22,44
Spart Moscow,5498,2,11,5,4,38,26,12,38
CSKA Moscow,5498,3,11,3,6,27,20,7,36
Zenit,5498,4,8,8,4,24,16,8,32
Krasnodar,5498,5,9,4,7,31,29,2,31
Terek Grozny,5498,6,8,5,7,21,23,-2,29
Din Moscow,5498,7,6,6,8,21,25,-4,24
FK Rubin,5498,8,5,5,10,24,23,1,20
Amkar,5498,9,5,4,11,10,23,-13,19
Rostov,5498,10,4,6,10,10,18,-8,18
Anzhi,5498,11,2,5,13,14,39,-25,11
Loko Moscow,5499,1,11,5,4,30,15,15,38
Zenit,5499,2,9,8,3,23,13,10,35
Krasnodar,5499,3,10,4,6,32,25,7,34
CSKA Moscow,5499,4,10,4,6,26,19,7,34
Spart Moscow,5499,5,8,7,5,35,29,6,31
Terek Grozny,5499,6,8,5,7,22,24,-2,29
FK Rubin,5499,7,6,5,9,23,20,3,23
Din Moscow,5499,8,5,7,8,19,24,-5,22
Amkar,5499,9,6,4,10,12,22,-10,22
Rostov,5499,10,4,7,9,11,18,-7,19
Anzhi,5499,11,2,6,12,16,40,-24,12
Loko Moscow,5500,1,13,5,2,34,13,21,44
CSKA Moscow,5500,2,11,4,5,32,21,11,37
Spart Moscow,5500,3,10,5,5,39,30,9,35
Zenit,5500,4,7,9,4,25,19,6,30
Krasnodar,5500,5,8,4,8,29,29,0,28
Terek Grozny,5500,6,7,6,7,22,27,-5,27
FK Rubin,5500,7,7,5,8,28,19,9,26
Din Moscow,5500,8,6,6,8,21,27,-6,24
Amkar,5500,9,5,4,11,15,26,-11,19
Rostov,5500,10,4,6,10,10,18,-8,18
Anzhi,5500,11,2,6,12,16,42,-26,12
Spart Moscow,5501,1,11,5,4,40,26,14,38
Loko Moscow,5501,2,11,5,4,29,15,14,38
CSKA Moscow,5501,3,11,4,5,28,18,10,37
Zenit,5501,4,8,9,3,23,13,10,33
Krasnodar,5501,5,9,5,6,30,25,5,32
Terek Grozny,5501,6,8,5,7,21,24,-3,29
Din Moscow,5501,7,6,6,8,19,24,-5,24
FK Rubin,5501,8,5,6,9,22,19,3,21
Rostov,5501,9,4,6,10,10,20,-10,18
Amkar,5501,10,4,4,12,9,24,-15,16
Anzhi,5501,11,3,5,12,17,40,-23,14
Loko Moscow,5502,1,11,5,4,30,14,16,38
Spart Moscow,5502,2,10,6,4,37,26,11,36
CSKA Moscow,5502,3,11,3,6,28,18,10,36
Zenit,5502,4,8,8,4,22,16,6,32
Krasnodar,5502,5,9,5,6,31,27,4,32
Terek Grozny,5502,6,7,7,6,22,24,-2,28
FK Rubin,5502,7,6,6,8,24,19,5,24
Din Moscow,5502,8,5,6,9,17,24,-7,21
Rostov,5502,9,4,7,9,11,18,-7,19
Amkar,5502,10,4,5,11,10,24,-14,17
Anzhi,5502,11,3,6,11,16,38,-22,15
Loko Moscow,5503,1,12,5,3,33,19,14,41
CSKA Moscow,5503,2,12,3,5,29,17,12,39
Spart Moscow,5503,3,11,5,4,41,28,13,38
Zenit,5503,4,8,8,4,27,16,11,32
Krasnodar,5503,5,9,4,7,30,27,3,31
Terek Grozny,5503,6,7,7,6,22,24,-2,28
Din Moscow,5503,7,6,6,8,19,25,-6,24
FK Rubin,5503,8,5,5,10,22,20,2,20
Rostov,5503,9,4,6,10,11,19,-8,18
Amkar,5503,10,4,5,11,12,26,-14,17
Anzhi,5503,11,2,6,12,15,40,-25,12
Loko Moscow,5504,1,13,5,2,31,11,20,44
Spart Moscow,5504,2,10,5,5,36,26,10,35
CSKA Moscow,5504,3,10,4,6,25,19,6,34
Zenit,5504,4,8,8,4,23,14,9,32
Terek Grozny,5504,5,9,5,6,23,23,0,32
Krasnodar,5504,6,8,5,7,29,27,2,29
FK Rubin,5504,7,6,6,8,24,19,5,24
Rostov,5504,8,5,6,9,11,17,-6,21
Din Moscow,5504,9,5,6,9,17,24,-7,21
Amkar,5504,10,4,4,12,10,25,-15,16
Anzhi,5504,11,2,6,12,14,38,-24,12
Loko Moscow,5505,1,11,6,3,30,14,16,39
Spart Moscow,5505,2,10,6,4,37,27,10,36
CSKA Moscow,5505,3,11,3,6,30,20,10,36
Krasnodar,5505,4,10,4,6,32,25,7,34
Zenit,5505,5,8,9,3,24,15,9,33
Terek Grozny,5505,6,7,5,8,21,26,-5,26
Din Moscow,5505,7,6,6,8,20,24,-4,24
FK Rubin,5505,8,5,5,10,23,22,1,20
Rostov,5505,9,4,7,9,11,18,-7,19
Amkar,5505,10,5,4,11,11,23,-12,19
Anzhi,5505,11,3,5,12,17,42,-25,14
Loko Moscow,5506,1,11,5,4,30,17,13,38
CSKA Moscow,5506,2,10,5,5,28,20,8,35
Spart Moscow,5506,3,9,6,5,39,28,11,33
Zenit,5506,4,8,9,3,26,16,10,33
Krasnodar,5506,5,9,5,6,31,25,6,32
Terek Grozny,5506,6,7,7,6,21,23,-2,28
Din Moscow,5506,7,5,8,7,19,23,-4,23
FK Rubin,5506,8,5,7,8,23,19,4,22
Amkar,5506,9,5,5,10,12,24,-12,20
Rostov,5506,10,4,6,10,10,21,-11,18
Anzhi,5506,11,2,7,11,15,38,-23,13
Loko Moscow,5507,1,12,5,3,31,13,18,41
CSKA Moscow,5507,2,12,3,5,29,19,10,39
Spart Moscow,5507,3,11,5,4,40,28,12,38
Krasnodar,5507,4,9,5,6,30,25,5,32
Terek Grozny,5507,5,8,6,6,23,22,1,30
Zenit,5507,6,7,8,5,22,17,5,29
Din Moscow,5507,7,6,6,8,21,25,-4,24
FK Rubin,5507,8,5,6,9,22,20,2,21
Rostov,5507,9,4,6,10,10,18,-8,18
Amkar,5507,10,4,5,11,10,24,-14,17
Anzhi,5507,11,2,5,13,15,42,-27,11
Loko Moscow,5508,1,12,6,2,32,13,19,42
Spart Moscow,5508,2,11,5,4,40,27,13,38
CSKA Moscow,5508,3,10,4,6,25,18,7,34
Zenit,5508,4,8,8,4,23,15,8,32
Krasnodar,5508,5,8,6,6,28,25,3,30
Terek Grozny,5508,6,8,5,7,22,24,-2,29
FK Rubin,5508,7,5,7,8,21,17,4,22
Din Moscow,5508,8,5,7,8,18,24,-6,22
Amkar,5508,9,5,4,11,11,23,-12,19
Rostov,5508,10,4,6,10,11,20,-9,18
Anzhi,5508,11,2,6,12,14,39,-25,12
Loko Moscow,5509,1,12,5,3,31,13,18,41
CSKA Moscow,5509,2,11,3,6,27,20,7,36
Spart Moscow,5509,3,9,6,5,34,26,8,33
Zenit,5509,4,8,8,4,23,14,9,32
Krasnodar,5509,5,9,5,6,31,27,4,32
Terek Grozny,5509,6,7,6,7,21,24,-3,27
FK Rubin,5509,7,6,6,8,25,20,5,24
Din Moscow,5509,8,6,6,8,19,23,-4,24
Rostov,5509,9,4,7,9,10,17,-7,19
Amkar,5509,10,4,5,11,10,24,-14,17
Anzhi,5509,11,3,5,12,16,39,-23,14
Loko Moscow,5510,1,11,6,3,30,15,15,39
CSKA Moscow,5510,2,11,3,6,26,18,8,36
Spart Moscow,5510,3,10,5,5,36,28,8,35
Zenit,5510,4,8,8,4,24,14,10,32
Krasnodar,5510,5,9,5,6,30,25,5,32
Terek Grozny,5510,6,8,6,6,22,23,-1,30
Din Moscow,5510,7,7,6,7,23,21,2,27
FK Rubin,5510,8,5,5,10,21,23,-2,20
Rostov,5510,9,4,6,10,10,18,-8,18
Amkar,5510,10,4,5,11,11,25,-14,17
Anzhi,5510,11,3,5,12,15,38,-23,14
Loko Moscow,5511,1,12,5,3,32,14,18,41
CSKA Moscow,5511,2,11,3,6,27,19,8,36
Spart Moscow,5511,3,10,5,5,38,26,12,35
Zenit,5511,4,8,8,4,22,16,6,32
Krasnodar,5511,5,9,4,7,31,28,3,31
Terek Grozny,5511,6,7,6,7,22,25,-3,27
FK Rubin,5511,7,6,6,8,27,20,7,24
Din Moscow,5511,8,5,7,8,19,26,-7,22
Amkar,5511,9,5,5,10,10,22,-12,20
Rostov,5511,10,4,6,10,10,19,-9,18
Anzhi,5511,11,3,5,12,18,41,-23,14
Loko Moscow,5512,1,13,5,2,36,11,25,44
CSKA Moscow,5512,2,11,4,5,28,19,9,37
Spart Moscow,5512,3,9,6,5,37,27,10,33
Terek Grozny,5512,4,9,5,6,24,23,1,32
Zenit,5512,5,7,9,4,22,16,6,30
Krasnodar,5512,6,8,5,7,28,30,-2,29
FK Rubin,5512,7,6,6,8,26,19,7,24
Din Moscow,5512,8,5,7,8,19,26,-7,22
Rostov,5512,9,5,6,9,11,17,-6,21
Amkar,5512,10,4,4,12,10,28,-18,16
Anzhi,5512,11,2,5,13,15,40,-25,11
Loko Moscow,5513,1,12,6,2,31,11,20,42
CSKA Moscow,5513,2,11,3,6,28,20,8,36
Spart Moscow,5513,3,10,5,5,43,32,11,35
Zenit,5513,4,8,9,3,24,14,10,33
Terek Grozny,5513,5,8,6,6,23,24,-1,30
Krasnodar,5513,6,8,5,7,27,26,1,29
Din Moscow,5513,7,6,6,8,20,26,-6,24
FK Rubin,5513,8,5,6,9,21,18,3,21
Amkar,5513,9,5,4,11,12,25,-13,19
Rostov,5513,10,4,6,10,12,20,-8,18
Anzhi,5513,11,2,6,12,16,41,-25,12
Loko Moscow,5514,1,11,6,3,30,13,17,39
Spart Moscow,5514,2,10,6,4,36,25,11,36
CSKA Moscow,5514,3,11,3,6,29,19,10,36
Zenit,5514,4,9,8,3,25,15,10,35
Krasnodar,5514,5,9,5,6,31,25,6,32
Terek Grozny,5514,6,7,6,7,21,26,-5,27
FK Rubin,5514,7,6,5,9,23,21,2,23
Din Moscow,5514,8,5,6,9,17,23,-6,21
Rostov,5514,9,4,6,10,10,19,-9,18
Amkar,5514,10,4,6,10,10,23,-13,18
Anzhi,5514,11,3,5,12,17,40,-23,14
Loko Moscow,5515,1,12,5,3,30,12,18,41
CSKA Moscow,5515,2,11,3,6,28,19,9,36
Spart Moscow,5515,3,9,6,5,39,28,11,33
Krasnodar,5515,4,9,4,7,29,26,3,31
Terek Grozny,5515,5,8,6,6,22,22,0,30
Zenit,5515,6,7,8,5,21,16,5,29
Din Moscow,5515,7,7,6,7,22,23,-1,27
FK Rubin,5515,8,6,5,9,24,21,3,23
Rostov,5515,9,4,7,9,11,18,-7,19
Amkar,5515,10,4,4,12,9,28,-19,16
Anzhi,5515,11,3,6,11,16,38,-22,15
Loko Moscow,5516,1,12,5,3,30,12,18,41
CSKA Moscow,5516,2,10,4,6,26,19,7,34
Zenit,5516,3,8,9,3,23,14,9,33
Spart Moscow,5516,4,8,7,5,37,30,7,31
Krasnodar,5516,5,9,4,7,29,25,4,31
Terek Grozny,5516,6,7,7,6,21,23,-2,28
Din Moscow,5516,7,7,6,7,21,22,-1,27
FK Rubin,5516,8,5,5,10,21,21,0,20
Rostov,5516,9,4,7,9,12,19,-7,19
Amkar,5516,10,4,6,10,11,24,-13,18
Anzhi,5516,11,3,6,11,15,37,-22,15
CSKA Moscow,5517,1,12,3,5,31,18,13,39
Spart Moscow,5517,2,11,5,4,40,25,15,38
Loko Moscow,5517,3,11,5,4,29,16,13,38
Krasnodar,5517,4,10,4,6,34,25,9,34
Zenit,5517,5,8,8,4,23,15,8,32
Terek Grozny,5517,6,8,5,7,22,23,-1,29
Din Moscow,5517,7,6,6,8,18,22,-4,24
FK Rubin,5517,8,5,5,10,22,22,0,20
Amkar,5517,9,5,4,11,10,25,-15,19
Rostov,5517,10,4,6,10,10,20,-10,18
Anzhi,5517,11,2,5,13,15,43,-28,11
Loko Moscow,5518,1,11,5,4,30,15,15,38
Spart Moscow,5518,2,11,5,4,37,26,11,38
CSKA Moscow,5518,3,11,3,6,27,21,6,36
Zenit,5518,4,9,8,3,26,14,12,35
Krasnodar,5518,5,10,4,6,30,24,6,34
Terek Grozny,5518,6,7,6,7,20,24,-4,27
FK Rubin,5518,7,6,5,9,22,18,4,23
Din Moscow,5518,8,5,6,9,17,23,-6,21
Rostov,5518,9,4,6,10,10,18,-8,18
Amkar,5518,10,4,5,11,10,24,-14,17
Anzhi,5518,11,3,5,12,17,39,-22,14
Loko Moscow,5519,1,11,7,2,31,13,18,40
CSKA Moscow,5519,2,11,3,6,26,18,8,36
Spart Moscow,5519,3,10,5,5,36,26,10,35
Zenit,5519,4,8,9,3,22,13,9,33
Krasnodar,5519,5,8,6,6,31,28,3,30
Terek Grozny,5519,6,8,6,6,22,23,-1,30
FK Rubin,5519,7,5,7,8,23,19,4,22
Din Moscow,5519,8,5,7,8,17,22,-5,22
Amkar,5519,9,5,4,11,10,23,-13,19
Rostov,5519,10,4,6,10,10,19,-9,18
Anzhi,5519,11,2,6,12,15,39,-24,12
Loko Moscow,5520,1,11,5,4,29,15,14,38
CSKA Moscow,5520,2,11,3,6,29,22,7,36
Zenit,5520,3,9,8,3,24,13,11,35
Krasnodar,5520,4,10,4,6,32,25,7,34
Spart Moscow,5520,5,9,6,5,36,28,8,33
Terek Grozny,5520,6,7,6,7,21,25,-4,27
FK Rubin,5520,7,6,5,9,23,19,4,23
Din Moscow,5520,8,5,7,8,18,23,-5,22
Rostov,5520,9,5,6,9,12,17,-5,21
Amkar,5520,10,4,5,11,10,25,-15,17
Anzhi,5520,11,3,5,12,19,41,-22,14
Loko Moscow,5521,1,12,6,2,34,15,19,42
CSKA Moscow,5521,2,11,3,6,26,18,8,36
Spart Moscow,5521,3,9,5,6,39,28,11,32
Zenit,5521,4,8,8,4,24,16,8,32
Krasnodar,5521,5,8,6,6,29,26,3,30
Terek Grozny,5521,6,7,7,6,22,24,-2,28
FK Rubin,5521,7,5,7,8,21,17,4,22
Din Moscow,5521,8,5,7,8,17,26,-9,22
Rostov,5521,9,5,6,9,11,17,-6,21
Amkar,5521,10,5,5,10,12,24,-12,20
Anzhi,5521,11,2,6,12,15,39,-24,12
Loko Moscow,5522,1,12,6,2,32,12,20,42
CSKA Moscow,5522,2,11,4,5,28,17,11,37
Krasnodar,5522,3,9,5,6,30,25,5,32
Spart Moscow,5522,4,8,7,5,36,29,7,31
Zenit,5522,5,7,9,4,22,16,6,30
Terek Grozny,5522,6,8,5,7,21,27,-6,29
Din Moscow,5522,7,5,8,7,20,24,-4,23
FK Rubin,5522,8,5,6,9,23,21,2,21
Rostov,5522,9,5,6,9,11,17,-6,21
Amkar,5522,10,5,5,10,15,23,-8,20
Anzhi,5522,11,2,5,13,14,41,-27,11
Loko Moscow,5523,1,11,6,3,31,14,17,39
CSKA Moscow,5523,2,11,4,5,27,18,9,37
Spart Moscow,5523,3,10,6,4,39,27,12,36
Krasnodar,5523,4,9,5,6,28,24,4,32
Terek Grozny,5523,5,9,5,6,23,22,1,32
Zenit,5523,6,7,10,3,24,16,8,31
Din Moscow,5523,7,6,6,8,20,26,-6,24
FK Rubin,5523,8,5,6,9,22,19,3,21
Rostov,5523,9,4,6,10,10,18,-8,18
Amkar,5523,10,4,5,11,10,24,-14,17
Anzhi,5523,11,2,5,13,14,40,-26,11
Loko Moscow,5524,1,13,5,2,34,11,23,44
CSKA Moscow,5524,2,11,3,6,29,23,6,36
Spart Moscow,5524,3,10,5,5,38,29,9,35
Zenit,5524,4,8,8,4,26,16,10,32
Krasnodar,5524,5,8,5,7,28,29,-1,29
Terek Grozny,5524,6,7,7,6,22,24,-2,28
FK Rubin,5524,7,6,6,8,23,18,5,24
Din Moscow,5524,8,5,6,9,18,24,-6,21
Rostov,5524,9,5,6,9,12,18,-6,21
Amkar,5524,10,4,5,11,12,26,-14,17
Anzhi,5524,11,2,6,12,15,39,-24,12
Loko Moscow,5525,1,12,5,3,31,13,18,41
CSKA Moscow,5525,2,11,3,6,26,18,8,36
Krasnodar,5525,3,10,4,6,31,26,5,34
Spart Moscow,5525,4,9,6,5,39,28,11,33
Zenit,5525,5,7,8,5,21,15,6,29
Terek Grozny,5525,6,7,5,8,20,27,-7,26
FK Rubin,5525,7,6,5,9,23,19,4,23
Din Moscow,5525,8,5,7,8,18,23,-5,22
Amkar,5525,9,6,4,10,13,23,-10,22
Rostov,5525,10,4,6,10,10,21,-11,18
Anzhi,5525,11,4,5,11,18,37,-19,17
Loko Moscow,5526,1,12,5,3,35,16,19,41
CSKA Moscow,5526,2,11,3,6,27,19,8,36
Krasnodar,5526,3,10,4,6,32,26,6,34
Spart Moscow,5526,4,9,6,5,39,29,10,33
Zenit,5526,5,8,8,4,24,18,6,32
Terek Grozny,5526,6,7,6,7,20,25,-5,27
Din Moscow,5526,7,6,6,8,21,25,-4,24
FK Rubin,5526,8,6,5,9,24,20,4,23
Rostov,5526,9,4,7,9,11,18,-7,19
Amkar,5526,10,4,5,11,10,26,-16,17
Anzhi,5526,11,3,5,12,17,38,-21,14
Loko Moscow,5527,1,11,5,4,32,17,15,38
CSKA Moscow,5527,2,11,3,6,28,21,7,36
Zenit,5527,3,9,8,3,25,13,12,35
Spart Moscow,5527,4,10,5,5,37,27,10,35
Krasnodar,5527,5,10,4,6,34,28,6,34
Terek Grozny,5527,6,9,5,6,24,24,0,32
Din Moscow,5527,7,6,6,8,18,24,-6,24
FK Rubin,5527,8,6,5,9,25,20,5,23
Rostov,5527,9,4,6,10,10,19,-9,18
Amkar,5527,10,4,4,12,10,25,-15,16
Anzhi,5527,11,2,5,13,18,43,-25,11
Loko Moscow,5528,1,12,5,3,31,13,18,41
CSKA Moscow,5528,2,11,3,6,28,18,10,36
Spart Moscow,5528,3,10,5,5,36,29,7,35
Krasnodar,5528,4,10,4,6,30,25,5,34
Zenit,5528,5,8,8,4,22,14,8,32
Din Moscow,5528,6,7,6,7,22,22,0,27
Terek Grozny,5528,7,7,6,7,22,27,-5,27
FK Rubin,5528,8,5,5,10,22,20,2,20
Rostov,5528,9,4,6,10,10,18,-8,18
Amkar,5528,10,4,5,11,12,26,-14,17
Anzhi,5528,11,3,5,12,17,40,-23,14
Loko Moscow,5529,1,12,6,2,31,11,20,42
CSKA Moscow,5529,2,11,4,5,32,20,12,37
Spart Moscow,5529,3,10,5,5,39,28,11,35
Zenit,5529,4,7,10,3,24,16,8,31
Krasnodar,5529,5,9,4,7,31,29,2,31
Terek Grozny,5529,6,7,7,6,21,23,-2,28
Din Moscow,5529,7,6,6,8,23,26,-3,24
Rostov,5529,8,5,6,9,12,18,-6,21
FK Rubin,5529,9,5,5,10,25,26,-1,20
Amkar,5529,10,4,5,11,9,23,-14,17
Anzhi,5529,11,2,6,12,15,42,-27,12
Loko Moscow,5530,1,12,6,2,31,12,19,42
CSKA Moscow,5530,2,11,4,5,27,18,9,37
Spart Moscow,5530,3,10,6,4,36,25,11,36
Terek Grozny,5530,4,8,6,6,24,24,0,30
Zenit,5530,5,7,8,5,21,15,6,29
Krasnodar,5530,6,8,5,7,28,27,1,29
Din Moscow,5530,7,6,6,8,20,23,-3,24
FK Rubin,5530,8,6,5,9,23,20,3,23
Rostov,5530,9,4,6,10,10,18,-8,18
Amkar,5530,10,4,6,10,9,22,-13,18
Anzhi,5530,11,2,6,12,17,42,-25,12
Loko Moscow,5531,1,12,5,3,32,14,18,41
CSKA Moscow,5531,2,11,4,5,29,19,10,37
Spart Moscow,5531,3,10,5,5,38,28,10,35
Krasnodar,5531,4,9,5,6,29,25,4,32
Zenit,5531,5,7,9,4,25,18,7,30
Terek Grozny,5531,6,8,6,6,22,23,-1,30
Din Moscow,5531,7,6,6,8,19,23,-4,24
FK Rubin,5531,8,5,6,9,22,19,3,21
Amkar,5531,9,5,4,11,11,24,-13,19
Rostov,5531,10,4,6,10,11,20,-9,18
Anzhi,5531,11,2,6,12,14,39,-25,12
Loko Moscow,5532,1,11,5,4,33,17,16,38
Spart Moscow,5532,2,11,5,4,43,29,14,38
CSKA Moscow,5532,3,11,3,6,29,20,9,36
Zenit,5532,4,9,8,3,26,16,10,35
Krasnodar,5532,5,10,4,6,32,26,6,34
Terek Grozny,5532,6,9,5,6,24,22,2,32
FK Rubin,5532,7,6,5,9,23,19,4,23
Din Moscow,5532,8,5,6,9,18,26,-8,21
Rostov,5532,9,4,6,10,11,20,-9,18
Amkar,5532,10,4,4,12,11,28,-17,16
Anzhi,5532,11,2,5,13,15,42,-27,11
Loko Moscow,5533,1,13,5,2,34,13,21,44
CSKA Moscow,5533,2,10,5,5,25,17,8,35
Spart Moscow,5533,3,9,5,6,38,31,7,32
Krasnodar,5533,4,9,4,7,30,28,2,31
Zenit,5533,5,7,9,4,22,15,7,30
Terek Grozny,5533,6,8,5,7,22,23,-1,29
Din Moscow,5533,7,6,7,7,19,22,-3,25
FK Rubin,5533,8,5,6,9,22,19,3,21
Amkar,5533,9,5,4,11,11,25,-14,19
Rostov,5533,10,4,6,10,12,20,-8,18
Anzhi,5533,11,3,6,11,15,37,-22,15
Loko Moscow,5534,1,11,6,3,33,16,17,39
Spart Moscow,5534,2,10,6,4,37,27,10,36
CSKA Moscow,5534,3,11,3,6,28,20,8,36
Zenit,5534,4,9,8,3,27,16,11,35
Krasnodar,5534,5,9,5,6,30,26,4,32
Terek Grozny,5534,6,7,5,8,21,26,-5,26
FK Rubin,5534,7,6,5,9,23,18,5,23
Din Moscow,5534,8,5,7,8,18,24,-6,22
Amkar,5534,9,5,4,11,12,25,-13,19
Rostov,5534,10,4,6,10,10,18,-8,18
Anzhi,5534,11,3,5,12,16,39,-23,14
Loko Moscow,5535,1,12,6,2,31,11,20,42
Spart Moscow,5535,2,11,5,4,40,27,13,38
CSKA Moscow,5535,3,10,4,6,28,21,7,34
Zenit,5535,4,8,9,3,23,14,9,33
Krasnodar,5535,5,8,5,7,28,27,1,29
Terek Grozny,5535,6,8,5,7,22,24,-2,29
Din Moscow,5535,7,6,6,8,19,24,-5,24
FK Rubin,5535,8,5,6,9,23,20,3,21
Rostov,5535,9,4,6,10,10,19,-9,18
Amkar,5535,10,4,4,12,12,27,-15,16
Anzhi,5535,11,3,6,11,17,39,-22,15
Loko Moscow,5536,1,13,5,2,33,11,22,44
CSKA Moscow,5536,2,11,4,5,29,18,11,37
Spart Moscow,5536,3,9,7,4,37,27,10,34
Zenit,5536,4,7,9,4,22,15,7,30
Krasnodar,5536,5,8,5,7,28,28,0,29
Terek Grozny,5536,6,7,5,8,21,25,-4,26
FK Rubin,5536,7,5,7,8,22,18,4,22
Din Moscow,5536,8,5,7,8,17,23,-6,22
Amkar,5536,9,5,5,10,11,23,-12,20
Rostov,5536,10,4,7,9,11,18,-7,19
Anzhi,5536,11,3,5,12,16,41,-25,14
Loko Moscow,5537,1,12,6,2,30,11,19,42
CSKA Moscow,5537,2,11,3,6,27,19,8,36
Spart Moscow,5537,3,9,6,5,36,27,9,33
Zenit,5537,4,8,9,3,23,14,9,33
Krasnodar,5537,5,9,4,7,28,25,3,31
Terek Grozny,5537,6,8,5,7,22,25,-3,29
Din Moscow,5537,7,7,6,7,21,22,-1,27
FK Rubin,5537,8,5,5,10,21,20,1,20
Rostov,5537,9,4,7,9,10,17,-7,19
Amkar,5537,10,4,4,12,9,25,-16,16
Anzhi,5537,11,3,5,12,17,39,-22,14
Loko Moscow,5538,1,11,6,3,31,14,17,39
Spart Moscow,5538,2,10,6,4,39,28,11,36
CSKA Moscow,5538,3,11,3,6,26,21,5,36
Zenit,5538,4,9,8,3,27,14,13,35
Krasnodar,5538,5,9,5,6,33,26,7,32
Terek Grozny,5538,6,7,6,7,20,24,-4,27
Din Moscow,5538,7,6,6,8,20,24,-4,24
FK Rubin,5538,8,5,5,10,22,24,-2,20
Rostov,5538,9,4,7,9,11,18,-7,19
Amkar,5538,10,4,5,11,10,24,-14,17
Anzhi,5538,11,3,5,12,16,38,-22,14
Loko Moscow,5539,1,13,5,2,35,12,23,44
CSKA Moscow,5539,2,12,3,5,31,18,13,39
Spart Moscow,5539,3,10,5,5,39,30,9,35
Zenit,5539,4,7,8,5,23,18,5,29
Terek Grozny,5539,5,8,5,7,21,25,-4,29
Krasnodar,5539,6,8,4,8,28,30,-2,28
FK Rubin,5539,7,7,5,8,26,19,7,26
Din Moscow,5539,8,6,6,8,21,26,-5,24
Rostov,5539,9,4,6,10,11,19,-8,18
Amkar,5539,10,4,4,12,10,25,-15,16
Anzhi,5539,11,3,5,12,17,40,-23,14
Loko Moscow,5540,1,13,5,2,32,11,21,44
CSKA Moscow,5540,2,11,3,6,30,19,11,36
Spart Moscow,5540,3,10,5,5,40,30,10,35
Zenit,5540,4,8,8,4,23,15,8,32
Krasnodar,5540,5,9,4,7,30,26,4,31
Terek Grozny,5540,6,7,5,8,21,26,-5,26
Din Moscow,5540,7,6,6,8,22,26,-4,24
FK Rubin,5540,8,6,5,9,23,21,2,23
Amkar,5540,9,5,4,11,11,25,-14,19
Rostov,5540,10,4,6,10,10,18,-8,18
Anzhi,5540,11,3,5,12,17,42,-25,14
Loko Moscow,5541,1,11,6,3,32,15,17,39
Spart Moscow,5541,2,11,5,4,40,27,13,38
CSKA Moscow,5541,3,11,3,6,27,19,8,36
Zenit,5541,4,9,8,3,24,14,10,35
Krasnodar,5541,5,8,6,6,30,27,3,30
Terek Grozny,5541,6,8,5,7,26,24,2,29
Din Moscow,5541,7,6,6,8,22,24,-2,24
FK Rubin,5541,8,5,6,9,22,22,0,21
Amkar,5541,9,5,4,11,11,25,-14,19
Rostov,5541,10,4,6,10,11,19,-8,18
Anzhi,5541,11,2,5,13,15,44,-29,11
Loko Moscow,5542,1,12,5,3,31,12,19,41
CSKA Moscow,5542,2,11,4,5,28,18,10,37
Spart Moscow,5542,3,10,6,4,43,29,14,36
Zenit,5542,4,8,9,3,22,13,9,33
Terek Grozny,5542,5,8,6,6,24,24,0,30
Krasnodar,5542,6,8,5,7,27,26,1,29
Din Moscow,5542,7,6,6,8,18,25,-7,24
FK Rubin,5542,8,5,6,9,21,18,3,21
Rostov,5542,9,4,6,10,12,21,-9,18
Amkar,5542,10,4,6,10,11,24,-13,18
Anzhi,5542,11,2,5,13,17,44,-27,11
Loko Moscow,5543,1,13,5,2,32,12,20,44
Spart Moscow,5543,2,11,5,4,42,27,15,38
CSKA Moscow,5543,3,10,4,6,26,19,7,34
Krasnodar,5543,4,9,4,7,29,26,3,31
Zenit,5543,5,7,9,4,21,14,7,30
Terek Grozny,5543,6,7,5,8,21,27,-6,26
Din Moscow,5543,7,6,6,8,21,24,-3,24
FK Rubin,5543,8,5,5,10,21,21,0,20
Amkar,5543,9,5,4,11,12,26,-14,19
Rostov,5543,10,4,6,10,10,20,-10,18
Anzhi,5543,11,4,5,11,19,38,-19,17
Loko Moscow,5544,1,13,5,2,32,12,20,44
CSKA Moscow,5544,2,12,3,5,28,18,10,39
Spart Moscow,5544,3,9,6,5,37,29,8,33
Zenit,5544,4,7,8,5,21,15,6,29
Terek Grozny,5544,5,8,5,7,22,24,-2,29
Krasnodar,5544,6,8,4,8,28,27,1,28
Din Moscow,5544,7,6,7,7,20,23,-3,25
FK Rubin,5544,8,6,5,9,22,18,4,23
Amkar,5544,9,6,4,10,13,24,-11,22
Rostov,5544,10,4,6,10,10,18,-8,18
Anzhi,5544,11,2,5,13,15,40,-25,11
Loko Moscow,5545,1,12,5,3,34,16,18,41
CSKA Moscow,5545,2,10,5,5,29,21,8,35
Spart Moscow,5545,3,9,7,4,38,29,9,34
Krasnodar,5545,4,9,4,7,32,30,2,31
Zenit,5545,5,7,9,4,23,17,6,30
Terek Grozny,5545,6,7,6,7,22,25,-3,27
Din Moscow,5545,7,6,7,7,21,24,-3,25
FK Rubin,5545,8,6,5,9,27,21,6,23
Rostov,5545,9,4,6,10,11,19,-8,18
Amkar,5545,10,4,6,10,13,26,-13,18
Anzhi,5545,11,3,6,11,18,40,-22,15
Loko Moscow,5546,1,12,5,3,32,15,17,41
Spart Moscow,5546,2,10,6,4,38,28,10,36
CSKA Moscow,5546,3,10,4,6,27,22,5,34
Zenit,5546,4,8,8,4,26,16,10,32
Krasnodar,5546,5,9,5,6,30,25,5,32
Terek Grozny,5546,6,8,6,6,21,22,-1,30
Din Moscow,5546,7,5,8,7,20,24,-4,23
FK Rubin,5546,8,5,7,8,23,19,4,22
Rostov,5546,9,4,6,10,10,18,-8,18
Amkar,5546,10,4,4,12,10,25,-15,16
Anzhi,5546,11,2,7,11,16,39,-23,13
Loko Moscow,5547,1,11,6,3,31,14,17,39
Zenit,5547,2,9,8,3,25,15,10,35
Spart Moscow,5547,3,9,6,5,36,29,7,33
CSKA Moscow,5547,4,10,3,7,27,21,6,33
Krasnodar,5547,5,9,5,6,30,26,4,32
Terek Grozny,5547,6,8,5,7,22,24,-2,29
FK Rubin,5547,7,6,5,9,25,21,4,23
Din Moscow,5547,8,5,6,9,21,27,-6,21
Rostov,5547,9,4,7,9,10,17,-7,19
Amkar,5547,10,5,4,11,12,24,-12,19
Anzhi,5547,11,4,5,11,17,38,-21,17
Loko Moscow,5548,1,11,5,4,30,14,16,38
Spart Moscow,5548,2,10,5,5,40,30,10,35
Zenit,5548,3,9,8,3,23,13,10,35
CSKA Moscow,5548,4,10,3,7,25,20,5,33
Krasnodar,5548,5,9,4,7,31,28,3,31
Terek Grozny,5548,6,7,5,8,20,27,-7,26
FK Rubin,5548,7,6,6,8,24,19,5,24
Din Moscow,5548,8,5,7,8,18,23,-5,22
Amkar,5548,9,6,4,10,15,23,-8,22
Rostov,5548,10,4,6,10,12,21,-9,18
Anzhi,5548,11,4,5,11,17,37,-20,17
CSKA Moscow,5549,1,12,3,5,29,17,12,39
Loko Moscow,5549,2,11,5,4,30,15,15,38
Spart Moscow,5549,3,10,6,4,37,25,12,36
Zenit,5549,4,8,8,4,23,16,7,32
Krasnodar,5549,5,9,5,6,29,24,5,32
Terek Grozny,5549,6,9,5,6,22,22,0,32
FK Rubin,5549,7,5,7,8,21,17,4,22
Din Moscow,5549,8,5,7,8,17,23,-6,22
Rostov,5549,9,4,7,9,10,17,-7,19
Amkar,5549,10,4,4,12,9,25,-16,16
Anzhi,5549,11,2,5,13,14,40,-26,11
Loko Moscow,5550,1,12,6,2,32,13,19,42
CSKA Moscow,5550,2,11,4,5,29,18,11,37
Spart Moscow,5550,3,9,6,5,37,29,8,33
Krasnodar,5550,4,8,6,6,30,27,3,30
Zenit,5550,5,7,8,5,22,18,4,29
Terek Grozny,5550,6,8,5,7,21,24,-3,29
FK Rubin,5550,7,5,7,8,23,19,4,22
Din Moscow,5550,8,5,7,8,18,24,-6,22
Rostov,5550,9,5,6,9,12,17,-5,21
Amkar,5550,10,4,5,11,10,24,-14,17
Anzhi,5550,11,3,6,11,17,38,-21,15
Loko Moscow,5551,1,11,6,3,31,14,17,39
CSKA Moscow,5551,2,11,3,6,29,21,8,36
Spart Moscow,5551,3,10,5,5,39,27,12,35
Krasnodar,5551,4,10,4,6,31,24,7,34
Zenit,5551,5,8,9,3,26,16,10,33
Terek Grozny,5551,6,7,6,7,21,24,-3,27
FK Rubin,5551,7,6,5,9,23,20,3,23
Amkar,5551,8,6,4,10,12,22,-10,22
Din Moscow,5551,9,5,6,9,17,25,-8,21
Rostov,5551,10,4,6,10,10,21,-11,18
Anzhi,5551,11,2,6,12,16,41,-25,12
Loko Moscow,5552,1,13,5,2,35,12,23,44
Spart Moscow,5552,2,10,6,4,38,26,12,36
CSKA Moscow,5552,3,11,3,6,30,20,10,36
Zenit,5552,4,8,8,4,24,17,7,32
Terek Grozny,5552,5,9,5,6,23,22,1,32
Krasnodar,5552,6,9,4,7,31,29,2,31
Din Moscow,5552,7,5,7,8,18,24,-6,22
FK Rubin,5552,8,5,6,9,22,20,2,21
Rostov,5552,9,4,7,9,10,17,-7,19
Amkar,5552,10,4,4,12,9,25,-16,16
Anzhi,5552,11,2,5,13,14,42,-28,11
Loko Moscow,5553,1,12,5,3,30,12,18,41
CSKA Moscow,5553,2,12,3,5,31,18,13,39
Spart Moscow,5553,3,10,5,5,38,27,11,35
Krasnodar,5553,4,9,4,7,30,29,1,31
Terek Grozny,5553,5,8,6,6,24,25,-1,30
Zenit,5553,6,7,8,5,21,16,5,29
FK Rubin,5553,7,7,5,8,28,20,8,26
Din Moscow,5553,8,5,6,9,19,25,-6,21
Rostov,5553,9,5,6,9,11,17,-6,21
Amkar,5553,10,4,5,11,12,28,-16,17
Anzhi,5553,11,2,5,13,15,42,-27,11
Loko Moscow,5554,1,12,5,3,33,13,20,41
CSKA Moscow,5554,2,11,3,6,30,20,10,36
Zenit,5554,3,9,8,3,24,14,10,35
Spart Moscow,5554,4,9,6,5,39,31,8,33
Krasnodar,5554,5,9,4,7,32,28,4,31
Terek Grozny,5554,6,7,6,7,22,25,-3,27
Din Moscow,5554,7,6,7,7,21,24,-3,25
Amkar,5554,8,6,4,10,11,22,-11,22
FK Rubin,5554,9,5,5,10,21,22,-1,20
Rostov,5554,10,4,6,10,12,20,-8,18
Anzhi,5554,11,2,6,12,17,43,-26,12
Loko Moscow,5555,1,11,5,4,29,13,16,38
CSKA Moscow,5555,2,11,3,6,26,18,8,36
Spart Moscow,5555,3,10,5,5,40,30,10,35
Krasnodar,5555,4,10,4,6,31,25,6,34
Zenit,5555,5,8,8,4,22,14,8,32
Terek Grozny,5555,6,7,6,7,21,24,-3,27
Din Moscow,5555,7,6,6,8,21,23,-2,24
FK Rubin,5555,8,5,5,10,22,23,-1,20
Amkar,5555,9,5,5,10,13,24,-11,20
Rostov,5555,10,4,6,10,11,21,-10,18
Anzhi,5555,11,4,5,11,16,37,-21,17
Loko Moscow,5556,1,11,5,4,32,16,16,38
CSKA Moscow,5556,2,10,5,5,25,17,8,35
Spart Moscow,5556,3,9,7,4,39,30,9,34
Krasnodar,5556,4,10,4,6,33,26,7,34
Zenit,5556,5,8,9,3,23,14,9,33
Terek Grozny,5556,6,7,6,7,22,26,-4,27
Din Moscow,5556,7,5,7,8,18,23,-5,22
FK Rubin,5556,8,5,6,9,21,20,1,21
Amkar,5556,9,5,5,10,15,26,-11,20
Rostov,5556,10,4,7,9,11,18,-7,19
Anzhi,5556,11,2,7,11,15,38,-23,13
Loko Moscow,5557,1,12,6,2,31,12,19,42
Spart Moscow,5557,2,10,6,4,39,29,10,36
Zenit,5557,3,8,9,3,24,14,10,33
CSKA Moscow,5557,4,10,3,7,26,21,5,33
Terek Grozny,5557,5,9,5,6,29,25,4,32
Krasnodar,5557,6,8,4,8,28,27,1,28
FK Rubin,5557,7,6,6,8,23,18,5,24
Din Moscow,5557,8,5,7,8,18,23,-5,22
Rostov,5557,9,4,6,10,11,19,-8,18
Amkar,5557,10,4,5,11,12,28,-16,17
Anzhi,5557,11,3,5,12,18,43,-25,14
Loko Moscow,5558,1,12,5,3,32,14,18,41
Spart Moscow,5558,2,10,6,4,36,25,11,36
CSKA Moscow,5558,3,10,4,6,25,18,7,34
Krasnodar,5558,4,10,4,6,30,25,5,34
Zenit,5558,5,8,8,4,24,16,8,32
Terek Grozny,5558,6,7,5,8,21,25,-4,26
FK Rubin,5558,7,6,5,9,24,20,4,23
Din Moscow,5558,8,5,6,9,18,25,-7,21
Amkar,5558,9,5,5,10,10,22,-12,20
Rostov,5558,10,4,6,10,10,18,-8,18
Anzhi,5558,11,3,6,11,16,38,-22,15
Loko Moscow,5559,1,12,5,3,31,14,17,41
CSKA Moscow,5559,2,12,3,5,32,20,12,39
Spart Moscow,5559,3,11,5,4,41,27,14,38
Zenit,5559,4,8,8,4,25,17,8,32
Krasnodar,5559,5,8,4,8,29,28,1,28
Terek Grozny,5559,6,7,7,6,22,24,-2,28
FK Rubin,5559,7,7,5,8,24,18,6,26
Din Moscow,5559,8,5,6,9,18,24,-6,21
Rostov,5559,9,4,6,10,11,20,-9,18
Amkar,5559,10,4,5,11,9,25,-16,17
Anzhi,5559,11,2,6,12,17,42,-25,12
Loko Moscow,5560,1,11,7,2,31,13,18,40
Spart Moscow,5560,2,11,5,4,43,26,17,38
Zenit,5560,3,8,9,3,23,14,9,33
CSKA Moscow,5560,4,10,3,7,26,20,6,33
Krasnodar,5560,5,9,5,6,30,26,4,32
Terek Grozny,5560,6,8,5,7,24,24,0,29
Din Moscow,5560,7,6,6,8,18,26,-8,24
FK Rubin,5560,8,5,5,10,22,20,2,20
Amkar,5560,9,5,4,11,10,23,-13,19
Rostov,5560,10,4,6,10,11,21,-10,18
Anzhi,5560,11,3,5,12,17,42,-25,14
Loko Moscow,5561,1,12,6,2,31,12,19,42
CSKA Moscow,5561,2,11,3,6,28,19,9,36
Spart Moscow,5561,3,10,5,5,36,29,7,35
Zenit,5561,4,8,8,4,23,14,9,32
Krasnodar,5561,5,8,5,7,29,27,2,29
Terek Grozny,5561,6,7,7,6,22,24,-2,28
FK Rubin,5561,7,7,5,8,24,18,6,26
Rostov,5561,8,5,6,9,13,17,-4,21
Din Moscow,5561,9,5,6,9,18,24,-6,21
Amkar,5561,10,4,5,11,9,23,-14,17
Anzhi,5561,11,2,6,12,16,42,-26,12
Loko Moscow,5562,1,11,7,2,30,12,18,40
Spart Moscow,5562,2,10,5,5,38,29,9,35
CSKA Moscow,5562,3,10,5,5,27,19,8,35
Zenit,5562,4,7,10,3,22,14,8,31
Krasnodar,5562,5,8,6,6,30,27,3,30
Terek Grozny,5562,6,7,5,8,22,27,-5,26
FK Rubin,5562,7,5,7,8,23,19,4,22
Din Moscow,5562,8,5,7,8,17,22,-5,22
Rostov,5562,9,5,6,9,13,19,-6,21
Amkar,5562,10,5,4,11,13,25,-12,19
Anzhi,5562,11,3,6,11,17,39,-22,15
Loko Moscow,5563,1,11,7,2,29,11,18,40
CSKA Moscow,5563,2,12,3,5,30,17,13,39
Spart Moscow,5563,3,10,5,5,37,29,8,35
Krasnodar,5563,4,9,5,6,29,25,4,32
Zenit,5563,5,7,9,4,21,16,5,30
Terek Grozny,5563,6,7,7,6,22,24,-2,28
Din Moscow,5563,7,5,7,8,20,25,-5,22
FK Rubin,5563,8,5,6,9,24,21,3,21
Amkar,5563,9,5,5,10,12,23,-11,20
Rostov,5563,10,4,6,10,11,19,-8,18
Anzhi,5563,11,2,6,12,15,40,-25,12
Loko Moscow,5564,1,11,5,4,30,14,16,38
CSKA Moscow,5564,2,10,5,5,28,20,8,35
Krasnodar,5564,3,10,4,6,29,24,5,34
Zenit,5564,4,8,9,3,24,15,9,33
Spart Moscow,5564,5,9,5,6,35,30,5,32
Terek Grozny,5564,6,8,5,7,23,26,-3,29
Din Moscow,5564,7,6,6,8,20,23,-3,24
FK Rubin,5564,8,6,5,9,22,18,4,23
Rostov,5564,9,5,6,9,12,17,-5,21
Amkar,5564,10,5,4,11,11,23,-12,19
Anzhi,5564,11,2,6,12,18,42,-24,12
Loko Moscow,5565,1,12,5,3,31,12,19,41
Spart Moscow,5565,2,10,5,5,38,29,9,35
CSKA Moscow,5565,3,10,5,5,29,21,8,35
Krasnodar,5565,4,9,5,6,28,24,4,32
Terek Grozny,5565,5,9,5,6,24,22,2,32
Zenit,5565,6,7,9,4,22,16,6,30
Din Moscow,5565,7,6,6,8,20,24,-4,24
FK Rubin,5565,8,5,6,9,22,19,3,21
Rostov,5565,9,5,6,9,12,18,-6,21
Amkar,5565,10,4,4,12,10,25,-15,16
Anzhi,5565,11,2,6,12,17,43,-26,12
Loko Moscow,5566,1,12,5,3,31,12,19,41
CSKA Moscow,5566,2,11,4,5,30,19,11,37
Spart Moscow,5566,3,10,6,4,41,25,16,36
Krasnodar,5566,4,10,4,6,29,24,5,34
Terek Grozny,5566,5,9,5,6,23,23,0,32
Zenit,5566,6,7,9,4,23,17,6,30
Din Moscow,5566,7,6,6,8,19,27,-8,24
FK Rubin,5566,8,5,5,10,22,20,2,20
Rostov,5566,9,4,6,10,10,20,-10,18
Amkar,5566,10,4,5,11,9,23,-14,17
Anzhi,5566,11,2,5,13,15,42,-27,11
Loko Moscow,5567,1,11,7,2,31,13,18,40
CSKA Moscow,5567,2,11,4,5,28,17,11,37
Spart Moscow,5567,3,10,5,5,35,26,9,35
Zenit,5567,4,7,10,3,22,14,8,31
Krasnodar,5567,5,8,6,6,29,26,3,30
Terek Grozny,5567,6,7,5,8,20,25,-5,26
Din Moscow,5567,7,6,6,8,19,22,-3,24
Amkar,5567,8,6,4,10,12,22,-10,22
FK Rubin,5567,9,5,6,9,22,20,2,21
Rostov,5567,10,4,6,10,10,18,-8,18
Anzhi,5567,11,3,5,12,15,40,-25,14
Loko Moscow,5568,1,11,6,3,30,13,17,39
Zenit,5568,2,9,8,3,26,14,12,35
Spart Moscow,5568,3,9,6,5,36,28,8,33
CSKA Moscow,5568,4,10,3,7,25,21,4,33
Krasnodar,5568,5,8,6,6,29,26,3,30
Terek Grozny,5568,6,8,6,6,23,24,-1,30
FK Rubin,5568,7,6,6,8,24,19,5,24
Din Moscow,5568,8,5,7,8,18,23,-5,22
Rostov,5568,9,5,6,9,12,17,-5,21
Amkar,5568,10,4,5,11,10,25,-15,17
Anzhi,5568,11,3,5,12,16,39,-23,14
Loko Moscow,5569,1,12,6,2,31,12,19,42
CSKA Moscow,5569,2,10,5,5,28,20,8,35
Spart Moscow,5569,3,9,6,5,37,29,8,33
Terek Grozny,5569,4,9,5,6,24,23,1,32
Zenit,5569,5,7,9,4,22,15,7,30
Krasnodar,5569,6,8,5,7,28,26,2,29
Din Moscow,5569,7,6,7,7,19,22,-3,25
FK Rubin,5569,8,6,5,9,23,19,4,23
Amkar,5569,9,5,4,11,12,25,-13,19
Rostov,5569,10,4,6,10,11,19,-8,18
Anzhi,5569,11,2,6,12,17,42,-25,12
Loko Moscow,5570,1,11,6,3,30,14,16,39
Spart Moscow,5570,2,11,5,4,40,25,15,38
CSKA Moscow,5570,3,11,4,5,27,18,9,37
Zenit,5570,4,7,10,3,23,15,8,31
Krasnodar,5570,5,9,4,7,29,25,4,31
Terek Grozny,5570,6,7,5,8,20,25,-5,26
Din Moscow,5570,7,6,6,8,19,23,-4,24
FK Rubin,5570,8,6,5,9,22,19,3,23
Amkar,5570,9,5,4,11,10,23,-13,19
Rostov,5570,10,4,6,10,10,21,-11,18
Anzhi,5570,11,3,5,12,16,38,-22,14
Loko Moscow,5571,1,12,5,3,32,12,20,41
CSKA Moscow,5571,2,11,4,5,30,21,9,37
Krasnodar,5571,3,10,4,6,31,25,6,34
Spart Moscow,5571,4,8,7,5,37,30,7,31
Zenit,5571,5,7,9,4,22,17,5,30
Terek Grozny,5571,6,8,5,7,22,25,-3,29
Din Moscow,5571,7,6,7,7,18,21,-3,25
FK Rubin,5571,8,5,5,10,22,21,1,20
Rostov,5571,9,4,7,9,12,19,-7,19
Amkar,5571,10,5,4,11,12,26,-14,19
Anzhi,5571,11,3,5,12,20,41,-21,14
Loko Moscow,5572,1,12,5,3,30,12,18,41
Spart Moscow,5572,2,11,5,4,43,26,17,38
CSKA Moscow,5572,3,11,3,6,30,21,9,36
Zenit,5572,4,9,8,3,25,14,11,35
Krasnodar,5572,5,9,4,7,28,25,3,31
Terek Grozny,5572,6,7,6,7,21,25,-4,27
Din Moscow,5572,7,6,6,8,20,28,-8,24
FK Rubin,5572,8,5,5,10,22,20,2,20
Amkar,5572,9,5,4,11,11,23,-12,19
Rostov,5572,10,4,6,10,10,20,-10,18
Anzhi,5572,11,2,6,12,16,42,-26,12
Loko Moscow,5573,1,12,5,3,31,13,18,41
Spart Moscow,5573,2,9,7,4,35,26,9,34
CSKA Moscow,5573,3,10,4,6,27,20,7,34
Krasnodar,5573,4,9,5,6,30,26,4,32
Zenit,5573,5,7,9,4,23,16,7,30
Terek Grozny,5573,6,7,6,7,20,23,-3,27
Din Moscow,5573,7,6,6,8,21,23,-2,24
FK Rubin,5573,8,5,6,9,22,21,1,21
Rostov,5573,9,4,7,9,10,17,-7,19
Amkar,5573,10,4,6,10,9,22,-13,18
Anzhi,5573,11,4,5,11,16,37,-21,17
Loko Moscow,5574,1,12,6,2,32,13,19,42
Spart Moscow,5574,2,10,6,4,38,26,12,36
CSKA Moscow,5574,3,11,3,6,29,22,7,36
Zenit,5574,4,8,8,4,25,16,9,32
Krasnodar,5574,5,9,5,6,30,26,4,32
Terek Grozny,5574,6,8,6,6,23,23,0,30
Din Moscow,5574,7,6,6,8,19,24,-5,24
FK Rubin,5574,8,5,5,10,22,21,1,20
Rostov,5574,9,4,6,10,11,19,-8,18
Amkar,5574,10,4,6,10,9,22,-13,18
Anzhi,5574,11,2,5,13,17,43,-26,11
Loko Moscow,5575,1,12,6,2,32,12,20,42
CSKA Moscow,5575,2,11,3,6,26,19,7,36
Spart Moscow,5575,3,9,6,5,39,29,10,33
Zenit,5575,4,8,8,4,23,15,8,32
Krasnodar,5575,5,8,6,6,28,25,3,30
Terek Grozny,5575,6,7,5,8,20,24,-4,26
FK Rubin,5575,7,6,6,8,22,17,5,24
Din Moscow,5575,8,5,7,8,18,23,-5,22
Amkar,5575,9,6,4,10,13,24,-11,22
Rostov,5575,10,4,6,10,10,20,-10,18
Anzhi,5575,11,3,5,12,15,38,-23,14
Loko Moscow,5576,1,12,6,2,32,13,19,42
CSKA Moscow,5576,2,11,3,6,27,19,8,36
Spart Moscow,5576,3,10,5,5,39,28,11,35
Zenit,5576,4,8,9,3,24,14,10,33
Krasnodar,5576,5,9,4,7,29,26,3,31
Terek Grozny,5576,6,8,6,6,22,23,-1,30
FK Rubin,5576,7,6,5,9,23,19,4,23
Rostov,5576,8,5,6,9,12,18,-6,21
Din Moscow,5576,9,5,6,9,18,25,-7,21
Amkar,5576,10,4,5,11,10,25,-15,17
Anzhi,5576,11,2,5,13,15,41,-26,11
Loko Moscow,5577,1,12,5,3,34,15,19,41
CSKA Moscow,5577,2,12,3,5,32,19,13,39
Spart Moscow,5577,3,9,6,5,39,29,10,33
Zenit,5577,4,8,8,4,25,18,7,32
Krasnodar,5577,5,8,4,8,28,28,0,28
FK Rubin,5577,6,7,5,8,23,17,6,26
Terek Grozny,5577,7,7,5,8,22,26,-4,26
Din Moscow,5577,8,6,6,8,20,24,-4,24
Amkar,5577,9,5,5,10,10,22,-12,20
Rostov,5577,10,4,6,10,11,21,-10,18
Anzhi,5577,11,3,5,12,18,43,-25,14
Loko Moscow,5578,1,12,5,3,31,12,19,41
Spart Moscow,5578,2,11,5,4,42,28,14,38
CSKA Moscow,5578,3,11,3,6,28,20,8,36
Zenit,5578,4,8,8,4,22,15,7,32
Krasnodar,5578,5,9,4,7,29,26,3,31
Terek Grozny,5578,6,8,5,7,21,23,-2,29
Din Moscow,5578,7,6,6,8,19,24,-5,24
FK Rubin,5578,8,6,5,9,23,19,4,23
Amkar,5578,9,5,4,11,11,26,-15,19
Rostov,5578,10,4,6,10,11,19,-8,18
Anzhi,5578,11,2,5,13,16,41,-25,11
Loko Moscow,5579,1,12,5,3,31,12,19,41
Spart Moscow,5579,2,11,5,4,38,27,11,38
CSKA Moscow,5579,3,11,4,5,27,18,9,37
Zenit,5579,4,8,9,3,23,14,9,33
Krasnodar,5579,5,9,4,7,31,26,5,31
Terek Grozny,5579,6,7,5,8,20,25,-5,26
FK Rubin,5579,7,6,5,9,23,21,2,23
Din Moscow,5579,8,5,6,9,19,26,-7,21
Amkar,5579,9,5,4,11,10,23,-13,19
Rostov,5579,10,4,6,10,10,18,-8,18
Anzhi,5579,11,3,5,12,16,38,-22,14
Loko Moscow,5580,1,12,5,3,32,14,18,41
Spart Moscow,5580,2,10,6,4,40,28,12,36
CSKA Moscow,5580,3,11,3,6,27,19,8,36
Zenit,5580,4,8,8,4,22,15,7,32
Krasnodar,5580,5,9,5,6,32,27,5,32
Terek Grozny,5580,6,8,5,7,21,25,-4,29
FK Rubin,5580,7,6,6,8,24,19,5,24
Din Moscow,5580,8,5,6,9,18,26,-8,21
Amkar,5580,9,5,5,10,14,24,-10,20
Rostov,5580,10,4,6,10,10,18,-8,18
Anzhi,5580,11,2,5,13,15,40,-25,11
Loko Moscow,5581,1,13,5,2,32,12,20,44
CSKA Moscow,5581,2,10,4,6,29,22,7,34
Spart Moscow,5581,3,9,5,6,38,29,9,32
Zenit,5581,4,7,9,4,23,16,7,30
Krasnodar,5581,5,8,4,8,29,28,1,28
Terek Grozny,5581,6,7,6,7,21,24,-3,27
FK Rubin,5581,7,6,6,8,24,19,5,24
Din Moscow,5581,8,5,7,8,19,27,-8,22
Rostov,5581,9,5,6,9,11,17,-6,21
Amkar,5581,10,5,5,10,12,23,-11,20
Anzhi,5581,11,4,5,11,18,39,-21,17
Loko Moscow,5582,1,12,5,3,32,12,20,41
CSKA Moscow,5582,2,12,3,5,31,17,14,39
Krasnodar,5582,3,10,4,6,31,25,6,34
Spart Moscow,5582,4,9,6,5,40,32,8,33
Zenit,5582,5,7,8,5,21,17,4,29
Terek Grozny,5582,6,8,5,7,21,24,-3,29
Din Moscow,5582,7,6,6,8,19,24,-5,24
Rostov,5582,8,5,6,9,14,19,-5,21
FK Rubin,5582,9,5,5,10,22,21,1,20
Amkar,5582,10,4,5,11,11,25,-14,17
Anzhi,5582,11,3,5,12,16,42,-26,14
Loko Moscow,5583,1,12,5,3,33,16,17,41
CSKA Moscow,5583,2,12,3,5,28,18,10,39
Spart Moscow,5583,3,10,5,5,40,28,12,35
Terek Grozny,5583,4,9,5,6,24,23,1,32
Krasnodar,5583,5,9,4,7,32,27,5,31
Zenit,5583,6,7,8,5,21,17,4,29
FK Rubin,5583,7,6,6,8,24,18,6,24
Din Moscow,5583,8,5,7,8,19,25,-6,22
Rostov,5583,9,5,6,9,12,18,-6,21
Amkar,5583,10,4,4,12,10,27,-17,16
Anzhi,5583,11,2,5,13,15,41,-26,11
Loko Moscow,5584,1,13,5,2,34,12,22,44
CSKA Moscow,5584,2,12,3,5,30,17,13,39
Spart Moscow,5584,3,9,7,4,35,26,9,34
Terek Grozny,5584,4,9,5,6,22,22,0,32
Krasnodar,5584,5,9,4,7,30,27,3,31
Zenit,5584,6,7,8,5,21,16,5,29
FK Rubin,5584,7,6,5,9,22,19,3,23
Din Moscow,5584,8,5,6,9,17,23,-6,21
Rostov,5584,9,4,7,9,10,17,-7,19
Amkar,5584,10,4,5,11,10,24,-14,17
Anzhi,5584,11,2,5,13,14,42,-28,11
Loko Moscow,5585,1,12,6,2,31,12,19,42
CSKA Moscow,5585,2,10,4,6,27,23,4,34
Zenit,5585,3,8,9,3,26,14,12,33
Spart Moscow,5585,4,8,6,6,35,30,5,30
Krasnodar,5585,5,8,5,7,27,25,2,29
Terek Grozny,5585,6,8,5,7,23,24,-1,29
Din Moscow,5585,7,6,7,7,20,23,-3,25
FK Rubin,5585,8,5,7,8,22,18,4,22
Rostov,5585,9,5,6,9,13,18,-5,21
Amkar,5585,10,5,5,10,11,22,-11,20
Anzhi,5585,11,2,6,12,16,42,-26,12
Loko Moscow,5586,1,11,6,3,30,13,17,39
CSKA Moscow,5586,2,10,5,5,28,20,8,35
Spart Moscow,5586,3,9,6,5,35,28,7,33
Krasnodar,5586,4,9,5,6,28,24,4,32
Zenit,5586,5,7,10,3,24,16,8,31
Terek Grozny,5586,6,8,6,6,22,23,-1,30
Din Moscow,5586,7,6,6,8,20,23,-3,24
FK Rubin,5586,8,5,6,9,22,20,2,21
Rostov,5586,9,5,6,9,13,18,-5,21
Amkar,5586,10,4,5,11,10,24,-14,17
Anzhi,5586,11,2,7,11,15,38,-23,13
Loko Moscow,5587,1,12,6,2,33,13,20,42
CSKA Moscow,5587,2,11,4,5,31,21,10,37
Spart Moscow,5587,3,10,6,4,38,27,11,36
Zenit,5587,4,7,10,3,24,16,8,31
Terek Grozny,5587,5,8,5,7,21,23,-2,29
Krasnodar,5587,6,8,4,8,32,32,0,28
FK Rubin,5587,7,6,6,8,25,20,5,24
Din Moscow,5587,8,5,7,8,17,22,-5,22
Rostov,5587,9,4,6,10,11,20,-9,18
Amkar,5587,10,4,5,11,10,24,-14,17
Anzhi,5587,11,3,5,12,16,40,-24,14
Loko Moscow,5588,1,11,6,3,31,15,16,39
CSKA Moscow,5588,2,11,3,6,28,19,9,36
Zenit,5588,3,9,8,3,26,15,11,35
Krasnodar,5588,4,9,5,6,29,25,4,32
Spart Moscow,5588,5,8,5,7,36,31,5,29
Terek Grozny,5588,6,7,6,7,20,23,-3,27
Din Moscow,5588,7,6,7,7,19,22,-3,25
FK Rubin,5588,8,5,6,9,22,19,3,21
Rostov,5588,9,5,6,9,12,18,-6,21
Amkar,5588,10,5,5,10,12,24,-12,20
Anzhi,5588,11,3,5,12,15,39,-24,14
Loko Moscow,5589,1,12,5,3,32,12,20,41
CSKA Moscow,5589,2,11,3,6,27,18,9,36
Zenit,5589,3,9,8,3,23,13,10,35
Spart Moscow,5589,4,9,5,6,37,30,7,32
Krasnodar,5589,5,9,4,7,29,27,2,31
Terek Grozny,5589,6,7,7,6,20,22,-2,28
Din Moscow,5589,7,5,7,8,18,23,-5,22
FK Rubin,5589,8,5,6,9,21,19,2,21
Rostov,5589,9,5,6,9,12,18,-6,21
Amkar,5589,10,5,5,10,11,23,-12,20
Anzhi,5589,11,2,6,12,14,39,-25,12
Loko Moscow,5590,1,11,6,3,29,15,14,39
CSKA Moscow,5590,2,11,3,6,26,19,7,36
Krasnodar,5590,3,10,4,6,33,25,8,34
Zenit,5590,4,8,9,3,23,13,10,33
Spart Moscow,5590,5,9,6,5,36,27,9,33
Terek Grozny,5590,6,8,6,6,23,23,0,30
Din Moscow,5590,7,6,7,7,18,21,-3,25
Rostov,5590,8,5,6,9,11,17,-6,21
FK Rubin,5590,9,5,5,10,22,20,2,20
Amkar,5590,10,4,5,11,10,25,-15,17
Anzhi,5590,11,2,5,13,15,41,-26,11
Loko Moscow,5591,1,12,5,3,32,13,19,41
CSKA Moscow,5591,2,11,4,5,27,18,9,37
Krasnodar,5591,3,9,5,6,30,26,4,32
Terek Grozny,5591,4,9,5,6,24,23,1,32
Spart Moscow,5591,5,8,7,5,35,29,6,31
Zenit,5591,6,7,9,4,21,15,6,30
Din Moscow,5591,7,5,8,7,21,25,-4,23
FK Rubin,5591,8,5,7,8,24,20,4,22
Rostov,5591,9,4,7,9,10,17,-7,19
Amkar,5591,10,5,4,11,12,25,-13,19
Anzhi,5591,11,2,5,13,15,40,-25,11
Loko Moscow,5592,1,12,5,3,32,14,18,41
CSKA Moscow,5592,2,12,3,5,28,18,10,39
Spart Moscow,5592,3,9,7,4,36,26,10,34
Krasnodar,5592,4,9,5,6,30,25,5,32
Terek Grozny,5592,5,8,6,6,23,24,-1,30
Zenit,5592,6,7,8,5,22,17,5,29
Din Moscow,5592,7,5,8,7,18,22,-4,23
FK Rubin,5592,8,5,7,8,23,19,4,22
Rostov,5592,9,4,6,10,10,19,-9,18
Amkar,5592,10,4,5,11,10,24,-14,17
Anzhi,5592,11,2,6,12,17,41,-24,12
Loko Moscow,5593,1,11,5,4,29,14,15,38
CSKA Moscow,5593,2,11,4,5,27,18,9,37
Spart Moscow,5593,3,10,6,4,38,27,11,36
Zenit,5593,4,8,9,3,22,13,9,33
Krasnodar,5593,5,9,5,6,31,26,5,32
Terek Grozny,5593,6,7,6,7,22,26,-4,27
Din Moscow,5593,7,6,6,8,21,24,-3,24
FK Rubin,5593,8,5,6,9,23,22,1,21
Rostov,5593,9,4,7,9,11,18,-7,19
Amkar,5593,10,5,4,11,12,24,-12,19
Anzhi,5593,11,2,6,12,16,40,-24,12
Loko Moscow,5594,1,12,5,3,32,13,19,41
Zenit,5594,2,9,8,3,24,14,10,35
CSKA Moscow,5594,3,10,4,6,28,21,7,34
Terek Grozny,5594,4,9,5,6,23,23,0,32
Spart Moscow,5594,5,8,7,5,34,27,7,31
Krasnodar,5594,6,9,4,7,30,27,3,31
Din Moscow,5594,7,6,7,7,20,22,-2,25
Rostov,5594,8,5,6,9,11,17,-6,21
FK Rubin,5594,9,5,5,10,21,21,0,20
Amkar,5594,10,4,5,11,9,23,-14,17
Anzhi,5594,11,2,6,12,17,41,-24,12
Loko Moscow,5595,1,12,6,2,34,14,20,42
CSKA Moscow,5595,2,12,3,5,28,17,11,39
Spart Moscow,5595,3,8,8,4,35,27,8,32
Krasnodar,5595,4,9,5,6,31,26,5,32
Terek Grozny,5595,5,8,6,6,24,25,-1,30
Zenit,5595,6,7,8,5,23,18,5,29
Din Moscow,5595,7,6,7,7,19,22,-3,25
FK Rubin,5595,8,5,5,10,22,21,1,20
Rostov,5595,9,4,7,9,11,18,-7,19
Amkar,5595,10,4,5,11,11,25,-14,17
Anzhi,5595,11,2,6,12,15,40,-25,12
Loko Moscow,5596,1,12,6,2,31,12,19,42
Spart Moscow,5596,2,10,5,5,37,29,8,35
CSKA Moscow,5596,3,10,5,5,28,20,8,35
Zenit,5596,4,7,10,3,23,15,8,31
Krasnodar,5596,5,8,5,7,28,26,2,29
Terek Grozny,5596,6,7,5,8,20,24,-4,26
Din Moscow,5596,7,6,6,8,18,22,-4,24
Amkar,5596,8,6,4,10,14,22,-8,22
FK Rubin,5596,9,5,6,9,22,19,3,21
Rostov,5596,10,4,6,10,10,20,-10,18
Anzhi,5596,11,3,6,11,17,39,-22,15
Loko Moscow,5597,1,12,5,3,31,13,18,41
CSKA Moscow,5597,2,11,3,6,28,18,10,36
Spart Moscow,5597,3,9,6,5,36,30,6,33
Zenit,5597,4,8,8,4,22,15,7,32
Krasnodar,5597,5,9,4,7,29,26,3,31
Terek Grozny,5597,6,8,6,6,22,23,-1,30
Din Moscow,5597,7,7,6,7,21,21,0,27
FK Rubin,5597,8,6,5,9,23,18,5,23
Rostov,5597,9,4,6,10,10,18,-8,18
Amkar,5597,10,4,5,11,11,25,-14,17
Anzhi,5597,11,2,6,12,15,41,-26,12
Loko Moscow,5598,1,11,6,3,29,12,17,39
CSKA Moscow,5598,2,11,4,5,28,18,10,37
Zenit,5598,3,8,9,3,23,14,9,33
Spart Moscow,5598,4,9,5,6,36,29,7,32
Krasnodar,5598,5,9,5,6,30,26,4,32
Din Moscow,5598,6,7,6,7,20,22,-2,27
Terek Grozny,5598,7,7,5,8,21,26,-5,26
Amkar,5598,8,6,4,10,13,24,-11,22
FK Rubin,5598,9,5,5,10,23,21,2,20
Rostov,5598,10,4,6,10,10,18,-8,18
Anzhi,5598,11,3,5,12,16,39,-23,14
CSKA Moscow,5599,1,12,3,5,30,18,12,39
Loko Moscow,5599,2,11,5,4,30,17,13,38
Krasnodar,5599,3,10,4,6,34,26,8,34
Spart Moscow,5599,4,9,6,5,39,30,9,33
Zenit,5599,5,8,8,4,24,15,9,32
Terek Grozny,5599,6,7,7,6,22,24,-2,28
Din Moscow,5599,7,6,7,7,22,25,-3,25
FK Rubin,5599,8,5,6,9,25,24,1,21
Rostov,5599,9,4,7,9,12,19,-7,19
Amkar,5599,10,4,5,11,10,25,-15,17
Anzhi,5599,11,2,6,12,17,42,-25,12
Loko Moscow,5600,1,13,5,2,33,11,22,44
Spart Moscow,5600,2,10,6,4,38,26,12,36
CSKA Moscow,5600,3,11,3,6,27,18,9,36
Zenit,5600,4,8,8,4,22,15,7,32
Krasnodar,5600,5,8,5,7,27,26,1,29
Terek Grozny,5600,6,7,6,7,23,30,-7,27
Din Moscow,5600,7,6,6,8,20,24,-4,24
FK Rubin,5600,8,5,6,9,21,19,2,21
Rostov,5600,9,4,7,9,10,17,-7,19
Amkar,5600,10,4,5,11,12,27,-15,17
Anzhi,5600,11,3,5,12,19,39,-20,14
Loko Moscow,5601,1,13,5,2,35,13,22,44
CSKA Moscow,5601,2,11,3,6,28,19,9,36
Spart Moscow,5601,3,9,6,5,38,30,8,33
Zenit,5601,4,8,8,4,25,17,8,32
Krasnodar,5601,5,9,4,7,29,27,2,31
Terek Grozny,5601,6,8,6,6,22,23,-1,30
Din Moscow,5601,7,6,6,8,20,24,-4,24
Rostov,5601,8,5,6,9,12,18,-6,21
FK Rubin,5601,9,5,5,10,23,21,2,20
Amkar,5601,10,4,6,10,11,24,-13,18
Anzhi,5601,11,2,5,13,15,42,-27,11
Loko Moscow,5602,1,12,5,3,31,14,17,41
Spart Moscow,5602,2,11,5,4,40,26,14,38
CSKA Moscow,5602,3,11,3,6,27,18,9,36
Zenit,5602,4,9,8,3,24,13,11,35
Krasnodar,5602,5,9,4,7,31,28,3,31
Terek Grozny,5602,6,8,5,7,21,27,-6,29
Din Moscow,5602,7,6,6,8,20,24,-4,24
FK Rubin,5602,8,5,5,10,24,23,1,20
Amkar,5602,9,5,4,11,14,24,-10,19
Rostov,5602,10,4,6,10,11,20,-9,18
Anzhi,5602,11,2,5,13,14,40,-26,11
Loko Moscow,5603,1,13,5,2,32,11,21,44
Spart Moscow,5603,2,11,5,4,42,26,16,38
CSKA Moscow,5603,3,11,3,6,29,18,11,36
Zenit,5603,4,8,8,4,22,14,8,32
Krasnodar,5603,5,9,4,7,30,26,4,31
Terek Grozny,5603,6,8,5,7,24,25,-1,29
Din Moscow,5603,7,6,6,8,20,23,-3,24
FK Rubin,5603,8,5,5,10,21,22,-1,20
Amkar,5603,9,5,4,11,11,23,-12,19
Rostov,5603,10,4,6,10,10,23,-13,18
Anzhi,5603,11,2,5,13,15,45,-30,11
Loko Moscow,5604,1,12,5,3,30,15,15,41
Spart Moscow,5604,2,10,6,4,37,27,10,36
CSKA Moscow,5604,3,10,4,6,25,19,6,34
Krasnodar,5604,4,9,4,7,32,26,6,31
Zenit,5604,5,7,9,4,21,14,7,30
Terek Grozny,5604,6,8,6,6,25,26,-1,30
FK Rubin,5604,7,7,5,8,26,19,7,26
Din Moscow,5604,8,5,6,9,19,26,-7,21
Rostov,5604,9,4,7,9,10,17,-7,19
Amkar,5604,10,4,4,12,10,25,-15,16
Anzhi,5604,11,3,6,11,20,41,-21,15
Loko Moscow,5605,1,12,6,2,31,11,20,42
CSKA Moscow,5605,2,11,4,5,28,19,9,37
Spart Moscow,5605,3,9,6,5,39,30,9,33
Zenit,5605,4,7,9,4,22,16,6,30
Krasnodar,5605,5,8,5,7,27,26,1,29
Terek Grozny,5605,6,7,7,6,20,22,-2,28
FK Rubin,5605,7,7,5,8,24,17,7,26
Rostov,5605,8,5,6,9,14,19,-5,21
Din Moscow,5605,9,5,6,9,17,25,-8,21
Amkar,5605,10,4,6,10,10,23,-13,18
Anzhi,5605,11,2,6,12,15,39,-24,12
Loko Moscow,5606,1,12,6,2,31,12,19,42
CSKA Moscow,5606,2,10,5,5,27,19,8,35
Spart Moscow,5606,3,9,5,6,34,27,7,32
Zenit,5606,4,7,9,4,22,15,7,30
Krasnodar,5606,5,8,5,7,27,27,0,29
Terek Grozny,5606,6,7,7,6,22,24,-2,28
FK Rubin,5606,7,6,6,8,25,18,7,24
Din Moscow,5606,8,5,7,8,18,23,-5,22
Rostov,5606,9,5,6,9,11,17,-6,21
Amkar,5606,10,5,5,10,11,23,-12,20
Anzhi,5606,11,2,7,11,17,40,-23,13
Loko Moscow,5607,1,11,6,3,30,13,17,39
CSKA Moscow,5607,2,10,4,6,27,20,7,34
Zenit,5607,3,8,9,3,24,15,9,33
Spart Moscow,5607,4,9,5,6,37,30,7,32
Krasnodar,5607,5,9,5,6,30,26,4,32
Terek Grozny,5607,6,7,7,6,20,22,-2,28
Din Moscow,5607,7,6,6,8,18,23,-5,24
FK Rubin,5607,8,5,6,9,23,20,3,21
Rostov,5607,9,5,6,9,13,18,-5,21
Amkar,5607,10,5,5,10,11,23,-12,20
Anzhi,5607,11,2,7,11,15,38,-23,13
Loko Moscow,5608,1,12,6,2,32,11,21,42
CSKA Moscow,5608,2,11,4,5,27,18,9,37
Spart Moscow,5608,3,8,7,5,34,28,6,31
Krasnodar,5608,4,8,6,6,28,25,3,30
Zenit,5608,5,7,8,5,21,17,4,29
Terek Grozny,5608,6,8,5,7,22,25,-3,29
Din Moscow,5608,7,5,8,7,19,23,-4,23
FK Rubin,5608,8,5,7,8,23,19,4,22
Amkar,5608,9,6,4,10,14,22,-8,22
Rostov,5608,10,4,7,9,10,17,-7,19
Anzhi,5608,11,2,6,12,15,40,-25,12
Loko Moscow,5609,1,11,5,4,30,14,16,38
Spart Moscow,5609,2,10,6,4,41,28,13,36
Zenit,5609,3,9,8,3,24,14,10,35
CSKA Moscow,5609,4,10,3,7,27,21,6,33
Krasnodar,5609,5,9,4,7,30,27,3,31
Terek Grozny,5609,6,8,5,7,21,23,-2,29
FK Rubin,5609,7,7,5,8,26,19,7,26
Din Moscow,5609,8,5,6,9,20,27,-7,21
Amkar,5609,9,5,5,10,11,23,-12,20
Rostov,5609,10,4,6,10,10,21,-11,18
Anzhi,5609,11,3,5,12,16,39,-23,14
Loko Moscow,5610,1,12,5,3,30,12,18,41
CSKA Moscow,5610,2,11,4,5,32,19,13,37
Spart Moscow,5610,3,9,5,6,37,30,7,32
Zenit,5610,4,8,8,4,23,19,4,32
Krasnodar,5610,5,9,4,7,28,25,3,31
Terek Grozny,5610,6,8,6,6,22,23,-1,30
FK Rubin,5610,7,6,5,9,22,18,4,23
Din Moscow,5610,8,5,6,9,18,24,-6,21
Rostov,5610,9,5,6,9,12,18,-6,21
Amkar,5610,10,5,5,10,11,23,-12,20
Anzhi,5610,11,2,6,12,16,40,-24,12
Loko Moscow,5611,1,12,5,3,31,13,18,41
CSKA Moscow,5611,2,11,4,5,29,20,9,37
Zenit,5611,3,8,9,3,23,14,9,33
Spart Moscow,5611,4,9,6,5,35,27,8,33
Krasnodar,5611,5,9,4,7,31,28,3,31
Terek Grozny,5611,6,7,6,7,22,25,-3,27
Din Moscow,5611,7,6,7,7,19,21,-2,25
Rostov,5611,8,5,6,9,11,17,-6,21
FK Rubin,5611,9,5,5,10,23,22,1,20
Amkar,5611,10,5,4,11,11,24,-13,19
Anzhi,5611,11,2,6,12,18,42,-24,12
Loko Moscow,5612,1,12,6,2,34,14,20,42
CSKA Moscow,5612,2,12,3,5,31,20,11,39
Spart Moscow,5612,3,8,7,5,39,32,7,31
Zenit,5612,4,7,8,5,25,21,4,29
Krasnodar,5612,5,8,5,7,28,26,2,29
Terek Grozny,5612,6,8,5,7,21,23,-2,29
Din Moscow,5612,7,6,7,7,21,24,-3,25
FK Rubin,5612,8,6,5,9,22,18,4,23
Rostov,5612,9,5,6,9,12,18,-6,21
Amkar,5612,10,5,5,10,12,24,-12,20
Anzhi,5612,11,2,5,13,15,40,-25,11
Loko Moscow,5613,1,12,5,3,31,13,18,41
Spart Moscow,5613,2,11,5,4,39,28,11,38
Zenit,5613,3,9,8,3,27,16,11,35
CSKA Moscow,5613,4,10,4,6,28,22,6,34
Terek Grozny,5613,5,9,5,6,25,23,2,32
Krasnodar,5613,6,9,4,7,30,26,4,31
Din Moscow,5613,7,5,7,8,18,23,-5,22
FK Rubin,5613,8,5,6,9,22,20,2,21
Rostov,5613,9,4,6,10,11,19,-8,18
Amkar,5613,10,4,4,12,11,26,-15,16
Anzhi,5613,11,2,6,12,15,41,-26,12
CSKA Moscow,5614,1,12,3,5,28,18,10,39
Loko Moscow,5614,2,11,5,4,29,14,15,38
Spart Moscow,5614,3,9,6,5,38,29,9,33
Zenit,5614,4,8,8,4,23,14,9,32
Krasnodar,5614,5,9,4,7,28,25,3,31
Terek Grozny,5614,6,8,6,6,22,22,0,30
FK Rubin,5614,7,6,6,8,24,19,5,24
Din Moscow,5614,8,5,8,7,21,25,-4,23
Amkar,5614,9,5,5,10,10,22,-12,20
Rostov,5614,10,4,6,10,11,20,-9,18
Anzhi,5614,11,2,5,13,15,41,-26,11
Loko Moscow,5615,1,12,5,3,32,12,20,41
CSKA Moscow,5615,2,10,5,5,27,19,8,35
Spart Moscow,5615,3,9,6,5,39,29,10,33
Zenit,5615,4,8,9,3,23,14,9,33
Terek Grozny,5615,5,9,5,6,23,22,1,32
Krasnodar,5615,6,9,4,7,30,28,2,31
Din Moscow,5615,7,7,6,7,22,22,0,27
FK Rubin,5615,8,5,5,10,22,23,-1,20
Rostov,5615,9,4,7,9,12,19,-7,19
Amkar,5615,10,4,4,12,9,27,-18,16
Anzhi,5615,11,2,6,12,15,39,-24,12
Loko Moscow,5616,1,12,5,3,32,17,15,41
CSKA Moscow,5616,2,11,3,6,28,21,7,36
Spart Moscow,5616,3,9,7,4,37,28,9,34
Krasnodar,5616,4,10,4,6,33,25,8,34
Zenit,5616,5,8,8,4,26,16,10,32
Terek Grozny,5616,6,7,6,7,21,25,-4,27
FK Rubin,5616,7,6,5,9,24,20,4,23
Din Moscow,5616,8,5,7,8,19,24,-5,22
Rostov,5616,9,4,7,9,12,19,-7,19
Amkar,5616,10,5,4,11,11,23,-12,19
Anzhi,5616,11,2,6,12,16,41,-25,12
Loko Moscow,5617,1,11,6,3,30,13,17,39
CSKA Moscow,5617,2,11,3,6,29,21,8,36
Zenit,5617,3,9,8,3,26,14,12,35
Krasnodar,5617,4,9,5,6,31,25,6,32
Spart Moscow,5617,5,8,6,6,33,27,6,30
Terek Grozny,5617,6,7,6,7,23,26,-3,27
Din Moscow,5617,7,6,7,7,18,21,-3,25
FK Rubin,5617,8,5,6,9,22,21,1,21
Amkar,5617,9,5,5,10,12,24,-12,20
Rostov,5617,10,4,7,9,10,17,-7,19
Anzhi,5617,11,3,5,12,17,42,-25,14
Loko Moscow,5618,1,12,6,2,31,12,19,42
CSKA Moscow,5618,2,12,3,5,30,20,10,39
Spart Moscow,5618,3,9,6,5,38,28,10,33
Zenit,5618,4,7,9,4,23,16,7,30
Terek Grozny,5618,5,8,6,6,23,23,0,30
Krasnodar,5618,6,8,4,8,29,28,1,28
Din Moscow,5618,7,6,7,7,18,21,-3,25
FK Rubin,5618,8,6,6,8,23,18,5,24
Rostov,5618,9,4,6,10,11,21,-10,18
Amkar,5618,10,4,6,10,10,23,-13,18
Anzhi,5618,11,2,5,13,16,42,-26,11
Spart Moscow,5619,1,11,5,4,41,28,13,38
Loko Moscow,5619,2,11,5,4,30,17,13,38
CSKA Moscow,5619,3,11,3,6,27,19,8,36
Zenit,5619,4,9,8,3,26,14,12,35
Krasnodar,5619,5,9,5,6,30,25,5,32
Terek Grozny,5619,6,8,6,6,22,23,-1,30
Din Moscow,5619,7,6,6,8,19,22,-3,24
FK Rubin,5619,8,5,6,9,22,20,2,21
Rostov,5619,9,4,6,10,12,21,-9,18
Amkar,5619,10,4,4,12,10,26,-16,16
Anzhi,5619,11,2,6,12,16,40,-24,12
Loko Moscow,5620,1,12,5,3,32,13,19,41
CSKA Moscow,5620,2,11,3,6,28,18,10,36
Zenit,5620,3,8,8,4,22,15,7,32
Krasnodar,5620,4,9,5,6,30,26,4,32
Terek Grozny,5620,5,9,5,6,25,23,2,32
Spart Moscow,5620,6,8,6,6,34,29,5,30
FK Rubin,5620,7,6,6,8,23,18,5,24
Din Moscow,5620,8,6,6,8,19,23,-4,24
Rostov,5620,9,5,6,9,12,17,-5,21
Amkar,5620,10,4,5,11,9,23,-14,17
Anzhi,5620,11,2,5,13,15,44,-29,11
Loko Moscow,5621,1,11,7,2,31,13,18,40
CSKA Moscow,5621,2,12,3,5,29,19,10,39
Spart Moscow,5621,3,9,6,5,36,27,9,33
Zenit,5621,4,7,9,4,22,15,7,30
Terek Grozny,5621,5,8,6,6,22,23,-1,30
Krasnodar,5621,6,8,5,7,30,30,0,29
Din Moscow,5621,7,6,6,8,18,23,-5,24
FK Rubin,5621,8,6,5,9,25,19,6,23
Amkar,5621,9,5,5,10,10,22,-12,20
Rostov,5621,10,4,7,9,11,18,-7,19
Anzhi,5621,11,2,5,13,16,41,-25,11
Loko Moscow,5622,1,11,6,3,33,16,17,39
Spart Moscow,5622,2,10,5,5,37,28,9,35
CSKA Moscow,5622,3,10,5,5,27,19,8,35
Zenit,5622,4,7,10,3,22,14,8,31
Krasnodar,5622,5,9,4,7,31,28,3,31
Terek Grozny,5622,6,8,5,7,22,24,-2,29
FK Rubin,5622,7,7,5,8,25,18,7,26
Rostov,5622,8,5,6,9,12,18,-6,21
Din Moscow,5622,9,5,6,9,19,26,-7,21
Amkar,5622,10,5,4,11,10,23,-13,19
Anzhi,5622,11,2,6,12,17,41,-24,12
Loko Moscow,5623,1,13,5,2,34,13,21,44
CSKA Moscow,5623,2,11,3,6,28,19,9,36
Zenit,5623,3,8,8,4,25,16,9,32
Spart Moscow,5623,4,9,5,6,35,28,7,32
Krasnodar,5623,5,8,5,7,28,27,1,29
Terek Grozny,5623,6,8,5,7,22,23,-1,29
FK Rubin,5623,7,5,7,8,22,18,4,22
Din Moscow,5623,8,5,7,8,17,23,-6,22
Amkar,5623,9,6,4,10,12,22,-10,22
Rostov,5623,10,5,6,9,11,17,-6,21
Anzhi,5623,11,2,5,13,14,42,-28,11
Loko Moscow,5624,1,13,5,2,34,13,21,44
Spart Moscow,5624,2,10,5,5,39,30,9,35
CSKA Moscow,5624,3,10,3,7,27,21,6,33
Zenit,5624,4,8,8,4,24,16,8,32
Krasnodar,5624,5,8,5,7,28,27,1,29
Terek Grozny,5624,6,7,5,8,20,25,-5,26
Din Moscow,5624,7,6,7,7,22,25,-3,25
FK Rubin,5624,8,5,7,8,23,19,4,22
Amkar,5624,9,5,4,11,12,24,-12,19
Rostov,5624,10,4,6,10,11,19,-8,18
Anzhi,5624,11,4,5,11,17,38,-21,17
Loko Moscow,5625,1,11,6,3,30,13,17,39
CSKA Moscow,5625,2,11,4,5,29,17,12,37
Krasnodar,5625,3,10,4,6,30,25,5,34
Spart Moscow,5625,4,9,5,6,36,28,8,32
Zenit,5625,5,7,10,3,22,14,8,31
Terek Grozny,5625,6,8,6,6,22,23,-1,30
Din Moscow,5625,7,6,7,7,19,22,-3,25
FK Rubin,5625,8,5,6,9,22,19,3,21
Rostov,5625,9,5,6,9,11,17,-6,21
Amkar,5625,10,4,5,11,10,25,-15,17
Anzhi,5625,11,2,5,13,14,42,-28,11
Loko Moscow,5626,1,12,6,2,33,12,21,42
CSKA Moscow,5626,2,12,3,5,29,17,12,39
Spart Moscow,5626,3,10,6,4,39,28,11,36
Krasnodar,5626,4,9,5,6,31,26,5,32
Terek Grozny,5626,5,8,6,6,25,25,0,30
Zenit,5626,6,7,8,5,21,17,4,29
Din Moscow,5626,7,6,6,8,21,23,-2,24
FK Rubin,5626,8,5,5,10,22,23,-1,20
Rostov,5626,9,4,7,9,11,18,-7,19
Amkar,5626,10,4,5,11,11,26,-15,17
Anzhi,5626,11,2,5,13,16,44,-28,11
Loko Moscow,5627,1,12,6,2,32,13,19,42
CSKA Moscow,5627,2,12,3,5,29,17,12,39
Krasnodar,5627,3,9,5,6,31,26,5,32
Terek Grozny,5627,4,9,5,6,22,22,0,32
Spart Moscow,5627,5,8,7,5,37,31,6,31
Zenit,5627,6,7,8,5,22,16,6,29
Din Moscow,5627,7,7,6,7,22,23,-1,27
FK Rubin,5627,8,5,5,10,23,22,1,20
Rostov,5627,9,4,7,9,11,18,-7,19
Amkar,5627,10,4,5,11,11,25,-14,17
Anzhi,5627,11,2,5,13,14,41,-27,11
Loko Moscow,5628,1,11,5,4,29,15,14,38
CSKA Moscow,5628,2,11,3,6,32,22,10,36
Zenit,5628,3,9,8,3,27,14,13,35
Krasnodar,5628,4,9,5,6,30,25,5,32
Spart Moscow,5628,5,8,7,5,37,30,7,31
Terek Grozny,5628,6,7,6,7,20,23,-3,27
FK Rubin,5628,7,6,6,8,23,18,5,24
Din Moscow,5628,8,5,7,8,19,24,-5,22
Rostov,5628,9,5,6,9,13,19,-6,21
Amkar,5628,10,4,6,10,9,22,-13,18
Anzhi,5628,11,3,5,12,16,43,-27,14
Loko Moscow,5629,1,12,6,2,31,11,20,42
CSKA Moscow,5629,2,11,4,5,29,18,11,37
Spart Moscow,5629,3,9,6,5,40,28,12,33
Terek Grozny,5629,4,9,5,6,24,24,0,32
Zenit,5629,5,7,9,4,22,16,6,30
Krasnodar,5629,6,8,5,7,27,25,2,29
Din Moscow,5629,7,7,6,7,22,23,-1,27
FK Rubin,5629,8,6,5,9,23,20,3,23
Rostov,5629,9,4,6,10,10,22,-12,18
Amkar,5629,10,4,5,11,12,26,-14,17
Anzhi,5629,11,2,5,13,14,41,-27,11
Loko Moscow,5630,1,12,5,3,31,14,17,41
CSKA Moscow,5630,2,11,3,6,28,19,9,36
Zenit,5630,3,9,8,3,24,13,11,35
Spart Moscow,5630,4,9,6,5,36,27,9,33
Krasnodar,5630,5,9,4,7,32,27,5,31
Terek Grozny,5630,6,8,6,6,25,23,2,30
Din Moscow,5630,7,6,6,8,19,24,-5,24
FK Rubin,5630,8,6,5,9,25,22,3,23
Rostov,5630,9,4,6,10,10,19,-9,18
Amkar,5630,10,4,5,11,10,27,-17,17
Anzhi,5630,11,2,6,12,16,41,-25,12
Loko Moscow,5631,1,12,6,2,32,13,19,42
Spart Moscow,5631,2,11,5,4,37,26,11,38
CSKA Moscow,5631,3,11,3,6,27,18,9,36
Zenit,5631,4,8,8,4,23,15,8,32
Krasnodar,5631,5,9,5,6,30,26,4,32
Terek Grozny,5631,6,8,5,7,22,24,-2,29
FK Rubin,5631,7,6,5,9,23,19,4,23
Din Moscow,5631,8,5,6,9,17,23,-6,21
Rostov,5631,9,4,6,10,10,18,-8,18
Amkar,5631,10,4,4,12,10,25,-15,16
Anzhi,5631,11,3,5,12,16,40,-24,14
Loko Moscow,5632,1,13,5,2,32,12,20,44
CSKA Moscow,5632,2,11,3,6,27,18,9,36
Zenit,5632,3,8,8,4,23,15,8,32
Spart Moscow,5632,4,8,6,6,34,29,5,30
Terek Grozny,5632,5,8,6,6,23,23,0,30
Krasnodar,5632,6,8,4,8,27,27,0,28
FK Rubin,5632,7,7,5,8,24,17,7,26
Din Moscow,5632,8,6,6,8,19,22,-3,24
Rostov,5632,9,4,7,9,11,18,-7,19
Amkar,5632,10,5,4,11,10,24,-14,19
Anzhi,5632,11,2,6,12,15,40,-25,12
Loko Moscow,5633,1,11,6,3,31,15,16,39
CSKA Moscow,5633,2,12,3,5,30,19,11,39
Spart Moscow,5633,3,11,5,4,38,25,13,38
Zenit,5633,4,8,8,4,25,17,8,32
Krasnodar,5633,5,8,5,7,30,28,2,29
Terek Grozny,5633,6,7,6,7,21,26,-5,27
FK Rubin,5633,7,6,6,8,24,19,5,24
Din Moscow,5633,8,5,7,8,18,24,-6,22
Amkar,5633,9,5,4,11,13,24,-11,19
Rostov,5633,10,4,6,10,10,19,-9,18
Anzhi,5633,11,2,6,12,14,38,-24,12
Loko Moscow,5634,1,12,5,3,32,13,19,41
CSKA Moscow,5634,2,11,4,5,27,17,10,37
Spart Moscow,5634,3,10,6,4,36,25,11,36
Krasnodar,5634,4,9,5,6,29,25,4,32
Zenit,5634,5,7,9,4,22,16,6,30
Terek Grozny,5634,6,7,5,8,22,26,-4,26
FK Rubin,5634,7,6,6,8,23,18,5,24
Din Moscow,5634,8,5,7,8,17,22,-5,22
Amkar,5634,9,5,4,11,11,24,-13,19
Rostov,5634,10,4,6,10,10,19,-9,18
Anzhi,5634,11,3,5,12,16,40,-24,14
Loko Moscow,5635,1,13,5,2,31,11,20,44
CSKA Moscow,5635,2,11,4,5,29,17,12,37
Spart Moscow,5635,3,10,6,4,43,30,13,36
Krasnodar,5635,4,9,4,7,30,26,4,31
Zenit,5635,5,7,9,4,21,14,7,30
Terek Grozny,5635,6,7,6,7,22,25,-3,27
Din Moscow,5635,7,5,8,7,19,23,-4,23
FK Rubin,5635,8,5,6,9,22,20,2,21
Amkar,5635,9,5,4,11,12,27,-15,19
Rostov,5635,10,4,6,10,12,21,-9,18
Anzhi,5635,11,2,6,12,15,42,-27,12
Loko Moscow,5636,1,12,5,3,31,14,17,41
Spart Moscow,5636,2,11,5,4,38,26,12,38
CSKA Moscow,5636,3,11,3,6,28,20,8,36
Krasnodar,5636,4,10,4,6,34,25,9,34
Zenit,5636,5,7,8,5,21,16,5,29
Terek Grozny,5636,6,8,5,7,22,24,-2,29
Din Moscow,5636,7,6,6,8,19,23,-4,24
FK Rubin,5636,8,5,5,10,23,23,0,20
Rostov,5636,9,4,6,10,11,19,-8,18
Anzhi,5636,10,4,5,11,18,39,-21,17
Amkar,5636,11,4,4,12,10,26,-16,16
Loko Moscow,5637,1,12,6,2,31,12,19,42
CSKA Moscow,5637,2,10,5,5,28,20,8,35
Zenit,5637,3,7,9,4,23,16,7,30
Spart Moscow,5637,4,8,6,6,34,29,5,30
Krasnodar,5637,5,8,5,7,27,26,1,29
Terek Grozny,5637,6,7,7,6,21,23,-2,28
Din Moscow,5637,7,6,7,7,19,22,-3,25
FK Rubin,5637,8,6,6,8,23,17,6,24
Amkar,5637,9,5,5,10,12,23,-11,20
Rostov,5637,10,4,7,9,10,17,-7,19
Anzhi,5637,11,2,7,11,16,39,-23,13
Loko Moscow,5638,1,12,6,2,33,13,20,42
CSKA Moscow,5638,2,10,4,6,26,19,7,34
Spart Moscow,5638,3,9,6,5,41,29,12,33
Zenit,5638,4,8,9,3,24,15,9,33
Krasnodar,5638,5,8,4,8,29,29,0,28
Terek Grozny,5638,6,7,6,7,21,26,-5,27
FK Rubin,5638,7,6,6,8,24,19,5,24
Din Moscow,5638,8,5,7,8,18,27,-9,22
Amkar,5638,9,5,5,10,11,23,-12,20
Rostov,5638,10,4,7,9,13,20,-7,19
Anzhi,5638,11,3,6,11,17,37,-20,15
Loko Moscow,5639,1,11,7,2,34,16,18,40
CSKA Moscow,5639,2,11,4,5,30,17,13,37
Krasnodar,5639,3,9,5,6,32,27,5,32
Zenit,5639,4,7,10,3,25,17,8,31
Spart Moscow,5639,5,8,5,7,36,32,4,29
Terek Grozny,5639,6,7,6,7,20,24,-4,27
Din Moscow,5639,7,6,7,7,19,22,-3,25
FK Rubin,5639,8,5,6,9,24,22,2,21
Rostov,5639,9,5,6,9,14,19,-5,21
Amkar,5639,10,5,5,10,11,23,-12,20
Anzhi,5639,11,3,5,12,16,42,-26,14
Loko Moscow,5640,1,11,6,3,30,13,17,39
CSKA Moscow,5640,2,11,4,5,32,20,12,37
Spart Moscow,5640,3,10,5,5,40,28,12,35
Zenit,5640,4,8,9,3,24,15,9,33
Krasnodar,5640,5,8,5,7,29,29,0,29
Terek Grozny,5640,6,7,6,7,22,25,-3,27
FK Rubin,5640,7,7,5,8,26,18,8,26
Amkar,5640,8,6,4,10,11,22,-11,22
Din Moscow,5640,9,5,6,9,18,25,-7,21
Rostov,5640,10,4,6,10,11,21,-10,18
Anzhi,5640,11,2,6,12,17,44,-27,12
Loko Moscow,5641,1,12,6,2,32,13,19,42
Spart Moscow,5641,2,10,6,4,40,27,13,36
CSKA Moscow,5641,3,11,3,6,30,20,10,36
Zenit,5641,4,8,8,4,24,16,8,32
Krasnodar,5641,5,9,5,6,31,27,4,32
Terek Grozny,5641,6,8,6,6,25,26,-1,30
Din Moscow,5641,7,6,6,8,20,24,-4,24
FK Rubin,5641,8,5,5,10,23,21,2,20
Rostov,5641,9,4,6,10,10,21,-11,18
Amkar,5641,10,4,5,11,11,25,-14,17
Anzhi,5641,11,2,6,12,17,43,-26,12
Loko Moscow,5642,1,12,5,3,30,13,17,41
Spart Moscow,5642,2,11,5,4,39,26,13,38
CSKA Moscow,5642,3,11,3,6,26,18,8,36
Zenit,5642,4,8,8,4,23,14,9,32
Krasnodar,5642,5,9,4,7,30,25,5,31
Terek Grozny,5642,6,7,6,7,20,27,-7,27
FK Rubin,5642,7,6,5,9,23,21,2,23
Din Moscow,5642,8,5,6,9,19,25,-6,21
Amkar,5642,9,5,4,11,14,23,-9,19
Rostov,5642,10,4,6,10,10,20,-10,18
Anzhi,5642,11,3,6,11,15,37,-22,15
Loko Moscow,5643,1,12,5,3,31,13,18,41
CSKA Moscow,5643,2,11,3,6,28,18,10,36
Zenit,5643,3,9,8,3,24,14,10,35
Spart Moscow,5643,4,9,6,5,40,31,9,33
Krasnodar,5643,5,9,4,7,30,27,3,31
Terek Grozny,5643,6,7,7,6,22,24,-2,28
Din Moscow,5643,7,5,8,7,18,22,-4,23
FK Rubin,5643,8,5,6,9,24,21,3,21
Rostov,5643,9,5,6,9,15,20,-5,21
Amkar,5643,10,4,5,11,11,27,-16,17
Anzhi,5643,11,2,6,12,15,41,-26,12
Loko Moscow,5644,1,13,5,2,34,12,22,44
CSKA Moscow,5644,2,12,3,5,32,20,12,39
Spart Moscow,5644,3,10,6,4,40,27,13,36
Zenit,5644,4,7,8,5,22,18,4,29
Krasnodar,5644,5,8,4,8,27,28,-1,28
Terek Grozny,5644,6,7,7,6,20,22,-2,28
FK Rubin,5644,7,6,6,8,23,18,5,24
Din Moscow,5644,8,5,7,8,19,27,-8,22
Rostov,5644,9,4,7,9,10,17,-7,19
Amkar,5644,10,4,5,11,10,24,-14,17
Anzhi,5644,11,2,6,12,17,41,-24,12
Loko Moscow,5645,1,12,6,2,33,14,19,42
CSKA Moscow,5645,2,11,4,5,27,18,9,37
Spart Moscow,5645,3,9,5,6,38,31,7,32
Zenit,5645,4,7,9,4,23,16,7,30
Krasnodar,5645,5,8,5,7,30,28,2,29
Terek Grozny,5645,6,8,5,7,21,23,-2,29
Din Moscow,5645,7,6,6,8,18,22,-4,24
FK Rubin,5645,8,6,5,9,23,19,4,23
Rostov,5645,9,5,6,9,13,19,-6,21
Amkar,5645,10,5,4,11,12,25,-13,19
Anzhi,5645,11,3,5,12,15,38,-23,14
Loko Moscow,5646,1,12,5,3,31,13,18,41
CSKA Moscow,5646,2,11,4,5,26,17,9,37
Krasnodar,5646,3,10,4,6,31,26,5,34
Spart Moscow,5646,4,9,6,5,41,30,11,33
Zenit,5646,5,7,9,4,21,14,7,30
Terek Grozny,5646,6,8,6,6,25,25,0,30
Din Moscow,5646,7,6,6,8,21,27,-6,24
Rostov,5646,8,5,6,9,12,18,-6,21
FK Rubin,5646,9,5,5,10,23,22,1,20
Amkar,5646,10,4,5,11,13,28,-15,17
Anzhi,5646,11,2,6,12,15,39,-24,12
Loko Moscow,5647,1,11,5,4,30,14,16,38
CSKA Moscow,5647,2,11,4,5,29,18,11,37
Spart Moscow,5647,3,10,5,5,37,27,10,35
Zenit,5647,4,8,9,3,23,14,9,33
Krasnodar,5647,5,9,5,6,29,25,4,32
Terek Grozny,5647,6,7,6,7,22,27,-5,27
FK Rubin,5647,7,6,6,8,24,18,6,24
Amkar,5647,8,6,4,10,13,22,-9,22
Din Moscow,5647,9,5,6,9,19,26,-7,21
Rostov,5647,10,4,6,10,10,19,-9,18
Anzhi,5647,11,2,6,12,16,42,-26,12
Loko Moscow,5648,1,11,6,3,31,14,17,39
Spart Moscow,5648,2,10,6,4,37,27,10,36
Zenit,5648,3,9,8,3,25,15,10,35
CSKA Moscow,5648,4,10,3,7,26,20,6,33
Krasnodar,5648,5,8,5,7,29,27,2,29
Terek Grozny,5648,6,7,7,6,21,23,-2,28
Din Moscow,5648,7,6,7,7,20,23,-3,25
FK Rubin,5648,8,6,5,9,24,20,4,23
Rostov,5648,9,4,6,10,10,18,-8,18
Amkar,5648,10,4,5,11,10,24,-14,17
Anzhi,5648,11,3,6,11,16,38,-22,15
Loko Moscow,5649,1,11,6,3,32,15,17,39
Spart Moscow,5649,2,10,5,5,38,27,11,35
CSKA Moscow,5649,3,10,4,6,26,19,7,34
Zenit,5649,4,8,9,3,23,14,9,33
Krasnodar,5649,5,9,5,6,31,27,4,32
Terek Grozny,5649,6,8,6,6,21,22,-1,30
Din Moscow,5649,7,6,6,8,18,22,-4,24
FK Rubin,5649,8,5,6,9,22,19,3,21
Amkar,5649,9,5,5,10,11,23,-12,20
Rostov,5649,10,4,6,10,10,20,-10,18
Anzhi,5649,11,2,6,12,15,39,-24,12
Loko Moscow,5650,1,11,6,3,30,13,17,39
CSKA Moscow,5650,2,12,3,5,27,17,10,39
Spart Moscow,5650,3,9,6,5,37,26,11,33
Zenit,5650,4,8,8,4,22,14,8,32
Terek Grozny,5650,5,8,6,6,23,23,0,30
Krasnodar,5650,6,8,5,7,29,27,2,29
FK Rubin,5650,7,6,6,8,25,20,5,24
Din Moscow,5650,8,5,7,8,19,27,-8,22
Amkar,5650,9,5,5,10,11,23,-12,20
Rostov,5650,10,4,7,9,10,17,-7,19
Anzhi,5650,11,2,5,13,14,40,-26,11
Loko Moscow,5651,1,12,5,3,33,13,20,41
CSKA Moscow,5651,2,11,4,5,29,17,12,37
Krasnodar,5651,3,10,4,6,31,26,5,34
Spart Moscow,5651,4,9,6,5,36,28,8,33
Zenit,5651,5,7,9,4,21,16,5,30
Terek Grozny,5651,6,8,5,7,21,24,-3,29
Din Moscow,5651,7,5,7,8,18,23,-5,22
Amkar,5651,8,6,4,10,12,22,-10,22
FK Rubin,5651,9,5,6,9,22,19,3,21
Rostov,5651,10,4,7,9,11,18,-7,19
Anzhi,5651,11,2,5,13,14,42,-28,11
Loko Moscow,5652,1,13,5,2,38,11,27,44
Spart Moscow,5652,2,10,6,4,37,27,10,36
CSKA Moscow,5652,3,11,3,6,29,20,9,36
Zenit,5652,4,8,8,4,23,18,5,32
Terek Grozny,5652,5,9,5,6,23,22,1,32
Krasnodar,5652,6,9,4,7,29,28,1,31
Din Moscow,5652,7,6,6,8,20,24,-4,24
FK Rubin,5652,8,5,5,10,22,21,1,20
Rostov,5652,9,4,6,10,10,18,-8,18
Amkar,5652,10,4,5,11,10,24,-14,17
Anzhi,5652,11,2,5,13,15,43,-28,11
Loko Moscow,5653,1,11,6,3,31,16,15,39
Krasnodar,5653,2,10,4,6,36,25,11,34
CSKA Moscow,5653,3,10,4,6,25,18,7,34
Zenit,5653,4,7,10,3,22,14,8,31
Spart Moscow,5653,5,8,7,5,35,29,6,31
Terek Grozny,5653,6,8,6,6,24,25,-1,30
Din Moscow,5653,7,6,6,8,20,23,-3,24
FK Rubin,5653,8,6,5,9,23,23,0,23
Rostov,5653,9,4,7,9,11,18,-7,19
Amkar,5653,10,4,6,10,11,24,-13,18
Anzhi,5653,11,3,5,12,17,40,-23,14
Loko Moscow,5654,1,12,5,3,31,12,19,41
CSKA Moscow,5654,2,11,3,6,28,20,8,36
Zenit,5654,3,9,8,3,25,13,12,35
Spart Moscow,5654,4,10,5,5,41,30,11,35
Terek Grozny,5654,5,8,5,7,23,25,-2,29
Krasnodar,5654,6,8,4,8,27,27,0,28
FK Rubin,5654,7,7,5,8,25,17,8,26
Amkar,5654,8,6,4,10,14,24,-10,22
Din Moscow,5654,9,5,6,9,18,27,-9,21
Rostov,5654,10,4,6,10,12,21,-9,18
Anzhi,5654,11,2,5,13,14,42,-28,11
CSKA Moscow,5655,1,12,3,5,29,19,10,39
Loko Moscow,5655,2,11,5,4,30,18,12,38
Spart Moscow,5655,3,9,7,4,37,27,10,34
Zenit,5655,4,8,8,4,26,16,10,32
Krasnodar,5655,5,9,4,7,30,26,4,31
Terek Grozny,5655,6,8,6,6,22,23,-1,30
FK Rubin,5655,7,7,5,8,25,18,7,26
Din Moscow,5655,8,5,6,9,18,25,-7,21
Rostov,5655,9,4,7,9,11,18,-7,19
Amkar,5655,10,4,6,10,10,23,-13,18
Anzhi,5655,11,2,5,13,16,41,-25,11
Loko Moscow,5656,1,12,6,2,31,12,19,42
CSKA Moscow,5656,2,10,4,6,27,20,7,34
Zenit,5656,3,8,9,3,23,14,9,33
Spart Moscow,5656,4,9,6,5,39,32,7,33
Terek Grozny,5656,5,9,5,6,24,22,2,32
Krasnodar,5656,6,8,5,7,28,26,2,29
Din Moscow,5656,7,6,7,7,22,24,-2,25
FK Rubin,5656,8,5,6,9,23,21,2,21
Rostov,5656,9,5,6,9,13,18,-5,21
Amkar,5656,10,4,4,12,11,26,-15,16
Anzhi,5656,11,2,6,12,16,42,-26,12
Loko Moscow,5657,1,11,6,3,29,14,15,39
CSKA Moscow,5657,2,12,3,5,28,17,11,39
Spart Moscow,5657,3,9,6,5,37,28,9,33
Krasnodar,5657,4,9,5,6,32,26,6,32
Zenit,5657,5,7,9,4,21,15,6,30
Terek Grozny,5657,6,7,6,7,20,23,-3,27
Din Moscow,5657,7,6,7,7,20,23,-3,25
Amkar,5657,8,6,4,10,12,23,-11,22
FK Rubin,5657,9,5,6,9,24,21,3,21
Rostov,5657,10,4,6,10,10,19,-9,18
Anzhi,5657,11,2,6,12,14,38,-24,12
Loko Moscow,5658,1,12,6,2,33,13,20,42
CSKA Moscow,5658,2,12,3,5,30,19,11,39
Spart Moscow,5658,3,9,6,5,35,27,8,33
Zenit,5658,4,7,9,4,23,16,7,30
Krasnodar,5658,5,8,4,8,29,29,0,28
Terek Grozny,5658,6,7,6,7,21,24,-3,27
FK Rubin,5658,7,7,5,8,25,18,7,26
Din Moscow,5658,8,5,7,8,18,24,-6,22
Rostov,5658,9,5,6,9,11,17,-6,21
Amkar,5658,10,4,5,11,9,23,-14,17
Anzhi,5658,11,3,5,12,17,41,-24,14
Loko Moscow,5659,1,12,6,2,32,12,20,42
CSKA Moscow,5659,2,10,5,5,27,19,8,35
Spart Moscow,5659,3,9,5,6,35,28,7,32
Zenit,5659,4,7,10,3,22,14,8,31
Terek Grozny,5659,5,8,6,6,23,24,-1,30
Krasnodar,5659,6,8,5,7,29,28,1,29
FK Rubin,5659,7,5,7,8,22,18,4,22
Din Moscow,5659,8,5,7,8,18,23,-5,22
Rostov,5659,9,5,6,9,11,17,-6,21
Amkar,5659,10,5,5,10,11,23,-12,20
Anzhi,5659,11,2,6,12,16,40,-24,12
Loko Moscow,5660,1,12,5,3,33,15,18,41
CSKA Moscow,5660,2,11,3,6,29,19,10,36
Krasnodar,5660,3,10,4,6,31,26,5,34
Spart Moscow,5660,4,9,6,5,36,29,7,33
Zenit,5660,5,8,8,4,23,15,8,32
Terek Grozny,5660,6,7,5,8,22,28,-6,26
Din Moscow,5660,7,5,7,8,20,25,-5,22
Amkar,5660,8,6,4,10,14,23,-9,22
FK Rubin,5660,9,5,6,9,22,19,3,21
Rostov,5660,10,4,7,9,10,17,-7,19
Anzhi,5660,11,3,5,12,18,42,-24,14
CSKA Moscow,5661,1,12,3,5,30,17,13,39
Loko Moscow,5661,2,11,5,4,31,17,14,38
Krasnodar,5661,3,10,4,6,31,26,5,34
Spart Moscow,5661,4,9,6,5,34,26,8,33
Zenit,5661,5,8,8,4,24,16,8,32
Terek Grozny,5661,6,8,5,7,24,24,0,29
Din Moscow,5661,7,6,6,8,18,22,-4,24
Amkar,5661,8,6,4,10,12,23,-11,22
FK Rubin,5661,9,5,5,10,21,19,2,20
Rostov,5661,10,4,7,9,10,17,-7,19
Anzhi,5661,11,2,5,13,14,42,-28,11
Loko Moscow,5662,1,13,5,2,32,11,21,44
Spart Moscow,5662,2,10,6,4,38,26,12,36
CSKA Moscow,5662,3,11,3,6,28,20,8,36
Zenit,5662,4,8,8,4,24,16,8,32
Krasnodar,5662,5,8,5,7,28,26,2,29
Terek Grozny,5662,6,7,5,8,20,25,-5,26
FK Rubin,5662,7,5,7,8,23,19,4,22
Din Moscow,5662,8,5,7,8,18,25,-7,22
Amkar,5662,9,5,5,10,11,23,-12,20
Rostov,5662,10,4,6,10,10,18,-8,18
Anzhi,5662,11,3,5,12,16,39,-23,14
Loko Moscow,5663,1,11,6,3,32,15,17,39
CSKA Moscow,5663,2,11,3,6,27,20,7,36
Zenit,5663,3,9,8,3,25,14,11,35
Spart Moscow,5663,4,9,6,5,37,30,7,33
Krasnodar,5663,5,9,5,6,31,26,5,32
Terek Grozny,5663,6,8,5,7,24,26,-2,29
Din Moscow,5663,7,7,6,7,23,22,1,27
FK Rubin,5663,8,5,5,10,21,22,-1,20
Rostov,5663,9,4,7,9,11,18,-7,19
Amkar,5663,10,5,4,11,13,24,-11,19
Anzhi,5663,11,2,5,13,16,43,-27,11
Loko Moscow,5664,1,12,6,2,30,11,19,42
CSKA Moscow,5664,2,11,3,6,27,21,6,36
Spart Moscow,5664,3,9,7,4,39,28,11,34
Zenit,5664,4,8,9,3,25,13,12,33
Krasnodar,5664,5,9,4,7,29,26,3,31
Terek Grozny,5664,6,8,5,7,24,24,0,29
FK Rubin,5664,7,6,5,9,24,19,5,23
Din Moscow,5664,8,5,6,9,19,28,-9,21
Rostov,5664,9,4,7,9,10,17,-7,19
Amkar,5664,10,4,5,11,10,26,-16,17
Anzhi,5664,11,3,5,12,16,40,-24,14
Loko Moscow,5665,1,13,5,2,33,12,21,44
CSKA Moscow,5665,2,12,3,5,28,18,10,39
Spart Moscow,5665,3,8,7,5,39,32,7,31
Krasnodar,5665,4,9,4,7,32,26,6,31
Terek Grozny,5665,5,8,6,6,22,23,-1,30
Zenit,5665,6,7,8,5,21,16,5,29
Din Moscow,5665,7,6,7,7,23,24,-1,25
Rostov,5665,8,5,6,9,12,18,-6,21
FK Rubin,5665,9,5,5,10,21,24,-3,20
Amkar,5665,10,4,6,10,12,25,-13,18
Anzhi,5665,11,2,5,13,15,40,-25,11
Loko Moscow,5666,1,12,6,2,32,11,21,42
CSKA Moscow,5666,2,12,3,5,31,19,12,39
Spart Moscow,5666,3,10,6,4,39,27,12,36
Krasnodar,5666,4,9,5,6,29,24,5,32
Zenit,5666,5,7,8,5,22,19,3,29
Terek Grozny,5666,6,7,6,7,20,23,-3,27
FK Rubin,5666,7,6,5,9,22,19,3,23
Din Moscow,5666,8,5,6,9,19,27,-8,21
Rostov,5666,9,4,6,10,10,18,-8,18
Amkar,5666,10,4,6,10,9,22,-13,18
Anzhi,5666,11,3,5,12,16,40,-24,14
Loko Moscow,5667,1,12,6,2,33,14,19,42
CSKA Moscow,5667,2,11,4,5,26,17,9,37
Zenit,5667,3,7,10,3,22,14,8,31
Spart Moscow,5667,4,8,6,6,35,29,6,30
Krasnodar,5667,5,8,5,7,30,28,2,29
Terek Grozny,5667,6,7,7,6,22,24,-2,28
FK Rubin,5667,7,6,6,8,23,18,5,24
Din Moscow,5667,8,5,7,8,19,24,-5,22
Rostov,5667,9,5,6,9,11,17,-6,21
Amkar,5667,10,5,5,10,11,23,-12,20
Anzhi,5667,11,2,6,12,15,39,-24,12
Loko Moscow,5668,1,11,6,3,29,14,15,39
CSKA Moscow,5668,2,11,3,6,29,20,9,36
Krasnodar,5668,3,10,4,6,31,24,7,34
Zenit,5668,4,8,9,3,23,14,9,33
Spart Moscow,5668,5,8,8,4,36,28,8,32
Terek Grozny,5668,6,7,6,7,23,30,-7,27
Din Moscow,5668,7,6,7,7,21,22,-1,25
FK Rubin,5668,8,5,5,10,21,21,0,20
Rostov,5668,9,4,7,9,10,17,-7,19
Amkar,5668,10,4,6,10,12,25,-13,18
Anzhi,5668,11,3,5,12,22,42,-20,14
Loko Moscow,5669,1,11,5,4,30,14,16,38
CSKA Moscow,5669,2,11,3,6,28,18,10,36
Zenit,5669,3,9,8,3,23,13,10,35
Spart Moscow,5669,4,9,7,4,40,29,11,34
Krasnodar,5669,5,9,5,6,31,27,4,32
Terek Grozny,5669,6,7,7,6,22,24,-2,28
FK Rubin,5669,7,6,6,8,25,19,6,24
Din Moscow,5669,8,5,7,8,19,25,-6,22
Rostov,5669,9,4,6,10,10,20,-10,18
Amkar,5669,10,4,6,10,12,25,-13,18
Anzhi,5669,11,2,6,12,15,41,-26,12
Loko Moscow,5670,1,12,6,2,32,13,19,42
CSKA Moscow,5670,2,11,4,5,30,20,10,37
Spart Moscow,5670,3,10,5,5,37,28,9,35
Zenit,5670,4,7,10,3,24,16,8,31
Krasnodar,5670,5,8,5,7,28,26,2,29
Terek Grozny,5670,6,8,5,7,21,25,-4,29
Din Moscow,5670,7,7,6,7,23,21,2,27
FK Rubin,5670,8,5,6,9,21,20,1,21
Amkar,5670,9,5,4,11,12,24,-12,19
Rostov,5670,10,4,6,10,10,19,-9,18
Anzhi,5670,11,2,5,13,15,41,-26,11
Loko Moscow,5671,1,11,7,2,30,12,18,40
Spart Moscow,5671,2,11,5,4,38,26,12,38
CSKA Moscow,5671,3,11,4,5,28,19,9,37
Zenit,5671,4,7,9,4,23,16,7,30
Krasnodar,5671,5,8,6,6,29,26,3,30
Terek Grozny,5671,6,8,6,6,22,22,0,30
FK Rubin,5671,7,6,6,8,24,19,5,24
Din Moscow,5671,8,5,6,9,19,25,-6,21
Rostov,5671,9,4,6,10,10,19,-9,18
Amkar,5671,10,4,5,11,9,23,-14,17
Anzhi,5671,11,2,6,12,14,39,-25,12
Loko Moscow,5672,1,11,6,3,29,13,16,39
Spart Moscow,5672,2,10,5,5,40,27,13,35
CSKA Moscow,5672,3,10,5,5,26,18,8,35
Krasnodar,5672,4,10,4,6,32,25,7,34
Terek Grozny,5672,5,9,5,6,26,24,2,32
Zenit,5672,6,7,10,3,22,14,8,31
Din Moscow,5672,7,6,6,8,18,22,-4,24
FK Rubin,5672,8,6,5,9,23,20,3,23
Rostov,5672,9,4,6,10,11,20,-9,18
Amkar,5672,10,4,4,12,11,30,-19,16
Anzhi,5672,11,2,6,12,14,39,-25,12
Loko Moscow,5673,1,12,6,2,34,15,19,42
CSKA Moscow,5673,2,11,3,6,26,20,6,36
Spart Moscow,5673,3,10,5,5,41,27,14,35
Zenit,5673,4,8,9,3,26,15,11,33
Krasnodar,5673,5,8,5,7,30,28,2,29
Terek Grozny,5673,6,7,6,7,22,25,-3,27
Din Moscow,5673,7,6,6,8,22,28,-6,24
FK Rubin,5673,8,5,6,9,24,23,1,21
Rostov,5673,9,5,6,9,11,17,-6,21
Amkar,5673,10,5,4,11,11,25,-14,19
Anzhi,5673,11,2,6,12,16,40,-24,12
Loko Moscow,5674,1,12,5,3,32,14,18,41
CSKA Moscow,5674,2,10,5,5,26,18,8,35
Spart Moscow,5674,3,9,7,4,36,27,9,34
Krasnodar,5674,4,9,5,6,30,25,5,32
Zenit,5674,5,7,9,4,21,15,6,30
Terek Grozny,5674,6,8,6,6,22,23,-1,30
Din Moscow,5674,7,6,7,7,20,22,-2,25
FK Rubin,5674,8,5,6,9,21,19,2,21
Rostov,5674,9,4,7,9,11,18,-7,19
Amkar,5674,10,4,5,11,9,23,-14,17
Anzhi,5674,11,2,6,12,16,40,-24,12
Loko Moscow,5675,1,11,6,3,31,15,16,39
CSKA Moscow,5675,2,11,4,5,27,18,9,37
Spart Moscow,5675,3,10,5,5,38,28,10,35
Krasnodar,5675,4,9,5,6,31,26,5,32
Zenit,5675,5,7,10,3,22,14,8,31
Terek Grozny,5675,6,8,5,7,25,25,0,29
Din Moscow,5675,7,7,6,7,21,22,-1,27
FK Rubin,5675,8,5,6,9,22,20,2,21
Rostov,5675,9,4,6,10,11,19,-8,18
Amkar,5675,10,4,4,12,10,28,-18,16
Anzhi,5675,11,3,5,12,17,40,-23,14
Loko Moscow,5676,1,12,6,2,31,12,19,42
CSKA Moscow,5676,2,11,4,5,28,18,10,37
Spart Moscow,5676,3,10,5,5,36,27,9,35
Zenit,5676,4,7,9,4,22,16,6,30
Krasnodar,5676,5,8,5,7,28,26,2,29
Terek Grozny,5676,6,8,5,7,22,24,-2,29
Din Moscow,5676,7,6,6,8,20,23,-3,24
Amkar,5676,8,6,4,10,13,22,-9,22
FK Rubin,5676,9,5,6,9,22,21,1,21
Rostov,5676,10,4,6,10,10,18,-8,18
Anzhi,5676,11,2,6,12,15,40,-25,12
Loko Moscow,5677,1,11,6,3,31,16,15,39
Spart Moscow,5677,2,11,5,4,45,27,18,38
CSKA Moscow,5677,3,11,4,5,29,18,11,37
Krasnodar,5677,4,10,4,6,31,24,7,34
Terek Grozny,5677,5,9,5,6,24,23,1,32
Zenit,5677,6,7,10,3,23,15,8,31
Din Moscow,5677,7,6,6,8,20,29,-9,24
FK Rubin,5677,8,5,5,10,21,20,1,20
Rostov,5677,9,4,6,10,11,19,-8,18
Amkar,5677,10,4,4,12,9,26,-17,16
Anzhi,5677,11,2,5,13,16,43,-27,11
Loko Moscow,5678,1,12,5,3,30,12,18,41
CSKA Moscow,5678,2,12,3,5,30,17,13,39
Spart Moscow,5678,3,10,5,5,39,29,10,35
Zenit,5678,4,8,8,4,22,15,7,32
Krasnodar,5678,5,8,5,7,29,27,2,29
Terek Grozny,5678,6,7,6,7,21,24,-3,27
FK Rubin,5678,7,5,7,8,23,19,4,22
Din Moscow,5678,8,5,7,8,17,23,-6,22
Amkar,5678,9,5,5,10,13,23,-10,20
Rostov,5678,10,4,6,10,10,20,-10,18
Anzhi,5678,11,3,5,12,16,41,-25,14
Loko Moscow,5679,1,13,5,2,33,13,20,44
Spart Moscow,5679,2,11,5,4,41,26,15,38
CSKA Moscow,5679,3,10,3,7,29,24,5,33
Zenit,5679,4,8,8,4,28,19,9,32
Krasnodar,5679,5,9,4,7,30,26,4,31
Terek Grozny,5679,6,8,5,7,25,26,-1,29
Din Moscow,5679,7,6,6,8,21,26,-5,24
FK Rubin,5679,8,5,5,10,22,23,-1,20
Amkar,5679,9,5,4,11,12,24,-12,19
Rostov,5679,10,4,6,10,10,19,-9,18
Anzhi,5679,11,3,5,12,17,42,-25,14
Loko Moscow,5680,1,13,5,2,36,13,23,44
CSKA Moscow,5680,2,10,4,6,26,19,7,34
Spart Moscow,5680,3,9,6,5,38,29,9,33
Krasnodar,5680,4,9,4,7,28,28,0,31
Zenit,5680,5,7,9,4,23,16,7,30
Terek Grozny,5680,6,7,6,7,23,26,-3,27
Din Moscow,5680,7,6,7,7,20,23,-3,25
Amkar,5680,8,6,4,10,14,24,-10,22
FK Rubin,5680,9,5,5,10,22,20,2,20
Rostov,5680,10,4,6,10,11,21,-10,18
Anzhi,5680,11,3,6,11,17,39,-22,15
Loko Moscow,5681,1,11,6,3,32,15,17,39
Spart Moscow,5681,2,11,5,4,39,27,12,38
CSKA Moscow,5681,3,11,3,6,27,20,7,36
Zenit,5681,4,9,8,3,25,14,11,35
Krasnodar,5681,5,9,5,6,31,27,4,32
Terek Grozny,5681,6,7,6,7,22,25,-3,27
Din Moscow,5681,7,6,6,8,19,23,-4,24
FK Rubin,5681,8,5,5,10,22,20,2,20
Amkar,5681,9,5,4,11,12,26,-14,19
Rostov,5681,10,4,6,10,10,18,-8,18
Anzhi,5681,11,2,6,12,16,40,-24,12
Loko Moscow,5682,1,12,6,2,32,12,20,42
CSKA Moscow,5682,2,11,4,5,30,19,11,37
Spart Moscow,5682,3,10,6,4,38,27,11,36
Krasnodar,5682,4,9,5,6,31,26,5,32
Zenit,5682,5,7,9,4,22,16,6,30
Terek Grozny,5682,6,8,6,6,21,22,-1,30
Din Moscow,5682,7,6,6,8,19,23,-4,24
FK Rubin,5682,8,5,5,10,22,21,1,20
Rostov,5682,9,4,7,9,11,18,-7,19
Amkar,5682,10,4,4,12,9,25,-16,16
Anzhi,5682,11,2,6,12,15,41,-26,12
Loko Moscow,5683,1,11,6,3,30,13,17,39
CSKA Moscow,5683,2,12,3,5,30,19,11,39
Spart Moscow,5683,3,9,6,5,36,28,8,33
Zenit,5683,4,8,8,4,24,16,8,32
Terek Grozny,5683,5,9,5,6,22,22,0,32
Krasnodar,5683,6,8,5,7,29,27,2,29
FK Rubin,5683,7,6,6,8,23,18,5,24
Din Moscow,5683,8,5,7,8,18,23,-5,22
Rostov,5683,9,4,7,9,11,18,-7,19
Amkar,5683,10,5,4,11,10,23,-13,19
Anzhi,5683,11,2,5,13,14,40,-26,11
Loko Moscow,5684,1,12,6,2,31,12,19,42
CSKA Moscow,5684,2,11,3,6,29,18,11,36
Zenit,5684,3,8,9,3,22,13,9,33
Spart Moscow,5684,4,8,7,5,34,29,5,31
Krasnodar,5684,5,9,4,7,30,27,3,31
Terek Grozny,5684,6,7,6,7,21,25,-4,27
Din Moscow,5684,7,6,7,7,20,22,-2,25
FK Rubin,5684,8,5,5,10,22,21,1,20
Amkar,5684,9,5,5,10,12,22,-10,20
Rostov,5684,10,4,7,9,10,17,-7,19
Anzhi,5684,11,3,5,12,17,42,-25,14
Loko Moscow,5685,1,13,5,2,32,11,21,44
CSKA Moscow,5685,2,11,4,5,29,19,10,37
Spart Moscow,5685,3,10,5,5,39,27,12,35
Krasnodar,5685,4,9,4,7,28,25,3,31
Zenit,5685,5,7,9,4,22,16,6,30
Terek Grozny,5685,6,8,5,7,21,24,-3,29
FK Rubin,5685,7,6,5,9,22,18,4,23
Amkar,5685,8,6,4,10,12,22,-10,22
Din Moscow,5685,9,5,6,9,17,24,-7,21
Rostov,5685,10,4,6,10,11,21,-10,18
Anzhi,5685,11,2,5,13,15,41,-26,11
Loko Moscow,5686,1,11,7,2,33,15,18,40
CSKA Moscow,5686,2,12,3,5,27,17,10,39
Spart Moscow,5686,3,9,7,4,36,26,10,34
Krasnodar,5686,4,9,5,6,33,27,6,32
Zenit,5686,5,7,9,4,23,16,7,30
Terek Grozny,5686,6,7,7,6,22,24,-2,28
Din Moscow,5686,7,6,6,8,18,23,-5,24
FK Rubin,5686,8,5,5,10,22,22,0,20
Rostov,5686,9,4,7,9,10,17,-7,19
Amkar,5686,10,4,6,10,11,24,-13,18
Anzhi,5686,11,2,6,12,15,39,-24,12
Loko Moscow,5687,1,11,6,3,32,15,17,39
Zenit,5687,2,9,8,3,23,13,10,35
CSKA Moscow,5687,3,10,4,6,26,19,7,34
Spart Moscow,5687,4,9,6,5,38,29,9,33
Krasnodar,5687,5,9,5,6,31,27,4,32
Terek Grozny,5687,6,8,5,7,22,24,-2,29
Din Moscow,5687,7,6,6,8,18,24,-6,24
Rostov,5687,8,5,6,9,12,17,-5,21
FK Rubin,5687,9,5,5,10,21,19,2,20
Amkar,5687,10,5,5,10,12,24,-12,20
Anzhi,5687,11,2,6,12,16,40,-24,12
Loko Moscow,5688,1,11,5,4,31,15,16,38
CSKA Moscow,5688,2,11,3,6,27,19,8,36
Zenit,5688,3,9,8,3,23,13,10,35
Spart Moscow,5688,4,10,5,5,36,28,8,35
Krasnodar,5688,5,9,5,6,30,26,4,32
Terek Grozny,5688,6,7,6,7,20,23,-3,27
FK Rubin,5688,7,6,6,8,23,17,6,24
Rostov,5688,8,5,6,9,12,17,-5,21
Din Moscow,5688,9,5,6,9,18,25,-7,21
Amkar,5688,10,5,4,11,10,23,-13,19
Anzhi,5688,11,2,6,12,15,39,-24,12
Loko Moscow,5689,1,12,5,3,30,12,18,41
Spart Moscow,5689,2,10,6,4,38,28,10,36
CSKA Moscow,5689,3,11,3,6,26,18,8,36
Zenit,5689,4,9,8,3,23,13,10,35
Krasnodar,5689,5,9,4,7,29,25,4,31
Terek Grozny,5689,6,8,6,6,22,23,-1,30
Din Moscow,5689,7,5,7,8,18,23,-5,22
FK Rubin,5689,8,5,6,9,21,19,2,21
Rostov,5689,9,4,7,9,12,19,-7,19
Amkar,5689,10,4,4,12,9,24,-15,16
Anzhi,5689,11,2,6,12,15,39,-24,12
Loko Moscow,5690,1,13,5,2,34,11,23,44
CSKA Moscow,5690,2,11,4,5,28,19,9,37
Spart Moscow,5690,3,9,6,5,37,28,9,33
Terek Grozny,5690,4,8,6,6,22,23,-1,30
Zenit,5690,5,7,8,5,21,16,5,29
Krasnodar,5690,6,8,4,8,27,28,-1,28
FK Rubin,5690,7,7,5,8,23,17,6,26
Din Moscow,5690,8,5,7,8,19,24,-5,22
Amkar,5690,9,5,4,11,10,23,-13,19
Rostov,5690,10,4,6,10,10,19,-9,18
Anzhi,5690,11,2,7,11,17,40,-23,13
Loko Moscow,5691,1,12,5,3,34,15,19,41
Spart Moscow,5691,2,10,6,4,37,25,12,36
CSKA Moscow,5691,3,11,3,6,27,19,8,36
Zenit,5691,4,8,8,4,25,17,8,32
Krasnodar,5691,5,9,4,7,32,27,5,31
Terek Grozny,5691,6,7,5,8,21,25,-4,26
Din Moscow,5691,7,5,7,8,17,24,-7,22
FK Rubin,5691,8,5,6,9,21,21,0,21
Amkar,5691,9,5,5,10,10,22,-12,20
Rostov,5691,10,4,6,10,10,18,-8,18
Anzhi,5691,11,4,5,11,17,38,-21,17
CSKA Moscow,5692,1,12,3,5,27,17,10,39
Loko Moscow,5692,2,11,5,4,29,14,15,38
Zenit,5692,3,8,8,4,23,14,9,32
Krasnodar,5692,4,9,5,6,29,25,4,32
Spart Moscow,5692,5,8,6,6,37,31,6,30
Terek Grozny,5692,6,8,5,7,22,24,-2,29
Din Moscow,5692,7,7,6,7,20,22,-2,27
FK Rubin,5692,8,5,6,9,22,19,3,21
Rostov,5692,9,5,6,9,11,17,-6,21
Amkar,5692,10,4,5,11,13,27,-14,17
Anzhi,5692,11,3,5,12,15,38,-23,14
Loko Moscow,5693,1,11,5,4,30,15,15,38
Spart Moscow,5693,2,10,5,5,41,31,10,35
Zenit,5693,3,9,8,3,24,14,10,35
CSKA Moscow,5693,4,10,4,6,26,19,7,34
Krasnodar,5693,5,9,5,6,31,26,5,32
Terek Grozny,5693,6,8,6,6,23,24,-1,30
FK Rubin,5693,7,6,6,8,24,19,5,24
Din Moscow,5693,8,6,6,8,22,26,-4,24
Rostov,5693,9,4,6,10,11,20,-9,18
Amkar,5693,10,4,4,12,10,25,-15,16
Anzhi,5693,11,2,7,11,16,39,-23,13
Loko Moscow,5694,1,11,6,3,30,14,16,39
CSKA Moscow,5694,2,10,5,5,25,17,8,35
Krasnodar,5694,3,10,4,6,33,26,7,34
Spart Moscow,5694,4,9,6,5,38,31,7,33
Zenit,5694,5,7,10,3,21,13,8,31
Terek Grozny,5694,6,7,6,7,21,26,-5,27
Din Moscow,5694,7,5,8,7,19,23,-4,23
FK Rubin,5694,8,5,6,9,23,21,2,21
Amkar,5694,9,5,5,10,15,25,-10,20
Rostov,5694,10,4,6,10,10,19,-9,18
Anzhi,5694,11,3,6,11,17,37,-20,15
Loko Moscow,5695,1,12,5,3,32,15,17,41
CSKA Moscow,5695,2,11,4,5,29,18,11,37
Spart Moscow,5695,3,10,5,5,37,28,9,35
Krasnodar,5695,4,9,4,7,31,27,4,31
Zenit,5695,5,7,9,4,22,15,7,30
Terek Grozny,5695,6,8,5,7,23,24,-1,29
Din Moscow,5695,7,6,7,7,19,22,-3,25
FK Rubin,5695,8,6,6,8,23,18,5,24
Amkar,5695,9,5,4,11,11,24,-13,19
Rostov,5695,10,4,6,10,11,19,-8,18
Anzhi,5695,11,2,5,13,15,43,-28,11
Loko Moscow,5696,1,12,6,2,34,12,22,42
CSKA Moscow,5696,2,12,3,5,32,19,13,39
Spart Moscow,5696,3,10,5,5,38,28,10,35
Krasnodar,5696,4,8,6,6,30,27,3,30
Zenit,5696,5,7,8,5,23,21,2,29
Din Moscow,5696,6,7,6,7,21,23,-2,27
Terek Grozny,5696,7,7,5,8,20,25,-5,26
FK Rubin,5696,8,5,6,9,23,20,3,21
Amkar,5696,9,5,4,11,11,23,-12,19
Rostov,5696,10,4,6,10,10,19,-9,18
Anzhi,5696,11,3,5,12,15,40,-25,14
Loko Moscow,5697,1,12,6,2,32,13,19,42
CSKA Moscow,5697,2,10,5,5,27,19,8,35
Zenit,5697,3,7,10,3,23,15,8,31
Spart Moscow,5697,4,8,6,6,35,29,6,30
Terek Grozny,5697,5,8,5,7,22,25,-3,29
Krasnodar,5697,6,8,4,8,29,29,0,28
Din Moscow,5697,7,6,7,7,19,21,-2,25
FK Rubin,5697,8,6,5,9,24,20,4,23
Amkar,5697,9,6,4,10,13,23,-10,22
Rostov,5697,10,5,6,9,13,19,-6,21
Anzhi,5697,11,2,6,12,15,39,-24,12
Loko Moscow,5698,1,12,6,2,31,12,19,42
CSKA Moscow,5698,2,11,3,6,28,21,7,36
Spart Moscow,5698,3,10,5,5,37,26,11,35
Zenit,5698,4,8,9,3,24,13,11,33
Krasnodar,5698,5,8,5,7,29,27,2,29
Terek Grozny,5698,6,8,5,7,23,24,-1,29
FK Rubin,5698,7,5,7,8,23,19,4,22
Din Moscow,5698,8,5,7,8,18,24,-6,22
Amkar,5698,9,5,4,11,10,24,-14,19
Rostov,5698,10,4,6,10,10,19,-9,18
Anzhi,5698,11,3,5,12,17,41,-24,14
Loko Moscow,5699,1,11,5,4,31,15,16,38
CSKA Moscow,5699,2,11,4,5,29,18,11,37
Spart Moscow,5699,3,10,5,5,37,27,10,35
Zenit,5699,4,8,9,3,25,16,9,33
Krasnodar,5699,5,9,5,6,28,24,4,32
Terek Grozny,5699,6,7,6,7,21,24,-3,27
Din Moscow,5699,7,6,6,8,19,24,-5,24
FK Rubin,5699,8,5,6,9,21,18,3,21
Rostov,5699,9,5,6,9,11,17,-6,21
Amkar,5699,10,4,5,11,10,24,-14,17
Anzhi,5699,11,3,5,12,15,40,-25,14
Loko Moscow,5700,1,11,6,3,32,15,17,39
Spart Moscow,5700,2,10,6,4,38,27,11,36
CSKA Moscow,5700,3,11,3,6,28,18,10,36
Zenit,5700,4,9,8,3,24,14,10,35
Krasnodar,5700,5,8,6,6,29,26,3,30
Terek Grozny,5700,6,8,6,6,21,22,-1,30
Din Moscow,5700,7,6,6,8,21,26,-5,24
FK Rubin,5700,8,5,6,9,22,19,3,21
Rostov,5700,9,4,6,10,10,18,-8,18
Amkar,5700,10,4,6,10,9,22,-13,18
Anzhi,5700,11,2,5,13,14,41,-27,11
Loko Moscow,5701,1,12,5,3,31,14,17,41
CSKA Moscow,5701,2,12,3,5,30,18,12,39
Zenit,5701,3,8,8,4,24,15,9,32
Spart Moscow,5701,4,8,7,5,33,28,5,31
Krasnodar,5701,5,8,5,7,28,26,2,29
Terek Grozny,5701,6,7,7,6,22,24,-2,28
Din Moscow,5701,7,6,7,7,19,21,-2,25
FK Rubin,5701,8,5,6,9,21,19,2,21
Rostov,5701,9,5,6,9,13,17,-4,21
Amkar,5701,10,4,6,10,10,23,-13,18
Anzhi,5701,11,2,6,12,15,41,-26,12
Loko Moscow,5702,1,11,5,4,29,14,15,38
CSKA Moscow,5702,2,11,3,6,28,19,9,36
Zenit,5702,3,9,8,3,24,13,11,35
Krasnodar,5702,4,10,4,6,29,24,5,34
Spart Moscow,5702,5,8,5,7,36,31,5,29
Terek Grozny,5702,6,8,5,7,23,27,-4,29
Din Moscow,5702,7,7,6,7,23,24,-1,27
Rostov,5702,8,5,6,9,12,18,-6,21
FK Rubin,5702,9,5,5,10,22,21,1,20
Amkar,5702,10,5,4,11,11,24,-13,19
Anzhi,5702,11,3,5,12,19,41,-22,14
Loko Moscow,5703,1,11,7,2,30,12,18,40
CSKA Moscow,5703,2,12,3,5,29,17,12,39
Spart Moscow,5703,3,11,5,4,40,26,14,38
Zenit,5703,4,7,9,4,21,14,7,30
Krasnodar,5703,5,8,5,7,28,26,2,29
Terek Grozny,5703,6,7,7,6,20,22,-2,28
Din Moscow,5703,7,6,6,8,18,23,-5,24
FK Rubin,5703,8,6,5,9,22,18,4,23
Rostov,5703,9,4,6,10,11,21,-10,18
Amkar,5703,10,4,5,11,9,23,-14,17
Anzhi,5703,11,2,6,12,14,40,-26,12
Loko Moscow,5704,1,12,5,3,31,14,17,41
Spart Moscow,5704,2,10,6,4,35,25,10,36
CSKA Moscow,5704,3,11,3,6,28,22,6,36
Zenit,5704,4,8,8,4,25,15,10,32
Terek Grozny,5704,5,9,5,6,27,23,4,32
Krasnodar,5704,6,9,4,7,32,28,4,31
Din Moscow,5704,7,6,7,7,23,23,0,25
FK Rubin,5704,8,6,5,9,26,25,1,23
Rostov,5704,9,4,6,10,10,18,-8,18
Amkar,5704,10,4,4,12,10,26,-16,16
Anzhi,5704,11,2,5,13,15,43,-28,11
Loko Moscow,5705,1,12,6,2,34,14,20,42
CSKA Moscow,5705,2,12,3,5,29,17,12,39
Spart Moscow,5705,3,9,5,6,35,29,6,32
Krasnodar,5705,4,9,5,6,30,26,4,32
Zenit,5705,5,7,8,5,22,19,3,29
Terek Grozny,5705,6,7,6,7,22,25,-3,27
FK Rubin,5705,7,6,5,9,23,19,4,23
Amkar,5705,8,6,4,10,13,24,-11,22
Rostov,5705,9,5,6,9,13,18,-5,21
Din Moscow,5705,10,5,6,9,18,24,-6,21
Anzhi,5705,11,2,6,12,14,38,-24,12
Loko Moscow,5706,1,12,6,2,33,14,19,42
CSKA Moscow,5706,2,11,3,6,27,19,8,36
Spart Moscow,5706,3,9,6,5,38,29,9,33
Zenit,5706,4,8,9,3,23,14,9,33
Terek Grozny,5706,5,9,5,6,27,25,2,32
Krasnodar,5706,6,8,4,8,29,28,1,28
FK Rubin,5706,7,7,5,8,24,18,6,26
Din Moscow,5706,8,5,6,9,19,26,-7,21
Rostov,5706,9,4,7,9,12,19,-7,19
Amkar,5706,10,5,4,11,11,25,-14,19
Anzhi,5706,11,2,5,13,17,43,-26,11
Loko Moscow,5707,1,11,7,2,30,12,18,40
CSKA Moscow,5707,2,11,3,6,27,19,8,36
Zenit,5707,3,8,9,3,22,13,9,33
Spart Moscow,5707,4,9,5,6,36,29,7,32
Krasnodar,5707,5,8,5,7,28,27,1,29
Terek Grozny,5707,6,7,6,7,22,25,-3,27
FK Rubin,5707,7,6,6,8,23,17,6,24
Din Moscow,5707,8,5,7,8,18,23,-5,22
Amkar,5707,9,6,4,10,11,22,-11,22
Rostov,5707,10,5,6,9,12,18,-6,21
Anzhi,5707,11,2,6,12,17,41,-24,12
Loko Moscow,5708,1,12,6,2,31,12,19,42
CSKA Moscow,5708,2,11,3,6,32,19,13,36
Zenit,5708,3,8,8,4,23,15,8,32
Spart Moscow,5708,4,9,5,6,35,30,5,32
Krasnodar,5708,5,8,6,6,29,26,3,30
Terek Grozny,5708,6,8,6,6,22,23,-1,30
Din Moscow,5708,7,7,6,7,20,21,-1,27
FK Rubin,5708,8,5,6,9,22,20,2,21
Rostov,5708,9,5,6,9,14,18,-4,21
Amkar,5708,10,4,5,11,9,23,-14,17
Anzhi,5708,11,2,5,13,15,45,-30,11
Loko Moscow,5709,1,13,5,2,31,11,20,44
Spart Moscow,5709,2,11,5,4,40,26,14,38
CSKA Moscow,5709,3,11,3,6,26,18,8,36
Krasnodar,5709,4,9,4,7,29,25,4,31
Terek Grozny,5709,5,8,6,6,23,23,0,30
Zenit,5709,6,7,8,5,21,15,6,29
FK Rubin,5709,7,6,5,9,23,20,3,23
Din Moscow,5709,8,5,6,9,18,26,-8,21
Rostov,5709,9,4,6,10,11,20,-9,18
Amkar,5709,10,4,5,11,10,24,-14,17
Anzhi,5709,11,3,5,12,15,39,-24,14
Loko Moscow,5710,1,11,7,2,31,13,18,40
CSKA Moscow,5710,2,11,3,6,30,19,11,36
Zenit,5710,3,8,9,3,24,15,9,33
Spart Moscow,5710,4,9,6,5,37,31,6,33
Krasnodar,5710,5,8,5,7,28,26,2,29
Terek Grozny,5710,6,7,7,6,21,23,-2,28
FK Rubin,5710,7,7,5,8,25,18,7,26
Rostov,5710,8,5,6,9,13,17,-4,21
Din Moscow,5710,9,5,6,9,18,25,-7,21
Amkar,5710,10,4,6,10,12,25,-13,18
Anzhi,5710,11,2,6,12,15,42,-27,12
Loko Moscow,5711,1,12,6,2,31,12,19,42
Spart Moscow,5711,2,10,6,4,39,25,14,36
CSKA Moscow,5711,3,11,3,6,28,18,10,36
Zenit,5711,4,8,9,3,22,13,9,33
Terek Grozny,5711,5,9,5,6,24,23,1,32
Krasnodar,5711,6,9,4,7,29,26,3,31
Din Moscow,5711,7,5,7,8,18,26,-8,22
FK Rubin,5711,8,5,6,9,22,19,3,21
Rostov,5711,9,4,7,9,10,17,-7,19
Amkar,5711,10,4,4,12,10,27,-17,16
Anzhi,5711,11,2,5,13,14,41,-27,11
Loko Moscow,5712,1,13,5,2,34,12,22,44
CSKA Moscow,5712,2,11,3,6,31,19,12,36
Zenit,5712,3,8,8,4,23,14,9,32
Spart Moscow,5712,4,9,5,6,34,30,4,32
Krasnodar,5712,5,8,4,8,28,29,-1,28
Din Moscow,5712,6,7,6,7,22,21,1,27
Terek Grozny,5712,7,7,6,7,21,24,-3,27
FK Rubin,5712,8,6,5,9,22,19,3,23
Amkar,5712,9,5,5,10,11,22,-11,20
Rostov,5712,10,4,6,10,10,18,-8,18
Anzhi,5712,11,3,5,12,16,44,-28,14
Loko Moscow,5713,1,12,6,2,30,11,19,42
Spart Moscow,5713,2,10,6,4,41,30,11,36
CSKA Moscow,5713,3,11,3,6,27,18,9,36
Zenit,5713,4,8,8,4,22,14,8,32
Krasnodar,5713,5,9,5,6,29,25,4,32
Terek Grozny,5713,6,9,5,6,23,22,1,32
Din Moscow,5713,7,6,6,8,23,27,-4,24
FK Rubin,5713,8,5,5,10,24,23,1,20
Rostov,5713,9,4,7,9,12,19,-7,19
Amkar,5713,10,4,4,12,10,25,-15,16
Anzhi,5713,11,2,5,13,14,41,-27,11
Loko Moscow,5714,1,12,6,2,32,13,19,42
Spart Moscow,5714,2,10,6,4,37,26,11,36
CSKA Moscow,5714,3,11,3,6,29,18,11,36
Zenit,5714,4,8,9,3,22,13,9,33
Krasnodar,5714,5,9,4,7,31,27,4,31
Terek Grozny,5714,6,8,6,6,22,22,0,30
Din Moscow,5714,7,6,7,7,19,21,-2,25
FK Rubin,5714,8,5,5,10,21,21,0,20
Rostov,5714,9,4,6,10,10,18,-8,18
Amkar,5714,10,4,5,11,10,25,-15,17
Anzhi,5714,11,2,5,13,14,43,-29,11
Loko Moscow,5715,1,13,5,2,33,12,21,44
CSKA Moscow,5715,2,11,4,5,28,19,9,37
Spart Moscow,5715,3,9,5,6,37,29,8,32
Zenit,5715,4,7,9,4,23,16,7,30
Krasnodar,5715,5,8,5,7,29,28,1,29
Terek Grozny,5715,6,7,6,7,21,25,-4,27
FK Rubin,5715,7,6,6,8,24,19,5,24
Din Moscow,5715,8,6,6,8,20,24,-4,24
Amkar,5715,9,6,4,10,13,22,-9,22
Rostov,5715,10,4,6,10,10,20,-10,18
Anzhi,5715,11,2,6,12,15,39,-24,12
Loko Moscow,5716,1,12,6,2,30,11,19,42
CSKA Moscow,5716,2,10,5,5,27,19,8,35
Spart Moscow,5716,3,9,5,6,37,30,7,32
Krasnodar,5716,4,9,5,6,31,25,6,32
Zenit,5716,5,7,9,4,22,15,7,30
Terek Grozny,5716,6,8,5,7,22,25,-3,29
Din Moscow,5716,7,7,6,7,21,23,-2,27
FK Rubin,5716,8,5,5,10,23,23,0,20
Amkar,5716,9,5,4,11,12,24,-12,19
Rostov,5716,10,4,6,10,10,19,-9,18
Anzhi,5716,11,3,6,11,18,39,-21,15
Loko Moscow,5717,1,11,5,4,29,14,15,38
CSKA Moscow,5717,2,11,4,5,27,18,9,37
Zenit,5717,3,8,9,3,24,14,10,33
Spart Moscow,5717,4,9,5,6,34,28,6,32
Krasnodar,5717,5,9,5,6,30,26,4,32
Terek Grozny,5717,6,8,6,6,24,24,0,30
Din Moscow,5717,7,6,7,7,20,22,-2,25
FK Rubin,5717,8,5,7,8,24,20,4,22
Rostov,5717,9,5,6,9,11,17,-6,21
Amkar,5717,10,4,5,11,10,24,-14,17
Anzhi,5717,11,2,5,13,15,41,-26,11
Loko Moscow,5718,1,12,5,3,30,12,18,41
Spart Moscow,5718,2,11,5,4,38,26,12,38
Zenit,5718,3,9,8,3,23,13,10,35
CSKA Moscow,5718,4,10,3,7,27,21,6,33
Krasnodar,5718,5,8,4,8,27,26,1,28
Terek Grozny,5718,6,7,7,6,22,24,-2,28
FK Rubin,5718,7,6,6,8,22,17,5,24
Din Moscow,5718,8,5,7,8,17,23,-6,22
Rostov,5718,9,4,6,10,11,19,-8,18
Amkar,5718,10,4,5,11,9,23,-14,17
Anzhi,5718,11,3,6,11,19,41,-22,15
Loko Moscow,5719,1,13,5,2,35,11,24,44
Spart Moscow,5719,2,10,6,4,38,28,10,36
CSKA Moscow,5719,3,10,4,6,26,19,7,34
Zenit,5719,4,8,8,4,22,15,7,32
Krasnodar,5719,5,8,5,7,28,29,-1,29
Terek Grozny,5719,6,7,5,8,20,27,-7,26
FK Rubin,5719,7,6,6,8,23,18,5,24
Din Moscow,5719,8,5,6,9,17,23,-6,21
Amkar,5719,9,5,5,10,13,24,-11,20
Rostov,5719,10,4,6,10,11,19,-8,18
Anzhi,5719,11,3,6,11,18,38,-20,15
Loko Moscow,5720,1,12,6,2,31,12,19,42
Spart Moscow,5720,2,10,6,4,43,29,14,36
CSKA Moscow,5720,3,11,3,6,28,20,8,36
Zenit,5720,4,8,9,3,24,14,10,33
Terek Grozny,5720,5,8,6,6,23,22,1,30
Krasnodar,5720,6,8,4,8,28,28,0,28
Din Moscow,5720,7,6,6,8,21,25,-4,24
FK Rubin,5720,8,6,5,9,24,20,4,23
Rostov,5720,9,4,7,9,13,20,-7,19
Amkar,5720,10,4,5,11,9,26,-17,17
Anzhi,5720,11,2,5,13,14,42,-28,11
CSKA Moscow,5721,1,12,3,5,28,18,10,39
Loko Moscow,5721,2,11,5,4,29,14,15,38
Spart Moscow,5721,3,9,7,4,36,27,9,34
Krasnodar,5721,4,10,4,6,31,25,6,34
Zenit,5721,5,8,8,4,23,15,8,32
Terek Grozny,5721,6,8,5,7,22,24,-2,29
FK Rubin,5721,7,6,5,9,25,20,5,23
Din Moscow,5721,8,5,7,8,19,25,-6,22
Amkar,5721,9,5,5,10,12,24,-12,20
Rostov,5721,10,4,6,10,10,18,-8,18
Anzhi,5721,11,2,5,13,14,39,-25,11
Loko Moscow,5722,1,12,6,2,31,12,19,42
Spart Moscow,5722,2,10,6,4,42,30,12,36
CSKA Moscow,5722,3,10,3,7,27,23,4,33
Zenit,5722,4,8,8,4,24,15,9,32
Terek Grozny,5722,5,8,6,6,22,22,0,30
Krasnodar,5722,6,8,5,7,28,27,1,29
Din Moscow,5722,7,6,7,7,21,23,-2,25
FK Rubin,5722,8,6,5,9,24,20,4,23
Rostov,5722,9,4,6,10,12,21,-9,18
Amkar,5722,10,4,5,11,11,26,-15,17
Anzhi,5722,11,3,5,12,17,40,-23,14
Loko Moscow,5723,1,13,5,2,32,12,20,44
CSKA Moscow,5723,2,11,4,5,28,19,9,37
Spart Moscow,5723,3,10,5,5,38,28,10,35
Terek Grozny,5723,4,8,6,6,22,22,0,30
Zenit,5723,5,7,8,5,23,17,6,29
Krasnodar,5723,6,8,4,8,29,30,-1,28
Din Moscow,5723,7,7,6,7,21,22,-1,27
FK Rubin,5723,8,6,5,9,25,20,5,23
Rostov,5723,9,4,6,10,11,20,-9,18
Amkar,5723,10,4,5,11,9,23,-14,17
Anzhi,5723,11,2,6,12,14,39,-25,12
Loko Moscow,5724,1,12,5,3,30,12,18,41
Spart Moscow,5724,2,11,5,4,38,25,13,38
CSKA Moscow,5724,3,11,4,5,28,19,9,37
Krasnodar,5724,4,10,4,6,30,25,5,34
Zenit,5724,5,7,9,4,22,15,7,30
Terek Grozny,5724,6,7,7,6,21,23,-2,28
Din Moscow,5724,7,5,7,8,17,24,-7,22
FK Rubin,5724,8,5,6,9,22,19,3,21
Rostov,5724,9,4,6,10,10,18,-8,18
Amkar,5724,10,4,5,11,10,24,-14,17
Anzhi,5724,11,2,6,12,15,39,-24,12
Loko Moscow,5725,1,12,6,2,30,11,19,42
Spart Moscow,5725,2,10,6,4,38,27,11,36
CSKA Moscow,5725,3,10,4,6,26,19,7,34
Zenit,5725,4,8,8,4,23,15,8,32
Krasnodar,5725,5,8,5,7,27,25,2,29
Terek Grozny,5725,6,7,6,7,21,24,-3,27
FK Rubin,5725,7,6,6,8,23,18,5,24
Din Moscow,5725,8,5,7,8,18,23,-5,22
Amkar,5725,9,5,5,10,10,22,-12,20
Rostov,5725,10,4,6,10,12,21,-9,18
Anzhi,5725,11,2,7,11,15,38,-23,13
Loko Moscow,5726,1,11,6,3,34,17,17,39
Spart Moscow,5726,2,10,6,4,38,27,11,36
CSKA Moscow,5726,3,11,3,6,27,20,7,36
Zenit,5726,4,9,8,3,25,14,11,35
Krasnodar,5726,5,8,6,6,32,29,3,30
Terek Grozny,5726,6,8,5,7,22,24,-2,29
FK Rubin,5726,7,6,6,8,23,18,5,24
Din Moscow,5726,8,5,6,9,19,25,-6,21
Rostov,5726,9,4,7,9,10,17,-7,19
Amkar,5726,10,5,4,11,10,24,-14,19
Anzhi,5726,11,2,5,13,16,41,-25,11
Loko Moscow,5727,1,12,5,3,31,14,17,41
CSKA Moscow,5727,2,11,4,5,29,19,10,37
Krasnodar,5727,3,9,5,6,29,24,5,32
Terek Grozny,5727,4,9,5,6,23,23,0,32
Spart Moscow,5727,5,8,7,5,36,29,7,31
Zenit,5727,6,7,9,4,24,17,7,30
FK Rubin,5727,7,6,6,8,23,18,5,24
Din Moscow,5727,8,5,7,8,19,24,-5,22
Rostov,5727,9,4,7,9,11,18,-7,19
Amkar,5727,10,5,4,11,12,25,-13,19
Anzhi,5727,11,2,5,13,14,40,-26,11
Loko Moscow,5728,1,12,6,2,33,13,20,42
CSKA Moscow,5728,2,12,3,5,27,17,10,39
Spart Moscow,5728,3,8,7,5,36,30,6,31
Krasnodar,5728,4,9,4,7,29,27,2,31
Zenit,5728,5,7,9,4,22,15,7,30
Terek Grozny,5728,6,7,6,7,22,25,-3,27
Din Moscow,5728,7,6,7,7,20,22,-2,25
FK Rubin,5728,8,5,6,9,21,18,3,21
Rostov,5728,9,4,7,9,11,18,-7,19
Amkar,5728,10,4,6,10,11,24,-13,18
Anzhi,5728,11,3,5,12,16,39,-23,14
Loko Moscow,5729,1,12,5,3,31,13,18,41
CSKA Moscow,5729,2,12,3,5,30,17,13,39
Spart Moscow,5729,3,9,6,5,38,32,6,33
Krasnodar,5729,4,9,4,7,28,26,2,31
Zenit,5729,5,7,8,5,22,18,4,29
Terek Grozny,5729,6,7,5,8,22,26,-4,26
Din Moscow,5729,7,6,7,7,20,23,-3,25
FK Rubin,5729,8,6,5,9,24,19,5,23
Amkar,5729,9,6,4,10,16,24,-8,22
Rostov,5729,10,4,6,10,11,20,-9,18
Anzhi,5729,11,3,5,12,16,40,-24,14
Loko Moscow,5730,1,11,5,4,29,14,15,38
CSKA Moscow,5730,2,11,4,5,31,20,11,37
Krasnodar,5730,3,10,4,6,31,24,7,34
Zenit,5730,4,8,9,3,24,15,9,33
Spart Moscow,5730,5,9,6,5,35,28,7,33
Terek Grozny,5730,6,9,5,6,24,23,1,32
Din Moscow,5730,7,5,7,8,19,24,-5,22
FK Rubin,5730,8,5,6,9,23,21,2,21
Rostov,5730,9,4,7,9,10,17,-7,19
Amkar,5730,10,5,4,11,12,25,-13,19
Anzhi,5730,11,2,5,13,16,43,-27,11
Loko Moscow,5731,1,11,6,3,32,17,15,39
CSKA Moscow,5731,2,11,3,6,28,20,8,36
Spart Moscow,5731,3,10,5,5,40,28,12,35
Zenit,5731,4,8,9,3,26,16,10,33
Terek Grozny,5731,5,9,5,6,24,22,2,32
Krasnodar,5731,6,9,4,7,31,26,5,31
FK Rubin,5731,7,7,5,8,26,18,8,26
Din Moscow,5731,8,6,6,8,19,25,-6,24
Rostov,5731,9,4,6,10,11,20,-9,18
Amkar,5731,10,4,4,12,9,26,-17,16
Anzhi,5731,11,2,5,13,15,43,-28,11
Loko Moscow,5732,1,11,6,3,29,12,17,39
CSKA Moscow,5732,2,11,3,6,27,19,8,36
Krasnodar,5732,3,10,4,6,31,26,5,34
Spart Moscow,5732,4,8,7,5,37,31,6,31
Zenit,5732,5,7,9,4,21,14,7,30
Din Moscow,5732,6,7,6,7,22,22,0,27
Terek Grozny,5732,7,7,6,7,21,25,-4,27
FK Rubin,5732,8,5,5,10,23,22,1,20
Amkar,5732,9,5,5,10,13,24,-11,20
Rostov,5732,10,4,7,9,11,18,-7,19
Anzhi,5732,11,3,6,11,17,39,-22,15
Loko Moscow,5733,1,12,6,2,32,12,20,42
CSKA Moscow,5733,2,10,5,5,26,18,8,35
Spart Moscow,5733,3,9,6,5,36,27,9,33
Zenit,5733,4,7,9,4,22,16,6,30
Krasnodar,5733,5,8,6,6,29,26,3,30
Terek Grozny,5733,6,7,6,7,21,24,-3,27
FK Rubin,5733,7,6,6,8,24,18,6,24
Din Moscow,5733,8,5,7,8,18,24,-6,22
Rostov,5733,9,5,6,9,11,17,-6,21
Amkar,5733,10,5,4,11,10,24,-14,19
Anzhi,5733,11,2,7,11,15,38,-23,13
Loko Moscow,5734,1,13,5,2,33,12,21,44
Spart Moscow,5734,2,10,6,4,40,29,11,36
CSKA Moscow,5734,3,10,4,6,27,20,7,34
Zenit,5734,4,8,8,4,24,16,8,32
Krasnodar,5734,5,9,4,7,29,27,2,31
Terek Grozny,5734,6,8,6,6,24,24,0,30
FK Rubin,5734,7,6,5,9,23,19,4,23
Din Moscow,5734,8,5,6,9,18,25,-7,21
Rostov,5734,9,4,7,9,12,19,-7,19
Amkar,5734,10,4,5,11,12,26,-14,17
Anzhi,5734,11,2,6,12,15,40,-25,12
Loko Moscow,5735,1,12,5,3,31,13,18,41
CSKA Moscow,5735,2,11,4,5,28,17,11,37
Spart Moscow,5735,3,10,6,4,39,27,12,36
Zenit,5735,4,8,9,3,23,14,9,33
Krasnodar,5735,5,9,4,7,29,26,3,31
Terek Grozny,5735,6,7,5,8,20,25,-5,26
FK Rubin,5735,7,6,5,9,24,19,5,23
Din Moscow,5735,8,5,7,8,18,24,-6,22
Amkar,5735,9,5,4,11,10,24,-14,19
Rostov,5735,10,4,6,10,11,20,-9,18
Anzhi,5735,11,3,5,12,16,40,-24,14
Loko Moscow,5736,1,12,6,2,31,12,19,42
Zenit,5736,2,8,9,3,23,14,9,33
CSKA Moscow,5736,3,10,3,7,25,19,6,33
Spart Moscow,5736,4,9,5,6,38,31,7,32
Krasnodar,5736,5,9,4,7,28,25,3,31
Terek Grozny,5736,6,7,5,8,20,24,-4,26
Din Moscow,5736,7,6,7,7,21,24,-3,25
Amkar,5736,8,6,4,10,11,22,-11,22
FK Rubin,5736,9,5,6,9,22,19,3,21
Rostov,5736,10,4,6,10,12,20,-8,18
Anzhi,5736,11,4,5,11,16,37,-21,17
Loko Moscow,5737,1,12,6,2,33,14,19,42
CSKA Moscow,5737,2,12,3,5,29,19,10,39
Spart Moscow,5737,3,11,5,4,39,27,12,38
Zenit,5737,4,7,9,4,24,17,7,30
Krasnodar,5737,5,8,4,8,28,29,-1,28
Terek Grozny,5737,6,7,7,6,22,24,-2,28
Din Moscow,5737,7,6,6,8,21,25,-4,24
FK Rubin,5737,8,6,5,9,26,20,6,23
Rostov,5737,9,4,6,10,11,20,-9,18
Amkar,5737,10,4,5,11,10,24,-14,17
Anzhi,5737,11,2,6,12,16,40,-24,12
Loko Moscow,5738,1,12,5,3,31,13,18,41
CSKA Moscow,5738,2,12,3,5,30,18,12,39
Spart Moscow,5738,3,11,5,4,44,30,14,38
Zenit,5738,4,8,8,4,22,15,7,32
Terek Grozny,5738,5,8,6,6,21,22,-1,30
Krasnodar,5738,6,8,5,7,28,26,2,29
FK Rubin,5738,7,5,7,8,23,19,4,22
Din Moscow,5738,8,5,7,8,20,26,-6,22
Rostov,5738,9,4,6,10,12,21,-9,18
Amkar,5738,10,4,5,11,11,26,-15,17
Anzhi,5738,11,2,5,13,15,41,-26,11
Loko Moscow,5739,1,12,5,3,34,14,20,41
CSKA Moscow,5739,2,11,3,6,29,20,9,36
Spart Moscow,5739,3,10,5,5,39,28,11,35
Krasnodar,5739,4,10,4,6,33,25,8,34
Zenit,5739,5,8,8,4,24,19,5,32
Terek Grozny,5739,6,8,5,7,22,24,-2,29
Din Moscow,5739,7,6,6,8,19,23,-4,24
FK Rubin,5739,8,6,5,9,22,20,2,23
Amkar,5739,9,5,4,11,11,25,-14,19
Rostov,5739,10,4,6,10,11,20,-9,18
Anzhi,5739,11,2,5,13,14,40,-26,11
Loko Moscow,5740,1,12,6,2,34,12,22,42
CSKA Moscow,5740,2,11,4,5,32,20,12,37
Spart Moscow,5740,3,9,6,5,36,26,10,33
Krasnodar,5740,4,9,5,6,30,26,4,32
Zenit,5740,5,7,9,4,24,20,4,30
Terek Grozny,5740,6,8,5,7,22,24,-2,29
Din Moscow,5740,7,6,7,7,18,21,-3,25
FK Rubin,5740,8,5,5,10,22,20,2,20
Amkar,5740,9,5,4,11,10,23,-13,19
Rostov,5740,10,4,6,10,10,20,-10,18
Anzhi,5740,11,3,5,12,16,42,-26,14
Loko Moscow,5741,1,12,5,3,32,13,19,41
CSKA Moscow,5741,2,11,4,5,33,22,11,37
Spart Moscow,5741,3,10,6,4,38,28,10,36
Zenit,5741,4,8,9,3,23,14,9,33
Krasnodar,5741,5,9,4,7,30,28,2,31
Terek Grozny,5741,6,7,6,7,21,24,-3,27
FK Rubin,5741,7,6,5,9,25,21,4,23
Din Moscow,5741,8,5,6,9,20,26,-6,21
Rostov,5741,9,4,7,9,11,18,-7,19
Amkar,5741,10,5,4,11,11,24,-13,19
Anzhi,5741,11,2,6,12,19,45,-26,12
Loko Moscow,5742,1,11,6,3,31,14,17,39
Spart Moscow,5742,2,10,6,4,39,26,13,36
CSKA Moscow,5742,3,10,5,5,26,18,8,35
Zenit,5742,4,8,9,3,22,13,9,33
Terek Grozny,5742,5,9,5,6,24,24,0,32
Krasnodar,5742,6,8,5,7,29,28,1,29
FK Rubin,5742,7,7,5,8,27,20,7,26
Din Moscow,5742,8,5,6,9,20,28,-8,21
Rostov,5742,9,4,7,9,11,18,-7,19
Amkar,5742,10,4,4,12,11,27,-16,16
Anzhi,5742,11,2,6,12,15,39,-24,12
Loko Moscow,5743,1,11,6,3,30,13,17,39
Spart Moscow,5743,2,10,6,4,38,26,12,36
CSKA Moscow,5743,3,11,3,6,26,18,8,36
Krasnodar,5743,4,10,4,6,31,25,6,34
Zenit,5743,5,8,9,3,22,13,9,33
Terek Grozny,5743,6,7,7,6,21,23,-2,28
FK Rubin,5743,7,6,5,9,23,20,3,23
Din Moscow,5743,8,5,6,9,18,26,-8,21
Rostov,5743,9,4,6,10,10,18,-8,18
Amkar,5743,10,4,6,10,11,24,-13,18
Anzhi,5743,11,2,6,12,14,38,-24,12
Loko Moscow,5744,1,11,6,3,30,13,17,39
CSKA Moscow,5744,2,11,4,5,29,20,9,37
Spart Moscow,5744,3,10,6,4,38,28,10,36
Zenit,5744,4,7,10,3,22,14,8,31
Krasnodar,5744,5,9,4,7,30,27,3,31
Terek Grozny,5744,6,8,6,6,23,22,1,30
FK Rubin,5744,7,7,5,8,26,19,7,26
Din Moscow,5744,8,5,6,9,19,26,-7,21
Rostov,5744,9,4,6,10,12,20,-8,18
Amkar,5744,10,4,5,11,9,25,-16,17
Anzhi,5744,11,2,6,12,16,40,-24,12
Loko Moscow,5745,1,12,6,2,32,11,21,42
Spart Moscow,5745,2,10,6,4,38,27,11,36
CSKA Moscow,5745,3,11,3,6,28,18,10,36
Zenit,5745,4,8,9,3,22,13,9,33
Krasnodar,5745,5,9,4,7,29,27,2,31
Terek Grozny,5745,6,8,5,7,21,23,-2,29
Din Moscow,5745,7,5,8,7,18,22,-4,23
FK Rubin,5745,8,5,6,9,21,19,2,21
Amkar,5745,9,5,4,11,11,25,-14,19
Rostov,5745,10,4,6,10,10,18,-8,18
Anzhi,5745,11,2,5,13,14,41,-27,11
CSKA Moscow,5746,1,12,3,5,30,17,13,39
Loko Moscow,5746,2,11,5,4,31,16,15,38
Spart Moscow,5746,3,9,6,5,35,27,8,33
Zenit,5746,4,8,8,4,23,16,7,32
Krasnodar,5746,5,9,4,7,30,26,4,31
Terek Grozny,5746,6,8,5,7,21,25,-4,29
FK Rubin,5746,7,7,5,8,23,17,6,26
Amkar,5746,8,6,4,10,14,23,-9,22
Din Moscow,5746,9,5,6,9,17,23,-6,21
Rostov,5746,10,4,7,9,10,17,-7,19
Anzhi,5746,11,2,5,13,14,41,-27,11
CSKA Moscow,5747,1,12,3,5,29,18,11,39
Loko Moscow,5747,2,11,5,4,30,15,15,38
Krasnodar,5747,3,10,4,6,31,25,6,34
Spart Moscow,5747,4,9,6,5,36,27,9,33
Zenit,5747,5,8,8,4,22,15,7,32
Terek Grozny,5747,6,7,5,8,20,26,-6,26
Din Moscow,5747,7,6,6,8,20,24,-4,24
Amkar,5747,8,6,4,10,13,23,-10,22
FK Rubin,5747,9,5,5,10,22,21,1,20
Rostov,5747,10,4,7,9,10,17,-7,19
Anzhi,5747,11,3,5,12,17,39,-22,14
Loko Moscow,5748,1,13,5,2,33,12,21,44
CSKA Moscow,5748,2,11,3,6,26,18,8,36
Spart Moscow,5748,3,9,5,6,38,28,10,32
Zenit,5748,4,8,8,4,22,15,7,32
Krasnodar,5748,5,9,4,7,30,27,3,31
Terek Grozny,5748,6,8,5,7,22,24,-2,29
Din Moscow,5748,7,5,7,8,17,25,-8,22
FK Rubin,5748,8,5,6,9,22,19,3,21
Rostov,5748,9,5,6,9,12,18,-6,21
Amkar,5748,10,5,4,11,10,24,-14,19
Anzhi,5748,11,3,5,12,16,38,-22,14
Loko Moscow,5749,1,13,5,2,35,13,22,44
CSKA Moscow,5749,2,11,4,5,28,18,10,37
Spart Moscow,5749,3,10,5,5,40,31,9,35
Krasnodar,5749,4,9,4,7,30,28,2,31
Zenit,5749,5,7,9,4,23,17,6,30
Terek Grozny,5749,6,7,6,7,21,25,-4,27
Din Moscow,5749,7,6,6,8,19,23,-4,24
FK Rubin,5749,8,5,5,10,22,20,2,20
Amkar,5749,9,5,5,10,12,24,-12,20
Rostov,5749,10,4,6,10,13,21,-8,18
Anzhi,5749,11,3,5,12,16,39,-23,14
Loko Moscow,5750,1,12,5,3,30,13,17,41
Spart Moscow,5750,2,11,5,4,42,27,15,38
CSKA Moscow,5750,3,10,5,5,26,18,8,35
Zenit,5750,4,8,9,3,23,13,10,33
Krasnodar,5750,5,9,4,7,30,25,5,31
Terek Grozny,5750,6,8,6,6,22,23,-1,30
Din Moscow,5750,7,5,7,8,20,27,-7,22
FK Rubin,5750,8,5,6,9,23,22,1,21
Rostov,5750,9,4,6,10,11,20,-9,18
Amkar,5750,10,4,4,12,9,25,-16,16
Anzhi,5750,11,2,7,11,16,39,-23,13
Loko Moscow,5751,1,11,7,2,30,12,18,40
CSKA Moscow,5751,2,12,3,5,30,20,10,39
Spart Moscow,5751,3,9,7,4,38,28,10,34
Krasnodar,5751,4,9,5,6,30,24,6,32
Zenit,5751,5,7,9,4,24,17,7,30
Terek Grozny,5751,6,8,6,6,22,23,-1,30
Din Moscow,5751,7,6,7,7,21,24,-3,25
FK Rubin,5751,8,5,5,10,21,21,0,20
Rostov,5751,9,4,6,10,10,19,-9,18
Amkar,5751,10,4,5,11,9,23,-14,17
Anzhi,5751,11,2,6,12,16,40,-24,12
Loko Moscow,5752,1,13,5,2,31,11,20,44
CSKA Moscow,5752,2,11,3,6,27,19,8,36
Spart Moscow,5752,3,10,5,5,39,28,11,35
Zenit,5752,4,8,8,4,23,14,9,32
Krasnodar,5752,5,8,5,7,29,27,2,29
Terek Grozny,5752,6,7,6,7,22,27,-5,27
FK Rubin,5752,7,5,7,8,23,19,4,22
Din Moscow,5752,8,5,7,8,18,23,-5,22
Rostov,5752,9,5,6,9,12,17,-5,21
Amkar,5752,10,5,4,11,13,27,-14,19
Anzhi,5752,11,2,6,12,15,40,-25,12
Loko Moscow,5753,1,11,7,2,32,14,18,40
CSKA Moscow,5753,2,12,3,5,30,18,12,39
Spart Moscow,5753,3,9,6,5,38,28,10,33
Zenit,5753,4,7,9,4,24,17,7,30
Terek Grozny,5753,5,8,6,6,22,23,-1,30
Krasnodar,5753,6,8,5,7,30,28,2,29
FK Rubin,5753,7,6,6,8,25,20,5,24
Din Moscow,5753,8,5,8,7,20,24,-4,23
Rostov,5753,9,5,6,9,11,17,-6,21
Amkar,5753,10,4,5,11,10,26,-16,17
Anzhi,5753,11,2,5,13,14,41,-27,11
Loko Moscow,5754,1,11,5,4,29,14,15,38
CSKA Moscow,5754,2,11,4,5,27,18,9,37
Spart Moscow,5754,3,9,7,4,39,30,9,34
Zenit,5754,4,8,8,4,23,15,8,32
Krasnodar,5754,5,9,5,6,31,26,5,32
Terek Grozny,5754,6,7,6,7,21,26,-5,27
FK Rubin,5754,7,5,7,8,24,20,4,22
Din Moscow,5754,8,5,7,8,21,26,-5,22
Amkar,5754,9,5,5,10,14,24,-10,20
Rostov,5754,10,4,7,9,11,18,-7,19
Anzhi,5754,11,2,7,11,14,37,-23,13
Loko Moscow,5755,1,11,6,3,30,14,16,39
CSKA Moscow,5755,2,11,3,6,27,20,7,36
Zenit,5755,3,9,8,3,26,13,13,35
Spart Moscow,5755,4,9,6,5,39,31,8,33
Terek Grozny,5755,5,9,5,6,22,22,0,32
Krasnodar,5755,6,8,5,7,29,28,1,29
FK Rubin,5755,7,7,5,8,26,18,8,26
Din Moscow,5755,8,6,6,8,20,25,-5,24
Rostov,5755,9,4,6,10,10,18,-8,18
Amkar,5755,10,4,5,11,12,26,-14,17
Anzhi,5755,11,2,5,13,14,40,-26,11
Loko Moscow,5756,1,12,5,3,32,14,18,41
CSKA Moscow,5756,2,12,3,5,29,19,10,39
Spart Moscow,5756,3,10,5,5,37,28,9,35
Zenit,5756,4,8,8,4,24,16,8,32
Krasnodar,5756,5,8,5,7,28,26,2,29
Terek Grozny,5756,6,7,7,6,21,23,-2,28
Din Moscow,5756,7,6,6,8,19,23,-4,24
FK Rubin,5756,8,5,6,9,22,19,3,21
Amkar,5756,9,5,5,10,11,23,-12,20
Rostov,5756,10,4,6,10,11,19,-8,18
Anzhi,5756,11,2,6,12,16,40,-24,12
Loko Moscow,5757,1,13,5,2,35,11,24,44
CSKA Moscow,5757,2,11,3,6,29,20,9,36
Spart Moscow,5757,3,9,6,5,37,29,8,33
Zenit,5757,4,8,8,4,22,17,5,32
Terek Grozny,5757,5,8,6,6,22,22,0,30
Krasnodar,5757,6,8,4,8,27,27,0,28
FK Rubin,5757,7,7,5,8,24,17,7,26
Din Moscow,5757,8,5,6,9,17,25,-8,21
Rostov,5757,9,4,7,9,12,19,-7,19
Amkar,5757,10,5,4,11,11,24,-13,19
Anzhi,5757,11,2,6,12,16,41,-25,12
Loko Moscow,5758,1,11,6,3,31,14,17,39
CSKA Moscow,5758,2,10,5,5,27,19,8,35
Krasnodar,5758,3,10,4,6,31,24,7,34
Spart Moscow,5758,4,9,6,5,34,27,7,33
Zenit,5758,5,7,10,3,24,16,8,31
Terek Grozny,5758,6,8,6,6,24,25,-1,30
Din Moscow,5758,7,6,6,8,19,22,-3,24
FK Rubin,5758,8,6,5,9,22,20,2,23
Rostov,5758,9,4,6,10,10,18,-8,18
Amkar,5758,10,4,6,10,10,23,-13,18
Anzhi,5758,11,2,6,12,17,41,-24,12
Loko Moscow,5759,1,12,6,2,34,13,21,42
Spart Moscow,5759,2,11,5,4,39,27,12,38
CSKA Moscow,5759,3,11,3,6,28,19,9,36
Zenit,5759,4,8,8,4,23,17,6,32
Krasnodar,5759,5,9,5,6,30,26,4,32
Terek Grozny,5759,6,8,5,7,23,24,-1,29
Din Moscow,5759,7,6,6,8,20,24,-4,24
FK Rubin,5759,8,5,5,10,21,19,2,20
Amkar,5759,9,5,4,11,11,25,-14,19
Rostov,5759,10,4,6,10,10,18,-8,18
Anzhi,5759,11,2,5,13,14,41,-27,11
Loko Moscow,5760,1,11,5,4,31,15,16,38
CSKA Moscow,5760,2,11,4,5,28,19,9,37
Spart Moscow,5760,3,10,6,4,38,25,13,36
Krasnodar,5760,4,10,4,6,29,24,5,34
Zenit,5760,5,8,8,4,26,18,8,32
Terek Grozny,5760,6,9,5,6,27,27,0,32
Din Moscow,5760,7,6,6,8,18,23,-5,24
FK Rubin,5760,8,5,5,10,21,19,2,20
Rostov,5760,9,4,6,10,10,20,-10,18
Amkar,5760,10,4,5,11,11,25,-14,17
Anzhi,5760,11,2,6,12,17,41,-24,12
Loko Moscow,5761,1,12,6,2,32,13,19,42
Spart Moscow,5761,2,11,5,4,37,25,12,38
CSKA Moscow,5761,3,11,4,5,29,19,10,37
Zenit,5761,4,7,9,4,23,16,7,30
Terek Grozny,5761,5,8,6,6,28,27,1,30
Krasnodar,5761,6,8,5,7,29,27,2,29
Din Moscow,5761,7,6,6,8,18,22,-4,24
FK Rubin,5761,8,6,5,9,23,19,4,23
Rostov,5761,9,4,6,10,10,19,-9,18
Amkar,5761,10,4,5,11,12,26,-14,17
Anzhi,5761,11,2,5,13,17,45,-28,11
Loko Moscow,5762,1,11,6,3,29,13,16,39
CSKA Moscow,5762,2,11,3,6,27,19,8,36
Spart Moscow,5762,3,9,7,4,37,26,11,34
Zenit,5762,4,8,9,3,22,13,9,33
Krasnodar,5762,5,9,5,6,29,24,5,32
Terek Grozny,5762,6,8,6,6,23,24,-1,30
Din Moscow,5762,7,5,8,7,19,23,-4,23
FK Rubin,5762,8,5,7,8,22,18,4,22
Rostov,5762,9,4,6,10,10,20,-10,18
Amkar,5762,10,4,5,11,9,23,-14,17
Anzhi,5762,11,2,6,12,17,41,-24,12
Loko Moscow,5763,1,11,7,2,32,14,18,40
CSKA Moscow,5763,2,11,4,5,28,18,10,37
Spart Moscow,5763,3,10,6,4,42,29,13,36
Krasnodar,5763,4,9,5,6,29,25,4,32
Zenit,5763,5,7,9,4,23,17,6,30
Terek Grozny,5763,6,8,5,7,23,27,-4,29
Din Moscow,5763,7,6,6,8,20,26,-6,24
FK Rubin,5763,8,5,5,10,22,20,2,20
Rostov,5763,9,4,6,10,12,21,-9,18
Amkar,5763,10,4,5,11,11,26,-15,17
Anzhi,5763,11,3,6,11,19,38,-19,15
Loko Moscow,5764,1,13,5,2,36,16,20,44
CSKA Moscow,5764,2,10,4,6,27,20,7,34
Spart Moscow,5764,3,9,6,5,35,27,8,33
Zenit,5764,4,8,8,4,26,18,8,32
Terek Grozny,5764,5,8,6,6,22,23,-1,30
Krasnodar,5764,6,8,5,7,31,29,2,29
FK Rubin,5764,7,6,6,8,24,18,6,24
Din Moscow,5764,8,6,6,8,18,23,-5,24
Rostov,5764,9,4,7,9,10,17,-7,19
Amkar,5764,10,4,4,12,10,25,-15,16
Anzhi,5764,11,2,7,11,15,38,-23,13
Loko Moscow,5765,1,11,7,2,32,14,18,40
CSKA Moscow,5765,2,11,3,6,29,18,11,36
Spart Moscow,5765,3,10,5,5,37,29,8,35
Zenit,5765,4,8,9,3,23,14,9,33
Krasnodar,5765,5,9,5,6,30,26,4,32
Terek Grozny,5765,6,7,7,6,20,22,-2,28
Din Moscow,5765,7,6,7,7,19,21,-2,25
FK Rubin,5765,8,5,6,9,21,18,3,21
Rostov,5765,9,4,6,10,11,19,-8,18
Amkar,5765,10,4,5,11,10,24,-14,17
Anzhi,5765,11,2,6,12,14,41,-27,12
Loko Moscow,5766,1,12,6,2,32,13,19,42
CSKA Moscow,5766,2,12,3,5,30,18,12,39
Spart Moscow,5766,3,9,5,6,39,30,9,32
Krasnodar,5766,4,9,5,6,30,26,4,32
Terek Grozny,5766,5,9,5,6,24,24,0,32
Zenit,5766,6,7,8,5,22,17,5,29
Din Moscow,5766,7,6,7,7,21,24,-3,25
FK Rubin,5766,8,5,6,9,23,20,3,21
Rostov,5766,9,5,6,9,12,17,-5,21
Amkar,5766,10,4,4,12,10,28,-18,16
Anzhi,5766,11,2,5,13,16,42,-26,11
Loko Moscow,5767,1,11,6,3,30,13,17,39
CSKA Moscow,5767,2,11,4,5,30,19,11,37
Krasnodar,5767,3,10,4,6,31,25,6,34
Spart Moscow,5767,4,9,6,5,38,29,9,33
Zenit,5767,5,7,10,3,24,16,8,31
Terek Grozny,5767,6,8,5,7,23,23,0,29
Din Moscow,5767,7,7,6,7,20,22,-2,27
FK Rubin,5767,8,5,5,10,22,21,1,20
Rostov,5767,9,4,7,9,11,18,-7,19
Amkar,5767,10,4,4,12,10,28,-18,16
Anzhi,5767,11,3,5,12,15,40,-25,14
CSKA Moscow,5768,1,12,3,5,27,17,10,39
Loko Moscow,5768,2,11,5,4,30,14,16,38
Spart Moscow,5768,3,10,5,5,36,26,10,35
Krasnodar,5768,4,10,4,6,31,26,5,34
Zenit,5768,5,8,8,4,22,14,8,32
Terek Grozny,5768,6,8,5,7,22,23,-1,29
Din Moscow,5768,7,7,6,7,19,21,-2,27
FK Rubin,5768,8,5,5,10,22,20,2,20
Rostov,5768,9,4,6,10,10,19,-9,18
Amkar,5768,10,4,4,12,9,25,-16,16
Anzhi,5768,11,3,5,12,15,38,-23,14
Loko Moscow,5769,1,12,6,2,35,16,19,42
CSKA Moscow,5769,2,11,4,5,29,19,10,37
Spart Moscow,5769,3,9,5,6,39,30,9,32
Zenit,5769,4,7,9,4,26,19,7,30
Krasnodar,5769,5,8,6,6,32,29,3,30
Terek Grozny,5769,6,7,6,7,20,24,-4,27
Din Moscow,5769,7,6,6,8,19,25,-6,24
FK Rubin,5769,8,5,6,9,24,22,2,21
Rostov,5769,9,5,6,9,11,17,-6,21
Amkar,5769,10,5,5,10,13,24,-11,20
Anzhi,5769,11,3,5,12,16,39,-23,14
Loko Moscow,5770,1,13,5,2,31,11,20,44
CSKA Moscow,5770,2,11,3,6,31,23,8,36
Zenit,5770,3,8,8,4,23,15,8,32
Spart Moscow,5770,4,8,5,7,35,31,4,29
Krasnodar,5770,5,8,5,7,27,25,2,29
Din Moscow,5770,6,7,6,7,20,21,-1,27
Terek Grozny,5770,7,7,6,7,21,24,-3,27
Amkar,5770,8,6,4,10,12,23,-11,22
FK Rubin,5770,9,5,6,9,21,18,3,21
Rostov,5770,10,5,6,9,12,18,-6,21
Anzhi,5770,11,2,6,12,19,43,-24,12
Loko Moscow,5771,1,11,7,2,31,13,18,40
CSKA Moscow,5771,2,11,4,5,26,17,9,37
Spart Moscow,5771,3,9,6,5,39,30,9,33
Krasnodar,5771,4,9,5,6,29,25,4,32
Zenit,5771,5,7,10,3,22,14,8,31
Terek Grozny,5771,6,8,6,6,21,22,-1,30
Din Moscow,5771,7,5,7,8,21,28,-7,22
FK Rubin,5771,8,5,6,9,23,20,3,21
Amkar,5771,9,5,5,10,12,23,-11,20
Rostov,5771,10,4,7,9,10,17,-7,19
Anzhi,5771,11,2,5,13,14,39,-25,11
Loko Moscow,5772,1,11,7,2,29,11,18,40
CSKA Moscow,5772,2,10,4,6,28,22,6,34
Zenit,5772,3,8,9,3,25,15,10,33
Spart Moscow,5772,4,9,6,5,38,29,9,33
Krasnodar,5772,5,8,5,7,28,26,2,29
Terek Grozny,5772,6,7,6,7,21,24,-3,27
FK Rubin,5772,7,7,5,8,27,19,8,26
Din Moscow,5772,8,6,6,8,21,25,-4,24
Rostov,5772,9,4,7,9,11,18,-7,19
Amkar,5772,10,4,5,11,10,27,-17,17
Anzhi,5772,11,3,6,11,16,38,-22,15
Loko Moscow,5773,1,12,5,3,31,13,18,41
CSKA Moscow,5773,2,11,3,6,27,19,8,36
Krasnodar,5773,3,10,4,6,31,25,6,34
Spart Moscow,5773,4,9,6,5,39,32,7,33
Terek Grozny,5773,5,9,5,6,24,22,2,32
Zenit,5773,6,7,8,5,21,17,4,29
FK Rubin,5773,7,6,5,9,25,20,5,23
Din Moscow,5773,8,5,7,8,21,27,-6,22
Amkar,5773,9,5,4,11,13,26,-13,19
Rostov,5773,10,4,6,10,10,18,-8,18
Anzhi,5773,11,3,5,12,16,39,-23,14
Loko Moscow,5774,1,13,5,2,33,13,20,44
CSKA Moscow,5774,2,10,3,7,27,21,6,33
Zenit,5774,3,8,8,4,25,17,8,32
Spart Moscow,5774,4,8,5,7,34,29,5,29
Krasnodar,5774,5,8,5,7,28,26,2,29
Din Moscow,5774,6,7,6,7,19,21,-2,27
Terek Grozny,5774,7,7,6,7,20,24,-4,27
Amkar,5774,8,6,4,10,12,22,-10,22
FK Rubin,5774,9,5,6,9,21,18,3,21
Rostov,5774,10,5,6,9,12,18,-6,21
Anzhi,5774,11,3,6,11,15,37,-22,15
Loko Moscow,5775,1,12,6,2,31,12,19,42
CSKA Moscow,5775,2,11,3,6,26,20,6,36
Spart Moscow,5775,3,10,5,5,37,29,8,35
Zenit,5775,4,8,9,3,24,13,11,33
Krasnodar,5775,5,9,4,7,31,26,5,31
Terek Grozny,5775,6,8,5,7,23,26,-3,29
Din Moscow,5775,7,5,7,8,19,24,-5,22
Amkar,5775,8,6,4,10,13,22,-9,22
FK Rubin,5775,9,5,6,9,21,20,1,21
Rostov,5775,10,4,6,10,10,18,-8,18
Anzhi,5775,11,2,5,13,16,41,-25,11
Loko Moscow,5776,1,12,6,2,32,12,20,42
Spart Moscow,5776,2,10,6,4,41,27,14,36
CSKA Moscow,5776,3,11,3,6,29,22,7,36
Zenit,5776,4,8,9,3,26,15,11,33
Terek Grozny,5776,5,9,5,6,27,22,5,32
Krasnodar,5776,6,9,4,7,29,26,3,31
Din Moscow,5776,7,6,6,8,18,24,-6,24
FK Rubin,5776,8,5,5,10,21,20,1,20
Rostov,5776,9,4,6,10,10,20,-10,18
Amkar,5776,10,4,5,11,11,28,-17,17
Anzhi,5776,11,2,5,13,15,43,-28,11
Loko Moscow,5777,1,12,5,3,30,12,18,41
CSKA Moscow,5777,2,11,4,5,28,18,10,37
Krasnodar,5777,3,10,4,6,30,24,6,34
Spart Moscow,5777,4,9,5,6,35,32,3,32
Zenit,5777,5,7,8,5,21,16,5,29
Terek Grozny,5777,6,8,5,7,23,23,0,29
Din Moscow,5777,7,5,7,8,17,22,-5,22
Amkar,5777,8,6,4,10,15,22,-7,22
FK Rubin,5777,9,5,6,9,21,19,2,21
Rostov,5777,10,5,6,9,12,18,-6,21
Anzhi,5777,11,2,6,12,15,41,-26,12
Loko Moscow,5778,1,12,5,3,31,15,16,41
CSKA Moscow,5778,2,11,4,5,29,19,10,37
Zenit,5778,3,8,9,3,26,15,11,33
Spart Moscow,5778,4,9,6,5,36,28,8,33
Krasnodar,5778,5,9,4,7,28,25,3,31
Terek Grozny,5778,6,8,6,6,22,22,0,30
Din Moscow,5778,7,6,7,7,21,23,-2,25
FK Rubin,5778,8,5,6,9,22,19,3,21
Rostov,5778,9,4,7,9,10,17,-7,19
Amkar,5778,10,4,4,12,9,26,-17,16
Anzhi,5778,11,2,6,12,15,40,-25,12
Loko Moscow,5779,1,11,6,3,31,14,17,39
CSKA Moscow,5779,2,11,4,5,29,19,10,37
Spart Moscow,5779,3,9,7,4,37,27,10,34
Zenit,5779,4,7,10,3,23,15,8,31
Krasnodar,5779,5,9,4,7,29,26,3,31
Terek Grozny,5779,6,8,5,7,22,24,-2,29
FK Rubin,5779,7,6,6,8,23,18,5,24
Din Moscow,5779,8,5,7,8,18,24,-6,22
Amkar,5779,9,5,5,10,11,22,-11,20
Rostov,5779,10,4,7,9,12,19,-7,19
Anzhi,5779,11,2,5,13,15,42,-27,11
Loko Moscow,5780,1,11,5,4,30,15,15,38
CSKA Moscow,5780,2,11,3,6,29,20,9,36
Zenit,5780,3,9,8,3,26,14,12,35
Krasnodar,5780,4,10,4,6,30,24,6,34
Spart Moscow,5780,5,9,5,6,35,29,6,32
Terek Grozny,5780,6,8,5,7,23,25,-2,29
Din Moscow,5780,7,7,6,7,20,22,-2,27
Amkar,5780,8,6,4,10,13,23,-10,22
FK Rubin,5780,9,5,5,10,22,20,2,20
Rostov,5780,10,4,6,10,11,19,-8,18
Anzhi,5780,11,2,5,13,15,43,-28,11
Loko Moscow,5781,1,11,6,3,31,14,17,39
Spart Moscow,5781,2,10,6,4,38,27,11,36
CSKA Moscow,5781,3,10,4,6,26,20,6,34
Zenit,5781,4,8,9,3,23,14,9,33
Krasnodar,5781,5,9,5,6,29,25,4,32
Terek Grozny,5781,6,8,6,6,22,23,-1,30
FK Rubin,5781,7,6,5,9,23,19,4,23
Din Moscow,5781,8,5,6,9,19,26,-7,21
Rostov,5781,9,4,6,10,10,18,-8,18
Amkar,5781,10,4,5,11,10,24,-14,17
Anzhi,5781,11,3,6,11,18,39,-21,15
Loko Moscow,5782,1,12,5,3,31,12,19,41
CSKA Moscow,5782,2,11,3,6,28,19,9,36
Krasnodar,5782,3,10,4,6,30,25,5,34
Zenit,5782,4,8,8,4,22,15,7,32
Spart Moscow,5782,5,9,5,6,35,30,5,32
Terek Grozny,5782,6,7,6,7,23,26,-3,27
FK Rubin,5782,7,6,5,9,23,19,4,23
Amkar,5782,8,6,4,10,12,22,-10,22
Rostov,5782,9,5,6,9,12,17,-5,21
Din Moscow,5782,10,5,6,9,18,24,-6,21
Anzhi,5782,11,2,6,12,18,43,-25,12
CSKA Moscow,5783,1,12,3,5,30,18,12,39
Loko Moscow,5783,2,11,5,4,29,15,14,38
Spart Moscow,5783,3,10,5,5,42,28,14,35
Zenit,5783,4,8,8,4,25,16,9,32
Terek Grozny,5783,5,9,5,6,25,24,1,32
Krasnodar,5783,6,9,4,7,28,25,3,31
Din Moscow,5783,7,6,7,7,20,23,-3,25
FK Rubin,5783,8,6,6,8,23,18,5,24
Rostov,5783,9,4,6,10,10,22,-12,18
Amkar,5783,10,4,4,12,11,27,-16,16
Anzhi,5783,11,2,5,13,15,42,-27,11
Loko Moscow,5784,1,11,5,4,29,15,14,38
CSKA Moscow,5784,2,11,3,6,26,20,6,36
Zenit,5784,3,9,8,3,25,13,12,35
Spart Moscow,5784,4,9,6,5,35,27,8,33
Krasnodar,5784,5,9,4,7,30,25,5,31
Din Moscow,5784,6,7,6,7,21,22,-1,27
Terek Grozny,5784,7,7,6,7,22,27,-5,27
FK Rubin,5784,8,6,5,9,22,19,3,23
Amkar,5784,9,5,5,10,12,22,-10,20
Rostov,5784,10,4,6,10,10,18,-8,18
Anzhi,5784,11,2,6,12,16,40,-24,12
Loko Moscow,5785,1,12,6,2,32,12,20,42
CSKA Moscow,5785,2,11,3,6,28,20,8,36
Zenit,5785,3,8,9,3,24,13,11,33
Spart Moscow,5785,4,9,5,6,37,30,7,32
Terek Grozny,5785,5,8,5,7,22,24,-2,29
Krasnodar,5785,6,8,4,8,28,31,-3,28
Din Moscow,5785,7,7,6,7,22,21,1,27
FK Rubin,5785,8,6,5,9,25,19,6,23
Amkar,5785,9,6,4,10,12,22,-10,22
Rostov,5785,10,4,6,10,10,21,-11,18
Anzhi,5785,11,2,5,13,15,42,-27,11
Loko Moscow,5786,1,11,5,4,30,15,15,38
Spart Moscow,5786,2,11,5,4,39,27,12,38
Zenit,5786,3,9,8,3,24,14,10,35
CSKA Moscow,5786,4,10,4,6,27,20,7,34
Terek Grozny,5786,5,9,5,6,28,22,6,32
Krasnodar,5786,6,9,5,6,30,25,5,32
FK Rubin,5786,7,5,7,8,22,18,4,22
Din Moscow,5786,8,5,7,8,17,23,-6,22
Rostov,5786,9,4,6,10,12,20,-8,18
Amkar,5786,10,4,4,12,9,26,-17,16
Anzhi,5786,11,2,6,12,16,44,-28,12
Loko Moscow,5787,1,11,6,3,31,14,17,39
Spart Moscow,5787,2,10,6,4,39,27,12,36
CSKA Moscow,5787,3,11,3,6,30,22,8,36
Zenit,5787,4,8,9,3,24,14,10,33
Krasnodar,5787,5,9,4,7,31,28,3,31
FK Rubin,5787,6,7,5,8,26,18,8,26
Terek Grozny,5787,7,7,5,8,21,26,-5,26
Din Moscow,5787,8,5,7,8,19,26,-7,22
Amkar,5787,9,5,4,11,11,25,-14,19
Rostov,5787,10,4,6,10,10,19,-9,18
Anzhi,5787,11,3,5,12,18,41,-23,14
Loko Moscow,5788,1,13,5,2,32,12,20,44
Spart Moscow,5788,2,11,5,4,42,28,14,38
CSKA Moscow,5788,3,10,4,6,27,21,6,34
Zenit,5788,4,8,8,4,25,16,9,32
Terek Grozny,5788,5,8,6,6,22,23,-1,30
Krasnodar,5788,6,8,5,7,27,25,2,29
FK Rubin,5788,7,5,7,8,22,18,4,22
Din Moscow,5788,8,5,7,8,19,26,-7,22
Rostov,5788,9,4,6,10,10,19,-9,18
Amkar,5788,10,4,4,12,12,27,-15,16
Anzhi,5788,11,2,7,11,15,38,-23,13
Loko Moscow,5789,1,13,5,2,35,13,22,44
Spart Moscow,5789,2,11,5,4,39,26,13,38
CSKA Moscow,5789,3,11,3,6,27,22,5,36
Zenit,5789,4,8,8,4,26,15,11,32
Krasnodar,5789,5,9,4,7,29,28,1,31
Terek Grozny,5789,6,7,6,7,23,28,-5,27
FK Rubin,5789,7,6,5,9,22,18,4,23
Din Moscow,5789,8,5,6,9,17,25,-8,21
Amkar,5789,9,5,4,11,13,24,-11,19
Rostov,5789,10,4,6,10,11,19,-8,18
Anzhi,5789,11,2,6,12,17,41,-24,12
Loko Moscow,5790,1,11,6,3,32,16,16,39
Zenit,5790,2,9,8,3,25,14,11,35
CSKA Moscow,5790,3,10,3,7,26,20,6,33
Spart Moscow,5790,4,8,7,5,34,27,7,31
Krasnodar,5790,5,8,6,6,30,27,3,30
Terek Grozny,5790,6,8,6,6,22,23,-1,30
FK Rubin,5790,7,6,6,8,23,18,5,24
Din Moscow,5790,8,6,6,8,19,23,-4,24
Rostov,5790,9,4,7,9,10,17,-7,19
Amkar,5790,10,4,6,10,10,23,-13,18
Anzhi,5790,11,3,5,12,16,39,-23,14
Loko Moscow,5791,1,12,6,2,31,12,19,42
CSKA Moscow,5791,2,11,3,6,28,20,8,36
Spart Moscow,5791,3,10,5,5,39,29,10,35
Zenit,5791,4,8,9,3,23,14,9,33
Terek Grozny,5791,5,8,6,6,22,23,-1,30
Krasnodar,5791,6,8,5,7,28,26,2,29
FK Rubin,5791,7,6,6,8,24,19,5,24
Rostov,5791,8,5,6,9,14,18,-4,21
Din Moscow,5791,9,5,6,9,18,24,-6,21
Amkar,5791,10,4,4,12,9,27,-18,16
Anzhi,5791,11,2,6,12,17,41,-24,12
Loko Moscow,5792,1,12,6,2,32,12,20,42
Spart Moscow,5792,2,11,5,4,39,25,14,38
Zenit,5792,3,8,9,3,24,14,10,33
CSKA Moscow,5792,4,10,3,7,25,22,3,33
Terek Grozny,5792,5,8,6,6,24,24,0,30
Krasnodar,5792,6,8,4,8,27,27,0,28
FK Rubin,5792,7,7,5,8,24,17,7,26
Din Moscow,5792,8,5,6,9,17,24,-7,21
Rostov,5792,9,4,6,10,10,20,-10,18
Amkar,5792,10,4,5,11,10,25,-15,17
Anzhi,5792,11,3,5,12,18,40,-22,14
Loko Moscow,5793,1,12,5,3,30,13,17,41
Spart Moscow,5793,2,10,5,5,37,26,11,35
Zenit,5793,3,9,8,3,24,13,11,35
CSKA Moscow,5793,4,10,3,7,25,21,4,33
Terek Grozny,5793,5,9,5,6,22,22,0,32
Krasnodar,5793,6,8,4,8,27,26,1,28
Din Moscow,5793,7,6,7,7,19,22,-3,25
FK Rubin,5793,8,6,6,8,23,18,5,24
Rostov,5793,9,4,6,10,10,18,-8,18
Amkar,5793,10,4,4,12,9,26,-17,16
Anzhi,5793,11,3,5,12,17,38,-21,14
Loko Moscow,5794,1,11,7,2,30,12,18,40
CSKA Moscow,5794,2,11,4,5,27,17,10,37
Spart Moscow,5794,3,9,6,5,36,27,9,33
Krasnodar,5794,4,9,5,6,30,25,5,32
Zenit,5794,5,7,10,3,22,14,8,31
Din Moscow,5794,6,7,6,7,19,21,-2,27
Terek Grozny,5794,7,7,6,7,21,26,-5,27
FK Rubin,5794,8,5,5,10,22,21,1,20
Amkar,5794,9,5,5,10,12,22,-10,20
Rostov,5794,10,4,6,10,11,20,-9,18
Anzhi,5794,11,2,6,12,15,40,-25,12
Loko Moscow,5795,1,12,6,2,33,13,20,42
CSKA Moscow,5795,2,12,3,5,31,19,12,39
Terek Grozny,5795,3,9,5,6,26,26,0,32
Spart Moscow,5795,4,8,7,5,36,29,7,31
Zenit,5795,5,7,9,4,23,17,6,30
Krasnodar,5795,6,8,4,8,27,29,-2,28
FK Rubin,5795,7,7,5,8,25,17,8,26
Din Moscow,5795,8,6,6,8,18,22,-4,24
Rostov,5795,9,4,7,9,11,18,-7,19
Amkar,5795,10,4,5,11,12,26,-14,17
Anzhi,5795,11,2,5,13,19,45,-26,11
Loko Moscow,5796,1,12,5,3,31,12,19,41
CSKA Moscow,5796,2,11,4,5,29,20,9,37
Zenit,5796,3,8,9,3,23,14,9,33
Spart Moscow,5796,4,9,5,6,37,31,6,32
Terek Grozny,5796,5,8,6,6,21,22,-1,30
Krasnodar,5796,6,8,4,8,27,28,-1,28
Din Moscow,5796,7,7,6,7,19,21,-2,27
FK Rubin,5796,8,6,5,9,23,18,5,23
Amkar,5796,9,5,4,11,12,24,-12,19
Rostov,5796,10,4,6,10,12,20,-8,18
Anzhi,5796,11,2,6,12,16,40,-24,12
Loko Moscow,5797,1,13,5,2,33,12,21,44
CSKA Moscow,5797,2,11,4,5,27,18,9,37
Krasnodar,5797,3,9,4,7,31,27,4,31
Zenit,5797,4,7,9,4,21,15,6,30
Spart Moscow,5797,5,8,6,6,37,33,4,30
Terek Grozny,5797,6,8,6,6,22,23,-1,30
FK Rubin,5797,7,6,5,9,23,20,3,23
Din Moscow,5797,8,5,7,8,18,23,-5,22
Rostov,5797,9,5,6,9,13,18,-5,21
Amkar,5797,10,5,5,10,14,25,-11,20
Anzhi,5797,11,2,5,13,15,40,-25,11
Loko Moscow,5798,1,12,5,3,31,13,18,41
Spart Moscow,5798,2,11,5,4,40,28,12,38
CSKA Moscow,5798,3,11,4,5,26,17,9,37
Zenit,5798,4,8,9,3,22,13,9,33
Krasnodar,5798,5,9,4,7,32,29,3,31
Terek Grozny,5798,6,7,6,7,21,26,-5,27
FK Rubin,5798,7,6,5,9,27,22,5,23
Din Moscow,5798,8,5,6,9,21,28,-7,21
Rostov,5798,9,4,6,10,10,19,-9,18
Amkar,5798,10,4,5,11,10,24,-14,17
Anzhi,5798,11,3,5,12,17,38,-21,14
Loko Moscow,5799,1,12,6,2,34,14,20,42
CSKA Moscow,5799,2,11,3,6,26,18,8,36
Spart Moscow,5799,3,9,7,4,37,28,9,34
Zenit,5799,4,8,8,4,23,16,7,32
Krasnodar,5799,5,8,6,6,31,28,3,30
Terek Grozny,5799,6,7,5,8,21,26,-5,26
Din Moscow,5799,7,6,7,7,21,24,-3,25
FK Rubin,5799,8,5,6,9,25,22,3,21
Amkar,5799,9,5,5,10,12,23,-11,20
Rostov,5799,10,4,6,10,11,19,-8,18
Anzhi,5799,11,3,5,12,16,39,-23,14
Spart Moscow,5800,1,11,5,4,44,28,16,38
Loko Moscow,5800,2,11,5,4,29,13,16,38
CSKA Moscow,5800,3,11,4,5,29,19,10,37
Krasnodar,5800,4,10,4,6,30,25,5,34
Zenit,5800,5,8,9,3,23,14,9,33
Terek Grozny,5800,6,8,5,7,21,24,-3,29
Din Moscow,5800,7,6,6,8,21,25,-4,24
FK Rubin,5800,8,5,5,10,22,21,1,20
Amkar,5800,9,5,4,11,12,24,-12,19
Rostov,5800,10,4,6,10,10,22,-12,18
Anzhi,5800,11,2,5,13,15,41,-26,11
Loko Moscow,5801,1,11,6,3,30,13,17,39
CSKA Moscow,5801,2,12,3,5,30,17,13,39
Spart Moscow,5801,3,9,6,5,37,29,8,33
Zenit,5801,4,8,8,4,22,15,7,32
Krasnodar,5801,5,8,5,7,28,29,-1,29
Terek Grozny,5801,6,8,5,7,22,25,-3,29
Din Moscow,5801,7,6,6,8,19,23,-4,24
FK Rubin,5801,8,6,5,9,26,19,7,23
Rostov,5801,9,5,6,9,13,19,-6,21
Amkar,5801,10,5,5,10,12,23,-11,20
Anzhi,5801,11,2,5,13,15,42,-27,11
Loko Moscow,5802,1,11,6,3,29,14,15,39
Spart Moscow,5802,2,10,6,4,38,26,12,36
CSKA Moscow,5802,3,11,3,6,29,19,10,36
Zenit,5802,4,8,9,3,23,14,9,33
Krasnodar,5802,5,9,4,7,31,26,5,31
Terek Grozny,5802,6,8,5,7,25,27,-2,29
Din Moscow,5802,7,6,7,7,20,23,-3,25
FK Rubin,5802,8,6,5,9,24,20,4,23
Amkar,5802,9,5,4,11,13,25,-12,19
Rostov,5802,10,4,6,10,10,20,-10,18
Anzhi,5802,11,2,5,13,15,43,-28,11
Loko Moscow,5803,1,11,6,3,30,14,16,39
CSKA Moscow,5803,2,11,4,5,28,17,11,37
Spart Moscow,5803,3,9,7,4,38,28,10,34
Zenit,5803,4,8,9,3,23,13,10,33
Krasnodar,5803,5,9,5,6,30,25,5,32
Terek Grozny,5803,6,7,5,8,20,24,-4,26
Din Moscow,5803,7,5,7,8,17,23,-6,22
FK Rubin,5803,8,5,6,9,21,19,2,21
Amkar,5803,9,5,5,10,10,22,-12,20
Rostov,5803,10,4,7,9,13,20,-7,19
Anzhi,5803,11,3,5,12,15,40,-25,14
Loko Moscow,5804,1,12,6,2,32,13,19,42
CSKA Moscow,5804,2,12,3,5,30,17,13,39
Spart Moscow,5804,3,11,5,4,42,29,13,38
Zenit,5804,4,7,9,4,22,16,6,30
Terek Grozny,5804,5,8,6,6,22,22,0,30
Krasnodar,5804,6,8,4,8,29,28,1,28
FK Rubin,5804,7,6,6,8,24,19,5,24
Din Moscow,5804,8,5,7,8,19,24,-5,22
Rostov,5804,9,4,6,10,11,21,-10,18
Amkar,5804,10,4,4,12,11,27,-16,16
Anzhi,5804,11,2,6,12,14,40,-26,12
Loko Moscow,5805,1,11,6,3,31,14,17,39
Spart Moscow,5805,2,10,5,5,41,28,13,35
CSKA Moscow,5805,3,10,5,5,29,21,8,35
Zenit,5805,4,8,9,3,25,16,9,33
Krasnodar,5805,5,9,5,6,31,27,4,32
Terek Grozny,5805,6,8,6,6,22,22,0,30
Din Moscow,5805,7,5,7,8,18,25,-7,22
FK Rubin,5805,8,5,6,9,23,20,3,21
Amkar,5805,9,5,4,11,12,24,-12,19
Rostov,5805,10,4,6,10,10,22,-12,18
Anzhi,5805,11,2,7,11,15,38,-23,13
Loko Moscow,5806,1,12,6,2,31,12,19,42
Spart Moscow,5806,2,10,6,4,41,25,16,36
CSKA Moscow,5806,3,11,3,6,29,22,7,36
Zenit,5806,4,8,9,3,25,13,12,33
Krasnodar,5806,5,8,4,8,28,29,-1,28
Terek Grozny,5806,6,7,5,8,20,25,-5,26
FK Rubin,5806,7,6,6,8,25,18,7,24
Din Moscow,5806,8,5,7,8,18,27,-9,22
Amkar,5806,9,5,5,10,10,22,-12,20
Rostov,5806,10,4,6,10,10,20,-10,18
Anzhi,5806,11,3,5,12,17,41,-24,14
Loko Moscow,5807,1,12,6,2,34,12,22,42
CSKA Moscow,5807,2,10,4,6,26,21,5,34
Spart Moscow,5807,3,9,5,6,40,32,8,32
Zenit,5807,4,8,8,4,24,17,7,32
Krasnodar,5807,5,9,5,6,30,25,5,32
Terek Grozny,5807,6,7,7,6,20,22,-2,28
Din Moscow,5807,7,6,7,7,21,24,-3,25
FK Rubin,5807,8,5,6,9,23,21,2,21
Rostov,5807,9,5,6,9,14,20,-6,21
Amkar,5807,10,4,5,11,10,25,-15,17
Anzhi,5807,11,2,7,11,15,38,-23,13
Loko Moscow,5808,1,12,5,3,32,14,18,41
Spart Moscow,5808,2,11,5,4,36,25,11,38
CSKA Moscow,5808,3,11,3,6,29,21,8,36
Zenit,5808,4,8,8,4,24,16,8,32
Krasnodar,5808,5,9,4,7,30,27,3,31
Terek Grozny,5808,6,8,5,7,23,25,-2,29
Din Moscow,5808,7,6,6,8,19,22,-3,24
FK Rubin,5808,8,6,5,9,23,20,3,23
Amkar,5808,9,5,4,11,10,23,-13,19
Rostov,5808,10,4,6,10,10,18,-8,18
Anzhi,5808,11,2,5,13,18,43,-25,11
Loko Moscow,5809,1,13,5,2,33,12,21,44
CSKA Moscow,5809,2,11,4,5,28,17,11,37
Spart Moscow,5809,3,9,5,6,38,31,7,32
Zenit,5809,4,7,8,5,22,18,4,29
Krasnodar,5809,5,8,4,8,27,28,-1,28
Din Moscow,5809,6,7,6,7,22,24,-2,27
Terek Grozny,5809,7,7,6,7,21,24,-3,27
FK Rubin,5809,8,6,5,9,24,19,5,23
Rostov,5809,9,5,6,9,12,17,-5,21
Amkar,5809,10,5,4,11,11,25,-14,19
Anzhi,5809,11,2,7,11,15,38,-23,13
Loko Moscow,5810,1,12,6,2,32,13,19,42
CSKA Moscow,5810,2,11,4,5,28,18,10,37
Spart Moscow,5810,3,9,6,5,38,30,8,33
Zenit,5810,4,7,9,4,22,15,7,30
Krasnodar,5810,5,8,5,7,30,28,2,29
Terek Grozny,5810,6,8,5,7,21,23,-2,29
Din Moscow,5810,7,6,7,7,19,22,-3,25
FK Rubin,5810,8,6,6,8,23,18,5,24
Amkar,5810,9,5,5,10,12,24,-12,20
Rostov,5810,10,4,6,10,11,19,-8,18
Anzhi,5810,11,2,5,13,14,40,-26,11
Loko Moscow,5811,1,11,7,2,29,11,18,40
Spart Moscow,5811,2,10,6,4,42,30,12,36
CSKA Moscow,5811,3,11,3,6,26,18,8,36
Zenit,5811,4,8,9,3,22,13,9,33
Terek Grozny,5811,5,9,5,6,24,24,0,32
Krasnodar,5811,6,8,6,6,28,25,3,30
FK Rubin,5811,7,5,7,8,22,18,4,22
Din Moscow,5811,8,5,7,8,19,25,-6,22
Rostov,5811,9,4,6,10,11,20,-9,18
Amkar,5811,10,4,5,11,12,26,-14,17
Anzhi,5811,11,2,5,13,15,40,-25,11
Loko Moscow,5812,1,13,5,2,32,11,21,44
CSKA Moscow,5812,2,12,3,5,30,18,12,39
Spart Moscow,5812,3,8,6,6,37,34,3,30
Terek Grozny,5812,4,8,6,6,21,22,-1,30
Zenit,5812,5,7,8,5,21,17,4,29
Krasnodar,5812,6,8,4,8,28,28,0,28
Din Moscow,5812,7,7,6,7,24,23,1,27
FK Rubin,5812,8,6,5,9,24,19,5,23
Amkar,5812,9,5,5,10,11,23,-12,20
Rostov,5812,10,4,7,9,11,18,-7,19
Anzhi,5812,11,2,5,13,15,41,-26,11
Loko Moscow,5813,1,12,6,2,33,13,20,42
CSKA Moscow,5813,2,12,3,5,28,18,10,39
Spart Moscow,5813,3,10,6,4,40,28,12,36
Zenit,5813,4,7,9,4,23,16,7,30
Terek Grozny,5813,5,8,6,6,22,23,-1,30
Krasnodar,5813,6,8,4,8,30,30,0,28
Din Moscow,5813,7,6,7,7,20,23,-3,25
FK Rubin,5813,8,6,5,9,25,21,4,23
Rostov,5813,9,4,6,10,11,20,-9,18
Amkar,5813,10,4,5,11,11,26,-15,17
Anzhi,5813,11,2,5,13,14,39,-25,11
Loko Moscow,5814,1,11,5,4,32,17,15,38
Spart Moscow,5814,2,10,6,4,39,26,13,36
CSKA Moscow,5814,3,11,3,6,27,19,8,36
Zenit,5814,4,9,8,3,25,14,11,35
Krasnodar,5814,5,9,5,6,31,27,4,32
Terek Grozny,5814,6,9,5,6,23,22,1,32
FK Rubin,5814,7,6,6,8,23,18,5,24
Din Moscow,5814,8,5,7,8,18,23,-5,22
Rostov,5814,9,4,6,10,10,20,-10,18
Amkar,5814,10,4,4,12,9,25,-16,16
Anzhi,5814,11,2,5,13,15,41,-26,11
Loko Moscow,5815,1,12,5,3,33,15,18,41
Spart Moscow,5815,2,10,5,5,39,29,10,35
CSKA Moscow,5815,3,10,5,5,28,20,8,35
Krasnodar,5815,4,9,5,6,33,27,6,32
Zenit,5815,5,7,9,4,23,18,5,30
Terek Grozny,5815,6,8,6,6,21,22,-1,30
FK Rubin,5815,7,6,6,8,27,22,5,24
Din Moscow,5815,8,5,6,9,20,28,-8,21
Amkar,5815,9,5,5,10,11,22,-11,20
Rostov,5815,10,4,6,10,11,19,-8,18
Anzhi,5815,11,2,6,12,16,40,-24,12
Loko Moscow,5816,1,12,6,2,32,12,20,42
Spart Moscow,5816,2,11,5,4,39,27,12,38
CSKA Moscow,5816,3,10,4,6,26,20,6,34
Zenit,5816,4,7,10,3,23,15,8,31
Krasnodar,5816,5,8,5,7,29,28,1,29
Terek Grozny,5816,6,8,5,7,23,25,-2,29
FK Rubin,5816,7,6,6,8,26,19,7,24
Din Moscow,5816,8,5,6,9,17,26,-9,21
Amkar,5816,9,5,4,11,11,24,-13,19
Rostov,5816,10,4,6,10,11,19,-8,18
Anzhi,5816,11,3,5,12,18,40,-22,14
Loko Moscow,5817,1,12,5,3,31,13,18,41
CSKA Moscow,5817,2,11,4,5,27,17,10,37
Spart Moscow,5817,3,10,6,4,36,25,11,36
Zenit,5817,4,8,8,4,22,15,7,32
Krasnodar,5817,5,9,4,7,30,27,3,31
Terek Grozny,5817,6,8,5,7,22,25,-3,29
Din Moscow,5817,7,6,6,8,20,23,-3,24
FK Rubin,5817,8,5,5,10,22,22,0,20
Rostov,5817,9,4,6,10,10,18,-8,18
Amkar,5817,10,4,5,11,10,24,-14,17
Anzhi,5817,11,3,6,11,16,37,-21,15
Loko Moscow,5818,1,12,6,2,33,13,20,42
CSKA Moscow,5818,2,12,3,5,30,17,13,39
Spart Moscow,5818,3,11,5,4,39,26,13,38
Krasnodar,5818,4,9,5,6,31,27,4,32
Zenit,5818,5,7,8,5,21,17,4,29
Terek Grozny,5818,6,8,5,7,24,26,-2,29
Din Moscow,5818,7,6,6,8,20,24,-4,24
FK Rubin,5818,8,5,5,10,23,21,2,20
Rostov,5818,9,4,6,10,10,19,-9,18
Amkar,5818,10,4,4,12,10,26,-16,16
Anzhi,5818,11,3,5,12,17,42,-25,14
Loko Moscow,5819,1,12,5,3,32,13,19,41
Spart Moscow,5819,2,10,6,4,38,27,11,36
CSKA Moscow,5819,3,11,3,6,26,19,7,36
Zenit,5819,4,9,8,3,25,14,11,35
Krasnodar,5819,5,9,4,7,32,27,5,31
Terek Grozny,5819,6,8,5,7,23,26,-3,29
Din Moscow,5819,7,6,7,7,20,22,-2,25
FK Rubin,5819,8,5,5,10,23,25,-2,20
Amkar,5819,9,5,4,11,13,25,-12,19
Rostov,5819,10,4,6,10,11,19,-8,18
Anzhi,5819,11,2,5,13,15,41,-26,11
Loko Moscow,5820,1,11,6,3,30,13,17,39
CSKA Moscow,5820,2,11,3,6,31,20,11,36
Spart Moscow,5820,3,9,7,4,38,27,11,34
Zenit,5820,4,8,9,3,24,15,9,33
Krasnodar,5820,5,9,4,7,30,27,3,31
Terek Grozny,5820,6,8,5,7,23,25,-2,29
FK Rubin,5820,7,7,5,8,24,18,6,26
Din Moscow,5820,8,5,6,9,18,26,-8,21
Amkar,5820,9,5,5,10,12,24,-12,20
Rostov,5820,10,4,7,9,10,17,-7,19
Anzhi,5820,11,2,5,13,15,43,-28,11
Loko Moscow,5821,1,12,6,2,35,16,19,42
Spart Moscow,5821,2,11,5,4,49,28,21,38
CSKA Moscow,5821,3,11,3,6,27,18,9,36
Zenit,5821,4,8,8,4,24,16,8,32
Krasnodar,5821,5,8,6,6,32,29,3,30
Terek Grozny,5821,6,7,6,7,21,24,-3,27
FK Rubin,5821,7,6,6,8,27,20,7,24
Din Moscow,5821,8,5,6,9,19,30,-11,21
Amkar,5821,9,5,4,11,12,27,-15,19
Rostov,5821,10,4,6,10,11,24,-13,18
Anzhi,5821,11,2,6,12,14,39,-25,12
Loko Moscow,5822,1,11,6,3,31,14,17,39
CSKA Moscow,5822,2,12,3,5,32,18,14,39
Spart Moscow,5822,3,10,5,5,37,27,10,35
Zenit,5822,4,8,8,4,24,17,7,32
Krasnodar,5822,5,9,5,6,30,25,5,32
Terek Grozny,5822,6,7,6,7,20,23,-3,27
Din Moscow,5822,7,6,6,8,19,23,-4,24
FK Rubin,5822,8,6,5,9,22,19,3,23
Amkar,5822,9,5,4,11,10,24,-14,19
Rostov,5822,10,4,6,10,10,18,-8,18
Anzhi,5822,11,2,6,12,14,41,-27,12
Loko Moscow,5823,1,12,5,3,31,12,19,41
CSKA Moscow,5823,2,10,4,6,25,21,4,34
Spart Moscow,5823,3,9,6,5,36,28,8,33
Zenit,5823,4,8,8,4,25,15,10,32
Krasnodar,5823,5,9,5,6,29,25,4,32
Terek Grozny,5823,6,7,6,7,21,25,-4,27
FK Rubin,5823,7,5,7,8,23,19,4,22
Din Moscow,5823,8,5,7,8,19,24,-5,22
Amkar,5823,9,5,5,10,11,23,-12,20
Rostov,5823,10,4,7,9,11,18,-7,19
Anzhi,5823,11,3,6,11,16,37,-21,15
Loko Moscow,5824,1,11,7,2,29,11,18,40
CSKA Moscow,5824,2,12,3,5,32,19,13,39
Zenit,5824,3,7,9,4,21,17,4,30
Terek Grozny,5824,4,8,6,6,22,23,-1,30
Spart Moscow,5824,5,8,5,7,35,31,4,29
Krasnodar,5824,6,8,5,7,27,25,2,29
Din Moscow,5824,7,7,6,7,20,22,-2,27
FK Rubin,5824,8,6,5,9,22,18,4,23
Rostov,5824,9,5,6,9,11,17,-6,21
Amkar,5824,10,5,5,10,13,24,-11,20
Anzhi,5824,11,2,5,13,16,41,-25,11
Loko Moscow,5825,1,11,6,3,29,13,16,39
Spart Moscow,5825,2,9,7,4,37,28,9,34
Krasnodar,5825,3,10,4,6,31,24,7,34
CSKA Moscow,5825,4,10,4,6,27,21,6,34
Zenit,5825,5,8,9,3,25,15,10,33
Terek Grozny,5825,6,7,6,7,20,23,-3,27
Din Moscow,5825,7,6,7,7,22,24,-2,25
FK Rubin,5825,8,5,5,10,22,22,0,20
Rostov,5825,9,4,7,9,11,18,-7,19
Amkar,5825,10,4,5,11,9,23,-14,17
Anzhi,5825,11,3,6,11,15,37,-22,15
Loko Moscow,5826,1,11,7,2,32,14,18,40
CSKA Moscow,5826,2,11,4,5,29,20,9,37
Spart Moscow,5826,3,9,6,5,36,27,9,33
Zenit,5826,4,7,10,3,24,16,8,31
Krasnodar,5826,5,8,6,6,30,27,3,30
Din Moscow,5826,6,7,6,7,19,21,-2,27
Terek Grozny,5826,7,7,6,7,21,24,-3,27
FK Rubin,5826,8,5,6,9,22,19,3,21
Amkar,5826,9,5,5,10,11,23,-12,20
Rostov,5826,10,4,6,10,10,19,-9,18
Anzhi,5826,11,2,6,12,16,40,-24,12
Loko Moscow,5827,1,11,6,3,31,15,16,39
CSKA Moscow,5827,2,11,3,6,26,18,8,36
Zenit,5827,3,9,8,3,24,13,11,35
Spart Moscow,5827,4,9,6,5,36,28,8,33
Krasnodar,5827,5,9,5,6,30,26,4,32
Terek Grozny,5827,6,8,5,7,22,24,-2,29
Din Moscow,5827,7,6,6,8,21,25,-4,24
FK Rubin,5827,8,6,5,9,24,20,4,23
Amkar,5827,9,5,5,10,11,23,-12,20
Rostov,5827,10,4,6,10,10,18,-8,18
Anzhi,5827,11,2,5,13,15,40,-25,11
Loko Moscow,5828,1,12,6,2,30,11,19,42
CSKA Moscow,5828,2,11,4,5,29,19,10,37
Spart Moscow,5828,3,9,6,5,36,27,9,33
Zenit,5828,4,7,10,3,23,15,8,31
Terek Grozny,5828,5,8,6,6,23,24,-1,30
Krasnodar,5828,6,8,4,8,28,27,1,28
FK Rubin,5828,7,6,6,8,24,19,5,24
Din Moscow,5828,8,5,8,7,19,23,-4,23
Amkar,5828,9,5,5,10,11,23,-12,20
Rostov,5828,10,4,6,10,10,19,-9,18
Anzhi,5828,11,2,5,13,15,41,-26,11
Loko Moscow,5829,1,12,6,2,33,13,20,42
Spart Moscow,5829,2,11,5,4,40,27,13,38
CSKA Moscow,5829,3,11,4,5,28,18,10,37
Zenit,5829,4,7,10,3,22,14,8,31
Krasnodar,5829,5,9,4,7,31,27,4,31
Terek Grozny,5829,6,8,5,7,21,23,-2,29
FK Rubin,5829,7,6,5,9,24,20,4,23
Din Moscow,5829,8,5,6,9,17,27,-10,21
Amkar,5829,9,5,4,11,11,24,-13,19
Rostov,5829,10,4,6,10,11,19,-8,18
Anzhi,5829,11,2,5,13,15,41,-26,11
Loko Moscow,5830,1,12,5,3,31,14,17,41
Spart Moscow,5830,2,11,5,4,37,25,12,38
CSKA Moscow,5830,3,11,3,6,26,18,8,36
Krasnodar,5830,4,9,4,7,29,28,1,31
Zenit,5830,5,7,8,5,22,16,6,29
Terek Grozny,5830,6,7,6,7,21,24,-3,27
FK Rubin,5830,7,7,5,8,27,18,9,26
Din Moscow,5830,8,5,6,9,18,24,-6,21
Rostov,5830,9,4,6,10,10,19,-9,18
Amkar,5830,10,4,5,11,9,23,-14,17
Anzhi,5830,11,4,5,11,17,38,-21,17
Loko Moscow,5831,1,13,5,2,34,12,22,44
CSKA Moscow,5831,2,12,3,5,29,18,11,39
Spart Moscow,5831,3,10,6,4,37,26,11,36
Krasnodar,5831,4,9,4,7,30,27,3,31
Zenit,5831,5,7,8,5,23,17,6,29
Terek Grozny,5831,6,7,5,8,21,27,-6,26
FK Rubin,5831,7,6,5,9,23,21,2,23
Din Moscow,5831,8,5,7,8,19,24,-5,22
Amkar,5831,9,5,4,11,12,24,-12,19
Rostov,5831,10,4,6,10,10,19,-9,18
Anzhi,5831,11,3,5,12,16,39,-23,14
Loko Moscow,5832,1,12,5,3,31,15,16,41
CSKA Moscow,5832,2,11,3,6,26,19,7,36
Spart Moscow,5832,3,9,6,5,36,28,8,33
Zenit,5832,4,8,8,4,24,15,9,32
Terek Grozny,5832,5,9,5,6,25,22,3,32
Krasnodar,5832,6,9,4,7,31,26,5,31
Din Moscow,5832,7,6,6,8,19,22,-3,24
FK Rubin,5832,8,6,5,9,23,20,3,23
Rostov,5832,9,4,7,9,11,18,-7,19
Amkar,5832,10,5,4,11,11,26,-15,19
Anzhi,5832,11,2,5,13,14,40,-26,11
Loko Moscow,5833,1,13,5,2,33,13,20,44
CSKA Moscow,5833,2,11,3,6,26,19,7,36
Spart Moscow,5833,3,10,5,5,39,27,12,35
Zenit,5833,4,8,8,4,25,16,9,32
Krasnodar,5833,5,8,4,8,27,26,1,28
Terek Grozny,5833,6,7,6,7,20,23,-3,27
Din Moscow,5833,7,6,6,8,19,25,-6,24
FK Rubin,5833,8,6,5,9,22,18,4,23
Amkar,5833,9,6,4,10,11,22,-11,22
Rostov,5833,10,4,6,10,10,19,-9,18
Anzhi,5833,11,2,6,12,14,38,-24,12
Loko Moscow,5834,1,11,6,3,29,13,16,39
CSKA Moscow,5834,2,12,3,5,28,18,10,39
Krasnodar,5834,3,9,5,6,30,25,5,32
Spart Moscow,5834,4,8,7,5,36,29,7,31
Zenit,5834,5,7,9,4,22,15,7,30
Terek Grozny,5834,6,7,5,8,21,25,-4,26
FK Rubin,5834,7,6,6,8,25,20,5,24
Din Moscow,5834,8,6,6,8,21,25,-4,24
Amkar,5834,9,5,5,10,10,22,-12,20
Rostov,5834,10,4,7,9,12,19,-7,19
Anzhi,5834,11,3,5,12,16,39,-23,14
Loko Moscow,5835,1,13,5,2,31,11,20,44
CSKA Moscow,5835,2,12,3,5,28,18,10,39
Spart Moscow,5835,3,9,6,5,38,29,9,33
Zenit,5835,4,7,8,5,21,15,6,29
Krasnodar,5835,5,8,4,8,27,26,1,28
Terek Grozny,5835,6,7,7,6,20,22,-2,28
FK Rubin,5835,7,7,5,8,24,18,6,26
Din Moscow,5835,8,6,6,8,19,23,-4,24
Rostov,5835,9,4,6,10,12,21,-9,18
Amkar,5835,10,4,6,10,10,23,-13,18
Anzhi,5835,11,2,6,12,15,39,-24,12
Loko Moscow,5836,1,12,5,3,33,13,20,41
Spart Moscow,5836,2,10,6,4,37,26,11,36
CSKA Moscow,5836,3,10,4,6,29,22,7,34
Krasnodar,5836,4,9,5,6,29,25,4,32
Zenit,5836,5,7,9,4,24,19,5,30
Terek Grozny,5836,6,7,6,7,21,24,-3,27
Din Moscow,5836,7,5,8,7,18,22,-4,23
FK Rubin,5836,8,5,7,8,23,19,4,22
Amkar,5836,9,5,4,11,10,24,-14,19
Rostov,5836,10,4,6,10,11,19,-8,18
Anzhi,5836,11,3,6,11,18,40,-22,15
Loko Moscow,5837,1,12,5,3,32,14,18,41
Spart Moscow,5837,2,10,6,4,39,27,12,36
Krasnodar,5837,3,10,4,6,31,26,5,34
CSKA Moscow,5837,4,10,3,7,25,20,5,33
Zenit,5837,5,8,8,4,24,15,9,32
Terek Grozny,5837,6,8,6,6,24,25,-1,30
Din Moscow,5837,7,5,7,8,18,25,-7,22
FK Rubin,5837,8,5,6,9,22,19,3,21
Rostov,5837,9,4,7,9,11,18,-7,19
Amkar,5837,10,4,5,11,11,25,-14,17
Anzhi,5837,11,3,5,12,16,39,-23,14
Loko Moscow,5838,1,13,5,2,33,12,21,44
CSKA Moscow,5838,2,11,3,6,27,19,8,36
Spart Moscow,5838,3,10,5,5,36,28,8,35
Zenit,5838,4,8,8,4,23,16,7,32
Krasnodar,5838,5,8,4,8,29,29,0,28
Terek Grozny,5838,6,7,5,8,21,26,-5,26
FK Rubin,5838,7,6,6,8,24,18,6,24
Din Moscow,5838,8,5,7,8,17,22,-5,22
Rostov,5838,9,5,6,9,12,17,-5,21
Amkar,5838,10,5,4,11,12,24,-12,19
Anzhi,5838,11,3,5,12,16,39,-23,14
Loko Moscow,5839,1,13,5,2,31,11,20,44
CSKA Moscow,5839,2,12,3,5,30,19,11,39
Spart Moscow,5839,3,9,5,6,39,31,8,32
Krasnodar,5839,4,9,4,7,28,25,3,31
Zenit,5839,5,7,8,5,21,15,6,29
Terek Grozny,5839,6,8,5,7,22,23,-1,29
Din Moscow,5839,7,5,7,8,20,26,-6,22
Amkar,5839,8,6,4,10,12,23,-11,22
FK Rubin,5839,9,5,6,9,23,20,3,21
Rostov,5839,10,5,6,9,13,19,-6,21
Anzhi,5839,11,2,5,13,16,43,-27,11
Loko Moscow,5840,1,12,6,2,31,12,19,42
Spart Moscow,5840,2,10,6,4,40,28,12,36
CSKA Moscow,5840,3,10,4,6,27,20,7,34
Zenit,5840,4,8,9,3,23,14,9,33
Krasnodar,5840,5,9,4,7,29,26,3,31
Terek Grozny,5840,6,8,6,6,21,22,-1,30
Din Moscow,5840,7,6,7,7,20,23,-3,25
FK Rubin,5840,8,5,5,10,23,21,2,20
Rostov,5840,9,4,6,10,10,20,-10,18
Amkar,5840,10,4,5,11,12,26,-14,17
Anzhi,5840,11,2,6,12,15,39,-24,12
Loko Moscow,5841,1,12,5,3,32,14,18,41
CSKA Moscow,5841,2,12,3,5,29,17,12,39
Spart Moscow,5841,3,10,5,5,40,30,10,35
Krasnodar,5841,4,10,4,6,35,28,7,34
Zenit,5841,5,7,8,5,21,15,6,29
Terek Grozny,5841,6,7,5,8,21,27,-6,26
Din Moscow,5841,7,6,6,8,21,24,-3,24
FK Rubin,5841,8,6,5,9,25,23,2,23
Amkar,5841,9,5,4,11,12,25,-13,19
Rostov,5841,10,4,6,10,10,20,-10,18
Anzhi,5841,11,3,5,12,18,41,-23,14
Loko Moscow,5842,1,11,5,4,31,16,15,38
Zenit,5842,2,9,8,3,24,13,11,35
Spart Moscow,5842,3,10,5,5,37,28,9,35
CSKA Moscow,5842,4,10,4,6,25,18,7,34
Krasnodar,5842,5,10,4,6,32,26,6,34
Terek Grozny,5842,6,8,6,6,21,22,-1,30
FK Rubin,5842,7,6,5,9,22,19,3,23
Din Moscow,5842,8,5,6,9,17,23,-6,21
Amkar,5842,9,5,5,10,11,23,-12,20
Rostov,5842,10,4,6,10,11,19,-8,18
Anzhi,5842,11,2,6,12,14,38,-24,12
Loko Moscow,5843,1,12,5,3,33,13,20,41
CSKA Moscow,5843,2,11,4,5,29,20,9,37
Spart Moscow,5843,3,9,6,5,35,26,9,33
Krasnodar,5843,4,9,5,6,29,25,4,32
Zenit,5843,5,7,9,4,22,17,5,30
Terek Grozny,5843,6,7,5,8,20,27,-7,26
Din Moscow,5843,7,5,8,7,18,22,-4,23
FK Rubin,5843,8,5,7,8,22,18,4,22
Rostov,5843,9,5,6,9,11,17,-6,21
Amkar,5843,10,5,4,11,11,24,-13,19
Anzhi,5843,11,3,5,12,19,40,-21,14
Loko Moscow,5844,1,12,5,3,31,13,18,41
CSKA Moscow,5844,2,11,3,6,28,20,8,36
Krasnodar,5844,3,10,4,6,33,24,9,34
Spart Moscow,5844,4,9,6,5,37,29,8,33
Zenit,5844,5,7,8,5,21,17,4,29
Terek Grozny,5844,6,8,5,7,22,24,-2,29
Din Moscow,5844,7,6,7,7,19,22,-3,25
Rostov,5844,8,5,6,9,13,19,-6,21
FK Rubin,5844,9,5,5,10,21,22,-1,20
Anzhi,5844,10,4,5,11,19,39,-20,17
Amkar,5844,11,4,4,12,9,24,-15,16
Loko Moscow,5845,1,11,6,3,29,12,17,39
CSKA Moscow,5845,2,11,4,5,30,19,11,37
Spart Moscow,5845,3,9,6,5,38,29,9,33
Zenit,5845,4,7,10,3,23,15,8,31
Krasnodar,5845,5,9,4,7,29,26,3,31
Terek Grozny,5845,6,7,5,8,20,27,-7,26
Din Moscow,5845,7,6,6,8,18,24,-6,24
FK Rubin,5845,8,6,5,9,23,19,4,23
Rostov,5845,9,5,6,9,13,18,-5,21
Amkar,5845,10,5,5,10,11,23,-12,20
Anzhi,5845,11,3,5,12,18,40,-22,14
Loko Moscow,5846,1,12,5,3,32,15,17,41
CSKA Moscow,5846,2,11,4,5,28,19,9,37
Spart Moscow,5846,3,10,6,4,39,27,12,36
Krasnodar,5846,4,10,4,6,33,26,7,34
Zenit,5846,5,7,8,5,23,17,6,29
Terek Grozny,5846,6,7,5,8,20,25,-5,26
Din Moscow,5846,7,5,8,7,20,24,-4,23
FK Rubin,5846,8,5,6,9,23,21,2,21
Amkar,5846,9,5,4,11,11,24,-13,19
Rostov,5846,10,4,6,10,10,19,-9,18
Anzhi,5846,11,3,6,11,16,38,-22,15
Loko Moscow,5847,1,13,5,2,35,13,22,44
Spart Moscow,5847,2,11,5,4,39,25,14,38
CSKA Moscow,5847,3,11,4,5,28,18,10,37
Krasnodar,5847,4,9,4,7,31,27,4,31
Zenit,5847,5,7,8,5,21,18,3,29
Terek Grozny,5847,6,8,5,7,23,25,-2,29
Din Moscow,5847,7,5,7,8,17,23,-6,22
FK Rubin,5847,8,5,6,9,21,19,2,21
Rostov,5847,9,4,6,10,10,20,-10,18
Amkar,5847,10,4,4,12,9,24,-15,16
Anzhi,5847,11,3,6,11,18,40,-22,15
Loko Moscow,5848,1,13,5,2,33,11,22,44
CSKA Moscow,5848,2,12,3,5,30,17,13,39
Terek Grozny,5848,3,9,5,6,24,24,0,32
Spart Moscow,5848,4,8,6,6,35,30,5,30
Zenit,5848,5,7,8,5,21,18,3,29
Krasnodar,5848,6,8,5,7,27,25,2,29
FK Rubin,5848,7,6,6,8,26,17,9,24
Din Moscow,5848,8,6,6,8,19,27,-8,24
Rostov,5848,9,4,7,9,11,18,-7,19
Amkar,5848,10,5,4,11,11,23,-12,19
Anzhi,5848,11,2,5,13,16,43,-27,11
Loko Moscow,5849,1,13,5,2,33,12,21,44
CSKA Moscow,5849,2,11,4,5,28,19,9,37
Spart Moscow,5849,3,9,7,4,37,26,11,34
Terek Grozny,5849,4,9,5,6,23,23,0,32
Krasnodar,5849,5,9,4,7,30,26,4,31
Zenit,5849,6,7,9,4,22,16,6,30
FK Rubin,5849,7,6,5,9,23,19,4,23
Din Moscow,5849,8,5,7,8,18,24,-6,22
Rostov,5849,9,4,6,10,10,20,-10,18
Amkar,5849,10,4,5,11,10,24,-14,17
Anzhi,5849,11,2,5,13,15,40,-25,11
Loko Moscow,5850,1,12,6,2,31,12,19,42
CSKA Moscow,5850,2,11,4,5,30,19,11,37
Spart Moscow,5850,3,9,5,6,39,32,7,32
Zenit,5850,4,7,10,3,22,14,8,31
Terek Grozny,5850,5,8,5,7,22,25,-3,29
Krasnodar,5850,6,8,4,8,28,27,1,28
Din Moscow,5850,7,6,6,8,23,25,-2,24
FK Rubin,5850,8,6,5,9,22,20,2,23
Amkar,5850,9,6,4,10,14,24,-10,22
Rostov,5850,10,5,6,9,12,18,-6,21
Anzhi,5850,11,2,5,13,15,42,-27,11
Loko Moscow,5851,1,12,5,3,32,12,20,41
CSKA Moscow,5851,2,12,3,5,31,18,13,39
Spart Moscow,5851,3,11,5,4,44,26,18,38
Zenit,5851,4,8,8,4,22,16,6,32
Terek Grozny,5851,5,8,6,6,22,23,-1,30
Krasnodar,5851,6,8,5,7,27,27,0,29
Din Moscow,5851,7,6,6,8,21,24,-3,24
FK Rubin,5851,8,5,6,9,21,21,0,21
Rostov,5851,9,4,6,10,10,21,-11,18
Amkar,5851,10,4,4,12,10,27,-17,16
Anzhi,5851,11,2,6,12,16,41,-25,12
Loko Moscow,5852,1,12,6,2,33,13,20,42
CSKA Moscow,5852,2,11,3,6,27,20,7,36
Spart Moscow,5852,3,9,6,5,36,28,8,33
Zenit,5852,4,8,8,4,25,17,8,32
Krasnodar,5852,5,9,5,6,32,27,5,32
Terek Grozny,5852,6,7,7,6,22,24,-2,28
Din Moscow,5852,7,6,6,8,21,24,-3,24
FK Rubin,5852,8,6,5,9,26,23,3,23
Rostov,5852,9,4,6,10,11,20,-9,18
Amkar,5852,10,4,6,10,10,23,-13,18
Anzhi,5852,11,2,6,12,15,39,-24,12
Loko Moscow,5853,1,11,5,4,29,14,15,38
CSKA Moscow,5853,2,11,4,5,27,18,9,37
Spart Moscow,5853,3,10,5,5,41,28,13,35
Zenit,5853,4,8,9,3,23,14,9,33
Krasnodar,5853,5,9,4,7,31,27,4,31
Terek Grozny,5853,6,8,5,7,21,25,-4,29
FK Rubin,5853,7,7,5,8,25,19,6,26
Din Moscow,5853,8,5,6,9,19,25,-6,21
Rostov,5853,9,5,6,9,11,17,-6,21
Amkar,5853,10,5,4,11,12,27,-15,19
Anzhi,5853,11,2,5,13,14,39,-25,11
Loko Moscow,5854,1,12,5,3,30,13,17,41
Spart Moscow,5854,2,10,5,5,38,29,9,35
CSKA Moscow,5854,3,10,3,7,26,21,5,33
Zenit,5854,4,8,8,4,22,14,8,32
Krasnodar,5854,5,9,5,6,30,25,5,32
Terek Grozny,5854,6,8,6,6,22,23,-1,30
Din Moscow,5854,7,7,6,7,22,23,-1,27
FK Rubin,5854,8,5,6,9,23,20,3,21
Rostov,5854,9,4,6,10,11,19,-8,18
Amkar,5854,10,4,5,11,10,25,-15,17
Anzhi,5854,11,3,5,12,17,39,-22,14
Loko Moscow,5855,1,12,5,3,32,14,18,41
Spart Moscow,5855,2,10,6,4,37,25,12,36
CSKA Moscow,5855,3,11,3,6,27,20,7,36
Zenit,5855,4,9,8,3,25,13,12,35
Krasnodar,5855,5,8,5,7,28,27,1,29
Terek Grozny,5855,6,8,5,7,23,23,0,29
FK Rubin,5855,7,5,7,8,22,18,4,22
Din Moscow,5855,8,5,7,8,18,24,-6,22
Rostov,5855,9,4,7,9,10,17,-7,19
Amkar,5855,10,5,4,11,10,24,-14,19
Anzhi,5855,11,2,5,13,15,42,-27,11
Loko Moscow,5856,1,11,6,3,30,15,15,39
CSKA Moscow,5856,2,12,3,5,29,17,12,39
Spart Moscow,5856,3,11,5,4,41,28,13,38
Krasnodar,5856,4,10,4,6,32,24,8,34
Zenit,5856,5,7,9,4,22,15,7,30
Terek Grozny,5856,6,8,5,7,21,23,-2,29
FK Rubin,5856,7,6,5,9,22,19,3,23
Din Moscow,5856,8,5,6,9,18,25,-7,21
Amkar,5856,9,5,4,11,11,24,-13,19
Rostov,5856,10,4,6,10,11,20,-9,18
Anzhi,5856,11,2,5,13,14,41,-27,11
Loko Moscow,5857,1,11,5,4,29,16,13,38
CSKA Moscow,5857,2,11,3,6,29,19,10,36
Zenit,5857,3,9,8,3,23,13,10,35
Spart Moscow,5857,4,9,6,5,38,29,9,33
Krasnodar,5857,5,9,5,6,31,24,7,32
Terek Grozny,5857,6,8,5,7,23,25,-2,29
Din Moscow,5857,7,6,7,7,20,23,-3,25
FK Rubin,5857,8,5,7,8,22,18,4,22
Rostov,5857,9,4,7,9,11,18,-7,19
Amkar,5857,10,5,4,11,13,26,-13,19
Anzhi,5857,11,2,5,13,15,43,-28,11
Loko Moscow,5858,1,12,6,2,32,12,20,42
CSKA Moscow,5858,2,11,3,6,27,20,7,36
Spart Moscow,5858,3,10,5,5,39,29,10,35
Zenit,5858,4,8,8,4,24,15,9,32
Krasnodar,5858,5,8,6,6,29,26,3,30
Terek Grozny,5858,6,8,5,7,21,23,-2,29
Din Moscow,5858,7,6,6,8,20,24,-4,24
FK Rubin,5858,8,5,6,9,22,20,2,21
Rostov,5858,9,5,6,9,12,17,-5,21
Amkar,5858,10,5,4,11,11,25,-14,19
Anzhi,5858,11,2,5,13,14,40,-26,11
Loko Moscow,5859,1,12,6,2,31,12,19,42
CSKA Moscow,5859,2,12,3,5,29,17,12,39
Spart Moscow,5859,3,10,5,5,39,29,10,35
Krasnodar,5859,4,9,5,6,29,25,4,32
Terek Grozny,5859,5,9,5,6,27,23,4,32
Zenit,5859,6,7,8,5,21,15,6,29
FK Rubin,5859,7,6,5,9,22,18,4,23
Din Moscow,5859,8,5,6,9,17,23,-6,21
Amkar,5859,9,5,4,11,13,27,-14,19
Rostov,5859,10,4,6,10,11,20,-9,18
Anzhi,5859,11,2,5,13,14,44,-30,11
Loko Moscow,5860,1,11,6,3,30,13,17,39
Spart Moscow,5860,2,11,5,4,43,29,14,38
CSKA Moscow,5860,3,11,3,6,28,19,9,36
Krasnodar,5860,4,9,5,6,30,26,4,32
Zenit,5860,5,7,9,4,21,15,6,30
Terek Grozny,5860,6,7,5,8,21,27,-6,26
FK Rubin,5860,7,5,7,8,23,19,4,22
Din Moscow,5860,8,5,7,8,20,26,-6,22
Amkar,5860,9,5,4,11,13,25,-12,19
Rostov,5860,10,4,6,10,11,20,-9,18
Anzhi,5860,11,4,5,11,18,39,-21,17
Loko Moscow,5861,1,12,6,2,32,13,19,42
CSKA Moscow,5861,2,11,4,5,29,19,10,37
Spart Moscow,5861,3,10,6,4,40,29,11,36
Zenit,5861,4,7,9,4,23,17,6,30
Krasnodar,5861,5,8,5,7,29,27,2,29
Terek Grozny,5861,6,7,6,7,21,25,-4,27
Din Moscow,5861,7,5,8,7,18,22,-4,23
FK Rubin,5861,8,5,7,8,22,18,4,22
Amkar,5861,9,5,4,11,12,25,-13,19
Rostov,5861,10,4,6,10,12,20,-8,18
Anzhi,5861,11,2,7,11,16,39,-23,13
Loko Moscow,5862,1,12,5,3,31,13,18,41
CSKA Moscow,5862,2,11,4,5,29,20,9,37
Spart Moscow,5862,3,10,6,4,40,30,10,36
Zenit,5862,4,8,9,3,24,15,9,33
Terek Grozny,5862,5,8,5,7,22,24,-2,29
Krasnodar,5862,6,8,4,8,29,29,0,28
FK Rubin,5862,7,7,5,8,27,18,9,26
Din Moscow,5862,8,5,6,9,18,26,-8,21
Rostov,5862,9,4,6,10,12,20,-8,18
Amkar,5862,10,4,5,11,11,25,-14,17
Anzhi,5862,11,3,5,12,17,40,-23,14
CSKA Moscow,5863,1,12,3,5,27,17,10,39
Loko Moscow,5863,2,11,5,4,31,16,15,38
Spart Moscow,5863,3,10,6,4,36,26,10,36
Zenit,5863,4,8,8,4,25,16,9,32
Krasnodar,5863,5,9,4,7,28,27,1,31
Terek Grozny,5863,6,7,6,7,20,24,-4,27
FK Rubin,5863,7,7,5,8,25,17,8,26
Din Moscow,5863,8,5,6,9,17,23,-6,21
Rostov,5863,9,4,6,10,10,18,-8,18
Amkar,5863,10,4,6,10,10,23,-13,18
Anzhi,5863,11,3,5,12,16,38,-22,14
Loko Moscow,5864,1,11,6,3,29,13,16,39
Spart Moscow,5864,2,11,5,4,41,28,13,38
CSKA Moscow,5864,3,11,3,6,27,20,7,36
Zenit,5864,4,9,8,3,25,13,12,35
Krasnodar,5864,5,9,5,6,28,24,4,32
Terek Grozny,5864,6,9,5,6,24,23,1,32
Din Moscow,5864,7,6,6,8,19,23,-4,24
FK Rubin,5864,8,5,5,10,21,19,2,20
Rostov,5864,9,4,6,10,10,20,-10,18
Amkar,5864,10,4,4,12,11,27,-16,16
Anzhi,5864,11,2,5,13,16,41,-25,11
Loko Moscow,5865,1,12,6,2,32,12,20,42
Spart Moscow,5865,2,10,6,4,36,26,10,36
CSKA Moscow,5865,3,10,3,7,26,22,4,33
Zenit,5865,4,8,8,4,23,15,8,32
Krasnodar,5865,5,9,5,6,29,25,4,32
Terek Grozny,5865,6,8,6,6,23,24,-1,30
FK Rubin,5865,7,6,5,9,24,19,5,23
Din Moscow,5865,8,5,6,9,18,25,-7,21
Rostov,5865,9,4,6,10,10,18,-8,18
Amkar,5865,10,4,5,11,11,25,-14,17
Anzhi,5865,11,3,6,11,18,39,-21,15
Loko Moscow,5866,1,13,5,2,32,12,20,44
CSKA Moscow,5866,2,11,3,6,29,20,9,36
Spart Moscow,5866,3,9,7,4,39,29,10,34
Terek Grozny,5866,4,9,5,6,25,24,1,32
Zenit,5866,5,7,8,5,21,16,5,29
Krasnodar,5866,6,8,5,7,29,27,2,29
Din Moscow,5866,7,5,8,7,21,25,-4,23
FK Rubin,5866,8,5,7,8,24,20,4,22
Rostov,5866,9,4,7,9,11,18,-7,19
Amkar,5866,10,4,4,12,12,28,-16,16
Anzhi,5866,11,3,5,12,17,41,-24,14
Loko Moscow,5867,1,11,6,3,32,15,17,39
Spart Moscow,5867,2,11,5,4,44,25,19,38
CSKA Moscow,5867,3,11,3,6,27,19,8,36
Zenit,5867,4,8,9,3,25,16,9,33
Krasnodar,5867,5,9,4,7,29,27,2,31
Terek Grozny,5867,6,8,5,7,22,23,-1,29
Din Moscow,5867,7,6,6,8,21,26,-5,24
FK Rubin,5867,8,6,5,9,23,21,2,23
Amkar,5867,9,5,4,11,10,25,-15,19
Rostov,5867,10,4,6,10,10,20,-10,18
Anzhi,5867,11,2,5,13,14,40,-26,11
Loko Moscow,5868,1,11,7,2,31,13,18,40
Spart Moscow,5868,2,10,6,4,35,25,10,36
CSKA Moscow,5868,3,11,3,6,27,19,8,36
Zenit,5868,4,8,9,3,23,14,9,33
Krasnodar,5868,5,9,5,6,30,26,4,32
Terek Grozny,5868,6,8,5,7,21,26,-5,29
Din Moscow,5868,7,5,7,8,17,22,-5,22
FK Rubin,5868,8,5,6,9,22,19,3,21
Rostov,5868,9,4,7,9,10,17,-7,19
Amkar,5868,10,5,4,11,13,23,-10,19
Anzhi,5868,11,2,5,13,15,40,-25,11
Loko Moscow,5869,1,11,6,3,30,13,17,39
CSKA Moscow,5869,2,12,3,5,29,19,10,39
Spart Moscow,5869,3,9,5,6,38,31,7,32
Krasnodar,5869,4,9,5,6,29,25,4,32
Zenit,5869,5,7,9,4,23,16,7,30
Terek Grozny,5869,6,7,7,6,23,25,-2,28
Din Moscow,5869,7,7,6,7,21,22,-1,27
FK Rubin,5869,8,5,6,9,22,19,3,21
Amkar,5869,9,5,5,10,11,23,-12,20
Rostov,5869,10,4,6,10,12,21,-9,18
Anzhi,5869,11,2,6,12,17,41,-24,12
Loko Moscow,5870,1,12,6,2,32,11,21,42
CSKA Moscow,5870,2,12,3,5,27,17,10,39
Spart Moscow,5870,3,10,6,4,37,27,10,36
Krasnodar,5870,4,8,6,6,27,24,3,30
Zenit,5870,5,7,8,5,21,17,4,29
Terek Grozny,5870,6,7,7,6,23,25,-2,28
Din Moscow,5870,7,6,7,7,22,23,-1,25
FK Rubin,5870,8,5,6,9,21,20,1,21
Rostov,5870,9,4,6,10,10,18,-8,18
Amkar,5870,10,4,5,11,11,25,-14,17
Anzhi,5870,11,2,6,12,15,39,-24,12
Loko Moscow,5871,1,12,6,2,34,12,22,42
CSKA Moscow,5871,2,11,3,6,27,18,9,36
Spart Moscow,5871,3,10,5,5,39,29,10,35
Zenit,5871,4,8,8,4,22,17,5,32
Krasnodar,5871,5,8,6,6,30,27,3,30
Terek Grozny,5871,6,8,5,7,21,23,-2,29
Din Moscow,5871,7,6,6,8,20,26,-6,24
FK Rubin,5871,8,5,6,9,24,21,3,21
Rostov,5871,9,5,6,9,12,17,-5,21
Amkar,5871,10,5,4,11,11,24,-13,19
Anzhi,5871,11,2,5,13,14,40,-26,11
Loko Moscow,5872,1,11,6,3,29,13,16,39
Spart Moscow,5872,2,10,6,4,39,28,11,36
CSKA Moscow,5872,3,10,4,6,26,19,7,34
Zenit,5872,4,8,9,3,23,14,9,33
Krasnodar,5872,5,9,4,7,30,26,4,31
Terek Grozny,5872,6,8,6,6,24,24,0,30
Din Moscow,5872,7,6,7,7,21,23,-2,25
FK Rubin,5872,8,6,5,9,23,20,3,23
Rostov,5872,9,4,6,10,11,20,-9,18
Amkar,5872,10,4,5,11,11,25,-14,17
Anzhi,5872,11,2,6,12,14,39,-25,12
Loko Moscow,5873,1,12,5,3,32,14,18,41
CSKA Moscow,5873,2,11,4,5,29,19,10,37
Spart Moscow,5873,3,8,8,4,36,28,8,32
Krasnodar,5873,4,9,4,7,30,29,1,31
Zenit,5873,5,7,9,4,23,16,7,30
Terek Grozny,5873,6,8,6,6,23,24,-1,30
FK Rubin,5873,7,7,5,8,26,18,8,26
Din Moscow,5873,8,5,7,8,18,23,-5,22
Rostov,5873,9,4,7,9,12,19,-7,19
Amkar,5873,10,4,6,10,11,24,-13,18
Anzhi,5873,11,2,5,13,15,41,-26,11
Loko Moscow,5874,1,12,5,3,31,13,18,41
CSKA Moscow,5874,2,11,4,5,28,18,10,37
Spart Moscow,5874,3,9,6,5,37,26,11,33
Zenit,5874,4,8,9,3,22,13,9,33
Terek Grozny,5874,5,8,6,6,22,23,-1,30
Krasnodar,5874,6,8,4,8,28,27,1,28
FK Rubin,5874,7,7,5,8,25,18,7,26
Din Moscow,5874,8,5,6,9,18,28,-10,21
Rostov,5874,9,4,7,9,10,17,-7,19
Amkar,5874,10,5,4,11,10,23,-13,19
Anzhi,5874,11,2,6,12,16,41,-25,12
Loko Moscow,5875,1,11,5,4,29,14,15,38
Spart Moscow,5875,2,10,6,4,40,28,12,36
Zenit,5875,3,9,8,3,23,13,10,35
Krasnodar,5875,4,10,4,6,31,25,6,34
CSKA Moscow,5875,5,10,3,7,25,20,5,33
Terek Grozny,5875,6,7,6,7,20,23,-3,27
Din Moscow,5875,7,5,7,8,18,24,-6,22
FK Rubin,5875,8,5,6,9,22,19,3,21
Amkar,5875,9,5,5,10,12,24,-12,20
Rostov,5875,10,4,6,10,10,19,-9,18
Anzhi,5875,11,3,6,11,16,37,-21,15
Loko Moscow,5876,1,12,5,3,33,14,19,41
Krasnodar,5876,2,10,4,6,35,25,10,34
CSKA Moscow,5876,3,10,4,6,27,22,5,34
Spart Moscow,5876,4,9,6,5,38,28,10,33
Zenit,5876,5,8,8,4,24,16,8,32
Terek Grozny,5876,6,8,6,6,25,26,-1,30
Din Moscow,5876,7,5,8,7,20,24,-4,23
FK Rubin,5876,8,5,6,9,23,24,-1,21
Amkar,5876,9,5,5,10,14,26,-12,20
Rostov,5876,10,4,6,10,10,20,-10,18
Anzhi,5876,11,2,6,12,17,41,-24,12
Loko Moscow,5877,1,13,5,2,34,12,22,44
CSKA Moscow,5877,2,11,3,6,27,20,7,36
Spart Moscow,5877,3,9,6,5,36,28,8,33
Zenit,5877,4,8,8,4,24,15,9,32
Krasnodar,5877,5,9,4,7,30,28,2,31
Terek Grozny,5877,6,7,7,6,21,23,-2,28
Din Moscow,5877,7,5,8,7,18,22,-4,23
FK Rubin,5877,8,5,6,9,22,19,3,21
Rostov,5877,9,5,6,9,12,17,-5,21
Amkar,5877,10,4,5,11,9,24,-15,17
Anzhi,5877,11,2,6,12,15,40,-25,12
Loko Moscow,5878,1,12,5,3,30,12,18,41
CSKA Moscow,5878,2,11,4,5,29,20,9,37
Spart Moscow,5878,3,10,6,4,38,28,10,36
Krasnodar,5878,4,9,5,6,29,25,4,32
Zenit,5878,5,7,8,5,23,17,6,29
Terek Grozny,5878,6,8,5,7,22,25,-3,29
FK Rubin,5878,7,5,7,8,23,19,4,22
Din Moscow,5878,8,5,7,8,18,23,-5,22
Rostov,5878,9,4,6,10,12,20,-8,18
Amkar,5878,10,4,5,11,11,25,-14,17
Anzhi,5878,11,3,6,11,17,38,-21,15
Loko Moscow,5879,1,12,6,2,32,12,20,42
CSKA Moscow,5879,2,12,3,5,29,17,12,39
Spart Moscow,5879,3,11,5,4,39,27,12,38
Krasnodar,5879,4,9,4,7,29,26,3,31
Zenit,5879,5,7,9,4,22,15,7,30
Terek Grozny,5879,6,8,5,7,23,23,0,29
Din Moscow,5879,7,6,6,8,19,23,-4,24
FK Rubin,5879,8,5,5,10,21,20,1,20
Amkar,5879,9,5,4,11,11,24,-13,19
Rostov,5879,10,4,6,10,10,19,-9,18
Anzhi,5879,11,2,5,13,14,43,-29,11
Loko Moscow,5880,1,12,5,3,32,13,19,41
CSKA Moscow,5880,2,10,3,7,26,20,6,33
Zenit,5880,3,8,8,4,23,16,7,32
Krasnodar,5880,4,9,5,6,30,26,4,32
Spart Moscow,5880,5,8,7,5,34,27,7,31
Terek Grozny,5880,6,7,5,8,22,27,-5,26
Din Moscow,5880,7,6,7,7,18,21,-3,25
FK Rubin,5880,8,5,7,8,22,18,4,22
Amkar,5880,9,5,5,10,12,23,-11,20
Rostov,5880,10,4,7,9,11,18,-7,19
Anzhi,5880,11,4,5,11,17,38,-21,17
Loko Moscow,5881,1,12,6,2,33,14,19,42
CSKA Moscow,5881,2,11,3,6,27,20,7,36
Spart Moscow,5881,3,10,5,5,39,29,10,35
Zenit,5881,4,8,8,4,26,16,10,32
Krasnodar,5881,5,8,5,7,28,26,2,29
Terek Grozny,5881,6,7,7,6,21,23,-2,28
FK Rubin,5881,7,6,6,8,23,18,5,24
Din Moscow,5881,8,5,7,8,19,25,-6,22
Amkar,5881,9,5,5,10,13,24,-11,20
Rostov,5881,10,4,6,10,10,19,-9,18
Anzhi,5881,11,2,6,12,14,39,-25,12
Loko Moscow,5882,1,12,6,2,32,12,20,42
CSKA Moscow,5882,2,11,3,6,27,20,7,36
Spart Moscow,5882,3,10,5,5,37,28,9,35
Zenit,5882,4,8,9,3,23,13,10,33
Krasnodar,5882,5,9,4,7,33,27,6,31
Din Moscow,5882,6,7,6,7,20,22,-2,27
Terek Grozny,5882,7,7,6,7,20,23,-3,27
FK Rubin,5882,8,5,5,10,21,23,-2,20
Amkar,5882,9,5,4,11,10,23,-13,19
Rostov,5882,10,4,6,10,11,19,-8,18
Anzhi,5882,11,2,6,12,15,39,-24,12
Loko Moscow,5883,1,11,7,2,31,13,18,40
Spart Moscow,5883,2,10,6,4,36,26,10,36
CSKA Moscow,5883,3,10,4,6,26,20,6,34
Zenit,5883,4,8,9,3,25,15,10,33
Terek Grozny,5883,5,8,5,7,26,25,1,29
Krasnodar,5883,6,8,5,7,28,28,0,29
FK Rubin,5883,7,7,5,8,25,17,8,26
Din Moscow,5883,8,5,6,9,18,24,-6,21
Amkar,5883,9,5,5,10,12,24,-12,20
Rostov,5883,10,4,6,10,10,18,-8,18
Anzhi,5883,11,2,6,12,14,41,-27,12
Loko Moscow,5884,1,11,6,3,32,15,17,39
Spart Moscow,5884,2,11,5,4,40,26,14,38
CSKA Moscow,5884,3,11,3,6,27,20,7,36
Zenit,5884,4,8,9,3,25,15,10,33
Krasnodar,5884,5,9,4,7,29,26,3,31
Terek Grozny,5884,6,7,6,7,21,24,-3,27
Din Moscow,5884,7,6,6,8,18,24,-6,24
FK Rubin,5884,8,6,5,9,22,18,4,23
Rostov,5884,9,4,6,10,10,19,-9,18
Amkar,5884,10,4,5,11,11,25,-14,17
Anzhi,5884,11,3,5,12,16,39,-23,14
Loko Moscow,5885,1,11,6,3,30,13,17,39
Spart Moscow,5885,2,11,5,4,42,28,14,38
CSKA Moscow,5885,3,11,4,5,29,19,10,37
Krasnodar,5885,4,10,4,6,29,24,5,34
Zenit,5885,5,7,10,3,24,16,8,31
Terek Grozny,5885,6,8,6,6,24,23,1,30
Din Moscow,5885,7,6,6,8,21,24,-3,24
FK Rubin,5885,8,5,5,10,22,21,1,20
Rostov,5885,9,4,6,10,10,19,-9,18
Amkar,5885,10,4,4,12,11,30,-19,16
Anzhi,5885,11,2,6,12,15,40,-25,12
Loko Moscow,5886,1,13,5,2,35,13,22,44
CSKA Moscow,5886,2,11,4,5,28,18,10,37
Spart Moscow,5886,3,10,6,4,38,27,11,36
Krasnodar,5886,4,9,4,7,30,29,1,31
Zenit,5886,5,7,8,5,21,16,5,29
Terek Grozny,5886,6,8,5,7,22,24,-2,29
Din Moscow,5886,7,6,7,7,20,23,-3,25
FK Rubin,5886,8,5,5,10,22,20,2,20
Amkar,5886,9,5,4,11,11,25,-14,19
Rostov,5886,10,4,6,10,11,19,-8,18
Anzhi,5886,11,2,6,12,15,39,-24,12
Loko Moscow,5887,1,12,5,3,32,14,18,41
Spart Moscow,5887,2,11,5,4,42,26,16,38
Zenit,5887,3,9,8,3,25,14,11,35
CSKA Moscow,5887,4,10,4,6,26,20,6,34
Krasnodar,5887,5,8,5,7,31,29,2,29
Terek Grozny,5887,6,8,5,7,21,23,-2,29
Din Moscow,5887,7,6,6,8,19,24,-5,24
FK Rubin,5887,8,5,6,9,24,21,3,21
Amkar,5887,9,5,4,11,11,26,-15,19
Rostov,5887,10,4,6,10,10,20,-10,18
Anzhi,5887,11,2,6,12,14,38,-24,12
Loko Moscow,5888,1,12,6,2,32,13,19,42
Zenit,5888,2,8,9,3,25,15,10,33
CSKA Moscow,5888,3,10,3,7,27,22,5,33
Spart Moscow,5888,4,9,5,6,37,30,7,32
Terek Grozny,5888,5,9,5,6,22,22,0,32
Krasnodar,5888,6,9,4,7,30,26,4,31
FK Rubin,5888,7,6,5,9,22,19,3,23
Din Moscow,5888,8,5,6,9,19,25,-6,21
Rostov,5888,9,5,6,9,11,17,-6,21
Amkar,5888,10,5,4,11,11,24,-13,19
Anzhi,5888,11,3,5,12,16,39,-23,14
Loko Moscow,5889,1,11,7,2,32,14,18,40
CSKA Moscow,5889,2,10,4,6,25,18,7,34
Zenit,5889,3,8,9,3,24,15,9,33
Spart Moscow,5889,4,9,5,6,40,31,9,32
Krasnodar,5889,5,9,5,6,30,26,4,32
Terek Grozny,5889,6,7,7,6,25,27,-2,28
Din Moscow,5889,7,7,6,7,20,22,-2,27
FK Rubin,5889,8,5,5,10,22,20,2,20
Amkar,5889,9,5,5,10,16,28,-12,20
Rostov,5889,10,4,6,10,11,21,-10,18
Anzhi,5889,11,2,7,11,15,38,-23,13
Loko Moscow,5890,1,11,5,4,29,14,15,38
CSKA Moscow,5890,2,11,4,5,27,18,9,37
Spart Moscow,5890,3,10,6,4,40,29,11,36
Krasnodar,5890,4,10,4,6,29,24,5,34
Zenit,5890,5,8,9,3,24,14,10,33
Terek Grozny,5890,6,8,6,6,22,23,-1,30
Din Moscow,5890,7,6,6,8,20,25,-5,24
FK Rubin,5890,8,5,5,10,21,19,2,20
Rostov,5890,9,4,7,9,11,18,-7,19
Amkar,5890,10,4,5,11,10,24,-14,17
Anzhi,5890,11,2,5,13,15,40,-25,11
Loko Moscow,5891,1,11,5,4,30,15,15,38
CSKA Moscow,5891,2,11,3,6,28,24,4,36
Zenit,5891,3,9,8,3,28,14,14,35
Spart Moscow,5891,4,10,5,5,37,27,10,35
Krasnodar,5891,5,9,4,7,30,26,4,31
Terek Grozny,5891,6,7,7,6,22,24,-2,28
FK Rubin,5891,7,6,6,8,24,19,5,24
Din Moscow,5891,8,5,7,8,18,23,-5,22
Amkar,5891,9,5,5,10,13,24,-11,20
Rostov,5891,10,4,6,10,10,20,-10,18
Anzhi,5891,11,2,6,12,16,40,-24,12
Loko Moscow,5892,1,12,5,3,31,15,16,41
CSKA Moscow,5892,2,10,5,5,26,18,8,35
Zenit,5892,3,8,9,3,24,13,11,33
Spart Moscow,5892,4,8,7,5,35,28,7,31
Krasnodar,5892,5,9,4,7,29,26,3,31
Terek Grozny,5892,6,8,5,7,22,23,-1,29
Din Moscow,5892,7,5,8,7,18,22,-4,23
FK Rubin,5892,8,5,6,9,21,18,3,21
Rostov,5892,9,5,6,9,12,18,-6,21
Amkar,5892,10,5,5,10,10,22,-12,20
Anzhi,5892,11,2,6,12,15,40,-25,12
Loko Moscow,5893,1,11,5,4,29,15,14,38
CSKA Moscow,5893,2,11,3,6,27,18,9,36
Zenit,5893,3,8,8,4,23,15,8,32
Spart Moscow,5893,4,9,5,6,34,29,5,32
Krasnodar,5893,5,9,5,6,29,24,5,32
Din Moscow,5893,6,7,6,7,22,22,0,27
Terek Grozny,5893,7,7,6,7,20,23,-3,27
FK Rubin,5893,8,5,6,9,22,19,3,21
Rostov,5893,9,5,6,9,11,17,-6,21
Amkar,5893,10,4,5,11,9,23,-14,17
Anzhi,5893,11,4,5,11,16,37,-21,17
Loko Moscow,5894,1,11,5,4,30,15,15,38
CSKA Moscow,5894,2,11,3,6,29,23,6,36
Zenit,5894,3,9,8,3,27,14,13,35
Krasnodar,5894,4,10,4,6,33,25,8,34
Spart Moscow,5894,5,8,6,6,35,30,5,30
Terek Grozny,5894,6,8,6,6,21,22,-1,30
Din Moscow,5894,7,6,7,7,20,23,-3,25
FK Rubin,5894,8,5,6,9,23,22,1,21
Amkar,5894,9,5,5,10,12,23,-11,20
Rostov,5894,10,4,7,9,11,18,-7,19
Anzhi,5894,11,2,5,13,15,41,-26,11
Loko Moscow,5895,1,12,5,3,31,13,18,41
CSKA Moscow,5895,2,11,3,6,26,20,6,36
Spart Moscow,5895,3,9,7,4,36,27,9,34
Zenit,5895,4,8,8,4,25,15,10,32
Krasnodar,5895,5,9,5,6,28,24,4,32
Terek Grozny,5895,6,8,5,7,21,25,-4,29
Din Moscow,5895,7,5,8,7,18,22,-4,23
FK Rubin,5895,8,5,7,8,22,18,4,22
Rostov,5895,9,4,7,9,11,18,-7,19
Amkar,5895,10,5,4,11,13,24,-11,19
Anzhi,5895,11,2,5,13,14,39,-25,11
Loko Moscow,5896,1,11,5,4,29,14,15,38
CSKA Moscow,5896,2,11,4,5,29,18,11,37
Zenit,5896,3,8,9,3,23,13,10,33
Spart Moscow,5896,4,9,5,6,37,30,7,32
Krasnodar,5896,5,9,4,7,29,27,2,31
Terek Grozny,5896,6,8,6,6,23,24,-1,30
Din Moscow,5896,7,6,7,7,19,21,-2,25
FK Rubin,5896,8,6,6,8,24,18,6,24
Amkar,5896,9,5,4,11,13,26,-13,19
Rostov,5896,10,4,6,10,10,19,-9,18
Anzhi,5896,11,2,6,12,16,42,-26,12
Loko Moscow,5897,1,12,5,3,31,13,18,41
Spart Moscow,5897,2,10,6,4,38,27,11,36
CSKA Moscow,5897,3,11,3,6,31,21,10,36
Zenit,5897,4,9,8,3,27,17,10,35
Terek Grozny,5897,5,8,6,6,24,25,-1,30
Krasnodar,5897,6,8,4,8,28,27,1,28
FK Rubin,5897,7,6,6,8,24,19,5,24
Din Moscow,5897,8,5,8,7,19,23,-4,23
Rostov,5897,9,4,6,10,10,18,-8,18
Amkar,5897,10,4,5,11,12,27,-15,17
Anzhi,5897,11,2,5,13,15,42,-27,11
CSKA Moscow,5898,1,12,3,5,30,18,12,39
Loko Moscow,5898,2,11,5,4,29,13,16,38
Spart Moscow,5898,3,11,5,4,39,28,11,38
Zenit,5898,4,8,8,4,23,16,7,32
Krasnodar,5898,5,9,5,6,28,24,4,32
Terek Grozny,5898,6,7,5,8,20,26,-6,26
FK Rubin,5898,7,6,6,8,22,17,5,24
Din Moscow,5898,8,5,6,9,17,23,-6,21
Amkar,5898,9,5,4,11,12,25,-13,19
Rostov,5898,10,4,6,10,11,19,-8,18
Anzhi,5898,11,3,5,12,17,39,-22,14
Loko Moscow,5899,1,11,6,3,30,13,17,39
CSKA Moscow,5899,2,11,3,6,27,18,9,36
Krasnodar,5899,3,10,4,6,31,25,6,34
Zenit,5899,4,8,9,3,22,13,9,33
Spart Moscow,5899,5,9,6,5,36,28,8,33
Terek Grozny,5899,6,7,7,6,21,23,-2,28
FK Rubin,5899,7,6,5,9,25,21,4,23
Din Moscow,5899,8,5,7,8,19,25,-6,22
Amkar,5899,9,5,5,10,12,22,-10,20
Rostov,5899,10,4,6,10,10,20,-10,18
Anzhi,5899,11,2,6,12,15,40,-25,12
Loko Moscow,5900,1,12,6,2,31,12,19,42
CSKA Moscow,5900,2,11,3,6,29,21,8,36
Zenit,5900,3,8,8,4,24,15,9,32
Spart Moscow,5900,4,8,7,5,35,28,7,31
Terek Grozny,5900,5,8,6,6,26,24,2,30
Krasnodar,5900,6,8,5,7,29,27,2,29
Din Moscow,5900,7,7,6,7,22,21,1,27
FK Rubin,5900,8,6,5,9,23,22,1,23
Rostov,5900,9,4,7,9,11,18,-7,19
Amkar,5900,10,4,6,10,12,25,-13,18
Anzhi,5900,11,2,5,13,15,44,-29,11
Loko Moscow,5901,1,13,5,2,31,11,20,44
CSKA Moscow,5901,2,10,4,6,25,18,7,34
Zenit,5901,3,8,8,4,22,14,8,32
Spart Moscow,5901,4,9,5,6,34,27,7,32
Krasnodar,5901,5,8,5,7,28,26,2,29
Din Moscow,5901,6,7,6,7,22,22,0,27
Terek Grozny,5901,7,7,6,7,20,23,-3,27
FK Rubin,5901,8,5,6,9,23,22,1,21
Amkar,5901,9,5,5,10,10,22,-12,20
Rostov,5901,10,4,6,10,10,18,-8,18
Anzhi,5901,11,3,6,11,15,37,-22,15
Loko Moscow,5902,1,11,6,3,32,16,16,39
CSKA Moscow,5902,2,11,3,6,28,18,10,36
Zenit,5902,3,8,9,3,23,14,9,33
Terek Grozny,5902,4,9,5,6,28,24,4,32
Spart Moscow,5902,5,8,7,5,34,28,6,31
Krasnodar,5902,6,9,4,7,32,28,4,31
Din Moscow,5902,7,6,7,7,20,22,-2,25
FK Rubin,5902,8,6,5,9,24,21,3,23
Rostov,5902,9,4,7,9,10,17,-7,19
Amkar,5902,10,5,4,11,13,26,-13,19
Anzhi,5902,11,2,5,13,15,45,-30,11
Spart Moscow,5903,1,11,5,4,41,27,14,38
Loko Moscow,5903,2,11,5,4,30,16,14,38
CSKA Moscow,5903,3,11,3,6,27,21,6,36
Zenit,5903,4,9,8,3,27,14,13,35
Krasnodar,5903,5,10,4,6,33,26,7,34
Terek Grozny,5903,6,7,7,6,23,25,-2,28
Din Moscow,5903,7,5,7,8,17,22,-5,22
FK Rubin,5903,8,5,6,9,22,20,2,21
Rostov,5903,9,4,6,10,10,21,-11,18
Amkar,5903,10,4,5,11,11,25,-14,17
Anzhi,5903,11,2,6,12,17,41,-24,12
Loko Moscow,5904,1,11,5,4,29,14,15,38
CSKA Moscow,5904,2,11,3,6,28,20,8,36
Krasnodar,5904,3,10,4,6,31,26,5,34
Spart Moscow,5904,4,9,6,5,40,30,10,33
Zenit,5904,5,8,8,4,24,15,9,32
Terek Grozny,5904,6,8,5,7,22,24,-2,29
Din Moscow,5904,7,6,6,8,20,27,-7,24
Rostov,5904,8,5,6,9,13,18,-5,21
FK Rubin,5904,9,5,5,10,25,23,2,20
Amkar,5904,10,4,5,11,11,25,-14,17
Anzhi,5904,11,4,5,11,18,39,-21,17
Loko Moscow,5905,1,12,6,2,31,12,19,42
CSKA Moscow,5905,2,11,3,6,31,20,11,36
Zenit,5905,3,8,9,3,25,16,9,33
Spart Moscow,5905,4,9,5,6,35,28,7,32
Krasnodar,5905,5,8,5,7,28,26,2,29
Terek Grozny,5905,6,7,6,7,23,26,-3,27
FK Rubin,5905,7,6,6,8,23,18,5,24
Din Moscow,5905,8,6,6,8,18,22,-4,24
Amkar,5905,9,5,5,10,14,26,-12,20
Rostov,5905,10,4,6,10,10,18,-8,18
Anzhi,5905,11,3,5,12,15,41,-26,14
Loko Moscow,5906,1,13,5,2,33,11,22,44
Spart Moscow,5906,2,10,6,4,40,28,12,36
CSKA Moscow,5906,3,10,4,6,26,21,5,34
Zenit,5906,4,8,8,4,24,16,8,32
Krasnodar,5906,5,9,4,7,30,25,5,31
Terek Grozny,5906,6,8,6,6,24,24,0,30
Din Moscow,5906,7,5,7,8,18,25,-7,22
FK Rubin,5906,8,5,6,9,21,20,1,21
Rostov,5906,9,4,6,10,10,18,-8,18
Amkar,5906,10,4,6,10,12,25,-13,18
Anzhi,5906,11,2,6,12,16,41,-25,12
Loko Moscow,5907,1,11,6,3,30,13,17,39
CSKA Moscow,5907,2,11,3,6,27,20,7,36
Zenit,5907,3,9,8,3,25,13,12,35
Spart Moscow,5907,4,9,6,5,36,28,8,33
Krasnodar,5907,5,8,5,7,28,29,-1,29
Terek Grozny,5907,6,7,5,8,21,25,-4,26
Din Moscow,5907,7,6,7,7,21,24,-3,25
FK Rubin,5907,8,6,6,8,26,18,8,24
Rostov,5907,9,4,7,9,10,17,-7,19
Amkar,5907,10,5,4,11,10,23,-13,19
Anzhi,5907,11,3,5,12,16,40,-24,14
Loko Moscow,5908,1,12,6,2,33,14,19,42
CSKA Moscow,5908,2,12,3,5,31,18,13,39
Spart Moscow,5908,3,11,5,4,39,26,13,38
Zenit,5908,4,7,9,4,24,17,7,30
Krasnodar,5908,5,8,5,7,28,26,2,29
Terek Grozny,5908,6,8,5,7,24,24,0,29
FK Rubin,5908,7,5,7,8,21,17,4,22
Din Moscow,5908,8,5,7,8,18,23,-5,22
Rostov,5908,9,4,6,10,10,20,-10,18
Amkar,5908,10,4,4,12,10,27,-17,16
Anzhi,5908,11,3,5,12,15,41,-26,14
Loko Moscow,5909,1,12,5,3,34,15,19,41
CSKA Moscow,5909,2,11,3,6,32,21,11,36
Krasnodar,5909,3,10,4,6,32,27,5,34
Spart Moscow,5909,4,9,6,5,38,30,8,33
Zenit,5909,5,8,8,4,24,17,7,32
Terek Grozny,5909,6,7,5,8,20,26,-6,26
Din Moscow,5909,7,5,7,8,19,25,-6,22
FK Rubin,5909,8,5,6,9,22,19,3,21
Rostov,5909,9,5,6,9,12,17,-5,21
Amkar,5909,10,5,5,10,12,23,-11,20
Anzhi,5909,11,3,5,12,18,43,-25,14
Loko Moscow,5910,1,12,5,3,31,12,19,41
CSKA Moscow,5910,2,11,4,5,28,19,9,37
Spart Moscow,5910,3,10,6,4,40,26,14,36
Zenit,5910,4,8,8,4,23,15,8,32
Terek Grozny,5910,5,8,5,7,22,25,-3,29
Krasnodar,5910,6,8,4,8,27,27,0,28
FK Rubin,5910,7,7,5,8,25,18,7,26
Din Moscow,5910,8,5,6,9,18,25,-7,21
Rostov,5910,9,4,6,10,10,22,-12,18
Amkar,5910,10,4,5,11,10,24,-14,17
Anzhi,5910,11,3,6,11,18,39,-21,15
Loko Moscow,5911,1,12,5,3,32,14,18,41
CSKA Moscow,5911,2,10,5,5,26,18,8,35
Spart Moscow,5911,3,9,7,4,38,29,9,34
Krasnodar,5911,4,10,4,6,33,25,8,34
Zenit,5911,5,7,9,4,21,16,5,30
Terek Grozny,5911,6,7,5,8,24,29,-5,26
FK Rubin,5911,7,6,5,9,23,20,3,23
Din Moscow,5911,8,5,7,8,19,24,-5,22
Amkar,5911,9,5,5,10,13,25,-12,20
Rostov,5911,10,4,6,10,11,19,-8,18
Anzhi,5911,11,3,6,11,19,40,-21,15
Loko Moscow,5912,1,12,6,2,33,14,19,42
CSKA Moscow,5912,2,10,4,6,26,19,7,34
Spart Moscow,5912,3,9,6,5,36,27,9,33
Zenit,5912,4,7,10,3,22,14,8,31
Krasnodar,5912,5,8,4,8,29,30,-1,28
Terek Grozny,5912,6,7,6,7,21,24,-3,27
FK Rubin,5912,7,6,6,8,25,18,7,24
Din Moscow,5912,8,5,7,8,18,24,-6,22
Amkar,5912,9,5,5,10,11,23,-12,20
Rostov,5912,10,4,7,9,11,18,-7,19
Anzhi,5912,11,4,5,11,17,38,-21,17
Loko Moscow,5913,1,11,7,2,29,11,18,40
CSKA Moscow,5913,2,11,3,6,28,19,9,36
Spart Moscow,5913,3,9,7,4,37,25,12,34
Krasnodar,5913,4,9,5,6,31,24,7,32
Zenit,5913,5,7,9,4,21,15,6,30
Terek Grozny,5913,6,7,5,8,22,30,-8,26
Din Moscow,5913,7,6,7,7,19,21,-2,25
FK Rubin,5913,8,5,5,10,21,23,-2,20
Amkar,5913,9,5,5,10,13,23,-10,20
Rostov,5913,10,4,6,10,10,21,-11,18
Anzhi,5913,11,4,5,11,20,39,-19,17
Loko Moscow,5914,1,11,6,3,30,13,17,39
CSKA Moscow,5914,2,12,3,5,32,17,15,39
Spart Moscow,5914,3,11,5,4,39,26,13,38
Zenit,5914,4,8,8,4,23,17,6,32
Krasnodar,5914,5,9,5,6,30,25,5,32
Terek Grozny,5914,6,8,5,7,22,25,-3,29
FK Rubin,5914,7,6,5,9,25,22,3,23
Din Moscow,5914,8,5,6,9,20,27,-7,21
Rostov,5914,9,4,6,10,10,18,-8,18
Amkar,5914,10,4,4,12,9,25,-16,16
Anzhi,5914,11,3,5,12,17,42,-25,14
Loko Moscow,5915,1,12,5,3,30,12,18,41
Zenit,5915,2,9,8,3,24,14,10,35
CSKA Moscow,5915,3,10,3,7,27,21,6,33
Spart Moscow,5915,4,9,5,6,36,31,5,32
Krasnodar,5915,5,9,4,7,30,25,5,31
Din Moscow,5915,6,7,6,7,21,22,-1,27
Terek Grozny,5915,7,7,5,8,21,25,-4,26
Amkar,5915,8,6,4,10,13,22,-9,22
FK Rubin,5915,9,5,5,10,21,22,-1,20
Rostov,5915,10,4,6,10,11,19,-8,18
Anzhi,5915,11,4,5,11,18,39,-21,17
Loko Moscow,5916,1,11,6,3,30,13,17,39
CSKA Moscow,5916,2,11,4,5,28,18,10,37
Spart Moscow,5916,3,10,6,4,39,26,13,36
Krasnodar,5916,4,10,4,6,30,24,6,34
Terek Grozny,5916,5,9,5,6,27,23,4,32
Zenit,5916,6,7,10,3,23,15,8,31
FK Rubin,5916,7,6,5,9,23,20,3,23
Din Moscow,5916,8,5,6,9,18,25,-7,21
Rostov,5916,9,4,7,9,11,18,-7,19
Amkar,5916,10,4,4,12,10,29,-19,16
Anzhi,5916,11,2,5,13,14,42,-28,11
Loko Moscow,5917,1,12,6,2,32,12,20,42
CSKA Moscow,5917,2,11,4,5,28,19,9,37
Zenit,5917,3,7,9,4,23,17,6,30
Spart Moscow,5917,4,8,6,6,33,30,3,30
Krasnodar,5917,5,8,6,6,29,26,3,30
Terek Grozny,5917,6,7,5,8,22,28,-6,26
FK Rubin,5917,7,6,6,8,25,18,7,24
Din Moscow,5917,8,6,6,8,20,24,-4,24
Amkar,5917,9,6,4,10,14,22,-8,22
Rostov,5917,10,4,7,9,10,17,-7,19
Anzhi,5917,11,3,5,12,17,40,-23,14
Loko Moscow,5918,1,12,6,2,32,11,21,42
CSKA Moscow,5918,2,12,3,5,28,17,11,39
Spart Moscow,5918,3,9,5,6,40,30,10,32
Krasnodar,5918,4,9,4,7,30,28,2,31
Zenit,5918,5,7,9,4,21,14,7,30
Terek Grozny,5918,6,8,6,6,24,24,0,30
Din Moscow,5918,7,6,7,7,21,23,-2,25
FK Rubin,5918,8,5,6,9,24,22,2,21
Amkar,5918,9,5,5,10,12,24,-12,20
Rostov,5918,10,4,6,10,11,23,-12,18
Anzhi,5918,11,2,5,13,15,42,-27,11
Loko Moscow,5919,1,12,6,2,31,12,19,42
Spart Moscow,5919,2,10,6,4,38,26,12,36
CSKA Moscow,5919,3,10,4,6,28,21,7,34
Zenit,5919,4,8,8,4,23,15,8,32
Terek Grozny,5919,5,9,5,6,25,24,1,32
Krasnodar,5919,6,8,6,6,29,26,3,30
FK Rubin,5919,7,5,7,8,24,20,4,22
Din Moscow,5919,8,5,7,8,19,26,-7,22
Rostov,5919,9,4,6,10,10,18,-8,18
Amkar,5919,10,4,5,11,11,26,-15,17
Anzhi,5919,11,2,6,12,17,41,-24,12
Loko Moscow,5920,1,12,6,2,35,15,20,42
CSKA Moscow,5920,2,10,4,6,26,19,7,34
Zenit,5920,3,7,10,3,24,16,8,31
Spart Moscow,5920,4,8,7,5,35,30,5,31
Krasnodar,5920,5,9,4,7,30,28,2,31
Terek Grozny,5920,6,8,6,6,24,24,0,30
Din Moscow,5920,7,7,6,7,23,21,2,27
FK Rubin,5920,8,5,5,10,21,21,0,20
Rostov,5920,9,4,7,9,11,18,-7,19
Amkar,5920,10,4,5,11,11,26,-15,17
Anzhi,5920,11,3,6,11,16,38,-22,15
Loko Moscow,5921,1,13,5,2,33,12,21,44
CSKA Moscow,5921,2,11,4,5,27,18,9,37
Spart Moscow,5921,3,10,6,4,40,28,12,36
Krasnodar,5921,4,9,4,7,29,26,3,31
Zenit,5921,5,7,9,4,22,16,6,30
Terek Grozny,5921,6,7,6,7,20,24,-4,27
Din Moscow,5921,7,5,7,8,19,25,-6,22
FK Rubin,5921,8,5,6,9,23,20,3,21
Rostov,5921,9,4,7,9,11,18,-7,19
Amkar,5921,10,5,4,11,12,25,-13,19
Anzhi,5921,11,2,6,12,15,39,-24,12
Loko Moscow,5922,1,12,6,2,31,12,19,42
Spart Moscow,5922,2,11,5,4,41,25,16,38
CSKA Moscow,5922,3,11,4,5,29,19,10,37
Zenit,5922,4,7,10,3,22,14,8,31
Krasnodar,5922,5,9,4,7,31,28,3,31
Terek Grozny,5922,6,8,5,7,23,25,-2,29
FK Rubin,5922,7,6,5,9,26,22,4,23
Din Moscow,5922,8,5,6,9,19,26,-7,21
Amkar,5922,9,5,4,11,12,25,-13,19
Rostov,5922,10,4,6,10,10,22,-12,18
Anzhi,5922,11,2,5,13,15,41,-26,11
Loko Moscow,5923,1,11,6,3,30,13,17,39
CSKA Moscow,5923,2,10,4,6,25,19,6,34
Zenit,5923,3,8,9,3,23,13,10,33
Spart Moscow,5923,4,9,6,5,38,30,8,33
Krasnodar,5923,5,9,4,7,29,27,2,31
Terek Grozny,5923,6,8,6,6,21,22,-1,30
FK Rubin,5923,7,7,5,8,25,17,8,26
Din Moscow,5923,8,6,6,8,20,25,-5,24
Rostov,5923,9,4,7,9,12,19,-7,19
Amkar,5923,10,4,5,11,9,23,-14,17
Anzhi,5923,11,2,6,12,14,38,-24,12
Loko Moscow,5924,1,13,5,2,34,12,22,44
Spart Moscow,5924,2,11,5,4,42,25,17,38
CSKA Moscow,5924,3,11,4,5,28,19,9,37
Zenit,5924,4,7,8,5,23,17,6,29
Krasnodar,5924,5,8,5,7,29,29,0,29
Terek Grozny,5924,6,7,5,8,21,27,-6,26
FK Rubin,5924,7,6,6,8,25,19,6,24
Din Moscow,5924,8,5,6,9,17,25,-8,21
Amkar,5924,9,5,4,11,12,29,-17,19
Rostov,5924,10,4,6,10,10,18,-8,18
Anzhi,5924,11,3,6,11,17,38,-21,15
Loko Moscow,5925,1,12,5,3,35,15,20,41
CSKA Moscow,5925,2,11,3,6,27,19,8,36
Krasnodar,5925,3,10,4,6,31,26,5,34
Spart Moscow,5925,4,9,6,5,36,28,8,33
Zenit,5925,5,8,8,4,23,17,6,32
Din Moscow,5925,6,7,6,7,20,21,-1,27
Terek Grozny,5925,7,7,5,8,21,26,-5,26
FK Rubin,5925,8,5,5,10,21,19,2,20
Rostov,5925,9,4,7,9,11,18,-7,19
Amkar,5925,10,5,4,11,11,24,-13,19
Anzhi,5925,11,3,5,12,17,40,-23,14
Loko Moscow,5926,1,11,7,2,31,13,18,40
CSKA Moscow,5926,2,11,4,5,30,19,11,37
Zenit,5926,3,7,10,3,22,14,8,31
Spart Moscow,5926,4,8,6,6,37,34,3,30
Krasnodar,5926,5,8,5,7,29,27,2,29
Terek Grozny,5926,6,8,5,7,22,24,-2,29
Din Moscow,5926,7,6,7,7,23,23,0,25
FK Rubin,5926,8,6,6,8,24,19,5,24
Rostov,5926,9,5,6,9,13,19,-6,21
Amkar,5926,10,5,5,10,13,24,-11,20
Anzhi,5926,11,2,5,13,15,43,-28,11
Loko Moscow,5927,1,11,6,3,30,13,17,39
CSKA Moscow,5927,2,11,4,5,32,18,14,37
Krasnodar,5927,3,10,4,6,30,25,5,34
Spart Moscow,5927,4,9,6,5,35,28,7,33
Zenit,5927,5,7,10,3,23,15,8,31
Terek Grozny,5927,6,7,6,7,21,26,-5,27
Din Moscow,5927,7,6,7,7,18,21,-3,25
Rostov,5927,8,5,6,9,12,17,-5,21
FK Rubin,5927,9,5,5,10,22,20,2,20
Amkar,5927,10,4,5,11,11,25,-14,17
Anzhi,5927,11,3,5,12,17,43,-26,14
Loko Moscow,5928,1,13,5,2,32,12,20,44
CSKA Moscow,5928,2,11,3,6,29,20,9,36
Zenit,5928,3,8,8,4,24,15,9,32
Spart Moscow,5928,4,9,5,6,39,31,8,32
Krasnodar,5928,5,8,5,7,28,26,2,29
Terek Grozny,5928,6,7,5,8,20,25,-5,26
FK Rubin,5928,7,6,6,8,24,18,6,24
Amkar,5928,8,6,4,10,14,22,-8,22
Rostov,5928,9,5,6,9,13,19,-6,21
Din Moscow,5928,10,5,6,9,17,27,-10,21
Anzhi,5928,11,3,5,12,16,41,-25,14
Loko Moscow,5929,1,11,7,2,31,13,18,40
Spart Moscow,5929,2,10,5,5,38,28,10,35
CSKA Moscow,5929,3,10,4,6,28,21,7,34
Zenit,5929,4,8,9,3,24,15,9,33
Krasnodar,5929,5,9,5,6,34,27,7,32
Terek Grozny,5929,6,8,6,6,23,24,-1,30
Din Moscow,5929,7,7,6,7,21,23,-2,27
FK Rubin,5929,8,5,5,10,24,25,-1,20
Rostov,5929,9,4,6,10,10,19,-9,18
Amkar,5929,10,4,4,12,10,25,-15,16
Anzhi,5929,11,2,7,11,18,41,-23,13
Loko Moscow,5930,1,12,6,2,32,12,20,42
Spart Moscow,5930,2,11,5,4,38,27,11,38
CSKA Moscow,5930,3,11,3,6,27,18,9,36
Zenit,5930,4,8,8,4,22,15,7,32
Krasnodar,5930,5,9,5,6,31,26,5,32
Terek Grozny,5930,6,7,7,6,21,23,-2,28
Din Moscow,5930,7,6,6,8,20,24,-4,24
FK Rubin,5930,8,5,5,10,23,22,1,20
Rostov,5930,9,4,6,10,11,19,-8,18
Amkar,5930,10,4,5,11,9,23,-14,17
Anzhi,5930,11,2,6,12,15,40,-25,12
Loko Moscow,5931,1,12,5,3,31,13,18,41
CSKA Moscow,5931,2,11,4,5,28,18,10,37
Spart Moscow,5931,3,10,6,4,36,25,11,36
Krasnodar,5931,4,10,4,6,30,25,5,34
Zenit,5931,5,7,9,4,23,16,7,30
Terek Grozny,5931,6,7,6,7,20,24,-4,27
FK Rubin,5931,7,6,5,9,25,19,6,23
Din Moscow,5931,8,5,6,9,17,26,-9,21
Rostov,5931,9,4,7,9,10,17,-7,19
Amkar,5931,10,5,4,11,11,23,-12,19
Anzhi,5931,11,2,6,12,14,39,-25,12
Loko Moscow,5932,1,11,6,3,30,14,16,39
CSKA Moscow,5932,2,12,3,5,28,18,10,39
Spart Moscow,5932,3,10,6,4,39,28,11,36
Krasnodar,5932,4,9,4,7,29,25,4,31
Zenit,5932,5,7,9,4,23,16,7,30
Terek Grozny,5932,6,8,5,7,21,24,-3,29
FK Rubin,5932,7,6,6,8,22,17,5,24
Din Moscow,5932,8,5,7,8,17,22,-5,22
Amkar,5932,9,5,5,10,13,24,-11,20
Rostov,5932,10,4,6,10,11,20,-9,18
Anzhi,5932,11,2,5,13,14,39,-25,11
Loko Moscow,5933,1,12,5,3,33,14,19,41
CSKA Moscow,5933,2,11,4,5,28,19,9,37
Spart Moscow,5933,3,10,6,4,35,25,10,36
Krasnodar,5933,4,10,4,6,33,27,6,34
Terek Grozny,5933,5,8,6,6,24,25,-1,30
Zenit,5933,6,7,8,5,22,18,4,29
FK Rubin,5933,7,6,5,9,24,20,4,23
Din Moscow,5933,8,5,6,9,17,23,-6,21
Rostov,5933,9,4,7,9,10,17,-7,19
Amkar,5933,10,4,5,11,12,26,-14,17
Anzhi,5933,11,2,6,12,15,39,-24,12
CSKA Moscow,5934,1,12,3,5,27,17,10,39
Loko Moscow,5934,2,11,5,4,30,15,15,38
Spart Moscow,5934,3,10,6,4,40,26,14,36
Krasnodar,5934,4,10,4,6,33,27,6,34
Zenit,5934,5,8,8,4,23,14,9,32
Terek Grozny,5934,6,7,6,7,22,25,-3,27
Din Moscow,5934,7,5,7,8,18,27,-9,22
FK Rubin,5934,8,5,6,9,24,22,2,21
Amkar,5934,9,5,5,10,11,23,-12,20
Rostov,5934,10,4,6,10,11,19,-8,18
Anzhi,5934,11,2,6,12,15,39,-24,12
Loko Moscow,5935,1,11,7,2,31,13,18,40
CSKA Moscow,5935,2,11,3,6,28,18,10,36
Zenit,5935,3,8,9,3,22,13,9,33
Spart Moscow,5935,4,8,7,5,36,30,6,31
Krasnodar,5935,5,8,6,6,29,26,3,30
Terek Grozny,5935,6,8,6,6,22,23,-1,30
Din Moscow,5935,7,5,8,7,19,23,-4,23
FK Rubin,5935,8,5,7,8,22,18,4,22
Amkar,5935,9,5,5,10,12,23,-11,20
Rostov,5935,10,4,7,9,12,19,-7,19
Anzhi,5935,11,2,5,13,14,41,-27,11
Loko Moscow,5936,1,11,6,3,31,14,17,39
CSKA Moscow,5936,2,12,3,5,28,18,10,39
Spart Moscow,5936,3,10,5,5,36,27,9,35
Zenit,5936,4,8,8,4,23,15,8,32
Krasnodar,5936,5,8,6,6,30,27,3,30
Terek Grozny,5936,6,8,6,6,23,23,0,30
FK Rubin,5936,7,6,6,8,25,18,7,24
Rostov,5936,8,5,6,9,11,17,-6,21
Din Moscow,5936,9,5,6,9,17,25,-8,21
Amkar,5936,10,4,4,12,11,27,-16,16
Anzhi,5936,11,2,6,12,14,38,-24,12
Loko Moscow,5937,1,11,6,3,32,16,16,39
CSKA Moscow,5937,2,11,4,5,28,19,9,37
Spart Moscow,5937,3,9,6,5,35,26,9,33
Zenit,5937,4,7,10,3,24,16,8,31
Krasnodar,5937,5,9,4,7,30,26,4,31
Terek Grozny,5937,6,7,5,8,20,25,-5,26
FK Rubin,5937,7,6,6,8,23,18,5,24
Din Moscow,5937,8,5,7,8,18,24,-6,22
Amkar,5937,9,6,4,10,11,22,-11,22
Rostov,5937,10,4,7,9,10,17,-7,19
Anzhi,5937,11,3,5,12,17,39,-22,14
Loko Moscow,5938,1,12,5,3,31,13,18,41
CSKA Moscow,5938,2,12,3,5,27,17,10,39
Spart Moscow,5938,3,10,5,5,40,28,12,35
Krasnodar,5938,4,9,4,7,29,26,3,31
Terek Grozny,5938,5,8,6,6,25,24,1,30
Zenit,5938,6,7,8,5,22,16,6,29
FK Rubin,5938,7,6,6,8,23,18,5,24
Din Moscow,5938,8,5,7,8,18,26,-8,22
Rostov,5938,9,5,6,9,11,17,-6,21
Amkar,5938,10,4,5,11,12,26,-14,17
Anzhi,5938,11,2,5,13,14,41,-27,11
Loko Moscow,5939,1,12,5,3,33,15,18,41
Spart Moscow,5939,2,10,5,5,38,27,11,35
Zenit,5939,3,9,8,3,26,16,10,35
CSKA Moscow,5939,4,10,4,6,26,19,7,34
Krasnodar,5939,5,9,4,7,31,27,4,31
Terek Grozny,5939,6,8,5,7,21,24,-3,29
FK Rubin,5939,7,6,5,9,26,23,3,23
Rostov,5939,8,5,6,9,11,17,-6,21
Din Moscow,5939,9,5,6,9,20,27,-7,21
Amkar,5939,10,5,4,11,11,24,-13,19
Anzhi,5939,11,2,6,12,15,39,-24,12
Loko Moscow,5940,1,11,6,3,32,15,17,39
Spart Moscow,5940,2,11,5,4,40,27,13,38
CSKA Moscow,5940,3,11,3,6,30,18,12,36
Zenit,5940,4,9,8,3,23,13,10,35
Krasnodar,5940,5,8,6,6,30,27,3,30
Terek Grozny,5940,6,7,5,8,22,27,-5,26
FK Rubin,5940,7,5,7,8,21,17,4,22
Din Moscow,5940,8,5,7,8,17,22,-5,22
Amkar,5940,9,5,4,11,12,26,-14,19
Rostov,5940,10,4,6,10,12,20,-8,18
Anzhi,5940,11,3,5,12,16,43,-27,14
Loko Moscow,5941,1,13,5,2,31,11,20,44
CSKA Moscow,5941,2,12,3,5,28,17,11,39
Spart Moscow,5941,3,10,5,5,40,29,11,35
Krasnodar,5941,4,9,4,7,29,26,3,31
Zenit,5941,5,7,8,5,21,16,5,29
Terek Grozny,5941,6,7,5,8,20,26,-6,26
Din Moscow,5941,7,6,6,8,22,26,-4,24
Amkar,5941,8,6,4,10,14,22,-8,22
FK Rubin,5941,9,5,5,10,24,23,1,20
Rostov,5941,10,4,6,10,10,21,-11,18
Anzhi,5941,11,3,5,12,16,38,-22,14
Loko Moscow,5942,1,11,5,4,29,15,14,38
CSKA Moscow,5942,2,11,3,6,26,18,8,36
Zenit,5942,3,9,8,3,24,13,11,35
Spart Moscow,5942,4,9,6,5,38,28,10,33
Krasnodar,5942,5,9,4,7,29,26,3,31
Terek Grozny,5942,6,8,6,6,25,23,2,30
FK Rubin,5942,7,7,5,8,24,17,7,26
Din Moscow,5942,8,5,7,8,18,23,-5,22
Amkar,5942,9,5,4,11,11,27,-16,19
Rostov,5942,10,4,6,10,10,20,-10,18
Anzhi,5942,11,2,6,12,15,39,-24,12
Loko Moscow,5943,1,11,7,2,30,12,18,40
Spart Moscow,5943,2,11,5,4,40,26,14,38
CSKA Moscow,5943,3,10,5,5,26,18,8,35
Zenit,5943,4,7,10,3,22,14,8,31
Krasnodar,5943,5,8,5,7,27,27,0,29
Terek Grozny,5943,6,8,5,7,24,26,-2,29
Din Moscow,5943,7,6,6,8,19,24,-5,24
FK Rubin,5943,8,6,5,9,25,19,6,23
Amkar,5943,9,5,4,11,13,27,-14,19
Rostov,5943,10,4,6,10,10,19,-9,18
Anzhi,5943,11,2,6,12,16,40,-24,12
Loko Moscow,5944,1,11,7,2,30,12,18,40
Spart Moscow,5944,2,10,6,4,38,26,12,36
CSKA Moscow,5944,3,11,3,6,28,19,9,36
Zenit,5944,4,8,9,3,22,13,9,33
Krasnodar,5944,5,9,5,6,30,25,5,32
Terek Grozny,5944,6,8,6,6,22,23,-1,30
Din Moscow,5944,7,6,6,8,21,25,-4,24
FK Rubin,5944,8,5,5,10,23,23,0,20
Rostov,5944,9,4,6,10,10,19,-9,18
Amkar,5944,10,4,6,10,11,24,-13,18
Anzhi,5944,11,2,5,13,15,41,-26,11
Loko Moscow,5945,1,13,5,2,33,12,21,44
Spart Moscow,5945,2,10,5,5,40,28,12,35
CSKA Moscow,5945,3,10,5,5,26,18,8,35
Terek Grozny,5945,4,9,5,6,24,24,0,32
Zenit,5945,5,7,9,4,23,17,6,30
Krasnodar,5945,6,8,4,8,27,26,1,28
FK Rubin,5945,7,7,5,8,23,17,6,26
Din Moscow,5945,8,5,6,9,18,24,-6,21
Amkar,5945,9,5,4,11,12,25,-13,19
Rostov,5945,10,4,6,10,10,21,-11,18
Anzhi,5945,11,2,6,12,15,39,-24,12
Loko Moscow,5946,1,12,6,2,35,15,20,42
CSKA Moscow,5946,2,11,3,6,30,21,9,36
Zenit,5946,3,8,9,3,26,17,9,33
Spart Moscow,5946,4,9,6,5,42,35,7,33
Krasnodar,5946,5,9,4,7,32,30,2,31
Terek Grozny,5946,6,8,6,6,24,25,-1,30
Din Moscow,5946,7,5,8,7,21,25,-4,23
FK Rubin,5946,8,5,6,9,24,21,3,21
Amkar,5946,9,5,4,11,15,27,-12,19
Rostov,5946,10,4,6,10,12,20,-8,18
Anzhi,5946,11,2,6,12,17,42,-25,12
Loko Moscow,5947,1,11,7,2,32,14,18,40
CSKA Moscow,5947,2,11,3,6,33,21,12,36
Zenit,5947,3,8,9,3,25,16,9,33
Spart Moscow,5947,4,9,6,5,37,29,8,33
Krasnodar,5947,5,9,5,6,32,26,6,32
Terek Grozny,5947,6,7,5,8,22,27,-5,26
Din Moscow,5947,7,5,7,8,19,24,-5,22
FK Rubin,5947,8,5,6,9,22,21,1,21
Rostov,5947,9,5,6,9,11,17,-6,21
Amkar,5947,10,5,5,10,13,24,-11,20
Anzhi,5947,11,3,5,12,18,45,-27,14
Loko Moscow,5948,1,12,6,2,31,11,20,42
CSKA Moscow,5948,2,11,4,5,28,19,9,37
Spart Moscow,5948,3,9,5,6,38,31,7,32
Krasnodar,5948,4,9,5,6,28,24,4,32
Terek Grozny,5948,5,8,6,6,22,23,-1,30
Zenit,5948,6,7,8,5,21,16,5,29
FK Rubin,5948,7,6,5,9,22,18,4,23
Rostov,5948,8,5,6,9,12,18,-6,21
Din Moscow,5948,9,5,6,9,17,25,-8,21
Amkar,5948,10,5,5,10,14,24,-10,20
Anzhi,5948,11,2,6,12,16,40,-24,12
Loko Moscow,5949,1,12,5,3,33,13,20,41
Zenit,5949,2,9,8,3,24,14,10,35
Spart Moscow,5949,3,9,6,5,38,30,8,33
CSKA Moscow,5949,4,10,3,7,27,22,5,33
Krasnodar,5949,5,8,5,7,29,29,0,29
Terek Grozny,5949,6,7,5,8,20,24,-4,26
FK Rubin,5949,7,6,6,8,24,19,5,24
Din Moscow,5949,8,6,6,8,22,24,-2,24
Amkar,5949,9,5,5,10,11,23,-12,20
Rostov,5949,10,4,6,10,10,20,-10,18
Anzhi,5949,11,4,5,11,18,38,-20,17
Loko Moscow,5950,1,12,6,2,33,14,19,42
CSKA Moscow,5950,2,12,3,5,29,17,12,39
Spart Moscow,5950,3,9,5,6,35,29,6,32
Terek Grozny,5950,4,9,5,6,23,23,0,32
Zenit,5950,5,7,9,4,24,18,6,30
Krasnodar,5950,6,8,5,7,27,25,2,29
FK Rubin,5950,7,6,6,8,24,18,6,24
Din Moscow,5950,8,6,6,8,19,24,-5,24
Rostov,5950,9,5,6,9,12,17,-5,21
Amkar,5950,10,4,4,12,11,26,-15,16
Anzhi,5950,11,2,5,13,14,40,-26,11
Loko Moscow,5951,1,11,6,3,30,13,17,39
CSKA Moscow,5951,2,11,4,5,30,20,10,37
Spart Moscow,5951,3,9,5,6,38,32,6,32
Krasnodar,5951,4,9,5,6,28,24,4,32
Zenit,5951,5,7,9,4,23,17,6,30
Terek Grozny,5951,6,8,6,6,21,22,-1,30
Din Moscow,5951,7,6,7,7,20,22,-2,25
FK Rubin,5951,8,5,7,8,22,18,4,22
Rostov,5951,9,5,6,9,11,17,-6,21
Amkar,5951,10,4,5,11,13,27,-14,17
Anzhi,5951,11,2,6,12,16,40,-24,12
Loko Moscow,5952,1,11,7,2,29,11,18,40
CSKA Moscow,5952,2,12,3,5,29,19,10,39
Spart Moscow,5952,3,10,6,4,40,27,13,36
Zenit,5952,4,7,9,4,21,14,7,30
Krasnodar,5952,5,8,5,7,28,29,-1,29
Terek Grozny,5952,6,8,5,7,22,24,-2,29
Din Moscow,5952,7,6,6,8,18,23,-5,24
FK Rubin,5952,8,6,5,9,26,19,7,23
Amkar,5952,9,5,5,10,12,24,-12,20
Rostov,5952,10,4,6,10,10,20,-10,18
Anzhi,5952,11,2,5,13,17,42,-25,11
Loko Moscow,5953,1,11,5,4,30,15,15,38
CSKA Moscow,5953,2,11,3,6,29,20,9,36
Zenit,5953,3,9,8,3,25,14,11,35
Krasnodar,5953,4,10,4,6,33,28,5,34
Spart Moscow,5953,5,9,6,5,39,27,12,33
Terek Grozny,5953,6,9,5,6,22,22,0,32
FK Rubin,5953,7,6,5,9,27,22,5,23
Din Moscow,5953,8,5,7,8,19,25,-6,22
Rostov,5953,9,5,6,9,11,17,-6,21
Amkar,5953,10,4,4,12,9,28,-19,16
Anzhi,5953,11,2,5,13,15,41,-26,11
Loko Moscow,5954,1,12,5,3,33,13,20,41
CSKA Moscow,5954,2,12,3,5,28,17,11,39
Krasnodar,5954,3,10,4,6,31,25,6,34
Spart Moscow,5954,4,8,8,4,34,26,8,32
Terek Grozny,5954,5,8,6,6,25,24,1,30
Zenit,5954,6,7,8,5,21,18,3,29
Din Moscow,5954,7,6,7,7,19,22,-3,25
FK Rubin,5954,8,5,5,10,22,21,1,20
Rostov,5954,9,4,7,9,10,17,-7,19
Amkar,5954,10,4,6,10,11,24,-13,18
Anzhi,5954,11,2,5,13,15,42,-27,11
Loko Moscow,5955,1,12,5,3,31,13,18,41
CSKA Moscow,5955,2,11,4,5,28,19,9,37
Spart Moscow,5955,3,9,6,5,40,28,12,33
Krasnodar,5955,4,9,5,6,30,25,5,32
Zenit,5955,5,7,8,5,23,18,5,29
Terek Grozny,5955,6,8,5,7,23,25,-2,29
Din Moscow,5955,7,5,8,7,18,22,-4,23
FK Rubin,5955,8,5,7,8,22,18,4,22
Amkar,5955,9,6,4,10,13,24,-11,22
Rostov,5955,10,4,6,10,10,22,-12,18
Anzhi,5955,11,2,6,12,15,39,-24,12
Loko Moscow,5956,1,12,6,2,34,13,21,42
CSKA Moscow,5956,2,11,3,6,27,22,5,36
Zenit,5956,3,8,8,4,25,16,9,32
Spart Moscow,5956,4,9,5,6,37,31,6,32
Krasnodar,5956,5,9,5,6,31,27,4,32
Din Moscow,5956,6,7,6,7,19,21,-2,27
Terek Grozny,5956,7,7,6,7,21,26,-5,27
Amkar,5956,8,6,4,10,14,22,-8,22
FK Rubin,5956,9,5,5,10,22,20,2,20
Rostov,5956,10,4,6,10,13,21,-8,18
Anzhi,5956,11,2,6,12,16,40,-24,12
Loko Moscow,5957,1,13,5,2,31,11,20,44
Spart Moscow,5957,2,10,6,4,38,25,13,36
CSKA Moscow,5957,3,10,5,5,25,17,8,35
Zenit,5957,4,7,9,4,21,14,7,30
Krasnodar,5957,5,8,5,7,28,26,2,29
Terek Grozny,5957,6,7,5,8,22,28,-6,26
Din Moscow,5957,7,5,8,7,17,21,-4,23
FK Rubin,5957,8,5,7,8,22,18,4,22
Amkar,5957,9,5,4,11,11,24,-13,19
Rostov,5957,10,4,6,10,10,21,-11,18
Anzhi,5957,11,3,6,11,18,38,-20,15
Loko Moscow,5958,1,12,6,2,31,12,19,42
CSKA Moscow,5958,2,10,4,6,25,18,7,34
Spart Moscow,5958,3,9,6,5,38,27,11,33
Zenit,5958,4,7,10,3,22,14,8,31
Krasnodar,5958,5,9,4,7,29,25,4,31
Terek Grozny,5958,6,8,6,6,22,23,-1,30
Din Moscow,5958,7,6,6,8,18,25,-7,24
Rostov,5958,8,5,6,9,11,17,-6,21
FK Rubin,5958,9,5,5,10,21,20,1,20
Amkar,5958,10,4,6,10,11,24,-13,18
Anzhi,5958,11,3,5,12,15,38,-23,14
Loko Moscow,5959,1,13,5,2,34,12,22,44
CSKA Moscow,5959,2,12,3,5,31,19,12,39
Spart Moscow,5959,3,10,6,4,38,25,13,36
Terek Grozny,5959,4,8,6,6,23,24,-1,30
Zenit,5959,5,7,8,5,23,18,5,29
Krasnodar,5959,6,8,4,8,27,28,-1,28
FK Rubin,5959,7,7,5,8,26,19,7,26
Din Moscow,5959,8,5,6,9,19,27,-8,21
Rostov,5959,9,4,6,10,10,19,-9,18
Amkar,5959,10,4,6,10,10,23,-13,18
Anzhi,5959,11,2,5,13,16,43,-27,11
Loko Moscow,5960,1,11,6,3,29,12,17,39
CSKA Moscow,5960,2,11,3,6,27,20,7,36
Zenit,5960,3,9,8,3,25,13,12,35
Spart Moscow,5960,4,8,7,5,33,27,6,31
Krasnodar,5960,5,8,5,7,28,27,1,29
Terek Grozny,5960,6,7,6,7,21,24,-3,27
Din Moscow,5960,7,6,7,7,18,21,-3,25
FK Rubin,5960,8,6,5,9,24,19,5,23
Rostov,5960,9,5,6,9,12,17,-5,21
Amkar,5960,10,5,5,10,10,22,-12,20
Anzhi,5960,11,2,6,12,15,40,-25,12
Loko Moscow,5961,1,13,5,2,37,14,23,44
CSKA Moscow,5961,2,11,3,6,26,19,7,36
Zenit,5961,3,8,8,4,24,18,6,32
Spart Moscow,5961,4,8,7,5,35,28,7,31
Krasnodar,5961,5,8,5,7,29,27,2,29
Terek Grozny,5961,6,7,7,6,22,24,-2,28
Din Moscow,5961,7,5,8,7,20,24,-4,23
FK Rubin,5961,8,5,7,8,23,19,4,22
Rostov,5961,9,5,6,9,11,17,-6,21
Amkar,5961,10,4,6,10,11,24,-13,18
Anzhi,5961,11,2,6,12,15,39,-24,12
Loko Moscow,5962,1,12,6,2,31,12,19,42
CSKA Moscow,5962,2,11,3,6,29,20,9,36
Zenit,5962,3,8,9,3,24,15,9,33
Spart Moscow,5962,4,9,5,6,35,28,7,32
Krasnodar,5962,5,9,4,7,28,25,3,31
Terek Grozny,5962,6,7,7,6,20,22,-2,28
Din Moscow,5962,7,7,6,7,19,21,-2,27
FK Rubin,5962,8,5,5,10,21,19,2,20
Amkar,5962,9,5,5,10,11,22,-11,20
Rostov,5962,10,4,6,10,10,19,-9,18
Anzhi,5962,11,2,6,12,15,40,-25,12
CSKA Moscow,5963,1,12,3,5,29,17,12,39
Loko Moscow,5963,2,11,5,4,29,14,15,38
Spart Moscow,5963,3,9,6,5,37,27,10,33
Zenit,5963,4,8,8,4,22,14,8,32
Krasnodar,5963,5,9,4,7,29,27,2,31
Terek Grozny,5963,6,8,5,7,23,25,-2,29
Din Moscow,5963,7,6,6,8,20,25,-5,24
FK Rubin,5963,8,6,5,9,24,19,5,23
Rostov,5963,9,4,7,9,10,17,-7,19
Amkar,5963,10,5,4,11,12,25,-13,19
Anzhi,5963,11,3,5,12,15,40,-25,14
Loko Moscow,5964,1,11,6,3,30,13,17,39
Krasnodar,5964,2,10,4,6,31,25,6,34
Zenit,5964,3,8,9,3,25,15,10,33
CSKA Moscow,5964,4,10,3,7,27,22,5,33
Spart Moscow,5964,5,8,6,6,37,31,6,30
Terek Grozny,5964,6,7,7,6,24,26,-2,28
FK Rubin,5964,7,6,5,9,23,20,3,23
Din Moscow,5964,8,5,7,8,20,25,-5,22
Rostov,5964,9,5,6,9,12,18,-6,21
Amkar,5964,10,5,5,10,11,23,-12,20
Anzhi,5964,11,3,6,11,19,41,-22,15
Loko Moscow,5965,1,12,5,3,32,13,19,41
CSKA Moscow,5965,2,11,3,6,28,19,9,36
Spart Moscow,5965,3,9,7,4,37,28,9,34
Krasnodar,5965,4,10,4,6,31,26,5,34
Zenit,5965,5,8,8,4,23,16,7,32
Terek Grozny,5965,6,8,5,7,22,23,-1,29
Din Moscow,5965,7,6,7,7,19,22,-3,25
FK Rubin,5965,8,5,5,10,22,20,2,20
Amkar,5965,9,5,5,10,11,23,-12,20
Rostov,5965,10,4,6,10,11,19,-8,18
Anzhi,5965,11,2,5,13,14,41,-27,11
Loko Moscow,5966,1,12,6,2,34,14,20,42
Spart Moscow,5966,2,10,6,4,37,27,10,36
CSKA Moscow,5966,3,10,4,6,28,22,6,34
Zenit,5966,4,8,9,3,27,17,10,33
Terek Grozny,5966,5,8,6,6,23,23,0,30
Krasnodar,5966,6,8,4,8,28,28,0,28
FK Rubin,5966,7,7,5,8,24,18,6,26
Din Moscow,5966,8,5,7,8,17,22,-5,22
Rostov,5966,9,4,6,10,12,20,-8,18
Amkar,5966,10,4,5,11,10,24,-14,17
Anzhi,5966,11,2,6,12,16,41,-25,12
Loko Moscow,5967,1,11,5,4,30,15,15,38
Spart Moscow,5967,2,11,5,4,39,26,13,38
CSKA Moscow,5967,3,10,5,5,27,19,8,35
Zenit,5967,4,8,9,3,24,15,9,33
Krasnodar,5967,5,9,5,6,30,25,5,32
Terek Grozny,5967,6,9,5,6,24,23,1,32
Din Moscow,5967,7,6,6,8,19,24,-5,24
FK Rubin,5967,8,5,6,9,22,19,3,21
Rostov,5967,9,4,6,10,10,18,-8,18
Amkar,5967,10,4,4,12,10,27,-17,16
Anzhi,5967,11,2,6,12,15,39,-24,12
Loko Moscow,5968,1,13,5,2,34,12,22,44
CSKA Moscow,5968,2,12,3,5,30,19,11,39
Spart Moscow,5968,3,9,6,5,41,30,11,33
Zenit,5968,4,7,8,5,24,19,5,29
Krasnodar,5968,5,8,5,7,29,28,1,29
Terek Grozny,5968,6,8,5,7,22,24,-2,29
FK Rubin,5968,7,6,6,8,24,19,5,24
Din Moscow,5968,8,5,7,8,19,24,-5,22
Amkar,5968,9,6,4,10,14,24,-10,22
Rostov,5968,10,4,6,10,10,21,-11,18
Anzhi,5968,11,2,5,13,14,41,-27,11
Loko Moscow,5969,1,11,5,4,30,14,16,38
CSKA Moscow,5969,2,11,3,6,30,21,9,36
Zenit,5969,3,9,8,3,25,14,11,35
Krasnodar,5969,4,9,4,7,28,26,2,31
Spart Moscow,5969,5,8,5,7,33,30,3,29
Din Moscow,5969,6,7,6,7,20,21,-1,27
Terek Grozny,5969,7,7,5,8,20,27,-7,26
FK Rubin,5969,8,6,5,9,23,19,4,23
Amkar,5969,9,6,4,10,14,22,-8,22
Rostov,5969,10,5,6,9,11,17,-6,21
Anzhi,5969,11,3,5,12,19,42,-23,14
Loko Moscow,5970,1,11,6,3,29,13,16,39
CSKA Moscow,5970,2,11,3,6,28,20,8,36
Spart Moscow,5970,3,9,7,4,35,26,9,34
Krasnodar,5970,4,9,4,7,29,26,3,31
Zenit,5970,5,7,9,4,23,16,7,30
Terek Grozny,5970,6,8,5,7,22,24,-2,29
FK Rubin,5970,7,6,6,8,23,17,6,24
Din Moscow,5970,8,5,7,8,18,23,-5,22
Rostov,5970,9,4,7,9,10,17,-7,19
Amkar,5970,10,4,5,11,9,23,-14,17
Anzhi,5970,11,4,5,11,17,38,-21,17
Loko Moscow,5971,1,12,5,3,32,14,18,41
CSKA Moscow,5971,2,11,4,5,30,20,10,37
Spart Moscow,5971,3,10,5,5,36,26,10,35
Zenit,5971,4,8,9,3,23,14,9,33
Krasnodar,5971,5,9,4,7,30,27,3,31
Terek Grozny,5971,6,8,6,6,26,26,0,30
Din Moscow,5971,7,6,6,8,19,23,-4,24
FK Rubin,5971,8,5,5,10,22,20,2,20
Amkar,5971,9,5,5,10,12,24,-12,20
Rostov,5971,10,4,6,10,10,19,-9,18
Anzhi,5971,11,2,5,13,18,45,-27,11
Loko Moscow,5972,1,12,5,3,31,13,18,41
Zenit,5972,2,9,8,3,25,14,11,35
Spart Moscow,5972,3,10,5,5,37,27,10,35
CSKA Moscow,5972,4,10,3,7,25,22,3,33
Terek Grozny,5972,5,8,5,7,21,23,-2,29
Krasnodar,5972,6,8,4,8,27,26,1,28
Din Moscow,5972,7,6,6,8,19,23,-4,24
FK Rubin,5972,8,6,5,9,22,19,3,23
Amkar,5972,9,5,4,11,11,23,-12,19
Rostov,5972,10,4,6,10,10,19,-9,18
Anzhi,5972,11,4,5,11,18,37,-19,17
Loko Moscow,5973,1,12,6,2,31,12,19,42
CSKA Moscow,5973,2,11,4,5,31,19,12,37
Zenit,5973,3,7,10,3,23,15,8,31
Spart Moscow,5973,4,8,5,7,34,30,4,29
Krasnodar,5973,5,8,5,7,28,26,2,29
Din Moscow,5973,6,7,6,7,21,22,-1,27
Terek Grozny,5973,7,7,6,7,21,24,-3,27
FK Rubin,5973,8,5,6,9,22,20,2,21
Rostov,5973,9,5,6,9,12,17,-5,21
Amkar,5973,10,5,5,10,11,23,-12,20
Anzhi,5973,11,3,5,12,16,42,-26,14
Loko Moscow,5974,1,12,5,3,34,14,20,41
CSKA Moscow,5974,2,12,3,5,27,17,10,39
Krasnodar,5974,3,10,4,6,32,25,7,34
Spart Moscow,5974,4,8,8,4,36,28,8,32
Zenit,5974,5,7,8,5,22,18,4,29
Terek Grozny,5974,6,7,5,8,20,24,-4,26
Din Moscow,5974,7,6,7,7,21,23,-2,25
FK Rubin,5974,8,5,5,10,21,22,-1,20
Amkar,5974,9,5,5,10,10,22,-12,20
Rostov,5974,10,4,7,9,11,18,-7,19
Anzhi,5974,11,3,5,12,15,38,-23,14
CSKA Moscow,5975,1,12,3,5,31,18,13,39
Loko Moscow,5975,2,11,5,4,29,15,14,38
Spart Moscow,5975,3,10,6,4,38,27,11,36
Zenit,5975,4,8,8,4,24,16,8,32
Krasnodar,5975,5,9,4,7,29,25,4,31
Terek Grozny,5975,6,8,6,6,23,24,-1,30
FK Rubin,5975,7,6,6,8,23,18,5,24
Din Moscow,5975,8,5,7,8,19,24,-5,22
Rostov,5975,9,4,6,10,10,19,-9,18
Amkar,5975,10,4,6,10,11,24,-13,18
Anzhi,5975,11,2,5,13,15,42,-27,11
Loko Moscow,5976,1,13,5,2,35,13,22,44
Spart Moscow,5976,2,10,5,5,39,27,12,35
CSKA Moscow,5976,3,10,4,6,26,20,6,34
Zenit,5976,4,8,8,4,25,16,9,32
Krasnodar,5976,5,9,4,7,31,28,3,31
Terek Grozny,5976,6,7,7,6,20,22,-2,28
Din Moscow,5976,7,6,6,8,19,24,-5,24
FK Rubin,5976,8,5,5,10,22,22,0,20
Amkar,5976,9,5,5,10,10,22,-12,20
Rostov,5976,10,4,6,10,11,21,-10,18
Anzhi,5976,11,2,7,11,14,37,-23,13
Loko Moscow,5977,1,11,6,3,31,15,16,39
Zenit,5977,2,9,8,3,25,14,11,35
Spart Moscow,5977,3,9,7,4,37,27,10,34
CSKA Moscow,5977,4,10,4,6,28,21,7,34
Terek Grozny,5977,5,9,5,6,24,23,1,32
Krasnodar,5977,6,8,6,6,29,26,3,30
Din Moscow,5977,7,6,7,7,20,23,-3,25
FK Rubin,5977,8,5,6,9,22,19,3,21
Rostov,5977,9,4,6,10,10,19,-9,18
Amkar,5977,10,4,5,11,11,25,-14,17
Anzhi,5977,11,2,6,12,16,41,-25,12
Loko Moscow,5978,1,13,5,2,31,11,20,44
CSKA Moscow,5978,2,10,5,5,27,19,8,35
Spart Moscow,5978,3,9,6,5,39,28,11,33
Zenit,5978,4,7,9,4,22,15,7,30
Krasnodar,5978,5,8,4,8,29,28,1,28
Terek Grozny,5978,6,7,6,7,21,25,-4,27
FK Rubin,5978,7,7,5,8,26,20,6,26
Din Moscow,5978,8,5,7,8,19,24,-5,22
Rostov,5978,9,5,6,9,12,18,-6,21
Amkar,5978,10,4,5,11,10,27,-17,17
Anzhi,5978,11,3,6,11,17,38,-21,15
Loko Moscow,5979,1,12,5,3,31,12,19,41
CSKA Moscow,5979,2,12,3,5,28,17,11,39
Spart Moscow,5979,3,10,5,5,39,30,9,35
Krasnodar,5979,4,10,4,6,30,25,5,34
Terek Grozny,5979,5,8,6,6,22,23,-1,30
Zenit,5979,6,7,8,5,21,16,5,29
Din Moscow,5979,7,6,6,8,21,25,-4,24
FK Rubin,5979,8,5,5,10,22,20,2,20
Amkar,5979,9,5,4,11,10,23,-13,19
Rostov,5979,10,4,6,10,11,19,-8,18
Anzhi,5979,11,2,6,12,15,40,-25,12
Loko Moscow,5980,1,12,6,2,33,12,21,42
CSKA Moscow,5980,2,12,3,5,30,19,11,39
Spart Moscow,5980,3,10,5,5,45,33,12,35
Krasnodar,5980,4,9,4,7,29,28,1,31
Zenit,5980,5,7,9,4,22,16,6,30
Terek Grozny,5980,6,7,6,7,22,25,-3,27
Din Moscow,5980,7,5,7,8,20,29,-9,22
FK Rubin,5980,8,5,6,9,23,20,3,21
Amkar,5980,9,5,5,10,13,24,-11,20
Rostov,5980,10,4,6,10,12,20,-8,18
Anzhi,5980,11,3,5,12,19,42,-23,14
Loko Moscow,5981,1,11,6,3,29,13,16,39
CSKA Moscow,5981,2,11,4,5,28,19,9,37
Spart Moscow,5981,3,9,7,4,36,26,10,34
Zenit,5981,4,8,9,3,24,14,10,33
Krasnodar,5981,5,8,6,6,29,26,3,30
Terek Grozny,5981,6,7,6,7,21,24,-3,27
Din Moscow,5981,7,6,6,8,18,23,-5,24
FK Rubin,5981,8,5,6,9,23,20,3,21
Amkar,5981,9,5,5,10,11,23,-12,20
Rostov,5981,10,4,7,9,10,17,-7,19
Anzhi,5981,11,2,6,12,16,40,-24,12
Loko Moscow,5982,1,11,6,3,30,13,17,39
CSKA Moscow,5982,2,11,3,6,29,21,8,36
Spart Moscow,5982,3,10,5,5,38,30,8,35
Zenit,5982,4,8,9,3,24,14,10,33
Krasnodar,5982,5,9,4,7,29,27,2,31
FK Rubin,5982,6,7,5,8,25,18,7,26
Terek Grozny,5982,7,7,5,8,21,25,-4,26
Rostov,5982,8,5,6,9,14,18,-4,21
Din Moscow,5982,9,5,6,9,17,24,-7,21
Amkar,5982,10,5,4,11,12,25,-13,19
Anzhi,5982,11,3,5,12,17,41,-24,14
Loko Moscow,5983,1,13,5,2,34,11,23,44
CSKA Moscow,5983,2,12,3,5,27,17,10,39
Spart Moscow,5983,3,9,7,4,40,31,9,34
Terek Grozny,5983,4,9,5,6,24,22,2,32
Krasnodar,5983,5,9,4,7,30,30,0,31
Zenit,5983,6,7,8,5,21,15,6,29
FK Rubin,5983,7,6,5,9,25,20,5,23
Din Moscow,5983,8,5,6,9,18,25,-7,21
Rostov,5983,9,4,7,9,12,19,-7,19
Amkar,5983,10,4,5,11,12,28,-16,17
Anzhi,5983,11,2,5,13,14,39,-25,11
Loko Moscow,5984,1,13,5,2,34,14,20,44
CSKA Moscow,5984,2,12,3,5,29,18,11,39
Spart Moscow,5984,3,9,7,4,40,30,10,34
Krasnodar,5984,4,9,4,7,33,29,4,31
Zenit,5984,5,7,8,5,23,17,6,29
Terek Grozny,5984,6,7,6,7,22,27,-5,27
FK Rubin,5984,7,6,5,9,25,21,4,23
Din Moscow,5984,8,5,7,8,19,25,-6,22
Rostov,5984,9,4,7,9,12,19,-7,19
Amkar,5984,10,5,4,11,14,26,-12,19
Anzhi,5984,11,2,6,12,15,40,-25,12
Loko Moscow,5985,1,12,6,2,32,13,19,42
CSKA Moscow,5985,2,12,3,5,29,18,11,39
Spart Moscow,5985,3,10,5,5,38,27,11,35
Zenit,5985,4,7,9,4,23,16,7,30
Terek Grozny,5985,5,8,5,7,24,26,-2,29
Krasnodar,5985,6,8,4,8,29,28,1,28
Din Moscow,5985,7,6,6,8,20,24,-4,24
FK Rubin,5985,8,6,5,9,24,21,3,23
Amkar,5985,9,6,4,10,15,25,-10,22
Rostov,5985,10,4,6,10,10,19,-9,18
Anzhi,5985,11,2,5,13,14,41,-27,11
Loko Moscow,5986,1,12,5,3,30,15,15,41
CSKA Moscow,5986,2,11,4,5,31,19,12,37
Zenit,5986,3,8,9,3,26,14,12,33
Spart Moscow,5986,4,9,6,5,39,30,9,33
Terek Grozny,5986,5,9,5,6,24,22,2,32
Krasnodar,5986,6,8,4,8,27,28,-1,28
Din Moscow,5986,7,7,6,7,21,22,-1,27
FK Rubin,5986,8,6,5,9,25,19,6,23
Rostov,5986,9,4,7,9,12,19,-7,19
Amkar,5986,10,4,4,12,10,29,-19,16
Anzhi,5986,11,2,5,13,15,43,-28,11
Loko Moscow,5987,1,13,5,2,33,11,22,44
CSKA Moscow,5987,2,10,3,7,27,21,6,33
Zenit,5987,3,8,8,4,24,17,7,32
Spart Moscow,5987,4,9,5,6,35,29,6,32
Krasnodar,5987,5,9,4,7,28,26,2,31
Terek Grozny,5987,6,7,7,6,22,24,-2,28
Din Moscow,5987,7,6,6,8,20,24,-4,24
Rostov,5987,8,5,6,9,11,17,-6,21
FK Rubin,5987,9,5,5,10,22,20,2,20
Amkar,5987,10,5,5,10,12,23,-11,20
Anzhi,5987,11,3,6,11,16,38,-22,15
Loko Moscow,5988,1,11,5,4,29,15,14,38
CSKA Moscow,5988,2,11,3,6,27,19,8,36
Zenit,5988,3,9,8,3,25,13,12,35
Spart Moscow,5988,4,10,5,5,37,28,9,35
Krasnodar,5988,5,10,4,6,31,25,6,34
Terek Grozny,5988,6,8,6,6,21,22,-1,30
Din Moscow,5988,7,5,7,8,17,23,-6,22
FK Rubin,5988,8,5,6,9,22,20,2,21
Amkar,5988,9,5,5,10,12,23,-11,20
Rostov,5988,10,4,6,10,10,18,-8,18
Anzhi,5988,11,2,5,13,15,40,-25,11
Loko Moscow,5989,1,11,6,3,30,13,17,39
CSKA Moscow,5989,2,10,5,5,27,19,8,35
Spart Moscow,5989,3,9,6,5,37,27,10,33
Zenit,5989,4,8,9,3,23,14,9,33
Krasnodar,5989,5,9,5,6,30,26,4,32
Terek Grozny,5989,6,8,5,7,24,25,-1,29
FK Rubin,5989,7,6,5,9,24,20,4,23
Rostov,5989,8,5,6,9,12,18,-6,21
Din Moscow,5989,9,5,6,9,18,26,-8,21
Amkar,5989,10,5,5,10,10,22,-12,20
Anzhi,5989,11,2,6,12,17,42,-25,12
Loko Moscow,5990,1,13,5,2,34,11,23,44
CSKA Moscow,5990,2,11,4,5,29,19,10,37
Spart Moscow,5990,3,10,6,4,36,26,10,36
Terek Grozny,5990,4,9,5,6,24,24,0,32
Zenit,5990,5,7,9,4,22,17,5,30
Krasnodar,5990,6,8,4,8,27,28,-1,28
FK Rubin,5990,7,6,6,8,23,17,6,24
Din Moscow,5990,8,5,8,7,18,22,-4,23
Rostov,5990,9,4,6,10,10,18,-8,18
Amkar,5990,10,4,4,12,10,25,-15,16
Anzhi,5990,11,2,5,13,16,42,-26,11
Loko Moscow,5991,1,12,6,2,31,11,20,42
CSKA Moscow,5991,2,11,3,6,28,21,7,36
Spart Moscow,5991,3,9,7,4,37,28,9,34
Zenit,5991,4,8,8,4,23,15,8,32
Krasnodar,5991,5,9,5,6,30,24,6,32
Terek Grozny,5991,6,7,6,7,21,27,-6,27
Din Moscow,5991,7,6,6,8,19,22,-3,24
FK Rubin,5991,8,5,5,10,21,22,-1,20
Rostov,5991,9,4,7,9,11,18,-7,19
Amkar,5991,10,4,6,10,12,25,-13,18
Anzhi,5991,11,3,5,12,20,40,-20,14
Loko Moscow,5992,1,12,5,3,31,12,19,41
Spart Moscow,5992,2,11,5,4,41,27,14,38
CSKA Moscow,5992,3,11,4,5,27,18,9,37
Krasnodar,5992,4,10,4,6,30,25,5,34
Zenit,5992,5,7,9,4,22,16,6,30
Terek Grozny,5992,6,7,6,7,22,26,-4,27
Din Moscow,5992,7,6,6,8,21,26,-5,24
FK Rubin,5992,8,5,5,10,22,21,1,20
Amkar,5992,9,5,4,11,11,23,-12,19
Rostov,5992,10,4,6,10,10,19,-9,18
Anzhi,5992,11,2,6,12,16,40,-24,12
Loko Moscow,5993,1,11,6,3,30,13,17,39
CSKA Moscow,5993,2,12,3,5,29,17,12,39
Krasnodar,5993,3,10,4,6,31,26,5,34
Spart Moscow,5993,4,9,5,6,37,29,8,32
Zenit,5993,5,7,9,4,21,14,7,30
Terek Grozny,5993,6,7,6,7,21,24,-3,27
Din Moscow,5993,7,6,6,8,19,24,-5,24
Amkar,5993,8,6,4,10,12,23,-11,22
Rostov,5993,9,5,6,9,12,18,-6,21
FK Rubin,5993,10,5,5,10,22,20,2,20
Anzhi,5993,11,2,6,12,14,40,-26,12
Loko Moscow,5994,1,12,6,2,30,11,19,42
CSKA Moscow,5994,2,11,3,6,29,19,10,36
Zenit,5994,3,8,9,3,23,14,9,33
Spart Moscow,5994,4,9,5,6,38,29,9,32
Terek Grozny,5994,5,8,6,6,23,23,0,30
Krasnodar,5994,6,8,5,7,27,25,2,29
FK Rubin,5994,7,6,6,8,23,17,6,24
Rostov,5994,8,5,6,9,11,17,-6,21
Din Moscow,5994,9,5,6,9,18,27,-9,21
Amkar,5994,10,5,5,10,12,24,-12,20
Anzhi,5994,11,2,5,13,14,42,-28,11
Loko Moscow,5995,1,11,5,4,30,17,13,38
Zenit,5995,2,9,8,3,23,13,10,35
Krasnodar,5995,3,10,4,6,34,26,8,34
CSKA Moscow,5995,4,10,4,6,27,20,7,34
Spart Moscow,5995,5,8,8,4,39,31,8,32
Terek Grozny,5995,6,8,6,6,24,25,-1,30
FK Rubin,5995,7,6,5,9,23,19,4,23
Din Moscow,5995,8,5,7,8,18,23,-5,22
Rostov,5995,9,4,7,9,12,19,-7,19
Amkar,5995,10,4,5,11,13,27,-14,17
Anzhi,5995,11,2,7,11,18,41,-23,13
Loko Moscow,5996,1,11,6,3,30,13,17,39
CSKA Moscow,5996,2,10,4,6,25,18,7,34
Krasnodar,5996,3,10,4,6,30,25,5,34
Zenit,5996,4,8,9,3,22,13,9,33
Spart Moscow,5996,5,9,6,5,37,29,8,33
Terek Grozny,5996,6,8,5,7,22,24,-2,29
Din Moscow,5996,7,6,7,7,21,24,-3,25
FK Rubin,5996,8,5,5,10,22,20,2,20
Amkar,5996,9,5,4,11,11,24,-13,19
Rostov,5996,10,4,6,10,10,18,-8,18
Anzhi,5996,11,3,6,11,16,38,-22,15
Loko Moscow,5997,1,12,6,2,30,11,19,42
CSKA Moscow,5997,2,11,4,5,26,17,9,37
Spart Moscow,5997,3,10,6,4,37,25,12,36
Terek Grozny,5997,4,9,5,6,24,23,1,32
Krasnodar,5997,5,9,4,7,31,25,6,31
Zenit,5997,6,7,9,4,21,14,7,30
Din Moscow,5997,7,6,6,8,19,22,-3,24
FK Rubin,5997,8,5,5,10,21,23,-2,20
Rostov,5997,9,4,7,9,10,17,-7,19
Amkar,5997,10,4,4,12,10,27,-17,16
Anzhi,5997,11,2,6,12,14,39,-25,12
Loko Moscow,5998,1,12,5,3,32,12,20,41
Spart Moscow,5998,2,10,6,4,37,25,12,36
CSKA Moscow,5998,3,11,3,6,28,19,9,36
Krasnodar,5998,4,10,4,6,31,26,5,34
Zenit,5998,5,8,8,4,22,16,6,32
Terek Grozny,5998,6,8,6,6,23,24,-1,30
Din Moscow,5998,7,5,7,8,18,25,-7,22
FK Rubin,5998,8,5,6,9,24,21,3,21
Rostov,5998,9,4,7,9,10,17,-7,19
Amkar,5998,10,4,5,11,9,23,-14,17
Anzhi,5998,11,2,5,13,17,43,-26,11
Loko Moscow,5999,1,12,6,2,32,13,19,42
CSKA Moscow,5999,2,11,3,6,31,19,12,36
Zenit,5999,3,8,9,3,24,14,10,33
Terek Grozny,5999,4,9,5,6,23,23,0,32
Spart Moscow,5999,5,8,7,5,35,30,5,31
Krasnodar,5999,6,8,4,8,28,27,1,28
FK Rubin,5999,7,7,5,8,24,18,6,26
Din Moscow,5999,8,5,7,8,19,24,-5,22
Rostov,5999,9,5,6,9,13,17,-4,21
Amkar,5999,10,4,5,11,10,24,-14,17
Anzhi,5999,11,2,5,13,15,45,-30,11
Loko Moscow,6000,1,11,7,2,32,14,18,40
CSKA Moscow,6000,2,10,4,6,26,21,5,34
Zenit,6000,3,8,9,3,25,14,11,33
Spart Moscow,6000,4,9,6,5,36,26,10,33
Krasnodar,6000,5,9,5,6,32,28,4,32
Terek Grozny,6000,6,8,5,7,23,25,-2,29
Din Moscow,6000,7,6,7,7,18,21,-3,25
Rostov,6000,8,5,6,9,11,17,-6,21
FK Rubin,6000,9,5,5,10,22,20,2,20
Amkar,6000,10,4,4,12,10,28,-18,16
Anzhi,6000,11,3,6,11,16,37,-21,15
Loko Moscow,6001,1,12,6,2,30,11,19,42
CSKA Moscow,6001,2,12,3,5,30,18,12,39
Spart Moscow,6001,3,10,6,4,41,28,13,36
Zenit,6001,4,7,9,4,21,15,6,30
Terek Grozny,6001,5,8,5,7,22,24,-2,29
Krasnodar,6001,6,8,4,8,28,27,1,28
FK Rubin,6001,7,6,6,8,24,19,5,24
Din Moscow,6001,8,5,7,8,20,26,-6,22
Amkar,6001,9,5,5,10,11,23,-12,20
Rostov,6001,10,4,6,10,10,20,-10,18
Anzhi,6001,11,2,5,13,16,42,-26,11
Loko Moscow,6002,1,12,6,2,33,12,21,42
CSKA Moscow,6002,2,11,3,6,28,19,9,36
Spart Moscow,6002,3,9,6,5,37,27,10,33
Zenit,6002,4,8,9,3,23,14,9,33
Krasnodar,6002,5,9,4,7,29,27,2,31
Terek Grozny,6002,6,7,6,7,20,23,-3,27
FK Rubin,6002,7,6,5,9,24,20,4,23
Rostov,6002,8,5,6,9,11,17,-6,21
Din Moscow,6002,9,5,6,9,19,28,-9,21
Amkar,6002,10,5,5,10,10,22,-12,20
Anzhi,6002,11,2,6,12,15,40,-25,12
Loko Moscow,6003,1,11,7,2,29,11,18,40
CSKA Moscow,6003,2,12,3,5,31,19,12,39
Spart Moscow,6003,3,11,5,4,42,27,15,38
Krasnodar,6003,4,9,5,6,30,26,4,32
Zenit,6003,5,7,9,4,22,15,7,30
Terek Grozny,6003,6,7,7,6,21,23,-2,28
FK Rubin,6003,7,6,5,9,25,20,5,23
Din Moscow,6003,8,5,6,9,18,28,-10,21
Rostov,6003,9,4,6,10,10,18,-8,18
Amkar,6003,10,4,5,11,10,25,-15,17
Anzhi,6003,11,2,6,12,16,42,-26,12
Loko Moscow,6004,1,12,6,2,32,13,19,42
CSKA Moscow,6004,2,11,4,5,30,19,11,37
Spart Moscow,6004,3,9,6,5,36,28,8,33
Zenit,6004,4,7,9,4,24,17,7,30
Krasnodar,6004,5,8,5,7,28,27,1,29
Terek Grozny,6004,6,7,6,7,21,24,-3,27
FK Rubin,6004,7,7,5,8,24,17,7,26
Din Moscow,6004,8,5,7,8,17,22,-5,22
Rostov,6004,9,5,6,9,12,18,-6,21
Amkar,6004,10,4,5,11,11,25,-14,17
Anzhi,6004,11,3,5,12,15,40,-25,14
Loko Moscow,6005,1,12,5,3,32,14,18,41
CSKA Moscow,6005,2,11,4,5,27,18,9,37
Zenit,6005,3,8,8,4,25,17,8,32
Spart Moscow,6005,4,9,5,6,38,32,6,32
Terek Grozny,6005,5,8,6,6,23,24,-1,30
Krasnodar,6005,6,8,5,7,29,27,2,29
FK Rubin,6005,7,6,6,8,26,20,6,24
Rostov,6005,8,5,6,9,14,20,-6,21
Din Moscow,6005,9,5,6,9,18,25,-7,21
Amkar,6005,10,5,5,10,13,24,-11,20
Anzhi,6005,11,2,6,12,15,39,-24,12
Loko Moscow,6006,1,11,6,3,29,14,15,39
Spart Moscow,6006,2,10,6,4,36,26,10,36
CSKA Moscow,6006,3,10,5,5,31,23,8,35
Zenit,6006,4,8,9,3,26,15,11,33
Krasnodar,6006,5,8,5,7,27,25,2,29
Terek Grozny,6006,6,7,6,7,22,25,-3,27
FK Rubin,6006,7,6,6,8,23,18,5,24
Din Moscow,6006,8,5,7,8,18,23,-5,22
Rostov,6006,9,4,7,9,11,18,-7,19
Amkar,6006,10,4,5,11,10,24,-14,17
Anzhi,6006,11,3,6,11,20,42,-22,15
Loko Moscow,6007,1,13,5,2,36,14,22,44
Spart Moscow,6007,2,11,5,4,44,28,16,38
CSKA Moscow,6007,3,11,4,5,28,18,10,37
Krasnodar,6007,4,9,4,7,32,31,1,31
Zenit,6007,5,7,9,4,23,16,7,30
Terek Grozny,6007,6,7,5,8,20,25,-5,26
Din Moscow,6007,7,6,6,8,20,23,-3,24
FK Rubin,6007,8,5,5,10,23,22,1,20
Amkar,6007,9,5,4,11,11,25,-14,19
Rostov,6007,10,4,6,10,12,23,-11,18
Anzhi,6007,11,3,5,12,15,39,-24,14
Loko Moscow,6008,1,12,6,2,30,11,19,42
Spart Moscow,6008,2,10,6,4,41,27,14,36
Zenit,6008,3,8,9,3,23,13,10,33
CSKA Moscow,6008,4,10,3,7,25,20,5,33
Krasnodar,6008,5,9,4,7,29,26,3,31
Terek Grozny,6008,6,8,5,7,22,23,-1,29
FK Rubin,6008,7,6,5,9,25,20,5,23
Din Moscow,6008,8,5,7,8,18,24,-6,22
Amkar,6008,9,5,4,11,11,27,-16,19
Rostov,6008,10,4,6,10,11,20,-9,18
Anzhi,6008,11,3,5,12,15,39,-24,14
Loko Moscow,6009,1,11,6,3,30,13,17,39
CSKA Moscow,6009,2,12,3,5,31,17,14,39
Krasnodar,6009,3,10,4,6,30,25,5,34
Spart Moscow,6009,4,9,6,5,37,30,7,33
Zenit,6009,5,7,9,4,21,15,6,30
Terek Grozny,6009,6,8,6,6,22,23,-1,30
Din Moscow,6009,7,6,6,8,22,24,-2,24
FK Rubin,6009,8,6,5,9,24,20,4,23
Rostov,6009,9,4,6,10,11,20,-9,18
Amkar,6009,10,4,6,10,11,24,-13,18
Anzhi,6009,11,2,5,13,14,42,-28,11
Loko Moscow,6010,1,12,6,2,32,12,20,42
CSKA Moscow,6010,2,11,3,6,26,19,7,36
Zenit,6010,3,8,9,3,24,14,10,33
Spart Moscow,6010,4,9,5,6,35,27,8,32
Krasnodar,6010,5,9,4,7,29,27,2,31
Terek Grozny,6010,6,8,6,6,25,23,2,30
Din Moscow,6010,7,7,6,7,22,23,-1,27
FK Rubin,6010,8,5,5,10,24,23,1,20
Amkar,6010,9,5,5,10,10,22,-12,20
Rostov,6010,10,4,6,10,10,19,-9,18
Anzhi,6010,11,2,5,13,15,43,-28,11
Loko Moscow,6011,1,12,5,3,35,15,20,41
CSKA Moscow,6011,2,11,4,5,28,19,9,37
Spart Moscow,6011,3,9,6,5,38,29,9,33
Zenit,6011,4,8,9,3,24,15,9,33
Krasnodar,6011,5,8,5,7,29,29,0,29
Terek Grozny,6011,6,7,6,7,20,23,-3,27
Din Moscow,6011,7,6,7,7,18,21,-3,25
FK Rubin,6011,8,5,7,8,21,17,4,22
Rostov,6011,9,4,6,10,12,21,-9,18
Amkar,6011,10,4,6,10,10,23,-13,18
Anzhi,6011,11,3,5,12,16,39,-23,14
CSKA Moscow,6012,1,12,3,5,28,17,11,39
Loko Moscow,6012,2,11,5,4,33,17,16,38
Spart Moscow,6012,3,10,6,4,40,27,13,36
Zenit,6012,4,8,8,4,23,15,8,32
Krasnodar,6012,5,9,5,6,32,28,4,32
Terek Grozny,6012,6,7,5,8,20,24,-4,26
Din Moscow,6012,7,6,6,8,20,25,-5,24
FK Rubin,6012,8,5,6,9,23,21,2,21
Rostov,6012,9,4,7,9,11,18,-7,19
Amkar,6012,10,5,4,11,11,25,-14,19
Anzhi,6012,11,3,5,12,15,39,-24,14
Loko Moscow,6013,1,12,5,3,31,13,18,41
Krasnodar,6013,2,10,4,6,33,26,7,34
CSKA Moscow,6013,3,10,4,6,28,21,7,34
Spart Moscow,6013,4,9,6,5,39,31,8,33
Zenit,6013,5,7,9,4,23,17,6,30
Terek Grozny,6013,6,7,5,8,20,24,-4,26
Din Moscow,6013,7,6,6,8,21,25,-4,24
Rostov,6013,8,5,6,9,13,19,-6,21
FK Rubin,6013,9,5,5,10,24,23,1,20
Amkar,6013,10,5,5,10,11,23,-12,20
Anzhi,6013,11,4,5,11,17,38,-21,17
Loko Moscow,6014,1,12,6,2,32,13,19,42
CSKA Moscow,6014,2,10,4,6,26,20,6,34
Spart Moscow,6014,3,9,6,5,37,30,7,33
Krasnodar,6014,4,9,5,6,28,24,4,32
Zenit,6014,5,7,9,4,24,17,7,30
Terek Grozny,6014,6,8,6,6,26,25,1,30
FK Rubin,6014,7,6,5,9,24,19,5,23
Din Moscow,6014,8,5,6,9,19,27,-8,21
Amkar,6014,9,5,5,10,14,24,-10,20
Rostov,6014,10,4,7,9,10,17,-7,19
Anzhi,6014,11,3,5,12,18,42,-24,14
Loko Moscow,6015,1,12,5,3,31,13,18,41
CSKA Moscow,6015,2,12,3,5,31,18,13,39
Krasnodar,6015,3,9,4,7,30,26,4,31
Spart Moscow,6015,4,8,6,6,34,31,3,30
Zenit,6015,5,7,8,5,22,17,5,29
Terek Grozny,6015,6,7,6,7,21,24,-3,27
Din Moscow,6015,7,6,7,7,20,23,-3,25
FK Rubin,6015,8,6,5,9,24,20,4,23
Amkar,6015,9,6,4,10,13,22,-9,22
Rostov,6015,10,5,6,9,12,17,-5,21
Anzhi,6015,11,2,6,12,15,42,-27,12
Loko Moscow,6016,1,11,7,2,32,14,18,40
Spart Moscow,6016,2,10,6,4,38,26,12,36
CSKA Moscow,6016,3,10,5,5,25,17,8,35
Krasnodar,6016,4,9,5,6,31,27,4,32
Zenit,6016,5,7,10,3,22,14,8,31
Terek Grozny,6016,6,8,5,7,21,24,-3,29
FK Rubin,6016,7,6,5,9,24,19,5,23
Din Moscow,6016,8,5,6,9,17,24,-7,21
Rostov,6016,9,4,7,9,11,18,-7,19
Amkar,6016,10,4,4,12,9,26,-17,16
Anzhi,6016,11,3,6,11,16,37,-21,15
Loko Moscow,6017,1,13,5,2,32,12,20,44
CSKA Moscow,6017,2,11,4,5,29,20,9,37
Spart Moscow,6017,3,9,6,5,37,29,8,33
Zenit,6017,4,7,8,5,22,16,6,29
Krasnodar,6017,5,8,4,8,28,27,1,28
Terek Grozny,6017,6,7,7,6,22,24,-2,28
FK Rubin,6017,7,7,5,8,24,17,7,26
Din Moscow,6017,8,5,6,9,18,25,-7,21
Amkar,6017,9,5,5,10,11,23,-12,20
Rostov,6017,10,4,7,9,12,19,-7,19
Anzhi,6017,11,2,7,11,17,40,-23,13
Loko Moscow,6018,1,12,5,3,32,12,20,41
CSKA Moscow,6018,2,11,4,5,28,18,10,37
Spart Moscow,6018,3,9,7,4,36,27,9,34
Krasnodar,6018,4,9,4,7,29,26,3,31
Zenit,6018,5,7,9,4,22,17,5,30
Terek Grozny,6018,6,7,7,6,21,23,-2,28
Din Moscow,6018,7,6,6,8,22,25,-3,24
FK Rubin,6018,8,6,5,9,25,22,3,23
Rostov,6018,9,4,7,9,10,17,-7,19
Amkar,6018,10,4,6,10,10,23,-13,18
Anzhi,6018,11,2,6,12,15,40,-25,12
CSKA Moscow,6019,1,12,3,5,29,17,12,39
Loko Moscow,6019,2,11,5,4,30,15,15,38
Spart Moscow,6019,3,10,6,4,38,27,11,36
Zenit,6019,4,8,8,4,23,15,8,32
Krasnodar,6019,5,9,5,6,29,24,5,32
Terek Grozny,6019,6,8,5,7,21,25,-4,29
Din Moscow,6019,7,6,6,8,19,22,-3,24
FK Rubin,6019,8,5,6,9,21,19,2,21
Rostov,6019,9,4,6,10,10,19,-9,18
Amkar,6019,10,4,5,11,11,25,-14,17
Anzhi,6019,11,3,5,12,17,40,-23,14
Loko Moscow,6020,1,11,6,3,31,15,16,39
CSKA Moscow,6020,2,11,3,6,26,20,6,36
Spart Moscow,6020,3,10,5,5,39,30,9,35
Krasnodar,6020,4,10,4,6,30,24,6,34
Zenit,6020,5,8,9,3,26,15,11,33
Terek Grozny,6020,6,7,6,7,22,25,-3,27
Din Moscow,6020,7,5,7,8,19,24,-5,22
Amkar,6020,8,6,4,10,14,24,-10,22
FK Rubin,6020,9,5,6,9,21,18,3,21
Rostov,6020,10,4,6,10,10,19,-9,18
Anzhi,6020,11,2,6,12,15,39,-24,12
Loko Moscow,6021,1,13,5,2,33,11,22,44
CSKA Moscow,6021,2,11,4,5,28,19,9,37
Spart Moscow,6021,3,8,7,5,36,29,7,31
Krasnodar,6021,4,9,4,7,30,26,4,31
Terek Grozny,6021,5,8,6,6,22,23,-1,30
Zenit,6021,6,7,8,5,21,16,5,29
Din Moscow,6021,7,6,7,7,22,25,-3,25
FK Rubin,6021,8,5,5,10,22,22,0,20
Amkar,6021,9,5,5,10,10,22,-12,20
Rostov,6021,10,4,7,9,10,17,-7,19
Anzhi,6021,11,2,6,12,17,41,-24,12
Loko Moscow,6022,1,12,5,3,31,13,18,41
Spart Moscow,6022,2,11,5,4,38,25,13,38
Zenit,6022,3,9,8,3,25,14,11,35
CSKA Moscow,6022,4,10,4,6,28,21,7,34
Krasnodar,6022,5,8,5,7,28,27,1,29
Terek Grozny,6022,6,8,5,7,25,25,0,29
FK Rubin,6022,7,5,7,8,22,18,4,22
Din Moscow,6022,8,5,7,8,17,24,-7,22
Amkar,6022,9,5,4,11,11,23,-12,19
Rostov,6022,10,4,6,10,10,18,-8,18
Anzhi,6022,11,2,6,12,17,44,-27,12
Loko Moscow,6023,1,13,5,2,33,12,21,44
CSKA Moscow,6023,2,11,3,6,27,18,9,36
Zenit,6023,3,8,8,4,23,15,8,32
Spart Moscow,6023,4,9,5,6,35,29,6,32
Krasnodar,6023,5,8,4,8,27,28,-1,28
Terek Grozny,6023,6,7,6,7,21,24,-3,27
Din Moscow,6023,7,6,7,7,19,22,-3,25
FK Rubin,6023,8,6,6,8,24,18,6,24
Amkar,6023,9,5,5,10,13,23,-10,20
Rostov,6023,10,4,6,10,10,19,-9,18
Anzhi,6023,11,3,5,12,15,39,-24,14
Loko Moscow,6024,1,11,5,4,30,16,14,38
Spart Moscow,6024,2,10,6,4,40,28,12,36
CSKA Moscow,6024,3,11,3,6,29,21,8,36
Zenit,6024,4,9,8,3,27,14,13,35
Krasnodar,6024,5,9,4,7,29,26,3,31
Terek Grozny,6024,6,7,5,8,21,27,-6,26
FK Rubin,6024,7,6,6,8,22,17,5,24
Din Moscow,6024,8,5,7,8,17,22,-5,22
Amkar,6024,9,5,5,10,14,24,-10,20
Rostov,6024,10,4,6,10,11,21,-10,18
Anzhi,6024,11,3,5,12,17,41,-24,14
Loko Moscow,6025,1,12,5,3,33,16,17,41
Spart Moscow,6025,2,10,6,4,39,28,11,36
CSKA Moscow,6025,3,10,5,5,27,19,8,35
Krasnodar,6025,4,9,4,7,30,26,4,31
Zenit,6025,5,7,9,4,24,17,7,30
Terek Grozny,6025,6,8,6,6,26,24,2,30
FK Rubin,6025,7,6,6,8,22,17,5,24
Din Moscow,6025,8,5,7,8,17,23,-6,22
Rostov,6025,9,4,6,10,11,19,-8,18
Amkar,6025,10,4,5,11,12,29,-17,17
Anzhi,6025,11,2,7,11,16,39,-23,13
Loko Moscow,6026,1,11,6,3,32,16,16,39
Spart Moscow,6026,2,11,5,4,39,28,11,38
CSKA Moscow,6026,3,11,3,6,27,18,9,36
Krasnodar,6026,4,9,5,6,31,26,5,32
Terek Grozny,6026,5,9,5,6,24,22,2,32
Zenit,6026,6,7,9,4,23,17,6,30
FK Rubin,6026,7,6,6,8,24,18,6,24
Din Moscow,6026,8,5,6,9,18,25,-7,21
Rostov,6026,9,4,6,10,11,19,-8,18
Amkar,6026,10,4,4,12,10,27,-17,16
Anzhi,6026,11,3,5,12,15,38,-23,14
Loko Moscow,6027,1,12,6,2,31,12,19,42
CSKA Moscow,6027,2,12,3,5,29,19,10,39
Spart Moscow,6027,3,11,5,4,37,26,11,38
Zenit,6027,4,7,9,4,22,15,7,30
Krasnodar,6027,5,8,5,7,29,27,2,29
Terek Grozny,6027,6,7,6,7,20,23,-3,27
Din Moscow,6027,7,6,6,8,18,22,-4,24
FK Rubin,6027,8,5,6,9,22,19,3,21
Rostov,6027,9,4,6,10,11,19,-8,18
Amkar,6027,10,4,5,11,9,23,-14,17
Anzhi,6027,11,3,5,12,16,39,-23,14
Loko Moscow,6028,1,11,6,3,29,12,17,39
Spart Moscow,6028,2,11,5,4,42,27,15,38
Zenit,6028,3,9,8,3,24,13,11,35
CSKA Moscow,6028,4,10,4,6,25,19,6,34
Krasnodar,6028,5,9,5,6,31,24,7,32
Terek Grozny,6028,6,8,5,7,24,23,1,29
FK Rubin,6028,7,6,5,9,22,21,1,23
Din Moscow,6028,8,5,6,9,18,26,-8,21
Rostov,6028,9,4,6,10,10,19,-9,18
Amkar,6028,10,4,4,12,10,29,-19,16
Anzhi,6028,11,3,6,11,15,37,-22,15
Loko Moscow,6029,1,13,5,2,33,11,22,44
CSKA Moscow,6029,2,11,3,6,28,19,9,36
Spart Moscow,6029,3,9,6,5,35,28,7,33
Zenit,6029,4,8,8,4,23,15,8,32
Terek Grozny,6029,5,8,6,6,22,23,-1,30
Krasnodar,6029,6,8,4,8,28,28,0,28
Din Moscow,6029,7,6,7,7,20,22,-2,25
FK Rubin,6029,8,6,6,8,24,19,5,24
Rostov,6029,9,4,7,9,11,18,-7,19
Amkar,6029,10,4,5,11,10,24,-14,17
Anzhi,6029,11,2,5,13,14,41,-27,11
Loko Moscow,6030,1,11,6,3,31,15,16,39
CSKA Moscow,6030,2,11,3,6,29,22,7,36
Zenit,6030,3,8,9,3,28,17,11,33
Spart Moscow,6030,4,9,6,5,36,28,8,33
Krasnodar,6030,5,9,4,7,29,25,4,31
Terek Grozny,6030,6,7,5,8,21,28,-7,26
FK Rubin,6030,7,6,6,8,22,17,5,24
Din Moscow,6030,8,5,8,7,18,22,-4,23
Amkar,6030,9,6,4,10,14,23,-9,22
Rostov,6030,10,4,6,10,10,18,-8,18
Anzhi,6030,11,3,5,12,17,40,-23,14
Loko Moscow,6031,1,11,5,4,29,13,16,38
CSKA Moscow,6031,2,11,3,6,27,18,9,36
Zenit,6031,3,9,8,3,23,13,10,35
Krasnodar,6031,4,10,4,6,30,25,5,34
Spart Moscow,6031,5,9,6,5,39,30,9,33
Terek Grozny,6031,6,9,5,6,26,22,4,32
FK Rubin,6031,7,6,5,9,24,19,5,23
Din Moscow,6031,8,5,7,8,19,25,-6,22
Amkar,6031,9,5,4,11,11,25,-14,19
Rostov,6031,10,4,6,10,11,20,-9,18
Anzhi,6031,11,2,5,13,14,43,-29,11
Loko Moscow,6032,1,11,6,3,30,14,16,39
CSKA Moscow,6032,2,11,4,5,27,18,9,37
Krasnodar,6032,3,10,4,6,32,25,7,34
Spart Moscow,6032,4,9,5,6,37,31,6,32
Zenit,6032,5,7,9,4,21,14,7,30
Din Moscow,6032,6,7,6,7,21,22,-1,27
Terek Grozny,6032,7,7,6,7,22,25,-3,27
Amkar,6032,8,6,4,10,13,23,-10,22
FK Rubin,6032,9,5,5,10,21,20,1,20
Rostov,6032,10,4,6,10,11,20,-9,18
Anzhi,6032,11,2,7,11,16,39,-23,13
Loko Moscow,6033,1,12,6,2,31,11,20,42
CSKA Moscow,6033,2,11,3,6,26,18,8,36
Spart Moscow,6033,3,10,5,5,40,28,12,35
Zenit,6033,4,8,9,3,22,13,9,33
Krasnodar,6033,5,8,5,7,28,27,1,29
Terek Grozny,6033,6,8,5,7,23,24,-1,29
Din Moscow,6033,7,6,6,8,19,24,-5,24
FK Rubin,6033,8,5,6,9,22,20,2,21
Rostov,6033,9,5,6,9,13,18,-5,21
Amkar,6033,10,5,4,11,11,26,-15,19
Anzhi,6033,11,2,5,13,14,40,-26,11
Loko Moscow,6034,1,11,6,3,30,14,16,39
Spart Moscow,6034,2,11,5,4,43,27,16,38
CSKA Moscow,6034,3,11,3,6,30,18,12,36
Krasnodar,6034,4,10,4,6,30,24,6,34
Zenit,6034,5,8,9,3,23,14,9,33
Terek Grozny,6034,6,9,5,6,25,25,0,32
FK Rubin,6034,7,6,5,9,22,18,4,23
Din Moscow,6034,8,5,6,9,18,25,-7,21
Rostov,6034,9,4,6,10,11,22,-11,18
Amkar,6034,10,4,4,12,12,28,-16,16
Anzhi,6034,11,2,5,13,14,43,-29,11
Loko Moscow,6035,1,13,5,2,33,12,21,44
CSKA Moscow,6035,2,11,3,6,27,19,8,36
Spart Moscow,6035,3,9,7,4,35,26,9,34
Krasnodar,6035,4,9,4,7,31,26,5,31
Zenit,6035,5,7,8,5,23,18,5,29
Terek Grozny,6035,6,7,6,7,22,25,-3,27
Din Moscow,6035,7,5,7,8,20,25,-5,22
FK Rubin,6035,8,5,6,9,24,23,1,21
Rostov,6035,9,4,7,9,10,17,-7,19
Amkar,6035,10,4,6,10,10,23,-13,18
Anzhi,6035,11,4,5,11,17,38,-21,17
Loko Moscow,6036,1,12,5,3,31,13,18,41
Zenit,6036,2,9,8,3,25,14,11,35
CSKA Moscow,6036,3,10,4,6,26,19,7,34
Spart Moscow,6036,4,9,6,5,36,29,7,33
Krasnodar,6036,5,9,4,7,28,26,2,31
Terek Grozny,6036,6,7,5,8,20,28,-8,26
Din Moscow,6036,7,6,6,8,20,25,-5,24
FK Rubin,6036,8,6,5,9,25,19,6,23
Amkar,6036,9,5,5,10,14,24,-10,20
Rostov,6036,10,4,6,10,10,18,-8,18
Anzhi,6036,11,3,6,11,17,37,-20,15
Loko Moscow,6037,1,11,6,3,30,13,17,39
CSKA Moscow,6037,2,11,4,5,28,19,9,37
Zenit,6037,3,7,10,3,23,15,8,31
Krasnodar,6037,4,9,4,7,31,28,3,31
Spart Moscow,6037,5,8,6,6,36,34,2,30
Terek Grozny,6037,6,7,6,7,20,23,-3,27
Din Moscow,6037,7,6,7,7,21,22,-1,25
FK Rubin,6037,8,6,6,8,25,20,5,24
Amkar,6037,9,5,5,10,12,22,-10,20
Rostov,6037,10,4,7,9,12,19,-7,19
Anzhi,6037,11,3,5,12,16,39,-23,14
Loko Moscow,6038,1,11,5,4,30,15,15,38
Spart Moscow,6038,2,9,7,4,35,26,9,34
CSKA Moscow,6038,3,10,4,6,25,18,7,34
Zenit,6038,4,8,9,3,23,14,9,33
Krasnodar,6038,5,9,5,6,29,24,5,32
Terek Grozny,6038,6,8,6,6,21,22,-1,30
Din Moscow,6038,7,6,6,8,18,22,-4,24
FK Rubin,6038,8,5,6,9,21,18,3,21
Rostov,6038,9,4,7,9,10,17,-7,19
Amkar,6038,10,4,6,10,10,23,-13,18
Anzhi,6038,11,3,5,12,15,38,-23,14
Loko Moscow,6039,1,11,6,3,32,15,17,39
Spart Moscow,6039,2,10,6,4,40,27,13,36
CSKA Moscow,6039,3,10,4,6,29,22,7,34
Zenit,6039,4,8,9,3,25,16,9,33
Krasnodar,6039,5,9,5,6,33,29,4,32
Terek Grozny,6039,6,8,5,7,23,25,-2,29
FK Rubin,6039,7,6,6,8,27,21,6,24
Din Moscow,6039,8,5,6,9,18,25,-7,21
Rostov,6039,9,4,7,9,11,18,-7,19
Amkar,6039,10,5,4,11,12,27,-15,19
Anzhi,6039,11,2,6,12,17,42,-25,12
Loko Moscow,6040,1,13,5,2,32,11,21,44
CSKA Moscow,6040,2,12,3,5,31,20,11,39
Spart Moscow,6040,3,9,6,5,37,29,8,33
Terek Grozny,6040,4,8,6,6,23,24,-1,30
Zenit,6040,5,7,8,5,22,16,6,29
Krasnodar,6040,6,8,4,8,28,28,0,28
FK Rubin,6040,7,7,5,8,25,18,7,26
Din Moscow,6040,8,5,6,9,17,25,-8,21
Amkar,6040,9,5,5,10,12,23,-11,20
Rostov,6040,10,4,7,9,12,19,-7,19
Anzhi,6040,11,2,5,13,17,43,-26,11
Loko Moscow,6041,1,12,5,3,33,13,20,41
Spart Moscow,6041,2,11,5,4,37,25,12,38
CSKA Moscow,6041,3,11,3,6,26,20,6,36
Zenit,6041,4,8,8,4,24,16,8,32
Krasnodar,6041,5,9,5,6,29,25,4,32
Terek Grozny,6041,6,8,6,6,22,23,-1,30
FK Rubin,6041,7,5,7,8,22,18,4,22
Din Moscow,6041,8,5,7,8,18,23,-5,22
Rostov,6041,9,4,6,10,10,19,-9,18
Amkar,6041,10,4,5,11,9,23,-14,17
Anzhi,6041,11,2,5,13,15,40,-25,11
Loko Moscow,6042,1,13,5,2,34,11,23,44
CSKA Moscow,6042,2,11,3,6,28,19,9,36
Spart Moscow,6042,3,10,5,5,36,26,10,35
Terek Grozny,6042,4,9,5,6,23,23,0,32
Zenit,6042,5,7,8,5,21,18,3,29
Krasnodar,6042,6,8,4,8,27,30,-3,28
Din Moscow,6042,7,6,7,7,18,21,-3,25
FK Rubin,6042,8,6,6,8,25,17,8,24
Rostov,6042,9,4,6,10,10,18,-8,18
Amkar,6042,10,4,4,12,9,25,-16,16
Anzhi,6042,11,3,5,12,17,40,-23,14
Loko Moscow,6043,1,11,6,3,31,15,16,39
Spart Moscow,6043,2,10,5,5,39,29,10,35
CSKA Moscow,6043,3,10,4,6,29,22,7,34
Krasnodar,6043,4,10,4,6,31,25,6,34
Zenit,6043,5,8,9,3,26,17,9,33
Terek Grozny,6043,6,7,7,6,22,24,-2,28
Din Moscow,6043,7,6,6,8,22,25,-3,24
FK Rubin,6043,8,5,5,10,22,22,0,20
Amkar,6043,9,5,5,10,11,23,-12,20
Rostov,6043,10,4,6,10,11,19,-8,18
Anzhi,6043,11,2,7,11,17,40,-23,13
Loko Moscow,6044,1,11,7,2,31,13,18,40
Spart Moscow,6044,2,10,6,4,39,28,11,36
CSKA Moscow,6044,3,10,4,6,26,19,7,34
Zenit,6044,4,8,9,3,23,14,9,33
Krasnodar,6044,5,9,5,6,31,27,4,32
Terek Grozny,6044,6,7,5,8,21,25,-4,26
FK Rubin,6044,7,6,5,9,24,20,4,23
Din Moscow,6044,8,5,6,9,17,24,-7,21
Rostov,6044,9,4,7,9,13,20,-7,19
Amkar,6044,10,5,4,11,11,24,-13,19
Anzhi,6044,11,3,6,11,16,38,-22,15
Loko Moscow,6045,1,11,6,3,29,12,17,39
CSKA Moscow,6045,2,11,3,6,26,20,6,36
Zenit,6045,3,8,9,3,24,13,11,33
Spart Moscow,6045,4,9,5,6,35,29,6,32
Krasnodar,6045,5,9,5,6,29,25,4,32
Terek Grozny,6045,6,8,6,6,24,22,2,30
Din Moscow,6045,7,6,6,8,19,24,-5,24
FK Rubin,6045,8,5,6,9,23,20,3,21
Rostov,6045,9,5,6,9,12,17,-5,21
Amkar,6045,10,5,5,10,11,22,-11,20
Anzhi,6045,11,2,5,13,14,42,-28,11
Loko Moscow,6046,1,13,5,2,32,12,20,44
Spart Moscow,6046,2,10,6,4,39,26,13,36
CSKA Moscow,6046,3,10,4,6,27,20,7,34
Krasnodar,6046,4,9,4,7,30,26,4,31
Zenit,6046,5,7,9,4,23,16,7,30
Terek Grozny,6046,6,7,7,6,21,23,-2,28
Din Moscow,6046,7,5,7,8,20,26,-6,22
FK Rubin,6046,8,5,6,9,24,22,2,21
Rostov,6046,9,4,7,9,10,17,-7,19
Amkar,6046,10,4,5,11,10,26,-16,17
Anzhi,6046,11,3,6,11,16,38,-22,15
Loko Moscow,6047,1,13,5,2,35,13,22,44
Spart Moscow,6047,2,11,5,4,40,26,14,38
CSKA Moscow,6047,3,10,4,6,28,22,6,34
Zenit,6047,4,8,8,4,26,17,9,32
Terek Grozny,6047,5,9,5,6,24,23,1,32
Krasnodar,6047,6,9,4,7,32,28,4,31
Din Moscow,6047,7,6,6,8,18,24,-6,24
FK Rubin,6047,8,5,5,10,21,22,-1,20
Rostov,6047,9,4,6,10,11,20,-9,18
Amkar,6047,10,4,4,12,9,24,-15,16
Anzhi,6047,11,2,6,12,16,41,-25,12
Loko Moscow,6048,1,11,6,3,29,13,16,39
Spart Moscow,6048,2,11,5,4,42,27,15,38
Krasnodar,6048,3,10,4,6,30,24,6,34
Zenit,6048,4,8,9,3,22,13,9,33
CSKA Moscow,6048,5,10,3,7,26,20,6,33
Terek Grozny,6048,6,7,5,8,21,25,-4,26
FK Rubin,6048,7,6,5,9,22,18,4,23
Din Moscow,6048,8,5,6,9,17,24,-7,21
Amkar,6048,9,5,4,11,11,25,-14,19
Rostov,6048,10,4,6,10,11,21,-10,18
Anzhi,6048,11,4,5,11,18,39,-21,17
Loko Moscow,6049,1,11,7,2,31,13,18,40
CSKA Moscow,6049,2,11,4,5,33,19,14,37
Spart Moscow,6049,3,9,6,5,37,27,10,33
Zenit,6049,4,7,10,3,23,15,8,31
Krasnodar,6049,5,8,6,6,31,28,3,30
Terek Grozny,6049,6,7,6,7,21,24,-3,27
Din Moscow,6049,7,6,7,7,22,23,-1,25
Amkar,6049,8,6,4,10,11,22,-11,22
FK Rubin,6049,9,5,6,9,24,23,1,21
Rostov,6049,10,4,6,10,10,20,-10,18
Anzhi,6049,11,2,6,12,15,44,-29,12
Loko Moscow,6050,1,12,5,3,30,13,17,41
CSKA Moscow,6050,2,10,4,6,28,22,6,34
Spart Moscow,6050,3,9,6,5,37,28,9,33
Zenit,6050,4,8,8,4,24,15,9,32
Krasnodar,6050,5,9,5,6,30,25,5,32
Terek Grozny,6050,6,8,5,7,22,23,-1,29
Din Moscow,6050,7,6,7,7,18,21,-3,25
FK Rubin,6050,8,5,6,9,22,19,3,21
Amkar,6050,9,5,4,11,12,26,-14,19
Rostov,6050,10,4,6,10,10,19,-9,18
Anzhi,6050,11,3,6,11,17,39,-22,15
Loko Moscow,6051,1,12,6,2,31,12,19,42
CSKA Moscow,6051,2,11,4,5,27,18,9,37
Spart Moscow,6051,3,9,7,4,38,29,9,34
Zenit,6051,4,7,10,3,22,14,8,31
Krasnodar,6051,5,9,4,7,29,25,4,31
Terek Grozny,6051,6,7,5,8,21,25,-4,26
Din Moscow,6051,7,5,8,7,19,23,-4,23
FK Rubin,6051,8,5,6,9,22,20,2,21
Rostov,6051,9,4,7,9,11,18,-7,19
Amkar,6051,10,5,4,11,12,25,-13,19
Anzhi,6051,11,3,5,12,17,40,-23,14
Loko Moscow,6052,1,12,5,3,33,14,19,41
CSKA Moscow,6052,2,11,4,5,27,18,9,37
Spart Moscow,6052,3,8,7,5,33,26,7,31
Krasnodar,6052,4,9,4,7,30,27,3,31
Terek Grozny,6052,5,8,6,6,23,23,0,30
Zenit,6052,6,7,8,5,22,17,5,29
Din Moscow,6052,7,6,7,7,18,21,-3,25
FK Rubin,6052,8,6,5,9,23,19,4,23
Amkar,6052,9,5,5,10,11,23,-12,20
Rostov,6052,10,4,7,9,10,17,-7,19
Anzhi,6052,11,2,6,12,15,40,-25,12
Loko Moscow,6053,1,11,6,3,30,13,17,39
CSKA Moscow,6053,2,10,4,6,25,18,7,34
Zenit,6053,3,8,9,3,23,14,9,33
Spart Moscow,6053,4,9,6,5,36,29,7,33
Krasnodar,6053,5,9,5,6,28,24,4,32
Terek Grozny,6053,6,7,7,6,21,23,-2,28
Din Moscow,6053,7,6,7,7,19,22,-3,25
FK Rubin,6053,8,5,6,9,21,18,3,21
Amkar,6053,9,5,5,10,12,22,-10,20
Rostov,6053,10,4,6,10,10,19,-9,18
Anzhi,6053,11,2,7,11,15,38,-23,13
Loko Moscow,6054,1,13,5,2,36,12,24,44
CSKA Moscow,6054,2,12,3,5,31,18,13,39
Spart Moscow,6054,3,10,6,4,38,27,11,36
Zenit,6054,4,7,8,5,23,21,2,29
Krasnodar,6054,5,8,5,7,28,28,0,29
Terek Grozny,6054,6,7,7,6,21,23,-2,28
FK Rubin,6054,7,5,7,8,23,19,4,22
Din Moscow,6054,8,5,7,8,18,24,-6,22
Rostov,6054,9,4,6,10,10,18,-8,18
Amkar,6054,10,4,6,10,12,25,-13,18
Anzhi,6054,11,2,6,12,14,39,-25,12
Loko Moscow,6055,1,11,7,2,32,14,18,40
CSKA Moscow,6055,2,11,3,6,29,20,9,36
Zenit,6055,3,8,9,3,25,15,10,33
Spart Moscow,6055,4,9,5,6,36,29,7,32
Krasnodar,6055,5,8,6,6,30,27,3,30
Terek Grozny,6055,6,7,6,7,21,24,-3,27
FK Rubin,6055,7,6,6,8,23,18,5,24
Amkar,6055,8,6,4,10,13,24,-11,22
Din Moscow,6055,9,5,6,9,17,23,-6,21
Rostov,6055,10,5,6,9,12,18,-6,21
Anzhi,6055,11,2,6,12,14,40,-26,12
Loko Moscow,6056,1,11,6,3,29,13,16,39
CSKA Moscow,6056,2,11,4,5,28,17,11,37
Zenit,6056,3,8,9,3,23,13,10,33
Spart Moscow,6056,4,9,6,5,35,28,7,33
Krasnodar,6056,5,9,5,6,29,25,4,32
Terek Grozny,6056,6,7,5,8,20,24,-4,26
FK Rubin,6056,7,6,5,9,23,19,4,23
Din Moscow,6056,8,5,7,8,18,23,-5,22
Rostov,6056,9,5,6,9,12,17,-5,21
Amkar,6056,10,5,4,11,10,23,-13,19
Anzhi,6056,11,3,5,12,15,40,-25,14
Loko Moscow,6057,1,12,6,2,32,11,21,42
CSKA Moscow,6057,2,11,4,5,27,17,10,37
Spart Moscow,6057,3,9,7,4,37,27,10,34
Terek Grozny,6057,4,9,5,6,23,23,0,32
Zenit,6057,5,7,10,3,21,13,8,31
Krasnodar,6057,6,8,5,7,27,27,0,29
Din Moscow,6057,7,5,8,7,19,23,-4,23
FK Rubin,6057,8,5,7,8,22,18,4,22
Rostov,6057,9,4,6,10,11,20,-9,18
Amkar,6057,10,4,5,11,10,24,-14,17
Anzhi,6057,11,2,5,13,14,40,-26,11
Loko Moscow,6058,1,12,6,2,34,14,20,42
CSKA Moscow,6058,2,11,3,6,27,20,7,36
Zenit,6058,3,8,9,3,24,14,10,33
Spart Moscow,6058,4,9,5,6,35,28,7,32
Krasnodar,6058,5,8,5,7,30,29,1,29
Terek Grozny,6058,6,8,5,7,23,23,0,29
Din Moscow,6058,7,6,6,8,20,25,-5,24
FK Rubin,6058,8,5,6,9,24,21,3,21
Rostov,6058,9,5,6,9,11,17,-6,21
Amkar,6058,10,5,4,11,11,25,-14,19
Anzhi,6058,11,3,5,12,16,39,-23,14
Loko Moscow,6059,1,12,6,2,30,11,19,42
CSKA Moscow,6059,2,12,3,5,29,17,12,39
Spart Moscow,6059,3,9,6,5,35,31,4,33
Terek Grozny,6059,4,9,5,6,23,23,0,32
Zenit,6059,5,7,8,5,21,15,6,29
Krasnodar,6059,6,8,5,7,27,25,2,29
FK Rubin,6059,7,6,6,8,23,18,5,24
Din Moscow,6059,8,5,7,8,19,24,-5,22
Rostov,6059,9,4,7,9,10,17,-7,19
Amkar,6059,10,5,4,11,15,24,-9,19
Anzhi,6059,11,2,5,13,14,41,-27,11
Loko Moscow,6060,1,12,5,3,31,12,19,41
CSKA Moscow,6060,2,11,4,5,29,18,11,37
Spart Moscow,6060,3,9,7,4,36,27,9,34
Zenit,6060,4,8,9,3,23,14,9,33
Krasnodar,6060,5,9,4,7,29,27,2,31
Terek Grozny,6060,6,8,5,7,24,25,-1,29
Din Moscow,6060,7,6,7,7,22,22,0,25
FK Rubin,6060,8,5,5,10,23,24,-1,20
Rostov,6060,9,4,7,9,11,18,-7,19
Amkar,6060,10,5,4,11,12,25,-13,19
Anzhi,6060,11,2,5,13,15,43,-28,11
Loko Moscow,6061,1,11,6,3,29,13,16,39
CSKA Moscow,6061,2,11,4,5,26,17,9,37
Spart Moscow,6061,3,10,5,5,40,27,13,35
Krasnodar,6061,4,9,5,6,29,24,5,32
Zenit,6061,5,7,9,4,21,14,7,30
Terek Grozny,6061,6,8,6,6,25,24,1,30
Din Moscow,6061,7,6,7,7,18,21,-3,25
FK Rubin,6061,8,5,7,8,21,17,4,22
Rostov,6061,9,4,6,10,10,21,-11,18
Amkar,6061,10,4,5,11,11,26,-15,17
Anzhi,6061,11,2,6,12,15,41,-26,12
Loko Moscow,6062,1,11,6,3,31,15,16,39
Spart Moscow,6062,2,11,5,4,41,27,14,38
CSKA Moscow,6062,3,11,3,6,26,19,7,36
Zenit,6062,4,8,9,3,25,15,10,33
Krasnodar,6062,5,9,5,6,30,25,5,32
Terek Grozny,6062,6,7,6,7,22,26,-4,27
FK Rubin,6062,7,6,6,8,24,19,5,24
Din Moscow,6062,8,5,6,9,18,25,-7,21
Amkar,6062,9,5,4,11,11,24,-13,19
Rostov,6062,10,4,6,10,12,21,-9,18
Anzhi,6062,11,2,6,12,16,40,-24,12
Loko Moscow,6063,1,13,5,2,33,13,20,44
CSKA Moscow,6063,2,11,3,6,27,19,8,36
Spart Moscow,6063,3,9,6,5,39,31,8,33
Zenit,6063,4,8,8,4,23,15,8,32
Krasnodar,6063,5,9,4,7,31,28,3,31
Terek Grozny,6063,6,7,6,7,20,24,-4,27
Din Moscow,6063,7,6,7,7,20,22,-2,25
FK Rubin,6063,8,5,5,10,23,22,1,20
Amkar,6063,9,5,5,10,13,24,-11,20
Rostov,6063,10,4,6,10,11,20,-9,18
Anzhi,6063,11,3,5,12,17,39,-22,14
Loko Moscow,6064,1,11,5,4,30,17,13,38
CSKA Moscow,6064,2,11,3,6,30,20,10,36
Zenit,6064,3,9,8,3,27,15,12,35
Spart Moscow,6064,4,9,7,4,38,29,9,34
Krasnodar,6064,5,9,4,7,29,25,4,31
Terek Grozny,6064,6,7,5,8,20,28,-8,26
Din Moscow,6064,7,6,7,7,21,22,-1,25
FK Rubin,6064,8,6,5,9,22,20,2,23
Amkar,6064,9,5,5,10,13,24,-11,20
Rostov,6064,10,4,6,10,11,19,-8,18
Anzhi,6064,11,3,5,12,19,41,-22,14
Loko Moscow,6065,1,12,6,2,32,12,20,42
Spart Moscow,6065,2,11,5,4,41,27,14,38
CSKA Moscow,6065,3,11,3,6,29,20,9,36
Zenit,6065,4,8,8,4,24,16,8,32
Krasnodar,6065,5,8,5,7,28,27,1,29
Terek Grozny,6065,6,8,5,7,23,24,-1,29
FK Rubin,6065,7,7,5,8,26,18,8,26
Din Moscow,6065,8,5,6,9,18,27,-9,21
Amkar,6065,9,5,4,11,11,25,-14,19
Rostov,6065,10,4,6,10,12,20,-8,18
Anzhi,6065,11,2,5,13,14,42,-28,11
Loko Moscow,6066,1,13,5,2,32,11,21,44
CSKA Moscow,6066,2,12,3,5,29,18,11,39
Spart Moscow,6066,3,9,6,5,36,28,8,33
Zenit,6066,4,7,8,5,22,16,6,29
Krasnodar,6066,5,8,5,7,27,26,1,29
Terek Grozny,6066,6,7,6,7,21,24,-3,27
FK Rubin,6066,7,6,6,8,22,17,5,24
Din Moscow,6066,8,6,6,8,19,23,-4,24
Rostov,6066,9,4,6,10,10,18,-8,18
Amkar,6066,10,4,6,10,10,23,-13,18
Anzhi,6066,11,3,5,12,16,40,-24,14
Loko Moscow,6067,1,12,5,3,30,15,15,41
CSKA Moscow,6067,2,10,5,5,29,21,8,35
Spart Moscow,6067,3,9,7,4,37,27,10,34
Krasnodar,6067,4,10,4,6,32,24,8,34
Zenit,6067,5,7,9,4,23,16,7,30
Terek Grozny,6067,6,8,6,6,23,24,-1,30
FK Rubin,6067,7,6,5,9,22,18,4,23
Din Moscow,6067,8,5,6,9,17,24,-7,21
Rostov,6067,9,4,7,9,11,18,-7,19
Amkar,6067,10,4,5,11,11,25,-14,17
Anzhi,6067,11,2,7,11,17,40,-23,13
Loko Moscow,6068,1,11,6,3,30,13,17,39
CSKA Moscow,6068,2,11,3,6,26,19,7,36
Spart Moscow,6068,3,9,5,6,36,29,7,32
Krasnodar,6068,4,9,4,7,30,27,3,31
Zenit,6068,5,7,9,4,22,15,7,30
Terek Grozny,6068,6,7,5,8,20,26,-6,26
Din Moscow,6068,7,6,6,8,18,22,-4,24
FK Rubin,6068,8,6,5,9,24,20,4,23
Amkar,6068,9,6,4,10,14,23,-9,22
Rostov,6068,10,5,6,9,12,18,-6,21
Anzhi,6068,11,4,5,11,17,37,-20,17
Loko Moscow,6069,1,13,5,2,32,12,20,44
Spart Moscow,6069,2,10,6,4,38,27,11,36
CSKA Moscow,6069,3,10,4,6,27,20,7,34
Zenit,6069,4,8,8,4,24,16,8,32
Krasnodar,6069,5,8,5,7,29,27,2,29
Terek Grozny,6069,6,7,6,7,23,26,-3,27
FK Rubin,6069,7,5,7,8,23,19,4,22
Din Moscow,6069,8,5,7,8,18,23,-5,22
Amkar,6069,9,5,5,10,11,23,-12,20
Rostov,6069,10,4,6,10,11,20,-9,18
Anzhi,6069,11,2,7,11,17,40,-23,13
Loko Moscow,6070,1,12,5,3,33,15,18,41
Spart Moscow,6070,2,11,5,4,40,26,14,38
CSKA Moscow,6070,3,11,4,5,26,17,9,37
Zenit,6070,4,8,8,4,23,14,9,32
Krasnodar,6070,5,8,5,7,30,29,1,29
Terek Grozny,6070,6,7,6,7,22,25,-3,27
FK Rubin,6070,7,6,6,8,23,18,5,24
Din Moscow,6070,8,5,6,9,17,25,-8,21
Amkar,6070,9,5,4,11,10,23,-13,19
Rostov,6070,10,4,6,10,11,20,-9,18
Anzhi,6070,11,2,7,11,16,39,-23,13
Loko Moscow,6071,1,12,5,3,30,13,17,41
CSKA Moscow,6071,2,11,4,5,28,19,9,37
Spart Moscow,6071,3,10,6,4,39,29,10,36
Krasnodar,6071,4,9,4,7,29,25,4,31
Zenit,6071,5,7,8,5,22,16,6,29
Terek Grozny,6071,6,7,7,6,23,25,-2,28
Din Moscow,6071,7,6,6,8,19,23,-4,24
FK Rubin,6071,8,6,5,9,23,19,4,23
Rostov,6071,9,4,7,9,12,19,-7,19
Amkar,6071,10,4,5,11,12,26,-14,17
Anzhi,6071,11,2,7,11,17,40,-23,13
Loko Moscow,6072,1,12,6,2,31,12,19,42
CSKA Moscow,6072,2,11,4,5,29,17,12,37
Zenit,6072,3,7,10,3,22,14,8,31
Spart Moscow,6072,4,8,7,5,35,28,7,31
Krasnodar,6072,5,9,4,7,29,25,4,31
Terek Grozny,6072,6,7,6,7,21,25,-4,27
Din Moscow,6072,7,6,7,7,21,22,-1,25
FK Rubin,6072,8,5,5,10,21,22,-1,20
Amkar,6072,9,5,5,10,10,22,-12,20
Rostov,6072,10,4,7,9,11,18,-7,19
Anzhi,6072,11,3,5,12,17,42,-25,14
Loko Moscow,6073,1,12,5,3,31,14,17,41
CSKA Moscow,6073,2,11,4,5,29,17,12,37
Spart Moscow,6073,3,10,5,5,38,29,9,35
Krasnodar,6073,4,10,4,6,33,26,7,34
Zenit,6073,5,7,9,4,21,15,6,30
Terek Grozny,6073,6,8,5,7,23,23,0,29
FK Rubin,6073,7,6,5,9,26,20,6,23
Din Moscow,6073,8,5,6,9,17,26,-9,21
Amkar,6073,9,5,4,11,12,25,-13,19
Rostov,6073,10,4,6,10,11,20,-9,18
Anzhi,6073,11,3,5,12,15,41,-26,14
Loko Moscow,6074,1,12,5,3,30,12,18,41
CSKA Moscow,6074,2,10,5,5,28,20,8,35
Krasnodar,6074,3,10,4,6,30,24,6,34
Spart Moscow,6074,4,9,6,5,36,28,8,33
Zenit,6074,5,7,9,4,21,14,7,30
Terek Grozny,6074,6,7,6,7,21,25,-4,27
Din Moscow,6074,7,6,7,7,21,23,-2,25
FK Rubin,6074,8,5,5,10,21,21,0,20
Amkar,6074,9,5,5,10,11,23,-12,20
Rostov,6074,10,4,6,10,10,18,-8,18
Anzhi,6074,11,3,6,11,19,40,-21,15
Loko Moscow,6075,1,13,5,2,32,12,20,44
Spart Moscow,6075,2,10,5,5,37,26,11,35
CSKA Moscow,6075,3,10,3,7,25,22,3,33
Zenit,6075,4,8,8,4,24,14,10,32
Terek Grozny,6075,5,9,5,6,26,24,2,32
Krasnodar,6075,6,8,5,7,29,27,2,29
FK Rubin,6075,7,6,6,8,23,18,5,24
Din Moscow,6075,8,5,6,9,17,24,-7,21
Amkar,6075,9,5,4,11,10,24,-14,19
Rostov,6075,10,4,6,10,10,19,-9,18
Anzhi,6075,11,3,5,12,18,41,-23,14
Loko Moscow,6076,1,12,5,3,32,12,20,41
CSKA Moscow,6076,2,11,4,5,29,19,10,37
Krasnodar,6076,3,10,4,6,29,24,5,34
Spart Moscow,6076,4,9,6,5,36,29,7,33
Zenit,6076,5,7,9,4,21,16,5,30
Terek Grozny,6076,6,7,5,8,21,25,-4,26
Din Moscow,6076,7,6,6,8,20,23,-3,24
FK Rubin,6076,8,6,5,9,22,18,4,23
Rostov,6076,9,4,7,9,11,18,-7,19
Amkar,6076,10,5,4,11,10,23,-13,19
Anzhi,6076,11,3,5,12,18,42,-24,14
CSKA Moscow,6077,1,12,3,5,30,18,12,39
Loko Moscow,6077,2,11,5,4,31,15,16,38
Krasnodar,6077,3,10,4,6,31,26,5,34
Spart Moscow,6077,4,9,5,6,37,29,8,32
Zenit,6077,5,8,8,4,24,16,8,32
Din Moscow,6077,6,7,6,7,21,22,-1,27
Terek Grozny,6077,7,7,6,7,20,23,-3,27
Amkar,6077,8,6,4,10,12,22,-10,22
FK Rubin,6077,9,5,5,10,22,21,1,20
Rostov,6077,10,4,6,10,10,20,-10,18
Anzhi,6077,11,2,6,12,14,40,-26,12
Loko Moscow,6078,1,13,5,2,34,13,21,44
Spart Moscow,6078,2,11,5,4,42,29,13,38
CSKA Moscow,6078,3,11,4,5,29,19,10,37
Krasnodar,6078,4,9,4,7,30,28,2,31
Zenit,6078,5,7,9,4,23,16,7,30
Terek Grozny,6078,6,8,5,7,21,23,-2,29
Din Moscow,6078,7,5,7,8,18,23,-5,22
FK Rubin,6078,8,5,6,9,22,19,3,21
Amkar,6078,9,5,4,11,11,25,-14,19
Rostov,6078,10,4,6,10,12,21,-9,18
Anzhi,6078,11,2,5,13,15,41,-26,11
Loko Moscow,6079,1,12,5,3,32,14,18,41
Spart Moscow,6079,2,10,5,5,39,32,7,35
CSKA Moscow,6079,3,10,3,7,26,20,6,33
Zenit,6079,4,8,8,4,23,15,8,32
Krasnodar,6079,5,9,5,6,32,28,4,32
Terek Grozny,6079,6,8,5,7,22,26,-4,29
FK Rubin,6079,7,6,6,8,27,19,8,24
Amkar,6079,8,6,4,10,17,23,-6,22
Din Moscow,6079,9,5,6,9,17,27,-10,21
Rostov,6079,10,4,6,10,12,20,-8,18
Anzhi,6079,11,3,5,12,16,39,-23,14
Loko Moscow,6080,1,12,6,2,32,12,20,42
Spart Moscow,6080,2,10,6,4,36,26,10,36
CSKA Moscow,6080,3,10,5,5,29,21,8,35
Zenit,6080,4,7,9,4,23,17,6,30
Krasnodar,6080,5,8,6,6,29,26,3,30
Terek Grozny,6080,6,7,6,7,20,23,-3,27
FK Rubin,6080,7,5,7,8,22,18,4,22
Din Moscow,6080,8,5,7,8,17,22,-5,22
Rostov,6080,9,4,6,10,11,19,-8,18
Amkar,6080,10,4,6,10,9,22,-13,18
Anzhi,6080,11,3,6,11,17,39,-22,15
Loko Moscow,6081,1,12,6,2,32,13,19,42
Spart Moscow,6081,2,11,5,4,38,25,13,38
CSKA Moscow,6081,3,10,4,6,25,18,7,34
Zenit,6081,4,8,9,3,22,13,9,33
Terek Grozny,6081,5,9,5,6,22,22,0,32
Krasnodar,6081,6,8,5,7,30,28,2,29
FK Rubin,6081,7,6,6,8,24,19,5,24
Din Moscow,6081,8,5,6,9,18,25,-7,21
Rostov,6081,9,4,6,10,10,19,-9,18
Amkar,6081,10,4,4,12,9,24,-15,16
Anzhi,6081,11,2,6,12,14,38,-24,12
Loko Moscow,6082,1,12,5,3,32,14,18,41
Spart Moscow,6082,2,11,5,4,41,27,14,38
CSKA Moscow,6082,3,11,3,6,29,20,9,36
Zenit,6082,4,8,8,4,23,15,8,32
Krasnodar,6082,5,9,4,7,31,30,1,31
Terek Grozny,6082,6,7,6,7,21,24,-3,27
FK Rubin,6082,7,6,6,8,25,18,7,24
Din Moscow,6082,8,5,7,8,18,23,-5,22
Rostov,6082,9,4,6,10,10,21,-11,18
Amkar,6082,10,4,5,11,10,24,-14,17
Anzhi,6082,11,3,5,12,17,41,-24,14
Loko Moscow,6083,1,12,6,2,33,14,19,42
CSKA Moscow,6083,2,11,3,6,28,19,9,36
Spart Moscow,6083,3,8,8,4,36,28,8,32
Krasnodar,6083,4,9,4,7,32,29,3,31
Zenit,6083,5,7,9,4,23,17,6,30
Terek Grozny,6083,6,8,6,6,22,23,-1,30
Din Moscow,6083,7,6,7,7,20,22,-2,25
FK Rubin,6083,8,5,5,10,24,23,1,20
Rostov,6083,9,4,7,9,11,18,-7,19
Amkar,6083,10,4,6,10,10,23,-13,18
Anzhi,6083,11,3,5,12,17,40,-23,14
Loko Moscow,6084,1,11,6,3,31,14,17,39
Spart Moscow,6084,2,11,5,4,41,27,14,38
CSKA Moscow,6084,3,10,4,6,26,19,7,34
Krasnodar,6084,4,10,4,6,31,26,5,34
Zenit,6084,5,7,10,3,23,15,8,31
Terek Grozny,6084,6,8,6,6,21,22,-1,30
FK Rubin,6084,7,6,5,9,25,21,4,23
Din Moscow,6084,8,5,6,9,20,27,-7,21
Rostov,6084,9,4,6,10,11,21,-10,18
Amkar,6084,10,4,5,11,9,23,-14,17
Anzhi,6084,11,3,5,12,15,38,-23,14
Loko Moscow,6085,1,12,5,3,32,14,18,41
CSKA Moscow,6085,2,11,3,6,28,21,7,36
Krasnodar,6085,3,10,4,6,32,26,6,34
Spart Moscow,6085,4,9,6,5,34,27,7,33
Zenit,6085,5,8,8,4,24,15,9,32
Terek Grozny,6085,6,8,5,7,22,27,-5,29
FK Rubin,6085,7,6,5,9,27,20,7,23
Din Moscow,6085,8,5,6,9,18,27,-9,21
Rostov,6085,9,4,7,9,10,17,-7,19
Amkar,6085,10,5,4,11,11,23,-12,19
Anzhi,6085,11,3,5,12,20,41,-21,14
Loko Moscow,6086,1,12,6,2,32,13,19,42
CSKA Moscow,6086,2,11,3,6,27,20,7,36
Zenit,6086,3,8,8,4,24,15,9,32
Spart Moscow,6086,4,9,5,6,35,27,8,32
Krasnodar,6086,5,8,5,7,28,27,1,29
Terek Grozny,6086,6,7,6,7,20,23,-3,27
Din Moscow,6086,7,6,7,7,19,22,-3,25
FK Rubin,6086,8,6,6,8,24,18,6,24
Amkar,6086,9,5,5,10,10,22,-12,20
Rostov,6086,10,4,6,10,10,19,-9,18
Anzhi,6086,11,3,5,12,16,39,-23,14
Loko Moscow,6087,1,12,5,3,33,15,18,41
Spart Moscow,6087,2,11,5,4,38,26,12,38
CSKA Moscow,6087,3,11,4,5,27,17,10,37
Krasnodar,6087,4,9,4,7,31,29,2,31
Zenit,6087,5,7,9,4,22,15,7,30
Terek Grozny,6087,6,8,6,6,26,25,1,30
FK Rubin,6087,7,6,6,8,26,20,6,24
Din Moscow,6087,8,5,7,8,20,25,-5,22
Rostov,6087,9,4,6,10,10,19,-9,18
Amkar,6087,10,4,5,11,11,25,-14,17
Anzhi,6087,11,2,5,13,15,43,-28,11
Loko Moscow,6088,1,13,5,2,34,13,21,44
Spart Moscow,6088,2,10,6,4,39,28,11,36
CSKA Moscow,6088,3,11,3,6,27,20,7,36
Zenit,6088,4,8,8,4,23,15,8,32
Terek Grozny,6088,5,9,5,6,24,23,1,32
Krasnodar,6088,6,9,4,7,31,27,4,31
FK Rubin,6088,7,6,5,9,23,19,4,23
Din Moscow,6088,8,5,6,9,18,25,-7,21
Rostov,6088,9,4,6,10,12,21,-9,18
Amkar,6088,10,4,5,11,10,24,-14,17
Anzhi,6088,11,2,5,13,15,41,-26,11
Loko Moscow,6089,1,11,6,3,30,15,15,39
Spart Moscow,6089,2,11,5,4,37,26,11,38
CSKA Moscow,6089,3,11,3,6,28,18,10,36
Zenit,6089,4,8,9,3,23,14,9,33
Krasnodar,6089,5,9,4,7,31,26,5,31
FK Rubin,6089,6,7,5,8,24,18,6,26
Terek Grozny,6089,7,7,5,8,23,29,-6,26
Din Moscow,6089,8,5,6,9,17,23,-6,21
Amkar,6089,9,5,4,11,13,24,-11,19
Rostov,6089,10,4,6,10,10,18,-8,18
Anzhi,6089,11,3,5,12,18,43,-25,14
Loko Moscow,6090,1,12,5,3,31,13,18,41
Spart Moscow,6090,2,9,7,4,36,26,10,34
CSKA Moscow,6090,3,10,3,7,25,19,6,33
Zenit,6090,4,8,8,4,22,14,8,32
Krasnodar,6090,5,9,4,7,29,26,3,31
FK Rubin,6090,6,7,5,8,24,17,7,26
Terek Grozny,6090,7,7,5,8,20,25,-5,26
Din Moscow,6090,8,5,7,8,18,24,-6,22
Amkar,6090,9,5,5,10,10,22,-12,20
Rostov,6090,10,4,6,10,10,19,-9,18
Anzhi,6090,11,4,5,11,17,37,-20,17
Loko Moscow,6091,1,11,5,4,29,15,14,38
CSKA Moscow,6091,2,11,3,6,27,19,8,36
Zenit,6091,3,9,8,3,25,13,12,35
Spart Moscow,6091,4,9,5,6,36,29,7,32
Krasnodar,6091,5,9,5,6,31,26,5,32
Terek Grozny,6091,6,8,6,6,22,22,0,30
Din Moscow,6091,7,7,6,7,20,22,-2,27
FK Rubin,6091,8,5,6,9,23,20,3,21
Amkar,6091,9,5,5,10,10,22,-12,20
Rostov,6091,10,4,6,10,11,19,-8,18
Anzhi,6091,11,2,5,13,14,41,-27,11
Loko Moscow,6092,1,12,5,3,32,13,19,41
Spart Moscow,6092,2,10,6,4,38,27,11,36
CSKA Moscow,6092,3,11,3,6,27,19,8,36
Krasnodar,6092,4,10,4,6,33,28,5,34
Zenit,6092,5,8,8,4,23,15,8,32
Terek Grozny,6092,6,8,5,7,23,25,-2,29
Din Moscow,6092,7,6,7,7,20,21,-1,25
FK Rubin,6092,8,5,5,10,24,24,0,20
Amkar,6092,9,5,4,11,12,24,-12,19
Rostov,6092,10,4,6,10,11,20,-9,18
Anzhi,6092,11,2,5,13,15,42,-27,11
Loko Moscow,6093,1,12,5,3,31,13,18,41
CSKA Moscow,6093,2,11,4,5,31,20,11,37
Spart Moscow,6093,3,10,5,5,40,29,11,35
Zenit,6093,4,8,8,4,25,19,6,32
Krasnodar,6093,5,9,4,7,28,25,3,31
Terek Grozny,6093,6,7,6,7,21,27,-6,27
Din Moscow,6093,7,6,7,7,21,23,-2,25
FK Rubin,6093,8,5,6,9,22,19,3,21
Amkar,6093,9,5,4,11,13,25,-12,19
Rostov,6093,10,4,6,10,11,20,-9,18
Anzhi,6093,11,2,7,11,16,39,-23,13
Loko Moscow,6094,1,12,6,2,32,13,19,42
CSKA Moscow,6094,2,11,4,5,29,18,11,37
Spart Moscow,6094,3,10,6,4,38,25,13,36
Zenit,6094,4,7,10,3,23,15,8,31
Krasnodar,6094,5,8,5,7,29,27,2,29
Terek Grozny,6094,6,7,5,8,20,25,-5,26
Din Moscow,6094,7,5,8,7,18,22,-4,23
FK Rubin,6094,8,5,7,8,23,19,4,22
Amkar,6094,9,5,4,11,11,25,-14,19
Rostov,6094,10,4,6,10,10,19,-9,18
Anzhi,6094,11,3,5,12,15,40,-25,14
Loko Moscow,6095,1,12,6,2,32,12,20,42
CSKA Moscow,6095,2,11,4,5,26,17,9,37
Zenit,6095,3,7,10,3,21,13,8,31
Spart Moscow,6095,4,8,6,6,34,28,6,30
Terek Grozny,6095,5,8,6,6,23,24,-1,30
Krasnodar,6095,6,8,5,7,30,29,1,29
FK Rubin,6095,7,6,6,8,25,19,6,24
Din Moscow,6095,8,6,6,8,18,23,-5,24
Rostov,6095,9,5,6,9,11,17,-6,21
Amkar,6095,10,4,6,10,11,24,-13,18
Anzhi,6095,11,2,5,13,15,40,-25,11
Loko Moscow,6096,1,13,5,2,36,13,23,44
CSKA Moscow,6096,2,11,3,6,27,20,7,36
Zenit,6096,3,8,8,4,24,15,9,32
Krasnodar,6096,4,9,4,7,29,29,0,31
Spart Moscow,6096,5,8,6,6,35,29,6,30
Terek Grozny,6096,6,8,6,6,23,24,-1,30
Din Moscow,6096,7,7,6,7,21,22,-1,27
FK Rubin,6096,8,5,5,10,21,20,1,20
Rostov,6096,9,4,7,9,11,18,-7,19
Amkar,6096,10,5,4,11,10,23,-13,19
Anzhi,6096,11,2,6,12,17,41,-24,12
Loko Moscow,6097,1,11,6,3,30,15,15,39
CSKA Moscow,6097,2,11,4,5,27,18,9,37
Krasnodar,6097,3,10,4,6,31,24,7,34
Spart Moscow,6097,4,9,6,5,39,31,8,33
Terek Grozny,6097,5,9,5,6,25,24,1,32
Zenit,6097,6,7,9,4,22,15,7,30
Din Moscow,6097,7,5,8,7,20,24,-4,23
FK Rubin,6097,8,5,6,9,21,18,3,21
Amkar,6097,9,5,4,11,11,25,-14,19
Rostov,6097,10,4,6,10,12,20,-8,18
Anzhi,6097,11,2,6,12,16,40,-24,12
Loko Moscow,6098,1,11,6,3,31,15,16,39
Spart Moscow,6098,2,10,5,5,37,26,11,35
CSKA Moscow,6098,3,10,5,5,28,20,8,35
Krasnodar,6098,4,10,4,6,33,26,7,34
Zenit,6098,5,7,10,3,23,15,8,31
Terek Grozny,6098,6,8,6,6,23,23,0,30
Din Moscow,6098,7,6,6,8,19,23,-4,24
Rostov,6098,8,5,6,9,11,17,-6,21
FK Rubin,6098,9,5,5,10,22,22,0,20
Amkar,6098,10,4,4,12,10,27,-17,16
Anzhi,6098,11,2,7,11,16,39,-23,13
Loko Moscow,6099,1,12,5,3,31,14,17,41
CSKA Moscow,6099,2,11,4,5,26,17,9,37
Zenit,6099,3,8,9,3,24,14,10,33
Terek Grozny,6099,4,9,5,6,26,23,3,32
Spart Moscow,6099,5,8,7,5,39,33,6,31
Krasnodar,6099,6,9,4,7,29,25,4,31
Din Moscow,6099,7,6,7,7,21,24,-3,25
FK Rubin,6099,8,5,5,10,21,20,1,20
Rostov,6099,9,4,7,9,11,18,-7,19
Amkar,6099,10,5,4,11,13,25,-12,19
Anzhi,6099,11,2,5,13,15,43,-28,11
Loko Moscow,6100,1,12,5,3,31,12,19,41
CSKA Moscow,6100,2,11,4,5,30,17,13,37
Spart Moscow,6100,3,10,6,4,39,27,12,36
Krasnodar,6100,4,9,4,7,28,25,3,31
Zenit,6100,5,7,9,4,21,15,6,30
Terek Grozny,6100,6,8,5,7,23,26,-3,29
FK Rubin,6100,7,6,6,8,22,17,5,24
Din Moscow,6100,8,5,7,8,18,24,-6,22
Rostov,6100,9,4,7,9,11,18,-7,19
Amkar,6100,10,4,4,12,11,27,-16,16
Anzhi,6100,11,3,5,12,16,42,-26,14
Loko Moscow,6101,1,12,6,2,32,12,20,42
CSKA Moscow,6101,2,10,4,6,26,19,7,34
Zenit,6101,3,8,9,3,23,14,9,33
Spart Moscow,6101,4,9,5,6,36,29,7,32
Krasnodar,6101,5,9,4,7,28,26,2,31
Terek Grozny,6101,6,8,6,6,23,22,1,30
Din Moscow,6101,7,7,6,7,21,22,-1,27
FK Rubin,6101,8,5,5,10,21,20,1,20
Amkar,6101,9,5,5,10,10,22,-12,20
Rostov,6101,10,4,6,10,11,19,-8,18
Anzhi,6101,11,2,6,12,15,41,-26,12
Loko Moscow,6102,1,13,5,2,34,13,21,44
CSKA Moscow,6102,2,11,3,6,32,20,12,36
Spart Moscow,6102,3,9,7,4,40,28,12,34
Zenit,6102,4,8,8,4,23,15,8,32
Krasnodar,6102,5,9,4,7,34,28,6,31
Terek Grozny,6102,6,8,6,6,25,25,0,30
FK Rubin,6102,7,6,5,9,24,23,1,23
Din Moscow,6102,8,5,7,8,20,26,-6,22
Rostov,6102,9,4,6,10,11,22,-11,18
Amkar,6102,10,4,5,11,11,26,-15,17
Anzhi,6102,11,2,6,12,16,44,-28,12
Loko Moscow,6103,1,12,6,2,33,14,19,42
Zenit,6103,2,8,9,3,26,15,11,33
CSKA Moscow,6103,3,10,3,7,25,21,4,33
Spart Moscow,6103,4,9,5,6,34,28,6,32
Krasnodar,6103,5,8,5,7,28,26,2,29
Terek Grozny,6103,6,8,5,7,23,24,-1,29
Din Moscow,6103,7,7,6,7,21,22,-1,27
FK Rubin,6103,8,5,6,9,22,19,3,21
Rostov,6103,9,5,6,9,11,17,-6,21
Amkar,6103,10,5,4,11,10,23,-13,19
Anzhi,6103,11,3,5,12,16,40,-24,14
Loko Moscow,6104,1,12,6,2,32,13,19,42
CSKA Moscow,6104,2,12,3,5,32,19,13,39
Spart Moscow,6104,3,9,5,6,35,28,7,32
Krasnodar,6104,4,9,4,7,30,26,4,31
Zenit,6104,5,7,9,4,24,18,6,30
Terek Grozny,6104,6,8,5,7,23,25,-2,29
Din Moscow,6104,7,5,7,8,18,23,-5,22
Amkar,6104,8,6,4,10,13,24,-11,22
FK Rubin,6104,9,5,6,9,22,20,2,21
Rostov,6104,10,5,6,9,11,17,-6,21
Anzhi,6104,11,2,5,13,15,42,-27,11
Loko Moscow,6105,1,12,6,2,31,12,19,42
CSKA Moscow,6105,2,11,4,5,27,18,9,37
Spart Moscow,6105,3,10,5,5,39,28,11,35
Krasnodar,6105,4,9,5,6,30,25,5,32
Zenit,6105,5,7,9,4,22,15,7,30
Terek Grozny,6105,6,7,6,7,20,23,-3,27
Din Moscow,6105,7,6,6,8,18,24,-6,24
Rostov,6105,8,5,6,9,12,18,-6,21
FK Rubin,6105,9,5,5,10,21,20,1,20
Amkar,6105,10,4,5,11,10,24,-14,17
Anzhi,6105,11,3,5,12,15,38,-23,14
Loko Moscow,6106,1,13,5,2,35,13,22,44
CSKA Moscow,6106,2,12,3,5,29,17,12,39
Spart Moscow,6106,3,10,5,5,35,26,9,35
Zenit,6106,4,7,8,5,21,16,5,29
Krasnodar,6106,5,8,4,8,30,30,0,28
Terek Grozny,6106,6,7,5,8,20,25,-5,26
FK Rubin,6106,7,6,6,8,25,20,5,24
Din Moscow,6106,8,5,7,8,19,24,-5,22
Amkar,6106,9,6,4,10,12,22,-10,22
Rostov,6106,10,4,6,10,10,18,-8,18
Anzhi,6106,11,3,5,12,15,40,-25,14
Loko Moscow,6107,1,13,5,2,36,11,25,44
CSKA Moscow,6107,2,11,4,5,27,18,9,37
Spart Moscow,6107,3,9,6,5,38,28,10,33
Krasnodar,6107,4,9,4,7,29,27,2,31
Zenit,6107,5,7,8,5,22,20,2,29
Din Moscow,6107,6,7,6,7,22,23,-1,27
Terek Grozny,6107,7,7,6,7,23,26,-3,27
FK Rubin,6107,8,5,5,10,23,22,1,20
Rostov,6107,9,4,7,9,11,18,-7,19
Amkar,6107,10,4,5,11,10,26,-16,17
Anzhi,6107,11,3,6,11,17,39,-22,15
Loko Moscow,6108,1,12,6,2,34,13,21,42
CSKA Moscow,6108,2,11,3,6,28,20,8,36
Spart Moscow,6108,3,9,7,4,39,27,12,34
Zenit,6108,4,8,8,4,25,19,6,32
Krasnodar,6108,5,8,6,6,27,24,3,30
Terek Grozny,6108,6,8,5,7,22,24,-2,29
Din Moscow,6108,7,6,7,7,20,23,-3,25
FK Rubin,6108,8,5,6,9,22,19,3,21
Rostov,6108,9,4,6,10,10,21,-11,18
Amkar,6108,10,4,5,11,10,24,-14,17
Anzhi,6108,11,3,5,12,17,40,-23,14
Loko Moscow,6109,1,11,7,2,32,14,18,40
CSKA Moscow,6109,2,11,3,6,26,19,7,36
Spart Moscow,6109,3,9,6,5,36,30,6,33
Krasnodar,6109,4,9,5,6,31,27,4,32
Zenit,6109,5,7,9,4,22,15,7,30
Terek Grozny,6109,6,7,6,7,20,25,-5,27
FK Rubin,6109,7,6,5,9,23,19,4,23
Din Moscow,6109,8,5,7,8,18,23,-5,22
Rostov,6109,9,5,6,9,14,17,-3,21
Amkar,6109,10,4,5,11,9,24,-15,17
Anzhi,6109,11,4,5,11,19,37,-18,17
Loko Moscow,6110,1,12,6,2,30,11,19,42
CSKA Moscow,6110,2,10,5,5,27,19,8,35
Spart Moscow,6110,3,8,7,5,36,30,6,31
Zenit,6110,4,7,9,4,22,15,7,30
Krasnodar,6110,5,8,6,6,27,24,3,30
Terek Grozny,6110,6,7,6,7,21,25,-4,27
Din Moscow,6110,7,6,7,7,20,22,-2,25
FK Rubin,6110,8,5,7,8,22,18,4,22
Amkar,6110,9,5,5,10,15,26,-11,20
Rostov,6110,10,4,7,9,10,17,-7,19
Anzhi,6110,11,2,7,11,15,38,-23,13
Loko Moscow,6111,1,11,7,2,31,13,18,40
CSKA Moscow,6111,2,11,3,6,26,18,8,36
Zenit,6111,3,8,9,3,24,15,9,33
Spart Moscow,6111,4,9,6,5,34,26,8,33
Krasnodar,6111,5,8,6,6,28,25,3,30
Terek Grozny,6111,6,7,5,8,21,26,-5,26
FK Rubin,6111,7,6,6,8,24,19,5,24
Din Moscow,6111,8,5,7,8,18,23,-5,22
Amkar,6111,9,6,4,10,12,23,-11,22
Rostov,6111,10,4,6,10,10,18,-8,18
Anzhi,6111,11,3,5,12,16,38,-22,14
Loko Moscow,6112,1,12,5,3,32,13,19,41
CSKA Moscow,6112,2,12,3,5,31,19,12,39
Krasnodar,6112,3,10,4,6,31,25,6,34
Spart Moscow,6112,4,9,5,6,38,31,7,32
Zenit,6112,5,7,8,5,22,17,5,29
Terek Grozny,6112,6,7,7,6,22,24,-2,28
Din Moscow,6112,7,6,6,8,19,24,-5,24
Rostov,6112,8,5,6,9,13,18,-5,21
FK Rubin,6112,9,5,5,10,21,20,1,20
Amkar,6112,10,5,5,10,11,23,-12,20
Anzhi,6112,11,2,6,12,17,43,-26,12
Loko Moscow,6113,1,13,5,2,34,12,22,44
CSKA Moscow,6113,2,11,4,5,32,18,14,37
Spart Moscow,6113,3,10,5,5,37,31,6,35
Zenit,6113,4,7,9,4,22,16,6,30
Krasnodar,6113,5,8,5,7,30,29,1,29
Terek Grozny,6113,6,7,5,8,20,26,-6,26
FK Rubin,6113,7,5,7,8,25,21,4,22
Din Moscow,6113,8,5,7,8,20,25,-5,22
Amkar,6113,9,6,4,10,14,22,-8,22
Rostov,6113,10,4,6,10,11,19,-8,18
Anzhi,6113,11,3,5,12,17,43,-26,14
Loko Moscow,6114,1,12,5,3,33,15,18,41
Spart Moscow,6114,2,10,6,4,36,26,10,36
CSKA Moscow,6114,3,11,3,6,26,18,8,36
Krasnodar,6114,4,10,4,6,32,26,6,34
Zenit,6114,5,8,8,4,23,15,8,32
Terek Grozny,6114,6,7,6,7,22,25,-3,27
Din Moscow,6114,7,6,7,7,21,23,-2,25
FK Rubin,6114,8,5,5,10,22,22,0,20
Amkar,6114,9,5,4,11,11,24,-13,19
Rostov,6114,10,4,6,10,10,18,-8,18
Anzhi,6114,11,2,6,12,15,39,-24,12
Loko Moscow,6115,1,13,5,2,34,12,22,44
CSKA Moscow,6115,2,11,3,6,28,19,9,36
Zenit,6115,3,8,8,4,23,16,7,32
Spart Moscow,6115,4,9,5,6,37,31,6,32
Krasnodar,6115,5,9,4,7,29,27,2,31
Terek Grozny,6115,6,8,6,6,21,22,-1,30
FK Rubin,6115,7,6,5,9,23,19,4,23
Rostov,6115,8,5,6,9,13,18,-5,21
Din Moscow,6115,9,5,6,9,18,25,-7,21
Amkar,6115,10,5,4,11,12,24,-12,19
Anzhi,6115,11,2,6,12,14,39,-25,12
Loko Moscow,6116,1,12,6,2,30,11,19,42
CSKA Moscow,6116,2,11,4,5,27,17,10,37
Spart Moscow,6116,3,9,5,6,38,30,8,32
Zenit,6116,4,7,10,3,21,13,8,31
Krasnodar,6116,5,8,4,8,28,27,1,28
Terek Grozny,6116,6,7,6,7,22,26,-4,27
Din Moscow,6116,7,6,7,7,19,22,-3,25
FK Rubin,6116,8,6,6,8,24,19,5,24
Amkar,6116,9,6,4,10,15,24,-9,22
Rostov,6116,10,4,6,10,11,21,-10,18
Anzhi,6116,11,2,6,12,15,40,-25,12
Loko Moscow,6117,1,12,5,3,31,14,17,41
CSKA Moscow,6117,2,11,3,6,27,19,8,36
Spart Moscow,6117,3,10,5,5,38,28,10,35
Krasnodar,6117,4,10,4,6,31,25,6,34
Zenit,6117,5,8,8,4,22,14,8,32
Terek Grozny,6117,6,8,5,7,22,24,-2,29
FK Rubin,6117,7,6,5,9,22,18,4,23
Din Moscow,6117,8,5,6,9,18,24,-6,21
Amkar,6117,9,5,4,11,12,25,-13,19
Rostov,6117,10,4,6,10,10,19,-9,18
Anzhi,6117,11,3,5,12,16,39,-23,14
CSKA Moscow,6118,1,12,3,5,29,17,12,39
Loko Moscow,6118,2,11,5,4,30,14,16,38
Krasnodar,6118,3,10,4,6,30,24,6,34
Zenit,6118,4,8,8,4,23,15,8,32
Spart Moscow,6118,5,8,7,5,36,29,7,31
Din Moscow,6118,6,7,6,7,21,23,-2,27
Terek Grozny,6118,7,7,6,7,21,24,-3,27
FK Rubin,6118,8,5,5,10,23,22,1,20
Rostov,6118,9,4,7,9,11,18,-7,19
Amkar,6118,10,4,6,10,12,25,-13,18
Anzhi,6118,11,3,5,12,15,40,-25,14
Loko Moscow,6119,1,11,6,3,31,14,17,39
CSKA Moscow,6119,2,11,4,5,26,17,9,37
Krasnodar,6119,3,10,4,6,30,25,5,34
Spart Moscow,6119,4,9,6,5,37,29,8,33
Zenit,6119,5,7,10,3,22,14,8,31
Terek Grozny,6119,6,8,5,7,22,23,-1,29
Din Moscow,6119,7,6,7,7,19,22,-3,25
FK Rubin,6119,8,5,6,9,21,18,3,21
Amkar,6119,9,5,5,10,11,23,-12,20
Rostov,6119,10,4,6,10,11,19,-8,18
Anzhi,6119,11,2,5,13,14,40,-26,11
Loko Moscow,6120,1,12,5,3,32,13,19,41
Spart Moscow,6120,2,10,6,4,40,26,14,36
Zenit,6120,3,9,8,3,24,13,11,35
CSKA Moscow,6120,4,10,3,7,26,22,4,33
Krasnodar,6120,5,9,4,7,29,27,2,31
Terek Grozny,6120,6,8,5,7,21,23,-2,29
Din Moscow,6120,7,5,8,7,20,24,-4,23
FK Rubin,6120,8,5,6,9,23,20,3,21
Amkar,6120,9,5,4,11,10,26,-16,19
Rostov,6120,10,4,6,10,10,19,-9,18
Anzhi,6120,11,3,5,12,17,39,-22,14
Loko Moscow,6121,1,13,5,2,33,12,21,44
CSKA Moscow,6121,2,11,4,5,28,19,9,37
Spart Moscow,6121,3,10,5,5,36,28,8,35
Krasnodar,6121,4,9,4,7,29,27,2,31
Zenit,6121,5,7,8,5,22,16,6,29
Terek Grozny,6121,6,7,5,8,22,28,-6,26
Din Moscow,6121,7,5,7,8,17,22,-5,22
Amkar,6121,8,6,4,10,16,25,-9,22
FK Rubin,6121,9,5,6,9,21,18,3,21
Rostov,6121,10,4,6,10,10,18,-8,18
Anzhi,6121,11,3,6,11,17,38,-21,15
Loko Moscow,6122,1,12,5,3,32,15,17,41
CSKA Moscow,6122,2,11,3,6,27,18,9,36
Spart Moscow,6122,3,10,5,5,40,28,12,35
Zenit,6122,4,8,8,4,24,16,8,32
Krasnodar,6122,5,9,5,6,29,24,5,32
Terek Grozny,6122,6,7,6,7,20,23,-3,27
Din Moscow,6122,7,6,6,8,19,24,-5,24
FK Rubin,6122,8,5,6,9,21,19,2,21
Rostov,6122,9,5,6,9,12,18,-6,21
Amkar,6122,10,4,5,11,10,25,-15,17
Anzhi,6122,11,3,5,12,15,39,-24,14
Loko Moscow,6123,1,12,5,3,33,14,19,41
Zenit,6123,2,9,8,3,25,14,11,35
Spart Moscow,6123,3,9,7,4,35,26,9,34
CSKA Moscow,6123,4,10,4,6,26,19,7,34
Krasnodar,6123,5,9,4,7,31,30,1,31
Terek Grozny,6123,6,8,6,6,23,24,-1,30
Din Moscow,6123,7,5,8,7,19,23,-4,23
FK Rubin,6123,8,5,6,9,25,22,3,21
Rostov,6123,9,4,7,9,10,17,-7,19
Amkar,6123,10,4,5,11,12,26,-14,17
Anzhi,6123,11,2,6,12,14,38,-24,12
Loko Moscow,6124,1,13,5,2,32,12,20,44
CSKA Moscow,6124,2,11,3,6,28,20,8,36
Spart Moscow,6124,3,10,5,5,37,27,10,35
Zenit,6124,4,8,8,4,25,16,9,32
Krasnodar,6124,5,8,4,8,28,27,1,28
Terek Grozny,6124,6,7,6,7,20,23,-3,27
Din Moscow,6124,7,6,6,8,21,24,-3,24
FK Rubin,6124,8,6,5,9,24,21,3,23
Rostov,6124,9,5,6,9,11,17,-6,21
Amkar,6124,10,5,4,11,10,24,-14,19
Anzhi,6124,11,2,6,12,14,39,-25,12
Loko Moscow,6125,1,12,5,3,33,15,18,41
CSKA Moscow,6125,2,12,3,5,29,17,12,39
Zenit,6125,3,8,8,4,24,16,8,32
Spart Moscow,6125,4,9,5,6,38,32,6,32
Krasnodar,6125,5,8,4,8,28,29,-1,28
FK Rubin,6125,6,7,5,8,25,17,8,26
Terek Grozny,6125,7,7,5,8,20,24,-4,26
Din Moscow,6125,8,6,6,8,20,24,-4,24
Amkar,6125,9,6,4,10,13,23,-10,22
Rostov,6125,10,4,6,10,11,20,-9,18
Anzhi,6125,11,3,5,12,15,39,-24,14
Loko Moscow,6126,1,13,5,2,31,11,20,44
Spart Moscow,6126,2,10,5,5,40,30,10,35
CSKA Moscow,6126,3,10,5,5,26,18,8,35
Zenit,6126,4,7,9,4,21,14,7,30
Krasnodar,6126,5,8,5,7,27,25,2,29
Terek Grozny,6126,6,8,5,7,21,23,-2,29
FK Rubin,6126,7,6,6,8,22,17,5,24
Amkar,6126,8,6,4,10,14,24,-10,22
Din Moscow,6126,9,5,6,9,18,24,-6,21
Rostov,6126,10,4,6,10,10,20,-10,18
Anzhi,6126,11,2,6,12,15,39,-24,12
Loko Moscow,6127,1,13,5,2,33,13,20,44
CSKA Moscow,6127,2,11,3,6,30,21,9,36
Spart Moscow,6127,3,10,5,5,37,27,10,35
Zenit,6127,4,8,8,4,25,16,9,32
Terek Grozny,6127,5,8,5,7,23,24,-1,29
Krasnodar,6127,6,8,4,8,29,29,0,28
Din Moscow,6127,7,6,6,8,19,24,-5,24
FK Rubin,6127,8,6,5,9,24,19,5,23
Amkar,6127,9,5,4,11,10,24,-14,19
Rostov,6127,10,4,6,10,10,18,-8,18
Anzhi,6127,11,3,5,12,17,42,-25,14
Loko Moscow,6128,1,12,6,2,32,13,19,42
CSKA Moscow,6128,2,11,4,5,28,19,9,37
Spart Moscow,6128,3,8,7,5,39,33,6,31
Zenit,6128,4,7,8,5,21,15,6,29
Krasnodar,6128,5,8,5,7,29,27,2,29
Terek Grozny,6128,6,7,6,7,21,24,-3,27
FK Rubin,6128,7,7,5,8,26,18,8,26
Din Moscow,6128,8,5,7,8,21,28,-7,22
Amkar,6128,9,6,4,10,14,24,-10,22
Rostov,6128,10,4,7,9,12,19,-7,19
Anzhi,6128,11,2,7,11,16,39,-23,13
Loko Moscow,6129,1,13,5,2,32,11,21,44
CSKA Moscow,6129,2,12,3,5,31,20,11,39
Spart Moscow,6129,3,10,5,5,39,30,9,35
Zenit,6129,4,7,8,5,22,18,4,29
Krasnodar,6129,5,8,4,8,27,27,0,28
Terek Grozny,6129,6,7,7,6,22,24,-2,28
FK Rubin,6129,7,6,6,8,24,18,6,24
Din Moscow,6129,8,5,7,8,19,24,-5,22
Amkar,6129,9,5,5,10,14,25,-11,20
Rostov,6129,10,4,6,10,10,19,-9,18
Anzhi,6129,11,2,6,12,17,41,-24,12
Loko Moscow,6130,1,11,5,4,29,14,15,38
Spart Moscow,6130,2,10,6,4,37,26,11,36
CSKA Moscow,6130,3,11,3,6,26,19,7,36
Zenit,6130,4,9,8,3,24,13,11,35
Terek Grozny,6130,5,9,5,6,23,22,1,32
Krasnodar,6130,6,9,4,7,30,26,4,31
Din Moscow,6130,7,6,7,7,19,21,-2,25
FK Rubin,6130,8,6,5,9,23,20,3,23
Rostov,6130,9,4,6,10,10,18,-8,18
Amkar,6130,10,4,4,12,10,26,-16,16
Anzhi,6130,11,2,5,13,14,40,-26,11
Loko Moscow,6131,1,12,5,3,33,14,19,41
Spart Moscow,6131,2,10,6,4,39,26,13,36
CSKA Moscow,6131,3,11,3,6,30,20,10,36
Zenit,6131,4,8,8,4,24,19,5,32
Krasnodar,6131,5,9,4,7,31,26,5,31
Terek Grozny,6131,6,7,5,8,21,25,-4,26
Din Moscow,6131,7,6,6,8,22,24,-2,24
FK Rubin,6131,8,6,5,9,23,23,0,23
Amkar,6131,9,5,5,10,11,23,-12,20
Rostov,6131,10,4,6,10,11,20,-9,18
Anzhi,6131,11,3,5,12,15,40,-25,14
Loko Moscow,6132,1,13,5,2,34,13,21,44
Spart Moscow,6132,2,10,6,4,39,26,13,36
CSKA Moscow,6132,3,10,4,6,25,18,7,34
Zenit,6132,4,8,8,4,23,16,7,32
Krasnodar,6132,5,9,4,7,29,26,3,31
Terek Grozny,6132,6,7,5,8,21,25,-4,26
Din Moscow,6132,7,6,7,7,19,22,-3,25
FK Rubin,6132,8,5,5,10,22,20,2,20
Amkar,6132,9,5,4,11,10,24,-14,19
Rostov,6132,10,4,6,10,11,21,-10,18
Anzhi,6132,11,3,6,11,16,38,-22,15
Loko Moscow,6133,1,12,5,3,32,15,17,41
Spart Moscow,6133,2,9,7,4,44,30,14,34
Krasnodar,6133,3,10,4,6,31,24,7,34
CSKA Moscow,6133,4,10,3,7,27,22,5,33
Zenit,6133,5,8,8,4,26,17,9,32
Terek Grozny,6133,6,8,6,6,23,24,-1,30
Din Moscow,6133,7,6,6,8,19,28,-9,24
FK Rubin,6133,8,5,5,10,21,20,1,20
Rostov,6133,9,4,7,9,12,19,-7,19
Amkar,6133,10,4,5,11,12,26,-14,17
Anzhi,6133,11,3,6,11,17,39,-22,15
Loko Moscow,6134,1,12,5,3,30,12,18,41
CSKA Moscow,6134,2,11,3,6,27,20,7,36
Zenit,6134,3,9,8,3,24,13,11,35
Spart Moscow,6134,4,9,6,5,38,30,8,33
Krasnodar,6134,5,9,4,7,30,26,4,31
Terek Grozny,6134,6,8,5,7,22,25,-3,29
Din Moscow,6134,7,5,7,8,20,25,-5,22
Amkar,6134,8,6,4,10,13,23,-10,22
FK Rubin,6134,9,5,6,9,22,20,2,21
Rostov,6134,10,4,7,9,11,18,-7,19
Anzhi,6134,11,2,5,13,15,40,-25,11
Loko Moscow,6135,1,11,5,4,30,14,16,38
CSKA Moscow,6135,2,11,4,5,27,18,9,37
Zenit,6135,3,8,9,3,23,14,9,33
Spart Moscow,6135,4,9,6,5,37,29,8,33
Krasnodar,6135,5,9,4,7,30,27,3,31
Terek Grozny,6135,6,7,7,6,21,23,-2,28
FK Rubin,6135,7,7,5,8,26,20,6,26
Din Moscow,6135,8,5,6,9,19,25,-6,21
Rostov,6135,9,5,6,9,11,17,-6,21
Amkar,6135,10,4,6,10,11,24,-13,18
Anzhi,6135,11,2,6,12,16,40,-24,12
Loko Moscow,6136,1,12,6,2,31,12,19,42
CSKA Moscow,6136,2,11,3,6,27,18,9,36
Spart Moscow,6136,3,10,5,5,37,28,9,35
Zenit,6136,4,7,9,4,22,16,6,30
Terek Grozny,6136,5,8,6,6,23,22,1,30
Krasnodar,6136,6,8,4,8,27,26,1,28
Din Moscow,6136,7,6,6,8,20,24,-4,24
FK Rubin,6136,8,6,5,9,23,20,3,23
Rostov,6136,9,5,6,9,12,17,-5,21
Amkar,6136,10,4,4,12,10,27,-17,16
Anzhi,6136,11,3,6,11,15,37,-22,15
Loko Moscow,6137,1,12,5,3,33,13,20,41
CSKA Moscow,6137,2,12,3,5,28,17,11,39
Spart Moscow,6137,3,10,5,5,36,27,9,35
Krasnodar,6137,4,9,4,7,29,27,2,31
Zenit,6137,5,7,8,5,21,17,4,29
Terek Grozny,6137,6,7,6,7,21,25,-4,27
FK Rubin,6137,7,7,5,8,25,17,8,26
Rostov,6137,8,5,6,9,11,17,-6,21
Din Moscow,6137,9,5,6,9,18,25,-7,21
Amkar,6137,10,5,4,11,11,23,-12,19
Anzhi,6137,11,2,6,12,15,40,-25,12
Loko Moscow,6138,1,11,6,3,32,15,17,39
CSKA Moscow,6138,2,11,4,5,29,19,10,37
Spart Moscow,6138,3,10,6,4,37,27,10,36
Zenit,6138,4,7,10,3,24,16,8,31
Krasnodar,6138,5,9,4,7,30,29,1,31
Terek Grozny,6138,6,8,5,7,23,26,-3,29
FK Rubin,6138,7,7,5,8,25,17,8,26
Din Moscow,6138,8,5,6,9,17,23,-6,21
Rostov,6138,9,4,6,10,11,19,-8,18
Amkar,6138,10,4,5,11,10,24,-14,17
Anzhi,6138,11,3,5,12,18,41,-23,14
Loko Moscow,6139,1,11,6,3,29,13,16,39
CSKA Moscow,6139,2,11,4,5,27,18,9,37
Spart Moscow,6139,3,10,5,5,40,30,10,35
Krasnodar,6139,4,10,4,6,31,24,7,34
Zenit,6139,5,7,10,3,22,14,8,31
Terek Grozny,6139,6,8,6,6,22,23,-1,30
Din Moscow,6139,7,7,6,7,22,23,-1,27
FK Rubin,6139,8,5,5,10,21,20,1,20
Rostov,6139,9,4,6,10,11,20,-9,18
Amkar,6139,10,4,5,11,10,25,-15,17
Anzhi,6139,11,2,5,13,14,39,-25,11
Loko Moscow,6140,1,11,6,3,31,14,17,39
CSKA Moscow,6140,2,12,3,5,29,18,11,39
Spart Moscow,6140,3,10,6,4,43,28,15,36
Krasnodar,6140,4,9,5,6,32,24,8,32
Zenit,6140,5,8,8,4,24,17,7,32
Terek Grozny,6140,6,8,5,7,23,28,-5,29
Din Moscow,6140,7,5,7,8,21,29,-8,22
FK Rubin,6140,8,5,6,9,23,24,-1,21
Rostov,6140,9,4,7,9,10,17,-7,19
Amkar,6140,10,5,4,11,15,27,-12,19
Anzhi,6140,11,2,5,13,16,41,-25,11
Loko Moscow,6141,1,12,6,2,31,12,19,42
CSKA Moscow,6141,2,10,3,7,25,19,6,33
Zenit,6141,3,8,8,4,22,14,8,32
Spart Moscow,6141,4,9,5,6,36,29,7,32
Krasnodar,6141,5,8,5,7,28,26,2,29
Terek Grozny,6141,6,7,7,6,20,22,-2,28
FK Rubin,6141,7,7,5,8,24,17,7,26
Din Moscow,6141,8,6,6,8,19,24,-5,24
Amkar,6141,9,5,5,10,10,22,-12,20
Rostov,6141,10,4,6,10,11,19,-8,18
Anzhi,6141,11,3,6,11,15,37,-22,15
Loko Moscow,6142,1,13,5,2,31,11,20,44
CSKA Moscow,6142,2,11,3,6,29,20,9,36
Spart Moscow,6142,3,9,6,5,37,29,8,33
Zenit,6142,4,7,8,5,21,16,5,29
Krasnodar,6142,5,8,4,8,27,26,1,28
Terek Grozny,6142,6,7,5,8,20,24,-4,26
Din Moscow,6142,7,6,6,8,18,25,-7,24
FK Rubin,6142,8,6,5,9,22,18,4,23
Rostov,6142,9,5,6,9,14,17,-3,21
Amkar,6142,10,5,5,10,10,22,-12,20
Anzhi,6142,11,4,5,11,18,39,-21,17
Loko Moscow,6143,1,11,6,3,30,13,17,39
CSKA Moscow,6143,2,12,3,5,29,17,12,39
Krasnodar,6143,3,10,4,6,31,26,5,34
Zenit,6143,4,7,9,4,21,14,7,30
Spart Moscow,6143,5,8,6,6,35,29,6,30
Terek Grozny,6143,6,8,6,6,22,22,0,30
Din Moscow,6143,7,6,7,7,22,23,-1,25
Rostov,6143,8,5,6,9,11,17,-6,21
FK Rubin,6143,9,5,5,10,23,23,0,20
Amkar,6143,10,5,5,10,11,23,-12,20
Anzhi,6143,11,2,5,13,14,42,-28,11
Loko Moscow,6144,1,12,5,3,31,15,16,41
CSKA Moscow,6144,2,11,3,6,26,21,5,36
Spart Moscow,6144,3,10,5,5,41,31,10,35
Zenit,6144,4,8,8,4,26,15,11,32
Krasnodar,6144,5,9,5,6,31,25,6,32
Terek Grozny,6144,6,7,7,6,23,25,-2,28
Din Moscow,6144,7,6,6,8,22,26,-4,24
FK Rubin,6144,8,5,6,9,23,22,1,21
Amkar,6144,9,5,5,10,15,26,-11,20
Rostov,6144,10,4,6,10,11,19,-8,18
Anzhi,6144,11,2,6,12,15,39,-24,12
Loko Moscow,6145,1,12,6,2,30,11,19,42
CSKA Moscow,6145,2,11,4,5,29,20,9,37
Spart Moscow,6145,3,9,5,6,38,32,6,32
Krasnodar,6145,4,9,5,6,29,24,5,32
Zenit,6145,5,7,8,5,22,16,6,29
Terek Grozny,6145,6,8,5,7,22,24,-2,29
FK Rubin,6145,7,6,5,9,24,19,5,23
Amkar,6145,8,6,4,10,15,24,-9,22
Rostov,6145,9,5,6,9,12,17,-5,21
Din Moscow,6145,10,5,6,9,18,28,-10,21
Anzhi,6145,11,2,6,12,16,40,-24,12
Loko Moscow,6146,1,11,6,3,31,16,15,39
Spart Moscow,6146,2,10,6,4,37,26,11,36
CSKA Moscow,6146,3,11,3,6,26,22,4,36
Zenit,6146,4,9,8,3,30,14,16,35
Krasnodar,6146,5,9,5,6,30,26,4,32
Terek Grozny,6146,6,8,5,7,21,23,-2,29
Din Moscow,6146,7,5,7,8,19,25,-6,22
FK Rubin,6146,8,5,6,9,23,20,3,21
Rostov,6146,9,4,6,10,10,18,-8,18
Amkar,6146,10,4,5,11,9,23,-14,17
Anzhi,6146,11,3,5,12,15,38,-23,14
Loko Moscow,6147,1,11,5,4,32,18,14,38
Spart Moscow,6147,2,10,6,4,40,27,13,36
CSKA Moscow,6147,3,11,3,6,27,19,8,36
Zenit,6147,4,9,8,3,28,15,13,35
Krasnodar,6147,5,9,5,6,29,25,4,32
Terek Grozny,6147,6,7,7,6,21,23,-2,28
FK Rubin,6147,7,6,6,8,23,18,5,24
Din Moscow,6147,8,5,6,9,18,25,-7,21
Rostov,6147,9,4,6,10,11,21,-10,18
Amkar,6147,10,4,6,10,10,23,-13,18
Anzhi,6147,11,2,6,12,15,40,-25,12
Loko Moscow,6148,1,12,5,3,31,13,18,41
CSKA Moscow,6148,2,11,3,6,27,20,7,36
Zenit,6148,3,9,8,3,24,13,11,35
Spart Moscow,6148,4,9,6,5,37,29,8,33
Terek Grozny,6148,5,8,6,6,23,22,1,30
Krasnodar,6148,6,8,4,8,28,28,0,28
Din Moscow,6148,7,6,6,8,19,23,-4,24
FK Rubin,6148,8,6,5,9,23,18,5,23
Rostov,6148,9,5,6,9,12,18,-6,21
Amkar,6148,10,4,6,10,10,23,-13,18
Anzhi,6148,11,2,5,13,15,42,-27,11
Loko Moscow,6149,1,12,5,3,31,14,17,41
Spart Moscow,6149,2,11,5,4,39,26,13,38
CSKA Moscow,6149,3,11,3,6,28,19,9,36
Zenit,6149,4,9,8,3,26,13,13,35
Krasnodar,6149,5,8,5,7,28,27,1,29
Terek Grozny,6149,6,7,6,7,22,25,-3,27
Din Moscow,6149,7,6,6,8,19,23,-4,24
FK Rubin,6149,8,5,6,9,23,20,3,21
Rostov,6149,9,4,6,10,11,21,-10,18
Amkar,6149,10,4,5,11,10,24,-14,17
Anzhi,6149,11,3,5,12,16,41,-25,14
Loko Moscow,6150,1,13,5,2,31,11,20,44
CSKA Moscow,6150,2,11,3,6,28,18,10,36
Spart Moscow,6150,3,9,6,5,37,28,9,33
Zenit,6150,4,8,8,4,22,14,8,32
Krasnodar,6150,5,9,4,7,28,25,3,31
Terek Grozny,6150,6,8,6,6,26,27,-1,30
Din Moscow,6150,7,5,8,7,20,24,-4,23
FK Rubin,6150,8,5,6,9,23,20,3,21
Amkar,6150,9,5,4,11,12,24,-12,19
Rostov,6150,10,4,6,10,10,20,-10,18
Anzhi,6150,11,2,6,12,18,44,-26,12
Loko Moscow,6151,1,12,5,3,31,13,18,41
Spart Moscow,6151,2,11,5,4,39,27,12,38
CSKA Moscow,6151,3,11,4,5,30,20,10,37
Zenit,6151,4,8,9,3,25,15,10,33
Krasnodar,6151,5,8,5,7,29,28,1,29
Terek Grozny,6151,6,7,6,7,22,25,-3,27
FK Rubin,6151,7,6,6,8,24,19,5,24
Din Moscow,6151,8,5,6,9,18,24,-6,21
Amkar,6151,9,5,4,11,11,24,-13,19
Rostov,6151,10,4,6,10,10,19,-9,18
Anzhi,6151,11,2,6,12,17,42,-25,12
Loko Moscow,6152,1,12,6,2,32,13,19,42
Spart Moscow,6152,2,10,6,4,38,25,13,36
CSKA Moscow,6152,3,11,3,6,29,19,10,36
Zenit,6152,4,8,8,4,23,15,8,32
Krasnodar,6152,5,8,5,7,28,26,2,29
Terek Grozny,6152,6,7,7,6,22,24,-2,28
FK Rubin,6152,7,6,6,8,22,17,5,24
Din Moscow,6152,8,5,8,7,17,21,-4,23
Rostov,6152,9,4,6,10,10,18,-8,18
Amkar,6152,10,4,5,11,10,27,-17,17
Anzhi,6152,11,2,6,12,16,42,-26,12
Loko Moscow,6153,1,13,5,2,34,13,21,44
Spart Moscow,6153,2,9,6,5,36,28,8,33
CSKA Moscow,6153,3,10,3,7,26,20,6,33
Zenit,6153,4,8,8,4,24,16,8,32
Krasnodar,6153,5,9,4,7,29,26,3,31
Terek Grozny,6153,6,8,6,6,23,23,0,30
Din Moscow,6153,7,6,6,8,20,24,-4,24
FK Rubin,6153,8,6,5,9,23,20,3,23
Rostov,6153,9,4,7,9,10,17,-7,19
Amkar,6153,10,4,5,11,11,25,-14,17
Anzhi,6153,11,3,5,12,16,40,-24,14
Loko Moscow,6154,1,13,5,2,32,11,21,44
CSKA Moscow,6154,2,11,4,5,27,17,10,37
Spart Moscow,6154,3,9,7,4,38,29,9,34
Terek Grozny,6154,4,9,5,6,25,25,0,32
Krasnodar,6154,5,9,4,7,29,26,3,31
Zenit,6154,6,7,9,4,21,15,6,30
Din Moscow,6154,7,5,7,8,20,25,-5,22
FK Rubin,6154,8,5,6,9,23,20,3,21
Rostov,6154,9,4,7,9,10,17,-7,19
Amkar,6154,10,4,5,11,13,27,-14,17
Anzhi,6154,11,2,5,13,15,41,-26,11
Loko Moscow,6155,1,12,5,3,31,13,18,41
CSKA Moscow,6155,2,11,4,5,27,17,10,37
Spart Moscow,6155,3,10,5,5,38,27,11,35
Zenit,6155,4,8,9,3,22,13,9,33
Krasnodar,6155,5,8,4,8,28,27,1,28
Terek Grozny,6155,6,7,6,7,22,25,-3,27
FK Rubin,6155,7,6,6,8,24,19,5,24
Din Moscow,6155,8,5,7,8,20,27,-7,22
Rostov,6155,9,5,6,9,11,17,-6,21
Amkar,6155,10,5,4,11,10,23,-13,19
Anzhi,6155,11,2,6,12,16,41,-25,12
Loko Moscow,6156,1,12,6,2,31,12,19,42
CSKA Moscow,6156,2,11,3,6,27,20,7,36
Spart Moscow,6156,3,9,6,5,36,30,6,33
Zenit,6156,4,8,8,4,23,14,9,32
Terek Grozny,6156,5,9,5,6,26,22,4,32
Krasnodar,6156,6,8,5,7,29,27,2,29
FK Rubin,6156,7,7,5,8,25,19,6,26
Din Moscow,6156,8,5,7,8,18,23,-5,22
Amkar,6156,9,5,4,11,14,24,-10,19
Rostov,6156,10,4,6,10,10,20,-10,18
Anzhi,6156,11,2,5,13,15,43,-28,11
Loko Moscow,6157,1,12,5,3,30,12,18,41
CSKA Moscow,6157,2,11,4,5,27,18,9,37
Spart Moscow,6157,3,10,5,5,41,30,11,35
Zenit,6157,4,8,8,4,22,14,8,32
Krasnodar,6157,5,9,4,7,30,25,5,31
Terek Grozny,6157,6,8,5,7,21,24,-3,29
Din Moscow,6157,7,6,6,8,19,26,-7,24
Amkar,6157,8,6,4,10,15,23,-8,22
FK Rubin,6157,9,5,5,10,21,21,0,20
Rostov,6157,10,4,6,10,10,19,-9,18
Anzhi,6157,11,2,6,12,15,39,-24,12
Loko Moscow,6158,1,11,7,2,31,13,18,40
Zenit,6158,2,8,9,3,22,13,9,33
CSKA Moscow,6158,3,10,3,7,26,20,6,33
Spart Moscow,6158,4,9,5,6,36,28,8,32
Terek Grozny,6158,5,8,6,6,23,24,-1,30
Krasnodar,6158,6,8,5,7,29,27,2,29
Din Moscow,6158,7,7,6,7,23,22,1,27
FK Rubin,6158,8,6,5,9,22,21,1,23
Rostov,6158,9,5,6,9,11,17,-6,21
Amkar,6158,10,4,5,11,10,25,-15,17
Anzhi,6158,11,3,5,12,17,40,-23,14
Loko Moscow,6159,1,12,5,3,34,16,18,41
Spart Moscow,6159,2,9,7,4,38,29,9,34
CSKA Moscow,6159,3,10,4,6,25,18,7,34
Krasnodar,6159,4,10,4,6,33,27,6,34
Zenit,6159,5,8,8,4,23,16,7,32
Terek Grozny,6159,6,9,5,6,24,24,0,32
FK Rubin,6159,7,6,5,9,24,20,4,23
Din Moscow,6159,8,5,7,8,20,25,-5,22
Rostov,6159,9,4,6,10,10,18,-8,18
Amkar,6159,10,4,5,11,12,26,-14,17
Anzhi,6159,11,2,6,12,15,39,-24,12
Loko Moscow,6160,1,12,5,3,34,14,20,41
CSKA Moscow,6160,2,12,3,5,29,18,11,39
Spart Moscow,6160,3,9,6,5,37,29,8,33
Krasnodar,6160,4,9,4,7,31,28,3,31
Terek Grozny,6160,5,8,6,6,24,24,0,30
Zenit,6160,6,7,8,5,22,18,4,29
Din Moscow,6160,7,6,6,8,20,23,-3,24
FK Rubin,6160,8,6,5,9,24,21,3,23
Amkar,6160,9,5,5,10,12,24,-12,20
Rostov,6160,10,4,7,9,13,20,-7,19
Anzhi,6160,11,2,5,13,14,41,-27,11
Loko Moscow,6161,1,11,6,3,31,14,17,39
CSKA Moscow,6161,2,12,3,5,28,18,10,39
Zenit,6161,3,8,8,4,24,16,8,32
Spart Moscow,6161,4,8,7,5,36,29,7,31
Krasnodar,6161,5,8,6,6,29,26,3,30
Terek Grozny,6161,6,7,5,8,20,26,-6,26
FK Rubin,6161,7,6,6,8,26,20,6,24
Din Moscow,6161,8,6,6,8,20,25,-5,24
Amkar,6161,9,5,5,10,13,24,-11,20
Rostov,6161,10,4,7,9,11,18,-7,19
Anzhi,6161,11,3,5,12,16,38,-22,14
Loko Moscow,6162,1,12,6,2,31,12,19,42
CSKA Moscow,6162,2,11,3,6,26,19,7,36
Spart Moscow,6162,3,9,6,5,38,28,10,33
Zenit,6162,4,8,9,3,24,14,10,33
Krasnodar,6162,5,8,5,7,28,26,2,29
Terek Grozny,6162,6,7,7,6,21,23,-2,28
FK Rubin,6162,7,6,6,8,23,18,5,24
Din Moscow,6162,8,6,6,8,20,24,-4,24
Rostov,6162,9,4,6,10,10,20,-10,18
Amkar,6162,10,4,6,10,9,22,-13,18
Anzhi,6162,11,2,6,12,15,39,-24,12
Loko Moscow,6163,1,11,6,3,33,16,17,39
CSKA Moscow,6163,2,11,3,6,28,20,8,36
Spart Moscow,6163,3,9,7,4,35,26,9,34
Zenit,6163,4,8,9,3,26,16,10,33
Krasnodar,6163,5,9,5,6,30,26,4,32
Terek Grozny,6163,6,8,6,6,21,22,-1,30
FK Rubin,6163,7,5,7,8,22,18,4,22
Din Moscow,6163,8,5,7,8,18,23,-5,22
Rostov,6163,9,4,7,9,10,17,-7,19
Amkar,6163,10,4,6,10,9,22,-13,18
Anzhi,6163,11,2,5,13,15,41,-26,11
Loko Moscow,6164,1,12,5,3,31,13,18,41
CSKA Moscow,6164,2,11,4,5,28,19,9,37
Spart Moscow,6164,3,10,5,5,41,33,8,35
Zenit,6164,4,8,9,3,24,15,9,33
Terek Grozny,6164,5,8,6,6,21,22,-1,30
Krasnodar,6164,6,8,4,8,29,29,0,28
Din Moscow,6164,7,6,6,8,20,25,-5,24
FK Rubin,6164,8,6,5,9,25,20,5,23
Rostov,6164,9,5,6,9,14,18,-4,21
Amkar,6164,10,4,4,12,12,27,-15,16
Anzhi,6164,11,2,6,12,14,38,-24,12
Loko Moscow,6165,1,12,6,2,32,13,19,42
CSKA Moscow,6165,2,11,4,5,29,19,10,37
Spart Moscow,6165,3,10,5,5,37,28,9,35
Zenit,6165,4,7,9,4,23,16,7,30
Krasnodar,6165,5,8,5,7,28,27,1,29
Terek Grozny,6165,6,7,6,7,20,24,-4,27
FK Rubin,6165,7,7,5,8,24,17,7,26
Din Moscow,6165,8,5,6,9,19,25,-6,21
Amkar,6165,9,5,5,10,10,22,-12,20
Rostov,6165,10,4,6,10,10,18,-8,18
Anzhi,6165,11,3,5,12,17,40,-23,14
Loko Moscow,6166,1,12,6,2,32,13,19,42
CSKA Moscow,6166,2,11,4,5,32,17,15,37
Zenit,6166,3,7,10,3,22,14,8,31
Spart Moscow,6166,4,8,7,5,35,29,6,31
Krasnodar,6166,5,9,4,7,31,26,5,31
Din Moscow,6166,6,7,6,7,21,21,0,27
Terek Grozny,6166,7,7,5,8,23,27,-4,26
FK Rubin,6166,8,5,5,10,21,22,-1,20
Amkar,6166,9,5,5,10,13,25,-12,20
Rostov,6166,10,4,7,9,11,18,-7,19
Anzhi,6166,11,3,5,12,16,45,-29,14
Loko Moscow,6167,1,12,6,2,32,12,20,42
CSKA Moscow,6167,2,11,3,6,30,21,9,36
Spart Moscow,6167,3,9,6,5,37,28,9,33
Zenit,6167,4,8,8,4,24,17,7,32
Krasnodar,6167,5,9,5,6,30,25,5,32
Terek Grozny,6167,6,7,5,8,20,25,-5,26
Din Moscow,6167,7,6,6,8,22,25,-3,24
Amkar,6167,8,6,4,10,12,22,-10,22
FK Rubin,6167,9,5,5,10,22,24,-2,20
Rostov,6167,10,4,7,9,10,17,-7,19
Anzhi,6167,11,3,5,12,18,41,-23,14
Loko Moscow,6168,1,12,6,2,32,13,19,42
CSKA Moscow,6168,2,10,5,5,27,19,8,35
Spart Moscow,6168,3,9,7,4,42,30,12,34
Zenit,6168,4,7,9,4,23,16,7,30
Krasnodar,6168,5,8,5,7,29,29,0,29
Terek Grozny,6168,6,7,7,6,20,22,-2,28
FK Rubin,6168,7,7,5,8,26,18,8,26
Din Moscow,6168,8,5,7,8,19,24,-5,22
Rostov,6168,9,4,7,9,12,19,-7,19
Amkar,6168,10,4,5,11,10,27,-17,17
Anzhi,6168,11,2,7,11,15,38,-23,13
Loko Moscow,6169,1,12,6,2,34,13,21,42
CSKA Moscow,6169,2,11,4,5,27,18,9,37
Spart Moscow,6169,3,9,6,5,42,30,12,33
Terek Grozny,6169,4,9,5,6,23,23,0,32
Zenit,6169,5,7,9,4,22,17,5,30
Krasnodar,6169,6,8,5,7,29,27,2,29
Din Moscow,6169,7,6,7,7,22,25,-3,25
FK Rubin,6169,8,6,6,8,25,20,5,24
Rostov,6169,9,4,6,10,12,24,-12,18
Amkar,6169,10,4,5,11,11,25,-14,17
Anzhi,6169,11,2,5,13,14,39,-25,11
Loko Moscow,6170,1,12,5,3,31,13,18,41
CSKA Moscow,6170,2,11,3,6,26,18,8,36
Zenit,6170,3,9,8,3,24,14,10,35
Krasnodar,6170,4,9,4,7,28,25,3,31
Spart Moscow,6170,5,8,6,6,36,30,6,30
Terek Grozny,6170,6,8,5,7,22,23,-1,29
Din Moscow,6170,7,6,6,8,18,22,-4,24
FK Rubin,6170,8,6,5,9,22,18,4,23
Rostov,6170,9,5,6,9,12,18,-6,21
Amkar,6170,10,4,5,11,11,26,-15,17
Anzhi,6170,11,3,5,12,15,38,-23,14
Loko Moscow,6171,1,11,6,3,32,16,16,39
Zenit,6171,2,9,8,3,25,14,11,35
Spart Moscow,6171,3,9,7,4,38,27,11,34
CSKA Moscow,6171,4,10,4,6,27,20,7,34
Krasnodar,6171,5,8,6,6,30,27,3,30
Terek Grozny,6171,6,7,6,7,21,25,-4,27
Din Moscow,6171,7,6,7,7,19,22,-3,25
FK Rubin,6171,8,5,6,9,22,19,3,21
Amkar,6171,9,5,5,10,12,23,-11,20
Rostov,6171,10,4,6,10,10,20,-10,18
Anzhi,6171,11,2,7,11,17,40,-23,13
Loko Moscow,6172,1,12,6,2,30,11,19,42
Spart Moscow,6172,2,10,6,4,40,28,12,36
CSKA Moscow,6172,3,10,3,7,25,19,6,33
Zenit,6172,4,8,8,4,22,14,8,32
Krasnodar,6172,5,8,6,6,28,25,3,30
Terek Grozny,6172,6,8,6,6,25,26,-1,30
FK Rubin,6172,7,5,7,8,23,19,4,22
Din Moscow,6172,8,5,7,8,20,27,-7,22
Rostov,6172,9,4,6,10,11,19,-8,18
Amkar,6172,10,4,6,10,12,25,-13,18
Anzhi,6172,11,3,5,12,16,39,-23,14
Loko Moscow,6173,1,13,5,2,36,11,25,44
Spart Moscow,6173,2,11,5,4,39,27,12,38
CSKA Moscow,6173,3,11,4,5,29,18,11,37
Krasnodar,6173,4,9,4,7,29,26,3,31
Zenit,6173,5,7,9,4,22,20,2,30
Terek Grozny,6173,6,7,6,7,20,23,-3,27
FK Rubin,6173,7,6,5,9,24,19,5,23
Din Moscow,6173,8,5,6,9,17,25,-8,21
Rostov,6173,9,4,6,10,11,19,-8,18
Amkar,6173,10,4,5,11,10,24,-14,17
Anzhi,6173,11,3,5,12,15,40,-25,14
Loko Moscow,6174,1,11,6,3,29,12,17,39
CSKA Moscow,6174,2,11,3,6,30,18,12,36
Spart Moscow,6174,3,10,6,4,36,25,11,36
Zenit,6174,4,8,9,3,22,13,9,33
Krasnodar,6174,5,9,4,7,28,25,3,31
Terek Grozny,6174,6,8,5,7,24,25,-1,29
Din Moscow,6174,7,6,7,7,18,21,-3,25
FK Rubin,6174,8,6,5,9,22,18,4,23
Amkar,6174,9,5,4,11,10,24,-14,19
Rostov,6174,10,4,6,10,10,18,-8,18
Anzhi,6174,11,2,5,13,16,46,-30,11
Loko Moscow,6175,1,11,5,4,30,14,16,38
Zenit,6175,2,9,8,3,25,14,11,35
Krasnodar,6175,3,10,4,6,31,24,7,34
CSKA Moscow,6175,4,10,4,6,25,19,6,34
Spart Moscow,6175,5,9,5,6,36,28,8,32
Terek Grozny,6175,6,8,5,7,23,25,-2,29
Din Moscow,6175,7,6,7,7,19,22,-3,25
FK Rubin,6175,8,5,6,9,21,20,1,21
Rostov,6175,9,5,6,9,11,17,-6,21
Amkar,6175,10,4,4,12,10,26,-16,16
Anzhi,6175,11,3,6,11,16,38,-22,15
Loko Moscow,6176,1,11,5,4,31,15,16,38
CSKA Moscow,6176,2,11,4,5,28,18,10,37
Zenit,6176,3,8,9,3,24,15,9,33
Spart Moscow,6176,4,9,6,5,35,27,8,33
Krasnodar,6176,5,9,5,6,29,25,4,32
Terek Grozny,6176,6,8,5,7,23,25,-2,29
FK Rubin,6176,7,5,7,8,22,18,4,22
Din Moscow,6176,8,5,7,8,18,23,-5,22
Amkar,6176,9,6,4,10,11,22,-11,22
Rostov,6176,10,4,7,9,11,18,-7,19
Anzhi,6176,11,2,5,13,16,42,-26,11
Loko Moscow,6177,1,11,5,4,29,14,15,38
CSKA Moscow,6177,2,11,4,5,28,18,10,37
Spart Moscow,6177,3,9,6,5,37,27,10,33
Zenit,6177,4,8,8,4,22,15,7,32
Krasnodar,6177,5,9,4,7,29,25,4,31
Terek Grozny,6177,6,8,5,7,23,25,-2,29
FK Rubin,6177,7,7,5,8,26,17,9,26
Amkar,6177,8,6,4,10,12,23,-11,22
Din Moscow,6177,9,5,6,9,17,28,-11,21
Rostov,6177,10,4,7,9,11,18,-7,19
Anzhi,6177,11,2,6,12,16,40,-24,12
Loko Moscow,6178,1,13,5,2,33,11,22,44
CSKA Moscow,6178,2,12,3,5,31,18,13,39
Spart Moscow,6178,3,9,6,5,36,28,8,33
Krasnodar,6178,4,9,4,7,29,27,2,31
Zenit,6178,5,7,8,5,22,17,5,29
Terek Grozny,6178,6,8,5,7,24,25,-1,29
Din Moscow,6178,7,5,8,7,18,22,-4,23
FK Rubin,6178,8,5,6,9,21,19,2,21
Rostov,6178,9,5,6,9,11,17,-6,21
Amkar,6178,10,5,4,11,12,25,-13,19
Anzhi,6178,11,2,5,13,15,43,-28,11
Loko Moscow,6179,1,11,7,2,30,12,18,40
CSKA Moscow,6179,2,11,3,6,28,20,8,36
Spart Moscow,6179,3,10,5,5,38,29,9,35
Zenit,6179,4,8,9,3,23,14,9,33
Krasnodar,6179,5,8,6,6,29,26,3,30
Terek Grozny,6179,6,8,6,6,22,23,-1,30
FK Rubin,6179,7,6,6,8,25,19,6,24
Rostov,6179,8,5,6,9,13,18,-5,21
Din Moscow,6179,9,5,6,9,18,26,-8,21
Amkar,6179,10,4,5,11,10,24,-14,17
Anzhi,6179,11,2,5,13,16,41,-25,11
Loko Moscow,6180,1,13,5,2,32,11,21,44
Spart Moscow,6180,2,9,7,4,37,28,9,34
CSKA Moscow,6180,3,10,3,7,25,19,6,33
Zenit,6180,4,8,8,4,22,15,7,32
Krasnodar,6180,5,9,4,7,28,25,3,31
Terek Grozny,6180,6,7,6,7,21,24,-3,27
Din Moscow,6180,7,5,8,7,22,26,-4,23
FK Rubin,6180,8,5,6,9,23,20,3,21
Rostov,6180,9,4,6,10,10,18,-8,18
Amkar,6180,10,4,6,10,9,22,-13,18
Anzhi,6180,11,4,5,11,17,38,-21,17
Loko Moscow,6181,1,12,5,3,31,14,17,41
Spart Moscow,6181,2,9,7,4,36,27,9,34
Krasnodar,6181,3,10,4,6,31,24,7,34
CSKA Moscow,6181,4,10,4,6,27,20,7,34
Zenit,6181,5,7,9,4,22,15,7,30
Terek Grozny,6181,6,8,5,7,24,25,-1,29
FK Rubin,6181,7,6,5,9,25,20,5,23
Din Moscow,6181,8,5,6,9,19,27,-8,21
Amkar,6181,9,5,5,10,11,23,-12,20
Rostov,6181,10,4,7,9,10,17,-7,19
Anzhi,6181,11,3,5,12,19,43,-24,14
Loko Moscow,6182,1,12,5,3,30,12,18,41
CSKA Moscow,6182,2,11,4,5,28,19,9,37
Zenit,6182,3,8,9,3,23,14,9,33
Spart Moscow,6182,4,9,6,5,37,29,8,33
Terek Grozny,6182,5,9,5,6,25,24,1,32
Krasnodar,6182,6,9,4,7,29,25,4,31
Din Moscow,6182,7,6,6,8,20,26,-6,24
FK Rubin,6182,8,6,5,9,25,20,5,23
Rostov,6182,9,4,6,10,11,19,-8,18
Amkar,6182,10,4,5,11,11,25,-14,17
Anzhi,6182,11,2,5,13,16,42,-26,11
CSKA Moscow,6183,1,12,3,5,31,20,11,39
Loko Moscow,6183,2,11,5,4,29,16,13,38
Spart Moscow,6183,3,10,5,5,39,28,11,35
Krasnodar,6183,4,10,4,6,31,24,7,34
Zenit,6183,5,8,8,4,25,17,8,32
Terek Grozny,6183,6,7,7,6,22,24,-2,28
Din Moscow,6183,7,6,6,8,18,23,-5,24
Rostov,6183,8,5,6,9,13,19,-6,21
FK Rubin,6183,9,5,5,10,21,19,2,20
Amkar,6183,10,4,5,11,10,25,-15,17
Anzhi,6183,11,2,6,12,16,40,-24,12
Loko Moscow,6184,1,12,5,3,32,15,17,41
CSKA Moscow,6184,2,11,3,6,26,19,7,36
Spart Moscow,6184,3,10,5,5,37,26,11,35
Zenit,6184,4,8,8,4,24,16,8,32
Krasnodar,6184,5,9,5,6,30,24,6,32
Terek Grozny,6184,6,8,6,6,22,23,-1,30
FK Rubin,6184,7,6,6,8,23,17,6,24
Rostov,6184,8,5,6,9,11,17,-6,21
Din Moscow,6184,9,5,6,9,17,25,-8,21
Amkar,6184,10,4,5,11,10,25,-15,17
Anzhi,6184,11,2,5,13,14,39,-25,11
Loko Moscow,6185,1,13,5,2,33,12,21,44
Spart Moscow,6185,2,10,6,4,37,26,11,36
CSKA Moscow,6185,3,11,3,6,29,21,8,36
Zenit,6185,4,8,8,4,23,16,7,32
Krasnodar,6185,5,8,4,8,28,27,1,28
Terek Grozny,6185,6,7,6,7,21,25,-4,27
FK Rubin,6185,7,7,5,8,24,18,6,26
Din Moscow,6185,8,5,6,9,18,25,-7,21
Amkar,6185,9,5,5,10,12,23,-11,20
Rostov,6185,10,4,6,10,10,18,-8,18
Anzhi,6185,11,2,6,12,17,41,-24,12
Loko Moscow,6186,1,12,6,2,32,12,20,42
CSKA Moscow,6186,2,12,3,5,30,18,12,39
Spart Moscow,6186,3,11,5,4,38,25,13,38
Krasnodar,6186,4,8,6,6,29,26,3,30
Zenit,6186,5,7,8,5,22,17,5,29
Terek Grozny,6186,6,8,5,7,22,24,-2,29
Din Moscow,6186,7,6,6,8,19,23,-4,24
FK Rubin,6186,8,5,6,9,22,20,2,21
Amkar,6186,9,5,4,11,10,23,-13,19
Rostov,6186,10,4,6,10,10,19,-9,18
Anzhi,6186,11,2,5,13,15,42,-27,11
Loko Moscow,6187,1,12,5,3,32,14,18,41
CSKA Moscow,6187,2,11,3,6,29,21,8,36
Krasnodar,6187,3,10,4,6,35,26,9,34
Spart Moscow,6187,4,9,5,6,36,28,8,32
Zenit,6187,5,8,8,4,24,16,8,32
Terek Grozny,6187,6,8,5,7,22,24,-2,29
Din Moscow,6187,7,5,7,8,18,24,-6,22
Amkar,6187,8,6,4,10,12,23,-11,22
FK Rubin,6187,9,5,6,9,22,23,-1,21
Rostov,6187,10,5,6,9,12,18,-6,21
Anzhi,6187,11,2,5,13,15,40,-25,11
Loko Moscow,6188,1,12,6,2,32,13,19,42
Spart Moscow,6188,2,10,6,4,37,26,11,36
CSKA Moscow,6188,3,11,3,6,27,19,8,36
Krasnodar,6188,4,9,5,6,34,27,7,32
Zenit,6188,5,7,8,5,21,15,6,29
Terek Grozny,6188,6,8,5,7,22,24,-2,29
Din Moscow,6188,7,5,7,8,20,26,-6,22
FK Rubin,6188,8,5,6,9,24,24,0,21
Rostov,6188,9,4,6,10,10,18,-8,18
Amkar,6188,10,4,5,11,9,23,-14,17
Anzhi,6188,11,4,5,11,18,39,-21,17
Loko Moscow,6189,1,12,5,3,31,13,18,41
CSKA Moscow,6189,2,11,4,5,32,21,11,37
Krasnodar,6189,3,10,4,6,31,26,5,34
Spart Moscow,6189,4,9,6,5,36,27,9,33
Zenit,6189,5,7,9,4,24,17,7,30
Terek Grozny,6189,6,8,5,7,24,26,-2,29
Din Moscow,6189,7,5,7,8,18,24,-6,22
FK Rubin,6189,8,5,6,9,23,20,3,21
Rostov,6189,9,5,6,9,11,17,-6,21
Amkar,6189,10,5,5,10,11,23,-12,20
Anzhi,6189,11,2,5,13,18,45,-27,11
Loko Moscow,6190,1,12,5,3,32,13,19,41
Spart Moscow,6190,2,10,6,4,37,26,11,36
CSKA Moscow,6190,3,10,4,6,25,20,5,34
Zenit,6190,4,8,8,4,25,16,9,32
Krasnodar,6190,5,9,5,6,29,25,4,32
Terek Grozny,6190,6,8,5,7,22,24,-2,29
FK Rubin,6190,7,5,7,8,24,20,4,22
Din Moscow,6190,8,5,7,8,19,24,-5,22
Rostov,6190,9,4,6,10,10,19,-9,18
Amkar,6190,10,4,5,11,10,24,-14,17
Anzhi,6190,11,3,6,11,16,38,-22,15
Loko Moscow,6191,1,12,5,3,31,13,18,41
CSKA Moscow,6191,2,11,4,5,28,18,10,37
Krasnodar,6191,3,9,4,7,29,27,2,31
Zenit,6191,4,7,9,4,22,15,7,30
Spart Moscow,6191,5,8,6,6,35,30,5,30
Terek Grozny,6191,6,7,6,7,22,26,-4,27
Din Moscow,6191,7,6,7,7,18,21,-3,25
FK Rubin,6191,8,6,6,8,23,17,6,24
Amkar,6191,9,5,5,10,12,23,-11,20
Rostov,6191,10,4,7,9,11,18,-7,19
Anzhi,6191,11,3,5,12,18,41,-23,14
Loko Moscow,6192,1,13,5,2,32,12,20,44
CSKA Moscow,6192,2,11,4,5,28,18,10,37
Spart Moscow,6192,3,10,6,4,41,30,11,36
Zenit,6192,4,7,8,5,22,17,5,29
Krasnodar,6192,5,8,4,8,28,27,1,28
Terek Grozny,6192,6,7,6,7,20,23,-3,27
FK Rubin,6192,7,6,6,8,25,20,5,24
Din Moscow,6192,8,5,7,8,19,25,-6,22
Amkar,6192,9,5,5,10,14,26,-12,20
Rostov,6192,10,4,6,10,11,19,-8,18
Anzhi,6192,11,2,7,11,15,38,-23,13
Loko Moscow,6193,1,12,5,3,31,13,18,41
Spart Moscow,6193,2,9,7,4,41,31,10,34
CSKA Moscow,6193,3,10,4,6,26,19,7,34
Zenit,6193,4,8,8,4,23,15,8,32
Krasnodar,6193,5,9,4,7,29,26,3,31
FK Rubin,6193,6,7,5,8,25,19,6,26
Terek Grozny,6193,7,7,5,8,21,26,-5,26
Din Moscow,6193,8,5,7,8,22,27,-5,22
Rostov,6193,9,4,7,9,11,18,-7,19
Amkar,6193,10,5,4,11,12,25,-13,19
Anzhi,6193,11,3,6,11,17,39,-22,15
Loko Moscow,6194,1,12,5,3,31,12,19,41
Spart Moscow,6194,2,11,5,4,40,27,13,38
CSKA Moscow,6194,3,10,5,5,27,19,8,35
Zenit,6194,4,8,9,3,23,14,9,33
Terek Grozny,6194,5,8,5,7,22,25,-3,29
Krasnodar,6194,6,8,4,8,28,30,-2,28
Din Moscow,6194,7,6,6,8,20,25,-5,24
FK Rubin,6194,8,6,5,9,26,20,6,23
Rostov,6194,9,4,6,10,11,19,-8,18
Amkar,6194,10,4,4,12,9,26,-17,16
Anzhi,6194,11,3,6,11,18,38,-20,15
Loko Moscow,6195,1,11,6,3,31,14,17,39
CSKA Moscow,6195,2,12,3,5,29,19,10,39
Krasnodar,6195,3,10,4,6,32,27,5,34
Spart Moscow,6195,4,9,6,5,35,26,9,33
Zenit,6195,5,7,9,4,23,16,7,30
Terek Grozny,6195,6,8,5,7,23,23,0,29
Din Moscow,6195,7,5,8,7,18,22,-4,23
Amkar,6195,8,6,4,10,11,22,-11,22
FK Rubin,6195,9,5,6,9,24,21,3,21
Rostov,6195,10,4,6,10,10,19,-9,18
Anzhi,6195,11,2,5,13,15,42,-27,11
Loko Moscow,6196,1,11,7,2,31,13,18,40
CSKA Moscow,6196,2,11,4,5,29,19,10,37
Spart Moscow,6196,3,9,5,6,37,30,7,32
Zenit,6196,4,7,10,3,22,14,8,31
Terek Grozny,6196,5,8,6,6,22,23,-1,30
Krasnodar,6196,6,8,5,7,29,30,-1,29
FK Rubin,6196,7,7,5,8,27,18,9,26
Din Moscow,6196,8,6,6,8,20,24,-4,24
Amkar,6196,9,5,5,10,11,22,-11,20
Rostov,6196,10,4,6,10,11,20,-9,18
Anzhi,6196,11,2,5,13,16,42,-26,11
Loko Moscow,6197,1,12,6,2,30,11,19,42
CSKA Moscow,6197,2,12,3,5,29,18,11,39
Spart Moscow,6197,3,9,6,5,37,27,10,33
Krasnodar,6197,4,8,6,6,27,24,3,30
Zenit,6197,5,7,8,5,21,15,6,29
Terek Grozny,6197,6,8,5,7,22,24,-2,29
FK Rubin,6197,7,5,7,8,22,18,4,22
Din Moscow,6197,8,5,7,8,18,26,-8,22
Amkar,6197,9,6,4,10,13,23,-10,22
Rostov,6197,10,4,7,9,10,17,-7,19
Anzhi,6197,11,2,5,13,15,41,-26,11
Loko Moscow,6198,1,11,6,3,30,16,14,39
CSKA Moscow,6198,2,11,4,5,26,17,9,37
Spart Moscow,6198,3,10,5,5,36,27,9,35
Krasnodar,6198,4,10,4,6,32,24,8,34
Zenit,6198,5,7,9,4,22,15,7,30
Terek Grozny,6198,6,8,5,7,23,26,-3,29
Din Moscow,6198,7,6,6,8,19,26,-7,24
FK Rubin,6198,8,6,5,9,25,18,7,23
Rostov,6198,9,4,6,10,10,18,-8,18
Amkar,6198,10,4,4,12,10,25,-15,16
Anzhi,6198,11,3,6,11,17,38,-21,15
Loko Moscow,6199,1,12,5,3,32,15,17,41
CSKA Moscow,6199,2,12,3,5,28,18,10,39
Spart Moscow,6199,3,10,5,5,37,27,10,35
Zenit,6199,4,8,8,4,25,16,9,32
Krasnodar,6199,5,9,4,7,30,27,3,31
Terek Grozny,6199,6,8,5,7,25,26,-1,29
Din Moscow,6199,7,7,6,7,19,21,-2,27
FK Rubin,6199,8,5,5,10,22,20,2,20
Amkar,6199,9,5,4,11,12,25,-13,19
Rostov,6199,10,4,6,10,11,20,-9,18
Anzhi,6199,11,2,5,13,15,41,-26,11
Loko Moscow,6200,1,11,5,4,29,15,14,38
CSKA Moscow,6200,2,11,4,5,29,17,12,37
Spart Moscow,6200,3,9,6,5,37,28,9,33
Zenit,6200,4,8,9,3,22,13,9,33
Krasnodar,6200,5,9,5,6,31,25,6,32
Terek Grozny,6200,6,7,6,7,23,26,-3,27
Din Moscow,6200,7,6,6,8,19,23,-4,24
FK Rubin,6200,8,5,6,9,22,20,2,21
Rostov,6200,9,5,6,9,13,19,-6,21
Amkar,6200,10,5,5,10,12,24,-12,20
Anzhi,6200,11,2,6,12,15,42,-27,12
Loko Moscow,6201,1,12,5,3,31,13,18,41
Spart Moscow,6201,2,10,6,4,43,25,18,36
Krasnodar,6201,3,10,4,6,31,25,6,34
CSKA Moscow,6201,4,10,4,6,27,21,6,34
Zenit,6201,5,8,8,4,23,14,9,32
Terek Grozny,6201,6,8,5,7,24,24,0,29
Din Moscow,6201,7,6,6,8,18,26,-8,24
FK Rubin,6201,8,5,5,10,21,20,1,20
Amkar,6201,9,5,5,10,11,23,-12,20
Rostov,6201,10,4,6,10,10,22,-12,18
Anzhi,6201,11,2,6,12,16,42,-26,12
Loko Moscow,6202,1,12,6,2,31,12,19,42
CSKA Moscow,6202,2,10,4,6,27,21,6,34
Zenit,6202,3,8,8,4,23,14,9,32
Spart Moscow,6202,4,8,6,6,35,30,5,30
Krasnodar,6202,5,8,5,7,28,28,0,29
Terek Grozny,6202,6,8,5,7,23,23,0,29
FK Rubin,6202,7,6,6,8,25,18,7,24
Din Moscow,6202,8,5,8,7,19,23,-4,23
Amkar,6202,9,6,4,10,13,23,-10,22
Rostov,6202,10,5,6,9,11,17,-6,21
Anzhi,6202,11,2,6,12,16,42,-26,12
Loko Moscow,6203,1,13,5,2,34,12,22,44
CSKA Moscow,6203,2,11,4,5,26,17,9,37
Spart Moscow,6203,3,9,6,5,39,31,8,33
Krasnodar,6203,4,9,4,7,29,27,2,31
Zenit,6203,5,7,8,5,22,17,5,29
Terek Grozny,6203,6,7,5,8,21,26,-5,26
Din Moscow,6203,7,6,7,7,21,23,-2,25
Amkar,6203,8,6,4,10,14,22,-8,22
FK Rubin,6203,9,5,5,10,23,22,1,20
Rostov,6203,10,4,6,10,12,22,-10,18
Anzhi,6203,11,3,6,11,16,38,-22,15
Loko Moscow,6204,1,12,5,3,33,16,17,41
CSKA Moscow,6204,2,12,3,5,32,18,14,39
Krasnodar,6204,3,10,4,6,34,25,9,34
Spart Moscow,6204,4,8,6,6,35,29,6,30
Terek Grozny,6204,5,8,6,6,22,23,-1,30
Zenit,6204,6,7,8,5,23,20,3,29
Din Moscow,6204,7,6,6,8,20,24,-4,24
FK Rubin,6204,8,6,5,9,23,21,2,23
Amkar,6204,9,5,5,10,11,23,-12,20
Rostov,6204,10,4,7,9,11,18,-7,19
Anzhi,6204,11,2,5,13,14,41,-27,11
CSKA Moscow,6205,1,12,3,5,27,17,10,39
Loko Moscow,6205,2,11,5,4,30,14,16,38
Spart Moscow,6205,3,11,5,4,39,25,14,38
Krasnodar,6205,4,10,4,6,31,24,7,34
Zenit,6205,5,8,8,4,23,15,8,32
Terek Grozny,6205,6,8,5,7,22,24,-2,29
Din Moscow,6205,7,5,7,8,17,24,-7,22
FK Rubin,6205,8,5,6,9,21,20,1,21
Rostov,6205,9,4,6,10,10,18,-8,18
Amkar,6205,10,4,4,12,9,25,-16,16
Anzhi,6205,11,3,5,12,16,39,-23,14
Loko Moscow,6206,1,12,6,2,31,12,19,42
CSKA Moscow,6206,2,11,4,5,28,19,9,37
Spart Moscow,6206,3,9,6,5,36,28,8,33
Terek Grozny,6206,4,9,5,6,26,23,3,32
Krasnodar,6206,5,8,6,6,28,25,3,30
Zenit,6206,6,7,8,5,22,16,6,29
Din Moscow,6206,7,6,6,8,19,23,-4,24
FK Rubin,6206,8,5,6,9,21,19,2,21
Rostov,6206,9,4,7,9,11,18,-7,19
Amkar,6206,10,5,4,11,12,24,-12,19
Anzhi,6206,11,2,6,12,15,42,-27,12
Loko Moscow,6207,1,12,6,2,32,13,19,42
CSKA Moscow,6207,2,12,3,5,30,18,12,39
Spart Moscow,6207,3,9,7,4,39,28,11,34
Terek Grozny,6207,4,9,5,6,25,23,2,32
Zenit,6207,5,7,9,4,23,16,7,30
Krasnodar,6207,6,8,5,7,29,27,2,29
Din Moscow,6207,7,6,6,8,19,25,-6,24
FK Rubin,6207,8,5,6,9,22,19,3,21
Rostov,6207,9,4,7,9,10,17,-7,19
Amkar,6207,10,4,5,11,11,26,-15,17
Anzhi,6207,11,2,5,13,15,43,-28,11
Loko Moscow,6208,1,11,6,3,31,14,17,39
Spart Moscow,6208,2,11,5,4,40,28,12,38
Zenit,6208,3,9,8,3,27,16,11,35
CSKA Moscow,6208,4,10,4,6,28,22,6,34
Krasnodar,6208,5,9,5,6,30,26,4,32
Terek Grozny,6208,6,9,5,6,25,24,1,32
Din Moscow,6208,7,6,6,8,20,24,-4,24
FK Rubin,6208,8,5,5,10,22,20,2,20
Rostov,6208,9,4,6,10,10,19,-9,18
Amkar,6208,10,4,4,12,11,26,-15,16
Anzhi,6208,11,2,6,12,16,41,-25,12
Loko Moscow,6209,1,11,6,3,30,13,17,39
CSKA Moscow,6209,2,11,3,6,28,20,8,36
Zenit,6209,3,9,8,3,25,15,10,35
Spart Moscow,6209,4,9,6,5,39,30,9,33
Krasnodar,6209,5,8,5,7,29,27,2,29
Terek Grozny,6209,6,7,6,7,21,24,-3,27
FK Rubin,6209,7,6,6,8,23,18,5,24
Din Moscow,6209,8,5,7,8,19,25,-6,22
Amkar,6209,9,6,4,10,11,22,-11,22
Rostov,6209,10,4,7,9,12,19,-7,19
Anzhi,6209,11,2,6,12,15,39,-24,12
Loko Moscow,6210,1,12,5,3,31,15,16,41
CSKA Moscow,6210,2,12,3,5,28,18,10,39
Spart Moscow,6210,3,10,6,4,36,26,10,36
Krasnodar,6210,4,10,4,6,32,25,7,34
Zenit,6210,5,7,8,5,22,16,6,29
Terek Grozny,6210,6,7,6,7,22,25,-3,27
Din Moscow,6210,7,6,6,8,19,23,-4,24
FK Rubin,6210,8,5,5,10,23,21,2,20
Amkar,6210,9,5,5,10,11,23,-12,20
Rostov,6210,10,4,6,10,11,19,-8,18
Anzhi,6210,11,2,6,12,16,40,-24,12
Loko Moscow,6211,1,12,5,3,31,13,18,41
CSKA Moscow,6211,2,12,3,5,31,20,11,39
Spart Moscow,6211,3,9,6,5,39,30,9,33
Krasnodar,6211,4,9,4,7,28,26,2,31
Zenit,6211,5,7,8,5,23,18,5,29
Terek Grozny,6211,6,8,5,7,22,25,-3,29
Din Moscow,6211,7,7,6,7,23,25,-2,27
FK Rubin,6211,8,6,5,9,25,20,5,23
Rostov,6211,9,4,7,9,11,18,-7,19
Amkar,6211,10,4,4,12,10,27,-17,16
Anzhi,6211,11,3,5,12,19,40,-21,14
Loko Moscow,6212,1,11,5,4,31,15,16,38
CSKA Moscow,6212,2,11,3,6,27,18,9,36
Zenit,6212,3,9,8,3,24,14,10,35
Spart Moscow,6212,4,10,5,5,37,30,7,35
Krasnodar,6212,5,9,5,6,31,27,4,32
Terek Grozny,6212,6,7,7,6,21,23,-2,28
FK Rubin,6212,7,5,7,8,23,19,4,22
Din Moscow,6212,8,5,7,8,18,23,-5,22
Amkar,6212,9,5,5,10,14,24,-10,20
Rostov,6212,10,4,6,10,10,18,-8,18
Anzhi,6212,11,2,6,12,14,39,-25,12
Loko Moscow,6213,1,12,5,3,31,13,18,41
CSKA Moscow,6213,2,11,3,6,28,18,10,36
Zenit,6213,3,9,8,3,24,14,10,35
Spart Moscow,6213,4,10,5,5,37,28,9,35
Terek Grozny,6213,5,8,6,6,22,23,-1,30
Krasnodar,6213,6,8,4,8,27,26,1,28
Din Moscow,6213,7,6,6,8,19,24,-5,24
FK Rubin,6213,8,6,5,9,23,19,4,23
Amkar,6213,9,5,4,11,12,23,-11,19
Rostov,6213,10,4,6,10,10,19,-9,18
Anzhi,6213,11,2,6,12,15,41,-26,12
Loko Moscow,6214,1,12,6,2,32,13,19,42
Zenit,6214,2,8,9,3,24,14,10,33
CSKA Moscow,6214,3,10,3,7,26,21,5,33
Spart Moscow,6214,4,8,6,6,34,28,6,30
Krasnodar,6214,5,8,5,7,29,27,2,29
Terek Grozny,6214,6,8,5,7,22,26,-4,29
Din Moscow,6214,7,6,7,7,18,21,-3,25
Amkar,6214,8,6,4,10,14,23,-9,22
FK Rubin,6214,9,5,6,9,22,19,3,21
Rostov,6214,10,5,6,9,12,18,-6,21
Anzhi,6214,11,3,5,12,16,39,-23,14
Loko Moscow,6215,1,11,6,3,30,13,17,39
CSKA Moscow,6215,2,11,4,5,27,18,9,37
Zenit,6215,3,8,9,3,23,14,9,33
Spart Moscow,6215,4,9,5,6,39,30,9,32
Krasnodar,6215,5,9,5,6,31,26,5,32
Terek Grozny,6215,6,7,6,7,21,24,-3,27
Din Moscow,6215,7,6,6,8,21,27,-6,24
Amkar,6215,8,6,4,10,13,23,-10,22
Rostov,6215,9,5,6,9,12,18,-6,21
FK Rubin,6215,10,5,5,10,24,24,0,20
Anzhi,6215,11,2,6,12,15,39,-24,12
Loko Moscow,6216,1,11,7,2,30,12,18,40
CSKA Moscow,6216,2,11,3,6,27,20,7,36
Spart Moscow,6216,3,10,5,5,37,26,11,35
Zenit,6216,4,8,9,3,24,14,10,33
Krasnodar,6216,5,8,6,6,28,25,3,30
Terek Grozny,6216,6,7,6,7,21,24,-3,27
FK Rubin,6216,7,5,7,8,22,18,4,22
Din Moscow,6216,8,5,7,8,18,24,-6,22
Rostov,6216,9,5,6,9,11,17,-6,21
Amkar,6216,10,4,5,11,10,25,-15,17
Anzhi,6216,11,3,5,12,15,38,-23,14
Loko Moscow,6217,1,11,7,2,30,12,18,40
CSKA Moscow,6217,2,10,5,5,29,21,8,35
Krasnodar,6217,3,9,5,6,30,25,5,32
Zenit,6217,4,7,10,3,22,14,8,31
Spart Moscow,6217,5,8,6,6,33,28,5,30
Terek Grozny,6217,6,8,5,7,24,26,-2,29
Din Moscow,6217,7,6,7,7,19,21,-2,25
FK Rubin,6217,8,5,6,9,21,19,2,21
Rostov,6217,9,4,7,9,10,17,-7,19
Amkar,6217,10,5,4,11,11,24,-13,19
Anzhi,6217,11,3,6,11,20,42,-22,15
Loko Moscow,6218,1,11,5,4,30,17,13,38
CSKA Moscow,6218,2,11,4,5,28,19,9,37
Spart Moscow,6218,3,10,6,4,40,27,13,36
Zenit,6218,4,8,9,3,25,16,9,33
Krasnodar,6218,5,9,5,6,34,27,7,32
Terek Grozny,6218,6,7,6,7,22,27,-5,27
Din Moscow,6218,7,5,8,7,20,24,-4,23
FK Rubin,6218,8,5,7,8,25,21,4,22
Amkar,6218,9,5,4,11,12,25,-13,19
Rostov,6218,10,4,6,10,10,19,-9,18
Anzhi,6218,11,2,6,12,16,40,-24,12
Loko Moscow,6219,1,11,5,4,29,13,16,38
CSKA Moscow,6219,2,11,3,6,29,20,9,36
Zenit,6219,3,9,8,3,25,15,10,35
Krasnodar,6219,4,9,5,6,28,24,4,32
Spart Moscow,6219,5,8,7,5,33,27,6,31
Terek Grozny,6219,6,7,6,7,23,28,-5,27
Din Moscow,6219,7,5,8,7,18,22,-4,23
FK Rubin,6219,8,5,7,8,22,18,4,22
Amkar,6219,9,5,5,10,12,23,-11,20
Rostov,6219,10,4,7,9,10,17,-7,19
Anzhi,6219,11,3,5,12,19,41,-22,14
Loko Moscow,6220,1,13,5,2,35,14,21,44
Spart Moscow,6220,2,11,5,4,40,28,12,38
CSKA Moscow,6220,3,10,4,6,27,20,7,34
Krasnodar,6220,4,9,4,7,30,28,2,31
Zenit,6220,5,7,9,4,24,17,7,30
Terek Grozny,6220,6,8,6,6,23,24,-1,30
FK Rubin,6220,7,6,5,9,23,19,4,23
Din Moscow,6220,8,5,6,9,19,26,-7,21
Rostov,6220,9,4,6,10,10,18,-8,18
Amkar,6220,10,4,4,12,10,25,-15,16
Anzhi,6220,11,3,6,11,18,40,-22,15
Loko Moscow,6221,1,11,6,3,29,13,16,39
CSKA Moscow,6221,2,11,4,5,30,19,11,37
Spart Moscow,6221,3,9,7,4,35,26,9,34
Krasnodar,6221,4,10,4,6,31,25,6,34
Zenit,6221,5,7,10,3,22,14,8,31
Terek Grozny,6221,6,8,5,7,21,23,-2,29
Din Moscow,6221,7,6,7,7,20,23,-3,25
FK Rubin,6221,8,5,5,10,23,21,2,20
Rostov,6221,9,4,7,9,10,17,-7,19
Amkar,6221,10,5,4,11,10,23,-13,19
Anzhi,6221,11,2,5,13,15,42,-27,11
Loko Moscow,6222,1,13,5,2,31,11,20,44
Spart Moscow,6222,2,11,5,4,38,27,11,38
CSKA Moscow,6222,3,10,4,6,29,22,7,34
Krasnodar,6222,4,9,4,7,30,26,4,31
Zenit,6222,5,7,9,4,22,15,7,30
Terek Grozny,6222,6,7,6,7,21,24,-3,27
Din Moscow,6222,7,6,6,8,18,22,-4,24
FK Rubin,6222,8,5,5,10,22,21,1,20
Rostov,6222,9,4,6,10,10,18,-8,18
Amkar,6222,10,4,5,11,11,25,-14,17
Anzhi,6222,11,4,5,11,20,41,-21,17
Loko Moscow,6223,1,12,6,2,30,11,19,42
CSKA Moscow,6223,2,12,3,5,27,17,10,39
Spart Moscow,6223,3,11,5,4,42,28,14,38
Krasnodar,6223,4,9,4,7,29,26,3,31
Zenit,6223,5,7,9,4,21,14,7,30
Terek Grozny,6223,6,8,6,6,23,24,-1,30
FK Rubin,6223,7,6,5,9,24,19,5,23
Din Moscow,6223,8,5,6,9,17,26,-9,21
Rostov,6223,9,4,6,10,11,20,-9,18
Amkar,6223,10,4,5,11,12,26,-14,17
Anzhi,6223,11,2,5,13,15,40,-25,11
Loko Moscow,6224,1,12,5,3,32,14,18,41
Spart Moscow,6224,2,10,6,4,40,27,13,36
CSKA Moscow,6224,3,11,3,6,26,18,8,36
Zenit,6224,4,8,8,4,22,15,7,32
Krasnodar,6224,5,9,5,6,33,28,5,32
Terek Grozny,6224,6,9,5,6,24,23,1,32
Din Moscow,6224,7,5,8,7,20,24,-4,23
FK Rubin,6224,8,5,7,8,25,21,4,22
Rostov,6224,9,4,6,10,10,20,-10,18
Amkar,6224,10,4,4,12,10,27,-17,16
Anzhi,6224,11,2,5,13,14,39,-25,11
Loko Moscow,6225,1,12,6,2,32,11,21,42
Spart Moscow,6225,2,11,5,4,42,26,16,38
CSKA Moscow,6225,3,11,3,6,30,19,11,36
Zenit,6225,4,8,9,3,22,13,9,33
Terek Grozny,6225,5,9,5,6,26,25,1,32
Krasnodar,6225,6,8,4,8,28,29,-1,28
FK Rubin,6225,7,6,6,8,23,18,5,24
Din Moscow,6225,8,5,7,8,17,25,-8,22
Rostov,6225,9,4,6,10,10,20,-10,18
Amkar,6225,10,4,4,12,12,27,-15,16
Anzhi,6225,11,2,5,13,16,45,-29,11
Loko Moscow,6226,1,12,5,3,32,16,16,41
CSKA Moscow,6226,2,11,4,5,28,18,10,37
Spart Moscow,6226,3,10,6,4,37,27,10,36
Krasnodar,6226,4,10,4,6,34,25,9,34
Terek Grozny,6226,5,9,5,6,27,23,4,32
Zenit,6226,6,7,9,4,22,17,5,30
Din Moscow,6226,7,6,6,8,18,22,-4,24
FK Rubin,6226,8,5,5,10,22,20,2,20
Rostov,6226,9,4,6,10,10,18,-8,18
Amkar,6226,10,4,5,11,12,28,-16,17
Anzhi,6226,11,2,5,13,14,42,-28,11
Loko Moscow,6227,1,13,5,2,33,12,21,44
CSKA Moscow,6227,2,11,3,6,29,19,10,36
Spart Moscow,6227,3,9,6,5,38,29,9,33
Zenit,6227,4,8,8,4,24,15,9,32
Krasnodar,6227,5,9,4,7,29,27,2,31
Terek Grozny,6227,6,7,6,7,21,24,-3,27
Din Moscow,6227,7,6,7,7,20,23,-3,25
FK Rubin,6227,8,5,6,9,23,20,3,21
Rostov,6227,9,4,6,10,10,19,-9,18
Amkar,6227,10,4,6,10,11,24,-13,18
Anzhi,6227,11,3,5,12,16,42,-26,14
Loko Moscow,6228,1,12,5,3,32,14,18,41
Spart Moscow,6228,2,11,5,4,37,25,12,38
CSKA Moscow,6228,3,11,4,5,29,18,11,37
Zenit,6228,4,8,9,3,24,15,9,33
Krasnodar,6228,5,8,4,8,30,31,-1,28
FK Rubin,6228,6,7,5,8,28,19,9,26
Terek Grozny,6228,7,7,5,8,22,27,-5,26
Din Moscow,6228,8,5,6,9,17,24,-7,21
Amkar,6228,9,5,4,11,12,26,-14,19
Rostov,6228,10,4,6,10,10,18,-8,18
Anzhi,6228,11,3,5,12,16,40,-24,14
Loko Moscow,6229,1,11,6,3,29,13,16,39
CSKA Moscow,6229,2,12,3,5,29,18,11,39
Spart Moscow,6229,3,10,6,4,36,25,11,36
Krasnodar,6229,4,9,5,6,29,24,5,32
Terek Grozny,6229,5,9,5,6,23,22,1,32
Zenit,6229,6,7,9,4,21,15,6,30
Din Moscow,6229,7,6,6,8,18,23,-5,24
FK Rubin,6229,8,5,6,9,21,18,3,21
Rostov,6229,9,4,6,10,10,18,-8,18
Amkar,6229,10,4,5,11,9,23,-14,17
Anzhi,6229,11,2,5,13,15,41,-26,11
Loko Moscow,6230,1,12,5,3,31,13,18,41
CSKA Moscow,6230,2,11,4,5,29,17,12,37
Zenit,6230,3,8,9,3,23,14,9,33
Terek Grozny,6230,4,8,6,6,24,23,1,30
Spart Moscow,6230,5,8,5,7,34,31,3,29
Krasnodar,6230,6,8,4,8,27,26,1,28
Din Moscow,6230,7,6,7,7,19,22,-3,25
FK Rubin,6230,8,6,6,8,23,18,5,24
Rostov,6230,9,5,6,9,13,18,-5,21
Amkar,6230,10,5,4,11,11,25,-14,19
Anzhi,6230,11,2,6,12,15,42,-27,12
Loko Moscow,6231,1,11,5,4,31,15,16,38
Spart Moscow,6231,2,10,5,5,38,27,11,35
CSKA Moscow,6231,3,10,4,6,27,20,7,34
Zenit,6231,4,8,9,3,23,14,9,33
Krasnodar,6231,5,9,4,7,29,26,3,31
Terek Grozny,6231,6,8,6,6,23,23,0,30
FK Rubin,6231,7,7,5,8,24,17,7,26
Din Moscow,6231,8,5,6,9,17,25,-8,21
Amkar,6231,9,5,4,11,12,26,-14,19
Rostov,6231,10,4,6,10,10,19,-9,18
Anzhi,6231,11,3,6,11,17,39,-22,15
Loko Moscow,6232,1,13,5,2,33,11,22,44
Spart Moscow,6232,2,10,6,4,41,30,11,36
CSKA Moscow,6232,3,10,4,6,28,21,7,34
Zenit,6232,4,7,9,4,23,16,7,30
Krasnodar,6232,5,8,5,7,28,28,0,29
Terek Grozny,6232,6,7,6,7,20,23,-3,27
FK Rubin,6232,7,5,7,8,23,19,4,22
Din Moscow,6232,8,5,7,8,21,26,-5,22
Amkar,6232,9,5,5,10,12,24,-12,20
Rostov,6232,10,4,6,10,10,19,-9,18
Anzhi,6232,11,3,6,11,16,38,-22,15
Loko Moscow,6233,1,11,6,3,29,12,17,39
CSKA Moscow,6233,2,11,4,5,28,19,9,37
Spart Moscow,6233,3,10,5,5,38,29,9,35
Krasnodar,6233,4,10,4,6,29,24,5,34
Zenit,6233,5,7,10,3,22,14,8,31
Terek Grozny,6233,6,8,5,7,22,24,-2,29
Din Moscow,6233,7,6,7,7,21,23,-2,25
FK Rubin,6233,8,5,6,9,22,19,3,21
Amkar,6233,9,5,4,11,12,24,-12,19
Rostov,6233,10,4,6,10,10,19,-9,18
Anzhi,6233,11,2,5,13,15,41,-26,11
Loko Moscow,6234,1,13,5,2,37,13,24,44
CSKA Moscow,6234,2,11,4,5,26,17,9,37
Spart Moscow,6234,3,9,6,5,37,29,8,33
Terek Grozny,6234,4,8,6,6,22,22,0,30
Zenit,6234,5,7,8,5,22,16,6,29
Krasnodar,6234,6,8,4,8,28,31,-3,28
Din Moscow,6234,7,7,6,7,21,23,-2,27
FK Rubin,6234,8,6,5,9,22,18,4,23
Rostov,6234,9,4,6,10,10,18,-8,18
Amkar,6234,10,4,6,10,10,23,-13,18
Anzhi,6234,11,2,6,12,14,39,-25,12
Loko Moscow,6235,1,12,6,2,31,12,19,42
CSKA Moscow,6235,2,11,3,6,31,19,12,36
Spart Moscow,6235,3,9,6,5,39,29,10,33
Zenit,6235,4,8,9,3,24,15,9,33
Krasnodar,6235,5,9,4,7,29,26,3,31
Terek Grozny,6235,6,8,5,7,24,25,-1,29
Din Moscow,6235,7,5,7,8,18,25,-7,22
FK Rubin,6235,8,5,6,9,22,19,3,21
Rostov,6235,9,4,7,9,10,17,-7,19
Amkar,6235,10,5,4,11,13,27,-14,19
Anzhi,6235,11,3,5,12,16,43,-27,14
Loko Moscow,6236,1,13,5,2,35,11,24,44
Spart Moscow,6236,2,10,6,4,41,28,13,36
CSKA Moscow,6236,3,11,3,6,29,19,10,36
Zenit,6236,4,8,8,4,23,18,5,32
Krasnodar,6236,5,8,4,8,27,27,0,28
Terek Grozny,6236,6,7,6,7,21,25,-4,27
Din Moscow,6236,7,6,6,8,20,26,-6,24
FK Rubin,6236,8,6,5,9,23,19,4,23
Rostov,6236,9,4,6,10,10,19,-9,18
Amkar,6236,10,4,6,10,12,25,-13,18
Anzhi,6236,11,3,5,12,16,40,-24,14
CSKA Moscow,6237,1,12,3,5,30,18,12,39
Loko Moscow,6237,2,11,5,4,29,14,15,38
Spart Moscow,6237,3,10,6,4,41,28,13,36
Krasnodar,6237,4,10,4,6,29,24,5,34
Zenit,6237,5,8,8,4,23,14,9,32
Terek Grozny,6237,6,7,6,7,22,25,-3,27
Din Moscow,6237,7,6,6,8,19,23,-4,24
FK Rubin,6237,8,5,5,10,21,19,2,20
Rostov,6237,9,4,7,9,12,19,-7,19
Amkar,6237,10,4,5,11,10,27,-17,17
Anzhi,6237,11,3,5,12,17,42,-25,14
Loko Moscow,6238,1,12,5,3,33,16,17,41
CSKA Moscow,6238,2,11,4,5,29,20,9,37
Spart Moscow,6238,3,10,6,4,38,25,13,36
Krasnodar,6238,4,9,4,7,31,26,5,31
Zenit,6238,5,7,8,5,22,17,5,29
Terek Grozny,6238,6,8,5,7,22,23,-1,29
Din Moscow,6238,7,6,6,8,18,24,-6,24
FK Rubin,6238,8,6,5,9,22,18,4,23
Amkar,6238,9,5,5,10,10,22,-12,20
Rostov,6238,10,4,6,10,10,19,-9,18
Anzhi,6238,11,2,6,12,17,42,-25,12
Loko Moscow,6239,1,13,5,2,33,12,21,44
CSKA Moscow,6239,2,12,3,5,28,17,11,39
Spart Moscow,6239,3,9,6,5,40,31,9,33
Krasnodar,6239,4,9,4,7,29,27,2,31
Zenit,6239,5,7,8,5,22,16,6,29
Terek Grozny,6239,6,7,5,8,20,28,-8,26
Din Moscow,6239,7,6,6,8,22,26,-4,24
FK Rubin,6239,8,6,5,9,24,20,4,23
Amkar,6239,9,5,5,10,14,24,-10,20
Rostov,6239,10,4,6,10,10,19,-9,18
Anzhi,6239,11,3,5,12,17,39,-22,14
Loko Moscow,6240,1,12,6,2,33,12,21,42
CSKA Moscow,6240,2,11,3,6,30,18,12,36
Zenit,6240,3,8,8,4,22,16,6,32
Terek Grozny,6240,4,9,5,6,24,23,1,32
Spart Moscow,6240,5,8,6,6,35,30,5,30
Krasnodar,6240,6,8,5,7,31,29,2,29
Din Moscow,6240,7,6,7,7,20,22,-2,25
FK Rubin,6240,8,6,6,8,25,20,5,24
Rostov,6240,9,5,6,9,11,17,-6,21
Amkar,6240,10,4,5,11,10,24,-14,17
Anzhi,6240,11,2,5,13,15,45,-30,11
Loko Moscow,6241,1,13,5,2,31,11,20,44
CSKA Moscow,6241,2,12,3,5,27,17,10,39
Terek Grozny,6241,3,9,5,6,23,23,0,32
Spart Moscow,6241,4,8,6,6,38,33,5,30
Zenit,6241,5,7,8,5,21,15,6,29
Krasnodar,6241,6,8,5,7,30,28,2,29
Din Moscow,6241,7,7,6,7,20,22,-2,27
FK Rubin,6241,8,5,6,9,24,21,3,21
Rostov,6241,9,4,7,9,12,19,-7,19
Amkar,6241,10,5,4,11,13,25,-12,19
Anzhi,6241,11,2,5,13,15,40,-25,11
Loko Moscow,6242,1,12,5,3,30,12,18,41
Zenit,6242,2,9,8,3,23,13,10,35
CSKA Moscow,6242,3,10,4,6,25,18,7,34
Spart Moscow,6242,4,9,6,5,37,28,9,33
Krasnodar,6242,5,8,5,7,28,26,2,29
Terek Grozny,6242,6,7,6,7,21,26,-5,27
Din Moscow,6242,7,6,7,7,20,22,-2,25
FK Rubin,6242,8,5,6,9,22,20,2,21
Amkar,6242,9,5,5,10,10,22,-12,20
Rostov,6242,10,4,6,10,11,20,-9,18
Anzhi,6242,11,3,6,11,18,38,-20,15
Loko Moscow,6243,1,12,6,2,30,11,19,42
CSKA Moscow,6243,2,11,4,5,27,18,9,37
Spart Moscow,6243,3,9,6,5,37,28,9,33
Krasnodar,6243,4,9,4,7,29,25,4,31
Zenit,6243,5,7,9,4,21,14,7,30
Terek Grozny,6243,6,7,7,6,21,23,-2,28
Din Moscow,6243,7,6,6,8,20,26,-6,24
Rostov,6243,8,5,6,9,13,18,-5,21
FK Rubin,6243,9,5,5,10,23,22,1,20
Amkar,6243,10,4,6,10,10,23,-13,18
Anzhi,6243,11,2,7,11,15,38,-23,13
Loko Moscow,6244,1,12,5,3,33,15,18,41
CSKA Moscow,6244,2,11,3,6,29,20,9,36
Zenit,6244,3,9,8,3,27,15,12,35
Spart Moscow,6244,4,9,7,4,36,27,9,34
Krasnodar,6244,5,8,4,8,29,30,-1,28
Terek Grozny,6244,6,7,5,8,21,26,-5,26
FK Rubin,6244,7,6,6,8,24,18,6,24
Din Moscow,6244,8,5,8,7,18,22,-4,23
Amkar,6244,9,5,5,10,12,24,-12,20
Rostov,6244,10,4,6,10,10,18,-8,18
Anzhi,6244,11,3,5,12,16,40,-24,14
Loko Moscow,6245,1,13,5,2,33,11,22,44
CSKA Moscow,6245,2,11,3,6,27,18,9,36
Spart Moscow,6245,3,9,5,6,39,34,5,32
Zenit,6245,4,7,8,5,21,18,3,29
Krasnodar,6245,5,8,5,7,28,26,2,29
Din Moscow,6245,6,7,6,7,22,23,-1,27
Terek Grozny,6245,7,7,5,8,21,25,-4,26
Amkar,6245,8,6,4,10,13,23,-10,22
FK Rubin,6245,9,5,6,9,22,19,3,21
Rostov,6245,10,4,6,10,12,20,-8,18
Anzhi,6245,11,4,5,11,17,38,-21,17
Loko Moscow,6246,1,12,5,3,31,12,19,41
CSKA Moscow,6246,2,10,5,5,27,19,8,35
Krasnodar,6246,3,10,4,6,29,24,5,34
Spart Moscow,6246,4,9,6,5,35,27,8,33
Terek Grozny,6246,5,9,5,6,24,24,0,32
Zenit,6246,6,7,9,4,23,17,6,30
Din Moscow,6246,7,7,6,7,19,21,-2,27
FK Rubin,6246,8,5,5,10,21,19,2,20
Rostov,6246,9,4,7,9,11,18,-7,19
Amkar,6246,10,4,4,12,11,26,-15,16
Anzhi,6246,11,2,6,12,14,38,-24,12
Loko Moscow,6247,1,12,6,2,30,11,19,42
CSKA Moscow,6247,2,11,4,5,27,18,9,37
Spart Moscow,6247,3,10,6,4,38,27,11,36
Zenit,6247,4,7,9,4,21,14,7,30
Krasnodar,6247,5,8,6,6,27,24,3,30
Terek Grozny,6247,6,7,7,6,22,24,-2,28
Din Moscow,6247,7,6,6,8,21,25,-4,24
FK Rubin,6247,8,5,6,9,22,20,2,21
Rostov,6247,9,4,6,10,11,19,-8,18
Amkar,6247,10,4,6,10,10,23,-13,18
Anzhi,6247,11,2,6,12,16,40,-24,12
Loko Moscow,6248,1,12,6,2,34,13,21,42
CSKA Moscow,6248,2,12,3,5,31,20,11,39
Spart Moscow,6248,3,9,6,5,40,32,8,33
Krasnodar,6248,4,9,4,7,30,29,1,31
Zenit,6248,5,7,9,4,24,18,6,30
Terek Grozny,6248,6,7,5,8,21,25,-4,26
Din Moscow,6248,7,5,8,7,18,22,-4,23
Amkar,6248,8,6,4,10,15,26,-11,22
FK Rubin,6248,9,5,6,9,22,19,3,21
Rostov,6248,10,4,6,10,11,19,-8,18
Anzhi,6248,11,3,5,12,17,40,-23,14
Loko Moscow,6249,1,12,5,3,31,12,19,41
CSKA Moscow,6249,2,11,4,5,27,18,9,37
Spart Moscow,6249,3,10,5,5,42,27,15,35
Zenit,6249,4,8,9,3,22,13,9,33
Krasnodar,6249,5,9,4,7,29,26,3,31
Terek Grozny,6249,6,8,6,6,22,22,0,30
FK Rubin,6249,7,6,5,9,24,21,3,23
Din Moscow,6249,8,5,6,9,20,30,-10,21
Amkar,6249,9,5,5,10,10,22,-12,20
Rostov,6249,10,4,6,10,10,20,-10,18
Anzhi,6249,11,2,5,13,15,41,-26,11
Loko Moscow,6250,1,12,5,3,30,12,18,41
CSKA Moscow,6250,2,11,4,5,28,19,9,37
Spart Moscow,6250,3,9,6,5,39,29,10,33
Zenit,6250,4,8,8,4,22,14,8,32
Terek Grozny,6250,5,8,5,7,22,27,-5,29
Krasnodar,6250,6,8,4,8,28,27,1,28
Din Moscow,6250,7,6,7,7,20,23,-3,25
FK Rubin,6250,8,6,6,8,24,19,5,24
Rostov,6250,9,4,7,9,10,17,-7,19
Amkar,6250,10,5,4,11,15,27,-12,19
Anzhi,6250,11,2,6,12,17,41,-24,12
Loko Moscow,6251,1,12,5,3,31,12,19,41
CSKA Moscow,6251,2,11,3,6,27,20,7,36
Spart Moscow,6251,3,10,5,5,41,28,13,35
Zenit,6251,4,8,8,4,23,15,8,32
Krasnodar,6251,5,9,5,6,28,24,4,32
Terek Grozny,6251,6,7,6,7,21,25,-4,27
Din Moscow,6251,7,6,7,7,20,23,-3,25
FK Rubin,6251,8,5,7,8,21,17,4,22
Rostov,6251,9,4,6,10,10,19,-9,18
Amkar,6251,10,4,5,11,10,27,-17,17
Anzhi,6251,11,3,5,12,17,39,-22,14
Loko Moscow,6252,1,12,5,3,32,13,19,41
CSKA Moscow,6252,2,11,3,6,29,22,7,36
Krasnodar,6252,3,10,4,6,33,25,8,34
Spart Moscow,6252,4,9,6,5,37,30,7,33
Zenit,6252,5,8,8,4,23,16,7,32
Terek Grozny,6252,6,8,6,6,22,23,-1,30
FK Rubin,6252,7,6,5,9,25,21,4,23
Din Moscow,6252,8,5,6,9,18,26,-8,21
Rostov,6252,9,4,7,9,11,18,-7,19
Amkar,6252,10,5,4,11,12,24,-12,19
Anzhi,6252,11,2,6,12,18,42,-24,12
Loko Moscow,6253,1,11,5,4,30,14,16,38
CSKA Moscow,6253,2,11,4,5,28,18,10,37
Spart Moscow,6253,3,10,5,5,38,29,9,35
Krasnodar,6253,4,10,4,6,31,26,5,34
Zenit,6253,5,8,8,4,22,15,7,32
Terek Grozny,6253,6,8,5,7,24,26,-2,29
FK Rubin,6253,7,6,5,9,23,19,4,23
Din Moscow,6253,8,5,6,9,17,24,-7,21
Amkar,6253,9,5,4,11,12,24,-12,19
Rostov,6253,10,4,6,10,12,20,-8,18
Anzhi,6253,11,3,6,11,18,40,-22,15
Loko Moscow,6254,1,11,6,3,31,14,17,39
Spart Moscow,6254,2,11,5,4,40,26,14,38
CSKA Moscow,6254,3,11,4,5,30,19,11,37
Zenit,6254,4,8,9,3,23,14,9,33
Krasnodar,6254,5,9,5,6,30,26,4,32
Terek Grozny,6254,6,8,6,6,23,24,-1,30
Din Moscow,6254,7,6,6,8,20,24,-4,24
FK Rubin,6254,8,5,5,10,22,21,1,20
Rostov,6254,9,4,6,10,10,18,-8,18
Amkar,6254,10,4,5,11,11,27,-16,17
Anzhi,6254,11,2,5,13,16,43,-27,11
Loko Moscow,6255,1,11,6,3,32,15,17,39
Zenit,6255,2,9,8,3,23,13,10,35
Spart Moscow,6255,3,9,6,5,38,31,7,33
CSKA Moscow,6255,4,10,3,7,26,20,6,33
Krasnodar,6255,5,8,6,6,31,28,3,30
Terek Grozny,6255,6,8,5,7,24,26,-2,29
FK Rubin,6255,7,6,6,8,24,19,5,24
Din Moscow,6255,8,5,7,8,19,24,-5,22
Amkar,6255,9,5,4,11,12,24,-12,19
Rostov,6255,10,4,6,10,12,20,-8,18
Anzhi,6255,11,4,5,11,20,41,-21,17
Loko Moscow,6256,1,12,6,2,32,12,20,42
CSKA Moscow,6256,2,12,3,5,30,19,11,39
Spart Moscow,6256,3,10,6,4,39,28,11,36
Terek Grozny,6256,4,9,5,6,25,24,1,32
Zenit,6256,5,7,9,4,22,16,6,30
Krasnodar,6256,6,8,5,7,29,28,1,29
Din Moscow,6256,7,5,8,7,19,23,-4,23
FK Rubin,6256,8,5,7,8,23,19,4,22
Rostov,6256,9,4,6,10,11,20,-9,18
Amkar,6256,10,4,4,12,11,27,-16,16
Anzhi,6256,11,2,5,13,16,41,-25,11
Loko Moscow,6257,1,13,5,2,32,11,21,44
CSKA Moscow,6257,2,10,4,6,27,20,7,34
Spart Moscow,6257,3,9,6,5,36,29,7,33
Zenit,6257,4,8,8,4,24,17,7,32
Terek Grozny,6257,5,8,6,6,26,23,3,30
Krasnodar,6257,6,8,5,7,28,26,2,29
Din Moscow,6257,7,5,8,7,19,23,-4,23
FK Rubin,6257,8,5,7,8,24,20,4,22
Rostov,6257,9,5,6,9,14,18,-4,21
Amkar,6257,10,4,4,12,9,29,-20,16
Anzhi,6257,11,2,7,11,15,38,-23,13
Loko Moscow,6258,1,11,5,4,30,15,15,38
CSKA Moscow,6258,2,10,4,6,27,21,6,34
Spart Moscow,6258,3,9,6,5,36,27,9,33
Zenit,6258,4,8,9,3,24,15,9,33
Krasnodar,6258,5,9,5,6,31,26,5,32
Terek Grozny,6258,6,8,5,7,22,25,-3,29
FK Rubin,6258,7,6,6,8,23,18,5,24
Din Moscow,6258,8,6,6,8,19,23,-4,24
Amkar,6258,9,5,5,10,11,22,-11,20
Rostov,6258,10,4,6,10,10,19,-9,18
Anzhi,6258,11,3,5,12,17,39,-22,14
Loko Moscow,6259,1,11,7,2,30,12,18,40
Spart Moscow,6259,2,11,5,4,39,27,12,38
CSKA Moscow,6259,3,10,4,6,26,19,7,34
Zenit,6259,4,7,10,3,22,14,8,31
Krasnodar,6259,5,8,6,6,29,26,3,30
Terek Grozny,6259,6,7,6,7,20,23,-3,27
FK Rubin,6259,7,5,7,8,23,19,4,22
Din Moscow,6259,8,5,7,8,18,23,-5,22
Rostov,6259,9,4,6,10,11,20,-9,18
Amkar,6259,10,4,5,11,10,24,-14,17
Anzhi,6259,11,4,5,11,16,37,-21,17
Loko Moscow,6260,1,13,5,2,34,12,22,44
CSKA Moscow,6260,2,11,3,6,28,20,8,36
Spart Moscow,6260,3,9,6,5,36,28,8,33
Zenit,6260,4,8,8,4,25,18,7,32
Krasnodar,6260,5,9,4,7,28,25,3,31
Terek Grozny,6260,6,8,6,6,23,24,-1,30
Din Moscow,6260,7,7,6,7,21,23,-2,27
FK Rubin,6260,8,5,5,10,22,20,2,20
Rostov,6260,9,4,7,9,11,18,-7,19
Amkar,6260,10,4,4,12,10,25,-15,16
Anzhi,6260,11,2,6,12,15,40,-25,12
Loko Moscow,6261,1,11,6,3,30,14,16,39
CSKA Moscow,6261,2,11,4,5,28,18,10,37
Spart Moscow,6261,3,9,6,5,38,27,11,33
Krasnodar,6261,4,9,5,6,30,25,5,32
Zenit,6261,5,7,9,4,21,15,6,30
Terek Grozny,6261,6,7,6,7,22,26,-4,27
Din Moscow,6261,7,5,8,7,20,24,-4,23
FK Rubin,6261,8,5,7,8,23,19,4,22
Amkar,6261,9,6,4,10,13,23,-10,22
Rostov,6261,10,4,6,10,10,21,-11,18
Anzhi,6261,11,2,7,11,16,39,-23,13
Loko Moscow,6262,1,11,6,3,29,12,17,39
CSKA Moscow,6262,2,11,3,6,28,19,9,36
Zenit,6262,3,9,8,3,24,14,10,35
Terek Grozny,6262,4,9,5,6,24,24,0,32
Spart Moscow,6262,5,8,7,5,38,32,6,31
Krasnodar,6262,6,8,6,6,28,25,3,30
Din Moscow,6262,7,7,6,7,24,24,0,27
FK Rubin,6262,8,5,6,9,24,22,2,21
Rostov,6262,9,4,7,9,12,19,-7,19
Amkar,6262,10,4,5,11,12,26,-14,17
Anzhi,6262,11,2,5,13,15,41,-26,11
Loko Moscow,6263,1,11,6,3,30,13,17,39
CSKA Moscow,6263,2,12,3,5,28,18,10,39
Spart Moscow,6263,3,9,7,4,34,25,9,34
Krasnodar,6263,4,9,4,7,29,26,3,31
Zenit,6263,5,7,9,4,23,16,7,30
Terek Grozny,6263,6,8,5,7,23,23,0,29
Din Moscow,6263,7,6,7,7,19,21,-2,25
FK Rubin,6263,8,6,5,9,23,20,3,23
Amkar,6263,9,5,5,10,10,22,-12,20
Rostov,6263,10,4,6,10,10,18,-8,18
Anzhi,6263,11,2,5,13,14,41,-27,11
Loko Moscow,6264,1,11,5,4,30,14,16,38
CSKA Moscow,6264,2,11,4,5,28,18,10,37
Spart Moscow,6264,3,10,5,5,38,28,10,35
Zenit,6264,4,8,9,3,23,14,9,33
Krasnodar,6264,5,9,5,6,29,25,4,32
Terek Grozny,6264,6,7,6,7,22,27,-5,27
Din Moscow,6264,7,6,6,8,19,23,-4,24
FK Rubin,6264,8,5,6,9,21,18,3,21
Amkar,6264,9,5,5,10,12,24,-12,20
Rostov,6264,10,4,6,10,10,19,-9,18
Anzhi,6264,11,3,5,12,18,40,-22,14
Loko Moscow,6265,1,12,6,2,31,12,19,42
CSKA Moscow,6265,2,12,3,5,29,18,11,39
Spart Moscow,6265,3,10,6,4,37,27,10,36
Krasnodar,6265,4,9,5,6,30,26,4,32
Zenit,6265,5,7,8,5,22,16,6,29
Terek Grozny,6265,6,7,7,6,21,23,-2,28
Din Moscow,6265,7,5,7,8,21,26,-5,22
FK Rubin,6265,8,5,6,9,24,21,3,21
Rostov,6265,9,4,7,9,10,17,-7,19
Amkar,6265,10,4,5,11,10,24,-14,17
Anzhi,6265,11,2,6,12,14,39,-25,12
Loko Moscow,6266,1,11,6,3,29,13,16,39
CSKA Moscow,6266,2,11,3,6,29,21,8,36
Spart Moscow,6266,3,9,6,5,38,28,10,33
Zenit,6266,4,8,9,3,23,14,9,33
Krasnodar,6266,5,9,5,6,29,24,5,32
Din Moscow,6266,6,7,6,7,22,22,0,27
Terek Grozny,6266,7,7,6,7,21,24,-3,27
FK Rubin,6266,8,5,6,9,21,20,1,21
Amkar,6266,9,5,5,10,11,23,-12,20
Rostov,6266,10,4,6,10,10,20,-10,18
Anzhi,6266,11,2,6,12,17,41,-24,12
Loko Moscow,6267,1,12,6,2,31,12,19,42
CSKA Moscow,6267,2,12,3,5,29,17,12,39
Spart Moscow,6267,3,9,5,6,35,28,7,32
Zenit,6267,4,7,9,4,21,15,6,30
Krasnodar,6267,5,8,5,7,29,27,2,29
Terek Grozny,6267,6,7,7,6,23,25,-2,28
FK Rubin,6267,7,6,6,8,23,18,5,24
Din Moscow,6267,8,6,6,8,19,23,-4,24
Rostov,6267,9,5,6,9,11,17,-6,21
Amkar,6267,10,4,5,11,10,24,-14,17
Anzhi,6267,11,2,6,12,16,41,-25,12
Loko Moscow,6268,1,12,5,3,33,14,19,41
CSKA Moscow,6268,2,12,3,5,27,17,10,39
Spart Moscow,6268,3,10,6,4,38,26,12,36
Terek Grozny,6268,4,9,5,6,26,25,1,32
Krasnodar,6268,5,9,4,7,30,28,2,31
Zenit,6268,6,7,8,5,22,17,5,29
Din Moscow,6268,7,6,6,8,20,24,-4,24
FK Rubin,6268,8,6,5,9,24,20,4,23
Rostov,6268,9,4,6,10,10,19,-9,18
Amkar,6268,10,4,5,11,11,25,-14,17
Anzhi,6268,11,2,5,13,15,41,-26,11
Loko Moscow,6269,1,11,6,3,30,14,16,39
CSKA Moscow,6269,2,11,4,5,31,20,11,37
Spart Moscow,6269,3,10,6,4,38,27,11,36
Krasnodar,6269,4,10,4,6,30,24,6,34
Zenit,6269,5,7,10,3,24,16,8,31
Terek Grozny,6269,6,8,5,7,22,24,-2,29
Din Moscow,6269,7,6,6,8,20,23,-3,24
FK Rubin,6269,8,5,5,10,21,21,0,20
Rostov,6269,9,4,7,9,10,17,-7,19
Amkar,6269,10,4,4,12,12,27,-15,16
Anzhi,6269,11,3,5,12,16,41,-25,14
Loko Moscow,6270,1,13,5,2,32,11,21,44
Spart Moscow,6270,2,11,5,4,39,26,13,38
CSKA Moscow,6270,3,11,3,6,28,20,8,36
Zenit,6270,4,8,8,4,24,15,9,32
Terek Grozny,6270,5,8,5,7,21,23,-2,29
Krasnodar,6270,6,8,4,8,27,26,1,28
Din Moscow,6270,7,6,6,8,18,22,-4,24
FK Rubin,6270,8,6,5,9,22,18,4,23
Amkar,6270,9,5,4,11,10,25,-15,19
Rostov,6270,10,4,6,10,11,19,-8,18
Anzhi,6270,11,2,5,13,14,41,-27,11
Loko Moscow,6271,1,12,5,3,31,13,18,41
CSKA Moscow,6271,2,11,3,6,27,20,7,36
Krasnodar,6271,3,10,4,6,30,24,6,34
Zenit,6271,4,8,8,4,24,16,8,32
Spart Moscow,6271,5,8,7,5,36,30,6,31
Terek Grozny,6271,6,8,6,6,25,25,0,30
Din Moscow,6271,7,7,6,7,21,22,-1,27
FK Rubin,6271,8,5,5,10,21,19,2,20
Rostov,6271,9,4,7,9,11,18,-7,19
Amkar,6271,10,4,5,11,11,26,-15,17
Anzhi,6271,11,2,6,12,16,40,-24,12
Loko Moscow,6272,1,13,5,2,31,11,20,44
CSKA Moscow,6272,2,10,4,6,26,19,7,34
Spart Moscow,6272,3,8,8,4,34,26,8,32
Zenit,6272,4,8,8,4,22,14,8,32
Krasnodar,6272,5,8,4,8,27,26,1,28
Terek Grozny,6272,6,7,7,6,21,23,-2,28
FK Rubin,6272,7,6,6,8,23,18,5,24
Din Moscow,6272,8,5,8,7,18,22,-4,23
Rostov,6272,9,4,7,9,11,18,-7,19
Amkar,6272,10,4,6,10,9,22,-13,18
Anzhi,6272,11,2,7,11,16,39,-23,13
Loko Moscow,6273,1,12,5,3,31,14,17,41
CSKA Moscow,6273,2,11,3,6,30,21,9,36
Zenit,6273,3,9,8,3,27,14,13,35
Spart Moscow,6273,4,9,6,5,38,29,9,33
Krasnodar,6273,5,9,4,7,29,26,3,31
Terek Grozny,6273,6,8,5,7,23,23,0,29
Din Moscow,6273,7,6,7,7,19,22,-3,25
Amkar,6273,8,6,4,10,13,23,-10,22
FK Rubin,6273,9,5,5,10,21,19,2,20
Rostov,6273,10,4,6,10,10,20,-10,18
Anzhi,6273,11,2,5,13,14,44,-30,11
CSKA Moscow,6274,1,12,3,5,28,18,10,39
Loko Moscow,6274,2,11,5,4,29,14,15,38
Spart Moscow,6274,3,9,7,4,40,29,11,34
Zenit,6274,4,8,8,4,24,15,9,32
Krasnodar,6274,5,9,4,7,29,26,3,31
Terek Grozny,6274,6,7,6,7,21,24,-3,27
Din Moscow,6274,7,6,7,7,20,21,-1,25
FK Rubin,6274,8,6,5,9,23,21,2,23
Rostov,6274,9,4,6,10,11,21,-10,18
Amkar,6274,10,4,6,10,13,26,-13,18
Anzhi,6274,11,3,5,12,15,38,-23,14
Loko Moscow,6275,1,11,5,4,29,13,16,38
Spart Moscow,6275,2,10,6,4,39,26,13,36
Zenit,6275,3,9,8,3,26,14,12,35
Krasnodar,6275,4,10,4,6,30,25,5,34
CSKA Moscow,6275,5,10,4,6,26,21,5,34
Terek Grozny,6275,6,9,5,6,24,22,2,32
FK Rubin,6275,7,6,5,9,24,20,4,23
Din Moscow,6275,8,5,7,8,18,23,-5,22
Rostov,6275,9,4,6,10,10,21,-11,18
Amkar,6275,10,4,4,12,10,26,-16,16
Anzhi,6275,11,2,6,12,14,39,-25,12
Loko Moscow,6276,1,12,6,2,34,14,20,42
CSKA Moscow,6276,2,11,4,5,28,19,9,37
Spart Moscow,6276,3,9,6,5,36,28,8,33
Terek Grozny,6276,4,9,5,6,23,22,1,32
Krasnodar,6276,5,9,4,7,31,28,3,31
Zenit,6276,6,7,9,4,23,16,7,30
Din Moscow,6276,7,5,7,8,19,24,-5,22
FK Rubin,6276,8,5,6,9,23,21,2,21
Rostov,6276,9,4,7,9,11,18,-7,19
Amkar,6276,10,5,4,11,10,24,-14,19
Anzhi,6276,11,2,6,12,16,40,-24,12
Loko Moscow,6277,1,11,6,3,30,13,17,39
CSKA Moscow,6277,2,11,4,5,30,20,10,37
Spart Moscow,6277,3,10,6,4,39,29,10,36
Zenit,6277,4,8,9,3,23,14,9,33
Krasnodar,6277,5,9,5,6,31,27,4,32
Terek Grozny,6277,6,7,6,7,21,24,-3,27
Din Moscow,6277,7,5,7,8,19,24,-5,22
FK Rubin,6277,8,5,6,9,24,21,3,21
Amkar,6277,9,5,5,10,12,24,-12,20
Rostov,6277,10,4,6,10,11,19,-8,18
Anzhi,6277,11,2,6,12,17,42,-25,12
Loko Moscow,6278,1,11,7,2,31,13,18,40
Spart Moscow,6278,2,11,5,4,40,26,14,38
CSKA Moscow,6278,3,11,3,6,31,24,7,36
Zenit,6278,4,8,9,3,25,15,10,33
Krasnodar,6278,5,8,6,6,28,25,3,30
Terek Grozny,6278,6,7,6,7,22,25,-3,27
FK Rubin,6278,7,5,7,8,21,17,4,22
Din Moscow,6278,8,5,7,8,17,25,-8,22
Amkar,6278,9,5,4,11,12,25,-13,19
Rostov,6278,10,4,6,10,10,18,-8,18
Anzhi,6278,11,2,6,12,19,43,-24,12
Loko Moscow,6279,1,12,5,3,30,14,16,41
Spart Moscow,6279,2,10,6,4,39,28,11,36
CSKA Moscow,6279,3,11,3,6,28,21,7,36
Krasnodar,6279,4,10,4,6,34,25,9,34
Zenit,6279,5,8,8,4,24,15,9,32
Terek Grozny,6279,6,8,5,7,23,24,-1,29
Din Moscow,6279,7,5,7,8,17,23,-6,22
FK Rubin,6279,8,5,6,9,22,21,1,21
Rostov,6279,9,4,7,9,11,18,-7,19
Amkar,6279,10,5,4,11,12,25,-13,19
Anzhi,6279,11,2,5,13,16,42,-26,11
Loko Moscow,6280,1,11,6,3,30,13,17,39
CSKA Moscow,6280,2,10,4,6,26,21,5,34
Zenit,6280,3,8,9,3,25,14,11,33
Spart Moscow,6280,4,9,6,5,36,28,8,33
Krasnodar,6280,5,9,5,6,29,25,4,32
Terek Grozny,6280,6,7,5,8,20,27,-7,26
Din Moscow,6280,7,5,8,7,20,24,-4,23
FK Rubin,6280,8,5,7,8,24,20,4,22
Rostov,6280,9,5,6,9,12,18,-6,21
Amkar,6280,10,5,4,11,11,23,-12,19
Anzhi,6280,11,3,6,11,18,38,-20,15
Loko Moscow,6281,1,13,5,2,33,12,21,44
CSKA Moscow,6281,2,12,3,5,28,18,10,39
Spart Moscow,6281,3,10,6,4,42,28,14,36
Zenit,6281,4,7,8,5,22,17,5,29
Terek Grozny,6281,5,8,5,7,22,23,-1,29
Krasnodar,6281,6,8,4,8,28,28,0,28
FK Rubin,6281,7,7,5,8,25,17,8,26
Din Moscow,6281,8,5,7,8,17,23,-6,22
Rostov,6281,9,4,6,10,12,22,-10,18
Amkar,6281,10,4,4,12,10,28,-18,16
Anzhi,6281,11,3,5,12,15,38,-23,14
Loko Moscow,6282,1,11,6,3,29,12,17,39
CSKA Moscow,6282,2,12,3,5,31,19,12,39
Spart Moscow,6282,3,10,6,4,43,31,12,36
Krasnodar,6282,4,9,5,6,28,24,4,32
Zenit,6282,5,7,9,4,22,15,7,30
Terek Grozny,6282,6,7,6,7,21,24,-3,27
FK Rubin,6282,7,6,6,8,24,17,7,24
Din Moscow,6282,8,5,6,9,18,27,-9,21
Rostov,6282,9,4,6,10,12,21,-9,18
Amkar,6282,10,4,6,10,12,25,-13,18
Anzhi,6282,11,3,5,12,17,42,-25,14
Loko Moscow,6283,1,11,6,3,31,15,16,39
Spart Moscow,6283,2,11,5,4,40,26,14,38
CSKA Moscow,6283,3,11,3,6,29,19,10,36
Zenit,6283,4,8,9,3,23,14,9,33
Krasnodar,6283,5,9,4,7,31,29,2,31
Terek Grozny,6283,6,8,5,7,22,24,-2,29
FK Rubin,6283,7,7,5,8,26,18,8,26
Din Moscow,6283,8,5,6,9,17,23,-6,21
Amkar,6283,9,5,4,11,12,26,-14,19
Rostov,6283,10,4,6,10,10,20,-10,18
Anzhi,6283,11,2,5,13,15,42,-27,11
Loko Moscow,6284,1,12,6,2,31,12,19,42
CSKA Moscow,6284,2,11,4,5,29,20,9,37
Spart Moscow,6284,3,9,7,4,38,29,9,34
Terek Grozny,6284,4,9,5,6,24,22,2,32
Zenit,6284,5,7,10,3,24,16,8,31
Krasnodar,6284,6,9,4,7,30,27,3,31
FK Rubin,6284,7,6,5,9,23,19,4,23
Din Moscow,6284,8,5,7,8,18,23,-5,22
Rostov,6284,9,4,7,9,11,18,-7,19
Amkar,6284,10,4,4,12,11,26,-15,16
Anzhi,6284,11,2,5,13,14,41,-27,11
Loko Moscow,6285,1,12,5,3,31,14,17,41
CSKA Moscow,6285,2,11,4,5,28,18,10,37
Spart Moscow,6285,3,9,7,4,37,28,9,34
Zenit,6285,4,8,9,3,24,14,10,33
Terek Grozny,6285,5,8,6,6,24,25,-1,30
Krasnodar,6285,6,8,4,8,28,27,1,28
Din Moscow,6285,7,6,7,7,18,21,-3,25
FK Rubin,6285,8,6,5,9,22,18,4,23
Rostov,6285,9,4,6,10,11,19,-8,18
Amkar,6285,10,4,6,10,13,26,-13,18
Anzhi,6285,11,2,5,13,15,41,-26,11
Loko Moscow,6286,1,13,5,2,32,11,21,44
CSKA Moscow,6286,2,12,3,5,28,18,10,39
Spart Moscow,6286,3,11,5,4,38,25,13,38
Zenit,6286,4,7,8,5,21,16,5,29
Krasnodar,6286,5,8,5,7,27,25,2,29
Terek Grozny,6286,6,7,5,8,21,29,-8,26
FK Rubin,6286,7,5,7,8,22,18,4,22
Din Moscow,6286,8,5,7,8,18,23,-5,22
Amkar,6286,9,5,4,11,12,25,-13,19
Rostov,6286,10,4,6,10,10,19,-9,18
Anzhi,6286,11,3,5,12,19,39,-20,14
Loko Moscow,6287,1,11,6,3,29,12,17,39
Spart Moscow,6287,2,9,6,5,39,29,10,33
Zenit,6287,3,8,9,3,23,13,10,33
CSKA Moscow,6287,4,10,3,7,25,20,5,33
Krasnodar,6287,5,9,5,6,29,25,4,32
Terek Grozny,6287,6,7,5,8,20,25,-5,26
FK Rubin,6287,7,6,6,8,24,18,6,24
Amkar,6287,8,6,4,10,14,24,-10,22
Din Moscow,6287,9,5,6,9,18,27,-9,21
Rostov,6287,10,4,7,9,10,17,-7,19
Anzhi,6287,11,4,5,11,16,37,-21,17
Loko Moscow,6288,1,11,6,3,31,14,17,39
CSKA Moscow,6288,2,11,3,6,30,21,9,36
Zenit,6288,3,8,9,3,26,16,10,33
Spart Moscow,6288,4,8,7,5,35,30,5,31
Krasnodar,6288,5,9,4,7,30,27,3,31
Terek Grozny,6288,6,7,6,7,21,24,-3,27
FK Rubin,6288,7,6,6,8,24,19,5,24
Din Moscow,6288,8,5,8,7,19,23,-4,23
Rostov,6288,9,5,6,9,13,17,-4,21
Amkar,6288,10,4,6,10,11,24,-13,18
Anzhi,6288,11,3,5,12,15,40,-25,14
Loko Moscow,6289,1,11,6,3,30,15,15,39
Spart Moscow,6289,2,10,6,4,40,26,14,36
CSKA Moscow,6289,3,11,3,6,26,19,7,36
Zenit,6289,4,9,8,3,26,13,13,35
Krasnodar,6289,5,9,5,6,32,27,5,32
Terek Grozny,6289,6,9,5,6,24,24,0,32
Din Moscow,6289,7,6,6,8,19,26,-7,24
FK Rubin,6289,8,5,5,10,23,23,0,20
Rostov,6289,9,4,7,9,10,17,-7,19
Amkar,6289,10,4,4,12,12,27,-15,16
Anzhi,6289,11,2,5,13,14,39,-25,11
Loko Moscow,6290,1,11,6,3,30,15,15,39
Spart Moscow,6290,2,10,6,4,36,26,10,36
CSKA Moscow,6290,3,10,4,6,28,21,7,34
Zenit,6290,4,8,9,3,25,14,11,33
Krasnodar,6290,5,8,5,7,29,27,2,29
Terek Grozny,6290,6,8,5,7,22,24,-2,29
Din Moscow,6290,7,6,7,7,18,21,-3,25
FK Rubin,6290,8,6,5,9,23,19,4,23
Rostov,6290,9,4,6,10,11,19,-8,18
Anzhi,6290,10,4,5,11,19,40,-21,17
Amkar,6290,11,4,4,12,9,24,-15,16
Loko Moscow,6291,1,13,5,2,33,12,21,44
CSKA Moscow,6291,2,10,5,5,26,18,8,35
Spart Moscow,6291,3,9,7,4,39,30,9,34
Krasnodar,6291,4,9,4,7,31,29,2,31
Zenit,6291,5,7,9,4,21,14,7,30
Terek Grozny,6291,6,7,7,6,22,24,-2,28
Din Moscow,6291,7,6,7,7,23,24,-1,25
FK Rubin,6291,8,5,5,10,24,24,0,20
Rostov,6291,9,4,6,10,10,18,-8,18
Amkar,6291,10,4,6,10,13,26,-13,18
Anzhi,6291,11,2,7,11,16,39,-23,13
Loko Moscow,6292,1,12,5,3,32,14,18,41
CSKA Moscow,6292,2,11,4,5,29,18,11,37
Krasnodar,6292,3,10,4,6,33,26,7,34
Spart Moscow,6292,4,9,6,5,35,28,7,33
Zenit,6292,5,7,9,4,22,16,6,30
Terek Grozny,6292,6,8,6,6,25,23,2,30
FK Rubin,6292,7,6,5,9,23,20,3,23
Din Moscow,6292,8,5,6,9,18,24,-6,21
Rostov,6292,9,4,7,9,10,17,-7,19
Amkar,6292,10,5,4,11,11,26,-15,19
Anzhi,6292,11,2,6,12,15,41,-26,12
Loko Moscow,6293,1,12,5,3,32,13,19,41
Spart Moscow,6293,2,11,5,4,38,26,12,38
CSKA Moscow,6293,3,11,3,6,27,19,8,36
Zenit,6293,4,9,8,3,23,13,10,35
Krasnodar,6293,5,9,4,7,30,27,3,31
Terek Grozny,6293,6,7,6,7,20,25,-5,27
Din Moscow,6293,7,6,6,8,20,22,-2,24
FK Rubin,6293,8,5,5,10,21,22,-1,20
Rostov,6293,9,4,6,10,11,20,-9,18
Amkar,6293,10,4,5,11,9,23,-14,17
Anzhi,6293,11,3,5,12,18,39,-21,14
Loko Moscow,6294,1,12,6,2,31,12,19,42
CSKA Moscow,6294,2,10,4,6,26,20,6,34
Zenit,6294,3,8,8,4,24,15,9,32
Spart Moscow,6294,4,9,5,6,34,28,6,32
Krasnodar,6294,5,8,6,6,29,26,3,30
Din Moscow,6294,6,7,6,7,19,21,-2,27
Terek Grozny,6294,7,7,6,7,21,25,-4,27
FK Rubin,6294,8,5,6,9,22,19,3,21
Amkar,6294,9,5,5,10,12,23,-11,20
Rostov,6294,10,4,6,10,10,18,-8,18
Anzhi,6294,11,3,6,11,16,37,-21,15
Loko Moscow,6295,1,11,5,4,30,16,14,38
CSKA Moscow,6295,2,11,4,5,29,19,10,37
Spart Moscow,6295,3,10,6,4,38,27,11,36
Zenit,6295,4,8,9,3,24,15,9,33
Krasnodar,6295,5,9,4,7,30,26,4,31
Terek Grozny,6295,6,8,6,6,24,23,1,30
FK Rubin,6295,7,6,6,8,25,19,6,24
Din Moscow,6295,8,5,7,8,19,24,-5,22
Rostov,6295,9,4,7,9,11,18,-7,19
Amkar,6295,10,4,5,11,11,26,-15,17
Anzhi,6295,11,2,5,13,15,43,-28,11
Loko Moscow,6296,1,11,5,4,29,13,16,38
Zenit,6296,2,9,8,3,25,15,10,35
CSKA Moscow,6296,3,10,4,6,27,20,7,34
Krasnodar,6296,4,10,4,6,30,24,6,34
Spart Moscow,6296,5,9,6,5,37,29,8,33
Terek Grozny,6296,6,8,5,7,22,24,-2,29
FK Rubin,6296,7,6,5,9,22,19,3,23
Din Moscow,6296,8,5,7,8,18,23,-5,22
Amkar,6296,9,6,4,10,13,24,-11,22
Rostov,6296,10,4,6,10,11,19,-8,18
Anzhi,6296,11,2,6,12,14,38,-24,12
Loko Moscow,6297,1,12,5,3,33,13,20,41
CSKA Moscow,6297,2,11,4,5,31,18,13,37
Zenit,6297,3,8,9,3,24,15,9,33
Spart Moscow,6297,4,8,7,5,36,29,7,31
Krasnodar,6297,5,9,4,7,29,27,2,31
Terek Grozny,6297,6,7,6,7,20,24,-4,27
Din Moscow,6297,7,6,7,7,20,23,-3,25
FK Rubin,6297,8,5,6,9,22,20,2,21
Amkar,6297,9,5,5,10,12,23,-11,20
Rostov,6297,10,4,7,9,11,18,-7,19
Anzhi,6297,11,2,6,12,14,42,-28,12
Loko Moscow,6298,1,11,5,4,29,16,13,38
CSKA Moscow,6298,2,11,4,5,30,18,12,37
Spart Moscow,6298,3,10,5,5,36,27,9,35
Zenit,6298,4,8,9,3,23,14,9,33
Terek Grozny,6298,5,9,5,6,23,22,1,32
Krasnodar,6298,6,9,4,7,32,26,6,31
FK Rubin,6298,7,7,5,8,25,18,7,26
Din Moscow,6298,8,6,6,8,19,23,-4,24
Rostov,6298,9,4,6,10,10,18,-8,18
Amkar,6298,10,4,4,12,9,26,-17,16
Anzhi,6298,11,2,5,13,14,42,-28,11
Loko Moscow,6299,1,12,5,3,31,12,19,41
CSKA Moscow,6299,2,11,3,6,27,19,8,36
Zenit,6299,3,9,8,3,24,13,11,35
Spart Moscow,6299,4,9,5,6,35,31,4,32
Terek Grozny,6299,5,8,5,7,25,25,0,29
Krasnodar,6299,6,8,4,8,27,27,0,28
Din Moscow,6299,7,6,6,8,18,22,-4,24
FK Rubin,6299,8,6,5,9,22,18,4,23
Amkar,6299,9,6,4,10,13,22,-9,22
Rostov,6299,10,5,6,9,13,18,-5,21
Anzhi,6299,11,2,5,13,16,44,-28,11
Loko Moscow,6300,1,12,6,2,32,13,19,42
CSKA Moscow,6300,2,11,4,5,29,18,11,37
Spart Moscow,6300,3,9,5,6,34,27,7,32
Krasnodar,6300,4,9,5,6,31,26,5,32
Zenit,6300,5,7,9,4,22,15,7,30
Terek Grozny,6300,6,7,6,7,21,25,-4,27
FK Rubin,6300,7,6,5,9,23,20,3,23
Din Moscow,6300,8,5,6,9,18,24,-6,21
Rostov,6300,9,5,6,9,11,17,-6,21
Amkar,6300,10,5,5,10,11,23,-12,20
Anzhi,6300,11,3,5,12,16,40,-24,14
Loko Moscow,6301,1,11,6,3,32,17,15,39
Spart Moscow,6301,2,10,6,4,40,26,14,36
CSKA Moscow,6301,3,11,3,6,28,21,7,36
Zenit,6301,4,9,8,3,28,15,13,35
Krasnodar,6301,5,8,5,7,31,31,0,29
FK Rubin,6301,6,7,5,8,28,19,9,26
Terek Grozny,6301,7,7,5,8,21,25,-4,26
Din Moscow,6301,8,5,6,9,17,27,-10,21
Amkar,6301,9,5,5,10,11,23,-12,20
Rostov,6301,10,4,6,10,10,19,-9,18
Anzhi,6301,11,3,5,12,17,40,-23,14
Loko Moscow,6302,1,11,6,3,29,13,16,39
CSKA Moscow,6302,2,11,4,5,30,19,11,37
Zenit,6302,3,7,10,3,22,14,8,31
Krasnodar,6302,4,9,4,7,29,25,4,31
Spart Moscow,6302,5,8,6,6,37,32,5,30
Terek Grozny,6302,6,7,6,7,21,25,-4,27
Din Moscow,6302,7,6,7,7,20,23,-3,25
FK Rubin,6302,8,6,5,9,22,18,4,23
Rostov,6302,9,5,6,9,12,18,-6,21
Amkar,6302,10,5,5,10,13,24,-11,20
Anzhi,6302,11,3,5,12,17,41,-24,14
Loko Moscow,6303,1,12,5,3,31,19,12,41
Spart Moscow,6303,2,10,5,5,36,27,9,35
Krasnodar,6303,3,10,4,6,39,25,14,34
CSKA Moscow,6303,4,10,3,7,26,21,5,33
Zenit,6303,5,8,8,4,24,16,8,32
Terek Grozny,6303,6,7,6,7,20,24,-4,27
Din Moscow,6303,7,6,6,8,23,23,0,24
FK Rubin,6303,8,5,5,10,22,26,-4,20
Amkar,6303,9,5,5,10,10,22,-12,20
Rostov,6303,10,4,6,10,10,18,-8,18
Anzhi,6303,11,4,5,11,17,37,-20,17
Loko Moscow,6304,1,12,6,2,34,15,19,42
CSKA Moscow,6304,2,12,3,5,27,17,10,39
Spart Moscow,6304,3,9,5,6,40,34,6,32
Krasnodar,6304,4,9,5,6,31,26,5,32
Terek Grozny,6304,5,8,6,6,22,23,-1,30
Zenit,6304,6,7,8,5,23,17,6,29
Din Moscow,6304,7,6,6,8,22,24,-2,24
Rostov,6304,8,5,6,9,14,20,-6,21
FK Rubin,6304,9,5,5,10,21,22,-1,20
Amkar,6304,10,5,5,10,13,24,-11,20
Anzhi,6304,11,2,5,13,14,39,-25,11
Loko Moscow,6305,1,11,6,3,30,13,17,39
Zenit,6305,2,8,9,3,24,14,10,33
Spart Moscow,6305,3,9,6,5,38,29,9,33
CSKA Moscow,6305,4,10,3,7,25,20,5,33
Krasnodar,6305,5,9,5,6,29,25,4,32
Terek Grozny,6305,6,8,5,7,22,25,-3,29
Din Moscow,6305,7,6,6,8,18,23,-5,24
Amkar,6305,8,6,4,10,13,23,-10,22
FK Rubin,6305,9,5,6,9,22,19,3,21
Rostov,6305,10,4,7,9,12,19,-7,19
Anzhi,6305,11,3,5,12,16,39,-23,14
Loko Moscow,6306,1,12,6,2,30,11,19,42
CSKA Moscow,6306,2,11,4,5,27,18,9,37
Spart Moscow,6306,3,10,5,5,38,27,11,35
Zenit,6306,4,7,10,3,22,14,8,31
Krasnodar,6306,5,9,4,7,30,27,3,31
Terek Grozny,6306,6,8,6,6,22,22,0,30
Din Moscow,6306,7,6,6,8,19,23,-4,24
FK Rubin,6306,8,5,5,10,23,22,1,20
Amkar,6306,9,5,4,11,11,25,-14,19
Rostov,6306,10,4,6,10,10,19,-9,18
Anzhi,6306,11,2,6,12,14,38,-24,12
Loko Moscow,6307,1,12,6,2,31,12,19,42
CSKA Moscow,6307,2,11,3,6,27,18,9,36
Spart Moscow,6307,3,10,5,5,39,28,11,35
Zenit,6307,4,8,8,4,22,14,8,32
Krasnodar,6307,5,9,5,6,31,25,6,32
Terek Grozny,6307,6,7,6,7,22,26,-4,27
Din Moscow,6307,7,6,6,8,19,23,-4,24
FK Rubin,6307,8,6,5,9,22,20,2,23
Rostov,6307,9,4,6,10,10,19,-9,18
Amkar,6307,10,4,5,11,11,26,-15,17
Anzhi,6307,11,3,5,12,17,40,-23,14
Loko Moscow,6308,1,13,5,2,33,13,20,44
Spart Moscow,6308,2,10,6,4,37,27,10,36
CSKA Moscow,6308,3,10,5,5,26,18,8,35
Krasnodar,6308,4,9,4,7,29,26,3,31
Zenit,6308,5,7,9,4,22,15,7,30
Terek Grozny,6308,6,8,5,7,24,25,-1,29
FK Rubin,6308,7,6,5,9,24,19,5,23
Din Moscow,6308,8,5,7,8,19,25,-6,22
Rostov,6308,9,4,6,10,10,18,-8,18
Amkar,6308,10,4,4,12,10,27,-17,16
Anzhi,6308,11,3,6,11,18,39,-21,15
Loko Moscow,6309,1,12,5,3,33,18,15,41
Spart Moscow,6309,2,10,5,5,38,29,9,35
CSKA Moscow,6309,3,10,3,7,27,22,5,33
Zenit,6309,4,8,8,4,27,18,9,32
Krasnodar,6309,5,9,5,6,31,24,7,32
Terek Grozny,6309,6,7,7,6,21,23,-2,28
Din Moscow,6309,7,6,6,8,19,23,-4,24
FK Rubin,6309,8,5,6,9,21,18,3,21
Amkar,6309,9,5,5,10,12,23,-11,20
Rostov,6309,10,4,6,10,10,19,-9,18
Anzhi,6309,11,3,6,11,17,39,-22,15
Loko Moscow,6310,1,12,6,2,32,12,20,42
Spart Moscow,6310,2,9,6,5,38,28,10,33
CSKA Moscow,6310,3,10,3,7,28,23,5,33
Zenit,6310,4,8,8,4,24,16,8,32
Terek Grozny,6310,5,8,6,6,23,24,-1,30
Krasnodar,6310,6,8,5,7,30,28,2,29
FK Rubin,6310,7,7,5,8,25,19,6,26
Din Moscow,6310,8,6,6,8,19,23,-4,24
Rostov,6310,9,4,7,9,10,17,-7,19
Amkar,6310,10,4,4,12,10,27,-17,16
Anzhi,6310,11,3,6,11,19,41,-22,15
Loko Moscow,6311,1,13,5,2,32,11,21,44
CSKA Moscow,6311,2,11,3,6,26,18,8,36
Spart Moscow,6311,3,10,5,5,38,30,8,35
Krasnodar,6311,4,9,4,7,29,25,4,31
Zenit,6311,5,7,8,5,21,16,5,29
Din Moscow,6311,6,7,6,7,21,21,0,27
Terek Grozny,6311,7,7,6,7,20,23,-3,27
FK Rubin,6311,8,5,5,10,21,20,1,20
Amkar,6311,9,5,4,11,11,24,-13,19
Rostov,6311,10,4,6,10,11,20,-9,18
Anzhi,6311,11,3,6,11,15,37,-22,15
Loko Moscow,6312,1,12,5,3,33,14,19,41
CSKA Moscow,6312,2,11,4,5,28,19,9,37
Spart Moscow,6312,3,10,5,5,38,28,10,35
Zenit,6312,4,8,9,3,23,14,9,33
Krasnodar,6312,5,9,4,7,31,28,3,31
Din Moscow,6312,6,7,6,7,22,22,0,27
Terek Grozny,6312,7,7,6,7,21,25,-4,27
FK Rubin,6312,8,5,5,10,22,22,0,20
Amkar,6312,9,5,4,11,13,26,-13,19
Rostov,6312,10,4,6,10,10,19,-9,18
Anzhi,6312,11,2,6,12,15,39,-24,12
Loko Moscow,6313,1,12,6,2,31,12,19,42
CSKA Moscow,6313,2,10,5,5,26,18,8,35
Spart Moscow,6313,3,9,6,5,34,26,8,33
Zenit,6313,4,7,9,4,21,14,7,30
Krasnodar,6313,5,8,6,6,30,27,3,30
Terek Grozny,6313,6,7,5,8,22,27,-5,26
FK Rubin,6313,7,6,6,8,26,20,6,24
Amkar,6313,8,6,4,10,13,24,-11,22
Din Moscow,6313,9,5,6,9,18,25,-7,21
Rostov,6313,10,4,7,9,10,17,-7,19
Anzhi,6313,11,3,6,11,17,38,-21,15
Loko Moscow,6314,1,12,5,3,31,15,16,41
CSKA Moscow,6314,2,11,3,6,27,18,9,36
Zenit,6314,3,9,8,3,25,13,12,35
Spart Moscow,6314,4,9,5,6,35,28,7,32
Krasnodar,6314,5,9,4,7,30,27,3,31
Din Moscow,6314,6,7,6,7,20,21,-1,27
Terek Grozny,6314,7,7,6,7,23,27,-4,27
Amkar,6314,8,6,4,10,13,23,-10,22
FK Rubin,6314,9,5,5,10,22,21,1,20
Rostov,6314,10,4,6,10,11,19,-8,18
Anzhi,6314,11,2,6,12,16,41,-25,12
Loko Moscow,6315,1,12,6,2,32,12,20,42
CSKA Moscow,6315,2,12,3,5,30,17,13,39
Terek Grozny,6315,3,9,5,6,24,23,1,32
Zenit,6315,4,7,9,4,22,15,7,30
Spart Moscow,6315,5,8,5,7,37,33,4,29
Krasnodar,6315,6,8,5,7,28,27,1,29
Din Moscow,6315,7,6,7,7,22,24,-2,25
FK Rubin,6315,8,5,7,8,23,19,4,22
Rostov,6315,9,5,6,9,12,18,-6,21
Amkar,6315,10,5,4,11,11,24,-13,19
Anzhi,6315,11,2,5,13,15,44,-29,11
Loko Moscow,6316,1,11,6,3,30,15,15,39
CSKA Moscow,6316,2,11,4,5,27,18,9,37
Spart Moscow,6316,3,9,7,4,34,25,9,34
Krasnodar,6316,4,9,5,6,31,25,6,32
Zenit,6316,5,7,10,3,23,15,8,31
Terek Grozny,6316,6,7,6,7,20,24,-4,27
Din Moscow,6316,7,6,7,7,19,22,-3,25
FK Rubin,6316,8,5,6,9,23,20,3,21
Rostov,6316,9,4,7,9,10,17,-7,19
Amkar,6316,10,4,5,11,9,23,-14,17
Anzhi,6316,11,3,5,12,16,38,-22,14
Loko Moscow,6317,1,11,7,2,30,12,18,40
CSKA Moscow,6317,2,10,4,6,27,20,7,34
Zenit,6317,3,8,9,3,23,14,9,33
Spart Moscow,6317,4,8,7,5,36,30,6,31
Krasnodar,6317,5,8,6,6,29,26,3,30
Terek Grozny,6317,6,8,5,7,23,24,-1,29
Din Moscow,6317,7,5,8,7,18,22,-4,23
FK Rubin,6317,8,5,7,8,23,19,4,22
Rostov,6317,9,5,6,9,13,18,-5,21
Amkar,6317,10,5,5,10,12,24,-12,20
Anzhi,6317,11,2,6,12,16,41,-25,12
Loko Moscow,6318,1,12,6,2,31,12,19,42
CSKA Moscow,6318,2,11,3,6,29,19,10,36
Spart Moscow,6318,3,10,5,5,39,28,11,35
Zenit,6318,4,8,9,3,24,14,10,33
Krasnodar,6318,5,9,4,7,30,26,4,31
Terek Grozny,6318,6,7,6,7,21,25,-4,27
Din Moscow,6318,7,6,6,8,18,22,-4,24
FK Rubin,6318,8,5,5,10,22,21,1,20
Amkar,6318,9,5,5,10,13,25,-12,20
Rostov,6318,10,4,6,10,10,20,-10,18
Anzhi,6318,11,3,5,12,16,41,-25,14
Loko Moscow,6319,1,11,5,4,29,15,14,38
CSKA Moscow,6319,2,10,5,5,25,17,8,35
Krasnodar,6319,3,10,4,6,31,24,7,34
Spart Moscow,6319,4,9,6,5,37,27,10,33
Zenit,6319,5,8,9,3,22,13,9,33
Terek Grozny,6319,6,8,6,6,23,24,-1,30
Din Moscow,6319,7,6,6,8,20,24,-4,24
FK Rubin,6319,8,6,5,9,23,19,4,23
Rostov,6319,9,4,6,10,10,20,-10,18
Amkar,6319,10,4,6,10,10,23,-13,18
Anzhi,6319,11,2,6,12,15,39,-24,12
Loko Moscow,6320,1,12,6,2,30,11,19,42
CSKA Moscow,6320,2,11,4,5,28,19,9,37
Spart Moscow,6320,3,9,6,5,39,31,8,33
Krasnodar,6320,4,9,4,7,28,25,3,31
Zenit,6320,5,7,9,4,21,14,7,30
Terek Grozny,6320,6,7,5,8,23,28,-5,26
Din Moscow,6320,7,6,7,7,21,23,-2,25
Amkar,6320,8,6,4,10,15,25,-10,22
FK Rubin,6320,9,5,5,10,21,20,1,20
Rostov,6320,10,4,6,10,12,20,-8,18
Anzhi,6320,11,3,6,11,18,40,-22,15
Loko Moscow,6321,1,12,6,2,35,13,22,42
CSKA Moscow,6321,2,11,3,6,29,22,7,36
Krasnodar,6321,3,9,5,6,33,26,7,32
Zenit,6321,4,8,8,4,26,19,7,32
Spart Moscow,6321,5,8,6,6,36,30,6,30
Din Moscow,6321,6,7,6,7,22,22,0,27
Terek Grozny,6321,7,7,5,8,21,25,-4,26
Amkar,6321,8,6,4,10,11,22,-11,22
FK Rubin,6321,9,5,5,10,21,24,-3,20
Rostov,6321,10,4,7,9,12,19,-7,19
Anzhi,6321,11,3,5,12,16,40,-24,14
Loko Moscow,6322,1,11,7,2,31,13,18,40
Spart Moscow,6322,2,11,5,4,40,27,13,38
CSKA Moscow,6322,3,10,4,6,29,22,7,34
Zenit,6322,4,8,9,3,25,16,9,33
Krasnodar,6322,5,9,5,6,30,25,5,32
Terek Grozny,6322,6,8,5,7,22,25,-3,29
Din Moscow,6322,7,6,6,8,20,23,-3,24
FK Rubin,6322,8,5,5,10,21,21,0,20
Amkar,6322,9,5,4,11,13,27,-14,19
Rostov,6322,10,4,6,10,10,18,-8,18
Anzhi,6322,11,2,6,12,16,40,-24,12
Loko Moscow,6323,1,11,7,2,32,14,18,40
Spart Moscow,6323,2,9,7,4,36,26,10,34
CSKA Moscow,6323,3,10,4,6,26,20,6,34
Zenit,6323,4,8,9,3,24,14,10,33
Krasnodar,6323,5,9,5,6,31,26,5,32
Terek Grozny,6323,6,8,6,6,22,22,0,30
FK Rubin,6323,7,6,5,9,23,19,4,23
Din Moscow,6323,8,5,6,9,17,25,-8,21
Rostov,6323,9,4,7,9,11,18,-7,19
Amkar,6323,10,4,5,11,9,24,-15,17
Anzhi,6323,11,2,7,11,15,38,-23,13
Loko Moscow,6324,1,11,6,3,29,14,15,39
CSKA Moscow,6324,2,10,5,5,27,19,8,35
Krasnodar,6324,3,10,4,6,32,24,8,34
Spart Moscow,6324,4,9,6,5,37,26,11,33
Terek Grozny,6324,5,9,5,6,22,22,0,32
Zenit,6324,6,7,10,3,22,14,8,31
Din Moscow,6324,7,5,7,8,18,26,-8,22
FK Rubin,6324,8,5,6,9,22,20,2,21
Rostov,6324,9,5,6,9,11,17,-6,21
Amkar,6324,10,4,5,11,9,23,-14,17
Anzhi,6324,11,2,6,12,15,39,-24,12
Loko Moscow,6325,1,12,5,3,31,13,18,41
CSKA Moscow,6325,2,11,4,5,28,19,9,37
Krasnodar,6325,3,10,4,6,32,26,6,34
Spart Moscow,6325,4,9,5,6,36,30,6,32
Zenit,6325,5,7,9,4,22,15,7,30
Terek Grozny,6325,6,8,6,6,23,24,-1,30
FK Rubin,6325,7,6,5,9,23,20,3,23
Din Moscow,6325,8,5,6,9,18,24,-6,21
Rostov,6325,9,5,6,9,11,17,-6,21
Amkar,6325,10,5,5,10,14,25,-11,20
Anzhi,6325,11,2,5,13,15,40,-25,11
Loko Moscow,6326,1,12,6,2,31,12,19,42
Spart Moscow,6326,2,10,6,4,41,26,15,36
CSKA Moscow,6326,3,10,5,5,26,18,8,35
Krasnodar,6326,4,9,5,6,29,25,4,32
Terek Grozny,6326,5,9,5,6,23,22,1,32
Zenit,6326,6,7,9,4,21,14,7,30
Din Moscow,6326,7,5,7,8,18,26,-8,22
FK Rubin,6326,8,5,6,9,22,19,3,21
Rostov,6326,9,4,6,10,10,20,-10,18
Amkar,6326,10,4,5,11,10,25,-15,17
Anzhi,6326,11,2,6,12,15,39,-24,12
Loko Moscow,6327,1,11,6,3,30,13,17,39
Spart Moscow,6327,2,11,5,4,42,28,14,38
Zenit,6327,3,9,8,3,23,13,10,35
CSKA Moscow,6327,4,10,3,7,26,20,6,33
Krasnodar,6327,5,9,5,6,31,26,5,32
Terek Grozny,6327,6,8,6,6,23,24,-1,30
FK Rubin,6327,7,6,5,9,24,20,4,23
Din Moscow,6327,8,5,6,9,17,24,-7,21
Rostov,6327,9,4,6,10,10,19,-9,18
Amkar,6327,10,4,5,11,14,30,-16,17
Anzhi,6327,11,3,5,12,16,39,-23,14
Loko Moscow,6328,1,12,6,2,33,14,19,42
Spart Moscow,6328,2,10,5,5,39,28,11,35
CSKA Moscow,6328,3,10,5,5,27,19,8,35
Zenit,6328,4,7,9,4,22,15,7,30
Krasnodar,6328,5,8,6,6,30,27,3,30
Terek Grozny,6328,6,8,6,6,22,23,-1,30
FK Rubin,6328,7,5,7,8,23,19,4,22
Din Moscow,6328,8,5,7,8,19,27,-8,22
Amkar,6328,9,5,5,10,11,22,-11,20
Rostov,6328,10,4,6,10,10,18,-8,18
Anzhi,6328,11,2,6,12,17,41,-24,12
Loko Moscow,6329,1,13,5,2,35,13,22,44
CSKA Moscow,6329,2,11,3,6,29,20,9,36
Zenit,6329,3,8,8,4,24,16,8,32
Spart Moscow,6329,4,9,5,6,38,31,7,32
Terek Grozny,6329,5,9,5,6,24,23,1,32
Krasnodar,6329,6,9,4,7,31,28,3,31
Din Moscow,6329,7,7,6,7,21,22,-1,27
FK Rubin,6329,8,5,5,10,21,21,0,20
Amkar,6329,9,5,4,11,12,25,-13,19
Rostov,6329,10,4,6,10,11,20,-9,18
Anzhi,6329,11,2,5,13,15,42,-27,11
Loko Moscow,6330,1,11,5,4,30,14,16,38
CSKA Moscow,6330,2,11,3,6,28,19,9,36
Spart Moscow,6330,3,10,5,5,43,30,13,35
Zenit,6330,4,9,8,3,25,15,10,35
Krasnodar,6330,5,10,4,6,31,24,7,34
Terek Grozny,6330,6,7,7,6,23,25,-2,28
Din Moscow,6330,7,5,7,8,17,27,-10,22
FK Rubin,6330,8,5,6,9,21,20,1,21
Amkar,6330,9,5,5,10,14,25,-11,20
Rostov,6330,10,4,6,10,11,19,-8,18
Anzhi,6330,11,2,6,12,16,41,-25,12
Loko Moscow,6331,1,12,5,3,32,13,19,41
CSKA Moscow,6331,2,11,3,6,27,19,8,36
Spart Moscow,6331,3,9,7,4,37,27,10,34
Krasnodar,6331,4,10,4,6,31,25,6,34
Terek Grozny,6331,5,8,6,6,23,22,1,30
Zenit,6331,6,7,8,5,21,18,3,29
FK Rubin,6331,7,6,5,9,25,20,5,23
Din Moscow,6331,8,5,7,8,18,24,-6,22
Rostov,6331,9,4,7,9,11,18,-7,19
Amkar,6331,10,4,5,11,10,25,-15,17
Anzhi,6331,11,3,5,12,16,40,-24,14
Loko Moscow,6332,1,13,5,2,32,11,21,44
Spart Moscow,6332,2,10,5,5,38,28,10,35
CSKA Moscow,6332,3,10,3,7,26,20,6,33
Zenit,6332,4,8,8,4,22,15,7,32
Krasnodar,6332,5,9,4,7,31,25,6,31
Terek Grozny,6332,6,7,6,7,22,25,-3,27
FK Rubin,6332,7,6,5,9,23,22,1,23
Din Moscow,6332,8,5,6,9,19,26,-7,21
Amkar,6332,9,5,5,10,13,25,-12,20
Rostov,6332,10,4,6,10,10,18,-8,18
Anzhi,6332,11,4,5,11,17,38,-21,17
Loko Moscow,6333,1,12,6,2,31,12,19,42
CSKA Moscow,6333,2,11,3,6,30,21,9,36
Spart Moscow,6333,3,10,5,5,37,27,10,35
Zenit,6333,4,8,8,4,25,16,9,32
Krasnodar,6333,5,8,5,7,28,27,1,29
Terek Grozny,6333,6,8,5,7,22,24,-2,29
Din Moscow,6333,7,6,6,8,19,23,-4,24
FK Rubin,6333,8,6,5,9,24,19,5,23
Amkar,6333,9,6,4,10,11,22,-11,22
Rostov,6333,10,4,6,10,11,20,-9,18
Anzhi,6333,11,2,5,13,15,42,-27,11
Loko Moscow,6334,1,12,5,3,31,12,19,41
Spart Moscow,6334,2,10,6,4,39,27,12,36
CSKA Moscow,6334,3,11,3,6,28,21,7,36
Zenit,6334,4,9,8,3,26,14,12,35
Terek Grozny,6334,5,9,5,6,24,23,1,32
Krasnodar,6334,6,8,4,8,27,27,0,28
Din Moscow,6334,7,6,6,8,20,24,-4,24
FK Rubin,6334,8,6,5,9,22,18,4,23
Rostov,6334,9,4,7,9,10,17,-7,19
Amkar,6334,10,4,4,12,9,27,-18,16
Anzhi,6334,11,2,5,13,15,41,-26,11
Loko Moscow,6335,1,12,6,2,32,12,20,42
Spart Moscow,6335,2,11,5,4,41,26,15,38
CSKA Moscow,6335,3,10,4,6,25,19,6,34
Zenit,6335,4,8,9,3,24,14,10,33
Krasnodar,6335,5,8,4,8,29,30,-1,28
Terek Grozny,6335,6,7,7,6,23,25,-2,28
Din Moscow,6335,7,6,6,8,20,24,-4,24
FK Rubin,6335,8,6,5,9,26,21,5,23
Rostov,6335,9,4,6,10,10,20,-10,18
Amkar,6335,10,4,5,11,11,27,-16,17
Anzhi,6335,11,2,7,11,15,38,-23,13
Loko Moscow,6336,1,13,5,2,34,12,22,44
CSKA Moscow,6336,2,12,3,5,31,20,11,39
Spart Moscow,6336,3,9,6,5,36,29,7,33
Krasnodar,6336,4,9,4,7,28,27,1,31
Zenit,6336,5,7,8,5,23,18,5,29
Terek Grozny,6336,6,8,5,7,21,23,-2,29
Din Moscow,6336,7,5,7,8,18,23,-5,22
FK Rubin,6336,8,5,6,9,21,18,3,21
Rostov,6336,9,4,7,9,11,18,-7,19
Amkar,6336,10,5,4,11,11,23,-12,19
Anzhi,6336,11,3,5,12,17,40,-23,14
Loko Moscow,6337,1,12,5,3,32,14,18,41
CSKA Moscow,6337,2,11,3,6,28,19,9,36
Zenit,6337,3,9,8,3,25,14,11,35
Spart Moscow,6337,4,9,6,5,38,30,8,33
Krasnodar,6337,5,8,4,8,28,28,0,28
Terek Grozny,6337,6,7,6,7,21,25,-4,27
Din Moscow,6337,7,6,6,8,20,23,-3,24
FK Rubin,6337,8,6,5,9,23,21,2,23
Amkar,6337,9,5,5,10,13,24,-11,20
Rostov,6337,10,4,7,9,12,19,-7,19
Anzhi,6337,11,3,5,12,17,40,-23,14
Loko Moscow,6338,1,11,6,3,31,14,17,39
CSKA Moscow,6338,2,12,3,5,31,19,12,39
Spart Moscow,6338,3,10,6,4,40,26,14,36
Krasnodar,6338,4,10,4,6,31,26,5,34
Terek Grozny,6338,5,9,5,6,25,22,3,32
Zenit,6338,6,7,9,4,22,15,7,30
Din Moscow,6338,7,6,6,8,19,24,-5,24
FK Rubin,6338,8,5,5,10,21,20,1,20
Rostov,6338,9,4,6,10,10,20,-10,18
Amkar,6338,10,4,5,11,10,27,-17,17
Anzhi,6338,11,2,5,13,15,42,-27,11
Loko Moscow,6339,1,12,6,2,33,14,19,42
Spart Moscow,6339,2,11,5,4,40,27,13,38
CSKA Moscow,6339,3,11,3,6,27,21,6,36
Zenit,6339,4,8,8,4,25,15,10,32
Krasnodar,6339,5,8,6,6,29,26,3,30
Terek Grozny,6339,6,8,6,6,24,23,1,30
FK Rubin,6339,7,5,7,8,22,18,4,22
Din Moscow,6339,8,5,7,8,19,24,-5,22
Rostov,6339,9,4,6,10,10,19,-9,18
Amkar,6339,10,4,5,11,11,26,-15,17
Anzhi,6339,11,2,5,13,15,42,-27,11
Loko Moscow,6340,1,13,5,2,31,11,20,44
CSKA Moscow,6340,2,11,3,6,27,18,9,36
Spart Moscow,6340,3,9,5,6,38,28,10,32
Zenit,6340,4,8,8,4,22,14,8,32
Krasnodar,6340,5,9,4,7,29,25,4,31
Din Moscow,6340,6,7,6,7,20,21,-1,27
Terek Grozny,6340,7,7,6,7,20,23,-3,27
FK Rubin,6340,8,5,5,10,21,20,1,20
Amkar,6340,9,5,5,10,10,22,-12,20
Rostov,6340,10,4,6,10,10,22,-12,18
Anzhi,6340,11,3,5,12,15,39,-24,14
Loko Moscow,6341,1,11,7,2,33,15,18,40
CSKA Moscow,6341,2,11,3,6,30,20,10,36
Zenit,6341,3,8,9,3,24,15,9,33
Spart Moscow,6341,4,9,5,6,36,29,7,32
Krasnodar,6341,5,8,5,7,30,30,0,29
Terek Grozny,6341,6,7,7,6,22,24,-2,28
Din Moscow,6341,7,7,6,7,20,21,-1,27
FK Rubin,6341,8,6,5,9,24,18,6,23
Rostov,6341,9,5,6,9,12,17,-5,21
Amkar,6341,10,4,5,11,10,26,-16,17
Anzhi,6341,11,2,6,12,16,42,-26,12
Loko Moscow,6342,1,11,5,4,30,17,13,38
Spart Moscow,6342,2,10,6,4,38,27,11,36
Zenit,6342,3,9,8,3,25,14,11,35
CSKA Moscow,6342,4,10,4,6,25,18,7,34
Krasnodar,6342,5,9,5,6,30,24,6,32
Terek Grozny,6342,6,8,6,6,26,25,1,30
Din Moscow,6342,7,6,7,7,19,22,-3,25
FK Rubin,6342,8,5,6,9,22,19,3,21
Rostov,6342,9,4,6,10,10,19,-9,18
Amkar,6342,10,4,5,11,12,26,-14,17
Anzhi,6342,11,2,6,12,16,42,-26,12
Loko Moscow,6343,1,11,6,3,33,18,15,39
Spart Moscow,6343,2,11,5,4,43,25,18,38
CSKA Moscow,6343,3,11,3,6,27,19,8,36
Zenit,6343,4,8,9,3,25,15,10,33
Krasnodar,6343,5,9,5,6,33,27,6,32
Terek Grozny,6343,6,8,6,6,23,24,-1,30
FK Rubin,6343,7,5,7,8,22,18,4,22
Din Moscow,6343,8,5,7,8,17,26,-9,22
Rostov,6343,9,4,6,10,10,19,-9,18
Amkar,6343,10,4,5,11,11,27,-16,17
Anzhi,6343,11,2,5,13,14,40,-26,11
Loko Moscow,6344,1,12,5,3,32,16,16,41
Spart Moscow,6344,2,10,5,5,41,27,14,35
Krasnodar,6344,3,10,4,6,32,25,7,34
CSKA Moscow,6344,4,10,4,6,27,20,7,34
Zenit,6344,5,7,9,4,24,17,7,30
Terek Grozny,6344,6,8,6,6,24,25,-1,30
Din Moscow,6344,7,5,7,8,20,27,-7,22
FK Rubin,6344,8,5,6,9,23,20,3,21
Amkar,6344,9,5,5,10,12,24,-12,20
Rostov,6344,10,4,6,10,10,21,-11,18
Anzhi,6344,11,3,5,12,16,39,-23,14
Loko Moscow,6345,1,13,5,2,33,12,21,44
Spart Moscow,6345,2,10,6,4,41,29,12,36
CSKA Moscow,6345,3,11,3,6,29,20,9,36
Zenit,6345,4,8,8,4,25,16,9,32
Krasnodar,6345,5,8,5,7,27,26,1,29
Terek Grozny,6345,6,8,5,7,22,24,-2,29
FK Rubin,6345,7,5,7,8,21,17,4,22
Din Moscow,6345,8,5,7,8,17,24,-7,22
Rostov,6345,9,4,6,10,11,19,-8,18
Amkar,6345,10,4,5,11,13,27,-14,17
Anzhi,6345,11,3,5,12,15,40,-25,14
Loko Moscow,6346,1,11,6,3,31,15,16,39
Spart Moscow,6346,2,10,6,4,41,28,13,36
CSKA Moscow,6346,3,11,3,6,30,19,11,36
Krasnodar,6346,4,10,4,6,33,27,6,34
Zenit,6346,5,8,9,3,23,14,9,33
Terek Grozny,6346,6,7,6,7,20,23,-3,27
Din Moscow,6346,7,6,7,7,22,24,-2,25
FK Rubin,6346,8,5,5,10,23,22,1,20
Rostov,6346,9,4,6,10,11,19,-8,18
Amkar,6346,10,4,5,11,9,26,-17,17
Anzhi,6346,11,3,5,12,15,41,-26,14
Loko Moscow,6347,1,11,6,3,30,14,16,39
CSKA Moscow,6347,2,11,4,5,28,19,9,37
Spart Moscow,6347,3,10,5,5,37,29,8,35
Krasnodar,6347,4,10,4,6,33,26,7,34
Zenit,6347,5,7,9,4,21,14,7,30
Terek Grozny,6347,6,7,5,8,22,27,-5,26
FK Rubin,6347,7,6,5,9,24,21,3,23
Amkar,6347,8,6,4,10,13,22,-9,22
Din Moscow,6347,9,5,6,9,18,24,-6,21
Rostov,6347,10,4,6,10,12,20,-8,18
Anzhi,6347,11,3,6,11,19,41,-22,15
Loko Moscow,6348,1,12,6,2,31,11,20,42
CSKA Moscow,6348,2,11,4,5,30,19,11,37
Spart Moscow,6348,3,10,5,5,38,27,11,35
Zenit,6348,4,7,9,4,23,17,6,30
Krasnodar,6348,5,8,6,6,28,25,3,30
Terek Grozny,6348,6,8,6,6,21,22,-1,30
FK Rubin,6348,7,5,7,8,23,19,4,22
Din Moscow,6348,8,5,7,8,18,26,-8,22
Amkar,6348,9,5,5,10,11,22,-11,20
Rostov,6348,10,4,6,10,10,18,-8,18
Anzhi,6348,11,2,5,13,14,41,-27,11
Loko Moscow,6349,1,11,7,2,30,12,18,40
CSKA Moscow,6349,2,12,3,5,27,17,10,39
Spart Moscow,6349,3,10,5,5,42,26,16,35
Zenit,6349,4,7,9,4,22,15,7,30
Krasnodar,6349,5,8,6,6,28,25,3,30
Terek Grozny,6349,6,8,5,7,22,24,-2,29
Din Moscow,6349,7,6,6,8,19,25,-6,24
Amkar,6349,8,6,4,10,12,23,-11,22
FK Rubin,6349,9,5,6,9,22,20,2,21
Rostov,6349,10,4,6,10,10,22,-12,18
Anzhi,6349,11,2,5,13,14,39,-25,11
Loko Moscow,6350,1,12,5,3,31,15,16,41
CSKA Moscow,6350,2,11,3,6,27,19,8,36
Krasnodar,6350,3,10,4,6,32,24,8,34
Spart Moscow,6350,4,8,6,6,34,31,3,30
Zenit,6350,5,7,8,5,23,17,6,29
Terek Grozny,6350,6,7,6,7,20,26,-6,27
Din Moscow,6350,7,6,6,8,21,24,-3,24
FK Rubin,6350,8,6,5,9,24,21,3,23
Rostov,6350,9,5,6,9,14,18,-4,21
Amkar,6350,10,4,6,10,9,22,-13,18
Anzhi,6350,11,4,5,11,19,37,-18,17
Loko Moscow,6351,1,12,6,2,32,13,19,42
CSKA Moscow,6351,2,11,3,6,28,19,9,36
Spart Moscow,6351,3,10,5,5,38,30,8,35
Zenit,6351,4,8,8,4,24,16,8,32
Krasnodar,6351,5,9,5,6,31,26,5,32
Terek Grozny,6351,6,8,6,6,23,22,1,30
FK Rubin,6351,7,6,5,9,24,21,3,23
Rostov,6351,8,5,6,9,14,18,-4,21
Din Moscow,6351,9,5,6,9,19,25,-6,21
Amkar,6351,10,4,4,12,9,27,-18,16
Anzhi,6351,11,2,6,12,14,39,-25,12
Loko Moscow,6352,1,12,6,2,32,12,20,42
Spart Moscow,6352,2,10,6,4,38,28,10,36
CSKA Moscow,6352,3,10,4,6,27,20,7,34
Zenit,6352,4,8,9,3,24,15,9,33
Terek Grozny,6352,5,8,6,6,23,23,0,30
Krasnodar,6352,6,8,4,8,29,29,0,28
Din Moscow,6352,7,6,6,8,18,22,-4,24
FK Rubin,6352,8,6,5,9,24,20,4,23
Rostov,6352,9,4,7,9,12,19,-7,19
Amkar,6352,10,4,4,12,10,26,-16,16
Anzhi,6352,11,2,7,11,16,39,-23,13
Loko Moscow,6353,1,13,5,2,32,12,20,44
Spart Moscow,6353,2,10,5,5,37,29,8,35
CSKA Moscow,6353,3,10,4,6,27,20,7,34
Zenit,6353,4,8,8,4,23,15,8,32
Krasnodar,6353,5,9,4,7,30,26,4,31
Terek Grozny,6353,6,8,5,7,23,26,-3,29
Din Moscow,6353,7,6,7,7,20,22,-2,25
FK Rubin,6353,8,5,6,9,22,20,2,21
Amkar,6353,9,5,4,11,14,25,-11,19
Rostov,6353,10,4,6,10,11,19,-8,18
Anzhi,6353,11,2,6,12,15,40,-25,12
Loko Moscow,6354,1,12,6,2,31,12,19,42
CSKA Moscow,6354,2,11,3,6,30,21,9,36
Spart Moscow,6354,3,9,6,5,39,29,10,33
Zenit,6354,4,7,9,4,23,17,6,30
Krasnodar,6354,5,8,4,8,27,26,1,28
Terek Grozny,6354,6,7,7,6,20,22,-2,28
FK Rubin,6354,7,7,5,8,24,17,7,26
Rostov,6354,8,5,6,9,12,18,-6,21
Din Moscow,6354,9,5,6,9,18,27,-9,21
Amkar,6354,10,4,6,10,10,23,-13,18
Anzhi,6354,11,3,6,11,17,39,-22,15
Loko Moscow,6355,1,13,5,2,34,12,22,44
CSKA Moscow,6355,2,12,3,5,29,19,10,39
Spart Moscow,6355,3,10,6,4,42,30,12,36
Terek Grozny,6355,4,8,6,6,21,22,-1,30
Zenit,6355,5,7,8,5,23,17,6,29
Krasnodar,6355,6,8,4,8,27,29,-2,28
FK Rubin,6355,7,6,6,8,23,17,6,24
Din Moscow,6355,8,5,7,8,18,23,-5,22
Rostov,6355,9,4,6,10,11,21,-10,18
Amkar,6355,10,4,6,10,12,25,-13,18
Anzhi,6355,11,2,5,13,15,40,-25,11
Loko Moscow,6356,1,13,5,2,33,12,21,44
Spart Moscow,6356,2,11,5,4,38,27,11,38
CSKA Moscow,6356,3,10,4,6,26,19,7,34
Zenit,6356,4,8,8,4,23,15,8,32
Terek Grozny,6356,5,8,5,7,23,27,-4,29
Krasnodar,6356,6,8,4,8,28,28,0,28
Din Moscow,6356,7,6,6,8,19,23,-4,24
FK Rubin,6356,8,6,5,9,23,19,4,23
Amkar,6356,9,5,4,11,12,23,-11,19
Rostov,6356,10,4,6,10,11,19,-8,18
Anzhi,6356,11,2,6,12,17,41,-24,12
Loko Moscow,6357,1,12,5,3,31,14,17,41
CSKA Moscow,6357,2,11,4,5,26,17,9,37
Zenit,6357,3,8,9,3,24,13,11,33
Terek Grozny,6357,4,9,5,6,25,24,1,32
Spart Moscow,6357,5,8,7,5,36,29,7,31
Krasnodar,6357,6,9,4,7,31,27,4,31
FK Rubin,6357,7,6,5,9,23,21,2,23
Din Moscow,6357,8,5,7,8,18,23,-5,22
Rostov,6357,9,4,7,9,11,18,-7,19
Amkar,6357,10,5,4,11,11,25,-14,19
Anzhi,6357,11,2,5,13,16,41,-25,11
Loko Moscow,6358,1,12,6,2,32,13,19,42
Spart Moscow,6358,2,10,6,4,37,27,10,36
CSKA Moscow,6358,3,10,3,7,26,22,4,33
Zenit,6358,4,8,8,4,24,16,8,32
Terek Grozny,6358,5,9,5,6,26,25,1,32
Krasnodar,6358,6,8,6,6,29,26,3,30
Din Moscow,6358,7,6,6,8,19,23,-4,24
FK Rubin,6358,8,5,6,9,23,20,3,21
Rostov,6358,9,4,7,9,11,18,-7,19
Amkar,6358,10,4,4,12,12,28,-16,16
Anzhi,6358,11,3,5,12,18,39,-21,14
Loko Moscow,6359,1,12,5,3,31,14,17,41
CSKA Moscow,6359,2,11,4,5,28,19,9,37
Spart Moscow,6359,3,9,7,4,37,28,9,34
Krasnodar,6359,4,10,4,6,34,25,9,34
Zenit,6359,5,7,9,4,22,15,7,30
Terek Grozny,6359,6,8,5,7,23,26,-3,29
Din Moscow,6359,7,6,6,8,19,23,-4,24
FK Rubin,6359,8,5,5,10,21,22,-1,20
Rostov,6359,9,4,7,9,11,18,-7,19
Amkar,6359,10,4,5,11,12,26,-14,17
Anzhi,6359,11,3,5,12,17,39,-22,14
Loko Moscow,6360,1,12,6,2,33,14,19,42
CSKA Moscow,6360,2,10,4,6,29,22,7,34
Krasnodar,6360,3,9,5,6,32,27,5,32
Spart Moscow,6360,4,8,7,5,34,27,7,31
Zenit,6360,5,7,9,4,25,18,7,30
Terek Grozny,6360,6,7,5,8,22,27,-5,26
Din Moscow,6360,7,5,8,7,19,23,-4,23
Amkar,6360,8,6,4,10,11,22,-11,22
FK Rubin,6360,9,5,6,9,23,21,2,21
Rostov,6360,10,4,7,9,10,17,-7,19
Anzhi,6360,11,4,5,11,20,40,-20,17
Loko Moscow,6361,1,11,6,3,31,16,15,39
CSKA Moscow,6361,2,12,3,5,29,17,12,39
Krasnodar,6361,3,9,5,6,32,26,6,32
Spart Moscow,6361,4,8,7,5,35,30,5,31
Zenit,6361,5,7,9,4,22,15,7,30
Terek Grozny,6361,6,7,6,7,20,23,-3,27
FK Rubin,6361,7,6,6,8,24,19,5,24
Din Moscow,6361,8,6,6,8,21,23,-2,24
Rostov,6361,9,4,7,9,11,18,-7,19
Amkar,6361,10,4,6,10,10,23,-13,18
Anzhi,6361,11,3,5,12,15,40,-25,14
Loko Moscow,6362,1,12,5,3,32,14,18,41
CSKA Moscow,6362,2,11,4,5,27,18,9,37
Zenit,6362,3,8,9,3,24,14,10,33
Krasnodar,6362,4,9,4,7,30,27,3,31
Spart Moscow,6362,5,8,6,6,34,30,4,30
Terek Grozny,6362,6,7,7,6,20,22,-2,28
Din Moscow,6362,7,6,6,8,19,22,-3,24
FK Rubin,6362,8,6,5,9,23,20,3,23
Amkar,6362,9,5,5,10,11,22,-11,20
Rostov,6362,10,4,7,9,11,18,-7,19
Anzhi,6362,11,2,6,12,15,39,-24,12
Loko Moscow,6363,1,12,6,2,31,11,20,42
Spart Moscow,6363,2,11,5,4,42,25,17,38
CSKA Moscow,6363,3,11,4,5,30,19,11,37
Krasnodar,6363,4,9,5,6,28,24,4,32
Zenit,6363,5,7,9,4,22,16,6,30
Terek Grozny,6363,6,7,6,7,21,24,-3,27
FK Rubin,6363,7,6,5,9,23,18,5,23
Din Moscow,6363,8,5,6,9,17,24,-7,21
Rostov,6363,9,4,6,10,10,21,-11,18
Amkar,6363,10,4,5,11,10,27,-17,17
Anzhi,6363,11,3,5,12,16,41,-25,14
Loko Moscow,6364,1,11,5,4,29,14,15,38
CSKA Moscow,6364,2,11,4,5,28,17,11,37
Spart Moscow,6364,3,10,6,4,36,26,10,36
Zenit,6364,4,8,9,3,22,13,9,33
Krasnodar,6364,5,9,4,7,29,27,2,31
Terek Grozny,6364,6,8,6,6,24,25,-1,30
Din Moscow,6364,7,6,6,8,20,22,-2,24
FK Rubin,6364,8,6,5,9,24,20,4,23
Rostov,6364,9,4,6,10,10,18,-8,18
Amkar,6364,10,4,5,11,11,25,-14,17
Anzhi,6364,11,2,6,12,16,42,-26,12
Loko Moscow,6365,1,12,5,3,30,12,18,41
CSKA Moscow,6365,2,11,3,6,30,20,10,36
Spart Moscow,6365,3,9,6,5,35,27,8,33
Krasnodar,6365,4,9,4,7,28,25,3,31
Terek Grozny,6365,5,8,6,6,22,23,-1,30
Zenit,6365,6,7,8,5,21,17,4,29
FK Rubin,6365,7,7,5,8,26,18,8,26
Din Moscow,6365,8,6,6,8,20,26,-6,24
Rostov,6365,9,4,6,10,10,18,-8,18
Amkar,6365,10,4,5,11,9,23,-14,17
Anzhi,6365,11,3,6,11,18,40,-22,15
Loko Moscow,6366,1,11,7,2,30,12,18,40
CSKA Moscow,6366,2,11,3,6,29,21,8,36
Spart Moscow,6366,3,9,7,4,37,27,10,34
Zenit,6366,4,8,9,3,25,14,11,33
Krasnodar,6366,5,9,5,6,30,26,4,32
Terek Grozny,6366,6,7,7,6,22,24,-2,28
FK Rubin,6366,7,6,5,9,23,19,4,23
Din Moscow,6366,8,5,6,9,17,24,-7,21
Rostov,6366,9,4,7,9,11,18,-7,19
Amkar,6366,10,4,6,10,10,23,-13,18
Anzhi,6366,11,2,6,12,16,42,-26,12
Loko Moscow,6367,1,11,5,4,30,17,13,38
CSKA Moscow,6367,2,11,4,5,30,18,12,37
Spart Moscow,6367,3,10,5,5,39,29,10,35
Zenit,6367,4,8,9,3,25,15,10,33
Krasnodar,6367,5,9,5,6,31,25,6,32
Terek Grozny,6367,6,8,6,6,24,23,1,30
FK Rubin,6367,7,6,6,8,23,18,5,24
Din Moscow,6367,8,6,6,8,20,23,-3,24
Rostov,6367,9,4,6,10,11,19,-8,18
Amkar,6367,10,4,4,12,9,28,-19,16
Anzhi,6367,11,2,6,12,15,42,-27,12
Loko Moscow,6368,1,11,6,3,30,14,16,39
Zenit,6368,2,9,8,3,24,13,11,35
Spart Moscow,6368,3,10,5,5,36,27,9,35
CSKA Moscow,6368,4,10,4,6,25,18,7,34
Krasnodar,6368,5,9,5,6,29,25,4,32
Terek Grozny,6368,6,8,6,6,23,24,-1,30
FK Rubin,6368,7,6,5,9,25,20,5,23
Din Moscow,6368,8,5,6,9,19,26,-7,21
Amkar,6368,9,5,4,11,12,24,-12,19
Rostov,6368,10,4,6,10,10,19,-9,18
Anzhi,6368,11,2,7,11,15,38,-23,13
Loko Moscow,6369,1,11,5,4,30,15,15,38
CSKA Moscow,6369,2,11,4,5,28,17,11,37
Spart Moscow,6369,3,10,5,5,39,28,11,35
Krasnodar,6369,4,10,4,6,30,24,6,34
Zenit,6369,5,8,9,3,23,14,9,33
Terek Grozny,6369,6,8,5,7,23,24,-1,29
FK Rubin,6369,7,6,5,9,23,18,5,23
Amkar,6369,8,6,4,10,11,22,-11,22
Din Moscow,6369,9,5,6,9,17,26,-9,21
Rostov,6369,10,4,6,10,12,20,-8,18
Anzhi,6369,11,2,5,13,15,43,-28,11
Loko Moscow,6370,1,13,5,2,33,12,21,44
CSKA Moscow,6370,2,11,3,6,26,18,8,36
Spart Moscow,6370,3,10,5,5,39,29,10,35
Krasnodar,6370,4,9,4,7,29,27,2,31
Zenit,6370,5,7,8,5,21,15,6,29
Terek Grozny,6370,6,7,5,8,22,26,-4,26
Din Moscow,6370,7,5,7,8,17,22,-5,22
Amkar,6370,8,6,4,10,13,23,-10,22
FK Rubin,6370,9,5,6,9,21,18,3,21
Rostov,6370,10,4,6,10,12,22,-10,18
Anzhi,6370,11,4,5,11,17,38,-21,17
Loko Moscow,6371,1,12,5,3,32,13,19,41
CSKA Moscow,6371,2,11,4,5,29,20,9,37
Zenit,6371,3,8,9,3,24,15,9,33
Krasnodar,6371,4,9,4,7,30,28,2,31
Spart Moscow,6371,5,8,6,6,36,32,4,30
Terek Grozny,6371,6,8,5,7,23,24,-1,29
Din Moscow,6371,7,5,8,7,18,22,-4,23
Amkar,6371,8,6,4,10,14,24,-10,22
FK Rubin,6371,9,5,6,9,22,19,3,21
Rostov,6371,10,5,6,9,13,18,-5,21
Anzhi,6371,11,2,5,13,15,41,-26,11
Loko Moscow,6372,1,11,6,3,30,13,17,39
Spart Moscow,6372,2,11,5,4,37,26,11,38
Zenit,6372,3,9,8,3,25,13,12,35
CSKA Moscow,6372,4,10,3,7,26,22,4,33
Krasnodar,6372,5,9,5,6,30,26,4,32
Terek Grozny,6372,6,9,5,6,23,23,0,32
FK Rubin,6372,7,6,5,9,26,21,5,23
Din Moscow,6372,8,5,6,9,19,26,-7,21
Rostov,6372,9,4,6,10,10,18,-8,18
Amkar,6372,10,4,4,12,11,26,-15,16
Anzhi,6372,11,3,5,12,16,39,-23,14
Loko Moscow,6373,1,12,5,3,30,13,17,41
CSKA Moscow,6373,2,12,3,5,29,17,12,39
Spart Moscow,6373,3,10,6,4,39,28,11,36
Krasnodar,6373,4,10,4,6,31,24,7,34
Zenit,6373,5,7,8,5,21,15,6,29
Terek Grozny,6373,6,8,5,7,23,25,-2,29
Din Moscow,6373,7,5,7,8,17,23,-6,22
FK Rubin,6373,8,5,6,9,21,19,2,21
Rostov,6373,9,4,6,10,11,19,-8,18
Amkar,6373,10,4,5,11,11,27,-16,17
Anzhi,6373,11,3,5,12,17,40,-23,14
Loko Moscow,6374,1,13,5,2,34,13,21,44
CSKA Moscow,6374,2,11,3,6,27,22,5,36
Zenit,6374,3,8,8,4,26,15,11,32
Spart Moscow,6374,4,8,7,5,35,28,7,31
Krasnodar,6374,5,9,4,7,31,28,3,31
Terek Grozny,6374,6,7,6,7,22,25,-3,27
Din Moscow,6374,7,6,6,8,19,24,-5,24
FK Rubin,6374,8,6,5,9,25,21,4,23
Amkar,6374,9,5,5,10,12,24,-12,20
Rostov,6374,10,4,7,9,11,18,-7,19
Anzhi,6374,11,2,6,12,16,40,-24,12
Loko Moscow,6375,1,12,6,2,33,14,19,42
CSKA Moscow,6375,2,12,3,5,29,17,12,39
Spart Moscow,6375,3,11,5,4,37,26,11,38
Krasnodar,6375,4,9,4,7,30,26,4,31
Zenit,6375,5,7,9,4,23,16,7,30
Terek Grozny,6375,6,7,6,7,21,25,-4,27
Din Moscow,6375,7,6,6,8,21,22,-1,24
FK Rubin,6375,8,5,5,10,21,23,-2,20
Rostov,6375,9,4,6,10,11,19,-8,18
Amkar,6375,10,4,5,11,10,24,-14,17
Anzhi,6375,11,3,5,12,16,40,-24,14
Loko Moscow,6376,1,13,5,2,34,12,22,44
CSKA Moscow,6376,2,11,4,5,27,17,10,37
Spart Moscow,6376,3,9,6,5,37,29,8,33
Krasnodar,6376,4,9,4,7,30,28,2,31
Zenit,6376,5,7,9,4,21,15,6,30
Terek Grozny,6376,6,7,6,7,20,25,-5,27
Din Moscow,6376,7,6,7,7,19,22,-3,25
FK Rubin,6376,8,5,6,9,22,19,3,21
Rostov,6376,9,4,7,9,12,19,-7,19
Amkar,6376,10,5,4,11,12,23,-11,19
Anzhi,6376,11,2,6,12,14,39,-25,12
Loko Moscow,6377,1,11,6,3,30,13,17,39
CSKA Moscow,6377,2,10,5,5,27,19,8,35
Spart Moscow,6377,3,9,7,4,42,30,12,34
Krasnodar,6377,4,10,4,6,30,24,6,34
Zenit,6377,5,7,10,3,22,14,8,31
Terek Grozny,6377,6,7,6,7,21,24,-3,27
Din Moscow,6377,7,6,6,8,20,27,-7,24
FK Rubin,6377,8,5,5,10,22,21,1,20
Amkar,6377,9,5,5,10,11,23,-12,20
Rostov,6377,10,4,7,9,13,20,-7,19
Anzhi,6377,11,2,7,11,17,40,-23,13
Loko Moscow,6378,1,12,6,2,31,12,19,42
CSKA Moscow,6378,2,11,4,5,30,19,11,37
Spart Moscow,6378,3,10,5,5,36,27,9,35
Zenit,6378,4,7,10,3,23,15,8,31
Terek Grozny,6378,5,8,6,6,22,23,-1,30
Krasnodar,6378,6,8,5,7,28,26,2,29
FK Rubin,6378,7,5,7,8,21,17,4,22
Din Moscow,6378,8,5,7,8,18,23,-5,22
Amkar,6378,9,5,5,10,11,23,-12,20
Rostov,6378,10,4,6,10,10,18,-8,18
Anzhi,6378,11,2,5,13,14,41,-27,11
Loko Moscow,6379,1,12,6,2,33,14,19,42
Spart Moscow,6379,2,10,6,4,40,28,12,36
CSKA Moscow,6379,3,11,3,6,31,22,9,36
Zenit,6379,4,8,8,4,25,16,9,32
Krasnodar,6379,5,9,5,6,33,27,6,32
Terek Grozny,6379,6,9,5,6,24,23,1,32
Din Moscow,6379,7,6,7,7,21,24,-3,25
FK Rubin,6379,8,5,5,10,22,22,0,20
Rostov,6379,9,4,6,10,10,18,-8,18
Amkar,6379,10,4,4,12,11,28,-17,16
Anzhi,6379,11,2,5,13,15,43,-28,11
Loko Moscow,6380,1,12,5,3,31,12,19,41
Spart Moscow,6380,2,10,5,5,40,29,11,35
Krasnodar,6380,3,10,4,6,31,25,6,34
CSKA Moscow,6380,4,10,3,7,27,23,4,33
Zenit,6380,5,8,8,4,25,16,9,32
Terek Grozny,6380,6,7,6,7,21,24,-3,27
Din Moscow,6380,7,6,6,8,22,25,-3,24
Amkar,6380,8,6,4,10,12,23,-11,22
FK Rubin,6380,9,5,5,10,23,23,0,20
Rostov,6380,10,4,6,10,10,20,-10,18
Anzhi,6380,11,3,6,11,17,39,-22,15
Loko Moscow,6381,1,11,6,3,29,12,17,39
CSKA Moscow,6381,2,12,3,5,28,18,10,39
Zenit,6381,3,8,8,4,23,15,8,32
Spart Moscow,6381,4,8,6,6,36,30,6,30
Krasnodar,6381,5,8,6,6,28,25,3,30
Terek Grozny,6381,6,7,5,8,20,25,-5,26
Din Moscow,6381,7,5,8,7,20,24,-4,23
FK Rubin,6381,8,5,7,8,23,19,4,22
Amkar,6381,9,6,4,10,12,23,-11,22
Rostov,6381,10,5,6,9,11,17,-6,21
Anzhi,6381,11,3,5,12,16,38,-22,14
Loko Moscow,6382,1,13,5,2,34,13,21,44
CSKA Moscow,6382,2,11,3,6,26,19,7,36
Spart Moscow,6382,3,9,5,6,36,27,9,32
Zenit,6382,4,8,8,4,24,16,8,32
Krasnodar,6382,5,8,4,8,30,29,1,28
Terek Grozny,6382,6,7,6,7,22,25,-3,27
FK Rubin,6382,7,7,5,8,26,19,7,26
Amkar,6382,8,6,4,10,12,23,-11,22
Rostov,6382,9,5,6,9,11,17,-6,21
Din Moscow,6382,10,5,6,9,17,26,-9,21
Anzhi,6382,11,2,6,12,15,39,-24,12
Loko Moscow,6383,1,12,6,2,32,13,19,42
Spart Moscow,6383,2,10,5,5,39,31,8,35
CSKA Moscow,6383,3,10,4,6,27,20,7,34
Zenit,6383,4,7,9,4,22,15,7,30
Krasnodar,6383,5,8,6,6,31,28,3,30
Terek Grozny,6383,6,7,6,7,22,26,-4,27
FK Rubin,6383,7,5,7,8,23,19,4,22
Din Moscow,6383,8,5,7,8,17,22,-5,22
Amkar,6383,9,5,5,10,13,23,-10,20
Rostov,6383,10,4,6,10,13,22,-9,18
Anzhi,6383,11,4,5,11,19,39,-20,17
Loko Moscow,6384,1,12,6,2,33,13,20,42
Spart Moscow,6384,2,10,6,4,39,25,14,36
CSKA Moscow,6384,3,11,3,6,27,20,7,36
Zenit,6384,4,8,9,3,23,13,10,33
Krasnodar,6384,5,9,4,7,33,29,4,31
Terek Grozny,6384,6,8,6,6,22,23,-1,30
Din Moscow,6384,7,6,6,8,18,24,-6,24
FK Rubin,6384,8,5,5,10,22,22,0,20
Rostov,6384,9,4,7,9,10,17,-7,19
Amkar,6384,10,4,5,11,9,25,-16,17
Anzhi,6384,11,2,5,13,16,41,-25,11
Loko Moscow,6385,1,12,5,3,30,14,16,41
CSKA Moscow,6385,2,10,4,6,26,19,7,34
Spart Moscow,6385,3,9,6,5,37,30,7,33
Krasnodar,6385,4,9,5,6,30,24,6,32
Zenit,6385,5,7,9,4,21,14,7,30
Terek Grozny,6385,6,8,5,7,22,23,-1,29
Din Moscow,6385,7,6,7,7,19,21,-2,25
FK Rubin,6385,8,5,7,8,21,17,4,22
Rostov,6385,9,4,7,9,12,19,-7,19
Amkar,6385,10,5,4,11,11,24,-13,19
Anzhi,6385,11,3,5,12,16,40,-24,14
Loko Moscow,6386,1,11,6,3,29,13,16,39
CSKA Moscow,6386,2,11,3,6,29,21,8,36
Krasnodar,6386,3,10,4,6,32,25,7,34
Zenit,6386,4,8,9,3,23,14,9,33
Spart Moscow,6386,5,8,8,4,39,31,8,32
Terek Grozny,6386,6,9,5,6,23,23,0,32
Din Moscow,6386,7,6,7,7,22,25,-3,25
FK Rubin,6386,8,5,5,10,23,22,1,20
Rostov,6386,9,4,7,9,11,18,-7,19
Amkar,6386,10,4,5,11,11,25,-14,17
Anzhi,6386,11,2,5,13,17,42,-25,11
Loko Moscow,6387,1,11,7,2,31,13,18,40
CSKA Moscow,6387,2,11,4,5,28,18,10,37
Spart Moscow,6387,3,8,8,4,36,28,8,32
Krasnodar,6387,4,9,5,6,29,24,5,32
Zenit,6387,5,7,10,3,24,16,8,31
Terek Grozny,6387,6,8,5,7,23,26,-3,29
Din Moscow,6387,7,5,8,7,18,22,-4,23
FK Rubin,6387,8,5,6,9,21,19,2,21
Rostov,6387,9,4,7,9,11,18,-7,19
Amkar,6387,10,4,5,11,11,25,-14,17
Anzhi,6387,11,3,5,12,17,40,-23,14
Loko Moscow,6388,1,11,6,3,30,13,17,39
CSKA Moscow,6388,2,11,3,6,27,20,7,36
Krasnodar,6388,3,10,4,6,30,24,6,34
Spart Moscow,6388,4,9,6,5,36,28,8,33
Zenit,6388,5,7,9,4,22,15,7,30
Terek Grozny,6388,6,7,6,7,21,25,-4,27
Din Moscow,6388,7,6,7,7,18,21,-3,25
FK Rubin,6388,8,5,6,9,21,19,2,21
Rostov,6388,9,4,7,9,11,18,-7,19
Amkar,6388,10,5,4,11,12,24,-12,19
Anzhi,6388,11,3,6,11,18,39,-21,15
Loko Moscow,6389,1,13,5,2,32,12,20,44
CSKA Moscow,6389,2,10,4,6,25,19,6,34
Spart Moscow,6389,3,9,6,5,37,28,9,33
Zenit,6389,4,8,8,4,23,14,9,32
Krasnodar,6389,5,9,4,7,31,26,5,31
Terek Grozny,6389,6,8,5,7,23,27,-4,29
Din Moscow,6389,7,6,7,7,19,22,-3,25
FK Rubin,6389,8,5,5,10,22,22,0,20
Amkar,6389,9,5,4,11,12,25,-13,19
Rostov,6389,10,4,6,10,11,20,-9,18
Anzhi,6389,11,3,6,11,18,38,-20,15
Loko Moscow,6390,1,12,5,3,31,15,16,41
CSKA Moscow,6390,2,11,3,6,28,19,9,36
Zenit,6390,3,9,8,3,26,14,12,35
Spart Moscow,6390,4,9,6,5,38,30,8,33
Krasnodar,6390,5,8,5,7,30,28,2,29
Terek Grozny,6390,6,8,5,7,22,24,-2,29
Din Moscow,6390,7,5,8,7,20,24,-4,23
FK Rubin,6390,8,5,7,8,24,20,4,22
Amkar,6390,9,5,4,11,12,24,-12,19
Rostov,6390,10,4,6,10,10,19,-9,18
Anzhi,6390,11,3,5,12,16,40,-24,14
Loko Moscow,6391,1,11,6,3,31,14,17,39
Zenit,6391,2,9,8,3,23,13,10,35
Spart Moscow,6391,3,9,6,5,35,28,7,33
CSKA Moscow,6391,4,10,3,7,25,21,4,33
Terek Grozny,6391,5,9,5,6,23,23,0,32
Krasnodar,6391,6,8,6,6,30,27,3,30
FK Rubin,6391,7,6,6,8,23,18,5,24
Din Moscow,6391,8,5,7,8,18,23,-5,22
Rostov,6391,9,5,6,9,12,17,-5,21
Amkar,6391,10,4,4,12,10,25,-15,16
Anzhi,6391,11,3,5,12,17,38,-21,14
Loko Moscow,6392,1,11,6,3,29,13,16,39
Krasnodar,6392,2,10,4,6,31,24,7,34
CSKA Moscow,6392,3,10,4,6,26,20,6,34
Zenit,6392,4,8,9,3,23,13,10,33
Terek Grozny,6392,5,9,5,6,22,22,0,32
Spart Moscow,6392,6,8,7,5,36,29,7,31
Din Moscow,6392,7,5,8,7,18,22,-4,23
FK Rubin,6392,8,5,6,9,21,19,2,21
Rostov,6392,9,4,7,9,11,18,-7,19
Amkar,6392,10,5,4,11,11,24,-13,19
Anzhi,6392,11,2,6,12,15,39,-24,12
Loko Moscow,6393,1,12,6,2,34,13,21,42
CSKA Moscow,6393,2,11,3,6,27,20,7,36
Spart Moscow,6393,3,9,6,5,35,27,8,33
Zenit,6393,4,8,8,4,24,17,7,32
Krasnodar,6393,5,9,5,6,32,26,6,32
Terek Grozny,6393,6,8,5,7,22,25,-3,29
Din Moscow,6393,7,6,7,7,21,22,-1,25
Amkar,6393,8,6,4,10,12,22,-10,22
FK Rubin,6393,9,5,5,10,21,23,-2,20
Rostov,6393,10,4,6,10,10,18,-8,18
Anzhi,6393,11,2,5,13,15,40,-25,11
Loko Moscow,6394,1,12,5,3,32,13,19,41
Zenit,6394,2,9,8,3,26,15,11,35
CSKA Moscow,6394,3,10,4,6,27,21,6,34
Spart Moscow,6394,4,9,5,6,40,31,9,32
Krasnodar,6394,5,9,4,7,29,27,2,31
Terek Grozny,6394,6,8,5,7,22,25,-3,29
Din Moscow,6394,7,5,7,8,19,27,-8,22
Amkar,6394,8,6,4,10,15,25,-10,22
FK Rubin,6394,9,5,6,9,23,20,3,21
Rostov,6394,10,5,6,9,12,17,-5,21
Anzhi,6394,11,2,6,12,15,39,-24,12
Loko Moscow,6395,1,11,5,4,31,16,15,38
Spart Moscow,6395,2,11,5,4,40,27,13,38
CSKA Moscow,6395,3,11,3,6,30,20,10,36
Zenit,6395,4,9,8,3,24,14,10,35
Krasnodar,6395,5,10,4,6,33,27,6,34
Terek Grozny,6395,6,8,6,6,23,24,-1,30
Din Moscow,6395,7,6,6,8,20,23,-3,24
FK Rubin,6395,8,5,5,10,24,23,1,20
Rostov,6395,9,4,6,10,11,20,-9,18
Amkar,6395,10,4,4,12,10,26,-16,16
Anzhi,6395,11,2,6,12,18,44,-26,12
Loko Moscow,6396,1,12,5,3,31,14,17,41
CSKA Moscow,6396,2,10,4,6,27,20,7,34
Krasnodar,6396,3,10,4,6,31,25,6,34
Spart Moscow,6396,4,8,8,4,36,28,8,32
Terek Grozny,6396,5,9,5,6,25,23,2,32
Zenit,6396,6,7,9,4,22,15,7,30
Din Moscow,6396,7,6,7,7,21,23,-2,25
FK Rubin,6396,8,5,5,10,22,21,1,20
Rostov,6396,9,4,7,9,11,18,-7,19
Amkar,6396,10,4,5,11,11,27,-16,17
Anzhi,6396,11,3,5,12,16,39,-23,14
Loko Moscow,6397,1,11,6,3,31,15,16,39
CSKA Moscow,6397,2,11,4,5,28,18,10,37
Krasnodar,6397,3,9,5,6,32,27,5,32
Zenit,6397,4,7,10,3,21,13,8,31
Spart Moscow,6397,5,8,7,5,35,29,6,31
Terek Grozny,6397,6,8,5,7,22,23,-1,29
Din Moscow,6397,7,6,7,7,20,23,-3,25
FK Rubin,6397,8,5,6,9,23,20,3,21
Rostov,6397,9,4,7,9,11,18,-7,19
Amkar,6397,10,5,4,11,11,24,-13,19
Anzhi,6397,11,3,5,12,16,40,-24,14
Loko Moscow,6398,1,11,7,2,33,15,18,40
CSKA Moscow,6398,2,11,3,6,30,21,9,36
Spart Moscow,6398,3,10,5,5,38,27,11,35
Zenit,6398,4,8,9,3,25,15,10,33
Krasnodar,6398,5,8,5,7,29,28,1,29
Terek Grozny,6398,6,7,6,7,22,26,-4,27
Din Moscow,6398,7,6,6,8,20,23,-3,24
FK Rubin,6398,8,6,5,9,23,20,3,23
Rostov,6398,9,5,6,9,12,17,-5,21
Amkar,6398,10,5,4,11,11,25,-14,19
Anzhi,6398,11,2,6,12,18,44,-26,12
Loko Moscow,6399,1,12,5,3,31,12,19,41
Spart Moscow,6399,2,11,5,4,43,27,16,38
CSKA Moscow,6399,3,11,4,5,27,18,9,37
Krasnodar,6399,4,10,4,6,30,25,5,34
Zenit,6399,5,7,8,5,22,17,5,29
Terek Grozny,6399,6,8,5,7,22,23,-1,29
Din Moscow,6399,7,5,7,8,18,24,-6,22
FK Rubin,6399,8,5,6,9,23,20,3,21
Amkar,6399,9,5,4,11,10,26,-16,19
Rostov,6399,10,4,6,10,12,21,-9,18
Anzhi,6399,11,2,6,12,14,39,-25,12
Loko Moscow,6400,1,12,6,2,33,13,20,42
Spart Moscow,6400,2,10,5,5,40,29,11,35
CSKA Moscow,6400,3,10,3,7,26,20,6,33
Zenit,6400,4,8,8,4,23,16,7,32
Krasnodar,6400,5,8,5,7,30,29,1,29
Terek Grozny,6400,6,8,5,7,22,24,-2,29
FK Rubin,6400,7,7,5,8,29,19,10,26
Din Moscow,6400,8,6,6,8,20,27,-7,24
Rostov,6400,9,4,6,10,10,20,-10,18
Anzhi,6400,10,4,5,11,18,39,-21,17
Amkar,6400,11,4,4,12,10,25,-15,16
Loko Moscow,6401,1,12,5,3,30,13,17,41
CSKA Moscow,6401,2,11,4,5,29,17,12,37
Spart Moscow,6401,3,9,7,4,41,29,12,34
Krasnodar,6401,4,10,4,6,30,24,6,34
Zenit,6401,5,7,9,4,21,14,7,30
Terek Grozny,6401,6,8,5,7,22,24,-2,29
Din Moscow,6401,7,6,6,8,20,26,-6,24
FK Rubin,6401,8,5,5,10,21,20,1,20
Rostov,6401,9,4,7,9,11,18,-7,19
Amkar,6401,10,4,5,11,11,25,-14,17
Anzhi,6401,11,3,5,12,16,42,-26,14
Loko Moscow,6402,1,11,6,3,31,14,17,39
Zenit,6402,2,9,8,3,25,13,12,35
Spart Moscow,6402,3,10,5,5,36,28,8,35
CSKA Moscow,6402,4,10,3,7,25,22,3,33
Krasnodar,6402,5,8,6,6,31,28,3,30
Terek Grozny,6402,6,7,7,6,21,23,-2,28
Din Moscow,6402,7,6,7,7,21,23,-2,25
FK Rubin,6402,8,5,7,8,24,20,4,22
Rostov,6402,9,4,6,10,10,18,-8,18
Amkar,6402,10,4,5,11,10,24,-14,17
Anzhi,6402,11,3,6,11,16,37,-21,15
Loko Moscow,6403,1,11,5,4,32,16,16,38
CSKA Moscow,6403,2,11,4,5,28,17,11,37
Spart Moscow,6403,3,10,6,4,38,28,10,36
Krasnodar,6403,4,10,4,6,32,27,5,34
Zenit,6403,5,8,9,3,23,14,9,33
Terek Grozny,6403,6,9,5,6,24,23,1,32
FK Rubin,6403,7,6,5,9,24,20,4,23
Din Moscow,6403,8,5,7,8,19,24,-5,22
Rostov,6403,9,4,6,10,11,19,-8,18
Amkar,6403,10,4,4,12,10,26,-16,16
Anzhi,6403,11,2,5,13,15,42,-27,11
Loko Moscow,6404,1,11,6,3,30,13,17,39
CSKA Moscow,6404,2,12,3,5,30,18,12,39
Spart Moscow,6404,3,10,6,4,40,29,11,36
Krasnodar,6404,4,9,4,7,28,25,3,31
Zenit,6404,5,7,9,4,23,16,7,30
Terek Grozny,6404,6,8,6,6,22,23,-1,30
Din Moscow,6404,7,6,7,7,21,23,-2,25
FK Rubin,6404,8,6,5,9,22,19,3,23
Rostov,6404,9,4,6,10,10,19,-9,18
Amkar,6404,10,4,5,11,12,26,-14,17
Anzhi,6404,11,2,5,13,14,41,-27,11
Loko Moscow,6405,1,11,7,2,30,12,18,40
Spart Moscow,6405,2,10,5,5,38,29,9,35
CSKA Moscow,6405,3,10,4,6,26,19,7,34
Zenit,6405,4,7,10,3,21,13,8,31
Terek Grozny,6405,5,8,6,6,24,23,1,30
Krasnodar,6405,6,8,5,7,29,29,0,29
FK Rubin,6405,7,7,5,8,26,18,8,26
Rostov,6405,8,5,6,9,12,17,-5,21
Din Moscow,6405,9,5,6,9,19,26,-7,21
Amkar,6405,10,4,5,11,9,23,-14,17
Anzhi,6405,11,3,5,12,17,42,-25,14
Loko Moscow,6406,1,12,6,2,32,12,20,42
Spart Moscow,6406,2,11,5,4,38,26,12,38
CSKA Moscow,6406,3,11,3,6,27,19,8,36
Zenit,6406,4,8,8,4,23,16,7,32
Krasnodar,6406,5,9,5,6,30,26,4,32
Terek Grozny,6406,6,8,5,7,21,25,-4,29
Din Moscow,6406,7,6,6,8,18,22,-4,24
FK Rubin,6406,8,5,5,10,22,20,2,20
Amkar,6406,9,5,4,11,12,23,-11,19
Rostov,6406,10,4,6,10,11,20,-9,18
Anzhi,6406,11,2,5,13,14,39,-25,11
Loko Moscow,6407,1,12,6,2,31,12,19,42
Spart Moscow,6407,2,11,5,4,37,26,11,38
CSKA Moscow,6407,3,11,3,6,29,22,7,36
Zenit,6407,4,8,8,4,24,15,9,32
Krasnodar,6407,5,8,6,6,28,25,3,30
Terek Grozny,6407,6,8,6,6,22,22,0,30
FK Rubin,6407,7,6,6,8,22,17,5,24
Din Moscow,6407,8,5,6,9,18,24,-6,21
Rostov,6407,9,4,6,10,10,18,-8,18
Amkar,6407,10,4,5,11,9,23,-14,17
Anzhi,6407,11,2,5,13,16,42,-26,11
Loko Moscow,6408,1,11,6,3,31,15,16,39
Spart Moscow,6408,2,10,6,4,42,28,14,36
CSKA Moscow,6408,3,10,4,6,28,23,5,34
Zenit,6408,4,8,9,3,27,16,11,33
Krasnodar,6408,5,9,4,7,30,26,4,31
Terek Grozny,6408,6,7,6,7,20,23,-3,27
FK Rubin,6408,7,7,5,8,23,17,6,26
Din Moscow,6408,8,5,7,8,19,24,-5,22
Rostov,6408,9,4,6,10,11,21,-10,18
Amkar,6408,10,4,5,11,9,25,-16,17
Anzhi,6408,11,3,6,11,16,38,-22,15
Loko Moscow,6409,1,12,5,3,30,13,17,41
Spart Moscow,6409,2,10,5,5,39,29,10,35
CSKA Moscow,6409,3,10,4,6,27,20,7,34
Krasnodar,6409,4,10,4,6,31,25,6,34
Zenit,6409,5,8,8,4,22,14,8,32
Terek Grozny,6409,6,7,5,8,21,26,-5,26
FK Rubin,6409,7,6,5,9,23,19,4,23
Amkar,6409,8,6,4,10,14,24,-10,22
Din Moscow,6409,9,5,6,9,18,25,-7,21
Rostov,6409,10,4,6,10,10,19,-9,18
Anzhi,6409,11,3,6,11,18,39,-21,15
Loko Moscow,6410,1,11,7,2,32,14,18,40
CSKA Moscow,6410,2,11,3,6,29,21,8,36
Spart Moscow,6410,3,10,5,5,39,30,9,35
Zenit,6410,4,8,9,3,25,15,10,33
Krasnodar,6410,5,8,6,6,29,26,3,30
Terek Grozny,6410,6,7,7,6,21,23,-2,28
Din Moscow,6410,7,6,6,8,21,25,-4,24
FK Rubin,6410,8,5,6,9,23,20,3,21
Rostov,6410,9,5,6,9,12,18,-6,21
Amkar,6410,10,4,5,11,10,24,-14,17
Anzhi,6410,11,2,6,12,17,42,-25,12
Loko Moscow,6411,1,12,5,3,31,12,19,41
Spart Moscow,6411,2,10,6,4,37,27,10,36
CSKA Moscow,6411,3,10,5,5,28,20,8,35
Krasnodar,6411,4,9,4,7,28,25,3,31
Zenit,6411,5,7,9,4,22,16,6,30
Terek Grozny,6411,6,7,7,6,20,22,-2,28
FK Rubin,6411,7,7,5,8,23,17,6,26
Din Moscow,6411,8,5,6,9,18,24,-6,21
Rostov,6411,9,4,6,10,11,19,-8,18
Amkar,6411,10,4,6,10,9,22,-13,18
Anzhi,6411,11,2,7,11,16,39,-23,13
Loko Moscow,6412,1,12,6,2,32,13,19,42
CSKA Moscow,6412,2,10,4,6,28,21,7,34
Zenit,6412,3,8,9,3,24,15,9,33
Spart Moscow,6412,4,9,6,5,36,29,7,33
Terek Grozny,6412,5,8,6,6,22,23,-1,30
Krasnodar,6412,6,8,5,7,29,27,2,29
FK Rubin,6412,7,6,6,8,24,19,5,24
Din Moscow,6412,8,6,6,8,20,23,-3,24
Rostov,6412,9,4,7,9,11,18,-7,19
Amkar,6412,10,4,5,11,11,25,-14,17
Anzhi,6412,11,2,6,12,16,40,-24,12
Loko Moscow,6413,1,12,5,3,33,15,18,41
CSKA Moscow,6413,2,12,3,5,29,17,12,39
Spart Moscow,6413,3,11,5,4,39,26,13,38
Krasnodar,6413,4,10,4,6,32,26,6,34
Zenit,6413,5,7,8,5,21,17,4,29
Terek Grozny,6413,6,7,5,8,20,24,-4,26
FK Rubin,6413,7,6,5,9,23,19,4,23
Din Moscow,6413,8,5,6,9,19,25,-6,21
Amkar,6413,9,5,4,11,10,25,-15,19
Rostov,6413,10,4,6,10,10,18,-8,18
Anzhi,6413,11,3,5,12,15,39,-24,14
Loko Moscow,6414,1,11,6,3,31,14,17,39
Spart Moscow,6414,2,10,6,4,38,27,11,36
CSKA Moscow,6414,3,11,3,6,29,20,9,36
Zenit,6414,4,9,8,3,25,15,10,35
Krasnodar,6414,5,9,5,6,32,25,7,32
Terek Grozny,6414,6,8,6,6,24,25,-1,30
FK Rubin,6414,7,6,5,9,23,22,1,23
Din Moscow,6414,8,5,7,8,19,24,-5,22
Rostov,6414,9,4,6,10,11,19,-8,18
Amkar,6414,10,4,5,11,11,26,-15,17
Anzhi,6414,11,2,5,13,16,42,-26,11
Loko Moscow,6415,1,12,6,2,33,12,21,42
CSKA Moscow,6415,2,11,4,5,28,19,9,37
Spart Moscow,6415,3,9,7,4,38,29,9,34
Zenit,6415,4,7,9,4,23,16,7,30
Krasnodar,6415,5,8,5,7,28,28,0,29
Terek Grozny,6415,6,7,6,7,22,25,-3,27
Din Moscow,6415,7,6,7,7,20,23,-3,25
FK Rubin,6415,8,5,6,9,23,20,3,21
Rostov,6415,9,4,6,10,11,19,-8,18
Amkar,6415,10,4,6,10,12,25,-13,18
Anzhi,6415,11,3,6,11,17,39,-22,15
Loko Moscow,6416,1,11,6,3,30,16,14,39
Spart Moscow,6416,2,10,6,4,38,26,12,36
CSKA Moscow,6416,3,11,3,6,28,18,10,36
Zenit,6416,4,8,9,3,23,14,9,33
Krasnodar,6416,5,9,5,6,32,25,7,32
Terek Grozny,6416,6,7,7,6,22,24,-2,28
FK Rubin,6416,7,5,7,8,22,18,4,22
Din Moscow,6416,8,5,7,8,18,24,-6,22
Rostov,6416,9,4,6,10,10,19,-9,18
Amkar,6416,10,4,6,10,10,23,-13,18
Anzhi,6416,11,2,6,12,15,41,-26,12
Loko Moscow,6417,1,12,5,3,32,13,19,41
CSKA Moscow,6417,2,12,3,5,28,18,10,39
Spart Moscow,6417,3,9,6,5,39,32,7,33
Zenit,6417,4,8,8,4,22,14,8,32
Krasnodar,6417,5,9,4,7,31,29,2,31
Terek Grozny,6417,6,8,5,7,23,25,-2,29
FK Rubin,6417,7,6,5,9,24,20,4,23
Din Moscow,6417,8,5,7,8,19,24,-5,22
Amkar,6417,9,5,4,11,13,26,-13,19
Rostov,6417,10,4,6,10,11,19,-8,18
Anzhi,6417,11,3,5,12,18,40,-22,14
Loko Moscow,6418,1,11,5,4,31,17,14,38
CSKA Moscow,6418,2,11,4,5,27,17,10,37
Krasnodar,6418,3,10,4,6,32,25,7,34
Zenit,6418,4,8,8,4,23,16,7,32
Spart Moscow,6418,5,9,5,6,39,33,6,32
Terek Grozny,6418,6,7,5,8,20,26,-6,26
Din Moscow,6418,7,6,6,8,21,24,-3,24
FK Rubin,6418,8,6,5,9,22,18,4,23
Rostov,6418,9,5,6,9,13,19,-6,21
Amkar,6418,10,5,4,11,12,24,-12,19
Anzhi,6418,11,3,6,11,16,37,-21,15
Loko Moscow,6419,1,12,6,2,31,12,19,42
CSKA Moscow,6419,2,11,4,5,29,20,9,37
Spart Moscow,6419,3,9,6,5,36,28,8,33
Terek Grozny,6419,4,9,5,6,24,23,1,32
Krasnodar,6419,5,9,4,7,30,25,5,31
Zenit,6419,6,7,9,4,23,16,7,30
Din Moscow,6419,7,5,8,7,18,22,-4,23
FK Rubin,6419,8,5,6,9,21,20,1,21
Amkar,6419,9,5,4,11,11,23,-12,19
Rostov,6419,10,4,6,10,10,19,-9,18
Anzhi,6419,11,2,6,12,17,42,-25,12
Loko Moscow,6420,1,13,5,2,39,13,26,44
Spart Moscow,6420,2,10,6,4,37,27,10,36
CSKA Moscow,6420,3,10,4,6,26,19,7,34
Zenit,6420,4,8,8,4,22,20,2,32
Krasnodar,6420,5,9,4,7,30,27,3,31
Terek Grozny,6420,6,7,5,8,22,26,-4,26
Din Moscow,6420,7,6,7,7,19,22,-3,25
FK Rubin,6420,8,5,5,10,22,20,2,20
Amkar,6420,9,5,4,11,12,25,-13,19
Rostov,6420,10,4,6,10,11,19,-8,18
Anzhi,6420,11,3,6,11,17,39,-22,15
Loko Moscow,6421,1,11,5,4,30,14,16,38
Spart Moscow,6421,2,11,5,4,42,29,13,38
CSKA Moscow,6421,3,11,4,5,28,19,9,37
Krasnodar,6421,4,10,4,6,32,26,6,34
Zenit,6421,5,8,8,4,23,15,8,32
Terek Grozny,6421,6,8,6,6,24,22,2,30
FK Rubin,6421,7,6,5,9,23,20,3,23
Din Moscow,6421,8,5,6,9,19,25,-6,21
Rostov,6421,9,4,6,10,12,21,-9,18
Amkar,6421,10,4,4,12,9,28,-19,16
Anzhi,6421,11,2,7,11,15,38,-23,13
Loko Moscow,6422,1,12,5,3,30,12,18,41
Spart Moscow,6422,2,11,5,4,43,29,14,38
CSKA Moscow,6422,3,11,4,5,27,18,9,37
Krasnodar,6422,4,10,4,6,32,26,6,34
Zenit,6422,5,7,8,5,22,16,6,29
Terek Grozny,6422,6,8,5,7,24,25,-1,29
Din Moscow,6422,7,5,7,8,19,24,-5,22
FK Rubin,6422,8,5,6,9,24,22,2,21
Rostov,6422,9,4,6,10,11,19,-8,18
Amkar,6422,10,4,4,12,12,31,-19,16
Anzhi,6422,11,3,6,11,16,38,-22,15
Loko Moscow,6423,1,12,6,2,34,12,22,42
CSKA Moscow,6423,2,12,3,5,30,17,13,39
Spart Moscow,6423,3,9,6,5,37,29,8,33
Terek Grozny,6423,4,9,5,6,24,23,1,32
Krasnodar,6423,5,9,4,7,28,28,0,31
Zenit,6423,6,7,9,4,22,17,5,30
FK Rubin,6423,7,6,5,9,23,19,4,23
Din Moscow,6423,8,5,6,9,19,25,-6,21
Rostov,6423,9,5,6,9,13,19,-6,21
Amkar,6423,10,4,5,11,9,24,-15,17
Anzhi,6423,11,2,5,13,15,41,-26,11
Loko Moscow,6424,1,12,6,2,31,11,20,42
CSKA Moscow,6424,2,11,4,5,28,19,9,37
Spart Moscow,6424,3,10,6,4,38,27,11,36
Zenit,6424,4,7,9,4,23,17,6,30
Krasnodar,6424,5,8,6,6,28,25,3,30
Terek Grozny,6424,6,7,5,8,21,25,-4,26
FK Rubin,6424,7,5,7,8,22,18,4,22
Din Moscow,6424,8,5,7,8,19,25,-6,22
Amkar,6424,9,5,5,10,11,23,-12,20
Rostov,6424,10,4,6,10,10,18,-8,18
Anzhi,6424,11,3,5,12,15,38,-23,14
Loko Moscow,6425,1,11,7,2,31,13,18,40
CSKA Moscow,6425,2,11,4,5,28,18,10,37
Spart Moscow,6425,3,10,6,4,39,26,13,36
Krasnodar,6425,4,9,5,6,31,26,5,32
Zenit,6425,5,7,9,4,22,16,6,30
Terek Grozny,6425,6,7,7,6,22,24,-2,28
FK Rubin,6425,7,6,5,9,24,19,5,23
Din Moscow,6425,8,5,7,8,18,25,-7,22
Rostov,6425,9,4,6,10,10,20,-10,18
Amkar,6425,10,4,5,11,10,25,-15,17
Anzhi,6425,11,2,7,11,15,38,-23,13
Loko Moscow,6426,1,11,6,3,29,13,16,39
CSKA Moscow,6426,2,12,3,5,29,17,12,39
Spart Moscow,6426,3,10,6,4,39,26,13,36
Krasnodar,6426,4,9,4,7,29,25,4,31
Zenit,6426,5,7,9,4,21,14,7,30
Terek Grozny,6426,6,8,5,7,21,24,-3,29
FK Rubin,6426,7,6,6,8,23,18,5,24
Din Moscow,6426,8,5,7,8,18,26,-8,22
Rostov,6426,9,4,6,10,10,18,-8,18
Amkar,6426,10,4,5,11,10,24,-14,17
Anzhi,6426,11,3,5,12,16,40,-24,14
Loko Moscow,6427,1,12,5,3,33,13,20,41
CSKA Moscow,6427,2,12,3,5,30,17,13,39
Krasnodar,6427,3,10,4,6,31,25,6,34
Spart Moscow,6427,4,9,6,5,37,29,8,33
Zenit,6427,5,7,8,5,22,19,3,29
Terek Grozny,6427,6,8,5,7,22,24,-2,29
FK Rubin,6427,7,6,5,9,24,21,3,23
Din Moscow,6427,8,5,6,9,19,25,-6,21
Rostov,6427,9,4,7,9,11,18,-7,19
Amkar,6427,10,5,4,11,12,25,-13,19
Anzhi,6427,11,3,5,12,15,40,-25,14
Loko Moscow,6428,1,12,5,3,30,12,18,41
CSKA Moscow,6428,2,12,3,5,29,18,11,39
Spart Moscow,6428,3,10,5,5,38,27,11,35
Krasnodar,6428,4,10,4,6,29,24,5,34
Terek Grozny,6428,5,8,6,6,22,23,-1,30
Zenit,6428,6,7,8,5,21,16,5,29
Din Moscow,6428,7,6,6,8,19,23,-4,24
FK Rubin,6428,8,5,5,10,21,19,2,20
Amkar,6428,9,5,4,11,11,24,-13,19
Rostov,6428,10,4,6,10,10,20,-10,18
Anzhi,6428,11,2,6,12,15,39,-24,12
Loko Moscow,6429,1,12,5,3,32,13,19,41
CSKA Moscow,6429,2,11,3,6,29,20,9,36
Zenit,6429,3,9,8,3,26,15,11,35
Spart Moscow,6429,4,9,5,6,39,30,9,32
Krasnodar,6429,5,8,5,7,27,26,1,29
Din Moscow,6429,6,7,6,7,21,22,-1,27
Terek Grozny,6429,7,7,5,8,20,27,-7,26
Amkar,6429,8,6,4,10,16,23,-7,22
FK Rubin,6429,9,5,6,9,21,19,2,21
Rostov,6429,10,4,6,10,10,21,-11,18
Anzhi,6429,11,3,5,12,15,40,-25,14
Loko Moscow,6430,1,12,6,2,32,13,19,42
Spart Moscow,6430,2,11,5,4,37,25,12,38
CSKA Moscow,6430,3,10,4,6,27,20,7,34
Zenit,6430,4,8,8,4,23,15,8,32
Krasnodar,6430,5,9,5,6,30,26,4,32
Terek Grozny,6430,6,8,6,6,23,23,0,30
FK Rubin,6430,7,6,5,9,25,19,6,23
Din Moscow,6430,8,5,6,9,18,26,-8,21
Rostov,6430,9,4,6,10,10,19,-9,18
Amkar,6430,10,4,4,12,9,25,-16,16
Anzhi,6430,11,2,7,11,16,39,-23,13
Loko Moscow,6431,1,12,6,2,31,12,19,42
CSKA Moscow,6431,2,11,3,6,27,19,8,36
Spart Moscow,6431,3,9,7,4,39,30,9,34
Zenit,6431,4,8,8,4,22,14,8,32
Krasnodar,6431,5,9,5,6,30,26,4,32
Terek Grozny,6431,6,8,5,7,21,24,-3,29
FK Rubin,6431,7,6,5,9,23,19,4,23
Din Moscow,6431,8,5,7,8,19,24,-5,22
Rostov,6431,9,4,7,9,11,18,-7,19
Amkar,6431,10,5,4,11,13,25,-12,19
Anzhi,6431,11,2,5,13,15,40,-25,11
Loko Moscow,6432,1,12,6,2,30,11,19,42
Spart Moscow,6432,2,11,5,4,39,28,11,38
CSKA Moscow,6432,3,11,3,6,27,20,7,36
Zenit,6432,4,7,9,4,21,14,7,30
Terek Grozny,6432,5,8,6,6,21,22,-1,30
Krasnodar,6432,6,8,5,7,28,26,2,29
Din Moscow,6432,7,6,6,8,18,22,-4,24
FK Rubin,6432,8,5,6,9,22,19,3,21
Rostov,6432,9,4,6,10,11,19,-8,18
Amkar,6432,10,4,5,11,11,25,-14,17
Anzhi,6432,11,3,5,12,17,39,-22,14
Loko Moscow,6433,1,11,6,3,29,13,16,39
CSKA Moscow,6433,2,11,4,5,29,18,11,37
Spart Moscow,6433,3,9,7,4,42,33,9,34
Zenit,6433,4,7,10,3,22,14,8,31
Krasnodar,6433,5,9,4,7,29,25,4,31
Terek Grozny,6433,6,7,7,6,21,23,-2,28
FK Rubin,6433,7,6,6,8,23,18,5,24
Din Moscow,6433,8,5,8,7,22,26,-4,23
Rostov,6433,9,4,6,10,11,19,-8,18
Amkar,6433,10,4,6,10,12,25,-13,18
Anzhi,6433,11,2,6,12,15,41,-26,12
Loko Moscow,6434,1,11,7,2,33,15,18,40
CSKA Moscow,6434,2,11,3,6,29,19,10,36
Spart Moscow,6434,3,8,8,4,34,26,8,32
Krasnodar,6434,4,9,5,6,30,26,4,32
Zenit,6434,5,7,9,4,23,18,5,30
Terek Grozny,6434,6,7,6,7,24,27,-3,27
Din Moscow,6434,7,6,7,7,20,22,-2,25
FK Rubin,6434,8,5,5,10,21,20,1,20
Amkar,6434,9,5,5,10,11,23,-12,20
Rostov,6434,10,4,7,9,10,17,-7,19
Anzhi,6434,11,3,6,11,19,41,-22,15
Loko Moscow,6435,1,12,6,2,32,12,20,42
CSKA Moscow,6435,2,11,4,5,27,17,10,37
Spart Moscow,6435,3,9,7,4,36,27,9,34
Zenit,6435,4,7,10,3,22,14,8,31
Krasnodar,6435,5,8,5,7,27,26,1,29
Terek Grozny,6435,6,7,5,8,21,25,-4,26
Din Moscow,6435,7,6,6,8,20,23,-3,24
FK Rubin,6435,8,5,6,9,22,20,2,21
Amkar,6435,9,5,5,10,12,24,-12,20
Rostov,6435,10,4,7,9,11,18,-7,19
Anzhi,6435,11,3,5,12,15,39,-24,14
Loko Moscow,6436,1,11,6,3,31,15,16,39
CSKA Moscow,6436,2,11,4,5,27,18,9,37
Spart Moscow,6436,3,9,5,6,37,31,6,32
Krasnodar,6436,4,9,5,6,31,26,5,32
Zenit,6436,5,7,10,3,22,14,8,31
Terek Grozny,6436,6,7,5,8,20,25,-5,26
FK Rubin,6436,7,6,6,8,26,21,5,24
Din Moscow,6436,8,6,6,8,22,25,-3,24
Amkar,6436,9,6,4,10,12,22,-10,22
Rostov,6436,10,4,6,10,12,21,-9,18
Anzhi,6436,11,3,5,12,17,39,-22,14
Loko Moscow,6437,1,12,6,2,32,11,21,42
Spart Moscow,6437,2,11,5,4,38,25,13,38
CSKA Moscow,6437,3,11,3,6,27,21,6,36
Zenit,6437,4,8,9,3,24,13,11,33
Krasnodar,6437,5,8,4,8,28,29,-1,28
Terek Grozny,6437,6,7,7,6,22,24,-2,28
FK Rubin,6437,7,7,5,8,24,18,6,26
Din Moscow,6437,8,5,6,9,17,24,-7,21
Rostov,6437,9,4,6,10,10,19,-9,18
Amkar,6437,10,4,5,11,10,24,-14,17
Anzhi,6437,11,2,6,12,16,40,-24,12
Loko Moscow,6438,1,11,6,3,30,13,17,39
CSKA Moscow,6438,2,11,3,6,27,20,7,36
Spart Moscow,6438,3,10,5,5,38,28,10,35
Krasnodar,6438,4,10,4,6,33,25,8,34
Zenit,6438,5,8,9,3,25,15,10,33
Terek Grozny,6438,6,8,6,6,23,24,-1,30
Din Moscow,6438,7,6,6,8,18,23,-5,24
Rostov,6438,8,5,6,9,12,18,-6,21
FK Rubin,6438,9,5,5,10,22,23,-1,20
Amkar,6438,10,4,5,11,10,24,-14,17
Anzhi,6438,11,2,5,13,16,41,-25,11
CSKA Moscow,6439,1,12,3,5,27,17,10,39
Loko Moscow,6439,2,11,5,4,29,16,13,38
Krasnodar,6439,3,10,4,6,32,25,7,34
Zenit,6439,4,8,8,4,23,14,9,32
Terek Grozny,6439,5,9,5,6,26,23,3,32
Spart Moscow,6439,6,8,6,6,35,30,5,30
Din Moscow,6439,7,6,6,8,20,24,-4,24
FK Rubin,6439,8,6,5,9,24,20,4,23
Rostov,6439,9,4,7,9,11,18,-7,19
Amkar,6439,10,5,4,11,11,25,-14,19
Anzhi,6439,11,2,5,13,15,41,-26,11
Loko Moscow,6440,1,12,5,3,32,12,20,41
CSKA Moscow,6440,2,11,3,6,29,19,10,36
Spart Moscow,6440,3,10,5,5,37,27,10,35
Zenit,6440,4,9,8,3,24,14,10,35
Krasnodar,6440,5,8,4,8,27,29,-2,28
Terek Grozny,6440,6,7,5,8,21,25,-4,26
Din Moscow,6440,7,6,6,8,19,23,-4,24
FK Rubin,6440,8,6,5,9,23,18,5,23
Rostov,6440,9,5,6,9,11,17,-6,21
Amkar,6440,10,5,4,11,10,24,-14,19
Anzhi,6440,11,3,5,12,16,41,-25,14
Loko Moscow,6441,1,12,6,2,31,12,19,42
CSKA Moscow,6441,2,10,5,5,26,18,8,35
Spart Moscow,6441,3,9,7,4,37,28,9,34
Zenit,6441,4,7,10,3,23,15,8,31
Terek Grozny,6441,5,8,5,7,23,25,-2,29
Krasnodar,6441,6,8,4,8,28,28,0,28
FK Rubin,6441,7,7,5,8,26,19,7,26
Din Moscow,6441,8,5,7,8,19,24,-5,22
Rostov,6441,9,4,6,10,11,19,-8,18
Amkar,6441,10,4,5,11,10,24,-14,17
Anzhi,6441,11,3,6,11,17,39,-22,15
Loko Moscow,6442,1,11,6,3,30,13,17,39
Zenit,6442,2,8,9,3,23,13,10,33
CSKA Moscow,6442,3,10,3,7,25,20,5,33
Spart Moscow,6442,4,9,5,6,37,31,6,32
Krasnodar,6442,5,9,5,6,29,25,4,32
Terek Grozny,6442,6,7,6,7,20,23,-3,27
FK Rubin,6442,7,6,6,8,23,18,5,24
Din Moscow,6442,8,6,6,8,20,23,-3,24
Rostov,6442,9,5,6,9,13,18,-5,21
Amkar,6442,10,5,4,11,11,25,-14,19
Anzhi,6442,11,3,6,11,15,37,-22,15
Loko Moscow,6443,1,12,5,3,31,14,17,41
CSKA Moscow,6443,2,10,3,7,26,21,5,33
Zenit,6443,3,8,8,4,24,15,9,32
Krasnodar,6443,4,9,5,6,30,25,5,32
Spart Moscow,6443,5,8,6,6,33,27,6,30
Terek Grozny,6443,6,7,7,6,20,22,-2,28
FK Rubin,6443,7,6,6,8,24,18,6,24
Din Moscow,6443,8,6,6,8,18,23,-5,24
Rostov,6443,9,5,6,9,11,17,-6,21
Amkar,6443,10,4,6,10,9,22,-13,18
Anzhi,6443,11,3,6,11,16,38,-22,15
Loko Moscow,6444,1,11,6,3,31,14,17,39
CSKA Moscow,6444,2,12,3,5,29,17,12,39
Spart Moscow,6444,3,9,6,5,38,29,9,33
Zenit,6444,4,8,8,4,23,16,7,32
Krasnodar,6444,5,8,6,6,31,28,3,30
Terek Grozny,6444,6,8,5,7,21,24,-3,29
Din Moscow,6444,7,6,6,8,20,25,-5,24
FK Rubin,6444,8,5,6,9,24,22,2,21
Rostov,6444,9,4,7,9,10,17,-7,19
Amkar,6444,10,5,4,11,12,24,-12,19
Anzhi,6444,11,3,5,12,16,39,-23,14
Loko Moscow,6445,1,12,5,3,31,13,18,41
CSKA Moscow,6445,2,11,4,5,27,18,9,37
Zenit,6445,3,8,8,4,23,15,8,32
Krasnodar,6445,4,9,4,7,30,27,3,31
Spart Moscow,6445,5,8,6,6,34,28,6,30
Terek Grozny,6445,6,8,6,6,22,23,-1,30
Din Moscow,6445,7,5,8,7,19,23,-4,23
FK Rubin,6445,8,5,6,9,24,21,3,21
Rostov,6445,9,5,6,9,11,17,-6,21
Amkar,6445,10,5,4,11,10,23,-13,19
Anzhi,6445,11,2,7,11,16,39,-23,13
Loko Moscow,6446,1,12,5,3,31,12,19,41
CSKA Moscow,6446,2,11,3,6,29,19,10,36
Zenit,6446,3,9,8,3,23,13,10,35
Spart Moscow,6446,4,9,6,5,35,27,8,33
Krasnodar,6446,5,9,4,7,28,26,2,31
Terek Grozny,6446,6,7,7,6,23,25,-2,28
Din Moscow,6446,7,5,8,7,19,23,-4,23
FK Rubin,6446,8,5,6,9,22,19,3,21
Amkar,6446,9,5,5,10,12,24,-12,20
Rostov,6446,10,4,6,10,10,18,-8,18
Anzhi,6446,11,2,6,12,16,42,-26,12
Loko Moscow,6447,1,12,5,3,30,12,18,41
CSKA Moscow,6447,2,11,3,6,26,21,5,36
Zenit,6447,3,9,8,3,26,13,13,35
Krasnodar,6447,4,9,4,7,30,27,3,31
Spart Moscow,6447,5,8,5,7,35,32,3,29
Terek Grozny,6447,6,7,7,6,22,24,-2,28
Din Moscow,6447,7,7,6,7,21,23,-2,27
Rostov,6447,8,5,6,9,11,17,-6,21
FK Rubin,6447,9,5,5,10,23,21,2,20
Amkar,6447,10,5,5,10,12,22,-10,20
Anzhi,6447,11,2,6,12,16,40,-24,12
Loko Moscow,6448,1,11,6,3,30,13,17,39
CSKA Moscow,6448,2,10,4,6,25,18,7,34
Krasnodar,6448,3,10,4,6,31,26,5,34
Zenit,6448,4,8,9,3,22,13,9,33
Spart Moscow,6448,5,9,6,5,36,29,7,33
Terek Grozny,6448,6,8,5,7,22,24,-2,29
Din Moscow,6448,7,6,6,8,20,23,-3,24
Amkar,6448,8,6,4,10,13,23,-10,22
FK Rubin,6448,9,5,5,10,22,21,1,20
Rostov,6448,10,4,7,9,11,18,-7,19
Anzhi,6448,11,2,6,12,14,38,-24,12
Loko Moscow,6449,1,13,5,2,34,11,23,44
CSKA Moscow,6449,2,11,4,5,29,19,10,37
Spart Moscow,6449,3,9,6,5,39,32,7,33
Krasnodar,6449,4,9,4,7,29,29,0,31
Zenit,6449,5,7,9,4,23,16,7,30
Terek Grozny,6449,6,8,5,7,21,23,-2,29
Din Moscow,6449,7,6,7,7,20,23,-3,25
FK Rubin,6449,8,5,5,10,22,20,2,20
Amkar,6449,9,5,4,11,12,24,-12,19
Rostov,6449,10,4,6,10,12,20,-8,18
Anzhi,6449,11,3,5,12,15,39,-24,14
Loko Moscow,6450,1,11,5,4,31,15,16,38
CSKA Moscow,6450,2,11,3,6,27,20,7,36
Zenit,6450,3,9,8,3,25,14,11,35
Krasnodar,6450,4,10,4,6,31,26,5,34
Spart Moscow,6450,5,8,6,6,34,29,5,30
Terek Grozny,6450,6,8,6,6,21,22,-1,30
Din Moscow,6450,7,5,8,7,19,23,-4,23
FK Rubin,6450,8,5,6,9,22,19,3,21
Rostov,6450,9,5,6,9,11,17,-6,21
Amkar,6450,10,5,5,10,11,22,-11,20
Anzhi,6450,11,2,5,13,14,39,-25,11
Loko Moscow,6451,1,12,6,2,32,13,19,42
Spart Moscow,6451,2,11,5,4,42,26,16,38
CSKA Moscow,6451,3,11,4,5,28,17,11,37
Krasnodar,6451,4,9,5,6,30,26,4,32
Terek Grozny,6451,5,9,5,6,24,22,2,32
Zenit,6451,6,7,9,4,21,14,7,30
Din Moscow,6451,7,6,6,8,19,25,-6,24
FK Rubin,6451,8,5,5,10,21,19,2,20
Rostov,6451,9,4,6,10,10,18,-8,18
Amkar,6451,10,4,4,12,9,27,-18,16
Anzhi,6451,11,2,5,13,14,43,-29,11
Loko Moscow,6452,1,13,5,2,33,12,21,44
CSKA Moscow,6452,2,11,4,5,27,18,9,37
Spart Moscow,6452,3,9,6,5,40,31,9,33
Krasnodar,6452,4,9,4,7,30,27,3,31
Zenit,6452,5,7,9,4,23,16,7,30
Terek Grozny,6452,6,7,6,7,22,26,-4,27
Din Moscow,6452,7,6,7,7,22,24,-2,25
Rostov,6452,8,5,6,9,12,18,-6,21
FK Rubin,6452,9,5,5,10,22,22,0,20
Amkar,6452,10,5,4,11,12,25,-13,19
Anzhi,6452,11,2,6,12,16,40,-24,12
Loko Moscow,6453,1,11,6,3,30,16,14,39
CSKA Moscow,6453,2,11,3,6,29,20,9,36
Spart Moscow,6453,3,10,5,5,37,29,8,35
Krasnodar,6453,4,10,4,6,34,25,9,34
Zenit,6453,5,8,9,3,23,14,9,33
Terek Grozny,6453,6,7,6,7,22,25,-3,27
Din Moscow,6453,7,6,7,7,20,22,-2,25
FK Rubin,6453,8,5,6,9,21,19,2,21
Rostov,6453,9,4,6,10,11,19,-8,18
Amkar,6453,10,4,5,11,10,24,-14,17
Anzhi,6453,11,3,5,12,17,41,-24,14
Loko Moscow,6454,1,11,6,3,29,12,17,39
Spart Moscow,6454,2,11,5,4,41,29,12,38
Zenit,6454,3,8,9,3,24,13,11,33
CSKA Moscow,6454,4,10,3,7,25,22,3,33
Krasnodar,6454,5,9,4,7,28,28,0,31
Terek Grozny,6454,6,7,6,7,21,25,-4,27
Din Moscow,6454,7,6,6,8,21,26,-5,24
FK Rubin,6454,8,6,5,9,26,19,7,23
Rostov,6454,9,4,6,10,11,19,-8,18
Amkar,6454,10,4,5,11,10,24,-14,17
Anzhi,6454,11,4,5,11,19,38,-19,17
Loko Moscow,6455,1,11,6,3,30,13,17,39
CSKA Moscow,6455,2,10,4,6,25,20,5,34
Zenit,6455,3,8,9,3,22,13,9,33
Spart Moscow,6455,4,9,5,6,38,32,6,32
Krasnodar,6455,5,9,5,6,31,27,4,32
Terek Grozny,6455,6,8,6,6,22,23,-1,30
Din Moscow,6455,7,6,6,8,22,24,-2,24
Rostov,6455,8,5,6,9,12,18,-6,21
FK Rubin,6455,9,5,5,10,23,23,0,20
Amkar,6455,10,5,4,11,13,25,-12,19
Anzhi,6455,11,3,6,11,17,37,-20,15
Loko Moscow,6456,1,11,6,3,31,14,17,39
CSKA Moscow,6456,2,12,3,5,33,19,14,39
Spart Moscow,6456,3,9,6,5,37,28,9,33
Zenit,6456,4,8,8,4,24,18,6,32
Krasnodar,6456,5,9,5,6,29,25,4,32
Terek Grozny,6456,6,7,6,7,22,25,-3,27
Din Moscow,6456,7,6,6,8,19,24,-5,24
Rostov,6456,8,5,6,9,12,18,-6,21
FK Rubin,6456,9,5,5,10,22,20,2,20
Amkar,6456,10,5,5,10,11,23,-12,20
Anzhi,6456,11,2,6,12,17,43,-26,12
Loko Moscow,6457,1,11,6,3,30,14,16,39
Krasnodar,6457,2,10,4,6,31,24,7,34
CSKA Moscow,6457,3,10,4,6,27,20,7,34
Spart Moscow,6457,4,9,6,5,35,26,9,33
Zenit,6457,5,8,9,3,24,15,9,33
Terek Grozny,6457,6,8,6,6,23,23,0,30
Din Moscow,6457,7,5,7,8,18,24,-6,22
FK Rubin,6457,8,5,6,9,22,20,2,21
Rostov,6457,9,5,6,9,11,17,-6,21
Amkar,6457,10,4,6,10,10,23,-13,18
Anzhi,6457,11,2,6,12,15,40,-25,12
Loko Moscow,6458,1,12,5,3,33,16,17,41
CSKA Moscow,6458,2,11,4,5,29,18,11,37
Zenit,6458,3,8,9,3,24,14,10,33
Spart Moscow,6458,4,8,6,6,34,31,3,30
Krasnodar,6458,5,8,5,7,30,28,2,29
Terek Grozny,6458,6,8,5,7,23,26,-3,29
FK Rubin,6458,7,6,6,8,24,19,5,24
Din Moscow,6458,8,5,7,8,19,24,-5,22
Amkar,6458,9,6,4,10,16,23,-7,22
Rostov,6458,10,5,6,9,11,17,-6,21
Anzhi,6458,11,2,5,13,16,43,-27,11
Loko Moscow,6459,1,12,5,3,33,16,17,41
CSKA Moscow,6459,2,11,3,6,27,18,9,36
Krasnodar,6459,3,10,4,6,33,27,6,34
Spart Moscow,6459,4,9,6,5,39,29,10,33
Zenit,6459,5,7,8,5,23,18,5,29
Terek Grozny,6459,6,8,5,7,23,27,-4,29
Din Moscow,6459,7,7,6,7,19,21,-2,27
FK Rubin,6459,8,5,5,10,23,21,2,20
Rostov,6459,9,4,7,9,11,18,-7,19
Amkar,6459,10,5,4,11,14,27,-13,19
Anzhi,6459,11,3,5,12,17,40,-23,14
Loko Moscow,6460,1,12,5,3,32,14,18,41
CSKA Moscow,6460,2,11,3,6,28,19,9,36
Zenit,6460,3,9,8,3,25,15,10,35
Spart Moscow,6460,4,8,7,5,35,29,6,31
Krasnodar,6460,5,9,4,7,31,26,5,31
Terek Grozny,6460,6,8,6,6,26,26,0,30
FK Rubin,6460,7,6,5,9,23,21,2,23
Din Moscow,6460,8,5,7,8,19,24,-5,22
Amkar,6460,9,5,5,10,13,24,-11,20
Rostov,6460,10,4,7,9,10,17,-7,19
Anzhi,6460,11,2,5,13,17,44,-27,11
CSKA Moscow,6461,1,12,3,5,32,20,12,39
Loko Moscow,6461,2,11,5,4,31,17,14,38
Spart Moscow,6461,3,10,5,5,38,26,12,35
Krasnodar,6461,4,10,4,6,30,24,6,34
Zenit,6461,5,8,8,4,27,18,9,32
Terek Grozny,6461,6,7,7,6,22,24,-2,28
FK Rubin,6461,7,6,5,9,23,18,5,23
Din Moscow,6461,8,5,6,9,17,26,-9,21
Amkar,6461,9,5,5,10,11,23,-12,20
Rostov,6461,10,4,6,10,10,19,-9,18
Anzhi,6461,11,2,6,12,16,42,-26,12
Loko Moscow,6462,1,11,7,2,30,12,18,40
CSKA Moscow,6462,2,11,3,6,27,22,5,36
Zenit,6462,3,8,9,3,25,13,12,33
Spart Moscow,6462,4,9,5,6,37,30,7,32
Krasnodar,6462,5,9,5,6,30,26,4,32
Terek Grozny,6462,6,7,7,6,20,22,-2,28
Din Moscow,6462,7,6,7,7,22,25,-3,25
FK Rubin,6462,8,5,6,9,23,20,3,21
Amkar,6462,9,5,5,10,10,22,-12,20
Rostov,6462,10,4,6,10,10,18,-8,18
Anzhi,6462,11,2,6,12,15,39,-24,12
Loko Moscow,6463,1,12,5,3,30,15,15,41
CSKA Moscow,6463,2,11,3,6,28,18,10,36
Zenit,6463,3,8,8,4,22,14,8,32
Krasnodar,6463,4,9,4,7,31,25,6,31
Spart Moscow,6463,5,8,6,6,34,29,5,30
Terek Grozny,6463,6,8,5,7,21,23,-2,29
FK Rubin,6463,7,7,5,8,24,18,6,26
Din Moscow,6463,8,6,6,8,20,24,-4,24
Rostov,6463,9,5,6,9,12,17,-5,21
Amkar,6463,10,5,5,10,10,22,-12,20
Anzhi,6463,11,2,5,13,14,41,-27,11
Loko Moscow,6464,1,11,5,4,30,15,15,38
CSKA Moscow,6464,2,11,3,6,27,19,8,36
Zenit,6464,3,9,8,3,24,13,11,35
Krasnodar,6464,4,10,4,6,31,25,6,34
Spart Moscow,6464,5,9,6,5,38,29,9,33
Terek Grozny,6464,6,7,6,7,22,25,-3,27
Din Moscow,6464,7,6,6,8,19,23,-4,24
FK Rubin,6464,8,5,5,10,21,21,0,20
Amkar,6464,9,5,5,10,13,25,-12,20
Rostov,6464,10,4,7,9,11,18,-7,19
Anzhi,6464,11,3,5,12,17,40,-23,14
Loko Moscow,6465,1,11,6,3,31,14,17,39
CSKA Moscow,6465,2,11,4,5,28,17,11,37
Spart Moscow,6465,3,10,5,5,42,30,12,35
Zenit,6465,4,7,10,3,22,14,8,31
Krasnodar,6465,5,9,4,7,31,28,3,31
Terek Grozny,6465,6,8,5,7,22,23,-1,29
FK Rubin,6465,7,7,5,8,25,19,6,26
Amkar,6465,8,6,4,10,12,22,-10,22
Din Moscow,6465,9,5,6,9,17,27,-10,21
Rostov,6465,10,4,6,10,13,21,-8,18
Anzhi,6465,11,2,5,13,14,42,-28,11
Loko Moscow,6466,1,12,5,3,31,15,16,41
CSKA Moscow,6466,2,11,3,6,27,19,8,36
Zenit,6466,3,9,8,3,26,14,12,35
Spart Moscow,6466,4,10,5,5,39,29,10,35
Krasnodar,6466,5,8,5,7,28,26,2,29
Terek Grozny,6466,6,7,7,6,21,23,-2,28
Din Moscow,6466,7,6,6,8,22,25,-3,24
FK Rubin,6466,8,5,6,9,22,20,2,21
Amkar,6466,9,5,5,10,10,22,-12,20
Rostov,6466,10,4,6,10,11,20,-9,18
Anzhi,6466,11,2,6,12,15,39,-24,12
Loko Moscow,6467,1,11,6,3,32,15,17,39
Spart Moscow,6467,2,10,6,4,42,29,13,36
CSKA Moscow,6467,3,10,4,6,28,21,7,34
Krasnodar,6467,4,10,4,6,31,26,5,34
Terek Grozny,6467,5,9,5,6,22,22,0,32
Zenit,6467,6,7,10,3,24,16,8,31
Din Moscow,6467,7,5,7,8,19,26,-7,22
FK Rubin,6467,8,5,6,9,22,19,3,21
Rostov,6467,9,4,6,10,10,19,-9,18
Amkar,6467,10,4,5,11,12,26,-14,17
Anzhi,6467,11,3,5,12,16,39,-23,14
CSKA Moscow,6468,1,12,3,5,30,19,11,39
Loko Moscow,6468,2,11,5,4,29,15,14,38
Spart Moscow,6468,3,9,6,5,36,27,9,33
Zenit,6468,4,8,8,4,23,15,8,32
Krasnodar,6468,5,9,5,6,31,25,6,32
Terek Grozny,6468,6,7,5,8,20,26,-6,26
FK Rubin,6468,7,6,6,8,24,18,6,24
Rostov,6468,8,5,6,9,11,17,-6,21
Din Moscow,6468,9,5,6,9,17,25,-8,21
Amkar,6468,10,5,5,10,13,23,-10,20
Anzhi,6468,11,3,5,12,16,40,-24,14
Loko Moscow,6469,1,11,6,3,32,15,17,39
Spart Moscow,6469,2,11,5,4,36,25,11,38
CSKA Moscow,6469,3,11,3,6,27,18,9,36
Zenit,6469,4,9,8,3,24,14,10,35
Terek Grozny,6469,5,9,5,6,29,23,6,32
Krasnodar,6469,6,8,5,7,29,28,1,29
FK Rubin,6469,7,6,6,8,24,18,6,24
Din Moscow,6469,8,5,7,8,18,23,-5,22
Rostov,6469,9,4,6,10,10,18,-8,18
Amkar,6469,10,4,4,12,9,28,-19,16
Anzhi,6469,11,2,5,13,15,43,-28,11
Loko Moscow,6470,1,11,5,4,30,16,14,38
Spart Moscow,6470,2,11,5,4,38,27,11,38
CSKA Moscow,6470,3,11,3,6,29,19,10,36
Zenit,6470,4,9,8,3,25,14,11,35
Krasnodar,6470,5,9,4,7,30,27,3,31
FK Rubin,6470,6,7,5,8,24,17,7,26
Terek Grozny,6470,7,7,5,8,21,26,-5,26
Din Moscow,6470,8,5,6,9,19,25,-6,21
Amkar,6470,9,5,4,11,10,23,-13,19
Rostov,6470,10,4,6,10,10,18,-8,18
Anzhi,6470,11,3,5,12,17,41,-24,14
Loko Moscow,6471,1,12,5,3,32,14,18,41
CSKA Moscow,6471,2,11,4,5,28,19,9,37
Spart Moscow,6471,3,10,6,4,39,27,12,36
Zenit,6471,4,8,9,3,24,15,9,33
Krasnodar,6471,5,8,5,7,30,28,2,29
Terek Grozny,6471,6,8,5,7,22,23,-1,29
FK Rubin,6471,7,6,6,8,24,19,5,24
Din Moscow,6471,8,5,6,9,18,26,-8,21
Rostov,6471,9,4,6,10,10,18,-8,18
Amkar,6471,10,4,5,11,10,25,-15,17
Anzhi,6471,11,3,5,12,16,39,-23,14
Loko Moscow,6472,1,12,5,3,31,14,17,41
CSKA Moscow,6472,2,11,4,5,26,17,9,37
Spart Moscow,6472,3,9,5,6,38,33,5,32
Terek Grozny,6472,4,9,5,6,22,22,0,32
Krasnodar,6472,5,9,4,7,30,26,4,31
Zenit,6472,6,7,9,4,21,15,6,30
FK Rubin,6472,7,7,5,8,24,17,7,26
Din Moscow,6472,8,6,6,8,21,24,-3,24
Amkar,6472,9,5,4,11,12,23,-11,19
Rostov,6472,10,4,6,10,11,20,-9,18
Anzhi,6472,11,2,5,13,14,39,-25,11
Loko Moscow,6473,1,11,5,4,30,15,15,38
Spart Moscow,6473,2,10,5,5,37,28,9,35
CSKA Moscow,6473,3,10,4,6,25,19,6,34
Krasnodar,6473,4,10,4,6,30,25,5,34
Zenit,6473,5,8,9,3,24,14,10,33
Terek Grozny,6473,6,8,6,6,24,23,1,30
FK Rubin,6473,7,6,5,9,25,20,5,23
Din Moscow,6473,8,5,6,9,18,25,-7,21
Amkar,6473,9,5,5,10,12,24,-12,20
Rostov,6473,10,4,6,10,10,18,-8,18
Anzhi,6473,11,3,5,12,17,41,-24,14
Loko Moscow,6474,1,11,6,3,31,15,16,39
CSKA Moscow,6474,2,11,4,5,27,18,9,37
Spart Moscow,6474,3,9,7,4,34,25,9,34
Zenit,6474,4,7,10,3,23,15,8,31
Krasnodar,6474,5,9,4,7,31,27,4,31
Terek Grozny,6474,6,8,5,7,21,24,-3,29
FK Rubin,6474,7,7,5,8,24,18,6,26
Din Moscow,6474,8,5,6,9,17,23,-6,21
Amkar,6474,9,5,5,10,11,22,-11,20
Rostov,6474,10,4,7,9,10,17,-7,19
Anzhi,6474,11,2,5,13,14,39,-25,11
Loko Moscow,6475,1,12,6,2,31,12,19,42
Zenit,6475,2,8,9,3,25,14,11,33
Spart Moscow,6475,3,9,6,5,36,27,9,33
CSKA Moscow,6475,4,10,3,7,25,22,3,33
Krasnodar,6475,5,8,5,7,29,27,2,29
Terek Grozny,6475,6,7,7,6,22,24,-2,28
Din Moscow,6475,7,5,8,7,18,22,-4,23
FK Rubin,6475,8,5,7,8,24,20,4,22
Amkar,6475,9,5,5,10,13,24,-11,20
Rostov,6475,10,4,6,10,10,20,-10,18
Anzhi,6475,11,3,6,11,16,37,-21,15
Loko Moscow,6476,1,12,5,3,33,14,19,41
Spart Moscow,6476,2,11,5,4,43,27,16,38
Krasnodar,6476,3,10,4,6,31,26,5,34
CSKA Moscow,6476,4,10,3,7,25,20,5,33
Zenit,6476,5,8,8,4,23,15,8,32
Terek Grozny,6476,6,7,6,7,22,25,-3,27
Din Moscow,6476,7,5,7,8,19,27,-8,22
FK Rubin,6476,8,5,6,9,23,20,3,21
Rostov,6476,9,4,6,10,12,21,-9,18
Amkar,6476,10,4,5,11,10,25,-15,17
Anzhi,6476,11,4,5,11,17,38,-21,17
Loko Moscow,6477,1,12,6,2,32,12,20,42
CSKA Moscow,6477,2,11,3,6,27,18,9,36
Spart Moscow,6477,3,10,5,5,37,27,10,35
Zenit,6477,4,8,9,3,23,14,9,33
Krasnodar,6477,5,9,4,7,29,27,2,31
Terek Grozny,6477,6,8,6,6,24,24,0,30
Din Moscow,6477,7,6,6,8,20,24,-4,24
FK Rubin,6477,8,5,5,10,23,22,1,20
Amkar,6477,9,5,4,11,10,24,-14,19
Rostov,6477,10,4,6,10,11,19,-8,18
Anzhi,6477,11,2,6,12,16,41,-25,12
Loko Moscow,6478,1,12,6,2,30,11,19,42
Spart Moscow,6478,2,11,5,4,39,25,14,38
CSKA Moscow,6478,3,11,4,5,28,18,10,37
Krasnodar,6478,4,9,5,6,29,25,4,32
Zenit,6478,5,7,9,4,22,15,7,30
Terek Grozny,6478,6,7,5,8,21,26,-5,26
Din Moscow,6478,7,5,7,8,19,27,-8,22
FK Rubin,6478,8,5,6,9,24,21,3,21
Amkar,6478,9,5,4,11,12,24,-12,19
Rostov,6478,10,4,6,10,10,18,-8,18
Anzhi,6478,11,3,5,12,15,39,-24,14
CSKA Moscow,6479,1,12,3,5,28,18,10,39
Loko Moscow,6479,2,11,5,4,29,13,16,38
Krasnodar,6479,3,10,4,6,31,24,7,34
Zenit,6479,4,8,8,4,22,14,8,32
Spart Moscow,6479,5,8,6,6,34,29,5,30
Terek Grozny,6479,6,7,6,7,20,23,-3,27
Din Moscow,6479,7,6,6,8,19,24,-5,24
FK Rubin,6479,8,6,5,9,24,20,4,23
Rostov,6479,9,5,6,9,11,17,-6,21
Amkar,6479,10,4,6,10,10,23,-13,18
Anzhi,6479,11,3,5,12,16,39,-23,14
Loko Moscow,6480,1,11,7,2,30,12,18,40
CSKA Moscow,6480,2,11,3,6,26,18,8,36
Spart Moscow,6480,3,9,5,6,38,31,7,32
Zenit,6480,4,7,9,4,22,15,7,30
Krasnodar,6480,5,8,5,7,27,25,2,29
Terek Grozny,6480,6,8,5,7,22,24,-2,29
FK Rubin,6480,7,6,6,8,23,18,5,24
Din Moscow,6480,8,5,7,8,20,25,-5,22
Amkar,6480,9,6,4,10,12,23,-11,22
Rostov,6480,10,5,6,9,12,18,-6,21
Anzhi,6480,11,3,5,12,16,39,-23,14
Loko Moscow,6481,1,11,7,2,30,12,18,40
CSKA Moscow,6481,2,11,3,6,28,19,9,36
Zenit,6481,3,8,9,3,22,13,9,33
Spart Moscow,6481,4,8,6,6,34,29,5,30
Krasnodar,6481,5,8,6,6,28,25,3,30
Terek Grozny,6481,6,8,5,7,21,23,-2,29
Din Moscow,6481,7,7,6,7,22,23,-1,27
FK Rubin,6481,8,5,6,9,22,20,2,21
Rostov,6481,9,4,7,9,10,17,-7,19
Amkar,6481,10,5,4,11,11,23,-12,19
Anzhi,6481,11,3,5,12,16,40,-24,14
Loko Moscow,6482,1,12,5,3,33,15,18,41
CSKA Moscow,6482,2,11,4,5,30,19,11,37
Spart Moscow,6482,3,10,5,5,36,28,8,35
Krasnodar,6482,4,9,4,7,30,27,3,31
Zenit,6482,5,7,9,4,23,17,6,30
FK Rubin,6482,6,7,5,8,25,18,7,26
Terek Grozny,6482,7,7,5,8,20,26,-6,26
Din Moscow,6482,8,6,6,8,21,24,-3,24
Amkar,6482,9,5,4,11,11,23,-12,19
Rostov,6482,10,4,6,10,10,18,-8,18
Anzhi,6482,11,3,5,12,17,41,-24,14
Loko Moscow,6483,1,12,5,3,34,15,19,41
Spart Moscow,6483,2,10,5,5,38,28,10,35
CSKA Moscow,6483,3,10,3,7,27,21,6,33
Zenit,6483,4,8,8,4,24,18,6,32
Krasnodar,6483,5,9,4,7,31,27,4,31
Terek Grozny,6483,6,8,5,7,22,24,-2,29
FK Rubin,6483,7,7,5,8,26,19,7,26
Din Moscow,6483,8,6,6,8,20,25,-5,24
Amkar,6483,9,5,4,11,11,24,-13,19
Rostov,6483,10,4,6,10,11,19,-8,18
Anzhi,6483,11,3,5,12,16,40,-24,14
Loko Moscow,6484,1,11,6,3,30,14,16,39
CSKA Moscow,6484,2,10,5,5,25,17,8,35
Spart Moscow,6484,3,9,6,5,37,29,8,33
Krasnodar,6484,4,9,5,6,31,26,5,32
Zenit,6484,5,7,10,3,22,14,8,31
Terek Grozny,6484,6,8,6,6,23,23,0,30
Din Moscow,6484,7,6,7,7,20,22,-2,25
FK Rubin,6484,8,5,7,8,23,19,4,22
Rostov,6484,9,4,6,10,10,19,-9,18
Amkar,6484,10,4,5,11,10,25,-15,17
Anzhi,6484,11,2,7,11,15,38,-23,13
Loko Moscow,6485,1,13,5,2,32,12,20,44
Spart Moscow,6485,2,10,6,4,41,27,14,36
CSKA Moscow,6485,3,11,3,6,30,21,9,36
Zenit,6485,4,8,8,4,23,14,9,32
Terek Grozny,6485,5,8,6,6,21,22,-1,30
Krasnodar,6485,6,8,5,7,28,26,2,29
Din Moscow,6485,7,6,6,8,19,26,-7,24
FK Rubin,6485,8,5,6,9,22,19,3,21
Rostov,6485,9,4,7,9,12,19,-7,19
Amkar,6485,10,4,4,12,9,25,-16,16
Anzhi,6485,11,2,6,12,16,42,-26,12
Loko Moscow,6486,1,11,5,4,31,16,15,38
CSKA Moscow,6486,2,11,4,5,26,17,9,37
Zenit,6486,3,8,9,3,24,15,9,33
Spart Moscow,6486,4,9,5,6,35,28,7,32
Krasnodar,6486,5,9,4,7,30,26,4,31
Terek Grozny,6486,6,7,6,7,21,24,-3,27
Din Moscow,6486,7,6,7,7,19,22,-3,25
FK Rubin,6486,8,6,6,8,24,19,5,24
Rostov,6486,9,5,6,9,11,17,-6,21
Amkar,6486,10,5,4,11,11,24,-13,19
Anzhi,6486,11,2,6,12,15,39,-24,12
CSKA Moscow,6487,1,12,3,5,28,18,10,39
Loko Moscow,6487,2,11,5,4,31,16,15,38
Krasnodar,6487,3,10,4,6,32,26,6,34
Zenit,6487,4,8,8,4,23,15,8,32
Spart Moscow,6487,5,8,6,6,35,30,5,30
Terek Grozny,6487,6,8,6,6,22,23,-1,30
Din Moscow,6487,7,6,6,8,20,23,-3,24
FK Rubin,6487,8,6,5,9,23,19,4,23
Amkar,6487,9,5,5,10,12,24,-12,20
Rostov,6487,10,4,7,9,10,17,-7,19
Anzhi,6487,11,2,5,13,15,40,-25,11
Loko Moscow,6488,1,13,5,2,34,12,22,44
Spart Moscow,6488,2,10,6,4,38,26,12,36
CSKA Moscow,6488,3,10,4,6,25,19,6,34
Zenit,6488,4,8,8,4,24,16,8,32
Terek Grozny,6488,5,9,5,6,25,22,3,32
Krasnodar,6488,6,8,5,7,28,27,1,29
Din Moscow,6488,7,6,6,8,18,24,-6,24
FK Rubin,6488,8,5,6,9,22,19,3,21
Rostov,6488,9,4,7,9,11,18,-7,19
Amkar,6488,10,4,4,12,9,26,-17,16
Anzhi,6488,11,2,6,12,14,39,-25,12
Loko Moscow,6489,1,12,6,2,32,13,19,42
CSKA Moscow,6489,2,11,4,5,29,20,9,37
Spart Moscow,6489,3,10,5,5,43,34,9,35
Krasnodar,6489,4,9,5,6,29,25,4,32
Zenit,6489,5,7,8,5,23,17,6,29
Terek Grozny,6489,6,8,5,7,23,24,-1,29
Din Moscow,6489,7,5,7,8,21,28,-7,22
Amkar,6489,8,6,4,10,18,25,-7,22
FK Rubin,6489,9,5,6,9,23,20,3,21
Rostov,6489,10,4,6,10,10,20,-10,18
Anzhi,6489,11,2,6,12,16,41,-25,12
Loko Moscow,6490,1,11,6,3,29,14,15,39
CSKA Moscow,6490,2,12,3,5,31,19,12,39
Krasnodar,6490,3,10,4,6,34,24,10,34
Spart Moscow,6490,4,9,5,6,36,31,5,32
Zenit,6490,5,7,9,4,22,15,7,30
Terek Grozny,6490,6,8,5,7,24,26,-2,29
FK Rubin,6490,7,6,5,9,22,21,1,23
Din Moscow,6490,8,5,6,9,17,23,-6,21
Rostov,6490,9,5,6,9,13,19,-6,21
Amkar,6490,10,5,4,11,13,24,-11,19
Anzhi,6490,11,3,5,12,18,43,-25,14
Loko Moscow,6491,1,12,5,3,31,13,18,41
CSKA Moscow,6491,2,11,3,6,29,19,10,36
Spart Moscow,6491,3,9,6,5,37,30,7,33
Zenit,6491,4,8,8,4,23,16,7,32
Krasnodar,6491,5,9,4,7,29,27,2,31
Terek Grozny,6491,6,7,5,8,20,24,-4,26
FK Rubin,6491,7,6,6,8,26,19,7,24
Din Moscow,6491,8,5,7,8,20,25,-5,22
Amkar,6491,9,6,4,10,13,23,-10,22
Rostov,6491,10,4,7,9,11,18,-7,19
Anzhi,6491,11,3,5,12,15,40,-25,14
Loko Moscow,6492,1,11,6,3,31,15,16,39
CSKA Moscow,6492,2,11,4,5,31,19,12,37
Krasnodar,6492,3,10,4,6,31,25,6,34
Spart Moscow,6492,4,9,5,6,37,27,10,32
Zenit,6492,5,7,10,3,24,16,8,31
Terek Grozny,6492,6,8,6,6,22,23,-1,30
Din Moscow,6492,7,7,6,7,20,21,-1,27
FK Rubin,6492,8,5,5,10,21,20,1,20
Amkar,6492,9,5,5,10,10,22,-12,20
Rostov,6492,10,4,6,10,10,21,-11,18
Anzhi,6492,11,2,5,13,15,43,-28,11
Loko Moscow,6493,1,12,5,3,31,12,19,41
CSKA Moscow,6493,2,11,4,5,27,18,9,37
Spart Moscow,6493,3,10,6,4,36,26,10,36
Krasnodar,6493,4,9,5,6,30,26,4,32
Zenit,6493,5,7,9,4,21,15,6,30
Terek Grozny,6493,6,8,6,6,23,24,-1,30
FK Rubin,6493,7,5,7,8,25,21,4,22
Din Moscow,6493,8,5,7,8,20,25,-5,22
Rostov,6493,9,4,6,10,10,18,-8,18
Amkar,6493,10,4,5,11,10,24,-14,17
Anzhi,6493,11,2,6,12,16,40,-24,12
Loko Moscow,6494,1,12,6,2,31,12,19,42
Spart Moscow,6494,2,10,5,5,37,27,10,35
CSKA Moscow,6494,3,10,4,6,26,19,7,34
Zenit,6494,4,8,8,4,22,14,8,32
Krasnodar,6494,5,9,5,6,30,26,4,32
Terek Grozny,6494,6,8,6,6,24,24,0,30
Din Moscow,6494,7,5,7,8,19,24,-5,22
FK Rubin,6494,8,5,6,9,23,20,3,21
Rostov,6494,9,5,6,9,11,17,-6,21
Amkar,6494,10,4,4,12,9,26,-17,16
Anzhi,6494,11,2,7,11,17,40,-23,13
Loko Moscow,6495,1,11,6,3,30,14,16,39
Spart Moscow,6495,2,11,5,4,40,27,13,38
CSKA Moscow,6495,3,11,3,6,28,18,10,36
Krasnodar,6495,4,10,4,6,31,25,6,34
Zenit,6495,5,8,9,3,23,14,9,33
Terek Grozny,6495,6,8,5,7,22,23,-1,29
Din Moscow,6495,7,6,6,8,20,23,-3,24
FK Rubin,6495,8,5,5,10,23,22,1,20
Amkar,6495,9,5,4,11,11,25,-14,19
Rostov,6495,10,4,6,10,11,20,-9,18
Anzhi,6495,11,2,5,13,14,42,-28,11
Loko Moscow,6496,1,13,5,2,35,12,23,44
Spart Moscow,6496,2,10,5,5,41,28,13,35
CSKA Moscow,6496,3,10,4,6,26,21,5,34
Zenit,6496,4,7,9,4,22,17,5,30
Krasnodar,6496,5,8,5,7,30,29,1,29
Terek Grozny,6496,6,8,5,7,23,24,-1,29
Din Moscow,6496,7,6,6,8,21,27,-6,24
Amkar,6496,8,6,4,10,12,23,-11,22
FK Rubin,6496,9,5,6,9,25,22,3,21
Rostov,6496,10,4,6,10,10,20,-10,18
Anzhi,6496,11,3,5,12,18,40,-22,14
Loko Moscow,6497,1,12,6,2,32,12,20,42
CSKA Moscow,6497,2,11,4,5,29,20,9,37
Spart Moscow,6497,3,9,5,6,36,30,6,32
Zenit,6497,4,7,9,4,22,15,7,30
Terek Grozny,6497,5,8,6,6,23,24,-1,30
Krasnodar,6497,6,8,4,8,28,28,0,28
FK Rubin,6497,7,7,5,8,24,18,6,26
Din Moscow,6497,8,6,6,8,21,23,-2,24
Amkar,6497,9,5,5,10,10,22,-12,20
Rostov,6497,10,4,6,10,10,19,-9,18
Anzhi,6497,11,2,6,12,19,43,-24,12
Loko Moscow,6498,1,12,6,2,32,12,20,42
Spart Moscow,6498,2,10,6,4,39,27,12,36
CSKA Moscow,6498,3,11,3,6,27,18,9,36
Zenit,6498,4,8,8,4,22,15,7,32
Krasnodar,6498,5,9,5,6,30,26,4,32
Terek Grozny,6498,6,7,7,6,22,24,-2,28
Din Moscow,6498,7,6,7,7,19,22,-3,25
FK Rubin,6498,8,5,5,10,22,20,2,20
Rostov,6498,9,4,6,10,11,21,-10,18
Amkar,6498,10,4,5,11,9,23,-14,17
Anzhi,6498,11,2,6,12,16,41,-25,12
Loko Moscow,6499,1,13,5,2,32,12,20,44
CSKA Moscow,6499,2,11,4,5,28,17,11,37
Zenit,6499,3,7,9,4,22,15,7,30
Spart Moscow,6499,4,8,6,6,34,29,5,30
Terek Grozny,6499,5,8,5,7,21,23,-2,29
Krasnodar,6499,6,8,4,8,28,28,0,28
Din Moscow,6499,7,7,6,7,23,23,0,27
FK Rubin,6499,8,6,5,9,26,22,4,23
Amkar,6499,9,6,4,10,12,23,-11,22
Rostov,6499,10,4,7,9,10,17,-7,19
Anzhi,6499,11,2,5,13,14,41,-27,11
Loko Moscow,6500,1,11,5,4,29,14,15,38
Spart Moscow,6500,2,10,6,4,39,29,10,36
Zenit,6500,3,9,8,3,24,13,11,35
CSKA Moscow,6500,4,10,4,6,26,19,7,34
Terek Grozny,6500,5,9,5,6,23,22,1,32
Krasnodar,6500,6,9,4,7,30,27,3,31
Din Moscow,6500,7,6,6,8,20,23,-3,24
FK Rubin,6500,8,6,5,9,24,21,3,23
Rostov,6500,9,4,7,9,13,20,-7,19
Amkar,6500,10,4,4,12,9,24,-15,16
Anzhi,6500,11,2,6,12,15,40,-25,12
Loko Moscow,6501,1,13,5,2,36,11,25,44
CSKA Moscow,6501,2,12,3,5,27,17,10,39
Spart Moscow,6501,3,9,6,5,39,31,8,33
Zenit,6501,4,7,8,5,21,17,4,29
Krasnodar,6501,5,8,5,7,27,28,-1,29
Terek Grozny,6501,6,8,5,7,22,27,-5,29
FK Rubin,6501,7,6,6,8,22,17,5,24
Amkar,6501,8,6,4,10,15,22,-7,22
Din Moscow,6501,9,5,6,9,20,26,-6,21
Rostov,6501,10,4,7,9,12,19,-7,19
Anzhi,6501,11,2,5,13,14,40,-26,11
Loko Moscow,6502,1,11,6,3,31,14,17,39
Spart Moscow,6502,2,10,5,5,37,28,9,35
Krasnodar,6502,3,10,4,6,31,26,5,34
Zenit,6502,4,8,9,3,23,13,10,33
CSKA Moscow,6502,5,10,3,7,25,20,5,33
Terek Grozny,6502,6,7,7,6,23,25,-2,28
Din Moscow,6502,7,6,6,8,18,22,-4,24
Rostov,6502,8,5,6,9,13,19,-6,21
FK Rubin,6502,9,5,5,10,21,19,2,20
Amkar,6502,10,4,5,11,11,25,-14,17
Anzhi,6502,11,3,6,11,16,38,-22,15
Loko Moscow,6503,1,12,5,3,32,14,18,41
CSKA Moscow,6503,2,12,3,5,29,18,11,39
Zenit,6503,3,8,8,4,24,16,8,32
Terek Grozny,6503,4,8,6,6,22,23,-1,30
Spart Moscow,6503,5,8,5,7,35,30,5,29
Krasnodar,6503,6,8,4,8,28,29,-1,28
FK Rubin,6503,7,7,5,8,25,17,8,26
Din Moscow,6503,8,6,6,8,18,22,-4,24
Rostov,6503,9,5,6,9,13,19,-6,21
Amkar,6503,10,5,5,10,10,22,-12,20
Anzhi,6503,11,2,5,13,15,41,-26,11
Loko Moscow,6504,1,12,6,2,31,12,19,42
CSKA Moscow,6504,2,11,3,6,28,18,10,36
Zenit,6504,3,8,9,3,22,13,9,33
Spart Moscow,6504,4,8,7,5,35,28,7,31
Krasnodar,6504,5,9,4,7,30,27,3,31
Terek Grozny,6504,6,8,5,7,23,23,0,29
Din Moscow,6504,7,5,8,7,21,25,-4,23
FK Rubin,6504,8,5,6,9,24,21,3,21
Rostov,6504,9,5,6,9,11,17,-6,21
Amkar,6504,10,4,5,11,9,25,-16,17
Anzhi,6504,11,3,5,12,15,40,-25,14
Loko Moscow,6505,1,12,5,3,32,15,17,41
Spart Moscow,6505,2,10,5,5,42,30,12,35
Zenit,6505,3,9,8,3,25,14,11,35
CSKA Moscow,6505,4,10,4,6,27,20,7,34
Terek Grozny,6505,5,8,6,6,23,24,-1,30
Krasnodar,6505,6,8,4,8,28,29,-1,28
FK Rubin,6505,7,6,6,8,24,17,7,24
Din Moscow,6505,8,5,7,8,18,24,-6,22
Amkar,6505,9,5,5,10,12,23,-11,20
Rostov,6505,10,4,6,10,12,23,-11,18
Anzhi,6505,11,2,6,12,17,41,-24,12
Loko Moscow,6506,1,13,5,2,32,11,21,44
CSKA Moscow,6506,2,11,3,6,26,18,8,36
Zenit,6506,3,8,8,4,22,15,7,32
Spart Moscow,6506,4,9,5,6,36,30,6,32
Terek Grozny,6506,5,8,5,7,21,23,-2,29
Krasnodar,6506,6,8,4,8,27,26,1,28
Din Moscow,6506,7,6,6,8,20,24,-4,24
FK Rubin,6506,8,6,5,9,23,20,3,23
Amkar,6506,9,6,4,10,14,23,-9,22
Rostov,6506,10,5,6,9,11,17,-6,21
Anzhi,6506,11,2,5,13,14,39,-25,11
Loko Moscow,6507,1,12,5,3,31,14,17,41
CSKA Moscow,6507,2,12,3,5,29,19,10,39
Spart Moscow,6507,3,10,6,4,40,30,10,36
Zenit,6507,4,8,8,4,24,15,9,32
Terek Grozny,6507,5,9,5,6,24,23,1,32
Krasnodar,6507,6,9,4,7,30,27,3,31
Din Moscow,6507,7,5,7,8,18,23,-5,22
FK Rubin,6507,8,5,6,9,22,19,3,21
Rostov,6507,9,4,6,10,11,19,-8,18
Amkar,6507,10,4,5,11,12,27,-15,17
Anzhi,6507,11,2,5,13,16,41,-25,11
Loko Moscow,6508,1,11,6,3,30,13,17,39
CSKA Moscow,6508,2,11,3,6,28,19,9,36
Spart Moscow,6508,3,10,5,5,35,28,7,35
Zenit,6508,4,8,8,4,23,16,7,32
Krasnodar,6508,5,9,5,6,29,25,4,32
Terek Grozny,6508,6,8,6,6,23,24,-1,30
Din Moscow,6508,7,7,6,7,21,21,0,27
FK Rubin,6508,8,5,5,10,21,19,2,20
Rostov,6508,9,4,6,10,10,18,-8,18
Amkar,6508,10,4,5,11,10,24,-14,17
Anzhi,6508,11,3,5,12,16,39,-23,14
Loko Moscow,6509,1,12,6,2,33,14,19,42
CSKA Moscow,6509,2,11,3,6,26,18,8,36
Spart Moscow,6509,3,9,6,5,35,27,8,33
Zenit,6509,4,8,8,4,22,14,8,32
Krasnodar,6509,5,8,5,7,30,29,1,29
Terek Grozny,6509,6,8,5,7,21,23,-2,29
Din Moscow,6509,7,7,6,7,20,22,-2,27
FK Rubin,6509,8,6,5,9,24,19,5,23
Amkar,6509,9,5,5,10,11,23,-12,20
Rostov,6509,10,4,6,10,10,18,-8,18
Anzhi,6509,11,2,5,13,14,39,-25,11
Loko Moscow,6510,1,12,5,3,31,13,18,41
Spart Moscow,6510,2,10,5,5,38,30,8,35
CSKA Moscow,6510,3,10,4,6,26,19,7,34
Zenit,6510,4,8,9,3,23,14,9,33
Krasnodar,6510,5,8,4,8,27,26,1,28
Terek Grozny,6510,6,7,7,6,20,22,-2,28
FK Rubin,6510,7,7,5,8,23,17,6,26
Din Moscow,6510,8,6,6,8,19,22,-3,24
Rostov,6510,9,4,6,10,11,19,-8,18
Amkar,6510,10,4,5,11,11,25,-14,17
Anzhi,6510,11,3,6,11,16,38,-22,15
Loko Moscow,6511,1,11,7,2,31,13,18,40
CSKA Moscow,6511,2,11,3,6,27,18,9,36
Zenit,6511,3,8,9,3,22,13,9,33
Spart Moscow,6511,4,9,6,5,37,29,8,33
Krasnodar,6511,5,9,5,6,32,27,5,32
Terek Grozny,6511,6,7,7,6,21,23,-2,28
FK Rubin,6511,7,6,5,9,23,20,3,23
Din Moscow,6511,8,5,6,9,17,23,-6,21
Rostov,6511,9,5,6,9,12,18,-6,21
Amkar,6511,10,4,6,10,11,24,-13,18
Anzhi,6511,11,2,6,12,15,40,-25,12
Loko Moscow,6512,1,12,6,2,35,14,21,42
Spart Moscow,6512,2,9,7,4,40,30,10,34
CSKA Moscow,6512,3,10,3,7,26,22,4,33
Zenit,6512,4,8,8,4,26,18,8,32
Krasnodar,6512,5,9,5,6,32,26,6,32
Terek Grozny,6512,6,9,5,6,23,23,0,32
Din Moscow,6512,7,6,7,7,22,23,-1,25
FK Rubin,6512,8,5,5,10,22,24,-2,20
Rostov,6512,9,4,6,10,11,20,-9,18
Amkar,6512,10,4,5,11,12,26,-14,17
Anzhi,6512,11,3,5,12,16,39,-23,14
Loko Moscow,6513,1,12,5,3,31,13,18,41
Spart Moscow,6513,2,9,6,5,39,28,11,33
CSKA Moscow,6513,3,10,3,7,26,21,5,33
Zenit,6513,4,8,8,4,24,16,8,32
Krasnodar,6513,5,9,5,6,29,25,4,32
Terek Grozny,6513,6,7,7,6,21,23,-2,28
Din Moscow,6513,7,6,6,8,19,25,-6,24
FK Rubin,6513,8,5,6,9,22,20,2,21
Amkar,6513,9,5,5,10,11,23,-12,20
Rostov,6513,10,4,7,9,11,18,-7,19
Anzhi,6513,11,3,6,11,17,38,-21,15
Loko Moscow,6514,1,11,6,3,29,12,17,39
CSKA Moscow,6514,2,12,3,5,29,18,11,39
Spart Moscow,6514,3,9,6,5,37,32,5,33
Zenit,6514,4,8,8,4,23,16,7,32
Terek Grozny,6514,5,8,6,6,23,24,-1,30
Krasnodar,6514,6,8,5,7,27,25,2,29
FK Rubin,6514,7,6,6,8,22,17,5,24
Din Moscow,6514,8,5,7,8,17,22,-5,22
Amkar,6514,9,5,5,10,15,24,-9,20
Rostov,6514,10,4,7,9,12,19,-7,19
Anzhi,6514,11,2,5,13,15,40,-25,11
Loko Moscow,6515,1,12,5,3,30,14,16,41
CSKA Moscow,6515,2,11,3,6,28,20,8,36
Zenit,6515,3,8,8,4,24,15,9,32
Spart Moscow,6515,4,9,5,6,38,31,7,32
Krasnodar,6515,5,9,4,7,30,26,4,31
Terek Grozny,6515,6,8,5,7,22,25,-3,29
Din Moscow,6515,7,6,6,8,23,28,-5,24
FK Rubin,6515,8,6,5,9,25,20,5,23
Rostov,6515,9,5,6,9,12,17,-5,21
Amkar,6515,10,5,4,11,10,23,-13,19
Anzhi,6515,11,3,5,12,17,40,-23,14
Loko Moscow,6516,1,12,6,2,33,13,20,42
CSKA Moscow,6516,2,12,3,5,28,18,10,39
Spart Moscow,6516,3,10,6,4,41,29,12,36
Krasnodar,6516,4,9,4,7,30,28,2,31
Zenit,6516,5,7,9,4,23,16,7,30
Terek Grozny,6516,6,7,6,7,20,23,-3,27
Din Moscow,6516,7,6,6,8,19,24,-5,24
FK Rubin,6516,8,5,5,10,23,21,2,20
Rostov,6516,9,4,7,9,13,20,-7,19
Amkar,6516,10,5,4,11,11,25,-14,19
Anzhi,6516,11,2,6,12,14,38,-24,12
Loko Moscow,6517,1,12,6,2,33,14,19,42
CSKA Moscow,6517,2,12,3,5,29,18,11,39
Spart Moscow,6517,3,9,5,6,37,30,7,32
Krasnodar,6517,4,9,5,6,31,27,4,32
Terek Grozny,6517,5,9,5,6,25,23,2,32
Zenit,6517,6,7,8,5,22,16,6,29
Din Moscow,6517,7,6,6,8,20,25,-5,24
FK Rubin,6517,8,6,5,9,25,20,5,23
Amkar,6517,9,5,4,11,12,24,-12,19
Rostov,6517,10,4,6,10,10,20,-10,18
Anzhi,6517,11,2,5,13,16,43,-27,11
Loko Moscow,6518,1,12,5,3,32,14,18,41
CSKA Moscow,6518,2,11,3,6,26,20,6,36
Zenit,6518,3,9,8,3,26,14,12,35
Spart Moscow,6518,4,9,5,6,36,29,7,32
Krasnodar,6518,5,9,4,7,30,27,3,31
Din Moscow,6518,6,7,6,7,19,21,-2,27
Terek Grozny,6518,7,7,6,7,20,26,-6,27
Rostov,6518,8,5,6,9,11,17,-6,21
FK Rubin,6518,9,5,5,10,22,20,2,20
Amkar,6518,10,5,4,11,15,25,-10,19
Anzhi,6518,11,2,6,12,14,38,-24,12
Loko Moscow,6519,1,12,5,3,32,12,20,41
CSKA Moscow,6519,2,11,4,5,27,18,9,37
Krasnodar,6519,3,10,4,6,31,25,6,34
Spart Moscow,6519,4,9,6,5,40,30,10,33
Zenit,6519,5,7,9,4,21,16,5,30
Terek Grozny,6519,6,7,7,6,22,24,-2,28
Din Moscow,6519,7,6,6,8,21,27,-6,24
FK Rubin,6519,8,5,5,10,23,22,1,20
Amkar,6519,9,5,5,10,12,24,-12,20
Rostov,6519,10,4,7,9,12,19,-7,19
Anzhi,6519,11,2,6,12,15,39,-24,12
Loko Moscow,6520,1,12,5,3,31,14,17,41
Spart Moscow,6520,2,10,6,4,39,28,11,36
CSKA Moscow,6520,3,10,4,6,26,19,7,34
Zenit,6520,4,8,8,4,23,15,8,32
Krasnodar,6520,5,9,4,7,29,27,2,31
Terek Grozny,6520,6,7,5,8,21,27,-6,26
Din Moscow,6520,7,6,7,7,20,22,-2,25
FK Rubin,6520,8,6,5,9,24,19,5,23
Amkar,6520,9,5,4,11,14,25,-11,19
Rostov,6520,10,4,6,10,11,20,-9,18
Anzhi,6520,11,3,6,11,16,38,-22,15
Loko Moscow,6521,1,11,5,4,31,15,16,38
Zenit,6521,2,9,8,3,25,14,11,35
Krasnodar,6521,3,10,4,6,32,26,6,34
CSKA Moscow,6521,4,10,4,6,25,19,6,34
Spart Moscow,6521,5,9,6,5,38,28,10,33
Terek Grozny,6521,6,7,6,7,20,24,-4,27
FK Rubin,6521,7,6,5,9,23,20,3,23
Amkar,6521,8,6,4,10,13,23,-10,22
Din Moscow,6521,9,5,6,9,18,26,-8,21
Rostov,6521,10,4,7,9,10,17,-7,19
Anzhi,6521,11,2,7,11,14,37,-23,13
Loko Moscow,6522,1,12,6,2,35,13,22,42
Zenit,6522,2,8,9,3,25,15,10,33
Spart Moscow,6522,3,9,6,5,37,28,9,33
CSKA Moscow,6522,4,10,3,7,26,21,5,33
Krasnodar,6522,5,8,4,8,27,29,-2,28
Terek Grozny,6522,6,7,6,7,20,25,-5,27
Din Moscow,6522,7,6,6,8,18,23,-5,24
FK Rubin,6522,8,6,5,9,22,18,4,23
Rostov,6522,9,5,6,9,12,18,-6,21
Amkar,6522,10,5,5,10,13,23,-10,20
Anzhi,6522,11,3,6,11,16,38,-22,15
Loko Moscow,6523,1,12,5,3,33,12,21,41
CSKA Moscow,6523,2,11,4,5,30,18,12,37
Krasnodar,6523,3,10,4,6,29,24,5,34
Spart Moscow,6523,4,8,7,5,35,28,7,31
Zenit,6523,5,7,9,4,22,18,4,30
Terek Grozny,6523,6,8,5,7,23,25,-2,29
Din Moscow,6523,7,6,7,7,20,22,-2,25
Rostov,6523,8,5,6,9,12,18,-6,21
FK Rubin,6523,9,5,5,10,21,20,1,20
Amkar,6523,10,4,5,11,10,24,-14,17
Anzhi,6523,11,3,5,12,16,42,-26,14
Loko Moscow,6524,1,12,5,3,33,14,19,41
CSKA Moscow,6524,2,11,3,6,27,19,8,36
Spart Moscow,6524,3,10,5,5,37,28,9,35
Krasnodar,6524,4,10,4,6,31,25,6,34
Zenit,6524,5,8,8,4,22,16,6,32
Terek Grozny,6524,6,8,5,7,23,24,-1,29
Din Moscow,6524,7,6,6,8,20,23,-3,24
FK Rubin,6524,8,6,5,9,23,19,4,23
Rostov,6524,9,4,6,10,11,19,-8,18
Amkar,6524,10,4,4,12,9,26,-17,16
Anzhi,6524,11,3,5,12,17,40,-23,14
Loko Moscow,6525,1,12,6,2,31,12,19,42
CSKA Moscow,6525,2,11,3,6,28,19,9,36
Spart Moscow,6525,3,10,5,5,38,26,12,35
Zenit,6525,4,8,8,4,23,15,8,32
Krasnodar,6525,5,8,5,7,29,30,-1,29
Terek Grozny,6525,6,7,6,7,23,26,-3,27
Din Moscow,6525,7,6,6,8,20,25,-5,24
FK Rubin,6525,8,6,5,9,27,21,6,23
Amkar,6525,9,6,4,10,12,23,-11,22
Rostov,6525,10,4,6,10,10,19,-9,18
Anzhi,6525,11,2,6,12,16,41,-25,12
Loko Moscow,6526,1,11,5,4,30,15,15,38
CSKA Moscow,6526,2,11,3,6,28,20,8,36
Zenit,6526,3,9,8,3,25,14,11,35
Spart Moscow,6526,4,10,5,5,38,28,10,35
Krasnodar,6526,5,10,4,6,30,25,5,34
Terek Grozny,6526,6,7,6,7,20,23,-3,27
Din Moscow,6526,7,6,6,8,18,22,-4,24
Rostov,6526,8,5,6,9,12,18,-6,21
FK Rubin,6526,9,5,5,10,21,19,2,20
Amkar,6526,10,5,4,11,11,25,-14,19
Anzhi,6526,11,2,6,12,15,39,-24,12
Loko Moscow,6527,1,11,6,3,30,15,15,39
CSKA Moscow,6527,2,11,4,5,27,18,9,37
Krasnodar,6527,3,10,4,6,32,25,7,34
Zenit,6527,4,7,10,3,23,15,8,31
Spart Moscow,6527,5,8,5,7,34,29,5,29
Terek Grozny,6527,6,8,5,7,23,25,-2,29
Din Moscow,6527,7,6,6,8,19,25,-6,24
FK Rubin,6527,8,6,5,9,25,19,6,23
Amkar,6527,9,6,4,10,13,24,-11,22
Rostov,6527,10,5,6,9,11,17,-6,21
Anzhi,6527,11,2,5,13,14,39,-25,11
Loko Moscow,6528,1,12,6,2,31,12,19,42
CSKA Moscow,6528,2,11,3,6,30,18,12,36
Zenit,6528,3,8,9,3,22,13,9,33
Krasnodar,6528,4,9,4,7,29,26,3,31
Spart Moscow,6528,5,8,6,6,37,34,3,30
Terek Grozny,6528,6,7,6,7,20,23,-3,27
Din Moscow,6528,7,6,6,8,20,23,-3,24
FK Rubin,6528,8,6,5,9,22,18,4,23
Amkar,6528,9,6,4,10,15,24,-9,22
Rostov,6528,10,4,7,9,11,18,-7,19
Anzhi,6528,11,2,6,12,14,42,-28,12
Loko Moscow,6529,1,12,6,2,32,13,19,42
CSKA Moscow,6529,2,12,3,5,27,17,10,39
Spart Moscow,6529,3,10,5,5,36,27,9,35
Krasnodar,6529,4,9,4,7,29,25,4,31
Zenit,6529,5,7,9,4,23,16,7,30
Terek Grozny,6529,6,8,5,7,24,24,0,29
Din Moscow,6529,7,6,6,8,20,23,-3,24
Rostov,6529,8,5,6,9,12,17,-5,21
FK Rubin,6529,9,5,5,10,21,22,-1,20
Amkar,6529,10,5,4,11,11,24,-13,19
Anzhi,6529,11,2,5,13,14,41,-27,11
Loko Moscow,6530,1,11,6,3,32,15,17,39
CSKA Moscow,6530,2,11,3,6,29,18,11,36
Krasnodar,6530,3,10,4,6,31,24,7,34
Zenit,6530,4,8,9,3,25,16,9,33
Spart Moscow,6530,5,9,6,5,36,28,8,33
Terek Grozny,6530,6,7,5,8,20,24,-4,26
Din Moscow,6530,7,6,6,8,19,23,-4,24
FK Rubin,6530,8,6,5,9,23,20,3,23
Amkar,6530,9,5,5,10,11,23,-12,20
Rostov,6530,10,4,6,10,10,19,-9,18
Anzhi,6530,11,3,5,12,15,41,-26,14
Loko Moscow,6531,1,12,6,2,33,12,21,42
CSKA Moscow,6531,2,10,4,6,28,21,7,34
Spart Moscow,6531,3,8,6,6,35,30,5,30
Zenit,6531,4,7,9,4,23,18,5,30
Krasnodar,6531,5,8,5,7,27,26,1,29
Terek Grozny,6531,6,7,5,8,20,24,-4,26
Din Moscow,6531,7,6,7,7,20,22,-2,25
FK Rubin,6531,8,6,6,8,23,17,6,24
Rostov,6531,9,5,6,9,12,18,-6,21
Amkar,6531,10,5,5,10,10,22,-12,20
Anzhi,6531,11,4,5,11,18,39,-21,17
Loko Moscow,6532,1,12,6,2,35,14,21,42
Spart Moscow,6532,2,10,6,4,38,27,11,36
Zenit,6532,3,8,9,3,25,16,9,33
CSKA Moscow,6532,4,10,3,7,26,22,4,33
Krasnodar,6532,5,8,5,7,28,28,0,29
Terek Grozny,6532,6,7,6,7,22,25,-3,27
Din Moscow,6532,7,6,6,8,19,23,-4,24
FK Rubin,6532,8,5,6,9,22,20,2,21
Rostov,6532,9,4,6,10,11,19,-8,18
Amkar,6532,10,4,6,10,11,24,-13,18
Anzhi,6532,11,4,5,11,20,39,-19,17
Loko Moscow,6533,1,12,5,3,33,13,20,41
Spart Moscow,6533,2,11,5,4,40,26,14,38
CSKA Moscow,6533,3,11,4,5,28,19,9,37
Zenit,6533,4,8,9,3,24,15,9,33
Krasnodar,6533,5,9,4,7,29,27,2,31
Terek Grozny,6533,6,8,6,6,23,24,-1,30
Din Moscow,6533,7,6,6,8,22,24,-2,24
FK Rubin,6533,8,5,5,10,21,23,-2,20
Rostov,6533,9,4,6,10,10,20,-10,18
Amkar,6533,10,4,5,11,10,24,-14,17
Anzhi,6533,11,2,5,13,16,41,-25,11
Loko Moscow,6534,1,12,6,2,33,13,20,42
CSKA Moscow,6534,2,12,3,5,29,18,11,39
Spart Moscow,6534,3,10,6,4,41,28,13,36
Terek Grozny,6534,4,9,5,6,24,23,1,32
Krasnodar,6534,5,8,6,6,28,25,3,30
Zenit,6534,6,7,8,5,23,18,5,29
FK Rubin,6534,7,6,6,8,22,17,5,24
Din Moscow,6534,8,5,6,9,18,26,-8,21
Rostov,6534,9,4,7,9,11,18,-7,19
Amkar,6534,10,4,4,12,10,27,-17,16
Anzhi,6534,11,2,5,13,15,41,-26,11
Loko Moscow,6535,1,11,7,2,33,15,18,40
CSKA Moscow,6535,2,11,4,5,29,18,11,37
Spart Moscow,6535,3,9,6,5,36,28,8,33
Zenit,6535,4,7,10,3,23,15,8,31
Krasnodar,6535,5,8,6,6,31,28,3,30
Terek Grozny,6535,6,8,6,6,23,23,0,30
FK Rubin,6535,7,6,6,8,24,19,5,24
Din Moscow,6535,8,5,6,9,20,26,-6,21
Amkar,6535,9,5,5,10,10,22,-12,20
Rostov,6535,10,4,7,9,10,17,-7,19
Anzhi,6535,11,2,5,13,15,43,-28,11
Loko Moscow,6536,1,12,6,2,32,12,20,42
Spart Moscow,6536,2,11,5,4,41,25,16,38
CSKA Moscow,6536,3,11,3,6,26,18,8,36
Zenit,6536,4,8,8,4,22,15,7,32
Krasnodar,6536,5,8,6,6,28,25,3,30
Terek Grozny,6536,6,8,5,7,21,24,-3,29
FK Rubin,6536,7,6,6,8,24,18,6,24
Din Moscow,6536,8,5,6,9,18,28,-10,21
Rostov,6536,9,4,6,10,10,19,-9,18
Amkar,6536,10,4,4,12,9,25,-16,16
Anzhi,6536,11,3,5,12,16,38,-22,14
Loko Moscow,6537,1,12,5,3,33,16,17,41
CSKA Moscow,6537,2,11,3,6,26,18,8,36
Spart Moscow,6537,3,9,6,5,38,30,8,33
Zenit,6537,4,8,8,4,24,15,9,32
Krasnodar,6537,5,9,4,7,34,27,7,31
Terek Grozny,6537,6,8,6,6,22,23,-1,30
Din Moscow,6537,7,7,6,7,21,22,-1,27
FK Rubin,6537,8,5,5,10,21,24,-3,20
Rostov,6537,9,4,6,10,10,18,-8,18
Amkar,6537,10,4,5,11,12,26,-14,17
Anzhi,6537,11,3,6,11,16,38,-22,15
Loko Moscow,6538,1,12,6,2,31,11,20,42
CSKA Moscow,6538,2,11,4,5,30,21,9,37
Spart Moscow,6538,3,9,6,5,41,28,13,33
Terek Grozny,6538,4,9,5,6,25,23,2,32
Zenit,6538,5,7,8,5,22,17,5,29
Krasnodar,6538,6,8,5,7,28,26,2,29
FK Rubin,6538,7,7,5,8,24,18,6,26
Din Moscow,6538,8,5,6,9,17,29,-12,21
Rostov,6538,9,4,7,9,10,17,-7,19
Amkar,6538,10,5,4,11,12,25,-13,19
Anzhi,6538,11,2,6,12,18,43,-25,12
Loko Moscow,6539,1,12,5,3,31,14,17,41
Spart Moscow,6539,2,10,6,4,36,25,11,36
CSKA Moscow,6539,3,10,5,5,26,18,8,35
Krasnodar,6539,4,10,4,6,32,24,8,34
Zenit,6539,5,7,9,4,23,16,7,30
Terek Grozny,6539,6,7,6,7,20,24,-4,27
Din Moscow,6539,7,5,7,8,18,24,-6,22
FK Rubin,6539,8,5,6,9,22,21,1,21
Rostov,6539,9,4,6,10,10,18,-8,18
Amkar,6539,10,4,6,10,9,22,-13,18
Anzhi,6539,11,3,6,11,16,37,-21,15
Loko Moscow,6540,1,11,7,2,30,12,18,40
Spart Moscow,6540,2,10,6,4,36,25,11,36
CSKA Moscow,6540,3,10,4,6,27,20,7,34
Zenit,6540,4,8,9,3,23,14,9,33
Krasnodar,6540,5,9,5,6,30,25,5,32
Terek Grozny,6540,6,8,5,7,22,24,-2,29
FK Rubin,6540,7,6,5,9,24,20,4,23
Din Moscow,6540,8,5,6,9,17,24,-7,21
Amkar,6540,9,5,5,10,11,22,-11,20
Rostov,6540,10,4,6,10,10,19,-9,18
Anzhi,6540,11,2,6,12,16,41,-25,12
Loko Moscow,6541,1,12,5,3,33,13,20,41
CSKA Moscow,6541,2,11,4,5,27,17,10,37
Krasnodar,6541,3,10,4,6,31,26,5,34
Spart Moscow,6541,4,9,5,6,36,30,6,32
Terek Grozny,6541,5,8,6,6,21,22,-1,30
Zenit,6541,6,7,8,5,21,18,3,29
Din Moscow,6541,7,5,7,8,21,26,-5,22
FK Rubin,6541,8,5,6,9,25,22,3,21
Rostov,6541,9,5,6,9,12,18,-6,21
Amkar,6541,10,5,5,10,11,22,-11,20
Anzhi,6541,11,2,6,12,14,38,-24,12
Loko Moscow,6542,1,11,6,3,30,13,17,39
CSKA Moscow,6542,2,11,3,6,30,20,10,36
Zenit,6542,3,9,8,3,24,14,10,35
Spart Moscow,6542,4,10,5,5,40,32,8,35
Krasnodar,6542,5,9,5,6,32,25,7,32
Terek Grozny,6542,6,8,6,6,24,23,1,30
Din Moscow,6542,7,6,7,7,19,21,-2,25
FK Rubin,6542,8,5,6,9,21,21,0,21
Rostov,6542,9,4,6,10,12,20,-8,18
Amkar,6542,10,4,5,11,13,27,-14,17
Anzhi,6542,11,2,5,13,15,44,-29,11
Loko Moscow,6543,1,12,6,2,31,12,19,42
CSKA Moscow,6543,2,11,4,5,26,17,9,37
Spart Moscow,6543,3,9,6,5,36,28,8,33
Terek Grozny,6543,4,9,5,6,23,22,1,32
Krasnodar,6543,5,9,4,7,30,26,4,31
Zenit,6543,6,7,9,4,22,15,7,30
Din Moscow,6543,7,6,7,7,20,23,-3,25
Rostov,6543,8,5,6,9,12,17,-5,21
FK Rubin,6543,9,5,5,10,24,23,1,20
Amkar,6543,10,4,4,12,10,27,-17,16
Anzhi,6543,11,2,6,12,14,38,-24,12
Loko Moscow,6544,1,12,5,3,32,14,18,41
CSKA Moscow,6544,2,11,3,6,28,19,9,36
Spart Moscow,6544,3,10,5,5,40,31,9,35
Zenit,6544,4,8,8,4,23,15,8,32
Krasnodar,6544,5,9,4,7,29,28,1,31
Terek Grozny,6544,6,7,6,7,21,26,-5,27
FK Rubin,6544,7,7,5,8,27,18,9,26
Din Moscow,6544,8,6,6,8,21,25,-4,24
Amkar,6544,9,5,4,11,13,24,-11,19
Rostov,6544,10,4,6,10,12,21,-9,18
Anzhi,6544,11,2,6,12,16,41,-25,12
Loko Moscow,6545,1,11,5,4,30,16,14,38
CSKA Moscow,6545,2,11,3,6,27,19,8,36
Zenit,6545,3,9,8,3,25,14,11,35
Spart Moscow,6545,4,9,5,6,35,27,8,32
Krasnodar,6545,5,9,4,7,30,27,3,31
Din Moscow,6545,6,7,6,7,21,22,-1,27
Terek Grozny,6545,7,7,5,8,22,28,-6,26
FK Rubin,6545,8,6,5,9,24,20,4,23
Amkar,6545,9,6,4,10,13,22,-9,22
Rostov,6545,10,4,6,10,10,19,-9,18
Anzhi,6545,11,3,5,12,17,40,-23,14
Loko Moscow,6546,1,11,6,3,32,16,16,39
CSKA Moscow,6546,2,11,4,5,27,17,10,37
Krasnodar,6546,3,10,4,6,30,24,6,34
Spart Moscow,6546,4,9,6,5,36,27,9,33
Zenit,6546,5,7,9,4,24,18,6,30
Terek Grozny,6546,6,7,5,8,22,26,-4,26
Din Moscow,6546,7,6,7,7,19,22,-3,25
Amkar,6546,8,6,4,10,11,22,-11,22
FK Rubin,6546,9,5,5,10,21,19,2,20
Rostov,6546,10,4,6,10,10,19,-9,18
Anzhi,6546,11,3,6,11,17,39,-22,15
Loko Moscow,6547,1,12,6,2,31,11,20,42
CSKA Moscow,6547,2,12,3,5,30,19,11,39
Spart Moscow,6547,3,10,5,5,44,32,12,35
Zenit,6547,4,7,9,4,21,14,7,30
Krasnodar,6547,5,8,5,7,27,26,1,29
Terek Grozny,6547,6,7,7,6,21,23,-2,28
Din Moscow,6547,7,6,6,8,21,24,-3,24
FK Rubin,6547,8,5,6,9,21,20,1,21
Amkar,6547,9,5,5,10,15,26,-11,20
Rostov,6547,10,4,6,10,10,21,-11,18
Anzhi,6547,11,2,6,12,17,42,-25,12
Loko Moscow,6548,1,13,5,2,33,12,21,44
CSKA Moscow,6548,2,12,3,5,30,18,12,39
Spart Moscow,6548,3,9,7,4,36,27,9,34
Krasnodar,6548,4,9,4,7,30,27,3,31
Terek Grozny,6548,5,8,6,6,23,24,-1,30
Zenit,6548,6,7,8,5,23,18,5,29
Din Moscow,6548,7,5,8,7,20,24,-4,23
FK Rubin,6548,8,5,6,9,24,22,2,21
Rostov,6548,9,4,6,10,10,18,-8,18
Amkar,6548,10,4,5,11,10,24,-14,17
Anzhi,6548,11,2,6,12,16,41,-25,12
Loko Moscow,6549,1,13,5,2,34,12,22,44
Spart Moscow,6549,2,11,5,4,40,28,12,38
CSKA Moscow,6549,3,11,3,6,28,18,10,36
Zenit,6549,4,8,8,4,22,15,7,32
Krasnodar,6549,5,9,4,7,30,28,2,31
Terek Grozny,6549,6,8,5,7,22,26,-4,29
Din Moscow,6549,7,6,6,8,21,24,-3,24
FK Rubin,6549,8,5,5,10,23,22,1,20
Rostov,6549,9,4,6,10,10,19,-9,18
Amkar,6549,10,4,4,12,12,27,-15,16
Anzhi,6549,11,3,5,12,17,40,-23,14
Loko Moscow,6550,1,12,5,3,34,16,18,41
CSKA Moscow,6550,2,12,3,5,31,18,13,39
Spart Moscow,6550,3,10,5,5,39,30,9,35
Zenit,6550,4,8,8,4,24,16,8,32
Terek Grozny,6550,5,8,5,7,23,26,-3,29
Krasnodar,6550,6,8,4,8,29,29,0,28
Din Moscow,6550,7,6,6,8,21,24,-3,24
FK Rubin,6550,8,6,5,9,23,19,4,23
Amkar,6550,9,5,4,11,12,25,-13,19
Rostov,6550,10,4,6,10,12,20,-8,18
Anzhi,6550,11,3,5,12,17,42,-25,14
Loko Moscow,6551,1,13,5,2,34,13,21,44
Spart Moscow,6551,2,11,5,4,44,26,18,38
CSKA Moscow,6551,3,11,3,6,31,21,10,36
Zenit,6551,4,8,8,4,25,18,7,32
Krasnodar,6551,5,9,4,7,29,26,3,31
Terek Grozny,6551,6,8,6,6,22,23,-1,30
FK Rubin,6551,7,6,5,9,24,20,4,23
Din Moscow,6551,8,5,6,9,19,28,-9,21
Rostov,6551,9,4,6,10,11,20,-9,18
Amkar,6551,10,4,5,11,9,26,-17,17
Anzhi,6551,11,2,5,13,16,43,-27,11
Loko Moscow,6552,1,12,5,3,31,12,19,41
CSKA Moscow,6552,2,11,4,5,27,18,9,37
Spart Moscow,6552,3,9,6,5,38,29,9,33
Zenit,6552,4,8,9,3,22,13,9,33
Krasnodar,6552,5,8,5,7,28,27,1,29
Terek Grozny,6552,6,7,5,8,22,26,-4,26
FK Rubin,6552,7,5,7,8,23,19,4,22
Din Moscow,6552,8,5,7,8,20,26,-6,22
Rostov,6552,9,5,6,9,12,18,-6,21
Amkar,6552,10,5,5,10,11,23,-12,20
Anzhi,6552,11,3,5,12,17,40,-23,14
Loko Moscow,6553,1,12,5,3,30,12,18,41
CSKA Moscow,6553,2,11,4,5,28,19,9,37
Spart Moscow,6553,3,10,6,4,42,29,13,36
Krasnodar,6553,4,10,4,6,32,24,8,34
Zenit,6553,5,7,9,4,22,15,7,30
Terek Grozny,6553,6,8,6,6,23,24,-1,30
Din Moscow,6553,7,6,6,8,21,24,-3,24
FK Rubin,6553,8,5,5,10,21,23,-2,20
Rostov,6553,9,4,6,10,10,21,-11,18
Amkar,6553,10,4,5,11,12,26,-14,17
Anzhi,6553,11,2,6,12,16,40,-24,12
Loko Moscow,6554,1,12,5,3,32,14,18,41
CSKA Moscow,6554,2,11,4,5,28,19,9,37
Spart Moscow,6554,3,10,6,4,39,26,13,36
Krasnodar,6554,4,9,5,6,30,26,4,32
Terek Grozny,6554,5,9,5,6,23,23,0,32
Zenit,6554,6,7,8,5,22,16,6,29
Din Moscow,6554,7,6,6,8,20,24,-4,24
FK Rubin,6554,8,5,6,9,22,20,2,21
Rostov,6554,9,4,6,10,10,20,-10,18
Amkar,6554,10,4,5,11,9,23,-14,17
Anzhi,6554,11,2,6,12,17,41,-24,12
Loko Moscow,6555,1,11,6,3,30,13,17,39
CSKA Moscow,6555,2,12,3,5,28,18,10,39
Spart Moscow,6555,3,9,5,6,38,31,7,32
Krasnodar,6555,4,9,4,7,29,27,2,31
Zenit,6555,5,7,9,4,23,16,7,30
Terek Grozny,6555,6,7,7,6,22,24,-2,28
FK Rubin,6555,7,7,5,8,25,18,7,26
Rostov,6555,8,5,6,9,13,18,-5,21
Din Moscow,6555,9,5,6,9,17,24,-7,21
Amkar,6555,10,5,5,10,13,25,-12,20
Anzhi,6555,11,2,6,12,15,39,-24,12
Loko Moscow,6556,1,12,5,3,33,14,19,41
CSKA Moscow,6556,2,10,4,6,26,19,7,34
Zenit,6556,3,8,8,4,23,17,6,32
Krasnodar,6556,4,9,5,6,30,25,5,32
Spart Moscow,6556,5,8,7,5,36,29,7,31
Terek Grozny,6556,6,8,6,6,22,23,-1,30
Din Moscow,6556,7,6,7,7,21,23,-2,25
FK Rubin,6556,8,5,6,9,23,21,2,21
Amkar,6556,9,5,5,10,10,22,-12,20
Rostov,6556,10,4,7,9,12,19,-7,19
Anzhi,6556,11,2,6,12,16,40,-24,12
Loko Moscow,6557,1,13,5,2,33,12,21,44
CSKA Moscow,6557,2,11,4,5,27,17,10,37
Spart Moscow,6557,3,9,6,5,37,29,8,33
Krasnodar,6557,4,9,4,7,31,27,4,31
Zenit,6557,5,7,8,5,21,17,4,29
Terek Grozny,6557,6,7,5,8,21,25,-4,26
Din Moscow,6557,7,5,8,7,20,24,-4,23
Amkar,6557,8,6,4,10,11,22,-11,22
FK Rubin,6557,9,5,6,9,22,20,2,21
Rostov,6557,10,4,6,10,10,18,-8,18
Anzhi,6557,11,3,6,11,16,38,-22,15
Loko Moscow,6558,1,12,6,2,31,12,19,42
Spart Moscow,6558,2,11,5,4,39,27,12,38
CSKA Moscow,6558,3,10,4,6,26,19,7,34
Zenit,6558,4,8,8,4,23,15,8,32
Krasnodar,6558,5,8,6,6,28,25,3,30
Terek Grozny,6558,6,8,5,7,21,23,-2,29
Din Moscow,6558,7,6,6,8,19,22,-3,24
FK Rubin,6558,8,5,6,9,22,20,2,21
Amkar,6558,9,5,4,11,10,24,-14,19
Rostov,6558,10,4,6,10,12,20,-8,18
Anzhi,6558,11,2,6,12,15,39,-24,12
Loko Moscow,6559,1,11,6,3,29,14,15,39
CSKA Moscow,6559,2,11,3,6,29,21,8,36
Zenit,6559,3,8,9,3,24,14,10,33
Krasnodar,6559,4,9,5,6,32,26,6,32
Spart Moscow,6559,5,9,5,6,38,33,5,32
Terek Grozny,6559,6,8,6,6,24,25,-1,30
Din Moscow,6559,7,7,6,7,21,22,-1,27
FK Rubin,6559,8,5,6,9,23,20,3,21
Amkar,6559,9,5,5,10,16,25,-9,20
Rostov,6559,10,4,6,10,10,20,-10,18
Anzhi,6559,11,2,5,13,16,42,-26,11
Loko Moscow,6560,1,12,6,2,32,12,20,42
CSKA Moscow,6560,2,11,4,5,27,17,10,37
Spart Moscow,6560,3,9,6,5,35,27,8,33
Krasnodar,6560,4,9,5,6,32,25,7,32
Zenit,6560,5,7,9,4,21,15,6,30
Terek Grozny,6560,6,7,7,6,20,22,-2,28
Din Moscow,6560,7,6,7,7,19,22,-3,25
FK Rubin,6560,8,5,6,9,22,22,0,21
Rostov,6560,9,4,6,10,10,18,-8,18
Amkar,6560,10,4,6,10,10,23,-13,18
Anzhi,6560,11,2,6,12,14,39,-25,12
Loko Moscow,6561,1,11,5,4,29,15,14,38
Zenit,6561,2,9,8,3,25,14,11,35
CSKA Moscow,6561,3,10,4,6,27,20,7,34
Krasnodar,6561,4,10,4,6,31,25,6,34
Spart Moscow,6561,5,8,7,5,33,27,6,31
Terek Grozny,6561,6,8,6,6,23,24,-1,30
Din Moscow,6561,7,6,7,7,20,23,-3,25
FK Rubin,6561,8,5,5,10,24,22,2,20
Rostov,6561,9,4,7,9,10,17,-7,19
Amkar,6561,10,5,4,11,11,23,-12,19
Anzhi,6561,11,2,7,11,17,40,-23,13
Loko Moscow,6562,1,11,6,3,31,15,16,39
CSKA Moscow,6562,2,11,3,6,26,18,8,36
Spart Moscow,6562,3,10,5,5,37,29,8,35
Krasnodar,6562,4,10,4,6,34,26,8,34
Zenit,6562,5,7,9,4,21,14,7,30
Terek Grozny,6562,6,7,7,6,22,24,-2,28
FK Rubin,6562,7,6,5,9,23,21,2,23
Din Moscow,6562,8,5,6,9,19,25,-6,21
Amkar,6562,9,5,5,10,12,23,-11,20
Rostov,6562,10,4,6,10,11,19,-8,18
Anzhi,6562,11,3,6,11,16,38,-22,15
Loko Moscow,6563,1,11,7,2,31,13,18,40
Spart Moscow,6563,2,9,7,4,40,30,10,34
CSKA Moscow,6563,3,10,4,6,27,20,7,34
Zenit,6563,4,8,9,3,23,14,9,33
Krasnodar,6563,5,9,5,6,31,27,4,32
Terek Grozny,6563,6,7,6,7,22,25,-3,27
FK Rubin,6563,7,6,5,9,25,21,4,23
Din Moscow,6563,8,5,6,9,19,26,-7,21
Amkar,6563,9,5,5,10,11,23,-12,20
Rostov,6563,10,4,7,9,13,20,-7,19
Anzhi,6563,11,2,7,11,18,41,-23,13
Loko Moscow,6564,1,12,5,3,33,14,19,41
Spart Moscow,6564,2,10,5,5,39,29,10,35
Krasnodar,6564,3,10,4,6,33,26,7,34
CSKA Moscow,6564,4,10,4,6,27,21,6,34
Zenit,6564,5,8,8,4,24,16,8,32
Terek Grozny,6564,6,9,5,6,23,23,0,32
Din Moscow,6564,7,6,6,8,18,23,-5,24
FK Rubin,6564,8,5,5,10,21,21,0,20
Amkar,6564,9,5,4,11,12,25,-13,19
Rostov,6564,10,4,6,10,12,20,-8,18
Anzhi,6564,11,2,6,12,15,39,-24,12
Loko Moscow,6565,1,12,5,3,33,13,20,41
CSKA Moscow,6565,2,10,4,6,27,23,4,34
Zenit,6565,3,8,8,4,25,16,9,32
Spart Moscow,6565,4,8,7,5,36,30,6,31
Krasnodar,6565,5,9,4,7,30,28,2,31
Terek Grozny,6565,6,7,5,8,20,25,-5,26
Din Moscow,6565,7,6,7,7,22,24,-2,25
FK Rubin,6565,8,6,6,8,26,20,6,24
Amkar,6565,9,5,5,10,11,23,-12,20
Rostov,6565,10,4,7,9,11,18,-7,19
Anzhi,6565,11,3,6,11,18,39,-21,15
Loko Moscow,6566,1,12,6,2,32,13,19,42
Spart Moscow,6566,2,10,6,4,39,29,10,36
CSKA Moscow,6566,3,11,3,6,27,19,8,36
Zenit,6566,4,8,8,4,24,16,8,32
Krasnodar,6566,5,9,5,6,33,26,7,32
Terek Grozny,6566,6,7,5,8,20,30,-10,26
Din Moscow,6566,7,6,6,8,20,24,-4,24
FK Rubin,6566,8,5,5,10,23,24,-1,20
Amkar,6566,9,5,5,10,14,24,-10,20
Rostov,6566,10,4,6,10,11,19,-8,18
Anzhi,6566,11,3,5,12,19,38,-19,14
Loko Moscow,6567,1,12,5,3,33,14,19,41
Spart Moscow,6567,2,11,5,4,40,28,12,38
CSKA Moscow,6567,3,11,3,6,30,18,12,36
Zenit,6567,4,8,8,4,22,15,7,32
Krasnodar,6567,5,9,5,6,31,27,4,32
Terek Grozny,6567,6,8,6,6,24,25,-1,30
FK Rubin,6567,7,6,6,8,24,19,5,24
Din Moscow,6567,8,5,6,9,20,26,-6,21
Rostov,6567,9,4,6,10,10,19,-9,18
Amkar,6567,10,4,4,12,11,26,-15,16
Anzhi,6567,11,2,6,12,16,44,-28,12
Loko Moscow,6568,1,13,5,2,34,12,22,44
CSKA Moscow,6568,2,12,3,5,29,17,12,39
Spart Moscow,6568,3,9,6,5,38,30,8,33
Terek Grozny,6568,4,9,5,6,22,22,0,32
Krasnodar,6568,5,9,4,7,29,26,3,31
Zenit,6568,6,7,8,5,21,17,4,29
FK Rubin,6568,7,6,5,9,23,18,5,23
Din Moscow,6568,8,5,6,9,19,26,-7,21
Rostov,6568,9,4,7,9,11,18,-7,19
Amkar,6568,10,5,4,11,11,24,-13,19
Anzhi,6568,11,2,5,13,14,41,-27,11
Loko Moscow,6569,1,11,6,3,31,14,17,39
CSKA Moscow,6569,2,11,4,5,30,20,10,37
Spart Moscow,6569,3,9,6,5,37,27,10,33
Zenit,6569,4,8,9,3,24,15,9,33
Krasnodar,6569,5,8,5,7,29,29,0,29
Terek Grozny,6569,6,7,5,8,21,28,-7,26
FK Rubin,6569,7,6,6,8,24,17,7,24
Din Moscow,6569,8,5,8,7,17,21,-4,23
Amkar,6569,9,6,4,10,14,23,-9,22
Rostov,6569,10,4,6,10,10,20,-10,18
Anzhi,6569,11,3,5,12,18,41,-23,14
Loko Moscow,6570,1,12,6,2,31,12,19,42
CSKA Moscow,6570,2,11,4,5,27,18,9,37
Spart Moscow,6570,3,9,6,5,36,31,5,33
Zenit,6570,4,7,10,3,22,14,8,31
Krasnodar,6570,5,8,5,7,29,27,2,29
Din Moscow,6570,6,7,6,7,29,23,6,27
Terek Grozny,6570,7,7,6,7,22,26,-4,27
FK Rubin,6570,8,5,6,9,22,24,-2,21
Rostov,6570,9,4,6,10,10,18,-8,18
Amkar,6570,10,4,6,10,11,24,-13,18
Anzhi,6570,11,3,5,12,16,38,-22,14
Loko Moscow,6571,1,12,5,3,33,14,19,41
Spart Moscow,6571,2,11,5,4,38,25,13,38
CSKA Moscow,6571,3,11,3,6,29,20,9,36
Zenit,6571,4,9,8,3,26,14,12,35
Krasnodar,6571,5,8,4,8,29,29,0,28
Terek Grozny,6571,6,7,6,7,21,24,-3,27
FK Rubin,6571,7,6,6,8,24,19,5,24
Din Moscow,6571,8,5,7,8,18,24,-6,22
Rostov,6571,9,4,6,10,10,19,-9,18
Amkar,6571,10,4,5,11,10,24,-14,17
Anzhi,6571,11,3,5,12,15,41,-26,14
Loko Moscow,6572,1,11,5,4,30,14,16,38
CSKA Moscow,6572,2,11,3,6,29,21,8,36
Zenit,6572,3,9,8,3,24,14,10,35
Spart Moscow,6572,4,9,7,4,36,26,10,34
Krasnodar,6572,5,9,4,7,30,27,3,31
Terek Grozny,6572,6,7,6,7,21,25,-4,27
FK Rubin,6572,7,6,6,8,23,18,5,24
Din Moscow,6572,8,5,8,7,17,21,-4,23
Amkar,6572,9,5,5,10,12,23,-11,20
Rostov,6572,10,4,6,10,10,19,-9,18
Anzhi,6572,11,2,6,12,17,41,-24,12
Loko Moscow,6573,1,12,5,3,32,16,16,41
CSKA Moscow,6573,2,12,3,5,30,18,12,39
Krasnodar,6573,3,10,4,6,33,26,7,34
Spart Moscow,6573,4,8,7,5,34,27,7,31
Zenit,6573,5,7,8,5,23,17,6,29
Terek Grozny,6573,6,8,5,7,21,24,-3,29
Din Moscow,6573,7,7,6,7,20,22,-2,27
FK Rubin,6573,8,5,5,10,22,20,2,20
Rostov,6573,9,4,7,9,10,17,-7,19
Amkar,6573,10,4,5,11,9,23,-14,17
Anzhi,6573,11,3,5,12,16,40,-24,14
Loko Moscow,6574,1,12,5,3,31,12,19,41
CSKA Moscow,6574,2,12,3,5,27,17,10,39
Zenit,6574,3,8,8,4,22,14,8,32
Spart Moscow,6574,4,8,7,5,36,30,6,31
Krasnodar,6574,5,9,4,7,29,26,3,31
Terek Grozny,6574,6,8,5,7,22,24,-2,29
Din Moscow,6574,7,5,8,7,18,22,-4,23
FK Rubin,6574,8,5,6,9,22,20,2,21
Rostov,6574,9,5,6,9,13,18,-5,21
Amkar,6574,10,4,5,11,12,26,-14,17
Anzhi,6574,11,3,5,12,15,38,-23,14
Loko Moscow,6575,1,12,5,3,30,12,18,41
Spart Moscow,6575,2,11,5,4,39,27,12,38
CSKA Moscow,6575,3,11,3,6,29,24,5,36
Krasnodar,6575,4,10,4,6,30,25,5,34
Zenit,6575,5,8,8,4,26,14,12,32
Terek Grozny,6575,6,8,6,6,23,23,0,30
Din Moscow,6575,7,6,6,8,18,23,-5,24
FK Rubin,6575,8,5,5,10,22,20,2,20
Rostov,6575,9,4,6,10,10,18,-8,18
Amkar,6575,10,4,5,11,11,25,-14,17
Anzhi,6575,11,2,5,13,17,44,-27,11
Loko Moscow,6576,1,12,5,3,30,12,18,41
CSKA Moscow,6576,2,12,3,5,28,18,10,39
Spart Moscow,6576,3,10,6,4,35,25,10,36
Zenit,6576,4,8,8,4,22,14,8,32
Terek Grozny,6576,5,9,5,6,22,22,0,32
Krasnodar,6576,6,8,4,8,28,27,1,28
Din Moscow,6576,7,6,6,8,19,23,-4,24
FK Rubin,6576,8,6,5,9,24,20,4,23
Rostov,6576,9,4,7,9,10,17,-7,19
Amkar,6576,10,4,4,12,9,24,-15,16
Anzhi,6576,11,2,5,13,15,40,-25,11
Loko Moscow,6577,1,13,5,2,31,11,20,44
CSKA Moscow,6577,2,10,4,6,27,21,6,34
Spart Moscow,6577,3,9,6,5,37,27,10,33
Zenit,6577,4,8,8,4,24,15,9,32
Krasnodar,6577,5,9,4,7,28,25,3,31
Terek Grozny,6577,6,7,6,7,22,25,-3,27
Din Moscow,6577,7,6,6,8,20,26,-6,24
FK Rubin,6577,8,5,5,10,23,21,2,20
Amkar,6577,9,5,5,10,11,23,-12,20
Rostov,6577,10,4,7,9,11,18,-7,19
Anzhi,6577,11,3,6,11,17,39,-22,15
Loko Moscow,6578,1,11,5,4,29,13,16,38
CSKA Moscow,6578,2,10,4,6,26,20,6,34
Spart Moscow,6578,3,9,6,5,40,30,10,33
Zenit,6578,4,8,9,3,23,14,9,33
Krasnodar,6578,5,9,5,6,29,25,4,32
Terek Grozny,6578,6,8,5,7,24,26,-2,29
Din Moscow,6578,7,6,6,8,19,25,-6,24
Amkar,6578,8,6,4,10,18,25,-7,22
FK Rubin,6578,9,5,6,9,22,20,2,21
Rostov,6578,10,4,7,9,10,17,-7,19
Anzhi,6578,11,3,5,12,16,41,-25,14
Loko Moscow,6579,1,12,6,2,30,11,19,42
Spart Moscow,6579,2,11,5,4,40,28,12,38
CSKA Moscow,6579,3,11,3,6,28,20,8,36
Zenit,6579,4,8,9,3,23,14,9,33
Krasnodar,6579,5,9,4,7,29,25,4,31
Terek Grozny,6579,6,7,5,8,22,29,-7,26
Din Moscow,6579,7,6,6,8,21,22,-1,24
FK Rubin,6579,8,5,5,10,21,23,-2,20
Amkar,6579,9,5,4,11,15,26,-11,19
Rostov,6579,10,4,6,10,11,19,-8,18
Anzhi,6579,11,3,5,12,18,41,-23,14
Loko Moscow,6580,1,11,7,2,31,13,18,40
Spart Moscow,6580,2,11,5,4,38,27,11,38
Zenit,6580,3,8,9,3,25,14,11,33
CSKA Moscow,6580,4,10,3,7,25,21,4,33
Krasnodar,6580,5,9,5,6,30,25,5,32
Terek Grozny,6580,6,8,6,6,23,24,-1,30
Din Moscow,6580,7,6,6,8,19,23,-4,24
FK Rubin,6580,8,5,5,10,21,20,1,20
Rostov,6580,9,4,6,10,11,19,-8,18
Amkar,6580,10,4,4,12,10,25,-15,16
Anzhi,6580,11,3,6,11,16,38,-22,15
Loko Moscow,6581,1,11,7,2,31,13,18,40
CSKA Moscow,6581,2,11,4,5,26,17,9,37
Spart Moscow,6581,3,10,5,5,36,28,8,35
Zenit,6581,4,7,10,3,22,14,8,31
Krasnodar,6581,5,8,5,7,29,27,2,29
Terek Grozny,6581,6,7,7,6,23,25,-2,28
FK Rubin,6581,7,6,6,8,24,19,5,24
Din Moscow,6581,8,5,7,8,18,24,-6,22
Amkar,6581,9,5,5,10,14,24,-10,20
Rostov,6581,10,4,6,10,10,18,-8,18
Anzhi,6581,11,2,6,12,15,39,-24,12
Loko Moscow,6582,1,11,6,3,31,14,17,39
CSKA Moscow,6582,2,11,3,6,27,19,8,36
Zenit,6582,3,9,8,3,25,14,11,35
Spart Moscow,6582,4,9,6,5,39,28,11,33
Krasnodar,6582,5,9,5,6,29,25,4,32
Terek Grozny,6582,6,8,5,7,21,24,-3,29
Din Moscow,6582,7,5,8,7,18,22,-4,23
FK Rubin,6582,8,5,6,9,21,18,3,21
Amkar,6582,9,5,4,11,11,24,-13,19
Rostov,6582,10,4,6,10,10,21,-11,18
Anzhi,6582,11,3,5,12,16,39,-23,14
Loko Moscow,6583,1,11,7,2,31,13,18,40
CSKA Moscow,6583,2,12,3,5,31,19,12,39
Spart Moscow,6583,3,10,5,5,39,30,9,35
Zenit,6583,4,7,9,4,23,16,7,30
Krasnodar,6583,5,8,5,7,29,27,2,29
Terek Grozny,6583,6,7,6,7,22,25,-3,27
FK Rubin,6583,7,6,6,8,24,19,5,24
Din Moscow,6583,8,5,7,8,21,26,-5,22
Amkar,6583,9,6,4,10,14,23,-9,22
Rostov,6583,10,4,6,10,10,20,-10,18
Anzhi,6583,11,2,6,12,15,41,-26,12
Loko Moscow,6584,1,12,5,3,31,13,18,41
CSKA Moscow,6584,2,11,3,6,28,19,9,36
Krasnodar,6584,3,9,4,7,29,26,3,31
Spart Moscow,6584,4,8,6,6,34,29,5,30
Zenit,6584,5,7,8,5,21,16,5,29
Terek Grozny,6584,6,8,5,7,21,23,-2,29
FK Rubin,6584,7,7,5,8,23,17,6,26
Din Moscow,6584,8,6,6,8,19,23,-4,24
Rostov,6584,9,4,7,9,10,17,-7,19
Amkar,6584,10,5,4,11,11,23,-12,19
Anzhi,6584,11,4,5,11,17,38,-21,17
Loko Moscow,6585,1,11,6,3,30,13,17,39
Spart Moscow,6585,2,10,6,4,39,28,11,36
CSKA Moscow,6585,3,11,3,6,28,18,10,36
Krasnodar,6585,4,10,4,6,32,26,6,34
Zenit,6585,5,8,9,3,22,13,9,33
Terek Grozny,6585,6,7,7,6,21,23,-2,28
Din Moscow,6585,7,6,7,7,21,24,-3,25
FK Rubin,6585,8,5,5,10,23,22,1,20
Rostov,6585,9,4,6,10,10,19,-9,18
Amkar,6585,10,4,5,11,10,24,-14,17
Anzhi,6585,11,2,6,12,15,41,-26,12
Loko Moscow,6586,1,11,7,2,32,14,18,40
Spart Moscow,6586,2,10,5,5,40,32,8,35
CSKA Moscow,6586,3,10,5,5,26,18,8,35
Zenit,6586,4,7,10,3,22,14,8,31
Krasnodar,6586,5,8,5,7,30,28,2,29
Terek Grozny,6586,6,7,5,8,22,26,-4,26
FK Rubin,6586,7,6,6,8,23,18,5,24
Din Moscow,6586,8,5,7,8,19,25,-6,22
Rostov,6586,9,5,6,9,15,18,-3,21
Amkar,6586,10,5,4,11,10,24,-14,19
Anzhi,6586,11,3,6,11,18,40,-22,15
Loko Moscow,6587,1,11,5,4,31,15,16,38
CSKA Moscow,6587,2,11,4,5,27,18,9,37
Spart Moscow,6587,3,10,6,4,42,27,15,36
Krasnodar,6587,4,10,4,6,31,26,5,34
Zenit,6587,5,8,8,4,23,15,8,32
Terek Grozny,6587,6,7,6,7,21,24,-3,27
FK Rubin,6587,7,6,5,9,23,19,4,23
Din Moscow,6587,8,5,6,9,18,25,-7,21
Rostov,6587,9,4,6,10,11,23,-12,18
Amkar,6587,10,4,6,10,11,24,-13,18
Anzhi,6587,11,3,6,11,15,37,-22,15
Loko Moscow,6588,1,12,6,2,31,12,19,42
CSKA Moscow,6588,2,10,4,6,25,20,5,34
Zenit,6588,3,8,8,4,24,14,10,32
Krasnodar,6588,4,9,5,6,31,26,5,32
Spart Moscow,6588,5,8,6,6,36,31,5,30
Din Moscow,6588,6,7,6,7,21,22,-1,27
Terek Grozny,6588,7,7,6,7,20,23,-3,27
Amkar,6588,8,6,4,10,12,23,-11,22
FK Rubin,6588,9,5,5,10,23,22,1,20
Rostov,6588,10,4,7,9,12,19,-7,19
Anzhi,6588,11,2,7,11,14,37,-23,13
Loko Moscow,6589,1,13,5,2,32,12,20,44
CSKA Moscow,6589,2,12,3,5,29,19,10,39
Spart Moscow,6589,3,10,6,4,38,28,10,36
Krasnodar,6589,4,9,4,7,29,25,4,31
Zenit,6589,5,7,8,5,22,16,6,29
Terek Grozny,6589,6,8,5,7,23,26,-3,29
Din Moscow,6589,7,6,6,8,20,24,-4,24
FK Rubin,6589,8,5,5,10,21,20,1,20
Rostov,6589,9,4,7,9,11,18,-7,19
Amkar,6589,10,4,4,12,11,26,-15,16
Anzhi,6589,11,3,5,12,18,40,-22,14
Loko Moscow,6590,1,11,5,4,29,15,14,38
Spart Moscow,6590,2,11,5,4,37,25,12,38
CSKA Moscow,6590,3,10,5,5,27,19,8,35
Zenit,6590,4,8,9,3,24,14,10,33
Krasnodar,6590,5,9,4,7,30,26,4,31
Terek Grozny,6590,6,8,6,6,21,22,-1,30
Din Moscow,6590,7,6,6,8,18,22,-4,24
FK Rubin,6590,8,6,5,9,23,19,4,23
Rostov,6590,9,4,6,10,10,19,-9,18
Amkar,6590,10,4,4,12,9,24,-15,16
Anzhi,6590,11,2,7,11,15,38,-23,13
Loko Moscow,6591,1,13,5,2,33,12,21,44
CSKA Moscow,6591,2,11,4,5,28,18,10,37
Spart Moscow,6591,3,10,6,4,41,30,11,36
Zenit,6591,4,7,9,4,21,14,7,30
Terek Grozny,6591,5,8,6,6,21,22,-1,30
Krasnodar,6591,6,8,5,7,28,27,1,29
FK Rubin,6591,7,5,7,8,23,19,4,22
Din Moscow,6591,8,5,7,8,19,25,-6,22
Rostov,6591,9,4,7,9,11,18,-7,19
Amkar,6591,10,4,4,12,13,28,-15,16
Anzhi,6591,11,2,6,12,15,40,-25,12
Loko Moscow,6592,1,11,5,4,30,16,14,38
Spart Moscow,6592,2,10,6,4,37,26,11,36
Krasnodar,6592,3,10,4,6,32,25,7,34
CSKA Moscow,6592,4,10,4,6,25,19,6,34
Zenit,6592,5,8,9,3,22,13,9,33
Terek Grozny,6592,6,9,5,6,23,22,1,32
FK Rubin,6592,7,6,5,9,23,19,4,23
Din Moscow,6592,8,5,6,9,18,24,-6,21
Rostov,6592,9,4,7,9,11,18,-7,19
Amkar,6592,10,4,4,12,9,25,-16,16
Anzhi,6592,11,3,5,12,16,39,-23,14
Loko Moscow,6593,1,11,6,3,30,14,16,39
CSKA Moscow,6593,2,11,3,6,27,18,9,36
Spart Moscow,6593,3,10,5,5,37,27,10,35
Zenit,6593,4,8,8,4,23,15,8,32
Krasnodar,6593,5,9,5,6,31,25,6,32
Terek Grozny,6593,6,8,6,6,23,23,0,30
Din Moscow,6593,7,5,7,8,18,24,-6,22
FK Rubin,6593,8,5,6,9,22,21,1,21
Amkar,6593,9,5,5,10,11,23,-12,20
Rostov,6593,10,4,6,10,11,19,-8,18
Anzhi,6593,11,3,5,12,15,39,-24,14
Loko Moscow,6594,1,12,6,2,33,11,22,42
CSKA Moscow,6594,2,11,3,6,29,19,10,36
Spart Moscow,6594,3,10,5,5,40,30,10,35
Zenit,6594,4,8,8,4,23,18,5,32
Krasnodar,6594,5,8,5,7,27,25,2,29
Terek Grozny,6594,6,7,7,6,22,24,-2,28
FK Rubin,6594,7,6,6,8,23,18,5,24
Din Moscow,6594,8,5,7,8,18,23,-5,22
Amkar,6594,9,5,5,10,14,25,-11,20
Rostov,6594,10,4,6,10,11,21,-10,18
Anzhi,6594,11,2,6,12,15,41,-26,12
Loko Moscow,6595,1,11,6,3,29,14,15,39
CSKA Moscow,6595,2,11,4,5,29,17,12,37
Spart Moscow,6595,3,9,6,5,34,26,8,33
Terek Grozny,6595,4,9,5,6,26,25,1,32
Zenit,6595,5,7,10,3,21,13,8,31
Krasnodar,6595,6,9,4,7,31,27,4,31
Din Moscow,6595,7,7,6,7,21,22,-1,27
FK Rubin,6595,8,6,5,9,25,21,4,23
Rostov,6595,9,4,6,10,10,18,-8,18
Amkar,6595,10,4,5,11,10,25,-15,17
Anzhi,6595,11,2,5,13,16,44,-28,11
Loko Moscow,6596,1,12,6,2,34,14,20,42
Spart Moscow,6596,2,10,6,4,37,27,10,36
CSKA Moscow,6596,3,11,3,6,29,22,7,36
Zenit,6596,4,8,9,3,26,16,10,33
Krasnodar,6596,5,8,5,7,27,26,1,29
Terek Grozny,6596,6,7,5,8,21,25,-4,26
FK Rubin,6596,7,5,7,8,21,17,4,22
Din Moscow,6596,8,5,7,8,18,23,-5,22
Amkar,6596,9,5,5,10,10,22,-12,20
Rostov,6596,10,4,6,10,11,19,-8,18
Anzhi,6596,11,3,5,12,19,42,-23,14
Loko Moscow,6597,1,12,6,2,32,12,20,42
CSKA Moscow,6597,2,10,5,5,27,19,8,35
Spart Moscow,6597,3,9,7,4,38,28,10,34
Zenit,6597,4,7,10,3,22,14,8,31
Krasnodar,6597,5,8,4,8,29,29,0,28
Terek Grozny,6597,6,7,7,6,21,23,-2,28
FK Rubin,6597,7,7,5,8,25,19,6,26
Din Moscow,6597,8,5,7,8,20,25,-5,22
Rostov,6597,9,4,6,10,11,20,-9,18
Amkar,6597,10,4,6,10,10,23,-13,18
Anzhi,6597,11,2,7,11,15,38,-23,13
Loko Moscow,6598,1,11,6,3,30,14,16,39
CSKA Moscow,6598,2,11,4,5,28,19,9,37
Spart Moscow,6598,3,9,6,5,35,27,8,33
Zenit,6598,4,8,8,4,24,15,9,32
Terek Grozny,6598,5,8,6,6,25,26,-1,30
Krasnodar,6598,6,8,5,7,28,27,1,29
Din Moscow,6598,7,6,6,8,20,24,-4,24
FK Rubin,6598,8,6,5,9,24,19,5,23
Amkar,6598,9,5,5,10,13,25,-12,20
Rostov,6598,10,4,7,9,10,17,-7,19
Anzhi,6598,11,2,6,12,16,40,-24,12
Loko Moscow,6599,1,11,6,3,31,14,17,39
Spart Moscow,6599,2,11,5,4,38,25,13,38
CSKA Moscow,6599,3,11,4,5,28,18,10,37
Zenit,6599,4,7,10,3,23,15,8,31
Krasnodar,6599,5,9,4,7,32,29,3,31
Terek Grozny,6599,6,7,7,6,23,25,-2,28
FK Rubin,6599,7,6,6,8,26,21,5,24
Din Moscow,6599,8,5,7,8,18,23,-5,22
Rostov,6599,9,4,6,10,10,19,-9,18
Amkar,6599,10,4,5,11,11,26,-15,17
Anzhi,6599,11,2,6,12,15,40,-25,12
Loko Moscow,6600,1,12,6,2,35,11,24,42
Spart Moscow,6600,2,10,6,4,40,27,13,36
CSKA Moscow,6600,3,11,3,6,27,20,7,36
Krasnodar,6600,4,9,5,6,30,25,5,32
Zenit,6600,5,8,8,4,23,19,4,32
Terek Grozny,6600,6,7,7,6,21,23,-2,28
Din Moscow,6600,7,5,8,7,18,22,-4,23
FK Rubin,6600,8,5,6,9,22,20,2,21
Rostov,6600,9,4,6,10,11,22,-11,18
Amkar,6600,10,4,5,11,9,23,-14,17
Anzhi,6600,11,2,6,12,16,40,-24,12
Loko Moscow,6601,1,12,6,2,33,14,19,42
Spart Moscow,6601,2,10,6,4,40,28,12,36
CSKA Moscow,6601,3,10,5,5,26,18,8,35
Krasnodar,6601,4,9,5,6,32,27,5,32
Zenit,6601,5,7,9,4,23,16,7,30
Terek Grozny,6601,6,7,5,8,21,25,-4,26
Din Moscow,6601,7,6,6,8,21,25,-4,24
FK Rubin,6601,8,5,5,10,23,22,1,20
Amkar,6601,9,5,5,10,11,23,-12,20
Rostov,6601,10,4,6,10,11,21,-10,18
Anzhi,6601,11,3,6,11,15,37,-22,15
Loko Moscow,6602,1,12,5,3,30,12,18,41
CSKA Moscow,6602,2,11,4,5,31,20,11,37
Spart Moscow,6602,3,10,6,4,39,28,11,36
Krasnodar,6602,4,9,4,7,28,26,2,31
Zenit,6602,5,7,9,4,22,15,7,30
Terek Grozny,6602,6,8,5,7,22,23,-1,29
FK Rubin,6602,7,6,6,8,23,17,6,24
Din Moscow,6602,8,5,8,7,18,22,-4,23
Rostov,6602,9,4,6,10,11,20,-9,18
Amkar,6602,10,4,4,12,10,26,-16,16
Anzhi,6602,11,3,5,12,17,42,-25,14
Loko Moscow,6603,1,12,6,2,32,13,19,42
CSKA Moscow,6603,2,11,4,5,27,17,10,37
Krasnodar,6603,3,9,5,6,32,27,5,32
Zenit,6603,4,7,9,4,21,14,7,30
Spart Moscow,6603,5,8,6,6,34,32,2,30
Terek Grozny,6603,6,7,7,6,21,23,-2,28
Din Moscow,6603,7,6,6,8,18,22,-4,24
FK Rubin,6603,8,6,5,9,23,20,3,23
Amkar,6603,9,5,5,10,14,22,-8,20
Rostov,6603,10,4,7,9,11,18,-7,19
Anzhi,6603,11,2,6,12,15,40,-25,12
Loko Moscow,6604,1,13,5,2,32,11,21,44
CSKA Moscow,6604,2,11,3,6,27,22,5,36
Spart Moscow,6604,3,10,5,5,38,29,9,35
Zenit,6604,4,8,8,4,25,15,10,32
Terek Grozny,6604,5,8,6,6,22,23,-1,30
Krasnodar,6604,6,8,5,7,28,26,2,29
FK Rubin,6604,7,6,6,8,24,19,5,24
Din Moscow,6604,8,5,6,9,19,25,-6,21
Rostov,6604,9,5,6,9,12,18,-6,21
Amkar,6604,10,4,5,11,11,25,-14,17
Anzhi,6604,11,2,5,13,15,40,-25,11
Loko Moscow,6605,1,11,6,3,30,13,17,39
CSKA Moscow,6605,2,12,3,5,28,18,10,39
Krasnodar,6605,3,10,4,6,29,24,5,34
Spart Moscow,6605,4,8,7,5,38,33,5,31
Zenit,6605,5,7,9,4,22,15,7,30
Terek Grozny,6605,6,7,7,6,20,22,-2,28
Din Moscow,6605,7,5,8,7,19,23,-4,23
FK Rubin,6605,8,5,6,9,22,19,3,21
Amkar,6605,9,5,5,10,15,25,-10,20
Rostov,6605,10,4,7,9,11,18,-7,19
Anzhi,6605,11,2,6,12,15,39,-24,12
Loko Moscow,6606,1,13,5,2,33,12,21,44
CSKA Moscow,6606,2,11,3,6,30,20,10,36
Spart Moscow,6606,3,10,5,5,41,27,14,35
Zenit,6606,4,8,8,4,23,16,7,32
Terek Grozny,6606,5,9,5,6,22,22,0,32
Krasnodar,6606,6,8,4,8,29,28,1,28
FK Rubin,6606,7,7,5,8,26,19,7,26
Din Moscow,6606,8,5,6,9,18,26,-8,21
Amkar,6606,9,5,4,11,10,23,-13,19
Rostov,6606,10,4,6,10,11,23,-12,18
Anzhi,6606,11,2,5,13,15,42,-27,11
Loko Moscow,6607,1,11,5,4,30,14,16,38
CSKA Moscow,6607,2,11,3,6,27,19,8,36
Spart Moscow,6607,3,10,5,5,36,27,9,35
Zenit,6607,4,8,8,4,24,16,8,32
Krasnodar,6607,5,9,4,7,29,26,3,31
Terek Grozny,6607,6,8,6,6,25,25,0,30
Din Moscow,6607,7,7,6,7,19,21,-2,27
FK Rubin,6607,8,6,5,9,23,19,4,23
Rostov,6607,9,4,6,10,10,18,-8,18
Amkar,6607,10,4,4,12,10,26,-16,16
Anzhi,6607,11,3,6,11,18,40,-22,15
Loko Moscow,6608,1,12,5,3,31,13,18,41
CSKA Moscow,6608,2,11,4,5,28,19,9,37
Spart Moscow,6608,3,10,6,4,38,26,12,36
Terek Grozny,6608,4,9,5,6,23,23,0,32
Krasnodar,6608,5,9,4,7,28,25,3,31
Zenit,6608,6,7,9,4,22,15,7,30
FK Rubin,6608,7,7,5,8,25,17,8,26
Din Moscow,6608,8,5,6,9,17,25,-8,21
Rostov,6608,9,4,7,9,11,18,-7,19
Amkar,6608,10,4,4,12,9,26,-17,16
Anzhi,6608,11,2,5,13,17,42,-25,11
Loko Moscow,6609,1,13,5,2,33,12,21,44
CSKA Moscow,6609,2,11,3,6,27,21,6,36
Spart Moscow,6609,3,10,5,5,38,29,9,35
Zenit,6609,4,8,8,4,26,17,9,32
Terek Grozny,6609,5,9,5,6,24,24,0,32
Krasnodar,6609,6,9,4,7,30,27,3,31
Din Moscow,6609,7,6,7,7,19,22,-3,25
FK Rubin,6609,8,5,6,9,24,21,3,21
Rostov,6609,9,4,6,10,13,21,-8,18
Amkar,6609,10,4,4,12,11,26,-15,16
Anzhi,6609,11,2,5,13,14,39,-25,11
Loko Moscow,6610,1,11,5,4,31,17,14,38
CSKA Moscow,6610,2,11,4,5,26,17,9,37
Spart Moscow,6610,3,10,6,4,40,30,10,36
Zenit,6610,4,8,8,4,24,16,8,32
Krasnodar,6610,5,9,5,6,31,25,6,32
Terek Grozny,6610,6,7,6,7,23,27,-4,27
Din Moscow,6610,7,6,6,8,22,26,-4,24
FK Rubin,6610,8,5,6,9,23,20,3,21
Rostov,6610,9,4,7,9,11,18,-7,19
Amkar,6610,10,5,4,11,12,24,-12,19
Anzhi,6610,11,2,7,11,17,40,-23,13
Loko Moscow,6611,1,11,6,3,30,14,16,39
CSKA Moscow,6611,2,11,3,6,31,22,9,36
Krasnodar,6611,3,10,4,6,32,26,6,34
Zenit,6611,4,8,9,3,25,15,10,33
Spart Moscow,6611,5,9,6,5,35,28,7,33
Terek Grozny,6611,6,8,6,6,23,23,0,30
Din Moscow,6611,7,6,6,8,18,22,-4,24
FK Rubin,6611,8,5,5,10,23,21,2,20
Amkar,6611,9,5,5,10,12,23,-11,20
Rostov,6611,10,4,7,9,11,18,-7,19
Anzhi,6611,11,2,5,13,16,44,-28,11
Loko Moscow,6612,1,12,5,3,33,16,17,41
CSKA Moscow,6612,2,11,3,6,27,19,8,36
Spart Moscow,6612,3,10,5,5,39,28,11,35
Krasnodar,6612,4,10,4,6,32,26,6,34
Zenit,6612,5,8,8,4,26,18,8,32
Din Moscow,6612,6,7,6,7,20,22,-2,27
Terek Grozny,6612,7,7,6,7,20,23,-3,27
FK Rubin,6612,8,5,5,10,23,21,2,20
Rostov,6612,9,4,6,10,11,19,-8,18
Amkar,6612,10,4,5,11,9,25,-16,17
Anzhi,6612,11,3,5,12,15,38,-23,14
Loko Moscow,6613,1,13,5,2,35,15,20,44
CSKA Moscow,6613,2,12,3,5,33,17,16,39
Spart Moscow,6613,3,8,8,4,38,30,8,32
Krasnodar,6613,4,9,4,7,32,28,4,31
Zenit,6613,5,7,8,5,23,21,2,29
Terek Grozny,6613,6,8,5,7,22,24,-2,29
Din Moscow,6613,7,6,7,7,21,24,-3,25
FK Rubin,6613,8,5,5,10,22,21,1,20
Amkar,6613,9,5,5,10,10,22,-12,20
Rostov,6613,10,4,7,9,12,19,-7,19
Anzhi,6613,11,2,5,13,15,42,-27,11
Loko Moscow,6614,1,12,5,3,30,13,17,41
CSKA Moscow,6614,2,11,4,5,29,19,10,37
Spart Moscow,6614,3,9,5,6,37,30,7,32
Krasnodar,6614,4,9,5,6,29,24,5,32
Zenit,6614,5,7,8,5,21,16,5,29
Terek Grozny,6614,6,8,5,7,22,24,-2,29
FK Rubin,6614,7,5,7,8,21,17,4,22
Din Moscow,6614,8,5,7,8,18,23,-5,22
Rostov,6614,9,5,6,9,11,17,-6,21
Amkar,6614,10,5,4,11,13,26,-13,19
Anzhi,6614,11,3,6,11,17,39,-22,15
Loko Moscow,6615,1,11,6,3,31,14,17,39
CSKA Moscow,6615,2,10,4,6,26,19,7,34
Zenit,6615,3,8,9,3,23,14,9,33
Krasnodar,6615,4,9,4,7,29,27,2,31
Spart Moscow,6615,5,8,6,6,35,30,5,30
Terek Grozny,6615,6,7,7,6,23,25,-2,28
Din Moscow,6615,7,6,7,7,18,21,-3,25
FK Rubin,6615,8,6,6,8,23,17,6,24
Amkar,6615,9,5,5,10,12,23,-11,20
Rostov,6615,10,4,7,9,12,19,-7,19
Anzhi,6615,11,2,7,11,17,40,-23,13
Loko Moscow,6616,1,12,5,3,31,13,18,41
CSKA Moscow,6616,2,11,4,5,28,18,10,37
Zenit,6616,3,8,9,3,24,15,9,33
Spart Moscow,6616,4,9,6,5,35,27,8,33
Krasnodar,6616,5,9,4,7,28,25,3,31
Din Moscow,6616,6,7,6,7,21,21,0,27
Terek Grozny,6616,7,7,6,7,20,23,-3,27
FK Rubin,6616,8,5,5,10,21,20,1,20
Rostov,6616,9,4,7,9,10,17,-7,19
Amkar,6616,10,4,5,11,9,24,-15,17
Anzhi,6616,11,3,5,12,15,39,-24,14
Loko Moscow,6617,1,12,5,3,32,13,19,41
Spart Moscow,6617,2,10,6,4,39,28,11,36
CSKA Moscow,6617,3,11,3,6,28,18,10,36
Zenit,6617,4,8,8,4,23,16,7,32
Krasnodar,6617,5,9,5,6,28,24,4,32
Terek Grozny,6617,6,8,6,6,25,25,0,30
Din Moscow,6617,7,6,6,8,18,23,-5,24
FK Rubin,6617,8,5,6,9,21,18,3,21
Rostov,6617,9,4,7,9,13,20,-7,19
Amkar,6617,10,4,5,11,11,25,-14,17
Anzhi,6617,11,2,5,13,15,43,-28,11
Loko Moscow,6618,1,11,6,3,30,13,17,39
CSKA Moscow,6618,2,11,4,5,29,19,10,37
Spart Moscow,6618,3,10,6,4,43,29,14,36
Krasnodar,6618,4,9,4,7,28,25,3,31
Zenit,6618,5,7,9,4,22,16,6,30
Terek Grozny,6618,6,7,6,7,22,25,-3,27
Din Moscow,6618,7,6,6,8,24,29,-5,24
FK Rubin,6618,8,6,5,9,24,22,2,23
Amkar,6618,9,5,5,10,12,24,-12,20
Rostov,6618,10,4,6,10,11,20,-9,18
Anzhi,6618,11,2,7,11,17,40,-23,13
Loko Moscow,6619,1,11,5,4,29,15,14,38
CSKA Moscow,6619,2,11,3,6,28,19,9,36
Zenit,6619,3,9,8,3,24,14,10,35
Spart Moscow,6619,4,9,7,4,37,28,9,34
Krasnodar,6619,5,10,4,6,32,25,7,34
Terek Grozny,6619,6,7,6,7,22,25,-3,27
Din Moscow,6619,7,6,6,8,20,24,-4,24
FK Rubin,6619,8,5,5,10,23,21,2,20
Amkar,6619,9,5,5,10,13,25,-12,20
Rostov,6619,10,4,7,9,10,17,-7,19
Anzhi,6619,11,2,6,12,15,40,-25,12
Loko Moscow,6620,1,11,7,2,29,11,18,40
Spart Moscow,6620,2,11,5,4,41,30,11,38
CSKA Moscow,6620,3,11,4,5,29,18,11,37
Zenit,6620,4,7,10,3,22,14,8,31
Krasnodar,6620,5,8,6,6,27,24,3,30
Terek Grozny,6620,6,8,6,6,22,23,-1,30
FK Rubin,6620,7,6,6,8,23,18,5,24
Din Moscow,6620,8,5,6,9,20,26,-6,21
Rostov,6620,9,4,6,10,12,20,-8,18
Amkar,6620,10,4,5,11,10,24,-14,17
Anzhi,6620,11,2,5,13,15,42,-27,11
Loko Moscow,6621,1,12,6,2,32,13,19,42
Spart Moscow,6621,2,10,5,5,39,30,9,35
CSKA Moscow,6621,3,10,5,5,30,22,8,35
Zenit,6621,4,7,10,3,25,17,8,31
Krasnodar,6621,5,8,5,7,29,27,2,29
Terek Grozny,6621,6,8,5,7,22,24,-2,29
Din Moscow,6621,7,6,6,8,22,25,-3,24
Amkar,6621,8,6,4,10,13,24,-11,22
FK Rubin,6621,9,5,6,9,23,21,2,21
Rostov,6621,10,4,6,10,11,19,-8,18
Anzhi,6621,11,2,6,12,16,40,-24,12
Loko Moscow,6622,1,12,5,3,31,15,16,41
CSKA Moscow,6622,2,11,4,5,28,18,10,37
Spart Moscow,6622,3,10,6,4,38,27,11,36
Zenit,6622,4,8,9,3,24,13,11,33
Krasnodar,6622,5,9,4,7,31,28,3,31
Terek Grozny,6622,6,7,6,7,21,24,-3,27
FK Rubin,6622,7,6,5,9,24,20,4,23
Din Moscow,6622,8,5,6,9,17,23,-6,21
Rostov,6622,9,4,6,10,11,20,-9,18
Amkar,6622,10,4,6,10,11,24,-13,18
Anzhi,6622,11,3,5,12,16,40,-24,14
Loko Moscow,6623,1,11,5,4,29,16,13,38
CSKA Moscow,6623,2,11,3,6,30,19,11,36
Zenit,6623,3,9,8,3,24,14,10,35
Krasnodar,6623,4,10,4,6,32,24,8,34
Spart Moscow,6623,5,9,6,5,37,31,6,33
Terek Grozny,6623,6,7,6,7,23,26,-3,27
Din Moscow,6623,7,6,6,8,21,24,-3,24
FK Rubin,6623,8,6,5,9,23,18,5,23
Rostov,6623,9,4,7,9,12,19,-7,19
Amkar,6623,10,5,4,11,12,25,-13,19
Anzhi,6623,11,2,6,12,15,42,-27,12
Loko Moscow,6624,1,11,5,4,33,20,13,38
CSKA Moscow,6624,2,11,4,5,26,17,9,37
Spart Moscow,6624,3,10,6,4,38,26,12,36
Krasnodar,6624,4,10,4,6,36,27,9,34
Zenit,6624,5,8,9,3,24,15,9,33
Terek Grozny,6624,6,7,6,7,21,24,-3,27
Din Moscow,6624,7,5,8,7,17,21,-4,23
FK Rubin,6624,8,5,6,9,22,20,2,21
Rostov,6624,9,4,6,10,11,20,-9,18
Amkar,6624,10,4,5,11,10,25,-15,17
Anzhi,6624,11,3,5,12,15,38,-23,14
Loko Moscow,6625,1,12,5,3,30,14,16,41
CSKA Moscow,6625,2,11,4,5,30,19,11,37
Spart Moscow,6625,3,10,6,4,42,29,13,36
Krasnodar,6625,4,9,4,7,31,27,4,31
Zenit,6625,5,7,9,4,23,16,7,30
Terek Grozny,6625,6,7,7,6,22,24,-2,28
FK Rubin,6625,7,6,6,8,24,18,6,24
Din Moscow,6625,8,5,7,8,18,24,-6,22
Rostov,6625,9,4,6,10,11,21,-10,18
Amkar,6625,10,4,6,10,13,26,-13,18
Anzhi,6625,11,2,6,12,14,40,-26,12
Loko Moscow,6626,1,12,6,2,34,15,19,42
Spart Moscow,6626,2,10,5,5,36,26,10,35
CSKA Moscow,6626,3,10,4,6,26,19,7,34
Zenit,6626,4,8,9,3,22,13,9,33
Krasnodar,6626,5,9,4,7,34,30,4,31
Terek Grozny,6626,6,8,5,7,21,23,-2,29
Din Moscow,6626,7,6,6,8,19,23,-4,24
Rostov,6626,8,5,6,9,11,17,-6,21
FK Rubin,6626,9,5,5,10,23,22,1,20
Amkar,6626,10,4,4,12,9,25,-16,16
Anzhi,6626,11,3,6,11,16,38,-22,15
Loko Moscow,6627,1,13,5,2,35,12,23,44
CSKA Moscow,6627,2,12,3,5,28,18,10,39
Spart Moscow,6627,3,9,6,5,38,29,9,33
Krasnodar,6627,4,9,4,7,30,26,4,31
Zenit,6627,5,7,8,5,21,18,3,29
Terek Grozny,6627,6,7,6,7,22,25,-3,27
FK Rubin,6627,7,6,5,9,22,19,3,23
Rostov,6627,8,5,6,9,12,18,-6,21
Din Moscow,6627,9,5,6,9,17,24,-7,21
Amkar,6627,10,4,6,10,12,25,-13,18
Anzhi,6627,11,3,5,12,17,40,-23,14
Loko Moscow,6628,1,12,5,3,32,12,20,41
CSKA Moscow,6628,2,12,3,5,30,19,11,39
Spart Moscow,6628,3,11,5,4,38,26,12,38
Zenit,6628,4,8,8,4,22,14,8,32
Terek Grozny,6628,5,9,5,6,23,22,1,32
Krasnodar,6628,6,8,4,8,27,29,-2,28
FK Rubin,6628,7,7,5,8,27,17,10,26
Din Moscow,6628,8,5,6,9,17,27,-10,21
Rostov,6628,9,4,6,10,10,18,-8,18
Amkar,6628,10,4,4,12,10,25,-15,16
Anzhi,6628,11,2,5,13,16,43,-27,11
Loko Moscow,6629,1,13,5,2,34,13,21,44
CSKA Moscow,6629,2,10,4,6,25,19,6,34
Spart Moscow,6629,3,9,5,6,37,29,8,32
Zenit,6629,4,8,8,4,23,15,8,32
Krasnodar,6629,5,9,4,7,30,27,3,31
Terek Grozny,6629,6,8,6,6,22,23,-1,30
Din Moscow,6629,7,6,6,8,20,25,-5,24
Rostov,6629,8,5,6,9,13,18,-5,21
FK Rubin,6629,9,5,5,10,22,21,1,20
Amkar,6629,10,5,5,10,10,22,-12,20
Anzhi,6629,11,2,6,12,15,39,-24,12
CSKA Moscow,6630,1,12,3,5,28,18,10,39
Loko Moscow,6630,2,11,5,4,33,17,16,38
Spart Moscow,6630,3,11,5,4,37,25,12,38
Zenit,6630,4,8,8,4,26,18,8,32
Krasnodar,6630,5,9,5,6,30,26,4,32
Terek Grozny,6630,6,7,6,7,22,26,-4,27
FK Rubin,6630,7,6,6,8,24,18,6,24
Din Moscow,6630,8,5,6,9,17,24,-7,21
Amkar,6630,9,5,4,11,11,23,-12,19
Rostov,6630,10,4,6,10,10,19,-9,18
Anzhi,6630,11,2,6,12,16,40,-24,12
Loko Moscow,6631,1,12,5,3,31,13,18,41
Spart Moscow,6631,2,11,5,4,37,25,12,38
CSKA Moscow,6631,3,11,4,5,28,19,9,37
Krasnodar,6631,4,10,4,6,30,24,6,34
Zenit,6631,5,7,9,4,23,16,7,30
Terek Grozny,6631,6,7,6,7,22,25,-3,27
FK Rubin,6631,7,6,5,9,22,19,3,23
Din Moscow,6631,8,5,6,9,17,23,-6,21
Amkar,6631,9,5,4,11,11,24,-13,19
Rostov,6631,10,4,6,10,10,19,-9,18
Anzhi,6631,11,2,6,12,16,40,-24,12
Loko Moscow,6632,1,12,5,3,33,16,17,41
CSKA Moscow,6632,2,12,3,5,34,17,17,39
Krasnodar,6632,3,9,4,7,32,29,3,31
Spart Moscow,6632,4,8,5,7,33,29,4,29
Zenit,6632,5,7,8,5,22,18,4,29
Terek Grozny,6632,6,7,6,7,20,23,-3,27
Din Moscow,6632,7,6,7,7,19,22,-3,25
FK Rubin,6632,8,6,6,8,25,19,6,24
Amkar,6632,9,6,4,10,11,22,-11,22
Rostov,6632,10,5,6,9,12,17,-5,21
Anzhi,6632,11,2,6,12,14,43,-29,12
Loko Moscow,6633,1,11,6,3,29,14,15,39
CSKA Moscow,6633,2,11,4,5,28,19,9,37
Spart Moscow,6633,3,9,5,6,36,29,7,32
Krasnodar,6633,4,9,5,6,31,25,6,32
Zenit,6633,5,7,10,3,22,14,8,31
Terek Grozny,6633,6,8,6,6,24,24,0,30
Din Moscow,6633,7,7,6,7,21,21,0,27
FK Rubin,6633,8,5,6,9,22,20,2,21
Amkar,6633,9,5,4,11,10,24,-14,19
Rostov,6633,10,4,6,10,11,20,-9,18
Anzhi,6633,11,2,6,12,17,41,-24,12
Loko Moscow,6634,1,12,5,3,31,13,18,41
CSKA Moscow,6634,2,10,4,6,26,19,7,34
Spart Moscow,6634,3,9,6,5,37,29,8,33
Zenit,6634,4,8,8,4,22,15,7,32
Terek Grozny,6634,5,9,5,6,22,22,0,32
Krasnodar,6634,6,9,4,7,29,25,4,31
Din Moscow,6634,7,6,7,7,20,22,-2,25
FK Rubin,6634,8,6,5,9,22,19,3,23
Amkar,6634,9,5,4,11,12,25,-13,19
Rostov,6634,10,4,6,10,10,18,-8,18
Anzhi,6634,11,2,6,12,15,39,-24,12
Loko Moscow,6635,1,12,6,2,31,12,19,42
CSKA Moscow,6635,2,12,3,5,29,17,12,39
Spart Moscow,6635,3,10,5,5,37,28,9,35
Krasnodar,6635,4,9,5,6,33,26,7,32
Zenit,6635,5,7,8,5,21,16,5,29
Terek Grozny,6635,6,8,5,7,21,23,-2,29
Din Moscow,6635,7,6,7,7,21,24,-3,25
FK Rubin,6635,8,5,6,9,23,23,0,21
Rostov,6635,9,4,6,10,10,18,-8,18
Amkar,6635,10,4,4,12,9,24,-15,16
Anzhi,6635,11,3,5,12,15,39,-24,14
Loko Moscow,6636,1,12,5,3,33,13,20,41
CSKA Moscow,6636,2,11,3,6,29,19,10,36
Spart Moscow,6636,3,10,5,5,40,28,12,35
Zenit,6636,4,8,8,4,23,16,7,32
Krasnodar,6636,5,9,4,7,30,28,2,31
Terek Grozny,6636,6,8,6,6,21,22,-1,30
Din Moscow,6636,7,6,6,8,21,27,-6,24
FK Rubin,6636,8,6,5,9,25,21,4,23
Amkar,6636,9,5,5,10,10,22,-12,20
Rostov,6636,10,4,6,10,11,19,-8,18
Anzhi,6636,11,2,5,13,14,42,-28,11
Loko Moscow,6637,1,11,6,3,32,15,17,39
Spart Moscow,6637,2,11,5,4,42,27,15,38
CSKA Moscow,6637,3,11,4,5,26,17,9,37
Zenit,6637,4,8,8,4,24,16,8,32
Krasnodar,6637,5,8,6,6,30,27,3,30
Terek Grozny,6637,6,8,6,6,23,24,-1,30
Din Moscow,6637,7,6,6,8,19,26,-7,24
FK Rubin,6637,8,5,6,9,24,21,3,21
Rostov,6637,9,4,6,10,10,19,-9,18
Amkar,6637,10,4,4,12,12,27,-15,16
Anzhi,6637,11,2,7,11,15,38,-23,13
Loko Moscow,6638,1,12,6,2,31,11,20,42
CSKA Moscow,6638,2,10,5,5,27,19,8,35
Spart Moscow,6638,3,9,6,5,36,27,9,33
Krasnodar,6638,4,9,5,6,29,25,4,32
Zenit,6638,5,7,9,4,23,17,6,30
Terek Grozny,6638,6,7,7,6,22,24,-2,28
Din Moscow,6638,7,5,7,8,18,24,-6,22
FK Rubin,6638,8,5,6,9,23,20,3,21
Rostov,6638,9,5,6,9,11,17,-6,21
Amkar,6638,10,4,6,10,11,24,-13,18
Anzhi,6638,11,2,7,11,15,38,-23,13
Loko Moscow,6639,1,12,5,3,32,12,20,41
CSKA Moscow,6639,2,11,4,5,30,20,10,37
Zenit,6639,3,8,9,3,25,16,9,33
Spart Moscow,6639,4,9,6,5,37,29,8,33
Krasnodar,6639,5,8,4,8,27,28,-1,28
Terek Grozny,6639,6,7,5,8,24,30,-6,26
Din Moscow,6639,7,6,7,7,20,23,-3,25
FK Rubin,6639,8,6,6,8,23,18,5,24
Amkar,6639,9,5,5,10,13,25,-12,20
Rostov,6639,10,4,6,10,10,18,-8,18
Anzhi,6639,11,3,5,12,20,42,-22,14
Loko Moscow,6640,1,13,5,2,35,11,24,44
CSKA Moscow,6640,2,10,3,7,28,22,6,33
Spart Moscow,6640,3,9,5,6,38,31,7,32
Zenit,6640,4,8,8,4,24,17,7,32
Terek Grozny,6640,5,8,6,6,21,22,-1,30
Krasnodar,6640,6,8,4,8,28,30,-2,28
Din Moscow,6640,7,6,6,8,20,24,-4,24
FK Rubin,6640,8,6,5,9,23,19,4,23
Rostov,6640,9,5,6,9,12,18,-6,21
Amkar,6640,10,5,5,10,11,23,-12,20
Anzhi,6640,11,3,5,12,16,39,-23,14
Loko Moscow,6641,1,12,6,2,31,12,19,42
Spart Moscow,6641,2,11,5,4,41,28,13,38
CSKA Moscow,6641,3,10,4,6,26,19,7,34
Krasnodar,6641,4,9,5,6,30,26,4,32
Zenit,6641,5,7,9,4,22,15,7,30
Terek Grozny,6641,6,8,5,7,25,27,-2,29
Din Moscow,6641,7,6,6,8,19,23,-4,24
FK Rubin,6641,8,5,5,10,22,20,2,20
Amkar,6641,9,5,4,11,16,29,-13,19
Rostov,6641,10,4,6,10,10,18,-8,18
Anzhi,6641,11,3,5,12,15,40,-25,14
Loko Moscow,6642,1,12,6,2,31,11,20,42
CSKA Moscow,6642,2,11,3,6,30,18,12,36
Spart Moscow,6642,3,10,6,4,37,27,10,36
Zenit,6642,4,8,8,4,22,15,7,32
Krasnodar,6642,5,9,5,6,31,25,6,32
Terek Grozny,6642,6,7,6,7,20,25,-5,27
FK Rubin,6642,7,6,5,9,23,21,2,23
Din Moscow,6642,8,5,7,8,17,22,-5,22
Rostov,6642,9,4,6,10,12,20,-8,18
Amkar,6642,10,4,5,11,9,23,-14,17
Anzhi,6642,11,3,5,12,17,42,-25,14
Loko Moscow,6643,1,12,5,3,33,15,18,41
CSKA Moscow,6643,2,12,3,5,31,20,11,39
Spart Moscow,6643,3,11,5,4,40,28,12,38
Krasnodar,6643,4,10,4,6,31,26,5,34
Zenit,6643,5,7,8,5,24,19,5,29
Terek Grozny,6643,6,7,6,7,20,23,-3,27
FK Rubin,6643,7,6,5,9,22,18,4,23
Din Moscow,6643,8,5,6,9,17,24,-7,21
Rostov,6643,9,4,6,10,11,19,-8,18
Amkar,6643,10,4,5,11,11,25,-14,17
Anzhi,6643,11,3,5,12,16,39,-23,14
Loko Moscow,6644,1,12,5,3,33,14,19,41
CSKA Moscow,6644,2,11,3,6,28,21,7,36
Krasnodar,6644,3,10,4,6,31,25,6,34
Spart Moscow,6644,4,9,6,5,37,28,9,33
Zenit,6644,5,8,8,4,24,16,8,32
Terek Grozny,6644,6,8,6,6,25,26,-1,30
FK Rubin,6644,7,6,5,9,24,19,5,23
Din Moscow,6644,8,5,7,8,18,25,-7,22
Amkar,6644,9,5,4,11,12,25,-13,19
Rostov,6644,10,4,6,10,11,20,-9,18
Anzhi,6644,11,2,6,12,18,42,-24,12
Loko Moscow,6645,1,11,6,3,31,14,17,39
CSKA Moscow,6645,2,11,3,6,28,19,9,36
Spart Moscow,6645,3,9,7,4,36,27,9,34
Krasnodar,6645,4,10,4,6,32,25,7,34
Zenit,6645,5,7,9,4,22,16,6,30
Terek Grozny,6645,6,7,5,8,20,28,-8,26
Din Moscow,6645,7,5,8,7,20,24,-4,23
FK Rubin,6645,8,5,6,9,22,21,1,21
Amkar,6645,9,5,5,10,13,22,-9,20
Rostov,6645,10,4,6,10,10,18,-8,18
Anzhi,6645,11,4,5,11,18,38,-20,17
Loko Moscow,6646,1,12,5,3,30,12,18,41
Spart Moscow,6646,2,10,6,4,36,25,11,36
CSKA Moscow,6646,3,11,3,6,28,20,8,36
Zenit,6646,4,8,8,4,23,15,8,32
Terek Grozny,6646,5,9,5,6,22,22,0,32
Krasnodar,6646,6,9,4,7,30,27,3,31
Din Moscow,6646,7,6,7,7,19,22,-3,25
FK Rubin,6646,8,5,5,10,24,22,2,20
Rostov,6646,9,4,6,10,10,19,-9,18
Amkar,6646,10,4,4,12,9,24,-15,16
Anzhi,6646,11,3,5,12,16,39,-23,14
Loko Moscow,6647,1,12,6,2,31,12,19,42
CSKA Moscow,6647,2,11,4,5,29,18,11,37
Spart Moscow,6647,3,9,6,5,40,33,7,33
Krasnodar,6647,4,9,5,6,29,25,4,32
Zenit,6647,5,7,9,4,22,15,7,30
Terek Grozny,6647,6,7,7,6,22,24,-2,28
Din Moscow,6647,7,5,7,8,21,26,-5,22
FK Rubin,6647,8,5,6,9,22,19,3,21
Amkar,6647,9,5,5,10,13,24,-11,20
Rostov,6647,10,4,7,9,12,19,-7,19
Anzhi,6647,11,2,6,12,15,41,-26,12
Loko Moscow,6648,1,13,5,2,34,14,20,44
CSKA Moscow,6648,2,12,3,5,28,18,10,39
Spart Moscow,6648,3,11,5,4,40,26,14,38
Krasnodar,6648,4,9,4,7,29,26,3,31
Terek Grozny,6648,5,8,6,6,23,24,-1,30
Zenit,6648,6,7,8,5,24,18,6,29
Din Moscow,6648,7,6,6,8,18,22,-4,24
FK Rubin,6648,8,5,5,10,21,19,2,20
Rostov,6648,9,4,6,10,11,19,-8,18
Amkar,6648,10,4,4,12,10,28,-18,16
Anzhi,6648,11,2,6,12,15,39,-24,12
Loko Moscow,6649,1,12,6,2,32,13,19,42
CSKA Moscow,6649,2,12,3,5,30,17,13,39
Spart Moscow,6649,3,11,5,4,39,26,13,38
Krasnodar,6649,4,8,6,6,28,25,3,30
Terek Grozny,6649,5,8,6,6,23,23,0,30
Zenit,6649,6,7,8,5,22,16,6,29
Din Moscow,6649,7,6,6,8,19,25,-6,24
FK Rubin,6649,8,5,6,9,22,19,3,21
Rostov,6649,9,4,6,10,11,19,-8,18
Amkar,6649,10,4,5,11,9,23,-14,17
Anzhi,6649,11,2,5,13,15,44,-29,11
Loko Moscow,6650,1,12,5,3,32,12,20,41
CSKA Moscow,6650,2,11,4,5,30,18,12,37
Spart Moscow,6650,3,10,5,5,37,27,10,35
Zenit,6650,4,8,9,3,23,14,9,33
Terek Grozny,6650,5,8,6,6,21,22,-1,30
Krasnodar,6650,6,8,4,8,27,29,-2,28
Din Moscow,6650,7,7,6,7,21,22,-1,27
FK Rubin,6650,8,6,5,9,23,19,4,23
Rostov,6650,9,4,6,10,10,18,-8,18
Amkar,6650,10,4,5,11,9,24,-15,17
Anzhi,6650,11,2,5,13,14,42,-28,11
Loko Moscow,6651,1,12,6,2,32,13,19,42
CSKA Moscow,6651,2,11,3,6,32,22,10,36
Spart Moscow,6651,3,10,5,5,39,28,11,35
Zenit,6651,4,8,8,4,24,16,8,32
Krasnodar,6651,5,8,6,6,29,26,3,30
Terek Grozny,6651,6,7,7,6,22,24,-2,28
FK Rubin,6651,7,6,6,8,24,19,5,24
Din Moscow,6651,8,6,6,8,21,24,-3,24
Rostov,6651,9,4,6,10,10,20,-10,18
Amkar,6651,10,4,5,11,10,25,-15,17
Anzhi,6651,11,2,6,12,18,44,-26,12
Loko Moscow,6652,1,12,6,2,37,13,24,42
CSKA Moscow,6652,2,10,4,6,28,21,7,34
Zenit,6652,3,8,9,3,25,16,9,33
Terek Grozny,6652,4,8,6,6,24,22,2,30
Spart Moscow,6652,5,8,5,7,36,32,4,29
Krasnodar,6652,6,8,4,8,28,32,-4,28
Din Moscow,6652,7,7,6,7,22,22,0,27
FK Rubin,6652,8,6,5,9,22,20,2,23
Rostov,6652,9,5,6,9,12,17,-5,21
Amkar,6652,10,5,5,10,12,24,-12,20
Anzhi,6652,11,2,6,12,15,42,-27,12
Loko Moscow,6653,1,12,5,3,32,14,18,41
CSKA Moscow,6653,2,11,3,6,26,20,6,36
Spart Moscow,6653,3,10,5,5,38,29,9,35
Krasnodar,6653,4,10,4,6,30,25,5,34
Zenit,6653,5,8,8,4,25,15,10,32
Terek Grozny,6653,6,7,7,6,20,22,-2,28
FK Rubin,6653,7,6,5,9,23,19,4,23
Din Moscow,6653,8,5,6,9,19,25,-6,21
Amkar,6653,9,5,5,10,11,23,-12,20
Rostov,6653,10,4,6,10,11,19,-8,18
Anzhi,6653,11,2,6,12,14,38,-24,12
Loko Moscow,6654,1,11,5,4,31,15,16,38
Zenit,6654,2,9,8,3,25,15,10,35
CSKA Moscow,6654,3,10,4,6,25,18,7,34
Krasnodar,6654,4,10,4,6,29,24,5,34
Spart Moscow,6654,5,9,5,6,38,31,7,32
Terek Grozny,6654,6,7,5,8,20,25,-5,26
Din Moscow,6654,7,6,6,8,20,23,-3,24
Amkar,6654,8,6,4,10,11,22,-11,22
Rostov,6654,9,5,6,9,14,20,-6,21
FK Rubin,6654,10,5,5,10,21,20,1,20
Anzhi,6654,11,3,6,11,16,37,-21,15
Loko Moscow,6655,1,13,5,2,32,11,21,44
CSKA Moscow,6655,2,11,4,5,29,20,9,37
Spart Moscow,6655,3,10,6,4,41,30,11,36
Terek Grozny,6655,4,9,5,6,22,22,0,32
Krasnodar,6655,5,9,4,7,28,26,2,31
Zenit,6655,6,7,8,5,23,17,6,29
FK Rubin,6655,7,6,5,9,23,19,4,23
Din Moscow,6655,8,5,6,9,20,27,-7,21
Rostov,6655,9,4,6,10,12,20,-8,18
Amkar,6655,10,4,5,11,10,24,-14,17
Anzhi,6655,11,2,6,12,15,39,-24,12
Loko Moscow,6656,1,11,5,4,31,16,15,38
Spart Moscow,6656,2,10,6,4,38,27,11,36
CSKA Moscow,6656,3,11,3,6,26,19,7,36
Zenit,6656,4,9,8,3,26,14,12,35
Krasnodar,6656,5,10,4,6,32,26,6,34
Terek Grozny,6656,6,7,5,8,21,27,-6,26
FK Rubin,6656,7,6,5,9,24,21,3,23
Din Moscow,6656,8,5,6,9,19,25,-6,21
Rostov,6656,9,4,7,9,11,18,-7,19
Amkar,6656,10,5,4,11,11,24,-13,19
Anzhi,6656,11,3,5,12,17,39,-22,14
Loko Moscow,6657,1,12,5,3,31,15,16,41
CSKA Moscow,6657,2,11,4,5,29,19,10,37
Spart Moscow,6657,3,10,6,4,43,28,15,36
Krasnodar,6657,4,9,5,6,30,24,6,32
Zenit,6657,5,7,8,5,23,18,5,29
Terek Grozny,6657,6,8,5,7,23,24,-1,29
FK Rubin,6657,7,6,6,8,22,17,5,24
Din Moscow,6657,8,5,7,8,17,22,-5,22
Rostov,6657,9,4,6,10,12,22,-10,18
Amkar,6657,10,4,4,12,10,29,-19,16
Anzhi,6657,11,3,6,11,17,39,-22,15
Loko Moscow,6658,1,12,5,3,30,13,17,41
Spart Moscow,6658,2,10,5,5,38,28,10,35
Krasnodar,6658,3,10,4,6,32,24,8,34
CSKA Moscow,6658,4,10,4,6,27,21,6,34
Zenit,6658,5,8,8,4,23,14,9,32
Terek Grozny,6658,6,8,6,6,24,25,-1,30
Din Moscow,6658,7,5,7,8,19,25,-6,22
FK Rubin,6658,8,5,6,9,22,21,1,21
Rostov,6658,9,5,6,9,11,17,-6,21
Amkar,6658,10,4,5,11,11,25,-14,17
Anzhi,6658,11,2,6,12,18,42,-24,12
Loko Moscow,6659,1,12,6,2,33,12,21,42
CSKA Moscow,6659,2,12,3,5,32,17,15,39
Spart Moscow,6659,3,11,5,4,40,26,14,38
Krasnodar,6659,4,9,4,7,29,27,2,31
Zenit,6659,5,7,9,4,22,17,5,30
Terek Grozny,6659,6,8,5,7,23,24,-1,29
FK Rubin,6659,7,6,5,9,22,19,3,23
Din Moscow,6659,8,5,6,9,17,24,-7,21
Rostov,6659,9,4,6,10,11,21,-10,18
Amkar,6659,10,4,4,12,10,26,-16,16
Anzhi,6659,11,3,5,12,15,41,-26,14
Loko Moscow,6660,1,13,5,2,33,13,20,44
CSKA Moscow,6660,2,10,3,7,25,19,6,33
Spart Moscow,6660,3,9,5,6,37,29,8,32
Zenit,6660,4,8,8,4,23,15,8,32
Krasnodar,6660,5,8,5,7,30,28,2,29
Terek Grozny,6660,6,7,6,7,20,23,-3,27
FK Rubin,6660,7,5,7,8,25,21,4,22
Din Moscow,6660,8,5,7,8,20,27,-7,22
Amkar,6660,9,6,4,10,11,22,-11,22
Rostov,6660,10,5,6,9,12,17,-5,21
Anzhi,6660,11,3,6,11,15,37,-22,15
Loko Moscow,6661,1,13,5,2,35,13,22,44
CSKA Moscow,6661,2,11,3,6,28,19,9,36
Spart Moscow,6661,3,10,5,5,38,28,10,35
Krasnodar,6661,4,9,4,7,31,26,5,31
Zenit,6661,5,7,8,5,23,20,3,29
Din Moscow,6661,6,7,6,7,19,21,-2,27
Terek Grozny,6661,7,7,5,8,21,26,-5,26
FK Rubin,6661,8,5,5,10,21,21,0,20
Amkar,6661,9,5,4,11,13,25,-12,19
Rostov,6661,10,4,6,10,10,19,-9,18
Anzhi,6661,11,4,5,11,17,38,-21,17
Loko Moscow,6662,1,12,6,2,31,11,20,42
CSKA Moscow,6662,2,11,4,5,29,20,9,37
Spart Moscow,6662,3,10,5,5,38,27,11,35
Krasnodar,6662,4,9,5,6,28,24,4,32
Zenit,6662,5,7,9,4,22,16,6,30
Terek Grozny,6662,6,8,5,7,22,24,-2,29
Din Moscow,6662,7,7,6,7,21,22,-1,27
FK Rubin,6662,8,5,5,10,22,21,1,20
Amkar,6662,9,5,4,11,11,25,-14,19
Rostov,6662,10,4,6,10,10,19,-9,18
Anzhi,6662,11,2,5,13,17,42,-25,11
Loko Moscow,6663,1,12,5,3,32,14,18,41
CSKA Moscow,6663,2,10,4,6,27,20,7,34
Spart Moscow,6663,3,9,6,5,37,28,9,33
Zenit,6663,4,8,8,4,25,17,8,32
Krasnodar,6663,5,9,5,6,29,25,4,32
Terek Grozny,6663,6,7,5,8,20,25,-5,26
FK Rubin,6663,7,6,6,8,23,18,5,24
Din Moscow,6663,8,5,7,8,18,23,-5,22
Amkar,6663,9,6,4,10,11,22,-11,22
Rostov,6663,10,4,6,10,11,20,-9,18
Anzhi,6663,11,3,6,11,17,38,-21,15
Loko Moscow,6664,1,11,6,3,32,15,17,39
CSKA Moscow,6664,2,12,3,5,30,18,12,39
Spart Moscow,6664,3,10,6,4,38,28,10,36
Zenit,6664,4,8,8,4,25,17,8,32
Krasnodar,6664,5,9,5,6,30,25,5,32
Terek Grozny,6664,6,7,5,8,21,25,-4,26
Din Moscow,6664,7,5,7,8,18,23,-5,22
FK Rubin,6664,8,5,6,9,21,19,2,21
Amkar,6664,9,5,5,10,13,25,-12,20
Rostov,6664,10,4,6,10,10,18,-8,18
Anzhi,6664,11,3,5,12,15,40,-25,14
Loko Moscow,6665,1,13,5,2,34,12,22,44
CSKA Moscow,6665,2,11,3,6,29,20,9,36
Zenit,6665,3,8,8,4,23,15,8,32
Spart Moscow,6665,4,9,5,6,35,28,7,32
Terek Grozny,6665,5,9,5,6,25,24,1,32
Krasnodar,6665,6,8,5,7,28,28,0,29
Din Moscow,6665,7,7,6,7,20,22,-2,27
FK Rubin,6665,8,5,6,9,22,19,3,21
Amkar,6665,9,5,4,11,11,25,-14,19
Rostov,6665,10,4,6,10,10,18,-8,18
Anzhi,6665,11,2,5,13,17,43,-26,11
Loko Moscow,6666,1,13,5,2,31,11,20,44
Spart Moscow,6666,2,11,5,4,40,28,12,38
CSKA Moscow,6666,3,11,3,6,29,21,8,36
Zenit,6666,4,8,8,4,22,14,8,32
Terek Grozny,6666,5,9,5,6,26,22,4,32
Krasnodar,6666,6,9,4,7,30,27,3,31
Din Moscow,6666,7,6,6,8,19,24,-5,24
FK Rubin,6666,8,5,5,10,24,22,2,20
Rostov,6666,9,4,6,10,11,19,-8,18
Amkar,6666,10,4,4,12,11,27,-16,16
Anzhi,6666,11,2,5,13,17,45,-28,11
Loko Moscow,6667,1,11,6,3,30,13,17,39
CSKA Moscow,6667,2,11,4,5,29,18,11,37
Spart Moscow,6667,3,10,6,4,38,27,11,36
Zenit,6667,4,8,9,3,23,14,9,33
Krasnodar,6667,5,8,5,7,30,29,1,29
Terek Grozny,6667,6,7,6,7,20,23,-3,27
FK Rubin,6667,7,7,5,8,27,20,7,26
Din Moscow,6667,8,5,7,8,18,23,-5,22
Amkar,6667,9,5,4,11,11,24,-13,19
Rostov,6667,10,4,6,10,11,20,-9,18
Anzhi,6667,11,2,6,12,14,40,-26,12
Loko Moscow,6668,1,13,5,2,33,12,21,44
Spart Moscow,6668,2,11,5,4,40,27,13,38
CSKA Moscow,6668,3,10,3,7,26,21,5,33
Zenit,6668,4,8,8,4,24,16,8,32
Terek Grozny,6668,5,8,6,6,21,22,-1,30
Krasnodar,6668,6,8,4,8,27,27,0,28
FK Rubin,6668,7,7,5,8,25,17,8,26
Din Moscow,6668,8,5,6,9,18,28,-10,21
Rostov,6668,9,4,6,10,11,19,-8,18
Amkar,6668,10,4,4,12,9,24,-15,16
Anzhi,6668,11,3,6,11,16,37,-21,15
Loko Moscow,6669,1,13,5,2,34,11,23,44
CSKA Moscow,6669,2,11,4,5,29,18,11,37
Spart Moscow,6669,3,9,6,5,37,29,8,33
Krasnodar,6669,4,9,4,7,29,28,1,31
Zenit,6669,5,7,8,5,21,18,3,29
Terek Grozny,6669,6,7,5,8,21,26,-5,26
Din Moscow,6669,7,5,8,7,19,23,-4,23
Amkar,6669,8,6,4,10,13,22,-9,22
FK Rubin,6669,9,5,6,9,23,20,3,21
Rostov,6669,10,4,6,10,11,20,-9,18
Anzhi,6669,11,3,6,11,17,39,-22,15
Loko Moscow,6670,1,12,5,3,31,12,19,41
CSKA Moscow,6670,2,10,4,6,26,19,7,34
Krasnodar,6670,3,10,4,6,30,24,6,34
Spart Moscow,6670,4,9,6,5,34,26,8,33
Zenit,6670,5,8,8,4,23,16,7,32
Terek Grozny,6670,6,8,5,7,21,24,-3,29
Din Moscow,6670,7,6,6,8,19,23,-4,24
Rostov,6670,8,5,6,9,11,17,-6,21
FK Rubin,6670,9,5,5,10,22,21,1,20
Amkar,6670,10,5,5,10,11,22,-11,20
Anzhi,6670,11,2,6,12,14,38,-24,12
Loko Moscow,6671,1,12,5,3,33,12,21,41
CSKA Moscow,6671,2,11,4,5,31,21,10,37
Spart Moscow,6671,3,10,6,4,39,28,11,36
Krasnodar,6671,4,9,5,6,29,25,4,32
Zenit,6671,5,7,9,4,23,19,4,30
Terek Grozny,6671,6,7,6,7,21,24,-3,27
Din Moscow,6671,7,6,7,7,21,24,-3,25
FK Rubin,6671,8,5,6,9,23,20,3,21
Amkar,6671,9,5,4,11,11,25,-14,19
Rostov,6671,10,4,6,10,11,19,-8,18
Anzhi,6671,11,2,6,12,16,41,-25,12
Loko Moscow,6672,1,12,5,3,31,13,18,41
Zenit,6672,2,9,8,3,24,13,11,35
Spart Moscow,6672,3,9,6,5,36,28,8,33
CSKA Moscow,6672,4,10,3,7,25,20,5,33
Terek Grozny,6672,5,9,5,6,24,23,1,32
Krasnodar,6672,6,8,5,7,29,28,1,29
FK Rubin,6672,7,6,6,8,25,19,6,24
Din Moscow,6672,8,6,6,8,20,24,-4,24
Rostov,6672,9,4,7,9,10,17,-7,19
Amkar,6672,10,4,4,12,9,25,-16,16
Anzhi,6672,11,3,5,12,17,40,-23,14
Loko Moscow,6673,1,11,6,3,30,13,17,39
CSKA Moscow,6673,2,11,4,5,28,18,10,37
Spart Moscow,6673,3,9,5,6,35,27,8,32
Krasnodar,6673,4,9,5,6,31,27,4,32
Zenit,6673,5,7,9,4,21,15,6,30
Din Moscow,6673,6,7,6,7,20,22,-2,27
Terek Grozny,6673,7,7,6,7,21,25,-4,27
FK Rubin,6673,8,5,6,9,24,21,3,21
Rostov,6673,9,5,6,9,11,17,-6,21
Amkar,6673,10,5,4,11,12,25,-13,19
Anzhi,6673,11,2,7,11,15,38,-23,13
CSKA Moscow,6674,1,12,3,5,32,19,13,39
Loko Moscow,6674,2,11,5,4,29,14,15,38
Spart Moscow,6674,3,10,6,4,39,26,13,36
Krasnodar,6674,4,10,4,6,31,24,7,34
Zenit,6674,5,8,8,4,24,15,9,32
Terek Grozny,6674,6,8,6,6,24,24,0,30
Din Moscow,6674,7,6,6,8,19,25,-6,24
FK Rubin,6674,8,5,5,10,21,21,0,20
Rostov,6674,9,4,7,9,10,17,-7,19
Amkar,6674,10,4,4,12,10,27,-17,16
Anzhi,6674,11,2,6,12,16,43,-27,12
Loko Moscow,6675,1,11,6,3,32,15,17,39
CSKA Moscow,6675,2,11,4,5,26,17,9,37
Zenit,6675,3,8,9,3,23,14,9,33
Spart Moscow,6675,4,9,6,5,37,29,8,33
Krasnodar,6675,5,8,5,7,31,31,0,29
Terek Grozny,6675,6,7,7,6,22,24,-2,28
FK Rubin,6675,7,7,5,8,27,19,8,26
Din Moscow,6675,8,5,7,8,18,23,-5,22
Amkar,6675,9,5,5,10,12,24,-12,20
Rostov,6675,10,4,6,10,11,19,-8,18
Anzhi,6675,11,2,6,12,15,39,-24,12
Loko Moscow,6676,1,12,5,3,32,15,17,41
CSKA Moscow,6676,2,11,3,6,27,19,8,36
Spart Moscow,6676,3,9,6,5,36,27,9,33
Zenit,6676,4,8,8,4,24,16,8,32
Krasnodar,6676,5,9,4,7,31,28,3,31
Terek Grozny,6676,6,8,6,6,24,25,-1,30
FK Rubin,6676,7,7,5,8,25,18,7,26
Din Moscow,6676,8,5,7,8,18,23,-5,22
Rostov,6676,9,5,6,9,11,17,-6,21
Amkar,6676,10,4,5,11,10,25,-15,17
Anzhi,6676,11,2,5,13,16,41,-25,11
Loko Moscow,6677,1,12,5,3,32,13,19,41
CSKA Moscow,6677,2,12,3,5,30,17,13,39
Krasnodar,6677,3,9,5,6,29,25,4,32
Spart Moscow,6677,4,8,7,5,37,30,7,31
Zenit,6677,5,7,8,5,22,18,4,29
Terek Grozny,6677,6,7,5,8,20,27,-7,26
Din Moscow,6677,7,5,8,7,20,24,-4,23
FK Rubin,6677,8,5,7,8,25,21,4,22
Rostov,6677,9,5,6,9,13,19,-6,21
Amkar,6677,10,5,5,10,14,24,-10,20
Anzhi,6677,11,3,5,12,16,40,-24,14
Loko Moscow,6678,1,13,5,2,34,11,23,44
CSKA Moscow,6678,2,11,3,6,27,19,8,36
Spart Moscow,6678,3,8,6,6,35,29,6,30
Zenit,6678,4,7,8,5,21,15,6,29
Krasnodar,6678,5,8,5,7,27,28,-1,29
Terek Grozny,6678,6,7,6,7,21,24,-3,27
FK Rubin,6678,7,6,6,8,24,19,5,24
Din Moscow,6678,8,6,6,8,21,25,-4,24
Rostov,6678,9,5,6,9,11,17,-6,21
Amkar,6678,10,4,6,10,10,23,-13,18
Anzhi,6678,11,4,5,11,18,39,-21,17
Loko Moscow,6679,1,11,6,3,30,15,15,39
CSKA Moscow,6679,2,12,3,5,31,17,14,39
Spart Moscow,6679,3,9,6,5,36,27,9,33
Zenit,6679,4,8,8,4,24,15,9,32
Terek Grozny,6679,5,8,6,6,23,24,-1,30
Krasnodar,6679,6,8,5,7,28,26,2,29
FK Rubin,6679,7,6,6,8,22,17,5,24
Din Moscow,6679,8,5,8,7,17,21,-4,23
Amkar,6679,9,5,5,10,10,22,-12,20
Rostov,6679,10,4,6,10,11,20,-9,18
Anzhi,6679,11,2,5,13,16,44,-28,11
Loko Moscow,6680,1,11,6,3,30,13,17,39
CSKA Moscow,6680,2,11,4,5,28,18,10,37
Spart Moscow,6680,3,9,6,5,40,30,10,33
Zenit,6680,4,8,9,3,24,15,9,33
Krasnodar,6680,5,9,5,6,29,25,4,32
Terek Grozny,6680,6,8,6,6,23,23,0,30
Din Moscow,6680,7,6,6,8,22,27,-5,24
FK Rubin,6680,8,5,5,10,24,23,1,20
Amkar,6680,9,5,5,10,11,23,-12,20
Rostov,6680,10,4,7,9,12,19,-7,19
Anzhi,6680,11,2,5,13,15,42,-27,11
Loko Moscow,6681,1,11,6,3,29,12,17,39
CSKA Moscow,6681,2,12,3,5,31,19,12,39
Krasnodar,6681,3,10,4,6,31,24,7,34
Spart Moscow,6681,4,9,6,5,37,30,7,33
Zenit,6681,5,7,9,4,22,15,7,30
Terek Grozny,6681,6,8,6,6,22,22,0,30
Din Moscow,6681,7,6,7,7,20,23,-3,25
FK Rubin,6681,8,5,5,10,21,21,0,20
Amkar,6681,9,5,4,11,11,24,-13,19
Rostov,6681,10,4,6,10,11,19,-8,18
Anzhi,6681,11,2,6,12,15,41,-26,12
Loko Moscow,6682,1,13,5,2,33,13,20,44
CSKA Moscow,6682,2,11,3,6,27,19,8,36
Spart Moscow,6682,3,9,7,4,36,27,9,34
Zenit,6682,4,7,8,5,23,17,6,29
Terek Grozny,6682,5,8,5,7,25,25,0,29
Krasnodar,6682,6,8,4,8,29,28,1,28
FK Rubin,6682,7,6,6,8,25,20,5,24
Din Moscow,6682,8,5,7,8,19,24,-5,22
Rostov,6682,9,4,7,9,10,17,-7,19
Amkar,6682,10,4,5,11,11,27,-16,17
Anzhi,6682,11,4,5,11,18,39,-21,17
Loko Moscow,6683,1,12,5,3,31,13,18,41
Spart Moscow,6683,2,11,5,4,38,25,13,38
CSKA Moscow,6683,3,11,3,6,28,19,9,36
Zenit,6683,4,9,8,3,25,14,11,35
Krasnodar,6683,5,8,5,7,29,27,2,29
Terek Grozny,6683,6,8,5,7,24,26,-2,29
FK Rubin,6683,7,5,7,8,24,20,4,22
Din Moscow,6683,8,5,7,8,18,25,-7,22
Amkar,6683,9,5,4,11,12,25,-13,19
Rostov,6683,10,4,6,10,10,18,-8,18
Anzhi,6683,11,2,5,13,15,42,-27,11
Loko Moscow,6684,1,11,6,3,32,15,17,39
CSKA Moscow,6684,2,11,3,6,26,20,6,36
Krasnodar,6684,3,9,4,7,31,28,3,31
Zenit,6684,4,7,9,4,21,14,7,30
Spart Moscow,6684,5,8,6,6,35,30,5,30
Terek Grozny,6684,6,8,6,6,23,24,-1,30
FK Rubin,6684,7,6,6,8,23,18,5,24
Din Moscow,6684,8,5,8,7,19,23,-4,23
Rostov,6684,9,5,6,9,12,18,-6,21
Amkar,6684,10,5,4,11,11,23,-12,19
Anzhi,6684,11,3,6,11,19,39,-20,15
Loko Moscow,6685,1,12,5,3,31,14,17,41
CSKA Moscow,6685,2,11,3,6,31,20,11,36
Spart Moscow,6685,3,10,5,5,40,27,13,35
Zenit,6685,4,9,8,3,27,15,12,35
Krasnodar,6685,5,9,4,7,29,26,3,31
Terek Grozny,6685,6,7,6,7,21,24,-3,27
Din Moscow,6685,7,5,7,8,19,26,-7,22
FK Rubin,6685,8,5,6,9,23,21,2,21
Rostov,6685,9,5,6,9,12,18,-6,21
Amkar,6685,10,5,4,11,10,25,-15,19
Anzhi,6685,11,2,6,12,15,42,-27,12
Loko Moscow,6686,1,12,6,2,31,11,20,42
CSKA Moscow,6686,2,11,3,6,27,18,9,36
Spart Moscow,6686,3,10,5,5,38,28,10,35
Zenit,6686,4,8,8,4,22,15,7,32
Krasnodar,6686,5,8,5,7,27,25,2,29
Terek Grozny,6686,6,7,5,8,21,26,-5,26
FK Rubin,6686,7,6,6,8,23,18,5,24
Din Moscow,6686,8,5,7,8,18,24,-6,22
Amkar,6686,9,6,4,10,12,23,-11,22
Rostov,6686,10,4,6,10,11,19,-8,18
Anzhi,6686,11,3,5,12,17,40,-23,14
Loko Moscow,6687,1,12,6,2,32,12,20,42
CSKA Moscow,6687,2,12,3,5,30,18,12,39
Spart Moscow,6687,3,10,6,4,36,26,10,36
Terek Grozny,6687,4,8,6,6,21,22,-1,30
Zenit,6687,5,7,8,5,22,17,5,29
Krasnodar,6687,6,8,5,7,29,28,1,29
FK Rubin,6687,7,7,5,8,25,18,7,26
Din Moscow,6687,8,5,6,9,17,23,-6,21
Rostov,6687,9,4,6,10,10,18,-8,18
Amkar,6687,10,4,6,10,10,23,-13,18
Anzhi,6687,11,2,5,13,14,41,-27,11
Loko Moscow,6688,1,12,5,3,30,16,14,41
Spart Moscow,6688,2,10,5,5,38,28,10,35
CSKA Moscow,6688,3,10,4,6,25,18,7,34
Krasnodar,6688,4,9,5,6,32,24,8,32
Zenit,6688,5,8,8,4,22,14,8,32
Terek Grozny,6688,6,7,6,7,21,24,-3,27
Din Moscow,6688,7,6,6,8,21,25,-4,24
FK Rubin,6688,8,5,6,9,23,21,2,21
Rostov,6688,9,5,6,9,12,18,-6,21
Amkar,6688,10,5,4,11,11,24,-13,19
Anzhi,6688,11,2,7,11,15,38,-23,13
Loko Moscow,6689,1,11,5,4,31,16,15,38
Spart Moscow,6689,2,10,5,5,40,28,12,35
Zenit,6689,3,9,8,3,25,14,11,35
Krasnodar,6689,4,10,4,6,31,25,6,34
CSKA Moscow,6689,5,10,3,7,26,20,6,33
Terek Grozny,6689,6,7,7,6,22,24,-2,28
Din Moscow,6689,7,5,7,8,19,24,-5,22
FK Rubin,6689,8,5,6,9,22,20,2,21
Amkar,6689,9,5,5,10,10,22,-12,20
Rostov,6689,10,4,6,10,11,22,-11,18
Anzhi,6689,11,3,6,11,18,40,-22,15
Loko Moscow,6690,1,13,5,2,34,11,23,44
Spart Moscow,6690,2,10,6,4,39,25,14,36
CSKA Moscow,6690,3,10,4,6,25,20,5,34
Zenit,6690,4,8,8,4,24,14,10,32
Krasnodar,6690,5,9,4,7,31,30,1,31
Terek Grozny,6690,6,7,6,7,23,26,-3,27
Din Moscow,6690,7,6,6,8,21,25,-4,24
FK Rubin,6690,8,5,5,10,23,25,-2,20
Rostov,6690,9,4,7,9,10,17,-7,19
Amkar,6690,10,4,5,11,10,25,-15,17
Anzhi,6690,11,3,6,11,17,39,-22,15
Loko Moscow,6691,1,12,6,2,31,12,19,42
CSKA Moscow,6691,2,11,4,5,28,17,11,37
Spart Moscow,6691,3,9,6,5,38,28,10,33
Zenit,6691,4,7,10,3,22,14,8,31
Krasnodar,6691,5,8,4,8,29,28,1,28
Terek Grozny,6691,6,7,6,7,21,25,-4,27
Din Moscow,6691,7,6,6,8,20,26,-6,24
FK Rubin,6691,8,6,5,9,25,21,4,23
Amkar,6691,9,6,4,10,12,22,-10,22
Rostov,6691,10,4,7,9,11,18,-7,19
Anzhi,6691,11,2,6,12,15,41,-26,12
Loko Moscow,6692,1,12,6,2,30,11,19,42
CSKA Moscow,6692,2,12,3,5,29,17,12,39
Krasnodar,6692,3,9,5,6,31,26,5,32
Terek Grozny,6692,4,9,5,6,22,22,0,32
Spart Moscow,6692,5,8,6,6,36,31,5,30
Zenit,6692,6,7,8,5,21,15,6,29
FK Rubin,6692,7,6,5,9,30,21,9,23
Din Moscow,6692,8,5,7,8,19,30,-11,22
Rostov,6692,9,5,6,9,12,17,-5,21
Amkar,6692,10,5,4,11,11,24,-13,19
Anzhi,6692,11,2,5,13,14,41,-27,11
Loko Moscow,6693,1,13,5,2,37,14,23,44
Spart Moscow,6693,2,9,7,4,37,28,9,34
CSKA Moscow,6693,3,10,4,6,26,19,7,34
Zenit,6693,4,8,8,4,24,16,8,32
Terek Grozny,6693,5,9,5,6,25,22,3,32
Krasnodar,6693,6,9,4,7,29,29,0,31
Din Moscow,6693,7,5,8,7,18,22,-4,23
FK Rubin,6693,8,5,6,9,21,18,3,21
Rostov,6693,9,4,6,10,10,18,-8,18
Amkar,6693,10,4,5,11,11,25,-14,17
Anzhi,6693,11,2,6,12,15,42,-27,12
Loko Moscow,6694,1,12,5,3,32,14,18,41
CSKA Moscow,6694,2,11,4,5,29,20,9,37
Krasnodar,6694,3,10,4,6,31,26,5,34
Spart Moscow,6694,4,9,6,5,36,28,8,33
Zenit,6694,5,7,9,4,24,17,7,30
Terek Grozny,6694,6,7,5,8,23,27,-4,26
Din Moscow,6694,7,6,6,8,20,23,-3,24
Rostov,6694,8,5,6,9,12,18,-6,21
FK Rubin,6694,9,5,5,10,22,21,1,20
Amkar,6694,10,5,5,10,11,23,-12,20
Anzhi,6694,11,3,5,12,18,41,-23,14
Loko Moscow,6695,1,11,5,4,30,16,14,38
CSKA Moscow,6695,2,11,3,6,27,19,8,36
Zenit,6695,3,9,8,3,24,14,10,35
Spart Moscow,6695,4,9,6,5,39,31,8,33
Krasnodar,6695,5,9,4,7,32,27,5,31
Terek Grozny,6695,6,8,5,7,23,24,-1,29
FK Rubin,6695,7,7,5,8,25,19,6,26
Din Moscow,6695,8,6,6,8,20,24,-4,24
Amkar,6695,9,5,5,10,12,24,-12,20
Rostov,6695,10,4,6,10,12,20,-8,18
Anzhi,6695,11,2,5,13,15,41,-26,11
Loko Moscow,6696,1,13,5,2,33,12,21,44
CSKA Moscow,6696,2,10,4,6,27,21,6,34
Spart Moscow,6696,3,9,6,5,35,27,8,33
Zenit,6696,4,8,8,4,23,14,9,32
Terek Grozny,6696,5,9,5,6,24,23,1,32
Krasnodar,6696,6,8,5,7,29,28,1,29
Din Moscow,6696,7,5,8,7,20,24,-4,23
FK Rubin,6696,8,5,7,8,24,20,4,22
Rostov,6696,9,5,6,9,11,17,-6,21
Amkar,6696,10,4,4,12,10,26,-16,16
Anzhi,6696,11,2,6,12,16,40,-24,12
Loko Moscow,6697,1,12,6,2,31,12,19,42
Spart Moscow,6697,2,10,6,4,38,28,10,36
CSKA Moscow,6697,3,10,5,5,26,18,8,35
Terek Grozny,6697,4,9,5,6,23,23,0,32
Zenit,6697,5,7,10,3,21,13,8,31
Krasnodar,6697,6,9,4,7,29,26,3,31
Din Moscow,6697,7,5,7,8,19,24,-5,22
FK Rubin,6697,8,5,6,9,22,19,3,21
Rostov,6697,9,4,6,10,11,19,-8,18
Amkar,6697,10,4,5,11,11,25,-14,17
Anzhi,6697,11,2,6,12,15,39,-24,12
Loko Moscow,6698,1,12,6,2,32,13,19,42
CSKA Moscow,6698,2,11,3,6,26,19,7,36
Spart Moscow,6698,3,10,5,5,35,26,9,35
Krasnodar,6698,4,9,4,7,31,27,4,31
Zenit,6698,5,7,9,4,21,14,7,30
Terek Grozny,6698,6,8,5,7,22,24,-2,29
FK Rubin,6698,7,6,5,9,24,20,4,23
Amkar,6698,8,6,4,10,11,22,-11,22
Din Moscow,6698,9,5,6,9,18,25,-7,21
Rostov,6698,10,4,6,10,10,18,-8,18
Anzhi,6698,11,3,5,12,17,39,-22,14
Loko Moscow,6699,1,11,6,3,29,12,17,39
Spart Moscow,6699,2,10,6,4,40,28,12,36
CSKA Moscow,6699,3,11,3,6,29,21,8,36
Krasnodar,6699,4,10,4,6,29,24,5,34
Zenit,6699,5,8,9,3,23,14,9,33
Terek Grozny,6699,6,8,6,6,23,24,-1,30
Din Moscow,6699,7,6,6,8,22,25,-3,24
FK Rubin,6699,8,5,5,10,22,21,1,20
Rostov,6699,9,4,6,10,11,21,-10,18
Amkar,6699,10,4,6,10,10,23,-13,18
Anzhi,6699,11,2,5,13,17,42,-25,11
Loko Moscow,6700,1,11,6,3,29,14,15,39
CSKA Moscow,6700,2,11,4,5,28,19,9,37
Spart Moscow,6700,3,9,5,6,34,28,6,32
Zenit,6700,4,7,10,3,22,14,8,31
Krasnodar,6700,5,9,4,7,30,26,4,31
Terek Grozny,6700,6,7,5,8,24,28,-4,26
FK Rubin,6700,7,6,6,8,24,18,6,24
Din Moscow,6700,8,5,7,8,18,23,-5,22
Amkar,6700,9,6,4,10,14,25,-11,22
Rostov,6700,10,5,6,9,12,17,-5,21
Anzhi,6700,11,3,5,12,17,40,-23,14
Loko Moscow,6701,1,13,5,2,33,12,21,44
Spart Moscow,6701,2,11,5,4,39,26,13,38
CSKA Moscow,6701,3,11,4,5,29,18,11,37
Zenit,6701,4,7,9,4,23,17,6,30
Krasnodar,6701,5,8,5,7,29,27,2,29
Terek Grozny,6701,6,7,5,8,20,24,-4,26
FK Rubin,6701,7,6,6,8,26,21,5,24
Din Moscow,6701,8,5,6,9,20,26,-6,21
Amkar,6701,9,5,4,11,10,23,-13,19
Rostov,6701,10,4,6,10,10,20,-10,18
Anzhi,6701,11,3,5,12,15,40,-25,14
Loko Moscow,6702,1,12,5,3,31,13,18,41
CSKA Moscow,6702,2,10,4,6,25,19,6,34
Spart Moscow,6702,3,8,8,4,36,28,8,32
Zenit,6702,4,8,8,4,23,15,8,32
Krasnodar,6702,5,9,5,6,29,24,5,32
Terek Grozny,6702,6,8,6,6,23,23,0,30
Din Moscow,6702,7,5,8,7,19,23,-4,23
FK Rubin,6702,8,5,7,8,21,17,4,22
Rostov,6702,9,4,7,9,10,17,-7,19
Amkar,6702,10,4,5,11,10,25,-15,17
Anzhi,6702,11,2,7,11,15,38,-23,13
Loko Moscow,6703,1,12,6,2,35,15,20,42
Spart Moscow,6703,2,10,5,5,40,30,10,35
CSKA Moscow,6703,3,10,4,6,27,20,7,34
Zenit,6703,4,7,9,4,22,16,6,30
Krasnodar,6703,5,8,6,6,32,29,3,30
Terek Grozny,6703,6,7,7,6,21,23,-2,28
FK Rubin,6703,7,6,6,8,24,18,6,24
Rostov,6703,8,5,6,9,11,17,-6,21
Din Moscow,6703,9,5,6,9,20,27,-7,21
Amkar,6703,10,4,5,11,10,25,-15,17
Anzhi,6703,11,3,6,11,17,39,-22,15
Loko Moscow,6704,1,11,7,2,30,12,18,40
CSKA Moscow,6704,2,11,3,6,27,20,7,36
Zenit,6704,3,8,9,3,23,13,10,33
Spart Moscow,6704,4,9,6,5,36,29,7,33
Krasnodar,6704,5,9,5,6,30,26,4,32
Terek Grozny,6704,6,8,6,6,21,22,-1,30
Din Moscow,6704,7,6,7,7,20,23,-3,25
FK Rubin,6704,8,5,5,10,23,21,2,20
Amkar,6704,9,5,5,10,12,23,-11,20
Rostov,6704,10,4,6,10,10,18,-8,18
Anzhi,6704,11,2,5,13,15,40,-25,11
Loko Moscow,6705,1,12,5,3,31,15,16,41
CSKA Moscow,6705,2,12,3,5,28,18,10,39
Spart Moscow,6705,3,10,6,4,39,28,11,36
Krasnodar,6705,4,9,4,7,30,25,5,31
Terek Grozny,6705,5,8,6,6,23,23,0,30
Zenit,6705,6,7,8,5,22,16,6,29
FK Rubin,6705,7,6,6,8,23,18,5,24
Din Moscow,6705,8,5,7,8,19,24,-5,22
Rostov,6705,9,4,7,9,12,19,-7,19
Amkar,6705,10,4,5,11,10,25,-15,17
Anzhi,6705,11,2,5,13,15,41,-26,11
Loko Moscow,6706,1,11,6,3,31,14,17,39
CSKA Moscow,6706,2,11,4,5,31,18,13,37
Spart Moscow,6706,3,10,5,5,38,28,10,35
Zenit,6706,4,8,9,3,23,14,9,33
Krasnodar,6706,5,9,5,6,33,28,5,32
Terek Grozny,6706,6,7,6,7,23,26,-3,27
Din Moscow,6706,7,6,6,8,20,23,-3,24
FK Rubin,6706,8,6,5,9,24,21,3,23
Amkar,6706,9,5,4,11,11,26,-15,19
Rostov,6706,10,4,6,10,10,18,-8,18
Anzhi,6706,11,2,6,12,16,44,-28,12
Loko Moscow,6707,1,11,6,3,33,16,17,39
CSKA Moscow,6707,2,11,4,5,30,18,12,37
Zenit,6707,3,8,9,3,24,15,9,33
Spart Moscow,6707,4,9,6,5,37,29,8,33
Terek Grozny,6707,5,8,6,6,24,25,-1,30
Krasnodar,6707,6,8,5,7,30,28,2,29
Din Moscow,6707,7,7,6,7,20,21,-1,27
FK Rubin,6707,8,6,5,9,22,18,4,23
Rostov,6707,9,4,7,9,11,18,-7,19
Amkar,6707,10,4,5,11,11,26,-15,17
Anzhi,6707,11,2,5,13,16,44,-28,11
Loko Moscow,6708,1,11,5,4,29,14,15,38
CSKA Moscow,6708,2,11,3,6,26,19,7,36
Zenit,6708,3,9,8,3,24,13,11,35
Spart Moscow,6708,4,9,6,5,36,27,9,33
Krasnodar,6708,5,9,5,6,29,24,5,32
Terek Grozny,6708,6,8,6,6,24,25,-1,30
Din Moscow,6708,7,6,6,8,18,23,-5,24
FK Rubin,6708,8,5,6,9,21,18,3,21
Rostov,6708,9,4,7,9,10,17,-7,19
Amkar,6708,10,5,4,11,12,25,-13,19
Anzhi,6708,11,2,6,12,16,40,-24,12
Loko Moscow,6709,1,11,5,4,31,15,16,38
Spart Moscow,6709,2,11,5,4,38,26,12,38
CSKA Moscow,6709,3,11,3,6,27,19,8,36
Zenit,6709,4,9,8,3,26,15,11,35
Krasnodar,6709,5,9,4,7,28,25,3,31
Terek Grozny,6709,6,7,5,8,20,24,-4,26
Din Moscow,6709,7,6,6,8,20,25,-5,24
FK Rubin,6709,8,6,5,9,24,20,4,23
Amkar,6709,9,5,4,11,10,23,-13,19
Rostov,6709,10,4,6,10,11,19,-8,18
Anzhi,6709,11,3,5,12,15,39,-24,14
Loko Moscow,6710,1,11,6,3,29,15,14,39
Spart Moscow,6710,2,10,6,4,35,25,10,36
CSKA Moscow,6710,3,11,3,6,29,20,9,36
Zenit,6710,4,9,8,3,28,14,14,35
Krasnodar,6710,5,9,5,6,29,24,5,32
Terek Grozny,6710,6,8,6,6,24,22,2,30
Din Moscow,6710,7,6,6,8,19,22,-3,24
FK Rubin,6710,8,5,5,10,21,21,0,20
Rostov,6710,9,4,7,9,10,17,-7,19
Amkar,6710,10,4,5,11,9,23,-14,17
Anzhi,6710,11,2,5,13,14,44,-30,11
CSKA Moscow,6711,1,12,3,5,29,17,12,39
Loko Moscow,6711,2,11,5,4,31,15,16,38
Spart Moscow,6711,3,9,7,4,35,26,9,34
Zenit,6711,4,8,8,4,24,16,8,32
Krasnodar,6711,5,9,5,6,29,25,4,32
Terek Grozny,6711,6,8,6,6,24,24,0,30
Din Moscow,6711,7,5,8,7,20,24,-4,23
FK Rubin,6711,8,5,7,8,24,20,4,22
Rostov,6711,9,4,7,9,10,17,-7,19
Amkar,6711,10,4,4,12,10,26,-16,16
Anzhi,6711,11,2,6,12,15,41,-26,12
Loko Moscow,6712,1,11,6,3,30,14,16,39
Spart Moscow,6712,2,11,5,4,41,26,15,38
CSKA Moscow,6712,3,11,3,6,28,20,8,36
Krasnodar,6712,4,10,4,6,31,24,7,34
Zenit,6712,5,8,9,3,24,15,9,33
Terek Grozny,6712,6,7,7,6,21,23,-2,28
FK Rubin,6712,7,6,5,9,23,20,3,23
Din Moscow,6712,8,5,6,9,18,26,-8,21
Rostov,6712,9,4,6,10,10,18,-8,18
Amkar,6712,10,4,5,11,10,26,-16,17
Anzhi,6712,11,2,6,12,16,40,-24,12
Loko Moscow,6713,1,11,5,4,30,14,16,38
CSKA Moscow,6713,2,11,4,5,28,18,10,37
Zenit,6713,3,8,9,3,24,15,9,33
Spart Moscow,6713,4,9,5,6,36,30,6,32
Krasnodar,6713,5,9,5,6,30,26,4,32
Terek Grozny,6713,6,9,5,6,23,22,1,32
Din Moscow,6713,7,6,6,8,19,24,-5,24
FK Rubin,6713,8,5,6,9,23,21,2,21
Rostov,6713,9,5,6,9,13,17,-4,21
Amkar,6713,10,5,4,11,11,23,-12,19
Anzhi,6713,11,2,5,13,14,41,-27,11
Loko Moscow,6714,1,13,5,2,33,12,21,44
CSKA Moscow,6714,2,11,3,6,26,18,8,36
Spart Moscow,6714,3,10,5,5,39,27,12,35
Zenit,6714,4,8,8,4,22,15,7,32
Krasnodar,6714,5,9,4,7,30,27,3,31
Terek Grozny,6714,6,8,5,7,24,24,0,29
FK Rubin,6714,7,6,5,9,25,20,5,23
Amkar,6714,8,6,4,10,11,22,-11,22
Din Moscow,6714,9,5,6,9,19,28,-9,21
Rostov,6714,10,4,6,10,10,19,-9,18
Anzhi,6714,11,2,5,13,15,42,-27,11
Loko Moscow,6715,1,12,5,3,31,14,17,41
CSKA Moscow,6715,2,12,3,5,27,17,10,39
Spart Moscow,6715,3,10,6,4,37,25,12,36
Zenit,6715,4,8,8,4,23,14,9,32
Krasnodar,6715,5,8,5,7,29,27,2,29
Terek Grozny,6715,6,7,5,8,20,24,-4,26
FK Rubin,6715,7,6,6,8,26,18,8,24
Din Moscow,6715,8,5,7,8,17,25,-8,22
Amkar,6715,9,5,4,11,10,24,-14,19
Rostov,6715,10,4,6,10,10,19,-9,18
Anzhi,6715,11,3,5,12,15,38,-23,14
Loko Moscow,6716,1,11,6,3,31,14,17,39
CSKA Moscow,6716,2,11,3,6,28,19,9,36
Zenit,6716,3,9,8,3,23,13,10,35
Spart Moscow,6716,4,8,7,5,38,31,7,31
Krasnodar,6716,5,8,6,6,30,27,3,30
Din Moscow,6716,6,7,6,7,20,22,-2,27
Terek Grozny,6716,7,7,6,7,20,23,-3,27
FK Rubin,6716,8,5,6,9,22,19,3,21
Amkar,6716,9,5,5,10,11,23,-12,20
Rostov,6716,10,4,7,9,13,20,-7,19
Anzhi,6716,11,2,6,12,15,40,-25,12
Loko Moscow,6717,1,12,6,2,32,12,20,42
Spart Moscow,6717,2,9,7,4,39,27,12,34
CSKA Moscow,6717,3,10,3,7,27,21,6,33
Zenit,6717,4,8,8,4,22,15,7,32
Terek Grozny,6717,5,8,6,6,23,22,1,30
Krasnodar,6717,6,8,5,7,29,27,2,29
FK Rubin,6717,7,6,6,8,23,18,5,24
Din Moscow,6717,8,5,7,8,17,25,-8,22
Rostov,6717,9,4,7,9,11,18,-7,19
Amkar,6717,10,4,5,11,10,26,-16,17
Anzhi,6717,11,3,6,11,17,39,-22,15
Loko Moscow,6718,1,12,6,2,31,11,20,42
Spart Moscow,6718,2,10,6,4,38,27,11,36
CSKA Moscow,6718,3,10,4,6,25,19,6,34
Zenit,6718,4,8,9,3,23,13,10,33
Krasnodar,6718,5,9,4,7,31,29,2,31
Terek Grozny,6718,6,8,5,7,23,25,-2,29
FK Rubin,6718,7,6,5,9,27,23,4,23
Din Moscow,6718,8,5,6,9,20,27,-7,21
Amkar,6718,9,5,5,10,12,24,-12,20
Rostov,6718,10,4,6,10,10,18,-8,18
Anzhi,6718,11,2,6,12,15,39,-24,12
Loko Moscow,6719,1,11,6,3,31,15,16,39
Spart Moscow,6719,2,11,5,4,42,29,13,38
Zenit,6719,3,9,8,3,25,14,11,35
CSKA Moscow,6719,4,10,3,7,26,21,5,33
Terek Grozny,6719,5,9,5,6,27,24,3,32
Krasnodar,6719,6,8,5,7,32,31,1,29
FK Rubin,6719,7,7,5,8,28,21,7,26
Din Moscow,6719,8,5,6,9,18,24,-6,21
Rostov,6719,9,4,6,10,11,20,-9,18
Amkar,6719,10,4,4,12,12,28,-16,16
Anzhi,6719,11,3,5,12,18,43,-25,14
Loko Moscow,6720,1,13,5,2,33,12,21,44
Spart Moscow,6720,2,10,6,4,39,29,10,36
CSKA Moscow,6720,3,11,3,6,27,19,8,36
Zenit,6720,4,8,8,4,22,14,8,32
Krasnodar,6720,5,9,4,7,31,28,3,31
Terek Grozny,6720,6,8,6,6,22,23,-1,30
Din Moscow,6720,7,5,7,8,19,24,-5,22
FK Rubin,6720,8,5,6,9,23,21,2,21
Rostov,6720,9,4,7,9,11,18,-7,19
Amkar,6720,10,4,5,11,12,26,-14,17
Anzhi,6720,11,2,5,13,15,40,-25,11
Loko Moscow,6721,1,12,6,2,32,12,20,42
CSKA Moscow,6721,2,11,3,6,28,19,9,36
Spart Moscow,6721,3,9,7,4,36,27,9,34
Zenit,6721,4,8,8,4,23,16,7,32
Terek Grozny,6721,5,9,5,6,24,24,0,32
Krasnodar,6721,6,8,5,7,27,25,2,29
FK Rubin,6721,7,7,5,8,23,17,6,26
Din Moscow,6721,8,5,6,9,18,24,-6,21
Rostov,6721,9,4,7,9,10,17,-7,19
Amkar,6721,10,4,5,11,11,25,-14,17
Anzhi,6721,11,2,5,13,16,42,-26,11
Loko Moscow,6722,1,12,5,3,31,13,18,41
CSKA Moscow,6722,2,11,4,5,28,18,10,37
Spart Moscow,6722,3,10,6,4,40,26,14,36
Krasnodar,6722,4,9,5,6,29,25,4,32
Zenit,6722,5,7,8,5,21,16,5,29
Terek Grozny,6722,6,8,5,7,22,24,-2,29
FK Rubin,6722,7,6,6,8,23,18,5,24
Din Moscow,6722,8,5,6,9,18,28,-10,21
Amkar,6722,9,5,5,10,10,22,-12,20
Rostov,6722,10,4,6,10,11,19,-8,18
Anzhi,6722,11,2,6,12,16,40,-24,12
Loko Moscow,6723,1,11,6,3,29,12,17,39
CSKA Moscow,6723,2,11,3,6,29,20,9,36
Spart Moscow,6723,3,10,5,5,42,30,12,35
Zenit,6723,4,8,9,3,24,14,10,33
Krasnodar,6723,5,9,4,7,28,25,3,31
Din Moscow,6723,6,7,6,7,21,23,-2,27
Terek Grozny,6723,7,7,6,7,21,24,-3,27
FK Rubin,6723,8,6,5,9,22,18,4,23
Amkar,6723,9,5,4,11,11,24,-13,19
Rostov,6723,10,4,6,10,11,22,-11,18
Anzhi,6723,11,2,6,12,15,41,-26,12
Loko Moscow,6724,1,11,6,3,33,16,17,39
Spart Moscow,6724,2,10,6,4,40,28,12,36
CSKA Moscow,6724,3,11,3,6,27,19,8,36
Krasnodar,6724,4,9,5,6,31,27,4,32
Zenit,6724,5,7,9,4,24,17,7,30
Terek Grozny,6724,6,8,6,6,23,23,0,30
Din Moscow,6724,7,5,8,7,19,23,-4,23
FK Rubin,6724,8,5,7,8,22,18,4,22
Rostov,6724,9,4,6,10,11,21,-10,18
Amkar,6724,10,4,4,12,9,25,-16,16
Anzhi,6724,11,3,6,11,16,38,-22,15
Loko Moscow,6725,1,12,6,2,31,12,19,42
CSKA Moscow,6725,2,11,3,6,29,22,7,36
Spart Moscow,6725,3,10,5,5,37,27,10,35
Zenit,6725,4,8,8,4,25,15,10,32
Krasnodar,6725,5,9,5,6,31,26,5,32
Terek Grozny,6725,6,7,6,7,22,25,-3,27
Din Moscow,6725,7,5,7,8,17,23,-6,22
FK Rubin,6725,8,5,6,9,22,20,2,21
Amkar,6725,9,5,5,10,13,24,-11,20
Rostov,6725,10,4,6,10,10,19,-9,18
Anzhi,6725,11,3,5,12,16,40,-24,14
Loko Moscow,6726,1,12,6,2,31,12,19,42
CSKA Moscow,6726,2,11,4,5,29,19,10,37
Spart Moscow,6726,3,9,5,6,38,32,6,32
Zenit,6726,4,7,10,3,23,15,8,31
Krasnodar,6726,5,8,5,7,29,27,2,29
Terek Grozny,6726,6,8,5,7,22,25,-3,29
Din Moscow,6726,7,6,7,7,22,24,-2,25
FK Rubin,6726,8,5,7,8,24,20,4,22
Amkar,6726,9,6,4,10,15,23,-8,22
Rostov,6726,10,4,6,10,11,21,-10,18
Anzhi,6726,11,2,5,13,14,40,-26,11
Loko Moscow,6727,1,11,5,4,32,16,16,38
CSKA Moscow,6727,2,11,3,6,27,20,7,36
Zenit,6727,3,9,8,3,26,14,12,35
Spart Moscow,6727,4,9,7,4,38,25,13,34
Krasnodar,6727,5,9,5,6,30,26,4,32
Terek Grozny,6727,6,9,5,6,24,22,2,32
Din Moscow,6727,7,6,7,7,19,21,-2,25
FK Rubin,6727,8,5,6,9,21,19,2,21
Rostov,6727,9,4,6,10,10,22,-12,18
Amkar,6727,10,4,5,11,9,23,-14,17
Anzhi,6727,11,2,5,13,14,42,-28,11
Loko Moscow,6728,1,11,6,3,30,13,17,39
Spart Moscow,6728,2,11,5,4,39,27,12,38
CSKA Moscow,6728,3,11,3,6,30,24,6,36
Krasnodar,6728,4,10,4,6,29,24,5,34
Zenit,6728,5,8,9,3,27,15,12,33
Terek Grozny,6728,6,8,5,7,23,25,-2,29
Din Moscow,6728,7,6,6,8,20,23,-3,24
FK Rubin,6728,8,5,5,10,21,20,1,20
Amkar,6728,9,5,4,11,11,24,-13,19
Rostov,6728,10,4,6,10,11,20,-9,18
Anzhi,6728,11,2,5,13,17,43,-26,11
Loko Moscow,6729,1,12,6,2,32,12,20,42
CSKA Moscow,6729,2,12,3,5,29,18,11,39
Spart Moscow,6729,3,10,5,5,37,28,9,35
Krasnodar,6729,4,9,5,6,30,26,4,32
Terek Grozny,6729,5,8,6,6,22,22,0,30
Zenit,6729,6,7,8,5,23,19,4,29
Din Moscow,6729,7,5,7,8,19,24,-5,22
FK Rubin,6729,8,5,6,9,24,21,3,21
Rostov,6729,9,5,6,9,11,17,-6,21
Amkar,6729,10,4,4,12,10,26,-16,16
Anzhi,6729,11,2,6,12,14,38,-24,12
Loko Moscow,6730,1,13,5,2,35,12,23,44
Spart Moscow,6730,2,11,5,4,40,26,14,38
CSKA Moscow,6730,3,10,4,6,26,19,7,34
Zenit,6730,4,7,9,4,21,16,5,30
Krasnodar,6730,5,8,5,7,28,27,1,29
Terek Grozny,6730,6,8,5,7,21,23,-2,29
Din Moscow,6730,7,6,6,8,20,24,-4,24
FK Rubin,6730,8,5,6,9,22,19,3,21
Amkar,6730,9,5,4,11,10,23,-13,19
Rostov,6730,10,4,6,10,10,21,-11,18
Anzhi,6730,11,3,5,12,16,39,-23,14
Loko Moscow,6731,1,11,6,3,30,13,17,39
CSKA Moscow,6731,2,10,4,6,26,20,6,34
Krasnodar,6731,3,10,4,6,31,26,5,34
Zenit,6731,4,8,9,3,24,14,10,33
Spart Moscow,6731,5,9,5,6,36,30,6,32
Terek Grozny,6731,6,7,6,7,21,25,-4,27
Din Moscow,6731,7,6,6,8,21,24,-3,24
Amkar,6731,8,6,4,10,14,23,-9,22
Rostov,6731,9,5,6,9,11,17,-6,21
FK Rubin,6731,10,5,5,10,22,21,1,20
Anzhi,6731,11,2,7,11,14,37,-23,13
Loko Moscow,6732,1,11,6,3,30,13,17,39
Spart Moscow,6732,2,11,5,4,43,29,14,38
CSKA Moscow,6732,3,10,5,5,27,19,8,35
Krasnodar,6732,4,9,5,6,30,26,4,32
Zenit,6732,5,7,10,3,21,13,8,31
Terek Grozny,6732,6,8,6,6,22,23,-1,30
FK Rubin,6732,7,6,6,8,24,19,5,24
Din Moscow,6732,8,5,6,9,21,29,-8,21
Rostov,6732,9,4,6,10,11,19,-8,18
Amkar,6732,10,4,4,12,10,26,-16,16
Anzhi,6732,11,2,7,11,16,39,-23,13
Loko Moscow,6733,1,11,5,4,30,15,15,38
Spart Moscow,6733,2,11,5,4,39,25,14,38
Zenit,6733,3,9,8,3,25,15,10,35
CSKA Moscow,6733,4,10,3,7,26,23,3,33
Krasnodar,6733,5,9,4,7,30,26,4,31
Terek Grozny,6733,6,7,6,7,20,24,-4,27
FK Rubin,6733,7,7,5,8,24,18,6,26
Din Moscow,6733,8,5,6,9,17,25,-8,21
Rostov,6733,9,4,6,10,10,18,-8,18
Amkar,6733,10,4,5,11,9,24,-15,17
Anzhi,6733,11,4,5,11,20,37,-17,17
Loko Moscow,6734,1,12,6,2,30,11,19,42
CSKA Moscow,6734,2,11,4,5,31,20,11,37
Spart Moscow,6734,3,9,7,4,38,29,9,34
Krasnodar,6734,4,9,5,6,30,24,6,32
Zenit,6734,5,7,9,4,23,16,7,30
Terek Grozny,6734,6,7,6,7,21,24,-3,27
Din Moscow,6734,7,5,8,7,20,24,-4,23
FK Rubin,6734,8,5,6,9,22,21,1,21
Amkar,6734,9,5,5,10,12,24,-12,20
Rostov,6734,10,4,6,10,10,18,-8,18
Anzhi,6734,11,2,6,12,16,42,-26,12
Loko Moscow,6735,1,12,5,3,30,15,15,41
CSKA Moscow,6735,2,12,3,5,27,17,10,39
Spart Moscow,6735,3,10,5,5,38,28,10,35
Zenit,6735,4,8,8,4,25,14,11,32
Krasnodar,6735,5,9,4,7,30,26,4,31
Terek Grozny,6735,6,7,5,8,20,28,-8,26
Din Moscow,6735,7,5,7,8,18,24,-6,22
Amkar,6735,8,6,4,10,14,22,-8,22
FK Rubin,6735,9,5,6,9,22,20,2,21
Rostov,6735,10,4,6,10,11,19,-8,18
Anzhi,6735,11,3,5,12,16,38,-22,14
Loko Moscow,6736,1,11,5,4,30,16,14,38
CSKA Moscow,6736,2,11,4,5,28,18,10,37
Spart Moscow,6736,3,10,5,5,39,30,9,35
Krasnodar,6736,4,10,4,6,30,24,6,34
Zenit,6736,5,8,9,3,25,15,10,33
Terek Grozny,6736,6,8,5,7,24,23,1,29
Din Moscow,6736,7,6,7,7,19,22,-3,25
FK Rubin,6736,8,5,6,9,21,18,3,21
Amkar,6736,9,5,4,11,11,24,-13,19
Rostov,6736,10,4,6,10,12,20,-8,18
Anzhi,6736,11,2,5,13,14,43,-29,11
Loko Moscow,6737,1,13,5,2,32,12,20,44
CSKA Moscow,6737,2,11,4,5,29,19,10,37
Spart Moscow,6737,3,9,6,5,39,31,8,33
Krasnodar,6737,4,9,4,7,30,26,4,31
Zenit,6737,5,7,9,4,23,16,7,30
Terek Grozny,6737,6,7,6,7,22,26,-4,27
FK Rubin,6737,7,6,5,9,24,20,4,23
Din Moscow,6737,8,5,7,8,19,25,-6,22
Rostov,6737,9,5,6,9,11,17,-6,21
Amkar,6737,10,5,4,11,15,27,-12,19
Anzhi,6737,11,2,6,12,16,41,-25,12
Loko Moscow,6738,1,12,6,2,32,12,20,42
CSKA Moscow,6738,2,11,3,6,28,19,9,36
Zenit,6738,3,8,8,4,24,17,7,32
Krasnodar,6738,4,9,5,6,29,24,5,32
Spart Moscow,6738,5,8,7,5,36,29,7,31
Terek Grozny,6738,6,8,5,7,21,25,-4,29
FK Rubin,6738,7,6,5,9,22,19,3,23
Din Moscow,6738,8,5,7,8,19,24,-5,22
Rostov,6738,9,5,6,9,11,17,-6,21
Amkar,6738,10,4,5,11,10,24,-14,17
Anzhi,6738,11,3,5,12,17,39,-22,14
Loko Moscow,6739,1,13,5,2,33,13,20,44
Spart Moscow,6739,2,11,5,4,40,25,15,38
CSKA Moscow,6739,3,11,4,5,30,21,9,37
Terek Grozny,6739,4,9,5,6,23,22,1,32
Zenit,6739,5,7,9,4,23,16,7,30
Krasnodar,6739,6,8,5,7,29,27,2,29
FK Rubin,6739,7,6,6,8,23,18,5,24
Din Moscow,6739,8,5,6,9,17,25,-8,21
Rostov,6739,9,4,6,10,10,19,-9,18
Amkar,6739,10,4,4,12,9,26,-17,16
Anzhi,6739,11,2,5,13,17,42,-25,11
Loko Moscow,6740,1,12,6,2,31,12,19,42
CSKA Moscow,6740,2,11,3,6,28,18,10,36
Spart Moscow,6740,3,10,5,5,37,27,10,35
Zenit,6740,4,8,9,3,23,14,9,33
Krasnodar,6740,5,9,4,7,28,25,3,31
Terek Grozny,6740,6,7,6,7,20,23,-3,27
Din Moscow,6740,7,5,7,8,18,24,-6,22
FK Rubin,6740,8,5,6,9,21,18,3,21
Rostov,6740,9,5,6,9,11,17,-6,21
Amkar,6740,10,4,5,11,9,23,-14,17
Anzhi,6740,11,3,5,12,15,40,-25,14
Loko Moscow,6741,1,11,7,2,31,13,18,40
Spart Moscow,6741,2,10,6,4,38,28,10,36
CSKA Moscow,6741,3,11,3,6,30,20,10,36
Zenit,6741,4,8,9,3,23,14,9,33
Krasnodar,6741,5,9,5,6,31,25,6,32
Terek Grozny,6741,6,8,6,6,25,24,1,30
FK Rubin,6741,7,6,5,9,22,20,2,23
Din Moscow,6741,8,5,6,9,18,24,-6,21
Rostov,6741,9,4,6,10,10,18,-8,18
Amkar,6741,10,4,5,11,13,29,-16,17
Anzhi,6741,11,2,6,12,16,42,-26,12
Loko Moscow,6742,1,12,6,2,31,12,19,42
CSKA Moscow,6742,2,11,3,6,26,19,7,36
Zenit,6742,3,8,8,4,23,14,9,32
Krasnodar,6742,4,9,5,6,30,25,5,32
Terek Grozny,6742,5,9,5,6,27,22,5,32
Spart Moscow,6742,6,8,7,5,35,30,5,31
Din Moscow,6742,7,6,7,7,21,23,-2,25
Rostov,6742,8,5,6,9,13,17,-4,21
FK Rubin,6742,9,5,5,10,22,22,0,20
Amkar,6742,10,4,5,11,10,27,-17,17
Anzhi,6742,11,2,5,13,14,41,-27,11
Loko Moscow,6743,1,12,6,2,31,12,19,42
CSKA Moscow,6743,2,12,3,5,30,19,11,39
Spart Moscow,6743,3,8,7,5,34,27,7,31
Zenit,6743,4,7,9,4,23,17,6,30
Terek Grozny,6743,5,8,6,6,21,22,-1,30
Krasnodar,6743,6,8,5,7,28,26,2,29
FK Rubin,6743,7,6,6,8,23,18,5,24
Din Moscow,6743,8,5,7,8,18,23,-5,22
Rostov,6743,9,5,6,9,11,17,-6,21
Amkar,6743,10,4,6,10,9,22,-13,18
Anzhi,6743,11,2,5,13,15,40,-25,11
Loko Moscow,6744,1,11,6,3,32,15,17,39
CSKA Moscow,6744,2,11,4,5,29,19,10,37
Spart Moscow,6744,3,9,6,5,38,29,9,33
Krasnodar,6744,4,9,5,6,31,27,4,32
Zenit,6744,5,7,9,4,23,17,6,30
Terek Grozny,6744,6,7,6,7,22,27,-5,27
FK Rubin,6744,7,6,6,8,25,19,6,24
Amkar,6744,8,6,4,10,15,23,-8,22
Din Moscow,6744,9,5,6,9,17,26,-9,21
Rostov,6744,10,4,7,9,11,18,-7,19
Anzhi,6744,11,2,7,11,18,41,-23,13
Loko Moscow,6745,1,11,6,3,30,13,17,39
CSKA Moscow,6745,2,11,3,6,27,22,5,36
Zenit,6745,3,8,9,3,26,14,12,33
Spart Moscow,6745,4,9,6,5,36,28,8,33
Krasnodar,6745,5,9,5,6,28,24,4,32
Terek Grozny,6745,6,8,6,6,23,23,0,30
FK Rubin,6745,7,6,6,8,22,17,5,24
Din Moscow,6745,8,6,6,8,19,23,-4,24
Rostov,6745,9,4,7,9,11,18,-7,19
Amkar,6745,10,4,4,12,9,25,-16,16
Anzhi,6745,11,2,6,12,16,40,-24,12
Loko Moscow,6746,1,11,6,3,31,14,17,39
Spart Moscow,6746,2,10,6,4,39,26,13,36
CSKA Moscow,6746,3,11,3,6,27,20,7,36
Zenit,6746,4,8,9,3,26,15,11,33
Krasnodar,6746,5,9,4,7,29,26,3,31
Terek Grozny,6746,6,7,5,8,20,27,-7,26
Din Moscow,6746,7,6,6,8,20,27,-7,24
FK Rubin,6746,8,6,5,9,25,21,4,23
Rostov,6746,9,4,7,9,11,18,-7,19
Amkar,6746,10,5,4,11,10,23,-13,19
Anzhi,6746,11,3,5,12,18,39,-21,14
Loko Moscow,6747,1,13,5,2,34,12,22,44
CSKA Moscow,6747,2,11,4,5,28,19,9,37
Spart Moscow,6747,3,10,5,5,39,29,10,35
Terek Grozny,6747,4,9,5,6,24,24,0,32
Krasnodar,6747,5,9,4,7,33,28,5,31
Zenit,6747,6,7,9,4,22,17,5,30
Din Moscow,6747,7,5,7,8,18,24,-6,22
FK Rubin,6747,8,5,6,9,23,22,1,21
Amkar,6747,9,5,4,11,12,25,-13,19
Rostov,6747,10,4,6,10,11,19,-8,18
Anzhi,6747,11,2,5,13,16,41,-25,11
Loko Moscow,6748,1,13,5,2,34,12,22,44
Spart Moscow,6748,2,11,5,4,43,27,16,38
CSKA Moscow,6748,3,11,3,6,27,19,8,36
Zenit,6748,4,7,8,5,22,18,4,29
Krasnodar,6748,5,8,5,7,29,28,1,29
Terek Grozny,6748,6,8,5,7,22,25,-3,29
Din Moscow,6748,7,6,6,8,20,25,-5,24
FK Rubin,6748,8,5,6,9,23,21,2,21
Rostov,6748,9,4,6,10,11,20,-9,18
Anzhi,6748,10,4,5,11,19,38,-19,17
Amkar,6748,11,4,4,12,9,26,-17,16
Loko Moscow,6749,1,12,6,2,30,11,19,42
CSKA Moscow,6749,2,11,4,5,29,18,11,37
Zenit,6749,3,7,9,4,22,15,7,30
Spart Moscow,6749,4,8,6,6,36,30,6,30
Krasnodar,6749,5,8,6,6,28,25,3,30
Terek Grozny,6749,6,7,6,7,23,26,-3,27
Din Moscow,6749,7,6,7,7,19,21,-2,25
Amkar,6749,8,6,4,10,13,24,-11,22
FK Rubin,6749,9,5,6,9,22,20,2,21
Rostov,6749,10,5,6,9,13,19,-6,21
Anzhi,6749,11,2,6,12,16,42,-26,12
Loko Moscow,6750,1,11,6,3,31,15,16,39
CSKA Moscow,6750,2,11,3,6,28,19,9,36
Zenit,6750,3,9,8,3,24,13,11,35
Spart Moscow,6750,4,10,5,5,38,28,10,35
Krasnodar,6750,5,9,5,6,33,27,6,32
Terek Grozny,6750,6,7,6,7,22,25,-3,27
FK Rubin,6750,7,6,5,9,24,21,3,23
Amkar,6750,8,6,4,10,12,23,-11,22
Din Moscow,6750,9,5,6,9,17,25,-8,21
Rostov,6750,10,4,6,10,11,19,-8,18
Anzhi,6750,11,2,6,12,17,42,-25,12
Loko Moscow,6751,1,12,6,2,32,12,20,42
CSKA Moscow,6751,2,11,3,6,26,20,6,36
Spart Moscow,6751,3,10,5,5,43,27,16,35
Zenit,6751,4,8,8,4,24,15,9,32
Krasnodar,6751,5,9,5,6,31,25,6,32
Terek Grozny,6751,6,9,5,6,24,22,2,32
FK Rubin,6751,7,6,5,9,22,20,2,23
Din Moscow,6751,8,5,6,9,17,26,-9,21
Amkar,6751,9,5,4,11,10,24,-14,19
Rostov,6751,10,4,6,10,11,23,-12,18
Anzhi,6751,11,2,5,13,14,40,-26,11
Loko Moscow,6752,1,11,7,2,33,15,18,40
CSKA Moscow,6752,2,11,4,5,27,18,9,37
Spart Moscow,6752,3,10,6,4,39,27,12,36
Krasnodar,6752,4,9,5,6,34,28,6,32
Zenit,6752,5,7,9,4,23,16,7,30
Terek Grozny,6752,6,8,6,6,23,24,-1,30
Din Moscow,6752,7,6,7,7,22,24,-2,25
FK Rubin,6752,8,5,5,10,23,24,-1,20
Rostov,6752,9,4,6,10,10,19,-9,18
Amkar,6752,10,4,5,11,11,26,-15,17
Anzhi,6752,11,2,6,12,14,38,-24,12
Loko Moscow,6753,1,11,5,4,30,15,15,38
Spart Moscow,6753,2,10,6,4,39,28,11,36
CSKA Moscow,6753,3,11,3,6,28,18,10,36
Zenit,6753,4,9,8,3,23,13,10,35
Krasnodar,6753,5,10,4,6,32,26,6,34
Terek Grozny,6753,6,8,5,7,21,24,-3,29
Din Moscow,6753,7,5,7,8,20,26,-6,22
FK Rubin,6753,8,5,6,9,23,20,3,21
Rostov,6753,9,4,7,9,10,17,-7,19
Amkar,6753,10,4,4,12,10,25,-15,16
Anzhi,6753,11,3,5,12,16,40,-24,14
Loko Moscow,6754,1,11,7,2,32,14,18,40
CSKA Moscow,6754,2,11,4,5,27,18,9,37
Spart Moscow,6754,3,10,6,4,37,27,10,36
Zenit,6754,4,7,9,4,23,16,7,30
Krasnodar,6754,5,8,5,7,28,28,0,29
Terek Grozny,6754,6,8,5,7,23,24,-1,29
FK Rubin,6754,7,7,5,8,26,18,8,26
Din Moscow,6754,8,5,6,9,19,25,-6,21
Rostov,6754,9,4,7,9,11,18,-7,19
Amkar,6754,10,4,4,12,10,26,-16,16
Anzhi,6754,11,3,6,11,16,38,-22,15
Loko Moscow,6755,1,12,5,3,33,14,19,41
CSKA Moscow,6755,2,11,3,6,29,19,10,36
Spart Moscow,6755,3,10,5,5,38,28,10,35
Krasnodar,6755,4,10,4,6,32,26,6,34
Zenit,6755,5,8,8,4,24,18,6,32
Terek Grozny,6755,6,8,5,7,22,24,-2,29
Din Moscow,6755,7,6,6,8,19,24,-5,24
Amkar,6755,8,6,4,10,13,23,-10,22
FK Rubin,6755,9,5,5,10,24,22,2,20
Rostov,6755,10,4,6,10,10,19,-9,18
Anzhi,6755,11,2,5,13,15,42,-27,11
Loko Moscow,6756,1,12,6,2,32,12,20,42
Spart Moscow,6756,2,10,6,4,40,28,12,36
CSKA Moscow,6756,3,10,5,5,28,20,8,35
Krasnodar,6756,4,9,5,6,29,24,5,32
Terek Grozny,6756,5,9,5,6,23,22,1,32
Zenit,6756,6,7,9,4,24,18,6,30
Din Moscow,6756,7,5,7,8,18,25,-7,22
FK Rubin,6756,8,5,6,9,22,20,2,21
Rostov,6756,9,4,6,10,11,19,-8,18
Amkar,6756,10,4,5,11,11,25,-14,17
Anzhi,6756,11,2,6,12,15,40,-25,12
Loko Moscow,6757,1,13,5,2,33,13,20,44
CSKA Moscow,6757,2,11,3,6,28,19,9,36
Spart Moscow,6757,3,8,7,5,35,29,6,31
Krasnodar,6757,4,9,4,7,30,27,3,31
Zenit,6757,5,7,8,5,21,17,4,29
Terek Grozny,6757,6,8,5,7,22,26,-4,29
FK Rubin,6757,7,6,5,9,22,18,4,23
Din Moscow,6757,8,5,7,8,18,23,-5,22
Amkar,6757,9,6,4,10,15,23,-8,22
Rostov,6757,10,4,7,9,11,18,-7,19
Anzhi,6757,11,3,5,12,16,38,-22,14
Loko Moscow,6758,1,12,5,3,30,12,18,41
CSKA Moscow,6758,2,11,3,6,28,20,8,36
Spart Moscow,6758,3,9,7,4,38,29,9,34
Zenit,6758,4,8,8,4,24,15,9,32
Krasnodar,6758,5,9,4,7,28,25,3,31
Terek Grozny,6758,6,8,6,6,22,23,-1,30
Din Moscow,6758,7,6,6,8,20,23,-3,24
FK Rubin,6758,8,6,5,9,22,19,3,23
Rostov,6758,9,4,7,9,11,18,-7,19
Amkar,6758,10,4,5,11,11,25,-14,17
Anzhi,6758,11,2,6,12,15,40,-25,12
Loko Moscow,6759,1,11,6,3,30,14,16,39
CSKA Moscow,6759,2,12,3,5,30,18,12,39
Spart Moscow,6759,3,10,5,5,37,27,10,35
Zenit,6759,4,8,8,4,23,14,9,32
Krasnodar,6759,5,9,5,6,30,26,4,32
Terek Grozny,6759,6,9,5,6,25,22,3,32
Din Moscow,6759,7,6,6,8,20,25,-5,24
FK Rubin,6759,8,5,5,10,24,22,2,20
Amkar,6759,9,5,4,11,11,23,-12,19
Rostov,6759,10,4,6,10,10,19,-9,18
Anzhi,6759,11,2,5,13,15,45,-30,11
Loko Moscow,6760,1,11,5,4,30,14,16,38
CSKA Moscow,6760,2,11,3,6,29,18,11,36
Zenit,6760,3,9,8,3,24,14,10,35
Krasnodar,6760,4,10,4,6,30,24,6,34
Spart Moscow,6760,5,9,6,5,37,27,10,33
Terek Grozny,6760,6,8,6,6,23,23,0,30
Din Moscow,6760,7,6,6,8,19,25,-6,24
Rostov,6760,8,5,6,9,11,17,-6,21
FK Rubin,6760,9,5,5,10,22,21,1,20
Amkar,6760,10,4,6,10,11,24,-13,18
Anzhi,6760,11,2,5,13,14,43,-29,11
Loko Moscow,6761,1,11,6,3,29,13,16,39
Spart Moscow,6761,2,11,5,4,38,26,12,38
CSKA Moscow,6761,3,11,4,5,28,19,9,37
Krasnodar,6761,4,9,5,6,29,24,5,32
Zenit,6761,5,7,9,4,21,14,7,30
Terek Grozny,6761,6,8,5,7,21,23,-2,29
FK Rubin,6761,7,6,6,8,22,17,5,24
Din Moscow,6761,8,5,6,9,17,24,-7,21
Rostov,6761,9,4,6,10,10,18,-8,18
Amkar,6761,10,4,4,12,10,25,-15,16
Anzhi,6761,11,3,6,11,17,39,-22,15
Loko Moscow,6762,1,12,6,2,30,11,19,42
Spart Moscow,6762,2,10,5,5,41,28,13,35
CSKA Moscow,6762,3,10,4,6,26,19,7,34
Zenit,6762,4,8,9,3,22,13,9,33
Krasnodar,6762,5,9,4,7,29,26,3,31
Terek Grozny,6762,6,8,5,7,22,25,-3,29
Din Moscow,6762,7,6,6,8,18,26,-8,24
Rostov,6762,8,5,6,9,12,18,-6,21
FK Rubin,6762,9,5,5,10,22,20,2,20
Amkar,6762,10,4,4,12,10,25,-15,16
Anzhi,6762,11,3,6,11,18,39,-21,15
Loko Moscow,6763,1,13,5,2,32,12,20,44
CSKA Moscow,6763,2,11,3,6,26,18,8,36
Spart Moscow,6763,3,9,6,5,39,30,9,33
Zenit,6763,4,8,8,4,22,14,8,32
Krasnodar,6763,5,9,4,7,30,26,4,31
Terek Grozny,6763,6,8,6,6,24,25,-1,30
Din Moscow,6763,7,7,6,7,21,22,-1,27
FK Rubin,6763,8,5,5,10,21,21,0,20
Rostov,6763,9,4,7,9,11,18,-7,19
Amkar,6763,10,4,5,11,13,28,-15,17
Anzhi,6763,11,2,5,13,15,40,-25,11
Loko Moscow,6764,1,12,5,3,34,14,20,41
CSKA Moscow,6764,2,11,3,6,30,19,11,36
Krasnodar,6764,3,10,4,6,34,26,8,34
Spart Moscow,6764,4,9,6,5,35,27,8,33
Zenit,6764,5,8,8,4,23,17,6,32
Terek Grozny,6764,6,9,5,6,24,24,0,32
FK Rubin,6764,7,6,5,9,23,22,1,23
Din Moscow,6764,8,5,6,9,18,24,-6,21
Rostov,6764,9,5,6,9,11,17,-6,21
Amkar,6764,10,4,5,11,10,24,-14,17
Anzhi,6764,11,2,5,13,16,44,-28,11
Loko Moscow,6765,1,12,5,3,31,13,18,41
Spart Moscow,6765,2,10,6,4,40,29,11,36
CSKA Moscow,6765,3,11,3,6,28,21,7,36
Zenit,6765,4,9,8,3,25,14,11,35
Krasnodar,6765,5,8,5,7,28,26,2,29
Terek Grozny,6765,6,7,7,6,20,22,-2,28
FK Rubin,6765,7,6,6,8,24,18,6,24
Din Moscow,6765,8,5,6,9,17,25,-8,21
Rostov,6765,9,4,6,10,12,20,-8,18
Amkar,6765,10,4,6,10,11,24,-13,18
Anzhi,6765,11,2,6,12,16,40,-24,12
Loko Moscow,6766,1,12,6,2,30,11,19,42
Spart Moscow,6766,2,10,5,5,39,29,10,35
CSKA Moscow,6766,3,10,4,6,25,18,7,34
Zenit,6766,4,7,9,4,21,14,7,30
Krasnodar,6766,5,8,6,6,29,26,3,30
Terek Grozny,6766,6,8,6,6,24,24,0,30
FK Rubin,6766,7,5,7,8,24,20,4,22
Din Moscow,6766,8,5,7,8,20,26,-6,22
Rostov,6766,9,5,6,9,12,17,-5,21
Amkar,6766,10,4,4,12,10,27,-17,16
Anzhi,6766,11,3,6,11,16,38,-22,15
Loko Moscow,6767,1,11,6,3,32,15,17,39
CSKA Moscow,6767,2,12,3,5,29,18,11,39
Krasnodar,6767,3,10,4,6,31,26,5,34
Spart Moscow,6767,4,9,6,5,36,27,9,33
Zenit,6767,5,7,9,4,22,16,6,30
Terek Grozny,6767,6,7,6,7,20,23,-3,27
Din Moscow,6767,7,6,7,7,20,21,-1,25
Rostov,6767,8,5,6,9,11,17,-6,21
FK Rubin,6767,9,5,5,10,21,21,0,20
Amkar,6767,10,5,4,11,11,25,-14,19
Anzhi,6767,11,2,6,12,15,39,-24,12
Loko Moscow,6768,1,11,5,4,29,15,14,38
Spart Moscow,6768,2,10,6,4,38,27,11,36
CSKA Moscow,6768,3,11,3,6,27,20,7,36
Krasnodar,6768,4,10,4,6,32,27,5,34
Zenit,6768,5,8,8,4,24,14,10,32
Terek Grozny,6768,6,8,6,6,23,24,-1,30
FK Rubin,6768,7,6,5,9,25,21,4,23
Din Moscow,6768,8,5,6,9,18,25,-7,21
Rostov,6768,9,4,6,10,10,18,-8,18
Amkar,6768,10,4,5,11,10,24,-14,17
Anzhi,6768,11,3,6,11,19,40,-21,15
CSKA Moscow,6769,1,12,3,5,29,18,11,39
Loko Moscow,6769,2,11,5,4,29,13,16,38
Spart Moscow,6769,3,10,6,4,40,27,13,36
Zenit,6769,4,8,8,4,22,15,7,32
Krasnodar,6769,5,9,5,6,29,25,4,32
Terek Grozny,6769,6,8,6,6,22,23,-1,30
Din Moscow,6769,7,6,6,8,18,23,-5,24
FK Rubin,6769,8,5,6,9,22,19,3,21
Rostov,6769,9,4,6,10,10,20,-10,18
Amkar,6769,10,4,6,10,11,24,-13,18
Anzhi,6769,11,2,5,13,16,41,-25,11
Loko Moscow,6770,1,13,5,2,36,12,24,44
CSKA Moscow,6770,2,10,4,6,25,19,6,34
Zenit,6770,3,8,8,4,23,15,8,32
Spart Moscow,6770,4,8,7,5,35,28,7,31
Terek Grozny,6770,5,8,5,7,24,24,0,29
Krasnodar,6770,6,8,5,7,29,30,-1,29
FK Rubin,6770,7,6,6,8,23,18,5,24
Din Moscow,6770,8,5,7,8,17,22,-5,22
Rostov,6770,9,5,6,9,12,18,-6,21
Amkar,6770,10,4,5,11,10,26,-16,17
Anzhi,6770,11,3,6,11,16,38,-22,15
Loko Moscow,6771,1,12,5,3,33,14,19,41
Spart Moscow,6771,2,10,6,4,38,26,12,36
CSKA Moscow,6771,3,11,3,6,27,19,8,36
Krasnodar,6771,4,10,4,6,34,27,7,34
Zenit,6771,5,8,8,4,22,15,7,32
Terek Grozny,6771,6,7,7,6,20,22,-2,28
FK Rubin,6771,7,6,5,9,24,21,3,23
Din Moscow,6771,8,5,6,9,17,25,-8,21
Rostov,6771,9,4,6,10,10,19,-9,18
Amkar,6771,10,4,6,10,10,23,-13,18
Anzhi,6771,11,2,6,12,15,39,-24,12
Loko Moscow,6772,1,12,5,3,32,13,19,41
Spart Moscow,6772,2,10,6,4,37,26,11,36
CSKA Moscow,6772,3,10,4,6,25,18,7,34
Krasnodar,6772,4,10,4,6,30,25,5,34
Zenit,6772,5,8,8,4,22,15,7,32
Terek Grozny,6772,6,9,5,6,25,25,0,32
FK Rubin,6772,7,6,5,9,23,19,4,23
Din Moscow,6772,8,5,6,9,18,25,-7,21
Rostov,6772,9,4,7,9,11,18,-7,19
Amkar,6772,10,4,4,12,11,26,-15,16
Anzhi,6772,11,2,6,12,15,39,-24,12
Loko Moscow,6773,1,12,5,3,30,12,18,41
Spart Moscow,6773,2,10,5,5,38,30,8,35
CSKA Moscow,6773,3,10,4,6,28,21,7,34
Krasnodar,6773,4,9,4,7,28,26,2,31
Zenit,6773,5,7,9,4,21,14,7,30
Terek Grozny,6773,6,8,5,7,25,27,-2,29
FK Rubin,6773,7,7,5,8,24,17,7,26
Din Moscow,6773,8,5,6,9,18,24,-6,21
Amkar,6773,9,5,4,11,14,27,-13,19
Rostov,6773,10,4,6,10,11,19,-8,18
Anzhi,6773,11,4,5,11,21,41,-20,17
Loko Moscow,6774,1,11,6,3,30,13,17,39
CSKA Moscow,6774,2,11,4,5,28,18,10,37
Spart Moscow,6774,3,10,6,4,39,27,12,36
Krasnodar,6774,4,10,4,6,30,25,5,34
Zenit,6774,5,7,10,3,23,15,8,31
Terek Grozny,6774,6,8,6,6,24,24,0,30
FK Rubin,6774,7,6,5,9,24,20,4,23
Din Moscow,6774,8,5,6,9,19,26,-7,21
Rostov,6774,9,4,6,10,10,19,-9,18
Amkar,6774,10,4,6,10,11,24,-13,18
Anzhi,6774,11,2,5,13,15,42,-27,11
Loko Moscow,6775,1,11,6,3,30,15,15,39
CSKA Moscow,6775,2,11,4,5,27,17,10,37
Spart Moscow,6775,3,9,6,5,37,27,10,33
Zenit,6775,4,7,10,3,22,14,8,31
Krasnodar,6775,5,9,4,7,30,25,5,31
Terek Grozny,6775,6,8,5,7,22,24,-2,29
Din Moscow,6775,7,6,7,7,20,22,-2,25
FK Rubin,6775,8,6,5,9,22,19,3,23
Amkar,6775,9,5,4,11,10,23,-13,19
Rostov,6775,10,4,6,10,10,20,-10,18
Anzhi,6775,11,3,5,12,16,40,-24,14
Loko Moscow,6776,1,11,7,2,29,11,18,40
Spart Moscow,6776,2,11,5,4,39,27,12,38
CSKA Moscow,6776,3,10,4,6,26,19,7,34
Zenit,6776,4,8,9,3,23,14,9,33
Krasnodar,6776,5,9,5,6,28,24,4,32
Terek Grozny,6776,6,8,6,6,23,24,-1,30
Din Moscow,6776,7,6,6,8,19,22,-3,24
FK Rubin,6776,8,5,5,10,21,20,1,20
Rostov,6776,9,4,6,10,11,19,-8,18
Amkar,6776,10,4,5,11,12,27,-15,17
Anzhi,6776,11,2,6,12,14,38,-24,12
Loko Moscow,6777,1,11,6,3,29,12,17,39
CSKA Moscow,6777,2,12,3,5,27,17,10,39
Spart Moscow,6777,3,10,5,5,37,27,10,35
Terek Grozny,6777,4,9,5,6,27,26,1,32
Krasnodar,6777,5,9,4,7,29,28,1,31
Zenit,6777,6,7,9,4,21,14,7,30
FK Rubin,6777,7,7,5,8,27,18,9,26
Rostov,6777,8,5,6,9,12,18,-6,21
Din Moscow,6777,9,5,6,9,17,25,-8,21
Amkar,6777,10,4,4,12,11,26,-15,16
Anzhi,6777,11,2,5,13,16,42,-26,11
Loko Moscow,6778,1,11,6,3,30,15,15,39
CSKA Moscow,6778,2,11,3,6,28,18,10,36
Krasnodar,6778,3,10,4,6,31,24,7,34
Zenit,6778,4,8,9,3,23,14,9,33
Terek Grozny,6778,5,9,5,6,25,24,1,32
Spart Moscow,6778,6,8,6,6,35,29,6,30
Din Moscow,6778,7,7,6,7,21,22,-1,27
Rostov,6778,8,5,6,9,12,18,-6,21
FK Rubin,6778,9,5,5,10,22,21,1,20
Amkar,6778,10,4,5,11,11,26,-15,17
Anzhi,6778,11,2,5,13,15,42,-27,11
Loko Moscow,6779,1,12,6,2,30,11,19,42
CSKA Moscow,6779,2,11,4,5,27,18,9,37
Spart Moscow,6779,3,10,5,5,36,26,10,35
Zenit,6779,4,7,9,4,21,14,7,30
Krasnodar,6779,5,8,5,7,27,25,2,29
Din Moscow,6779,6,7,6,7,20,22,-2,27
Terek Grozny,6779,7,7,6,7,21,24,-3,27
FK Rubin,6779,8,6,5,9,23,19,4,23
Rostov,6779,9,4,6,10,10,19,-9,18
Amkar,6779,10,4,5,11,10,24,-14,17
Anzhi,6779,11,3,5,12,16,39,-23,14
Loko Moscow,6780,1,11,6,3,30,14,16,39
CSKA Moscow,6780,2,12,3,5,28,18,10,39
Spart Moscow,6780,3,9,5,6,36,29,7,32
Krasnodar,6780,4,9,4,7,30,28,2,31
Zenit,6780,5,7,9,4,22,15,7,30
Terek Grozny,6780,6,7,6,7,23,27,-4,27
FK Rubin,6780,7,7,5,8,27,19,8,26
Din Moscow,6780,8,6,6,8,20,24,-4,24
Rostov,6780,9,5,6,9,11,17,-6,21
Amkar,6780,10,5,4,11,13,25,-12,19
Anzhi,6780,11,2,6,12,17,41,-24,12
Loko Moscow,6781,1,11,6,3,30,13,17,39
CSKA Moscow,6781,2,11,3,6,28,21,7,36
Zenit,6781,3,8,9,3,25,14,11,33
Spart Moscow,6781,4,8,8,4,38,30,8,32
Krasnodar,6781,5,9,4,7,28,26,2,31
Terek Grozny,6781,6,7,6,7,23,26,-3,27
FK Rubin,6781,7,6,6,8,24,18,6,24
Din Moscow,6781,8,5,8,7,20,24,-4,23
Amkar,6781,9,5,5,10,12,24,-12,20
Rostov,6781,10,4,7,9,12,19,-7,19
Anzhi,6781,11,2,6,12,17,42,-25,12
Loko Moscow,6782,1,13,5,2,32,12,20,44
Spart Moscow,6782,2,11,5,4,39,26,13,38
CSKA Moscow,6782,3,11,4,5,27,18,9,37
Terek Grozny,6782,4,9,5,6,24,23,1,32
Krasnodar,6782,5,9,4,7,29,26,3,31
Zenit,6782,6,7,9,4,21,14,7,30
Din Moscow,6782,7,6,6,8,21,25,-4,24
FK Rubin,6782,8,5,5,10,22,22,0,20
Rostov,6782,9,4,6,10,11,19,-8,18
Amkar,6782,10,4,4,12,9,25,-16,16
Anzhi,6782,11,2,5,13,16,41,-25,11
Loko Moscow,6783,1,12,5,3,30,12,18,41
CSKA Moscow,6783,2,11,4,5,29,19,10,37
Krasnodar,6783,3,10,4,6,29,24,5,34
Zenit,6783,4,7,9,4,23,16,7,30
Spart Moscow,6783,5,8,6,6,35,29,6,30
Terek Grozny,6783,6,8,5,7,23,25,-2,29
Din Moscow,6783,7,6,6,8,21,25,-4,24
FK Rubin,6783,8,6,5,9,24,20,4,23
Rostov,6783,9,5,6,9,11,17,-6,21
Amkar,6783,10,4,5,11,10,25,-15,17
Anzhi,6783,11,3,5,12,17,40,-23,14
Loko Moscow,6784,1,11,6,3,30,13,17,39
CSKA Moscow,6784,2,12,3,5,29,18,11,39
Spart Moscow,6784,3,11,5,4,37,26,11,38
Krasnodar,6784,4,10,4,6,30,25,5,34
Zenit,6784,5,7,9,4,22,15,7,30
Terek Grozny,6784,6,7,7,6,20,22,-2,28
Din Moscow,6784,7,5,7,8,19,24,-5,22
FK Rubin,6784,8,5,6,9,22,19,3,21
Rostov,6784,9,4,6,10,10,18,-8,18
Amkar,6784,10,4,5,11,9,23,-14,17
Anzhi,6784,11,2,6,12,14,39,-25,12
Loko Moscow,6785,1,12,6,2,31,12,19,42
CSKA Moscow,6785,2,11,4,5,28,18,10,37
Spart Moscow,6785,3,9,6,5,36,29,7,33
Krasnodar,6785,4,9,5,6,28,24,4,32
Zenit,6785,5,7,9,4,23,16,7,30
Terek Grozny,6785,6,8,5,7,21,24,-3,29
Din Moscow,6785,7,5,7,8,19,24,-5,22
FK Rubin,6785,8,5,6,9,22,19,3,21
Rostov,6785,9,5,6,9,13,18,-5,21
Amkar,6785,10,4,5,11,9,23,-14,17
Anzhi,6785,11,3,5,12,16,39,-23,14
Loko Moscow,6786,1,11,6,3,29,12,17,39
CSKA Moscow,6786,2,11,4,5,28,18,10,37
Spart Moscow,6786,3,9,6,5,35,27,8,33
Zenit,6786,4,7,10,3,22,14,8,31
Krasnodar,6786,5,9,4,7,29,27,2,31
Terek Grozny,6786,6,8,6,6,23,24,-1,30
FK Rubin,6786,7,7,5,8,29,19,10,26
Din Moscow,6786,8,5,7,8,19,27,-8,22
Rostov,6786,9,5,6,9,11,17,-6,21
Amkar,6786,10,4,5,11,10,24,-14,17
Anzhi,6786,11,2,5,13,15,41,-26,11
Loko Moscow,6787,1,12,5,3,33,15,18,41
CSKA Moscow,6787,2,11,4,5,28,19,9,37
Spart Moscow,6787,3,10,6,4,35,25,10,36
Krasnodar,6787,4,10,4,6,33,27,6,34
Zenit,6787,5,7,9,4,23,17,6,30
Terek Grozny,6787,6,8,5,7,24,24,0,29
FK Rubin,6787,7,6,5,9,24,20,4,23
Din Moscow,6787,8,5,7,8,17,22,-5,22
Rostov,6787,9,4,6,10,10,18,-8,18
Amkar,6787,10,4,4,12,9,26,-17,16
Anzhi,6787,11,3,5,12,17,40,-23,14
Loko Moscow,6788,1,11,6,3,29,12,17,39
Spart Moscow,6788,2,10,6,4,37,27,10,36
CSKA Moscow,6788,3,10,5,5,29,21,8,35
Krasnodar,6788,4,10,4,6,30,24,6,34
Zenit,6788,5,7,10,3,22,14,8,31
Terek Grozny,6788,6,7,5,8,21,26,-5,26
Din Moscow,6788,7,5,7,8,19,24,-5,22
FK Rubin,6788,8,5,6,9,23,21,2,21
Amkar,6788,9,5,5,10,11,23,-12,20
Rostov,6788,10,4,6,10,11,19,-8,18
Anzhi,6788,11,3,6,11,20,41,-21,15
Loko Moscow,6789,1,12,6,2,30,11,19,42
CSKA Moscow,6789,2,11,3,6,31,19,12,36
Spart Moscow,6789,3,9,6,5,36,27,9,33
Zenit,6789,4,8,8,4,23,15,8,32
Terek Grozny,6789,5,8,6,6,24,23,1,30
Krasnodar,6789,6,8,5,7,27,25,2,29
Din Moscow,6789,7,7,6,7,23,22,1,27
FK Rubin,6789,8,6,5,9,23,21,2,23
Rostov,6789,9,4,6,10,10,20,-10,18
Amkar,6789,10,4,6,10,10,23,-13,18
Anzhi,6789,11,2,5,13,14,45,-31,11
Loko Moscow,6790,1,11,6,3,29,14,15,39
Spart Moscow,6790,2,10,6,4,39,26,13,36
CSKA Moscow,6790,3,11,3,6,29,21,8,36
Zenit,6790,4,9,8,3,27,14,13,35
Krasnodar,6790,5,9,5,6,28,24,4,32
Terek Grozny,6790,6,9,5,6,24,23,1,32
Din Moscow,6790,7,5,8,7,19,23,-4,23
FK Rubin,6790,8,5,6,9,22,19,3,21
Rostov,6790,9,4,6,10,10,19,-9,18
Amkar,6790,10,4,4,12,10,27,-17,16
Anzhi,6790,11,2,5,13,15,42,-27,11
Loko Moscow,6791,1,11,5,4,30,14,16,38
Zenit,6791,2,9,8,3,24,14,10,35
CSKA Moscow,6791,3,10,3,7,25,20,5,33
Krasnodar,6791,4,9,5,6,30,26,4,32
Spart Moscow,6791,5,8,7,5,36,32,4,31
Terek Grozny,6791,6,7,6,7,21,24,-3,27
Din Moscow,6791,7,5,8,7,20,24,-4,23
FK Rubin,6791,8,5,7,8,25,21,4,22
Amkar,6791,9,5,5,10,14,23,-9,20
Rostov,6791,10,4,7,9,12,19,-7,19
Anzhi,6791,11,4,5,11,17,37,-20,17
Loko Moscow,6792,1,12,5,3,31,14,17,41
CSKA Moscow,6792,2,11,4,5,27,18,9,37
Spart Moscow,6792,3,9,7,4,37,28,9,34
Krasnodar,6792,4,9,5,6,30,25,5,32
Zenit,6792,5,7,9,4,23,16,7,30
Terek Grozny,6792,6,7,7,6,22,24,-2,28
Din Moscow,6792,7,6,6,8,19,23,-4,24
FK Rubin,6792,8,5,6,9,22,19,3,21
Rostov,6792,9,4,7,9,11,18,-7,19
Amkar,6792,10,4,6,10,11,24,-13,18
Anzhi,6792,11,2,6,12,15,39,-24,12
Loko Moscow,6793,1,12,6,2,32,12,20,42
Spart Moscow,6793,2,11,5,4,38,26,12,38
CSKA Moscow,6793,3,11,3,6,28,19,9,36
Zenit,6793,4,8,9,3,24,14,10,33
Krasnodar,6793,5,8,5,7,29,28,1,29
Terek Grozny,6793,6,7,5,8,22,27,-5,26
FK Rubin,6793,7,5,7,8,24,20,4,22
Din Moscow,6793,8,5,7,8,19,24,-5,22
Amkar,6793,9,5,4,11,12,25,-13,19
Rostov,6793,10,4,6,10,10,18,-8,18
Anzhi,6793,11,3,5,12,16,41,-25,14
Loko Moscow,6794,1,13,5,2,32,11,21,44
CSKA Moscow,6794,2,11,4,5,30,18,12,37
Spart Moscow,6794,3,9,6,5,39,28,11,33
Zenit,6794,4,7,9,4,22,16,6,30
Krasnodar,6794,5,8,4,8,27,27,0,28
FK Rubin,6794,6,7,5,8,24,17,7,26
Terek Grozny,6794,7,7,5,8,23,27,-4,26
Amkar,6794,8,6,4,10,13,24,-11,22
Din Moscow,6794,9,5,6,9,17,26,-9,21
Rostov,6794,10,4,7,9,11,18,-7,19
Anzhi,6794,11,3,5,12,17,43,-26,14
Loko Moscow,6795,1,12,6,2,31,11,20,42
CSKA Moscow,6795,2,11,3,6,27,19,8,36
Zenit,6795,3,8,9,3,23,13,10,33
Spart Moscow,6795,4,8,7,5,36,30,6,31
Krasnodar,6795,5,9,4,7,29,27,2,31
Terek Grozny,6795,6,8,6,6,26,23,3,30
Din Moscow,6795,7,5,8,7,19,23,-4,23
FK Rubin,6795,8,5,6,9,22,19,3,21
Amkar,6795,9,5,5,10,12,23,-11,20
Rostov,6795,10,4,7,9,11,18,-7,19
Anzhi,6795,11,2,5,13,14,44,-30,11
Loko Moscow,6796,1,12,6,2,32,12,20,42
CSKA Moscow,6796,2,12,3,5,30,18,12,39
Spart Moscow,6796,3,10,5,5,38,27,11,35
Krasnodar,6796,4,9,4,7,32,28,4,31
Zenit,6796,5,7,9,4,22,15,7,30
Terek Grozny,6796,6,7,7,6,20,22,-2,28
Din Moscow,6796,7,6,6,8,21,25,-4,24
Rostov,6796,8,5,6,9,11,17,-6,21
FK Rubin,6796,9,5,5,10,24,24,0,20
Amkar,6796,10,4,5,11,9,25,-16,17
Anzhi,6796,11,2,6,12,14,40,-26,12
Loko Moscow,6797,1,11,6,3,30,13,17,39
CSKA Moscow,6797,2,11,3,6,27,18,9,36
Spart Moscow,6797,3,9,7,4,35,26,9,34
Krasnodar,6797,4,10,4,6,31,25,6,34
Zenit,6797,5,8,9,3,22,13,9,33
Terek Grozny,6797,6,9,5,6,23,22,1,32
Din Moscow,6797,7,6,7,7,18,21,-3,25
FK Rubin,6797,8,5,5,10,21,20,1,20
Rostov,6797,9,4,6,10,11,19,-8,18
Amkar,6797,10,4,5,11,9,23,-14,17
Anzhi,6797,11,2,5,13,14,41,-27,11
Loko Moscow,6798,1,13,5,2,33,13,20,44
Spart Moscow,6798,2,10,6,4,39,28,11,36
CSKA Moscow,6798,3,10,3,7,25,20,5,33
Zenit,6798,4,8,8,4,23,15,8,32
Terek Grozny,6798,5,8,5,7,21,23,-2,29
Krasnodar,6798,6,8,4,8,28,27,1,28
Din Moscow,6798,7,6,6,8,19,23,-4,24
FK Rubin,6798,8,6,5,9,22,19,3,23
Rostov,6798,9,4,7,9,11,18,-7,19
Amkar,6798,10,5,4,11,12,25,-13,19
Anzhi,6798,11,3,5,12,16,38,-22,14
CSKA Moscow,6799,1,12,3,5,28,18,10,39
Loko Moscow,6799,2,11,5,4,30,14,16,38
Krasnodar,6799,3,10,4,6,32,25,7,34
Zenit,6799,4,8,8,4,22,14,8,32
Spart Moscow,6799,5,8,7,5,34,28,6,31
Terek Grozny,6799,6,7,6,7,21,25,-4,27
Din Moscow,6799,7,6,7,7,20,22,-2,25
FK Rubin,6799,8,5,6,9,22,21,1,21
Amkar,6799,9,5,5,10,11,22,-11,20
Rostov,6799,10,4,7,9,11,18,-7,19
Anzhi,6799,11,2,6,12,16,40,-24,12
Loko Moscow,6800,1,12,5,3,31,15,16,41
CSKA Moscow,6800,2,11,3,6,29,20,9,36
Spart Moscow,6800,3,9,6,5,36,27,9,33
Zenit,6800,4,8,8,4,24,14,10,32
Krasnodar,6800,5,9,5,6,32,26,6,32
Terek Grozny,6800,6,8,5,7,21,23,-2,29
Din Moscow,6800,7,6,6,8,18,23,-5,24
FK Rubin,6800,8,5,6,9,22,19,3,21
Rostov,6800,9,5,6,9,11,17,-6,21
Amkar,6800,10,5,5,10,11,23,-12,20
Anzhi,6800,11,2,5,13,14,42,-28,11
Loko Moscow,6801,1,11,6,3,31,16,15,39
CSKA Moscow,6801,2,12,3,5,28,17,11,39
Spart Moscow,6801,3,9,6,5,36,27,9,33
Zenit,6801,4,8,8,4,25,16,9,32
Krasnodar,6801,5,8,5,7,30,29,1,29
Terek Grozny,6801,6,8,5,7,22,24,-2,29
FK Rubin,6801,7,6,6,8,26,20,6,24
Din Moscow,6801,8,5,8,7,19,23,-4,23
Amkar,6801,9,5,4,11,11,24,-13,19
Rostov,6801,10,4,6,10,10,19,-9,18
Anzhi,6801,11,3,5,12,15,38,-23,14
Loko Moscow,6802,1,11,6,3,29,14,15,39
Spart Moscow,6802,2,11,5,4,40,27,13,38
CSKA Moscow,6802,3,11,4,5,30,18,12,37
Zenit,6802,4,8,9,3,25,14,11,33
Krasnodar,6802,5,9,5,6,28,24,4,32
Terek Grozny,6802,6,8,5,7,24,25,-1,29
Din Moscow,6802,7,6,6,8,19,24,-5,24
FK Rubin,6802,8,5,5,10,21,20,1,20
Rostov,6802,9,4,6,10,11,19,-8,18
Amkar,6802,10,4,4,12,10,26,-16,16
Anzhi,6802,11,3,5,12,17,43,-26,14
Loko Moscow,6803,1,12,5,3,31,12,19,41
CSKA Moscow,6803,2,10,5,5,27,19,8,35
Krasnodar,6803,3,9,5,6,30,26,4,32
Zenit,6803,4,7,9,4,22,16,6,30
Spart Moscow,6803,5,8,6,6,35,30,5,30
Terek Grozny,6803,6,8,5,7,21,23,-2,29
Din Moscow,6803,7,7,6,7,22,22,0,27
Amkar,6803,8,6,4,10,12,22,-10,22
FK Rubin,6803,9,5,6,9,23,22,1,21
Rostov,6803,10,4,7,9,11,18,-7,19
Anzhi,6803,11,2,6,12,15,39,-24,12
Loko Moscow,6804,1,12,5,3,31,13,18,41
CSKA Moscow,6804,2,11,4,5,28,19,9,37
Krasnodar,6804,3,10,4,6,30,25,5,34
Spart Moscow,6804,4,9,6,5,35,27,8,33
Zenit,6804,5,7,8,5,22,16,6,29
Terek Grozny,6804,6,7,7,6,22,24,-2,28
Din Moscow,6804,7,6,6,8,21,24,-3,24
FK Rubin,6804,8,5,5,10,23,22,1,20
Amkar,6804,9,5,5,10,11,23,-12,20
Rostov,6804,10,4,7,9,10,17,-7,19
Anzhi,6804,11,2,7,11,17,40,-23,13
Loko Moscow,6805,1,13,5,2,34,13,21,44
CSKA Moscow,6805,2,11,4,5,28,19,9,37
Spart Moscow,6805,3,9,6,5,37,27,10,33
Zenit,6805,4,7,9,4,22,15,7,30
Krasnodar,6805,5,8,5,7,28,27,1,29
Terek Grozny,6805,6,7,7,6,23,25,-2,28
Din Moscow,6805,7,5,8,7,17,21,-4,23
FK Rubin,6805,8,5,7,8,21,17,4,22
Amkar,6805,9,5,5,10,11,23,-12,20
Rostov,6805,10,4,6,10,11,21,-10,18
Anzhi,6805,11,2,6,12,18,42,-24,12
Loko Moscow,6806,1,11,5,4,29,13,16,38
Spart Moscow,6806,2,10,6,4,38,27,11,36
CSKA Moscow,6806,3,11,3,6,29,20,9,36
Zenit,6806,4,9,8,3,25,13,12,35
Krasnodar,6806,5,9,4,7,30,27,3,31
Terek Grozny,6806,6,8,6,6,22,22,0,30
FK Rubin,6806,7,6,6,8,25,20,5,24
Din Moscow,6806,8,5,7,8,19,24,-5,22
Rostov,6806,9,4,6,10,10,19,-9,18
Amkar,6806,10,4,6,10,10,23,-13,18
Anzhi,6806,11,2,5,13,14,43,-29,11
Loko Moscow,6807,1,11,7,2,30,12,18,40
Spart Moscow,6807,2,11,5,4,43,27,16,38
CSKA Moscow,6807,3,11,4,5,29,18,11,37
Zenit,6807,4,7,10,3,22,14,8,31
Krasnodar,6807,5,8,5,7,29,27,2,29
Terek Grozny,6807,6,8,5,7,23,24,-1,29
FK Rubin,6807,7,7,5,8,24,18,6,26
Din Moscow,6807,8,5,6,9,18,24,-6,21
Amkar,6807,9,5,4,11,11,25,-14,19
Rostov,6807,10,4,6,10,10,22,-12,18
Anzhi,6807,11,2,5,13,15,43,-28,11
Loko Moscow,6808,1,11,6,3,29,14,15,39
Zenit,6808,2,9,8,3,26,13,13,35
Spart Moscow,6808,3,10,5,5,38,29,9,35
CSKA Moscow,6808,4,10,3,7,26,21,5,33
Krasnodar,6808,5,8,5,7,27,25,2,29
Terek Grozny,6808,6,7,5,8,21,25,-4,26
Din Moscow,6808,7,6,6,8,20,23,-3,24
FK Rubin,6808,8,6,5,9,22,19,3,23
Rostov,6808,9,5,6,9,13,19,-6,21
Amkar,6808,10,5,4,11,10,23,-13,19
Anzhi,6808,11,4,5,11,18,39,-21,17
Loko Moscow,6809,1,11,6,3,30,13,17,39
CSKA Moscow,6809,2,11,4,5,31,18,13,37
Krasnodar,6809,3,10,4,6,30,25,5,34
Spart Moscow,6809,4,9,6,5,38,30,8,33
Zenit,6809,5,7,10,3,23,15,8,31
Terek Grozny,6809,6,8,6,6,23,24,-1,30
Din Moscow,6809,7,6,7,7,20,22,-2,25
Rostov,6809,8,5,6,9,13,19,-6,21
FK Rubin,6809,9,5,5,10,22,21,1,20
Amkar,6809,10,4,5,11,12,26,-14,17
Anzhi,6809,11,2,5,13,14,43,-29,11
Loko Moscow,6810,1,12,5,3,31,12,19,41
CSKA Moscow,6810,2,10,5,5,26,18,8,35
Spart Moscow,6810,3,9,6,5,39,30,9,33
Zenit,6810,4,8,9,3,22,13,9,33
Krasnodar,6810,5,8,5,7,27,26,1,29
Terek Grozny,6810,6,8,5,7,22,23,-1,29
FK Rubin,6810,7,6,6,8,24,18,6,24
Rostov,6810,8,5,6,9,12,18,-6,21
Din Moscow,6810,9,5,6,9,19,27,-8,21
Amkar,6810,10,5,5,10,12,24,-12,20
Anzhi,6810,11,2,6,12,15,40,-25,12
Loko Moscow,6811,1,12,5,3,32,14,18,41
CSKA Moscow,6811,2,12,3,5,29,19,10,39
Spart Moscow,6811,3,11,5,4,37,26,11,38
Zenit,6811,4,8,8,4,23,14,9,32
Krasnodar,6811,5,8,5,7,29,28,1,29
Terek Grozny,6811,6,7,6,7,22,27,-5,27
Din Moscow,6811,7,6,6,8,19,22,-3,24
FK Rubin,6811,8,5,6,9,22,20,2,21
Rostov,6811,9,4,6,10,10,18,-8,18
Amkar,6811,10,4,5,11,12,26,-14,17
Anzhi,6811,11,3,5,12,19,40,-21,14
Loko Moscow,6812,1,12,5,3,33,13,20,41
CSKA Moscow,6812,2,11,3,6,28,20,8,36
Spart Moscow,6812,3,10,5,5,38,29,9,35
Zenit,6812,4,8,8,4,24,17,7,32
Terek Grozny,6812,5,8,6,6,21,22,-1,30
Krasnodar,6812,6,8,5,7,28,28,0,29
FK Rubin,6812,7,5,7,8,24,20,4,22
Din Moscow,6812,8,5,7,8,21,26,-5,22
Amkar,6812,9,5,4,11,10,23,-13,19
Rostov,6812,10,4,6,10,11,19,-8,18
Anzhi,6812,11,3,6,11,16,37,-21,15
Loko Moscow,6813,1,11,5,4,29,17,12,38
CSKA Moscow,6813,2,11,3,6,30,18,12,36
Spart Moscow,6813,3,10,5,5,37,26,11,35
Zenit,6813,4,9,8,3,23,13,10,35
Krasnodar,6813,5,9,5,6,33,25,8,32
Terek Grozny,6813,6,8,5,7,23,24,-1,29
Din Moscow,6813,7,6,6,8,20,24,-4,24
FK Rubin,6813,8,5,6,9,23,21,2,21
Amkar,6813,9,5,4,11,10,24,-14,19
Rostov,6813,10,4,6,10,10,19,-9,18
Anzhi,6813,11,3,5,12,16,43,-27,14
Loko Moscow,6814,1,12,5,3,30,12,18,41
Spart Moscow,6814,2,9,7,4,40,31,9,34
CSKA Moscow,6814,3,10,4,6,26,19,7,34
Krasnodar,6814,4,9,5,6,28,24,4,32
Zenit,6814,5,7,9,4,22,15,7,30
Terek Grozny,6814,6,8,5,7,21,23,-2,29
FK Rubin,6814,7,6,6,8,24,18,6,24
Din Moscow,6814,8,5,7,8,20,26,-6,22
Amkar,6814,9,5,5,10,11,23,-12,20
Rostov,6814,10,4,6,10,13,21,-8,18
Anzhi,6814,11,3,5,12,15,38,-23,14
Loko Moscow,6815,1,11,7,2,30,12,18,40
Spart Moscow,6815,2,10,5,5,38,29,9,35
CSKA Moscow,6815,3,10,4,6,26,19,7,34
Zenit,6815,4,7,10,3,22,14,8,31
Krasnodar,6815,5,8,5,7,28,26,2,29
FK Rubin,6815,6,7,5,8,25,19,6,26
Terek Grozny,6815,7,7,5,8,20,26,-6,26
Din Moscow,6815,8,6,6,8,20,24,-4,24
Amkar,6815,9,5,4,11,12,24,-12,19
Rostov,6815,10,4,6,10,11,19,-8,18
Anzhi,6815,11,4,5,11,18,38,-20,17
Loko Moscow,6816,1,11,6,3,34,17,17,39
CSKA Moscow,6816,2,10,4,6,27,21,6,34
Zenit,6816,3,8,9,3,26,17,9,33
Krasnodar,6816,4,9,5,6,32,27,5,32
Spart Moscow,6816,5,8,7,5,34,27,7,31
Terek Grozny,6816,6,7,7,6,21,23,-2,28
Din Moscow,6816,7,7,6,7,19,21,-2,27
FK Rubin,6816,8,5,5,10,22,21,1,20
Rostov,6816,9,4,7,9,11,18,-7,19
Amkar,6816,10,4,6,10,9,22,-13,18
Anzhi,6816,11,3,6,11,18,39,-21,15
Loko Moscow,6817,1,12,6,2,32,12,20,42
CSKA Moscow,6817,2,12,3,5,28,17,11,39
Spart Moscow,6817,3,11,5,4,44,25,19,38
Zenit,6817,4,7,9,4,22,16,6,30
Terek Grozny,6817,5,8,6,6,22,22,0,30
Krasnodar,6817,6,8,5,7,29,28,1,29
FK Rubin,6817,7,5,7,8,23,19,4,22
Din Moscow,6817,8,5,7,8,17,25,-8,22
Rostov,6817,9,4,6,10,10,21,-11,18
Amkar,6817,10,4,5,11,9,25,-16,17
Anzhi,6817,11,2,5,13,14,40,-26,11
Loko Moscow,6818,1,11,7,2,31,13,18,40
CSKA Moscow,6818,2,11,4,5,31,18,13,37
Spart Moscow,6818,3,10,6,4,39,27,12,36
Krasnodar,6818,4,9,5,6,31,27,4,32
Zenit,6818,5,7,10,3,22,14,8,31
Terek Grozny,6818,6,8,5,7,22,24,-2,29
Din Moscow,6818,7,5,7,8,19,26,-7,22
FK Rubin,6818,8,5,6,9,24,21,3,21
Amkar,6818,9,5,5,10,11,23,-12,20
Rostov,6818,10,4,6,10,11,19,-8,18
Anzhi,6818,11,2,5,13,15,44,-29,11
Loko Moscow,6819,1,12,5,3,30,12,18,41
CSKA Moscow,6819,2,11,4,5,29,18,11,37
Zenit,6819,3,8,9,3,23,14,9,33
Spart Moscow,6819,4,9,5,6,39,33,6,32
Krasnodar,6819,5,8,5,7,27,25,2,29
Terek Grozny,6819,6,7,6,7,20,23,-3,27
FK Rubin,6819,7,5,7,8,22,18,4,22
Din Moscow,6819,8,5,7,8,18,26,-8,22
Rostov,6819,9,5,6,9,12,17,-5,21
Amkar,6819,10,5,5,10,15,24,-9,20
Anzhi,6819,11,3,5,12,15,40,-25,14
Loko Moscow,6820,1,11,6,3,30,13,17,39
Spart Moscow,6820,2,11,5,4,39,26,13,38
CSKA Moscow,6820,3,11,3,6,27,20,7,36
Zenit,6820,4,8,8,4,23,15,8,32
Krasnodar,6820,5,8,6,6,29,26,3,30
Terek Grozny,6820,6,8,6,6,22,23,-1,30
FK Rubin,6820,7,5,7,8,23,19,4,22
Din Moscow,6820,8,5,7,8,19,25,-6,22
Rostov,6820,9,4,6,10,10,19,-9,18
Amkar,6820,10,4,5,11,9,23,-14,17
Anzhi,6820,11,3,5,12,17,39,-22,14
Loko Moscow,6821,1,13,5,2,33,12,21,44
Spart Moscow,6821,2,10,6,4,40,27,13,36
CSKA Moscow,6821,3,10,3,7,26,20,6,33
Zenit,6821,4,8,8,4,24,16,8,32
Krasnodar,6821,5,8,5,7,28,27,1,29
Terek Grozny,6821,6,8,5,7,23,23,0,29
Din Moscow,6821,7,6,6,8,19,23,-4,24
FK Rubin,6821,8,5,6,9,22,20,2,21
Rostov,6821,9,4,7,9,11,18,-7,19
Amkar,6821,10,5,4,11,11,26,-15,19
Anzhi,6821,11,3,5,12,15,40,-25,14
Loko Moscow,6822,1,12,6,2,31,11,20,42
CSKA Moscow,6822,2,11,3,6,32,21,11,36
Zenit,6822,3,8,8,4,24,16,8,32
Krasnodar,6822,4,9,5,6,29,24,5,32
Terek Grozny,6822,5,9,5,6,24,24,0,32
Spart Moscow,6822,6,8,5,7,33,30,3,29
Din Moscow,6822,7,7,6,7,22,21,1,27
Rostov,6822,8,5,6,9,11,17,-6,21
FK Rubin,6822,9,5,5,10,21,23,-2,20
Amkar,6822,10,5,4,11,12,23,-11,19
Anzhi,6822,11,2,5,13,17,46,-29,11
Loko Moscow,6823,1,13,5,2,34,12,22,44
Spart Moscow,6823,2,10,6,4,37,26,11,36
CSKA Moscow,6823,3,10,4,6,28,21,7,34
Krasnodar,6823,4,9,4,7,30,27,3,31
Zenit,6823,5,7,9,4,24,19,5,30
Terek Grozny,6823,6,8,5,7,21,24,-3,29
Din Moscow,6823,7,6,6,8,19,23,-4,24
FK Rubin,6823,8,5,5,10,23,21,2,20
Rostov,6823,9,4,7,9,10,17,-7,19
Amkar,6823,10,5,4,11,12,25,-13,19
Anzhi,6823,11,3,5,12,15,38,-23,14
Loko Moscow,6824,1,12,5,3,31,13,18,41
CSKA Moscow,6824,2,11,3,6,26,19,7,36
Zenit,6824,3,8,8,4,23,14,9,32
Spart Moscow,6824,4,9,5,6,38,31,7,32
Krasnodar,6824,5,9,4,7,29,27,2,31
FK Rubin,6824,6,7,5,8,24,17,7,26
Terek Grozny,6824,7,7,5,8,20,25,-5,26
Amkar,6824,8,6,4,10,14,24,-10,22
Rostov,6824,9,5,6,9,12,17,-5,21
Din Moscow,6824,10,5,6,9,17,25,-8,21
Anzhi,6824,11,3,5,12,16,38,-22,14
Loko Moscow,6825,1,13,5,2,36,12,24,44
CSKA Moscow,6825,2,10,4,6,25,19,6,34
Zenit,6825,3,8,8,4,23,16,7,32
Spart Moscow,6825,4,8,7,5,37,30,7,31
Krasnodar,6825,5,8,5,7,28,28,0,29
Terek Grozny,6825,6,7,5,8,20,25,-5,26
Din Moscow,6825,7,6,7,7,19,22,-3,25
Amkar,6825,8,6,4,10,13,24,-11,22
FK Rubin,6825,9,5,6,9,21,18,3,21
Rostov,6825,10,4,7,9,11,18,-7,19
Anzhi,6825,11,3,6,11,16,37,-21,15
Loko Moscow,6826,1,13,5,2,34,12,22,44
Spart Moscow,6826,2,11,5,4,36,25,11,38
CSKA Moscow,6826,3,10,4,6,26,19,7,34
Krasnodar,6826,4,9,4,7,30,27,3,31
Zenit,6826,5,7,9,4,21,15,6,30
Terek Grozny,6826,6,8,5,7,21,24,-3,29
FK Rubin,6826,7,6,5,9,24,19,5,23
Din Moscow,6826,8,5,6,9,17,25,-8,21
Rostov,6826,9,4,6,10,10,18,-8,18
Anzhi,6826,10,4,5,11,18,38,-20,17
Amkar,6826,11,4,4,12,9,24,-15,16
Loko Moscow,6827,1,12,5,3,31,14,17,41
CSKA Moscow,6827,2,12,3,5,27,17,10,39
Spart Moscow,6827,3,11,5,4,39,26,13,38
Krasnodar,6827,4,9,5,6,30,25,5,32
Terek Grozny,6827,5,9,5,6,23,22,1,32
Zenit,6827,6,7,8,5,21,15,6,29
Din Moscow,6827,7,6,6,8,19,23,-4,24
FK Rubin,6827,8,5,6,9,21,19,2,21
Rostov,6827,9,4,6,10,10,19,-9,18
Amkar,6827,10,4,4,12,10,26,-16,16
Anzhi,6827,11,2,5,13,14,39,-25,11
Loko Moscow,6828,1,13,5,2,34,12,22,44
CSKA Moscow,6828,2,12,3,5,30,18,12,39
Spart Moscow,6828,3,11,5,4,43,30,13,38
Terek Grozny,6828,4,8,6,6,23,24,-1,30
Zenit,6828,5,7,8,5,21,17,4,29
Krasnodar,6828,6,8,4,8,29,32,-3,28
FK Rubin,6828,7,7,5,8,27,18,9,26
Din Moscow,6828,8,5,6,9,19,25,-6,21
Rostov,6828,9,4,6,10,13,21,-8,18
Amkar,6828,10,4,4,12,10,27,-17,16
Anzhi,6828,11,2,6,12,16,41,-25,12
Loko Moscow,6829,1,12,6,2,30,11,19,42
Spart Moscow,6829,2,10,6,4,37,27,10,36
CSKA Moscow,6829,3,10,4,6,27,20,7,34
Zenit,6829,4,8,9,3,23,14,9,33
Krasnodar,6829,5,9,4,7,30,26,4,31
Terek Grozny,6829,6,7,6,7,21,24,-3,27
Din Moscow,6829,7,5,7,8,19,24,-5,22
FK Rubin,6829,8,5,6,9,22,20,2,21
Rostov,6829,9,4,7,9,10,17,-7,19
Amkar,6829,10,5,4,11,10,23,-13,19
Anzhi,6829,11,2,7,11,16,39,-23,13
Loko Moscow,6830,1,11,6,3,30,13,17,39
CSKA Moscow,6830,2,11,4,5,29,20,9,37
Spart Moscow,6830,3,10,6,4,40,26,14,36
Krasnodar,6830,4,10,4,6,32,25,7,34
Terek Grozny,6830,5,9,5,6,25,23,2,32
Zenit,6830,6,7,9,4,24,17,7,30
Din Moscow,6830,7,6,6,8,18,24,-6,24
FK Rubin,6830,8,5,5,10,22,22,0,20
Rostov,6830,9,4,6,10,11,21,-10,18
Amkar,6830,10,4,5,11,9,24,-15,17
Anzhi,6830,11,2,6,12,16,41,-25,12
Loko Moscow,6831,1,12,6,2,33,13,20,42
Spart Moscow,6831,2,10,6,4,39,25,14,36
CSKA Moscow,6831,3,11,3,6,31,19,12,36
Zenit,6831,4,8,8,4,23,16,7,32
Terek Grozny,6831,5,8,6,6,24,22,2,30
Krasnodar,6831,6,8,5,7,29,28,1,29
FK Rubin,6831,7,6,6,8,25,19,6,24
Din Moscow,6831,8,5,7,8,18,26,-8,22
Rostov,6831,9,4,7,9,10,17,-7,19
Amkar,6831,10,4,5,11,9,24,-15,17
Anzhi,6831,11,2,5,13,15,47,-32,11
Loko Moscow,6832,1,12,6,2,33,12,21,42
CSKA Moscow,6832,2,11,3,6,28,18,10,36
Zenit,6832,3,8,9,3,23,14,9,33
Spart Moscow,6832,4,9,5,6,37,29,8,32
Krasnodar,6832,5,9,4,7,29,27,2,31
Terek Grozny,6832,6,8,5,7,22,24,-2,29
Din Moscow,6832,7,6,6,8,18,22,-4,24
FK Rubin,6832,8,6,5,9,22,19,3,23
Rostov,6832,9,5,6,9,12,18,-6,21
Amkar,6832,10,4,4,12,11,27,-16,16
Anzhi,6832,11,3,5,12,15,40,-25,14
Loko Moscow,6833,1,12,5,3,33,15,18,41
CSKA Moscow,6833,2,12,3,5,29,18,11,39
Spart Moscow,6833,3,9,7,4,38,28,10,34
Krasnodar,6833,4,10,4,6,35,27,8,34
Terek Grozny,6833,5,9,5,6,24,23,1,32
Zenit,6833,6,7,8,5,21,17,4,29
FK Rubin,6833,7,6,5,9,24,21,3,23
Din Moscow,6833,8,5,7,8,19,24,-5,22
Rostov,6833,9,4,6,10,11,20,-9,18
Amkar,6833,10,4,5,11,9,23,-14,17
Anzhi,6833,11,2,5,13,16,43,-27,11
Loko Moscow,6834,1,12,6,2,30,11,19,42
CSKA Moscow,6834,2,10,5,5,29,21,8,35
Spart Moscow,6834,3,9,7,4,37,28,9,34
Zenit,6834,4,7,10,3,23,15,8,31
Krasnodar,6834,5,9,4,7,28,25,3,31
Terek Grozny,6834,6,8,5,7,24,25,-1,29
Din Moscow,6834,7,5,7,8,20,25,-5,22
FK Rubin,6834,8,5,6,9,23,20,3,21
Amkar,6834,9,5,5,10,12,24,-12,20
Rostov,6834,10,4,7,9,11,18,-7,19
Anzhi,6834,11,2,6,12,17,42,-25,12
Loko Moscow,6835,1,11,6,3,32,15,17,39
CSKA Moscow,6835,2,11,3,6,27,19,8,36
Spart Moscow,6835,3,9,6,5,35,27,8,33
Zenit,6835,4,8,8,4,23,16,7,32
Krasnodar,6835,5,9,5,6,31,27,4,32
Terek Grozny,6835,6,8,6,6,22,23,-1,30
Din Moscow,6835,7,6,6,8,18,22,-4,24
Rostov,6835,8,5,6,9,11,17,-6,21
FK Rubin,6835,9,5,5,10,22,20,2,20
Amkar,6835,10,4,6,10,11,24,-13,18
Anzhi,6835,11,3,5,12,16,38,-22,14
Loko Moscow,6836,1,11,6,3,29,12,17,39
CSKA Moscow,6836,2,10,4,6,27,20,7,34
Krasnodar,6836,3,10,4,6,29,24,5,34
Spart Moscow,6836,4,9,6,5,38,32,6,33
Zenit,6836,5,7,10,3,22,14,8,31
Terek Grozny,6836,6,7,6,7,21,24,-3,27
Din Moscow,6836,7,5,8,7,18,22,-4,23
FK Rubin,6836,8,5,6,9,21,18,3,21
Amkar,6836,9,5,5,10,14,23,-9,20
Rostov,6836,10,4,6,10,11,20,-9,18
Anzhi,6836,11,4,5,11,18,39,-21,17
Loko Moscow,6837,1,13,5,2,36,12,24,44
Spart Moscow,6837,2,10,6,4,39,28,11,36
CSKA Moscow,6837,3,11,3,6,27,19,8,36
Krasnodar,6837,4,9,4,7,28,28,0,31
Terek Grozny,6837,5,8,6,6,22,23,-1,30
Zenit,6837,6,7,8,5,23,18,5,29
Din Moscow,6837,7,5,7,8,20,25,-5,22
FK Rubin,6837,8,5,6,9,22,19,3,21
Rostov,6837,9,4,7,9,10,17,-7,19
Amkar,6837,10,4,5,11,10,25,-15,17
Anzhi,6837,11,3,5,12,16,39,-23,14
Loko Moscow,6838,1,11,6,3,31,14,17,39
CSKA Moscow,6838,2,12,3,5,29,19,10,39
Spart Moscow,6838,3,10,5,5,36,27,9,35
Zenit,6838,4,8,8,4,25,17,8,32
Krasnodar,6838,5,9,5,6,29,25,4,32
Terek Grozny,6838,6,8,5,7,21,25,-4,29
Din Moscow,6838,7,6,6,8,18,22,-4,24
Rostov,6838,8,5,6,9,12,18,-6,21
FK Rubin,6838,9,5,5,10,21,19,2,20
Amkar,6838,10,4,4,12,9,24,-15,16
Anzhi,6838,11,3,5,12,17,38,-21,14
Loko Moscow,6839,1,11,5,4,30,14,16,38
CSKA Moscow,6839,2,11,4,5,27,17,10,37
Zenit,6839,3,8,9,3,22,13,9,33
Spart Moscow,6839,4,9,6,5,35,29,6,33
Krasnodar,6839,5,9,4,7,30,27,3,31
Terek Grozny,6839,6,8,5,7,23,25,-2,29
Din Moscow,6839,7,6,6,8,19,22,-3,24
FK Rubin,6839,8,6,5,9,23,20,3,23
Amkar,6839,9,6,4,10,13,22,-9,22
Rostov,6839,10,4,7,9,11,18,-7,19
Anzhi,6839,11,2,5,13,16,42,-26,11
Loko Moscow,6840,1,12,5,3,30,15,15,41
CSKA Moscow,6840,2,11,4,5,28,17,11,37
Spart Moscow,6840,3,9,6,5,36,30,6,33
Krasnodar,6840,4,9,5,6,33,26,7,32
Zenit,6840,5,7,9,4,21,14,7,30
Terek Grozny,6840,6,8,6,6,23,24,-1,30
FK Rubin,6840,7,6,6,8,25,19,6,24
Din Moscow,6840,8,6,6,8,21,24,-3,24
Rostov,6840,9,4,6,10,10,18,-8,18
Amkar,6840,10,4,6,10,10,23,-13,18
Anzhi,6840,11,2,5,13,16,43,-27,11
Loko Moscow,6841,1,11,6,3,32,15,17,39
CSKA Moscow,6841,2,10,4,6,25,18,7,34
Krasnodar,6841,3,10,4,6,31,26,5,34
Spart Moscow,6841,4,9,5,6,35,29,6,32
Zenit,6841,5,7,10,3,22,14,8,31
Terek Grozny,6841,6,8,6,6,23,24,-1,30
Din Moscow,6841,7,6,6,8,19,26,-7,24
FK Rubin,6841,8,6,5,9,26,18,8,23
Amkar,6841,9,5,4,11,11,23,-12,19
Rostov,6841,10,4,6,10,10,19,-9,18
Anzhi,6841,11,3,6,11,17,39,-22,15
Loko Moscow,6842,1,12,6,2,32,13,19,42
CSKA Moscow,6842,2,12,3,5,31,18,13,39
Spart Moscow,6842,3,11,5,4,42,28,14,38
Terek Grozny,6842,4,8,6,6,25,23,2,30
Zenit,6842,5,7,8,5,22,17,5,29
Krasnodar,6842,6,8,5,7,29,27,2,29
Din Moscow,6842,7,6,6,8,19,23,-4,24
FK Rubin,6842,8,6,5,9,22,18,4,23
Rostov,6842,9,4,6,10,10,20,-10,18
Amkar,6842,10,4,5,11,12,27,-15,17
Anzhi,6842,11,2,5,13,14,44,-30,11
Loko Moscow,6843,1,11,5,4,30,15,15,38
Spart Moscow,6843,2,11,5,4,40,28,12,38
CSKA Moscow,6843,3,11,4,5,30,19,11,37
Krasnodar,6843,4,10,4,6,32,25,7,34
Zenit,6843,5,8,9,3,25,15,10,33
Terek Grozny,6843,6,7,5,8,20,24,-4,26
FK Rubin,6843,7,6,5,9,24,20,4,23
Din Moscow,6843,8,5,6,9,17,26,-9,21
Amkar,6843,9,5,4,11,12,25,-13,19
Rostov,6843,10,4,6,10,11,19,-8,18
Anzhi,6843,11,3,5,12,15,40,-25,14
Loko Moscow,6844,1,12,6,2,32,12,20,42
CSKA Moscow,6844,2,12,3,5,27,17,10,39
Spart Moscow,6844,3,11,5,4,43,27,16,38
Terek Grozny,6844,4,8,6,6,22,23,-1,30
Zenit,6844,5,7,8,5,21,16,5,29
Krasnodar,6844,6,8,5,7,29,27,2,29
FK Rubin,6844,7,6,6,8,23,18,5,24
Din Moscow,6844,8,5,7,8,18,24,-6,22
Rostov,6844,9,4,6,10,10,21,-11,18
Amkar,6844,10,4,5,11,11,26,-15,17
Anzhi,6844,11,2,5,13,14,39,-25,11
Loko Moscow,6845,1,12,5,3,33,13,20,41
CSKA Moscow,6845,2,12,3,5,29,19,10,39
Spart Moscow,6845,3,8,7,5,37,30,7,31
Krasnodar,6845,4,9,4,7,28,25,3,31
Zenit,6845,5,7,8,5,24,20,4,29
Terek Grozny,6845,6,7,6,7,22,26,-4,27
Din Moscow,6845,7,6,7,7,20,23,-3,25
FK Rubin,6845,8,6,6,8,22,17,5,24
Amkar,6845,9,5,5,10,11,22,-11,20
Rostov,6845,10,4,7,9,12,19,-7,19
Anzhi,6845,11,2,6,12,16,40,-24,12
Loko Moscow,6846,1,12,6,2,32,13,19,42
CSKA Moscow,6846,2,11,3,6,28,18,10,36
Spart Moscow,6846,3,9,7,4,37,28,9,34
Zenit,6846,4,8,9,3,22,13,9,33
Krasnodar,6846,5,8,5,7,29,27,2,29
Terek Grozny,6846,6,8,5,7,23,25,-2,29
FK Rubin,6846,7,5,7,8,21,17,4,22
Din Moscow,6846,8,5,7,8,17,22,-5,22
Rostov,6846,9,4,7,9,12,19,-7,19
Amkar,6846,10,4,5,11,10,25,-15,17
Anzhi,6846,11,3,5,12,17,41,-24,14
Loko Moscow,6847,1,11,7,2,30,12,18,40
CSKA Moscow,6847,2,10,4,6,26,20,6,34
Zenit,6847,3,8,9,3,23,13,10,33
Spart Moscow,6847,4,9,5,6,36,30,6,32
Krasnodar,6847,5,8,6,6,28,25,3,30
Terek Grozny,6847,6,7,5,8,20,25,-5,26
FK Rubin,6847,7,6,6,8,24,18,6,24
Amkar,6847,8,6,4,10,14,24,-10,22
Rostov,6847,9,5,6,9,11,17,-6,21
Din Moscow,6847,10,5,6,9,18,25,-7,21
Anzhi,6847,11,3,6,11,17,38,-21,15
Loko Moscow,6848,1,12,5,3,31,12,19,41
CSKA Moscow,6848,2,10,4,6,26,19,7,34
Spart Moscow,6848,3,9,6,5,39,28,11,33
Krasnodar,6848,4,9,4,7,28,26,2,31
Zenit,6848,5,7,9,4,21,15,6,30
Terek Grozny,6848,6,8,5,7,24,28,-4,29
Din Moscow,6848,7,7,6,7,20,22,-2,27
FK Rubin,6848,8,6,5,9,23,18,5,23
Amkar,6848,9,5,5,10,14,23,-9,20
Rostov,6848,10,4,6,10,10,21,-11,18
Anzhi,6848,11,3,5,12,18,42,-24,14
Loko Moscow,6849,1,11,6,3,31,14,17,39
CSKA Moscow,6849,2,11,3,6,31,18,13,36
Zenit,6849,3,9,8,3,24,14,10,35
Spart Moscow,6849,4,8,7,5,35,28,7,31
Krasnodar,6849,5,8,6,6,30,27,3,30
Terek Grozny,6849,6,7,6,7,21,24,-3,27
Din Moscow,6849,7,6,7,7,21,21,0,25
FK Rubin,6849,8,5,6,9,23,23,0,21
Amkar,6849,9,5,5,10,11,23,-12,20
Rostov,6849,10,4,7,9,11,18,-7,19
Anzhi,6849,11,3,5,12,16,44,-28,14
Loko Moscow,6850,1,12,5,3,31,13,18,41
CSKA Moscow,6850,2,12,3,5,29,17,12,39
Spart Moscow,6850,3,10,5,5,37,28,9,35
Krasnodar,6850,4,10,4,6,30,25,5,34
Terek Grozny,6850,5,8,6,6,26,24,2,30
Zenit,6850,6,7,8,5,21,15,6,29
Din Moscow,6850,7,7,6,7,20,22,-2,27
FK Rubin,6850,8,5,5,10,22,20,2,20
Rostov,6850,9,4,6,10,11,19,-8,18
Amkar,6850,10,4,5,11,12,26,-14,17
Anzhi,6850,11,2,5,13,14,44,-30,11
Loko Moscow,6851,1,11,6,3,29,12,17,39
CSKA Moscow,6851,2,11,4,5,27,18,9,37
Spart Moscow,6851,3,10,6,4,39,27,12,36
Krasnodar,6851,4,9,5,6,29,25,4,32
Terek Grozny,6851,5,9,5,6,23,23,0,32
Zenit,6851,6,7,10,3,22,14,8,31
Din Moscow,6851,7,6,6,8,20,26,-6,24
FK Rubin,6851,8,5,6,9,24,21,3,21
Rostov,6851,9,4,6,10,11,19,-8,18
Amkar,6851,10,4,5,11,11,25,-14,17
Anzhi,6851,11,2,5,13,14,39,-25,11
Loko Moscow,6852,1,13,5,2,35,14,21,44
Spart Moscow,6852,2,10,5,5,39,28,11,35
CSKA Moscow,6852,3,10,4,6,26,20,6,34
Zenit,6852,4,8,8,4,23,15,8,32
Krasnodar,6852,5,9,4,7,31,28,3,31
Terek Grozny,6852,6,7,6,7,20,25,-5,27
FK Rubin,6852,7,6,5,9,23,19,4,23
Din Moscow,6852,8,5,6,9,20,27,-7,21
Amkar,6852,9,5,5,10,10,22,-12,20
Rostov,6852,10,4,6,10,10,19,-9,18
Anzhi,6852,11,3,6,11,18,38,-20,15
Loko Moscow,6853,1,13,5,2,36,14,22,44
CSKA Moscow,6853,2,12,3,5,29,19,10,39
Spart Moscow,6853,3,9,7,4,40,29,11,34
Krasnodar,6853,4,9,4,7,32,30,2,31
Terek Grozny,6853,5,8,6,6,24,23,1,30
Zenit,6853,6,7,8,5,22,17,5,29
Din Moscow,6853,7,5,7,8,19,26,-7,22
FK Rubin,6853,8,5,6,9,23,20,3,21
Rostov,6853,9,4,7,9,12,19,-7,19
Amkar,6853,10,4,5,11,10,26,-16,17
Anzhi,6853,11,2,6,12,16,40,-24,12
Loko Moscow,6854,1,12,6,2,32,13,19,42
CSKA Moscow,6854,2,10,5,5,27,19,8,35
Spart Moscow,6854,3,9,7,4,38,27,11,34
Zenit,6854,4,7,10,3,24,16,8,31
Krasnodar,6854,5,9,4,7,32,26,6,31
Terek Grozny,6854,6,7,6,7,22,25,-3,27
Din Moscow,6854,7,6,6,8,19,24,-5,24
FK Rubin,6854,8,5,5,10,22,24,-2,20
Amkar,6854,9,5,5,10,12,24,-12,20
Rostov,6854,10,4,7,9,11,18,-7,19
Anzhi,6854,11,2,7,11,16,39,-23,13
Loko Moscow,6855,1,12,5,3,31,15,16,41
CSKA Moscow,6855,2,12,3,5,29,17,12,39
Spart Moscow,6855,3,11,5,4,41,28,13,38
Krasnodar,6855,4,10,4,6,32,25,7,34
Zenit,6855,5,7,8,5,21,15,6,29
Terek Grozny,6855,6,8,5,7,23,24,-1,29
FK Rubin,6855,7,6,5,9,23,19,4,23
Din Moscow,6855,8,5,6,9,19,25,-6,21
Amkar,6855,9,5,4,11,13,26,-13,19
Rostov,6855,10,4,6,10,10,20,-10,18
Anzhi,6855,11,2,5,13,14,42,-28,11
Loko Moscow,6856,1,12,6,2,33,13,20,42
Spart Moscow,6856,2,10,5,5,38,26,12,35
CSKA Moscow,6856,3,10,4,6,26,19,7,34
Zenit,6856,4,7,10,3,23,15,8,31
Terek Grozny,6856,5,8,5,7,21,24,-3,29
Krasnodar,6856,6,8,4,8,28,28,0,28
Din Moscow,6856,7,6,6,8,18,24,-6,24
FK Rubin,6856,8,6,5,9,22,18,4,23
Amkar,6856,9,6,4,10,12,22,-10,22
Rostov,6856,10,4,6,10,10,19,-9,18
Anzhi,6856,11,3,5,12,15,38,-23,14
Loko Moscow,6857,1,12,5,3,31,15,16,41
CSKA Moscow,6857,2,11,4,5,29,19,10,37
Spart Moscow,6857,3,10,5,5,37,28,9,35
Krasnodar,6857,4,10,4,6,32,24,8,34
Zenit,6857,5,7,9,4,23,16,7,30
Terek Grozny,6857,6,7,6,7,20,23,-3,27
Din Moscow,6857,7,5,7,8,19,24,-5,22
FK Rubin,6857,8,5,6,9,22,20,2,21
Amkar,6857,9,5,5,10,11,22,-11,20
Rostov,6857,10,4,6,10,10,19,-9,18
Anzhi,6857,11,3,5,12,16,40,-24,14
Loko Moscow,6858,1,12,5,3,30,12,18,41
CSKA Moscow,6858,2,12,3,5,30,19,11,39
Spart Moscow,6858,3,9,6,5,36,28,8,33
Zenit,6858,4,8,8,4,22,15,7,32
Krasnodar,6858,5,8,5,7,27,25,2,29
Terek Grozny,6858,6,7,6,7,21,25,-4,27
Din Moscow,6858,7,6,6,8,19,23,-4,24
FK Rubin,6858,8,5,6,9,21,18,3,21
Amkar,6858,9,5,5,10,10,22,-12,20
Rostov,6858,10,4,7,9,11,18,-7,19
Anzhi,6858,11,3,5,12,19,41,-22,14
Loko Moscow,6859,1,12,6,2,33,13,20,42
CSKA Moscow,6859,2,11,4,5,29,19,10,37
Spart Moscow,6859,3,10,5,5,39,30,9,35
Krasnodar,6859,4,9,5,6,32,27,5,32
Zenit,6859,5,7,9,4,22,16,6,30
Terek Grozny,6859,6,8,5,7,21,23,-2,29
Din Moscow,6859,7,6,7,7,20,22,-2,25
FK Rubin,6859,8,5,6,9,22,20,2,21
Amkar,6859,9,5,4,11,11,24,-13,19
Rostov,6859,10,4,6,10,11,20,-9,18
Anzhi,6859,11,2,5,13,15,41,-26,11
Loko Moscow,6860,1,12,5,3,33,14,19,41
CSKA Moscow,6860,2,12,3,5,27,17,10,39
Spart Moscow,6860,3,9,7,4,42,29,13,34
Zenit,6860,4,8,8,4,24,15,9,32
Krasnodar,6860,5,9,4,7,29,28,1,31
Terek Grozny,6860,6,7,7,6,22,24,-2,28
Din Moscow,6860,7,6,6,8,19,27,-8,24
FK Rubin,6860,8,5,5,10,22,20,2,20
Rostov,6860,9,4,7,9,11,18,-7,19
Amkar,6860,10,4,6,10,12,25,-13,18
Anzhi,6860,11,2,6,12,15,39,-24,12
Loko Moscow,6861,1,12,6,2,31,12,19,42
CSKA Moscow,6861,2,11,4,5,28,17,11,37
Spart Moscow,6861,3,9,6,5,37,29,8,33
Zenit,6861,4,7,10,3,21,13,8,31
Terek Grozny,6861,5,8,5,7,21,24,-3,29
Krasnodar,6861,6,8,4,8,28,27,1,28
Din Moscow,6861,7,7,6,7,21,22,-1,27
FK Rubin,6861,8,6,5,9,22,19,3,23
Rostov,6861,9,4,7,9,12,19,-7,19
Amkar,6861,10,4,4,12,9,24,-15,16
Anzhi,6861,11,3,5,12,16,40,-24,14
Loko Moscow,6862,1,12,5,3,30,12,18,41
CSKA Moscow,6862,2,11,4,5,28,18,10,37
Spart Moscow,6862,3,10,6,4,37,27,10,36
Krasnodar,6862,4,9,5,6,29,25,4,32
Zenit,6862,5,7,9,4,21,14,7,30
Terek Grozny,6862,6,8,5,7,23,25,-2,29
Din Moscow,6862,7,6,6,8,18,22,-4,24
FK Rubin,6862,8,5,6,9,22,19,3,21
Rostov,6862,9,4,6,10,11,19,-8,18
Amkar,6862,10,4,5,11,10,26,-16,17
Anzhi,6862,11,3,5,12,18,40,-22,14
Loko Moscow,6863,1,11,6,3,29,13,16,39
CSKA Moscow,6863,2,11,3,6,30,19,11,36
Zenit,6863,3,8,9,3,23,14,9,33
Spart Moscow,6863,4,9,6,5,37,30,7,33
Krasnodar,6863,5,9,4,7,30,26,4,31
Terek Grozny,6863,6,7,7,6,22,24,-2,28
Din Moscow,6863,7,6,6,8,20,24,-4,24
FK Rubin,6863,8,6,5,9,24,20,4,23
Rostov,6863,9,5,6,9,12,17,-5,21
Amkar,6863,10,4,6,10,11,24,-13,18
Anzhi,6863,11,2,6,12,16,43,-27,12
Loko Moscow,6864,1,13,5,2,35,13,22,44
Spart Moscow,6864,2,10,5,5,37,28,9,35
CSKA Moscow,6864,3,10,3,7,25,20,5,33
Zenit,6864,4,8,8,4,23,16,7,32
Krasnodar,6864,5,9,4,7,31,27,4,31
Terek Grozny,6864,6,7,5,8,21,26,-5,26
Din Moscow,6864,7,6,6,8,20,24,-4,24
Amkar,6864,8,6,4,10,13,24,-11,22
FK Rubin,6864,9,5,5,10,22,22,0,20
Rostov,6864,10,4,6,10,10,18,-8,18
Anzhi,6864,11,4,5,11,18,37,-19,17
Loko Moscow,6865,1,13,5,2,35,11,24,44
CSKA Moscow,6865,2,11,3,6,27,19,8,36
Spart Moscow,6865,3,10,5,5,38,31,7,35
Zenit,6865,4,7,8,5,21,17,4,29
Krasnodar,6865,5,8,5,7,28,28,0,29
Terek Grozny,6865,6,7,5,8,21,27,-6,26
Din Moscow,6865,7,6,6,8,19,23,-4,24
Amkar,6865,8,6,4,10,15,23,-8,22
FK Rubin,6865,9,5,6,9,22,19,3,21
Rostov,6865,10,4,6,10,11,19,-8,18
Anzhi,6865,11,4,5,11,19,39,-20,17
Loko Moscow,6866,1,11,7,2,32,14,18,40
CSKA Moscow,6866,2,11,4,5,27,18,9,37
Spart Moscow,6866,3,10,5,5,42,29,13,35
Terek Grozny,6866,4,9,5,6,23,22,1,32
Zenit,6866,5,7,9,4,23,16,7,30
Krasnodar,6866,6,8,6,6,31,28,3,30
FK Rubin,6866,7,5,7,8,24,20,4,22
Din Moscow,6866,8,5,7,8,18,27,-9,22
Amkar,6866,9,5,4,11,12,26,-14,19
Rostov,6866,10,4,6,10,11,19,-8,18
Anzhi,6866,11,2,6,12,14,38,-24,12
Loko Moscow,6867,1,13,5,2,31,11,20,44
CSKA Moscow,6867,2,11,3,6,30,21,9,36
Spart Moscow,6867,3,10,5,5,38,29,9,35
Zenit,6867,4,7,8,5,22,17,5,29
Krasnodar,6867,5,8,5,7,28,26,2,29
Terek Grozny,6867,6,8,5,7,21,24,-3,29
FK Rubin,6867,7,6,6,8,24,18,6,24
Din Moscow,6867,8,6,6,8,20,24,-4,24
Rostov,6867,9,4,6,10,10,18,-8,18
Anzhi,6867,10,4,5,11,19,39,-20,17
Amkar,6867,11,4,4,12,10,26,-16,16
Loko Moscow,6868,1,11,7,2,31,13,18,40
Zenit,6868,2,8,9,3,24,14,10,33
Spart Moscow,6868,3,9,6,5,37,29,8,33
CSKA Moscow,6868,4,10,3,7,26,21,5,33
Krasnodar,6868,5,8,6,6,28,25,3,30
Terek Grozny,6868,6,8,5,7,22,25,-3,29
FK Rubin,6868,7,6,6,8,22,17,5,24
Din Moscow,6868,8,5,6,9,17,23,-6,21
Rostov,6868,9,4,7,9,12,19,-7,19
Amkar,6868,10,5,4,11,12,25,-13,19
Anzhi,6868,11,4,5,11,18,38,-20,17
Loko Moscow,6869,1,11,6,3,32,15,17,39
Spart Moscow,6869,2,9,7,4,37,26,11,34
Krasnodar,6869,3,10,4,6,33,28,5,34
Zenit,6869,4,8,9,3,25,15,10,33
CSKA Moscow,6869,5,10,3,7,25,20,5,33
Terek Grozny,6869,6,9,5,6,25,22,3,32
FK Rubin,6869,7,6,5,9,26,21,5,23
Din Moscow,6869,8,5,6,9,17,26,-9,21
Rostov,6869,9,4,7,9,11,18,-7,19
Amkar,6869,10,4,5,11,9,23,-14,17
Anzhi,6869,11,3,5,12,15,41,-26,14
Loko Moscow,6870,1,12,6,2,30,11,19,42
CSKA Moscow,6870,2,11,3,6,28,18,10,36
Spart Moscow,6870,3,10,5,5,37,28,9,35
Zenit,6870,4,8,9,3,22,13,9,33
Krasnodar,6870,5,8,4,8,27,27,0,28
Terek Grozny,6870,6,7,6,7,22,25,-3,27
Din Moscow,6870,7,6,6,8,21,24,-3,24
FK Rubin,6870,8,6,5,9,24,20,4,23
Amkar,6870,9,6,4,10,11,22,-11,22
Rostov,6870,10,4,6,10,11,19,-8,18
Anzhi,6870,11,2,6,12,16,42,-26,12
Loko Moscow,6871,1,11,6,3,30,13,17,39
CSKA Moscow,6871,2,12,3,5,29,17,12,39
Spart Moscow,6871,3,10,5,5,38,28,10,35
Zenit,6871,4,8,8,4,22,15,7,32
Krasnodar,6871,5,9,5,6,29,25,4,32
Terek Grozny,6871,6,8,5,7,24,24,0,29
Din Moscow,6871,7,5,7,8,17,23,-6,22
FK Rubin,6871,8,5,6,9,21,18,3,21
Rostov,6871,9,5,6,9,11,17,-6,21
Amkar,6871,10,4,4,12,11,28,-17,16
Anzhi,6871,11,3,5,12,16,40,-24,14
Loko Moscow,6872,1,12,6,2,32,13,19,42
Spart Moscow,6872,2,10,5,5,39,27,12,35
CSKA Moscow,6872,3,10,4,6,27,20,7,34
Krasnodar,6872,4,9,5,6,29,24,5,32
Zenit,6872,5,7,9,4,24,17,7,30
Terek Grozny,6872,6,7,6,7,22,26,-4,27
Din Moscow,6872,7,6,7,7,20,23,-3,25
FK Rubin,6872,8,5,6,9,23,21,2,21
Rostov,6872,9,4,6,10,10,19,-9,18
Amkar,6872,10,4,5,11,11,27,-16,17
Anzhi,6872,11,4,5,11,19,39,-20,17
Loko Moscow,6873,1,11,5,4,29,13,16,38
Zenit,6873,2,9,8,3,25,13,12,35
CSKA Moscow,6873,3,10,4,6,25,20,5,34
Spart Moscow,6873,4,9,6,5,36,28,8,33
Krasnodar,6873,5,9,5,6,28,24,4,32
Terek Grozny,6873,6,8,6,6,24,25,-1,30
FK Rubin,6873,7,6,6,8,23,18,5,24
Din Moscow,6873,8,6,6,8,20,24,-4,24
Rostov,6873,9,4,6,10,10,18,-8,18
Amkar,6873,10,4,5,11,10,24,-14,17
Anzhi,6873,11,2,7,11,17,40,-23,13
Loko Moscow,6874,1,12,6,2,30,11,19,42
CSKA Moscow,6874,2,11,3,6,27,21,6,36
Zenit,6874,3,8,9,3,24,13,11,33
Spart Moscow,6874,4,9,6,5,38,29,9,33
Krasnodar,6874,5,9,4,7,29,26,3,31
Terek Grozny,6874,6,7,6,7,21,24,-3,27
Din Moscow,6874,7,6,6,8,21,25,-4,24
Rostov,6874,8,5,6,9,12,17,-5,21
FK Rubin,6874,9,5,5,10,23,23,0,20
Amkar,6874,10,5,5,10,13,25,-12,20
Anzhi,6874,11,2,6,12,15,39,-24,12
Spart Moscow,6875,1,11,5,4,43,29,14,38
Loko Moscow,6875,2,11,5,4,30,17,13,38
CSKA Moscow,6875,3,11,3,6,26,18,8,36
Zenit,6875,4,9,8,3,25,13,12,35
Krasnodar,6875,5,9,5,6,30,25,5,32
Terek Grozny,6875,6,7,5,8,21,27,-6,26
FK Rubin,6875,7,6,6,8,23,18,5,24
Din Moscow,6875,8,5,6,9,20,26,-6,21
Amkar,6875,9,5,4,11,12,26,-14,19
Rostov,6875,10,4,6,10,11,21,-10,18
Anzhi,6875,11,3,5,12,17,38,-21,14
Loko Moscow,6876,1,11,6,3,31,14,17,39
CSKA Moscow,6876,2,11,3,6,31,21,10,36
Zenit,6876,3,8,9,3,26,17,9,33
Spart Moscow,6876,4,9,6,5,36,29,7,33
Krasnodar,6876,5,9,5,6,29,25,4,32
Terek Grozny,6876,6,7,6,7,25,29,-4,27
Din Moscow,6876,7,6,7,7,20,22,-2,25
FK Rubin,6876,8,5,6,9,22,20,2,21
Amkar,6876,9,5,5,10,13,24,-11,20
Rostov,6876,10,4,6,10,11,19,-8,18
Anzhi,6876,11,3,5,12,20,44,-24,14
Loko Moscow,6877,1,12,5,3,32,15,17,41
CSKA Moscow,6877,2,11,4,5,29,20,9,37
Spart Moscow,6877,3,10,6,4,38,28,10,36
Krasnodar,6877,4,9,5,6,32,27,5,32
Zenit,6877,5,7,9,4,24,17,7,30
Terek Grozny,6877,6,7,6,7,21,24,-3,27
FK Rubin,6877,7,6,6,8,24,19,5,24
Din Moscow,6877,8,5,7,8,19,24,-5,22
Rostov,6877,9,4,6,10,11,19,-8,18
Amkar,6877,10,4,5,11,11,25,-14,17
Anzhi,6877,11,3,5,12,15,38,-23,14
Loko Moscow,6878,1,13,5,2,33,11,22,44
CSKA Moscow,6878,2,10,5,5,27,19,8,35
Spart Moscow,6878,3,9,6,5,36,29,7,33
Zenit,6878,4,7,9,4,22,15,7,30
Krasnodar,6878,5,8,4,8,27,29,-2,28
Terek Grozny,6878,6,7,5,8,22,27,-5,26
FK Rubin,6878,7,6,6,8,23,17,6,24
Din Moscow,6878,8,5,7,8,17,22,-5,22
Rostov,6878,9,5,6,9,13,18,-5,21
Amkar,6878,10,5,5,10,13,24,-11,20
Anzhi,6878,11,3,6,11,17,39,-22,15
Loko Moscow,6879,1,12,6,2,30,11,19,42
CSKA Moscow,6879,2,12,3,5,27,17,10,39
Spart Moscow,6879,3,10,6,4,36,26,10,36
Krasnodar,6879,4,9,5,6,31,24,7,32
Zenit,6879,5,7,8,5,21,15,6,29
Terek Grozny,6879,6,8,5,7,22,24,-2,29
Din Moscow,6879,7,6,6,8,19,22,-3,24
FK Rubin,6879,8,5,5,10,21,23,-2,20
Rostov,6879,9,4,7,9,11,18,-7,19
Amkar,6879,10,5,4,11,11,23,-12,19
Anzhi,6879,11,2,5,13,14,40,-26,11
Loko Moscow,6880,1,12,5,3,31,13,18,41
Spart Moscow,6880,2,11,5,4,38,25,13,38
CSKA Moscow,6880,3,10,4,6,26,21,5,34
Zenit,6880,4,8,9,3,22,13,9,33
Terek Grozny,6880,5,8,6,6,25,25,0,30
Krasnodar,6880,6,8,5,7,28,26,2,29
FK Rubin,6880,7,5,7,8,21,17,4,22
Din Moscow,6880,8,5,7,8,17,22,-5,22
Rostov,6880,9,4,6,10,10,19,-9,18
Amkar,6880,10,4,4,12,10,27,-17,16
Anzhi,6880,11,3,6,11,20,40,-20,15
Loko Moscow,6881,1,12,5,3,31,12,19,41
CSKA Moscow,6881,2,12,3,5,29,18,11,39
Spart Moscow,6881,3,10,6,4,42,30,12,36
Krasnodar,6881,4,10,4,6,30,25,5,34
Zenit,6881,5,7,8,5,21,17,4,29
Terek Grozny,6881,6,8,5,7,22,24,-2,29
Din Moscow,6881,7,6,6,8,20,25,-5,24
FK Rubin,6881,8,5,5,10,22,20,2,20
Rostov,6881,9,4,7,9,11,18,-7,19
Amkar,6881,10,5,4,11,13,27,-14,19
Anzhi,6881,11,2,5,13,15,40,-25,11
Loko Moscow,6882,1,11,5,4,30,17,13,38
Zenit,6882,2,9,8,3,24,13,11,35
Spart Moscow,6882,3,9,7,4,35,25,10,34
Krasnodar,6882,4,10,4,6,32,25,7,34
CSKA Moscow,6882,5,10,3,7,25,19,6,33
Terek Grozny,6882,6,8,5,7,21,24,-3,29
FK Rubin,6882,7,6,5,9,23,19,4,23
Din Moscow,6882,8,5,7,8,18,23,-5,22
Amkar,6882,9,5,5,10,11,22,-11,20
Rostov,6882,10,4,6,10,10,19,-9,18
Anzhi,6882,11,3,5,12,15,38,-23,14
Loko Moscow,6883,1,12,5,3,32,13,19,41
CSKA Moscow,6883,2,12,3,5,29,17,12,39
Spart Moscow,6883,3,10,5,5,40,29,11,35
Krasnodar,6883,4,9,5,6,29,25,4,32
Zenit,6883,5,7,8,5,21,16,5,29
Terek Grozny,6883,6,7,6,7,21,24,-3,27
FK Rubin,6883,7,5,7,8,22,18,4,22
Din Moscow,6883,8,5,7,8,19,26,-7,22
Amkar,6883,9,5,5,10,12,23,-11,20
Rostov,6883,10,4,6,10,11,20,-9,18
Anzhi,6883,11,3,5,12,15,40,-25,14
Loko Moscow,6884,1,11,6,3,30,13,17,39
CSKA Moscow,6884,2,11,3,6,27,19,8,36
Spart Moscow,6884,3,9,7,4,40,28,12,34
Krasnodar,6884,4,10,4,6,29,24,5,34
Zenit,6884,5,8,9,3,23,14,9,33
Terek Grozny,6884,6,9,5,6,26,25,1,32
FK Rubin,6884,7,6,5,9,23,18,5,23
Din Moscow,6884,8,5,7,8,17,23,-6,22
Rostov,6884,9,4,6,10,11,22,-11,18
Amkar,6884,10,4,5,11,12,27,-15,17
Anzhi,6884,11,2,5,13,17,42,-25,11
Loko Moscow,6885,1,11,7,2,31,13,18,40
CSKA Moscow,6885,2,11,4,5,31,19,12,37
Spart Moscow,6885,3,9,6,5,38,32,6,33
Terek Grozny,6885,4,9,5,6,24,24,0,32
Zenit,6885,5,7,9,4,21,17,4,30
Krasnodar,6885,6,8,5,7,30,29,1,29
Din Moscow,6885,7,6,6,8,21,25,-4,24
FK Rubin,6885,8,6,5,9,25,20,5,23
Rostov,6885,9,5,6,9,14,18,-4,21
Amkar,6885,10,4,5,11,12,26,-14,17
Anzhi,6885,11,2,6,12,16,40,-24,12
Loko Moscow,6886,1,12,5,3,30,14,16,41
CSKA Moscow,6886,2,11,4,5,29,19,10,37
Spart Moscow,6886,3,10,6,4,38,25,13,36
Krasnodar,6886,4,9,4,7,31,27,4,31
Zenit,6886,5,7,9,4,23,16,7,30
Terek Grozny,6886,6,8,5,7,25,25,0,29
Din Moscow,6886,7,6,6,8,18,25,-7,24
FK Rubin,6886,8,6,5,9,24,19,5,23
Amkar,6886,9,5,5,10,10,22,-12,20
Rostov,6886,10,4,6,10,10,18,-8,18
Anzhi,6886,11,2,5,13,16,44,-28,11
Loko Moscow,6887,1,13,5,2,35,13,22,44
Spart Moscow,6887,2,10,6,4,40,27,13,36
CSKA Moscow,6887,3,11,3,6,32,19,13,36
Zenit,6887,4,8,8,4,24,18,6,32
Krasnodar,6887,5,9,4,7,33,27,6,31
Terek Grozny,6887,6,7,6,7,22,26,-4,27
Din Moscow,6887,7,6,6,8,21,24,-3,24
FK Rubin,6887,8,5,5,10,22,25,-3,20
Rostov,6887,9,4,6,10,10,20,-10,18
Amkar,6887,10,4,6,10,11,24,-13,18
Anzhi,6887,11,3,5,12,17,44,-27,14
Loko Moscow,6888,1,12,6,2,31,12,19,42
CSKA Moscow,6888,2,11,3,6,27,18,9,36
Spart Moscow,6888,3,9,7,4,38,29,9,34
Zenit,6888,4,8,9,3,22,13,9,33
Terek Grozny,6888,5,9,5,6,25,25,0,32
Krasnodar,6888,6,9,4,7,29,26,3,31
FK Rubin,6888,7,6,5,9,23,18,5,23
Din Moscow,6888,8,5,6,9,17,24,-7,21
Rostov,6888,9,4,7,9,12,19,-7,19
Amkar,6888,10,4,5,11,13,27,-14,17
Anzhi,6888,11,2,5,13,15,41,-26,11
Loko Moscow,6889,1,11,5,4,31,17,14,38
Spart Moscow,6889,2,10,6,4,36,26,10,36
Zenit,6889,3,9,8,3,27,15,12,35
CSKA Moscow,6889,4,10,3,7,25,20,5,33
Krasnodar,6889,5,9,4,7,31,27,4,31
Terek Grozny,6889,6,7,6,7,22,25,-3,27
FK Rubin,6889,7,6,6,8,26,21,5,24
Din Moscow,6889,8,5,7,8,19,24,-5,22
Rostov,6889,9,4,7,9,10,17,-7,19
Amkar,6889,10,4,5,11,11,25,-14,17
Anzhi,6889,11,4,5,11,17,38,-21,17
Loko Moscow,6890,1,12,5,3,31,16,15,41
Spart Moscow,6890,2,11,5,4,45,27,18,38
CSKA Moscow,6890,3,10,4,6,25,18,7,34
Zenit,6890,4,8,8,4,23,15,8,32
Krasnodar,6890,5,9,5,6,32,25,7,32
Terek Grozny,6890,6,8,5,7,22,24,-2,29
FK Rubin,6890,7,5,7,8,23,19,4,22
Din Moscow,6890,8,5,7,8,18,25,-7,22
Amkar,6890,9,5,4,11,11,26,-15,19
Rostov,6890,10,4,6,10,12,23,-11,18
Anzhi,6890,11,2,6,12,14,38,-24,12
Loko Moscow,6891,1,13,5,2,33,11,22,44
CSKA Moscow,6891,2,11,4,5,28,18,10,37
Spart Moscow,6891,3,10,6,4,39,29,10,36
Krasnodar,6891,4,9,4,7,29,27,2,31
Zenit,6891,5,7,9,4,22,15,7,30
Terek Grozny,6891,6,8,5,7,25,26,-1,29
Din Moscow,6891,7,5,8,7,19,23,-4,23
FK Rubin,6891,8,5,6,9,22,20,2,21
Amkar,6891,9,5,4,11,13,26,-13,19
Rostov,6891,10,4,6,10,11,19,-8,18
Anzhi,6891,11,2,5,13,16,43,-27,11
Loko Moscow,6892,1,11,5,4,29,14,15,38
CSKA Moscow,6892,2,11,3,6,26,18,8,36
Zenit,6892,3,9,8,3,23,13,10,35
Spart Moscow,6892,4,9,6,5,36,27,9,33
Krasnodar,6892,5,9,4,7,29,25,4,31
Terek Grozny,6892,6,8,5,7,21,23,-2,29
Din Moscow,6892,7,7,6,7,20,22,-2,27
FK Rubin,6892,8,6,5,9,23,19,4,23
Rostov,6892,9,4,6,10,11,20,-9,18
Amkar,6892,10,4,5,11,9,23,-14,17
Anzhi,6892,11,3,5,12,15,38,-23,14
Loko Moscow,6893,1,12,6,2,31,12,19,42
Spart Moscow,6893,2,11,5,4,44,31,13,38
CSKA Moscow,6893,3,11,4,5,29,18,11,37
Krasnodar,6893,4,9,5,6,30,26,4,32
Zenit,6893,5,7,9,4,23,16,7,30
Terek Grozny,6893,6,7,6,7,20,25,-5,27
Din Moscow,6893,7,6,6,8,21,25,-4,24
FK Rubin,6893,8,5,5,10,23,22,1,20
Rostov,6893,9,4,6,10,13,21,-8,18
Amkar,6893,10,4,5,11,10,25,-15,17
Anzhi,6893,11,3,5,12,17,40,-23,14
Loko Moscow,6894,1,11,7,2,32,14,18,40
Spart Moscow,6894,2,11,5,4,39,26,13,38
CSKA Moscow,6894,3,11,4,5,26,17,9,37
Krasnodar,6894,4,9,5,6,30,26,4,32
Zenit,6894,5,7,10,3,23,15,8,31
Terek Grozny,6894,6,7,7,6,21,23,-2,28
Din Moscow,6894,7,6,6,8,19,22,-3,24
FK Rubin,6894,8,5,5,10,22,21,1,20
Rostov,6894,9,4,6,10,10,20,-10,18
Amkar,6894,10,4,5,11,11,25,-14,17
Anzhi,6894,11,2,6,12,14,38,-24,12
Loko Moscow,6895,1,11,5,4,32,16,16,38
Spart Moscow,6895,2,10,6,4,36,25,11,36
CSKA Moscow,6895,3,11,3,6,29,20,9,36
Zenit,6895,4,9,8,3,25,15,10,35
Terek Grozny,6895,5,9,5,6,24,24,0,32
Krasnodar,6895,6,9,4,7,30,27,3,31
FK Rubin,6895,7,6,6,8,25,20,5,24
Din Moscow,6895,8,5,7,8,19,24,-5,22
Rostov,6895,9,4,6,10,10,19,-9,18
Amkar,6895,10,4,5,11,11,25,-14,17
Anzhi,6895,11,2,5,13,16,42,-26,11
Loko Moscow,6896,1,11,6,3,29,14,15,39
Spart Moscow,6896,2,9,7,4,38,28,10,34
CSKA Moscow,6896,3,10,4,6,28,21,7,34
Zenit,6896,4,7,10,3,22,14,8,31
Krasnodar,6896,5,9,4,7,30,25,5,31
Terek Grozny,6896,6,8,5,7,22,27,-5,29
FK Rubin,6896,7,6,6,8,23,18,5,24
Din Moscow,6896,8,5,8,7,19,23,-4,23
Rostov,6896,9,4,7,9,10,17,-7,19
Anzhi,6896,10,4,5,11,21,39,-18,17
Amkar,6896,11,4,4,12,12,28,-16,16
Loko Moscow,6897,1,12,5,3,30,12,18,41
CSKA Moscow,6897,2,11,3,6,30,20,10,36
Spart Moscow,6897,3,9,6,5,37,29,8,33
Zenit,6897,4,8,8,4,24,16,8,32
Krasnodar,6897,5,9,5,6,29,25,4,32
Din Moscow,6897,6,7,6,7,20,22,-2,27
Terek Grozny,6897,7,7,6,7,22,25,-3,27
FK Rubin,6897,8,5,6,9,22,19,3,21
Rostov,6897,9,4,7,9,12,19,-7,19
Amkar,6897,10,4,5,11,10,24,-14,17
Anzhi,6897,11,3,5,12,16,41,-25,14
Loko Moscow,6898,1,13,5,2,34,12,22,44
CSKA Moscow,6898,2,11,4,5,27,18,9,37
Spart Moscow,6898,3,10,5,5,37,27,10,35
Zenit,6898,4,7,9,4,22,16,6,30
Krasnodar,6898,5,8,5,7,29,28,1,29
Terek Grozny,6898,6,8,5,7,22,25,-3,29
Din Moscow,6898,7,7,6,7,20,22,-2,27
FK Rubin,6898,8,5,6,9,23,20,3,21
Rostov,6898,9,4,6,10,10,19,-9,18
Amkar,6898,10,4,4,12,10,25,-15,16
Anzhi,6898,11,3,5,12,17,39,-22,14
Loko Moscow,6899,1,11,6,3,30,13,17,39
CSKA Moscow,6899,2,11,3,6,28,20,8,36
Spart Moscow,6899,3,10,5,5,41,30,11,35
Zenit,6899,4,8,9,3,24,15,9,33
Krasnodar,6899,5,9,4,7,28,25,3,31
Terek Grozny,6899,6,7,7,6,21,23,-2,28
FK Rubin,6899,7,6,6,8,23,18,5,24
Din Moscow,6899,8,5,7,8,20,26,-6,22
Amkar,6899,9,5,5,10,12,23,-11,20
Rostov,6899,10,4,6,10,10,20,-10,18
Anzhi,6899,11,2,6,12,16,40,-24,12
Loko Moscow,6900,1,11,6,3,32,15,17,39
Spart Moscow,6900,2,10,6,4,44,27,17,36
CSKA Moscow,6900,3,10,5,5,28,20,8,35
Zenit,6900,4,8,9,3,25,16,9,33
Krasnodar,6900,5,9,5,6,31,25,6,32
Terek Grozny,6900,6,8,6,6,22,23,-1,30
Din Moscow,6900,7,6,6,8,19,27,-8,24
FK Rubin,6900,8,5,5,10,22,22,0,20
Rostov,6900,9,4,6,10,10,21,-11,18
Amkar,6900,10,4,5,11,12,26,-14,17
Anzhi,6900,11,2,7,11,16,39,-23,13
Loko Moscow,6901,1,12,5,3,31,15,16,41
CSKA Moscow,6901,2,12,3,5,30,19,11,39
Spart Moscow,6901,3,10,5,5,37,29,8,35
Zenit,6901,4,8,8,4,26,16,10,32
Terek Grozny,6901,5,9,5,6,24,22,2,32
Krasnodar,6901,6,9,4,7,30,27,3,31
Din Moscow,6901,7,5,7,8,19,24,-5,22
FK Rubin,6901,8,5,6,9,23,20,3,21
Amkar,6901,9,5,4,11,12,24,-12,19
Rostov,6901,10,4,6,10,10,18,-8,18
Anzhi,6901,11,2,5,13,14,42,-28,11
Loko Moscow,6902,1,11,5,4,30,17,13,38
CSKA Moscow,6902,2,11,3,6,29,19,10,36
Zenit,6902,3,9,8,3,26,15,11,35
Terek Grozny,6902,4,9,5,6,26,24,2,32
Spart Moscow,6902,5,8,7,5,35,28,7,31
Krasnodar,6902,6,9,4,7,30,26,4,31
FK Rubin,6902,7,6,6,8,23,17,6,24
Din Moscow,6902,8,5,8,7,18,22,-4,23
Rostov,6902,9,5,6,9,12,18,-6,21
Amkar,6902,10,4,5,11,10,26,-16,17
Anzhi,6902,11,2,5,13,15,42,-27,11
Loko Moscow,6903,1,12,5,3,31,15,16,41
Zenit,6903,2,9,8,3,27,13,14,35
CSKA Moscow,6903,3,10,4,6,27,22,5,34
Spart Moscow,6903,4,9,6,5,40,35,5,33
Terek Grozny,6903,5,8,5,7,23,23,0,29
Krasnodar,6903,6,8,4,8,29,30,-1,28
Din Moscow,6903,7,6,7,7,22,21,1,25
FK Rubin,6903,8,6,6,8,25,18,7,24
Rostov,6903,9,4,7,9,14,21,-7,19
Amkar,6903,10,4,4,12,10,28,-18,16
Anzhi,6903,11,3,6,11,17,39,-22,15
Loko Moscow,6904,1,13,5,2,32,11,21,44
CSKA Moscow,6904,2,11,3,6,27,20,7,36
Spart Moscow,6904,3,9,7,4,35,26,9,34
Zenit,6904,4,7,8,5,22,16,6,29
Terek Grozny,6904,5,8,5,7,23,25,-2,29
Krasnodar,6904,6,8,4,8,27,29,-2,28
Din Moscow,6904,7,6,6,8,19,22,-3,24
FK Rubin,6904,8,6,5,9,24,19,5,23
Amkar,6904,9,5,5,10,11,23,-12,20
Rostov,6904,10,4,7,9,11,18,-7,19
Anzhi,6904,11,3,5,12,17,39,-22,14
Loko Moscow,6905,1,11,6,3,29,13,16,39
CSKA Moscow,6905,2,11,4,5,30,18,12,37
Spart Moscow,6905,3,10,5,5,37,26,11,35
Krasnodar,6905,4,10,4,6,33,26,7,34
Zenit,6905,5,7,10,3,22,14,8,31
Terek Grozny,6905,6,7,5,8,21,25,-4,26
Din Moscow,6905,7,6,6,8,18,23,-5,24
Amkar,6905,8,6,4,10,11,22,-11,22
FK Rubin,6905,9,5,5,10,23,22,1,20
Rostov,6905,10,4,6,10,10,19,-9,18
Anzhi,6905,11,3,5,12,16,42,-26,14
Loko Moscow,6906,1,11,6,3,31,14,17,39
CSKA Moscow,6906,2,11,3,6,29,19,10,36
Zenit,6906,3,9,8,3,25,15,10,35
Spart Moscow,6906,4,9,5,6,37,28,9,32
Krasnodar,6906,5,9,5,6,29,25,4,32
Terek Grozny,6906,6,9,5,6,23,23,0,32
Din Moscow,6906,7,6,7,7,20,23,-3,25
FK Rubin,6906,8,5,6,9,22,19,3,21
Amkar,6906,9,5,4,11,10,23,-13,19
Rostov,6906,10,4,6,10,10,20,-10,18
Anzhi,6906,11,2,5,13,15,42,-27,11
Loko Moscow,6907,1,12,6,2,35,15,20,42
CSKA Moscow,6907,2,11,3,6,27,19,8,36
Zenit,6907,3,8,8,4,25,17,8,32
Spart Moscow,6907,4,8,7,5,37,30,7,31
Terek Grozny,6907,5,8,6,6,22,22,0,30
Krasnodar,6907,6,8,5,7,29,28,1,29
FK Rubin,6907,7,6,6,8,25,19,6,24
Din Moscow,6907,8,5,8,7,20,24,-4,23
Amkar,6907,9,5,5,10,11,23,-12,20
Rostov,6907,10,4,7,9,12,19,-7,19
Anzhi,6907,11,2,5,13,14,41,-27,11
Loko Moscow,6908,1,11,6,3,30,13,17,39
Spart Moscow,6908,2,11,5,4,39,26,13,38
CSKA Moscow,6908,3,11,3,6,27,19,8,36
Zenit,6908,4,9,8,3,25,14,11,35
Terek Grozny,6908,5,9,5,6,23,23,0,32
Krasnodar,6908,6,8,6,6,28,25,3,30
Din Moscow,6908,7,6,6,8,19,24,-5,24
FK Rubin,6908,8,5,6,9,22,20,2,21
Rostov,6908,9,4,6,10,11,19,-8,18
Amkar,6908,10,4,4,12,9,24,-15,16
Anzhi,6908,11,2,5,13,15,41,-26,11
Loko Moscow,6909,1,12,5,3,32,14,18,41
CSKA Moscow,6909,2,11,4,5,32,20,12,37
Spart Moscow,6909,3,9,7,4,37,27,10,34
Terek Grozny,6909,4,9,5,6,23,22,1,32
Krasnodar,6909,5,9,4,7,31,27,4,31
Zenit,6909,6,7,9,4,24,18,6,30
FK Rubin,6909,7,6,6,8,24,19,5,24
Din Moscow,6909,8,5,8,7,18,22,-4,23
Rostov,6909,9,4,6,10,10,19,-9,18
Amkar,6909,10,4,5,11,10,24,-14,17
Anzhi,6909,11,2,5,13,15,44,-29,11
Loko Moscow,6910,1,12,5,3,30,12,18,41
CSKA Moscow,6910,2,11,3,6,29,19,10,36
Zenit,6910,3,9,8,3,24,14,10,35
Spart Moscow,6910,4,9,6,5,37,29,8,33
Terek Grozny,6910,5,8,6,6,21,22,-1,30
Krasnodar,6910,6,8,5,7,27,25,2,29
Din Moscow,6910,7,5,8,7,18,22,-4,23
FK Rubin,6910,8,5,7,8,21,17,4,22
Rostov,6910,9,5,6,9,11,17,-6,21
Amkar,6910,10,4,5,11,11,25,-14,17
Anzhi,6910,11,2,5,13,14,41,-27,11
Loko Moscow,6911,1,13,5,2,32,12,20,44
CSKA Moscow,6911,2,11,3,6,29,18,11,36
Spart Moscow,6911,3,10,6,4,39,29,10,36
Zenit,6911,4,8,8,4,23,15,8,32
Terek Grozny,6911,5,9,5,6,22,22,0,32
Krasnodar,6911,6,8,5,7,28,26,2,29
FK Rubin,6911,7,6,6,8,26,19,7,24
Din Moscow,6911,8,5,6,9,19,27,-8,21
Rostov,6911,9,4,7,9,11,18,-7,19
Amkar,6911,10,4,4,12,11,26,-15,16
Anzhi,6911,11,2,5,13,14,42,-28,11
Loko Moscow,6912,1,12,5,3,31,12,19,41
Spart Moscow,6912,2,11,5,4,42,27,15,38
CSKA Moscow,6912,3,11,3,6,27,21,6,36
Krasnodar,6912,4,10,4,6,29,24,5,34
Zenit,6912,5,8,8,4,24,15,9,32
Terek Grozny,6912,6,7,6,7,22,25,-3,27
FK Rubin,6912,7,6,5,9,23,19,4,23
Din Moscow,6912,8,5,6,9,19,26,-7,21
Rostov,6912,9,4,6,10,10,19,-9,18
Amkar,6912,10,4,5,11,11,27,-16,17
Anzhi,6912,11,3,5,12,17,40,-23,14
Loko Moscow,6913,1,11,7,2,32,14,18,40
Spart Moscow,6913,2,11,5,4,42,27,15,38
Zenit,6913,3,8,9,3,26,16,10,33
CSKA Moscow,6913,4,10,3,7,26,21,5,33
Krasnodar,6913,5,8,6,6,28,25,3,30
Terek Grozny,6913,6,7,5,8,21,26,-5,26
Din Moscow,6913,7,6,6,8,21,25,-4,24
FK Rubin,6913,8,5,6,9,21,20,1,21
Amkar,6913,9,5,4,11,11,23,-12,19
Rostov,6913,10,4,6,10,11,21,-10,18
Anzhi,6913,11,4,5,11,17,38,-21,17
Loko Moscow,6914,1,13,5,2,33,12,21,44
Spart Moscow,6914,2,10,5,5,39,29,10,35
CSKA Moscow,6914,3,10,4,6,26,19,7,34
Zenit,6914,4,8,8,4,22,15,7,32
Krasnodar,6914,5,8,5,7,31,29,2,29
Terek Grozny,6914,6,8,5,7,23,24,-1,29
FK Rubin,6914,7,6,6,8,26,20,6,24
Amkar,6914,8,6,4,10,14,25,-11,22
Din Moscow,6914,9,5,6,9,17,25,-8,21
Rostov,6914,10,4,6,10,10,18,-8,18
Anzhi,6914,11,2,6,12,16,41,-25,12
Loko Moscow,6915,1,11,6,3,32,15,17,39
CSKA Moscow,6915,2,11,4,5,28,18,10,37
Spart Moscow,6915,3,10,6,4,38,26,12,36
Zenit,6915,4,8,8,4,23,16,7,32
Krasnodar,6915,5,9,5,6,32,27,5,32
Terek Grozny,6915,6,7,7,6,22,24,-2,28
Din Moscow,6915,7,6,7,7,21,22,-1,25
FK Rubin,6915,8,5,5,10,22,23,-1,20
Rostov,6915,9,4,6,10,10,18,-8,18
Amkar,6915,10,4,5,11,10,26,-16,17
Anzhi,6915,11,2,7,11,16,39,-23,13
Loko Moscow,6916,1,11,6,3,30,13,17,39
CSKA Moscow,6916,2,11,4,5,28,19,9,37
Spart Moscow,6916,3,10,6,4,38,25,13,36
Krasnodar,6916,4,9,5,6,28,24,4,32
Zenit,6916,5,7,10,3,23,15,8,31
Terek Grozny,6916,6,8,5,7,24,25,-1,29
FK Rubin,6916,7,6,6,8,23,18,5,24
Din Moscow,6916,8,5,7,8,18,23,-5,22
Rostov,6916,9,4,6,10,10,21,-11,18
Amkar,6916,10,4,4,12,10,26,-16,16
Anzhi,6916,11,3,5,12,17,40,-23,14
Loko Moscow,6917,1,13,5,2,33,12,21,44
Spart Moscow,6917,2,9,7,4,36,26,10,34
CSKA Moscow,6917,3,10,4,6,26,19,7,34
Zenit,6917,4,8,8,4,22,14,8,32
Krasnodar,6917,5,9,4,7,29,27,2,31
Terek Grozny,6917,6,8,5,7,24,28,-4,29
Din Moscow,6917,7,6,7,7,19,21,-2,25
FK Rubin,6917,8,5,5,10,21,20,1,20
Amkar,6917,9,5,5,10,15,25,-10,20
Rostov,6917,10,4,6,10,10,19,-9,18
Anzhi,6917,11,2,6,12,16,40,-24,12
Loko Moscow,6918,1,13,5,2,33,11,22,44
CSKA Moscow,6918,2,11,4,5,29,20,9,37
Spart Moscow,6918,3,10,5,5,37,29,8,35
Krasnodar,6918,4,9,4,7,33,26,7,31
Terek Grozny,6918,5,8,6,6,22,23,-1,30
Zenit,6918,6,7,8,5,23,19,4,29
Din Moscow,6918,7,6,6,8,19,23,-4,24
Rostov,6918,8,5,6,9,12,17,-5,21
FK Rubin,6918,9,5,5,10,22,24,-2,20
Amkar,6918,10,4,4,12,10,25,-15,16
Anzhi,6918,11,2,7,11,16,39,-23,13
Loko Moscow,6919,1,11,6,3,31,17,14,39
CSKA Moscow,6919,2,11,3,6,27,19,8,36
Spart Moscow,6919,3,10,5,5,39,29,10,35
Krasnodar,6919,4,9,4,7,31,25,6,31
Zenit,6919,5,7,9,4,24,17,7,30
Terek Grozny,6919,6,8,5,7,23,26,-3,29
Din Moscow,6919,7,6,6,8,20,24,-4,24
FK Rubin,6919,8,6,5,9,22,19,3,23
Rostov,6919,9,5,6,9,12,18,-6,21
Anzhi,6919,10,4,5,11,18,38,-20,17
Amkar,6919,11,4,4,12,11,26,-15,16
Loko Moscow,6920,1,11,5,4,31,15,16,38
Spart Moscow,6920,2,11,5,4,37,25,12,38
CSKA Moscow,6920,3,11,4,5,28,18,10,37
Zenit,6920,4,8,9,3,24,15,9,33
Krasnodar,6920,5,9,5,6,31,27,4,32
Terek Grozny,6920,6,8,5,7,24,26,-2,29
FK Rubin,6920,7,6,6,8,24,19,5,24
Din Moscow,6920,8,5,6,9,17,24,-7,21
Amkar,6920,9,5,4,11,11,24,-13,19
Rostov,6920,10,4,6,10,10,18,-8,18
Anzhi,6920,11,2,5,13,16,42,-26,11
Loko Moscow,6921,1,13,5,2,32,11,21,44
CSKA Moscow,6921,2,12,3,5,31,21,10,39
Spart Moscow,6921,3,10,6,4,36,25,11,36
Krasnodar,6921,4,9,4,7,28,26,2,31
Zenit,6921,5,7,8,5,23,17,6,29
Terek Grozny,6921,6,7,5,8,22,28,-6,26
Din Moscow,6921,7,6,6,8,20,23,-3,24
FK Rubin,6921,8,5,5,10,22,21,1,20
Amkar,6921,9,5,5,10,12,22,-10,20
Rostov,6921,10,4,6,10,10,19,-9,18
Anzhi,6921,11,3,5,12,19,42,-23,14
Loko Moscow,6922,1,12,6,2,32,13,19,42
CSKA Moscow,6922,2,10,3,7,28,23,5,33
Zenit,6922,3,8,8,4,24,16,8,32
Krasnodar,6922,4,9,5,6,30,25,5,32
Spart Moscow,6922,5,8,6,6,34,31,3,30
Terek Grozny,6922,6,7,7,6,23,25,-2,28
Din Moscow,6922,7,7,6,7,21,21,0,27
Rostov,6922,8,5,6,9,12,17,-5,21
FK Rubin,6922,9,5,5,10,21,20,1,20
Amkar,6922,10,4,6,10,11,24,-13,18
Anzhi,6922,11,3,6,11,20,41,-21,15
Loko Moscow,6923,1,13,5,2,34,11,23,44
CSKA Moscow,6923,2,11,3,6,28,18,10,36
Zenit,6923,3,8,8,4,22,15,7,32
Krasnodar,6923,4,9,4,7,30,28,2,31
Spart Moscow,6923,5,8,6,6,36,31,5,30
Terek Grozny,6923,6,8,5,7,22,25,-3,29
Din Moscow,6923,7,7,6,7,23,23,0,27
Rostov,6923,8,5,6,9,12,17,-5,21
FK Rubin,6923,9,5,5,10,24,25,-1,20
Amkar,6923,10,4,5,11,12,26,-14,17
Anzhi,6923,11,3,5,12,17,41,-24,14
Loko Moscow,6924,1,13,5,2,34,12,22,44
CSKA Moscow,6924,2,11,4,5,29,19,10,37
Spart Moscow,6924,3,9,5,6,36,29,7,32
Zenit,6924,4,7,9,4,23,17,6,30
Krasnodar,6924,5,8,4,8,27,28,-1,28
Terek Grozny,6924,6,7,5,8,20,26,-6,26
FK Rubin,6924,7,6,6,8,23,17,6,24
Din Moscow,6924,8,5,7,8,18,23,-5,22
Amkar,6924,9,6,4,10,12,23,-11,22
Rostov,6924,10,5,6,9,11,17,-6,21
Anzhi,6924,11,3,5,12,18,40,-22,14
Loko Moscow,6925,1,12,5,3,30,13,17,41
CSKA Moscow,6925,2,10,4,6,27,22,5,34
Spart Moscow,6925,3,9,6,5,38,28,10,33
Zenit,6925,4,8,9,3,25,15,10,33
Krasnodar,6925,5,9,4,7,30,27,3,31
Din Moscow,6925,6,7,6,7,20,22,-2,27
Terek Grozny,6925,7,7,5,8,21,26,-5,26
FK Rubin,6925,8,5,5,10,23,21,2,20
Amkar,6925,9,5,5,10,12,24,-12,20
Rostov,6925,10,4,6,10,10,20,-10,18
Anzhi,6925,11,4,5,11,19,37,-18,17
Loko Moscow,6926,1,12,5,3,32,13,19,41
CSKA Moscow,6926,2,11,3,6,27,21,6,36
Zenit,6926,3,8,8,4,25,16,9,32
Spart Moscow,6926,4,8,8,4,36,28,8,32
Krasnodar,6926,5,9,5,6,29,24,5,32
Terek Grozny,6926,6,7,6,7,22,26,-4,27
Din Moscow,6926,7,6,7,7,19,21,-2,25
FK Rubin,6926,8,5,6,9,21,19,2,21
Rostov,6926,9,4,7,9,12,19,-7,19
Amkar,6926,10,4,6,10,12,25,-13,18
Anzhi,6926,11,3,5,12,16,39,-23,14
Loko Moscow,6927,1,13,5,2,33,12,21,44
Spart Moscow,6927,2,11,5,4,43,28,15,38
CSKA Moscow,6927,3,11,3,6,26,19,7,36
Zenit,6927,4,8,8,4,24,16,8,32
Krasnodar,6927,5,9,4,7,30,26,4,31
Terek Grozny,6927,6,8,5,7,24,25,-1,29
Din Moscow,6927,7,5,7,8,19,28,-9,22
FK Rubin,6927,8,5,6,9,23,21,2,21
Amkar,6927,9,5,4,11,11,24,-13,19
Rostov,6927,10,4,6,10,11,19,-8,18
Anzhi,6927,11,2,5,13,16,42,-26,11
Loko Moscow,6928,1,12,6,2,34,14,20,42
CSKA Moscow,6928,2,11,3,6,27,23,4,36
Spart Moscow,6928,3,10,5,5,37,26,11,35
Zenit,6928,4,8,9,3,28,15,13,33
Krasnodar,6928,5,9,4,7,30,27,3,31
Terek Grozny,6928,6,7,6,7,21,24,-3,27
Din Moscow,6928,7,6,6,8,18,23,-5,24
FK Rubin,6928,8,5,5,10,21,20,1,20
Amkar,6928,9,5,5,10,10,22,-12,20
Rostov,6928,10,4,6,10,10,19,-9,18
Anzhi,6928,11,3,5,12,17,40,-23,14
Loko Moscow,6929,1,12,5,3,32,14,18,41
CSKA Moscow,6929,2,12,3,5,30,20,10,39
Spart Moscow,6929,3,9,6,5,37,28,9,33
Zenit,6929,4,8,8,4,25,17,8,32
Krasnodar,6929,5,8,5,7,29,27,2,29
Terek Grozny,6929,6,8,5,7,23,26,-3,29
Din Moscow,6929,7,6,6,8,18,23,-5,24
FK Rubin,6929,8,5,6,9,22,19,3,21
Rostov,6929,9,5,6,9,12,18,-6,21
Amkar,6929,10,5,5,10,13,24,-11,20
Anzhi,6929,11,2,5,13,16,41,-25,11
Loko Moscow,6930,1,12,5,3,32,16,16,41
CSKA Moscow,6930,2,11,3,6,30,20,10,36
Zenit,6930,3,9,8,3,28,14,14,35
Spart Moscow,6930,4,9,5,6,38,31,7,32
Krasnodar,6930,5,8,5,7,29,27,2,29
Terek Grozny,6930,6,7,5,8,20,25,-5,26
FK Rubin,6930,7,5,7,8,23,19,4,22
Din Moscow,6930,8,5,7,8,18,23,-5,22
Amkar,6930,9,6,4,10,14,24,-10,22
Rostov,6930,10,5,6,9,13,19,-6,21
Anzhi,6930,11,3,5,12,15,42,-27,14
Loko Moscow,6931,1,11,7,2,30,12,18,40
CSKA Moscow,6931,2,12,3,5,30,19,11,39
Spart Moscow,6931,3,9,7,4,35,26,9,34
Krasnodar,6931,4,9,5,6,32,25,7,32
Zenit,6931,5,7,9,4,23,17,6,30
Terek Grozny,6931,6,7,7,6,21,23,-2,28
Din Moscow,6931,7,5,7,8,21,26,-5,22
FK Rubin,6931,8,5,6,9,24,24,0,21
Rostov,6931,9,4,7,9,10,17,-7,19
Amkar,6931,10,4,6,10,9,22,-13,18
Anzhi,6931,11,2,6,12,15,39,-24,12
Loko Moscow,6932,1,12,6,2,30,11,19,42
CSKA Moscow,6932,2,11,3,6,28,20,8,36
Zenit,6932,3,8,9,3,24,13,11,33
Spart Moscow,6932,4,9,6,5,39,30,9,33
Krasnodar,6932,5,9,4,7,32,28,4,31
Terek Grozny,6932,6,8,5,7,22,25,-3,29
Din Moscow,6932,7,6,6,8,20,25,-5,24
Amkar,6932,8,6,4,10,15,24,-9,22
FK Rubin,6932,9,5,5,10,25,24,1,20
Rostov,6932,10,4,7,9,11,18,-7,19
Anzhi,6932,11,2,5,13,14,42,-28,11
Loko Moscow,6933,1,12,6,2,32,13,19,42
CSKA Moscow,6933,2,11,3,6,31,22,9,36
Zenit,6933,3,8,9,3,24,14,10,33
Spart Moscow,6933,4,8,7,5,35,29,6,31
Krasnodar,6933,5,9,4,7,30,26,4,31
Terek Grozny,6933,6,8,5,7,23,26,-3,29
Din Moscow,6933,7,5,8,7,19,23,-4,23
Amkar,6933,8,6,4,10,15,24,-9,22
FK Rubin,6933,9,5,6,9,22,20,2,21
Rostov,6933,10,4,7,9,10,17,-7,19
Anzhi,6933,11,2,5,13,18,45,-27,11
Loko Moscow,6934,1,11,6,3,30,13,17,39
Spart Moscow,6934,2,10,5,5,39,27,12,35
CSKA Moscow,6934,3,10,4,6,25,18,7,34
Krasnodar,6934,4,10,4,6,30,24,6,34
Zenit,6934,5,7,10,3,22,14,8,31
Terek Grozny,6934,6,8,5,7,23,25,-2,29
Din Moscow,6934,7,6,6,8,20,24,-4,24
FK Rubin,6934,8,6,5,9,23,20,3,23
Amkar,6934,9,5,4,11,10,26,-16,19
Rostov,6934,10,4,6,10,10,18,-8,18
Anzhi,6934,11,3,5,12,17,40,-23,14
Loko Moscow,6935,1,13,5,2,36,14,22,44
Spart Moscow,6935,2,9,6,5,37,26,11,33
CSKA Moscow,6935,3,10,3,7,26,21,5,33
Zenit,6935,4,8,8,4,24,16,8,32
Krasnodar,6935,5,9,4,7,30,29,1,31
Terek Grozny,6935,6,7,6,7,21,24,-3,27
Din Moscow,6935,7,6,6,8,18,25,-7,24
Amkar,6935,8,6,4,10,12,23,-11,22
FK Rubin,6935,9,5,5,10,21,19,2,20
Rostov,6935,10,4,7,9,10,17,-7,19
Anzhi,6935,11,3,6,11,16,37,-21,15
Loko Moscow,6936,1,12,5,3,32,13,19,41
Spart Moscow,6936,2,10,5,5,36,28,8,35
CSKA Moscow,6936,3,10,5,5,27,19,8,35
Krasnodar,6936,4,10,4,6,31,25,6,34
Zenit,6936,5,7,9,4,22,16,6,30
Terek Grozny,6936,6,8,6,6,23,24,-1,30
Din Moscow,6936,7,7,6,7,20,21,-1,27
FK Rubin,6936,8,5,5,10,21,20,1,20
Rostov,6936,9,4,6,10,10,18,-8,18
Amkar,6936,10,4,5,11,12,26,-14,17
Anzhi,6936,11,2,6,12,15,39,-24,12
Loko Moscow,6937,1,12,6,2,32,11,21,42
CSKA Moscow,6937,2,11,3,6,28,23,5,36
Spart Moscow,6937,3,10,5,5,39,28,11,35
Zenit,6937,4,8,9,3,26,14,12,33
Krasnodar,6937,5,8,5,7,27,27,0,29
Terek Grozny,6937,6,7,7,6,23,25,-2,28
FK Rubin,6937,7,6,6,8,25,19,6,24
Din Moscow,6937,8,5,6,9,20,28,-8,21
Amkar,6937,9,5,5,10,12,24,-12,20
Rostov,6937,10,4,6,10,10,19,-9,18
Anzhi,6937,11,2,6,12,17,41,-24,12
Loko Moscow,6938,1,13,5,2,34,12,22,44
CSKA Moscow,6938,2,11,4,5,26,17,9,37
Spart Moscow,6938,3,10,6,4,41,30,11,36
Krasnodar,6938,4,9,4,7,30,26,4,31
Zenit,6938,5,7,8,5,22,18,4,29
Terek Grozny,6938,6,8,5,7,23,24,-1,29
Din Moscow,6938,7,6,7,7,21,23,-2,25
FK Rubin,6938,8,5,5,10,23,23,0,20
Amkar,6938,9,5,4,11,13,26,-13,19
Rostov,6938,10,4,6,10,11,20,-9,18
Anzhi,6938,11,2,6,12,15,40,-25,12
Loko Moscow,6939,1,11,6,3,34,17,17,39
Spart Moscow,6939,2,11,5,4,39,26,13,38
CSKA Moscow,6939,3,11,4,5,28,19,9,37
Zenit,6939,4,8,9,3,24,15,9,33
Krasnodar,6939,5,9,5,6,32,28,4,32
Terek Grozny,6939,6,8,5,7,21,24,-3,29
Din Moscow,6939,7,5,7,8,19,24,-5,22
FK Rubin,6939,8,5,6,9,23,20,3,21
Rostov,6939,9,4,6,10,10,19,-9,18
Amkar,6939,10,4,4,12,10,26,-16,16
Anzhi,6939,11,3,5,12,17,39,-22,14
Loko Moscow,6940,1,11,6,3,30,14,16,39
CSKA Moscow,6940,2,11,4,5,28,19,9,37
Spart Moscow,6940,3,10,5,5,41,29,12,35
Krasnodar,6940,4,10,4,6,31,24,7,34
Terek Grozny,6940,5,9,5,6,25,23,2,32
Zenit,6940,6,7,10,3,24,16,8,31
Din Moscow,6940,7,5,7,8,20,27,-7,22
FK Rubin,6940,8,5,6,9,22,20,2,21
Rostov,6940,9,5,6,9,12,17,-5,21
Amkar,6940,10,4,4,12,10,27,-17,16
Anzhi,6940,11,2,5,13,14,41,-27,11
Loko Moscow,6941,1,12,5,3,33,14,19,41
CSKA Moscow,6941,2,12,3,5,28,18,10,39
Spart Moscow,6941,3,9,6,5,35,28,7,33
Krasnodar,6941,4,9,4,7,30,26,4,31
Zenit,6941,5,7,8,5,22,18,4,29
Terek Grozny,6941,6,8,5,7,24,25,-1,29
FK Rubin,6941,7,7,5,8,24,18,6,26
Din Moscow,6941,8,6,6,8,21,23,-2,24
Rostov,6941,9,4,7,9,10,17,-7,19
Amkar,6941,10,4,4,12,10,27,-17,16
Anzhi,6941,11,3,5,12,16,39,-23,14
Loko Moscow,6942,1,12,5,3,30,12,18,41
CSKA Moscow,6942,2,12,3,5,32,22,10,39
Spart Moscow,6942,3,10,5,5,39,27,12,35
Zenit,6942,4,8,8,4,24,16,8,32
Krasnodar,6942,5,9,4,7,28,25,3,31
Terek Grozny,6942,6,7,7,6,22,24,-2,28
Din Moscow,6942,7,6,6,8,19,25,-6,24
Rostov,6942,8,5,6,9,12,18,-6,21
FK Rubin,6942,9,5,5,10,22,20,2,20
Amkar,6942,10,4,5,11,10,25,-15,17
Anzhi,6942,11,2,6,12,18,42,-24,12
Loko Moscow,6943,1,11,5,4,31,15,16,38
Spart Moscow,6943,2,11,5,4,37,25,12,38
CSKA Moscow,6943,3,11,3,6,29,19,10,36
Zenit,6943,4,9,8,3,26,16,10,35
Krasnodar,6943,5,9,4,7,28,26,2,31
Terek Grozny,6943,6,7,6,7,23,28,-5,27
FK Rubin,6943,7,7,5,8,25,18,7,26
Din Moscow,6943,8,5,6,9,18,24,-6,21
Rostov,6943,9,4,6,10,10,18,-8,18
Amkar,6943,10,4,5,11,11,26,-15,17
Anzhi,6943,11,3,5,12,18,41,-23,14
Loko Moscow,6944,1,13,5,2,32,11,21,44
Spart Moscow,6944,2,11,5,4,40,27,13,38
CSKA Moscow,6944,3,11,3,6,28,20,8,36
Zenit,6944,4,8,8,4,22,15,7,32
Krasnodar,6944,5,9,4,7,29,25,4,31
Terek Grozny,6944,6,8,5,7,21,23,-2,29
Din Moscow,6944,7,6,6,8,19,23,-4,24
FK Rubin,6944,8,5,5,10,21,20,1,20
Amkar,6944,9,5,4,11,10,24,-14,19
Rostov,6944,10,4,6,10,11,20,-9,18
Anzhi,6944,11,2,5,13,16,41,-25,11
Loko Moscow,6945,1,12,5,3,33,13,20,41
CSKA Moscow,6945,2,12,3,5,28,17,11,39
Spart Moscow,6945,3,11,5,4,41,27,14,38
Krasnodar,6945,4,9,4,7,28,26,2,31
Zenit,6945,5,7,8,5,22,18,4,29
Terek Grozny,6945,6,7,5,8,20,25,-5,26
Din Moscow,6945,7,6,6,8,22,27,-5,24
FK Rubin,6945,8,6,5,9,24,20,4,23
Amkar,6945,9,5,4,11,10,23,-13,19
Rostov,6945,10,4,6,10,10,19,-9,18
Anzhi,6945,11,3,5,12,16,39,-23,14
Loko Moscow,6946,1,12,5,3,35,14,21,41
CSKA Moscow,6946,2,11,4,5,30,20,10,37
Spart Moscow,6946,3,9,7,4,38,29,9,34
Zenit,6946,4,8,9,3,25,16,9,33
Krasnodar,6946,5,8,5,7,28,29,-1,29
Terek Grozny,6946,6,8,5,7,21,26,-5,29
FK Rubin,6946,7,6,6,8,24,19,5,24
Din Moscow,6946,8,5,6,9,19,25,-6,21
Amkar,6946,9,5,5,10,14,23,-9,20
Rostov,6946,10,4,7,9,12,19,-7,19
Anzhi,6946,11,2,5,13,16,42,-26,11
Loko Moscow,6947,1,12,5,3,32,14,18,41
CSKA Moscow,6947,2,11,3,6,28,19,9,36
Krasnodar,6947,3,9,5,6,31,26,5,32
Spart Moscow,6947,4,8,7,5,35,29,6,31
Zenit,6947,5,7,8,5,21,17,4,29
Terek Grozny,6947,6,8,5,7,21,24,-3,29
Din Moscow,6947,7,7,6,7,23,23,0,27
FK Rubin,6947,8,5,6,9,24,22,2,21
Rostov,6947,9,4,7,9,11,18,-7,19
Amkar,6947,10,4,5,11,10,24,-14,17
Anzhi,6947,11,4,5,11,18,38,-20,17
Loko Moscow,6948,1,13,5,2,36,12,24,44
Spart Moscow,6948,2,10,6,4,40,28,12,36
CSKA Moscow,6948,3,10,4,6,26,19,7,34
Krasnodar,6948,4,9,4,7,31,29,2,31
Zenit,6948,5,7,9,4,21,16,5,30
Terek Grozny,6948,6,7,5,8,21,26,-5,26
FK Rubin,6948,7,6,5,9,24,21,3,23
Din Moscow,6948,8,5,6,9,19,27,-8,21
Rostov,6948,9,4,7,9,11,18,-7,19
Amkar,6948,10,5,4,11,12,24,-12,19
Anzhi,6948,11,4,5,11,18,39,-21,17
CSKA Moscow,6949,1,12,3,5,31,18,13,39
Loko Moscow,6949,2,11,5,4,29,17,12,38
Spart Moscow,6949,3,10,6,4,39,25,14,36
Krasnodar,6949,4,10,4,6,33,25,8,34
Zenit,6949,5,8,8,4,23,17,6,32
Terek Grozny,6949,6,7,6,7,23,28,-5,27
Din Moscow,6949,7,5,8,7,17,21,-4,23
FK Rubin,6949,8,5,6,9,22,19,3,21
Rostov,6949,9,4,6,10,10,20,-10,18
Amkar,6949,10,4,5,11,11,27,-16,17
Anzhi,6949,11,3,5,12,19,40,-21,14
Loko Moscow,6950,1,12,5,3,31,12,19,41
Spart Moscow,6950,2,10,6,4,39,28,11,36
CSKA Moscow,6950,3,11,3,6,27,19,8,36
Zenit,6950,4,8,8,4,23,16,7,32
Krasnodar,6950,5,9,5,6,28,24,4,32
Terek Grozny,6950,6,7,6,7,21,24,-3,27
FK Rubin,6950,7,6,6,8,23,17,6,24
Din Moscow,6950,8,5,7,8,20,26,-6,22
Amkar,6950,9,5,4,11,10,23,-13,19
Rostov,6950,10,4,6,10,10,19,-9,18
Anzhi,6950,11,2,6,12,15,39,-24,12
Loko Moscow,6951,1,12,6,2,34,13,21,42
CSKA Moscow,6951,2,11,3,6,29,21,8,36
Spart Moscow,6951,3,10,5,5,37,29,8,35
Zenit,6951,4,8,9,3,25,15,10,33
Terek Grozny,6951,5,8,6,6,22,23,-1,30
Krasnodar,6951,6,8,5,7,28,28,0,29
FK Rubin,6951,7,6,6,8,23,18,5,24
Din Moscow,6951,8,5,6,9,18,24,-6,21
Amkar,6951,9,5,5,10,13,24,-11,20
Rostov,6951,10,4,6,10,11,19,-8,18
Anzhi,6951,11,2,5,13,15,41,-26,11
Loko Moscow,6952,1,12,5,3,30,13,17,41
CSKA Moscow,6952,2,11,3,6,27,19,8,36
Zenit,6952,3,9,8,3,25,14,11,35
Spart Moscow,6952,4,10,5,5,37,29,8,35
Terek Grozny,6952,5,8,5,7,22,25,-3,29
Krasnodar,6952,6,8,4,8,28,28,0,28
Din Moscow,6952,7,6,7,7,21,23,-2,25
FK Rubin,6952,8,6,6,8,25,19,6,24
Amkar,6952,9,5,4,11,12,24,-12,19
Rostov,6952,10,4,6,10,10,18,-8,18
Anzhi,6952,11,2,5,13,15,40,-25,11
Loko Moscow,6953,1,12,6,2,34,14,20,42
CSKA Moscow,6953,2,11,3,6,27,19,8,36
Spart Moscow,6953,3,9,7,4,37,26,11,34
Zenit,6953,4,8,8,4,25,17,8,32
Krasnodar,6953,5,8,5,7,29,27,2,29
Terek Grozny,6953,6,7,6,7,20,26,-6,27
FK Rubin,6953,7,7,5,8,24,18,6,26
Din Moscow,6953,8,5,6,9,17,25,-8,21
Rostov,6953,9,4,7,9,10,17,-7,19
Amkar,6953,10,4,6,10,10,23,-13,18
Anzhi,6953,11,3,5,12,18,39,-21,14
CSKA Moscow,6954,1,12,3,5,32,17,15,39
Loko Moscow,6954,2,11,5,4,29,13,16,38
Spart Moscow,6954,3,10,6,4,37,27,10,36
Krasnodar,6954,4,10,4,6,30,25,5,34
Zenit,6954,5,8,8,4,22,17,5,32
Terek Grozny,6954,6,8,5,7,22,24,-2,29
Din Moscow,6954,7,6,6,8,18,22,-4,24
FK Rubin,6954,8,5,5,10,22,20,2,20
Amkar,6954,9,5,5,10,12,24,-12,20
Rostov,6954,10,4,6,10,10,18,-8,18
Anzhi,6954,11,2,5,13,15,42,-27,11
Loko Moscow,6955,1,11,7,2,32,14,18,40
CSKA Moscow,6955,2,12,3,5,30,18,12,39
Spart Moscow,6955,3,9,7,4,37,28,9,34
Zenit,6955,4,7,9,4,23,18,5,30
Krasnodar,6955,5,8,6,6,28,25,3,30
Terek Grozny,6955,6,8,6,6,25,26,-1,30
Din Moscow,6955,7,5,8,7,17,21,-4,23
FK Rubin,6955,8,5,7,8,21,17,4,22
Rostov,6955,9,4,7,9,12,19,-7,19
Amkar,6955,10,4,5,11,12,26,-14,17
Anzhi,6955,11,2,5,13,17,42,-25,11
Loko Moscow,6956,1,12,5,3,34,15,19,41
CSKA Moscow,6956,2,11,3,6,27,18,9,36
Spart Moscow,6956,3,9,6,5,37,28,9,33
Zenit,6956,4,8,8,4,23,17,6,32
Krasnodar,6956,5,9,4,7,30,28,2,31
Terek Grozny,6956,6,8,5,7,22,23,-1,29
Din Moscow,6956,7,6,7,7,19,21,-2,25
FK Rubin,6956,8,6,5,9,24,19,5,23
Amkar,6956,9,6,4,10,12,23,-11,22
Rostov,6956,10,4,6,10,11,20,-9,18
Anzhi,6956,11,2,5,13,14,41,-27,11
Loko Moscow,6957,1,13,5,2,33,11,22,44
CSKA Moscow,6957,2,11,4,5,27,18,9,37
Spart Moscow,6957,3,10,5,5,38,29,9,35
Zenit,6957,4,7,9,4,22,15,7,30
Terek Grozny,6957,5,8,5,7,23,24,-1,29
Krasnodar,6957,6,8,4,8,28,29,-1,28
FK Rubin,6957,7,7,5,8,24,18,6,26
Din Moscow,6957,8,6,6,8,19,22,-3,24
Rostov,6957,9,4,6,10,10,19,-9,18
Amkar,6957,10,4,4,12,11,27,-16,16
Anzhi,6957,11,3,5,12,16,39,-23,14
Loko Moscow,6958,1,12,6,2,32,13,19,42
CSKA Moscow,6958,2,11,4,5,29,17,12,37
Spart Moscow,6958,3,10,5,5,39,26,13,35
Krasnodar,6958,4,9,5,6,30,26,4,32
Zenit,6958,5,7,9,4,21,14,7,30
Terek Grozny,6958,6,7,6,7,21,25,-4,27
Din Moscow,6958,7,6,6,8,19,25,-6,24
Amkar,6958,8,6,4,10,12,22,-10,22
FK Rubin,6958,9,5,5,10,21,20,1,20
Rostov,6958,10,4,6,10,10,19,-9,18
Anzhi,6958,11,2,6,12,15,42,-27,12
Loko Moscow,6959,1,12,6,2,33,13,20,42
CSKA Moscow,6959,2,11,3,6,28,18,10,36
Spart Moscow,6959,3,9,7,4,37,26,11,34
Zenit,6959,4,8,9,3,23,14,9,33
Krasnodar,6959,5,9,4,7,30,28,2,31
Terek Grozny,6959,6,7,5,8,22,28,-6,26
FK Rubin,6959,7,6,5,9,25,21,4,23
Din Moscow,6959,8,5,6,9,19,27,-8,21
Amkar,6959,9,5,5,10,11,22,-11,20
Rostov,6959,10,4,7,9,11,18,-7,19
Anzhi,6959,11,3,5,12,18,42,-24,14
Loko Moscow,6960,1,11,5,4,30,17,13,38
CSKA Moscow,6960,2,10,4,6,27,20,7,34
Krasnodar,6960,3,10,4,6,31,25,6,34
Zenit,6960,4,8,9,3,26,14,12,33
Spart Moscow,6960,5,8,7,5,35,28,7,31
Terek Grozny,6960,6,7,5,8,22,26,-4,26
Din Moscow,6960,7,6,7,7,19,22,-3,25
Amkar,6960,8,6,4,10,13,24,-11,22
FK Rubin,6960,9,5,5,10,21,20,1,20
Rostov,6960,10,4,7,9,10,17,-7,19
Anzhi,6960,11,4,5,11,18,39,-21,17
Loko Moscow,6961,1,11,7,2,31,13,18,40
CSKA Moscow,6961,2,11,4,5,29,20,9,37
Spart Moscow,6961,3,10,6,4,40,29,11,36
Krasnodar,6961,4,9,5,6,31,27,4,32
Zenit,6961,5,7,10,3,24,16,8,31
Terek Grozny,6961,6,8,5,7,22,24,-2,29
Din Moscow,6961,7,5,7,8,22,28,-6,22
FK Rubin,6961,8,5,6,9,26,23,3,21
Rostov,6961,9,4,7,9,11,18,-7,19
Amkar,6961,10,4,4,12,10,26,-16,16
Anzhi,6961,11,3,5,12,17,39,-22,14
Loko Moscow,6962,1,11,7,2,31,13,18,40
CSKA Moscow,6962,2,12,3,5,28,18,10,39
Spart Moscow,6962,3,10,6,4,39,27,12,36
Zenit,6962,4,7,9,4,23,16,7,30
Krasnodar,6962,5,8,6,6,29,26,3,30
Terek Grozny,6962,6,7,5,8,21,25,-4,26
FK Rubin,6962,7,5,7,8,23,19,4,22
Din Moscow,6962,8,5,7,8,18,23,-5,22
Amkar,6962,9,5,5,10,11,23,-12,20
Rostov,6962,10,4,6,10,11,21,-10,18
Anzhi,6962,11,3,5,12,16,39,-23,14
Loko Moscow,6963,1,12,5,3,32,12,20,41
Spart Moscow,6963,2,11,5,4,41,28,13,38
CSKA Moscow,6963,3,10,4,6,25,19,6,34
Krasnodar,6963,4,9,5,6,28,24,4,32
Terek Grozny,6963,5,9,5,6,23,23,0,32
Zenit,6963,6,7,9,4,21,16,5,30
FK Rubin,6963,7,6,6,8,24,17,7,24
Din Moscow,6963,8,5,6,9,18,26,-8,21
Rostov,6963,9,4,6,10,10,18,-8,18
Amkar,6963,10,4,4,12,12,29,-17,16
Anzhi,6963,11,3,5,12,16,38,-22,14
Loko Moscow,6964,1,12,5,3,31,13,18,41
Spart Moscow,6964,2,11,5,4,40,28,12,38
CSKA Moscow,6964,3,11,4,5,27,18,9,37
Krasnodar,6964,4,9,5,6,29,25,4,32
Zenit,6964,5,7,8,5,22,16,6,29
Terek Grozny,6964,6,8,5,7,22,24,-2,29
FK Rubin,6964,7,6,6,8,25,20,5,24
Din Moscow,6964,8,5,6,9,19,25,-6,21
Rostov,6964,9,4,6,10,12,21,-9,18
Amkar,6964,10,4,4,12,10,25,-15,16
Anzhi,6964,11,3,6,11,17,39,-22,15
Loko Moscow,6965,1,11,6,3,31,14,17,39
CSKA Moscow,6965,2,11,3,6,27,19,8,36
Zenit,6965,3,9,8,3,25,15,10,35
Spart Moscow,6965,4,9,7,4,38,29,9,34
Krasnodar,6965,5,9,5,6,30,25,5,32
Terek Grozny,6965,6,7,7,6,22,24,-2,28
Din Moscow,6965,7,5,8,7,19,23,-4,23
FK Rubin,6965,8,5,6,9,22,20,2,21
Rostov,6965,9,4,7,9,12,19,-7,19
Amkar,6965,10,4,5,11,11,25,-14,17
Anzhi,6965,11,2,6,12,15,39,-24,12
Loko Moscow,6966,1,11,6,3,29,12,17,39
Spart Moscow,6966,2,10,6,4,38,27,11,36
CSKA Moscow,6966,3,11,3,6,31,20,11,36
Zenit,6966,4,9,8,3,25,15,10,35
Terek Grozny,6966,5,9,5,6,23,23,0,32
Krasnodar,6966,6,8,6,6,27,24,3,30
Din Moscow,6966,7,6,6,8,21,25,-4,24
FK Rubin,6966,8,5,6,9,24,21,3,21
Rostov,6966,9,4,6,10,10,19,-9,18
Amkar,6966,10,4,5,11,11,25,-14,17
Anzhi,6966,11,2,5,13,15,43,-28,11
Loko Moscow,6967,1,12,6,2,33,14,19,42
CSKA Moscow,6967,2,11,4,5,27,18,9,37
Spart Moscow,6967,3,9,6,5,38,28,10,33
Terek Grozny,6967,4,8,6,6,23,24,-1,30
Zenit,6967,5,7,8,5,23,17,6,29
Krasnodar,6967,6,8,5,7,29,28,1,29
Din Moscow,6967,7,6,7,7,20,23,-3,25
FK Rubin,6967,8,6,6,8,25,19,6,24
Rostov,6967,9,4,6,10,10,20,-10,18
Amkar,6967,10,4,6,10,11,24,-13,18
Anzhi,6967,11,2,6,12,16,40,-24,12
Loko Moscow,6968,1,13,5,2,32,12,20,44
CSKA Moscow,6968,2,12,3,5,28,17,11,39
Spart Moscow,6968,3,9,6,5,37,31,6,33
Terek Grozny,6968,4,9,5,6,25,24,1,32
Zenit,6968,5,7,8,5,21,15,6,29
Krasnodar,6968,6,8,5,7,29,27,2,29
Din Moscow,6968,7,6,6,8,21,23,-2,24
FK Rubin,6968,8,5,6,9,22,21,1,21
Rostov,6968,9,4,7,9,11,18,-7,19
Amkar,6968,10,5,4,11,14,25,-11,19
Anzhi,6968,11,2,5,13,15,42,-27,11
Loko Moscow,6969,1,12,6,2,30,11,19,42
CSKA Moscow,6969,2,11,3,6,29,22,7,36
Zenit,6969,3,8,9,3,23,13,10,33
Spart Moscow,6969,4,9,6,5,37,29,8,33
Terek Grozny,6969,5,8,6,6,22,22,0,30
Krasnodar,6969,6,8,4,8,28,27,1,28
FK Rubin,6969,7,7,5,8,27,18,9,26
Din Moscow,6969,8,5,7,8,20,28,-8,22
Amkar,6969,9,5,4,11,10,24,-14,19
Rostov,6969,10,4,6,10,10,18,-8,18
Anzhi,6969,11,2,6,12,17,41,-24,12
Loko Moscow,6970,1,12,6,2,31,12,19,42
CSKA Moscow,6970,2,11,3,6,28,20,8,36
Zenit,6970,3,8,8,4,23,15,8,32
Spart Moscow,6970,4,9,5,6,37,30,7,32
Krasnodar,6970,5,8,5,7,29,27,2,29
Terek Grozny,6970,6,8,5,7,22,24,-2,29
FK Rubin,6970,7,7,5,8,25,18,7,26
Rostov,6970,8,5,6,9,12,18,-6,21
Din Moscow,6970,9,5,6,9,18,25,-7,21
Amkar,6970,10,5,4,11,12,25,-13,19
Anzhi,6970,11,3,5,12,16,39,-23,14
Loko Moscow,6971,1,12,6,2,33,12,21,42
CSKA Moscow,6971,2,11,3,6,27,19,8,36
Spart Moscow,6971,3,9,7,4,37,27,10,34
Zenit,6971,4,8,9,3,24,14,10,33
Krasnodar,6971,5,8,5,7,28,28,0,29
Terek Grozny,6971,6,7,7,6,22,24,-2,28
Din Moscow,6971,7,5,8,7,19,23,-4,23
FK Rubin,6971,8,5,7,8,23,19,4,22
Rostov,6971,9,4,7,9,11,18,-7,19
Amkar,6971,10,4,5,11,11,26,-15,17
Anzhi,6971,11,2,6,12,14,39,-25,12
Loko Moscow,6972,1,12,5,3,32,12,20,41
CSKA Moscow,6972,2,11,4,5,26,17,9,37
Krasnodar,6972,3,10,4,6,30,24,6,34
Zenit,6972,4,7,9,4,21,16,5,30
Spart Moscow,6972,5,8,6,6,34,32,2,30
Terek Grozny,6972,6,7,6,7,20,23,-3,27
Din Moscow,6972,7,6,6,8,21,22,-1,24
FK Rubin,6972,8,6,5,9,22,19,3,23
Amkar,6972,9,5,5,10,11,22,-11,20
Rostov,6972,10,4,7,9,11,18,-7,19
Anzhi,6972,11,3,5,12,15,38,-23,14
Loko Moscow,6973,1,12,5,3,32,13,19,41
Spart Moscow,6973,2,11,5,4,37,25,12,38
CSKA Moscow,6973,3,10,3,7,27,22,5,33
Zenit,6973,4,8,8,4,23,15,8,32
Krasnodar,6973,5,9,5,6,30,26,4,32
Terek Grozny,6973,6,8,5,7,21,24,-3,29
Din Moscow,6973,7,6,6,8,20,23,-3,24
FK Rubin,6973,8,5,6,9,22,21,1,21
Amkar,6973,9,5,4,11,11,23,-12,19
Rostov,6973,10,4,6,10,10,18,-8,18
Anzhi,6973,11,3,5,12,17,40,-23,14
Loko Moscow,6974,1,11,6,3,29,14,15,39
CSKA Moscow,6974,2,11,3,6,29,19,10,36
Zenit,6974,3,8,9,3,23,13,10,33
Spart Moscow,6974,4,8,7,5,36,29,7,31
Krasnodar,6974,5,9,4,7,32,28,4,31
Terek Grozny,6974,6,7,6,7,20,23,-3,27
Din Moscow,6974,7,6,7,7,19,22,-3,25
FK Rubin,6974,8,6,6,8,26,20,6,24
Rostov,6974,9,4,7,9,11,18,-7,19
Amkar,6974,10,4,6,10,11,24,-13,18
Anzhi,6974,11,3,5,12,15,41,-26,14
Loko Moscow,6975,1,12,6,2,33,12,21,42
Spart Moscow,6975,2,10,5,5,39,30,9,35
CSKA Moscow,6975,3,10,4,6,25,21,4,34
Zenit,6975,4,8,8,4,25,16,9,32
Krasnodar,6975,5,9,5,6,29,25,4,32
Terek Grozny,6975,6,8,5,7,24,26,-2,29
Din Moscow,6975,7,6,6,8,19,22,-3,24
FK Rubin,6975,8,6,5,9,22,18,4,23
Amkar,6975,9,5,4,11,14,27,-13,19
Rostov,6975,10,4,6,10,10,19,-9,18
Anzhi,6975,11,2,6,12,16,40,-24,12
Loko Moscow,6976,1,13,5,2,32,12,20,44
CSKA Moscow,6976,2,10,4,6,28,21,7,34
Spart Moscow,6976,3,9,6,5,37,28,9,33
Zenit,6976,4,8,8,4,24,16,8,32
Terek Grozny,6976,5,8,6,6,22,23,-1,30
Krasnodar,6976,6,8,4,8,29,28,1,28
FK Rubin,6976,7,6,6,8,23,18,5,24
Din Moscow,6976,8,5,8,7,18,22,-4,23
Amkar,6976,9,5,4,11,11,24,-13,19
Rostov,6976,10,4,6,10,10,19,-9,18
Anzhi,6976,11,2,7,11,16,39,-23,13
Loko Moscow,6977,1,13,5,2,32,11,21,44
CSKA Moscow,6977,2,12,3,5,28,17,11,39
Spart Moscow,6977,3,10,6,4,39,26,13,36
Terek Grozny,6977,4,9,5,6,23,22,1,32
Krasnodar,6977,5,9,4,7,29,27,2,31
Zenit,6977,6,7,8,5,21,15,6,29
Din Moscow,6977,7,6,6,8,19,25,-6,24
FK Rubin,6977,8,5,5,10,23,21,2,20
Rostov,6977,9,4,6,10,10,19,-9,18
Amkar,6977,10,4,5,11,10,24,-14,17
Anzhi,6977,11,2,5,13,14,41,-27,11
Loko Moscow,6978,1,12,5,3,31,13,18,41
Spart Moscow,6978,2,11,5,4,41,26,15,38
Krasnodar,6978,3,10,4,6,30,25,5,34
CSKA Moscow,6978,4,10,3,7,25,22,3,33
Zenit,6978,5,8,8,4,25,14,11,32
Terek Grozny,6978,6,7,6,7,21,24,-3,27
FK Rubin,6978,7,6,5,9,23,19,4,23
Din Moscow,6978,8,5,6,9,18,27,-9,21
Rostov,6978,9,4,6,10,10,19,-9,18
Amkar,6978,10,4,5,11,11,25,-14,17
Anzhi,6978,11,4,5,11,16,37,-21,17
Loko Moscow,6979,1,12,6,2,30,11,19,42
CSKA Moscow,6979,2,11,4,5,27,18,9,37
Zenit,6979,3,7,10,3,22,14,8,31
Spart Moscow,6979,4,8,7,5,35,28,7,31
Terek Grozny,6979,5,8,5,7,25,26,-1,29
Krasnodar,6979,6,8,4,8,28,27,1,28
FK Rubin,6979,7,6,6,8,23,18,5,24
Din Moscow,6979,8,5,8,7,18,22,-4,23
Rostov,6979,9,4,7,9,11,18,-7,19
Amkar,6979,10,5,4,11,12,26,-14,19
Anzhi,6979,11,3,5,12,16,39,-23,14
Loko Moscow,6980,1,11,6,3,30,15,15,39
CSKA Moscow,6980,2,10,5,5,27,19,8,35
Spart Moscow,6980,3,9,7,4,37,28,9,34
Zenit,6980,4,8,9,3,24,13,11,33
Krasnodar,6980,5,8,6,6,29,26,3,30
Terek Grozny,6980,6,8,5,7,22,25,-3,29
FK Rubin,6980,7,5,7,8,22,18,4,22
Din Moscow,6980,8,5,7,8,17,22,-5,22
Rostov,6980,9,4,7,9,12,19,-7,19
Amkar,6980,10,4,5,11,10,24,-14,17
Anzhi,6980,11,3,6,11,19,40,-21,15
Loko Moscow,6981,1,12,5,3,31,13,18,41
Spart Moscow,6981,2,10,5,5,37,27,10,35
CSKA Moscow,6981,3,10,4,6,26,20,6,34
Zenit,6981,4,8,8,4,23,15,8,32
Krasnodar,6981,5,9,4,7,32,29,3,31
Terek Grozny,6981,6,7,5,8,21,28,-7,26
Din Moscow,6981,7,6,6,8,19,23,-4,24
FK Rubin,6981,8,6,5,9,26,21,5,23
Amkar,6981,9,6,4,10,12,22,-10,22
Rostov,6981,10,4,6,10,10,19,-9,18
Anzhi,6981,11,3,6,11,19,39,-20,15
Loko Moscow,6982,1,11,6,3,30,13,17,39
CSKA Moscow,6982,2,12,3,5,32,20,12,39
Spart Moscow,6982,3,10,5,5,38,30,8,35
Krasnodar,6982,4,10,4,6,32,27,5,34
Zenit,6982,5,7,9,4,21,14,7,30
Terek Grozny,6982,6,8,6,6,22,23,-1,30
Din Moscow,6982,7,6,6,8,21,25,-4,24
FK Rubin,6982,8,6,5,9,27,21,6,23
Rostov,6982,9,4,6,10,10,19,-9,18
Amkar,6982,10,4,5,11,11,25,-14,17
Anzhi,6982,11,2,5,13,18,45,-27,11
Loko Moscow,6983,1,12,6,2,33,14,19,42
CSKA Moscow,6983,2,11,4,5,26,17,9,37
Krasnodar,6983,3,9,5,6,32,27,5,32
Terek Grozny,6983,4,9,5,6,24,23,1,32
Zenit,6983,5,7,9,4,22,15,7,30
Spart Moscow,6983,6,8,5,7,34,30,4,29
Din Moscow,6983,7,6,7,7,20,22,-2,25
FK Rubin,6983,8,5,6,9,22,20,2,21
Rostov,6983,9,5,6,9,11,17,-6,21
Amkar,6983,10,5,4,11,11,25,-14,19
Anzhi,6983,11,2,5,13,14,39,-25,11
Loko Moscow,6984,1,12,5,3,30,12,18,41
CSKA Moscow,6984,2,12,3,5,31,19,12,39
Spart Moscow,6984,3,10,6,4,37,26,11,36
Zenit,6984,4,8,8,4,24,17,7,32
Krasnodar,6984,5,9,4,7,30,25,5,31
Terek Grozny,6984,6,7,5,8,20,24,-4,26
Din Moscow,6984,7,6,7,7,19,22,-3,25
FK Rubin,6984,8,5,5,10,21,21,0,20
Amkar,6984,9,5,4,11,10,24,-14,19
Rostov,6984,10,4,6,10,10,18,-8,18
Anzhi,6984,11,3,5,12,15,39,-24,14
Loko Moscow,6985,1,12,5,3,30,12,18,41
Zenit,6985,2,9,8,3,23,13,10,35
CSKA Moscow,6985,3,10,4,6,27,20,7,34
Spart Moscow,6985,4,9,6,5,36,28,8,33
Terek Grozny,6985,5,9,5,6,25,24,1,32
Krasnodar,6985,6,8,5,7,28,26,2,29
FK Rubin,6985,7,6,6,8,24,18,6,24
Din Moscow,6985,8,5,6,9,17,24,-7,21
Rostov,6985,9,4,7,9,11,18,-7,19
Amkar,6985,10,5,4,11,12,25,-13,19
Anzhi,6985,11,2,6,12,17,42,-25,12
Loko Moscow,6986,1,12,5,3,32,14,18,41
Spart Moscow,6986,2,10,6,4,40,29,11,36
CSKA Moscow,6986,3,10,4,6,26,19,7,34
Krasnodar,6986,4,9,5,6,31,27,4,32
Zenit,6986,5,7,9,4,21,14,7,30
Terek Grozny,6986,6,7,5,8,21,27,-6,26
FK Rubin,6986,7,5,7,8,23,19,4,22
Din Moscow,6986,8,5,7,8,20,26,-6,22
Amkar,6986,9,5,5,10,14,24,-10,20
Rostov,6986,10,4,6,10,11,19,-8,18
Anzhi,6986,11,4,5,11,17,38,-21,17
Loko Moscow,6987,1,12,5,3,33,13,20,41
CSKA Moscow,6987,2,11,3,6,29,20,9,36
Zenit,6987,3,9,8,3,26,15,11,35
Spart Moscow,6987,4,9,6,5,34,26,8,33
Krasnodar,6987,5,9,4,7,31,27,4,31
Terek Grozny,6987,6,7,6,7,22,26,-4,27
FK Rubin,6987,7,6,5,9,23,22,1,23
Din Moscow,6987,8,5,7,8,18,23,-5,22
Amkar,6987,9,5,5,10,10,22,-12,20
Rostov,6987,10,4,6,10,10,18,-8,18
Anzhi,6987,11,3,5,12,18,42,-24,14
Loko Moscow,6988,1,13,5,2,33,11,22,44
Spart Moscow,6988,2,10,6,4,38,28,10,36
CSKA Moscow,6988,3,11,3,6,29,20,9,36
Krasnodar,6988,4,9,4,7,29,27,2,31
Zenit,6988,5,7,8,5,23,18,5,29
Terek Grozny,6988,6,7,6,7,20,23,-3,27
FK Rubin,6988,7,6,5,9,23,19,4,23
Din Moscow,6988,8,5,7,8,19,25,-6,22
Amkar,6988,9,5,4,11,11,24,-13,19
Rostov,6988,10,4,6,10,10,18,-8,18
Anzhi,6988,11,3,6,11,15,37,-22,15
Loko Moscow,6989,1,11,6,3,33,16,17,39
CSKA Moscow,6989,2,11,3,6,28,20,8,36
Spart Moscow,6989,3,9,7,4,38,28,10,34
Krasnodar,6989,4,9,5,6,30,26,4,32
Zenit,6989,5,7,9,4,25,19,6,30
Terek Grozny,6989,6,7,6,7,24,27,-3,27
Din Moscow,6989,7,6,6,8,21,24,-3,24
FK Rubin,6989,8,5,6,9,22,21,1,21
Amkar,6989,9,5,5,10,11,23,-12,20
Rostov,6989,10,4,7,9,12,19,-7,19
Anzhi,6989,11,3,6,11,19,40,-21,15
Loko Moscow,6990,1,13,5,2,32,11,21,44
Spart Moscow,6990,2,11,5,4,41,25,16,38
CSKA Moscow,6990,3,11,4,5,29,18,11,37
Krasnodar,6990,4,9,4,7,28,25,3,31
Zenit,6990,5,7,9,4,22,16,6,30
Terek Grozny,6990,6,7,7,6,20,22,-2,28
Din Moscow,6990,7,6,6,8,19,22,-3,24
FK Rubin,6990,8,5,5,10,21,20,1,20
Rostov,6990,9,4,6,10,10,20,-10,18
Amkar,6990,10,4,5,11,9,26,-17,17
Anzhi,6990,11,2,6,12,14,40,-26,12
Loko Moscow,6991,1,12,5,3,30,12,18,41
CSKA Moscow,6991,2,10,4,6,25,18,7,34
Spart Moscow,6991,3,8,8,4,37,29,8,32
Zenit,6991,4,8,8,4,22,14,8,32
Krasnodar,6991,5,9,4,7,30,29,1,31
FK Rubin,6991,6,7,5,8,31,20,11,26
Terek Grozny,6991,7,7,5,8,20,24,-4,26
Din Moscow,6991,8,5,7,8,18,26,-8,22
Amkar,6991,9,5,5,10,12,24,-12,20
Rostov,6991,10,4,7,9,12,19,-7,19
Anzhi,6991,11,3,6,11,15,37,-22,15
Loko Moscow,6992,1,12,5,3,33,14,19,41
CSKA Moscow,6992,2,11,3,6,27,20,7,36
Spart Moscow,6992,3,9,6,5,36,28,8,33
Zenit,6992,4,8,8,4,24,17,7,32
Krasnodar,6992,5,9,5,6,30,25,5,32
Terek Grozny,6992,6,9,5,6,24,22,2,32
FK Rubin,6992,7,6,6,8,25,18,7,24
Din Moscow,6992,8,5,7,8,18,25,-7,22
Rostov,6992,9,5,6,9,12,17,-5,21
Amkar,6992,10,4,4,12,9,26,-17,16
Anzhi,6992,11,2,5,13,15,41,-26,11
Loko Moscow,6993,1,11,5,4,30,16,14,38
Spart Moscow,6993,2,10,5,5,39,29,10,35
Zenit,6993,3,9,8,3,24,14,10,35
CSKA Moscow,6993,4,10,3,7,25,20,5,33
Krasnodar,6993,5,9,4,7,30,26,4,31
Terek Grozny,6993,6,8,5,7,24,27,-3,29
FK Rubin,6993,7,7,5,8,24,17,7,26
Amkar,6993,8,6,4,10,14,23,-9,22
Din Moscow,6993,9,5,6,9,18,24,-6,21
Rostov,6993,10,4,6,10,11,20,-9,18
Anzhi,6993,11,3,5,12,18,41,-23,14
Loko Moscow,6994,1,12,6,2,31,12,19,42
CSKA Moscow,6994,2,11,4,5,28,18,10,37
Terek Grozny,6994,3,9,5,6,24,23,1,32
Zenit,6994,4,7,9,4,23,16,7,30
Spart Moscow,6994,5,8,6,6,37,31,6,30
Krasnodar,6994,6,8,6,6,27,24,3,30
FK Rubin,6994,7,6,6,8,22,17,5,24
Din Moscow,6994,8,6,6,8,20,24,-4,24
Rostov,6994,9,4,7,9,12,19,-7,19
Amkar,6994,10,5,4,11,10,24,-14,19
Anzhi,6994,11,2,5,13,15,41,-26,11
Loko Moscow,6995,1,11,7,2,31,13,18,40
Zenit,6995,2,8,9,3,22,13,9,33
Spart Moscow,6995,3,9,6,5,35,27,8,33
CSKA Moscow,6995,4,10,3,7,27,22,5,33
Krasnodar,6995,5,9,5,6,31,27,4,32
Terek Grozny,6995,6,7,6,7,22,26,-4,27
Din Moscow,6995,7,6,6,8,20,23,-3,24
Rostov,6995,8,5,6,9,11,17,-6,21
FK Rubin,6995,9,5,5,10,22,21,1,20
Amkar,6995,10,4,6,10,10,23,-13,18
Anzhi,6995,11,4,5,11,21,40,-19,17
Loko Moscow,6996,1,11,6,3,30,14,16,39
Spart Moscow,6996,2,11,5,4,40,28,12,38
CSKA Moscow,6996,3,11,4,5,29,19,10,37
Krasnodar,6996,4,9,5,6,29,24,5,32
Zenit,6996,5,7,10,3,23,15,8,31
Terek Grozny,6996,6,8,5,7,22,23,-1,29
Din Moscow,6996,7,6,6,8,19,23,-4,24
FK Rubin,6996,8,5,6,9,21,18,3,21
Amkar,6996,9,5,4,11,11,24,-13,19
Rostov,6996,10,4,6,10,11,20,-9,18
Anzhi,6996,11,2,5,13,15,42,-27,11
Loko Moscow,6997,1,12,6,2,33,13,20,42
Spart Moscow,6997,2,11,5,4,41,28,13,38
CSKA Moscow,6997,3,11,3,6,26,19,7,36
Zenit,6997,4,7,9,4,22,15,7,30
Terek Grozny,6997,5,8,6,6,22,23,-1,30
Krasnodar,6997,6,8,5,7,29,28,1,29
FK Rubin,6997,7,6,6,8,23,18,5,24
Din Moscow,6997,8,5,6,9,19,25,-6,21
Rostov,6997,9,4,6,10,10,20,-10,18
Amkar,6997,10,4,5,11,10,24,-14,17
Anzhi,6997,11,3,5,12,17,39,-22,14
Loko Moscow,6998,1,11,7,2,30,12,18,40
CSKA Moscow,6998,2,11,4,5,28,18,10,37
Spart Moscow,6998,3,9,7,4,37,27,10,34
Zenit,6998,4,7,10,3,22,14,8,31
Krasnodar,6998,5,8,6,6,28,25,3,30
Terek Grozny,6998,6,7,5,8,22,27,-5,26
Din Moscow,6998,7,6,7,7,21,22,-1,25
FK Rubin,6998,8,5,6,9,21,20,1,21
Rostov,6998,9,4,7,9,11,18,-7,19
Amkar,6998,10,5,4,11,11,25,-14,19
Anzhi,6998,11,3,5,12,17,40,-23,14
Loko Moscow,6999,1,12,6,2,32,13,19,42
Spart Moscow,6999,2,11,5,4,38,27,11,38
CSKA Moscow,6999,3,10,5,5,27,19,8,35
Krasnodar,6999,4,9,5,6,29,25,4,32
Terek Grozny,6999,5,9,5,6,25,23,2,32
Zenit,6999,6,7,9,4,22,15,7,30
Din Moscow,6999,7,6,6,8,21,25,-4,24
FK Rubin,6999,8,5,5,10,22,20,2,20
Rostov,6999,9,4,6,10,10,18,-8,18
Amkar,6999,10,4,4,12,9,25,-16,16
Anzhi,6999,11,2,6,12,17,42,-25,12
Loko Moscow,7000,1,12,6,2,34,13,21,42
Zenit,7000,2,8,9,3,25,15,10,33
CSKA Moscow,7000,3,10,3,7,26,21,5,33
Spart Moscow,7000,4,9,5,6,38,29,9,32
Krasnodar,7000,5,9,4,7,29,28,1,31
Terek Grozny,7000,6,7,5,8,20,29,-9,26
FK Rubin,7000,7,6,5,9,26,18,8,23
Amkar,7000,8,6,4,10,13,23,-10,22
Rostov,7000,9,5,6,9,11,17,-6,21
Din Moscow,7000,10,5,6,9,18,30,-12,21
Anzhi,7000,11,4,5,11,20,37,-17,17
Loko Moscow,7001,1,11,6,3,31,15,16,39
CSKA Moscow,7001,2,12,3,5,32,20,12,39
Spart Moscow,7001,3,9,7,4,36,27,9,34
Zenit,7001,4,8,8,4,24,15,9,32
Krasnodar,7001,5,8,6,6,31,28,3,30
Terek Grozny,7001,6,7,6,7,22,27,-5,27
Din Moscow,7001,7,6,7,7,20,23,-3,25
FK Rubin,7001,8,5,6,9,23,20,3,21
Rostov,7001,9,4,7,9,10,17,-7,19
Amkar,7001,10,4,5,11,11,25,-14,17
Anzhi,7001,11,3,5,12,19,42,-23,14
Loko Moscow,7002,1,11,6,3,29,12,17,39
CSKA Moscow,7002,2,11,3,6,26,21,5,36
Zenit,7002,3,9,8,3,26,13,13,35
Spart Moscow,7002,4,9,7,4,39,29,10,34
Krasnodar,7002,5,8,6,6,28,25,3,30
Terek Grozny,7002,6,7,7,6,22,24,-2,28
Din Moscow,7002,7,5,8,7,20,24,-4,23
FK Rubin,7002,8,5,7,8,22,18,4,22
Rostov,7002,9,4,7,9,10,17,-7,19
Amkar,7002,10,4,5,11,11,26,-15,17
Anzhi,7002,11,2,6,12,15,39,-24,12
Loko Moscow,7003,1,12,5,3,33,13,20,41
Spart Moscow,7003,2,10,5,5,35,26,9,35
CSKA Moscow,7003,3,10,5,5,26,18,8,35
Krasnodar,7003,4,9,4,7,29,27,2,31
Zenit,7003,5,7,9,4,21,16,5,30
Terek Grozny,7003,6,8,5,7,22,23,-1,29
Din Moscow,7003,7,6,7,7,18,21,-3,25
FK Rubin,7003,8,6,6,8,23,17,6,24
Rostov,7003,9,4,6,10,10,18,-8,18
Amkar,7003,10,4,4,12,9,25,-16,16
Anzhi,7003,11,3,6,11,16,38,-22,15
Loko Moscow,7004,1,11,7,2,31,13,18,40
CSKA Moscow,7004,2,12,3,5,29,18,11,39
Spart Moscow,7004,3,11,5,4,42,28,14,38
Krasnodar,7004,4,9,5,6,29,25,4,32
Zenit,7004,5,7,9,4,23,17,6,30
Terek Grozny,7004,6,8,6,6,22,23,-1,30
FK Rubin,7004,7,6,5,9,23,18,5,23
Din Moscow,7004,8,5,6,9,18,25,-7,21
Rostov,7004,9,4,6,10,12,21,-9,18
Amkar,7004,10,4,4,12,10,27,-17,16
Anzhi,7004,11,2,6,12,14,38,-24,12
Loko Moscow,7005,1,11,7,2,30,12,18,40
CSKA Moscow,7005,2,10,4,6,27,20,7,34
Zenit,7005,3,8,9,3,23,14,9,33
Spart Moscow,7005,4,9,5,6,35,29,6,32
Krasnodar,7005,5,9,5,6,29,24,5,32
Din Moscow,7005,6,7,6,7,22,24,-2,27
Terek Grozny,7005,7,7,6,7,21,25,-4,27
FK Rubin,7005,8,5,5,10,23,22,1,20
Amkar,7005,9,5,5,10,12,23,-11,20
Rostov,7005,10,4,6,10,10,18,-8,18
Anzhi,7005,11,3,6,11,18,39,-21,15
Loko Moscow,7006,1,12,5,3,32,15,17,41
Spart Moscow,7006,2,10,5,5,38,29,9,35
CSKA Moscow,7006,3,10,3,7,25,19,6,33
Zenit,7006,4,8,8,4,23,15,8,32
Krasnodar,7006,5,9,4,7,31,29,2,31
Terek Grozny,7006,6,7,6,7,21,25,-4,27
FK Rubin,7006,7,7,5,8,28,19,9,26
Din Moscow,7006,8,6,6,8,20,25,-5,24
Rostov,7006,9,4,6,10,11,19,-8,18
Amkar,7006,10,4,5,11,11,25,-14,17
Anzhi,7006,11,4,5,11,17,37,-20,17
Loko Moscow,7007,1,13,5,2,34,12,22,44
CSKA Moscow,7007,2,11,3,6,28,18,10,36
Spart Moscow,7007,3,10,5,5,42,28,14,35
Zenit,7007,4,8,8,4,23,16,7,32
Terek Grozny,7007,5,8,5,7,23,26,-3,29
Krasnodar,7007,6,8,4,8,27,27,0,28
FK Rubin,7007,7,6,6,8,23,18,5,24
Din Moscow,7007,8,5,7,8,18,26,-8,22
Rostov,7007,9,5,6,9,12,18,-6,21
Amkar,7007,10,5,4,11,13,26,-13,19
Anzhi,7007,11,2,5,13,15,43,-28,11
Loko Moscow,7008,1,12,6,2,33,13,20,42
Spart Moscow,7008,2,9,6,5,38,29,9,33
Zenit,7008,3,8,9,3,23,14,9,33
CSKA Moscow,7008,4,10,3,7,26,22,4,33
Krasnodar,7008,5,8,4,8,30,30,0,28
Terek Grozny,7008,6,7,6,7,21,24,-3,27
FK Rubin,7008,7,7,5,8,26,19,7,26
Rostov,7008,8,5,6,9,12,18,-6,21
Din Moscow,7008,9,5,6,9,19,27,-8,21
Amkar,7008,10,4,6,10,10,23,-13,18
Anzhi,7008,11,4,5,11,19,38,-19,17
Loko Moscow,7009,1,12,6,2,34,15,19,42
CSKA Moscow,7009,2,10,5,5,29,21,8,35
Zenit,7009,3,7,9,4,23,16,7,30
Spart Moscow,7009,4,8,6,6,33,28,5,30
Terek Grozny,7009,5,8,6,6,23,24,-1,30
Krasnodar,7009,6,8,5,7,30,29,1,29
FK Rubin,7009,7,6,6,8,23,17,6,24
Din Moscow,7009,8,5,8,7,17,21,-4,23
Rostov,7009,9,5,6,9,11,17,-6,21
Amkar,7009,10,5,5,10,13,24,-11,20
Anzhi,7009,11,2,6,12,17,41,-24,12
Loko Moscow,7010,1,12,5,3,31,12,19,41
CSKA Moscow,7010,2,12,3,5,29,18,11,39
Spart Moscow,7010,3,9,5,6,37,29,8,32
Zenit,7010,4,8,8,4,23,15,8,32
Krasnodar,7010,5,9,4,7,30,28,2,31
Terek Grozny,7010,6,8,5,7,22,25,-3,29
Din Moscow,7010,7,7,6,7,21,21,0,27
Amkar,7010,8,6,4,10,14,24,-10,22
FK Rubin,7010,9,5,5,10,23,23,0,20
Rostov,7010,10,4,6,10,10,19,-9,18
Anzhi,7010,11,2,5,13,15,41,-26,11
Loko Moscow,7011,1,12,5,3,32,14,18,41
CSKA Moscow,7011,2,11,3,6,28,20,8,36
Krasnodar,7011,3,10,4,6,29,24,5,34
Spart Moscow,7011,4,8,6,6,34,28,6,30
Terek Grozny,7011,5,8,6,6,22,23,-1,30
Zenit,7011,6,7,8,5,24,18,6,29
Din Moscow,7011,7,6,7,7,20,23,-3,25
Rostov,7011,8,5,6,9,11,17,-6,21
FK Rubin,7011,9,5,5,10,22,20,2,20
Amkar,7011,10,5,5,10,10,22,-12,20
Anzhi,7011,11,3,5,12,17,40,-23,14
Loko Moscow,7012,1,12,5,3,30,12,18,41
Spart Moscow,7012,2,10,6,4,43,30,13,36
CSKA Moscow,7012,3,10,5,5,25,17,8,35
Krasnodar,7012,4,10,4,6,32,24,8,34
Zenit,7012,5,7,9,4,21,14,7,30
Terek Grozny,7012,6,7,5,8,20,24,-4,26
Din Moscow,7012,7,5,8,7,20,24,-4,23
FK Rubin,7012,8,5,6,9,22,22,0,21
Amkar,7012,9,5,4,11,13,26,-13,19
Rostov,7012,10,4,6,10,10,21,-11,18
Anzhi,7012,11,3,6,11,15,37,-22,15
Loko Moscow,7013,1,12,5,3,35,14,21,41
CSKA Moscow,7013,2,12,3,5,28,17,11,39
Spart Moscow,7013,3,10,6,4,38,26,12,36
Krasnodar,7013,4,9,5,6,30,26,4,32
Terek Grozny,7013,5,9,5,6,25,23,2,32
Zenit,7013,6,7,8,5,22,19,3,29
Din Moscow,7013,7,6,6,8,18,23,-5,24
FK Rubin,7013,8,5,6,9,22,19,3,21
Rostov,7013,9,4,6,10,10,19,-9,18
Amkar,7013,10,4,5,11,11,26,-15,17
Anzhi,7013,11,2,5,13,14,41,-27,11
Loko Moscow,7014,1,12,6,2,31,11,20,42
CSKA Moscow,7014,2,11,4,5,29,20,9,37
Spart Moscow,7014,3,9,7,4,38,29,9,34
Krasnodar,7014,4,9,5,6,29,24,5,32
Zenit,7014,5,7,9,4,23,17,6,30
Terek Grozny,7014,6,8,5,7,23,27,-4,29
Din Moscow,7014,7,6,6,8,22,23,-1,24
FK Rubin,7014,8,5,5,10,21,23,-2,20
Rostov,7014,9,4,7,9,11,18,-7,19
Amkar,7014,10,4,5,11,12,27,-15,17
Anzhi,7014,11,3,5,12,19,39,-20,14
Loko Moscow,7015,1,13,5,2,32,12,20,44
CSKA Moscow,7015,2,11,4,5,30,19,11,37
Terek Grozny,7015,3,9,5,6,24,24,0,32
Krasnodar,7015,4,9,4,7,30,27,3,31
Spart Moscow,7015,5,8,6,6,36,30,6,30
Zenit,7015,6,7,8,5,21,17,4,29
Din Moscow,7015,7,6,7,7,20,23,-3,25
FK Rubin,7015,8,5,6,9,23,20,3,21
Rostov,7015,9,5,6,9,12,18,-6,21
Amkar,7015,10,4,5,11,11,25,-14,17
Anzhi,7015,11,2,6,12,17,41,-24,12
Loko Moscow,7016,1,12,6,2,30,11,19,42
Spart Moscow,7016,2,9,7,4,36,27,9,34
CSKA Moscow,7016,3,10,4,6,26,20,6,34
Zenit,7016,4,8,8,4,24,15,9,32
Krasnodar,7016,5,8,6,6,28,25,3,30
Terek Grozny,7016,6,8,5,7,21,24,-3,29
Din Moscow,7016,7,6,6,8,19,23,-4,24
FK Rubin,7016,8,5,6,9,22,19,3,21
Amkar,7016,9,5,5,10,12,23,-11,20
Rostov,7016,10,4,7,9,10,17,-7,19
Anzhi,7016,11,2,6,12,14,38,-24,12
Loko Moscow,7017,1,11,6,3,30,13,17,39
CSKA Moscow,7017,2,10,4,6,26,19,7,34
Krasnodar,7017,3,10,4,6,31,26,5,34
Zenit,7017,4,8,9,3,22,13,9,33
Spart Moscow,7017,5,8,7,5,37,30,7,31
Terek Grozny,7017,6,8,5,7,23,24,-1,29
Din Moscow,7017,7,6,7,7,21,24,-3,25
Rostov,7017,8,5,6,9,11,17,-6,21
FK Rubin,7017,9,5,5,10,23,21,2,20
Amkar,7017,10,4,5,11,12,27,-15,17
Anzhi,7017,11,3,6,11,16,38,-22,15
Loko Moscow,7018,1,12,5,3,33,14,19,41
Spart Moscow,7018,2,11,5,4,38,25,13,38
CSKA Moscow,7018,3,11,3,6,26,18,8,36
Zenit,7018,4,9,8,3,24,14,10,35
Krasnodar,7018,5,9,4,7,29,27,2,31
Terek Grozny,7018,6,8,5,7,26,28,-2,29
FK Rubin,7018,7,6,5,9,23,19,4,23
Din Moscow,7018,8,5,6,9,18,24,-6,21
Rostov,7018,9,4,6,10,10,18,-8,18
Amkar,7018,10,4,4,12,12,29,-17,16
Anzhi,7018,11,3,5,12,17,40,-23,14
Loko Moscow,7019,1,11,6,3,30,14,16,39
CSKA Moscow,7019,2,12,3,5,27,17,10,39
Spart Moscow,7019,3,10,6,4,37,26,11,36
Zenit,7019,4,8,8,4,23,14,9,32
Krasnodar,7019,5,9,5,6,29,25,4,32
Terek Grozny,7019,6,7,6,7,21,24,-3,27
Din Moscow,7019,7,5,7,8,19,25,-6,22
FK Rubin,7019,8,5,6,9,22,19,3,21
Rostov,7019,9,4,7,9,10,17,-7,19
Amkar,7019,10,5,4,11,10,23,-13,19
Anzhi,7019,11,2,6,12,15,39,-24,12
Loko Moscow,7020,1,13,5,2,33,12,21,44
Spart Moscow,7020,2,11,5,4,42,28,14,38
CSKA Moscow,7020,3,11,3,6,27,20,7,36
Zenit,7020,4,8,8,4,24,16,8,32
Krasnodar,7020,5,9,4,7,29,26,3,31
Terek Grozny,7020,6,8,6,6,24,25,-1,30
Din Moscow,7020,7,6,6,8,20,23,-3,24
FK Rubin,7020,8,5,5,10,21,20,1,20
Rostov,7020,9,4,6,10,10,20,-10,18
Amkar,7020,10,4,5,11,11,26,-15,17
Anzhi,7020,11,2,5,13,17,42,-25,11
Loko Moscow,7021,1,12,5,3,32,12,20,41
Spart Moscow,7021,2,10,5,5,37,27,10,35
CSKA Moscow,7021,3,10,3,7,26,20,6,33
Zenit,7021,4,8,8,4,23,17,6,32
Krasnodar,7021,5,9,4,7,28,25,3,31
Terek Grozny,7021,6,8,6,6,23,24,-1,30
FK Rubin,7021,7,6,6,8,22,17,5,24
Din Moscow,7021,8,5,7,8,17,23,-6,22
Amkar,7021,9,5,4,11,13,25,-12,19
Rostov,7021,10,4,6,10,10,19,-9,18
Anzhi,7021,11,3,6,11,15,37,-22,15
Loko Moscow,7022,1,13,5,2,34,11,23,44
Spart Moscow,7022,2,10,6,4,39,29,10,36
CSKA Moscow,7022,3,10,4,6,25,18,7,34
Zenit,7022,4,8,8,4,22,14,8,32
Krasnodar,7022,5,9,4,7,28,28,0,31
Terek Grozny,7022,6,7,6,7,20,25,-5,27
FK Rubin,7022,7,6,5,9,23,18,5,23
Din Moscow,7022,8,5,6,9,18,25,-7,21
Rostov,7022,9,4,7,9,12,19,-7,19
Amkar,7022,10,4,5,11,10,24,-14,17
Anzhi,7022,11,3,6,11,17,37,-20,15
Loko Moscow,7023,1,11,5,4,31,15,16,38
Spart Moscow,7023,2,10,6,4,37,27,10,36
CSKA Moscow,7023,3,11,3,6,27,20,7,36
Zenit,7023,4,9,8,3,26,15,11,35
Krasnodar,7023,5,9,5,6,29,25,4,32
Terek Grozny,7023,6,8,6,6,22,23,-1,30
FK Rubin,7023,7,6,6,8,23,18,5,24
Din Moscow,7023,8,5,7,8,18,23,-5,22
Rostov,7023,9,4,6,10,11,19,-8,18
Amkar,7023,10,4,4,12,10,25,-15,16
Anzhi,7023,11,2,6,12,15,39,-24,12
Loko Moscow,7024,1,11,7,2,31,13,18,40
Spart Moscow,7024,2,10,6,4,37,26,11,36
CSKA Moscow,7024,3,11,3,6,29,20,9,36
Zenit,7024,4,8,9,3,24,14,10,33
Krasnodar,7024,5,8,5,7,29,27,2,29
Terek Grozny,7024,6,7,7,6,23,25,-2,28
Din Moscow,7024,7,6,6,8,19,24,-5,24
FK Rubin,7024,8,6,5,9,24,20,4,23
Rostov,7024,9,4,7,9,11,18,-7,19
Amkar,7024,10,4,5,11,10,24,-14,17
Anzhi,7024,11,2,6,12,17,43,-26,12
Loko Moscow,7025,1,11,6,3,30,14,16,39
CSKA Moscow,7025,2,11,4,5,29,18,11,37
Krasnodar,7025,3,10,4,6,31,25,6,34
Spart Moscow,7025,4,9,6,5,38,30,8,33
Zenit,7025,5,7,10,3,22,14,8,31
Terek Grozny,7025,6,7,5,8,20,25,-5,26
Din Moscow,7025,7,6,6,8,20,23,-3,24
FK Rubin,7025,8,6,5,9,22,18,4,23
Amkar,7025,9,5,5,10,13,24,-11,20
Rostov,7025,10,4,6,10,10,19,-9,18
Anzhi,7025,11,3,5,12,15,40,-25,14
Loko Moscow,7026,1,12,6,2,32,13,19,42
CSKA Moscow,7026,2,11,4,5,28,18,10,37
Spart Moscow,7026,3,10,5,5,39,30,9,35
Zenit,7026,4,7,9,4,22,16,6,30
Krasnodar,7026,5,8,4,8,30,29,1,28
Terek Grozny,7026,6,7,6,7,22,25,-3,27
Din Moscow,7026,7,6,6,8,22,24,-2,24
FK Rubin,7026,8,6,5,9,24,22,2,23
Rostov,7026,9,5,6,9,12,18,-6,21
Amkar,7026,10,4,5,11,11,25,-14,17
Anzhi,7026,11,3,6,11,17,39,-22,15
Loko Moscow,7027,1,13,5,2,33,12,21,44
CSKA Moscow,7027,2,11,4,5,30,20,10,37
Spart Moscow,7027,3,9,5,6,36,28,8,32
Zenit,7027,4,7,9,4,24,18,6,30
Terek Grozny,7027,5,8,6,6,22,23,-1,30
Krasnodar,7027,6,8,4,8,27,26,1,28
Din Moscow,7027,7,6,6,8,21,24,-3,24
FK Rubin,7027,8,6,5,9,22,20,2,23
Rostov,7027,9,5,6,9,11,17,-6,21
Amkar,7027,10,5,5,10,11,23,-12,20
Anzhi,7027,11,2,5,13,15,41,-26,11
Loko Moscow,7028,1,11,5,4,31,17,14,38
CSKA Moscow,7028,2,11,4,5,30,19,11,37
Spart Moscow,7028,3,10,6,4,38,26,12,36
Krasnodar,7028,4,10,4,6,31,26,5,34
Zenit,7028,5,8,9,3,25,14,11,33
Terek Grozny,7028,6,7,6,7,21,24,-3,27
Din Moscow,7028,7,5,8,7,19,23,-4,23
FK Rubin,7028,8,5,6,9,22,19,3,21
Amkar,7028,9,5,4,11,10,23,-13,19
Rostov,7028,10,4,6,10,10,20,-10,18
Anzhi,7028,11,2,6,12,16,42,-26,12
Loko Moscow,7029,1,12,6,2,32,12,20,42
CSKA Moscow,7029,2,12,3,5,28,17,11,39
Spart Moscow,7029,3,9,6,5,36,28,8,33
Krasnodar,7029,4,9,5,6,31,26,5,32
Terek Grozny,7029,5,8,6,6,23,24,-1,30
Zenit,7029,6,7,8,5,21,16,5,29
Din Moscow,7029,7,6,6,8,19,23,-4,24
FK Rubin,7029,8,5,5,10,22,21,1,20
Rostov,7029,9,4,7,9,10,17,-7,19
Amkar,7029,10,5,4,11,12,25,-13,19
Anzhi,7029,11,2,6,12,15,40,-25,12
Spart Moscow,7030,1,11,5,4,41,25,16,38
Loko Moscow,7030,2,11,5,4,29,13,16,38
CSKA Moscow,7030,3,11,4,5,28,18,10,37
Krasnodar,7030,4,10,4,6,31,26,5,34
Zenit,7030,5,8,9,3,23,14,9,33
Terek Grozny,7030,6,8,5,7,22,25,-3,29
Din Moscow,7030,7,6,6,8,19,24,-5,24
FK Rubin,7030,8,5,5,10,23,22,1,20
Rostov,7030,9,4,6,10,10,20,-10,18
Amkar,7030,10,4,4,12,9,25,-16,16
Anzhi,7030,11,3,5,12,17,40,-23,14
Loko Moscow,7031,1,12,5,3,31,12,19,41
CSKA Moscow,7031,2,10,4,6,26,19,7,34
Zenit,7031,3,8,9,3,22,13,9,33
Spart Moscow,7031,4,9,6,5,34,27,7,33
Krasnodar,7031,5,8,5,7,28,27,1,29
Terek Grozny,7031,6,7,6,7,21,24,-3,27
FK Rubin,7031,7,5,7,8,22,18,4,22
Din Moscow,7031,8,5,7,8,17,22,-5,22
Rostov,7031,9,5,6,9,12,17,-5,21
Amkar,7031,10,5,5,10,11,23,-12,20
Anzhi,7031,11,3,6,11,16,38,-22,15
Loko Moscow,7032,1,12,5,3,30,12,18,41
CSKA Moscow,7032,2,12,3,5,29,17,12,39
Spart Moscow,7032,3,11,5,4,40,27,13,38
Krasnodar,7032,4,10,4,6,30,24,6,34
Zenit,7032,5,7,8,5,21,17,4,29
Terek Grozny,7032,6,8,5,7,23,25,-2,29
Din Moscow,7032,7,6,6,8,20,23,-3,24
FK Rubin,7032,8,5,5,10,21,21,0,20
Amkar,7032,9,5,4,11,11,26,-15,19
Rostov,7032,10,4,6,10,11,19,-8,18
Anzhi,7032,11,2,5,13,15,40,-25,11
Loko Moscow,7033,1,12,5,3,30,13,17,41
CSKA Moscow,7033,2,12,3,5,29,17,12,39
Spart Moscow,7033,3,11,5,4,40,27,13,38
Terek Grozny,7033,4,9,5,6,22,22,0,32
Krasnodar,7033,5,9,4,7,29,27,2,31
Zenit,7033,6,7,8,5,21,15,6,29
FK Rubin,7033,7,7,5,8,25,17,8,26
Din Moscow,7033,8,5,6,9,19,25,-6,21
Rostov,7033,9,4,6,10,10,20,-10,18
Amkar,7033,10,4,4,12,9,24,-15,16
Anzhi,7033,11,2,5,13,14,41,-27,11
Loko Moscow,7034,1,11,7,2,29,11,18,40
CSKA Moscow,7034,2,11,4,5,29,20,9,37
Zenit,7034,3,7,9,4,21,14,7,30
Spart Moscow,7034,4,8,6,6,36,34,2,30
Krasnodar,7034,5,8,5,7,27,26,1,29
Terek Grozny,7034,6,8,5,7,23,25,-2,29
Din Moscow,7034,7,6,7,7,21,24,-3,25
FK Rubin,7034,8,6,5,9,24,19,5,23
Amkar,7034,9,6,4,10,16,23,-7,22
Rostov,7034,10,5,6,9,12,17,-5,21
Anzhi,7034,11,2,6,12,18,43,-25,12
Loko Moscow,7035,1,12,6,2,32,11,21,42
CSKA Moscow,7035,2,10,4,6,25,19,6,34
Zenit,7035,3,8,9,3,23,13,10,33
Spart Moscow,7035,4,8,7,5,34,28,6,31
Krasnodar,7035,5,9,4,7,29,27,2,31
Terek Grozny,7035,6,7,7,6,20,22,-2,28
Din Moscow,7035,7,6,7,7,20,22,-2,25
FK Rubin,7035,8,5,6,9,22,20,2,21
Rostov,7035,9,4,7,9,11,18,-7,19
Amkar,7035,10,4,6,10,9,22,-13,18
Anzhi,7035,11,2,7,11,14,37,-23,13
Loko Moscow,7036,1,12,6,2,32,12,20,42
CSKA Moscow,7036,2,10,5,5,29,21,8,35
Spart Moscow,7036,3,9,7,4,36,26,10,34
Terek Grozny,7036,4,9,5,6,25,23,2,32
Zenit,7036,5,7,10,3,23,15,8,31
Krasnodar,7036,6,8,5,7,27,26,1,29
Din Moscow,7036,7,6,6,8,19,23,-4,24
FK Rubin,7036,8,5,6,9,21,19,2,21
Rostov,7036,9,4,7,9,11,18,-7,19
Amkar,7036,10,4,5,11,9,24,-15,17
Anzhi,7036,11,2,6,12,18,43,-25,12
Loko Moscow,7037,1,13,5,2,33,13,20,44
CSKA Moscow,7037,2,11,3,6,29,21,8,36
Spart Moscow,7037,3,10,5,5,37,29,8,35
Zenit,7037,4,8,8,4,25,17,8,32
Terek Grozny,7037,5,9,5,6,24,22,2,32
Krasnodar,7037,6,8,5,7,28,26,2,29
Din Moscow,7037,7,6,6,8,18,23,-5,24
FK Rubin,7037,8,5,6,9,22,19,3,21
Amkar,7037,9,5,4,11,12,24,-12,19
Rostov,7037,10,4,6,10,11,19,-8,18
Anzhi,7037,11,2,5,13,16,42,-26,11
CSKA Moscow,7038,1,12,3,5,30,18,12,39
Loko Moscow,7038,2,11,5,4,30,14,16,38
Spart Moscow,7038,3,10,5,5,37,28,9,35
Zenit,7038,4,8,8,4,23,15,8,32
Krasnodar,7038,5,9,5,6,30,26,4,32
Terek Grozny,7038,6,8,5,7,25,25,0,29
Din Moscow,7038,7,6,6,8,23,24,-1,24
Amkar,7038,8,6,4,10,12,23,-11,22
FK Rubin,7038,9,5,6,9,22,22,0,21
Rostov,7038,10,4,6,10,10,18,-8,18
Anzhi,7038,11,2,5,13,15,44,-29,11
Loko Moscow,7039,1,12,5,3,33,15,18,41
CSKA Moscow,7039,2,11,4,5,28,19,9,37
Spart Moscow,7039,3,10,5,5,39,28,11,35
Zenit,7039,4,8,9,3,26,17,9,33
Krasnodar,7039,5,8,5,7,29,27,2,29
Terek Grozny,7039,6,8,5,7,23,24,-1,29
Din Moscow,7039,7,6,6,8,19,22,-3,24
Amkar,7039,8,6,4,10,14,25,-11,22
FK Rubin,7039,9,5,6,9,22,20,2,21
Rostov,7039,10,4,6,10,10,20,-10,18
Anzhi,7039,11,2,5,13,14,40,-26,11
Loko Moscow,7040,1,13,5,2,36,12,24,44
CSKA Moscow,7040,2,12,3,5,29,18,11,39
Spart Moscow,7040,3,10,5,5,39,29,10,35
Zenit,7040,4,7,8,5,22,18,4,29
Terek Grozny,7040,5,8,5,7,25,27,-2,29
Krasnodar,7040,6,8,4,8,28,29,-1,28
Din Moscow,7040,7,6,6,8,21,25,-4,24
FK Rubin,7040,8,6,5,9,22,19,3,23
Amkar,7040,9,6,4,10,15,23,-8,22
Rostov,7040,10,4,6,10,10,19,-9,18
Anzhi,7040,11,2,5,13,15,43,-28,11
Loko Moscow,7041,1,12,5,3,31,13,18,41
CSKA Moscow,7041,2,11,3,6,26,18,8,36
Zenit,7041,3,9,8,3,24,14,10,35
Spart Moscow,7041,4,10,5,5,35,27,8,35
Krasnodar,7041,5,8,4,8,27,26,1,28
Terek Grozny,7041,6,7,7,6,21,23,-2,28
FK Rubin,7041,7,6,6,8,23,18,5,24
Din Moscow,7041,8,5,7,8,18,23,-5,22
Amkar,7041,9,5,5,10,12,23,-11,20
Rostov,7041,10,4,6,10,10,18,-8,18
Anzhi,7041,11,2,6,12,14,38,-24,12
Loko Moscow,7042,1,13,5,2,31,11,20,44
Spart Moscow,7042,2,10,6,4,37,27,10,36
CSKA Moscow,7042,3,10,3,7,25,19,6,33
Zenit,7042,4,8,8,4,22,14,8,32
Krasnodar,7042,5,8,5,7,28,26,2,29
Terek Grozny,7042,6,8,5,7,22,24,-2,29
FK Rubin,7042,7,6,6,8,24,19,5,24
Din Moscow,7042,8,5,6,9,19,25,-6,21
Rostov,7042,9,4,7,9,10,17,-7,19
Amkar,7042,10,5,4,11,11,24,-13,19
Anzhi,7042,11,3,5,12,16,39,-23,14
Loko Moscow,7043,1,11,6,3,33,16,17,39
CSKA Moscow,7043,2,12,3,5,28,18,10,39
Zenit,7043,3,8,8,4,24,16,8,32
Krasnodar,7043,4,9,5,6,31,27,4,32
Terek Grozny,7043,5,9,5,6,24,24,0,32
Spart Moscow,7043,6,8,6,6,35,31,4,30
Din Moscow,7043,7,5,8,7,18,22,-4,23
FK Rubin,7043,8,5,6,9,22,19,3,21
Rostov,7043,9,5,6,9,12,18,-6,21
Amkar,7043,10,5,4,11,13,24,-11,19
Anzhi,7043,11,2,5,13,16,41,-25,11
Loko Moscow,7044,1,12,6,2,32,11,21,42
CSKA Moscow,7044,2,11,3,6,26,18,8,36
Spart Moscow,7044,3,10,5,5,40,31,9,35
Zenit,7044,4,7,8,5,21,17,4,29
Krasnodar,7044,5,8,5,7,27,28,-1,29
Terek Grozny,7044,6,8,5,7,21,23,-2,29
Din Moscow,7044,7,6,6,8,23,27,-4,24
FK Rubin,7044,8,6,5,9,27,20,7,23
Amkar,7044,9,5,4,11,11,24,-13,19
Rostov,7044,10,4,6,10,11,19,-8,18
Anzhi,7044,11,4,5,11,16,37,-21,17
Loko Moscow,7045,1,11,6,3,33,16,17,39
CSKA Moscow,7045,2,12,3,5,29,18,11,39
Spart Moscow,7045,3,10,6,4,39,28,11,36
Krasnodar,7045,4,9,4,7,29,27,2,31
Zenit,7045,5,7,9,4,24,17,7,30
Terek Grozny,7045,6,7,6,7,22,25,-3,27
FK Rubin,7045,7,7,5,8,24,17,7,26
Din Moscow,7045,8,5,6,9,19,25,-6,21
Rostov,7045,9,4,7,9,10,17,-7,19
Amkar,7045,10,5,4,11,11,25,-14,19
Anzhi,7045,11,2,6,12,17,42,-25,12
Loko Moscow,7046,1,12,5,3,32,13,19,41
Spart Moscow,7046,2,11,5,4,39,26,13,38
Krasnodar,7046,3,10,4,6,32,26,6,34
CSKA Moscow,7046,4,10,3,7,27,23,4,33
Zenit,7046,5,8,8,4,23,15,8,32
Terek Grozny,7046,6,7,5,8,20,25,-5,26
Din Moscow,7046,7,6,6,8,19,23,-4,24
FK Rubin,7046,8,5,5,10,23,22,1,20
Amkar,7046,9,5,4,11,11,24,-13,19
Rostov,7046,10,4,6,10,10,20,-10,18
Anzhi,7046,11,4,5,11,20,39,-19,17
Loko Moscow,7047,1,12,5,3,31,13,18,41
Spart Moscow,7047,2,10,6,4,38,28,10,36
CSKA Moscow,7047,3,11,3,6,29,19,10,36
Zenit,7047,4,8,8,4,22,15,7,32
Krasnodar,7047,5,9,4,7,29,26,3,31
Terek Grozny,7047,6,8,5,7,23,25,-2,29
FK Rubin,7047,7,6,6,8,23,17,6,24
Din Moscow,7047,8,5,7,8,18,23,-5,22
Rostov,7047,9,4,7,9,11,18,-7,19
Amkar,7047,10,5,4,11,13,25,-12,19
Anzhi,7047,11,2,5,13,15,43,-28,11
Loko Moscow,7048,1,12,5,3,33,13,20,41
CSKA Moscow,7048,2,10,5,5,26,18,8,35
Spart Moscow,7048,3,9,7,4,38,28,10,34
Krasnodar,7048,4,10,4,6,31,25,6,34
Zenit,7048,5,7,9,4,22,17,5,30
Terek Grozny,7048,6,7,6,7,24,27,-3,27
FK Rubin,7048,7,6,5,9,23,19,4,23
Din Moscow,7048,8,5,7,8,19,25,-6,22
Rostov,7048,9,4,7,9,10,17,-7,19
Amkar,7048,10,5,4,11,12,26,-14,19
Anzhi,7048,11,2,7,11,17,40,-23,13
Loko Moscow,7049,1,12,5,3,33,13,20,41
Spart Moscow,7049,2,10,5,5,39,30,9,35
Krasnodar,7049,3,10,4,6,34,25,9,34
CSKA Moscow,7049,4,10,3,7,26,22,4,33
Zenit,7049,5,8,8,4,24,17,7,32
Terek Grozny,7049,6,7,7,6,23,25,-2,28
FK Rubin,7049,7,6,5,9,23,23,0,23
Din Moscow,7049,8,5,6,9,21,27,-6,21
Rostov,7049,9,5,6,9,11,17,-6,21
Amkar,7049,10,4,5,11,11,25,-14,17
Anzhi,7049,11,3,6,11,18,39,-21,15
Loko Moscow,7050,1,13,5,2,33,12,21,44
Spart Moscow,7050,2,11,5,4,44,25,19,38
CSKA Moscow,7050,3,10,3,7,26,20,6,33
Zenit,7050,4,8,8,4,22,14,8,32
Krasnodar,7050,5,9,4,7,30,28,2,31
Terek Grozny,7050,6,8,6,6,26,26,0,30
FK Rubin,7050,7,6,5,9,23,19,4,23
Din Moscow,7050,8,5,6,9,17,27,-10,21
Rostov,7050,9,4,6,10,10,20,-10,18
Amkar,7050,10,4,4,12,10,28,-18,16
Anzhi,7050,11,3,6,11,19,41,-22,15
Loko Moscow,7051,1,11,5,4,31,17,14,38
CSKA Moscow,7051,2,11,4,5,27,18,9,37
Spart Moscow,7051,3,9,7,4,40,29,11,34
Krasnodar,7051,4,10,4,6,32,26,6,34
Zenit,7051,5,8,9,3,23,13,10,33
Terek Grozny,7051,6,9,5,6,26,22,4,32
FK Rubin,7051,7,6,5,9,24,18,6,23
Din Moscow,7051,8,5,6,9,19,29,-10,21
Rostov,7051,9,4,7,9,12,19,-7,19
Amkar,7051,10,4,5,11,9,24,-15,17
Anzhi,7051,11,2,5,13,15,43,-28,11
Loko Moscow,7052,1,12,5,3,31,13,18,41
Spart Moscow,7052,2,10,6,4,40,29,11,36
Zenit,7052,3,9,8,3,23,13,10,35
CSKA Moscow,7052,4,10,4,6,26,19,7,34
Terek Grozny,7052,5,8,6,6,22,22,0,30
Krasnodar,7052,6,8,4,8,29,29,0,28
FK Rubin,7052,7,7,5,8,25,18,7,26
Din Moscow,7052,8,5,6,9,19,25,-6,21
Rostov,7052,9,4,7,9,10,17,-7,19
Amkar,7052,10,4,5,11,11,26,-15,17
Anzhi,7052,11,2,6,12,15,40,-25,12
Loko Moscow,7053,1,12,6,2,32,12,20,42
Spart Moscow,7053,2,11,5,4,39,26,13,38
CSKA Moscow,7053,3,11,3,6,28,21,7,36
Zenit,7053,4,8,8,4,24,16,8,32
Krasnodar,7053,5,9,5,6,31,25,6,32
Terek Grozny,7053,6,8,5,7,23,24,-1,29
FK Rubin,7053,7,6,5,9,22,20,2,23
Din Moscow,7053,8,5,6,9,17,24,-7,21
Amkar,7053,9,5,4,11,12,25,-13,19
Rostov,7053,10,4,6,10,10,19,-9,18
Anzhi,7053,11,2,5,13,15,41,-26,11
Loko Moscow,7054,1,11,5,4,30,15,15,38
CSKA Moscow,7054,2,11,4,5,29,19,10,37
Spart Moscow,7054,3,9,7,4,35,26,9,34
Zenit,7054,4,8,9,3,24,14,10,33
Krasnodar,7054,5,9,5,6,31,27,4,32
Terek Grozny,7054,6,8,5,7,24,25,-1,29
Din Moscow,7054,7,6,6,8,19,23,-4,24
FK Rubin,7054,8,5,6,9,23,20,3,21
Rostov,7054,9,4,7,9,10,17,-7,19
Amkar,7054,10,4,5,11,10,26,-16,17
Anzhi,7054,11,3,5,12,17,40,-23,14
Loko Moscow,7055,1,12,5,3,31,13,18,41
Spart Moscow,7055,2,10,5,5,39,28,11,35
Krasnodar,7055,3,10,4,6,30,24,6,34
CSKA Moscow,7055,4,10,4,6,26,20,6,34
Zenit,7055,5,8,8,4,25,16,9,32
Terek Grozny,7055,6,9,5,6,22,22,0,32
Din Moscow,7055,7,6,6,8,20,25,-5,24
FK Rubin,7055,8,5,5,10,22,21,1,20
Amkar,7055,9,5,4,11,11,24,-13,19
Rostov,7055,10,4,6,10,10,19,-9,18
Anzhi,7055,11,2,6,12,14,38,-24,12
Loko Moscow,7056,1,13,5,2,34,11,23,44
CSKA Moscow,7056,2,12,3,5,30,19,11,39
Spart Moscow,7056,3,9,7,4,37,27,10,34
Krasnodar,7056,4,9,4,7,28,25,3,31
Zenit,7056,5,7,8,5,21,18,3,29
Terek Grozny,7056,6,7,5,8,22,27,-5,26
Din Moscow,7056,7,6,7,7,22,21,1,25
FK Rubin,7056,8,5,5,10,21,23,-2,20
Amkar,7056,9,5,5,10,13,25,-12,20
Rostov,7056,10,4,6,10,10,19,-9,18
Anzhi,7056,11,3,5,12,19,42,-23,14
Loko Moscow,7057,1,11,6,3,31,14,17,39
Spart Moscow,7057,2,11,5,4,39,27,12,38
CSKA Moscow,7057,3,11,3,6,27,19,8,36
Zenit,7057,4,8,9,3,24,15,9,33
Krasnodar,7057,5,9,4,7,28,27,1,31
Terek Grozny,7057,6,8,5,7,24,24,0,29
FK Rubin,7057,7,6,6,8,25,18,7,24
Din Moscow,7057,8,5,7,8,18,23,-5,22
Amkar,7057,9,5,4,11,11,25,-14,19
Rostov,7057,10,4,6,10,11,19,-8,18
Anzhi,7057,11,2,5,13,16,43,-27,11
Loko Moscow,7058,1,13,5,2,32,11,21,44
CSKA Moscow,7058,2,12,3,5,29,19,10,39
Spart Moscow,7058,3,10,5,5,38,26,12,35
Zenit,7058,4,7,8,5,21,15,6,29
Krasnodar,7058,5,8,5,7,28,27,1,29
Terek Grozny,7058,6,7,6,7,21,25,-4,27
Din Moscow,7058,7,6,6,8,18,23,-5,24
FK Rubin,7058,8,5,6,9,22,19,3,21
Amkar,7058,9,5,5,10,11,23,-12,20
Rostov,7058,10,4,6,10,10,20,-10,18
Anzhi,7058,11,3,5,12,18,40,-22,14
Loko Moscow,7059,1,12,5,3,30,13,17,41
CSKA Moscow,7059,2,11,3,6,30,20,10,36
Spart Moscow,7059,3,10,5,5,36,26,10,35
Zenit,7059,4,8,8,4,24,16,8,32
Krasnodar,7059,5,9,5,6,31,26,5,32
Terek Grozny,7059,6,7,6,7,20,25,-5,27
Din Moscow,7059,7,6,6,8,19,22,-3,24
FK Rubin,7059,8,5,6,9,23,21,2,21
Rostov,7059,9,5,6,9,11,17,-6,21
Amkar,7059,10,4,5,11,9,24,-15,17
Anzhi,7059,11,3,5,12,17,40,-23,14
Loko Moscow,7060,1,12,5,3,32,15,17,41
CSKA Moscow,7060,2,11,3,6,29,20,9,36
Krasnodar,7060,3,10,4,6,31,24,7,34
Zenit,7060,4,8,8,4,24,17,7,32
Terek Grozny,7060,5,9,5,6,24,24,0,32
Spart Moscow,7060,6,8,7,5,35,31,4,31
Din Moscow,7060,7,6,7,7,22,22,0,25
Rostov,7060,8,5,6,9,14,17,-3,21
FK Rubin,7060,9,5,5,10,21,22,-1,20
Amkar,7060,10,4,5,11,11,25,-14,17
Anzhi,7060,11,2,5,13,16,42,-26,11
Loko Moscow,7061,1,12,5,3,33,12,21,41
Spart Moscow,7061,2,10,6,4,39,27,12,36
CSKA Moscow,7061,3,10,5,5,25,17,8,35
Krasnodar,7061,4,9,5,6,29,25,4,32
Zenit,7061,5,7,9,4,21,17,4,30
Terek Grozny,7061,6,8,6,6,22,23,-1,30
FK Rubin,7061,7,6,6,8,24,19,5,24
Din Moscow,7061,8,5,6,9,18,26,-8,21
Rostov,7061,9,4,6,10,10,18,-8,18
Amkar,7061,10,4,6,10,12,25,-13,18
Anzhi,7061,11,2,6,12,14,38,-24,12
Loko Moscow,7062,1,11,7,2,32,14,18,40
CSKA Moscow,7062,2,11,4,5,27,18,9,37
Krasnodar,7062,3,9,5,6,31,26,5,32
Terek Grozny,7062,4,9,5,6,22,22,0,32
Zenit,7062,5,7,10,3,23,15,8,31
Spart Moscow,7062,6,8,5,7,35,31,4,29
Din Moscow,7062,7,7,6,7,22,23,-1,27
Rostov,7062,8,5,6,9,13,19,-6,21
FK Rubin,7062,9,5,5,10,23,22,1,20
Amkar,7062,10,5,4,11,10,23,-13,19
Anzhi,7062,11,2,5,13,14,39,-25,11
Loko Moscow,7063,1,12,5,3,32,14,18,41
CSKA Moscow,7063,2,11,3,6,29,18,11,36
Spart Moscow,7063,3,9,7,4,37,28,9,34
Krasnodar,7063,4,10,4,6,31,25,6,34
Zenit,7063,5,8,8,4,23,15,8,32
Terek Grozny,7063,6,8,6,6,22,23,-1,30
FK Rubin,7063,7,6,5,9,23,19,4,23
Din Moscow,7063,8,5,6,9,18,25,-7,21
Rostov,7063,9,4,7,9,12,19,-7,19
Amkar,7063,10,4,6,10,10,23,-13,18
Anzhi,7063,11,2,5,13,14,42,-28,11
Loko Moscow,7064,1,12,5,3,31,12,19,41
Spart Moscow,7064,2,10,5,5,39,29,10,35
CSKA Moscow,7064,3,10,4,6,27,20,7,34
Zenit,7064,4,8,8,4,23,16,7,32
Krasnodar,7064,5,9,5,6,28,24,4,32
Terek Grozny,7064,6,7,6,7,20,23,-3,27
Din Moscow,7064,7,6,6,8,22,25,-3,24
FK Rubin,7064,8,5,6,9,21,20,1,21
Rostov,7064,9,5,6,9,12,18,-6,21
Amkar,7064,10,5,4,11,10,23,-13,19
Anzhi,7064,11,2,7,11,15,38,-23,13
Loko Moscow,7065,1,12,6,2,31,12,19,42
CSKA Moscow,7065,2,11,3,6,26,19,7,36
Spart Moscow,7065,3,9,7,4,36,27,9,34
Zenit,7065,4,8,9,3,23,13,10,33
Krasnodar,7065,5,8,5,7,28,26,2,29
Terek Grozny,7065,6,7,6,7,21,24,-3,27
FK Rubin,7065,7,5,7,8,22,18,4,22
Din Moscow,7065,8,5,7,8,18,23,-5,22
Rostov,7065,9,4,7,9,11,18,-7,19
Amkar,7065,10,4,6,10,11,24,-13,18
Anzhi,7065,11,3,5,12,15,38,-23,14
Loko Moscow,7066,1,12,6,2,31,12,19,42
CSKA Moscow,7066,2,11,4,5,28,18,10,37
Spart Moscow,7066,3,10,6,4,36,26,10,36
Zenit,7066,4,7,9,4,23,16,7,30
Krasnodar,7066,5,8,5,7,28,26,2,29
Terek Grozny,7066,6,8,5,7,23,25,-2,29
FK Rubin,7066,7,7,5,8,24,18,6,26
Din Moscow,7066,8,5,6,9,17,23,-6,21
Amkar,7066,9,5,5,10,12,23,-11,20
Rostov,7066,10,4,6,10,10,18,-8,18
Anzhi,7066,11,2,5,13,15,42,-27,11
Loko Moscow,7067,1,11,6,3,31,16,15,39
Spart Moscow,7067,2,11,5,4,40,29,11,38
Zenit,7067,3,9,8,3,28,15,13,35
CSKA Moscow,7067,4,10,4,6,29,23,6,34
Krasnodar,7067,5,9,5,6,31,26,5,32
Terek Grozny,7067,6,7,6,7,21,26,-5,27
Din Moscow,7067,7,6,6,8,20,23,-3,24
FK Rubin,7067,8,5,5,10,21,21,0,20
Amkar,7067,9,5,4,11,13,24,-11,19
Rostov,7067,10,4,6,10,12,20,-8,18
Anzhi,7067,11,2,7,11,17,40,-23,13
Loko Moscow,7068,1,11,6,3,31,17,14,39
CSKA Moscow,7068,2,12,3,5,30,19,11,39
Spart Moscow,7068,3,9,6,5,38,28,10,33
Krasnodar,7068,4,9,4,7,32,26,6,31
Zenit,7068,5,7,9,4,24,18,6,30
Terek Grozny,7068,6,8,6,6,25,25,0,30
FK Rubin,7068,7,7,5,8,25,17,8,26
Din Moscow,7068,8,6,6,8,19,25,-6,24
Rostov,7068,9,4,6,10,11,21,-10,18
Amkar,7068,10,4,6,10,11,24,-13,18
Anzhi,7068,11,2,5,13,15,41,-26,11
Loko Moscow,7069,1,11,6,3,31,15,16,39
CSKA Moscow,7069,2,11,3,6,26,18,8,36
Zenit,7069,3,8,9,3,24,15,9,33
Spart Moscow,7069,4,9,5,6,38,33,5,32
Krasnodar,7069,5,9,5,6,30,25,5,32
Terek Grozny,7069,6,7,6,7,23,28,-5,27
Din Moscow,7069,7,6,7,7,22,22,0,25
FK Rubin,7069,8,5,7,8,23,19,4,22
Amkar,7069,9,5,5,10,14,25,-11,20
Rostov,7069,10,4,6,10,11,21,-10,18
Anzhi,7069,11,3,5,12,18,39,-21,14
Loko Moscow,7070,1,12,5,3,31,13,18,41
Spart Moscow,7070,2,11,5,4,39,28,11,38
CSKA Moscow,7070,3,11,3,6,27,21,6,36
Zenit,7070,4,8,8,4,24,15,9,32
Krasnodar,7070,5,9,5,6,30,25,5,32
Terek Grozny,7070,6,9,5,6,23,22,1,32
Din Moscow,7070,7,6,6,8,20,23,-3,24
FK Rubin,7070,8,5,6,9,22,20,2,21
Rostov,7070,9,4,6,10,11,19,-8,18
Amkar,7070,10,4,4,12,10,26,-16,16
Anzhi,7070,11,2,5,13,15,40,-25,11
Loko Moscow,7071,1,11,6,3,30,13,17,39
CSKA Moscow,7071,2,10,4,6,29,22,7,34
Krasnodar,7071,3,10,4,6,31,26,5,34
Zenit,7071,4,8,9,3,24,15,9,33
Spart Moscow,7071,5,9,6,5,36,28,8,33
Terek Grozny,7071,6,8,6,6,24,25,-1,30
FK Rubin,7071,7,6,5,9,25,20,5,23
Din Moscow,7071,8,5,6,9,18,25,-7,21
Rostov,7071,9,4,7,9,11,18,-7,19
Amkar,7071,10,5,4,11,10,23,-13,19
Anzhi,7071,11,2,7,11,20,43,-23,13
Loko Moscow,7072,1,12,5,3,32,14,18,41
CSKA Moscow,7072,2,11,4,5,30,19,11,37
Spart Moscow,7072,3,10,5,5,37,27,10,35
Krasnodar,7072,4,10,4,6,33,27,6,34
Zenit,7072,5,7,9,4,23,16,7,30
Terek Grozny,7072,6,7,7,6,22,24,-2,28
Din Moscow,7072,7,6,7,7,19,22,-3,25
FK Rubin,7072,8,5,6,9,23,21,2,21
Rostov,7072,9,4,6,10,11,19,-8,18
Amkar,7072,10,4,5,11,10,25,-15,17
Anzhi,7072,11,2,6,12,15,41,-26,12
Loko Moscow,7073,1,12,5,3,32,15,17,41
CSKA Moscow,7073,2,12,3,5,31,17,14,39
Krasnodar,7073,3,10,4,6,33,26,7,34
Spart Moscow,7073,4,9,6,5,35,28,7,33
Terek Grozny,7073,5,8,6,6,24,24,0,30
Zenit,7073,6,7,8,5,21,16,5,29
Din Moscow,7073,7,5,7,8,18,23,-5,22
FK Rubin,7073,8,5,6,9,23,20,3,21
Rostov,7073,9,4,7,9,11,18,-7,19
Amkar,7073,10,5,4,11,12,25,-13,19
Anzhi,7073,11,2,6,12,15,43,-28,12
CSKA Moscow,7074,1,12,3,5,29,17,12,39
Loko Moscow,7074,2,11,5,4,29,13,16,38
Zenit,7074,3,8,8,4,22,15,7,32
Krasnodar,7074,4,9,5,6,29,25,4,32
Spart Moscow,7074,5,8,6,6,37,31,6,30
Terek Grozny,7074,6,8,5,7,24,26,-2,29
Din Moscow,7074,7,5,8,7,21,25,-4,23
FK Rubin,7074,8,5,7,8,24,20,4,22
Amkar,7074,9,6,4,10,13,24,-11,22
Rostov,7074,10,5,6,9,12,18,-6,21
Anzhi,7074,11,2,5,13,16,42,-26,11
Loko Moscow,7075,1,12,5,3,32,14,18,41
Spart Moscow,7075,2,9,7,4,35,26,9,34
CSKA Moscow,7075,3,10,3,7,27,21,6,33
Zenit,7075,4,8,8,4,24,16,8,32
Krasnodar,7075,5,9,4,7,29,26,3,31
Terek Grozny,7075,6,7,6,7,21,24,-3,27
FK Rubin,7075,7,6,6,8,23,18,5,24
Din Moscow,7075,8,5,7,8,18,23,-5,22
Rostov,7075,9,4,7,9,11,18,-7,19
Amkar,7075,10,4,6,10,10,23,-13,18
Anzhi,7075,11,4,5,11,17,38,-21,17
Loko Moscow,7076,1,11,6,3,30,14,16,39
CSKA Moscow,7076,2,11,4,5,27,17,10,37
Spart Moscow,7076,3,10,5,5,38,29,9,35
Zenit,7076,4,8,9,3,24,14,10,33
Terek Grozny,7076,5,9,5,6,22,22,0,32
Krasnodar,7076,6,8,5,7,27,26,1,29
Din Moscow,7076,7,6,6,8,19,22,-3,24
FK Rubin,7076,8,6,5,9,23,19,4,23
Amkar,7076,9,5,4,11,11,24,-13,19
Rostov,7076,10,4,6,10,12,20,-8,18
Anzhi,7076,11,2,5,13,14,40,-26,11
Loko Moscow,7077,1,12,6,2,35,15,20,42
Spart Moscow,7077,2,11,5,4,39,25,14,38
CSKA Moscow,7077,3,11,3,6,28,19,9,36
Zenit,7077,4,8,8,4,24,17,7,32
Krasnodar,7077,5,9,5,6,31,26,5,32
Terek Grozny,7077,6,9,5,6,22,22,0,32
FK Rubin,7077,7,6,5,9,22,19,3,23
Din Moscow,7077,8,5,6,9,17,25,-8,21
Rostov,7077,9,4,6,10,10,19,-9,18
Amkar,7077,10,4,4,12,9,24,-15,16
Anzhi,7077,11,2,5,13,15,41,-26,11
Loko Moscow,7078,1,12,5,3,32,14,18,41
Spart Moscow,7078,2,11,5,4,40,28,12,38
CSKA Moscow,7078,3,11,3,6,28,19,9,36
Zenit,7078,4,9,8,3,25,15,10,35
Krasnodar,7078,5,8,5,7,28,26,2,29
Terek Grozny,7078,6,7,6,7,21,24,-3,27
FK Rubin,7078,7,6,6,8,22,17,5,24
Din Moscow,7078,8,5,6,9,20,26,-6,21
Rostov,7078,9,4,6,10,10,19,-9,18
Amkar,7078,10,4,5,11,9,23,-14,17
Anzhi,7078,11,3,5,12,16,40,-24,14
Loko Moscow,7079,1,12,5,3,32,15,17,41
Spart Moscow,7079,2,10,6,4,38,27,11,36
CSKA Moscow,7079,3,11,3,6,26,18,8,36
Zenit,7079,4,9,8,3,25,14,11,35
Terek Grozny,7079,5,8,6,6,23,24,-1,30
Krasnodar,7079,6,8,4,8,28,29,-1,28
FK Rubin,7079,7,7,5,8,25,17,8,26
Din Moscow,7079,8,5,6,9,17,23,-6,21
Rostov,7079,9,4,7,9,11,18,-7,19
Amkar,7079,10,4,5,11,12,27,-15,17
Anzhi,7079,11,2,5,13,14,39,-25,11
Loko Moscow,7080,1,13,5,2,33,12,21,44
CSKA Moscow,7080,2,12,3,5,27,17,10,39
Spart Moscow,7080,3,9,6,5,38,28,10,33
Zenit,7080,4,7,8,5,22,16,6,29
Krasnodar,7080,5,8,5,7,29,28,1,29
Terek Grozny,7080,6,7,7,6,23,25,-2,28
Din Moscow,7080,7,6,6,8,18,24,-6,24
FK Rubin,7080,8,5,6,9,23,20,3,21
Amkar,7080,9,5,5,10,11,23,-12,20
Rostov,7080,10,4,7,9,11,18,-7,19
Anzhi,7080,11,2,6,12,17,41,-24,12
Loko Moscow,7081,1,11,6,3,30,14,16,39
Spart Moscow,7081,2,11,5,4,40,28,12,38
CSKA Moscow,7081,3,11,4,5,31,18,13,37
Zenit,7081,4,8,9,3,25,15,10,33
Krasnodar,7081,5,9,5,6,29,25,4,32
Terek Grozny,7081,6,8,6,6,22,23,-1,30
Din Moscow,7081,7,6,6,8,19,23,-4,24
FK Rubin,7081,8,5,5,10,22,20,2,20
Rostov,7081,9,4,6,10,11,19,-8,18
Amkar,7081,10,4,5,11,10,25,-15,17
Anzhi,7081,11,2,5,13,15,44,-29,11
Loko Moscow,7082,1,13,5,2,34,13,21,44
CSKA Moscow,7082,2,11,3,6,30,19,11,36
Spart Moscow,7082,3,10,5,5,40,32,8,35
Zenit,7082,4,8,8,4,24,16,8,32
Krasnodar,7082,5,9,4,7,30,27,3,31
Terek Grozny,7082,6,8,5,7,22,24,-2,29
Din Moscow,7082,7,7,6,7,24,23,1,27
FK Rubin,7082,8,5,5,10,22,21,1,20
Rostov,7082,9,4,6,10,11,20,-9,18
Amkar,7082,10,4,4,12,10,26,-16,16
Anzhi,7082,11,3,5,12,16,42,-26,14
Loko Moscow,7083,1,12,6,2,32,11,21,42
CSKA Moscow,7083,2,11,4,5,26,17,9,37
Spart Moscow,7083,3,9,7,4,34,25,9,34
Terek Grozny,7083,4,9,5,6,24,23,1,32
Zenit,7083,5,7,9,4,21,16,5,30
Krasnodar,7083,6,8,5,7,27,26,1,29
FK Rubin,7083,7,7,5,8,24,17,7,26
Din Moscow,7083,8,5,7,8,17,22,-5,22
Rostov,7083,9,4,6,10,10,18,-8,18
Amkar,7083,10,4,5,11,9,23,-14,17
Anzhi,7083,11,2,5,13,15,41,-26,11
Loko Moscow,7084,1,13,5,2,34,13,21,44
CSKA Moscow,7084,2,12,3,5,27,17,10,39
Spart Moscow,7084,3,9,6,5,35,27,8,33
Zenit,7084,4,7,8,5,23,17,6,29
Terek Grozny,7084,5,8,5,7,22,23,-1,29
Krasnodar,7084,6,8,4,8,27,28,-1,28
FK Rubin,7084,7,7,5,8,26,19,7,26
Din Moscow,7084,8,6,6,8,20,24,-4,24
Rostov,7084,9,4,7,9,11,18,-7,19
Amkar,7084,10,4,4,12,9,25,-16,16
Anzhi,7084,11,3,5,12,15,38,-23,14
Loko Moscow,7085,1,11,6,3,30,14,16,39
CSKA Moscow,7085,2,11,3,6,30,18,12,36
Zenit,7085,3,9,8,3,24,13,11,35
Spart Moscow,7085,4,10,5,5,38,29,9,35
Krasnodar,7085,5,9,5,6,30,25,5,32
Terek Grozny,7085,6,8,5,7,22,23,-1,29
Din Moscow,7085,7,6,6,8,19,23,-4,24
FK Rubin,7085,8,5,5,10,21,20,1,20
Amkar,7085,9,5,4,11,11,25,-14,19
Rostov,7085,10,4,6,10,11,19,-8,18
Anzhi,7085,11,3,5,12,15,42,-27,14
Loko Moscow,7086,1,12,5,3,31,13,18,41
Spart Moscow,7086,2,10,5,5,38,28,10,35
Krasnodar,7086,3,10,4,6,32,24,8,34
CSKA Moscow,7086,4,10,4,6,25,18,7,34
Zenit,7086,5,8,8,4,22,15,7,32
Terek Grozny,7086,6,8,5,7,22,24,-2,29
Din Moscow,7086,7,6,6,8,19,23,-4,24
Rostov,7086,8,5,6,9,13,18,-5,21
FK Rubin,7086,9,5,5,10,22,22,0,20
Amkar,7086,10,5,4,11,11,26,-15,19
Anzhi,7086,11,2,6,12,14,38,-24,12
Loko Moscow,7087,1,11,6,3,31,15,16,39
CSKA Moscow,7087,2,12,3,5,29,18,11,39
Spart Moscow,7087,3,9,7,4,35,25,10,34
Krasnodar,7087,4,10,4,6,33,25,8,34
Zenit,7087,5,7,9,4,22,15,7,30
Terek Grozny,7087,6,7,6,7,21,25,-4,27
Din Moscow,7087,7,6,7,7,20,21,-1,25
FK Rubin,7087,8,5,5,10,21,23,-2,20
Amkar,7087,9,5,5,10,11,22,-11,20
Rostov,7087,10,4,6,10,10,19,-9,18
Anzhi,7087,11,2,6,12,16,41,-25,12
Loko Moscow,7088,1,12,5,3,32,13,19,41
CSKA Moscow,7088,2,11,4,5,31,18,13,37
Spart Moscow,7088,3,10,6,4,35,25,10,36
Krasnodar,7088,4,9,5,6,30,26,4,32
Zenit,7088,5,7,9,4,21,15,6,30
Terek Grozny,7088,6,7,6,7,21,25,-4,27
Din Moscow,7088,7,5,8,7,17,21,-4,23
FK Rubin,7088,8,5,7,8,22,18,4,22
Rostov,7088,9,4,6,10,10,18,-8,18
Amkar,7088,10,4,5,11,10,24,-14,17
Anzhi,7088,11,3,5,12,17,43,-26,14
Loko Moscow,7089,1,11,5,4,30,14,16,38
CSKA Moscow,7089,2,11,4,5,28,18,10,37
Spart Moscow,7089,3,9,6,5,38,27,11,33
Zenit,7089,4,8,9,3,24,15,9,33
Krasnodar,7089,5,9,5,6,29,25,4,32
Terek Grozny,7089,6,7,6,7,21,26,-5,27
FK Rubin,7089,7,5,7,8,24,20,4,22
Din Moscow,7089,8,5,7,8,19,27,-8,22
Amkar,7089,9,5,5,10,11,23,-12,20
Rostov,7089,10,4,7,9,11,18,-7,19
Anzhi,7089,11,3,5,12,17,39,-22,14
Loko Moscow,7090,1,11,6,3,29,15,14,39
CSKA Moscow,7090,2,12,3,5,27,17,10,39
Spart Moscow,7090,3,11,5,4,38,27,11,38
Krasnodar,7090,4,9,5,6,32,25,7,32
Zenit,7090,5,7,9,4,21,14,7,30
Terek Grozny,7090,6,7,5,8,21,25,-4,26
FK Rubin,7090,7,6,6,8,25,19,6,24
Din Moscow,7090,8,5,6,9,19,26,-7,21
Amkar,7090,9,5,4,11,11,24,-13,19
Rostov,7090,10,4,6,10,11,19,-8,18
Anzhi,7090,11,3,5,12,15,38,-23,14
Loko Moscow,7091,1,13,5,2,34,11,23,44
CSKA Moscow,7091,2,11,3,6,29,19,10,36
Spart Moscow,7091,3,8,8,4,36,28,8,32
Zenit,7091,4,8,8,4,23,18,5,32
Krasnodar,7091,5,8,4,8,27,26,1,28
Terek Grozny,7091,6,7,6,7,22,25,-3,27
Din Moscow,7091,7,6,7,7,20,22,-2,25
FK Rubin,7091,8,6,5,9,22,19,3,23
Rostov,7091,9,4,7,9,11,18,-7,19
Amkar,7091,10,4,6,10,11,24,-13,18
Anzhi,7091,11,3,5,12,16,41,-25,14
Loko Moscow,7092,1,11,5,4,29,14,15,38
CSKA Moscow,7092,2,11,3,6,27,18,9,36
Zenit,7092,3,9,8,3,23,13,10,35
Spart Moscow,7092,4,9,6,5,37,30,7,33
Krasnodar,7092,5,9,5,6,29,24,5,32
Terek Grozny,7092,6,8,5,7,21,23,-2,29
Din Moscow,7092,7,7,6,7,23,23,0,27
FK Rubin,7092,8,5,6,9,22,19,3,21
Rostov,7092,9,4,7,9,11,18,-7,19
Amkar,7092,10,5,4,11,10,24,-14,19
Anzhi,7092,11,2,5,13,14,40,-26,11
Loko Moscow,7093,1,12,5,3,32,13,19,41
CSKA Moscow,7093,2,11,3,6,27,19,8,36
Spart Moscow,7093,3,9,6,5,36,27,9,33
Zenit,7093,4,8,8,4,24,16,8,32
Terek Grozny,7093,5,8,5,7,28,27,1,29
Krasnodar,7093,6,8,4,8,27,27,0,28
Din Moscow,7093,7,7,6,7,20,22,-2,27
FK Rubin,7093,8,6,5,9,23,19,4,23
Amkar,7093,9,5,5,10,14,25,-11,20
Rostov,7093,10,4,6,10,10,19,-9,18
Anzhi,7093,11,3,5,12,16,43,-27,14
Loko Moscow,7094,1,12,5,3,31,15,16,41
Spart Moscow,7094,2,10,5,5,36,26,10,35
Krasnodar,7094,3,10,4,6,33,26,7,34
CSKA Moscow,7094,4,10,4,6,25,18,7,34
Zenit,7094,5,7,9,4,21,14,7,30
Terek Grozny,7094,6,8,6,6,22,22,0,30
Din Moscow,7094,7,6,7,7,19,22,-3,25
FK Rubin,7094,8,5,6,9,23,20,3,21
Rostov,7094,9,4,6,10,10,19,-9,18
Amkar,7094,10,4,5,11,9,23,-14,17
Anzhi,7094,11,3,5,12,15,39,-24,14
Loko Moscow,7095,1,13,5,2,34,12,22,44
CSKA Moscow,7095,2,11,3,6,27,19,8,36
Zenit,7095,3,8,8,4,24,16,8,32
Spart Moscow,7095,4,9,5,6,37,30,7,32
Terek Grozny,7095,5,8,6,6,23,24,-1,30
Krasnodar,7095,6,8,5,7,28,27,1,29
FK Rubin,7095,7,6,6,8,25,20,5,24
Din Moscow,7095,8,5,6,9,20,26,-6,21
Rostov,7095,9,5,6,9,12,18,-6,21
Amkar,7095,10,5,4,11,11,24,-13,19
Anzhi,7095,11,2,6,12,16,41,-25,12
Loko Moscow,7096,1,12,6,2,32,13,19,42
Spart Moscow,7096,2,11,5,4,42,26,16,38
CSKA Moscow,7096,3,10,4,6,25,18,7,34
Krasnodar,7096,4,9,5,6,32,27,5,32
Zenit,7096,5,7,9,4,22,15,7,30
Terek Grozny,7096,6,7,6,7,20,23,-3,27
FK Rubin,7096,7,6,5,9,25,21,4,23
Din Moscow,7096,8,5,6,9,18,28,-10,21
Amkar,7096,9,5,4,11,10,25,-15,19
Rostov,7096,10,4,6,10,10,18,-8,18
Anzhi,7096,11,3,6,11,15,37,-22,15
Loko Moscow,7097,1,11,7,2,31,13,18,40
CSKA Moscow,7097,2,11,4,5,27,17,10,37
Spart Moscow,7097,3,10,5,5,38,28,10,35
Zenit,7097,4,7,9,4,22,16,6,30
Krasnodar,7097,5,8,6,6,29,26,3,30
Terek Grozny,7097,6,7,6,7,20,25,-5,27
Din Moscow,7097,7,6,6,8,19,23,-4,24
FK Rubin,7097,8,5,6,9,22,20,2,21
Amkar,7097,9,5,5,10,11,23,-12,20
Rostov,7097,10,4,6,10,11,19,-8,18
Anzhi,7097,11,3,6,11,17,37,-20,15
Loko Moscow,7098,1,12,5,3,35,16,19,41
CSKA Moscow,7098,2,12,3,5,29,17,12,39
Spart Moscow,7098,3,9,5,6,36,28,8,32
Zenit,7098,4,8,8,4,23,15,8,32
Terek Grozny,7098,5,9,5,6,26,22,4,32
Krasnodar,7098,6,8,5,7,31,30,1,29
FK Rubin,7098,7,6,6,8,24,18,6,24
Rostov,7098,8,5,6,9,12,17,-5,21
Din Moscow,7098,9,5,6,9,17,26,-9,21
Amkar,7098,10,5,4,11,10,23,-13,19
Anzhi,7098,11,2,5,13,14,45,-31,11
Loko Moscow,7099,1,12,5,3,31,14,17,41
CSKA Moscow,7099,2,11,4,5,28,18,10,37
Spart Moscow,7099,3,9,7,4,38,27,11,34
Krasnodar,7099,4,10,4,6,33,26,7,34
Terek Grozny,7099,5,8,6,6,24,25,-1,30
Zenit,7099,6,7,8,5,22,17,5,29
Din Moscow,7099,7,5,8,7,19,23,-4,23
FK Rubin,7099,8,5,6,9,22,20,2,21
Rostov,7099,9,4,6,10,10,20,-10,18
Amkar,7099,10,4,6,10,11,24,-13,18
Anzhi,7099,11,2,6,12,15,39,-24,12
CSKA Moscow,7100,1,12,3,5,27,17,10,39
Loko Moscow,7100,2,11,5,4,31,15,16,38
Spart Moscow,7100,3,10,6,4,38,28,10,36
Zenit,7100,4,8,8,4,23,15,8,32
Krasnodar,7100,5,9,4,7,30,27,3,31
Terek Grozny,7100,6,8,6,6,22,23,-1,30
Din Moscow,7100,7,6,6,8,21,25,-4,24
FK Rubin,7100,8,6,5,9,25,21,4,23
Rostov,7100,9,4,6,10,10,18,-8,18
Amkar,7100,10,4,5,11,11,25,-14,17
Anzhi,7100,11,2,6,12,15,39,-24,12
Loko Moscow,7101,1,12,6,2,34,12,22,42
CSKA Moscow,7101,2,10,5,5,26,18,8,35
Spart Moscow,7101,3,9,6,5,39,31,8,33
Terek Grozny,7101,4,9,5,6,27,26,1,32
Zenit,7101,5,7,10,3,23,15,8,31
Krasnodar,7101,6,8,4,8,27,29,-2,28
FK Rubin,7101,7,6,6,8,23,18,5,24
Din Moscow,7101,8,5,7,8,20,25,-5,22
Rostov,7101,9,4,7,9,11,18,-7,19
Amkar,7101,10,5,4,11,13,27,-14,19
Anzhi,7101,11,2,6,12,17,41,-24,12
Loko Moscow,7102,1,11,6,3,31,15,16,39
CSKA Moscow,7102,2,11,4,5,28,17,11,37
Spart Moscow,7102,3,9,7,4,36,26,10,34
Krasnodar,7102,4,9,5,6,30,25,5,32
Zenit,7102,5,7,10,3,23,15,8,31
Terek Grozny,7102,6,7,5,8,22,28,-6,26
FK Rubin,7102,7,6,6,8,23,18,5,24
Din Moscow,7102,8,5,6,9,17,24,-7,21
Amkar,7102,9,5,5,10,12,24,-12,20
Rostov,7102,10,4,7,9,10,17,-7,19
Anzhi,7102,11,3,5,12,18,41,-23,14
Loko Moscow,7103,1,12,6,2,33,14,19,42
Spart Moscow,7103,2,10,6,4,40,25,15,36
CSKA Moscow,7103,3,11,3,6,27,20,7,36
Zenit,7103,4,8,9,3,26,16,10,33
Krasnodar,7103,5,9,4,7,29,25,4,31
Terek Grozny,7103,6,8,6,6,24,23,1,30
Din Moscow,7103,7,5,7,8,17,23,-6,22
FK Rubin,7103,8,5,6,9,21,19,2,21
Rostov,7103,9,4,6,10,10,22,-12,18
Amkar,7103,10,4,6,10,10,23,-13,18
Anzhi,7103,11,2,5,13,15,42,-27,11
Loko Moscow,7104,1,12,6,2,32,13,19,42
Spart Moscow,7104,2,10,5,5,38,30,8,35
CSKA Moscow,7104,3,10,5,5,28,20,8,35
Zenit,7104,4,7,10,3,25,17,8,31
Krasnodar,7104,5,9,4,7,29,25,4,31
Terek Grozny,7104,6,8,6,6,22,23,-1,30
Din Moscow,7104,7,6,6,8,21,24,-3,24
FK Rubin,7104,8,6,5,9,23,20,3,23
Rostov,7104,9,4,6,10,11,19,-8,18
Amkar,7104,10,4,4,12,10,25,-15,16
Anzhi,7104,11,2,7,11,16,39,-23,13
Loko Moscow,7105,1,11,6,3,30,14,16,39
CSKA Moscow,7105,2,11,4,5,29,19,10,37
Spart Moscow,7105,3,9,6,5,36,28,8,33
Zenit,7105,4,8,8,4,23,15,8,32
Krasnodar,7105,5,9,5,6,30,25,5,32
Terek Grozny,7105,6,8,5,7,21,23,-2,29
Din Moscow,7105,7,7,6,7,20,22,-2,27
FK Rubin,7105,8,5,5,10,21,20,1,20
Rostov,7105,9,4,6,10,10,18,-8,18
Amkar,7105,10,4,5,11,10,24,-14,17
Anzhi,7105,11,3,6,11,17,39,-22,15
Loko Moscow,7106,1,12,5,3,31,13,18,41
CSKA Moscow,7106,2,11,3,6,29,18,11,36
Spart Moscow,7106,3,10,5,5,39,27,12,35
Zenit,7106,4,9,8,3,23,13,10,35
Krasnodar,7106,5,9,4,7,30,26,4,31
Terek Grozny,7106,6,8,6,6,23,23,0,30
Din Moscow,7106,7,6,6,8,20,26,-6,24
FK Rubin,7106,8,5,5,10,22,22,0,20
Amkar,7106,9,5,4,11,11,24,-13,19
Rostov,7106,10,4,6,10,10,19,-9,18
Anzhi,7106,11,2,6,12,15,42,-27,12
CSKA Moscow,7107,1,12,3,5,32,18,14,39
Loko Moscow,7107,2,11,5,4,30,14,16,38
Krasnodar,7107,3,10,4,6,33,27,6,34
Spart Moscow,7107,4,9,6,5,37,28,9,33
Zenit,7107,5,8,8,4,22,16,6,32
Terek Grozny,7107,6,7,5,8,20,26,-6,26
Din Moscow,7107,7,6,6,8,18,23,-5,24
Amkar,7107,8,6,4,10,13,23,-10,22
FK Rubin,7107,9,5,5,10,23,22,1,20
Rostov,7107,10,4,7,9,11,18,-7,19
Anzhi,7107,11,3,5,12,17,41,-24,14
Loko Moscow,7108,1,12,5,3,32,15,17,41
Spart Moscow,7108,2,10,6,4,41,29,12,36
CSKA Moscow,7108,3,11,3,6,26,19,7,36
Krasnodar,7108,4,10,4,6,30,24,6,34
Zenit,7108,5,8,8,4,25,16,9,32
Terek Grozny,7108,6,8,6,6,22,23,-1,30
Din Moscow,7108,7,6,6,8,20,24,-4,24
FK Rubin,7108,8,5,5,10,22,20,2,20
Rostov,7108,9,4,6,10,11,21,-10,18
Amkar,7108,10,4,6,10,11,24,-13,18
Anzhi,7108,11,2,5,13,15,40,-25,11
Loko Moscow,7109,1,12,6,2,32,13,19,42
CSKA Moscow,7109,2,12,3,5,28,17,11,39
Spart Moscow,7109,3,9,6,5,37,28,9,33
Zenit,7109,4,7,8,5,21,15,6,29
Krasnodar,7109,5,8,5,7,29,28,1,29
Terek Grozny,7109,6,7,7,6,20,22,-2,28
Din Moscow,7109,7,7,6,7,21,21,0,27
FK Rubin,7109,8,6,5,9,23,20,3,23
Rostov,7109,9,4,7,9,11,18,-7,19
Amkar,7109,10,4,5,11,10,25,-15,17
Anzhi,7109,11,2,6,12,14,39,-25,12
Loko Moscow,7110,1,12,5,3,30,12,18,41
CSKA Moscow,7110,2,12,3,5,29,18,11,39
Spart Moscow,7110,3,11,5,4,40,26,14,38
Krasnodar,7110,4,9,4,7,28,26,2,31
Zenit,7110,5,7,8,5,22,16,6,29
Terek Grozny,7110,6,7,5,8,21,26,-5,26
Din Moscow,7110,7,6,6,8,21,24,-3,24
FK Rubin,7110,8,6,5,9,23,21,2,23
Amkar,7110,9,5,4,11,12,25,-13,19
Rostov,7110,10,4,6,10,10,19,-9,18
Anzhi,7110,11,3,5,12,16,39,-23,14
Loko Moscow,7111,1,13,5,2,31,11,20,44
Spart Moscow,7111,2,11,5,4,38,26,12,38
CSKA Moscow,7111,3,11,3,6,30,19,11,36
Zenit,7111,4,8,8,4,23,15,8,32
Krasnodar,7111,5,9,4,7,29,26,3,31
Terek Grozny,7111,6,8,6,6,22,22,0,30
FK Rubin,7111,7,6,5,9,23,19,4,23
Din Moscow,7111,8,5,6,9,17,23,-6,21
Rostov,7111,9,4,6,10,11,19,-8,18
Amkar,7111,10,4,5,11,9,24,-15,17
Anzhi,7111,11,2,5,13,14,43,-29,11
Loko Moscow,7112,1,12,5,3,31,14,17,41
CSKA Moscow,7112,2,11,3,6,30,19,11,36
Zenit,7112,3,9,8,3,25,13,12,35
Spart Moscow,7112,4,9,6,5,38,28,10,33
Krasnodar,7112,5,8,4,8,29,30,-1,28
Terek Grozny,7112,6,7,5,8,20,26,-6,26
Din Moscow,7112,7,6,7,7,20,23,-3,25
FK Rubin,7112,8,6,6,8,26,19,7,24
Amkar,7112,9,5,5,10,13,23,-10,20
Rostov,7112,10,4,6,10,10,20,-10,18
Anzhi,7112,11,3,5,12,15,42,-27,14
Loko Moscow,7113,1,13,5,2,34,13,21,44
CSKA Moscow,7113,2,10,5,5,27,19,8,35
Spart Moscow,7113,3,8,7,5,35,28,7,31
Zenit,7113,4,7,9,4,22,16,6,30
Terek Grozny,7113,5,8,5,7,21,23,-2,29
Krasnodar,7113,6,8,4,8,30,30,0,28
FK Rubin,7113,7,7,5,8,26,18,8,26
Din Moscow,7113,8,5,7,8,19,25,-6,22
Amkar,7113,9,6,4,10,11,22,-11,22
Rostov,7113,10,4,7,9,10,17,-7,19
Anzhi,7113,11,2,6,12,15,39,-24,12
Loko Moscow,7114,1,13,5,2,32,12,20,44
CSKA Moscow,7114,2,11,4,5,27,18,9,37
Spart Moscow,7114,3,10,5,5,35,26,9,35
Terek Grozny,7114,4,9,5,6,25,24,1,32
Zenit,7114,5,7,9,4,22,15,7,30
Krasnodar,7114,6,8,5,7,28,26,2,29
FK Rubin,7114,7,6,6,8,23,18,5,24
Din Moscow,7114,8,5,6,9,17,23,-6,21
Amkar,7114,9,5,4,11,11,25,-14,19
Rostov,7114,10,4,6,10,10,18,-8,18
Anzhi,7114,11,2,5,13,16,41,-25,11
Loko Moscow,7115,1,11,6,3,30,17,13,39
CSKA Moscow,7115,2,12,3,5,29,18,11,39
Spart Moscow,7115,3,11,5,4,40,27,13,38
Krasnodar,7115,4,9,5,6,33,25,8,32
Zenit,7115,5,7,9,4,23,16,7,30
Terek Grozny,7115,6,8,5,7,21,23,-2,29
FK Rubin,7115,7,6,6,8,25,19,6,24
Din Moscow,7115,8,5,6,9,19,27,-8,21
Rostov,7115,9,4,6,10,10,19,-9,18
Amkar,7115,10,4,4,12,10,25,-15,16
Anzhi,7115,11,3,5,12,15,39,-24,14
Loko Moscow,7116,1,12,5,3,32,15,17,41
Spart Moscow,7116,2,11,5,4,38,26,12,38
CSKA Moscow,7116,3,11,3,6,27,20,7,36
Zenit,7116,4,8,8,4,24,16,8,32
Krasnodar,7116,5,9,5,6,30,24,6,32
Terek Grozny,7116,6,7,7,6,20,22,-2,28
Din Moscow,7116,7,6,6,8,19,22,-3,24
FK Rubin,7116,8,5,6,9,21,19,2,21
Rostov,7116,9,4,6,10,10,19,-9,18
Amkar,7116,10,4,5,11,10,24,-14,17
Anzhi,7116,11,2,6,12,15,39,-24,12
Loko Moscow,7117,1,11,5,4,31,16,15,38
CSKA Moscow,7117,2,11,4,5,29,17,12,37
Krasnodar,7117,3,10,4,6,33,26,7,34
Zenit,7117,4,8,9,3,22,13,9,33
Spart Moscow,7117,5,8,7,5,34,29,5,31
Terek Grozny,7117,6,8,6,6,23,23,0,30
Din Moscow,7117,7,7,6,7,21,21,0,27
FK Rubin,7117,8,5,5,10,21,20,1,20
Rostov,7117,9,4,7,9,10,17,-7,19
Amkar,7117,10,4,6,10,11,24,-13,18
Anzhi,7117,11,2,5,13,14,43,-29,11
Loko Moscow,7118,1,12,5,3,32,13,19,41
Krasnodar,7118,2,10,4,6,31,25,6,34
Spart Moscow,7118,3,9,6,5,36,28,8,33
CSKA Moscow,7118,4,10,3,7,26,24,2,33
Zenit,7118,5,8,8,4,23,16,7,32
Terek Grozny,7118,6,9,5,6,26,22,4,32
FK Rubin,7118,7,6,5,9,23,19,4,23
Din Moscow,7118,8,5,7,8,19,25,-6,22
Amkar,7118,9,5,4,11,10,26,-16,19
Rostov,7118,10,4,6,10,10,18,-8,18
Anzhi,7118,11,3,5,12,19,39,-20,14
Loko Moscow,7119,1,12,5,3,31,15,16,41
CSKA Moscow,7119,2,11,4,5,29,20,9,37
Zenit,7119,3,8,9,3,27,16,11,33
Spart Moscow,7119,4,9,6,5,39,30,9,33
Krasnodar,7119,5,9,4,7,31,28,3,31
Terek Grozny,7119,6,8,6,6,23,24,-1,30
FK Rubin,7119,7,6,5,9,25,20,5,23
Din Moscow,7119,8,5,6,9,17,26,-9,21
Amkar,7119,9,5,5,10,14,25,-11,20
Rostov,7119,10,4,7,9,11,18,-7,19
Anzhi,7119,11,2,5,13,15,40,-25,11
Loko Moscow,7120,1,12,6,2,33,13,20,42
Spart Moscow,7120,2,11,5,4,41,28,13,38
CSKA Moscow,7120,3,10,4,6,26,19,7,34
Zenit,7120,4,8,8,4,24,17,7,32
Krasnodar,7120,5,8,5,7,28,26,2,29
Terek Grozny,7120,6,7,6,7,24,27,-3,27
Din Moscow,7120,7,6,6,8,20,26,-6,24
FK Rubin,7120,8,6,5,9,24,20,4,23
Rostov,7120,9,4,6,10,11,19,-8,18
Amkar,7120,10,4,5,11,11,25,-14,17
Anzhi,7120,11,3,6,11,19,41,-22,15
Loko Moscow,7121,1,12,5,3,31,15,16,41
CSKA Moscow,7121,2,11,4,5,29,19,10,37
Spart Moscow,7121,3,10,5,5,39,28,11,35
Krasnodar,7121,4,10,4,6,32,25,7,34
Zenit,7121,5,7,8,5,23,18,5,29
Terek Grozny,7121,6,7,6,7,20,23,-3,27
FK Rubin,7121,7,6,5,9,24,20,4,23
Rostov,7121,8,5,6,9,11,17,-6,21
Din Moscow,7121,9,5,6,9,18,26,-8,21
Amkar,7121,10,5,4,11,12,25,-13,19
Anzhi,7121,11,2,7,11,15,38,-23,13
Loko Moscow,7122,1,11,6,3,32,15,17,39
Spart Moscow,7122,2,10,6,4,41,28,13,36
CSKA Moscow,7122,3,10,5,5,26,18,8,35
Zenit,7122,4,8,9,3,23,14,9,33
Krasnodar,7122,5,9,5,6,31,26,5,32
Terek Grozny,7122,6,9,5,6,24,22,2,32
FK Rubin,7122,7,6,5,9,23,19,4,23
Din Moscow,7122,8,5,6,9,18,27,-9,21
Rostov,7122,9,4,6,10,11,20,-9,18
Amkar,7122,10,4,5,11,10,25,-15,17
Anzhi,7122,11,2,6,12,15,40,-25,12
Loko Moscow,7123,1,12,5,3,31,13,18,41
CSKA Moscow,7123,2,11,3,6,30,21,9,36
Zenit,7123,3,9,8,3,25,14,11,35
Krasnodar,7123,4,9,4,7,30,27,3,31
Spart Moscow,7123,5,8,6,6,35,29,6,30
Terek Grozny,7123,6,8,6,6,24,25,-1,30
Din Moscow,7123,7,6,7,7,19,22,-3,25
Rostov,7123,8,5,6,9,11,17,-6,21
FK Rubin,7123,9,5,5,10,22,20,2,20
Amkar,7123,10,5,5,10,13,25,-12,20
Anzhi,7123,11,2,5,13,16,43,-27,11
Loko Moscow,7124,1,12,6,2,31,11,20,42
CSKA Moscow,7124,2,12,3,5,31,18,13,39
Spart Moscow,7124,3,8,7,5,35,28,7,31
Zenit,7124,4,7,9,4,21,14,7,30
Terek Grozny,7124,5,8,5,7,21,24,-3,29
Krasnodar,7124,6,8,4,8,27,27,0,28
Din Moscow,7124,7,7,6,7,20,22,-2,27
FK Rubin,7124,8,6,5,9,22,18,4,23
Rostov,7124,9,4,7,9,10,17,-7,19
Amkar,7124,10,4,5,11,10,24,-14,17
Anzhi,7124,11,3,5,12,17,42,-25,14
Loko Moscow,7125,1,13,5,2,32,11,21,44
CSKA Moscow,7125,2,10,5,5,26,18,8,35
Terek Grozny,7125,3,9,5,6,27,23,4,32
Spart Moscow,7125,4,8,7,5,37,30,7,31
Zenit,7125,5,7,9,4,21,15,6,30
Krasnodar,7125,6,8,4,8,28,27,1,28
Din Moscow,7125,7,6,7,7,21,23,-2,25
FK Rubin,7125,8,6,5,9,23,20,3,23
Rostov,7125,9,5,6,9,11,17,-6,21
Amkar,7125,10,4,5,11,11,27,-16,17
Anzhi,7125,11,2,6,12,16,42,-26,12
Loko Moscow,7126,1,12,6,2,32,12,20,42
CSKA Moscow,7126,2,11,3,6,31,19,12,36
Spart Moscow,7126,3,10,5,5,39,28,11,35
Zenit,7126,4,8,9,3,24,15,9,33
Krasnodar,7126,5,9,4,7,29,27,2,31
Terek Grozny,7126,6,8,5,7,24,25,-1,29
Din Moscow,7126,7,6,7,7,18,21,-3,25
FK Rubin,7126,8,5,6,9,22,19,3,21
Amkar,7126,9,5,4,11,12,26,-14,19
Rostov,7126,10,4,6,10,11,20,-9,18
Anzhi,7126,11,2,5,13,15,45,-30,11
Loko Moscow,7127,1,11,5,4,29,14,15,38
CSKA Moscow,7127,2,11,4,5,28,18,10,37
Spart Moscow,7127,3,10,6,4,39,28,11,36
Zenit,7127,4,8,9,3,24,14,10,33
Krasnodar,7127,5,9,4,7,28,25,3,31
Terek Grozny,7127,6,7,6,7,21,24,-3,27
FK Rubin,7127,7,6,6,8,23,18,5,24
Din Moscow,7127,8,5,7,8,18,24,-6,22
Rostov,7127,9,4,7,9,13,20,-7,19
Amkar,7127,10,5,4,11,10,23,-13,19
Anzhi,7127,11,2,6,12,15,40,-25,12
Loko Moscow,7128,1,12,6,2,32,12,20,42
CSKA Moscow,7128,2,11,3,6,28,21,7,36
Spart Moscow,7128,3,9,6,5,38,30,8,33
Zenit,7128,4,8,8,4,26,16,10,32
Krasnodar,7128,5,9,5,6,28,24,4,32
Terek Grozny,7128,6,7,5,8,21,25,-4,26
Din Moscow,7128,7,6,7,7,20,23,-3,25
Amkar,7128,8,6,4,10,13,23,-10,22
FK Rubin,7128,9,5,5,10,22,20,2,20
Rostov,7128,10,4,6,10,11,20,-9,18
Anzhi,7128,11,3,5,12,16,41,-25,14
Loko Moscow,7129,1,13,5,2,33,11,22,44
Spart Moscow,7129,2,9,6,5,36,28,8,33
CSKA Moscow,7129,3,10,3,7,26,20,6,33
Zenit,7129,4,8,8,4,22,16,6,32
Krasnodar,7129,5,8,4,8,28,27,1,28
Terek Grozny,7129,6,7,5,8,21,25,-4,26
Din Moscow,7129,7,6,7,7,21,23,-2,25
FK Rubin,7129,8,6,5,9,23,20,3,23
Rostov,7129,9,5,6,9,11,17,-6,21
Amkar,7129,10,5,4,11,10,23,-13,19
Anzhi,7129,11,4,5,11,18,39,-21,17
Loko Moscow,7130,1,12,6,2,31,11,20,42
CSKA Moscow,7130,2,11,3,6,27,21,6,36
Spart Moscow,7130,3,9,6,5,41,31,10,33
Zenit,7130,4,8,8,4,25,16,9,32
Krasnodar,7130,5,8,5,7,27,28,-1,29
Terek Grozny,7130,6,8,5,7,25,26,-1,29
Din Moscow,7130,7,7,6,7,22,22,0,27
FK Rubin,7130,8,6,5,9,25,19,6,23
Rostov,7130,9,4,7,9,13,20,-7,19
Amkar,7130,10,5,4,11,10,26,-16,19
Anzhi,7130,11,2,5,13,17,43,-26,11
Loko Moscow,7131,1,12,5,3,32,14,18,41
Spart Moscow,7131,2,11,5,4,39,26,13,38
CSKA Moscow,7131,3,10,5,5,25,17,8,35
Krasnodar,7131,4,9,5,6,30,26,4,32
Zenit,7131,5,7,9,4,21,14,7,30
Terek Grozny,7131,6,7,6,7,20,24,-4,27
Din Moscow,7131,7,6,6,8,18,23,-5,24
FK Rubin,7131,8,5,6,9,21,18,3,21
Rostov,7131,9,4,6,10,11,19,-8,18
Amkar,7131,10,4,5,11,9,24,-15,17
Anzhi,7131,11,3,6,11,16,37,-21,15
Loko Moscow,7132,1,11,6,3,34,17,17,39
CSKA Moscow,7132,2,11,4,5,30,21,9,37
Zenit,7132,3,7,10,3,25,17,8,31
Krasnodar,7132,4,9,4,7,31,28,3,31
Spart Moscow,7132,5,8,6,6,34,28,6,30
Terek Grozny,7132,6,8,6,6,24,24,0,30
Din Moscow,7132,7,7,6,7,21,21,0,27
FK Rubin,7132,8,6,5,9,22,20,2,23
Rostov,7132,9,5,6,9,12,18,-6,21
Amkar,7132,10,4,6,10,11,24,-13,18
Anzhi,7132,11,2,5,13,16,42,-26,11
Loko Moscow,7133,1,11,5,4,31,17,14,38
CSKA Moscow,7133,2,10,4,6,25,19,6,34
Zenit,7133,3,8,9,3,25,14,11,33
Spart Moscow,7133,4,9,6,5,37,28,9,33
Krasnodar,7133,5,9,4,7,30,27,3,31
Terek Grozny,7133,6,8,6,6,23,24,-1,30
Din Moscow,7133,7,7,6,7,20,22,-2,27
FK Rubin,7133,8,6,5,9,23,19,4,23
Rostov,7133,9,4,7,9,11,18,-7,19
Amkar,7133,10,4,5,11,11,26,-15,17
Anzhi,7133,11,3,5,12,16,38,-22,14
Loko Moscow,7134,1,11,5,4,30,14,16,38
Spart Moscow,7134,2,10,6,4,37,27,10,36
CSKA Moscow,7134,3,11,3,6,28,20,8,36
Zenit,7134,4,9,8,3,25,14,11,35
Krasnodar,7134,5,9,5,6,29,25,4,32
Terek Grozny,7134,6,8,5,7,25,26,-1,29
FK Rubin,7134,7,5,7,8,23,19,4,22
Din Moscow,7134,8,5,7,8,19,24,-5,22
Rostov,7134,9,4,7,9,11,18,-7,19
Amkar,7134,10,4,4,12,10,26,-16,16
Anzhi,7134,11,3,5,12,18,42,-24,14
Loko Moscow,7135,1,12,5,3,30,12,18,41
CSKA Moscow,7135,2,11,4,5,29,18,11,37
Spart Moscow,7135,3,10,5,5,40,31,9,35
Krasnodar,7135,4,10,4,6,30,24,6,34
Zenit,7135,5,7,9,4,21,14,7,30
Terek Grozny,7135,6,8,5,7,22,24,-2,29
FK Rubin,7135,7,6,5,9,22,19,3,23
Din Moscow,7135,8,5,6,9,18,24,-6,21
Amkar,7135,9,5,4,11,14,27,-13,19
Rostov,7135,10,4,6,10,10,18,-8,18
Anzhi,7135,11,3,5,12,17,42,-25,14
Loko Moscow,7136,1,12,5,3,30,12,18,41
CSKA Moscow,7136,2,11,3,6,27,19,8,36
Zenit,7136,3,9,8,3,24,14,10,35
Spart Moscow,7136,4,10,5,5,38,29,9,35
Krasnodar,7136,5,8,4,8,28,27,1,28
FK Rubin,7136,6,7,5,8,25,18,7,26
Terek Grozny,7136,7,7,5,8,20,25,-5,26
Din Moscow,7136,8,6,6,8,19,23,-4,24
Amkar,7136,9,5,4,11,11,25,-14,19
Rostov,7136,10,4,6,10,11,19,-8,18
Anzhi,7136,11,3,5,12,16,38,-22,14
Loko Moscow,7137,1,12,5,3,31,14,17,41
CSKA Moscow,7137,2,11,3,6,26,18,8,36
Spart Moscow,7137,3,10,5,5,39,30,9,35
Zenit,7137,4,8,8,4,23,15,8,32
Krasnodar,7137,5,9,5,6,30,25,5,32
Terek Grozny,7137,6,8,6,6,23,24,-1,30
FK Rubin,7137,7,6,6,8,23,18,5,24
Din Moscow,7137,8,5,6,9,18,25,-7,21
Amkar,7137,9,5,5,10,12,23,-11,20
Rostov,7137,10,4,6,10,12,20,-8,18
Anzhi,7137,11,2,5,13,15,40,-25,11
Loko Moscow,7138,1,13,5,2,33,12,21,44
CSKA Moscow,7138,2,11,4,5,28,18,10,37
Spart Moscow,7138,3,10,5,5,41,29,12,35
Zenit,7138,4,7,8,5,22,18,4,29
Krasnodar,7138,5,8,5,7,27,25,2,29
Terek Grozny,7138,6,8,5,7,24,26,-2,29
Din Moscow,7138,7,6,6,8,19,25,-6,24
FK Rubin,7138,8,5,6,9,22,19,3,21
Rostov,7138,9,5,6,9,14,19,-5,21
Amkar,7138,10,5,4,11,13,27,-14,19
Anzhi,7138,11,2,6,12,15,40,-25,12
Loko Moscow,7139,1,12,6,2,30,11,19,42
CSKA Moscow,7139,2,10,4,6,25,18,7,34
Spart Moscow,7139,3,9,6,5,36,27,9,33
Zenit,7139,4,8,8,4,22,14,8,32
Krasnodar,7139,5,9,5,6,28,24,4,32
Terek Grozny,7139,6,8,5,7,23,24,-1,29
FK Rubin,7139,7,6,5,9,23,19,4,23
Rostov,7139,8,5,6,9,11,17,-6,21
Din Moscow,7139,9,5,6,9,18,25,-7,21
Amkar,7139,10,4,5,11,11,26,-15,17
Anzhi,7139,11,3,6,11,15,37,-22,15
Loko Moscow,7140,1,11,5,4,29,15,14,38
CSKA Moscow,7140,2,11,3,6,28,22,6,36
Zenit,7140,3,9,8,3,27,14,13,35
Spart Moscow,7140,4,10,5,5,39,30,9,35
Krasnodar,7140,5,9,4,7,30,26,4,31
Terek Grozny,7140,6,8,6,6,23,23,0,30
Din Moscow,7140,7,6,6,8,18,22,-4,24
FK Rubin,7140,8,6,5,9,23,19,4,23
Amkar,7140,9,5,5,10,13,25,-12,20
Rostov,7140,10,4,6,10,12,20,-8,18
Anzhi,7140,11,2,5,13,15,41,-26,11
Loko Moscow,7141,1,11,7,2,30,12,18,40
CSKA Moscow,7141,2,11,3,6,28,19,9,36
Zenit,7141,3,8,9,3,24,15,9,33
Spart Moscow,7141,4,9,6,5,37,29,8,33
Terek Grozny,7141,5,9,5,6,22,22,0,32
Krasnodar,7141,6,8,6,6,28,25,3,30
FK Rubin,7141,7,6,6,8,23,18,5,24
Din Moscow,7141,8,6,6,8,20,22,-2,24
Rostov,7141,9,4,7,9,11,18,-7,19
Amkar,7141,10,4,4,12,9,26,-17,16
Anzhi,7141,11,2,5,13,14,40,-26,11
Loko Moscow,7142,1,11,7,2,31,13,18,40
Spart Moscow,7142,2,9,6,5,37,28,9,33
Zenit,7142,3,8,9,3,24,15,9,33
CSKA Moscow,7142,4,10,3,7,26,21,5,33
Krasnodar,7142,5,8,5,7,29,27,2,29
Terek Grozny,7142,6,8,5,7,23,24,-1,29
Din Moscow,7142,7,7,6,7,20,22,-2,27
FK Rubin,7142,8,6,5,9,23,19,4,23
Amkar,7142,9,5,5,10,12,24,-12,20
Rostov,7142,10,4,6,10,10,19,-9,18
Anzhi,7142,11,3,5,12,16,39,-23,14
Loko Moscow,7143,1,12,6,2,33,13,20,42
Spart Moscow,7143,2,10,6,4,38,26,12,36
CSKA Moscow,7143,3,11,3,6,31,20,11,36
Zenit,7143,4,8,9,3,25,15,10,33
Krasnodar,7143,5,9,4,7,30,27,3,31
Terek Grozny,7143,6,8,5,7,22,25,-3,29
Din Moscow,7143,7,5,8,7,17,21,-4,23
FK Rubin,7143,8,5,6,9,21,19,2,21
Amkar,7143,9,5,4,11,12,24,-12,19
Rostov,7143,10,4,6,10,10,20,-10,18
Anzhi,7143,11,2,5,13,15,44,-29,11
Loko Moscow,7144,1,12,5,3,32,12,20,41
CSKA Moscow,7144,2,12,3,5,31,19,12,39
Spart Moscow,7144,3,10,5,5,39,29,10,35
Krasnodar,7144,4,10,4,6,31,25,6,34
Terek Grozny,7144,5,9,5,6,25,22,3,32
Zenit,7144,6,7,8,5,21,18,3,29
Din Moscow,7144,7,5,7,8,20,25,-5,22
FK Rubin,7144,8,5,6,9,24,22,2,21
Amkar,7144,9,5,4,11,11,25,-14,19
Rostov,7144,10,4,6,10,11,20,-9,18
Anzhi,7144,11,2,5,13,16,44,-28,11
Loko Moscow,7145,1,12,5,3,32,15,17,41
Spart Moscow,7145,2,11,5,4,40,26,14,38
CSKA Moscow,7145,3,11,3,6,27,23,4,36
Zenit,7145,4,8,8,4,27,15,12,32
Krasnodar,7145,5,9,5,6,31,26,5,32
Terek Grozny,7145,6,8,5,7,22,23,-1,29
FK Rubin,7145,7,5,7,8,22,18,4,22
Din Moscow,7145,8,5,7,8,17,23,-6,22
Amkar,7145,9,5,4,11,11,24,-13,19
Rostov,7145,10,4,6,10,10,20,-10,18
Anzhi,7145,11,2,5,13,15,41,-26,11
Loko Moscow,7146,1,12,5,3,32,14,18,41
CSKA Moscow,7146,2,11,4,5,27,18,9,37
Spart Moscow,7146,3,9,6,5,37,28,9,33
Zenit,7146,4,8,9,3,24,15,9,33
Krasnodar,7146,5,8,4,8,28,27,1,28
Terek Grozny,7146,6,7,6,7,24,27,-3,27
Din Moscow,7146,7,6,7,7,20,23,-3,25
FK Rubin,7146,8,6,6,8,23,18,5,24
Amkar,7146,9,5,5,10,13,25,-12,20
Rostov,7146,10,4,6,10,11,20,-9,18
Anzhi,7146,11,2,6,12,15,39,-24,12
Loko Moscow,7147,1,13,5,2,32,11,21,44
CSKA Moscow,7147,2,11,4,5,29,20,9,37
Spart Moscow,7147,3,9,5,6,37,29,8,32
Krasnodar,7147,4,9,4,7,30,28,2,31
Zenit,7147,5,7,8,5,23,17,6,29
Terek Grozny,7147,6,8,5,7,22,25,-3,29
Din Moscow,7147,7,6,6,8,20,24,-4,24
FK Rubin,7147,8,6,5,9,25,21,4,23
Amkar,7147,9,5,4,11,11,24,-13,19
Rostov,7147,10,4,6,10,10,19,-9,18
Anzhi,7147,11,3,6,11,18,39,-21,15
Loko Moscow,7148,1,12,6,2,33,14,19,42
Spart Moscow,7148,2,9,7,4,38,28,10,34
CSKA Moscow,7148,3,10,4,6,25,18,7,34
Zenit,7148,4,7,10,3,22,14,8,31
Krasnodar,7148,5,8,4,8,29,28,1,28
Terek Grozny,7148,6,7,7,6,20,22,-2,28
FK Rubin,7148,7,6,6,8,22,17,5,24
Din Moscow,7148,8,5,8,7,17,21,-4,23
Rostov,7148,9,4,6,10,10,19,-9,18
Amkar,7148,10,4,6,10,12,25,-13,18
Anzhi,7148,11,3,6,11,15,37,-22,15
Loko Moscow,7149,1,11,7,2,32,14,18,40
CSKA Moscow,7149,2,12,3,5,30,18,12,39
Spart Moscow,7149,3,9,7,4,37,28,9,34
Krasnodar,7149,4,9,5,6,32,28,4,32
Zenit,7149,5,7,9,4,22,16,6,30
Terek Grozny,7149,6,7,7,6,21,23,-2,28
Din Moscow,7149,7,5,8,7,20,24,-4,23
FK Rubin,7149,8,5,6,9,24,21,3,21
Rostov,7149,9,4,7,9,11,18,-7,19
Amkar,7149,10,4,5,11,9,23,-14,17
Anzhi,7149,11,2,6,12,16,41,-25,12
Loko Moscow,7150,1,13,5,2,31,11,20,44
CSKA Moscow,7150,2,12,3,5,29,18,11,39
Spart Moscow,7150,3,11,5,4,39,27,12,38
Zenit,7150,4,7,8,5,21,16,5,29
Krasnodar,7150,5,8,5,7,28,26,2,29
Terek Grozny,7150,6,7,5,8,20,25,-5,26
FK Rubin,7150,7,6,6,8,23,18,5,24
Din Moscow,7150,8,5,6,9,17,23,-6,21
Amkar,7150,9,5,4,11,11,24,-13,19
Rostov,7150,10,4,6,10,11,20,-9,18
Anzhi,7150,11,3,5,12,17,39,-22,14
Loko Moscow,7151,1,11,6,3,30,14,16,39
CSKA Moscow,7151,2,11,4,5,26,17,9,37
Krasnodar,7151,3,10,4,6,30,24,6,34
Spart Moscow,7151,4,9,5,6,36,29,7,32
Zenit,7151,5,7,10,3,22,14,8,31
Din Moscow,7151,6,7,6,7,21,23,-2,27
Terek Grozny,7151,7,7,5,8,21,26,-5,26
Amkar,7151,8,6,4,10,12,23,-11,22
FK Rubin,7151,9,5,5,10,23,21,2,20
Rostov,7151,10,4,6,10,11,19,-8,18
Anzhi,7151,11,3,5,12,17,39,-22,14
Loko Moscow,7152,1,12,6,2,31,12,19,42
CSKA Moscow,7152,2,12,3,5,28,17,11,39
Spart Moscow,7152,3,10,5,5,37,29,8,35
Krasnodar,7152,4,9,5,6,31,25,6,32
Zenit,7152,5,7,8,5,21,16,5,29
Terek Grozny,7152,6,8,5,7,24,25,-1,29
Din Moscow,7152,7,6,6,8,19,23,-4,24
FK Rubin,7152,8,5,5,10,21,21,0,20
Amkar,7152,9,5,4,11,13,25,-12,19
Rostov,7152,10,4,6,10,10,19,-9,18
Anzhi,7152,11,3,5,12,16,39,-23,14
Loko Moscow,7153,1,11,5,4,30,16,14,38
Zenit,7153,2,9,8,3,25,14,11,35
CSKA Moscow,7153,3,10,4,6,26,19,7,34
Krasnodar,7153,4,9,4,7,31,28,3,31
Spart Moscow,7153,5,8,5,7,33,30,3,29
Terek Grozny,7153,6,7,6,7,20,23,-3,27
Din Moscow,7153,7,6,7,7,20,23,-3,25
FK Rubin,7153,8,6,6,8,27,21,6,24
Amkar,7153,9,6,4,10,11,22,-11,22
Rostov,7153,10,5,6,9,13,17,-4,21
Anzhi,7153,11,2,7,11,15,38,-23,13
Loko Moscow,7154,1,11,5,4,30,14,16,38
Spart Moscow,7154,2,11,5,4,39,27,12,38
CSKA Moscow,7154,3,11,3,6,28,22,6,36
Zenit,7154,4,9,8,3,27,14,13,35
Krasnodar,7154,5,10,4,6,30,24,6,34
Terek Grozny,7154,6,7,6,7,21,27,-6,27
Din Moscow,7154,7,6,6,8,19,23,-4,24
FK Rubin,7154,8,5,5,10,21,20,1,20
Amkar,7154,9,5,4,11,14,25,-11,19
Rostov,7154,10,4,6,10,10,18,-8,18
Anzhi,7154,11,2,6,12,16,41,-25,12
Loko Moscow,7155,1,12,6,2,31,12,19,42
CSKA Moscow,7155,2,11,3,6,26,18,8,36
Zenit,7155,3,8,8,4,22,14,8,32
Spart Moscow,7155,4,9,5,6,38,32,6,32
Krasnodar,7155,5,8,6,6,28,25,3,30
Din Moscow,7155,6,7,6,7,20,22,-2,27
Terek Grozny,7155,7,7,6,7,20,23,-3,27
FK Rubin,7155,8,5,6,9,21,18,3,21
Amkar,7155,9,5,5,10,13,24,-11,20
Rostov,7155,10,4,6,10,11,19,-8,18
Anzhi,7155,11,3,5,12,15,38,-23,14
Loko Moscow,7156,1,11,6,3,31,14,17,39
CSKA Moscow,7156,2,12,3,5,29,17,12,39
Spart Moscow,7156,3,9,7,4,38,28,10,34
Krasnodar,7156,4,10,4,6,31,26,5,34
Zenit,7156,5,7,9,4,22,16,6,30
Terek Grozny,7156,6,7,6,7,20,23,-3,27
Din Moscow,7156,7,5,8,7,19,23,-4,23
FK Rubin,7156,8,5,6,9,23,20,3,21
Rostov,7156,9,4,6,10,10,19,-9,18
Amkar,7156,10,4,6,10,11,24,-13,18
Anzhi,7156,11,3,5,12,15,39,-24,14
Loko Moscow,7157,1,12,6,2,31,12,19,42
CSKA Moscow,7157,2,12,3,5,30,18,12,39
Spart Moscow,7157,3,9,6,5,37,27,10,33
Krasnodar,7157,4,9,5,6,33,27,6,32
Zenit,7157,5,7,8,5,22,16,6,29
Terek Grozny,7157,6,7,6,7,21,24,-3,27
Din Moscow,7157,7,6,6,8,18,23,-5,24
FK Rubin,7157,8,6,5,9,25,22,3,23
Amkar,7157,9,5,5,10,11,23,-12,20
Rostov,7157,10,4,6,10,10,20,-10,18
Anzhi,7157,11,2,6,12,15,41,-26,12
Loko Moscow,7158,1,11,5,4,30,14,16,38
Spart Moscow,7158,2,10,6,4,37,26,11,36
Zenit,7158,3,9,8,3,24,14,10,35
Krasnodar,7158,4,10,4,6,32,26,6,34
CSKA Moscow,7158,5,10,3,7,26,22,4,33
Terek Grozny,7158,6,9,5,6,24,23,1,32
Din Moscow,7158,7,6,6,8,18,23,-5,24
FK Rubin,7158,8,5,5,10,22,21,1,20
Rostov,7158,9,4,7,9,11,18,-7,19
Amkar,7158,10,4,4,12,10,25,-15,16
Anzhi,7158,11,3,5,12,17,39,-22,14
Loko Moscow,7159,1,11,5,4,30,15,15,38
CSKA Moscow,7159,2,11,3,6,28,19,9,36
Zenit,7159,3,9,8,3,24,14,10,35
Spart Moscow,7159,4,9,5,6,37,31,6,32
Krasnodar,7159,5,9,5,6,30,25,5,32
Terek Grozny,7159,6,7,5,8,20,25,-5,26
Din Moscow,7159,7,6,7,7,22,23,-1,25
FK Rubin,7159,8,5,7,8,22,18,4,22
Amkar,7159,9,6,4,10,12,23,-11,22
Rostov,7159,10,4,6,10,10,19,-9,18
Anzhi,7159,11,3,5,12,16,39,-23,14
Loko Moscow,7160,1,11,6,3,29,13,16,39
CSKA Moscow,7160,2,11,4,5,27,18,9,37
Spart Moscow,7160,3,10,6,4,41,28,13,36
Zenit,7160,4,8,8,4,23,14,9,32
Krasnodar,7160,5,9,5,6,30,24,6,32
Terek Grozny,7160,6,7,5,8,23,28,-5,26
Din Moscow,7160,7,5,7,8,19,27,-8,22
FK Rubin,7160,8,5,6,9,22,21,1,21
Rostov,7160,9,4,7,9,12,19,-7,19
Amkar,7160,10,5,4,11,12,25,-13,19
Anzhi,7160,11,3,6,11,18,39,-21,15
Loko Moscow,7161,1,12,5,3,33,13,20,41
CSKA Moscow,7161,2,12,3,5,27,17,10,39
Spart Moscow,7161,3,9,7,4,39,28,11,34
Zenit,7161,4,8,8,4,23,15,8,32
Krasnodar,7161,5,9,4,7,30,27,3,31
Terek Grozny,7161,6,7,5,8,20,28,-8,26
Din Moscow,7161,7,6,7,7,19,22,-3,25
FK Rubin,7161,8,5,5,10,21,21,0,20
Rostov,7161,9,4,7,9,11,18,-7,19
Amkar,7161,10,5,4,11,14,26,-12,19
Anzhi,7161,11,3,5,12,16,38,-22,14
Loko Moscow,7162,1,11,6,3,31,15,16,39
Spart Moscow,7162,2,10,5,5,38,27,11,35
Zenit,7162,3,8,9,3,25,15,10,33
CSKA Moscow,7162,4,10,3,7,26,22,4,33
Krasnodar,7162,5,9,4,7,30,26,4,31
Terek Grozny,7162,6,8,5,7,23,24,-1,29
Din Moscow,7162,7,6,6,8,18,22,-4,24
FK Rubin,7162,8,6,5,9,22,18,4,23
Amkar,7162,9,6,4,10,12,23,-11,22
Rostov,7162,10,4,6,10,10,20,-10,18
Anzhi,7162,11,3,5,12,17,40,-23,14
Loko Moscow,7163,1,11,6,3,29,12,17,39
Zenit,7163,2,9,8,3,24,13,11,35
CSKA Moscow,7163,3,10,4,6,28,22,6,34
Spart Moscow,7163,4,9,5,6,35,28,7,32
Krasnodar,7163,5,8,5,7,28,27,1,29
Terek Grozny,7163,6,7,6,7,20,23,-3,27
FK Rubin,7163,7,7,5,8,25,18,7,26
Din Moscow,7163,8,6,6,8,19,23,-4,24
Amkar,7163,9,6,4,10,11,22,-11,22
Rostov,7163,10,4,6,10,10,18,-8,18
Anzhi,7163,11,2,7,11,17,40,-23,13
Loko Moscow,7164,1,11,6,3,30,14,16,39
CSKA Moscow,7164,2,11,4,5,29,19,10,37
Spart Moscow,7164,3,9,5,6,36,29,7,32
Krasnodar,7164,4,9,5,6,32,27,5,32
Zenit,7164,5,7,10,3,22,14,8,31
Terek Grozny,7164,6,8,5,7,22,23,-1,29
FK Rubin,7164,7,5,7,8,24,20,4,22
Din Moscow,7164,8,5,7,8,18,23,-5,22
Rostov,7164,9,5,6,9,11,17,-6,21
Amkar,7164,10,5,4,11,12,26,-14,19
Anzhi,7164,11,3,5,12,16,40,-24,14
Loko Moscow,7165,1,12,6,2,34,12,22,42
CSKA Moscow,7165,2,11,4,5,28,18,10,37
Spart Moscow,7165,3,10,6,4,39,28,11,36
Zenit,7165,4,7,10,3,21,13,8,31
Krasnodar,7165,5,8,5,7,31,32,-1,29
Terek Grozny,7165,6,7,5,8,21,25,-4,26
Din Moscow,7165,7,6,6,8,22,25,-3,24
FK Rubin,7165,8,5,6,9,25,23,2,21
Amkar,7165,9,5,5,10,11,23,-12,20
Rostov,7165,10,4,6,10,10,19,-9,18
Anzhi,7165,11,3,5,12,17,41,-24,14
Loko Moscow,7166,1,12,5,3,31,14,17,41
CSKA Moscow,7166,2,11,4,5,27,17,10,37
Spart Moscow,7166,3,9,7,4,36,27,9,34
Krasnodar,7166,4,9,4,7,30,26,4,31
Zenit,7166,5,7,9,4,21,14,7,30
Terek Grozny,7166,6,7,5,8,21,26,-5,26
FK Rubin,7166,7,6,6,8,22,17,5,24
Din Moscow,7166,8,5,7,8,17,22,-5,22
Amkar,7166,9,5,5,10,12,24,-12,20
Rostov,7166,10,4,7,9,11,18,-7,19
Anzhi,7166,11,3,5,12,16,39,-23,14
Loko Moscow,7167,1,11,7,2,30,12,18,40
CSKA Moscow,7167,2,11,3,6,27,18,9,36
Spart Moscow,7167,3,10,5,5,39,30,9,35
Zenit,7167,4,8,9,3,23,14,9,33
Krasnodar,7167,5,9,5,6,29,25,4,32
Terek Grozny,7167,6,9,5,6,25,23,2,32
Din Moscow,7167,7,6,6,8,20,23,-3,24
FK Rubin,7167,8,5,5,10,22,21,1,20
Amkar,7167,9,5,4,11,13,26,-13,19
Rostov,7167,10,4,6,10,11,19,-8,18
Anzhi,7167,11,2,5,13,14,42,-28,11
Loko Moscow,7168,1,13,5,2,32,11,21,44
CSKA Moscow,7168,2,11,4,5,28,19,9,37
Spart Moscow,7168,3,9,6,5,35,28,7,33
Terek Grozny,7168,4,9,5,6,24,23,1,32
Zenit,7168,5,7,9,4,22,15,7,30
Krasnodar,7168,6,8,4,8,29,29,0,28
FK Rubin,7168,7,6,6,8,25,20,5,24
Din Moscow,7168,8,5,8,7,18,22,-4,23
Amkar,7168,9,5,4,11,12,25,-13,19
Rostov,7168,10,4,6,10,11,19,-8,18
Anzhi,7168,11,2,5,13,15,40,-25,11
Loko Moscow,7169,1,13,5,2,31,11,20,44
CSKA Moscow,7169,2,11,3,6,28,21,7,36
Spart Moscow,7169,3,9,6,5,35,27,8,33
Zenit,7169,4,8,8,4,24,14,10,32
Krasnodar,7169,5,8,4,8,27,26,1,28
FK Rubin,7169,6,7,5,8,23,17,6,26
Terek Grozny,7169,7,7,5,8,21,26,-5,26
Amkar,7169,8,6,4,10,12,22,-10,22
Din Moscow,7169,9,5,6,9,17,24,-7,21
Rostov,7169,10,4,7,9,10,17,-7,19
Anzhi,7169,11,3,5,12,18,41,-23,14
Loko Moscow,7170,1,12,6,2,34,13,21,42
CSKA Moscow,7170,2,11,4,5,30,21,9,37
Spart Moscow,7170,3,9,6,5,35,27,8,33
Zenit,7170,4,7,10,3,26,18,8,31
Krasnodar,7170,5,9,4,7,28,27,1,31
Terek Grozny,7170,6,8,5,7,23,23,0,29
FK Rubin,7170,7,6,5,9,23,19,4,23
Din Moscow,7170,8,5,6,9,19,25,-6,21
Rostov,7170,9,4,7,9,10,17,-7,19
Amkar,7170,10,5,4,11,10,25,-15,19
Anzhi,7170,11,3,5,12,16,39,-23,14
Loko Moscow,7171,1,13,5,2,33,13,20,44
Spart Moscow,7171,2,11,5,4,38,25,13,38
CSKA Moscow,7171,3,11,3,6,30,21,9,36
Zenit,7171,4,8,8,4,24,16,8,32
Terek Grozny,7171,5,9,5,6,26,26,0,32
Krasnodar,7171,6,8,5,7,28,26,2,29
FK Rubin,7171,7,6,6,8,22,17,5,24
Din Moscow,7171,8,5,6,9,17,23,-6,21
Rostov,7171,9,4,6,10,10,20,-10,18
Amkar,7171,10,4,4,12,11,26,-15,16
Anzhi,7171,11,2,5,13,18,44,-26,11
Loko Moscow,7172,1,12,6,2,31,11,20,42
CSKA Moscow,7172,2,11,4,5,30,18,12,37
Spart Moscow,7172,3,10,5,5,39,29,10,35
Zenit,7172,4,7,10,3,22,14,8,31
Krasnodar,7172,5,8,5,7,28,27,1,29
Terek Grozny,7172,6,7,7,6,21,23,-2,28
FK Rubin,7172,7,6,6,8,24,19,5,24
Din Moscow,7172,8,5,6,9,19,25,-6,21
Amkar,7172,9,5,5,10,11,23,-12,20
Rostov,7172,10,4,6,10,12,21,-9,18
Anzhi,7172,11,2,6,12,14,41,-27,12
Loko Moscow,7173,1,11,5,4,29,13,16,38
CSKA Moscow,7173,2,11,4,5,28,19,9,37
Zenit,7173,3,8,9,3,23,14,9,33
Krasnodar,7173,4,9,5,6,28,24,4,32
Terek Grozny,7173,5,8,6,6,23,24,-1,30
Spart Moscow,7173,6,8,5,7,34,32,2,29
FK Rubin,7173,7,6,6,8,22,17,5,24
Din Moscow,7173,8,6,6,8,21,23,-2,24
Rostov,7173,9,5,6,9,11,17,-6,21
Amkar,7173,10,5,4,11,11,23,-12,19
Anzhi,7173,11,2,6,12,17,41,-24,12
Loko Moscow,7174,1,12,5,3,31,13,18,41
CSKA Moscow,7174,2,11,3,6,29,19,10,36
Zenit,7174,3,9,8,3,23,13,10,35
Spart Moscow,7174,4,8,7,5,36,29,7,31
Terek Grozny,7174,5,8,6,6,22,23,-1,30
Krasnodar,7174,6,8,5,7,29,27,2,29
Din Moscow,7174,7,5,8,7,20,24,-4,23
FK Rubin,7174,8,5,7,8,23,19,4,22
Amkar,7174,9,5,5,10,10,22,-12,20
Rostov,7174,10,4,7,9,11,18,-7,19
Anzhi,7174,11,2,5,13,16,43,-27,11
Loko Moscow,7175,1,11,5,4,29,17,12,38
Zenit,7175,2,9,8,3,25,13,12,35
CSKA Moscow,7175,3,10,3,7,25,20,5,33
Spart Moscow,7175,4,8,7,5,35,28,7,31
Krasnodar,7175,5,9,4,7,32,27,5,31
Terek Grozny,7175,6,7,6,7,23,26,-3,27
Din Moscow,7175,7,6,7,7,20,23,-3,25
FK Rubin,7175,8,6,5,9,24,19,5,23
Amkar,7175,9,5,5,10,11,23,-12,20
Rostov,7175,10,4,7,9,10,17,-7,19
Anzhi,7175,11,4,5,11,18,39,-21,17
CSKA Moscow,7176,1,12,3,5,27,17,10,39
Loko Moscow,7176,2,11,5,4,32,16,16,38
Zenit,7176,3,8,8,4,24,16,8,32
Spart Moscow,7176,4,9,5,6,38,31,7,32
Krasnodar,7176,5,9,5,6,29,25,4,32
Terek Grozny,7176,6,8,5,7,22,25,-3,29
Din Moscow,7176,7,6,6,8,23,26,-3,24
FK Rubin,7176,8,5,6,9,22,20,2,21
Rostov,7176,9,5,6,9,11,17,-6,21
Amkar,7176,10,5,4,11,12,25,-13,19
Anzhi,7176,11,3,5,12,16,38,-22,14
Loko Moscow,7177,1,12,6,2,31,12,19,42
Spart Moscow,7177,2,10,5,5,41,29,12,35
CSKA Moscow,7177,3,10,3,7,26,21,5,33
Zenit,7177,4,8,8,4,25,16,9,32
Krasnodar,7177,5,9,5,6,29,25,4,32
Terek Grozny,7177,6,8,6,6,24,25,-1,30
FK Rubin,7177,7,6,5,9,23,19,4,23
Din Moscow,7177,8,5,6,9,17,23,-6,21
Amkar,7177,9,5,4,11,11,24,-13,19
Rostov,7177,10,4,6,10,12,23,-11,18
Anzhi,7177,11,3,6,11,18,40,-22,15
Loko Moscow,7178,1,12,6,2,30,11,19,42
CSKA Moscow,7178,2,11,3,6,27,19,8,36
Zenit,7178,3,8,8,4,23,14,9,32
Spart Moscow,7178,4,9,5,6,39,31,8,32
Krasnodar,7178,5,9,5,6,30,25,5,32
Terek Grozny,7178,6,7,6,7,21,25,-4,27
Din Moscow,7178,7,6,6,8,20,26,-6,24
Rostov,7178,8,5,6,9,13,18,-5,21
FK Rubin,7178,9,5,5,10,23,22,1,20
Amkar,7178,10,5,5,10,12,24,-12,20
Anzhi,7178,11,3,5,12,16,39,-23,14
Loko Moscow,7179,1,11,6,3,30,13,17,39
Zenit,7179,2,8,9,3,25,15,10,33
Spart Moscow,7179,3,9,6,5,37,29,8,33
CSKA Moscow,7179,4,10,3,7,26,21,5,33
Krasnodar,7179,5,9,4,7,31,28,3,31
Terek Grozny,7179,6,8,6,6,22,23,-1,30
Din Moscow,7179,7,6,7,7,20,22,-2,25
FK Rubin,7179,8,6,6,8,25,20,5,24
Rostov,7179,9,4,6,10,11,20,-9,18
Amkar,7179,10,4,6,10,9,22,-13,18
Anzhi,7179,11,3,5,12,16,39,-23,14
Loko Moscow,7180,1,12,5,3,33,14,19,41
CSKA Moscow,7180,2,12,3,5,28,17,11,39
Krasnodar,7180,3,10,4,6,30,25,5,34
Spart Moscow,7180,4,9,6,5,41,29,12,33
Terek Grozny,7180,5,9,5,6,23,23,0,32
Zenit,7180,6,7,8,5,22,17,5,29
Din Moscow,7180,7,5,8,7,17,21,-4,23
FK Rubin,7180,8,5,6,9,21,18,3,21
Amkar,7180,9,5,4,11,13,26,-13,19
Rostov,7180,10,4,6,10,10,22,-12,18
Anzhi,7180,11,2,5,13,15,41,-26,11
Loko Moscow,7181,1,12,6,2,32,13,19,42
CSKA Moscow,7181,2,11,4,5,29,17,12,37
Spart Moscow,7181,3,10,6,4,36,26,10,36
Krasnodar,7181,4,9,5,6,31,27,4,32
Terek Grozny,7181,5,9,5,6,23,22,1,32
Zenit,7181,6,7,9,4,21,14,7,30
Din Moscow,7181,7,5,7,8,18,23,-5,22
FK Rubin,7181,8,5,6,9,23,20,3,21
Rostov,7181,9,4,6,10,10,18,-8,18
Amkar,7181,10,4,5,11,10,24,-14,17
Anzhi,7181,11,2,5,13,14,43,-29,11
Loko Moscow,7182,1,12,5,3,31,12,19,41
Zenit,7182,2,9,8,3,25,13,12,35
Spart Moscow,7182,3,9,6,5,40,31,9,33
CSKA Moscow,7182,4,10,3,7,26,22,4,33
Terek Grozny,7182,5,8,5,7,21,24,-3,29
Krasnodar,7182,6,8,4,8,27,28,-1,28
Din Moscow,7182,7,7,6,7,22,22,0,27
FK Rubin,7182,8,6,5,9,23,19,4,23
Rostov,7182,9,4,7,9,11,18,-7,19
Amkar,7182,10,5,4,11,13,27,-14,19
Anzhi,7182,11,3,5,12,16,39,-23,14
Loko Moscow,7183,1,13,5,2,33,12,21,44
CSKA Moscow,7183,2,11,4,5,31,18,13,37
Spart Moscow,7183,3,9,7,4,37,28,9,34
Krasnodar,7183,4,9,4,7,29,27,2,31
Zenit,7183,5,7,9,4,22,15,7,30
Terek Grozny,7183,6,8,6,6,26,24,2,30
Din Moscow,7183,7,6,6,8,20,23,-3,24
FK Rubin,7183,8,5,5,10,21,20,1,20
Rostov,7183,9,4,7,9,11,18,-7,19
Amkar,7183,10,4,6,10,12,25,-13,18
Anzhi,7183,11,2,5,13,14,46,-32,11
Loko Moscow,7184,1,11,6,3,29,14,15,39
CSKA Moscow,7184,2,10,4,6,25,18,7,34
Zenit,7184,3,8,9,3,22,13,9,33
Spart Moscow,7184,4,9,6,5,37,29,8,33
Krasnodar,7184,5,9,4,7,30,26,4,31
Terek Grozny,7184,6,8,6,6,21,22,-1,30
FK Rubin,7184,7,7,5,8,24,17,7,26
Din Moscow,7184,8,5,6,9,17,23,-6,21
Rostov,7184,9,4,7,9,11,18,-7,19
Amkar,7184,10,5,4,11,12,25,-13,19
Anzhi,7184,11,2,7,11,14,37,-23,13
Loko Moscow,7185,1,12,6,2,33,14,19,42
Spart Moscow,7185,2,10,6,4,39,28,11,36
CSKA Moscow,7185,3,10,5,5,27,19,8,35
Zenit,7185,4,7,9,4,22,15,7,30
Krasnodar,7185,5,8,6,6,30,27,3,30
Terek Grozny,7185,6,7,7,6,22,24,-2,28
FK Rubin,7185,7,5,7,8,22,18,4,22
Din Moscow,7185,8,5,7,8,18,24,-6,22
Rostov,7185,9,4,6,10,11,19,-8,18
Amkar,7185,10,4,6,10,12,25,-13,18
Anzhi,7185,11,2,7,11,16,39,-23,13
Loko Moscow,7186,1,12,6,2,35,16,19,42
Spart Moscow,7186,2,11,5,4,40,27,13,38
CSKA Moscow,7186,3,11,3,6,29,21,8,36
Zenit,7186,4,8,9,3,26,15,11,33
Krasnodar,7186,5,9,4,7,33,29,4,31
Terek Grozny,7186,6,7,6,7,22,27,-5,27
FK Rubin,7186,7,6,5,9,24,21,3,23
Din Moscow,7186,8,5,6,9,19,25,-6,21
Rostov,7186,9,4,6,10,10,19,-9,18
Amkar,7186,10,4,5,11,10,25,-15,17
Anzhi,7186,11,3,5,12,20,43,-23,14
Loko Moscow,7187,1,13,5,2,31,11,20,44
Spart Moscow,7187,2,11,5,4,39,27,12,38
CSKA Moscow,7187,3,11,3,6,28,19,9,36
Zenit,7187,4,8,8,4,23,15,8,32
Krasnodar,7187,5,9,4,7,29,25,4,31
Terek Grozny,7187,6,8,5,7,21,23,-2,29
Din Moscow,7187,7,5,7,8,17,23,-6,22
FK Rubin,7187,8,5,6,9,21,19,2,21
Amkar,7187,9,5,4,11,10,23,-13,19
Rostov,7187,10,4,6,10,12,20,-8,18
Anzhi,7187,11,2,5,13,14,40,-26,11
Loko Moscow,7188,1,13,5,2,31,11,20,44
Spart Moscow,7188,2,10,5,5,36,27,9,35
CSKA Moscow,7188,3,10,4,6,28,22,6,34
Zenit,7188,4,8,8,4,23,14,9,32
Terek Grozny,7188,5,8,6,6,21,22,-1,30
Krasnodar,7188,6,8,5,7,27,25,2,29
Din Moscow,7188,7,6,6,8,18,22,-4,24
FK Rubin,7188,8,5,6,9,21,18,3,21
Amkar,7188,9,5,4,11,11,23,-12,19
Rostov,7188,10,4,6,10,10,19,-9,18
Anzhi,7188,11,2,7,11,17,40,-23,13
Loko Moscow,7189,1,12,6,2,31,12,19,42
CSKA Moscow,7189,2,11,3,6,26,19,7,36
Spart Moscow,7189,3,10,5,5,37,29,8,35
Zenit,7189,4,8,9,3,23,13,10,33
Terek Grozny,7189,5,8,6,6,23,23,0,30
Krasnodar,7189,6,8,4,8,28,28,0,28
FK Rubin,7189,7,7,5,8,26,19,7,26
Din Moscow,7189,8,5,6,9,19,25,-6,21
Amkar,7189,9,5,5,10,13,23,-10,20
Rostov,7189,10,4,6,10,11,20,-9,18
Anzhi,7189,11,2,5,13,14,40,-26,11
Loko Moscow,7190,1,12,6,2,30,11,19,42
Spart Moscow,7190,2,10,5,5,41,30,11,35
Zenit,7190,3,8,9,3,23,13,10,33
CSKA Moscow,7190,4,10,3,7,25,20,5,33
Krasnodar,7190,5,9,4,7,29,25,4,31
Terek Grozny,7190,6,8,6,6,23,24,-1,30
Din Moscow,7190,7,6,6,8,19,25,-6,24
Rostov,7190,8,5,6,9,13,19,-6,21
FK Rubin,7190,9,5,5,10,21,20,1,20
Amkar,7190,10,4,4,12,11,26,-15,16
Anzhi,7190,11,3,6,11,16,38,-22,15
Loko Moscow,7191,1,12,5,3,32,15,17,41
Spart Moscow,7191,2,10,6,4,37,25,12,36
CSKA Moscow,7191,3,11,3,6,29,22,7,36
Krasnodar,7191,4,10,4,6,31,24,7,34
Terek Grozny,7191,5,9,5,6,24,23,1,32
Zenit,7191,6,7,8,5,25,19,6,29
FK Rubin,7191,7,6,5,9,23,20,3,23
Din Moscow,7191,8,5,6,9,18,25,-7,21
Rostov,7191,9,4,6,10,10,19,-9,18
Amkar,7191,10,4,5,11,9,24,-15,17
Anzhi,7191,11,3,5,12,18,40,-22,14
Loko Moscow,7192,1,12,5,3,30,13,17,41
CSKA Moscow,7192,2,11,4,5,28,18,10,37
Spart Moscow,7192,3,10,6,4,39,28,11,36
Zenit,7192,4,8,8,4,23,15,8,32
Krasnodar,7192,5,8,4,8,27,26,1,28
Terek Grozny,7192,6,7,6,7,21,25,-4,27
FK Rubin,7192,7,7,5,8,23,17,6,26
Din Moscow,7192,8,5,7,8,19,24,-5,22
Rostov,7192,9,4,6,10,10,19,-9,18
Amkar,7192,10,4,5,11,10,24,-14,17
Anzhi,7192,11,3,6,11,18,39,-21,15
Loko Moscow,7193,1,12,5,3,32,13,19,41
Spart Moscow,7193,2,10,6,4,41,27,14,36
CSKA Moscow,7193,3,11,3,6,28,20,8,36
Zenit,7193,4,9,8,3,25,15,10,35
Krasnodar,7193,5,8,5,7,28,27,1,29
Terek Grozny,7193,6,7,7,6,22,24,-2,28
FK Rubin,7193,7,6,6,8,22,17,5,24
Din Moscow,7193,8,5,6,9,18,26,-8,21
Rostov,7193,9,4,6,10,10,20,-10,18
Amkar,7193,10,4,6,10,12,25,-13,18
Anzhi,7193,11,2,6,12,14,38,-24,12
Loko Moscow,7194,1,13,5,2,32,11,21,44
CSKA Moscow,7194,2,11,4,5,29,19,10,37
Spart Moscow,7194,3,9,5,6,39,29,10,32
Krasnodar,7194,4,9,4,7,30,26,4,31
Zenit,7194,5,7,9,4,22,16,6,30
Terek Grozny,7194,6,8,6,6,23,24,-1,30
Din Moscow,7194,7,7,6,7,23,23,0,27
Rostov,7194,8,5,6,9,11,17,-6,21
FK Rubin,7194,9,5,5,10,22,23,-1,20
Amkar,7194,10,4,5,11,11,28,-17,17
Anzhi,7194,11,2,5,13,15,41,-26,11
Loko Moscow,7195,1,12,6,2,33,14,19,42
CSKA Moscow,7195,2,11,3,6,28,20,8,36
Zenit,7195,3,8,9,3,25,16,9,33
Spart Moscow,7195,4,9,5,6,36,31,5,32
Krasnodar,7195,5,9,4,7,31,27,4,31
Terek Grozny,7195,6,8,6,6,25,25,0,30
Din Moscow,7195,7,6,6,8,20,22,-2,24
FK Rubin,7195,8,6,5,9,23,20,3,23
Amkar,7195,9,5,5,10,13,25,-12,20
Rostov,7195,10,4,6,10,11,19,-8,18
Anzhi,7195,11,2,5,13,16,42,-26,11
Loko Moscow,7196,1,12,6,2,33,13,20,42
CSKA Moscow,7196,2,10,4,6,29,22,7,34
Zenit,7196,3,8,8,4,25,18,7,32
Spart Moscow,7196,4,8,7,5,36,31,5,31
Krasnodar,7196,5,8,5,7,28,28,0,29
Terek Grozny,7196,6,8,5,7,21,25,-4,29
Din Moscow,7196,7,6,7,7,20,23,-3,25
FK Rubin,7196,8,6,5,9,24,18,6,23
Amkar,7196,9,6,4,10,15,22,-7,22
Rostov,7196,10,4,7,9,11,18,-7,19
Anzhi,7196,11,2,6,12,16,40,-24,12
Loko Moscow,7197,1,13,5,2,32,11,21,44
Spart Moscow,7197,2,9,6,5,37,29,8,33
CSKA Moscow,7197,3,10,3,7,26,21,5,33
Zenit,7197,4,8,8,4,24,15,9,32
Krasnodar,7197,5,9,4,7,28,26,2,31
Terek Grozny,7197,6,8,6,6,23,23,0,30
Din Moscow,7197,7,6,6,8,21,24,-3,24
Rostov,7197,8,5,6,9,12,18,-6,21
FK Rubin,7197,9,5,5,10,22,21,1,20
Amkar,7197,10,4,5,11,11,26,-15,17
Anzhi,7197,11,3,6,11,15,37,-22,15
Loko Moscow,7198,1,11,6,3,30,13,17,39
CSKA Moscow,7198,2,11,4,5,27,18,9,37
Spart Moscow,7198,3,10,5,5,36,27,9,35
Zenit,7198,4,8,9,3,23,14,9,33
Terek Grozny,7198,5,9,5,6,22,22,0,32
Krasnodar,7198,6,8,5,7,30,28,2,29
Din Moscow,7198,7,6,6,8,19,23,-4,24
FK Rubin,7198,8,6,5,9,25,21,4,23
Rostov,7198,9,5,6,9,12,18,-6,21
Amkar,7198,10,4,4,12,9,24,-15,16
Anzhi,7198,11,2,5,13,14,39,-25,11
Loko Moscow,7199,1,12,6,2,37,17,20,42
CSKA Moscow,7199,2,12,3,5,28,18,10,39
Spart Moscow,7199,3,10,6,4,39,27,12,36
Zenit,7199,4,7,8,5,25,20,5,29
Krasnodar,7199,5,8,5,7,30,29,1,29
Terek Grozny,7199,6,8,5,7,22,24,-2,29
FK Rubin,7199,7,6,6,8,24,18,6,24
Din Moscow,7199,8,5,7,8,18,23,-5,22
Rostov,7199,9,4,7,9,12,19,-7,19
Amkar,7199,10,5,4,11,10,25,-15,19
Anzhi,7199,11,2,5,13,15,40,-25,11
Loko Moscow,7200,1,11,7,2,32,14,18,40
Spart Moscow,7200,2,11,5,4,38,26,12,38
CSKA Moscow,7200,3,11,4,5,28,17,11,37
Zenit,7200,4,7,10,3,22,14,8,31
Krasnodar,7200,5,8,5,7,29,28,1,29
FK Rubin,7200,6,7,5,8,25,17,8,26
Terek Grozny,7200,7,7,5,8,21,25,-4,26
Din Moscow,7200,8,5,6,9,18,25,-7,21
Amkar,7200,9,5,4,11,10,24,-14,19
Rostov,7200,10,4,6,10,10,18,-8,18
Anzhi,7200,11,3,5,12,16,41,-25,14
Loko Moscow,7201,1,12,6,2,31,12,19,42
CSKA Moscow,7201,2,11,4,5,26,17,9,37
Spart Moscow,7201,3,9,5,6,35,28,7,32
Krasnodar,7201,4,9,5,6,30,26,4,32
Zenit,7201,5,7,8,5,22,16,6,29
Terek Grozny,7201,6,8,5,7,22,24,-2,29
FK Rubin,7201,7,6,5,9,24,20,4,23
Amkar,7201,8,6,4,10,13,24,-11,22
Din Moscow,7201,9,5,6,9,17,23,-6,21
Rostov,7201,10,5,6,9,11,17,-6,21
Anzhi,7201,11,2,6,12,14,38,-24,12
Loko Moscow,7202,1,12,6,2,32,12,20,42
CSKA Moscow,7202,2,11,3,6,27,21,6,36
Spart Moscow,7202,3,9,7,4,39,30,9,34
Zenit,7202,4,8,8,4,25,15,10,32
Terek Grozny,7202,5,8,6,6,23,23,0,30
Krasnodar,7202,6,8,5,7,29,27,2,29
Din Moscow,7202,7,6,7,7,22,25,-3,25
FK Rubin,7202,8,6,5,9,23,19,4,23
Rostov,7202,9,4,7,9,11,18,-7,19
Amkar,7202,10,4,4,12,9,25,-16,16
Anzhi,7202,11,2,6,12,15,40,-25,12
Loko Moscow,7203,1,12,6,2,32,12,20,42
Spart Moscow,7203,2,10,5,5,36,28,8,35
CSKA Moscow,7203,3,10,4,6,26,19,7,34
Zenit,7203,4,7,10,3,23,15,8,31
Krasnodar,7203,5,9,4,7,31,27,4,31
Terek Grozny,7203,6,8,5,7,22,25,-3,29
Din Moscow,7203,7,6,6,8,19,23,-4,24
FK Rubin,7203,8,5,5,10,23,23,0,20
Amkar,7203,9,5,4,11,13,25,-12,19
Rostov,7203,10,4,6,10,10,18,-8,18
Anzhi,7203,11,4,5,11,17,37,-20,17
Loko Moscow,7204,1,13,5,2,33,11,22,44
CSKA Moscow,7204,2,11,3,6,30,20,10,36
Spart Moscow,7204,3,9,6,5,34,26,8,33
Zenit,7204,4,8,8,4,24,16,8,32
Krasnodar,7204,5,8,5,7,27,27,0,29
Terek Grozny,7204,6,8,5,7,22,26,-4,29
Din Moscow,7204,7,6,7,7,18,21,-3,25
FK Rubin,7204,8,5,6,9,21,18,3,21
Rostov,7204,9,5,6,9,11,17,-6,21
Amkar,7204,10,5,4,11,12,23,-11,19
Anzhi,7204,11,2,5,13,15,42,-27,11
Loko Moscow,7205,1,11,6,3,31,15,16,39
CSKA Moscow,7205,2,12,3,5,30,18,12,39
Spart Moscow,7205,3,9,5,6,38,30,8,32
Zenit,7205,4,8,8,4,25,17,8,32
Krasnodar,7205,5,8,6,6,28,25,3,30
Terek Grozny,7205,6,7,5,8,20,25,-5,26
FK Rubin,7205,7,5,7,8,23,19,4,22
Din Moscow,7205,8,5,7,8,19,25,-6,22
Amkar,7205,9,6,4,10,12,22,-10,22
Rostov,7205,10,5,6,9,13,19,-6,21
Anzhi,7205,11,3,5,12,16,40,-24,14
Loko Moscow,7206,1,12,6,2,31,12,19,42
Spart Moscow,7206,2,10,6,4,39,28,11,36
CSKA Moscow,7206,3,11,3,6,27,18,9,36
Zenit,7206,4,8,9,3,22,13,9,33
Krasnodar,7206,5,8,5,7,28,26,2,29
Terek Grozny,7206,6,7,5,8,22,28,-6,26
FK Rubin,7206,7,6,6,8,23,17,6,24
Din Moscow,7206,8,5,6,9,17,25,-8,21
Rostov,7206,9,4,7,9,12,19,-7,19
Amkar,7206,10,5,4,11,12,25,-13,19
Anzhi,7206,11,3,5,12,18,40,-22,14
Loko Moscow,7207,1,11,6,3,32,15,17,39
Spart Moscow,7207,2,10,6,4,39,27,12,36
Zenit,7207,3,9,8,3,25,14,11,35
CSKA Moscow,7207,4,10,3,7,26,21,5,33
Terek Grozny,7207,5,8,6,6,23,23,0,30
Krasnodar,7207,6,8,5,7,30,28,2,29
FK Rubin,7207,7,6,6,8,22,17,5,24
Din Moscow,7207,8,5,7,8,17,24,-7,22
Rostov,7207,9,4,7,9,11,18,-7,19
Amkar,7207,10,4,4,12,10,26,-16,16
Anzhi,7207,11,3,6,11,16,38,-22,15
Loko Moscow,7208,1,12,5,3,31,13,18,41
CSKA Moscow,7208,2,11,4,5,31,19,12,37
Zenit,7208,3,8,9,3,25,16,9,33
Krasnodar,7208,4,9,4,7,29,26,3,31
Spart Moscow,7208,5,8,5,7,36,31,5,29
Terek Grozny,7208,6,7,7,6,21,23,-2,28
Din Moscow,7208,7,6,7,7,19,22,-3,25
FK Rubin,7208,8,5,6,9,23,20,3,21
Rostov,7208,9,5,6,9,13,19,-6,21
Amkar,7208,10,5,5,10,11,23,-12,20
Anzhi,7208,11,2,6,12,15,42,-27,12
CSKA Moscow,7209,1,12,3,5,30,18,12,39
Loko Moscow,7209,2,11,5,4,30,17,13,38
Krasnodar,7209,3,10,4,6,32,25,7,34
Spart Moscow,7209,4,9,6,5,38,30,8,33
Zenit,7209,5,8,8,4,23,15,8,32
Terek Grozny,7209,6,7,7,6,22,24,-2,28
Din Moscow,7209,7,6,7,7,21,24,-3,25
Rostov,7209,8,5,6,9,13,19,-6,21
FK Rubin,7209,9,5,5,10,22,20,2,20
Amkar,7209,10,4,5,11,10,24,-14,17
Anzhi,7209,11,2,6,12,16,41,-25,12
Loko Moscow,7210,1,12,6,2,31,12,19,42
Spart Moscow,7210,2,10,6,4,36,26,10,36
CSKA Moscow,7210,3,11,3,6,27,19,8,36
Krasnodar,7210,4,9,4,7,30,26,4,31
Zenit,7210,5,7,9,4,21,14,7,30
Terek Grozny,7210,6,7,5,8,22,26,-4,26
Din Moscow,7210,7,5,8,7,18,22,-4,23
FK Rubin,7210,8,5,6,9,21,19,2,21
Amkar,7210,9,5,4,11,10,23,-13,19
Rostov,7210,10,4,6,10,10,18,-8,18
Anzhi,7210,11,4,5,11,19,40,-21,17
Loko Moscow,7211,1,13,5,2,32,11,21,44
CSKA Moscow,7211,2,12,3,5,30,18,12,39
Spart Moscow,7211,3,9,5,6,36,28,8,32
Terek Grozny,7211,4,8,6,6,22,23,-1,30
Zenit,7211,5,7,8,5,21,17,4,29
Krasnodar,7211,6,8,5,7,29,28,1,29
FK Rubin,7211,7,5,7,8,23,19,4,22
Din Moscow,7211,8,5,7,8,17,24,-7,22
Rostov,7211,9,5,6,9,12,17,-5,21
Amkar,7211,10,5,5,10,10,22,-12,20
Anzhi,7211,11,2,5,13,16,41,-25,11
Loko Moscow,7212,1,13,5,2,32,11,21,44
CSKA Moscow,7212,2,11,4,5,28,19,9,37
Spart Moscow,7212,3,9,5,6,35,30,5,32
Zenit,7212,4,7,9,4,22,16,6,30
Terek Grozny,7212,5,8,6,6,22,23,-1,30
Krasnodar,7212,6,8,5,7,28,26,2,29
FK Rubin,7212,7,6,6,8,23,18,5,24
Din Moscow,7212,8,6,6,8,20,23,-3,24
Amkar,7212,9,5,4,11,11,23,-12,19
Rostov,7212,10,4,6,10,10,18,-8,18
Anzhi,7212,11,2,6,12,16,40,-24,12
Loko Moscow,7213,1,12,6,2,31,12,19,42
Spart Moscow,7213,2,11,5,4,44,28,16,38
CSKA Moscow,7213,3,11,4,5,28,19,9,37
Zenit,7213,4,7,9,4,23,16,7,30
Krasnodar,7213,5,8,5,7,28,26,2,29
Terek Grozny,7213,6,8,5,7,22,24,-2,29
FK Rubin,7213,7,5,7,8,22,18,4,22
Din Moscow,7213,8,5,7,8,19,27,-8,22
Rostov,7213,9,4,6,10,11,20,-9,18
Amkar,7213,10,4,4,12,10,26,-16,16
Anzhi,7213,11,3,6,11,16,38,-22,15
Loko Moscow,7214,1,12,5,3,31,13,18,41
CSKA Moscow,7214,2,11,3,6,27,19,8,36
Spart Moscow,7214,3,10,5,5,37,27,10,35
Krasnodar,7214,4,10,4,6,29,24,5,34
Zenit,7214,5,8,8,4,23,15,8,32
Terek Grozny,7214,6,8,6,6,22,23,-1,30
Din Moscow,7214,7,5,7,8,19,25,-6,22
FK Rubin,7214,8,5,6,9,22,19,3,21
Amkar,7214,9,5,4,11,10,23,-13,19
Rostov,7214,10,4,6,10,10,18,-8,18
Anzhi,7214,11,2,6,12,16,40,-24,12
Loko Moscow,7215,1,12,5,3,30,14,16,41
CSKA Moscow,7215,2,11,3,6,29,21,8,36
Krasnodar,7215,3,10,4,6,31,24,7,34
Spart Moscow,7215,4,9,6,5,36,27,9,33
Zenit,7215,5,8,8,4,25,16,9,32
Terek Grozny,7215,6,8,5,7,21,23,-2,29
Din Moscow,7215,7,6,6,8,18,23,-5,24
FK Rubin,7215,8,6,5,9,23,18,5,23
Rostov,7215,9,4,7,9,10,17,-7,19
Amkar,7215,10,5,4,11,11,25,-14,19
Anzhi,7215,11,2,5,13,14,40,-26,11
Loko Moscow,7216,1,11,6,3,31,14,17,39
CSKA Moscow,7216,2,11,3,6,28,20,8,36
Zenit,7216,3,8,9,3,25,16,9,33
Spart Moscow,7216,4,9,6,5,37,29,8,33
Krasnodar,7216,5,9,5,6,31,27,4,32
Terek Grozny,7216,6,8,6,6,26,25,1,30
FK Rubin,7216,7,6,6,8,26,19,7,24
Din Moscow,7216,8,5,6,9,18,26,-8,21
Rostov,7216,9,4,7,9,11,18,-7,19
Amkar,7216,10,5,4,11,13,28,-15,19
Anzhi,7216,11,2,6,12,15,39,-24,12
Loko Moscow,7217,1,12,5,3,34,14,20,41
Spart Moscow,7217,2,10,6,4,38,27,11,36
Zenit,7217,3,9,8,3,25,14,11,35
CSKA Moscow,7217,4,10,4,6,25,19,6,34
Terek Grozny,7217,5,8,6,6,23,24,-1,30
Krasnodar,7217,6,8,4,8,30,31,-1,28
Din Moscow,7217,7,6,6,8,18,22,-4,24
FK Rubin,7217,8,6,5,9,24,20,4,23
Rostov,7217,9,4,7,9,12,19,-7,19
Amkar,7217,10,4,5,11,10,25,-15,17
Anzhi,7217,11,2,6,12,15,39,-24,12
Loko Moscow,7218,1,11,6,3,29,13,16,39
CSKA Moscow,7218,2,11,3,6,27,19,8,36
Zenit,7218,3,8,9,3,22,13,9,33
Spart Moscow,7218,4,9,6,5,34,26,8,33
Krasnodar,7218,5,9,4,7,29,26,3,31
Terek Grozny,7218,6,8,5,7,21,23,-2,29
FK Rubin,7218,7,6,6,8,25,19,6,24
Din Moscow,7218,8,5,8,7,19,23,-4,23
Amkar,7218,9,6,4,10,11,22,-11,22
Rostov,7218,10,4,6,10,10,18,-8,18
Anzhi,7218,11,2,5,13,15,40,-25,11
Loko Moscow,7219,1,11,6,3,29,12,17,39
Spart Moscow,7219,2,10,6,4,39,26,13,36
CSKA Moscow,7219,3,10,4,6,27,20,7,34
Zenit,7219,4,8,9,3,23,14,9,33
Krasnodar,7219,5,8,5,7,27,25,2,29
Terek Grozny,7219,6,7,5,8,22,28,-6,26
FK Rubin,7219,7,6,6,8,23,18,5,24
Din Moscow,7219,8,5,7,8,18,25,-7,22
Rostov,7219,9,4,7,9,10,17,-7,19
Amkar,7219,10,5,4,11,13,26,-13,19
Anzhi,7219,11,4,5,11,19,39,-20,17
Loko Moscow,7220,1,12,5,3,30,12,18,41
CSKA Moscow,7220,2,12,3,5,27,17,10,39
Spart Moscow,7220,3,9,6,5,38,30,8,33
Krasnodar,7220,4,9,4,7,29,26,3,31
Zenit,7220,5,7,8,5,21,15,6,29
Terek Grozny,7220,6,8,5,7,22,24,-2,29
Din Moscow,7220,7,6,6,8,20,23,-3,24
FK Rubin,7220,8,6,5,9,23,21,2,23
Rostov,7220,9,5,6,9,13,18,-5,21
Amkar,7220,10,4,5,11,12,26,-14,17
Anzhi,7220,11,3,5,12,15,38,-23,14
Loko Moscow,7221,1,11,5,4,32,17,15,38
Spart Moscow,7221,2,11,5,4,41,27,14,38
CSKA Moscow,7221,3,11,3,6,28,21,7,36
Zenit,7221,4,9,8,3,27,16,11,35
Krasnodar,7221,5,9,5,6,31,26,5,32
Terek Grozny,7221,6,8,6,6,23,23,0,30
FK Rubin,7221,7,6,6,8,24,19,5,24
Din Moscow,7221,8,5,6,9,19,26,-7,21
Rostov,7221,9,4,6,10,11,21,-10,18
Amkar,7221,10,4,4,12,9,25,-16,16
Anzhi,7221,11,2,6,12,16,40,-24,12
Loko Moscow,7222,1,11,6,3,32,15,17,39
CSKA Moscow,7222,2,11,4,5,29,20,9,37
Spart Moscow,7222,3,9,5,6,38,29,9,32
Zenit,7222,4,8,8,4,24,16,8,32
Krasnodar,7222,5,8,6,6,32,29,3,30
Din Moscow,7222,6,7,6,7,20,21,-1,27
Terek Grozny,7222,7,7,6,7,22,26,-4,27
Amkar,7222,8,6,4,10,14,24,-10,22
FK Rubin,7222,9,5,6,9,24,22,2,21
Rostov,7222,10,4,6,10,10,20,-10,18
Anzhi,7222,11,2,7,11,18,41,-23,13
CSKA Moscow,7223,1,12,3,5,37,19,18,39
Loko Moscow,7223,2,11,6,3,31,14,17,39
Spart Moscow,7223,3,10,5,5,35,26,9,35
Zenit,7223,4,8,8,4,23,17,6,32
Krasnodar,7223,5,9,5,6,31,26,5,32
Terek Grozny,7223,6,7,6,7,22,26,-4,27
Din Moscow,7223,7,5,7,8,19,24,-5,22
Amkar,7223,8,6,4,10,13,23,-10,22
FK Rubin,7223,9,5,6,9,23,21,2,21
Rostov,7223,10,4,6,10,10,18,-8,18
Anzhi,7223,11,2,6,12,16,46,-30,12
Loko Moscow,7224,1,12,5,3,32,14,18,41
CSKA Moscow,7224,2,11,3,6,27,19,8,36
Spart Moscow,7224,3,10,5,5,36,29,7,35
Zenit,7224,4,8,8,4,24,15,9,32
Krasnodar,7224,5,9,4,7,30,27,3,31
Terek Grozny,7224,6,8,5,7,21,23,-2,29
Din Moscow,7224,7,6,6,8,21,24,-3,24
FK Rubin,7224,8,6,5,9,24,21,3,23
Amkar,7224,9,6,4,10,13,22,-9,22
Rostov,7224,10,4,6,10,10,18,-8,18
Anzhi,7224,11,2,5,13,14,40,-26,11
Loko Moscow,7225,1,13,5,2,32,11,21,44
CSKA Moscow,7225,2,11,3,6,27,22,5,36
Spart Moscow,7225,3,9,6,5,36,28,8,33
Krasnodar,7225,4,9,4,7,28,25,3,31
Zenit,7225,5,7,8,5,22,17,5,29
Terek Grozny,7225,6,8,5,7,24,25,-1,29
Din Moscow,7225,7,6,7,7,19,21,-2,25
Amkar,7225,8,6,4,10,12,22,-10,22
FK Rubin,7225,9,5,5,10,21,20,1,20
Rostov,7225,10,4,6,10,11,20,-9,18
Anzhi,7225,11,3,5,12,20,41,-21,14
Loko Moscow,7226,1,11,6,3,31,14,17,39
CSKA Moscow,7226,2,11,3,6,26,18,8,36
Zenit,7226,3,8,9,3,23,14,9,33
Spart Moscow,7226,4,9,6,5,36,29,7,33
Krasnodar,7226,5,9,5,6,30,26,4,32
Terek Grozny,7226,6,9,5,6,25,24,1,32
Din Moscow,7226,7,6,6,8,18,22,-4,24
FK Rubin,7226,8,5,6,9,22,19,3,21
Rostov,7226,9,5,6,9,13,18,-5,21
Amkar,7226,10,4,5,11,11,26,-15,17
Anzhi,7226,11,2,5,13,15,40,-25,11
Loko Moscow,7227,1,12,6,2,31,12,19,42
Spart Moscow,7227,2,11,5,4,43,27,16,38
CSKA Moscow,7227,3,11,3,6,29,19,10,36
Zenit,7227,4,8,8,4,24,15,9,32
Krasnodar,7227,5,8,5,7,27,28,-1,29
Terek Grozny,7227,6,8,5,7,22,26,-4,29
Din Moscow,7227,7,6,6,8,22,24,-2,24
FK Rubin,7227,8,6,5,9,26,22,4,23
Rostov,7227,9,4,6,10,11,22,-11,18
Amkar,7227,10,4,4,12,11,27,-16,16
Anzhi,7227,11,3,5,12,17,41,-24,14
Loko Moscow,7228,1,12,5,3,32,13,19,41
CSKA Moscow,7228,2,11,3,6,26,19,7,36
Zenit,7228,3,9,8,3,24,13,11,35
Spart Moscow,7228,4,9,6,5,37,28,9,33
Terek Grozny,7228,5,9,5,6,24,23,1,32
Krasnodar,7228,6,9,4,7,30,27,3,31
Din Moscow,7228,7,6,6,8,19,23,-4,24
FK Rubin,7228,8,5,5,10,21,21,0,20
Rostov,7228,9,4,7,9,11,18,-7,19
Amkar,7228,10,5,4,11,12,25,-13,19
Anzhi,7228,11,2,5,13,14,40,-26,11
Loko Moscow,7229,1,11,6,3,31,14,17,39
Spart Moscow,7229,2,11,5,4,39,26,13,38
CSKA Moscow,7229,3,11,4,5,28,19,9,37
Zenit,7229,4,7,10,3,21,13,8,31
Krasnodar,7229,5,9,4,7,30,27,3,31
Terek Grozny,7229,6,8,5,7,24,25,-1,29
Din Moscow,7229,7,6,6,8,20,25,-5,24
FK Rubin,7229,8,6,5,9,23,19,4,23
Rostov,7229,9,4,6,10,10,19,-9,18
Amkar,7229,10,4,4,12,10,26,-16,16
Anzhi,7229,11,3,5,12,18,41,-23,14
Loko Moscow,7230,1,11,5,4,30,15,15,38
Spart Moscow,7230,2,10,6,4,37,26,11,36
Zenit,7230,3,9,8,3,24,14,10,35
Krasnodar,7230,4,10,4,6,32,26,6,34
CSKA Moscow,7230,5,10,3,7,27,21,6,33
Terek Grozny,7230,6,8,6,6,23,23,0,30
Din Moscow,7230,7,6,6,8,20,23,-3,24
FK Rubin,7230,8,5,5,10,23,22,1,20
Rostov,7230,9,4,6,10,10,19,-9,18
Amkar,7230,10,4,6,10,11,24,-13,18
Anzhi,7230,11,3,5,12,16,40,-24,14
Loko Moscow,7231,1,12,6,2,33,13,20,42
CSKA Moscow,7231,2,11,3,6,29,19,10,36
Spart Moscow,7231,3,10,5,5,42,32,10,35
Zenit,7231,4,8,8,4,23,15,8,32
Terek Grozny,7231,5,8,6,6,22,23,-1,30
Krasnodar,7231,6,8,5,7,30,28,2,29
FK Rubin,7231,7,6,6,8,23,18,5,24
Din Moscow,7231,8,5,7,8,19,24,-5,22
Amkar,7231,9,5,4,11,13,24,-11,19
Rostov,7231,10,4,6,10,11,22,-11,18
Anzhi,7231,11,2,6,12,15,42,-27,12
Loko Moscow,7232,1,12,5,3,31,14,17,41
CSKA Moscow,7232,2,11,3,6,29,19,10,36
Spart Moscow,7232,3,9,6,5,37,29,8,33
Zenit,7232,4,8,8,4,24,16,8,32
Krasnodar,7232,5,9,4,7,29,25,4,31
Terek Grozny,7232,6,8,5,7,22,24,-2,29
FK Rubin,7232,7,6,6,8,23,18,5,24
Din Moscow,7232,8,5,8,7,18,22,-4,23
Amkar,7232,9,6,4,10,12,23,-11,22
Rostov,7232,10,4,6,10,12,20,-8,18
Anzhi,7232,11,2,5,13,15,42,-27,11
Loko Moscow,7233,1,12,6,2,33,13,20,42
CSKA Moscow,7233,2,12,3,5,30,17,13,39
Spart Moscow,7233,3,10,6,4,37,25,12,36
Zenit,7233,4,7,9,4,22,17,5,30
Terek Grozny,7233,5,8,6,6,22,23,-1,30
Krasnodar,7233,6,8,5,7,28,27,1,29
FK Rubin,7233,7,6,6,8,24,19,5,24
Din Moscow,7233,8,5,6,9,19,26,-7,21
Rostov,7233,9,4,7,9,10,17,-7,19
Amkar,7233,10,4,5,11,10,25,-15,17
Anzhi,7233,11,2,5,13,14,40,-26,11
Loko Moscow,7234,1,12,6,2,31,12,19,42
CSKA Moscow,7234,2,11,3,6,29,20,9,36
Spart Moscow,7234,3,9,6,5,38,30,8,33
Zenit,7234,4,8,8,4,22,14,8,32
Krasnodar,7234,5,9,5,6,30,26,4,32
Terek Grozny,7234,6,8,6,6,23,24,-1,30
Din Moscow,7234,7,6,6,8,20,23,-3,24
Rostov,7234,8,5,6,9,13,19,-6,21
FK Rubin,7234,9,5,5,10,22,21,1,20
Amkar,7234,10,4,5,11,11,25,-14,17
Anzhi,7234,11,2,6,12,17,42,-25,12
Loko Moscow,7235,1,12,5,3,31,13,18,41
CSKA Moscow,7235,2,10,4,6,27,20,7,34
Krasnodar,7235,3,10,4,6,30,25,5,34
Zenit,7235,4,7,9,4,23,16,7,30
Terek Grozny,7235,5,8,6,6,21,22,-1,30
Spart Moscow,7235,6,8,5,7,33,31,2,29
Din Moscow,7235,7,6,7,7,23,23,0,25
FK Rubin,7235,8,5,6,9,24,21,3,21
Rostov,7235,9,5,6,9,11,17,-6,21
Amkar,7235,10,5,5,10,10,22,-12,20
Anzhi,7235,11,3,5,12,16,39,-23,14
Loko Moscow,7236,1,12,5,3,31,13,18,41
CSKA Moscow,7236,2,10,5,5,26,18,8,35
Krasnodar,7236,3,10,4,6,32,25,7,34
Spart Moscow,7236,4,8,8,4,37,29,8,32
Zenit,7236,5,7,9,4,21,15,6,30
Terek Grozny,7236,6,8,6,6,24,25,-1,30
Din Moscow,7236,7,6,7,7,19,22,-3,25
FK Rubin,7236,8,5,5,10,22,21,1,20
Rostov,7236,9,4,7,9,12,19,-7,19
Amkar,7236,10,4,5,11,11,25,-14,17
Anzhi,7236,11,2,7,11,17,40,-23,13
Loko Moscow,7237,1,11,5,4,30,19,11,38
Zenit,7237,2,9,8,3,27,14,13,35
Krasnodar,7237,3,10,4,6,34,26,8,34
CSKA Moscow,7237,4,10,4,6,25,19,6,34
Spart Moscow,7237,5,8,7,5,36,29,7,31
Terek Grozny,7237,6,8,6,6,22,23,-1,30
Din Moscow,7237,7,6,7,7,23,24,-1,25
FK Rubin,7237,8,5,5,10,24,24,0,20
Rostov,7237,9,4,7,9,10,17,-7,19
Amkar,7237,10,5,4,11,12,25,-13,19
Anzhi,7237,11,2,7,11,14,37,-23,13
Loko Moscow,7238,1,13,5,2,34,14,20,44
CSKA Moscow,7238,2,11,4,5,28,17,11,37
Spart Moscow,7238,3,9,5,6,37,30,7,32
Zenit,7238,4,7,9,4,23,16,7,30
Krasnodar,7238,5,8,5,7,29,27,2,29
Din Moscow,7238,6,7,6,7,20,21,-1,27
Terek Grozny,7238,7,7,5,8,20,27,-7,26
Amkar,7238,8,6,4,10,11,22,-11,22
FK Rubin,7238,9,5,6,9,22,19,3,21
Rostov,7238,10,4,6,10,12,21,-9,18
Anzhi,7238,11,3,5,12,18,40,-22,14
Loko Moscow,7239,1,11,7,2,31,13,18,40
CSKA Moscow,7239,2,11,3,6,27,20,7,36
Zenit,7239,3,8,9,3,24,14,10,33
Spart Moscow,7239,4,9,6,5,36,30,6,33
Krasnodar,7239,5,9,5,6,29,25,4,32
Terek Grozny,7239,6,8,6,6,24,25,-1,30
FK Rubin,7239,7,6,5,9,22,18,4,23
Din Moscow,7239,8,5,6,9,17,23,-6,21
Rostov,7239,9,4,7,9,12,19,-7,19
Amkar,7239,10,5,4,11,13,24,-11,19
Anzhi,7239,11,2,6,12,17,41,-24,12
Loko Moscow,7240,1,11,6,3,30,13,17,39
CSKA Moscow,7240,2,11,4,5,27,18,9,37
Zenit,7240,3,8,9,3,24,15,9,33
Spart Moscow,7240,4,9,6,5,38,31,7,33
Krasnodar,7240,5,9,5,6,28,24,4,32
Terek Grozny,7240,6,7,6,7,21,24,-3,27
Din Moscow,7240,7,6,7,7,20,23,-3,25
FK Rubin,7240,8,5,5,10,22,20,2,20
Amkar,7240,9,5,5,10,14,23,-9,20
Rostov,7240,10,4,6,10,11,21,-10,18
Anzhi,7240,11,3,5,12,15,38,-23,14
Loko Moscow,7241,1,13,5,2,32,12,20,44
CSKA Moscow,7241,2,10,3,7,25,19,6,33
Zenit,7241,3,8,8,4,23,15,8,32
Spart Moscow,7241,4,8,5,7,37,34,3,29
Terek Grozny,7241,5,8,5,7,22,24,-2,29
Krasnodar,7241,6,8,4,8,28,27,1,28
FK Rubin,7241,7,7,5,8,25,19,6,26
Din Moscow,7241,8,6,6,8,22,25,-3,24
Rostov,7241,9,5,6,9,12,18,-6,21
Amkar,7241,10,5,4,11,12,24,-12,19
Anzhi,7241,11,4,5,11,17,38,-21,17
Loko Moscow,7242,1,12,5,3,31,13,18,41
CSKA Moscow,7242,2,11,3,6,28,21,7,36
Zenit,7242,3,9,8,3,24,13,11,35
Spart Moscow,7242,4,9,6,5,36,30,6,33
Terek Grozny,7242,5,9,5,6,23,22,1,32
Krasnodar,7242,6,8,4,8,30,31,-1,28
FK Rubin,7242,7,7,5,8,27,19,8,26
Din Moscow,7242,8,5,6,9,17,24,-7,21
Rostov,7242,9,4,7,9,11,18,-7,19
Amkar,7242,10,5,4,11,13,23,-10,19
Anzhi,7242,11,2,5,13,16,42,-26,11
Loko Moscow,7243,1,12,5,3,31,13,18,41
Spart Moscow,7243,2,10,6,4,38,27,11,36
CSKA Moscow,7243,3,10,4,6,25,18,7,34
Krasnodar,7243,4,9,4,7,28,25,3,31
Zenit,7243,5,7,9,4,22,15,7,30
Terek Grozny,7243,6,7,6,7,24,27,-3,27
Din Moscow,7243,7,6,7,7,19,22,-3,25
FK Rubin,7243,8,6,5,9,22,18,4,23
Amkar,7243,9,5,4,11,12,26,-14,19
Rostov,7243,10,4,6,10,11,19,-8,18
Anzhi,7243,11,3,6,11,17,39,-22,15
Loko Moscow,7244,1,12,6,2,30,11,19,42
Spart Moscow,7244,2,11,5,4,41,29,12,38
CSKA Moscow,7244,3,11,4,5,28,18,10,37
Zenit,7244,4,7,10,3,22,14,8,31
Krasnodar,7244,5,9,4,7,29,25,4,31
Terek Grozny,7244,6,7,6,7,22,27,-5,27
Din Moscow,7244,7,6,6,8,20,24,-4,24
FK Rubin,7244,8,5,5,10,22,21,1,20
Rostov,7244,9,4,6,10,11,20,-9,18
Amkar,7244,10,4,5,11,13,27,-14,17
Anzhi,7244,11,3,5,12,17,39,-22,14
Loko Moscow,7245,1,13,5,2,32,12,20,44
CSKA Moscow,7245,2,11,3,6,27,19,8,36
Spart Moscow,7245,3,10,5,5,36,28,8,35
Zenit,7245,4,8,8,4,22,14,8,32
Terek Grozny,7245,5,8,5,7,23,24,-1,29
Krasnodar,7245,6,8,4,8,29,29,0,28
Din Moscow,7245,7,7,6,7,22,23,-1,27
FK Rubin,7245,8,6,5,9,25,20,5,23
Amkar,7245,9,5,4,11,11,24,-13,19
Rostov,7245,10,4,6,10,10,18,-8,18
Anzhi,7245,11,2,5,13,15,41,-26,11
Loko Moscow,7246,1,11,6,3,31,15,16,39
CSKA Moscow,7246,2,12,3,5,32,21,11,39
Spart Moscow,7246,3,10,5,5,38,28,10,35
Krasnodar,7246,4,9,5,6,32,27,5,32
Zenit,7246,5,7,9,4,23,16,7,30
Terek Grozny,7246,6,8,6,6,23,24,-1,30
Din Moscow,7246,7,7,6,7,20,22,-2,27
FK Rubin,7246,8,5,6,9,23,20,3,21
Rostov,7246,9,4,6,10,10,18,-8,18
Amkar,7246,10,4,4,12,10,26,-16,16
Anzhi,7246,11,2,6,12,19,44,-25,12
Loko Moscow,7247,1,11,5,4,31,16,15,38
CSKA Moscow,7247,2,11,4,5,28,18,10,37
Krasnodar,7247,3,10,4,6,32,25,7,34
Zenit,7247,4,8,9,3,24,15,9,33
Spart Moscow,7247,5,9,6,5,37,30,7,33
Terek Grozny,7247,6,8,6,6,22,23,-1,30
Din Moscow,7247,7,6,7,7,21,22,-1,25
FK Rubin,7247,8,5,6,9,22,20,2,21
Rostov,7247,9,4,6,10,10,19,-9,18
Amkar,7247,10,4,6,10,12,25,-13,18
Anzhi,7247,11,2,5,13,14,40,-26,11
Loko Moscow,7248,1,12,5,3,37,18,19,41
CSKA Moscow,7248,2,11,3,6,27,18,9,36
Spart Moscow,7248,3,10,5,5,36,28,8,35
Krasnodar,7248,4,9,5,6,32,28,4,32
Zenit,7248,5,7,8,5,23,19,4,29
Terek Grozny,7248,6,8,5,7,21,24,-3,29
FK Rubin,7248,7,6,6,8,24,19,5,24
Din Moscow,7248,8,6,6,8,22,24,-2,24
Rostov,7248,9,4,6,10,10,18,-8,18
Anzhi,7248,10,4,5,11,17,37,-20,17
Amkar,7248,11,4,4,12,9,25,-16,16
Loko Moscow,7249,1,11,7,2,31,13,18,40
CSKA Moscow,7249,2,11,4,5,27,18,9,37
Spart Moscow,7249,3,10,5,5,37,27,10,35
Zenit,7249,4,7,10,3,23,15,8,31
Krasnodar,7249,5,8,5,7,28,27,1,29
Terek Grozny,7249,6,8,5,7,23,27,-4,29
Din Moscow,7249,7,6,6,8,20,24,-4,24
FK Rubin,7249,8,6,5,9,23,19,4,23
Amkar,7249,9,6,4,10,14,23,-9,22
Rostov,7249,10,4,6,10,10,18,-8,18
Anzhi,7249,11,2,5,13,15,40,-25,11
Loko Moscow,7250,1,12,5,3,31,13,18,41
Spart Moscow,7250,2,11,5,4,45,28,17,38
CSKA Moscow,7250,3,11,3,6,30,19,11,36
Krasnodar,7250,4,10,4,6,29,24,5,34
Terek Grozny,7250,5,8,6,6,23,23,0,30
Zenit,7250,6,7,8,5,22,19,3,29
Din Moscow,7250,7,5,7,8,18,28,-10,22
FK Rubin,7250,8,5,6,9,22,19,3,21
Rostov,7250,9,4,6,10,12,20,-8,18
Amkar,7250,10,4,5,11,11,26,-15,17
Anzhi,7250,11,3,5,12,16,40,-24,14
Loko Moscow,7251,1,12,6,2,32,13,19,42
CSKA Moscow,7251,2,12,3,5,30,19,11,39
Spart Moscow,7251,3,11,5,4,39,27,12,38
Krasnodar,7251,4,8,6,6,28,25,3,30
Terek Grozny,7251,5,8,6,6,22,23,-1,30
Zenit,7251,6,7,8,5,24,18,6,29
FK Rubin,7251,7,5,7,8,22,18,4,22
Din Moscow,7251,8,5,7,8,19,24,-5,22
Rostov,7251,9,4,6,10,10,19,-9,18
Amkar,7251,10,4,4,12,10,25,-15,16
Anzhi,7251,11,2,6,12,15,40,-25,12
Loko Moscow,7252,1,12,6,2,33,14,19,42
Spart Moscow,7252,2,11,5,4,42,25,17,38
CSKA Moscow,7252,3,11,3,6,28,20,8,36
Zenit,7252,4,8,8,4,24,15,9,32
Krasnodar,7252,5,9,5,6,33,29,4,32
Terek Grozny,7252,6,8,5,7,23,25,-2,29
Din Moscow,7252,7,5,7,8,17,24,-7,22
FK Rubin,7252,8,5,6,9,23,20,3,21
Rostov,7252,9,4,6,10,10,21,-11,18
Amkar,7252,10,4,4,12,9,25,-16,16
Anzhi,7252,11,3,5,12,17,41,-24,14
Loko Moscow,7253,1,11,7,2,31,13,18,40
CSKA Moscow,7253,2,11,4,5,30,19,11,37
Spart Moscow,7253,3,10,6,4,39,26,13,36
Krasnodar,7253,4,9,5,6,31,26,5,32
Terek Grozny,7253,5,9,5,6,25,24,1,32
Zenit,7253,6,7,10,3,23,15,8,31
Din Moscow,7253,7,5,7,8,19,24,-5,22
FK Rubin,7253,8,5,6,9,24,22,2,21
Rostov,7253,9,4,7,9,11,18,-7,19
Amkar,7253,10,4,4,12,10,29,-19,16
Anzhi,7253,11,2,5,13,16,43,-27,11
Loko Moscow,7254,1,12,5,3,31,12,19,41
CSKA Moscow,7254,2,11,3,6,27,20,7,36
Krasnodar,7254,3,10,4,6,33,24,9,34
Spart Moscow,7254,4,9,6,5,36,28,8,33
Zenit,7254,5,8,8,4,24,16,8,32
Terek Grozny,7254,6,8,5,7,23,24,-1,29
Din Moscow,7254,7,5,7,8,18,23,-5,22
Amkar,7254,8,6,4,10,11,22,-11,22
FK Rubin,7254,9,5,6,9,22,23,-1,21
Rostov,7254,10,4,7,9,12,19,-7,19
Anzhi,7254,11,2,5,13,15,41,-26,11
Loko Moscow,7255,1,12,5,3,31,14,17,41
CSKA Moscow,7255,2,11,3,6,29,21,8,36
Zenit,7255,3,9,8,3,27,14,13,35
Spart Moscow,7255,4,9,7,4,38,29,9,34
Terek Grozny,7255,5,8,6,6,23,24,-1,30
Krasnodar,7255,6,8,5,7,28,26,2,29
FK Rubin,7255,7,6,6,8,25,19,6,24
Din Moscow,7255,8,5,7,8,19,25,-6,22
Rostov,7255,9,4,6,10,11,19,-8,18
Amkar,7255,10,4,6,10,12,25,-13,18
Anzhi,7255,11,2,5,13,16,43,-27,11
Loko Moscow,7256,1,11,5,4,29,13,16,38
CSKA Moscow,7256,2,11,4,5,29,19,10,37
Zenit,7256,3,8,9,3,22,13,9,33
Terek Grozny,7256,4,9,5,6,22,22,0,32
Krasnodar,7256,5,9,4,7,29,27,2,31
Spart Moscow,7256,6,8,5,7,36,32,4,29
Din Moscow,7256,7,7,6,7,21,22,-1,27
FK Rubin,7256,8,6,5,9,24,20,4,23
Rostov,7256,9,5,6,9,13,19,-6,21
Amkar,7256,10,5,4,11,11,23,-12,19
Anzhi,7256,11,2,5,13,16,42,-26,11
Loko Moscow,7257,1,11,6,3,31,15,16,39
CSKA Moscow,7257,2,11,3,6,27,19,8,36
Zenit,7257,3,9,8,3,25,14,11,35
Krasnodar,7257,4,9,5,6,30,26,4,32
Terek Grozny,7257,5,9,5,6,27,23,4,32
Spart Moscow,7257,6,8,5,7,35,33,2,29
Din Moscow,7257,7,6,6,8,19,23,-4,24
FK Rubin,7257,8,6,5,9,22,18,4,23
Rostov,7257,9,5,6,9,13,17,-4,21
Amkar,7257,10,5,4,11,12,26,-14,19
Anzhi,7257,11,2,5,13,15,42,-27,11
Loko Moscow,7258,1,13,5,2,34,14,20,44
Spart Moscow,7258,2,11,5,4,39,27,12,38
CSKA Moscow,7258,3,11,3,6,27,18,9,36
Zenit,7258,4,8,8,4,24,16,8,32
Terek Grozny,7258,5,9,5,6,24,24,0,32
Krasnodar,7258,6,9,4,7,30,27,3,31
Din Moscow,7258,7,6,6,8,18,22,-4,24
FK Rubin,7258,8,5,5,10,22,20,2,20
Rostov,7258,9,4,6,10,12,20,-8,18
Amkar,7258,10,4,4,12,10,26,-16,16
Anzhi,7258,11,2,5,13,15,41,-26,11
Loko Moscow,7259,1,11,5,4,32,16,16,38
Spart Moscow,7259,2,10,5,5,39,29,10,35
Zenit,7259,3,9,8,3,26,16,10,35
Krasnodar,7259,4,10,4,6,31,26,5,34
CSKA Moscow,7259,5,10,3,7,28,22,6,33
Terek Grozny,7259,6,8,5,7,21,23,-2,29
Din Moscow,7259,7,6,6,8,19,23,-4,24
FK Rubin,7259,8,6,5,9,22,18,4,23
Amkar,7259,9,5,4,11,11,24,-13,19
Rostov,7259,10,4,6,10,11,20,-9,18
Anzhi,7259,11,3,5,12,16,39,-23,14
Loko Moscow,7260,1,12,6,2,32,12,20,42
Spart Moscow,7260,2,11,5,4,37,26,11,38
CSKA Moscow,7260,3,11,3,6,29,21,8,36
Zenit,7260,4,8,8,4,24,15,9,32
Terek Grozny,7260,5,8,6,6,23,24,-1,30
Krasnodar,7260,6,8,5,7,29,27,2,29
FK Rubin,7260,7,7,5,8,24,18,6,26
Din Moscow,7260,8,5,6,9,18,24,-6,21
Rostov,7260,9,4,6,10,10,18,-8,18
Amkar,7260,10,4,5,11,10,24,-14,17
Anzhi,7260,11,2,5,13,16,43,-27,11
Loko Moscow,7261,1,12,5,3,31,12,19,41
Spart Moscow,7261,2,10,6,4,43,32,11,36
CSKA Moscow,7261,3,11,3,6,28,19,9,36
Krasnodar,7261,4,9,5,6,28,24,4,32
Terek Grozny,7261,5,8,6,6,23,22,1,30
Zenit,7261,6,7,8,5,21,17,4,29
Din Moscow,7261,7,6,6,8,20,25,-5,24
FK Rubin,7261,8,5,6,9,21,18,3,21
Rostov,7261,9,4,7,9,12,19,-7,19
Amkar,7261,10,4,5,11,12,26,-14,17
Anzhi,7261,11,3,5,12,16,41,-25,14
Loko Moscow,7262,1,12,5,3,34,17,17,41
CSKA Moscow,7262,2,12,3,5,32,20,12,39
Spart Moscow,7262,3,9,6,5,36,26,10,33
Krasnodar,7262,4,9,4,7,32,27,5,31
Zenit,7262,5,7,8,5,24,20,4,29
Terek Grozny,7262,6,8,5,7,23,27,-4,29
Din Moscow,7262,7,6,7,7,19,22,-3,25
FK Rubin,7262,8,6,6,8,24,18,6,24
Rostov,7262,9,4,7,9,10,17,-7,19
Amkar,7262,10,5,4,11,13,25,-12,19
Anzhi,7262,11,2,5,13,16,44,-28,11
Loko Moscow,7263,1,13,5,2,31,11,20,44
Spart Moscow,7263,2,11,5,4,41,28,13,38
CSKA Moscow,7263,3,11,3,6,28,19,9,36
Zenit,7263,4,8,8,4,23,15,8,32
Krasnodar,7263,5,9,4,7,29,26,3,31
Terek Grozny,7263,6,8,5,7,22,25,-3,29
FK Rubin,7263,7,6,5,9,24,19,5,23
Din Moscow,7263,8,5,6,9,19,26,-7,21
Amkar,7263,9,5,4,11,13,26,-13,19
Rostov,7263,10,4,6,10,10,19,-9,18
Anzhi,7263,11,2,5,13,14,40,-26,11
Loko Moscow,7264,1,12,6,2,30,11,19,42
CSKA Moscow,7264,2,11,4,5,28,19,9,37
Zenit,7264,3,7,10,3,21,13,8,31
Spart Moscow,7264,4,8,7,5,37,31,6,31
Krasnodar,7264,5,9,4,7,29,25,4,31
Terek Grozny,7264,6,8,6,6,24,24,0,30
Din Moscow,7264,7,6,7,7,21,22,-1,25
FK Rubin,7264,8,5,5,10,21,22,-1,20
Rostov,7264,9,4,7,9,11,18,-7,19
Amkar,7264,10,5,4,11,13,26,-13,19
Anzhi,7264,11,2,6,12,18,42,-24,12
Loko Moscow,7265,1,12,5,3,33,13,20,41
CSKA Moscow,7265,2,11,4,5,28,18,10,37
Zenit,7265,3,8,9,3,24,14,10,33
Spart Moscow,7265,4,9,5,6,36,27,9,32
Krasnodar,7265,5,9,4,7,28,28,0,31
Terek Grozny,7265,6,7,5,8,20,24,-4,26
Din Moscow,7265,7,6,6,8,18,22,-4,24
FK Rubin,7265,8,6,5,9,22,18,4,23
Rostov,7265,9,5,6,9,11,17,-6,21
Amkar,7265,10,5,4,11,10,25,-15,19
Anzhi,7265,11,3,5,12,15,39,-24,14
Loko Moscow,7266,1,12,5,3,32,14,18,41
Spart Moscow,7266,2,10,6,4,39,26,13,36
CSKA Moscow,7266,3,11,3,6,29,22,7,36
Zenit,7266,4,8,8,4,24,15,9,32
Krasnodar,7266,5,9,5,6,29,25,4,32
Terek Grozny,7266,6,8,5,7,23,26,-3,29
Din Moscow,7266,7,6,6,8,19,24,-5,24
FK Rubin,7266,8,5,6,9,21,19,2,21
Rostov,7266,9,4,6,10,10,19,-9,18
Amkar,7266,10,4,5,11,11,25,-14,17
Anzhi,7266,11,3,5,12,20,42,-22,14
Loko Moscow,7267,1,11,6,3,31,14,17,39
CSKA Moscow,7267,2,11,3,6,26,19,7,36
Zenit,7267,3,9,8,3,25,14,11,35
Spart Moscow,7267,4,9,6,5,37,27,10,33
Krasnodar,7267,5,8,6,6,28,25,3,30
Terek Grozny,7267,6,7,5,8,21,25,-4,26
FK Rubin,7267,7,6,6,8,22,17,5,24
Din Moscow,7267,8,6,6,8,18,22,-4,24
Rostov,7267,9,4,7,9,11,18,-7,19
Amkar,7267,10,5,4,11,10,25,-15,19
Anzhi,7267,11,3,5,12,16,39,-23,14
Loko Moscow,7268,1,13,5,2,32,11,21,44
CSKA Moscow,7268,2,11,3,6,27,18,9,36
Spart Moscow,7268,3,9,7,4,38,28,10,34
Zenit,7268,4,8,8,4,22,14,8,32
Krasnodar,7268,5,8,4,8,28,29,-1,28
Terek Grozny,7268,6,7,6,7,22,25,-3,27
FK Rubin,7268,7,7,5,8,26,19,7,26
Din Moscow,7268,8,5,7,8,19,24,-5,22
Rostov,7268,9,4,6,10,11,20,-9,18
Amkar,7268,10,4,6,10,12,25,-13,18
Anzhi,7268,11,3,5,12,15,39,-24,14
Loko Moscow,7269,1,13,5,2,35,13,22,44
CSKA Moscow,7269,2,11,3,6,29,18,11,36
Spart Moscow,7269,3,10,5,5,38,28,10,35
Zenit,7269,4,8,8,4,23,17,6,32
Terek Grozny,7269,5,8,6,6,24,24,0,30
Krasnodar,7269,6,8,4,8,29,28,1,28
FK Rubin,7269,7,7,5,8,25,19,6,26
Din Moscow,7269,8,6,6,8,19,23,-4,24
Rostov,7269,9,4,6,10,11,20,-9,18
Amkar,7269,10,4,5,11,11,25,-14,17
Anzhi,7269,11,2,5,13,15,44,-29,11
Loko Moscow,7270,1,13,5,2,31,11,20,44
Spart Moscow,7270,2,11,5,4,39,28,11,38
CSKA Moscow,7270,3,10,4,6,26,19,7,34
Krasnodar,7270,4,9,4,7,30,26,4,31
Zenit,7270,5,7,9,4,21,14,7,30
Terek Grozny,7270,6,8,5,7,21,23,-2,29
Din Moscow,7270,7,6,6,8,19,23,-4,24
FK Rubin,7270,8,5,5,10,22,21,1,20
Rostov,7270,9,4,6,10,10,18,-8,18
Anzhi,7270,10,4,5,11,17,38,-21,17
Amkar,7270,11,4,4,12,11,26,-15,16
Loko Moscow,7271,1,12,5,3,34,13,21,41
CSKA Moscow,7271,2,11,3,6,27,20,7,36
Spart Moscow,7271,3,10,5,5,41,31,10,35
Krasnodar,7271,4,10,4,6,31,25,6,34
Zenit,7271,5,8,8,4,24,18,6,32
Terek Grozny,7271,6,8,6,6,23,24,-1,30
Din Moscow,7271,7,5,7,8,20,26,-6,22
FK Rubin,7271,8,5,6,9,23,20,3,21
Amkar,7271,9,5,5,10,13,24,-11,20
Rostov,7271,10,4,6,10,11,20,-9,18
Anzhi,7271,11,2,5,13,15,41,-26,11
Loko Moscow,7272,1,12,5,3,34,14,20,41
CSKA Moscow,7272,2,12,3,5,33,19,14,39
Spart Moscow,7272,3,9,7,4,35,26,9,34
Krasnodar,7272,4,10,4,6,33,26,7,34
Zenit,7272,5,7,8,5,21,20,1,29
Terek Grozny,7272,6,7,6,7,21,26,-5,27
Din Moscow,7272,7,6,6,8,20,22,-2,24
FK Rubin,7272,8,5,5,10,21,23,-2,20
Amkar,7272,9,5,5,10,12,22,-10,20
Rostov,7272,10,4,7,9,11,18,-7,19
Anzhi,7272,11,2,6,12,17,42,-25,12
Loko Moscow,7273,1,13,5,2,33,12,21,44
Spart Moscow,7273,2,10,6,4,39,27,12,36
CSKA Moscow,7273,3,10,3,7,26,21,5,33
Zenit,7273,4,8,8,4,23,14,9,32
Krasnodar,7273,5,9,4,7,29,27,2,31
Terek Grozny,7273,6,7,7,6,22,24,-2,28
FK Rubin,7273,7,6,5,9,23,19,4,23
Din Moscow,7273,8,5,6,9,19,26,-7,21
Rostov,7273,9,4,6,10,10,19,-9,18
Amkar,7273,10,4,6,10,11,24,-13,18
Anzhi,7273,11,3,6,11,17,39,-22,15
Loko Moscow,7274,1,12,6,2,30,11,19,42
CSKA Moscow,7274,2,11,3,6,28,19,9,36
Spart Moscow,7274,3,9,6,5,36,28,8,33
Zenit,7274,4,8,8,4,22,14,8,32
Krasnodar,7274,5,8,5,7,28,26,2,29
Terek Grozny,7274,6,7,7,6,20,22,-2,28
FK Rubin,7274,7,7,5,8,25,18,7,26
Din Moscow,7274,8,5,6,9,17,24,-7,21
Amkar,7274,9,5,5,10,11,23,-12,20
Rostov,7274,10,4,7,9,11,18,-7,19
Anzhi,7274,11,2,6,12,15,40,-25,12
Loko Moscow,7275,1,11,7,2,30,12,18,40
CSKA Moscow,7275,2,11,4,5,27,18,9,37
Spart Moscow,7275,3,9,6,5,36,27,9,33
Terek Grozny,7275,4,9,5,6,24,22,2,32
Zenit,7275,5,7,10,3,23,15,8,31
Krasnodar,7275,6,8,5,7,27,27,0,29
FK Rubin,7275,7,7,5,8,26,17,9,26
Din Moscow,7275,8,5,6,9,17,25,-8,21
Rostov,7275,9,4,7,9,10,17,-7,19
Amkar,7275,10,5,4,11,11,25,-14,19
Anzhi,7275,11,2,5,13,14,40,-26,11
Loko Moscow,7276,1,12,6,2,33,13,20,42
CSKA Moscow,7276,2,12,3,5,28,17,11,39
Spart Moscow,7276,3,10,5,5,37,29,8,35
Krasnodar,7276,4,9,4,7,29,27,2,31
Zenit,7276,5,7,9,4,22,16,6,30
Terek Grozny,7276,6,8,6,6,23,23,0,30
FK Rubin,7276,7,6,5,9,22,18,4,23
Din Moscow,7276,8,5,6,9,18,25,-7,21
Amkar,7276,9,5,5,10,12,22,-10,20
Rostov,7276,10,4,6,10,10,18,-8,18
Anzhi,7276,11,2,5,13,15,41,-26,11
Loko Moscow,7277,1,12,5,3,30,12,18,41
Spart Moscow,7277,2,11,5,4,39,28,11,38
CSKA Moscow,7277,3,10,4,6,27,20,7,34
Krasnodar,7277,4,9,5,6,29,25,4,32
Zenit,7277,5,7,9,4,22,15,7,30
Terek Grozny,7277,6,7,6,7,23,27,-4,27
FK Rubin,7277,7,6,6,8,25,18,7,24
Din Moscow,7277,8,5,6,9,17,25,-8,21
Amkar,7277,9,5,4,11,14,26,-12,19
Rostov,7277,10,4,6,10,11,19,-8,18
Anzhi,7277,11,3,6,11,18,40,-22,15
Loko Moscow,7278,1,11,6,3,30,14,16,39
CSKA Moscow,7278,2,11,3,6,28,19,9,36
Zenit,7278,3,9,8,3,25,13,12,35
Spart Moscow,7278,4,9,6,5,36,27,9,33
Krasnodar,7278,5,8,6,6,29,26,3,30
Terek Grozny,7278,6,8,6,6,23,22,1,30
Din Moscow,7278,7,6,6,8,19,24,-5,24
FK Rubin,7278,8,5,6,9,22,19,3,21
Rostov,7278,9,5,6,9,11,17,-6,21
Amkar,7278,10,4,6,10,9,22,-13,18
Anzhi,7278,11,2,5,13,14,43,-29,11
Loko Moscow,7279,1,12,5,3,32,14,18,41
Spart Moscow,7279,2,10,6,4,41,27,14,36
CSKA Moscow,7279,3,11,3,6,30,23,7,36
Zenit,7279,4,8,8,4,24,15,9,32
Krasnodar,7279,5,9,4,7,30,27,3,31
Terek Grozny,7279,6,7,5,8,20,28,-8,26
Din Moscow,7279,7,6,7,7,21,23,-2,25
FK Rubin,7279,8,6,5,9,22,19,3,23
Amkar,7279,9,5,4,11,11,24,-13,19
Rostov,7279,10,4,6,10,10,21,-11,18
Anzhi,7279,11,3,5,12,21,41,-20,14
Loko Moscow,7280,1,11,5,4,30,14,16,38
Spart Moscow,7280,2,10,6,4,39,27,12,36
CSKA Moscow,7280,3,11,3,6,26,18,8,36
Zenit,7280,4,9,8,3,23,13,10,35
Krasnodar,7280,5,9,5,6,30,26,4,32
Terek Grozny,7280,6,9,5,6,24,24,0,32
FK Rubin,7280,7,6,6,8,23,18,5,24
Din Moscow,7280,8,5,6,9,17,24,-7,21
Rostov,7280,9,4,7,9,12,19,-7,19
Amkar,7280,10,4,4,12,10,26,-16,16
Anzhi,7280,11,2,5,13,15,40,-25,11
Loko Moscow,7281,1,11,6,3,30,15,15,39
CSKA Moscow,7281,2,12,3,5,32,18,14,39
Spart Moscow,7281,3,10,5,5,40,29,11,35
Zenit,7281,4,8,8,4,26,18,8,32
Krasnodar,7281,5,8,6,6,28,25,3,30
Terek Grozny,7281,6,7,7,6,23,25,-2,28
FK Rubin,7281,7,6,6,8,25,18,7,24
Din Moscow,7281,8,5,6,9,18,27,-9,21
Amkar,7281,9,5,5,10,13,23,-10,20
Rostov,7281,10,4,6,10,10,21,-11,18
Anzhi,7281,11,2,6,12,16,42,-26,12
Loko Moscow,7282,1,12,5,3,32,14,18,41
CSKA Moscow,7282,2,11,4,5,28,19,9,37
Spart Moscow,7282,3,10,6,4,41,26,15,36
Krasnodar,7282,4,9,4,7,30,28,2,31
Zenit,7282,5,7,9,4,24,17,7,30
FK Rubin,7282,6,7,5,8,25,18,7,26
Terek Grozny,7282,7,7,5,8,20,27,-7,26
Din Moscow,7282,8,5,6,9,17,26,-9,21
Amkar,7282,9,5,5,10,11,22,-11,20
Rostov,7282,10,4,6,10,11,21,-10,18
Anzhi,7282,11,3,5,12,17,38,-21,14
Loko Moscow,7283,1,12,5,3,30,15,15,41
CSKA Moscow,7283,2,12,3,5,30,19,11,39
Spart Moscow,7283,3,9,7,4,38,28,10,34
Krasnodar,7283,4,9,5,6,32,25,7,32
Zenit,7283,5,7,8,5,22,16,6,29
Terek Grozny,7283,6,7,6,7,21,24,-3,27
Din Moscow,7283,7,6,7,7,19,22,-3,25
FK Rubin,7283,8,5,6,9,22,19,3,21
Rostov,7283,9,4,7,9,11,18,-7,19
Amkar,7283,10,4,5,11,11,26,-15,17
Anzhi,7283,11,3,5,12,16,40,-24,14
Loko Moscow,7284,1,11,6,3,31,15,16,39
CSKA Moscow,7284,2,11,4,5,31,19,12,37
Zenit,7284,3,8,9,3,24,14,10,33
Spart Moscow,7284,4,9,6,5,36,27,9,33
Krasnodar,7284,5,8,6,6,29,26,3,30
Terek Grozny,7284,6,7,6,7,22,25,-3,27
Din Moscow,7284,7,6,7,7,21,22,-1,25
FK Rubin,7284,8,5,6,9,21,20,1,21
Amkar,7284,9,5,5,10,11,23,-12,20
Rostov,7284,10,4,6,10,10,19,-9,18
Anzhi,7284,11,3,5,12,17,43,-26,14
Loko Moscow,7285,1,12,6,2,30,11,19,42
CSKA Moscow,7285,2,11,4,5,29,19,10,37
Spart Moscow,7285,3,10,6,4,38,27,11,36
Zenit,7285,4,7,10,3,22,14,8,31
Krasnodar,7285,5,8,5,7,28,26,2,29
Terek Grozny,7285,6,7,7,6,22,24,-2,28
Din Moscow,7285,7,6,7,7,19,21,-2,25
FK Rubin,7285,8,5,6,9,22,20,2,21
Rostov,7285,9,4,6,10,11,20,-9,18
Amkar,7285,10,4,5,11,11,25,-14,17
Anzhi,7285,11,2,6,12,16,41,-25,12
Loko Moscow,7286,1,12,6,2,30,11,19,42
Spart Moscow,7286,2,10,6,4,39,27,12,36
CSKA Moscow,7286,3,11,3,6,27,18,9,36
Zenit,7286,4,8,9,3,22,13,9,33
Terek Grozny,7286,5,8,6,6,24,25,-1,30
Krasnodar,7286,6,8,4,8,28,27,1,28
FK Rubin,7286,7,6,6,8,25,20,5,24
Din Moscow,7286,8,5,7,8,20,26,-6,22
Rostov,7286,9,4,6,10,10,19,-9,18
Amkar,7286,10,4,6,10,12,25,-13,18
Anzhi,7286,11,2,5,13,15,41,-26,11
Loko Moscow,7287,1,12,6,2,32,13,19,42
Spart Moscow,7287,2,10,5,5,40,30,10,35
CSKA Moscow,7287,3,10,4,6,27,20,7,34
Zenit,7287,4,8,8,4,24,16,8,32
Krasnodar,7287,5,9,5,6,31,25,6,32
Terek Grozny,7287,6,7,6,7,21,25,-4,27
Din Moscow,7287,7,5,7,8,18,23,-5,22
Amkar,7287,8,6,4,10,14,24,-10,22
FK Rubin,7287,9,5,6,9,21,20,1,21
Rostov,7287,10,4,6,10,11,20,-9,18
Anzhi,7287,11,2,7,11,16,39,-23,13
Loko Moscow,7288,1,12,6,2,32,12,20,42
CSKA Moscow,7288,2,11,4,5,27,18,9,37
Spart Moscow,7288,3,10,5,5,41,29,12,35
Zenit,7288,4,7,10,3,22,14,8,31
Krasnodar,7288,5,8,5,7,28,27,1,29
Terek Grozny,7288,6,7,6,7,20,23,-3,27
FK Rubin,7288,7,6,6,8,22,17,5,24
Din Moscow,7288,8,5,6,9,19,27,-8,21
Amkar,7288,9,5,5,10,11,23,-12,20
Rostov,7288,10,4,6,10,10,19,-9,18
Anzhi,7288,11,3,5,12,15,38,-23,14
Loko Moscow,7289,1,12,6,2,33,13,20,42
CSKA Moscow,7289,2,11,3,6,29,18,11,36
Spart Moscow,7289,3,10,6,4,40,30,10,36
Zenit,7289,4,8,8,4,22,15,7,32
Krasnodar,7289,5,8,6,6,30,27,3,30
Terek Grozny,7289,6,8,6,6,23,24,-1,30
Din Moscow,7289,7,6,6,8,19,23,-4,24
FK Rubin,7289,8,5,6,9,22,19,3,21
Rostov,7289,9,4,7,9,12,19,-7,19
Amkar,7289,10,4,4,12,12,27,-15,16
Anzhi,7289,11,2,6,12,15,42,-27,12
Loko Moscow,7290,1,11,6,3,30,14,16,39
CSKA Moscow,7290,2,11,3,6,27,19,8,36
Spart Moscow,7290,3,10,5,5,39,28,11,35
Zenit,7290,4,8,9,3,24,14,10,33
Krasnodar,7290,5,9,4,7,30,26,4,31
FK Rubin,7290,6,7,5,8,27,20,7,26
Terek Grozny,7290,7,7,5,8,22,26,-4,26
Amkar,7290,8,6,4,10,12,22,-10,22
Din Moscow,7290,9,5,6,9,20,28,-8,21
Rostov,7290,10,4,6,10,10,20,-10,18
Anzhi,7290,11,3,5,12,17,41,-24,14
Loko Moscow,7291,1,11,6,3,29,14,15,39
Zenit,7291,2,9,8,3,25,13,12,35
CSKA Moscow,7291,3,10,4,6,25,18,7,34
Spart Moscow,7291,4,9,6,5,37,30,7,33
Krasnodar,7291,5,9,5,6,31,24,7,32
Terek Grozny,7291,6,7,7,6,21,23,-2,28
Din Moscow,7291,7,5,8,7,20,24,-4,23
FK Rubin,7291,8,5,6,9,22,22,0,21
Rostov,7291,9,5,6,9,12,17,-5,21
Amkar,7291,10,4,5,11,11,25,-14,17
Anzhi,7291,11,2,7,11,14,37,-23,13
Loko Moscow,7292,1,12,5,3,34,15,19,41
Spart Moscow,7292,2,11,5,4,40,27,13,38
Zenit,7292,3,9,8,3,27,16,11,35
CSKA Moscow,7292,4,10,3,7,25,21,4,33
Krasnodar,7292,5,8,5,7,28,27,1,29
Terek Grozny,7292,6,7,6,7,20,23,-3,27
FK Rubin,7292,7,5,7,8,24,20,4,22
Din Moscow,7292,8,5,7,8,19,26,-7,22
Rostov,7292,9,4,6,10,11,19,-8,18
Amkar,7292,10,4,5,11,10,24,-14,17
Anzhi,7292,11,4,5,11,17,37,-20,17
Loko Moscow,7293,1,11,6,3,30,13,17,39
Spart Moscow,7293,2,9,7,4,38,26,12,34
Zenit,7293,3,8,9,3,25,13,12,33
CSKA Moscow,7293,4,10,3,7,25,23,2,33
Krasnodar,7293,5,9,5,6,29,25,4,32
Terek Grozny,7293,6,7,6,7,21,24,-3,27
Din Moscow,7293,7,6,6,8,19,26,-7,24
FK Rubin,7293,8,5,6,9,22,19,3,21
Amkar,7293,9,5,5,10,10,22,-12,20
Rostov,7293,10,4,7,9,11,18,-7,19
Anzhi,7293,11,3,6,11,17,38,-21,15
Loko Moscow,7294,1,11,7,2,29,11,18,40
CSKA Moscow,7294,2,12,3,5,31,21,10,39
Spart Moscow,7294,3,10,6,4,42,27,15,36
Krasnodar,7294,4,9,5,6,28,24,4,32
Zenit,7294,5,7,9,4,23,16,7,30
Terek Grozny,7294,6,7,7,6,22,24,-2,28
Din Moscow,7294,7,5,7,8,17,23,-6,22
FK Rubin,7294,8,5,6,9,21,18,3,21
Rostov,7294,9,4,6,10,10,22,-12,18
Amkar,7294,10,4,6,10,11,24,-13,18
Anzhi,7294,11,2,6,12,18,42,-24,12
Loko Moscow,7295,1,13,5,2,35,12,23,44
CSKA Moscow,7295,2,10,4,6,26,20,6,34
Spart Moscow,7295,3,9,5,6,37,29,8,32
Zenit,7295,4,8,8,4,23,16,7,32
Terek Grozny,7295,5,9,5,6,23,23,0,32
Krasnodar,7295,6,8,5,7,29,28,1,29
Din Moscow,7295,7,6,7,7,20,22,-2,25
FK Rubin,7295,8,5,7,8,22,18,4,22
Amkar,7295,9,5,4,11,10,23,-13,19
Rostov,7295,10,4,6,10,10,20,-10,18
Anzhi,7295,11,2,6,12,16,40,-24,12
Loko Moscow,7296,1,11,7,2,33,15,18,40
Spart Moscow,7296,2,10,6,4,38,26,12,36
CSKA Moscow,7296,3,11,3,6,28,19,9,36
Zenit,7296,4,8,9,3,23,14,9,33
Terek Grozny,7296,5,8,6,6,23,23,0,30
Krasnodar,7296,6,8,5,7,31,29,2,29
FK Rubin,7296,7,6,6,8,25,20,5,24
Din Moscow,7296,8,5,7,8,19,25,-6,22
Rostov,7296,9,4,6,10,10,19,-9,18
Amkar,7296,10,4,6,10,11,24,-13,18
Anzhi,7296,11,2,5,13,15,42,-27,11
Loko Moscow,7297,1,11,6,3,30,13,17,39
CSKA Moscow,7297,2,11,4,5,28,17,11,37
Spart Moscow,7297,3,10,6,4,39,29,10,36
Krasnodar,7297,4,9,5,6,28,24,4,32
Zenit,7297,5,7,10,3,22,14,8,31
Terek Grozny,7297,6,8,6,6,21,22,-1,30
Din Moscow,7297,7,5,8,7,20,24,-4,23
FK Rubin,7297,8,5,7,8,22,18,4,22
Rostov,7297,9,4,6,10,10,18,-8,18
Amkar,7297,10,4,5,11,11,25,-14,17
Anzhi,7297,11,2,5,13,14,41,-27,11
Loko Moscow,7298,1,12,5,3,31,14,17,41
Spart Moscow,7298,2,9,6,5,36,28,8,33
CSKA Moscow,7298,3,10,3,7,25,19,6,33
Zenit,7298,4,8,8,4,22,14,8,32
Krasnodar,7298,5,9,5,6,32,27,5,32
Terek Grozny,7298,6,7,5,8,21,26,-5,26
FK Rubin,7298,7,6,6,8,25,20,5,24
Din Moscow,7298,8,5,7,8,18,23,-5,22
Amkar,7298,9,6,4,10,13,24,-11,22
Rostov,7298,10,4,6,10,10,18,-8,18
Anzhi,7298,11,4,5,11,18,38,-20,17
Loko Moscow,7299,1,12,5,3,31,13,18,41
Spart Moscow,7299,2,11,5,4,42,26,16,38
CSKA Moscow,7299,3,10,5,5,28,20,8,35
Terek Grozny,7299,4,9,5,6,25,22,3,32
Krasnodar,7299,5,9,4,7,29,26,3,31
Zenit,7299,6,7,9,4,23,16,7,30
Din Moscow,7299,7,6,6,8,18,25,-7,24
FK Rubin,7299,8,6,5,9,22,18,4,23
Rostov,7299,9,4,6,10,11,21,-10,18
Amkar,7299,10,4,4,12,9,25,-16,16
Anzhi,7299,11,2,6,12,15,41,-26,12
Loko Moscow,7300,1,12,5,3,30,12,18,41
CSKA Moscow,7300,2,11,3,6,29,19,10,36
Zenit,7300,3,9,8,3,24,14,10,35
Spart Moscow,7300,4,9,6,5,37,31,6,33
Krasnodar,7300,5,9,4,7,29,26,3,31
Terek Grozny,7300,6,8,6,6,23,24,-1,30
Din Moscow,7300,7,6,6,8,18,22,-4,24
FK Rubin,7300,8,5,5,10,22,20,2,20
Rostov,7300,9,4,7,9,12,19,-7,19
Amkar,7300,10,5,4,11,13,24,-11,19
Anzhi,7300,11,2,6,12,16,42,-26,12
Loko Moscow,7301,1,12,5,3,30,12,18,41
Zenit,7301,2,9,8,3,25,14,11,35
CSKA Moscow,7301,3,10,3,7,26,21,5,33
Spart Moscow,7301,4,9,5,6,37,31,6,32
Terek Grozny,7301,5,9,5,6,23,23,0,32
Krasnodar,7301,6,8,5,7,28,26,2,29
Din Moscow,7301,7,6,7,7,20,23,-3,25
FK Rubin,7301,8,5,7,8,23,19,4,22
Amkar,7301,9,5,4,11,12,24,-12,19
Rostov,7301,10,4,6,10,11,19,-8,18
Anzhi,7301,11,3,5,12,16,39,-23,14
Loko Moscow,7302,1,12,5,3,31,14,17,41
CSKA Moscow,7302,2,12,3,5,30,18,12,39
Spart Moscow,7302,3,9,6,5,40,29,11,33
Krasnodar,7302,4,9,4,7,29,28,1,31
Zenit,7302,5,7,8,5,23,18,5,29
Terek Grozny,7302,6,8,5,7,23,24,-1,29
FK Rubin,7302,7,7,5,8,27,17,10,26
Amkar,7302,8,6,4,10,13,23,-10,22
Din Moscow,7302,9,5,6,9,17,27,-10,21
Rostov,7302,10,4,7,9,12,19,-7,19
Anzhi,7302,11,2,5,13,14,42,-28,11
Loko Moscow,7303,1,13,5,2,35,13,22,44
CSKA Moscow,7303,2,11,4,5,28,19,9,37
Spart Moscow,7303,3,10,5,5,40,28,12,35
Terek Grozny,7303,4,8,6,6,23,23,0,30
Zenit,7303,5,7,8,5,22,16,6,29
Krasnodar,7303,6,8,5,7,29,29,0,29
FK Rubin,7303,7,6,6,8,24,18,6,24
Rostov,7303,8,5,6,9,12,18,-6,21
Din Moscow,7303,9,5,6,9,17,26,-9,21
Amkar,7303,10,4,4,12,10,27,-17,16
Anzhi,7303,11,2,7,11,17,40,-23,13
Loko Moscow,7304,1,13,5,2,33,11,22,44
Spart Moscow,7304,2,11,5,4,38,25,13,38
CSKA Moscow,7304,3,11,4,5,28,19,9,37
Krasnodar,7304,4,9,4,7,29,27,2,31
Zenit,7304,5,7,9,4,22,15,7,30
Terek Grozny,7304,6,8,5,7,24,24,0,29
Din Moscow,7304,7,5,7,8,17,24,-7,22
FK Rubin,7304,8,5,6,9,21,19,2,21
Amkar,7304,9,5,4,11,10,23,-13,19
Rostov,7304,10,4,6,10,10,18,-8,18
Anzhi,7304,11,2,5,13,16,43,-27,11
Loko Moscow,7305,1,11,5,4,30,15,15,38
Zenit,7305,2,9,8,3,23,13,10,35
Spart Moscow,7305,3,10,5,5,37,28,9,35
CSKA Moscow,7305,4,10,4,6,26,19,7,34
Krasnodar,7305,5,9,4,7,30,27,3,31
Terek Grozny,7305,6,7,7,6,21,23,-2,28
Din Moscow,7305,7,6,6,8,20,25,-5,24
FK Rubin,7305,8,6,5,9,25,20,5,23
Amkar,7305,9,5,5,10,11,22,-11,20
Rostov,7305,10,4,6,10,11,19,-8,18
Anzhi,7305,11,2,7,11,16,39,-23,13
Loko Moscow,7306,1,12,5,3,32,13,19,41
CSKA Moscow,7306,2,11,4,5,30,21,9,37
Spart Moscow,7306,3,9,6,5,37,29,8,33
Zenit,7306,4,8,8,4,25,17,8,32
Terek Grozny,7306,5,8,6,6,21,22,-1,30
Krasnodar,7306,6,8,4,8,27,28,-1,28
FK Rubin,7306,7,7,5,8,25,18,7,26
Din Moscow,7306,8,5,6,9,19,25,-6,21
Rostov,7306,9,5,6,9,12,18,-6,21
Amkar,7306,10,4,5,11,10,24,-14,17
Anzhi,7306,11,2,7,11,16,39,-23,13
Loko Moscow,7307,1,11,6,3,29,12,17,39
CSKA Moscow,7307,2,12,3,5,29,18,11,39
Zenit,7307,3,8,8,4,23,15,8,32
Spart Moscow,7307,4,9,5,6,34,28,6,32
Krasnodar,7307,5,8,5,7,27,25,2,29
FK Rubin,7307,6,7,5,8,24,18,6,26
Terek Grozny,7307,7,7,5,8,21,26,-5,26
Din Moscow,7307,8,6,6,8,19,23,-4,24
Amkar,7307,9,6,4,10,13,23,-10,22
Rostov,7307,10,4,6,10,10,18,-8,18
Anzhi,7307,11,3,5,12,16,39,-23,14
Loko Moscow,7308,1,13,5,2,32,12,20,44
CSKA Moscow,7308,2,11,3,6,26,21,5,36
Spart Moscow,7308,3,10,5,5,37,28,9,35
Zenit,7308,4,8,8,4,26,15,11,32
Krasnodar,7308,5,8,4,8,27,32,-5,28
Terek Grozny,7308,6,7,6,7,22,25,-3,27
FK Rubin,7308,7,7,5,8,31,18,13,26
Din Moscow,7308,8,6,6,8,21,25,-4,24
Amkar,7308,9,5,4,11,11,25,-14,19
Rostov,7308,10,4,6,10,10,18,-8,18
Anzhi,7308,11,2,6,12,15,39,-24,12
Loko Moscow,7309,1,11,6,3,32,15,17,39
CSKA Moscow,7309,2,11,3,6,28,20,8,36
Zenit,7309,3,9,8,3,25,14,11,35
Spart Moscow,7309,4,10,5,5,35,29,6,35
Krasnodar,7309,5,9,5,6,31,27,4,32
Terek Grozny,7309,6,8,5,7,24,24,0,29
Din Moscow,7309,7,7,6,7,23,22,1,27
FK Rubin,7309,8,5,5,10,22,20,2,20
Rostov,7309,9,4,6,10,10,18,-8,18
Amkar,7309,10,4,4,12,9,26,-17,16
Anzhi,7309,11,3,5,12,16,40,-24,14
Loko Moscow,7310,1,11,7,2,29,11,18,40
CSKA Moscow,7310,2,11,3,6,27,18,9,36
Zenit,7310,3,8,9,3,22,13,9,33
Spart Moscow,7310,4,9,6,5,35,29,6,33
Krasnodar,7310,5,9,5,6,29,24,5,32
Terek Grozny,7310,6,8,5,7,24,24,0,29
Din Moscow,7310,7,7,6,7,22,22,0,27
FK Rubin,7310,8,5,5,10,21,20,1,20
Amkar,7310,9,5,5,10,11,23,-12,20
Rostov,7310,10,4,6,10,10,18,-8,18
Anzhi,7310,11,2,5,13,14,42,-28,11
Loko Moscow,7311,1,12,6,2,32,12,20,42
Spart Moscow,7311,2,9,6,5,35,28,7,33
CSKA Moscow,7311,3,10,3,7,25,21,4,33
Zenit,7311,4,8,8,4,24,15,9,32
Krasnodar,7311,5,9,5,6,31,27,4,32
Terek Grozny,7311,6,9,5,6,23,23,0,32
Din Moscow,7311,7,6,7,7,19,22,-3,25
FK Rubin,7311,8,5,5,10,23,21,2,20
Amkar,7311,9,5,4,11,12,24,-12,19
Rostov,7311,10,4,6,10,10,18,-8,18
Anzhi,7311,11,3,5,12,15,38,-23,14
Loko Moscow,7312,1,11,6,3,29,12,17,39
CSKA Moscow,7312,2,11,3,6,29,22,7,36
Zenit,7312,3,9,8,3,26,13,13,35
Spart Moscow,7312,4,10,5,5,40,28,12,35
Krasnodar,7312,5,9,5,6,29,24,5,32
Terek Grozny,7312,6,7,5,8,21,26,-5,26
Din Moscow,7312,7,6,6,8,19,25,-6,24
Rostov,7312,8,5,6,9,12,18,-6,21
FK Rubin,7312,9,5,5,10,21,21,0,20
Amkar,7312,10,5,4,11,12,25,-13,19
Anzhi,7312,11,3,5,12,17,41,-24,14
Loko Moscow,7313,1,12,5,3,31,13,18,41
CSKA Moscow,7313,2,12,3,5,30,18,12,39
Spart Moscow,7313,3,9,6,5,34,29,5,33
Krasnodar,7313,4,9,4,7,30,26,4,31
Terek Grozny,7313,5,8,6,6,23,24,-1,30
Zenit,7313,6,7,8,5,22,18,4,29
FK Rubin,7313,7,6,6,8,24,19,5,24
Din Moscow,7313,8,5,7,8,18,23,-5,22
Amkar,7313,9,5,5,10,14,23,-9,20
Rostov,7313,10,4,7,9,10,17,-7,19
Anzhi,7313,11,2,5,13,15,41,-26,11
Loko Moscow,7314,1,11,6,3,31,14,17,39
Spart Moscow,7314,2,10,6,4,39,27,12,36
Krasnodar,7314,3,10,4,6,31,25,6,34
Zenit,7314,4,8,9,3,25,15,10,33
CSKA Moscow,7314,5,10,3,7,25,20,5,33
Terek Grozny,7314,6,8,5,7,23,24,-1,29
Din Moscow,7314,7,6,6,8,22,24,-2,24
FK Rubin,7314,8,5,5,10,23,24,-1,20
Rostov,7314,9,4,7,9,11,18,-7,19
Anzhi,7314,10,4,5,11,16,37,-21,17
Amkar,7314,11,4,4,12,10,28,-18,16
Loko Moscow,7315,1,13,5,2,32,12,20,44
Spart Moscow,7315,2,11,5,4,43,26,17,38
CSKA Moscow,7315,3,10,3,7,27,25,2,33
Zenit,7315,4,8,8,4,27,15,12,32
Terek Grozny,7315,5,9,5,6,22,22,0,32
Krasnodar,7315,6,9,4,7,29,25,4,31
Din Moscow,7315,7,5,7,8,18,23,-5,22
FK Rubin,7315,8,5,6,9,21,19,2,21
Rostov,7315,9,4,6,10,10,20,-10,18
Amkar,7315,10,4,4,12,9,28,-19,16
Anzhi,7315,11,3,5,12,17,40,-23,14
Loko Moscow,7316,1,11,7,2,29,11,18,40
Spart Moscow,7316,2,10,6,4,37,27,10,36
CSKA Moscow,7316,3,11,3,6,30,22,8,36
Zenit,7316,4,8,9,3,24,15,9,33
Krasnodar,7316,5,8,5,7,27,25,2,29
FK Rubin,7316,6,7,5,8,24,17,7,26
Terek Grozny,7316,7,7,5,8,20,24,-4,26
Din Moscow,7316,8,5,6,9,18,25,-7,21
Amkar,7316,9,5,5,10,11,23,-12,20
Rostov,7316,10,4,6,10,10,18,-8,18
Anzhi,7316,11,3,5,12,17,40,-23,14
Loko Moscow,7317,1,11,6,3,30,17,13,39
CSKA Moscow,7317,2,11,4,5,31,20,11,37
Spart Moscow,7317,3,8,7,5,36,29,7,31
Krasnodar,7317,4,9,4,7,32,26,6,31
Zenit,7317,5,7,9,4,22,17,5,30
Terek Grozny,7317,6,8,6,6,22,23,-1,30
FK Rubin,7317,7,7,5,8,25,18,7,26
Din Moscow,7317,8,5,7,8,19,24,-5,22
Amkar,7317,9,5,5,10,10,22,-12,20
Rostov,7317,10,4,7,9,12,19,-7,19
Anzhi,7317,11,2,6,12,18,42,-24,12
Loko Moscow,7318,1,12,5,3,32,13,19,41
Spart Moscow,7318,2,11,5,4,39,25,14,38
CSKA Moscow,7318,3,11,3,6,30,21,9,36
Zenit,7318,4,9,8,3,25,14,11,35
Krasnodar,7318,5,8,5,7,28,27,1,29
Terek Grozny,7318,6,7,5,8,20,26,-6,26
Din Moscow,7318,7,6,6,8,19,24,-5,24
FK Rubin,7318,8,5,6,9,22,19,3,21
Amkar,7318,9,5,4,11,10,23,-13,19
Rostov,7318,10,4,6,10,10,20,-10,18
Anzhi,7318,11,3,5,12,18,41,-23,14
Loko Moscow,7319,1,11,6,3,29,12,17,39
Spart Moscow,7319,2,11,5,4,38,26,12,38
CSKA Moscow,7319,3,11,3,6,28,19,9,36
Zenit,7319,4,8,9,3,22,13,9,33
Krasnodar,7319,5,9,4,7,28,27,1,31
Terek Grozny,7319,6,7,6,7,20,23,-3,27
Din Moscow,7319,7,6,6,8,20,24,-4,24
FK Rubin,7319,8,6,5,9,25,19,6,23
Amkar,7319,9,5,4,11,10,23,-13,19
Rostov,7319,10,4,6,10,10,19,-9,18
Anzhi,7319,11,2,6,12,15,40,-25,12
Loko Moscow,7320,1,11,6,3,31,14,17,39
Krasnodar,7320,2,10,4,6,32,25,7,34
Zenit,7320,3,8,9,3,26,16,10,33
CSKA Moscow,7320,4,10,3,7,28,23,5,33
Spart Moscow,7320,5,8,7,5,38,31,7,31
Terek Grozny,7320,6,8,5,7,22,25,-3,29
FK Rubin,7320,7,6,5,9,23,20,3,23
Din Moscow,7320,8,5,7,8,17,23,-6,22
Rostov,7320,9,5,6,9,14,20,-6,21
Amkar,7320,10,5,5,10,14,25,-11,20
Anzhi,7320,11,3,5,12,16,39,-23,14
Loko Moscow,7321,1,12,5,3,30,12,18,41
Spart Moscow,7321,2,11,5,4,41,27,14,38
CSKA Moscow,7321,3,11,3,6,27,19,8,36
Zenit,7321,4,9,8,3,24,14,10,35
Terek Grozny,7321,5,8,6,6,21,22,-1,30
Krasnodar,7321,6,8,5,7,30,28,2,29
FK Rubin,7321,7,6,6,8,26,21,5,24
Din Moscow,7321,8,5,6,9,19,25,-6,21
Rostov,7321,9,4,6,10,11,21,-10,18
Amkar,7321,10,4,5,11,9,24,-15,17
Anzhi,7321,11,2,5,13,14,39,-25,11
Loko Moscow,7322,1,12,5,3,32,13,19,41
CSKA Moscow,7322,2,10,5,5,28,20,8,35
Krasnodar,7322,3,9,5,6,30,26,4,32
Zenit,7322,4,7,9,4,22,16,6,30
Spart Moscow,7322,5,8,6,6,36,32,4,30
Terek Grozny,7322,6,7,6,7,23,26,-3,27
Din Moscow,7322,7,6,7,7,21,23,-2,25
FK Rubin,7322,8,5,7,8,23,19,4,22
Rostov,7322,9,5,6,9,13,18,-5,21
Amkar,7322,10,5,5,10,12,24,-12,20
Anzhi,7322,11,2,7,11,18,41,-23,13
Loko Moscow,7323,1,12,6,2,31,12,19,42
CSKA Moscow,7323,2,12,3,5,28,18,10,39
Spart Moscow,7323,3,9,6,5,39,28,11,33
Krasnodar,7323,4,9,4,7,31,26,5,31
Zenit,7323,5,7,9,4,22,15,7,30
Terek Grozny,7323,6,8,6,6,22,23,-1,30
Din Moscow,7323,7,7,6,7,22,22,0,27
FK Rubin,7323,8,5,5,10,22,23,-1,20
Rostov,7323,9,4,6,10,10,22,-12,18
Amkar,7323,10,4,6,10,9,22,-13,18
Anzhi,7323,11,2,5,13,16,41,-25,11
Loko Moscow,7324,1,12,5,3,31,12,19,41
CSKA Moscow,7324,2,11,3,6,29,19,10,36
Zenit,7324,3,8,8,4,23,15,8,32
Krasnodar,7324,4,9,5,6,29,25,4,32
Terek Grozny,7324,5,9,5,6,24,23,1,32
Spart Moscow,7324,6,8,7,5,34,27,7,31
FK Rubin,7324,7,6,6,8,25,18,7,24
Din Moscow,7324,8,6,6,8,18,24,-6,24
Rostov,7324,9,4,7,9,10,17,-7,19
Amkar,7324,10,4,5,11,10,25,-15,17
Anzhi,7324,11,2,5,13,15,43,-28,11
Loko Moscow,7325,1,11,6,3,30,13,17,39
Spart Moscow,7325,2,10,5,5,39,27,12,35
CSKA Moscow,7325,3,10,5,5,25,17,8,35
Zenit,7325,4,8,9,3,22,13,9,33
Krasnodar,7325,5,8,6,6,30,27,3,30
Terek Grozny,7325,6,8,6,6,26,25,1,30
Din Moscow,7325,7,6,7,7,21,24,-3,25
FK Rubin,7325,8,5,7,8,25,21,4,22
Rostov,7325,9,4,6,10,10,20,-10,18
Amkar,7325,10,4,5,11,10,25,-15,17
Anzhi,7325,11,2,6,12,16,42,-26,12
Loko Moscow,7326,1,11,6,3,31,14,17,39
CSKA Moscow,7326,2,11,3,6,28,19,9,36
Spart Moscow,7326,3,10,5,5,42,32,10,35
Zenit,7326,4,8,8,4,23,16,7,32
Terek Grozny,7326,5,8,6,6,23,23,0,30
Krasnodar,7326,6,8,5,7,30,29,1,29
FK Rubin,7326,7,6,6,8,24,18,6,24
Din Moscow,7326,8,5,7,8,19,24,-5,22
Amkar,7326,9,5,5,10,13,25,-12,20
Rostov,7326,10,4,6,10,12,21,-9,18
Anzhi,7326,11,3,5,12,15,39,-24,14
Loko Moscow,7327,1,11,5,4,29,13,16,38
CSKA Moscow,7327,2,11,3,6,28,20,8,36
Zenit,7327,3,9,8,3,25,13,12,35
Spart Moscow,7327,4,9,6,5,35,27,8,33
Krasnodar,7327,5,9,4,7,29,26,3,31
Terek Grozny,7327,6,7,6,7,21,25,-4,27
FK Rubin,7327,7,7,5,8,25,18,7,26
Din Moscow,7327,8,6,6,8,18,23,-5,24
Rostov,7327,9,4,6,10,11,19,-8,18
Amkar,7327,10,4,6,10,10,23,-13,18
Anzhi,7327,11,3,5,12,16,40,-24,14
Loko Moscow,7328,1,12,5,3,31,13,18,41
CSKA Moscow,7328,2,12,3,5,30,19,11,39
Zenit,7328,3,8,8,4,25,18,7,32
Terek Grozny,7328,4,8,6,6,23,23,0,30
Spart Moscow,7328,5,8,5,7,34,29,5,29
Krasnodar,7328,6,8,5,7,28,26,2,29
FK Rubin,7328,7,6,6,8,24,19,5,24
Din Moscow,7328,8,6,6,8,19,23,-4,24
Rostov,7328,9,5,6,9,12,18,-6,21
Amkar,7328,10,5,5,10,11,23,-12,20
Anzhi,7328,11,2,5,13,14,40,-26,11
Loko Moscow,7329,1,12,5,3,32,14,18,41
CSKA Moscow,7329,2,11,3,6,31,19,12,36
Spart Moscow,7329,3,10,5,5,38,27,11,35
Zenit,7329,4,9,8,3,24,13,11,35
Krasnodar,7329,5,9,4,7,30,27,3,31
Terek Grozny,7329,6,7,5,8,20,24,-4,26
Din Moscow,7329,7,6,6,8,19,23,-4,24
FK Rubin,7329,8,6,5,9,23,19,4,23
Amkar,7329,9,5,4,11,11,25,-14,19
Rostov,7329,10,4,6,10,10,19,-9,18
Anzhi,7329,11,3,5,12,15,43,-28,14
Loko Moscow,7330,1,12,5,3,31,13,18,41
CSKA Moscow,7330,2,11,4,5,28,18,10,37
Spart Moscow,7330,3,10,5,5,38,29,9,35
Krasnodar,7330,4,9,5,6,28,24,4,32
Zenit,7330,5,7,9,4,22,15,7,30
Terek Grozny,7330,6,7,5,8,20,26,-6,26
FK Rubin,7330,7,5,7,8,23,19,4,22
Din Moscow,7330,8,5,7,8,20,25,-5,22
Amkar,7330,9,6,4,10,14,24,-10,22
Rostov,7330,10,4,6,10,10,18,-8,18
Anzhi,7330,11,3,5,12,17,40,-23,14
Loko Moscow,7331,1,12,5,3,33,14,19,41
CSKA Moscow,7331,2,11,4,5,28,18,10,37
Spart Moscow,7331,3,10,5,5,38,27,11,35
Krasnodar,7331,4,9,5,6,31,27,4,32
Zenit,7331,5,7,9,4,21,15,6,30
Terek Grozny,7331,6,8,6,6,24,23,1,30
FK Rubin,7331,7,6,6,8,23,18,5,24
Din Moscow,7331,8,6,6,8,19,22,-3,24
Rostov,7331,9,4,6,10,10,18,-8,18
Amkar,7331,10,4,4,12,9,29,-20,16
Anzhi,7331,11,2,6,12,16,41,-25,12
Loko Moscow,7332,1,13,5,2,31,11,20,44
Spart Moscow,7332,2,10,5,5,39,29,10,35
CSKA Moscow,7332,3,10,5,5,27,19,8,35
Krasnodar,7332,4,9,4,7,30,27,3,31
Zenit,7332,5,7,9,4,21,14,7,30
Terek Grozny,7332,6,7,6,7,22,25,-3,27
Din Moscow,7332,7,6,6,8,19,23,-4,24
FK Rubin,7332,8,5,5,10,23,21,2,20
Amkar,7332,9,5,5,10,13,25,-12,20
Rostov,7332,10,4,6,10,10,19,-9,18
Anzhi,7332,11,3,6,11,18,40,-22,15
Loko Moscow,7333,1,11,6,3,30,13,17,39
CSKA Moscow,7333,2,12,3,5,30,20,10,39
Spart Moscow,7333,3,9,7,4,36,27,9,34
Zenit,7333,4,8,8,4,24,16,8,32
Krasnodar,7333,5,9,5,6,28,24,4,32
Terek Grozny,7333,6,8,6,6,22,23,-1,30
Din Moscow,7333,7,6,7,7,20,22,-2,25
FK Rubin,7333,8,5,5,10,22,21,1,20
Rostov,7333,9,4,6,10,11,19,-8,18
Amkar,7333,10,4,6,10,11,24,-13,18
Anzhi,7333,11,2,5,13,16,41,-25,11
Loko Moscow,7334,1,12,5,3,30,12,18,41
Spart Moscow,7334,2,9,7,4,37,27,10,34
CSKA Moscow,7334,3,10,4,6,27,20,7,34
Krasnodar,7334,4,10,4,6,29,24,5,34
Zenit,7334,5,8,8,4,23,15,8,32
Terek Grozny,7334,6,8,5,7,24,25,-1,29
Din Moscow,7334,7,5,8,7,18,22,-4,23
FK Rubin,7334,8,5,6,9,22,19,3,21
Amkar,7334,9,5,5,10,14,24,-10,20
Rostov,7334,10,4,6,10,10,19,-9,18
Anzhi,7334,11,2,6,12,15,42,-27,12
Loko Moscow,7335,1,11,6,3,33,16,17,39
CSKA Moscow,7335,2,11,3,6,30,20,10,36
Zenit,7335,3,9,8,3,26,16,10,35
Spart Moscow,7335,4,10,5,5,37,28,9,35
Krasnodar,7335,5,9,5,6,33,29,4,32
Terek Grozny,7335,6,8,5,7,21,24,-3,29
Din Moscow,7335,7,6,6,8,20,24,-4,24
FK Rubin,7335,8,6,5,9,25,21,4,23
Amkar,7335,9,5,4,11,11,23,-12,19
Rostov,7335,10,4,6,10,11,19,-8,18
Anzhi,7335,11,2,5,13,14,41,-27,11
Loko Moscow,7336,1,11,6,3,31,14,17,39
CSKA Moscow,7336,2,11,3,6,29,19,10,36
Zenit,7336,3,8,9,3,24,15,9,33
Spart Moscow,7336,4,9,6,5,37,29,8,33
Krasnodar,7336,5,9,5,6,30,26,4,32
Terek Grozny,7336,6,8,6,6,22,23,-1,30
Din Moscow,7336,7,6,7,7,20,23,-3,25
FK Rubin,7336,8,5,6,9,22,19,3,21
Rostov,7336,9,5,6,9,11,17,-6,21
Amkar,7336,10,4,5,11,11,25,-14,17
Anzhi,7336,11,2,5,13,14,41,-27,11
Loko Moscow,7337,1,13,5,2,35,14,21,44
CSKA Moscow,7337,2,12,3,5,31,19,12,39
Spart Moscow,7337,3,9,6,5,36,28,8,33
Terek Grozny,7337,4,9,5,6,23,22,1,32
Krasnodar,7337,5,9,4,7,31,27,4,31
Zenit,7337,6,7,8,5,24,21,3,29
FK Rubin,7337,7,6,5,9,24,21,3,23
Din Moscow,7337,8,5,6,9,19,25,-6,21
Rostov,7337,9,4,7,9,11,18,-7,19
Amkar,7337,10,5,4,11,10,23,-13,19
Anzhi,7337,11,2,5,13,15,41,-26,11
Loko Moscow,7338,1,12,6,2,31,12,19,42
Spart Moscow,7338,2,10,6,4,39,29,10,36
CSKA Moscow,7338,3,10,4,6,26,20,6,34
Zenit,7338,4,8,9,3,24,14,10,33
Terek Grozny,7338,5,8,5,7,24,26,-2,29
Krasnodar,7338,6,8,4,8,27,26,1,28
Din Moscow,7338,7,6,6,8,20,24,-4,24
FK Rubin,7338,8,6,5,9,22,18,4,23
Rostov,7338,9,4,6,10,11,19,-8,18
Amkar,7338,10,4,5,11,10,25,-15,17
Anzhi,7338,11,3,6,11,19,40,-21,15
Loko Moscow,7339,1,11,6,3,31,14,17,39
Spart Moscow,7339,2,10,5,5,40,28,12,35
Zenit,7339,3,9,8,3,25,14,11,35
CSKA Moscow,7339,4,10,3,7,25,20,5,33
Krasnodar,7339,5,9,5,6,31,26,5,32
Terek Grozny,7339,6,7,5,8,22,26,-4,26
Din Moscow,7339,7,6,6,8,20,25,-5,24
Rostov,7339,8,5,6,9,12,18,-6,21
FK Rubin,7339,9,5,5,10,22,22,0,20
Amkar,7339,10,5,4,11,10,24,-14,19
Anzhi,7339,11,4,5,11,18,39,-21,17
Loko Moscow,7340,1,11,7,2,33,15,18,40
Zenit,7340,2,8,9,3,23,14,9,33
CSKA Moscow,7340,3,10,3,7,26,20,6,33
Spart Moscow,7340,4,9,5,6,35,29,6,32
Krasnodar,7340,5,8,5,7,33,31,2,29
Terek Grozny,7340,6,8,5,7,21,24,-3,29
Din Moscow,7340,7,6,7,7,22,24,-2,25
FK Rubin,7340,8,6,6,8,26,21,5,24
Rostov,7340,9,5,6,9,11,17,-6,21
Amkar,7340,10,5,4,11,11,23,-12,19
Anzhi,7340,11,3,5,12,15,38,-23,14
Loko Moscow,7341,1,12,6,2,32,12,20,42
Spart Moscow,7341,2,10,6,4,42,29,13,36
CSKA Moscow,7341,3,11,3,6,27,18,9,36
Krasnodar,7341,4,9,5,6,32,26,6,32
Zenit,7341,5,7,8,5,21,17,4,29
Terek Grozny,7341,6,7,6,7,21,24,-3,27
FK Rubin,7341,7,6,5,9,23,21,2,23
Din Moscow,7341,8,5,6,9,20,27,-7,21
Rostov,7341,9,4,7,9,11,18,-7,19
Amkar,7341,10,5,4,11,10,25,-15,19
Anzhi,7341,11,3,6,11,16,38,-22,15
Loko Moscow,7342,1,13,5,2,35,14,21,44
CSKA Moscow,7342,2,12,3,5,29,18,11,39
Spart Moscow,7342,3,9,5,6,35,28,7,32
Zenit,7342,4,7,8,5,23,17,6,29
Krasnodar,7342,5,8,5,7,29,28,1,29
Terek Grozny,7342,6,8,5,7,22,24,-2,29
FK Rubin,7342,7,5,7,8,23,19,4,22
Din Moscow,7342,8,5,7,8,19,24,-5,22
Rostov,7342,9,5,6,9,11,17,-6,21
Amkar,7342,10,5,4,11,10,23,-13,19
Anzhi,7342,11,3,5,12,17,41,-24,14
Loko Moscow,7343,1,12,6,2,33,13,20,42
CSKA Moscow,7343,2,11,3,6,26,19,7,36
Spart Moscow,7343,3,10,5,5,36,26,10,35
Zenit,7343,4,8,8,4,23,15,8,32
Krasnodar,7343,5,8,6,6,30,27,3,30
Terek Grozny,7343,6,7,6,7,20,23,-3,27
FK Rubin,7343,7,5,7,8,23,19,4,22
Din Moscow,7343,8,5,7,8,18,23,-5,22
Amkar,7343,9,5,5,10,10,22,-12,20
Rostov,7343,10,4,6,10,10,19,-9,18
Anzhi,7343,11,3,5,12,15,38,-23,14
Loko Moscow,7344,1,12,6,2,30,11,19,42
CSKA Moscow,7344,2,11,3,6,26,18,8,36
Zenit,7344,3,8,9,3,22,13,9,33
Spart Moscow,7344,4,9,6,5,36,28,8,33
Krasnodar,7344,5,8,4,8,29,28,1,28
Terek Grozny,7344,6,7,5,8,21,25,-4,26
FK Rubin,7344,7,6,6,8,24,19,5,24
Din Moscow,7344,8,5,7,8,18,23,-5,22
Rostov,7344,9,5,6,9,11,17,-6,21
Amkar,7344,10,5,5,10,12,24,-12,20
Anzhi,7344,11,3,5,12,15,38,-23,14
Loko Moscow,7345,1,12,5,3,32,13,19,41
CSKA Moscow,7345,2,12,3,5,28,18,10,39
Spart Moscow,7345,3,10,5,5,36,27,9,35
Krasnodar,7345,4,9,4,7,29,26,3,31
Zenit,7345,5,7,8,5,22,17,5,29
Terek Grozny,7345,6,8,5,7,24,24,0,29
FK Rubin,7345,7,7,5,8,25,17,8,26
Rostov,7345,8,5,6,9,12,18,-6,21
Din Moscow,7345,9,5,6,9,17,25,-8,21
Amkar,7345,10,5,4,11,11,23,-12,19
Anzhi,7345,11,2,5,13,14,42,-28,11
Loko Moscow,7346,1,11,6,3,31,14,17,39
CSKA Moscow,7346,2,11,3,6,30,19,11,36
Zenit,7346,3,9,8,3,24,14,10,35
Spart Moscow,7346,4,9,7,4,36,26,10,34
Krasnodar,7346,5,9,5,6,31,26,5,32
Terek Grozny,7346,6,7,6,7,22,25,-3,27
Din Moscow,7346,7,6,6,8,18,23,-5,24
FK Rubin,7346,8,5,5,10,21,20,1,20
Amkar,7346,9,5,5,10,11,23,-12,20
Rostov,7346,10,4,7,9,11,18,-7,19
Anzhi,7346,11,2,6,12,15,42,-27,12
Loko Moscow,7347,1,13,5,2,31,11,20,44
CSKA Moscow,7347,2,11,3,6,27,19,8,36
Krasnodar,7347,3,9,4,7,29,26,3,31
Spart Moscow,7347,4,8,6,6,35,29,6,30
Zenit,7347,5,7,8,5,21,15,6,29
Terek Grozny,7347,6,8,5,7,22,25,-3,29
Din Moscow,7347,7,5,8,7,17,21,-4,23
Amkar,7347,8,6,4,10,14,23,-9,22
FK Rubin,7347,9,5,6,9,22,19,3,21
Rostov,7347,10,5,6,9,12,18,-6,21
Anzhi,7347,11,3,5,12,16,40,-24,14
Loko Moscow,7348,1,12,6,2,32,13,19,42
CSKA Moscow,7348,2,10,4,6,27,20,7,34
Zenit,7348,3,8,9,3,24,15,9,33
Spart Moscow,7348,4,9,6,5,37,30,7,33
Krasnodar,7348,5,9,4,7,30,26,4,31
Terek Grozny,7348,6,8,5,7,22,24,-2,29
Din Moscow,7348,7,6,6,8,20,25,-5,24
FK Rubin,7348,8,6,5,9,24,19,5,23
Rostov,7348,9,4,6,10,12,20,-8,18
Amkar,7348,10,4,5,11,9,24,-15,17
Anzhi,7348,11,3,6,11,17,38,-21,15
Loko Moscow,7349,1,12,6,2,34,15,19,42
CSKA Moscow,7349,2,12,3,5,29,18,11,39
Spart Moscow,7349,3,9,5,6,39,30,9,32
Terek Grozny,7349,4,9,5,6,25,23,2,32
Krasnodar,7349,5,9,4,7,30,27,3,31
Zenit,7349,6,7,9,4,24,18,6,30
Din Moscow,7349,7,7,6,7,23,25,-2,27
Rostov,7349,8,5,6,9,12,18,-6,21
FK Rubin,7349,9,5,5,10,25,23,2,20
Amkar,7349,10,4,4,12,10,28,-18,16
Anzhi,7349,11,2,5,13,16,42,-26,11
Loko Moscow,7350,1,12,5,3,32,14,18,41
Krasnodar,7350,2,10,4,6,32,25,7,34
CSKA Moscow,7350,3,10,4,6,26,19,7,34
Zenit,7350,4,8,8,4,22,16,6,32
Terek Grozny,7350,5,8,6,6,24,23,1,30
Spart Moscow,7350,6,8,5,7,37,34,3,29
Din Moscow,7350,7,6,6,8,20,24,-4,24
FK Rubin,7350,8,6,5,9,24,20,4,23
Rostov,7350,9,5,6,9,13,19,-6,21
Amkar,7350,10,5,4,11,13,26,-13,19
Anzhi,7350,11,2,7,11,16,39,-23,13
Loko Moscow,7351,1,11,6,3,31,15,16,39
CSKA Moscow,7351,2,11,3,6,28,19,9,36
Spart Moscow,7351,3,9,7,4,36,27,9,34
Zenit,7351,4,8,9,3,25,16,9,33
Krasnodar,7351,5,9,4,7,31,27,4,31
Terek Grozny,7351,6,7,6,7,21,24,-3,27
FK Rubin,7351,7,7,5,8,28,20,8,26
Din Moscow,7351,8,5,7,8,19,26,-7,22
Rostov,7351,9,4,6,10,10,18,-8,18
Amkar,7351,10,4,6,10,11,24,-13,18
Anzhi,7351,11,3,5,12,15,39,-24,14
Loko Moscow,7352,1,11,6,3,30,14,16,39
Krasnodar,7352,2,10,4,6,31,25,6,34
CSKA Moscow,7352,3,10,4,6,28,22,6,34
Zenit,7352,4,8,9,3,23,13,10,33
Spart Moscow,7352,5,9,5,6,36,28,8,32
Din Moscow,7352,6,7,6,7,20,21,-1,27
Terek Grozny,7352,7,7,6,7,20,23,-3,27
FK Rubin,7352,8,5,5,10,21,19,2,20
Amkar,7352,9,5,5,10,10,22,-12,20
Rostov,7352,10,4,6,10,10,20,-10,18
Anzhi,7352,11,3,6,11,18,40,-22,15
Loko Moscow,7353,1,12,6,2,32,11,21,42
CSKA Moscow,7353,2,10,5,5,25,17,8,35
Zenit,7353,3,7,10,3,21,13,8,31
Spart Moscow,7353,4,8,7,5,38,31,7,31
Terek Grozny,7353,5,7,7,6,21,23,-2,28
Krasnodar,7353,6,8,4,8,27,30,-3,28
Din Moscow,7353,7,7,6,7,21,22,-1,27
FK Rubin,7353,8,6,5,9,24,19,5,23
Rostov,7353,9,4,7,9,11,18,-7,19
Amkar,7353,10,4,6,10,12,25,-13,18
Anzhi,7353,11,2,7,11,15,38,-23,13
Loko Moscow,7354,1,11,6,3,29,12,17,39
CSKA Moscow,7354,2,10,4,6,26,19,7,34
Krasnodar,7354,3,10,4,6,30,24,6,34
Zenit,7354,4,8,9,3,22,13,9,33
Spart Moscow,7354,5,8,8,4,37,29,8,32
Terek Grozny,7354,6,9,5,6,22,22,0,32
FK Rubin,7354,7,6,5,9,22,19,3,23
Din Moscow,7354,8,5,7,8,18,23,-5,22
Rostov,7354,9,4,7,9,12,19,-7,19
Amkar,7354,10,4,5,11,10,24,-14,17
Anzhi,7354,11,2,6,12,15,39,-24,12
Loko Moscow,7355,1,12,6,2,31,12,19,42
CSKA Moscow,7355,2,11,3,6,26,20,6,36
Spart Moscow,7355,3,10,5,5,37,28,9,35
Zenit,7355,4,8,9,3,24,13,11,33
Krasnodar,7355,5,9,4,7,30,26,4,31
Terek Grozny,7355,6,7,7,6,22,24,-2,28
Din Moscow,7355,7,5,7,8,18,23,-5,22
FK Rubin,7355,8,5,6,9,22,20,2,21
Amkar,7355,9,5,5,10,12,24,-12,20
Rostov,7355,10,4,6,10,11,19,-8,18
Anzhi,7355,11,2,6,12,15,39,-24,12
Loko Moscow,7356,1,11,6,3,30,13,17,39
CSKA Moscow,7356,2,10,5,5,26,18,8,35
Krasnodar,7356,3,10,4,6,32,26,6,34
Terek Grozny,7356,4,9,5,6,26,24,2,32
Zenit,7356,5,7,10,3,22,14,8,31
Spart Moscow,7356,6,8,6,6,37,31,6,30
Din Moscow,7356,7,6,7,7,20,23,-3,25
FK Rubin,7356,8,5,6,9,23,21,2,21
Rostov,7356,9,5,6,9,12,18,-6,21
Amkar,7356,10,4,5,11,12,26,-14,17
Anzhi,7356,11,2,6,12,15,41,-26,12
Loko Moscow,7357,1,13,5,2,35,12,23,44
CSKA Moscow,7357,2,11,3,6,28,20,8,36
Spart Moscow,7357,3,8,8,4,40,32,8,32
Zenit,7357,4,8,8,4,25,17,8,32
Krasnodar,7357,5,9,4,7,30,28,2,31
Terek Grozny,7357,6,8,6,6,22,23,-1,30
FK Rubin,7357,7,6,5,9,25,21,4,23
Din Moscow,7357,8,5,7,8,19,25,-6,22
Rostov,7357,9,4,7,9,14,21,-7,19
Amkar,7357,10,4,6,10,11,24,-13,18
Anzhi,7357,11,2,5,13,15,41,-26,11
Loko Moscow,7358,1,12,6,2,35,14,21,42
CSKA Moscow,7358,2,11,4,5,30,20,10,37
Spart Moscow,7358,3,9,6,5,37,29,8,33
Zenit,7358,4,7,9,4,22,17,5,30
Krasnodar,7358,5,8,6,6,29,26,3,30
Terek Grozny,7358,6,8,6,6,23,24,-1,30
Din Moscow,7358,7,6,6,8,20,24,-4,24
FK Rubin,7358,8,5,6,9,21,18,3,21
Rostov,7358,9,5,6,9,11,17,-6,21
Amkar,7358,10,4,5,11,10,24,-14,17
Anzhi,7358,11,2,6,12,19,44,-25,12
Loko Moscow,7359,1,11,6,3,31,16,15,39
CSKA Moscow,7359,2,11,3,6,28,21,7,36
Spart Moscow,7359,3,10,5,5,37,27,10,35
Krasnodar,7359,4,10,4,6,34,26,8,34
Zenit,7359,5,8,9,3,24,14,10,33
Terek Grozny,7359,6,7,5,8,21,26,-5,26
Din Moscow,7359,7,6,6,8,22,23,-1,24
Amkar,7359,8,6,4,10,12,23,-11,22
FK Rubin,7359,9,5,5,10,22,25,-3,20
Rostov,7359,10,4,6,10,11,19,-8,18
Anzhi,7359,11,3,5,12,18,40,-22,14
Loko Moscow,7360,1,11,6,3,29,13,16,39
CSKA Moscow,7360,2,11,3,6,26,18,8,36
Zenit,7360,3,8,9,3,22,13,9,33
Spart Moscow,7360,4,9,6,5,36,28,8,33
Krasnodar,7360,5,9,4,7,30,27,3,31
Terek Grozny,7360,6,8,5,7,22,24,-2,29
FK Rubin,7360,7,6,6,8,25,19,6,24
Din Moscow,7360,8,5,8,7,19,23,-4,23
Rostov,7360,9,5,6,9,11,17,-6,21
Amkar,7360,10,4,4,12,10,26,-16,16
Anzhi,7360,11,3,5,12,16,38,-22,14
Loko Moscow,7361,1,12,5,3,32,14,18,41
CSKA Moscow,7361,2,11,3,6,28,20,8,36
Spart Moscow,7361,3,9,7,4,36,26,10,34
Zenit,7361,4,8,8,4,25,17,8,32
Krasnodar,7361,5,9,5,6,30,26,4,32
Terek Grozny,7361,6,7,5,8,21,27,-6,26
Din Moscow,7361,7,5,8,7,18,22,-4,23
FK Rubin,7361,8,5,7,8,23,19,4,22
Amkar,7361,9,5,5,10,12,22,-10,20
Rostov,7361,10,4,6,10,10,19,-9,18
Anzhi,7361,11,3,5,12,17,40,-23,14
Loko Moscow,7362,1,13,5,2,32,11,21,44
CSKA Moscow,7362,2,11,3,6,27,19,8,36
Spart Moscow,7362,3,9,5,6,37,29,8,32
Terek Grozny,7362,4,9,5,6,26,24,2,32
Zenit,7362,5,7,8,5,22,17,5,29
Krasnodar,7362,6,8,4,8,28,28,0,28
FK Rubin,7362,7,6,6,8,24,18,6,24
Din Moscow,7362,8,5,7,8,17,23,-6,22
Rostov,7362,9,5,6,9,12,18,-6,21
Amkar,7362,10,5,4,11,13,28,-15,19
Anzhi,7362,11,3,5,12,15,38,-23,14
Loko Moscow,7363,1,12,5,3,34,15,19,41
Krasnodar,7363,2,10,4,6,32,27,5,34
Spart Moscow,7363,3,9,6,5,35,27,8,33
CSKA Moscow,7363,4,10,3,7,25,20,5,33
Zenit,7363,5,8,8,4,24,16,8,32
Terek Grozny,7363,6,7,7,6,22,24,-2,28
Din Moscow,7363,7,7,6,7,21,22,-1,27
FK Rubin,7363,8,5,5,10,23,22,1,20
Rostov,7363,9,4,7,9,11,18,-7,19
Amkar,7363,10,4,5,11,9,23,-14,17
Anzhi,7363,11,3,6,11,17,39,-22,15
Loko Moscow,7364,1,12,6,2,33,12,21,42
Spart Moscow,7364,2,9,7,4,35,26,9,34
CSKA Moscow,7364,3,10,4,6,27,20,7,34
Zenit,7364,4,8,8,4,23,17,6,32
Krasnodar,7364,5,8,6,6,29,26,3,30
Terek Grozny,7364,6,7,7,6,22,24,-2,28
FK Rubin,7364,7,6,6,8,24,18,6,24
Din Moscow,7364,8,5,7,8,18,24,-6,22
Rostov,7364,9,4,7,9,10,17,-7,19
Amkar,7364,10,4,5,11,10,24,-14,17
Anzhi,7364,11,2,7,11,16,39,-23,13
Loko Moscow,7365,1,11,7,2,32,14,18,40
CSKA Moscow,7365,2,12,3,5,28,18,10,39
Spart Moscow,7365,3,9,5,6,36,30,6,32
Terek Grozny,7365,4,9,5,6,23,23,0,32
Zenit,7365,5,7,9,4,21,14,7,30
Krasnodar,7365,6,8,5,7,30,28,2,29
FK Rubin,7365,7,6,6,8,23,18,5,24
Din Moscow,7365,8,5,7,8,18,24,-6,22
Rostov,7365,9,5,6,9,12,18,-6,21
Amkar,7365,10,5,4,11,13,24,-11,19
Anzhi,7365,11,2,5,13,15,40,-25,11
Loko Moscow,7366,1,13,5,2,32,12,20,44
Spart Moscow,7366,2,11,5,4,40,26,14,38
CSKA Moscow,7366,3,10,4,6,26,19,7,34
Krasnodar,7366,4,9,4,7,29,26,3,31
Zenit,7366,5,7,9,4,21,14,7,30
Terek Grozny,7366,6,8,5,7,25,26,-1,29
FK Rubin,7366,7,6,5,9,25,18,7,23
Din Moscow,7366,8,5,6,9,17,27,-10,21
Rostov,7366,9,4,6,10,10,18,-8,18
Anzhi,7366,10,4,5,11,18,39,-21,17
Amkar,7366,11,4,4,12,12,30,-18,16
Loko Moscow,7367,1,11,7,2,31,13,18,40
CSKA Moscow,7367,2,11,3,6,28,21,7,36
Zenit,7367,3,8,9,3,25,15,10,33
Spart Moscow,7367,4,9,6,5,39,31,8,33
Krasnodar,7367,5,9,5,6,31,26,5,32
Terek Grozny,7367,6,7,6,7,21,24,-3,27
Din Moscow,7367,7,6,6,8,21,25,-4,24
Rostov,7367,8,5,6,9,13,19,-6,21
FK Rubin,7367,9,5,5,10,23,22,1,20
Amkar,7367,10,4,6,10,10,23,-13,18
Anzhi,7367,11,3,5,12,17,40,-23,14
Loko Moscow,7368,1,12,6,2,33,13,20,42
Spart Moscow,7368,2,11,5,4,42,28,14,38
CSKA Moscow,7368,3,10,4,6,27,20,7,34
Zenit,7368,4,8,8,4,23,16,7,32
Krasnodar,7368,5,8,5,7,28,26,2,29
Terek Grozny,7368,6,8,5,7,21,24,-3,29
FK Rubin,7368,7,6,6,8,22,17,5,24
Din Moscow,7368,8,5,7,8,19,26,-7,22
Amkar,7368,9,5,4,11,12,25,-13,19
Rostov,7368,10,4,6,10,10,18,-8,18
Anzhi,7368,11,2,6,12,16,40,-24,12
Loko Moscow,7369,1,12,5,3,31,15,16,41
Spart Moscow,7369,2,11,5,4,37,25,12,38
Krasnodar,7369,3,10,4,6,34,26,8,34
CSKA Moscow,7369,4,10,4,6,26,19,7,34
Zenit,7369,5,8,8,4,23,15,8,32
Terek Grozny,7369,6,8,6,6,22,23,-1,30
Din Moscow,7369,7,5,7,8,18,23,-5,22
FK Rubin,7369,8,5,6,9,24,22,2,21
Rostov,7369,9,4,6,10,10,18,-8,18
Amkar,7369,10,4,5,11,9,24,-15,17
Anzhi,7369,11,2,6,12,16,40,-24,12
Loko Moscow,7370,1,12,5,3,31,12,19,41
Spart Moscow,7370,2,10,6,4,40,28,12,36
CSKA Moscow,7370,3,11,3,6,27,18,9,36
Krasnodar,7370,4,10,4,6,29,24,5,34
Zenit,7370,5,8,8,4,22,15,7,32
Terek Grozny,7370,6,7,6,7,21,24,-3,27
Din Moscow,7370,7,6,6,8,21,24,-3,24
FK Rubin,7370,8,5,5,10,21,20,1,20
Rostov,7370,9,4,6,10,10,20,-10,18
Amkar,7370,10,4,6,10,10,23,-13,18
Anzhi,7370,11,3,5,12,16,40,-24,14
Loko Moscow,7371,1,11,6,3,29,12,17,39
CSKA Moscow,7371,2,12,3,5,28,17,11,39
Spart Moscow,7371,3,11,5,4,40,26,14,38
Krasnodar,7371,4,9,5,6,29,25,4,32
Zenit,7371,5,7,9,4,21,14,7,30
Terek Grozny,7371,6,7,6,7,24,27,-3,27
FK Rubin,7371,7,5,7,8,22,18,4,22
Din Moscow,7371,8,5,7,8,17,24,-7,22
Rostov,7371,9,4,6,10,10,19,-9,18
Amkar,7371,10,4,5,11,11,25,-14,17
Anzhi,7371,11,3,5,12,18,42,-24,14
Loko Moscow,7372,1,11,5,4,31,16,15,38
Zenit,7372,2,9,8,3,25,13,12,35
CSKA Moscow,7372,3,10,4,6,26,20,6,34
Krasnodar,7372,4,9,4,7,31,28,3,31
Spart Moscow,7372,5,8,6,6,36,31,5,30
Terek Grozny,7372,6,7,6,7,20,23,-3,27
FK Rubin,7372,7,7,5,8,25,18,7,26
Din Moscow,7372,8,6,6,8,19,23,-4,24
Rostov,7372,9,5,6,9,12,18,-6,21
Amkar,7372,10,4,6,10,11,24,-13,18
Anzhi,7372,11,3,6,11,16,38,-22,15
Loko Moscow,7373,1,11,7,2,30,12,18,40
CSKA Moscow,7373,2,12,3,5,32,19,13,39
Spart Moscow,7373,3,11,5,4,42,26,16,38
Zenit,7373,4,7,9,4,22,18,4,30
Krasnodar,7373,5,8,5,7,28,26,2,29
Terek Grozny,7373,6,7,5,8,20,26,-6,26
Din Moscow,7373,7,6,6,8,19,27,-8,24
FK Rubin,7373,8,6,5,9,23,19,4,23
Amkar,7373,9,5,4,11,12,23,-11,19
Rostov,7373,10,4,6,10,10,19,-9,18
Anzhi,7373,11,3,5,12,17,40,-23,14
Loko Moscow,7374,1,11,6,3,32,15,17,39
CSKA Moscow,7374,2,11,4,5,28,19,9,37
Spart Moscow,7374,3,10,6,4,37,26,11,36
Zenit,7374,4,8,8,4,23,15,8,32
Terek Grozny,7374,5,9,5,6,26,23,3,32
Krasnodar,7374,6,8,6,6,31,28,3,30
Din Moscow,7374,7,6,7,7,21,22,-1,25
FK Rubin,7374,8,5,6,9,23,22,1,21
Rostov,7374,9,4,6,10,11,20,-9,18
Amkar,7374,10,4,4,12,9,26,-17,16
Anzhi,7374,11,2,6,12,16,41,-25,12
Loko Moscow,7375,1,12,6,2,31,11,20,42
CSKA Moscow,7375,2,12,3,5,31,20,11,39
Spart Moscow,7375,3,9,7,4,37,28,9,34
Zenit,7375,4,7,9,4,22,15,7,30
Terek Grozny,7375,5,8,5,7,21,23,-2,29
Krasnodar,7375,6,8,4,8,28,29,-1,28
FK Rubin,7375,7,6,6,8,24,18,6,24
Din Moscow,7375,8,5,7,8,19,24,-5,22
Rostov,7375,9,4,7,9,11,18,-7,19
Amkar,7375,10,4,5,11,9,23,-14,17
Anzhi,7375,11,3,5,12,17,41,-24,14
Loko Moscow,7376,1,13,5,2,33,13,20,44
Spart Moscow,7376,2,9,7,4,38,29,9,34
CSKA Moscow,7376,3,10,4,6,25,20,5,34
Zenit,7376,4,8,8,4,26,16,10,32
Krasnodar,7376,5,8,5,7,30,28,2,29
Terek Grozny,7376,6,7,7,6,23,25,-2,28
FK Rubin,7376,7,6,6,8,26,21,5,24
Din Moscow,7376,8,5,6,9,20,26,-6,21
Rostov,7376,9,4,7,9,11,18,-7,19
Amkar,7376,10,4,6,10,12,25,-13,18
Anzhi,7376,11,2,7,11,15,38,-23,13
Loko Moscow,7377,1,12,6,2,33,14,19,42
CSKA Moscow,7377,2,12,3,5,29,19,10,39
Spart Moscow,7377,3,9,7,4,38,28,10,34
Zenit,7377,4,7,8,5,24,18,6,29
Krasnodar,7377,5,8,5,7,29,27,2,29
Terek Grozny,7377,6,7,6,7,22,25,-3,27
FK Rubin,7377,7,7,5,8,24,18,6,26
Din Moscow,7377,8,5,7,8,20,25,-5,22
Rostov,7377,9,4,6,10,10,19,-9,18
Amkar,7377,10,4,6,10,10,23,-13,18
Anzhi,7377,11,3,5,12,17,40,-23,14
Loko Moscow,7378,1,13,5,2,35,12,23,44
CSKA Moscow,7378,2,11,4,5,28,19,9,37
Spart Moscow,7378,3,9,6,5,37,28,9,33
Zenit,7378,4,7,8,5,22,17,5,29
Krasnodar,7378,5,8,4,8,28,29,-1,28
Terek Grozny,7378,6,7,5,8,22,27,-5,26
Din Moscow,7378,7,6,6,8,20,25,-5,24
FK Rubin,7378,8,6,5,9,23,19,4,23
Amkar,7378,9,6,4,10,12,22,-10,22
Rostov,7378,10,4,7,9,11,18,-7,19
Anzhi,7378,11,3,6,11,18,40,-22,15
Loko Moscow,7379,1,11,6,3,31,14,17,39
CSKA Moscow,7379,2,12,3,5,29,18,11,39
Spart Moscow,7379,3,9,7,4,38,29,9,34
Zenit,7379,4,8,8,4,23,16,7,32
Krasnodar,7379,5,8,5,7,28,28,0,29
Terek Grozny,7379,6,7,6,7,20,23,-3,27
FK Rubin,7379,7,6,6,8,24,17,7,24
Din Moscow,7379,8,5,8,7,18,22,-4,23
Rostov,7379,9,4,6,10,11,19,-8,18
Amkar,7379,10,4,6,10,11,24,-13,18
Anzhi,7379,11,3,5,12,16,39,-23,14
Loko Moscow,7380,1,12,5,3,30,13,17,41
CSKA Moscow,7380,2,11,3,6,28,20,8,36
Krasnodar,7380,3,10,4,6,30,24,6,34
Spart Moscow,7380,4,9,5,6,37,29,8,32
Zenit,7380,5,7,8,5,22,16,6,29
Terek Grozny,7380,6,8,5,7,22,23,-1,29
Din Moscow,7380,7,6,6,8,19,23,-4,24
FK Rubin,7380,8,6,5,9,22,18,4,23
Rostov,7380,9,5,6,9,12,18,-6,21
Anzhi,7380,10,4,5,11,17,38,-21,17
Amkar,7380,11,4,4,12,9,26,-17,16
Loko Moscow,7381,1,11,6,3,32,15,17,39
Spart Moscow,7381,2,10,5,5,36,27,9,35
Krasnodar,7381,3,10,4,6,32,27,5,34
Zenit,7381,4,8,9,3,26,15,11,33
CSKA Moscow,7381,5,10,3,7,28,24,4,33
Terek Grozny,7381,6,8,6,6,22,23,-1,30
Din Moscow,7381,7,6,6,8,18,22,-4,24
FK Rubin,7381,8,5,5,10,22,20,2,20
Amkar,7381,9,5,4,11,11,24,-13,19
Rostov,7381,10,4,6,10,10,18,-8,18
Anzhi,7381,11,3,6,11,18,40,-22,15
Loko Moscow,7382,1,11,7,2,32,14,18,40
CSKA Moscow,7382,2,11,3,6,27,21,6,36
Zenit,7382,3,7,9,4,23,16,7,30
Spart Moscow,7382,4,8,6,6,34,29,5,30
Krasnodar,7382,5,8,6,6,29,26,3,30
Terek Grozny,7382,6,7,6,7,20,24,-4,27
FK Rubin,7382,7,6,6,8,24,18,6,24
Din Moscow,7382,8,5,7,8,18,24,-6,22
Rostov,7382,9,5,6,9,12,17,-5,21
Amkar,7382,10,5,5,10,10,22,-12,20
Anzhi,7382,11,4,5,11,20,38,-18,17
CSKA Moscow,7383,1,12,3,5,28,18,10,39
Loko Moscow,7383,2,11,5,4,30,15,15,38
Spart Moscow,7383,3,9,6,5,35,27,8,33
Zenit,7383,4,8,8,4,23,15,8,32
Terek Grozny,7383,5,9,5,6,24,22,2,32
Krasnodar,7383,6,9,4,7,30,27,3,31
FK Rubin,7383,7,7,5,8,27,19,8,26
Rostov,7383,8,5,6,9,12,18,-6,21
Din Moscow,7383,9,5,6,9,19,26,-7,21
Amkar,7383,10,4,5,11,9,25,-16,17
Anzhi,7383,11,2,5,13,14,39,-25,11
Loko Moscow,7384,1,13,5,2,31,11,20,44
CSKA Moscow,7384,2,11,4,5,29,18,11,37
Spart Moscow,7384,3,9,7,4,38,27,11,34
Krasnodar,7384,4,9,4,7,31,25,6,31
Zenit,7384,5,7,9,4,22,15,7,30
Terek Grozny,7384,6,7,7,6,21,23,-2,28
Din Moscow,7384,7,6,7,7,20,22,-2,25
FK Rubin,7384,8,5,5,10,21,23,-2,20
Rostov,7384,9,4,6,10,10,20,-10,18
Amkar,7384,10,4,6,10,11,24,-13,18
Anzhi,7384,11,2,6,12,14,40,-26,12
Loko Moscow,7385,1,13,5,2,32,12,20,44
CSKA Moscow,7385,2,11,4,5,29,18,11,37
Spart Moscow,7385,3,9,6,5,38,27,11,33
Zenit,7385,4,7,9,4,22,15,7,30
Terek Grozny,7385,5,8,6,6,23,23,0,30
Krasnodar,7385,6,8,4,8,28,28,0,28
Din Moscow,7385,7,6,7,7,19,22,-3,25
FK Rubin,7385,8,6,6,8,24,18,6,24
Rostov,7385,9,4,6,10,10,21,-11,18
Amkar,7385,10,4,6,10,11,24,-13,18
Anzhi,7385,11,2,5,13,14,42,-28,11
Loko Moscow,7386,1,11,5,4,32,18,14,38
Spart Moscow,7386,2,10,6,4,39,28,11,36
Zenit,7386,3,9,8,3,24,14,10,35
Krasnodar,7386,4,10,4,6,37,27,10,34
CSKA Moscow,7386,5,10,3,7,27,21,6,33
Terek Grozny,7386,6,8,5,7,23,24,-1,29
Din Moscow,7386,7,6,6,8,21,24,-3,24
FK Rubin,7386,8,5,5,10,22,25,-3,20
Amkar,7386,9,5,5,10,12,24,-12,20
Rostov,7386,10,4,6,10,11,19,-8,18
Anzhi,7386,11,3,5,12,17,41,-24,14
Loko Moscow,7387,1,12,6,2,30,11,19,42
CSKA Moscow,7387,2,11,4,5,33,18,15,37
Spart Moscow,7387,3,9,6,5,38,28,10,33
Zenit,7387,4,7,10,3,22,14,8,31
Krasnodar,7387,5,9,4,7,28,25,3,31
Terek Grozny,7387,6,8,6,6,24,25,-1,30
Din Moscow,7387,7,5,8,7,19,23,-4,23
FK Rubin,7387,8,5,6,9,22,19,3,21
Rostov,7387,9,5,6,9,12,18,-6,21
Amkar,7387,10,4,5,11,10,26,-16,17
Anzhi,7387,11,2,5,13,16,47,-31,11
Loko Moscow,7388,1,12,6,2,30,11,19,42
Spart Moscow,7388,2,10,6,4,37,27,10,36
CSKA Moscow,7388,3,11,3,6,27,20,7,36
Zenit,7388,4,8,9,3,24,14,10,33
Krasnodar,7388,5,9,4,7,30,26,4,31
Terek Grozny,7388,6,7,6,7,21,25,-4,27
Din Moscow,7388,7,5,7,8,18,23,-5,22
FK Rubin,7388,8,5,6,9,23,21,2,21
Rostov,7388,9,4,6,10,11,19,-8,18
Amkar,7388,10,4,6,10,11,24,-13,18
Anzhi,7388,11,3,5,12,16,38,-22,14
Loko Moscow,7389,1,11,6,3,30,13,17,39
CSKA Moscow,7389,2,11,4,5,28,18,10,37
Spart Moscow,7389,3,9,6,5,36,28,8,33
Zenit,7389,4,7,10,3,23,15,8,31
Krasnodar,7389,5,9,4,7,28,25,3,31
Terek Grozny,7389,6,8,5,7,23,26,-3,29
Din Moscow,7389,7,6,6,8,18,22,-4,24
FK Rubin,7389,8,6,5,9,22,18,4,23
Rostov,7389,9,5,6,9,13,19,-6,21
Amkar,7389,10,5,5,10,13,24,-11,20
Anzhi,7389,11,2,5,13,14,40,-26,11
Loko Moscow,7390,1,11,7,2,32,14,18,40
CSKA Moscow,7390,2,12,3,5,29,18,11,39
Spart Moscow,7390,3,10,6,4,37,27,10,36
Krasnodar,7390,4,9,5,6,31,27,4,32
Zenit,7390,5,7,9,4,22,16,6,30
Terek Grozny,7390,6,8,6,6,26,26,0,30
FK Rubin,7390,7,6,5,9,24,19,5,23
Din Moscow,7390,8,5,6,9,19,26,-7,21
Rostov,7390,9,4,7,9,10,17,-7,19
Amkar,7390,10,4,5,11,11,25,-14,17
Anzhi,7390,11,2,5,13,17,43,-26,11
Loko Moscow,7391,1,11,5,4,29,14,15,38
Spart Moscow,7391,2,10,6,4,38,28,10,36
Zenit,7391,3,9,8,3,23,13,10,35
Krasnodar,7391,4,10,4,6,32,25,7,34
CSKA Moscow,7391,5,10,4,6,26,19,7,34
Terek Grozny,7391,6,8,6,6,24,24,0,30
Din Moscow,7391,7,6,6,8,21,23,-2,24
FK Rubin,7391,8,5,5,10,22,23,-1,20
Rostov,7391,9,4,6,10,11,19,-8,18
Amkar,7391,10,4,5,11,11,26,-15,17
Anzhi,7391,11,2,7,11,16,39,-23,13
Loko Moscow,7392,1,12,6,2,31,12,19,42
Zenit,7392,2,8,9,3,24,14,10,33
CSKA Moscow,7392,3,10,3,7,27,22,5,33
Spart Moscow,7392,4,8,6,6,36,31,5,30
Terek Grozny,7392,5,8,6,6,23,24,-1,30
Krasnodar,7392,6,8,4,8,27,27,0,28
Din Moscow,7392,7,6,7,7,19,22,-3,25
FK Rubin,7392,8,6,6,8,23,17,6,24
Rostov,7392,9,4,7,9,11,18,-7,19
Amkar,7392,10,5,4,11,13,25,-12,19
Anzhi,7392,11,3,6,11,18,40,-22,15
Loko Moscow,7393,1,13,5,2,31,11,20,44
Spart Moscow,7393,2,10,6,4,38,27,11,36
CSKA Moscow,7393,3,10,4,6,25,18,7,34
Zenit,7393,4,8,8,4,22,14,8,32
Krasnodar,7393,5,8,4,8,27,28,-1,28
Terek Grozny,7393,6,7,6,7,21,24,-3,27
Din Moscow,7393,7,6,6,8,19,23,-4,24
FK Rubin,7393,8,6,5,9,25,19,6,23
Amkar,7393,9,5,5,10,11,23,-12,20
Rostov,7393,10,4,6,10,11,20,-9,18
Anzhi,7393,11,2,7,11,15,38,-23,13
Loko Moscow,7394,1,12,5,3,33,13,20,41
Spart Moscow,7394,2,11,5,4,37,26,11,38
CSKA Moscow,7394,3,11,3,6,31,22,9,36
Zenit,7394,4,9,8,3,27,17,10,35
Krasnodar,7394,5,9,4,7,29,27,2,31
Terek Grozny,7394,6,8,5,7,23,24,-1,29
FK Rubin,7394,7,6,5,9,23,19,4,23
Din Moscow,7394,8,5,6,9,17,24,-7,21
Amkar,7394,9,5,4,11,10,23,-13,19
Rostov,7394,10,4,6,10,11,19,-8,18
Anzhi,7394,11,2,5,13,16,43,-27,11
Loko Moscow,7395,1,11,6,3,31,14,17,39
CSKA Moscow,7395,2,12,3,5,31,17,14,39
Spart Moscow,7395,3,9,7,4,37,28,9,34
Zenit,7395,4,8,8,4,23,15,8,32
Krasnodar,7395,5,9,5,6,30,26,4,32
Terek Grozny,7395,6,8,6,6,22,23,-1,30
Din Moscow,7395,7,5,8,7,20,24,-4,23
FK Rubin,7395,8,5,6,9,24,21,3,21
Rostov,7395,9,4,7,9,11,18,-7,19
Amkar,7395,10,4,5,11,11,25,-14,17
Anzhi,7395,11,2,5,13,14,43,-29,11
Loko Moscow,7396,1,13,5,2,31,11,20,44
CSKA Moscow,7396,2,12,3,5,28,18,10,39
Spart Moscow,7396,3,9,7,4,37,26,11,34
Krasnodar,7396,4,9,4,7,31,26,5,31
Zenit,7396,5,7,8,5,22,16,6,29
Terek Grozny,7396,6,8,5,7,22,24,-2,29
FK Rubin,7396,7,6,5,9,23,21,2,23
Din Moscow,7396,8,5,7,8,18,23,-5,22
Amkar,7396,9,5,5,10,10,22,-12,20
Rostov,7396,10,4,6,10,10,20,-10,18
Anzhi,7396,11,2,5,13,15,40,-25,11
Loko Moscow,7397,1,11,6,3,31,14,17,39
CSKA Moscow,7397,2,12,3,5,30,17,13,39
Spart Moscow,7397,3,10,5,5,38,28,10,35
Krasnodar,7397,4,10,4,6,30,25,5,34
Zenit,7397,5,7,9,4,22,17,5,30
Terek Grozny,7397,6,7,6,7,21,24,-3,27
FK Rubin,7397,7,6,5,9,23,19,4,23
Rostov,7397,8,5,6,9,12,18,-6,21
Din Moscow,7397,9,5,6,9,18,25,-7,21
Amkar,7397,10,5,4,11,12,25,-13,19
Anzhi,7397,11,2,6,12,14,39,-25,12
Loko Moscow,7398,1,11,5,4,29,14,15,38
Spart Moscow,7398,2,10,6,4,40,28,12,36
CSKA Moscow,7398,3,11,3,6,28,20,8,36
Zenit,7398,4,9,8,3,25,15,10,35
Krasnodar,7398,5,10,4,6,30,24,6,34
Terek Grozny,7398,6,7,6,7,21,24,-3,27
Din Moscow,7398,7,5,8,7,21,25,-4,23
FK Rubin,7398,8,5,6,9,23,20,3,21
Amkar,7398,9,5,4,11,11,25,-14,19
Rostov,7398,10,4,6,10,11,20,-9,18
Anzhi,7398,11,2,6,12,14,38,-24,12
Loko Moscow,7399,1,11,6,3,29,12,17,39
Spart Moscow,7399,2,10,5,5,40,27,13,35
CSKA Moscow,7399,3,10,5,5,25,17,8,35
Zenit,7399,4,7,10,3,21,13,8,31
Krasnodar,7399,5,9,4,7,28,25,3,31
Terek Grozny,7399,6,8,6,6,21,22,-1,30
FK Rubin,7399,7,7,5,8,23,17,6,26
Din Moscow,7399,8,6,6,8,19,22,-3,24
Rostov,7399,9,4,6,10,10,21,-11,18
Amkar,7399,10,4,4,12,9,26,-17,16
Anzhi,7399,11,2,7,11,14,37,-23,13
Loko Moscow,7400,1,11,6,3,30,15,15,39
CSKA Moscow,7400,2,12,3,5,33,20,13,39
Spart Moscow,7400,3,9,7,4,38,28,10,34
Krasnodar,7400,4,9,5,6,32,26,6,32
Zenit,7400,5,7,9,4,21,15,6,30
Terek Grozny,7400,6,8,6,6,22,23,-1,30
FK Rubin,7400,7,6,6,8,23,18,5,24
Din Moscow,7400,8,5,7,8,19,24,-5,22
Rostov,7400,9,4,7,9,10,17,-7,19
Amkar,7400,10,4,4,12,10,26,-16,16
Anzhi,7400,11,2,6,12,18,44,-26,12
Loko Moscow,7401,1,11,7,2,31,13,18,40
CSKA Moscow,7401,2,12,3,5,31,21,10,39
Spart Moscow,7401,3,10,5,5,40,28,12,35
Zenit,7401,4,7,9,4,24,17,7,30
Krasnodar,7401,5,8,5,7,27,25,2,29
Terek Grozny,7401,6,7,5,8,20,24,-4,26
FK Rubin,7401,7,6,6,8,23,18,5,24
Din Moscow,7401,8,5,7,8,18,24,-6,22
Amkar,7401,9,6,4,10,12,22,-10,22
Rostov,7401,10,4,6,10,11,22,-11,18
Anzhi,7401,11,3,5,12,18,41,-23,14
Loko Moscow,7402,1,12,6,2,32,13,19,42
CSKA Moscow,7402,2,11,3,6,27,20,7,36
Spart Moscow,7402,3,9,5,6,35,28,7,32
Krasnodar,7402,4,9,4,7,30,27,3,31
Zenit,7402,5,7,9,4,23,16,7,30
Terek Grozny,7402,6,8,5,7,22,26,-4,29
Din Moscow,7402,7,6,6,8,18,23,-5,24
Rostov,7402,8,5,6,9,12,17,-5,21
FK Rubin,7402,9,5,5,10,22,20,2,20
Amkar,7402,10,5,4,11,11,24,-13,19
Anzhi,7402,11,4,5,11,19,37,-18,17
Loko Moscow,7403,1,11,5,4,29,14,15,38
CSKA Moscow,7403,2,11,3,6,28,19,9,36
Zenit,7403,3,9,8,3,24,13,11,35
Spart Moscow,7403,4,10,5,5,37,28,9,35
Krasnodar,7403,5,10,4,6,31,24,7,34
Terek Grozny,7403,6,7,6,7,20,23,-3,27
Din Moscow,7403,7,5,7,8,18,23,-5,22
FK Rubin,7403,8,5,6,9,21,19,2,21
Rostov,7403,9,5,6,9,12,17,-5,21
Amkar,7403,10,5,4,11,10,24,-14,19
Anzhi,7403,11,2,6,12,14,40,-26,12
Loko Moscow,7404,1,11,5,4,30,16,14,38
Spart Moscow,7404,2,10,6,4,40,29,11,36
CSKA Moscow,7404,3,10,5,5,27,19,8,35
Krasnodar,7404,4,10,4,6,32,25,7,34
Zenit,7404,5,8,9,3,24,14,10,33
Terek Grozny,7404,6,9,5,6,24,23,1,32
Din Moscow,7404,7,6,6,8,20,24,-4,24
FK Rubin,7404,8,5,5,10,21,21,0,20
Rostov,7404,9,4,7,9,12,19,-7,19
Amkar,7404,10,4,4,12,10,25,-15,16
Anzhi,7404,11,2,6,12,16,41,-25,12
Loko Moscow,7405,1,12,5,3,32,13,19,41
CSKA Moscow,7405,2,11,3,6,30,21,9,36
Spart Moscow,7405,3,10,5,5,41,30,11,35
Krasnodar,7405,4,10,4,6,30,24,6,34
Zenit,7405,5,8,8,4,25,18,7,32
Terek Grozny,7405,6,8,6,6,23,23,0,30
Din Moscow,7405,7,6,6,8,23,26,-3,24
Rostov,7405,8,5,6,9,12,18,-6,21
FK Rubin,7405,9,5,5,10,23,23,0,20
Amkar,7405,10,4,4,12,10,28,-18,16
Anzhi,7405,11,2,6,12,16,41,-25,12
Loko Moscow,7406,1,11,6,3,30,15,15,39
CSKA Moscow,7406,2,11,4,5,28,19,9,37
Krasnodar,7406,3,10,4,6,33,25,8,34
Spart Moscow,7406,4,9,6,5,38,29,9,33
Terek Grozny,7406,5,9,5,6,27,22,5,32
Zenit,7406,6,7,10,3,22,14,8,31
Din Moscow,7406,7,6,7,7,20,23,-3,25
FK Rubin,7406,8,5,6,9,22,20,2,21
Rostov,7406,9,4,6,10,11,20,-9,18
Amkar,7406,10,4,5,11,10,26,-16,17
Anzhi,7406,11,2,5,13,15,43,-28,11
Loko Moscow,7407,1,11,6,3,31,14,17,39
CSKA Moscow,7407,2,11,3,6,27,18,9,36
Zenit,7407,3,9,8,3,24,14,10,35
Spart Moscow,7407,4,9,7,4,39,29,10,34
Krasnodar,7407,5,9,5,6,31,25,6,32
Terek Grozny,7407,6,8,5,7,22,24,-2,29
Din Moscow,7407,7,6,6,8,21,25,-4,24
FK Rubin,7407,8,5,5,10,21,22,-1,20
Rostov,7407,9,4,7,9,11,18,-7,19
Amkar,7407,10,4,5,11,11,25,-14,17
Anzhi,7407,11,3,5,12,15,39,-24,14
Loko Moscow,7408,1,11,6,3,31,14,17,39
Zenit,7408,2,9,8,3,24,14,10,35
CSKA Moscow,7408,3,10,4,6,25,18,7,34
Spart Moscow,7408,4,9,6,5,35,28,7,33
Terek Grozny,7408,5,8,6,6,23,23,0,30
Krasnodar,7408,6,8,5,7,29,28,1,29
Din Moscow,7408,7,6,7,7,20,23,-3,25
FK Rubin,7408,8,6,5,9,25,20,5,23
Rostov,7408,9,5,6,9,12,17,-5,21
Amkar,7408,10,4,5,11,10,24,-14,17
Anzhi,7408,11,2,6,12,14,39,-25,12
Loko Moscow,7409,1,12,5,3,30,12,18,41
Spart Moscow,7409,2,11,5,4,39,25,14,38
Krasnodar,7409,3,10,4,6,31,26,5,34
CSKA Moscow,7409,4,10,3,7,27,21,6,33
Zenit,7409,5,8,8,4,23,15,8,32
Terek Grozny,7409,6,9,5,6,25,22,3,32
Din Moscow,7409,7,5,7,8,18,26,-8,22
FK Rubin,7409,8,5,6,9,24,21,3,21
Rostov,7409,9,4,6,10,10,18,-8,18
Amkar,7409,10,4,4,12,9,26,-17,16
Anzhi,7409,11,3,5,12,16,40,-24,14
Loko Moscow,7410,1,11,7,2,31,13,18,40
CSKA Moscow,7410,2,11,3,6,27,19,8,36
Spart Moscow,7410,3,10,5,5,38,29,9,35
Zenit,7410,4,8,9,3,24,15,9,33
Krasnodar,7410,5,9,5,6,31,27,4,32
Terek Grozny,7410,6,9,5,6,24,23,1,32
FK Rubin,7410,7,6,5,9,25,21,4,23
Din Moscow,7410,8,5,6,9,18,25,-7,21
Amkar,7410,9,5,4,11,14,25,-11,19
Rostov,7410,10,4,6,10,10,20,-10,18
Anzhi,7410,11,2,5,13,14,39,-25,11
Loko Moscow,7411,1,11,6,3,32,15,17,39
CSKA Moscow,7411,2,11,3,6,30,19,11,36
Spart Moscow,7411,3,10,6,4,35,25,10,36
Krasnodar,7411,4,10,4,6,32,26,6,34
Zenit,7411,5,8,9,3,25,16,9,33
Terek Grozny,7411,6,8,6,6,22,23,-1,30
FK Rubin,7411,7,6,5,9,24,20,4,23
Din Moscow,7411,8,5,6,9,17,24,-7,21
Rostov,7411,9,4,7,9,10,17,-7,19
Amkar,7411,10,4,4,12,9,24,-15,16
Anzhi,7411,11,2,6,12,15,42,-27,12
Loko Moscow,7412,1,12,5,3,32,15,17,41
CSKA Moscow,7412,2,11,3,6,30,20,10,36
Zenit,7412,3,8,8,4,23,15,8,32
Spart Moscow,7412,4,9,5,6,37,31,6,32
Terek Grozny,7412,5,9,5,6,24,22,2,32
Krasnodar,7412,6,9,4,7,32,28,4,31
FK Rubin,7412,7,7,5,8,25,18,7,26
Din Moscow,7412,8,6,6,8,20,23,-3,24
Amkar,7412,9,5,4,11,11,24,-13,19
Rostov,7412,10,4,6,10,11,20,-9,18
Anzhi,7412,11,2,5,13,15,44,-29,11
Loko Moscow,7413,1,11,7,2,31,13,18,40
Spart Moscow,7413,2,10,5,5,36,29,7,35
CSKA Moscow,7413,3,10,4,6,26,20,6,34
Zenit,7413,4,8,9,3,24,14,10,33
Terek Grozny,7413,5,9,5,6,25,22,3,32
Krasnodar,7413,6,8,5,7,29,28,1,29
FK Rubin,7413,7,7,5,8,27,19,8,26
Din Moscow,7413,8,6,6,8,22,24,-2,24
Rostov,7413,9,4,6,10,10,19,-9,18
Amkar,7413,10,4,4,12,9,25,-16,16
Anzhi,7413,11,2,6,12,15,41,-26,12
Loko Moscow,7414,1,11,6,3,30,13,17,39
CSKA Moscow,7414,2,11,4,5,30,19,11,37
Krasnodar,7414,3,10,4,6,30,25,5,34
Spart Moscow,7414,4,9,6,5,37,29,8,33
Zenit,7414,5,7,10,3,22,14,8,31
Terek Grozny,7414,6,8,6,6,21,22,-1,30
Din Moscow,7414,7,6,7,7,20,22,-2,25
FK Rubin,7414,8,5,5,10,21,20,1,20
Amkar,7414,9,5,5,10,10,22,-12,20
Rostov,7414,10,4,6,10,12,20,-8,18
Anzhi,7414,11,2,5,13,15,42,-27,11
CSKA Moscow,7415,1,12,3,5,28,18,10,39
Loko Moscow,7415,2,11,5,4,29,13,16,38
Spart Moscow,7415,3,11,5,4,38,26,12,38
Zenit,7415,4,8,8,4,23,15,8,32
Krasnodar,7415,5,9,4,7,28,25,3,31
Terek Grozny,7415,6,7,6,7,23,26,-3,27
Din Moscow,7415,7,6,6,8,18,22,-4,24
FK Rubin,7415,8,6,5,9,22,18,4,23
Amkar,7415,9,5,4,11,12,25,-13,19
Rostov,7415,10,4,6,10,11,20,-9,18
Anzhi,7415,11,2,6,12,15,39,-24,12
Loko Moscow,7416,1,11,6,3,30,13,17,39
Spart Moscow,7416,2,10,6,4,37,27,10,36
CSKA Moscow,7416,3,11,3,6,29,21,8,36
Zenit,7416,4,9,8,3,25,14,11,35
Krasnodar,7416,5,9,5,6,30,26,4,32
Terek Grozny,7416,6,7,6,7,21,24,-3,27
FK Rubin,7416,7,6,5,9,24,19,5,23
Din Moscow,7416,8,5,6,9,17,24,-7,21
Rostov,7416,9,4,7,9,12,19,-7,19
Amkar,7416,10,4,5,11,10,24,-14,17
Anzhi,7416,11,3,5,12,16,40,-24,14
Loko Moscow,7417,1,11,7,2,31,13,18,40
Spart Moscow,7417,2,10,6,4,38,27,11,36
CSKA Moscow,7417,3,11,3,6,28,18,10,36
Zenit,7417,4,8,9,3,23,14,9,33
Krasnodar,7417,5,8,5,7,29,27,2,29
Terek Grozny,7417,6,7,6,7,20,23,-3,27
Din Moscow,7417,7,6,6,8,21,24,-3,24
FK Rubin,7417,8,6,5,9,23,21,2,23
Rostov,7417,9,4,7,9,11,18,-7,19
Amkar,7417,10,5,4,11,10,23,-13,19
Anzhi,7417,11,2,6,12,14,40,-26,12
Loko Moscow,7418,1,12,5,3,36,16,20,41
Spart Moscow,7418,2,10,6,4,39,28,11,36
CSKA Moscow,7418,3,11,3,6,29,20,9,36
Zenit,7418,4,9,8,3,25,14,11,35
Terek Grozny,7418,5,9,5,6,24,23,1,32
Krasnodar,7418,6,8,5,7,31,31,0,29
Din Moscow,7418,7,6,7,7,21,23,-2,25
FK Rubin,7418,8,5,6,9,22,20,2,21
Rostov,7418,9,4,6,10,10,19,-9,18
Amkar,7418,10,4,4,12,10,25,-15,16
Anzhi,7418,11,2,5,13,16,44,-28,11
Loko Moscow,7419,1,11,7,2,31,13,18,40
Spart Moscow,7419,2,9,7,4,36,27,9,34
Zenit,7419,3,8,9,3,24,15,9,33
CSKA Moscow,7419,4,10,3,7,27,21,6,33
Krasnodar,7419,5,9,5,6,29,25,4,32
Terek Grozny,7419,6,9,5,6,25,22,3,32
Din Moscow,7419,7,6,7,7,19,22,-3,25
FK Rubin,7419,8,5,5,10,21,19,2,20
Rostov,7419,9,4,7,9,10,17,-7,19
Amkar,7419,10,4,4,12,10,26,-16,16
Anzhi,7419,11,3,5,12,16,41,-25,14
Loko Moscow,7420,1,12,5,3,34,16,18,41
CSKA Moscow,7420,2,12,3,5,28,18,10,39
Krasnodar,7420,3,10,4,6,32,26,6,34
Spart Moscow,7420,4,9,6,5,37,30,7,33
Terek Grozny,7420,5,9,5,6,27,24,3,32
Zenit,7420,6,7,8,5,24,18,6,29
Din Moscow,7420,7,7,6,7,24,24,0,27
FK Rubin,7420,8,5,5,10,22,22,0,20
Rostov,7420,9,4,7,9,10,17,-7,19
Amkar,7420,10,4,4,12,11,27,-16,16
Anzhi,7420,11,2,5,13,15,42,-27,11
Loko Moscow,7421,1,12,6,2,33,14,19,42
CSKA Moscow,7421,2,11,4,5,28,17,11,37
Zenit,7421,3,7,10,3,24,16,8,31
Spart Moscow,7421,4,8,7,5,34,27,7,31
Krasnodar,7421,5,9,4,7,30,26,4,31
Terek Grozny,7421,6,8,6,6,23,24,-1,30
FK Rubin,7421,7,6,5,9,25,20,5,23
Din Moscow,7421,8,5,7,8,17,24,-7,22
Amkar,7421,9,5,5,10,11,23,-12,20
Rostov,7421,10,4,7,9,11,18,-7,19
Anzhi,7421,11,2,5,13,15,42,-27,11
Loko Moscow,7422,1,12,6,2,31,11,20,42
CSKA Moscow,7422,2,10,4,6,26,21,5,34
Zenit,7422,3,8,8,4,24,15,9,32
Spart Moscow,7422,4,8,5,7,35,31,4,29
Krasnodar,7422,5,8,5,7,27,25,2,29
Terek Grozny,7422,6,7,5,8,22,26,-4,26
Din Moscow,7422,7,6,7,7,19,22,-3,25
FK Rubin,7422,8,6,6,8,22,17,5,24
Amkar,7422,9,6,4,10,11,22,-11,22
Rostov,7422,10,5,6,9,13,18,-5,21
Anzhi,7422,11,3,6,11,18,40,-22,15
Loko Moscow,7423,1,11,6,3,30,14,16,39
CSKA Moscow,7423,2,12,3,5,29,17,12,39
Zenit,7423,3,8,8,4,23,15,8,32
Spart Moscow,7423,4,8,6,6,34,29,5,30
Krasnodar,7423,5,8,6,6,29,26,3,30
Terek Grozny,7423,6,7,7,6,20,22,-2,28
Din Moscow,7423,7,5,8,7,18,22,-4,23
FK Rubin,7423,8,5,7,8,22,18,4,22
Rostov,7423,9,5,6,9,12,17,-5,21
Amkar,7423,10,5,5,10,10,22,-12,20
Anzhi,7423,11,2,6,12,14,39,-25,12
Loko Moscow,7424,1,12,5,3,33,14,19,41
Krasnodar,7424,2,10,4,6,33,26,7,34
CSKA Moscow,7424,3,10,4,6,25,18,7,34
Spart Moscow,7424,4,9,5,6,37,30,7,32
Zenit,7424,5,8,8,4,23,16,7,32
Terek Grozny,7424,6,8,6,6,26,25,1,30
Din Moscow,7424,7,6,7,7,18,21,-3,25
FK Rubin,7424,8,5,6,9,22,21,1,21
Rostov,7424,9,5,6,9,13,19,-6,21
Amkar,7424,10,4,4,12,11,28,-17,16
Anzhi,7424,11,2,7,11,16,39,-23,13
Loko Moscow,7425,1,12,5,3,32,13,19,41
Spart Moscow,7425,2,11,5,4,38,26,12,38
CSKA Moscow,7425,3,11,3,6,29,19,10,36
Krasnodar,7425,4,10,4,6,32,26,6,34
Zenit,7425,5,8,8,4,22,16,6,32
Terek Grozny,7425,6,8,5,7,22,24,-2,29
Din Moscow,7425,7,5,7,8,18,23,-5,22
FK Rubin,7425,8,5,6,9,24,21,3,21
Rostov,7425,9,4,6,10,10,19,-9,18
Amkar,7425,10,4,4,12,11,26,-15,16
Anzhi,7425,11,3,5,12,16,41,-25,14
Loko Moscow,7426,1,13,5,2,35,12,23,44
CSKA Moscow,7426,2,11,3,6,27,19,8,36
Spart Moscow,7426,3,9,6,5,36,29,7,33
Zenit,7426,4,8,8,4,23,16,7,32
Terek Grozny,7426,5,8,6,6,23,23,0,30
Krasnodar,7426,6,8,4,8,29,29,0,28
FK Rubin,7426,7,6,6,8,24,19,5,24
Din Moscow,7426,8,5,8,7,20,24,-4,23
Rostov,7426,9,5,6,9,12,17,-5,21
Amkar,7426,10,4,5,11,9,23,-14,17
Anzhi,7426,11,2,5,13,15,42,-27,11
Loko Moscow,7427,1,12,5,3,32,13,19,41
CSKA Moscow,7427,2,12,3,5,28,17,11,39
Spart Moscow,7427,3,10,5,5,37,29,8,35
Krasnodar,7427,4,10,4,6,29,24,5,34
Zenit,7427,5,7,8,5,22,18,4,29
Terek Grozny,7427,6,7,6,7,23,26,-3,27
Din Moscow,7427,7,6,6,8,18,22,-4,24
FK Rubin,7427,8,5,5,10,21,19,2,20
Amkar,7427,9,5,5,10,16,26,-10,20
Rostov,7427,10,4,6,10,10,19,-9,18
Anzhi,7427,11,3,5,12,15,38,-23,14
Loko Moscow,7428,1,12,5,3,32,13,19,41
CSKA Moscow,7428,2,11,4,5,27,18,9,37
Krasnodar,7428,3,10,4,6,30,25,5,34
Spart Moscow,7428,4,9,6,5,36,28,8,33
Zenit,7428,5,7,8,5,21,16,5,29
Terek Grozny,7428,6,7,6,7,22,25,-3,27
FK Rubin,7428,7,6,5,9,25,20,5,23
Din Moscow,7428,8,5,7,8,19,25,-6,22
Rostov,7428,9,5,6,9,13,19,-6,21
Amkar,7428,10,5,4,11,11,24,-13,19
Anzhi,7428,11,2,7,11,16,39,-23,13
Loko Moscow,7429,1,12,5,3,31,13,18,41
CSKA Moscow,7429,2,11,3,6,27,23,4,36
Zenit,7429,3,9,8,3,28,14,14,35
Spart Moscow,7429,4,9,6,5,37,30,7,33
Krasnodar,7429,5,9,4,7,28,25,3,31
Terek Grozny,7429,6,8,6,6,24,24,0,30
Din Moscow,7429,7,6,6,8,19,24,-5,24
Rostov,7429,8,5,6,9,13,17,-4,21
FK Rubin,7429,9,5,5,10,22,20,2,20
Amkar,7429,10,4,6,10,12,25,-13,18
Anzhi,7429,11,2,5,13,16,42,-26,11
Spart Moscow,7430,1,11,5,4,41,26,15,38
Loko Moscow,7430,2,11,5,4,31,17,14,38
CSKA Moscow,7430,3,11,3,6,27,18,9,36
Zenit,7430,4,9,8,3,26,15,11,35
Krasnodar,7430,5,10,4,6,31,24,7,34
Terek Grozny,7430,6,7,5,8,21,29,-8,26
FK Rubin,7430,7,6,5,9,23,20,3,23
Din Moscow,7430,8,5,6,9,18,27,-9,21
Amkar,7430,9,5,4,11,12,25,-13,19
Rostov,7430,10,4,6,10,10,19,-9,18
Anzhi,7430,11,3,5,12,19,39,-20,14
Loko Moscow,7431,1,11,5,4,29,16,13,38
CSKA Moscow,7431,2,11,4,5,28,18,10,37
Krasnodar,7431,3,10,4,6,33,25,8,34
Zenit,7431,4,8,9,3,23,14,9,33
Spart Moscow,7431,5,9,6,5,40,32,8,33
Terek Grozny,7431,6,8,6,6,22,23,-1,30
Din Moscow,7431,7,6,7,7,23,26,-3,25
FK Rubin,7431,8,5,6,9,24,21,3,21
Rostov,7431,9,4,7,9,12,19,-7,19
Amkar,7431,10,4,5,11,11,25,-14,17
Anzhi,7431,11,2,5,13,14,40,-26,11
Loko Moscow,7432,1,11,6,3,31,14,17,39
Spart Moscow,7432,2,10,6,4,37,27,10,36
CSKA Moscow,7432,3,11,3,6,27,19,8,36
Krasnodar,7432,4,10,4,6,30,25,5,34
Zenit,7432,5,8,9,3,24,15,9,33
Terek Grozny,7432,6,8,6,6,23,24,-1,30
FK Rubin,7432,7,6,5,9,23,18,5,23
Din Moscow,7432,8,5,6,9,17,24,-7,21
Rostov,7432,9,4,6,10,11,19,-8,18
Amkar,7432,10,4,6,10,11,24,-13,18
Anzhi,7432,11,2,5,13,15,40,-25,11
Loko Moscow,7433,1,12,6,2,32,13,19,42
CSKA Moscow,7433,2,11,4,5,29,19,10,37
Spart Moscow,7433,3,9,5,6,38,31,7,32
Krasnodar,7433,4,9,5,6,30,25,5,32
Zenit,7433,5,7,9,4,23,16,7,30
Terek Grozny,7433,6,7,6,7,22,25,-3,27
Din Moscow,7433,7,6,6,8,21,25,-4,24
FK Rubin,7433,8,6,5,9,23,20,3,23
Amkar,7433,9,6,4,10,13,24,-11,22
Rostov,7433,10,4,6,10,11,19,-8,18
Anzhi,7433,11,2,6,12,16,41,-25,12
Loko Moscow,7434,1,13,5,2,34,12,22,44
CSKA Moscow,7434,2,10,4,6,26,20,6,34
Spart Moscow,7434,3,9,6,5,37,27,10,33
Zenit,7434,4,8,8,4,23,15,8,32
Terek Grozny,7434,5,8,5,7,24,24,0,29
Krasnodar,7434,6,8,4,8,29,32,-3,28
Din Moscow,7434,7,6,7,7,19,22,-3,25
FK Rubin,7434,8,6,5,9,26,19,7,23
Amkar,7434,9,6,4,10,12,23,-11,22
Rostov,7434,10,4,6,10,10,20,-10,18
Anzhi,7434,11,2,6,12,15,41,-26,12
Loko Moscow,7435,1,13,5,2,33,13,20,44
CSKA Moscow,7435,2,11,3,6,29,20,9,36
Spart Moscow,7435,3,9,6,5,36,26,10,33
Zenit,7435,4,8,8,4,24,16,8,32
Terek Grozny,7435,5,8,5,7,23,24,-1,29
Krasnodar,7435,6,8,4,8,29,30,-1,28
FK Rubin,7435,7,7,5,8,27,19,8,26
Din Moscow,7435,8,6,6,8,19,23,-4,24
Rostov,7435,9,4,7,9,10,17,-7,19
Amkar,7435,10,5,4,11,11,26,-15,19
Anzhi,7435,11,2,5,13,15,42,-27,11
Loko Moscow,7436,1,11,5,4,32,16,16,38
CSKA Moscow,7436,2,11,4,5,29,19,10,37
Zenit,7436,3,8,9,3,24,15,9,33
Spart Moscow,7436,4,9,6,5,37,31,6,33
Krasnodar,7436,5,9,5,6,31,27,4,32
Terek Grozny,7436,6,8,5,7,24,26,-2,29
FK Rubin,7436,7,6,6,8,24,19,5,24
Amkar,7436,8,6,4,10,17,24,-7,22
Din Moscow,7436,9,5,6,9,18,25,-7,21
Rostov,7436,10,4,7,9,12,19,-7,19
Anzhi,7436,11,2,5,13,15,42,-27,11
Loko Moscow,7437,1,13,5,2,33,12,21,44
CSKA Moscow,7437,2,11,3,6,26,18,8,36
Zenit,7437,3,8,8,4,22,15,7,32
Spart Moscow,7437,4,9,5,6,38,32,6,32
Krasnodar,7437,5,8,5,7,29,27,2,29
Terek Grozny,7437,6,8,5,7,22,24,-2,29
FK Rubin,7437,7,6,6,8,23,18,5,24
Amkar,7437,8,6,4,10,12,22,-10,22
Rostov,7437,9,5,6,9,13,17,-4,21
Din Moscow,7437,10,5,6,9,19,27,-8,21
Anzhi,7437,11,2,5,13,15,40,-25,11
Loko Moscow,7438,1,12,5,3,31,13,18,41
CSKA Moscow,7438,2,11,3,6,28,21,7,36
Zenit,7438,3,9,8,3,27,14,13,35
Spart Moscow,7438,4,9,6,5,36,27,9,33
Krasnodar,7438,5,9,4,7,29,25,4,31
Terek Grozny,7438,6,7,7,6,23,25,-2,28
Din Moscow,7438,7,5,8,7,18,22,-4,23
FK Rubin,7438,8,5,6,9,21,19,2,21
Rostov,7438,9,5,6,9,11,17,-6,21
Amkar,7438,10,4,5,11,11,26,-15,17
Anzhi,7438,11,2,6,12,15,41,-26,12
Loko Moscow,7439,1,11,5,4,30,15,15,38
CSKA Moscow,7439,2,11,3,6,27,19,8,36
Zenit,7439,3,9,8,3,24,14,10,35
Spart Moscow,7439,4,9,7,4,35,26,9,34
Krasnodar,7439,5,10,4,6,32,25,7,34
Terek Grozny,7439,6,8,5,7,21,23,-2,29
Din Moscow,7439,7,5,8,7,17,21,-4,23
FK Rubin,7439,8,5,6,9,21,19,2,21
Rostov,7439,9,4,7,9,10,17,-7,19
Amkar,7439,10,5,4,11,11,24,-13,19
Anzhi,7439,11,2,5,13,14,39,-25,11
Loko Moscow,7440,1,12,6,2,31,12,19,42
CSKA Moscow,7440,2,12,3,5,29,18,11,39
Spart Moscow,7440,3,9,6,5,34,26,8,33
Zenit,7440,4,7,8,5,22,16,6,29
Krasnodar,7440,5,8,5,7,29,27,2,29
Terek Grozny,7440,6,8,5,7,21,24,-3,29
Din Moscow,7440,7,6,6,8,20,23,-3,24
FK Rubin,7440,8,6,5,9,24,21,3,23
Amkar,7440,9,6,4,10,12,22,-10,22
Rostov,7440,10,4,7,9,10,17,-7,19
Anzhi,7440,11,2,5,13,14,40,-26,11
Loko Moscow,7441,1,11,6,3,31,14,17,39
CSKA Moscow,7441,2,10,5,5,26,18,8,35
Spart Moscow,7441,3,9,7,4,38,26,12,34
Krasnodar,7441,4,9,5,6,30,26,4,32
Zenit,7441,5,7,10,3,22,14,8,31
Terek Grozny,7441,6,8,6,6,23,24,-1,30
FK Rubin,7441,7,6,6,8,24,19,5,24
Din Moscow,7441,8,5,7,8,19,24,-5,22
Rostov,7441,9,4,7,9,10,17,-7,19
Amkar,7441,10,4,5,11,10,27,-17,17
Anzhi,7441,11,2,6,12,16,40,-24,12
CSKA Moscow,7442,1,12,3,5,31,18,13,39
Loko Moscow,7442,2,11,5,4,31,15,16,38
Spart Moscow,7442,3,10,5,5,40,27,13,35
Krasnodar,7442,4,10,4,6,32,27,5,34
Zenit,7442,5,8,8,4,23,16,7,32
Terek Grozny,7442,6,8,6,6,22,23,-1,30
Din Moscow,7442,7,6,6,8,21,25,-4,24
Rostov,7442,8,5,6,9,11,17,-6,21
FK Rubin,7442,9,5,5,10,24,23,1,20
Amkar,7442,10,4,5,11,10,27,-17,17
Anzhi,7442,11,2,5,13,15,42,-27,11
Loko Moscow,7443,1,12,5,3,31,12,19,41
Krasnodar,7443,2,10,4,6,31,24,7,34
Spart Moscow,7443,3,9,6,5,34,26,8,33
CSKA Moscow,7443,4,10,3,7,27,21,6,33
Zenit,7443,5,8,8,4,23,16,7,32
Terek Grozny,7443,6,9,5,6,22,22,0,32
FK Rubin,7443,7,6,5,9,22,20,2,23
Din Moscow,7443,8,5,6,9,17,23,-6,21
Rostov,7443,9,5,6,9,11,17,-6,21
Amkar,7443,10,4,5,11,9,23,-14,17
Anzhi,7443,11,3,5,12,16,39,-23,14
Loko Moscow,7444,1,11,5,4,29,16,13,38
Spart Moscow,7444,2,10,6,4,36,26,10,36
CSKA Moscow,7444,3,11,3,6,28,19,9,36
Zenit,7444,4,9,8,3,23,13,10,35
Krasnodar,7444,5,9,5,6,32,25,7,32
Terek Grozny,7444,6,7,7,6,21,23,-2,28
FK Rubin,7444,7,5,7,8,22,18,4,22
Din Moscow,7444,8,5,7,8,17,22,-5,22
Rostov,7444,9,4,7,9,11,18,-7,19
Amkar,7444,10,4,5,11,9,23,-14,17
Anzhi,7444,11,2,6,12,16,41,-25,12
Loko Moscow,7445,1,11,6,3,30,14,16,39
Spart Moscow,7445,2,10,5,5,39,28,11,35
CSKA Moscow,7445,3,10,5,5,28,20,8,35
Krasnodar,7445,4,10,4,6,31,25,6,34
Zenit,7445,5,7,10,3,24,16,8,31
Terek Grozny,7445,6,7,6,7,21,25,-4,27
Din Moscow,7445,7,6,6,8,21,25,-4,24
Rostov,7445,8,5,6,9,12,18,-6,21
FK Rubin,7445,9,5,5,10,23,22,1,20
Amkar,7445,10,4,5,11,9,24,-15,17
Anzhi,7445,11,3,6,11,18,39,-21,15
Loko Moscow,7446,1,13,5,2,33,13,20,44
Spart Moscow,7446,2,11,5,4,41,27,14,38
CSKA Moscow,7446,3,10,4,6,27,20,7,34
Zenit,7446,4,8,8,4,23,15,8,32
Krasnodar,7446,5,9,4,7,31,28,3,31
Terek Grozny,7446,6,7,7,6,24,26,-2,28
FK Rubin,7446,7,6,5,9,23,19,4,23
Din Moscow,7446,8,5,6,9,18,24,-6,21
Rostov,7446,9,4,6,10,10,19,-9,18
Amkar,7446,10,4,5,11,12,28,-16,17
Anzhi,7446,11,2,7,11,17,40,-23,13
Loko Moscow,7447,1,11,5,4,30,14,16,38
CSKA Moscow,7447,2,11,4,5,28,17,11,37
Spart Moscow,7447,3,10,6,4,37,26,11,36
Zenit,7447,4,8,9,3,22,13,9,33
Terek Grozny,7447,5,9,5,6,24,22,2,32
Krasnodar,7447,6,9,4,7,29,26,3,31
FK Rubin,7447,7,7,5,8,25,17,8,26
Din Moscow,7447,8,5,6,9,18,27,-9,21
Rostov,7447,9,4,7,9,10,17,-7,19
Amkar,7447,10,4,4,12,9,24,-15,16
Anzhi,7447,11,2,5,13,14,43,-29,11
Loko Moscow,7448,1,12,5,3,33,15,18,41
Spart Moscow,7448,2,11,5,4,42,29,13,38
CSKA Moscow,7448,3,10,5,5,27,19,8,35
Zenit,7448,4,8,9,3,25,16,9,33
Krasnodar,7448,5,8,5,7,29,27,2,29
Terek Grozny,7448,6,8,5,7,21,24,-3,29
FK Rubin,7448,7,6,6,8,23,18,5,24
Din Moscow,7448,8,5,6,9,19,26,-7,21
Amkar,7448,9,5,4,11,12,25,-13,19
Rostov,7448,10,4,6,10,11,19,-8,18
Anzhi,7448,11,2,6,12,15,39,-24,12
Loko Moscow,7449,1,13,5,2,32,11,21,44
CSKA Moscow,7449,2,11,3,6,26,18,8,36
Zenit,7449,3,8,8,4,22,15,7,32
Spart Moscow,7449,4,8,7,5,34,28,6,31
Krasnodar,7449,5,9,4,7,29,25,4,31
Terek Grozny,7449,6,7,7,6,22,24,-2,28
Din Moscow,7449,7,5,8,7,20,24,-4,23
FK Rubin,7449,8,5,6,9,23,21,2,21
Amkar,7449,9,5,5,10,12,23,-11,20
Rostov,7449,10,4,7,9,10,17,-7,19
Anzhi,7449,11,2,6,12,15,39,-24,12
Loko Moscow,7450,1,12,5,3,34,14,20,41
CSKA Moscow,7450,2,11,3,6,27,18,9,36
Spart Moscow,7450,3,9,5,6,38,30,8,32
Zenit,7450,4,8,8,4,22,16,6,32
Krasnodar,7450,5,9,5,6,31,27,4,32
Terek Grozny,7450,6,7,6,7,22,26,-4,27
FK Rubin,7450,7,6,6,8,24,18,6,24
Din Moscow,7450,8,6,6,8,19,24,-5,24
Amkar,7450,9,6,4,10,14,24,-10,22
Rostov,7450,10,4,6,10,11,20,-9,18
Anzhi,7450,11,2,6,12,15,40,-25,12
Loko Moscow,7451,1,11,7,2,30,12,18,40
CSKA Moscow,7451,2,12,3,5,31,17,14,39
Spart Moscow,7451,3,11,5,4,41,28,13,38
Terek Grozny,7451,4,9,5,6,23,22,1,32
Zenit,7451,5,7,9,4,22,15,7,30
Krasnodar,7451,6,8,6,6,28,25,3,30
FK Rubin,7451,7,6,6,8,23,18,5,24
Din Moscow,7451,8,5,6,9,18,25,-7,21
Rostov,7451,9,4,6,10,11,19,-8,18
Amkar,7451,10,4,4,12,10,27,-17,16
Anzhi,7451,11,2,5,13,14,43,-29,11
Loko Moscow,7452,1,13,5,2,32,11,21,44
CSKA Moscow,7452,2,11,3,6,28,19,9,36
Zenit,7452,3,8,8,4,22,15,7,32
Terek Grozny,7452,4,9,5,6,22,22,0,32
Spart Moscow,7452,5,8,5,7,34,31,3,29
Krasnodar,7452,6,8,5,7,29,27,2,29
Din Moscow,7452,7,7,6,7,20,22,-2,27
FK Rubin,7452,8,5,6,9,24,21,3,21
Rostov,7452,9,5,6,9,13,18,-5,21
Amkar,7452,10,5,4,11,11,23,-12,19
Anzhi,7452,11,2,5,13,15,41,-26,11
Loko Moscow,7453,1,12,5,3,34,16,18,41
CSKA Moscow,7453,2,12,3,5,29,17,12,39
Spart Moscow,7453,3,10,6,4,42,29,13,36
Krasnodar,7453,4,10,4,6,33,26,7,34
Zenit,7453,5,7,8,5,21,17,4,29
Terek Grozny,7453,6,7,5,8,21,26,-5,26
FK Rubin,7453,7,6,5,9,24,20,4,23
Din Moscow,7453,8,5,7,8,20,25,-5,22
Amkar,7453,9,5,4,11,15,28,-13,19
Rostov,7453,10,4,6,10,10,20,-10,18
Anzhi,7453,11,3,5,12,15,40,-25,14
Loko Moscow,7454,1,12,6,2,34,12,22,42
CSKA Moscow,7454,2,12,3,5,34,18,16,39
Spart Moscow,7454,3,9,6,5,39,28,11,33
Krasnodar,7454,4,9,4,7,29,28,1,31
Zenit,7454,5,7,9,4,23,17,6,30
Terek Grozny,7454,6,7,6,7,21,24,-3,27
FK Rubin,7454,7,6,5,9,23,19,4,23
Din Moscow,7454,8,5,7,8,17,23,-6,22
Amkar,7454,9,5,5,10,12,23,-11,20
Rostov,7454,10,4,6,10,11,23,-12,18
Anzhi,7454,11,3,5,12,15,43,-28,14
Loko Moscow,7455,1,12,5,3,30,12,18,41
CSKA Moscow,7455,2,11,3,6,26,21,5,36
Zenit,7455,3,8,8,4,25,14,11,32
Spart Moscow,7455,4,9,5,6,35,29,6,32
Krasnodar,7455,5,9,4,7,28,28,0,31
Terek Grozny,7455,6,8,5,7,23,25,-2,29
FK Rubin,7455,7,7,5,8,26,17,9,26
Din Moscow,7455,8,6,6,8,18,22,-4,24
Rostov,7455,9,5,6,9,12,17,-5,21
Amkar,7455,10,4,4,12,12,27,-15,16
Anzhi,7455,11,3,5,12,15,38,-23,14
Loko Moscow,7456,1,12,5,3,32,14,18,41
CSKA Moscow,7456,2,12,3,5,29,17,12,39
Spart Moscow,7456,3,10,5,5,37,26,11,35
Krasnodar,7456,4,9,4,7,30,27,3,31
Zenit,7456,5,7,8,5,22,16,6,29
Terek Grozny,7456,6,7,7,6,20,22,-2,28
Din Moscow,7456,7,6,6,8,18,24,-6,24
FK Rubin,7456,8,6,5,9,23,19,4,23
Rostov,7456,9,5,6,9,11,17,-6,21
Amkar,7456,10,4,5,11,9,23,-14,17
Anzhi,7456,11,2,6,12,14,40,-26,12
Loko Moscow,7457,1,11,6,3,30,13,17,39
CSKA Moscow,7457,2,11,4,5,26,17,9,37
Spart Moscow,7457,3,10,5,5,39,26,13,35
Zenit,7457,4,8,9,3,22,13,9,33
Krasnodar,7457,5,9,5,6,33,28,5,32
Terek Grozny,7457,6,7,5,8,20,25,-5,26
FK Rubin,7457,7,6,5,9,26,23,3,23
Amkar,7457,8,6,4,10,12,22,-10,22
Din Moscow,7457,9,5,6,9,18,25,-7,21
Rostov,7457,10,4,6,10,10,21,-11,18
Anzhi,7457,11,3,5,12,15,38,-23,14
Loko Moscow,7458,1,12,6,2,30,11,19,42
CSKA Moscow,7458,2,11,4,5,29,19,10,37
Terek Grozny,7458,3,9,5,6,25,24,1,32
Zenit,7458,4,7,10,3,21,13,8,31
Spart Moscow,7458,5,8,7,5,38,31,7,31
Krasnodar,7458,6,8,5,7,27,25,2,29
Din Moscow,7458,7,7,6,7,22,23,-1,27
FK Rubin,7458,8,5,6,9,22,20,2,21
Rostov,7458,9,4,7,9,10,17,-7,19
Amkar,7458,10,4,5,11,14,29,-15,17
Anzhi,7458,11,2,5,13,17,43,-26,11
Loko Moscow,7459,1,12,6,2,32,13,19,42
Spart Moscow,7459,2,10,5,5,39,30,9,35
CSKA Moscow,7459,3,10,5,5,25,17,8,35
Zenit,7459,4,7,10,3,23,15,8,31
Krasnodar,7459,5,9,4,7,29,25,4,31
Din Moscow,7459,6,7,6,7,22,23,-1,27
Terek Grozny,7459,7,7,6,7,23,27,-4,27
FK Rubin,7459,8,5,5,10,22,21,1,20
Amkar,7459,9,5,4,11,12,24,-12,19
Rostov,7459,10,4,6,10,12,21,-9,18
Anzhi,7459,11,2,7,11,16,39,-23,13
Loko Moscow,7460,1,12,6,2,31,12,19,42
CSKA Moscow,7460,2,12,3,5,30,19,11,39
Spart Moscow,7460,3,10,5,5,38,28,10,35
Krasnodar,7460,4,9,5,6,31,25,6,32
Zenit,7460,5,7,8,5,21,15,6,29
Terek Grozny,7460,6,8,5,7,21,23,-2,29
Din Moscow,7460,7,5,7,8,18,23,-5,22
Amkar,7460,8,6,4,10,12,22,-10,22
FK Rubin,7460,9,5,6,9,21,20,1,21
Rostov,7460,10,4,6,10,10,20,-10,18
Anzhi,7460,11,2,5,13,16,42,-26,11
Loko Moscow,7461,1,12,5,3,33,16,17,41
Spart Moscow,7461,2,10,6,4,37,27,10,36
Zenit,7461,3,9,8,3,27,14,13,35
CSKA Moscow,7461,4,10,4,6,25,20,5,34
Krasnodar,7461,5,9,4,7,30,27,3,31
Terek Grozny,7461,6,8,5,7,21,23,-2,29
FK Rubin,7461,7,6,5,9,22,18,4,23
Din Moscow,7461,8,5,6,9,18,24,-6,21
Rostov,7461,9,4,6,10,11,19,-8,18
Amkar,7461,10,4,5,11,9,23,-14,17
Anzhi,7461,11,3,6,11,15,37,-22,15
Loko Moscow,7462,1,11,5,4,31,15,16,38
Spart Moscow,7462,2,10,6,4,40,26,14,36
CSKA Moscow,7462,3,10,5,5,25,17,8,35
Zenit,7462,4,8,9,3,23,14,9,33
Krasnodar,7462,5,9,4,7,30,28,2,31
Terek Grozny,7462,6,7,7,6,20,22,-2,28
FK Rubin,7462,7,6,6,8,24,18,6,24
Din Moscow,7462,8,5,7,8,17,25,-8,22
Rostov,7462,9,4,6,10,10,19,-9,18
Amkar,7462,10,4,6,10,10,23,-13,18
Anzhi,7462,11,2,7,11,14,37,-23,13
Loko Moscow,7463,1,11,6,3,30,14,16,39
CSKA Moscow,7463,2,11,3,6,27,18,9,36
Zenit,7463,3,8,9,3,22,13,9,33
Spart Moscow,7463,4,8,7,5,37,31,6,31
Krasnodar,7463,5,9,4,7,31,27,4,31
Terek Grozny,7463,6,8,5,7,21,25,-4,29
Din Moscow,7463,7,6,7,7,23,26,-3,25
FK Rubin,7463,8,6,5,9,25,21,4,23
Amkar,7463,9,6,4,10,14,22,-8,22
Rostov,7463,10,4,7,9,11,18,-7,19
Anzhi,7463,11,2,5,13,14,40,-26,11
Loko Moscow,7464,1,12,5,3,32,15,17,41
Krasnodar,7464,2,10,4,6,30,24,6,34
Spart Moscow,7464,3,9,6,5,37,29,8,33
CSKA Moscow,7464,4,10,3,7,25,19,6,33
Zenit,7464,5,8,8,4,24,16,8,32
Terek Grozny,7464,6,8,6,6,23,23,0,30
Din Moscow,7464,7,6,7,7,20,23,-3,25
Rostov,7464,8,5,6,9,12,18,-6,21
FK Rubin,7464,9,5,5,10,22,20,2,20
Amkar,7464,10,4,5,11,10,24,-14,17
Anzhi,7464,11,3,5,12,16,40,-24,14
Loko Moscow,7465,1,12,5,3,32,14,18,41
CSKA Moscow,7465,2,11,3,6,29,21,8,36
Zenit,7465,3,9,8,3,26,15,11,35
Spart Moscow,7465,4,10,5,5,37,28,9,35
Krasnodar,7465,5,9,4,7,29,26,3,31
Terek Grozny,7465,6,7,5,8,20,25,-5,26
Din Moscow,7465,7,6,6,8,20,22,-2,24
Amkar,7465,8,6,4,10,13,22,-9,22
FK Rubin,7465,9,5,5,10,21,21,0,20
Rostov,7465,10,4,6,10,11,20,-9,18
Anzhi,7465,11,3,5,12,16,40,-24,14
Loko Moscow,7466,1,12,6,2,31,12,19,42
Spart Moscow,7466,2,11,5,4,38,27,11,38
CSKA Moscow,7466,3,11,3,6,28,19,9,36
Zenit,7466,4,8,8,4,23,14,9,32
Krasnodar,7466,5,9,5,6,30,25,5,32
Terek Grozny,7466,6,8,6,6,21,22,-1,30
FK Rubin,7466,7,6,5,9,23,20,3,23
Din Moscow,7466,8,5,6,9,20,26,-6,21
Rostov,7466,9,4,6,10,10,18,-8,18
Amkar,7466,10,4,4,12,9,24,-15,16
Anzhi,7466,11,2,6,12,14,40,-26,12
Loko Moscow,7467,1,12,5,3,31,12,19,41
CSKA Moscow,7467,2,11,4,5,29,17,12,37
Zenit,7467,3,8,9,3,22,13,9,33
Spart Moscow,7467,4,9,5,6,37,28,9,32
Terek Grozny,7467,5,9,5,6,24,24,0,32
Krasnodar,7467,6,8,5,7,28,27,1,29
Din Moscow,7467,7,6,7,7,20,22,-2,25
FK Rubin,7467,8,5,7,8,23,19,4,22
Rostov,7467,9,5,6,9,11,17,-6,21
Amkar,7467,10,4,4,12,10,28,-18,16
Anzhi,7467,11,2,5,13,15,43,-28,11
Loko Moscow,7468,1,13,5,2,32,12,20,44
Spart Moscow,7468,2,10,6,4,38,27,11,36
CSKA Moscow,7468,3,10,4,6,27,20,7,34
Zenit,7468,4,8,8,4,23,15,8,32
Krasnodar,7468,5,9,4,7,29,26,3,31
Terek Grozny,7468,6,8,6,6,23,22,1,30
Din Moscow,7468,7,5,7,8,18,23,-5,22
FK Rubin,7468,8,5,6,9,21,18,3,21
Rostov,7468,9,4,6,10,11,20,-9,18
Amkar,7468,10,4,6,10,9,22,-13,18
Anzhi,7468,11,2,6,12,15,41,-26,12
Loko Moscow,7469,1,12,5,3,31,14,17,41
CSKA Moscow,7469,2,12,3,5,31,17,14,39
Spart Moscow,7469,3,10,5,5,37,27,10,35
Zenit,7469,4,8,8,4,23,16,7,32
Krasnodar,7469,5,9,4,7,32,27,5,31
Terek Grozny,7469,6,7,6,7,21,25,-4,27
Din Moscow,7469,7,5,7,8,18,24,-6,22
FK Rubin,7469,8,5,6,9,23,22,1,21
Rostov,7469,9,5,6,9,11,17,-6,21
Amkar,7469,10,4,5,11,11,25,-14,17
Anzhi,7469,11,3,5,12,16,40,-24,14
Loko Moscow,7470,1,12,5,3,32,13,19,41
CSKA Moscow,7470,2,12,3,5,30,18,12,39
Spart Moscow,7470,3,10,5,5,40,26,14,35
Zenit,7470,4,8,8,4,23,17,6,32
Krasnodar,7470,5,8,5,7,28,27,1,29
Terek Grozny,7470,6,8,5,7,22,25,-3,29
FK Rubin,7470,7,6,6,8,24,19,5,24
Din Moscow,7470,8,6,6,8,19,23,-4,24
Amkar,7470,9,5,4,11,12,24,-12,19
Rostov,7470,10,4,6,10,10,22,-12,18
Anzhi,7470,11,2,5,13,15,41,-26,11
Loko Moscow,7471,1,11,6,3,30,13,17,39
CSKA Moscow,7471,2,11,4,5,30,19,11,37
Spart Moscow,7471,3,10,5,5,37,27,10,35
Krasnodar,7471,4,10,4,6,29,24,5,34
Terek Grozny,7471,5,9,5,6,26,25,1,32
Zenit,7471,6,7,10,3,23,15,8,31
Din Moscow,7471,7,6,6,8,18,22,-4,24
Rostov,7471,8,5,6,9,12,18,-6,21
FK Rubin,7471,9,5,5,10,21,19,2,20
Amkar,7471,10,4,4,12,10,26,-16,16
Anzhi,7471,11,2,5,13,17,45,-28,11
Loko Moscow,7472,1,12,6,2,33,14,19,42
CSKA Moscow,7472,2,11,4,5,26,17,9,37
Spart Moscow,7472,3,9,5,6,37,30,7,32
Krasnodar,7472,4,9,5,6,33,26,7,32
Zenit,7472,5,7,8,5,22,16,6,29
Terek Grozny,7472,6,8,5,7,22,23,-1,29
Din Moscow,7472,7,7,6,7,21,22,-1,27
FK Rubin,7472,8,5,5,10,21,23,-2,20
Amkar,7472,9,5,4,11,12,26,-14,19
Rostov,7472,10,4,6,10,10,18,-8,18
Anzhi,7472,11,3,6,11,15,37,-22,15
Loko Moscow,7473,1,12,6,2,31,12,19,42
CSKA Moscow,7473,2,12,3,5,29,18,11,39
Spart Moscow,7473,3,9,7,4,37,28,9,34
Zenit,7473,4,7,9,4,22,16,6,30
Krasnodar,7473,5,8,5,7,27,25,2,29
Terek Grozny,7473,6,7,5,8,21,25,-4,26
Din Moscow,7473,7,5,8,7,19,23,-4,23
FK Rubin,7473,8,5,7,8,22,18,4,22
Rostov,7473,9,4,7,9,11,18,-7,19
Amkar,7473,10,5,4,11,12,25,-13,19
Anzhi,7473,11,3,5,12,16,39,-23,14
Loko Moscow,7474,1,11,5,4,29,13,16,38
CSKA Moscow,7474,2,11,4,5,34,21,13,37
Zenit,7474,3,8,9,3,25,16,9,33
Krasnodar,7474,4,9,5,6,29,25,4,32
Spart Moscow,7474,5,8,6,6,36,32,4,30
Terek Grozny,7474,6,8,6,6,23,23,0,30
FK Rubin,7474,7,6,6,8,24,19,5,24
Din Moscow,7474,8,6,6,8,21,23,-2,24
Amkar,7474,9,5,5,10,13,25,-12,20
Rostov,7474,10,4,7,9,10,17,-7,19
Anzhi,7474,11,2,5,13,16,46,-30,11
Loko Moscow,7475,1,12,6,2,33,13,20,42
CSKA Moscow,7475,2,11,4,5,28,18,10,37
Spart Moscow,7475,3,10,5,5,37,28,9,35
Zenit,7475,4,7,9,4,22,16,6,30
Krasnodar,7475,5,8,6,6,31,28,3,30
Terek Grozny,7475,6,7,6,7,21,24,-3,27
Din Moscow,7475,7,6,6,8,19,23,-4,24
FK Rubin,7475,8,5,6,9,23,20,3,21
Rostov,7475,9,5,6,9,11,17,-6,21
Amkar,7475,10,5,4,11,11,24,-13,19
Anzhi,7475,11,2,6,12,15,40,-25,12
Loko Moscow,7476,1,12,5,3,33,14,19,41
CSKA Moscow,7476,2,11,3,6,27,21,6,36
Zenit,7476,3,9,8,3,27,15,12,35
Spart Moscow,7476,4,10,5,5,39,29,10,35
Krasnodar,7476,5,8,5,7,30,29,1,29
Terek Grozny,7476,6,7,6,7,20,23,-3,27
FK Rubin,7476,7,5,7,8,23,19,4,22
Din Moscow,7476,8,5,7,8,17,22,-5,22
Rostov,7476,9,5,6,9,12,18,-6,21
Amkar,7476,10,4,5,11,11,26,-15,17
Anzhi,7476,11,3,5,12,15,38,-23,14
Loko Moscow,7477,1,12,6,2,30,11,19,42
Spart Moscow,7477,2,10,6,4,41,30,11,36
CSKA Moscow,7477,3,10,4,6,27,21,6,34
Krasnodar,7477,4,9,5,6,28,24,4,32
Zenit,7477,5,7,9,4,22,15,7,30
Terek Grozny,7477,6,8,5,7,23,25,-2,29
Din Moscow,7477,7,5,8,7,17,21,-4,23
FK Rubin,7477,8,5,6,9,21,18,3,21
Rostov,7477,9,4,6,10,13,21,-8,18
Anzhi,7477,10,4,5,11,20,40,-20,17
Amkar,7477,11,4,4,12,11,27,-16,16
Loko Moscow,7478,1,13,5,2,32,12,20,44
CSKA Moscow,7478,2,11,4,5,29,19,10,37
Spart Moscow,7478,3,10,6,4,39,27,12,36
Zenit,7478,4,7,9,4,24,17,7,30
Terek Grozny,7478,5,8,5,7,22,24,-2,29
Krasnodar,7478,6,8,4,8,28,27,1,28
FK Rubin,7478,7,7,5,8,25,18,7,26
Din Moscow,7478,8,5,6,9,18,26,-8,21
Rostov,7478,9,4,7,9,10,17,-7,19
Amkar,7478,10,5,4,11,12,25,-13,19
Anzhi,7478,11,2,5,13,14,41,-27,11
Loko Moscow,7479,1,12,5,3,31,13,18,41
CSKA Moscow,7479,2,11,3,6,27,20,7,36
Spart Moscow,7479,3,10,5,5,39,27,12,35
Zenit,7479,4,8,8,4,23,14,9,32
Krasnodar,7479,5,9,5,6,30,26,4,32
Terek Grozny,7479,6,7,7,6,22,24,-2,28
FK Rubin,7479,7,6,6,8,25,19,6,24
Din Moscow,7479,8,6,6,8,19,24,-5,24
Rostov,7479,9,4,6,10,10,21,-11,18
Amkar,7479,10,4,5,11,11,25,-14,17
Anzhi,7479,11,2,6,12,16,40,-24,12
Loko Moscow,7480,1,11,7,2,31,13,18,40
Spart Moscow,7480,2,10,6,4,39,25,14,36
CSKA Moscow,7480,3,11,3,6,27,18,9,36
Zenit,7480,4,8,9,3,22,13,9,33
Krasnodar,7480,5,9,5,6,30,26,4,32
Terek Grozny,7480,6,7,6,7,24,28,-4,27
FK Rubin,7480,7,6,5,9,22,18,4,23
Din Moscow,7480,8,5,6,9,17,26,-9,21
Rostov,7480,9,4,7,9,10,17,-7,19
Amkar,7480,10,5,4,11,11,24,-13,19
Anzhi,7480,11,2,6,12,18,43,-25,12
Loko Moscow,7481,1,11,5,4,30,15,15,38
CSKA Moscow,7481,2,11,3,6,27,19,8,36
Spart Moscow,7481,3,10,5,5,38,28,10,35
Zenit,7481,4,9,8,3,24,14,10,35
Krasnodar,7481,5,9,4,7,29,25,4,31
Terek Grozny,7481,6,7,6,7,21,24,-3,27
Din Moscow,7481,7,6,6,8,19,24,-5,24
FK Rubin,7481,8,6,5,9,22,18,4,23
Amkar,7481,9,6,4,10,12,23,-11,22
Rostov,7481,10,4,6,10,10,18,-8,18
Anzhi,7481,11,2,6,12,16,40,-24,12
Loko Moscow,7482,1,12,6,2,33,14,19,42
CSKA Moscow,7482,2,11,4,5,26,17,9,37
Spart Moscow,7482,3,9,7,4,39,28,11,34
Krasnodar,7482,4,9,5,6,30,26,4,32
Zenit,7482,5,7,9,4,22,15,7,30
Terek Grozny,7482,6,8,5,7,22,25,-3,29
FK Rubin,7482,7,6,5,9,23,19,4,23
Din Moscow,7482,8,5,6,9,19,27,-8,21
Amkar,7482,9,5,5,10,11,22,-11,20
Rostov,7482,10,4,7,9,12,19,-7,19
Anzhi,7482,11,2,5,13,15,40,-25,11
Loko Moscow,7483,1,11,6,3,30,13,17,39
Spart Moscow,7483,2,10,6,4,37,26,11,36
CSKA Moscow,7483,3,11,3,6,27,20,7,36
Zenit,7483,4,8,9,3,23,13,10,33
Krasnodar,7483,5,9,5,6,30,26,4,32
Terek Grozny,7483,6,7,7,6,22,24,-2,28
FK Rubin,7483,7,5,7,8,23,19,4,22
Din Moscow,7483,8,5,7,8,18,23,-5,22
Rostov,7483,9,4,6,10,10,19,-9,18
Amkar,7483,10,4,6,10,11,24,-13,18
Anzhi,7483,11,2,6,12,16,40,-24,12
Loko Moscow,7484,1,12,6,2,33,14,19,42
CSKA Moscow,7484,2,11,3,6,26,20,6,36
Spart Moscow,7484,3,9,7,4,42,31,11,34
Zenit,7484,4,8,9,3,26,15,11,33
Krasnodar,7484,5,9,4,7,30,27,3,31
Terek Grozny,7484,6,8,5,7,24,26,-2,29
FK Rubin,7484,7,6,5,9,25,20,5,23
Din Moscow,7484,8,5,6,9,19,28,-9,21
Rostov,7484,9,4,7,9,12,19,-7,19
Amkar,7484,10,4,5,11,13,27,-14,17
Anzhi,7484,11,3,5,12,17,40,-23,14
Loko Moscow,7485,1,13,5,2,34,13,21,44
CSKA Moscow,7485,2,11,4,5,29,19,10,37
Spart Moscow,7485,3,10,6,4,41,27,14,36
Zenit,7485,4,7,9,4,24,17,7,30
Terek Grozny,7485,5,8,5,7,22,24,-2,29
Krasnodar,7485,6,8,4,8,27,28,-1,28
FK Rubin,7485,7,6,6,8,23,17,6,24
Din Moscow,7485,8,5,8,7,19,23,-4,23
Rostov,7485,9,4,6,10,10,20,-10,18
Amkar,7485,10,4,4,12,9,26,-17,16
Anzhi,7485,11,3,5,12,17,41,-24,14
Loko Moscow,7486,1,12,6,2,33,13,20,42
CSKA Moscow,7486,2,11,3,6,31,20,11,36
Spart Moscow,7486,3,10,5,5,40,26,14,35
Zenit,7486,4,8,8,4,24,16,8,32
Krasnodar,7486,5,9,5,6,31,27,4,32
Terek Grozny,7486,6,8,6,6,22,23,-1,30
Din Moscow,7486,7,5,7,8,17,23,-6,22
FK Rubin,7486,8,5,6,9,22,19,3,21
Amkar,7486,9,5,5,10,11,23,-12,20
Rostov,7486,10,4,6,10,10,22,-12,18
Anzhi,7486,11,2,5,13,14,43,-29,11
Loko Moscow,7487,1,11,7,2,29,11,18,40
CSKA Moscow,7487,2,12,3,5,28,17,11,39
Spart Moscow,7487,3,10,6,4,39,27,12,36
Zenit,7487,4,7,9,4,21,14,7,30
Krasnodar,7487,5,8,6,6,27,24,3,30
Terek Grozny,7487,6,8,6,6,22,23,-1,30
FK Rubin,7487,7,6,6,8,23,17,6,24
Din Moscow,7487,8,5,6,9,18,25,-7,21
Rostov,7487,9,4,6,10,10,20,-10,18
Amkar,7487,10,4,6,10,11,24,-13,18
Anzhi,7487,11,2,5,13,14,40,-26,11
Loko Moscow,7488,1,11,5,4,31,17,14,38
CSKA Moscow,7488,2,11,4,5,26,17,9,37
Zenit,7488,3,8,9,3,24,15,9,33
Krasnodar,7488,4,9,5,6,32,26,6,32
Spart Moscow,7488,5,8,6,6,34,29,5,30
Din Moscow,7488,6,7,6,7,21,22,-1,27
Terek Grozny,7488,7,7,5,8,22,27,-5,26
FK Rubin,7488,8,5,6,9,24,21,3,21
Rostov,7488,9,5,6,9,11,17,-6,21
Amkar,7488,10,5,5,10,11,23,-12,20
Anzhi,7488,11,3,5,12,18,40,-22,14
Loko Moscow,7489,1,11,6,3,30,14,16,39
Spart Moscow,7489,2,11,5,4,42,28,14,38
CSKA Moscow,7489,3,10,4,6,26,19,7,34
Zenit,7489,4,8,9,3,23,13,10,33
Krasnodar,7489,5,9,5,6,29,25,4,32
Terek Grozny,7489,6,7,5,8,20,24,-4,26
Din Moscow,7489,7,5,7,8,19,24,-5,22
FK Rubin,7489,8,5,6,9,22,19,3,21
Amkar,7489,9,5,4,11,10,26,-16,19
Rostov,7489,10,4,6,10,12,20,-8,18
Anzhi,7489,11,4,5,11,17,38,-21,17
Loko Moscow,7490,1,12,5,3,33,15,18,41
Spart Moscow,7490,2,11,5,4,39,27,12,38
CSKA Moscow,7490,3,10,5,5,27,19,8,35
Krasnodar,7490,4,10,4,6,33,28,5,34
Zenit,7490,5,7,9,4,22,15,7,30
Terek Grozny,7490,6,7,5,8,23,29,-6,26
Din Moscow,7490,7,6,6,8,21,25,-4,24
FK Rubin,7490,8,5,5,10,23,21,2,20
Amkar,7490,9,5,4,11,12,24,-12,19
Rostov,7490,10,4,6,10,10,18,-8,18
Anzhi,7490,11,3,6,11,19,41,-22,15
Loko Moscow,7491,1,12,5,3,32,14,18,41
CSKA Moscow,7491,2,12,3,5,32,18,14,39
Spart Moscow,7491,3,10,6,4,41,29,12,36
Krasnodar,7491,4,10,4,6,32,25,7,34
Zenit,7491,5,7,8,5,21,18,3,29
Terek Grozny,7491,6,7,6,7,22,25,-3,27
Din Moscow,7491,7,6,6,8,19,25,-6,24
FK Rubin,7491,8,5,5,10,22,21,1,20
Rostov,7491,9,4,7,9,13,20,-7,19
Amkar,7491,10,4,5,11,12,26,-14,17
Anzhi,7491,11,3,5,12,16,41,-25,14
Loko Moscow,7492,1,12,5,3,30,13,17,41
Spart Moscow,7492,2,10,6,4,41,27,14,36
CSKA Moscow,7492,3,11,3,6,26,18,8,36
Krasnodar,7492,4,10,4,6,32,24,8,34
Zenit,7492,5,8,8,4,22,14,8,32
Terek Grozny,7492,6,7,5,8,20,27,-7,26
Din Moscow,7492,7,6,6,8,18,26,-8,24
FK Rubin,7492,8,5,5,10,21,21,0,20
Amkar,7492,9,5,5,10,11,23,-12,20
Rostov,7492,10,4,6,10,11,19,-8,18
Anzhi,7492,11,3,5,12,18,38,-20,14
Loko Moscow,7493,1,12,5,3,34,16,18,41
CSKA Moscow,7493,2,12,3,5,29,17,12,39
Spart Moscow,7493,3,10,6,4,37,27,10,36
Krasnodar,7493,4,10,4,6,33,25,8,34
Terek Grozny,7493,5,8,6,6,22,23,-1,30
Zenit,7493,6,7,8,5,23,19,4,29
FK Rubin,7493,7,6,5,9,23,20,3,23
Din Moscow,7493,8,5,6,9,18,24,-6,21
Rostov,7493,9,4,6,10,10,18,-8,18
Amkar,7493,10,4,6,10,11,24,-13,18
Anzhi,7493,11,2,5,13,14,41,-27,11
Loko Moscow,7494,1,12,6,2,33,13,20,42
CSKA Moscow,7494,2,10,4,6,27,22,5,34
Spart Moscow,7494,3,9,6,5,38,29,9,33
Zenit,7494,4,8,8,4,25,16,9,32
Krasnodar,7494,5,8,6,6,29,26,3,30
Terek Grozny,7494,6,7,6,7,23,26,-3,27
FK Rubin,7494,7,6,6,8,24,19,5,24
Din Moscow,7494,8,6,6,8,19,23,-4,24
Rostov,7494,9,4,7,9,10,17,-7,19
Amkar,7494,10,4,5,11,15,30,-15,17
Anzhi,7494,11,3,6,11,17,39,-22,15
Loko Moscow,7495,1,12,5,3,31,14,17,41
CSKA Moscow,7495,2,10,4,6,25,18,7,34
Zenit,7495,3,8,8,4,22,15,7,32
Spart Moscow,7495,4,8,7,5,36,29,7,31
Krasnodar,7495,5,9,4,7,30,26,4,31
Terek Grozny,7495,6,7,7,6,23,25,-2,28
FK Rubin,7495,7,6,6,8,24,18,6,24
Din Moscow,7495,8,5,8,7,19,23,-4,23
Amkar,7495,9,5,5,10,12,24,-12,20
Rostov,7495,10,4,7,9,12,19,-7,19
Anzhi,7495,11,2,7,11,15,38,-23,13
Loko Moscow,7496,1,11,7,2,31,13,18,40
CSKA Moscow,7496,2,11,3,6,29,22,7,36
Zenit,7496,3,8,9,3,26,15,11,33
Spart Moscow,7496,4,8,7,5,35,28,7,31
Krasnodar,7496,5,8,5,7,28,26,2,29
Terek Grozny,7496,6,8,5,7,23,24,-1,29
FK Rubin,7496,7,7,5,8,24,17,7,26
Din Moscow,7496,8,5,7,8,17,23,-6,22
Rostov,7496,9,4,7,9,12,19,-7,19
Amkar,7496,10,5,4,11,11,25,-14,19
Anzhi,7496,11,3,5,12,16,40,-24,14
Loko Moscow,7497,1,11,6,3,30,13,17,39
CSKA Moscow,7497,2,11,4,5,29,18,11,37
Zenit,7497,3,8,9,3,22,13,9,33
Spart Moscow,7497,4,9,6,5,36,28,8,33
Krasnodar,7497,5,8,5,7,28,29,-1,29
FK Rubin,7497,6,7,5,8,27,18,9,26
Terek Grozny,7497,7,7,5,8,21,27,-6,26
Din Moscow,7497,8,5,7,8,19,24,-5,22
Rostov,7497,9,5,6,9,12,17,-5,21
Amkar,7497,10,5,4,11,11,24,-13,19
Anzhi,7497,11,3,5,12,18,42,-24,14
Loko Moscow,7498,1,12,6,2,32,11,21,42
Spart Moscow,7498,2,9,6,5,39,30,9,33
CSKA Moscow,7498,3,10,3,7,26,21,5,33
Zenit,7498,4,8,8,4,23,17,6,32
Krasnodar,7498,5,9,5,6,29,24,5,32
Terek Grozny,7498,6,7,6,7,22,25,-3,27
Din Moscow,7498,7,5,8,7,19,23,-4,23
FK Rubin,7498,8,5,6,9,21,19,2,21
Amkar,7498,9,5,5,10,12,24,-12,20
Rostov,7498,10,4,6,10,11,20,-9,18
Anzhi,7498,11,4,5,11,18,38,-20,17
Loko Moscow,7499,1,13,5,2,33,12,21,44
CSKA Moscow,7499,2,11,4,5,27,18,9,37
Spart Moscow,7499,3,10,5,5,36,26,10,35
Zenit,7499,4,7,9,4,22,16,6,30
Krasnodar,7499,5,8,5,7,28,26,2,29
Terek Grozny,7499,6,8,5,7,22,25,-3,29
Din Moscow,7499,7,7,6,7,20,22,-2,27
FK Rubin,7499,8,5,6,9,22,19,3,21
Amkar,7499,9,5,4,11,12,24,-12,19
Rostov,7499,10,4,6,10,10,19,-9,18
Anzhi,7499,11,2,5,13,14,39,-25,11
Loko Moscow,7500,1,13,5,2,35,12,23,44
CSKA Moscow,7500,2,10,5,5,26,18,8,35
Spart Moscow,7500,3,9,7,4,35,26,9,34
Zenit,7500,4,7,9,4,22,18,4,30
Terek Grozny,7500,5,8,6,6,23,23,0,30
Krasnodar,7500,6,8,4,8,28,27,1,28
FK Rubin,7500,7,6,6,8,23,18,5,24
Din Moscow,7500,8,5,8,7,18,22,-4,23
Rostov,7500,9,4,6,10,10,18,-8,18
Amkar,7500,10,4,6,10,11,24,-13,18
Anzhi,7500,11,2,6,12,14,39,-25,12
Loko Moscow,7501,1,11,7,2,31,13,18,40
CSKA Moscow,7501,2,11,4,5,27,18,9,37
Spart Moscow,7501,3,9,6,5,38,28,10,33
Krasnodar,7501,4,9,5,6,30,26,4,32
Zenit,7501,5,7,10,3,23,15,8,31
Terek Grozny,7501,6,8,6,6,21,22,-1,30
Din Moscow,7501,7,7,6,7,20,21,-1,27
FK Rubin,7501,8,5,5,10,22,21,1,20
Rostov,7501,9,4,6,10,11,21,-10,18
Amkar,7501,10,4,5,11,10,24,-14,17
Anzhi,7501,11,2,6,12,14,38,-24,12
Loko Moscow,7502,1,13,5,2,35,13,22,44
Spart Moscow,7502,2,10,6,4,40,28,12,36
CSKA Moscow,7502,3,10,4,6,27,22,5,34
Zenit,7502,4,7,9,4,22,15,7,30
Krasnodar,7502,5,8,5,7,30,30,0,29
Terek Grozny,7502,6,8,5,7,23,25,-2,29
FK Rubin,7502,7,5,7,8,22,18,4,22
Din Moscow,7502,8,5,7,8,17,23,-6,22
Rostov,7502,9,4,7,9,12,19,-7,19
Amkar,7502,10,5,4,11,13,27,-14,19
Anzhi,7502,11,3,5,12,18,39,-21,14
Loko Moscow,7503,1,12,5,3,32,13,19,41
Spart Moscow,7503,2,10,6,4,41,30,11,36
CSKA Moscow,7503,3,10,4,6,26,19,7,34
Zenit,7503,4,8,9,3,23,14,9,33
Krasnodar,7503,5,9,4,7,30,27,3,31
Terek Grozny,7503,6,7,6,7,21,24,-3,27
Din Moscow,7503,7,5,8,7,19,23,-4,23
FK Rubin,7503,8,5,6,9,22,20,2,21
Rostov,7503,9,4,6,10,11,20,-9,18
Amkar,7503,10,4,5,11,12,26,-14,17
Anzhi,7503,11,4,5,11,17,38,-21,17
Loko Moscow,7504,1,12,6,2,31,12,19,42
Spart Moscow,7504,2,11,5,4,41,26,15,38
CSKA Moscow,7504,3,11,4,5,30,19,11,37
Zenit,7504,4,7,9,4,23,16,7,30
Krasnodar,7504,5,8,6,6,29,26,3,30
Terek Grozny,7504,6,7,7,6,20,22,-2,28
FK Rubin,7504,7,5,7,8,22,18,4,22
Din Moscow,7504,8,5,7,8,18,23,-5,22
Rostov,7504,9,4,6,10,10,20,-10,18
Amkar,7504,10,4,5,11,9,25,-16,17
Anzhi,7504,11,2,6,12,14,40,-26,12
Loko Moscow,7505,1,11,6,3,30,16,14,39
CSKA Moscow,7505,2,12,3,5,30,17,13,39
Krasnodar,7505,3,10,4,6,35,24,11,34
Spart Moscow,7505,4,9,6,5,36,28,8,33
Zenit,7505,5,7,9,4,22,15,7,30
Terek Grozny,7505,6,8,5,7,23,23,0,29
Din Moscow,7505,7,5,8,7,20,24,-4,23
FK Rubin,7505,8,5,6,9,23,23,0,21
Rostov,7505,9,5,6,9,12,18,-6,21
Amkar,7505,10,5,4,11,10,23,-13,19
Anzhi,7505,11,2,5,13,14,44,-30,11
Loko Moscow,7506,1,12,6,2,31,12,19,42
CSKA Moscow,7506,2,11,3,6,31,18,13,36
Spart Moscow,7506,3,10,5,5,40,28,12,35
Zenit,7506,4,8,9,3,23,14,9,33
Terek Grozny,7506,5,8,5,7,23,25,-2,29
Krasnodar,7506,6,8,4,8,28,27,1,28
Din Moscow,7506,7,6,6,8,20,23,-3,24
FK Rubin,7506,8,6,5,9,23,21,2,23
Rostov,7506,9,5,6,9,13,18,-5,21
Amkar,7506,10,5,4,11,11,27,-16,19
Anzhi,7506,11,2,5,13,15,45,-30,11
Loko Moscow,7507,1,13,5,2,36,12,24,44
CSKA Moscow,7507,2,12,3,5,33,18,15,39
Spart Moscow,7507,3,10,6,4,40,26,14,36
Krasnodar,7507,4,9,4,7,31,28,3,31
Zenit,7507,5,7,8,5,22,20,2,29
Terek Grozny,7507,6,7,6,7,24,28,-4,27
Din Moscow,7507,7,6,6,8,18,24,-6,24
FK Rubin,7507,8,5,5,10,22,21,1,20
Rostov,7507,9,4,6,10,10,20,-10,18
Amkar,7507,10,4,6,10,13,26,-13,18
Anzhi,7507,11,3,5,12,17,43,-26,14
Loko Moscow,7508,1,11,6,3,31,15,16,39
CSKA Moscow,7508,2,10,5,5,27,19,8,35
Zenit,7508,3,7,10,3,21,13,8,31
Spart Moscow,7508,4,8,7,5,36,30,6,31
Krasnodar,7508,5,9,4,7,32,28,4,31
Terek Grozny,7508,6,8,5,7,24,25,-1,29
FK Rubin,7508,7,7,5,8,27,19,8,26
Din Moscow,7508,8,5,7,8,19,26,-7,22
Amkar,7508,9,6,4,10,14,24,-10,22
Rostov,7508,10,4,7,9,11,18,-7,19
Anzhi,7508,11,2,6,12,17,42,-25,12
Loko Moscow,7509,1,13,5,2,33,13,20,44
CSKA Moscow,7509,2,12,3,5,28,18,10,39
Spart Moscow,7509,3,9,7,4,36,26,10,34
Krasnodar,7509,4,9,4,7,30,27,3,31
Zenit,7509,5,7,8,5,23,17,6,29
Terek Grozny,7509,6,7,5,8,21,25,-4,26
Din Moscow,7509,7,6,6,8,18,23,-5,24
FK Rubin,7509,8,5,5,10,22,20,2,20
Amkar,7509,9,5,5,10,10,22,-12,20
Rostov,7509,10,4,7,9,11,18,-7,19
Anzhi,7509,11,3,5,12,16,39,-23,14
Loko Moscow,7510,1,12,5,3,33,14,19,41
CSKA Moscow,7510,2,11,4,5,27,18,9,37
Spart Moscow,7510,3,9,5,6,36,30,6,32
Krasnodar,7510,4,9,4,7,29,26,3,31
Zenit,7510,5,7,9,4,24,18,6,30
Terek Grozny,7510,6,8,5,7,23,23,0,29
FK Rubin,7510,7,6,6,8,25,20,5,24
Din Moscow,7510,8,5,7,8,21,26,-5,22
Amkar,7510,9,6,4,10,12,22,-10,22
Rostov,7510,10,5,6,9,11,17,-6,21
Anzhi,7510,11,2,5,13,14,41,-27,11
Loko Moscow,7511,1,12,6,2,31,11,20,42
Spart Moscow,7511,2,11,5,4,41,27,14,38
CSKA Moscow,7511,3,11,4,5,28,19,9,37
Zenit,7511,4,7,9,4,22,16,6,30
Krasnodar,7511,5,8,5,7,27,25,2,29
Terek Grozny,7511,6,8,5,7,22,24,-2,29
FK Rubin,7511,7,6,6,8,23,18,5,24
Din Moscow,7511,8,5,7,8,19,24,-5,22
Amkar,7511,9,5,4,11,10,25,-15,19
Rostov,7511,10,4,6,10,11,20,-9,18
Anzhi,7511,11,2,5,13,16,41,-25,11
Loko Moscow,7512,1,11,7,2,32,14,18,40
CSKA Moscow,7512,2,11,4,5,27,18,9,37
Spart Moscow,7512,3,10,6,4,39,27,12,36
Zenit,7512,4,7,10,3,22,14,8,31
Krasnodar,7512,5,8,6,6,30,27,3,30
Terek Grozny,7512,6,7,5,8,21,25,-4,26
FK Rubin,7512,7,5,7,8,23,19,4,22
Din Moscow,7512,8,5,7,8,19,26,-7,22
Amkar,7512,9,5,5,10,10,22,-12,20
Rostov,7512,10,4,6,10,11,19,-8,18
Anzhi,7512,11,3,5,12,17,40,-23,14
Loko Moscow,7513,1,13,5,2,31,11,20,44
CSKA Moscow,7513,2,12,3,5,29,17,12,39
Spart Moscow,7513,3,9,6,5,38,29,9,33
Zenit,7513,4,7,8,5,21,15,6,29
Krasnodar,7513,5,8,4,8,27,28,-1,28
Terek Grozny,7513,6,7,7,6,22,24,-2,28
FK Rubin,7513,7,7,5,8,25,17,8,26
Din Moscow,7513,8,5,7,8,18,23,-5,22
Amkar,7513,9,5,5,10,13,24,-11,20
Rostov,7513,10,4,6,10,10,20,-10,18
Anzhi,7513,11,2,6,12,15,41,-26,12
Loko Moscow,7514,1,12,5,3,31,13,18,41
CSKA Moscow,7514,2,12,3,5,34,21,13,39
Spart Moscow,7514,3,10,6,4,38,28,10,36
Zenit,7514,4,8,8,4,24,17,7,32
Terek Grozny,7514,5,8,6,6,24,23,1,30
Krasnodar,7514,6,8,4,8,28,27,1,28
FK Rubin,7514,7,7,5,8,24,18,6,26
Din Moscow,7514,8,5,6,9,18,24,-6,21
Rostov,7514,9,4,7,9,11,18,-7,19
Amkar,7514,10,4,5,11,11,25,-14,17
Anzhi,7514,11,2,5,13,17,46,-29,11
Loko Moscow,7515,1,11,7,2,30,12,18,40
Spart Moscow,7515,2,11,5,4,39,26,13,38
CSKA Moscow,7515,3,11,4,5,28,18,10,37
Krasnodar,7515,4,9,5,6,28,24,4,32
Zenit,7515,5,7,10,3,23,15,8,31
Terek Grozny,7515,6,8,6,6,22,23,-1,30
Din Moscow,7515,7,6,6,8,20,23,-3,24
FK Rubin,7515,8,5,5,10,22,21,1,20
Rostov,7515,9,4,6,10,11,20,-9,18
Amkar,7515,10,4,5,11,10,25,-15,17
Anzhi,7515,11,2,5,13,14,40,-26,11
Loko Moscow,7516,1,11,5,4,30,17,13,38
CSKA Moscow,7516,2,11,3,6,27,20,7,36
Zenit,7516,3,9,8,3,28,14,14,35
Spart Moscow,7516,4,8,7,5,34,28,6,31
Krasnodar,7516,5,9,4,7,30,27,3,31
Terek Grozny,7516,6,7,5,8,20,27,-7,26
Din Moscow,7516,7,6,7,7,19,22,-3,25
FK Rubin,7516,8,6,5,9,23,19,4,23
Rostov,7516,9,5,6,9,12,17,-5,21
Amkar,7516,10,5,5,10,13,22,-9,20
Anzhi,7516,11,3,5,12,15,38,-23,14
Loko Moscow,7517,1,11,6,3,32,15,17,39
Spart Moscow,7517,2,11,5,4,44,28,16,38
CSKA Moscow,7517,3,10,4,6,27,21,6,34
Zenit,7517,4,8,9,3,25,15,10,33
Krasnodar,7517,5,9,4,7,31,28,3,31
FK Rubin,7517,6,7,5,8,26,20,6,26
Terek Grozny,7517,7,7,5,8,20,25,-5,26
Din Moscow,7517,8,5,6,9,20,30,-10,21
Amkar,7517,9,5,4,11,11,25,-14,19
Rostov,7517,10,4,6,10,11,19,-8,18
Anzhi,7517,11,3,6,11,17,38,-21,15
Loko Moscow,7518,1,12,5,3,30,14,16,41
Krasnodar,7518,2,10,4,6,33,24,9,34
CSKA Moscow,7518,3,10,4,6,28,21,7,34
Spart Moscow,7518,4,9,5,6,38,28,10,32
Zenit,7518,5,7,9,4,22,15,7,30
Din Moscow,7518,6,7,6,7,21,22,-1,27
Terek Grozny,7518,7,7,5,8,21,25,-4,26
Rostov,7518,8,5,6,9,12,18,-6,21
FK Rubin,7518,9,5,5,10,22,23,-1,20
Amkar,7518,10,5,4,11,10,26,-16,19
Anzhi,7518,11,4,5,11,19,40,-21,17
Loko Moscow,7519,1,13,5,2,32,12,20,44
CSKA Moscow,7519,2,12,3,5,31,17,14,39
Spart Moscow,7519,3,10,6,4,36,26,10,36
Zenit,7519,4,7,8,5,21,15,6,29
Krasnodar,7519,5,8,5,7,28,26,2,29
Terek Grozny,7519,6,7,6,7,22,25,-3,27
FK Rubin,7519,7,5,7,8,22,18,4,22
Din Moscow,7519,8,5,7,8,18,23,-5,22
Amkar,7519,9,5,5,10,10,22,-12,20
Rostov,7519,10,4,6,10,11,19,-8,18
Anzhi,7519,11,2,6,12,16,44,-28,12
Loko Moscow,7520,1,12,5,3,30,13,17,41
CSKA Moscow,7520,2,11,3,6,29,21,8,36
Zenit,7520,3,9,8,3,27,14,13,35
Spart Moscow,7520,4,8,6,6,35,30,5,30
Krasnodar,7520,5,8,4,8,27,26,1,28
Terek Grozny,7520,6,7,7,6,22,24,-2,28
Din Moscow,7520,7,6,7,7,20,22,-2,25
FK Rubin,7520,8,6,6,8,23,18,5,24
Rostov,7520,9,5,6,9,13,19,-6,21
Amkar,7520,10,4,6,10,10,23,-13,18
Anzhi,7520,11,2,6,12,15,41,-26,12
Loko Moscow,7521,1,13,5,2,32,12,20,44
CSKA Moscow,7521,2,10,4,6,27,20,7,34
Spart Moscow,7521,3,9,6,5,39,32,7,33
Krasnodar,7521,4,9,4,7,28,25,3,31
Zenit,7521,5,7,9,4,23,16,7,30
Terek Grozny,7521,6,8,6,6,22,23,-1,30
Din Moscow,7521,7,6,6,8,24,27,-3,24
Rostov,7521,8,5,6,9,14,19,-5,21
FK Rubin,7521,9,5,5,10,23,22,1,20
Amkar,7521,10,4,5,11,9,23,-14,17
Anzhi,7521,11,3,6,11,17,39,-22,15
Loko Moscow,7522,1,12,6,2,32,12,20,42
CSKA Moscow,7522,2,11,4,5,30,18,12,37
Spart Moscow,7522,3,10,6,4,39,28,11,36
Zenit,7522,4,7,10,3,23,15,8,31
Krasnodar,7522,5,8,5,7,27,26,1,29
Terek Grozny,7522,6,7,6,7,21,25,-4,27
FK Rubin,7522,7,5,7,8,22,18,4,22
Din Moscow,7522,8,5,7,8,19,25,-6,22
Rostov,7522,9,4,7,9,11,18,-7,19
Amkar,7522,10,4,5,11,11,25,-14,17
Anzhi,7522,11,3,5,12,16,41,-25,14
Loko Moscow,7523,1,12,5,3,32,12,20,41
CSKA Moscow,7523,2,12,3,5,33,19,14,39
Zenit,7523,3,8,8,4,22,14,8,32
Spart Moscow,7523,4,9,5,6,36,30,6,32
Krasnodar,7523,5,9,4,7,28,27,1,31
Terek Grozny,7523,6,8,6,6,24,23,1,30
Din Moscow,7523,7,6,6,8,20,25,-5,24
FK Rubin,7523,8,6,5,9,24,18,6,23
Amkar,7523,9,5,4,11,11,26,-15,19
Rostov,7523,10,4,6,10,10,18,-8,18
Anzhi,7523,11,2,6,12,17,45,-28,12
Loko Moscow,7524,1,12,6,2,32,12,20,42
CSKA Moscow,7524,2,10,5,5,27,19,8,35
Spart Moscow,7524,3,9,7,4,36,27,9,34
Zenit,7524,4,7,10,3,22,14,8,31
Krasnodar,7524,5,8,4,8,29,29,0,28
Terek Grozny,7524,6,7,6,7,22,25,-3,27
FK Rubin,7524,7,7,5,8,25,19,6,26
Din Moscow,7524,8,5,6,9,18,24,-6,21
Amkar,7524,9,5,5,10,11,23,-12,20
Rostov,7524,10,4,7,9,11,18,-7,19
Anzhi,7524,11,2,7,11,17,40,-23,13
Loko Moscow,7525,1,13,5,2,32,11,21,44
Spart Moscow,7525,2,11,5,4,40,26,14,38
CSKA Moscow,7525,3,11,3,6,33,20,13,36
Zenit,7525,4,8,8,4,23,16,7,32
Krasnodar,7525,5,8,4,8,28,29,-1,28
Terek Grozny,7525,6,7,5,8,21,27,-6,26
Din Moscow,7525,7,6,6,8,20,23,-3,24
FK Rubin,7525,8,6,5,9,26,21,5,23
Amkar,7525,9,5,4,11,11,26,-15,19
Rostov,7525,10,4,6,10,11,19,-8,18
Anzhi,7525,11,3,5,12,18,45,-27,14
Loko Moscow,7526,1,11,7,2,31,13,18,40
Spart Moscow,7526,2,10,6,4,43,32,11,36
CSKA Moscow,7526,3,11,3,6,28,19,9,36
Zenit,7526,4,8,9,3,24,14,10,33
Krasnodar,7526,5,9,5,6,30,25,5,32
Terek Grozny,7526,6,8,5,7,23,25,-2,29
FK Rubin,7526,7,6,5,9,22,19,3,23
Din Moscow,7526,8,5,6,9,20,27,-7,21
Rostov,7526,9,4,6,10,12,20,-8,18
Amkar,7526,10,4,5,11,12,26,-14,17
Anzhi,7526,11,3,5,12,16,41,-25,14
Loko Moscow,7527,1,12,6,2,32,12,20,42
Spart Moscow,7527,2,11,5,4,44,28,16,38
CSKA Moscow,7527,3,11,3,6,28,21,7,36
Krasnodar,7527,4,8,6,6,28,25,3,30
Zenit,7527,5,7,8,5,21,17,4,29
Terek Grozny,7527,6,8,5,7,21,24,-3,29
FK Rubin,7527,7,6,6,8,22,17,5,24
Din Moscow,7527,8,5,6,9,19,25,-6,21
Rostov,7527,9,4,6,10,11,22,-11,18
Anzhi,7527,10,4,5,11,20,38,-18,17
Amkar,7527,11,4,4,12,9,26,-17,16
Loko Moscow,7528,1,11,6,3,30,13,17,39
Spart Moscow,7528,2,11,5,4,40,29,11,38
CSKA Moscow,7528,3,11,4,5,30,18,12,37
Zenit,7528,4,8,9,3,22,13,9,33
Krasnodar,7528,5,8,6,6,30,27,3,30
Terek Grozny,7528,6,7,6,7,21,25,-4,27
FK Rubin,7528,7,5,7,8,24,20,4,22
Din Moscow,7528,8,5,7,8,20,25,-5,22
Amkar,7528,9,5,4,11,12,24,-12,19
Rostov,7528,10,4,6,10,11,19,-8,18
Anzhi,7528,11,2,6,12,16,43,-27,12
Loko Moscow,7529,1,12,5,3,32,13,19,41
Spart Moscow,7529,2,10,5,5,38,29,9,35
Krasnodar,7529,3,10,4,6,30,24,6,34
CSKA Moscow,7529,4,10,3,7,28,22,6,33
Zenit,7529,5,8,8,4,24,17,7,32
Terek Grozny,7529,6,9,5,6,23,23,0,32
FK Rubin,7529,7,6,5,9,24,21,3,23
Rostov,7529,8,5,6,9,12,17,-5,21
Din Moscow,7529,9,5,6,9,20,27,-7,21
Amkar,7529,10,4,4,12,11,26,-15,16
Anzhi,7529,11,3,5,12,17,40,-23,14
Loko Moscow,7530,1,11,6,3,29,13,16,39
CSKA Moscow,7530,2,12,3,5,29,18,11,39
Spart Moscow,7530,3,10,5,5,35,28,7,35
Zenit,7530,4,8,8,4,23,15,8,32
Krasnodar,7530,5,8,6,6,28,25,3,30
Terek Grozny,7530,6,8,5,7,23,25,-2,29
Din Moscow,7530,7,6,6,8,18,22,-4,24
Amkar,7530,8,6,4,10,14,22,-8,22
FK Rubin,7530,9,5,6,9,22,19,3,21
Rostov,7530,10,4,6,10,10,18,-8,18
Anzhi,7530,11,2,5,13,16,42,-26,11
Loko Moscow,7531,1,12,5,3,33,17,16,41
CSKA Moscow,7531,2,12,3,5,30,18,12,39
Zenit,7531,3,8,8,4,26,15,11,32
Spart Moscow,7531,4,8,7,5,35,28,7,31
Terek Grozny,7531,5,8,6,6,23,23,0,30
Krasnodar,7531,6,8,5,7,30,29,1,29
FK Rubin,7531,7,6,6,8,23,18,5,24
Din Moscow,7531,8,5,7,8,19,24,-5,22
Amkar,7531,9,5,5,10,10,22,-12,20
Rostov,7531,10,4,7,9,10,17,-7,19
Anzhi,7531,11,2,5,13,15,43,-28,11
Loko Moscow,7532,1,11,6,3,31,14,17,39
Spart Moscow,7532,2,11,5,4,40,26,14,38
CSKA Moscow,7532,3,11,4,5,31,20,11,37
Zenit,7532,4,8,9,3,24,15,9,33
Krasnodar,7532,5,9,5,6,32,28,4,32
Terek Grozny,7532,6,9,5,6,24,23,1,32
Din Moscow,7532,7,6,6,8,20,24,-4,24
FK Rubin,7532,8,5,5,10,23,23,0,20
Rostov,7532,9,4,6,10,10,19,-9,18
Amkar,7532,10,4,4,12,11,26,-15,16
Anzhi,7532,11,2,5,13,15,43,-28,11
Loko Moscow,7533,1,12,5,3,31,13,18,41
Spart Moscow,7533,2,10,6,4,40,28,12,36
CSKA Moscow,7533,3,11,3,6,28,22,6,36
Zenit,7533,4,8,8,4,25,15,10,32
Krasnodar,7533,5,9,4,7,28,25,3,31
Terek Grozny,7533,6,8,5,7,22,23,-1,29
FK Rubin,7533,7,7,5,8,24,17,7,26
Din Moscow,7533,8,5,6,9,17,25,-8,21
Amkar,7533,9,5,5,10,12,24,-12,20
Rostov,7533,10,4,6,10,11,20,-9,18
Anzhi,7533,11,2,5,13,16,42,-26,11
Loko Moscow,7534,1,12,5,3,32,16,16,41
CSKA Moscow,7534,2,11,3,6,27,20,7,36
Krasnodar,7534,3,10,4,6,34,24,10,34
Spart Moscow,7534,4,9,6,5,34,26,8,33
Zenit,7534,5,8,8,4,24,16,8,32
Terek Grozny,7534,6,7,6,7,22,25,-3,27
Din Moscow,7534,7,6,7,7,20,21,-1,25
Amkar,7534,8,6,4,10,11,22,-11,22
FK Rubin,7534,9,5,5,10,21,22,-1,20
Rostov,7534,10,4,6,10,10,18,-8,18
Anzhi,7534,11,2,6,12,16,41,-25,12
Loko Moscow,7535,1,12,5,3,31,13,18,41
CSKA Moscow,7535,2,12,3,5,28,17,11,39
Spart Moscow,7535,3,11,5,4,41,26,15,38
Krasnodar,7535,4,9,5,6,30,25,5,32
Terek Grozny,7535,5,9,5,6,26,22,4,32
Zenit,7535,6,7,8,5,21,16,5,29
FK Rubin,7535,7,5,7,8,22,18,4,22
Din Moscow,7535,8,5,7,8,18,24,-6,22
Rostov,7535,9,4,6,10,10,20,-10,18
Amkar,7535,10,4,4,12,9,25,-16,16
Anzhi,7535,11,2,5,13,14,44,-30,11
Loko Moscow,7536,1,12,5,3,31,12,19,41
CSKA Moscow,7536,2,12,3,5,29,17,12,39
Spart Moscow,7536,3,10,6,4,39,28,11,36
Krasnodar,7536,4,9,4,7,28,26,2,31
Zenit,7536,5,7,8,5,21,16,5,29
Terek Grozny,7536,6,8,5,7,22,25,-3,29
Din Moscow,7536,7,6,6,8,21,25,-4,24
FK Rubin,7536,8,6,5,9,23,18,5,23
Rostov,7536,9,4,7,9,10,17,-7,19
Amkar,7536,10,5,4,11,11,24,-13,19
Anzhi,7536,11,2,5,13,15,42,-27,11
Loko Moscow,7537,1,11,6,3,30,16,14,39
CSKA Moscow,7537,2,11,3,6,28,19,9,36
Zenit,7537,3,8,9,3,23,13,10,33
Spart Moscow,7537,4,9,5,6,36,32,4,32
Krasnodar,7537,5,9,4,7,32,26,6,31
Din Moscow,7537,6,7,6,7,22,21,1,27
Terek Grozny,7537,7,7,6,7,21,24,-3,27
FK Rubin,7537,8,6,5,9,22,18,4,23
Amkar,7537,9,5,5,10,11,23,-12,20
Rostov,7537,10,4,6,10,11,19,-8,18
Anzhi,7537,11,3,5,12,16,41,-25,14
Loko Moscow,7538,1,12,6,2,31,12,19,42
CSKA Moscow,7538,2,12,3,5,29,17,12,39
Spart Moscow,7538,3,10,5,5,39,30,9,35
Krasnodar,7538,4,8,6,6,28,25,3,30
Zenit,7538,5,7,8,5,21,16,5,29
Din Moscow,7538,6,7,6,7,21,22,-1,27
Terek Grozny,7538,7,7,5,8,21,26,-5,26
FK Rubin,7538,8,5,6,9,22,19,3,21
Amkar,7538,9,5,4,11,12,26,-14,19
Rostov,7538,10,4,6,10,12,20,-8,18
Anzhi,7538,11,3,5,12,16,39,-23,14
Loko Moscow,7539,1,11,6,3,30,13,17,39
CSKA Moscow,7539,2,11,3,6,26,18,8,36
Krasnodar,7539,3,10,4,6,30,25,5,34
Zenit,7539,4,8,9,3,22,13,9,33
Spart Moscow,7539,5,9,5,6,39,32,7,32
Terek Grozny,7539,6,8,6,6,21,22,-1,30
Din Moscow,7539,7,6,7,7,21,24,-3,25
FK Rubin,7539,8,5,6,9,22,19,3,21
Amkar,7539,9,5,4,11,12,24,-12,19
Rostov,7539,10,4,6,10,11,20,-9,18
Anzhi,7539,11,2,6,12,14,38,-24,12
Loko Moscow,7540,1,11,7,2,31,13,18,40
CSKA Moscow,7540,2,12,3,5,28,18,10,39
Spart Moscow,7540,3,10,5,5,38,28,10,35
Terek Grozny,7540,4,9,5,6,23,22,1,32
Zenit,7540,5,7,9,4,23,16,7,30
Krasnodar,7540,6,8,5,7,27,28,-1,29
Din Moscow,7540,7,7,6,7,20,22,-2,27
FK Rubin,7540,8,6,5,9,26,19,7,23
Rostov,7540,9,4,6,10,11,20,-9,18
Amkar,7540,10,4,4,12,10,26,-16,16
Anzhi,7540,11,2,5,13,15,40,-25,11
Loko Moscow,7541,1,11,6,3,30,17,13,39
Spart Moscow,7541,2,10,6,4,37,26,11,36
Zenit,7541,3,8,9,3,24,15,9,33
CSKA Moscow,7541,4,10,3,7,28,22,6,33
Krasnodar,7541,5,9,4,7,33,28,5,31
Terek Grozny,7541,6,7,5,8,21,25,-4,26
Din Moscow,7541,7,6,6,8,18,22,-4,24
FK Rubin,7541,8,6,5,9,25,19,6,23
Rostov,7541,9,4,7,9,10,17,-7,19
Amkar,7541,10,5,4,11,12,26,-14,19
Anzhi,7541,11,4,5,11,18,39,-21,17
Loko Moscow,7542,1,12,5,3,31,15,16,41
CSKA Moscow,7542,2,11,4,5,26,17,9,37
Spart Moscow,7542,3,10,5,5,37,28,9,35
Zenit,7542,4,8,8,4,25,15,10,32
Krasnodar,7542,5,9,4,7,30,25,5,31
Terek Grozny,7542,6,8,5,7,23,25,-2,29
Din Moscow,7542,7,6,7,7,22,25,-3,25
FK Rubin,7542,8,5,6,9,23,22,1,21
Amkar,7542,9,5,4,11,11,24,-13,19
Rostov,7542,10,4,6,10,10,18,-8,18
Anzhi,7542,11,2,6,12,15,39,-24,12
Loko Moscow,7543,1,11,5,4,31,17,14,38
CSKA Moscow,7543,2,11,3,6,28,18,10,36
Zenit,7543,3,9,8,3,25,14,11,35
Spart Moscow,7543,4,9,6,5,41,28,13,33
Krasnodar,7543,5,9,4,7,31,27,4,31
Terek Grozny,7543,6,8,6,6,23,23,0,30
FK Rubin,7543,7,6,6,8,24,19,5,24
Din Moscow,7543,8,5,7,8,18,28,-10,22
Rostov,7543,9,5,6,9,12,18,-6,21
Amkar,7543,10,4,5,11,10,25,-15,17
Anzhi,7543,11,2,6,12,15,41,-26,12
Loko Moscow,7544,1,12,6,2,31,12,19,42
CSKA Moscow,7544,2,10,5,5,27,19,8,35
Spart Moscow,7544,3,9,6,5,35,26,9,33
Zenit,7544,4,7,10,3,22,14,8,31
Krasnodar,7544,5,9,4,7,28,25,3,31
Terek Grozny,7544,6,7,6,7,20,23,-3,27
FK Rubin,7544,7,6,5,9,23,18,5,23
Din Moscow,7544,8,5,7,8,17,23,-6,22
Amkar,7544,9,5,5,10,10,22,-12,20
Rostov,7544,10,4,6,10,10,19,-9,18
Anzhi,7544,11,3,6,11,17,39,-22,15
Loko Moscow,7545,1,12,6,2,31,12,19,42
CSKA Moscow,7545,2,11,4,5,28,19,9,37
Spart Moscow,7545,3,9,7,4,38,29,9,34
Zenit,7545,4,7,9,4,21,14,7,30
Terek Grozny,7545,5,8,5,7,21,23,-2,29
Krasnodar,7545,6,8,4,8,29,29,0,28
FK Rubin,7545,7,7,5,8,26,18,8,26
Din Moscow,7545,8,5,6,9,18,25,-7,21
Rostov,7545,9,4,7,9,12,19,-7,19
Amkar,7545,10,4,5,11,10,24,-14,17
Anzhi,7545,11,3,6,11,17,39,-22,15
Loko Moscow,7546,1,12,5,3,33,12,21,41
Spart Moscow,7546,2,10,6,4,39,28,11,36
CSKA Moscow,7546,3,10,5,5,29,21,8,35
Krasnodar,7546,4,9,5,6,29,25,4,32
Zenit,7546,5,7,9,4,24,20,4,30
Terek Grozny,7546,6,7,6,7,21,25,-4,27
FK Rubin,7546,7,6,6,8,23,18,5,24
Din Moscow,7546,8,5,6,9,18,25,-7,21
Rostov,7546,9,4,7,9,11,18,-7,19
Amkar,7546,10,5,4,11,13,25,-12,19
Anzhi,7546,11,2,7,11,15,38,-23,13
Loko Moscow,7547,1,13,5,2,34,12,22,44
CSKA Moscow,7547,2,11,4,5,27,17,10,37
Spart Moscow,7547,3,10,6,4,38,27,11,36
Zenit,7547,4,7,9,4,21,15,6,30
Krasnodar,7547,5,8,5,7,28,27,1,29
Terek Grozny,7547,6,7,6,7,22,25,-3,27
Din Moscow,7547,7,6,6,8,22,22,0,24
FK Rubin,7547,8,5,6,9,21,22,-1,21
Rostov,7547,9,4,6,10,11,20,-9,18
Amkar,7547,10,4,6,10,11,24,-13,18
Anzhi,7547,11,3,5,12,16,40,-24,14
Loko Moscow,7548,1,12,5,3,31,17,14,41
CSKA Moscow,7548,2,12,3,5,28,17,11,39
Spart Moscow,7548,3,9,6,5,37,29,8,33
Krasnodar,7548,4,9,5,6,32,24,8,32
Zenit,7548,5,7,8,5,22,16,6,29
Terek Grozny,7548,6,7,6,7,20,23,-3,27
FK Rubin,7548,7,5,7,8,22,18,4,22
Din Moscow,7548,8,5,7,8,19,24,-5,22
Rostov,7548,9,5,6,9,12,18,-6,21
Amkar,7548,10,4,6,10,10,23,-13,18
Anzhi,7548,11,3,5,12,15,39,-24,14
Loko Moscow,7549,1,12,5,3,30,13,17,41
Spart Moscow,7549,2,10,6,4,39,27,12,36
CSKA Moscow,7549,3,11,3,6,28,20,8,36
Krasnodar,7549,4,9,5,6,30,25,5,32
Zenit,7549,5,7,8,5,22,16,6,29
Terek Grozny,7549,6,7,7,6,22,24,-2,28
Din Moscow,7549,7,6,6,8,19,23,-4,24
FK Rubin,7549,8,5,6,9,23,20,3,21
Rostov,7549,9,4,6,10,11,21,-10,18
Amkar,7549,10,4,6,10,10,23,-13,18
Anzhi,7549,11,3,6,11,18,40,-22,15
Loko Moscow,7550,1,12,5,3,34,16,18,41
CSKA Moscow,7550,2,11,4,5,27,18,9,37
Spart Moscow,7550,3,9,6,5,37,26,11,33
Zenit,7550,4,8,9,3,26,17,9,33
Krasnodar,7550,5,8,4,8,28,29,-1,28
Terek Grozny,7550,6,7,6,7,21,25,-4,27
FK Rubin,7550,7,7,5,8,26,17,9,26
Din Moscow,7550,8,6,6,8,18,23,-5,24
Amkar,7550,9,5,5,10,11,22,-11,20
Rostov,7550,10,4,6,10,10,21,-11,18
Anzhi,7550,11,2,6,12,15,39,-24,12
Loko Moscow,7551,1,11,6,3,29,15,14,39
CSKA Moscow,7551,2,12,3,5,30,19,11,39
Spart Moscow,7551,3,9,6,5,35,28,7,33
Krasnodar,7551,4,9,4,7,31,26,5,31
Zenit,7551,5,7,9,4,22,15,7,30
Terek Grozny,7551,6,8,6,6,22,23,-1,30
Din Moscow,7551,7,6,6,8,20,23,-3,24
FK Rubin,7551,8,6,5,9,23,19,4,23
Rostov,7551,9,5,6,9,12,17,-5,21
Amkar,7551,10,4,6,10,9,22,-13,18
Anzhi,7551,11,2,5,13,16,42,-26,11
Loko Moscow,7552,1,11,7,2,31,13,18,40
Spart Moscow,7552,2,10,6,4,38,27,11,36
CSKA Moscow,7552,3,11,3,6,28,18,10,36
Zenit,7552,4,8,9,3,23,14,9,33
Krasnodar,7552,5,8,5,7,28,27,1,29
Terek Grozny,7552,6,8,5,7,24,25,-1,29
Din Moscow,7552,7,6,6,8,19,23,-4,24
FK Rubin,7552,8,6,5,9,23,18,5,23
Rostov,7552,9,4,7,9,11,18,-7,19
Amkar,7552,10,4,4,12,9,26,-17,16
Anzhi,7552,11,3,5,12,17,42,-25,14
Loko Moscow,7553,1,11,6,3,31,14,17,39
Spart Moscow,7553,2,10,6,4,39,27,12,36
CSKA Moscow,7553,3,11,3,6,28,19,9,36
Krasnodar,7553,4,10,4,6,31,24,7,34
Zenit,7553,5,8,9,3,24,15,9,33
Terek Grozny,7553,6,8,6,6,21,22,-1,30
FK Rubin,7553,7,6,5,9,24,20,4,23
Din Moscow,7553,8,5,7,8,18,25,-7,22
Rostov,7553,9,4,6,10,10,20,-10,18
Amkar,7553,10,4,4,12,10,25,-15,16
Anzhi,7553,11,2,6,12,15,40,-25,12
Loko Moscow,7554,1,12,6,2,32,13,19,42
CSKA Moscow,7554,2,11,3,6,28,18,10,36
Spart Moscow,7554,3,9,7,4,34,25,9,34
Zenit,7554,4,8,9,3,23,14,9,33
Krasnodar,7554,5,9,4,7,31,26,5,31
Terek Grozny,7554,6,8,5,7,22,24,-2,29
Din Moscow,7554,7,5,8,7,18,22,-4,23
FK Rubin,7554,8,5,6,9,22,21,1,21
Rostov,7554,9,4,7,9,10,17,-7,19
Amkar,7554,10,5,4,11,10,23,-13,19
Anzhi,7554,11,2,5,13,15,42,-27,11
Loko Moscow,7555,1,11,6,3,29,13,16,39
Spart Moscow,7555,2,10,6,4,37,25,12,36
CSKA Moscow,7555,3,11,3,6,28,21,7,36
Zenit,7555,4,9,8,3,27,14,13,35
Krasnodar,7555,5,9,5,6,29,25,4,32
Terek Grozny,7555,6,8,6,6,23,23,0,30
Din Moscow,7555,7,6,6,8,20,23,-3,24
FK Rubin,7555,8,5,5,10,22,22,0,20
Rostov,7555,9,4,7,9,10,17,-7,19
Amkar,7555,10,4,5,11,10,25,-15,17
Anzhi,7555,11,2,5,13,14,41,-27,11
Loko Moscow,7556,1,11,5,4,31,17,14,38
Spart Moscow,7556,2,10,6,4,40,28,12,36
CSKA Moscow,7556,3,11,3,6,29,22,7,36
Zenit,7556,4,9,8,3,30,17,13,35
Krasnodar,7556,5,10,4,6,31,24,7,34
Terek Grozny,7556,6,8,6,6,21,22,-1,30
Din Moscow,7556,7,6,7,7,21,23,-2,25
FK Rubin,7556,8,5,5,10,22,23,-1,20
Rostov,7556,9,4,6,10,10,20,-10,18
Amkar,7556,10,4,4,12,11,26,-15,16
Anzhi,7556,11,2,6,12,15,39,-24,12
Loko Moscow,7557,1,12,6,2,32,13,19,42
CSKA Moscow,7557,2,11,4,5,30,19,11,37
Spart Moscow,7557,3,10,5,5,39,33,6,35
Krasnodar,7557,4,9,5,6,29,25,4,32
Zenit,7557,5,7,9,4,24,17,7,30
Terek Grozny,7557,6,7,6,7,21,24,-3,27
Din Moscow,7557,7,6,6,8,23,25,-2,24
FK Rubin,7557,8,6,5,9,25,20,5,23
Rostov,7557,9,4,6,10,13,21,-8,18
Amkar,7557,10,4,5,11,11,25,-14,17
Anzhi,7557,11,3,5,12,15,40,-25,14
Loko Moscow,7558,1,12,5,3,34,16,18,41
Spart Moscow,7558,2,10,6,4,35,25,10,36
CSKA Moscow,7558,3,11,3,6,30,21,9,36
Zenit,7558,4,9,8,3,27,17,10,35
Krasnodar,7558,5,9,4,7,30,27,3,31
Terek Grozny,7558,6,7,6,7,21,25,-4,27
Din Moscow,7558,7,6,6,8,19,23,-4,24
FK Rubin,7558,8,5,5,10,22,20,2,20
Rostov,7558,9,4,7,9,10,17,-7,19
Amkar,7558,10,4,5,11,10,24,-14,17
Anzhi,7558,11,3,5,12,17,40,-23,14
Loko Moscow,7559,1,11,5,4,31,16,15,38
CSKA Moscow,7559,2,11,4,5,27,18,9,37
Spart Moscow,7559,3,10,5,5,38,29,9,35
Zenit,7559,4,8,9,3,23,14,9,33
Krasnodar,7559,5,9,4,7,30,27,3,31
Terek Grozny,7559,6,7,7,6,23,25,-2,28
FK Rubin,7559,7,6,6,8,23,17,6,24
Din Moscow,7559,8,5,7,8,18,24,-6,22
Rostov,7559,9,5,6,9,13,17,-4,21
Amkar,7559,10,4,5,11,11,26,-15,17
Anzhi,7559,11,2,6,12,16,40,-24,12
Loko Moscow,7560,1,12,5,3,31,13,18,41
CSKA Moscow,7560,2,12,3,5,29,19,10,39
Spart Moscow,7560,3,10,6,4,36,26,10,36
Zenit,7560,4,8,8,4,24,15,9,32
Krasnodar,7560,5,9,4,7,33,26,7,31
Terek Grozny,7560,6,7,6,7,21,24,-3,27
Din Moscow,7560,7,6,6,8,19,23,-4,24
FK Rubin,7560,8,5,5,10,21,24,-3,20
Amkar,7560,9,5,5,10,11,23,-12,20
Rostov,7560,10,4,6,10,10,18,-8,18
Anzhi,7560,11,2,6,12,15,39,-24,12
Loko Moscow,7561,1,12,5,3,31,14,17,41
CSKA Moscow,7561,2,11,4,5,32,19,13,37
Krasnodar,7561,3,10,4,6,32,25,7,34
Zenit,7561,4,7,9,4,24,17,7,30
Spart Moscow,7561,5,8,6,6,36,30,6,30
Din Moscow,7561,6,7,6,7,22,23,-1,27
Terek Grozny,7561,7,7,6,7,21,24,-3,27
Amkar,7561,8,6,4,10,12,23,-11,22
FK Rubin,7561,9,5,5,10,22,22,0,20
Rostov,7561,10,4,7,9,10,17,-7,19
Anzhi,7561,11,2,6,12,15,43,-28,12
Loko Moscow,7562,1,11,6,3,30,13,17,39
CSKA Moscow,7562,2,11,3,6,28,19,9,36
Spart Moscow,7562,3,9,6,5,37,28,9,33
Zenit,7562,4,8,9,3,23,14,9,33
Krasnodar,7562,5,9,4,7,29,26,3,31
Terek Grozny,7562,6,7,6,7,20,24,-4,27
Din Moscow,7562,7,6,6,8,20,26,-6,24
FK Rubin,7562,8,6,5,9,24,20,4,23
Rostov,7562,9,5,6,9,12,17,-5,21
Amkar,7562,10,4,6,10,9,22,-13,18
Anzhi,7562,11,3,5,12,17,40,-23,14
Loko Moscow,7563,1,11,5,4,30,14,16,38
CSKA Moscow,7563,2,11,3,6,30,20,10,36
Zenit,7563,3,9,8,3,26,15,11,35
Spart Moscow,7563,4,9,7,4,37,28,9,34
Krasnodar,7563,5,10,4,6,30,25,5,34
Terek Grozny,7563,6,7,6,7,21,24,-3,27
FK Rubin,7563,7,6,5,9,23,19,4,23
Din Moscow,7563,8,5,7,8,17,22,-5,22
Rostov,7563,9,4,7,9,11,18,-7,19
Amkar,7563,10,4,5,11,12,26,-14,17
Anzhi,7563,11,3,5,12,15,41,-26,14
Loko Moscow,7564,1,11,6,3,32,15,17,39
Spart Moscow,7564,2,10,6,4,37,27,10,36
Zenit,7564,3,9,8,3,25,15,10,35
CSKA Moscow,7564,4,10,3,7,26,20,6,33
Krasnodar,7564,5,8,6,6,28,25,3,30
Terek Grozny,7564,6,8,5,7,22,24,-2,29
FK Rubin,7564,7,6,6,8,24,18,6,24
Din Moscow,7564,8,5,7,8,19,25,-6,22
Amkar,7564,9,5,4,11,12,24,-12,19
Rostov,7564,10,4,6,10,10,18,-8,18
Anzhi,7564,11,3,5,12,16,40,-24,14
Loko Moscow,7565,1,12,6,2,31,12,19,42
CSKA Moscow,7565,2,12,3,5,30,18,12,39
Krasnodar,7565,3,9,5,6,30,25,5,32
Spart Moscow,7565,4,8,6,6,35,34,1,30
Zenit,7565,5,7,8,5,21,16,5,29
Terek Grozny,7565,6,7,6,7,22,25,-3,27
Din Moscow,7565,7,6,7,7,21,24,-3,25
Rostov,7565,8,5,6,9,15,17,-2,21
FK Rubin,7565,9,5,5,10,22,21,1,20
Amkar,7565,10,5,5,10,13,24,-11,20
Anzhi,7565,11,3,5,12,16,40,-24,14
Loko Moscow,7566,1,12,6,2,32,13,19,42
Spart Moscow,7566,2,10,5,5,38,28,10,35
CSKA Moscow,7566,3,10,4,6,28,22,6,34
Zenit,7566,4,8,8,4,28,19,9,32
Krasnodar,7566,5,9,5,6,30,25,5,32
Terek Grozny,7566,6,8,6,6,22,22,0,30
Din Moscow,7566,7,5,7,8,18,24,-6,22
FK Rubin,7566,8,5,6,9,23,21,2,21
Rostov,7566,9,5,6,9,12,18,-6,21
Amkar,7566,10,4,5,11,10,24,-14,17
Anzhi,7566,11,2,6,12,14,39,-25,12
Loko Moscow,7567,1,11,6,3,31,14,17,39
CSKA Moscow,7567,2,10,5,5,27,19,8,35
Krasnodar,7567,3,10,4,6,33,25,8,34
Zenit,7567,4,7,10,3,23,15,8,31
Spart Moscow,7567,5,8,6,6,34,28,6,30
Din Moscow,7567,6,7,6,7,19,21,-2,27
Terek Grozny,7567,7,7,6,7,22,25,-3,27
Rostov,7567,8,5,6,9,11,17,-6,21
FK Rubin,7567,9,5,5,10,21,22,-1,20
Amkar,7567,10,5,5,10,11,23,-12,20
Anzhi,7567,11,2,7,11,17,40,-23,13
Loko Moscow,7568,1,12,6,2,31,12,19,42
CSKA Moscow,7568,2,11,4,5,28,18,10,37
Spart Moscow,7568,3,10,5,5,38,29,9,35
Zenit,7568,4,7,10,3,21,13,8,31
Krasnodar,7568,5,9,4,7,30,26,4,31
Terek Grozny,7568,6,8,6,6,28,24,4,30
Din Moscow,7568,7,5,7,8,20,25,-5,22
FK Rubin,7568,8,5,6,9,21,19,2,21
Amkar,7568,9,5,5,10,11,23,-12,20
Rostov,7568,10,4,6,10,10,18,-8,18
Anzhi,7568,11,2,5,13,16,47,-31,11
Loko Moscow,7569,1,11,6,3,30,14,16,39
CSKA Moscow,7569,2,12,3,5,29,18,11,39
Spart Moscow,7569,3,9,7,4,39,28,11,34
Zenit,7569,4,8,8,4,24,15,9,32
Krasnodar,7569,5,9,5,6,30,25,5,32
Terek Grozny,7569,6,8,5,7,22,23,-1,29
Din Moscow,7569,7,6,6,8,18,24,-6,24
FK Rubin,7569,8,5,5,10,21,20,1,20
Rostov,7569,9,4,7,9,11,18,-7,19
Amkar,7569,10,4,5,11,11,26,-15,17
Anzhi,7569,11,3,5,12,15,39,-24,14
Loko Moscow,7570,1,13,5,2,35,13,22,44
CSKA Moscow,7570,2,11,4,5,28,18,10,37
Spart Moscow,7570,3,9,7,4,40,30,10,34
Terek Grozny,7570,4,8,6,6,23,23,0,30
Zenit,7570,5,7,8,5,23,19,4,29
Krasnodar,7570,6,8,4,8,28,29,-1,28
FK Rubin,7570,7,6,6,8,25,19,6,24
Din Moscow,7570,8,5,8,7,21,25,-4,23
Rostov,7570,9,4,7,9,10,17,-7,19
Amkar,7570,10,4,5,11,12,27,-15,17
Anzhi,7570,11,2,6,12,15,40,-25,12
Loko Moscow,7571,1,12,5,3,30,13,17,41
CSKA Moscow,7571,2,12,3,5,30,20,10,39
Spart Moscow,7571,3,10,5,5,38,28,10,35
Krasnodar,7571,4,10,4,6,31,24,7,34
Terek Grozny,7571,5,9,5,6,22,22,0,32
Zenit,7571,6,7,8,5,22,16,6,29
Din Moscow,7571,7,6,6,8,21,24,-3,24
FK Rubin,7571,8,5,5,10,21,22,-1,20
Amkar,7571,9,5,4,11,11,24,-13,19
Rostov,7571,10,4,6,10,10,18,-8,18
Anzhi,7571,11,2,5,13,16,41,-25,11
CSKA Moscow,7572,1,12,3,5,27,17,10,39
Loko Moscow,7572,2,11,5,4,30,16,14,38
Spart Moscow,7572,3,9,7,4,39,30,9,34
Zenit,7572,4,8,8,4,24,14,10,32
Krasnodar,7572,5,9,5,6,29,25,4,32
Terek Grozny,7572,6,8,5,7,22,25,-3,29
FK Rubin,7572,7,6,6,8,22,17,5,24
Din Moscow,7572,8,5,6,9,18,24,-6,21
Rostov,7572,9,4,7,9,11,18,-7,19
Amkar,7572,10,4,5,11,12,27,-15,17
Anzhi,7572,11,3,5,12,17,38,-21,14
Loko Moscow,7573,1,12,6,2,33,14,19,42
CSKA Moscow,7573,2,12,3,5,27,17,10,39
Spart Moscow,7573,3,10,5,5,39,31,8,35
Krasnodar,7573,4,8,6,6,30,27,3,30
Terek Grozny,7573,5,8,6,6,21,22,-1,30
Zenit,7573,6,7,8,5,22,16,6,29
FK Rubin,7573,7,5,7,8,23,19,4,22
Din Moscow,7573,8,5,7,8,19,25,-6,22
Amkar,7573,9,5,5,10,14,22,-8,20
Rostov,7573,10,4,6,10,10,20,-10,18
Anzhi,7573,11,2,5,13,14,39,-25,11
Loko Moscow,7574,1,13,5,2,33,12,21,44
CSKA Moscow,7574,2,12,3,5,28,17,11,39
Spart Moscow,7574,3,11,5,4,40,26,14,38
Terek Grozny,7574,4,9,5,6,22,22,0,32
Krasnodar,7574,5,9,4,7,30,26,4,31
Zenit,7574,6,7,8,5,21,16,5,29
FK Rubin,7574,7,6,5,9,23,19,4,23
Din Moscow,7574,8,5,6,9,17,26,-9,21
Rostov,7574,9,4,6,10,10,19,-9,18
Amkar,7574,10,4,4,12,10,25,-15,16
Anzhi,7574,11,2,5,13,14,40,-26,11
Loko Moscow,7575,1,12,6,2,31,11,20,42
CSKA Moscow,7575,2,11,3,6,26,18,8,36
Zenit,7575,3,8,8,4,22,15,7,32
Spart Moscow,7575,4,8,7,5,38,31,7,31
Krasnodar,7575,5,8,6,6,29,26,3,30
Terek Grozny,7575,6,8,6,6,21,22,-1,30
Din Moscow,7575,7,6,7,7,19,22,-3,25
FK Rubin,7575,8,5,7,8,23,19,4,22
Rostov,7575,9,4,7,9,12,19,-7,19
Amkar,7575,10,4,6,10,11,24,-13,18
Anzhi,7575,11,2,5,13,14,39,-25,11
Loko Moscow,7576,1,12,6,2,32,13,19,42
CSKA Moscow,7576,2,10,4,6,27,21,6,34
Zenit,7576,3,8,8,4,23,14,9,32
Krasnodar,7576,4,9,5,6,33,27,6,32
Terek Grozny,7576,5,9,5,6,26,25,1,32
Spart Moscow,7576,6,8,6,6,36,30,6,30
Din Moscow,7576,7,7,6,7,21,22,-1,27
FK Rubin,7576,8,5,5,10,22,23,-1,20
Rostov,7576,9,4,7,9,11,18,-7,19
Amkar,7576,10,5,4,11,11,24,-13,19
Anzhi,7576,11,2,6,12,19,44,-25,12
Loko Moscow,7577,1,11,5,4,31,15,16,38
Spart Moscow,7577,2,10,6,4,40,29,11,36
Zenit,7577,3,9,8,3,26,16,10,35
CSKA Moscow,7577,4,10,3,7,26,22,4,33
Krasnodar,7577,5,9,5,6,29,25,4,32
Terek Grozny,7577,6,7,6,7,22,26,-4,27
FK Rubin,7577,7,6,6,8,23,18,5,24
Din Moscow,7577,8,5,6,9,18,25,-7,21
Rostov,7577,9,4,7,9,13,20,-7,19
Amkar,7577,10,5,4,11,13,25,-12,19
Anzhi,7577,11,3,6,11,17,37,-20,15
Loko Moscow,7578,1,12,5,3,33,15,18,41
CSKA Moscow,7578,2,11,3,6,27,19,8,36
Krasnodar,7578,3,10,4,6,32,26,6,34
Spart Moscow,7578,4,9,6,5,39,31,8,33
Zenit,7578,5,8,8,4,24,15,9,32
Terek Grozny,7578,6,8,6,6,24,25,-1,30
Din Moscow,7578,7,5,8,7,19,23,-4,23
FK Rubin,7578,8,5,6,9,22,20,2,21
Amkar,7578,9,5,4,11,13,25,-12,19
Rostov,7578,10,4,6,10,11,20,-9,18
Anzhi,7578,11,2,6,12,17,42,-25,12
Loko Moscow,7579,1,11,7,2,32,14,18,40
CSKA Moscow,7579,2,10,4,6,27,20,7,34
Zenit,7579,3,8,9,3,24,15,9,33
Krasnodar,7579,4,9,5,6,31,26,5,32
Terek Grozny,7579,5,9,5,6,22,22,0,32
Spart Moscow,7579,6,8,6,6,33,27,6,30
Din Moscow,7579,7,6,7,7,21,24,-3,25
FK Rubin,7579,8,5,6,9,24,22,2,21
Rostov,7579,9,5,6,9,11,17,-6,21
Amkar,7579,10,4,5,11,9,23,-14,17
Anzhi,7579,11,2,6,12,15,39,-24,12
CSKA Moscow,7580,1,12,3,5,30,19,11,39
Loko Moscow,7580,2,11,5,4,31,15,16,38
Krasnodar,7580,3,10,4,6,31,26,5,34
Zenit,7580,4,8,8,4,22,14,8,32
Spart Moscow,7580,5,8,7,5,37,30,7,31
Terek Grozny,7580,6,7,6,7,20,23,-3,27
Din Moscow,7580,7,6,7,7,20,23,-3,25
FK Rubin,7580,8,5,6,9,22,19,3,21
Amkar,7580,9,5,5,10,11,23,-12,20
Rostov,7580,10,4,7,9,12,19,-7,19
Anzhi,7580,11,2,6,12,16,41,-25,12
Loko Moscow,7581,1,13,5,2,34,13,21,44
CSKA Moscow,7581,2,11,3,6,28,21,7,36
Zenit,7581,3,8,8,4,23,15,8,32
Spart Moscow,7581,4,8,7,5,35,28,7,31
Krasnodar,7581,5,8,4,8,29,28,1,28
Terek Grozny,7581,6,7,5,8,21,25,-4,26
Din Moscow,7581,7,6,7,7,19,22,-3,25
FK Rubin,7581,8,6,5,9,22,18,4,23
Rostov,7581,9,5,6,9,11,17,-6,21
Amkar,7581,10,5,5,10,11,23,-12,20
Anzhi,7581,11,3,5,12,18,41,-23,14
Loko Moscow,7582,1,11,6,3,31,14,17,39
CSKA Moscow,7582,2,10,4,6,27,20,7,34
Zenit,7582,3,8,9,3,24,15,9,33
Spart Moscow,7582,4,9,5,6,36,29,7,32
Krasnodar,7582,5,9,5,6,31,26,5,32
Terek Grozny,7582,6,8,5,7,22,23,-1,29
Din Moscow,7582,7,6,7,7,19,22,-3,25
FK Rubin,7582,8,5,6,9,22,20,2,21
Rostov,7582,9,5,6,9,11,17,-6,21
Amkar,7582,10,5,4,11,11,24,-13,19
Anzhi,7582,11,3,5,12,16,40,-24,14
Loko Moscow,7583,1,12,5,3,31,13,18,41
CSKA Moscow,7583,2,11,3,6,27,19,8,36
Zenit,7583,3,9,8,3,23,13,10,35
Spart Moscow,7583,4,9,6,5,41,29,12,33
Krasnodar,7583,5,9,4,7,29,26,3,31
Terek Grozny,7583,6,7,6,7,22,27,-5,27
Din Moscow,7583,7,6,7,7,20,23,-3,25
Rostov,7583,8,5,6,9,13,19,-6,21
FK Rubin,7583,9,5,5,10,22,20,2,20
Amkar,7583,10,5,4,11,13,28,-15,19
Anzhi,7583,11,2,6,12,16,40,-24,12
Loko Moscow,7584,1,12,5,3,32,15,17,41
CSKA Moscow,7584,2,12,3,5,29,18,11,39
Spart Moscow,7584,3,9,5,6,40,31,9,32
Zenit,7584,4,8,8,4,23,14,9,32
Krasnodar,7584,5,8,5,7,31,29,2,29
Din Moscow,7584,6,7,6,7,21,22,-1,27
Terek Grozny,7584,7,7,6,7,22,25,-3,27
Amkar,7584,8,6,4,10,13,24,-11,22
FK Rubin,7584,9,5,6,9,23,20,3,21
Rostov,7584,10,4,6,10,11,22,-11,18
Anzhi,7584,11,2,6,12,16,41,-25,12
Loko Moscow,7585,1,12,6,2,32,13,19,42
Spart Moscow,7585,2,10,6,4,40,30,10,36
CSKA Moscow,7585,3,11,3,6,27,18,9,36
Zenit,7585,4,8,8,4,23,15,8,32
Krasnodar,7585,5,9,5,6,30,25,5,32
Terek Grozny,7585,6,7,6,7,21,24,-3,27
Din Moscow,7585,7,6,6,8,19,23,-4,24
FK Rubin,7585,8,5,5,10,21,20,1,20
Rostov,7585,9,4,7,9,12,19,-7,19
Amkar,7585,10,4,5,11,11,25,-14,17
Anzhi,7585,11,3,5,12,16,40,-24,14
Loko Moscow,7586,1,11,6,3,29,12,17,39
Spart Moscow,7586,2,11,5,4,38,26,12,38
CSKA Moscow,7586,3,11,3,6,29,21,8,36
Zenit,7586,4,8,8,4,24,16,8,32
Krasnodar,7586,5,9,5,6,28,24,4,32
Terek Grozny,7586,6,9,5,6,24,24,0,32
Din Moscow,7586,7,5,7,8,18,24,-6,22
FK Rubin,7586,8,5,6,9,22,19,3,21
Rostov,7586,9,4,6,10,11,19,-8,18
Amkar,7586,10,4,4,12,10,25,-15,16
Anzhi,7586,11,3,5,12,17,40,-23,14
Loko Moscow,7587,1,12,5,3,32,13,19,41
Spart Moscow,7587,2,11,5,4,41,27,14,38
CSKA Moscow,7587,3,11,3,6,30,21,9,36
Zenit,7587,4,9,8,3,26,15,11,35
Krasnodar,7587,5,8,4,8,27,27,0,28
Terek Grozny,7587,6,7,5,8,21,28,-7,26
Din Moscow,7587,7,6,6,8,19,24,-5,24
FK Rubin,7587,8,6,5,9,22,18,4,23
Amkar,7587,9,5,4,11,12,24,-12,19
Rostov,7587,10,4,6,10,10,20,-10,18
Anzhi,7587,11,3,5,12,19,42,-23,14
Loko Moscow,7588,1,11,5,4,29,18,11,38
CSKA Moscow,7588,2,11,4,5,28,19,9,37
Spart Moscow,7588,3,10,6,4,39,26,13,36
Zenit,7588,4,8,8,4,26,14,12,32
Terek Grozny,7588,5,9,5,6,25,25,0,32
Krasnodar,7588,6,9,4,7,30,27,3,31
FK Rubin,7588,7,7,5,8,26,18,8,26
Din Moscow,7588,8,5,6,9,17,27,-10,21
Rostov,7588,9,4,7,9,11,18,-7,19
Amkar,7588,10,4,4,12,10,25,-15,16
Anzhi,7588,11,2,6,12,18,42,-24,12
Loko Moscow,7589,1,12,5,3,30,13,17,41
CSKA Moscow,7589,2,11,3,6,26,18,8,36
Zenit,7589,3,8,8,4,23,14,9,32
Spart Moscow,7589,4,8,6,6,36,30,6,30
Krasnodar,7589,5,8,4,8,27,27,0,28
Terek Grozny,7589,6,7,7,6,23,25,-2,28
Din Moscow,7589,7,6,7,7,19,22,-3,25
FK Rubin,7589,8,6,6,8,23,17,6,24
Amkar,7589,9,5,5,10,11,23,-12,20
Rostov,7589,10,4,7,9,12,19,-7,19
Anzhi,7589,11,3,6,11,17,39,-22,15
Loko Moscow,7590,1,12,5,3,31,15,16,41
CSKA Moscow,7590,2,11,4,5,28,18,10,37
Spart Moscow,7590,3,9,6,5,38,30,8,33
Krasnodar,7590,4,9,5,6,30,24,6,32
Zenit,7590,5,7,9,4,23,16,7,30
Terek Grozny,7590,6,7,6,7,25,28,-3,27
Din Moscow,7590,7,6,7,7,19,22,-3,25
FK Rubin,7590,8,5,7,8,21,17,4,22
Rostov,7590,9,4,7,9,12,19,-7,19
Amkar,7590,10,5,4,11,13,26,-13,19
Anzhi,7590,11,2,6,12,17,42,-25,12
Loko Moscow,7591,1,12,6,2,35,13,22,42
CSKA Moscow,7591,2,12,3,5,30,18,12,39
Spart Moscow,7591,3,10,6,4,39,28,11,36
Zenit,7591,4,7,8,5,22,19,3,29
Krasnodar,7591,5,8,5,7,28,26,2,29
Terek Grozny,7591,6,8,5,7,21,25,-4,29
FK Rubin,7591,7,7,5,8,24,17,7,26
Din Moscow,7591,8,5,6,9,18,25,-7,21
Rostov,7591,9,4,6,10,11,20,-9,18
Amkar,7591,10,4,5,11,10,24,-14,17
Anzhi,7591,11,3,5,12,18,41,-23,14
Loko Moscow,7592,1,12,5,3,32,14,18,41
Spart Moscow,7592,2,10,5,5,38,27,11,35
Krasnodar,7592,3,10,4,6,33,26,7,34
CSKA Moscow,7592,4,10,4,6,28,21,7,34
Zenit,7592,5,8,8,4,24,17,7,32
Terek Grozny,7592,6,8,5,7,21,27,-6,29
Din Moscow,7592,7,6,6,8,19,23,-4,24
Amkar,7592,8,6,4,10,15,22,-7,22
FK Rubin,7592,9,5,5,10,24,23,1,20
Rostov,7592,10,4,6,10,11,21,-10,18
Anzhi,7592,11,2,6,12,16,40,-24,12
Loko Moscow,7593,1,12,6,2,35,14,21,42
CSKA Moscow,7593,2,11,4,5,30,20,10,37
Spart Moscow,7593,3,10,6,4,38,27,11,36
Zenit,7593,4,7,9,4,23,18,5,30
Krasnodar,7593,5,8,5,7,29,27,2,29
Terek Grozny,7593,6,8,5,7,22,24,-2,29
Din Moscow,7593,7,6,7,7,19,22,-3,25
FK Rubin,7593,8,6,5,9,23,19,4,23
Amkar,7593,9,5,4,11,12,24,-12,19
Rostov,7593,10,4,6,10,11,20,-9,18
Anzhi,7593,11,2,5,13,16,43,-27,11
Loko Moscow,7594,1,11,5,4,30,16,14,38
Zenit,7594,2,9,8,3,28,14,14,35
Krasnodar,7594,3,10,4,6,32,25,7,34
CSKA Moscow,7594,4,10,3,7,25,22,3,33
Spart Moscow,7594,5,9,5,6,37,36,1,32
Terek Grozny,7594,6,8,5,7,24,25,-1,29
Din Moscow,7594,7,6,6,8,21,25,-4,24
Amkar,7594,8,6,4,10,17,24,-7,22
Rostov,7594,9,5,6,9,14,17,-3,21
FK Rubin,7594,10,5,5,10,23,22,1,20
Anzhi,7594,11,3,5,12,15,40,-25,14
CSKA Moscow,7595,1,12,3,5,30,17,13,39
Spart Moscow,7595,2,11,5,4,44,29,15,38
Loko Moscow,7595,3,11,5,4,30,15,15,38
Zenit,7595,4,8,8,4,23,17,6,32
Krasnodar,7595,5,9,4,7,30,27,3,31
Terek Grozny,7595,6,8,6,6,24,24,0,30
FK Rubin,7595,7,6,6,8,25,19,6,24
Din Moscow,7595,8,5,7,8,18,25,-7,22
Rostov,7595,9,4,6,10,12,21,-9,18
Amkar,7595,10,4,4,12,11,28,-17,16
Anzhi,7595,11,2,6,12,16,41,-25,12
Loko Moscow,7596,1,11,6,3,29,16,13,39
CSKA Moscow,7596,2,12,3,5,28,18,10,39
Spart Moscow,7596,3,10,5,5,39,29,10,35
Terek Grozny,7596,4,9,5,6,25,23,2,32
Krasnodar,7596,5,9,4,7,33,26,7,31
Zenit,7596,6,7,9,4,21,14,7,30
FK Rubin,7596,7,6,6,8,24,19,5,24
Din Moscow,7596,8,5,7,8,18,24,-6,22
Amkar,7596,9,5,4,11,13,24,-11,19
Rostov,7596,10,4,6,10,11,21,-10,18
Anzhi,7596,11,2,5,13,15,42,-27,11
Loko Moscow,7597,1,12,5,3,32,14,18,41
CSKA Moscow,7597,2,11,3,6,26,19,7,36
Zenit,7597,3,8,8,4,24,15,9,32
Spart Moscow,7597,4,8,7,5,37,31,6,31
Krasnodar,7597,5,9,4,7,29,27,2,31
Terek Grozny,7597,6,8,6,6,23,23,0,30
FK Rubin,7597,7,7,5,8,24,17,7,26
Din Moscow,7597,8,5,7,8,19,24,-5,22
Rostov,7597,9,4,7,9,11,18,-7,19
Amkar,7597,10,5,4,11,13,26,-13,19
Anzhi,7597,11,2,6,12,14,38,-24,12
CSKA Moscow,7598,1,12,3,5,28,18,10,39
Loko Moscow,7598,2,11,5,4,29,14,15,38
Krasnodar,7598,3,10,4,6,30,24,6,34
Zenit,7598,4,8,8,4,23,14,9,32
Spart Moscow,7598,5,8,7,5,36,30,6,31
Terek Grozny,7598,6,7,6,7,20,23,-3,27
Din Moscow,7598,7,6,7,7,19,22,-3,25
FK Rubin,7598,8,5,5,10,22,21,1,20
Amkar,7598,9,5,5,10,11,22,-11,20
Rostov,7598,10,4,7,9,13,20,-7,19
Anzhi,7598,11,3,5,12,16,39,-23,14
Spart Moscow,7599,1,11,5,4,44,28,16,38
Loko Moscow,7599,2,11,5,4,29,15,14,38
Zenit,7599,3,9,8,3,24,13,11,35
CSKA Moscow,7599,4,10,4,6,26,20,6,34
Krasnodar,7599,5,9,4,7,30,26,4,31
Terek Grozny,7599,6,7,5,8,20,27,-7,26
Din Moscow,7599,7,6,6,8,23,28,-5,24
FK Rubin,7599,8,6,5,9,24,21,3,23
Amkar,7599,9,5,4,11,10,25,-15,19
Rostov,7599,10,4,6,10,11,19,-8,18
Anzhi,7599,11,3,6,11,19,38,-19,15
Loko Moscow,7600,1,11,6,3,30,15,15,39
CSKA Moscow,7600,2,11,3,6,30,20,10,36
Zenit,7600,3,8,9,3,24,14,10,33
Spart Moscow,7600,4,9,6,5,37,28,9,33
Krasnodar,7600,5,9,4,7,31,26,5,31
Terek Grozny,7600,6,7,6,7,21,24,-3,27
FK Rubin,7600,7,6,6,8,24,19,5,24
Din Moscow,7600,8,5,8,7,20,24,-4,23
Rostov,7600,9,5,6,9,11,17,-6,21
Amkar,7600,10,5,4,11,10,24,-14,19
Anzhi,7600,11,2,6,12,16,43,-27,12
Loko Moscow,7601,1,12,5,3,31,14,17,41
Spart Moscow,7601,2,10,6,4,39,29,10,36
Krasnodar,7601,3,10,4,6,33,26,7,34
CSKA Moscow,7601,4,10,4,6,28,21,7,34
Zenit,7601,5,8,8,4,23,16,7,32
Terek Grozny,7601,6,8,6,6,23,24,-1,30
Din Moscow,7601,7,5,8,7,20,24,-4,23
FK Rubin,7601,8,5,6,9,24,21,3,21
Rostov,7601,9,4,6,10,11,19,-8,18
Amkar,7601,10,4,5,11,11,25,-14,17
Anzhi,7601,11,2,6,12,17,41,-24,12
Loko Moscow,7602,1,12,5,3,32,12,20,41
CSKA Moscow,7602,2,12,3,5,28,18,10,39
Zenit,7602,3,8,8,4,23,15,8,32
Spart Moscow,7602,4,9,5,6,35,28,7,32
Krasnodar,7602,5,9,4,7,30,27,3,31
Terek Grozny,7602,6,7,6,7,21,24,-3,27
Din Moscow,7602,7,6,6,8,20,24,-4,24
FK Rubin,7602,8,6,5,9,24,22,2,23
Rostov,7602,9,5,6,9,11,17,-6,21
Amkar,7602,10,5,4,11,11,24,-13,19
Anzhi,7602,11,2,6,12,15,39,-24,12
Loko Moscow,7603,1,11,5,4,30,17,13,38
Zenit,7603,2,9,8,3,27,14,13,35
Spart Moscow,7603,3,10,5,5,36,27,9,35
CSKA Moscow,7603,4,10,4,6,25,19,6,34
Krasnodar,7603,5,9,4,7,29,26,3,31
Terek Grozny,7603,6,7,6,7,20,23,-3,27
Din Moscow,7603,7,6,6,8,19,23,-4,24
FK Rubin,7603,8,6,5,9,23,18,5,23
Amkar,7603,9,6,4,10,11,22,-11,22
Rostov,7603,10,4,6,10,10,18,-8,18
Anzhi,7603,11,2,7,11,14,37,-23,13
Loko Moscow,7604,1,12,5,3,30,12,18,41
CSKA Moscow,7604,2,10,4,6,27,23,4,34
Zenit,7604,3,8,8,4,25,14,11,32
Krasnodar,7604,4,9,5,6,28,24,4,32
Spart Moscow,7604,5,8,6,6,35,30,5,30
Terek Grozny,7604,6,7,7,6,21,23,-2,28
Din Moscow,7604,7,5,8,7,19,23,-4,23
FK Rubin,7604,8,5,7,8,22,18,4,22
Rostov,7604,9,5,6,9,11,17,-6,21
Amkar,7604,10,5,5,10,13,24,-11,20
Anzhi,7604,11,2,7,11,16,39,-23,13
Loko Moscow,7605,1,11,6,3,30,13,17,39
CSKA Moscow,7605,2,12,3,5,32,19,13,39
Spart Moscow,7605,3,10,6,4,38,27,11,36
Krasnodar,7605,4,9,4,7,30,27,3,31
Zenit,7605,5,7,9,4,23,17,6,30
Terek Grozny,7605,6,7,7,6,22,24,-2,28
FK Rubin,7605,7,6,6,8,24,19,5,24
Din Moscow,7605,8,5,7,8,19,25,-6,22
Rostov,7605,9,4,6,10,10,18,-8,18
Amkar,7605,10,4,6,10,10,23,-13,18
Anzhi,7605,11,2,6,12,16,42,-26,12
Loko Moscow,7606,1,11,6,3,30,14,16,39
Spart Moscow,7606,2,10,6,4,42,30,12,36
CSKA Moscow,7606,3,10,4,6,27,20,7,34
Zenit,7606,4,8,9,3,24,14,10,33
Krasnodar,7606,5,8,6,6,29,26,3,30
Terek Grozny,7606,6,7,6,7,20,24,-4,27
Din Moscow,7606,7,6,6,8,19,24,-5,24
FK Rubin,7606,8,5,6,9,22,19,3,21
Rostov,7606,9,4,6,10,13,22,-9,18
Amkar,7606,10,4,6,10,10,23,-13,18
Anzhi,7606,11,4,5,11,18,38,-20,17
Loko Moscow,7607,1,11,6,3,33,16,17,39
Spart Moscow,7607,2,11,5,4,40,28,12,38
CSKA Moscow,7607,3,10,4,6,27,20,7,34
Krasnodar,7607,4,10,4,6,32,27,5,34
Zenit,7607,5,8,9,3,23,14,9,33
Terek Grozny,7607,6,8,5,7,22,26,-4,29
Din Moscow,7607,7,5,7,8,19,25,-6,22
FK Rubin,7607,8,5,6,9,22,19,3,21
Amkar,7607,9,5,4,11,13,24,-11,19
Rostov,7607,10,4,6,10,11,19,-8,18
Anzhi,7607,11,2,6,12,17,41,-24,12
Loko Moscow,7608,1,12,6,2,32,13,19,42
CSKA Moscow,7608,2,11,3,6,26,20,6,36
Zenit,7608,3,8,8,4,24,14,10,32
Krasnodar,7608,4,9,5,6,32,28,4,32
Spart Moscow,7608,5,8,6,6,36,30,6,30
Terek Grozny,7608,6,8,6,6,21,22,-1,30
Din Moscow,7608,7,5,8,7,17,21,-4,23
FK Rubin,7608,8,5,6,9,23,20,3,21
Rostov,7608,9,5,6,9,14,20,-6,21
Amkar,7608,10,5,5,10,10,22,-12,20
Anzhi,7608,11,2,5,13,14,39,-25,11
Loko Moscow,7609,1,11,6,3,29,14,15,39
CSKA Moscow,7609,2,12,3,5,28,18,10,39
Krasnodar,7609,3,10,4,6,32,24,8,34
Spart Moscow,7609,4,9,5,6,35,28,7,32
Zenit,7609,5,7,9,4,21,14,7,30
Terek Grozny,7609,6,8,6,6,22,23,-1,30
Din Moscow,7609,7,6,7,7,19,22,-3,25
FK Rubin,7609,8,5,6,9,21,19,2,21
Amkar,7609,9,5,4,11,10,23,-13,19
Rostov,7609,10,4,6,10,10,18,-8,18
Anzhi,7609,11,2,6,12,16,40,-24,12
Loko Moscow,7610,1,12,6,2,33,11,22,42
CSKA Moscow,7610,2,12,3,5,30,17,13,39
Spart Moscow,7610,3,10,6,4,38,28,10,36
Krasnodar,7610,4,9,5,6,28,24,4,32
Zenit,7610,5,7,8,5,21,18,3,29
Terek Grozny,7610,6,8,5,7,23,25,-2,29
FK Rubin,7610,7,6,5,9,22,18,4,23
Din Moscow,7610,8,5,6,9,18,24,-6,21
Rostov,7610,9,4,6,10,11,19,-8,18
Amkar,7610,10,4,5,11,11,25,-14,17
Anzhi,7610,11,3,5,12,16,42,-26,14
Loko Moscow,7611,1,11,7,2,31,13,18,40
Spart Moscow,7611,2,10,5,5,39,29,10,35
CSKA Moscow,7611,3,10,4,6,28,21,7,34
Zenit,7611,4,8,9,3,23,14,9,33
Krasnodar,7611,5,9,5,6,33,28,5,32
Terek Grozny,7611,6,7,5,8,21,25,-4,26
Din Moscow,7611,7,6,6,8,21,25,-4,24
Rostov,7611,8,5,6,9,12,18,-6,21
FK Rubin,7611,9,5,5,10,24,24,0,20
Amkar,7611,10,5,4,11,11,24,-13,19
Anzhi,7611,11,3,6,11,18,40,-22,15
Loko Moscow,7612,1,12,5,3,31,13,18,41
CSKA Moscow,7612,2,11,4,5,29,19,10,37
Spart Moscow,7612,3,10,6,4,37,26,11,36
Zenit,7612,4,8,9,3,25,16,9,33
Terek Grozny,7612,5,8,6,6,22,23,-1,30
Krasnodar,7612,6,8,5,7,28,26,2,29
FK Rubin,7612,7,6,6,8,23,18,5,24
Din Moscow,7612,8,5,7,8,17,22,-5,22
Rostov,7612,9,4,6,10,10,18,-8,18
Amkar,7612,10,4,5,11,11,26,-15,17
Anzhi,7612,11,2,5,13,14,40,-26,11
Loko Moscow,7613,1,12,5,3,32,12,20,41
Spart Moscow,7613,2,11,5,4,40,26,14,38
CSKA Moscow,7613,3,11,3,6,28,20,8,36
Zenit,7613,4,8,8,4,22,14,8,32
Krasnodar,7613,5,8,4,8,27,30,-3,28
Terek Grozny,7613,6,7,5,8,22,27,-5,26
FK Rubin,7613,7,6,6,8,25,18,7,24
Din Moscow,7613,8,5,7,8,18,26,-8,22
Amkar,7613,9,5,4,11,11,24,-13,19
Rostov,7613,10,4,6,10,11,19,-8,18
Anzhi,7613,11,4,5,11,20,40,-20,17
Loko Moscow,7614,1,13,5,2,33,13,20,44
CSKA Moscow,7614,2,11,4,5,28,18,10,37
Spart Moscow,7614,3,9,7,4,39,29,10,34
Krasnodar,7614,4,9,4,7,31,27,4,31
Zenit,7614,5,7,9,4,21,14,7,30
Terek Grozny,7614,6,8,5,7,23,25,-2,29
FK Rubin,7614,7,6,5,9,25,19,6,23
Din Moscow,7614,8,5,7,8,20,28,-8,22
Rostov,7614,9,4,7,9,10,17,-7,19
Amkar,7614,10,5,4,11,12,26,-14,19
Anzhi,7614,11,2,5,13,16,42,-26,11
Loko Moscow,7615,1,11,5,4,32,16,16,38
Spart Moscow,7615,2,10,5,5,36,27,9,35
CSKA Moscow,7615,3,10,5,5,28,20,8,35
Zenit,7615,4,8,9,3,26,17,9,33
Krasnodar,7615,5,9,4,7,29,26,3,31
Terek Grozny,7615,6,8,6,6,22,23,-1,30
Din Moscow,7615,7,6,6,8,20,23,-3,24
FK Rubin,7615,8,6,5,9,22,19,3,23
Rostov,7615,9,5,6,9,11,17,-6,21
Amkar,7615,10,4,4,12,9,24,-15,16
Anzhi,7615,11,2,7,11,16,39,-23,13
CSKA Moscow,7616,1,12,3,5,31,19,12,39
Loko Moscow,7616,2,11,5,4,29,13,16,38
Krasnodar,7616,3,10,4,6,33,24,9,34
Spart Moscow,7616,4,9,6,5,37,29,8,33
Zenit,7616,5,8,8,4,23,17,6,32
Terek Grozny,7616,6,9,5,6,26,24,2,32
Din Moscow,7616,7,7,6,7,22,24,-2,27
FK Rubin,7616,8,5,5,10,22,24,-2,20
Rostov,7616,9,4,7,9,11,18,-7,19
Amkar,7616,10,4,4,12,10,27,-17,16
Anzhi,7616,11,2,5,13,16,41,-25,11
Loko Moscow,7617,1,11,5,4,30,15,15,38
Spart Moscow,7617,2,10,6,4,40,28,12,36
CSKA Moscow,7617,3,11,3,6,26,18,8,36
Zenit,7617,4,9,8,3,23,13,10,35
Krasnodar,7617,5,10,4,6,32,26,6,34
Terek Grozny,7617,6,7,5,8,20,27,-7,26
Din Moscow,7617,7,6,6,8,18,23,-5,24
FK Rubin,7617,8,5,5,10,22,20,2,20
Amkar,7617,9,5,5,10,14,23,-9,20
Rostov,7617,10,4,6,10,12,21,-9,18
Anzhi,7617,11,3,5,12,15,38,-23,14
Loko Moscow,7618,1,13,5,2,32,12,20,44
Spart Moscow,7618,2,11,5,4,41,29,12,38
CSKA Moscow,7618,3,10,4,6,27,20,7,34
Zenit,7618,4,8,8,4,23,15,8,32
Krasnodar,7618,5,8,5,7,28,26,2,29
Terek Grozny,7618,6,7,6,7,21,24,-3,27
FK Rubin,7618,7,6,6,8,24,18,6,24
Din Moscow,7618,8,5,6,9,19,26,-7,21
Amkar,7618,9,5,4,11,11,25,-14,19
Rostov,7618,10,4,6,10,12,20,-8,18
Anzhi,7618,11,2,7,11,16,39,-23,13
Loko Moscow,7619,1,11,6,3,29,12,17,39
CSKA Moscow,7619,2,12,3,5,28,18,10,39
Terek Grozny,7619,3,9,5,6,24,24,0,32
Krasnodar,7619,4,9,4,7,28,25,3,31
Zenit,7619,5,7,9,4,22,15,7,30
Spart Moscow,7619,6,8,6,6,37,31,6,30
Din Moscow,7619,7,7,6,7,22,23,-1,27
FK Rubin,7619,8,6,5,9,22,19,3,23
Rostov,7619,9,5,6,9,12,18,-6,21
Amkar,7619,10,4,5,11,12,26,-14,17
Anzhi,7619,11,2,5,13,14,39,-25,11
Loko Moscow,7620,1,12,6,2,32,13,19,42
CSKA Moscow,7620,2,12,3,5,29,19,10,39
Spart Moscow,7620,3,9,6,5,35,28,7,33
Terek Grozny,7620,4,9,5,6,24,23,1,32
Zenit,7620,5,7,8,5,22,16,6,29
Krasnodar,7620,6,8,5,7,29,27,2,29
Din Moscow,7620,7,6,7,7,20,22,-2,25
FK Rubin,7620,8,6,5,9,23,20,3,23
Rostov,7620,9,5,6,9,12,17,-5,21
Amkar,7620,10,4,4,12,10,25,-15,16
Anzhi,7620,11,2,5,13,16,42,-26,11
Loko Moscow,7621,1,12,5,3,34,13,21,41
CSKA Moscow,7621,2,12,3,5,29,17,12,39
Spart Moscow,7621,3,9,6,5,39,33,6,33
Krasnodar,7621,4,9,5,6,29,25,4,32
Zenit,7621,5,7,8,5,22,21,1,29
Terek Grozny,7621,6,7,5,8,21,26,-5,26
Din Moscow,7621,7,6,7,7,22,24,-2,25
Amkar,7621,8,6,4,10,15,22,-7,22
FK Rubin,7621,9,5,6,9,22,20,2,21
Rostov,7621,10,4,6,10,11,20,-9,18
Anzhi,7621,11,3,5,12,16,39,-23,14
Loko Moscow,7622,1,13,5,2,33,13,20,44
Spart Moscow,7622,2,11,5,4,40,28,12,38
CSKA Moscow,7622,3,11,3,6,28,22,6,36
Krasnodar,7622,4,9,4,7,32,28,4,31
Terek Grozny,7622,5,8,6,6,23,24,-1,30
Zenit,7622,6,7,8,5,22,16,6,29
Din Moscow,7622,7,5,7,8,19,25,-6,22
FK Rubin,7622,8,5,6,9,22,20,2,21
Rostov,7622,9,4,6,10,10,18,-8,18
Amkar,7622,10,4,4,12,10,25,-15,16
Anzhi,7622,11,3,6,11,20,40,-20,15
Loko Moscow,7623,1,12,6,2,33,14,19,42
CSKA Moscow,7623,2,11,4,5,29,19,10,37
Spart Moscow,7623,3,8,7,5,33,27,6,31
Zenit,7623,4,7,9,4,23,16,7,30
Krasnodar,7623,5,8,6,6,30,27,3,30
Din Moscow,7623,6,7,6,7,24,22,2,27
Terek Grozny,7623,7,7,6,7,21,26,-5,27
FK Rubin,7623,8,5,6,9,23,23,0,21
Amkar,7623,9,5,5,10,12,22,-10,20
Rostov,7623,10,4,7,9,10,17,-7,19
Anzhi,7623,11,2,6,12,16,41,-25,12
Loko Moscow,7624,1,11,6,3,29,13,16,39
CSKA Moscow,7624,2,11,4,5,27,18,9,37
Spart Moscow,7624,3,10,5,5,38,28,10,35
Krasnodar,7624,4,10,4,6,30,24,6,34
Zenit,7624,5,7,10,3,22,14,8,31
Terek Grozny,7624,6,7,6,7,21,24,-3,27
Din Moscow,7624,7,5,7,8,17,23,-6,22
FK Rubin,7624,8,5,6,9,21,18,3,21
Amkar,7624,9,5,5,10,13,25,-12,20
Rostov,7624,10,4,6,10,10,18,-8,18
Anzhi,7624,11,3,5,12,15,38,-23,14
Loko Moscow,7625,1,12,6,2,33,14,19,42
CSKA Moscow,7625,2,11,3,6,28,18,10,36
Zenit,7625,3,8,9,3,24,15,9,33
Spart Moscow,7625,4,9,5,6,36,29,7,32
Krasnodar,7625,5,9,4,7,29,26,3,31
Din Moscow,7625,6,7,6,7,19,21,-2,27
Terek Grozny,7625,7,7,6,7,20,23,-3,27
Rostov,7625,8,5,6,9,13,19,-6,21
FK Rubin,7625,9,5,5,10,21,19,2,20
Amkar,7625,10,4,5,11,9,23,-14,17
Anzhi,7625,11,3,5,12,15,40,-25,14
Loko Moscow,7626,1,13,5,2,33,11,22,44
CSKA Moscow,7626,2,11,4,5,26,17,9,37
Spart Moscow,7626,3,10,6,4,38,27,11,36
Krasnodar,7626,4,9,4,7,28,26,2,31
Zenit,7626,5,7,9,4,21,15,6,30
Terek Grozny,7626,6,7,6,7,23,28,-5,27
Din Moscow,7626,7,5,7,8,19,25,-6,22
FK Rubin,7626,8,5,6,9,23,20,3,21
Amkar,7626,9,5,5,10,15,25,-10,20
Rostov,7626,10,4,6,10,10,18,-8,18
Anzhi,7626,11,2,6,12,16,40,-24,12
Loko Moscow,7627,1,12,6,2,35,14,21,42
Zenit,7627,2,8,9,3,27,15,12,33
Spart Moscow,7627,3,9,6,5,39,31,8,33
CSKA Moscow,7627,4,10,3,7,26,23,3,33
Terek Grozny,7627,5,8,6,6,22,23,-1,30
Krasnodar,7627,6,8,4,8,29,30,-1,28
Din Moscow,7627,7,6,7,7,22,23,-1,25
FK Rubin,7627,8,6,5,9,23,21,2,23
Rostov,7627,9,5,6,9,13,19,-6,21
Amkar,7627,10,4,4,12,10,25,-15,16
Anzhi,7627,11,3,6,11,17,39,-22,15
Loko Moscow,7628,1,12,5,3,30,14,16,41
CSKA Moscow,7628,2,10,4,6,26,19,7,34
Spart Moscow,7628,3,9,5,6,39,31,8,32
Zenit,7628,4,8,8,4,22,14,8,32
Krasnodar,7628,5,9,4,7,30,25,5,31
Terek Grozny,7628,6,8,5,7,21,23,-2,29
Din Moscow,7628,7,7,6,7,22,23,-1,27
FK Rubin,7628,8,6,5,9,23,19,4,23
Rostov,7628,9,5,6,9,13,19,-6,21
Amkar,7628,10,5,4,11,10,25,-15,19
Anzhi,7628,11,2,6,12,15,39,-24,12
Loko Moscow,7629,1,13,5,2,33,11,22,44
CSKA Moscow,7629,2,11,3,6,26,18,8,36
Spart Moscow,7629,3,10,5,5,39,27,12,35
Zenit,7629,4,8,8,4,22,16,6,32
Krasnodar,7629,5,9,4,7,29,26,3,31
Terek Grozny,7629,6,8,6,6,26,25,1,30
Din Moscow,7629,7,7,6,7,22,22,0,27
FK Rubin,7629,8,5,5,10,23,22,1,20
Rostov,7629,9,4,6,10,10,20,-10,18
Amkar,7629,10,4,4,12,10,29,-19,16
Anzhi,7629,11,2,6,12,16,40,-24,12
Loko Moscow,7630,1,12,5,3,33,16,17,41
Spart Moscow,7630,2,11,5,4,43,27,16,38
CSKA Moscow,7630,3,11,3,6,28,19,9,36
Zenit,7630,4,8,8,4,24,16,8,32
Krasnodar,7630,5,9,4,7,31,28,3,31
Terek Grozny,7630,6,7,6,7,21,24,-3,27
FK Rubin,7630,7,7,5,8,25,17,8,26
Din Moscow,7630,8,5,6,9,17,24,-7,21
Amkar,7630,9,5,4,11,10,26,-16,19
Rostov,7630,10,4,6,10,12,21,-9,18
Anzhi,7630,11,2,6,12,15,41,-26,12
Loko Moscow,7631,1,12,5,3,31,14,17,41
CSKA Moscow,7631,2,11,3,6,28,20,8,36
Spart Moscow,7631,3,9,7,4,39,27,12,34
Krasnodar,7631,4,10,4,6,31,24,7,34
Terek Grozny,7631,5,8,6,6,24,25,-1,30
Zenit,7631,6,7,8,5,22,17,5,29
Din Moscow,7631,7,5,8,7,18,22,-4,23
FK Rubin,7631,8,5,6,9,22,19,3,21
Rostov,7631,9,4,6,10,11,22,-11,18
Amkar,7631,10,4,6,10,12,25,-13,18
Anzhi,7631,11,3,5,12,17,40,-23,14
Loko Moscow,7632,1,11,7,2,29,11,18,40
CSKA Moscow,7632,2,11,3,6,27,19,8,36
Zenit,7632,3,8,9,3,23,14,9,33
Spart Moscow,7632,4,9,5,6,38,31,7,32
Krasnodar,7632,5,8,6,6,29,26,3,30
Terek Grozny,7632,6,7,6,7,20,25,-5,27
FK Rubin,7632,7,6,6,8,27,21,6,24
Din Moscow,7632,8,6,6,8,23,28,-5,24
Amkar,7632,9,5,5,10,10,22,-12,20
Rostov,7632,10,4,6,10,11,19,-8,18
Anzhi,7632,11,3,5,12,17,38,-21,14
Loko Moscow,7633,1,12,5,3,31,12,19,41
CSKA Moscow,7633,2,12,3,5,29,18,11,39
Spart Moscow,7633,3,11,5,4,40,25,15,38
Zenit,7633,4,8,8,4,23,15,8,32
Krasnodar,7633,5,9,4,7,30,27,3,31
Terek Grozny,7633,6,7,5,8,22,28,-6,26
Din Moscow,7633,7,5,7,8,18,24,-6,22
FK Rubin,7633,8,5,6,9,23,21,2,21
Amkar,7633,9,5,4,11,11,26,-15,19
Rostov,7633,10,4,6,10,10,19,-9,18
Anzhi,7633,11,3,5,12,18,40,-22,14
Loko Moscow,7634,1,12,6,2,33,12,21,42
CSKA Moscow,7634,2,12,3,5,30,17,13,39
Spart Moscow,7634,3,10,6,4,39,26,13,36
Terek Grozny,7634,4,9,5,6,24,23,1,32
Krasnodar,7634,5,9,4,7,29,28,1,31
Zenit,7634,6,7,9,4,21,15,6,30
Din Moscow,7634,7,6,6,8,19,25,-6,24
FK Rubin,7634,8,5,5,10,22,20,2,20
Rostov,7634,9,4,6,10,10,19,-9,18
Amkar,7634,10,4,5,11,11,26,-15,17
Anzhi,7634,11,2,5,13,14,41,-27,11
Loko Moscow,7635,1,11,5,4,30,14,16,38
Zenit,7635,2,9,8,3,25,13,12,35
Spart Moscow,7635,3,9,7,4,39,29,10,34
CSKA Moscow,7635,4,10,3,7,25,21,4,33
Krasnodar,7635,5,9,4,7,30,27,3,31
Terek Grozny,7635,6,8,5,7,24,26,-2,29
FK Rubin,7635,7,6,6,8,24,19,5,24
Din Moscow,7635,8,5,8,7,20,24,-4,23
Rostov,7635,9,4,7,9,12,19,-7,19
Amkar,7635,10,5,4,11,11,25,-14,19
Anzhi,7635,11,3,5,12,17,40,-23,14
Loko Moscow,7636,1,12,6,2,31,12,19,42
CSKA Moscow,7636,2,12,3,5,31,18,13,39
Spart Moscow,7636,3,10,5,5,40,30,10,35
Krasnodar,7636,4,8,6,6,29,26,3,30
Zenit,7636,5,7,8,5,22,16,6,29
Terek Grozny,7636,6,8,5,7,26,26,0,29
FK Rubin,7636,7,6,6,8,26,18,8,24
Din Moscow,7636,8,5,6,9,19,28,-9,21
Amkar,7636,9,5,4,11,11,26,-15,19
Rostov,7636,10,4,6,10,11,20,-9,18
Anzhi,7636,11,3,5,12,18,44,-26,14
Loko Moscow,7637,1,12,5,3,32,14,18,41
CSKA Moscow,7637,2,11,3,6,31,21,10,36
Spart Moscow,7637,3,9,7,4,38,28,10,34
Krasnodar,7637,4,10,4,6,32,26,6,34
Zenit,7637,5,8,8,4,24,16,8,32
Terek Grozny,7637,6,7,6,7,22,25,-3,27
Din Moscow,7637,7,6,6,8,19,23,-4,24
FK Rubin,7637,8,5,5,10,21,21,0,20
Rostov,7637,9,4,7,9,10,17,-7,19
Amkar,7637,10,4,6,10,14,27,-13,18
Anzhi,7637,11,3,5,12,16,41,-25,14
Loko Moscow,7638,1,13,5,2,33,12,21,44
CSKA Moscow,7638,2,12,3,5,31,19,12,39
Spart Moscow,7638,3,10,5,5,37,26,11,35
Terek Grozny,7638,4,8,6,6,23,23,0,30
Zenit,7638,5,7,8,5,21,18,3,29
Krasnodar,7638,6,8,5,7,29,27,2,29
Din Moscow,7638,7,6,6,8,19,23,-4,24
FK Rubin,7638,8,5,6,9,23,20,3,21
Amkar,7638,9,5,4,11,11,25,-14,19
Rostov,7638,10,4,6,10,10,20,-10,18
Anzhi,7638,11,2,6,12,16,40,-24,12
Loko Moscow,7639,1,12,5,3,31,13,18,41
CSKA Moscow,7639,2,11,4,5,31,17,14,37
Spart Moscow,7639,3,9,6,5,37,28,9,33
Krasnodar,7639,4,9,4,7,29,26,3,31
Zenit,7639,5,7,9,4,22,15,7,30
Terek Grozny,7639,6,7,6,7,20,23,-3,27
FK Rubin,7639,7,7,5,8,27,19,8,26
Din Moscow,7639,8,5,7,8,19,26,-7,22
Amkar,7639,9,6,4,10,11,22,-11,22
Rostov,7639,10,4,6,10,11,20,-9,18
Anzhi,7639,11,2,6,12,14,43,-29,12
Loko Moscow,7640,1,12,6,2,31,12,19,42
CSKA Moscow,7640,2,10,4,6,26,19,7,34
Spart Moscow,7640,3,9,6,5,38,29,9,33
Zenit,7640,4,8,8,4,23,15,8,32
Krasnodar,7640,5,8,5,7,28,26,2,29
Terek Grozny,7640,6,8,5,7,22,24,-2,29
FK Rubin,7640,7,7,5,8,25,18,7,26
Din Moscow,7640,8,6,6,8,18,23,-5,24
Amkar,7640,9,5,5,10,11,23,-12,20
Rostov,7640,10,4,6,10,12,21,-9,18
Anzhi,7640,11,2,6,12,16,40,-24,12
Loko Moscow,7641,1,12,6,2,30,11,19,42
CSKA Moscow,7641,2,12,3,5,29,18,11,39
Spart Moscow,7641,3,8,7,5,33,27,6,31
Krasnodar,7641,4,8,6,6,28,25,3,30
Zenit,7641,5,7,8,5,22,17,5,29
Terek Grozny,7641,6,8,5,7,22,25,-3,29
Din Moscow,7641,7,7,6,7,22,22,0,27
FK Rubin,7641,8,5,6,9,23,21,2,21
Amkar,7641,9,5,5,10,11,22,-11,20
Rostov,7641,10,4,7,9,10,17,-7,19
Anzhi,7641,11,2,5,13,15,40,-25,11
Loko Moscow,7642,1,13,5,2,32,11,21,44
CSKA Moscow,7642,2,12,3,5,30,17,13,39
Spart Moscow,7642,3,11,5,4,36,25,11,38
Zenit,7642,4,7,8,5,21,17,4,29
Krasnodar,7642,5,8,4,8,27,28,-1,28
Terek Grozny,7642,6,7,7,6,23,25,-2,28
FK Rubin,7642,7,6,6,8,23,17,6,24
Din Moscow,7642,8,5,7,8,17,22,-5,22
Rostov,7642,9,4,6,10,10,18,-8,18
Amkar,7642,10,4,5,11,10,24,-14,17
Anzhi,7642,11,2,6,12,16,41,-25,12
Loko Moscow,7643,1,12,5,3,31,16,15,41
CSKA Moscow,7643,2,11,3,6,30,20,10,36
Spart Moscow,7643,3,9,6,5,35,28,7,33
Zenit,7643,4,8,8,4,23,14,9,32
Krasnodar,7643,5,9,5,6,34,27,7,32
Terek Grozny,7643,6,9,5,6,25,22,3,32
FK Rubin,7643,7,5,7,8,25,21,4,22
Din Moscow,7643,8,5,7,8,20,25,-5,22
Rostov,7643,9,4,7,9,10,17,-7,19
Amkar,7643,10,5,4,11,11,24,-13,19
Anzhi,7643,11,2,5,13,15,45,-30,11
Loko Moscow,7644,1,11,5,4,31,15,16,38
Zenit,7644,2,9,8,3,24,13,11,35
Spart Moscow,7644,3,10,5,5,39,30,9,35
CSKA Moscow,7644,4,10,4,6,26,20,6,34
Krasnodar,7644,5,9,4,7,30,28,2,31
Terek Grozny,7644,6,7,5,8,23,28,-5,26
FK Rubin,7644,7,6,6,8,25,19,6,24
Din Moscow,7644,8,5,7,8,21,26,-5,22
Rostov,7644,9,5,6,9,13,19,-6,21
Amkar,7644,10,5,4,11,12,24,-12,19
Anzhi,7644,11,3,6,11,18,40,-22,15
Loko Moscow,7645,1,12,5,3,32,13,19,41
CSKA Moscow,7645,2,12,3,5,28,18,10,39
Spart Moscow,7645,3,10,5,5,40,30,10,35
Zenit,7645,4,8,8,4,22,14,8,32
Krasnodar,7645,5,8,4,8,28,28,0,28
Din Moscow,7645,6,7,6,7,21,22,-1,27
Terek Grozny,7645,7,7,6,7,22,26,-4,27
FK Rubin,7645,8,6,5,9,22,18,4,23
Rostov,7645,9,4,6,10,10,20,-10,18
Amkar,7645,10,4,5,11,13,27,-14,17
Anzhi,7645,11,3,5,12,17,39,-22,14
Loko Moscow,7646,1,12,6,2,32,13,19,42
Spart Moscow,7646,2,10,6,4,39,27,12,36
CSKA Moscow,7646,3,11,3,6,27,18,9,36
Zenit,7646,4,8,9,3,23,14,9,33
Terek Grozny,7646,5,8,6,6,23,24,-1,30
Krasnodar,7646,6,8,4,8,29,28,1,28
Din Moscow,7646,7,6,7,7,20,22,-2,25
FK Rubin,7646,8,6,5,9,24,21,3,23
Rostov,7646,9,4,6,10,12,21,-9,18
Amkar,7646,10,4,4,12,9,25,-16,16
Anzhi,7646,11,2,6,12,16,41,-25,12
Loko Moscow,7647,1,11,6,3,29,12,17,39
Spart Moscow,7647,2,10,6,4,41,28,13,36
CSKA Moscow,7647,3,10,5,5,25,17,8,35
Krasnodar,7647,4,9,5,6,28,24,4,32
Zenit,7647,5,7,10,3,21,13,8,31
Terek Grozny,7647,6,8,5,7,23,24,-1,29
FK Rubin,7647,7,6,6,8,23,17,6,24
Din Moscow,7647,8,5,6,9,17,24,-7,21
Rostov,7647,9,4,7,9,12,19,-7,19
Amkar,7647,10,5,4,11,12,27,-15,19
Anzhi,7647,11,2,6,12,14,40,-26,12
Loko Moscow,7648,1,12,5,3,30,12,18,41
CSKA Moscow,7648,2,11,3,6,28,20,8,36
Spart Moscow,7648,3,10,5,5,38,30,8,35
Zenit,7648,4,8,8,4,24,16,8,32
Terek Grozny,7648,5,9,5,6,27,25,2,32
Krasnodar,7648,6,8,4,8,29,28,1,28
FK Rubin,7648,7,7,5,8,26,19,7,26
Din Moscow,7648,8,5,6,9,19,26,-7,21
Amkar,7648,9,5,4,11,14,27,-13,19
Rostov,7648,10,4,6,10,10,19,-9,18
Anzhi,7648,11,3,5,12,16,39,-23,14
Loko Moscow,7649,1,11,6,3,29,12,17,39
Spart Moscow,7649,2,11,5,4,43,28,15,38
Zenit,7649,3,9,8,3,24,13,11,35
CSKA Moscow,7649,4,10,4,6,26,20,6,34
Krasnodar,7649,5,8,6,6,28,25,3,30
Terek Grozny,7649,6,8,5,7,21,23,-2,29
Din Moscow,7649,7,6,6,8,23,25,-2,24
FK Rubin,7649,8,5,6,9,23,22,1,21
Amkar,7649,9,5,4,11,10,26,-16,19
Rostov,7649,10,4,6,10,11,20,-9,18
Anzhi,7649,11,2,6,12,15,39,-24,12
Loko Moscow,7650,1,11,6,3,29,12,17,39
CSKA Moscow,7650,2,12,3,5,31,20,11,39
Krasnodar,7650,3,10,4,6,30,25,5,34
Terek Grozny,7650,4,9,5,6,24,22,2,32
Spart Moscow,7650,5,8,7,5,36,29,7,31
Zenit,7650,6,7,9,4,23,16,7,30
Din Moscow,7650,7,7,6,7,20,22,-2,27
FK Rubin,7650,8,5,5,10,22,20,2,20
Rostov,7650,9,4,7,9,11,18,-7,19
Amkar,7650,10,4,5,11,10,24,-14,17
Anzhi,7650,11,2,5,13,15,43,-28,11
Loko Moscow,7651,1,12,5,3,32,13,19,41
Spart Moscow,7651,2,11,5,4,41,28,13,38
CSKA Moscow,7651,3,11,4,5,28,18,10,37
Krasnodar,7651,4,9,4,7,28,25,3,31
Zenit,7651,5,7,9,4,23,17,6,30
Terek Grozny,7651,6,7,5,8,21,26,-5,26
FK Rubin,7651,7,6,6,8,22,17,5,24
Din Moscow,7651,8,5,7,8,18,23,-5,22
Amkar,7651,9,5,4,11,12,27,-15,19
Rostov,7651,10,4,6,10,10,18,-8,18
Anzhi,7651,11,3,5,12,17,40,-23,14
Loko Moscow,7652,1,12,6,2,31,12,19,42
CSKA Moscow,7652,2,10,5,5,27,19,8,35
Krasnodar,7652,3,9,5,6,30,26,4,32
Terek Grozny,7652,4,9,5,6,23,23,0,32
Spart Moscow,7652,5,8,7,5,35,28,7,31
Zenit,7652,6,7,9,4,22,15,7,30
FK Rubin,7652,7,6,5,9,23,19,4,23
Din Moscow,7652,8,5,7,8,17,22,-5,22
Rostov,7652,9,5,6,9,12,18,-6,21
Amkar,7652,10,4,5,11,11,25,-14,17
Anzhi,7652,11,2,6,12,15,39,-24,12
Loko Moscow,7653,1,11,6,3,29,13,16,39
Spart Moscow,7653,2,10,5,5,38,28,10,35
CSKA Moscow,7653,3,10,4,6,25,18,7,34
Zenit,7653,4,8,9,3,22,13,9,33
Krasnodar,7653,5,9,4,7,29,25,4,31
Terek Grozny,7653,6,7,6,7,21,24,-3,27
Din Moscow,7653,7,6,6,8,20,24,-4,24
FK Rubin,7653,8,6,5,9,22,19,3,23
Amkar,7653,9,5,5,10,11,23,-12,20
Rostov,7653,10,4,6,10,11,19,-8,18
Anzhi,7653,11,3,6,11,15,37,-22,15
Loko Moscow,7654,1,11,7,2,31,13,18,40
CSKA Moscow,7654,2,11,4,5,29,19,10,37
Spart Moscow,7654,3,10,6,4,39,27,12,36
Krasnodar,7654,4,9,5,6,30,26,4,32
Zenit,7654,5,7,9,4,22,16,6,30
Terek Grozny,7654,6,7,5,8,20,24,-4,26
Din Moscow,7654,7,5,7,8,19,24,-5,22
FK Rubin,7654,8,5,6,9,22,19,3,21
Amkar,7654,9,5,5,10,11,23,-12,20
Rostov,7654,10,4,6,10,10,20,-10,18
Anzhi,7654,11,3,6,11,16,38,-22,15
Loko Moscow,7655,1,12,5,3,31,14,17,41
CSKA Moscow,7655,2,11,3,6,26,20,6,36
Krasnodar,7655,3,10,4,6,30,24,6,34
Spart Moscow,7655,4,9,6,5,35,28,7,33
Zenit,7655,5,8,8,4,25,15,10,32
Terek Grozny,7655,6,8,5,7,22,24,-2,29
Din Moscow,7655,7,6,6,8,22,23,-1,24
Amkar,7655,8,6,4,10,12,22,-10,22
FK Rubin,7655,9,5,5,10,22,23,-1,20
Rostov,7655,10,4,7,9,11,18,-7,19
Anzhi,7655,11,2,5,13,15,40,-25,11
Loko Moscow,7656,1,13,5,2,32,11,21,44
CSKA Moscow,7656,2,11,3,6,30,20,10,36
Zenit,7656,3,8,8,4,24,17,7,32
Terek Grozny,7656,4,9,5,6,25,23,2,32
Krasnodar,7656,5,9,4,7,29,26,3,31
Spart Moscow,7656,6,8,6,6,35,29,6,30
Din Moscow,7656,7,7,6,7,21,21,0,27
Rostov,7656,8,5,6,9,12,18,-6,21
FK Rubin,7656,9,5,5,10,22,22,0,20
Amkar,7656,10,4,5,11,10,26,-16,17
Anzhi,7656,11,2,5,13,15,42,-27,11
Loko Moscow,7657,1,13,5,2,31,11,20,44
Spart Moscow,7657,2,11,5,4,41,27,14,38
CSKA Moscow,7657,3,10,4,6,27,22,5,34
Zenit,7657,4,8,8,4,25,15,10,32
Terek Grozny,7657,5,9,5,6,26,24,2,32
Krasnodar,7657,6,8,4,8,27,27,0,28
Din Moscow,7657,7,6,6,8,22,24,-2,24
FK Rubin,7657,8,6,5,9,23,22,1,23
Rostov,7657,9,4,6,10,10,18,-8,18
Amkar,7657,10,4,4,12,12,28,-16,16
Anzhi,7657,11,2,6,12,16,42,-26,12
Loko Moscow,7658,1,13,5,2,33,12,21,44
CSKA Moscow,7658,2,10,5,5,27,19,8,35
Spart Moscow,7658,3,9,6,5,38,30,8,33
Krasnodar,7658,4,9,4,7,30,27,3,31
Zenit,7658,5,7,9,4,22,16,6,30
Terek Grozny,7658,6,8,5,7,24,26,-2,29
Din Moscow,7658,7,6,7,7,25,23,2,25
FK Rubin,7658,8,5,5,10,22,25,-3,20
Amkar,7658,9,5,4,11,12,26,-14,19
Rostov,7658,10,4,6,10,10,18,-8,18
Anzhi,7658,11,3,6,11,19,40,-21,15
Loko Moscow,7659,1,11,6,3,31,14,17,39
CSKA Moscow,7659,2,12,3,5,29,17,12,39
Krasnodar,7659,3,10,4,6,31,25,6,34
Spart Moscow,7659,4,9,6,5,36,28,8,33
Zenit,7659,5,7,9,4,22,15,7,30
Terek Grozny,7659,6,7,6,7,22,26,-4,27
Din Moscow,7659,7,6,6,8,21,25,-4,24
FK Rubin,7659,8,6,5,9,24,21,3,23
Rostov,7659,9,4,6,10,11,19,-8,18
Amkar,7659,10,4,6,10,10,23,-13,18
Anzhi,7659,11,3,5,12,17,41,-24,14
Loko Moscow,7660,1,12,5,3,30,12,18,41
CSKA Moscow,7660,2,11,3,6,29,19,10,36
Zenit,7660,3,9,8,3,24,13,11,35
Spart Moscow,7660,4,10,5,5,37,27,10,35
Krasnodar,7660,5,8,5,7,27,25,2,29
Terek Grozny,7660,6,8,5,7,21,23,-2,29
FK Rubin,7660,7,5,7,8,21,17,4,22
Din Moscow,7660,8,5,7,8,17,23,-6,22
Amkar,7660,9,6,4,10,12,23,-11,22
Rostov,7660,10,4,6,10,10,18,-8,18
Anzhi,7660,11,2,5,13,14,42,-28,11
Loko Moscow,7661,1,12,5,3,32,15,17,41
CSKA Moscow,7661,2,11,4,5,28,18,10,37
Spart Moscow,7661,3,10,5,5,45,30,15,35
Krasnodar,7661,4,9,5,6,31,25,6,32
Terek Grozny,7661,5,9,5,6,23,22,1,32
Zenit,7661,6,7,9,4,23,17,6,30
Din Moscow,7661,7,6,6,8,19,25,-6,24
FK Rubin,7661,8,5,6,9,22,19,3,21
Amkar,7661,9,5,4,11,11,25,-14,19
Rostov,7661,10,4,6,10,12,24,-12,18
Anzhi,7661,11,2,5,13,14,40,-26,11
Loko Moscow,7662,1,11,7,2,32,14,18,40
Spart Moscow,7662,2,10,6,4,39,27,12,36
CSKA Moscow,7662,3,10,4,6,28,21,7,34
Zenit,7662,4,7,10,3,24,16,8,31
Krasnodar,7662,5,8,5,7,28,26,2,29
Terek Grozny,7662,6,7,6,7,21,24,-3,27
FK Rubin,7662,7,6,6,8,24,19,5,24
Din Moscow,7662,8,5,7,8,19,26,-7,22
Amkar,7662,9,5,5,10,12,24,-12,20
Rostov,7662,10,4,6,10,11,19,-8,18
Anzhi,7662,11,3,6,11,17,39,-22,15
Loko Moscow,7663,1,11,7,2,31,13,18,40
Spart Moscow,7663,2,10,6,4,38,27,11,36
CSKA Moscow,7663,3,11,3,6,27,19,8,36
Zenit,7663,4,8,9,3,24,14,10,33
Terek Grozny,7663,5,8,6,6,24,24,0,30
Krasnodar,7663,6,8,5,7,28,26,2,29
Din Moscow,7663,7,6,7,7,22,23,-1,25
FK Rubin,7663,8,6,5,9,23,21,2,23
Rostov,7663,9,4,6,10,10,19,-9,18
Amkar,7663,10,4,5,11,11,25,-14,17
Anzhi,7663,11,2,5,13,15,42,-27,11
Loko Moscow,7664,1,12,5,3,31,13,18,41
CSKA Moscow,7664,2,12,3,5,32,18,14,39
Spart Moscow,7664,3,8,8,4,36,28,8,32
Krasnodar,7664,4,9,5,6,30,26,4,32
Zenit,7664,5,7,8,5,21,19,2,29
Terek Grozny,7664,6,8,5,7,22,24,-2,29
Din Moscow,7664,7,5,8,7,19,23,-4,23
FK Rubin,7664,8,5,7,8,22,18,4,22
Rostov,7664,9,4,7,9,10,17,-7,19
Amkar,7664,10,4,5,11,10,24,-14,17
Anzhi,7664,11,3,5,12,17,40,-23,14
Loko Moscow,7665,1,11,7,2,30,12,18,40
CSKA Moscow,7665,2,10,4,6,27,20,7,34
Zenit,7665,3,8,9,3,24,15,9,33
Spart Moscow,7665,4,8,8,4,38,30,8,32
Krasnodar,7665,5,8,5,7,28,26,2,29
Terek Grozny,7665,6,8,5,7,22,25,-3,29
FK Rubin,7665,7,7,5,8,25,17,8,26
Din Moscow,7665,8,5,7,8,19,26,-7,22
Rostov,7665,9,4,7,9,12,19,-7,19
Amkar,7665,10,4,5,11,11,25,-14,17
Anzhi,7665,11,3,6,11,16,37,-21,15
Loko Moscow,7666,1,11,5,4,30,14,16,38
Spart Moscow,7666,2,11,5,4,41,28,13,38
CSKA Moscow,7666,3,10,4,6,25,18,7,34
Zenit,7666,4,8,9,3,23,14,9,33
Krasnodar,7666,5,9,5,6,28,24,4,32
Terek Grozny,7666,6,7,5,8,20,26,-6,26
Din Moscow,7666,7,6,6,8,19,24,-5,24
FK Rubin,7666,8,5,6,9,21,18,3,21
Amkar,7666,9,5,4,11,12,24,-12,19
Rostov,7666,10,4,6,10,11,20,-9,18
Anzhi,7666,11,4,5,11,17,37,-20,17
Loko Moscow,7667,1,11,6,3,29,13,16,39
Krasnodar,7667,2,10,4,6,31,24,7,34
CSKA Moscow,7667,3,10,4,6,28,21,7,34
Zenit,7667,4,8,9,3,23,14,9,33
Spart Moscow,7667,5,9,6,5,36,28,8,33
Terek Grozny,7667,6,8,6,6,21,22,-1,30
Din Moscow,7667,7,6,7,7,19,22,-3,25
FK Rubin,7667,8,5,6,9,21,19,2,21
Rostov,7667,9,4,6,10,10,18,-8,18
Amkar,7667,10,4,6,10,10,23,-13,18
Anzhi,7667,11,2,6,12,16,40,-24,12
Loko Moscow,7668,1,13,5,2,32,11,21,44
CSKA Moscow,7668,2,11,3,6,28,20,8,36
Zenit,7668,3,8,8,4,24,14,10,32
Terek Grozny,7668,4,9,5,6,25,25,0,32
Spart Moscow,7668,5,8,7,5,36,29,7,31
Krasnodar,7668,6,8,4,8,29,29,0,28
FK Rubin,7668,7,6,6,8,24,19,5,24
Din Moscow,7668,8,5,8,7,18,22,-4,23
Rostov,7668,9,5,6,9,11,17,-6,21
Amkar,7668,10,4,5,11,12,26,-14,17
Anzhi,7668,11,2,5,13,16,43,-27,11
Loko Moscow,7669,1,12,6,2,30,11,19,42
CSKA Moscow,7669,2,11,3,6,29,21,8,36
Spart Moscow,7669,3,10,5,5,39,29,10,35
Zenit,7669,4,8,8,4,24,15,9,32
Krasnodar,7669,5,9,5,6,28,24,4,32
Terek Grozny,7669,6,7,6,7,20,23,-3,27
Din Moscow,7669,7,6,6,8,18,23,-5,24
FK Rubin,7669,8,6,5,9,23,18,5,23
Amkar,7669,9,5,4,11,11,25,-14,19
Rostov,7669,10,4,6,10,12,20,-8,18
Anzhi,7669,11,2,6,12,15,40,-25,12
Loko Moscow,7670,1,11,6,3,30,13,17,39
CSKA Moscow,7670,2,12,3,5,31,17,14,39
Krasnodar,7670,3,9,5,6,29,25,4,32
Spart Moscow,7670,4,8,7,5,33,26,7,31
Zenit,7670,5,7,9,4,22,16,6,30
Terek Grozny,7670,6,7,6,7,20,23,-3,27
FK Rubin,7670,7,6,6,8,25,19,6,24
Din Moscow,7670,8,5,7,8,18,24,-6,22
Amkar,7670,9,6,4,10,11,22,-11,22
Rostov,7670,10,4,7,9,10,17,-7,19
Anzhi,7670,11,2,6,12,14,41,-27,12
Loko Moscow,7671,1,12,5,3,33,16,17,41
CSKA Moscow,7671,2,11,3,6,29,18,11,36
Krasnodar,7671,3,9,5,6,32,25,7,32
Zenit,7671,4,8,8,4,23,17,6,32
Spart Moscow,7671,5,8,7,5,38,31,7,31
Terek Grozny,7671,6,8,5,7,23,25,-2,29
Din Moscow,7671,7,6,7,7,20,23,-3,25
FK Rubin,7671,8,5,6,9,22,19,3,21
Rostov,7671,9,5,6,9,12,18,-6,21
Amkar,7671,10,5,5,10,14,25,-11,20
Anzhi,7671,11,2,5,13,14,43,-29,11
Loko Moscow,7672,1,11,5,4,29,14,15,38
CSKA Moscow,7672,2,11,3,6,29,19,10,36
Zenit,7672,3,9,8,3,25,14,11,35
Krasnodar,7672,4,10,4,6,30,24,6,34
Spart Moscow,7672,5,8,7,5,36,29,7,31
Terek Grozny,7672,6,8,5,7,22,26,-4,29
Din Moscow,7672,7,6,7,7,21,24,-3,25
FK Rubin,7672,8,5,5,10,22,21,1,20
Rostov,7672,9,4,7,9,11,18,-7,19
Amkar,7672,10,5,4,11,11,24,-13,19
Anzhi,7672,11,3,5,12,17,40,-23,14
Loko Moscow,7673,1,12,6,2,30,11,19,42
CSKA Moscow,7673,2,11,3,6,28,22,6,36
Spart Moscow,7673,3,10,5,5,37,29,8,35
Zenit,7673,4,8,8,4,25,15,10,32
Krasnodar,7673,5,9,5,6,29,25,4,32
Terek Grozny,7673,6,8,5,7,22,23,-1,29
Din Moscow,7673,7,6,7,7,21,23,-2,25
FK Rubin,7673,8,5,6,9,23,20,3,21
Amkar,7673,9,5,4,11,10,23,-13,19
Rostov,7673,10,4,6,10,11,19,-8,18
Anzhi,7673,11,2,5,13,15,41,-26,11
Loko Moscow,7674,1,13,5,2,35,13,22,44
Spart Moscow,7674,2,11,5,4,44,30,14,38
CSKA Moscow,7674,3,11,4,5,29,18,11,37
Zenit,7674,4,7,9,4,22,16,6,30
Terek Grozny,7674,5,8,6,6,23,23,0,30
Krasnodar,7674,6,8,5,7,28,27,1,29
FK Rubin,7674,7,6,6,8,22,17,5,24
Din Moscow,7674,8,5,6,9,21,27,-6,21
Rostov,7674,9,4,6,10,11,20,-9,18
Amkar,7674,10,4,5,11,10,26,-16,17
Anzhi,7674,11,2,5,13,15,43,-28,11
Loko Moscow,7675,1,13,5,2,33,13,20,44
CSKA Moscow,7675,2,11,3,6,28,19,9,36
Zenit,7675,3,8,8,4,23,15,8,32
Krasnodar,7675,4,9,4,7,30,27,3,31
Spart Moscow,7675,5,8,6,6,34,29,5,30
Din Moscow,7675,6,7,6,7,20,22,-2,27
Terek Grozny,7675,7,7,5,8,20,25,-5,26
Amkar,7675,8,6,4,10,12,22,-10,22
FK Rubin,7675,9,5,5,10,22,20,2,20
Rostov,7675,10,4,7,9,10,17,-7,19
Anzhi,7675,11,3,5,12,17,40,-23,14
Loko Moscow,7676,1,12,5,3,31,14,17,41
CSKA Moscow,7676,2,11,4,5,27,18,9,37
Krasnodar,7676,3,10,4,6,31,25,6,34
Spart Moscow,7676,4,9,6,5,36,28,8,33
Zenit,7676,5,7,8,5,22,16,6,29
Terek Grozny,7676,6,7,5,8,21,25,-4,26
Din Moscow,7676,7,6,6,8,19,23,-4,24
FK Rubin,7676,8,6,5,9,22,18,4,23
Amkar,7676,9,5,5,10,12,24,-12,20
Rostov,7676,10,4,6,10,10,18,-8,18
Anzhi,7676,11,3,6,11,15,37,-22,15
Loko Moscow,7677,1,13,5,2,33,11,22,44
Spart Moscow,7677,2,11,5,4,39,26,13,38
CSKA Moscow,7677,3,10,4,6,26,19,7,34
Zenit,7677,4,8,8,4,22,15,7,32
Krasnodar,7677,5,8,4,8,27,29,-2,28
Terek Grozny,7677,6,7,6,7,21,26,-5,27
Din Moscow,7677,7,6,6,8,20,24,-4,24
FK Rubin,7677,8,6,5,9,25,19,6,23
Amkar,7677,9,5,4,11,12,23,-11,19
Rostov,7677,10,4,6,10,10,20,-10,18
Anzhi,7677,11,2,7,11,16,39,-23,13
Loko Moscow,7678,1,12,5,3,31,12,19,41
Spart Moscow,7678,2,10,6,4,40,26,14,36
CSKA Moscow,7678,3,10,4,6,25,18,7,34
Krasnodar,7678,4,9,5,6,28,24,4,32
Zenit,7678,5,7,9,4,21,15,6,30
Terek Grozny,7678,6,8,5,7,25,26,-1,29
FK Rubin,7678,7,6,6,8,23,18,5,24
Din Moscow,7678,8,5,7,8,19,24,-5,22
Amkar,7678,9,5,4,11,11,26,-15,19
Rostov,7678,10,4,6,10,10,20,-10,18
Anzhi,7678,11,3,5,12,17,41,-24,14
Loko Moscow,7679,1,12,5,3,31,14,17,41
Spart Moscow,7679,2,10,6,4,37,26,11,36
CSKA Moscow,7679,3,11,3,6,30,20,10,36
Zenit,7679,4,9,8,3,25,14,11,35
Krasnodar,7679,5,9,4,7,30,26,4,31
Terek Grozny,7679,6,7,7,6,23,25,-2,28
Din Moscow,7679,7,5,7,8,17,23,-6,22
FK Rubin,7679,8,5,6,9,21,19,2,21
Rostov,7679,9,4,6,10,10,18,-8,18
Amkar,7679,10,4,6,10,12,25,-13,18
Anzhi,7679,11,2,6,12,16,42,-26,12
Loko Moscow,7680,1,12,5,3,31,14,17,41
CSKA Moscow,7680,2,11,4,5,27,17,10,37
Spart Moscow,7680,3,9,6,5,39,30,9,33
Krasnodar,7680,4,9,5,6,31,26,5,32
Zenit,7680,5,7,9,4,21,14,7,30
Terek Grozny,7680,6,7,7,6,21,23,-2,28
FK Rubin,7680,7,6,6,8,24,18,6,24
Din Moscow,7680,8,5,7,8,18,24,-6,22
Rostov,7680,9,5,6,9,14,19,-5,21
Amkar,7680,10,4,5,11,10,26,-16,17
Anzhi,7680,11,2,6,12,14,39,-25,12
Loko Moscow,7681,1,11,7,2,29,11,18,40
Spart Moscow,7681,2,10,6,4,35,25,10,36
CSKA Moscow,7681,3,11,3,6,26,18,8,36
Zenit,7681,4,8,9,3,22,13,9,33
Krasnodar,7681,5,9,5,6,28,24,4,32
Terek Grozny,7681,6,8,6,6,24,25,-1,30
Din Moscow,7681,7,6,6,8,18,22,-4,24
FK Rubin,7681,8,5,5,10,21,19,2,20
Rostov,7681,9,4,7,9,10,17,-7,19
Amkar,7681,10,4,5,11,10,24,-14,17
Anzhi,7681,11,2,5,13,16,41,-25,11
Loko Moscow,7682,1,12,6,2,31,11,20,42
CSKA Moscow,7682,2,11,3,6,28,19,9,36
Zenit,7682,3,8,9,3,23,14,9,33
Krasnodar,7682,4,9,4,7,28,26,2,31
Spart Moscow,7682,5,8,5,7,35,34,1,29
Terek Grozny,7682,6,7,7,6,21,23,-2,28
Din Moscow,7682,7,7,6,7,22,23,-1,27
Rostov,7682,8,5,6,9,13,18,-5,21
FK Rubin,7682,9,5,5,10,22,21,1,20
Amkar,7682,10,5,5,10,13,22,-9,20
Anzhi,7682,11,2,6,12,15,40,-25,12
Loko Moscow,7683,1,11,7,2,31,13,18,40
Spart Moscow,7683,2,11,5,4,41,27,14,38
CSKA Moscow,7683,3,11,4,5,27,17,10,37
Zenit,7683,4,7,9,4,22,16,6,30
Krasnodar,7683,5,8,5,7,28,26,2,29
Terek Grozny,7683,6,7,7,6,21,23,-2,28
Din Moscow,7683,7,6,6,8,21,25,-4,24
FK Rubin,7683,8,6,5,9,24,20,4,23
Rostov,7683,9,4,6,10,10,20,-10,18
Amkar,7683,10,4,5,11,11,26,-15,17
Anzhi,7683,11,2,7,11,14,37,-23,13
Loko Moscow,7684,1,12,5,3,31,15,16,41
CSKA Moscow,7684,2,11,3,6,26,18,8,36
Krasnodar,7684,3,10,4,6,33,25,8,34
Spart Moscow,7684,4,8,8,4,36,28,8,32
Zenit,7684,5,8,8,4,23,15,8,32
Terek Grozny,7684,6,8,6,6,22,23,-1,30
Din Moscow,7684,7,6,7,7,20,21,-1,25
FK Rubin,7684,8,5,5,10,22,23,-1,20
Rostov,7684,9,4,7,9,12,19,-7,19
Amkar,7684,10,4,5,11,11,25,-14,17
Anzhi,7684,11,2,6,12,14,38,-24,12
Loko Moscow,7685,1,12,6,2,31,12,19,42
CSKA Moscow,7685,2,11,4,5,27,17,10,37
Spart Moscow,7685,3,9,7,4,39,27,12,34
Zenit,7685,4,7,9,4,21,14,7,30
Krasnodar,7685,5,8,6,6,30,27,3,30
Terek Grozny,7685,6,7,5,8,22,26,-4,26
Din Moscow,7685,7,6,6,8,20,25,-5,24
FK Rubin,7685,8,5,6,9,23,22,1,21
Amkar,7685,9,5,5,10,13,25,-12,20
Rostov,7685,10,4,7,9,10,17,-7,19
Anzhi,7685,11,3,5,12,16,40,-24,14
Loko Moscow,7686,1,12,5,3,32,14,18,41
CSKA Moscow,7686,2,11,4,5,27,18,9,37
Krasnodar,7686,3,10,4,6,31,26,5,34
Spart Moscow,7686,4,9,6,5,38,30,8,33
Zenit,7686,5,7,9,4,23,16,7,30
Terek Grozny,7686,6,7,5,8,22,26,-4,26
Din Moscow,7686,7,6,6,8,21,24,-3,24
Rostov,7686,8,5,6,9,12,17,-5,21
FK Rubin,7686,9,5,5,10,22,22,0,20
Amkar,7686,10,5,5,10,13,25,-12,20
Anzhi,7686,11,3,5,12,16,39,-23,14
Loko Moscow,7687,1,12,5,3,31,13,18,41
CSKA Moscow,7687,2,11,3,6,28,18,10,36
Zenit,7687,3,9,8,3,24,14,10,35
Spart Moscow,7687,4,10,5,5,37,29,8,35
Terek Grozny,7687,5,9,5,6,24,22,2,32
Krasnodar,7687,6,9,4,7,30,26,4,31
Din Moscow,7687,7,7,6,7,25,23,2,27
FK Rubin,7687,8,5,5,10,23,24,-1,20
Rostov,7687,9,4,6,10,10,18,-8,18
Amkar,7687,10,4,4,12,9,26,-17,16
Anzhi,7687,11,2,5,13,14,42,-28,11
Loko Moscow,7688,1,12,5,3,33,12,21,41
Spart Moscow,7688,2,11,5,4,43,26,17,38
Krasnodar,7688,3,10,4,6,31,25,6,34
CSKA Moscow,7688,4,10,4,6,27,21,6,34
Zenit,7688,5,8,8,4,25,19,6,32
Terek Grozny,7688,6,7,7,6,21,23,-2,28
Din Moscow,7688,7,6,6,8,19,29,-10,24
FK Rubin,7688,8,5,5,10,22,21,1,20
Rostov,7688,9,4,6,10,10,18,-8,18
Amkar,7688,10,4,5,11,9,23,-14,17
Anzhi,7688,11,2,7,11,15,38,-23,13
Loko Moscow,7689,1,12,6,2,32,12,20,42
CSKA Moscow,7689,2,11,4,5,28,17,11,37
Spart Moscow,7689,3,9,5,6,38,29,9,32
Zenit,7689,4,7,9,4,21,15,6,30
Krasnodar,7689,5,8,5,7,28,26,2,29
Terek Grozny,7689,6,8,5,7,21,26,-5,29
FK Rubin,7689,7,7,5,8,24,18,6,26
Din Moscow,7689,8,6,6,8,21,25,-4,24
Amkar,7689,9,5,4,11,10,23,-13,19
Rostov,7689,10,4,6,10,10,20,-10,18
Anzhi,7689,11,3,5,12,18,40,-22,14
Loko Moscow,7690,1,11,7,2,31,13,18,40
Spart Moscow,7690,2,11,5,4,42,29,13,38
Zenit,7690,3,8,9,3,25,15,10,33
CSKA Moscow,7690,4,10,3,7,26,21,5,33
Krasnodar,7690,5,8,5,7,30,28,2,29
Terek Grozny,7690,6,7,6,7,22,27,-5,27
Din Moscow,7690,7,6,6,8,21,25,-4,24
FK Rubin,7690,8,6,5,9,24,21,3,23
Rostov,7690,9,4,6,10,11,20,-9,18
Amkar,7690,10,4,5,11,12,26,-14,17
Anzhi,7690,11,4,5,11,18,37,-19,17
Loko Moscow,7691,1,13,5,2,34,14,20,44
Spart Moscow,7691,2,10,6,4,40,30,10,36
CSKA Moscow,7691,3,10,4,6,25,18,7,34
Zenit,7691,4,8,8,4,24,16,8,32
Krasnodar,7691,5,9,4,7,30,26,4,31
Terek Grozny,7691,6,8,5,7,21,27,-6,29
Din Moscow,7691,7,6,6,8,20,24,-4,24
FK Rubin,7691,8,5,5,10,21,20,1,20
Amkar,7691,9,5,5,10,16,24,-8,20
Rostov,7691,10,4,6,10,11,19,-8,18
Anzhi,7691,11,2,6,12,14,38,-24,12
Loko Moscow,7692,1,12,5,3,34,13,21,41
CSKA Moscow,7692,2,11,3,6,27,19,8,36
Spart Moscow,7692,3,9,7,4,34,25,9,34
Zenit,7692,4,8,8,4,23,18,5,32
Krasnodar,7692,5,9,4,7,29,26,3,31
Terek Grozny,7692,6,8,5,7,22,24,-2,29
FK Rubin,7692,7,6,6,8,22,17,5,24
Din Moscow,7692,8,5,8,7,17,21,-4,23
Rostov,7692,9,4,7,9,10,17,-7,19
Amkar,7692,10,5,4,11,10,23,-13,19
Anzhi,7692,11,2,5,13,15,40,-25,11
Loko Moscow,7693,1,12,5,3,31,14,17,41
Zenit,7693,2,9,8,3,26,14,12,35
CSKA Moscow,7693,3,10,4,6,26,20,6,34
Spart Moscow,7693,4,9,6,5,35,27,8,33
Krasnodar,7693,5,8,5,7,28,26,2,29
Terek Grozny,7693,6,8,5,7,23,25,-2,29
Din Moscow,7693,7,5,8,7,18,22,-4,23
FK Rubin,7693,8,5,7,8,22,18,4,22
Amkar,7693,9,5,4,11,10,23,-13,19
Rostov,7693,10,4,6,10,11,19,-8,18
Anzhi,7693,11,3,6,11,17,39,-22,15
Loko Moscow,7694,1,12,6,2,30,11,19,42
Spart Moscow,7694,2,11,5,4,38,25,13,38
Zenit,7694,3,8,9,3,24,14,10,33
CSKA Moscow,7694,4,10,3,7,28,23,5,33
Krasnodar,7694,5,9,4,7,30,25,5,31
Terek Grozny,7694,6,8,6,6,22,23,-1,30
Din Moscow,7694,7,5,7,8,18,24,-6,22
FK Rubin,7694,8,5,6,9,22,21,1,21
Rostov,7694,9,4,6,10,10,18,-8,18
Amkar,7694,10,4,5,11,10,25,-15,17
Anzhi,7694,11,3,5,12,17,40,-23,14
Loko Moscow,7695,1,11,7,2,31,13,18,40
CSKA Moscow,7695,2,11,4,5,30,21,9,37
Terek Grozny,7695,3,9,5,6,24,23,1,32
Zenit,7695,4,7,9,4,23,16,7,30
Spart Moscow,7695,5,8,6,6,35,29,6,30
Krasnodar,7695,6,8,6,6,30,27,3,30
Din Moscow,7695,7,6,7,7,19,22,-3,25
FK Rubin,7695,8,5,7,8,22,18,4,22
Rostov,7695,9,5,6,9,11,17,-6,21
Amkar,7695,10,4,5,11,11,25,-14,17
Anzhi,7695,11,2,6,12,16,41,-25,12
Loko Moscow,7696,1,12,6,2,31,12,19,42
CSKA Moscow,7696,2,11,4,5,28,17,11,37
Spart Moscow,7696,3,10,5,5,41,28,13,35
Zenit,7696,4,7,10,3,22,14,8,31
Krasnodar,7696,5,9,4,7,30,26,4,31
Terek Grozny,7696,6,8,5,7,24,23,1,29
Din Moscow,7696,7,5,7,8,19,28,-9,22
FK Rubin,7696,8,5,6,9,23,21,2,21
Amkar,7696,9,5,4,11,11,26,-15,19
Rostov,7696,10,4,6,10,10,19,-9,18
Anzhi,7696,11,3,5,12,15,40,-25,14
Loko Moscow,7697,1,11,7,2,32,14,18,40
Spart Moscow,7697,2,10,6,4,41,28,13,36
CSKA Moscow,7697,3,11,3,6,29,22,7,36
Zenit,7697,4,8,9,3,27,17,10,33
Krasnodar,7697,5,8,5,7,28,26,2,29
Terek Grozny,7697,6,7,5,8,21,27,-6,26
FK Rubin,7697,7,6,6,8,22,17,5,24
Din Moscow,7697,8,5,7,8,17,23,-6,22
Amkar,7697,9,5,5,10,14,25,-11,20
Rostov,7697,10,4,6,10,10,20,-10,18
Anzhi,7697,11,3,5,12,18,40,-22,14
Loko Moscow,7698,1,12,5,3,32,13,19,41
CSKA Moscow,7698,2,11,4,5,28,19,9,37
Spart Moscow,7698,3,10,5,5,43,30,13,35
Zenit,7698,4,8,8,4,22,14,8,32
Terek Grozny,7698,5,8,6,6,25,25,0,30
Krasnodar,7698,6,8,4,8,28,28,0,28
FK Rubin,7698,7,7,5,8,24,17,7,26
Din Moscow,7698,8,5,6,9,18,28,-10,21
Amkar,7698,9,5,5,10,16,27,-11,20
Rostov,7698,10,4,6,10,10,20,-10,18
Anzhi,7698,11,2,6,12,16,41,-25,12
Loko Moscow,7699,1,11,6,3,29,12,17,39
CSKA Moscow,7699,2,10,4,6,26,19,7,34
Zenit,7699,3,8,9,3,22,13,9,33
Spart Moscow,7699,4,8,8,4,36,28,8,32
Krasnodar,7699,5,9,4,7,28,26,2,31
Terek Grozny,7699,6,7,5,8,21,31,-10,26
Din Moscow,7699,7,6,7,7,19,21,-2,25
FK Rubin,7699,8,6,5,9,23,19,4,23
Amkar,7699,9,5,5,10,14,23,-9,20
Rostov,7699,10,4,7,9,12,19,-7,19
Anzhi,7699,11,3,6,11,20,39,-19,15
Loko Moscow,7700,1,11,6,3,29,13,16,39
CSKA Moscow,7700,2,11,4,5,27,17,10,37
Spart Moscow,7700,3,9,6,5,38,29,9,33
Zenit,7700,4,7,10,3,21,13,8,31
Krasnodar,7700,5,9,4,7,29,25,4,31
Terek Grozny,7700,6,7,6,7,20,26,-6,27
Din Moscow,7700,7,6,7,7,21,22,-1,25
FK Rubin,7700,8,6,5,9,22,20,2,23
Amkar,7700,9,5,5,10,11,23,-12,20
Rostov,7700,10,4,6,10,11,20,-9,18
Anzhi,7700,11,3,5,12,18,39,-21,14
Loko Moscow,7701,1,12,5,3,33,13,20,41
CSKA Moscow,7701,2,11,3,6,26,19,7,36
Zenit,7701,3,9,8,3,24,13,11,35
Spart Moscow,7701,4,8,7,5,36,29,7,31
Terek Grozny,7701,5,8,5,7,23,25,-2,29
Krasnodar,7701,6,8,4,8,30,31,-1,28
Din Moscow,7701,7,6,7,7,19,22,-3,25
FK Rubin,7701,8,6,6,8,24,19,5,24
Rostov,7701,9,4,7,9,12,19,-7,19
Amkar,7701,10,4,5,11,9,24,-15,17
Anzhi,7701,11,3,5,12,17,39,-22,14
Loko Moscow,7702,1,11,6,3,30,14,16,39
CSKA Moscow,7702,2,11,3,6,32,23,9,36
Spart Moscow,7702,3,10,5,5,40,29,11,35
Krasnodar,7702,4,10,4,6,34,27,7,34
Zenit,7702,5,8,9,3,25,15,10,33
Terek Grozny,7702,6,9,5,6,25,24,1,32
FK Rubin,7702,7,6,5,9,26,21,5,23
Din Moscow,7702,8,5,6,9,19,27,-8,21
Amkar,7702,9,5,4,11,11,25,-14,19
Rostov,7702,10,4,6,10,11,21,-10,18
Anzhi,7702,11,2,5,13,17,44,-27,11
Loko Moscow,7703,1,13,5,2,32,11,21,44
CSKA Moscow,7703,2,10,4,6,25,18,7,34
Spart Moscow,7703,3,9,6,5,36,28,8,33
Zenit,7703,4,8,8,4,22,15,7,32
Terek Grozny,7703,5,8,6,6,23,24,-1,30
Krasnodar,7703,6,8,4,8,29,28,1,28
FK Rubin,7703,7,7,5,8,26,20,6,26
Din Moscow,7703,8,5,6,9,19,26,-7,21
Rostov,7703,9,4,7,9,10,17,-7,19
Amkar,7703,10,5,4,11,12,24,-12,19
Anzhi,7703,11,2,7,11,15,38,-23,13
Loko Moscow,7704,1,13,5,2,32,12,20,44
CSKA Moscow,7704,2,11,3,6,27,18,9,36
Spart Moscow,7704,3,9,7,4,36,26,10,34
Zenit,7704,4,8,8,4,22,14,8,32
Krasnodar,7704,5,9,4,7,31,27,4,31
Terek Grozny,7704,6,8,6,6,22,22,0,30
Din Moscow,7704,7,6,7,7,21,21,0,25
FK Rubin,7704,8,5,5,10,22,24,-2,20
Rostov,7704,9,4,6,10,10,19,-9,18
Amkar,7704,10,4,6,10,10,23,-13,18
Anzhi,7704,11,2,5,13,14,41,-27,11
Loko Moscow,7705,1,13,5,2,33,13,20,44
CSKA Moscow,7705,2,11,4,5,27,18,9,37
Spart Moscow,7705,3,9,7,4,39,30,9,34
Krasnodar,7705,4,9,4,7,32,27,5,31
Zenit,7705,5,7,8,5,22,16,6,29
Terek Grozny,7705,6,7,6,7,22,25,-3,27
Din Moscow,7705,7,5,8,7,20,24,-4,23
FK Rubin,7705,8,5,6,9,23,22,1,21
Amkar,7705,9,5,5,10,12,24,-12,20
Rostov,7705,10,4,6,10,12,20,-8,18
Anzhi,7705,11,2,7,11,16,39,-23,13
Loko Moscow,7706,1,13,5,2,33,12,21,44
CSKA Moscow,7706,2,10,4,6,25,20,5,34
Zenit,7706,3,8,8,4,24,15,9,32
Spart Moscow,7706,4,9,5,6,36,31,5,32
Krasnodar,7706,5,9,4,7,31,27,4,31
Terek Grozny,7706,6,7,6,7,20,23,-3,27
Din Moscow,7706,7,5,7,8,20,25,-5,22
FK Rubin,7706,8,5,6,9,23,21,2,21
Rostov,7706,9,5,6,9,13,17,-4,21
Amkar,7706,10,5,5,10,10,22,-12,20
Anzhi,7706,11,3,6,11,15,37,-22,15
Loko Moscow,7707,1,12,5,3,30,15,15,41
CSKA Moscow,7707,2,11,4,5,28,19,9,37
Spart Moscow,7707,3,10,5,5,39,30,9,35
Krasnodar,7707,4,9,5,6,33,26,7,32
Zenit,7707,5,7,9,4,23,16,7,30
Terek Grozny,7707,6,8,5,7,23,25,-2,29
Din Moscow,7707,7,6,6,8,18,23,-5,24
FK Rubin,7707,8,5,6,9,23,20,3,21
Rostov,7707,9,5,6,9,14,18,-4,21
Amkar,7707,10,4,4,12,11,27,-16,16
Anzhi,7707,11,3,5,12,16,39,-23,14
Loko Moscow,7708,1,11,5,4,31,16,15,38
CSKA Moscow,7708,2,11,3,6,26,19,7,36
Zenit,7708,3,9,8,3,26,14,12,35
Krasnodar,7708,4,10,4,6,32,25,7,34
Spart Moscow,7708,5,9,6,5,35,27,8,33
Terek Grozny,7708,6,8,6,6,22,23,-1,30
FK Rubin,7708,7,6,5,9,22,20,2,23
Din Moscow,7708,8,5,6,9,18,24,-6,21
Rostov,7708,9,5,6,9,11,17,-6,21
Amkar,7708,10,4,6,10,9,22,-13,18
Anzhi,7708,11,2,5,13,15,40,-25,11
Loko Moscow,7709,1,13,5,2,33,12,21,44
CSKA Moscow,7709,2,11,4,5,28,18,10,37
Spart Moscow,7709,3,10,6,4,38,26,12,36
Krasnodar,7709,4,9,4,7,29,26,3,31
Zenit,7709,5,7,9,4,23,17,6,30
Terek Grozny,7709,6,7,6,7,21,26,-5,27
FK Rubin,7709,7,6,5,9,25,19,6,23
Din Moscow,7709,8,5,6,9,17,25,-8,21
Amkar,7709,9,5,5,10,13,23,-10,20
Rostov,7709,10,4,6,10,10,20,-10,18
Anzhi,7709,11,2,6,12,15,40,-25,12
Loko Moscow,7710,1,12,6,2,32,13,19,42
CSKA Moscow,7710,2,11,3,6,26,18,8,36
Spart Moscow,7710,3,9,7,4,40,29,11,34
Zenit,7710,4,8,8,4,22,14,8,32
Krasnodar,7710,5,8,5,7,30,30,0,29
Terek Grozny,7710,6,7,6,7,20,23,-3,27
Din Moscow,7710,7,6,7,7,23,24,-1,25
FK Rubin,7710,8,6,5,9,26,22,4,23
Rostov,7710,9,4,6,10,11,21,-10,18
Amkar,7710,10,4,6,10,10,23,-13,18
Anzhi,7710,11,3,5,12,15,38,-23,14
Loko Moscow,7711,1,11,5,4,29,15,14,38
Spart Moscow,7711,2,11,5,4,37,26,11,38
Zenit,7711,3,9,8,3,24,13,11,35
CSKA Moscow,7711,4,10,3,7,25,19,6,33
Krasnodar,7711,5,9,5,6,30,25,5,32
Terek Grozny,7711,6,9,5,6,24,24,0,32
FK Rubin,7711,7,6,6,8,25,19,6,24
Din Moscow,7711,8,5,6,9,18,25,-7,21
Rostov,7711,9,4,6,10,10,18,-8,18
Amkar,7711,10,4,4,12,11,26,-15,16
Anzhi,7711,11,3,5,12,16,39,-23,14
Loko Moscow,7712,1,13,5,2,33,11,22,44
CSKA Moscow,7712,2,11,4,5,30,18,12,37
Spart Moscow,7712,3,10,6,4,36,26,10,36
Zenit,7712,4,7,9,4,22,17,5,30
Krasnodar,7712,5,8,4,8,28,27,1,28
Terek Grozny,7712,6,7,5,8,21,27,-6,26
Din Moscow,7712,7,6,6,8,18,22,-4,24
FK Rubin,7712,8,6,5,9,23,19,4,23
Rostov,7712,9,4,7,9,11,18,-7,19
Amkar,7712,10,5,4,11,12,24,-12,19
Anzhi,7712,11,3,5,12,16,41,-25,14
Loko Moscow,7713,1,12,5,3,32,15,17,41
CSKA Moscow,7713,2,12,3,5,27,17,10,39
Spart Moscow,7713,3,9,6,5,38,29,9,33
Krasnodar,7713,4,9,4,7,31,27,4,31
Zenit,7713,5,7,8,5,22,16,6,29
Terek Grozny,7713,6,7,6,7,21,24,-3,27
Din Moscow,7713,7,6,7,7,20,22,-2,25
FK Rubin,7713,8,6,6,8,23,18,5,24
Rostov,7713,9,4,7,9,11,18,-7,19
Amkar,7713,10,4,5,11,10,26,-16,17
Anzhi,7713,11,3,5,12,15,38,-23,14
Loko Moscow,7714,1,11,5,4,29,13,16,38
CSKA Moscow,7714,2,11,3,6,27,19,8,36
Krasnodar,7714,3,10,4,6,31,25,6,34
Zenit,7714,4,8,8,4,22,14,8,32
Spart Moscow,7714,5,9,5,6,38,31,7,32
Terek Grozny,7714,6,8,5,7,23,25,-2,29
Din Moscow,7714,7,6,6,8,21,23,-2,24
FK Rubin,7714,8,6,5,9,23,20,3,23
Amkar,7714,9,6,4,10,13,23,-10,22
Rostov,7714,10,4,6,10,10,20,-10,18
Anzhi,7714,11,3,5,12,17,41,-24,14
Loko Moscow,7715,1,12,5,3,32,14,18,41
CSKA Moscow,7715,2,11,3,6,27,20,7,36
Zenit,7715,3,9,8,3,26,14,12,35
Spart Moscow,7715,4,10,5,5,38,28,10,35
Terek Grozny,7715,5,9,5,6,25,23,2,32
Krasnodar,7715,6,9,4,7,30,27,3,31
FK Rubin,7715,7,6,5,9,24,19,5,23
Din Moscow,7715,8,5,6,9,17,25,-8,21
Amkar,7715,9,5,4,11,11,24,-13,19
Rostov,7715,10,4,6,10,12,20,-8,18
Anzhi,7715,11,2,5,13,14,42,-28,11
Loko Moscow,7716,1,12,6,2,33,14,19,42
CSKA Moscow,7716,2,11,4,5,27,18,9,37
Spart Moscow,7716,3,10,5,5,38,27,11,35
Krasnodar,7716,4,9,5,6,30,26,4,32
Zenit,7716,5,7,8,5,23,17,6,29
Terek Grozny,7716,6,8,5,7,24,27,-3,29
Din Moscow,7716,7,5,7,8,18,23,-5,22
FK Rubin,7716,8,5,6,9,22,19,3,21
Amkar,7716,9,5,4,11,12,25,-13,19
Rostov,7716,10,4,6,10,10,20,-10,18
Anzhi,7716,11,3,6,11,18,39,-21,15
Loko Moscow,7717,1,12,6,2,32,12,20,42
Spart Moscow,7717,2,11,5,4,42,28,14,38
CSKA Moscow,7717,3,11,3,6,27,19,8,36
Krasnodar,7717,4,8,6,6,29,26,3,30
Zenit,7717,5,7,8,5,22,17,5,29
Terek Grozny,7717,6,7,5,8,21,26,-5,26
FK Rubin,7717,7,5,7,8,22,18,4,22
Din Moscow,7717,8,5,7,8,19,24,-5,22
Amkar,7717,9,5,4,11,12,25,-13,19
Rostov,7717,10,4,6,10,10,20,-10,18
Anzhi,7717,11,4,5,11,17,38,-21,17
Loko Moscow,7718,1,12,5,3,31,12,19,41
CSKA Moscow,7718,2,11,4,5,29,20,9,37
Zenit,7718,3,8,9,3,23,14,9,33
Terek Grozny,7718,4,9,5,6,26,24,2,32
Spart Moscow,7718,5,8,7,5,35,28,7,31
Krasnodar,7718,6,9,4,7,30,27,3,31
Din Moscow,7718,7,5,8,7,17,21,-4,23
FK Rubin,7718,8,5,6,9,22,20,2,21
Rostov,7718,9,5,6,9,11,17,-6,21
Amkar,7718,10,4,5,11,12,26,-14,17
Anzhi,7718,11,2,5,13,17,44,-27,11
Loko Moscow,7719,1,12,5,3,31,14,17,41
CSKA Moscow,7719,2,11,3,6,27,18,9,36
Zenit,7719,3,9,8,3,25,14,11,35
Spart Moscow,7719,4,8,7,5,38,31,7,31
Krasnodar,7719,5,9,4,7,28,25,3,31
Terek Grozny,7719,6,8,5,7,23,23,0,29
FK Rubin,7719,7,6,5,9,23,18,5,23
Din Moscow,7719,8,5,7,8,20,26,-6,22
Amkar,7719,9,6,4,10,12,23,-11,22
Rostov,7719,10,4,7,9,11,18,-7,19
Anzhi,7719,11,2,5,13,14,42,-28,11
Loko Moscow,7720,1,13,5,2,31,11,20,44
CSKA Moscow,7720,2,11,4,5,29,18,11,37
Spart Moscow,7720,3,10,5,5,40,27,13,35
Krasnodar,7720,4,9,4,7,32,26,6,31
Zenit,7720,5,7,9,4,21,14,7,30
Terek Grozny,7720,6,7,6,7,22,25,-3,27
Din Moscow,7720,7,5,7,8,18,26,-8,22
FK Rubin,7720,8,5,6,9,23,23,0,21
Amkar,7720,9,5,5,10,11,23,-12,20
Rostov,7720,10,4,6,10,11,20,-9,18
Anzhi,7720,11,3,5,12,17,42,-25,14
Loko Moscow,7721,1,12,5,3,30,13,17,41
Spart Moscow,7721,2,10,6,4,40,28,12,36
CSKA Moscow,7721,3,10,3,7,25,22,3,33
Zenit,7721,4,8,8,4,25,14,11,32
Krasnodar,7721,5,9,5,6,29,24,5,32
Terek Grozny,7721,6,9,5,6,27,24,3,32
FK Rubin,7721,7,6,6,8,24,19,5,24
Din Moscow,7721,8,5,6,9,20,27,-7,21
Rostov,7721,9,4,6,10,10,19,-9,18
Amkar,7721,10,4,5,11,11,28,-17,17
Anzhi,7721,11,3,5,12,17,40,-23,14
Loko Moscow,7722,1,12,5,3,33,13,20,41
CSKA Moscow,7722,2,11,3,6,26,18,8,36
Zenit,7722,3,9,8,3,24,13,11,35
Krasnodar,7722,4,9,4,7,30,28,2,31
Spart Moscow,7722,5,8,5,7,35,31,4,29
Terek Grozny,7722,6,8,5,7,24,26,-2,29
Din Moscow,7722,7,6,6,8,19,23,-4,24
FK Rubin,7722,8,6,5,9,22,20,2,23
Amkar,7722,9,6,4,10,14,24,-10,22
Rostov,7722,10,5,6,9,12,18,-6,21
Anzhi,7722,11,2,5,13,15,40,-25,11
Loko Moscow,7723,1,12,6,2,31,12,19,42
Spart Moscow,7723,2,11,5,4,45,27,18,38
CSKA Moscow,7723,3,11,4,5,28,19,9,37
Terek Grozny,7723,4,9,5,6,25,24,1,32
Zenit,7723,5,7,10,3,24,16,8,31
Krasnodar,7723,6,9,4,7,28,25,3,31
FK Rubin,7723,7,6,5,9,23,19,4,23
Din Moscow,7723,8,5,6,9,19,29,-10,21
Rostov,7723,9,4,6,10,10,18,-8,18
Amkar,7723,10,4,4,12,11,29,-18,16
Anzhi,7723,11,2,5,13,15,41,-26,11
Loko Moscow,7724,1,11,5,4,31,16,15,38
Zenit,7724,2,9,8,3,26,15,11,35
Krasnodar,7724,3,10,4,6,31,25,6,34
CSKA Moscow,7724,4,10,4,6,26,20,6,34
Spart Moscow,7724,5,9,5,6,36,29,7,32
Terek Grozny,7724,6,7,7,6,22,24,-2,28
Din Moscow,7724,7,7,6,7,20,22,-2,27
FK Rubin,7724,8,5,5,10,21,19,2,20
Amkar,7724,9,5,5,10,12,24,-12,20
Rostov,7724,10,4,6,10,10,18,-8,18
Anzhi,7724,11,2,7,11,15,38,-23,13
Loko Moscow,7725,1,12,6,2,32,12,20,42
Spart Moscow,7725,2,9,7,4,37,27,10,34
CSKA Moscow,7725,3,10,3,7,27,21,6,33
Zenit,7725,4,8,8,4,24,17,7,32
Terek Grozny,7725,5,8,6,6,22,23,-1,30
Krasnodar,7725,6,8,5,7,28,26,2,29
FK Rubin,7725,7,7,5,8,24,17,7,26
Din Moscow,7725,8,5,7,8,19,25,-6,22
Rostov,7725,9,4,6,10,10,19,-9,18
Amkar,7725,10,4,5,11,9,23,-14,17
Anzhi,7725,11,3,6,11,16,38,-22,15
Loko Moscow,7726,1,12,6,2,30,11,19,42
Spart Moscow,7726,2,11,5,4,41,26,15,38
CSKA Moscow,7726,3,11,4,5,29,20,9,37
Krasnodar,7726,4,9,5,6,30,25,5,32
Zenit,7726,5,7,9,4,22,15,7,30
Terek Grozny,7726,6,7,5,8,20,24,-4,26
Din Moscow,7726,7,6,6,8,22,25,-3,24
FK Rubin,7726,8,5,5,10,22,24,-2,20
Amkar,7726,9,5,4,11,10,23,-13,19
Rostov,7726,10,4,6,10,10,20,-10,18
Anzhi,7726,11,3,5,12,17,40,-23,14
Loko Moscow,7727,1,12,6,2,34,12,22,42
Spart Moscow,7727,2,11,5,4,39,27,12,38
CSKA Moscow,7727,3,11,4,5,27,18,9,37
Zenit,7727,4,7,9,4,23,19,4,30
Krasnodar,7727,5,8,5,7,28,26,2,29
Terek Grozny,7727,6,7,5,8,22,27,-5,26
Din Moscow,7727,7,6,6,8,19,23,-4,24
FK Rubin,7727,8,6,5,9,23,19,4,23
Amkar,7727,9,5,4,11,12,25,-13,19
Rostov,7727,10,4,6,10,10,19,-9,18
Anzhi,7727,11,3,5,12,17,39,-22,14
Loko Moscow,7728,1,12,5,3,32,14,18,41
CSKA Moscow,7728,2,12,3,5,29,18,11,39
Spart Moscow,7728,3,9,6,5,36,28,8,33
Krasnodar,7728,4,9,4,7,30,27,3,31
Zenit,7728,5,7,8,5,21,16,5,29
Terek Grozny,7728,6,8,5,7,23,24,-1,29
FK Rubin,7728,7,7,5,8,25,17,8,26
Amkar,7728,8,6,4,10,13,24,-11,22
Din Moscow,7728,9,5,6,9,18,25,-7,21
Rostov,7728,10,4,7,9,10,17,-7,19
Anzhi,7728,11,2,5,13,15,42,-27,11
Loko Moscow,7729,1,12,6,2,34,14,20,42
CSKA Moscow,7729,2,11,4,5,31,20,11,37
Spart Moscow,7729,3,9,6,5,41,32,9,33
Krasnodar,7729,4,9,5,6,34,26,8,32
Terek Grozny,7729,5,9,5,6,23,22,1,32
Zenit,7729,6,7,9,4,24,18,6,30
Din Moscow,7729,7,6,6,8,21,25,-4,24
Rostov,7729,8,5,6,9,12,18,-6,21
FK Rubin,7729,9,5,5,10,21,24,-3,20
Amkar,7729,10,4,5,11,12,26,-14,17
Anzhi,7729,11,2,5,13,15,43,-28,11
Loko Moscow,7730,1,12,5,3,31,13,18,41
CSKA Moscow,7730,2,11,4,5,27,17,10,37
Spart Moscow,7730,3,10,5,5,38,29,9,35
Zenit,7730,4,8,9,3,23,14,9,33
Krasnodar,7730,5,8,4,8,27,26,1,28
Terek Grozny,7730,6,7,7,6,22,24,-2,28
FK Rubin,7730,7,6,6,8,23,18,5,24
Din Moscow,7730,8,5,7,8,19,25,-6,22
Amkar,7730,9,5,5,10,12,23,-11,20
Rostov,7730,10,4,6,10,11,19,-8,18
Anzhi,7730,11,2,6,12,15,40,-25,12
Loko Moscow,7731,1,12,6,2,32,13,19,42
CSKA Moscow,7731,2,10,5,5,25,17,8,35
Zenit,7731,3,7,10,3,23,15,8,31
Spart Moscow,7731,4,8,7,5,35,28,7,31
Krasnodar,7731,5,9,4,7,30,26,4,31
Terek Grozny,7731,6,8,5,7,22,24,-2,29
Din Moscow,7731,7,6,7,7,20,23,-3,25
FK Rubin,7731,8,5,6,9,24,22,2,21
Rostov,7731,9,4,7,9,11,18,-7,19
Amkar,7731,10,4,5,11,10,24,-14,17
Anzhi,7731,11,3,6,11,16,38,-22,15
Loko Moscow,7732,1,11,6,3,32,15,17,39
Spart Moscow,7732,2,10,6,4,39,26,13,36
CSKA Moscow,7732,3,11,3,6,28,19,9,36
Zenit,7732,4,9,8,3,25,15,10,35
Krasnodar,7732,5,8,5,7,29,27,2,29
Terek Grozny,7732,6,7,5,8,23,28,-5,26
Din Moscow,7732,7,6,6,8,19,25,-6,24
FK Rubin,7732,8,6,5,9,22,19,3,23
Rostov,7732,9,4,7,9,10,17,-7,19
Amkar,7732,10,5,4,11,12,25,-13,19
Anzhi,7732,11,3,5,12,18,41,-23,14
Loko Moscow,7733,1,12,6,2,31,12,19,42
CSKA Moscow,7733,2,12,3,5,33,19,14,39
Spart Moscow,7733,3,10,5,5,36,28,8,35
Krasnodar,7733,4,9,4,7,30,27,3,31
Zenit,7733,5,7,9,4,21,15,6,30
Terek Grozny,7733,6,8,5,7,22,25,-3,29
Din Moscow,7733,7,6,6,8,22,23,-1,24
FK Rubin,7733,8,5,5,10,22,23,-1,20
Amkar,7733,9,5,4,11,11,24,-13,19
Rostov,7733,10,4,6,10,10,18,-8,18
Anzhi,7733,11,3,5,12,19,43,-24,14
Loko Moscow,7734,1,12,6,2,33,13,20,42
Spart Moscow,7734,2,11,5,4,39,25,14,38
CSKA Moscow,7734,3,11,3,6,29,19,10,36
Zenit,7734,4,8,9,3,23,14,9,33
Terek Grozny,7734,5,8,6,6,25,24,1,30
Krasnodar,7734,6,8,5,7,29,28,1,29
FK Rubin,7734,7,5,7,8,23,19,4,22
Din Moscow,7734,8,5,7,8,18,24,-6,22
Rostov,7734,9,4,6,10,10,19,-9,18
Amkar,7734,10,4,5,11,10,25,-15,17
Anzhi,7734,11,2,5,13,16,45,-29,11
Loko Moscow,7735,1,12,6,2,34,13,21,42
CSKA Moscow,7735,2,11,3,6,31,19,12,36
Spart Moscow,7735,3,9,7,4,39,30,9,34
Zenit,7735,4,8,9,3,23,14,9,33
Krasnodar,7735,5,9,4,7,31,29,2,31
Terek Grozny,7735,6,8,6,6,23,24,-1,30
Din Moscow,7735,7,6,6,8,19,23,-4,24
FK Rubin,7735,8,5,5,10,21,20,1,20
Rostov,7735,9,4,7,9,12,19,-7,19
Amkar,7735,10,4,6,10,12,25,-13,18
Anzhi,7735,11,2,5,13,15,44,-29,11
Loko Moscow,7736,1,12,6,2,30,11,19,42
CSKA Moscow,7736,2,11,3,6,29,20,9,36
Spart Moscow,7736,3,9,7,4,39,29,10,34
Zenit,7736,4,8,9,3,22,13,9,33
Krasnodar,7736,5,9,4,7,29,26,3,31
Terek Grozny,7736,6,7,5,8,20,26,-6,26
FK Rubin,7736,7,6,5,9,25,20,5,23
Din Moscow,7736,8,5,6,9,18,26,-8,21
Amkar,7736,9,5,5,10,11,23,-12,20
Rostov,7736,10,4,7,9,13,20,-7,19
Anzhi,7736,11,3,5,12,19,41,-22,14
Loko Moscow,7737,1,12,6,2,33,13,20,42
Spart Moscow,7737,2,10,6,4,40,28,12,36
CSKA Moscow,7737,3,11,3,6,28,20,8,36
Zenit,7737,4,8,8,4,25,16,9,32
Krasnodar,7737,5,8,5,7,29,27,2,29
Terek Grozny,7737,6,8,5,7,22,25,-3,29
FK Rubin,7737,7,6,6,8,23,18,5,24
Din Moscow,7737,8,5,7,8,19,24,-5,22
Amkar,7737,9,5,5,10,13,24,-11,20
Rostov,7737,10,4,6,10,10,20,-10,18
Anzhi,7737,11,2,5,13,14,41,-27,11
Loko Moscow,7738,1,12,6,2,30,11,19,42
Spart Moscow,7738,2,10,6,4,38,28,10,36
CSKA Moscow,7738,3,10,4,6,26,20,6,34
Zenit,7738,4,8,8,4,24,15,9,32
Krasnodar,7738,5,9,5,6,29,25,4,32
Terek Grozny,7738,6,8,5,7,23,24,-1,29
FK Rubin,7738,7,6,5,9,23,19,4,23
Din Moscow,7738,8,5,7,8,18,23,-5,22
Amkar,7738,9,5,4,11,11,24,-13,19
Rostov,7738,10,4,6,10,11,19,-8,18
Anzhi,7738,11,2,6,12,15,40,-25,12
Loko Moscow,7739,1,12,5,3,31,16,15,41
CSKA Moscow,7739,2,10,3,7,25,19,6,33
Zenit,7739,3,8,8,4,23,15,8,32
Krasnodar,7739,4,9,4,7,31,26,5,31
Spart Moscow,7739,5,8,5,7,36,31,5,29
Terek Grozny,7739,6,7,6,7,22,27,-5,27
Din Moscow,7739,7,6,7,7,20,23,-3,25
FK Rubin,7739,8,6,6,8,25,19,6,24
Rostov,7739,9,5,6,9,12,18,-6,21
Amkar,7739,10,5,5,10,14,26,-12,20
Anzhi,7739,11,4,5,11,18,37,-19,17
Loko Moscow,7740,1,12,5,3,31,14,17,41
CSKA Moscow,7740,2,12,3,5,28,17,11,39
Spart Moscow,7740,3,10,5,5,39,27,12,35
Krasnodar,7740,4,9,5,6,31,25,6,32
Zenit,7740,5,7,8,5,21,17,4,29
Terek Grozny,7740,6,7,6,7,21,24,-3,27
FK Rubin,7740,7,5,7,8,25,21,4,22
Din Moscow,7740,8,5,7,8,21,29,-8,22
Rostov,7740,9,5,6,9,11,17,-6,21
Amkar,7740,10,4,5,11,10,24,-14,17
Anzhi,7740,11,3,5,12,15,38,-23,14
Loko Moscow,7741,1,12,6,2,33,12,21,42
CSKA Moscow,7741,2,11,4,5,29,20,9,37
Spart Moscow,7741,3,9,6,5,41,31,10,33
Krasnodar,7741,4,9,5,6,30,26,4,32
Terek Grozny,7741,5,8,6,6,23,23,0,30
Zenit,7741,6,7,8,5,23,19,4,29
Din Moscow,7741,7,5,7,8,19,26,-7,22
FK Rubin,7741,8,5,6,9,23,20,3,21
Rostov,7741,9,5,6,9,12,18,-6,21
Amkar,7741,10,4,6,10,13,26,-13,18
Anzhi,7741,11,2,6,12,15,40,-25,12
Loko Moscow,7742,1,13,5,2,32,11,21,44
CSKA Moscow,7742,2,11,4,5,28,17,11,37
Spart Moscow,7742,3,10,6,4,41,27,14,36
Zenit,7742,4,7,8,5,21,18,3,29
Krasnodar,7742,5,8,5,7,30,28,2,29
Terek Grozny,7742,6,7,5,8,21,25,-4,26
Din Moscow,7742,7,6,6,8,20,28,-8,24
FK Rubin,7742,8,5,6,9,25,22,3,21
Rostov,7742,9,4,7,9,10,17,-7,19
Amkar,7742,10,5,4,11,11,24,-13,19
Anzhi,7742,11,3,6,11,16,38,-22,15
Loko Moscow,7743,1,12,5,3,31,14,17,41
CSKA Moscow,7743,2,11,3,6,28,20,8,36
Krasnodar,7743,3,10,4,6,34,25,9,34
Zenit,7743,4,8,8,4,24,16,8,32
Spart Moscow,7743,5,9,5,6,37,30,7,32
Din Moscow,7743,6,7,6,7,22,22,0,27
Terek Grozny,7743,7,7,6,7,21,25,-4,27
FK Rubin,7743,8,5,5,10,21,24,-3,20
Amkar,7743,9,5,5,10,12,24,-12,20
Rostov,7743,10,4,6,10,11,19,-8,18
Anzhi,7743,11,3,5,12,16,38,-22,14
Loko Moscow,7744,1,12,5,3,32,15,17,41
CSKA Moscow,7744,2,12,3,5,28,18,10,39
Spart Moscow,7744,3,9,6,5,36,27,9,33
Zenit,7744,4,8,8,4,24,15,9,32
Terek Grozny,7744,5,8,5,7,21,24,-3,29
Krasnodar,7744,6,8,4,8,29,29,0,28
Din Moscow,7744,7,6,7,7,20,23,-3,25
FK Rubin,7744,8,6,5,9,24,19,5,23
Amkar,7744,9,5,4,11,10,23,-13,19
Rostov,7744,10,4,6,10,10,19,-9,18
Anzhi,7744,11,3,5,12,16,38,-22,14
Loko Moscow,7745,1,12,5,3,32,14,18,41
CSKA Moscow,7745,2,12,3,5,30,18,12,39
Krasnodar,7745,3,10,4,6,33,27,6,34
Spart Moscow,7745,4,9,6,5,39,33,6,33
Zenit,7745,5,7,8,5,21,17,4,29
Terek Grozny,7745,6,7,5,8,21,29,-8,26
Din Moscow,7745,7,6,6,8,19,23,-4,24
Amkar,7745,8,6,4,10,17,23,-6,22
FK Rubin,7745,9,5,5,10,23,21,2,20
Rostov,7745,10,4,7,9,13,20,-7,19
Anzhi,7745,11,3,5,12,18,41,-23,14
Loko Moscow,7746,1,12,5,3,32,13,19,41
CSKA Moscow,7746,2,12,3,5,29,18,11,39
Spart Moscow,7746,3,11,5,4,39,27,12,38
Krasnodar,7746,4,10,4,6,30,25,5,34
Terek Grozny,7746,5,9,5,6,24,23,1,32
Zenit,7746,6,7,8,5,22,17,5,29
Din Moscow,7746,7,6,6,8,19,22,-3,24
FK Rubin,7746,8,5,5,10,21,20,1,20
Rostov,7746,9,4,6,10,10,19,-9,18
Amkar,7746,10,4,4,12,12,27,-15,16
Anzhi,7746,11,2,5,13,14,41,-27,11
Loko Moscow,7747,1,12,5,3,31,12,19,41
Spart Moscow,7747,2,10,5,5,37,28,9,35
CSKA Moscow,7747,3,10,5,5,27,19,8,35
Zenit,7747,4,8,9,3,22,13,9,33
Krasnodar,7747,5,9,4,7,28,26,2,31
Terek Grozny,7747,6,8,6,6,24,24,0,30
Din Moscow,7747,7,6,6,8,20,23,-3,24
FK Rubin,7747,8,6,5,9,22,18,4,23
Rostov,7747,9,4,6,10,10,19,-9,18
Amkar,7747,10,4,5,11,10,24,-14,17
Anzhi,7747,11,2,6,12,17,42,-25,12
Loko Moscow,7748,1,12,6,2,31,11,20,42
CSKA Moscow,7748,2,11,3,6,28,19,9,36
Spart Moscow,7748,3,9,6,5,36,31,5,33
Zenit,7748,4,8,8,4,23,16,7,32
Krasnodar,7748,5,9,5,6,29,24,5,32
Terek Grozny,7748,6,8,6,6,22,23,-1,30
Din Moscow,7748,7,6,7,7,19,22,-3,25
Rostov,7748,8,5,6,9,15,17,-2,21
FK Rubin,7748,9,5,5,10,21,20,1,20
Amkar,7748,10,4,5,11,10,25,-15,17
Anzhi,7748,11,2,5,13,14,40,-26,11
Loko Moscow,7749,1,13,5,2,33,12,21,44
Spart Moscow,7749,2,10,5,5,43,34,9,35
CSKA Moscow,7749,3,10,4,6,26,19,7,34
Zenit,7749,4,8,8,4,23,15,8,32
Krasnodar,7749,5,9,4,7,29,27,2,31
Terek Grozny,7749,6,7,6,7,22,25,-3,27
Din Moscow,7749,7,5,7,8,22,27,-5,22
FK Rubin,7749,8,5,6,9,23,20,3,21
Rostov,7749,9,5,6,9,14,20,-6,21
Amkar,7749,10,5,4,11,12,25,-13,19
Anzhi,7749,11,2,7,11,16,39,-23,13
Loko Moscow,7750,1,12,6,2,32,13,19,42
CSKA Moscow,7750,2,11,3,6,30,21,9,36
Spart Moscow,7750,3,10,5,5,41,30,11,35
Zenit,7750,4,8,8,4,24,16,8,32
Krasnodar,7750,5,9,5,6,33,27,6,32
Terek Grozny,7750,6,8,6,6,22,23,-1,30
Din Moscow,7750,7,6,6,8,18,24,-6,24
FK Rubin,7750,8,5,5,10,23,23,0,20
Amkar,7750,9,5,5,10,13,23,-10,20
Rostov,7750,10,4,6,10,12,22,-10,18
Anzhi,7750,11,2,5,13,16,42,-26,11
Loko Moscow,7751,1,12,6,2,31,12,19,42
CSKA Moscow,7751,2,11,3,6,27,21,6,36
Spart Moscow,7751,3,10,5,5,39,28,11,35
Zenit,7751,4,8,8,4,25,14,11,32
Krasnodar,7751,5,9,5,6,32,25,7,32
Terek Grozny,7751,6,8,5,7,22,24,-2,29
Din Moscow,7751,7,7,6,7,20,21,-1,27
FK Rubin,7751,8,5,5,10,21,23,-2,20
Amkar,7751,9,5,4,11,13,26,-13,19
Rostov,7751,10,4,6,10,10,20,-10,18
Anzhi,7751,11,2,5,13,14,40,-26,11
Loko Moscow,7752,1,11,6,3,30,13,17,39
CSKA Moscow,7752,2,11,4,5,27,17,10,37
Spart Moscow,7752,3,10,5,5,38,27,11,35
Zenit,7752,4,8,9,3,22,13,9,33
Krasnodar,7752,5,9,5,6,32,25,7,32
Terek Grozny,7752,6,7,6,7,20,23,-3,27
Din Moscow,7752,7,6,6,8,19,22,-3,24
FK Rubin,7752,8,6,5,9,22,21,1,23
Amkar,7752,9,5,4,11,10,25,-15,19
Rostov,7752,10,4,6,10,10,19,-9,18
Anzhi,7752,11,2,6,12,14,39,-25,12
Loko Moscow,7753,1,11,5,4,30,15,15,38
CSKA Moscow,7753,2,11,4,5,27,17,10,37
Zenit,7753,3,8,9,3,22,13,9,33
Spart Moscow,7753,4,9,5,6,38,32,6,32
Terek Grozny,7753,5,9,5,6,24,23,1,32
Krasnodar,7753,6,9,4,7,30,28,2,31
Din Moscow,7753,7,7,6,7,20,22,-2,27
FK Rubin,7753,8,6,5,9,24,18,6,23
Rostov,7753,9,5,6,9,13,18,-5,21
Amkar,7753,10,4,4,12,12,27,-15,16
Anzhi,7753,11,2,5,13,14,41,-27,11
Loko Moscow,7754,1,12,6,2,33,14,19,42
CSKA Moscow,7754,2,12,3,5,30,19,11,39
Spart Moscow,7754,3,8,7,5,35,28,7,31
Krasnodar,7754,4,9,4,7,31,27,4,31
Zenit,7754,5,7,9,4,23,16,7,30
Terek Grozny,7754,6,8,5,7,22,26,-4,29
Din Moscow,7754,7,6,7,7,21,24,-3,25
Amkar,7754,8,6,4,10,14,23,-9,22
FK Rubin,7754,9,5,5,10,22,21,1,20
Rostov,7754,10,4,7,9,10,17,-7,19
Anzhi,7754,11,2,5,13,15,41,-26,11
Loko Moscow,7755,1,11,7,2,30,12,18,40
CSKA Moscow,7755,2,11,3,6,30,20,10,36
Spart Moscow,7755,3,10,5,5,39,30,9,35
Zenit,7755,4,8,9,3,23,14,9,33
Krasnodar,7755,5,9,5,6,31,26,5,32
Terek Grozny,7755,6,9,5,6,25,23,2,32
Din Moscow,7755,7,6,7,7,21,24,-3,25
FK Rubin,7755,8,5,6,9,23,21,2,21
Rostov,7755,9,4,6,10,11,19,-8,18
Amkar,7755,10,4,4,12,11,26,-15,16
Anzhi,7755,11,2,5,13,15,44,-29,11
Loko Moscow,7756,1,12,5,3,30,12,18,41
CSKA Moscow,7756,2,11,4,5,32,20,12,37
Spart Moscow,7756,3,10,6,4,39,26,13,36
Zenit,7756,4,8,9,3,23,14,9,33
Krasnodar,7756,5,8,5,7,28,26,2,29
Terek Grozny,7756,6,8,5,7,21,23,-2,29
FK Rubin,7756,7,6,6,8,24,19,5,24
Din Moscow,7756,8,5,6,9,18,25,-7,21
Rostov,7756,9,4,6,10,10,20,-10,18
Amkar,7756,10,4,5,11,10,24,-14,17
Anzhi,7756,11,3,5,12,17,43,-26,14
Loko Moscow,7757,1,12,6,2,31,12,19,42
Spart Moscow,7757,2,10,6,4,37,25,12,36
CSKA Moscow,7757,3,11,3,6,27,20,7,36
Zenit,7757,4,8,9,3,23,13,10,33
Terek Grozny,7757,5,8,5,7,22,24,-2,29
Krasnodar,7757,6,8,4,8,29,28,1,28
FK Rubin,7757,7,7,5,8,25,18,7,26
Din Moscow,7757,8,5,6,9,17,24,-7,21
Rostov,7757,9,4,6,10,10,20,-10,18
Amkar,7757,10,4,5,11,9,23,-14,17
Anzhi,7757,11,3,5,12,17,40,-23,14
Loko Moscow,7758,1,12,5,3,30,13,17,41
Spart Moscow,7758,2,11,5,4,38,25,13,38
CSKA Moscow,7758,3,11,4,5,30,20,10,37
Krasnodar,7758,4,9,4,7,30,26,4,31
Zenit,7758,5,7,8,5,23,18,5,29
Terek Grozny,7758,6,7,6,7,21,24,-3,27
FK Rubin,7758,7,6,6,8,23,18,5,24
Din Moscow,7758,8,5,7,8,17,22,-5,22
Amkar,7758,9,5,4,11,11,24,-13,19
Rostov,7758,10,4,6,10,10,20,-10,18
Anzhi,7758,11,2,7,11,15,38,-23,13
Loko Moscow,7759,1,13,5,2,31,11,20,44
Spart Moscow,7759,2,11,5,4,41,27,14,38
CSKA Moscow,7759,3,11,3,6,32,21,11,36
Zenit,7759,4,8,8,4,22,14,8,32
Krasnodar,7759,5,8,5,7,28,26,2,29
Terek Grozny,7759,6,8,5,7,23,26,-3,29
FK Rubin,7759,7,6,6,8,24,19,5,24
Din Moscow,7759,8,5,6,9,18,25,-7,21
Amkar,7759,9,5,4,11,12,24,-12,19
Rostov,7759,10,4,6,10,11,21,-10,18
Anzhi,7759,11,2,5,13,19,47,-28,11
Loko Moscow,7760,1,12,6,2,34,14,20,42
CSKA Moscow,7760,2,12,3,5,34,19,15,39
Spart Moscow,7760,3,11,5,4,41,29,12,38
Krasnodar,7760,4,8,6,6,29,26,3,30
Zenit,7760,5,7,8,5,24,21,3,29
Terek Grozny,7760,6,8,5,7,22,23,-1,29
FK Rubin,7760,7,6,6,8,25,20,5,24
Din Moscow,7760,8,5,6,9,20,27,-7,21
Amkar,7760,9,5,4,11,12,25,-13,19
Rostov,7760,10,4,6,10,11,19,-8,18
Anzhi,7760,11,2,5,13,15,44,-29,11
Loko Moscow,7761,1,11,6,3,29,12,17,39
CSKA Moscow,7761,2,12,3,5,30,19,11,39
Spart Moscow,7761,3,9,7,4,37,28,9,34
Zenit,7761,4,8,8,4,24,16,8,32
Krasnodar,7761,5,9,5,6,29,24,5,32
Terek Grozny,7761,6,7,5,8,20,31,-11,26
FK Rubin,7761,7,6,5,9,24,20,4,23
Din Moscow,7761,8,5,7,8,20,26,-6,22
Amkar,7761,9,5,5,10,11,22,-11,20
Rostov,7761,10,4,6,10,11,19,-8,18
Anzhi,7761,11,3,5,12,21,39,-18,14
Loko Moscow,7762,1,12,5,3,31,13,18,41
Spart Moscow,7762,2,10,6,4,37,26,11,36
CSKA Moscow,7762,3,10,4,6,26,20,6,34
Zenit,7762,4,8,8,4,25,16,9,32
Terek Grozny,7762,5,9,5,6,24,23,1,32
Krasnodar,7762,6,9,4,7,28,25,3,31
Din Moscow,7762,7,6,6,8,19,23,-4,24
FK Rubin,7762,8,6,5,9,22,19,3,23
Rostov,7762,9,4,7,9,11,18,-7,19
Amkar,7762,10,4,4,12,10,26,-16,16
Anzhi,7762,11,2,6,12,14,38,-24,12
Loko Moscow,7763,1,13,5,2,34,12,22,44
Spart Moscow,7763,2,10,6,4,36,26,10,36
CSKA Moscow,7763,3,10,4,6,27,22,5,34
Zenit,7763,4,8,8,4,24,16,8,32
Krasnodar,7763,5,9,4,7,32,26,6,31
Terek Grozny,7763,6,7,5,8,20,26,-6,26
Din Moscow,7763,7,5,8,7,17,21,-4,23
FK Rubin,7763,8,5,6,9,21,21,0,21
Amkar,7763,9,5,4,11,12,23,-11,19
Rostov,7763,10,4,6,10,11,19,-8,18
Anzhi,7763,11,3,6,11,17,39,-22,15
Loko Moscow,7764,1,12,6,2,31,12,19,42
CSKA Moscow,7764,2,12,3,5,29,18,11,39
Spart Moscow,7764,3,10,5,5,37,30,7,35
Krasnodar,7764,4,9,5,6,29,25,4,32
Zenit,7764,5,7,8,5,21,15,6,29
Terek Grozny,7764,6,7,6,7,21,24,-3,27
Din Moscow,7764,7,6,6,8,19,23,-4,24
Rostov,7764,8,5,6,9,14,17,-3,21
FK Rubin,7764,9,5,5,10,21,19,2,20
Amkar,7764,10,4,5,11,10,25,-15,17
Anzhi,7764,11,3,5,12,16,40,-24,14
Loko Moscow,7765,1,12,6,2,31,12,19,42
CSKA Moscow,7765,2,11,3,6,27,19,8,36
Spart Moscow,7765,3,10,5,5,46,30,16,35
Zenit,7765,4,8,9,3,24,14,10,33
Terek Grozny,7765,5,8,6,6,23,24,-1,30
Krasnodar,7765,6,8,4,8,27,27,0,28
Din Moscow,7765,7,6,6,8,22,28,-6,24
FK Rubin,7765,8,6,5,9,25,21,4,23
Amkar,7765,9,5,5,10,13,25,-12,20
Rostov,7765,10,4,6,10,11,23,-12,18
Anzhi,7765,11,2,5,13,15,41,-26,11
Loko Moscow,7766,1,11,5,4,29,15,14,38
CSKA Moscow,7766,2,11,3,6,26,19,7,36
Krasnodar,7766,3,10,4,6,29,24,5,34
Zenit,7766,4,8,8,4,24,14,10,32
Spart Moscow,7766,5,9,5,6,36,28,8,32
Terek Grozny,7766,6,8,6,6,25,22,3,30
Din Moscow,7766,7,6,7,7,18,21,-3,25
FK Rubin,7766,8,5,6,9,21,18,3,21
Rostov,7766,9,5,6,9,12,18,-6,21
Amkar,7766,10,4,5,11,9,24,-15,17
Anzhi,7766,11,3,5,12,16,42,-26,14
Loko Moscow,7767,1,13,5,2,33,12,21,44
CSKA Moscow,7767,2,11,3,6,27,19,8,36
Spart Moscow,7767,3,10,5,5,41,30,11,35
Zenit,7767,4,8,8,4,22,15,7,32
Krasnodar,7767,5,8,4,8,28,29,-1,28
Terek Grozny,7767,6,7,7,6,21,23,-2,28
FK Rubin,7767,7,7,5,8,26,18,8,26
Din Moscow,7767,8,6,6,8,21,25,-4,24
Rostov,7767,9,4,6,10,11,21,-10,18
Amkar,7767,10,4,5,11,10,24,-14,17
Anzhi,7767,11,2,6,12,16,40,-24,12
Loko Moscow,7768,1,13,5,2,32,12,20,44
Spart Moscow,7768,2,11,5,4,41,27,14,38
CSKA Moscow,7768,3,10,4,6,26,19,7,34
Krasnodar,7768,4,9,4,7,31,28,3,31
Zenit,7768,5,7,9,4,22,15,7,30
Terek Grozny,7768,6,7,6,7,22,26,-4,27
Din Moscow,7768,7,5,7,8,19,24,-5,22
FK Rubin,7768,8,5,6,9,24,21,3,21
Amkar,7768,9,5,4,11,13,26,-13,19
Rostov,7768,10,4,6,10,10,20,-10,18
Anzhi,7768,11,3,6,11,16,38,-22,15
Loko Moscow,7769,1,11,6,3,31,15,16,39
CSKA Moscow,7769,2,12,3,5,29,18,11,39
Spart Moscow,7769,3,9,6,5,38,28,10,33
Zenit,7769,4,8,8,4,24,15,9,32
Krasnodar,7769,5,8,6,6,29,26,3,30
Terek Grozny,7769,6,7,5,8,20,27,-7,26
Din Moscow,7769,7,6,6,8,19,24,-5,24
FK Rubin,7769,8,5,6,9,21,19,2,21
Rostov,7769,9,5,6,9,12,18,-6,21
Amkar,7769,10,5,5,10,12,23,-11,20
Anzhi,7769,11,3,5,12,17,39,-22,14
CSKA Moscow,7770,1,12,3,5,31,18,13,39
Loko Moscow,7770,2,11,5,4,29,14,15,38
Krasnodar,7770,3,10,4,6,31,25,6,34
Zenit,7770,4,8,8,4,23,16,7,32
Terek Grozny,7770,5,9,5,6,23,23,0,32
Spart Moscow,7770,6,8,6,6,35,29,6,30
Din Moscow,7770,7,7,6,7,21,23,-2,27
Rostov,7770,8,5,6,9,11,17,-6,21
FK Rubin,7770,9,5,5,10,23,21,2,20
Amkar,7770,10,4,5,11,11,25,-14,17
Anzhi,7770,11,2,5,13,14,41,-27,11
Loko Moscow,7771,1,12,6,2,32,13,19,42
CSKA Moscow,7771,2,11,4,5,28,18,10,37
Spart Moscow,7771,3,10,6,4,39,28,11,36
Zenit,7771,4,7,10,3,22,14,8,31
Terek Grozny,7771,5,8,6,6,23,24,-1,30
Krasnodar,7771,6,8,5,7,28,26,2,29
Din Moscow,7771,7,6,7,7,20,23,-3,25
FK Rubin,7771,8,5,6,9,22,19,3,21
Rostov,7771,9,4,6,10,10,19,-9,18
Amkar,7771,10,4,5,11,13,27,-14,17
Anzhi,7771,11,2,5,13,15,41,-26,11
Loko Moscow,7772,1,11,5,4,30,15,15,38
CSKA Moscow,7772,2,11,3,6,28,19,9,36
Zenit,7772,3,9,8,3,24,13,11,35
Spart Moscow,7772,4,10,5,5,38,29,9,35
Krasnodar,7772,5,10,4,6,32,26,6,34
Terek Grozny,7772,6,7,5,8,21,27,-6,26
FK Rubin,7772,7,6,5,9,24,20,4,23
Amkar,7772,8,6,4,10,16,24,-8,22
Din Moscow,7772,9,5,6,9,18,24,-6,21
Rostov,7772,10,4,6,10,10,19,-9,18
Anzhi,7772,11,3,5,12,16,41,-25,14
Loko Moscow,7773,1,11,7,2,30,12,18,40
Spart Moscow,7773,2,11,5,4,40,29,11,38
CSKA Moscow,7773,3,10,4,6,27,20,7,34
Zenit,7773,4,8,9,3,23,14,9,33
Terek Grozny,7773,5,9,5,6,22,22,0,32
Krasnodar,7773,6,8,5,7,30,28,2,29
Din Moscow,7773,7,6,6,8,21,25,-4,24
FK Rubin,7773,8,6,5,9,24,20,4,23
Rostov,7773,9,4,6,10,10,18,-8,18
Amkar,7773,10,4,4,12,10,25,-15,16
Anzhi,7773,11,2,6,12,15,39,-24,12
Loko Moscow,7774,1,12,5,3,31,14,17,41
CSKA Moscow,7774,2,11,4,5,31,19,12,37
Spart Moscow,7774,3,9,7,4,36,27,9,34
Zenit,7774,4,8,9,3,25,15,10,33
Terek Grozny,7774,5,8,6,6,22,23,-1,30
Krasnodar,7774,6,8,5,7,30,28,2,29
FK Rubin,7774,7,6,6,8,25,19,6,24
Din Moscow,7774,8,5,7,8,18,24,-6,22
Rostov,7774,9,4,6,10,11,19,-8,18
Amkar,7774,10,4,5,11,10,24,-14,17
Anzhi,7774,11,2,6,12,14,41,-27,12
Loko Moscow,7775,1,11,5,4,32,16,16,38
CSKA Moscow,7775,2,11,4,5,30,21,9,37
Spart Moscow,7775,3,10,6,4,41,26,15,36
Krasnodar,7775,4,10,4,6,32,27,5,34
Zenit,7775,5,8,8,4,25,17,8,32
Terek Grozny,7775,6,8,6,6,22,22,0,30
FK Rubin,7775,7,6,5,9,26,21,5,23
Din Moscow,7775,8,5,6,9,19,27,-8,21
Rostov,7775,9,4,6,10,10,22,-12,18
Amkar,7775,10,4,6,10,10,23,-13,18
Anzhi,7775,11,2,6,12,16,41,-25,12
Loko Moscow,7776,1,13,5,2,33,12,21,44
Spart Moscow,7776,2,10,6,4,40,29,11,36
CSKA Moscow,7776,3,10,3,7,25,19,6,33
Zenit,7776,4,8,8,4,23,16,7,32
Krasnodar,7776,5,9,4,7,28,25,3,31
Terek Grozny,7776,6,8,5,7,21,24,-3,29
Din Moscow,7776,7,5,8,7,21,25,-4,23
FK Rubin,7776,8,5,6,9,21,18,3,21
Amkar,7776,9,5,4,11,11,24,-13,19
Rostov,7776,10,4,6,10,10,18,-8,18
Anzhi,7776,11,3,5,12,15,38,-23,14
Loko Moscow,7777,1,12,5,3,31,14,17,41
CSKA Moscow,7777,2,11,4,5,28,18,10,37
Spart Moscow,7777,3,9,5,6,35,28,7,32
Terek Grozny,7777,4,9,5,6,22,22,0,32
Krasnodar,7777,5,9,4,7,30,26,4,31
Zenit,7777,6,7,8,5,21,17,4,29
FK Rubin,7777,7,7,5,8,24,17,7,26
Din Moscow,7777,8,5,6,9,17,23,-6,21
Rostov,7777,9,5,6,9,12,18,-6,21
Amkar,7777,10,5,4,11,10,23,-13,19
Anzhi,7777,11,2,6,12,15,39,-24,12
Loko Moscow,7778,1,11,7,2,31,13,18,40
Spart Moscow,7778,2,10,6,4,41,26,15,36
CSKA Moscow,7778,3,11,3,6,26,18,8,36
Zenit,7778,4,8,9,3,23,14,9,33
Krasnodar,7778,5,8,6,6,30,27,3,30
Terek Grozny,7778,6,8,5,7,24,25,-1,29
FK Rubin,7778,7,5,7,8,23,19,4,22
Din Moscow,7778,8,5,7,8,18,26,-8,22
Rostov,7778,9,4,6,10,10,20,-10,18
Amkar,7778,10,4,5,11,9,24,-15,17
Anzhi,7778,11,3,5,12,17,40,-23,14
Loko Moscow,7779,1,13,5,2,32,11,21,44
CSKA Moscow,7779,2,10,3,7,26,21,5,33
Zenit,7779,3,8,8,4,23,14,9,32
Spart Moscow,7779,4,8,8,4,39,31,8,32
Krasnodar,7779,5,8,4,8,30,30,0,28
Terek Grozny,7779,6,7,6,7,22,25,-3,27
FK Rubin,7779,7,7,5,8,26,20,6,26
Din Moscow,7779,8,5,7,8,18,23,-5,22
Rostov,7779,9,4,7,9,11,18,-7,19
Amkar,7779,10,4,6,10,13,26,-13,18
Anzhi,7779,11,4,5,11,19,40,-21,17
CSKA Moscow,7780,1,12,3,5,30,18,12,39
Loko Moscow,7780,2,11,5,4,30,15,15,38
Spart Moscow,7780,3,10,5,5,40,29,11,35
Krasnodar,7780,4,10,4,6,32,25,7,34
Zenit,7780,5,8,8,4,24,17,7,32
Terek Grozny,7780,6,8,6,6,21,22,-1,30
Din Moscow,7780,7,5,7,8,19,25,-6,22
FK Rubin,7780,8,5,6,9,22,21,1,21
Rostov,7780,9,5,6,9,13,17,-4,21
Amkar,7780,10,4,5,11,9,26,-17,17
Anzhi,7780,11,2,5,13,14,39,-25,11
Loko Moscow,7781,1,12,5,3,33,15,18,41
CSKA Moscow,7781,2,10,5,5,25,17,8,35
Zenit,7781,3,8,9,3,23,14,9,33
Spart Moscow,7781,4,8,6,6,38,32,6,30
Terek Grozny,7781,5,8,6,6,23,23,0,30
Krasnodar,7781,6,8,4,8,29,28,1,28
Din Moscow,7781,7,6,7,7,21,23,-2,25
FK Rubin,7781,8,6,5,9,22,19,3,23
Rostov,7781,9,5,6,9,14,20,-6,21
Amkar,7781,10,5,5,10,10,22,-12,20
Anzhi,7781,11,2,6,12,15,40,-25,12
Loko Moscow,7782,1,13,5,2,34,12,22,44
CSKA Moscow,7782,2,12,3,5,27,17,10,39
Spart Moscow,7782,3,10,5,5,41,28,13,35
Krasnodar,7782,4,9,4,7,30,28,2,31
Zenit,7782,5,7,8,5,22,17,5,29
Terek Grozny,7782,6,7,5,8,20,24,-4,26
Din Moscow,7782,7,5,7,8,20,28,-8,22
FK Rubin,7782,8,5,6,9,25,22,3,21
Rostov,7782,9,5,6,9,11,17,-6,21
Amkar,7782,10,5,4,11,11,25,-14,19
Anzhi,7782,11,3,5,12,15,38,-23,14
Loko Moscow,7783,1,12,5,3,32,13,19,41
CSKA Moscow,7783,2,11,3,6,28,21,7,36
Zenit,7783,3,9,8,3,26,14,12,35
Spart Moscow,7783,4,9,6,5,36,27,9,33
Krasnodar,7783,5,9,4,7,31,28,3,31
Terek Grozny,7783,6,8,6,6,24,25,-1,30
FK Rubin,7783,7,6,5,9,25,21,4,23
Rostov,7783,8,5,6,9,11,17,-6,21
Din Moscow,7783,9,5,6,9,19,27,-8,21
Amkar,7783,10,4,5,11,9,23,-14,17
Anzhi,7783,11,2,6,12,17,42,-25,12
Loko Moscow,7784,1,13,5,2,32,11,21,44
CSKA Moscow,7784,2,12,3,5,28,17,11,39
Spart Moscow,7784,3,9,7,4,39,29,10,34
Krasnodar,7784,4,9,4,7,30,26,4,31
Zenit,7784,5,7,8,5,21,15,6,29
Terek Grozny,7784,6,7,6,7,20,23,-3,27
Din Moscow,7784,7,6,7,7,19,22,-3,25
FK Rubin,7784,8,5,5,10,21,21,0,20
Rostov,7784,9,4,6,10,12,21,-9,18
Amkar,7784,10,4,6,10,10,23,-13,18
Anzhi,7784,11,3,5,12,15,39,-24,14
Loko Moscow,7785,1,11,5,4,31,18,13,38
CSKA Moscow,7785,2,11,4,5,28,17,11,37
Zenit,7785,3,8,9,3,25,15,10,33
Spart Moscow,7785,4,9,6,5,38,30,8,33
Krasnodar,7785,5,9,4,7,30,26,4,31
Terek Grozny,7785,6,8,5,7,24,25,-1,29
Din Moscow,7785,7,7,6,7,23,24,-1,27
FK Rubin,7785,8,6,5,9,24,19,5,23
Rostov,7785,9,4,7,9,11,18,-7,19
Amkar,7785,10,4,4,12,9,26,-17,16
Anzhi,7785,11,3,5,12,17,42,-25,14
Loko Moscow,7786,1,13,5,2,33,13,20,44
CSKA Moscow,7786,2,12,3,5,28,17,11,39
Spart Moscow,7786,3,9,7,4,37,28,9,34
Krasnodar,7786,4,9,4,7,30,27,3,31
Zenit,7786,5,7,8,5,22,17,5,29
Terek Grozny,7786,6,8,5,7,22,25,-3,29
FK Rubin,7786,7,6,5,9,24,19,5,23
Din Moscow,7786,8,5,7,8,18,24,-6,22
Amkar,7786,9,5,5,10,13,24,-11,20
Rostov,7786,10,4,6,10,11,19,-8,18
Anzhi,7786,11,2,5,13,14,39,-25,11
Loko Moscow,7787,1,12,6,2,31,12,19,42
CSKA Moscow,7787,2,12,3,5,28,18,10,39
Spart Moscow,7787,3,10,5,5,41,30,11,35
Krasnodar,7787,4,9,5,6,30,25,5,32
Zenit,7787,5,7,8,5,22,16,6,29
Terek Grozny,7787,6,7,6,7,22,25,-3,27
FK Rubin,7787,7,6,5,9,23,20,3,23
Din Moscow,7787,8,5,6,9,18,25,-7,21
Amkar,7787,9,5,5,10,14,26,-12,20
Rostov,7787,10,4,6,10,12,21,-9,18
Anzhi,7787,11,3,5,12,15,38,-23,14
Loko Moscow,7788,1,12,5,3,30,12,18,41
CSKA Moscow,7788,2,11,3,6,26,19,7,36
Spart Moscow,7788,3,9,7,4,38,29,9,34
Krasnodar,7788,4,9,4,7,28,25,3,31
Zenit,7788,5,7,8,5,21,15,6,29
Terek Grozny,7788,6,8,5,7,23,25,-2,29
Din Moscow,7788,7,6,7,7,19,22,-3,25
FK Rubin,7788,8,6,5,9,22,18,4,23
Rostov,7788,9,4,7,9,11,18,-7,19
Anzhi,7788,10,4,5,11,18,38,-20,17
Amkar,7788,11,4,4,12,12,27,-15,16
Loko Moscow,7789,1,12,5,3,33,13,20,41
Spart Moscow,7789,2,11,5,4,39,25,14,38
CSKA Moscow,7789,3,11,3,6,26,18,8,36
Zenit,7789,4,8,8,4,23,17,6,32
Krasnodar,7789,5,9,5,6,30,26,4,32
Terek Grozny,7789,6,8,6,6,25,24,1,30
FK Rubin,7789,7,5,7,8,24,20,4,22
Din Moscow,7789,8,5,7,8,18,24,-6,22
Rostov,7789,9,4,6,10,10,19,-9,18
Amkar,7789,10,4,5,11,10,25,-15,17
Anzhi,7789,11,2,5,13,15,42,-27,11
Loko Moscow,7790,1,12,5,3,30,13,17,41
CSKA Moscow,7790,2,11,3,6,31,19,12,36
Spart Moscow,7790,3,9,6,5,37,30,7,33
Zenit,7790,4,8,8,4,23,15,8,32
Krasnodar,7790,5,9,5,6,31,26,5,32
Terek Grozny,7790,6,8,6,6,21,22,-1,30
FK Rubin,7790,7,6,6,8,24,19,5,24
Din Moscow,7790,8,5,7,8,18,23,-5,22
Rostov,7790,9,5,6,9,13,18,-5,21
Amkar,7790,10,4,5,11,10,24,-14,17
Anzhi,7790,11,2,5,13,14,43,-29,11
Loko Moscow,7791,1,11,6,3,32,15,17,39
CSKA Moscow,7791,2,12,3,5,33,19,14,39
Spart Moscow,7791,3,9,7,4,36,27,9,34
Zenit,7791,4,8,8,4,24,16,8,32
Terek Grozny,7791,5,9,5,6,22,22,0,32
Krasnodar,7791,6,8,6,6,31,28,3,30
Din Moscow,7791,7,6,7,7,20,23,-3,25
FK Rubin,7791,8,5,6,9,22,19,3,21
Rostov,7791,9,4,7,9,10,17,-7,19
Amkar,7791,10,4,4,12,9,24,-15,16
Anzhi,7791,11,2,5,13,14,43,-29,11
Loko Moscow,7792,1,11,5,4,30,15,15,38
Spart Moscow,7792,2,10,6,4,43,29,14,36
CSKA Moscow,7792,3,10,5,5,25,17,8,35
Zenit,7792,4,8,9,3,23,14,9,33
Krasnodar,7792,5,9,4,7,29,26,3,31
Terek Grozny,7792,6,8,5,7,24,26,-2,29
FK Rubin,7792,7,7,5,8,24,17,7,26
Din Moscow,7792,8,5,7,8,18,23,-5,22
Amkar,7792,9,5,4,11,14,26,-12,19
Rostov,7792,10,4,6,10,11,23,-12,18
Anzhi,7792,11,2,6,12,15,40,-25,12
Loko Moscow,7793,1,12,6,2,32,13,19,42
Spart Moscow,7793,2,11,5,4,40,28,12,38
Zenit,7793,3,8,9,3,23,14,9,33
CSKA Moscow,7793,4,10,3,7,25,19,6,33
Krasnodar,7793,5,9,4,7,32,28,4,31
Terek Grozny,7793,6,7,7,6,22,24,-2,28
FK Rubin,7793,7,6,5,9,24,21,3,23
Din Moscow,7793,8,5,6,9,19,26,-7,21
Rostov,7793,9,4,6,10,10,18,-8,18
Amkar,7793,10,4,5,11,11,25,-14,17
Anzhi,7793,11,3,6,11,16,38,-22,15
Loko Moscow,7794,1,12,6,2,33,14,19,42
CSKA Moscow,7794,2,12,3,5,28,18,10,39
Spart Moscow,7794,3,11,5,4,41,27,14,38
Zenit,7794,4,7,9,4,22,15,7,30
Terek Grozny,7794,5,8,6,6,23,24,-1,30
Krasnodar,7794,6,8,4,8,29,28,1,28
Din Moscow,7794,7,6,6,8,19,25,-6,24
FK Rubin,7794,8,6,5,9,22,18,4,23
Rostov,7794,9,4,6,10,11,19,-8,18
Amkar,7794,10,4,5,11,10,25,-15,17
Anzhi,7794,11,2,5,13,16,41,-25,11
Loko Moscow,7795,1,13,5,2,35,12,23,44
CSKA Moscow,7795,2,10,5,5,25,17,8,35
Spart Moscow,7795,3,9,5,6,34,29,5,32
Krasnodar,7795,4,9,4,7,29,27,2,31
Zenit,7795,5,7,9,4,22,17,5,30
Terek Grozny,7795,6,8,6,6,24,24,0,30
Din Moscow,7795,7,6,7,7,19,21,-2,25
FK Rubin,7795,8,5,6,9,22,19,3,21
Amkar,7795,9,5,5,10,11,22,-11,20
Rostov,7795,10,4,6,10,10,18,-8,18
Anzhi,7795,11,2,6,12,16,41,-25,12
Loko Moscow,7796,1,12,6,2,33,13,20,42
CSKA Moscow,7796,2,10,4,6,27,21,6,34
Zenit,7796,3,8,9,3,24,14,10,33
Spart Moscow,7796,4,9,5,6,37,30,7,32
Terek Grozny,7796,5,8,5,7,23,24,-1,29
Krasnodar,7796,6,8,4,8,28,28,0,28
FK Rubin,7796,7,7,5,8,24,17,7,26
Din Moscow,7796,8,6,6,8,20,24,-4,24
Rostov,7796,9,5,6,9,12,18,-6,21
Amkar,7796,10,5,4,11,10,24,-14,19
Anzhi,7796,11,2,6,12,17,42,-25,12
Loko Moscow,7797,1,12,5,3,32,12,20,41
CSKA Moscow,7797,2,11,3,6,32,19,13,36
Spart Moscow,7797,3,9,7,4,41,31,10,34
Krasnodar,7797,4,10,4,6,32,24,8,34
Zenit,7797,5,8,8,4,23,16,7,32
Terek Grozny,7797,6,9,5,6,26,22,4,32
FK Rubin,7797,7,6,5,9,22,21,1,23
Din Moscow,7797,8,5,7,8,18,23,-5,22
Rostov,7797,9,4,7,9,14,21,-7,19
Amkar,7797,10,4,4,12,10,26,-16,16
Anzhi,7797,11,2,5,13,14,49,-35,11
Loko Moscow,7798,1,12,5,3,34,14,20,41
CSKA Moscow,7798,2,12,3,5,29,18,11,39
Krasnodar,7798,3,10,4,6,30,25,5,34
Spart Moscow,7798,4,9,5,6,35,30,5,32
Zenit,7798,5,7,8,5,24,20,4,29
Terek Grozny,7798,6,8,5,7,22,24,-2,29
Din Moscow,7798,7,7,6,7,20,22,-2,27
Amkar,7798,8,6,4,10,14,22,-8,22
FK Rubin,7798,9,5,5,10,22,20,2,20
Rostov,7798,10,4,6,10,10,18,-8,18
Anzhi,7798,11,2,5,13,14,41,-27,11
Loko Moscow,7799,1,12,5,3,32,14,18,41
CSKA Moscow,7799,2,11,4,5,28,19,9,37
Spart Moscow,7799,3,8,7,5,37,32,5,31
Krasnodar,7799,4,9,4,7,29,26,3,31
Terek Grozny,7799,5,8,6,6,22,23,-1,30
Zenit,7799,6,7,8,5,23,17,6,29
FK Rubin,7799,7,6,6,8,24,19,5,24
Din Moscow,7799,8,5,8,7,20,24,-4,23
Rostov,7799,9,4,7,9,13,20,-7,19
Amkar,7799,10,5,4,11,12,23,-11,19
Anzhi,7799,11,2,7,11,16,39,-23,13
Loko Moscow,7800,1,12,5,3,33,15,18,41
Spart Moscow,7800,2,10,6,4,38,27,11,36
Krasnodar,7800,3,10,4,6,32,26,6,34
CSKA Moscow,7800,4,10,4,6,26,21,5,34
Zenit,7800,5,8,8,4,26,17,9,32
Terek Grozny,7800,6,9,5,6,22,22,0,32
Din Moscow,7800,7,5,7,8,17,22,-5,22
FK Rubin,7800,8,5,6,9,22,19,3,21
Rostov,7800,9,4,6,10,10,19,-9,18
Amkar,7800,10,4,5,11,11,25,-14,17
Anzhi,7800,11,2,6,12,14,38,-24,12
Loko Moscow,7801,1,11,6,3,31,17,14,39
CSKA Moscow,7801,2,11,4,5,30,20,10,37
Spart Moscow,7801,3,10,6,4,38,28,10,36
Zenit,7801,4,8,9,3,27,15,12,33
Krasnodar,7801,5,8,6,6,30,27,3,30
Terek Grozny,7801,6,7,6,7,24,27,-3,27
FK Rubin,7801,7,6,6,8,24,18,6,24
Din Moscow,7801,8,5,7,8,18,24,-6,22
Rostov,7801,9,4,6,10,11,19,-8,18
Amkar,7801,10,4,5,11,13,27,-14,17
Anzhi,7801,11,3,5,12,17,41,-24,14
Loko Moscow,7802,1,11,7,2,31,13,18,40
CSKA Moscow,7802,2,11,3,6,28,20,8,36
Spart Moscow,7802,3,9,6,5,39,28,11,33
Zenit,7802,4,8,9,3,25,15,10,33
Krasnodar,7802,5,8,5,7,28,26,2,29
Terek Grozny,7802,6,7,6,7,21,24,-3,27
FK Rubin,7802,7,7,5,8,24,17,7,26
Din Moscow,7802,8,6,6,8,18,23,-5,24
Rostov,7802,9,4,6,10,11,22,-11,18
Amkar,7802,10,4,6,10,11,24,-13,18
Anzhi,7802,11,3,5,12,15,39,-24,14
Loko Moscow,7803,1,12,5,3,30,12,18,41
Spart Moscow,7803,2,10,6,4,36,26,10,36
CSKA Moscow,7803,3,11,3,6,28,21,7,36
Zenit,7803,4,9,8,3,24,13,11,35
Krasnodar,7803,5,8,5,7,28,26,2,29
Terek Grozny,7803,6,8,5,7,22,24,-2,29
FK Rubin,7803,7,6,6,8,23,18,5,24
Din Moscow,7803,8,5,6,9,18,24,-6,21
Rostov,7803,9,4,7,9,10,17,-7,19
Amkar,7803,10,5,4,11,10,23,-13,19
Anzhi,7803,11,2,5,13,17,42,-25,11
Loko Moscow,7804,1,12,5,3,30,12,18,41
CSKA Moscow,7804,2,12,3,5,31,19,12,39
Krasnodar,7804,3,10,4,6,30,24,6,34
Spart Moscow,7804,4,9,6,5,36,28,8,33
Zenit,7804,5,7,8,5,22,16,6,29
Terek Grozny,7804,6,8,5,7,22,24,-2,29
Din Moscow,7804,7,6,6,8,20,24,-4,24
FK Rubin,7804,8,5,5,10,23,22,1,20
Rostov,7804,9,4,7,9,11,18,-7,19
Amkar,7804,10,5,4,11,12,25,-13,19
Anzhi,7804,11,3,5,12,16,41,-25,14
CSKA Moscow,7805,1,12,3,5,30,18,12,39
Loko Moscow,7805,2,11,5,4,30,17,13,38
Zenit,7805,3,8,8,4,22,15,7,32
Spart Moscow,7805,4,9,5,6,36,31,5,32
Krasnodar,7805,5,9,4,7,33,27,6,31
Terek Grozny,7805,6,7,6,7,22,25,-3,27
Din Moscow,7805,7,6,7,7,22,23,-1,25
FK Rubin,7805,8,6,6,8,24,19,5,24
Amkar,7805,9,6,4,10,12,22,-10,22
Rostov,7805,10,4,6,10,10,19,-9,18
Anzhi,7805,11,2,6,12,17,42,-25,12
Loko Moscow,7806,1,12,5,3,31,16,15,41
CSKA Moscow,7806,2,10,4,6,27,20,7,34
Spart Moscow,7806,3,9,6,5,41,32,9,33
Zenit,7806,4,8,8,4,23,15,8,32
Krasnodar,7806,5,9,5,6,33,26,7,32
Terek Grozny,7806,6,7,6,7,21,24,-3,27
FK Rubin,7806,7,6,6,8,26,19,7,24
Din Moscow,7806,8,5,7,8,19,26,-7,22
Amkar,7806,9,5,5,10,13,23,-10,20
Rostov,7806,10,4,6,10,11,22,-11,18
Anzhi,7806,11,3,6,11,18,40,-22,15
Loko Moscow,7807,1,11,6,3,31,14,17,39
Spart Moscow,7807,2,10,6,4,38,27,11,36
CSKA Moscow,7807,3,10,4,6,27,22,5,34
Krasnodar,7807,4,9,5,6,31,27,4,32
Zenit,7807,5,7,10,3,23,15,8,31
Terek Grozny,7807,6,7,6,7,21,26,-5,27
Din Moscow,7807,7,6,6,8,19,23,-4,24
FK Rubin,7807,8,5,6,9,22,20,2,21
Amkar,7807,9,5,5,10,13,23,-10,20
Rostov,7807,10,4,6,10,11,19,-8,18
Anzhi,7807,11,3,6,11,18,38,-20,15
Loko Moscow,7808,1,11,6,3,30,13,17,39
Spart Moscow,7808,2,10,6,4,42,27,15,36
Zenit,7808,3,9,8,3,24,14,10,35
CSKA Moscow,7808,4,10,3,7,27,21,6,33
Krasnodar,7808,5,8,6,6,29,26,3,30
Terek Grozny,7808,6,7,6,7,23,26,-3,27
FK Rubin,7808,7,6,6,8,25,19,6,24
Din Moscow,7808,8,5,6,9,18,28,-10,21
Rostov,7808,9,4,6,10,10,20,-10,18
Amkar,7808,10,4,6,10,13,26,-13,18
Anzhi,7808,11,4,5,11,18,39,-21,17
Loko Moscow,7809,1,12,5,3,32,15,17,41
CSKA Moscow,7809,2,11,4,5,29,19,10,37
Spart Moscow,7809,3,9,7,4,37,28,9,34
Krasnodar,7809,4,10,4,6,33,26,7,34
Zenit,7809,5,7,9,4,23,16,7,30
Terek Grozny,7809,6,7,6,7,20,23,-3,27
Din Moscow,7809,7,5,7,8,17,22,-5,22
FK Rubin,7809,8,5,6,9,22,20,2,21
Rostov,7809,9,4,7,9,12,19,-7,19
Amkar,7809,10,4,6,10,10,23,-13,18
Anzhi,7809,11,3,5,12,16,40,-24,14
Loko Moscow,7810,1,13,5,2,31,11,20,44
Spart Moscow,7810,2,11,5,4,37,25,12,38
CSKA Moscow,7810,3,11,3,6,29,20,9,36
Zenit,7810,4,8,8,4,23,15,8,32
Terek Grozny,7810,5,8,6,6,22,22,0,30
Krasnodar,7810,6,8,5,7,28,26,2,29
Din Moscow,7810,7,6,6,8,19,24,-5,24
FK Rubin,7810,8,5,6,9,23,20,3,21
Rostov,7810,9,4,6,10,10,18,-8,18
Amkar,7810,10,4,5,11,9,23,-14,17
Anzhi,7810,11,2,5,13,15,42,-27,11
Loko Moscow,7811,1,12,6,2,35,13,22,42
CSKA Moscow,7811,2,11,4,5,29,20,9,37
Spart Moscow,7811,3,10,5,5,40,29,11,35
Zenit,7811,4,7,8,5,23,20,3,29
Krasnodar,7811,5,8,5,7,30,28,2,29
Terek Grozny,7811,6,7,6,7,22,25,-3,27
FK Rubin,7811,7,7,5,8,25,19,6,26
Rostov,7811,8,5,6,9,13,19,-6,21
Din Moscow,7811,9,5,6,9,18,25,-7,21
Amkar,7811,10,4,5,11,10,25,-15,17
Anzhi,7811,11,3,6,11,18,40,-22,15
Loko Moscow,7812,1,12,5,3,31,13,18,41
CSKA Moscow,7812,2,11,4,5,26,17,9,37
Spart Moscow,7812,3,10,6,4,37,26,11,36
Krasnodar,7812,4,9,4,7,29,27,2,31
Zenit,7812,5,7,9,4,21,14,7,30
Terek Grozny,7812,6,7,5,8,21,27,-6,26
Din Moscow,7812,7,6,6,8,19,24,-5,24
FK Rubin,7812,8,6,5,9,23,18,5,23
Rostov,7812,9,4,7,9,10,17,-7,19
Amkar,7812,10,5,4,11,12,23,-11,19
Anzhi,7812,11,3,5,12,16,39,-23,14
Loko Moscow,7813,1,11,6,3,29,12,17,39
CSKA Moscow,7813,2,12,3,5,30,19,11,39
Spart Moscow,7813,3,10,6,4,39,29,10,36
Krasnodar,7813,4,10,4,6,30,25,5,34
Zenit,7813,5,7,9,4,22,15,7,30
Terek Grozny,7813,6,8,5,7,23,25,-2,29
Din Moscow,7813,7,6,6,8,23,24,-1,24
FK Rubin,7813,8,5,5,10,22,23,-1,20
Rostov,7813,9,4,6,10,10,18,-8,18
Amkar,7813,10,4,5,11,11,25,-14,17
Anzhi,7813,11,3,5,12,18,42,-24,14
Loko Moscow,7814,1,12,6,2,33,14,19,42
CSKA Moscow,7814,2,12,3,5,32,18,14,39
Krasnodar,7814,3,9,4,7,31,28,3,31
Zenit,7814,4,7,9,4,23,17,6,30
Spart Moscow,7814,5,8,5,7,36,32,4,29
Terek Grozny,7814,6,8,5,7,22,24,-2,29
Din Moscow,7814,7,7,6,7,20,22,-2,27
Rostov,7814,8,5,6,9,12,17,-5,21
FK Rubin,7814,9,5,5,10,22,20,2,20
Amkar,7814,10,5,4,11,13,26,-13,19
Anzhi,7814,11,3,5,12,15,41,-26,14
Loko Moscow,7815,1,13,5,2,32,11,21,44
Spart Moscow,7815,2,10,6,4,39,27,12,36
CSKA Moscow,7815,3,11,3,6,29,20,9,36
Terek Grozny,7815,4,9,5,6,26,24,2,32
Krasnodar,7815,5,9,4,7,28,25,3,31
Zenit,7815,6,7,8,5,22,18,4,29
FK Rubin,7815,7,6,5,9,23,18,5,23
Din Moscow,7815,8,5,6,9,17,26,-9,21
Rostov,7815,9,4,6,10,11,19,-8,18
Amkar,7815,10,4,5,11,10,26,-16,17
Anzhi,7815,11,3,5,12,18,41,-23,14
Loko Moscow,7816,1,12,5,3,32,14,18,41
CSKA Moscow,7816,2,11,4,5,29,19,10,37
Krasnodar,7816,3,9,5,6,31,27,4,32
Spart Moscow,7816,4,8,7,5,37,31,6,31
Zenit,7816,5,7,9,4,23,16,7,30
Terek Grozny,7816,6,7,7,6,22,24,-2,28
Din Moscow,7816,7,6,7,7,19,21,-2,25
FK Rubin,7816,8,5,7,8,22,18,4,22
Rostov,7816,9,4,7,9,12,19,-7,19
Amkar,7816,10,4,6,10,12,25,-13,18
Anzhi,7816,11,2,6,12,15,40,-25,12
Loko Moscow,7817,1,12,5,3,32,15,17,41
Spart Moscow,7817,2,10,5,5,40,29,11,35
CSKA Moscow,7817,3,10,3,7,25,19,6,33
Zenit,7817,4,8,8,4,22,14,8,32
Krasnodar,7817,5,9,4,7,34,30,4,31
Terek Grozny,7817,6,7,6,7,22,28,-6,27
FK Rubin,7817,7,7,5,8,27,20,7,26
Din Moscow,7817,8,5,6,9,18,25,-7,21
Amkar,7817,9,5,5,10,13,25,-12,20
Rostov,7817,10,4,6,10,11,21,-10,18
Anzhi,7817,11,4,5,11,19,37,-18,17
Loko Moscow,7818,1,12,6,2,30,11,19,42
CSKA Moscow,7818,2,11,3,6,28,18,10,36
Spart Moscow,7818,3,9,6,5,39,30,9,33
Zenit,7818,4,8,9,3,22,13,9,33
Krasnodar,7818,5,9,4,7,29,25,4,31
Terek Grozny,7818,6,8,5,7,23,25,-2,29
Din Moscow,7818,7,7,6,7,21,21,0,27
FK Rubin,7818,8,5,5,10,21,21,0,20
Rostov,7818,9,4,7,9,12,19,-7,19
Amkar,7818,10,5,4,11,12,26,-14,19
Anzhi,7818,11,2,5,13,15,43,-28,11
Loko Moscow,7819,1,13,5,2,36,16,20,44
CSKA Moscow,7819,2,12,3,5,31,17,14,39
Spart Moscow,7819,3,10,6,4,42,29,13,36
Krasnodar,7819,4,9,4,7,32,28,4,31
Zenit,7819,5,7,8,5,24,19,5,29
Terek Grozny,7819,6,7,5,8,20,27,-7,26
FK Rubin,7819,7,6,5,9,24,20,4,23
Din Moscow,7819,8,5,7,8,19,25,-6,22
Amkar,7819,9,5,4,11,13,24,-11,19
Rostov,7819,10,4,6,10,12,22,-10,18
Anzhi,7819,11,3,5,12,15,41,-26,14
Loko Moscow,7820,1,13,5,2,34,12,22,44
CSKA Moscow,7820,2,11,4,5,31,18,13,37
Spart Moscow,7820,3,9,5,6,37,32,5,32
Zenit,7820,4,7,9,4,22,17,5,30
Terek Grozny,7820,5,8,6,6,24,23,1,30
Krasnodar,7820,6,8,5,7,29,27,2,29
Din Moscow,7820,7,7,6,7,25,22,3,27
FK Rubin,7820,8,5,6,9,22,22,0,21
Amkar,7820,9,5,4,11,11,26,-15,19
Rostov,7820,10,4,6,10,11,19,-8,18
Anzhi,7820,11,2,6,12,15,43,-28,12
Loko Moscow,7821,1,13,5,2,33,11,22,44
Spart Moscow,7821,2,10,5,5,36,26,10,35
CSKA Moscow,7821,3,10,3,7,26,20,6,33
Zenit,7821,4,8,8,4,22,16,6,32
Krasnodar,7821,5,8,5,7,27,25,2,29
Terek Grozny,7821,6,7,6,7,22,26,-4,27
FK Rubin,7821,7,6,6,8,22,17,5,24
Din Moscow,7821,8,5,6,9,17,23,-6,21
Rostov,7821,9,5,6,9,11,17,-6,21
Amkar,7821,10,4,5,11,11,26,-15,17
Anzhi,7821,11,4,5,11,18,38,-20,17
Loko Moscow,7822,1,11,6,3,30,14,16,39
CSKA Moscow,7822,2,11,4,5,26,17,9,37
Spart Moscow,7822,3,9,6,5,39,29,10,33
Zenit,7822,4,8,9,3,24,14,10,33
Krasnodar,7822,5,9,5,6,29,25,4,32
Terek Grozny,7822,6,7,5,8,22,26,-4,26
Din Moscow,7822,7,5,7,8,20,27,-7,22
FK Rubin,7822,8,5,6,9,24,21,3,21
Rostov,7822,9,5,6,9,12,18,-6,21
Amkar,7822,10,5,5,10,13,25,-12,20
Anzhi,7822,11,3,5,12,15,38,-23,14
Loko Moscow,7823,1,12,6,2,31,12,19,42
Spart Moscow,7823,2,9,7,4,36,27,9,34
CSKA Moscow,7823,3,10,4,6,27,20,7,34
Zenit,7823,4,7,10,3,23,15,8,31
Krasnodar,7823,5,8,5,7,28,26,2,29
Terek Grozny,7823,6,8,5,7,23,24,-1,29
Din Moscow,7823,7,5,8,7,19,23,-4,23
FK Rubin,7823,8,5,7,8,23,19,4,22
Rostov,7823,9,4,7,9,11,18,-7,19
Amkar,7823,10,5,4,11,11,24,-13,19
Anzhi,7823,11,3,5,12,16,40,-24,14
Loko Moscow,7824,1,12,6,2,30,11,19,42
CSKA Moscow,7824,2,10,4,6,26,20,6,34
Spart Moscow,7824,3,9,6,5,35,27,8,33
Zenit,7824,4,7,10,3,22,14,8,31
Krasnodar,7824,5,9,4,7,29,25,4,31
Terek Grozny,7824,6,7,6,7,22,25,-3,27
FK Rubin,7824,7,6,5,9,23,19,4,23
Din Moscow,7824,8,5,6,9,17,24,-7,21
Amkar,7824,9,5,5,10,10,22,-12,20
Rostov,7824,10,4,7,9,11,18,-7,19
Anzhi,7824,11,4,5,11,19,39,-20,17
Loko Moscow,7825,1,11,6,3,30,13,17,39
Spart Moscow,7825,2,10,5,5,38,28,10,35
Krasnodar,7825,3,10,4,6,31,26,5,34
CSKA Moscow,7825,4,10,4,6,26,21,5,34
Zenit,7825,5,7,10,3,22,14,8,31
Terek Grozny,7825,6,8,5,7,23,24,-1,29
Din Moscow,7825,7,5,7,8,17,22,-5,22
Amkar,7825,8,6,4,10,11,22,-11,22
FK Rubin,7825,9,5,6,9,22,19,3,21
Rostov,7825,10,4,6,10,12,21,-9,18
Anzhi,7825,11,3,5,12,18,40,-22,14
Spart Moscow,7826,1,11,5,4,42,27,15,38
Loko Moscow,7826,2,11,5,4,29,14,15,38
Zenit,7826,3,9,8,3,25,13,12,35
Krasnodar,7826,4,10,4,6,32,24,8,34
CSKA Moscow,7826,5,10,3,7,26,23,3,33
Terek Grozny,7826,6,8,5,7,24,25,-1,29
Din Moscow,7826,7,6,6,8,20,23,-3,24
FK Rubin,7826,8,5,5,10,21,22,-1,20
Amkar,7826,9,5,4,11,10,25,-15,19
Rostov,7826,10,4,6,10,11,21,-10,18
Anzhi,7826,11,3,5,12,19,42,-23,14
Loko Moscow,7827,1,11,5,4,31,18,13,38
Spart Moscow,7827,2,10,6,4,41,30,11,36
Zenit,7827,3,9,8,3,25,15,10,35
CSKA Moscow,7827,4,10,4,6,26,19,7,34
Krasnodar,7827,5,9,4,7,33,27,6,31
Terek Grozny,7827,6,8,5,7,24,24,0,29
FK Rubin,7827,7,7,5,8,25,19,6,26
Din Moscow,7827,8,5,6,9,18,25,-7,21
Rostov,7827,9,4,7,9,12,19,-7,19
Amkar,7827,10,4,4,12,11,28,-17,16
Anzhi,7827,11,3,6,11,17,39,-22,15
Loko Moscow,7828,1,12,6,2,33,14,19,42
CSKA Moscow,7828,2,12,3,5,29,18,11,39
Spart Moscow,7828,3,10,5,5,40,30,10,35
Krasnodar,7828,4,9,4,7,30,27,3,31
Zenit,7828,5,7,9,4,23,16,7,30
Terek Grozny,7828,6,8,6,6,21,22,-1,30
Din Moscow,7828,7,6,7,7,20,22,-2,25
FK Rubin,7828,8,5,6,9,21,18,3,21
Rostov,7828,9,4,6,10,11,20,-9,18
Amkar,7828,10,4,4,12,10,26,-16,16
Anzhi,7828,11,2,6,12,14,39,-25,12
Loko Moscow,7829,1,12,5,3,31,14,17,41
Spart Moscow,7829,2,10,5,5,37,30,7,35
CSKA Moscow,7829,3,10,4,6,28,21,7,34
Krasnodar,7829,4,10,4,6,31,25,6,34
Zenit,7829,5,8,8,4,23,15,8,32
Terek Grozny,7829,6,8,6,6,22,23,-1,30
FK Rubin,7829,7,6,5,9,22,18,4,23
Din Moscow,7829,8,5,6,9,17,23,-6,21
Amkar,7829,9,5,4,11,13,24,-11,19
Rostov,7829,10,4,6,10,11,19,-8,18
Anzhi,7829,11,2,7,11,17,40,-23,13
Loko Moscow,7830,1,12,6,2,31,11,20,42
CSKA Moscow,7830,2,11,3,6,28,20,8,36
Zenit,7830,3,8,9,3,23,13,10,33
Spart Moscow,7830,4,8,7,5,37,30,7,31
Krasnodar,7830,5,9,4,7,29,27,2,31
Terek Grozny,7830,6,7,6,7,23,26,-3,27
Din Moscow,7830,7,6,7,7,22,24,-2,25
Rostov,7830,8,5,6,9,12,18,-6,21
FK Rubin,7830,9,5,5,10,23,22,1,20
Amkar,7830,10,4,6,10,11,24,-13,18
Anzhi,7830,11,3,5,12,18,42,-24,14
Loko Moscow,7831,1,12,5,3,32,14,18,41
Spart Moscow,7831,2,11,5,4,40,27,13,38
CSKA Moscow,7831,3,11,4,5,27,17,10,37
Krasnodar,7831,4,9,4,7,29,26,3,31
Zenit,7831,5,7,9,4,22,16,6,30
Terek Grozny,7831,6,7,5,8,23,28,-5,26
FK Rubin,7831,7,6,6,8,25,19,6,24
Din Moscow,7831,8,5,7,8,19,25,-6,22
Amkar,7831,9,5,4,11,13,26,-13,19
Rostov,7831,10,4,6,10,11,20,-9,18
Anzhi,7831,11,3,5,12,17,40,-23,14
CSKA Moscow,7832,1,12,3,5,30,17,13,39
Loko Moscow,7832,2,11,5,4,29,14,15,38
Spart Moscow,7832,3,8,8,4,37,29,8,32
Zenit,7832,4,8,8,4,23,15,8,32
Krasnodar,7832,5,9,5,6,29,25,4,32
Terek Grozny,7832,6,7,6,7,23,26,-3,27
Din Moscow,7832,7,5,8,7,18,22,-4,23
FK Rubin,7832,8,5,7,8,22,18,4,22
Rostov,7832,9,4,7,9,11,18,-7,19
Amkar,7832,10,4,6,10,12,25,-13,18
Anzhi,7832,11,3,5,12,17,42,-25,14
Loko Moscow,7833,1,11,6,3,31,14,17,39
Spart Moscow,7833,2,11,5,4,38,25,13,38
CSKA Moscow,7833,3,11,3,6,28,20,8,36
Zenit,7833,4,8,9,3,25,16,9,33
Krasnodar,7833,5,9,5,6,29,25,4,32
Terek Grozny,7833,6,7,5,8,20,25,-5,26
FK Rubin,7833,7,5,7,8,23,19,4,22
Din Moscow,7833,8,5,7,8,18,24,-6,22
Amkar,7833,9,5,4,11,11,23,-12,19
Rostov,7833,10,4,6,10,10,19,-9,18
Anzhi,7833,11,3,5,12,16,39,-23,14
Loko Moscow,7834,1,12,6,2,32,11,21,42
CSKA Moscow,7834,2,11,4,5,27,18,9,37
Spart Moscow,7834,3,9,6,5,36,28,8,33
Zenit,7834,4,7,9,4,21,16,5,30
Krasnodar,7834,5,8,6,6,29,26,3,30
Terek Grozny,7834,6,7,6,7,21,24,-3,27
Din Moscow,7834,7,6,7,7,19,22,-3,25
Amkar,7834,8,6,4,10,12,22,-10,22
FK Rubin,7834,9,5,6,9,24,21,3,21
Rostov,7834,10,4,6,10,11,20,-9,18
Anzhi,7834,11,2,6,12,16,40,-24,12
Loko Moscow,7835,1,11,5,4,29,16,13,38
CSKA Moscow,7835,2,11,3,6,29,20,9,36
Zenit,7835,3,9,8,3,24,14,10,35
Spart Moscow,7835,4,10,5,5,40,31,9,35
Krasnodar,7835,5,9,4,7,31,27,4,31
Din Moscow,7835,6,7,6,7,23,25,-2,27
Terek Grozny,7835,7,7,5,8,22,26,-4,26
FK Rubin,7835,8,6,5,9,25,19,6,23
Amkar,7835,9,5,4,11,13,26,-13,19
Rostov,7835,10,4,6,10,10,18,-8,18
Anzhi,7835,11,3,5,12,17,41,-24,14
Loko Moscow,7836,1,13,5,2,35,12,23,44
CSKA Moscow,7836,2,11,3,6,28,18,10,36
Zenit,7836,3,8,8,4,22,14,8,32
Spart Moscow,7836,4,9,5,6,38,32,6,32
Krasnodar,7836,5,9,4,7,32,31,1,31
Terek Grozny,7836,6,8,5,7,21,23,-2,29
Din Moscow,7836,7,6,6,8,19,23,-4,24
FK Rubin,7836,8,6,5,9,24,21,3,23
Amkar,7836,9,5,4,11,12,24,-12,19
Rostov,7836,10,4,6,10,12,20,-8,18
Anzhi,7836,11,3,5,12,15,40,-25,14
CSKA Moscow,7837,1,12,3,5,29,18,11,39
Loko Moscow,7837,2,11,5,4,30,14,16,38
Krasnodar,7837,3,10,4,6,31,26,5,34
Spart Moscow,7837,4,9,5,6,38,31,7,32
Zenit,7837,5,8,8,4,22,15,7,32
Terek Grozny,7837,6,7,7,6,21,23,-2,28
Din Moscow,7837,7,6,7,7,23,26,-3,25
FK Rubin,7837,8,5,6,9,24,21,3,21
Rostov,7837,9,5,6,9,12,17,-5,21
Amkar,7837,10,4,5,11,9,24,-15,17
Anzhi,7837,11,2,6,12,16,40,-24,12
Loko Moscow,7838,1,11,5,4,31,15,16,38
CSKA Moscow,7838,2,10,5,5,28,20,8,35
Spart Moscow,7838,3,9,7,4,37,28,9,34
Zenit,7838,4,8,9,3,23,14,9,33
Krasnodar,7838,5,9,4,7,30,27,3,31
Terek Grozny,7838,6,8,6,6,26,25,1,30
Din Moscow,7838,7,6,7,7,19,22,-3,25
FK Rubin,7838,8,6,5,9,23,19,4,23
Rostov,7838,9,4,7,9,12,19,-7,19
Amkar,7838,10,4,4,12,10,27,-17,16
Anzhi,7838,11,2,7,11,19,42,-23,13
Loko Moscow,7839,1,11,6,3,30,15,15,39
CSKA Moscow,7839,2,12,3,5,30,17,13,39
Spart Moscow,7839,3,10,5,5,38,27,11,35
Zenit,7839,4,8,8,4,24,14,10,32
Krasnodar,7839,5,9,5,6,29,25,4,32
Terek Grozny,7839,6,9,5,6,25,25,0,32
Din Moscow,7839,7,6,6,8,20,25,-5,24
Rostov,7839,8,5,6,9,11,17,-6,21
FK Rubin,7839,9,5,5,10,22,21,1,20
Amkar,7839,10,4,4,12,13,28,-15,16
Anzhi,7839,11,2,5,13,14,42,-28,11
Loko Moscow,7840,1,12,5,3,32,13,19,41
CSKA Moscow,7840,2,12,3,5,30,19,11,39
Krasnodar,7840,3,10,4,6,32,25,7,34
Spart Moscow,7840,4,9,5,6,35,32,3,32
Zenit,7840,5,7,8,5,21,17,4,29
Terek Grozny,7840,6,8,5,7,22,24,-2,29
Din Moscow,7840,7,6,6,8,19,22,-3,24
Rostov,7840,8,5,6,9,13,18,-5,21
FK Rubin,7840,9,5,5,10,21,22,-1,20
Amkar,7840,10,5,4,11,13,23,-10,19
Anzhi,7840,11,3,5,12,18,41,-23,14
Loko Moscow,7841,1,12,5,3,31,12,19,41
CSKA Moscow,7841,2,12,3,5,28,17,11,39
Spart Moscow,7841,3,9,6,5,39,32,7,33
Zenit,7841,4,8,8,4,22,14,8,32
Terek Grozny,7841,5,8,6,6,22,23,-1,30
Krasnodar,7841,6,8,5,7,27,26,1,29
Din Moscow,7841,7,6,6,8,21,24,-3,24
FK Rubin,7841,8,5,6,9,21,19,2,21
Rostov,7841,9,5,6,9,13,18,-5,21
Amkar,7841,10,4,5,11,12,26,-14,17
Anzhi,7841,11,2,6,12,14,39,-25,12
Spart Moscow,7842,1,11,5,4,43,27,16,38
Loko Moscow,7842,2,11,5,4,30,15,15,38
CSKA Moscow,7842,3,11,3,6,30,20,10,36
Zenit,7842,4,9,8,3,25,15,10,35
Krasnodar,7842,5,10,4,6,30,24,6,34
Terek Grozny,7842,6,8,6,6,26,24,2,30
Din Moscow,7842,7,6,6,8,19,26,-7,24
FK Rubin,7842,8,5,5,10,21,19,2,20
Rostov,7842,9,4,6,10,11,21,-10,18
Amkar,7842,10,4,5,11,10,24,-14,17
Anzhi,7842,11,2,5,13,16,46,-30,11
Loko Moscow,7843,1,12,6,2,31,12,19,42
CSKA Moscow,7843,2,12,3,5,28,18,10,39
Spart Moscow,7843,3,9,6,5,38,28,10,33
Krasnodar,7843,4,8,6,6,28,25,3,30
Zenit,7843,5,7,8,5,21,15,6,29
Terek Grozny,7843,6,8,5,7,21,24,-3,29
FK Rubin,7843,7,5,7,8,22,18,4,22
Din Moscow,7843,8,5,7,8,18,25,-7,22
Amkar,7843,9,6,4,10,13,23,-10,22
Rostov,7843,10,4,7,9,11,18,-7,19
Anzhi,7843,11,2,5,13,15,40,-25,11
Loko Moscow,7844,1,11,6,3,32,17,15,39
CSKA Moscow,7844,2,11,4,5,29,19,10,37
Spart Moscow,7844,3,8,8,4,36,28,8,32
Krasnodar,7844,4,9,4,7,32,27,5,31
Zenit,7844,5,7,9,4,24,18,6,30
Terek Grozny,7844,6,8,5,7,23,25,-2,29
FK Rubin,7844,7,6,6,8,24,19,5,24
Din Moscow,7844,8,5,8,7,19,23,-4,23
Amkar,7844,9,5,5,10,12,24,-12,20
Rostov,7844,10,4,7,9,11,18,-7,19
Anzhi,7844,11,2,6,12,16,40,-24,12
Loko Moscow,7845,1,12,5,3,31,12,19,41
CSKA Moscow,7845,2,12,3,5,28,17,11,39
Spart Moscow,7845,3,10,6,4,37,27,10,36
Krasnodar,7845,4,9,4,7,30,28,2,31
Zenit,7845,5,7,8,5,21,17,4,29
Terek Grozny,7845,6,7,7,6,22,24,-2,28
Din Moscow,7845,7,6,6,8,19,23,-4,24
FK Rubin,7845,8,6,5,9,26,21,5,23
Rostov,7845,9,4,7,9,11,18,-7,19
Amkar,7845,10,4,5,11,11,25,-14,17
Anzhi,7845,11,2,6,12,15,39,-24,12
Loko Moscow,7846,1,11,6,3,30,13,17,39
CSKA Moscow,7846,2,12,3,5,29,17,12,39
Spart Moscow,7846,3,10,6,4,42,29,13,36
Zenit,7846,4,8,8,4,22,16,6,32
Krasnodar,7846,5,9,5,6,30,26,4,32
Terek Grozny,7846,6,7,5,8,21,26,-5,26
Din Moscow,7846,7,5,7,8,18,26,-8,22
FK Rubin,7846,8,5,6,9,22,19,3,21
Rostov,7846,9,4,7,9,11,18,-7,19
Amkar,7846,10,5,4,11,13,25,-12,19
Anzhi,7846,11,3,5,12,16,39,-23,14
Loko Moscow,7847,1,11,5,4,30,15,15,38
Spart Moscow,7847,2,10,5,5,38,30,8,35
CSKA Moscow,7847,3,10,5,5,25,17,8,35
Zenit,7847,4,8,9,3,23,13,10,33
Krasnodar,7847,5,9,4,7,29,26,3,31
Terek Grozny,7847,6,8,6,6,24,25,-1,30
FK Rubin,7847,7,7,5,8,25,17,8,26
Din Moscow,7847,8,5,6,9,18,27,-9,21
Amkar,7847,9,5,4,11,15,26,-11,19
Rostov,7847,10,4,6,10,10,18,-8,18
Anzhi,7847,11,2,7,11,15,38,-23,13
Loko Moscow,7848,1,11,6,3,30,13,17,39
CSKA Moscow,7848,2,11,4,5,29,18,11,37
Spart Moscow,7848,3,10,5,5,37,28,9,35
Krasnodar,7848,4,10,4,6,30,25,5,34
Terek Grozny,7848,5,9,5,6,23,23,0,32
Zenit,7848,6,7,10,3,22,14,8,31
Din Moscow,7848,7,6,6,8,20,25,-5,24
FK Rubin,7848,8,5,5,10,22,20,2,20
Amkar,7848,9,5,4,11,12,24,-12,19
Rostov,7848,10,4,6,10,10,18,-8,18
Anzhi,7848,11,2,5,13,14,41,-27,11
Loko Moscow,7849,1,11,7,2,30,12,18,40
CSKA Moscow,7849,2,12,3,5,28,18,10,39
Spart Moscow,7849,3,10,6,4,43,28,15,36
Krasnodar,7849,4,9,5,6,30,24,6,32
Zenit,7849,5,7,9,4,22,15,7,30
Terek Grozny,7849,6,8,6,6,22,23,-1,30
Din Moscow,7849,7,5,7,8,18,26,-8,22
FK Rubin,7849,8,5,6,9,21,20,1,21
Rostov,7849,9,4,6,10,11,21,-10,18
Amkar,7849,10,4,5,11,10,24,-14,17
Anzhi,7849,11,2,6,12,16,40,-24,12
Loko Moscow,7850,1,11,7,2,31,13,18,40
Spart Moscow,7850,2,10,6,4,35,25,10,36
CSKA Moscow,7850,3,11,3,6,29,20,9,36
Krasnodar,7850,4,9,5,6,30,26,4,32
Zenit,7850,5,7,9,4,23,18,5,30
Terek Grozny,7850,6,8,5,7,24,26,-2,29
Din Moscow,7850,7,6,7,7,18,21,-3,25
FK Rubin,7850,8,5,5,10,22,20,2,20
Amkar,7850,9,5,4,11,13,25,-12,19
Rostov,7850,10,4,6,10,10,18,-8,18
Anzhi,7850,11,3,5,12,16,39,-23,14
Loko Moscow,7851,1,12,6,2,32,13,19,42
Spart Moscow,7851,2,11,5,4,39,25,14,38
CSKA Moscow,7851,3,10,3,7,27,21,6,33
Zenit,7851,4,8,8,4,23,15,8,32
Krasnodar,7851,5,8,5,7,29,29,0,29
Terek Grozny,7851,6,8,5,7,23,24,-1,29
FK Rubin,7851,7,7,5,8,25,17,8,26
Din Moscow,7851,8,5,6,9,17,25,-8,21
Rostov,7851,9,4,6,10,10,18,-8,18
Anzhi,7851,10,4,5,11,18,39,-21,17
Amkar,7851,11,4,4,12,9,26,-17,16
Loko Moscow,7852,1,12,5,3,31,12,19,41
CSKA Moscow,7852,2,12,3,5,27,17,10,39
Krasnodar,7852,3,10,4,6,29,24,5,34
Spart Moscow,7852,4,8,8,4,34,26,8,32
Zenit,7852,5,7,8,5,21,16,5,29
Terek Grozny,7852,6,7,5,8,21,28,-7,26
FK Rubin,7852,7,6,5,9,22,18,4,23
Din Moscow,7852,8,5,7,8,18,23,-5,22
Amkar,7852,9,5,5,10,13,22,-9,20
Rostov,7852,10,4,7,9,10,17,-7,19
Anzhi,7852,11,3,5,12,16,39,-23,14
Loko Moscow,7853,1,11,6,3,30,16,14,39
CSKA Moscow,7853,2,11,3,6,27,20,7,36
Zenit,7853,3,8,9,3,25,15,10,33
Spart Moscow,7853,4,9,6,5,34,26,8,33
Krasnodar,7853,5,9,5,6,32,25,7,32
Terek Grozny,7853,6,9,5,6,24,23,1,32
FK Rubin,7853,7,6,6,8,24,19,5,24
Din Moscow,7853,8,5,6,9,18,24,-6,21
Rostov,7853,9,4,7,9,10,17,-7,19
Amkar,7853,10,5,4,11,10,24,-14,19
Anzhi,7853,11,2,5,13,15,40,-25,11
Loko Moscow,7854,1,12,5,3,31,15,16,41
CSKA Moscow,7854,2,11,3,6,28,18,10,36
Spart Moscow,7854,3,10,5,5,40,29,11,35
Zenit,7854,4,8,8,4,23,15,8,32
Krasnodar,7854,5,9,4,7,30,25,5,31
Terek Grozny,7854,6,7,7,6,21,23,-2,28
FK Rubin,7854,7,6,6,8,24,19,5,24
Din Moscow,7854,8,5,7,8,21,27,-6,22
Rostov,7854,9,5,6,9,12,18,-6,21
Amkar,7854,10,4,5,11,10,25,-15,17
Anzhi,7854,11,2,6,12,14,40,-26,12
Loko Moscow,7855,1,11,6,3,32,15,17,39
Spart Moscow,7855,2,10,5,5,39,29,10,35
CSKA Moscow,7855,3,10,5,5,25,17,8,35
Krasnodar,7855,4,9,5,6,32,28,4,32
Zenit,7855,5,7,10,3,22,14,8,31
Terek Grozny,7855,6,8,5,7,23,25,-2,29
FK Rubin,7855,7,5,7,8,23,19,4,22
Din Moscow,7855,8,5,7,8,19,26,-7,22
Rostov,7855,9,5,6,9,12,17,-5,21
Amkar,7855,10,5,4,11,11,23,-12,19
Anzhi,7855,11,2,6,12,15,40,-25,12
Loko Moscow,7856,1,12,5,3,33,15,18,41
CSKA Moscow,7856,2,11,3,6,28,20,8,36
Zenit,7856,3,9,8,3,25,15,10,35
Spart Moscow,7856,4,9,7,4,40,29,11,34
Krasnodar,7856,5,8,5,7,30,28,2,29
Terek Grozny,7856,6,8,5,7,23,24,-1,29
FK Rubin,7856,7,5,7,8,22,18,4,22
Din Moscow,7856,8,5,7,8,19,26,-7,22
Rostov,7856,9,4,7,9,11,18,-7,19
Amkar,7856,10,4,5,11,10,25,-15,17
Anzhi,7856,11,3,5,12,17,40,-23,14
Loko Moscow,7857,1,12,6,2,33,13,20,42
CSKA Moscow,7857,2,11,4,5,28,19,9,37
Spart Moscow,7857,3,9,6,5,37,30,7,33
Zenit,7857,4,7,10,3,23,15,8,31
Krasnodar,7857,5,8,5,7,29,28,1,29
Terek Grozny,7857,6,8,5,7,22,23,-1,29
Din Moscow,7857,7,5,8,7,19,23,-4,23
FK Rubin,7857,8,5,7,8,22,18,4,22
Amkar,7857,9,6,4,10,13,22,-9,22
Rostov,7857,10,4,6,10,10,19,-9,18
Anzhi,7857,11,2,5,13,15,41,-26,11
Loko Moscow,7858,1,13,5,2,32,12,20,44
Spart Moscow,7858,2,11,5,4,41,29,12,38
CSKA Moscow,7858,3,10,4,6,27,20,7,34
Zenit,7858,4,8,8,4,24,16,8,32
Krasnodar,7858,5,8,4,8,29,28,1,28
Terek Grozny,7858,6,7,6,7,21,26,-5,27
FK Rubin,7858,7,6,6,8,24,19,5,24
Din Moscow,7858,8,5,7,8,20,25,-5,22
Rostov,7858,9,4,6,10,11,19,-8,18
Amkar,7858,10,4,5,11,10,25,-15,17
Anzhi,7858,11,3,6,11,18,38,-20,15
Loko Moscow,7859,1,12,6,2,35,12,23,42
Spart Moscow,7859,2,10,6,4,36,26,10,36
CSKA Moscow,7859,3,11,3,6,27,19,8,36
Zenit,7859,4,8,8,4,22,18,4,32
Krasnodar,7859,5,8,6,6,28,25,3,30
Terek Grozny,7859,6,8,6,6,22,23,-1,30
FK Rubin,7859,7,6,6,8,22,17,5,24
Din Moscow,7859,8,5,7,8,18,23,-5,22
Rostov,7859,9,4,6,10,10,18,-8,18
Amkar,7859,10,4,5,11,9,23,-14,17
Anzhi,7859,11,2,5,13,16,41,-25,11
Loko Moscow,7860,1,12,5,3,31,13,18,41
CSKA Moscow,7860,2,10,4,6,26,19,7,34
Zenit,7860,3,8,8,4,22,14,8,32
Krasnodar,7860,4,9,4,7,29,26,3,31
Spart Moscow,7860,5,8,5,7,34,31,3,29
Din Moscow,7860,6,7,6,7,22,23,-1,27
Terek Grozny,7860,7,7,6,7,22,25,-3,27
FK Rubin,7860,8,6,5,9,23,19,4,23
Rostov,7860,9,5,6,9,11,17,-6,21
Amkar,7860,10,5,5,10,12,23,-11,20
Anzhi,7860,11,3,6,11,17,39,-22,15
Loko Moscow,7861,1,12,5,3,33,14,19,41
Spart Moscow,7861,2,10,5,5,38,28,10,35
Krasnodar,7861,3,10,4,6,32,27,5,34
CSKA Moscow,7861,4,10,4,6,26,21,5,34
Zenit,7861,5,7,9,4,22,16,6,30
Terek Grozny,7861,6,7,6,7,21,25,-4,27
Din Moscow,7861,7,5,7,8,18,23,-5,22
Amkar,7861,8,6,4,10,12,22,-10,22
FK Rubin,7861,9,5,6,9,23,20,3,21
Rostov,7861,10,4,6,10,11,20,-9,18
Anzhi,7861,11,3,6,11,19,39,-20,15
Loko Moscow,7862,1,11,6,3,30,14,16,39
Spart Moscow,7862,2,11,5,4,39,27,12,38
CSKA Moscow,7862,3,11,3,6,27,21,6,36
Krasnodar,7862,4,10,4,6,30,24,6,34
Zenit,7862,5,8,9,3,26,14,12,33
Terek Grozny,7862,6,8,5,7,24,26,-2,29
Din Moscow,7862,7,6,6,8,21,25,-4,24
FK Rubin,7862,8,5,5,10,22,20,2,20
Amkar,7862,9,5,4,11,11,25,-14,19
Rostov,7862,10,4,6,10,10,18,-8,18
Anzhi,7862,11,2,5,13,16,42,-26,11
Loko Moscow,7863,1,13,5,2,34,12,22,44
CSKA Moscow,7863,2,10,5,5,26,18,8,35
Spart Moscow,7863,3,8,8,4,38,30,8,32
Krasnodar,7863,4,9,4,7,30,27,3,31
Zenit,7863,5,7,9,4,23,18,5,30
Terek Grozny,7863,6,8,5,7,22,25,-3,29
Din Moscow,7863,7,6,7,7,19,22,-3,25
FK Rubin,7863,8,5,5,10,23,21,2,20
Rostov,7863,9,4,7,9,13,20,-7,19
Amkar,7863,10,4,5,11,11,25,-14,17
Anzhi,7863,11,3,6,11,16,37,-21,15
Loko Moscow,7864,1,12,5,3,30,12,18,41
CSKA Moscow,7864,2,12,3,5,30,18,12,39
Spart Moscow,7864,3,9,6,5,36,27,9,33
Zenit,7864,4,8,8,4,23,15,8,32
Krasnodar,7864,5,9,4,7,30,27,3,31
Terek Grozny,7864,6,7,6,7,22,25,-3,27
FK Rubin,7864,7,6,5,9,25,21,4,23
Amkar,7864,8,6,4,10,11,22,-11,22
Din Moscow,7864,9,5,6,9,18,25,-7,21
Rostov,7864,10,4,7,9,11,18,-7,19
Anzhi,7864,11,2,6,12,16,42,-26,12
Loko Moscow,7865,1,12,6,2,32,11,21,42
CSKA Moscow,7865,2,10,4,6,26,19,7,34
Spart Moscow,7865,3,9,6,5,36,28,8,33
Zenit,7865,4,8,8,4,22,16,6,32
Krasnodar,7865,5,8,6,6,29,26,3,30
Terek Grozny,7865,6,8,6,6,22,23,-1,30
Din Moscow,7865,7,6,7,7,19,22,-3,25
FK Rubin,7865,8,5,6,9,23,20,3,21
Rostov,7865,9,5,6,9,11,17,-6,21
Amkar,7865,10,4,5,11,11,25,-14,17
Anzhi,7865,11,2,6,12,15,39,-24,12
Loko Moscow,7866,1,11,6,3,31,14,17,39
CSKA Moscow,7866,2,12,3,5,33,18,15,39
Spart Moscow,7866,3,9,5,6,39,31,8,32
Zenit,7866,4,8,8,4,23,16,7,32
Krasnodar,7866,5,8,6,6,29,26,3,30
Terek Grozny,7866,6,7,6,7,21,24,-3,27
FK Rubin,7866,7,6,6,8,24,19,5,24
Rostov,7866,8,5,6,9,12,18,-6,21
Din Moscow,7866,9,5,6,9,20,27,-7,21
Amkar,7866,10,5,5,10,12,24,-12,20
Anzhi,7866,11,3,5,12,16,43,-27,14
Loko Moscow,7867,1,12,6,2,35,13,22,42
Zenit,7867,2,8,9,3,25,14,11,33
CSKA Moscow,7867,3,10,3,7,25,21,4,33
Spart Moscow,7867,4,8,6,6,37,33,4,30
Krasnodar,7867,5,8,4,8,28,30,-2,28
Terek Grozny,7867,6,7,7,6,22,24,-2,28
Din Moscow,7867,7,7,6,7,21,22,-1,27
FK Rubin,7867,8,6,5,9,23,19,4,23
Amkar,7867,9,5,5,10,13,24,-11,20
Rostov,7867,10,4,7,9,13,20,-7,19
Anzhi,7867,11,3,6,11,16,38,-22,15
Loko Moscow,7868,1,11,5,4,33,17,16,38
CSKA Moscow,7868,2,10,5,5,26,18,8,35
Spart Moscow,7868,3,9,7,4,34,25,9,34
Zenit,7868,4,8,9,3,24,15,9,33
Krasnodar,7868,5,9,5,6,31,27,4,32
Terek Grozny,7868,6,7,6,7,22,25,-3,27
FK Rubin,7868,7,5,7,8,23,19,4,22
Din Moscow,7868,8,5,7,8,18,23,-5,22
Amkar,7868,9,5,5,10,11,23,-12,20
Rostov,7868,10,4,7,9,10,17,-7,19
Anzhi,7868,11,2,7,11,16,39,-23,13
Loko Moscow,7869,1,12,5,3,31,13,18,41
CSKA Moscow,7869,2,11,3,6,27,18,9,36
Spart Moscow,7869,3,9,6,5,38,28,10,33
Zenit,7869,4,8,8,4,22,15,7,32
Krasnodar,7869,5,9,4,7,30,28,2,31
FK Rubin,7869,6,7,5,8,26,18,8,26
Terek Grozny,7869,7,7,5,8,21,27,-6,26
Din Moscow,7869,8,6,6,8,19,23,-4,24
Rostov,7869,9,4,7,9,11,18,-7,19
Amkar,7869,10,5,4,11,11,26,-15,19
Anzhi,7869,11,3,5,12,17,39,-22,14
Loko Moscow,7870,1,12,6,2,32,12,20,42
Spart Moscow,7870,2,10,6,4,38,28,10,36
CSKA Moscow,7870,3,10,4,6,25,18,7,34
Zenit,7870,4,8,8,4,22,15,7,32
Krasnodar,7870,5,9,5,6,33,28,5,32
Terek Grozny,7870,6,7,5,8,20,25,-5,26
Din Moscow,7870,7,6,6,8,19,23,-4,24
FK Rubin,7870,8,5,5,10,24,23,1,20
Amkar,7870,9,5,5,10,13,24,-11,20
Rostov,7870,10,4,6,10,10,18,-8,18
Anzhi,7870,11,3,6,11,15,37,-22,15
Loko Moscow,7871,1,11,5,4,31,16,15,38
Spart Moscow,7871,2,11,5,4,38,25,13,38
CSKA Moscow,7871,3,11,4,5,29,18,11,37
Zenit,7871,4,8,9,3,24,15,9,33
Krasnodar,7871,5,9,4,7,30,26,4,31
Terek Grozny,7871,6,8,5,7,24,25,-1,29
FK Rubin,7871,7,6,6,8,22,17,5,24
Din Moscow,7871,8,5,7,8,17,22,-5,22
Amkar,7871,9,5,4,11,11,24,-13,19
Rostov,7871,10,4,6,10,10,19,-9,18
Anzhi,7871,11,2,5,13,15,44,-29,11
Loko Moscow,7872,1,12,6,2,32,12,20,42
CSKA Moscow,7872,2,11,4,5,30,18,12,37
Spart Moscow,7872,3,9,6,5,35,27,8,33
Zenit,7872,4,7,10,3,22,14,8,31
Terek Grozny,7872,5,8,5,7,22,26,-4,29
Krasnodar,7872,6,8,4,8,28,28,0,28
FK Rubin,7872,7,7,5,8,24,18,6,26
Din Moscow,7872,8,5,6,9,19,25,-6,21
Rostov,7872,9,4,7,9,10,17,-7,19
Amkar,7872,10,5,4,11,10,23,-13,19
Anzhi,7872,11,3,5,12,18,42,-24,14
Loko Moscow,7873,1,12,6,2,32,12,20,42
CSKA Moscow,7873,2,11,4,5,28,18,10,37
Zenit,7873,3,7,10,3,23,15,8,31
Spart Moscow,7873,4,8,5,7,35,32,3,29
Terek Grozny,7873,5,8,5,7,23,27,-4,29
Krasnodar,7873,6,8,4,8,28,29,-1,28
Din Moscow,7873,7,7,6,7,24,23,1,27
FK Rubin,7873,8,6,5,9,24,21,3,23
Amkar,7873,9,6,4,10,15,23,-8,22
Rostov,7873,10,5,6,9,11,17,-6,21
Anzhi,7873,11,2,5,13,15,41,-26,11
Loko Moscow,7874,1,11,5,4,30,17,13,38
Spart Moscow,7874,2,11,5,4,37,25,12,38
CSKA Moscow,7874,3,11,3,6,28,20,8,36
Zenit,7874,4,9,8,3,26,13,13,35
Krasnodar,7874,5,10,4,6,32,25,7,34
Terek Grozny,7874,6,9,5,6,23,22,1,32
FK Rubin,7874,7,6,5,9,23,18,5,23
Din Moscow,7874,8,5,6,9,17,24,-7,21
Rostov,7874,9,4,6,10,10,19,-9,18
Amkar,7874,10,4,4,12,9,25,-16,16
Anzhi,7874,11,2,5,13,14,41,-27,11
Loko Moscow,7875,1,12,6,2,34,14,20,42
CSKA Moscow,7875,2,12,3,5,31,19,12,39
Spart Moscow,7875,3,10,5,5,40,27,13,35
Krasnodar,7875,4,8,6,6,31,28,3,30
Zenit,7875,5,7,8,5,22,18,4,29
Din Moscow,7875,6,7,6,7,22,23,-1,27
Terek Grozny,7875,7,7,6,7,20,26,-6,27
FK Rubin,7875,8,5,6,9,23,21,2,21
Amkar,7875,9,5,4,11,13,23,-10,19
Rostov,7875,10,4,6,10,10,22,-12,18
Anzhi,7875,11,2,6,12,15,40,-25,12
Loko Moscow,7876,1,12,6,2,31,12,19,42
Spart Moscow,7876,2,11,5,4,37,25,12,38
CSKA Moscow,7876,3,11,3,6,27,19,8,36
Zenit,7876,4,8,8,4,23,15,8,32
Krasnodar,7876,5,9,5,6,29,25,4,32
Terek Grozny,7876,6,9,5,6,24,22,2,32
Din Moscow,7876,7,5,7,8,19,24,-5,22
FK Rubin,7876,8,5,6,9,24,21,3,21
Rostov,7876,9,4,6,10,10,18,-8,18
Amkar,7876,10,4,4,12,9,27,-18,16
Anzhi,7876,11,2,5,13,15,40,-25,11
Loko Moscow,7877,1,13,5,2,33,12,21,44
Spart Moscow,7877,2,10,6,4,41,27,14,36
CSKA Moscow,7877,3,11,3,6,28,20,8,36
Zenit,7877,4,8,8,4,22,14,8,32
Krasnodar,7877,5,9,4,7,31,27,4,31
Terek Grozny,7877,6,8,5,7,24,23,1,29
Din Moscow,7877,7,5,8,7,18,22,-4,23
FK Rubin,7877,8,5,6,9,21,20,1,21
Amkar,7877,9,5,4,11,10,26,-16,19
Rostov,7877,10,4,6,10,11,20,-9,18
Anzhi,7877,11,2,5,13,16,44,-28,11
Loko Moscow,7878,1,11,7,2,30,12,18,40
CSKA Moscow,7878,2,12,3,5,29,17,12,39
Spart Moscow,7878,3,10,5,5,38,29,9,35
Zenit,7878,4,7,9,4,21,16,5,30
Terek Grozny,7878,5,8,6,6,22,23,-1,30
Krasnodar,7878,6,8,5,7,28,27,1,29
FK Rubin,7878,7,7,5,8,25,18,7,26
Din Moscow,7878,8,6,6,8,21,23,-2,24
Rostov,7878,9,4,6,10,11,20,-9,18
Amkar,7878,10,4,4,12,10,26,-16,16
Anzhi,7878,11,2,6,12,14,38,-24,12
Loko Moscow,7879,1,11,7,2,31,13,18,40
CSKA Moscow,7879,2,11,4,5,26,17,9,37
Spart Moscow,7879,3,9,7,4,38,27,11,34
Zenit,7879,4,7,10,3,22,14,8,31
Terek Grozny,7879,5,8,6,6,22,22,0,30
Krasnodar,7879,6,8,5,7,29,28,1,29
Din Moscow,7879,7,6,7,7,19,22,-3,25
FK Rubin,7879,8,6,5,9,24,19,5,23
Rostov,7879,9,4,6,10,11,21,-10,18
Amkar,7879,10,4,5,11,9,24,-15,17
Anzhi,7879,11,2,6,12,14,38,-24,12
Loko Moscow,7880,1,11,5,4,31,17,14,38
Spart Moscow,7880,2,10,6,4,36,26,10,36
Zenit,7880,3,9,8,3,26,14,12,35
Krasnodar,7880,4,10,4,6,33,25,8,34
CSKA Moscow,7880,5,10,4,6,26,19,7,34
Terek Grozny,7880,6,7,5,8,21,27,-6,26
FK Rubin,7880,7,6,5,9,22,21,1,23
Din Moscow,7880,8,5,6,9,17,23,-6,21
Rostov,7880,9,4,7,9,10,17,-7,19
Amkar,7880,10,5,4,11,12,24,-12,19
Anzhi,7880,11,3,6,11,18,39,-21,15
Loko Moscow,7881,1,11,6,3,30,13,17,39
Spart Moscow,7881,2,10,6,4,39,27,12,36
CSKA Moscow,7881,3,11,3,6,29,19,10,36
Zenit,7881,4,9,8,3,24,14,10,35
Krasnodar,7881,5,9,5,6,30,26,4,32
Terek Grozny,7881,6,8,5,7,23,24,-1,29
Din Moscow,7881,7,5,8,7,18,22,-4,23
FK Rubin,7881,8,5,6,9,22,19,3,21
Rostov,7881,9,4,6,10,10,19,-9,18
Amkar,7881,10,4,4,12,10,27,-17,16
Anzhi,7881,11,3,5,12,16,41,-25,14
Loko Moscow,7882,1,11,6,3,30,13,17,39
Zenit,7882,2,9,8,3,28,13,15,35
Spart Moscow,7882,3,10,5,5,38,27,11,35
CSKA Moscow,7882,4,10,4,6,26,24,2,34
Terek Grozny,7882,5,9,5,6,24,22,2,32
Krasnodar,7882,6,8,6,6,28,25,3,30
FK Rubin,7882,7,5,7,8,23,19,4,22
Din Moscow,7882,8,5,7,8,19,24,-5,22
Rostov,7882,9,5,6,9,11,17,-6,21
Amkar,7882,10,4,4,12,10,27,-17,16
Anzhi,7882,11,2,6,12,15,41,-26,12
Loko Moscow,7883,1,11,6,3,30,13,17,39
Spart Moscow,7883,2,11,5,4,38,27,11,38
CSKA Moscow,7883,3,10,4,6,28,22,6,34
Krasnodar,7883,4,10,4,6,29,24,5,34
Zenit,7883,5,8,9,3,24,14,10,33
Terek Grozny,7883,6,7,6,7,20,23,-3,27
FK Rubin,7883,7,6,5,9,22,18,4,23
Din Moscow,7883,8,5,6,9,18,24,-6,21
Amkar,7883,9,5,4,11,10,23,-13,19
Rostov,7883,10,4,6,10,11,19,-8,18
Anzhi,7883,11,2,7,11,17,40,-23,13
Loko Moscow,7884,1,12,5,3,32,16,16,41
CSKA Moscow,7884,2,10,5,5,26,18,8,35
Krasnodar,7884,3,10,4,6,33,26,7,34
Spart Moscow,7884,4,9,6,5,39,32,7,33
Zenit,7884,5,7,9,4,23,16,7,30
Terek Grozny,7884,6,8,5,7,21,23,-2,29
Din Moscow,7884,7,6,7,7,22,23,-1,25
FK Rubin,7884,8,5,5,10,22,22,0,20
Amkar,7884,9,5,4,11,14,24,-10,19
Rostov,7884,10,4,6,10,10,20,-10,18
Anzhi,7884,11,3,6,11,15,37,-22,15
Loko Moscow,7885,1,12,6,2,31,12,19,42
Spart Moscow,7885,2,10,6,4,36,26,10,36
CSKA Moscow,7885,3,11,3,6,27,19,8,36
Zenit,7885,4,8,8,4,22,14,8,32
Krasnodar,7885,5,8,6,6,29,26,3,30
Terek Grozny,7885,6,8,5,7,21,23,-2,29
FK Rubin,7885,7,6,6,8,25,18,7,24
Din Moscow,7885,8,5,6,9,17,25,-8,21
Amkar,7885,9,5,5,10,11,23,-12,20
Rostov,7885,10,4,6,10,10,18,-8,18
Anzhi,7885,11,2,5,13,15,40,-25,11
Loko Moscow,7886,1,12,5,3,31,13,18,41
Spart Moscow,7886,2,11,5,4,42,27,15,38
CSKA Moscow,7886,3,10,4,6,27,20,7,34
Zenit,7886,4,8,8,4,24,16,8,32
Krasnodar,7886,5,9,4,7,29,28,1,31
Terek Grozny,7886,6,8,6,6,23,23,0,30
Din Moscow,7886,7,6,6,8,21,24,-3,24
FK Rubin,7886,8,6,5,9,25,20,5,23
Rostov,7886,9,4,6,10,10,21,-11,18
Amkar,7886,10,4,5,11,10,25,-15,17
Anzhi,7886,11,2,6,12,15,40,-25,12
Loko Moscow,7887,1,11,7,2,33,15,18,40
Spart Moscow,7887,2,11,5,4,39,28,11,38
Zenit,7887,3,8,9,3,24,15,9,33
CSKA Moscow,7887,4,10,3,7,25,19,6,33
Krasnodar,7887,5,8,6,6,30,27,3,30
Terek Grozny,7887,6,8,6,6,23,24,-1,30
FK Rubin,7887,7,5,7,8,23,19,4,22
Din Moscow,7887,8,5,7,8,20,25,-5,22
Rostov,7887,9,4,6,10,11,19,-8,18
Amkar,7887,10,4,5,11,10,24,-14,17
Anzhi,7887,11,3,5,12,16,39,-23,14
Loko Moscow,7888,1,12,5,3,31,13,18,41
CSKA Moscow,7888,2,11,4,5,28,18,10,37
Spart Moscow,7888,3,9,6,5,38,28,10,33
Krasnodar,7888,4,9,4,7,30,27,3,31
Zenit,7888,5,7,9,4,22,15,7,30
Terek Grozny,7888,6,8,5,7,23,25,-2,29
Din Moscow,7888,7,6,6,8,20,26,-6,24
FK Rubin,7888,8,6,5,9,24,20,4,23
Rostov,7888,9,5,6,9,11,17,-6,21
Amkar,7888,10,4,5,11,11,26,-15,17
Anzhi,7888,11,3,5,12,16,39,-23,14
Loko Moscow,7889,1,11,6,3,29,13,16,39
CSKA Moscow,7889,2,11,4,5,26,17,9,37
Spart Moscow,7889,3,9,6,5,36,30,6,33
Krasnodar,7889,4,9,4,7,29,25,4,31
Zenit,7889,5,7,9,4,21,14,7,30
Terek Grozny,7889,6,8,5,7,22,26,-4,29
Din Moscow,7889,7,6,6,8,19,23,-4,24
FK Rubin,7889,8,6,5,9,22,18,4,23
Rostov,7889,9,4,7,9,11,18,-7,19
Amkar,7889,10,5,4,11,12,23,-11,19
Anzhi,7889,11,3,6,11,18,38,-20,15
Loko Moscow,7890,1,11,6,3,31,14,17,39
Spart Moscow,7890,2,11,5,4,41,26,15,38
Zenit,7890,3,9,8,3,24,14,10,35
CSKA Moscow,7890,4,10,3,7,25,19,6,33
Krasnodar,7890,5,8,5,7,28,26,2,29
Terek Grozny,7890,6,8,5,7,21,23,-2,29
Din Moscow,7890,7,6,6,8,18,25,-7,24
FK Rubin,7890,8,6,5,9,22,18,4,23
Rostov,7890,9,4,6,10,11,19,-8,18
Anzhi,7890,10,4,5,11,16,37,-21,17
Amkar,7890,11,4,4,12,9,25,-16,16
Loko Moscow,7891,1,11,5,4,29,13,16,38
CSKA Moscow,7891,2,11,4,5,28,19,9,37
Spart Moscow,7891,3,10,6,4,39,25,14,36
Krasnodar,7891,4,10,4,6,30,25,5,34
Zenit,7891,5,8,9,3,23,14,9,33
Terek Grozny,7891,6,8,6,6,22,23,-1,30
Din Moscow,7891,7,6,6,8,19,23,-4,24
FK Rubin,7891,8,5,5,10,22,21,1,20
Rostov,7891,9,4,6,10,10,21,-11,18
Amkar,7891,10,4,6,10,9,22,-13,18
Anzhi,7891,11,2,5,13,16,41,-25,11
Loko Moscow,7892,1,12,6,2,32,12,20,42
CSKA Moscow,7892,2,10,4,6,26,20,6,34
Zenit,7892,3,8,9,3,24,14,10,33
Spart Moscow,7892,4,9,6,5,39,31,8,33
Krasnodar,7892,5,9,4,7,28,26,2,31
Terek Grozny,7892,6,7,5,8,21,26,-5,26
FK Rubin,7892,7,6,5,9,23,19,4,23
Din Moscow,7892,8,5,7,8,20,25,-5,22
Rostov,7892,9,5,6,9,14,19,-5,21
Amkar,7892,10,5,4,11,10,24,-14,19
Anzhi,7892,11,3,6,11,18,39,-21,15
Loko Moscow,7893,1,13,5,2,35,13,22,44
Spart Moscow,7893,2,10,5,5,44,28,16,35
CSKA Moscow,7893,3,10,4,6,28,21,7,34
Zenit,7893,4,8,8,4,23,17,6,32
Terek Grozny,7893,5,9,5,6,23,23,0,32
Krasnodar,7893,6,9,4,7,31,28,3,31
FK Rubin,7893,7,6,5,9,23,19,4,23
Rostov,7893,8,5,6,9,12,18,-6,21
Din Moscow,7893,9,5,6,9,17,28,-11,21
Amkar,7893,10,4,4,12,10,27,-17,16
Anzhi,7893,11,2,6,12,17,41,-24,12
CSKA Moscow,7894,1,12,3,5,31,18,13,39
Loko Moscow,7894,2,11,5,4,30,16,14,38
Spart Moscow,7894,3,11,5,4,36,25,11,38
Krasnodar,7894,4,10,4,6,30,25,5,34
Zenit,7894,5,8,8,4,25,15,10,32
Terek Grozny,7894,6,8,5,7,22,24,-2,29
Din Moscow,7894,7,5,7,8,17,22,-5,22
FK Rubin,7894,8,5,6,9,21,18,3,21
Amkar,7894,9,5,4,11,11,23,-12,19
Rostov,7894,10,4,6,10,10,18,-8,18
Anzhi,7894,11,2,5,13,14,43,-29,11
Loko Moscow,7895,1,13,5,2,34,13,21,44
CSKA Moscow,7895,2,11,4,5,30,17,13,37
Spart Moscow,7895,3,9,6,5,38,30,8,33
Krasnodar,7895,4,9,4,7,29,26,3,31
Zenit,7895,5,7,9,4,22,16,6,30
Terek Grozny,7895,6,8,5,7,22,23,-1,29
Din Moscow,7895,7,6,7,7,21,24,-3,25
Amkar,7895,8,6,4,10,12,23,-11,22
FK Rubin,7895,9,5,5,10,21,19,2,20
Rostov,7895,10,4,6,10,10,18,-8,18
Anzhi,7895,11,2,5,13,14,44,-30,11
CSKA Moscow,7896,1,12,3,5,27,17,10,39
Loko Moscow,7896,2,11,5,4,30,14,16,38
Krasnodar,7896,3,10,4,6,31,26,5,34
Zenit,7896,4,8,8,4,22,14,8,32
Spart Moscow,7896,5,9,5,6,37,32,5,32
Terek Grozny,7896,6,7,6,7,24,27,-3,27
Din Moscow,7896,7,6,6,8,20,24,-4,24
Amkar,7896,8,6,4,10,14,24,-10,22
Rostov,7896,9,5,6,9,12,17,-5,21
FK Rubin,7896,10,5,5,10,22,20,2,20
Anzhi,7896,11,2,6,12,17,41,-24,12
Loko Moscow,7897,1,12,6,2,32,13,19,42
Spart Moscow,7897,2,10,6,4,38,27,11,36
CSKA Moscow,7897,3,11,3,6,31,20,11,36
Zenit,7897,4,8,8,4,24,15,9,32
Terek Grozny,7897,5,9,5,6,23,22,1,32
Krasnodar,7897,6,8,6,6,32,29,3,30
FK Rubin,7897,7,5,7,8,24,20,4,22
Din Moscow,7897,8,5,7,8,18,24,-6,22
Rostov,7897,9,4,7,9,11,18,-7,19
Amkar,7897,10,4,4,12,9,24,-15,16
Anzhi,7897,11,2,5,13,14,44,-30,11
Loko Moscow,7898,1,11,6,3,29,12,17,39
CSKA Moscow,7898,2,11,3,6,31,22,9,36
Spart Moscow,7898,3,10,5,5,37,27,10,35
Krasnodar,7898,4,10,4,6,30,25,5,34
Zenit,7898,5,8,9,3,23,14,9,33
Terek Grozny,7898,6,7,6,7,23,27,-4,27
Din Moscow,7898,7,6,6,8,19,24,-5,24
FK Rubin,7898,8,6,5,9,25,20,5,23
Rostov,7898,9,4,6,10,10,19,-9,18
Amkar,7898,10,4,5,11,11,25,-14,17
Anzhi,7898,11,3,5,12,21,44,-23,14
Loko Moscow,7899,1,11,7,2,29,11,18,40
CSKA Moscow,7899,2,10,4,6,25,19,6,34
Zenit,7899,3,8,9,3,23,13,10,33
Krasnodar,7899,4,9,5,6,30,25,5,32
Spart Moscow,7899,5,8,6,6,36,30,6,30
Terek Grozny,7899,6,8,6,6,25,23,2,30
Din Moscow,7899,7,7,6,7,19,21,-2,27
Rostov,7899,8,5,6,9,12,18,-6,21
FK Rubin,7899,9,5,5,10,22,21,1,20
Amkar,7899,10,4,6,10,11,24,-13,18
Anzhi,7899,11,2,6,12,15,42,-27,12
Loko Moscow,7900,1,12,5,3,31,13,18,41
CSKA Moscow,7900,2,11,4,5,32,19,13,37
Spart Moscow,7900,3,10,5,5,37,26,11,35
Krasnodar,7900,4,9,4,7,30,27,3,31
Zenit,7900,5,7,9,4,22,15,7,30
Terek Grozny,7900,6,7,5,8,22,27,-5,26
Din Moscow,7900,7,6,6,8,19,24,-5,24
FK Rubin,7900,8,6,5,9,24,20,4,23
Amkar,7900,9,6,4,10,12,22,-10,22
Rostov,7900,10,4,6,10,10,19,-9,18
Anzhi,7900,11,3,5,12,18,45,-27,14
Loko Moscow,7901,1,11,6,3,33,18,15,39
Spart Moscow,7901,2,10,5,5,40,29,11,35
Krasnodar,7901,3,10,4,6,35,27,8,34
CSKA Moscow,7901,4,10,4,6,26,19,7,34
Zenit,7901,5,7,10,3,23,15,8,31
Terek Grozny,7901,6,8,5,7,22,25,-3,29
Din Moscow,7901,7,6,6,8,18,22,-4,24
FK Rubin,7901,8,5,5,10,21,20,1,20
Amkar,7901,9,5,4,11,13,26,-13,19
Rostov,7901,10,4,6,10,11,21,-10,18
Anzhi,7901,11,4,5,11,17,37,-20,17
Loko Moscow,7902,1,12,5,3,32,16,16,41
CSKA Moscow,7902,2,10,5,5,26,18,8,35
Spart Moscow,7902,3,9,7,4,36,26,10,34
Krasnodar,7902,4,9,4,7,31,26,5,31
Zenit,7902,5,7,9,4,22,15,7,30
Terek Grozny,7902,6,7,6,7,21,24,-3,27
FK Rubin,7902,7,7,5,8,23,17,6,26
Din Moscow,7902,8,5,7,8,17,22,-5,22
Rostov,7902,9,4,6,10,10,19,-9,18
Amkar,7902,10,4,6,10,11,24,-13,18
Anzhi,7902,11,3,6,11,16,38,-22,15
Loko Moscow,7903,1,11,6,3,29,12,17,39
Spart Moscow,7903,2,10,5,5,40,28,12,35
Zenit,7903,3,9,8,3,23,13,10,35
CSKA Moscow,7903,4,10,4,6,25,18,7,34
Krasnodar,7903,5,8,5,7,28,27,1,29
Terek Grozny,7903,6,8,5,7,21,23,-2,29
FK Rubin,7903,7,7,5,8,25,18,7,26
Amkar,7903,8,6,4,10,13,22,-9,22
Din Moscow,7903,9,5,6,9,17,25,-8,21
Rostov,7903,10,4,6,10,10,21,-11,18
Anzhi,7903,11,2,6,12,14,38,-24,12
Loko Moscow,7904,1,12,5,3,30,12,18,41
Spart Moscow,7904,2,10,6,4,40,28,12,36
CSKA Moscow,7904,3,11,3,6,30,20,10,36
Krasnodar,7904,4,10,4,6,30,24,6,34
Zenit,7904,5,8,8,4,24,15,9,32
Terek Grozny,7904,6,8,6,6,22,23,-1,30
Din Moscow,7904,7,5,7,8,20,27,-7,22
FK Rubin,7904,8,5,6,9,22,20,2,21
Rostov,7904,9,4,7,9,11,18,-7,19
Amkar,7904,10,4,4,12,9,24,-15,16
Anzhi,7904,11,2,6,12,15,42,-27,12
CSKA Moscow,7905,1,12,3,5,29,17,12,39
Loko Moscow,7905,2,11,5,4,29,13,16,38
Spart Moscow,7905,3,9,7,4,38,29,9,34
Zenit,7905,4,8,8,4,22,14,8,32
Krasnodar,7905,5,9,5,6,29,25,4,32
Terek Grozny,7905,6,8,5,7,22,25,-3,29
FK Rubin,7905,7,6,6,8,24,18,6,24
Din Moscow,7905,8,5,7,8,19,25,-6,22
Amkar,7905,9,5,5,10,11,22,-11,20
Rostov,7905,10,4,6,10,12,20,-8,18
Anzhi,7905,11,2,5,13,15,42,-27,11
Loko Moscow,7906,1,11,7,2,31,13,18,40
CSKA Moscow,7906,2,11,3,6,29,19,10,36
Zenit,7906,3,8,9,3,24,15,9,33
Spart Moscow,7906,4,8,7,5,35,29,6,31
Krasnodar,7906,5,8,6,6,29,26,3,30
Terek Grozny,7906,6,7,6,7,20,24,-4,27
Din Moscow,7906,7,6,7,7,19,21,-2,25
FK Rubin,7906,8,5,7,8,22,18,4,22
Rostov,7906,9,4,7,9,11,18,-7,19
Amkar,7906,10,4,6,10,10,23,-13,18
Anzhi,7906,11,3,5,12,16,40,-24,14
Loko Moscow,7907,1,12,5,3,32,14,18,41
Zenit,7907,2,9,8,3,26,14,12,35
Spart Moscow,7907,3,9,6,5,37,30,7,33
CSKA Moscow,7907,4,10,3,7,25,21,4,33
Krasnodar,7907,5,8,5,7,30,28,2,29
Terek Grozny,7907,6,8,5,7,22,25,-3,29
Din Moscow,7907,7,6,7,7,18,21,-3,25
Amkar,7907,8,6,4,10,17,24,-7,22
FK Rubin,7907,9,5,6,9,23,20,3,21
Rostov,7907,10,4,6,10,10,19,-9,18
Anzhi,7907,11,3,5,12,15,39,-24,14
Loko Moscow,7908,1,12,5,3,32,15,17,41
Spart Moscow,7908,2,11,5,4,39,25,14,38
CSKA Moscow,7908,3,11,3,6,28,19,9,36
Krasnodar,7908,4,10,4,6,31,25,6,34
Zenit,7908,5,8,8,4,24,15,9,32
Terek Grozny,7908,6,9,5,6,23,22,1,32
Din Moscow,7908,7,6,6,8,20,24,-4,24
FK Rubin,7908,8,5,5,10,22,21,1,20
Rostov,7908,9,4,6,10,10,19,-9,18
Amkar,7908,10,4,4,12,9,26,-17,16
Anzhi,7908,11,2,5,13,14,41,-27,11
Loko Moscow,7909,1,11,5,4,31,15,16,38
CSKA Moscow,7909,2,11,4,5,28,18,10,37
Spart Moscow,7909,3,10,5,5,37,28,9,35
Zenit,7909,4,8,8,4,23,16,7,32
Krasnodar,7909,5,9,5,6,30,26,4,32
Din Moscow,7909,6,7,6,7,21,22,-1,27
Terek Grozny,7909,7,7,5,8,22,27,-5,26
FK Rubin,7909,8,5,6,9,22,19,3,21
Amkar,7909,9,5,4,11,12,24,-12,19
Rostov,7909,10,4,6,10,10,19,-9,18
Anzhi,7909,11,3,6,11,17,39,-22,15
Loko Moscow,7910,1,12,5,3,32,15,17,41
Spart Moscow,7910,2,10,6,4,38,28,10,36
CSKA Moscow,7910,3,11,3,6,27,19,8,36
Zenit,7910,4,9,8,3,26,14,12,35
Krasnodar,7910,5,9,4,7,29,26,3,31
Terek Grozny,7910,6,8,6,6,24,24,0,30
FK Rubin,7910,7,6,5,9,23,18,5,23
Din Moscow,7910,8,5,6,9,18,25,-7,21
Rostov,7910,9,4,7,9,12,19,-7,19
Amkar,7910,10,4,5,11,10,24,-14,17
Anzhi,7910,11,2,5,13,15,42,-27,11
Spart Moscow,7911,1,11,5,4,39,26,13,38
Loko Moscow,7911,2,11,5,4,30,17,13,38
CSKA Moscow,7911,3,11,3,6,27,21,6,36
Zenit,7911,4,9,8,3,29,13,16,35
Krasnodar,7911,5,9,4,7,29,28,1,31
Terek Grozny,7911,6,8,6,6,23,24,-1,30
FK Rubin,7911,7,6,6,8,24,17,7,24
Din Moscow,7911,8,5,7,8,18,23,-5,22
Rostov,7911,9,4,6,10,10,18,-8,18
Amkar,7911,10,4,5,11,9,25,-16,17
Anzhi,7911,11,2,5,13,16,42,-26,11
Loko Moscow,7912,1,13,5,2,32,12,20,44
Spart Moscow,7912,2,10,6,4,40,26,14,36
CSKA Moscow,7912,3,10,5,5,27,19,8,35
Zenit,7912,4,7,9,4,23,16,7,30
Terek Grozny,7912,5,8,6,6,22,23,-1,30
Krasnodar,7912,6,8,5,7,28,26,2,29
FK Rubin,7912,7,5,7,8,23,19,4,22
Din Moscow,7912,8,5,7,8,19,24,-5,22
Rostov,7912,9,4,6,10,10,22,-12,18
Amkar,7912,10,4,6,10,10,23,-13,18
Anzhi,7912,11,2,6,12,15,39,-24,12
Loko Moscow,7913,1,11,6,3,30,13,17,39
CSKA Moscow,7913,2,12,3,5,28,17,11,39
Spart Moscow,7913,3,10,6,4,39,29,10,36
Zenit,7913,4,8,8,4,23,16,7,32
Krasnodar,7913,5,9,5,6,28,24,4,32
Terek Grozny,7913,6,7,5,8,20,25,-5,26
Din Moscow,7913,7,6,6,8,20,23,-3,24
FK Rubin,7913,8,5,5,10,21,20,1,20
Rostov,7913,9,4,7,9,10,17,-7,19
Amkar,7913,10,5,4,11,14,26,-12,19
Anzhi,7913,11,3,5,12,15,38,-23,14
Loko Moscow,7914,1,13,5,2,33,12,21,44
CSKA Moscow,7914,2,11,4,5,27,18,9,37
Spart Moscow,7914,3,10,5,5,42,28,14,35
Krasnodar,7914,4,9,4,7,30,25,5,31
Zenit,7914,5,7,9,4,22,16,6,30
Terek Grozny,7914,6,7,6,7,21,25,-4,27
Din Moscow,7914,7,6,6,8,18,24,-6,24
FK Rubin,7914,8,5,5,10,21,21,0,20
Amkar,7914,9,5,5,10,12,24,-12,20
Rostov,7914,10,4,6,10,11,22,-11,18
Anzhi,7914,11,3,5,12,17,39,-22,14
Loko Moscow,7915,1,11,5,4,30,15,15,38
CSKA Moscow,7915,2,11,4,5,29,19,10,37
Krasnodar,7915,3,10,4,6,31,24,7,34
Zenit,7915,4,8,9,3,25,16,9,33
Spart Moscow,7915,5,8,8,4,36,28,8,32
Terek Grozny,7915,6,7,6,7,22,25,-3,27
Din Moscow,7915,7,6,7,7,20,22,-2,25
FK Rubin,7915,8,5,5,10,21,21,0,20
Amkar,7915,9,5,5,10,13,25,-12,20
Rostov,7915,10,4,7,9,10,17,-7,19
Anzhi,7915,11,2,6,12,15,40,-25,12
Loko Moscow,7916,1,13,5,2,34,12,22,44
Spart Moscow,7916,2,10,5,5,44,30,14,35
CSKA Moscow,7916,3,10,3,7,25,20,5,33
Zenit,7916,4,8,8,4,24,16,8,32
Terek Grozny,7916,5,8,5,7,26,27,-1,29
Krasnodar,7916,6,8,4,8,28,28,0,28
FK Rubin,7916,7,7,5,8,25,19,6,26
Din Moscow,7916,8,6,6,8,22,24,-2,24
Rostov,7916,9,4,6,10,10,22,-12,18
Anzhi,7916,10,4,5,11,18,39,-21,17
Amkar,7916,11,4,4,12,12,31,-19,16
Loko Moscow,7917,1,12,5,3,31,14,17,41
Spart Moscow,7917,2,9,7,4,39,29,10,34
CSKA Moscow,7917,3,10,4,6,26,20,6,34
Zenit,7917,4,8,8,4,24,15,9,32
Krasnodar,7917,5,9,4,7,29,26,3,31
FK Rubin,7917,6,7,5,8,24,17,7,26
Terek Grozny,7917,7,7,5,8,23,29,-6,26
Din Moscow,7917,8,5,6,9,19,26,-7,21
Amkar,7917,9,5,5,10,14,25,-11,20
Rostov,7917,10,4,7,9,11,18,-7,19
Anzhi,7917,11,3,6,11,18,39,-21,15
Loko Moscow,7918,1,12,5,3,30,12,18,41
CSKA Moscow,7918,2,11,4,5,28,17,11,37
Krasnodar,7918,3,10,4,6,30,24,6,34
Spart Moscow,7918,4,9,5,6,37,29,8,32
Zenit,7918,5,7,9,4,21,14,7,30
Terek Grozny,7918,6,7,6,7,21,24,-3,27
Din Moscow,7918,7,5,7,8,19,25,-6,22
FK Rubin,7918,8,5,6,9,22,20,2,21
Rostov,7918,9,5,6,9,12,18,-6,21
Amkar,7918,10,5,5,10,11,23,-12,20
Anzhi,7918,11,3,5,12,15,40,-25,14
Loko Moscow,7919,1,12,6,2,33,14,19,42
CSKA Moscow,7919,2,11,4,5,27,18,9,37
Spart Moscow,7919,3,10,6,4,37,27,10,36
Krasnodar,7919,4,9,5,6,31,27,4,32
Zenit,7919,5,7,9,4,23,16,7,30
Terek Grozny,7919,6,7,7,6,22,24,-2,28
Din Moscow,7919,7,5,7,8,19,24,-5,22
FK Rubin,7919,8,5,6,9,24,21,3,21
Rostov,7919,9,4,6,10,12,20,-8,18
Amkar,7919,10,4,6,10,10,23,-13,18
Anzhi,7919,11,2,6,12,15,39,-24,12
Loko Moscow,7920,1,11,6,3,32,15,17,39
CSKA Moscow,7920,2,11,3,6,28,20,8,36
Zenit,7920,3,9,8,3,24,14,10,35
Spart Moscow,7920,4,10,5,5,36,27,9,35
Krasnodar,7920,5,9,5,6,32,28,4,32
Terek Grozny,7920,6,8,6,6,21,22,-1,30
FK Rubin,7920,7,6,5,9,26,20,6,23
Din Moscow,7920,8,5,6,9,18,26,-8,21
Amkar,7920,9,5,4,11,10,23,-13,19
Rostov,7920,10,4,6,10,11,19,-8,18
Anzhi,7920,11,2,6,12,15,39,-24,12
Loko Moscow,7921,1,11,6,3,30,13,17,39
CSKA Moscow,7921,2,11,3,6,28,20,8,36
Krasnodar,7921,3,10,4,6,32,24,8,34
Zenit,7921,4,8,9,3,24,15,9,33
Spart Moscow,7921,5,9,5,6,39,36,3,32
Terek Grozny,7921,6,8,5,7,22,23,-1,29
Din Moscow,7921,7,7,6,7,24,23,1,27
Amkar,7921,8,6,4,10,14,23,-9,22
FK Rubin,7921,9,5,5,10,21,22,-1,20
Rostov,7921,10,4,6,10,11,20,-9,18
Anzhi,7921,11,2,5,13,15,41,-26,11
Loko Moscow,7922,1,12,5,3,31,12,19,41
Spart Moscow,7922,2,9,7,4,35,26,9,34
CSKA Moscow,7922,3,10,4,6,26,19,7,34
Zenit,7922,4,8,9,3,22,13,9,33
Krasnodar,7922,5,9,4,7,31,27,4,31
Terek Grozny,7922,6,7,6,7,24,29,-5,27
Din Moscow,7922,7,5,8,7,18,22,-4,23
FK Rubin,7922,8,5,6,9,22,21,1,21
Amkar,7922,9,5,5,10,14,24,-10,20
Rostov,7922,10,4,6,10,10,18,-8,18
Anzhi,7922,11,3,6,11,18,40,-22,15
Loko Moscow,7923,1,13,5,2,33,13,20,44
CSKA Moscow,7923,2,11,3,6,28,20,8,36
Spart Moscow,7923,3,10,5,5,38,26,12,35
Zenit,7923,4,7,8,5,23,17,6,29
Krasnodar,7923,5,8,4,8,28,28,0,28
Din Moscow,7923,6,7,6,7,20,21,-1,27
Terek Grozny,7923,7,7,5,8,20,26,-6,26
FK Rubin,7923,8,6,5,9,23,19,4,23
Amkar,7923,9,5,4,11,12,25,-13,19
Rostov,7923,10,4,6,10,10,19,-9,18
Anzhi,7923,11,4,5,11,17,38,-21,17
Loko Moscow,7924,1,11,6,3,30,13,17,39
Spart Moscow,7924,2,11,5,4,39,26,13,38
CSKA Moscow,7924,3,10,5,5,27,19,8,35
Krasnodar,7924,4,10,4,6,30,24,6,34
Zenit,7924,5,7,10,3,23,15,8,31
Terek Grozny,7924,6,8,6,6,22,23,-1,30
FK Rubin,7924,7,6,5,9,23,20,3,23
Din Moscow,7924,8,5,6,9,18,24,-6,21
Rostov,7924,9,4,6,10,10,19,-9,18
Amkar,7924,10,4,4,12,10,26,-16,16
Anzhi,7924,11,2,7,11,16,39,-23,13
Loko Moscow,7925,1,12,5,3,30,12,18,41
Spart Moscow,7925,2,10,6,4,39,28,11,36
CSKA Moscow,7925,3,11,3,6,28,21,7,36
Krasnodar,7925,4,10,4,6,30,24,6,34
Zenit,7925,5,8,8,4,24,15,9,32
Terek Grozny,7925,6,7,7,6,22,24,-2,28
FK Rubin,7925,7,6,5,9,23,19,4,23
Din Moscow,7925,8,5,7,8,19,25,-6,22
Rostov,7925,9,4,6,10,10,18,-8,18
Amkar,7925,10,4,5,11,11,26,-15,17
Anzhi,7925,11,2,6,12,16,40,-24,12
Loko Moscow,7926,1,12,5,3,32,12,20,41
CSKA Moscow,7926,2,11,4,5,28,19,9,37
Spart Moscow,7926,3,10,5,5,36,27,9,35
Zenit,7926,4,8,9,3,22,13,9,33
Krasnodar,7926,5,8,5,7,27,27,0,29
Terek Grozny,7926,6,7,6,7,20,24,-4,27
Din Moscow,7926,7,6,6,8,18,22,-4,24
Amkar,7926,8,6,4,10,13,22,-9,22
FK Rubin,7926,9,5,6,9,21,18,3,21
Rostov,7926,10,4,6,10,10,19,-9,18
Anzhi,7926,11,2,6,12,16,40,-24,12
Loko Moscow,7927,1,11,5,4,31,16,15,38
Spart Moscow,7927,2,11,5,4,36,25,11,38
CSKA Moscow,7927,3,11,3,6,29,21,8,36
Zenit,7927,4,9,8,3,26,15,11,35
Krasnodar,7927,5,9,4,7,31,27,4,31
Terek Grozny,7927,6,7,5,8,23,30,-7,26
Din Moscow,7927,7,6,6,8,20,23,-3,24
FK Rubin,7927,8,6,5,9,24,21,3,23
Amkar,7927,9,5,4,11,12,24,-12,19
Rostov,7927,10,4,6,10,10,18,-8,18
Anzhi,7927,11,3,5,12,20,42,-22,14
Loko Moscow,7928,1,11,7,2,30,12,18,40
Spart Moscow,7928,2,10,6,4,39,28,11,36
CSKA Moscow,7928,3,11,3,6,27,19,8,36
Zenit,7928,4,8,9,3,23,14,9,33
Krasnodar,7928,5,8,6,6,28,25,3,30
Terek Grozny,7928,6,7,5,8,22,26,-4,26
Din Moscow,7928,7,6,6,8,21,24,-3,24
FK Rubin,7928,8,5,6,9,22,20,2,21
Amkar,7928,9,5,5,10,12,24,-12,20
Rostov,7928,10,4,6,10,10,19,-9,18
Anzhi,7928,11,3,5,12,17,40,-23,14
CSKA Moscow,7929,1,12,3,5,28,18,10,39
Loko Moscow,7929,2,11,5,4,30,16,14,38
Krasnodar,7929,3,10,4,6,33,26,7,34
Zenit,7929,4,8,8,4,24,15,9,32
Spart Moscow,7929,5,9,5,6,36,29,7,32
Terek Grozny,7929,6,8,6,6,22,23,-1,30
FK Rubin,7929,7,6,5,9,24,20,4,23
Rostov,7929,8,5,6,9,12,18,-6,21
Din Moscow,7929,9,5,6,9,17,25,-8,21
Amkar,7929,10,5,5,10,12,23,-11,20
Anzhi,7929,11,2,5,13,14,39,-25,11
Loko Moscow,7930,1,11,6,3,29,14,15,39
CSKA Moscow,7930,2,12,3,5,29,17,12,39
Spart Moscow,7930,3,10,6,4,40,30,10,36
Krasnodar,7930,4,9,5,6,31,25,6,32
Zenit,7930,5,7,9,4,21,14,7,30
Terek Grozny,7930,6,8,6,6,25,24,1,30
Din Moscow,7930,7,6,6,8,20,24,-4,24
FK Rubin,7930,8,5,6,9,22,19,3,21
Rostov,7930,9,4,7,9,13,20,-7,19
Amkar,7930,10,4,4,12,9,26,-17,16
Anzhi,7930,11,2,6,12,16,42,-26,12
Loko Moscow,7931,1,12,5,3,31,14,17,41
Spart Moscow,7931,2,10,6,4,36,26,10,36
CSKA Moscow,7931,3,10,4,6,25,18,7,34
Krasnodar,7931,4,9,5,6,31,26,5,32
Zenit,7931,5,7,9,4,22,15,7,30
Terek Grozny,7931,6,8,5,7,22,24,-2,29
FK Rubin,7931,7,6,6,8,24,19,5,24
Din Moscow,7931,8,5,6,9,17,23,-6,21
Rostov,7931,9,4,6,10,10,18,-8,18
Amkar,7931,10,4,5,11,10,24,-14,17
Anzhi,7931,11,4,5,11,17,38,-21,17
Loko Moscow,7932,1,11,6,3,30,14,16,39
Zenit,7932,2,9,8,3,25,13,12,35
CSKA Moscow,7932,3,10,4,6,26,20,6,34
Spart Moscow,7932,4,9,5,6,38,32,6,32
Krasnodar,7932,5,9,5,6,29,25,4,32
Terek Grozny,7932,6,8,5,7,21,24,-3,29
Din Moscow,7932,7,7,6,7,26,23,3,27
FK Rubin,7932,8,5,5,10,21,22,-1,20
Amkar,7932,9,5,4,11,11,24,-13,19
Rostov,7932,10,4,6,10,10,19,-9,18
Anzhi,7932,11,3,6,11,17,38,-21,15
Loko Moscow,7933,1,13,5,2,35,12,23,44
Spart Moscow,7933,2,11,5,4,40,28,12,38
CSKA Moscow,7933,3,10,4,6,25,19,6,34
Krasnodar,7933,4,9,4,7,30,28,2,31
Zenit,7933,5,7,9,4,22,17,5,30
Terek Grozny,7933,6,8,5,7,21,25,-4,29
Din Moscow,7933,7,5,7,8,20,25,-5,22
FK Rubin,7933,8,5,6,9,25,22,3,21
Amkar,7933,9,5,4,11,13,24,-11,19
Rostov,7933,10,4,6,10,11,20,-9,18
Anzhi,7933,11,3,5,12,16,38,-22,14
Loko Moscow,7934,1,13,5,2,34,13,21,44
CSKA Moscow,7934,2,11,4,5,28,19,9,37
Spart Moscow,7934,3,10,5,5,39,28,11,35
Krasnodar,7934,4,9,4,7,30,28,2,31
Zenit,7934,5,7,9,4,22,15,7,30
Terek Grozny,7934,6,8,5,7,22,24,-2,29
Din Moscow,7934,7,5,7,8,19,25,-6,22
FK Rubin,7934,8,5,6,9,22,19,3,21
Rostov,7934,9,5,6,9,12,18,-6,21
Amkar,7934,10,5,4,11,11,24,-13,19
Anzhi,7934,11,2,5,13,15,41,-26,11
Loko Moscow,7935,1,12,5,3,31,12,19,41
CSKA Moscow,7935,2,11,3,6,28,20,8,36
Zenit,7935,3,8,8,4,23,16,7,32
Spart Moscow,7935,4,9,5,6,34,29,5,32
Krasnodar,7935,5,9,5,6,29,25,4,32
Terek Grozny,7935,6,8,5,7,23,23,0,29
Din Moscow,7935,7,6,7,7,21,23,-2,25
FK Rubin,7935,8,5,7,8,24,20,4,22
Amkar,7935,9,5,4,11,11,25,-14,19
Rostov,7935,10,4,6,10,10,18,-8,18
Anzhi,7935,11,3,5,12,16,39,-23,14
Loko Moscow,7936,1,13,5,2,32,12,20,44
Spart Moscow,7936,2,11,5,4,39,26,13,38
CSKA Moscow,7936,3,11,3,6,27,20,7,36
Zenit,7936,4,8,8,4,25,15,10,32
Krasnodar,7936,5,9,4,7,30,27,3,31
Terek Grozny,7936,6,8,5,7,21,23,-2,29
Din Moscow,7936,7,5,7,8,18,25,-7,22
FK Rubin,7936,8,5,6,9,23,20,3,21
Amkar,7936,9,5,4,11,10,23,-13,19
Rostov,7936,10,4,6,10,10,18,-8,18
Anzhi,7936,11,2,5,13,14,40,-26,11
Loko Moscow,7937,1,13,5,2,35,13,22,44
Spart Moscow,7937,2,11,5,4,41,27,14,38
CSKA Moscow,7937,3,10,3,7,25,21,4,33
Zenit,7937,4,8,8,4,26,17,9,32
Krasnodar,7937,5,9,4,7,28,26,2,31
Terek Grozny,7937,6,8,6,6,22,22,0,30
Din Moscow,7937,7,6,6,8,20,25,-5,24
FK Rubin,7937,8,5,5,10,22,20,2,20
Rostov,7937,9,4,6,10,10,18,-8,18
Amkar,7937,10,4,4,12,10,28,-18,16
Anzhi,7937,11,3,6,11,15,37,-22,15
Loko Moscow,7938,1,11,7,2,31,13,18,40
CSKA Moscow,7938,2,10,5,5,26,18,8,35
Krasnodar,7938,3,9,5,6,32,26,6,32
Zenit,7938,4,7,10,3,22,14,8,31
Spart Moscow,7938,5,8,7,5,34,29,5,31
Terek Grozny,7938,6,8,6,6,22,23,-1,30
Din Moscow,7938,7,5,8,7,18,22,-4,23
FK Rubin,7938,8,5,6,9,22,21,1,21
Rostov,7938,9,4,7,9,10,17,-7,19
Amkar,7938,10,5,4,11,13,24,-11,19
Anzhi,7938,11,2,7,11,15,38,-23,13
Loko Moscow,7939,1,12,6,2,33,14,19,42
Spart Moscow,7939,2,10,6,4,40,28,12,36
CSKA Moscow,7939,3,10,5,5,25,17,8,35
Krasnodar,7939,4,9,5,6,33,27,6,32
Zenit,7939,5,7,9,4,22,15,7,30
Terek Grozny,7939,6,8,5,7,21,23,-2,29
Din Moscow,7939,7,6,7,7,21,22,-1,25
FK Rubin,7939,8,5,5,10,22,24,-2,20
Rostov,7939,9,4,6,10,11,21,-10,18
Amkar,7939,10,4,4,12,10,25,-15,16
Anzhi,7939,11,3,6,11,15,37,-22,15
Loko Moscow,7940,1,11,6,3,29,13,16,39
Spart Moscow,7940,2,11,5,4,40,26,14,38
CSKA Moscow,7940,3,11,3,6,29,19,10,36
Zenit,7940,4,8,9,3,23,14,9,33
Krasnodar,7940,5,9,5,6,30,25,5,32
Terek Grozny,7940,6,7,6,7,20,23,-3,27
FK Rubin,7940,7,5,7,8,23,19,4,22
Din Moscow,7940,8,5,7,8,19,25,-6,22
Amkar,7940,9,5,4,11,10,23,-13,19
Rostov,7940,10,4,6,10,10,20,-10,18
Anzhi,7940,11,2,6,12,14,40,-26,12
Loko Moscow,7941,1,13,5,2,33,12,21,44
CSKA Moscow,7941,2,11,3,6,31,20,11,36
Spart Moscow,7941,3,9,7,4,40,30,10,34
Zenit,7941,4,8,8,4,24,17,7,32
Krasnodar,7941,5,8,5,7,31,29,2,29
Terek Grozny,7941,6,8,5,7,23,26,-3,29
Din Moscow,7941,7,6,6,8,20,24,-4,24
FK Rubin,7941,8,5,6,9,24,22,2,21
Rostov,7941,9,4,7,9,13,20,-7,19
Amkar,7941,10,4,5,11,11,26,-15,17
Anzhi,7941,11,3,5,12,17,41,-24,14
Loko Moscow,7942,1,12,5,3,33,14,19,41
Spart Moscow,7942,2,11,5,4,38,25,13,38
CSKA Moscow,7942,3,11,3,6,27,20,7,36
Zenit,7942,4,9,8,3,25,13,12,35
Krasnodar,7942,5,8,5,7,29,29,0,29
Terek Grozny,7942,6,7,7,6,22,24,-2,28
FK Rubin,7942,7,6,6,8,24,18,6,24
Din Moscow,7942,8,5,6,9,17,24,-7,21
Rostov,7942,9,4,6,10,10,19,-9,18
Amkar,7942,10,4,5,11,10,25,-15,17
Anzhi,7942,11,2,6,12,16,40,-24,12
Loko Moscow,7943,1,13,5,2,31,11,20,44
CSKA Moscow,7943,2,11,4,5,26,17,9,37
Spart Moscow,7943,3,9,7,4,36,26,10,34
Zenit,7943,4,7,8,5,21,15,6,29
Krasnodar,7943,5,8,5,7,28,26,2,29
Terek Grozny,7943,6,7,6,7,22,25,-3,27
FK Rubin,7943,7,6,6,8,25,18,7,24
Din Moscow,7943,8,5,6,9,17,26,-9,21
Amkar,7943,9,5,5,10,12,24,-12,20
Rostov,7943,10,4,7,9,10,17,-7,19
Anzhi,7943,11,2,7,11,15,38,-23,13
Loko Moscow,7944,1,11,6,3,29,12,17,39
CSKA Moscow,7944,2,11,4,5,28,19,9,37
Zenit,7944,3,8,9,3,23,14,9,33
Spart Moscow,7944,4,9,6,5,36,28,8,33
Krasnodar,7944,5,9,5,6,29,24,5,32
Terek Grozny,7944,6,7,7,6,21,23,-2,28
Din Moscow,7944,7,7,6,7,22,23,-1,27
FK Rubin,7944,8,5,5,10,22,22,0,20
Rostov,7944,9,4,7,9,11,18,-7,19
Amkar,7944,10,4,5,11,9,23,-14,17
Anzhi,7944,11,2,6,12,16,40,-24,12
Loko Moscow,7945,1,11,7,2,32,14,18,40
Spart Moscow,7945,2,11,5,4,41,28,13,38
CSKA Moscow,7945,3,11,3,6,26,18,8,36
Zenit,7945,4,8,9,3,23,14,9,33
Krasnodar,7945,5,8,6,6,30,27,3,30
Terek Grozny,7945,6,8,5,7,22,23,-1,29
FK Rubin,7945,7,5,7,8,23,19,4,22
Din Moscow,7945,8,5,7,8,19,25,-6,22
Amkar,7945,9,5,4,11,11,24,-13,19
Rostov,7945,10,4,6,10,11,20,-9,18
Anzhi,7945,11,2,5,13,14,40,-26,11
Loko Moscow,7946,1,12,5,3,32,14,18,41
Spart Moscow,7946,2,10,6,4,37,26,11,36
CSKA Moscow,7946,3,10,4,6,26,20,6,34
Zenit,7946,4,8,8,4,25,16,9,32
Krasnodar,7946,5,9,5,6,30,26,4,32
Terek Grozny,7946,6,8,6,6,23,24,-1,30
Din Moscow,7946,7,6,6,8,21,24,-3,24
FK Rubin,7946,8,5,6,9,23,21,2,21
Rostov,7946,9,4,6,10,10,19,-9,18
Amkar,7946,10,4,5,11,9,23,-14,17
Anzhi,7946,11,2,7,11,16,39,-23,13
Loko Moscow,7947,1,13,5,2,36,15,21,44
Spart Moscow,7947,2,11,5,4,39,27,12,38
CSKA Moscow,7947,3,11,3,6,27,20,7,36
Zenit,7947,4,8,8,4,25,15,10,32
Krasnodar,7947,5,9,4,7,31,29,2,31
Terek Grozny,7947,6,7,6,7,21,24,-3,27
Din Moscow,7947,7,6,6,8,19,22,-3,24
FK Rubin,7947,8,5,5,10,21,20,1,20
Rostov,7947,9,4,6,10,11,20,-9,18
Amkar,7947,10,4,5,11,10,24,-14,17
Anzhi,7947,11,3,5,12,16,40,-24,14
Loko Moscow,7948,1,12,5,3,31,14,17,41
CSKA Moscow,7948,2,12,3,5,29,17,12,39
Spart Moscow,7948,3,9,5,6,37,29,8,32
Krasnodar,7948,4,9,4,7,31,27,4,31
Zenit,7948,5,7,8,5,21,15,6,29
Terek Grozny,7948,6,7,6,7,21,24,-3,27
Din Moscow,7948,7,6,6,8,20,24,-4,24
FK Rubin,7948,8,6,5,9,23,20,3,23
Amkar,7948,9,6,4,10,12,23,-11,22
Rostov,7948,10,5,6,9,11,17,-6,21
Anzhi,7948,11,2,6,12,15,41,-26,12
Loko Moscow,7949,1,12,5,3,32,13,19,41
Spart Moscow,7949,2,10,6,4,39,28,11,36
CSKA Moscow,7949,3,10,4,6,25,18,7,34
Terek Grozny,7949,4,9,5,6,23,23,0,32
Krasnodar,7949,5,9,4,7,30,27,3,31
Zenit,7949,6,7,9,4,21,15,6,30
Din Moscow,7949,7,6,6,8,19,24,-5,24
FK Rubin,7949,8,6,5,9,23,19,4,23
Rostov,7949,9,4,7,9,11,18,-7,19
Amkar,7949,10,4,4,12,10,25,-15,16
Anzhi,7949,11,3,5,12,16,39,-23,14
Loko Moscow,7950,1,11,7,2,29,11,18,40
CSKA Moscow,7950,2,11,4,5,31,20,11,37
Spart Moscow,7950,3,9,6,5,37,30,7,33
Krasnodar,7950,4,9,5,6,29,24,5,32
Zenit,7950,5,7,10,3,23,15,8,31
Terek Grozny,7950,6,8,5,7,23,26,-3,29
Din Moscow,7950,7,6,7,7,19,21,-2,25
FK Rubin,7950,8,5,6,9,21,19,2,21
Rostov,7950,9,4,6,10,11,19,-8,18
Amkar,7950,10,4,5,11,13,27,-14,17
Anzhi,7950,11,3,5,12,17,41,-24,14
CSKA Moscow,7951,1,12,3,5,29,17,12,39
Loko Moscow,7951,2,11,5,4,30,16,14,38
Spart Moscow,7951,3,9,7,4,38,28,10,34
Zenit,7951,4,8,8,4,22,14,8,32
Krasnodar,7951,5,9,4,7,31,26,5,31
Terek Grozny,7951,6,8,6,6,21,22,-1,30
FK Rubin,7951,7,7,5,8,25,17,8,26
Din Moscow,7951,8,5,7,8,18,25,-7,22
Rostov,7951,9,4,6,10,11,20,-9,18
Amkar,7951,10,4,5,11,10,24,-14,17
Anzhi,7951,11,2,6,12,14,40,-26,12
Loko Moscow,7952,1,12,5,3,34,15,19,41
Spart Moscow,7952,2,10,6,4,38,25,13,36
CSKA Moscow,7952,3,11,3,6,27,20,7,36
Krasnodar,7952,4,9,5,6,30,26,4,32
Terek Grozny,7952,5,8,6,6,23,24,-1,30
Zenit,7952,6,7,8,5,23,18,5,29
Din Moscow,7952,7,6,6,8,20,24,-4,24
FK Rubin,7952,8,5,6,9,23,21,2,21
Rostov,7952,9,4,7,9,10,17,-7,19
Amkar,7952,10,4,4,12,10,27,-17,16
Anzhi,7952,11,3,6,11,18,39,-21,15
Loko Moscow,7953,1,11,6,3,31,15,16,39
CSKA Moscow,7953,2,11,4,5,29,17,12,37
Spart Moscow,7953,3,9,6,5,35,30,5,33
Krasnodar,7953,4,9,5,6,31,26,5,32
Zenit,7953,5,7,10,3,22,14,8,31
Terek Grozny,7953,6,7,6,7,22,25,-3,27
Din Moscow,7953,7,6,7,7,19,22,-3,25
FK Rubin,7953,8,5,6,9,23,20,3,21
Amkar,7953,9,5,5,10,14,23,-9,20
Rostov,7953,10,4,6,10,11,19,-8,18
Anzhi,7953,11,3,5,12,16,42,-26,14
Loko Moscow,7954,1,11,6,3,31,14,17,39
Spart Moscow,7954,2,11,5,4,42,28,14,38
CSKA Moscow,7954,3,11,4,5,29,20,9,37
Zenit,7954,4,8,9,3,24,15,9,33
Krasnodar,7954,5,8,6,6,29,26,3,30
Terek Grozny,7954,6,7,6,7,20,23,-3,27
Din Moscow,7954,7,6,6,8,21,25,-4,24
FK Rubin,7954,8,5,6,9,23,21,2,21
Amkar,7954,9,5,4,11,11,26,-15,19
Rostov,7954,10,4,6,10,11,19,-8,18
Anzhi,7954,11,2,6,12,16,40,-24,12
Loko Moscow,7955,1,13,5,2,35,12,23,44
Spart Moscow,7955,2,10,6,4,40,27,13,36
CSKA Moscow,7955,3,11,3,6,27,19,8,36
Zenit,7955,4,8,8,4,23,14,9,32
Krasnodar,7955,5,9,4,7,31,29,2,31
Terek Grozny,7955,6,8,6,6,22,23,-1,30
Din Moscow,7955,7,6,7,7,20,23,-3,25
FK Rubin,7955,8,5,5,10,22,22,0,20
Rostov,7955,9,4,6,10,10,21,-11,18
Amkar,7955,10,4,5,11,10,24,-14,17
Anzhi,7955,11,2,5,13,15,41,-26,11
Loko Moscow,7956,1,11,5,4,29,14,15,38
Spart Moscow,7956,2,10,6,4,37,27,10,36
Krasnodar,7956,3,10,4,6,31,24,7,34
CSKA Moscow,7956,4,10,4,6,25,19,6,34
Zenit,7956,5,8,9,3,22,13,9,33
Terek Grozny,7956,6,9,5,6,25,25,0,32
Din Moscow,7956,7,6,6,8,19,23,-4,24
FK Rubin,7956,8,5,5,10,21,20,1,20
Rostov,7956,9,4,7,9,10,17,-7,19
Amkar,7956,10,4,4,12,12,27,-15,16
Anzhi,7956,11,3,5,12,17,39,-22,14
Loko Moscow,7957,1,11,5,4,30,15,15,38
CSKA Moscow,7957,2,11,4,5,30,18,12,37
Spart Moscow,7957,3,10,5,5,36,27,9,35
Zenit,7957,4,8,9,3,23,14,9,33
Krasnodar,7957,5,9,4,7,30,27,3,31
Terek Grozny,7957,6,7,6,7,21,24,-3,27
FK Rubin,7957,7,7,5,8,26,17,9,26
Amkar,7957,8,6,4,10,12,22,-10,22
Din Moscow,7957,9,5,6,9,17,26,-9,21
Rostov,7957,10,4,6,10,10,18,-8,18
Anzhi,7957,11,2,6,12,15,42,-27,12
Loko Moscow,7958,1,11,7,2,33,15,18,40
CSKA Moscow,7958,2,10,4,6,28,21,7,34
Spart Moscow,7958,3,9,5,6,35,30,5,32
Terek Grozny,7958,4,9,5,6,23,22,1,32
Zenit,7958,5,7,10,3,25,17,8,31
Krasnodar,7958,6,8,6,6,29,26,3,30
FK Rubin,7958,7,6,6,8,22,17,5,24
Din Moscow,7958,8,5,6,9,18,24,-6,21
Rostov,7958,9,5,6,9,11,17,-6,21
Amkar,7958,10,5,4,11,12,23,-11,19
Anzhi,7958,11,3,5,12,16,40,-24,14
Loko Moscow,7959,1,12,6,2,34,15,19,42
Spart Moscow,7959,2,10,5,5,36,26,10,35
CSKA Moscow,7959,3,10,4,6,29,22,7,34
Zenit,7959,4,8,9,3,25,16,9,33
Terek Grozny,7959,5,8,5,7,21,24,-3,29
Krasnodar,7959,6,8,4,8,30,29,1,28
Din Moscow,7959,7,6,6,8,20,23,-3,24
FK Rubin,7959,8,6,5,9,23,20,3,23
Rostov,7959,9,5,6,9,11,17,-6,21
Amkar,7959,10,5,4,11,11,24,-13,19
Anzhi,7959,11,2,6,12,16,40,-24,12
Loko Moscow,7960,1,13,5,2,33,12,21,44
Spart Moscow,7960,2,10,5,5,37,29,8,35
CSKA Moscow,7960,3,10,4,6,27,21,6,34
Zenit,7960,4,8,8,4,24,16,8,32
Terek Grozny,7960,5,9,5,6,25,25,0,32
Krasnodar,7960,6,8,4,8,29,28,1,28
FK Rubin,7960,7,7,5,8,26,19,7,26
Rostov,7960,8,5,6,9,13,18,-5,21
Din Moscow,7960,9,5,6,9,19,26,-7,21
Amkar,7960,10,4,4,12,10,25,-15,16
Anzhi,7960,11,2,6,12,17,41,-24,12
Loko Moscow,7961,1,12,6,2,32,13,19,42
CSKA Moscow,7961,2,11,3,6,28,19,9,36
Zenit,7961,3,8,9,3,24,15,9,33
Spart Moscow,7961,4,9,6,5,35,28,7,33
Krasnodar,7961,5,9,4,7,32,28,4,31
Terek Grozny,7961,6,8,5,7,22,25,-3,29
Din Moscow,7961,7,6,6,8,19,22,-3,24
FK Rubin,7961,8,6,5,9,24,21,3,23
Rostov,7961,9,4,7,9,10,17,-7,19
Amkar,7961,10,5,4,11,12,24,-12,19
Anzhi,7961,11,2,5,13,15,41,-26,11
Loko Moscow,7962,1,11,7,2,30,12,18,40
CSKA Moscow,7962,2,11,4,5,28,18,10,37
Spart Moscow,7962,3,9,6,5,40,31,9,33
Krasnodar,7962,4,9,5,6,30,25,5,32
Zenit,7962,5,7,10,3,22,14,8,31
Terek Grozny,7962,6,7,5,8,21,26,-5,26
Din Moscow,7962,7,5,8,7,19,23,-4,23
Amkar,7962,8,6,4,10,14,23,-9,22
FK Rubin,7962,9,5,6,9,22,20,2,21
Rostov,7962,10,4,6,10,12,22,-10,18
Anzhi,7962,11,3,5,12,16,40,-24,14
Loko Moscow,7963,1,12,5,3,30,12,18,41
Spart Moscow,7963,2,10,6,4,39,28,11,36
CSKA Moscow,7963,3,11,3,6,26,18,8,36
Zenit,7963,4,9,8,3,23,13,10,35
Krasnodar,7963,5,9,4,7,28,25,3,31
Terek Grozny,7963,6,7,7,6,20,22,-2,28
Din Moscow,7963,7,5,7,8,19,24,-5,22
FK Rubin,7963,8,5,6,9,22,19,3,21
Rostov,7963,9,4,7,9,11,18,-7,19
Amkar,7963,10,4,5,11,10,25,-15,17
Anzhi,7963,11,2,6,12,14,38,-24,12
Loko Moscow,7964,1,12,5,3,30,12,18,41
CSKA Moscow,7964,2,11,3,6,27,19,8,36
Krasnodar,7964,3,10,4,6,30,25,5,34
Spart Moscow,7964,4,9,6,5,36,28,8,33
Zenit,7964,5,7,8,5,22,16,6,29
Terek Grozny,7964,6,7,6,7,21,25,-4,27
Din Moscow,7964,7,6,7,7,20,23,-3,25
Amkar,7964,8,6,4,10,12,22,-10,22
FK Rubin,7964,9,5,5,10,23,21,2,20
Rostov,7964,10,4,6,10,11,19,-8,18
Anzhi,7964,11,3,6,11,16,38,-22,15
Loko Moscow,7965,1,11,6,3,32,15,17,39
Spart Moscow,7965,2,10,6,4,38,25,13,36
Zenit,7965,3,9,8,3,25,15,10,35
CSKA Moscow,7965,4,10,4,6,27,20,7,34
Krasnodar,7965,5,8,5,7,29,27,2,29
Terek Grozny,7965,6,7,6,7,21,24,-3,27
FK Rubin,7965,7,7,5,8,24,18,6,26
Din Moscow,7965,8,5,6,9,18,25,-7,21
Amkar,7965,9,5,5,10,10,22,-12,20
Rostov,7965,10,4,6,10,10,20,-10,18
Anzhi,7965,11,2,7,11,16,39,-23,13
Loko Moscow,7966,1,11,7,2,30,12,18,40
CSKA Moscow,7966,2,11,4,5,28,18,10,37
Spart Moscow,7966,3,10,6,4,41,30,11,36
Zenit,7966,4,7,10,3,23,15,8,31
Terek Grozny,7966,5,8,6,6,24,25,-1,30
Krasnodar,7966,6,8,5,7,27,26,1,29
Din Moscow,7966,7,6,6,8,19,24,-5,24
FK Rubin,7966,8,6,5,9,23,18,5,23
Rostov,7966,9,4,7,9,12,19,-7,19
Amkar,7966,10,4,4,12,12,27,-15,16
Anzhi,7966,11,2,6,12,16,41,-25,12
Loko Moscow,7967,1,11,6,3,29,12,17,39
Spart Moscow,7967,2,11,5,4,37,25,12,38
CSKA Moscow,7967,3,11,3,6,29,21,8,36
Zenit,7967,4,8,8,4,23,15,8,32
Terek Grozny,7967,5,9,5,6,24,24,0,32
Krasnodar,7967,6,8,6,6,29,26,3,30
FK Rubin,7967,7,5,7,8,23,19,4,22
Din Moscow,7967,8,5,7,8,17,22,-5,22
Rostov,7967,9,4,6,10,10,19,-9,18
Amkar,7967,10,4,4,12,10,25,-15,16
Anzhi,7967,11,3,5,12,18,41,-23,14
Loko Moscow,7968,1,11,5,4,30,17,13,38
Spart Moscow,7968,2,11,5,4,38,27,11,38
Zenit,7968,3,9,8,3,24,13,11,35
Krasnodar,7968,4,10,4,6,34,27,7,34
CSKA Moscow,7968,5,10,4,6,25,18,7,34
Terek Grozny,7968,6,7,7,6,21,23,-2,28
FK Rubin,7968,7,6,5,9,26,21,5,23
Din Moscow,7968,8,5,6,9,18,25,-7,21
Rostov,7968,9,4,6,10,10,18,-8,18
Amkar,7968,10,4,5,11,11,25,-14,17
Anzhi,7968,11,2,7,11,15,38,-23,13
Loko Moscow,7969,1,12,5,3,31,15,16,41
CSKA Moscow,7969,2,11,3,6,26,19,7,36
Zenit,7969,3,8,8,4,23,14,9,32
Terek Grozny,7969,4,9,5,6,25,24,1,32
Krasnodar,7969,5,9,4,7,31,27,4,31
Spart Moscow,7969,6,8,6,6,36,31,5,30
FK Rubin,7969,7,6,6,8,24,18,6,24
Din Moscow,7969,8,5,8,7,20,24,-4,23
Rostov,7969,9,5,6,9,12,18,-6,21
Amkar,7969,10,5,4,11,11,24,-13,19
Anzhi,7969,11,2,5,13,16,41,-25,11
Loko Moscow,7970,1,11,6,3,31,14,17,39
CSKA Moscow,7970,2,11,4,5,28,19,9,37
Spart Moscow,7970,3,9,7,4,35,26,9,34
Zenit,7970,4,8,8,4,24,16,8,32
Krasnodar,7970,5,9,5,6,29,25,4,32
Terek Grozny,7970,6,7,7,6,21,23,-2,28
FK Rubin,7970,7,6,5,9,23,19,4,23
Din Moscow,7970,8,5,6,9,18,24,-6,21
Rostov,7970,9,4,7,9,10,17,-7,19
Amkar,7970,10,4,6,10,10,23,-13,18
Anzhi,7970,11,2,7,11,16,39,-23,13
Loko Moscow,7971,1,11,6,3,29,14,15,39
CSKA Moscow,7971,2,11,3,6,28,20,8,36
Zenit,7971,3,9,8,3,26,13,13,35
Spart Moscow,7971,4,9,6,5,37,27,10,33
Krasnodar,7971,5,9,5,6,31,26,5,32
Terek Grozny,7971,6,7,6,7,21,24,-3,27
Din Moscow,7971,7,6,7,7,21,21,0,25
Rostov,7971,8,5,6,9,12,18,-6,21
FK Rubin,7971,9,5,5,10,23,25,-2,20
Amkar,7971,10,4,5,11,10,26,-16,17
Anzhi,7971,11,3,5,12,16,40,-24,14
Loko Moscow,7972,1,11,6,3,31,14,17,39
CSKA Moscow,7972,2,11,4,5,30,18,12,37
Krasnodar,7972,3,10,4,6,31,25,6,34
Spart Moscow,7972,4,9,6,5,37,28,9,33
Terek Grozny,7972,5,9,5,6,24,22,2,32
Zenit,7972,6,7,10,3,23,15,8,31
Din Moscow,7972,7,7,6,7,20,22,-2,27
FK Rubin,7972,8,5,5,10,21,20,1,20
Rostov,7972,9,4,7,9,10,17,-7,19
Amkar,7972,10,4,4,12,10,27,-17,16
Anzhi,7972,11,2,5,13,14,43,-29,11
Loko Moscow,7973,1,12,5,3,31,12,19,41
CSKA Moscow,7973,2,11,3,6,27,21,6,36
Spart Moscow,7973,3,10,5,5,36,28,8,35
Krasnodar,7973,4,10,4,6,29,24,5,34
Zenit,7973,5,8,8,4,25,15,10,32
Terek Grozny,7973,6,9,5,6,25,23,2,32
Din Moscow,7973,7,5,7,8,18,23,-5,22
FK Rubin,7973,8,5,6,9,22,19,3,21
Rostov,7973,9,5,6,9,12,17,-5,21
Amkar,7973,10,4,4,12,11,27,-16,16
Anzhi,7973,11,2,5,13,14,41,-27,11
Loko Moscow,7974,1,12,6,2,32,12,20,42
Spart Moscow,7974,2,11,5,4,45,31,14,38
CSKA Moscow,7974,3,11,4,5,28,19,9,37
Zenit,7974,4,7,10,3,22,14,8,31
Krasnodar,7974,5,8,4,8,29,29,0,28
Terek Grozny,7974,6,7,5,8,20,24,-4,26
FK Rubin,7974,7,6,6,8,24,19,5,24
Din Moscow,7974,8,5,7,8,20,25,-5,22
Amkar,7974,9,5,4,11,11,27,-16,19
Rostov,7974,10,4,6,10,13,21,-8,18
Anzhi,7974,11,3,5,12,16,39,-23,14
Loko Moscow,7975,1,12,5,3,32,14,18,41
CSKA Moscow,7975,2,10,5,5,26,18,8,35
Krasnodar,7975,3,10,4,6,31,25,6,34
Spart Moscow,7975,4,9,6,5,35,27,8,33
Zenit,7975,5,7,9,4,22,16,6,30
Terek Grozny,7975,6,8,6,6,21,22,-1,30
FK Rubin,7975,7,6,5,9,22,18,4,23
Din Moscow,7975,8,5,7,8,18,23,-5,22
Rostov,7975,9,5,6,9,11,17,-6,21
Amkar,7975,10,4,4,12,9,24,-15,16
Anzhi,7975,11,2,7,11,14,37,-23,13
Loko Moscow,7976,1,11,6,3,30,14,16,39
CSKA Moscow,7976,2,11,4,5,27,17,10,37
Krasnodar,7976,3,10,4,6,31,24,7,34
Spart Moscow,7976,4,8,8,4,34,26,8,32
Zenit,7976,5,7,10,3,22,14,8,31
Terek Grozny,7976,6,8,6,6,23,23,0,30
Din Moscow,7976,7,5,8,7,18,22,-4,23
FK Rubin,7976,8,5,6,9,21,19,2,21
Rostov,7976,9,4,7,9,10,17,-7,19
Amkar,7976,10,4,5,11,9,24,-15,17
Anzhi,7976,11,2,6,12,15,40,-25,12
Loko Moscow,7977,1,11,6,3,30,13,17,39
CSKA Moscow,7977,2,11,4,5,27,18,9,37
Krasnodar,7977,3,10,4,6,29,24,5,34
Spart Moscow,7977,4,9,5,6,36,31,5,32
Zenit,7977,5,7,10,3,23,15,8,31
Terek Grozny,7977,6,7,7,6,21,23,-2,28
Din Moscow,7977,7,6,6,8,19,23,-4,24
Rostov,7977,8,5,6,9,13,18,-5,21
FK Rubin,7977,9,5,5,10,21,19,2,20
Amkar,7977,10,5,5,10,12,23,-11,20
Anzhi,7977,11,2,6,12,14,38,-24,12
Loko Moscow,7978,1,12,5,3,31,14,17,41
Spart Moscow,7978,2,10,5,5,39,31,8,35
CSKA Moscow,7978,3,10,4,6,25,18,7,34
Zenit,7978,4,8,9,3,24,14,10,33
Krasnodar,7978,5,9,4,7,29,26,3,31
Terek Grozny,7978,6,7,5,8,22,26,-4,26
FK Rubin,7978,7,6,5,9,25,20,5,23
Rostov,7978,8,5,6,9,13,18,-5,21
Din Moscow,7978,9,5,6,9,20,27,-7,21
Amkar,7978,10,5,4,11,12,25,-13,19
Anzhi,7978,11,4,5,11,17,38,-21,17
Loko Moscow,7979,1,12,6,2,32,12,20,42
CSKA Moscow,7979,2,11,3,6,28,18,10,36
Spart Moscow,7979,3,10,5,5,40,27,13,35
Zenit,7979,4,8,9,3,22,13,9,33
Krasnodar,7979,5,9,4,7,30,27,3,31
Terek Grozny,7979,6,8,6,6,23,23,0,30
FK Rubin,7979,7,6,5,9,23,20,3,23
Din Moscow,7979,8,5,6,9,18,25,-7,21
Amkar,7979,9,5,5,10,12,24,-12,20
Rostov,7979,10,4,6,10,10,21,-11,18
Anzhi,7979,11,2,5,13,14,42,-28,11
Loko Moscow,7980,1,11,7,2,32,14,18,40
CSKA Moscow,7980,2,11,3,6,27,20,7,36
Spart Moscow,7980,3,10,5,5,36,27,9,35
Zenit,7980,4,8,9,3,25,15,10,33
Krasnodar,7980,5,9,5,6,30,26,4,32
Terek Grozny,7980,6,7,6,7,20,24,-4,27
Din Moscow,7980,7,5,7,8,19,24,-5,22
Amkar,7980,8,6,4,10,12,22,-10,22
FK Rubin,7980,9,5,6,9,22,19,3,21
Rostov,7980,10,4,6,10,10,18,-8,18
Anzhi,7980,11,2,6,12,14,38,-24,12
Loko Moscow,7981,1,12,5,3,32,15,17,41
CSKA Moscow,7981,2,11,3,6,27,21,6,36
Krasnodar,7981,3,10,4,6,32,25,7,34
Zenit,7981,4,8,8,4,26,16,10,32
Spart Moscow,7981,5,8,7,5,36,29,7,31
Terek Grozny,7981,6,8,5,7,22,24,-2,29
FK Rubin,7981,7,6,5,9,22,19,3,23
Din Moscow,7981,8,5,7,8,18,23,-5,22
Rostov,7981,9,5,6,9,12,18,-6,21
Amkar,7981,10,5,5,10,12,24,-12,20
Anzhi,7981,11,2,5,13,14,39,-25,11
Loko Moscow,7982,1,11,5,4,29,13,16,38
CSKA Moscow,7982,2,11,3,6,29,21,8,36
Zenit,7982,3,9,8,3,25,15,10,35
Krasnodar,7982,4,10,4,6,29,24,5,34
Spart Moscow,7982,5,9,5,6,37,28,9,32
Terek Grozny,7982,6,8,5,7,22,24,-2,29
FK Rubin,7982,7,6,5,9,22,18,4,23
Rostov,7982,8,5,6,9,11,17,-6,21
Din Moscow,7982,9,5,6,9,17,25,-8,21
Amkar,7982,10,5,4,11,11,24,-13,19
Anzhi,7982,11,3,5,12,17,40,-23,14
Loko Moscow,7983,1,12,6,2,30,11,19,42
CSKA Moscow,7983,2,11,3,6,26,18,8,36
Spart Moscow,7983,3,10,5,5,39,28,11,35
Zenit,7983,4,8,9,3,22,13,9,33
Krasnodar,7983,5,9,4,7,28,25,3,31
Terek Grozny,7983,6,7,6,7,21,24,-3,27
FK Rubin,7983,7,6,5,9,23,19,4,23
Amkar,7983,8,6,4,10,13,24,-11,22
Din Moscow,7983,9,5,6,9,18,24,-6,21
Rostov,7983,10,4,6,10,10,20,-10,18
Anzhi,7983,11,2,6,12,15,39,-24,12
Loko Moscow,7984,1,13,5,2,34,11,23,44
Spart Moscow,7984,2,10,5,5,39,29,10,35
CSKA Moscow,7984,3,10,3,7,26,20,6,33
Zenit,7984,4,8,8,4,22,14,8,32
Terek Grozny,7984,5,9,5,6,27,25,2,32
Krasnodar,7984,6,9,4,7,30,30,0,31
Din Moscow,7984,7,6,6,8,20,23,-3,24
Rostov,7984,8,5,6,9,13,19,-6,21
FK Rubin,7984,9,5,5,10,23,22,1,20
Amkar,7984,10,4,4,12,11,28,-17,16
Anzhi,7984,11,3,5,12,17,41,-24,14
Loko Moscow,7985,1,12,5,3,31,14,17,41
CSKA Moscow,7985,2,12,3,5,28,17,11,39
Spart Moscow,7985,3,10,5,5,41,27,14,35
Krasnodar,7985,4,9,4,7,31,28,3,31
Zenit,7985,5,7,8,5,22,16,6,29
FK Rubin,7985,6,7,5,8,27,20,7,26
Terek Grozny,7985,7,7,5,8,21,25,-4,26
Amkar,7985,8,6,4,10,12,23,-11,22
Din Moscow,7985,9,5,6,9,19,27,-8,21
Rostov,7985,10,4,6,10,10,21,-11,18
Anzhi,7985,11,3,5,12,15,39,-24,14
Loko Moscow,7986,1,11,7,2,32,14,18,40
CSKA Moscow,7986,2,12,3,5,28,17,11,39
Spart Moscow,7986,3,10,6,4,38,27,11,36
Krasnodar,7986,4,9,5,6,32,27,5,32
Zenit,7986,5,7,9,4,22,16,6,30
Terek Grozny,7986,6,8,5,7,22,24,-2,29
FK Rubin,7986,7,6,5,9,24,21,3,23
Din Moscow,7986,8,5,6,9,18,25,-7,21
Rostov,7986,9,4,7,9,12,19,-7,19
Amkar,7986,10,4,4,12,9,24,-15,16
Anzhi,7986,11,3,5,12,16,39,-23,14
Spart Moscow,7987,1,11,5,4,42,26,16,38
Loko Moscow,7987,2,11,5,4,31,15,16,38
CSKA Moscow,7987,3,11,3,6,27,21,6,36
Zenit,7987,4,9,8,3,28,15,13,35
Krasnodar,7987,5,9,5,6,28,24,4,32
Terek Grozny,7987,6,8,6,6,23,22,1,30
FK Rubin,7987,7,5,7,8,21,17,4,22
Din Moscow,7987,8,5,7,8,18,25,-7,22
Rostov,7987,9,4,6,10,10,21,-11,18
Amkar,7987,10,4,5,11,9,23,-14,17
Anzhi,7987,11,2,5,13,14,42,-28,11
Loko Moscow,7988,1,12,5,3,33,14,19,41
Krasnodar,7988,2,10,4,6,32,25,7,34
Spart Moscow,7988,3,9,6,5,38,29,9,33
CSKA Moscow,7988,4,10,3,7,26,23,3,33
Zenit,7988,5,8,8,4,25,16,9,32
Terek Grozny,7988,6,8,5,7,25,25,0,29
Din Moscow,7988,7,6,7,7,20,23,-3,25
FK Rubin,7988,8,5,6,9,22,21,1,21
Amkar,7988,9,5,5,10,12,24,-12,20
Rostov,7988,10,4,6,10,10,19,-9,18
Anzhi,7988,11,3,5,12,19,43,-24,14
Loko Moscow,7989,1,12,6,2,33,12,21,42
CSKA Moscow,7989,2,12,3,5,28,18,10,39
Spart Moscow,7989,3,11,5,4,38,25,13,38
Terek Grozny,7989,4,9,5,6,26,23,3,32
Zenit,7989,5,7,9,4,22,15,7,30
Krasnodar,7989,6,8,4,8,27,29,-2,28
FK Rubin,7989,7,6,6,8,23,17,6,24
Din Moscow,7989,8,5,7,8,17,23,-6,22
Rostov,7989,9,4,6,10,10,18,-8,18
Amkar,7989,10,4,4,12,9,25,-16,16
Anzhi,7989,11,2,5,13,16,44,-28,11
Loko Moscow,7990,1,12,6,2,30,11,19,42
CSKA Moscow,7990,2,11,3,6,27,19,8,36
Spart Moscow,7990,3,9,6,5,35,27,8,33
Zenit,7990,4,8,8,4,22,14,8,32
Krasnodar,7990,5,8,6,6,28,25,3,30
Terek Grozny,7990,6,7,6,7,20,23,-3,27
Din Moscow,7990,7,5,8,7,18,22,-4,23
FK Rubin,7990,8,5,7,8,23,19,4,22
Rostov,7990,9,5,6,9,12,17,-5,21
Amkar,7990,10,5,4,11,10,24,-14,19
Anzhi,7990,11,2,6,12,15,39,-24,12
Loko Moscow,7991,1,11,6,3,31,15,16,39
Spart Moscow,7991,2,10,6,4,39,29,10,36
Krasnodar,7991,3,10,4,6,31,25,6,34
CSKA Moscow,7991,4,10,4,6,26,21,5,34
Zenit,7991,5,8,9,3,25,14,11,33
Terek Grozny,7991,6,8,6,6,23,23,0,30
FK Rubin,7991,7,6,5,9,22,18,4,23
Din Moscow,7991,8,5,6,9,18,24,-6,21
Rostov,7991,9,4,7,9,12,19,-7,19
Amkar,7991,10,4,5,11,11,25,-14,17
Anzhi,7991,11,2,6,12,15,40,-25,12
Loko Moscow,7992,1,11,5,4,30,15,15,38
CSKA Moscow,7992,2,11,4,5,27,17,10,37
Zenit,7992,3,8,9,3,24,14,10,33
Spart Moscow,7992,4,9,6,5,36,28,8,33
Krasnodar,7992,5,9,4,7,29,26,3,31
Din Moscow,7992,6,7,6,7,19,21,-2,27
Terek Grozny,7992,7,7,6,7,20,23,-3,27
FK Rubin,7992,8,6,5,9,23,19,4,23
Rostov,7992,9,4,7,9,12,19,-7,19
Amkar,7992,10,5,4,11,10,23,-13,19
Anzhi,7992,11,2,6,12,14,39,-25,12
Loko Moscow,7993,1,12,5,3,31,13,18,41
CSKA Moscow,7993,2,10,5,5,28,20,8,35
Krasnodar,7993,3,10,4,6,30,24,6,34
Zenit,7993,4,7,9,4,23,16,7,30
Spart Moscow,7993,5,8,6,6,35,29,6,30
Terek Grozny,7993,6,8,6,6,22,22,0,30
Din Moscow,7993,7,6,6,8,21,25,-4,24
FK Rubin,7993,8,6,5,9,23,20,3,23
Rostov,7993,9,4,7,9,10,17,-7,19
Amkar,7993,10,5,4,11,10,24,-14,19
Anzhi,7993,11,2,7,11,16,39,-23,13
CSKA Moscow,7994,1,12,3,5,32,18,14,39
Loko Moscow,7994,2,11,5,4,29,13,16,38
Spart Moscow,7994,3,9,7,4,38,29,9,34
Krasnodar,7994,4,10,4,6,29,24,5,34
Zenit,7994,5,8,8,4,22,16,6,32
Terek Grozny,7994,6,7,6,7,22,25,-3,27
FK Rubin,7994,7,6,5,9,23,18,5,23
Din Moscow,7994,8,5,7,8,18,24,-6,22
Amkar,7994,9,5,5,10,11,23,-12,20
Rostov,7994,10,4,6,10,12,20,-8,18
Anzhi,7994,11,2,6,12,17,43,-26,12
Loko Moscow,7995,1,12,6,2,31,12,19,42
Spart Moscow,7995,2,10,6,4,35,25,10,36
CSKA Moscow,7995,3,10,3,7,26,20,6,33
Zenit,7995,4,8,8,4,23,15,8,32
Terek Grozny,7995,5,9,5,6,24,24,0,32
Krasnodar,7995,6,8,5,7,27,26,1,29
Din Moscow,7995,7,6,6,8,20,22,-2,24
FK Rubin,7995,8,6,5,9,23,20,3,23
Rostov,7995,9,4,6,10,10,18,-8,18
Amkar,7995,10,4,5,11,10,24,-14,17
Anzhi,7995,11,3,5,12,17,40,-23,14
Loko Moscow,7996,1,11,6,3,31,14,17,39
CSKA Moscow,7996,2,11,4,5,30,18,12,37
Zenit,7996,3,8,9,3,24,15,9,33
Spart Moscow,7996,4,8,6,6,38,32,6,30
Terek Grozny,7996,5,8,6,6,23,24,-1,30
Krasnodar,7996,6,8,5,7,28,28,0,29
FK Rubin,7996,7,7,5,8,25,17,8,26
Din Moscow,7996,8,5,7,8,19,24,-5,22
Rostov,7996,9,5,6,9,11,17,-6,21
Amkar,7996,10,5,4,11,13,26,-13,19
Anzhi,7996,11,2,6,12,16,43,-27,12
Loko Moscow,7997,1,11,6,3,33,16,17,39
CSKA Moscow,7997,2,11,4,5,33,18,15,37
Spart Moscow,7997,3,10,6,4,40,29,11,36
Zenit,7997,4,7,10,3,24,16,8,31
Krasnodar,7997,5,9,4,7,30,29,1,31
Terek Grozny,7997,6,8,5,7,21,24,-3,29
FK Rubin,7997,7,6,6,8,24,17,7,24
Din Moscow,7997,8,5,8,7,20,24,-4,23
Amkar,7997,9,5,4,11,12,24,-12,19
Rostov,7997,10,4,6,10,10,19,-9,18
Anzhi,7997,11,2,5,13,14,45,-31,11
Loko Moscow,7998,1,11,6,3,31,14,17,39
CSKA Moscow,7998,2,11,4,5,27,17,10,37
Spart Moscow,7998,3,9,5,6,37,32,5,32
Krasnodar,7998,4,9,4,7,29,28,1,31
Zenit,7998,5,7,9,4,22,16,6,30
Terek Grozny,7998,6,8,5,7,23,25,-2,29
FK Rubin,7998,7,7,5,8,26,18,8,26
Amkar,7998,8,6,4,10,16,25,-9,22
Rostov,7998,9,5,6,9,12,17,-5,21
Din Moscow,7998,10,5,6,9,18,25,-7,21
Anzhi,7998,11,2,6,12,15,39,-24,12
Loko Moscow,7999,1,12,6,2,35,14,21,42
CSKA Moscow,7999,2,12,3,5,32,18,14,39
Spart Moscow,7999,3,9,7,4,35,25,10,34
Krasnodar,7999,4,9,5,6,30,26,4,32
Zenit,7999,5,7,8,5,23,19,4,29
Terek Grozny,7999,6,7,5,8,21,26,-5,26
Din Moscow,7999,7,5,7,8,17,23,-6,22
FK Rubin,7999,8,5,6,9,21,18,3,21
Amkar,7999,9,5,5,10,11,22,-11,20
Rostov,7999,10,4,7,9,10,17,-7,19
Anzhi,7999,11,3,5,12,16,43,-27,14
Loko Moscow,8000,1,12,5,3,32,15,17,41
CSKA Moscow,8000,2,11,4,5,28,19,9,37
Krasnodar,8000,3,9,4,7,31,27,4,31
Zenit,8000,4,7,9,4,22,15,7,30
Spart Moscow,8000,5,8,6,6,38,32,6,30
FK Rubin,8000,6,7,5,8,25,18,7,26
Terek Grozny,8000,7,7,5,8,22,27,-5,26
Din Moscow,8000,8,5,7,8,20,26,-6,22
Amkar,8000,9,6,4,10,12,23,-11,22
Rostov,8000,10,5,6,9,14,20,-6,21
Anzhi,8000,11,3,5,12,18,40,-22,14
Loko Moscow,8001,1,12,5,3,32,12,20,41
Spart Moscow,8001,2,10,6,4,39,28,11,36
CSKA Moscow,8001,3,11,3,6,28,19,9,36
Zenit,8001,4,9,8,3,24,14,10,35
Krasnodar,8001,5,8,4,8,28,30,-2,28
Terek Grozny,8001,6,7,7,6,21,23,-2,28
Din Moscow,8001,7,6,7,7,20,23,-3,25
FK Rubin,8001,8,6,5,9,24,19,5,23
Rostov,8001,9,4,6,10,10,18,-8,18
Amkar,8001,10,4,5,11,11,26,-15,17
Anzhi,8001,11,2,6,12,14,39,-25,12
Loko Moscow,8002,1,11,6,3,30,14,16,39
CSKA Moscow,8002,2,11,3,6,28,20,8,36
Zenit,8002,3,9,8,3,26,14,12,35
Spart Moscow,8002,4,9,6,5,35,26,9,33
Krasnodar,8002,5,8,6,6,28,25,3,30
Terek Grozny,8002,6,8,5,7,26,28,-2,29
FK Rubin,8002,7,6,6,8,26,19,7,24
Din Moscow,8002,8,5,7,8,19,26,-7,22
Amkar,8002,9,6,4,10,13,22,-9,22
Rostov,8002,10,4,6,10,10,19,-9,18
Anzhi,8002,11,2,5,13,17,45,-28,11
Loko Moscow,8003,1,11,6,3,30,13,17,39
CSKA Moscow,8003,2,11,3,6,26,18,8,36
Spart Moscow,8003,3,10,5,5,39,28,11,35
Krasnodar,8003,4,10,4,6,31,24,7,34
Zenit,8003,5,7,9,4,22,15,7,30
Terek Grozny,8003,6,7,5,8,21,29,-8,26
Din Moscow,8003,7,5,7,8,20,25,-5,22
FK Rubin,8003,8,5,6,9,22,21,1,21
Rostov,8003,9,5,6,9,11,17,-6,21
Amkar,8003,10,5,4,11,13,26,-13,19
Anzhi,8003,11,4,5,11,18,37,-19,17
Loko Moscow,8004,1,11,6,3,29,13,16,39
Krasnodar,8004,2,10,4,6,32,24,8,34
CSKA Moscow,8004,3,10,4,6,26,19,7,34
Zenit,8004,4,8,9,3,23,14,9,33
Spart Moscow,8004,5,9,6,5,35,27,8,33
Terek Grozny,8004,6,8,5,7,25,23,2,29
Din Moscow,8004,7,5,8,7,18,22,-4,23
Amkar,8004,8,6,4,10,11,22,-11,22
FK Rubin,8004,9,5,6,9,22,21,1,21
Rostov,8004,10,4,6,10,11,19,-8,18
Anzhi,8004,11,2,6,12,14,42,-28,12
Loko Moscow,8005,1,12,5,3,33,15,18,41
CSKA Moscow,8005,2,11,3,6,27,20,7,36
Spart Moscow,8005,3,9,5,6,39,30,9,32
Zenit,8005,4,8,8,4,23,15,8,32
Krasnodar,8005,5,8,5,7,30,28,2,29
Terek Grozny,8005,6,7,6,7,21,24,-3,27
Din Moscow,8005,7,6,7,7,20,23,-3,25
FK Rubin,8005,8,5,7,8,22,18,4,22
Amkar,8005,9,5,5,10,12,24,-12,20
Rostov,8005,10,4,6,10,10,20,-10,18
Anzhi,8005,11,4,5,11,18,38,-20,17
Loko Moscow,8006,1,12,6,2,31,11,20,42
CSKA Moscow,8006,2,11,4,5,27,17,10,37
Zenit,8006,3,7,10,3,21,13,8,31
Spart Moscow,8006,4,8,6,6,37,33,4,30
Krasnodar,8006,5,8,5,7,28,27,1,29
Terek Grozny,8006,6,8,5,7,23,26,-3,29
Din Moscow,8006,7,6,7,7,20,22,-2,25
FK Rubin,8006,8,5,7,8,22,18,4,22
Amkar,8006,9,6,4,10,15,23,-8,22
Rostov,8006,10,4,7,9,12,19,-7,19
Anzhi,8006,11,2,5,13,15,42,-27,11
Loko Moscow,8007,1,11,6,3,30,14,16,39
Spart Moscow,8007,2,11,5,4,41,29,12,38
CSKA Moscow,8007,3,11,3,6,26,19,7,36
Zenit,8007,4,8,9,3,23,13,10,33
Krasnodar,8007,5,9,5,6,30,25,5,32
Terek Grozny,8007,6,8,6,6,22,23,-1,30
FK Rubin,8007,7,6,6,8,23,17,6,24
Din Moscow,8007,8,5,6,9,18,26,-8,21
Rostov,8007,9,4,6,10,12,20,-8,18
Amkar,8007,10,4,4,12,10,25,-15,16
Anzhi,8007,11,2,6,12,15,39,-24,12
Loko Moscow,8008,1,12,6,2,31,11,20,42
CSKA Moscow,8008,2,12,3,5,33,19,14,39
Spart Moscow,8008,3,10,6,4,38,28,10,36
Zenit,8008,4,7,9,4,22,15,7,30
Krasnodar,8008,5,8,4,8,27,27,0,28
FK Rubin,8008,6,7,5,8,25,19,6,26
Terek Grozny,8008,7,7,5,8,23,27,-4,26
Din Moscow,8008,8,5,6,9,21,27,-6,21
Amkar,8008,9,5,5,10,12,24,-12,20
Rostov,8008,10,4,6,10,10,18,-8,18
Anzhi,8008,11,3,5,12,18,45,-27,14
Loko Moscow,8009,1,13,5,2,36,11,25,44
CSKA Moscow,8009,2,11,4,5,27,17,10,37
Spart Moscow,8009,3,9,5,6,37,30,7,32
Krasnodar,8009,4,9,4,7,30,29,1,31
Zenit,8009,5,7,9,4,21,17,4,30
Terek Grozny,8009,6,8,5,7,23,23,0,29
Din Moscow,8009,7,7,6,7,20,22,-2,27
FK Rubin,8009,8,5,5,10,23,21,2,20
Amkar,8009,9,5,4,11,12,26,-14,19
Rostov,8009,10,4,6,10,10,19,-9,18
Anzhi,8009,11,3,5,12,15,39,-24,14
Loko Moscow,8010,1,11,6,3,31,15,16,39
CSKA Moscow,8010,2,11,3,6,29,18,11,36
Spart Moscow,8010,3,10,6,4,37,27,10,36
Krasnodar,8010,4,10,4,6,31,25,6,34
Zenit,8010,5,8,9,3,23,14,9,33
Terek Grozny,8010,6,7,6,7,21,24,-3,27
FK Rubin,8010,7,6,5,9,24,19,5,23
Din Moscow,8010,8,5,7,8,19,25,-6,22
Rostov,8010,9,4,6,10,10,18,-8,18
Amkar,8010,10,4,5,11,11,25,-14,17
Anzhi,8010,11,3,5,12,15,41,-26,14
Loko Moscow,8011,1,13,5,2,33,11,22,44
CSKA Moscow,8011,2,11,3,6,27,19,8,36
Spart Moscow,8011,3,9,7,4,35,26,9,34
Zenit,8011,4,7,8,5,22,16,6,29
Krasnodar,8011,5,8,5,7,27,27,0,29
Terek Grozny,8011,6,7,5,8,22,27,-5,26
Din Moscow,8011,7,6,6,8,18,22,-4,24
FK Rubin,8011,8,5,6,9,21,18,3,21
Amkar,8011,9,5,5,10,13,24,-11,20
Rostov,8011,10,4,7,9,10,17,-7,19
Anzhi,8011,11,4,5,11,17,38,-21,17
Loko Moscow,8012,1,12,6,2,30,11,19,42
Spart Moscow,8012,2,11,5,4,41,25,16,38
CSKA Moscow,8012,3,11,4,5,29,18,11,37
Krasnodar,8012,4,9,5,6,29,24,5,32
Zenit,8012,5,7,9,4,22,15,7,30
Terek Grozny,8012,6,8,5,7,23,25,-2,29
Din Moscow,8012,7,6,6,8,19,23,-4,24
FK Rubin,8012,8,5,5,10,22,21,1,20
Rostov,8012,9,4,6,10,10,21,-11,18
Amkar,8012,10,4,4,12,9,26,-17,16
Anzhi,8012,11,3,5,12,17,42,-25,14
Loko Moscow,8013,1,11,5,4,30,14,16,38
CSKA Moscow,8013,2,11,3,6,26,18,8,36
Zenit,8013,3,9,8,3,23,13,10,35
Krasnodar,8013,4,10,4,6,33,27,6,34
Spart Moscow,8013,5,9,5,6,39,31,8,32
Terek Grozny,8013,6,8,5,7,23,25,-2,29
Din Moscow,8013,7,6,7,7,21,22,-1,25
FK Rubin,8013,8,5,6,9,23,21,2,21
Rostov,8013,9,5,6,9,11,17,-6,21
Amkar,8013,10,4,4,12,11,29,-18,16
Anzhi,8013,11,3,5,12,16,39,-23,14
Loko Moscow,8014,1,12,6,2,33,14,19,42
Spart Moscow,8014,2,11,5,4,37,25,12,38
CSKA Moscow,8014,3,11,4,5,29,18,11,37
Zenit,8014,4,7,10,3,24,16,8,31
Krasnodar,8014,5,9,4,7,32,26,6,31
Terek Grozny,8014,6,7,7,6,21,23,-2,28
Din Moscow,8014,7,6,6,8,19,24,-5,24
FK Rubin,8014,8,5,5,10,22,23,-1,20
Rostov,8014,9,4,6,10,10,18,-8,18
Amkar,8014,10,4,5,11,10,24,-14,17
Anzhi,8014,11,2,6,12,14,40,-26,12
Loko Moscow,8015,1,11,6,3,30,13,17,39
Spart Moscow,8015,2,11,5,4,42,30,12,38
CSKA Moscow,8015,3,11,4,5,29,19,10,37
Krasnodar,8015,4,10,4,6,29,24,5,34
Terek Grozny,8015,5,9,5,6,23,23,0,32
Zenit,8015,6,7,9,4,23,17,6,30
Din Moscow,8015,7,6,6,8,22,25,-3,24
FK Rubin,8015,8,5,5,10,22,21,1,20
Rostov,8015,9,4,6,10,12,21,-9,18
Amkar,8015,10,4,4,12,10,25,-15,16
Anzhi,8015,11,2,6,12,16,40,-24,12
Loko Moscow,8016,1,11,7,2,32,14,18,40
CSKA Moscow,8016,2,11,3,6,28,21,7,36
Spart Moscow,8016,3,10,5,5,36,29,7,35
Zenit,8016,4,8,9,3,24,14,10,33
Krasnodar,8016,5,9,5,6,31,26,5,32
Terek Grozny,8016,6,8,5,7,23,27,-4,29
Din Moscow,8016,7,6,6,8,20,24,-4,24
FK Rubin,8016,8,6,5,9,24,19,5,23
Amkar,8016,9,5,4,11,12,23,-11,19
Rostov,8016,10,4,6,10,11,19,-8,18
Anzhi,8016,11,2,5,13,18,43,-25,11
Loko Moscow,8017,1,12,5,3,31,13,18,41
Spart Moscow,8017,2,10,6,4,41,28,13,36
CSKA Moscow,8017,3,10,5,5,26,18,8,35
Krasnodar,8017,4,9,4,7,29,26,3,31
Zenit,8017,5,7,9,4,21,14,7,30
Terek Grozny,8017,6,8,5,7,22,24,-2,29
Din Moscow,8017,7,6,6,8,18,25,-7,24
FK Rubin,8017,8,6,5,9,22,18,4,23
Rostov,8017,9,4,6,10,12,20,-8,18
Amkar,8017,10,4,5,11,10,24,-14,17
Anzhi,8017,11,3,6,11,17,39,-22,15
Loko Moscow,8018,1,12,5,3,31,12,19,41
CSKA Moscow,8018,2,12,3,5,30,19,11,39
Spart Moscow,8018,3,9,6,5,34,26,8,33
Krasnodar,8018,4,9,4,7,28,26,2,31
Zenit,8018,5,7,8,5,22,17,5,29
Terek Grozny,8018,6,7,6,7,21,24,-3,27
FK Rubin,8018,7,6,6,8,23,17,6,24
Din Moscow,8018,8,5,8,7,17,21,-4,23
Amkar,8018,9,6,4,10,11,22,-11,22
Rostov,8018,10,4,6,10,10,18,-8,18
Anzhi,8018,11,2,6,12,16,41,-25,12
Loko Moscow,8019,1,11,5,4,29,14,15,38
Spart Moscow,8019,2,10,6,4,43,29,14,36
CSKA Moscow,8019,3,11,3,6,32,19,13,36
Zenit,8019,4,9,8,3,25,13,12,35
Krasnodar,8019,5,10,4,6,30,25,5,34
Terek Grozny,8019,6,7,7,6,22,24,-2,28
Din Moscow,8019,7,6,6,8,22,25,-3,24
FK Rubin,8019,8,5,5,10,22,24,-2,20
Rostov,8019,9,4,6,10,11,20,-9,18
Amkar,8019,10,4,6,10,12,25,-13,18
Anzhi,8019,11,2,6,12,16,46,-30,12
Loko Moscow,8020,1,12,5,3,31,14,17,41
CSKA Moscow,8020,2,12,3,5,29,19,10,39
Spart Moscow,8020,3,9,7,4,39,29,10,34
Krasnodar,8020,4,10,4,6,30,24,6,34
Zenit,8020,5,7,8,5,23,17,6,29
Terek Grozny,8020,6,7,5,8,20,27,-7,26
Din Moscow,8020,7,6,7,7,20,23,-3,25
FK Rubin,8020,8,5,5,10,22,20,2,20
Rostov,8020,9,4,7,9,11,18,-7,19
Amkar,8020,10,5,4,11,12,26,-14,19
Anzhi,8020,11,3,5,12,19,39,-20,14
Loko Moscow,8021,1,11,6,3,30,13,17,39
Spart Moscow,8021,2,11,5,4,40,29,11,38
CSKA Moscow,8021,3,10,4,6,26,19,7,34
Zenit,8021,4,8,9,3,23,14,9,33
Krasnodar,8021,5,9,5,6,30,26,4,32
Terek Grozny,8021,6,8,5,7,23,24,-1,29
FK Rubin,8021,7,6,6,8,25,18,7,24
Din Moscow,8021,8,5,6,9,18,26,-8,21
Rostov,8021,9,4,6,10,12,20,-8,18
Amkar,8021,10,4,4,12,10,26,-16,16
Anzhi,8021,11,3,6,11,16,38,-22,15
Loko Moscow,8022,1,12,5,3,31,13,18,41
CSKA Moscow,8022,2,10,4,6,25,18,7,34
Zenit,8022,3,8,8,4,23,15,8,32
Spart Moscow,8022,4,8,7,5,35,29,6,31
Krasnodar,8022,5,9,4,7,28,25,3,31
Terek Grozny,8022,6,7,6,7,20,23,-3,27
FK Rubin,8022,7,6,6,8,23,18,5,24
Din Moscow,8022,8,5,8,7,18,22,-4,23
Amkar,8022,9,6,4,10,13,23,-10,22
Rostov,8022,10,4,7,9,11,18,-7,19
Anzhi,8022,11,2,7,11,14,37,-23,13
Loko Moscow,8023,1,11,6,3,30,13,17,39
CSKA Moscow,8023,2,12,3,5,30,18,12,39
Spart Moscow,8023,3,10,6,4,36,26,10,36
Krasnodar,8023,4,10,4,6,30,25,5,34
Zenit,8023,5,7,9,4,21,15,6,30
Terek Grozny,8023,6,8,5,7,23,24,-1,29
FK Rubin,8023,7,6,5,9,24,19,5,23
Din Moscow,8023,8,5,6,9,19,26,-7,21
Amkar,8023,9,5,5,10,10,22,-12,20
Rostov,8023,10,4,6,10,10,18,-8,18
Anzhi,8023,11,2,5,13,16,43,-27,11
Loko Moscow,8024,1,12,5,3,31,15,16,41
CSKA Moscow,8024,2,11,4,5,27,17,10,37
Spart Moscow,8024,3,10,6,4,36,26,10,36
Terek Grozny,8024,4,9,5,6,23,22,1,32
Krasnodar,8024,5,9,4,7,31,26,5,31
Zenit,8024,6,7,9,4,21,14,7,30
FK Rubin,8024,7,7,5,8,24,17,7,26
Din Moscow,8024,8,5,6,9,17,24,-7,21
Rostov,8024,9,4,7,9,11,18,-7,19
Amkar,8024,10,4,4,12,9,25,-16,16
Anzhi,8024,11,2,5,13,14,40,-26,11
Loko Moscow,8025,1,12,6,2,35,14,21,42
CSKA Moscow,8025,2,11,3,6,27,19,8,36
Zenit,8025,3,8,8,4,24,17,7,32
Krasnodar,8025,4,9,5,6,31,27,4,32
Spart Moscow,8025,5,8,6,6,36,31,5,30
Terek Grozny,8025,6,8,6,6,24,23,1,30
Din Moscow,8025,7,6,7,7,21,24,-3,25
Rostov,8025,8,5,6,9,12,17,-5,21
FK Rubin,8025,9,5,5,10,22,20,2,20
Amkar,8025,10,5,4,11,10,25,-15,19
Anzhi,8025,11,2,6,12,15,40,-25,12
Spart Moscow,8026,1,11,5,4,45,26,19,38
Loko Moscow,8026,2,11,5,4,30,17,13,38
CSKA Moscow,8026,3,11,3,6,30,21,9,36
Zenit,8026,4,9,8,3,26,15,11,35
Krasnodar,8026,5,9,4,7,31,26,5,31
Terek Grozny,8026,6,8,5,7,23,24,-1,29
FK Rubin,8026,7,7,5,8,23,17,6,26
Din Moscow,8026,8,5,6,9,18,29,-11,21
Rostov,8026,9,4,6,10,10,21,-11,18
Amkar,8026,10,4,4,12,9,25,-16,16
Anzhi,8026,11,3,5,12,17,41,-24,14
Loko Moscow,8027,1,12,5,3,34,14,20,41
CSKA Moscow,8027,2,12,3,5,27,17,10,39
Krasnodar,8027,3,9,5,6,31,27,4,32
Spart Moscow,8027,4,8,7,5,37,30,7,31
Zenit,8027,5,7,8,5,21,17,4,29
Terek Grozny,8027,6,7,6,7,22,26,-4,27
Din Moscow,8027,7,5,8,7,20,24,-4,23
FK Rubin,8027,8,5,7,8,23,19,4,22
Amkar,8027,9,6,4,10,15,25,-10,22
Rostov,8027,10,4,7,9,10,17,-7,19
Anzhi,8027,11,2,6,12,15,39,-24,12
Loko Moscow,8028,1,12,5,3,30,12,18,41
Spart Moscow,8028,2,10,5,5,38,28,10,35
CSKA Moscow,8028,3,10,4,6,27,20,7,34
Krasnodar,8028,4,9,5,6,30,26,4,32
Zenit,8028,5,7,9,4,22,15,7,30
Terek Grozny,8028,6,7,6,7,21,24,-3,27
Din Moscow,8028,7,6,6,8,18,22,-4,24
FK Rubin,8028,8,5,6,9,23,20,3,21
Rostov,8028,9,5,6,9,13,19,-6,21
Amkar,8028,10,4,5,11,9,24,-15,17
Anzhi,8028,11,4,5,11,18,39,-21,17
Loko Moscow,8029,1,11,5,4,30,16,14,38
Zenit,8029,2,9,8,3,24,14,10,35
Spart Moscow,8029,3,9,7,4,37,28,9,34
Krasnodar,8029,4,10,4,6,32,25,7,34
CSKA Moscow,8029,5,10,4,6,25,18,7,34
Terek Grozny,8029,6,7,6,7,20,23,-3,27
Din Moscow,8029,7,5,8,7,18,22,-4,23
FK Rubin,8029,8,5,6,9,22,19,3,21
Rostov,8029,9,4,6,10,10,18,-8,18
Amkar,8029,10,4,6,10,11,24,-13,18
Anzhi,8029,11,3,6,11,15,37,-22,15
Loko Moscow,8030,1,11,7,2,31,13,18,40
CSKA Moscow,8030,2,11,4,5,27,17,10,37
Spart Moscow,8030,3,10,5,5,39,30,9,35
Krasnodar,8030,4,9,5,6,30,25,5,32
Zenit,8030,5,7,10,3,22,14,8,31
Terek Grozny,8030,6,8,5,7,24,23,1,29
FK Rubin,8030,7,6,5,9,22,19,3,23
Din Moscow,8030,8,5,6,9,17,23,-6,21
Amkar,8030,9,5,4,11,12,28,-16,19
Rostov,8030,10,4,6,10,12,20,-8,18
Anzhi,8030,11,3,5,12,15,39,-24,14
Loko Moscow,8031,1,12,5,3,32,12,20,41
Spart Moscow,8031,2,11,5,4,39,26,13,38
CSKA Moscow,8031,3,11,3,6,27,18,9,36
Krasnodar,8031,4,10,4,6,29,24,5,34
Zenit,8031,5,8,8,4,22,16,6,32
Terek Grozny,8031,6,8,6,6,23,23,0,30
FK Rubin,8031,7,6,5,9,24,20,4,23
Din Moscow,8031,8,5,6,9,19,25,-6,21
Rostov,8031,9,4,6,10,11,21,-10,18
Amkar,8031,10,4,5,11,10,24,-14,17
Anzhi,8031,11,2,5,13,14,41,-27,11
Loko Moscow,8032,1,13,5,2,34,12,22,44
CSKA Moscow,8032,2,12,3,5,28,18,10,39
Spart Moscow,8032,3,8,7,5,36,29,7,31
Terek Grozny,8032,4,8,6,6,22,23,-1,30
Zenit,8032,5,7,8,5,22,17,5,29
Krasnodar,8032,6,8,5,7,29,28,1,29
Din Moscow,8032,7,5,8,7,19,23,-4,23
FK Rubin,8032,8,5,7,8,23,19,4,22
Amkar,8032,9,5,5,10,11,23,-12,20
Rostov,8032,10,4,7,9,12,19,-7,19
Anzhi,8032,11,2,5,13,14,39,-25,11
Loko Moscow,8033,1,13,5,2,31,11,20,44
Spart Moscow,8033,2,9,7,4,35,26,9,34
CSKA Moscow,8033,3,10,4,6,25,22,3,34
Zenit,8033,4,8,8,4,26,14,12,32
Terek Grozny,8033,5,8,5,7,22,25,-3,29
Krasnodar,8033,6,8,4,8,27,28,-1,28
Din Moscow,8033,7,6,6,8,18,22,-4,24
FK Rubin,8033,8,6,5,9,24,18,6,23
Rostov,8033,9,4,7,9,11,18,-7,19
Amkar,8033,10,4,5,11,10,24,-14,17
Anzhi,8033,11,3,6,11,16,37,-21,15
Loko Moscow,8034,1,12,5,3,30,12,18,41
CSKA Moscow,8034,2,11,4,5,29,18,11,37
Spart Moscow,8034,3,8,8,4,35,27,8,32
Krasnodar,8034,4,9,4,7,29,26,3,31
Zenit,8034,5,7,9,4,22,15,7,30
Terek Grozny,8034,6,8,5,7,21,23,-2,29
FK Rubin,8034,7,7,5,8,26,20,6,26
Din Moscow,8034,8,5,7,8,19,24,-5,22
Rostov,8034,9,4,7,9,11,18,-7,19
Amkar,8034,10,4,5,11,10,24,-14,17
Anzhi,8034,11,3,5,12,15,40,-25,14
Loko Moscow,8035,1,12,5,3,31,13,18,41
CSKA Moscow,8035,2,11,4,5,29,19,10,37
Spart Moscow,8035,3,10,6,4,40,27,13,36
Zenit,8035,4,8,9,3,23,14,9,33
Terek Grozny,8035,5,8,5,7,22,24,-2,29
Krasnodar,8035,6,8,4,8,30,29,1,28
Din Moscow,8035,7,6,7,7,20,21,-1,25
FK Rubin,8035,8,6,5,9,24,22,2,23
Amkar,8035,9,5,4,11,13,27,-14,19
Rostov,8035,10,4,6,10,10,20,-10,18
Anzhi,8035,11,2,5,13,15,41,-26,11
Loko Moscow,8036,1,11,7,2,30,12,18,40
CSKA Moscow,8036,2,11,3,6,26,20,6,36
Zenit,8036,3,8,9,3,24,13,11,33
Spart Moscow,8036,4,9,6,5,36,28,8,33
Krasnodar,8036,5,8,6,6,30,27,3,30
Terek Grozny,8036,6,8,6,6,23,24,-1,30
Din Moscow,8036,7,5,8,7,20,24,-4,23
FK Rubin,8036,8,5,7,8,24,20,4,22
Rostov,8036,9,5,6,9,11,17,-6,21
Amkar,8036,10,4,5,11,10,24,-14,17
Anzhi,8036,11,2,5,13,15,40,-25,11
Loko Moscow,8037,1,12,6,2,30,11,19,42
CSKA Moscow,8037,2,11,4,5,28,18,10,37
Terek Grozny,8037,3,9,5,6,25,23,2,32
Spart Moscow,8037,4,8,7,5,37,30,7,31
Zenit,8037,5,7,9,4,22,15,7,30
Krasnodar,8037,6,8,6,6,27,24,3,30
Din Moscow,8037,7,5,8,7,19,23,-4,23
FK Rubin,8037,8,5,7,8,22,18,4,22
Rostov,8037,9,5,6,9,12,18,-6,21
Amkar,8037,10,4,5,11,11,25,-14,17
Anzhi,8037,11,2,5,13,15,43,-28,11
Loko Moscow,8038,1,12,5,3,30,12,18,41
CSKA Moscow,8038,2,10,5,5,26,18,8,35
Krasnodar,8038,3,10,4,6,29,24,5,34
Zenit,8038,4,7,9,4,22,15,7,30
Spart Moscow,8038,5,8,6,6,36,30,6,30
Terek Grozny,8038,6,8,5,7,22,24,-2,29
Din Moscow,8038,7,7,6,7,19,21,-2,27
Rostov,8038,8,5,6,9,13,19,-6,21
FK Rubin,8038,9,5,5,10,21,19,2,20
Amkar,8038,10,5,5,10,12,24,-12,20
Anzhi,8038,11,2,6,12,14,38,-24,12
Loko Moscow,8039,1,12,6,2,34,12,22,42
CSKA Moscow,8039,2,11,4,5,27,18,9,37
Krasnodar,8039,3,9,5,6,31,26,5,32
Terek Grozny,8039,4,9,5,6,24,23,1,32
Spart Moscow,8039,5,8,6,6,36,30,6,30
Zenit,8039,6,7,9,4,21,17,4,30
Din Moscow,8039,7,6,7,7,19,22,-3,25
FK Rubin,8039,8,5,6,9,23,21,2,21
Rostov,8039,9,5,6,9,12,18,-6,21
Amkar,8039,10,4,5,11,12,27,-15,17
Anzhi,8039,11,2,5,13,15,40,-25,11
Loko Moscow,8040,1,11,7,2,34,16,18,40
CSKA Moscow,8040,2,12,3,5,29,18,11,39
Spart Moscow,8040,3,10,5,5,37,30,7,35
Zenit,8040,4,7,9,4,26,19,7,30
Krasnodar,8040,5,8,6,6,28,25,3,30
Terek Grozny,8040,6,7,6,7,20,23,-3,27
Din Moscow,8040,7,6,6,8,19,23,-4,24
Amkar,8040,8,6,4,10,13,22,-9,22
FK Rubin,8040,9,5,6,9,21,18,3,21
Rostov,8040,10,4,6,10,11,19,-8,18
Anzhi,8040,11,2,6,12,14,39,-25,12
Loko Moscow,8041,1,12,5,3,34,15,19,41
CSKA Moscow,8041,2,11,3,6,27,19,8,36
Spart Moscow,8041,3,9,6,5,37,29,8,33
Zenit,8041,4,8,8,4,23,16,7,32
Krasnodar,8041,5,9,5,6,31,27,4,32
Terek Grozny,8041,6,8,5,7,22,24,-2,29
Din Moscow,8041,7,5,8,7,19,23,-4,23
FK Rubin,8041,8,5,7,8,23,19,4,22
Amkar,8041,9,6,4,10,12,23,-11,22
Rostov,8041,10,4,6,10,11,19,-8,18
Anzhi,8041,11,2,5,13,16,41,-25,11
Loko Moscow,8042,1,12,6,2,31,12,19,42
CSKA Moscow,8042,2,12,3,5,30,17,13,39
Spart Moscow,8042,3,10,6,4,40,27,13,36
Zenit,8042,4,7,9,4,22,16,6,30
Krasnodar,8042,5,8,4,8,28,28,0,28
Terek Grozny,8042,6,7,6,7,20,25,-5,27
Din Moscow,8042,7,6,7,7,20,22,-2,25
FK Rubin,8042,8,6,5,9,24,20,4,23
Rostov,8042,9,4,6,10,11,20,-9,18
Amkar,8042,10,4,5,11,9,25,-16,17
Anzhi,8042,11,3,5,12,17,40,-23,14
Loko Moscow,8043,1,11,7,2,30,12,18,40
Spart Moscow,8043,2,10,5,5,39,30,9,35
Zenit,8043,3,8,9,3,25,14,11,33
CSKA Moscow,8043,4,10,3,7,26,22,4,33
Terek Grozny,8043,5,9,5,6,22,22,0,32
Krasnodar,8043,6,8,6,6,28,25,3,30
FK Rubin,8043,7,5,7,8,22,18,4,22
Din Moscow,8043,8,5,7,8,18,23,-5,22
Amkar,8043,9,5,4,11,12,24,-12,19
Rostov,8043,10,4,6,10,11,20,-9,18
Anzhi,8043,11,3,5,12,16,39,-23,14
Loko Moscow,8044,1,11,6,3,30,13,17,39
CSKA Moscow,8044,2,11,4,5,29,20,9,37
Spart Moscow,8044,3,9,7,4,36,27,9,34
Zenit,8044,4,8,8,4,24,16,8,32
Krasnodar,8044,5,9,5,6,29,25,4,32
Terek Grozny,8044,6,8,6,6,22,23,-1,30
FK Rubin,8044,7,6,5,9,24,19,5,23
Din Moscow,8044,8,5,7,8,17,23,-6,22
Rostov,8044,9,4,6,10,11,19,-8,18
Amkar,8044,10,4,6,10,11,24,-13,18
Anzhi,8044,11,2,6,12,16,40,-24,12
Loko Moscow,8045,1,11,6,3,29,12,17,39
Krasnodar,8045,2,10,4,6,31,25,6,34
CSKA Moscow,8045,3,10,4,6,27,21,6,34
Spart Moscow,8045,4,9,6,5,35,28,7,33
Terek Grozny,8045,5,9,5,6,27,23,4,32
Zenit,8045,6,7,10,3,22,14,8,31
Din Moscow,8045,7,6,6,8,20,23,-3,24
FK Rubin,8045,8,6,5,9,24,21,3,23
Rostov,8045,9,4,6,10,11,19,-8,18
Amkar,8045,10,4,5,11,9,26,-17,17
Anzhi,8045,11,3,5,12,18,41,-23,14
Loko Moscow,8046,1,11,6,3,30,13,17,39
CSKA Moscow,8046,2,12,3,5,29,17,12,39
Spart Moscow,8046,3,10,5,5,37,30,7,35
Zenit,8046,4,8,8,4,22,14,8,32
Krasnodar,8046,5,9,5,6,29,25,4,32
Terek Grozny,8046,6,7,6,7,21,24,-3,27
FK Rubin,8046,7,6,5,9,22,18,4,23
Din Moscow,8046,8,5,6,9,18,24,-6,21
Amkar,8046,9,5,5,10,13,23,-10,20
Rostov,8046,10,4,6,10,11,19,-8,18
Anzhi,8046,11,3,5,12,15,40,-25,14
Loko Moscow,8047,1,11,5,4,30,15,15,38
CSKA Moscow,8047,2,11,4,5,32,20,12,37
Zenit,8047,3,8,9,3,26,16,10,33
Spart Moscow,8047,4,9,6,5,36,28,8,33
Krasnodar,8047,5,9,5,6,32,28,4,32
Terek Grozny,8047,6,7,7,6,21,23,-2,28
Din Moscow,8047,7,6,7,7,21,23,-2,25
FK Rubin,8047,8,5,7,8,26,22,4,22
Rostov,8047,9,4,7,9,10,17,-7,19
Amkar,8047,10,4,5,11,10,25,-15,17
Anzhi,8047,11,2,6,12,15,42,-27,12
Loko Moscow,8048,1,13,5,2,36,11,25,44
CSKA Moscow,8048,2,11,4,5,29,19,10,37
Spart Moscow,8048,3,10,5,5,37,27,10,35
Krasnodar,8048,4,9,4,7,30,29,1,31
Zenit,8048,5,7,9,4,21,15,6,30
Terek Grozny,8048,6,8,5,7,21,23,-2,29
Din Moscow,8048,7,5,7,8,17,24,-7,22
FK Rubin,8048,8,5,6,9,21,20,1,21
Rostov,8048,9,5,6,9,12,17,-5,21
Amkar,8048,10,4,4,12,9,24,-15,16
Anzhi,8048,11,3,5,12,17,41,-24,14
Loko Moscow,8049,1,11,5,4,30,14,16,38
Spart Moscow,8049,2,11,5,4,38,26,12,38
CSKA Moscow,8049,3,11,4,5,27,18,9,37
Krasnodar,8049,4,10,4,6,33,24,9,34
Zenit,8049,5,8,9,3,23,14,9,33
Terek Grozny,8049,6,9,5,6,25,23,2,32
FK Rubin,8049,7,6,5,9,22,22,0,23
Din Moscow,8049,8,5,6,9,17,23,-6,21
Rostov,8049,9,4,6,10,10,18,-8,18
Amkar,8049,10,4,4,12,11,28,-17,16
Anzhi,8049,11,2,5,13,15,41,-26,11
Loko Moscow,8050,1,12,6,2,32,13,19,42
CSKA Moscow,8050,2,11,3,6,28,20,8,36
Spart Moscow,8050,3,10,5,5,40,28,12,35
Zenit,8050,4,7,9,4,22,16,6,30
Krasnodar,8050,5,8,5,7,29,27,2,29
Terek Grozny,8050,6,8,5,7,23,27,-4,29
FK Rubin,8050,7,5,7,8,23,19,4,22
Din Moscow,8050,8,5,7,8,18,23,-5,22
Rostov,8050,9,5,6,9,13,19,-6,21
Amkar,8050,10,5,4,11,12,26,-14,19
Anzhi,8050,11,3,5,12,19,41,-22,14
Loko Moscow,8051,1,11,6,3,29,12,17,39
Spart Moscow,8051,2,10,6,4,40,29,11,36
CSKA Moscow,8051,3,11,3,6,29,20,9,36
Zenit,8051,4,9,8,3,24,13,11,35
Krasnodar,8051,5,8,5,7,28,26,2,29
Terek Grozny,8051,6,7,6,7,22,26,-4,27
FK Rubin,8051,7,7,5,8,25,18,7,26
Din Moscow,8051,8,5,6,9,19,27,-8,21
Rostov,8051,9,4,7,9,11,18,-7,19
Amkar,8051,10,5,4,11,13,25,-12,19
Anzhi,8051,11,2,6,12,16,42,-26,12
Loko Moscow,8052,1,12,6,2,34,12,22,42
CSKA Moscow,8052,2,10,4,6,26,19,7,34
Spart Moscow,8052,3,9,5,6,39,30,9,32
Zenit,8052,4,8,8,4,22,17,5,32
Krasnodar,8052,5,8,6,6,28,25,3,30
Terek Grozny,8052,6,7,5,8,20,25,-5,26
Din Moscow,8052,7,6,6,8,20,25,-5,24
Amkar,8052,8,6,4,10,12,23,-11,22
FK Rubin,8052,9,5,6,9,21,19,2,21
Rostov,8052,10,5,6,9,12,18,-6,21
Anzhi,8052,11,3,6,11,17,38,-21,15
Loko Moscow,8053,1,12,5,3,32,14,18,41
Spart Moscow,8053,2,11,5,4,40,29,11,38
Krasnodar,8053,3,10,4,6,31,25,6,34
CSKA Moscow,8053,4,10,3,7,25,21,4,33
Zenit,8053,5,8,8,4,24,15,9,32
Terek Grozny,8053,6,8,5,7,22,24,-2,29
FK Rubin,8053,7,6,5,9,23,20,3,23
Din Moscow,8053,8,5,6,9,20,26,-6,21
Amkar,8053,9,5,4,11,12,24,-12,19
Rostov,8053,10,4,6,10,11,19,-8,18
Anzhi,8053,11,3,5,12,16,39,-23,14
Loko Moscow,8054,1,12,5,3,33,14,19,41
CSKA Moscow,8054,2,12,3,5,30,19,11,39
Spart Moscow,8054,3,11,5,4,40,27,13,38
Krasnodar,8054,4,9,4,7,30,28,2,31
Terek Grozny,8054,5,8,6,6,24,24,0,30
Zenit,8054,6,7,8,5,23,19,4,29
FK Rubin,8054,7,7,5,8,25,18,7,26
Din Moscow,8054,8,5,6,9,18,26,-8,21
Rostov,8054,9,4,6,10,10,18,-8,18
Amkar,8054,10,4,5,11,12,26,-14,17
Anzhi,8054,11,2,5,13,15,41,-26,11
Loko Moscow,8055,1,12,6,2,31,12,19,42
CSKA Moscow,8055,2,10,4,6,26,20,6,34
Spart Moscow,8055,3,9,6,5,35,27,8,33
Zenit,8055,4,7,9,4,23,16,7,30
Krasnodar,8055,5,8,6,6,28,25,3,30
Terek Grozny,8055,6,8,6,6,21,22,-1,30
FK Rubin,8055,7,6,6,8,25,19,6,24
Din Moscow,8055,8,6,6,8,19,24,-5,24
Rostov,8055,9,4,7,9,10,17,-7,19
Amkar,8055,10,4,5,11,10,24,-14,17
Anzhi,8055,11,3,5,12,16,38,-22,14
Loko Moscow,8056,1,11,7,2,31,13,18,40
Spart Moscow,8056,2,10,6,4,40,26,14,36
CSKA Moscow,8056,3,10,5,5,27,19,8,35
Zenit,8056,4,7,10,3,23,15,8,31
Terek Grozny,8056,5,8,6,6,24,23,1,30
Krasnodar,8056,6,8,5,7,29,27,2,29
Din Moscow,8056,7,6,6,8,22,24,-2,24
FK Rubin,8056,8,6,5,9,22,22,0,23
Rostov,8056,9,4,6,10,10,20,-10,18
Amkar,8056,10,4,6,10,11,24,-13,18
Anzhi,8056,11,2,6,12,14,40,-26,12
Loko Moscow,8057,1,11,5,4,29,14,15,38
CSKA Moscow,8057,2,11,4,5,29,18,11,37
Zenit,8057,3,8,9,3,23,13,10,33
Spart Moscow,8057,4,8,7,5,35,28,7,31
Krasnodar,8057,5,9,4,7,29,26,3,31
Terek Grozny,8057,6,7,6,7,21,25,-4,27
FK Rubin,8057,7,7,5,8,26,19,7,26
Din Moscow,8057,8,6,6,8,20,25,-5,24
Amkar,8057,9,5,5,10,12,23,-11,20
Rostov,8057,10,4,7,9,10,17,-7,19
Anzhi,8057,11,2,6,12,16,42,-26,12
Loko Moscow,8058,1,12,5,3,31,12,19,41
Spart Moscow,8058,2,10,6,4,39,26,13,36
CSKA Moscow,8058,3,11,3,6,30,21,9,36
Zenit,8058,4,8,8,4,25,15,10,32
Krasnodar,8058,5,9,5,6,29,25,4,32
Terek Grozny,8058,6,8,5,7,22,25,-3,29
Din Moscow,8058,7,6,6,8,19,26,-7,24
FK Rubin,8058,8,5,6,9,23,20,3,21
Rostov,8058,9,4,7,9,11,18,-7,19
Amkar,8058,10,4,4,12,10,25,-15,16
Anzhi,8058,11,3,5,12,16,42,-26,14
Loko Moscow,8059,1,12,6,2,32,12,20,42
CSKA Moscow,8059,2,11,4,5,27,18,9,37
Spart Moscow,8059,3,10,6,4,43,27,16,36
Zenit,8059,4,7,10,3,22,14,8,31
Krasnodar,8059,5,9,4,7,30,28,2,31
Terek Grozny,8059,6,7,6,7,21,24,-3,27
Din Moscow,8059,7,6,7,7,21,22,-1,25
FK Rubin,8059,8,5,5,10,22,22,0,20
Amkar,8059,9,5,4,11,11,28,-17,19
Rostov,8059,10,4,6,10,10,20,-10,18
Anzhi,8059,11,2,6,12,15,39,-24,12
Loko Moscow,8060,1,12,6,2,32,12,20,42
CSKA Moscow,8060,2,11,4,5,30,19,11,37
Spart Moscow,8060,3,9,6,5,38,28,10,33
Krasnodar,8060,4,9,4,7,32,28,4,31
Zenit,8060,5,7,9,4,21,16,5,30
Din Moscow,8060,6,7,6,7,21,21,0,27
Terek Grozny,8060,7,7,6,7,22,25,-3,27
FK Rubin,8060,8,5,5,10,22,24,-2,20
Rostov,8060,9,4,7,9,12,19,-7,19
Amkar,8060,10,5,4,11,10,25,-15,19
Anzhi,8060,11,2,7,11,18,41,-23,13
Loko Moscow,8061,1,13,5,2,36,14,22,44
CSKA Moscow,8061,2,12,3,5,28,17,11,39
Spart Moscow,8061,3,10,6,4,41,28,13,36
Zenit,8061,4,7,8,5,23,18,5,29
Krasnodar,8061,5,8,4,8,28,30,-2,28
Terek Grozny,8061,6,7,5,8,21,26,-5,26
FK Rubin,8061,7,6,6,8,25,18,7,24
Din Moscow,8061,8,5,7,8,19,27,-8,22
Amkar,8061,9,5,5,10,13,25,-12,20
Rostov,8061,10,4,6,10,10,18,-8,18
Anzhi,8061,11,3,5,12,16,39,-23,14
Loko Moscow,8062,1,12,6,2,31,12,19,42
CSKA Moscow,8062,2,10,4,6,25,18,7,34
Spart Moscow,8062,3,9,5,6,38,33,5,32
Krasnodar,8062,4,9,5,6,31,27,4,32
Zenit,8062,5,7,9,4,21,14,7,30
Terek Grozny,8062,6,8,6,6,25,26,-1,30
Din Moscow,8062,7,6,6,8,18,23,-5,24
FK Rubin,8062,8,6,5,9,25,20,5,23
Amkar,8062,9,5,5,10,17,26,-9,20
Rostov,8062,10,4,6,10,11,20,-9,18
Anzhi,8062,11,3,5,12,17,40,-23,14
Loko Moscow,8063,1,11,7,2,32,14,18,40
CSKA Moscow,8063,2,11,4,5,28,19,9,37
Spart Moscow,8063,3,9,6,5,37,29,8,33
Krasnodar,8063,4,9,5,6,30,25,5,32
Terek Grozny,8063,5,9,5,6,22,22,0,32
Zenit,8063,6,7,9,4,24,17,7,30
Din Moscow,8063,7,6,7,7,19,21,-2,25
FK Rubin,8063,8,5,6,9,21,19,2,21
Rostov,8063,9,4,6,10,10,19,-9,18
Amkar,8063,10,4,5,11,11,25,-14,17
Anzhi,8063,11,2,6,12,15,39,-24,12
Loko Moscow,8064,1,11,7,2,32,14,18,40
CSKA Moscow,8064,2,11,4,5,29,18,11,37
Zenit,8064,3,7,9,4,23,18,5,30
Spart Moscow,8064,4,8,6,6,36,32,4,30
Terek Grozny,8064,5,8,6,6,24,25,-1,30
Krasnodar,8064,6,8,5,7,28,27,1,29
Din Moscow,8064,7,6,7,7,21,24,-3,25
FK Rubin,8064,8,6,6,8,24,18,6,24
Amkar,8064,9,5,5,10,13,23,-10,20
Rostov,8064,10,4,7,9,11,18,-7,19
Anzhi,8064,11,2,6,12,17,41,-24,12
Loko Moscow,8065,1,11,7,2,31,13,18,40
CSKA Moscow,8065,2,11,3,6,28,21,7,36
Spart Moscow,8065,3,10,5,5,38,30,8,35
Zenit,8065,4,8,9,3,25,15,10,33
Krasnodar,8065,5,8,6,6,28,25,3,30
Terek Grozny,8065,6,7,6,7,21,24,-3,27
FK Rubin,8065,7,6,6,8,22,17,5,24
Rostov,8065,8,5,6,9,14,19,-5,21
Din Moscow,8065,9,5,6,9,18,24,-6,21
Amkar,8065,10,4,5,11,10,24,-14,17
Anzhi,8065,11,3,5,12,16,39,-23,14
Loko Moscow,8066,1,11,6,3,29,12,17,39
CSKA Moscow,8066,2,12,3,5,30,19,11,39
Spart Moscow,8066,3,10,6,4,38,26,12,36
Krasnodar,8066,4,10,4,6,30,24,6,34
Zenit,8066,5,7,9,4,22,16,6,30
Terek Grozny,8066,6,7,7,6,21,23,-2,28
FK Rubin,8066,7,6,5,9,22,19,3,23
Din Moscow,8066,8,5,6,9,17,24,-7,21
Rostov,8066,9,4,6,10,11,20,-9,18
Amkar,8066,10,4,6,10,9,22,-13,18
Anzhi,8066,11,2,6,12,16,40,-24,12
Loko Moscow,8067,1,12,6,2,32,12,20,42
CSKA Moscow,8067,2,11,3,6,26,18,8,36
Spart Moscow,8067,3,10,5,5,37,27,10,35
Krasnodar,8067,4,9,4,7,29,27,2,31
Zenit,8067,5,7,9,4,21,14,7,30
Terek Grozny,8067,6,7,5,8,20,25,-5,26
Din Moscow,8067,7,5,7,8,19,24,-5,22
Amkar,8067,8,6,4,10,12,22,-10,22
FK Rubin,8067,9,5,6,9,22,19,3,21
Rostov,8067,10,4,6,10,10,19,-9,18
Anzhi,8067,11,4,5,11,16,37,-21,17
Loko Moscow,8068,1,12,5,3,31,15,16,41
CSKA Moscow,8068,2,11,3,6,26,19,7,36
Krasnodar,8068,3,10,4,6,31,24,7,34
Spart Moscow,8068,4,9,6,5,34,26,8,33
Zenit,8068,5,8,8,4,24,15,9,32
Terek Grozny,8068,6,8,5,7,21,24,-3,29
FK Rubin,8068,7,6,5,9,23,19,4,23
Din Moscow,8068,8,5,7,8,18,23,-5,22
Amkar,8068,9,6,4,10,12,22,-10,22
Rostov,8068,10,4,6,10,10,18,-8,18
Anzhi,8068,11,2,5,13,14,39,-25,11
Loko Moscow,8069,1,11,6,3,30,14,16,39
Krasnodar,8069,2,10,4,6,32,25,7,34
Zenit,8069,3,8,9,3,24,15,9,33
CSKA Moscow,8069,4,10,3,7,28,22,6,33
Spart Moscow,8069,5,8,5,7,34,32,2,29
Din Moscow,8069,6,7,6,7,20,21,-1,27
Terek Grozny,8069,7,7,5,8,22,26,-4,26
Amkar,8069,8,6,4,10,12,23,-11,22
Rostov,8069,9,5,6,9,14,17,-3,21
FK Rubin,8069,10,5,5,10,22,22,0,20
Anzhi,8069,11,4,5,11,20,41,-21,17
Loko Moscow,8070,1,12,5,3,32,13,19,41
Krasnodar,8070,2,10,4,6,31,25,6,34
CSKA Moscow,8070,3,10,3,7,27,21,6,33
Zenit,8070,4,8,8,4,23,17,6,32
Terek Grozny,8070,5,9,5,6,24,23,1,32
Spart Moscow,8070,6,8,6,6,34,31,3,30
Din Moscow,8070,7,7,6,7,21,21,0,27
FK Rubin,8070,8,5,5,10,22,21,1,20
Rostov,8070,9,4,7,9,11,18,-7,19
Amkar,8070,10,5,4,11,13,24,-11,19
Anzhi,8070,11,3,5,12,16,40,-24,14
Loko Moscow,8071,1,12,5,3,31,14,17,41
Spart Moscow,8071,2,11,5,4,39,25,14,38
CSKA Moscow,8071,3,10,5,5,26,18,8,35
Krasnodar,8071,4,9,4,7,30,25,5,31
Zenit,8071,5,7,9,4,22,16,6,30
FK Rubin,8071,6,7,5,8,25,19,6,26
Terek Grozny,8071,7,7,5,8,21,26,-5,26
Din Moscow,8071,8,5,6,9,19,26,-7,21
Amkar,8071,9,5,4,11,11,25,-14,19
Rostov,8071,10,4,6,10,10,19,-9,18
Anzhi,8071,11,3,6,11,16,37,-21,15
Loko Moscow,8072,1,12,5,3,32,12,20,41
CSKA Moscow,8072,2,11,4,5,26,17,9,37
Krasnodar,8072,3,10,4,6,29,24,5,34
Spart Moscow,8072,4,9,6,5,35,27,8,33
Zenit,8072,5,7,8,5,21,17,4,29
Terek Grozny,8072,6,7,5,8,20,26,-6,26
Din Moscow,8072,7,6,6,8,19,25,-6,24
FK Rubin,8072,8,6,5,9,24,18,6,23
Rostov,8072,9,4,7,9,10,17,-7,19
Amkar,8072,10,5,4,11,11,23,-12,19
Anzhi,8072,11,3,6,11,16,37,-21,15
Loko Moscow,8073,1,11,7,2,31,13,18,40
CSKA Moscow,8073,2,11,3,6,27,19,8,36
Spart Moscow,8073,3,9,6,5,37,28,9,33
Zenit,8073,4,8,9,3,23,14,9,33
Krasnodar,8073,5,9,5,6,32,26,6,32
Terek Grozny,8073,6,8,5,7,23,24,-1,29
Din Moscow,8073,7,7,6,7,21,23,-2,27
FK Rubin,8073,8,5,5,10,22,22,0,20
Amkar,8073,9,5,5,10,10,22,-12,20
Rostov,8073,10,4,6,10,10,19,-9,18
Anzhi,8073,11,2,5,13,16,42,-26,11
Loko Moscow,8074,1,11,5,4,31,16,15,38
CSKA Moscow,8074,2,11,3,6,26,18,8,36
Spart Moscow,8074,3,9,7,4,40,30,10,34
Krasnodar,8074,4,10,4,6,32,26,6,34
Zenit,8074,5,8,8,4,23,14,9,32
Terek Grozny,8074,6,8,5,7,22,25,-3,29
Din Moscow,8074,7,5,8,7,20,24,-4,23
FK Rubin,8074,8,5,6,9,22,20,2,21
Rostov,8074,9,4,7,9,12,19,-7,19
Anzhi,8074,10,4,5,11,18,38,-20,17
Amkar,8074,11,4,4,12,10,26,-16,16
Loko Moscow,8075,1,11,6,3,34,17,17,39
CSKA Moscow,8075,2,11,4,5,26,17,9,37
Krasnodar,8075,3,9,5,6,33,29,4,32
Zenit,8075,4,7,9,4,22,15,7,30
Spart Moscow,8075,5,8,5,7,34,30,4,29
Din Moscow,8075,6,7,6,7,19,21,-2,27
Terek Grozny,8075,7,7,5,8,22,26,-4,26
Amkar,8075,8,6,4,10,13,23,-10,22
FK Rubin,8075,9,5,6,9,22,19,3,21
Rostov,8075,10,5,6,9,12,18,-6,21
Anzhi,8075,11,3,6,11,16,38,-22,15
Loko Moscow,8076,1,12,5,3,32,14,18,41
Spart Moscow,8076,2,10,6,4,43,28,15,36
CSKA Moscow,8076,3,10,4,6,26,19,7,34
Zenit,8076,4,8,9,3,25,15,10,33
Krasnodar,8076,5,9,4,7,29,27,2,31
Terek Grozny,8076,6,7,6,7,21,24,-3,27
FK Rubin,8076,7,6,5,9,24,20,4,23
Din Moscow,8076,8,5,6,9,20,29,-9,21
Rostov,8076,9,4,7,9,10,17,-7,19
Amkar,8076,10,4,5,11,11,27,-16,17
Anzhi,8076,11,4,5,11,16,37,-21,17
Loko Moscow,8077,1,12,5,3,32,17,15,41
CSKA Moscow,8077,2,11,3,6,29,20,9,36
Krasnodar,8077,3,10,4,6,34,26,8,34
Zenit,8077,4,8,8,4,24,16,8,32
Spart Moscow,8077,5,9,5,6,35,28,7,32
Terek Grozny,8077,6,7,5,8,20,26,-6,26
Din Moscow,8077,7,6,7,7,18,21,-3,25
FK Rubin,8077,8,5,6,9,22,19,3,21
Rostov,8077,9,5,6,9,12,17,-5,21
Amkar,8077,10,5,4,11,10,24,-14,19
Anzhi,8077,11,3,5,12,18,40,-22,14
Loko Moscow,8078,1,13,5,2,32,11,21,44
CSKA Moscow,8078,2,11,4,5,26,17,9,37
Spart Moscow,8078,3,9,7,4,39,29,10,34
Krasnodar,8078,4,9,4,7,29,26,3,31
Terek Grozny,8078,5,8,6,6,22,23,-1,30
Zenit,8078,6,7,8,5,21,16,5,29
Din Moscow,8078,7,6,7,7,21,22,-1,25
FK Rubin,8078,8,5,5,10,22,22,0,20
Rostov,8078,9,4,6,10,11,20,-9,18
Amkar,8078,10,4,5,11,11,25,-14,17
Anzhi,8078,11,2,7,11,15,38,-23,13
Loko Moscow,8079,1,12,5,3,32,14,18,41
Spart Moscow,8079,2,10,5,5,40,30,10,35
CSKA Moscow,8079,3,10,4,6,25,18,7,34
Zenit,8079,4,8,9,3,23,14,9,33
Terek Grozny,8079,5,8,6,6,23,24,-1,30
Krasnodar,8079,6,8,4,8,28,27,1,28
Din Moscow,8079,7,6,6,8,21,25,-4,24
FK Rubin,8079,8,6,5,9,23,20,3,23
Rostov,8079,9,5,6,9,13,18,-5,21
Amkar,8079,10,4,5,11,10,25,-15,17
Anzhi,8079,11,3,5,12,17,40,-23,14
Loko Moscow,8080,1,11,6,3,31,14,17,39
CSKA Moscow,8080,2,11,3,6,30,19,11,36
Spart Moscow,8080,3,10,5,5,39,28,11,35
Zenit,8080,4,9,8,3,23,13,10,35
Krasnodar,8080,5,9,5,6,31,26,5,32
Terek Grozny,8080,6,7,5,8,21,26,-5,26
FK Rubin,8080,7,6,5,9,23,20,3,23
Amkar,8080,8,6,4,10,13,23,-10,22
Din Moscow,8080,9,5,6,9,19,26,-7,21
Rostov,8080,10,4,6,10,10,20,-10,18
Anzhi,8080,11,3,5,12,17,42,-25,14
Loko Moscow,8081,1,12,6,2,37,14,23,42
CSKA Moscow,8081,2,11,4,5,29,19,10,37
Spart Moscow,8081,3,10,6,4,37,26,11,36
Krasnodar,8081,4,9,4,7,29,30,-1,31
Zenit,8081,5,7,9,4,23,17,6,30
Terek Grozny,8081,6,7,6,7,22,25,-3,27
Din Moscow,8081,7,6,7,7,19,22,-3,25
FK Rubin,8081,8,5,5,10,22,20,2,20
Amkar,8081,9,5,4,11,12,26,-14,19
Rostov,8081,10,4,6,10,10,18,-8,18
Anzhi,8081,11,2,7,11,17,40,-23,13
Loko Moscow,8082,1,12,5,3,31,13,18,41
CSKA Moscow,8082,2,12,3,5,30,18,12,39
Spart Moscow,8082,3,9,7,4,39,27,12,34
Zenit,8082,4,8,8,4,22,16,6,32
Terek Grozny,8082,5,9,5,6,24,23,1,32
Krasnodar,8082,6,9,4,7,30,27,3,31
Din Moscow,8082,7,5,7,8,19,27,-8,22
FK Rubin,8082,8,5,6,9,23,20,3,21
Rostov,8082,9,4,7,9,10,17,-7,19
Amkar,8082,10,4,5,11,11,26,-15,17
Anzhi,8082,11,2,5,13,15,40,-25,11
Loko Moscow,8083,1,13,5,2,34,12,22,44
CSKA Moscow,8083,2,12,3,5,28,17,11,39
Spart Moscow,8083,3,10,5,5,37,27,10,35
Krasnodar,8083,4,9,4,7,29,28,1,31
Zenit,8083,5,7,8,5,22,16,6,29
Terek Grozny,8083,6,7,7,6,22,24,-2,28
Din Moscow,8083,7,5,7,8,19,24,-5,22
FK Rubin,8083,8,5,6,9,23,20,3,21
Amkar,8083,9,5,5,10,11,23,-12,20
Rostov,8083,10,4,6,10,10,19,-9,18
Anzhi,8083,11,2,6,12,15,40,-25,12
Loko Moscow,8084,1,13,5,2,32,12,20,44
CSKA Moscow,8084,2,10,5,5,28,20,8,35
Spart Moscow,8084,3,9,7,4,40,26,14,34
Zenit,8084,4,7,9,4,23,16,7,30
Krasnodar,8084,5,8,5,7,29,27,2,29
Terek Grozny,8084,6,7,7,6,20,22,-2,28
Din Moscow,8084,7,6,7,7,19,22,-3,25
FK Rubin,8084,8,5,6,9,24,21,3,21
Amkar,8084,9,4,6,10,10,23,-13,18
Rostov,8084,9,4,6,10,10,23,-13,18
Anzhi,8084,11,2,7,11,16,39,-23,13
Loko Moscow,8085,1,12,5,3,33,15,18,41
Spart Moscow,8085,2,9,6,5,38,31,7,33
CSKA Moscow,8085,3,10,3,7,27,22,5,33
Zenit,8085,4,8,8,4,25,17,8,32
Krasnodar,8085,5,9,4,7,29,27,2,31
Terek Grozny,8085,6,7,6,7,21,25,-4,27
Din Moscow,8085,7,6,6,8,19,24,-5,24
FK Rubin,8085,8,6,5,9,24,19,5,23
Amkar,8085,9,5,5,10,14,24,-10,20
Rostov,8085,10,4,7,9,11,18,-7,19
Anzhi,8085,11,4,5,11,20,39,-19,17
Loko Moscow,8086,1,12,5,3,31,12,19,41
Spart Moscow,8086,2,11,5,4,37,26,11,38
CSKA Moscow,8086,3,10,4,6,27,20,7,34
Zenit,8086,4,8,8,4,23,16,7,32
Krasnodar,8086,5,9,4,7,28,25,3,31
Terek Grozny,8086,6,8,6,6,23,24,-1,30
Din Moscow,8086,7,6,6,8,22,23,-1,24
FK Rubin,8086,8,6,5,9,22,21,1,23
Rostov,8086,9,4,6,10,10,18,-8,18
Amkar,8086,10,4,5,11,10,24,-14,17
Anzhi,8086,11,2,6,12,16,40,-24,12
Loko Moscow,8087,1,11,6,3,30,14,16,39
CSKA Moscow,8087,2,11,3,6,31,21,10,36
Spart Moscow,8087,3,10,5,5,37,27,10,35
Krasnodar,8087,4,10,4,6,30,24,6,34
Zenit,8087,5,8,9,3,25,14,11,33
Terek Grozny,8087,6,7,6,7,21,25,-4,27
Din Moscow,8087,7,6,6,8,20,24,-4,24
FK Rubin,8087,8,5,5,10,22,20,2,20
Amkar,8087,9,5,5,10,11,23,-12,20
Rostov,8087,10,4,6,10,10,19,-9,18
Anzhi,8087,11,3,5,12,17,43,-26,14
Loko Moscow,8088,1,11,5,4,30,18,12,38
Zenit,8088,2,9,8,3,28,13,15,35
CSKA Moscow,8088,3,10,4,6,25,19,6,34
Spart Moscow,8088,4,8,8,4,37,29,8,32
Terek Grozny,8088,5,9,5,6,24,23,1,32
Krasnodar,8088,6,9,4,7,30,28,2,31
FK Rubin,8088,7,6,6,8,26,20,6,24
Din Moscow,8088,8,5,8,7,20,24,-4,23
Rostov,8088,9,4,7,9,11,18,-7,19
Amkar,8088,10,4,5,11,11,26,-15,17
Anzhi,8088,11,2,6,12,15,39,-24,12
Loko Moscow,8089,1,13,5,2,34,12,22,44
CSKA Moscow,8089,2,11,4,5,28,18,10,37
Spart Moscow,8089,3,10,6,4,41,29,12,36
Zenit,8089,4,7,9,4,23,17,6,30
Krasnodar,8089,5,8,5,7,28,27,1,29
Terek Grozny,8089,6,8,5,7,21,23,-2,29
FK Rubin,8089,7,5,7,8,22,18,4,22
Din Moscow,8089,8,5,7,8,18,23,-5,22
Rostov,8089,9,4,6,10,12,22,-10,18
Amkar,8089,10,4,5,11,10,24,-14,17
Anzhi,8089,11,3,5,12,15,39,-24,14
Loko Moscow,8090,1,12,6,2,32,11,21,42
Spart Moscow,8090,2,11,5,4,41,27,14,38
Zenit,8090,3,8,9,3,23,14,9,33
CSKA Moscow,8090,4,10,3,7,27,23,4,33
Terek Grozny,8090,5,9,5,6,25,24,1,32
Krasnodar,8090,6,8,4,8,28,29,-1,28
Din Moscow,8090,7,6,6,8,20,23,-3,24
FK Rubin,8090,8,6,5,9,23,20,3,23
Rostov,8090,9,4,6,10,10,20,-10,18
Amkar,8090,10,4,4,12,11,27,-16,16
Anzhi,8090,11,3,5,12,19,41,-22,14
Loko Moscow,8091,1,12,5,3,31,13,18,41
CSKA Moscow,8091,2,11,4,5,30,18,12,37
Spart Moscow,8091,3,10,6,4,40,28,12,36
Zenit,8091,4,8,9,3,24,15,9,33
Krasnodar,8091,5,9,4,7,31,25,6,31
Terek Grozny,8091,6,8,6,6,24,24,0,30
Din Moscow,8091,7,5,7,8,19,25,-6,22
FK Rubin,8091,8,5,6,9,22,22,0,21
Rostov,8091,9,4,6,10,12,21,-9,18
Amkar,8091,10,4,6,10,10,23,-13,18
Anzhi,8091,11,2,5,13,15,44,-29,11
Loko Moscow,8092,1,12,5,3,31,13,18,41
CSKA Moscow,8092,2,11,4,5,27,18,9,37
Krasnodar,8092,3,10,4,6,31,25,6,34
Spart Moscow,8092,4,9,5,6,36,33,3,32
Zenit,8092,5,7,9,4,22,15,7,30
Terek Grozny,8092,6,7,7,6,22,24,-2,28
Din Moscow,8092,7,6,7,7,22,23,-1,25
FK Rubin,8092,8,5,6,9,22,20,2,21
Rostov,8092,9,5,6,9,13,17,-4,21
Amkar,8092,10,4,5,11,11,25,-14,17
Anzhi,8092,11,2,6,12,15,39,-24,12
Loko Moscow,8093,1,12,5,3,32,14,18,41
Spart Moscow,8093,2,10,6,4,47,29,18,36
CSKA Moscow,8093,3,11,3,6,30,21,9,36
Krasnodar,8093,4,10,4,6,33,25,8,34
Zenit,8093,5,8,8,4,26,18,8,32
Terek Grozny,8093,6,8,6,6,24,25,-1,30
Din Moscow,8093,7,5,7,8,20,30,-10,22
FK Rubin,8093,8,5,6,9,23,22,1,21
Rostov,8093,9,4,7,9,12,19,-7,19
Amkar,8093,10,4,4,12,10,28,-18,16
Anzhi,8093,11,2,6,12,16,42,-26,12
Loko Moscow,8094,1,11,7,2,31,13,18,40
Spart Moscow,8094,2,10,5,5,36,26,10,35
CSKA Moscow,8094,3,10,5,5,28,20,8,35
Zenit,8094,4,7,10,3,24,16,8,31
Krasnodar,8094,5,8,6,6,29,26,3,30
Terek Grozny,8094,6,8,5,7,21,24,-3,29
FK Rubin,8094,7,6,6,8,24,18,6,24
Amkar,8094,8,6,4,10,12,22,-10,22
Din Moscow,8094,9,5,6,9,17,24,-7,21
Rostov,8094,10,4,6,10,10,19,-9,18
Anzhi,8094,11,2,6,12,15,39,-24,12
Loko Moscow,8095,1,11,6,3,30,14,16,39
CSKA Moscow,8095,2,11,4,5,27,18,9,37
Zenit,8095,3,8,9,3,24,14,10,33
Spart Moscow,8095,4,9,6,5,39,31,8,33
Terek Grozny,8095,5,9,5,6,24,23,1,32
Krasnodar,8095,6,8,5,7,27,26,1,29
FK Rubin,8095,7,6,6,8,23,17,6,24
Din Moscow,8095,8,5,8,7,19,23,-4,23
Amkar,8095,9,5,4,11,13,27,-14,19
Rostov,8095,10,4,6,10,11,19,-8,18
Anzhi,8095,11,2,5,13,15,40,-25,11
Loko Moscow,8096,1,12,5,3,30,14,16,41
CSKA Moscow,8096,2,11,4,5,26,17,9,37
Krasnodar,8096,3,10,4,6,33,25,8,34
Spart Moscow,8096,4,9,5,6,37,28,9,32
Terek Grozny,8096,5,9,5,6,27,24,3,32
Zenit,8096,6,7,9,4,21,14,7,30
Din Moscow,8096,7,7,6,7,19,21,-2,27
FK Rubin,8096,8,5,5,10,22,21,1,20
Amkar,8096,9,5,4,11,13,27,-14,19
Rostov,8096,10,4,6,10,10,20,-10,18
Anzhi,8096,11,2,5,13,14,41,-27,11
Loko Moscow,8097,1,12,5,3,32,12,20,41
Spart Moscow,8097,2,11,5,4,44,27,17,38
CSKA Moscow,8097,3,11,3,6,28,22,6,36
Krasnodar,8097,4,10,4,6,31,24,7,34
Zenit,8097,5,8,8,4,25,17,8,32
Terek Grozny,8097,6,8,6,6,21,22,-1,30
FK Rubin,8097,7,6,5,9,22,20,2,23
Din Moscow,8097,8,5,6,9,18,26,-8,21
Rostov,8097,9,4,6,10,10,21,-11,18
Amkar,8097,10,4,4,12,10,26,-16,16
Anzhi,8097,11,2,6,12,15,39,-24,12
Loko Moscow,8098,1,11,6,3,31,14,17,39
Spart Moscow,8098,2,10,6,4,39,25,14,36
CSKA Moscow,8098,3,11,3,6,26,20,6,36
Zenit,8098,4,8,8,4,22,14,8,32
Krasnodar,8098,5,9,5,6,30,26,4,32
Terek Grozny,8098,6,8,6,6,22,23,-1,30
FK Rubin,8098,7,6,5,9,23,19,4,23
Din Moscow,8098,8,5,6,9,18,24,-6,21
Rostov,8098,9,4,6,10,10,22,-12,18
Amkar,8098,10,4,6,10,10,23,-13,18
Anzhi,8098,11,3,5,12,17,38,-21,14
Loko Moscow,8099,1,12,6,2,31,12,19,42
CSKA Moscow,8099,2,11,4,5,30,19,11,37
Spart Moscow,8099,3,10,5,5,37,28,9,35
Zenit,8099,4,7,9,4,22,15,7,30
Krasnodar,8099,5,8,6,6,28,25,3,30
Terek Grozny,8099,6,7,6,7,23,26,-3,27
Din Moscow,8099,7,6,6,8,19,24,-5,24
FK Rubin,8099,8,5,6,9,22,19,3,21
Rostov,8099,9,5,6,9,12,17,-5,21
Amkar,8099,10,5,4,11,12,25,-13,19
Anzhi,8099,11,2,6,12,17,43,-26,12
Loko Moscow,8100,1,12,5,3,32,13,19,41
Spart Moscow,8100,2,10,6,4,39,26,13,36
CSKA Moscow,8100,3,11,3,6,29,18,11,36
Krasnodar,8100,4,10,4,6,34,25,9,34
Zenit,8100,5,8,8,4,22,15,7,32
Terek Grozny,8100,6,7,5,8,22,26,-4,26
Din Moscow,8100,7,5,8,7,20,24,-4,23
FK Rubin,8100,8,5,6,9,23,24,-1,21
Amkar,8100,9,5,4,11,11,25,-14,19
Rostov,8100,10,4,6,10,10,20,-10,18
Anzhi,8100,11,3,5,12,16,42,-26,14
Loko Moscow,8101,1,11,7,2,31,13,18,40
CSKA Moscow,8101,2,11,3,6,27,20,7,36
Spart Moscow,8101,3,9,7,4,41,29,12,34
Zenit,8101,4,8,9,3,24,14,10,33
Terek Grozny,8101,5,8,6,6,22,23,-1,30
Krasnodar,8101,6,8,5,7,29,27,2,29
Din Moscow,8101,7,6,7,7,22,23,-1,25
FK Rubin,8101,8,6,5,9,22,20,2,23
Rostov,8101,9,4,7,9,12,19,-7,19
Amkar,8101,10,4,4,12,9,27,-18,16
Anzhi,8101,11,2,6,12,15,39,-24,12
Loko Moscow,8102,1,13,5,2,33,12,21,44
CSKA Moscow,8102,2,10,4,6,25,19,6,34
Spart Moscow,8102,3,9,6,5,38,28,10,33
Zenit,8102,4,8,8,4,23,15,8,32
Krasnodar,8102,5,8,4,8,28,27,1,28
Terek Grozny,8102,6,7,5,8,20,25,-5,26
FK Rubin,8102,7,6,6,8,23,18,5,24
Din Moscow,8102,8,5,8,7,19,23,-4,23
Amkar,8102,9,6,4,10,13,23,-10,22
Rostov,8102,10,4,6,10,10,20,-10,18
Anzhi,8102,11,3,6,11,15,37,-22,15
Loko Moscow,8103,1,11,5,4,29,14,15,38
Spart Moscow,8103,2,10,6,4,40,26,14,36
CSKA Moscow,8103,3,11,3,6,28,21,7,36
Zenit,8103,4,9,8,3,25,13,12,35
Krasnodar,8103,5,10,4,6,30,25,5,34
Terek Grozny,8103,6,7,6,7,20,23,-3,27
Din Moscow,8103,7,5,7,8,18,24,-6,22
FK Rubin,8103,8,5,6,9,23,20,3,21
Rostov,8103,9,4,7,9,11,18,-7,19
Amkar,8103,10,5,4,11,10,26,-16,19
Anzhi,8103,11,2,6,12,16,40,-24,12
Loko Moscow,8104,1,11,6,3,29,16,13,39
CSKA Moscow,8104,2,11,3,6,30,20,10,36
Zenit,8104,3,9,8,3,28,13,15,35
Spart Moscow,8104,4,9,6,5,35,26,9,33
Terek Grozny,8104,5,8,6,6,23,24,-1,30
Krasnodar,8104,6,8,5,7,28,27,1,29
FK Rubin,8104,7,7,5,8,27,18,9,26
Din Moscow,8104,8,5,6,9,17,26,-9,21
Amkar,8104,9,5,5,10,11,23,-12,20
Rostov,8104,10,4,7,9,10,17,-7,19
Anzhi,8104,11,2,5,13,16,44,-28,11
Loko Moscow,8105,1,12,5,3,31,13,18,41
CSKA Moscow,8105,2,11,4,5,29,18,11,37
Krasnodar,8105,3,10,4,6,30,25,5,34
Spart Moscow,8105,4,9,5,6,35,28,7,32
Zenit,8105,5,7,9,4,22,15,7,30
Din Moscow,8105,6,7,6,7,22,21,1,27
Terek Grozny,8105,7,7,5,8,21,26,-5,26
Amkar,8105,8,6,4,10,12,23,-11,22
FK Rubin,8105,9,5,5,10,21,22,-1,20
Rostov,8105,10,4,6,10,10,18,-8,18
Anzhi,8105,11,3,5,12,17,41,-24,14
Loko Moscow,8106,1,11,5,4,30,14,16,38
Zenit,8106,2,9,8,3,25,13,12,35
CSKA Moscow,8106,3,10,4,6,26,21,5,34
Spart Moscow,8106,4,9,6,5,37,28,9,33
Krasnodar,8106,5,9,5,6,32,28,4,32
Terek Grozny,8106,6,8,5,7,23,26,-3,29
FK Rubin,8106,7,6,6,8,26,20,6,24
Din Moscow,8106,8,6,6,8,19,24,-5,24
Rostov,8106,9,4,7,9,11,18,-7,19
Amkar,8106,10,5,4,11,13,25,-12,19
Anzhi,8106,11,2,6,12,15,40,-25,12
Loko Moscow,8107,1,11,6,3,31,14,17,39
Zenit,8107,2,9,8,3,26,13,13,35
Spart Moscow,8107,3,9,7,4,37,27,10,34
CSKA Moscow,8107,4,10,3,7,26,23,3,33
Krasnodar,8107,5,9,5,6,32,28,4,32
Terek Grozny,8107,6,8,6,6,22,23,-1,30
FK Rubin,8107,7,6,5,9,26,21,5,23
Din Moscow,8107,8,5,7,8,19,25,-6,22
Rostov,8107,9,4,7,9,11,18,-7,19
Amkar,8107,10,4,4,12,9,25,-16,16
Anzhi,8107,11,3,6,11,17,39,-22,15
Loko Moscow,8108,1,13,5,2,33,12,21,44
Spart Moscow,8108,2,10,6,4,37,26,11,36
CSKA Moscow,8108,3,11,3,6,26,18,8,36
Zenit,8108,4,8,8,4,23,15,8,32
Krasnodar,8108,5,9,4,7,29,27,2,31
Terek Grozny,8108,6,7,6,7,21,27,-6,27
Din Moscow,8108,7,5,7,8,18,23,-5,22
FK Rubin,8108,8,5,6,9,23,20,3,21
Rostov,8108,9,4,7,9,11,18,-7,19
Amkar,8108,10,4,5,11,10,25,-15,17
Anzhi,8108,11,3,5,12,18,38,-20,14
CSKA Moscow,8109,1,12,3,5,30,18,12,39
Loko Moscow,8109,2,11,5,4,30,15,15,38
Spart Moscow,8109,3,9,6,5,36,30,6,33
Zenit,8109,4,8,8,4,22,14,8,32
Krasnodar,8109,5,9,4,7,30,27,3,31
Terek Grozny,8109,6,8,6,6,22,22,0,30
Din Moscow,8109,7,6,7,7,20,21,-1,25
FK Rubin,8109,8,6,6,8,23,17,6,24
Rostov,8109,9,4,6,10,12,20,-8,18
Amkar,8109,10,4,5,11,9,24,-15,17
Anzhi,8109,11,2,6,12,15,41,-26,12
Loko Moscow,8110,1,11,7,2,32,14,18,40
CSKA Moscow,8110,2,11,4,5,28,19,9,37
Spart Moscow,8110,3,9,6,5,36,28,8,33
Krasnodar,8110,4,9,5,6,32,27,5,32
Zenit,8110,5,7,9,4,22,15,7,30
Terek Grozny,8110,6,7,6,7,21,24,-3,27
Din Moscow,8110,7,6,7,7,19,22,-3,25
Rostov,8110,8,5,6,9,11,17,-6,21
FK Rubin,8110,9,5,5,10,22,21,1,20
Amkar,8110,10,5,4,11,13,26,-13,19
Anzhi,8110,11,2,7,11,15,38,-23,13
Loko Moscow,8111,1,12,5,3,30,15,15,41
Spart Moscow,8111,2,10,5,5,40,27,13,35
CSKA Moscow,8111,3,10,3,7,26,23,3,33
Zenit,8111,4,8,8,4,24,15,9,32
Krasnodar,8111,5,9,5,6,32,25,7,32
Terek Grozny,8111,6,7,6,7,21,26,-5,27
FK Rubin,8111,7,5,7,8,23,19,4,22
Din Moscow,8111,8,5,7,8,18,26,-8,22
Amkar,8111,9,5,5,10,11,22,-11,20
Rostov,8111,10,4,6,10,10,20,-10,18
Anzhi,8111,11,4,5,11,21,38,-17,17
Loko Moscow,8112,1,11,5,4,29,14,15,38
CSKA Moscow,8112,2,11,4,5,29,19,10,37
Spart Moscow,8112,3,9,7,4,38,28,10,34
Krasnodar,8112,4,10,4,6,30,25,5,34
Zenit,8112,5,8,9,3,24,14,10,33
Terek Grozny,8112,6,7,6,7,21,24,-3,27
Din Moscow,8112,7,6,7,7,20,23,-3,25
FK Rubin,8112,8,5,5,10,22,20,2,20
Rostov,8112,9,4,6,10,10,19,-9,18
Amkar,8112,10,4,6,10,11,24,-13,18
Anzhi,8112,11,3,5,12,16,40,-24,14
Loko Moscow,8113,1,12,5,3,32,12,20,41
CSKA Moscow,8113,2,10,5,5,26,18,8,35
Krasnodar,8113,3,10,4,6,29,24,5,34
Spart Moscow,8113,4,9,6,5,37,29,8,33
Zenit,8113,5,7,9,4,22,17,5,30
Terek Grozny,8113,6,8,5,7,23,24,-1,29
Din Moscow,8113,7,6,7,7,20,22,-2,25
Rostov,8113,8,5,6,9,12,18,-6,21
FK Rubin,8113,9,5,5,10,21,20,1,20
Amkar,8113,10,5,4,11,12,25,-13,19
Anzhi,8113,11,2,6,12,14,39,-25,12
Loko Moscow,8114,1,11,6,3,30,13,17,39
CSKA Moscow,8114,2,11,3,6,29,19,10,36
Zenit,8114,3,9,8,3,23,13,10,35
Spart Moscow,8114,4,9,6,5,36,28,8,33
Krasnodar,8114,5,9,5,6,32,26,6,32
Terek Grozny,8114,6,9,5,6,24,22,2,32
FK Rubin,8114,7,6,5,9,23,21,2,23
Din Moscow,8114,8,5,6,9,19,25,-6,21
Rostov,8114,9,5,6,9,11,17,-6,21
Amkar,8114,10,4,5,11,9,24,-15,17
Anzhi,8114,11,2,5,13,15,43,-28,11
Loko Moscow,8115,1,12,5,3,32,12,20,41
CSKA Moscow,8115,2,11,3,6,27,20,7,36
Spart Moscow,8115,3,9,6,5,34,29,5,33
Zenit,8115,4,8,8,4,24,16,8,32
Krasnodar,8115,5,9,5,6,28,24,4,32
Terek Grozny,8115,6,8,5,7,22,24,-2,29
Din Moscow,8115,7,5,8,7,18,22,-4,23
FK Rubin,8115,8,5,7,8,22,18,4,22
Rostov,8115,9,5,6,9,14,17,-3,21
Amkar,8115,10,5,4,11,10,23,-13,19
Anzhi,8115,11,2,5,13,15,41,-26,11
Loko Moscow,8116,1,11,5,4,29,14,15,38
Spart Moscow,8116,2,10,5,5,39,30,9,35
CSKA Moscow,8116,3,10,5,5,29,21,8,35
Zenit,8116,4,8,9,3,24,15,9,33
Krasnodar,8116,5,9,4,7,29,25,4,31
Din Moscow,8116,6,7,6,7,20,22,-2,27
Terek Grozny,8116,7,7,5,8,22,26,-4,26
FK Rubin,8116,8,6,5,9,22,18,4,23
Amkar,8116,9,5,4,11,13,26,-13,19
Rostov,8116,10,4,6,10,12,20,-8,18
Anzhi,8116,11,3,6,11,17,39,-22,15
Loko Moscow,8117,1,11,7,2,31,13,18,40
CSKA Moscow,8117,2,11,4,5,27,18,9,37
Spart Moscow,8117,3,10,5,5,39,28,11,35
Krasnodar,8117,4,9,5,6,34,26,8,32
Zenit,8117,5,7,10,3,21,13,8,31
Terek Grozny,8117,6,7,6,7,22,25,-3,27
Din Moscow,8117,7,6,6,8,19,24,-5,24
FK Rubin,8117,8,5,5,10,21,23,-2,20
Amkar,8117,9,5,5,10,11,23,-12,20
Rostov,8117,10,4,6,10,11,20,-9,18
Anzhi,8117,11,3,5,12,17,40,-23,14
Loko Moscow,8118,1,12,6,2,32,13,19,42
Spart Moscow,8118,2,11,5,4,42,25,17,38
CSKA Moscow,8118,3,11,3,6,27,19,8,36
Zenit,8118,4,7,9,4,22,15,7,30
Krasnodar,8118,5,8,4,8,28,27,1,28
Terek Grozny,8118,6,7,5,8,20,25,-5,26
FK Rubin,8118,7,6,6,8,23,18,5,24
Din Moscow,8118,8,5,7,8,18,24,-6,22
Amkar,8118,9,5,4,11,10,28,-18,19
Rostov,8118,10,4,6,10,10,18,-8,18
Anzhi,8118,11,4,5,11,18,38,-20,17
Loko Moscow,8119,1,13,5,2,36,12,24,44
Spart Moscow,8119,2,9,7,4,39,29,10,34
CSKA Moscow,8119,3,10,4,6,26,19,7,34
Zenit,8119,4,8,8,4,23,18,5,32
Terek Grozny,8119,5,8,6,6,22,23,-1,30
Krasnodar,8119,6,8,4,8,28,28,0,28
FK Rubin,8119,7,7,5,8,24,18,6,26
Din Moscow,8119,8,5,7,8,19,24,-5,22
Rostov,8119,9,4,7,9,11,18,-7,19
Amkar,8119,10,4,5,11,11,26,-15,17
Anzhi,8119,11,2,6,12,15,39,-24,12
Loko Moscow,8120,1,12,5,3,30,13,17,41
Spart Moscow,8120,2,11,5,4,39,26,13,38
CSKA Moscow,8120,3,11,4,5,28,18,10,37
Zenit,8120,4,8,8,4,24,16,8,32
Terek Grozny,8120,5,8,5,7,21,25,-4,29
Krasnodar,8120,6,8,4,8,27,26,1,28
FK Rubin,8120,7,7,5,8,26,17,9,26
Din Moscow,8120,8,5,6,9,17,26,-9,21
Amkar,8120,9,5,4,11,13,24,-11,19
Rostov,8120,10,4,6,10,10,20,-10,18
Anzhi,8120,11,2,6,12,14,38,-24,12
Loko Moscow,8121,1,11,7,2,32,14,18,40
CSKA Moscow,8121,2,11,4,5,28,18,10,37
Zenit,8121,3,7,10,3,25,17,8,31
Spart Moscow,8121,4,8,7,5,36,30,6,31
Krasnodar,8121,5,8,5,7,28,26,2,29
Terek Grozny,8121,6,7,6,7,23,27,-4,27
FK Rubin,8121,7,7,5,8,26,20,6,26
Din Moscow,8121,8,5,7,8,20,25,-5,22
Rostov,8121,9,5,6,9,13,18,-5,21
Amkar,8121,10,4,6,10,12,25,-13,18
Anzhi,8121,11,3,5,12,17,40,-23,14
Loko Moscow,8122,1,12,5,3,32,15,17,41
Spart Moscow,8122,2,10,5,5,38,29,9,35
Krasnodar,8122,3,10,4,6,33,24,9,34
CSKA Moscow,8122,4,10,3,7,26,22,4,33
Zenit,8122,5,8,8,4,25,17,8,32
Terek Grozny,8122,6,7,5,8,21,26,-5,26
Din Moscow,8122,7,6,6,8,19,23,-4,24
Amkar,8122,8,6,4,10,13,23,-10,22
FK Rubin,8122,9,5,5,10,21,20,1,20
Rostov,8122,10,4,6,10,12,20,-8,18
Anzhi,8122,11,4,5,11,16,37,-21,17
Loko Moscow,8123,1,11,5,4,30,16,14,38
Spart Moscow,8123,2,10,6,4,39,28,11,36
CSKA Moscow,8123,3,11,3,6,28,20,8,36
Zenit,8123,4,9,8,3,24,13,11,35
Krasnodar,8123,5,10,4,6,32,26,6,34
Terek Grozny,8123,6,8,6,6,24,23,1,30
FK Rubin,8123,7,6,5,9,24,19,5,23
Din Moscow,8123,8,5,6,9,18,26,-8,21
Rostov,8123,9,4,7,9,11,18,-7,19
Amkar,8123,10,4,4,12,10,27,-17,16
Anzhi,8123,11,2,6,12,17,41,-24,12
Loko Moscow,8124,1,12,6,2,37,13,24,42
CSKA Moscow,8124,2,11,3,6,28,19,9,36
Spart Moscow,8124,3,9,6,5,37,28,9,33
Zenit,8124,4,8,9,3,25,16,9,33
Krasnodar,8124,5,8,5,7,28,31,-3,29
Terek Grozny,8124,6,7,6,7,23,26,-3,27
FK Rubin,8124,7,6,6,8,24,19,5,24
Din Moscow,8124,8,5,7,8,19,24,-5,22
Amkar,8124,9,6,4,10,13,24,-11,22
Rostov,8124,10,4,6,10,11,20,-9,18
Anzhi,8124,11,2,6,12,15,40,-25,12
Loko Moscow,8125,1,12,5,3,34,14,20,41
CSKA Moscow,8125,2,11,3,6,30,19,11,36
Spart Moscow,8125,3,10,5,5,39,29,10,35
Zenit,8125,4,9,8,3,25,15,10,35
Terek Grozny,8125,5,8,5,7,23,24,-1,29
Krasnodar,8125,6,8,4,8,30,31,-1,28
FK Rubin,8125,7,6,6,8,24,19,5,24
Din Moscow,8125,8,5,7,8,17,22,-5,22
Amkar,8125,9,6,4,10,13,23,-10,22
Rostov,8125,10,4,6,10,11,21,-10,18
Anzhi,8125,11,2,5,13,15,44,-29,11
Loko Moscow,8126,1,11,6,3,29,14,15,39
CSKA Moscow,8126,2,11,3,6,27,18,9,36
Spart Moscow,8126,3,9,7,4,38,29,9,34
Zenit,8126,4,8,9,3,22,13,9,33
Krasnodar,8126,5,9,4,7,31,26,5,31
Terek Grozny,8126,6,7,6,7,22,26,-4,27
Din Moscow,8126,7,6,6,8,19,23,-4,24
FK Rubin,8126,8,6,5,9,24,20,4,23
Rostov,8126,9,4,7,9,12,19,-7,19
Amkar,8126,10,4,6,10,13,26,-13,18
Anzhi,8126,11,3,5,12,16,39,-23,14
Loko Moscow,8127,1,13,5,2,35,12,23,44
Spart Moscow,8127,2,11,5,4,38,25,13,38
CSKA Moscow,8127,3,11,4,5,29,18,11,37
Terek Grozny,8127,4,9,5,6,26,25,1,32
Zenit,8127,5,7,9,4,21,15,6,30
Krasnodar,8127,6,8,5,7,29,29,0,29
Din Moscow,8127,7,6,6,8,18,22,-4,24
FK Rubin,8127,8,5,6,9,22,19,3,21
Rostov,8127,9,4,6,10,10,19,-9,18
Amkar,8127,10,4,4,12,11,27,-16,16
Anzhi,8127,11,2,5,13,16,44,-28,11
Loko Moscow,8128,1,11,6,3,30,13,17,39
CSKA Moscow,8128,2,12,3,5,30,18,12,39
Spart Moscow,8128,3,9,5,6,38,30,8,32
Krasnodar,8128,4,9,5,6,30,26,4,32
Zenit,8128,5,7,9,4,21,15,6,30
Terek Grozny,8128,6,7,6,7,20,23,-3,27
FK Rubin,8128,7,6,6,8,23,18,5,24
Din Moscow,8128,8,6,6,8,20,23,-3,24
Amkar,8128,9,5,5,10,11,23,-12,20
Rostov,8128,10,4,6,10,10,20,-10,18
Anzhi,8128,11,3,5,12,16,40,-24,14
Loko Moscow,8129,1,11,5,4,30,17,13,38
CSKA Moscow,8129,2,11,4,5,32,19,13,37
Spart Moscow,8129,3,10,6,4,38,26,12,36
Krasnodar,8129,4,10,4,6,31,25,6,34
Zenit,8129,5,8,9,3,27,15,12,33
Terek Grozny,8129,6,8,6,6,21,22,-1,30
Din Moscow,8129,7,5,8,7,19,23,-4,23
FK Rubin,8129,8,5,6,9,23,21,2,21
Rostov,8129,9,4,6,10,10,20,-10,18
Amkar,8129,10,4,5,11,9,23,-14,17
Anzhi,8129,11,2,5,13,15,44,-29,11
Loko Moscow,8130,1,12,6,2,33,12,21,42
Spart Moscow,8130,2,10,5,5,38,29,9,35
CSKA Moscow,8130,3,10,4,6,26,20,6,34
Zenit,8130,4,8,8,4,23,16,7,32
Krasnodar,8130,5,9,5,6,29,25,4,32
Terek Grozny,8130,6,8,6,6,30,25,5,30
Din Moscow,8130,7,5,7,8,19,24,-5,22
FK Rubin,8130,8,5,6,9,22,19,3,21
Amkar,8130,9,5,5,10,14,26,-12,20
Rostov,8130,10,4,6,10,10,18,-8,18
Anzhi,8130,11,2,6,12,16,46,-30,12
Loko Moscow,8131,1,11,6,3,29,12,17,39
CSKA Moscow,8131,2,11,4,5,26,17,9,37
Spart Moscow,8131,3,9,7,4,37,27,10,34
Krasnodar,8131,4,10,4,6,30,24,6,34
Zenit,8131,5,7,9,4,21,14,7,30
Terek Grozny,8131,6,8,6,6,22,23,-1,30
Din Moscow,8131,7,6,7,7,21,21,0,25
FK Rubin,8131,8,5,5,10,21,23,-2,20
Rostov,8131,9,4,6,10,11,20,-9,18
Amkar,8131,10,4,5,11,10,24,-14,17
Anzhi,8131,11,2,7,11,15,38,-23,13
Loko Moscow,8132,1,13,5,2,31,11,20,44
CSKA Moscow,8132,2,11,4,5,28,19,9,37
Spart Moscow,8132,3,9,7,4,39,30,9,34
Krasnodar,8132,4,9,4,7,30,25,5,31
Zenit,8132,5,7,9,4,22,15,7,30
Terek Grozny,8132,6,7,6,7,22,25,-3,27
Din Moscow,8132,7,5,7,8,19,24,-5,22
FK Rubin,8132,8,5,6,9,22,21,1,21
Amkar,8132,9,5,5,10,12,24,-12,20
Rostov,8132,10,4,7,9,13,20,-7,19
Anzhi,8132,11,2,6,12,16,40,-24,12
Loko Moscow,8133,1,12,5,3,33,16,17,41
Spart Moscow,8133,2,10,5,5,42,31,11,35
CSKA Moscow,8133,3,10,4,6,25,20,5,34
Zenit,8133,4,8,8,4,24,16,8,32
Krasnodar,8133,5,9,4,7,34,29,5,31
Terek Grozny,8133,6,7,5,8,20,25,-5,26
Din Moscow,8133,7,6,7,7,22,24,-2,25
FK Rubin,8133,8,6,6,8,26,20,6,24
Amkar,8133,9,5,4,11,13,26,-13,19
Rostov,8133,10,4,6,10,10,20,-10,18
Anzhi,8133,11,3,6,11,15,37,-22,15
Loko Moscow,8134,1,13,5,2,33,12,21,44
CSKA Moscow,8134,2,12,3,5,32,18,14,39
Spart Moscow,8134,3,9,6,5,36,27,9,33
Terek Grozny,8134,4,9,5,6,25,24,1,32
Zenit,8134,5,7,8,5,23,20,3,29
Krasnodar,8134,6,8,4,8,28,27,1,28
Din Moscow,8134,7,7,6,7,23,22,1,27
FK Rubin,8134,8,6,5,9,24,22,2,23
Rostov,8134,9,4,6,10,10,20,-10,18
Amkar,8134,10,4,5,11,9,24,-15,17
Anzhi,8134,11,2,5,13,16,43,-27,11
Loko Moscow,8135,1,13,5,2,33,11,22,44
CSKA Moscow,8135,2,12,3,5,28,17,11,39
Spart Moscow,8135,3,9,5,6,37,31,6,32
Zenit,8135,4,7,8,5,21,17,4,29
Krasnodar,8135,5,8,5,7,28,27,1,29
Terek Grozny,8135,6,8,5,7,21,26,-5,29
Din Moscow,8135,7,6,7,7,21,23,-2,25
FK Rubin,8135,8,5,7,8,23,19,4,22
Amkar,8135,9,5,4,11,11,24,-13,19
Rostov,8135,10,4,6,10,11,19,-8,18
Anzhi,8135,11,3,5,12,18,38,-20,14
Loko Moscow,8136,1,11,6,3,30,15,15,39
CSKA Moscow,8136,2,11,3,6,27,19,8,36
Spart Moscow,8136,3,10,5,5,38,30,8,35
Zenit,8136,4,8,9,3,24,15,9,33
Krasnodar,8136,5,9,5,6,31,25,6,32
Terek Grozny,8136,6,8,6,6,22,23,-1,30
FK Rubin,8136,7,6,6,8,24,19,5,24
Din Moscow,8136,8,6,6,8,21,24,-3,24
Rostov,8136,9,4,6,10,11,19,-8,18
Amkar,8136,10,4,5,11,11,25,-14,17
Anzhi,8136,11,2,5,13,14,39,-25,11
Loko Moscow,8137,1,12,6,2,31,12,19,42
CSKA Moscow,8137,2,11,4,5,30,20,10,37
Spart Moscow,8137,3,8,8,4,35,27,8,32
Terek Grozny,8137,4,9,5,6,26,23,3,32
Zenit,8137,5,7,10,3,23,15,8,31
Krasnodar,8137,6,8,5,7,28,26,2,29
Din Moscow,8137,7,5,8,7,17,21,-4,23
FK Rubin,8137,8,5,7,8,21,17,4,22
Rostov,8137,9,4,7,9,10,17,-7,19
Amkar,8137,10,4,5,11,11,26,-15,17
Anzhi,8137,11,2,5,13,16,44,-28,11
Loko Moscow,8138,1,12,6,2,33,13,20,42
CSKA Moscow,8138,2,11,4,5,29,20,9,37
Spart Moscow,8138,3,9,7,4,37,28,9,34
Krasnodar,8138,4,9,5,6,32,26,6,32
Zenit,8138,5,7,9,4,24,18,6,30
Terek Grozny,8138,6,8,5,7,23,25,-2,29
Din Moscow,8138,7,5,7,8,17,22,-5,22
FK Rubin,8138,8,5,6,9,22,21,1,21
Amkar,8138,9,5,5,10,12,24,-12,20
Rostov,8138,10,4,7,9,12,19,-7,19
Anzhi,8138,11,2,5,13,16,41,-25,11
Loko Moscow,8139,1,11,6,3,32,17,15,39
Spart Moscow,8139,2,11,5,4,40,27,13,38
CSKA Moscow,8139,3,10,5,5,28,20,8,35
Krasnodar,8139,4,10,4,6,32,25,7,34
Zenit,8139,5,7,10,3,23,15,8,31
Terek Grozny,8139,6,8,5,7,22,24,-2,29
Din Moscow,8139,7,6,6,8,18,23,-5,24
FK Rubin,8139,8,5,5,10,21,19,2,20
Amkar,8139,9,5,4,11,11,24,-13,19
Rostov,8139,10,4,6,10,11,20,-9,18
Anzhi,8139,11,2,6,12,18,42,-24,12
Loko Moscow,8140,1,13,5,2,37,13,24,44
CSKA Moscow,8140,2,12,3,5,31,18,13,39
Spart Moscow,8140,3,9,6,5,37,31,6,33
Krasnodar,8140,4,9,4,7,31,28,3,31
Terek Grozny,8140,5,8,6,6,22,23,-1,30
Zenit,8140,6,7,8,5,23,21,2,29
Din Moscow,8140,7,5,7,8,20,25,-5,22
FK Rubin,8140,8,5,6,9,24,22,2,21
Rostov,8140,9,5,6,9,14,18,-4,21
Amkar,8140,10,4,6,10,11,24,-13,18
Anzhi,8140,11,2,5,13,14,41,-27,11
Loko Moscow,8141,1,11,6,3,31,14,17,39
CSKA Moscow,8141,2,10,4,6,27,20,7,34
Zenit,8141,3,8,9,3,24,15,9,33
Spart Moscow,8141,4,9,5,6,36,28,8,32
Krasnodar,8141,5,9,4,7,31,28,3,31
Terek Grozny,8141,6,8,6,6,22,22,0,30
FK Rubin,8141,7,7,5,8,26,20,6,26
Din Moscow,8141,8,6,6,8,19,23,-4,24
Rostov,8141,9,5,6,9,12,17,-5,21
Amkar,8141,10,4,5,11,9,25,-16,17
Anzhi,8141,11,2,6,12,15,40,-25,12
Loko Moscow,8142,1,12,6,2,30,11,19,42
Spart Moscow,8142,2,11,5,4,40,26,14,38
CSKA Moscow,8142,3,10,3,7,27,21,6,33
Zenit,8142,4,8,8,4,23,15,8,32
Krasnodar,8142,5,9,5,6,31,25,6,32
Terek Grozny,8142,6,8,6,6,22,23,-1,30
FK Rubin,8142,7,6,5,9,25,23,2,23
Din Moscow,8142,8,5,6,9,19,27,-8,21
Rostov,8142,9,4,6,10,10,19,-9,18
Amkar,8142,10,4,5,11,11,25,-14,17
Anzhi,8142,11,3,5,12,16,39,-23,14
Loko Moscow,8143,1,12,5,3,30,12,18,41
CSKA Moscow,8143,2,11,4,5,30,19,11,37
Spart Moscow,8143,3,10,6,4,38,25,13,36
Zenit,8143,4,8,9,3,24,15,9,33
Krasnodar,8143,5,9,4,7,28,25,3,31
Terek Grozny,8143,6,7,5,8,22,26,-4,26
FK Rubin,8143,7,6,5,9,22,18,4,23
Din Moscow,8143,8,5,7,8,17,22,-5,22
Amkar,8143,9,5,4,11,10,25,-15,19
Rostov,8143,10,4,6,10,10,19,-9,18
Anzhi,8143,11,3,5,12,17,42,-25,14
Loko Moscow,8144,1,13,5,2,34,13,21,44
CSKA Moscow,8144,2,11,4,5,27,17,10,37
Spart Moscow,8144,3,10,5,5,41,32,9,35
Krasnodar,8144,4,9,4,7,30,28,2,31
Zenit,8144,5,7,9,4,21,14,7,30
Terek Grozny,8144,6,7,6,7,21,24,-3,27
Din Moscow,8144,7,5,7,8,17,23,-6,22
FK Rubin,8144,8,5,6,9,21,18,3,21
Rostov,8144,9,5,6,9,16,21,-5,21
Amkar,8144,10,4,5,11,11,25,-14,17
Anzhi,8144,11,3,5,12,15,39,-24,14
Loko Moscow,8145,1,11,5,4,29,15,14,38
Zenit,8145,2,9,8,3,25,14,11,35
CSKA Moscow,8145,3,10,4,6,27,20,7,34
Spart Moscow,8145,4,9,6,5,35,27,8,33
Krasnodar,8145,5,9,4,7,30,27,3,31
Terek Grozny,8145,6,7,6,7,20,23,-3,27
FK Rubin,8145,7,6,6,8,25,19,6,24
Din Moscow,8145,8,5,7,8,18,24,-6,22
Amkar,8145,9,5,5,10,11,22,-11,20
Rostov,8145,10,4,7,9,10,17,-7,19
Anzhi,8145,11,3,6,11,16,38,-22,15
CSKA Moscow,8146,1,12,3,5,27,17,10,39
Loko Moscow,8146,2,11,5,4,29,15,14,38
Spart Moscow,8146,3,9,6,5,37,27,10,33
Zenit,8146,4,8,8,4,23,14,9,32
Krasnodar,8146,5,9,4,7,29,25,4,31
Terek Grozny,8146,6,7,7,6,23,25,-2,28
FK Rubin,8146,7,6,6,8,22,17,5,24
Din Moscow,8146,8,5,7,8,18,25,-7,22
Amkar,8146,9,5,5,10,11,23,-12,20
Rostov,8146,10,4,7,9,10,17,-7,19
Anzhi,8146,11,2,6,12,16,40,-24,12
Loko Moscow,8147,1,13,5,2,32,11,21,44
CSKA Moscow,8147,2,11,3,6,28,19,9,36
Spart Moscow,8147,3,10,5,5,38,27,11,35
Zenit,8147,4,8,8,4,22,14,8,32
Krasnodar,8147,5,9,4,7,28,26,2,31
Terek Grozny,8147,6,8,5,7,22,23,-1,29
Din Moscow,8147,7,6,6,8,20,25,-5,24
FK Rubin,8147,8,5,5,10,21,20,1,20
Amkar,8147,9,5,4,11,10,24,-14,19
Rostov,8147,10,4,6,10,10,18,-8,18
Anzhi,8147,11,3,5,12,16,40,-24,14
Loko Moscow,8148,1,12,5,3,33,15,18,41
Spart Moscow,8148,2,10,6,4,40,28,12,36
CSKA Moscow,8148,3,11,3,6,28,19,9,36
Zenit,8148,4,8,8,4,23,17,6,32
Krasnodar,8148,5,9,4,7,31,27,4,31
Terek Grozny,8148,6,7,6,7,22,27,-5,27
Din Moscow,8148,7,6,6,8,21,25,-4,24
FK Rubin,8148,8,6,5,9,24,21,3,23
Rostov,8148,9,4,7,9,12,19,-7,19
Amkar,8148,10,5,4,11,14,25,-11,19
Anzhi,8148,11,2,6,12,15,40,-25,12
Loko Moscow,8149,1,13,5,2,32,11,21,44
Spart Moscow,8149,2,11,5,4,40,26,14,38
CSKA Moscow,8149,3,11,3,6,27,19,8,36
Zenit,8149,4,8,8,4,22,15,7,32
Krasnodar,8149,5,8,5,7,30,28,2,29
Terek Grozny,8149,6,8,5,7,22,23,-1,29
FK Rubin,8149,7,6,6,8,26,21,5,24
Din Moscow,8149,8,5,6,9,18,26,-8,21
Amkar,8149,9,5,4,11,10,24,-14,19
Rostov,8149,10,4,6,10,11,19,-8,18
Anzhi,8149,11,2,5,13,15,41,-26,11
Loko Moscow,8150,1,12,6,2,31,11,20,42
CSKA Moscow,8150,2,11,4,5,29,18,11,37
Spart Moscow,8150,3,10,6,4,38,27,11,36
Zenit,8150,4,7,8,5,21,18,3,29
Krasnodar,8150,5,8,5,7,28,26,2,29
Terek Grozny,8150,6,7,6,7,21,24,-3,27
Din Moscow,8150,7,6,6,8,21,25,-4,24
FK Rubin,8150,8,6,5,9,25,21,4,23
Amkar,8150,9,5,5,10,11,23,-12,20
Rostov,8150,10,4,6,10,10,19,-9,18
Anzhi,8150,11,2,7,11,16,39,-23,13
Loko Moscow,8151,1,12,5,3,32,16,16,41
CSKA Moscow,8151,2,11,3,6,29,20,9,36
Spart Moscow,8151,3,10,5,5,37,29,8,35
Krasnodar,8151,4,10,4,6,35,25,10,34
Zenit,8151,5,8,8,4,22,15,7,32
Terek Grozny,8151,6,8,6,6,23,22,1,30
Din Moscow,8151,7,6,6,8,20,24,-4,24
FK Rubin,8151,8,5,5,10,22,23,-1,20
Amkar,8151,9,5,5,10,13,23,-10,20
Rostov,8151,10,4,6,10,10,18,-8,18
Anzhi,8151,11,2,5,13,16,44,-28,11
Loko Moscow,8152,1,12,5,3,32,13,19,41
Spart Moscow,8152,2,11,5,4,41,25,16,38
CSKA Moscow,8152,3,11,3,6,27,22,5,36
Zenit,8152,4,9,8,3,27,14,13,35
Krasnodar,8152,5,9,4,7,30,28,2,31
Terek Grozny,8152,6,8,5,7,24,24,0,29
Din Moscow,8152,7,6,6,8,18,24,-6,24
FK Rubin,8152,8,5,5,10,23,21,2,20
Amkar,8152,9,5,4,11,10,24,-14,19
Rostov,8152,10,4,6,10,10,20,-10,18
Anzhi,8152,11,2,5,13,16,43,-27,11
Loko Moscow,8153,1,11,6,3,30,14,16,39
Spart Moscow,8153,2,10,6,4,37,25,12,36
Zenit,8153,3,8,9,3,26,14,12,33
CSKA Moscow,8153,4,10,3,7,25,22,3,33
Krasnodar,8153,5,9,4,7,29,25,4,31
Terek Grozny,8153,6,8,6,6,21,22,-1,30
FK Rubin,8153,7,7,5,8,23,17,6,26
Din Moscow,8153,8,5,6,9,17,25,-8,21
Rostov,8153,9,4,6,10,10,18,-8,18
Amkar,8153,10,4,6,10,9,22,-13,18
Anzhi,8153,11,3,5,12,15,38,-23,14
Loko Moscow,8154,1,11,5,4,30,14,16,38
CSKA Moscow,8154,2,11,4,5,29,18,11,37
Spart Moscow,8154,3,10,6,4,37,26,11,36
Krasnodar,8154,4,10,4,6,30,25,5,34
Zenit,8154,5,8,9,3,22,13,9,33
Terek Grozny,8154,6,8,6,6,24,25,-1,30
Din Moscow,8154,7,6,6,8,20,23,-3,24
FK Rubin,8154,8,5,5,10,21,20,1,20
Rostov,8154,9,4,7,9,10,17,-7,19
Amkar,8154,10,4,4,12,10,26,-16,16
Anzhi,8154,11,2,6,12,17,43,-26,12
Loko Moscow,8155,1,12,5,3,32,13,19,41
CSKA Moscow,8155,2,12,3,5,30,18,12,39
Spart Moscow,8155,3,10,6,4,39,27,12,36
Zenit,8155,4,8,8,4,23,16,7,32
Krasnodar,8155,5,8,5,7,27,27,0,29
Terek Grozny,8155,6,8,5,7,22,25,-3,29
Din Moscow,8155,7,5,8,7,18,22,-4,23
FK Rubin,8155,8,5,7,8,21,17,4,22
Rostov,8155,9,4,6,10,11,21,-10,18
Amkar,8155,10,4,4,12,9,24,-15,16
Anzhi,8155,11,3,5,12,18,40,-22,14
Loko Moscow,8156,1,12,5,3,31,14,17,41
CSKA Moscow,8156,2,12,3,5,30,20,10,39
Spart Moscow,8156,3,9,7,4,37,27,10,34
Krasnodar,8156,4,9,4,7,32,30,2,31
Zenit,8156,5,7,8,5,22,16,6,29
Terek Grozny,8156,6,7,7,6,23,25,-2,28
FK Rubin,8156,7,6,6,8,26,19,7,24
Din Moscow,8156,8,5,8,7,17,21,-4,23
Rostov,8156,9,4,6,10,10,19,-9,18
Amkar,8156,10,4,6,10,12,25,-13,18
Anzhi,8156,11,2,6,12,18,42,-24,12
Loko Moscow,8157,1,11,7,2,31,13,18,40
Spart Moscow,8157,2,11,5,4,40,26,14,38
CSKA Moscow,8157,3,10,4,6,27,21,6,34
Krasnodar,8157,4,9,5,6,29,25,4,32
Zenit,8157,5,7,10,3,23,15,8,31
Terek Grozny,8157,6,7,7,6,20,22,-2,28
Din Moscow,8157,7,5,7,8,17,23,-6,22
FK Rubin,8157,8,5,6,9,21,18,3,21
Rostov,8157,9,4,6,10,11,20,-9,18
Amkar,8157,10,4,5,11,9,24,-15,17
Anzhi,8157,11,3,6,11,17,38,-21,15
Loko Moscow,8158,1,12,5,3,33,14,19,41
CSKA Moscow,8158,2,12,3,5,31,18,13,39
Spart Moscow,8158,3,9,6,5,39,29,10,33
Zenit,8158,4,8,8,4,23,15,8,32
Terek Grozny,8158,5,8,5,7,23,24,-1,29
Krasnodar,8158,6,8,4,8,29,30,-1,28
Din Moscow,8158,7,6,7,7,22,24,-2,25
FK Rubin,8158,8,6,5,9,25,21,4,23
Rostov,8158,9,5,6,9,12,18,-6,21
Amkar,8158,10,5,4,11,11,26,-15,19
Anzhi,8158,11,2,5,13,15,44,-29,11
Loko Moscow,8159,1,12,6,2,34,14,20,42
CSKA Moscow,8159,2,11,3,6,27,18,9,36
Spart Moscow,8159,3,9,5,6,37,29,8,32
Zenit,8159,4,8,8,4,23,16,7,32
Krasnodar,8159,5,8,6,6,29,26,3,30
Terek Grozny,8159,6,7,6,7,21,24,-3,27
FK Rubin,8159,7,6,6,8,24,18,6,24
Rostov,8159,8,5,6,9,13,19,-6,21
Din Moscow,8159,9,5,6,9,18,26,-8,21
Amkar,8159,10,5,5,10,10,22,-12,20
Anzhi,8159,11,3,5,12,16,40,-24,14
Loko Moscow,8160,1,11,6,3,30,13,17,39
CSKA Moscow,8160,2,11,4,5,27,17,10,37
Spart Moscow,8160,3,10,5,5,36,28,8,35
Krasnodar,8160,4,9,5,6,28,24,4,32
Zenit,8160,5,7,10,3,22,14,8,31
Terek Grozny,8160,6,7,6,7,22,25,-3,27
Din Moscow,8160,7,6,6,8,19,22,-3,24
FK Rubin,8160,8,5,6,9,21,19,2,21
Amkar,8160,9,5,5,10,11,22,-11,20
Rostov,8160,10,4,6,10,11,19,-8,18
Anzhi,8160,11,3,5,12,17,41,-24,14
Loko Moscow,8161,1,13,5,2,33,12,21,44
CSKA Moscow,8161,2,10,4,6,27,20,7,34
Spart Moscow,8161,3,8,7,5,36,30,6,31
Zenit,8161,4,7,9,4,22,16,6,30
Terek Grozny,8161,5,8,6,6,22,23,-1,30
Krasnodar,8161,6,8,5,7,29,27,2,29
Din Moscow,8161,7,7,6,7,23,24,-1,27
FK Rubin,8161,8,5,6,9,24,21,3,21
Rostov,8161,9,4,7,9,10,17,-7,19
Amkar,8161,10,4,6,10,12,25,-13,18
Anzhi,8161,11,3,5,12,16,39,-23,14
Loko Moscow,8162,1,13,5,2,33,11,22,44
CSKA Moscow,8162,2,11,4,5,28,19,9,37
Spart Moscow,8162,3,9,6,5,34,27,7,33
Zenit,8162,4,7,8,5,21,17,4,29
Krasnodar,8162,5,8,4,8,27,26,1,28
Terek Grozny,8162,6,7,6,7,20,25,-5,27
FK Rubin,8162,7,7,5,8,23,17,6,26
Din Moscow,8162,8,5,6,9,17,23,-6,21
Amkar,8162,9,5,5,10,11,22,-11,20
Rostov,8162,10,4,7,9,10,17,-7,19
Anzhi,8162,11,3,6,11,19,39,-20,15
Loko Moscow,8163,1,12,5,3,31,13,18,41
CSKA Moscow,8163,2,12,3,5,30,18,12,39
Krasnodar,8163,3,10,4,6,30,25,5,34
Spart Moscow,8163,4,8,6,6,38,33,5,30
Zenit,8163,5,7,8,5,21,15,6,29
Terek Grozny,8163,6,7,6,7,21,24,-3,27
Din Moscow,8163,7,5,8,7,20,24,-4,23
Amkar,8163,8,6,4,10,14,25,-11,22
FK Rubin,8163,9,5,6,9,21,18,3,21
Rostov,8163,10,5,6,9,12,17,-5,21
Anzhi,8163,11,2,6,12,15,41,-26,12
Loko Moscow,8164,1,12,5,3,31,14,17,41
Spart Moscow,8164,2,10,6,4,40,29,11,36
CSKA Moscow,8164,3,10,5,5,27,19,8,35
Krasnodar,8164,4,9,5,6,32,27,5,32
Zenit,8164,5,7,9,4,23,16,7,30
Terek Grozny,8164,6,7,5,8,20,28,-8,26
FK Rubin,8164,7,6,6,8,26,20,6,24
Din Moscow,8164,8,5,7,8,18,24,-6,22
Amkar,8164,9,5,4,11,14,26,-12,19
Rostov,8164,10,4,6,10,12,20,-8,18
Anzhi,8164,11,3,6,11,17,37,-20,15
Loko Moscow,8165,1,12,5,3,32,14,18,41
CSKA Moscow,8165,2,10,5,5,27,19,8,35
Spart Moscow,8165,3,9,7,4,38,29,9,34
Krasnodar,8165,4,10,4,6,31,24,7,34
Zenit,8165,5,7,9,4,22,16,6,30
Terek Grozny,8165,6,7,6,7,22,25,-3,27
Din Moscow,8165,7,5,8,7,18,22,-4,23
FK Rubin,8165,8,5,6,9,21,19,2,21
Amkar,8165,9,5,5,10,11,23,-12,20
Rostov,8165,10,4,6,10,12,20,-8,18
Anzhi,8165,11,2,7,11,18,41,-23,13
Loko Moscow,8166,1,11,6,3,31,14,17,39
CSKA Moscow,8166,2,12,3,5,30,19,11,39
Spart Moscow,8166,3,9,7,4,37,27,10,34
Zenit,8166,4,8,8,4,24,17,7,32
Krasnodar,8166,5,9,5,6,30,26,4,32
Terek Grozny,8166,6,7,5,8,22,28,-6,26
FK Rubin,8166,7,6,5,9,23,19,4,23
Din Moscow,8166,8,5,7,8,17,22,-5,22
Amkar,8166,9,5,5,10,13,25,-12,20
Rostov,8166,10,4,6,10,10,19,-9,18
Anzhi,8166,11,3,5,12,19,40,-21,14
Loko Moscow,8167,1,11,5,4,29,13,16,38
CSKA Moscow,8167,2,11,4,5,27,17,10,37
Spart Moscow,8167,3,10,6,4,39,27,12,36
Zenit,8167,4,8,9,3,22,13,9,33
Krasnodar,8167,5,9,4,7,29,26,3,31
Terek Grozny,8167,6,8,5,7,26,24,2,29
FK Rubin,8167,7,7,5,8,25,18,7,26
Din Moscow,8167,8,5,7,8,19,25,-6,22
Amkar,8167,9,5,4,11,10,25,-15,19
Rostov,8167,10,4,6,10,10,18,-8,18
Anzhi,8167,11,2,5,13,15,45,-30,11
Loko Moscow,8168,1,13,5,2,34,12,22,44
CSKA Moscow,8168,2,11,3,6,29,18,11,36
Spart Moscow,8168,3,10,6,4,39,29,10,36
Zenit,8168,4,8,8,4,23,16,7,32
Terek Grozny,8168,5,8,6,6,23,24,-1,30
Krasnodar,8168,6,8,4,8,27,27,0,28
Din Moscow,8168,7,6,7,7,21,23,-2,25
FK Rubin,8168,8,6,5,9,22,19,3,23
Rostov,8168,9,4,6,10,11,19,-8,18
Amkar,8168,10,4,5,11,11,25,-14,17
Anzhi,8168,11,2,5,13,15,43,-28,11
Loko Moscow,8169,1,12,5,3,32,14,18,41
CSKA Moscow,8169,2,12,3,5,29,18,11,39
Spart Moscow,8169,3,10,5,5,39,26,13,35
Krasnodar,8169,4,10,4,6,31,26,5,34
Terek Grozny,8169,5,9,5,6,25,23,2,32
Zenit,8169,6,7,8,5,23,17,6,29
FK Rubin,8169,7,6,5,9,23,19,4,23
Din Moscow,8169,8,5,6,9,17,24,-7,21
Amkar,8169,9,5,4,11,10,24,-14,19
Rostov,8169,10,4,6,10,10,21,-11,18
Anzhi,8169,11,2,5,13,15,42,-27,11
Loko Moscow,8170,1,12,6,2,35,13,22,42
CSKA Moscow,8170,2,11,4,5,27,18,9,37
Spart Moscow,8170,3,9,7,4,36,27,9,34
Zenit,8170,4,7,10,3,23,15,8,31
Krasnodar,8170,5,8,5,7,29,30,-1,29
Terek Grozny,8170,6,7,6,7,21,24,-3,27
Din Moscow,8170,7,6,7,7,20,23,-3,25
FK Rubin,8170,8,5,6,9,23,20,3,21
Rostov,8170,9,4,7,9,11,18,-7,19
Amkar,8170,10,4,5,11,10,24,-14,17
Anzhi,8170,11,3,5,12,15,38,-23,14
Loko Moscow,8171,1,12,5,3,32,14,18,41
CSKA Moscow,8171,2,12,3,5,29,18,11,39
Spart Moscow,8171,3,11,5,4,41,27,14,38
Krasnodar,8171,4,10,4,6,32,26,6,34
Zenit,8171,5,7,8,5,22,17,5,29
Terek Grozny,8171,6,8,5,7,21,24,-3,29
Din Moscow,8171,7,5,7,8,19,24,-5,22
FK Rubin,8171,8,5,6,9,23,21,2,21
Rostov,8171,9,4,6,10,10,19,-9,18
Amkar,8171,10,4,4,12,10,27,-17,16
Anzhi,8171,11,3,5,12,17,39,-22,14
Loko Moscow,8172,1,12,5,3,31,12,19,41
CSKA Moscow,8172,2,11,4,5,27,18,9,37
Spart Moscow,8172,3,10,5,5,36,26,10,35
Zenit,8172,4,8,9,3,23,14,9,33
Terek Grozny,8172,5,9,5,6,23,23,0,32
Krasnodar,8172,6,8,5,7,28,27,1,29
Din Moscow,8172,7,6,6,8,19,23,-4,24
FK Rubin,8172,8,5,6,9,23,20,3,21
Amkar,8172,9,5,4,11,10,23,-13,19
Rostov,8172,10,4,6,10,10,19,-9,18
Anzhi,8172,11,2,5,13,15,40,-25,11
Loko Moscow,8173,1,12,5,3,33,13,20,41
CSKA Moscow,8173,2,12,3,5,28,17,11,39
Spart Moscow,8173,3,11,5,4,39,26,13,38
Krasnodar,8173,4,9,4,7,30,27,3,31
Terek Grozny,8173,5,8,6,6,21,22,-1,30
Zenit,8173,6,7,8,5,22,19,3,29
Din Moscow,8173,7,6,6,8,18,24,-6,24
FK Rubin,8173,8,6,5,9,24,20,4,23
Rostov,8173,9,4,6,10,10,18,-8,18
Amkar,8173,10,4,4,12,10,25,-15,16
Anzhi,8173,11,2,6,12,14,38,-24,12
Loko Moscow,8174,1,11,5,4,30,15,15,38
Spart Moscow,8174,2,10,6,4,38,28,10,36
CSKA Moscow,8174,3,11,3,6,27,19,8,36
Zenit,8174,4,9,8,3,25,14,11,35
Krasnodar,8174,5,10,4,6,32,26,6,34
Terek Grozny,8174,6,8,6,6,21,22,-1,30
Din Moscow,8174,7,6,6,8,20,24,-4,24
FK Rubin,8174,8,5,5,10,23,22,1,20
Rostov,8174,9,4,6,10,11,19,-8,18
Amkar,8174,10,4,6,10,10,23,-13,18
Anzhi,8174,11,2,5,13,14,39,-25,11
Loko Moscow,8175,1,12,5,3,32,12,20,41
Spart Moscow,8175,2,11,5,4,38,26,12,38
CSKA Moscow,8175,3,10,3,7,25,21,4,33
Zenit,8175,4,8,8,4,22,16,6,32
Krasnodar,8175,5,9,5,6,28,24,4,32
Terek Grozny,8175,6,8,6,6,23,24,-1,30
FK Rubin,8175,7,6,6,8,23,17,6,24
Din Moscow,8175,8,5,6,9,18,25,-7,21
Rostov,8175,9,4,6,10,10,19,-9,18
Amkar,8175,10,4,5,11,9,23,-14,17
Anzhi,8175,11,3,5,12,19,40,-21,14
Loko Moscow,8176,1,11,6,3,32,15,17,39
CSKA Moscow,8176,2,11,4,5,28,19,9,37
Krasnodar,8176,3,9,5,6,33,29,4,32
Zenit,8176,4,7,10,3,22,14,8,31
Spart Moscow,8176,5,8,6,6,35,31,4,30
Din Moscow,8176,6,7,6,7,19,21,-2,27
Terek Grozny,8176,7,7,5,8,21,27,-6,26
Amkar,8176,8,6,4,10,15,23,-8,22
FK Rubin,8176,9,5,6,9,24,21,3,21
Rostov,8176,10,4,7,9,11,18,-7,19
Anzhi,8176,11,3,5,12,19,41,-22,14
Loko Moscow,8177,1,11,7,2,32,14,18,40
CSKA Moscow,8177,2,12,3,5,29,18,11,39
Spart Moscow,8177,3,9,6,5,35,26,9,33
Zenit,8177,4,7,9,4,22,15,7,30
Krasnodar,8177,5,8,6,6,31,28,3,30
Terek Grozny,8177,6,8,6,6,21,22,-1,30
Din Moscow,8177,7,6,7,7,18,21,-3,25
FK Rubin,8177,8,5,6,9,23,20,3,21
Rostov,8177,9,5,6,9,11,17,-6,21
Amkar,8177,10,4,4,12,9,25,-16,16
Anzhi,8177,11,2,6,12,15,40,-25,12
Loko Moscow,8178,1,13,5,2,32,11,21,44
CSKA Moscow,8178,2,11,4,5,28,18,10,37
Spart Moscow,8178,3,10,5,5,42,32,10,35
Zenit,8178,4,7,9,4,22,15,7,30
Terek Grozny,8178,5,8,6,6,22,23,-1,30
Krasnodar,8178,6,8,4,8,28,28,0,28
Din Moscow,8178,7,7,6,7,22,24,-2,27
FK Rubin,8178,8,6,5,9,24,20,4,23
Rostov,8178,9,4,6,10,11,19,-8,18
Amkar,8178,10,4,4,12,12,28,-16,16
Anzhi,8178,11,2,6,12,15,40,-25,12
Loko Moscow,8179,1,12,5,3,31,13,18,41
CSKA Moscow,8179,2,11,3,6,28,19,9,36
Zenit,8179,3,9,8,3,25,15,10,35
Spart Moscow,8179,4,9,5,6,37,31,6,32
Terek Grozny,8179,5,8,5,7,23,26,-3,29
Krasnodar,8179,6,8,4,8,27,26,1,28
Din Moscow,8179,7,6,6,8,19,23,-4,24
FK Rubin,8179,8,6,5,9,22,19,3,23
Amkar,8179,9,6,4,10,14,23,-9,22
Rostov,8179,10,5,6,9,13,18,-5,21
Anzhi,8179,11,2,5,13,16,42,-26,11
Loko Moscow,8180,1,13,5,2,34,12,22,44
CSKA Moscow,8180,2,12,3,5,28,17,11,39
Spart Moscow,8180,3,10,6,4,40,26,14,36
Zenit,8180,4,7,8,5,22,17,5,29
Terek Grozny,8180,5,8,5,7,23,25,-2,29
Krasnodar,8180,6,8,4,8,27,27,0,28
FK Rubin,8180,7,6,6,8,22,17,5,24
Din Moscow,8180,8,5,7,8,17,26,-9,22
Rostov,8180,9,4,7,9,10,17,-7,19
Amkar,8180,10,4,4,12,10,26,-16,16
Anzhi,8180,11,3,5,12,17,40,-23,14
Loko Moscow,8181,1,13,5,2,35,12,23,44
CSKA Moscow,8181,2,11,4,5,30,18,12,37
Spart Moscow,8181,3,10,5,5,39,27,12,35
Krasnodar,8181,4,9,4,7,28,26,2,31
Zenit,8181,5,7,9,4,22,17,5,30
Terek Grozny,8181,6,8,6,6,21,22,-1,30
Din Moscow,8181,7,6,6,8,21,25,-4,24
FK Rubin,8181,8,5,5,10,21,21,0,20
Amkar,8181,9,5,5,10,10,22,-12,20
Rostov,8181,10,4,6,10,10,19,-9,18
Anzhi,8181,11,2,5,13,15,43,-28,11
Loko Moscow,8182,1,13,5,2,33,13,20,44
Spart Moscow,8182,2,11,5,4,44,28,16,38
CSKA Moscow,8182,3,11,4,5,31,20,11,37
Zenit,8182,4,7,9,4,23,16,7,30
Terek Grozny,8182,5,8,6,6,23,24,-1,30
Krasnodar,8182,6,8,5,7,29,27,2,29
FK Rubin,8182,7,5,7,8,23,19,4,22
Din Moscow,8182,8,5,7,8,20,27,-7,22
Rostov,8182,9,4,6,10,10,19,-9,18
Amkar,8182,10,4,4,12,10,27,-17,16
Anzhi,8182,11,2,6,12,18,44,-26,12
Loko Moscow,8183,1,11,6,3,31,15,16,39
CSKA Moscow,8183,2,11,3,6,29,22,7,36
Zenit,8183,3,9,8,3,26,14,12,35
Spart Moscow,8183,4,9,6,5,37,28,9,33
Krasnodar,8183,5,9,5,6,33,27,6,32
Terek Grozny,8183,6,8,6,6,23,23,0,30
Din Moscow,8183,7,7,6,7,21,22,-1,27
FK Rubin,8183,8,5,5,10,22,23,-1,20
Rostov,8183,9,4,7,9,10,17,-7,19
Amkar,8183,10,4,4,12,10,27,-17,16
Anzhi,8183,11,2,6,12,17,41,-24,12
Loko Moscow,8184,1,11,7,2,31,13,18,40
CSKA Moscow,8184,2,12,3,5,30,19,11,39
Spart Moscow,8184,3,9,6,5,35,27,8,33
Krasnodar,8184,4,9,5,6,31,26,5,32
Zenit,8184,5,7,9,4,22,15,7,30
Terek Grozny,8184,6,8,6,6,22,23,-1,30
Din Moscow,8184,7,6,6,8,19,24,-5,24
FK Rubin,8184,8,6,5,9,24,20,4,23
Rostov,8184,9,4,6,10,10,18,-8,18
Amkar,8184,10,4,6,10,10,23,-13,18
Anzhi,8184,11,2,5,13,16,42,-26,11
Loko Moscow,8185,1,12,5,3,31,13,18,41
CSKA Moscow,8185,2,11,3,6,27,21,6,36
Spart Moscow,8185,3,9,7,4,34,25,9,34
Krasnodar,8185,4,10,4,6,31,26,5,34
Zenit,8185,5,8,8,4,25,15,10,32
Terek Grozny,8185,6,7,5,8,24,28,-4,26
FK Rubin,8185,7,6,5,9,26,19,7,23
Din Moscow,8185,8,5,7,8,17,25,-8,22
Amkar,8185,9,5,5,10,11,23,-12,20
Rostov,8185,10,4,6,10,10,18,-8,18
Anzhi,8185,11,3,5,12,18,41,-23,14
Loko Moscow,8186,1,11,6,3,29,12,17,39
Zenit,8186,2,9,8,3,24,13,11,35
Spart Moscow,8186,3,9,6,5,36,28,8,33
CSKA Moscow,8186,4,10,3,7,26,21,5,33
Krasnodar,8186,5,9,5,6,28,24,4,32
Terek Grozny,8186,6,7,6,7,21,24,-3,27
Din Moscow,8186,7,6,7,7,19,22,-3,25
FK Rubin,8186,8,5,6,9,22,19,3,21
Rostov,8186,9,4,7,9,11,18,-7,19
Amkar,8186,10,5,4,11,11,24,-13,19
Anzhi,8186,11,3,6,11,17,39,-22,15
Loko Moscow,8187,1,12,5,3,32,15,17,41
CSKA Moscow,8187,2,11,4,5,28,19,9,37
Krasnodar,8187,3,10,4,6,33,27,6,34
Spart Moscow,8187,4,9,6,5,36,31,5,33
Zenit,8187,5,7,9,4,23,16,7,30
Terek Grozny,8187,6,7,6,7,24,27,-3,27
FK Rubin,8187,7,6,5,9,25,21,4,23
Amkar,8187,8,6,4,10,16,24,-8,22
Din Moscow,8187,9,5,6,9,19,25,-6,21
Rostov,8187,10,4,7,9,11,18,-7,19
Anzhi,8187,11,2,6,12,17,41,-24,12
Loko Moscow,8188,1,11,6,3,30,14,16,39
Spart Moscow,8188,2,10,5,5,38,28,10,35
CSKA Moscow,8188,3,10,5,5,27,19,8,35
Zenit,8188,4,7,10,3,24,16,8,31
Krasnodar,8188,5,9,4,7,29,25,4,31
Terek Grozny,8188,6,8,5,7,22,23,-1,29
FK Rubin,8188,7,7,5,8,25,17,8,26
Din Moscow,8188,8,6,6,8,18,24,-6,24
Amkar,8188,9,5,4,11,11,25,-14,19
Rostov,8188,10,4,6,10,11,19,-8,18
Anzhi,8188,11,2,6,12,14,39,-25,12
Loko Moscow,8189,1,12,5,3,33,15,18,41
CSKA Moscow,8189,2,12,3,5,30,18,12,39
Spart Moscow,8189,3,9,7,4,39,29,10,34
Krasnodar,8189,4,9,5,6,31,26,5,32
Terek Grozny,8189,5,9,5,6,25,22,3,32
Zenit,8189,6,7,8,5,22,18,4,29
Din Moscow,8189,7,6,6,8,21,25,-4,24
FK Rubin,8189,8,5,6,9,23,21,2,21
Rostov,8189,9,4,7,9,13,20,-7,19
Amkar,8189,10,4,5,11,9,24,-15,17
Anzhi,8189,11,2,5,13,15,43,-28,11
Loko Moscow,8190,1,11,6,3,31,14,17,39
Spart Moscow,8190,2,9,7,4,38,29,9,34
CSKA Moscow,8190,3,10,4,6,27,21,6,34
Zenit,8190,4,8,9,3,24,14,10,33
Krasnodar,8190,5,9,5,6,30,26,4,32
Terek Grozny,8190,6,7,6,7,21,27,-6,27
Din Moscow,8190,7,6,7,7,19,22,-3,25
FK Rubin,8190,8,5,6,9,22,19,3,21
Rostov,8190,9,4,7,9,11,18,-7,19
Amkar,8190,10,5,4,11,15,25,-10,19
Anzhi,8190,11,2,7,11,17,40,-23,13
Loko Moscow,8191,1,11,6,3,30,14,16,39
CSKA Moscow,8191,2,12,3,5,30,19,11,39
Spart Moscow,8191,3,10,6,4,39,28,11,36
Zenit,8191,4,8,8,4,25,16,9,32
Krasnodar,8191,5,8,5,7,28,26,2,29
Terek Grozny,8191,6,7,6,7,20,23,-3,27
Din Moscow,8191,7,6,6,8,22,25,-3,24
FK Rubin,8191,8,6,5,9,24,21,3,23
Amkar,8191,9,5,5,10,10,22,-12,20
Rostov,8191,10,4,6,10,11,20,-9,18
Anzhi,8191,11,2,6,12,15,40,-25,12
Loko Moscow,8192,1,13,5,2,31,11,20,44
CSKA Moscow,8192,2,11,3,6,29,20,9,36
Spart Moscow,8192,3,9,6,5,35,27,8,33
Zenit,8192,4,8,8,4,24,14,10,32
Terek Grozny,8192,5,8,5,7,22,23,-1,29
Krasnodar,8192,6,8,4,8,28,27,1,28
Din Moscow,8192,7,6,7,7,19,22,-3,25
FK Rubin,8192,8,6,5,9,24,20,4,23
Amkar,8192,9,6,4,10,12,23,-11,22
Rostov,8192,10,4,6,10,10,18,-8,18
Anzhi,8192,11,2,5,13,14,43,-29,11
Loko Moscow,8193,1,12,5,3,35,17,18,41
CSKA Moscow,8193,2,10,4,6,26,19,7,34
Zenit,8193,3,8,8,4,23,16,7,32
Krasnodar,8193,4,9,5,6,34,29,5,32
Spart Moscow,8193,5,8,7,5,36,29,7,31
Terek Grozny,8193,6,8,6,6,24,23,1,30
Din Moscow,8193,7,6,7,7,19,22,-3,25
FK Rubin,8193,8,5,6,9,23,20,3,21
Amkar,8193,9,5,5,10,12,24,-12,20
Rostov,8193,10,4,7,9,11,18,-7,19
Anzhi,8193,11,2,6,12,15,41,-26,12
Loko Moscow,8194,1,13,5,2,34,12,22,44
CSKA Moscow,8194,2,12,3,5,32,19,13,39
Spart Moscow,8194,3,9,6,5,37,29,8,33
Krasnodar,8194,4,9,4,7,32,27,5,31
Zenit,8194,5,7,8,5,21,17,4,29
Terek Grozny,8194,6,7,5,8,22,27,-5,26
Din Moscow,8194,7,5,7,8,20,25,-5,22
Amkar,8194,8,6,4,10,13,24,-11,22
FK Rubin,8194,9,5,6,9,23,23,0,21
Rostov,8194,10,4,7,9,11,18,-7,19
Anzhi,8194,11,3,5,12,19,43,-24,14
Loko Moscow,8195,1,11,6,3,31,14,17,39
Zenit,8195,2,9,8,3,25,15,10,35
Spart Moscow,8195,3,9,6,5,40,29,11,33
CSKA Moscow,8195,4,10,3,7,26,21,5,33
Krasnodar,8195,5,8,5,7,29,27,2,29
Terek Grozny,8195,6,8,5,7,21,23,-2,29
FK Rubin,8195,7,7,5,8,24,18,6,26
Din Moscow,8195,8,6,6,8,19,23,-4,24
Amkar,8195,9,5,5,10,11,23,-12,20
Rostov,8195,10,4,6,10,11,22,-11,18
Anzhi,8195,11,3,5,12,16,38,-22,14
Loko Moscow,8196,1,13,5,2,35,11,24,44
CSKA Moscow,8196,2,11,3,6,26,20,6,36
Spart Moscow,8196,3,9,6,5,38,29,9,33
Zenit,8196,4,8,8,4,24,17,7,32
Terek Grozny,8196,5,9,5,6,24,23,1,32
Krasnodar,8196,6,8,4,8,28,29,-1,28
FK Rubin,8196,7,7,5,8,26,19,7,26
Rostov,8196,8,5,6,9,12,18,-6,21
Din Moscow,8196,9,5,6,9,20,27,-7,21
Amkar,8196,10,4,5,11,9,24,-15,17
Anzhi,8196,11,2,5,13,15,40,-25,11
Loko Moscow,8197,1,11,7,2,30,12,18,40
CSKA Moscow,8197,2,12,3,5,28,17,11,39
Spart Moscow,8197,3,9,5,6,38,28,10,32
Krasnodar,8197,4,9,5,6,31,25,6,32
Zenit,8197,5,7,9,4,21,15,6,30
Terek Grozny,8197,6,7,7,6,22,24,-2,28
Din Moscow,8197,7,5,7,8,17,25,-8,22
FK Rubin,8197,8,5,6,9,21,20,1,21
Rostov,8197,9,5,6,9,12,18,-6,21
Amkar,8197,10,5,5,10,11,23,-12,20
Anzhi,8197,11,2,6,12,15,39,-24,12
Loko Moscow,8198,1,11,6,3,30,13,17,39
CSKA Moscow,8198,2,11,3,6,28,20,8,36
Zenit,8198,3,9,8,3,24,13,11,35
Spart Moscow,8198,4,9,7,4,40,27,13,34
Krasnodar,8198,5,8,6,6,28,25,3,30
Terek Grozny,8198,6,7,6,7,21,24,-3,27
FK Rubin,8198,7,5,7,8,21,17,4,22
Din Moscow,8198,8,5,7,8,18,27,-9,22
Amkar,8198,9,5,5,10,10,22,-12,20
Rostov,8198,10,4,7,9,11,18,-7,19
Anzhi,8198,11,2,6,12,16,41,-25,12
Loko Moscow,8199,1,13,5,2,32,11,21,44
Spart Moscow,8199,2,10,5,5,37,27,10,35
CSKA Moscow,8199,3,10,5,5,26,18,8,35
Krasnodar,8199,4,9,4,7,29,25,4,31
Zenit,8199,5,7,9,4,21,15,6,30
Terek Grozny,8199,6,8,6,6,22,23,-1,30
FK Rubin,8199,7,6,5,9,23,20,3,23
Din Moscow,8199,8,5,6,9,18,25,-7,21
Amkar,8199,9,5,4,11,12,24,-12,19
Rostov,8199,10,4,6,10,10,19,-9,18
Anzhi,8199,11,2,7,11,15,38,-23,13
Loko Moscow,8200,1,12,5,3,33,13,20,41
CSKA Moscow,8200,2,11,3,6,27,19,8,36
Krasnodar,8200,3,10,4,6,30,25,5,34
Zenit,8200,4,8,8,4,23,16,7,32
Terek Grozny,8200,5,9,5,6,23,23,0,32
Spart Moscow,8200,6,8,6,6,33,28,5,30
Din Moscow,8200,7,6,7,7,20,22,-2,25
FK Rubin,8200,8,5,6,9,22,19,3,21
Rostov,8200,9,5,6,9,11,17,-6,21
Amkar,8200,10,4,5,11,10,24,-14,17
Anzhi,8200,11,2,5,13,14,40,-26,11
Loko Moscow,8201,1,12,5,3,31,16,15,41
Spart Moscow,8201,2,10,6,4,39,27,12,36
CSKA Moscow,8201,3,10,5,5,27,19,8,35
Krasnodar,8201,4,9,4,7,34,28,6,31
Zenit,8201,5,7,9,4,22,15,7,30
Terek Grozny,8201,6,8,5,7,21,23,-2,29
FK Rubin,8201,7,6,6,8,25,20,5,24
Din Moscow,8201,8,5,8,7,19,23,-4,23
Rostov,8201,9,4,6,10,11,20,-9,18
Amkar,8201,10,4,4,12,9,25,-16,16
Anzhi,8201,11,3,6,11,16,38,-22,15
Loko Moscow,8202,1,11,5,4,29,14,15,38
Zenit,8202,2,9,8,3,24,14,10,35
Krasnodar,8202,3,10,4,6,30,24,6,34
CSKA Moscow,8202,4,10,3,7,27,22,5,33
Spart Moscow,8202,5,8,6,6,34,29,5,30
Terek Grozny,8202,6,7,6,7,21,25,-4,27
Din Moscow,8202,7,6,6,8,19,23,-4,24
FK Rubin,8202,8,6,5,9,22,18,4,23
Amkar,8202,9,5,5,10,12,23,-11,20
Rostov,8202,10,4,7,9,10,17,-7,19
Anzhi,8202,11,4,5,11,19,38,-19,17
Loko Moscow,8203,1,11,5,4,30,15,15,38
Spart Moscow,8203,2,11,5,4,38,26,12,38
Zenit,8203,3,9,8,3,25,14,11,35
CSKA Moscow,8203,4,10,4,6,26,19,7,34
Krasnodar,8203,5,10,4,6,32,27,5,34
Terek Grozny,8203,6,8,5,7,22,25,-3,29
FK Rubin,8203,7,6,5,9,26,21,5,23
Din Moscow,8203,8,5,6,9,17,25,-8,21
Amkar,8203,9,5,4,11,13,25,-12,19
Rostov,8203,10,4,6,10,10,18,-8,18
Anzhi,8203,11,2,6,12,15,39,-24,12
Loko Moscow,8204,1,12,5,3,32,16,16,41
CSKA Moscow,8204,2,11,4,5,31,18,13,37
Zenit,8204,3,8,9,3,27,15,12,33
Spart Moscow,8204,4,8,7,5,34,27,7,31
Krasnodar,8204,5,9,4,7,31,26,5,31
Terek Grozny,8204,6,7,6,7,21,25,-4,27
Din Moscow,8204,7,6,7,7,20,23,-3,25
FK Rubin,8204,8,5,5,10,22,23,-1,20
Amkar,8204,9,5,5,10,11,23,-12,20
Rostov,8204,10,4,7,9,10,17,-7,19
Anzhi,8204,11,3,5,12,16,42,-26,14
Loko Moscow,8205,1,11,5,4,31,15,16,38
CSKA Moscow,8205,2,11,3,6,28,21,7,36
Zenit,8205,3,8,8,4,23,15,8,32
Spart Moscow,8205,4,8,7,5,36,30,6,31
Krasnodar,8205,5,9,4,7,30,28,2,31
Terek Grozny,8205,6,7,6,7,22,28,-6,27
FK Rubin,8205,7,7,5,8,25,17,8,26
Din Moscow,8205,8,5,7,8,18,24,-6,22
Amkar,8205,9,6,4,10,16,23,-7,22
Rostov,8205,10,4,7,9,11,18,-7,19
Anzhi,8205,11,3,6,11,19,40,-21,15
Loko Moscow,8206,1,13,5,2,32,11,21,44
CSKA Moscow,8206,2,11,3,6,32,20,12,36
Spart Moscow,8206,3,10,6,4,39,28,11,36
Zenit,8206,4,8,8,4,24,16,8,32
Terek Grozny,8206,5,9,5,6,25,22,3,32
Krasnodar,8206,6,9,4,7,29,27,2,31
Din Moscow,8206,7,5,7,8,18,24,-6,22
FK Rubin,8206,8,5,6,9,22,19,3,21
Rostov,8206,9,4,7,9,11,18,-7,19
Amkar,8206,10,4,4,12,10,28,-18,16
Anzhi,8206,11,2,5,13,14,43,-29,11
Loko Moscow,8207,1,12,6,2,31,11,20,42
CSKA Moscow,8207,2,11,3,6,27,19,8,36
Spart Moscow,8207,3,9,6,5,36,29,7,33
Zenit,8207,4,8,8,4,23,16,7,32
Krasnodar,8207,5,9,5,6,28,24,4,32
Terek Grozny,8207,6,8,6,6,24,24,0,30
FK Rubin,8207,7,6,5,9,24,19,5,23
Din Moscow,8207,8,5,6,9,19,27,-8,21
Rostov,8207,9,4,7,9,10,17,-7,19
Amkar,8207,10,5,4,11,12,24,-12,19
Anzhi,8207,11,2,6,12,16,40,-24,12
Loko Moscow,8208,1,13,5,2,34,13,21,44
CSKA Moscow,8208,2,12,3,5,31,17,14,39
Spart Moscow,8208,3,11,5,4,39,26,13,38
Zenit,8208,4,7,8,5,21,16,5,29
Terek Grozny,8208,5,8,5,7,24,26,-2,29
Krasnodar,8208,6,8,4,8,29,28,1,28
Din Moscow,8208,7,6,6,8,20,24,-4,24
FK Rubin,8208,8,6,5,9,23,20,3,23
Rostov,8208,9,4,6,10,10,18,-8,18
Amkar,8208,10,4,4,12,11,27,-16,16
Anzhi,8208,11,3,5,12,17,44,-27,14
Loko Moscow,8209,1,11,6,3,31,15,16,39
CSKA Moscow,8209,2,12,3,5,29,18,11,39
Spart Moscow,8209,3,9,6,5,35,27,8,33
Krasnodar,8209,4,9,5,6,31,26,5,32
Zenit,8209,5,7,9,4,23,16,7,30
Terek Grozny,8209,6,7,7,6,23,25,-2,28
Din Moscow,8209,7,6,7,7,21,22,-1,25
FK Rubin,8209,8,5,6,9,23,22,1,21
Rostov,8209,9,5,6,9,11,17,-6,21
Amkar,8209,10,4,5,11,11,25,-14,17
Anzhi,8209,11,2,6,12,16,41,-25,12
Loko Moscow,8210,1,12,5,3,31,13,18,41
CSKA Moscow,8210,2,12,3,5,28,17,11,39
Spart Moscow,8210,3,11,5,4,39,26,13,38
Zenit,8210,4,8,8,4,22,15,7,32
Krasnodar,8210,5,9,4,7,30,26,4,31
Terek Grozny,8210,6,8,6,6,24,23,1,30
Din Moscow,8210,7,6,6,8,20,23,-3,24
FK Rubin,8210,8,5,5,10,21,22,-1,20
Rostov,8210,9,4,6,10,10,19,-9,18
Amkar,8210,10,4,5,11,11,25,-14,17
Anzhi,8210,11,2,5,13,14,41,-27,11
Loko Moscow,8211,1,11,5,4,29,13,16,38
CSKA Moscow,8211,2,11,4,5,27,18,9,37
Spart Moscow,8211,3,9,6,5,37,28,9,33
Zenit,8211,4,8,8,4,22,14,8,32
Krasnodar,8211,5,9,5,6,28,24,4,32
Terek Grozny,8211,6,8,6,6,24,22,2,30
FK Rubin,8211,7,6,6,8,24,19,5,24
Din Moscow,8211,8,6,6,8,20,24,-4,24
Rostov,8211,9,4,6,10,11,20,-9,18
Amkar,8211,10,4,5,11,10,27,-17,17
Anzhi,8211,11,2,7,11,15,38,-23,13
Loko Moscow,8212,1,12,5,3,32,13,19,41
Zenit,8212,2,9,8,3,24,13,11,35
Spart Moscow,8212,3,10,5,5,39,30,9,35
CSKA Moscow,8212,4,10,4,6,27,20,7,34
Krasnodar,8212,5,8,5,7,27,27,0,29
Terek Grozny,8212,6,7,6,7,20,23,-3,27
FK Rubin,8212,7,6,6,8,24,18,6,24
Din Moscow,8212,8,6,6,8,21,25,-4,24
Rostov,8212,9,4,6,10,10,19,-9,18
Amkar,8212,10,4,5,11,11,25,-14,17
Anzhi,8212,11,3,6,11,17,39,-22,15
Loko Moscow,8213,1,13,5,2,31,11,20,44
CSKA Moscow,8213,2,11,3,6,28,19,9,36
Spart Moscow,8213,3,9,7,4,39,29,10,34
Zenit,8213,4,8,8,4,23,14,9,32
Krasnodar,8213,5,9,4,7,29,25,4,31
Terek Grozny,8213,6,8,6,6,22,22,0,30
FK Rubin,8213,7,6,5,9,25,20,5,23
Din Moscow,8213,8,5,7,8,20,27,-7,22
Rostov,8213,9,4,6,10,11,20,-9,18
Amkar,8213,10,4,5,11,10,25,-15,17
Anzhi,8213,11,2,6,12,14,40,-26,12
Loko Moscow,8214,1,12,6,2,33,14,19,42
CSKA Moscow,8214,2,11,4,5,29,19,10,37
Spart Moscow,8214,3,9,6,5,36,29,7,33
Terek Grozny,8214,4,8,6,6,22,23,-1,30
Zenit,8214,5,7,8,5,22,17,5,29
Krasnodar,8214,6,8,5,7,30,28,2,29
Din Moscow,8214,7,6,7,7,22,23,-1,25
FK Rubin,8214,8,6,5,9,22,20,2,23
Amkar,8214,9,5,5,10,11,22,-11,20
Rostov,8214,10,4,6,10,10,18,-8,18
Anzhi,8214,11,2,6,12,16,40,-24,12
Loko Moscow,8215,1,12,5,3,32,13,19,41
CSKA Moscow,8215,2,11,4,5,26,17,9,37
Spart Moscow,8215,3,10,5,5,38,29,9,35
Krasnodar,8215,4,10,4,6,33,26,7,34
Zenit,8215,5,7,9,4,21,15,6,30
Terek Grozny,8215,6,8,5,7,22,24,-2,29
Din Moscow,8215,7,5,7,8,20,26,-6,22
FK Rubin,8215,8,5,6,9,25,24,1,21
Rostov,8215,9,5,6,9,13,18,-5,21
Amkar,8215,10,5,4,11,11,24,-13,19
Anzhi,8215,11,2,5,13,15,40,-25,11
Loko Moscow,8216,1,11,6,3,30,14,16,39
CSKA Moscow,8216,2,11,3,6,27,22,5,36
Zenit,8216,3,9,8,3,27,13,14,35
Spart Moscow,8216,4,10,5,5,35,28,7,35
Krasnodar,8216,5,9,5,6,31,25,6,32
Terek Grozny,8216,6,7,7,6,21,23,-2,28
Din Moscow,8216,7,5,7,8,18,23,-5,22
FK Rubin,8216,8,5,6,9,22,21,1,21
Amkar,8216,9,5,5,10,12,22,-10,20
Rostov,8216,10,4,6,10,10,18,-8,18
Anzhi,8216,11,2,6,12,16,40,-24,12
Loko Moscow,8217,1,11,7,2,32,14,18,40
CSKA Moscow,8217,2,12,3,5,31,19,12,39
Spart Moscow,8217,3,10,5,5,37,27,10,35
Zenit,8217,4,7,9,4,24,17,7,30
Krasnodar,8217,5,8,5,7,28,27,1,29
Terek Grozny,8217,6,7,7,6,23,25,-2,28
Din Moscow,8217,7,6,6,8,19,25,-6,24
FK Rubin,8217,8,6,5,9,24,19,5,23
Amkar,8217,9,5,5,10,12,23,-11,20
Rostov,8217,10,4,6,10,10,18,-8,18
Anzhi,8217,11,2,6,12,17,43,-26,12
Loko Moscow,8218,1,11,7,2,29,11,18,40
CSKA Moscow,8218,2,11,4,5,29,20,9,37
Spart Moscow,8218,3,8,8,4,37,29,8,32
Zenit,8218,4,7,9,4,22,15,7,30
Krasnodar,8218,5,8,5,7,27,25,2,29
FK Rubin,8218,6,7,5,8,23,17,6,26
Terek Grozny,8218,7,7,5,8,21,25,-4,26
Din Moscow,8218,8,5,7,8,19,24,-5,22
Amkar,8218,9,5,5,10,13,25,-12,20
Rostov,8218,10,4,7,9,10,17,-7,19
Anzhi,8218,11,3,6,11,17,39,-22,15
Loko Moscow,8219,1,11,6,3,33,16,17,39
CSKA Moscow,8219,2,11,3,6,27,19,8,36
Zenit,8219,3,9,8,3,26,16,10,35
Spart Moscow,8219,4,9,5,6,38,31,7,32
Krasnodar,8219,5,8,5,7,29,28,1,29
Terek Grozny,8219,6,8,5,7,22,24,-2,29
FK Rubin,8219,7,7,5,8,24,17,7,26
Din Moscow,8219,8,6,6,8,22,25,-3,24
Rostov,8219,9,5,6,9,11,17,-6,21
Amkar,8219,10,4,4,12,10,26,-16,16
Anzhi,8219,11,3,5,12,15,38,-23,14
Loko Moscow,8220,1,12,5,3,32,17,15,41
CSKA Moscow,8220,2,11,3,6,30,19,11,36
Zenit,8220,3,9,8,3,28,15,13,35
Spart Moscow,8220,4,8,7,5,39,33,6,31
Krasnodar,8220,5,9,4,7,32,26,6,31
Terek Grozny,8220,6,8,5,7,22,24,-2,29
Din Moscow,8220,7,6,7,7,23,25,-2,25
FK Rubin,8220,8,5,6,9,21,21,0,21
Rostov,8220,9,4,7,9,11,18,-7,19
Amkar,8220,10,4,5,11,10,25,-15,17
Anzhi,8220,11,3,5,12,16,41,-25,14
Loko Moscow,8221,1,11,6,3,32,17,15,39
CSKA Moscow,8221,2,11,3,6,27,18,9,36
Spart Moscow,8221,3,9,6,5,38,28,10,33
Zenit,8221,4,8,9,3,24,15,9,33
Krasnodar,8221,5,9,4,7,32,28,4,31
Terek Grozny,8221,6,8,5,7,21,23,-2,29
Din Moscow,8221,7,7,6,7,19,21,-2,27
FK Rubin,8221,8,6,5,9,24,19,5,23
Rostov,8221,9,4,6,10,10,20,-10,18
Amkar,8221,10,4,5,11,11,25,-14,17
Anzhi,8221,11,3,5,12,15,39,-24,14
Loko Moscow,8222,1,12,5,3,31,13,18,41
Spart Moscow,8222,2,11,5,4,39,27,12,38
CSKA Moscow,8222,3,11,3,6,27,20,7,36
Zenit,8222,4,8,8,4,25,15,10,32
Krasnodar,8222,5,9,5,6,29,25,4,32
Terek Grozny,8222,6,8,6,6,23,23,0,30
Din Moscow,8222,7,6,6,8,20,24,-4,24
FK Rubin,8222,8,5,6,9,23,20,3,21
Rostov,8222,9,4,6,10,11,20,-9,18
Amkar,8222,10,4,4,12,9,25,-16,16
Anzhi,8222,11,2,6,12,15,40,-25,12
Loko Moscow,8223,1,13,5,2,35,11,24,44
CSKA Moscow,8223,2,10,4,6,25,18,7,34
Spart Moscow,8223,3,8,7,5,34,27,7,31
Zenit,8223,4,7,9,4,21,16,5,30
Krasnodar,8223,5,8,5,7,28,28,0,29
Terek Grozny,8223,6,8,5,7,22,25,-3,29
FK Rubin,8223,7,6,6,8,23,18,5,24
Din Moscow,8223,8,5,7,8,18,23,-5,22
Rostov,8223,9,5,6,9,11,17,-6,21
Amkar,8223,10,4,5,11,9,24,-15,17
Anzhi,8223,11,4,5,11,18,37,-19,17
Loko Moscow,8224,1,12,5,3,33,14,19,41
CSKA Moscow,8224,2,11,4,5,29,19,10,37
Spart Moscow,8224,3,9,5,6,37,31,6,32
Krasnodar,8224,4,9,4,7,30,26,4,31
Zenit,8224,5,7,9,4,23,18,5,30
Terek Grozny,8224,6,8,6,6,24,25,-1,30
Din Moscow,8224,7,6,7,7,19,22,-3,25
FK Rubin,8224,8,6,6,8,24,19,5,24
Amkar,8224,9,5,4,11,16,27,-11,19
Rostov,8224,10,4,6,10,10,19,-9,18
Anzhi,8224,11,2,6,12,16,41,-25,12
Loko Moscow,8225,1,13,5,2,36,13,23,44
CSKA Moscow,8225,2,11,4,5,26,17,9,37
Spart Moscow,8225,3,10,6,4,38,27,11,36
Krasnodar,8225,4,9,4,7,30,27,3,31
Zenit,8225,5,7,8,5,23,19,4,29
Terek Grozny,8225,6,7,5,8,20,26,-6,26
Din Moscow,8225,7,6,6,8,20,25,-5,24
FK Rubin,8225,8,5,5,10,23,22,1,20
Amkar,8225,9,5,5,10,13,23,-10,20
Rostov,8225,10,4,6,10,10,18,-8,18
Anzhi,8225,11,3,6,11,15,37,-22,15
Loko Moscow,8226,1,12,6,2,31,12,19,42
Spart Moscow,8226,2,10,6,4,40,30,10,36
Zenit,8226,3,8,9,3,23,13,10,33
CSKA Moscow,8226,4,10,3,7,27,23,4,33
Terek Grozny,8226,5,8,5,7,23,23,0,29
Krasnodar,8226,6,8,4,8,29,28,1,28
Din Moscow,8226,7,6,6,8,22,26,-4,24
FK Rubin,8226,8,6,5,9,24,20,4,23
Rostov,8226,9,4,6,10,11,19,-8,18
Amkar,8226,10,4,5,11,10,26,-16,17
Anzhi,8226,11,4,5,11,19,39,-20,17
Loko Moscow,8227,1,11,6,3,30,13,17,39
Spart Moscow,8227,2,11,5,4,43,26,17,38
CSKA Moscow,8227,3,11,3,6,28,20,8,36
Zenit,8227,4,9,8,3,25,13,12,35
Krasnodar,8227,5,8,6,6,29,26,3,30
Terek Grozny,8227,6,8,5,7,23,24,-1,29
FK Rubin,8227,7,6,6,8,24,19,5,24
Din Moscow,8227,8,5,6,9,19,25,-6,21
Rostov,8227,9,4,6,10,10,21,-11,18
Amkar,8227,10,4,4,12,9,28,-19,16
Anzhi,8227,11,3,5,12,16,41,-25,14
Loko Moscow,8228,1,12,5,3,31,14,17,41
Spart Moscow,8228,2,10,5,5,38,27,11,35
CSKA Moscow,8228,3,10,5,5,28,20,8,35
Krasnodar,8228,4,9,5,6,30,25,5,32
Zenit,8228,5,7,9,4,21,14,7,30
Terek Grozny,8228,6,8,6,6,23,24,-1,30
Din Moscow,8228,7,7,6,7,20,22,-2,27
FK Rubin,8228,8,5,6,9,21,18,3,21
Rostov,8228,9,4,6,10,10,20,-10,18
Amkar,8228,10,4,4,12,10,25,-15,16
Anzhi,8228,11,2,7,11,18,41,-23,13
Loko Moscow,8229,1,11,6,3,31,14,17,39
CSKA Moscow,8229,2,10,4,6,26,19,7,34
Zenit,8229,3,8,9,3,23,14,9,33
Spart Moscow,8229,4,9,6,5,34,26,8,33
Terek Grozny,8229,5,9,5,6,27,22,5,32
Krasnodar,8229,6,8,6,6,28,25,3,30
Din Moscow,8229,7,7,6,7,20,22,-2,27
FK Rubin,8229,8,5,6,9,22,19,3,21
Rostov,8229,9,4,6,10,10,18,-8,18
Amkar,8229,10,4,5,11,9,25,-16,17
Anzhi,8229,11,3,5,12,16,42,-26,14
Loko Moscow,8230,1,13,5,2,33,11,22,44
Spart Moscow,8230,2,10,6,4,42,27,15,36
CSKA Moscow,8230,3,10,3,7,27,23,4,33
Zenit,8230,4,8,8,4,24,16,8,32
Krasnodar,8230,5,9,4,7,30,27,3,31
Terek Grozny,8230,6,7,5,8,21,26,-5,26
FK Rubin,8230,7,6,5,9,23,20,3,23
Din Moscow,8230,8,5,6,9,18,27,-9,21
Rostov,8230,9,4,7,9,11,18,-7,19
Amkar,8230,10,5,4,11,11,26,-15,19
Anzhi,8230,11,4,5,11,19,38,-19,17
Loko Moscow,8231,1,13,5,2,33,11,22,44
CSKA Moscow,8231,2,11,3,6,30,21,9,36
Spart Moscow,8231,3,9,6,5,37,28,9,33
Zenit,8231,4,8,8,4,24,16,8,32
Krasnodar,8231,5,9,4,7,29,26,3,31
Terek Grozny,8231,6,7,6,7,21,25,-4,27
Din Moscow,8231,7,6,7,7,19,22,-3,25
Amkar,8231,8,6,4,10,12,22,-10,22
FK Rubin,8231,9,5,5,10,21,20,1,20
Rostov,8231,10,4,6,10,11,20,-9,18
Anzhi,8231,11,2,6,12,16,42,-26,12
Loko Moscow,8232,1,11,6,3,30,14,16,39
CSKA Moscow,8232,2,11,3,6,29,19,10,36
Zenit,8232,3,8,9,3,23,14,9,33
Spart Moscow,8232,4,9,5,6,37,29,8,32
Krasnodar,8232,5,9,5,6,31,26,5,32
Terek Grozny,8232,6,8,6,6,22,23,-1,30
Din Moscow,8232,7,7,6,7,22,21,1,27
FK Rubin,8232,8,5,6,9,23,21,2,21
Amkar,8232,9,5,4,11,10,23,-13,19
Rostov,8232,10,4,6,10,10,21,-11,18
Anzhi,8232,11,2,6,12,16,42,-26,12
Loko Moscow,8233,1,11,5,4,32,17,15,38
CSKA Moscow,8233,2,11,4,5,26,17,9,37
Spart Moscow,8233,3,10,5,5,38,28,10,35
Zenit,8233,4,8,8,4,23,15,8,32
Krasnodar,8233,5,9,5,6,33,28,5,32
Terek Grozny,8233,6,7,5,8,21,27,-6,26
FK Rubin,8233,7,5,7,8,24,20,4,22
Din Moscow,8233,8,5,7,8,19,25,-6,22
Amkar,8233,9,6,4,10,14,23,-9,22
Rostov,8233,10,4,6,10,10,18,-8,18
Anzhi,8233,11,3,6,11,16,38,-22,15
Loko Moscow,8234,1,13,5,2,32,12,20,44
CSKA Moscow,8234,2,11,3,6,27,19,8,36
Spart Moscow,8234,3,9,6,5,39,29,10,33
Terek Grozny,8234,4,8,6,6,21,22,-1,30
Zenit,8234,5,7,8,5,21,15,6,29
Krasnodar,8234,6,8,5,7,29,27,2,29
Din Moscow,8234,7,6,6,8,19,25,-6,24
FK Rubin,8234,8,5,6,9,22,19,3,21
Rostov,8234,9,5,6,9,11,17,-6,21
Amkar,8234,10,4,6,10,11,24,-13,18
Anzhi,8234,11,3,5,12,16,39,-23,14
Loko Moscow,8235,1,12,5,3,32,15,17,41
CSKA Moscow,8235,2,11,4,5,34,20,14,37
Krasnodar,8235,3,10,4,6,32,26,6,34
Spart Moscow,8235,4,9,6,5,35,26,9,33
Terek Grozny,8235,5,9,5,6,22,22,0,32
Zenit,8235,6,7,9,4,24,17,7,30
Din Moscow,8235,7,6,6,8,20,24,-4,24
Rostov,8235,8,5,6,9,11,17,-6,21
FK Rubin,8235,9,5,5,10,23,22,1,20
Amkar,8235,10,4,5,11,9,23,-14,17
Anzhi,8235,11,2,5,13,15,45,-30,11
Loko Moscow,8236,1,11,6,3,29,12,17,39
CSKA Moscow,8236,2,10,5,5,26,18,8,35
Spart Moscow,8236,3,9,7,4,37,27,10,34
Zenit,8236,4,7,10,3,22,14,8,31
Krasnodar,8236,5,9,4,7,28,26,2,31
Terek Grozny,8236,6,8,5,7,21,24,-3,29
FK Rubin,8236,7,7,5,8,25,18,7,26
Din Moscow,8236,8,5,7,8,19,24,-5,22
Amkar,8236,9,5,5,10,11,22,-11,20
Rostov,8236,10,4,6,10,11,20,-9,18
Anzhi,8236,11,2,6,12,14,38,-24,12
Loko Moscow,8237,1,12,5,3,33,15,18,41
CSKA Moscow,8237,2,12,3,5,32,18,14,39
Spart Moscow,8237,3,10,6,4,40,28,12,36
Krasnodar,8237,4,10,4,6,30,24,6,34
Zenit,8237,5,7,8,5,24,19,5,29
Terek Grozny,8237,6,7,7,6,21,23,-2,28
Din Moscow,8237,7,5,8,7,19,23,-4,23
FK Rubin,8237,8,5,6,9,21,18,3,21
Rostov,8237,9,4,6,10,11,20,-9,18
Amkar,8237,10,4,5,11,9,24,-15,17
Anzhi,8237,11,2,6,12,15,43,-28,12
Loko Moscow,8238,1,12,5,3,32,14,18,41
Spart Moscow,8238,2,11,5,4,41,29,12,38
Krasnodar,8238,3,10,4,6,33,26,7,34
CSKA Moscow,8238,4,10,4,6,27,20,7,34
Zenit,8238,5,8,8,4,22,15,7,32
Terek Grozny,8238,6,7,6,7,21,26,-5,27
Din Moscow,8238,7,6,6,8,19,22,-3,24
FK Rubin,8238,8,5,5,10,22,22,0,20
Amkar,8238,9,5,4,11,15,26,-11,19
Rostov,8238,10,4,6,10,11,20,-9,18
Anzhi,8238,11,2,7,11,17,40,-23,13
Loko Moscow,8239,1,11,7,2,29,11,18,40
CSKA Moscow,8239,2,11,3,6,28,20,8,36
Spart Moscow,8239,3,10,5,5,37,28,9,35
Zenit,8239,4,8,9,3,23,14,9,33
Krasnodar,8239,5,8,6,6,28,25,3,30
Terek Grozny,8239,6,8,6,6,25,24,1,30
Din Moscow,8239,7,7,6,7,19,21,-2,27
FK Rubin,8239,8,5,6,9,22,19,3,21
Rostov,8239,9,4,6,10,11,19,-8,18
Amkar,8239,10,4,4,12,10,27,-17,16
Anzhi,8239,11,2,6,12,17,41,-24,12
Loko Moscow,8240,1,12,6,2,31,11,20,42
CSKA Moscow,8240,2,10,4,6,29,22,7,34
Zenit,8240,3,8,8,4,22,15,7,32
Spart Moscow,8240,4,8,7,5,35,28,7,31
Krasnodar,8240,5,8,5,7,28,26,2,29
Terek Grozny,8240,6,7,5,8,22,27,-5,26
Din Moscow,8240,7,6,7,7,18,21,-3,25
FK Rubin,8240,8,6,5,9,23,19,4,23
Rostov,8240,9,5,6,9,12,18,-6,21
Amkar,8240,10,5,5,10,12,24,-12,20
Anzhi,8240,11,3,6,11,21,42,-21,15
Loko Moscow,8241,1,12,5,3,31,13,18,41
CSKA Moscow,8241,2,11,3,6,31,20,11,36
Krasnodar,8241,3,10,4,6,30,24,6,34
Spart Moscow,8241,4,9,6,5,36,27,9,33
Zenit,8241,5,8,8,4,24,15,9,32
Terek Grozny,8241,6,8,5,7,25,27,-2,29
Din Moscow,8241,7,6,7,7,19,22,-3,25
FK Rubin,8241,8,5,6,9,22,19,3,21
Rostov,8241,9,4,7,9,11,18,-7,19
Amkar,8241,10,5,4,11,14,27,-13,19
Anzhi,8241,11,2,5,13,14,45,-31,11
Loko Moscow,8242,1,13,5,2,32,11,21,44
CSKA Moscow,8242,2,11,3,6,28,19,9,36
Spart Moscow,8242,3,9,5,6,37,30,7,32
Zenit,8242,4,8,8,4,22,15,7,32
Krasnodar,8242,5,8,5,7,28,26,2,29
Terek Grozny,8242,6,8,5,7,22,25,-3,29
Din Moscow,8242,7,6,6,8,22,25,-3,24
Amkar,8242,8,6,4,10,13,22,-9,22
FK Rubin,8242,9,5,6,9,23,21,2,21
Rostov,8242,10,5,6,9,12,18,-6,21
Anzhi,8242,11,2,5,13,15,42,-27,11
Loko Moscow,8243,1,11,6,3,33,18,15,39
Spart Moscow,8243,2,11,5,4,43,27,16,38
CSKA Moscow,8243,3,11,4,5,29,20,9,37
Krasnodar,8243,4,10,4,6,33,25,8,34
Zenit,8243,5,7,9,4,25,18,7,30
Terek Grozny,8243,6,8,5,7,23,25,-2,29
Din Moscow,8243,7,6,6,8,21,26,-5,24
FK Rubin,8243,8,5,5,10,23,22,1,20
Rostov,8243,9,4,6,10,11,21,-10,18
Amkar,8243,10,4,4,12,10,27,-17,16
Anzhi,8243,11,3,6,11,18,40,-22,15
Loko Moscow,8244,1,12,6,2,32,13,19,42
CSKA Moscow,8244,2,11,4,5,29,20,9,37
Spart Moscow,8244,3,10,6,4,41,27,14,36
Krasnodar,8244,4,9,5,6,30,26,4,32
Zenit,8244,5,7,9,4,23,16,7,30
Terek Grozny,8244,6,8,5,7,25,26,-1,29
Din Moscow,8244,7,6,6,8,20,25,-5,24
FK Rubin,8244,8,5,5,10,21,19,2,20
Rostov,8244,9,4,6,10,10,21,-11,18
Amkar,8244,10,4,5,11,10,25,-15,17
Anzhi,8244,11,3,5,12,18,41,-23,14
Loko Moscow,8245,1,13,5,2,32,12,20,44
CSKA Moscow,8245,2,11,4,5,29,18,11,37
Spart Moscow,8245,3,10,6,4,37,26,11,36
Zenit,8245,4,7,9,4,23,16,7,30
Terek Grozny,8245,5,8,6,6,23,24,-1,30
Krasnodar,8245,6,8,5,7,27,25,2,29
FK Rubin,8245,7,5,7,8,21,17,4,22
Din Moscow,8245,8,5,7,8,17,22,-5,22
Rostov,8245,9,4,6,10,10,19,-9,18
Amkar,8245,10,4,6,10,10,23,-13,18
Anzhi,8245,11,2,5,13,16,43,-27,11
Loko Moscow,8246,1,12,5,3,32,12,20,41
Spart Moscow,8246,2,11,5,4,42,29,13,38
CSKA Moscow,8246,3,10,4,6,28,23,5,34
Zenit,8246,4,8,9,3,22,13,9,33
Krasnodar,8246,5,8,5,7,27,27,0,29
Terek Grozny,8246,6,7,6,7,21,24,-3,27
Din Moscow,8246,7,6,6,8,20,25,-5,24
FK Rubin,8246,8,5,6,9,21,18,3,21
Amkar,8246,9,5,4,11,12,25,-13,19
Rostov,8246,10,4,6,10,11,20,-9,18
Anzhi,8246,11,3,6,11,20,40,-20,15
Loko Moscow,8247,1,13,5,2,31,11,20,44
CSKA Moscow,8247,2,11,4,5,26,17,9,37
Spart Moscow,8247,3,10,5,5,42,27,15,35
Zenit,8247,4,7,9,4,21,14,7,30
Krasnodar,8247,5,8,5,7,29,27,2,29
Terek Grozny,8247,6,7,6,7,22,25,-3,27
Din Moscow,8247,7,6,7,7,20,23,-3,25
FK Rubin,8247,8,5,7,8,24,20,4,22
Amkar,8247,9,5,4,11,11,27,-16,19
Rostov,8247,10,4,6,10,10,21,-11,18
Anzhi,8247,11,2,6,12,15,39,-24,12
Loko Moscow,8248,1,13,5,2,33,11,22,44
Spart Moscow,8248,2,10,6,4,39,26,13,36
CSKA Moscow,8248,3,10,5,5,27,19,8,35
Zenit,8248,4,7,9,4,23,17,6,30
Terek Grozny,8248,5,8,6,6,24,25,-1,30
Krasnodar,8248,6,8,5,7,28,27,1,29
FK Rubin,8248,7,5,7,8,23,19,4,22
Din Moscow,8248,8,5,7,8,18,25,-7,22
Rostov,8248,9,4,6,10,10,19,-9,18
Amkar,8248,10,4,6,10,11,24,-13,18
Anzhi,8248,11,2,6,12,16,40,-24,12
Loko Moscow,8249,1,12,6,2,31,12,19,42
CSKA Moscow,8249,2,11,3,6,27,19,8,36
Zenit,8249,3,8,9,3,23,13,10,33
Spart Moscow,8249,4,8,7,5,34,27,7,31
Terek Grozny,8249,5,8,6,6,23,24,-1,30
Krasnodar,8249,6,8,5,7,28,26,2,29
Din Moscow,8249,7,6,7,7,18,21,-3,25
FK Rubin,8249,8,5,7,8,21,17,4,22
Rostov,8249,9,4,7,9,10,17,-7,19
Amkar,8249,10,4,5,11,11,25,-14,17
Anzhi,8249,11,2,6,12,15,40,-25,12
Loko Moscow,8250,1,13,5,2,31,11,20,44
CSKA Moscow,8250,2,12,3,5,30,18,12,39
Spart Moscow,8250,3,10,5,5,39,30,9,35
Terek Grozny,8250,4,9,5,6,22,22,0,32
Krasnodar,8250,5,9,4,7,30,25,5,31
Zenit,8250,6,7,8,5,21,15,6,29
Din Moscow,8250,7,5,7,8,20,26,-6,22
FK Rubin,8250,8,5,6,9,23,22,1,21
Rostov,8250,9,5,6,9,14,18,-4,21
Amkar,8250,10,4,4,12,9,25,-16,16
Anzhi,8250,11,2,5,13,15,42,-27,11
Loko Moscow,8251,1,11,6,3,32,15,17,39
CSKA Moscow,8251,2,11,4,5,31,20,11,37
Spart Moscow,8251,3,10,6,4,37,26,11,36
Zenit,8251,4,7,10,3,25,17,8,31
Krasnodar,8251,5,9,4,7,30,27,3,31
Terek Grozny,8251,6,8,5,7,22,27,-5,29
FK Rubin,8251,7,7,5,8,25,19,6,26
Din Moscow,8251,8,5,6,9,18,25,-7,21
Rostov,8251,9,4,7,9,11,18,-7,19
Amkar,8251,10,4,4,12,10,25,-15,16
Anzhi,8251,11,3,5,12,19,41,-22,14
Loko Moscow,8252,1,13,5,2,33,12,21,44
CSKA Moscow,8252,2,12,3,5,29,17,12,39
Spart Moscow,8252,3,9,6,5,37,29,8,33
Terek Grozny,8252,4,9,5,6,27,26,1,32
Zenit,8252,5,7,8,5,21,16,5,29
Krasnodar,8252,6,8,4,8,28,27,1,28
FK Rubin,8252,7,7,5,8,24,18,6,26
Din Moscow,8252,8,5,6,9,18,25,-7,21
Rostov,8252,9,4,7,9,12,19,-7,19
Amkar,8252,10,5,4,11,13,25,-12,19
Anzhi,8252,11,2,5,13,16,44,-28,11
Loko Moscow,8253,1,13,5,2,34,12,22,44
Spart Moscow,8253,2,11,5,4,43,27,16,38
CSKA Moscow,8253,3,11,3,6,29,20,9,36
Terek Grozny,8253,4,9,5,6,23,23,0,32
Krasnodar,8253,5,9,4,7,30,26,4,31
Zenit,8253,6,7,8,5,22,18,4,29
FK Rubin,8253,7,6,5,9,24,20,4,23
Din Moscow,8253,8,5,6,9,18,29,-11,21
Rostov,8253,9,4,6,10,10,19,-9,18
Amkar,8253,10,4,4,12,10,26,-16,16
Anzhi,8253,11,3,5,12,18,41,-23,14
Loko Moscow,8254,1,12,6,2,31,12,19,42
CSKA Moscow,8254,2,11,3,6,28,21,7,36
Zenit,8254,3,8,8,4,24,15,9,32
Spart Moscow,8254,4,9,5,6,37,30,7,32
Krasnodar,8254,5,9,5,6,32,26,6,32
Din Moscow,8254,6,7,6,7,22,23,-1,27
Terek Grozny,8254,7,7,6,7,21,24,-3,27
Amkar,8254,8,6,4,10,11,22,-11,22
FK Rubin,8254,9,5,5,10,23,23,0,20
Rostov,8254,10,4,6,10,11,20,-9,18
Anzhi,8254,11,2,6,12,16,40,-24,12
Loko Moscow,8255,1,11,6,3,32,16,16,39
Spart Moscow,8255,2,10,6,4,37,26,11,36
Zenit,8255,3,9,8,3,26,15,11,35
CSKA Moscow,8255,4,10,4,6,27,20,7,34
Krasnodar,8255,5,9,5,6,31,26,5,32
Terek Grozny,8255,6,8,6,6,23,24,-1,30
Din Moscow,8255,7,5,7,8,18,23,-5,22
FK Rubin,8255,8,5,6,9,21,19,2,21
Rostov,8255,9,4,6,10,10,19,-9,18
Amkar,8255,10,4,6,10,9,22,-13,18
Anzhi,8255,11,2,6,12,17,41,-24,12
Loko Moscow,8256,1,13,5,2,32,11,21,44
Spart Moscow,8256,2,10,6,4,38,26,12,36
CSKA Moscow,8256,3,10,5,5,27,19,8,35
Krasnodar,8256,4,9,4,7,29,26,3,31
Zenit,8256,5,7,9,4,22,16,6,30
Terek Grozny,8256,6,8,5,7,22,23,-1,29
Din Moscow,8256,7,5,7,8,18,24,-6,22
FK Rubin,8256,8,5,6,9,23,20,3,21
Rostov,8256,9,4,6,10,10,19,-9,18
Amkar,8256,10,4,5,11,10,25,-15,17
Anzhi,8256,11,3,6,11,16,38,-22,15
Loko Moscow,8257,1,12,6,2,33,12,21,42
CSKA Moscow,8257,2,11,3,6,28,20,8,36
Spart Moscow,8257,3,10,5,5,37,26,11,35
Zenit,8257,4,8,9,3,25,14,11,33
Krasnodar,8257,5,9,4,7,30,29,1,31
Terek Grozny,8257,6,8,6,6,26,25,1,30
Din Moscow,8257,7,5,7,8,17,24,-7,22
FK Rubin,8257,8,5,6,9,23,20,3,21
Amkar,8257,9,5,5,10,11,23,-12,20
Rostov,8257,10,4,6,10,10,18,-8,18
Anzhi,8257,11,2,5,13,16,45,-29,11
Loko Moscow,8258,1,12,6,2,31,12,19,42
Spart Moscow,8258,2,11,5,4,40,25,15,38
Zenit,8258,3,8,9,3,23,14,9,33
CSKA Moscow,8258,4,10,3,7,25,20,5,33
Krasnodar,8258,5,8,5,7,27,25,2,29
Terek Grozny,8258,6,7,7,6,22,24,-2,28
FK Rubin,8258,7,5,7,8,21,17,4,22
Din Moscow,8258,8,5,7,8,17,23,-6,22
Rostov,8258,9,4,6,10,10,20,-10,18
Amkar,8258,10,4,5,11,10,25,-15,17
Anzhi,8258,11,3,6,11,17,38,-21,15
Loko Moscow,8259,1,12,5,3,31,12,19,41
CSKA Moscow,8259,2,11,4,5,28,19,9,37
Spart Moscow,8259,3,10,6,4,38,27,11,36
Krasnodar,8259,4,10,4,6,30,24,6,34
Zenit,8259,5,7,9,4,22,16,6,30
Terek Grozny,8259,6,8,6,6,21,22,-1,30
Din Moscow,8259,7,5,8,7,19,23,-4,23
FK Rubin,8259,8,5,6,9,22,20,2,21
Rostov,8259,9,4,6,10,10,19,-9,18
Amkar,8259,10,4,5,11,10,24,-14,17
Anzhi,8259,11,2,5,13,15,40,-25,11
Loko Moscow,8260,1,11,6,3,31,14,17,39
CSKA Moscow,8260,2,11,3,6,28,23,5,36
Zenit,8260,3,9,8,3,28,15,13,35
Spart Moscow,8260,4,9,5,6,35,29,6,32
Terek Grozny,8260,5,9,5,6,24,24,0,32
Krasnodar,8260,6,8,6,6,30,27,3,30
Din Moscow,8260,7,6,6,8,20,23,-3,24
FK Rubin,8260,8,5,6,9,23,21,2,21
Rostov,8260,9,5,6,9,12,17,-5,21
Amkar,8260,10,5,4,11,11,24,-13,19
Anzhi,8260,11,2,5,13,16,41,-25,11
Loko Moscow,8261,1,12,5,3,33,15,18,41
CSKA Moscow,8261,2,11,3,6,26,18,8,36
Spart Moscow,8261,3,10,5,5,38,29,9,35
Krasnodar,8261,4,9,5,6,31,24,7,32
Zenit,8261,5,8,8,4,22,17,5,32
Din Moscow,8261,6,7,6,7,22,23,-1,27
Terek Grozny,8261,7,7,5,8,20,27,-7,26
FK Rubin,8261,8,5,6,9,22,20,2,21
Amkar,8261,9,5,4,11,12,24,-12,19
Rostov,8261,10,4,6,10,11,19,-8,18
Anzhi,8261,11,3,5,12,17,38,-21,14
Loko Moscow,8262,1,13,5,2,35,13,22,44
CSKA Moscow,8262,2,10,5,5,27,19,8,35
Spart Moscow,8262,3,9,6,5,37,30,7,33
Terek Grozny,8262,4,9,5,6,22,22,0,32
Krasnodar,8262,5,9,4,7,31,28,3,31
Zenit,8262,6,7,9,4,22,16,6,30
Din Moscow,8262,7,6,6,8,19,23,-4,24
FK Rubin,8262,8,5,5,10,22,21,1,20
Rostov,8262,9,4,7,9,11,18,-7,19
Amkar,8262,10,5,4,11,12,24,-12,19
Anzhi,8262,11,2,6,12,16,40,-24,12
Loko Moscow,8263,1,12,6,2,34,14,20,42
CSKA Moscow,8263,2,11,3,6,30,20,10,36
Spart Moscow,8263,3,10,5,5,39,28,11,35
Zenit,8263,4,8,9,3,24,15,9,33
Krasnodar,8263,5,9,4,7,30,28,2,31
Terek Grozny,8263,6,7,6,7,20,23,-3,27
Din Moscow,8263,7,5,7,8,19,25,-6,22
Amkar,8263,8,6,4,10,12,23,-11,22
FK Rubin,8263,9,5,6,9,22,19,3,21
Rostov,8263,10,4,6,10,10,19,-9,18
Anzhi,8263,11,2,6,12,15,41,-26,12
Loko Moscow,8264,1,12,6,2,32,13,19,42
CSKA Moscow,8264,2,12,3,5,28,17,11,39
Spart Moscow,8264,3,9,6,5,37,29,8,33
Krasnodar,8264,4,9,5,6,32,28,4,32
Terek Grozny,8264,5,9,5,6,23,22,1,32
Zenit,8264,6,7,8,5,21,15,6,29
Din Moscow,8264,7,6,6,8,19,23,-4,24
FK Rubin,8264,8,5,5,10,24,22,2,20
Rostov,8264,9,4,7,9,11,18,-7,19
Amkar,8264,10,5,4,11,12,26,-14,19
Anzhi,8264,11,2,5,13,14,40,-26,11
Loko Moscow,8265,1,12,6,2,30,11,19,42
CSKA Moscow,8265,2,10,4,6,25,18,7,34
Zenit,8265,3,8,8,4,22,14,8,32
Krasnodar,8265,4,9,5,6,28,24,4,32
Spart Moscow,8265,5,9,5,6,34,31,3,32
Terek Grozny,8265,6,7,6,7,21,24,-3,27
FK Rubin,8265,7,6,5,9,23,18,5,23
Amkar,8265,8,6,4,10,14,23,-9,22
Rostov,8265,9,5,6,9,13,17,-4,21
Din Moscow,8265,10,5,6,9,17,24,-7,21
Anzhi,8265,11,2,7,11,14,37,-23,13
Loko Moscow,8266,1,13,5,2,32,11,21,44
CSKA Moscow,8266,2,11,3,6,30,22,8,36
Zenit,8266,3,8,8,4,24,17,7,32
Spart Moscow,8266,4,8,7,5,38,31,7,31
Krasnodar,8266,5,9,4,7,28,25,3,31
Terek Grozny,8266,6,8,6,6,21,22,-1,30
Din Moscow,8266,7,6,7,7,20,23,-3,25
FK Rubin,8266,8,5,5,10,21,19,2,20
Amkar,8266,9,5,5,10,11,23,-12,20
Rostov,8266,10,4,7,9,12,19,-7,19
Anzhi,8266,11,2,5,13,16,41,-25,11
Loko Moscow,8267,1,11,6,3,29,13,16,39
Spart Moscow,8267,2,10,6,4,37,27,10,36
CSKA Moscow,8267,3,11,3,6,28,19,9,36
Zenit,8267,4,8,9,3,22,13,9,33
Krasnodar,8267,5,9,4,7,29,26,3,31
Terek Grozny,8267,6,7,5,8,22,26,-4,26
FK Rubin,8267,7,6,6,8,23,17,6,24
Din Moscow,8267,8,5,7,8,18,23,-5,22
Amkar,8267,9,5,5,10,12,24,-12,20
Rostov,8267,10,4,6,10,11,19,-8,18
Anzhi,8267,11,3,5,12,16,40,-24,14
Loko Moscow,8268,1,13,5,2,32,11,21,44
Spart Moscow,8268,2,11,5,4,41,29,12,38
CSKA Moscow,8268,3,11,4,5,28,19,9,37
Krasnodar,8268,4,9,4,7,29,27,2,31
Zenit,8268,5,7,9,4,22,15,7,30
Terek Grozny,8268,6,7,5,8,20,25,-5,26
FK Rubin,8268,7,6,5,9,25,19,6,23
Din Moscow,8268,8,5,6,9,19,27,-8,21
Amkar,8268,9,5,4,11,12,25,-13,19
Rostov,8268,10,4,6,10,10,19,-9,18
Anzhi,8268,11,3,5,12,17,39,-22,14
Loko Moscow,8269,1,12,6,2,33,12,21,42
CSKA Moscow,8269,2,11,3,6,27,22,5,36
Spart Moscow,8269,3,9,6,5,39,28,11,33
Zenit,8269,4,8,8,4,25,16,9,32
Krasnodar,8269,5,9,5,6,30,25,5,32
Terek Grozny,8269,6,8,5,7,23,25,-2,29
Din Moscow,8269,7,6,7,7,20,23,-3,25
FK Rubin,8269,8,5,6,9,22,20,2,21
Rostov,8269,9,4,7,9,11,18,-7,19
Amkar,8269,10,4,4,12,9,27,-18,16
Anzhi,8269,11,3,5,12,18,41,-23,14
Loko Moscow,8270,1,12,5,3,33,13,20,41
CSKA Moscow,8270,2,12,3,5,30,17,13,39
Krasnodar,8270,3,10,4,6,30,24,6,34
Spart Moscow,8270,4,9,6,5,37,28,9,33
Zenit,8270,5,7,8,5,22,19,3,29
Terek Grozny,8270,6,7,6,7,21,26,-5,27
Din Moscow,8270,7,6,7,7,20,23,-3,25
Amkar,8270,8,6,4,10,14,23,-9,22
FK Rubin,8270,9,5,5,10,22,21,1,20
Rostov,8270,10,4,6,10,10,19,-9,18
Anzhi,8270,11,2,6,12,15,41,-26,12
Loko Moscow,8271,1,13,5,2,33,12,21,44
CSKA Moscow,8271,2,11,4,5,27,17,10,37
Spart Moscow,8271,3,10,6,4,38,27,11,36
Krasnodar,8271,4,9,4,7,30,27,3,31
Zenit,8271,5,7,8,5,21,17,4,29
Terek Grozny,8271,6,8,5,7,21,23,-2,29
FK Rubin,8271,7,6,5,9,23,19,4,23
Din Moscow,8271,8,5,7,8,17,22,-5,22
Rostov,8271,9,4,6,10,11,19,-8,18
Amkar,8271,10,4,4,12,10,26,-16,16
Anzhi,8271,11,3,6,11,15,37,-22,15
Loko Moscow,8272,1,13,5,2,34,13,21,44
CSKA Moscow,8272,2,11,3,6,27,19,8,36
Spart Moscow,8272,3,10,5,5,37,28,9,35
Zenit,8272,4,8,8,4,23,15,8,32
Terek Grozny,8272,5,8,6,6,24,22,2,30
Krasnodar,8272,6,8,4,8,28,28,0,28
Din Moscow,8272,7,6,6,8,20,23,-3,24
FK Rubin,8272,8,6,5,9,22,19,3,23
Amkar,8272,9,5,5,10,11,22,-11,20
Rostov,8272,10,4,6,10,10,19,-9,18
Anzhi,8272,11,2,5,13,15,43,-28,11
Loko Moscow,8273,1,12,5,3,31,15,16,41
CSKA Moscow,8273,2,12,3,5,31,18,13,39
Zenit,8273,3,8,8,4,26,16,10,32
Spart Moscow,8273,4,9,5,6,36,29,7,32
Terek Grozny,8273,5,8,5,7,22,23,-1,29
Krasnodar,8273,6,8,4,8,27,26,1,28
FK Rubin,8273,7,6,6,8,22,17,5,24
Din Moscow,8273,8,5,7,8,19,24,-5,22
Amkar,8273,9,6,4,10,11,22,-11,22
Rostov,8273,10,5,6,9,11,17,-6,21
Anzhi,8273,11,2,5,13,14,43,-29,11
Loko Moscow,8274,1,13,5,2,34,13,21,44
CSKA Moscow,8274,2,11,4,5,26,17,9,37
Spart Moscow,8274,3,9,7,4,38,27,11,34
Terek Grozny,8274,4,9,5,6,24,23,1,32
Krasnodar,8274,5,9,4,7,31,27,4,31
Zenit,8274,6,7,9,4,22,15,7,30
Din Moscow,8274,7,5,8,7,18,22,-4,23
FK Rubin,8274,8,5,6,9,22,21,1,21
Rostov,8274,9,4,6,10,10,20,-10,18
Amkar,8274,10,4,5,11,11,26,-15,17
Anzhi,8274,11,2,5,13,15,40,-25,11
Loko Moscow,8275,1,12,5,3,33,16,17,41
CSKA Moscow,8275,2,11,4,5,27,18,9,37
Zenit,8275,3,8,9,3,25,15,10,33
Spart Moscow,8275,4,8,6,6,33,27,6,30
Krasnodar,8275,5,8,5,7,30,28,2,29
Terek Grozny,8275,6,7,6,7,22,25,-3,27
Din Moscow,8275,7,6,7,7,18,21,-3,25
FK Rubin,8275,8,5,7,8,23,19,4,22
Amkar,8275,9,5,5,10,10,22,-12,20
Rostov,8275,10,4,7,9,10,17,-7,19
Anzhi,8275,11,3,5,12,18,41,-23,14
Loko Moscow,8276,1,12,5,3,31,13,18,41
CSKA Moscow,8276,2,11,3,6,29,23,6,36
Zenit,8276,3,9,8,3,26,14,12,35
Spart Moscow,8276,4,10,5,5,38,27,11,35
Terek Grozny,8276,5,8,5,7,21,23,-2,29
Krasnodar,8276,6,8,4,8,28,27,1,28
FK Rubin,8276,7,7,5,8,23,17,6,26
Rostov,8276,8,5,6,9,12,18,-6,21
Din Moscow,8276,9,5,6,9,17,25,-8,21
Amkar,8276,10,4,4,12,9,24,-15,16
Anzhi,8276,11,3,5,12,17,40,-23,14
Loko Moscow,8277,1,12,6,2,32,13,19,42
CSKA Moscow,8277,2,11,4,5,27,17,10,37
Spart Moscow,8277,3,10,5,5,37,30,7,35
Zenit,8277,4,7,10,3,23,15,8,31
Krasnodar,8277,5,9,4,7,29,25,4,31
Terek Grozny,8277,6,7,5,8,21,25,-4,26
FK Rubin,8277,7,6,5,9,23,19,4,23
Amkar,8277,8,6,4,10,15,23,-8,22
Din Moscow,8277,9,5,6,9,17,25,-8,21
Rostov,8277,10,4,6,10,10,18,-8,18
Anzhi,8277,11,3,5,12,16,40,-24,14
Loko Moscow,8278,1,12,5,3,32,12,20,41
CSKA Moscow,8278,2,11,3,6,29,19,10,36
Spart Moscow,8278,3,10,5,5,37,26,11,35
Zenit,8278,4,9,8,3,24,14,10,35
Terek Grozny,8278,5,9,5,6,22,22,0,32
Krasnodar,8278,6,8,4,8,27,28,-1,28
FK Rubin,8278,7,7,5,8,23,17,6,26
Din Moscow,8278,8,5,6,9,17,24,-7,21
Amkar,8278,9,5,4,11,10,23,-13,19
Rostov,8278,10,4,6,10,10,19,-9,18
Anzhi,8278,11,2,5,13,14,41,-27,11
Loko Moscow,8279,1,12,5,3,33,14,19,41
CSKA Moscow,8279,2,11,4,5,27,17,10,37
Spart Moscow,8279,3,10,5,5,39,28,11,35
Krasnodar,8279,4,10,4,6,33,27,6,34
Zenit,8279,5,7,9,4,21,15,6,30
Terek Grozny,8279,6,7,5,8,20,25,-5,26
Din Moscow,8279,7,5,7,8,18,26,-8,22
Amkar,8279,8,6,4,10,14,23,-9,22
FK Rubin,8279,9,5,6,9,23,21,2,21
Rostov,8279,10,4,6,10,10,18,-8,18
Anzhi,8279,11,3,5,12,15,39,-24,14
Loko Moscow,8280,1,11,6,3,30,13,17,39
CSKA Moscow,8280,2,11,3,6,28,20,8,36
Zenit,8280,3,9,8,3,25,15,10,35
Spart Moscow,8280,4,9,5,6,37,30,7,32
Krasnodar,8280,5,9,5,6,31,24,7,32
Terek Grozny,8280,6,7,6,7,22,25,-3,27
FK Rubin,8280,7,6,5,9,22,21,1,23
Rostov,8280,8,5,6,9,12,18,-6,21
Din Moscow,8280,9,5,6,9,17,24,-7,21
Amkar,8280,10,5,5,10,13,24,-11,20
Anzhi,8280,11,3,5,12,17,40,-23,14
Loko Moscow,8281,1,11,6,3,31,14,17,39
Spart Moscow,8281,2,10,5,5,37,28,9,35
CSKA Moscow,8281,3,10,4,6,25,18,7,34
Krasnodar,8281,4,10,4,6,35,29,6,34
Zenit,8281,5,7,10,3,21,13,8,31
Terek Grozny,8281,6,8,5,7,24,26,-2,29
Din Moscow,8281,7,7,6,7,22,22,0,27
FK Rubin,8281,8,5,5,10,25,25,0,20
Amkar,8281,9,5,4,11,14,27,-13,19
Rostov,8281,10,4,6,10,10,19,-9,18
Anzhi,8281,11,3,5,12,15,38,-23,14
Loko Moscow,8282,1,12,6,2,31,12,19,42
CSKA Moscow,8282,2,11,3,6,27,19,8,36
Zenit,8282,3,8,9,3,24,14,10,33
Spart Moscow,8282,4,9,6,5,37,29,8,33
Krasnodar,8282,5,8,5,7,27,25,2,29
Terek Grozny,8282,6,7,6,7,21,24,-3,27
Din Moscow,8282,7,6,7,7,22,24,-2,25
FK Rubin,8282,8,5,6,9,23,21,2,21
Rostov,8282,9,5,6,9,12,17,-5,21
Amkar,8282,10,5,4,11,11,25,-14,19
Anzhi,8282,11,2,6,12,15,40,-25,12
Loko Moscow,8283,1,12,6,2,32,12,20,42
Spart Moscow,8283,2,10,6,4,39,29,10,36
Zenit,8283,3,8,9,3,24,15,9,33
CSKA Moscow,8283,4,10,3,7,26,20,6,33
Krasnodar,8283,5,9,4,7,29,26,3,31
Terek Grozny,8283,6,7,6,7,21,24,-3,27
FK Rubin,8283,7,6,5,9,22,19,3,23
Din Moscow,8283,8,5,6,9,19,25,-6,21
Rostov,8283,9,4,7,9,11,18,-7,19
Amkar,8283,10,5,4,11,11,24,-13,19
Anzhi,8283,11,3,6,11,16,38,-22,15
Loko Moscow,8284,1,11,7,2,31,13,18,40
CSKA Moscow,8284,2,12,3,5,30,17,13,39
Spart Moscow,8284,3,10,5,5,37,27,10,35
Krasnodar,8284,4,9,5,6,32,25,7,32
Zenit,8284,5,7,9,4,22,15,7,30
Terek Grozny,8284,6,8,5,7,22,24,-2,29
Din Moscow,8284,7,5,7,8,18,24,-6,22
Amkar,8284,8,6,4,10,13,23,-10,22
FK Rubin,8284,9,5,6,9,22,22,0,21
Rostov,8284,10,4,6,10,10,18,-8,18
Anzhi,8284,11,2,5,13,14,43,-29,11
Loko Moscow,8285,1,11,5,4,29,14,15,38
CSKA Moscow,8285,2,11,4,5,29,18,11,37
Spart Moscow,8285,3,10,5,5,36,29,7,35
Zenit,8285,4,8,9,3,23,14,9,33
Krasnodar,8285,5,9,5,6,29,24,5,32
Terek Grozny,8285,6,8,5,7,23,24,-1,29
FK Rubin,8285,7,5,7,8,21,17,4,22
Din Moscow,8285,8,5,7,8,17,22,-5,22
Rostov,8285,9,5,6,9,14,18,-4,21
Amkar,8285,10,5,4,11,11,24,-13,19
Anzhi,8285,11,2,5,13,14,42,-28,11
Loko Moscow,8286,1,12,5,3,32,14,18,41
Spart Moscow,8286,2,10,6,4,42,27,15,36
CSKA Moscow,8286,3,11,3,6,27,20,7,36
Zenit,8286,4,9,8,3,27,15,12,35
Terek Grozny,8286,5,8,6,6,22,23,-1,30
Krasnodar,8286,6,8,4,8,27,26,1,28
Din Moscow,8286,7,6,7,7,20,23,-3,25
FK Rubin,8286,8,6,5,9,22,18,4,23
Rostov,8286,9,4,6,10,10,19,-9,18
Amkar,8286,10,4,5,11,9,27,-18,17
Anzhi,8286,11,2,5,13,15,41,-26,11
Loko Moscow,8287,1,11,5,4,29,13,16,38
CSKA Moscow,8287,2,11,3,6,29,22,7,36
Zenit,8287,3,9,8,3,25,13,12,35
Krasnodar,8287,4,9,4,7,30,27,3,31
Spart Moscow,8287,5,8,5,7,34,30,4,29
Terek Grozny,8287,6,8,5,7,21,25,-4,29
Din Moscow,8287,7,6,7,7,20,22,-2,25
FK Rubin,8287,8,6,6,8,25,20,5,24
Amkar,8287,9,6,4,10,13,22,-9,22
Rostov,8287,10,5,6,9,12,18,-6,21
Anzhi,8287,11,2,5,13,16,42,-26,11
Loko Moscow,8288,1,12,5,3,31,12,19,41
CSKA Moscow,8288,2,11,3,6,33,20,13,36
Spart Moscow,8288,3,10,6,4,39,27,12,36
Zenit,8288,4,8,8,4,23,15,8,32
Krasnodar,8288,5,9,4,7,29,26,3,31
Terek Grozny,8288,6,7,5,8,20,26,-6,26
Din Moscow,8288,7,6,7,7,19,22,-3,25
FK Rubin,8288,8,6,5,9,23,19,4,23
Amkar,8288,9,5,4,11,11,24,-13,19
Rostov,8288,10,4,6,10,11,20,-9,18
Anzhi,8288,11,3,5,12,17,45,-28,14
Loko Moscow,8289,1,12,5,3,32,15,17,41
Spart Moscow,8289,2,11,5,4,41,25,16,38
CSKA Moscow,8289,3,11,3,6,27,19,8,36
Zenit,8289,4,8,8,4,24,16,8,32
Krasnodar,8289,5,9,5,6,30,25,5,32
Terek Grozny,8289,6,7,7,6,23,25,-2,28
Din Moscow,8289,7,6,6,8,18,26,-8,24
FK Rubin,8289,8,5,6,9,21,18,3,21
Rostov,8289,9,4,6,10,10,19,-9,18
Amkar,8289,10,4,5,11,9,23,-14,17
Anzhi,8289,11,2,6,12,17,41,-24,12
Loko Moscow,8290,1,12,5,3,32,13,19,41
CSKA Moscow,8290,2,10,4,6,27,21,6,34
Spart Moscow,8290,3,9,6,5,39,29,10,33
Krasnodar,8290,4,9,4,7,29,28,1,31
Zenit,8290,5,7,9,4,23,17,6,30
Terek Grozny,8290,6,8,5,7,23,25,-2,29
Din Moscow,8290,7,6,7,7,20,23,-3,25
FK Rubin,8290,8,6,6,8,24,17,7,24
Rostov,8290,9,4,7,9,11,18,-7,19
Amkar,8290,10,5,4,11,12,26,-14,19
Anzhi,8290,11,3,5,12,16,39,-23,14
Loko Moscow,8291,1,11,5,4,30,16,14,38
Spart Moscow,8291,2,10,6,4,39,28,11,36
CSKA Moscow,8291,3,11,3,6,27,18,9,36
Zenit,8291,4,8,8,4,24,16,8,32
Terek Grozny,8291,5,9,5,6,26,24,2,32
Krasnodar,8291,6,9,4,7,29,26,3,31
Din Moscow,8291,7,6,6,8,21,25,-4,24
FK Rubin,8291,8,6,5,9,23,19,4,23
Rostov,8291,9,4,6,10,10,18,-8,18
Amkar,8291,10,4,5,11,11,27,-16,17
Anzhi,8291,11,3,5,12,16,39,-23,14
Loko Moscow,8292,1,11,6,3,29,13,16,39
Spart Moscow,8292,2,10,6,4,41,27,14,36
CSKA Moscow,8292,3,11,3,6,31,22,9,36
Krasnodar,8292,4,10,4,6,31,24,7,34
Zenit,8292,5,8,9,3,23,14,9,33
Terek Grozny,8292,6,8,5,7,25,28,-3,29
Din Moscow,8292,7,5,8,7,18,22,-4,23
FK Rubin,8292,8,5,6,9,21,19,2,21
Amkar,8292,9,5,4,11,12,25,-13,19
Rostov,8292,10,4,6,10,11,22,-11,18
Anzhi,8292,11,2,5,13,20,46,-26,11
Loko Moscow,8293,1,12,6,2,31,12,19,42
CSKA Moscow,8293,2,10,5,5,26,18,8,35
Spart Moscow,8293,3,10,5,5,37,30,7,35
Zenit,8293,4,7,10,3,22,14,8,31
Terek Grozny,8293,5,8,6,6,23,23,0,30
Krasnodar,8293,6,8,5,7,28,26,2,29
FK Rubin,8293,7,5,7,8,24,20,4,22
Din Moscow,8293,8,5,7,8,19,24,-5,22
Rostov,8293,9,5,6,9,14,18,-4,21
Amkar,8293,10,4,5,11,11,25,-14,17
Anzhi,8293,11,2,6,12,15,40,-25,12
Loko Moscow,8294,1,12,5,3,33,14,19,41
CSKA Moscow,8294,2,11,3,6,29,20,9,36
Spart Moscow,8294,3,9,6,5,36,28,8,33
Zenit,8294,4,8,8,4,25,17,8,32
Terek Grozny,8294,5,9,5,6,23,22,1,32
Krasnodar,8294,6,9,4,7,31,28,3,31
Din Moscow,8294,7,6,6,8,18,23,-5,24
FK Rubin,8294,8,6,5,9,24,20,4,23
Rostov,8294,9,4,7,9,11,18,-7,19
Amkar,8294,10,5,4,11,11,23,-12,19
Anzhi,8294,11,2,5,13,14,42,-28,11
Loko Moscow,8295,1,12,5,3,31,13,18,41
CSKA Moscow,8295,2,11,4,5,31,18,13,37
Zenit,8295,3,8,9,3,23,14,9,33
Spart Moscow,8295,4,9,5,6,38,30,8,32
Krasnodar,8295,5,9,4,7,30,27,3,31
Terek Grozny,8295,6,8,5,7,25,25,0,29
Din Moscow,8295,7,6,6,8,20,27,-7,24
Amkar,8295,8,6,4,10,13,23,-10,22
Rostov,8295,9,5,6,9,12,17,-5,21
FK Rubin,8295,10,5,5,10,23,21,2,20
Anzhi,8295,11,2,5,13,15,46,-31,11
Loko Moscow,8296,1,11,7,2,32,14,18,40
CSKA Moscow,8296,2,12,3,5,31,17,14,39
Terek Grozny,8296,3,9,5,6,24,23,1,32
Spart Moscow,8296,4,8,7,5,37,30,7,31
Zenit,8296,5,7,9,4,23,19,4,30
Krasnodar,8296,6,8,6,6,29,26,3,30
Din Moscow,8296,7,6,7,7,22,24,-2,25
FK Rubin,8296,8,5,6,9,24,22,2,21
Rostov,8296,9,4,7,9,12,19,-7,19
Amkar,8296,10,5,4,11,12,25,-13,19
Anzhi,8296,11,2,5,13,14,41,-27,11
Loko Moscow,8297,1,11,6,3,30,15,15,39
CSKA Moscow,8297,2,12,3,5,27,17,10,39
Krasnodar,8297,3,10,4,6,31,24,7,34
Zenit,8297,4,7,9,4,22,15,7,30
Spart Moscow,8297,5,8,6,6,33,30,3,30
Terek Grozny,8297,6,8,6,6,21,22,-1,30
FK Rubin,8297,7,6,5,9,22,18,4,23
Din Moscow,8297,8,5,7,8,17,22,-5,22
Rostov,8297,9,5,6,9,11,17,-6,21
Amkar,8297,10,5,5,10,13,22,-9,20
Anzhi,8297,11,2,5,13,14,39,-25,11
Loko Moscow,8298,1,11,5,4,30,16,14,38
Zenit,8298,2,9,8,3,24,13,11,35
Spart Moscow,8298,3,9,6,5,35,28,7,33
CSKA Moscow,8298,4,10,3,7,25,19,6,33
Krasnodar,8298,5,9,5,6,31,26,5,32
Terek Grozny,8298,6,9,5,6,24,22,2,32
FK Rubin,8298,7,6,6,8,24,18,6,24
Din Moscow,8298,8,5,7,8,18,24,-6,22
Amkar,8298,9,5,4,11,11,24,-13,19
Rostov,8298,10,4,6,10,10,18,-8,18
Anzhi,8298,11,3,5,12,15,39,-24,14
Loko Moscow,8299,1,11,7,2,30,12,18,40
Spart Moscow,8299,2,10,6,4,36,26,10,36
CSKA Moscow,8299,3,11,3,6,28,19,9,36
Zenit,8299,4,8,9,3,22,13,9,33
Krasnodar,8299,5,8,6,6,30,27,3,30
Terek Grozny,8299,6,8,5,7,21,23,-2,29
Din Moscow,8299,7,6,6,8,20,22,-2,24
FK Rubin,8299,8,5,6,9,23,22,1,21
Rostov,8299,9,4,7,9,11,18,-7,19
Amkar,8299,10,4,4,12,9,24,-15,16
Anzhi,8299,11,3,5,12,16,40,-24,14
Loko Moscow,8300,1,12,6,2,31,12,19,42
CSKA Moscow,8300,2,12,3,5,33,18,15,39
Spart Moscow,8300,3,9,5,6,36,33,3,32
Zenit,8300,4,7,9,4,22,16,6,30
Terek Grozny,8300,5,8,5,7,24,24,0,29
Krasnodar,8300,6,8,4,8,28,30,-2,28
Din Moscow,8300,7,7,6,7,20,22,-2,27
FK Rubin,8300,8,6,5,9,25,18,7,23
Rostov,8300,9,5,6,9,16,18,-2,21
Amkar,8300,10,4,4,12,9,26,-17,16
Anzhi,8300,11,3,5,12,16,43,-27,14
Loko Moscow,8301,1,12,5,3,33,14,19,41
CSKA Moscow,8301,2,11,3,6,26,19,7,36
Spart Moscow,8301,3,9,7,4,38,29,9,34
Krasnodar,8301,4,9,5,6,30,25,5,32
Zenit,8301,5,7,8,5,21,17,4,29
Terek Grozny,8301,6,8,5,7,23,24,-1,29
Din Moscow,8301,7,6,7,7,19,22,-3,25
FK Rubin,8301,8,5,6,9,21,18,3,21
Rostov,8301,9,4,7,9,11,18,-7,19
Anzhi,8301,10,4,5,11,18,38,-20,17
Amkar,8301,11,4,4,12,11,27,-16,16
Loko Moscow,8302,1,11,6,3,31,14,17,39
CSKA Moscow,8302,2,11,4,5,29,18,11,37
Krasnodar,8302,3,9,5,6,32,28,4,32
Zenit,8302,4,7,10,3,21,13,8,31
Terek Grozny,8302,5,8,6,6,23,23,0,30
Spart Moscow,8302,6,8,5,7,36,32,4,29
Din Moscow,8302,7,7,6,7,21,22,-1,27
FK Rubin,8302,8,5,6,9,23,21,2,21
Rostov,8302,9,5,6,9,13,19,-6,21
Amkar,8302,10,5,5,10,12,23,-11,20
Anzhi,8302,11,2,5,13,15,43,-28,11
Loko Moscow,8303,1,12,5,3,31,14,17,41
CSKA Moscow,8303,2,12,3,5,35,18,17,39
Spart Moscow,8303,3,10,6,4,37,26,11,36
Krasnodar,8303,4,10,4,6,31,25,6,34
Zenit,8303,5,7,8,5,23,17,6,29
Terek Grozny,8303,6,7,6,7,21,24,-3,27
Din Moscow,8303,7,6,6,8,18,22,-4,24
FK Rubin,8303,8,5,5,10,22,20,2,20
Amkar,8303,9,5,5,10,11,23,-12,20
Rostov,8303,10,4,6,10,10,19,-9,18
Anzhi,8303,11,2,6,12,15,46,-31,12
Loko Moscow,8304,1,12,6,2,32,13,19,42
CSKA Moscow,8304,2,12,3,5,32,17,15,39
Spart Moscow,8304,3,10,5,5,41,27,14,35
Zenit,8304,4,7,9,4,23,18,5,30
Terek Grozny,8304,5,8,5,7,21,25,-4,29
Krasnodar,8304,6,8,4,8,28,27,1,28
Din Moscow,8304,7,6,6,8,19,26,-7,24
FK Rubin,8304,8,6,5,9,24,20,4,23
Amkar,8304,9,5,4,11,11,24,-13,19
Rostov,8304,10,4,6,10,10,20,-10,18
Anzhi,8304,11,3,5,12,17,41,-24,14
Loko Moscow,8305,1,12,5,3,30,12,18,41
Spart Moscow,8305,2,9,6,5,37,28,9,33
CSKA Moscow,8305,3,10,3,7,29,26,3,33
Zenit,8305,4,8,8,4,26,16,10,32
Krasnodar,8305,5,9,5,6,28,24,4,32
Terek Grozny,8305,6,7,5,8,23,28,-5,26
FK Rubin,8305,7,5,7,8,22,18,4,22
Din Moscow,8305,8,5,7,8,19,25,-6,22
Amkar,8305,9,6,4,10,13,24,-11,22
Rostov,8305,10,4,7,9,10,17,-7,19
Anzhi,8305,11,4,5,11,22,41,-19,17
Loko Moscow,8306,1,12,5,3,30,15,15,41
CSKA Moscow,8306,2,10,4,6,26,19,7,34
Spart Moscow,8306,3,9,6,5,38,31,7,33
Zenit,8306,4,8,8,4,23,15,8,32
Krasnodar,8306,5,9,5,6,31,24,7,32
Terek Grozny,8306,6,8,5,7,25,25,0,29
Din Moscow,8306,7,6,7,7,22,23,-1,25
FK Rubin,8306,8,5,7,8,22,18,4,22
Rostov,8306,9,4,7,9,11,18,-7,19
Amkar,8306,10,4,4,12,10,28,-18,16
Anzhi,8306,11,3,6,11,17,39,-22,15
Loko Moscow,8307,1,12,5,3,32,13,19,41
CSKA Moscow,8307,2,11,3,6,27,18,9,36
Spart Moscow,8307,3,10,5,5,38,27,11,35
Zenit,8307,4,9,8,3,24,14,10,35
Krasnodar,8307,5,8,5,7,27,26,1,29
Terek Grozny,8307,6,7,5,8,20,27,-7,26
Din Moscow,8307,7,6,6,8,18,23,-5,24
Amkar,8307,8,6,4,10,13,23,-10,22
FK Rubin,8307,9,5,6,9,21,18,3,21
Rostov,8307,10,4,6,10,10,19,-9,18
Anzhi,8307,11,3,5,12,17,39,-22,14
Loko Moscow,8308,1,13,5,2,32,12,20,44
CSKA Moscow,8308,2,10,4,6,26,19,7,34
Zenit,8308,3,8,8,4,24,16,8,32
Spart Moscow,8308,4,9,5,6,35,30,5,32
Krasnodar,8308,5,9,4,7,30,25,5,31
Terek Grozny,8308,6,8,6,6,22,23,-1,30
Din Moscow,8308,7,7,6,7,22,22,0,27
FK Rubin,8308,8,5,5,10,21,22,-1,20
Amkar,8308,9,5,5,10,11,22,-11,20
Rostov,8308,10,4,6,10,10,18,-8,18
Anzhi,8308,11,2,6,12,15,39,-24,12
Loko Moscow,8309,1,12,6,2,33,14,19,42
Spart Moscow,8309,2,11,5,4,40,25,15,38
CSKA Moscow,8309,3,11,4,5,27,18,9,37
Krasnodar,8309,4,9,4,7,31,28,3,31
Zenit,8309,5,7,9,4,23,16,7,30
Terek Grozny,8309,6,8,5,7,25,25,0,29
Din Moscow,8309,7,5,7,8,18,24,-6,22
FK Rubin,8309,8,5,6,9,23,20,3,21
Amkar,8309,9,5,4,11,11,24,-13,19
Rostov,8309,10,4,6,10,10,21,-11,18
Anzhi,8309,11,2,6,12,15,41,-26,12
Loko Moscow,8310,1,11,6,3,29,12,17,39
Spart Moscow,8310,2,11,5,4,40,27,13,38
CSKA Moscow,8310,3,11,3,6,27,18,9,36
Zenit,8310,4,9,8,3,23,13,10,35
Krasnodar,8310,5,8,5,7,28,26,2,29
Terek Grozny,8310,6,7,7,6,21,23,-2,28
Din Moscow,8310,7,6,6,8,19,23,-4,24
FK Rubin,8310,8,6,5,9,23,19,4,23
Rostov,8310,9,4,6,10,10,19,-9,18
Amkar,8310,10,4,5,11,11,26,-15,17
Anzhi,8310,11,2,6,12,14,39,-25,12
Loko Moscow,8311,1,12,6,2,34,13,21,42
CSKA Moscow,8311,2,10,5,5,27,19,8,35
Spart Moscow,8311,3,9,6,5,37,26,11,33
Zenit,8311,4,7,9,4,24,19,5,30
Krasnodar,8311,5,8,6,6,28,25,3,30
Terek Grozny,8311,6,8,6,6,24,25,-1,30
Din Moscow,8311,7,6,6,8,20,27,-7,24
FK Rubin,8311,8,5,6,9,23,20,3,21
Rostov,8311,9,4,7,9,10,17,-7,19
Amkar,8311,10,5,4,11,11,24,-13,19
Anzhi,8311,11,2,7,11,16,39,-23,13
Loko Moscow,8312,1,13,5,2,32,12,20,44
CSKA Moscow,8312,2,11,4,5,27,17,10,37
Spart Moscow,8312,3,8,8,4,36,28,8,32
Terek Grozny,8312,4,9,5,6,24,23,1,32
Krasnodar,8312,5,9,4,7,32,26,6,31
Zenit,8312,6,7,8,5,21,16,5,29
Din Moscow,8312,7,6,7,7,20,22,-2,25
FK Rubin,8312,8,5,5,10,22,24,-2,20
Rostov,8312,9,4,7,9,12,19,-7,19
Amkar,8312,10,4,5,11,11,26,-15,17
Anzhi,8312,11,2,6,12,14,38,-24,12
Loko Moscow,8313,1,13,5,2,36,13,23,44
Spart Moscow,8313,2,10,5,5,37,29,8,35
CSKA Moscow,8313,3,10,5,5,27,19,8,35
Terek Grozny,8313,4,9,5,6,22,22,0,32
Zenit,8313,5,7,9,4,23,18,5,30
Krasnodar,8313,6,8,4,8,29,29,0,28
FK Rubin,8313,7,6,6,8,23,18,5,24
Din Moscow,8313,8,5,7,8,18,24,-6,22
Amkar,8313,9,5,4,11,13,24,-11,19
Rostov,8313,10,4,6,10,10,18,-8,18
Anzhi,8313,11,2,6,12,14,38,-24,12
Loko Moscow,8314,1,13,5,2,33,12,21,44
CSKA Moscow,8314,2,10,5,5,27,19,8,35
Spart Moscow,8314,3,9,6,5,35,28,7,33
Krasnodar,8314,4,9,4,7,29,26,3,31
Zenit,8314,5,7,9,4,23,17,6,30
Terek Grozny,8314,6,8,5,7,23,26,-3,29
Din Moscow,8314,7,6,7,7,20,22,-2,25
FK Rubin,8314,8,5,5,10,21,20,1,20
Amkar,8314,9,5,4,11,11,24,-13,19
Rostov,8314,10,4,6,10,10,18,-8,18
Anzhi,8314,11,3,6,11,18,38,-20,15
Loko Moscow,8315,1,11,7,2,29,11,18,40
Spart Moscow,8315,2,10,6,4,38,26,12,36
CSKA Moscow,8315,3,11,3,6,27,19,8,36
Zenit,8315,4,8,9,3,23,14,9,33
Krasnodar,8315,5,8,6,6,28,25,3,30
Terek Grozny,8315,6,8,5,7,22,24,-2,29
FK Rubin,8315,7,6,6,8,25,18,7,24
Din Moscow,8315,8,5,6,9,18,27,-9,21
Rostov,8315,9,4,7,9,10,17,-7,19
Amkar,8315,10,5,4,11,11,24,-13,19
Anzhi,8315,11,2,5,13,14,40,-26,11
Loko Moscow,8316,1,12,5,3,33,13,20,41
Spart Moscow,8316,2,11,5,4,40,27,13,38
CSKA Moscow,8316,3,11,4,5,26,17,9,37
Zenit,8316,4,8,9,3,22,13,9,33
Terek Grozny,8316,5,8,6,6,22,23,-1,30
Krasnodar,8316,6,8,4,8,29,30,-1,28
FK Rubin,8316,7,7,5,8,25,19,6,26
Din Moscow,8316,8,5,6,9,18,24,-6,21
Rostov,8316,9,4,6,10,11,21,-10,18
Amkar,8316,10,4,4,12,11,26,-15,16
Anzhi,8316,11,2,6,12,14,38,-24,12
Loko Moscow,8317,1,12,5,3,31,13,18,41
CSKA Moscow,8317,2,11,3,6,29,20,9,36
Spart Moscow,8317,3,10,5,5,40,28,12,35
Zenit,8317,4,8,8,4,23,15,8,32
Krasnodar,8317,5,9,5,6,31,27,4,32
Terek Grozny,8317,6,7,6,7,20,24,-4,27
Din Moscow,8317,7,6,6,8,20,25,-5,24
Amkar,8317,8,6,4,10,13,23,-10,22
FK Rubin,8317,9,5,6,9,23,21,2,21
Rostov,8317,10,4,6,10,10,19,-9,18
Anzhi,8317,11,2,6,12,15,40,-25,12
Loko Moscow,8318,1,12,5,3,30,14,16,41
CSKA Moscow,8318,2,10,5,5,28,20,8,35
Krasnodar,8318,3,10,4,6,32,24,8,34
Spart Moscow,8318,4,9,6,5,37,30,7,33
Terek Grozny,8318,5,9,5,6,23,23,0,32
Zenit,8318,6,7,9,4,22,15,7,30
Din Moscow,8318,7,5,8,7,18,22,-4,23
FK Rubin,8318,8,5,6,9,22,20,2,21
Amkar,8318,9,5,4,11,12,24,-12,19
Rostov,8318,10,4,6,10,12,20,-8,18
Anzhi,8318,11,2,6,12,17,41,-24,12
Loko Moscow,8319,1,13,5,2,33,13,20,44
CSKA Moscow,8319,2,12,3,5,29,18,11,39
Spart Moscow,8319,3,11,5,4,41,27,14,38
Krasnodar,8319,4,9,4,7,31,27,4,31
Terek Grozny,8319,5,8,6,6,24,23,1,30
Zenit,8319,6,7,8,5,23,18,5,29
FK Rubin,8319,7,6,5,9,25,22,3,23
Din Moscow,8319,8,5,6,9,20,26,-6,21
Rostov,8319,9,4,6,10,10,20,-10,18
Amkar,8319,10,4,4,12,10,28,-18,16
Anzhi,8319,11,2,6,12,15,39,-24,12
Loko Moscow,8320,1,11,5,4,30,15,15,38
CSKA Moscow,8320,2,11,3,6,29,21,8,36
Zenit,8320,3,9,8,3,26,15,11,35
Spart Moscow,8320,4,10,5,5,36,29,7,35
Krasnodar,8320,5,10,4,6,31,25,6,34
Terek Grozny,8320,6,8,6,6,24,24,0,30
Din Moscow,8320,7,6,6,8,18,22,-4,24
FK Rubin,8320,8,5,5,10,22,20,2,20
Amkar,8320,9,5,5,10,14,24,-10,20
Rostov,8320,10,4,6,10,11,19,-8,18
Anzhi,8320,11,2,5,13,15,42,-27,11
Loko Moscow,8321,1,11,6,3,30,15,15,39
CSKA Moscow,8321,2,11,3,6,28,19,9,36
Krasnodar,8321,3,10,4,6,34,27,7,34
Zenit,8321,4,8,9,3,22,13,9,33
Spart Moscow,8321,5,9,6,5,36,28,8,33
Terek Grozny,8321,6,8,6,6,24,23,1,30
Din Moscow,8321,7,6,6,8,20,22,-2,24
Rostov,8321,8,5,6,9,11,17,-6,21
FK Rubin,8321,9,5,5,10,23,23,0,20
Amkar,8321,10,4,6,10,12,25,-13,18
Anzhi,8321,11,2,5,13,15,43,-28,11
Loko Moscow,8322,1,12,6,2,33,12,21,42
CSKA Moscow,8322,2,11,3,6,26,20,6,36
Zenit,8322,3,8,8,4,24,16,8,32
Spart Moscow,8322,4,8,6,6,33,29,4,30
Krasnodar,8322,5,8,6,6,30,27,3,30
Terek Grozny,8322,6,7,5,8,20,25,-5,26
Din Moscow,8322,7,6,7,7,19,21,-2,25
FK Rubin,8322,8,5,7,8,23,19,4,22
Amkar,8322,9,6,4,10,13,22,-9,22
Rostov,8322,10,4,7,9,10,17,-7,19
Anzhi,8322,11,3,5,12,15,38,-23,14
Loko Moscow,8323,1,12,6,2,31,12,19,42
CSKA Moscow,8323,2,12,3,5,29,18,11,39
Spart Moscow,8323,3,8,7,5,36,29,7,31
Krasnodar,8323,4,9,4,7,31,26,5,31
Zenit,8323,5,7,9,4,21,14,7,30
Terek Grozny,8323,6,7,5,8,22,27,-5,26
Din Moscow,8323,7,6,6,8,19,23,-4,24
FK Rubin,8323,8,6,5,9,22,20,2,23
Amkar,8323,9,5,5,10,13,24,-11,20
Rostov,8323,10,4,7,9,11,18,-7,19
Anzhi,8323,11,3,5,12,17,41,-24,14
Loko Moscow,8324,1,13,5,2,32,12,20,44
CSKA Moscow,8324,2,11,3,6,27,18,9,36
Zenit,8324,3,8,8,4,23,15,8,32
Krasnodar,8324,4,9,4,7,28,25,3,31
Spart Moscow,8324,5,8,6,6,35,31,4,30
Terek Grozny,8324,6,7,5,8,21,27,-6,26
Din Moscow,8324,7,6,7,7,21,24,-3,25
Amkar,8324,8,6,4,10,13,23,-10,22
Rostov,8324,9,5,6,9,12,17,-5,21
FK Rubin,8324,10,5,5,10,22,20,2,20
Anzhi,8324,11,3,5,12,17,39,-22,14
Loko Moscow,8325,1,11,6,3,32,15,17,39
Spart Moscow,8325,2,11,5,4,41,25,16,38
CSKA Moscow,8325,3,11,3,6,27,20,7,36
Zenit,8325,4,9,8,3,26,14,12,35
Krasnodar,8325,5,8,5,7,29,28,1,29
Terek Grozny,8325,6,7,5,8,20,24,-4,26
FK Rubin,8325,7,6,6,8,24,18,6,24
Din Moscow,8325,8,5,7,8,18,26,-8,22
Amkar,8325,9,5,4,11,10,23,-13,19
Rostov,8325,10,4,6,10,10,20,-10,18
Anzhi,8325,11,3,5,12,15,39,-24,14
Loko Moscow,8326,1,12,5,3,31,13,18,41
Spart Moscow,8326,2,10,6,4,39,26,13,36
CSKA Moscow,8326,3,11,3,6,26,18,8,36
Zenit,8326,4,8,8,4,23,15,8,32
Krasnodar,8326,5,9,5,6,30,26,4,32
Terek Grozny,8326,6,7,5,8,21,25,-4,26
FK Rubin,8326,7,5,7,8,24,20,4,22
Din Moscow,8326,8,5,7,8,18,24,-6,22
Rostov,8326,9,4,7,9,10,17,-7,19
Amkar,8326,10,5,4,11,11,26,-15,19
Anzhi,8326,11,3,5,12,16,39,-23,14
Loko Moscow,8327,1,13,5,2,32,11,21,44
Spart Moscow,8327,2,10,6,4,41,28,13,36
CSKA Moscow,8327,3,11,3,6,28,19,9,36
Zenit,8327,4,8,8,4,23,14,9,32
Krasnodar,8327,5,9,4,7,30,26,4,31
Terek Grozny,8327,6,8,6,6,23,24,-1,30
FK Rubin,8327,7,6,5,9,24,21,3,23
Din Moscow,8327,8,5,6,9,19,27,-8,21
Rostov,8327,9,4,7,9,11,18,-7,19
Amkar,8327,10,4,5,11,11,27,-16,17
Anzhi,8327,11,2,5,13,15,42,-27,11
Loko Moscow,8328,1,12,6,2,32,12,20,42
Spart Moscow,8328,2,11,5,4,40,27,13,38
CSKA Moscow,8328,3,11,4,5,28,19,9,37
Krasnodar,8328,4,9,5,6,30,25,5,32
Zenit,8328,5,7,9,4,23,17,6,30
Terek Grozny,8328,6,7,7,6,21,23,-2,28
Din Moscow,8328,7,5,7,8,17,23,-6,22
FK Rubin,8328,8,5,6,9,21,19,2,21
Rostov,8328,9,4,6,10,11,20,-9,18
Amkar,8328,10,4,5,11,11,25,-14,17
Anzhi,8328,11,2,6,12,14,38,-24,12
Loko Moscow,8329,1,11,6,3,30,13,17,39
Spart Moscow,8329,2,11,5,4,41,28,13,38
CSKA Moscow,8329,3,11,4,5,30,20,10,37
Zenit,8329,4,7,10,3,24,16,8,31
Krasnodar,8329,5,9,4,7,28,26,2,31
Terek Grozny,8329,6,7,5,8,22,26,-4,26
Din Moscow,8329,7,6,6,8,19,24,-5,24
FK Rubin,8329,8,6,5,9,23,18,5,23
Amkar,8329,9,5,4,11,11,25,-14,19
Rostov,8329,10,4,6,10,11,19,-8,18
Anzhi,8329,11,3,5,12,18,42,-24,14
Loko Moscow,8330,1,12,5,3,31,12,19,41
CSKA Moscow,8330,2,11,3,6,28,19,9,36
Spart Moscow,8330,3,9,6,5,42,31,11,33
Zenit,8330,4,8,8,4,23,15,8,32
Krasnodar,8330,5,9,5,6,29,25,4,32
Terek Grozny,8330,6,7,6,7,20,25,-5,27
Din Moscow,8330,7,6,7,7,21,24,-3,25
FK Rubin,8330,8,5,6,9,23,20,3,21
Amkar,8330,9,5,5,10,12,24,-12,20
Rostov,8330,10,4,6,10,11,22,-11,18
Anzhi,8330,11,3,5,12,17,40,-23,14
Loko Moscow,8331,1,11,6,3,30,14,16,39
CSKA Moscow,8331,2,11,4,5,30,19,11,37
Zenit,8331,3,8,9,3,25,15,10,33
Krasnodar,8331,4,9,5,6,31,27,4,32
Spart Moscow,8331,5,8,7,5,36,29,7,31
Terek Grozny,8331,6,8,5,7,22,24,-2,29
Din Moscow,8331,7,7,6,7,21,23,-2,27
FK Rubin,8331,8,5,5,10,23,21,2,20
Rostov,8331,9,4,7,9,11,18,-7,19
Amkar,8331,10,4,5,11,9,23,-14,17
Anzhi,8331,11,3,5,12,16,41,-25,14
Loko Moscow,8332,1,11,6,3,29,13,16,39
Spart Moscow,8332,2,10,6,4,39,27,12,36
CSKA Moscow,8332,3,11,3,6,27,19,8,36
Krasnodar,8332,4,10,4,6,31,25,6,34
Zenit,8332,5,7,9,4,22,15,7,30
Terek Grozny,8332,6,7,7,6,21,23,-2,28
Din Moscow,8332,7,5,8,7,19,23,-4,23
FK Rubin,8332,8,5,6,9,23,20,3,21
Rostov,8332,9,4,6,10,10,19,-9,18
Amkar,8332,10,4,5,11,10,25,-15,17
Anzhi,8332,11,3,6,11,16,38,-22,15
Loko Moscow,8333,1,12,6,2,32,12,20,42
Spart Moscow,8333,2,11,5,4,42,27,15,38
CSKA Moscow,8333,3,11,3,6,29,18,11,36
Zenit,8333,4,8,9,3,23,14,9,33
Terek Grozny,8333,5,8,5,7,22,24,-2,29
Krasnodar,8333,6,8,4,8,27,27,0,28
Din Moscow,8333,7,6,6,8,20,26,-6,24
FK Rubin,8333,8,6,5,9,23,19,4,23
Amkar,8333,9,5,4,11,11,25,-14,19
Rostov,8333,10,4,6,10,10,19,-9,18
Anzhi,8333,11,2,5,13,15,43,-28,11
Loko Moscow,8334,1,11,5,4,31,15,16,38
CSKA Moscow,8334,2,11,3,6,29,20,9,36
Zenit,8334,3,9,8,3,24,13,11,35
Spart Moscow,8334,4,8,7,5,37,30,7,31
Krasnodar,8334,5,9,4,7,32,30,2,31
Terek Grozny,8334,6,8,5,7,22,25,-3,29
Din Moscow,8334,7,7,6,7,22,23,-1,27
FK Rubin,8334,8,6,5,9,26,22,4,23
Rostov,8334,9,4,7,9,11,18,-7,19
Amkar,8334,10,4,5,11,11,25,-14,17
Anzhi,8334,11,3,5,12,18,42,-24,14
Loko Moscow,8335,1,11,5,4,30,15,15,38
CSKA Moscow,8335,2,11,3,6,26,19,7,36
Zenit,8335,3,9,8,3,25,13,12,35
Krasnodar,8335,4,9,5,6,30,26,4,32
Spart Moscow,8335,5,8,7,5,35,28,7,31
Terek Grozny,8335,6,8,6,6,23,24,-1,30
FK Rubin,8335,7,6,6,8,25,20,5,24
Din Moscow,8335,8,5,7,8,20,25,-5,22
Amkar,8335,9,5,5,10,11,23,-12,20
Rostov,8335,10,4,7,9,11,18,-7,19
Anzhi,8335,11,2,5,13,15,40,-25,11
Loko Moscow,8336,1,13,5,2,33,11,22,44
CSKA Moscow,8336,2,11,3,6,28,22,6,36
Spart Moscow,8336,3,10,5,5,38,28,10,35
Zenit,8336,4,8,8,4,25,15,10,32
Terek Grozny,8336,5,9,5,6,26,22,4,32
Krasnodar,8336,6,8,4,8,27,28,-1,28
Din Moscow,8336,7,6,6,8,19,23,-4,24
FK Rubin,8336,8,6,5,9,22,19,3,23
Amkar,8336,9,5,4,11,12,25,-13,19
Rostov,8336,10,4,6,10,10,19,-9,18
Anzhi,8336,11,2,5,13,15,43,-28,11
Loko Moscow,8337,1,12,5,3,32,15,17,41
CSKA Moscow,8337,2,11,3,6,27,21,6,36
Krasnodar,8337,3,10,4,6,33,26,7,34
Terek Grozny,8337,4,8,6,6,23,22,1,30
Zenit,8337,5,7,8,5,21,16,5,29
Spart Moscow,8337,6,8,5,7,36,33,3,29
Din Moscow,8337,7,7,6,7,20,21,-1,27
Rostov,8337,8,5,6,9,14,19,-5,21
FK Rubin,8337,9,5,5,10,22,20,2,20
Amkar,8337,10,5,5,10,11,23,-12,20
Anzhi,8337,11,3,5,12,18,41,-23,14
Loko Moscow,8338,1,11,6,3,32,15,17,39
Spart Moscow,8338,2,11,5,4,39,26,13,38
CSKA Moscow,8338,3,11,3,6,27,19,8,36
Krasnodar,8338,4,9,5,6,29,25,4,32
Zenit,8338,5,7,9,4,24,18,6,30
Terek Grozny,8338,6,8,5,7,23,25,-2,29
FK Rubin,8338,7,6,6,8,23,18,5,24
Din Moscow,8338,8,5,6,9,17,24,-7,21
Rostov,8338,9,4,6,10,10,19,-9,18
Anzhi,8338,10,4,5,11,18,38,-20,17
Amkar,8338,11,4,4,12,11,26,-15,16
Loko Moscow,8339,1,13,5,2,32,11,21,44
CSKA Moscow,8339,2,10,4,6,27,20,7,34
Spart Moscow,8339,3,9,6,5,37,29,8,33
Zenit,8339,4,7,9,4,22,16,6,30
Krasnodar,8339,5,8,5,7,27,25,2,29
Terek Grozny,8339,6,7,6,7,22,25,-3,27
FK Rubin,8339,7,6,6,8,23,17,6,24
Din Moscow,8339,8,6,6,8,19,24,-5,24
Rostov,8339,9,4,7,9,12,19,-7,19
Amkar,8339,10,5,4,11,11,24,-13,19
Anzhi,8339,11,3,6,11,17,39,-22,15
CSKA Moscow,8340,1,12,3,5,31,19,12,39
Loko Moscow,8340,2,11,5,4,30,14,16,38
Krasnodar,8340,3,10,4,6,34,26,8,34
Spart Moscow,8340,4,9,5,6,36,29,7,32
Zenit,8340,5,8,8,4,22,15,7,32
Terek Grozny,8340,6,8,6,6,25,25,0,30
Din Moscow,8340,7,7,6,7,21,23,-2,27
FK Rubin,8340,8,5,5,10,23,24,-1,20
Amkar,8340,9,5,4,11,12,26,-14,19
Rostov,8340,10,4,6,10,10,18,-8,18
Anzhi,8340,11,2,6,12,18,43,-25,12
Loko Moscow,8341,1,12,5,3,30,13,17,41
Spart Moscow,8341,2,11,5,4,39,27,12,38
CSKA Moscow,8341,3,11,3,6,27,20,7,36
Zenit,8341,4,9,8,3,25,13,12,35
Krasnodar,8341,5,9,4,7,30,25,5,31
Terek Grozny,8341,6,8,5,7,23,24,-1,29
Din Moscow,8341,7,5,7,8,19,24,-5,22
FK Rubin,8341,8,5,6,9,22,21,1,21
Rostov,8341,9,4,6,10,11,19,-8,18
Amkar,8341,10,4,4,12,10,27,-17,16
Anzhi,8341,11,3,5,12,16,39,-23,14
Loko Moscow,8342,1,12,5,3,31,13,18,41
Spart Moscow,8342,2,10,6,4,38,26,12,36
CSKA Moscow,8342,3,11,3,6,30,21,9,36
Krasnodar,8342,4,10,4,6,31,25,6,34
Zenit,8342,5,8,8,4,24,15,9,32
Terek Grozny,8342,6,8,5,7,22,24,-2,29
FK Rubin,8342,7,6,5,9,22,19,3,23
Din Moscow,8342,8,5,7,8,18,23,-5,22
Amkar,8342,9,5,4,11,10,25,-15,19
Rostov,8342,10,4,6,10,10,18,-8,18
Anzhi,8342,11,2,5,13,16,43,-27,11
Loko Moscow,8343,1,11,6,3,30,13,17,39
CSKA Moscow,8343,2,12,3,5,27,17,10,39
Spart Moscow,8343,3,9,5,6,34,28,6,32
Krasnodar,8343,4,9,5,6,31,27,4,32
Zenit,8343,5,7,9,4,21,14,7,30
Terek Grozny,8343,6,8,5,7,25,23,2,29
FK Rubin,8343,7,5,7,8,24,20,4,22
Din Moscow,8343,8,5,7,8,18,23,-5,22
Amkar,8343,9,6,4,10,11,22,-11,22
Rostov,8343,10,5,6,9,12,17,-5,21
Anzhi,8343,11,2,5,13,14,43,-29,11
Loko Moscow,8344,1,12,5,3,34,16,18,41
CSKA Moscow,8344,2,11,4,5,31,20,11,37
Spart Moscow,8344,3,10,5,5,39,28,11,35
Krasnodar,8344,4,9,5,6,32,26,6,32
Zenit,8344,5,7,9,4,24,19,5,30
Terek Grozny,8344,6,8,5,7,23,25,-2,29
Din Moscow,8344,7,6,7,7,20,23,-3,25
FK Rubin,8344,8,5,7,8,24,20,4,22
Amkar,8344,9,5,4,11,11,26,-15,19
Rostov,8344,10,4,6,10,12,20,-8,18
Anzhi,8344,11,2,5,13,16,43,-27,11
Loko Moscow,8345,1,11,5,4,29,14,15,38
Spart Moscow,8345,2,10,6,4,37,27,10,36
CSKA Moscow,8345,3,11,3,6,26,18,8,36
Zenit,8345,4,9,8,3,23,13,10,35
Krasnodar,8345,5,9,5,6,30,25,5,32
Terek Grozny,8345,6,8,6,6,22,23,-1,30
FK Rubin,8345,7,6,6,8,24,19,5,24
Din Moscow,8345,8,5,7,8,19,24,-5,22
Rostov,8345,9,4,6,10,11,19,-8,18
Amkar,8345,10,4,4,12,9,24,-15,16
Anzhi,8345,11,2,6,12,15,39,-24,12
Loko Moscow,8346,1,11,7,2,31,13,18,40
Spart Moscow,8346,2,10,5,5,40,28,12,35
CSKA Moscow,8346,3,10,4,6,25,18,7,34
Zenit,8346,4,8,9,3,23,14,9,33
Krasnodar,8346,5,8,6,6,28,25,3,30
Terek Grozny,8346,6,7,7,6,22,24,-2,28
Din Moscow,8346,7,6,6,8,18,25,-7,24
FK Rubin,8346,8,5,6,9,21,18,3,21
Amkar,8346,9,5,5,10,12,23,-11,20
Rostov,8346,10,4,6,10,10,19,-9,18
Anzhi,8346,11,2,7,11,16,39,-23,13
Loko Moscow,8347,1,11,6,3,30,13,17,39
CSKA Moscow,8347,2,11,3,6,27,19,8,36
Spart Moscow,8347,3,10,5,5,37,29,8,35
Krasnodar,8347,4,10,4,6,29,24,5,34
Zenit,8347,5,8,9,3,23,14,9,33
Terek Grozny,8347,6,7,6,7,22,25,-3,27
Din Moscow,8347,7,6,6,8,20,24,-4,24
Amkar,8347,8,6,4,10,14,24,-10,22
FK Rubin,8347,9,5,5,10,21,19,2,20
Rostov,8347,10,4,6,10,10,18,-8,18
Anzhi,8347,11,2,6,12,15,39,-24,12
Loko Moscow,8348,1,12,5,3,30,13,17,41
CSKA Moscow,8348,2,11,3,6,27,18,9,36
Spart Moscow,8348,3,8,8,4,36,28,8,32
Zenit,8348,4,8,8,4,22,14,8,32
Krasnodar,8348,5,9,4,7,29,26,3,31
Terek Grozny,8348,6,8,6,6,22,23,-1,30
FK Rubin,8348,7,6,6,8,25,19,6,24
Din Moscow,8348,8,5,8,7,20,24,-4,23
Rostov,8348,9,4,7,9,10,17,-7,19
Amkar,8348,10,4,5,11,12,26,-14,17
Anzhi,8348,11,2,6,12,14,39,-25,12
Loko Moscow,8349,1,13,5,2,34,12,22,44
Spart Moscow,8349,2,9,7,4,36,26,10,34
CSKA Moscow,8349,3,10,4,6,25,20,5,34
Zenit,8349,4,8,8,4,24,15,9,32
Terek Grozny,8349,5,9,5,6,24,24,0,32
Krasnodar,8349,6,8,4,8,28,28,0,28
FK Rubin,8349,7,6,6,8,22,17,5,24
Din Moscow,8349,8,5,8,7,17,21,-4,23
Rostov,8349,9,4,7,9,10,17,-7,19
Amkar,8349,10,4,4,12,10,26,-16,16
Anzhi,8349,11,2,6,12,16,40,-24,12
Loko Moscow,8350,1,13,5,2,33,13,20,44
Spart Moscow,8350,2,11,5,4,39,25,14,38
CSKA Moscow,8350,3,11,3,6,30,19,11,36
Zenit,8350,4,8,8,4,24,16,8,32
Terek Grozny,8350,5,8,5,7,23,26,-3,29
Krasnodar,8350,6,8,4,8,29,28,1,28
FK Rubin,8350,7,6,6,8,24,19,5,24
Din Moscow,8350,8,5,7,8,18,25,-7,22
Amkar,8350,9,5,4,11,11,24,-13,19
Rostov,8350,10,4,6,10,10,18,-8,18
Anzhi,8350,11,2,5,13,16,44,-28,11
Loko Moscow,8351,1,13,5,2,35,12,23,44
CSKA Moscow,8351,2,11,3,6,29,19,10,36
Spart Moscow,8351,3,9,5,6,37,30,7,32
Zenit,8351,4,8,8,4,24,19,5,32
Krasnodar,8351,5,9,4,7,29,25,4,31
Terek Grozny,8351,6,8,5,7,23,23,0,29
Din Moscow,8351,7,5,7,8,19,25,-6,22
FK Rubin,8351,8,5,6,9,22,20,2,21
Rostov,8351,9,5,6,9,11,17,-6,21
Amkar,8351,10,5,4,11,12,26,-14,19
Anzhi,8351,11,3,5,12,15,40,-25,14
Loko Moscow,8352,1,12,6,2,31,12,19,42
CSKA Moscow,8352,2,10,4,6,25,19,6,34
Zenit,8352,3,8,9,3,24,14,10,33
Spart Moscow,8352,4,9,5,6,38,32,6,32
Krasnodar,8352,5,8,4,8,27,26,1,28
Terek Grozny,8352,6,7,5,8,20,27,-7,26
Din Moscow,8352,7,6,7,7,22,24,-2,25
FK Rubin,8352,8,6,6,8,23,18,5,24
Rostov,8352,9,5,6,9,12,17,-5,21
Amkar,8352,10,5,4,11,13,25,-12,19
Anzhi,8352,11,3,6,11,16,37,-21,15
Loko Moscow,8353,1,11,5,4,32,16,16,38
CSKA Moscow,8353,2,11,3,6,27,21,6,36
Zenit,8353,3,9,8,3,26,14,12,35
Krasnodar,8353,4,10,4,6,34,27,7,34
Spart Moscow,8353,5,9,6,5,37,29,8,33
Terek Grozny,8353,6,7,6,7,23,26,-3,27
FK Rubin,8353,7,6,5,9,24,22,2,23
Din Moscow,8353,8,5,7,8,19,24,-5,22
Rostov,8353,9,5,6,9,11,17,-6,21
Amkar,8353,10,5,4,11,12,25,-13,19
Anzhi,8353,11,2,6,12,18,42,-24,12
Loko Moscow,8354,1,12,6,2,30,11,19,42
Spart Moscow,8354,2,10,6,4,35,25,10,36
CSKA Moscow,8354,3,11,3,6,28,20,8,36
Zenit,8354,4,8,9,3,24,14,10,33
Krasnodar,8354,5,8,5,7,28,26,2,29
Terek Grozny,8354,6,7,5,8,21,25,-4,26
Din Moscow,8354,7,6,6,8,19,22,-3,24
FK Rubin,8354,8,5,6,9,22,20,2,21
Rostov,8354,9,4,7,9,10,17,-7,19
Amkar,8354,10,5,4,11,10,23,-13,19
Anzhi,8354,11,3,5,12,16,40,-24,14
Loko Moscow,8355,1,12,5,3,30,13,17,41
CSKA Moscow,8355,2,12,3,5,33,17,16,39
Spart Moscow,8355,3,9,6,5,36,28,8,33
Krasnodar,8355,4,9,4,7,29,27,2,31
Zenit,8355,5,7,8,5,21,17,4,29
Terek Grozny,8355,6,7,5,8,20,24,-4,26
Din Moscow,8355,7,6,6,8,18,22,-4,24
FK Rubin,8355,8,6,5,9,24,18,6,23
Rostov,8355,9,5,6,9,12,18,-6,21
Amkar,8355,10,5,5,10,11,23,-12,20
Anzhi,8355,11,3,5,12,15,42,-27,14
Loko Moscow,8356,1,12,6,2,32,13,19,42
CSKA Moscow,8356,2,11,3,6,28,19,9,36
Spart Moscow,8356,3,10,5,5,38,30,8,35
Zenit,8356,4,8,8,4,22,14,8,32
Krasnodar,8356,5,9,5,6,30,26,4,32
Din Moscow,8356,6,7,6,7,24,24,0,27
Terek Grozny,8356,7,7,6,7,21,25,-4,27
FK Rubin,8356,8,5,5,10,22,20,2,20
Amkar,8356,9,5,4,11,12,25,-13,19
Rostov,8356,10,4,6,10,10,18,-8,18
Anzhi,8356,11,2,6,12,15,40,-25,12
Loko Moscow,8357,1,13,5,2,32,12,20,44
CSKA Moscow,8357,2,12,3,5,32,18,14,39
Spart Moscow,8357,3,9,6,5,37,29,8,33
Zenit,8357,4,7,8,5,21,16,5,29
Krasnodar,8357,5,8,5,7,29,27,2,29
Din Moscow,8357,6,7,6,7,21,23,-2,27
Terek Grozny,8357,7,7,6,7,22,25,-3,27
FK Rubin,8357,8,5,6,9,22,19,3,21
Rostov,8357,9,4,7,9,10,17,-7,19
Amkar,8357,10,5,4,11,12,25,-13,19
Anzhi,8357,11,2,6,12,16,43,-27,12
Loko Moscow,8358,1,13,5,2,35,12,23,44
CSKA Moscow,8358,2,11,3,6,29,21,8,36
Spart Moscow,8358,3,9,7,4,36,27,9,34
Zenit,8358,4,8,8,4,24,17,7,32
Krasnodar,8358,5,9,4,7,31,29,2,31
Terek Grozny,8358,6,7,6,7,22,25,-3,27
Din Moscow,8358,7,6,7,7,20,23,-3,25
FK Rubin,8358,8,5,5,10,22,21,1,20
Rostov,8358,9,4,7,9,10,17,-7,19
Amkar,8358,10,4,5,11,11,25,-14,17
Anzhi,8358,11,3,5,12,16,39,-23,14
Loko Moscow,8359,1,11,6,3,32,15,17,39
CSKA Moscow,8359,2,12,3,5,28,17,11,39
Spart Moscow,8359,3,9,7,4,38,26,12,34
Zenit,8359,4,8,8,4,23,15,8,32
Krasnodar,8359,5,8,6,6,29,26,3,30
Terek Grozny,8359,6,7,7,6,24,26,-2,28
FK Rubin,8359,7,6,6,8,23,18,5,24
Din Moscow,8359,8,5,6,9,18,27,-9,21
Rostov,8359,9,4,7,9,10,17,-7,19
Amkar,8359,10,4,6,10,12,25,-13,18
Anzhi,8359,11,2,6,12,16,41,-25,12
Loko Moscow,8360,1,12,6,2,31,12,19,42
Spart Moscow,8360,2,9,6,5,38,28,10,33
Zenit,8360,3,8,9,3,23,14,9,33
CSKA Moscow,8360,4,10,3,7,26,20,6,33
Krasnodar,8360,5,9,4,7,28,25,3,31
Terek Grozny,8360,6,7,6,7,20,24,-4,27
FK Rubin,8360,7,6,5,9,23,18,5,23
Rostov,8360,8,5,6,9,11,17,-6,21
Din Moscow,8360,9,5,6,9,17,26,-9,21
Amkar,8360,10,4,6,10,11,24,-13,18
Anzhi,8360,11,4,5,11,18,38,-20,17
Loko Moscow,8361,1,11,7,2,30,12,18,40
CSKA Moscow,8361,2,11,3,6,31,19,12,36
Spart Moscow,8361,3,9,6,5,39,28,11,33
Zenit,8361,4,8,9,3,23,14,9,33
Krasnodar,8361,5,8,5,7,29,28,1,29
Terek Grozny,8361,6,7,5,8,21,27,-6,26
FK Rubin,8361,7,6,6,8,25,19,6,24
Din Moscow,8361,8,5,7,8,18,26,-8,22
Rostov,8361,9,5,6,9,12,18,-6,21
Amkar,8361,10,5,5,10,14,24,-10,20
Anzhi,8361,11,3,5,12,15,42,-27,14
Loko Moscow,8362,1,11,6,3,30,14,16,39
CSKA Moscow,8362,2,10,5,5,25,17,8,35
Spart Moscow,8362,3,9,6,5,38,28,10,33
Zenit,8362,4,8,9,3,23,13,10,33
Krasnodar,8362,5,9,5,6,31,26,5,32
Terek Grozny,8362,6,8,6,6,21,22,-1,30
Din Moscow,8362,7,6,7,7,23,24,-1,25
FK Rubin,8362,8,5,5,10,23,24,-1,20
Amkar,8362,9,5,4,11,10,23,-13,19
Rostov,8362,10,4,6,10,10,20,-10,18
Anzhi,8362,11,2,7,11,14,37,-23,13
Loko Moscow,8363,1,12,5,3,30,12,18,41
CSKA Moscow,8363,2,11,4,5,28,18,10,37
Zenit,8363,3,8,9,3,22,13,9,33
Spart Moscow,8363,4,9,5,6,35,27,8,32
Krasnodar,8363,5,9,4,7,29,26,3,31
Terek Grozny,8363,6,7,7,6,23,25,-2,28
Din Moscow,8363,7,7,6,7,20,21,-1,27
FK Rubin,8363,8,5,5,10,22,21,1,20
Amkar,8363,9,5,5,10,10,22,-12,20
Rostov,8363,10,4,6,10,10,19,-9,18
Anzhi,8363,11,2,6,12,18,43,-25,12
Loko Moscow,8364,1,12,5,3,31,13,18,41
CSKA Moscow,8364,2,11,4,5,31,20,11,37
Zenit,8364,3,8,9,3,23,14,9,33
Spart Moscow,8364,4,9,6,5,38,30,8,33
Terek Grozny,8364,5,9,5,6,23,22,1,32
Krasnodar,8364,6,9,4,7,30,27,3,31
Din Moscow,8364,7,6,6,8,22,24,-2,24
Rostov,8364,8,5,6,9,11,17,-6,21
FK Rubin,8364,9,5,5,10,23,23,0,20
Amkar,8364,10,4,5,11,12,27,-15,17
Anzhi,8364,11,2,5,13,16,43,-27,11
Loko Moscow,8365,1,11,6,3,29,13,16,39
Krasnodar,8365,2,10,4,6,33,26,7,34
CSKA Moscow,8365,3,10,4,6,25,19,6,34
Zenit,8365,4,8,9,3,23,13,10,33
Spart Moscow,8365,5,9,5,6,36,29,7,32
Terek Grozny,8365,6,8,5,7,22,23,-1,29
Din Moscow,8365,7,6,6,8,20,23,-3,24
FK Rubin,8365,8,6,5,9,25,22,3,23
Amkar,8365,9,5,4,11,11,25,-14,19
Rostov,8365,10,4,6,10,10,19,-9,18
Anzhi,8365,11,3,6,11,15,37,-22,15
Loko Moscow,8366,1,11,6,3,29,13,16,39
CSKA Moscow,8366,2,11,4,5,28,19,9,37
Spart Moscow,8366,3,10,6,4,38,26,12,36
Krasnodar,8366,4,10,4,6,30,24,6,34
Zenit,8366,5,7,10,3,22,14,8,31
Terek Grozny,8366,6,8,5,7,22,24,-2,29
Din Moscow,8366,7,6,6,8,18,22,-4,24
FK Rubin,8366,8,5,5,10,21,19,2,20
Rostov,8366,9,4,6,10,11,21,-10,18
Amkar,8366,10,4,5,11,9,24,-15,17
Anzhi,8366,11,3,5,12,17,39,-22,14
Loko Moscow,8367,1,12,6,2,32,12,20,42
Spart Moscow,8367,2,10,6,4,39,27,12,36
Zenit,8367,3,8,9,3,26,16,10,33
CSKA Moscow,8367,4,10,3,7,27,22,5,33
Krasnodar,8367,5,9,4,7,29,27,2,31
Terek Grozny,8367,6,7,6,7,22,25,-3,27
Din Moscow,8367,7,6,6,8,21,25,-4,24
FK Rubin,8367,8,5,5,10,24,22,2,20
Rostov,8367,9,4,7,9,11,18,-7,19
Amkar,8367,10,5,4,11,11,26,-15,19
Anzhi,8367,11,3,6,11,16,38,-22,15
Loko Moscow,8368,1,11,6,3,30,14,16,39
Zenit,8368,2,9,8,3,25,13,12,35
Spart Moscow,8368,3,10,5,5,38,28,10,35
CSKA Moscow,8368,4,10,4,6,26,20,6,34
Krasnodar,8368,5,9,5,6,33,26,7,32
Terek Grozny,8368,6,7,5,8,20,24,-4,26
FK Rubin,8368,7,6,5,9,23,22,1,23
Rostov,8368,8,5,6,9,11,17,-6,21
Din Moscow,8368,9,5,6,9,17,24,-7,21
Amkar,8368,10,5,4,11,12,25,-13,19
Anzhi,8368,11,3,6,11,16,38,-22,15
Loko Moscow,8369,1,11,6,3,30,17,13,39
CSKA Moscow,8369,2,11,3,6,27,19,8,36
Zenit,8369,3,8,9,3,23,14,9,33
Spart Moscow,8369,4,9,6,5,39,31,8,33
Krasnodar,8369,5,9,5,6,34,26,8,32
Terek Grozny,8369,6,8,6,6,22,23,-1,30
Din Moscow,8369,7,7,6,7,21,22,-1,27
FK Rubin,8369,8,5,6,9,23,20,3,21
Rostov,8369,9,4,7,9,12,19,-7,19
Amkar,8369,10,4,4,12,10,26,-16,16
Anzhi,8369,11,2,6,12,16,40,-24,12
Loko Moscow,8370,1,12,5,3,33,14,19,41
CSKA Moscow,8370,2,11,3,6,28,18,10,36
Zenit,8370,3,8,8,4,22,16,6,32
Spart Moscow,8370,4,8,7,5,35,29,6,31
Krasnodar,8370,5,9,4,7,32,29,3,31
Terek Grozny,8370,6,7,6,7,22,25,-3,27
FK Rubin,8370,7,7,5,8,27,19,8,26
Din Moscow,8370,8,5,7,8,19,25,-6,22
Rostov,8370,9,5,6,9,12,17,-5,21
Amkar,8370,10,4,6,10,10,23,-13,18
Anzhi,8370,11,3,5,12,16,41,-25,14
Loko Moscow,8371,1,11,6,3,33,19,14,39
Spart Moscow,8371,2,10,5,5,42,30,12,35
CSKA Moscow,8371,3,10,4,6,27,20,7,34
Zenit,8371,4,8,9,3,24,15,9,33
Krasnodar,8371,5,9,4,7,34,30,4,31
Terek Grozny,8371,6,8,5,7,23,25,-2,29
FK Rubin,8371,7,7,5,8,29,18,11,26
Din Moscow,8371,8,6,6,8,19,25,-6,24
Rostov,8371,9,4,6,10,11,21,-10,18
Amkar,8371,10,4,4,12,11,29,-18,16
Anzhi,8371,11,3,6,11,19,40,-21,15
Loko Moscow,8372,1,11,6,3,30,13,17,39
Spart Moscow,8372,2,10,6,4,37,26,11,36
CSKA Moscow,8372,3,11,3,6,31,20,11,36
Zenit,8372,4,8,9,3,23,14,9,33
Krasnodar,8372,5,9,5,6,30,26,4,32
Terek Grozny,8372,6,8,5,7,25,23,2,29
FK Rubin,8372,7,5,7,8,22,18,4,22
Din Moscow,8372,8,5,7,8,18,24,-6,22
Rostov,8372,9,4,7,9,10,17,-7,19
Amkar,8372,10,5,4,11,10,23,-13,19
Anzhi,8372,11,2,5,13,15,47,-32,11
Loko Moscow,8373,1,11,7,2,29,11,18,40
CSKA Moscow,8373,2,11,4,5,27,18,9,37
Spart Moscow,8373,3,10,6,4,36,26,10,36
Zenit,8373,4,7,9,4,21,14,7,30
Krasnodar,8373,5,8,5,7,27,25,2,29
Terek Grozny,8373,6,7,5,8,22,26,-4,26
Din Moscow,8373,7,6,6,8,20,24,-4,24
FK Rubin,8373,8,6,5,9,23,19,4,23
Rostov,8373,9,4,7,9,10,17,-7,19
Amkar,8373,10,5,4,11,11,24,-13,19
Anzhi,8373,11,3,6,11,17,39,-22,15
Loko Moscow,8374,1,12,6,2,31,12,19,42
Spart Moscow,8374,2,11,5,4,38,27,11,38
CSKA Moscow,8374,3,11,4,5,28,18,10,37
Zenit,8374,4,7,10,3,22,14,8,31
Krasnodar,8374,5,9,4,7,30,26,4,31
Terek Grozny,8374,6,8,6,6,23,24,-1,30
Din Moscow,8374,7,6,6,8,18,22,-4,24
FK Rubin,8374,8,5,5,10,21,20,1,20
Rostov,8374,9,4,6,10,11,19,-8,18
Amkar,8374,10,4,4,12,10,25,-15,16
Anzhi,8374,11,2,6,12,16,41,-25,12
Loko Moscow,8375,1,12,5,3,33,14,19,41
CSKA Moscow,8375,2,11,3,6,29,19,10,36
Krasnodar,8375,3,10,4,6,30,24,6,34
Spart Moscow,8375,4,9,6,5,37,27,10,33
Zenit,8375,5,8,8,4,25,18,7,32
Terek Grozny,8375,6,8,5,7,22,26,-4,29
Din Moscow,8375,7,5,8,7,18,22,-4,23
FK Rubin,8375,8,5,6,9,21,19,2,21
Rostov,8375,9,5,6,9,11,17,-6,21
Amkar,8375,10,5,4,11,13,25,-12,19
Anzhi,8375,11,2,5,13,14,42,-28,11
Loko Moscow,8376,1,13,5,2,34,11,23,44
CSKA Moscow,8376,2,11,4,5,28,17,11,37
Spart Moscow,8376,3,8,6,6,36,31,5,30
Terek Grozny,8376,4,8,6,6,24,25,-1,30
Zenit,8376,5,7,8,5,21,18,3,29
Krasnodar,8376,6,8,4,8,27,28,-1,28
Din Moscow,8376,7,6,7,7,20,23,-3,25
FK Rubin,8376,8,6,5,9,23,19,4,23
Rostov,8376,9,5,6,9,12,17,-5,21
Amkar,8376,10,5,5,10,14,26,-12,20
Anzhi,8376,11,2,6,12,15,39,-24,12
Loko Moscow,8377,1,11,6,3,29,15,14,39
CSKA Moscow,8377,2,11,3,6,28,20,8,36
Spart Moscow,8377,3,10,5,5,36,29,7,35
Zenit,8377,4,8,9,3,23,14,9,33
Krasnodar,8377,5,9,5,6,33,26,7,32
Din Moscow,8377,6,7,6,7,23,22,1,27
Terek Grozny,8377,7,7,6,7,22,25,-3,27
FK Rubin,8377,8,5,6,9,24,22,2,21
Amkar,8377,9,5,4,11,10,23,-13,19
Rostov,8377,10,4,6,10,11,19,-8,18
Anzhi,8377,11,2,6,12,17,41,-24,12
Loko Moscow,8378,1,12,6,2,30,11,19,42
CSKA Moscow,8378,2,11,3,6,26,19,7,36
Spart Moscow,8378,3,10,5,5,37,28,9,35
Zenit,8378,4,8,8,4,23,14,9,32
Krasnodar,8378,5,8,6,6,28,25,3,30
Terek Grozny,8378,6,8,6,6,24,25,-1,30
FK Rubin,8378,7,6,6,8,23,18,5,24
Din Moscow,8378,8,6,6,8,20,23,-3,24
Rostov,8378,9,4,6,10,10,19,-9,18
Amkar,8378,10,4,5,11,11,25,-14,17
Anzhi,8378,11,2,5,13,15,40,-25,11
Loko Moscow,8379,1,11,5,4,33,17,16,38
Zenit,8379,2,9,8,3,24,14,10,35
Spart Moscow,8379,3,9,7,4,38,27,11,34
CSKA Moscow,8379,4,10,4,6,26,19,7,34
Krasnodar,8379,5,9,5,6,32,28,4,32
Terek Grozny,8379,6,8,5,7,22,23,-1,29
FK Rubin,8379,7,6,6,8,24,19,5,24
Din Moscow,8379,8,5,6,9,18,26,-8,21
Amkar,8379,9,5,5,10,10,22,-12,20
Rostov,8379,10,4,7,9,12,19,-7,19
Anzhi,8379,11,2,6,12,15,40,-25,12
Loko Moscow,8380,1,11,7,2,29,11,18,40
CSKA Moscow,8380,2,11,3,6,29,21,8,36
Zenit,8380,3,8,9,3,24,13,11,33
Krasnodar,8380,4,9,5,6,29,24,5,32
Spart Moscow,8380,5,8,6,6,36,32,4,30
Terek Grozny,8380,6,8,5,7,26,27,-1,29
Din Moscow,8380,7,7,6,7,20,21,-1,27
Amkar,8380,8,6,4,10,16,24,-8,22
FK Rubin,8380,9,5,5,10,21,21,0,20
Rostov,8380,10,4,7,9,12,19,-7,19
Anzhi,8380,11,2,5,13,17,46,-29,11
Loko Moscow,8381,1,13,5,2,34,13,21,44
CSKA Moscow,8381,2,11,3,6,27,19,8,36
Spart Moscow,8381,3,9,5,6,37,29,8,32
Zenit,8381,4,8,8,4,24,17,7,32
Krasnodar,8381,5,9,4,7,29,26,3,31
Terek Grozny,8381,6,8,5,7,21,23,-2,29
Din Moscow,8381,7,6,6,8,21,25,-4,24
Rostov,8381,8,5,6,9,11,17,-6,21
FK Rubin,8381,9,5,5,10,21,21,0,20
Amkar,8381,10,5,4,11,11,23,-12,19
Anzhi,8381,11,3,5,12,15,38,-23,14
Loko Moscow,8382,1,11,7,2,30,12,18,40
Spart Moscow,8382,2,10,6,4,39,29,10,36
CSKA Moscow,8382,3,11,3,6,28,19,9,36
Zenit,8382,4,8,9,3,23,14,9,33
Krasnodar,8382,5,8,5,7,29,28,1,29
Terek Grozny,8382,6,7,6,7,21,24,-3,27
FK Rubin,8382,7,6,6,8,24,18,6,24
Din Moscow,8382,8,5,7,8,18,23,-5,22
Rostov,8382,9,4,6,10,11,19,-8,18
Amkar,8382,10,4,6,10,11,24,-13,18
Anzhi,8382,11,3,5,12,16,40,-24,14
Loko Moscow,8383,1,12,5,3,32,14,18,41
Spart Moscow,8383,2,9,7,4,39,30,9,34
CSKA Moscow,8383,3,10,4,6,26,19,7,34
Krasnodar,8383,4,9,5,6,31,27,4,32
Zenit,8383,5,7,9,4,22,15,7,30
Terek Grozny,8383,6,8,5,7,21,25,-4,29
FK Rubin,8383,7,6,6,8,26,20,6,24
Din Moscow,8383,8,5,7,8,19,25,-6,22
Rostov,8383,9,4,7,9,12,19,-7,19
Amkar,8383,10,5,4,11,14,25,-11,19
Anzhi,8383,11,3,5,12,16,39,-23,14
Loko Moscow,8384,1,11,6,3,30,14,16,39
Spart Moscow,8384,2,10,6,4,36,25,11,36
Zenit,8384,3,9,8,3,24,13,11,35
CSKA Moscow,8384,4,10,4,6,25,18,7,34
Krasnodar,8384,5,8,6,6,29,26,3,30
Terek Grozny,8384,6,7,6,7,24,27,-3,27
Din Moscow,8384,7,5,8,7,19,23,-4,23
FK Rubin,8384,8,5,7,8,24,20,4,22
Amkar,8384,9,5,4,11,12,26,-14,19
Rostov,8384,10,4,6,10,10,18,-8,18
Anzhi,8384,11,2,7,11,16,39,-23,13
Loko Moscow,8385,1,12,6,2,32,13,19,42
CSKA Moscow,8385,2,10,4,6,26,19,7,34
Spart Moscow,8385,3,9,6,5,34,26,8,33
Zenit,8385,4,7,10,3,24,16,8,31
Terek Grozny,8385,5,8,6,6,24,25,-1,30
Krasnodar,8385,6,8,5,7,28,26,2,29
FK Rubin,8385,7,6,6,8,24,19,5,24
Din Moscow,8385,8,5,7,8,18,23,-5,22
Amkar,8385,9,5,5,10,11,23,-12,20
Rostov,8385,10,4,6,10,10,18,-8,18
Anzhi,8385,11,3,5,12,17,40,-23,14
CSKA Moscow,8386,1,12,3,5,29,17,12,39
Loko Moscow,8386,2,11,5,4,30,15,15,38
Zenit,8386,3,8,8,4,23,15,8,32
Krasnodar,8386,4,9,5,6,31,27,4,32
Spart Moscow,8386,5,8,6,6,37,31,6,30
Terek Grozny,8386,6,8,6,6,23,23,0,30
FK Rubin,8386,7,6,6,8,24,19,5,24
Din Moscow,8386,8,5,7,8,20,25,-5,22
Rostov,8386,9,5,6,9,12,18,-6,21
Amkar,8386,10,5,5,10,10,22,-12,20
Anzhi,8386,11,2,5,13,15,42,-27,11
Loko Moscow,8387,1,12,5,3,30,12,18,41
Spart Moscow,8387,2,11,5,4,39,26,13,38
CSKA Moscow,8387,3,11,4,5,27,18,9,37
Krasnodar,8387,4,10,4,6,30,24,6,34
Zenit,8387,5,7,9,4,22,15,7,30
Terek Grozny,8387,6,7,6,7,22,25,-3,27
FK Rubin,8387,7,6,5,9,24,21,3,23
Din Moscow,8387,8,5,6,9,19,25,-6,21
Rostov,8387,9,4,6,10,10,20,-10,18
Amkar,8387,10,4,5,11,12,26,-14,17
Anzhi,8387,11,3,5,12,15,38,-23,14
Loko Moscow,8388,1,12,6,2,31,12,19,42
Spart Moscow,8388,2,11,5,4,41,27,14,38
CSKA Moscow,8388,3,11,3,6,28,20,8,36
Zenit,8388,4,8,8,4,24,16,8,32
Krasnodar,8388,5,8,5,7,28,26,2,29
Terek Grozny,8388,6,7,5,8,21,25,-4,26
Din Moscow,8388,7,6,6,8,18,24,-6,24
FK Rubin,8388,8,6,5,9,23,19,4,23
Amkar,8388,9,5,4,11,12,25,-13,19
Rostov,8388,10,4,6,10,11,20,-9,18
Anzhi,8388,11,3,5,12,16,39,-23,14
Loko Moscow,8389,1,11,7,2,31,13,18,40
Spart Moscow,8389,2,11,5,4,39,27,12,38
Zenit,8389,3,8,9,3,23,14,9,33
CSKA Moscow,8389,4,10,3,7,26,20,6,33
Krasnodar,8389,5,9,5,6,32,27,5,32
Terek Grozny,8389,6,8,6,6,24,23,1,30
FK Rubin,8389,7,6,5,9,24,21,3,23
Din Moscow,8389,8,5,6,9,17,23,-6,21
Rostov,8389,9,4,6,10,11,20,-9,18
Amkar,8389,10,4,4,12,11,28,-17,16
Anzhi,8389,11,3,6,11,16,38,-22,15
Loko Moscow,8390,1,11,6,3,31,14,17,39
CSKA Moscow,8390,2,11,3,6,27,19,8,36
Zenit,8390,3,8,9,3,23,14,9,33
Spart Moscow,8390,4,9,5,6,37,30,7,32
Krasnodar,8390,5,9,4,7,29,27,2,31
Terek Grozny,8390,6,8,6,6,25,24,1,30
FK Rubin,8390,7,6,6,8,23,17,6,24
Din Moscow,8390,8,5,7,8,18,24,-6,22
Rostov,8390,9,5,6,9,11,17,-6,21
Amkar,8390,10,5,4,11,12,26,-14,19
Anzhi,8390,11,2,6,12,17,41,-24,12
Loko Moscow,8391,1,12,6,2,33,12,21,42
CSKA Moscow,8391,2,12,3,5,31,17,14,39
Spart Moscow,8391,3,11,5,4,41,25,16,38
Krasnodar,8391,4,9,4,7,30,28,2,31
Zenit,8391,5,7,9,4,21,14,7,30
Terek Grozny,8391,6,8,6,6,24,23,1,30
FK Rubin,8391,7,6,5,9,22,19,3,23
Din Moscow,8391,8,5,6,9,17,24,-7,21
Rostov,8391,9,4,6,10,10,20,-10,18
Amkar,8391,10,4,4,12,9,28,-19,16
Anzhi,8391,11,2,6,12,15,43,-28,12
Loko Moscow,8392,1,12,5,3,32,14,18,41
CSKA Moscow,8392,2,11,4,5,29,18,11,37
Spart Moscow,8392,3,10,5,5,38,28,10,35
Krasnodar,8392,4,10,4,6,31,25,6,34
Zenit,8392,5,7,9,4,22,16,6,30
Terek Grozny,8392,6,8,5,7,23,26,-3,29
Din Moscow,8392,7,6,6,8,21,24,-3,24
FK Rubin,8392,8,6,5,9,23,19,4,23
Amkar,8392,9,5,4,11,11,24,-13,19
Rostov,8392,10,4,6,10,10,19,-9,18
Anzhi,8392,11,2,5,13,16,43,-27,11
Loko Moscow,8393,1,12,6,2,32,13,19,42
CSKA Moscow,8393,2,12,3,5,31,19,12,39
Spart Moscow,8393,3,10,5,5,37,27,10,35
Krasnodar,8393,4,9,5,6,31,25,6,32
Zenit,8393,5,7,8,5,23,17,6,29
Terek Grozny,8393,6,7,5,8,22,26,-4,26
Din Moscow,8393,7,6,6,8,19,24,-5,24
Amkar,8393,8,6,4,10,12,23,-11,22
FK Rubin,8393,9,5,5,10,22,22,0,20
Rostov,8393,10,4,6,10,10,18,-8,18
Anzhi,8393,11,3,5,12,18,43,-25,14
Loko Moscow,8394,1,12,6,2,32,12,20,42
CSKA Moscow,8394,2,12,3,5,32,19,13,39
Spart Moscow,8394,3,10,5,5,38,29,9,35
Krasnodar,8394,4,8,6,6,29,26,3,30
Terek Grozny,8394,5,8,6,6,22,22,0,30
Zenit,8394,6,7,8,5,22,17,5,29
FK Rubin,8394,7,5,7,8,22,18,4,22
Din Moscow,8394,8,5,7,8,18,24,-6,22
Amkar,8394,9,5,5,10,12,23,-11,20
Rostov,8394,10,4,6,10,10,18,-8,18
Anzhi,8394,11,2,5,13,15,44,-29,11
Loko Moscow,8395,1,12,6,2,31,11,20,42
CSKA Moscow,8395,2,12,3,5,29,19,10,39
Spart Moscow,8395,3,10,5,5,38,28,10,35
Krasnodar,8395,4,9,4,7,28,26,2,31
Zenit,8395,5,7,9,4,21,14,7,30
Terek Grozny,8395,6,8,5,7,23,25,-2,29
Din Moscow,8395,7,6,6,8,19,25,-6,24
Rostov,8395,8,5,6,9,13,18,-5,21
FK Rubin,8395,9,5,5,10,22,20,2,20
Amkar,8395,10,5,4,11,10,23,-13,19
Anzhi,8395,11,2,5,13,18,43,-25,11
Loko Moscow,8396,1,11,6,3,29,13,16,39
Zenit,8396,2,8,9,3,22,13,9,33
CSKA Moscow,8396,3,10,3,7,25,20,5,33
Krasnodar,8396,4,9,5,6,29,24,5,32
Spart Moscow,8396,5,8,7,5,35,30,5,31
Terek Grozny,8396,6,8,5,7,24,26,-2,29
FK Rubin,8396,7,6,6,8,22,17,5,24
Din Moscow,8396,8,6,6,8,20,22,-2,24
Rostov,8396,9,4,7,9,11,18,-7,19
Amkar,8396,10,4,5,11,11,25,-14,17
Anzhi,8396,11,4,5,11,19,39,-20,17
Loko Moscow,8397,1,12,5,3,30,12,18,41
CSKA Moscow,8397,2,12,3,5,31,21,10,39
Krasnodar,8397,3,10,4,6,30,25,5,34
Spart Moscow,8397,4,8,8,4,33,25,8,32
Terek Grozny,8397,5,8,6,6,24,25,-1,30
Zenit,8397,6,7,8,5,22,16,6,29
Din Moscow,8397,7,6,7,7,19,21,-2,25
FK Rubin,8397,8,5,5,10,22,21,1,20
Rostov,8397,9,4,7,9,10,17,-7,19
Amkar,8397,10,4,6,10,12,25,-13,18
Anzhi,8397,11,2,5,13,17,42,-25,11
Loko Moscow,8398,1,11,6,3,29,13,16,39
CSKA Moscow,8398,2,11,3,6,32,19,13,36
Zenit,8398,3,9,8,3,25,14,11,35
Spart Moscow,8398,4,10,5,5,37,29,8,35
Krasnodar,8398,5,9,5,6,29,24,5,32
Terek Grozny,8398,6,8,5,7,21,23,-2,29
FK Rubin,8398,7,6,5,9,22,19,3,23
Rostov,8398,8,5,6,9,12,17,-5,21
Din Moscow,8398,9,5,6,9,18,24,-6,21
Amkar,8398,10,5,4,11,11,24,-13,19
Anzhi,8398,11,2,5,13,14,44,-30,11
Loko Moscow,8399,1,12,6,2,32,13,19,42
CSKA Moscow,8399,2,12,3,5,30,19,11,39
Spart Moscow,8399,3,10,6,4,38,25,13,36
Zenit,8399,4,7,9,4,22,15,7,30
Krasnodar,8399,5,8,4,8,29,28,1,28
Terek Grozny,8399,6,7,6,7,20,23,-3,27
FK Rubin,8399,7,7,5,8,23,17,6,26
Din Moscow,8399,8,5,7,8,17,22,-5,22
Rostov,8399,9,4,6,10,10,21,-11,18
Amkar,8399,10,4,5,11,9,23,-14,17
Anzhi,8399,11,3,5,12,16,40,-24,14
Loko Moscow,8400,1,11,6,3,33,16,17,39
CSKA Moscow,8400,2,11,3,6,29,20,9,36
Spart Moscow,8400,3,10,5,5,38,26,12,35
Zenit,8400,4,8,9,3,26,16,10,33
Krasnodar,8400,5,9,4,7,30,29,1,31
Terek Grozny,8400,6,8,6,6,22,23,-1,30
FK Rubin,8400,7,7,5,8,25,17,8,26
Din Moscow,8400,8,6,6,8,18,22,-4,24
Rostov,8400,9,4,6,10,10,21,-11,18
Amkar,8400,10,4,4,12,9,24,-15,16
Anzhi,8400,11,2,6,12,15,41,-26,12
Loko Moscow,8401,1,13,5,2,34,13,21,44
CSKA Moscow,8401,2,10,4,6,26,19,7,34
Spart Moscow,8401,3,9,6,5,35,28,7,33
Zenit,8401,4,7,9,4,23,17,6,30
Krasnodar,8401,5,8,4,8,29,28,1,28
Terek Grozny,8401,6,7,6,7,21,25,-4,27
FK Rubin,8401,7,7,5,8,25,18,7,26
Amkar,8401,8,6,4,10,13,22,-9,22
Din Moscow,8401,9,5,6,9,17,24,-7,21
Rostov,8401,10,4,7,9,11,18,-7,19
Anzhi,8401,11,3,6,11,16,38,-22,15
Loko Moscow,8402,1,11,5,4,29,14,15,38
CSKA Moscow,8402,2,11,4,5,28,18,10,37
Spart Moscow,8402,3,10,6,4,38,28,10,36
Krasnodar,8402,4,10,4,6,32,24,8,34
Zenit,8402,5,8,9,3,23,14,9,33
Terek Grozny,8402,6,8,6,6,23,23,0,30
Din Moscow,8402,7,6,6,8,22,25,-3,24
FK Rubin,8402,8,5,5,10,23,24,-1,20
Rostov,8402,9,4,7,9,10,17,-7,19
Amkar,8402,10,4,5,11,12,26,-14,17
Anzhi,8402,11,2,5,13,14,41,-27,11
Loko Moscow,8403,1,11,5,4,29,14,15,38
CSKA Moscow,8403,2,11,4,5,28,19,9,37
Krasnodar,8403,3,10,4,6,32,25,7,34
Spart Moscow,8403,4,9,6,5,40,32,8,33
Zenit,8403,5,8,8,4,23,15,8,32
Terek Grozny,8403,6,8,6,6,22,23,-1,30
FK Rubin,8403,7,6,5,9,26,21,5,23
Din Moscow,8403,8,5,7,8,19,26,-7,22
Rostov,8403,9,5,6,9,14,19,-5,21
Amkar,8403,10,4,5,11,11,26,-15,17
Anzhi,8403,11,2,6,12,16,40,-24,12
Loko Moscow,8404,1,13,5,2,34,12,22,44
CSKA Moscow,8404,2,11,4,5,29,20,9,37
Spart Moscow,8404,3,9,6,5,37,28,9,33
Krasnodar,8404,4,9,4,7,31,28,3,31
Zenit,8404,5,7,8,5,23,17,6,29
Terek Grozny,8404,6,7,7,6,21,23,-2,28
Din Moscow,8404,7,6,6,8,19,23,-4,24
Rostov,8404,8,5,6,9,12,18,-6,21
FK Rubin,8404,9,5,5,10,22,23,-1,20
Amkar,8404,10,4,6,10,10,23,-13,18
Anzhi,8404,11,2,7,11,17,40,-23,13
Loko Moscow,8405,1,12,5,3,32,15,17,41
Spart Moscow,8405,2,10,5,5,39,29,10,35
Krasnodar,8405,3,10,4,6,36,25,11,34
CSKA Moscow,8405,4,10,4,6,26,20,6,34
Zenit,8405,5,8,8,4,24,16,8,32
Terek Grozny,8405,6,9,5,6,22,22,0,32
Din Moscow,8405,7,6,6,8,18,23,-5,24
Rostov,8405,8,5,6,9,12,18,-6,21
FK Rubin,8405,9,5,5,10,21,23,-2,20
Amkar,8405,10,4,4,12,11,26,-15,16
Anzhi,8405,11,2,6,12,14,38,-24,12
Loko Moscow,8406,1,13,5,2,32,12,20,44
Spart Moscow,8406,2,10,6,4,41,29,12,36
CSKA Moscow,8406,3,11,3,6,30,20,10,36
Zenit,8406,4,8,8,4,24,16,8,32
Terek Grozny,8406,5,8,6,6,23,23,0,30
Krasnodar,8406,6,8,4,8,27,26,1,28
Din Moscow,8406,7,6,6,8,19,23,-4,24
FK Rubin,8406,8,6,5,9,22,19,3,23
Rostov,8406,9,4,6,10,12,21,-9,18
Amkar,8406,10,4,6,10,12,25,-13,18
Anzhi,8406,11,2,5,13,15,43,-28,11
Loko Moscow,8407,1,11,7,2,31,13,18,40
CSKA Moscow,8407,2,12,3,5,32,17,15,39
Spart Moscow,8407,3,11,5,4,40,27,13,38
Terek Grozny,8407,4,9,5,6,26,23,3,32
Zenit,8407,5,7,9,4,21,14,7,30
Krasnodar,8407,6,8,5,7,30,28,2,29
FK Rubin,8407,7,6,6,8,24,19,5,24
Din Moscow,8407,8,5,7,8,19,26,-7,22
Rostov,8407,9,4,6,10,11,19,-8,18
Amkar,8407,10,4,4,12,9,25,-16,16
Anzhi,8407,11,2,5,13,15,47,-32,11
Loko Moscow,8408,1,12,5,3,31,12,19,41
Spart Moscow,8408,2,10,6,4,38,27,11,36
CSKA Moscow,8408,3,10,3,7,26,20,6,33
Zenit,8408,4,8,8,4,23,16,7,32
Krasnodar,8408,5,9,5,6,28,24,4,32
Terek Grozny,8408,6,8,6,6,21,22,-1,30
Din Moscow,8408,7,6,6,8,20,24,-4,24
FK Rubin,8408,8,5,6,9,22,19,3,21
Rostov,8408,9,4,6,10,10,19,-9,18
Amkar,8408,10,4,6,10,10,23,-13,18
Anzhi,8408,11,3,5,12,15,38,-23,14
Loko Moscow,8409,1,12,6,2,31,12,19,42
CSKA Moscow,8409,2,12,3,5,27,17,10,39
Spart Moscow,8409,3,10,5,5,35,28,7,35
Terek Grozny,8409,4,9,5,6,24,23,1,32
Zenit,8409,5,7,9,4,22,15,7,30
Krasnodar,8409,6,8,4,8,27,26,1,28
Din Moscow,8409,7,6,6,8,20,24,-4,24
FK Rubin,8409,8,6,5,9,24,20,4,23
Amkar,8409,9,5,4,11,12,23,-11,19
Rostov,8409,10,4,6,10,10,18,-8,18
Anzhi,8409,11,2,5,13,15,41,-26,11
Loko Moscow,8410,1,12,6,2,33,13,20,42
CSKA Moscow,8410,2,12,3,5,29,18,11,39
Spart Moscow,8410,3,10,6,4,36,26,10,36
Krasnodar,8410,4,9,5,6,30,26,4,32
Zenit,8410,5,7,8,5,21,17,4,29
Terek Grozny,8410,6,8,5,7,21,25,-4,29
FK Rubin,8410,7,6,5,9,22,18,4,23
Din Moscow,8410,8,5,6,9,17,23,-6,21
Rostov,8410,9,4,6,10,10,18,-8,18
Amkar,8410,10,4,5,11,10,24,-14,17
Anzhi,8410,11,3,5,12,18,39,-21,14
Loko Moscow,8411,1,11,6,3,29,12,17,39
CSKA Moscow,8411,2,11,3,6,28,19,9,36
Spart Moscow,8411,3,9,7,4,39,27,12,34
Krasnodar,8411,4,10,4,6,32,26,6,34
Zenit,8411,5,8,9,3,23,13,10,33
Terek Grozny,8411,6,9,5,6,28,24,4,32
Din Moscow,8411,7,5,8,7,18,22,-4,23
FK Rubin,8411,8,5,6,9,23,21,2,21
Rostov,8411,9,4,6,10,10,21,-11,18
Amkar,8411,10,4,5,11,11,27,-16,17
Anzhi,8411,11,2,5,13,15,44,-29,11
Loko Moscow,8412,1,12,5,3,32,13,19,41
Spart Moscow,8412,2,10,5,5,37,27,10,35
Zenit,8412,3,9,8,3,24,14,10,35
CSKA Moscow,8412,4,10,4,6,25,18,7,34
Krasnodar,8412,5,8,5,7,27,26,1,29
Terek Grozny,8412,6,8,5,7,22,25,-3,29
FK Rubin,8412,7,5,7,8,22,18,4,22
Din Moscow,8412,8,5,7,8,18,23,-5,22
Amkar,8412,9,5,4,11,11,24,-13,19
Rostov,8412,10,4,6,10,10,19,-9,18
Anzhi,8412,11,3,6,11,17,38,-21,15
Loko Moscow,8413,1,12,5,3,31,13,18,41
CSKA Moscow,8413,2,12,3,5,31,19,12,39
Spart Moscow,8413,3,10,5,5,40,32,8,35
Krasnodar,8413,4,9,4,7,30,27,3,31
Zenit,8413,5,7,8,5,21,15,6,29
Terek Grozny,8413,6,7,6,7,20,23,-3,27
FK Rubin,8413,7,6,6,8,24,19,5,24
Din Moscow,8413,8,5,7,8,19,24,-5,22
Amkar,8413,9,6,4,10,13,23,-10,22
Rostov,8413,10,4,6,10,13,21,-8,18
Anzhi,8413,11,2,6,12,16,42,-26,12
Loko Moscow,8414,1,11,6,3,29,12,17,39
Krasnodar,8414,2,10,4,6,31,24,7,34
CSKA Moscow,8414,3,10,4,6,26,21,5,34
Spart Moscow,8414,4,9,6,5,36,28,8,33
Zenit,8414,5,7,10,3,22,14,8,31
Terek Grozny,8414,6,7,7,6,20,22,-2,28
FK Rubin,8414,7,6,5,9,24,20,4,23
Rostov,8414,8,5,6,9,12,17,-5,21
Din Moscow,8414,9,5,6,9,17,26,-9,21
Amkar,8414,10,4,6,10,10,23,-13,18
Anzhi,8414,11,3,6,11,17,37,-20,15
Loko Moscow,8415,1,12,5,3,31,13,18,41
Zenit,8415,2,9,8,3,24,14,10,35
Spart Moscow,8415,3,10,5,5,39,30,9,35
CSKA Moscow,8415,4,10,4,6,26,19,7,34
Terek Grozny,8415,5,8,5,7,22,25,-3,29
Krasnodar,8415,6,8,4,8,27,28,-1,28
Din Moscow,8415,7,6,6,8,20,24,-4,24
FK Rubin,8415,8,6,5,9,24,18,6,23
Rostov,8415,9,5,6,9,13,19,-6,21
Amkar,8415,10,5,4,11,11,23,-12,19
Anzhi,8415,11,2,6,12,16,40,-24,12
Loko Moscow,8416,1,12,5,3,32,14,18,41
CSKA Moscow,8416,2,11,3,6,27,19,8,36
Zenit,8416,3,9,8,3,25,14,11,35
Spart Moscow,8416,4,10,5,5,36,27,9,35
Krasnodar,8416,5,9,4,7,28,26,2,31
Terek Grozny,8416,6,8,5,7,22,25,-3,29
FK Rubin,8416,7,6,5,9,22,18,4,23
Amkar,8416,8,6,4,10,14,24,-10,22
Din Moscow,8416,9,5,6,9,17,23,-6,21
Rostov,8416,10,4,6,10,10,18,-8,18
Anzhi,8416,11,2,5,13,15,40,-25,11
Loko Moscow,8417,1,11,7,2,29,11,18,40
CSKA Moscow,8417,2,12,3,5,31,17,14,39
Spart Moscow,8417,3,9,5,6,38,31,7,32
Zenit,8417,4,7,9,4,21,15,6,30
Terek Grozny,8417,5,8,6,6,22,23,-1,30
Krasnodar,8417,6,8,5,7,28,26,2,29
Din Moscow,8417,7,7,6,7,23,24,-1,27
FK Rubin,8417,8,6,5,9,23,20,3,23
Amkar,8417,9,5,5,10,12,23,-11,20
Rostov,8417,10,4,6,10,10,19,-9,18
Anzhi,8417,11,2,5,13,14,42,-28,11
Loko Moscow,8418,1,12,6,2,32,12,20,42
CSKA Moscow,8418,2,11,3,6,27,19,8,36
Spart Moscow,8418,3,9,6,5,38,31,7,33
Krasnodar,8418,4,9,5,6,30,25,5,32
Zenit,8418,5,7,8,5,22,17,5,29
Terek Grozny,8418,6,7,6,7,20,23,-3,27
Din Moscow,8418,7,6,6,8,21,25,-4,24
Amkar,8418,8,6,4,10,14,23,-9,22
FK Rubin,8418,9,5,5,10,22,22,0,20
Rostov,8418,10,4,7,9,11,18,-7,19
Anzhi,8418,11,3,6,11,15,37,-22,15
Loko Moscow,8419,1,12,6,2,32,13,19,42
Spart Moscow,8419,2,10,5,5,38,29,9,35
CSKA Moscow,8419,3,10,5,5,26,18,8,35
Krasnodar,8419,4,9,5,6,31,26,5,32
Zenit,8419,5,7,9,4,22,15,7,30
Din Moscow,8419,6,7,6,7,22,23,-1,27
Terek Grozny,8419,7,7,6,7,21,24,-3,27
FK Rubin,8419,8,5,5,10,22,22,0,20
Amkar,8419,9,5,4,11,11,24,-13,19
Rostov,8419,10,4,6,10,11,19,-8,18
Anzhi,8419,11,2,7,11,15,38,-23,13
Loko Moscow,8420,1,12,5,3,33,12,21,41
Zenit,8420,2,9,8,3,23,13,10,35
Spart Moscow,8420,3,9,7,4,41,28,13,34
CSKA Moscow,8420,4,10,3,7,26,20,6,33
Krasnodar,8420,5,9,4,7,30,30,0,31
Terek Grozny,8420,6,7,7,6,20,22,-2,28
FK Rubin,8420,7,6,5,9,26,20,6,23
Din Moscow,8420,8,5,7,8,19,26,-7,22
Rostov,8420,9,4,6,10,10,22,-12,18
Amkar,8420,10,4,6,10,10,23,-13,18
Anzhi,8420,11,3,6,11,16,38,-22,15
Loko Moscow,8421,1,12,5,3,31,13,18,41
CSKA Moscow,8421,2,12,3,5,30,18,12,39
Spart Moscow,8421,3,9,6,5,38,29,9,33
Zenit,8421,4,8,8,4,24,16,8,32
Terek Grozny,8421,5,8,6,6,21,22,-1,30
Krasnodar,8421,6,8,4,8,28,27,1,28
Din Moscow,8421,7,7,6,7,22,23,-1,27
FK Rubin,8421,8,6,5,9,24,20,4,23
Rostov,8421,9,4,7,9,11,18,-7,19
Amkar,8421,10,4,5,11,9,25,-16,17
Anzhi,8421,11,2,5,13,14,41,-27,11
Loko Moscow,8422,1,11,6,3,31,14,17,39
CSKA Moscow,8422,2,10,4,6,28,21,7,34
Zenit,8422,3,8,9,3,23,14,9,33
Krasnodar,8422,4,9,5,6,31,27,4,32
Spart Moscow,8422,5,8,6,6,35,30,5,30
Terek Grozny,8422,6,8,6,6,22,23,-1,30
Din Moscow,8422,7,7,6,7,20,22,-2,27
FK Rubin,8422,8,5,6,9,23,20,3,21
Amkar,8422,9,5,5,10,12,23,-11,20
Rostov,8422,10,4,7,9,11,18,-7,19
Anzhi,8422,11,2,6,12,17,41,-24,12
Loko Moscow,8423,1,12,5,3,34,12,22,41
CSKA Moscow,8423,2,11,3,6,29,19,10,36
Zenit,8423,3,9,8,3,24,13,11,35
Spart Moscow,8423,4,9,6,5,37,30,7,33
Krasnodar,8423,5,8,5,7,28,30,-2,29
Terek Grozny,8423,6,7,5,8,20,25,-5,26
FK Rubin,8423,7,6,6,8,24,18,6,24
Din Moscow,8423,8,5,7,8,18,24,-6,22
Rostov,8423,9,5,6,9,13,18,-5,21
Amkar,8423,10,5,4,11,12,24,-12,19
Anzhi,8423,11,3,5,12,15,41,-26,14
Loko Moscow,8424,1,11,7,2,30,12,18,40
CSKA Moscow,8424,2,12,3,5,31,20,11,39
Spart Moscow,8424,3,10,5,5,37,26,11,35
Krasnodar,8424,4,9,5,6,29,25,4,32
Zenit,8424,5,7,9,4,22,15,7,30
Terek Grozny,8424,6,7,6,7,20,23,-3,27
Din Moscow,8424,7,6,6,8,19,25,-6,24
Amkar,8424,8,6,4,10,11,22,-11,22
FK Rubin,8424,9,5,5,10,22,20,2,20
Rostov,8424,10,4,6,10,10,18,-8,18
Anzhi,8424,11,2,6,12,16,41,-25,12
Loko Moscow,8425,1,13,5,2,34,12,22,44
CSKA Moscow,8425,2,12,3,5,28,18,10,39
Spart Moscow,8425,3,9,6,5,37,29,8,33
Zenit,8425,4,7,8,5,23,18,5,29
Krasnodar,8425,5,8,5,7,27,26,1,29
Terek Grozny,8425,6,7,7,6,23,25,-2,28
FK Rubin,8425,7,5,7,8,22,18,4,22
Din Moscow,8425,8,5,7,8,18,24,-6,22
Rostov,8425,9,5,6,9,13,18,-5,21
Amkar,8425,10,4,6,10,12,25,-13,18
Anzhi,8425,11,2,6,12,15,39,-24,12
Loko Moscow,8426,1,13,5,2,33,13,20,44
Spart Moscow,8426,2,10,5,5,39,29,10,35
CSKA Moscow,8426,3,10,3,7,25,21,4,33
Zenit,8426,4,8,8,4,24,14,10,32
Terek Grozny,8426,5,9,5,6,24,23,1,32
Krasnodar,8426,6,9,4,7,31,27,4,31
Din Moscow,8426,7,7,6,7,22,24,-2,27
FK Rubin,8426,8,5,5,10,22,21,1,20
Rostov,8426,9,4,6,10,11,20,-9,18
Amkar,8426,10,4,4,12,9,24,-15,16
Anzhi,8426,11,3,5,12,16,40,-24,14
Loko Moscow,8427,1,13,5,2,34,13,21,44
Spart Moscow,8427,2,10,6,4,37,25,12,36
CSKA Moscow,8427,3,11,3,6,28,20,8,36
Zenit,8427,4,8,8,4,25,17,8,32
Krasnodar,8427,5,8,4,8,28,28,0,28
Terek Grozny,8427,6,7,6,7,24,27,-3,27
FK Rubin,8427,7,7,5,8,23,17,6,26
Din Moscow,8427,8,5,6,9,17,23,-6,21
Rostov,8427,9,4,7,9,10,17,-7,19
Amkar,8427,10,4,5,11,10,26,-16,17
Anzhi,8427,11,3,5,12,18,41,-23,14
Loko Moscow,8428,1,11,6,3,29,12,17,39
CSKA Moscow,8428,2,12,3,5,34,19,15,39
Spart Moscow,8428,3,10,5,5,41,29,12,35
Zenit,8428,4,8,8,4,24,16,8,32
Krasnodar,8428,5,9,5,6,31,26,5,32
Terek Grozny,8428,6,8,6,6,22,23,-1,30
Din Moscow,8428,7,5,7,8,17,24,-7,22
FK Rubin,8428,8,5,6,9,23,21,2,21
Amkar,8428,9,5,4,11,13,25,-12,19
Rostov,8428,10,4,6,10,10,20,-10,18
Anzhi,8428,11,2,6,12,15,44,-29,12
Loko Moscow,8429,1,11,7,2,31,13,18,40
CSKA Moscow,8429,2,11,4,5,26,17,9,37
Spart Moscow,8429,3,10,6,4,39,26,13,36
Zenit,8429,4,7,10,3,21,13,8,31
Krasnodar,8429,5,8,6,6,30,27,3,30
Terek Grozny,8429,6,8,5,7,22,24,-2,29
FK Rubin,8429,7,6,6,8,25,19,6,24
Din Moscow,8429,8,5,6,9,18,27,-9,21
Rostov,8429,9,4,7,9,11,18,-7,19
Amkar,8429,10,5,4,11,10,24,-14,19
Anzhi,8429,11,2,5,13,15,40,-25,11
Loko Moscow,8430,1,13,5,2,32,11,21,44
CSKA Moscow,8430,2,10,4,6,25,18,7,34
Spart Moscow,8430,3,9,6,5,38,29,9,33
Zenit,8430,4,7,9,4,21,15,6,30
Krasnodar,8430,5,8,5,7,30,28,2,29
Terek Grozny,8430,6,7,6,7,22,25,-3,27
Din Moscow,8430,7,6,7,7,20,22,-2,25
FK Rubin,8430,8,5,7,8,24,20,4,22
Amkar,8430,9,5,5,10,11,23,-12,20
Rostov,8430,10,4,6,10,11,21,-10,18
Anzhi,8430,11,3,6,11,16,38,-22,15
Loko Moscow,8431,1,13,5,2,33,12,21,44
CSKA Moscow,8431,2,12,3,5,31,20,11,39
Spart Moscow,8431,3,10,5,5,37,28,9,35
Krasnodar,8431,4,9,4,7,30,27,3,31
Zenit,8431,5,7,8,5,25,19,6,29
Terek Grozny,8431,6,7,6,7,22,26,-4,27
Din Moscow,8431,7,6,6,8,19,23,-4,24
Rostov,8431,8,5,6,9,12,17,-5,21
FK Rubin,8431,9,5,5,10,22,21,1,20
Amkar,8431,10,5,4,11,11,24,-13,19
Anzhi,8431,11,2,6,12,16,41,-25,12
Loko Moscow,8432,1,11,6,3,29,12,17,39
Spart Moscow,8432,2,11,5,4,41,26,15,38
CSKA Moscow,8432,3,11,4,5,27,18,9,37
Zenit,8432,4,7,10,3,22,14,8,31
Krasnodar,8432,5,9,4,7,29,26,3,31
Terek Grozny,8432,6,7,7,6,22,24,-2,28
Din Moscow,8432,7,6,6,8,19,24,-5,24
FK Rubin,8432,8,6,5,9,23,19,4,23
Rostov,8432,9,4,6,10,10,20,-10,18
Amkar,8432,10,4,5,11,11,26,-15,17
Anzhi,8432,11,2,6,12,14,38,-24,12
Loko Moscow,8433,1,13,5,2,32,12,20,44
Spart Moscow,8433,2,10,6,4,38,27,11,36
CSKA Moscow,8433,3,10,3,7,26,21,5,33
Zenit,8433,4,8,8,4,22,14,8,32
Krasnodar,8433,5,9,4,7,32,28,4,31
Terek Grozny,8433,6,8,5,7,22,24,-2,29
Din Moscow,8433,7,5,7,8,19,25,-6,22
FK Rubin,8433,8,5,6,9,24,22,2,21
Amkar,8433,9,5,5,10,11,22,-11,20
Rostov,8433,10,4,6,10,11,19,-8,18
Anzhi,8433,11,3,5,12,17,40,-23,14
Loko Moscow,8434,1,11,6,3,30,13,17,39
CSKA Moscow,8434,2,12,3,5,31,18,13,39
Spart Moscow,8434,3,10,5,5,38,30,8,35
Krasnodar,8434,4,10,4,6,30,24,6,34
Zenit,8434,5,7,9,4,22,16,6,30
Terek Grozny,8434,6,7,6,7,22,25,-3,27
Din Moscow,8434,7,5,7,8,19,24,-5,22
Amkar,8434,8,6,4,10,14,23,-9,22
FK Rubin,8434,9,5,6,9,21,19,2,21
Rostov,8434,10,4,6,10,10,19,-9,18
Anzhi,8434,11,2,6,12,16,42,-26,12
Loko Moscow,8435,1,12,5,3,30,13,17,41
Zenit,8435,2,9,8,3,27,13,14,35
Spart Moscow,8435,3,10,5,5,36,27,9,35
CSKA Moscow,8435,4,10,4,6,28,24,4,34
Krasnodar,8435,5,9,4,7,28,25,3,31
Terek Grozny,8435,6,7,5,8,22,27,-5,26
Din Moscow,8435,7,6,6,8,19,22,-3,24
FK Rubin,8435,8,6,5,9,22,18,4,23
Amkar,8435,9,5,4,11,11,25,-14,19
Rostov,8435,10,4,6,10,10,18,-8,18
Anzhi,8435,11,3,6,11,20,41,-21,15
Loko Moscow,8436,1,11,6,3,30,13,17,39
CSKA Moscow,8436,2,11,3,6,28,20,8,36
Zenit,8436,3,9,8,3,25,14,11,35
Spart Moscow,8436,4,9,6,5,38,29,9,33
Terek Grozny,8436,5,9,5,6,22,22,0,32
Krasnodar,8436,6,8,6,6,28,25,3,30
Din Moscow,8436,7,6,6,8,19,24,-5,24
FK Rubin,8436,8,5,6,9,22,19,3,21
Rostov,8436,9,5,6,9,12,18,-6,21
Amkar,8436,10,4,5,11,11,25,-14,17
Anzhi,8436,11,2,5,13,14,40,-26,11
Loko Moscow,8437,1,11,6,3,30,15,15,39
CSKA Moscow,8437,2,12,3,5,29,18,11,39
Krasnodar,8437,3,10,4,6,33,25,8,34
Spart Moscow,8437,4,8,7,5,36,29,7,31
Zenit,8437,5,7,9,4,22,16,6,30
Terek Grozny,8437,6,7,5,8,21,25,-4,26
Din Moscow,8437,7,6,7,7,21,24,-3,25
FK Rubin,8437,8,5,6,9,23,21,2,21
Amkar,8437,9,5,5,10,11,23,-12,20
Rostov,8437,10,4,7,9,10,17,-7,19
Anzhi,8437,11,3,5,12,17,40,-23,14
Loko Moscow,8438,1,13,5,2,31,11,20,44
Spart Moscow,8438,2,9,7,4,39,30,9,34
CSKA Moscow,8438,3,10,4,6,26,20,6,34
Terek Grozny,8438,4,9,5,6,24,22,2,32
Krasnodar,8438,5,9,4,7,29,25,4,31
Zenit,8438,6,7,9,4,21,14,7,30
FK Rubin,8438,7,6,5,9,23,20,3,23
Din Moscow,8438,8,5,7,8,19,24,-5,22
Rostov,8438,9,4,6,10,12,20,-8,18
Amkar,8438,10,4,5,11,11,26,-15,17
Anzhi,8438,11,3,5,12,17,40,-23,14
Loko Moscow,8439,1,12,5,3,31,15,16,41
CSKA Moscow,8439,2,11,4,5,30,18,12,37
Krasnodar,8439,3,10,4,6,32,25,7,34
Spart Moscow,8439,4,8,7,5,33,28,5,31
Zenit,8439,5,7,9,4,22,15,7,30
Terek Grozny,8439,6,7,5,8,22,26,-4,26
Din Moscow,8439,7,6,7,7,18,21,-3,25
Amkar,8439,8,6,4,10,14,23,-9,22
FK Rubin,8439,9,5,5,10,22,20,2,20
Rostov,8439,10,4,7,9,10,17,-7,19
Anzhi,8439,11,3,5,12,17,43,-26,14
Loko Moscow,8440,1,12,5,3,32,12,20,41
CSKA Moscow,8440,2,12,3,5,29,17,12,39
Krasnodar,8440,3,10,4,6,30,24,6,34
Spart Moscow,8440,4,9,6,5,36,28,8,33
Terek Grozny,8440,5,8,6,6,22,22,0,30
Zenit,8440,6,7,8,5,21,18,3,29
FK Rubin,8440,7,6,5,9,22,19,3,23
Din Moscow,8440,8,5,6,9,18,24,-6,21
Rostov,8440,9,4,7,9,10,17,-7,19
Amkar,8440,10,5,4,11,11,25,-14,19
Anzhi,8440,11,2,6,12,14,39,-25,12
Loko Moscow,8441,1,13,5,2,31,11,20,44
Spart Moscow,8441,2,10,5,5,39,28,11,35
CSKA Moscow,8441,3,10,3,7,27,23,4,33
Zenit,8441,4,8,8,4,25,16,9,32
Krasnodar,8441,5,9,4,7,29,26,3,31
Terek Grozny,8441,6,8,5,7,25,26,-1,29
FK Rubin,8441,7,6,5,9,24,20,4,23
Din Moscow,8441,8,5,6,9,19,25,-6,21
Amkar,8441,9,5,4,11,12,26,-14,19
Rostov,8441,10,4,6,10,10,20,-10,18
Anzhi,8441,11,4,5,11,19,39,-20,17
Loko Moscow,8442,1,11,6,3,29,14,15,39
Spart Moscow,8442,2,9,7,4,36,26,10,34
Krasnodar,8442,3,10,4,6,32,25,7,34
Zenit,8442,4,8,9,3,23,13,10,33
CSKA Moscow,8442,5,10,3,7,26,21,5,33
Terek Grozny,8442,6,8,5,7,22,23,-1,29
Din Moscow,8442,7,5,7,8,17,23,-6,22
FK Rubin,8442,8,5,6,9,22,19,3,21
Amkar,8442,9,5,5,10,11,23,-12,20
Rostov,8442,10,4,7,9,10,17,-7,19
Anzhi,8442,11,3,5,12,16,40,-24,14
Loko Moscow,8443,1,11,5,4,30,15,15,38
Spart Moscow,8443,2,10,6,4,39,27,12,36
Zenit,8443,3,9,8,3,26,15,11,35
Krasnodar,8443,4,10,4,6,29,24,5,34
CSKA Moscow,8443,5,10,3,7,27,21,6,33
Terek Grozny,8443,6,8,6,6,24,25,-1,30
Din Moscow,8443,7,5,8,7,19,23,-4,23
FK Rubin,8443,8,5,6,9,22,19,3,21
Rostov,8443,9,4,6,10,11,20,-9,18
Amkar,8443,10,4,4,12,11,27,-16,16
Anzhi,8443,11,3,6,11,17,39,-22,15
Loko Moscow,8444,1,12,5,3,32,13,19,41
Spart Moscow,8444,2,11,5,4,41,26,15,38
CSKA Moscow,8444,3,11,3,6,29,18,11,36
Zenit,8444,4,9,8,3,23,13,10,35
Krasnodar,8444,5,8,5,7,30,29,1,29
Terek Grozny,8444,6,7,6,7,21,25,-4,27
FK Rubin,8444,7,6,6,8,26,20,6,24
Din Moscow,8444,8,5,6,9,19,27,-8,21
Amkar,8444,9,5,4,11,12,24,-12,19
Rostov,8444,10,4,6,10,10,21,-11,18
Anzhi,8444,11,2,6,12,14,41,-27,12
Loko Moscow,8445,1,12,5,3,31,14,17,41
CSKA Moscow,8445,2,11,4,5,27,18,9,37
Spart Moscow,8445,3,9,6,5,34,31,3,33
Krasnodar,8445,4,9,5,6,30,25,5,32
Terek Grozny,8445,5,8,6,6,22,23,-1,30
Zenit,8445,6,7,8,5,22,16,6,29
Din Moscow,8445,7,6,6,8,20,23,-3,24
FK Rubin,8445,8,5,6,9,23,21,2,21
Amkar,8445,9,5,5,10,15,22,-7,20
Rostov,8445,10,4,7,9,10,17,-7,19
Anzhi,8445,11,2,6,12,16,40,-24,12
Loko Moscow,8446,1,12,6,2,33,13,20,42
CSKA Moscow,8446,2,11,3,6,29,20,9,36
Spart Moscow,8446,3,9,6,5,37,29,8,33
Zenit,8446,4,8,8,4,23,16,7,32
Terek Grozny,8446,5,8,6,6,22,23,-1,30
Krasnodar,8446,6,8,5,7,30,28,2,29
FK Rubin,8446,7,6,6,8,24,19,5,24
Din Moscow,8446,8,5,7,8,19,24,-5,22
Rostov,8446,9,5,6,9,11,17,-6,21
Amkar,8446,10,4,5,11,11,25,-14,17
Anzhi,8446,11,2,6,12,16,41,-25,12
Loko Moscow,8447,1,12,6,2,31,12,19,42
CSKA Moscow,8447,2,11,3,6,26,19,7,36
Spart Moscow,8447,3,10,5,5,38,28,10,35
Krasnodar,8447,4,8,6,6,29,26,3,30
Zenit,8447,5,7,8,5,21,15,6,29
Terek Grozny,8447,6,7,6,7,20,24,-4,27
FK Rubin,8447,7,5,7,8,23,19,4,22
Din Moscow,8447,8,5,7,8,19,24,-5,22
Amkar,8447,9,6,4,10,13,23,-10,22
Rostov,8447,10,4,6,10,10,19,-9,18
Anzhi,8447,11,3,6,11,16,37,-21,15
Loko Moscow,8448,1,13,5,2,33,13,20,44
CSKA Moscow,8448,2,11,4,5,29,19,10,37
Spart Moscow,8448,3,9,7,4,38,28,10,34
Krasnodar,8448,4,9,4,7,29,26,3,31
Zenit,8448,5,7,9,4,23,16,7,30
Terek Grozny,8448,6,8,5,7,22,25,-3,29
FK Rubin,8448,7,6,5,9,22,18,4,23
Din Moscow,8448,8,5,7,8,19,24,-5,22
Rostov,8448,9,4,6,10,11,20,-9,18
Amkar,8448,10,4,5,11,9,23,-14,17
Anzhi,8448,11,3,5,12,18,41,-23,14
Loko Moscow,8449,1,12,6,2,32,13,19,42
CSKA Moscow,8449,2,11,4,5,27,18,9,37
Spart Moscow,8449,3,10,5,5,39,28,11,35
Zenit,8449,4,7,10,3,23,15,8,31
Krasnodar,8449,5,9,4,7,29,26,3,31
Terek Grozny,8449,6,8,5,7,21,23,-2,29
Din Moscow,8449,7,6,6,8,21,23,-2,24
Amkar,8449,8,6,4,10,11,22,-11,22
FK Rubin,8449,9,5,5,10,21,21,0,20
Rostov,8449,10,4,6,10,11,21,-10,18
Anzhi,8449,11,2,5,13,14,39,-25,11
Loko Moscow,8450,1,12,6,2,31,12,19,42
Spart Moscow,8450,2,10,6,4,37,27,10,36
CSKA Moscow,8450,3,10,4,6,27,22,5,34
Zenit,8450,4,8,9,3,25,14,11,33
Krasnodar,8450,5,9,4,7,31,27,4,31
Terek Grozny,8450,6,8,5,7,23,25,-2,29
Din Moscow,8450,7,5,8,7,17,21,-4,23
FK Rubin,8450,8,5,6,9,22,20,2,21
Rostov,8450,9,4,6,10,11,19,-8,18
Amkar,8450,10,4,4,12,10,25,-15,16
Anzhi,8450,11,3,6,11,18,40,-22,15
Loko Moscow,8451,1,12,5,3,32,13,19,41
CSKA Moscow,8451,2,12,3,5,30,18,12,39
Spart Moscow,8451,3,10,5,5,44,28,16,35
Krasnodar,8451,4,10,4,6,31,25,6,34
Terek Grozny,8451,5,8,6,6,22,23,-1,30
Zenit,8451,6,7,8,5,23,18,5,29
Din Moscow,8451,7,6,6,8,19,26,-7,24
FK Rubin,8451,8,5,5,10,23,22,1,20
Amkar,8451,9,5,5,10,13,25,-12,20
Rostov,8451,10,4,6,10,10,22,-12,18
Anzhi,8451,11,2,5,13,14,41,-27,11
Loko Moscow,8452,1,13,5,2,33,11,22,44
CSKA Moscow,8452,2,12,3,5,29,18,11,39
Spart Moscow,8452,3,11,5,4,39,25,14,38
Terek Grozny,8452,4,9,5,6,26,23,3,32
Krasnodar,8452,5,9,4,7,29,26,3,31
Zenit,8452,6,7,8,5,21,18,3,29
FK Rubin,8452,7,6,5,9,25,19,6,23
Din Moscow,8452,8,5,6,9,17,26,-9,21
Rostov,8452,9,4,6,10,10,18,-8,18
Amkar,8452,10,4,4,12,9,29,-20,16
Anzhi,8452,11,2,5,13,16,41,-25,11
Loko Moscow,8453,1,11,7,2,31,13,18,40
Spart Moscow,8453,2,10,5,5,37,26,11,35
CSKA Moscow,8453,3,10,4,6,26,19,7,34
Zenit,8453,4,8,9,3,22,13,9,33
Krasnodar,8453,5,9,5,6,32,27,5,32
Terek Grozny,8453,6,8,5,7,22,24,-2,29
FK Rubin,8453,7,6,5,9,23,20,3,23
Rostov,8453,8,5,6,9,11,17,-6,21
Din Moscow,8453,9,5,6,9,17,24,-7,21
Amkar,8453,10,5,4,11,10,24,-14,19
Anzhi,8453,11,2,6,12,16,40,-24,12
Loko Moscow,8454,1,11,7,2,32,14,18,40
CSKA Moscow,8454,2,11,4,5,30,19,11,37
Zenit,8454,3,7,10,3,23,15,8,31
Spart Moscow,8454,4,8,7,5,34,27,7,31
Krasnodar,8454,5,8,6,6,29,26,3,30
Terek Grozny,8454,6,8,5,7,23,24,-1,29
Din Moscow,8454,7,6,7,7,19,21,-2,25
Amkar,8454,8,6,4,10,13,24,-11,22
FK Rubin,8454,9,5,6,9,21,19,2,21
Rostov,8454,10,4,7,9,10,17,-7,19
Anzhi,8454,11,2,5,13,15,43,-28,11
Loko Moscow,8455,1,12,5,3,31,13,18,41
CSKA Moscow,8455,2,11,3,6,30,20,10,36
Spart Moscow,8455,3,10,5,5,37,28,9,35
Krasnodar,8455,4,9,5,6,29,25,4,32
Zenit,8455,5,7,8,5,22,18,4,29
Terek Grozny,8455,6,7,5,8,22,27,-5,26
FK Rubin,8455,7,6,6,8,23,17,6,24
Amkar,8455,8,6,4,10,14,24,-10,22
Din Moscow,8455,9,5,6,9,17,24,-7,21
Rostov,8455,10,4,6,10,11,19,-8,18
Anzhi,8455,11,4,5,11,18,39,-21,17
Loko Moscow,8456,1,12,5,3,32,14,18,41
Spart Moscow,8456,2,11,5,4,44,27,17,38
CSKA Moscow,8456,3,11,4,5,30,20,10,37
Zenit,8456,4,8,9,3,25,16,9,33
Terek Grozny,8456,5,8,6,6,22,23,-1,30
Krasnodar,8456,6,8,4,8,29,30,-1,28
FK Rubin,8456,7,6,6,8,26,19,7,24
Din Moscow,8456,8,5,7,8,19,25,-6,22
Rostov,8456,9,4,6,10,10,21,-11,18
Amkar,8456,10,4,5,11,11,27,-16,17
Anzhi,8456,11,2,5,13,15,41,-26,11
Loko Moscow,8457,1,11,7,2,29,11,18,40
CSKA Moscow,8457,2,10,5,5,25,17,8,35
Spart Moscow,8457,3,9,6,5,36,26,10,33
Krasnodar,8457,4,9,5,6,28,24,4,32
Zenit,8457,5,7,10,3,21,13,8,31
Terek Grozny,8457,6,7,7,6,21,23,-2,28
Din Moscow,8457,7,6,7,7,19,22,-3,25
FK Rubin,8457,8,5,5,10,22,20,2,20
Amkar,8457,9,5,5,10,11,23,-12,20
Rostov,8457,10,4,6,10,10,20,-10,18
Anzhi,8457,11,2,7,11,14,37,-23,13
Loko Moscow,8458,1,12,5,3,33,15,18,41
CSKA Moscow,8458,2,11,3,6,30,20,10,36
Spart Moscow,8458,3,10,5,5,38,30,8,35
Krasnodar,8458,4,10,4,6,31,25,6,34
Zenit,8458,5,8,8,4,23,16,7,32
Terek Grozny,8458,6,7,6,7,20,24,-4,27
Din Moscow,8458,7,6,7,7,22,24,-2,25
FK Rubin,8458,8,5,6,9,22,19,3,21
Rostov,8458,9,4,6,10,11,19,-8,18
Amkar,8458,10,4,5,11,9,23,-14,17
Anzhi,8458,11,3,5,12,18,42,-24,14
Loko Moscow,8459,1,11,5,4,29,14,15,38
CSKA Moscow,8459,2,11,3,6,30,18,12,36
Zenit,8459,3,9,8,3,24,13,11,35
Krasnodar,8459,4,10,4,6,33,25,8,34
Spart Moscow,8459,5,9,6,5,37,27,10,33
Terek Grozny,8459,6,8,5,7,21,24,-3,29
Din Moscow,8459,7,6,6,8,18,24,-6,24
Rostov,8459,8,5,6,9,12,18,-6,21
FK Rubin,8459,9,5,5,10,22,23,-1,20
Amkar,8459,10,4,5,11,9,23,-14,17
Anzhi,8459,11,3,5,12,16,42,-26,14
Loko Moscow,8460,1,12,5,3,32,14,18,41
CSKA Moscow,8460,2,10,4,6,26,19,7,34
Spart Moscow,8460,3,9,6,5,40,31,9,33
Zenit,8460,4,8,9,3,22,13,9,33
Terek Grozny,8460,5,8,6,6,22,23,-1,30
Krasnodar,8460,6,8,4,8,29,28,1,28
FK Rubin,8460,7,7,5,8,23,17,6,26
Din Moscow,8460,8,5,6,9,18,26,-8,21
Rostov,8460,9,4,7,9,12,19,-7,19
Amkar,8460,10,5,4,11,13,25,-12,19
Anzhi,8460,11,3,6,11,16,38,-22,15
Loko Moscow,8461,1,12,5,3,33,13,20,41
CSKA Moscow,8461,2,11,3,6,28,21,7,36
Krasnodar,8461,3,10,4,6,30,24,6,34
Spart Moscow,8461,4,9,5,6,37,27,10,32
Zenit,8461,5,8,8,4,25,17,8,32
Terek Grozny,8461,6,7,5,8,20,24,-4,26
Din Moscow,8461,7,5,7,8,18,26,-8,22
Amkar,8461,8,6,4,10,11,22,-11,22
FK Rubin,8461,9,5,6,9,22,19,3,21
Rostov,8461,10,5,6,9,11,17,-6,21
Anzhi,8461,11,3,5,12,15,40,-25,14
Loko Moscow,8462,1,12,5,3,31,13,18,41
Spart Moscow,8462,2,11,5,4,40,25,15,38
CSKA Moscow,8462,3,11,3,6,28,22,6,36
Zenit,8462,4,8,8,4,24,14,10,32
Krasnodar,8462,5,9,4,7,29,26,3,31
FK Rubin,8462,6,7,5,8,25,17,8,26
Terek Grozny,8462,7,7,5,8,20,26,-6,26
Din Moscow,8462,8,5,6,9,17,28,-11,21
Amkar,8462,9,5,4,11,10,24,-14,19
Rostov,8462,10,4,6,10,10,18,-8,18
Anzhi,8462,11,3,5,12,19,40,-21,14
Loko Moscow,8463,1,11,6,3,32,17,15,39
CSKA Moscow,8463,2,12,3,5,29,18,11,39
Spart Moscow,8463,3,9,7,4,36,27,9,34
Zenit,8463,4,8,8,4,26,16,10,32
Krasnodar,8463,5,8,6,6,29,26,3,30
Terek Grozny,8463,6,7,6,7,20,23,-3,27
Din Moscow,8463,7,5,8,7,19,23,-4,23
FK Rubin,8463,8,5,7,8,21,17,4,22
Rostov,8463,9,4,7,9,10,17,-7,19
Amkar,8463,10,4,5,11,9,23,-14,17
Anzhi,8463,11,3,5,12,15,39,-24,14
Loko Moscow,8464,1,13,5,2,32,12,20,44
CSKA Moscow,8464,2,11,4,5,27,18,9,37
Spart Moscow,8464,3,9,7,4,39,30,9,34
Zenit,8464,4,7,8,5,22,16,6,29
Krasnodar,8464,5,8,4,8,27,26,1,28
FK Rubin,8464,6,7,5,8,25,18,7,26
Terek Grozny,8464,7,7,5,8,21,25,-4,26
Din Moscow,8464,8,5,7,8,20,26,-6,22
Rostov,8464,9,4,7,9,12,19,-7,19
Amkar,8464,10,5,4,11,12,25,-13,19
Anzhi,8464,11,3,6,11,16,38,-22,15
Loko Moscow,8465,1,12,5,3,31,12,19,41
CSKA Moscow,8465,2,10,5,5,27,19,8,35
Spart Moscow,8465,3,9,6,5,36,28,8,33
Krasnodar,8465,4,9,5,6,29,25,4,32
Zenit,8465,5,7,9,4,22,16,6,30
Terek Grozny,8465,6,8,6,6,24,24,0,30
FK Rubin,8465,7,6,6,8,27,19,8,24
Din Moscow,8465,8,6,6,8,19,26,-7,24
Rostov,8465,9,4,6,10,11,19,-8,18
Amkar,8465,10,4,6,10,11,24,-13,18
Anzhi,8465,11,2,6,12,16,41,-25,12
Loko Moscow,8466,1,11,6,3,31,14,17,39
Spart Moscow,8466,2,10,5,5,38,26,12,35
CSKA Moscow,8466,3,10,4,6,25,19,6,34
Zenit,8466,4,8,9,3,25,15,10,33
Krasnodar,8466,5,9,5,6,29,25,4,32
Terek Grozny,8466,6,7,6,7,21,25,-4,27
FK Rubin,8466,7,5,7,8,23,19,4,22
Din Moscow,8466,8,5,7,8,18,26,-8,22
Amkar,8466,9,6,4,10,12,22,-10,22
Rostov,8466,10,4,6,10,10,18,-8,18
Anzhi,8466,11,2,7,11,15,38,-23,13
Loko Moscow,8467,1,11,6,3,30,14,16,39
CSKA Moscow,8467,2,11,3,6,28,21,7,36
Spart Moscow,8467,3,10,5,5,42,26,16,35
Zenit,8467,4,9,8,3,26,14,12,35
Krasnodar,8467,5,9,5,6,30,25,5,32
Terek Grozny,8467,6,7,6,7,21,25,-4,27
FK Rubin,8467,7,6,5,9,23,19,4,23
Din Moscow,8467,8,5,6,9,17,29,-12,21
Amkar,8467,9,5,5,10,11,23,-12,20
Rostov,8467,10,4,6,10,10,20,-10,18
Anzhi,8467,11,3,5,12,17,39,-22,14
Loko Moscow,8468,1,13,5,2,36,13,23,44
CSKA Moscow,8468,2,12,3,5,30,19,11,39
Spart Moscow,8468,3,11,5,4,41,27,14,38
Zenit,8468,4,7,8,5,22,18,4,29
Krasnodar,8468,5,8,5,7,30,29,1,29
Terek Grozny,8468,6,8,5,7,21,23,-2,29
FK Rubin,8468,7,5,7,8,23,19,4,22
Din Moscow,8468,8,5,7,8,19,27,-8,22
Amkar,8468,9,5,4,11,11,24,-13,19
Rostov,8468,10,4,6,10,10,18,-8,18
Anzhi,8468,11,2,5,13,15,41,-26,11
Loko Moscow,8469,1,11,7,2,31,13,18,40
CSKA Moscow,8469,2,10,5,5,26,18,8,35
Spart Moscow,8469,3,9,6,5,35,27,8,33
Krasnodar,8469,4,9,5,6,34,25,9,32
Zenit,8469,5,7,10,3,22,14,8,31
Terek Grozny,8469,6,8,5,7,22,25,-3,29
Din Moscow,8469,7,5,8,7,17,21,-4,23
Amkar,8469,8,6,4,10,13,23,-10,22
FK Rubin,8469,9,5,6,9,21,23,-2,21
Rostov,8469,10,4,6,10,10,18,-8,18
Anzhi,8469,11,2,6,12,16,40,-24,12
Loko Moscow,8470,1,11,6,3,29,12,17,39
CSKA Moscow,8470,2,10,4,6,25,19,6,34
Zenit,8470,3,8,9,3,23,13,10,33
Spart Moscow,8470,4,9,5,6,39,31,8,32
Krasnodar,8470,5,9,5,6,29,25,4,32
Terek Grozny,8470,6,9,5,6,26,22,4,32
Din Moscow,8470,7,6,6,8,20,24,-4,24
FK Rubin,8470,8,5,6,9,22,20,2,21
Rostov,8470,9,5,6,9,12,18,-6,21
Amkar,8470,10,5,4,11,12,28,-16,19
Anzhi,8470,11,2,6,12,14,39,-25,12
Loko Moscow,8471,1,13,5,2,33,11,22,44
CSKA Moscow,8471,2,11,4,5,31,20,11,37
Spart Moscow,8471,3,10,5,5,37,28,9,35
Krasnodar,8471,4,9,4,7,29,27,2,31
Zenit,8471,5,7,9,4,23,16,7,30
Terek Grozny,8471,6,8,5,7,21,23,-2,29
Din Moscow,8471,7,5,7,8,18,23,-5,22
Amkar,8471,8,6,4,10,13,24,-11,22
FK Rubin,8471,9,5,6,9,22,20,2,21
Rostov,8471,10,4,6,10,10,18,-8,18
Anzhi,8471,11,2,5,13,15,42,-27,11
Loko Moscow,8472,1,11,6,3,29,12,17,39
Zenit,8472,2,8,9,3,22,13,9,33
Spart Moscow,8472,3,9,6,5,36,28,8,33
CSKA Moscow,8472,4,10,3,7,26,20,6,33
Krasnodar,8472,5,9,5,6,28,24,4,32
Terek Grozny,8472,6,7,5,8,20,25,-5,26
FK Rubin,8472,7,6,6,8,23,18,5,24
Din Moscow,8472,8,5,7,8,19,24,-5,22
Amkar,8472,9,6,4,10,13,22,-9,22
Rostov,8472,10,4,6,10,10,19,-9,18
Anzhi,8472,11,4,5,11,17,38,-21,17
Loko Moscow,8473,1,13,5,2,36,13,23,44
CSKA Moscow,8473,2,10,5,5,25,17,8,35
Spart Moscow,8473,3,9,6,5,35,27,8,33
Krasnodar,8473,4,9,4,7,30,27,3,31
Zenit,8473,5,7,9,4,21,17,4,30
Terek Grozny,8473,6,7,6,7,20,23,-3,27
FK Rubin,8473,7,6,5,9,22,18,4,23
Din Moscow,8473,8,5,7,8,17,22,-5,22
Amkar,8473,9,6,4,10,12,23,-11,22
Rostov,8473,10,4,6,10,10,18,-8,18
Anzhi,8473,11,2,7,11,14,37,-23,13
Loko Moscow,8474,1,11,6,3,30,13,17,39
CSKA Moscow,8474,2,11,3,6,27,20,7,36
Krasnodar,8474,3,10,4,6,30,24,6,34
Zenit,8474,4,8,9,3,25,14,11,33
Spart Moscow,8474,5,9,6,5,34,26,8,33
Terek Grozny,8474,6,8,6,6,22,23,-1,30
Din Moscow,8474,7,6,7,7,19,22,-3,25
FK Rubin,8474,8,5,5,10,22,21,1,20
Amkar,8474,9,5,5,10,11,23,-12,20
Rostov,8474,10,4,6,10,10,18,-8,18
Anzhi,8474,11,2,5,13,14,40,-26,11
Loko Moscow,8475,1,12,6,2,38,16,22,42
CSKA Moscow,8475,2,12,3,5,27,17,10,39
Spart Moscow,8475,3,9,7,4,39,28,11,34
Krasnodar,8475,4,9,5,6,33,29,4,32
Zenit,8475,5,7,8,5,22,19,3,29
Terek Grozny,8475,6,7,6,7,20,23,-3,27
Din Moscow,8475,7,5,8,7,20,24,-4,23
FK Rubin,8475,8,5,6,9,24,21,3,21
Rostov,8475,9,4,7,9,11,18,-7,19
Amkar,8475,10,4,5,11,10,26,-16,17
Anzhi,8475,11,3,5,12,15,38,-23,14
Loko Moscow,8476,1,13,5,2,33,12,21,44
CSKA Moscow,8476,2,11,3,6,29,19,10,36
Spart Moscow,8476,3,9,6,5,38,29,9,33
Zenit,8476,4,8,8,4,24,15,9,32
Terek Grozny,8476,5,9,5,6,23,23,0,32
Krasnodar,8476,6,9,4,7,30,28,2,31
Din Moscow,8476,7,7,6,7,20,22,-2,27
FK Rubin,8476,8,5,5,10,23,21,2,20
Rostov,8476,9,4,6,10,11,20,-9,18
Amkar,8476,10,4,5,11,10,24,-14,17
Anzhi,8476,11,2,5,13,15,43,-28,11
Loko Moscow,8477,1,13,5,2,35,14,21,44
CSKA Moscow,8477,2,11,4,5,30,20,10,37
Spart Moscow,8477,3,10,5,5,41,31,10,35
Krasnodar,8477,4,9,4,7,32,28,4,31
Zenit,8477,5,7,9,4,24,18,6,30
Terek Grozny,8477,6,7,7,6,21,23,-2,28
Din Moscow,8477,7,5,7,8,20,26,-6,22
FK Rubin,8477,8,5,6,9,22,20,2,21
Amkar,8477,9,5,5,10,12,24,-12,20
Rostov,8477,10,4,6,10,11,19,-8,18
Anzhi,8477,11,2,6,12,15,40,-25,12
Loko Moscow,8478,1,13,5,2,33,13,20,44
Spart Moscow,8478,2,10,5,5,39,28,11,35
CSKA Moscow,8478,3,10,4,6,26,19,7,34
Zenit,8478,4,8,8,4,23,15,8,32
Krasnodar,8478,5,8,5,7,29,27,2,29
Terek Grozny,8478,6,8,5,7,22,23,-1,29
Din Moscow,8478,7,6,6,8,20,27,-7,24
FK Rubin,8478,8,5,6,9,24,21,3,21
Rostov,8478,9,5,6,9,12,17,-5,21
Amkar,8478,10,4,4,12,10,26,-16,16
Anzhi,8478,11,3,6,11,16,38,-22,15
Loko Moscow,8479,1,11,6,3,30,13,17,39
CSKA Moscow,8479,2,10,4,6,26,19,7,34
Krasnodar,8479,3,10,4,6,31,25,6,34
Spart Moscow,8479,4,9,6,5,36,27,9,33
Zenit,8479,5,8,9,3,24,15,9,33
Terek Grozny,8479,6,8,6,6,21,22,-1,30
FK Rubin,8479,7,6,5,9,24,20,4,23
Din Moscow,8479,8,5,7,8,18,24,-6,22
Amkar,8479,9,5,4,11,10,23,-13,19
Rostov,8479,10,4,6,10,10,19,-9,18
Anzhi,8479,11,2,7,11,14,37,-23,13
Loko Moscow,8480,1,11,6,3,32,16,16,39
Spart Moscow,8480,2,10,6,4,42,26,16,36
CSKA Moscow,8480,3,10,4,6,27,21,6,34
Zenit,8480,4,8,9,3,26,16,10,33
Krasnodar,8480,5,9,4,7,29,25,4,31
Terek Grozny,8480,6,8,5,7,25,25,0,29
Din Moscow,8480,7,6,7,7,21,21,0,25
FK Rubin,8480,8,6,5,9,22,21,1,23
Amkar,8480,9,5,4,11,12,27,-15,19
Rostov,8480,10,4,6,10,10,22,-12,18
Anzhi,8480,11,2,6,12,17,43,-26,12
Loko Moscow,8481,1,13,5,2,32,12,20,44
Spart Moscow,8481,2,10,5,5,37,28,9,35
CSKA Moscow,8481,3,10,4,6,25,18,7,34
Zenit,8481,4,8,8,4,22,14,8,32
Krasnodar,8481,5,9,4,7,29,26,3,31
Terek Grozny,8481,6,7,5,8,20,27,-7,26
Din Moscow,8481,7,6,6,8,21,24,-3,24
Rostov,8481,8,5,6,9,12,17,-5,21
FK Rubin,8481,9,5,5,10,21,21,0,20
Amkar,8481,10,5,4,11,13,23,-10,19
Anzhi,8481,11,3,6,11,15,37,-22,15
Loko Moscow,8482,1,11,5,4,30,14,16,38
CSKA Moscow,8482,2,11,3,6,27,20,7,36
Spart Moscow,8482,3,10,5,5,38,27,11,35
Zenit,8482,4,9,8,3,25,14,11,35
Krasnodar,8482,5,9,4,7,29,29,0,31
Terek Grozny,8482,6,7,6,7,20,24,-4,27
FK Rubin,8482,7,6,6,8,28,20,8,24
Din Moscow,8482,8,5,7,8,19,25,-6,22
Amkar,8482,9,6,4,10,13,22,-9,22
Rostov,8482,10,4,6,10,10,20,-10,18
Anzhi,8482,11,2,6,12,15,39,-24,12
Loko Moscow,8483,1,13,5,2,32,12,20,44
Spart Moscow,8483,2,11,5,4,38,26,12,38
CSKA Moscow,8483,3,11,3,6,28,20,8,36
Zenit,8483,4,8,8,4,23,14,9,32
Terek Grozny,8483,5,8,6,6,21,22,-1,30
Krasnodar,8483,6,8,4,8,28,28,0,28
Din Moscow,8483,7,6,6,8,21,24,-3,24
FK Rubin,8483,8,6,5,9,23,20,3,23
Rostov,8483,9,4,6,10,10,18,-8,18
Amkar,8483,10,4,4,12,9,24,-15,16
Anzhi,8483,11,2,6,12,15,40,-25,12
Loko Moscow,8484,1,12,6,2,30,11,19,42
Spart Moscow,8484,2,10,5,5,39,28,11,35
CSKA Moscow,8484,3,10,5,5,26,18,8,35
Zenit,8484,4,7,10,3,21,13,8,31
Krasnodar,8484,5,8,4,8,27,27,0,28
Terek Grozny,8484,6,7,5,8,21,25,-4,26
Din Moscow,8484,7,6,6,8,18,24,-6,24
FK Rubin,8484,8,6,5,9,23,18,5,23
Rostov,8484,9,5,6,9,13,18,-5,21
Amkar,8484,10,5,4,11,10,24,-14,19
Anzhi,8484,11,3,6,11,17,39,-22,15
Loko Moscow,8485,1,11,5,4,31,15,16,38
CSKA Moscow,8485,2,11,4,5,29,17,12,37
Spart Moscow,8485,3,10,6,4,36,25,11,36
Zenit,8485,4,8,9,3,23,14,9,33
Krasnodar,8485,5,9,5,6,29,25,4,32
Terek Grozny,8485,6,9,5,6,23,23,0,32
Din Moscow,8485,7,6,7,7,18,21,-3,25
FK Rubin,8485,8,5,6,9,21,18,3,21
Rostov,8485,9,4,6,10,10,19,-9,18
Amkar,8485,10,4,4,12,10,25,-15,16
Anzhi,8485,11,2,5,13,14,42,-28,11
CSKA Moscow,8486,1,12,3,5,31,18,13,39
Loko Moscow,8486,2,11,5,4,29,14,15,38
Zenit,8486,3,8,8,4,23,15,8,32
Spart Moscow,8486,4,9,5,6,39,33,6,32
Krasnodar,8486,5,9,4,7,28,26,2,31
Terek Grozny,8486,6,7,7,6,21,23,-2,28
Din Moscow,8486,7,7,6,7,23,25,-2,27
FK Rubin,8486,8,6,5,9,24,19,5,23
Rostov,8486,9,5,6,9,13,17,-4,21
Amkar,8486,10,4,5,11,10,25,-15,17
Anzhi,8486,11,2,6,12,16,42,-26,12
Loko Moscow,8487,1,11,7,2,32,14,18,40
Spart Moscow,8487,2,10,6,4,37,27,10,36
CSKA Moscow,8487,3,11,3,6,27,20,7,36
Terek Grozny,8487,4,9,5,6,23,22,1,32
Zenit,8487,5,7,9,4,22,15,7,30
Krasnodar,8487,6,8,6,6,31,28,3,30
FK Rubin,8487,7,5,7,8,23,19,4,22
Din Moscow,8487,8,5,7,8,18,23,-5,22
Rostov,8487,9,4,7,9,10,17,-7,19
Amkar,8487,10,4,4,12,10,25,-15,16
Anzhi,8487,11,3,5,12,17,40,-23,14
Loko Moscow,8488,1,12,5,3,30,12,18,41
CSKA Moscow,8488,2,11,4,5,27,18,9,37
Spart Moscow,8488,3,10,5,5,38,29,9,35
Krasnodar,8488,4,10,4,6,29,24,5,34
Zenit,8488,5,7,9,4,22,15,7,30
Terek Grozny,8488,6,7,6,7,23,26,-3,27
FK Rubin,8488,7,6,5,9,23,19,4,23
Din Moscow,8488,8,5,6,9,20,26,-6,21
Amkar,8488,9,5,5,10,12,24,-12,20
Rostov,8488,10,4,6,10,10,18,-8,18
Anzhi,8488,11,3,5,12,17,40,-23,14
Loko Moscow,8489,1,12,5,3,30,13,17,41
Spart Moscow,8489,2,10,6,4,38,27,11,36
CSKA Moscow,8489,3,10,5,5,27,19,8,35
Zenit,8489,4,8,9,3,23,13,10,33
Krasnodar,8489,5,9,4,7,29,26,3,31
Terek Grozny,8489,6,7,6,7,20,23,-3,27
FK Rubin,8489,7,6,5,9,24,19,5,23
Din Moscow,8489,8,5,6,9,17,25,-8,21
Rostov,8489,9,4,6,10,11,19,-8,18
Amkar,8489,10,4,6,10,10,23,-13,18
Anzhi,8489,11,3,6,11,17,39,-22,15
Loko Moscow,8490,1,13,5,2,33,13,20,44
CSKA Moscow,8490,2,11,3,6,27,19,8,36
Spart Moscow,8490,3,9,7,4,41,32,9,34
Zenit,8490,4,8,8,4,23,15,8,32
Krasnodar,8490,5,9,4,7,32,27,5,31
Terek Grozny,8490,6,7,7,6,20,22,-2,28
Din Moscow,8490,7,5,8,7,22,26,-4,23
FK Rubin,8490,8,5,6,9,24,23,1,21
Rostov,8490,9,4,6,10,12,20,-8,18
Amkar,8490,10,4,6,10,11,24,-13,18
Anzhi,8490,11,2,6,12,15,39,-24,12
Loko Moscow,8491,1,12,5,3,33,14,19,41
CSKA Moscow,8491,2,11,3,6,29,20,9,36
Spart Moscow,8491,3,9,6,5,40,30,10,33
Krasnodar,8491,4,9,5,6,31,27,4,32
Terek Grozny,8491,5,8,6,6,23,23,0,30
Zenit,8491,6,7,8,5,22,18,4,29
Din Moscow,8491,7,5,8,7,20,24,-4,23
FK Rubin,8491,8,5,7,8,24,20,4,22
Rostov,8491,9,5,6,9,13,19,-6,21
Amkar,8491,10,4,5,11,9,25,-16,17
Anzhi,8491,11,3,5,12,18,42,-24,14
Loko Moscow,8492,1,11,6,3,30,14,16,39
CSKA Moscow,8492,2,12,3,5,29,19,10,39
Spart Moscow,8492,3,9,6,5,37,27,10,33
Zenit,8492,4,8,8,4,25,16,9,32
Krasnodar,8492,5,8,6,6,30,27,3,30
Terek Grozny,8492,6,8,6,6,21,22,-1,30
Din Moscow,8492,7,6,6,8,20,26,-6,24
FK Rubin,8492,8,5,6,9,25,22,3,21
Rostov,8492,9,5,6,9,11,17,-6,21
Amkar,8492,10,4,5,11,10,24,-14,17
Anzhi,8492,11,2,6,12,14,38,-24,12
Loko Moscow,8493,1,11,5,4,32,16,16,38
CSKA Moscow,8493,2,11,4,5,29,17,12,37
Zenit,8493,3,8,9,3,24,15,9,33
Spart Moscow,8493,4,9,6,5,37,31,6,33
Krasnodar,8493,5,9,4,7,29,26,3,31
Terek Grozny,8493,6,8,6,6,23,24,-1,30
FK Rubin,8493,7,7,5,8,23,17,6,26
Din Moscow,8493,8,5,7,8,18,23,-5,22
Amkar,8493,9,5,5,10,13,23,-10,20
Rostov,8493,10,4,6,10,12,20,-8,18
Anzhi,8493,11,2,5,13,15,43,-28,11
CSKA Moscow,8494,1,12,3,5,28,18,10,39
Loko Moscow,8494,2,11,5,4,29,14,15,38
Spart Moscow,8494,3,10,5,5,39,29,10,35
Zenit,8494,4,8,8,4,23,14,9,32
Krasnodar,8494,5,9,5,6,29,25,4,32
Terek Grozny,8494,6,8,6,6,23,23,0,30
FK Rubin,8494,7,6,6,8,23,18,5,24
Din Moscow,8494,8,5,6,9,17,24,-7,21
Amkar,8494,9,5,5,10,13,24,-11,20
Rostov,8494,10,4,6,10,11,20,-9,18
Anzhi,8494,11,2,5,13,15,41,-26,11
Loko Moscow,8495,1,11,5,4,30,14,16,38
Spart Moscow,8495,2,11,5,4,42,27,15,38
CSKA Moscow,8495,3,11,4,5,26,17,9,37
Krasnodar,8495,4,10,4,6,29,24,5,34
Zenit,8495,5,8,9,3,23,14,9,33
Terek Grozny,8495,6,8,5,7,23,23,0,29
Din Moscow,8495,7,6,6,8,20,24,-4,24
FK Rubin,8495,8,5,5,10,21,19,2,20
Rostov,8495,9,4,6,10,10,19,-9,18
Amkar,8495,10,4,4,12,9,29,-20,16
Anzhi,8495,11,3,5,12,15,38,-23,14
Loko Moscow,8496,1,12,6,2,33,13,20,42
CSKA Moscow,8496,2,12,3,5,29,18,11,39
Spart Moscow,8496,3,10,6,4,40,26,14,36
Krasnodar,8496,4,9,4,7,29,27,2,31
Zenit,8496,5,7,9,4,22,15,7,30
Terek Grozny,8496,6,8,5,7,22,24,-2,29
FK Rubin,8496,7,6,5,9,22,18,4,23
Din Moscow,8496,8,5,6,9,18,26,-8,21
Rostov,8496,9,4,7,9,10,17,-7,19
Amkar,8496,10,5,4,11,11,25,-14,19
Anzhi,8496,11,2,5,13,15,42,-27,11
Loko Moscow,8497,1,11,6,3,31,14,17,39
CSKA Moscow,8497,2,12,3,5,29,19,10,39
Krasnodar,8497,3,10,4,6,30,25,5,34
Spart Moscow,8497,4,9,5,6,38,32,6,32
Zenit,8497,5,7,9,4,23,16,7,30
Terek Grozny,8497,6,8,5,7,22,23,-1,29
Din Moscow,8497,7,6,6,8,22,24,-2,24
Rostov,8497,8,5,6,9,12,18,-6,21
FK Rubin,8497,9,5,5,10,21,21,0,20
Amkar,8497,10,5,4,11,12,25,-13,19
Anzhi,8497,11,3,5,12,16,39,-23,14
Loko Moscow,8498,1,12,5,3,32,14,18,41
CSKA Moscow,8498,2,11,3,6,30,19,11,36
Zenit,8498,3,9,8,3,26,15,11,35
Spart Moscow,8498,4,10,5,5,37,28,9,35
Krasnodar,8498,5,9,4,7,30,28,2,31
Terek Grozny,8498,6,7,6,7,20,23,-3,27
Din Moscow,8498,7,5,7,8,17,23,-6,22
FK Rubin,8498,8,5,6,9,23,20,3,21
Amkar,8498,9,5,5,10,11,22,-11,20
Rostov,8498,10,4,6,10,11,19,-8,18
Anzhi,8498,11,3,5,12,15,41,-26,14
Loko Moscow,8499,1,13,5,2,36,11,25,44
Spart Moscow,8499,2,10,6,4,41,27,14,36
CSKA Moscow,8499,3,10,4,6,26,19,7,34
Zenit,8499,4,8,8,4,22,16,6,32
Krasnodar,8499,5,9,4,7,28,28,0,31
Terek Grozny,8499,6,7,5,8,21,25,-4,26
Din Moscow,8499,7,6,6,8,19,25,-6,24
FK Rubin,8499,8,5,5,10,21,20,1,20
Amkar,8499,9,5,5,10,11,23,-12,20
Rostov,8499,10,4,6,10,11,20,-9,18
Anzhi,8499,11,3,6,11,17,39,-22,15
Loko Moscow,8500,1,13,5,2,36,15,21,44
CSKA Moscow,8500,2,10,5,5,26,18,8,35
Zenit,8500,3,7,9,4,23,16,7,30
Spart Moscow,8500,4,8,6,6,35,29,6,30
Krasnodar,8500,5,8,4,8,31,31,0,28
Terek Grozny,8500,6,7,7,6,23,25,-2,28
FK Rubin,8500,7,7,5,8,24,18,6,26
Din Moscow,8500,8,5,7,8,18,23,-5,22
Rostov,8500,9,5,6,9,12,18,-6,21
Amkar,8500,10,5,5,10,12,24,-12,20
Anzhi,8500,11,2,7,11,15,38,-23,13
Loko Moscow,8501,1,12,5,3,30,12,18,41
CSKA Moscow,8501,2,11,4,5,28,17,11,37
Spart Moscow,8501,3,10,6,4,42,28,14,36
Zenit,8501,4,8,9,3,22,13,9,33
Terek Grozny,8501,5,8,5,7,22,24,-2,29
Krasnodar,8501,6,8,4,8,27,26,1,28
Din Moscow,8501,7,6,6,8,19,26,-7,24
FK Rubin,8501,8,6,5,9,23,19,4,23
Rostov,8501,9,4,6,10,10,19,-9,18
Amkar,8501,10,4,5,11,13,27,-14,17
Anzhi,8501,11,3,5,12,15,40,-25,14
CSKA Moscow,8502,1,12,3,5,32,18,14,39
Loko Moscow,8502,2,11,5,4,31,17,14,38
Spart Moscow,8502,3,9,6,5,37,29,8,33
Zenit,8502,4,8,8,4,25,16,9,32
Krasnodar,8502,5,9,4,7,30,26,4,31
Terek Grozny,8502,6,7,6,7,24,27,-3,27
FK Rubin,8502,7,7,5,8,25,19,6,26
Din Moscow,8502,8,5,7,8,19,24,-5,22
Amkar,8502,9,5,5,10,14,26,-12,20
Rostov,8502,10,4,6,10,12,20,-8,18
Anzhi,8502,11,3,5,12,16,43,-27,14
Loko Moscow,8503,1,12,6,2,30,11,19,42
Spart Moscow,8503,2,11,5,4,40,27,13,38
CSKA Moscow,8503,3,11,3,6,27,19,8,36
Zenit,8503,4,8,9,3,23,13,10,33
Krasnodar,8503,5,8,4,8,28,27,1,28
Terek Grozny,8503,6,7,7,6,22,24,-2,28
FK Rubin,8503,7,6,6,8,24,19,5,24
Din Moscow,8503,8,5,7,8,18,24,-6,22
Rostov,8503,9,4,6,10,11,20,-9,18
Amkar,8503,10,4,5,11,11,25,-14,17
Anzhi,8503,11,2,6,12,15,40,-25,12
Loko Moscow,8504,1,13,5,2,34,13,21,44
Spart Moscow,8504,2,10,6,4,40,28,12,36
CSKA Moscow,8504,3,10,4,6,27,20,7,34
Zenit,8504,4,7,9,4,22,15,7,30
Krasnodar,8504,5,8,4,8,30,30,0,28
Terek Grozny,8504,6,7,7,6,21,23,-2,28
Din Moscow,8504,7,6,6,8,18,24,-6,24
FK Rubin,8504,8,6,5,9,23,19,4,23
Rostov,8504,9,4,7,9,11,18,-7,19
Amkar,8504,10,4,5,11,11,25,-14,17
Anzhi,8504,11,3,6,11,17,39,-22,15
Loko Moscow,8505,1,11,6,3,30,13,17,39
CSKA Moscow,8505,2,12,3,5,29,17,12,39
Spart Moscow,8505,3,10,5,5,43,29,14,35
Zenit,8505,4,8,8,4,23,15,8,32
Krasnodar,8505,5,9,5,6,28,24,4,32
Terek Grozny,8505,6,9,5,6,23,22,1,32
Din Moscow,8505,7,6,6,8,20,27,-7,24
FK Rubin,8505,8,5,5,10,21,19,2,20
Amkar,8505,9,5,4,11,11,24,-13,19
Rostov,8505,10,4,6,10,10,20,-10,18
Anzhi,8505,11,2,5,13,14,42,-28,11
Loko Moscow,8506,1,11,6,3,32,15,17,39
CSKA Moscow,8506,2,12,3,5,32,18,14,39
Spart Moscow,8506,3,10,5,5,36,26,10,35
Krasnodar,8506,4,9,4,7,32,29,3,31
Zenit,8506,5,7,9,4,22,16,6,30
Terek Grozny,8506,6,7,6,7,20,23,-3,27
FK Rubin,8506,7,7,5,8,24,18,6,26
Din Moscow,8506,8,6,6,8,18,22,-4,24
Rostov,8506,9,4,6,10,10,19,-9,18
Amkar,8506,10,4,5,11,9,23,-14,17
Anzhi,8506,11,3,5,12,15,41,-26,14
Loko Moscow,8507,1,11,5,4,29,16,13,38
CSKA Moscow,8507,2,11,4,5,30,20,10,37
Krasnodar,8507,3,10,4,6,34,25,9,34
Zenit,8507,4,8,9,3,24,15,9,33
Spart Moscow,8507,5,9,6,5,37,29,8,33
Terek Grozny,8507,6,8,5,7,22,23,-1,29
Din Moscow,8507,7,6,7,7,20,23,-3,25
FK Rubin,8507,8,5,6,9,23,21,2,21
Rostov,8507,9,4,6,10,11,19,-8,18
Amkar,8507,10,4,5,11,10,25,-15,17
Anzhi,8507,11,3,5,12,16,40,-24,14
Loko Moscow,8508,1,12,5,3,30,13,17,41
CSKA Moscow,8508,2,11,3,6,26,18,8,36
Zenit,8508,3,8,8,4,22,14,8,32
Krasnodar,8508,4,9,5,6,30,25,5,32
Spart Moscow,8508,5,8,7,5,36,31,5,31
Terek Grozny,8508,6,8,5,7,22,23,-1,29
FK Rubin,8508,7,6,6,8,24,19,5,24
Din Moscow,8508,8,6,6,8,21,23,-2,24
Amkar,8508,9,5,5,10,12,24,-12,20
Rostov,8508,10,4,7,9,11,18,-7,19
Anzhi,8508,11,2,5,13,14,40,-26,11
Loko Moscow,8509,1,12,5,3,32,14,18,41
CSKA Moscow,8509,2,11,3,6,28,20,8,36
Spart Moscow,8509,3,8,8,4,37,29,8,32
Zenit,8509,4,8,8,4,23,15,8,32
Krasnodar,8509,5,9,4,7,30,27,3,31
Terek Grozny,8509,6,8,5,7,22,25,-3,29
FK Rubin,8509,7,6,6,8,22,17,5,24
Din Moscow,8509,8,5,8,7,19,23,-4,23
Rostov,8509,9,4,7,9,10,17,-7,19
Amkar,8509,10,4,5,11,11,25,-14,17
Anzhi,8509,11,3,5,12,18,40,-22,14
Loko Moscow,8510,1,13,5,2,33,13,20,44
CSKA Moscow,8510,2,11,3,6,28,20,8,36
Spart Moscow,8510,3,9,6,5,38,30,8,33
Zenit,8510,4,8,8,4,25,16,9,32
Krasnodar,8510,5,8,5,7,28,26,2,29
Terek Grozny,8510,6,8,5,7,22,24,-2,29
Din Moscow,8510,7,5,8,7,19,23,-4,23
FK Rubin,8510,8,5,7,8,21,17,4,22
Rostov,8510,9,5,6,9,13,19,-6,21
Amkar,8510,10,4,4,12,9,24,-15,16
Anzhi,8510,11,3,5,12,16,40,-24,14
Loko Moscow,8511,1,12,6,2,33,13,20,42
CSKA Moscow,8511,2,11,4,5,27,18,9,37
Spart Moscow,8511,3,10,5,5,38,30,8,35
Krasnodar,8511,4,9,5,6,31,26,5,32
Zenit,8511,5,7,9,4,21,15,6,30
Terek Grozny,8511,6,7,6,7,24,28,-4,27
FK Rubin,8511,7,6,5,9,23,20,3,23
Amkar,8511,8,6,4,10,14,23,-9,22
Din Moscow,8511,9,5,6,9,20,26,-6,21
Rostov,8511,10,4,6,10,11,19,-8,18
Anzhi,8511,11,2,6,12,18,42,-24,12
Loko Moscow,8512,1,12,5,3,31,14,17,41
CSKA Moscow,8512,2,12,3,5,28,18,10,39
Krasnodar,8512,3,10,4,6,30,24,6,34
Spart Moscow,8512,4,9,6,5,35,27,8,33
Zenit,8512,5,7,8,5,23,17,6,29
Terek Grozny,8512,6,7,5,8,23,30,-7,26
Din Moscow,8512,7,5,8,7,18,22,-4,23
Amkar,8512,8,6,4,10,13,23,-10,22
FK Rubin,8512,9,5,6,9,22,19,3,21
Rostov,8512,10,4,6,10,10,18,-8,18
Anzhi,8512,11,3,5,12,20,41,-21,14
Loko Moscow,8513,1,12,5,3,34,13,21,41
Spart Moscow,8513,2,10,5,5,36,27,9,35
CSKA Moscow,8513,3,10,3,7,27,21,6,33
Zenit,8513,4,8,8,4,23,18,5,32
Krasnodar,8513,5,9,4,7,30,28,2,31
Terek Grozny,8513,6,7,6,7,21,24,-3,27
FK Rubin,8513,7,6,6,8,24,18,6,24
Din Moscow,8513,8,5,7,8,17,23,-6,22
Amkar,8513,9,5,5,10,12,23,-11,20
Rostov,8513,10,4,6,10,10,18,-8,18
Anzhi,8513,11,4,5,11,17,38,-21,17
Loko Moscow,8514,1,11,6,3,32,16,16,39
CSKA Moscow,8514,2,11,4,5,27,18,9,37
Spart Moscow,8514,3,10,5,5,37,28,9,35
Zenit,8514,4,8,9,3,23,13,10,33
Krasnodar,8514,5,8,5,7,30,28,2,29
Terek Grozny,8514,6,7,6,7,20,23,-3,27
FK Rubin,8514,7,7,5,8,23,17,6,26
Din Moscow,8514,8,5,6,9,17,23,-6,21
Amkar,8514,9,5,5,10,11,23,-12,20
Rostov,8514,10,4,6,10,11,19,-8,18
Anzhi,8514,11,3,5,12,16,39,-23,14
Loko Moscow,8515,1,12,5,3,32,13,19,41
CSKA Moscow,8515,2,11,3,6,29,21,8,36
Zenit,8515,3,9,8,3,24,14,10,35
Spart Moscow,8515,4,9,6,5,37,30,7,33
Krasnodar,8515,5,8,4,8,28,28,0,28
Terek Grozny,8515,6,7,7,6,23,25,-2,28
Din Moscow,8515,7,7,6,7,24,22,2,27
FK Rubin,8515,8,6,5,9,23,21,2,23
Rostov,8515,9,4,6,10,10,19,-9,18
Amkar,8515,10,4,6,10,11,24,-13,18
Anzhi,8515,11,2,6,12,19,43,-24,12
Loko Moscow,8516,1,11,5,4,30,14,16,38
Spart Moscow,8516,2,10,5,5,36,27,9,35
CSKA Moscow,8516,3,10,5,5,26,18,8,35
Krasnodar,8516,4,10,4,6,32,24,8,34
Zenit,8516,5,8,9,3,23,14,9,33
Terek Grozny,8516,6,8,6,6,24,24,0,30
Din Moscow,8516,7,6,6,8,18,23,-5,24
FK Rubin,8516,8,5,5,10,21,22,-1,20
Amkar,8516,9,5,5,10,12,23,-11,20
Rostov,8516,10,4,6,10,10,18,-8,18
Anzhi,8516,11,2,6,12,16,41,-25,12
Loko Moscow,8517,1,12,5,3,32,15,17,41
CSKA Moscow,8517,2,11,3,6,27,19,8,36
Spart Moscow,8517,3,10,5,5,37,29,8,35
Zenit,8517,4,8,8,4,23,15,8,32
Krasnodar,8517,5,9,5,6,30,25,5,32
Terek Grozny,8517,6,7,6,7,23,29,-6,27
FK Rubin,8517,7,5,7,8,22,18,4,22
Din Moscow,8517,8,5,7,8,18,24,-6,22
Amkar,8517,9,6,4,10,17,23,-6,22
Rostov,8517,10,4,6,10,11,19,-8,18
Anzhi,8517,11,2,6,12,17,41,-24,12
Loko Moscow,8518,1,12,6,2,33,14,19,42
Spart Moscow,8518,2,11,5,4,38,26,12,38
CSKA Moscow,8518,3,10,4,6,26,19,7,34
Zenit,8518,4,7,10,3,25,17,8,31
Krasnodar,8518,5,8,4,8,28,28,0,28
Terek Grozny,8518,6,7,6,7,20,23,-3,27
FK Rubin,8518,7,7,5,8,26,19,7,26
Din Moscow,8518,8,5,6,9,18,24,-6,21
Rostov,8518,9,4,6,10,10,19,-9,18
Amkar,8518,10,4,5,11,10,24,-14,17
Anzhi,8518,11,4,5,11,16,37,-21,17
Loko Moscow,8519,1,11,6,3,31,14,17,39
CSKA Moscow,8519,2,12,3,5,32,17,15,39
Spart Moscow,8519,3,10,5,5,41,29,12,35
Zenit,8519,4,8,8,4,22,15,7,32
Krasnodar,8519,5,9,5,6,31,27,4,32
Terek Grozny,8519,6,7,6,7,21,24,-3,27
Din Moscow,8519,7,6,6,8,20,26,-6,24
Rostov,8519,8,5,6,9,14,20,-6,21
FK Rubin,8519,9,5,5,10,23,22,1,20
Amkar,8519,10,5,4,11,10,23,-13,19
Anzhi,8519,11,2,6,12,15,43,-28,12
Loko Moscow,8520,1,11,6,3,31,14,17,39
CSKA Moscow,8520,2,12,3,5,30,17,13,39
Spart Moscow,8520,3,9,7,4,40,30,10,34
Krasnodar,8520,4,10,4,6,33,27,6,34
Zenit,8520,5,7,9,4,21,16,5,30
Terek Grozny,8520,6,8,5,7,23,26,-3,29
FK Rubin,8520,7,6,5,9,24,21,3,23
Din Moscow,8520,8,5,7,8,21,26,-5,22
Amkar,8520,9,5,5,10,14,25,-11,20
Rostov,8520,10,4,6,10,10,19,-9,18
Anzhi,8520,11,2,5,13,15,41,-26,11
Loko Moscow,8521,1,12,6,2,30,11,19,42
CSKA Moscow,8521,2,12,3,5,34,18,16,39
Spart Moscow,8521,3,10,5,5,38,28,10,35
Krasnodar,8521,4,9,4,7,31,25,6,31
Zenit,8521,5,7,9,4,22,16,6,30
Terek Grozny,8521,6,7,6,7,23,26,-3,27
Din Moscow,8521,7,6,6,8,20,23,-3,24
FK Rubin,8521,8,5,5,10,22,24,-2,20
Amkar,8521,9,5,5,10,13,25,-12,20
Rostov,8521,10,4,6,10,10,19,-9,18
Anzhi,8521,11,3,5,12,17,45,-28,14
Loko Moscow,8522,1,12,6,2,32,13,19,42
CSKA Moscow,8522,2,11,3,6,28,22,6,36
Spart Moscow,8522,3,9,6,5,36,27,9,33
Zenit,8522,4,8,8,4,26,15,11,32
Krasnodar,8522,5,8,6,6,30,27,3,30
Terek Grozny,8522,6,7,5,8,21,25,-4,26
Din Moscow,8522,7,5,8,7,19,23,-4,23
FK Rubin,8522,8,5,7,8,23,19,4,22
Rostov,8522,9,5,6,9,11,17,-6,21
Amkar,8522,10,5,4,11,11,25,-14,19
Anzhi,8522,11,3,5,12,15,39,-24,14
Loko Moscow,8523,1,13,5,2,32,12,20,44
CSKA Moscow,8523,2,12,3,5,28,17,11,39
Spart Moscow,8523,3,11,5,4,37,26,11,38
Terek Grozny,8523,4,8,6,6,23,24,-1,30
Zenit,8523,5,7,8,5,22,16,6,29
Krasnodar,8523,6,8,5,7,30,28,2,29
Din Moscow,8523,7,6,6,8,21,24,-3,24
FK Rubin,8523,8,5,6,9,25,23,2,21
Rostov,8523,9,4,6,10,10,18,-8,18
Amkar,8523,10,4,5,11,10,24,-14,17
Anzhi,8523,11,2,5,13,15,41,-26,11
Loko Moscow,8524,1,11,6,3,32,16,16,39
CSKA Moscow,8524,2,12,3,5,29,19,10,39
Spart Moscow,8524,3,8,7,5,37,31,6,31
Krasnodar,8524,4,9,4,7,32,28,4,31
Zenit,8524,5,7,9,4,23,16,7,30
Terek Grozny,8524,6,8,6,6,21,22,-1,30
FK Rubin,8524,7,7,5,8,24,18,6,26
Din Moscow,8524,8,5,7,8,19,24,-5,22
Rostov,8524,9,4,7,9,12,19,-7,19
Amkar,8524,10,5,4,11,11,23,-12,19
Anzhi,8524,11,2,6,12,15,39,-24,12
Loko Moscow,8525,1,12,5,3,31,14,17,41
CSKA Moscow,8525,2,11,3,6,28,20,8,36
Krasnodar,8525,3,10,4,6,32,25,7,34
Zenit,8525,4,8,8,4,23,15,8,32
Spart Moscow,8525,5,9,5,6,36,29,7,32
Terek Grozny,8525,6,8,5,7,22,24,-2,29
Din Moscow,8525,7,7,6,7,22,23,-1,27
Amkar,8525,8,6,4,10,12,23,-11,22
FK Rubin,8525,9,5,5,10,23,22,1,20
Rostov,8525,10,4,6,10,10,19,-9,18
Anzhi,8525,11,2,5,13,16,41,-25,11
Loko Moscow,8526,1,11,6,3,29,12,17,39
CSKA Moscow,8526,2,11,4,5,28,18,10,37
Zenit,8526,3,8,8,4,22,15,7,32
Spart Moscow,8526,4,9,5,6,36,31,5,32
Krasnodar,8526,5,8,5,7,27,25,2,29
Terek Grozny,8526,6,8,5,7,23,23,0,29
Din Moscow,8526,7,6,6,8,21,25,-4,24
FK Rubin,8526,8,6,5,9,24,20,4,23
Amkar,8526,9,6,4,10,13,23,-10,22
Rostov,8526,10,5,6,9,12,17,-5,21
Anzhi,8526,11,2,6,12,15,41,-26,12
Loko Moscow,8527,1,11,6,3,29,12,17,39
CSKA Moscow,8527,2,11,4,5,31,18,13,37
Zenit,8527,3,8,9,3,23,14,9,33
Spart Moscow,8527,4,9,5,6,37,30,7,32
Krasnodar,8527,5,8,6,6,28,25,3,30
Terek Grozny,8527,6,7,6,7,22,25,-3,27
FK Rubin,8527,7,6,6,8,23,18,5,24
Rostov,8527,8,5,6,9,13,17,-4,21
Din Moscow,8527,9,5,6,9,17,25,-8,21
Amkar,8527,10,5,5,10,12,24,-12,20
Anzhi,8527,11,3,5,12,16,43,-27,14
Loko Moscow,8528,1,12,5,3,31,14,17,41
Spart Moscow,8528,2,11,5,4,44,29,15,38
CSKA Moscow,8528,3,11,4,5,28,19,9,37
Zenit,8528,4,8,9,3,23,13,10,33
Krasnodar,8528,5,8,5,7,28,26,2,29
Terek Grozny,8528,6,7,5,8,21,27,-6,26
FK Rubin,8528,7,5,7,8,21,17,4,22
Din Moscow,8528,8,5,7,8,18,26,-8,22
Amkar,8528,9,5,4,11,12,25,-13,19
Rostov,8528,10,4,6,10,11,20,-9,18
Anzhi,8528,11,3,5,12,20,41,-21,14
Loko Moscow,8529,1,12,5,3,30,14,16,41
CSKA Moscow,8529,2,11,3,6,30,20,10,36
Spart Moscow,8529,3,8,8,4,37,29,8,32
Zenit,8529,4,8,8,4,23,15,8,32
Krasnodar,8529,5,9,5,6,31,25,6,32
Terek Grozny,8529,6,8,6,6,24,25,-1,30
Din Moscow,8529,7,6,7,7,20,23,-3,25
FK Rubin,8529,8,5,6,9,23,20,3,21
Rostov,8529,9,4,7,9,11,18,-7,19
Amkar,8529,10,4,5,11,11,25,-14,17
Anzhi,8529,11,2,6,12,18,44,-26,12
Loko Moscow,8530,1,11,5,4,29,14,15,38
Spart Moscow,8530,2,11,5,4,37,25,12,38
CSKA Moscow,8530,3,11,4,5,30,18,12,37
Zenit,8530,4,8,9,3,23,14,9,33
Krasnodar,8530,5,9,4,7,30,27,3,31
Terek Grozny,8530,6,7,6,7,21,24,-3,27
Din Moscow,8530,7,6,6,8,20,23,-3,24
FK Rubin,8530,8,6,5,9,25,21,4,23
Amkar,8530,9,5,4,11,10,24,-14,19
Rostov,8530,10,4,6,10,10,18,-8,18
Anzhi,8530,11,2,6,12,15,42,-27,12
Loko Moscow,8531,1,11,7,2,31,13,18,40
CSKA Moscow,8531,2,11,4,5,29,19,10,37
Spart Moscow,8531,3,10,6,4,40,29,11,36
Zenit,8531,4,7,10,3,23,15,8,31
Krasnodar,8531,5,8,5,7,28,26,2,29
Terek Grozny,8531,6,8,5,7,21,25,-4,29
FK Rubin,8531,7,7,5,8,23,17,6,26
Din Moscow,8531,8,5,6,9,17,24,-7,21
Amkar,8531,9,5,5,10,14,24,-10,20
Rostov,8531,10,4,6,10,12,20,-8,18
Anzhi,8531,11,2,5,13,15,41,-26,11
Loko Moscow,8532,1,12,5,3,31,12,19,41
CSKA Moscow,8532,2,12,3,5,29,18,11,39
Spart Moscow,8532,3,9,6,5,35,28,7,33
Zenit,8532,4,8,8,4,22,14,8,32
Krasnodar,8532,5,9,4,7,29,27,2,31
Terek Grozny,8532,6,7,7,6,21,23,-2,28
Din Moscow,8532,7,6,7,7,19,22,-3,25
FK Rubin,8532,8,5,5,10,22,20,2,20
Amkar,8532,9,5,5,10,12,23,-11,20
Rostov,8532,10,4,6,10,10,18,-8,18
Anzhi,8532,11,2,6,12,15,40,-25,12
Loko Moscow,8533,1,12,5,3,35,17,18,41
Spart Moscow,8533,2,11,5,4,39,26,13,38
CSKA Moscow,8533,3,11,4,5,29,18,11,37
Krasnodar,8533,4,9,4,7,33,27,6,31
Zenit,8533,5,7,9,4,23,19,4,30
Terek Grozny,8533,6,7,7,6,23,25,-2,28
FK Rubin,8533,7,7,5,8,24,18,6,26
Din Moscow,8533,8,5,6,9,17,24,-7,21
Rostov,8533,9,4,6,10,10,18,-8,18
Amkar,8533,10,4,5,11,11,26,-15,17
Anzhi,8533,11,2,6,12,16,42,-26,12
Loko Moscow,8534,1,12,5,3,31,12,19,41
CSKA Moscow,8534,2,11,4,5,26,17,9,37
Krasnodar,8534,3,9,4,7,28,25,3,31
Spart Moscow,8534,4,8,6,6,34,28,6,30
Zenit,8534,5,7,9,4,21,15,6,30
Terek Grozny,8534,6,7,7,6,21,23,-2,28
Din Moscow,8534,7,6,7,7,20,21,-1,25
FK Rubin,8534,8,6,5,9,22,20,2,23
Rostov,8534,9,5,6,9,12,18,-6,21
Amkar,8534,10,5,5,10,10,22,-12,20
Anzhi,8534,11,2,6,12,15,39,-24,12
Loko Moscow,8535,1,12,5,3,31,13,18,41
CSKA Moscow,8535,2,11,3,6,28,20,8,36
Zenit,8535,3,9,8,3,23,13,10,35
Spart Moscow,8535,4,9,7,4,35,26,9,34
Krasnodar,8535,5,9,4,7,31,27,4,31
Terek Grozny,8535,6,7,5,8,22,26,-4,26
Din Moscow,8535,7,6,7,7,19,22,-3,25
FK Rubin,8535,8,5,5,10,22,21,1,20
Rostov,8535,9,4,7,9,10,17,-7,19
Amkar,8535,10,5,4,11,10,23,-13,19
Anzhi,8535,11,3,5,12,19,42,-23,14
Loko Moscow,8536,1,11,6,3,32,18,14,39
CSKA Moscow,8536,2,12,3,5,29,18,11,39
Spart Moscow,8536,3,10,6,4,35,25,10,36
Krasnodar,8536,4,10,4,6,35,26,9,34
Zenit,8536,5,7,9,4,24,17,7,30
Terek Grozny,8536,6,7,5,8,20,24,-4,26
Din Moscow,8536,7,6,6,8,18,22,-4,24
FK Rubin,8536,8,5,5,10,22,21,1,20
Amkar,8536,9,5,5,10,10,22,-12,20
Rostov,8536,10,4,6,10,10,18,-8,18
Anzhi,8536,11,3,5,12,15,39,-24,14
Loko Moscow,8537,1,13,5,2,33,11,22,44
CSKA Moscow,8537,2,11,3,6,29,20,9,36
Spart Moscow,8537,3,9,6,5,37,29,8,33
Zenit,8537,4,8,8,4,23,16,7,32
Krasnodar,8537,5,8,4,8,27,27,0,28
Din Moscow,8537,6,7,6,7,21,21,0,27
Terek Grozny,8537,7,7,5,8,21,25,-4,26
FK Rubin,8537,8,6,5,9,22,19,3,23
Rostov,8537,9,4,7,9,11,18,-7,19
Amkar,8537,10,5,4,11,11,25,-14,19
Anzhi,8537,11,3,5,12,17,41,-24,14
Loko Moscow,8538,1,13,5,2,33,12,21,44
Spart Moscow,8538,2,10,6,4,37,26,11,36
CSKA Moscow,8538,3,11,3,6,29,18,11,36
Zenit,8538,4,8,8,4,23,15,8,32
Krasnodar,8538,5,9,4,7,30,27,3,31
Terek Grozny,8538,6,8,5,7,24,25,-1,29
Din Moscow,8538,7,6,6,8,19,22,-3,24
FK Rubin,8538,8,5,5,10,22,22,0,20
Rostov,8538,9,4,7,9,11,18,-7,19
Amkar,8538,10,4,4,12,10,28,-18,16
Anzhi,8538,11,3,5,12,16,41,-25,14
Loko Moscow,8539,1,12,6,2,32,13,19,42
CSKA Moscow,8539,2,11,4,5,27,17,10,37
Spart Moscow,8539,3,9,6,5,37,29,8,33
Krasnodar,8539,4,9,5,6,30,26,4,32
Zenit,8539,5,7,9,4,21,14,7,30
Terek Grozny,8539,6,7,5,8,21,27,-6,26
Din Moscow,8539,7,6,7,7,19,22,-3,25
FK Rubin,8539,8,5,6,9,22,19,3,21
Amkar,8539,9,5,5,10,12,24,-12,20
Rostov,8539,10,4,6,10,11,19,-8,18
Anzhi,8539,11,3,5,12,18,40,-22,14
Loko Moscow,8540,1,13,5,2,32,11,21,44
CSKA Moscow,8540,2,11,3,6,28,22,6,36
Spart Moscow,8540,3,9,7,4,35,26,9,34
Zenit,8540,4,7,8,5,22,16,6,29
Krasnodar,8540,5,8,4,8,28,30,-2,28
Terek Grozny,8540,6,7,5,8,22,30,-8,26
Din Moscow,8540,7,6,7,7,19,22,-3,25
FK Rubin,8540,8,6,5,9,26,20,6,23
Rostov,8540,9,4,7,9,11,18,-7,19
Amkar,8540,10,5,4,11,12,25,-13,19
Anzhi,8540,11,4,5,11,23,38,-15,17
Loko Moscow,8541,1,12,5,3,31,12,19,41
CSKA Moscow,8541,2,11,3,6,27,19,8,36
Krasnodar,8541,3,10,4,6,30,25,5,34
Zenit,8541,4,8,8,4,23,15,8,32
Spart Moscow,8541,5,9,5,6,37,31,6,32
Terek Grozny,8541,6,7,7,6,22,24,-2,28
Din Moscow,8541,7,6,6,8,19,23,-4,24
FK Rubin,8541,8,6,5,9,24,19,5,23
Amkar,8541,9,5,5,10,12,24,-12,20
Rostov,8541,10,4,6,10,12,20,-8,18
Anzhi,8541,11,2,6,12,15,40,-25,12
Loko Moscow,8542,1,12,6,2,31,12,19,42
CSKA Moscow,8542,2,12,3,5,30,19,11,39
Spart Moscow,8542,3,9,6,5,41,33,8,33
Krasnodar,8542,4,9,5,6,29,25,4,32
Terek Grozny,8542,5,8,6,6,21,22,-1,30
Zenit,8542,6,7,8,5,23,18,5,29
Din Moscow,8542,7,6,7,7,19,22,-3,25
Rostov,8542,8,5,6,9,15,20,-5,21
FK Rubin,8542,9,5,5,10,21,19,2,20
Amkar,8542,10,4,5,11,11,26,-15,17
Anzhi,8542,11,2,5,13,14,39,-25,11
Loko Moscow,8543,1,12,5,3,31,13,18,41
CSKA Moscow,8543,2,11,3,6,27,20,7,36
Spart Moscow,8543,3,9,6,5,36,27,9,33
Zenit,8543,4,8,8,4,23,14,9,32
Krasnodar,8543,5,9,4,7,29,26,3,31
FK Rubin,8543,6,7,5,8,24,18,6,26
Terek Grozny,8543,7,7,5,8,21,26,-5,26
Amkar,8543,8,6,4,10,12,23,-11,22
Din Moscow,8543,9,5,6,9,18,25,-7,21
Rostov,8543,10,4,7,9,11,18,-7,19
Anzhi,8543,11,3,5,12,17,39,-22,14
Loko Moscow,8544,1,11,6,3,32,15,17,39
CSKA Moscow,8544,2,12,3,5,27,17,10,39
Spart Moscow,8544,3,11,5,4,41,27,14,38
Zenit,8544,4,8,8,4,24,16,8,32
Krasnodar,8544,5,8,6,6,30,27,3,30
Terek Grozny,8544,6,8,5,7,22,24,-2,29
FK Rubin,8544,7,5,7,8,23,19,4,22
Din Moscow,8544,8,5,7,8,17,23,-6,22
Rostov,8544,9,4,6,10,10,20,-10,18
Amkar,8544,10,4,4,12,12,27,-15,16
Anzhi,8544,11,3,5,12,15,38,-23,14
Loko Moscow,8545,1,13,5,2,32,11,21,44
CSKA Moscow,8545,2,11,3,6,29,19,10,36
Spart Moscow,8545,3,10,5,5,38,27,11,35
Zenit,8545,4,8,8,4,22,14,8,32
Krasnodar,8545,5,9,4,7,28,26,2,31
Terek Grozny,8545,6,8,5,7,23,26,-3,29
FK Rubin,8545,7,6,5,9,22,18,4,23
Din Moscow,8545,8,5,6,9,17,25,-8,21
Amkar,8545,9,5,4,11,11,24,-13,19
Rostov,8545,10,4,6,10,11,19,-8,18
Anzhi,8545,11,3,5,12,18,42,-24,14
Loko Moscow,8546,1,13,5,2,34,12,22,44
CSKA Moscow,8546,2,12,3,5,29,18,11,39
Spart Moscow,8546,3,11,5,4,40,26,14,38
Krasnodar,8546,4,9,4,7,32,26,6,31
Zenit,8546,5,7,8,5,22,18,4,29
Terek Grozny,8546,6,7,6,7,21,24,-3,27
Din Moscow,8546,7,6,6,8,18,24,-6,24
FK Rubin,8546,8,5,5,10,21,22,-1,20
Rostov,8546,9,4,6,10,10,19,-9,18
Amkar,8546,10,4,5,11,11,25,-14,17
Anzhi,8546,11,3,5,12,15,39,-24,14
Loko Moscow,8547,1,11,7,2,31,13,18,40
CSKA Moscow,8547,2,11,3,6,28,20,8,36
Zenit,8547,3,8,9,3,25,16,9,33
Spart Moscow,8547,4,9,6,5,34,28,6,33
Krasnodar,8547,5,9,5,6,29,24,5,32
Terek Grozny,8547,6,8,5,7,24,24,0,29
FK Rubin,8547,7,6,5,9,24,21,3,23
Rostov,8547,8,5,6,9,13,17,-4,21
Din Moscow,8547,9,5,6,9,19,25,-6,21
Amkar,8547,10,4,5,11,9,25,-16,17
Anzhi,8547,11,3,5,12,17,40,-23,14
Loko Moscow,8548,1,13,5,2,34,14,20,44
CSKA Moscow,8548,2,11,3,6,27,19,8,36
Spart Moscow,8548,3,9,6,5,36,27,9,33
Terek Grozny,8548,4,9,5,6,22,22,0,32
Zenit,8548,5,7,8,5,24,18,6,29
Krasnodar,8548,6,8,4,8,27,26,1,28
FK Rubin,8548,7,6,6,8,23,18,5,24
Din Moscow,8548,8,5,7,8,18,25,-7,22
Rostov,8548,9,4,7,9,10,17,-7,19
Amkar,8548,10,5,4,11,11,23,-12,19
Anzhi,8548,11,3,5,12,16,39,-23,14
Loko Moscow,8549,1,12,6,2,34,13,21,42
CSKA Moscow,8549,2,11,4,5,28,17,11,37
Spart Moscow,8549,3,8,8,4,36,28,8,32
Zenit,8549,4,7,10,3,21,13,8,31
Terek Grozny,8549,5,8,6,6,25,23,2,30
Krasnodar,8549,6,8,5,7,31,31,0,29
Din Moscow,8549,7,6,7,7,22,23,-1,25
FK Rubin,8549,8,5,6,9,24,23,1,21
Rostov,8549,9,4,7,9,12,19,-7,19
Amkar,8549,10,4,6,10,9,22,-13,18
Anzhi,8549,11,2,5,13,15,45,-30,11
Loko Moscow,8550,1,11,5,4,30,16,14,38
CSKA Moscow,8550,2,11,4,5,29,18,11,37
Zenit,8550,3,8,9,3,24,14,10,33
Spart Moscow,8550,4,9,6,5,37,29,8,33
Krasnodar,8550,5,9,5,6,31,26,5,32
Terek Grozny,8550,6,8,5,7,24,26,-2,29
Din Moscow,8550,7,6,7,7,18,21,-3,25
FK Rubin,8550,8,5,6,9,22,19,3,21
Amkar,8550,9,5,4,11,11,24,-13,19
Rostov,8550,10,4,6,10,13,21,-8,18
Anzhi,8550,11,3,5,12,17,42,-25,14
Loko Moscow,8551,1,12,5,3,33,14,19,41
CSKA Moscow,8551,2,11,4,5,29,18,11,37
Spart Moscow,8551,3,9,7,4,37,27,10,34
Krasnodar,8551,4,9,5,6,30,26,4,32
Terek Grozny,8551,5,9,5,6,25,23,2,32
Zenit,8551,6,7,9,4,23,17,6,30
FK Rubin,8551,7,5,7,8,22,18,4,22
Din Moscow,8551,8,5,7,8,18,24,-6,22
Rostov,8551,9,4,7,9,11,18,-7,19
Amkar,8551,10,4,5,11,9,24,-15,17
Anzhi,8551,11,2,5,13,15,43,-28,11
Loko Moscow,8552,1,13,5,2,36,11,25,44
CSKA Moscow,8552,2,12,3,5,30,17,13,39
Spart Moscow,8552,3,10,6,4,40,27,13,36
Terek Grozny,8552,4,8,6,6,24,25,-1,30
Zenit,8552,5,7,8,5,21,18,3,29
Krasnodar,8552,6,8,5,7,28,30,-2,29
FK Rubin,8552,7,5,7,8,22,18,4,22
Din Moscow,8552,8,5,7,8,18,24,-6,22
Rostov,8552,9,4,7,9,11,18,-7,19
Amkar,8552,10,4,5,11,11,27,-16,17
Anzhi,8552,11,2,5,13,15,41,-26,11
Loko Moscow,8553,1,11,6,3,29,13,16,39
CSKA Moscow,8553,2,12,3,5,27,17,10,39
Spart Moscow,8553,3,9,7,4,36,27,9,34
Krasnodar,8553,4,9,5,6,30,25,5,32
Terek Grozny,8553,5,9,5,6,23,23,0,32
Zenit,8553,6,7,9,4,21,14,7,30
FK Rubin,8553,7,6,6,8,24,18,6,24
Din Moscow,8553,8,5,6,9,18,25,-7,21
Rostov,8553,9,4,7,9,10,17,-7,19
Amkar,8553,10,4,5,11,10,24,-14,17
Anzhi,8553,11,2,5,13,15,40,-25,11
Loko Moscow,8554,1,12,6,2,32,12,20,42
CSKA Moscow,8554,2,12,3,5,30,18,12,39
Spart Moscow,8554,3,8,7,5,36,29,7,31
Krasnodar,8554,4,9,4,7,30,27,3,31
Zenit,8554,5,7,9,4,21,15,6,30
Terek Grozny,8554,6,8,5,7,27,28,-1,29
Din Moscow,8554,7,6,6,8,19,25,-6,24
FK Rubin,8554,8,6,5,9,24,19,5,23
Amkar,8554,9,5,5,10,15,25,-10,20
Rostov,8554,10,4,7,9,10,17,-7,19
Anzhi,8554,11,2,5,13,17,46,-29,11
Loko Moscow,8555,1,12,6,2,31,11,20,42
CSKA Moscow,8555,2,11,3,6,30,19,11,36
Spart Moscow,8555,3,9,6,5,37,29,8,33
Zenit,8555,4,8,8,4,23,16,7,32
Krasnodar,8555,5,8,6,6,27,24,3,30
Terek Grozny,8555,6,7,6,7,21,27,-6,27
FK Rubin,8555,7,6,6,8,23,17,6,24
Rostov,8555,8,5,6,9,12,18,-6,21
Din Moscow,8555,9,5,6,9,19,26,-7,21
Amkar,8555,10,4,6,10,9,22,-13,18
Anzhi,8555,11,3,5,12,19,42,-23,14
Loko Moscow,8556,1,12,6,2,31,12,19,42
Spart Moscow,8556,2,10,6,4,37,27,10,36
CSKA Moscow,8556,3,11,3,6,31,21,10,36
Zenit,8556,4,8,9,3,26,16,10,33
Krasnodar,8556,5,8,5,7,27,25,2,29
Terek Grozny,8556,6,8,5,7,22,23,-1,29
Din Moscow,8556,7,6,6,8,20,23,-3,24
FK Rubin,8556,8,5,6,9,21,19,2,21
Rostov,8556,9,4,6,10,11,19,-8,18
Amkar,8556,10,4,5,11,9,24,-15,17
Anzhi,8556,11,3,5,12,15,41,-26,14
Loko Moscow,8557,1,11,7,2,31,13,18,40
CSKA Moscow,8557,2,12,3,5,32,19,13,39
Spart Moscow,8557,3,11,5,4,43,28,15,38
Zenit,8557,4,7,9,4,23,16,7,30
Krasnodar,8557,5,8,6,6,28,25,3,30
Terek Grozny,8557,6,8,6,6,24,25,-1,30
FK Rubin,8557,7,6,6,8,23,18,5,24
Din Moscow,8557,8,5,6,9,20,26,-6,21
Rostov,8557,9,4,6,10,10,22,-12,18
Amkar,8557,10,4,4,12,11,26,-15,16
Anzhi,8557,11,2,6,12,17,44,-27,12
Loko Moscow,8558,1,12,5,3,31,13,18,41
CSKA Moscow,8558,2,12,3,5,28,17,11,39
Spart Moscow,8558,3,10,6,4,38,26,12,36
Krasnodar,8558,4,10,4,6,31,26,5,34
Zenit,8558,5,7,8,5,22,16,6,29
Terek Grozny,8558,6,7,5,8,21,25,-4,26
Din Moscow,8558,7,5,7,8,17,24,-7,22
FK Rubin,8558,8,5,6,9,23,20,3,21
Rostov,8558,9,4,7,9,11,18,-7,19
Amkar,8558,10,5,4,11,11,24,-13,19
Anzhi,8558,11,3,5,12,15,39,-24,14
Loko Moscow,8559,1,12,5,3,30,13,17,41
CSKA Moscow,8559,2,11,4,5,29,18,11,37
Krasnodar,8559,3,9,5,6,31,26,5,32
Zenit,8559,4,7,9,4,22,15,7,30
Spart Moscow,8559,5,8,6,6,35,30,5,30
Terek Grozny,8559,6,7,6,7,21,24,-3,27
Din Moscow,8559,7,5,8,7,18,22,-4,23
FK Rubin,8559,8,5,7,8,24,20,4,22
Rostov,8559,9,5,6,9,12,18,-6,21
Amkar,8559,10,5,5,10,13,24,-11,20
Anzhi,8559,11,3,5,12,15,40,-25,14
Loko Moscow,8560,1,12,5,3,31,12,19,41
CSKA Moscow,8560,2,10,3,7,25,21,4,33
Zenit,8560,3,8,8,4,24,15,9,32
Spart Moscow,8560,4,9,5,6,36,28,8,32
Krasnodar,8560,5,9,4,7,29,29,0,31
Terek Grozny,8560,6,8,6,6,22,23,-1,30
Din Moscow,8560,7,7,6,7,20,21,-1,27
FK Rubin,8560,8,6,5,9,26,20,6,23
Amkar,8560,9,5,5,10,11,23,-12,20
Rostov,8560,10,4,6,10,10,19,-9,18
Anzhi,8560,11,3,5,12,16,39,-23,14
Loko Moscow,8561,1,11,6,3,30,13,17,39
CSKA Moscow,8561,2,12,3,5,30,18,12,39
Spart Moscow,8561,3,10,6,4,41,29,12,36
Zenit,8561,4,8,8,4,23,17,6,32
Krasnodar,8561,5,9,5,6,31,26,5,32
Terek Grozny,8561,6,7,6,7,22,25,-3,27
FK Rubin,8561,7,6,5,9,25,21,4,23
Din Moscow,8561,8,5,7,8,19,25,-6,22
Rostov,8561,9,4,6,10,12,20,-8,18
Amkar,8561,10,4,5,11,12,28,-16,17
Anzhi,8561,11,3,5,12,15,38,-23,14
Loko Moscow,8562,1,13,5,2,37,13,24,44
CSKA Moscow,8562,2,12,3,5,33,18,15,39
Krasnodar,8562,3,9,4,7,29,29,0,31
Spart Moscow,8562,4,8,6,6,37,33,4,30
Zenit,8562,5,7,8,5,23,18,5,29
Terek Grozny,8562,6,7,6,7,20,23,-3,27
Din Moscow,8562,7,6,6,8,20,24,-4,24
FK Rubin,8562,8,6,5,9,23,18,5,23
Rostov,8562,9,5,6,9,13,18,-5,21
Amkar,8562,10,4,6,10,11,24,-13,18
Anzhi,8562,11,3,5,12,15,43,-28,14
Loko Moscow,8563,1,11,6,3,29,14,15,39
Spart Moscow,8563,2,11,5,4,44,25,19,38
CSKA Moscow,8563,3,11,4,5,27,17,10,37
Zenit,8563,4,8,9,3,24,13,11,33
Krasnodar,8563,5,8,6,6,27,24,3,30
Terek Grozny,8563,6,7,7,6,24,26,-2,28
Din Moscow,8563,7,6,6,8,18,28,-10,24
FK Rubin,8563,8,5,6,9,21,18,3,21
Rostov,8563,9,4,6,10,10,19,-9,18
Amkar,8563,10,4,5,11,11,26,-15,17
Anzhi,8563,11,2,6,12,16,41,-25,12
Loko Moscow,8564,1,13,5,2,39,14,25,44
Spart Moscow,8564,2,11,5,4,43,27,16,38
CSKA Moscow,8564,3,11,4,5,27,18,9,37
Krasnodar,8564,4,9,4,7,30,29,1,31
Zenit,8564,5,7,9,4,23,19,4,30
Terek Grozny,8564,6,8,5,7,24,25,-1,29
Din Moscow,8564,7,6,6,8,21,27,-6,24
FK Rubin,8564,8,5,5,10,22,22,0,20
Amkar,8564,9,5,4,11,11,24,-13,19
Rostov,8564,10,4,6,10,11,20,-9,18
Anzhi,8564,11,2,5,13,16,42,-26,11
Loko Moscow,8565,1,11,7,2,29,11,18,40
CSKA Moscow,8565,2,11,4,5,27,18,9,37
Spart Moscow,8565,3,9,6,5,40,29,11,33
Krasnodar,8565,4,9,5,6,29,24,5,32
Terek Grozny,8565,5,9,5,6,24,23,1,32
Zenit,8565,6,7,9,4,21,14,7,30
Din Moscow,8565,7,6,7,7,19,22,-3,25
FK Rubin,8565,8,5,6,9,21,19,2,21
Rostov,8565,9,4,6,10,12,23,-11,18
Amkar,8565,10,4,5,11,9,24,-15,17
Anzhi,8565,11,2,6,12,16,40,-24,12
Loko Moscow,8566,1,12,5,3,30,15,15,41
CSKA Moscow,8566,2,11,3,6,26,19,7,36
Spart Moscow,8566,3,9,6,5,36,28,8,33
Krasnodar,8566,4,9,5,6,32,25,7,32
Terek Grozny,8566,5,9,5,6,25,24,1,32
Zenit,8566,6,7,8,5,21,15,6,29
FK Rubin,8566,7,5,7,8,23,19,4,22
Din Moscow,8566,8,5,7,8,18,23,-5,22
Rostov,8566,9,4,7,9,12,19,-7,19
Amkar,8566,10,5,4,11,11,25,-14,19
Anzhi,8566,11,3,5,12,17,39,-22,14
Loko Moscow,8567,1,12,6,2,35,14,21,42
Zenit,8567,2,8,9,3,26,15,11,33
Spart Moscow,8567,3,9,6,5,38,28,10,33
CSKA Moscow,8567,4,10,3,7,25,22,3,33
Krasnodar,8567,5,9,4,7,31,28,3,31
Terek Grozny,8567,6,7,5,8,20,25,-5,26
Din Moscow,8567,7,5,7,8,20,27,-7,22
Amkar,8567,8,6,4,10,13,23,-10,22
FK Rubin,8567,9,5,6,9,23,22,1,21
Rostov,8567,10,4,7,9,10,17,-7,19
Anzhi,8567,11,4,5,11,17,37,-20,17
Loko Moscow,8568,1,12,6,2,34,14,20,42
Spart Moscow,8568,2,10,5,5,40,30,10,35
CSKA Moscow,8568,3,10,4,6,29,22,7,34
Zenit,8568,4,8,9,3,25,16,9,33
Krasnodar,8568,5,8,5,7,29,28,1,29
Terek Grozny,8568,6,7,5,8,22,27,-5,26
Din Moscow,8568,7,6,6,8,20,25,-5,24
FK Rubin,8568,8,5,6,9,22,19,3,21
Rostov,8568,9,5,6,9,12,17,-5,21
Amkar,8568,10,5,4,11,12,25,-13,19
Anzhi,8568,11,3,6,11,20,42,-22,15
Loko Moscow,8569,1,13,5,2,33,13,20,44
Spart Moscow,8569,2,10,6,4,38,27,11,36
CSKA Moscow,8569,3,11,3,6,27,18,9,36
Zenit,8569,4,8,8,4,22,14,8,32
Terek Grozny,8569,5,9,5,6,27,23,4,32
Krasnodar,8569,6,8,4,8,30,30,0,28
FK Rubin,8569,7,7,5,8,26,18,8,26
Din Moscow,8569,8,5,7,8,17,23,-6,22
Rostov,8569,9,4,6,10,10,18,-8,18
Amkar,8569,10,4,4,12,12,28,-16,16
Anzhi,8569,11,2,5,13,14,44,-30,11
Loko Moscow,8570,1,12,6,2,30,11,19,42
Zenit,8570,2,8,9,3,23,13,10,33
CSKA Moscow,8570,3,10,3,7,26,21,5,33
Spart Moscow,8570,4,8,8,4,37,29,8,32
Krasnodar,8570,5,9,4,7,29,26,3,31
Terek Grozny,8570,6,8,5,7,22,24,-2,29
Din Moscow,8570,7,5,8,7,18,22,-4,23
FK Rubin,8570,8,5,6,9,22,19,3,21
Amkar,8570,9,5,5,10,11,23,-12,20
Rostov,8570,10,4,7,9,12,19,-7,19
Anzhi,8570,11,3,5,12,17,40,-23,14
Loko Moscow,8571,1,11,5,4,30,14,16,38
Spart Moscow,8571,2,10,6,4,40,29,11,36
CSKA Moscow,8571,3,10,5,5,28,20,8,35
Zenit,8571,4,8,9,3,23,14,9,33
Krasnodar,8571,5,9,4,7,29,27,2,31
Terek Grozny,8571,6,8,6,6,22,22,0,30
Din Moscow,8571,7,6,7,7,20,23,-3,25
FK Rubin,8571,8,6,5,9,23,18,5,23
Rostov,8571,9,4,6,10,10,19,-9,18
Amkar,8571,10,4,4,12,11,27,-16,16
Anzhi,8571,11,2,7,11,16,39,-23,13
Loko Moscow,8572,1,12,5,3,34,14,20,41
CSKA Moscow,8572,2,11,3,6,27,19,8,36
Spart Moscow,8572,3,9,7,4,37,27,10,34
Zenit,8572,4,8,8,4,23,15,8,32
Krasnodar,8572,5,8,5,7,29,29,0,29
Terek Grozny,8572,6,8,5,7,23,25,-2,29
Din Moscow,8572,7,5,8,7,20,24,-4,23
FK Rubin,8572,8,5,7,8,23,19,4,22
Rostov,8572,9,4,7,9,10,17,-7,19
Anzhi,8572,10,4,5,11,18,39,-21,17
Amkar,8572,11,4,4,12,10,26,-16,16
Loko Moscow,8573,1,12,5,3,31,14,17,41
Spart Moscow,8573,2,11,5,4,37,26,11,38
Zenit,8573,3,9,8,3,24,13,11,35
CSKA Moscow,8573,4,10,3,7,25,19,6,33
Krasnodar,8573,5,8,4,8,29,29,0,28
Terek Grozny,8573,6,7,6,7,21,24,-3,27
Din Moscow,8573,7,6,6,8,19,23,-4,24
FK Rubin,8573,8,6,5,9,24,19,5,23
Amkar,8573,9,5,4,11,10,23,-13,19
Rostov,8573,10,4,6,10,10,18,-8,18
Anzhi,8573,11,3,6,11,16,38,-22,15
Loko Moscow,8574,1,12,5,3,32,15,17,41
Zenit,8574,2,9,8,3,25,14,11,35
CSKA Moscow,8574,3,10,4,6,26,19,7,34
Spart Moscow,8574,4,9,6,5,36,29,7,33
Krasnodar,8574,5,9,4,7,32,29,3,31
Terek Grozny,8574,6,7,7,6,21,23,-2,28
Din Moscow,8574,7,5,7,8,18,23,-5,22
FK Rubin,8574,8,5,6,9,23,20,3,21
Amkar,8574,9,5,5,10,12,23,-11,20
Rostov,8574,10,4,7,9,11,18,-7,19
Anzhi,8574,11,2,7,11,14,37,-23,13
Loko Moscow,8575,1,12,5,3,32,13,19,41
Krasnodar,8575,2,10,4,6,31,25,6,34
CSKA Moscow,8575,3,10,4,6,28,23,5,34
Zenit,8575,4,8,8,4,25,16,9,32
Spart Moscow,8575,5,8,6,6,36,30,6,30
Terek Grozny,8575,6,7,7,6,23,25,-2,28
Din Moscow,8575,7,6,7,7,20,23,-3,25
FK Rubin,8575,8,5,6,9,22,20,2,21
Amkar,8575,9,5,5,10,12,24,-12,20
Rostov,8575,10,4,7,9,11,18,-7,19
Anzhi,8575,11,2,7,11,18,41,-23,13
Loko Moscow,8576,1,11,6,3,30,13,17,39
CSKA Moscow,8576,2,10,5,5,28,20,8,35
Spart Moscow,8576,3,9,6,5,37,28,9,33
Zenit,8576,4,8,9,3,23,14,9,33
Terek Grozny,8576,5,9,5,6,24,23,1,32
Krasnodar,8576,6,8,5,7,28,26,2,29
Din Moscow,8576,7,6,6,8,20,25,-5,24
FK Rubin,8576,8,6,5,9,23,19,4,23
Rostov,8576,9,4,7,9,10,17,-7,19
Amkar,8576,10,5,4,11,11,24,-13,19
Anzhi,8576,11,2,6,12,17,42,-25,12
Loko Moscow,8577,1,12,6,2,33,13,20,42
CSKA Moscow,8577,2,11,3,6,26,19,7,36
Zenit,8577,3,8,9,3,24,14,10,33
Spart Moscow,8577,4,9,5,6,36,30,6,32
Krasnodar,8577,5,9,4,7,31,29,2,31
Terek Grozny,8577,6,8,5,7,24,23,1,29
Din Moscow,8577,7,6,6,8,20,24,-4,24
FK Rubin,8577,8,6,5,9,24,20,4,23
Amkar,8577,9,6,4,10,12,22,-10,22
Rostov,8577,10,4,6,10,10,18,-8,18
Anzhi,8577,11,2,5,13,14,42,-28,11
Loko Moscow,8578,1,11,5,4,30,18,12,38
CSKA Moscow,8578,2,11,4,5,29,18,11,37
Spart Moscow,8578,3,10,5,5,40,28,12,35
Krasnodar,8578,4,9,5,6,33,25,8,32
Zenit,8578,5,8,8,4,23,17,6,32
Terek Grozny,8578,6,9,5,6,22,22,0,32
FK Rubin,8578,7,5,7,8,23,19,4,22
Din Moscow,8578,8,5,7,8,19,25,-6,22
Rostov,8578,9,5,6,9,12,18,-6,21
Amkar,8578,10,4,4,12,9,26,-17,16
Anzhi,8578,11,2,6,12,15,39,-24,12
Loko Moscow,8579,1,12,6,2,31,11,20,42
CSKA Moscow,8579,2,11,3,6,30,21,9,36
Spart Moscow,8579,3,9,6,5,35,27,8,33
Zenit,8579,4,8,8,4,25,17,8,32
Krasnodar,8579,5,8,6,6,30,27,3,30
Terek Grozny,8579,6,8,6,6,25,23,2,30
Din Moscow,8579,7,5,8,7,18,22,-4,23
FK Rubin,8579,8,5,7,8,24,20,4,22
Amkar,8579,9,5,5,10,11,23,-12,20
Rostov,8579,10,4,6,10,10,18,-8,18
Anzhi,8579,11,2,5,13,14,44,-30,11
Loko Moscow,8580,1,12,5,3,34,16,18,41
CSKA Moscow,8580,2,11,3,6,26,19,7,36
Zenit,8580,3,9,8,3,26,15,11,35
Krasnodar,8580,4,9,4,7,31,28,3,31
Spart Moscow,8580,5,8,6,6,35,30,5,30
Terek Grozny,8580,6,7,6,7,21,26,-5,27
Din Moscow,8580,7,6,7,7,22,25,-3,25
Amkar,8580,8,6,4,10,14,22,-8,22
Rostov,8580,9,5,6,9,11,17,-6,21
FK Rubin,8580,10,5,5,10,24,22,2,20
Anzhi,8580,11,2,6,12,15,39,-24,12
Loko Moscow,8581,1,11,7,2,30,12,18,40
CSKA Moscow,8581,2,10,5,5,27,19,8,35
Spart Moscow,8581,3,9,6,5,36,29,7,33
Krasnodar,8581,4,9,5,6,31,26,5,32
Zenit,8581,5,7,10,3,22,14,8,31
Terek Grozny,8581,6,7,5,8,23,30,-7,26
Din Moscow,8581,7,6,6,8,22,23,-1,24
Amkar,8581,8,6,4,10,16,23,-7,22
FK Rubin,8581,9,5,5,10,22,24,-2,20
Rostov,8581,10,4,7,9,11,18,-7,19
Anzhi,8581,11,3,6,11,18,40,-22,15
Loko Moscow,8582,1,12,5,3,30,12,18,41
Zenit,8582,2,9,8,3,23,13,10,35
CSKA Moscow,8582,3,10,3,7,25,19,6,33
Spart Moscow,8582,4,9,5,6,43,33,10,32
Krasnodar,8582,5,8,4,8,28,27,1,28
Terek Grozny,8582,6,7,6,7,22,25,-3,27
FK Rubin,8582,7,7,5,8,24,18,6,26
Rostov,8582,8,5,6,9,13,19,-6,21
Din Moscow,8582,9,5,6,9,18,28,-10,21
Amkar,8582,10,5,5,10,14,25,-11,20
Anzhi,8582,11,4,5,11,17,38,-21,17
Loko Moscow,8583,1,11,6,3,31,16,15,39
Spart Moscow,8583,2,10,5,5,36,27,9,35
CSKA Moscow,8583,3,10,4,6,25,18,7,34
Zenit,8583,4,8,9,3,24,13,11,33
Krasnodar,8583,5,8,6,6,30,27,3,30
Terek Grozny,8583,6,8,6,6,28,27,1,30
Din Moscow,8583,7,7,6,7,19,21,-2,27
FK Rubin,8583,8,5,6,9,22,19,3,21
Rostov,8583,9,4,6,10,11,19,-8,18
Amkar,8583,10,4,5,11,13,27,-14,17
Anzhi,8583,11,3,5,12,16,41,-25,14
Loko Moscow,8584,1,12,6,2,31,11,20,42
CSKA Moscow,8584,2,12,3,5,28,18,10,39
Spart Moscow,8584,3,10,6,4,39,27,12,36
Zenit,8584,4,7,9,4,21,14,7,30
Terek Grozny,8584,5,8,6,6,22,23,-1,30
Krasnodar,8584,6,8,4,8,28,29,-1,28
FK Rubin,8584,7,7,5,8,26,19,7,26
Din Moscow,8584,8,5,6,9,19,27,-8,21
Rostov,8584,9,4,6,10,11,19,-8,18
Amkar,8584,10,4,5,11,9,23,-14,17
Anzhi,8584,11,2,6,12,16,40,-24,12
Loko Moscow,8585,1,13,5,2,33,12,21,44
CSKA Moscow,8585,2,11,4,5,26,17,9,37
Spart Moscow,8585,3,10,5,5,39,28,11,35
Krasnodar,8585,4,9,4,7,31,28,3,31
Zenit,8585,5,7,8,5,21,16,5,29
Terek Grozny,8585,6,8,5,7,22,23,-1,29
Din Moscow,8585,7,6,6,8,19,24,-5,24
Amkar,8585,8,6,4,10,11,22,-11,22
FK Rubin,8585,9,5,5,10,23,21,2,20
Rostov,8585,10,4,6,10,11,20,-9,18
Anzhi,8585,11,2,6,12,14,39,-25,12
Loko Moscow,8586,1,12,5,3,31,13,18,41
CSKA Moscow,8586,2,12,3,5,31,17,14,39
Spart Moscow,8586,3,11,5,4,39,26,13,38
Krasnodar,8586,4,10,4,6,31,25,6,34
Zenit,8586,5,7,8,5,21,16,5,29
Terek Grozny,8586,6,7,5,8,20,26,-6,26
FK Rubin,8586,7,6,5,9,24,20,4,23
Din Moscow,8586,8,5,6,9,18,26,-8,21
Amkar,8586,9,5,4,11,11,24,-13,19
Rostov,8586,10,4,6,10,10,19,-9,18
Anzhi,8586,11,3,5,12,17,41,-24,14
Loko Moscow,8587,1,11,6,3,31,15,16,39
Spart Moscow,8587,2,10,6,4,38,27,11,36
CSKA Moscow,8587,3,11,3,6,27,19,8,36
Krasnodar,8587,4,10,4,6,31,25,6,34
Zenit,8587,5,8,9,3,24,15,9,33
Terek Grozny,8587,6,7,6,7,21,24,-3,27
FK Rubin,8587,7,6,5,9,24,19,5,23
Din Moscow,8587,8,5,6,9,18,25,-7,21
Rostov,8587,9,4,7,9,11,18,-7,19
Amkar,8587,10,5,4,11,11,25,-14,19
Anzhi,8587,11,2,6,12,15,39,-24,12
Loko Moscow,8588,1,12,6,2,30,11,19,42
Spart Moscow,8588,2,10,5,5,39,32,7,35
CSKA Moscow,8588,3,10,3,7,26,21,5,33
Zenit,8588,4,8,8,4,23,15,8,32
Krasnodar,8588,5,9,5,6,29,24,5,32
Terek Grozny,8588,6,8,5,7,22,24,-2,29
Din Moscow,8588,7,6,7,7,22,23,-1,25
FK Rubin,8588,8,5,6,9,22,20,2,21
Amkar,8588,9,5,4,11,12,24,-12,19
Rostov,8588,10,4,6,10,12,20,-8,18
Anzhi,8588,11,3,5,12,16,39,-23,14
Loko Moscow,8589,1,13,5,2,32,12,20,44
CSKA Moscow,8589,2,11,3,6,26,18,8,36
Spart Moscow,8589,3,9,7,4,35,25,10,34
Zenit,8589,4,7,8,5,21,15,6,29
Krasnodar,8589,5,8,5,7,29,27,2,29
Terek Grozny,8589,6,8,5,7,23,26,-3,29
FK Rubin,8589,7,6,6,8,25,20,5,24
Din Moscow,8589,8,5,7,8,19,24,-5,22
Rostov,8589,9,4,6,10,10,19,-9,18
Amkar,8589,10,4,5,11,9,25,-16,17
Anzhi,8589,11,4,5,11,19,37,-18,17
Loko Moscow,8590,1,12,5,3,31,15,16,41
CSKA Moscow,8590,2,12,3,5,31,18,13,39
Spart Moscow,8590,3,10,6,4,40,30,10,36
Zenit,8590,4,8,8,4,25,15,10,32
Krasnodar,8590,5,9,4,7,31,27,4,31
Terek Grozny,8590,6,7,5,8,20,25,-5,26
Din Moscow,8590,7,6,6,8,21,25,-4,24
FK Rubin,8590,8,5,5,10,22,21,1,20
Amkar,8590,9,5,5,10,11,23,-12,20
Rostov,8590,10,4,6,10,11,19,-8,18
Anzhi,8590,11,3,5,12,16,41,-25,14
Loko Moscow,8591,1,13,5,2,31,11,20,44
CSKA Moscow,8591,2,11,4,5,26,17,9,37
Spart Moscow,8591,3,10,5,5,38,28,10,35
Zenit,8591,4,7,9,4,21,14,7,30
Terek Grozny,8591,5,8,5,7,21,25,-4,29
Krasnodar,8591,6,8,4,8,27,26,1,28
Din Moscow,8591,7,6,6,8,19,24,-5,24
FK Rubin,8591,8,6,5,9,23,19,4,23
Amkar,8591,9,6,4,10,14,23,-9,22
Rostov,8591,10,4,6,10,11,19,-8,18
Anzhi,8591,11,2,5,13,14,39,-25,11
Loko Moscow,8592,1,11,5,4,30,14,16,38
CSKA Moscow,8592,2,10,5,5,27,19,8,35
Zenit,8592,3,8,9,3,23,14,9,33
Spart Moscow,8592,4,9,5,6,34,29,5,32
Krasnodar,8592,5,9,4,7,29,27,2,31
Terek Grozny,8592,6,8,6,6,23,24,-1,30
Din Moscow,8592,7,7,6,7,22,23,-1,27
FK Rubin,8592,8,6,5,9,25,20,5,23
Amkar,8592,9,5,5,10,12,23,-11,20
Rostov,8592,10,4,6,10,10,18,-8,18
Anzhi,8592,11,2,6,12,16,40,-24,12
Loko Moscow,8593,1,12,6,2,32,13,19,42
Spart Moscow,8593,2,10,6,4,39,26,13,36
CSKA Moscow,8593,3,11,3,6,27,19,8,36
Zenit,8593,4,8,9,3,24,14,10,33
Krasnodar,8593,5,8,4,8,28,27,1,28
Terek Grozny,8593,6,7,5,8,20,24,-4,26
Din Moscow,8593,7,6,7,7,22,22,0,25
FK Rubin,8593,8,6,5,9,22,21,1,23
Amkar,8593,9,5,4,11,10,24,-14,19
Rostov,8593,10,4,6,10,10,20,-10,18
Anzhi,8593,11,3,5,12,15,39,-24,14
Loko Moscow,8594,1,12,6,2,30,11,19,42
Spart Moscow,8594,2,10,6,4,40,26,14,36
CSKA Moscow,8594,3,11,3,6,28,19,9,36
Zenit,8594,4,7,8,5,22,17,5,29
Krasnodar,8594,5,8,5,7,28,26,2,29
Terek Grozny,8594,6,7,6,7,22,25,-3,27
FK Rubin,8594,7,7,5,8,27,19,8,26
Din Moscow,8594,8,5,6,9,19,31,-12,21
Rostov,8594,9,4,6,10,10,18,-8,18
Amkar,8594,10,4,6,10,9,22,-13,18
Anzhi,8594,11,4,5,11,18,39,-21,17
Loko Moscow,8595,1,12,6,2,31,12,19,42
Spart Moscow,8595,2,11,5,4,40,26,14,38
CSKA Moscow,8595,3,11,3,6,29,22,7,36
Zenit,8595,4,8,9,3,26,16,10,33
Krasnodar,8595,5,8,5,7,28,26,2,29
Terek Grozny,8595,6,8,5,7,21,23,-2,29
Din Moscow,8595,7,6,6,8,19,23,-4,24
FK Rubin,8595,8,5,6,9,23,20,3,21
Amkar,8595,9,5,4,11,10,23,-13,19
Rostov,8595,10,4,6,10,11,22,-11,18
Anzhi,8595,11,2,5,13,15,40,-25,11
Loko Moscow,8596,1,12,5,3,33,13,20,41
Spart Moscow,8596,2,11,5,4,38,25,13,38
CSKA Moscow,8596,3,11,4,5,28,17,11,37
Krasnodar,8596,4,10,4,6,31,26,5,34
Zenit,8596,5,7,9,4,21,16,5,30
Terek Grozny,8596,6,8,6,6,22,23,-1,30
Din Moscow,8596,7,6,6,8,18,24,-6,24
FK Rubin,8596,8,5,5,10,22,20,2,20
Rostov,8596,9,4,6,10,10,18,-8,18
Amkar,8596,10,4,5,11,10,24,-14,17
Anzhi,8596,11,2,5,13,14,41,-27,11
Loko Moscow,8597,1,12,5,3,32,15,17,41
CSKA Moscow,8597,2,11,3,6,28,20,8,36
Zenit,8597,3,9,8,3,27,14,13,35
Spart Moscow,8597,4,9,5,6,35,28,7,32
Krasnodar,8597,5,8,5,7,29,27,2,29
Din Moscow,8597,6,7,6,7,21,22,-1,27
Terek Grozny,8597,7,7,6,7,20,23,-3,27
FK Rubin,8597,8,5,6,9,22,20,2,21
Rostov,8597,9,5,6,9,11,17,-6,21
Amkar,8597,10,4,5,11,9,23,-14,17
Anzhi,8597,11,3,5,12,15,40,-25,14
Loko Moscow,8598,1,12,5,3,33,15,18,41
CSKA Moscow,8598,2,12,3,5,29,18,11,39
Spart Moscow,8598,3,9,6,5,35,28,7,33
Krasnodar,8598,4,9,5,6,31,27,4,32
Zenit,8598,5,7,8,5,22,17,5,29
Terek Grozny,8598,6,7,6,7,20,24,-4,27
FK Rubin,8598,7,6,6,8,23,18,5,24
Din Moscow,8598,8,5,6,9,18,24,-6,21
Amkar,8598,9,5,5,10,11,22,-11,20
Rostov,8598,10,4,7,9,10,17,-7,19
Anzhi,8598,11,3,5,12,17,39,-22,14
Loko Moscow,8599,1,11,5,4,30,15,15,38
Zenit,8599,2,9,8,3,24,14,10,35
CSKA Moscow,8599,3,10,4,6,27,20,7,34
Krasnodar,8599,4,10,4,6,31,25,6,34
Spart Moscow,8599,5,9,6,5,39,34,5,33
Terek Grozny,8599,6,8,6,6,25,25,0,30
Din Moscow,8599,7,6,6,8,19,23,-4,24
Rostov,8599,8,5,6,9,14,17,-3,21
FK Rubin,8599,9,5,5,10,21,19,2,20
Amkar,8599,10,4,5,11,14,29,-15,17
Anzhi,8599,11,2,7,11,17,40,-23,13
Loko Moscow,8600,1,12,5,3,31,13,18,41
CSKA Moscow,8600,2,12,3,5,29,18,11,39
Krasnodar,8600,3,10,4,6,30,24,6,34
Spart Moscow,8600,4,9,6,5,37,28,9,33
Terek Grozny,8600,5,8,6,6,23,23,0,30
Zenit,8600,6,7,8,5,23,18,5,29
Din Moscow,8600,7,5,7,8,18,24,-6,22
FK Rubin,8600,8,5,6,9,22,20,2,21
Rostov,8600,9,4,7,9,11,18,-7,19
Amkar,8600,10,5,4,11,12,26,-14,19
Anzhi,8600,11,2,6,12,14,38,-24,12
Loko Moscow,8601,1,11,5,4,29,13,16,38
CSKA Moscow,8601,2,11,3,6,27,18,9,36
Zenit,8601,3,9,8,3,23,13,10,35
Krasnodar,8601,4,10,4,6,30,25,5,34
Spart Moscow,8601,5,9,5,6,40,32,8,32
Terek Grozny,8601,6,8,6,6,23,22,1,30
Din Moscow,8601,7,7,6,7,22,23,-1,27
FK Rubin,8601,8,5,5,10,22,21,1,20
Amkar,8601,9,5,5,10,13,23,-10,20
Rostov,8601,10,4,6,10,10,21,-11,18
Anzhi,8601,11,2,5,13,14,42,-28,11
Loko Moscow,8602,1,11,6,3,31,14,17,39
Spart Moscow,8602,2,9,7,4,34,25,9,34
CSKA Moscow,8602,3,10,4,6,28,21,7,34
Krasnodar,8602,4,10,4,6,30,25,5,34
Zenit,8602,5,8,9,3,25,16,9,33
Terek Grozny,8602,6,7,7,6,22,24,-2,28
Din Moscow,8602,7,5,7,8,18,23,-5,22
FK Rubin,8602,8,5,6,9,23,20,3,21
Rostov,8602,9,4,7,9,10,17,-7,19
Amkar,8602,10,4,6,10,10,23,-13,18
Anzhi,8602,11,2,7,11,17,40,-23,13
Loko Moscow,8603,1,12,6,2,32,12,20,42
CSKA Moscow,8603,2,11,4,5,28,19,9,37
Spart Moscow,8603,3,9,7,4,37,28,9,34
Zenit,8603,4,7,9,4,22,16,6,30
Terek Grozny,8603,5,8,6,6,25,24,1,30
Krasnodar,8603,6,8,5,7,28,27,1,29
Din Moscow,8603,7,6,7,7,21,24,-3,25
FK Rubin,8603,8,6,5,9,23,18,5,23
Rostov,8603,9,4,7,9,10,17,-7,19
Amkar,8603,10,4,5,11,10,24,-14,17
Anzhi,8603,11,2,5,13,16,43,-27,11
Loko Moscow,8604,1,12,6,2,32,12,20,42
Spart Moscow,8604,2,10,6,4,36,26,10,36
CSKA Moscow,8604,3,11,3,6,27,20,7,36
Zenit,8604,4,8,9,3,24,14,10,33
Krasnodar,8604,5,9,4,7,30,28,2,31
Terek Grozny,8604,6,7,6,7,21,24,-3,27
Din Moscow,8604,7,5,8,7,18,22,-4,23
FK Rubin,8604,8,5,6,9,23,20,3,21
Amkar,8604,9,5,4,11,10,23,-13,19
Rostov,8604,10,4,6,10,10,18,-8,18
Anzhi,8604,11,2,6,12,16,40,-24,12
Loko Moscow,8605,1,12,5,3,30,13,17,41
CSKA Moscow,8605,2,11,3,6,27,21,6,36
Spart Moscow,8605,3,9,6,5,38,30,8,33
Zenit,8605,4,8,8,4,24,14,10,32
Krasnodar,8605,5,9,4,7,29,26,3,31
Terek Grozny,8605,6,8,5,7,21,23,-2,29
Din Moscow,8605,7,6,7,7,19,22,-3,25
FK Rubin,8605,8,6,5,9,23,18,5,23
Amkar,8605,9,6,4,10,13,24,-11,22
Rostov,8605,10,4,6,10,11,19,-8,18
Anzhi,8605,11,2,5,13,15,40,-25,11
Loko Moscow,8606,1,12,5,3,31,13,18,41
CSKA Moscow,8606,2,12,3,5,30,19,11,39
Spart Moscow,8606,3,9,6,5,39,29,10,33
Krasnodar,8606,4,9,5,6,29,25,4,32
Terek Grozny,8606,5,9,5,6,24,22,2,32
Zenit,8606,6,7,8,5,22,16,6,29
Din Moscow,8606,7,6,7,7,20,22,-2,25
FK Rubin,8606,8,5,7,8,23,19,4,22
Rostov,8606,9,4,6,10,10,21,-11,18
Amkar,8606,10,4,5,11,11,25,-14,17
Anzhi,8606,11,2,5,13,16,44,-28,11
Loko Moscow,8607,1,11,6,3,29,12,17,39
CSKA Moscow,8607,2,10,5,5,25,17,8,35
Krasnodar,8607,3,9,5,6,30,26,4,32
Terek Grozny,8607,4,9,5,6,24,23,1,32
Zenit,8607,5,7,10,3,21,13,8,31
Spart Moscow,8607,6,8,5,7,34,30,4,29
FK Rubin,8607,7,6,6,8,25,20,5,24
Din Moscow,8607,8,6,6,8,20,24,-4,24
Rostov,8607,9,5,6,9,12,17,-5,21
Amkar,8607,10,5,4,11,10,24,-14,19
Anzhi,8607,11,2,6,12,15,39,-24,12
Loko Moscow,8608,1,12,5,3,30,12,18,41
CSKA Moscow,8608,2,12,3,5,32,19,13,39
Krasnodar,8608,3,10,4,6,30,25,5,34
Spart Moscow,8608,4,8,7,5,34,27,7,31
Zenit,8608,5,7,8,5,22,17,5,29
Terek Grozny,8608,6,7,5,8,21,27,-6,26
Din Moscow,8608,7,6,7,7,19,21,-2,25
Amkar,8608,8,6,4,10,13,22,-9,22
FK Rubin,8608,9,5,5,10,22,21,1,20
Rostov,8608,10,4,7,9,11,18,-7,19
Anzhi,8608,11,3,5,12,17,42,-25,14
Loko Moscow,8609,1,11,6,3,30,14,16,39
CSKA Moscow,8609,2,11,3,6,27,21,6,36
Spart Moscow,8609,3,10,5,5,36,26,10,35
Zenit,8609,4,8,9,3,25,14,11,33
Terek Grozny,8609,5,9,5,6,22,22,0,32
Krasnodar,8609,6,9,4,7,30,29,1,31
Din Moscow,8609,7,7,6,7,19,21,-2,27
FK Rubin,8609,8,6,5,9,26,19,7,23
Rostov,8609,9,4,6,10,10,19,-9,18
Amkar,8609,10,4,4,12,9,24,-15,16
Anzhi,8609,11,2,5,13,15,40,-25,11
Loko Moscow,8610,1,12,5,3,30,12,18,41
CSKA Moscow,8610,2,11,4,5,30,18,12,37
Spart Moscow,8610,3,10,5,5,38,29,9,35
Krasnodar,8610,4,9,4,7,28,25,3,31
Zenit,8610,5,7,9,4,21,14,7,30
Terek Grozny,8610,6,8,5,7,21,25,-4,29
Din Moscow,8610,7,6,6,8,21,26,-5,24
FK Rubin,8610,8,6,5,9,25,21,4,23
Rostov,8610,9,5,6,9,13,17,-4,21
Amkar,8610,10,5,4,11,13,25,-12,19
Anzhi,8610,11,2,5,13,15,43,-28,11
Loko Moscow,8611,1,11,6,3,30,13,17,39
CSKA Moscow,8611,2,12,3,5,28,18,10,39
Krasnodar,8611,3,10,4,6,31,25,6,34
Spart Moscow,8611,4,9,5,6,35,31,4,32
Terek Grozny,8611,5,9,5,6,22,22,0,32
Zenit,8611,6,7,9,4,22,15,7,30
Din Moscow,8611,7,6,7,7,20,22,-2,25
FK Rubin,8611,8,5,6,9,23,21,2,21
Amkar,8611,9,5,4,11,12,23,-11,19
Rostov,8611,10,4,6,10,11,19,-8,18
Anzhi,8611,11,2,5,13,15,40,-25,11
Loko Moscow,8612,1,12,5,3,31,15,16,41
CSKA Moscow,8612,2,11,3,6,28,18,10,36
Krasnodar,8612,3,10,4,6,32,25,7,34
Spart Moscow,8612,4,9,6,5,38,29,9,33
Zenit,8612,5,8,8,4,23,15,8,32
Terek Grozny,8612,6,7,6,7,20,23,-3,27
Din Moscow,8612,7,6,6,8,21,26,-5,24
FK Rubin,8612,8,6,5,9,25,20,5,23
Rostov,8612,9,4,6,10,10,19,-9,18
Amkar,8612,10,4,6,10,10,23,-13,18
Anzhi,8612,11,3,5,12,15,40,-25,14
Loko Moscow,8613,1,12,5,3,31,13,18,41
Zenit,8613,2,9,8,3,25,15,10,35
Spart Moscow,8613,3,10,5,5,35,26,9,35
CSKA Moscow,8613,4,10,4,6,27,20,7,34
Terek Grozny,8613,5,8,6,6,22,23,-1,30
Krasnodar,8613,6,8,4,8,27,27,0,28
FK Rubin,8613,7,7,5,8,24,17,7,26
Din Moscow,8613,8,6,6,8,18,22,-4,24
Rostov,8613,9,4,6,10,10,18,-8,18
Amkar,8613,10,4,5,11,9,23,-14,17
Anzhi,8613,11,2,6,12,16,40,-24,12
Loko Moscow,8614,1,11,6,3,29,12,17,39
CSKA Moscow,8614,2,11,3,6,29,21,8,36
Zenit,8614,3,9,8,3,24,13,11,35
Spart Moscow,8614,4,9,7,4,37,28,9,34
Krasnodar,8614,5,8,5,7,29,27,2,29
Terek Grozny,8614,6,8,5,7,22,23,-1,29
FK Rubin,8614,7,7,5,8,25,19,6,26
Din Moscow,8614,8,5,6,9,18,24,-6,21
Amkar,8614,9,5,5,10,11,23,-12,20
Rostov,8614,10,4,7,9,11,18,-7,19
Anzhi,8614,11,2,5,13,16,43,-27,11
Loko Moscow,8615,1,11,6,3,32,15,17,39
CSKA Moscow,8615,2,12,3,5,30,18,12,39
Spart Moscow,8615,3,10,6,4,38,27,11,36
Krasnodar,8615,4,10,4,6,31,26,5,34
Zenit,8615,5,7,9,4,24,18,6,30
Terek Grozny,8615,6,8,5,7,22,24,-2,29
Din Moscow,8615,7,6,7,7,19,22,-3,25
FK Rubin,8615,8,5,5,10,22,20,2,20
Amkar,8615,9,5,4,11,10,23,-13,19
Rostov,8615,10,4,6,10,11,20,-9,18
Anzhi,8615,11,2,5,13,15,41,-26,11
CSKA Moscow,8616,1,12,3,5,31,19,12,39
Loko Moscow,8616,2,11,5,4,29,14,15,38
Spart Moscow,8616,3,9,6,5,36,28,8,33
Zenit,8616,4,8,8,4,24,16,8,32
Krasnodar,8616,5,9,4,7,28,25,3,31
Terek Grozny,8616,6,8,5,7,26,25,1,29
Din Moscow,8616,7,6,7,7,19,22,-3,25
FK Rubin,8616,8,6,6,8,23,18,5,24
Amkar,8616,9,5,5,10,12,23,-11,20
Rostov,8616,10,4,6,10,11,19,-8,18
Anzhi,8616,11,2,5,13,16,46,-30,11
Loko Moscow,8617,1,11,6,3,30,14,16,39
Zenit,8617,2,9,8,3,24,13,11,35
Spart Moscow,8617,3,9,6,5,36,27,9,33
CSKA Moscow,8617,4,10,3,7,26,20,6,33
Krasnodar,8617,5,9,5,6,30,26,4,32
Terek Grozny,8617,6,7,7,6,20,22,-2,28
Din Moscow,8617,7,6,7,7,19,22,-3,25
FK Rubin,8617,8,5,6,9,23,20,3,21
Rostov,8617,9,4,6,10,10,19,-9,18
Amkar,8617,10,4,6,10,10,23,-13,18
Anzhi,8617,11,3,6,11,16,38,-22,15
Loko Moscow,8618,1,12,6,2,30,11,19,42
CSKA Moscow,8618,2,11,3,6,28,18,10,36
Spart Moscow,8618,3,10,5,5,39,30,9,35
Zenit,8618,4,8,8,4,22,14,8,32
Krasnodar,8618,5,9,5,6,28,24,4,32
Terek Grozny,8618,6,7,6,7,21,25,-4,27
Din Moscow,8618,7,6,7,7,19,22,-3,25
FK Rubin,8618,8,5,6,9,21,18,3,21
Amkar,8618,9,5,4,11,13,25,-12,19
Rostov,8618,10,4,6,10,11,19,-8,18
Anzhi,8618,11,2,6,12,15,41,-26,12
Loko Moscow,8619,1,11,5,4,31,15,16,38
Spart Moscow,8619,2,10,6,4,39,29,10,36
CSKA Moscow,8619,3,11,3,6,27,21,6,36
Zenit,8619,4,9,8,3,25,13,12,35
Krasnodar,8619,5,9,5,6,31,27,4,32
Terek Grozny,8619,6,8,6,6,23,23,0,30
FK Rubin,8619,7,5,7,8,22,18,4,22
Din Moscow,8619,8,5,7,8,20,25,-5,22
Rostov,8619,9,4,6,10,11,19,-8,18
Amkar,8619,10,4,5,11,9,24,-15,17
Anzhi,8619,11,2,6,12,16,40,-24,12
Loko Moscow,8620,1,12,5,3,31,12,19,41
CSKA Moscow,8620,2,11,3,6,29,20,9,36
Spart Moscow,8620,3,9,6,5,36,26,10,33
Zenit,8620,4,8,8,4,23,16,7,32
Terek Grozny,8620,5,8,6,6,23,23,0,30
Krasnodar,8620,6,8,5,7,27,26,1,29
Din Moscow,8620,7,7,6,7,20,21,-1,27
FK Rubin,8620,8,5,6,9,21,19,2,21
Rostov,8620,9,4,7,9,10,17,-7,19
Amkar,8620,10,4,4,12,9,27,-18,16
Anzhi,8620,11,3,6,11,17,39,-22,15
Loko Moscow,8621,1,11,6,3,30,13,17,39
Spart Moscow,8621,2,9,7,4,37,27,10,34
CSKA Moscow,8621,3,10,4,6,26,20,6,34
Zenit,8621,4,8,9,3,24,14,10,33
Krasnodar,8621,5,9,5,6,29,25,4,32
Terek Grozny,8621,6,8,5,7,24,23,1,29
FK Rubin,8621,7,5,7,8,23,19,4,22
Din Moscow,8621,8,5,7,8,19,25,-6,22
Amkar,8621,9,5,5,10,11,23,-12,20
Rostov,8621,10,4,7,9,10,17,-7,19
Anzhi,8621,11,2,6,12,15,42,-27,12
Loko Moscow,8622,1,12,5,3,31,14,17,41
CSKA Moscow,8622,2,12,3,5,30,19,11,39
Spart Moscow,8622,3,10,6,4,37,26,11,36
Zenit,8622,4,8,8,4,24,15,9,32
Terek Grozny,8622,5,8,6,6,23,23,0,30
Krasnodar,8622,6,8,5,7,29,27,2,29
Din Moscow,8622,7,6,6,8,20,23,-3,24
FK Rubin,8622,8,5,6,9,22,21,1,21
Rostov,8622,9,4,7,9,11,18,-7,19
Amkar,8622,10,4,4,12,9,25,-16,16
Anzhi,8622,11,2,6,12,16,41,-25,12
Loko Moscow,8623,1,13,5,2,33,11,22,44
Spart Moscow,8623,2,11,5,4,39,28,11,38
CSKA Moscow,8623,3,10,4,6,26,21,5,34
Zenit,8623,4,8,8,4,24,16,8,32
Krasnodar,8623,5,9,4,7,30,27,3,31
Terek Grozny,8623,6,8,5,7,23,25,-2,29
Din Moscow,8623,7,6,6,8,19,22,-3,24
FK Rubin,8623,8,5,5,10,23,22,1,20
Amkar,8623,9,5,4,11,12,25,-13,19
Rostov,8623,10,4,6,10,11,19,-8,18
Anzhi,8623,11,2,6,12,17,41,-24,12
Loko Moscow,8624,1,11,6,3,30,13,17,39
Spart Moscow,8624,2,11,5,4,38,26,12,38
CSKA Moscow,8624,3,10,5,5,27,19,8,35
Krasnodar,8624,4,10,4,6,31,26,5,34
Zenit,8624,5,7,10,3,22,14,8,31
Terek Grozny,8624,6,7,5,8,20,25,-5,26
Din Moscow,8624,7,6,6,8,20,25,-5,24
FK Rubin,8624,8,5,5,10,23,21,2,20
Amkar,8624,9,5,4,11,10,23,-13,19
Rostov,8624,10,4,6,10,10,18,-8,18
Anzhi,8624,11,3,6,11,17,38,-21,15
Loko Moscow,8625,1,11,5,4,30,15,15,38
CSKA Moscow,8625,2,11,4,5,31,19,12,37
Spart Moscow,8625,3,10,6,4,38,26,12,36
Krasnodar,8625,4,10,4,6,31,25,6,34
Zenit,8625,5,8,9,3,24,14,10,33
Terek Grozny,8625,6,9,5,6,23,22,1,32
FK Rubin,8625,7,6,5,9,24,21,3,23
Din Moscow,8625,8,5,6,9,19,27,-8,21
Rostov,8625,9,4,6,10,10,18,-8,18
Amkar,8625,10,4,5,11,10,24,-14,17
Anzhi,8625,11,2,5,13,15,44,-29,11
Loko Moscow,8626,1,13,5,2,33,13,20,44
Spart Moscow,8626,2,11,5,4,38,25,13,38
CSKA Moscow,8626,3,10,3,7,27,21,6,33
Zenit,8626,4,8,8,4,25,17,8,32
Krasnodar,8626,5,9,4,7,29,26,3,31
Terek Grozny,8626,6,7,6,7,20,23,-3,27
FK Rubin,8626,7,6,5,9,25,19,6,23
Din Moscow,8626,8,5,6,9,17,26,-9,21
Rostov,8626,9,4,6,10,10,19,-9,18
Amkar,8626,10,4,5,11,9,23,-14,17
Anzhi,8626,11,4,5,11,17,38,-21,17
CSKA Moscow,8627,1,12,3,5,29,18,11,39
Loko Moscow,8627,2,11,5,4,29,13,16,38
Krasnodar,8627,3,10,4,6,29,24,5,34
Spart Moscow,8627,4,9,6,5,39,31,8,33
Zenit,8627,5,8,8,4,23,16,7,32
Terek Grozny,8627,6,7,5,8,20,24,-4,26
Din Moscow,8627,7,6,6,8,21,23,-2,24
FK Rubin,8627,8,6,5,9,23,19,4,23
Amkar,8627,9,5,5,10,13,25,-12,20
Rostov,8627,10,4,6,10,10,20,-10,18
Anzhi,8627,11,3,5,12,15,38,-23,14
Loko Moscow,8628,1,13,5,2,36,13,23,44
CSKA Moscow,8628,2,10,4,6,25,20,5,34
Krasnodar,8628,3,9,4,7,31,29,2,31
Zenit,8628,4,7,9,4,22,17,5,30
Spart Moscow,8628,5,8,6,6,35,32,3,30
Terek Grozny,8628,6,7,5,8,21,25,-4,26
Din Moscow,8628,7,6,6,8,22,24,-2,24
FK Rubin,8628,8,6,5,9,25,20,5,23
Rostov,8628,9,5,6,9,12,18,-6,21
Amkar,8628,10,5,5,10,10,22,-12,20
Anzhi,8628,11,4,5,11,19,38,-19,17
Loko Moscow,8629,1,11,5,4,29,15,14,38
Zenit,8629,2,9,8,3,23,13,10,35
CSKA Moscow,8629,3,10,4,6,26,19,7,34
Spart Moscow,8629,4,9,6,5,38,30,8,33
Krasnodar,8629,5,9,4,7,30,25,5,31
Terek Grozny,8629,6,8,6,6,25,26,-1,30
Din Moscow,8629,7,6,7,7,21,22,-1,25
FK Rubin,8629,8,6,6,8,23,18,5,24
Rostov,8629,9,4,6,10,11,21,-10,18
Amkar,8629,10,4,6,10,12,25,-13,18
Anzhi,8629,11,2,6,12,17,41,-24,12
Loko Moscow,8630,1,11,6,3,32,15,17,39
Spart Moscow,8630,2,10,5,5,38,28,10,35
Krasnodar,8630,3,10,4,6,33,25,8,34
Zenit,8630,4,8,9,3,24,15,9,33
CSKA Moscow,8630,5,10,3,7,25,19,6,33
Terek Grozny,8630,6,7,7,6,23,25,-2,28
Din Moscow,8630,7,6,6,8,19,25,-6,24
FK Rubin,8630,8,5,5,10,22,23,-1,20
Amkar,8630,9,5,5,10,14,25,-11,20
Rostov,8630,10,4,6,10,10,18,-8,18
Anzhi,8630,11,3,6,11,16,38,-22,15
Loko Moscow,8631,1,12,6,2,33,14,19,42
CSKA Moscow,8631,2,11,4,5,26,17,9,37
Krasnodar,8631,3,9,5,6,32,27,5,32
Spart Moscow,8631,4,8,7,5,33,26,7,31
Zenit,8631,5,7,9,4,22,15,7,30
Terek Grozny,8631,6,8,5,7,22,25,-3,29
Din Moscow,8631,7,5,8,7,17,21,-4,23
FK Rubin,8631,8,5,6,9,22,20,2,21
Rostov,8631,9,5,6,9,11,17,-6,21
Amkar,8631,10,5,5,10,11,22,-11,20
Anzhi,8631,11,2,5,13,15,40,-25,11
Loko Moscow,8632,1,11,6,3,30,13,17,39
CSKA Moscow,8632,2,11,3,6,28,20,8,36
Zenit,8632,3,8,9,3,25,15,10,33
Spart Moscow,8632,4,9,6,5,38,30,8,33
Krasnodar,8632,5,9,4,7,28,25,3,31
Terek Grozny,8632,6,8,6,6,23,24,-1,30
FK Rubin,8632,7,7,5,8,23,17,6,26
Din Moscow,8632,8,5,6,9,18,25,-7,21
Rostov,8632,9,4,7,9,12,19,-7,19
Amkar,8632,10,5,4,11,11,23,-12,19
Anzhi,8632,11,2,6,12,16,41,-25,12
Loko Moscow,8633,1,11,6,3,32,15,17,39
Spart Moscow,8633,2,11,5,4,41,26,15,38
CSKA Moscow,8633,3,10,5,5,29,21,8,35
Zenit,8633,4,8,9,3,25,16,9,33
Krasnodar,8633,5,8,5,7,28,26,2,29
Terek Grozny,8633,6,8,5,7,23,25,-2,29
Din Moscow,8633,7,6,6,8,18,24,-6,24
FK Rubin,8633,8,6,5,9,22,18,4,23
Rostov,8633,9,4,6,10,10,20,-10,18
Amkar,8633,10,4,4,12,11,26,-15,16
Anzhi,8633,11,3,6,11,19,41,-22,15
Loko Moscow,8634,1,13,5,2,34,11,23,44
CSKA Moscow,8634,2,11,4,5,26,17,9,37
Spart Moscow,8634,3,9,5,6,36,34,2,32
Zenit,8634,4,7,8,5,21,16,5,29
Krasnodar,8634,5,8,5,7,29,29,0,29
Terek Grozny,8634,6,8,5,7,22,24,-2,29
FK Rubin,8634,7,6,6,8,24,19,5,24
Rostov,8634,8,5,6,9,14,19,-5,21
Din Moscow,8634,9,5,6,9,17,23,-6,21
Amkar,8634,10,5,4,11,15,24,-9,19
Anzhi,8634,11,3,6,11,15,37,-22,15
Loko Moscow,8635,1,11,5,4,30,15,15,38
CSKA Moscow,8635,2,11,4,5,28,19,9,37
Spart Moscow,8635,3,9,7,4,38,28,10,34
Krasnodar,8635,4,10,4,6,30,24,6,34
Zenit,8635,5,8,9,3,24,15,9,33
Terek Grozny,8635,6,7,5,8,20,25,-5,26
Din Moscow,8635,7,5,8,7,19,23,-4,23
FK Rubin,8635,8,5,6,9,22,19,3,21
Amkar,8635,9,5,5,10,13,24,-11,20
Rostov,8635,10,4,6,10,10,19,-9,18
Anzhi,8635,11,3,5,12,16,39,-23,14
Loko Moscow,8636,1,11,6,3,31,16,15,39
CSKA Moscow,8636,2,11,4,5,31,17,14,37
Spart Moscow,8636,3,10,5,5,36,28,8,35
Zenit,8636,4,7,10,3,22,14,8,31
Krasnodar,8636,5,9,4,7,31,26,5,31
Terek Grozny,8636,6,8,5,7,23,24,-1,29
Din Moscow,8636,7,7,6,7,21,22,-1,27
FK Rubin,8636,8,6,5,9,23,19,4,23
Rostov,8636,9,4,6,10,11,19,-8,18
Amkar,8636,10,4,4,12,9,25,-16,16
Anzhi,8636,11,3,5,12,16,44,-28,14
Loko Moscow,8637,1,11,6,3,30,14,16,39
CSKA Moscow,8637,2,10,5,5,27,19,8,35
Krasnodar,8637,3,10,4,6,31,24,7,34
Spart Moscow,8637,4,8,8,4,35,27,8,32
Zenit,8637,5,7,10,3,22,14,8,31
Terek Grozny,8637,6,7,6,7,20,25,-5,27
FK Rubin,8637,7,6,5,9,24,19,5,23
Din Moscow,8637,8,5,7,8,17,24,-7,22
Amkar,8637,9,5,5,10,13,23,-10,20
Rostov,8637,10,4,7,9,11,18,-7,19
Anzhi,8637,11,2,7,11,16,39,-23,13
Loko Moscow,8638,1,11,6,3,30,13,17,39
Spart Moscow,8638,2,11,5,4,39,27,12,38
CSKA Moscow,8638,3,11,3,6,28,20,8,36
Zenit,8638,4,8,9,3,23,13,10,33
Krasnodar,8638,5,9,5,6,30,26,4,32
Terek Grozny,8638,6,9,5,6,28,25,3,32
Din Moscow,8638,7,6,6,8,20,25,-5,24
FK Rubin,8638,8,5,6,9,22,19,3,21
Rostov,8638,9,4,6,10,10,18,-8,18
Amkar,8638,10,4,4,12,10,27,-17,16
Anzhi,8638,11,2,5,13,17,44,-27,11
Loko Moscow,8639,1,12,6,2,32,12,20,42
Spart Moscow,8639,2,11,5,4,40,26,14,38
CSKA Moscow,8639,3,11,4,5,27,18,9,37
Krasnodar,8639,4,9,5,6,30,25,5,32
Zenit,8639,5,7,9,4,21,15,6,30
Terek Grozny,8639,6,8,6,6,23,23,0,30
FK Rubin,8639,7,6,5,9,23,19,4,23
Din Moscow,8639,8,5,6,9,17,26,-9,21
Rostov,8639,9,4,6,10,10,19,-9,18
Amkar,8639,10,4,5,11,11,25,-14,17
Anzhi,8639,11,2,5,13,15,41,-26,11
Loko Moscow,8640,1,13,5,2,33,12,21,44
CSKA Moscow,8640,2,12,3,5,30,19,11,39
Krasnodar,8640,3,9,4,7,29,26,3,31
Zenit,8640,4,7,8,5,22,17,5,29
Spart Moscow,8640,5,8,5,7,35,34,1,29
Din Moscow,8640,6,7,6,7,22,24,-2,27
Terek Grozny,8640,7,7,6,7,22,26,-4,27
Amkar,8640,8,6,4,10,14,22,-8,22
Rostov,8640,9,5,6,9,13,17,-4,21
FK Rubin,8640,10,5,5,10,22,20,2,20
Anzhi,8640,11,2,6,12,17,42,-25,12
Loko Moscow,8641,1,11,6,3,31,14,17,39
CSKA Moscow,8641,2,11,3,6,26,18,8,36
Spart Moscow,8641,3,9,5,6,37,28,9,32
Zenit,8641,4,8,8,4,22,14,8,32
Krasnodar,8641,5,9,5,6,32,26,6,32
Terek Grozny,8641,6,9,5,6,28,24,4,32
Din Moscow,8641,7,6,7,7,19,21,-2,25
FK Rubin,8641,8,5,6,9,21,20,1,21
Rostov,8641,9,5,6,9,11,17,-6,21
Amkar,8641,10,4,4,12,10,28,-18,16
Anzhi,8641,11,3,5,12,16,43,-27,14
Loko Moscow,8642,1,12,6,2,31,11,20,42
CSKA Moscow,8642,2,11,3,6,27,19,8,36
Zenit,8642,3,8,9,3,23,14,9,33
Spart Moscow,8642,4,9,6,5,36,29,7,33
Terek Grozny,8642,5,8,6,6,23,24,-1,30
Krasnodar,8642,6,8,4,8,27,27,0,28
Din Moscow,8642,7,6,7,7,20,22,-2,25
FK Rubin,8642,8,6,6,8,23,18,5,24
Rostov,8642,9,4,6,10,11,19,-8,18
Amkar,8642,10,4,5,11,11,25,-14,17
Anzhi,8642,11,2,6,12,15,39,-24,12
Loko Moscow,8643,1,12,6,2,31,11,20,42
Spart Moscow,8643,2,11,5,4,45,28,17,38
CSKA Moscow,8643,3,11,4,5,29,19,10,37
Zenit,8643,4,7,9,4,21,15,6,30
Terek Grozny,8643,5,8,6,6,22,23,-1,30
Krasnodar,8643,6,8,5,7,27,25,2,29
Din Moscow,8643,7,6,6,8,20,26,-6,24
FK Rubin,8643,8,6,5,9,23,19,4,23
Rostov,8643,9,4,6,10,10,22,-12,18
Amkar,8643,10,4,4,12,11,26,-15,16
Anzhi,8643,11,2,6,12,17,42,-25,12
Loko Moscow,8644,1,12,6,2,33,12,21,42
CSKA Moscow,8644,2,11,4,5,27,18,9,37
Spart Moscow,8644,3,9,5,6,36,29,7,32
Zenit,8644,4,7,10,3,22,14,8,31
Krasnodar,8644,5,8,5,7,28,28,0,29
Din Moscow,8644,6,7,6,7,21,23,-2,27
Terek Grozny,8644,7,7,6,7,20,23,-3,27
FK Rubin,8644,8,5,6,9,22,19,3,21
Rostov,8644,9,5,6,9,12,18,-6,21
Amkar,8644,10,4,5,11,9,23,-14,17
Anzhi,8644,11,3,5,12,15,38,-23,14
Loko Moscow,8645,1,11,6,3,29,15,14,39
CSKA Moscow,8645,2,11,3,6,29,18,11,36
Spart Moscow,8645,3,9,7,4,36,27,9,34
Zenit,8645,4,8,9,3,22,13,9,33
Krasnodar,8645,5,9,4,7,31,25,6,31
Terek Grozny,8645,6,8,5,7,22,24,-2,29
Din Moscow,8645,7,6,6,8,21,23,-2,24
FK Rubin,8645,8,6,5,9,22,20,2,23
Amkar,8645,9,5,5,10,11,23,-12,20
Rostov,8645,10,4,7,9,11,18,-7,19
Anzhi,8645,11,2,5,13,14,42,-28,11
Loko Moscow,8646,1,11,6,3,30,14,16,39
CSKA Moscow,8646,2,11,4,5,28,18,10,37
Zenit,8646,3,8,9,3,23,13,10,33
Krasnodar,8646,4,8,6,6,28,25,3,30
Spart Moscow,8646,5,8,5,7,35,30,5,29
Terek Grozny,8646,6,7,5,8,20,24,-4,26
FK Rubin,8646,7,6,6,8,24,19,5,24
Din Moscow,8646,8,6,6,8,21,25,-4,24
Amkar,8646,9,6,4,10,11,22,-11,22
Rostov,8646,10,5,6,9,12,18,-6,21
Anzhi,8646,11,3,5,12,16,40,-24,14
Loko Moscow,8647,1,12,5,3,30,12,18,41
Spart Moscow,8647,2,10,6,4,37,25,12,36
CSKA Moscow,8647,3,11,3,6,28,20,8,36
Zenit,8647,4,8,8,4,24,15,9,32
Krasnodar,8647,5,9,5,6,28,24,4,32
Terek Grozny,8647,6,7,6,7,22,25,-3,27
Din Moscow,8647,7,6,6,8,19,25,-6,24
FK Rubin,8647,8,5,6,9,22,19,3,21
Rostov,8647,9,4,6,10,10,18,-8,18
Amkar,8647,10,4,6,10,11,24,-13,18
Anzhi,8647,11,3,5,12,15,39,-24,14
Loko Moscow,8648,1,13,5,2,33,12,21,44
Spart Moscow,8648,2,11,5,4,42,26,16,38
CSKA Moscow,8648,3,10,3,7,26,21,5,33
Zenit,8648,4,8,8,4,24,15,9,32
Terek Grozny,8648,5,8,5,7,21,23,-2,29
Krasnodar,8648,6,8,4,8,27,28,-1,28
FK Rubin,8648,7,7,5,8,25,17,8,26
Din Moscow,8648,8,5,6,9,18,26,-8,21
Amkar,8648,9,5,4,11,10,24,-14,19
Rostov,8648,10,4,6,10,10,21,-11,18
Anzhi,8648,11,3,5,12,16,39,-23,14
Loko Moscow,8649,1,12,5,3,36,15,21,41
CSKA Moscow,8649,2,11,3,6,30,22,8,36
Spart Moscow,8649,3,9,5,6,36,30,6,32
Zenit,8649,4,8,8,4,27,21,6,32
Krasnodar,8649,5,9,5,6,30,26,4,32
Terek Grozny,8649,6,7,5,8,21,25,-4,26
Din Moscow,8649,7,6,6,8,19,22,-3,24
Amkar,8649,8,6,4,10,13,24,-11,22
FK Rubin,8649,9,5,6,9,22,20,2,21
Rostov,8649,10,5,6,9,12,17,-5,21
Anzhi,8649,11,3,5,12,17,41,-24,14
Loko Moscow,8650,1,12,5,3,34,14,20,41
CSKA Moscow,8650,2,11,3,6,26,19,7,36
Zenit,8650,3,9,8,3,25,14,11,35
Spart Moscow,8650,4,9,7,4,38,28,10,34
Terek Grozny,8650,5,8,5,7,24,25,-1,29
Krasnodar,8650,6,8,4,8,28,31,-3,28
FK Rubin,8650,7,6,6,8,25,18,7,24
Din Moscow,8650,8,5,7,8,18,24,-6,22
Amkar,8650,9,5,5,10,13,24,-11,20
Rostov,8650,10,4,7,9,11,18,-7,19
Anzhi,8650,11,2,5,13,15,42,-27,11
Loko Moscow,8651,1,12,6,2,33,14,19,42
CSKA Moscow,8651,2,11,4,5,26,17,9,37
Spart Moscow,8651,3,9,6,5,39,32,7,33
Zenit,8651,4,7,9,4,23,16,7,30
Krasnodar,8651,5,8,6,6,28,25,3,30
Terek Grozny,8651,6,7,6,7,21,24,-3,27
Din Moscow,8651,7,6,6,8,21,25,-4,24
FK Rubin,8651,8,5,6,9,21,18,3,21
Rostov,8651,9,5,6,9,13,18,-5,21
Amkar,8651,10,5,5,10,11,23,-12,20
Anzhi,8651,11,2,6,12,15,39,-24,12
Loko Moscow,8652,1,12,6,2,34,12,22,42
Spart Moscow,8652,2,11,5,4,39,25,14,38
CSKA Moscow,8652,3,11,3,6,28,19,9,36
Zenit,8652,4,8,8,4,23,17,6,32
Krasnodar,8652,5,8,5,7,28,27,1,29
Terek Grozny,8652,6,7,6,7,22,27,-5,27
FK Rubin,8652,7,6,6,8,23,17,6,24
Din Moscow,8652,8,5,7,8,17,24,-7,22
Rostov,8652,9,4,6,10,10,19,-9,18
Amkar,8652,10,4,5,11,9,23,-14,17
Anzhi,8652,11,3,5,12,19,42,-23,14
Loko Moscow,8653,1,11,6,3,30,13,17,39
CSKA Moscow,8653,2,12,3,5,28,18,10,39
Zenit,8653,3,8,8,4,22,14,8,32
Krasnodar,8653,4,9,5,6,29,25,4,32
Spart Moscow,8653,5,8,7,5,38,31,7,31
Terek Grozny,8653,6,8,6,6,22,23,-1,30
Din Moscow,8653,7,5,8,7,18,22,-4,23
FK Rubin,8653,8,5,6,9,21,18,3,21
Rostov,8653,9,5,6,9,11,17,-6,21
Amkar,8653,10,4,6,10,13,26,-13,18
Anzhi,8653,11,2,5,13,16,41,-25,11
Loko Moscow,8654,1,13,5,2,33,11,22,44
CSKA Moscow,8654,2,10,4,6,25,18,7,34
Spart Moscow,8654,3,9,5,6,40,31,9,32
Zenit,8654,4,8,8,4,22,15,7,32
Terek Grozny,8654,5,9,5,6,26,24,2,32
Krasnodar,8654,6,8,5,7,27,26,1,29
FK Rubin,8654,7,6,6,8,23,18,5,24
Rostov,8654,8,5,6,9,13,18,-5,21
Din Moscow,8654,9,5,6,9,18,27,-9,21
Amkar,8654,10,5,4,11,13,27,-14,19
Anzhi,8654,11,2,6,12,15,40,-25,12
Loko Moscow,8655,1,12,5,3,32,13,19,41
CSKA Moscow,8655,2,11,4,5,27,17,10,37
Krasnodar,8655,3,10,4,6,32,25,7,34
Spart Moscow,8655,4,9,6,5,39,30,9,33
Zenit,8655,5,7,9,4,21,15,6,30
Terek Grozny,8655,6,8,6,6,23,24,-1,30
FK Rubin,8655,7,6,5,9,23,21,2,23
Din Moscow,8655,8,5,7,8,20,25,-5,22
Rostov,8655,9,5,6,9,12,18,-6,21
Amkar,8655,10,4,4,12,10,26,-16,16
Anzhi,8655,11,2,6,12,16,41,-25,12
Loko Moscow,8656,1,12,6,2,31,12,19,42
CSKA Moscow,8656,2,10,4,6,27,21,6,34
Zenit,8656,3,8,9,3,24,14,10,33
Spart Moscow,8656,4,8,6,6,34,29,5,30
Terek Grozny,8656,5,8,5,7,24,27,-3,29
Krasnodar,8656,6,8,4,8,28,27,1,28
Din Moscow,8656,7,6,7,7,19,22,-3,25
FK Rubin,8656,8,6,6,8,23,18,5,24
Rostov,8656,9,5,6,9,13,18,-5,21
Amkar,8656,10,4,5,11,9,24,-15,17
Anzhi,8656,11,3,6,11,20,40,-20,15
CSKA Moscow,8657,1,12,3,5,30,17,13,39
Loko Moscow,8657,2,11,5,4,29,16,13,38
Zenit,8657,3,8,8,4,24,15,9,32
Spart Moscow,8657,4,8,8,4,37,29,8,32
Krasnodar,8657,5,9,5,6,29,24,5,32
Terek Grozny,8657,6,8,6,6,21,22,-1,30
FK Rubin,8657,7,6,6,8,23,18,5,24
Din Moscow,8657,8,5,7,8,20,25,-5,22
Rostov,8657,9,4,7,9,11,18,-7,19
Amkar,8657,10,4,5,11,10,24,-14,17
Anzhi,8657,11,2,6,12,14,40,-26,12
Loko Moscow,8658,1,12,5,3,30,15,15,41
CSKA Moscow,8658,2,10,4,6,27,21,6,34
Spart Moscow,8658,3,9,5,6,36,31,5,32
Krasnodar,8658,4,9,4,7,31,25,6,31
Zenit,8658,5,7,9,4,22,15,7,30
Terek Grozny,8658,6,7,6,7,21,24,-3,27
FK Rubin,8658,7,7,5,8,24,17,7,26
Din Moscow,8658,8,6,6,8,21,24,-3,24
Amkar,8658,9,6,4,10,12,23,-11,22
Rostov,8658,10,4,6,10,11,19,-8,18
Anzhi,8658,11,3,6,11,17,38,-21,15
Loko Moscow,8659,1,12,5,3,31,14,17,41
CSKA Moscow,8659,2,11,3,6,27,18,9,36
Spart Moscow,8659,3,9,6,5,41,33,8,33
Krasnodar,8659,4,9,4,7,30,27,3,31
Terek Grozny,8659,5,8,6,6,24,25,-1,30
Zenit,8659,6,7,8,5,21,17,4,29
Din Moscow,8659,7,7,6,7,22,23,-1,27
FK Rubin,8659,8,6,5,9,24,19,5,23
Rostov,8659,9,4,6,10,13,21,-8,18
Amkar,8659,10,4,6,10,12,25,-13,18
Anzhi,8659,11,3,5,12,17,40,-23,14
Loko Moscow,8660,1,11,6,3,31,16,15,39
Zenit,8660,2,9,8,3,26,13,13,35
CSKA Moscow,8660,3,10,3,7,26,21,5,33
Spart Moscow,8660,4,8,7,5,36,29,7,31
Krasnodar,8660,5,8,5,7,29,27,2,29
Terek Grozny,8660,6,7,6,7,21,25,-4,27
FK Rubin,8660,7,7,5,8,24,18,6,26
Din Moscow,8660,8,5,7,8,18,23,-5,22
Rostov,8660,9,5,6,9,13,19,-6,21
Amkar,8660,10,4,6,10,11,24,-13,18
Anzhi,8660,11,4,5,11,18,38,-20,17
Loko Moscow,8661,1,12,6,2,30,11,19,42
CSKA Moscow,8661,2,11,4,5,27,17,10,37
Spart Moscow,8661,3,9,6,5,40,32,8,33
Zenit,8661,4,7,9,4,21,14,7,30
Krasnodar,8661,5,8,6,6,29,26,3,30
Terek Grozny,8661,6,8,5,7,23,26,-3,29
FK Rubin,8661,7,6,6,8,25,20,5,24
Din Moscow,8661,8,5,7,8,20,25,-5,22
Amkar,8661,9,5,4,11,13,27,-14,19
Rostov,8661,10,4,6,10,12,20,-8,18
Anzhi,8661,11,3,5,12,17,39,-22,14
Loko Moscow,8662,1,12,5,3,30,12,18,41
CSKA Moscow,8662,2,11,4,5,29,19,10,37
Spart Moscow,8662,3,10,5,5,38,31,7,35
Zenit,8662,4,8,9,3,23,14,9,33
Krasnodar,8662,5,9,4,7,30,25,5,31
Terek Grozny,8662,6,7,7,6,21,23,-2,28
Din Moscow,8662,7,6,6,8,20,22,-2,24
FK Rubin,8662,8,5,5,10,21,23,-2,20
Amkar,8662,9,5,5,10,12,22,-10,20
Rostov,8662,10,4,6,10,13,21,-8,18
Anzhi,8662,11,2,6,12,16,41,-25,12
Loko Moscow,8663,1,12,5,3,34,12,22,41
Spart Moscow,8663,2,10,5,5,38,27,11,35
CSKA Moscow,8663,3,10,4,6,26,19,7,34
Krasnodar,8663,4,10,4,6,30,25,5,34
Zenit,8663,5,8,8,4,22,18,4,32
Terek Grozny,8663,6,8,5,7,22,24,-2,29
Din Moscow,8663,7,6,6,8,19,23,-4,24
FK Rubin,8663,8,6,5,9,23,19,4,23
Amkar,8663,9,5,4,11,11,23,-12,19
Rostov,8663,10,4,6,10,10,20,-10,18
Anzhi,8663,11,2,6,12,15,40,-25,12
Loko Moscow,8664,1,12,6,2,32,13,19,42
CSKA Moscow,8664,2,10,4,6,28,21,7,34
Zenit,8664,3,8,9,3,25,16,9,33
Spart Moscow,8664,4,9,6,5,34,26,8,33
Krasnodar,8664,5,8,5,7,28,26,2,29
Terek Grozny,8664,6,8,5,7,22,24,-2,29
Din Moscow,8664,7,6,7,7,18,21,-3,25
Amkar,8664,8,6,4,10,11,22,-11,22
FK Rubin,8664,9,5,6,9,21,18,3,21
Rostov,8664,10,4,6,10,10,18,-8,18
Anzhi,8664,11,2,6,12,16,40,-24,12
Loko Moscow,8665,1,13,5,2,33,11,22,44
CSKA Moscow,8665,2,11,3,6,29,22,7,36
Zenit,8665,3,8,8,4,24,17,7,32
Spart Moscow,8665,4,8,7,5,36,29,7,31
Krasnodar,8665,5,9,4,7,28,25,3,31
Terek Grozny,8665,6,8,6,6,21,22,-1,30
FK Rubin,8665,7,6,5,9,23,18,5,23
Din Moscow,8665,8,5,7,8,18,24,-6,22
Rostov,8665,9,5,6,9,12,18,-6,21
Amkar,8665,10,4,6,10,10,23,-13,18
Anzhi,8665,11,2,5,13,16,41,-25,11
Loko Moscow,8666,1,12,5,3,31,13,18,41
Spart Moscow,8666,2,9,7,4,39,29,10,34
CSKA Moscow,8666,3,10,4,6,26,19,7,34
Krasnodar,8666,4,10,4,6,30,25,5,34
Zenit,8666,5,8,8,4,22,14,8,32
Terek Grozny,8666,6,8,6,6,24,24,0,30
Din Moscow,8666,7,5,7,8,19,25,-6,22
FK Rubin,8666,8,5,6,9,22,19,3,21
Rostov,8666,9,4,7,9,12,19,-7,19
Amkar,8666,10,4,5,11,12,27,-15,17
Anzhi,8666,11,2,7,11,15,38,-23,13
Loko Moscow,8667,1,11,6,3,30,13,17,39
Spart Moscow,8667,2,10,5,5,37,27,10,35
Zenit,8667,3,9,8,3,23,13,10,35
CSKA Moscow,8667,4,10,4,6,26,19,7,34
Krasnodar,8667,5,9,5,6,31,27,4,32
Terek Grozny,8667,6,9,5,6,26,25,1,32
Din Moscow,8667,7,5,7,8,17,24,-7,22
FK Rubin,8667,8,5,6,9,23,20,3,21
Amkar,8667,9,5,4,11,11,23,-12,19
Rostov,8667,10,4,6,10,10,18,-8,18
Anzhi,8667,11,2,6,12,18,43,-25,12
Loko Moscow,8668,1,11,7,2,34,16,18,40
CSKA Moscow,8668,2,12,3,5,29,18,11,39
Spart Moscow,8668,3,10,5,5,40,28,12,35
Zenit,8668,4,7,9,4,23,16,7,30
Krasnodar,8668,5,8,6,6,32,29,3,30
Terek Grozny,8668,6,7,6,7,20,23,-3,27
Din Moscow,8668,7,6,6,8,18,24,-6,24
FK Rubin,8668,8,5,6,9,22,19,3,21
Rostov,8668,9,5,6,9,12,18,-6,21
Amkar,8668,10,4,5,11,10,25,-15,17
Anzhi,8668,11,3,5,12,15,39,-24,14
Loko Moscow,8669,1,11,7,2,32,14,18,40
CSKA Moscow,8669,2,12,3,5,28,18,10,39
Spart Moscow,8669,3,10,6,4,42,28,14,36
Krasnodar,8669,4,9,5,6,29,25,4,32
Zenit,8669,5,7,9,4,24,17,7,30
Terek Grozny,8669,6,8,6,6,23,24,-1,30
FK Rubin,8669,7,6,5,9,22,18,4,23
Din Moscow,8669,8,5,6,9,19,28,-9,21
Rostov,8669,9,4,6,10,10,19,-9,18
Amkar,8669,10,4,6,10,11,24,-13,18
Anzhi,8669,11,2,5,13,15,40,-25,11
Loko Moscow,8670,1,12,6,2,30,11,19,42
CSKA Moscow,8670,2,11,3,6,26,18,8,36
Spart Moscow,8670,3,10,5,5,38,26,12,35
Zenit,8670,4,8,9,3,22,13,9,33
Krasnodar,8670,5,8,5,7,27,25,2,29
Terek Grozny,8670,6,7,6,7,20,24,-4,27
Din Moscow,8670,7,6,6,8,19,25,-6,24
Amkar,8670,8,6,4,10,12,22,-10,22
FK Rubin,8670,9,5,6,9,22,19,3,21
Rostov,8670,10,4,6,10,10,19,-9,18
Anzhi,8670,11,2,6,12,14,38,-24,12
Loko Moscow,8671,1,11,5,4,31,15,16,38
CSKA Moscow,8671,2,11,3,6,29,21,8,36
Zenit,8671,3,9,8,3,27,17,10,35
Krasnodar,8671,4,10,4,6,30,25,5,34
Spart Moscow,8671,5,9,5,6,36,28,8,32
Terek Grozny,8671,6,8,6,6,21,22,-1,30
Din Moscow,8671,7,6,6,8,19,22,-3,24
FK Rubin,8671,8,6,5,9,23,19,4,23
Amkar,8671,9,5,5,10,10,22,-12,20
Rostov,8671,10,4,6,10,10,20,-10,18
Anzhi,8671,11,2,5,13,15,40,-25,11
Loko Moscow,8672,1,11,7,2,32,14,18,40
Spart Moscow,8672,2,10,6,4,36,26,10,36
CSKA Moscow,8672,3,10,4,6,28,23,5,34
Zenit,8672,4,8,9,3,26,15,11,33
Krasnodar,8672,5,9,5,6,30,26,4,32
Terek Grozny,8672,6,8,5,7,22,24,-2,29
FK Rubin,8672,7,6,5,9,24,19,5,23
Din Moscow,8672,8,5,6,9,17,24,-7,21
Rostov,8672,9,4,6,10,10,18,-8,18
Amkar,8672,10,4,5,11,11,25,-14,17
Anzhi,8672,11,3,6,11,18,40,-22,15
Loko Moscow,8673,1,12,5,3,31,15,16,41
CSKA Moscow,8673,2,12,3,5,29,18,11,39
Spart Moscow,8673,3,9,6,5,35,28,7,33
Krasnodar,8673,4,9,5,6,32,25,7,32
Terek Grozny,8673,5,9,5,6,24,24,0,32
Zenit,8673,6,7,8,5,21,16,5,29
Din Moscow,8673,7,6,6,8,18,22,-4,24
FK Rubin,8673,8,5,6,9,22,19,3,21
Rostov,8673,9,5,6,9,12,17,-5,21
Amkar,8673,10,4,5,11,11,25,-14,17
Anzhi,8673,11,2,5,13,16,42,-26,11
Loko Moscow,8674,1,11,6,3,30,13,17,39
CSKA Moscow,8674,2,11,3,6,30,19,11,36
Spart Moscow,8674,3,10,5,5,42,28,14,35
Zenit,8674,4,9,8,3,24,13,11,35
Krasnodar,8674,5,9,5,6,29,25,4,32
Terek Grozny,8674,6,8,6,6,23,23,0,30
FK Rubin,8674,7,6,5,9,23,19,4,23
Din Moscow,8674,8,5,6,9,18,28,-10,21
Amkar,8674,9,5,5,10,12,24,-12,20
Rostov,8674,10,4,6,10,11,20,-9,18
Anzhi,8674,11,2,5,13,14,44,-30,11
Loko Moscow,8675,1,12,5,3,31,14,17,41
CSKA Moscow,8675,2,11,4,5,28,18,10,37
Spart Moscow,8675,3,10,6,4,40,26,14,36
Krasnodar,8675,4,9,4,7,31,27,4,31
Terek Grozny,8675,5,8,6,6,21,22,-1,30
Zenit,8675,6,7,8,5,22,17,5,29
FK Rubin,8675,7,7,5,8,26,20,6,26
Din Moscow,8675,8,5,6,9,19,26,-7,21
Rostov,8675,9,4,7,9,10,17,-7,19
Amkar,8675,10,4,5,11,9,26,-17,17
Anzhi,8675,11,2,6,12,15,39,-24,12
Loko Moscow,8676,1,11,6,3,30,13,17,39
CSKA Moscow,8676,2,12,3,5,31,18,13,39
Spart Moscow,8676,3,10,5,5,39,29,10,35
Zenit,8676,4,8,8,4,23,15,8,32
Krasnodar,8676,5,9,5,6,31,26,5,32
Terek Grozny,8676,6,8,5,7,22,24,-2,29
Din Moscow,8676,7,6,6,8,19,24,-5,24
FK Rubin,8676,8,6,5,9,24,20,4,23
Amkar,8676,9,5,4,11,12,26,-14,19
Rostov,8676,10,4,6,10,11,19,-8,18
Anzhi,8676,11,2,5,13,14,42,-28,11
Loko Moscow,8677,1,11,5,4,31,16,15,38
CSKA Moscow,8677,2,11,3,6,30,23,7,36
Zenit,8677,3,9,8,3,27,15,12,35
Spart Moscow,8677,4,9,5,6,36,29,7,32
Terek Grozny,8677,5,9,5,6,24,22,2,32
Krasnodar,8677,6,9,4,7,30,27,3,31
Din Moscow,8677,7,6,6,8,19,24,-5,24
FK Rubin,8677,8,6,5,9,23,18,5,23
Rostov,8677,9,5,6,9,11,17,-6,21
Amkar,8677,10,5,4,11,11,23,-12,19
Anzhi,8677,11,2,5,13,16,44,-28,11
Loko Moscow,8678,1,13,5,2,32,11,21,44
Spart Moscow,8678,2,10,6,4,39,26,13,36
CSKA Moscow,8678,3,10,4,6,26,20,6,34
Zenit,8678,4,8,8,4,23,15,8,32
Krasnodar,8678,5,9,4,7,29,26,3,31
Terek Grozny,8678,6,8,5,7,21,24,-3,29
Din Moscow,8678,7,6,6,8,20,24,-4,24
FK Rubin,8678,8,5,5,10,23,21,2,20
Rostov,8678,9,4,6,10,10,21,-11,18
Amkar,8678,10,4,5,11,9,23,-14,17
Anzhi,8678,11,3,6,11,17,38,-21,15
Loko Moscow,8679,1,12,5,3,32,14,18,41
CSKA Moscow,8679,2,11,4,5,28,19,9,37
Spart Moscow,8679,3,10,5,5,39,30,9,35
Krasnodar,8679,4,9,4,7,32,28,4,31
Zenit,8679,5,7,9,4,22,16,6,30
Din Moscow,8679,6,7,6,7,21,21,0,27
Terek Grozny,8679,7,7,6,7,20,23,-3,27
FK Rubin,8679,8,6,5,9,24,21,3,23
Amkar,8679,9,5,4,11,12,25,-13,19
Rostov,8679,10,4,6,10,11,20,-9,18
Anzhi,8679,11,2,6,12,15,39,-24,12
Loko Moscow,8680,1,12,5,3,32,15,17,41
CSKA Moscow,8680,2,12,3,5,33,19,14,39
Spart Moscow,8680,3,10,5,5,36,26,10,35
Zenit,8680,4,8,8,4,25,16,9,32
Terek Grozny,8680,5,9,5,6,23,23,0,32
Krasnodar,8680,6,8,5,7,28,26,2,29
FK Rubin,8680,7,6,6,8,24,17,7,24
Din Moscow,8680,8,5,6,9,17,25,-8,21
Amkar,8680,9,5,4,11,11,24,-13,19
Rostov,8680,10,4,6,10,10,19,-9,18
Anzhi,8680,11,2,5,13,15,44,-29,11
Loko Moscow,8681,1,12,6,2,32,12,20,42
Spart Moscow,8681,2,10,6,4,40,28,12,36
CSKA Moscow,8681,3,11,3,6,29,20,9,36
Zenit,8681,4,8,9,3,24,14,10,33
Krasnodar,8681,5,9,4,7,28,26,2,31
Terek Grozny,8681,6,8,6,6,23,24,-1,30
Din Moscow,8681,7,6,6,8,20,24,-4,24
FK Rubin,8681,8,5,5,10,22,20,2,20
Rostov,8681,9,4,6,10,10,20,-10,18
Amkar,8681,10,4,6,10,12,25,-13,18
Anzhi,8681,11,2,5,13,16,43,-27,11
Loko Moscow,8682,1,13,5,2,33,12,21,44
CSKA Moscow,8682,2,10,5,5,25,17,8,35
Spart Moscow,8682,3,9,6,5,37,30,7,33
Zenit,8682,4,7,9,4,22,15,7,30
Krasnodar,8682,5,8,5,7,28,27,1,29
Terek Grozny,8682,6,7,6,7,21,26,-5,27
FK Rubin,8682,7,5,7,8,22,18,4,22
Din Moscow,8682,8,5,7,8,17,22,-5,22
Amkar,8682,9,6,4,10,15,23,-8,22
Rostov,8682,10,4,7,9,12,19,-7,19
Anzhi,8682,11,2,7,11,15,38,-23,13
Loko Moscow,8683,1,11,5,4,30,14,16,38
CSKA Moscow,8683,2,11,3,6,27,18,9,36
Zenit,8683,3,9,8,3,23,13,10,35
Krasnodar,8683,4,10,4,6,30,25,5,34
Spart Moscow,8683,5,8,7,5,34,28,6,31
Terek Grozny,8683,6,8,6,6,22,23,-1,30
Din Moscow,8683,7,6,6,8,19,23,-4,24
FK Rubin,8683,8,6,5,9,23,18,5,23
Rostov,8683,9,4,7,9,11,18,-7,19
Amkar,8683,10,4,5,11,9,23,-14,17
Anzhi,8683,11,2,6,12,15,40,-25,12
Loko Moscow,8684,1,12,6,2,32,12,20,42
Spart Moscow,8684,2,11,5,4,43,28,15,38
CSKA Moscow,8684,3,11,3,6,28,18,10,36
Zenit,8684,4,8,9,3,23,14,9,33
Krasnodar,8684,5,8,5,7,27,26,1,29
Terek Grozny,8684,6,8,5,7,22,25,-3,29
FK Rubin,8684,7,6,6,8,24,18,6,24
Din Moscow,8684,8,5,6,9,19,28,-9,21
Amkar,8684,9,5,4,11,12,25,-13,19
Rostov,8684,10,4,6,10,11,20,-9,18
Anzhi,8684,11,2,5,13,15,42,-27,11
Loko Moscow,8685,1,12,6,2,33,13,20,42
Spart Moscow,8685,2,10,6,4,39,27,12,36
CSKA Moscow,8685,3,11,3,6,28,22,6,36
Zenit,8685,4,8,9,3,26,15,11,33
Krasnodar,8685,5,8,5,7,29,28,1,29
Terek Grozny,8685,6,7,6,7,20,24,-4,27
FK Rubin,8685,7,6,6,8,23,18,5,24
Din Moscow,8685,8,5,7,8,18,23,-5,22
Rostov,8685,9,4,6,10,11,19,-8,18
Amkar,8685,10,4,5,11,9,25,-16,17
Anzhi,8685,11,3,5,12,17,39,-22,14
Loko Moscow,8686,1,12,6,2,31,12,19,42
CSKA Moscow,8686,2,11,4,5,28,19,9,37
Spart Moscow,8686,3,10,5,5,37,27,10,35
Krasnodar,8686,4,9,5,6,30,25,5,32
Zenit,8686,5,7,9,4,22,15,7,30
Terek Grozny,8686,6,8,6,6,23,24,-1,30
Din Moscow,8686,7,6,6,8,19,23,-4,24
FK Rubin,8686,8,5,5,10,21,21,0,20
Amkar,8686,9,5,5,10,13,24,-11,20
Rostov,8686,10,4,6,10,10,19,-9,18
Anzhi,8686,11,2,5,13,15,40,-25,11
Loko Moscow,8687,1,13,5,2,33,13,20,44
CSKA Moscow,8687,2,11,4,5,28,18,10,37
Spart Moscow,8687,3,10,6,4,41,28,13,36
Zenit,8687,4,7,9,4,22,15,7,30
Krasnodar,8687,5,8,4,8,29,28,1,28
Terek Grozny,8687,6,7,7,6,20,22,-2,28
FK Rubin,8687,7,6,6,8,22,17,5,24
Din Moscow,8687,8,5,7,8,17,24,-7,22
Rostov,8687,9,4,7,9,12,19,-7,19
Amkar,8687,10,4,5,11,10,25,-15,17
Anzhi,8687,11,2,6,12,14,39,-25,12
Loko Moscow,8688,1,12,6,2,32,12,20,42
CSKA Moscow,8688,2,12,3,5,31,18,13,39
Spart Moscow,8688,3,10,6,4,40,27,13,36
Krasnodar,8688,4,9,5,6,31,26,5,32
Zenit,8688,5,7,8,5,21,17,4,29
Terek Grozny,8688,6,8,5,7,23,27,-4,29
FK Rubin,8688,7,6,5,9,24,21,3,23
Din Moscow,8688,8,5,6,9,18,25,-7,21
Amkar,8688,9,5,5,10,15,24,-9,20
Rostov,8688,10,4,6,10,11,21,-10,18
Anzhi,8688,11,2,5,13,15,43,-28,11
Loko Moscow,8689,1,12,6,2,31,11,20,42
CSKA Moscow,8689,2,11,3,6,29,21,8,36
Zenit,8689,3,8,9,3,24,15,9,33
Spart Moscow,8689,4,8,8,4,34,26,8,32
Terek Grozny,8689,5,8,5,7,23,27,-4,29
Krasnodar,8689,6,8,4,8,28,29,-1,28
FK Rubin,8689,7,7,5,8,28,21,7,26
Din Moscow,8689,8,5,7,8,21,26,-5,22
Amkar,8689,9,5,5,10,14,23,-9,20
Rostov,8689,10,4,7,9,10,17,-7,19
Anzhi,8689,11,2,5,13,15,41,-26,11
Loko Moscow,8690,1,12,5,3,32,14,18,41
CSKA Moscow,8690,2,10,5,5,27,19,8,35
Spart Moscow,8690,3,9,6,5,38,29,9,33
Zenit,8690,4,8,9,3,24,15,9,33
Krasnodar,8690,5,8,5,7,28,26,2,29
Terek Grozny,8690,6,7,6,7,21,24,-3,27
FK Rubin,8690,7,6,6,8,23,17,6,24
Amkar,8690,8,6,4,10,13,22,-9,22
Din Moscow,8690,9,5,6,9,17,27,-10,21
Rostov,8690,10,4,7,9,11,18,-7,19
Anzhi,8690,11,2,7,11,16,39,-23,13
Loko Moscow,8691,1,11,6,3,30,14,16,39
CSKA Moscow,8691,2,10,4,6,26,20,6,34
Zenit,8691,3,8,9,3,23,13,10,33
Spart Moscow,8691,4,9,5,6,39,32,7,32
Krasnodar,8691,5,9,5,6,30,25,5,32
Terek Grozny,8691,6,9,5,6,23,22,1,32
FK Rubin,8691,7,6,6,8,22,17,5,24
Din Moscow,8691,8,5,6,9,18,24,-6,21
Rostov,8691,9,5,6,9,13,19,-6,21
Amkar,8691,10,5,4,11,12,26,-14,19
Anzhi,8691,11,2,6,12,15,39,-24,12
Loko Moscow,8692,1,12,6,2,31,12,19,42
CSKA Moscow,8692,2,12,3,5,32,18,14,39
Spart Moscow,8692,3,9,6,5,38,29,9,33
Krasnodar,8692,4,8,6,6,30,27,3,30
Zenit,8692,5,7,8,5,22,17,5,29
Terek Grozny,8692,6,8,5,7,21,24,-3,29
Din Moscow,8692,7,6,6,8,20,25,-5,24
FK Rubin,8692,8,5,6,9,23,20,3,21
Rostov,8692,9,4,7,9,11,18,-7,19
Amkar,8692,10,5,4,11,10,23,-13,19
Anzhi,8692,11,3,5,12,16,41,-25,14
Loko Moscow,8693,1,12,5,3,32,14,18,41
CSKA Moscow,8693,2,12,3,5,29,17,12,39
Spart Moscow,8693,3,10,6,4,36,26,10,36
Zenit,8693,4,8,8,4,23,16,7,32
Terek Grozny,8693,5,8,6,6,24,24,0,30
Krasnodar,8693,6,8,5,7,30,28,2,29
FK Rubin,8693,7,5,7,8,23,19,4,22
Din Moscow,8693,8,5,7,8,17,22,-5,22
Rostov,8693,9,4,6,10,11,19,-8,18
Amkar,8693,10,4,5,11,9,24,-15,17
Anzhi,8693,11,2,6,12,16,41,-25,12
Loko Moscow,8694,1,11,5,4,30,14,16,38
Spart Moscow,8694,2,11,5,4,39,26,13,38
Zenit,8694,3,9,8,3,23,13,10,35
CSKA Moscow,8694,4,10,4,6,27,20,7,34
Krasnodar,8694,5,9,4,7,30,27,3,31
Terek Grozny,8694,6,8,5,7,23,26,-3,29
Din Moscow,8694,7,6,6,8,20,24,-4,24
FK Rubin,8694,8,6,5,9,24,21,3,23
Rostov,8694,9,4,6,10,11,20,-9,18
Amkar,8694,10,4,4,12,10,25,-15,16
Anzhi,8694,11,3,6,11,19,40,-21,15
Loko Moscow,8695,1,12,6,2,33,14,19,42
Spart Moscow,8695,2,10,5,5,37,29,8,35
CSKA Moscow,8695,3,10,4,6,26,19,7,34
Zenit,8695,4,8,9,3,23,14,9,33
Krasnodar,8695,5,9,4,7,31,28,3,31
Terek Grozny,8695,6,7,6,7,22,26,-4,27
Din Moscow,8695,7,6,7,7,20,22,-2,25
FK Rubin,8695,8,5,6,9,23,20,3,21
Rostov,8695,9,4,6,10,12,20,-8,18
Amkar,8695,10,4,5,11,11,25,-14,17
Anzhi,8695,11,3,6,11,17,38,-21,15
Loko Moscow,8696,1,13,5,2,34,13,21,44
Spart Moscow,8696,2,11,5,4,40,28,12,38
CSKA Moscow,8696,3,11,4,5,26,17,9,37
Zenit,8696,4,7,9,4,21,15,6,30
Krasnodar,8696,5,8,4,8,29,28,1,28
Terek Grozny,8696,6,7,7,6,22,24,-2,28
Din Moscow,8696,7,6,6,8,19,23,-4,24
FK Rubin,8696,8,6,5,9,22,18,4,23
Rostov,8696,9,4,6,10,11,19,-8,18
Amkar,8696,10,4,5,11,10,25,-15,17
Anzhi,8696,11,2,6,12,16,40,-24,12
Loko Moscow,8697,1,12,5,3,31,13,18,41
CSKA Moscow,8697,2,11,3,6,28,19,9,36
Krasnodar,8697,3,10,4,6,30,24,6,34
Zenit,8697,4,8,8,4,23,16,7,32
Spart Moscow,8697,5,8,6,6,36,31,5,30
Terek Grozny,8697,6,8,6,6,22,22,0,30
Din Moscow,8697,7,6,6,8,20,23,-3,24
FK Rubin,8697,8,6,5,9,22,18,4,23
Rostov,8697,9,5,6,9,12,18,-6,21
Amkar,8697,10,4,6,10,10,23,-13,18
Anzhi,8697,11,2,5,13,14,41,-27,11
Loko Moscow,8698,1,12,5,3,31,13,18,41
CSKA Moscow,8698,2,11,3,6,28,21,7,36
Krasnodar,8698,3,10,4,6,30,24,6,34
Spart Moscow,8698,4,9,6,5,38,30,8,33
Zenit,8698,5,8,8,4,24,16,8,32
Terek Grozny,8698,6,7,6,7,21,24,-3,27
Din Moscow,8698,7,6,6,8,19,22,-3,24
FK Rubin,8698,8,5,5,10,21,20,1,20
Amkar,8698,9,5,5,10,12,24,-12,20
Rostov,8698,10,4,7,9,12,19,-7,19
Anzhi,8698,11,3,5,12,17,40,-23,14
Loko Moscow,8699,1,11,6,3,29,14,15,39
Spart Moscow,8699,2,10,6,4,37,25,12,36
CSKA Moscow,8699,3,11,3,6,28,18,10,36
Krasnodar,8699,4,10,4,6,32,25,7,34
Zenit,8699,5,8,9,3,22,13,9,33
Terek Grozny,8699,6,7,5,8,22,27,-5,26
FK Rubin,8699,7,6,5,9,23,19,4,23
Din Moscow,8699,8,5,6,9,17,24,-7,21
Rostov,8699,9,4,7,9,10,17,-7,19
Amkar,8699,10,5,4,11,12,26,-14,19
Anzhi,8699,11,3,5,12,16,40,-24,14
Loko Moscow,8700,1,11,6,3,30,13,17,39
CSKA Moscow,8700,2,12,3,5,28,18,10,39
Spart Moscow,8700,3,10,5,5,35,26,9,35
Terek Grozny,8700,4,9,5,6,24,22,2,32
Krasnodar,8700,5,9,4,7,29,26,3,31
Zenit,8700,6,7,9,4,21,14,7,30
FK Rubin,8700,7,7,5,8,23,17,6,26
Din Moscow,8700,8,6,6,8,18,22,-4,24
Rostov,8700,9,4,6,10,10,18,-8,18
Amkar,8700,10,4,4,12,9,24,-15,16
Anzhi,8700,11,2,5,13,15,42,-27,11
Loko Moscow,8701,1,12,6,2,36,13,23,42
CSKA Moscow,8701,2,12,3,5,30,18,12,39
Spart Moscow,8701,3,10,5,5,38,28,10,35
Zenit,8701,4,7,9,4,23,16,7,30
Terek Grozny,8701,5,8,5,7,23,23,0,29
Krasnodar,8701,6,8,4,8,28,31,-3,28
FK Rubin,8701,7,7,5,8,24,18,6,26
Amkar,8701,8,6,4,10,12,23,-11,22
Din Moscow,8701,9,5,6,9,18,24,-6,21
Rostov,8701,10,4,6,10,10,19,-9,18
Anzhi,8701,11,2,5,13,15,44,-29,11
Loko Moscow,8702,1,12,6,2,32,12,20,42
CSKA Moscow,8702,2,12,3,5,31,18,13,39
Spart Moscow,8702,3,9,6,5,37,29,8,33
Krasnodar,8702,4,9,5,6,31,26,5,32
Terek Grozny,8702,5,8,6,6,23,24,-1,30
Zenit,8702,6,7,8,5,21,16,5,29
Din Moscow,8702,7,5,8,7,18,22,-4,23
FK Rubin,8702,8,5,6,9,22,20,2,21
Rostov,8702,9,5,6,9,12,18,-6,21
Amkar,8702,10,4,4,12,11,26,-15,16
Anzhi,8702,11,2,6,12,16,43,-27,12
Loko Moscow,8703,1,11,6,3,30,13,17,39
CSKA Moscow,8703,2,11,3,6,28,19,9,36
Zenit,8703,3,9,8,3,24,13,11,35
Spart Moscow,8703,4,10,5,5,38,28,10,35
Krasnodar,8703,5,8,6,6,30,27,3,30
Terek Grozny,8703,6,8,6,6,23,24,-1,30
Din Moscow,8703,7,6,6,8,19,24,-5,24
FK Rubin,8703,8,5,6,9,23,20,3,21
Amkar,8703,9,5,5,10,12,24,-12,20
Rostov,8703,10,4,6,10,10,18,-8,18
Anzhi,8703,11,2,5,13,15,42,-27,11
Loko Moscow,8704,1,11,7,2,31,13,18,40
CSKA Moscow,8704,2,10,4,6,28,21,7,34
Spart Moscow,8704,3,9,6,5,39,29,10,33
Zenit,8704,4,8,9,3,24,15,9,33
Krasnodar,8704,5,8,6,6,30,27,3,30
Terek Grozny,8704,6,7,6,7,22,25,-3,27
Din Moscow,8704,7,6,6,8,18,24,-6,24
FK Rubin,8704,8,5,6,9,23,20,3,21
Rostov,8704,9,5,6,9,12,18,-6,21
Amkar,8704,10,5,5,10,13,25,-12,20
Anzhi,8704,11,2,7,11,17,40,-23,13
Loko Moscow,8705,1,12,6,2,35,14,21,42
CSKA Moscow,8705,2,11,4,5,34,20,14,37
Spart Moscow,8705,3,9,7,4,35,25,10,34
Terek Grozny,8705,4,9,5,6,24,23,1,32
Zenit,8705,5,7,9,4,23,18,5,30
Krasnodar,8705,6,8,6,6,30,27,3,30
Din Moscow,8705,7,5,8,7,18,22,-4,23
FK Rubin,8705,8,5,7,8,23,19,4,22
Rostov,8705,9,4,6,10,10,19,-9,18
Amkar,8705,10,4,5,11,9,23,-14,17
Anzhi,8705,11,2,5,13,17,48,-31,11
Loko Moscow,8706,1,11,7,2,30,12,18,40
CSKA Moscow,8706,2,11,4,5,27,18,9,37
Spart Moscow,8706,3,9,6,5,37,29,8,33
Krasnodar,8706,4,9,5,6,30,25,5,32
Zenit,8706,5,7,10,3,22,14,8,31
Terek Grozny,8706,6,7,5,8,21,28,-7,26
Din Moscow,8706,7,6,6,8,20,25,-5,24
Amkar,8706,8,6,4,10,15,23,-8,22
FK Rubin,8706,9,5,5,10,22,21,1,20
Rostov,8706,10,4,7,9,10,17,-7,19
Anzhi,8706,11,3,5,12,17,39,-22,14
Loko Moscow,8707,1,12,6,2,30,11,19,42
CSKA Moscow,8707,2,12,3,5,31,17,14,39
Spart Moscow,8707,3,10,6,4,40,29,11,36
Krasnodar,8707,4,9,4,7,30,27,3,31
Zenit,8707,5,7,9,4,21,14,7,30
Terek Grozny,8707,6,7,5,8,22,26,-4,26
Din Moscow,8707,7,6,7,7,21,24,-3,25
FK Rubin,8707,8,5,5,10,24,22,2,20
Amkar,8707,9,5,4,11,13,27,-14,19
Rostov,8707,10,4,6,10,10,18,-8,18
Anzhi,8707,11,3,5,12,16,43,-27,14
Loko Moscow,8708,1,12,5,3,32,15,17,41
Spart Moscow,8708,2,9,6,5,36,28,8,33
CSKA Moscow,8708,3,10,3,7,25,21,4,33
Zenit,8708,4,8,8,4,24,14,10,32
Krasnodar,8708,5,9,5,6,32,27,5,32
Terek Grozny,8708,6,7,6,7,21,25,-4,27
Din Moscow,8708,7,6,6,8,20,24,-4,24
FK Rubin,8708,8,5,6,9,23,20,3,21
Rostov,8708,9,5,6,9,11,17,-6,21
Amkar,8708,10,5,5,10,12,23,-11,20
Anzhi,8708,11,3,6,11,16,38,-22,15
Loko Moscow,8709,1,12,6,2,31,11,20,42
Spart Moscow,8709,2,11,5,4,39,27,12,38
CSKA Moscow,8709,3,10,5,5,25,17,8,35
Zenit,8709,4,7,10,3,21,13,8,31
Krasnodar,8709,5,9,4,7,28,26,2,31
Terek Grozny,8709,6,7,5,8,23,27,-4,26
FK Rubin,8709,7,6,5,9,22,18,4,23
Din Moscow,8709,8,5,6,9,18,24,-6,21
Amkar,8709,9,5,4,11,11,25,-14,19
Rostov,8709,10,4,6,10,11,19,-8,18
Anzhi,8709,11,3,6,11,17,39,-22,15
Loko Moscow,8710,1,11,7,2,30,12,18,40
CSKA Moscow,8710,2,11,4,5,30,20,10,37
Spart Moscow,8710,3,9,6,5,40,30,10,33
Zenit,8710,4,7,9,4,23,17,6,30
Krasnodar,8710,5,8,6,6,27,24,3,30
Terek Grozny,8710,6,8,6,6,22,23,-1,30
Din Moscow,8710,7,6,6,8,20,24,-4,24
FK Rubin,8710,8,5,6,9,21,20,1,21
Rostov,8710,9,5,6,9,11,17,-6,21
Amkar,8710,10,4,6,10,13,26,-13,18
Anzhi,8710,11,2,6,12,17,41,-24,12
Loko Moscow,8711,1,11,6,3,30,13,17,39
CSKA Moscow,8711,2,11,3,6,27,19,8,36
Zenit,8711,3,9,8,3,23,13,10,35
Spart Moscow,8711,4,10,5,5,38,31,7,35
Krasnodar,8711,5,9,5,6,31,27,4,32
Terek Grozny,8711,6,8,5,7,22,25,-3,29
Din Moscow,8711,7,6,6,8,21,23,-2,24
FK Rubin,8711,8,6,5,9,24,20,4,23
Rostov,8711,9,4,6,10,11,19,-8,18
Amkar,8711,10,4,4,12,10,25,-15,16
Anzhi,8711,11,3,5,12,18,40,-22,14
Loko Moscow,8712,1,11,5,4,33,17,16,38
CSKA Moscow,8712,2,11,4,5,31,20,11,37
Spart Moscow,8712,3,10,5,5,40,27,13,35
Krasnodar,8712,4,10,4,6,33,28,5,34
Zenit,8712,5,8,9,3,25,16,9,33
Terek Grozny,8712,6,9,5,6,23,23,0,32
FK Rubin,8712,7,6,5,9,24,19,5,23
Rostov,8712,8,5,6,9,11,17,-6,21
Din Moscow,8712,9,5,6,9,18,27,-9,21
Amkar,8712,10,4,4,12,9,26,-17,16
Anzhi,8712,11,2,5,13,16,43,-27,11
Loko Moscow,8713,1,12,6,2,35,12,23,42
Spart Moscow,8713,2,10,6,4,40,27,13,36
CSKA Moscow,8713,3,10,5,5,29,21,8,35
Krasnodar,8713,4,9,5,6,30,25,5,32
Zenit,8713,5,7,9,4,24,21,3,30
Terek Grozny,8713,6,8,6,6,24,25,-1,30
Din Moscow,8713,7,5,7,8,21,29,-8,22
FK Rubin,8713,8,5,6,9,25,23,2,21
Rostov,8713,9,4,7,9,11,18,-7,19
Amkar,8713,10,4,4,12,10,25,-15,16
Anzhi,8713,11,2,7,11,18,41,-23,13
Loko Moscow,8714,1,12,6,2,31,12,19,42
Spart Moscow,8714,2,10,5,5,39,30,9,35
CSKA Moscow,8714,3,10,4,6,27,20,7,34
Zenit,8714,4,8,8,4,22,14,8,32
Krasnodar,8714,5,9,5,6,30,25,5,32
Terek Grozny,8714,6,8,5,7,23,24,-1,29
FK Rubin,8714,7,6,5,9,24,20,4,23
Din Moscow,8714,8,5,6,9,21,28,-7,21
Amkar,8714,9,5,4,11,10,25,-15,19
Rostov,8714,10,4,6,10,11,19,-8,18
Anzhi,8714,11,3,6,11,18,39,-21,15
Loko Moscow,8715,1,12,6,2,30,11,19,42
CSKA Moscow,8715,2,11,4,5,27,17,10,37
Spart Moscow,8715,3,10,5,5,38,28,10,35
Krasnodar,8715,4,9,4,7,31,27,4,31
Zenit,8715,5,7,9,4,21,15,6,30
Terek Grozny,8715,6,8,5,7,23,24,-1,29
FK Rubin,8715,7,6,5,9,24,21,3,23
Amkar,8715,8,6,4,10,12,23,-11,22
Din Moscow,8715,9,5,6,9,18,25,-7,21
Rostov,8715,10,4,6,10,10,18,-8,18
Anzhi,8715,11,2,6,12,15,40,-25,12
Loko Moscow,8716,1,11,5,4,31,16,15,38
CSKA Moscow,8716,2,11,4,5,27,18,9,37
Krasnodar,8716,3,10,4,6,31,26,5,34
Zenit,8716,4,8,9,3,23,13,10,33
Spart Moscow,8716,5,9,5,6,36,30,6,32
Terek Grozny,8716,6,8,5,7,22,23,-1,29
Din Moscow,8716,7,6,7,7,18,21,-3,25
FK Rubin,8716,8,5,6,9,21,18,3,21
Amkar,8716,9,5,4,11,12,25,-13,19
Rostov,8716,10,4,6,10,11,19,-8,18
Anzhi,8716,11,3,5,12,16,39,-23,14
Loko Moscow,8717,1,11,6,3,30,13,17,39
Spart Moscow,8717,2,10,6,4,38,27,11,36
CSKA Moscow,8717,3,11,3,6,29,21,8,36
Zenit,8717,4,9,8,3,25,14,11,35
Krasnodar,8717,5,9,5,6,32,26,6,32
Terek Grozny,8717,6,8,5,7,22,24,-2,29
FK Rubin,8717,7,6,5,9,25,22,3,23
Din Moscow,8717,8,5,7,8,19,25,-6,22
Amkar,8717,9,5,4,11,11,25,-14,19
Rostov,8717,10,4,6,10,10,18,-8,18
Anzhi,8717,11,2,5,13,16,42,-26,11
Loko Moscow,8718,1,12,5,3,33,14,19,41
CSKA Moscow,8718,2,11,3,6,31,19,12,36
Krasnodar,8718,3,10,4,6,33,27,6,34
Zenit,8718,4,8,8,4,24,18,6,32
Spart Moscow,8718,5,8,7,5,34,27,7,31
Terek Grozny,8718,6,8,6,6,21,22,-1,30
Din Moscow,8718,7,7,6,7,19,21,-2,27
FK Rubin,8718,8,5,5,10,24,22,2,20
Rostov,8718,9,4,7,9,10,17,-7,19
Amkar,8718,10,4,6,10,10,23,-13,18
Anzhi,8718,11,2,5,13,14,43,-29,11
Loko Moscow,8719,1,11,5,4,31,15,16,38
Spart Moscow,8719,2,10,5,5,40,28,12,35
CSKA Moscow,8719,3,10,5,5,26,18,8,35
Krasnodar,8719,4,10,4,6,30,25,5,34
Zenit,8719,5,8,9,3,23,14,9,33
Terek Grozny,8719,6,9,5,6,23,22,1,32
Din Moscow,8719,7,5,7,8,18,24,-6,22
FK Rubin,8719,8,5,6,9,21,18,3,21
Amkar,8719,9,5,4,11,11,24,-13,19
Rostov,8719,10,4,6,10,10,20,-10,18
Anzhi,8719,11,2,6,12,15,40,-25,12
Loko Moscow,8720,1,11,5,4,29,15,14,38
Zenit,8720,2,9,8,3,26,14,12,35
Spart Moscow,8720,3,9,6,5,38,29,9,33
CSKA Moscow,8720,4,10,3,7,26,20,6,33
Krasnodar,8720,5,9,4,7,28,26,2,31
Terek Grozny,8720,6,8,6,6,26,25,1,30
Din Moscow,8720,7,6,6,8,18,23,-5,24
FK Rubin,8720,8,6,5,9,23,18,5,23
Rostov,8720,9,5,6,9,13,19,-6,21
Amkar,8720,10,4,5,11,10,26,-16,17
Anzhi,8720,11,3,6,11,18,40,-22,15
Loko Moscow,8721,1,11,5,4,30,14,16,38
CSKA Moscow,8721,2,11,4,5,28,18,10,37
Spart Moscow,8721,3,9,7,4,38,28,10,34
Krasnodar,8721,4,10,4,6,31,25,6,34
Zenit,8721,5,8,9,3,23,14,9,33
Terek Grozny,8721,6,8,6,6,24,23,1,30
Din Moscow,8721,7,5,7,8,18,24,-6,22
FK Rubin,8721,8,5,6,9,22,20,2,21
Rostov,8721,9,4,7,9,11,18,-7,19
Amkar,8721,10,4,6,10,12,25,-13,18
Anzhi,8721,11,2,5,13,14,42,-28,11
Loko Moscow,8722,1,12,5,3,30,12,18,41
CSKA Moscow,8722,2,11,3,6,26,21,5,36
Zenit,8722,3,9,8,3,26,13,13,35
Spart Moscow,8722,4,10,5,5,36,28,8,35
Krasnodar,8722,5,9,4,7,29,26,3,31
Terek Grozny,8722,6,7,6,7,20,25,-5,27
FK Rubin,8722,7,6,5,9,25,19,6,23
Amkar,8722,8,6,4,10,15,23,-8,22
Din Moscow,8722,9,5,6,9,17,25,-8,21
Rostov,8722,10,4,6,10,10,18,-8,18
Anzhi,8722,11,2,6,12,14,38,-24,12
Loko Moscow,8723,1,12,6,2,32,13,19,42
Spart Moscow,8723,2,11,5,4,42,27,15,38
CSKA Moscow,8723,3,11,3,6,28,20,8,36
Zenit,8723,4,8,8,4,24,15,9,32
Krasnodar,8723,5,9,5,6,29,25,4,32
Terek Grozny,8723,6,8,5,7,24,24,0,29
Din Moscow,8723,7,6,6,8,20,23,-3,24
FK Rubin,8723,8,5,5,10,22,21,1,20
Amkar,8723,9,5,4,11,11,25,-14,19
Rostov,8723,10,4,6,10,11,22,-11,18
Anzhi,8723,11,2,5,13,16,44,-28,11
Loko Moscow,8724,1,13,5,2,33,12,21,44
CSKA Moscow,8724,2,10,4,6,28,21,7,34
Zenit,8724,3,8,8,4,24,17,7,32
Spart Moscow,8724,4,8,7,5,33,26,7,31
Krasnodar,8724,5,8,5,7,28,26,2,29
Terek Grozny,8724,6,7,6,7,22,25,-3,27
FK Rubin,8724,7,6,6,8,25,20,5,24
Din Moscow,8724,8,5,7,8,19,24,-5,22
Amkar,8724,9,6,4,10,11,22,-11,22
Rostov,8724,10,4,7,9,10,17,-7,19
Anzhi,8724,11,2,7,11,18,41,-23,13
Loko Moscow,8725,1,12,5,3,32,13,19,41
Zenit,8725,2,9,8,3,24,13,11,35
Spart Moscow,8725,3,9,6,5,35,28,7,33
CSKA Moscow,8725,4,10,3,7,27,23,4,33
Krasnodar,8725,5,9,4,7,29,27,2,31
Terek Grozny,8725,6,8,5,7,24,27,-3,29
Din Moscow,8725,7,6,6,8,20,24,-4,24
FK Rubin,8725,8,5,5,10,22,20,2,20
Rostov,8725,9,4,7,9,10,17,-7,19
Amkar,8725,10,5,4,11,12,24,-12,19
Anzhi,8725,11,4,5,11,22,41,-19,17
Loko Moscow,8726,1,12,5,3,32,14,18,41
CSKA Moscow,8726,2,12,3,5,31,20,11,39
Spart Moscow,8726,3,10,6,4,41,30,11,36
Krasnodar,8726,4,9,4,7,30,28,2,31
Zenit,8726,5,7,8,5,22,18,4,29
Terek Grozny,8726,6,8,5,7,23,26,-3,29
Din Moscow,8726,7,6,7,7,22,25,-3,25
FK Rubin,8726,8,6,5,9,25,19,6,23
Rostov,8726,9,4,6,10,10,18,-8,18
Amkar,8726,10,4,4,12,12,29,-17,16
Anzhi,8726,11,3,5,12,19,40,-21,14
Loko Moscow,8727,1,11,6,3,30,13,17,39
Spart Moscow,8727,2,10,6,4,42,27,15,36
CSKA Moscow,8727,3,10,4,6,25,20,5,34
Zenit,8727,4,8,9,3,24,13,11,33
Krasnodar,8727,5,9,4,7,29,26,3,31
FK Rubin,8727,6,7,5,8,24,17,7,26
Terek Grozny,8727,7,7,5,8,21,26,-5,26
Din Moscow,8727,8,5,6,9,18,30,-12,21
Rostov,8727,9,4,7,9,10,17,-7,19
Amkar,8727,10,5,4,11,13,25,-12,19
Anzhi,8727,11,3,6,11,15,37,-22,15
Loko Moscow,8728,1,11,6,3,32,15,17,39
Zenit,8728,2,8,9,3,26,15,11,33
CSKA Moscow,8728,3,10,3,7,25,22,3,33
Terek Grozny,8728,4,9,5,6,23,23,0,32
Spart Moscow,8728,5,8,7,5,36,29,7,31
Krasnodar,8728,6,9,4,7,30,27,3,31
FK Rubin,8728,7,6,6,8,24,19,5,24
Din Moscow,8728,8,5,8,7,19,23,-4,23
Rostov,8728,9,4,7,9,11,18,-7,19
Amkar,8728,10,5,4,11,12,25,-13,19
Anzhi,8728,11,3,5,12,16,38,-22,14
Loko Moscow,8729,1,13,5,2,33,12,21,44
Spart Moscow,8729,2,10,6,4,41,27,14,36
CSKA Moscow,8729,3,11,3,6,28,20,8,36
Zenit,8729,4,8,8,4,24,15,9,32
Krasnodar,8729,5,8,4,8,29,30,-1,28
Terek Grozny,8729,6,7,5,8,22,26,-4,26
Din Moscow,8729,7,6,6,8,20,28,-8,24
FK Rubin,8729,8,6,5,9,27,22,5,23
Amkar,8729,9,5,5,10,13,25,-12,20
Rostov,8729,10,4,6,10,10,18,-8,18
Anzhi,8729,11,3,5,12,17,41,-24,14
Loko Moscow,8730,1,11,7,2,32,14,18,40
CSKA Moscow,8730,2,11,3,6,27,19,8,36
Zenit,8730,3,8,9,3,24,15,9,33
Spart Moscow,8730,4,9,6,5,36,28,8,33
Krasnodar,8730,5,9,5,6,32,26,6,32
Terek Grozny,8730,6,8,6,6,23,23,0,30
Din Moscow,8730,7,5,7,8,18,23,-5,22
FK Rubin,8730,8,5,6,9,22,21,1,21
Rostov,8730,9,4,7,9,11,18,-7,19
Amkar,8730,10,5,4,11,10,24,-14,19
Anzhi,8730,11,2,6,12,16,40,-24,12
Loko Moscow,8731,1,12,5,3,31,13,18,41
CSKA Moscow,8731,2,12,3,5,31,17,14,39
Spart Moscow,8731,3,10,5,5,42,31,11,35
Krasnodar,8731,4,10,4,6,32,26,6,34
Zenit,8731,5,7,8,5,22,16,6,29
Terek Grozny,8731,6,7,6,7,20,25,-5,27
FK Rubin,8731,7,6,5,9,26,21,5,23
Din Moscow,8731,8,5,6,9,19,28,-9,21
Amkar,8731,9,5,5,10,12,23,-11,20
Rostov,8731,10,4,6,10,11,21,-10,18
Anzhi,8731,11,3,5,12,17,42,-25,14
Loko Moscow,8732,1,13,5,2,34,13,21,44
CSKA Moscow,8732,2,11,3,6,30,20,10,36
Spart Moscow,8732,3,9,7,4,36,27,9,34
Zenit,8732,4,8,8,4,25,16,9,32
Terek Grozny,8732,5,8,6,6,21,22,-1,30
Krasnodar,8732,6,8,5,7,29,28,1,29
FK Rubin,8732,7,6,6,8,24,19,5,24
Din Moscow,8732,8,5,6,9,19,25,-6,21
Rostov,8732,9,4,7,9,10,17,-7,19
Amkar,8732,10,4,5,11,10,24,-14,17
Anzhi,8732,11,2,6,12,14,41,-27,12
Loko Moscow,8733,1,12,6,2,32,13,19,42
CSKA Moscow,8733,2,12,3,5,27,17,10,39
Spart Moscow,8733,3,9,6,5,39,31,8,33
Zenit,8733,4,7,9,4,22,15,7,30
Krasnodar,8733,5,8,4,8,28,27,1,28
Terek Grozny,8733,6,7,5,8,21,27,-6,26
Din Moscow,8733,7,6,7,7,20,23,-3,25
FK Rubin,8733,8,6,6,8,23,18,5,24
Rostov,8733,9,4,7,9,10,17,-7,19
Amkar,8733,10,5,4,11,15,27,-12,19
Anzhi,8733,11,3,5,12,17,39,-22,14
Loko Moscow,8734,1,12,5,3,32,14,18,41
CSKA Moscow,8734,2,11,3,6,29,20,9,36
Spart Moscow,8734,3,10,5,5,39,28,11,35
Zenit,8734,4,9,8,3,26,15,11,35
Krasnodar,8734,5,9,4,7,29,26,3,31
Terek Grozny,8734,6,8,5,7,21,23,-2,29
FK Rubin,8734,7,6,5,9,23,19,4,23
Din Moscow,8734,8,5,6,9,17,24,-7,21
Amkar,8734,9,5,4,11,10,23,-13,19
Rostov,8734,10,4,6,10,12,21,-9,18
Anzhi,8734,11,3,5,12,16,41,-25,14
Loko Moscow,8735,1,12,6,2,33,14,19,42
CSKA Moscow,8735,2,11,4,5,30,18,12,37
Spart Moscow,8735,3,9,6,5,38,28,10,33
Zenit,8735,4,7,9,4,24,17,7,30
Terek Grozny,8735,5,8,6,6,23,23,0,30
Krasnodar,8735,6,8,5,7,30,29,1,29
FK Rubin,8735,7,6,6,8,25,19,6,24
Din Moscow,8735,8,5,7,8,17,24,-7,22
Amkar,8735,9,5,5,10,12,24,-12,20
Rostov,8735,10,4,7,9,11,18,-7,19
Anzhi,8735,11,2,5,13,14,43,-29,11
Loko Moscow,8736,1,11,6,3,30,14,16,39
CSKA Moscow,8736,2,11,3,6,26,20,6,36
Zenit,8736,3,9,8,3,26,13,13,35
Spart Moscow,8736,4,9,6,5,37,27,10,33
Krasnodar,8736,5,9,5,6,32,26,6,32
Terek Grozny,8736,6,7,5,8,20,27,-7,26
Din Moscow,8736,7,6,6,8,20,24,-4,24
Amkar,8736,8,6,4,10,12,22,-10,22
FK Rubin,8736,9,5,5,10,22,24,-2,20
Rostov,8736,10,4,7,9,11,18,-7,19
Anzhi,8736,11,3,5,12,17,38,-21,14
Loko Moscow,8737,1,12,5,3,32,14,18,41
CSKA Moscow,8737,2,11,3,6,28,20,8,36
Zenit,8737,3,8,8,4,23,15,8,32
Spart Moscow,8737,4,9,5,6,37,31,6,32
Krasnodar,8737,5,9,4,7,32,28,4,31
Terek Grozny,8737,6,7,6,7,22,26,-4,27
Din Moscow,8737,7,6,7,7,21,24,-3,25
FK Rubin,8737,8,5,6,9,24,22,2,21
Amkar,8737,9,5,5,10,12,23,-11,20
Rostov,8737,10,4,6,10,11,19,-8,18
Anzhi,8737,11,4,5,11,20,40,-20,17
Loko Moscow,8738,1,12,6,2,33,13,20,42
CSKA Moscow,8738,2,12,3,5,34,20,14,39
Spart Moscow,8738,3,11,5,4,42,27,15,38
Zenit,8738,4,7,9,4,24,18,6,30
Krasnodar,8738,5,8,5,7,28,27,1,29
Terek Grozny,8738,6,7,5,8,21,26,-5,26
FK Rubin,8738,7,5,7,8,21,17,4,22
Din Moscow,8738,8,5,7,8,18,25,-7,22
Amkar,8738,9,5,4,11,10,25,-15,19
Rostov,8738,10,4,6,10,11,19,-8,18
Anzhi,8738,11,3,5,12,18,43,-25,14
Loko Moscow,8739,1,11,7,2,31,13,18,40
CSKA Moscow,8739,2,12,3,5,29,18,11,39
Spart Moscow,8739,3,9,7,4,35,25,10,34
Krasnodar,8739,4,9,5,6,31,26,5,32
Zenit,8739,5,7,9,4,22,16,6,30
Terek Grozny,8739,6,8,5,7,22,23,-1,29
FK Rubin,8739,7,6,5,9,24,21,3,23
Din Moscow,8739,8,5,7,8,18,23,-5,22
Rostov,8739,9,4,7,9,10,17,-7,19
Amkar,8739,10,4,4,12,9,26,-17,16
Anzhi,8739,11,3,5,12,16,39,-23,14
Loko Moscow,8740,1,12,5,3,34,15,19,41
CSKA Moscow,8740,2,11,4,5,33,18,15,37
Spart Moscow,8740,3,10,5,5,36,26,10,35
Zenit,8740,4,8,9,3,24,15,9,33
Krasnodar,8740,5,9,4,7,33,30,3,31
Terek Grozny,8740,6,8,5,7,23,24,-1,29
Din Moscow,8740,7,5,7,8,19,25,-6,22
FK Rubin,8740,8,5,6,9,25,23,2,21
Amkar,8740,9,5,4,11,11,25,-14,19
Rostov,8740,10,4,6,10,10,18,-8,18
Anzhi,8740,11,3,5,12,15,44,-29,14
Loko Moscow,8741,1,13,5,2,34,13,21,44
CSKA Moscow,8741,2,12,3,5,29,17,12,39
Spart Moscow,8741,3,10,5,5,39,31,8,35
Terek Grozny,8741,4,8,6,6,22,23,-1,30
Zenit,8741,5,7,8,5,22,17,5,29
Krasnodar,8741,6,8,4,8,30,30,0,28
FK Rubin,8741,7,7,5,8,25,19,6,26
Din Moscow,8741,8,5,6,9,19,25,-6,21
Amkar,8741,9,5,4,11,13,25,-12,19
Rostov,8741,10,4,6,10,10,18,-8,18
Anzhi,8741,11,2,6,12,15,40,-25,12
Loko Moscow,8742,1,11,5,4,31,19,12,38
CSKA Moscow,8742,2,11,4,5,28,17,11,37
Spart Moscow,8742,3,10,5,5,41,30,11,35
Zenit,8742,4,8,9,3,22,13,9,33
Krasnodar,8742,5,9,5,6,35,27,8,32
Terek Grozny,8742,6,7,6,7,23,26,-3,27
Din Moscow,8742,7,6,6,8,20,26,-6,24
FK Rubin,8742,8,5,6,9,22,19,3,21
Rostov,8742,9,5,6,9,11,17,-6,21
Amkar,8742,10,4,5,11,13,27,-14,17
Anzhi,8742,11,3,5,12,16,41,-25,14
Loko Moscow,8743,1,12,6,2,32,12,20,42
CSKA Moscow,8743,2,11,4,5,27,17,10,37
Spart Moscow,8743,3,9,6,5,39,29,10,33
Zenit,8743,4,7,10,3,22,14,8,31
Krasnodar,8743,5,9,4,7,28,26,2,31
Terek Grozny,8743,6,8,5,7,24,26,-2,29
Din Moscow,8743,7,5,7,8,18,25,-7,22
FK Rubin,8743,8,5,6,9,21,18,3,21
Rostov,8743,9,5,6,9,12,18,-6,21
Amkar,8743,10,4,5,11,11,26,-15,17
Anzhi,8743,11,3,5,12,17,40,-23,14
Loko Moscow,8744,1,11,7,2,32,14,18,40
Spart Moscow,8744,2,11,5,4,41,26,15,38
CSKA Moscow,8744,3,11,3,6,27,19,8,36
Zenit,8744,4,8,9,3,24,14,10,33
Krasnodar,8744,5,8,6,6,31,28,3,30
Terek Grozny,8744,6,7,6,7,20,23,-3,27
FK Rubin,8744,7,6,6,8,25,19,6,24
Din Moscow,8744,8,5,6,9,17,26,-9,21
Rostov,8744,9,4,6,10,10,20,-10,18
Amkar,8744,10,4,5,11,10,24,-14,17
Anzhi,8744,11,3,5,12,15,39,-24,14
Loko Moscow,8745,1,13,5,2,35,14,21,44
CSKA Moscow,8745,2,11,3,6,27,19,8,36
Spart Moscow,8745,3,9,6,5,36,30,6,33
Zenit,8745,4,8,8,4,23,15,8,32
Terek Grozny,8745,5,8,5,7,22,23,-1,29
Krasnodar,8745,6,8,4,8,29,31,-2,28
FK Rubin,8745,7,6,6,8,26,19,7,24
Din Moscow,8745,8,5,7,8,19,24,-5,22
Rostov,8745,9,5,6,9,13,17,-4,21
Amkar,8745,10,4,5,11,11,26,-15,17
Anzhi,8745,11,3,5,12,16,39,-23,14
Loko Moscow,8746,1,13,5,2,34,12,22,44
CSKA Moscow,8746,2,11,3,6,30,19,11,36
Spart Moscow,8746,3,10,6,4,38,28,10,36
Zenit,8746,4,8,8,4,24,16,8,32
Terek Grozny,8746,5,9,5,6,26,26,0,32
Krasnodar,8746,6,8,5,7,28,28,0,29
Din Moscow,8746,7,6,6,8,19,23,-4,24
FK Rubin,8746,8,5,6,9,22,19,3,21
Rostov,8746,9,4,6,10,11,19,-8,18
Amkar,8746,10,4,5,11,12,26,-14,17
Anzhi,8746,11,2,5,13,16,44,-28,11
Loko Moscow,8747,1,12,5,3,32,15,17,41
CSKA Moscow,8747,2,11,3,6,30,19,11,36
Zenit,8747,3,8,8,4,25,17,8,32
Krasnodar,8747,4,9,5,6,31,26,5,32
Spart Moscow,8747,5,8,6,6,35,29,6,30
Terek Grozny,8747,6,8,6,6,25,26,-1,30
Din Moscow,8747,7,7,6,7,21,22,-1,27
FK Rubin,8747,8,5,6,9,23,21,2,21
Rostov,8747,9,4,7,9,10,17,-7,19
Amkar,8747,10,5,4,11,13,26,-13,19
Anzhi,8747,11,2,6,12,16,43,-27,12
Loko Moscow,8748,1,12,5,3,31,13,18,41
Spart Moscow,8748,2,9,7,4,38,27,11,34
CSKA Moscow,8748,3,10,4,6,25,18,7,34
Krasnodar,8748,4,9,4,7,29,26,3,31
Zenit,8748,5,7,9,4,21,14,7,30
Terek Grozny,8748,6,8,6,6,22,23,-1,30
Din Moscow,8748,7,6,7,7,22,24,-2,25
FK Rubin,8748,8,6,5,9,24,21,3,23
Rostov,8748,9,4,6,10,10,20,-10,18
Amkar,8748,10,4,5,11,10,24,-14,17
Anzhi,8748,11,3,6,11,16,38,-22,15
Loko Moscow,8749,1,12,6,2,30,11,19,42
CSKA Moscow,8749,2,12,3,5,30,18,12,39
Spart Moscow,8749,3,11,5,4,40,27,13,38
Zenit,8749,4,7,9,4,22,15,7,30
Krasnodar,8749,5,8,4,8,27,28,-1,28
FK Rubin,8749,6,7,5,8,25,17,8,26
Terek Grozny,8749,7,7,5,8,20,26,-6,26
Din Moscow,8749,8,5,6,9,18,25,-7,21
Amkar,8749,9,5,4,11,11,25,-14,19
Rostov,8749,10,4,6,10,10,18,-8,18
Anzhi,8749,11,3,5,12,17,40,-23,14
Loko Moscow,8750,1,11,7,2,31,13,18,40
Spart Moscow,8750,2,11,5,4,39,25,14,38
CSKA Moscow,8750,3,11,3,6,27,19,8,36
Zenit,8750,4,8,9,3,24,14,10,33
Krasnodar,8750,5,8,5,7,28,26,2,29
Terek Grozny,8750,6,8,5,7,25,25,0,29
Din Moscow,8750,7,6,6,8,22,24,-2,24
FK Rubin,8750,8,6,5,9,23,22,1,23
Amkar,8750,9,5,4,11,12,26,-14,19
Rostov,8750,10,4,6,10,10,19,-9,18
Anzhi,8750,11,2,5,13,14,42,-28,11
Loko Moscow,8751,1,13,5,2,33,13,20,44
CSKA Moscow,8751,2,12,3,5,29,18,11,39
Spart Moscow,8751,3,9,7,4,38,29,9,34
Zenit,8751,4,7,8,5,22,16,6,29
Krasnodar,8751,5,8,4,8,29,31,-2,28
Terek Grozny,8751,6,7,7,6,23,25,-2,28
FK Rubin,8751,7,6,6,8,27,19,8,24
Din Moscow,8751,8,5,7,8,21,26,-5,22
Rostov,8751,9,4,7,9,10,17,-7,19
Amkar,8751,10,4,6,10,13,26,-13,18
Anzhi,8751,11,2,6,12,15,40,-25,12
Loko Moscow,8752,1,13,5,2,32,12,20,44
CSKA Moscow,8752,2,11,4,5,29,19,10,37
Spart Moscow,8752,3,10,6,4,38,27,11,36
Krasnodar,8752,4,9,4,7,28,25,3,31
Zenit,8752,5,7,9,4,23,16,7,30
Terek Grozny,8752,6,8,6,6,26,24,2,30
Din Moscow,8752,7,6,7,7,20,23,-3,25
FK Rubin,8752,8,5,5,10,22,20,2,20
Rostov,8752,9,4,6,10,11,20,-9,18
Amkar,8752,10,4,5,11,11,25,-14,17
Anzhi,8752,11,2,5,13,15,44,-29,11
Loko Moscow,8753,1,13,5,2,34,13,21,44
CSKA Moscow,8753,2,10,4,6,27,20,7,34
Krasnodar,8753,3,9,4,7,30,26,4,31
Zenit,8753,4,7,9,4,24,18,6,30
Spart Moscow,8753,5,8,6,6,36,31,5,30
Terek Grozny,8753,6,8,5,7,25,24,1,29
Din Moscow,8753,7,7,6,7,22,24,-2,27
Rostov,8753,8,5,6,9,12,17,-5,21
FK Rubin,8753,9,5,5,10,22,21,1,20
Amkar,8753,10,5,5,10,12,24,-12,20
Anzhi,8753,11,3,5,12,15,41,-26,14
Loko Moscow,8754,1,11,6,3,32,15,17,39
CSKA Moscow,8754,2,12,3,5,29,17,12,39
Spart Moscow,8754,3,9,6,5,38,29,9,33
Krasnodar,8754,4,9,5,6,30,26,4,32
Zenit,8754,5,7,9,4,23,16,7,30
Terek Grozny,8754,6,7,5,8,20,25,-5,26
FK Rubin,8754,7,6,6,8,24,18,6,24
Din Moscow,8754,8,5,7,8,18,24,-6,22
Amkar,8754,9,6,4,10,13,23,-10,22
Rostov,8754,10,4,6,10,11,20,-9,18
Anzhi,8754,11,3,5,12,15,40,-25,14
Loko Moscow,8755,1,11,6,3,30,13,17,39
Spart Moscow,8755,2,11,5,4,40,26,14,38
Krasnodar,8755,3,10,4,6,31,25,6,34
CSKA Moscow,8755,4,10,4,6,26,20,6,34
Zenit,8755,5,8,9,3,23,13,10,33
Terek Grozny,8755,6,9,5,6,28,24,4,32
FK Rubin,8755,7,6,5,9,23,19,4,23
Din Moscow,8755,8,5,6,9,17,27,-10,21
Rostov,8755,9,4,6,10,10,18,-8,18
Amkar,8755,10,4,4,12,10,28,-18,16
Anzhi,8755,11,2,6,12,17,42,-25,12
Loko Moscow,8756,1,11,6,3,30,14,16,39
CSKA Moscow,8756,2,11,4,5,26,17,9,37
Spart Moscow,8756,3,9,7,4,36,26,10,34
Krasnodar,8756,4,9,5,6,31,26,5,32
Zenit,8756,5,7,9,4,21,14,7,30
Terek Grozny,8756,6,7,6,7,21,25,-4,27
Din Moscow,8756,7,5,8,7,19,23,-4,23
FK Rubin,8756,8,5,7,8,23,19,4,22
Rostov,8756,9,4,7,9,10,17,-7,19
Amkar,8756,10,5,4,11,12,25,-13,19
Anzhi,8756,11,2,7,11,14,37,-23,13
Loko Moscow,8757,1,11,7,2,31,13,18,40
Spart Moscow,8757,2,11,5,4,43,26,17,38
CSKA Moscow,8757,3,11,4,5,28,17,11,37
Krasnodar,8757,4,9,5,6,32,26,6,32
Zenit,8757,5,7,10,3,22,14,8,31
Terek Grozny,8757,6,8,6,6,21,22,-1,30
Din Moscow,8757,7,5,7,8,18,26,-8,22
FK Rubin,8757,8,5,6,9,23,22,1,21
Rostov,8757,9,4,6,10,10,19,-9,18
Amkar,8757,10,4,4,12,10,27,-17,16
Anzhi,8757,11,2,6,12,14,40,-26,12
Loko Moscow,8758,1,12,5,3,33,15,18,41
CSKA Moscow,8758,2,11,4,5,29,19,10,37
Spart Moscow,8758,3,9,6,5,36,28,8,33
Zenit,8758,4,8,8,4,24,16,8,32
Terek Grozny,8758,5,9,5,6,26,23,3,32
Krasnodar,8758,6,8,5,7,29,28,1,29
Din Moscow,8758,7,6,7,7,20,23,-3,25
FK Rubin,8758,8,5,7,8,24,20,4,22
Rostov,8758,9,4,6,10,10,18,-8,18
Amkar,8758,10,4,5,11,12,26,-14,17
Anzhi,8758,11,2,6,12,16,43,-27,12
Loko Moscow,8759,1,12,5,3,31,13,18,41
CSKA Moscow,8759,2,12,3,5,28,17,11,39
Spart Moscow,8759,3,10,5,5,40,29,11,35
Krasnodar,8759,4,10,4,6,31,25,6,34
Zenit,8759,5,7,8,5,22,17,5,29
Terek Grozny,8759,6,8,5,7,22,24,-2,29
Din Moscow,8759,7,6,6,8,18,25,-7,24
FK Rubin,8759,8,5,5,10,22,21,1,20
Amkar,8759,9,5,4,11,13,24,-11,19
Rostov,8759,10,4,6,10,10,19,-9,18
Anzhi,8759,11,3,5,12,16,39,-23,14
Loko Moscow,8760,1,13,5,2,32,11,21,44
CSKA Moscow,8760,2,11,3,6,27,19,8,36
Spart Moscow,8760,3,10,5,5,37,27,10,35
Zenit,8760,4,8,8,4,22,15,7,32
Krasnodar,8760,5,9,4,7,29,26,3,31
Terek Grozny,8760,6,8,6,6,24,24,0,30
FK Rubin,8760,7,6,5,9,25,19,6,23
Din Moscow,8760,8,5,6,9,17,25,-8,21
Amkar,8760,9,5,5,10,12,23,-11,20
Rostov,8760,10,4,6,10,10,20,-10,18
Anzhi,8760,11,2,5,13,16,42,-26,11
Loko Moscow,8761,1,12,6,2,32,12,20,42
Spart Moscow,8761,2,11,5,4,41,28,13,38
CSKA Moscow,8761,3,10,4,6,25,20,5,34
Zenit,8761,4,8,8,4,24,15,9,32
Krasnodar,8761,5,9,5,6,32,25,7,32
Terek Grozny,8761,6,8,5,7,22,25,-3,29
Din Moscow,8761,7,5,7,8,17,24,-7,22
FK Rubin,8761,8,5,6,9,21,21,0,21
Amkar,8761,9,5,4,11,13,25,-12,19
Rostov,8761,10,4,6,10,11,19,-8,18
Anzhi,8761,11,2,6,12,15,39,-24,12
Loko Moscow,8762,1,13,5,2,31,11,20,44
CSKA Moscow,8762,2,11,4,5,29,20,9,37
Spart Moscow,8762,3,10,6,4,38,28,10,36
Zenit,8762,4,7,8,5,23,17,6,29
Krasnodar,8762,5,8,4,8,27,26,1,28
Terek Grozny,8762,6,7,6,7,21,24,-3,27
Din Moscow,8762,7,6,6,8,19,23,-4,24
FK Rubin,8762,8,6,5,9,22,18,4,23
Rostov,8762,9,4,6,10,11,19,-8,18
Amkar,8762,10,4,6,10,11,24,-13,18
Anzhi,8762,11,3,6,11,16,38,-22,15
Loko Moscow,8763,1,11,6,3,29,13,16,39
CSKA Moscow,8763,2,11,4,5,29,19,10,37
Spart Moscow,8763,3,9,7,4,39,28,11,34
Zenit,8763,4,7,10,3,22,14,8,31
Krasnodar,8763,5,9,4,7,29,25,4,31
FK Rubin,8763,6,7,5,8,23,17,6,26
Terek Grozny,8763,7,7,5,8,21,26,-5,26
Din Moscow,8763,8,5,7,8,18,23,-5,22
Rostov,8763,9,4,7,9,11,18,-7,19
Amkar,8763,10,5,4,11,12,27,-15,19
Anzhi,8763,11,3,5,12,17,40,-23,14
Loko Moscow,8764,1,11,7,2,32,14,18,40
CSKA Moscow,8764,2,12,3,5,28,17,11,39
Spart Moscow,8764,3,9,6,5,37,28,9,33
Krasnodar,8764,4,9,5,6,29,25,4,32
Zenit,8764,5,7,9,4,23,16,7,30
Din Moscow,8764,6,7,6,7,23,23,0,27
Terek Grozny,8764,7,7,5,8,20,26,-6,26
FK Rubin,8764,8,5,5,10,21,21,0,20
Rostov,8764,9,4,7,9,10,17,-7,19
Amkar,8764,10,5,4,11,11,24,-13,19
Anzhi,8764,11,3,5,12,16,39,-23,14
Loko Moscow,8765,1,11,7,2,31,13,18,40
Spart Moscow,8765,2,10,6,4,42,30,12,36
CSKA Moscow,8765,3,11,3,6,29,21,8,36
Zenit,8765,4,7,9,4,24,17,7,30
Krasnodar,8765,5,8,5,7,27,28,-1,29
Terek Grozny,8765,6,7,5,8,20,25,-5,26
FK Rubin,8765,7,6,6,8,25,17,8,24
Din Moscow,8765,8,5,7,8,20,25,-5,22
Rostov,8765,9,4,7,9,12,19,-7,19
Amkar,8765,10,5,4,11,10,25,-15,19
Anzhi,8765,11,4,5,11,19,39,-20,17
Loko Moscow,8766,1,11,7,2,32,14,18,40
CSKA Moscow,8766,2,11,3,6,27,20,7,36
Spart Moscow,8766,3,10,5,5,39,27,12,35
Zenit,8766,4,8,9,3,25,15,10,33
Terek Grozny,8766,5,8,6,6,24,23,1,30
Krasnodar,8766,6,8,5,7,28,26,2,29
Din Moscow,8766,7,6,6,8,21,28,-7,24
FK Rubin,8766,8,6,5,9,25,21,4,23
Amkar,8766,9,5,5,10,12,23,-11,20
Rostov,8766,10,4,6,10,10,19,-9,18
Anzhi,8766,11,2,5,13,15,42,-27,11
Loko Moscow,8767,1,12,5,3,31,13,18,41
Spart Moscow,8767,2,10,6,4,36,25,11,36
Krasnodar,8767,3,10,4,6,30,25,5,34
CSKA Moscow,8767,4,10,3,7,27,23,4,33
Zenit,8767,5,8,8,4,24,15,9,32
Terek Grozny,8767,6,7,7,6,21,23,-2,28
FK Rubin,8767,7,6,5,9,23,19,4,23
Din Moscow,8767,8,5,6,9,18,25,-7,21
Rostov,8767,9,4,6,10,10,18,-8,18
Amkar,8767,10,4,6,10,9,22,-13,18
Anzhi,8767,11,3,6,11,18,39,-21,15
Loko Moscow,8768,1,12,6,2,31,12,19,42
Spart Moscow,8768,2,11,5,4,40,26,14,38
CSKA Moscow,8768,3,11,3,6,27,20,7,36
Zenit,8768,4,8,9,3,25,15,10,33
Krasnodar,8768,5,9,4,7,29,26,3,31
Terek Grozny,8768,6,8,5,7,22,27,-5,29
FK Rubin,8768,7,6,5,9,24,20,4,23
Din Moscow,8768,8,5,6,9,18,25,-7,21
Amkar,8768,9,5,4,11,14,24,-10,19
Rostov,8768,10,4,6,10,10,20,-10,18
Anzhi,8768,11,2,5,13,15,40,-25,11
Loko Moscow,8769,1,11,5,4,30,14,16,38
CSKA Moscow,8769,2,11,4,5,27,18,9,37
Spart Moscow,8769,3,9,7,4,39,26,13,34
Zenit,8769,4,8,8,4,22,14,8,32
Krasnodar,8769,5,9,4,7,29,27,2,31
Terek Grozny,8769,6,8,5,7,22,23,-1,29
FK Rubin,8769,7,6,6,8,23,17,6,24
Din Moscow,8769,8,5,7,8,17,26,-9,22
Rostov,8769,9,4,7,9,10,17,-7,19
Amkar,8769,10,4,5,11,10,25,-15,17
Anzhi,8769,11,3,6,11,16,38,-22,15
Loko Moscow,8770,1,12,5,3,31,16,15,41
Spart Moscow,8770,2,10,5,5,38,26,12,35
CSKA Moscow,8770,3,10,5,5,27,19,8,35
Krasnodar,8770,4,10,4,6,34,25,9,34
Zenit,8770,5,7,9,4,21,14,7,30
Terek Grozny,8770,6,7,5,8,20,25,-5,26
Din Moscow,8770,7,5,7,8,19,27,-8,22
FK Rubin,8770,8,5,6,9,23,21,2,21
Rostov,8770,9,5,6,9,11,17,-6,21
Amkar,8770,10,5,4,11,10,23,-13,19
Anzhi,8770,11,3,6,11,18,39,-21,15
Loko Moscow,8771,1,12,5,3,31,14,17,41
Zenit,8771,2,9,8,3,24,13,11,35
Spart Moscow,8771,3,9,7,4,38,27,11,34
CSKA Moscow,8771,4,10,3,7,27,21,6,33
Krasnodar,8771,5,8,5,7,28,26,2,29
Terek Grozny,8771,6,8,5,7,21,24,-3,29
FK Rubin,8771,7,5,7,8,21,17,4,22
Din Moscow,8771,8,5,7,8,17,24,-7,22
Rostov,8771,9,4,7,9,11,18,-7,19
Amkar,8771,10,4,5,11,10,24,-14,17
Anzhi,8771,11,4,5,11,19,39,-20,17
Loko Moscow,8772,1,12,6,2,32,12,20,42
Spart Moscow,8772,2,10,6,4,37,27,10,36
CSKA Moscow,8772,3,10,4,6,28,21,7,34
Zenit,8772,4,7,9,4,22,16,6,30
Terek Grozny,8772,5,8,6,6,22,23,-1,30
Krasnodar,8772,6,8,5,7,28,26,2,29
FK Rubin,8772,7,7,5,8,24,17,7,26
Din Moscow,8772,8,5,7,8,18,24,-6,22
Rostov,8772,9,4,6,10,11,19,-8,18
Amkar,8772,10,4,4,12,9,24,-15,16
Anzhi,8772,11,3,6,11,18,40,-22,15
Loko Moscow,8773,1,13,5,2,35,11,24,44
CSKA Moscow,8773,2,11,3,6,30,20,10,36
Spart Moscow,8773,3,10,5,5,39,30,9,35
Zenit,8773,4,8,8,4,23,17,6,32
Terek Grozny,8773,5,8,6,6,21,22,-1,30
Krasnodar,8773,6,8,4,8,27,30,-3,28
FK Rubin,8773,7,6,6,8,27,19,8,24
Din Moscow,8773,8,5,7,8,19,24,-5,22
Amkar,8773,9,5,5,10,12,24,-12,20
Rostov,8773,10,4,6,10,12,20,-8,18
Anzhi,8773,11,2,5,13,15,43,-28,11
Loko Moscow,8774,1,13,5,2,32,11,21,44
CSKA Moscow,8774,2,12,3,5,27,17,10,39
Spart Moscow,8774,3,10,5,5,37,28,9,35
Terek Grozny,8774,4,8,6,6,23,23,0,30
Zenit,8774,5,7,8,5,21,15,6,29
Krasnodar,8774,6,8,4,8,28,30,-2,28
Din Moscow,8774,7,6,6,8,20,23,-3,24
FK Rubin,8774,8,6,5,9,25,20,5,23
Rostov,8774,9,5,6,9,12,18,-6,21
Amkar,8774,10,4,5,11,10,24,-14,17
Anzhi,8774,11,2,5,13,14,40,-26,11
Loko Moscow,8775,1,11,6,3,30,16,14,39
CSKA Moscow,8775,2,11,4,5,28,19,9,37
Krasnodar,8775,3,10,4,6,33,24,9,34
Zenit,8775,4,7,10,3,23,15,8,31
Spart Moscow,8775,5,8,6,6,33,28,5,30
Terek Grozny,8775,6,7,5,8,22,27,-5,26
Din Moscow,8775,7,6,6,8,18,23,-5,24
FK Rubin,8775,8,6,5,9,23,19,4,23
Amkar,8775,9,6,4,10,14,23,-9,22
Rostov,8775,10,4,7,9,10,17,-7,19
Anzhi,8775,11,3,5,12,17,40,-23,14
Loko Moscow,8776,1,11,7,2,32,14,18,40
Spart Moscow,8776,2,11,5,4,41,30,11,38
CSKA Moscow,8776,3,11,4,5,29,18,11,37
Zenit,8776,4,7,10,3,22,14,8,31
Krasnodar,8776,5,8,5,7,30,28,2,29
Terek Grozny,8776,6,8,5,7,22,24,-2,29
FK Rubin,8776,7,6,6,8,25,20,5,24
Din Moscow,8776,8,5,7,8,23,28,-5,22
Amkar,8776,9,5,4,11,12,24,-12,19
Rostov,8776,10,4,6,10,11,19,-8,18
Anzhi,8776,11,2,5,13,14,42,-28,11
Loko Moscow,8777,1,12,5,3,30,14,16,41
CSKA Moscow,8777,2,11,3,6,26,19,7,36
Zenit,8777,3,9,8,3,26,13,13,35
Spart Moscow,8777,4,10,5,5,39,29,10,35
Krasnodar,8777,5,9,4,7,30,27,3,31
Terek Grozny,8777,6,8,6,6,23,24,-1,30
Din Moscow,8777,7,6,6,8,20,24,-4,24
FK Rubin,8777,8,5,5,10,23,22,1,20
Amkar,8777,9,5,4,11,13,26,-13,19
Rostov,8777,10,4,6,10,10,18,-8,18
Anzhi,8777,11,2,6,12,15,39,-24,12
Loko Moscow,8778,1,12,5,3,30,12,18,41
CSKA Moscow,8778,2,12,3,5,29,17,12,39
Spart Moscow,8778,3,10,6,4,39,26,13,36
Krasnodar,8778,4,9,4,7,30,29,1,31
Zenit,8778,5,7,8,5,21,15,6,29
Terek Grozny,8778,6,8,5,7,23,24,-1,29
FK Rubin,8778,7,6,6,8,27,20,7,24
Din Moscow,8778,8,5,7,8,18,24,-6,22
Amkar,8778,9,5,5,10,12,24,-12,20
Rostov,8778,10,4,6,10,10,20,-10,18
Anzhi,8778,11,2,5,13,14,42,-28,11
Loko Moscow,8779,1,11,7,2,31,13,18,40
Spart Moscow,8779,2,10,6,4,37,26,11,36
CSKA Moscow,8779,3,10,4,6,25,18,7,34
Zenit,8779,4,8,9,3,23,14,9,33
Krasnodar,8779,5,8,5,7,29,27,2,29
Terek Grozny,8779,6,7,6,7,23,26,-3,27
Din Moscow,8779,7,6,6,8,20,23,-3,24
FK Rubin,8779,8,6,5,9,23,21,2,23
Rostov,8779,9,4,7,9,10,17,-7,19
Amkar,8779,10,4,5,11,12,26,-14,17
Anzhi,8779,11,3,6,11,16,38,-22,15
CSKA Moscow,8780,1,12,3,5,29,18,11,39
Loko Moscow,8780,2,11,5,4,30,19,11,38
Spart Moscow,8780,3,10,6,4,40,28,12,36
Zenit,8780,4,8,8,4,24,17,7,32
Krasnodar,8780,5,9,4,7,33,26,7,31
Terek Grozny,8780,6,7,6,7,23,26,-3,27
Din Moscow,8780,7,6,7,7,21,23,-2,25
FK Rubin,8780,8,6,5,9,23,19,4,23
Rostov,8780,9,4,6,10,10,18,-8,18
Amkar,8780,10,4,5,11,11,27,-16,17
Anzhi,8780,11,3,5,12,17,40,-23,14
Loko Moscow,8781,1,12,6,2,30,11,19,42
CSKA Moscow,8781,2,12,3,5,29,19,10,39
Spart Moscow,8781,3,9,7,4,37,28,9,34
Krasnodar,8781,4,9,4,7,30,27,3,31
Zenit,8781,5,7,9,4,21,14,7,30
Terek Grozny,8781,6,7,5,8,21,25,-4,26
FK Rubin,8781,7,6,5,9,25,20,5,23
Din Moscow,8781,8,5,7,8,18,24,-6,22
Amkar,8781,9,5,5,10,11,23,-12,20
Rostov,8781,10,4,6,10,11,19,-8,18
Anzhi,8781,11,3,5,12,18,41,-23,14
Loko Moscow,8782,1,12,5,3,32,15,17,41
Spart Moscow,8782,2,10,6,4,40,30,10,36
CSKA Moscow,8782,3,11,3,6,26,18,8,36
Krasnodar,8782,4,10,4,6,34,28,6,34
Zenit,8782,5,8,8,4,22,14,8,32
Terek Grozny,8782,6,9,5,6,23,23,0,32
Din Moscow,8782,7,5,7,8,18,23,-5,22
FK Rubin,8782,8,5,6,9,23,20,3,21
Rostov,8782,9,4,6,10,11,19,-8,18
Amkar,8782,10,4,5,11,13,27,-14,17
Anzhi,8782,11,2,5,13,14,39,-25,11
Loko Moscow,8783,1,11,6,3,29,13,16,39
Spart Moscow,8783,2,11,5,4,39,28,11,38
Krasnodar,8783,3,10,4,6,31,25,6,34
Zenit,8783,4,8,9,3,22,13,9,33
CSKA Moscow,8783,5,10,3,7,25,19,6,33
Terek Grozny,8783,6,7,7,6,22,24,-2,28
Din Moscow,8783,7,5,7,8,19,24,-5,22
FK Rubin,8783,8,5,6,9,23,20,3,21
Rostov,8783,9,4,6,10,10,18,-8,18
Amkar,8783,10,4,5,11,12,26,-14,17
Anzhi,8783,11,3,6,11,16,38,-22,15
Loko Moscow,8784,1,12,6,2,33,14,19,42
CSKA Moscow,8784,2,11,4,5,28,17,11,37
Spart Moscow,8784,3,10,5,5,39,27,12,35
Zenit,8784,4,7,9,4,22,17,5,30
Terek Grozny,8784,5,8,6,6,21,22,-1,30
Krasnodar,8784,6,8,5,7,31,29,2,29
FK Rubin,8784,7,5,7,8,23,19,4,22
Din Moscow,8784,8,5,7,8,17,23,-6,22
Amkar,8784,9,5,4,11,11,23,-12,19
Rostov,8784,10,4,6,10,10,21,-11,18
Anzhi,8784,11,2,7,11,14,37,-23,13
CSKA Moscow,8785,1,12,3,5,30,19,11,39
Loko Moscow,8785,2,11,5,4,30,14,16,38
Krasnodar,8785,3,10,4,6,31,25,6,34
Zenit,8785,4,8,8,4,22,15,7,32
Spart Moscow,8785,5,8,6,6,34,28,6,30
Terek Grozny,8785,6,7,7,6,22,24,-2,28
Din Moscow,8785,7,7,6,7,19,21,-2,27
FK Rubin,8785,8,5,5,10,21,20,1,20
Amkar,8785,9,5,5,10,11,23,-12,20
Rostov,8785,10,4,7,9,11,18,-7,19
Anzhi,8785,11,2,6,12,17,41,-24,12
Loko Moscow,8786,1,12,5,3,34,14,20,41
Spart Moscow,8786,2,10,6,4,40,27,13,36
CSKA Moscow,8786,3,11,3,6,26,18,8,36
Krasnodar,8786,4,10,4,6,32,26,6,34
Zenit,8786,5,8,8,4,23,18,5,32
Terek Grozny,8786,6,8,5,7,24,26,-2,29
Din Moscow,8786,7,5,8,7,19,23,-4,23
FK Rubin,8786,8,5,6,9,24,21,3,21
Rostov,8786,9,4,6,10,10,19,-9,18
Amkar,8786,10,4,4,12,10,28,-18,16
Anzhi,8786,11,3,5,12,18,40,-22,14
Loko Moscow,8787,1,12,5,3,31,15,16,41
CSKA Moscow,8787,2,11,3,6,26,18,8,36
Spart Moscow,8787,3,10,5,5,37,28,9,35
Zenit,8787,4,8,8,4,23,15,8,32
Krasnodar,8787,5,9,5,6,31,25,6,32
Terek Grozny,8787,6,8,6,6,21,22,-1,30
FK Rubin,8787,7,6,6,8,25,18,7,24
Din Moscow,8787,8,5,6,9,18,26,-8,21
Amkar,8787,9,5,5,10,11,23,-12,20
Rostov,8787,10,4,6,10,10,18,-8,18
Anzhi,8787,11,2,5,13,14,39,-25,11
Loko Moscow,8788,1,11,5,4,29,14,15,38
Spart Moscow,8788,2,10,6,4,37,25,12,36
CSKA Moscow,8788,3,11,3,6,28,20,8,36
Zenit,8788,4,9,8,3,25,14,11,35
Krasnodar,8788,5,10,4,6,32,26,6,34
Terek Grozny,8788,6,7,6,7,22,25,-3,27
FK Rubin,8788,7,6,5,9,24,20,4,23
Din Moscow,8788,8,5,6,9,17,24,-7,21
Rostov,8788,9,4,6,10,10,19,-9,18
Amkar,8788,10,4,6,10,11,24,-13,18
Anzhi,8788,11,3,5,12,15,39,-24,14
Loko Moscow,8789,1,12,5,3,31,13,18,41
Spart Moscow,8789,2,10,5,5,39,29,10,35
Zenit,8789,3,9,8,3,23,13,10,35
CSKA Moscow,8789,4,10,3,7,25,20,5,33
Krasnodar,8789,5,8,5,7,28,26,2,29
Terek Grozny,8789,6,8,5,7,21,23,-2,29
Din Moscow,8789,7,6,6,8,20,25,-5,24
FK Rubin,8789,8,5,6,9,22,20,2,21
Amkar,8789,9,5,4,11,13,25,-12,19
Rostov,8789,10,4,6,10,10,18,-8,18
Anzhi,8789,11,4,5,11,17,37,-20,17
Loko Moscow,8790,1,12,6,2,32,13,19,42
Spart Moscow,8790,2,10,6,4,38,27,11,36
CSKA Moscow,8790,3,10,4,6,27,21,6,34
Zenit,8790,4,8,9,3,25,15,10,33
Krasnodar,8790,5,8,4,8,29,29,0,28
Terek Grozny,8790,6,7,5,8,20,24,-4,26
FK Rubin,8790,7,6,6,8,24,18,6,24
Din Moscow,8790,8,5,7,8,19,24,-5,22
Rostov,8790,9,4,7,9,10,17,-7,19
Amkar,8790,10,5,4,11,10,24,-14,19
Anzhi,8790,11,3,6,11,16,38,-22,15
Loko Moscow,8791,1,11,7,2,31,13,18,40
CSKA Moscow,8791,2,11,4,5,29,18,11,37
Spart Moscow,8791,3,9,6,5,40,30,10,33
Zenit,8791,4,7,10,3,23,15,8,31
Terek Grozny,8791,5,8,6,6,21,22,-1,30
Krasnodar,8791,6,8,5,7,29,27,2,29
FK Rubin,8791,7,7,5,8,24,18,6,26
Rostov,8791,8,5,6,9,14,19,-5,21
Din Moscow,8791,9,5,6,9,18,27,-9,21
Amkar,8791,10,4,6,10,9,22,-13,18
Anzhi,8791,11,2,5,13,14,41,-27,11
Loko Moscow,8792,1,11,6,3,31,15,16,39
CSKA Moscow,8792,2,12,3,5,28,18,10,39
Spart Moscow,8792,3,11,5,4,38,26,12,38
Zenit,8792,4,8,8,4,24,15,9,32
Krasnodar,8792,5,9,5,6,30,26,4,32
Terek Grozny,8792,6,7,6,7,20,25,-5,27
FK Rubin,8792,7,6,5,9,26,22,4,23
Din Moscow,8792,8,5,6,9,20,26,-6,21
Rostov,8792,9,4,6,10,10,19,-9,18
Amkar,8792,10,4,5,11,10,24,-14,17
Anzhi,8792,11,3,5,12,18,39,-21,14
Loko Moscow,8793,1,13,5,2,36,12,24,44
CSKA Moscow,8793,2,11,3,6,29,21,8,36
Spart Moscow,8793,3,9,6,5,36,26,10,33
Zenit,8793,4,8,8,4,24,18,6,32
Terek Grozny,8793,5,8,6,6,22,23,-1,30
Krasnodar,8793,6,8,4,8,28,28,0,28
Din Moscow,8793,7,7,6,7,19,21,-2,27
FK Rubin,8793,8,6,5,9,22,18,4,23
Rostov,8793,9,4,6,10,10,20,-10,18
Amkar,8793,10,4,5,11,9,23,-14,17
Anzhi,8793,11,2,6,12,16,41,-25,12
Loko Moscow,8794,1,11,7,2,29,11,18,40
Spart Moscow,8794,2,9,7,4,37,28,9,34
CSKA Moscow,8794,3,10,4,6,26,19,7,34
Zenit,8794,4,7,10,3,22,14,8,31
Krasnodar,8794,5,8,5,7,27,26,1,29
Terek Grozny,8794,6,7,7,6,23,25,-2,28
FK Rubin,8794,7,7,5,8,25,18,7,26
Din Moscow,8794,8,5,6,9,19,25,-6,21
Rostov,8794,9,4,7,9,10,17,-7,19
Amkar,8794,10,4,6,10,12,25,-13,18
Anzhi,8794,11,3,6,11,17,39,-22,15
Loko Moscow,8795,1,12,5,3,32,15,17,41
Krasnodar,8795,2,10,4,6,30,24,6,34
Spart Moscow,8795,3,9,6,5,37,29,8,33
CSKA Moscow,8795,4,10,3,7,28,23,5,33
Zenit,8795,5,8,8,4,25,17,8,32
Terek Grozny,8795,6,7,7,6,23,25,-2,28
Din Moscow,8795,7,5,7,8,19,25,-6,22
FK Rubin,8795,8,5,6,9,23,20,3,21
Rostov,8795,9,5,6,9,13,18,-5,21
Amkar,8795,10,4,6,10,12,25,-13,18
Anzhi,8795,11,3,6,11,19,40,-21,15
Loko Moscow,8796,1,13,5,2,35,15,20,44
Spart Moscow,8796,2,10,6,4,40,26,14,36
CSKA Moscow,8796,3,11,3,6,27,19,8,36
Zenit,8796,4,8,8,4,25,16,9,32
Krasnodar,8796,5,8,4,8,30,29,1,28
Terek Grozny,8796,6,7,7,6,20,22,-2,28
FK Rubin,8796,7,7,5,8,25,18,7,26
Din Moscow,8796,8,5,6,9,17,25,-8,21
Rostov,8796,9,4,6,10,10,21,-11,18
Amkar,8796,10,4,6,10,10,23,-13,18
Anzhi,8796,11,2,6,12,14,39,-25,12
Loko Moscow,8797,1,12,5,3,33,14,19,41
CSKA Moscow,8797,2,11,3,6,29,21,8,36
Spart Moscow,8797,3,9,5,6,37,29,8,32
Zenit,8797,4,8,8,4,24,18,6,32
Krasnodar,8797,5,9,4,7,29,26,3,31
Terek Grozny,8797,6,8,5,7,24,25,-1,29
Din Moscow,8797,7,6,7,7,19,22,-3,25
FK Rubin,8797,8,6,6,8,23,17,6,24
Amkar,8797,9,6,4,10,14,23,-9,22
Rostov,8797,10,4,6,10,10,19,-9,18
Anzhi,8797,11,2,5,13,16,44,-28,11
Loko Moscow,8798,1,13,5,2,35,13,22,44
CSKA Moscow,8798,2,11,4,5,32,23,9,37
Spart Moscow,8798,3,9,6,5,39,30,9,33
Terek Grozny,8798,4,9,5,6,24,23,1,32
Zenit,8798,5,7,9,4,24,19,5,30
Krasnodar,8798,6,8,4,8,28,28,0,28
Din Moscow,8798,7,6,6,8,18,23,-5,24
FK Rubin,8798,8,6,5,9,23,18,5,23
Rostov,8798,9,4,7,9,12,19,-7,19
Amkar,8798,10,5,4,11,12,25,-13,19
Anzhi,8798,11,2,5,13,19,45,-26,11
Loko Moscow,8799,1,12,6,2,31,12,19,42
Spart Moscow,8799,2,11,5,4,40,28,12,38
CSKA Moscow,8799,3,11,3,6,29,24,5,36
Zenit,8799,4,8,9,3,27,15,12,33
Terek Grozny,8799,5,9,5,6,24,22,2,32
Krasnodar,8799,6,8,5,7,28,26,2,29
Din Moscow,8799,7,6,6,8,20,25,-5,24
FK Rubin,8799,8,5,6,9,23,20,3,21
Rostov,8799,9,4,6,10,12,20,-8,18
Amkar,8799,10,4,4,12,9,26,-17,16
Anzhi,8799,11,2,5,13,16,41,-25,11
Loko Moscow,8800,1,12,6,2,30,11,19,42
CSKA Moscow,8800,2,12,3,5,29,18,11,39
Spart Moscow,8800,3,9,5,6,34,30,4,32
Zenit,8800,4,7,9,4,22,15,7,30
Terek Grozny,8800,5,8,6,6,22,23,-1,30
Krasnodar,8800,6,8,5,7,28,26,2,29
Din Moscow,8800,7,7,6,7,21,22,-1,27
FK Rubin,8800,8,5,6,9,23,20,3,21
Amkar,8800,9,5,4,11,12,23,-11,19
Rostov,8800,10,4,6,10,10,18,-8,18
Anzhi,8800,11,2,6,12,15,40,-25,12
Loko Moscow,8801,1,12,6,2,33,14,19,42
CSKA Moscow,8801,2,11,4,5,30,19,11,37
Spart Moscow,8801,3,10,6,4,37,27,10,36
Zenit,8801,4,7,10,3,24,16,8,31
Krasnodar,8801,5,9,4,7,29,26,3,31
Terek Grozny,8801,6,7,5,8,21,25,-4,26
FK Rubin,8801,7,6,5,9,23,19,4,23
Din Moscow,8801,8,5,6,9,18,24,-6,21
Rostov,8801,9,4,7,9,11,18,-7,19
Amkar,8801,10,5,4,11,12,25,-13,19
Anzhi,8801,11,3,5,12,16,41,-25,14
Loko Moscow,8802,1,12,6,2,32,13,19,42
CSKA Moscow,8802,2,11,3,6,28,21,7,36
Zenit,8802,3,8,9,3,25,14,11,33
Spart Moscow,8802,4,9,5,6,37,30,7,32
Krasnodar,8802,5,9,4,7,34,30,4,31
Terek Grozny,8802,6,7,5,8,20,24,-4,26
Din Moscow,8802,7,5,7,8,20,26,-6,22
Amkar,8802,8,6,4,10,12,22,-10,22
FK Rubin,8802,9,5,6,9,26,24,2,21
Rostov,8802,10,5,6,9,11,17,-6,21
Anzhi,8802,11,3,5,12,16,40,-24,14
CSKA Moscow,8803,1,12,3,5,31,19,12,39
Loko Moscow,8803,2,11,5,4,31,16,15,38
Spart Moscow,8803,3,10,6,4,37,25,12,36
Krasnodar,8803,4,10,4,6,31,26,5,34
Zenit,8803,5,8,8,4,24,16,8,32
Terek Grozny,8803,6,7,5,8,20,24,-4,26
FK Rubin,8803,7,6,5,9,22,18,4,23
Din Moscow,8803,8,5,7,8,17,22,-5,22
Amkar,8803,9,5,4,11,10,24,-14,19
Rostov,8803,10,4,6,10,10,19,-9,18
Anzhi,8803,11,3,5,12,16,40,-24,14
Loko Moscow,8804,1,11,6,3,30,13,17,39
Spart Moscow,8804,2,10,6,4,37,25,12,36
Zenit,8804,3,9,8,3,23,13,10,35
CSKA Moscow,8804,4,10,3,7,25,19,6,33
Krasnodar,8804,5,8,6,6,29,26,3,30
Terek Grozny,8804,6,7,5,8,20,25,-5,26
FK Rubin,8804,7,6,6,8,24,19,5,24
Din Moscow,8804,8,5,6,9,18,25,-7,21
Amkar,8804,9,5,5,10,11,22,-11,20
Rostov,8804,10,4,6,10,10,19,-9,18
Anzhi,8804,11,4,5,11,16,37,-21,17
Loko Moscow,8805,1,13,5,2,33,11,22,44
CSKA Moscow,8805,2,10,5,5,25,17,8,35
Spart Moscow,8805,3,9,6,5,37,29,8,33
Krasnodar,8805,4,9,4,7,28,26,2,31
Zenit,8805,5,7,9,4,21,15,6,30
Terek Grozny,8805,6,8,6,6,23,23,0,30
Din Moscow,8805,7,7,6,7,23,24,-1,27
FK Rubin,8805,8,5,5,10,23,21,2,20
Rostov,8805,9,4,7,9,10,17,-7,19
Amkar,8805,10,4,5,11,11,26,-15,17
Anzhi,8805,11,2,6,12,14,39,-25,12
Loko Moscow,8806,1,12,5,3,32,15,17,41
Krasnodar,8806,2,10,4,6,34,25,9,34
CSKA Moscow,8806,3,10,3,7,27,22,5,33
Zenit,8806,4,8,8,4,24,16,8,32
Spart Moscow,8806,5,9,5,6,36,29,7,32
Terek Grozny,8806,6,8,5,7,22,25,-3,29
Din Moscow,8806,7,7,6,7,19,21,-2,27
Rostov,8806,8,5,6,9,12,18,-6,21
FK Rubin,8806,9,5,5,10,21,21,0,20
Anzhi,8806,10,4,5,11,19,38,-19,17
Amkar,8806,11,4,4,12,10,26,-16,16
Loko Moscow,8807,1,11,6,3,29,12,17,39
Spart Moscow,8807,2,10,6,4,40,27,13,36
Zenit,8807,3,9,8,3,23,13,10,35
CSKA Moscow,8807,4,10,4,6,27,20,7,34
Krasnodar,8807,5,9,5,6,30,25,5,32
Terek Grozny,8807,6,8,6,6,23,23,0,30
Din Moscow,8807,7,6,6,8,20,25,-5,24
FK Rubin,8807,8,5,5,10,22,22,0,20
Rostov,8807,9,4,6,10,10,19,-9,18
Amkar,8807,10,4,6,10,11,24,-13,18
Anzhi,8807,11,2,6,12,16,41,-25,12
Loko Moscow,8808,1,12,6,2,32,12,20,42
CSKA Moscow,8808,2,12,3,5,32,19,13,39
Spart Moscow,8808,3,10,5,5,37,28,9,35
Krasnodar,8808,4,9,5,6,29,25,4,32
Zenit,8808,5,7,8,5,23,18,5,29
Din Moscow,8808,6,7,6,7,21,22,-1,27
Terek Grozny,8808,7,7,6,7,20,23,-3,27
FK Rubin,8808,8,5,5,10,21,20,1,20
Amkar,8808,9,5,4,11,11,24,-13,19
Rostov,8808,10,4,6,10,10,18,-8,18
Anzhi,8808,11,2,6,12,14,41,-27,12
Loko Moscow,8809,1,12,5,3,33,15,18,41
CSKA Moscow,8809,2,11,4,5,29,18,11,37
Spart Moscow,8809,3,10,6,4,38,27,11,36
Krasnodar,8809,4,10,4,6,31,26,5,34
Zenit,8809,5,7,9,4,23,16,7,30
Terek Grozny,8809,6,7,6,7,21,24,-3,27
Din Moscow,8809,7,5,7,8,19,24,-5,22
FK Rubin,8809,8,5,6,9,23,20,3,21
Rostov,8809,9,4,7,9,12,19,-7,19
Amkar,8809,10,4,5,11,10,25,-15,17
Anzhi,8809,11,3,5,12,15,40,-25,14
Loko Moscow,8810,1,12,6,2,33,14,19,42
Spart Moscow,8810,2,10,6,4,38,26,12,36
CSKA Moscow,8810,3,10,3,7,29,23,6,33
Zenit,8810,4,8,8,4,25,17,8,32
Krasnodar,8810,5,9,5,6,30,26,4,32
Terek Grozny,8810,6,9,5,6,24,24,0,32
Din Moscow,8810,7,5,7,8,18,25,-7,22
FK Rubin,8810,8,5,6,9,22,19,3,21
Rostov,8810,9,4,6,10,10,18,-8,18
Amkar,8810,10,4,5,11,10,24,-14,17
Anzhi,8810,11,3,5,12,19,42,-23,14
Loko Moscow,8811,1,12,5,3,34,15,19,41
CSKA Moscow,8811,2,11,3,6,27,19,8,36
Spart Moscow,8811,3,9,5,6,36,30,6,32
Krasnodar,8811,4,9,5,6,32,27,5,32
Terek Grozny,8811,5,9,5,6,24,23,1,32
Zenit,8811,6,7,8,5,22,19,3,29
Din Moscow,8811,7,6,7,7,21,23,-2,25
FK Rubin,8811,8,5,7,8,24,20,4,22
Rostov,8811,9,5,6,9,11,17,-6,21
Amkar,8811,10,4,4,12,10,26,-16,16
Anzhi,8811,11,3,5,12,17,39,-22,14
Spart Moscow,8812,1,11,5,4,45,29,16,38
Loko Moscow,8812,2,11,5,4,29,18,11,38
Zenit,8812,3,9,8,3,26,13,13,35
Krasnodar,8812,4,10,4,6,34,24,10,34
CSKA Moscow,8812,5,10,3,7,26,20,6,33
Terek Grozny,8812,6,8,6,6,23,23,0,30
Din Moscow,8812,7,6,6,8,22,31,-9,24
FK Rubin,8812,8,5,5,10,23,24,-1,20
Rostov,8812,9,4,6,10,11,19,-8,18
Amkar,8812,10,4,5,11,11,25,-14,17
Anzhi,8812,11,3,5,12,16,40,-24,14
Loko Moscow,8813,1,12,6,2,32,13,19,42
CSKA Moscow,8813,2,11,4,5,28,19,9,37
Spart Moscow,8813,3,9,5,6,34,28,6,32
Terek Grozny,8813,4,9,5,6,23,23,0,32
Krasnodar,8813,5,8,6,6,30,27,3,30
Zenit,8813,6,7,8,5,22,16,6,29
Din Moscow,8813,7,7,6,7,20,21,-1,27
FK Rubin,8813,8,5,6,9,22,19,3,21
Rostov,8813,9,5,6,9,11,17,-6,21
Amkar,8813,10,4,4,12,10,25,-15,16
Anzhi,8813,11,2,6,12,15,39,-24,12
Loko Moscow,8814,1,12,6,2,30,11,19,42
Spart Moscow,8814,2,11,5,4,42,26,16,38
CSKA Moscow,8814,3,11,3,6,26,18,8,36
Zenit,8814,4,7,9,4,21,14,7,30
Krasnodar,8814,5,8,5,7,28,26,2,29
Terek Grozny,8814,6,8,5,7,22,26,-4,29
Din Moscow,8814,7,6,6,8,22,24,-2,24
FK Rubin,8814,8,5,6,9,22,22,0,21
Rostov,8814,9,4,6,10,10,20,-10,18
Anzhi,8814,10,4,5,11,18,37,-19,17
Amkar,8814,11,4,4,12,10,27,-17,16
Loko Moscow,8815,1,12,5,3,33,12,21,41
Spart Moscow,8815,2,10,6,4,38,26,12,36
Zenit,8815,3,9,8,3,26,13,13,35
CSKA Moscow,8815,4,10,4,6,26,22,4,34
Krasnodar,8815,5,8,4,8,28,31,-3,28
FK Rubin,8815,6,7,5,8,26,18,8,26
Terek Grozny,8815,7,7,5,8,22,26,-4,26
Din Moscow,8815,8,5,6,9,17,24,-7,21
Amkar,8815,9,5,5,10,11,23,-12,20
Rostov,8815,10,4,6,10,10,20,-10,18
Anzhi,8815,11,3,6,11,18,40,-22,15
Loko Moscow,8816,1,11,6,3,31,14,17,39
CSKA Moscow,8816,2,11,4,5,27,18,9,37
Krasnodar,8816,3,9,5,6,28,24,4,32
Zenit,8816,4,7,10,3,23,15,8,31
Spart Moscow,8816,5,8,7,5,38,31,7,31
Din Moscow,8816,6,7,6,7,21,22,-1,27
Terek Grozny,8816,7,7,6,7,21,25,-4,27
FK Rubin,8816,8,5,6,9,22,20,2,21
Rostov,8816,9,4,7,9,13,20,-7,19
Amkar,8816,10,4,6,10,12,25,-13,18
Anzhi,8816,11,3,5,12,17,39,-22,14
Loko Moscow,8817,1,12,6,2,32,12,20,42
CSKA Moscow,8817,2,11,4,5,29,20,9,37
Spart Moscow,8817,3,10,5,5,40,28,12,35
Terek Grozny,8817,4,9,5,6,25,23,2,32
Zenit,8817,5,7,10,3,23,15,8,31
Krasnodar,8817,6,9,4,7,29,27,2,31
Din Moscow,8817,7,7,6,7,22,23,-1,27
FK Rubin,8817,8,5,5,10,22,21,1,20
Rostov,8817,9,4,6,10,11,20,-9,18
Amkar,8817,10,4,4,12,9,28,-19,16
Anzhi,8817,11,2,5,13,16,41,-25,11
Loko Moscow,8818,1,11,6,3,30,13,17,39
Spart Moscow,8818,2,11,5,4,38,26,12,38
Krasnodar,8818,3,10,4,6,32,25,7,34
CSKA Moscow,8818,4,10,4,6,26,19,7,34
Zenit,8818,5,7,10,3,22,14,8,31
Terek Grozny,8818,6,8,5,7,21,25,-4,29
Din Moscow,8818,7,6,6,8,20,23,-3,24
FK Rubin,8818,8,5,5,10,21,22,-1,20
Rostov,8818,9,4,6,10,10,18,-8,18
Anzhi,8818,10,4,5,11,18,37,-19,17
Amkar,8818,11,4,4,12,9,25,-16,16
Loko Moscow,8819,1,13,5,2,31,11,20,44
Spart Moscow,8819,2,11,5,4,38,25,13,38
CSKA Moscow,8819,3,11,3,6,26,19,7,36
Zenit,8819,4,8,8,4,23,14,9,32
Terek Grozny,8819,5,8,6,6,23,24,-1,30
Krasnodar,8819,6,8,4,8,28,27,1,28
FK Rubin,8819,7,7,5,8,24,18,6,26
Din Moscow,8819,8,5,6,9,17,24,-7,21
Rostov,8819,9,4,6,10,10,18,-8,18
Amkar,8819,10,4,5,11,10,25,-15,17
Anzhi,8819,11,2,5,13,15,40,-25,11
Loko Moscow,8820,1,12,6,2,33,13,20,42
CSKA Moscow,8820,2,12,3,5,31,19,12,39
Krasnodar,8820,3,9,5,6,31,26,5,32
Terek Grozny,8820,4,9,5,6,25,25,0,32
Spart Moscow,8820,5,8,7,5,37,30,7,31
Zenit,8820,6,7,8,5,23,18,5,29
Din Moscow,8820,7,6,7,7,20,23,-3,25
FK Rubin,8820,8,5,6,9,21,19,2,21
Rostov,8820,9,4,7,9,11,18,-7,19
Amkar,8820,10,4,5,11,11,25,-14,17
Anzhi,8820,11,2,5,13,16,43,-27,11
Loko Moscow,8821,1,12,5,3,30,12,18,41
Spart Moscow,8821,2,10,6,4,45,29,16,36
CSKA Moscow,8821,3,10,5,5,27,19,8,35
Krasnodar,8821,4,9,5,6,29,25,4,32
Zenit,8821,5,7,9,4,22,15,7,30
Terek Grozny,8821,6,7,7,6,21,23,-2,28
Din Moscow,8821,7,6,6,8,18,28,-10,24
FK Rubin,8821,8,5,6,9,22,19,3,21
Rostov,8821,9,4,6,10,13,21,-8,18
Amkar,8821,10,4,6,10,10,23,-13,18
Anzhi,8821,11,2,7,11,16,39,-23,13
Loko Moscow,8822,1,12,6,2,32,13,19,42
CSKA Moscow,8822,2,11,4,5,30,20,10,37
Spart Moscow,8822,3,10,6,4,39,27,12,36
Zenit,8822,4,7,9,4,24,17,7,30
Krasnodar,8822,5,8,6,6,29,26,3,30
Terek Grozny,8822,6,8,6,6,24,24,0,30
Din Moscow,8822,7,6,6,8,20,22,-2,24
FK Rubin,8822,8,5,6,9,22,21,1,21
Rostov,8822,9,4,7,9,12,19,-7,19
Amkar,8822,10,4,5,11,9,25,-16,17
Anzhi,8822,11,2,5,13,17,44,-27,11
Loko Moscow,8823,1,11,6,3,29,13,16,39
CSKA Moscow,8823,2,11,4,5,35,21,14,37
Spart Moscow,8823,3,10,5,5,39,28,11,35
Krasnodar,8823,4,10,4,6,30,24,6,34
Zenit,8823,5,7,10,3,23,15,8,31
Din Moscow,8823,6,7,6,7,21,21,0,27
Terek Grozny,8823,7,7,5,8,20,25,-5,26
FK Rubin,8823,8,5,5,10,21,20,1,20
Amkar,8823,9,5,4,11,11,25,-14,19
Rostov,8823,10,4,6,10,10,20,-10,18
Anzhi,8823,11,3,5,12,18,45,-27,14
Loko Moscow,8824,1,13,5,2,32,12,20,44
CSKA Moscow,8824,2,11,3,6,28,20,8,36
Spart Moscow,8824,3,9,6,5,34,26,8,33
Krasnodar,8824,4,9,4,7,29,25,4,31
Zenit,8824,5,7,8,5,22,16,6,29
Terek Grozny,8824,6,7,6,7,22,26,-4,27
FK Rubin,8824,7,6,5,9,23,20,3,23
Din Moscow,8824,8,5,7,8,18,23,-5,22
Rostov,8824,9,5,6,9,11,17,-6,21
Amkar,8824,10,4,5,11,10,24,-14,17
Anzhi,8824,11,4,5,11,20,40,-20,17
Loko Moscow,8825,1,12,5,3,32,14,18,41
Spart Moscow,8825,2,10,6,4,37,26,11,36
CSKA Moscow,8825,3,11,3,6,29,20,9,36
Krasnodar,8825,4,9,4,7,29,27,2,31
Zenit,8825,5,7,8,5,23,18,5,29
Terek Grozny,8825,6,7,7,6,20,22,-2,28
Din Moscow,8825,7,6,6,8,18,22,-4,24
FK Rubin,8825,8,6,5,9,24,19,5,23
Rostov,8825,9,4,6,10,10,19,-9,18
Amkar,8825,10,4,6,10,10,23,-13,18
Anzhi,8825,11,3,6,11,17,39,-22,15
Loko Moscow,8826,1,12,6,2,34,13,21,42
CSKA Moscow,8826,2,11,3,6,29,21,8,36
Zenit,8826,3,8,8,4,24,17,7,32
Spart Moscow,8826,4,8,7,5,33,26,7,31
Krasnodar,8826,5,8,5,7,29,27,2,29
FK Rubin,8826,6,7,5,8,24,18,6,26
Terek Grozny,8826,7,7,5,8,20,26,-6,26
Din Moscow,8826,8,6,6,8,18,22,-4,24
Amkar,8826,9,5,5,10,10,22,-12,20
Rostov,8826,10,4,7,9,10,17,-7,19
Anzhi,8826,11,3,5,12,19,41,-22,14
Loko Moscow,8827,1,12,5,3,32,14,18,41
CSKA Moscow,8827,2,11,4,5,28,17,11,37
Spart Moscow,8827,3,10,6,4,44,26,18,36
Zenit,8827,4,8,9,3,23,14,9,33
Krasnodar,8827,5,9,4,7,30,26,4,31
Terek Grozny,8827,6,8,6,6,22,23,-1,30
Din Moscow,8827,7,6,6,8,21,30,-9,24
FK Rubin,8827,8,5,5,10,22,23,-1,20
Rostov,8827,9,4,7,9,11,18,-7,19
Amkar,8827,10,4,4,12,9,25,-16,16
Anzhi,8827,11,2,6,12,15,41,-26,12
Loko Moscow,8828,1,13,5,2,33,11,22,44
Spart Moscow,8828,2,10,5,5,42,29,13,35
CSKA Moscow,8828,3,10,4,6,25,18,7,34
Zenit,8828,4,8,8,4,22,15,7,32
Krasnodar,8828,5,8,5,7,28,27,1,29
Terek Grozny,8828,6,7,6,7,22,25,-3,27
FK Rubin,8828,7,6,6,8,23,18,5,24
Din Moscow,8828,8,5,6,9,18,27,-9,21
Amkar,8828,9,5,5,10,14,26,-12,20
Rostov,8828,10,4,6,10,10,19,-9,18
Anzhi,8828,11,3,6,11,15,37,-22,15
Loko Moscow,8829,1,12,5,3,31,12,19,41
CSKA Moscow,8829,2,12,3,5,29,19,10,39
Spart Moscow,8829,3,9,6,5,43,33,10,33
Zenit,8829,4,8,8,4,22,14,8,32
Terek Grozny,8829,5,8,6,6,23,24,-1,30
Krasnodar,8829,6,8,5,7,28,27,1,29
FK Rubin,8829,7,6,6,8,26,18,8,24
Rostov,8829,8,5,6,9,13,19,-6,21
Din Moscow,8829,9,5,6,9,18,29,-11,21
Amkar,8829,10,4,5,11,13,27,-14,17
Anzhi,8829,11,2,6,12,18,42,-24,12
Loko Moscow,8830,1,12,6,2,32,13,19,42
CSKA Moscow,8830,2,12,3,5,27,17,10,39
Spart Moscow,8830,3,10,6,4,36,26,10,36
Krasnodar,8830,4,9,5,6,32,26,6,32
Terek Grozny,8830,5,8,6,6,22,23,-1,30
Zenit,8830,6,7,8,5,21,15,6,29
FK Rubin,8830,7,6,5,9,23,21,2,23
Din Moscow,8830,8,5,6,9,18,24,-6,21
Rostov,8830,9,4,7,9,10,17,-7,19
Amkar,8830,10,4,5,11,10,24,-14,17
Anzhi,8830,11,2,5,13,15,40,-25,11
Loko Moscow,8831,1,12,5,3,31,12,19,41
CSKA Moscow,8831,2,12,3,5,30,19,11,39
Spart Moscow,8831,3,10,5,5,36,29,7,35
Zenit,8831,4,8,8,4,23,15,8,32
Krasnodar,8831,5,8,5,7,29,28,1,29
Terek Grozny,8831,6,7,6,7,20,23,-3,27
Din Moscow,8831,7,6,6,8,18,23,-5,24
Amkar,8831,8,6,4,10,14,22,-8,22
FK Rubin,8831,9,5,6,9,23,20,3,21
Rostov,8831,10,4,6,10,10,18,-8,18
Anzhi,8831,11,2,6,12,15,40,-25,12
Loko Moscow,8832,1,13,5,2,33,13,20,44
Spart Moscow,8832,2,10,6,4,41,28,13,36
CSKA Moscow,8832,3,11,3,6,28,18,10,36
Zenit,8832,4,8,8,4,24,16,8,32
Krasnodar,8832,5,9,4,7,31,27,4,31
Terek Grozny,8832,6,7,7,6,26,28,-2,28
Din Moscow,8832,7,5,7,8,19,24,-5,22
FK Rubin,8832,8,5,6,9,23,21,2,21
Rostov,8832,9,4,6,10,10,21,-11,18
Amkar,8832,10,4,6,10,13,26,-13,18
Anzhi,8832,11,2,6,12,17,43,-26,12
Loko Moscow,8833,1,11,5,4,31,15,16,38
CSKA Moscow,8833,2,11,4,5,29,19,10,37
Spart Moscow,8833,3,9,6,5,38,29,9,33
Zenit,8833,4,8,8,4,24,17,7,32
Krasnodar,8833,5,9,5,6,30,26,4,32
Terek Grozny,8833,6,8,6,6,22,23,-1,30
FK Rubin,8833,7,6,6,8,23,18,5,24
Rostov,8833,8,5,6,9,12,18,-6,21
Din Moscow,8833,9,5,6,9,18,25,-7,21
Amkar,8833,10,4,5,11,11,25,-14,17
Anzhi,8833,11,2,7,11,15,38,-23,13
Loko Moscow,8834,1,12,6,2,31,12,19,42
Spart Moscow,8834,2,10,5,5,37,27,10,35
CSKA Moscow,8834,3,10,4,6,26,20,6,34
Zenit,8834,4,8,8,4,24,15,9,32
Krasnodar,8834,5,8,5,7,27,25,2,29
Terek Grozny,8834,6,8,5,7,22,23,-1,29
Din Moscow,8834,7,6,6,8,19,23,-4,24
FK Rubin,8834,8,6,5,9,23,19,4,23
Rostov,8834,9,5,6,9,12,18,-6,21
Amkar,8834,10,4,4,12,9,26,-17,16
Anzhi,8834,11,3,6,11,16,38,-22,15
Loko Moscow,8835,1,12,6,2,31,11,20,42
Spart Moscow,8835,2,11,5,4,37,25,12,38
CSKA Moscow,8835,3,11,4,5,30,18,12,37
Zenit,8835,4,7,9,4,22,16,6,30
Krasnodar,8835,5,8,5,7,28,26,2,29
Terek Grozny,8835,6,8,5,7,23,24,-1,29
FK Rubin,8835,7,7,5,8,27,18,9,26
Din Moscow,8835,8,5,6,9,17,26,-9,21
Rostov,8835,9,4,6,10,10,18,-8,18
Amkar,8835,10,4,4,12,9,26,-17,16
Anzhi,8835,11,3,5,12,16,42,-26,14
Loko Moscow,8836,1,11,7,2,30,12,18,40
CSKA Moscow,8836,2,11,4,5,26,17,9,37
Spart Moscow,8836,3,9,5,6,36,30,6,32
Terek Grozny,8836,4,9,5,6,27,24,3,32
Zenit,8836,5,7,9,4,22,15,7,30
Krasnodar,8836,6,8,6,6,27,24,3,30
FK Rubin,8836,7,6,6,8,23,17,6,24
Rostov,8836,8,5,6,9,13,19,-6,21
Din Moscow,8836,9,5,6,9,17,24,-7,21
Amkar,8836,10,5,4,11,11,25,-14,19
Anzhi,8836,11,2,6,12,16,41,-25,12
Loko Moscow,8837,1,12,6,2,33,14,19,42
CSKA Moscow,8837,2,11,3,6,35,19,16,36
Spart Moscow,8837,3,10,6,4,40,29,11,36
Zenit,8837,4,8,9,3,24,15,9,33
Krasnodar,8837,5,8,5,7,31,29,2,29
Terek Grozny,8837,6,7,6,7,22,26,-4,27
Din Moscow,8837,7,6,6,8,21,24,-3,24
FK Rubin,8837,8,5,6,9,23,22,1,21
Amkar,8837,9,5,5,10,13,24,-11,20
Rostov,8837,10,4,6,10,11,19,-8,18
Anzhi,8837,11,2,6,12,16,48,-32,12
Loko Moscow,8838,1,12,6,2,33,14,19,42
CSKA Moscow,8838,2,11,4,5,30,19,11,37
Spart Moscow,8838,3,9,7,4,39,28,11,34
Zenit,8838,4,7,10,3,23,15,8,31
Krasnodar,8838,5,8,4,8,28,27,1,28
Terek Grozny,8838,6,7,5,8,21,27,-6,26
FK Rubin,8838,7,6,6,8,22,17,5,24
Din Moscow,8838,8,5,7,8,17,24,-7,22
Amkar,8838,9,5,5,10,15,25,-10,20
Rostov,8838,10,4,7,9,11,18,-7,19
Anzhi,8838,11,3,5,12,17,42,-25,14
Loko Moscow,8839,1,11,6,3,30,13,17,39
CSKA Moscow,8839,2,11,4,5,28,19,9,37
Spart Moscow,8839,3,9,7,4,34,25,9,34
Zenit,8839,4,8,9,3,23,14,9,33
Krasnodar,8839,5,9,5,6,34,26,8,32
Terek Grozny,8839,6,9,5,6,26,23,3,32
FK Rubin,8839,7,6,5,9,23,23,0,23
Din Moscow,8839,8,5,6,9,17,23,-6,21
Rostov,8839,9,4,7,9,10,17,-7,19
Amkar,8839,10,4,5,11,9,26,-17,17
Anzhi,8839,11,2,5,13,16,41,-25,11
Loko Moscow,8840,1,13,5,2,33,12,21,44
Spart Moscow,8840,2,10,5,5,42,28,14,35
CSKA Moscow,8840,3,10,4,6,26,21,5,34
Zenit,8840,4,7,9,4,22,15,7,30
Terek Grozny,8840,5,8,6,6,25,24,1,30
Krasnodar,8840,6,8,4,8,28,28,0,28
FK Rubin,8840,7,7,5,8,23,17,6,26
Din Moscow,8840,8,5,6,9,17,26,-9,21
Amkar,8840,9,5,4,11,12,26,-14,19
Rostov,8840,10,4,6,10,10,21,-11,18
Anzhi,8840,11,3,6,11,19,39,-20,15
Loko Moscow,8841,1,11,6,3,30,13,17,39
Spart Moscow,8841,2,10,6,4,41,29,12,36
CSKA Moscow,8841,3,11,3,6,30,19,11,36
Zenit,8841,4,9,8,3,24,14,10,35
Krasnodar,8841,5,9,5,6,29,25,4,32
Terek Grozny,8841,6,7,5,8,21,25,-4,26
Din Moscow,8841,7,5,7,8,20,25,-5,22
FK Rubin,8841,8,5,6,9,22,19,3,21
Amkar,8841,9,5,5,10,12,24,-12,20
Rostov,8841,10,4,6,10,11,21,-10,18
Anzhi,8841,11,3,5,12,15,41,-26,14
Loko Moscow,8842,1,12,6,2,33,12,21,42
CSKA Moscow,8842,2,10,4,6,27,20,7,34
Spart Moscow,8842,3,9,6,5,36,27,9,33
Zenit,8842,4,7,9,4,21,16,5,30
Terek Grozny,8842,5,8,6,6,23,24,-1,30
Krasnodar,8842,6,8,5,7,30,28,2,29
Din Moscow,8842,7,6,6,8,18,23,-5,24
FK Rubin,8842,8,6,5,9,24,20,4,23
Amkar,8842,9,5,5,10,11,23,-12,20
Rostov,8842,10,4,7,9,10,17,-7,19
Anzhi,8842,11,3,5,12,19,42,-23,14
Loko Moscow,8843,1,13,5,2,32,11,21,44
CSKA Moscow,8843,2,11,4,5,30,20,10,37
Spart Moscow,8843,3,10,6,4,39,27,12,36
Zenit,8843,4,7,9,4,22,15,7,30
Krasnodar,8843,5,8,5,7,28,27,1,29
Terek Grozny,8843,6,7,5,8,21,26,-5,26
FK Rubin,8843,7,5,7,8,23,19,4,22
Din Moscow,8843,8,5,7,8,18,25,-7,22
Rostov,8843,9,4,7,9,11,18,-7,19
Amkar,8843,10,5,4,11,11,24,-13,19
Anzhi,8843,11,3,5,12,19,42,-23,14
Loko Moscow,8844,1,11,7,2,31,13,18,40
CSKA Moscow,8844,2,11,4,5,27,18,9,37
Spart Moscow,8844,3,10,5,5,38,28,10,35
Zenit,8844,4,7,10,3,23,15,8,31
Krasnodar,8844,5,8,6,6,29,26,3,30
Terek Grozny,8844,6,7,7,6,22,24,-2,28
FK Rubin,8844,7,6,6,8,24,19,5,24
Din Moscow,8844,8,6,6,8,20,24,-4,24
Rostov,8844,9,4,6,10,10,19,-9,18
Amkar,8844,10,4,5,11,11,25,-14,17
Anzhi,8844,11,2,6,12,15,39,-24,12
Loko Moscow,8845,1,11,6,3,30,14,16,39
CSKA Moscow,8845,2,11,3,6,29,18,11,36
Spart Moscow,8845,3,10,5,5,40,28,12,35
Zenit,8845,4,9,8,3,25,14,11,35
Terek Grozny,8845,5,9,5,6,27,24,3,32
Krasnodar,8845,6,8,5,7,28,26,2,29
FK Rubin,8845,7,7,5,8,26,20,6,26
Rostov,8845,8,5,6,9,12,18,-6,21
Din Moscow,8845,9,5,6,9,20,28,-8,21
Amkar,8845,10,4,4,12,9,28,-19,16
Anzhi,8845,11,2,5,13,16,44,-28,11
Loko Moscow,8846,1,11,5,4,29,15,14,38
Spart Moscow,8846,2,11,5,4,40,27,13,38
CSKA Moscow,8846,3,10,5,5,28,20,8,35
Zenit,8846,4,8,9,3,23,14,9,33
Krasnodar,8846,5,9,5,6,31,25,6,32
Terek Grozny,8846,6,8,5,7,21,24,-3,29
FK Rubin,8846,7,6,6,8,24,18,6,24
Din Moscow,8846,8,5,6,9,18,27,-9,21
Rostov,8846,9,4,6,10,11,19,-8,18
Amkar,8846,10,4,4,12,9,24,-15,16
Anzhi,8846,11,3,6,11,18,39,-21,15
Loko Moscow,8847,1,12,5,3,32,14,18,41
CSKA Moscow,8847,2,11,4,5,30,21,9,37
Spart Moscow,8847,3,10,6,4,39,27,12,36
Krasnodar,8847,4,10,4,6,31,26,5,34
Zenit,8847,5,7,8,5,21,15,6,29
Terek Grozny,8847,6,7,5,8,21,25,-4,26
Din Moscow,8847,7,5,7,8,18,24,-6,22
FK Rubin,8847,8,5,6,9,21,18,3,21
Rostov,8847,9,4,7,9,11,18,-7,19
Amkar,8847,10,5,4,11,11,25,-14,19
Anzhi,8847,11,3,6,11,19,41,-22,15
Loko Moscow,8848,1,12,6,2,33,13,20,42
CSKA Moscow,8848,2,11,3,6,27,20,7,36
Zenit,8848,3,8,9,3,24,14,10,33
Spart Moscow,8848,4,9,5,6,40,30,10,32
Terek Grozny,8848,5,9,5,6,25,24,1,32
Krasnodar,8848,6,9,4,7,29,27,2,31
Din Moscow,8848,7,6,6,8,20,24,-4,24
FK Rubin,8848,8,6,5,9,22,18,4,23
Rostov,8848,9,5,6,9,12,18,-6,21
Amkar,8848,10,4,4,12,10,28,-18,16
Anzhi,8848,11,2,5,13,16,42,-26,11
Loko Moscow,8849,1,12,6,2,30,11,19,42
Spart Moscow,8849,2,10,6,4,40,29,11,36
CSKA Moscow,8849,3,11,3,6,28,19,9,36
Zenit,8849,4,8,8,4,23,15,8,32
Krasnodar,8849,5,9,5,6,30,24,6,32
Terek Grozny,8849,6,7,6,7,21,25,-4,27
Din Moscow,8849,7,6,6,8,19,23,-4,24
FK Rubin,8849,8,5,5,10,21,22,-1,20
Rostov,8849,9,4,7,9,12,19,-7,19
Amkar,8849,10,5,4,11,13,25,-12,19
Anzhi,8849,11,2,6,12,15,40,-25,12
Loko Moscow,8850,1,11,6,3,29,12,17,39
Spart Moscow,8850,2,10,5,5,37,26,11,35
CSKA Moscow,8850,3,10,4,6,26,19,7,34
Zenit,8850,4,8,9,3,22,13,9,33
Krasnodar,8850,5,9,4,7,29,27,2,31
Din Moscow,8850,6,7,6,7,21,21,0,27
Terek Grozny,8850,7,7,5,8,20,26,-6,26
FK Rubin,8850,8,6,5,9,24,21,3,23
Amkar,8850,9,5,4,11,11,23,-12,19
Rostov,8850,10,4,6,10,10,20,-10,18
Anzhi,8850,11,3,6,11,17,38,-21,15
Loko Moscow,8851,1,11,6,3,30,13,17,39
CSKA Moscow,8851,2,11,3,6,28,19,9,36
Krasnodar,8851,3,10,4,6,33,27,6,34
Zenit,8851,4,8,9,3,23,13,10,33
Spart Moscow,8851,5,9,6,5,35,29,6,33
Terek Grozny,8851,6,7,5,8,23,27,-4,26
Din Moscow,8851,7,5,8,7,17,21,-4,23
Amkar,8851,8,6,4,10,16,25,-9,22
FK Rubin,8851,9,5,6,9,23,21,2,21
Rostov,8851,10,4,6,10,10,18,-8,18
Anzhi,8851,11,3,5,12,16,41,-25,14
Loko Moscow,8852,1,13,5,2,33,12,21,44
Spart Moscow,8852,2,10,5,5,38,28,10,35
CSKA Moscow,8852,3,10,5,5,25,17,8,35
Terek Grozny,8852,4,9,5,6,28,23,5,32
Zenit,8852,5,7,9,4,22,15,7,30
Krasnodar,8852,6,8,4,8,27,27,0,28
Din Moscow,8852,7,7,6,7,21,23,-2,27
FK Rubin,8852,8,6,5,9,23,19,4,23
Rostov,8852,9,4,6,10,10,19,-9,18
Amkar,8852,10,4,4,12,11,30,-19,16
Anzhi,8852,11,2,6,12,14,39,-25,12
Loko Moscow,8853,1,12,5,3,33,13,20,41
Spart Moscow,8853,2,11,5,4,41,28,13,38
CSKA Moscow,8853,3,11,4,5,30,20,10,37
Krasnodar,8853,4,9,5,6,30,26,4,32
Zenit,8853,5,7,8,5,23,20,3,29
Terek Grozny,8853,6,7,5,8,21,26,-5,26
Din Moscow,8853,7,6,6,8,22,25,-3,24
FK Rubin,8853,8,5,6,9,23,21,2,21
Amkar,8853,9,5,4,11,12,25,-13,19
Rostov,8853,10,4,6,10,11,20,-9,18
Anzhi,8853,11,3,6,11,16,38,-22,15
Loko Moscow,8854,1,12,5,3,31,13,18,41
CSKA Moscow,8854,2,11,3,6,28,21,7,36
Spart Moscow,8854,3,10,5,5,36,28,8,35
Krasnodar,8854,4,10,4,6,30,25,5,34
Zenit,8854,5,8,8,4,24,14,10,32
Terek Grozny,8854,6,7,6,7,20,23,-3,27
Din Moscow,8854,7,6,6,8,21,25,-4,24
FK Rubin,8854,8,5,5,10,23,21,2,20
Amkar,8854,9,5,5,10,11,22,-11,20
Rostov,8854,10,4,6,10,10,18,-8,18
Anzhi,8854,11,3,5,12,16,40,-24,14
Loko Moscow,8855,1,12,5,3,32,14,18,41
Spart Moscow,8855,2,11,5,4,39,25,14,38
CSKA Moscow,8855,3,11,4,5,29,20,9,37
Krasnodar,8855,4,10,4,6,33,27,6,34
Zenit,8855,5,7,9,4,22,15,7,30
Terek Grozny,8855,6,7,5,8,23,27,-4,26
Din Moscow,8855,7,6,6,8,19,25,-6,24
FK Rubin,8855,8,5,5,10,23,22,1,20
Amkar,8855,9,5,4,11,11,25,-14,19
Rostov,8855,10,4,6,10,10,18,-8,18
Anzhi,8855,11,3,5,12,19,42,-23,14
Loko Moscow,8856,1,11,6,3,29,12,17,39
Spart Moscow,8856,2,11,5,4,39,25,14,38
CSKA Moscow,8856,3,11,3,6,28,19,9,36
Zenit,8856,4,8,9,3,23,14,9,33
Krasnodar,8856,5,9,4,7,28,27,1,31
Terek Grozny,8856,6,8,6,6,21,22,-1,30
FK Rubin,8856,7,6,6,8,26,19,7,24
Din Moscow,8856,8,5,7,8,19,24,-5,22
Rostov,8856,9,4,6,10,10,18,-8,18
Amkar,8856,10,4,4,12,9,27,-18,16
Anzhi,8856,11,2,6,12,14,39,-25,12
Loko Moscow,8857,1,12,5,3,34,14,20,41
Spart Moscow,8857,2,11,5,4,38,27,11,38
Zenit,8857,3,9,8,3,24,14,10,35
CSKA Moscow,8857,4,10,3,7,25,19,6,33
Terek Grozny,8857,5,9,5,6,24,24,0,32
Krasnodar,8857,6,9,4,7,34,29,5,31
Din Moscow,8857,7,6,6,8,18,22,-4,24
FK Rubin,8857,8,5,5,10,22,24,-2,20
Rostov,8857,9,4,6,10,10,18,-8,18
Amkar,8857,10,4,4,12,12,27,-15,16
Anzhi,8857,11,3,5,12,16,39,-23,14
Loko Moscow,8858,1,11,5,4,29,13,16,38
Spart Moscow,8858,2,11,5,4,41,27,14,38
CSKA Moscow,8858,3,11,4,5,26,17,9,37
Zenit,8858,4,8,8,4,22,14,8,32
Krasnodar,8858,5,9,4,7,28,25,3,31
Terek Grozny,8858,6,8,5,7,24,26,-2,29
FK Rubin,8858,7,7,5,8,25,19,6,26
Din Moscow,8858,8,5,6,9,19,26,-7,21
Rostov,8858,9,4,6,10,11,19,-8,18
Amkar,8858,10,4,4,12,11,28,-17,16
Anzhi,8858,11,3,6,11,17,39,-22,15
Loko Moscow,8859,1,12,5,3,30,12,18,41
Spart Moscow,8859,2,10,6,4,40,27,13,36
CSKA Moscow,8859,3,10,5,5,28,20,8,35
Krasnodar,8859,4,9,5,6,29,25,4,32
Zenit,8859,5,7,9,4,22,15,7,30
Terek Grozny,8859,6,7,6,7,21,24,-3,27
Din Moscow,8859,7,5,8,7,19,23,-4,23
FK Rubin,8859,8,5,7,8,22,18,4,22
Amkar,8859,9,5,4,11,10,24,-14,19
Rostov,8859,10,4,6,10,10,20,-10,18
Anzhi,8859,11,2,7,11,17,40,-23,13
Loko Moscow,8860,1,11,7,2,30,12,18,40
Spart Moscow,8860,2,11,5,4,38,26,12,38
CSKA Moscow,8860,3,10,5,5,29,21,8,35
Zenit,8860,4,7,10,3,23,15,8,31
Krasnodar,8860,5,8,6,6,30,27,3,30
Terek Grozny,8860,6,7,6,7,22,25,-3,27
FK Rubin,8860,7,6,6,8,25,20,5,24
Din Moscow,8860,8,5,6,9,19,25,-6,21
Amkar,8860,9,5,4,11,11,25,-14,19
Rostov,8860,10,4,6,10,10,18,-8,18
Anzhi,8860,11,2,7,11,17,40,-23,13
Loko Moscow,8861,1,12,6,2,31,12,19,42
CSKA Moscow,8861,2,12,3,5,30,17,13,39
Spart Moscow,8861,3,11,5,4,41,27,14,38
Terek Grozny,8861,4,8,6,6,24,23,1,30
Zenit,8861,5,7,8,5,21,16,5,29
Krasnodar,8861,6,8,5,7,28,26,2,29
FK Rubin,8861,7,7,5,8,26,19,7,26
Din Moscow,8861,8,5,6,9,21,30,-9,21
Rostov,8861,9,4,6,10,10,19,-9,18
Amkar,8861,10,4,5,11,9,23,-14,17
Anzhi,8861,11,2,5,13,15,44,-29,11
Loko Moscow,8862,1,13,5,2,33,12,21,44
CSKA Moscow,8862,2,12,3,5,30,18,12,39
Spart Moscow,8862,3,8,6,6,37,32,5,30
Terek Grozny,8862,4,8,6,6,23,24,-1,30
Zenit,8862,5,7,8,5,23,19,4,29
Krasnodar,8862,6,8,4,8,27,26,1,28
Din Moscow,8862,7,6,7,7,20,23,-3,25
FK Rubin,8862,8,6,6,8,22,17,5,24
Amkar,8862,9,5,5,10,13,24,-11,20
Rostov,8862,10,4,7,9,11,18,-7,19
Anzhi,8862,11,2,5,13,15,41,-26,11
Loko Moscow,8863,1,12,5,3,32,15,17,41
CSKA Moscow,8863,2,11,4,5,29,19,10,37
Krasnodar,8863,3,10,4,6,30,24,6,34
Spart Moscow,8863,4,9,6,5,36,28,8,33
Zenit,8863,5,7,9,4,25,18,7,30
Terek Grozny,8863,6,7,6,7,22,25,-3,27
Din Moscow,8863,7,5,8,7,17,21,-4,23
FK Rubin,8863,8,5,6,9,21,18,3,21
Amkar,8863,9,5,5,10,12,24,-12,20
Rostov,8863,10,4,6,10,11,19,-8,18
Anzhi,8863,11,3,5,12,16,40,-24,14
Loko Moscow,8864,1,12,5,3,30,14,16,41
CSKA Moscow,8864,2,11,4,5,30,20,10,37
Zenit,8864,3,8,8,4,26,17,9,32
Spart Moscow,8864,4,8,7,5,36,29,7,31
Terek Grozny,8864,5,8,6,6,22,23,-1,30
Krasnodar,8864,6,8,5,7,27,25,2,29
FK Rubin,8864,7,6,6,8,25,17,8,24
Din Moscow,8864,8,6,6,8,19,26,-7,24
Rostov,8864,9,4,7,9,11,18,-7,19
Amkar,8864,10,4,6,10,11,24,-13,18
Anzhi,8864,11,2,6,12,15,39,-24,12
Loko Moscow,8865,1,12,6,2,30,11,19,42
Spart Moscow,8865,2,10,6,4,36,25,11,36
CSKA Moscow,8865,3,10,5,5,28,20,8,35
Krasnodar,8865,4,9,5,6,30,24,6,32
Zenit,8865,5,7,9,4,21,14,7,30
Terek Grozny,8865,6,8,6,6,25,24,1,30
Din Moscow,8865,7,6,7,7,19,22,-3,25
FK Rubin,8865,8,5,5,10,22,22,0,20
Rostov,8865,9,4,6,10,10,19,-9,18
Amkar,8865,10,4,5,11,11,25,-14,17
Anzhi,8865,11,2,6,12,17,43,-26,12
Loko Moscow,8866,1,13,5,2,33,12,21,44
Spart Moscow,8866,2,10,6,4,38,26,12,36
CSKA Moscow,8866,3,11,3,6,28,20,8,36
Terek Grozny,8866,4,8,6,6,24,25,-1,30
Zenit,8866,5,7,8,5,23,17,6,29
Krasnodar,8866,6,8,5,7,28,27,1,29
FK Rubin,8866,7,6,6,8,24,18,6,24
Din Moscow,8866,8,5,7,8,17,23,-6,22
Rostov,8866,9,4,6,10,11,21,-10,18
Amkar,8866,10,4,5,11,12,26,-14,17
Anzhi,8866,11,3,5,12,16,39,-23,14
Loko Moscow,8867,1,12,6,2,33,13,20,42
CSKA Moscow,8867,2,11,4,5,29,18,11,37
Spart Moscow,8867,3,10,6,4,40,30,10,36
Zenit,8867,4,7,9,4,22,16,6,30
Krasnodar,8867,5,8,6,6,31,28,3,30
Terek Grozny,8867,6,8,5,7,22,24,-2,29
Din Moscow,8867,7,6,6,8,20,23,-3,24
FK Rubin,8867,8,5,6,9,23,21,2,21
Rostov,8867,9,4,7,9,13,20,-7,19
Amkar,8867,10,5,4,11,12,24,-12,19
Anzhi,8867,11,2,5,13,14,42,-28,11
Loko Moscow,8868,1,12,5,3,31,13,18,41
CSKA Moscow,8868,2,12,3,5,30,20,10,39
Krasnodar,8868,3,10,4,6,30,25,5,34
Spart Moscow,8868,4,9,5,6,35,28,7,32
Zenit,8868,5,7,8,5,23,17,6,29
Terek Grozny,8868,6,7,6,7,20,24,-4,27
Din Moscow,8868,7,6,7,7,20,23,-3,25
FK Rubin,8868,8,5,6,9,23,20,3,21
Rostov,8868,9,5,6,9,11,17,-6,21
Amkar,8868,10,4,5,11,10,24,-14,17
Anzhi,8868,11,3,5,12,17,39,-22,14
Loko Moscow,8869,1,13,5,2,33,12,21,44
Spart Moscow,8869,2,10,6,4,37,26,11,36
CSKA Moscow,8869,3,11,3,6,26,20,6,36
Zenit,8869,4,8,8,4,24,15,9,32
Terek Grozny,8869,5,8,6,6,21,22,-1,30
Krasnodar,8869,6,8,4,8,28,27,1,28
Din Moscow,8869,7,6,6,8,20,24,-4,24
FK Rubin,8869,8,6,5,9,23,20,3,23
Rostov,8869,9,4,7,9,11,18,-7,19
Amkar,8869,10,4,4,12,9,24,-15,16
Anzhi,8869,11,2,6,12,14,38,-24,12
Loko Moscow,8870,1,11,7,2,30,12,18,40
CSKA Moscow,8870,2,10,5,5,28,20,8,35
Zenit,8870,3,7,10,3,22,14,8,31
Spart Moscow,8870,4,8,6,6,34,28,6,30
Krasnodar,8870,5,8,5,7,28,26,2,29
Terek Grozny,8870,6,8,5,7,25,25,0,29
Din Moscow,8870,7,6,7,7,19,21,-2,25
FK Rubin,8870,8,6,5,9,22,19,3,23
Rostov,8870,9,5,6,9,11,17,-6,21
Amkar,8870,10,5,4,11,12,27,-15,19
Anzhi,8870,11,3,6,11,18,40,-22,15
Loko Moscow,8871,1,11,5,4,31,17,14,38
CSKA Moscow,8871,2,11,3,6,28,20,8,36
Zenit,8871,3,9,8,3,26,15,11,35
Krasnodar,8871,4,10,4,6,34,26,8,34
Spart Moscow,8871,5,9,6,5,36,27,9,33
Terek Grozny,8871,6,8,5,7,22,23,-1,29
Din Moscow,8871,7,7,6,7,20,22,-2,27
FK Rubin,8871,8,5,5,10,23,23,0,20
Rostov,8871,9,4,6,10,10,19,-9,18
Amkar,8871,10,4,5,11,10,25,-15,17
Anzhi,8871,11,3,5,12,16,39,-23,14
Loko Moscow,8872,1,12,5,3,34,13,21,41
Zenit,8872,2,9,8,3,26,14,12,35
CSKA Moscow,8872,3,10,3,7,26,21,5,33
Spart Moscow,8872,4,8,8,4,34,26,8,32
Terek Grozny,8872,5,8,6,6,23,23,0,30
Krasnodar,8872,6,8,5,7,30,32,-2,29
FK Rubin,8872,7,6,6,8,25,20,5,24
Din Moscow,8872,8,5,7,8,17,22,-5,22
Rostov,8872,9,4,7,9,11,18,-7,19
Amkar,8872,10,4,6,10,10,23,-13,18
Anzhi,8872,11,3,5,12,15,39,-24,14
Loko Moscow,8873,1,12,6,2,33,13,20,42
CSKA Moscow,8873,2,10,4,6,26,20,6,34
Spart Moscow,8873,3,9,6,5,38,32,6,33
Zenit,8873,4,8,8,4,24,16,8,32
Krasnodar,8873,5,9,5,6,29,25,4,32
Terek Grozny,8873,6,8,5,7,23,24,-1,29
Din Moscow,8873,7,5,7,8,19,24,-5,22
FK Rubin,8873,8,5,6,9,21,18,3,21
Rostov,8873,9,5,6,9,14,18,-4,21
Amkar,8873,10,5,5,10,12,24,-12,20
Anzhi,8873,11,2,6,12,15,40,-25,12
Loko Moscow,8874,1,11,7,2,30,12,18,40
Spart Moscow,8874,2,11,5,4,43,25,18,38
CSKA Moscow,8874,3,11,4,5,26,17,9,37
Krasnodar,8874,4,9,5,6,29,25,4,32
Zenit,8874,5,7,10,3,21,13,8,31
Terek Grozny,8874,6,7,6,7,20,23,-3,27
Din Moscow,8874,7,6,6,8,19,25,-6,24
FK Rubin,8874,8,5,5,10,21,20,1,20
Rostov,8874,9,4,6,10,10,20,-10,18
Amkar,8874,10,4,5,11,9,25,-16,17
Anzhi,8874,11,3,5,12,15,38,-23,14
Loko Moscow,8875,1,12,5,3,33,14,19,41
Zenit,8875,2,9,8,3,25,15,10,35
Spart Moscow,8875,3,9,6,5,36,27,9,33
CSKA Moscow,8875,4,10,3,7,27,21,6,33
Terek Grozny,8875,5,8,5,7,24,23,1,29
Krasnodar,8875,6,8,4,8,29,30,-1,28
Din Moscow,8875,7,6,6,8,19,24,-5,24
FK Rubin,8875,8,6,5,9,24,19,5,23
Rostov,8875,9,5,6,9,11,17,-6,21
Amkar,8875,10,5,5,10,10,22,-12,20
Anzhi,8875,11,3,5,12,16,42,-26,14
Loko Moscow,8876,1,11,6,3,30,13,17,39
CSKA Moscow,8876,2,10,4,6,26,20,6,34
Zenit,8876,3,8,9,3,23,13,10,33
Spart Moscow,8876,4,9,6,5,38,29,9,33
Krasnodar,8876,5,9,4,7,29,26,3,31
Terek Grozny,8876,6,8,5,7,22,23,-1,29
FK Rubin,8876,7,6,6,8,23,18,5,24
Din Moscow,8876,8,5,7,8,18,24,-6,22
Rostov,8876,9,4,7,9,12,19,-7,19
Amkar,8876,10,5,4,11,11,25,-14,19
Anzhi,8876,11,3,6,11,16,38,-22,15
Loko Moscow,8877,1,11,6,3,30,13,17,39
CSKA Moscow,8877,2,11,3,6,30,21,9,36
Zenit,8877,3,8,9,3,26,16,10,33
Spart Moscow,8877,4,9,6,5,35,27,8,33
Krasnodar,8877,5,9,5,6,29,25,4,32
Terek Grozny,8877,6,7,5,8,20,26,-6,26
Din Moscow,8877,7,6,7,7,19,22,-3,25
FK Rubin,8877,8,5,7,8,23,19,4,22
Rostov,8877,9,4,7,9,11,18,-7,19
Amkar,8877,10,5,4,11,11,23,-12,19
Anzhi,8877,11,3,5,12,16,40,-24,14
Loko Moscow,8878,1,12,5,3,35,17,18,41
CSKA Moscow,8878,2,12,3,5,28,18,10,39
Spart Moscow,8878,3,10,6,4,38,26,12,36
Krasnodar,8878,4,10,4,6,33,27,6,34
Zenit,8878,5,7,8,5,23,17,6,29
Terek Grozny,8878,6,7,5,8,22,26,-4,26
FK Rubin,8878,7,6,5,9,23,19,4,23
Din Moscow,8878,8,5,6,9,18,25,-7,21
Amkar,8878,9,5,5,10,10,22,-12,20
Rostov,8878,10,4,6,10,10,20,-10,18
Anzhi,8878,11,3,5,12,18,41,-23,14
Loko Moscow,8879,1,11,7,2,30,12,18,40
CSKA Moscow,8879,2,11,3,6,26,19,7,36
Spart Moscow,8879,3,10,5,5,39,28,11,35
Zenit,8879,4,8,9,3,23,13,10,33
Krasnodar,8879,5,8,6,6,30,27,3,30
Terek Grozny,8879,6,8,5,7,23,26,-3,29
Din Moscow,8879,7,6,6,8,20,24,-4,24
FK Rubin,8879,8,5,6,9,23,21,2,21
Rostov,8879,9,5,6,9,11,17,-6,21
Amkar,8879,10,4,4,12,10,27,-17,16
Anzhi,8879,11,3,5,12,18,39,-21,14
Loko Moscow,8880,1,11,6,3,29,12,17,39
CSKA Moscow,8880,2,12,3,5,31,19,12,39
Spart Moscow,8880,3,10,6,4,38,25,13,36
Krasnodar,8880,4,10,4,6,31,26,5,34
Zenit,8880,5,7,9,4,22,15,7,30
Terek Grozny,8880,6,7,5,8,21,25,-4,26
Din Moscow,8880,7,5,8,7,17,21,-4,23
FK Rubin,8880,8,5,6,9,23,20,3,21
Amkar,8880,9,5,4,11,11,24,-13,19
Rostov,8880,10,4,6,10,10,21,-11,18
Anzhi,8880,11,3,5,12,16,41,-25,14
Spart Moscow,8881,1,11,5,4,43,28,15,38
Loko Moscow,8881,2,11,5,4,30,17,13,38
CSKA Moscow,8881,3,11,3,6,27,19,8,36
Zenit,8881,4,9,8,3,25,13,12,35
Krasnodar,8881,5,9,5,6,30,25,5,32
Terek Grozny,8881,6,7,6,7,22,25,-3,27
FK Rubin,8881,7,5,7,8,21,17,4,22
Din Moscow,8881,8,5,7,8,18,26,-8,22
Amkar,8881,9,5,4,11,11,25,-14,19
Rostov,8881,10,4,6,10,12,20,-8,18
Anzhi,8881,11,2,6,12,16,40,-24,12
Loko Moscow,8882,1,12,6,2,32,12,20,42
CSKA Moscow,8882,2,11,3,6,27,18,9,36
Spart Moscow,8882,3,10,5,5,37,27,10,35
Krasnodar,8882,4,9,4,7,31,26,5,31
Zenit,8882,5,7,9,4,22,16,6,30
Terek Grozny,8882,6,7,5,8,22,26,-4,26
Din Moscow,8882,7,5,7,8,19,24,-5,22
Amkar,8882,8,6,4,10,11,22,-11,22
FK Rubin,8882,9,5,6,9,22,22,0,21
Rostov,8882,10,4,6,10,10,19,-9,18
Anzhi,8882,11,4,5,11,18,39,-21,17
Loko Moscow,8883,1,12,5,3,34,14,20,41
CSKA Moscow,8883,2,12,3,5,30,18,12,39
Spart Moscow,8883,3,9,6,5,36,28,8,33
Krasnodar,8883,4,9,5,6,30,26,4,32
Zenit,8883,5,7,8,5,21,18,3,29
Din Moscow,8883,6,7,6,7,25,24,1,27
Terek Grozny,8883,7,7,6,7,22,25,-3,27
FK Rubin,8883,8,5,6,9,22,22,0,21
Rostov,8883,9,4,7,9,10,17,-7,19
Amkar,8883,10,5,4,11,10,23,-13,19
Anzhi,8883,11,2,6,12,17,42,-25,12
Loko Moscow,8884,1,11,5,4,30,14,16,38
CSKA Moscow,8884,2,11,3,6,28,20,8,36
Zenit,8884,3,9,8,3,25,14,11,35
Krasnodar,8884,4,10,4,6,31,26,5,34
Spart Moscow,8884,5,8,6,6,36,32,4,30
Terek Grozny,8884,6,7,5,8,20,26,-6,26
Din Moscow,8884,7,6,6,8,18,23,-5,24
FK Rubin,8884,8,6,5,9,25,20,5,23
Amkar,8884,9,6,4,10,17,24,-7,22
Rostov,8884,10,4,7,9,11,18,-7,19
Anzhi,8884,11,3,5,12,16,40,-24,14
Loko Moscow,8885,1,12,6,2,31,12,19,42
CSKA Moscow,8885,2,11,4,5,30,18,12,37
Spart Moscow,8885,3,10,6,4,37,27,10,36
Zenit,8885,4,7,10,3,23,15,8,31
Krasnodar,8885,5,9,4,7,30,25,5,31
Terek Grozny,8885,6,8,6,6,21,22,-1,30
Din Moscow,8885,7,6,7,7,20,23,-3,25
FK Rubin,8885,8,5,5,10,22,22,0,20
Rostov,8885,9,4,6,10,10,18,-8,18
Amkar,8885,10,4,4,12,10,25,-15,16
Anzhi,8885,11,2,6,12,14,41,-27,12
Loko Moscow,8886,1,11,6,3,31,15,16,39
CSKA Moscow,8886,2,11,4,5,27,18,9,37
Spart Moscow,8886,3,10,5,5,39,28,11,35
Krasnodar,8886,4,9,5,6,30,25,5,32
Zenit,8886,5,7,9,4,22,15,7,30
Terek Grozny,8886,6,7,6,7,22,25,-3,27
FK Rubin,8886,7,6,6,8,22,17,5,24
Amkar,8886,8,6,4,10,12,23,-11,22
Din Moscow,8886,9,5,6,9,18,24,-6,21
Rostov,8886,10,4,6,10,10,20,-10,18
Anzhi,8886,11,2,7,11,17,40,-23,13
Loko Moscow,8887,1,11,7,2,30,12,18,40
CSKA Moscow,8887,2,11,4,5,29,18,11,37
Spart Moscow,8887,3,9,6,5,39,29,10,33
Krasnodar,8887,4,9,5,6,30,24,6,32
Zenit,8887,5,7,10,3,22,14,8,31
Terek Grozny,8887,6,7,6,7,22,26,-4,27
FK Rubin,8887,7,6,5,9,22,20,2,23
Din Moscow,8887,8,5,7,8,19,24,-5,22
Rostov,8887,9,5,6,9,12,18,-6,21
Amkar,8887,10,5,4,11,12,26,-14,19
Anzhi,8887,11,2,6,12,16,42,-26,12
Loko Moscow,8888,1,11,6,3,30,13,17,39
CSKA Moscow,8888,2,10,5,5,28,20,8,35
Spart Moscow,8888,3,9,7,4,38,29,9,34
Zenit,8888,4,8,9,3,24,15,9,33
Krasnodar,8888,5,9,5,6,29,24,5,32
Terek Grozny,8888,6,8,5,7,23,24,-1,29
Din Moscow,8888,7,6,7,7,20,23,-3,25
FK Rubin,8888,8,5,5,10,21,20,1,20
Rostov,8888,9,4,7,9,11,18,-7,19
Amkar,8888,10,4,4,12,10,26,-16,16
Anzhi,8888,11,3,6,11,18,40,-22,15
Loko Moscow,8889,1,13,5,2,34,11,23,44
CSKA Moscow,8889,2,11,4,5,31,19,12,37
Spart Moscow,8889,3,9,6,5,37,29,8,33
Terek Grozny,8889,4,9,5,6,24,24,0,32
Zenit,8889,5,7,9,4,23,17,6,30
Krasnodar,8889,6,8,4,8,27,28,-1,28
Din Moscow,8889,7,6,7,7,20,22,-2,25
FK Rubin,8889,8,6,6,8,23,18,5,24
Rostov,8889,9,4,6,10,11,20,-9,18
Amkar,8889,10,4,5,11,11,25,-14,17
Anzhi,8889,11,2,5,13,15,43,-28,11
Loko Moscow,8890,1,13,5,2,33,12,21,44
CSKA Moscow,8890,2,12,3,5,29,17,12,39
Spart Moscow,8890,3,10,5,5,37,28,9,35
Terek Grozny,8890,4,9,5,6,26,24,2,32
Krasnodar,8890,5,9,4,7,30,26,4,31
Zenit,8890,6,7,8,5,21,16,5,29
Din Moscow,8890,7,6,6,8,19,23,-4,24
Rostov,8890,8,5,6,9,12,17,-5,21
FK Rubin,8890,9,5,5,10,21,21,0,20
Amkar,8890,10,4,4,12,12,27,-15,16
Anzhi,8890,11,2,5,13,14,43,-29,11
Loko Moscow,8891,1,12,6,2,33,14,19,42
Spart Moscow,8891,2,11,5,4,40,26,14,38
CSKA Moscow,8891,3,10,4,6,25,18,7,34
Zenit,8891,4,7,10,3,23,15,8,31
Krasnodar,8891,5,9,4,7,30,27,3,31
Terek Grozny,8891,6,8,5,7,22,27,-5,29
FK Rubin,8891,7,6,5,9,23,19,4,23
Din Moscow,8891,8,5,6,9,17,23,-6,21
Rostov,8891,9,4,6,10,11,22,-11,18
Anzhi,8891,10,4,5,11,20,38,-18,17
Amkar,8891,11,4,4,12,9,24,-15,16
Loko Moscow,8892,1,12,5,3,31,13,18,41
CSKA Moscow,8892,2,12,3,5,28,17,11,39
Spart Moscow,8892,3,10,5,5,37,27,10,35
Zenit,8892,4,8,8,4,22,14,8,32
Krasnodar,8892,5,8,4,8,29,32,-3,28
Terek Grozny,8892,6,7,6,7,20,24,-4,27
FK Rubin,8892,7,7,5,8,30,19,11,26
Din Moscow,8892,8,5,6,9,18,26,-8,21
Amkar,8892,9,5,5,10,10,22,-12,20
Rostov,8892,10,4,6,10,11,19,-8,18
Anzhi,8892,11,3,5,12,16,39,-23,14
Loko Moscow,8893,1,12,6,2,32,13,19,42
CSKA Moscow,8893,2,11,4,5,28,19,9,37
Krasnodar,8893,3,9,5,6,30,25,5,32
Zenit,8893,4,7,9,4,23,16,7,30
Spart Moscow,8893,5,8,6,6,37,32,5,30
Terek Grozny,8893,6,7,6,7,22,26,-4,27
Din Moscow,8893,7,5,8,7,19,23,-4,23
FK Rubin,8893,8,5,6,9,22,20,2,21
Rostov,8893,9,5,6,9,14,19,-5,21
Amkar,8893,10,5,5,10,12,24,-12,20
Anzhi,8893,11,3,5,12,18,40,-22,14
Loko Moscow,8894,1,11,6,3,29,12,17,39
CSKA Moscow,8894,2,11,4,5,27,17,10,37
Zenit,8894,3,8,9,3,22,13,9,33
Spart Moscow,8894,4,9,5,6,35,33,2,32
Krasnodar,8894,5,8,6,6,28,25,3,30
Terek Grozny,8894,6,8,5,7,22,24,-2,29
FK Rubin,8894,7,6,6,8,24,18,6,24
Din Moscow,8894,8,6,6,8,23,24,-1,24
Rostov,8894,9,5,6,9,12,17,-5,21
Amkar,8894,10,4,4,12,10,25,-15,16
Anzhi,8894,11,3,5,12,15,39,-24,14
Loko Moscow,8895,1,11,6,3,30,13,17,39
CSKA Moscow,8895,2,10,5,5,26,18,8,35
Krasnodar,8895,3,10,4,6,30,25,5,34
Spart Moscow,8895,4,9,6,5,38,30,8,33
Zenit,8895,5,7,10,3,22,14,8,31
Terek Grozny,8895,6,8,5,7,23,25,-2,29
Din Moscow,8895,7,6,7,7,19,21,-2,25
FK Rubin,8895,8,5,6,9,22,19,3,21
Rostov,8895,9,4,7,9,11,18,-7,19
Amkar,8895,10,4,4,12,12,28,-16,16
Anzhi,8895,11,3,6,11,17,39,-22,15
Loko Moscow,8896,1,11,5,4,30,17,13,38
CSKA Moscow,8896,2,11,3,6,27,19,8,36
Zenit,8896,3,9,8,3,27,14,13,35
Spart Moscow,8896,4,10,5,5,37,28,9,35
Krasnodar,8896,5,9,4,7,29,27,2,31
Terek Grozny,8896,6,8,5,7,24,28,-4,29
Din Moscow,8896,7,6,7,7,21,23,-2,25
FK Rubin,8896,8,6,6,8,25,19,6,24
Amkar,8896,9,5,4,11,14,25,-11,19
Rostov,8896,10,4,6,10,10,19,-9,18
Anzhi,8896,11,2,5,13,16,41,-25,11
Loko Moscow,8897,1,12,5,3,32,13,19,41
CSKA Moscow,8897,2,11,3,6,26,19,7,36
Krasnodar,8897,3,10,4,6,30,25,5,34
Zenit,8897,4,8,8,4,23,15,8,32
Spart Moscow,8897,5,8,7,5,33,26,7,31
Terek Grozny,8897,6,8,6,6,25,26,-1,30
Din Moscow,8897,7,6,7,7,18,21,-3,25
FK Rubin,8897,8,5,5,10,21,19,2,20
Amkar,8897,9,5,5,10,13,25,-12,20
Rostov,8897,10,4,7,9,10,17,-7,19
Anzhi,8897,11,2,5,13,15,40,-25,11
Loko Moscow,8898,1,12,5,3,32,16,16,41
CSKA Moscow,8898,2,11,4,5,29,19,10,37
Krasnodar,8898,3,9,5,6,31,25,6,32
Spart Moscow,8898,4,9,5,6,39,35,4,32
Zenit,8898,5,7,9,4,24,17,7,30
Terek Grozny,8898,6,7,6,7,21,24,-3,27
FK Rubin,8898,7,6,6,8,24,18,6,24
Amkar,8898,8,6,4,10,14,22,-8,22
Rostov,8898,9,5,6,9,14,18,-4,21
Din Moscow,8898,10,5,6,9,19,28,-9,21
Anzhi,8898,11,2,6,12,16,41,-25,12
Loko Moscow,8899,1,13,5,2,32,12,20,44
CSKA Moscow,8899,2,12,3,5,30,19,11,39
Spart Moscow,8899,3,9,7,4,41,31,10,34
Terek Grozny,8899,4,9,5,6,24,23,1,32
Krasnodar,8899,5,9,4,7,30,26,4,31
Zenit,8899,6,7,8,5,22,16,6,29
FK Rubin,8899,7,6,5,9,23,19,4,23
Din Moscow,8899,8,5,7,8,20,26,-6,22
Rostov,8899,9,4,7,9,12,19,-7,19
Amkar,8899,10,4,4,12,11,27,-16,16
Anzhi,8899,11,2,5,13,15,42,-27,11
Loko Moscow,8900,1,12,6,2,32,12,20,42
CSKA Moscow,8900,2,11,4,5,29,19,10,37
Spart Moscow,8900,3,10,6,4,36,25,11,36
Zenit,8900,4,7,10,3,23,15,8,31
Terek Grozny,8900,5,8,6,6,22,23,-1,30
Krasnodar,8900,6,8,4,8,29,29,0,28
Din Moscow,8900,7,6,6,8,19,23,-4,24
FK Rubin,8900,8,6,5,9,24,20,4,23
Rostov,8900,9,4,6,10,10,19,-9,18
Amkar,8900,10,4,6,10,10,23,-13,18
Anzhi,8900,11,2,5,13,14,40,-26,11
Loko Moscow,8901,1,13,5,2,33,11,22,44
CSKA Moscow,8901,2,11,3,6,29,20,9,36
Spart Moscow,8901,3,10,5,5,38,28,10,35
Zenit,8901,4,8,8,4,23,15,8,32
Krasnodar,8901,5,9,4,7,28,27,1,31
Terek Grozny,8901,6,7,6,7,22,25,-3,27
FK Rubin,8901,7,6,5,9,23,19,4,23
Rostov,8901,8,5,6,9,12,17,-5,21
Din Moscow,8901,9,5,6,9,19,25,-6,21
Amkar,8901,10,4,5,11,10,26,-16,17
Anzhi,8901,11,3,5,12,17,41,-24,14
Loko Moscow,8902,1,12,6,2,33,14,19,42
CSKA Moscow,8902,2,12,3,5,31,20,11,39
Krasnodar,8902,3,9,5,6,30,26,4,32
Spart Moscow,8902,4,8,7,5,36,29,7,31
Terek Grozny,8902,5,8,6,6,22,23,-1,30
Zenit,8902,6,7,8,5,24,18,6,29
FK Rubin,8902,7,6,5,9,26,21,5,23
Din Moscow,8902,8,5,7,8,20,26,-6,22
Amkar,8902,9,5,5,10,12,24,-12,20
Rostov,8902,10,4,7,9,11,18,-7,19
Anzhi,8902,11,2,5,13,16,42,-26,11
Loko Moscow,8903,1,12,5,3,30,14,16,41
CSKA Moscow,8903,2,10,4,6,28,22,6,34
Spart Moscow,8903,3,9,6,5,40,32,8,33
Zenit,8903,4,8,8,4,24,15,9,32
Krasnodar,8903,5,9,4,7,31,26,5,31
Terek Grozny,8903,6,7,6,7,21,26,-5,27
FK Rubin,8903,7,6,6,8,23,18,5,24
Din Moscow,8903,8,5,7,8,20,25,-5,22
Amkar,8903,9,6,4,10,16,25,-9,22
Rostov,8903,10,4,7,9,10,17,-7,19
Anzhi,8903,11,2,7,11,17,40,-23,13
Loko Moscow,8904,1,13,5,2,33,13,20,44
Spart Moscow,8904,2,10,6,4,41,29,12,36
CSKA Moscow,8904,3,10,5,5,27,19,8,35
Krasnodar,8904,4,9,4,7,30,26,4,31
Zenit,8904,5,7,9,4,23,16,7,30
Terek Grozny,8904,6,8,6,6,25,23,2,30
Din Moscow,8904,7,6,6,8,22,26,-4,24
FK Rubin,8904,8,5,5,10,21,22,-1,20
Rostov,8904,9,4,6,10,11,19,-8,18
Amkar,8904,10,4,5,11,10,27,-17,17
Anzhi,8904,11,2,7,11,16,39,-23,13
Loko Moscow,8905,1,11,6,3,30,13,17,39
Spart Moscow,8905,2,11,5,4,39,27,12,38
CSKA Moscow,8905,3,11,3,6,29,21,8,36
Zenit,8905,4,9,8,3,24,14,10,35
Krasnodar,8905,5,8,6,6,29,26,3,30
Terek Grozny,8905,6,8,5,7,24,25,-1,29
FK Rubin,8905,7,6,6,8,24,19,5,24
Din Moscow,8905,8,5,6,9,19,25,-6,21
Amkar,8905,9,5,4,11,13,26,-13,19
Rostov,8905,10,4,6,10,10,19,-9,18
Anzhi,8905,11,2,5,13,16,42,-26,11
Loko Moscow,8906,1,12,5,3,32,12,20,41
Spart Moscow,8906,2,10,6,4,41,27,14,36
Zenit,8906,3,9,8,3,27,13,14,35
CSKA Moscow,8906,4,10,3,7,26,24,2,33
Krasnodar,8906,5,9,4,7,29,28,1,31
Terek Grozny,8906,6,8,5,7,23,24,-1,29
Din Moscow,8906,7,5,7,8,18,25,-7,22
FK Rubin,8906,8,5,6,9,23,20,3,21
Rostov,8906,9,4,7,9,12,19,-7,19
Amkar,8906,10,5,4,11,11,25,-14,19
Anzhi,8906,11,3,5,12,16,41,-25,14
Loko Moscow,8907,1,11,6,3,29,12,17,39
CSKA Moscow,8907,2,10,5,5,26,18,8,35
Zenit,8907,3,8,9,3,22,13,9,33
Spart Moscow,8907,4,9,5,6,36,28,8,32
Krasnodar,8907,5,9,5,6,29,25,4,32
Terek Grozny,8907,6,8,6,6,23,23,0,30
Din Moscow,8907,7,6,6,8,19,24,-5,24
FK Rubin,8907,8,6,5,9,25,20,5,23
Amkar,8907,9,5,5,10,11,23,-12,20
Rostov,8907,10,4,6,10,10,19,-9,18
Anzhi,8907,11,2,6,12,16,41,-25,12
Loko Moscow,8908,1,13,5,2,35,12,23,44
CSKA Moscow,8908,2,11,4,5,27,18,9,37
Spart Moscow,8908,3,9,6,5,38,29,9,33
Krasnodar,8908,4,9,4,7,30,29,1,31
Zenit,8908,5,7,9,4,22,16,6,30
Terek Grozny,8908,6,8,6,6,22,23,-1,30
FK Rubin,8908,7,6,5,9,25,20,5,23
Din Moscow,8908,8,5,7,8,19,25,-6,22
Amkar,8908,9,5,5,10,11,23,-12,20
Rostov,8908,10,4,6,10,11,20,-9,18
Anzhi,8908,11,2,5,13,15,40,-25,11
Loko Moscow,8909,1,12,6,2,32,13,19,42
CSKA Moscow,8909,2,11,4,5,27,18,9,37
Spart Moscow,8909,3,10,6,4,39,28,11,36
Zenit,8909,4,7,9,4,23,16,7,30
Krasnodar,8909,5,8,6,6,30,27,3,30
Terek Grozny,8909,6,7,6,7,20,23,-3,27
FK Rubin,8909,7,6,6,8,25,19,6,24
Din Moscow,8909,8,5,6,9,19,27,-8,21
Rostov,8909,9,4,6,10,10,18,-8,18
Amkar,8909,10,4,6,10,10,23,-13,18
Anzhi,8909,11,3,5,12,15,38,-23,14
Loko Moscow,8910,1,11,5,4,30,17,13,38
CSKA Moscow,8910,2,10,5,5,27,19,8,35
Zenit,8910,3,8,9,3,23,14,9,33
Spart Moscow,8910,4,9,5,6,35,30,5,32
Krasnodar,8910,5,9,4,7,33,27,6,31
Terek Grozny,8910,6,7,6,7,21,26,-5,27
FK Rubin,8910,7,6,6,8,23,18,5,24
Din Moscow,8910,8,5,7,8,18,23,-5,22
Amkar,8910,9,6,4,10,14,22,-8,22
Rostov,8910,10,5,6,9,12,17,-5,21
Anzhi,8910,11,2,7,11,16,39,-23,13
Loko Moscow,8911,1,12,5,3,30,12,18,41
CSKA Moscow,8911,2,11,3,6,30,18,12,36
Spart Moscow,8911,3,10,5,5,40,29,11,35
Zenit,8911,4,8,8,4,22,14,8,32
Krasnodar,8911,5,9,4,7,28,26,2,31
Terek Grozny,8911,6,8,5,7,22,24,-2,29
FK Rubin,8911,7,7,5,8,25,18,7,26
Din Moscow,8911,8,5,6,9,20,26,-6,21
Amkar,8911,9,5,4,11,12,25,-13,19
Rostov,8911,10,4,6,10,10,20,-10,18
Anzhi,8911,11,3,5,12,15,42,-27,14
Loko Moscow,8912,1,12,5,3,32,14,18,41
Spart Moscow,8912,2,9,7,4,35,26,9,34
Krasnodar,8912,3,10,4,6,30,25,5,34
CSKA Moscow,8912,4,10,3,7,25,19,6,33
Zenit,8912,5,8,8,4,23,15,8,32
Terek Grozny,8912,6,7,6,7,21,24,-3,27
Din Moscow,8912,7,5,7,8,20,25,-5,22
FK Rubin,8912,8,5,6,9,23,20,3,21
Amkar,8912,9,5,5,10,10,22,-12,20
Rostov,8912,10,4,7,9,10,17,-7,19
Anzhi,8912,11,3,6,11,16,38,-22,15
Loko Moscow,8913,1,13,5,2,33,13,20,44
CSKA Moscow,8913,2,11,4,5,27,18,9,37
Spart Moscow,8913,3,9,5,6,38,31,7,32
Zenit,8913,4,7,8,5,21,15,6,29
Krasnodar,8913,5,8,5,7,31,29,2,29
Terek Grozny,8913,6,7,5,8,20,24,-4,26
FK Rubin,8913,7,5,7,8,23,19,4,22
Din Moscow,8913,8,5,7,8,17,23,-6,22
Amkar,8913,9,6,4,10,13,24,-11,22
Rostov,8913,10,5,6,9,13,18,-5,21
Anzhi,8913,11,3,6,11,16,38,-22,15
Loko Moscow,8914,1,11,6,3,31,15,16,39
CSKA Moscow,8914,2,12,3,5,31,18,13,39
Spart Moscow,8914,3,10,5,5,39,29,10,35
Zenit,8914,4,8,8,4,24,15,9,32
Krasnodar,8914,5,9,5,6,31,26,5,32
Terek Grozny,8914,6,7,5,8,20,25,-5,26
Din Moscow,8914,7,6,6,8,19,24,-5,24
Amkar,8914,8,6,4,10,13,23,-10,22
FK Rubin,8914,9,5,5,10,22,21,1,20
Rostov,8914,10,4,6,10,11,20,-9,18
Anzhi,8914,11,3,5,12,16,41,-25,14
Loko Moscow,8915,1,12,5,3,31,13,18,41
CSKA Moscow,8915,2,11,3,6,29,21,8,36
Spart Moscow,8915,3,9,6,5,37,30,7,33
Zenit,8915,4,8,8,4,23,14,9,32
Krasnodar,8915,5,9,5,6,30,26,4,32
Terek Grozny,8915,6,7,6,7,21,24,-3,27
Din Moscow,8915,7,6,6,8,20,25,-5,24
FK Rubin,8915,8,5,6,9,24,21,3,21
Rostov,8915,9,5,6,9,13,17,-4,21
Amkar,8915,10,4,6,10,12,25,-13,18
Anzhi,8915,11,3,5,12,17,41,-24,14
Loko Moscow,8916,1,11,6,3,31,14,17,39
Spart Moscow,8916,2,11,5,4,41,27,14,38
CSKA Moscow,8916,3,11,3,6,28,20,8,36
Zenit,8916,4,9,8,3,26,16,10,35
Krasnodar,8916,5,8,6,6,29,26,3,30
Terek Grozny,8916,6,8,5,7,25,25,0,29
Din Moscow,8916,7,6,6,8,20,26,-6,24
FK Rubin,8916,8,5,6,9,23,20,3,21
Amkar,8916,9,5,4,11,12,25,-13,19
Rostov,8916,10,4,6,10,10,19,-9,18
Anzhi,8916,11,2,5,13,15,42,-27,11
Loko Moscow,8917,1,11,6,3,30,15,15,39
Spart Moscow,8917,2,11,5,4,39,27,12,38
CSKA Moscow,8917,3,11,4,5,26,17,9,37
Krasnodar,8917,4,9,5,6,33,27,6,32
Zenit,8917,5,7,9,4,21,14,7,30
Terek Grozny,8917,6,7,6,7,22,25,-3,27
Din Moscow,8917,7,6,6,8,20,23,-3,24
FK Rubin,8917,8,5,6,9,23,21,2,21
Rostov,8917,9,4,6,10,11,19,-8,18
Amkar,8917,10,4,5,11,10,25,-15,17
Anzhi,8917,11,3,6,11,16,38,-22,15
Loko Moscow,8918,1,12,6,2,33,14,19,42
Spart Moscow,8918,2,10,5,5,38,29,9,35
CSKA Moscow,8918,3,10,4,6,28,21,7,34
Zenit,8918,4,8,9,3,26,17,9,33
Krasnodar,8918,5,8,5,7,27,25,2,29
Terek Grozny,8918,6,7,7,6,22,24,-2,28
FK Rubin,8918,7,6,6,8,22,17,5,24
Din Moscow,8918,8,5,6,9,18,24,-6,21
Amkar,8918,9,5,5,10,11,23,-12,20
Rostov,8918,10,4,6,10,12,20,-8,18
Anzhi,8918,11,2,7,11,17,40,-23,13
Loko Moscow,8919,1,11,7,2,30,12,18,40
CSKA Moscow,8919,2,12,3,5,30,19,11,39
Spart Moscow,8919,3,9,6,5,40,31,9,33
Zenit,8919,4,7,9,4,21,14,7,30
Krasnodar,8919,5,8,6,6,29,26,3,30
Terek Grozny,8919,6,7,7,6,24,26,-2,28
Din Moscow,8919,7,7,6,7,22,23,-1,27
FK Rubin,8919,8,5,6,9,22,20,2,21
Rostov,8919,9,4,7,9,11,18,-7,19
Amkar,8919,10,4,5,11,13,28,-15,17
Anzhi,8919,11,2,6,12,18,43,-25,12
Loko Moscow,8920,1,12,6,2,33,13,20,42
CSKA Moscow,8920,2,11,3,6,28,20,8,36
Spart Moscow,8920,3,10,5,5,39,29,10,35
Zenit,8920,4,8,8,4,24,16,8,32
Krasnodar,8920,5,8,6,6,30,27,3,30
Terek Grozny,8920,6,7,7,6,23,25,-2,28
Din Moscow,8920,7,6,6,8,20,25,-5,24
FK Rubin,8920,8,5,6,9,23,20,3,21
Amkar,8920,9,5,5,10,14,25,-11,20
Rostov,8920,10,4,6,10,11,20,-9,18
Anzhi,8920,11,2,6,12,14,39,-25,12
Loko Moscow,8921,1,12,6,2,31,11,20,42
Spart Moscow,8921,2,10,6,4,37,26,11,36
CSKA Moscow,8921,3,11,3,6,26,18,8,36
Zenit,8921,4,8,9,3,22,13,9,33
Terek Grozny,8921,5,8,6,6,23,24,-1,30
Krasnodar,8921,6,8,5,7,27,26,1,29
Din Moscow,8921,7,6,6,8,20,23,-3,24
FK Rubin,8921,8,5,6,9,21,19,2,21
Rostov,8921,9,4,6,10,10,19,-9,18
Amkar,8921,10,4,6,10,9,22,-13,18
Anzhi,8921,11,2,5,13,16,41,-25,11
Loko Moscow,8922,1,11,6,3,30,13,17,39
CSKA Moscow,8922,2,12,3,5,30,17,13,39
Spart Moscow,8922,3,9,5,6,38,29,9,32
Krasnodar,8922,4,9,5,6,30,26,4,32
Zenit,8922,5,7,9,4,22,16,6,30
Terek Grozny,8922,6,8,5,7,22,26,-4,29
FK Rubin,8922,7,6,6,8,25,20,5,24
Din Moscow,8922,8,6,6,8,21,25,-4,24
Amkar,8922,9,6,4,10,13,22,-9,22
Rostov,8922,10,4,6,10,10,20,-10,18
Anzhi,8922,11,2,5,13,15,42,-27,11
Loko Moscow,8923,1,12,6,2,34,15,19,42
Zenit,8923,2,8,9,3,26,15,11,33
Spart Moscow,8923,3,9,6,5,36,28,8,33
CSKA Moscow,8923,4,10,3,7,25,22,3,33
Krasnodar,8923,5,9,4,7,30,27,3,31
Terek Grozny,8923,6,8,5,7,21,24,-3,29
Din Moscow,8923,7,6,7,7,19,22,-3,25
FK Rubin,8923,8,5,6,9,21,18,3,21
Rostov,8923,9,4,6,10,11,19,-8,18
Amkar,8923,10,4,5,11,9,23,-14,17
Anzhi,8923,11,4,5,11,18,37,-19,17
Loko Moscow,8924,1,12,6,2,34,12,22,42
CSKA Moscow,8924,2,10,3,7,26,22,4,33
Zenit,8924,3,8,8,4,24,17,7,32
Krasnodar,8924,4,9,5,6,31,25,6,32
Spart Moscow,8924,5,8,6,6,37,31,6,30
Terek Grozny,8924,6,8,6,6,23,24,-1,30
Din Moscow,8924,7,6,6,8,20,24,-4,24
FK Rubin,8924,8,6,5,9,23,21,2,23
Amkar,8924,9,5,5,10,12,24,-12,20
Rostov,8924,10,4,7,9,11,18,-7,19
Anzhi,8924,11,3,5,12,18,41,-23,14
Loko Moscow,8925,1,12,5,3,31,13,18,41
Krasnodar,8925,2,10,4,6,30,25,5,34
Spart Moscow,8925,3,9,6,5,37,29,8,33
CSKA Moscow,8925,4,10,3,7,28,24,4,33
Zenit,8925,5,8,8,4,25,15,10,32
Din Moscow,8925,6,7,6,7,21,23,-2,27
Terek Grozny,8925,7,7,5,8,23,27,-4,26
FK Rubin,8925,8,5,5,10,22,20,2,20
Rostov,8925,9,4,7,9,11,18,-7,19
Amkar,8925,10,5,4,11,13,26,-13,19
Anzhi,8925,11,4,5,11,19,40,-21,17
Loko Moscow,8926,1,11,6,3,30,13,17,39
CSKA Moscow,8926,2,10,5,5,28,20,8,35
Krasnodar,8926,3,9,5,6,29,25,4,32
Zenit,8926,4,7,10,3,22,14,8,31
Spart Moscow,8926,5,8,7,5,36,29,7,31
Terek Grozny,8926,6,7,5,8,22,28,-6,26
FK Rubin,8926,7,6,6,8,22,17,5,24
Din Moscow,8926,8,5,7,8,19,24,-5,22
Rostov,8926,9,5,6,9,11,17,-6,21
Amkar,8926,10,5,5,10,13,23,-10,20
Anzhi,8926,11,3,6,11,19,41,-22,15
Loko Moscow,8927,1,12,5,3,33,15,18,41
CSKA Moscow,8927,2,11,3,6,28,20,8,36
Spart Moscow,8927,3,9,7,4,39,29,10,34
Zenit,8927,4,8,8,4,24,16,8,32
Krasnodar,8927,5,9,4,7,32,28,4,31
Terek Grozny,8927,6,7,5,8,21,26,-5,26
Din Moscow,8927,7,6,7,7,20,22,-2,25
FK Rubin,8927,8,6,5,9,24,21,3,23
Rostov,8927,9,4,7,9,12,19,-7,19
Amkar,8927,10,5,4,11,11,25,-14,19
Anzhi,8927,11,3,5,12,18,41,-23,14
Loko Moscow,8928,1,11,5,4,31,15,16,38
CSKA Moscow,8928,2,11,4,5,26,17,9,37
Krasnodar,8928,3,10,4,6,33,26,7,34
Spart Moscow,8928,4,9,6,5,35,26,9,33
Zenit,8928,5,8,8,4,22,14,8,32
Terek Grozny,8928,6,8,5,7,21,23,-2,29
Din Moscow,8928,7,5,7,8,18,24,-6,22
FK Rubin,8928,8,5,6,9,22,21,1,21
Rostov,8928,9,4,7,9,10,17,-7,19
Amkar,8928,10,5,4,11,10,23,-13,19
Anzhi,8928,11,3,6,11,15,37,-22,15
Loko Moscow,8929,1,12,5,3,30,12,18,41
CSKA Moscow,8929,2,11,4,5,28,17,11,37
Spart Moscow,8929,3,9,5,6,38,28,10,32
Krasnodar,8929,4,9,4,7,29,26,3,31
Zenit,8929,5,7,9,4,21,14,7,30
Terek Grozny,8929,6,8,6,6,23,23,0,30
FK Rubin,8929,7,6,6,8,24,19,5,24
Din Moscow,8929,8,5,7,8,18,27,-9,22
Rostov,8929,9,5,6,9,11,17,-6,21
Amkar,8929,10,5,4,11,11,24,-13,19
Anzhi,8929,11,2,6,12,15,41,-26,12
Loko Moscow,8930,1,13,5,2,32,12,20,44
CSKA Moscow,8930,2,10,4,6,26,21,5,34
Zenit,8930,3,8,8,4,24,14,10,32
Spart Moscow,8930,4,9,5,6,38,31,7,32
Terek Grozny,8930,5,8,6,6,23,23,0,30
Krasnodar,8930,6,8,4,8,29,29,0,28
FK Rubin,8930,7,7,5,8,26,18,8,26
Din Moscow,8930,8,6,6,8,20,24,-4,24
Amkar,8930,9,5,4,11,11,25,-14,19
Rostov,8930,10,4,6,10,11,20,-9,18
Anzhi,8930,11,2,7,11,16,39,-23,13
Loko Moscow,8931,1,11,5,4,29,13,16,38
CSKA Moscow,8931,2,11,4,5,29,17,12,37
Zenit,8931,3,8,9,3,22,13,9,33
Spart Moscow,8931,4,9,5,6,37,30,7,32
Krasnodar,8931,5,9,5,6,29,25,4,32
Terek Grozny,8931,6,7,7,6,20,22,-2,28
Din Moscow,8931,7,6,6,8,20,24,-4,24
FK Rubin,8931,8,5,6,9,23,21,2,21
Rostov,8931,9,5,6,9,14,19,-5,21
Amkar,8931,10,5,5,10,10,22,-12,20
Anzhi,8931,11,2,6,12,14,41,-27,12
Loko Moscow,8932,1,12,5,3,32,13,19,41
Spart Moscow,8932,2,10,6,4,38,26,12,36
Krasnodar,8932,3,10,4,6,30,25,5,34
CSKA Moscow,8932,4,10,3,7,29,23,6,33
Zenit,8932,5,8,8,4,25,18,7,32
Terek Grozny,8932,6,8,5,7,23,23,0,29
Din Moscow,8932,7,5,7,8,18,23,-5,22
FK Rubin,8932,8,5,6,9,22,19,3,21
Amkar,8932,9,5,5,10,10,22,-12,20
Rostov,8932,10,4,6,10,10,20,-10,18
Anzhi,8932,11,3,5,12,17,42,-25,14
Loko Moscow,8933,1,11,7,2,30,12,18,40
CSKA Moscow,8933,2,11,3,6,29,18,11,36
Zenit,8933,3,8,9,3,23,14,9,33
Spart Moscow,8933,4,9,5,6,37,30,7,32
Krasnodar,8933,5,9,5,6,28,24,4,32
Terek Grozny,8933,6,7,6,7,21,24,-3,27
Din Moscow,8933,7,6,7,7,20,23,-3,25
Amkar,8933,8,6,4,10,13,23,-10,22
FK Rubin,8933,9,5,6,9,23,20,3,21
Rostov,8933,10,4,6,10,11,20,-9,18
Anzhi,8933,11,2,6,12,15,42,-27,12
Loko Moscow,8934,1,11,6,3,32,15,17,39
CSKA Moscow,8934,2,12,3,5,30,19,11,39
Spart Moscow,8934,3,10,5,5,41,31,10,35
Krasnodar,8934,4,9,4,7,31,29,2,31
Zenit,8934,5,7,9,4,23,17,6,30
Terek Grozny,8934,6,8,6,6,24,25,-1,30
Din Moscow,8934,7,6,6,8,22,26,-4,24
FK Rubin,8934,8,6,5,9,26,22,4,23
Rostov,8934,9,5,6,9,13,19,-6,21
Amkar,8934,10,4,4,12,12,27,-15,16
Anzhi,8934,11,2,6,12,17,41,-24,12
Loko Moscow,8935,1,12,5,3,31,12,19,41
Spart Moscow,8935,2,11,5,4,38,26,12,38
CSKA Moscow,8935,3,11,4,5,28,19,9,37
Zenit,8935,4,8,9,3,24,15,9,33
Krasnodar,8935,5,8,5,7,28,27,1,29
Terek Grozny,8935,6,7,5,8,21,25,-4,26
FK Rubin,8935,7,6,6,8,23,18,5,24
Din Moscow,8935,8,5,6,9,17,23,-6,21
Amkar,8935,9,5,4,11,11,24,-13,19
Rostov,8935,10,4,6,10,10,19,-9,18
Anzhi,8935,11,3,5,12,16,39,-23,14
Loko Moscow,8936,1,12,6,2,33,13,20,42
CSKA Moscow,8936,2,11,4,5,26,17,9,37
Spart Moscow,8936,3,10,6,4,39,28,11,36
Krasnodar,8936,4,9,4,7,32,28,4,31
Zenit,8936,5,7,9,4,22,15,7,30
Terek Grozny,8936,6,8,5,7,21,23,-2,29
Din Moscow,8936,7,5,7,8,20,26,-6,22
FK Rubin,8936,8,5,6,9,23,22,1,21
Amkar,8936,9,5,5,10,11,23,-12,20
Rostov,8936,10,4,6,10,10,18,-8,18
Anzhi,8936,11,2,6,12,14,38,-24,12
Loko Moscow,8937,1,12,5,3,31,15,16,41
Spart Moscow,8937,2,11,5,4,41,28,13,38
CSKA Moscow,8937,3,11,3,6,28,18,10,36
Krasnodar,8937,4,10,4,6,31,24,7,34
Zenit,8937,5,8,8,4,23,15,8,32
Terek Grozny,8937,6,8,6,6,24,25,-1,30
Din Moscow,8937,7,5,7,8,20,25,-5,22
FK Rubin,8937,8,5,6,9,23,20,3,21
Rostov,8937,9,4,6,10,11,20,-9,18
Amkar,8937,10,4,5,11,11,26,-15,17
Anzhi,8937,11,2,5,13,16,43,-27,11
Loko Moscow,8938,1,12,5,3,31,13,18,41
CSKA Moscow,8938,2,11,4,5,29,20,9,37
Spart Moscow,8938,3,10,6,4,39,28,11,36
Krasnodar,8938,4,10,4,6,29,24,5,34
Terek Grozny,8938,5,9,5,6,23,23,0,32
Zenit,8938,6,7,9,4,24,17,7,30
Din Moscow,8938,7,5,8,7,18,22,-4,23
FK Rubin,8938,8,5,6,9,21,18,3,21
Rostov,8938,9,4,6,10,10,18,-8,18
Amkar,8938,10,4,4,12,11,27,-16,16
Anzhi,8938,11,2,5,13,16,41,-25,11
Loko Moscow,8939,1,11,6,3,29,13,16,39
CSKA Moscow,8939,2,11,3,6,29,20,9,36
Zenit,8939,3,9,8,3,26,15,11,35
Spart Moscow,8939,4,9,7,4,40,28,12,34
Krasnodar,8939,5,8,6,6,27,24,3,30
Terek Grozny,8939,6,8,5,7,22,24,-2,29
FK Rubin,8939,7,6,6,8,24,17,7,24
Din Moscow,8939,8,5,6,9,18,29,-11,21
Rostov,8939,9,4,7,9,12,19,-7,19
Amkar,8939,10,4,5,11,10,24,-14,17
Anzhi,8939,11,3,5,12,15,39,-24,14
Loko Moscow,8940,1,12,6,2,32,13,19,42
CSKA Moscow,8940,2,12,3,5,32,19,13,39
Spart Moscow,8940,3,9,6,5,35,27,8,33
Krasnodar,8940,4,9,5,6,34,28,6,32
Terek Grozny,8940,5,8,6,6,25,25,0,30
Zenit,8940,6,7,8,5,22,17,5,29
FK Rubin,8940,7,6,5,9,25,23,2,23
Din Moscow,8940,8,5,7,8,18,23,-5,22
Amkar,8940,9,5,5,10,11,23,-12,20
Rostov,8940,10,4,6,10,11,19,-8,18
Anzhi,8940,11,2,5,13,17,45,-28,11
Loko Moscow,8941,1,12,6,2,32,13,19,42
CSKA Moscow,8941,2,12,3,5,30,18,12,39
Spart Moscow,8941,3,9,5,6,34,27,7,32
Zenit,8941,4,7,9,4,22,16,6,30
Terek Grozny,8941,5,8,5,7,22,24,-2,29
Krasnodar,8941,6,8,4,8,29,29,0,28
Din Moscow,8941,7,7,6,7,22,21,1,27
FK Rubin,8941,8,6,5,9,24,22,2,23
Rostov,8941,9,5,6,9,11,17,-6,21
Amkar,8941,10,4,4,12,10,25,-15,16
Anzhi,8941,11,3,5,12,16,40,-24,14
Loko Moscow,8942,1,11,6,3,31,15,16,39
Spart Moscow,8942,2,11,5,4,43,27,16,38
Zenit,8942,3,9,8,3,24,13,11,35
CSKA Moscow,8942,4,10,4,6,27,20,7,34
Krasnodar,8942,5,8,6,6,31,28,3,30
Terek Grozny,8942,6,8,5,7,22,25,-3,29
FK Rubin,8942,7,5,7,8,23,19,4,22
Din Moscow,8942,8,5,7,8,17,24,-7,22
Amkar,8942,9,5,4,11,12,25,-13,19
Rostov,8942,10,4,6,10,11,21,-10,18
Anzhi,8942,11,2,6,12,17,41,-24,12
Loko Moscow,8943,1,12,6,2,32,13,19,42
CSKA Moscow,8943,2,11,3,6,27,19,8,36
Spart Moscow,8943,3,9,7,4,38,27,11,34
Zenit,8943,4,8,8,4,22,14,8,32
Krasnodar,8943,5,9,5,6,32,26,6,32
Terek Grozny,8943,6,8,5,7,23,29,-6,29
Din Moscow,8943,7,5,8,7,19,23,-4,23
FK Rubin,8943,8,5,6,9,23,22,1,21
Rostov,8943,9,4,7,9,12,19,-7,19
Amkar,8943,10,4,4,12,9,26,-17,16
Anzhi,8943,11,3,5,12,22,41,-19,14
Loko Moscow,8944,1,12,6,2,31,12,19,42
CSKA Moscow,8944,2,10,4,6,26,19,7,34
Spart Moscow,8944,3,9,6,5,38,28,10,33
Zenit,8944,4,8,9,3,24,15,9,33
Terek Grozny,8944,5,9,5,6,25,25,0,32
Krasnodar,8944,6,8,4,8,28,28,0,28
FK Rubin,8944,7,7,5,8,28,19,9,26
Din Moscow,8944,8,6,6,8,20,26,-6,24
Rostov,8944,9,4,6,10,10,20,-10,18
Amkar,8944,10,4,5,11,12,26,-14,17
Anzhi,8944,11,2,6,12,15,39,-24,12
Loko Moscow,8945,1,11,6,3,30,13,17,39
CSKA Moscow,8945,2,12,3,5,30,19,11,39
Spart Moscow,8945,3,9,7,4,37,28,9,34
Krasnodar,8945,4,9,5,6,28,24,4,32
Zenit,8945,5,7,9,4,24,18,6,30
Terek Grozny,8945,6,7,5,8,20,25,-5,26
Din Moscow,8945,7,6,7,7,21,23,-2,25
FK Rubin,8945,8,5,6,9,22,20,2,21
Amkar,8945,9,5,5,10,12,24,-12,20
Rostov,8945,10,4,6,10,10,18,-8,18
Anzhi,8945,11,3,5,12,16,38,-22,14
Loko Moscow,8946,1,12,5,3,32,15,17,41
CSKA Moscow,8946,2,11,3,6,30,21,9,36
Spart Moscow,8946,3,10,5,5,39,26,13,35
Zenit,8946,4,8,8,4,23,14,9,32
Krasnodar,8946,5,9,5,6,31,26,5,32
Terek Grozny,8946,6,8,6,6,26,25,1,30
FK Rubin,8946,7,5,7,8,22,18,4,22
Din Moscow,8946,8,5,7,8,18,27,-9,22
Amkar,8946,9,5,5,10,12,24,-12,20
Rostov,8946,10,4,6,10,10,18,-8,18
Anzhi,8946,11,2,5,13,17,46,-29,11
Loko Moscow,8947,1,13,5,2,35,11,24,44
CSKA Moscow,8947,2,11,3,6,27,19,8,36
Spart Moscow,8947,3,9,6,5,35,28,7,33
Zenit,8947,4,8,8,4,22,15,7,32
Krasnodar,8947,5,9,4,7,29,29,0,31
Terek Grozny,8947,6,7,6,7,20,25,-5,27
Din Moscow,8947,7,6,6,8,21,24,-3,24
FK Rubin,8947,8,6,5,9,24,20,4,23
Amkar,8947,9,5,5,10,12,22,-10,20
Rostov,8947,10,4,6,10,10,18,-8,18
Anzhi,8947,11,2,6,12,15,39,-24,12
Loko Moscow,8948,1,11,6,3,33,16,17,39
CSKA Moscow,8948,2,11,4,5,29,20,9,37
Spart Moscow,8948,3,9,6,5,35,28,7,33
Krasnodar,8948,4,9,4,7,29,27,2,31
Zenit,8948,5,7,9,4,25,18,7,30
Terek Grozny,8948,6,8,6,6,24,25,-1,30
Din Moscow,8948,7,6,7,7,20,23,-3,25
FK Rubin,8948,8,6,5,9,24,19,5,23
Rostov,8948,9,5,6,9,12,17,-5,21
Amkar,8948,10,4,4,12,11,26,-15,16
Anzhi,8948,11,2,7,11,17,40,-23,13
Loko Moscow,8949,1,12,6,2,30,11,19,42
CSKA Moscow,8949,2,11,3,6,27,19,8,36
Zenit,8949,3,8,9,3,22,13,9,33
Terek Grozny,8949,4,8,6,6,23,24,-1,30
Spart Moscow,8949,5,8,5,7,35,30,5,29
Krasnodar,8949,6,8,4,8,27,29,-2,28
Din Moscow,8949,7,6,7,7,19,22,-3,25
FK Rubin,8949,8,6,6,8,26,18,8,24
Rostov,8949,9,5,6,9,12,18,-6,21
Amkar,8949,10,5,5,10,12,24,-12,20
Anzhi,8949,11,2,5,13,16,41,-25,11
Loko Moscow,8950,1,12,6,2,34,13,21,42
CSKA Moscow,8950,2,11,3,6,28,20,8,36
Spart Moscow,8950,3,9,7,4,39,30,9,34
Zenit,8950,4,8,8,4,23,17,6,32
Krasnodar,8950,5,9,5,6,32,27,5,32
Terek Grozny,8950,6,9,5,6,24,24,0,32
Din Moscow,8950,7,5,8,7,20,24,-4,23
FK Rubin,8950,8,5,6,9,23,21,2,21
Rostov,8950,9,4,6,10,10,18,-8,18
Amkar,8950,10,4,5,11,13,27,-14,17
Anzhi,8950,11,2,5,13,16,41,-25,11
Loko Moscow,8951,1,11,6,3,30,14,16,39
CSKA Moscow,8951,2,12,3,5,29,18,11,39
Spart Moscow,8951,3,10,6,4,39,27,12,36
Zenit,8951,4,8,8,4,23,14,9,32
Terek Grozny,8951,5,8,6,6,23,24,-1,30
Krasnodar,8951,6,8,5,7,29,27,2,29
Din Moscow,8951,7,6,6,8,19,23,-4,24
FK Rubin,8951,8,6,5,9,23,20,3,23
Rostov,8951,9,4,6,10,10,19,-9,18
Amkar,8951,10,4,5,11,12,26,-14,17
Anzhi,8951,11,2,6,12,16,41,-25,12
Loko Moscow,8952,1,12,6,2,32,12,20,42
Spart Moscow,8952,2,10,6,4,40,30,10,36
CSKA Moscow,8952,3,10,5,5,30,22,8,35
Zenit,8952,4,7,10,3,25,17,8,31
Terek Grozny,8952,5,8,5,7,24,25,-1,29
Krasnodar,8952,6,8,4,8,28,28,0,28
FK Rubin,8952,7,6,6,8,23,18,5,24
Din Moscow,8952,8,5,8,7,19,23,-4,23
Rostov,8952,9,4,6,10,10,18,-8,18
Amkar,8952,10,4,4,12,12,28,-16,16
Anzhi,8952,11,3,6,11,19,41,-22,15
Loko Moscow,8953,1,12,5,3,32,13,19,41
Spart Moscow,8953,2,11,5,4,39,26,13,38
CSKA Moscow,8953,3,11,3,6,27,20,7,36
Krasnodar,8953,4,10,4,6,31,25,6,34
Zenit,8953,5,8,8,4,23,15,8,32
Terek Grozny,8953,6,7,5,8,21,26,-5,26
Din Moscow,8953,7,5,7,8,18,23,-5,22
FK Rubin,8953,8,5,6,9,21,19,2,21
Amkar,8953,9,5,4,11,11,24,-13,19
Rostov,8953,10,4,6,10,10,19,-9,18
Anzhi,8953,11,3,5,12,17,40,-23,14
Loko Moscow,8954,1,11,7,2,30,12,18,40
CSKA Moscow,8954,2,11,4,5,29,18,11,37
Spart Moscow,8954,3,9,6,5,36,28,8,33
Krasnodar,8954,4,9,5,6,30,26,4,32
Zenit,8954,5,7,10,3,21,13,8,31
Terek Grozny,8954,6,8,5,7,23,25,-2,29
Din Moscow,8954,7,6,7,7,20,23,-3,25
Amkar,8954,8,6,4,10,13,24,-11,22
FK Rubin,8954,9,5,5,10,23,21,2,20
Rostov,8954,10,4,6,10,10,18,-8,18
Anzhi,8954,11,2,5,13,16,43,-27,11
Loko Moscow,8955,1,11,5,4,30,17,13,38
Zenit,8955,2,9,8,3,26,13,13,35
Krasnodar,8955,3,10,4,6,33,25,8,34
CSKA Moscow,8955,4,10,4,6,25,21,4,34
Spart Moscow,8955,5,9,5,6,34,28,6,32
Terek Grozny,8955,6,7,6,7,21,24,-3,27
Din Moscow,8955,7,6,6,8,18,22,-4,24
FK Rubin,8955,8,6,5,9,22,18,4,23
Amkar,8955,9,5,5,10,12,23,-11,20
Rostov,8955,10,4,6,10,10,18,-8,18
Anzhi,8955,11,3,6,11,15,37,-22,15
Loko Moscow,8956,1,12,5,3,31,13,18,41
CSKA Moscow,8956,2,11,3,6,26,18,8,36
Spart Moscow,8956,3,9,7,4,36,26,10,34
Krasnodar,8956,4,10,4,6,30,25,5,34
Zenit,8956,5,8,8,4,22,14,8,32
Terek Grozny,8956,6,8,6,6,24,24,0,30
Din Moscow,8956,7,5,8,7,19,23,-4,23
FK Rubin,8956,8,5,6,9,22,19,3,21
Rostov,8956,9,4,7,9,10,17,-7,19
Amkar,8956,10,4,5,11,10,25,-15,17
Anzhi,8956,11,2,5,13,15,41,-26,11
Loko Moscow,8957,1,11,6,3,31,17,14,39
Spart Moscow,8957,2,9,7,4,38,29,9,34
CSKA Moscow,8957,3,10,4,6,26,21,5,34
Zenit,8957,4,8,9,3,25,14,11,33
Krasnodar,8957,5,9,4,7,33,29,4,31
Terek Grozny,8957,6,8,6,6,22,22,0,30
Din Moscow,8957,7,6,7,7,20,22,-2,25
FK Rubin,8957,8,6,5,9,25,20,5,23
Rostov,8957,9,4,6,10,11,19,-8,18
Amkar,8957,10,4,5,11,11,26,-15,17
Anzhi,8957,11,2,7,11,15,38,-23,13
CSKA Moscow,8958,1,12,3,5,30,18,12,39
Loko Moscow,8958,2,11,5,4,30,14,16,38
Spart Moscow,8958,3,9,6,5,36,28,8,33
Zenit,8958,4,8,8,4,24,16,8,32
Krasnodar,8958,5,9,5,6,29,25,4,32
Terek Grozny,8958,6,7,6,7,22,27,-5,27
Din Moscow,8958,7,6,7,7,20,22,-2,25
FK Rubin,8958,8,5,7,8,23,19,4,22
Rostov,8958,9,4,7,9,11,18,-7,19
Amkar,8958,10,4,5,11,11,26,-15,17
Anzhi,8958,11,3,5,12,17,40,-23,14
Loko Moscow,8959,1,11,7,2,32,14,18,40
CSKA Moscow,8959,2,11,4,5,27,18,9,37
Spart Moscow,8959,3,9,6,5,35,26,9,33
Krasnodar,8959,4,9,5,6,31,26,5,32
Zenit,8959,5,7,9,4,22,15,7,30
Terek Grozny,8959,6,8,6,6,24,24,0,30
Din Moscow,8959,7,6,7,7,18,21,-3,25
FK Rubin,8959,8,5,5,10,21,20,1,20
Amkar,8959,9,5,5,10,12,24,-12,20
Rostov,8959,10,4,6,10,10,19,-9,18
Anzhi,8959,11,2,6,12,15,40,-25,12
Loko Moscow,8960,1,11,6,3,30,13,17,39
CSKA Moscow,8960,2,11,4,5,27,18,9,37
Spart Moscow,8960,3,10,6,4,40,27,13,36
Zenit,8960,4,8,8,4,23,15,8,32
Krasnodar,8960,5,8,6,6,29,26,3,30
Terek Grozny,8960,6,8,6,6,23,24,-1,30
Din Moscow,8960,7,6,6,8,20,25,-5,24
FK Rubin,8960,8,5,6,9,23,21,2,21
Rostov,8960,9,4,6,10,10,19,-9,18
Amkar,8960,10,4,6,10,11,24,-13,18
Anzhi,8960,11,2,6,12,16,40,-24,12
Loko Moscow,8961,1,12,5,3,31,15,16,41
CSKA Moscow,8961,2,11,4,5,31,21,10,37
Spart Moscow,8961,3,9,7,4,38,27,11,34
Terek Grozny,8961,4,9,5,6,25,25,0,32
Krasnodar,8961,5,9,4,7,32,28,4,31
Zenit,8961,6,7,9,4,24,17,7,30
Din Moscow,8961,7,6,7,7,22,22,0,25
FK Rubin,8961,8,6,5,9,24,22,2,23
Rostov,8961,9,4,6,10,10,20,-10,18
Amkar,8961,10,4,5,11,11,25,-14,17
Anzhi,8961,11,2,5,13,17,43,-26,11
Loko Moscow,8962,1,11,6,3,31,14,17,39
CSKA Moscow,8962,2,11,4,5,30,20,10,37
Zenit,8962,3,8,9,3,23,14,9,33
Spart Moscow,8962,4,9,6,5,38,30,8,33
Krasnodar,8962,5,8,6,6,29,26,3,30
Terek Grozny,8962,6,7,6,7,20,23,-3,27
Din Moscow,8962,7,6,6,8,19,25,-6,24
Amkar,8962,8,6,4,10,13,22,-9,22
FK Rubin,8962,9,5,6,9,22,19,3,21
Rostov,8962,10,4,7,9,12,19,-7,19
Anzhi,8962,11,2,6,12,16,41,-25,12
Loko Moscow,8963,1,11,6,3,32,16,16,39
Zenit,8963,2,9,8,3,26,15,11,35
Spart Moscow,8963,3,9,6,5,36,27,9,33
CSKA Moscow,8963,4,10,3,7,26,20,6,33
Krasnodar,8963,5,9,5,6,32,27,5,32
Terek Grozny,8963,6,7,7,6,23,25,-2,28
Din Moscow,8963,7,6,7,7,19,21,-2,25
FK Rubin,8963,8,5,5,10,22,22,0,20
Amkar,8963,9,5,5,10,13,25,-12,20
Rostov,8963,10,4,6,10,10,19,-9,18
Anzhi,8963,11,3,6,11,16,38,-22,15
Loko Moscow,8964,1,12,5,3,33,13,20,41
Spart Moscow,8964,2,10,5,5,36,27,9,35
CSKA Moscow,8964,3,10,4,6,27,20,7,34
Zenit,8964,4,8,8,4,22,17,5,32
Krasnodar,8964,5,9,4,7,30,26,4,31
Terek Grozny,8964,6,8,6,6,22,23,-1,30
Din Moscow,8964,7,6,7,7,22,25,-3,25
FK Rubin,8964,8,6,6,8,26,21,5,24
Rostov,8964,9,4,6,10,10,18,-8,18
Amkar,8964,10,4,4,12,10,25,-15,16
Anzhi,8964,11,2,7,11,16,39,-23,13
Loko Moscow,8965,1,11,5,4,31,15,16,38
CSKA Moscow,8965,2,11,3,6,27,19,8,36
Spart Moscow,8965,3,10,5,5,38,28,10,35
Zenit,8965,4,9,8,3,24,14,10,35
Krasnodar,8965,5,10,4,6,33,27,6,34
Terek Grozny,8965,6,7,6,7,20,25,-5,27
Din Moscow,8965,7,6,6,8,20,24,-4,24
FK Rubin,8965,8,6,5,9,25,21,4,23
Amkar,8965,9,5,4,11,12,23,-11,19
Rostov,8965,10,4,6,10,10,20,-10,18
Anzhi,8965,11,2,6,12,15,39,-24,12
Loko Moscow,8966,1,11,5,4,29,13,16,38
CSKA Moscow,8966,2,11,4,5,28,18,10,37
Krasnodar,8966,3,10,4,6,30,24,6,34
Spart Moscow,8966,4,9,6,5,38,29,9,33
Zenit,8966,5,8,9,3,23,14,9,33
Terek Grozny,8966,6,9,5,6,22,22,0,32
FK Rubin,8966,7,6,5,9,23,20,3,23
Rostov,8966,8,5,6,9,13,19,-6,21
Din Moscow,8966,9,5,6,9,19,26,-7,21
Amkar,8966,10,4,5,11,9,23,-14,17
Anzhi,8966,11,2,5,13,14,40,-26,11
Loko Moscow,8967,1,12,5,3,32,14,18,41
CSKA Moscow,8967,2,11,3,6,29,19,10,36
Spart Moscow,8967,3,9,6,5,36,28,8,33
Zenit,8967,4,8,8,4,24,18,6,32
Terek Grozny,8967,5,8,6,6,25,26,-1,30
Krasnodar,8967,6,8,5,7,28,26,2,29
FK Rubin,8967,7,6,6,8,23,18,5,24
Din Moscow,8967,8,5,6,9,17,23,-6,21
Rostov,8967,9,4,7,9,10,17,-7,19
Amkar,8967,10,5,4,11,14,27,-13,19
Anzhi,8967,11,3,6,11,18,40,-22,15
Loko Moscow,8968,1,11,6,3,30,13,17,39
CSKA Moscow,8968,2,11,3,6,31,22,9,36
Zenit,8968,3,9,8,3,27,16,11,35
Spart Moscow,8968,4,9,5,6,37,31,6,32
Krasnodar,8968,5,8,6,6,28,25,3,30
Terek Grozny,8968,6,8,5,7,23,23,0,29
Din Moscow,8968,7,6,6,8,22,25,-3,24
Amkar,8968,8,6,4,10,11,22,-11,22
FK Rubin,8968,9,5,6,9,23,21,2,21
Rostov,8968,10,5,6,9,13,18,-5,21
Anzhi,8968,11,2,5,13,15,44,-29,11
CSKA Moscow,8969,1,12,3,5,27,17,10,39
Loko Moscow,8969,2,11,5,4,31,16,15,38
Spart Moscow,8969,3,10,6,4,37,25,12,36
Krasnodar,8969,4,10,4,6,33,27,6,34
Zenit,8969,5,8,8,4,22,14,8,32
Terek Grozny,8969,6,8,5,7,21,23,-2,29
Din Moscow,8969,7,6,7,7,19,22,-3,25
FK Rubin,8969,8,5,5,10,23,21,2,20
Amkar,8969,9,5,4,11,10,25,-15,19
Rostov,8969,10,4,6,10,10,18,-8,18
Anzhi,8969,11,2,5,13,14,39,-25,11
Loko Moscow,8970,1,12,6,2,31,12,19,42
CSKA Moscow,8970,2,11,4,5,29,19,10,37
Zenit,8970,3,7,10,3,23,15,8,31
Spart Moscow,8970,4,8,6,6,38,32,6,30
Krasnodar,8970,5,8,5,7,28,26,2,29
Terek Grozny,8970,6,7,5,8,22,27,-5,26
Din Moscow,8970,7,5,8,7,21,25,-4,23
FK Rubin,8970,8,5,7,8,21,17,4,22
Amkar,8970,9,6,4,10,12,23,-11,22
Rostov,8970,10,5,6,9,12,18,-6,21
Anzhi,8970,11,3,5,12,17,40,-23,14
Loko Moscow,8971,1,13,5,2,34,12,22,44
CSKA Moscow,8971,2,10,4,6,26,19,7,34
Spart Moscow,8971,3,8,8,4,37,29,8,32
Zenit,8971,4,8,8,4,23,16,7,32
Krasnodar,8971,5,8,4,8,27,27,0,28
Terek Grozny,8971,6,7,6,7,24,28,-4,27
Din Moscow,8971,7,6,7,7,21,22,-1,25
FK Rubin,8971,8,6,5,9,22,20,2,23
Amkar,8971,9,5,5,10,14,25,-11,20
Rostov,8971,10,4,7,9,12,19,-7,19
Anzhi,8971,11,2,7,11,17,40,-23,13
Loko Moscow,8972,1,12,5,3,33,14,19,41
CSKA Moscow,8972,2,11,4,5,28,19,9,37
Zenit,8972,3,8,9,3,22,13,9,33
Spart Moscow,8972,4,9,6,5,38,31,7,33
Krasnodar,8972,5,8,4,8,30,30,0,28
Terek Grozny,8972,6,7,7,6,23,25,-2,28
Din Moscow,8972,7,6,7,7,20,21,-1,25
FK Rubin,8972,8,6,6,8,23,18,5,24
Rostov,8972,9,4,6,10,12,21,-9,18
Amkar,8972,10,4,6,10,10,23,-13,18
Anzhi,8972,11,2,6,12,19,43,-24,12
Loko Moscow,8973,1,11,7,2,30,12,18,40
CSKA Moscow,8973,2,12,3,5,32,20,12,39
Spart Moscow,8973,3,10,5,5,40,30,10,35
Zenit,8973,4,7,9,4,24,17,7,30
Krasnodar,8973,5,8,6,6,28,25,3,30
Terek Grozny,8973,6,8,5,7,23,25,-2,29
Din Moscow,8973,7,6,7,7,21,24,-3,25
FK Rubin,8973,8,5,7,8,23,19,4,22
Rostov,8973,9,4,6,10,10,19,-9,18
Amkar,8973,10,4,4,12,12,27,-15,16
Anzhi,8973,11,3,5,12,17,42,-25,14
Loko Moscow,8974,1,11,6,3,29,12,17,39
CSKA Moscow,8974,2,11,3,6,27,19,8,36
Spart Moscow,8974,3,9,7,4,36,26,10,34
Zenit,8974,4,8,8,4,22,14,8,32
Krasnodar,8974,5,8,6,6,28,25,3,30
Terek Grozny,8974,6,7,5,8,22,27,-5,26
FK Rubin,8974,7,5,7,8,23,19,4,22
Din Moscow,8974,8,5,7,8,18,24,-6,22
Amkar,8974,9,5,5,10,12,24,-12,20
Rostov,8974,10,4,7,9,11,18,-7,19
Anzhi,8974,11,4,5,11,18,38,-20,17
Loko Moscow,8975,1,11,5,4,30,14,16,38
CSKA Moscow,8975,2,11,3,6,27,20,7,36
Zenit,8975,3,9,8,3,25,14,11,35
Spart Moscow,8975,4,10,5,5,36,27,9,35
Krasnodar,8975,5,9,4,7,28,25,3,31
Terek Grozny,8975,6,8,5,7,22,23,-1,29
FK Rubin,8975,7,6,6,8,23,18,5,24
Din Moscow,8975,8,5,7,8,18,23,-5,22
Amkar,8975,9,6,4,10,12,23,-11,22
Rostov,8975,10,4,6,10,10,18,-8,18
Anzhi,8975,11,2,5,13,15,41,-26,11
CSKA Moscow,8976,1,12,3,5,33,19,14,39
Spart Moscow,8976,2,11,5,4,39,26,13,38
Loko Moscow,8976,3,11,5,4,30,19,11,38
Krasnodar,8976,4,10,4,6,32,24,8,34
Zenit,8976,5,8,8,4,26,17,9,32
Terek Grozny,8976,6,7,5,8,21,28,-7,26
Din Moscow,8976,7,5,7,8,19,25,-6,22
FK Rubin,8976,8,5,6,9,23,20,3,21
Amkar,8976,9,5,4,11,13,25,-12,19
Rostov,8976,10,4,6,10,10,18,-8,18
Anzhi,8976,11,3,5,12,18,43,-25,14
Loko Moscow,8977,1,12,5,3,31,13,18,41
CSKA Moscow,8977,2,12,3,5,32,18,14,39
Spart Moscow,8977,3,10,6,4,38,26,12,36
Krasnodar,8977,4,10,4,6,32,26,6,34
Zenit,8977,5,7,8,5,22,17,5,29
Terek Grozny,8977,6,7,7,6,21,23,-2,28
Din Moscow,8977,7,6,6,8,19,25,-6,24
FK Rubin,8977,8,5,5,10,23,22,1,20
Rostov,8977,9,4,6,10,10,18,-8,18
Amkar,8977,10,4,6,10,11,24,-13,18
Anzhi,8977,11,2,6,12,14,41,-27,12
Loko Moscow,8978,1,12,6,2,31,12,19,42
CSKA Moscow,8978,2,11,4,5,30,19,11,37
Spart Moscow,8978,3,10,5,5,37,27,10,35
Zenit,8978,4,7,10,3,24,16,8,31
Krasnodar,8978,5,8,4,8,27,27,0,28
Terek Grozny,8978,6,7,7,6,22,24,-2,28
FK Rubin,8978,7,7,5,8,25,18,7,26
Din Moscow,8978,8,5,6,9,19,26,-7,21
Amkar,8978,9,5,5,10,12,24,-12,20
Rostov,8978,10,4,6,10,10,18,-8,18
Anzhi,8978,11,2,6,12,14,40,-26,12
Loko Moscow,8979,1,12,5,3,32,14,18,41
Zenit,8979,2,9,8,3,25,14,11,35
Spart Moscow,8979,3,10,5,5,39,31,8,35
CSKA Moscow,8979,4,10,3,7,25,19,6,33
Krasnodar,8979,5,9,4,7,30,26,4,31
Terek Grozny,8979,6,8,5,7,24,25,-1,29
Din Moscow,8979,7,6,6,8,21,24,-3,24
FK Rubin,8979,8,6,5,9,23,20,3,23
Rostov,8979,9,4,6,10,10,18,-8,18
Anzhi,8979,10,4,5,11,18,39,-21,17
Amkar,8979,11,4,4,12,11,28,-17,16
Spart Moscow,8980,1,11,5,4,41,26,15,38
Loko Moscow,8980,2,11,5,4,31,16,15,38
CSKA Moscow,8980,3,11,4,5,28,17,11,37
Zenit,8980,4,8,9,3,22,13,9,33
Krasnodar,8980,5,9,4,7,31,29,2,31
Terek Grozny,8980,6,8,5,7,22,24,-2,29
FK Rubin,8980,7,6,6,8,25,18,7,24
Din Moscow,8980,8,5,7,8,18,24,-6,22
Rostov,8980,9,4,6,10,10,20,-10,18
Amkar,8980,10,4,4,12,11,27,-16,16
Anzhi,8980,11,3,5,12,15,40,-25,14
Loko Moscow,8981,1,12,5,3,33,14,19,41
CSKA Moscow,8981,2,11,3,6,27,20,7,36
Zenit,8981,3,9,8,3,25,13,12,35
Spart Moscow,8981,4,9,6,5,37,29,8,33
Krasnodar,8981,5,8,5,7,30,29,1,29
Terek Grozny,8981,6,7,6,7,21,26,-5,27
Din Moscow,8981,7,6,6,8,19,23,-4,24
FK Rubin,8981,8,5,6,9,22,19,3,21
Rostov,8981,9,5,6,9,12,18,-6,21
Amkar,8981,10,4,6,10,11,24,-13,18
Anzhi,8981,11,3,5,12,17,39,-22,14
Loko Moscow,8982,1,12,5,3,30,12,18,41
Spart Moscow,8982,2,11,5,4,36,25,11,38
CSKA Moscow,8982,3,11,4,5,27,17,10,37
Zenit,8982,4,8,9,3,22,13,9,33
Krasnodar,8982,5,8,5,7,28,26,2,29
Terek Grozny,8982,6,7,5,8,21,26,-5,26
Din Moscow,8982,7,6,6,8,20,23,-3,24
FK Rubin,8982,8,5,6,9,23,21,2,21
Amkar,8982,9,5,4,11,12,24,-12,19
Rostov,8982,10,4,6,10,10,18,-8,18
Anzhi,8982,11,3,5,12,15,39,-24,14
Loko Moscow,8983,1,13,5,2,32,11,21,44
CSKA Moscow,8983,2,11,3,6,27,19,8,36
Zenit,8983,3,8,8,4,23,15,8,32
Spart Moscow,8983,4,8,7,5,36,29,7,31
Krasnodar,8983,5,9,4,7,29,26,3,31
Terek Grozny,8983,6,8,6,6,21,22,-1,30
Din Moscow,8983,7,5,8,7,19,23,-4,23
FK Rubin,8983,8,5,6,9,24,21,3,21
Rostov,8983,9,4,7,9,11,18,-7,19
Amkar,8983,10,5,4,11,12,25,-13,19
Anzhi,8983,11,2,6,12,14,39,-25,12
Loko Moscow,8984,1,12,5,3,32,13,19,41
CSKA Moscow,8984,2,11,4,5,28,19,9,37
Krasnodar,8984,3,10,4,6,32,25,7,34
Spart Moscow,8984,4,8,7,5,33,26,7,31
Zenit,8984,5,7,9,4,23,17,6,30
Terek Grozny,8984,6,7,7,6,23,25,-2,28
Din Moscow,8984,7,6,7,7,19,22,-3,25
Rostov,8984,8,5,6,9,11,17,-6,21
FK Rubin,8984,9,5,5,10,22,22,0,20
Amkar,8984,10,4,6,10,10,23,-13,18
Anzhi,8984,11,2,6,12,16,40,-24,12
Loko Moscow,8985,1,12,5,3,32,17,15,41
CSKA Moscow,8985,2,11,3,6,27,20,7,36
Spart Moscow,8985,3,9,7,4,40,31,9,34
Zenit,8985,4,8,8,4,25,16,9,32
Krasnodar,8985,5,9,4,7,32,27,5,31
Terek Grozny,8985,6,8,5,7,22,25,-3,29
Din Moscow,8985,7,6,7,7,21,23,-2,25
FK Rubin,8985,8,6,5,9,24,20,4,23
Rostov,8985,9,4,7,9,13,20,-7,19
Amkar,8985,10,5,4,11,14,25,-11,19
Anzhi,8985,11,2,5,13,14,40,-26,11
Loko Moscow,8986,1,11,6,3,29,13,16,39
CSKA Moscow,8986,2,11,3,6,31,20,11,36
Spart Moscow,8986,3,10,6,4,37,27,10,36
Krasnodar,8986,4,10,4,6,31,25,6,34
Zenit,8986,5,8,9,3,24,15,9,33
Terek Grozny,8986,6,7,5,8,21,27,-6,26
Din Moscow,8986,7,6,6,8,22,24,-2,24
FK Rubin,8986,8,5,5,10,22,22,0,20
Rostov,8986,9,4,7,9,10,17,-7,19
Amkar,8986,10,5,4,11,11,24,-13,19
Anzhi,8986,11,3,5,12,17,41,-24,14
Loko Moscow,8987,1,12,5,3,30,12,18,41
Zenit,8987,2,9,8,3,27,13,14,35
CSKA Moscow,8987,3,10,4,6,25,22,3,34
Spart Moscow,8987,4,8,8,4,36,28,8,32
Krasnodar,8987,5,9,4,7,28,25,3,31
Terek Grozny,8987,6,8,5,7,22,24,-2,29
Din Moscow,8987,7,5,8,7,17,21,-4,23
FK Rubin,8987,8,5,6,9,21,18,3,21
Amkar,8987,9,5,5,10,13,25,-12,20
Rostov,8987,10,4,7,9,11,18,-7,19
Anzhi,8987,11,2,6,12,14,38,-24,12
Loko Moscow,8988,1,13,5,2,34,12,22,44
CSKA Moscow,8988,2,11,3,6,26,18,8,36
Spart Moscow,8988,3,9,5,6,39,30,9,32
Krasnodar,8988,4,9,4,7,29,28,1,31
Zenit,8988,5,7,8,5,21,15,6,29
Terek Grozny,8988,6,8,5,7,24,27,-3,29
Din Moscow,8988,7,6,7,7,20,23,-3,25
FK Rubin,8988,8,5,6,9,23,20,3,21
Amkar,8988,9,5,4,11,14,25,-11,19
Rostov,8988,10,4,6,10,10,22,-12,18
Anzhi,8988,11,4,5,11,19,39,-20,17
Loko Moscow,8989,1,13,5,2,35,13,22,44
Spart Moscow,8989,2,11,5,4,37,25,12,38
CSKA Moscow,8989,3,10,5,5,28,20,8,35
Zenit,8989,4,7,9,4,23,18,5,30
Terek Grozny,8989,5,8,5,7,23,24,-1,29
Krasnodar,8989,6,8,4,8,28,28,0,28
Din Moscow,8989,7,6,6,8,19,24,-5,24
FK Rubin,8989,8,6,5,9,24,19,5,23
Amkar,8989,9,5,4,11,10,23,-13,19
Rostov,8989,10,4,6,10,10,18,-8,18
Anzhi,8989,11,2,6,12,17,42,-25,12
Loko Moscow,8990,1,11,6,3,30,13,17,39
Krasnodar,8990,2,10,4,6,33,25,8,34
Spart Moscow,8990,3,9,6,5,37,28,9,33
Zenit,8990,4,8,9,3,23,14,9,33
CSKA Moscow,8990,5,10,3,7,27,22,5,33
Terek Grozny,8990,6,9,5,6,23,22,1,32
FK Rubin,8990,7,6,5,9,23,21,2,23
Din Moscow,8990,8,5,7,8,18,24,-6,22
Amkar,8990,9,5,4,11,11,24,-13,19
Rostov,8990,10,4,6,10,10,19,-9,18
Anzhi,8990,11,3,5,12,17,40,-23,14
Loko Moscow,8991,1,11,6,3,31,14,17,39
CSKA Moscow,8991,2,12,3,5,32,18,14,39
Spart Moscow,8991,3,10,6,4,37,27,10,36
Zenit,8991,4,8,8,4,23,17,6,32
Krasnodar,8991,5,9,5,6,31,27,4,32
Terek Grozny,8991,6,7,6,7,21,24,-3,27
Din Moscow,8991,7,6,6,8,20,23,-3,24
FK Rubin,8991,8,5,5,10,23,22,1,20
Rostov,8991,9,4,7,9,11,18,-7,19
Amkar,8991,10,4,5,11,10,24,-14,17
Anzhi,8991,11,3,5,12,16,41,-25,14
Loko Moscow,8992,1,12,6,2,32,13,19,42
CSKA Moscow,8992,2,11,3,6,28,20,8,36
Spart Moscow,8992,3,10,5,5,43,28,15,35
Zenit,8992,4,8,9,3,25,14,11,33
Krasnodar,8992,5,9,4,7,30,27,3,31
Terek Grozny,8992,6,8,6,6,22,22,0,30
Din Moscow,8992,7,6,6,8,20,27,-7,24
FK Rubin,8992,8,5,5,10,23,22,1,20
Amkar,8992,9,5,4,11,12,25,-13,19
Rostov,8992,10,4,6,10,10,21,-11,18
Anzhi,8992,11,2,6,12,14,40,-26,12
Loko Moscow,8993,1,12,5,3,31,15,16,41
CSKA Moscow,8993,2,10,4,6,26,20,6,34
Spart Moscow,8993,3,9,5,6,35,28,7,32
Krasnodar,8993,4,9,4,7,31,26,5,31
Zenit,8993,5,7,9,4,23,16,7,30
Terek Grozny,8993,6,8,5,7,21,23,-2,29
FK Rubin,8993,7,6,6,8,24,19,5,24
Din Moscow,8993,8,5,7,8,18,24,-6,22
Rostov,8993,9,5,6,9,12,17,-5,21
Amkar,8993,10,5,4,11,10,23,-13,19
Anzhi,8993,11,4,5,11,17,37,-20,17
Loko Moscow,8994,1,12,5,3,31,13,18,41
CSKA Moscow,8994,2,12,3,5,30,18,12,39
Spart Moscow,8994,3,11,5,4,38,27,11,38
Krasnodar,8994,4,10,4,6,30,25,5,34
Zenit,8994,5,7,8,5,21,16,5,29
Terek Grozny,8994,6,7,5,8,21,25,-4,26
Din Moscow,8994,7,5,7,8,20,25,-5,22
FK Rubin,8994,8,5,6,9,23,20,3,21
Amkar,8994,9,5,4,11,11,24,-13,19
Rostov,8994,10,4,6,10,10,18,-8,18
Anzhi,8994,11,3,5,12,17,41,-24,14
Loko Moscow,8995,1,12,6,2,32,13,19,42
CSKA Moscow,8995,2,11,3,6,29,19,10,36
Spart Moscow,8995,3,10,5,5,35,27,8,35
Zenit,8995,4,8,8,4,24,16,8,32
Krasnodar,8995,5,8,6,6,29,26,3,30
Terek Grozny,8995,6,8,6,6,21,22,-1,30
Din Moscow,8995,7,6,7,7,20,22,-2,25
FK Rubin,8995,8,5,7,8,23,19,4,22
Rostov,8995,9,4,6,10,10,18,-8,18
Amkar,8995,10,4,5,11,9,23,-14,17
Anzhi,8995,11,2,5,13,14,41,-27,11
Loko Moscow,8996,1,11,7,2,29,11,18,40
CSKA Moscow,8996,2,12,3,5,29,18,11,39
Krasnodar,8996,3,9,5,6,28,24,4,32
Terek Grozny,8996,4,9,5,6,26,24,2,32
Zenit,8996,5,7,9,4,21,14,7,30
Spart Moscow,8996,6,8,5,7,34,35,-1,29
Din Moscow,8996,7,6,7,7,21,22,-1,25
FK Rubin,8996,8,5,6,9,22,19,3,21
Rostov,8996,9,5,6,9,13,18,-5,21
Amkar,8996,10,5,4,11,14,25,-11,19
Anzhi,8996,11,2,5,13,16,43,-27,11
Loko Moscow,8997,1,13,5,2,33,11,22,44
CSKA Moscow,8997,2,12,3,5,29,18,11,39
Spart Moscow,8997,3,9,6,5,41,32,9,33
Zenit,8997,4,7,8,5,22,17,5,29
Terek Grozny,8997,5,8,5,7,22,23,-1,29
Krasnodar,8997,6,8,4,8,27,28,-1,28
FK Rubin,8997,7,6,6,8,23,18,5,24
Din Moscow,8997,8,5,7,8,20,26,-6,22
Rostov,8997,9,4,7,9,12,19,-7,19
Amkar,8997,10,5,4,11,12,26,-14,19
Anzhi,8997,11,3,5,12,15,38,-23,14
Loko Moscow,8998,1,11,7,2,30,12,18,40
Spart Moscow,8998,2,10,6,4,38,26,12,36
CSKA Moscow,8998,3,11,3,6,27,19,8,36
Zenit,8998,4,8,9,3,23,14,9,33
Terek Grozny,8998,5,9,5,6,23,23,0,32
Krasnodar,8998,6,8,5,7,28,30,-2,29
FK Rubin,8998,7,7,5,8,28,18,10,26
Din Moscow,8998,8,5,6,9,18,25,-7,21
Rostov,8998,9,4,6,10,10,19,-9,18
Amkar,8998,10,4,5,11,10,24,-14,17
Anzhi,8998,11,2,5,13,15,40,-25,11
Loko Moscow,8999,1,13,5,2,32,11,21,44
Spart Moscow,8999,2,10,5,5,38,28,10,35
CSKA Moscow,8999,3,10,4,6,26,19,7,34
Zenit,8999,4,7,9,4,21,15,6,30
Krasnodar,8999,5,8,4,8,27,27,0,28
Din Moscow,8999,6,7,6,7,20,21,-1,27
Terek Grozny,8999,7,7,5,8,20,25,-5,26
FK Rubin,8999,8,6,5,9,23,19,4,23
Amkar,8999,9,5,4,11,13,25,-12,19
Rostov,8999,10,4,6,10,10,19,-9,18
Anzhi,8999,11,4,5,11,17,38,-21,17
Loko Moscow,9000,1,11,6,3,31,15,16,39
CSKA Moscow,9000,2,11,4,5,30,20,10,37
Spart Moscow,9000,3,9,5,6,38,30,8,32
Terek Grozny,9000,4,9,5,6,24,24,0,32
Zenit,9000,5,7,10,3,24,16,8,31
Krasnodar,9000,6,9,4,7,30,26,4,31
Din Moscow,9000,7,6,6,8,19,25,-6,24
FK Rubin,9000,8,6,5,9,22,18,4,23
Rostov,9000,9,5,6,9,12,18,-6,21
Amkar,9000,10,5,4,11,12,24,-12,19
Anzhi,9000,11,2,5,13,16,42,-26,11
Loko Moscow,9001,1,11,6,3,31,14,17,39
CSKA Moscow,9001,2,11,4,5,29,20,9,37
Spart Moscow,9001,3,10,5,5,38,29,9,35
Krasnodar,9001,4,9,5,6,30,26,4,32
Zenit,9001,5,7,9,4,22,15,7,30
Terek Grozny,9001,6,7,7,6,20,22,-2,28
Din Moscow,9001,7,6,6,8,18,24,-6,24
FK Rubin,9001,8,5,6,9,21,18,3,21
Rostov,9001,9,5,6,9,13,17,-4,21
Amkar,9001,10,4,5,11,10,24,-14,17
Anzhi,9001,11,2,7,11,16,39,-23,13
Loko Moscow,9002,1,12,6,2,33,12,21,42
Spart Moscow,9002,2,10,5,5,40,28,12,35
CSKA Moscow,9002,3,10,3,7,25,21,4,33
Zenit,9002,4,8,8,4,24,16,8,32
Krasnodar,9002,5,9,5,6,29,25,4,32
Terek Grozny,9002,6,7,6,7,20,25,-5,27
FK Rubin,9002,7,6,5,9,22,18,4,23
Amkar,9002,8,6,4,10,14,23,-9,22
Din Moscow,9002,9,5,6,9,18,25,-7,21
Rostov,9002,10,4,6,10,10,20,-10,18
Anzhi,9002,11,3,6,11,15,37,-22,15
Loko Moscow,9003,1,11,6,3,30,15,15,39
CSKA Moscow,9003,2,11,4,5,26,17,9,37
Spart Moscow,9003,3,9,6,5,39,29,10,33
Zenit,9003,4,8,8,4,24,14,10,32
Krasnodar,9003,5,8,5,7,29,28,1,29
Terek Grozny,9003,6,7,6,7,22,25,-3,27
Din Moscow,9003,7,6,6,8,19,26,-7,24
FK Rubin,9003,8,6,5,9,25,20,5,23
Amkar,9003,9,5,5,10,14,25,-11,20
Rostov,9003,10,4,7,9,10,17,-7,19
Anzhi,9003,11,3,6,11,16,38,-22,15
Loko Moscow,9004,1,13,5,2,31,11,20,44
CSKA Moscow,9004,2,11,4,5,29,18,11,37
Spart Moscow,9004,3,10,5,5,39,28,11,35
Zenit,9004,4,7,8,5,22,18,4,29
Terek Grozny,9004,5,8,5,7,22,25,-3,29
Krasnodar,9004,6,8,4,8,27,27,0,28
FK Rubin,9004,7,6,6,8,26,20,6,24
Din Moscow,9004,8,5,7,8,20,27,-7,22
Rostov,9004,9,5,6,9,11,17,-6,21
Amkar,9004,10,5,4,11,14,25,-11,19
Anzhi,9004,11,2,6,12,14,39,-25,12
CSKA Moscow,9005,1,12,3,5,30,19,11,39
Loko Moscow,9005,2,11,5,4,31,15,16,38
Spart Moscow,9005,3,11,5,4,40,25,15,38
Zenit,9005,4,8,8,4,22,14,8,32
Krasnodar,9005,5,9,5,6,30,26,4,32
Terek Grozny,9005,6,8,6,6,21,22,-1,30
FK Rubin,9005,7,5,7,8,21,17,4,22
Din Moscow,9005,8,5,7,8,17,23,-6,22
Rostov,9005,9,4,6,10,10,18,-8,18
Amkar,9005,10,4,4,12,9,27,-18,16
Anzhi,9005,11,2,6,12,16,41,-25,12
Loko Moscow,9006,1,11,6,3,29,12,17,39
CSKA Moscow,9006,2,11,3,6,29,20,9,36
Zenit,9006,3,9,8,3,25,14,11,35
Krasnodar,9006,4,9,5,6,28,24,4,32
Spart Moscow,9006,5,8,6,6,34,28,6,30
Terek Grozny,9006,6,8,6,6,24,24,0,30
Din Moscow,9006,7,6,6,8,19,23,-4,24
FK Rubin,9006,8,6,5,9,22,18,4,23
Amkar,9006,9,5,5,10,11,23,-12,20
Rostov,9006,10,4,7,9,10,17,-7,19
Anzhi,9006,11,2,5,13,15,43,-28,11
Loko Moscow,9007,1,12,5,3,31,14,17,41
CSKA Moscow,9007,2,11,4,5,29,19,10,37
Zenit,9007,3,8,9,3,23,13,10,33
Spart Moscow,9007,4,9,5,6,35,30,5,32
Krasnodar,9007,5,9,4,7,32,27,5,31
Terek Grozny,9007,6,8,6,6,21,22,-1,30
Din Moscow,9007,7,6,7,7,19,22,-3,25
FK Rubin,9007,8,5,6,9,22,21,1,21
Amkar,9007,9,5,5,10,12,22,-10,20
Rostov,9007,10,4,6,10,10,18,-8,18
Anzhi,9007,11,2,5,13,16,42,-26,11
Loko Moscow,9008,1,12,5,3,32,16,16,41
CSKA Moscow,9008,2,11,4,5,26,17,9,37
Spart Moscow,9008,3,9,6,5,37,28,9,33
Krasnodar,9008,4,9,4,7,30,27,3,31
Zenit,9008,5,7,9,4,23,16,7,30
Terek Grozny,9008,6,7,6,7,23,27,-4,27
FK Rubin,9008,7,6,6,8,26,19,7,24
Din Moscow,9008,8,5,8,7,20,24,-4,23
Amkar,9008,9,6,4,10,12,22,-10,22
Rostov,9008,10,4,6,10,11,20,-9,18
Anzhi,9008,11,2,6,12,17,41,-24,12
Loko Moscow,9009,1,12,5,3,30,12,18,41
CSKA Moscow,9009,2,12,3,5,31,18,13,39
Spart Moscow,9009,3,11,5,4,43,27,16,38
Zenit,9009,4,8,8,4,23,17,6,32
Krasnodar,9009,5,9,4,7,28,25,3,31
Terek Grozny,9009,6,7,5,8,21,25,-4,26
Din Moscow,9009,7,5,7,8,18,27,-9,22
FK Rubin,9009,8,5,6,9,22,19,3,21
Amkar,9009,9,5,4,11,11,24,-13,19
Rostov,9009,10,4,6,10,11,20,-9,18
Anzhi,9009,11,3,5,12,16,40,-24,14
Loko Moscow,9010,1,12,6,2,31,11,20,42
Spart Moscow,9010,2,10,6,4,37,25,12,36
CSKA Moscow,9010,3,11,3,6,28,20,8,36
Zenit,9010,4,8,8,4,23,16,7,32
Krasnodar,9010,5,8,5,7,28,26,2,29
Terek Grozny,9010,6,7,6,7,21,24,-3,27
Din Moscow,9010,7,6,6,8,19,23,-4,24
FK Rubin,9010,8,6,5,9,23,20,3,23
Rostov,9010,9,4,7,9,10,17,-7,19
Amkar,9010,10,5,4,11,11,25,-14,19
Anzhi,9010,11,2,6,12,15,39,-24,12
Loko Moscow,9011,1,12,5,3,31,15,16,41
Krasnodar,9011,2,10,4,6,34,26,8,34
CSKA Moscow,9011,3,10,4,6,28,23,5,34
Spart Moscow,9011,4,9,6,5,37,29,8,33
Zenit,9011,5,8,8,4,25,15,10,32
Terek Grozny,9011,6,8,6,6,23,24,-1,30
Din Moscow,9011,7,6,7,7,20,22,-2,25
FK Rubin,9011,8,5,5,10,23,23,0,20
Amkar,9011,9,5,4,11,13,25,-12,19
Rostov,9011,10,4,6,10,10,19,-9,18
Anzhi,9011,11,2,7,11,18,41,-23,13
Loko Moscow,9012,1,12,5,3,32,15,17,41
Spart Moscow,9012,2,10,6,4,39,27,12,36
CSKA Moscow,9012,3,10,4,6,26,19,7,34
Krasnodar,9012,4,10,4,6,34,28,6,34
Zenit,9012,5,7,9,4,22,15,7,30
Terek Grozny,9012,6,8,6,6,24,24,0,30
FK Rubin,9012,7,6,5,9,25,20,5,23
Din Moscow,9012,8,5,6,9,17,26,-9,21
Rostov,9012,9,4,6,10,10,18,-8,18
Amkar,9012,10,4,6,10,12,25,-13,18
Anzhi,9012,11,3,5,12,16,40,-24,14
Loko Moscow,9013,1,12,5,3,31,12,19,41
CSKA Moscow,9013,2,11,4,5,28,19,9,37
Spart Moscow,9013,3,10,6,4,41,31,10,36
Krasnodar,9013,4,10,4,6,31,24,7,34
Zenit,9013,5,7,9,4,22,16,6,30
Terek Grozny,9013,6,8,5,7,21,24,-3,29
Din Moscow,9013,7,6,6,8,20,24,-4,24
FK Rubin,9013,8,5,5,10,21,21,0,20
Rostov,9013,9,4,7,9,13,20,-7,19
Amkar,9013,10,5,4,11,12,24,-12,19
Anzhi,9013,11,2,5,13,15,40,-25,11
Loko Moscow,9014,1,12,5,3,31,13,18,41
Zenit,9014,2,9,8,3,24,13,11,35
CSKA Moscow,9014,3,10,4,6,25,19,6,34
Spart Moscow,9014,4,8,7,5,34,28,6,31
Krasnodar,9014,5,9,4,7,31,27,4,31
Terek Grozny,9014,6,7,7,6,21,23,-2,28
Din Moscow,9014,7,6,6,8,19,23,-4,24
FK Rubin,9014,8,6,5,9,24,20,4,23
Rostov,9014,9,4,7,9,11,18,-7,19
Amkar,9014,10,4,6,10,9,22,-13,18
Anzhi,9014,11,2,7,11,15,38,-23,13
Loko Moscow,9015,1,13,5,2,35,11,24,44
CSKA Moscow,9015,2,11,3,6,27,18,9,36
Zenit,9015,3,8,8,4,22,16,6,32
Spart Moscow,9015,4,8,7,5,36,29,7,31
Krasnodar,9015,5,9,4,7,29,27,2,31
Terek Grozny,9015,6,8,5,7,21,23,-2,29
Din Moscow,9015,7,5,8,7,19,23,-4,23
Amkar,9015,8,6,4,10,11,22,-11,22
FK Rubin,9015,9,5,6,9,22,20,2,21
Rostov,9015,10,4,7,9,12,19,-7,19
Anzhi,9015,11,2,5,13,14,40,-26,11
Loko Moscow,9016,1,12,6,2,30,11,19,42
CSKA Moscow,9016,2,11,4,5,27,17,10,37
Spart Moscow,9016,3,9,6,5,38,30,8,33
Krasnodar,9016,4,9,5,6,31,25,6,32
Zenit,9016,5,7,9,4,21,14,7,30
Terek Grozny,9016,6,8,6,6,24,23,1,30
Din Moscow,9016,7,6,7,7,22,24,-2,25
FK Rubin,9016,8,5,6,9,23,22,1,21
Rostov,9016,9,4,7,9,11,18,-7,19
Amkar,9016,10,4,4,12,9,27,-18,16
Anzhi,9016,11,2,6,12,15,40,-25,12
Loko Moscow,9017,1,11,7,2,31,13,18,40
CSKA Moscow,9017,2,11,3,6,28,21,7,36
Spart Moscow,9017,3,9,7,4,36,27,9,34
Zenit,9017,4,8,9,3,26,15,11,33
Krasnodar,9017,5,9,5,6,29,25,4,32
Terek Grozny,9017,6,7,5,8,22,28,-6,26
Din Moscow,9017,7,6,6,8,20,23,-3,24
FK Rubin,9017,8,5,5,10,21,20,1,20
Amkar,9017,9,5,5,10,13,23,-10,20
Rostov,9017,10,4,7,9,11,18,-7,19
Anzhi,9017,11,3,5,12,16,40,-24,14
Loko Moscow,9018,1,13,5,2,34,13,21,44
CSKA Moscow,9018,2,12,3,5,32,19,13,39
Krasnodar,9018,3,9,4,7,34,28,6,31
Spart Moscow,9018,4,8,6,6,35,30,5,30
Zenit,9018,5,7,8,5,21,15,6,29
Terek Grozny,9018,6,7,5,8,21,25,-4,26
Din Moscow,9018,7,5,8,7,19,23,-4,23
Amkar,9018,8,6,4,10,13,23,-10,22
FK Rubin,9018,9,5,6,9,22,23,-1,21
Rostov,9018,10,5,6,9,12,18,-6,21
Anzhi,9018,11,3,5,12,17,43,-26,14
Loko Moscow,9019,1,11,5,4,32,16,16,38
CSKA Moscow,9019,2,11,3,6,29,24,5,36
Zenit,9019,3,9,8,3,31,15,16,35
Krasnodar,9019,4,10,4,6,30,25,5,34
Spart Moscow,9019,5,9,6,5,36,27,9,33
Terek Grozny,9019,6,8,5,7,23,25,-2,29
Din Moscow,9019,7,5,8,7,18,22,-4,23
FK Rubin,9019,8,5,6,9,21,18,3,21
Amkar,9019,9,5,4,11,11,24,-13,19
Rostov,9019,10,4,6,10,10,19,-9,18
Anzhi,9019,11,3,5,12,16,42,-26,14
Loko Moscow,9020,1,11,5,4,29,13,16,38
CSKA Moscow,9020,2,11,4,5,28,18,10,37
Spart Moscow,9020,3,10,5,5,38,27,11,35
Krasnodar,9020,4,10,4,6,30,25,5,34
Zenit,9020,5,8,9,3,23,14,9,33
Terek Grozny,9020,6,8,6,6,21,22,-1,30
Din Moscow,9020,7,5,7,8,18,25,-7,22
FK Rubin,9020,8,5,6,9,23,20,3,21
Rostov,9020,9,5,6,9,11,17,-6,21
Amkar,9020,10,4,4,12,10,25,-15,16
Anzhi,9020,11,2,6,12,14,39,-25,12
Loko Moscow,9021,1,12,6,2,30,11,19,42
CSKA Moscow,9021,2,12,3,5,28,18,10,39
Spart Moscow,9021,3,10,5,5,40,29,11,35
Zenit,9021,4,7,8,5,21,15,6,29
Krasnodar,9021,5,8,5,7,28,28,0,29
Terek Grozny,9021,6,8,5,7,23,26,-3,29
Din Moscow,9021,7,6,6,8,19,25,-6,24
FK Rubin,9021,8,6,5,9,26,20,6,23
Rostov,9021,9,5,6,9,13,18,-5,21
Amkar,9021,10,4,4,12,11,27,-16,16
Anzhi,9021,11,3,5,12,18,40,-22,14
Loko Moscow,9022,1,12,5,3,32,13,19,41
CSKA Moscow,9022,2,11,3,6,28,20,8,36
Zenit,9022,3,9,8,3,26,15,11,35
Spart Moscow,9022,4,8,7,5,35,28,7,31
Krasnodar,9022,5,9,4,7,28,26,2,31
Terek Grozny,9022,6,7,6,7,22,25,-3,27
Din Moscow,9022,7,5,8,7,18,22,-4,23
FK Rubin,9022,8,5,6,9,21,18,3,21
Amkar,9022,9,5,5,10,10,22,-12,20
Rostov,9022,10,4,7,9,11,18,-7,19
Anzhi,9022,11,3,5,12,17,41,-24,14
Loko Moscow,9023,1,12,6,2,34,14,20,42
Spart Moscow,9023,2,11,5,4,39,27,12,38
CSKA Moscow,9023,3,11,3,6,27,19,8,36
Zenit,9023,4,8,9,3,25,15,10,33
Krasnodar,9023,5,9,4,7,30,28,2,31
Terek Grozny,9023,6,7,6,7,22,25,-3,27
Din Moscow,9023,7,6,6,8,20,24,-4,24
FK Rubin,9023,8,5,5,10,22,21,1,20
Rostov,9023,9,4,6,10,10,18,-8,18
Amkar,9023,10,4,5,11,11,25,-14,17
Anzhi,9023,11,3,5,12,16,40,-24,14
Loko Moscow,9024,1,12,5,3,31,13,18,41
Spart Moscow,9024,2,11,5,4,39,26,13,38
CSKA Moscow,9024,3,11,3,6,27,21,6,36
Zenit,9024,4,8,8,4,26,16,10,32
Krasnodar,9024,5,9,5,6,28,24,4,32
Terek Grozny,9024,6,7,6,7,24,30,-6,27
FK Rubin,9024,7,6,6,8,23,17,6,24
Din Moscow,9024,8,5,6,9,18,26,-8,21
Amkar,9024,9,5,4,11,14,24,-10,19
Rostov,9024,10,4,6,10,10,19,-9,18
Anzhi,9024,11,2,6,12,17,41,-24,12
Loko Moscow,9025,1,11,6,3,31,14,17,39
CSKA Moscow,9025,2,10,5,5,27,19,8,35
Spart Moscow,9025,3,9,7,4,36,26,10,34
Zenit,9025,4,7,10,3,22,14,8,31
Krasnodar,9025,5,9,4,7,29,26,3,31
Terek Grozny,9025,6,7,6,7,22,25,-3,27
FK Rubin,9025,7,6,6,8,22,17,5,24
Din Moscow,9025,8,5,8,7,17,21,-4,23
Rostov,9025,9,4,7,9,11,18,-7,19
Amkar,9025,10,4,5,11,10,25,-15,17
Anzhi,9025,11,3,6,11,18,40,-22,15
Loko Moscow,9026,1,12,6,2,32,12,20,42
Spart Moscow,9026,2,10,5,5,39,27,12,35
CSKA Moscow,9026,3,10,4,6,27,20,7,34
Zenit,9026,4,8,9,3,23,14,9,33
Krasnodar,9026,5,8,4,8,29,29,0,28
Terek Grozny,9026,6,7,5,8,22,28,-6,26
FK Rubin,9026,7,6,6,8,24,19,5,24
Din Moscow,9026,8,5,7,8,18,25,-7,22
Amkar,9026,9,6,4,10,13,23,-10,22
Rostov,9026,10,4,6,10,10,20,-10,18
Anzhi,9026,11,3,6,11,19,39,-20,15
Loko Moscow,9027,1,12,5,3,33,14,19,41
CSKA Moscow,9027,2,10,5,5,27,19,8,35
Spart Moscow,9027,3,8,7,5,37,31,6,31
Krasnodar,9027,4,9,4,7,30,28,2,31
Zenit,9027,5,7,9,4,23,17,6,30
Terek Grozny,9027,6,7,7,6,21,23,-2,28
Din Moscow,9027,7,6,7,7,20,22,-2,25
FK Rubin,9027,8,6,6,8,24,18,6,24
Rostov,9027,9,4,7,9,12,19,-7,19
Amkar,9027,10,4,6,10,10,23,-13,18
Anzhi,9027,11,2,7,11,16,39,-23,13
Loko Moscow,9028,1,12,5,3,32,13,19,41
CSKA Moscow,9028,2,11,4,5,28,19,9,37
Spart Moscow,9028,3,10,5,5,36,27,9,35
Krasnodar,9028,4,10,4,6,31,24,7,34
Zenit,9028,5,7,9,4,22,16,6,30
Terek Grozny,9028,6,8,6,6,23,24,-1,30
Din Moscow,9028,7,6,6,8,20,22,-2,24
FK Rubin,9028,8,5,5,10,21,23,-2,20
Amkar,9028,9,5,4,11,12,24,-12,19
Rostov,9028,10,4,6,10,10,19,-9,18
Anzhi,9028,11,2,6,12,17,41,-24,12
Loko Moscow,9029,1,12,5,3,33,15,18,41
CSKA Moscow,9029,2,11,3,6,27,18,9,36
Zenit,9029,3,9,8,3,25,15,10,35
Spart Moscow,9029,4,8,7,5,35,30,5,31
Krasnodar,9029,5,8,4,8,29,28,1,28
Terek Grozny,9029,6,7,6,7,20,24,-4,27
Din Moscow,9029,7,6,7,7,20,23,-3,25
FK Rubin,9029,8,6,5,9,24,20,4,23
Amkar,9029,9,6,4,10,14,22,-8,22
Rostov,9029,10,4,7,9,11,18,-7,19
Anzhi,9029,11,2,6,12,14,39,-25,12
Loko Moscow,9030,1,12,6,2,33,14,19,42
CSKA Moscow,9030,2,11,3,6,28,22,6,36
Zenit,9030,3,8,9,3,26,14,12,33
Spart Moscow,9030,4,9,6,5,39,33,6,33
Krasnodar,9030,5,9,4,7,34,29,5,31
Terek Grozny,9030,6,8,5,7,22,24,-2,29
Din Moscow,9030,7,6,6,8,21,25,-4,24
Amkar,9030,8,6,4,10,13,22,-9,22
FK Rubin,9030,9,5,5,10,24,24,0,20
Rostov,9030,10,4,7,9,13,20,-7,19
Anzhi,9030,11,2,5,13,16,42,-26,11
Loko Moscow,9031,1,11,5,4,31,16,15,38
Spart Moscow,9031,2,10,6,4,38,28,10,36
Zenit,9031,3,9,8,3,25,14,11,35
CSKA Moscow,9031,4,10,4,6,27,20,7,34
Krasnodar,9031,5,9,5,6,31,27,4,32
Terek Grozny,9031,6,8,5,7,22,25,-3,29
FK Rubin,9031,7,6,6,8,25,19,6,24
Din Moscow,9031,8,5,6,9,18,25,-7,21
Rostov,9031,9,4,7,9,12,19,-7,19
Amkar,9031,10,4,4,12,11,26,-15,16
Anzhi,9031,11,3,6,11,17,38,-21,15
Loko Moscow,9032,1,12,5,3,32,14,18,41
Spart Moscow,9032,2,11,5,4,40,26,14,38
CSKA Moscow,9032,3,11,3,6,26,19,7,36
Zenit,9032,4,8,8,4,22,14,8,32
Krasnodar,9032,5,8,5,7,31,29,2,29
Terek Grozny,9032,6,7,6,7,21,24,-3,27
FK Rubin,9032,7,5,7,8,24,20,4,22
Din Moscow,9032,8,5,7,8,18,23,-5,22
Amkar,9032,9,5,4,11,11,25,-14,19
Rostov,9032,10,4,6,10,10,20,-10,18
Anzhi,9032,11,3,6,11,17,38,-21,15
Loko Moscow,9033,1,11,6,3,30,14,16,39
Spart Moscow,9033,2,11,5,4,40,27,13,38
CSKA Moscow,9033,3,11,4,5,29,19,10,37
Terek Grozny,9033,4,9,5,6,27,22,5,32
Krasnodar,9033,5,9,4,7,30,26,4,31
Zenit,9033,6,7,9,4,22,16,6,30
Din Moscow,9033,7,6,6,8,18,22,-4,24
FK Rubin,9033,8,6,5,9,22,18,4,23
Rostov,9033,9,4,6,10,11,21,-10,18
Amkar,9033,10,4,4,12,10,28,-18,16
Anzhi,9033,11,2,6,12,15,41,-26,12
Loko Moscow,9034,1,11,6,3,31,14,17,39
CSKA Moscow,9034,2,11,4,5,29,17,12,37
Spart Moscow,9034,3,10,5,5,42,29,13,35
Krasnodar,9034,4,10,4,6,29,24,5,34
Zenit,9034,5,7,10,3,23,15,8,31
Terek Grozny,9034,6,8,6,6,23,23,0,30
Din Moscow,9034,7,6,6,8,22,25,-3,24
FK Rubin,9034,8,5,5,10,22,21,1,20
Amkar,9034,9,5,4,11,11,25,-14,19
Rostov,9034,10,4,6,10,10,22,-12,18
Anzhi,9034,11,2,6,12,15,42,-27,12
Loko Moscow,9035,1,12,6,2,31,12,19,42
CSKA Moscow,9035,2,12,3,5,29,18,11,39
Spart Moscow,9035,3,9,6,5,37,28,9,33
Zenit,9035,4,7,9,4,22,15,7,30
Terek Grozny,9035,5,8,6,6,26,27,-1,30
Krasnodar,9035,6,8,5,7,28,26,2,29
FK Rubin,9035,7,6,6,8,23,18,5,24
Din Moscow,9035,8,5,6,9,17,24,-7,21
Rostov,9035,9,4,7,9,12,19,-7,19
Amkar,9035,10,5,4,11,11,24,-13,19
Anzhi,9035,11,2,6,12,19,44,-25,12
Loko Moscow,9036,1,12,5,3,32,13,19,41
Zenit,9036,2,9,8,3,25,14,11,35
CSKA Moscow,9036,3,10,4,6,26,19,7,34
Spart Moscow,9036,4,9,5,6,34,28,6,32
Krasnodar,9036,5,8,5,7,28,28,0,29
Terek Grozny,9036,6,7,6,7,20,24,-4,27
FK Rubin,9036,7,6,6,8,23,18,5,24
Din Moscow,9036,8,6,6,8,18,22,-4,24
Amkar,9036,9,6,4,10,13,22,-9,22
Rostov,9036,10,4,6,10,10,18,-8,18
Anzhi,9036,11,2,7,11,14,37,-23,13
Loko Moscow,9037,1,12,5,3,31,13,18,41
CSKA Moscow,9037,2,11,4,5,28,18,10,37
Spart Moscow,9037,3,9,6,5,40,31,9,33
Zenit,9037,4,8,9,3,24,15,9,33
Krasnodar,9037,5,9,4,7,29,26,3,31
Terek Grozny,9037,6,8,5,7,22,28,-6,29
Din Moscow,9037,7,5,8,7,20,24,-4,23
Amkar,9037,8,6,4,10,18,25,-7,22
FK Rubin,9037,9,5,6,9,23,20,3,21
Rostov,9037,10,4,6,10,11,20,-9,18
Anzhi,9037,11,2,5,13,14,40,-26,11
Loko Moscow,9038,1,12,5,3,34,17,17,41
Spart Moscow,9038,2,11,5,4,40,27,13,38
CSKA Moscow,9038,3,11,3,6,27,19,8,36
Zenit,9038,4,9,8,3,27,16,11,35
Krasnodar,9038,5,9,4,7,33,29,4,31
Terek Grozny,9038,6,8,6,6,22,22,0,30
Din Moscow,9038,7,5,7,8,19,24,-5,22
FK Rubin,9038,8,5,6,9,24,22,2,21
Rostov,9038,9,4,6,10,10,20,-10,18
Amkar,9038,10,4,5,11,10,24,-14,17
Anzhi,9038,11,2,5,13,14,40,-26,11
Loko Moscow,9039,1,11,5,4,30,17,13,38
CSKA Moscow,9039,2,11,3,6,27,20,7,36
Zenit,9039,3,9,8,3,25,14,11,35
Krasnodar,9039,4,10,4,6,32,24,8,34
Spart Moscow,9039,5,9,6,5,35,27,8,33
Terek Grozny,9039,6,8,5,7,22,23,-1,29
FK Rubin,9039,7,6,5,9,24,18,6,23
Din Moscow,9039,8,5,6,9,17,25,-8,21
Rostov,9039,9,4,7,9,10,17,-7,19
Amkar,9039,10,5,4,11,11,25,-14,19
Anzhi,9039,11,3,5,12,16,39,-23,14
Loko Moscow,9040,1,12,6,2,33,14,19,42
CSKA Moscow,9040,2,11,4,5,26,17,9,37
Spart Moscow,9040,3,10,5,5,40,29,11,35
Zenit,9040,4,7,9,4,22,15,7,30
Terek Grozny,9040,5,8,6,6,22,23,-1,30
Krasnodar,9040,6,8,5,7,29,27,2,29
Din Moscow,9040,7,6,6,8,20,24,-4,24
FK Rubin,9040,8,5,6,9,22,19,3,21
Rostov,9040,9,5,6,9,13,19,-6,21
Amkar,9040,10,4,5,11,9,25,-16,17
Anzhi,9040,11,2,6,12,15,39,-24,12
Loko Moscow,9041,1,11,5,4,31,15,16,38
CSKA Moscow,9041,2,11,4,5,31,19,12,37
Zenit,9041,3,8,9,3,25,16,9,33
Spart Moscow,9041,4,9,6,5,36,28,8,33
Terek Grozny,9041,5,9,5,6,27,27,0,32
Krasnodar,9041,6,9,4,7,30,27,3,31
FK Rubin,9041,7,6,6,8,24,19,5,24
Din Moscow,9041,8,5,7,8,18,23,-5,22
Rostov,9041,9,5,6,9,12,18,-6,21
Amkar,9041,10,4,5,11,13,27,-14,17
Anzhi,9041,11,2,5,13,16,44,-28,11
Loko Moscow,9042,1,12,5,3,31,13,18,41
Spart Moscow,9042,2,10,6,4,40,30,10,36
Zenit,9042,3,9,8,3,24,14,10,35
CSKA Moscow,9042,4,10,4,6,27,20,7,34
Krasnodar,9042,5,9,4,7,30,27,3,31
Terek Grozny,9042,6,7,6,7,21,25,-4,27
Din Moscow,9042,7,6,6,8,21,24,-3,24
FK Rubin,9042,8,5,5,10,23,22,1,20
Rostov,9042,9,4,6,10,11,19,-8,18
Amkar,9042,10,4,6,10,11,24,-13,18
Anzhi,9042,11,3,6,11,19,40,-21,15
Loko Moscow,9043,1,11,6,3,30,13,17,39
CSKA Moscow,9043,2,10,4,6,26,20,6,34
Zenit,9043,3,8,9,3,23,14,9,33
Krasnodar,9043,4,9,5,6,31,27,4,32
Spart Moscow,9043,5,9,5,6,35,32,3,32
Din Moscow,9043,6,7,6,7,23,22,1,27
Terek Grozny,9043,7,7,6,7,23,26,-3,27
Amkar,9043,8,6,4,10,14,23,-9,22
FK Rubin,9043,9,5,5,10,24,23,1,20
Rostov,9043,10,4,6,10,11,19,-8,18
Anzhi,9043,11,3,6,11,18,39,-21,15
Loko Moscow,9044,1,13,5,2,38,13,25,44
CSKA Moscow,9044,2,12,3,5,28,18,10,39
Spart Moscow,9044,3,10,5,5,39,29,10,35
Krasnodar,9044,4,9,4,7,31,30,1,31
Zenit,9044,5,7,8,5,22,19,3,29
Terek Grozny,9044,6,8,5,7,22,24,-2,29
Din Moscow,9044,7,6,6,8,20,25,-5,24
Rostov,9044,8,5,6,9,11,17,-6,21
FK Rubin,9044,9,5,5,10,24,22,2,20
Amkar,9044,10,5,4,11,12,25,-13,19
Anzhi,9044,11,2,5,13,16,41,-25,11
Loko Moscow,9045,1,12,6,2,31,12,19,42
CSKA Moscow,9045,2,11,3,6,31,22,9,36
Spart Moscow,9045,3,10,5,5,38,28,10,35
Zenit,9045,4,8,8,4,24,16,8,32
Krasnodar,9045,5,9,5,6,31,25,6,32
Terek Grozny,9045,6,9,5,6,25,22,3,32
FK Rubin,9045,7,6,5,9,23,21,2,23
Din Moscow,9045,8,5,6,9,18,26,-8,21
Amkar,9045,9,5,4,11,12,24,-12,19
Rostov,9045,10,4,6,10,10,19,-9,18
Anzhi,9045,11,2,5,13,16,44,-28,11
Loko Moscow,9046,1,12,5,3,32,15,17,41
CSKA Moscow,9046,2,12,3,5,30,20,10,39
Spart Moscow,9046,3,9,6,5,35,26,9,33
Terek Grozny,9046,4,9,5,6,23,23,0,32
Krasnodar,9046,5,9,4,7,30,27,3,31
Zenit,9046,6,7,8,5,24,18,6,29
FK Rubin,9046,7,7,5,8,25,17,8,26
Rostov,9046,8,5,6,9,11,17,-6,21
Din Moscow,9046,9,5,6,9,17,25,-8,21
Amkar,9046,10,4,5,11,10,24,-14,17
Anzhi,9046,11,2,5,13,15,40,-25,11
Loko Moscow,9047,1,11,6,3,30,14,16,39
Spart Moscow,9047,2,10,6,4,40,28,12,36
Zenit,9047,3,9,8,3,27,13,14,35
CSKA Moscow,9047,4,10,3,7,26,23,3,33
Krasnodar,9047,5,8,5,7,28,27,1,29
Terek Grozny,9047,6,7,6,7,23,26,-3,27
FK Rubin,9047,7,6,6,8,24,18,6,24
Din Moscow,9047,8,5,7,8,19,25,-6,22
Rostov,9047,9,4,6,10,11,20,-9,18
Amkar,9047,10,4,6,10,12,25,-13,18
Anzhi,9047,11,4,5,11,18,39,-21,17
Loko Moscow,9048,1,12,5,3,31,14,17,41
CSKA Moscow,9048,2,11,3,6,30,19,11,36
Zenit,9048,3,9,8,3,25,14,11,35
Spart Moscow,9048,4,8,7,5,35,28,7,31
Krasnodar,9048,5,9,4,7,29,25,4,31
Terek Grozny,9048,6,8,6,6,27,26,1,30
Din Moscow,9048,7,6,6,8,20,24,-4,24
FK Rubin,9048,8,6,5,9,24,21,3,23
Rostov,9048,9,4,7,9,11,18,-7,19
Amkar,9048,10,4,6,10,12,25,-13,18
Anzhi,9048,11,2,5,13,17,47,-30,11
Loko Moscow,9049,1,12,6,2,31,11,20,42
CSKA Moscow,9049,2,11,3,6,29,19,10,36
Zenit,9049,3,8,8,4,23,16,7,32
Krasnodar,9049,4,9,5,6,31,25,6,32
Spart Moscow,9049,5,8,7,5,37,31,6,31
Terek Grozny,9049,6,8,6,6,22,23,-1,30
Din Moscow,9049,7,7,6,7,22,22,0,27
FK Rubin,9049,8,5,5,10,22,23,-1,20
Rostov,9049,9,4,7,9,12,19,-7,19
Amkar,9049,10,4,5,11,11,25,-14,17
Anzhi,9049,11,2,6,12,14,40,-26,12
Loko Moscow,9050,1,12,6,2,35,16,19,42
CSKA Moscow,9050,2,10,5,5,26,18,8,35
Spart Moscow,9050,3,9,6,5,38,27,11,33
Krasnodar,9050,4,9,5,6,30,26,4,32
Terek Grozny,9050,5,9,5,6,23,22,1,32
Zenit,9050,6,7,9,4,24,17,7,30
FK Rubin,9050,7,6,5,9,23,18,5,23
Din Moscow,9050,8,5,6,9,17,27,-10,21
Rostov,9050,9,4,7,9,10,17,-7,19
Amkar,9050,10,5,4,11,11,25,-14,19
Anzhi,9050,11,2,6,12,15,39,-24,12
Loko Moscow,9051,1,12,6,2,30,11,19,42
CSKA Moscow,9051,2,10,4,6,25,18,7,34
Zenit,9051,3,7,9,4,21,14,7,30
Spart Moscow,9051,4,8,6,6,34,28,6,30
Krasnodar,9051,5,8,5,7,27,26,1,29
Terek Grozny,9051,6,8,5,7,23,23,0,29
FK Rubin,9051,7,7,5,8,26,17,9,26
Din Moscow,9051,8,5,7,8,18,25,-7,22
Rostov,9051,9,5,6,9,11,17,-6,21
Amkar,9051,10,5,4,11,10,25,-15,19
Anzhi,9051,11,4,5,11,16,37,-21,17
Loko Moscow,9052,1,13,5,2,31,11,20,44
CSKA Moscow,9052,2,12,3,5,32,18,14,39
Spart Moscow,9052,3,9,6,5,36,28,8,33
Terek Grozny,9052,4,8,6,6,24,24,0,30
Zenit,9052,5,7,8,5,22,17,5,29
Krasnodar,9052,6,8,4,8,27,26,1,28
FK Rubin,9052,7,7,5,8,23,17,6,26
Din Moscow,9052,8,6,6,8,19,22,-3,24
Rostov,9052,9,4,6,10,11,20,-9,18
Amkar,9052,10,4,6,10,10,23,-13,18
Anzhi,9052,11,2,5,13,15,44,-29,11
Loko Moscow,9053,1,11,5,4,30,17,13,38
CSKA Moscow,9053,2,11,3,6,27,21,6,36
Zenit,9053,3,9,8,3,28,13,15,35
Spart Moscow,9053,4,10,5,5,38,29,9,35
Krasnodar,9053,5,10,4,6,31,25,6,34
Terek Grozny,9053,6,8,5,7,21,25,-4,29
FK Rubin,9053,7,6,5,9,23,20,3,23
Din Moscow,9053,8,5,6,9,20,26,-6,21
Rostov,9053,9,5,6,9,12,18,-6,21
Amkar,9053,10,4,4,12,9,24,-15,16
Anzhi,9053,11,3,5,12,18,39,-21,14
CSKA Moscow,9054,1,12,3,5,36,19,17,39
Loko Moscow,9054,2,11,6,3,29,12,17,39
Zenit,9054,3,8,8,4,23,17,6,32
Krasnodar,9054,4,9,5,6,28,24,4,32
Spart Moscow,9054,5,8,7,5,34,27,7,31
Terek Grozny,9054,6,8,5,7,24,26,-2,29
FK Rubin,9054,7,6,5,9,22,18,4,23
Din Moscow,9054,8,5,7,8,18,23,-5,22
Rostov,9054,9,4,7,9,10,17,-7,19
Amkar,9054,10,5,4,11,11,25,-14,19
Anzhi,9054,11,3,5,12,18,45,-27,14
Loko Moscow,9055,1,11,6,3,29,12,17,39
Spart Moscow,9055,2,11,5,4,42,26,16,38
CSKA Moscow,9055,3,11,3,6,30,21,9,36
Zenit,9055,4,8,9,3,24,13,11,33
Krasnodar,9055,5,9,4,7,28,25,3,31
Terek Grozny,9055,6,7,7,6,21,23,-2,28
FK Rubin,9055,7,6,6,8,22,17,5,24
Din Moscow,9055,8,5,7,8,17,24,-7,22
Rostov,9055,9,4,6,10,10,18,-8,18
Amkar,9055,10,4,5,11,11,28,-17,17
Anzhi,9055,11,2,6,12,15,42,-27,12
Loko Moscow,9056,1,11,6,3,32,17,15,39
Spart Moscow,9056,2,10,5,5,41,27,14,35
Zenit,9056,3,9,8,3,27,14,13,35
CSKA Moscow,9056,4,10,4,6,27,21,6,34
Krasnodar,9056,5,8,6,6,29,26,3,30
Terek Grozny,9056,6,7,7,6,25,27,-2,28
Din Moscow,9056,7,6,6,8,20,24,-4,24
FK Rubin,9056,8,5,6,9,21,20,1,21
Amkar,9056,9,5,5,10,13,25,-12,20
Rostov,9056,10,4,6,10,10,21,-11,18
Anzhi,9056,11,2,7,11,19,42,-23,13
Loko Moscow,9057,1,13,5,2,33,11,22,44
CSKA Moscow,9057,2,11,4,5,28,18,10,37
Spart Moscow,9057,3,9,7,4,36,27,9,34
Krasnodar,9057,4,9,4,7,28,27,1,31
Zenit,9057,5,7,9,4,22,15,7,30
Terek Grozny,9057,6,7,6,7,25,28,-3,27
Din Moscow,9057,7,6,7,7,20,21,-1,25
FK Rubin,9057,8,5,5,10,21,21,0,20
Rostov,9057,9,4,6,10,10,18,-8,18
Amkar,9057,10,4,6,10,14,27,-13,18
Anzhi,9057,11,3,5,12,17,41,-24,14
Loko Moscow,9058,1,12,6,2,34,12,22,42
CSKA Moscow,9058,2,12,3,5,30,17,13,39
Spart Moscow,9058,3,9,7,4,37,28,9,34
Krasnodar,9058,4,9,5,6,29,25,4,32
Zenit,9058,5,7,8,5,22,19,3,29
Terek Grozny,9058,6,7,6,7,21,24,-3,27
Din Moscow,9058,7,6,7,7,20,23,-3,25
FK Rubin,9058,8,5,5,10,22,20,2,20
Amkar,9058,9,5,5,10,12,24,-12,20
Rostov,9058,10,4,6,10,10,18,-8,18
Anzhi,9058,11,2,6,12,14,41,-27,12
Loko Moscow,9059,1,11,6,3,31,14,17,39
CSKA Moscow,9059,2,11,3,6,28,19,9,36
Spart Moscow,9059,3,9,7,4,38,29,9,34
Krasnodar,9059,4,10,4,6,30,25,5,34
Zenit,9059,5,8,9,3,23,14,9,33
Terek Grozny,9059,6,8,5,7,23,24,-1,29
Din Moscow,9059,7,6,7,7,19,22,-3,25
FK Rubin,9059,8,5,5,10,21,19,2,20
Rostov,9059,9,4,7,9,13,20,-7,19
Amkar,9059,10,4,4,12,9,25,-16,16
Anzhi,9059,11,3,5,12,17,41,-24,14
Loko Moscow,9060,1,12,5,3,30,13,17,41
CSKA Moscow,9060,2,11,4,5,27,18,9,37
Spart Moscow,9060,3,9,7,4,36,25,11,34
Krasnodar,9060,4,10,4,6,32,26,6,34
Zenit,9060,5,7,8,5,21,15,6,29
Terek Grozny,9060,6,7,6,7,21,24,-3,27
FK Rubin,9060,7,6,5,9,26,21,5,23
Din Moscow,9060,8,5,6,9,18,27,-9,21
Rostov,9060,9,4,7,9,10,17,-7,19
Amkar,9060,10,4,6,10,10,23,-13,18
Anzhi,9060,11,3,6,11,16,38,-22,15
Loko Moscow,9061,1,12,5,3,31,12,19,41
CSKA Moscow,9061,2,11,3,6,28,20,8,36
Zenit,9061,3,9,8,3,24,14,10,35
Spart Moscow,9061,4,9,6,5,39,32,7,33
Terek Grozny,9061,5,9,5,6,24,22,2,32
Krasnodar,9061,6,9,4,7,29,27,2,31
Din Moscow,9061,7,6,7,7,21,23,-2,25
FK Rubin,9061,8,5,5,10,22,21,1,20
Amkar,9061,9,5,4,11,13,26,-13,19
Rostov,9061,10,4,6,10,11,20,-9,18
Anzhi,9061,11,2,5,13,15,40,-25,11
Loko Moscow,9062,1,13,5,2,33,11,22,44
CSKA Moscow,9062,2,11,4,5,30,21,9,37
Spart Moscow,9062,3,9,7,4,37,28,9,34
Krasnodar,9062,4,9,4,7,29,28,1,31
Zenit,9062,5,7,9,4,24,17,7,30
Terek Grozny,9062,6,7,6,7,22,26,-4,27
Din Moscow,9062,7,6,7,7,21,22,-1,25
FK Rubin,9062,8,5,5,10,22,22,0,20
Rostov,9062,9,4,7,9,11,18,-7,19
Amkar,9062,10,5,4,11,12,24,-12,19
Anzhi,9062,11,2,6,12,17,41,-24,12
Loko Moscow,9063,1,11,6,3,31,14,17,39
CSKA Moscow,9063,2,11,3,6,28,20,8,36
Spart Moscow,9063,3,9,7,4,35,26,9,34
Zenit,9063,4,8,9,3,23,14,9,33
Krasnodar,9063,5,9,4,7,31,28,3,31
Terek Grozny,9063,6,7,6,7,21,24,-3,27
FK Rubin,9063,7,7,5,8,26,19,7,26
Din Moscow,9063,8,5,7,8,18,24,-6,22
Amkar,9063,9,5,5,10,12,24,-12,20
Rostov,9063,10,4,6,10,10,18,-8,18
Anzhi,9063,11,2,6,12,15,39,-24,12
Loko Moscow,9064,1,12,6,2,32,13,19,42
CSKA Moscow,9064,2,11,3,6,27,18,9,36
Spart Moscow,9064,3,9,6,5,35,27,8,33
Zenit,9064,4,8,8,4,23,15,8,32
Krasnodar,9064,5,8,6,6,28,25,3,30
Terek Grozny,9064,6,8,6,6,22,23,-1,30
FK Rubin,9064,7,6,6,8,23,18,5,24
Din Moscow,9064,8,5,6,9,18,24,-6,21
Rostov,9064,9,5,6,9,12,18,-6,21
Amkar,9064,10,4,6,10,9,22,-13,18
Anzhi,9064,11,2,5,13,15,41,-26,11
Loko Moscow,9065,1,13,5,2,34,11,23,44
CSKA Moscow,9065,2,10,4,6,25,18,7,34
Zenit,9065,3,8,8,4,22,14,8,32
Spart Moscow,9065,4,8,7,5,34,27,7,31
Krasnodar,9065,5,9,4,7,29,29,0,31
Terek Grozny,9065,6,8,6,6,23,24,-1,30
Din Moscow,9065,7,7,6,7,19,21,-2,27
FK Rubin,9065,8,5,5,10,22,20,2,20
Rostov,9065,9,4,7,9,10,17,-7,19
Amkar,9065,10,4,6,10,10,23,-13,18
Anzhi,9065,11,2,6,12,16,40,-24,12
Loko Moscow,9066,1,11,6,3,30,13,17,39
CSKA Moscow,9066,2,11,4,5,27,18,9,37
Spart Moscow,9066,3,9,6,5,37,29,8,33
Zenit,9066,4,7,10,3,22,14,8,31
Krasnodar,9066,5,9,4,7,29,26,3,31
Terek Grozny,9066,6,7,6,7,21,24,-3,27
FK Rubin,9066,7,7,5,8,24,17,7,26
Din Moscow,9066,8,6,6,8,18,23,-5,24
Rostov,9066,9,4,6,10,11,19,-8,18
Amkar,9066,10,4,6,10,12,25,-13,18
Anzhi,9066,11,3,5,12,15,38,-23,14
Loko Moscow,9067,1,12,5,3,35,14,21,41
CSKA Moscow,9067,2,11,3,6,28,18,10,36
Zenit,9067,3,8,8,4,22,18,4,32
Spart Moscow,9067,4,8,7,5,35,28,7,31
Krasnodar,9067,5,9,4,7,30,26,4,31
Terek Grozny,9067,6,7,6,7,20,23,-3,27
FK Rubin,9067,7,6,6,8,22,17,5,24
Din Moscow,9067,8,5,8,7,18,22,-4,23
Rostov,9067,9,5,6,9,12,18,-6,21
Amkar,9067,10,4,6,10,9,22,-13,18
Anzhi,9067,11,3,5,12,15,40,-25,14
Loko Moscow,9068,1,12,6,2,32,12,20,42
CSKA Moscow,9068,2,11,4,5,30,19,11,37
Spart Moscow,9068,3,10,5,5,38,27,11,35
Krasnodar,9068,4,8,6,6,28,25,3,30
Zenit,9068,5,7,8,5,22,19,3,29
Terek Grozny,9068,6,7,5,8,20,24,-4,26
Din Moscow,9068,7,6,6,8,18,22,-4,24
FK Rubin,9068,8,5,6,9,21,18,3,21
Rostov,9068,9,5,6,9,11,17,-6,21
Amkar,9068,10,5,4,11,11,26,-15,19
Anzhi,9068,11,3,6,11,16,38,-22,15
Loko Moscow,9069,1,13,5,2,33,13,20,44
CSKA Moscow,9069,2,11,4,5,28,17,11,37
Spart Moscow,9069,3,8,7,5,34,29,5,31
Krasnodar,9069,4,9,4,7,31,28,3,31
Zenit,9069,5,7,9,4,21,14,7,30
Terek Grozny,9069,6,7,7,6,22,24,-2,28
Din Moscow,9069,7,5,8,7,18,22,-4,23
FK Rubin,9069,8,5,6,9,23,20,3,21
Amkar,9069,9,5,5,10,13,23,-10,20
Rostov,9069,10,4,7,9,11,18,-7,19
Anzhi,9069,11,2,6,12,15,41,-26,12
Loko Moscow,9070,1,11,5,4,30,14,16,38
CSKA Moscow,9070,2,11,4,5,29,18,11,37
Spart Moscow,9070,3,9,7,4,38,27,11,34
Zenit,9070,4,8,9,3,24,15,9,33
Krasnodar,9070,5,9,4,7,28,25,3,31
Terek Grozny,9070,6,7,7,6,23,25,-2,28
Din Moscow,9070,7,6,6,8,20,25,-5,24
FK Rubin,9070,8,6,5,9,22,19,3,23
Rostov,9070,9,4,7,9,11,18,-7,19
Amkar,9070,10,4,6,10,10,23,-13,18
Anzhi,9070,11,2,6,12,16,42,-26,12
Loko Moscow,9071,1,12,6,2,32,13,19,42
CSKA Moscow,9071,2,11,3,6,30,21,9,36
Spart Moscow,9071,3,9,6,5,39,30,9,33
Zenit,9071,4,8,8,4,23,15,8,32
Krasnodar,9071,5,8,6,6,30,27,3,30
Terek Grozny,9071,6,8,5,7,22,24,-2,29
FK Rubin,9071,7,6,6,8,23,18,5,24
Din Moscow,9071,8,6,6,8,20,24,-4,24
Amkar,9071,9,5,5,10,13,24,-11,20
Rostov,9071,10,4,6,10,10,19,-9,18
Anzhi,9071,11,2,5,13,16,43,-27,11
Loko Moscow,9072,1,12,6,2,32,11,21,42
CSKA Moscow,9072,2,11,3,6,26,18,8,36
Zenit,9072,3,8,9,3,22,13,9,33
Spart Moscow,9072,4,9,6,5,40,32,8,33
Krasnodar,9072,5,9,4,7,30,28,2,31
Terek Grozny,9072,6,7,5,8,22,27,-5,26
Din Moscow,9072,7,6,6,8,20,24,-4,24
Rostov,9072,8,5,6,9,12,18,-6,21
FK Rubin,9072,9,5,5,10,22,21,1,20
Amkar,9072,10,5,5,10,15,27,-12,20
Anzhi,9072,11,3,5,12,16,38,-22,14
Loko Moscow,9073,1,11,6,3,30,13,17,39
CSKA Moscow,9073,2,11,4,5,29,18,11,37
Spart Moscow,9073,3,10,5,5,39,29,10,35
Zenit,9073,4,8,9,3,23,14,9,33
Krasnodar,9073,5,8,5,7,28,27,1,29
Terek Grozny,9073,6,7,7,6,21,23,-2,28
FK Rubin,9073,7,7,5,8,25,18,7,26
Din Moscow,9073,8,5,6,9,19,25,-6,21
Amkar,9073,9,5,5,10,11,23,-12,20
Rostov,9073,10,4,6,10,11,20,-9,18
Anzhi,9073,11,2,6,12,15,41,-26,12
Loko Moscow,9074,1,11,7,2,29,11,18,40
CSKA Moscow,9074,2,11,3,6,28,18,10,36
Spart Moscow,9074,3,9,7,4,38,29,9,34
Zenit,9074,4,8,9,3,22,13,9,33
Terek Grozny,9074,5,9,5,6,22,22,0,32
Krasnodar,9074,6,8,6,6,28,25,3,30
Din Moscow,9074,7,5,8,7,19,23,-4,23
FK Rubin,9074,8,5,7,8,23,19,4,22
Rostov,9074,9,4,6,10,12,20,-8,18
Amkar,9074,10,4,5,11,10,24,-14,17
Anzhi,9074,11,2,5,13,14,41,-27,11
CSKA Moscow,9075,1,12,3,5,28,17,11,39
Loko Moscow,9075,2,11,5,4,29,13,16,38
Spart Moscow,9075,3,10,6,4,38,25,13,36
Krasnodar,9075,4,10,4,6,29,24,5,34
Zenit,9075,5,8,8,4,22,15,7,32
Terek Grozny,9075,6,7,5,8,22,26,-4,26
FK Rubin,9075,7,6,5,9,23,18,5,23
Din Moscow,9075,8,5,7,8,17,23,-6,22
Amkar,9075,9,5,4,11,12,25,-13,19
Rostov,9075,10,4,6,10,10,21,-11,18
Anzhi,9075,11,3,5,12,15,38,-23,14
Loko Moscow,9076,1,12,6,2,32,13,19,42
CSKA Moscow,9076,2,11,4,5,30,17,13,37
Spart Moscow,9076,3,10,6,4,39,28,11,36
Krasnodar,9076,4,9,5,6,29,25,4,32
Zenit,9076,5,7,9,4,22,15,7,30
Terek Grozny,9076,6,8,5,7,22,25,-3,29
FK Rubin,9076,7,6,5,9,23,19,4,23
Din Moscow,9076,8,5,6,9,19,26,-7,21
Amkar,9076,9,5,5,10,14,25,-11,20
Rostov,9076,10,4,6,10,10,18,-8,18
Anzhi,9076,11,2,5,13,14,43,-29,11
Loko Moscow,9077,1,11,5,4,30,14,16,38
CSKA Moscow,9077,2,11,4,5,27,18,9,37
Zenit,9077,3,8,9,3,24,15,9,33
Spart Moscow,9077,4,9,6,5,38,30,8,33
Krasnodar,9077,5,9,4,7,28,25,3,31
FK Rubin,9077,6,7,5,8,24,18,6,26
Terek Grozny,9077,7,7,5,8,20,24,-4,26
Din Moscow,9077,8,6,6,8,22,26,-4,24
Rostov,9077,9,4,7,9,11,18,-7,19
Amkar,9077,10,5,4,11,10,23,-13,19
Anzhi,9077,11,3,5,12,15,38,-23,14
Loko Moscow,9078,1,13,5,2,32,12,20,44
CSKA Moscow,9078,2,12,3,5,28,17,11,39
Krasnodar,9078,3,9,4,7,30,25,5,31
Spart Moscow,9078,4,8,6,6,36,30,6,30
Zenit,9078,5,7,8,5,22,16,6,29
Terek Grozny,9078,6,8,5,7,23,25,-2,29
Din Moscow,9078,7,6,7,7,20,22,-2,25
Rostov,9078,8,5,6,9,11,17,-6,21
FK Rubin,9078,9,5,5,10,21,22,-1,20
Amkar,9078,10,5,4,11,12,25,-13,19
Anzhi,9078,11,3,5,12,17,41,-24,14
Loko Moscow,9079,1,11,6,3,32,15,17,39
CSKA Moscow,9079,2,10,5,5,28,20,8,35
Krasnodar,9079,3,10,4,6,32,27,5,34
Spart Moscow,9079,4,9,6,5,36,29,7,33
Zenit,9079,5,7,10,3,23,15,8,31
Terek Grozny,9079,6,8,5,7,24,23,1,29
Din Moscow,9079,7,5,7,8,17,22,-5,22
FK Rubin,9079,8,5,6,9,22,19,3,21
Rostov,9079,9,5,6,9,13,18,-5,21
Amkar,9079,10,5,5,10,11,23,-12,20
Anzhi,9079,11,2,6,12,16,43,-27,12
Loko Moscow,9080,1,12,5,3,30,12,18,41
Spart Moscow,9080,2,11,5,4,42,27,15,38
Zenit,9080,3,9,8,3,25,13,12,35
CSKA Moscow,9080,4,10,3,7,26,22,4,33
Terek Grozny,9080,5,8,5,7,22,26,-4,29
Krasnodar,9080,6,8,4,8,27,29,-2,28
Din Moscow,9080,7,6,6,8,20,24,-4,24
FK Rubin,9080,8,6,5,9,26,19,7,23
Rostov,9080,9,4,6,10,11,22,-11,18
Anzhi,9080,10,4,5,11,20,39,-19,17
Amkar,9080,11,4,4,12,9,25,-16,16
Loko Moscow,9081,1,12,5,3,30,12,18,41
Spart Moscow,9081,2,11,5,4,37,26,11,38
CSKA Moscow,9081,3,11,4,5,27,18,9,37
Zenit,9081,4,8,8,4,23,15,8,32
Krasnodar,9081,5,9,4,7,31,25,6,31
Terek Grozny,9081,6,8,5,7,24,28,-4,29
Din Moscow,9081,7,5,7,8,18,23,-5,22
FK Rubin,9081,8,5,6,9,22,22,0,21
Rostov,9081,9,4,6,10,10,18,-8,18
Amkar,9081,10,4,4,12,11,26,-15,16
Anzhi,9081,11,3,6,11,19,39,-20,15
Loko Moscow,9082,1,13,5,2,31,11,20,44
Spart Moscow,9082,2,11,5,4,41,28,13,38
CSKA Moscow,9082,3,11,3,6,27,18,9,36
Zenit,9082,4,8,8,4,22,14,8,32
Krasnodar,9082,5,9,4,7,29,25,4,31
Terek Grozny,9082,6,8,5,7,21,23,-2,29
FK Rubin,9082,7,6,5,9,23,20,3,23
Din Moscow,9082,8,5,6,9,20,26,-6,21
Amkar,9082,9,5,4,11,11,25,-14,19
Rostov,9082,10,4,6,10,10,19,-9,18
Anzhi,9082,11,2,5,13,14,40,-26,11
Loko Moscow,9083,1,12,5,3,31,15,16,41
CSKA Moscow,9083,2,11,4,5,30,20,10,37
Spart Moscow,9083,3,10,5,5,40,31,9,35
Krasnodar,9083,4,10,4,6,32,24,8,34
Terek Grozny,9083,5,8,6,6,22,23,-1,30
Zenit,9083,6,7,8,5,21,17,4,29
FK Rubin,9083,7,6,5,9,22,18,4,23
Din Moscow,9083,8,5,6,9,19,25,-6,21
Amkar,9083,9,5,5,10,14,26,-12,20
Rostov,9083,10,4,6,10,10,18,-8,18
Anzhi,9083,11,2,6,12,17,41,-24,12
Loko Moscow,9084,1,11,6,3,29,12,17,39
CSKA Moscow,9084,2,12,3,5,27,17,10,39
Spart Moscow,9084,3,10,6,4,40,26,14,36
Krasnodar,9084,4,9,5,6,28,24,4,32
Zenit,9084,5,7,9,4,21,14,7,30
Terek Grozny,9084,6,8,6,6,23,23,0,30
Din Moscow,9084,7,6,7,7,19,22,-3,25
FK Rubin,9084,8,5,6,9,22,19,3,21
Rostov,9084,9,4,6,10,11,21,-10,18
Amkar,9084,10,4,5,11,9,25,-16,17
Anzhi,9084,11,2,5,13,15,41,-26,11
Loko Moscow,9085,1,12,6,2,30,11,19,42
Spart Moscow,9085,2,10,6,4,38,27,11,36
CSKA Moscow,9085,3,11,3,6,28,18,10,36
Zenit,9085,4,8,9,3,22,13,9,33
Krasnodar,9085,5,9,4,7,30,25,5,31
Terek Grozny,9085,6,7,5,8,20,27,-7,26
Din Moscow,9085,7,5,7,8,18,23,-5,22
FK Rubin,9085,8,5,6,9,21,20,1,21
Amkar,9085,9,5,5,10,12,23,-11,20
Rostov,9085,10,4,6,10,10,19,-9,18
Anzhi,9085,11,3,5,12,17,40,-23,14
Loko Moscow,9086,1,12,6,2,32,13,19,42
CSKA Moscow,9086,2,12,3,5,30,18,12,39
Spart Moscow,9086,3,9,6,5,38,29,9,33
Zenit,9086,4,7,9,4,24,18,6,30
Terek Grozny,9086,5,8,6,6,22,22,0,30
Krasnodar,9086,6,8,4,8,28,27,1,28
Din Moscow,9086,7,6,6,8,19,26,-7,24
FK Rubin,9086,8,6,5,9,24,20,4,23
Amkar,9086,9,5,5,10,12,22,-10,20
Rostov,9086,10,4,7,9,11,18,-7,19
Anzhi,9086,11,2,5,13,14,41,-27,11
Loko Moscow,9087,1,12,6,2,35,13,22,42
CSKA Moscow,9087,2,10,4,6,26,19,7,34
Zenit,9087,3,8,9,3,24,15,9,33
Spart Moscow,9087,4,9,5,6,39,31,8,32
Terek Grozny,9087,5,8,6,6,22,22,0,30
Krasnodar,9087,6,8,5,7,29,30,-1,29
Din Moscow,9087,7,7,6,7,21,22,-1,27
FK Rubin,9087,8,5,6,9,23,21,2,21
Amkar,9087,9,5,4,11,13,27,-14,19
Rostov,9087,10,4,6,10,10,19,-9,18
Anzhi,9087,11,2,7,11,15,38,-23,13
Loko Moscow,9088,1,11,6,3,30,14,16,39
Spart Moscow,9088,2,10,6,4,37,27,10,36
CSKA Moscow,9088,3,11,3,6,30,21,9,36
Zenit,9088,4,9,8,3,25,14,11,35
Krasnodar,9088,5,9,5,6,30,26,4,32
Terek Grozny,9088,6,8,6,6,22,22,0,30
Din Moscow,9088,7,5,7,8,17,22,-5,22
FK Rubin,9088,8,5,6,9,22,19,3,21
Rostov,9088,9,4,7,9,12,19,-7,19
Amkar,9088,10,4,4,12,9,25,-16,16
Anzhi,9088,11,2,6,12,16,41,-25,12
Loko Moscow,9089,1,12,5,3,32,14,18,41
CSKA Moscow,9089,2,11,4,5,29,19,10,37
Spart Moscow,9089,3,10,5,5,39,28,11,35
Krasnodar,9089,4,9,5,6,29,25,4,32
Zenit,9089,5,7,9,4,23,16,7,30
Terek Grozny,9089,6,8,6,6,24,23,1,30
FK Rubin,9089,7,6,6,8,23,17,6,24
Din Moscow,9089,8,5,6,9,18,27,-9,21
Amkar,9089,9,5,4,11,11,25,-14,19
Rostov,9089,10,4,6,10,10,19,-9,18
Anzhi,9089,11,2,6,12,16,41,-25,12
Loko Moscow,9090,1,12,5,3,30,12,18,41
Spart Moscow,9090,2,11,5,4,41,27,14,38
CSKA Moscow,9090,3,11,4,5,27,18,9,37
Zenit,9090,4,8,8,4,22,14,8,32
Krasnodar,9090,5,9,4,7,30,26,4,31
Terek Grozny,9090,6,8,6,6,23,23,0,30
Din Moscow,9090,7,6,6,8,20,24,-4,24
FK Rubin,9090,8,5,5,10,22,22,0,20
Rostov,9090,9,4,6,10,11,21,-10,18
Amkar,9090,10,4,5,11,10,24,-14,17
Anzhi,9090,11,2,6,12,15,40,-25,12
Loko Moscow,9091,1,12,6,2,31,11,20,42
Spart Moscow,9091,2,10,6,4,37,26,11,36
CSKA Moscow,9091,3,11,3,6,28,19,9,36
Zenit,9091,4,8,9,3,23,13,10,33
Krasnodar,9091,5,8,4,8,28,28,0,28
Terek Grozny,9091,6,7,7,6,22,24,-2,28
FK Rubin,9091,7,6,6,8,24,19,5,24
Din Moscow,9091,8,5,7,8,18,24,-6,22
Rostov,9091,9,4,7,9,10,17,-7,19
Amkar,9091,10,4,5,11,11,25,-14,17
Anzhi,9091,11,2,6,12,15,41,-26,12
Loko Moscow,9092,1,12,6,2,32,13,19,42
CSKA Moscow,9092,2,12,3,5,28,17,11,39
Spart Moscow,9092,3,9,7,4,36,25,11,34
Krasnodar,9092,4,9,5,6,30,26,4,32
Zenit,9092,5,7,8,5,21,15,6,29
Terek Grozny,9092,6,7,6,7,23,26,-3,27
Din Moscow,9092,7,5,7,8,18,25,-7,22
FK Rubin,9092,8,5,6,9,22,19,3,21
Rostov,9092,9,4,7,9,10,17,-7,19
Amkar,9092,10,4,6,10,10,23,-13,18
Anzhi,9092,11,3,5,12,17,41,-24,14
Loko Moscow,9093,1,12,5,3,34,15,19,41
CSKA Moscow,9093,2,12,3,5,28,18,10,39
Spart Moscow,9093,3,10,5,5,38,27,11,35
Zenit,9093,4,8,8,4,24,16,8,32
Terek Grozny,9093,5,8,5,7,23,26,-3,29
Krasnodar,9093,6,8,4,8,29,29,0,28
FK Rubin,9093,7,6,6,8,22,17,5,24
Din Moscow,9093,8,5,7,8,17,23,-6,22
Amkar,9093,9,5,4,11,11,24,-13,19
Rostov,9093,10,4,6,10,11,20,-9,18
Anzhi,9093,11,3,5,12,17,39,-22,14
Loko Moscow,9094,1,11,7,2,31,13,18,40
CSKA Moscow,9094,2,11,3,6,29,25,4,36
Zenit,9094,3,8,9,3,28,15,13,33
Spart Moscow,9094,4,9,5,6,36,28,8,32
Krasnodar,9094,5,9,5,6,30,26,4,32
Terek Grozny,9094,6,8,5,7,23,28,-5,29
Din Moscow,9094,7,7,6,7,19,21,-2,27
Rostov,9094,8,5,6,9,11,17,-6,21
FK Rubin,9094,9,5,5,10,22,20,2,20
Amkar,9094,10,4,4,12,10,27,-17,16
Anzhi,9094,11,3,5,12,22,41,-19,14
Loko Moscow,9095,1,11,6,3,31,14,17,39
CSKA Moscow,9095,2,11,3,6,29,20,9,36
Spart Moscow,9095,3,10,5,5,38,28,10,35
Zenit,9095,4,9,8,3,25,15,10,35
Terek Grozny,9095,5,8,6,6,23,24,-1,30
Krasnodar,9095,6,8,5,7,30,28,2,29
FK Rubin,9095,7,6,6,8,25,20,5,24
Din Moscow,9095,8,5,7,8,19,25,-6,22
Rostov,9095,9,5,6,9,12,17,-5,21
Amkar,9095,10,4,5,11,10,25,-15,17
Anzhi,9095,11,2,5,13,16,42,-26,11
Loko Moscow,9096,1,11,6,3,32,15,17,39
CSKA Moscow,9096,2,11,4,5,29,19,10,37
Spart Moscow,9096,3,9,6,5,36,28,8,33
Krasnodar,9096,4,9,5,6,31,27,4,32
Zenit,9096,5,7,10,3,24,16,8,31
Terek Grozny,9096,6,7,6,7,24,27,-3,27
FK Rubin,9096,7,6,6,8,25,20,5,24
Din Moscow,9096,8,5,7,8,19,24,-5,22
Amkar,9096,9,5,5,10,13,24,-11,20
Rostov,9096,10,4,6,10,10,19,-9,18
Anzhi,9096,11,3,5,12,18,42,-24,14
Loko Moscow,9097,1,12,5,3,32,13,19,41
CSKA Moscow,9097,2,11,3,6,28,18,10,36
Spart Moscow,9097,3,9,6,5,37,27,10,33
Zenit,9097,4,8,8,4,22,15,7,32
Krasnodar,9097,5,9,5,6,31,27,4,32
Terek Grozny,9097,6,7,6,7,20,23,-3,27
FK Rubin,9097,7,6,6,8,25,19,6,24
Din Moscow,9097,8,5,7,8,17,23,-6,22
Amkar,9097,9,6,4,10,11,22,-11,22
Rostov,9097,10,4,6,10,11,21,-10,18
Anzhi,9097,11,2,6,12,14,40,-26,12
Loko Moscow,9098,1,12,6,2,32,12,20,42
CSKA Moscow,9098,2,11,4,5,28,19,9,37
Spart Moscow,9098,3,10,5,5,39,29,10,35
Zenit,9098,4,7,9,4,23,17,6,30
Krasnodar,9098,5,8,6,6,30,27,3,30
Terek Grozny,9098,6,7,6,7,21,24,-3,27
Din Moscow,9098,7,6,6,8,20,24,-4,24
FK Rubin,9098,8,5,6,9,23,20,3,21
Amkar,9098,9,5,5,10,11,22,-11,20
Rostov,9098,10,4,6,10,10,20,-10,18
Anzhi,9098,11,3,5,12,16,39,-23,14
Spart Moscow,9099,1,11,5,4,40,27,13,38
Loko Moscow,9099,2,11,5,4,32,19,13,38
CSKA Moscow,9099,3,11,4,5,33,18,15,37
Krasnodar,9099,4,10,4,6,34,26,8,34
Zenit,9099,5,8,9,3,26,16,10,33
Terek Grozny,9099,6,8,5,7,25,26,-1,29
Din Moscow,9099,7,5,7,8,17,23,-6,22
FK Rubin,9099,8,5,6,9,22,20,2,21
Amkar,9099,9,5,4,11,12,26,-14,19
Rostov,9099,10,4,6,10,10,18,-8,18
Anzhi,9099,11,2,5,13,17,49,-32,11
Loko Moscow,9100,1,13,5,2,34,12,22,44
Spart Moscow,9100,2,11,5,4,42,28,14,38
CSKA Moscow,9100,3,11,3,6,27,18,9,36
Zenit,9100,4,8,8,4,23,16,7,32
Krasnodar,9100,5,9,4,7,30,26,4,31
Terek Grozny,9100,6,7,5,8,20,25,-5,26
Din Moscow,9100,7,5,7,8,18,25,-7,22
FK Rubin,9100,8,5,6,9,22,21,1,21
Amkar,9100,9,5,4,11,12,25,-13,19
Rostov,9100,10,4,6,10,11,20,-9,18
Anzhi,9100,11,3,5,12,16,39,-23,14
Loko Moscow,9101,1,12,6,2,30,11,19,42
CSKA Moscow,9101,2,12,3,5,32,19,13,39
Spart Moscow,9101,3,10,6,4,38,26,12,36
Terek Grozny,9101,4,9,5,6,25,23,2,32
Krasnodar,9101,5,9,4,7,30,25,5,31
Zenit,9101,6,7,9,4,22,16,6,30
FK Rubin,9101,7,6,5,9,24,21,3,23
Din Moscow,9101,8,5,6,9,18,27,-9,21
Rostov,9101,9,4,6,10,11,19,-8,18
Amkar,9101,10,4,5,11,9,24,-15,17
Anzhi,9101,11,2,5,13,16,44,-28,11
Loko Moscow,9102,1,12,6,2,31,12,19,42
Spart Moscow,9102,2,10,6,4,36,25,11,36
CSKA Moscow,9102,3,10,4,6,26,19,7,34
Zenit,9102,4,8,8,4,22,14,8,32
Krasnodar,9102,5,9,5,6,29,25,4,32
Terek Grozny,9102,6,8,6,6,24,23,1,30
Din Moscow,9102,7,6,7,7,20,21,-1,25
FK Rubin,9102,8,5,5,10,21,21,0,20
Rostov,9102,9,4,6,10,10,19,-9,18
Amkar,9102,10,4,5,11,9,23,-14,17
Anzhi,9102,11,2,6,12,16,42,-26,12
Loko Moscow,9103,1,11,6,3,29,13,16,39
Spart Moscow,9103,2,10,6,4,38,26,12,36
CSKA Moscow,9103,3,10,4,6,25,18,7,34
Krasnodar,9103,4,9,5,6,31,26,5,32
Zenit,9103,5,7,10,3,21,13,8,31
Terek Grozny,9103,6,8,6,6,22,23,-1,30
FK Rubin,9103,7,5,7,8,24,20,4,22
Din Moscow,9103,8,5,7,8,18,23,-5,22
Rostov,9103,9,4,7,9,10,17,-7,19
Amkar,9103,10,4,4,12,10,27,-17,16
Anzhi,9103,11,3,6,11,16,38,-22,15
Loko Moscow,9104,1,11,7,2,31,13,18,40
Spart Moscow,9104,2,10,6,4,39,29,10,36
CSKA Moscow,9104,3,11,3,6,26,18,8,36
Zenit,9104,4,8,9,3,22,13,9,33
Krasnodar,9104,5,9,5,6,31,26,5,32
Terek Grozny,9104,6,7,5,8,20,25,-5,26
FK Rubin,9104,7,6,5,9,23,20,3,23
Din Moscow,9104,8,5,6,9,19,25,-6,21
Amkar,9104,9,5,5,10,11,23,-12,20
Rostov,9104,10,4,6,10,12,20,-8,18
Anzhi,9104,11,3,5,12,16,38,-22,14
Loko Moscow,9105,1,12,5,3,30,12,18,41
CSKA Moscow,9105,2,12,3,5,27,17,10,39
Spart Moscow,9105,3,11,5,4,43,27,16,38
Krasnodar,9105,4,10,4,6,30,24,6,34
Zenit,9105,5,7,8,5,21,15,6,29
Terek Grozny,9105,6,8,5,7,21,23,-2,29
FK Rubin,9105,7,6,5,9,25,20,5,23
Din Moscow,9105,8,5,6,9,18,29,-11,21
Amkar,9105,9,5,4,11,11,24,-13,19
Rostov,9105,10,4,6,10,11,21,-10,18
Anzhi,9105,11,2,5,13,14,39,-25,11
Loko Moscow,9106,1,13,5,2,32,12,20,44
Spart Moscow,9106,2,9,7,4,38,28,10,34
CSKA Moscow,9106,3,10,4,6,26,19,7,34
Zenit,9106,4,7,9,4,21,14,7,30
Krasnodar,9106,5,8,5,7,30,28,2,29
Terek Grozny,9106,6,7,6,7,21,25,-4,27
Din Moscow,9106,7,6,7,7,19,22,-3,25
FK Rubin,9106,8,5,6,9,23,20,3,21
Rostov,9106,9,4,6,10,11,20,-9,18
Amkar,9106,10,4,6,10,10,23,-13,18
Anzhi,9106,11,4,5,11,19,39,-20,17
Loko Moscow,9107,1,11,6,3,29,14,15,39
CSKA Moscow,9107,2,11,4,5,27,18,9,37
Spart Moscow,9107,3,9,6,5,38,29,9,33
Zenit,9107,4,8,8,4,24,14,10,32
Krasnodar,9107,5,8,6,6,27,24,3,30
Terek Grozny,9107,6,8,5,7,22,23,-1,29
Din Moscow,9107,7,6,7,7,19,22,-3,25
FK Rubin,9107,8,5,7,8,21,17,4,22
Amkar,9107,9,5,5,10,11,23,-12,20
Rostov,9107,10,4,6,10,11,20,-9,18
Anzhi,9107,11,2,6,12,15,40,-25,12
Loko Moscow,9108,1,11,7,2,30,12,18,40
CSKA Moscow,9108,2,11,3,6,27,20,7,36
Zenit,9108,3,8,9,3,25,14,11,33
Krasnodar,9108,4,9,5,6,28,24,4,32
Spart Moscow,9108,5,8,7,5,34,29,5,31
Terek Grozny,9108,6,7,6,7,20,24,-4,27
Din Moscow,9108,7,5,8,7,17,21,-4,23
FK Rubin,9108,8,5,6,9,21,18,3,21
Amkar,9108,9,5,5,10,13,23,-10,20
Rostov,9108,10,4,7,9,10,17,-7,19
Anzhi,9108,11,3,5,12,16,39,-23,14
Loko Moscow,9109,1,13,5,2,33,11,22,44
CSKA Moscow,9109,2,12,3,5,31,21,10,39
Spart Moscow,9109,3,9,7,4,35,26,9,34
Krasnodar,9109,4,9,4,7,30,26,4,31
Zenit,9109,5,7,8,5,22,17,5,29
Terek Grozny,9109,6,8,5,7,23,24,-1,29
FK Rubin,9109,7,6,5,9,24,21,3,23
Din Moscow,9109,8,5,7,8,19,25,-6,22
Rostov,9109,9,4,7,9,10,17,-7,19
Amkar,9109,10,4,4,12,9,25,-16,16
Anzhi,9109,11,3,5,12,19,42,-23,14
Loko Moscow,9110,1,12,6,2,32,13,19,42
CSKA Moscow,9110,2,12,3,5,35,19,16,39
Spart Moscow,9110,3,9,5,6,38,32,6,32
Terek Grozny,9110,4,9,5,6,24,23,1,32
Krasnodar,9110,5,8,6,6,30,27,3,30
Zenit,9110,6,7,8,5,22,20,2,29
Din Moscow,9110,7,6,7,7,20,22,-2,25
FK Rubin,9110,8,5,7,8,23,19,4,22
Amkar,9110,9,5,4,11,12,25,-13,19
Rostov,9110,10,4,6,10,13,21,-8,18
Anzhi,9110,11,2,5,13,15,43,-28,11
Loko Moscow,9111,1,12,6,2,33,12,21,42
CSKA Moscow,9111,2,10,4,6,25,18,7,34
Krasnodar,9111,3,9,5,6,32,25,7,32
Zenit,9111,4,8,8,4,22,16,6,32
Spart Moscow,9111,5,8,6,6,36,31,5,30
Terek Grozny,9111,6,8,5,7,21,23,-2,29
Din Moscow,9111,7,6,7,7,19,22,-3,25
FK Rubin,9111,8,5,6,9,21,21,0,21
Rostov,9111,9,5,6,9,13,18,-5,21
Amkar,9111,10,4,5,11,10,24,-14,17
Anzhi,9111,11,3,6,11,15,37,-22,15
Loko Moscow,9112,1,12,6,2,32,12,20,42
Spart Moscow,9112,2,10,5,5,38,27,11,35
CSKA Moscow,9112,3,10,4,6,25,18,7,34
Zenit,9112,4,8,9,3,22,13,9,33
Krasnodar,9112,5,9,4,7,30,28,2,31
Terek Grozny,9112,6,8,5,7,22,23,-1,29
Din Moscow,9112,7,6,7,7,19,22,-3,25
FK Rubin,9112,8,5,6,9,22,19,3,21
Rostov,9112,9,4,6,10,10,18,-8,18
Amkar,9112,10,4,4,12,9,27,-18,16
Anzhi,9112,11,3,6,11,15,37,-22,15
Loko Moscow,9113,1,11,5,4,29,14,15,38
CSKA Moscow,9113,2,11,3,6,27,20,7,36
Zenit,9113,3,9,8,3,25,13,12,35
Spart Moscow,9113,4,9,6,5,34,27,7,33
Krasnodar,9113,5,9,5,6,30,25,5,32
Terek Grozny,9113,6,7,7,6,20,22,-2,28
FK Rubin,9113,7,5,7,8,23,19,4,22
Din Moscow,9113,8,5,7,8,18,23,-5,22
Rostov,9113,9,5,6,9,12,17,-5,21
Amkar,9113,10,4,6,10,9,22,-13,18
Anzhi,9113,11,2,6,12,14,39,-25,12
Spart Moscow,9114,1,11,5,4,41,26,15,38
Loko Moscow,9114,2,11,5,4,31,17,14,38
CSKA Moscow,9114,3,11,4,5,28,19,9,37
Krasnodar,9114,4,10,4,6,33,26,7,34
Zenit,9114,5,8,8,4,25,16,9,32
Terek Grozny,9114,6,8,5,7,25,23,2,29
Din Moscow,9114,7,6,6,8,18,23,-5,24
FK Rubin,9114,8,5,5,10,22,21,1,20
Amkar,9114,9,5,4,11,11,24,-13,19
Rostov,9114,10,4,6,10,10,21,-11,18
Anzhi,9114,11,2,6,12,15,43,-28,12
Loko Moscow,9115,1,12,6,2,32,12,20,42
CSKA Moscow,9115,2,12,3,5,29,18,11,39
Spart Moscow,9115,3,10,5,5,38,28,10,35
Krasnodar,9115,4,9,5,6,30,25,5,32
Zenit,9115,5,7,8,5,21,16,5,29
Terek Grozny,9115,6,7,7,6,20,22,-2,28
FK Rubin,9115,7,6,5,9,24,20,4,23
Rostov,9115,8,5,6,9,12,18,-6,21
Din Moscow,9115,9,5,6,9,18,26,-8,21
Amkar,9115,10,4,5,11,10,24,-14,17
Anzhi,9115,11,2,6,12,15,40,-25,12
Loko Moscow,9116,1,12,5,3,31,12,19,41
CSKA Moscow,9116,2,12,3,5,29,17,12,39
Spart Moscow,9116,3,9,6,5,37,28,9,33
Zenit,9116,4,8,8,4,22,14,8,32
Krasnodar,9116,5,9,4,7,29,26,3,31
Terek Grozny,9116,6,8,5,7,23,24,-1,29
Din Moscow,9116,7,6,6,8,20,25,-5,24
FK Rubin,9116,8,6,5,9,24,20,4,23
Rostov,9116,9,4,7,9,10,17,-7,19
Amkar,9116,10,4,4,12,10,28,-18,16
Anzhi,9116,11,3,5,12,16,40,-24,14
Loko Moscow,9117,1,13,5,2,33,13,20,44
CSKA Moscow,9117,2,12,3,5,30,18,12,39
Spart Moscow,9117,3,8,7,5,37,30,7,31
Krasnodar,9117,4,9,4,7,29,26,3,31
Zenit,9117,5,7,8,5,23,17,6,29
Terek Grozny,9117,6,7,5,8,20,24,-4,26
Din Moscow,9117,7,6,7,7,20,23,-3,25
Amkar,9117,8,6,4,10,12,23,-11,22
FK Rubin,9117,9,5,5,10,21,19,2,20
Rostov,9117,10,4,7,9,11,18,-7,19
Anzhi,9117,11,3,5,12,15,40,-25,14
Loko Moscow,9118,1,12,5,3,32,15,17,41
CSKA Moscow,9118,2,11,3,6,26,18,8,36
Zenit,9118,3,9,8,3,26,14,12,35
Spart Moscow,9118,4,9,7,4,39,28,11,34
Krasnodar,9118,5,8,4,8,28,28,0,28
Terek Grozny,9118,6,7,6,7,21,27,-6,27
FK Rubin,9118,7,6,6,8,23,18,5,24
Din Moscow,9118,8,5,7,8,17,24,-7,22
Rostov,9118,9,4,7,9,11,18,-7,19
Amkar,9118,10,4,6,10,12,25,-13,18
Anzhi,9118,11,3,5,12,18,38,-20,14
Loko Moscow,9119,1,11,6,3,29,12,17,39
Spart Moscow,9119,2,10,5,5,39,30,9,35
Krasnodar,9119,3,10,4,6,33,24,9,34
CSKA Moscow,9119,4,10,4,6,26,19,7,34
Zenit,9119,5,8,9,3,22,13,9,33
Terek Grozny,9119,6,8,6,6,22,23,-1,30
Din Moscow,9119,7,6,6,8,20,24,-4,24
FK Rubin,9119,8,5,5,10,22,24,-2,20
Amkar,9119,9,5,5,10,12,24,-12,20
Rostov,9119,10,4,6,10,12,20,-8,18
Anzhi,9119,11,2,6,12,15,39,-24,12
Loko Moscow,9120,1,12,6,2,33,11,22,42
Spart Moscow,9120,2,11,5,4,40,27,13,38
CSKA Moscow,9120,3,11,4,5,29,19,10,37
Zenit,9120,4,7,9,4,23,19,4,30
Krasnodar,9120,5,8,6,6,28,25,3,30
Terek Grozny,9120,6,8,5,7,21,25,-4,29
Din Moscow,9120,7,6,6,8,20,24,-4,24
FK Rubin,9120,8,5,6,9,22,20,2,21
Amkar,9120,9,5,4,11,13,25,-12,19
Rostov,9120,10,4,6,10,10,18,-8,18
Anzhi,9120,11,2,5,13,14,40,-26,11
Loko Moscow,9121,1,13,5,2,33,12,21,44
CSKA Moscow,9121,2,11,4,5,27,18,9,37
Spart Moscow,9121,3,10,6,4,40,26,14,36
Krasnodar,9121,4,9,4,7,30,27,3,31
Zenit,9121,5,7,9,4,23,17,6,30
Terek Grozny,9121,6,8,6,6,24,24,0,30
FK Rubin,9121,7,6,5,9,25,21,4,23
Din Moscow,9121,8,5,6,9,19,26,-7,21
Rostov,9121,9,4,6,10,10,21,-11,18
Amkar,9121,10,4,6,10,10,23,-13,18
Anzhi,9121,11,2,5,13,15,41,-26,11
Loko Moscow,9122,1,12,5,3,33,16,17,41
Spart Moscow,9122,2,10,5,5,39,30,9,35
Krasnodar,9122,3,10,4,6,34,25,9,34
CSKA Moscow,9122,4,10,3,7,29,24,5,33
Zenit,9122,5,8,8,4,25,16,9,32
Din Moscow,9122,6,7,6,7,23,24,-1,27
Terek Grozny,9122,7,7,5,8,21,25,-4,26
FK Rubin,9122,8,5,5,10,23,24,-1,20
Amkar,9122,9,5,4,11,11,24,-13,19
Rostov,9122,10,4,6,10,11,20,-9,18
Anzhi,9122,11,4,5,11,21,42,-21,17
Loko Moscow,9123,1,12,5,3,32,15,17,41
CSKA Moscow,9123,2,11,4,5,27,18,9,37
Spart Moscow,9123,3,9,5,6,37,31,6,32
Krasnodar,9123,4,9,5,6,30,24,6,32
Zenit,9123,5,7,9,4,23,17,6,30
Terek Grozny,9123,6,8,5,7,22,24,-2,29
FK Rubin,9123,7,6,6,8,24,17,7,24
Amkar,9123,8,6,4,10,14,22,-8,22
Rostov,9123,9,5,6,9,12,18,-6,21
Din Moscow,9123,10,5,6,9,17,27,-10,21
Anzhi,9123,11,2,5,13,15,40,-25,11
Loko Moscow,9124,1,11,5,4,30,14,16,38
Zenit,9124,2,9,8,3,23,13,10,35
CSKA Moscow,9124,3,10,4,6,26,19,7,34
Krasnodar,9124,4,10,4,6,32,27,5,34
Spart Moscow,9124,5,8,7,5,36,29,7,31
Terek Grozny,9124,6,8,5,7,22,24,-2,29
Din Moscow,9124,7,6,7,7,22,24,-2,25
Amkar,9124,8,6,4,10,11,22,-11,22
FK Rubin,9124,9,5,5,10,24,23,1,20
Rostov,9124,10,4,7,9,11,18,-7,19
Anzhi,9124,11,2,6,12,16,40,-24,12
Loko Moscow,9125,1,12,6,2,30,11,19,42
CSKA Moscow,9125,2,11,4,5,29,18,11,37
Spart Moscow,9125,3,9,7,4,36,25,11,34
Zenit,9125,4,7,9,4,22,15,7,30
Krasnodar,9125,5,8,5,7,27,25,2,29
Terek Grozny,9125,6,8,5,7,21,25,-4,29
Din Moscow,9125,7,6,7,7,19,22,-3,25
FK Rubin,9125,8,6,5,9,23,19,4,23
Amkar,9125,9,5,5,10,12,22,-10,20
Rostov,9125,10,4,6,10,10,20,-10,18
Anzhi,9125,11,2,5,13,14,41,-27,11
Loko Moscow,9126,1,13,5,2,33,13,20,44
CSKA Moscow,9126,2,12,3,5,31,20,11,39
Spart Moscow,9126,3,10,6,4,38,28,10,36
Krasnodar,9126,4,9,4,7,28,25,3,31
Terek Grozny,9126,5,8,6,6,23,24,-1,30
Zenit,9126,6,7,8,5,25,20,5,29
FK Rubin,9126,7,6,5,9,23,19,4,23
Din Moscow,9126,8,5,6,9,18,24,-6,21
Rostov,9126,9,4,6,10,10,18,-8,18
Amkar,9126,10,4,6,10,14,27,-13,18
Anzhi,9126,11,2,5,13,15,40,-25,11
Loko Moscow,9127,1,12,6,2,32,11,21,42
CSKA Moscow,9127,2,11,3,6,29,21,8,36
Zenit,9127,3,8,8,4,24,17,7,32
Krasnodar,9127,4,9,5,6,31,25,6,32
Spart Moscow,9127,5,8,6,6,36,30,6,30
Terek Grozny,9127,6,8,5,7,22,24,-2,29
Din Moscow,9127,7,6,7,7,20,23,-3,25
Rostov,9127,8,5,6,9,11,17,-6,21
FK Rubin,9127,9,5,5,10,22,22,0,20
Amkar,9127,10,5,4,11,11,25,-14,19
Anzhi,9127,11,3,5,12,17,40,-23,14
Loko Moscow,9128,1,11,6,3,31,15,16,39
CSKA Moscow,9128,2,12,3,5,30,17,13,39
Spart Moscow,9128,3,10,5,5,37,27,10,35
Krasnodar,9128,4,10,4,6,33,25,8,34
Zenit,9128,5,7,9,4,22,16,6,30
Terek Grozny,9128,6,7,7,6,21,23,-2,28
Din Moscow,9128,7,6,6,8,21,23,-2,24
FK Rubin,9128,8,5,5,10,22,24,-2,20
Amkar,9128,9,5,5,10,12,23,-11,20
Rostov,9128,10,4,6,10,10,20,-10,18
Anzhi,9128,11,2,6,12,14,40,-26,12
CSKA Moscow,9129,1,12,3,5,29,17,12,39
Loko Moscow,9129,2,11,5,4,29,15,14,38
Krasnodar,9129,3,10,4,6,30,25,5,34
Spart Moscow,9129,4,9,6,5,35,27,8,33
Zenit,9129,5,8,8,4,24,14,10,32
Terek Grozny,9129,6,9,5,6,23,23,0,32
Din Moscow,9129,7,7,6,7,20,21,-1,27
FK Rubin,9129,8,5,5,10,22,21,1,20
Rostov,9129,9,4,7,9,11,18,-7,19
Amkar,9129,10,4,4,12,10,25,-15,16
Anzhi,9129,11,2,5,13,14,41,-27,11
Loko Moscow,9130,1,12,6,2,31,12,19,42
CSKA Moscow,9130,2,11,3,6,27,19,8,36
Spart Moscow,9130,3,9,7,4,38,27,11,34
Zenit,9130,4,8,8,4,23,14,9,32
Krasnodar,9130,5,8,5,7,28,27,1,29
Terek Grozny,9130,6,8,5,7,24,25,-1,29
FK Rubin,9130,7,7,5,8,24,17,7,26
Din Moscow,9130,8,5,7,8,19,24,-5,22
Rostov,9130,9,4,6,10,10,20,-10,18
Amkar,9130,10,4,5,11,10,25,-15,17
Anzhi,9130,11,3,5,12,16,40,-24,14
Loko Moscow,9131,1,13,5,2,32,12,20,44
Spart Moscow,9131,2,9,7,4,40,26,14,34
CSKA Moscow,9131,3,10,4,6,26,20,6,34
Zenit,9131,4,8,8,4,24,15,9,32
Krasnodar,9131,5,8,4,8,27,26,1,28
Terek Grozny,9131,6,7,6,7,21,24,-3,27
FK Rubin,9131,7,6,6,8,24,19,5,24
Din Moscow,9131,8,5,8,7,19,23,-4,23
Amkar,9131,9,4,6,10,10,23,-13,18
Rostov,9131,9,4,6,10,10,23,-13,18
Anzhi,9131,11,3,6,11,17,39,-22,15
Loko Moscow,9132,1,12,5,3,31,15,16,41
Zenit,9132,2,9,8,3,25,13,12,35
CSKA Moscow,9132,3,10,4,6,27,20,7,34
Spart Moscow,9132,4,9,6,5,39,30,9,33
Krasnodar,9132,5,9,4,7,32,27,5,31
Terek Grozny,9132,6,7,5,8,20,26,-6,26
Din Moscow,9132,7,6,7,7,21,24,-3,25
FK Rubin,9132,8,5,6,9,23,22,1,21
Rostov,9132,9,4,7,9,11,18,-7,19
Amkar,9132,10,5,4,11,11,25,-14,19
Anzhi,9132,11,3,6,11,19,39,-20,15
Loko Moscow,9133,1,12,6,2,33,14,19,42
Spart Moscow,9133,2,10,6,4,38,26,12,36
CSKA Moscow,9133,3,11,3,6,28,21,7,36
Zenit,9133,4,7,9,4,24,17,7,30
Terek Grozny,9133,5,8,6,6,22,23,-1,30
Krasnodar,9133,6,8,5,7,28,26,2,29
FK Rubin,9133,7,5,7,8,22,18,4,22
Din Moscow,9133,8,5,7,8,17,22,-5,22
Rostov,9133,9,4,6,10,10,20,-10,18
Amkar,9133,10,4,5,11,10,24,-14,17
Anzhi,9133,11,3,6,11,19,40,-21,15
Loko Moscow,9134,1,11,5,4,31,15,16,38
CSKA Moscow,9134,2,11,3,6,28,20,8,36
Spart Moscow,9134,3,10,5,5,40,30,10,35
Zenit,9134,4,8,8,4,24,16,8,32
Krasnodar,9134,5,9,4,7,30,27,3,31
Terek Grozny,9134,6,7,5,8,21,26,-5,26
Din Moscow,9134,7,6,7,7,22,25,-3,25
FK Rubin,9134,8,6,6,8,25,20,5,24
Amkar,9134,9,5,4,11,13,25,-12,19
Rostov,9134,10,4,6,10,11,20,-9,18
Anzhi,9134,11,4,5,11,17,38,-21,17
Loko Moscow,9135,1,12,6,2,32,13,19,42
CSKA Moscow,9135,2,10,4,6,26,19,7,34
Spart Moscow,9135,3,9,6,5,37,27,10,33
Zenit,9135,4,8,8,4,24,16,8,32
Krasnodar,9135,5,9,5,6,30,26,4,32
Terek Grozny,9135,6,8,6,6,22,23,-1,30
FK Rubin,9135,7,6,5,9,23,19,4,23
Din Moscow,9135,8,5,6,9,17,25,-8,21
Amkar,9135,9,5,5,10,11,23,-12,20
Rostov,9135,10,4,7,9,10,17,-7,19
Anzhi,9135,11,2,6,12,15,39,-24,12
Loko Moscow,9136,1,11,7,2,30,12,18,40
Spart Moscow,9136,2,11,5,4,37,25,12,38
CSKA Moscow,9136,3,11,4,5,26,17,9,37
Zenit,9136,4,7,10,3,21,13,8,31
Krasnodar,9136,5,8,6,6,29,26,3,30
Terek Grozny,9136,6,8,6,6,23,24,-1,30
Din Moscow,9136,7,6,6,8,19,22,-3,24
FK Rubin,9136,8,5,6,9,22,20,2,21
Rostov,9136,9,4,6,10,10,19,-9,18
Amkar,9136,10,4,5,11,10,24,-14,17
Anzhi,9136,11,2,5,13,15,40,-25,11
Loko Moscow,9137,1,11,6,3,33,16,17,39
Zenit,9137,2,9,8,3,24,14,10,35
CSKA Moscow,9137,3,10,4,6,25,18,7,34
Terek Grozny,9137,4,8,6,6,24,25,-1,30
Spart Moscow,9137,5,8,5,7,36,32,4,29
Krasnodar,9137,6,8,5,7,32,30,2,29
Din Moscow,9137,7,6,7,7,21,23,-2,25
FK Rubin,9137,8,6,6,8,25,20,5,24
Rostov,9137,9,5,6,9,11,17,-6,21
Amkar,9137,10,5,4,11,13,26,-13,19
Anzhi,9137,11,2,7,11,16,39,-23,13
Loko Moscow,9138,1,12,5,3,30,13,17,41
Spart Moscow,9138,2,10,6,4,44,28,16,36
Zenit,9138,3,9,8,3,25,14,11,35
CSKA Moscow,9138,4,10,3,7,26,20,6,33
Terek Grozny,9138,5,9,5,6,23,22,1,32
Krasnodar,9138,6,8,5,7,30,28,2,29
Din Moscow,9138,7,6,6,8,18,27,-9,24
FK Rubin,9138,8,5,6,9,24,21,3,21
Rostov,9138,9,4,6,10,11,20,-9,18
Amkar,9138,10,4,5,11,11,26,-15,17
Anzhi,9138,11,3,5,12,15,38,-23,14
Loko Moscow,9139,1,12,6,2,31,11,20,42
CSKA Moscow,9139,2,11,4,5,32,18,14,37
Spart Moscow,9139,3,10,5,5,39,30,9,35
Zenit,9139,4,7,10,3,22,14,8,31
Krasnodar,9139,5,9,4,7,28,26,2,31
Terek Grozny,9139,6,7,5,8,20,25,-5,26
Din Moscow,9139,7,6,6,8,19,24,-5,24
Rostov,9139,8,5,6,9,13,18,-5,21
FK Rubin,9139,9,5,5,10,21,19,2,20
Amkar,9139,10,5,4,11,12,24,-12,19
Anzhi,9139,11,3,5,12,15,43,-28,14
Loko Moscow,9140,1,12,5,3,31,13,18,41
CSKA Moscow,9140,2,12,3,5,28,17,11,39
Spart Moscow,9140,3,10,6,4,38,26,12,36
Krasnodar,9140,4,9,4,7,29,26,3,31
Zenit,9140,5,7,8,5,21,15,6,29
Terek Grozny,9140,6,8,5,7,23,26,-3,29
FK Rubin,9140,7,6,6,8,24,19,5,24
Din Moscow,9140,8,5,8,7,20,24,-4,23
Amkar,9140,9,5,4,11,12,23,-11,19
Rostov,9140,10,4,6,10,10,20,-10,18
Anzhi,9140,11,2,5,13,15,42,-27,11
Loko Moscow,9141,1,11,5,4,30,15,15,38
Zenit,9141,2,9,8,3,26,16,10,35
Spart Moscow,9141,3,10,5,5,35,26,9,35
CSKA Moscow,9141,4,10,4,6,27,20,7,34
Krasnodar,9141,5,9,4,7,29,26,3,31
Terek Grozny,9141,6,7,5,8,20,27,-7,26
FK Rubin,9141,7,6,6,8,24,18,6,24
Din Moscow,9141,8,5,7,8,18,23,-5,22
Rostov,9141,9,5,6,9,11,17,-6,21
Amkar,9141,10,5,4,11,10,23,-13,19
Anzhi,9141,11,3,6,11,18,37,-19,15
Loko Moscow,9142,1,11,7,2,30,12,18,40
CSKA Moscow,9142,2,11,4,5,30,21,9,37
Spart Moscow,9142,3,10,6,4,43,29,14,36
Zenit,9142,4,7,9,4,23,16,7,30
Krasnodar,9142,5,8,6,6,28,25,3,30
Terek Grozny,9142,6,7,5,8,20,25,-5,26
Din Moscow,9142,7,6,7,7,22,25,-3,25
FK Rubin,9142,8,5,6,9,22,19,3,21
Amkar,9142,9,5,4,11,10,24,-14,19
Rostov,9142,10,4,6,10,10,21,-11,18
Anzhi,9142,11,3,6,11,19,40,-21,15
Loko Moscow,9143,1,12,6,2,31,12,19,42
CSKA Moscow,9143,2,11,3,6,29,22,7,36
Spart Moscow,9143,3,9,6,5,38,29,9,33
Zenit,9143,4,8,8,4,24,15,9,32
Krasnodar,9143,5,9,5,6,34,26,8,32
Terek Grozny,9143,6,7,6,7,20,26,-6,27
FK Rubin,9143,7,6,5,9,23,23,0,23
Din Moscow,9143,8,5,6,9,18,25,-7,21
Amkar,9143,9,5,5,10,11,23,-12,20
Rostov,9143,10,4,7,9,11,18,-7,19
Anzhi,9143,11,3,5,12,20,40,-20,14
Loko Moscow,9144,1,12,5,3,32,14,18,41
Zenit,9144,2,9,8,3,25,14,11,35
CSKA Moscow,9144,3,10,4,6,26,19,7,34
Spart Moscow,9144,4,8,7,5,35,28,7,31
Krasnodar,9144,5,9,4,7,30,27,3,31
Terek Grozny,9144,6,7,6,7,21,24,-3,27
Din Moscow,9144,7,5,8,7,18,22,-4,23
Amkar,9144,8,6,4,10,13,24,-11,22
FK Rubin,9144,9,5,6,9,21,19,2,21
Rostov,9144,10,4,7,9,10,17,-7,19
Anzhi,9144,11,2,7,11,14,37,-23,13
Loko Moscow,9145,1,11,7,2,32,14,18,40
CSKA Moscow,9145,2,11,4,5,29,17,12,37
Krasnodar,9145,3,9,5,6,33,26,7,32
Zenit,9145,4,7,10,3,22,14,8,31
Spart Moscow,9145,5,8,7,5,35,28,7,31
Terek Grozny,9145,6,8,5,7,21,23,-2,29
Din Moscow,9145,7,5,8,7,17,21,-4,23
FK Rubin,9145,8,5,6,9,21,21,0,21
Rostov,9145,9,4,7,9,11,18,-7,19
Amkar,9145,10,5,4,11,11,24,-13,19
Anzhi,9145,11,3,5,12,15,41,-26,14
Loko Moscow,9146,1,11,7,2,30,12,18,40
CSKA Moscow,9146,2,11,4,5,27,18,9,37
Spart Moscow,9146,3,10,6,4,38,28,10,36
Zenit,9146,4,7,10,3,21,13,8,31
Krasnodar,9146,5,8,6,6,28,25,3,30
Terek Grozny,9146,6,7,6,7,22,26,-4,27
Din Moscow,9146,7,6,6,8,22,24,-2,24
FK Rubin,9146,8,5,6,9,21,20,1,21
Amkar,9146,9,5,5,10,13,24,-11,20
Rostov,9146,10,4,6,10,10,18,-8,18
Anzhi,9146,11,2,6,12,16,40,-24,12
Loko Moscow,9147,1,12,6,2,32,12,20,42
CSKA Moscow,9147,2,11,3,6,26,18,8,36
Spart Moscow,9147,3,8,8,4,36,28,8,32
Krasnodar,9147,4,9,5,6,29,25,4,32
Terek Grozny,9147,5,8,6,6,23,24,-1,30
Zenit,9147,6,7,8,5,21,16,5,29
Din Moscow,9147,7,6,7,7,19,22,-3,25
FK Rubin,9147,8,5,5,10,21,19,2,20
Rostov,9147,9,4,7,9,11,18,-7,19
Amkar,9147,10,4,6,10,11,24,-13,18
Anzhi,9147,11,3,5,12,16,39,-23,14
Loko Moscow,9148,1,13,5,2,33,11,22,44
CSKA Moscow,9148,2,11,3,6,27,19,8,36
Spart Moscow,9148,3,9,6,5,39,27,12,33
Zenit,9148,4,8,8,4,23,15,8,32
Krasnodar,9148,5,8,5,7,27,26,1,29
Terek Grozny,9148,6,7,5,8,21,30,-9,26
Din Moscow,9148,7,5,8,7,18,22,-4,23
FK Rubin,9148,8,5,7,8,21,17,4,22
Amkar,9148,9,6,4,10,13,22,-9,22
Rostov,9148,10,4,6,10,10,22,-12,18
Anzhi,9148,11,3,5,12,19,40,-21,14
Loko Moscow,9149,1,12,5,3,33,13,20,41
CSKA Moscow,9149,2,11,4,5,32,21,11,37
Zenit,9149,3,8,9,3,24,15,9,33
Spart Moscow,9149,4,9,5,6,39,28,11,32
Krasnodar,9149,5,9,4,7,31,29,2,31
Terek Grozny,9149,6,8,5,7,22,26,-4,29
Din Moscow,9149,7,6,6,8,20,27,-7,24
Rostov,9149,8,5,6,9,11,17,-6,21
FK Rubin,9149,9,5,5,10,22,22,0,20
Amkar,9149,10,5,4,11,10,23,-13,19
Anzhi,9149,11,3,5,12,20,43,-23,14
Loko Moscow,9150,1,13,5,2,32,12,20,44
Spart Moscow,9150,2,11,5,4,40,27,13,38
CSKA Moscow,9150,3,11,3,6,28,19,9,36
Zenit,9150,4,8,8,4,23,15,8,32
Krasnodar,9150,5,9,4,7,32,26,6,31
Terek Grozny,9150,6,8,5,7,25,24,1,29
Din Moscow,9150,7,5,7,8,18,24,-6,22
FK Rubin,9150,8,5,6,9,22,22,0,21
Rostov,9150,9,4,6,10,12,20,-8,18
Amkar,9150,10,4,4,12,9,28,-19,16
Anzhi,9150,11,3,5,12,16,40,-24,14
Loko Moscow,9151,1,11,6,3,31,15,16,39
CSKA Moscow,9151,2,11,3,6,28,21,7,36
Spart Moscow,9151,3,10,5,5,36,27,9,35
Zenit,9151,4,8,9,3,26,15,11,33
Terek Grozny,9151,5,9,5,6,23,22,1,32
Krasnodar,9151,6,9,4,7,29,25,4,31
Din Moscow,9151,7,6,7,7,19,22,-3,25
FK Rubin,9151,8,6,6,8,23,18,5,24
Rostov,9151,9,4,6,10,11,19,-8,18
Amkar,9151,10,4,4,12,9,24,-15,16
Anzhi,9151,11,2,5,13,15,42,-27,11
Loko Moscow,9152,1,12,6,2,31,11,20,42
Spart Moscow,9152,2,10,6,4,41,27,14,36
CSKA Moscow,9152,3,10,4,6,27,20,7,34
Zenit,9152,4,8,9,3,23,14,9,33
Terek Grozny,9152,5,8,5,7,23,25,-2,29
Krasnodar,9152,6,8,4,8,27,27,0,28
FK Rubin,9152,7,6,6,8,23,18,5,24
Din Moscow,9152,8,5,7,8,18,27,-9,22
Rostov,9152,9,4,7,9,11,18,-7,19
Amkar,9152,10,5,4,11,12,25,-13,19
Anzhi,9152,11,2,6,12,16,40,-24,12
Loko Moscow,9153,1,12,5,3,31,12,19,41
CSKA Moscow,9153,2,11,3,6,28,21,7,36
Zenit,9153,3,8,8,4,25,16,9,32
Spart Moscow,9153,4,8,8,4,37,29,8,32
Krasnodar,9153,5,9,5,6,30,26,4,32
Terek Grozny,9153,6,7,5,8,21,27,-6,26
Din Moscow,9153,7,6,7,7,20,23,-3,25
FK Rubin,9153,8,5,6,9,23,20,3,21
Amkar,9153,9,5,5,10,14,25,-11,20
Rostov,9153,10,4,7,9,10,17,-7,19
Anzhi,9153,11,3,5,12,16,39,-23,14
Loko Moscow,9154,1,12,5,3,31,14,17,41
CSKA Moscow,9154,2,11,4,5,30,18,12,37
Spart Moscow,9154,3,10,5,5,40,28,12,35
Krasnodar,9154,4,9,4,7,30,26,4,31
Zenit,9154,5,7,9,4,22,15,7,30
Terek Grozny,9154,6,7,5,8,22,26,-4,26
FK Rubin,9154,7,6,6,8,22,17,5,24
Din Moscow,9154,8,5,7,8,17,23,-6,22
Amkar,9154,9,6,4,10,12,23,-11,22
Rostov,9154,10,4,6,10,11,21,-10,18
Anzhi,9154,11,3,5,12,17,43,-26,14
Loko Moscow,9155,1,12,5,3,32,14,18,41
Spart Moscow,9155,2,10,6,4,41,28,13,36
CSKA Moscow,9155,3,10,4,6,26,22,4,34
Zenit,9155,4,8,8,4,25,15,10,32
Krasnodar,9155,5,9,5,6,31,26,5,32
Terek Grozny,9155,6,8,5,7,22,23,-1,29
Din Moscow,9155,7,6,6,8,18,24,-6,24
FK Rubin,9155,8,5,6,9,22,19,3,21
Rostov,9155,9,4,6,10,11,20,-9,18
Amkar,9155,10,4,5,11,11,26,-15,17
Anzhi,9155,11,3,6,11,16,38,-22,15
Loko Moscow,9156,1,13,5,2,34,12,22,44
CSKA Moscow,9156,2,10,4,6,26,19,7,34
Zenit,9156,3,8,8,4,22,16,6,32
Krasnodar,9156,4,9,4,7,30,27,3,31
Spart Moscow,9156,5,8,6,6,37,32,5,30
Terek Grozny,9156,6,8,6,6,22,23,-1,30
Din Moscow,9156,7,6,7,7,19,22,-3,25
Rostov,9156,8,5,6,9,12,18,-6,21
FK Rubin,9156,9,5,5,10,22,20,2,20
Amkar,9156,10,5,5,10,14,25,-11,20
Anzhi,9156,11,2,6,12,15,39,-24,12
Loko Moscow,9157,1,13,5,2,31,11,20,44
Spart Moscow,9157,2,9,6,5,37,29,8,33
CSKA Moscow,9157,3,10,3,7,26,20,6,33
Zenit,9157,4,8,8,4,22,14,8,32
Terek Grozny,9157,5,9,5,6,24,24,0,32
Krasnodar,9157,6,8,4,8,27,27,0,28
FK Rubin,9157,7,7,5,8,24,17,7,26
Din Moscow,9157,8,5,7,8,18,23,-5,22
Rostov,9157,9,5,6,9,12,18,-6,21
Amkar,9157,10,4,4,12,11,26,-15,16
Anzhi,9157,11,3,5,12,17,40,-23,14
Loko Moscow,9158,1,13,5,2,32,12,20,44
CSKA Moscow,9158,2,12,3,5,29,18,11,39
Spart Moscow,9158,3,8,7,5,36,30,6,31
Zenit,9158,4,7,8,5,22,16,6,29
Krasnodar,9158,5,8,5,7,29,27,2,29
Terek Grozny,9158,6,8,5,7,24,24,0,29
Din Moscow,9158,7,5,8,7,20,24,-4,23
FK Rubin,9158,8,5,7,8,24,20,4,22
Rostov,9158,9,5,6,9,12,17,-5,21
Amkar,9158,10,4,5,11,11,27,-16,17
Anzhi,9158,11,3,5,12,16,40,-24,14
Loko Moscow,9159,1,11,5,4,30,14,16,38
CSKA Moscow,9159,2,11,3,6,26,19,7,36
Spart Moscow,9159,3,9,7,4,37,28,9,34
Krasnodar,9159,4,10,4,6,31,26,5,34
Zenit,9159,5,8,8,4,22,14,8,32
Terek Grozny,9159,6,8,5,7,21,25,-4,29
Din Moscow,9159,7,6,7,7,20,23,-3,25
FK Rubin,9159,8,5,5,10,22,20,2,20
Rostov,9159,9,4,7,9,10,17,-7,19
Anzhi,9159,10,4,5,11,19,37,-18,17
Amkar,9159,11,4,4,12,10,25,-15,16
Loko Moscow,9160,1,12,5,3,32,12,20,41
Spart Moscow,9160,2,11,5,4,42,30,12,38
CSKA Moscow,9160,3,11,3,6,28,19,9,36
Zenit,9160,4,8,8,4,22,16,6,32
Terek Grozny,9160,5,9,5,6,24,24,0,32
Krasnodar,9160,6,9,4,7,30,27,3,31
FK Rubin,9160,7,6,6,8,24,19,5,24
Din Moscow,9160,8,5,7,8,19,24,-5,22
Rostov,9160,9,4,6,10,10,19,-9,18
Amkar,9160,10,4,4,12,14,29,-15,16
Anzhi,9160,11,2,5,13,15,41,-26,11
Loko Moscow,9161,1,12,5,3,31,15,16,41
Spart Moscow,9161,2,11,5,4,38,26,12,38
CSKA Moscow,9161,3,10,4,6,25,19,6,34
Zenit,9161,4,8,8,4,24,15,9,32
Krasnodar,9161,5,9,4,7,30,25,5,31
Terek Grozny,9161,6,8,5,7,22,23,-1,29
FK Rubin,9161,7,7,5,8,24,17,7,26
Din Moscow,9161,8,5,6,9,18,26,-8,21
Amkar,9161,9,5,4,11,10,23,-13,19
Rostov,9161,10,4,6,10,10,18,-8,18
Anzhi,9161,11,2,6,12,14,39,-25,12
CSKA Moscow,9162,1,12,3,5,29,18,11,39
Loko Moscow,9162,2,11,5,4,30,15,15,38
Spart Moscow,9162,3,10,6,4,36,26,10,36
Zenit,9162,4,8,8,4,22,14,8,32
Krasnodar,9162,5,9,4,7,31,29,2,31
Terek Grozny,9162,6,8,5,7,22,23,-1,29
FK Rubin,9162,7,6,6,8,26,19,7,24
Din Moscow,9162,8,5,7,8,18,23,-5,22
Amkar,9162,9,5,5,10,10,22,-12,20
Rostov,9162,10,4,6,10,11,19,-8,18
Anzhi,9162,11,2,5,13,15,42,-27,11
Loko Moscow,9163,1,12,5,3,32,15,17,41
CSKA Moscow,9163,2,10,5,5,26,18,8,35
Krasnodar,9163,3,10,4,6,33,25,8,34
Spart Moscow,9163,4,9,6,5,38,26,12,33
Zenit,9163,5,7,9,4,23,17,6,30
Terek Grozny,9163,6,8,5,7,23,24,-1,29
FK Rubin,9163,7,6,5,9,23,20,3,23
Din Moscow,9163,8,5,6,9,17,27,-10,21
Rostov,9163,9,4,7,9,10,17,-7,19
Amkar,9163,10,5,4,11,10,25,-15,19
Anzhi,9163,11,3,6,11,16,37,-21,15
Loko Moscow,9164,1,11,5,4,32,17,15,38
CSKA Moscow,9164,2,11,4,5,28,18,10,37
Spart Moscow,9164,3,9,7,4,38,28,10,34
Zenit,9164,4,8,8,4,25,18,7,32
Terek Grozny,9164,5,9,5,6,23,23,0,32
Krasnodar,9164,6,9,4,7,30,26,4,31
FK Rubin,9164,7,7,5,8,24,18,6,26
Din Moscow,9164,8,5,7,8,17,22,-5,22
Rostov,9164,9,4,7,9,12,19,-7,19
Amkar,9164,10,4,4,12,11,27,-16,16
Anzhi,9164,11,2,6,12,15,39,-24,12
Loko Moscow,9165,1,12,6,2,31,12,19,42
Spart Moscow,9165,2,10,5,5,36,27,9,35
CSKA Moscow,9165,3,10,4,6,28,21,7,34
Zenit,9165,4,7,9,4,23,16,7,30
Krasnodar,9165,5,8,6,6,28,25,3,30
Terek Grozny,9165,6,7,7,6,20,22,-2,28
FK Rubin,9165,7,6,6,8,23,18,5,24
Din Moscow,9165,8,6,6,8,18,22,-4,24
Rostov,9165,9,4,6,10,10,18,-8,18
Amkar,9165,10,4,5,11,10,24,-14,17
Anzhi,9165,11,3,6,11,17,39,-22,15
Loko Moscow,9166,1,11,6,3,30,13,17,39
Zenit,9166,2,9,8,3,24,14,10,35
CSKA Moscow,9166,3,10,4,6,27,20,7,34
Spart Moscow,9166,4,9,6,5,39,31,8,33
Krasnodar,9166,5,8,6,6,27,24,3,30
Terek Grozny,9166,6,7,6,7,22,25,-3,27
Din Moscow,9166,7,6,6,8,21,24,-3,24
FK Rubin,9166,8,5,6,9,21,19,2,21
Rostov,9166,9,5,6,9,12,18,-6,21
Amkar,9166,10,4,6,10,11,24,-13,18
Anzhi,9166,11,3,6,11,19,41,-22,15
Loko Moscow,9167,1,13,5,2,34,14,20,44
CSKA Moscow,9167,2,11,4,5,28,19,9,37
Spart Moscow,9167,3,10,6,4,38,28,10,36
Krasnodar,9167,4,9,4,7,30,27,3,31
Zenit,9167,5,7,8,5,24,18,6,29
Terek Grozny,9167,6,7,6,7,20,24,-4,27
Din Moscow,9167,7,5,7,8,19,24,-5,22
FK Rubin,9167,8,5,6,9,21,18,3,21
Rostov,9167,9,4,6,10,11,19,-8,18
Amkar,9167,10,4,6,10,9,22,-13,18
Anzhi,9167,11,3,6,11,16,37,-21,15
Loko Moscow,9168,1,12,5,3,32,15,17,41
Spart Moscow,9168,2,10,5,5,35,26,9,35
CSKA Moscow,9168,3,10,4,6,27,20,7,34
Zenit,9168,4,8,8,4,24,16,8,32
Krasnodar,9168,5,9,5,6,31,26,5,32
Terek Grozny,9168,6,8,5,7,23,25,-2,29
FK Rubin,9168,7,6,6,8,24,19,5,24
Din Moscow,9168,8,5,6,9,18,24,-6,21
Rostov,9168,9,5,6,9,11,17,-6,21
Amkar,9168,10,4,4,12,9,25,-16,16
Anzhi,9168,11,3,6,11,18,39,-21,15
Loko Moscow,9169,1,12,6,2,32,12,20,42
CSKA Moscow,9169,2,11,4,5,28,18,10,37
Zenit,9169,3,7,10,3,22,14,8,31
Spart Moscow,9169,4,8,7,5,37,31,6,31
Krasnodar,9169,5,8,4,8,27,28,-1,28
Terek Grozny,9169,6,7,5,8,20,24,-4,26
Din Moscow,9169,7,6,7,7,22,24,-2,25
FK Rubin,9169,8,6,6,8,25,19,6,24
Amkar,9169,9,5,5,10,13,25,-12,20
Rostov,9169,10,4,7,9,10,17,-7,19
Anzhi,9169,11,3,5,12,16,40,-24,14
Loko Moscow,9170,1,12,6,2,32,13,19,42
CSKA Moscow,9170,2,11,4,5,28,17,11,37
Spart Moscow,9170,3,10,6,4,37,26,11,36
Zenit,9170,4,7,10,3,22,14,8,31
Krasnodar,9170,5,9,4,7,29,26,3,31
Terek Grozny,9170,6,7,5,8,20,26,-6,26
Din Moscow,9170,7,6,6,8,19,24,-5,24
FK Rubin,9170,8,5,5,10,22,20,2,20
Amkar,9170,9,5,5,10,12,23,-11,20
Rostov,9170,10,4,6,10,10,18,-8,18
Anzhi,9170,11,3,5,12,16,40,-24,14
Loko Moscow,9171,1,12,6,2,30,11,19,42
Spart Moscow,9171,2,11,5,4,38,26,12,38
CSKA Moscow,9171,3,11,3,6,29,22,7,36
Zenit,9171,4,8,9,3,25,14,11,33
Terek Grozny,9171,5,8,6,6,22,23,-1,30
Krasnodar,9171,6,8,4,8,28,27,1,28
FK Rubin,9171,7,7,5,8,26,20,6,26
Din Moscow,9171,8,5,6,9,20,27,-7,21
Rostov,9171,9,4,6,10,10,18,-8,18
Amkar,9171,10,4,5,11,9,23,-14,17
Anzhi,9171,11,2,5,13,16,42,-26,11
Loko Moscow,9172,1,12,6,2,31,11,20,42
CSKA Moscow,9172,2,11,3,6,29,22,7,36
Zenit,9172,3,8,9,3,26,15,11,33
Spart Moscow,9172,4,9,6,5,38,29,9,33
Krasnodar,9172,5,8,5,7,27,26,1,29
Terek Grozny,9172,6,8,5,7,25,25,0,29
Din Moscow,9172,7,6,7,7,20,23,-3,25
FK Rubin,9172,8,5,6,9,21,18,3,21
Amkar,9172,9,5,4,11,12,27,-15,19
Rostov,9172,10,4,6,10,10,19,-9,18
Anzhi,9172,11,3,5,12,16,40,-24,14
Loko Moscow,9173,1,11,6,3,30,15,15,39
CSKA Moscow,9173,2,11,3,6,29,19,10,36
Spart Moscow,9173,3,9,7,4,36,27,9,34
Krasnodar,9173,4,10,4,6,34,25,9,34
Zenit,9173,5,8,9,3,23,14,9,33
Terek Grozny,9173,6,8,6,6,23,22,1,30
Din Moscow,9173,7,5,8,7,21,25,-4,23
FK Rubin,9173,8,5,6,9,24,23,1,21
Rostov,9173,9,4,7,9,10,17,-7,19
Amkar,9173,10,4,4,12,9,26,-17,16
Anzhi,9173,11,2,6,12,15,41,-26,12
Loko Moscow,9174,1,12,5,3,30,12,18,41
CSKA Moscow,9174,2,12,3,5,29,19,10,39
Spart Moscow,9174,3,9,5,6,38,30,8,32
Zenit,9174,4,8,8,4,23,15,8,32
Terek Grozny,9174,5,9,5,6,24,24,0,32
Krasnodar,9174,6,8,4,8,28,27,1,28
FK Rubin,9174,7,7,5,8,25,19,6,26
Din Moscow,9174,8,6,6,8,22,25,-3,24
Amkar,9174,9,5,4,11,11,24,-13,19
Rostov,9174,10,4,6,10,10,20,-10,18
Anzhi,9174,11,2,5,13,16,41,-25,11
Loko Moscow,9175,1,12,6,2,32,13,19,42
Spart Moscow,9175,2,11,5,4,42,28,14,38
CSKA Moscow,9175,3,11,3,6,26,18,8,36
Zenit,9175,4,8,9,3,23,14,9,33
Krasnodar,9175,5,9,4,7,31,26,5,31
Terek Grozny,9175,6,7,6,7,21,24,-3,27
Din Moscow,9175,7,5,7,8,20,25,-5,22
FK Rubin,9175,8,5,6,9,21,20,1,21
Rostov,9175,9,4,6,10,10,21,-11,18
Amkar,9175,10,4,5,11,9,23,-14,17
Anzhi,9175,11,3,5,12,16,39,-23,14
Loko Moscow,9176,1,12,5,3,30,12,18,41
CSKA Moscow,9176,2,11,4,5,29,18,11,37
Spart Moscow,9176,3,10,6,4,36,25,11,36
Krasnodar,9176,4,10,4,6,31,25,6,34
Terek Grozny,9176,5,8,6,6,23,23,0,30
Zenit,9176,6,7,8,5,21,17,4,29
Din Moscow,9176,7,5,8,7,18,22,-4,23
FK Rubin,9176,8,5,6,9,23,21,2,21
Rostov,9176,9,4,6,10,10,19,-9,18
Amkar,9176,10,4,5,11,9,23,-14,17
Anzhi,9176,11,2,6,12,16,41,-25,12
Loko Moscow,9177,1,11,7,2,33,15,18,40
Spart Moscow,9177,2,10,5,5,36,26,10,35
Zenit,9177,3,8,9,3,24,15,9,33
CSKA Moscow,9177,4,10,3,7,25,19,6,33
Krasnodar,9177,5,8,6,6,29,26,3,30
Terek Grozny,9177,6,7,5,8,21,27,-6,26
FK Rubin,9177,7,6,6,8,23,17,6,24
Amkar,9177,8,6,4,10,12,22,-10,22
Din Moscow,9177,9,5,6,9,17,25,-8,21
Rostov,9177,10,4,6,10,10,18,-8,18
Anzhi,9177,11,4,5,11,18,38,-20,17
Loko Moscow,9178,1,11,6,3,31,14,17,39
CSKA Moscow,9178,2,10,4,6,25,18,7,34
Zenit,9178,3,8,9,3,23,14,9,33
Spart Moscow,9178,4,9,6,5,35,27,8,33
Krasnodar,9178,5,9,4,7,31,28,3,31
Terek Grozny,9178,6,8,5,7,21,23,-2,29
FK Rubin,9178,7,7,5,8,25,19,6,26
Din Moscow,9178,8,5,7,8,18,23,-5,22
Amkar,9178,9,6,4,10,11,22,-11,22
Rostov,9178,10,4,6,10,10,18,-8,18
Anzhi,9178,11,2,6,12,14,38,-24,12
Loko Moscow,9179,1,12,5,3,31,14,17,41
CSKA Moscow,9179,2,11,3,6,28,20,8,36
Spart Moscow,9179,3,10,5,5,39,27,12,35
Zenit,9179,4,8,8,4,24,15,9,32
Krasnodar,9179,5,9,4,7,29,26,3,31
Terek Grozny,9179,6,8,5,7,22,23,-1,29
Din Moscow,9179,7,5,7,8,18,24,-6,22
Amkar,9179,8,6,4,10,11,22,-11,22
FK Rubin,9179,9,5,6,9,21,18,3,21
Rostov,9179,10,4,6,10,10,20,-10,18
Anzhi,9179,11,3,5,12,16,40,-24,14
Loko Moscow,9180,1,12,5,3,32,12,20,41
CSKA Moscow,9180,2,11,4,5,27,18,9,37
Spart Moscow,9180,3,10,6,4,40,27,13,36
Krasnodar,9180,4,10,4,6,30,24,6,34
Terek Grozny,9180,5,9,5,6,22,22,0,32
Zenit,9180,6,7,9,4,21,16,5,30
Din Moscow,9180,7,5,7,8,21,28,-7,22
FK Rubin,9180,8,5,6,9,24,22,2,21
Rostov,9180,9,4,6,10,10,19,-9,18
Amkar,9180,10,4,5,11,10,24,-14,17
Anzhi,9180,11,2,5,13,15,40,-25,11
Loko Moscow,9181,1,12,6,2,31,12,19,42
Spart Moscow,9181,2,10,5,5,41,27,14,35
CSKA Moscow,9181,3,10,4,6,26,21,5,34
Zenit,9181,4,7,9,4,22,15,7,30
Krasnodar,9181,5,8,6,6,28,25,3,30
Terek Grozny,9181,6,7,5,8,20,24,-4,26
Din Moscow,9181,7,6,6,8,20,27,-7,24
Amkar,9181,8,6,4,10,12,23,-11,22
FK Rubin,9181,9,5,6,9,22,20,2,21
Rostov,9181,10,4,6,10,10,19,-9,18
Anzhi,9181,11,4,5,11,18,37,-19,17
Loko Moscow,9182,1,11,6,3,30,13,17,39
CSKA Moscow,9182,2,12,3,5,28,18,10,39
Spart Moscow,9182,3,10,6,4,39,28,11,36
Krasnodar,9182,4,9,4,7,30,27,3,31
Zenit,9182,5,7,9,4,21,14,7,30
Terek Grozny,9182,6,8,6,6,24,24,0,30
FK Rubin,9182,7,7,5,8,25,18,7,26
Din Moscow,9182,8,5,6,9,18,25,-7,21
Rostov,9182,9,4,6,10,11,20,-9,18
Amkar,9182,10,4,5,11,10,25,-15,17
Anzhi,9182,11,2,6,12,17,41,-24,12
Loko Moscow,9183,1,13,5,2,33,12,21,44
CSKA Moscow,9183,2,12,3,5,29,17,12,39
Spart Moscow,9183,3,9,6,5,36,28,8,33
Krasnodar,9183,4,9,4,7,29,26,3,31
Zenit,9183,5,7,8,5,21,17,4,29
Terek Grozny,9183,6,8,5,7,22,24,-2,29
FK Rubin,9183,7,6,5,9,24,19,5,23
Rostov,9183,8,5,6,9,11,17,-6,21
Din Moscow,9183,9,5,6,9,19,26,-7,21
Amkar,9183,10,5,5,10,11,23,-12,20
Anzhi,9183,11,2,5,13,15,41,-26,11
Loko Moscow,9184,1,12,6,2,31,12,19,42
CSKA Moscow,9184,2,11,3,6,26,20,6,36
Zenit,9184,3,8,9,3,25,14,11,33
Spart Moscow,9184,4,9,6,5,36,28,8,33
Krasnodar,9184,5,8,5,7,27,25,2,29
Terek Grozny,9184,6,8,5,7,23,25,-2,29
FK Rubin,9184,7,6,6,8,23,18,5,24
Rostov,9184,8,5,6,9,12,17,-5,21
Din Moscow,9184,9,5,6,9,18,25,-7,21
Amkar,9184,10,5,5,10,13,24,-11,20
Anzhi,9184,11,2,5,13,14,40,-26,11
Loko Moscow,9185,1,13,5,2,34,13,21,44
Spart Moscow,9185,2,10,5,5,42,29,13,35
CSKA Moscow,9185,3,10,4,6,27,20,7,34
Terek Grozny,9185,4,9,5,6,22,22,0,32
Krasnodar,9185,5,9,4,7,34,28,6,31
Zenit,9185,6,7,9,4,23,17,6,30
Din Moscow,9185,7,6,7,7,22,24,-2,25
FK Rubin,9185,8,5,6,9,23,23,0,21
Rostov,9185,9,4,6,10,10,20,-10,18
Amkar,9185,10,4,4,12,9,27,-18,16
Anzhi,9185,11,3,5,12,15,38,-23,14
CSKA Moscow,9186,1,12,3,5,30,18,12,39
Loko Moscow,9186,2,11,5,4,30,15,15,38
Spart Moscow,9186,3,10,5,5,38,28,10,35
Krasnodar,9186,4,10,4,6,32,27,5,34
Zenit,9186,5,8,8,4,24,16,8,32
Terek Grozny,9186,6,7,7,6,22,24,-2,28
Din Moscow,9186,7,6,7,7,20,23,-3,25
FK Rubin,9186,8,5,6,9,23,20,3,21
Rostov,9186,9,4,6,10,10,18,-8,18
Amkar,9186,10,4,5,11,9,24,-15,17
Anzhi,9186,11,2,6,12,16,41,-25,12
Loko Moscow,9187,1,12,5,3,32,15,17,41
Spart Moscow,9187,2,10,5,5,36,27,9,35
Krasnodar,9187,3,10,4,6,32,25,7,34
CSKA Moscow,9187,4,10,4,6,27,20,7,34
Zenit,9187,5,8,8,4,24,16,8,32
Terek Grozny,9187,6,8,6,6,23,23,0,30
FK Rubin,9187,7,6,5,9,27,19,8,23
Din Moscow,9187,8,5,6,9,18,29,-11,21
Amkar,9187,9,5,4,11,10,24,-14,19
Rostov,9187,10,4,6,10,10,18,-8,18
Anzhi,9187,11,2,7,11,16,39,-23,13
Loko Moscow,9188,1,12,6,2,30,11,19,42
CSKA Moscow,9188,2,11,4,5,26,17,9,37
Spart Moscow,9188,3,9,7,4,41,29,12,34
Zenit,9188,4,7,9,4,21,14,7,30
Krasnodar,9188,5,8,6,6,28,25,3,30
Terek Grozny,9188,6,7,6,7,20,24,-4,27
Din Moscow,9188,7,6,6,8,19,26,-7,24
FK Rubin,9188,8,5,6,9,22,19,3,21
Rostov,9188,9,4,7,9,12,19,-7,19
Amkar,9188,10,4,6,10,10,23,-13,18
Anzhi,9188,11,3,5,12,16,38,-22,14
Loko Moscow,9189,1,11,5,4,31,15,16,38
Spart Moscow,9189,2,11,5,4,39,26,13,38
CSKA Moscow,9189,3,11,3,6,27,19,8,36
Zenit,9189,4,9,8,3,25,15,10,35
Krasnodar,9189,5,10,4,6,32,25,7,34
Terek Grozny,9189,6,9,5,6,22,22,0,32
Din Moscow,9189,7,6,6,8,20,25,-5,24
FK Rubin,9189,8,5,5,10,22,22,0,20
Rostov,9189,9,4,6,10,10,18,-8,18
Amkar,9189,10,4,4,12,9,25,-16,16
Anzhi,9189,11,2,5,13,14,39,-25,11
Loko Moscow,9190,1,11,6,3,30,13,17,39
CSKA Moscow,9190,2,10,5,5,25,17,8,35
Zenit,9190,3,8,9,3,22,13,9,33
Spart Moscow,9190,4,8,7,5,35,29,6,31
Krasnodar,9190,5,8,5,7,28,26,2,29
Terek Grozny,9190,6,7,5,8,21,26,-5,26
Din Moscow,9190,7,6,7,7,19,21,-2,25
FK Rubin,9190,8,6,6,8,22,17,5,24
Amkar,9190,9,5,5,10,12,24,-12,20
Rostov,9190,10,4,7,9,11,18,-7,19
Anzhi,9190,11,3,6,11,16,37,-21,15
Loko Moscow,9191,1,12,6,2,32,13,19,42
CSKA Moscow,9191,2,11,4,5,30,20,10,37
Spart Moscow,9191,3,9,6,5,37,29,8,33
Zenit,9191,4,7,10,3,23,15,8,31
Krasnodar,9191,5,8,5,7,31,29,2,29
Terek Grozny,9191,6,8,5,7,21,23,-2,29
Din Moscow,9191,7,5,8,7,19,23,-4,23
FK Rubin,9191,8,5,7,8,24,20,4,22
Rostov,9191,9,5,6,9,13,18,-5,21
Amkar,9191,10,4,4,12,9,25,-16,16
Anzhi,9191,11,3,5,12,16,40,-24,14
Loko Moscow,9192,1,12,5,3,30,13,17,41
Spart Moscow,9192,2,10,6,4,38,25,13,36
CSKA Moscow,9192,3,11,3,6,29,21,8,36
Zenit,9192,4,8,8,4,23,15,8,32
Krasnodar,9192,5,9,5,6,30,25,5,32
Terek Grozny,9192,6,7,6,7,22,25,-3,27
FK Rubin,9192,7,5,7,8,22,18,4,22
Din Moscow,9192,8,5,7,8,17,25,-8,22
Rostov,9192,9,4,7,9,10,17,-7,19
Amkar,9192,10,4,5,11,9,23,-14,17
Anzhi,9192,11,3,5,12,19,42,-23,14
Loko Moscow,9193,1,12,5,3,31,13,18,41
CSKA Moscow,9193,2,11,3,6,28,20,8,36
Spart Moscow,9193,3,9,5,6,36,30,6,32
Krasnodar,9193,4,9,4,7,28,26,2,31
Zenit,9193,5,7,8,5,23,17,6,29
Terek Grozny,9193,6,8,5,7,23,26,-3,29
Din Moscow,9193,7,6,7,7,21,23,-2,25
FK Rubin,9193,8,6,6,8,24,18,6,24
Amkar,9193,9,6,4,10,14,23,-9,22
Rostov,9193,10,4,6,10,10,19,-9,18
Anzhi,9193,11,3,5,12,17,40,-23,14
Loko Moscow,9194,1,12,6,2,32,13,19,42
CSKA Moscow,9194,2,11,4,5,29,20,9,37
Spart Moscow,9194,3,10,6,4,40,28,12,36
Krasnodar,9194,4,9,4,7,31,27,4,31
Zenit,9194,5,7,9,4,23,16,7,30
Terek Grozny,9194,6,8,5,7,23,25,-2,29
Din Moscow,9194,7,5,8,7,18,22,-4,23
FK Rubin,9194,8,5,6,9,21,19,2,21
Amkar,9194,9,5,4,11,12,25,-13,19
Rostov,9194,10,4,6,10,11,21,-10,18
Anzhi,9194,11,2,6,12,16,40,-24,12
Loko Moscow,9195,1,12,6,2,32,12,20,42
CSKA Moscow,9195,2,11,4,5,27,18,9,37
Spart Moscow,9195,3,9,6,5,37,27,10,33
Krasnodar,9195,4,9,5,6,30,25,5,32
Zenit,9195,5,7,9,4,23,17,6,30
Terek Grozny,9195,6,7,5,8,21,25,-4,26
Din Moscow,9195,7,5,8,7,19,23,-4,23
Amkar,9195,8,6,4,10,11,22,-11,22
FK Rubin,9195,9,5,6,9,23,21,2,21
Rostov,9195,10,4,6,10,10,20,-10,18
Anzhi,9195,11,3,5,12,16,39,-23,14
Loko Moscow,9196,1,12,5,3,31,13,18,41
CSKA Moscow,9196,2,12,3,5,27,17,10,39
Zenit,9196,3,8,8,4,23,14,9,32
Spart Moscow,9196,4,9,5,6,34,28,6,32
Terek Grozny,9196,5,9,5,6,24,23,1,32
Krasnodar,9196,6,9,4,7,29,26,3,31
Din Moscow,9196,7,7,6,7,21,21,0,27
Rostov,9196,8,5,6,9,11,17,-6,21
FK Rubin,9196,9,5,5,10,21,21,0,20
Amkar,9196,10,4,4,12,9,25,-16,16
Anzhi,9196,11,2,5,13,15,40,-25,11
Loko Moscow,9197,1,12,6,2,32,13,19,42
CSKA Moscow,9197,2,11,4,5,27,18,9,37
Spart Moscow,9197,3,10,5,5,37,26,11,35
Zenit,9197,4,7,8,5,22,16,6,29
Krasnodar,9197,5,8,5,7,29,28,1,29
Din Moscow,9197,6,7,6,7,19,21,-2,27
Terek Grozny,9197,7,7,5,8,20,29,-9,26
FK Rubin,9197,8,6,5,9,24,19,5,23
Amkar,9197,9,5,4,11,13,24,-11,19
Rostov,9197,10,4,6,10,10,19,-9,18
Anzhi,9197,11,3,6,11,18,38,-20,15
Loko Moscow,9198,1,12,5,3,31,13,18,41
Spart Moscow,9198,2,10,6,4,37,25,12,36
CSKA Moscow,9198,3,11,3,6,26,19,7,36
Zenit,9198,4,8,8,4,23,14,9,32
Krasnodar,9198,5,9,5,6,30,26,4,32
Terek Grozny,9198,6,8,6,6,22,22,0,30
Din Moscow,9198,7,5,8,7,19,23,-4,23
FK Rubin,9198,8,5,7,8,24,20,4,22
Rostov,9198,9,4,6,10,10,19,-9,18
Amkar,9198,10,4,4,12,9,26,-17,16
Anzhi,9198,11,2,6,12,14,38,-24,12
Loko Moscow,9199,1,11,6,3,29,12,17,39
CSKA Moscow,9199,2,11,3,6,26,18,8,36
Spart Moscow,9199,3,9,5,6,39,29,10,32
Zenit,9199,4,8,8,4,22,14,8,32
Krasnodar,9199,5,9,5,6,29,24,5,32
Terek Grozny,9199,6,8,6,6,24,23,1,30
Din Moscow,9199,7,6,6,8,20,23,-3,24
FK Rubin,9199,8,6,5,9,23,20,3,23
Amkar,9199,9,5,5,10,12,24,-12,20
Rostov,9199,10,4,6,10,10,22,-12,18
Anzhi,9199,11,3,5,12,15,40,-25,14
Spart Moscow,9200,1,11,5,4,37,26,11,38
Loko Moscow,9200,2,11,5,4,29,19,10,38
Zenit,9200,3,9,8,3,25,15,10,35
CSKA Moscow,9200,4,10,3,7,27,21,6,33
Krasnodar,9200,5,9,5,6,34,24,10,32
Terek Grozny,9200,6,8,5,7,22,26,-4,29
Din Moscow,9200,7,6,6,8,19,22,-3,24
FK Rubin,9200,8,5,6,9,21,19,2,21
Amkar,9200,9,5,4,11,12,23,-11,19
Rostov,9200,10,4,6,10,11,19,-8,18
Anzhi,9200,11,3,5,12,16,39,-23,14
Loko Moscow,9201,1,12,6,2,32,13,19,42
CSKA Moscow,9201,2,11,4,5,29,20,9,37
Spart Moscow,9201,3,9,5,6,34,28,6,32
Terek Grozny,9201,4,9,5,6,26,22,4,32
Zenit,9201,5,7,10,3,23,15,8,31
Krasnodar,9201,6,9,4,7,32,27,5,31
Din Moscow,9201,7,6,6,8,19,22,-3,24
FK Rubin,9201,8,6,5,9,22,20,2,23
Amkar,9201,9,5,4,11,10,24,-14,19
Rostov,9201,10,4,6,10,10,18,-8,18
Anzhi,9201,11,2,5,13,15,43,-28,11
Loko Moscow,9202,1,12,5,3,32,13,19,41
CSKA Moscow,9202,2,10,4,6,28,22,6,34
Spart Moscow,9202,3,9,6,5,38,30,8,33
Krasnodar,9202,4,9,5,6,30,26,4,32
Zenit,9202,5,7,9,4,22,16,6,30
Terek Grozny,9202,6,8,5,7,21,23,-2,29
Din Moscow,9202,7,6,7,7,23,25,-2,25
Amkar,9202,8,6,4,10,11,22,-11,22
FK Rubin,9202,9,5,6,9,23,21,2,21
Rostov,9202,10,4,6,10,11,19,-8,18
Anzhi,9202,11,3,5,12,18,40,-22,14
Loko Moscow,9203,1,11,7,2,32,14,18,40
Spart Moscow,9203,2,11,5,4,39,27,12,38
CSKA Moscow,9203,3,11,4,5,29,19,10,37
Krasnodar,9203,4,9,5,6,30,26,4,32
Zenit,9203,5,7,10,3,23,15,8,31
Terek Grozny,9203,6,8,5,7,23,25,-2,29
Din Moscow,9203,7,6,6,8,20,24,-4,24
FK Rubin,9203,8,5,5,10,22,20,2,20
Amkar,9203,9,5,4,11,12,25,-13,19
Rostov,9203,10,4,6,10,10,19,-9,18
Anzhi,9203,11,2,5,13,16,42,-26,11
Loko Moscow,9204,1,13,5,2,34,12,22,44
Spart Moscow,9204,2,11,5,4,44,28,16,38
CSKA Moscow,9204,3,11,3,6,31,22,9,36
Zenit,9204,4,8,8,4,24,16,8,32
Terek Grozny,9204,5,8,6,6,24,25,-1,30
Krasnodar,9204,6,8,4,8,29,30,-1,28
Din Moscow,9204,7,6,6,8,20,24,-4,24
FK Rubin,9204,8,6,5,9,23,21,2,23
Rostov,9204,9,4,6,10,10,21,-11,18
Amkar,9204,10,4,4,12,13,28,-15,16
Anzhi,9204,11,2,6,12,18,43,-25,12
Loko Moscow,9205,1,12,5,3,33,14,19,41
CSKA Moscow,9205,2,12,3,5,30,17,13,39
Spart Moscow,9205,3,11,5,4,41,25,16,38
Krasnodar,9205,4,10,4,6,33,26,7,34
Zenit,9205,5,7,8,5,22,18,4,29
Terek Grozny,9205,6,7,6,7,21,25,-4,27
FK Rubin,9205,7,6,5,9,23,21,2,23
Din Moscow,9205,8,5,6,9,17,23,-6,21
Amkar,9205,9,5,4,11,11,24,-13,19
Rostov,9205,10,4,6,10,10,22,-12,18
Anzhi,9205,11,2,6,12,15,41,-26,12
Loko Moscow,9206,1,12,6,2,32,13,19,42
CSKA Moscow,9206,2,11,3,6,28,20,8,36
Zenit,9206,3,8,8,4,24,15,9,32
Spart Moscow,9206,4,8,7,5,36,31,5,31
Krasnodar,9206,5,8,6,6,30,27,3,30
Terek Grozny,9206,6,8,5,7,23,24,-1,29
FK Rubin,9206,7,6,6,8,24,18,6,24
Din Moscow,9206,8,5,7,8,18,24,-6,22
Rostov,9206,9,5,6,9,14,18,-4,21
Amkar,9206,10,5,5,10,12,24,-12,20
Anzhi,9206,11,2,5,13,14,41,-27,11
Loko Moscow,9207,1,11,5,4,30,15,15,38
CSKA Moscow,9207,2,11,4,5,29,17,12,37
Spart Moscow,9207,3,9,7,4,38,29,9,34
Krasnodar,9207,4,10,4,6,30,24,6,34
Zenit,9207,5,8,9,3,23,14,9,33
Terek Grozny,9207,6,9,5,6,23,22,1,32
Din Moscow,9207,7,6,7,7,21,24,-3,25
FK Rubin,9207,8,5,5,10,22,20,2,20
Rostov,9207,9,4,7,9,11,18,-7,19
Amkar,9207,10,4,4,12,10,25,-15,16
Anzhi,9207,11,2,5,13,14,43,-29,11
CSKA Moscow,9208,1,12,3,5,28,18,10,39
Loko Moscow,9208,2,11,5,4,29,14,15,38
Spart Moscow,9208,3,10,5,5,38,30,8,35
Krasnodar,9208,4,10,4,6,30,25,5,34
Zenit,9208,5,8,8,4,24,15,9,32
Din Moscow,9208,6,7,6,7,22,22,0,27
Terek Grozny,9208,7,7,5,8,23,27,-4,26
FK Rubin,9208,8,5,5,10,23,21,2,20
Amkar,9208,9,5,4,11,12,26,-14,19
Rostov,9208,10,4,6,10,11,19,-8,18
Anzhi,9208,11,3,5,12,17,40,-23,14
Loko Moscow,9209,1,11,5,4,29,16,13,38
CSKA Moscow,9209,2,11,3,6,27,19,8,36
Spart Moscow,9209,3,10,5,5,39,26,13,35
Zenit,9209,4,9,8,3,24,13,11,35
Krasnodar,9209,5,9,4,7,31,25,6,31
Terek Grozny,9209,6,7,7,6,24,26,-2,28
FK Rubin,9209,7,7,5,8,23,17,6,26
Din Moscow,9209,8,6,6,8,18,22,-4,24
Rostov,9209,9,4,6,10,10,20,-10,18
Amkar,9209,10,4,5,11,10,26,-16,17
Anzhi,9209,11,2,6,12,17,42,-25,12
Loko Moscow,9210,1,13,5,2,33,12,21,44
CSKA Moscow,9210,2,10,5,5,26,18,8,35
Spart Moscow,9210,3,9,7,4,41,28,13,34
Terek Grozny,9210,4,9,5,6,24,24,0,32
Krasnodar,9210,5,9,4,7,29,26,3,31
Zenit,9210,6,7,9,4,22,16,6,30
Din Moscow,9210,7,6,7,7,23,25,-2,25
FK Rubin,9210,8,5,5,10,23,22,1,20
Rostov,9210,9,4,7,9,11,18,-7,19
Amkar,9210,10,4,4,12,10,29,-19,16
Anzhi,9210,11,2,6,12,15,39,-24,12
Loko Moscow,9211,1,12,6,2,33,12,21,42
CSKA Moscow,9211,2,10,3,7,26,21,5,33
Spart Moscow,9211,3,9,5,6,36,29,7,32
Zenit,9211,4,8,8,4,23,16,7,32
Krasnodar,9211,5,8,6,6,30,27,3,30
Din Moscow,9211,6,7,6,7,21,22,-1,27
Terek Grozny,9211,7,7,6,7,20,25,-5,27
Amkar,9211,8,6,4,10,14,22,-8,22
FK Rubin,9211,9,5,6,9,24,22,2,21
Rostov,9211,10,4,6,10,11,20,-9,18
Anzhi,9211,11,3,6,11,16,38,-22,15
Loko Moscow,9212,1,12,6,2,31,11,20,42
Spart Moscow,9212,2,11,5,4,42,27,15,38
CSKA Moscow,9212,3,11,3,6,27,18,9,36
Zenit,9212,4,8,8,4,22,15,7,32
Krasnodar,9212,5,8,5,7,28,26,2,29
Terek Grozny,9212,6,7,6,7,22,26,-4,27
FK Rubin,9212,7,6,6,8,23,18,5,24
Din Moscow,9212,8,5,7,8,17,23,-6,22
Rostov,9212,9,4,6,10,12,21,-9,18
Amkar,9212,10,4,5,11,10,26,-16,17
Anzhi,9212,11,3,5,12,17,40,-23,14
Loko Moscow,9213,1,12,5,3,32,14,18,41
CSKA Moscow,9213,2,11,4,5,29,20,9,37
Spart Moscow,9213,3,10,5,5,38,28,10,35
Krasnodar,9213,4,9,5,6,31,27,4,32
Zenit,9213,5,7,9,4,23,16,7,30
Terek Grozny,9213,6,8,5,7,23,24,-1,29
Din Moscow,9213,7,6,6,8,19,24,-5,24
Amkar,9213,8,6,4,10,12,23,-11,22
FK Rubin,9213,9,5,6,9,22,19,3,21
Rostov,9213,10,4,6,10,10,18,-8,18
Anzhi,9213,11,2,5,13,16,42,-26,11
Loko Moscow,9214,1,11,5,4,29,13,16,38
CSKA Moscow,9214,2,11,3,6,26,19,7,36
Zenit,9214,3,9,8,3,24,13,11,35
Spart Moscow,9214,4,9,6,5,35,28,7,33
Krasnodar,9214,5,9,4,7,29,26,3,31
Terek Grozny,9214,6,8,6,6,21,22,-1,30
FK Rubin,9214,7,7,5,8,25,18,7,26
Din Moscow,9214,8,5,7,8,18,24,-6,22
Rostov,9214,9,5,6,9,12,17,-5,21
Amkar,9214,10,4,4,12,9,24,-15,16
Anzhi,9214,11,2,6,12,14,38,-24,12
Loko Moscow,9215,1,11,6,3,31,14,17,39
Spart Moscow,9215,2,10,5,5,37,27,10,35
CSKA Moscow,9215,3,10,4,6,26,19,7,34
Zenit,9215,4,8,9,3,23,14,9,33
Krasnodar,9215,5,9,5,6,30,26,4,32
Terek Grozny,9215,6,7,6,7,20,23,-3,27
Din Moscow,9215,7,6,6,8,19,24,-5,24
Amkar,9215,8,6,4,10,11,22,-11,22
FK Rubin,9215,9,5,6,9,22,19,3,21
Rostov,9215,10,4,6,10,10,18,-8,18
Anzhi,9215,11,2,7,11,15,38,-23,13
Loko Moscow,9216,1,13,5,2,32,11,21,44
CSKA Moscow,9216,2,12,3,5,29,19,10,39
Spart Moscow,9216,3,11,5,4,40,26,14,38
Krasnodar,9216,4,9,4,7,28,26,2,31
Zenit,9216,5,7,8,5,21,15,6,29
Terek Grozny,9216,6,8,5,7,22,23,-1,29
Din Moscow,9216,7,5,7,8,18,23,-5,22
FK Rubin,9216,8,5,6,9,22,19,3,21
Rostov,9216,9,4,6,10,11,20,-9,18
Amkar,9216,10,4,4,12,9,27,-18,16
Anzhi,9216,11,3,5,12,17,40,-23,14
Loko Moscow,9217,1,11,6,3,30,13,17,39
Spart Moscow,9217,2,10,5,5,40,27,13,35
CSKA Moscow,9217,3,10,4,6,27,20,7,34
Krasnodar,9217,4,10,4,6,31,26,5,34
Zenit,9217,5,8,9,3,23,14,9,33
Terek Grozny,9217,6,8,5,7,23,25,-2,29
FK Rubin,9217,7,6,5,9,24,20,4,23
Amkar,9217,8,6,4,10,11,22,-11,22
Din Moscow,9217,9,5,6,9,19,27,-8,21
Rostov,9217,10,4,6,10,10,20,-10,18
Anzhi,9217,11,2,6,12,17,41,-24,12
Loko Moscow,9218,1,12,5,3,32,14,18,41
CSKA Moscow,9218,2,12,3,5,29,17,12,39
Spart Moscow,9218,3,11,5,4,39,25,14,38
Terek Grozny,9218,4,9,5,6,23,22,1,32
Krasnodar,9218,5,9,4,7,31,29,2,31
Zenit,9218,6,7,8,5,21,16,5,29
FK Rubin,9218,7,7,5,8,25,18,7,26
Din Moscow,9218,8,5,6,9,17,24,-7,21
Rostov,9218,9,4,6,10,10,19,-9,18
Amkar,9218,10,4,4,12,9,26,-17,16
Anzhi,9218,11,2,5,13,14,40,-26,11
Loko Moscow,9219,1,11,6,3,30,13,17,39
CSKA Moscow,9219,2,11,4,5,28,18,10,37
Spart Moscow,9219,3,9,7,4,41,28,13,34
Krasnodar,9219,4,10,4,6,30,25,5,34
Zenit,9219,5,7,10,3,22,14,8,31
Terek Grozny,9219,6,7,5,8,21,26,-5,26
Din Moscow,9219,7,5,7,8,19,28,-9,22
FK Rubin,9219,8,5,6,9,23,20,3,21
Amkar,9219,9,5,5,10,13,24,-11,20
Rostov,9219,10,4,7,9,11,18,-7,19
Anzhi,9219,11,3,5,12,16,40,-24,14
Loko Moscow,9220,1,12,5,3,31,14,17,41
Spart Moscow,9220,2,10,6,4,39,26,13,36
CSKA Moscow,9220,3,11,3,6,26,18,8,36
Zenit,9220,4,9,8,3,25,14,11,35
Terek Grozny,9220,5,9,5,6,23,23,0,32
Krasnodar,9220,6,8,5,7,28,26,2,29
FK Rubin,9220,7,5,7,8,22,18,4,22
Din Moscow,9220,8,5,7,8,17,23,-6,22
Rostov,9220,9,4,7,9,10,17,-7,19
Amkar,9220,10,4,4,12,11,28,-17,16
Anzhi,9220,11,2,5,13,14,39,-25,11
Loko Moscow,9221,1,11,6,3,31,14,17,39
CSKA Moscow,9221,2,12,3,5,27,17,10,39
Spart Moscow,9221,3,10,6,4,39,26,13,36
Krasnodar,9221,4,10,4,6,32,27,5,34
Zenit,9221,5,7,9,4,22,15,7,30
Terek Grozny,9221,6,8,6,6,24,23,1,30
FK Rubin,9221,7,6,5,9,24,20,4,23
Din Moscow,9221,8,5,6,9,17,25,-8,21
Rostov,9221,9,4,6,10,10,19,-9,18
Amkar,9221,10,4,6,10,11,24,-13,18
Anzhi,9221,11,2,5,13,14,41,-27,11
Loko Moscow,9222,1,11,6,3,29,12,17,39
CSKA Moscow,9222,2,11,3,6,28,19,9,36
Zenit,9222,3,9,8,3,23,13,10,35
Spart Moscow,9222,4,10,5,5,35,28,7,35
Terek Grozny,9222,5,8,6,6,24,23,1,30
Krasnodar,9222,6,8,5,7,28,30,-2,29
Din Moscow,9222,7,6,6,8,19,23,-4,24
FK Rubin,9222,8,6,5,9,28,20,8,23
Amkar,9222,9,5,5,10,13,23,-10,20
Rostov,9222,10,4,6,10,10,18,-8,18
Anzhi,9222,11,2,5,13,15,43,-28,11
Loko Moscow,9223,1,12,5,3,31,13,18,41
CSKA Moscow,9223,2,11,3,6,26,19,7,36
Spart Moscow,9223,3,9,5,6,41,29,12,32
Zenit,9223,4,8,8,4,24,15,9,32
Krasnodar,9223,5,9,4,7,28,25,3,31
Terek Grozny,9223,6,7,7,6,22,24,-2,28
FK Rubin,9223,7,7,5,8,25,18,7,26
Din Moscow,9223,8,6,6,8,19,24,-5,24
Amkar,9223,9,5,5,10,13,25,-12,20
Rostov,9223,10,4,6,10,10,23,-13,18
Anzhi,9223,11,2,6,12,15,39,-24,12
Loko Moscow,9224,1,12,5,3,31,13,18,41
CSKA Moscow,9224,2,11,4,5,28,18,10,37
Spart Moscow,9224,3,10,5,5,37,28,9,35
Krasnodar,9224,4,9,4,7,28,25,3,31
Zenit,9224,5,7,9,4,23,16,7,30
Terek Grozny,9224,6,7,6,7,21,24,-3,27
Din Moscow,9224,7,6,6,8,21,24,-3,24
FK Rubin,9224,8,6,5,9,24,21,3,23
Amkar,9224,9,6,4,10,12,23,-11,22
Rostov,9224,10,4,6,10,11,19,-8,18
Anzhi,9224,11,2,6,12,15,40,-25,12
Loko Moscow,9225,1,12,5,3,31,13,18,41
CSKA Moscow,9225,2,11,3,6,29,21,8,36
Spart Moscow,9225,3,10,5,5,37,28,9,35
Zenit,9225,4,8,8,4,24,16,8,32
Terek Grozny,9225,5,8,6,6,22,23,-1,30
Krasnodar,9225,6,8,5,7,30,28,2,29
FK Rubin,9225,7,5,7,8,24,20,4,22
Din Moscow,9225,8,5,7,8,19,24,-5,22
Amkar,9225,9,5,4,11,10,23,-13,19
Rostov,9225,10,4,6,10,11,19,-8,18
Anzhi,9225,11,3,6,11,17,39,-22,15
Loko Moscow,9226,1,11,7,2,30,12,18,40
CSKA Moscow,9226,2,11,3,6,29,19,10,36
Spart Moscow,9226,3,10,5,5,39,29,10,35
Zenit,9226,4,8,9,3,22,13,9,33
Krasnodar,9226,5,8,5,7,29,29,0,29
Terek Grozny,9226,6,7,6,7,21,24,-3,27
Din Moscow,9226,7,6,6,8,20,24,-4,24
FK Rubin,9226,8,6,5,9,26,20,6,23
Rostov,9226,9,5,6,9,12,17,-5,21
Amkar,9226,10,4,5,11,10,26,-16,17
Anzhi,9226,11,3,5,12,17,42,-25,14
Loko Moscow,9227,1,12,5,3,32,15,17,41
Spart Moscow,9227,2,9,7,4,37,28,9,34
CSKA Moscow,9227,3,10,4,6,25,18,7,34
Zenit,9227,4,8,8,4,23,15,8,32
Krasnodar,9227,5,9,4,7,30,28,2,31
FK Rubin,9227,6,7,5,8,26,17,9,26
Terek Grozny,9227,7,7,5,8,21,25,-4,26
Din Moscow,9227,8,5,6,9,18,25,-7,21
Amkar,9227,9,5,5,10,11,23,-12,20
Rostov,9227,10,4,7,9,11,18,-7,19
Anzhi,9227,11,3,6,11,16,38,-22,15
Loko Moscow,9228,1,11,5,4,30,15,15,38
CSKA Moscow,9228,2,11,4,5,28,18,10,37
Zenit,9228,3,8,9,3,22,13,9,33
Spart Moscow,9228,4,9,5,6,37,31,6,32
Krasnodar,9228,5,9,4,7,30,26,4,31
Terek Grozny,9228,6,7,6,7,20,25,-5,27
Din Moscow,9228,7,6,6,8,20,23,-3,24
FK Rubin,9228,8,6,5,9,22,19,3,23
Rostov,9228,9,5,6,9,13,18,-5,21
Amkar,9228,10,5,5,10,11,23,-12,20
Anzhi,9228,11,3,5,12,18,40,-22,14
Loko Moscow,9229,1,11,6,3,31,14,17,39
CSKA Moscow,9229,2,11,3,6,27,20,7,36
Krasnodar,9229,3,10,4,6,30,25,5,34
Spart Moscow,9229,4,9,5,6,36,30,6,32
Zenit,9229,5,7,9,4,22,15,7,30
Terek Grozny,9229,6,7,5,8,20,26,-6,26
Din Moscow,9229,7,6,6,8,21,24,-3,24
Amkar,9229,8,6,4,10,14,22,-8,22
Rostov,9229,9,5,6,9,11,17,-6,21
FK Rubin,9229,10,5,5,10,21,20,1,20
Anzhi,9229,11,4,5,11,18,38,-20,17
Loko Moscow,9230,1,13,5,2,33,11,22,44
CSKA Moscow,9230,2,12,3,5,29,17,12,39
Spart Moscow,9230,3,9,6,5,35,27,8,33
Terek Grozny,9230,4,9,5,6,23,22,1,32
Zenit,9230,5,7,8,5,21,19,2,29
Krasnodar,9230,6,8,4,8,27,30,-3,28
FK Rubin,9230,7,6,6,8,27,18,9,24
Din Moscow,9230,8,5,7,8,18,23,-5,22
Rostov,9230,9,4,7,9,10,17,-7,19
Amkar,9230,10,5,4,11,11,24,-13,19
Anzhi,9230,11,2,5,13,14,40,-26,11
Loko Moscow,9231,1,11,6,3,29,12,17,39
Spart Moscow,9231,2,10,5,5,37,28,9,35
CSKA Moscow,9231,3,10,5,5,28,20,8,35
Krasnodar,9231,4,10,4,6,29,24,5,34
Zenit,9231,5,7,10,3,23,15,8,31
Terek Grozny,9231,6,7,7,6,21,23,-2,28
FK Rubin,9231,7,6,5,9,25,19,6,23
Din Moscow,9231,8,5,6,9,19,28,-9,21
Amkar,9231,9,5,5,10,11,22,-11,20
Rostov,9231,10,4,6,10,10,18,-8,18
Anzhi,9231,11,2,7,11,16,39,-23,13
Loko Moscow,9232,1,11,7,2,30,12,18,40
CSKA Moscow,9232,2,12,3,5,30,17,13,39
Spart Moscow,9232,3,11,5,4,41,26,15,38
Zenit,9232,4,7,9,4,21,14,7,30
Krasnodar,9232,5,8,6,6,28,25,3,30
Terek Grozny,9232,6,8,6,6,24,25,-1,30
Din Moscow,9232,7,6,6,8,20,24,-4,24
FK Rubin,9232,8,5,6,9,21,20,1,21
Rostov,9232,9,4,6,10,11,19,-8,18
Amkar,9232,10,4,5,11,11,27,-16,17
Anzhi,9232,11,2,5,13,15,43,-28,11
Loko Moscow,9233,1,12,5,3,31,12,19,41
CSKA Moscow,9233,2,11,4,5,29,19,10,37
Spart Moscow,9233,3,10,6,4,39,27,12,36
Krasnodar,9233,4,9,4,7,28,27,1,31
Zenit,9233,5,7,9,4,22,16,6,30
Terek Grozny,9233,6,8,5,7,24,26,-2,29
FK Rubin,9233,7,7,5,8,26,17,9,26
Din Moscow,9233,8,5,6,9,18,26,-8,21
Rostov,9233,9,4,7,9,10,17,-7,19
Amkar,9233,10,4,4,12,12,28,-16,16
Anzhi,9233,11,3,5,12,17,41,-24,14
Loko Moscow,9234,1,12,6,2,31,11,20,42
CSKA Moscow,9234,2,11,3,6,29,22,7,36
Zenit,9234,3,8,9,3,24,14,10,33
Spart Moscow,9234,4,9,6,5,34,26,8,33
Krasnodar,9234,5,9,4,7,29,26,3,31
Terek Grozny,9234,6,8,5,7,21,23,-2,29
Din Moscow,9234,7,5,7,8,18,23,-5,22
FK Rubin,9234,8,5,6,9,22,20,2,21
Rostov,9234,9,4,7,9,10,17,-7,19
Amkar,9234,10,5,4,11,10,23,-13,19
Anzhi,9234,11,3,5,12,17,40,-23,14
Loko Moscow,9235,1,12,6,2,31,12,19,42
CSKA Moscow,9235,2,11,3,6,30,21,9,36
Spart Moscow,9235,3,9,7,4,34,25,9,34
Krasnodar,9235,4,9,4,7,29,26,3,31
Zenit,9235,5,7,9,4,22,16,6,30
Terek Grozny,9235,6,7,6,7,22,25,-3,27
Din Moscow,9235,7,6,7,7,19,21,-2,25
FK Rubin,9235,8,5,5,10,21,20,1,20
Amkar,9235,9,5,5,10,10,22,-12,20
Rostov,9235,10,4,6,10,10,18,-8,18
Anzhi,9235,11,3,6,11,19,41,-22,15
Loko Moscow,9236,1,11,7,2,29,11,18,40
Spart Moscow,9236,2,11,5,4,38,27,11,38
CSKA Moscow,9236,3,11,3,6,27,20,7,36
Zenit,9236,4,8,9,3,24,14,10,33
Krasnodar,9236,5,8,6,6,27,24,3,30
Terek Grozny,9236,6,7,7,6,23,25,-2,28
Din Moscow,9236,7,6,6,8,21,24,-3,24
FK Rubin,9236,8,5,6,9,21,19,2,21
Rostov,9236,9,4,6,10,10,18,-8,18
Amkar,9236,10,4,5,11,10,24,-14,17
Anzhi,9236,11,2,6,12,16,40,-24,12
Loko Moscow,9237,1,11,7,2,30,12,18,40
CSKA Moscow,9237,2,11,4,5,31,20,11,37
Spart Moscow,9237,3,10,6,4,41,30,11,36
Krasnodar,9237,4,9,5,6,32,25,7,32
Terek Grozny,9237,5,9,5,6,24,23,1,32
Zenit,9237,6,7,10,3,23,15,8,31
Din Moscow,9237,7,5,7,8,19,24,-5,22
FK Rubin,9237,8,5,6,9,21,21,0,21
Rostov,9237,9,4,7,9,12,19,-7,19
Amkar,9237,10,4,4,12,11,27,-16,16
Anzhi,9237,11,2,5,13,15,43,-28,11
Loko Moscow,9238,1,13,5,2,33,12,21,44
CSKA Moscow,9238,2,11,3,6,31,21,10,36
Spart Moscow,9238,3,9,7,4,36,26,10,34
Krasnodar,9238,4,9,4,7,31,28,3,31
Zenit,9238,5,7,8,5,22,18,4,29
Terek Grozny,9238,6,8,5,7,22,25,-3,29
FK Rubin,9238,7,6,5,9,25,21,4,23
Din Moscow,9238,8,5,6,9,18,26,-8,21
Amkar,9238,9,5,5,10,11,22,-11,20
Rostov,9238,10,4,7,9,10,17,-7,19
Anzhi,9238,11,3,5,12,19,42,-23,14
Loko Moscow,9239,1,12,5,3,31,14,17,41
Spart Moscow,9239,2,11,5,4,42,25,17,38
CSKA Moscow,9239,3,11,3,6,28,19,9,36
Zenit,9239,4,8,8,4,23,15,8,32
Krasnodar,9239,5,9,5,6,29,24,5,32
Terek Grozny,9239,6,7,7,6,20,22,-2,28
FK Rubin,9239,7,6,6,8,24,19,5,24
Din Moscow,9239,8,5,6,9,19,29,-10,21
Rostov,9239,9,4,6,10,10,18,-8,18
Amkar,9239,10,4,5,11,9,25,-16,17
Anzhi,9239,11,2,6,12,15,40,-25,12
Loko Moscow,9240,1,12,5,3,31,14,17,41
CSKA Moscow,9240,2,11,4,5,26,17,9,37
Spart Moscow,9240,3,10,5,5,38,27,11,35
Zenit,9240,4,8,9,3,23,13,10,33
Krasnodar,9240,5,9,4,7,31,27,4,31
Terek Grozny,9240,6,8,5,7,25,24,1,29
Din Moscow,9240,7,5,7,8,17,22,-5,22
Amkar,9240,8,6,4,10,13,24,-11,22
FK Rubin,9240,9,5,6,9,22,20,2,21
Rostov,9240,10,4,6,10,10,20,-10,18
Anzhi,9240,11,2,5,13,14,42,-28,11
Loko Moscow,9241,1,11,5,4,32,17,15,38
Spart Moscow,9241,2,10,6,4,40,30,10,36
CSKA Moscow,9241,3,10,5,5,27,19,8,35
Krasnodar,9241,4,10,4,6,32,27,5,34
Zenit,9241,5,8,9,3,25,15,10,33
Terek Grozny,9241,6,7,6,7,21,24,-3,27
Din Moscow,9241,7,6,6,8,19,23,-4,24
FK Rubin,9241,8,5,5,10,22,20,2,20
Amkar,9241,9,5,5,10,14,26,-12,20
Rostov,9241,10,4,6,10,10,18,-8,18
Anzhi,9241,11,2,7,11,16,39,-23,13
Loko Moscow,9242,1,12,6,2,32,13,19,42
CSKA Moscow,9242,2,11,4,5,29,20,9,37
Spart Moscow,9242,3,10,5,5,39,28,11,35
Krasnodar,9242,4,9,5,6,29,25,4,32
Zenit,9242,5,7,8,5,24,18,6,29
Terek Grozny,9242,6,7,5,8,21,25,-4,26
FK Rubin,9242,7,6,5,9,23,18,5,23
Amkar,9242,8,6,4,10,11,22,-11,22
Din Moscow,9242,9,5,6,9,19,26,-7,21
Rostov,9242,10,4,6,10,10,20,-10,18
Anzhi,9242,11,3,6,11,17,39,-22,15
Loko Moscow,9243,1,11,5,4,31,16,15,38
CSKA Moscow,9243,2,10,4,6,26,19,7,34
Krasnodar,9243,3,10,4,6,31,25,6,34
Zenit,9243,4,8,9,3,26,16,10,33
Spart Moscow,9243,5,8,7,5,35,28,7,31
Terek Grozny,9243,6,7,7,6,23,25,-2,28
Din Moscow,9243,7,6,7,7,19,22,-3,25
FK Rubin,9243,8,5,6,9,23,21,2,21
Rostov,9243,9,4,7,9,12,19,-7,19
Amkar,9243,10,4,6,10,10,23,-13,18
Anzhi,9243,11,3,6,11,17,39,-22,15
Loko Moscow,9244,1,12,6,2,31,12,19,42
CSKA Moscow,9244,2,11,4,5,30,18,12,37
Spart Moscow,9244,3,9,7,4,37,27,10,34
Zenit,9244,4,7,9,4,23,16,7,30
Krasnodar,9244,5,8,6,6,29,26,3,30
Terek Grozny,9244,6,8,5,7,22,24,-2,29
Din Moscow,9244,7,6,7,7,19,22,-3,25
FK Rubin,9244,8,5,6,9,24,21,3,21
Rostov,9244,9,4,7,9,11,18,-7,19
Amkar,9244,10,4,4,12,10,27,-17,16
Anzhi,9244,11,3,5,12,16,41,-25,14
Loko Moscow,9245,1,12,5,3,30,12,18,41
Spart Moscow,9245,2,10,6,4,41,29,12,36
CSKA Moscow,9245,3,10,5,5,25,17,8,35
Krasnodar,9245,4,9,5,6,30,26,4,32
Zenit,9245,5,7,9,4,21,14,7,30
Terek Grozny,9245,6,8,5,7,22,23,-1,29
FK Rubin,9245,7,5,7,8,24,20,4,22
Din Moscow,9245,8,5,7,8,19,24,-5,22
Rostov,9245,9,4,7,9,12,19,-7,19
Amkar,9245,10,4,4,12,10,28,-18,16
Anzhi,9245,11,3,6,11,15,37,-22,15
Loko Moscow,9246,1,11,6,3,30,13,17,39
CSKA Moscow,9246,2,12,3,5,29,19,10,39
Spart Moscow,9246,3,9,7,4,38,28,10,34
Terek Grozny,9246,4,9,5,6,25,22,3,32
Krasnodar,9246,5,9,4,7,29,26,3,31
Zenit,9246,6,7,9,4,23,16,7,30
Din Moscow,9246,7,6,6,8,18,23,-5,24
FK Rubin,9246,8,6,5,9,23,19,4,23
Rostov,9246,9,4,7,9,12,19,-7,19
Amkar,9246,10,4,5,11,10,24,-14,17
Anzhi,9246,11,2,5,13,15,43,-28,11
Loko Moscow,9247,1,11,6,3,31,14,17,39
CSKA Moscow,9247,2,12,3,5,30,17,13,39
Zenit,9247,3,8,8,4,23,15,8,32
Spart Moscow,9247,4,8,7,5,36,29,7,31
Krasnodar,9247,5,8,6,6,28,25,3,30
Terek Grozny,9247,6,7,5,8,21,25,-4,26
Din Moscow,9247,7,6,7,7,21,24,-3,25
Amkar,9247,8,6,4,10,11,22,-11,22
FK Rubin,9247,9,5,6,9,22,19,3,21
Rostov,9247,10,4,7,9,11,18,-7,19
Anzhi,9247,11,3,5,12,16,42,-26,14
CSKA Moscow,9248,1,12,3,5,29,19,10,39
Loko Moscow,9248,2,11,5,4,30,15,15,38
Spart Moscow,9248,3,10,5,5,38,26,12,35
Zenit,9248,4,8,8,4,25,16,9,32
Krasnodar,9248,5,9,5,6,28,24,4,32
Terek Grozny,9248,6,7,7,6,21,23,-2,28
FK Rubin,9248,7,6,6,8,24,17,7,24
Rostov,9248,8,5,6,9,11,17,-6,21
Din Moscow,9248,9,5,6,9,17,27,-10,21
Amkar,9248,10,4,5,11,9,24,-15,17
Anzhi,9248,11,2,6,12,16,40,-24,12
Loko Moscow,9249,1,11,7,2,33,15,18,40
CSKA Moscow,9249,2,11,4,5,28,19,9,37
Spart Moscow,9249,3,10,5,5,39,28,11,35
Zenit,9249,4,7,9,4,22,15,7,30
Krasnodar,9249,5,8,5,7,32,30,2,29
Terek Grozny,9249,6,8,5,7,22,26,-4,29
Din Moscow,9249,7,6,6,8,22,25,-3,24
FK Rubin,9249,8,6,5,9,25,23,2,23
Amkar,9249,9,5,4,11,11,24,-13,19
Rostov,9249,10,4,6,10,11,20,-9,18
Anzhi,9249,11,3,6,11,19,39,-20,15
Loko Moscow,9250,1,12,5,3,31,14,17,41
CSKA Moscow,9250,2,11,3,6,26,19,7,36
Spart Moscow,9250,3,10,5,5,35,28,7,35
Zenit,9250,4,8,8,4,23,14,9,32
Krasnodar,9250,5,9,4,7,30,26,4,31
FK Rubin,9250,6,7,5,8,24,17,7,26
Terek Grozny,9250,7,7,5,8,21,25,-4,26
Amkar,9250,8,6,4,10,13,22,-9,22
Din Moscow,9250,9,5,6,9,17,24,-7,21
Rostov,9250,10,4,6,10,10,18,-8,18
Anzhi,9250,11,3,5,12,16,39,-23,14
Loko Moscow,9251,1,13,5,2,33,12,21,44
CSKA Moscow,9251,2,10,4,6,27,20,7,34
Zenit,9251,3,8,8,4,22,14,8,32
Spart Moscow,9251,4,8,7,5,35,28,7,31
Krasnodar,9251,5,9,4,7,29,27,2,31
Terek Grozny,9251,6,7,6,7,22,25,-3,27
FK Rubin,9251,7,6,5,9,22,18,4,23
Din Moscow,9251,8,5,7,8,18,23,-5,22
Amkar,9251,9,5,5,10,11,23,-12,20
Rostov,9251,10,4,7,9,11,18,-7,19
Anzhi,9251,11,3,6,11,18,40,-22,15
Loko Moscow,9252,1,12,5,3,31,13,18,41
CSKA Moscow,9252,2,11,4,5,26,17,9,37
Spart Moscow,9252,3,9,6,5,38,29,9,33
Zenit,9252,4,8,8,4,23,15,8,32
Krasnodar,9252,5,9,4,7,30,25,5,31
Terek Grozny,9252,6,7,7,6,23,25,-2,28
Din Moscow,9252,7,6,7,7,20,23,-3,25
Rostov,9252,8,5,6,9,12,18,-6,21
FK Rubin,9252,9,5,5,10,21,21,0,20
Amkar,9252,10,4,5,11,10,25,-15,17
Anzhi,9252,11,2,7,11,16,39,-23,13
Loko Moscow,9253,1,11,7,2,29,11,18,40
Spart Moscow,9253,2,11,5,4,40,25,15,38
Zenit,9253,3,8,9,3,24,13,11,33
CSKA Moscow,9253,4,10,3,7,26,24,2,33
Krasnodar,9253,5,9,5,6,29,24,5,32
Terek Grozny,9253,6,7,5,8,20,29,-9,26
Din Moscow,9253,7,5,7,8,18,24,-6,22
FK Rubin,9253,8,5,6,9,22,20,2,21
Amkar,9253,9,5,4,11,14,26,-12,19
Rostov,9253,10,4,6,10,10,18,-8,18
Anzhi,9253,11,4,5,11,20,38,-18,17
Loko Moscow,9254,1,12,6,2,34,15,19,42
CSKA Moscow,9254,2,11,4,5,30,21,9,37
Spart Moscow,9254,3,9,5,6,40,28,12,32
Krasnodar,9254,4,9,5,6,32,28,4,32
Zenit,9254,5,7,9,4,25,18,7,30
Terek Grozny,9254,6,7,5,8,21,25,-4,26
Din Moscow,9254,7,5,7,8,18,28,-10,22
Amkar,9254,8,6,4,10,12,23,-11,22
FK Rubin,9254,9,5,6,9,23,20,3,21
Rostov,9254,10,5,6,9,12,18,-6,21
Anzhi,9254,11,3,5,12,16,39,-23,14
Loko Moscow,9255,1,11,5,4,29,14,15,38
Spart Moscow,9255,2,10,5,5,37,26,11,35
Zenit,9255,3,9,8,3,25,14,11,35
CSKA Moscow,9255,4,10,3,7,26,20,6,33
Krasnodar,9255,5,9,5,6,29,25,4,32
Terek Grozny,9255,6,8,5,7,24,25,-1,29
Din Moscow,9255,7,6,6,8,18,23,-5,24
FK Rubin,9255,8,5,6,9,22,19,3,21
Amkar,9255,9,5,4,11,10,24,-14,19
Rostov,9255,10,4,6,10,10,19,-9,18
Anzhi,9255,11,4,5,11,18,39,-21,17
Loko Moscow,9256,1,11,6,3,29,14,15,39
CSKA Moscow,9256,2,11,4,5,32,18,14,37
Spart Moscow,9256,3,9,6,5,37,27,10,33
Krasnodar,9256,4,9,5,6,31,25,6,32
Zenit,9256,5,7,10,3,22,14,8,31
Terek Grozny,9256,6,8,5,7,21,23,-2,29
Din Moscow,9256,7,6,7,7,20,23,-3,25
FK Rubin,9256,8,5,7,8,23,19,4,22
Amkar,9256,9,5,5,10,10,22,-12,20
Rostov,9256,10,4,6,10,10,20,-10,18
Anzhi,9256,11,2,5,13,14,44,-30,11
Loko Moscow,9257,1,11,6,3,32,17,15,39
Spart Moscow,9257,2,11,5,4,38,26,12,38
CSKA Moscow,9257,3,11,3,6,26,20,6,36
Zenit,9257,4,9,8,3,28,14,14,35
Krasnodar,9257,5,9,5,6,31,27,4,32
Terek Grozny,9257,6,7,7,6,21,23,-2,28
Din Moscow,9257,7,6,6,8,20,22,-2,24
FK Rubin,9257,8,5,5,10,22,22,0,20
Rostov,9257,9,4,6,10,10,19,-9,18
Amkar,9257,10,4,5,11,11,25,-14,17
Anzhi,9257,11,2,6,12,14,38,-24,12
Loko Moscow,9258,1,11,7,2,31,13,18,40
CSKA Moscow,9258,2,11,4,5,28,18,10,37
Spart Moscow,9258,3,10,5,5,39,29,10,35
Zenit,9258,4,7,10,3,23,15,8,31
Krasnodar,9258,5,8,5,7,29,29,0,29
Terek Grozny,9258,6,7,6,7,21,25,-4,27
FK Rubin,9258,7,6,6,8,25,18,7,24
Din Moscow,9258,8,5,7,8,17,23,-6,22
Amkar,9258,9,6,4,10,16,26,-10,22
Rostov,9258,10,4,6,10,10,18,-8,18
Anzhi,9258,11,2,6,12,14,39,-25,12
Loko Moscow,9259,1,13,5,2,32,11,21,44
CSKA Moscow,9259,2,12,3,5,28,18,10,39
Spart Moscow,9259,3,11,5,4,39,25,14,38
Krasnodar,9259,4,9,4,7,29,26,3,31
Terek Grozny,9259,5,8,6,6,24,22,2,30
Zenit,9259,6,7,8,5,22,17,5,29
Din Moscow,9259,7,6,6,8,20,25,-5,24
FK Rubin,9259,8,5,5,10,24,22,2,20
Rostov,9259,9,4,6,10,10,19,-9,18
Amkar,9259,10,4,5,11,9,24,-15,17
Anzhi,9259,11,2,5,13,14,42,-28,11
Loko Moscow,9260,1,11,7,2,31,13,18,40
CSKA Moscow,9260,2,11,3,6,28,19,9,36
Zenit,9260,3,8,9,3,24,15,9,33
Spart Moscow,9260,4,8,6,6,36,31,5,30
Krasnodar,9260,5,8,6,6,29,26,3,30
Din Moscow,9260,6,7,6,7,19,21,-2,27
Terek Grozny,9260,7,7,5,8,21,26,-5,26
Amkar,9260,8,6,4,10,13,23,-10,22
FK Rubin,9260,9,5,6,9,22,19,3,21
Rostov,9260,10,4,7,9,12,19,-7,19
Anzhi,9260,11,3,5,12,17,40,-23,14
Loko Moscow,9261,1,12,6,2,33,14,19,42
CSKA Moscow,9261,2,11,4,5,28,18,10,37
Spart Moscow,9261,3,10,6,4,38,27,11,36
Zenit,9261,4,7,9,4,23,16,7,30
Krasnodar,9261,5,8,5,7,30,28,2,29
Terek Grozny,9261,6,7,7,6,22,24,-2,28
FK Rubin,9261,7,7,5,8,25,19,6,26
Din Moscow,9261,8,5,7,8,19,24,-5,22
Rostov,9261,9,4,6,10,10,19,-9,18
Amkar,9261,10,4,5,11,12,26,-14,17
Anzhi,9261,11,2,6,12,14,39,-25,12
Loko Moscow,9262,1,12,6,2,31,12,19,42
Spart Moscow,9262,2,10,5,5,40,29,11,35
CSKA Moscow,9262,3,10,4,6,26,20,6,34
Zenit,9262,4,8,8,4,23,14,9,32
Krasnodar,9262,5,8,6,6,30,27,3,30
Terek Grozny,9262,6,7,5,8,20,25,-5,26
FK Rubin,9262,7,5,7,8,24,20,4,22
Din Moscow,9262,8,5,7,8,18,25,-7,22
Amkar,9262,9,6,4,10,14,23,-9,22
Rostov,9262,10,4,6,10,11,20,-9,18
Anzhi,9262,11,3,6,11,16,38,-22,15
Loko Moscow,9263,1,11,6,3,29,12,17,39
CSKA Moscow,9263,2,12,3,5,31,19,12,39
Spart Moscow,9263,3,9,6,5,39,31,8,33
Zenit,9263,4,8,8,4,24,16,8,32
Krasnodar,9263,5,8,6,6,28,25,3,30
Terek Grozny,9263,6,7,6,7,22,26,-4,27
Din Moscow,9263,7,6,6,8,21,24,-3,24
FK Rubin,9263,8,5,6,9,23,21,2,21
Rostov,9263,9,5,6,9,13,19,-6,21
Amkar,9263,10,4,6,10,13,26,-13,18
Anzhi,9263,11,3,5,12,16,40,-24,14
CSKA Moscow,9264,1,12,3,5,29,18,11,39
Spart Moscow,9264,2,11,5,4,41,27,14,38
Loko Moscow,9264,3,11,5,4,30,16,14,38
Zenit,9264,4,8,8,4,25,17,8,32
Terek Grozny,9264,5,9,5,6,24,22,2,32
Krasnodar,9264,6,9,4,7,29,26,3,31
FK Rubin,9264,7,6,6,8,23,17,6,24
Din Moscow,9264,8,5,7,8,18,23,-5,22
Rostov,9264,9,4,6,10,10,20,-10,18
Amkar,9264,10,4,4,12,10,27,-17,16
Anzhi,9264,11,2,5,13,14,40,-26,11
Loko Moscow,9265,1,11,5,4,32,16,16,38
CSKA Moscow,9265,2,11,4,5,26,17,9,37
Spart Moscow,9265,3,10,6,4,42,30,12,36
Krasnodar,9265,4,10,4,6,31,26,5,34
Zenit,9265,5,8,9,3,23,14,9,33
Terek Grozny,9265,6,9,5,6,23,22,1,32
FK Rubin,9265,7,6,5,9,22,18,4,23
Din Moscow,9265,8,5,7,8,19,24,-5,22
Rostov,9265,9,4,6,10,12,21,-9,18
Amkar,9265,10,4,4,12,10,26,-16,16
Anzhi,9265,11,2,5,13,14,40,-26,11
Loko Moscow,9266,1,12,6,2,30,11,19,42
CSKA Moscow,9266,2,11,3,6,27,18,9,36
Spart Moscow,9266,3,10,5,5,37,30,7,35
Zenit,9266,4,8,9,3,22,13,9,33
Terek Grozny,9266,5,8,5,7,25,27,-2,29
Krasnodar,9266,6,8,4,8,27,26,1,28
FK Rubin,9266,7,7,5,8,24,17,7,26
Rostov,9266,8,5,6,9,14,17,-3,21
Din Moscow,9266,9,5,6,9,17,24,-7,21
Amkar,9266,10,5,4,11,14,28,-14,19
Anzhi,9266,11,2,5,13,15,41,-26,11
Loko Moscow,9267,1,12,5,3,30,13,17,41
Spart Moscow,9267,2,9,6,5,36,28,8,33
CSKA Moscow,9267,3,10,3,7,25,21,4,33
Zenit,9267,4,8,8,4,22,14,8,32
Krasnodar,9267,5,9,4,7,30,26,4,31
Terek Grozny,9267,6,7,6,7,21,24,-3,27
Din Moscow,9267,7,6,6,8,21,24,-3,24
FK Rubin,9267,8,6,5,9,24,21,3,23
Amkar,9267,9,6,4,10,13,24,-11,22
Rostov,9267,10,4,7,9,10,17,-7,19
Anzhi,9267,11,3,6,11,17,37,-20,15
Loko Moscow,9268,1,13,5,2,33,13,20,44
Spart Moscow,9268,2,10,5,5,41,29,12,35
CSKA Moscow,9268,3,10,3,7,27,22,5,33
Zenit,9268,4,8,8,4,22,14,8,32
Krasnodar,9268,5,9,4,7,32,28,4,31
Terek Grozny,9268,6,8,6,6,23,24,-1,30
Din Moscow,9268,7,6,6,8,20,24,-4,24
Rostov,9268,8,5,6,9,14,20,-6,21
FK Rubin,9268,9,5,5,10,22,23,-1,20
Amkar,9268,10,4,5,11,11,26,-15,17
Anzhi,9268,11,3,5,12,18,40,-22,14
Loko Moscow,9269,1,12,5,3,34,15,19,41
Spart Moscow,9269,2,11,5,4,38,26,12,38
CSKA Moscow,9269,3,11,3,6,28,21,7,36
Zenit,9269,4,9,8,3,27,15,12,35
Krasnodar,9269,5,9,4,7,31,28,3,31
Terek Grozny,9269,6,8,6,6,23,23,0,30
FK Rubin,9269,7,6,5,9,25,22,3,23
Din Moscow,9269,8,5,6,9,19,25,-6,21
Rostov,9269,9,4,6,10,11,19,-8,18
Amkar,9269,10,4,4,12,9,26,-17,16
Anzhi,9269,11,2,6,12,16,41,-25,12
Loko Moscow,9270,1,13,5,2,33,13,20,44
Spart Moscow,9270,2,10,6,4,40,28,12,36
CSKA Moscow,9270,3,11,3,6,28,20,8,36
Zenit,9270,4,8,8,4,24,16,8,32
Terek Grozny,9270,5,8,6,6,23,24,-1,30
Krasnodar,9270,6,8,5,7,29,27,2,29
FK Rubin,9270,7,6,6,8,25,19,6,24
Din Moscow,9270,8,5,6,9,20,29,-9,21
Rostov,9270,9,4,7,9,11,18,-7,19
Amkar,9270,10,4,5,11,9,23,-14,17
Anzhi,9270,11,2,5,13,17,42,-25,11
Loko Moscow,9271,1,12,5,3,33,15,18,41
CSKA Moscow,9271,2,11,3,6,29,19,10,36
Spart Moscow,9271,3,10,5,5,39,28,11,35
Krasnodar,9271,4,10,4,6,31,26,5,34
Zenit,9271,5,8,8,4,23,15,8,32
Terek Grozny,9271,6,9,5,6,23,22,1,32
Din Moscow,9271,7,6,6,8,21,23,-2,24
Rostov,9271,8,5,6,9,12,18,-6,21
FK Rubin,9271,9,5,5,10,21,22,-1,20
Amkar,9271,10,4,4,12,10,26,-16,16
Anzhi,9271,11,2,5,13,15,43,-28,11
Loko Moscow,9272,1,13,5,2,32,12,20,44
CSKA Moscow,9272,2,11,3,6,29,21,8,36
Zenit,9272,3,7,8,5,24,18,6,29
Krasnodar,9272,4,8,5,7,27,25,2,29
Spart Moscow,9272,5,8,5,7,33,34,-1,29
Terek Grozny,9272,6,7,6,7,20,25,-5,27
Din Moscow,9272,7,6,7,7,19,21,-2,25
FK Rubin,9272,8,5,7,8,21,17,4,22
Rostov,9272,9,5,6,9,13,17,-4,21
Amkar,9272,10,5,5,10,13,22,-9,20
Anzhi,9272,11,4,5,11,19,38,-19,17
Loko Moscow,9273,1,12,5,3,31,12,19,41
CSKA Moscow,9273,2,11,4,5,27,17,10,37
Spart Moscow,9273,3,9,6,5,35,30,5,33
Krasnodar,9273,4,9,4,7,28,25,3,31
Zenit,9273,5,7,9,4,21,15,6,30
Terek Grozny,9273,6,8,6,6,26,26,0,30
FK Rubin,9273,7,7,5,8,25,17,8,26
Din Moscow,9273,8,5,7,8,18,25,-7,22
Amkar,9273,9,5,4,11,14,25,-11,19
Rostov,9273,10,4,6,10,10,18,-8,18
Anzhi,9273,11,2,6,12,17,42,-25,12
Loko Moscow,9274,1,13,5,2,32,11,21,44
Spart Moscow,9274,2,11,5,4,39,27,12,38
CSKA Moscow,9274,3,11,4,5,28,18,10,37
Zenit,9274,4,7,9,4,22,15,7,30
Krasnodar,9274,5,8,5,7,28,27,1,29
Terek Grozny,9274,6,8,5,7,23,26,-3,29
FK Rubin,9274,7,5,7,8,22,18,4,22
Din Moscow,9274,8,5,7,8,19,24,-5,22
Rostov,9274,9,4,6,10,10,18,-8,18
Amkar,9274,10,4,4,12,11,27,-16,16
Anzhi,9274,11,3,5,12,16,39,-23,14
Loko Moscow,9275,1,11,6,3,29,12,17,39
CSKA Moscow,9275,2,11,4,5,29,19,10,37
Spart Moscow,9275,3,9,6,5,36,28,8,33
Zenit,9275,4,8,8,4,23,16,7,32
Krasnodar,9275,5,8,6,6,28,25,3,30
Terek Grozny,9275,6,8,5,7,24,27,-3,29
Din Moscow,9275,7,6,7,7,18,21,-3,25
Amkar,9275,8,6,4,10,13,23,-10,22
FK Rubin,9275,9,5,6,9,22,19,3,21
Rostov,9275,10,4,6,10,12,20,-8,18
Anzhi,9275,11,2,6,12,17,41,-24,12
Loko Moscow,9276,1,12,5,3,31,14,17,41
Spart Moscow,9276,2,10,6,4,40,29,11,36
CSKA Moscow,9276,3,10,4,6,25,18,7,34
Zenit,9276,4,8,8,4,22,15,7,32
Krasnodar,9276,5,9,5,6,30,24,6,32
Terek Grozny,9276,6,7,6,7,21,25,-4,27
Din Moscow,9276,7,6,7,7,21,23,-2,25
FK Rubin,9276,8,5,6,9,22,20,2,21
Rostov,9276,9,4,6,10,12,21,-9,18
Amkar,9276,10,4,5,11,11,25,-14,17
Anzhi,9276,11,3,6,11,16,37,-21,15
Loko Moscow,9277,1,11,5,4,31,18,13,38
CSKA Moscow,9277,2,11,3,6,27,20,7,36
Spart Moscow,9277,3,10,5,5,39,26,13,35
Zenit,9277,4,9,8,3,26,14,12,35
Krasnodar,9277,5,10,4,6,33,25,8,34
Terek Grozny,9277,6,8,5,7,23,23,0,29
FK Rubin,9277,7,6,5,9,22,18,4,23
Amkar,9277,8,6,4,10,11,22,-11,22
Din Moscow,9277,9,5,6,9,17,24,-7,21
Rostov,9277,10,4,6,10,10,21,-11,18
Anzhi,9277,11,2,5,13,14,42,-28,11
Loko Moscow,9278,1,13,5,2,34,13,21,44
Spart Moscow,9278,2,10,5,5,38,28,10,35
CSKA Moscow,9278,3,10,5,5,27,19,8,35
Krasnodar,9278,4,9,4,7,32,27,5,31
Zenit,9278,5,7,9,4,22,16,6,30
Terek Grozny,9278,6,8,6,6,25,24,1,30
Din Moscow,9278,7,5,7,8,18,23,-5,22
FK Rubin,9278,8,5,6,9,23,22,1,21
Amkar,9278,9,5,4,11,11,26,-15,19
Rostov,9278,10,4,6,10,11,20,-9,18
Anzhi,9278,11,2,7,11,18,41,-23,13
Loko Moscow,9279,1,11,6,3,30,14,16,39
CSKA Moscow,9279,2,11,4,5,27,18,9,37
Spart Moscow,9279,3,9,7,4,39,28,11,34
Zenit,9279,4,7,10,3,23,15,8,31
Krasnodar,9279,5,9,4,7,30,26,4,31
Terek Grozny,9279,6,8,5,7,23,24,-1,29
FK Rubin,9279,7,6,6,8,23,18,5,24
Din Moscow,9279,8,5,7,8,17,24,-7,22
Amkar,9279,9,5,5,10,13,25,-12,20
Rostov,9279,10,4,7,9,11,18,-7,19
Anzhi,9279,11,2,5,13,14,40,-26,11
Loko Moscow,9280,1,12,5,3,32,14,18,41
CSKA Moscow,9280,2,11,3,6,27,20,7,36
Krasnodar,9280,3,10,4,6,34,27,7,34
Spart Moscow,9280,4,9,6,5,38,29,9,33
Zenit,9280,5,8,8,4,24,16,8,32
Terek Grozny,9280,6,7,6,7,21,25,-4,27
Din Moscow,9280,7,6,6,8,20,25,-5,24
FK Rubin,9280,8,6,5,9,26,22,4,23
Rostov,9280,9,4,7,9,11,18,-7,19
Amkar,9280,10,4,5,11,9,24,-15,17
Anzhi,9280,11,3,5,12,18,40,-22,14
Loko Moscow,9281,1,11,7,2,30,12,18,40
CSKA Moscow,9281,2,11,3,6,28,23,5,36
Spart Moscow,9281,3,9,7,4,37,28,9,34
Zenit,9281,4,8,9,3,28,15,13,33
Krasnodar,9281,5,9,5,6,28,24,4,32
Terek Grozny,9281,6,7,5,8,21,25,-4,26
Din Moscow,9281,7,6,7,7,20,22,-2,25
FK Rubin,9281,8,5,5,10,21,20,1,20
Rostov,9281,9,4,7,9,10,17,-7,19
Amkar,9281,10,5,4,11,13,26,-13,19
Anzhi,9281,11,3,5,12,15,39,-24,14
Loko Moscow,9282,1,11,5,4,29,14,15,38
CSKA Moscow,9282,2,11,3,6,28,19,9,36
Zenit,9282,3,9,8,3,24,14,10,35
Spart Moscow,9282,4,9,6,5,41,31,10,33
Krasnodar,9282,5,9,5,6,30,25,5,32
Terek Grozny,9282,6,9,5,6,26,23,3,32
Din Moscow,9282,7,7,6,7,21,23,-2,27
FK Rubin,9282,8,5,6,9,23,20,3,21
Rostov,9282,9,4,6,10,11,21,-10,18
Amkar,9282,10,4,5,11,13,28,-15,17
Anzhi,9282,11,2,5,13,14,42,-28,11
Loko Moscow,9283,1,12,6,2,32,12,20,42
CSKA Moscow,9283,2,11,4,5,28,19,9,37
Spart Moscow,9283,3,10,5,5,38,26,12,35
Krasnodar,9283,4,9,5,6,29,25,4,32
Zenit,9283,5,7,9,4,22,16,6,30
Terek Grozny,9283,6,8,6,6,21,22,-1,30
Din Moscow,9283,7,7,6,7,21,22,-1,27
FK Rubin,9283,8,5,5,10,22,21,1,20
Rostov,9283,9,4,6,10,10,21,-11,18
Amkar,9283,10,4,4,12,9,24,-15,16
Anzhi,9283,11,2,6,12,15,39,-24,12
Loko Moscow,9284,1,12,6,2,31,11,20,42
CSKA Moscow,9284,2,10,5,5,25,17,8,35
Spart Moscow,9284,3,9,6,5,38,28,10,33
Krasnodar,9284,4,9,5,6,30,25,5,32
Zenit,9284,5,7,9,4,21,15,6,30
Terek Grozny,9284,6,7,7,6,22,24,-2,28
FK Rubin,9284,7,6,5,9,23,20,3,23
Din Moscow,9284,8,5,7,8,17,22,-5,22
Amkar,9284,9,5,5,10,13,25,-12,20
Rostov,9284,10,4,6,10,10,20,-10,18
Anzhi,9284,11,2,7,11,15,38,-23,13
Loko Moscow,9285,1,12,5,3,31,14,17,41
CSKA Moscow,9285,2,10,4,6,25,21,4,34
Zenit,9285,3,8,8,4,26,15,11,32
Spart Moscow,9285,4,9,5,6,36,29,7,32
Krasnodar,9285,5,9,4,7,30,26,4,31
Terek Grozny,9285,6,8,5,7,22,24,-2,29
Din Moscow,9285,7,7,6,7,20,22,-2,27
FK Rubin,9285,8,6,5,9,23,19,4,23
Amkar,9285,9,6,4,10,12,22,-10,22
Rostov,9285,10,4,6,10,10,19,-9,18
Anzhi,9285,11,2,6,12,15,39,-24,12
Loko Moscow,9286,1,12,6,2,35,14,21,42
Spart Moscow,9286,2,9,7,4,38,28,10,34
CSKA Moscow,9286,3,10,4,6,27,21,6,34
Zenit,9286,4,8,8,4,24,17,7,32
Krasnodar,9286,5,8,6,6,29,26,3,30
Terek Grozny,9286,6,8,5,7,22,25,-3,29
FK Rubin,9286,7,6,6,8,22,17,5,24
Din Moscow,9286,8,5,6,9,17,24,-7,21
Amkar,9286,9,5,5,10,11,22,-11,20
Rostov,9286,10,4,7,9,13,20,-7,19
Anzhi,9286,11,2,6,12,17,41,-24,12
Loko Moscow,9287,1,13,5,2,32,12,20,44
CSKA Moscow,9287,2,11,4,5,27,17,10,37
Spart Moscow,9287,3,9,5,6,34,29,5,32
Terek Grozny,9287,4,9,5,6,24,23,1,32
Zenit,9287,5,7,9,4,22,15,7,30
Krasnodar,9287,6,8,4,8,27,26,1,28
Din Moscow,9287,7,6,7,7,19,21,-2,25
FK Rubin,9287,8,6,6,8,22,17,5,24
Amkar,9287,9,5,4,11,12,24,-12,19
Rostov,9287,10,4,6,10,10,18,-8,18
Anzhi,9287,11,2,5,13,14,41,-27,11
Loko Moscow,9288,1,12,5,3,32,15,17,41
Spart Moscow,9288,2,10,6,4,38,28,10,36
CSKA Moscow,9288,3,11,3,6,27,20,7,36
Zenit,9288,4,8,8,4,25,16,9,32
Krasnodar,9288,5,9,4,7,31,27,4,31
Terek Grozny,9288,6,7,7,6,21,23,-2,28
FK Rubin,9288,7,6,6,8,24,19,5,24
Din Moscow,9288,8,5,8,7,20,24,-4,23
Rostov,9288,9,4,6,10,11,19,-8,18
Amkar,9288,10,4,5,11,9,23,-14,17
Anzhi,9288,11,2,6,12,15,39,-24,12
Loko Moscow,9289,1,11,7,2,32,14,18,40
CSKA Moscow,9289,2,11,4,5,31,20,11,37
Spart Moscow,9289,3,9,7,4,38,28,10,34
Zenit,9289,4,7,10,3,24,16,8,31
Krasnodar,9289,5,8,5,7,29,27,2,29
Terek Grozny,9289,6,7,6,7,20,24,-4,27
Din Moscow,9289,7,6,6,8,19,24,-5,24
FK Rubin,9289,8,6,5,9,22,18,4,23
Amkar,9289,9,5,5,10,12,23,-11,20
Rostov,9289,10,4,7,9,11,18,-7,19
Anzhi,9289,11,2,6,12,15,41,-26,12
Loko Moscow,9290,1,11,6,3,30,13,17,39
CSKA Moscow,9290,2,12,3,5,29,18,11,39
Spart Moscow,9290,3,8,8,4,36,28,8,32
Zenit,9290,4,8,8,4,22,14,8,32
Krasnodar,9290,5,8,6,6,28,25,3,30
Terek Grozny,9290,6,8,6,6,22,23,-1,30
Din Moscow,9290,7,5,8,7,19,23,-4,23
FK Rubin,9290,8,5,7,8,21,17,4,22
Rostov,9290,9,4,7,9,10,17,-7,19
Amkar,9290,10,4,6,10,10,23,-13,18
Anzhi,9290,11,2,5,13,16,42,-26,11
Loko Moscow,9291,1,12,5,3,31,12,19,41
CSKA Moscow,9291,2,11,4,5,27,18,9,37
Zenit,9291,3,8,9,3,23,14,9,33
Spart Moscow,9291,4,9,5,6,38,31,7,32
Terek Grozny,9291,5,8,6,6,22,23,-1,30
Krasnodar,9291,6,8,4,8,29,29,0,28
FK Rubin,9291,7,7,5,8,25,19,6,26
Din Moscow,9291,8,5,6,9,19,25,-6,21
Rostov,9291,9,5,6,9,12,18,-6,21
Amkar,9291,10,5,5,10,12,24,-12,20
Anzhi,9291,11,2,5,13,14,39,-25,11
Loko Moscow,9292,1,11,7,2,30,12,18,40
CSKA Moscow,9292,2,12,3,5,31,19,12,39
Spart Moscow,9292,3,9,7,4,36,27,9,34
Krasnodar,9292,4,9,5,6,31,26,5,32
Zenit,9292,5,7,9,4,22,15,7,30
Terek Grozny,9292,6,8,6,6,22,22,0,30
Din Moscow,9292,7,6,7,7,19,22,-3,25
FK Rubin,9292,8,5,5,10,23,22,1,20
Rostov,9292,9,4,7,9,10,17,-7,19
Amkar,9292,10,4,5,11,11,25,-14,17
Anzhi,9292,11,2,5,13,15,43,-28,11
CSKA Moscow,9293,1,12,3,5,30,18,12,39
Loko Moscow,9293,2,11,5,4,29,14,15,38
Spart Moscow,9293,3,11,5,4,42,28,14,38
Krasnodar,9293,4,10,4,6,32,25,7,34
Zenit,9293,5,8,8,4,22,15,7,32
Terek Grozny,9293,6,8,5,7,21,23,-2,29
Din Moscow,9293,7,6,6,8,19,25,-6,24
FK Rubin,9293,8,5,5,10,22,22,0,20
Amkar,9293,9,5,4,11,12,25,-13,19
Rostov,9293,10,4,6,10,11,19,-8,18
Anzhi,9293,11,2,5,13,15,41,-26,11
Loko Moscow,9294,1,12,6,2,31,12,19,42
CSKA Moscow,9294,2,10,4,6,26,19,7,34
Spart Moscow,9294,3,9,6,5,35,28,7,33
Zenit,9294,4,8,8,4,23,15,8,32
Krasnodar,9294,5,8,5,7,27,25,2,29
Terek Grozny,9294,6,8,5,7,25,28,-3,29
FK Rubin,9294,7,6,6,8,23,18,5,24
Din Moscow,9294,8,5,8,7,18,22,-4,23
Amkar,9294,9,6,4,10,16,23,-7,22
Rostov,9294,10,4,6,10,10,19,-9,18
Anzhi,9294,11,2,6,12,17,42,-25,12
Loko Moscow,9295,1,12,6,2,32,12,20,42
CSKA Moscow,9295,2,11,3,6,28,18,10,36
Spart Moscow,9295,3,10,5,5,38,30,8,35
Zenit,9295,4,8,9,3,22,13,9,33
Krasnodar,9295,5,9,4,7,30,28,2,31
Terek Grozny,9295,6,7,5,8,20,25,-5,26
Din Moscow,9295,7,6,6,8,22,25,-3,24
FK Rubin,9295,8,6,5,9,24,20,4,23
Amkar,9295,9,5,4,11,12,24,-12,19
Rostov,9295,10,4,6,10,10,18,-8,18
Anzhi,9295,11,3,5,12,15,40,-25,14
Loko Moscow,9296,1,11,6,3,29,14,15,39
CSKA Moscow,9296,2,10,5,5,25,17,8,35
Krasnodar,9296,3,10,4,6,31,24,7,34
Zenit,9296,4,7,10,3,21,13,8,31
Spart Moscow,9296,5,8,6,6,37,31,6,30
Terek Grozny,9296,6,7,7,6,21,23,-2,28
Din Moscow,9296,7,7,6,7,21,21,0,27
FK Rubin,9296,8,5,5,10,21,21,0,20
Amkar,9296,9,5,5,10,12,24,-12,20
Rostov,9296,10,4,7,9,13,20,-7,19
Anzhi,9296,11,2,7,11,14,37,-23,13
Loko Moscow,9297,1,11,6,3,31,16,15,39
CSKA Moscow,9297,2,11,3,6,27,19,8,36
Zenit,9297,3,8,9,3,25,16,9,33
Krasnodar,9297,4,9,5,6,31,25,6,32
Spart Moscow,9297,5,8,7,5,34,27,7,31
Terek Grozny,9297,6,7,5,8,20,25,-5,26
FK Rubin,9297,7,6,6,8,23,18,5,24
Din Moscow,9297,8,5,7,8,17,22,-5,22
Rostov,9297,9,5,6,9,12,18,-6,21
Amkar,9297,10,5,5,10,11,22,-11,20
Anzhi,9297,11,3,5,12,15,38,-23,14
Loko Moscow,9298,1,12,6,2,31,11,20,42
CSKA Moscow,9298,2,11,4,5,28,18,10,37
Spart Moscow,9298,3,10,5,5,39,27,12,35
Krasnodar,9298,4,9,5,6,29,24,5,32
Zenit,9298,5,7,9,4,22,16,6,30
Terek Grozny,9298,6,7,7,6,22,24,-2,28
Din Moscow,9298,7,6,6,8,19,26,-7,24
Rostov,9298,8,5,6,9,12,18,-6,21
FK Rubin,9298,9,5,5,10,22,21,1,20
Amkar,9298,10,4,5,11,9,23,-14,17
Anzhi,9298,11,2,6,12,16,41,-25,12
Loko Moscow,9299,1,12,6,2,32,13,19,42
Spart Moscow,9299,2,10,6,4,39,27,12,36
CSKA Moscow,9299,3,10,4,6,27,20,7,34
Zenit,9299,4,8,9,3,25,16,9,33
Terek Grozny,9299,5,8,6,6,21,22,-1,30
Krasnodar,9299,6,8,4,8,28,29,-1,28
FK Rubin,9299,7,6,6,8,26,19,7,24
Din Moscow,9299,8,5,7,8,19,26,-7,22
Rostov,9299,9,4,7,9,11,18,-7,19
Amkar,9299,10,4,4,12,10,25,-15,16
Anzhi,9299,11,2,7,11,14,37,-23,13
Loko Moscow,9300,1,11,5,4,29,13,16,38
CSKA Moscow,9300,2,11,3,6,26,20,6,36
Zenit,9300,3,9,8,3,25,13,12,35
Spart Moscow,9300,4,9,7,4,40,29,11,34
Krasnodar,9300,5,9,4,7,29,26,3,31
Terek Grozny,9300,6,7,6,7,21,25,-4,27
FK Rubin,9300,7,7,5,8,24,18,6,26
Din Moscow,9300,8,5,7,8,18,23,-5,22
Amkar,9300,9,5,5,10,13,24,-11,20
Rostov,9300,10,4,6,10,11,21,-10,18
Anzhi,9300,11,2,6,12,15,39,-24,12
Loko Moscow,9301,1,12,5,3,33,12,21,41
CSKA Moscow,9301,2,11,3,6,28,20,8,36
Krasnodar,9301,3,10,4,6,30,25,5,34
Spart Moscow,9301,4,9,6,5,38,29,9,33
Zenit,9301,5,8,8,4,23,18,5,32
Terek Grozny,9301,6,8,5,7,22,24,-2,29
Din Moscow,9301,7,6,6,8,21,25,-4,24
Amkar,9301,8,6,4,10,13,23,-10,22
FK Rubin,9301,9,5,5,10,23,22,1,20
Rostov,9301,10,4,7,9,11,18,-7,19
Anzhi,9301,11,2,5,13,15,41,-26,11
Loko Moscow,9302,1,13,5,2,33,13,20,44
CSKA Moscow,9302,2,12,3,5,31,18,13,39
Spart Moscow,9302,3,10,6,4,41,27,14,36
Krasnodar,9302,4,9,4,7,31,27,4,31
Zenit,9302,5,7,8,5,23,17,6,29
Terek Grozny,9302,6,8,5,7,21,23,-2,29
Din Moscow,9302,7,6,6,8,21,26,-5,24
FK Rubin,9302,8,5,5,10,23,24,-1,20
Rostov,9302,9,4,6,10,11,20,-9,18
Amkar,9302,10,4,5,11,10,24,-14,17
Anzhi,9302,11,3,5,12,15,41,-26,14
Loko Moscow,9303,1,11,7,2,33,15,18,40
CSKA Moscow,9303,2,11,4,5,29,19,10,37
Spart Moscow,9303,3,10,6,4,37,27,10,36
Terek Grozny,9303,4,9,5,6,24,24,0,32
Zenit,9303,5,7,10,3,25,17,8,31
Krasnodar,9303,6,8,5,7,28,26,2,29
Din Moscow,9303,7,6,6,8,20,23,-3,24
FK Rubin,9303,8,6,5,9,22,19,3,23
Rostov,9303,9,4,6,10,10,18,-8,18
Amkar,9303,10,4,5,11,10,24,-14,17
Anzhi,9303,11,2,5,13,17,43,-26,11
Loko Moscow,9304,1,12,5,3,32,14,18,41
CSKA Moscow,9304,2,11,3,6,27,19,8,36
Krasnodar,9304,3,10,4,6,34,28,6,34
Spart Moscow,9304,4,9,6,5,35,26,9,33
Zenit,9304,5,8,8,4,22,15,7,32
Terek Grozny,9304,6,8,5,7,22,26,-4,29
FK Rubin,9304,7,6,5,9,25,21,4,23
Amkar,9304,8,6,4,10,13,22,-9,22
Din Moscow,9304,9,5,6,9,17,24,-7,21
Rostov,9304,10,4,7,9,10,17,-7,19
Anzhi,9304,11,2,5,13,16,41,-25,11
Loko Moscow,9305,1,13,5,2,34,12,22,44
CSKA Moscow,9305,2,12,3,5,29,17,12,39
Spart Moscow,9305,3,9,5,6,38,31,7,32
Krasnodar,9305,4,9,4,7,28,26,2,31
Zenit,9305,5,7,8,5,22,18,4,29
Terek Grozny,9305,6,7,6,7,20,24,-4,27
Din Moscow,9305,7,5,7,8,17,24,-7,22
FK Rubin,9305,8,5,6,9,21,18,3,21
Rostov,9305,9,5,6,9,12,17,-5,21
Amkar,9305,10,5,5,10,13,24,-11,20
Anzhi,9305,11,3,5,12,16,39,-23,14
Loko Moscow,9306,1,13,5,2,34,14,20,44
Spart Moscow,9306,2,10,6,4,36,25,11,36
CSKA Moscow,9306,3,10,4,6,28,24,4,34
Zenit,9306,4,8,8,4,26,15,11,32
Terek Grozny,9306,5,8,6,6,24,25,-1,30
Krasnodar,9306,6,8,4,8,31,30,1,28
Din Moscow,9306,7,6,6,8,18,22,-4,24
FK Rubin,9306,8,6,5,9,24,20,4,23
Rostov,9306,9,4,6,10,10,19,-9,18
Amkar,9306,10,4,5,11,11,25,-14,17
Anzhi,9306,11,2,7,11,18,41,-23,13
Loko Moscow,9307,1,11,6,3,29,13,16,39
Spart Moscow,9307,2,10,6,4,41,28,13,36
Krasnodar,9307,3,10,4,6,31,24,7,34
Zenit,9307,4,8,9,3,24,13,11,33
CSKA Moscow,9307,5,10,3,7,25,21,4,33
Terek Grozny,9307,6,7,6,7,21,24,-3,27
Din Moscow,9307,7,6,6,8,20,25,-5,24
FK Rubin,9307,8,5,5,10,21,21,0,20
Rostov,9307,9,4,7,9,11,18,-7,19
Amkar,9307,10,4,5,11,11,26,-15,17
Anzhi,9307,11,4,5,11,16,37,-21,17
Loko Moscow,9308,1,12,5,3,31,15,16,41
Spart Moscow,9308,2,11,5,4,43,30,13,38
CSKA Moscow,9308,3,11,3,6,27,20,7,36
Zenit,9308,4,9,8,3,26,13,13,35
Terek Grozny,9308,5,8,6,6,22,23,-1,30
Krasnodar,9308,6,8,4,8,28,29,-1,28
Din Moscow,9308,7,6,6,8,21,25,-4,24
FK Rubin,9308,8,6,5,9,24,19,5,23
Rostov,9308,9,4,6,10,11,20,-9,18
Amkar,9308,10,4,4,12,12,27,-15,16
Anzhi,9308,11,2,6,12,15,39,-24,12
Loko Moscow,9309,1,11,6,3,32,16,16,39
Spart Moscow,9309,2,10,6,4,39,26,13,36
Zenit,9309,3,9,8,3,28,17,11,35
CSKA Moscow,9309,4,10,3,7,28,22,6,33
Krasnodar,9309,5,8,6,6,29,26,3,30
Terek Grozny,9309,6,7,7,6,22,24,-2,28
FK Rubin,9309,7,6,6,8,25,18,7,24
Din Moscow,9309,8,5,6,9,17,28,-11,21
Rostov,9309,9,4,6,10,11,19,-8,18
Amkar,9309,10,4,6,10,9,22,-13,18
Anzhi,9309,11,3,6,11,18,40,-22,15
Loko Moscow,9310,1,12,6,2,33,13,20,42
CSKA Moscow,9310,2,11,3,6,33,22,11,36
Spart Moscow,9310,3,10,5,5,38,28,10,35
Zenit,9310,4,8,8,4,26,16,10,32
Krasnodar,9310,5,9,5,6,30,26,4,32
Terek Grozny,9310,6,7,6,7,23,26,-3,27
Din Moscow,9310,7,5,7,8,19,24,-5,22
FK Rubin,9310,8,5,6,9,23,20,3,21
Amkar,9310,9,5,5,10,13,25,-12,20
Rostov,9310,10,4,6,10,10,19,-9,18
Anzhi,9310,11,3,5,12,17,46,-29,14
Loko Moscow,9311,1,13,5,2,34,13,21,44
Spart Moscow,9311,2,10,5,5,39,27,12,35
CSKA Moscow,9311,3,10,4,6,27,20,7,34
Zenit,9311,4,8,8,4,22,15,7,32
Terek Grozny,9311,5,9,5,6,24,24,0,32
Krasnodar,9311,6,8,4,8,31,31,0,28
FK Rubin,9311,7,7,5,8,28,19,9,26
Din Moscow,9311,8,6,6,8,18,24,-6,24
Rostov,9311,9,4,6,10,10,21,-11,18
Amkar,9311,10,4,4,12,10,25,-15,16
Anzhi,9311,11,2,6,12,18,42,-24,12
Loko Moscow,9312,1,12,5,3,32,13,19,41
CSKA Moscow,9312,2,11,3,6,27,19,8,36
Krasnodar,9312,3,10,4,6,32,27,5,34
Spart Moscow,9312,4,9,6,5,37,29,8,33
Zenit,9312,5,8,8,4,22,15,7,32
Terek Grozny,9312,6,8,5,7,23,24,-1,29
Din Moscow,9312,7,7,6,7,21,23,-2,27
FK Rubin,9312,8,5,5,10,24,22,2,20
Rostov,9312,9,4,6,10,11,19,-8,18
Amkar,9312,10,4,5,11,10,25,-15,17
Anzhi,9312,11,3,5,12,17,40,-23,14
Loko Moscow,9313,1,12,5,3,33,16,17,41
CSKA Moscow,9313,2,11,4,5,28,19,9,37
Krasnodar,9313,3,10,4,6,32,25,7,34
Spart Moscow,9313,4,9,6,5,37,30,7,33
Terek Grozny,9313,5,9,5,6,22,22,0,32
Zenit,9313,6,7,8,5,24,18,6,29
Din Moscow,9313,7,5,7,8,17,23,-6,22
FK Rubin,9313,8,5,6,9,21,19,2,21
Rostov,9313,9,5,6,9,13,17,-4,21
Amkar,9313,10,4,5,11,11,25,-14,17
Anzhi,9313,11,2,6,12,15,39,-24,12
Loko Moscow,9314,1,11,5,4,29,14,15,38
Spart Moscow,9314,2,10,6,4,40,26,14,36
CSKA Moscow,9314,3,11,3,6,27,19,8,36
Zenit,9314,4,9,8,3,24,13,11,35
Krasnodar,9314,5,10,4,6,30,24,6,34
Terek Grozny,9314,6,7,6,7,20,23,-3,27
Din Moscow,9314,7,6,6,8,20,25,-5,24
FK Rubin,9314,8,5,5,10,22,21,1,20
Rostov,9314,9,4,7,9,11,18,-7,19
Amkar,9314,10,5,4,11,10,25,-15,19
Anzhi,9314,11,2,6,12,14,39,-25,12
Loko Moscow,9315,1,11,6,3,31,14,17,39
CSKA Moscow,9315,2,11,4,5,31,20,11,37
Spart Moscow,9315,3,10,6,4,39,27,12,36
Zenit,9315,4,8,9,3,24,15,9,33
Krasnodar,9315,5,9,5,6,31,27,4,32
Terek Grozny,9315,6,9,5,6,24,24,0,32
Din Moscow,9315,7,5,8,7,21,25,-4,23
FK Rubin,9315,8,5,6,9,24,21,3,21
Rostov,9315,9,4,6,10,10,18,-8,18
Amkar,9315,10,4,4,12,9,26,-17,16
Anzhi,9315,11,2,5,13,17,44,-27,11
Loko Moscow,9316,1,12,5,3,32,15,17,41
CSKA Moscow,9316,2,12,3,5,30,18,12,39
Krasnodar,9316,3,10,4,6,32,26,6,34
Spart Moscow,9316,4,8,6,6,36,31,5,30
Zenit,9316,5,7,8,5,22,18,4,29
Terek Grozny,9316,6,7,5,8,20,27,-7,26
FK Rubin,9316,7,6,5,9,24,20,4,23
Din Moscow,9316,8,5,7,8,20,25,-5,22
Amkar,9316,9,6,4,10,14,23,-9,22
Rostov,9316,10,5,6,9,12,17,-5,21
Anzhi,9316,11,3,5,12,17,39,-22,14
Loko Moscow,9317,1,12,6,2,32,11,21,42
CSKA Moscow,9317,2,12,3,5,29,19,10,39
Spart Moscow,9317,3,8,6,6,35,30,5,30
Krasnodar,9317,4,8,6,6,28,25,3,30
Terek Grozny,9317,5,8,6,6,22,23,-1,30
Zenit,9317,6,7,8,5,22,18,4,29
FK Rubin,9317,7,6,6,8,23,18,5,24
Din Moscow,9317,8,5,7,8,18,23,-5,22
Rostov,9317,9,5,6,9,12,17,-5,21
Amkar,9317,10,5,4,11,12,25,-13,19
Anzhi,9317,11,2,6,12,15,39,-24,12
Loko Moscow,9318,1,12,6,2,32,13,19,42
CSKA Moscow,9318,2,11,4,5,29,19,10,37
Spart Moscow,9318,3,9,5,6,36,28,8,32
Zenit,9318,4,7,10,3,23,15,8,31
Krasnodar,9318,5,9,4,7,30,26,4,31
Terek Grozny,9318,6,8,6,6,22,23,-1,30
Din Moscow,9318,7,6,6,8,19,24,-5,24
FK Rubin,9318,8,6,5,9,23,19,4,23
Rostov,9318,9,5,6,9,11,17,-6,21
Amkar,9318,10,4,4,12,9,25,-16,16
Anzhi,9318,11,2,6,12,16,41,-25,12
Loko Moscow,9319,1,11,6,3,29,13,16,39
CSKA Moscow,9319,2,10,4,6,27,20,7,34
Spart Moscow,9319,3,9,6,5,38,30,8,33
Zenit,9319,4,7,10,3,23,15,8,31
Krasnodar,9319,5,9,4,7,31,27,4,31
Terek Grozny,9319,6,8,5,7,23,26,-3,29
Din Moscow,9319,7,6,7,7,19,21,-2,25
FK Rubin,9319,8,6,5,9,24,21,3,23
Amkar,9319,9,6,4,10,13,23,-10,22
Rostov,9319,10,4,6,10,13,21,-8,18
Anzhi,9319,11,3,5,12,17,40,-23,14
Loko Moscow,9320,1,13,5,2,33,12,21,44
CSKA Moscow,9320,2,12,3,5,31,18,13,39
Spart Moscow,9320,3,9,6,5,37,27,10,33
Zenit,9320,4,7,8,5,23,17,6,29
Krasnodar,9320,5,8,5,7,27,26,1,29
Terek Grozny,9320,6,7,6,7,22,25,-3,27
Din Moscow,9320,7,6,7,7,21,22,-1,25
FK Rubin,9320,8,5,6,9,21,20,1,21
Rostov,9320,9,5,6,9,11,17,-6,21
Amkar,9320,10,4,5,11,10,26,-16,17
Anzhi,9320,11,3,5,12,16,42,-26,14
Loko Moscow,9321,1,11,5,4,31,15,16,38
Spart Moscow,9321,2,11,5,4,43,29,14,38
Zenit,9321,3,9,8,3,25,14,11,35
CSKA Moscow,9321,4,10,4,6,27,21,6,34
Krasnodar,9321,5,9,4,7,30,27,3,31
FK Rubin,9321,6,7,5,8,25,19,6,26
Terek Grozny,9321,7,7,5,8,21,25,-4,26
Din Moscow,9321,8,5,6,9,19,27,-8,21
Amkar,9321,9,5,4,11,13,27,-14,19
Rostov,9321,10,4,6,10,11,19,-8,18
Anzhi,9321,11,3,6,11,17,39,-22,15
Loko Moscow,9322,1,11,7,2,30,12,18,40
CSKA Moscow,9322,2,11,3,6,28,22,6,36
Spart Moscow,9322,3,9,7,4,36,27,9,34
Zenit,9322,4,8,9,3,24,13,11,33
Terek Grozny,9322,5,9,5,6,26,26,0,32
Krasnodar,9322,6,8,6,6,29,26,3,30
FK Rubin,9322,7,6,6,8,24,19,5,24
Din Moscow,9322,8,5,7,8,19,24,-5,22
Rostov,9322,9,4,7,9,11,18,-7,19
Amkar,9322,10,4,4,12,12,27,-15,16
Anzhi,9322,11,2,5,13,17,42,-25,11
Loko Moscow,9323,1,11,7,2,31,13,18,40
Spart Moscow,9323,2,11,5,4,40,27,13,38
Zenit,9323,3,8,9,3,24,14,10,33
CSKA Moscow,9323,4,10,3,7,26,22,4,33
Terek Grozny,9323,5,9,5,6,23,22,1,32
Krasnodar,9323,6,8,6,6,30,27,3,30
FK Rubin,9323,7,5,7,8,24,20,4,22
Din Moscow,9323,8,5,7,8,18,24,-6,22
Rostov,9323,9,4,6,10,10,19,-9,18
Amkar,9323,10,4,4,12,11,26,-15,16
Anzhi,9323,11,3,5,12,17,40,-23,14
Loko Moscow,9324,1,12,5,3,32,14,18,41
Spart Moscow,9324,2,10,6,4,38,26,12,36
CSKA Moscow,9324,3,10,4,6,27,21,6,34
Zenit,9324,4,8,8,4,25,16,9,32
Krasnodar,9324,5,9,5,6,31,27,4,32
Terek Grozny,9324,6,9,5,6,25,24,1,32
FK Rubin,9324,7,5,7,8,24,20,4,22
Din Moscow,9324,8,5,7,8,18,24,-6,22
Rostov,9324,9,4,6,10,11,20,-9,18
Amkar,9324,10,4,5,11,9,24,-15,17
Anzhi,9324,11,2,6,12,17,41,-24,12
Loko Moscow,9325,1,12,6,2,33,14,19,42
CSKA Moscow,9325,2,11,4,5,28,17,11,37
Spart Moscow,9325,3,9,5,6,37,29,8,32
Zenit,9325,4,7,9,4,23,16,7,30
Krasnodar,9325,5,8,6,6,28,25,3,30
Terek Grozny,9325,6,8,6,6,24,24,0,30
FK Rubin,9325,7,5,7,8,22,18,4,22
Din Moscow,9325,8,5,7,8,19,26,-7,22
Rostov,9325,9,5,6,9,11,17,-6,21
Amkar,9325,10,5,5,10,12,23,-11,20
Anzhi,9325,11,2,5,13,15,43,-28,11
Loko Moscow,9326,1,12,6,2,34,13,21,42
CSKA Moscow,9326,2,12,3,5,30,19,11,39
Spart Moscow,9326,3,8,7,5,34,27,7,31
Zenit,9326,4,7,9,4,24,17,7,30
Krasnodar,9326,5,8,5,7,28,28,0,29
Terek Grozny,9326,6,7,7,6,21,23,-2,28
Din Moscow,9326,7,7,6,7,19,21,-2,27
FK Rubin,9326,8,5,6,9,21,18,3,21
Rostov,9326,9,4,7,9,11,18,-7,19
Amkar,9326,10,4,6,10,9,22,-13,18
Anzhi,9326,11,2,6,12,15,40,-25,12
Loko Moscow,9327,1,11,6,3,30,15,15,39
CSKA Moscow,9327,2,11,4,5,26,17,9,37
Spart Moscow,9327,3,9,5,6,39,31,8,32
Krasnodar,9327,4,9,4,7,31,26,5,31
Zenit,9327,5,7,9,4,22,15,7,30
Din Moscow,9327,6,7,6,7,23,24,-1,27
Terek Grozny,9327,7,7,6,7,21,24,-3,27
FK Rubin,9327,8,6,5,9,25,21,4,23
Amkar,9327,9,5,5,10,12,23,-11,20
Rostov,9327,10,4,6,10,10,21,-11,18
Anzhi,9327,11,3,6,11,16,38,-22,15
Loko Moscow,9328,1,12,6,2,31,11,20,42
CSKA Moscow,9328,2,11,3,6,28,19,9,36
Zenit,9328,3,8,9,3,22,13,9,33
Spart Moscow,9328,4,9,6,5,38,31,7,33
Krasnodar,9328,5,9,4,7,28,26,2,31
Terek Grozny,9328,6,8,6,6,23,23,0,30
Din Moscow,9328,7,6,7,7,20,22,-2,25
FK Rubin,9328,8,5,6,9,21,18,3,21
Rostov,9328,9,4,7,9,12,19,-7,19
Amkar,9328,10,4,5,11,10,24,-14,17
Anzhi,9328,11,2,5,13,16,43,-27,11
Loko Moscow,9329,1,13,5,2,32,12,20,44
CSKA Moscow,9329,2,11,3,6,27,18,9,36
Spart Moscow,9329,3,10,5,5,37,27,10,35
Zenit,9329,4,8,8,4,23,15,8,32
Krasnodar,9329,5,8,5,7,27,25,2,29
Terek Grozny,9329,6,8,5,7,21,25,-4,29
Din Moscow,9329,7,7,6,7,22,24,-2,27
FK Rubin,9329,8,5,6,9,24,21,3,21
Amkar,9329,9,5,4,11,12,24,-12,19
Rostov,9329,10,4,6,10,11,19,-8,18
Anzhi,9329,11,2,5,13,14,40,-26,11
Loko Moscow,9330,1,11,6,3,30,14,16,39
Zenit,9330,2,9,8,3,25,14,11,35
Spart Moscow,9330,3,9,6,5,39,29,10,33
CSKA Moscow,9330,4,10,3,7,26,20,6,33
Krasnodar,9330,5,9,5,6,29,25,4,32
Terek Grozny,9330,6,9,5,6,26,23,3,32
FK Rubin,9330,7,6,5,9,23,19,4,23
Din Moscow,9330,8,5,6,9,18,27,-9,21
Rostov,9330,9,4,7,9,12,19,-7,19
Amkar,9330,10,5,4,11,12,24,-12,19
Anzhi,9330,11,3,5,12,15,41,-26,14
Loko Moscow,9331,1,11,6,3,31,14,17,39
Spart Moscow,9331,2,10,6,4,35,25,10,36
CSKA Moscow,9331,3,11,3,6,29,22,7,36
Zenit,9331,4,8,9,3,25,14,11,33
Krasnodar,9331,5,9,5,6,29,25,4,32
Terek Grozny,9331,6,8,5,7,24,25,-1,29
FK Rubin,9331,7,5,7,8,22,18,4,22
Din Moscow,9331,8,5,7,8,18,23,-5,22
Amkar,9331,9,5,5,10,12,23,-11,20
Rostov,9331,10,4,6,10,10,18,-8,18
Anzhi,9331,11,2,5,13,16,44,-28,11
Loko Moscow,9332,1,12,6,2,32,12,20,42
Spart Moscow,9332,2,9,6,5,36,28,8,33
CSKA Moscow,9332,3,10,3,7,26,21,5,33
Zenit,9332,4,8,8,4,23,16,7,32
Krasnodar,9332,5,9,5,6,31,27,4,32
Terek Grozny,9332,6,7,5,8,22,26,-4,26
Din Moscow,9332,7,6,6,8,20,22,-2,24
Rostov,9332,8,5,6,9,11,17,-6,21
FK Rubin,9332,9,5,5,10,23,23,0,20
Amkar,9332,10,5,5,10,13,25,-12,20
Anzhi,9332,11,4,5,11,18,38,-20,17
Loko Moscow,9333,1,12,5,3,31,14,17,41
CSKA Moscow,9333,2,11,3,6,27,19,8,36
Spart Moscow,9333,3,10,5,5,35,26,9,35
Krasnodar,9333,4,10,4,6,32,26,6,34
Zenit,9333,5,8,8,4,22,14,8,32
Terek Grozny,9333,6,8,6,6,22,23,-1,30
Din Moscow,9333,7,5,7,8,19,24,-5,22
FK Rubin,9333,8,5,6,9,24,21,3,21
Amkar,9333,9,5,5,10,11,23,-12,20
Rostov,9333,10,4,6,10,10,18,-8,18
Anzhi,9333,11,2,5,13,15,40,-25,11
Loko Moscow,9334,1,12,6,2,32,12,20,42
CSKA Moscow,9334,2,10,5,5,27,19,8,35
Spart Moscow,9334,3,9,5,6,36,29,7,32
Terek Grozny,9334,4,9,5,6,24,22,2,32
Zenit,9334,5,7,9,4,22,16,6,30
Krasnodar,9334,6,8,6,6,29,26,3,30
Din Moscow,9334,7,7,6,7,20,22,-2,27
FK Rubin,9334,8,5,6,9,22,19,3,21
Rostov,9334,9,5,6,9,12,18,-6,21
Amkar,9334,10,4,4,12,9,25,-16,16
Anzhi,9334,11,2,6,12,15,40,-25,12
Loko Moscow,9335,1,13,5,2,33,11,22,44
CSKA Moscow,9335,2,11,4,5,27,17,10,37
Spart Moscow,9335,3,10,6,4,39,28,11,36
Krasnodar,9335,4,9,4,7,29,28,1,31
Zenit,9335,5,7,9,4,21,14,7,30
Terek Grozny,9335,6,8,6,6,24,25,-1,30
Din Moscow,9335,7,5,8,7,21,25,-4,23
FK Rubin,9335,8,5,6,9,23,20,3,21
Rostov,9335,9,4,6,10,10,19,-9,18
Amkar,9335,10,4,5,11,10,24,-14,17
Anzhi,9335,11,2,5,13,16,42,-26,11
Loko Moscow,9336,1,12,6,2,34,12,22,42
CSKA Moscow,9336,2,11,3,6,29,20,9,36
Spart Moscow,9336,3,10,5,5,36,27,9,35
Zenit,9336,4,8,8,4,22,17,5,32
Krasnodar,9336,5,8,5,7,28,26,2,29
Terek Grozny,9336,6,7,5,8,22,27,-5,26
FK Rubin,9336,7,6,6,8,23,18,5,24
Din Moscow,9336,8,5,7,8,18,23,-5,22
Rostov,9336,9,5,6,9,11,17,-6,21
Amkar,9336,10,5,4,11,12,25,-13,19
Anzhi,9336,11,3,5,12,19,42,-23,14
Loko Moscow,9337,1,11,5,4,30,15,15,38
Zenit,9337,2,9,8,3,25,15,10,35
CSKA Moscow,9337,3,10,4,6,26,19,7,34
Spart Moscow,9337,4,9,6,5,39,28,11,33
Krasnodar,9337,5,9,4,7,32,28,4,31
Terek Grozny,9337,6,8,6,6,25,25,0,30
Din Moscow,9337,7,6,6,8,20,25,-5,24
FK Rubin,9337,8,6,5,9,25,23,2,23
Rostov,9337,9,5,6,9,13,19,-6,21
Amkar,9337,10,4,5,11,9,24,-15,17
Anzhi,9337,11,2,7,11,17,40,-23,13
Loko Moscow,9338,1,12,6,2,33,13,20,42
CSKA Moscow,9338,2,11,4,5,27,18,9,37
Spart Moscow,9338,3,10,6,4,38,28,10,36
Zenit,9338,4,7,10,3,23,15,8,31
Krasnodar,9338,5,8,4,8,29,29,0,28
Terek Grozny,9338,6,7,6,7,20,24,-4,27
Din Moscow,9338,7,6,6,8,19,23,-4,24
FK Rubin,9338,8,6,5,9,24,20,4,23
Rostov,9338,9,4,7,9,11,18,-7,19
Amkar,9338,10,4,5,11,11,25,-14,17
Anzhi,9338,11,3,5,12,16,38,-22,14
Loko Moscow,9339,1,12,6,2,33,13,20,42
Spart Moscow,9339,2,10,6,4,37,27,10,36
CSKA Moscow,9339,3,11,3,6,28,20,8,36
Zenit,9339,4,8,9,3,23,14,9,33
Krasnodar,9339,5,8,5,7,28,27,1,29
Terek Grozny,9339,6,8,5,7,22,24,-2,29
FK Rubin,9339,7,6,6,8,23,18,5,24
Din Moscow,9339,8,5,6,9,19,25,-6,21
Rostov,9339,9,4,7,9,11,18,-7,19
Amkar,9339,10,4,4,12,9,24,-15,16
Anzhi,9339,11,3,5,12,18,41,-23,14
Loko Moscow,9340,1,12,6,2,33,14,19,42
CSKA Moscow,9340,2,11,3,6,28,20,8,36
Spart Moscow,9340,3,9,7,4,37,28,9,34
Zenit,9340,4,7,9,4,22,15,7,30
Terek Grozny,9340,5,8,6,6,23,22,1,30
Krasnodar,9340,6,8,4,8,30,30,0,28
FK Rubin,9340,7,6,6,8,25,19,6,24
Din Moscow,9340,8,5,7,8,19,24,-5,22
Rostov,9340,9,4,7,9,11,18,-7,19
Amkar,9340,10,4,6,10,10,23,-13,18
Anzhi,9340,11,3,5,12,17,42,-25,14
Loko Moscow,9341,1,12,6,2,31,12,19,42
Spart Moscow,9341,2,10,6,4,37,25,12,36
CSKA Moscow,9341,3,11,3,6,29,21,8,36
Zenit,9341,4,8,9,3,25,14,11,33
Krasnodar,9341,5,9,4,7,29,26,3,31
Terek Grozny,9341,6,8,6,6,24,25,-1,30
FK Rubin,9341,7,6,5,9,24,20,4,23
Din Moscow,9341,8,5,6,9,18,24,-6,21
Rostov,9341,9,4,7,9,10,17,-7,19
Amkar,9341,10,4,5,11,11,27,-16,17
Anzhi,9341,11,2,5,13,16,43,-27,11
Loko Moscow,9342,1,13,5,2,34,13,21,44
Spart Moscow,9342,2,11,5,4,38,27,11,38
CSKA Moscow,9342,3,11,4,5,26,17,9,37
Zenit,9342,4,7,9,4,22,15,7,30
Krasnodar,9342,5,8,4,8,28,28,0,28
Terek Grozny,9342,6,7,5,8,21,26,-5,26
Din Moscow,9342,7,6,6,8,21,24,-3,24
FK Rubin,9342,8,6,5,9,23,20,3,23
Amkar,9342,9,5,4,11,10,23,-13,19
Rostov,9342,10,4,6,10,11,19,-8,18
Anzhi,9342,11,3,5,12,17,39,-22,14
Loko Moscow,9343,1,12,5,3,33,15,18,41
CSKA Moscow,9343,2,11,4,5,28,19,9,37
Spart Moscow,9343,3,9,6,5,36,27,9,33
Zenit,9343,4,8,9,3,25,16,9,33
Krasnodar,9343,5,8,4,8,31,30,1,28
Terek Grozny,9343,6,7,5,8,21,25,-4,26
Din Moscow,9343,7,6,7,7,18,21,-3,25
FK Rubin,9343,8,6,6,8,24,19,5,24
Rostov,9343,9,4,7,9,11,18,-7,19
Amkar,9343,10,5,4,11,10,24,-14,19
Anzhi,9343,11,3,5,12,16,39,-23,14
Loko Moscow,9344,1,12,5,3,31,13,18,41
Zenit,9344,2,9,8,3,26,15,11,35
Spart Moscow,9344,3,10,5,5,39,29,10,35
CSKA Moscow,9344,4,10,4,6,27,21,6,34
Krasnodar,9344,5,9,4,7,30,25,5,31
Terek Grozny,9344,6,8,5,7,22,24,-2,29
Din Moscow,9344,7,5,7,8,19,25,-6,22
Amkar,9344,8,6,4,10,12,23,-11,22
FK Rubin,9344,9,5,6,9,22,21,1,21
Rostov,9344,10,4,6,10,11,19,-8,18
Anzhi,9344,11,2,6,12,16,40,-24,12
Loko Moscow,9345,1,12,5,3,31,14,17,41
CSKA Moscow,9345,2,11,4,5,32,22,10,37
Spart Moscow,9345,3,10,6,4,36,26,10,36
Zenit,9345,4,8,9,3,25,15,10,33
Krasnodar,9345,5,9,4,7,31,28,3,31
Terek Grozny,9345,6,7,5,8,22,26,-4,26
Din Moscow,9345,7,5,8,7,18,22,-4,23
FK Rubin,9345,8,5,6,9,24,21,3,21
Amkar,9345,9,5,4,11,12,25,-13,19
Rostov,9345,10,4,6,10,10,18,-8,18
Anzhi,9345,11,3,5,12,19,43,-24,14
Loko Moscow,9346,1,12,5,3,30,13,17,41
CSKA Moscow,9346,2,11,4,5,30,20,10,37
Spart Moscow,9346,3,9,5,6,40,33,7,32
Krasnodar,9346,4,9,4,7,29,25,4,31
Zenit,9346,5,7,9,4,23,16,7,30
Terek Grozny,9346,6,7,7,6,22,24,-2,28
FK Rubin,9346,7,6,6,8,22,17,5,24
Din Moscow,9346,8,5,7,8,18,25,-7,22
Rostov,9346,9,5,6,9,14,19,-5,21
Amkar,9346,10,5,5,10,13,24,-11,20
Anzhi,9346,11,2,6,12,16,41,-25,12
Loko Moscow,9347,1,12,5,3,31,13,18,41
Spart Moscow,9347,2,10,6,4,39,28,11,36
Zenit,9347,3,9,8,3,24,14,10,35
CSKA Moscow,9347,4,10,3,7,26,20,6,33
Krasnodar,9347,5,8,5,7,30,28,2,29
Terek Grozny,9347,6,7,7,6,21,23,-2,28
FK Rubin,9347,7,6,6,8,24,19,5,24
Din Moscow,9347,8,5,6,9,18,25,-7,21
Rostov,9347,9,4,7,9,11,18,-7,19
Amkar,9347,10,4,5,11,10,24,-14,17
Anzhi,9347,11,3,6,11,16,38,-22,15
Loko Moscow,9348,1,12,5,3,30,12,18,41
CSKA Moscow,9348,2,11,3,6,26,19,7,36
Spart Moscow,9348,3,9,6,5,39,31,8,33
Zenit,9348,4,8,8,4,23,14,9,32
Krasnodar,9348,5,9,4,7,30,27,3,31
Terek Grozny,9348,6,8,5,7,22,23,-1,29
Din Moscow,9348,7,6,7,7,21,24,-3,25
FK Rubin,9348,8,6,6,8,24,19,5,24
Rostov,9348,9,4,7,9,12,19,-7,19
Amkar,9348,10,4,4,12,9,25,-16,16
Anzhi,9348,11,3,5,12,15,38,-23,14
Loko Moscow,9349,1,11,6,3,32,15,17,39
Spart Moscow,9349,2,10,6,4,37,27,10,36
CSKA Moscow,9349,3,11,3,6,29,19,10,36
Zenit,9349,4,8,9,3,24,15,9,33
Krasnodar,9349,5,9,4,7,30,27,3,31
Terek Grozny,9349,6,8,5,7,23,26,-3,29
FK Rubin,9349,7,7,5,8,24,18,6,26
Din Moscow,9349,8,5,6,9,18,24,-6,21
Amkar,9349,9,5,5,10,14,25,-11,20
Rostov,9349,10,4,6,10,11,19,-8,18
Anzhi,9349,11,2,5,13,14,41,-27,11
Loko Moscow,9350,1,12,5,3,32,14,18,41
CSKA Moscow,9350,2,12,3,5,30,20,10,39
Spart Moscow,9350,3,8,7,5,35,32,3,31
Krasnodar,9350,4,9,4,7,30,27,3,31
Zenit,9350,5,7,8,5,23,17,6,29
Terek Grozny,9350,6,8,5,7,23,24,-1,29
Din Moscow,9350,7,7,6,7,24,21,3,27
FK Rubin,9350,8,6,5,9,22,19,3,23
Amkar,9350,9,5,5,10,11,23,-12,20
Rostov,9350,10,4,7,9,12,19,-7,19
Anzhi,9350,11,2,5,13,15,41,-26,11
Loko Moscow,9351,1,13,5,2,32,11,21,44
Spart Moscow,9351,2,11,5,4,42,27,15,38
CSKA Moscow,9351,3,11,3,6,30,20,10,36
Zenit,9351,4,8,8,4,24,16,8,32
Krasnodar,9351,5,9,4,7,28,26,2,31
Terek Grozny,9351,6,7,6,7,21,24,-3,27
FK Rubin,9351,7,6,5,9,24,18,6,23
Din Moscow,9351,8,5,6,9,18,26,-8,21
Rostov,9351,9,4,6,10,10,22,-12,18
Amkar,9351,10,4,5,11,11,25,-14,17
Anzhi,9351,11,3,5,12,15,40,-25,14
Loko Moscow,9352,1,13,5,2,33,12,21,44
CSKA Moscow,9352,2,11,4,5,29,19,10,37
Krasnodar,9352,3,9,4,7,29,26,3,31
Spart Moscow,9352,4,8,6,6,33,27,6,30
Zenit,9352,5,7,9,4,23,17,6,30
Terek Grozny,9352,6,8,6,6,21,22,-1,30
Din Moscow,9352,7,6,6,8,18,24,-6,24
FK Rubin,9352,8,6,5,9,24,18,6,23
Rostov,9352,9,4,7,9,10,17,-7,19
Amkar,9352,10,5,4,11,10,23,-13,19
Anzhi,9352,11,2,6,12,14,39,-25,12
Loko Moscow,9353,1,12,5,3,33,14,19,41
CSKA Moscow,9353,2,11,3,6,31,18,13,36
Spart Moscow,9353,3,9,7,4,38,28,10,34
Krasnodar,9353,4,10,4,6,33,26,7,34
Zenit,9353,5,8,8,4,23,17,6,32
Terek Grozny,9353,6,7,5,8,23,28,-5,26
Din Moscow,9353,7,5,7,8,18,24,-6,22
FK Rubin,9353,8,5,6,9,24,22,2,21
Amkar,9353,9,5,5,10,12,24,-12,20
Rostov,9353,10,4,7,9,12,19,-7,19
Anzhi,9353,11,3,5,12,18,45,-27,14
Loko Moscow,9354,1,11,5,4,30,18,12,38
CSKA Moscow,9354,2,11,3,6,27,19,8,36
Spart Moscow,9354,3,10,5,5,40,29,11,35
Zenit,9354,4,9,8,3,25,15,10,35
Krasnodar,9354,5,9,5,6,35,27,8,32
Din Moscow,9354,6,7,6,7,20,21,-1,27
Terek Grozny,9354,7,7,6,7,21,24,-3,27
FK Rubin,9354,8,5,6,9,24,22,2,21
Rostov,9354,9,4,6,10,10,20,-10,18
Amkar,9354,10,4,5,11,12,26,-14,17
Anzhi,9354,11,3,5,12,16,39,-23,14
Loko Moscow,9355,1,12,5,3,31,15,16,41
Spart Moscow,9355,2,10,6,4,40,27,13,36
CSKA Moscow,9355,3,10,4,6,30,24,6,34
Krasnodar,9355,4,9,4,7,30,26,4,31
Zenit,9355,5,7,9,4,26,19,7,30
Terek Grozny,9355,6,8,6,6,22,23,-1,30
Din Moscow,9355,7,6,6,8,20,25,-5,24
FK Rubin,9355,8,6,5,9,24,20,4,23
Rostov,9355,9,4,6,10,11,20,-9,18
Amkar,9355,10,4,6,10,10,23,-13,18
Anzhi,9355,11,3,5,12,18,40,-22,14
Loko Moscow,9356,1,12,6,2,31,11,20,42
CSKA Moscow,9356,2,10,4,6,28,21,7,34
Spart Moscow,9356,3,9,6,5,38,28,10,33
Zenit,9356,4,7,10,3,22,14,8,31
Krasnodar,9356,5,9,4,7,28,26,2,31
Terek Grozny,9356,6,8,6,6,23,24,-1,30
Din Moscow,9356,7,5,8,7,19,23,-4,23
FK Rubin,9356,8,5,6,9,22,19,3,21
Rostov,9356,9,5,6,9,11,17,-6,21
Amkar,9356,10,4,5,11,11,27,-16,17
Anzhi,9356,11,3,5,12,18,41,-23,14
Loko Moscow,9357,1,12,6,2,32,12,20,42
CSKA Moscow,9357,2,11,3,6,26,20,6,36
Zenit,9357,3,8,8,4,24,15,9,32
Spart Moscow,9357,4,8,6,6,35,31,4,30
Krasnodar,9357,5,8,5,7,29,28,1,29
Terek Grozny,9357,6,7,6,7,21,24,-3,27
FK Rubin,9357,7,7,5,8,27,19,8,26
Din Moscow,9357,8,6,6,8,20,24,-4,24
Amkar,9357,9,5,5,10,12,23,-11,20
Rostov,9357,10,4,7,9,12,19,-7,19
Anzhi,9357,11,3,5,12,15,38,-23,14
Loko Moscow,9358,1,11,6,3,31,14,17,39
CSKA Moscow,9358,2,11,3,6,27,18,9,36
Spart Moscow,9358,3,10,5,5,37,26,11,35
Zenit,9358,4,9,8,3,24,14,10,35
Krasnodar,9358,5,8,5,7,29,27,2,29
Terek Grozny,9358,6,8,5,7,24,26,-2,29
Din Moscow,9358,7,6,6,8,20,23,-3,24
FK Rubin,9358,8,6,5,9,23,21,2,23
Amkar,9358,9,5,4,11,11,25,-14,19
Rostov,9358,10,4,6,10,10,19,-9,18
Anzhi,9358,11,3,5,12,17,40,-23,14
Loko Moscow,9359,1,11,7,2,30,12,18,40
CSKA Moscow,9359,2,12,3,5,31,18,13,39
Spart Moscow,9359,3,11,5,4,40,27,13,38
Zenit,9359,4,7,9,4,22,16,6,30
Krasnodar,9359,5,8,5,7,28,27,1,29
Terek Grozny,9359,6,8,5,7,22,24,-2,29
FK Rubin,9359,7,7,5,8,25,18,7,26
Din Moscow,9359,8,5,6,9,18,24,-6,21
Rostov,9359,9,4,6,10,11,21,-10,18
Amkar,9359,10,4,4,12,10,25,-15,16
Anzhi,9359,11,3,5,12,16,41,-25,14
Loko Moscow,9360,1,11,5,4,32,17,15,38
CSKA Moscow,9360,2,11,4,5,28,18,10,37
Zenit,9360,3,8,9,3,25,15,10,33
Krasnodar,9360,4,9,4,7,30,28,2,31
Spart Moscow,9360,5,8,6,6,36,30,6,30
Terek Grozny,9360,6,8,6,6,23,24,-1,30
Din Moscow,9360,7,6,7,7,18,21,-3,25
FK Rubin,9360,8,6,6,8,23,17,6,24
Rostov,9360,9,5,6,9,12,18,-6,21
Amkar,9360,10,4,5,11,12,26,-14,17
Anzhi,9360,11,2,6,12,15,40,-25,12
Loko Moscow,9361,1,12,5,3,31,12,19,41
CSKA Moscow,9361,2,11,3,6,27,19,8,36
Spart Moscow,9361,3,10,5,5,40,29,11,35
Zenit,9361,4,8,8,4,22,15,7,32
Krasnodar,9361,5,9,5,6,28,24,4,32
Terek Grozny,9361,6,9,5,6,25,23,2,32
FK Rubin,9361,7,5,7,8,21,17,4,22
Din Moscow,9361,8,5,7,8,18,24,-6,22
Rostov,9361,9,5,6,9,12,18,-6,21
Amkar,9361,10,4,4,12,11,27,-16,16
Anzhi,9361,11,2,5,13,15,42,-27,11
Loko Moscow,9362,1,11,7,2,31,13,18,40
CSKA Moscow,9362,2,12,3,5,29,17,12,39
Spart Moscow,9362,3,10,6,4,38,26,12,36
Zenit,9362,4,7,9,4,22,15,7,30
Krasnodar,9362,5,8,6,6,28,25,3,30
Terek Grozny,9362,6,7,7,6,21,23,-2,28
FK Rubin,9362,7,5,7,8,22,18,4,22
Din Moscow,9362,8,5,7,8,18,23,-5,22
Rostov,9362,9,4,7,9,11,18,-7,19
Amkar,9362,10,4,5,11,10,26,-16,17
Anzhi,9362,11,2,6,12,14,40,-26,12
Loko Moscow,9363,1,12,6,2,32,12,20,42
Spart Moscow,9363,2,10,6,4,38,27,11,36
CSKA Moscow,9363,3,11,3,6,30,20,10,36
Zenit,9363,4,8,8,4,24,16,8,32
Krasnodar,9363,5,9,5,6,30,25,5,32
Terek Grozny,9363,6,7,6,7,22,25,-3,27
Din Moscow,9363,7,5,7,8,17,23,-6,22
FK Rubin,9363,8,5,6,9,21,19,2,21
Rostov,9363,9,4,7,9,10,17,-7,19
Amkar,9363,10,5,4,11,13,26,-13,19
Anzhi,9363,11,2,6,12,15,42,-27,12
Loko Moscow,9364,1,13,5,2,32,12,20,44
CSKA Moscow,9364,2,12,3,5,30,19,11,39
Spart Moscow,9364,3,10,6,4,37,26,11,36
Zenit,9364,4,7,8,5,22,17,5,29
Krasnodar,9364,5,8,5,7,29,27,2,29
Terek Grozny,9364,6,7,6,7,21,25,-4,27
Din Moscow,9364,7,6,6,8,18,23,-5,24
FK Rubin,9364,8,5,6,9,22,19,3,21
Amkar,9364,9,5,5,10,13,24,-11,20
Rostov,9364,10,4,6,10,10,18,-8,18
Anzhi,9364,11,2,6,12,15,39,-24,12
Loko Moscow,9365,1,12,6,2,33,13,20,42
Spart Moscow,9365,2,11,5,4,40,26,14,38
CSKA Moscow,9365,3,11,3,6,26,18,8,36
Zenit,9365,4,7,9,4,22,15,7,30
Krasnodar,9365,5,8,5,7,29,28,1,29
Terek Grozny,9365,6,7,5,8,21,26,-5,26
FK Rubin,9365,7,5,7,8,22,18,4,22
Din Moscow,9365,8,5,7,8,17,22,-5,22
Amkar,9365,9,5,4,11,11,24,-13,19
Rostov,9365,10,4,6,10,10,21,-11,18
Anzhi,9365,11,4,5,11,18,38,-20,17
Loko Moscow,9366,1,11,7,2,32,14,18,40
CSKA Moscow,9366,2,11,4,5,30,19,11,37
Spart Moscow,9366,3,9,6,5,40,30,10,33
Zenit,9366,4,7,10,3,25,17,8,31
Krasnodar,9366,5,8,5,7,29,27,2,29
Terek Grozny,9366,6,7,6,7,21,25,-4,27
FK Rubin,9366,7,7,5,8,25,18,7,26
Amkar,9366,8,6,4,10,14,24,-10,22
Din Moscow,9366,9,5,6,9,18,27,-9,21
Rostov,9366,10,4,7,9,11,18,-7,19
Anzhi,9366,11,2,6,12,15,41,-26,12
Loko Moscow,9367,1,13,5,2,33,13,20,44
CSKA Moscow,9367,2,11,4,5,29,19,10,37
Spart Moscow,9367,3,10,6,4,36,25,11,36
Krasnodar,9367,4,9,4,7,31,28,3,31
Zenit,9367,5,7,8,5,22,17,5,29
Terek Grozny,9367,6,7,6,7,20,23,-3,27
Din Moscow,9367,7,6,7,7,19,22,-3,25
FK Rubin,9367,8,5,5,10,23,21,2,20
Amkar,9367,9,5,4,11,10,24,-14,19
Rostov,9367,10,4,6,10,10,18,-8,18
Anzhi,9367,11,2,7,11,15,38,-23,13
Loko Moscow,9368,1,11,6,3,32,16,16,39
CSKA Moscow,9368,2,11,4,5,30,18,12,37
Spart Moscow,9368,3,9,7,4,36,26,10,34
Zenit,9368,4,8,9,3,25,15,10,33
Krasnodar,9368,5,9,5,6,31,27,4,32
Terek Grozny,9368,6,7,6,7,22,25,-3,27
Din Moscow,9368,7,6,7,7,20,21,-1,25
FK Rubin,9368,8,5,5,10,22,22,0,20
Rostov,9368,9,4,7,9,11,18,-7,19
Amkar,9368,10,5,4,11,11,25,-14,19
Anzhi,9368,11,2,6,12,15,42,-27,12
Loko Moscow,9369,1,12,6,2,32,12,20,42
CSKA Moscow,9369,2,12,3,5,31,19,12,39
Spart Moscow,9369,3,9,6,5,37,29,8,33
Zenit,9369,4,7,9,4,24,18,6,30
Krasnodar,9369,5,8,5,7,27,26,1,29
Terek Grozny,9369,6,8,5,7,24,24,0,29
Din Moscow,9369,7,6,6,8,21,24,-3,24
Amkar,9369,8,6,4,10,11,22,-11,22
FK Rubin,9369,9,5,6,9,21,19,2,21
Rostov,9369,10,4,7,9,11,18,-7,19
Anzhi,9369,11,2,5,13,15,43,-28,11
Loko Moscow,9370,1,12,5,3,32,13,19,41
CSKA Moscow,9370,2,12,3,5,28,17,11,39
Spart Moscow,9370,3,11,5,4,42,27,15,38
Zenit,9370,4,8,8,4,22,14,8,32
Terek Grozny,9370,5,8,6,6,23,23,0,30
Krasnodar,9370,6,8,4,8,28,28,0,28
FK Rubin,9370,7,6,6,8,23,18,5,24
Din Moscow,9370,8,5,7,8,19,25,-6,22
Rostov,9370,9,4,6,10,10,20,-10,18
Amkar,9370,10,4,4,12,10,27,-17,16
Anzhi,9370,11,2,6,12,15,40,-25,12
Loko Moscow,9371,1,11,5,4,29,15,14,38
Spart Moscow,9371,2,10,6,4,38,26,12,36
Zenit,9371,3,9,8,3,24,13,11,35
CSKA Moscow,9371,4,10,4,6,26,19,7,34
Terek Grozny,9371,5,9,5,6,27,24,3,32
Krasnodar,9371,6,9,4,7,29,25,4,31
Din Moscow,9371,7,6,6,8,19,25,-6,24
FK Rubin,9371,8,6,5,9,23,19,4,23
Rostov,9371,9,4,6,10,11,19,-8,18
Amkar,9371,10,4,5,11,11,25,-14,17
Anzhi,9371,11,2,6,12,15,42,-27,12
CSKA Moscow,9372,1,12,3,5,30,17,13,39
Loko Moscow,9372,2,11,5,4,29,14,15,38
Spart Moscow,9372,3,9,5,6,40,28,12,32
Zenit,9372,4,8,8,4,23,14,9,32
Krasnodar,9372,5,9,5,6,28,24,4,32
Terek Grozny,9372,6,9,5,6,24,24,0,32
FK Rubin,9372,7,6,6,8,22,17,5,24
Din Moscow,9372,8,6,6,8,18,22,-4,24
Amkar,9372,9,5,4,11,11,24,-13,19
Rostov,9372,10,4,6,10,10,23,-13,18
Anzhi,9372,11,2,5,13,16,44,-28,11
Loko Moscow,9373,1,11,6,3,29,12,17,39
Spart Moscow,9373,2,11,5,4,41,27,14,38
CSKA Moscow,9373,3,11,3,6,27,20,7,36
Zenit,9373,4,9,8,3,25,13,12,35
Krasnodar,9373,5,8,5,7,27,26,1,29
Terek Grozny,9373,6,7,5,8,22,26,-4,26
FK Rubin,9373,7,6,6,8,24,18,6,24
Din Moscow,9373,8,5,7,8,18,24,-6,22
Amkar,9373,9,5,4,11,12,25,-13,19
Rostov,9373,10,4,6,10,11,21,-10,18
Anzhi,9373,11,3,5,12,16,40,-24,14
Loko Moscow,9374,1,12,5,3,32,13,19,41
CSKA Moscow,9374,2,12,3,5,29,18,11,39
Krasnodar,9374,3,10,4,6,32,25,7,34
Spart Moscow,9374,4,9,5,6,35,28,7,32
Zenit,9374,5,7,8,5,22,18,4,29
Terek Grozny,9374,6,7,6,7,21,25,-4,27
Din Moscow,9374,7,6,6,8,20,24,-4,24
FK Rubin,9374,8,6,5,9,24,22,2,23
Amkar,9374,9,6,4,10,12,22,-10,22
Rostov,9374,10,4,6,10,10,18,-8,18
Anzhi,9374,11,2,6,12,16,40,-24,12
Loko Moscow,9375,1,11,5,4,31,15,16,38
Spart Moscow,9375,2,10,6,4,36,25,11,36
CSKA Moscow,9375,3,11,3,6,27,19,8,36
Zenit,9375,4,9,8,3,24,14,10,35
Krasnodar,9375,5,10,4,6,32,25,7,34
Terek Grozny,9375,6,8,5,7,24,26,-2,29
FK Rubin,9375,7,6,5,9,23,21,2,23
Din Moscow,9375,8,5,6,9,18,24,-6,21
Amkar,9375,9,5,5,10,11,23,-12,20
Rostov,9375,10,4,6,10,10,19,-9,18
Anzhi,9375,11,2,5,13,17,42,-25,11
Loko Moscow,9376,1,12,5,3,32,14,18,41
CSKA Moscow,9376,2,12,3,5,28,17,11,39
Spart Moscow,9376,3,10,6,4,42,26,16,36
Zenit,9376,4,8,8,4,23,14,9,32
Krasnodar,9376,5,8,5,7,28,27,1,29
Terek Grozny,9376,6,7,5,8,20,24,-4,26
FK Rubin,9376,7,5,7,8,21,17,4,22
Din Moscow,9376,8,5,7,8,17,24,-7,22
Amkar,9376,9,5,5,10,11,23,-12,20
Rostov,9376,10,4,6,10,10,22,-12,18
Anzhi,9376,11,3,5,12,15,39,-24,14
Loko Moscow,9377,1,11,7,2,30,12,18,40
CSKA Moscow,9377,2,12,3,5,28,17,11,39
Spart Moscow,9377,3,10,6,4,39,27,12,36
Krasnodar,9377,4,9,5,6,30,25,5,32
Terek Grozny,9377,5,9,5,6,22,22,0,32
Zenit,9377,6,7,9,4,22,15,7,30
FK Rubin,9377,7,6,5,9,23,20,3,23
Din Moscow,9377,8,5,7,8,18,23,-5,22
Rostov,9377,9,4,6,10,10,19,-9,18
Amkar,9377,10,4,4,12,10,26,-16,16
Anzhi,9377,11,2,5,13,14,40,-26,11
Loko Moscow,9378,1,12,5,3,32,14,18,41
CSKA Moscow,9378,2,12,3,5,29,18,11,39
Spart Moscow,9378,3,9,6,5,35,28,7,33
Zenit,9378,4,8,8,4,24,16,8,32
Terek Grozny,9378,5,8,6,6,24,25,-1,30
Krasnodar,9378,6,8,4,8,28,28,0,28
FK Rubin,9378,7,7,5,8,28,18,10,26
Din Moscow,9378,8,6,6,8,21,27,-6,24
Rostov,9378,9,4,6,10,10,18,-8,18
Amkar,9378,10,4,6,10,11,24,-13,18
Anzhi,9378,11,2,5,13,15,41,-26,11
Loko Moscow,9379,1,12,6,2,33,13,20,42
CSKA Moscow,9379,2,10,3,7,27,22,5,33
Zenit,9379,3,8,8,4,24,16,8,32
Krasnodar,9379,4,9,5,6,31,26,5,32
Spart Moscow,9379,5,8,7,5,39,32,7,31
Terek Grozny,9379,6,7,6,7,20,23,-3,27
Din Moscow,9379,7,5,8,7,19,23,-4,23
Amkar,9379,8,6,4,10,11,22,-11,22
FK Rubin,9379,9,5,6,9,22,20,2,21
Rostov,9379,10,4,7,9,14,21,-7,19
Anzhi,9379,11,3,6,11,17,39,-22,15
Loko Moscow,9380,1,12,6,2,31,12,19,42
CSKA Moscow,9380,2,10,3,7,28,22,6,33
Zenit,9380,3,8,8,4,24,16,8,32
Spart Moscow,9380,4,8,7,5,35,28,7,31
Krasnodar,9380,5,8,6,6,27,24,3,30
Terek Grozny,9380,6,8,5,7,22,25,-3,29
Din Moscow,9380,7,5,8,7,20,24,-4,23
FK Rubin,9380,8,5,7,8,23,19,4,22
Amkar,9380,9,6,4,10,13,22,-9,22
Rostov,9380,10,4,7,9,11,18,-7,19
Anzhi,9380,11,3,5,12,17,41,-24,14
Loko Moscow,9381,1,12,5,3,31,12,19,41
CSKA Moscow,9381,2,11,4,5,26,17,9,37
Spart Moscow,9381,3,9,6,5,35,29,6,33
Krasnodar,9381,4,9,5,6,29,25,4,32
Zenit,9381,5,7,9,4,21,15,6,30
Terek Grozny,9381,6,7,5,8,21,26,-5,26
FK Rubin,9381,7,6,6,8,24,19,5,24
Din Moscow,9381,8,6,6,8,21,23,-2,24
Amkar,9381,9,5,5,10,10,22,-12,20
Rostov,9381,10,4,6,10,11,19,-8,18
Anzhi,9381,11,3,5,12,17,39,-22,14
Loko Moscow,9382,1,13,5,2,32,11,21,44
CSKA Moscow,9382,2,11,3,6,31,19,12,36
Spart Moscow,9382,3,9,6,5,35,27,8,33
Zenit,9382,4,8,8,4,22,15,7,32
Krasnodar,9382,5,9,4,7,29,25,4,31
Terek Grozny,9382,6,8,5,7,23,24,-1,29
FK Rubin,9382,7,6,5,9,23,20,3,23
Din Moscow,9382,8,5,7,8,19,24,-5,22
Rostov,9382,9,5,6,9,11,17,-6,21
Amkar,9382,10,5,4,11,10,23,-13,19
Anzhi,9382,11,2,5,13,16,46,-30,11
Loko Moscow,9383,1,11,7,2,30,12,18,40
CSKA Moscow,9383,2,11,3,6,27,18,9,36
Spart Moscow,9383,3,9,7,4,38,28,10,34
Zenit,9383,4,8,9,3,22,13,9,33
Terek Grozny,9383,5,8,6,6,24,24,0,30
Krasnodar,9383,6,8,5,7,28,26,2,29
FK Rubin,9383,7,7,5,8,24,17,7,26
Din Moscow,9383,8,5,6,9,18,26,-8,21
Rostov,9383,9,4,7,9,12,19,-7,19
Amkar,9383,10,4,5,11,9,24,-15,17
Anzhi,9383,11,2,6,12,16,41,-25,12
Loko Moscow,9384,1,12,6,2,34,13,21,42
Zenit,9384,2,8,9,3,24,15,9,33
Spart Moscow,9384,3,9,6,5,38,32,6,33
CSKA Moscow,9384,4,10,3,7,25,20,5,33
Terek Grozny,9384,5,9,5,6,23,22,1,32
Krasnodar,9384,6,8,5,7,29,29,0,29
Din Moscow,9384,7,6,7,7,22,23,-1,25
FK Rubin,9384,8,5,7,8,24,20,4,22
Rostov,9384,9,4,7,9,12,19,-7,19
Amkar,9384,10,4,4,12,10,25,-15,16
Anzhi,9384,11,3,5,12,16,39,-23,14
Loko Moscow,9385,1,11,5,4,29,14,15,38
CSKA Moscow,9385,2,11,3,6,28,20,8,36
Zenit,9385,3,9,8,3,26,13,13,35
Spart Moscow,9385,4,8,8,4,35,27,8,32
Krasnodar,9385,5,9,5,6,29,25,4,32
Terek Grozny,9385,6,8,5,7,23,23,0,29
Din Moscow,9385,7,5,8,7,18,22,-4,23
FK Rubin,9385,8,5,7,8,22,18,4,22
Rostov,9385,9,4,7,9,10,17,-7,19
Amkar,9385,10,4,5,11,10,26,-16,17
Anzhi,9385,11,3,5,12,15,40,-25,14
Loko Moscow,9386,1,13,5,2,32,12,20,44
CSKA Moscow,9386,2,11,3,6,29,21,8,36
Spart Moscow,9386,3,9,7,4,39,30,9,34
Zenit,9386,4,8,8,4,24,15,9,32
Krasnodar,9386,5,9,4,7,30,26,4,31
Terek Grozny,9386,6,7,5,8,21,27,-6,26
Din Moscow,9386,7,6,7,7,20,23,-3,25
FK Rubin,9386,8,5,5,10,21,20,1,20
Rostov,9386,9,4,7,9,11,18,-7,19
Amkar,9386,10,5,4,11,13,25,-12,19
Anzhi,9386,11,3,5,12,18,41,-23,14
Loko Moscow,9387,1,11,7,2,31,13,18,40
CSKA Moscow,9387,2,12,3,5,28,17,11,39
Spart Moscow,9387,3,9,6,5,38,30,8,33
Krasnodar,9387,4,9,5,6,31,26,5,32
Zenit,9387,5,7,9,4,22,16,6,30
Terek Grozny,9387,6,7,7,6,22,24,-2,28
Din Moscow,9387,7,6,6,8,20,24,-4,24
Rostov,9387,8,5,6,9,12,18,-6,21
FK Rubin,9387,9,5,5,10,23,22,1,20
Amkar,9387,10,4,6,10,12,25,-13,18
Anzhi,9387,11,2,6,12,15,39,-24,12
Loko Moscow,9388,1,12,6,2,34,15,19,42
CSKA Moscow,9388,2,12,3,5,30,17,13,39
Spart Moscow,9388,3,10,5,5,40,29,11,35
Krasnodar,9388,4,8,6,6,31,28,3,30
Zenit,9388,5,7,8,5,21,15,6,29
Terek Grozny,9388,6,7,6,7,22,27,-5,27
FK Rubin,9388,7,6,6,8,25,18,7,24
Rostov,9388,8,5,6,9,12,17,-5,21
Din Moscow,9388,9,5,6,9,19,27,-8,21
Amkar,9388,10,5,4,11,13,27,-14,19
Anzhi,9388,11,2,6,12,16,43,-27,12
Loko Moscow,9389,1,12,5,3,33,16,17,41
CSKA Moscow,9389,2,12,3,5,29,19,10,39
Spart Moscow,9389,3,9,6,5,37,28,9,33
Zenit,9389,4,8,8,4,25,16,9,32
Krasnodar,9389,5,9,4,7,29,26,3,31
Terek Grozny,9389,6,8,6,6,23,23,0,30
Din Moscow,9389,7,6,6,8,19,23,-4,24
Rostov,9389,8,5,6,9,11,17,-6,21
FK Rubin,9389,9,5,5,10,21,20,1,20
Amkar,9389,10,4,6,10,11,24,-13,18
Anzhi,9389,11,2,5,13,17,43,-26,11
Loko Moscow,9390,1,12,5,3,32,14,18,41
CSKA Moscow,9390,2,12,3,5,30,19,11,39
Krasnodar,9390,3,10,4,6,33,27,6,34
Spart Moscow,9390,4,9,6,5,35,28,7,33
Terek Grozny,9390,5,8,6,6,25,25,0,30
Zenit,9390,6,7,8,5,22,16,6,29
FK Rubin,9390,7,6,5,9,24,21,3,23
Rostov,9390,8,5,6,9,12,17,-5,21
Din Moscow,9390,9,5,6,9,18,24,-6,21
Amkar,9390,10,4,6,10,12,25,-13,18
Anzhi,9390,11,2,5,13,16,43,-27,11
Loko Moscow,9391,1,12,6,2,31,11,20,42
CSKA Moscow,9391,2,11,4,5,29,20,9,37
Spart Moscow,9391,3,10,5,5,39,28,11,35
Krasnodar,9391,4,9,5,6,29,24,5,32
Zenit,9391,5,7,9,4,23,17,6,30
Terek Grozny,9391,6,8,6,6,22,22,0,30
Din Moscow,9391,7,5,7,8,19,25,-6,22
FK Rubin,9391,8,5,6,9,23,21,2,21
Amkar,9391,9,5,4,11,11,25,-14,19
Rostov,9391,10,4,6,10,11,20,-9,18
Anzhi,9391,11,2,6,12,15,39,-24,12
Loko Moscow,9392,1,13,5,2,32,12,20,44
CSKA Moscow,9392,2,11,4,5,34,21,13,37
Spart Moscow,9392,3,10,6,4,38,27,11,36
Terek Grozny,9392,4,9,5,6,23,22,1,32
Zenit,9392,5,7,9,4,24,17,7,30
Krasnodar,9392,6,8,5,7,29,27,2,29
Din Moscow,9392,7,6,6,8,20,24,-4,24
FK Rubin,9392,8,5,6,9,23,20,3,21
Rostov,9392,9,4,6,10,10,19,-9,18
Amkar,9392,10,4,5,11,10,25,-15,17
Anzhi,9392,11,2,5,13,15,44,-29,11
Loko Moscow,9393,1,13,5,2,31,11,20,44
CSKA Moscow,9393,2,10,5,5,28,20,8,35
Spart Moscow,9393,3,9,7,4,38,27,11,34
Zenit,9393,4,7,9,4,23,16,7,30
Krasnodar,9393,5,8,4,8,28,27,1,28
Terek Grozny,9393,6,7,6,7,21,25,-4,27
Din Moscow,9393,7,6,6,8,20,25,-5,24
FK Rubin,9393,8,6,5,9,24,21,3,23
Amkar,9393,9,5,5,10,12,23,-11,20
Rostov,9393,10,4,7,9,11,18,-7,19
Anzhi,9393,11,2,7,11,16,39,-23,13
Loko Moscow,9394,1,11,5,4,31,17,14,38
CSKA Moscow,9394,2,11,4,5,28,19,9,37
Spart Moscow,9394,3,10,5,5,43,29,14,35
Zenit,9394,4,8,9,3,24,15,9,33
Krasnodar,9394,5,9,4,7,32,27,5,31
Terek Grozny,9394,6,7,7,6,20,22,-2,28
FK Rubin,9394,7,6,6,8,24,19,5,24
Din Moscow,9394,8,5,7,8,19,28,-9,22
Amkar,9394,9,5,5,10,12,23,-11,20
Rostov,9394,10,4,6,10,10,20,-10,18
Anzhi,9394,11,2,6,12,15,39,-24,12
Loko Moscow,9395,1,12,6,2,31,12,19,42
Spart Moscow,9395,2,11,5,4,43,30,13,38
CSKA Moscow,9395,3,11,3,6,26,18,8,36
Zenit,9395,4,8,9,3,23,14,9,33
Terek Grozny,9395,5,8,5,7,24,24,0,29
Krasnodar,9395,6,8,4,8,27,26,1,28
FK Rubin,9395,7,6,6,8,22,17,5,24
Din Moscow,9395,8,5,7,8,20,27,-7,22
Amkar,9395,9,5,4,11,13,26,-13,19
Rostov,9395,10,4,6,10,10,18,-8,18
Anzhi,9395,11,2,5,13,14,41,-27,11
Loko Moscow,9396,1,12,6,2,31,12,19,42
CSKA Moscow,9396,2,12,3,5,30,17,13,39
Spart Moscow,9396,3,9,5,6,34,27,7,32
Krasnodar,9396,4,9,4,7,30,27,3,31
Zenit,9396,5,7,9,4,21,14,7,30
Terek Grozny,9396,6,7,6,7,23,26,-3,27
Din Moscow,9396,7,6,7,7,19,22,-3,25
FK Rubin,9396,8,5,6,9,23,20,3,21
Rostov,9396,9,5,6,9,11,17,-6,21
Amkar,9396,10,5,4,11,12,25,-13,19
Anzhi,9396,11,2,6,12,15,42,-27,12
Loko Moscow,9397,1,11,5,4,29,17,12,38
CSKA Moscow,9397,2,11,4,5,28,18,10,37
Spart Moscow,9397,3,10,5,5,37,27,10,35
Zenit,9397,4,8,8,4,24,15,9,32
Krasnodar,9397,5,9,5,6,30,24,6,32
Terek Grozny,9397,6,7,7,6,21,23,-2,28
FK Rubin,9397,7,6,6,8,23,18,5,24
Din Moscow,9397,8,6,6,8,20,24,-4,24
Rostov,9397,9,4,6,10,10,18,-8,18
Amkar,9397,10,4,5,11,9,24,-15,17
Anzhi,9397,11,2,7,11,16,39,-23,13
Loko Moscow,9398,1,12,5,3,32,13,19,41
Spart Moscow,9398,2,10,6,4,41,26,15,36
CSKA Moscow,9398,3,10,5,5,26,18,8,35
Krasnodar,9398,4,9,5,6,29,25,4,32
Zenit,9398,5,7,9,4,22,16,6,30
Terek Grozny,9398,6,8,6,6,21,22,-1,30
FK Rubin,9398,7,5,7,8,22,18,4,22
Din Moscow,9398,8,5,7,8,19,27,-8,22
Rostov,9398,9,4,6,10,10,20,-10,18
Amkar,9398,10,4,5,11,9,23,-14,17
Anzhi,9398,11,2,7,11,14,37,-23,13
Loko Moscow,9399,1,13,5,2,34,12,22,44
Spart Moscow,9399,2,11,5,4,41,26,15,38
CSKA Moscow,9399,3,11,4,5,26,17,9,37
Zenit,9399,4,7,9,4,21,16,5,30
Krasnodar,9399,5,8,5,7,30,28,2,29
Terek Grozny,9399,6,8,5,7,23,24,-1,29
FK Rubin,9399,7,5,7,8,24,20,4,22
Din Moscow,9399,8,5,7,8,18,26,-8,22
Amkar,9399,9,5,4,11,10,24,-14,19
Rostov,9399,10,4,6,10,11,19,-8,18
Anzhi,9399,11,2,5,13,15,41,-26,11
Loko Moscow,9400,1,13,5,2,36,13,23,44
Spart Moscow,9400,2,10,5,5,40,29,11,35
CSKA Moscow,9400,3,10,5,5,27,19,8,35
Zenit,9400,4,7,9,4,22,17,5,30
Krasnodar,9400,5,8,4,8,30,30,0,28
Terek Grozny,9400,6,7,6,7,20,23,-3,27
FK Rubin,9400,7,7,5,8,25,18,7,26
Amkar,9400,8,6,4,10,12,23,-11,22
Din Moscow,9400,9,5,6,9,18,26,-8,21
Rostov,9400,10,4,6,10,11,20,-9,18
Anzhi,9400,11,2,7,11,15,38,-23,13
Loko Moscow,9401,1,12,5,3,30,13,17,41
CSKA Moscow,9401,2,12,3,5,31,17,14,39
Zenit,9401,3,8,8,4,23,17,6,32
Terek Grozny,9401,4,9,5,6,25,23,2,32
Spart Moscow,9401,5,8,7,5,37,32,5,31
Krasnodar,9401,6,8,4,8,27,27,0,28
Din Moscow,9401,7,6,7,7,22,23,-1,25
FK Rubin,9401,8,6,5,9,23,20,3,23
Rostov,9401,9,4,7,9,12,19,-7,19
Amkar,9401,10,5,4,11,12,24,-12,19
Anzhi,9401,11,2,5,13,15,42,-27,11
Loko Moscow,9402,1,11,6,3,32,15,17,39
CSKA Moscow,9402,2,11,3,6,29,19,10,36
Spart Moscow,9402,3,9,7,4,37,28,9,34
Zenit,9402,4,8,9,3,26,17,9,33
Terek Grozny,9402,5,9,5,6,25,23,2,32
Krasnodar,9402,6,9,4,7,30,28,2,31
FK Rubin,9402,7,7,5,8,27,20,7,26
Din Moscow,9402,8,5,7,8,20,25,-5,22
Rostov,9402,9,4,7,9,11,18,-7,19
Amkar,9402,10,4,4,12,10,25,-15,16
Anzhi,9402,11,2,5,13,14,43,-29,11
Loko Moscow,9403,1,11,6,3,29,13,16,39
Krasnodar,9403,2,10,4,6,30,24,6,34
Spart Moscow,9403,3,9,6,5,39,30,9,33
Zenit,9403,4,8,9,3,23,14,9,33
CSKA Moscow,9403,5,10,3,7,27,21,6,33
Terek Grozny,9403,6,8,5,7,23,26,-3,29
FK Rubin,9403,7,6,5,9,23,18,5,23
Rostov,9403,8,5,6,9,11,17,-6,21
Din Moscow,9403,9,5,6,9,18,26,-8,21
Amkar,9403,10,4,5,11,14,28,-14,17
Anzhi,9403,11,4,5,11,18,38,-20,17
Loko Moscow,9404,1,11,5,4,30,14,16,38
CSKA Moscow,9404,2,11,3,6,28,20,8,36
Krasnodar,9404,3,10,4,6,33,25,8,34
Spart Moscow,9404,4,9,6,5,37,29,8,33
Zenit,9404,5,8,8,4,23,15,8,32
Terek Grozny,9404,6,7,7,6,20,22,-2,28
Din Moscow,9404,7,5,7,8,18,24,-6,22
FK Rubin,9404,8,5,6,9,21,21,0,21
Amkar,9404,9,5,5,10,11,22,-11,20
Rostov,9404,10,4,7,9,11,18,-7,19
Anzhi,9404,11,3,6,11,16,38,-22,15
Loko Moscow,9405,1,11,5,4,29,16,13,38
Spart Moscow,9405,2,10,6,4,39,28,11,36
Zenit,9405,3,9,8,3,25,13,12,35
Krasnodar,9405,4,10,4,6,31,24,7,34
CSKA Moscow,9405,5,10,3,7,25,20,5,33
Terek Grozny,9405,6,9,5,6,25,24,1,32
FK Rubin,9405,7,6,5,9,22,18,4,23
Din Moscow,9405,8,5,6,9,18,25,-7,21
Rostov,9405,9,4,6,10,11,19,-8,18
Amkar,9405,10,4,5,11,10,24,-14,17
Anzhi,9405,11,3,5,12,17,41,-24,14
Loko Moscow,9406,1,11,6,3,30,14,16,39
Spart Moscow,9406,2,11,5,4,41,26,15,38
CSKA Moscow,9406,3,11,3,6,28,21,7,36
Krasnodar,9406,4,10,4,6,33,25,8,34
Zenit,9406,5,8,9,3,25,14,11,33
Terek Grozny,9406,6,8,5,7,21,23,-2,29
Din Moscow,9406,7,6,6,8,20,24,-4,24
FK Rubin,9406,8,5,5,10,23,24,-1,20
Rostov,9406,9,4,6,10,10,20,-10,18
Amkar,9406,10,4,4,12,10,26,-16,16
Anzhi,9406,11,3,5,12,16,40,-24,14
Loko Moscow,9407,1,13,5,2,34,12,22,44
CSKA Moscow,9407,2,10,5,5,26,18,8,35
Spart Moscow,9407,3,9,5,6,36,29,7,32
Terek Grozny,9407,4,9,5,6,22,22,0,32
Zenit,9407,5,7,9,4,22,17,5,30
Krasnodar,9407,6,8,4,8,27,28,-1,28
Din Moscow,9407,7,6,6,8,18,22,-4,24
FK Rubin,9407,8,6,5,9,24,18,6,23
Rostov,9407,9,5,6,9,13,19,-6,21
Amkar,9407,10,5,4,11,10,23,-13,19
Anzhi,9407,11,2,6,12,15,39,-24,12
Loko Moscow,9408,1,12,6,2,35,12,23,42
CSKA Moscow,9408,2,11,4,5,29,17,12,37
Spart Moscow,9408,3,9,6,5,38,28,10,33
Terek Grozny,9408,4,9,5,6,25,22,3,32
Zenit,9408,5,7,9,4,21,18,3,30
Krasnodar,9408,6,8,5,7,29,27,2,29
Din Moscow,9408,7,6,7,7,20,23,-3,25
FK Rubin,9408,8,6,5,9,23,19,4,23
Amkar,9408,9,5,4,11,10,24,-14,19
Rostov,9408,10,4,6,10,10,20,-10,18
Anzhi,9408,11,2,5,13,14,44,-30,11
Loko Moscow,9409,1,11,6,3,29,12,17,39
Spart Moscow,9409,2,10,6,4,40,29,11,36
CSKA Moscow,9409,3,11,3,6,28,18,10,36
Krasnodar,9409,4,10,4,6,31,25,6,34
Zenit,9409,5,8,9,3,22,13,9,33
Terek Grozny,9409,6,8,5,7,24,27,-3,29
Din Moscow,9409,7,6,6,8,22,22,0,24
FK Rubin,9409,8,5,5,10,22,25,-3,20
Amkar,9409,9,5,5,10,16,25,-9,20
Rostov,9409,10,4,6,10,12,21,-9,18
Anzhi,9409,11,2,5,13,14,43,-29,11
Loko Moscow,9410,1,12,5,3,32,16,16,41
CSKA Moscow,9410,2,11,3,6,28,19,9,36
Spart Moscow,9410,3,10,5,5,38,28,10,35
Zenit,9410,4,8,8,4,24,16,8,32
Krasnodar,9410,5,9,5,6,31,25,6,32
Terek Grozny,9410,6,9,5,6,24,23,1,32
Din Moscow,9410,7,6,7,7,20,23,-3,25
FK Rubin,9410,8,5,7,8,23,19,4,22
Rostov,9410,9,4,6,10,10,19,-9,18
Amkar,9410,10,4,4,12,10,26,-16,16
Anzhi,9410,11,2,5,13,16,42,-26,11
Loko Moscow,9411,1,12,5,3,31,13,18,41
CSKA Moscow,9411,2,11,3,6,28,18,10,36
Spart Moscow,9411,3,10,5,5,38,27,11,35
Krasnodar,9411,4,10,4,6,32,26,6,34
Zenit,9411,5,8,8,4,23,15,8,32
Terek Grozny,9411,6,8,5,7,26,25,1,29
Din Moscow,9411,7,5,7,8,19,25,-6,22
FK Rubin,9411,8,5,6,9,24,22,2,21
Rostov,9411,9,5,6,9,11,17,-6,21
Amkar,9411,10,4,4,12,10,29,-19,16
Anzhi,9411,11,3,5,12,16,41,-25,14
CSKA Moscow,9412,1,12,3,5,31,17,14,39
Loko Moscow,9412,2,11,5,4,31,16,15,38
Spart Moscow,9412,3,10,6,4,39,27,12,36
Zenit,9412,4,8,8,4,23,16,7,32
Terek Grozny,9412,5,9,5,6,24,22,2,32
Krasnodar,9412,6,9,4,7,30,26,4,31
FK Rubin,9412,7,6,6,8,24,19,5,24
Din Moscow,9412,8,5,7,8,21,26,-5,22
Rostov,9412,9,4,7,9,10,17,-7,19
Amkar,9412,10,4,4,12,9,27,-18,16
Anzhi,9412,11,2,5,13,14,43,-29,11
Loko Moscow,9413,1,12,5,3,34,13,21,41
Spart Moscow,9413,2,9,7,4,36,27,9,34
CSKA Moscow,9413,3,10,4,6,26,19,7,34
Zenit,9413,4,8,8,4,22,17,5,32
Krasnodar,9413,5,9,5,6,30,26,4,32
Terek Grozny,9413,6,7,6,7,22,25,-3,27
Din Moscow,9413,7,6,7,7,20,23,-3,25
FK Rubin,9413,8,5,6,9,23,20,3,21
Rostov,9413,9,4,7,9,10,17,-7,19
Amkar,9413,10,4,5,11,11,25,-14,17
Anzhi,9413,11,3,6,11,17,39,-22,15
Loko Moscow,9414,1,11,5,4,30,15,15,38
CSKA Moscow,9414,2,11,3,6,30,23,7,36
Zenit,9414,3,9,8,3,27,13,14,35
Krasnodar,9414,4,10,4,6,31,26,5,34
Spart Moscow,9414,5,9,6,5,36,29,7,33
Terek Grozny,9414,6,8,6,6,23,23,0,30
Din Moscow,9414,7,6,6,8,19,24,-5,24
FK Rubin,9414,8,5,5,10,22,20,2,20
Rostov,9414,9,4,7,9,10,17,-7,19
Amkar,9414,10,5,4,11,12,24,-12,19
Anzhi,9414,11,2,6,12,17,43,-26,12
Loko Moscow,9415,1,12,5,3,31,13,18,41
CSKA Moscow,9415,2,11,4,5,27,18,9,37
Krasnodar,9415,3,10,4,6,31,25,6,34
Spart Moscow,9415,4,9,5,6,35,29,6,32
Zenit,9415,5,7,8,5,22,16,6,29
Terek Grozny,9415,6,7,7,6,26,28,-2,28
Din Moscow,9415,7,7,6,7,21,21,0,27
FK Rubin,9415,8,5,5,10,21,22,-1,20
Amkar,9415,9,5,5,10,14,24,-10,20
Rostov,9415,10,4,6,10,10,19,-9,18
Anzhi,9415,11,2,7,11,18,41,-23,13
Loko Moscow,9416,1,13,5,2,39,13,26,44
CSKA Moscow,9416,2,11,4,5,28,18,10,37
Spart Moscow,9416,3,10,6,4,40,26,14,36
Zenit,9416,4,7,9,4,22,20,2,30
Krasnodar,9416,5,8,5,7,30,29,1,29
Terek Grozny,9416,6,7,5,8,21,26,-5,26
FK Rubin,9416,7,6,6,8,23,18,5,24
Din Moscow,9416,8,5,6,9,17,26,-9,21
Amkar,9416,9,5,5,10,13,24,-11,20
Rostov,9416,10,4,6,10,10,19,-9,18
Anzhi,9416,11,3,5,12,15,39,-24,14
Loko Moscow,9417,1,11,6,3,30,13,17,39
CSKA Moscow,9417,2,10,4,6,27,20,7,34
Zenit,9417,3,8,9,3,24,15,9,33
Spart Moscow,9417,4,9,6,5,34,26,8,33
Krasnodar,9417,5,8,5,7,28,27,1,29
Terek Grozny,9417,6,7,5,8,22,26,-4,26
Din Moscow,9417,7,6,7,7,18,21,-3,25
FK Rubin,9417,8,6,5,9,23,18,5,23
Amkar,9417,9,6,4,10,12,23,-11,22
Rostov,9417,10,4,6,10,10,18,-8,18
Anzhi,9417,11,4,5,11,17,38,-21,17
Loko Moscow,9418,1,12,5,3,32,14,18,41
CSKA Moscow,9418,2,12,3,5,30,17,13,39
Krasnodar,9418,3,9,5,6,29,25,4,32
Spart Moscow,9418,4,8,7,5,35,29,6,31
Terek Grozny,9418,5,8,6,6,21,22,-1,30
Zenit,9418,6,7,8,5,23,20,3,29
Din Moscow,9418,7,7,6,7,21,22,-1,27
FK Rubin,9418,8,5,6,9,23,20,3,21
Rostov,9418,9,4,7,9,12,19,-7,19
Amkar,9418,10,4,6,10,9,22,-13,18
Anzhi,9418,11,2,5,13,14,39,-25,11
Loko Moscow,9419,1,11,5,4,30,18,12,38
CSKA Moscow,9419,2,11,4,5,33,19,14,37
Zenit,9419,3,8,9,3,28,15,13,33
Spart Moscow,9419,4,9,6,5,37,28,9,33
Krasnodar,9419,5,9,5,6,29,25,4,32
Terek Grozny,9419,6,7,6,7,22,27,-5,27
FK Rubin,9419,7,6,6,8,23,18,5,24
Din Moscow,9419,8,6,6,8,19,23,-4,24
Rostov,9419,9,4,7,9,11,18,-7,19
Amkar,9419,10,5,4,11,12,24,-12,19
Anzhi,9419,11,2,6,12,17,46,-29,12
Loko Moscow,9420,1,12,6,2,32,12,20,42
CSKA Moscow,9420,2,10,3,7,27,22,5,33
Zenit,9420,3,8,8,4,24,16,8,32
Spart Moscow,9420,4,9,5,6,35,29,6,32
Terek Grozny,9420,5,9,5,6,25,24,1,32
Krasnodar,9420,6,8,5,7,27,26,1,29
FK Rubin,9420,7,7,5,8,24,17,7,26
Din Moscow,9420,8,6,6,8,18,22,-4,24
Amkar,9420,9,5,4,11,14,27,-13,19
Rostov,9420,10,4,6,10,10,18,-8,18
Anzhi,9420,11,3,5,12,17,40,-23,14
Loko Moscow,9421,1,11,6,3,30,13,17,39
CSKA Moscow,9421,2,11,3,6,28,20,8,36
Spart Moscow,9421,3,10,5,5,38,31,7,35
Krasnodar,9421,4,10,4,6,30,24,6,34
Zenit,9421,5,8,9,3,25,15,10,33
Terek Grozny,9421,6,7,6,7,21,24,-3,27
Din Moscow,9421,7,6,6,8,21,24,-3,24
Rostov,9421,8,5,6,9,13,17,-4,21
FK Rubin,9421,9,5,5,10,21,21,0,20
Amkar,9421,10,5,4,11,11,24,-13,19
Anzhi,9421,11,2,6,12,15,40,-25,12
Loko Moscow,9422,1,11,6,3,30,14,16,39
CSKA Moscow,9422,2,11,4,5,31,20,11,37
Zenit,9422,3,8,9,3,24,14,10,33
Spart Moscow,9422,4,8,6,6,36,30,6,30
Krasnodar,9422,5,8,5,7,29,28,1,29
Terek Grozny,9422,6,7,6,7,23,27,-4,27
FK Rubin,9422,7,7,5,8,26,19,7,26
Din Moscow,9422,8,6,6,8,20,24,-4,24
Amkar,9422,9,6,4,10,13,23,-10,22
Rostov,9422,10,4,7,9,11,18,-7,19
Anzhi,9422,11,2,6,12,19,45,-26,12
Loko Moscow,9423,1,11,7,2,32,14,18,40
Spart Moscow,9423,2,10,6,4,40,27,13,36
CSKA Moscow,9423,3,11,3,6,26,18,8,36
Zenit,9423,4,8,9,3,24,15,9,33
Krasnodar,9423,5,8,6,6,28,25,3,30
Terek Grozny,9423,6,7,7,6,22,24,-2,28
FK Rubin,9423,7,6,6,8,23,17,6,24
Din Moscow,9423,8,5,6,9,18,28,-10,21
Rostov,9423,9,4,6,10,10,18,-8,18
Amkar,9423,10,4,6,10,11,24,-13,18
Anzhi,9423,11,2,6,12,15,39,-24,12
Loko Moscow,9424,1,13,5,2,31,11,20,44
CSKA Moscow,9424,2,11,4,5,28,18,10,37
Spart Moscow,9424,3,9,6,5,40,29,11,33
Krasnodar,9424,4,9,4,7,31,25,6,31
Zenit,9424,5,7,9,4,22,15,7,30
Terek Grozny,9424,6,8,6,6,22,23,-1,30
Din Moscow,9424,7,6,6,8,24,30,-6,24
Rostov,9424,8,5,6,9,11,17,-6,21
FK Rubin,9424,9,5,5,10,24,26,-2,20
Amkar,9424,10,4,6,10,11,24,-13,18
Anzhi,9424,11,2,5,13,14,40,-26,11
Loko Moscow,9425,1,12,5,3,31,14,17,41
CSKA Moscow,9425,2,11,4,5,27,18,9,37
Spart Moscow,9425,3,10,6,4,41,27,14,36
Zenit,9425,4,8,9,3,23,13,10,33
Krasnodar,9425,5,8,4,8,29,28,1,28
FK Rubin,9425,6,7,5,8,24,18,6,26
Terek Grozny,9425,7,7,5,8,21,27,-6,26
Din Moscow,9425,8,5,6,9,17,25,-8,21
Rostov,9425,9,4,7,9,11,18,-7,19
Amkar,9425,10,5,4,11,13,27,-14,19
Anzhi,9425,11,3,5,12,17,39,-22,14
CSKA Moscow,9426,1,12,3,5,33,18,15,39
Loko Moscow,9426,2,11,6,3,30,16,14,39
Zenit,9426,3,8,8,4,25,15,10,32
Spart Moscow,9426,4,9,5,6,36,28,8,32
Krasnodar,9426,5,8,5,7,28,26,2,29
Terek Grozny,9426,6,8,5,7,22,24,-2,29
FK Rubin,9426,7,7,5,8,26,18,8,26
Rostov,9426,8,5,6,9,11,17,-6,21
Din Moscow,9426,9,5,6,9,18,28,-10,21
Amkar,9426,10,5,4,11,11,23,-12,19
Anzhi,9426,11,3,5,12,17,44,-27,14
Loko Moscow,9427,1,11,7,2,29,11,18,40
Spart Moscow,9427,2,11,5,4,45,28,17,38
CSKA Moscow,9427,3,11,4,5,27,18,9,37
Zenit,9427,4,7,9,4,21,14,7,30
Krasnodar,9427,5,8,6,6,28,25,3,30
Terek Grozny,9427,6,7,7,6,21,23,-2,28
FK Rubin,9427,7,6,6,8,25,20,5,24
Din Moscow,9427,8,5,6,9,19,28,-9,21
Rostov,9427,9,4,6,10,10,21,-11,18
Amkar,9427,10,4,5,11,13,27,-14,17
Anzhi,9427,11,2,7,11,15,38,-23,13
Loko Moscow,9428,1,12,5,3,32,14,18,41
CSKA Moscow,9428,2,11,4,5,29,20,9,37
Spart Moscow,9428,3,9,6,5,39,31,8,33
Zenit,9428,4,8,8,4,25,16,9,32
Krasnodar,9428,5,8,4,8,30,30,0,28
Terek Grozny,9428,6,7,7,6,21,23,-2,28
Din Moscow,9428,7,6,6,8,23,26,-3,24
FK Rubin,9428,8,6,5,9,25,22,3,23
Amkar,9428,9,5,5,10,12,24,-12,20
Rostov,9428,10,4,7,9,11,18,-7,19
Anzhi,9428,11,2,7,11,15,38,-23,13
Loko Moscow,9429,1,13,5,2,33,12,21,44
CSKA Moscow,9429,2,11,4,5,28,18,10,37
Zenit,9429,3,7,8,5,21,16,5,29
Spart Moscow,9429,4,8,5,7,34,30,4,29
Terek Grozny,9429,5,8,5,7,23,25,-2,29
Krasnodar,9429,6,8,4,8,28,29,-1,28
FK Rubin,9429,7,7,5,8,24,17,7,26
Din Moscow,9429,8,6,6,8,19,23,-4,24
Amkar,9429,9,6,4,10,11,22,-11,22
Rostov,9429,10,5,6,9,12,17,-5,21
Anzhi,9429,11,2,6,12,17,41,-24,12
Loko Moscow,9430,1,11,5,4,29,16,13,38
Zenit,9430,2,9,8,3,25,13,12,35
Krasnodar,9430,3,10,4,6,33,26,7,34
Spart Moscow,9430,4,9,6,5,38,29,9,33
CSKA Moscow,9430,5,10,3,7,25,20,5,33
Terek Grozny,9430,6,7,5,8,20,27,-7,26
Din Moscow,9430,7,5,7,8,19,25,-6,22
Amkar,9430,8,6,4,10,15,23,-8,22
FK Rubin,9430,9,5,6,9,24,21,3,21
Rostov,9430,10,4,7,9,11,18,-7,19
Anzhi,9430,11,4,5,11,16,37,-21,17
Spart Moscow,9431,1,11,5,4,42,28,14,38
Loko Moscow,9431,2,11,5,4,31,17,14,38
CSKA Moscow,9431,3,10,4,6,25,18,7,34
Zenit,9431,4,8,9,3,23,14,9,33
Krasnodar,9431,5,9,4,7,31,26,5,31
Terek Grozny,9431,6,7,6,7,21,24,-3,27
FK Rubin,9431,7,7,5,8,24,18,6,26
Din Moscow,9431,8,5,6,9,18,26,-8,21
Rostov,9431,9,4,6,10,12,20,-8,18
Amkar,9431,10,4,5,11,10,25,-15,17
Anzhi,9431,11,4,5,11,17,38,-21,17
Loko Moscow,9432,1,11,6,3,32,16,16,39
CSKA Moscow,9432,2,12,3,5,29,17,12,39
Spart Moscow,9432,3,10,6,4,37,27,10,36
Krasnodar,9432,4,9,5,6,32,27,5,32
Zenit,9432,5,7,9,4,23,17,6,30
Terek Grozny,9432,6,8,6,6,23,24,-1,30
FK Rubin,9432,7,5,7,8,23,19,4,22
Din Moscow,9432,8,5,7,8,17,22,-5,22
Rostov,9432,9,4,7,9,12,19,-7,19
Amkar,9432,10,4,5,11,10,24,-14,17
Anzhi,9432,11,2,5,13,15,41,-26,11
Loko Moscow,9433,1,11,6,3,31,14,17,39
CSKA Moscow,9433,2,10,5,5,26,18,8,35
Spart Moscow,9433,3,9,6,5,37,27,10,33
Zenit,9433,4,7,10,3,22,14,8,31
Krasnodar,9433,5,9,4,7,30,28,2,31
Terek Grozny,9433,6,8,5,7,23,27,-4,29
Din Moscow,9433,7,6,6,8,21,24,-3,24
FK Rubin,9433,8,6,5,9,23,21,2,23
Rostov,9433,9,4,7,9,11,18,-7,19
Amkar,9433,10,5,4,11,10,23,-13,19
Anzhi,9433,11,3,6,11,19,39,-20,15
Loko Moscow,9434,1,12,6,2,33,13,20,42
Zenit,9434,2,8,9,3,26,14,12,33
CSKA Moscow,9434,3,10,3,7,27,25,2,33
Spart Moscow,9434,4,9,5,6,37,31,6,32
Terek Grozny,9434,5,8,6,6,21,22,-1,30
Krasnodar,9434,6,8,4,8,28,28,0,28
FK Rubin,9434,7,7,5,8,24,18,6,26
Rostov,9434,8,5,6,9,13,18,-5,21
Din Moscow,9434,9,5,6,9,19,25,-6,21
Amkar,9434,10,5,5,10,11,23,-12,20
Anzhi,9434,11,3,5,12,18,40,-22,14
Loko Moscow,9435,1,12,5,3,33,12,21,41
CSKA Moscow,9435,2,11,3,6,26,19,7,36
Zenit,9435,3,9,8,3,24,13,11,35
Spart Moscow,9435,4,9,5,6,36,31,5,32
Terek Grozny,9435,5,8,6,6,21,22,-1,30
Krasnodar,9435,6,8,5,7,28,29,-1,29
FK Rubin,9435,7,6,6,8,27,19,8,24
Rostov,9435,8,5,6,9,13,17,-4,21
Din Moscow,9435,9,5,6,9,19,28,-9,21
Amkar,9435,10,5,5,10,11,23,-12,20
Anzhi,9435,11,2,5,13,14,39,-25,11
Loko Moscow,9436,1,13,5,2,34,12,22,44
CSKA Moscow,9436,2,12,3,5,29,17,12,39
Krasnodar,9436,3,9,4,7,30,27,3,31
Spart Moscow,9436,4,8,6,6,36,31,5,30
Zenit,9436,5,7,8,5,22,18,4,29
Din Moscow,9436,6,7,6,7,20,22,-2,27
Terek Grozny,9436,7,7,6,7,21,24,-3,27
Amkar,9436,8,6,4,10,13,23,-10,22
FK Rubin,9436,9,5,5,10,22,21,1,20
Rostov,9436,10,4,7,9,12,19,-7,19
Anzhi,9436,11,2,6,12,14,39,-25,12
Loko Moscow,9437,1,12,5,3,31,12,19,41
CSKA Moscow,9437,2,11,4,5,29,17,12,37
Spart Moscow,9437,3,9,6,5,41,30,11,33
Krasnodar,9437,4,9,5,6,28,24,4,32
Zenit,9437,5,7,9,4,21,15,6,30
Terek Grozny,9437,6,8,5,7,21,23,-2,29
FK Rubin,9437,7,5,7,8,21,17,4,22
Din Moscow,9437,8,5,7,8,18,26,-8,22
Rostov,9437,9,4,7,9,13,20,-7,19
Amkar,9437,10,5,4,11,10,23,-13,19
Anzhi,9437,11,3,5,12,15,41,-26,14
Loko Moscow,9438,1,13,5,2,33,12,21,44
CSKA Moscow,9438,2,10,5,5,27,19,8,35
Spart Moscow,9438,3,9,6,5,37,27,10,33
Krasnodar,9438,4,9,4,7,30,27,3,31
Zenit,9438,5,7,9,4,22,16,6,30
Din Moscow,9438,6,7,6,7,20,21,-1,27
Terek Grozny,9438,7,7,6,7,23,26,-3,27
FK Rubin,9438,8,5,5,10,22,21,1,20
Amkar,9438,9,5,5,10,11,23,-12,20
Rostov,9438,10,4,6,10,11,21,-10,18
Anzhi,9438,11,2,7,11,17,40,-23,13
Loko Moscow,9439,1,12,6,2,32,12,20,42
CSKA Moscow,9439,2,11,3,6,27,21,6,36
Zenit,9439,3,8,8,4,24,15,9,32
Spart Moscow,9439,4,9,5,6,38,35,3,32
Krasnodar,9439,5,8,5,7,28,26,2,29
Terek Grozny,9439,6,8,5,7,23,23,0,29
FK Rubin,9439,7,7,5,8,24,18,6,26
Amkar,9439,8,6,4,10,15,25,-10,22
Rostov,9439,9,5,6,9,15,17,-2,21
Din Moscow,9439,10,5,6,9,18,25,-7,21
Anzhi,9439,11,2,5,13,15,42,-27,11
Loko Moscow,9440,1,11,6,3,31,15,16,39
CSKA Moscow,9440,2,12,3,5,29,18,11,39
Spart Moscow,9440,3,10,5,5,39,28,11,35
Zenit,9440,4,8,8,4,24,15,9,32
Terek Grozny,9440,5,9,5,6,23,22,1,32
Krasnodar,9440,6,8,5,7,29,28,1,29
FK Rubin,9440,7,7,5,8,24,17,7,26
Din Moscow,9440,8,5,6,9,17,24,-7,21
Amkar,9440,9,5,4,11,11,23,-12,19
Rostov,9440,10,4,6,10,11,21,-10,18
Anzhi,9440,11,2,5,13,14,41,-27,11
Loko Moscow,9441,1,11,6,3,29,13,16,39
CSKA Moscow,9441,2,11,3,6,28,20,8,36
Spart Moscow,9441,3,10,5,5,37,27,10,35
Krasnodar,9441,4,10,4,6,31,24,7,34
Zenit,9441,5,8,9,3,24,13,11,33
Terek Grozny,9441,6,8,5,7,24,25,-1,29
Din Moscow,9441,7,5,7,8,18,24,-6,22
FK Rubin,9441,8,5,6,9,22,20,2,21
Amkar,9441,9,5,4,11,11,24,-13,19
Rostov,9441,10,4,6,10,10,19,-9,18
Anzhi,9441,11,3,5,12,17,42,-25,14
Loko Moscow,9442,1,12,6,2,32,12,20,42
Spart Moscow,9442,2,11,5,4,40,25,15,38
Zenit,9442,3,8,9,3,22,13,9,33
CSKA Moscow,9442,4,10,3,7,25,19,6,33
Krasnodar,9442,5,8,4,8,30,30,0,28
Terek Grozny,9442,6,7,7,6,20,22,-2,28
FK Rubin,9442,7,6,6,8,28,23,5,24
Din Moscow,9442,8,5,7,8,21,27,-6,22
Rostov,9442,9,4,6,10,10,18,-8,18
Amkar,9442,10,4,5,11,9,26,-17,17
Anzhi,9442,11,3,6,11,15,37,-22,15
Loko Moscow,9443,1,12,6,2,32,13,19,42
CSKA Moscow,9443,2,10,4,6,26,19,7,34
Zenit,9443,3,8,8,4,23,15,8,32
Spart Moscow,9443,4,9,5,6,36,31,5,32
Krasnodar,9443,5,8,6,6,29,26,3,30
Terek Grozny,9443,6,8,5,7,21,24,-3,29
FK Rubin,9443,7,5,7,8,23,19,4,22
Din Moscow,9443,8,5,7,8,19,24,-5,22
Rostov,9443,9,5,6,9,12,17,-5,21
Amkar,9443,10,5,4,11,12,24,-12,19
Anzhi,9443,11,3,6,11,17,38,-21,15
Loko Moscow,9444,1,12,6,2,31,11,20,42
CSKA Moscow,9444,2,12,3,5,31,19,12,39
Spart Moscow,9444,3,10,5,5,37,27,10,35
Terek Grozny,9444,4,8,6,6,22,23,-1,30
Zenit,9444,5,7,8,5,21,17,4,29
Krasnodar,9444,6,8,5,7,27,26,1,29
FK Rubin,9444,7,6,6,8,24,18,6,24
Din Moscow,9444,8,5,7,8,19,25,-6,22
Amkar,9444,9,5,4,11,11,24,-13,19
Rostov,9444,10,4,6,10,10,18,-8,18
Anzhi,9444,11,2,6,12,16,41,-25,12
Loko Moscow,9445,1,12,5,3,33,15,18,41
CSKA Moscow,9445,2,12,3,5,29,19,10,39
Spart Moscow,9445,3,10,5,5,38,28,10,35
Zenit,9445,4,8,8,4,23,15,8,32
Terek Grozny,9445,5,8,5,7,21,24,-3,29
Krasnodar,9445,6,8,4,8,30,29,1,28
FK Rubin,9445,7,6,6,8,23,18,5,24
Din Moscow,9445,8,5,7,8,18,23,-5,22
Amkar,9445,9,6,4,10,13,23,-10,22
Rostov,9445,10,4,6,10,10,19,-9,18
Anzhi,9445,11,2,5,13,16,41,-25,11
Loko Moscow,9446,1,12,5,3,33,14,19,41
Spart Moscow,9446,2,11,5,4,43,29,14,38
CSKA Moscow,9446,3,11,4,5,28,19,9,37
Krasnodar,9446,4,9,4,7,30,26,4,31
Zenit,9446,5,7,9,4,23,18,5,30
Terek Grozny,9446,6,7,6,7,21,24,-3,27
FK Rubin,9446,7,7,5,8,27,21,6,26
Din Moscow,9446,8,5,6,9,22,30,-8,21
Amkar,9446,9,5,4,11,12,25,-13,19
Rostov,9446,10,4,6,10,10,19,-9,18
Anzhi,9446,11,2,6,12,16,40,-24,12
Loko Moscow,9447,1,13,5,2,31,11,20,44
Spart Moscow,9447,2,9,7,4,39,29,10,34
CSKA Moscow,9447,3,10,3,7,28,22,6,33
Zenit,9447,4,8,8,4,24,16,8,32
Krasnodar,9447,5,8,5,7,28,26,2,29
Terek Grozny,9447,6,8,5,7,21,25,-4,29
FK Rubin,9447,7,6,6,8,23,18,5,24
Din Moscow,9447,8,5,7,8,20,25,-5,22
Rostov,9447,9,4,6,10,10,19,-9,18
Amkar,9447,10,4,5,11,10,24,-14,17
Anzhi,9447,11,4,5,11,19,38,-19,17
Loko Moscow,9448,1,13,5,2,32,12,20,44
CSKA Moscow,9448,2,11,3,6,28,19,9,36
Spart Moscow,9448,3,8,8,4,38,30,8,32
Zenit,9448,4,8,8,4,22,14,8,32
Krasnodar,9448,5,9,4,7,29,26,3,31
Terek Grozny,9448,6,7,6,7,21,24,-3,27
Din Moscow,9448,7,5,8,7,18,22,-4,23
FK Rubin,9448,8,5,6,9,21,18,3,21
Rostov,9448,9,4,7,9,12,19,-7,19
Amkar,9448,10,4,6,10,11,24,-13,18
Anzhi,9448,11,3,5,12,17,41,-24,14
Loko Moscow,9449,1,12,5,3,32,14,18,41
CSKA Moscow,9449,2,10,5,5,27,19,8,35
Krasnodar,9449,3,9,5,6,31,27,4,32
Zenit,9449,4,7,9,4,23,16,7,30
Spart Moscow,9449,5,8,6,6,35,31,4,30
Terek Grozny,9449,6,7,7,6,22,24,-2,28
FK Rubin,9449,7,6,6,8,25,19,6,24
Din Moscow,9449,8,6,6,8,21,24,-3,24
Rostov,9449,9,5,6,9,11,17,-6,21
Amkar,9449,10,4,6,10,10,23,-13,18
Anzhi,9449,11,2,7,11,17,40,-23,13
Loko Moscow,9450,1,12,6,2,32,13,19,42
CSKA Moscow,9450,2,11,3,6,27,19,8,36
Zenit,9450,3,8,9,3,23,14,9,33
Spart Moscow,9450,4,9,5,6,35,27,8,32
Krasnodar,9450,5,9,4,7,30,26,4,31
Terek Grozny,9450,6,8,5,7,22,25,-3,29
Din Moscow,9450,7,6,6,8,18,23,-5,24
Amkar,9450,8,6,4,10,12,22,-10,22
Rostov,9450,9,5,6,9,11,17,-6,21
FK Rubin,9450,10,5,5,10,21,20,1,20
Anzhi,9450,11,2,5,13,16,41,-25,11
Loko Moscow,9451,1,12,5,3,34,15,19,41
CSKA Moscow,9451,2,12,3,5,29,17,12,39
Spart Moscow,9451,3,9,6,5,38,29,9,33
Krasnodar,9451,4,9,4,7,30,27,3,31
Terek Grozny,9451,5,8,6,6,24,25,-1,30
Zenit,9451,6,7,8,5,22,19,3,29
FK Rubin,9451,7,6,6,8,23,17,6,24
Din Moscow,9451,8,5,7,8,17,23,-6,22
Amkar,9451,9,5,5,10,13,25,-12,20
Rostov,9451,10,4,7,9,11,18,-7,19
Anzhi,9451,11,2,5,13,16,42,-26,11
Loko Moscow,9452,1,12,6,2,32,13,19,42
CSKA Moscow,9452,2,11,3,6,29,22,7,36
Zenit,9452,3,8,9,3,25,15,10,33
Spart Moscow,9452,4,9,6,5,37,28,9,33
Terek Grozny,9452,5,8,5,7,24,25,-1,29
Krasnodar,9452,6,8,4,8,29,28,1,28
FK Rubin,9452,7,7,5,8,25,18,7,26
Din Moscow,9452,8,5,6,9,18,26,-8,21
Rostov,9452,9,4,7,9,10,17,-7,19
Amkar,9452,10,5,4,11,11,25,-14,19
Anzhi,9452,11,3,5,12,19,42,-23,14
Loko Moscow,9453,1,11,7,2,30,12,18,40
Spart Moscow,9453,2,11,5,4,42,27,15,38
CSKA Moscow,9453,3,10,4,6,25,18,7,34
Zenit,9453,4,8,9,3,23,14,9,33
Krasnodar,9453,5,8,5,7,28,26,2,29
FK Rubin,9453,6,7,5,8,25,18,7,26
Terek Grozny,9453,7,7,5,8,21,26,-5,26
Din Moscow,9453,8,5,6,9,18,28,-10,21
Amkar,9453,9,5,4,11,13,25,-12,19
Rostov,9453,10,4,6,10,10,19,-9,18
Anzhi,9453,11,3,6,11,15,37,-22,15
Loko Moscow,9454,1,11,7,2,32,14,18,40
Spart Moscow,9454,2,11,5,4,40,26,14,38
CSKA Moscow,9454,3,10,4,6,25,20,5,34
Zenit,9454,4,8,9,3,25,14,11,33
Krasnodar,9454,5,9,5,6,31,27,4,32
Terek Grozny,9454,6,8,6,6,22,23,-1,30
Din Moscow,9454,7,6,6,8,18,23,-5,24
FK Rubin,9454,8,5,5,10,22,20,2,20
Rostov,9454,9,4,6,10,10,19,-9,18
Amkar,9454,10,4,4,12,10,26,-16,16
Anzhi,9454,11,2,7,11,15,38,-23,13
Loko Moscow,9455,1,11,5,4,29,14,15,38
CSKA Moscow,9455,2,11,3,6,27,19,8,36
Zenit,9455,3,9,8,3,23,13,10,35
Spart Moscow,9455,4,9,6,5,36,27,9,33
Krasnodar,9455,5,9,4,7,29,25,4,31
FK Rubin,9455,6,7,5,8,24,18,6,26
Terek Grozny,9455,7,7,5,8,21,26,-5,26
Rostov,9455,8,5,6,9,12,18,-6,21
Din Moscow,9455,9,5,6,9,18,25,-7,21
Amkar,9455,10,5,5,10,11,22,-11,20
Anzhi,9455,11,3,5,12,17,40,-23,14
Loko Moscow,9456,1,12,5,3,32,15,17,41
Spart Moscow,9456,2,10,6,4,40,28,12,36
CSKA Moscow,9456,3,10,5,5,25,17,8,35
Zenit,9456,4,8,9,3,24,13,11,33
Krasnodar,9456,5,9,4,7,29,27,2,31
Terek Grozny,9456,6,8,5,7,25,26,-1,29
FK Rubin,9456,7,6,5,9,24,19,5,23
Din Moscow,9456,8,5,6,9,20,28,-8,21
Rostov,9456,9,4,7,9,11,18,-7,19
Amkar,9456,10,4,4,12,9,27,-18,16
Anzhi,9456,11,3,6,11,18,39,-21,15
CSKA Moscow,9457,1,12,3,5,29,17,12,39
Loko Moscow,9457,2,11,5,4,29,14,15,38
Spart Moscow,9457,3,9,7,4,36,27,9,34
Krasnodar,9457,4,10,4,6,30,24,6,34
Zenit,9457,5,8,8,4,22,15,7,32
Terek Grozny,9457,6,7,5,8,21,26,-5,26
FK Rubin,9457,7,6,5,9,23,19,4,23
Din Moscow,9457,8,5,7,8,19,24,-5,22
Rostov,9457,9,4,7,9,11,18,-7,19
Amkar,9457,10,5,4,11,11,23,-12,19
Anzhi,9457,11,3,5,12,16,40,-24,14
Loko Moscow,9458,1,12,6,2,31,12,19,42
Spart Moscow,9458,2,10,5,5,37,27,10,35
CSKA Moscow,9458,3,10,5,5,25,17,8,35
Zenit,9458,4,7,10,3,22,14,8,31
Krasnodar,9458,5,9,4,7,28,25,3,31
Terek Grozny,9458,6,8,5,7,23,23,0,29
FK Rubin,9458,7,6,5,9,22,18,4,23
Rostov,9458,8,5,6,9,11,17,-6,21
Din Moscow,9458,9,5,6,9,17,24,-7,21
Amkar,9458,10,4,4,12,10,27,-17,16
Anzhi,9458,11,3,6,11,15,37,-22,15
Loko Moscow,9459,1,12,6,2,31,12,19,42
CSKA Moscow,9459,2,10,5,5,27,19,8,35
Spart Moscow,9459,3,9,6,5,38,29,9,33
Zenit,9459,4,7,10,3,23,15,8,31
Terek Grozny,9459,5,8,5,7,21,23,-2,29
Krasnodar,9459,6,8,4,8,28,27,1,28
Din Moscow,9459,7,6,6,8,20,25,-5,24
FK Rubin,9459,8,6,5,9,24,20,4,23
Rostov,9459,9,5,6,9,12,18,-6,21
Amkar,9459,10,4,5,11,10,24,-14,17
Anzhi,9459,11,3,6,11,16,38,-22,15
Loko Moscow,9460,1,12,5,3,31,13,18,41
CSKA Moscow,9460,2,11,4,5,28,18,10,37
Zenit,9460,3,8,9,3,23,14,9,33
Spart Moscow,9460,4,9,6,5,39,31,8,33
Krasnodar,9460,5,9,4,7,28,25,3,31
Terek Grozny,9460,6,7,5,8,21,27,-6,26
Din Moscow,9460,7,5,8,7,21,25,-4,23
FK Rubin,9460,8,5,6,9,22,19,3,21
Rostov,9460,9,5,6,9,13,19,-6,21
Amkar,9460,10,5,4,11,11,23,-12,19
Anzhi,9460,11,3,5,12,18,41,-23,14
Loko Moscow,9461,1,12,6,2,31,12,19,42
Spart Moscow,9461,2,10,5,5,38,28,10,35
CSKA Moscow,9461,3,10,4,6,27,20,7,34
Zenit,9461,4,7,10,3,22,14,8,31
Krasnodar,9461,5,9,4,7,29,26,3,31
Terek Grozny,9461,6,7,6,7,23,26,-3,27
Din Moscow,9461,7,6,6,8,20,24,-4,24
FK Rubin,9461,8,5,5,10,23,21,2,20
Amkar,9461,9,5,5,10,13,25,-12,20
Rostov,9461,10,4,6,10,10,19,-9,18
Anzhi,9461,11,4,5,11,19,40,-21,17
Loko Moscow,9462,1,11,6,3,30,14,16,39
CSKA Moscow,9462,2,11,4,5,30,21,9,37
Spart Moscow,9462,3,10,6,4,37,25,12,36
Krasnodar,9462,4,10,4,6,31,24,7,34
Zenit,9462,5,7,10,3,25,17,8,31
Terek Grozny,9462,6,8,5,7,22,24,-2,29
FK Rubin,9462,7,6,5,9,23,19,4,23
Din Moscow,9462,8,5,6,9,17,25,-8,21
Rostov,9462,9,4,7,9,10,17,-7,19
Amkar,9462,10,4,4,12,10,26,-16,16
Anzhi,9462,11,3,5,12,16,39,-23,14
Loko Moscow,9463,1,12,5,3,32,13,19,41
Spart Moscow,9463,2,11,5,4,43,27,16,38
Krasnodar,9463,3,10,4,6,32,25,7,34
CSKA Moscow,9463,4,10,4,6,27,22,5,34
Zenit,9463,5,8,8,4,25,17,8,32
Terek Grozny,9463,6,8,6,6,22,22,0,30
Din Moscow,9463,7,6,6,8,20,27,-7,24
FK Rubin,9463,8,5,5,10,22,23,-1,20
Rostov,9463,9,4,6,10,11,19,-8,18
Amkar,9463,10,4,5,11,10,24,-14,17
Anzhi,9463,11,2,6,12,15,40,-25,12
Loko Moscow,9464,1,12,5,3,34,17,17,41
CSKA Moscow,9464,2,11,3,6,28,19,9,36
Spart Moscow,9464,3,10,5,5,37,28,9,35
Zenit,9464,4,8,8,4,24,17,7,32
Krasnodar,9464,5,9,4,7,33,30,3,31
Terek Grozny,9464,6,8,5,7,21,24,-3,29
Din Moscow,9464,7,6,6,8,19,23,-4,24
FK Rubin,9464,8,6,5,9,25,20,5,23
Rostov,9464,9,5,6,9,13,18,-5,21
Amkar,9464,10,5,4,11,11,23,-12,19
Anzhi,9464,11,2,5,13,14,40,-26,11
Loko Moscow,9465,1,12,5,3,31,14,17,41
CSKA Moscow,9465,2,11,4,5,29,17,12,37
Krasnodar,9465,3,10,4,6,31,24,7,34
Spart Moscow,9465,4,9,6,5,37,29,8,33
Zenit,9465,5,7,9,4,22,15,7,30
Terek Grozny,9465,6,8,5,7,22,25,-3,29
Din Moscow,9465,7,7,6,7,21,23,-2,27
FK Rubin,9465,8,5,5,10,22,21,1,20
Amkar,9465,9,5,5,10,13,23,-10,20
Rostov,9465,10,4,6,10,11,19,-8,18
Anzhi,9465,11,2,5,13,14,43,-29,11
Loko Moscow,9466,1,13,5,2,33,12,21,44
Spart Moscow,9466,2,9,7,4,37,28,9,34
CSKA Moscow,9466,3,10,4,6,26,19,7,34
Zenit,9466,4,8,8,4,23,16,7,32
Krasnodar,9466,5,9,4,7,31,27,4,31
Terek Grozny,9466,6,8,6,6,29,24,5,30
Din Moscow,9466,7,6,7,7,19,22,-3,25
FK Rubin,9466,8,5,5,10,23,22,1,20
Rostov,9466,9,4,6,10,12,20,-8,18
Amkar,9466,10,4,5,11,10,30,-20,17
Anzhi,9466,11,2,7,11,16,39,-23,13
Loko Moscow,9467,1,12,6,2,32,13,19,42
Spart Moscow,9467,2,11,5,4,42,26,16,38
CSKA Moscow,9467,3,11,3,6,29,19,10,36
Zenit,9467,4,8,9,3,24,15,9,33
Terek Grozny,9467,5,9,5,6,22,22,0,32
Krasnodar,9467,6,8,4,8,28,27,1,28
FK Rubin,9467,7,6,6,8,22,17,5,24
Din Moscow,9467,8,5,7,8,17,22,-5,22
Rostov,9467,9,4,6,10,11,19,-8,18
Amkar,9467,10,4,4,12,9,29,-20,16
Anzhi,9467,11,2,5,13,14,41,-27,11
Loko Moscow,9468,1,11,5,4,30,14,16,38
CSKA Moscow,9468,2,11,3,6,27,20,7,36
Spart Moscow,9468,3,9,7,4,38,28,10,34
Krasnodar,9468,4,10,4,6,30,25,5,34
Zenit,9468,5,8,8,4,22,14,8,32
Terek Grozny,9468,6,9,5,6,22,22,0,32
FK Rubin,9468,7,6,5,9,23,18,5,23
Din Moscow,9468,8,5,6,9,18,26,-8,21
Rostov,9468,9,4,7,9,11,18,-7,19
Amkar,9468,10,4,5,11,10,24,-14,17
Anzhi,9468,11,3,5,12,17,39,-22,14
Loko Moscow,9469,1,11,6,3,30,13,17,39
Spart Moscow,9469,2,10,5,5,39,30,9,35
CSKA Moscow,9469,3,10,4,6,28,21,7,34
Zenit,9469,4,8,9,3,24,15,9,33
Krasnodar,9469,5,8,6,6,27,24,3,30
Terek Grozny,9469,6,8,6,6,22,22,0,30
FK Rubin,9469,7,6,6,8,23,17,6,24
Din Moscow,9469,8,6,6,8,19,24,-5,24
Rostov,9469,9,4,6,10,12,20,-8,18
Amkar,9469,10,4,5,11,10,24,-14,17
Anzhi,9469,11,3,5,12,17,41,-24,14
Loko Moscow,9470,1,11,6,3,29,12,17,39
CSKA Moscow,9470,2,12,3,5,30,17,13,39
Krasnodar,9470,3,10,4,6,31,24,7,34
Spart Moscow,9470,4,9,6,5,37,30,7,33
Terek Grozny,9470,5,9,5,6,22,22,0,32
Zenit,9470,6,7,9,4,21,14,7,30
Din Moscow,9470,7,6,6,8,20,23,-3,24
FK Rubin,9470,8,6,5,9,23,21,2,23
Rostov,9470,9,4,6,10,10,18,-8,18
Amkar,9470,10,4,5,11,12,26,-14,17
Anzhi,9470,11,2,5,13,14,42,-28,11
Loko Moscow,9471,1,12,5,3,32,15,17,41
CSKA Moscow,9471,2,11,4,5,27,18,9,37
Krasnodar,9471,3,10,4,6,31,25,6,34
Zenit,9471,4,7,9,4,23,16,7,30
Spart Moscow,9471,5,8,6,6,36,30,6,30
Din Moscow,9471,6,7,6,7,22,21,1,27
Terek Grozny,9471,7,7,6,7,22,25,-3,27
Amkar,9471,8,6,4,10,12,23,-11,22
FK Rubin,9471,9,5,5,10,21,22,-1,20
Rostov,9471,10,4,7,9,12,19,-7,19
Anzhi,9471,11,2,6,12,16,40,-24,12
Loko Moscow,9472,1,12,5,3,32,13,19,41
Spart Moscow,9472,2,10,5,5,40,29,11,35
Zenit,9472,3,9,8,3,24,14,10,35
CSKA Moscow,9472,4,10,4,6,27,20,7,34
Terek Grozny,9472,5,8,6,6,23,23,0,30
Krasnodar,9472,6,8,4,8,30,30,0,28
Din Moscow,9472,7,6,6,8,22,24,-2,24
FK Rubin,9472,8,6,5,9,25,23,2,23
Amkar,9472,9,5,5,10,13,24,-11,20
Rostov,9472,10,4,6,10,10,21,-11,18
Anzhi,9472,11,2,6,12,15,40,-25,12
Loko Moscow,9473,1,13,5,2,31,11,20,44
Spart Moscow,9473,2,11,5,4,43,28,15,38
CSKA Moscow,9473,3,11,3,6,28,20,8,36
Zenit,9473,4,8,8,4,24,15,9,32
Terek Grozny,9473,5,8,5,7,23,25,-2,29
Krasnodar,9473,6,8,4,8,29,28,1,28
FK Rubin,9473,7,7,5,8,26,19,7,26
Din Moscow,9473,8,5,6,9,18,27,-9,21
Amkar,9473,9,5,4,11,13,24,-11,19
Rostov,9473,10,4,6,10,11,21,-10,18
Anzhi,9473,11,2,5,13,14,42,-28,11
Loko Moscow,9474,1,11,5,4,30,17,13,38
Spart Moscow,9474,2,10,6,4,39,28,11,36
Zenit,9474,3,9,8,3,23,13,10,35
CSKA Moscow,9474,4,10,4,6,26,19,7,34
Krasnodar,9474,5,9,5,6,33,26,7,32
Terek Grozny,9474,6,8,5,7,22,24,-2,29
Din Moscow,9474,7,6,7,7,20,22,-2,25
FK Rubin,9474,8,5,6,9,22,20,2,21
Rostov,9474,9,4,6,10,11,19,-8,18
Amkar,9474,10,4,4,12,10,26,-16,16
Anzhi,9474,11,3,6,11,17,39,-22,15
Loko Moscow,9475,1,11,6,3,30,13,17,39
CSKA Moscow,9475,2,12,3,5,28,18,10,39
Terek Grozny,9475,3,9,5,6,24,24,0,32
Krasnodar,9475,4,9,4,7,29,26,3,31
Zenit,9475,5,7,9,4,21,14,7,30
Spart Moscow,9475,6,8,6,6,34,29,5,30
Din Moscow,9475,7,6,7,7,19,21,-2,25
FK Rubin,9475,8,6,6,8,22,17,5,24
Rostov,9475,9,4,7,9,11,18,-7,19
Amkar,9475,10,5,4,11,10,23,-13,19
Anzhi,9475,11,2,5,13,17,42,-25,11
Loko Moscow,9476,1,11,6,3,31,14,17,39
Zenit,9476,2,9,8,3,28,16,12,35
Spart Moscow,9476,3,9,6,5,35,27,8,33
CSKA Moscow,9476,4,10,3,7,29,25,4,33
Terek Grozny,9476,5,8,6,6,25,24,1,30
Krasnodar,9476,6,8,5,7,28,26,2,29
Din Moscow,9476,7,6,6,8,21,22,-1,24
FK Rubin,9476,8,6,5,9,22,21,1,23
Rostov,9476,9,5,6,9,12,18,-6,21
Amkar,9476,10,4,6,10,10,23,-13,18
Anzhi,9476,11,3,5,12,18,43,-25,14
Loko Moscow,9477,1,11,6,3,30,15,15,39
CSKA Moscow,9477,2,11,4,5,27,17,10,37
Spart Moscow,9477,3,10,5,5,37,28,9,35
Zenit,9477,4,8,9,3,24,13,11,33
Terek Grozny,9477,5,9,5,6,25,24,1,32
Krasnodar,9477,6,8,6,6,29,26,3,30
FK Rubin,9477,7,5,7,8,23,19,4,22
Din Moscow,9477,8,5,7,8,19,24,-5,22
Amkar,9477,9,5,4,11,10,24,-14,19
Rostov,9477,10,4,6,10,11,19,-8,18
Anzhi,9477,11,2,5,13,16,42,-26,11
Loko Moscow,9478,1,12,6,2,32,13,19,42
CSKA Moscow,9478,2,11,3,6,26,20,6,36
Spart Moscow,9478,3,9,6,5,36,28,8,33
Zenit,9478,4,8,8,4,25,15,10,32
Krasnodar,9478,5,9,5,6,32,26,6,32
Terek Grozny,9478,6,8,5,7,25,25,0,29
Din Moscow,9478,7,5,7,8,19,24,-5,22
FK Rubin,9478,8,5,6,9,23,22,1,21
Rostov,9478,9,5,6,9,11,17,-6,21
Amkar,9478,10,5,5,10,13,25,-12,20
Anzhi,9478,11,2,5,13,14,41,-27,11
Loko Moscow,9479,1,12,5,3,31,13,18,41
CSKA Moscow,9479,2,11,3,6,27,18,9,36
Zenit,9479,3,8,8,4,23,16,7,32
Spart Moscow,9479,4,9,5,6,35,29,6,32
Krasnodar,9479,5,8,5,7,29,27,2,29
Terek Grozny,9479,6,8,5,7,22,23,-1,29
FK Rubin,9479,7,6,6,8,28,19,9,24
Din Moscow,9479,8,6,6,8,19,26,-7,24
Amkar,9479,9,6,4,10,12,23,-11,22
Rostov,9479,10,4,6,10,10,18,-8,18
Anzhi,9479,11,3,5,12,15,39,-24,14
Loko Moscow,9480,1,12,5,3,32,14,18,41
CSKA Moscow,9480,2,12,3,5,32,18,14,39
Krasnodar,9480,3,10,4,6,32,27,5,34
Spart Moscow,9480,4,9,5,6,37,27,10,32
Zenit,9480,5,7,8,5,22,16,6,29
Terek Grozny,9480,6,8,5,7,22,24,-2,29
Din Moscow,9480,7,6,6,8,18,22,-4,24
FK Rubin,9480,8,6,5,9,23,19,4,23
Amkar,9480,9,5,4,11,10,23,-13,19
Rostov,9480,10,4,6,10,10,21,-11,18
Anzhi,9480,11,3,5,12,16,43,-27,14
Loko Moscow,9481,1,13,5,2,34,14,20,44
CSKA Moscow,9481,2,11,3,6,29,22,7,36
Spart Moscow,9481,3,10,5,5,40,30,10,35
Zenit,9481,4,8,8,4,27,18,9,32
Terek Grozny,9481,5,9,5,6,24,22,2,32
Krasnodar,9481,6,8,5,7,29,27,2,29
FK Rubin,9481,7,6,6,8,25,18,7,24
Din Moscow,9481,8,5,6,9,17,26,-9,21
Amkar,9481,9,5,4,11,11,24,-13,19
Rostov,9481,10,4,6,10,13,21,-8,18
Anzhi,9481,11,2,5,13,15,42,-27,11
Loko Moscow,9482,1,11,6,3,30,15,15,39
CSKA Moscow,9482,2,12,3,5,30,17,13,39
Spart Moscow,9482,3,9,6,5,37,31,6,33
Zenit,9482,4,8,8,4,24,14,10,32
Krasnodar,9482,5,8,6,6,28,25,3,30
Terek Grozny,9482,6,8,5,7,22,24,-2,29
FK Rubin,9482,7,6,6,8,22,17,5,24
Din Moscow,9482,8,5,6,9,17,23,-6,21
Rostov,9482,9,4,7,9,11,18,-7,19
Amkar,9482,10,5,4,11,14,25,-11,19
Anzhi,9482,11,3,5,12,16,42,-26,14
Loko Moscow,9483,1,12,6,2,33,14,19,42
Spart Moscow,9483,2,10,6,4,38,26,12,36
CSKA Moscow,9483,3,10,3,7,25,23,2,33
Zenit,9483,4,8,8,4,27,16,11,32
Krasnodar,9483,5,8,5,7,30,28,2,29
Terek Grozny,9483,6,8,5,7,24,25,-1,29
FK Rubin,9483,7,7,5,8,25,19,6,26
Din Moscow,9483,8,5,6,9,17,24,-7,21
Amkar,9483,9,5,5,10,12,24,-12,20
Rostov,9483,10,4,6,10,10,19,-9,18
Anzhi,9483,11,3,5,12,17,40,-23,14
Loko Moscow,9484,1,11,6,3,32,16,16,39
Spart Moscow,9484,2,9,7,4,37,28,9,34
CSKA Moscow,9484,3,10,4,6,29,22,7,34
Zenit,9484,4,8,9,3,25,16,9,33
Krasnodar,9484,5,9,4,7,30,26,4,31
Terek Grozny,9484,6,7,6,7,21,24,-3,27
FK Rubin,9484,7,6,6,8,22,17,5,24
Din Moscow,9484,8,5,7,8,18,23,-5,22
Rostov,9484,9,4,7,9,11,18,-7,19
Amkar,9484,10,4,6,10,11,24,-13,18
Anzhi,9484,11,3,6,11,18,40,-22,15
Loko Moscow,9485,1,13,5,2,32,11,21,44
CSKA Moscow,9485,2,11,3,6,30,20,10,36
Spart Moscow,9485,3,9,5,6,36,29,7,32
Zenit,9485,4,8,8,4,23,16,7,32
Krasnodar,9485,5,8,4,8,28,28,0,28
FK Rubin,9485,6,7,5,8,25,18,7,26
Terek Grozny,9485,7,7,5,8,21,27,-6,26
Din Moscow,9485,8,6,6,8,19,22,-3,24
Rostov,9485,9,5,6,9,12,18,-6,21
Amkar,9485,10,5,4,11,12,25,-13,19
Anzhi,9485,11,3,5,12,17,41,-24,14
Loko Moscow,9486,1,11,7,2,30,12,18,40
CSKA Moscow,9486,2,11,3,6,28,18,10,36
Spart Moscow,9486,3,10,5,5,40,27,13,35
Zenit,9486,4,8,9,3,22,13,9,33
Krasnodar,9486,5,9,5,6,30,25,5,32
Terek Grozny,9486,6,8,6,6,23,22,1,30
Din Moscow,9486,7,6,6,8,19,26,-7,24
Rostov,9486,8,5,6,9,11,17,-6,21
FK Rubin,9486,9,5,5,10,21,20,1,20
Amkar,9486,10,4,5,11,9,24,-15,17
Anzhi,9486,11,2,5,13,14,43,-29,11
Loko Moscow,9487,1,11,6,3,31,14,17,39
CSKA Moscow,9487,2,11,3,6,27,19,8,36
Spart Moscow,9487,3,10,5,5,41,27,14,35
Zenit,9487,4,9,8,3,25,15,10,35
Terek Grozny,9487,5,8,6,6,23,24,-1,30
Krasnodar,9487,6,8,5,7,28,26,2,29
FK Rubin,9487,7,7,5,8,24,18,6,26
Din Moscow,9487,8,5,6,9,18,28,-10,21
Amkar,9487,9,5,4,11,11,24,-13,19
Rostov,9487,10,4,6,10,10,19,-9,18
Anzhi,9487,11,2,6,12,16,40,-24,12
Loko Moscow,9488,1,11,6,3,30,14,16,39
Spart Moscow,9488,2,10,6,4,37,26,11,36
CSKA Moscow,9488,3,11,3,6,28,22,6,36
Zenit,9488,4,8,9,3,25,14,11,33
Krasnodar,9488,5,9,5,6,30,25,5,32
Terek Grozny,9488,6,8,5,7,26,27,-1,29
Din Moscow,9488,7,5,8,7,18,22,-4,23
FK Rubin,9488,8,5,7,8,22,18,4,22
Rostov,9488,9,4,6,10,10,19,-9,18
Amkar,9488,10,4,4,12,10,26,-16,16
Anzhi,9488,11,3,5,12,20,43,-23,14
Loko Moscow,9489,1,12,6,2,33,13,20,42
CSKA Moscow,9489,2,11,3,6,27,18,9,36
Spart Moscow,9489,3,10,5,5,38,28,10,35
Zenit,9489,4,8,9,3,23,14,9,33
Terek Grozny,9489,5,8,5,7,23,25,-2,29
Krasnodar,9489,6,8,4,8,28,28,0,28
FK Rubin,9489,7,7,5,8,25,19,6,26
Din Moscow,9489,8,6,6,8,21,25,-4,24
Rostov,9489,9,4,6,10,11,20,-9,18
Amkar,9489,10,4,4,12,11,26,-15,16
Anzhi,9489,11,3,5,12,15,39,-24,14
Loko Moscow,9490,1,13,5,2,33,11,22,44
CSKA Moscow,9490,2,11,3,6,26,19,7,36
Spart Moscow,9490,3,10,5,5,41,31,10,35
Zenit,9490,4,8,8,4,23,15,8,32
Terek Grozny,9490,5,9,5,6,23,22,1,32
Krasnodar,9490,6,9,4,7,29,26,3,31
FK Rubin,9490,7,6,5,9,22,19,3,23
Din Moscow,9490,8,5,6,9,18,26,-8,21
Amkar,9490,9,5,4,11,12,24,-12,19
Rostov,9490,10,4,6,10,12,21,-9,18
Anzhi,9490,11,2,5,13,14,39,-25,11
Loko Moscow,9491,1,12,5,3,33,15,18,41
CSKA Moscow,9491,2,11,3,6,29,20,9,36
Zenit,9491,3,9,8,3,26,14,12,35
Spart Moscow,9491,4,9,6,5,38,28,10,33
Krasnodar,9491,5,8,5,7,28,27,1,29
Terek Grozny,9491,6,8,5,7,24,25,-1,29
FK Rubin,9491,7,6,6,8,22,17,5,24
Din Moscow,9491,8,6,6,8,18,22,-4,24
Rostov,9491,9,4,7,9,11,18,-7,19
Amkar,9491,10,5,4,11,12,27,-15,19
Anzhi,9491,11,2,5,13,16,44,-28,11
Loko Moscow,9492,1,13,5,2,33,12,21,44
CSKA Moscow,9492,2,11,4,5,29,20,9,37
Spart Moscow,9492,3,9,6,5,38,30,8,33
Zenit,9492,4,7,9,4,23,16,7,30
Terek Grozny,9492,5,8,5,7,21,24,-3,29
Krasnodar,9492,6,8,4,8,28,28,0,28
FK Rubin,9492,7,7,5,8,25,19,6,26
Din Moscow,9492,8,6,6,8,21,25,-4,24
Amkar,9492,9,5,5,10,13,24,-11,20
Rostov,9492,10,4,6,10,10,18,-8,18
Anzhi,9492,11,2,5,13,16,41,-25,11
Loko Moscow,9493,1,11,7,2,31,13,18,40
CSKA Moscow,9493,2,11,3,6,27,19,8,36
Spart Moscow,9493,3,10,5,5,37,27,10,35
Zenit,9493,4,8,9,3,23,14,9,33
Terek Grozny,9493,5,9,5,6,25,24,1,32
Krasnodar,9493,6,8,5,7,29,28,1,29
FK Rubin,9493,7,7,5,8,27,20,7,26
Din Moscow,9493,8,5,6,9,19,25,-6,21
Amkar,9493,9,5,4,11,12,25,-13,19
Rostov,9493,10,4,6,10,10,19,-9,18
Anzhi,9493,11,2,5,13,16,42,-26,11
Loko Moscow,9494,1,12,6,2,33,12,21,42
CSKA Moscow,9494,2,10,4,6,27,20,7,34
Spart Moscow,9494,3,9,5,6,38,32,6,32
Zenit,9494,4,7,9,4,22,17,5,30
Krasnodar,9494,5,8,5,7,29,27,2,29
Terek Grozny,9494,6,8,5,7,24,26,-2,29
Din Moscow,9494,7,6,7,7,22,24,-2,25
FK Rubin,9494,8,6,6,8,25,20,5,24
Rostov,9494,9,5,6,9,13,18,-5,21
Amkar,9494,10,5,4,11,12,26,-14,19
Anzhi,9494,11,3,5,12,18,41,-23,14
Loko Moscow,9495,1,12,5,3,30,12,18,41
CSKA Moscow,9495,2,11,4,5,31,19,12,37
Spart Moscow,9495,3,10,5,5,39,29,10,35
Krasnodar,9495,4,10,4,6,30,24,6,34
Zenit,9495,5,7,9,4,22,15,7,30
Terek Grozny,9495,6,7,6,7,21,25,-4,27
Din Moscow,9495,7,5,7,8,19,24,-5,22
FK Rubin,9495,8,5,6,9,22,20,2,21
Amkar,9495,9,5,5,10,13,25,-12,20
Rostov,9495,10,4,6,10,10,19,-9,18
Anzhi,9495,11,3,5,12,17,42,-25,14
Loko Moscow,9496,1,12,6,2,32,11,21,42
CSKA Moscow,9496,2,10,4,6,26,20,6,34
Spart Moscow,9496,3,9,6,5,34,27,7,33
Zenit,9496,4,8,8,4,24,17,7,32
Krasnodar,9496,5,8,5,7,27,25,2,29
Terek Grozny,9496,6,7,5,8,21,25,-4,26
FK Rubin,9496,7,6,6,8,22,17,5,24
Din Moscow,9496,8,5,8,7,17,21,-4,23
Amkar,9496,9,6,4,10,12,22,-10,22
Rostov,9496,10,4,6,10,10,18,-8,18
Anzhi,9496,11,3,6,11,16,38,-22,15
Loko Moscow,9497,1,12,5,3,31,13,18,41
CSKA Moscow,9497,2,12,3,5,30,18,12,39
Spart Moscow,9497,3,11,5,4,39,27,12,38
Krasnodar,9497,4,10,4,6,31,25,6,34
Zenit,9497,5,7,8,5,21,17,4,29
Terek Grozny,9497,6,7,6,7,21,24,-3,27
Din Moscow,9497,7,5,7,8,20,25,-5,22
FK Rubin,9497,8,5,6,9,23,20,3,21
Amkar,9497,9,5,4,11,11,24,-13,19
Rostov,9497,10,4,6,10,10,19,-9,18
Anzhi,9497,11,2,6,12,15,40,-25,12
Loko Moscow,9498,1,12,6,2,33,13,20,42
Spart Moscow,9498,2,10,6,4,36,26,10,36
CSKA Moscow,9498,3,11,3,6,28,21,7,36
Zenit,9498,4,8,9,3,25,14,11,33
Krasnodar,9498,5,9,4,7,31,28,3,31
Terek Grozny,9498,6,7,5,8,20,24,-4,26
Din Moscow,9498,7,5,8,7,17,21,-4,23
FK Rubin,9498,8,5,6,9,22,20,2,21
Amkar,9498,9,5,4,11,11,24,-13,19
Rostov,9498,10,4,6,10,10,18,-8,18
Anzhi,9498,11,3,5,12,16,40,-24,14
Loko Moscow,9499,1,12,5,3,32,14,18,41
CSKA Moscow,9499,2,10,4,6,26,19,7,34
Zenit,9499,3,8,8,4,22,15,7,32
Spart Moscow,9499,4,8,7,5,36,30,6,31
Krasnodar,9499,5,9,4,7,31,27,4,31
Terek Grozny,9499,6,8,5,7,25,24,1,29
Din Moscow,9499,7,6,7,7,20,23,-3,25
FK Rubin,9499,8,6,5,9,24,20,4,23
Rostov,9499,9,4,7,9,11,18,-7,19
Amkar,9499,10,5,4,11,13,28,-15,19
Anzhi,9499,11,3,6,11,16,38,-22,15
Loko Moscow,9500,1,11,6,3,29,12,17,39
CSKA Moscow,9500,2,12,3,5,33,17,16,39
Spart Moscow,9500,3,9,6,5,35,30,5,33
Zenit,9500,4,8,8,4,22,15,7,32
Krasnodar,9500,5,8,6,6,30,27,3,30
Terek Grozny,9500,6,7,5,8,22,27,-5,26
FK Rubin,9500,7,6,6,8,27,21,6,24
Amkar,9500,8,6,4,10,14,22,-8,22
Din Moscow,9500,9,5,6,9,18,25,-7,21
Rostov,9500,10,4,7,9,11,18,-7,19
Anzhi,9500,11,3,5,12,18,45,-27,14
Loko Moscow,9501,1,11,5,4,29,14,15,38
Spart Moscow,9501,2,10,6,4,44,29,15,36
CSKA Moscow,9501,3,11,3,6,26,18,8,36
Zenit,9501,4,9,8,3,24,13,11,35
Krasnodar,9501,5,10,4,6,30,25,5,34
Terek Grozny,9501,6,8,6,6,24,24,0,30
Din Moscow,9501,7,6,7,7,22,23,-1,25
FK Rubin,9501,8,5,5,10,22,22,0,20
Rostov,9501,9,4,6,10,10,22,-12,18
Amkar,9501,10,4,4,12,12,29,-17,16
Anzhi,9501,11,2,6,12,15,39,-24,12
Loko Moscow,9502,1,11,7,2,31,13,18,40
CSKA Moscow,9502,2,11,3,6,28,20,8,36
Spart Moscow,9502,3,9,7,4,39,30,9,34
Zenit,9502,4,8,9,3,23,13,10,33
Krasnodar,9502,5,9,5,6,33,27,6,32
Terek Grozny,9502,6,9,5,6,23,23,0,32
FK Rubin,9502,7,6,5,9,26,21,5,23
Din Moscow,9502,8,5,7,8,18,26,-8,22
Rostov,9502,9,4,6,10,11,19,-8,18
Amkar,9502,10,4,5,11,13,27,-14,17
Anzhi,9502,11,2,5,13,15,41,-26,11
Loko Moscow,9503,1,11,6,3,30,14,16,39
CSKA Moscow,9503,2,11,3,6,32,20,12,36
Zenit,9503,3,8,9,3,24,15,9,33
Spart Moscow,9503,4,9,5,6,35,29,6,32
Krasnodar,9503,5,9,5,6,32,27,5,32
Terek Grozny,9503,6,8,5,7,23,23,0,29
FK Rubin,9503,7,6,6,8,26,20,6,24
Din Moscow,9503,8,6,6,8,19,23,-4,24
Amkar,9503,9,6,4,10,11,22,-11,22
Rostov,9503,10,4,6,10,11,19,-8,18
Anzhi,9503,11,2,5,13,15,46,-31,11
Loko Moscow,9504,1,12,5,3,31,13,18,41
CSKA Moscow,9504,2,11,4,5,29,19,10,37
Zenit,9504,3,8,9,3,23,14,9,33
Spart Moscow,9504,4,8,6,6,37,35,2,30
Krasnodar,9504,5,8,4,8,28,28,0,28
FK Rubin,9504,6,7,5,8,25,17,8,26
Terek Grozny,9504,7,7,5,8,21,26,-5,26
Din Moscow,9504,8,5,7,8,18,24,-6,22
Amkar,9504,9,6,4,10,15,23,-8,22
Rostov,9504,10,5,6,9,15,19,-4,21
Anzhi,9504,11,3,5,12,17,41,-24,14
Loko Moscow,9505,1,12,5,3,33,13,20,41
Spart Moscow,9505,2,11,5,4,42,28,14,38
CSKA Moscow,9505,3,11,3,6,27,18,9,36
Krasnodar,9505,4,9,5,6,29,24,5,32
Zenit,9505,5,8,8,4,22,17,5,32
Terek Grozny,9505,6,8,6,6,23,23,0,30
Din Moscow,9505,7,6,6,8,23,24,-1,24
FK Rubin,9505,8,5,6,9,22,23,-1,21
Rostov,9505,9,4,6,10,12,21,-9,18
Amkar,9505,10,4,5,11,11,26,-15,17
Anzhi,9505,11,2,5,13,14,41,-27,11
Loko Moscow,9506,1,11,6,3,32,16,16,39
CSKA Moscow,9506,2,12,3,5,30,19,11,39
Krasnodar,9506,3,9,4,7,30,27,3,31
Zenit,9506,4,7,9,4,25,18,7,30
Spart Moscow,9506,5,8,5,7,33,28,5,29
Terek Grozny,9506,6,8,5,7,24,25,-1,29
FK Rubin,9506,7,7,5,8,26,18,8,26
Din Moscow,9506,8,6,6,8,19,24,-5,24
Amkar,9506,9,6,4,10,13,23,-10,22
Rostov,9506,10,5,6,9,11,17,-6,21
Anzhi,9506,11,2,5,13,14,42,-28,11
Loko Moscow,9507,1,12,5,3,32,12,20,41
CSKA Moscow,9507,2,10,5,5,27,19,8,35
Krasnodar,9507,3,10,4,6,30,24,6,34
Spart Moscow,9507,4,9,6,5,37,28,9,33
Zenit,9507,5,7,9,4,22,17,5,30
Terek Grozny,9507,6,7,5,8,22,26,-4,26
FK Rubin,9507,7,6,5,9,23,20,3,23
Rostov,9507,8,5,6,9,11,17,-6,21
Din Moscow,9507,9,5,6,9,18,25,-7,21
Amkar,9507,10,5,5,10,12,24,-12,20
Anzhi,9507,11,3,6,11,18,40,-22,15
CSKA Moscow,9508,1,12,3,5,28,18,10,39
Loko Moscow,9508,2,11,5,4,29,13,16,38
Spart Moscow,9508,3,10,6,4,36,26,10,36
Krasnodar,9508,4,10,4,6,30,24,6,34
Zenit,9508,5,8,8,4,23,15,8,32
Terek Grozny,9508,6,7,6,7,20,24,-4,27
FK Rubin,9508,7,6,5,9,22,19,3,23
Din Moscow,9508,8,5,6,9,17,23,-6,21
Rostov,9508,9,4,7,9,11,18,-7,19
Amkar,9508,10,5,4,11,11,23,-12,19
Anzhi,9508,11,2,6,12,14,38,-24,12
Loko Moscow,9509,1,12,6,2,32,13,19,42
Spart Moscow,9509,2,10,6,4,37,27,10,36
CSKA Moscow,9509,3,11,3,6,27,20,7,36
Zenit,9509,4,8,8,4,25,16,9,32
Krasnodar,9509,5,8,6,6,30,27,3,30
Terek Grozny,9509,6,7,6,7,20,24,-4,27
FK Rubin,9509,7,6,6,8,29,20,9,24
Din Moscow,9509,8,5,7,8,18,27,-9,22
Amkar,9509,9,5,4,11,11,23,-12,19
Rostov,9509,10,4,6,10,11,19,-8,18
Anzhi,9509,11,2,6,12,15,39,-24,12
Loko Moscow,9510,1,12,6,2,33,12,21,42
CSKA Moscow,9510,2,12,3,5,29,18,11,39
Spart Moscow,9510,3,11,5,4,40,28,12,38
Zenit,9510,4,7,9,4,23,16,7,30
Krasnodar,9510,5,8,5,7,27,27,0,29
Terek Grozny,9510,6,7,5,8,20,25,-5,26
Din Moscow,9510,7,6,6,8,19,24,-5,24
FK Rubin,9510,8,5,6,9,22,19,3,21
Amkar,9510,9,5,4,11,13,25,-12,19
Rostov,9510,10,4,6,10,11,19,-8,18
Anzhi,9510,11,3,5,12,15,39,-24,14
Loko Moscow,9511,1,12,5,3,32,15,17,41
CSKA Moscow,9511,2,11,4,5,28,18,10,37
Spart Moscow,9511,3,9,6,5,37,28,9,33
Krasnodar,9511,4,9,5,6,30,25,5,32
Terek Grozny,9511,5,9,5,6,22,22,0,32
Zenit,9511,6,7,8,5,22,17,5,29
FK Rubin,9511,7,5,7,8,22,18,4,22
Din Moscow,9511,8,5,7,8,19,26,-7,22
Rostov,9511,9,4,7,9,10,17,-7,19
Amkar,9511,10,5,4,11,11,23,-12,19
Anzhi,9511,11,2,6,12,15,39,-24,12
Loko Moscow,9512,1,12,5,3,32,15,17,41
CSKA Moscow,9512,2,11,4,5,33,19,14,37
Spart Moscow,9512,3,9,7,4,37,28,9,34
Krasnodar,9512,4,9,5,6,32,26,6,32
Zenit,9512,5,7,9,4,22,16,6,30
Terek Grozny,9512,6,7,7,6,24,26,-2,28
Din Moscow,9512,7,5,8,7,19,23,-4,23
FK Rubin,9512,8,5,7,8,23,19,4,22
Rostov,9512,9,4,7,9,11,18,-7,19
Amkar,9512,10,4,5,11,12,26,-14,17
Anzhi,9512,11,2,6,12,17,46,-29,12
Loko Moscow,9513,1,13,5,2,35,13,22,44
Spart Moscow,9513,2,10,6,4,36,26,10,36
CSKA Moscow,9513,3,11,3,6,28,21,7,36
Zenit,9513,4,8,8,4,26,16,10,32
Krasnodar,9513,5,8,5,7,28,28,0,29
Terek Grozny,9513,6,7,6,7,22,25,-3,27
Din Moscow,9513,7,6,6,8,19,23,-4,24
FK Rubin,9513,8,5,6,9,22,19,3,21
Rostov,9513,9,4,7,9,10,17,-7,19
Amkar,9513,10,5,4,11,12,25,-13,19
Anzhi,9513,11,2,6,12,15,40,-25,12
Loko Moscow,9514,1,12,5,3,32,13,19,41
CSKA Moscow,9514,2,10,5,5,25,17,8,35
Krasnodar,9514,3,10,4,6,33,25,8,34
Spart Moscow,9514,4,9,5,6,37,33,4,32
Zenit,9514,5,7,9,4,21,15,6,30
Terek Grozny,9514,6,8,5,7,22,23,-1,29
Din Moscow,9514,7,7,6,7,22,22,0,27
FK Rubin,9514,8,5,5,10,21,22,-1,20
Amkar,9514,9,5,4,11,12,25,-13,19
Rostov,9514,10,4,6,10,11,19,-8,18
Anzhi,9514,11,3,6,11,15,37,-22,15
Loko Moscow,9515,1,12,6,2,33,13,20,42
Spart Moscow,9515,2,11,5,4,38,26,12,38
CSKA Moscow,9515,3,10,4,6,26,19,7,34
Zenit,9515,4,8,9,3,25,16,9,33
Krasnodar,9515,5,9,4,7,28,26,2,31
Terek Grozny,9515,6,8,5,7,25,28,-3,29
FK Rubin,9515,7,6,5,9,22,18,4,23
Din Moscow,9515,8,5,6,9,18,24,-6,21
Amkar,9515,9,5,4,11,14,25,-11,19
Rostov,9515,10,4,6,10,10,19,-9,18
Anzhi,9515,11,2,6,12,15,40,-25,12
Loko Moscow,9516,1,11,6,3,29,13,16,39
CSKA Moscow,9516,2,11,4,5,26,17,9,37
Krasnodar,9516,3,10,4,6,30,24,6,34
Zenit,9516,4,7,10,3,21,13,8,31
Spart Moscow,9516,5,8,5,7,33,29,4,29
Terek Grozny,9516,6,8,5,7,24,25,-1,29
Din Moscow,9516,7,7,6,7,21,21,0,27
Rostov,9516,8,5,6,9,12,17,-5,21
FK Rubin,9516,9,5,5,10,21,21,0,20
Amkar,9516,10,5,4,11,11,25,-14,19
Anzhi,9516,11,3,5,12,16,39,-23,14
Loko Moscow,9517,1,11,6,3,30,13,17,39
CSKA Moscow,9517,2,10,5,5,29,21,8,35
Zenit,9517,3,8,9,3,26,17,9,33
Spart Moscow,9517,4,9,5,6,37,31,6,32
Krasnodar,9517,5,8,6,6,28,25,3,30
Terek Grozny,9517,6,8,5,7,23,25,-2,29
FK Rubin,9517,7,6,6,8,24,18,6,24
Amkar,9517,8,6,4,10,15,24,-9,22
Rostov,9517,9,5,6,9,13,19,-6,21
Din Moscow,9517,10,5,6,9,17,25,-8,21
Anzhi,9517,11,2,6,12,15,39,-24,12
Loko Moscow,9518,1,12,6,2,31,12,19,42
CSKA Moscow,9518,2,11,4,5,26,17,9,37
Spart Moscow,9518,3,10,6,4,39,26,13,36
Zenit,9518,4,7,10,3,22,14,8,31
Krasnodar,9518,5,9,4,7,28,25,3,31
Terek Grozny,9518,6,8,5,7,24,25,-1,29
Din Moscow,9518,7,6,6,8,19,26,-7,24
FK Rubin,9518,8,5,5,10,22,20,2,20
Rostov,9518,9,4,6,10,10,18,-8,18
Amkar,9518,10,4,5,11,11,26,-15,17
Anzhi,9518,11,3,5,12,16,39,-23,14
Loko Moscow,9519,1,13,5,2,32,11,21,44
CSKA Moscow,9519,2,11,3,6,27,19,8,36
Spart Moscow,9519,3,9,5,6,36,28,8,32
Zenit,9519,4,8,8,4,23,15,8,32
Terek Grozny,9519,5,9,5,6,26,24,2,32
Krasnodar,9519,6,8,5,7,29,27,2,29
FK Rubin,9519,7,6,6,8,24,19,5,24
Din Moscow,9519,8,6,6,8,18,22,-4,24
Amkar,9519,9,5,4,11,12,25,-13,19
Rostov,9519,10,4,6,10,11,20,-9,18
Anzhi,9519,11,2,5,13,14,42,-28,11
Loko Moscow,9520,1,12,6,2,31,12,19,42
CSKA Moscow,9520,2,11,4,5,27,18,9,37
Spart Moscow,9520,3,9,6,5,39,30,9,33
Krasnodar,9520,4,9,5,6,30,25,5,32
Terek Grozny,9520,5,8,6,6,23,23,0,30
Zenit,9520,6,7,8,5,22,16,6,29
Din Moscow,9520,7,6,7,7,20,22,-2,25
FK Rubin,9520,8,5,6,9,22,20,2,21
Rostov,9520,9,4,6,10,11,21,-10,18
Amkar,9520,10,4,6,10,12,25,-13,18
Anzhi,9520,11,2,6,12,14,39,-25,12
Loko Moscow,9521,1,12,6,2,32,13,19,42
CSKA Moscow,9521,2,11,4,5,29,20,9,37
Spart Moscow,9521,3,10,5,5,37,27,10,35
Krasnodar,9521,4,9,5,6,31,27,4,32
Zenit,9521,5,7,9,4,22,15,7,30
Terek Grozny,9521,6,8,5,7,23,24,-1,29
Din Moscow,9521,7,5,7,8,18,24,-6,22
FK Rubin,9521,8,5,6,9,23,20,3,21
Rostov,9521,9,5,6,9,12,18,-6,21
Amkar,9521,10,5,4,11,11,24,-13,19
Anzhi,9521,11,2,5,13,16,42,-26,11
Loko Moscow,9522,1,11,5,4,29,14,15,38
CSKA Moscow,9522,2,11,4,5,28,17,11,37
Spart Moscow,9522,3,10,6,4,40,29,11,36
Krasnodar,9522,4,10,4,6,30,25,5,34
Zenit,9522,5,8,9,3,23,13,10,33
Terek Grozny,9522,6,7,5,8,21,25,-4,26
FK Rubin,9522,7,6,5,9,23,19,4,23
Din Moscow,9522,8,5,6,9,18,24,-6,21
Rostov,9522,9,4,7,9,12,19,-7,19
Amkar,9522,10,5,4,11,11,25,-14,19
Anzhi,9522,11,3,5,12,16,41,-25,14
Loko Moscow,9523,1,12,5,3,33,15,18,41
CSKA Moscow,9523,2,11,3,6,26,18,8,36
Zenit,9523,3,9,8,3,24,13,11,35
Spart Moscow,9523,4,10,5,5,36,27,9,35
Krasnodar,9523,5,9,4,7,30,28,2,31
Terek Grozny,9523,6,7,5,8,20,26,-6,26
Din Moscow,9523,7,6,6,8,19,23,-4,24
Amkar,9523,8,6,4,10,14,23,-9,22
FK Rubin,9523,9,5,5,10,22,20,2,20
Rostov,9523,10,4,6,10,10,18,-8,18
Anzhi,9523,11,3,5,12,15,38,-23,14
Loko Moscow,9524,1,12,5,3,31,13,18,41
Spart Moscow,9524,2,10,6,4,38,28,10,36
CSKA Moscow,9524,3,11,3,6,27,19,8,36
Krasnodar,9524,4,9,4,7,30,27,3,31
Zenit,9524,5,7,8,5,21,17,4,29
Terek Grozny,9524,6,7,5,8,21,27,-6,26
Din Moscow,9524,7,6,6,8,20,23,-3,24
FK Rubin,9524,8,6,5,9,24,20,4,23
Amkar,9524,9,5,5,10,14,24,-10,20
Rostov,9524,10,4,6,10,10,18,-8,18
Anzhi,9524,11,4,5,11,18,38,-20,17
Loko Moscow,9525,1,12,6,2,34,12,22,42
CSKA Moscow,9525,2,12,3,5,28,18,10,39
Spart Moscow,9525,3,10,6,4,38,27,11,36
Terek Grozny,9525,4,8,6,6,26,23,3,30
Zenit,9525,5,7,8,5,23,20,3,29
Krasnodar,9525,6,8,5,7,28,27,1,29
FK Rubin,9525,7,6,6,8,24,18,6,24
Din Moscow,9525,8,5,7,8,19,24,-5,22
Rostov,9525,9,4,6,10,10,19,-9,18
Amkar,9525,10,4,6,10,10,23,-13,18
Anzhi,9525,11,2,5,13,14,43,-29,11
Loko Moscow,9526,1,12,6,2,31,12,19,42
CSKA Moscow,9526,2,11,3,6,26,18,8,36
Zenit,9526,3,8,8,4,22,14,8,32
Spart Moscow,9526,4,8,7,5,35,28,7,31
Krasnodar,9526,5,8,6,6,29,26,3,30
Terek Grozny,9526,6,8,6,6,22,22,0,30
FK Rubin,9526,7,6,6,8,24,19,5,24
Din Moscow,9526,8,5,7,8,19,24,-5,22
Rostov,9526,9,5,6,9,11,17,-6,21
Amkar,9526,10,4,5,11,10,25,-15,17
Anzhi,9526,11,2,6,12,14,38,-24,12
Loko Moscow,9527,1,13,5,2,32,12,20,44
CSKA Moscow,9527,2,11,3,6,31,20,11,36
Zenit,9527,3,8,8,4,24,15,9,32
Spart Moscow,9527,4,8,6,6,34,28,6,30
Terek Grozny,9527,5,8,6,6,21,22,-1,30
Krasnodar,9527,6,8,4,8,29,28,1,28
FK Rubin,9527,7,7,5,8,24,18,6,26
Din Moscow,9527,8,6,6,8,18,22,-4,24
Rostov,9527,9,5,6,9,11,17,-6,21
Amkar,9527,10,4,6,10,10,23,-13,18
Anzhi,9527,11,2,5,13,14,43,-29,11
Loko Moscow,9528,1,11,6,3,31,14,17,39
CSKA Moscow,9528,2,11,4,5,26,17,9,37
Spart Moscow,9528,3,10,6,4,38,26,12,36
Krasnodar,9528,4,9,5,6,29,25,4,32
Zenit,9528,5,7,10,3,22,14,8,31
Terek Grozny,9528,6,8,5,7,22,25,-3,29
FK Rubin,9528,7,5,7,8,21,17,4,22
Din Moscow,9528,8,5,7,8,17,22,-5,22
Amkar,9528,9,5,5,10,12,23,-11,20
Rostov,9528,10,4,6,10,10,20,-10,18
Anzhi,9528,11,2,5,13,15,40,-25,11
Loko Moscow,9529,1,11,5,4,29,14,15,38
Spart Moscow,9529,2,10,6,4,40,29,11,36
CSKA Moscow,9529,3,11,3,6,27,19,8,36
Zenit,9529,4,9,8,3,24,13,11,35
Krasnodar,9529,5,10,4,6,31,25,6,34
Terek Grozny,9529,6,7,7,6,23,25,-2,28
Din Moscow,9529,7,6,6,8,22,26,-4,24
FK Rubin,9529,8,5,5,10,23,22,1,20
Rostov,9529,9,4,6,10,10,19,-9,18
Amkar,9529,10,4,6,10,11,24,-13,18
Anzhi,9529,11,2,6,12,17,41,-24,12
Loko Moscow,9530,1,12,5,3,32,14,18,41
CSKA Moscow,9530,2,11,3,6,29,23,6,36
Zenit,9530,3,9,8,3,26,14,12,35
Spart Moscow,9530,4,8,7,5,35,28,7,31
Krasnodar,9530,5,9,4,7,31,27,4,31
Terek Grozny,9530,6,7,6,7,24,28,-4,27
FK Rubin,9530,7,6,5,9,23,19,4,23
Din Moscow,9530,8,5,7,8,19,25,-6,22
Rostov,9530,9,5,6,9,11,17,-6,21
Amkar,9530,10,5,5,10,12,23,-11,20
Anzhi,9530,11,2,6,12,19,43,-24,12
Loko Moscow,9531,1,12,5,3,31,14,17,41
Spart Moscow,9531,2,10,6,4,37,25,12,36
Zenit,9531,3,9,8,3,25,14,11,35
CSKA Moscow,9531,4,10,4,6,26,19,7,34
Krasnodar,9531,5,9,4,7,29,26,3,31
Terek Grozny,9531,6,8,5,7,23,25,-2,29
Din Moscow,9531,7,5,7,8,18,24,-6,22
FK Rubin,9531,8,5,6,9,23,20,3,21
Rostov,9531,9,4,7,9,10,17,-7,19
Amkar,9531,10,5,4,11,11,25,-14,19
Anzhi,9531,11,2,6,12,16,40,-24,12
Loko Moscow,9532,1,11,6,3,29,12,17,39
CSKA Moscow,9532,2,12,3,5,28,17,11,39
Spart Moscow,9532,3,10,5,5,40,27,13,35
Zenit,9532,4,8,8,4,22,15,7,32
Krasnodar,9532,5,8,5,7,28,26,2,29
Terek Grozny,9532,6,8,5,7,24,26,-2,29
FK Rubin,9532,7,6,6,8,24,19,5,24
Din Moscow,9532,8,5,7,8,18,26,-8,22
Rostov,9532,9,5,6,9,11,17,-6,21
Amkar,9532,10,4,4,12,11,29,-18,16
Anzhi,9532,11,3,5,12,17,38,-21,14
Loko Moscow,9533,1,12,6,2,32,13,19,42
CSKA Moscow,9533,2,10,5,5,27,19,8,35
Spart Moscow,9533,3,9,6,5,38,27,11,33
Zenit,9533,4,7,10,3,22,14,8,31
Krasnodar,9533,5,9,4,7,33,28,5,31
Terek Grozny,9533,6,8,5,7,21,23,-2,29
Din Moscow,9533,7,5,7,8,18,26,-8,22
Amkar,9533,8,6,4,10,11,22,-11,22
FK Rubin,9533,9,5,6,9,23,22,1,21
Rostov,9533,10,4,7,9,11,18,-7,19
Anzhi,9533,11,2,6,12,15,39,-24,12
Loko Moscow,9534,1,13,5,2,33,11,22,44
CSKA Moscow,9534,2,10,4,6,27,20,7,34
Spart Moscow,9534,3,9,6,5,39,30,9,33
Zenit,9534,4,8,8,4,23,17,6,32
Krasnodar,9534,5,9,4,7,28,25,3,31
Terek Grozny,9534,6,8,6,6,21,22,-1,30
Din Moscow,9534,7,6,6,8,19,24,-5,24
Rostov,9534,8,5,6,9,12,18,-6,21
FK Rubin,9534,9,5,5,10,21,19,2,20
Amkar,9534,10,4,6,10,11,24,-13,18
Anzhi,9534,11,2,6,12,15,39,-24,12
Loko Moscow,9535,1,12,5,3,32,15,17,41
Spart Moscow,9535,2,10,5,5,40,28,12,35
CSKA Moscow,9535,3,10,4,6,27,20,7,34
Zenit,9535,4,8,8,4,23,15,8,32
Krasnodar,9535,5,9,4,7,32,28,4,31
Terek Grozny,9535,6,7,6,7,21,27,-6,27
Din Moscow,9535,7,6,6,8,20,24,-4,24
FK Rubin,9535,8,6,5,9,24,21,3,23
Amkar,9535,9,5,5,10,12,24,-12,20
Rostov,9535,10,4,6,10,10,20,-10,18
Anzhi,9535,11,3,6,11,20,39,-19,15
Loko Moscow,9536,1,12,6,2,30,11,19,42
Spart Moscow,9536,2,11,5,4,39,27,12,38
CSKA Moscow,9536,3,10,5,5,28,20,8,35
Zenit,9536,4,7,9,4,21,14,7,30
Krasnodar,9536,5,8,6,6,30,27,3,30
Terek Grozny,9536,6,7,5,8,20,24,-4,26
Din Moscow,9536,7,6,6,8,21,23,-2,24
FK Rubin,9536,8,5,6,9,24,23,1,21
Amkar,9536,9,5,4,11,11,24,-13,19
Rostov,9536,10,4,6,10,10,19,-9,18
Anzhi,9536,11,3,6,11,18,40,-22,15
Loko Moscow,9537,1,13,5,2,34,12,22,44
CSKA Moscow,9537,2,11,4,5,32,20,12,37
Spart Moscow,9537,3,9,7,4,36,26,10,34
Krasnodar,9537,4,9,4,7,30,28,2,31
Zenit,9537,5,7,9,4,24,18,6,30
Terek Grozny,9537,6,7,7,6,23,25,-2,28
Din Moscow,9537,7,5,8,7,18,22,-4,23
FK Rubin,9537,8,5,6,9,23,20,3,21
Rostov,9537,9,4,7,9,10,17,-7,19
Amkar,9537,10,4,5,11,12,27,-15,17
Anzhi,9537,11,2,6,12,15,42,-27,12
Loko Moscow,9538,1,12,6,2,32,13,19,42
CSKA Moscow,9538,2,11,3,6,28,20,8,36
Zenit,9538,3,8,9,3,25,16,9,33
Spart Moscow,9538,4,9,5,6,35,29,6,32
Terek Grozny,9538,5,8,5,7,22,24,-2,29
Krasnodar,9538,6,8,4,8,28,28,0,28
Din Moscow,9538,7,6,7,7,19,22,-3,25
FK Rubin,9538,8,6,6,8,23,17,6,24
Rostov,9538,9,5,6,9,12,17,-5,21
Amkar,9538,10,5,4,11,10,23,-13,19
Anzhi,9538,11,2,5,13,15,40,-25,11
Loko Moscow,9539,1,12,6,2,31,12,19,42
CSKA Moscow,9539,2,11,3,6,30,20,10,36
Zenit,9539,3,8,8,4,23,14,9,32
Spart Moscow,9539,4,8,6,6,35,32,3,30
Krasnodar,9539,5,8,6,6,31,28,3,30
Terek Grozny,9539,6,8,5,7,21,24,-3,29
Din Moscow,9539,7,5,8,7,19,23,-4,23
FK Rubin,9539,8,5,7,8,24,20,4,22
Amkar,9539,9,6,4,10,13,22,-9,22
Rostov,9539,10,5,6,9,13,17,-4,21
Anzhi,9539,11,2,5,13,15,43,-28,11
Loko Moscow,9540,1,12,5,3,31,14,17,41
Spart Moscow,9540,2,11,5,4,38,26,12,38
Zenit,9540,3,9,8,3,24,13,11,35
CSKA Moscow,9540,4,10,3,7,27,21,6,33
Krasnodar,9540,5,9,4,7,31,26,5,31
Terek Grozny,9540,6,7,6,7,21,25,-4,27
Din Moscow,9540,7,5,7,8,18,23,-5,22
FK Rubin,9540,8,5,6,9,22,21,1,21
Rostov,9540,9,4,6,10,10,19,-9,18
Amkar,9540,10,4,5,11,10,24,-14,17
Anzhi,9540,11,4,5,11,20,40,-20,17
Loko Moscow,9541,1,12,5,3,32,14,18,41
CSKA Moscow,9541,2,11,3,6,27,20,7,36
Spart Moscow,9541,3,9,5,6,39,31,8,32
Zenit,9541,4,8,8,4,23,15,8,32
Krasnodar,9541,5,9,4,7,31,27,4,31
FK Rubin,9541,6,7,5,8,25,18,7,26
Terek Grozny,9541,7,7,5,8,21,26,-5,26
Din Moscow,9541,8,6,6,8,21,26,-5,24
Rostov,9541,9,5,6,9,11,17,-6,21
Amkar,9541,10,5,4,11,12,26,-14,19
Anzhi,9541,11,3,5,12,17,39,-22,14
Loko Moscow,9542,1,12,5,3,33,14,19,41
Spart Moscow,9542,2,10,6,4,38,28,10,36
CSKA Moscow,9542,3,11,3,6,30,20,10,36
Krasnodar,9542,4,10,4,6,31,26,5,34
Zenit,9542,5,8,8,4,24,16,8,32
Terek Grozny,9542,6,8,6,6,23,23,0,30
Din Moscow,9542,7,6,7,7,19,22,-3,25
FK Rubin,9542,8,5,5,10,22,20,2,20
Rostov,9542,9,4,6,10,10,18,-8,18
Amkar,9542,10,4,5,11,12,26,-14,17
Anzhi,9542,11,2,5,13,15,44,-29,11
Loko Moscow,9543,1,13,5,2,33,11,22,44
CSKA Moscow,9543,2,12,3,5,30,20,10,39
Spart Moscow,9543,3,9,5,6,36,29,7,32
Terek Grozny,9543,4,9,5,6,26,24,2,32
Zenit,9543,5,7,8,5,21,15,6,29
Krasnodar,9543,6,8,4,8,27,31,-4,28
Din Moscow,9543,7,6,6,8,19,22,-3,24
FK Rubin,9543,8,6,5,9,25,19,6,23
Rostov,9543,9,5,6,9,12,18,-6,21
Amkar,9543,10,5,4,11,11,26,-15,19
Anzhi,9543,11,2,5,13,19,44,-25,11
Loko Moscow,9544,1,12,5,3,31,14,17,41
CSKA Moscow,9544,2,12,3,5,29,17,12,39
Spart Moscow,9544,3,11,5,4,42,27,15,38
Krasnodar,9544,4,9,5,6,31,25,6,32
Zenit,9544,5,7,8,5,21,17,4,29
Terek Grozny,9544,6,7,5,8,21,26,-5,26
FK Rubin,9544,7,5,7,8,23,19,4,22
Din Moscow,9544,8,5,7,8,18,25,-7,22
Amkar,9544,9,5,4,11,12,26,-14,19
Rostov,9544,10,4,6,10,10,19,-9,18
Anzhi,9544,11,3,5,12,17,40,-23,14
Loko Moscow,9545,1,11,6,3,29,14,15,39
CSKA Moscow,9545,2,11,3,6,29,21,8,36
Krasnodar,9545,3,10,4,6,33,24,9,34
Spart Moscow,9545,4,9,6,5,35,27,8,33
Zenit,9545,5,7,9,4,23,16,7,30
Terek Grozny,9545,6,8,5,7,21,23,-2,29
FK Rubin,9545,7,6,5,9,22,20,2,23
Din Moscow,9545,8,5,6,9,18,24,-6,21
Rostov,9545,9,4,7,9,10,17,-7,19
Amkar,9545,10,5,4,11,10,23,-13,19
Anzhi,9545,11,4,5,11,17,38,-21,17
Loko Moscow,9546,1,13,5,2,34,13,21,44
CSKA Moscow,9546,2,11,3,6,26,18,8,36
Spart Moscow,9546,3,10,5,5,38,30,8,35
Zenit,9546,4,8,8,4,22,14,8,32
Krasnodar,9546,5,8,5,7,30,29,1,29
Terek Grozny,9546,6,8,5,7,21,24,-3,29
FK Rubin,9546,7,6,6,8,24,18,6,24
Din Moscow,9546,8,5,6,9,17,24,-7,21
Amkar,9546,9,5,4,11,13,25,-12,19
Rostov,9546,10,4,6,10,11,19,-8,18
Anzhi,9546,11,3,5,12,16,38,-22,14
Loko Moscow,9547,1,12,6,2,34,14,20,42
Spart Moscow,9547,2,11,5,4,44,28,16,38
CSKA Moscow,9547,3,11,3,6,29,18,11,36
Zenit,9547,4,8,8,4,23,16,7,32
Krasnodar,9547,5,9,5,6,31,26,5,32
Terek Grozny,9547,6,7,6,7,21,24,-3,27
Din Moscow,9547,7,5,7,8,17,24,-7,22
FK Rubin,9547,8,5,6,9,21,19,2,21
Rostov,9547,9,4,6,10,10,19,-9,18
Amkar,9547,10,4,5,11,13,29,-16,17
Anzhi,9547,11,3,5,12,15,41,-26,14
Loko Moscow,9548,1,11,5,4,29,15,14,38
CSKA Moscow,9548,2,10,5,5,27,19,8,35
Spart Moscow,9548,3,9,7,4,38,29,9,34
Krasnodar,9548,4,10,4,6,33,25,8,34
Zenit,9548,5,8,9,3,25,15,10,33
Terek Grozny,9548,6,7,7,6,22,24,-2,28
FK Rubin,9548,7,6,5,9,24,21,3,23
Din Moscow,9548,8,5,7,8,18,24,-6,22
Rostov,9548,9,4,7,9,12,19,-7,19
Amkar,9548,10,4,5,11,11,25,-14,17
Anzhi,9548,11,2,7,11,15,38,-23,13
Loko Moscow,9549,1,12,5,3,31,15,16,41
CSKA Moscow,9549,2,11,3,6,29,20,9,36
Zenit,9549,3,9,8,3,26,14,12,35
Spart Moscow,9549,4,9,6,5,35,27,8,33
Terek Grozny,9549,5,8,5,7,23,24,-1,29
Krasnodar,9549,6,8,4,8,28,28,0,28
FK Rubin,9549,7,6,6,8,24,18,6,24
Din Moscow,9549,8,5,7,8,18,23,-5,22
Amkar,9549,9,6,4,10,11,22,-11,22
Rostov,9549,10,4,7,9,11,18,-7,19
Anzhi,9549,11,2,5,13,16,43,-27,11
Loko Moscow,9550,1,11,5,4,30,14,16,38
CSKA Moscow,9550,2,11,4,5,31,21,10,37
Spart Moscow,9550,3,10,6,4,38,27,11,36
Krasnodar,9550,4,10,4,6,30,25,5,34
Zenit,9550,5,8,9,3,25,16,9,33
Terek Grozny,9550,6,8,5,7,23,24,-1,29
Din Moscow,9550,7,6,6,8,19,24,-5,24
FK Rubin,9550,8,5,5,10,21,19,2,20
Amkar,9550,9,5,5,10,11,22,-11,20
Rostov,9550,10,4,6,10,11,19,-8,18
Anzhi,9550,11,2,5,13,15,43,-28,11
CSKA Moscow,9551,1,12,3,5,30,19,11,39
Loko Moscow,9551,2,11,5,4,30,15,15,38
Spart Moscow,9551,3,10,6,4,38,27,11,36
Zenit,9551,4,8,8,4,23,15,8,32
Krasnodar,9551,5,9,5,6,31,26,5,32
Terek Grozny,9551,6,8,5,7,24,25,-1,29
Din Moscow,9551,7,6,6,8,19,23,-4,24
FK Rubin,9551,8,5,6,9,22,20,2,21
Rostov,9551,9,4,7,9,11,18,-7,19
Amkar,9551,10,4,4,12,10,26,-16,16
Anzhi,9551,11,3,5,12,18,42,-24,14
Loko Moscow,9552,1,12,5,3,30,15,15,41
Spart Moscow,9552,2,11,5,4,40,27,13,38
Zenit,9552,3,9,8,3,28,14,14,35
CSKA Moscow,9552,4,10,3,7,27,22,5,33
Krasnodar,9552,5,9,4,7,31,25,6,31
Terek Grozny,9552,6,8,6,6,23,24,-1,30
Din Moscow,9552,7,6,6,8,19,24,-5,24
FK Rubin,9552,8,5,5,10,21,23,-2,20
Rostov,9552,9,4,6,10,12,20,-8,18
Amkar,9552,10,4,5,11,10,24,-14,17
Anzhi,9552,11,3,5,12,17,40,-23,14
Loko Moscow,9553,1,11,5,4,29,15,14,38
CSKA Moscow,9553,2,11,3,6,29,19,10,36
Zenit,9553,3,9,8,3,26,14,12,35
Spart Moscow,9553,4,8,7,5,36,29,7,31
Krasnodar,9553,5,9,4,7,29,26,3,31
Terek Grozny,9553,6,8,6,6,21,22,-1,30
FK Rubin,9553,7,6,6,8,25,20,5,24
Din Moscow,9553,8,5,8,7,21,25,-4,23
Amkar,9553,9,5,5,10,11,23,-12,20
Rostov,9553,10,4,7,9,10,17,-7,19
Anzhi,9553,11,2,5,13,14,41,-27,11
Loko Moscow,9554,1,11,5,4,29,14,15,38
CSKA Moscow,9554,2,11,4,5,32,19,13,37
Spart Moscow,9554,3,10,6,4,38,27,11,36
Zenit,9554,4,8,9,3,25,15,10,33
Krasnodar,9554,5,9,4,7,28,25,3,31
Terek Grozny,9554,6,8,5,7,23,28,-5,29
Din Moscow,9554,7,6,7,7,19,22,-3,25
FK Rubin,9554,8,6,5,9,22,18,4,23
Amkar,9554,9,5,4,11,15,25,-10,19
Rostov,9554,10,4,6,10,11,20,-9,18
Anzhi,9554,11,2,5,13,14,43,-29,11
Loko Moscow,9555,1,11,6,3,31,14,17,39
Spart Moscow,9555,2,10,5,5,39,29,10,35
Zenit,9555,3,9,8,3,24,14,10,35
CSKA Moscow,9555,4,10,3,7,26,22,4,33
Krasnodar,9555,5,8,5,7,29,27,2,29
Terek Grozny,9555,6,8,5,7,22,24,-2,29
Din Moscow,9555,7,6,7,7,19,22,-3,25
FK Rubin,9555,8,6,6,8,22,17,5,24
Rostov,9555,9,4,6,10,12,20,-8,18
Anzhi,9555,10,4,5,11,18,37,-19,17
Amkar,9555,11,4,4,12,10,26,-16,16
Loko Moscow,9556,1,11,5,4,31,17,14,38
CSKA Moscow,9556,2,11,3,6,28,20,8,36
Zenit,9556,3,9,8,3,28,14,14,35
Spart Moscow,9556,4,9,7,4,40,30,10,34
Terek Grozny,9556,5,9,5,6,24,23,1,32
Krasnodar,9556,6,9,4,7,30,28,2,31
FK Rubin,9556,7,7,5,8,27,19,8,26
Din Moscow,9556,8,5,6,9,20,28,-8,21
Rostov,9556,9,4,7,9,11,18,-7,19
Amkar,9556,10,4,5,11,11,25,-14,17
Anzhi,9556,11,2,5,13,15,43,-28,11
Loko Moscow,9557,1,11,6,3,31,14,17,39
CSKA Moscow,9557,2,11,3,6,28,20,8,36
Spart Moscow,9557,3,10,5,5,38,28,10,35
Zenit,9557,4,9,8,3,25,15,10,35
Krasnodar,9557,5,8,5,7,30,28,2,29
Terek Grozny,9557,6,7,5,8,20,24,-4,26
FK Rubin,9557,7,6,6,8,25,20,5,24
Din Moscow,9557,8,5,7,8,18,25,-7,22
Amkar,9557,9,6,4,10,13,23,-10,22
Rostov,9557,10,4,6,10,10,18,-8,18
Anzhi,9557,11,3,5,12,16,39,-23,14
Loko Moscow,9558,1,12,6,2,31,12,19,42
CSKA Moscow,9558,2,11,4,5,27,18,9,37
Zenit,9558,3,7,9,4,21,14,7,30
Spart Moscow,9558,4,8,6,6,37,33,4,30
Krasnodar,9558,5,8,5,7,28,26,2,29
Terek Grozny,9558,6,7,7,6,21,23,-2,28
Din Moscow,9558,7,7,6,7,21,22,-1,27
FK Rubin,9558,8,6,5,9,22,18,4,23
Amkar,9558,9,5,5,10,12,23,-11,20
Rostov,9558,10,4,7,9,12,19,-7,19
Anzhi,9558,11,2,6,12,16,40,-24,12
Loko Moscow,9559,1,12,5,3,32,14,18,41
CSKA Moscow,9559,2,12,3,5,27,17,10,39
Krasnodar,9559,3,9,5,6,30,24,6,32
Spart Moscow,9559,4,8,7,5,36,29,7,31
Terek Grozny,9559,5,8,6,6,23,23,0,30
Zenit,9559,6,7,8,5,21,17,4,29
Din Moscow,9559,7,6,7,7,21,23,-2,25
FK Rubin,9559,8,5,6,9,22,20,2,21
Amkar,9559,9,5,5,10,11,23,-12,20
Rostov,9559,10,4,7,9,11,18,-7,19
Anzhi,9559,11,2,5,13,15,41,-26,11
Loko Moscow,9560,1,12,6,2,33,14,19,42
CSKA Moscow,9560,2,11,3,6,27,18,9,36
Spart Moscow,9560,3,9,6,5,36,28,8,33
Zenit,9560,4,8,8,4,22,14,8,32
Krasnodar,9560,5,9,5,6,33,29,4,32
Terek Grozny,9560,6,9,5,6,24,23,1,32
FK Rubin,9560,7,6,5,9,25,20,5,23
Rostov,9560,8,5,6,9,11,17,-6,21
Din Moscow,9560,9,5,6,9,17,24,-7,21
Amkar,9560,10,4,5,11,11,26,-15,17
Anzhi,9560,11,2,5,13,15,41,-26,11
Loko Moscow,9561,1,11,5,4,29,13,16,38
Spart Moscow,9561,2,11,5,4,38,26,12,38
CSKA Moscow,9561,3,11,4,5,27,18,9,37
Krasnodar,9561,4,10,4,6,31,26,5,34
Zenit,9561,5,8,8,4,22,14,8,32
Terek Grozny,9561,6,7,5,8,20,25,-5,26
Din Moscow,9561,7,6,6,8,19,24,-5,24
FK Rubin,9561,8,5,5,10,23,21,2,20
Amkar,9561,9,5,4,11,10,23,-13,19
Rostov,9561,10,4,6,10,10,18,-8,18
Anzhi,9561,11,3,6,11,17,38,-21,15
Loko Moscow,9562,1,11,5,4,30,15,15,38
CSKA Moscow,9562,2,11,4,5,31,18,13,37
Spart Moscow,9562,3,10,5,5,37,27,10,35
Zenit,9562,4,8,9,3,25,15,10,33
Krasnodar,9562,5,9,5,6,29,25,4,32
Terek Grozny,9562,6,8,5,7,22,27,-5,29
Din Moscow,9562,7,7,6,7,21,21,0,27
FK Rubin,9562,8,5,6,9,22,21,1,21
Rostov,9562,9,4,6,10,10,18,-8,18
Amkar,9562,10,4,4,12,10,26,-16,16
Anzhi,9562,11,3,5,12,19,43,-24,14
Loko Moscow,9563,1,11,6,3,31,14,17,39
CSKA Moscow,9563,2,12,3,5,27,17,10,39
Spart Moscow,9563,3,10,6,4,38,27,11,36
Zenit,9563,4,8,8,4,22,14,8,32
Krasnodar,9563,5,9,5,6,30,26,4,32
Terek Grozny,9563,6,9,5,6,23,23,0,32
FK Rubin,9563,7,6,5,9,23,18,5,23
Din Moscow,9563,8,5,7,8,19,25,-6,22
Rostov,9563,9,4,6,10,10,18,-8,18
Amkar,9563,10,4,4,12,9,25,-16,16
Anzhi,9563,11,2,5,13,15,40,-25,11
Loko Moscow,9564,1,12,6,2,31,12,19,42
CSKA Moscow,9564,2,11,4,5,26,17,9,37
Spart Moscow,9564,3,10,5,5,39,30,9,35
Krasnodar,9564,4,9,5,6,29,25,4,32
Zenit,9564,5,7,9,4,21,14,7,30
Terek Grozny,9564,6,8,6,6,22,23,-1,30
FK Rubin,9564,7,6,5,9,23,18,5,23
Din Moscow,9564,8,5,6,9,18,25,-7,21
Amkar,9564,9,5,5,10,11,23,-12,20
Rostov,9564,10,4,6,10,12,20,-8,18
Anzhi,9564,11,2,5,13,15,40,-25,11
Loko Moscow,9565,1,11,6,3,29,12,17,39
Spart Moscow,9565,2,10,6,4,38,27,11,36
CSKA Moscow,9565,3,11,3,6,27,19,8,36
Krasnodar,9565,4,9,5,6,29,25,4,32
Zenit,9565,5,7,9,4,22,15,7,30
Terek Grozny,9565,6,8,6,6,22,23,-1,30
Din Moscow,9565,7,5,8,7,18,22,-4,23
FK Rubin,9565,8,5,7,8,22,18,4,22
Rostov,9565,9,4,6,10,11,19,-8,18
Amkar,9565,10,4,5,11,10,25,-15,17
Anzhi,9565,11,3,5,12,15,38,-23,14
Loko Moscow,9566,1,11,6,3,30,13,17,39
CSKA Moscow,9566,2,12,3,5,27,17,10,39
Spart Moscow,9566,3,9,6,5,36,28,8,33
Zenit,9566,4,8,8,4,22,14,8,32
Krasnodar,9566,5,8,6,6,28,25,3,30
Terek Grozny,9566,6,8,6,6,23,23,0,30
Din Moscow,9566,7,6,7,7,21,22,-1,25
FK Rubin,9566,8,5,6,9,21,20,1,21
Amkar,9566,9,5,4,11,11,25,-14,19
Rostov,9566,10,4,6,10,11,19,-8,18
Anzhi,9566,11,2,6,12,14,38,-24,12
Loko Moscow,9567,1,12,5,3,30,14,16,41
Spart Moscow,9567,2,11,5,4,38,26,12,38
CSKA Moscow,9567,3,11,3,6,28,20,8,36
Zenit,9567,4,9,8,3,26,13,13,35
Krasnodar,9567,5,8,5,7,27,25,2,29
Terek Grozny,9567,6,8,5,7,23,24,-1,29
FK Rubin,9567,7,6,6,8,25,17,8,24
Din Moscow,9567,8,5,6,9,17,27,-10,21
Rostov,9567,9,4,6,10,11,19,-8,18
Amkar,9567,10,4,4,12,9,25,-16,16
Anzhi,9567,11,3,5,12,17,41,-24,14
Loko Moscow,9568,1,11,5,4,29,15,14,38
CSKA Moscow,9568,2,11,4,5,28,19,9,37
Krasnodar,9568,3,10,4,6,30,24,6,34
Zenit,9568,4,8,8,4,24,15,9,32
Spart Moscow,9568,5,9,5,6,35,29,6,32
Din Moscow,9568,6,7,6,7,19,21,-2,27
Terek Grozny,9568,7,7,5,8,22,27,-5,26
Rostov,9568,8,5,6,9,13,18,-5,21
FK Rubin,9568,9,5,5,10,21,19,2,20
Amkar,9568,10,5,4,11,12,24,-12,19
Anzhi,9568,11,3,6,11,17,39,-22,15
Loko Moscow,9569,1,11,5,4,29,13,16,38
Zenit,9569,2,9,8,3,23,13,10,35
Spart Moscow,9569,3,9,6,5,37,29,8,33
CSKA Moscow,9569,4,10,3,7,26,21,5,33
Krasnodar,9569,5,9,5,6,30,26,4,32
Terek Grozny,9569,6,7,5,8,20,25,-5,26
Din Moscow,9569,7,5,8,7,18,22,-4,23
FK Rubin,9569,8,5,7,8,23,19,4,22
Rostov,9569,9,5,6,9,12,18,-6,21
Amkar,9569,10,5,4,11,12,24,-12,19
Anzhi,9569,11,4,5,11,18,38,-20,17
Loko Moscow,9570,1,12,5,3,32,13,19,41
CSKA Moscow,9570,2,10,4,6,29,22,7,34
Zenit,9570,3,8,9,3,23,14,9,33
Spart Moscow,9570,4,9,5,6,36,29,7,32
Terek Grozny,9570,5,8,5,7,26,26,0,29
Krasnodar,9570,6,8,4,8,28,28,0,28
FK Rubin,9570,7,7,5,8,23,17,6,26
Din Moscow,9570,8,6,6,8,19,23,-4,24
Amkar,9570,9,6,4,10,14,24,-10,22
Rostov,9570,10,4,6,10,10,18,-8,18
Anzhi,9570,11,3,5,12,19,45,-26,14
Loko Moscow,9571,1,12,5,3,31,12,19,41
CSKA Moscow,9571,2,11,3,6,28,18,10,36
Zenit,9571,3,9,8,3,23,13,10,35
Spart Moscow,9571,4,9,5,6,38,28,10,32
Krasnodar,9571,5,9,4,7,28,26,2,31
Terek Grozny,9571,6,8,6,6,24,25,-1,30
Din Moscow,9571,7,7,6,7,20,21,-1,27
FK Rubin,9571,8,5,5,10,21,20,1,20
Amkar,9571,9,5,4,11,11,24,-13,19
Rostov,9571,10,4,6,10,11,22,-11,18
Anzhi,9571,11,2,6,12,16,42,-26,12
Loko Moscow,9572,1,11,7,2,31,13,18,40
CSKA Moscow,9572,2,11,4,5,29,18,11,37
Spart Moscow,9572,3,10,6,4,40,26,14,36
Krasnodar,9572,4,9,5,6,31,25,6,32
Zenit,9572,5,7,10,3,23,15,8,31
Terek Grozny,9572,6,7,5,8,21,28,-7,26
FK Rubin,9572,7,6,5,9,23,20,3,23
Din Moscow,9572,8,5,6,9,17,27,-10,21
Amkar,9572,9,5,5,10,12,24,-12,20
Rostov,9572,10,4,6,10,10,19,-9,18
Anzhi,9572,11,3,5,12,18,40,-22,14
Loko Moscow,9573,1,11,5,4,30,15,15,38
CSKA Moscow,9573,2,11,4,5,28,19,9,37
Zenit,9573,3,8,9,3,23,14,9,33
Spart Moscow,9573,4,9,6,5,37,30,7,33
Krasnodar,9573,5,9,4,7,30,26,4,31
Terek Grozny,9573,6,7,6,7,21,25,-4,27
FK Rubin,9573,7,6,6,8,24,19,5,24
Din Moscow,9573,8,5,7,8,19,24,-5,22
Amkar,9573,9,5,5,10,14,25,-11,20
Rostov,9573,10,4,7,9,11,18,-7,19
Anzhi,9573,11,3,5,12,17,39,-22,14
Loko Moscow,9574,1,11,6,3,30,13,17,39
CSKA Moscow,9574,2,11,4,5,27,18,9,37
Spart Moscow,9574,3,10,6,4,37,27,10,36
Krasnodar,9574,4,10,4,6,31,25,6,34
Zenit,9574,5,7,9,4,22,15,7,30
Terek Grozny,9574,6,7,5,8,21,25,-4,26
Din Moscow,9574,7,6,6,8,20,23,-3,24
FK Rubin,9574,8,5,5,10,21,21,0,20
Rostov,9574,9,4,7,9,11,18,-7,19
Amkar,9574,10,5,4,11,10,23,-13,19
Anzhi,9574,11,3,6,11,16,38,-22,15
CSKA Moscow,9575,1,12,3,5,28,17,11,39
Loko Moscow,9575,2,11,5,4,29,13,16,38
Krasnodar,9575,3,10,4,6,31,25,6,34
Zenit,9575,4,8,8,4,22,14,8,32
Spart Moscow,9575,5,8,7,5,35,29,6,31
Terek Grozny,9575,6,7,5,8,21,25,-4,26
Din Moscow,9575,7,5,8,7,19,23,-4,23
FK Rubin,9575,8,5,6,9,22,20,2,21
Rostov,9575,9,5,6,9,12,17,-5,21
Amkar,9575,10,5,5,10,10,22,-12,20
Anzhi,9575,11,3,5,12,16,40,-24,14
Loko Moscow,9576,1,11,5,4,29,15,14,38
Zenit,9576,2,9,8,3,26,14,12,35
Spart Moscow,9576,3,9,7,4,37,28,9,34
CSKA Moscow,9576,4,10,4,6,27,20,7,34
Krasnodar,9576,5,10,4,6,31,26,5,34
Terek Grozny,9576,6,9,5,6,23,23,0,32
FK Rubin,9576,7,6,5,9,27,21,6,23
Din Moscow,9576,8,5,6,9,18,26,-8,21
Rostov,9576,9,4,7,9,11,18,-7,19
Amkar,9576,10,4,5,11,11,25,-14,17
Anzhi,9576,11,2,6,12,16,40,-24,12
Loko Moscow,9577,1,11,6,3,31,14,17,39
Spart Moscow,9577,2,10,6,4,39,27,12,36
CSKA Moscow,9577,3,11,3,6,28,19,9,36
Krasnodar,9577,4,10,4,6,29,24,5,34
Zenit,9577,5,8,9,3,24,15,9,33
Terek Grozny,9577,6,7,6,7,23,26,-3,27
Din Moscow,9577,7,6,6,8,19,24,-5,24
FK Rubin,9577,8,5,5,10,21,20,1,20
Rostov,9577,9,4,7,9,12,19,-7,19
Amkar,9577,10,5,4,11,11,24,-13,19
Anzhi,9577,11,2,6,12,17,42,-25,12
Loko Moscow,9578,1,11,7,2,31,13,18,40
Spart Moscow,9578,2,9,6,5,39,30,9,33
Zenit,9578,3,8,9,3,26,17,9,33
CSKA Moscow,9578,4,10,3,7,28,22,6,33
Krasnodar,9578,5,8,5,7,28,27,1,29
Terek Grozny,9578,6,8,5,7,23,24,-1,29
FK Rubin,9578,7,6,6,8,26,20,6,24
Din Moscow,9578,8,5,7,8,21,27,-6,22
Amkar,9578,9,6,4,10,14,25,-11,22
Rostov,9578,10,4,7,9,11,18,-7,19
Anzhi,9578,11,3,5,12,15,39,-24,14
Loko Moscow,9579,1,12,5,3,31,13,18,41
CSKA Moscow,9579,2,10,5,5,28,20,8,35
Krasnodar,9579,3,10,4,6,30,25,5,34
Spart Moscow,9579,4,9,6,5,38,32,6,33
Zenit,9579,5,7,9,4,24,17,7,30
Terek Grozny,9579,6,7,7,6,23,25,-2,28
FK Rubin,9579,7,6,5,9,24,20,4,23
Din Moscow,9579,8,5,6,9,18,25,-7,21
Amkar,9579,9,5,5,10,15,24,-9,20
Rostov,9579,10,4,7,9,12,19,-7,19
Anzhi,9579,11,2,7,11,17,40,-23,13
Loko Moscow,9580,1,12,6,2,31,12,19,42
CSKA Moscow,9580,2,11,4,5,27,18,9,37
Spart Moscow,9580,3,9,7,4,36,26,10,34
Krasnodar,9580,4,9,5,6,29,25,4,32
Zenit,9580,5,7,8,5,22,16,6,29
Terek Grozny,9580,6,7,6,7,21,24,-3,27
FK Rubin,9580,7,6,5,9,24,20,4,23
Din Moscow,9580,8,5,7,8,20,25,-5,22
Rostov,9580,9,4,6,10,10,19,-9,18
Amkar,9580,10,4,6,10,10,23,-13,18
Anzhi,9580,11,3,6,11,15,37,-22,15
Loko Moscow,9581,1,12,5,3,30,12,18,41
CSKA Moscow,9581,2,11,4,5,27,17,10,37
Krasnodar,9581,3,9,4,7,28,25,3,31
Zenit,9581,4,7,9,4,21,14,7,30
Spart Moscow,9581,5,8,6,6,35,29,6,30
Terek Grozny,9581,6,8,5,7,23,26,-3,29
Din Moscow,9581,7,6,7,7,20,22,-2,25
FK Rubin,9581,8,6,5,9,22,19,3,23
Amkar,9581,9,6,4,10,14,24,-10,22
Rostov,9581,10,5,6,9,11,17,-6,21
Anzhi,9581,11,2,5,13,15,41,-26,11
Loko Moscow,9582,1,12,5,3,33,15,18,41
CSKA Moscow,9582,2,11,4,5,28,19,9,37
Krasnodar,9582,3,10,4,6,32,27,5,34
Spart Moscow,9582,4,9,5,6,35,28,7,32
Zenit,9582,5,7,9,4,23,16,7,30
Terek Grozny,9582,6,7,5,8,21,25,-4,26
Din Moscow,9582,7,5,7,8,17,22,-5,22
Amkar,9582,8,6,4,10,12,23,-11,22
FK Rubin,9582,9,5,6,9,22,19,3,21
Rostov,9582,10,5,6,9,11,17,-6,21
Anzhi,9582,11,3,5,12,17,40,-23,14
Loko Moscow,9583,1,11,7,2,32,14,18,40
Spart Moscow,9583,2,11,5,4,38,27,11,38
CSKA Moscow,9583,3,11,3,6,28,19,9,36
Zenit,9583,4,8,9,3,23,14,9,33
Krasnodar,9583,5,9,5,6,32,26,6,32
Terek Grozny,9583,6,8,6,6,22,23,-1,30
Din Moscow,9583,7,6,6,8,19,23,-4,24
FK Rubin,9583,8,5,5,10,22,22,0,20
Rostov,9583,9,4,6,10,12,20,-8,18
Amkar,9583,10,4,5,11,10,24,-14,17
Anzhi,9583,11,2,5,13,15,41,-26,11
Loko Moscow,9584,1,11,5,4,29,13,16,38
Spart Moscow,9584,2,10,6,4,38,27,11,36
Zenit,9584,3,9,8,3,24,14,10,35
CSKA Moscow,9584,4,10,4,6,27,20,7,34
Krasnodar,9584,5,9,4,7,28,26,2,31
Terek Grozny,9584,6,8,6,6,23,24,-1,30
Din Moscow,9584,7,6,6,8,19,24,-5,24
FK Rubin,9584,8,6,5,9,24,19,5,23
Rostov,9584,9,4,6,10,11,19,-8,18
Amkar,9584,10,4,5,11,11,25,-14,17
Anzhi,9584,11,2,7,11,16,39,-23,13
Loko Moscow,9585,1,13,5,2,35,12,23,44
CSKA Moscow,9585,2,11,4,5,29,17,12,37
Spart Moscow,9585,3,10,5,5,37,29,8,35
Zenit,9585,4,7,9,4,22,16,6,30
Terek Grozny,9585,5,8,6,6,21,22,-1,30
Krasnodar,9585,6,8,5,7,28,28,0,29
Din Moscow,9585,7,6,6,8,19,23,-4,24
FK Rubin,9585,8,5,6,9,23,20,3,21
Amkar,9585,9,5,4,11,12,24,-12,19
Rostov,9585,10,4,6,10,11,19,-8,18
Anzhi,9585,11,2,6,12,14,41,-27,12
Loko Moscow,9586,1,11,6,3,30,13,17,39
Spart Moscow,9586,2,10,6,4,38,27,11,36
CSKA Moscow,9586,3,11,3,6,31,22,9,36
Zenit,9586,4,8,9,3,25,16,9,33
Krasnodar,9586,5,9,5,6,28,24,4,32
Terek Grozny,9586,6,7,6,7,20,23,-3,27
Din Moscow,9586,7,6,6,8,19,23,-4,24
FK Rubin,9586,8,5,6,9,21,18,3,21
Amkar,9586,9,5,5,10,11,23,-12,20
Rostov,9586,10,4,6,10,10,19,-9,18
Anzhi,9586,11,2,6,12,16,41,-25,12
Loko Moscow,9587,1,11,5,4,29,16,13,38
CSKA Moscow,9587,2,11,3,6,28,21,7,36
Zenit,9587,3,9,8,3,25,14,11,35
Spart Moscow,9587,4,9,7,4,40,30,10,34
Krasnodar,9587,5,10,4,6,32,24,8,34
Terek Grozny,9587,6,7,6,7,20,24,-4,27
Din Moscow,9587,7,6,6,8,19,23,-4,24
FK Rubin,9587,8,5,5,10,21,20,1,20
Amkar,9587,9,5,5,10,14,25,-11,20
Rostov,9587,10,4,7,9,12,19,-7,19
Anzhi,9587,11,2,6,12,15,39,-24,12
Loko Moscow,9588,1,11,5,4,30,14,16,38
Spart Moscow,9588,2,10,6,4,39,28,11,36
Zenit,9588,3,9,8,3,24,13,11,35
CSKA Moscow,9588,4,10,4,6,28,22,6,34
Krasnodar,9588,5,10,4,6,33,28,5,34
Terek Grozny,9588,6,8,5,7,22,24,-2,29
Din Moscow,9588,7,5,8,7,20,24,-4,23
FK Rubin,9588,8,5,6,9,24,21,3,21
Amkar,9588,9,5,4,11,11,24,-13,19
Rostov,9588,10,4,6,10,10,19,-9,18
Anzhi,9588,11,2,6,12,17,41,-24,12
Loko Moscow,9589,1,12,5,3,32,13,19,41
CSKA Moscow,9589,2,12,3,5,30,18,12,39
Spart Moscow,9589,3,9,6,5,39,29,10,33
Zenit,9589,4,8,8,4,23,14,9,32
Krasnodar,9589,5,9,4,7,33,29,4,31
Terek Grozny,9589,6,8,6,6,21,22,-1,30
FK Rubin,9589,7,6,5,9,25,23,2,23
Rostov,9589,8,5,6,9,12,18,-6,21
Din Moscow,9589,9,5,6,9,18,27,-9,21
Amkar,9589,10,4,5,11,10,24,-14,17
Anzhi,9589,11,2,6,12,15,41,-26,12
Loko Moscow,9590,1,13,5,2,35,11,24,44
Spart Moscow,9590,2,9,6,5,36,28,8,33
CSKA Moscow,9590,3,10,3,7,25,19,6,33
Zenit,9590,4,8,8,4,22,16,6,32
Terek Grozny,9590,5,9,5,6,22,22,0,32
Krasnodar,9590,6,9,4,7,29,27,2,31
Din Moscow,9590,7,6,7,7,20,23,-3,25
FK Rubin,9590,8,5,6,9,22,20,2,21
Rostov,9590,9,4,7,9,10,17,-7,19
Amkar,9590,10,4,4,12,10,25,-15,16
Anzhi,9590,11,3,5,12,15,38,-23,14
CSKA Moscow,9591,1,12,3,5,31,18,13,39
Loko Moscow,9591,2,11,5,4,29,15,14,38
Krasnodar,9591,3,10,4,6,33,24,9,34
Spart Moscow,9591,4,9,6,5,35,27,8,33
Zenit,9591,5,8,8,4,22,16,6,32
Terek Grozny,9591,6,7,5,8,22,28,-6,26
Din Moscow,9591,7,6,6,8,18,22,-4,24
Rostov,9591,8,5,6,9,11,17,-6,21
FK Rubin,9591,9,5,5,10,21,21,0,20
Amkar,9591,10,5,5,10,14,24,-10,20
Anzhi,9591,11,3,5,12,17,41,-24,14
Loko Moscow,9592,1,11,5,4,30,16,14,38
Spart Moscow,9592,2,10,6,4,41,28,13,36
CSKA Moscow,9592,3,11,3,6,32,21,11,36
Zenit,9592,4,9,8,3,25,14,11,35
Krasnodar,9592,5,9,5,6,32,26,6,32
Terek Grozny,9592,6,7,5,8,21,26,-5,26
Din Moscow,9592,7,5,8,7,21,25,-4,23
FK Rubin,9592,8,5,7,8,25,21,4,22
Amkar,9592,9,5,4,11,12,26,-14,19
Rostov,9592,10,4,6,10,11,21,-10,18
Anzhi,9592,11,3,5,12,17,43,-26,14
Loko Moscow,9593,1,11,6,3,31,14,17,39
Spart Moscow,9593,2,10,5,5,39,28,11,35
CSKA Moscow,9593,3,10,4,6,26,19,7,34
Krasnodar,9593,4,10,4,6,32,26,6,34
Zenit,9593,5,8,9,3,24,15,9,33
Terek Grozny,9593,6,7,5,8,22,27,-5,26
Din Moscow,9593,7,5,7,8,17,24,-7,22
Amkar,9593,8,6,4,10,13,23,-10,22
FK Rubin,9593,9,5,6,9,23,21,2,21
Rostov,9593,10,4,6,10,11,20,-9,18
Anzhi,9593,11,3,6,11,18,39,-21,15
Loko Moscow,9594,1,12,6,2,30,11,19,42
CSKA Moscow,9594,2,12,3,5,28,17,11,39
Spart Moscow,9594,3,9,6,5,36,28,8,33
Zenit,9594,4,7,9,4,21,15,6,30
Krasnodar,9594,5,8,4,8,28,27,1,28
Terek Grozny,9594,6,7,6,7,23,26,-3,27
Din Moscow,9594,7,6,6,8,19,24,-5,24
FK Rubin,9594,8,6,5,9,24,20,4,23
Amkar,9594,9,5,5,10,13,24,-11,20
Rostov,9594,10,4,7,9,10,17,-7,19
Anzhi,9594,11,3,5,12,17,40,-23,14
Loko Moscow,9595,1,13,5,2,32,12,20,44
CSKA Moscow,9595,2,11,4,5,28,17,11,37
Zenit,9595,3,7,9,4,21,14,7,30
Spart Moscow,9595,4,8,6,6,39,33,6,30
Terek Grozny,9595,5,8,5,7,23,24,-1,29
Krasnodar,9595,6,8,4,8,28,27,1,28
FK Rubin,9595,7,7,5,8,23,17,6,26
Din Moscow,9595,8,6,6,8,20,24,-4,24
Amkar,9595,9,6,4,10,14,25,-11,22
Rostov,9595,10,4,7,9,11,18,-7,19
Anzhi,9595,11,2,5,13,15,43,-28,11
Loko Moscow,9596,1,12,6,2,32,12,20,42
CSKA Moscow,9596,2,11,4,5,27,18,9,37
Zenit,9596,3,7,10,3,22,14,8,31
Spart Moscow,9596,4,8,6,6,34,29,5,30
Terek Grozny,9596,5,8,6,6,22,22,0,30
Krasnodar,9596,6,8,4,8,28,29,-1,28
Din Moscow,9596,7,6,7,7,20,23,-3,25
FK Rubin,9596,8,6,5,9,25,20,5,23
Rostov,9596,9,5,6,9,11,17,-6,21
Amkar,9596,10,5,5,10,11,22,-11,20
Anzhi,9596,11,2,5,13,15,41,-26,11
Loko Moscow,9597,1,13,5,2,34,12,22,44
CSKA Moscow,9597,2,11,4,5,30,19,11,37
Spart Moscow,9597,3,10,6,4,39,27,12,36
Krasnodar,9597,4,9,4,7,28,27,1,31
Zenit,9597,5,7,9,4,24,17,7,30
Terek Grozny,9597,6,7,6,7,23,26,-3,27
Din Moscow,9597,7,6,7,7,21,24,-3,25
FK Rubin,9597,8,5,5,10,23,21,2,20
Rostov,9597,9,4,6,10,10,20,-10,18
Amkar,9597,10,4,5,11,13,27,-14,17
Anzhi,9597,11,3,5,12,15,40,-25,14
Loko Moscow,9598,1,11,6,3,31,16,15,39
CSKA Moscow,9598,2,12,3,5,30,19,11,39
Spart Moscow,9598,3,9,7,4,39,28,11,34
Krasnodar,9598,4,10,4,6,35,25,10,34
Zenit,9598,5,7,9,4,22,15,7,30
Terek Grozny,9598,6,8,5,7,23,24,-1,29
Din Moscow,9598,7,6,6,8,20,26,-6,24
FK Rubin,9598,8,5,5,10,22,23,-1,20
Amkar,9598,9,5,5,10,12,24,-12,20
Rostov,9598,10,4,7,9,11,18,-7,19
Anzhi,9598,11,2,5,13,16,43,-27,11
Loko Moscow,9599,1,12,5,3,33,14,19,41
Spart Moscow,9599,2,10,6,4,37,27,10,36
CSKA Moscow,9599,3,11,3,6,26,18,8,36
Zenit,9599,4,8,8,4,22,16,6,32
Krasnodar,9599,5,9,5,6,31,26,5,32
Terek Grozny,9599,6,8,5,7,26,25,1,29
FK Rubin,9599,7,6,6,8,23,18,5,24
Din Moscow,9599,8,5,7,8,18,23,-5,22
Amkar,9599,9,5,4,11,11,24,-13,19
Rostov,9599,10,4,6,10,11,19,-8,18
Anzhi,9599,11,2,5,13,15,43,-28,11
Loko Moscow,9600,1,12,5,3,33,14,19,41
CSKA Moscow,9600,2,11,3,6,27,18,9,36
Zenit,9600,3,9,8,3,23,13,10,35
Terek Grozny,9600,4,9,5,6,24,22,2,32
Spart Moscow,9600,5,8,5,7,37,35,2,29
Krasnodar,9600,6,8,5,7,30,29,1,29
Din Moscow,9600,7,7,6,7,21,22,-1,27
FK Rubin,9600,8,5,6,9,22,19,3,21
Rostov,9600,9,5,6,9,13,17,-4,21
Amkar,9600,10,5,4,11,13,26,-13,19
Anzhi,9600,11,2,5,13,14,42,-28,11
Loko Moscow,9601,1,12,5,3,32,13,19,41
CSKA Moscow,9601,2,11,4,5,27,17,10,37
Spart Moscow,9601,3,10,5,5,37,28,9,35
Zenit,9601,4,8,9,3,23,13,10,33
Krasnodar,9601,5,9,4,7,28,27,1,31
Terek Grozny,9601,6,7,5,8,21,26,-5,26
Din Moscow,9601,7,6,7,7,19,22,-3,25
FK Rubin,9601,8,5,6,9,22,19,3,21
Amkar,9601,9,5,4,11,10,23,-13,19
Rostov,9601,10,4,6,10,12,20,-8,18
Anzhi,9601,11,3,5,12,17,40,-23,14
Loko Moscow,9602,1,11,5,4,31,16,15,38
CSKA Moscow,9602,2,11,4,5,27,18,9,37
Zenit,9602,3,8,9,3,24,14,10,33
Krasnodar,9602,4,9,5,6,30,26,4,32
Spart Moscow,9602,5,8,6,6,34,28,6,30
Terek Grozny,9602,6,7,6,7,21,24,-3,27
FK Rubin,9602,7,6,6,8,22,17,5,24
Din Moscow,9602,8,6,6,8,18,22,-4,24
Rostov,9602,9,5,6,9,11,17,-6,21
Amkar,9602,10,4,6,10,10,23,-13,18
Anzhi,9602,11,3,5,12,16,39,-23,14
Loko Moscow,9603,1,12,6,2,31,12,19,42
Spart Moscow,9603,2,10,6,4,39,28,11,36
CSKA Moscow,9603,3,10,3,7,25,22,3,33
Zenit,9603,4,8,8,4,25,15,10,32
Terek Grozny,9603,5,9,5,6,23,22,1,32
Krasnodar,9603,6,8,5,7,28,26,2,29
FK Rubin,9603,7,7,5,8,25,18,7,26
Din Moscow,9603,8,5,6,9,17,25,-8,21
Rostov,9603,9,4,6,10,12,20,-8,18
Amkar,9603,10,4,5,11,10,24,-14,17
Anzhi,9603,11,3,5,12,16,39,-23,14
Loko Moscow,9604,1,11,7,2,32,14,18,40
CSKA Moscow,9604,2,12,3,5,31,17,14,39
Spart Moscow,9604,3,8,8,4,36,28,8,32
Zenit,9604,4,7,9,4,23,17,6,30
Terek Grozny,9604,5,8,6,6,23,23,0,30
Krasnodar,9604,6,8,5,7,29,28,1,29
FK Rubin,9604,7,7,5,8,27,19,8,26
Din Moscow,9604,8,5,7,8,20,26,-6,22
Rostov,9604,9,4,7,9,10,17,-7,19
Amkar,9604,10,4,6,10,11,24,-13,18
Anzhi,9604,11,2,5,13,14,43,-29,11
Loko Moscow,9605,1,11,5,4,30,14,16,38
CSKA Moscow,9605,2,11,3,6,28,19,9,36
Spart Moscow,9605,3,10,5,5,39,27,12,35
Zenit,9605,4,9,8,3,24,13,11,35
Krasnodar,9605,5,9,4,7,30,28,2,31
Terek Grozny,9605,6,8,5,7,22,24,-2,29
FK Rubin,9605,7,6,6,8,24,18,6,24
Din Moscow,9605,8,5,7,8,17,23,-6,22
Amkar,9605,9,6,4,10,11,22,-11,22
Rostov,9605,10,4,6,10,11,21,-10,18
Anzhi,9605,11,2,5,13,15,42,-27,11
Loko Moscow,9606,1,12,6,2,31,11,20,42
CSKA Moscow,9606,2,12,3,5,33,20,13,39
Spart Moscow,9606,3,9,7,4,37,27,10,34
Krasnodar,9606,4,9,4,7,29,27,2,31
Zenit,9606,5,7,9,4,21,14,7,30
Terek Grozny,9606,6,8,6,6,23,24,-1,30
FK Rubin,9606,7,6,5,9,25,21,4,23
Din Moscow,9606,8,5,7,8,19,24,-5,22
Rostov,9606,9,4,6,10,11,20,-9,18
Amkar,9606,10,4,5,11,10,24,-14,17
Anzhi,9606,11,2,6,12,19,46,-27,12
Loko Moscow,9607,1,11,5,4,29,13,16,38
CSKA Moscow,9607,2,11,3,6,29,21,8,36
Spart Moscow,9607,3,9,5,6,38,29,9,32
Zenit,9607,4,8,8,4,22,14,8,32
Krasnodar,9607,5,9,5,6,29,25,4,32
Terek Grozny,9607,6,8,6,6,23,24,-1,30
FK Rubin,9607,7,6,6,8,23,18,5,24
Rostov,9607,8,5,6,9,12,18,-6,21
Din Moscow,9607,9,5,6,9,17,25,-8,21
Amkar,9607,10,5,4,11,12,25,-13,19
Anzhi,9607,11,3,6,11,19,41,-22,15
Loko Moscow,9608,1,12,6,2,34,13,21,42
Spart Moscow,9608,2,11,5,4,40,28,12,38
CSKA Moscow,9608,3,11,3,6,26,18,8,36
Zenit,9608,4,8,9,3,23,14,9,33
Krasnodar,9608,5,9,4,7,30,29,1,31
Terek Grozny,9608,6,7,5,8,21,26,-5,26
Din Moscow,9608,7,6,6,8,19,23,-4,24
FK Rubin,9608,8,5,5,10,23,21,2,20
Amkar,9608,9,5,4,11,11,25,-14,19
Rostov,9608,10,4,6,10,12,20,-8,18
Anzhi,9608,11,3,5,12,17,39,-22,14
CSKA Moscow,9609,1,12,3,5,29,17,12,39
Loko Moscow,9609,2,11,5,4,29,15,14,38
Krasnodar,9609,3,10,4,6,30,24,6,34
Spart Moscow,9609,4,9,6,5,37,30,7,33
Zenit,9609,5,8,8,4,23,14,9,32
Terek Grozny,9609,6,8,5,7,23,25,-2,29
Din Moscow,9609,7,7,6,7,23,22,1,27
FK Rubin,9609,8,5,5,10,22,22,0,20
Amkar,9609,9,5,5,10,13,25,-12,20
Rostov,9609,10,4,6,10,11,19,-8,18
Anzhi,9609,11,2,5,13,15,42,-27,11
Loko Moscow,9610,1,13,5,2,31,11,20,44
CSKA Moscow,9610,2,11,4,5,27,17,10,37
Spart Moscow,9610,3,8,7,5,35,29,6,31
Zenit,9610,4,7,9,4,21,14,7,30
Krasnodar,9610,5,8,5,7,27,25,2,29
Terek Grozny,9610,6,7,6,7,20,25,-5,27
Din Moscow,9610,7,6,7,7,21,22,-1,25
Amkar,9610,8,6,4,10,14,22,-8,22
FK Rubin,9610,9,5,6,9,21,20,1,21
Rostov,9610,10,4,7,9,11,18,-7,19
Anzhi,9610,11,2,6,12,14,39,-25,12
Loko Moscow,9611,1,11,6,3,31,14,17,39
Zenit,9611,2,9,8,3,25,15,10,35
CSKA Moscow,9611,3,10,4,6,28,21,7,34
Spart Moscow,9611,4,9,6,5,38,30,8,33
Terek Grozny,9611,5,9,5,6,24,23,1,32
Krasnodar,9611,6,8,6,6,28,25,3,30
FK Rubin,9611,7,6,6,8,24,17,7,24
Din Moscow,9611,8,6,6,8,21,27,-6,24
Rostov,9611,9,4,7,9,11,18,-7,19
Amkar,9611,10,4,4,12,9,24,-15,16
Anzhi,9611,11,2,6,12,17,42,-25,12
Loko Moscow,9612,1,13,5,2,33,12,21,44
CSKA Moscow,9612,2,11,4,5,27,17,10,37
Spart Moscow,9612,3,10,5,5,38,28,10,35
Krasnodar,9612,4,9,4,7,30,27,3,31
Zenit,9612,5,7,9,4,21,15,6,30
Terek Grozny,9612,6,8,6,6,22,23,-1,30
FK Rubin,9612,7,6,5,9,23,19,4,23
Din Moscow,9612,8,5,6,9,17,23,-6,21
Amkar,9612,9,5,4,11,11,24,-13,19
Rostov,9612,10,4,6,10,11,20,-9,18
Anzhi,9612,11,2,6,12,15,40,-25,12
Loko Moscow,9613,1,13,5,2,33,11,22,44
CSKA Moscow,9613,2,11,4,5,29,19,10,37
Spart Moscow,9613,3,9,6,5,37,27,10,33
Krasnodar,9613,4,9,4,7,30,26,4,31
Zenit,9613,5,7,9,4,22,16,6,30
Terek Grozny,9613,6,8,5,7,21,23,-2,29
Din Moscow,9613,7,6,6,8,18,24,-6,24
Amkar,9613,8,6,4,10,12,23,-11,22
FK Rubin,9613,9,5,5,10,21,21,0,20
Rostov,9613,10,4,7,9,10,17,-7,19
Anzhi,9613,11,2,5,13,15,41,-26,11
Loko Moscow,9614,1,11,6,3,31,14,17,39
Zenit,9614,2,9,8,3,24,14,10,35
CSKA Moscow,9614,3,10,3,7,26,21,5,33
Krasnodar,9614,4,9,5,6,34,26,8,32
Spart Moscow,9614,5,9,5,6,37,30,7,32
Terek Grozny,9614,6,9,5,6,23,23,0,32
Din Moscow,9614,7,6,6,8,21,23,-2,24
Rostov,9614,8,5,6,9,13,19,-6,21
FK Rubin,9614,9,5,5,10,21,25,-4,20
Amkar,9614,10,5,4,11,10,23,-13,19
Anzhi,9614,11,3,5,12,17,39,-22,14
Loko Moscow,9615,1,11,7,2,30,12,18,40
CSKA Moscow,9615,2,11,4,5,27,18,9,37
Zenit,9615,3,7,10,3,22,14,8,31
Spart Moscow,9615,4,8,7,5,37,31,6,31
Krasnodar,9615,5,8,5,7,28,29,-1,29
Terek Grozny,9615,6,8,5,7,23,24,-1,29
FK Rubin,9615,7,6,6,8,25,17,8,24
Din Moscow,9615,8,5,8,7,20,24,-4,23
Rostov,9615,9,4,7,9,11,18,-7,19
Amkar,9615,10,5,4,11,11,25,-14,19
Anzhi,9615,11,3,5,12,16,38,-22,14
Loko Moscow,9616,1,12,5,3,31,13,18,41
Spart Moscow,9616,2,10,5,5,40,31,9,35
CSKA Moscow,9616,3,10,3,7,26,21,5,33
Zenit,9616,4,8,8,4,23,15,8,32
Krasnodar,9616,5,9,5,6,30,26,4,32
Din Moscow,9616,6,7,6,7,23,22,1,27
Terek Grozny,9616,7,7,6,7,21,24,-3,27
FK Rubin,9616,8,5,6,9,24,22,2,21
Rostov,9616,9,4,6,10,12,21,-9,18
Amkar,9616,10,4,5,11,10,25,-15,17
Anzhi,9616,11,4,5,11,19,39,-20,17
Loko Moscow,9617,1,12,5,3,30,15,15,41
Spart Moscow,9617,2,9,7,4,38,28,10,34
CSKA Moscow,9617,3,10,4,6,26,20,6,34
Zenit,9617,4,8,8,4,23,14,9,32
Krasnodar,9617,5,9,5,6,33,26,7,32
Terek Grozny,9617,6,8,6,6,24,22,2,30
FK Rubin,9617,7,6,6,8,27,19,8,24
Din Moscow,9617,8,5,7,8,19,27,-8,22
Rostov,9617,9,4,7,9,11,18,-7,19
Amkar,9617,10,4,5,11,9,24,-15,17
Anzhi,9617,11,2,6,12,15,42,-27,12
Loko Moscow,9618,1,12,6,2,30,11,19,42
CSKA Moscow,9618,2,11,4,5,27,18,9,37
Spart Moscow,9618,3,10,6,4,38,27,11,36
Zenit,9618,4,7,10,3,22,14,8,31
Krasnodar,9618,5,9,4,7,29,26,3,31
Terek Grozny,9618,6,8,6,6,23,23,0,30
Din Moscow,9618,7,6,7,7,18,21,-3,25
FK Rubin,9618,8,5,5,10,22,20,2,20
Rostov,9618,9,4,6,10,11,20,-9,18
Amkar,9618,10,4,4,12,10,26,-16,16
Anzhi,9618,11,2,6,12,15,39,-24,12
Loko Moscow,9619,1,13,5,2,35,11,24,44
CSKA Moscow,9619,2,11,3,6,29,20,9,36
Zenit,9619,3,8,8,4,23,15,8,32
Spart Moscow,9619,4,8,6,6,38,33,5,30
Terek Grozny,9619,5,8,5,7,21,24,-3,29
Krasnodar,9619,6,8,4,8,27,30,-3,28
FK Rubin,9619,7,6,6,8,23,18,5,24
Din Moscow,9619,8,5,8,7,20,24,-4,23
Rostov,9619,9,5,6,9,13,18,-5,21
Amkar,9619,10,5,4,11,12,25,-13,19
Anzhi,9619,11,3,5,12,17,40,-23,14
Loko Moscow,9620,1,12,5,3,34,14,20,41
CSKA Moscow,9620,2,11,3,6,27,18,9,36
Spart Moscow,9620,3,10,5,5,39,29,10,35
Krasnodar,9620,4,10,4,6,31,24,7,34
Zenit,9620,5,8,8,4,22,18,4,32
Terek Grozny,9620,6,7,5,8,21,25,-4,26
Din Moscow,9620,7,5,7,8,18,24,-6,22
Amkar,9620,8,6,4,10,12,23,-11,22
FK Rubin,9620,9,5,6,9,21,18,3,21
Rostov,9620,10,4,6,10,11,19,-8,18
Anzhi,9620,11,3,5,12,16,40,-24,14
Loko Moscow,9621,1,12,6,2,31,12,19,42
CSKA Moscow,9621,2,11,3,6,27,19,8,36
Spart Moscow,9621,3,9,7,4,35,26,9,34
Zenit,9621,4,8,8,4,23,15,8,32
Krasnodar,9621,5,9,5,6,31,27,4,32
Terek Grozny,9621,6,7,6,7,22,25,-3,27
FK Rubin,9621,7,6,5,9,25,20,5,23
Din Moscow,9621,8,5,7,8,18,24,-6,22
Rostov,9621,9,4,6,10,10,18,-8,18
Amkar,9621,10,4,6,10,10,23,-13,18
Anzhi,9621,11,3,5,12,16,39,-23,14
Loko Moscow,9622,1,12,5,3,33,15,18,41
Krasnodar,9622,2,10,4,6,32,26,6,34
CSKA Moscow,9622,3,10,3,7,25,19,6,33
Zenit,9622,4,8,8,4,22,15,7,32
Spart Moscow,9622,5,8,5,7,36,33,3,29
Terek Grozny,9622,6,7,5,8,23,28,-5,26
Din Moscow,9622,7,6,7,7,21,23,-2,25
Amkar,9622,8,6,4,10,14,25,-11,22
FK Rubin,9622,9,5,6,9,22,19,3,21
Rostov,9622,10,5,6,9,13,18,-5,21
Anzhi,9622,11,4,5,11,18,38,-20,17
Loko Moscow,9623,1,11,5,4,30,14,16,38
CSKA Moscow,9623,2,11,3,6,28,19,9,36
Zenit,9623,3,9,8,3,24,13,11,35
Spart Moscow,9623,4,9,6,5,37,30,7,33
Krasnodar,9623,5,9,5,6,32,28,4,32
Terek Grozny,9623,6,8,5,7,21,23,-2,29
FK Rubin,9623,7,6,6,8,26,20,6,24
Din Moscow,9623,8,5,6,9,18,25,-7,21
Rostov,9623,9,4,7,9,11,18,-7,19
Amkar,9623,10,5,4,11,12,24,-12,19
Anzhi,9623,11,3,5,12,15,40,-25,14
Loko Moscow,9624,1,12,5,3,30,13,17,41
CSKA Moscow,9624,2,11,4,5,29,19,10,37
Spart Moscow,9624,3,9,7,4,38,29,9,34
Krasnodar,9624,4,9,5,6,29,24,5,32
Zenit,9624,5,7,9,4,22,15,7,30
Terek Grozny,9624,6,8,5,7,23,25,-2,29
Din Moscow,9624,7,6,6,8,20,23,-3,24
FK Rubin,9624,8,5,6,9,21,19,2,21
Rostov,9624,9,4,7,9,11,18,-7,19
Amkar,9624,10,4,5,11,12,26,-14,17
Anzhi,9624,11,3,5,12,17,41,-24,14
Loko Moscow,9625,1,13,5,2,32,12,20,44
CSKA Moscow,9625,2,12,3,5,29,19,10,39
Spart Moscow,9625,3,9,6,5,38,29,9,33
Krasnodar,9625,4,9,4,7,29,26,3,31
Zenit,9625,5,7,8,5,22,16,6,29
Terek Grozny,9625,6,7,6,7,24,27,-3,27
Din Moscow,9625,7,5,7,8,18,24,-6,22
Amkar,9625,8,6,4,10,13,24,-11,22
FK Rubin,9625,9,5,6,9,21,18,3,21
Rostov,9625,10,4,7,9,12,19,-7,19
Anzhi,9625,11,2,6,12,17,41,-24,12
Loko Moscow,9626,1,12,5,3,32,16,16,41
Spart Moscow,9626,2,9,7,4,38,29,9,34
CSKA Moscow,9626,3,10,4,6,27,20,7,34
Krasnodar,9626,4,9,4,7,31,26,5,31
Zenit,9626,5,7,9,4,24,17,7,30
Terek Grozny,9626,6,8,5,7,24,26,-2,29
FK Rubin,9626,7,6,6,8,23,18,5,24
Din Moscow,9626,8,5,8,7,19,23,-4,23
Amkar,9626,9,5,5,10,13,25,-12,20
Rostov,9626,10,4,6,10,10,18,-8,18
Anzhi,9626,11,3,5,12,18,41,-23,14
Loko Moscow,9627,1,11,7,2,31,13,18,40
Spart Moscow,9627,2,10,6,4,37,26,11,36
CSKA Moscow,9627,3,11,3,6,29,21,8,36
Zenit,9627,4,8,9,3,26,15,11,33
Krasnodar,9627,5,9,5,6,28,24,4,32
Terek Grozny,9627,6,7,7,6,22,24,-2,28
Din Moscow,9627,7,6,6,8,18,23,-5,24
FK Rubin,9627,8,5,5,10,21,19,2,20
Rostov,9627,9,4,7,9,11,18,-7,19
Amkar,9627,10,4,5,11,10,24,-14,17
Anzhi,9627,11,2,6,12,16,42,-26,12
Loko Moscow,9628,1,11,6,3,30,14,16,39
CSKA Moscow,9628,2,12,3,5,28,17,11,39
Spart Moscow,9628,3,10,5,5,39,28,11,35
Krasnodar,9628,4,10,4,6,33,24,9,34
Zenit,9628,5,7,9,4,22,15,7,30
Terek Grozny,9628,6,8,5,7,22,24,-2,29
Din Moscow,9628,7,6,6,8,19,25,-6,24
Rostov,9628,8,5,6,9,11,17,-6,21
FK Rubin,9628,9,5,5,10,21,22,-1,20
Amkar,9628,10,4,4,12,11,26,-15,16
Anzhi,9628,11,3,5,12,15,39,-24,14
Loko Moscow,9629,1,12,5,3,31,13,18,41
CSKA Moscow,9629,2,11,3,6,27,18,9,36
Krasnodar,9629,3,9,4,7,28,26,2,31
Spart Moscow,9629,4,8,6,6,36,30,6,30
Terek Grozny,9629,5,8,6,6,24,23,1,30
Zenit,9629,6,7,8,5,22,17,5,29
Din Moscow,9629,7,6,7,7,20,23,-3,25
FK Rubin,9629,8,6,6,8,23,17,6,24
Amkar,9629,9,5,5,10,11,23,-12,20
Rostov,9629,10,4,7,9,10,17,-7,19
Anzhi,9629,11,3,5,12,16,41,-25,14
Loko Moscow,9630,1,12,5,3,32,12,20,41
CSKA Moscow,9630,2,11,3,6,27,19,8,36
Zenit,9630,3,9,8,3,23,13,10,35
Spart Moscow,9630,4,9,7,4,36,27,9,34
Krasnodar,9630,5,9,4,7,30,28,2,31
Terek Grozny,9630,6,7,5,8,21,25,-4,26
Din Moscow,9630,7,6,7,7,21,22,-1,25
FK Rubin,9630,8,5,5,10,22,23,-1,20
Rostov,9630,9,4,7,9,11,18,-7,19
Amkar,9630,10,5,4,11,10,23,-13,19
Anzhi,9630,11,3,5,12,17,40,-23,14
Loko Moscow,9631,1,12,5,3,30,12,18,41
CSKA Moscow,9631,2,11,4,5,29,18,11,37
Spart Moscow,9631,3,10,5,5,42,29,13,35
Zenit,9631,4,8,9,3,23,14,9,33
Krasnodar,9631,5,8,5,7,27,25,2,29
Terek Grozny,9631,6,7,5,8,20,27,-7,26
FK Rubin,9631,7,5,7,8,21,17,4,22
Din Moscow,9631,8,5,7,8,18,24,-6,22
Amkar,9631,9,6,4,10,14,24,-10,22
Rostov,9631,10,4,6,10,10,21,-11,18
Anzhi,9631,11,3,5,12,17,40,-23,14
Loko Moscow,9632,1,11,6,3,31,15,16,39
Spart Moscow,9632,2,10,6,4,37,26,11,36
CSKA Moscow,9632,3,11,3,6,27,21,6,36
Zenit,9632,4,8,9,3,27,15,12,33
Krasnodar,9632,5,9,5,6,29,24,5,32
Terek Grozny,9632,6,7,7,6,22,24,-2,28
Din Moscow,9632,7,5,8,7,18,22,-4,23
FK Rubin,9632,8,5,7,8,22,18,4,22
Rostov,9632,9,4,6,10,11,19,-8,18
Amkar,9632,10,4,5,11,10,25,-15,17
Anzhi,9632,11,2,6,12,15,40,-25,12
Loko Moscow,9633,1,13,5,2,34,13,21,44
CSKA Moscow,9633,2,10,4,6,26,19,7,34
Spart Moscow,9633,3,9,6,5,38,27,11,33
Zenit,9633,4,8,8,4,22,15,7,32
Terek Grozny,9633,5,8,6,6,24,24,0,30
Krasnodar,9633,6,8,4,8,29,28,1,28
FK Rubin,9633,7,7,5,8,24,18,6,26
Din Moscow,9633,8,5,6,9,18,27,-9,21
Amkar,9633,9,5,5,10,11,23,-12,20
Rostov,9633,10,4,7,9,11,18,-7,19
Anzhi,9633,11,2,6,12,16,41,-25,12
Loko Moscow,9634,1,12,6,2,32,13,19,42
CSKA Moscow,9634,2,11,4,5,28,18,10,37
Spart Moscow,9634,3,10,5,5,38,27,11,35
Zenit,9634,4,7,10,3,22,14,8,31
Krasnodar,9634,5,9,4,7,31,26,5,31
Terek Grozny,9634,6,7,5,8,21,25,-4,26
Din Moscow,9634,7,6,6,8,18,24,-6,24
FK Rubin,9634,8,6,5,9,24,20,4,23
Amkar,9634,9,5,4,11,11,24,-13,19
Rostov,9634,10,4,6,10,11,21,-10,18
Anzhi,9634,11,3,5,12,16,40,-24,14
Loko Moscow,9635,1,11,7,2,31,13,18,40
CSKA Moscow,9635,2,11,4,5,28,19,9,37
Krasnodar,9635,3,9,5,6,30,25,5,32
Zenit,9635,4,7,10,3,23,15,8,31
Spart Moscow,9635,5,8,6,6,37,32,5,30
Terek Grozny,9635,6,8,6,6,22,23,-1,30
Din Moscow,9635,7,6,7,7,21,23,-2,25
FK Rubin,9635,8,5,6,9,22,20,2,21
Rostov,9635,9,5,6,9,13,19,-6,21
Amkar,9635,10,4,5,11,11,25,-14,17
Anzhi,9635,11,2,6,12,15,39,-24,12
Loko Moscow,9636,1,12,5,3,30,12,18,41
Spart Moscow,9636,2,10,6,4,38,27,11,36
Zenit,9636,3,9,8,3,24,13,11,35
CSKA Moscow,9636,4,10,4,6,25,19,6,34
Krasnodar,9636,5,8,4,8,27,26,1,28
Terek Grozny,9636,6,7,6,7,20,23,-3,27
FK Rubin,9636,7,6,6,8,23,18,5,24
Din Moscow,9636,8,5,8,7,19,23,-4,23
Amkar,9636,9,5,4,11,10,24,-14,19
Rostov,9636,10,4,6,10,11,19,-8,18
Anzhi,9636,11,2,7,11,14,37,-23,13
Loko Moscow,9637,1,11,6,3,29,12,17,39
CSKA Moscow,9637,2,12,3,5,29,19,10,39
Spart Moscow,9637,3,10,5,5,38,28,10,35
Zenit,9637,4,8,8,4,24,16,8,32
Krasnodar,9637,5,9,5,6,29,25,4,32
Terek Grozny,9637,6,9,5,6,24,24,0,32
FK Rubin,9637,7,6,5,9,23,19,4,23
Rostov,9637,8,5,6,9,13,18,-5,21
Din Moscow,9637,9,5,6,9,17,24,-7,21
Amkar,9637,10,4,4,12,10,26,-16,16
Anzhi,9637,11,2,5,13,15,40,-25,11
Loko Moscow,9638,1,12,5,3,31,12,19,41
CSKA Moscow,9638,2,11,3,6,28,21,7,36
Spart Moscow,9638,3,9,6,5,38,29,9,33
Krasnodar,9638,4,9,5,6,29,25,4,32
Terek Grozny,9638,5,8,6,6,24,24,0,30
Zenit,9638,6,7,8,5,22,17,5,29
Din Moscow,9638,7,6,6,8,19,26,-7,24
FK Rubin,9638,8,5,6,9,23,20,3,21
Rostov,9638,9,4,7,9,10,17,-7,19
Amkar,9638,10,5,4,11,14,26,-12,19
Anzhi,9638,11,3,6,11,18,39,-21,15
Loko Moscow,9639,1,13,5,2,34,12,22,44
CSKA Moscow,9639,2,11,4,5,30,18,12,37
Spart Moscow,9639,3,10,6,4,41,28,13,36
Krasnodar,9639,4,9,4,7,32,28,4,31
Zenit,9639,5,7,9,4,22,16,6,30
Terek Grozny,9639,6,8,5,7,24,25,-1,29
Din Moscow,9639,7,6,7,7,21,24,-3,25
FK Rubin,9639,8,5,5,10,23,23,0,20
Amkar,9639,9,5,4,11,10,26,-16,19
Rostov,9639,10,4,6,10,11,19,-8,18
Anzhi,9639,11,2,5,13,16,45,-29,11
Loko Moscow,9640,1,12,6,2,31,12,19,42
CSKA Moscow,9640,2,11,4,5,28,18,10,37
Spart Moscow,9640,3,10,5,5,39,28,11,35
Krasnodar,9640,4,9,4,7,30,26,4,31
Zenit,9640,5,7,9,4,22,16,6,30
Terek Grozny,9640,6,7,6,7,21,25,-4,27
Din Moscow,9640,7,6,6,8,20,24,-4,24
Rostov,9640,8,5,6,9,11,17,-6,21
FK Rubin,9640,9,5,5,10,23,23,0,20
Amkar,9640,10,5,4,11,13,26,-13,19
Anzhi,9640,11,2,7,11,16,39,-23,13
Loko Moscow,9641,1,13,5,2,34,12,22,44
Spart Moscow,9641,2,11,5,4,41,28,13,38
CSKA Moscow,9641,3,11,3,6,26,19,7,36
Zenit,9641,4,8,8,4,23,16,7,32
Krasnodar,9641,5,8,4,8,29,29,0,28
Terek Grozny,9641,6,7,6,7,21,24,-3,27
Din Moscow,9641,7,6,6,8,20,23,-3,24
FK Rubin,9641,8,6,5,9,24,20,4,23
Rostov,9641,9,4,6,10,11,21,-10,18
Amkar,9641,10,4,5,11,10,24,-14,17
Anzhi,9641,11,3,5,12,16,39,-23,14
Loko Moscow,9642,1,11,6,3,32,15,17,39
CSKA Moscow,9642,2,12,3,5,29,18,11,39
Spart Moscow,9642,3,9,6,5,35,28,7,33
Zenit,9642,4,8,8,4,24,17,7,32
Krasnodar,9642,5,9,5,6,31,26,5,32
Terek Grozny,9642,6,9,5,6,27,23,4,32
Din Moscow,9642,7,6,7,7,20,23,-3,25
FK Rubin,9642,8,5,5,10,23,22,1,20
Amkar,9642,9,5,4,11,11,25,-14,19
Rostov,9642,10,4,6,10,10,18,-8,18
Anzhi,9642,11,2,5,13,16,43,-27,11
Loko Moscow,9643,1,11,6,3,32,15,17,39
CSKA Moscow,9643,2,11,3,6,27,19,8,36
Spart Moscow,9643,3,10,5,5,35,26,9,35
Krasnodar,9643,4,10,4,6,32,26,6,34
Zenit,9643,5,8,9,3,23,14,9,33
Terek Grozny,9643,6,7,6,7,23,26,-3,27
Din Moscow,9643,7,6,6,8,19,22,-3,24
Rostov,9643,8,5,6,9,11,17,-6,21
FK Rubin,9643,9,5,5,10,21,21,0,20
Amkar,9643,10,4,5,11,10,24,-14,17
Anzhi,9643,11,3,5,12,18,41,-23,14
Loko Moscow,9644,1,12,5,3,31,14,17,41
CSKA Moscow,9644,2,12,3,5,30,20,10,39
Spart Moscow,9644,3,11,5,4,39,27,12,38
Krasnodar,9644,4,9,5,6,30,25,5,32
Zenit,9644,5,7,8,5,23,17,6,29
Terek Grozny,9644,6,8,5,7,21,24,-3,29
FK Rubin,9644,7,5,7,8,25,21,4,22
Din Moscow,9644,8,5,7,8,21,26,-5,22
Amkar,9644,9,5,4,11,11,24,-13,19
Rostov,9644,10,4,6,10,11,19,-8,18
Anzhi,9644,11,2,5,13,16,41,-25,11
Loko Moscow,9645,1,11,6,3,31,14,17,39
Spart Moscow,9645,2,10,6,4,41,27,14,36
CSKA Moscow,9645,3,10,5,5,27,19,8,35
Krasnodar,9645,4,10,4,6,31,26,5,34
Zenit,9645,5,7,10,3,23,15,8,31
Terek Grozny,9645,6,7,6,7,22,27,-5,27
Din Moscow,9645,7,6,7,7,20,22,-2,25
FK Rubin,9645,8,5,5,10,22,21,1,20
Amkar,9645,9,5,4,11,13,25,-12,19
Rostov,9645,10,4,6,10,10,21,-11,18
Anzhi,9645,11,2,7,11,17,40,-23,13
Loko Moscow,9646,1,12,5,3,33,15,18,41
Spart Moscow,9646,2,10,5,5,38,28,10,35
CSKA Moscow,9646,3,10,4,6,28,21,7,34
Zenit,9646,4,8,8,4,23,16,7,32
Krasnodar,9646,5,9,5,6,32,27,5,32
Terek Grozny,9646,6,7,6,7,22,27,-5,27
FK Rubin,9646,7,5,7,8,23,19,4,22
Din Moscow,9646,8,5,7,8,19,25,-6,22
Amkar,9646,9,6,4,10,14,23,-9,22
Rostov,9646,10,4,6,10,11,19,-8,18
Anzhi,9646,11,2,7,11,17,40,-23,13
Loko Moscow,9647,1,13,5,2,32,12,20,44
CSKA Moscow,9647,2,12,3,5,31,19,12,39
Spart Moscow,9647,3,9,5,6,35,27,8,32
Krasnodar,9647,4,9,4,7,28,25,3,31
Zenit,9647,5,7,8,5,24,18,6,29
Terek Grozny,9647,6,8,5,7,23,25,-2,29
FK Rubin,9647,7,6,5,9,22,18,4,23
Amkar,9647,8,6,4,10,11,22,-11,22
Rostov,9647,9,5,6,9,11,17,-6,21
Din Moscow,9647,10,5,6,9,17,24,-7,21
Anzhi,9647,11,2,5,13,16,43,-27,11
Loko Moscow,9648,1,11,6,3,30,13,17,39
CSKA Moscow,9648,2,11,3,6,28,18,10,36
Spart Moscow,9648,3,10,5,5,40,27,13,35
Zenit,9648,4,9,8,3,23,13,10,35
Krasnodar,9648,5,8,6,6,29,26,3,30
Din Moscow,9648,6,7,6,7,20,22,-2,27
Terek Grozny,9648,7,7,6,7,21,24,-3,27
FK Rubin,9648,8,5,6,9,23,20,3,21
Amkar,9648,9,5,4,11,11,26,-15,19
Rostov,9648,10,4,6,10,10,20,-10,18
Anzhi,9648,11,2,6,12,15,41,-26,12
Loko Moscow,9649,1,11,5,4,29,15,14,38
CSKA Moscow,9649,2,11,4,5,29,19,10,37
Zenit,9649,3,8,9,3,24,15,9,33
Krasnodar,9649,4,9,4,7,30,26,4,31
Spart Moscow,9649,5,8,6,6,36,31,5,30
Terek Grozny,9649,6,7,5,8,21,26,-5,26
Din Moscow,9649,7,6,7,7,19,22,-3,25
FK Rubin,9649,8,6,5,9,23,18,5,23
Amkar,9649,9,6,4,10,14,23,-9,22
Rostov,9649,10,5,6,9,13,19,-6,21
Anzhi,9649,11,3,5,12,15,39,-24,14
Loko Moscow,9650,1,12,5,3,30,12,18,41
CSKA Moscow,9650,2,11,3,6,27,18,9,36
Zenit,9650,3,9,8,3,23,13,10,35
Spart Moscow,9650,4,9,7,4,37,27,10,34
Krasnodar,9650,5,8,4,8,27,27,0,28
FK Rubin,9650,6,7,5,8,24,17,7,26
Terek Grozny,9650,7,7,5,8,22,27,-5,26
Din Moscow,9650,8,5,7,8,18,23,-5,22
Amkar,9650,9,5,5,10,12,23,-11,20
Rostov,9650,10,4,6,10,11,20,-9,18
Anzhi,9650,11,3,5,12,16,40,-24,14
Loko Moscow,9651,1,12,5,3,31,13,18,41
CSKA Moscow,9651,2,11,4,5,27,18,9,37
Zenit,9651,3,8,9,3,23,14,9,33
Spart Moscow,9651,4,9,6,5,35,27,8,33
Krasnodar,9651,5,8,5,7,27,25,2,29
Terek Grozny,9651,6,7,6,7,22,26,-4,27
Din Moscow,9651,7,5,8,7,18,22,-4,23
FK Rubin,9651,8,5,7,8,22,18,4,22
Amkar,9651,9,5,5,10,12,23,-11,20
Rostov,9651,10,4,6,10,10,19,-9,18
Anzhi,9651,11,3,5,12,18,40,-22,14
Loko Moscow,9652,1,11,7,2,29,11,18,40
CSKA Moscow,9652,2,11,4,5,26,17,9,37
Spart Moscow,9652,3,9,7,4,38,28,10,34
Terek Grozny,9652,4,9,5,6,24,24,0,32
Zenit,9652,5,7,10,3,21,13,8,31
Krasnodar,9652,6,8,6,6,28,25,3,30
FK Rubin,9652,7,6,6,8,24,18,6,24
Din Moscow,9652,8,5,7,8,19,25,-6,22
Rostov,9652,9,4,6,10,10,19,-9,18
Amkar,9652,10,4,5,11,11,25,-14,17
Anzhi,9652,11,2,5,13,15,40,-25,11
Loko Moscow,9653,1,11,6,3,29,12,17,39
CSKA Moscow,9653,2,12,3,5,28,17,11,39
Spart Moscow,9653,3,11,5,4,41,28,13,38
Krasnodar,9653,4,10,4,6,30,24,6,34
Zenit,9653,5,7,9,4,21,14,7,30
Terek Grozny,9653,6,7,6,7,21,25,-4,27
Din Moscow,9653,7,5,7,8,19,26,-7,22
FK Rubin,9653,8,5,6,9,22,20,2,21
Amkar,9653,9,5,4,11,12,24,-12,19
Rostov,9653,10,4,6,10,11,19,-8,18
Anzhi,9653,11,2,6,12,15,40,-25,12
Loko Moscow,9654,1,11,5,4,31,17,14,38
CSKA Moscow,9654,2,11,4,5,28,18,10,37
Spart Moscow,9654,3,10,6,4,42,29,13,36
Krasnodar,9654,4,10,4,6,32,25,7,34
Zenit,9654,5,8,8,4,23,16,7,32
Terek Grozny,9654,6,7,7,6,21,23,-2,28
FK Rubin,9654,7,6,5,9,22,18,4,23
Din Moscow,9654,8,5,7,8,21,26,-5,22
Rostov,9654,9,4,6,10,10,18,-8,18
Amkar,9654,10,4,5,11,9,26,-17,17
Anzhi,9654,11,2,7,11,16,39,-23,13
Loko Moscow,9655,1,13,5,2,33,12,21,44
CSKA Moscow,9655,2,10,4,6,28,22,6,34
Spart Moscow,9655,3,9,6,5,37,29,8,33
Zenit,9655,4,8,8,4,24,16,8,32
Terek Grozny,9655,5,8,6,6,25,26,-1,30
Krasnodar,9655,6,8,5,7,30,28,2,29
Din Moscow,9655,7,6,7,7,20,23,-3,25
FK Rubin,9655,8,5,6,9,24,21,3,21
Rostov,9655,9,5,6,9,12,18,-6,21
Amkar,9655,10,4,4,12,12,27,-15,16
Anzhi,9655,11,2,7,11,18,41,-23,13
Loko Moscow,9656,1,11,5,4,30,15,15,38
CSKA Moscow,9656,2,11,4,5,29,18,11,37
Krasnodar,9656,3,10,4,6,30,25,5,34
Zenit,9656,4,8,9,3,24,14,10,33
Spart Moscow,9656,5,9,6,5,37,29,8,33
Terek Grozny,9656,6,8,5,7,22,24,-2,29
Din Moscow,9656,7,6,6,8,19,24,-5,24
FK Rubin,9656,8,6,5,9,23,18,5,23
Rostov,9656,9,4,7,9,10,17,-7,19
Amkar,9656,10,5,4,11,12,25,-13,19
Anzhi,9656,11,2,5,13,15,42,-27,11
Loko Moscow,9657,1,12,6,2,32,12,20,42
CSKA Moscow,9657,2,10,5,5,25,17,8,35
Zenit,9657,3,7,10,3,22,14,8,31
Krasnodar,9657,4,9,4,7,29,26,3,31
Spart Moscow,9657,5,8,6,6,37,32,5,30
Din Moscow,9657,6,7,6,7,21,22,-1,27
Terek Grozny,9657,7,7,5,8,21,27,-6,26
Amkar,9657,8,6,4,10,13,22,-9,22
FK Rubin,9657,9,5,5,10,22,21,1,20
Rostov,9657,10,4,7,9,14,21,-7,19
Anzhi,9657,11,3,6,11,16,38,-22,15
Loko Moscow,9658,1,11,7,2,31,13,18,40
CSKA Moscow,9658,2,11,4,5,29,20,9,37
Spart Moscow,9658,3,10,5,5,39,30,9,35
Zenit,9658,4,7,9,4,24,17,7,30
Krasnodar,9658,5,8,5,7,28,26,2,29
Terek Grozny,9658,6,8,5,7,23,24,-1,29
FK Rubin,9658,7,7,5,8,25,19,6,26
Amkar,9658,8,6,4,10,14,24,-10,22
Din Moscow,9658,9,5,6,9,20,26,-6,21
Rostov,9658,10,4,6,10,11,19,-8,18
Anzhi,9658,11,2,6,12,15,41,-26,12
Loko Moscow,9659,1,12,5,3,32,14,18,41
CSKA Moscow,9659,2,10,5,5,28,20,8,35
Krasnodar,9659,3,9,5,6,31,26,5,32
Zenit,9659,4,7,9,4,24,18,6,30
Spart Moscow,9659,5,8,5,7,34,30,4,29
Terek Grozny,9659,6,7,6,7,21,24,-3,27
FK Rubin,9659,7,6,6,8,25,20,5,24
Din Moscow,9659,8,6,6,8,21,25,-4,24
Amkar,9659,9,6,4,10,12,22,-10,22
Rostov,9659,10,5,6,9,11,17,-6,21
Anzhi,9659,11,2,7,11,15,38,-23,13
Loko Moscow,9660,1,11,6,3,29,13,16,39
CSKA Moscow,9660,2,11,3,6,26,18,8,36
Zenit,9660,3,9,8,3,24,13,11,35
Spart Moscow,9660,4,10,5,5,36,28,8,35
Krasnodar,9660,5,9,5,6,29,25,4,32
Terek Grozny,9660,6,9,5,6,24,23,1,32
Din Moscow,9660,7,7,6,7,21,22,-1,27
FK Rubin,9660,8,5,5,10,23,21,2,20
Rostov,9660,9,4,6,10,10,18,-8,18
Amkar,9660,10,4,4,12,10,25,-15,16
Anzhi,9660,11,2,5,13,15,41,-26,11
Loko Moscow,9661,1,12,5,3,31,14,17,41
Spart Moscow,9661,2,11,5,4,40,26,14,38
CSKA Moscow,9661,3,11,3,6,30,21,9,36
Zenit,9661,4,9,8,3,26,14,12,35
Terek Grozny,9661,5,9,5,6,22,22,0,32
Krasnodar,9661,6,8,5,7,28,26,2,29
Din Moscow,9661,7,6,6,8,19,23,-4,24
FK Rubin,9661,8,5,6,9,21,18,3,21
Rostov,9661,9,4,6,10,10,20,-10,18
Amkar,9661,10,4,4,12,9,25,-16,16
Anzhi,9661,11,2,5,13,15,42,-27,11
Loko Moscow,9662,1,12,6,2,31,12,19,42
CSKA Moscow,9662,2,12,3,5,30,19,11,39
Spart Moscow,9662,3,11,5,4,39,26,13,38
Zenit,9662,4,7,9,4,21,15,6,30
Krasnodar,9662,5,8,5,7,28,26,2,29
Terek Grozny,9662,6,7,7,6,22,24,-2,28
Din Moscow,9662,7,6,6,8,20,23,-3,24
FK Rubin,9662,8,5,6,9,21,20,1,21
Rostov,9662,9,4,6,10,10,19,-9,18
Amkar,9662,10,4,5,11,10,24,-14,17
Anzhi,9662,11,2,6,12,18,42,-24,12
Loko Moscow,9663,1,13,5,2,35,12,23,44
Spart Moscow,9663,2,11,5,4,42,27,15,38
CSKA Moscow,9663,3,10,4,6,28,22,6,34
Zenit,9663,4,7,9,4,22,18,4,30
Terek Grozny,9663,5,8,6,6,21,22,-1,30
Krasnodar,9663,6,8,5,7,29,27,2,29
Din Moscow,9663,7,6,6,8,20,23,-3,24
FK Rubin,9663,8,5,6,9,23,21,2,21
Rostov,9663,9,4,6,10,10,21,-11,18
Amkar,9663,10,4,4,12,11,27,-16,16
Anzhi,9663,11,3,6,11,18,39,-21,15
Loko Moscow,9664,1,12,6,2,33,14,19,42
CSKA Moscow,9664,2,11,3,6,28,19,9,36
Zenit,9664,3,8,9,3,24,15,9,33
Krasnodar,9664,4,9,4,7,30,27,3,31
Spart Moscow,9664,5,8,6,6,33,27,6,30
Terek Grozny,9664,6,7,6,7,21,25,-4,27
Din Moscow,9664,7,6,6,8,18,22,-4,24
FK Rubin,9664,8,6,5,9,22,18,4,23
Amkar,9664,9,5,5,10,10,22,-12,20
Rostov,9664,10,4,7,9,10,17,-7,19
Anzhi,9664,11,3,5,12,17,40,-23,14
Loko Moscow,9665,1,12,6,2,33,14,19,42
CSKA Moscow,9665,2,11,4,5,27,18,9,37
Spart Moscow,9665,3,9,6,5,40,31,9,33
Zenit,9665,4,7,9,4,21,14,7,30
Krasnodar,9665,5,8,6,6,33,30,3,30
Terek Grozny,9665,6,8,5,7,23,25,-2,29
Din Moscow,9665,7,5,8,7,21,25,-4,23
FK Rubin,9665,8,5,7,8,25,21,4,22
Rostov,9665,9,5,6,9,12,17,-5,21
Amkar,9665,10,5,4,11,11,26,-15,19
Anzhi,9665,11,2,5,13,17,42,-25,11
Loko Moscow,9666,1,12,5,3,30,12,18,41
CSKA Moscow,9666,2,12,3,5,30,18,12,39
Spart Moscow,9666,3,9,6,5,37,29,8,33
Zenit,9666,4,8,8,4,22,15,7,32
Terek Grozny,9666,5,9,5,6,24,23,1,32
Krasnodar,9666,6,8,5,7,28,26,2,29
Din Moscow,9666,7,6,6,8,21,25,-4,24
FK Rubin,9666,8,5,6,9,23,20,3,21
Rostov,9666,9,4,7,9,11,18,-7,19
Amkar,9666,10,5,4,11,10,24,-14,19
Anzhi,9666,11,2,5,13,16,42,-26,11
CSKA Moscow,9667,1,12,3,5,30,20,10,39
Loko Moscow,9667,2,11,5,4,31,15,16,38
Spart Moscow,9667,3,9,6,5,37,28,9,33
Zenit,9667,4,8,8,4,26,18,8,32
Krasnodar,9667,5,9,5,6,28,24,4,32
Terek Grozny,9667,6,7,6,7,23,26,-3,27
Din Moscow,9667,7,6,7,7,20,23,-3,25
FK Rubin,9667,8,5,6,9,22,19,3,21
Amkar,9667,9,5,5,10,13,25,-12,20
Rostov,9667,10,4,6,10,10,19,-9,18
Anzhi,9667,11,3,5,12,17,40,-23,14
Loko Moscow,9668,1,13,5,2,32,12,20,44
CSKA Moscow,9668,2,12,3,5,27,17,10,39
Spart Moscow,9668,3,10,5,5,37,30,7,35
Zenit,9668,4,7,8,5,21,15,6,29
Krasnodar,9668,5,8,4,8,29,28,1,28
Terek Grozny,9668,6,7,7,6,24,26,-2,28
Din Moscow,9668,7,6,6,8,22,26,-4,24
FK Rubin,9668,8,6,5,9,26,22,4,23
Rostov,9668,9,5,6,9,14,18,-4,21
Amkar,9668,10,4,5,11,11,25,-14,17
Anzhi,9668,11,2,6,12,16,40,-24,12
Loko Moscow,9669,1,11,6,3,31,15,16,39
CSKA Moscow,9669,2,11,3,6,29,19,10,36
Spart Moscow,9669,3,9,7,4,36,25,11,34
Krasnodar,9669,4,10,4,6,32,26,6,34
Zenit,9669,5,8,9,3,24,14,10,33
Terek Grozny,9669,6,9,5,6,24,22,2,32
Din Moscow,9669,7,5,7,8,17,24,-7,22
FK Rubin,9669,8,5,6,9,22,19,3,21
Rostov,9669,9,4,7,9,10,17,-7,19
Amkar,9669,10,4,5,11,9,23,-14,17
Anzhi,9669,11,2,5,13,14,44,-30,11
Loko Moscow,9670,1,12,5,3,32,12,20,41
Spart Moscow,9670,2,10,6,4,38,28,10,36
CSKA Moscow,9670,3,11,3,6,28,18,10,36
Zenit,9670,4,8,8,4,22,16,6,32
Krasnodar,9670,5,9,4,7,28,25,3,31
Terek Grozny,9670,6,8,6,6,22,23,-1,30
Din Moscow,9670,7,6,7,7,21,24,-3,25
FK Rubin,9670,8,6,5,9,23,19,4,23
Rostov,9670,9,4,6,10,11,19,-8,18
Amkar,9670,10,4,4,12,9,24,-15,16
Anzhi,9670,11,2,6,12,15,41,-26,12
Loko Moscow,9671,1,12,6,2,32,13,19,42
Spart Moscow,9671,2,11,5,4,41,26,15,38
CSKA Moscow,9671,3,11,3,6,27,18,9,36
Zenit,9671,4,8,9,3,23,14,9,33
Krasnodar,9671,5,9,4,7,30,27,3,31
Terek Grozny,9671,6,7,7,6,21,23,-2,28
FK Rubin,9671,7,6,5,9,24,19,5,23
Din Moscow,9671,8,5,6,9,17,27,-10,21
Rostov,9671,9,4,6,10,10,19,-9,18
Amkar,9671,10,4,5,11,10,24,-14,17
Anzhi,9671,11,2,6,12,15,40,-25,12
Loko Moscow,9672,1,11,5,4,29,15,14,38
CSKA Moscow,9672,2,11,3,6,30,19,11,36
Zenit,9672,3,9,8,3,24,13,11,35
Krasnodar,9672,4,10,4,6,33,24,9,34
Spart Moscow,9672,5,9,6,5,35,28,7,33
Din Moscow,9672,6,7,6,7,20,21,-1,27
Terek Grozny,9672,7,7,6,7,21,25,-4,27
FK Rubin,9672,8,5,5,10,21,21,0,20
Rostov,9672,9,4,7,9,10,17,-7,19
Amkar,9672,10,4,5,11,11,25,-14,17
Anzhi,9672,11,3,5,12,16,42,-26,14
Loko Moscow,9673,1,12,6,2,32,12,20,42
Spart Moscow,9673,2,9,7,4,37,28,9,34
CSKA Moscow,9673,3,10,4,6,27,21,6,34
Zenit,9673,4,8,9,3,25,15,10,33
Krasnodar,9673,5,9,4,7,29,26,3,31
Terek Grozny,9673,6,8,6,6,21,22,-1,30
FK Rubin,9673,7,6,5,9,22,19,3,23
Din Moscow,9673,8,5,7,8,19,24,-5,22
Rostov,9673,9,4,6,10,10,18,-8,18
Amkar,9673,10,4,5,11,10,24,-14,17
Anzhi,9673,11,2,7,11,15,38,-23,13
CSKA Moscow,9674,1,12,3,5,29,17,12,39
Loko Moscow,9674,2,11,5,4,30,14,16,38
Krasnodar,9674,3,10,4,6,30,24,6,34
Zenit,9674,4,8,8,4,23,15,8,32
Spart Moscow,9674,5,9,5,6,34,28,6,32
Terek Grozny,9674,6,7,6,7,21,24,-3,27
Din Moscow,9674,7,5,7,8,17,22,-5,22
FK Rubin,9674,8,5,6,9,21,19,2,21
Rostov,9674,9,5,6,9,12,17,-5,21
Amkar,9674,10,5,5,10,10,22,-12,20
Anzhi,9674,11,3,5,12,16,41,-25,14
Loko Moscow,9675,1,11,5,4,31,15,16,38
CSKA Moscow,9675,2,11,3,6,27,20,7,36
Zenit,9675,3,9,8,3,25,14,11,35
Spart Moscow,9675,4,9,6,5,38,28,10,33
Krasnodar,9675,5,9,5,6,29,25,4,32
Terek Grozny,9675,6,8,6,6,23,23,0,30
FK Rubin,9675,7,6,6,8,22,17,5,24
Rostov,9675,8,5,6,9,11,17,-6,21
Din Moscow,9675,9,5,6,9,18,26,-8,21
Amkar,9675,10,4,5,11,10,25,-15,17
Anzhi,9675,11,2,6,12,16,40,-24,12
Loko Moscow,9676,1,11,5,4,32,18,14,38
CSKA Moscow,9676,2,10,5,5,27,19,8,35
Zenit,9676,3,8,9,3,24,15,9,33
Spart Moscow,9676,4,9,6,5,35,27,8,33
Krasnodar,9676,5,9,5,6,32,26,6,32
Terek Grozny,9676,6,8,5,7,23,26,-3,29
Din Moscow,9676,7,7,6,7,19,21,-2,27
FK Rubin,9676,8,5,6,9,22,19,3,21
Rostov,9676,9,4,7,9,11,18,-7,19
Amkar,9676,10,5,4,11,12,24,-12,19
Anzhi,9676,11,2,6,12,17,41,-24,12
Loko Moscow,9677,1,13,5,2,32,12,20,44
CSKA Moscow,9677,2,12,3,5,29,17,12,39
Spart Moscow,9677,3,9,7,4,36,27,9,34
Zenit,9677,4,7,8,5,21,15,6,29
Krasnodar,9677,5,8,5,7,29,27,2,29
Terek Grozny,9677,6,8,5,7,23,24,-1,29
Din Moscow,9677,7,6,6,8,19,23,-4,24
FK Rubin,9677,8,5,6,9,22,19,3,21
Rostov,9677,9,4,7,9,11,18,-7,19
Amkar,9677,10,4,5,11,9,24,-15,17
Anzhi,9677,11,3,5,12,16,41,-25,14
Loko Moscow,9678,1,11,6,3,30,13,17,39
CSKA Moscow,9678,2,11,3,6,28,19,9,36
Zenit,9678,3,9,8,3,24,13,11,35
Spart Moscow,9678,4,9,6,5,37,28,9,33
Terek Grozny,9678,5,8,6,6,22,22,0,30
Krasnodar,9678,6,8,5,7,29,27,2,29
Din Moscow,9678,7,6,7,7,20,23,-3,25
FK Rubin,9678,8,6,5,9,24,20,4,23
Amkar,9678,9,5,5,10,11,23,-12,20
Rostov,9678,10,4,6,10,10,19,-9,18
Anzhi,9678,11,2,5,13,14,42,-28,11
Loko Moscow,9679,1,12,5,3,31,14,17,41
CSKA Moscow,9679,2,10,5,5,26,18,8,35
Spart Moscow,9679,3,9,6,5,38,29,9,33
Krasnodar,9679,4,9,5,6,30,24,6,32
Terek Grozny,9679,5,9,5,6,23,22,1,32
Zenit,9679,6,7,9,4,22,16,6,30
Din Moscow,9679,7,6,7,7,20,22,-2,25
FK Rubin,9679,8,5,7,8,21,17,4,22
Rostov,9679,9,4,6,10,10,20,-10,18
Amkar,9679,10,4,5,11,10,25,-15,17
Anzhi,9679,11,2,6,12,14,38,-24,12
Loko Moscow,9680,1,13,5,2,34,14,20,44
CSKA Moscow,9680,2,11,4,5,29,20,9,37
Spart Moscow,9680,3,10,5,5,39,28,11,35
Terek Grozny,9680,4,9,5,6,23,22,1,32
Zenit,9680,5,7,9,4,24,17,7,30
Krasnodar,9680,6,8,5,7,30,28,2,29
FK Rubin,9680,7,5,7,8,23,19,4,22
Din Moscow,9680,8,5,7,8,18,23,-5,22
Amkar,9680,9,5,4,11,11,24,-13,19
Rostov,9680,10,4,6,10,11,21,-10,18
Anzhi,9680,11,2,5,13,15,41,-26,11
Loko Moscow,9681,1,13,5,2,32,11,21,44
Spart Moscow,9681,2,9,6,5,37,27,10,33
CSKA Moscow,9681,3,10,3,7,27,22,5,33
Zenit,9681,4,8,8,4,23,14,9,32
Krasnodar,9681,5,8,5,7,28,27,1,29
Terek Grozny,9681,6,7,5,8,21,26,-5,26
Din Moscow,9681,7,5,8,7,18,22,-4,23
FK Rubin,9681,8,5,7,8,22,18,4,22
Amkar,9681,9,6,4,10,12,22,-10,22
Rostov,9681,10,4,6,10,10,20,-10,18
Anzhi,9681,11,4,5,11,19,40,-21,17
Loko Moscow,9682,1,11,6,3,30,15,15,39
CSKA Moscow,9682,2,11,4,5,30,21,9,37
Spart Moscow,9682,3,9,5,6,38,29,9,32
Zenit,9682,4,7,10,3,24,16,8,31
Krasnodar,9682,5,9,4,7,30,28,2,31
Terek Grozny,9682,6,8,5,7,23,24,-1,29
Din Moscow,9682,7,6,6,8,20,25,-5,24
FK Rubin,9682,8,6,5,9,25,19,6,23
Rostov,9682,9,5,6,9,11,17,-6,21
Amkar,9682,10,5,4,11,11,25,-14,19
Anzhi,9682,11,3,5,12,18,41,-23,14
Loko Moscow,9683,1,11,6,3,30,15,15,39
CSKA Moscow,9683,2,11,4,5,29,18,11,37
Spart Moscow,9683,3,9,7,4,38,29,9,34
Krasnodar,9683,4,10,4,6,31,24,7,34
Zenit,9683,5,7,10,3,23,15,8,31
Terek Grozny,9683,6,8,6,6,24,24,0,30
Din Moscow,9683,7,5,7,8,20,25,-5,22
FK Rubin,9683,8,5,6,9,22,19,3,21
Rostov,9683,9,4,7,9,11,18,-7,19
Amkar,9683,10,4,6,10,12,25,-13,18
Anzhi,9683,11,2,5,13,14,42,-28,11
Loko Moscow,9684,1,12,5,3,34,14,20,41
CSKA Moscow,9684,2,11,3,6,28,20,8,36
Spart Moscow,9684,3,9,7,4,40,31,9,34
Zenit,9684,4,8,8,4,24,17,7,32
Terek Grozny,9684,5,8,6,6,22,23,-1,30
Krasnodar,9684,6,8,4,8,27,29,-2,28
FK Rubin,9684,7,6,6,8,23,17,6,24
Din Moscow,9684,8,5,8,7,20,24,-4,23
Rostov,9684,9,4,7,9,12,19,-7,19
Amkar,9684,10,4,4,12,10,25,-15,16
Anzhi,9684,11,3,6,11,18,39,-21,15
Loko Moscow,9685,1,13,5,2,33,13,20,44
CSKA Moscow,9685,2,11,4,5,27,18,9,37
Spart Moscow,9685,3,9,7,4,38,28,10,34
Zenit,9685,4,7,9,4,23,16,7,30
Krasnodar,9685,5,8,5,7,30,28,2,29
Terek Grozny,9685,6,7,6,7,20,24,-4,27
FK Rubin,9685,7,6,6,8,24,19,5,24
Din Moscow,9685,8,5,7,8,19,24,-5,22
Amkar,9685,9,5,5,10,12,23,-11,20
Rostov,9685,10,4,6,10,10,19,-9,18
Anzhi,9685,11,2,6,12,14,38,-24,12
Loko Moscow,9686,1,12,5,3,31,13,18,41
CSKA Moscow,9686,2,11,3,6,28,19,9,36
Krasnodar,9686,3,10,4,6,30,25,5,34
Spart Moscow,9686,4,9,6,5,36,27,9,33
Zenit,9686,5,8,8,4,22,14,8,32
Terek Grozny,9686,6,8,6,6,24,25,-1,30
Din Moscow,9686,7,7,6,7,20,22,-2,27
FK Rubin,9686,8,5,5,10,21,19,2,20
Rostov,9686,9,4,6,10,10,19,-9,18
Amkar,9686,10,4,6,10,11,24,-13,18
Anzhi,9686,11,2,5,13,16,42,-26,11
Loko Moscow,9687,1,12,5,3,32,13,19,41
CSKA Moscow,9687,2,12,3,5,29,18,11,39
Spart Moscow,9687,3,10,6,4,37,26,11,36
Krasnodar,9687,4,9,5,6,31,27,4,32
Terek Grozny,9687,5,8,6,6,22,23,-1,30
Zenit,9687,6,7,8,5,21,17,4,29
FK Rubin,9687,7,6,6,8,25,20,5,24
Din Moscow,9687,8,5,6,9,18,24,-6,21
Rostov,9687,9,4,7,9,11,18,-7,19
Amkar,9687,10,4,5,11,9,24,-15,17
Anzhi,9687,11,2,5,13,16,41,-25,11
Loko Moscow,9688,1,11,6,3,31,15,16,39
CSKA Moscow,9688,2,11,4,5,32,20,12,37
Spart Moscow,9688,3,10,6,4,43,30,13,36
Zenit,9688,4,7,10,3,23,15,8,31
Krasnodar,9688,5,9,4,7,32,28,4,31
Terek Grozny,9688,6,8,5,7,21,23,-2,29
Din Moscow,9688,7,6,7,7,20,23,-3,25
FK Rubin,9688,8,6,5,9,23,19,4,23
Amkar,9688,9,5,4,11,11,25,-14,19
Rostov,9688,10,4,6,10,12,22,-10,18
Anzhi,9688,11,2,5,13,15,43,-28,11
Loko Moscow,9689,1,11,7,2,31,13,18,40
CSKA Moscow,9689,2,11,4,5,29,18,11,37
Spart Moscow,9689,3,10,6,4,37,26,11,36
Krasnodar,9689,4,9,5,6,31,27,4,32
Zenit,9689,5,7,10,3,23,15,8,31
Terek Grozny,9689,6,7,5,8,21,26,-5,26
Din Moscow,9689,7,6,7,7,20,22,-2,25
FK Rubin,9689,8,5,5,10,23,22,1,20
Amkar,9689,9,5,4,11,12,24,-12,19
Rostov,9689,10,4,6,10,10,19,-9,18
Anzhi,9689,11,3,5,12,15,40,-25,14
Loko Moscow,9690,1,12,5,3,30,12,18,41
Spart Moscow,9690,2,11,5,4,39,27,12,38
CSKA Moscow,9690,3,11,3,6,28,20,8,36
Zenit,9690,4,8,8,4,23,15,8,32
Krasnodar,9690,5,9,4,7,30,25,5,31
Terek Grozny,9690,6,7,6,7,20,23,-3,27
Din Moscow,9690,7,6,6,8,21,26,-5,24
FK Rubin,9690,8,5,5,10,22,22,0,20
Amkar,9690,9,5,4,11,10,23,-13,19
Rostov,9690,10,4,6,10,10,18,-8,18
Anzhi,9690,11,3,6,11,16,38,-22,15
Loko Moscow,9691,1,12,5,3,31,13,18,41
CSKA Moscow,9691,2,10,4,6,26,20,6,34
Zenit,9691,3,8,8,4,23,14,9,32
Spart Moscow,9691,4,9,5,6,37,30,7,32
Krasnodar,9691,5,9,5,6,31,27,4,32
Terek Grozny,9691,6,8,5,7,23,26,-3,29
FK Rubin,9691,7,6,6,8,24,19,5,24
Rostov,9691,8,5,6,9,12,17,-5,21
Din Moscow,9691,9,5,6,9,17,24,-7,21
Amkar,9691,10,5,4,11,12,26,-14,19
Anzhi,9691,11,3,6,11,19,39,-20,15
Loko Moscow,9692,1,13,5,2,32,11,21,44
CSKA Moscow,9692,2,12,3,5,30,18,12,39
Spart Moscow,9692,3,10,6,4,42,26,16,36
Krasnodar,9692,4,9,4,7,28,26,2,31
Zenit,9692,5,7,8,5,22,16,6,29
Terek Grozny,9692,6,8,5,7,21,23,-2,29
Din Moscow,9692,7,5,7,8,18,25,-7,22
FK Rubin,9692,8,5,6,9,22,19,3,21
Rostov,9692,9,4,6,10,10,22,-12,18
Amkar,9692,10,4,5,11,10,24,-14,17
Anzhi,9692,11,3,5,12,15,40,-25,14
Loko Moscow,9693,1,13,5,2,33,12,21,44
CSKA Moscow,9693,2,11,4,5,27,17,10,37
Spart Moscow,9693,3,10,5,5,39,27,12,35
Krasnodar,9693,4,9,4,7,30,28,2,31
Zenit,9693,5,7,9,4,21,14,7,30
Terek Grozny,9693,6,7,7,6,22,24,-2,28
FK Rubin,9693,7,6,5,9,24,20,4,23
Din Moscow,9693,8,5,6,9,18,27,-9,21
Amkar,9693,9,5,5,10,11,23,-12,20
Rostov,9693,10,4,6,10,11,19,-8,18
Anzhi,9693,11,2,6,12,15,40,-25,12
Loko Moscow,9694,1,12,6,2,32,12,20,42
Spart Moscow,9694,2,10,6,4,38,27,11,36
CSKA Moscow,9694,3,10,4,6,25,19,6,34
Zenit,9694,4,8,9,3,24,14,10,33
Terek Grozny,9694,5,9,5,6,23,22,1,32
Krasnodar,9694,6,8,4,8,27,28,-1,28
FK Rubin,9694,7,7,5,8,25,18,7,26
Din Moscow,9694,8,5,6,9,18,25,-7,21
Rostov,9694,9,4,6,10,10,18,-8,18
Amkar,9694,10,4,5,11,11,26,-15,17
Anzhi,9694,11,2,6,12,14,38,-24,12
CSKA Moscow,9695,1,12,3,5,32,17,15,39
Spart Moscow,9695,2,11,5,4,44,26,18,38
Loko Moscow,9695,3,11,5,4,30,14,16,38
Krasnodar,9695,4,10,4,6,31,25,6,34
Zenit,9695,5,8,8,4,22,15,7,32
Terek Grozny,9695,6,9,5,6,23,23,0,32
Din Moscow,9695,7,6,6,8,19,24,-5,24
FK Rubin,9695,8,5,5,10,22,21,1,20
Rostov,9695,9,4,6,10,10,20,-10,18
Amkar,9695,10,4,4,12,10,29,-19,16
Anzhi,9695,11,2,5,13,15,44,-29,11
Loko Moscow,9696,1,12,6,2,30,11,19,42
CSKA Moscow,9696,2,11,4,5,28,18,10,37
Spart Moscow,9696,3,9,5,6,39,33,6,32
Krasnodar,9696,4,9,5,6,29,24,5,32
Zenit,9696,5,7,9,4,22,15,7,30
Terek Grozny,9696,6,8,6,6,24,24,0,30
Din Moscow,9696,7,5,7,8,21,27,-6,22
FK Rubin,9696,8,5,6,9,24,22,2,21
Rostov,9696,9,5,6,9,15,19,-4,21
Amkar,9696,10,5,4,11,11,25,-14,19
Anzhi,9696,11,2,6,12,16,41,-25,12
Loko Moscow,9697,1,12,6,2,33,12,21,42
CSKA Moscow,9697,2,11,3,6,28,19,9,36
Zenit,9697,3,8,8,4,22,16,6,32
Spart Moscow,9697,4,8,6,6,34,29,5,30
Krasnodar,9697,5,8,5,7,29,28,1,29
Terek Grozny,9697,6,8,5,7,22,25,-3,29
FK Rubin,9697,7,7,5,8,25,18,7,26
Din Moscow,9697,8,6,6,8,18,22,-4,24
Rostov,9697,9,4,7,9,11,18,-7,19
Amkar,9697,10,5,4,11,11,23,-12,19
Anzhi,9697,11,3,5,12,18,41,-23,14
Loko Moscow,9698,1,11,7,2,31,13,18,40
Spart Moscow,9698,2,10,5,5,36,27,9,35
CSKA Moscow,9698,3,10,4,6,25,18,7,34
Zenit,9698,4,7,10,3,21,13,8,31
Krasnodar,9698,5,8,6,6,29,26,3,30
Terek Grozny,9698,6,7,6,7,21,25,-4,27
Din Moscow,9698,7,6,6,8,18,22,-4,24
Amkar,9698,8,6,4,10,14,24,-10,22
FK Rubin,9698,9,5,6,9,21,18,3,21
Rostov,9698,10,4,6,10,10,18,-8,18
Anzhi,9698,11,3,6,11,15,37,-22,15
Loko Moscow,9699,1,12,5,3,32,14,18,41
Zenit,9699,2,9,8,3,25,15,10,35
CSKA Moscow,9699,3,10,4,6,26,19,7,34
Spart Moscow,9699,4,9,6,5,35,27,8,33
Terek Grozny,9699,5,8,6,6,22,23,-1,30
Krasnodar,9699,6,8,4,8,28,28,0,28
Din Moscow,9699,7,6,7,7,19,22,-3,25
FK Rubin,9699,8,6,6,8,24,18,6,24
Rostov,9699,9,4,7,9,10,17,-7,19
Amkar,9699,10,4,5,11,11,25,-14,17
Anzhi,9699,11,2,6,12,14,38,-24,12
Loko Moscow,9700,1,12,5,3,32,14,18,41
Spart Moscow,9700,2,11,5,4,38,25,13,38
CSKA Moscow,9700,3,11,3,6,27,19,8,36
Krasnodar,9700,4,10,4,6,31,25,6,34
Zenit,9700,5,8,8,4,22,15,7,32
Terek Grozny,9700,6,7,6,7,21,25,-4,27
FK Rubin,9700,7,6,5,9,23,19,4,23
Din Moscow,9700,8,5,6,9,18,25,-7,21
Amkar,9700,9,5,4,11,11,23,-12,19
Rostov,9700,10,4,6,10,10,19,-9,18
Anzhi,9700,11,2,6,12,16,40,-24,12
Loko Moscow,9701,1,11,6,3,30,13,17,39
Spart Moscow,9701,2,11,5,4,43,28,15,38
CSKA Moscow,9701,3,11,4,5,27,18,9,37
Krasnodar,9701,4,10,4,6,29,24,5,34
Zenit,9701,5,7,9,4,23,16,7,30
Terek Grozny,9701,6,7,5,8,20,26,-6,26
FK Rubin,9701,7,6,5,9,22,18,4,23
Din Moscow,9701,8,5,6,9,17,24,-7,21
Amkar,9701,9,5,4,11,12,27,-15,19
Rostov,9701,10,4,6,10,12,20,-8,18
Anzhi,9701,11,3,6,11,16,37,-21,15
Loko Moscow,9702,1,11,5,4,30,15,15,38
CSKA Moscow,9702,2,11,4,5,28,19,9,37
Spart Moscow,9702,3,10,6,4,40,27,13,36
Krasnodar,9702,4,10,4,6,31,25,6,34
Zenit,9702,5,8,8,4,24,16,8,32
Terek Grozny,9702,6,8,5,7,22,24,-2,29
Din Moscow,9702,7,6,7,7,19,22,-3,25
FK Rubin,9702,8,5,5,10,22,20,2,20
Amkar,9702,9,5,4,11,12,25,-13,19
Rostov,9702,10,4,6,10,10,20,-10,18
Anzhi,9702,11,2,6,12,15,40,-25,12
Loko Moscow,9703,1,12,5,3,32,14,18,41
CSKA Moscow,9703,2,11,3,6,28,19,9,36
Spart Moscow,9703,3,10,5,5,35,26,9,35
Krasnodar,9703,4,9,4,7,29,26,3,31
Zenit,9703,5,7,8,5,22,17,5,29
Terek Grozny,9703,6,7,7,6,21,23,-2,28
FK Rubin,9703,7,7,5,8,23,17,6,26
Din Moscow,9703,8,5,6,9,17,23,-6,21
Amkar,9703,9,5,5,10,11,23,-12,20
Rostov,9703,10,4,6,10,10,18,-8,18
Anzhi,9703,11,3,6,11,16,38,-22,15
Loko Moscow,9704,1,11,6,3,30,13,17,39
Spart Moscow,9704,2,11,5,4,42,25,17,38
CSKA Moscow,9704,3,11,3,6,26,19,7,36
Zenit,9704,4,9,8,3,25,14,11,35
Krasnodar,9704,5,9,5,6,31,26,5,32
Terek Grozny,9704,6,7,6,7,21,24,-3,27
Din Moscow,9704,7,5,7,8,18,26,-8,22
FK Rubin,9704,8,5,6,9,24,22,2,21
Amkar,9704,9,5,4,11,10,24,-14,19
Rostov,9704,10,4,6,10,10,20,-10,18
Anzhi,9704,11,2,6,12,15,39,-24,12
Loko Moscow,9705,1,12,5,3,31,12,19,41
CSKA Moscow,9705,2,12,3,5,29,18,11,39
Spart Moscow,9705,3,8,7,5,36,29,7,31
Krasnodar,9705,4,9,4,7,29,27,2,31
Zenit,9705,5,7,8,5,22,17,5,29
Terek Grozny,9705,6,7,6,7,22,25,-3,27
FK Rubin,9705,7,7,5,8,26,19,7,26
Din Moscow,9705,8,6,6,8,19,23,-4,24
Rostov,9705,9,4,7,9,11,18,-7,19
Amkar,9705,10,4,6,10,11,24,-13,18
Anzhi,9705,11,3,5,12,17,41,-24,14
Loko Moscow,9706,1,11,5,4,30,15,15,38
CSKA Moscow,9706,2,11,4,5,26,17,9,37
Krasnodar,9706,3,10,4,6,31,25,6,34
Spart Moscow,9706,4,9,6,5,39,27,12,33
Zenit,9706,5,8,9,3,23,14,9,33
Terek Grozny,9706,6,7,7,6,20,22,-2,28
Din Moscow,9706,7,5,7,8,18,27,-9,22
FK Rubin,9706,8,5,6,9,23,20,3,21
Amkar,9706,9,5,5,10,10,22,-12,20
Rostov,9706,10,4,7,9,11,18,-7,19
Anzhi,9706,11,2,6,12,14,38,-24,12
Loko Moscow,9707,1,12,6,2,34,15,19,42
CSKA Moscow,9707,2,12,3,5,30,19,11,39
Spart Moscow,9707,3,10,5,5,38,27,11,35
Krasnodar,9707,4,9,5,6,32,28,4,32
Terek Grozny,9707,5,9,5,6,24,22,2,32
Zenit,9707,6,7,8,5,21,16,5,29
Din Moscow,9707,7,6,6,8,20,24,-4,24
FK Rubin,9707,8,5,5,10,22,20,2,20
Amkar,9707,9,5,4,11,10,25,-15,19
Rostov,9707,10,4,6,10,10,20,-10,18
Anzhi,9707,11,2,5,13,16,41,-25,11
Loko Moscow,9708,1,12,5,3,33,14,19,41
CSKA Moscow,9708,2,10,4,6,28,21,7,34
Spart Moscow,9708,3,9,6,5,37,29,8,33
Zenit,9708,4,8,8,4,23,16,7,32
Krasnodar,9708,5,9,4,7,29,26,3,31
Terek Grozny,9708,6,8,5,7,25,27,-2,29
Din Moscow,9708,7,6,7,7,20,22,-2,25
FK Rubin,9708,8,6,5,9,22,19,3,23
Rostov,9708,9,5,6,9,12,17,-5,21
Amkar,9708,10,5,4,11,13,27,-14,19
Anzhi,9708,11,2,6,12,19,43,-24,12
Loko Moscow,9709,1,11,6,3,29,12,17,39
CSKA Moscow,9709,2,11,4,5,30,19,11,37
Spart Moscow,9709,3,9,7,4,35,26,9,34
Krasnodar,9709,4,9,5,6,31,27,4,32
Zenit,9709,5,7,10,3,23,15,8,31
Terek Grozny,9709,6,8,6,6,23,23,0,30
Din Moscow,9709,7,6,6,8,19,22,-3,24
FK Rubin,9709,8,5,6,9,24,22,2,21
Rostov,9709,9,4,7,9,10,17,-7,19
Amkar,9709,10,4,5,11,11,26,-15,17
Anzhi,9709,11,2,6,12,14,40,-26,12
Loko Moscow,9710,1,11,6,3,32,15,17,39
CSKA Moscow,9710,2,11,4,5,28,19,9,37
Spart Moscow,9710,3,10,5,5,37,29,8,35
Terek Grozny,9710,4,9,5,6,22,22,0,32
Zenit,9710,5,7,10,3,23,15,8,31
Krasnodar,9710,6,9,4,7,29,26,3,31
FK Rubin,9710,7,6,6,8,23,18,5,24
Din Moscow,9710,8,5,7,8,18,23,-5,22
Amkar,9710,9,5,4,11,11,23,-12,19
Rostov,9710,10,4,6,10,12,20,-8,18
Anzhi,9710,11,2,5,13,16,41,-25,11
Loko Moscow,9711,1,13,5,2,35,13,22,44
CSKA Moscow,9711,2,12,3,5,29,17,12,39
Spart Moscow,9711,3,10,6,4,38,27,11,36
Terek Grozny,9711,4,9,5,6,25,24,1,32
Krasnodar,9711,5,9,4,7,29,26,3,31
Zenit,9711,6,7,8,5,22,19,3,29
Din Moscow,9711,7,6,6,8,19,23,-4,24
FK Rubin,9711,8,5,5,10,22,20,2,20
Rostov,9711,9,4,6,10,11,20,-9,18
Amkar,9711,10,4,5,11,12,26,-14,17
Anzhi,9711,11,2,5,13,14,41,-27,11
Loko Moscow,9712,1,12,6,2,33,13,20,42
CSKA Moscow,9712,2,10,4,6,27,20,7,34
Spart Moscow,9712,3,9,6,5,37,29,8,33
Zenit,9712,4,7,9,4,23,17,6,30
Krasnodar,9712,5,8,5,7,29,27,2,29
Din Moscow,9712,6,7,6,7,21,22,-1,27
Terek Grozny,9712,7,7,6,7,23,27,-4,27
FK Rubin,9712,8,6,5,9,23,19,4,23
Rostov,9712,9,4,6,10,10,19,-9,18
Amkar,9712,10,4,6,10,11,24,-13,18
Anzhi,9712,11,4,5,11,20,40,-20,17
Loko Moscow,9713,1,12,5,3,31,15,16,41
CSKA Moscow,9713,2,11,4,5,28,19,9,37
Krasnodar,9713,3,10,4,6,33,24,9,34
Spart Moscow,9713,4,9,6,5,35,29,6,33
Terek Grozny,9713,5,9,5,6,23,22,1,32
Zenit,9713,6,7,9,4,23,16,7,30
Din Moscow,9713,7,5,8,7,19,23,-4,23
FK Rubin,9713,8,5,6,9,22,21,1,21
Amkar,9713,9,5,4,11,12,23,-11,19
Rostov,9713,10,4,6,10,10,18,-8,18
Anzhi,9713,11,2,5,13,15,41,-26,11
Loko Moscow,9714,1,11,6,3,29,12,17,39
CSKA Moscow,9714,2,11,3,6,28,18,10,36
Krasnodar,9714,3,10,4,6,30,24,6,34
Zenit,9714,4,8,9,3,22,13,9,33
Spart Moscow,9714,5,8,5,7,37,33,4,29
Terek Grozny,9714,6,8,5,7,21,24,-3,29
Din Moscow,9714,7,6,7,7,19,22,-3,25
FK Rubin,9714,8,5,6,9,22,20,2,21
Rostov,9714,9,5,6,9,12,18,-6,21
Amkar,9714,10,5,4,11,14,26,-12,19
Anzhi,9714,11,3,5,12,16,40,-24,14
Loko Moscow,9715,1,12,6,2,35,13,22,42
CSKA Moscow,9715,2,11,4,5,28,19,9,37
Spart Moscow,9715,3,10,5,5,35,26,9,35
Zenit,9715,4,7,9,4,22,18,4,30
Krasnodar,9715,5,8,6,6,29,26,3,30
Terek Grozny,9715,6,8,6,6,22,23,-1,30
FK Rubin,9715,7,5,7,8,23,19,4,22
Din Moscow,9715,8,5,7,8,18,23,-5,22
Rostov,9715,9,5,6,9,11,17,-6,21
Amkar,9715,10,4,5,11,10,24,-14,17
Anzhi,9715,11,2,5,13,16,41,-25,11
Loko Moscow,9716,1,12,6,2,31,12,19,42
CSKA Moscow,9716,2,11,4,5,31,18,13,37
Spart Moscow,9716,3,9,6,5,38,32,6,33
Zenit,9716,4,7,9,4,22,15,7,30
Krasnodar,9716,5,8,6,6,28,25,3,30
Terek Grozny,9716,6,8,5,7,23,25,-2,29
Din Moscow,9716,7,6,7,7,20,23,-3,25
FK Rubin,9716,8,5,6,9,21,18,3,21
Rostov,9716,9,5,6,9,14,18,-4,21
Amkar,9716,10,5,4,11,11,24,-13,19
Anzhi,9716,11,2,5,13,16,45,-29,11
Loko Moscow,9717,1,12,5,3,32,14,18,41
CSKA Moscow,9717,2,11,3,6,27,18,9,36
Spart Moscow,9717,3,10,5,5,39,30,9,35
Krasnodar,9717,4,9,5,6,30,24,6,32
Zenit,9717,5,8,8,4,22,16,6,32
Terek Grozny,9717,6,8,6,6,22,23,-1,30
FK Rubin,9717,7,6,6,8,22,17,5,24
Rostov,9717,8,5,6,9,13,18,-5,21
Din Moscow,9717,9,5,6,9,19,26,-7,21
Amkar,9717,10,4,5,11,10,24,-14,17
Anzhi,9717,11,2,5,13,14,40,-26,11
Loko Moscow,9718,1,11,6,3,29,12,17,39
CSKA Moscow,9718,2,10,4,6,26,19,7,34
Spart Moscow,9718,3,9,6,5,38,29,9,33
Zenit,9718,4,8,9,3,22,13,9,33
Krasnodar,9718,5,9,4,7,29,26,3,31
Terek Grozny,9718,6,7,6,7,21,24,-3,27
FK Rubin,9718,7,7,5,8,24,18,6,26
Din Moscow,9718,8,5,7,8,19,24,-5,22
Amkar,9718,9,5,5,10,12,24,-12,20
Rostov,9718,10,4,6,10,10,19,-9,18
Anzhi,9718,11,3,6,11,16,38,-22,15
Loko Moscow,9719,1,12,5,3,31,13,18,41
CSKA Moscow,9719,2,12,3,5,31,19,12,39
Spart Moscow,9719,3,9,6,5,37,30,7,33
Krasnodar,9719,4,9,5,6,29,25,4,32
Terek Grozny,9719,5,8,6,6,22,23,-1,30
Zenit,9719,6,7,8,5,22,17,5,29
FK Rubin,9719,7,5,7,8,22,18,4,22
Din Moscow,9719,8,5,7,8,20,25,-5,22
Rostov,9719,9,4,7,9,11,18,-7,19
Amkar,9719,10,5,4,11,11,23,-12,19
Anzhi,9719,11,2,6,12,16,41,-25,12
Loko Moscow,9720,1,11,6,3,31,14,17,39
CSKA Moscow,9720,2,11,3,6,27,19,8,36
Zenit,9720,3,9,8,3,24,13,11,35
Spart Moscow,9720,4,9,5,6,37,29,8,32
Krasnodar,9720,5,9,5,6,31,27,4,32
Terek Grozny,9720,6,8,6,6,24,23,1,30
Din Moscow,9720,7,6,7,7,19,22,-3,25
FK Rubin,9720,8,5,6,9,22,19,3,21
Amkar,9720,9,5,4,11,10,25,-15,19
Rostov,9720,10,4,6,10,11,20,-9,18
Anzhi,9720,11,2,6,12,15,40,-25,12
Loko Moscow,9721,1,12,6,2,33,14,19,42
CSKA Moscow,9721,2,11,4,5,27,18,9,37
Zenit,9721,3,7,10,3,24,16,8,31
Spart Moscow,9721,4,8,7,5,34,27,7,31
Krasnodar,9721,5,9,4,7,33,28,5,31
Terek Grozny,9721,6,7,7,6,23,25,-2,28
Din Moscow,9721,7,6,7,7,19,22,-3,25
FK Rubin,9721,8,5,6,9,23,22,1,21
Rostov,9721,9,4,7,9,10,17,-7,19
Amkar,9721,10,4,6,10,10,23,-13,18
Anzhi,9721,11,2,6,12,16,40,-24,12
Loko Moscow,9722,1,12,6,2,32,13,19,42
CSKA Moscow,9722,2,11,3,6,30,19,11,36
Spart Moscow,9722,3,10,5,5,40,28,12,35
Zenit,9722,4,8,8,4,23,14,9,32
Terek Grozny,9722,5,9,5,6,24,22,2,32
Krasnodar,9722,6,8,6,6,30,27,3,30
FK Rubin,9722,7,6,6,8,23,18,5,24
Din Moscow,9722,8,6,6,8,19,23,-4,24
Rostov,9722,9,4,6,10,11,20,-9,18
Amkar,9722,10,4,4,12,9,27,-18,16
Anzhi,9722,11,2,5,13,14,44,-30,11
Loko Moscow,9723,1,11,6,3,30,15,15,39
CSKA Moscow,9723,2,11,3,6,28,21,7,36
Zenit,9723,3,8,9,3,26,16,10,33
Spart Moscow,9723,4,9,6,5,37,28,9,33
Krasnodar,9723,5,9,4,7,30,25,5,31
Terek Grozny,9723,6,8,6,6,23,23,0,30
FK Rubin,9723,7,7,5,8,23,17,6,26
Rostov,9723,8,5,6,9,11,17,-6,21
Din Moscow,9723,9,5,6,9,17,24,-7,21
Amkar,9723,10,4,6,10,11,24,-13,18
Anzhi,9723,11,2,5,13,15,41,-26,11
Loko Moscow,9724,1,11,6,3,29,12,17,39
CSKA Moscow,9724,2,11,3,6,27,21,6,36
Spart Moscow,9724,3,9,6,5,36,28,8,33
Zenit,9724,4,8,8,4,23,15,8,32
Krasnodar,9724,5,8,5,7,28,26,2,29
Terek Grozny,9724,6,8,5,7,22,25,-3,29
FK Rubin,9724,7,7,5,8,24,18,6,26
Din Moscow,9724,8,5,7,8,17,22,-5,22
Amkar,9724,9,6,4,10,13,22,-9,22
Rostov,9724,10,4,6,10,12,20,-8,18
Anzhi,9724,11,3,5,12,17,39,-22,14
Loko Moscow,9725,1,12,5,3,31,12,19,41
CSKA Moscow,9725,2,12,3,5,29,17,12,39
Krasnodar,9725,3,10,4,6,30,24,6,34
Spart Moscow,9725,4,8,7,5,37,33,4,31
Zenit,9725,5,7,8,5,21,17,4,29
Terek Grozny,9725,6,7,5,8,21,26,-5,26
Din Moscow,9725,7,5,8,7,19,23,-4,23
Amkar,9725,8,6,4,10,16,23,-7,22
FK Rubin,9725,9,5,6,9,21,19,2,21
Rostov,9725,10,4,7,9,12,19,-7,19
Anzhi,9725,11,3,5,12,15,39,-24,14
Loko Moscow,9726,1,11,5,4,31,15,16,38
Spart Moscow,9726,2,10,6,4,38,28,10,36
CSKA Moscow,9726,3,11,3,6,29,19,10,36
Zenit,9726,4,9,8,3,25,15,10,35
Krasnodar,9726,5,9,4,7,30,29,1,31
Terek Grozny,9726,6,7,6,7,20,23,-3,27
Din Moscow,9726,7,6,7,7,20,23,-3,25
FK Rubin,9726,8,6,5,9,26,20,6,23
Rostov,9726,9,4,6,10,11,19,-8,18
Amkar,9726,10,4,5,11,10,24,-14,17
Anzhi,9726,11,3,5,12,15,40,-25,14
Loko Moscow,9727,1,12,6,2,31,12,19,42
CSKA Moscow,9727,2,10,5,5,26,18,8,35
Spart Moscow,9727,3,9,6,5,38,28,10,33
Terek Grozny,9727,4,9,5,6,25,23,2,32
Zenit,9727,5,7,9,4,21,14,7,30
Krasnodar,9727,6,8,5,7,28,28,0,29
FK Rubin,9727,7,6,6,8,24,17,7,24
Din Moscow,9727,8,5,7,8,17,24,-7,22
Rostov,9727,9,4,7,9,11,18,-7,19
Amkar,9727,10,5,4,11,11,24,-13,19
Anzhi,9727,11,2,6,12,16,42,-26,12
Loko Moscow,9728,1,12,5,3,32,13,19,41
CSKA Moscow,9728,2,11,3,6,28,20,8,36
Spart Moscow,9728,3,10,5,5,44,27,17,35
Krasnodar,9728,4,10,4,6,30,25,5,34
Zenit,9728,5,8,8,4,23,15,8,32
Terek Grozny,9728,6,8,5,7,22,24,-2,29
FK Rubin,9728,7,6,5,9,23,18,5,23
Rostov,9728,8,5,6,9,12,18,-6,21
Din Moscow,9728,9,5,6,9,17,25,-8,21
Amkar,9728,10,4,4,12,9,31,-22,16
Anzhi,9728,11,3,5,12,17,41,-24,14
Loko Moscow,9729,1,12,5,3,31,14,17,41
CSKA Moscow,9729,2,12,3,5,27,17,10,39
Spart Moscow,9729,3,10,5,5,39,29,10,35
Krasnodar,9729,4,9,4,7,30,25,5,31
Terek Grozny,9729,5,8,6,6,22,23,-1,30
Zenit,9729,6,7,8,5,21,16,5,29
Din Moscow,9729,7,7,6,7,20,22,-2,27
FK Rubin,9729,8,6,5,9,22,18,4,23
Rostov,9729,9,4,6,10,11,20,-9,18
Amkar,9729,10,4,5,11,11,25,-14,17
Anzhi,9729,11,2,5,13,14,39,-25,11
Loko Moscow,9730,1,11,6,3,29,13,16,39
CSKA Moscow,9730,2,12,3,5,29,17,12,39
Spart Moscow,9730,3,9,6,5,35,27,8,33
Krasnodar,9730,4,9,4,7,29,26,3,31
Zenit,9730,5,7,9,4,21,16,5,30
Terek Grozny,9730,6,7,6,7,21,25,-4,27
FK Rubin,9730,7,7,5,8,24,17,7,26
Din Moscow,9730,8,5,7,8,17,22,-5,22
Amkar,9730,9,5,5,10,12,24,-12,20
Rostov,9730,10,4,6,10,10,18,-8,18
Anzhi,9730,11,3,5,12,16,38,-22,14
Loko Moscow,9731,1,11,6,3,30,18,12,39
CSKA Moscow,9731,2,11,4,5,28,18,10,37
Krasnodar,9731,3,10,4,6,35,25,10,34
Zenit,9731,4,7,10,3,23,15,8,31
Spart Moscow,9731,5,8,7,5,37,32,5,31
Terek Grozny,9731,6,8,6,6,21,22,-1,30
Din Moscow,9731,7,7,6,7,22,21,1,27
FK Rubin,9731,8,5,5,10,22,21,1,20
Rostov,9731,9,4,7,9,11,18,-7,19
Amkar,9731,10,4,5,11,12,26,-14,17
Anzhi,9731,11,2,6,12,14,39,-25,12
CSKA Moscow,9732,1,12,3,5,31,18,13,39
Loko Moscow,9732,2,11,5,4,29,15,14,38
Spart Moscow,9732,3,10,5,5,39,29,10,35
Zenit,9732,4,8,8,4,24,16,8,32
Krasnodar,9732,5,9,5,6,29,24,5,32
Terek Grozny,9732,6,7,6,7,21,25,-4,27
FK Rubin,9732,7,6,6,8,22,17,5,24
Din Moscow,9732,8,5,6,9,19,25,-6,21
Amkar,9732,9,5,5,10,12,24,-12,20
Rostov,9732,10,4,6,10,10,19,-9,18
Anzhi,9732,11,3,5,12,16,40,-24,14
Loko Moscow,9733,1,11,7,2,31,13,18,40
Spart Moscow,9733,2,10,6,4,38,26,12,36
Zenit,9733,3,8,9,3,25,15,10,33
CSKA Moscow,9733,4,10,3,7,26,21,5,33
Krasnodar,9733,5,8,5,7,29,27,2,29
Terek Grozny,9733,6,7,6,7,20,24,-4,27
FK Rubin,9733,7,6,6,8,24,19,5,24
Din Moscow,9733,8,5,7,8,18,23,-5,22
Rostov,9733,9,4,6,10,11,21,-10,18
Amkar,9733,10,4,6,10,9,22,-13,18
Anzhi,9733,11,4,5,11,17,37,-20,17
Loko Moscow,9734,1,12,5,3,31,16,15,41
CSKA Moscow,9734,2,11,3,6,28,20,8,36
Spart Moscow,9734,3,9,6,5,36,28,8,33
Zenit,9734,4,8,8,4,25,14,11,32
Krasnodar,9734,5,8,4,8,28,28,0,28
Terek Grozny,9734,6,7,6,7,21,25,-4,27
FK Rubin,9734,7,7,5,8,26,18,8,26
Din Moscow,9734,8,5,6,9,19,26,-7,21
Amkar,9734,9,5,5,10,12,24,-12,20
Rostov,9734,10,4,7,9,10,17,-7,19
Anzhi,9734,11,4,5,11,19,39,-20,17
Loko Moscow,9735,1,12,5,3,32,13,19,41
Spart Moscow,9735,2,9,7,4,37,28,9,34
CSKA Moscow,9735,3,10,3,7,25,22,3,33
Zenit,9735,4,8,8,4,23,15,8,32
Krasnodar,9735,5,9,5,6,29,25,4,32
Terek Grozny,9735,6,8,5,7,24,26,-2,29
Din Moscow,9735,7,6,7,7,21,22,-1,25
FK Rubin,9735,8,5,6,9,22,21,1,21
Rostov,9735,9,4,6,10,11,19,-8,18
Amkar,9735,10,4,5,11,11,26,-15,17
Anzhi,9735,11,4,5,11,21,39,-18,17
Loko Moscow,9736,1,11,6,3,29,12,17,39
CSKA Moscow,9736,2,12,3,5,29,18,11,39
Zenit,9736,3,8,8,4,23,15,8,32
Krasnodar,9736,4,9,5,6,29,25,4,32
Spart Moscow,9736,5,8,7,5,35,28,7,31
Terek Grozny,9736,6,8,5,7,25,25,0,29
Din Moscow,9736,7,6,7,7,19,22,-3,25
FK Rubin,9736,8,5,6,9,23,20,3,21
Amkar,9736,9,5,5,10,13,24,-11,20
Rostov,9736,10,4,7,9,11,18,-7,19
Anzhi,9736,11,2,5,13,14,43,-29,11
Loko Moscow,9737,1,13,5,2,34,12,22,44
CSKA Moscow,9737,2,11,4,5,30,20,10,37
Spart Moscow,9737,3,10,6,4,38,26,12,36
Krasnodar,9737,4,9,4,7,28,26,2,31
Zenit,9737,5,7,8,5,23,19,4,29
Terek Grozny,9737,6,7,6,7,20,25,-5,27
Din Moscow,9737,7,5,7,8,17,23,-6,22
FK Rubin,9737,8,5,6,9,21,18,3,21
Rostov,9737,9,4,7,9,10,17,-7,19
Amkar,9737,10,4,5,11,10,25,-15,17
Anzhi,9737,11,3,6,11,19,39,-20,15
Loko Moscow,9738,1,13,5,2,32,11,21,44
CSKA Moscow,9738,2,12,3,5,28,17,11,39
Spart Moscow,9738,3,9,6,5,39,29,10,33
Zenit,9738,4,7,8,5,21,15,6,29
Terek Grozny,9738,5,8,5,7,21,24,-3,29
Krasnodar,9738,6,8,4,8,27,27,0,28
Din Moscow,9738,7,6,6,8,20,25,-5,24
FK Rubin,9738,8,6,5,9,22,19,3,23
Rostov,9738,9,5,6,9,12,18,-6,21
Amkar,9738,10,5,5,10,12,23,-11,20
Anzhi,9738,11,2,5,13,14,40,-26,11
Loko Moscow,9739,1,11,6,3,30,13,17,39
CSKA Moscow,9739,2,12,3,5,29,18,11,39
Spart Moscow,9739,3,10,6,4,38,27,11,36
Zenit,9739,4,8,8,4,22,14,8,32
Krasnodar,9739,5,9,5,6,31,25,6,32
Terek Grozny,9739,6,8,6,6,22,23,-1,30
Din Moscow,9739,7,6,6,8,19,23,-4,24
FK Rubin,9739,8,5,5,10,21,22,-1,20
Rostov,9739,9,4,7,9,12,19,-7,19
Amkar,9739,10,4,4,12,9,24,-15,16
Anzhi,9739,11,2,6,12,16,41,-25,12
Loko Moscow,9740,1,13,5,2,33,11,22,44
CSKA Moscow,9740,2,12,3,5,29,17,12,39
Spart Moscow,9740,3,9,6,5,38,30,8,33
Terek Grozny,9740,4,8,6,6,21,22,-1,30
Zenit,9740,5,7,8,5,21,16,5,29
Krasnodar,9740,6,8,5,7,28,27,1,29
FK Rubin,9740,7,5,7,8,22,18,4,22
Din Moscow,9740,8,5,7,8,18,24,-6,22
Amkar,9740,9,5,5,10,12,23,-11,20
Rostov,9740,10,4,7,9,11,18,-7,19
Anzhi,9740,11,2,5,13,14,41,-27,11
Loko Moscow,9741,1,12,5,3,31,14,17,41
CSKA Moscow,9741,2,11,3,6,27,18,9,36
Spart Moscow,9741,3,9,5,6,39,30,9,32
Zenit,9741,4,8,8,4,23,15,8,32
Krasnodar,9741,5,9,4,7,29,25,4,31
Terek Grozny,9741,6,8,5,7,21,23,-2,29
FK Rubin,9741,7,7,5,8,24,18,6,26
Din Moscow,9741,8,6,6,8,20,23,-3,24
Amkar,9741,9,6,4,10,12,23,-11,22
Rostov,9741,10,4,6,10,11,22,-11,18
Anzhi,9741,11,2,5,13,14,40,-26,11
Loko Moscow,9742,1,11,5,4,30,14,16,38
Spart Moscow,9742,2,10,6,4,37,27,10,36
CSKA Moscow,9742,3,11,3,6,28,20,8,36
Zenit,9742,4,9,8,3,25,15,10,35
Krasnodar,9742,5,9,5,6,29,25,4,32
Terek Grozny,9742,6,8,6,6,23,24,-1,30
Din Moscow,9742,7,6,6,8,20,23,-3,24
FK Rubin,9742,8,5,6,9,23,21,2,21
Rostov,9742,9,4,6,10,11,19,-8,18
Amkar,9742,10,4,6,10,11,24,-13,18
Anzhi,9742,11,2,5,13,16,41,-25,11
Loko Moscow,9743,1,12,6,2,30,11,19,42
Spart Moscow,9743,2,10,6,4,42,31,11,36
CSKA Moscow,9743,3,11,3,6,29,21,8,36
Zenit,9743,4,8,8,4,23,14,9,32
Terek Grozny,9743,5,9,5,6,25,24,1,32
Krasnodar,9743,6,8,5,7,28,26,2,29
FK Rubin,9743,7,7,5,8,25,19,6,26
Din Moscow,9743,8,5,6,9,21,27,-6,21
Rostov,9743,9,4,7,9,12,19,-7,19
Amkar,9743,10,4,4,12,11,28,-17,16
Anzhi,9743,11,2,5,13,17,43,-26,11
Loko Moscow,9744,1,12,5,3,30,12,18,41
CSKA Moscow,9744,2,11,4,5,28,19,9,37
Spart Moscow,9744,3,10,6,4,39,27,12,36
Krasnodar,9744,4,9,5,6,28,24,4,32
Zenit,9744,5,7,9,4,22,15,7,30
Terek Grozny,9744,6,8,6,6,22,23,-1,30
Din Moscow,9744,7,5,8,7,18,22,-4,23
FK Rubin,9744,8,5,7,8,21,17,4,22
Rostov,9744,9,4,6,10,10,20,-10,18
Amkar,9744,10,4,4,12,10,25,-15,16
Anzhi,9744,11,2,6,12,16,40,-24,12
Loko Moscow,9745,1,12,6,2,32,12,20,42
Spart Moscow,9745,2,10,5,5,40,28,12,35
Zenit,9745,3,8,9,3,24,14,10,33
CSKA Moscow,9745,4,10,3,7,26,21,5,33
Krasnodar,9745,5,9,4,7,29,26,3,31
Terek Grozny,9745,6,8,6,6,22,23,-1,30
Din Moscow,9745,7,6,6,8,19,23,-4,24
FK Rubin,9745,8,6,5,9,22,19,3,23
Rostov,9745,9,4,6,10,10,21,-11,18
Amkar,9745,10,4,5,11,11,25,-14,17
Anzhi,9745,11,3,5,12,16,39,-23,14
Loko Moscow,9746,1,11,7,2,31,13,18,40
CSKA Moscow,9746,2,11,3,6,28,19,9,36
Spart Moscow,9746,3,10,5,5,37,27,10,35
Zenit,9746,4,8,9,3,24,15,9,33
Krasnodar,9746,5,9,5,6,30,25,5,32
Terek Grozny,9746,6,8,6,6,21,22,-1,30
FK Rubin,9746,7,6,5,9,23,19,4,23
Din Moscow,9746,8,5,6,9,18,26,-8,21
Amkar,9746,9,5,5,10,10,22,-12,20
Rostov,9746,10,4,6,10,10,18,-8,18
Anzhi,9746,11,2,5,13,14,40,-26,11
Loko Moscow,9747,1,12,5,3,30,12,18,41
Spart Moscow,9747,2,11,5,4,40,26,14,38
CSKA Moscow,9747,3,11,3,6,27,20,7,36
Zenit,9747,4,8,8,4,23,14,9,32
Krasnodar,9747,5,9,4,7,30,27,3,31
Terek Grozny,9747,6,8,5,7,22,24,-2,29
Din Moscow,9747,7,6,6,8,19,26,-7,24
FK Rubin,9747,8,6,5,9,25,21,4,23
Rostov,9747,9,4,6,10,11,19,-8,18
Amkar,9747,10,4,4,12,9,24,-15,16
Anzhi,9747,11,3,5,12,17,40,-23,14
Loko Moscow,9748,1,12,5,3,30,16,14,41
Krasnodar,9748,2,10,4,6,34,25,9,34
CSKA Moscow,9748,3,10,4,6,26,20,6,34
Zenit,9748,4,8,8,4,23,14,9,32
Spart Moscow,9748,5,8,7,5,36,29,7,31
Terek Grozny,9748,6,8,6,6,22,23,-1,30
Din Moscow,9748,7,6,7,7,20,23,-3,25
FK Rubin,9748,8,5,6,9,23,20,3,21
Rostov,9748,9,4,7,9,11,18,-7,19
Amkar,9748,10,4,5,11,10,24,-14,17
Anzhi,9748,11,2,7,11,16,39,-23,13
Loko Moscow,9749,1,11,6,3,29,12,17,39
CSKA Moscow,9749,2,11,4,5,30,19,11,37
Zenit,9749,3,8,9,3,23,14,9,33
Krasnodar,9749,4,9,5,6,28,24,4,32
Spart Moscow,9749,5,8,7,5,35,28,7,31
Terek Grozny,9749,6,8,5,7,24,23,1,29
Din Moscow,9749,7,6,7,7,21,23,-2,25
Amkar,9749,8,6,4,10,11,22,-11,22
FK Rubin,9749,9,5,5,10,21,20,1,20
Rostov,9749,10,4,7,9,10,17,-7,19
Anzhi,9749,11,2,5,13,15,45,-30,11
Loko Moscow,9750,1,12,6,2,31,12,19,42
CSKA Moscow,9750,2,12,3,5,29,18,11,39
Spart Moscow,9750,3,9,6,5,40,29,11,33
Terek Grozny,9750,4,9,5,6,25,24,1,32
Krasnodar,9750,5,9,4,7,30,26,4,31
Zenit,9750,6,7,9,4,22,15,7,30
Din Moscow,9750,7,7,6,7,22,24,-2,27
FK Rubin,9750,8,5,5,10,24,23,1,20
Rostov,9750,9,4,6,10,12,23,-11,18
Amkar,9750,10,4,5,11,10,25,-15,17
Anzhi,9750,11,2,5,13,16,42,-26,11
Loko Moscow,9751,1,12,6,2,32,11,21,42
CSKA Moscow,9751,2,11,4,5,29,20,9,37
Spart Moscow,9751,3,9,7,4,39,30,9,34
Terek Grozny,9751,4,9,5,6,25,23,2,32
Zenit,9751,5,7,9,4,22,15,7,30
Krasnodar,9751,6,8,4,8,27,28,-1,28
FK Rubin,9751,7,7,5,8,24,18,6,26
Din Moscow,9751,8,5,7,8,21,26,-5,22
Rostov,9751,9,4,6,10,11,19,-8,18
Amkar,9751,10,4,5,11,11,25,-14,17
Anzhi,9751,11,2,6,12,16,42,-26,12
Loko Moscow,9752,1,13,5,2,32,12,20,44
Spart Moscow,9752,2,11,5,4,40,27,13,38
CSKA Moscow,9752,3,11,4,5,30,19,11,37
Zenit,9752,4,7,8,5,21,17,4,29
Terek Grozny,9752,5,8,5,7,23,24,-1,29
Krasnodar,9752,6,8,4,8,28,28,0,28
Din Moscow,9752,7,6,6,8,21,23,-2,24
FK Rubin,9752,8,6,5,9,23,20,3,23
Rostov,9752,9,4,6,10,10,20,-10,18
Amkar,9752,10,4,4,12,11,27,-16,16
Anzhi,9752,11,3,6,11,17,39,-22,15
Loko Moscow,9753,1,11,5,4,29,15,14,38
CSKA Moscow,9753,2,11,4,5,28,19,9,37
Krasnodar,9753,3,10,4,6,31,24,7,34
Spart Moscow,9753,4,9,6,5,38,29,9,33
Zenit,9753,5,8,8,4,23,15,8,32
Terek Grozny,9753,6,7,7,6,21,23,-2,28
FK Rubin,9753,7,6,5,9,23,19,4,23
Rostov,9753,8,5,6,9,13,18,-5,21
Din Moscow,9753,9,5,6,9,18,26,-8,21
Amkar,9753,10,4,6,10,10,23,-13,18
Anzhi,9753,11,2,7,11,16,39,-23,13
Loko Moscow,9754,1,11,7,2,29,11,18,40
CSKA Moscow,9754,2,12,3,5,28,18,10,39
Krasnodar,9754,3,9,5,6,29,24,5,32
Spart Moscow,9754,4,8,7,5,36,30,6,31
Zenit,9754,5,7,9,4,21,14,7,30
Terek Grozny,9754,6,7,5,8,21,27,-6,26
Din Moscow,9754,7,6,6,8,23,26,-3,24
FK Rubin,9754,8,6,5,9,24,21,3,23
Amkar,9754,9,5,5,10,13,23,-10,20
Rostov,9754,10,4,7,9,11,18,-7,19
Anzhi,9754,11,3,5,12,16,39,-23,14
Loko Moscow,9755,1,12,5,3,31,13,18,41
CSKA Moscow,9755,2,11,4,5,29,18,11,37
Spart Moscow,9755,3,10,5,5,41,31,10,35
Krasnodar,9755,4,9,5,6,30,26,4,32
Zenit,9755,5,7,9,4,22,15,7,30
Terek Grozny,9755,6,7,6,7,20,23,-3,27
Din Moscow,9755,7,6,6,8,22,24,-2,24
FK Rubin,9755,8,5,6,9,22,21,1,21
Rostov,9755,9,5,6,9,13,19,-6,21
Amkar,9755,10,5,4,11,11,25,-14,19
Anzhi,9755,11,2,6,12,14,40,-26,12
Loko Moscow,9756,1,11,7,2,31,13,18,40
CSKA Moscow,9756,2,11,4,5,27,18,9,37
Spart Moscow,9756,3,9,6,5,37,29,8,33
Krasnodar,9756,4,9,5,6,32,27,5,32
Zenit,9756,5,7,10,3,23,15,8,31
Terek Grozny,9756,6,7,6,7,22,26,-4,27
Din Moscow,9756,7,5,7,8,19,24,-5,22
FK Rubin,9756,8,5,6,9,24,22,2,21
Rostov,9756,9,5,6,9,11,17,-6,21
Amkar,9756,10,4,6,10,12,25,-13,18
Anzhi,9756,11,3,5,12,17,39,-22,14
Loko Moscow,9757,1,11,7,2,30,12,18,40
CSKA Moscow,9757,2,11,4,5,26,17,9,37
Spart Moscow,9757,3,10,5,5,40,29,11,35
Krasnodar,9757,4,9,5,6,30,26,4,32
Zenit,9757,5,7,10,3,21,13,8,31
Terek Grozny,9757,6,8,6,6,22,22,0,30
Din Moscow,9757,7,5,7,8,17,24,-7,22
FK Rubin,9757,8,5,6,9,22,19,3,21
Amkar,9757,9,5,5,10,12,24,-12,20
Rostov,9757,10,4,6,10,11,19,-8,18
Anzhi,9757,11,2,5,13,14,40,-26,11
Loko Moscow,9758,1,12,6,2,31,12,19,42
CSKA Moscow,9758,2,12,3,5,30,18,12,39
Spart Moscow,9758,3,10,6,4,38,26,12,36
Zenit,9758,4,7,9,4,22,15,7,30
Krasnodar,9758,5,8,4,8,28,28,0,28
FK Rubin,9758,6,7,5,8,26,19,7,26
Terek Grozny,9758,7,7,5,8,21,25,-4,26
Din Moscow,9758,8,5,6,9,18,24,-6,21
Rostov,9758,9,4,7,9,11,18,-7,19
Amkar,9758,10,5,4,11,10,25,-15,19
Anzhi,9758,11,3,5,12,17,42,-25,14
Loko Moscow,9759,1,12,5,3,30,16,14,41
Spart Moscow,9759,2,11,5,4,41,27,14,38
Krasnodar,9759,3,10,4,6,34,25,9,34
CSKA Moscow,9759,4,10,4,6,25,18,7,34
Zenit,9759,5,8,8,4,22,14,8,32
Terek Grozny,9759,6,7,6,7,20,23,-3,27
Din Moscow,9759,7,5,7,8,20,25,-5,22
FK Rubin,9759,8,5,6,9,24,21,3,21
Rostov,9759,9,4,6,10,11,20,-9,18
Amkar,9759,10,4,5,11,9,25,-16,17
Anzhi,9759,11,3,6,11,15,37,-22,15
Loko Moscow,9760,1,12,5,3,31,15,16,41
CSKA Moscow,9760,2,12,3,5,28,17,11,39
Spart Moscow,9760,3,10,6,4,36,25,11,36
Krasnodar,9760,4,9,4,7,30,26,4,31
Terek Grozny,9760,5,8,6,6,25,25,0,30
Zenit,9760,6,7,8,5,22,16,6,29
Din Moscow,9760,7,6,6,8,19,23,-4,24
FK Rubin,9760,8,6,5,9,23,19,4,23
Rostov,9760,9,4,7,9,10,17,-7,19
Amkar,9760,10,4,4,12,10,26,-16,16
Anzhi,9760,11,2,6,12,16,41,-25,12
Loko Moscow,9761,1,11,5,4,29,14,15,38
Spart Moscow,9761,2,10,6,4,39,26,13,36
CSKA Moscow,9761,3,11,3,6,27,21,6,36
Zenit,9761,4,9,8,3,27,14,13,35
Krasnodar,9761,5,10,4,6,30,25,5,34
Terek Grozny,9761,6,7,6,7,21,24,-3,27
Din Moscow,9761,7,6,6,8,18,25,-7,24
FK Rubin,9761,8,5,5,10,22,20,2,20
Rostov,9761,9,4,7,9,11,18,-7,19
Amkar,9761,10,4,5,11,10,24,-14,17
Anzhi,9761,11,3,5,12,15,38,-23,14
Loko Moscow,9762,1,11,5,4,30,15,15,38
CSKA Moscow,9762,2,10,4,6,25,18,7,34
Krasnodar,9762,3,10,4,6,32,26,6,34
Zenit,9762,4,8,9,3,23,13,10,33
Spart Moscow,9762,5,9,6,5,38,31,7,33
Terek Grozny,9762,6,8,6,6,23,24,-1,30
Din Moscow,9762,7,6,7,7,22,24,-2,25
FK Rubin,9762,8,5,5,10,23,23,0,20
Amkar,9762,9,5,4,11,13,24,-11,19
Rostov,9762,10,4,6,10,11,20,-9,18
Anzhi,9762,11,3,6,11,16,38,-22,15
Loko Moscow,9763,1,12,6,2,34,13,21,42
CSKA Moscow,9763,2,10,5,5,27,19,8,35
Spart Moscow,9763,3,9,6,5,36,27,9,33
Zenit,9763,4,7,9,4,22,17,5,30
Krasnodar,9763,5,8,6,6,31,28,3,30
Terek Grozny,9763,6,7,6,7,21,24,-3,27
Din Moscow,9763,7,6,7,7,19,22,-3,25
FK Rubin,9763,8,5,6,9,23,20,3,21
Rostov,9763,9,5,6,9,11,17,-6,21
Amkar,9763,10,5,4,11,10,24,-14,19
Anzhi,9763,11,2,7,11,16,39,-23,13
Loko Moscow,9764,1,12,5,3,33,15,18,41
CSKA Moscow,9764,2,11,4,5,26,17,9,37
Spart Moscow,9764,3,10,6,4,37,26,11,36
Krasnodar,9764,4,10,4,6,33,28,5,34
Zenit,9764,5,7,9,4,23,16,7,30
Terek Grozny,9764,6,7,5,8,20,26,-6,26
Din Moscow,9764,7,6,7,7,21,24,-3,25
FK Rubin,9764,8,5,5,10,26,24,2,20
Amkar,9764,9,5,4,11,11,24,-13,19
Rostov,9764,10,4,6,10,10,18,-8,18
Anzhi,9764,11,3,5,12,16,38,-22,14
Loko Moscow,9765,1,11,6,3,30,17,13,39
CSKA Moscow,9765,2,11,3,6,29,19,10,36
Krasnodar,9765,3,10,4,6,34,25,9,34
Zenit,9765,4,8,9,3,24,14,10,33
Spart Moscow,9765,5,9,6,5,37,30,7,33
Din Moscow,9765,6,7,6,7,24,22,2,27
Terek Grozny,9765,7,7,6,7,21,24,-3,27
FK Rubin,9765,8,5,5,10,22,22,0,20
Rostov,9765,9,4,7,9,11,18,-7,19
Amkar,9765,10,4,5,11,10,25,-15,17
Anzhi,9765,11,3,5,12,15,41,-26,14
Loko Moscow,9766,1,11,6,3,30,16,14,39
CSKA Moscow,9766,2,11,4,5,28,18,10,37
Spart Moscow,9766,3,10,5,5,40,30,10,35
Krasnodar,9766,4,10,4,6,34,25,9,34
Zenit,9766,5,7,10,3,22,14,8,31
Terek Grozny,9766,6,7,7,6,22,24,-2,28
Din Moscow,9766,7,6,6,8,21,25,-4,24
FK Rubin,9766,8,6,5,9,22,19,3,23
Rostov,9766,9,4,6,10,10,19,-9,18
Amkar,9766,10,4,5,11,11,25,-14,17
Anzhi,9766,11,2,6,12,15,40,-25,12
Loko Moscow,9767,1,12,6,2,31,12,19,42
CSKA Moscow,9767,2,12,3,5,28,17,11,39
Spart Moscow,9767,3,9,7,4,36,27,9,34
Zenit,9767,4,7,8,5,21,15,6,29
Krasnodar,9767,5,8,5,7,28,26,2,29
Terek Grozny,9767,6,8,5,7,22,23,-1,29
Din Moscow,9767,7,6,7,7,20,22,-2,25
FK Rubin,9767,8,6,5,9,22,19,3,23
Amkar,9767,9,5,5,10,11,23,-12,20
Rostov,9767,10,4,6,10,10,18,-8,18
Anzhi,9767,11,2,5,13,14,41,-27,11
Loko Moscow,9768,1,12,5,3,31,13,18,41
CSKA Moscow,9768,2,10,4,6,27,20,7,34
Spart Moscow,9768,3,8,8,4,35,27,8,32
Krasnodar,9768,4,9,4,7,29,27,2,31
Zenit,9768,5,7,9,4,22,15,7,30
Terek Grozny,9768,6,7,6,7,22,27,-5,27
FK Rubin,9768,7,6,6,8,24,18,6,24
Din Moscow,9768,8,5,8,7,18,22,-4,23
Amkar,9768,9,5,5,10,13,23,-10,20
Rostov,9768,10,4,7,9,11,18,-7,19
Anzhi,9768,11,3,6,11,18,40,-22,15
Loko Moscow,9769,1,11,6,3,30,15,15,39
CSKA Moscow,9769,2,11,3,6,27,18,9,36
Zenit,9769,3,9,8,3,25,13,12,35
Spart Moscow,9769,4,9,5,6,35,29,6,32
Krasnodar,9769,5,8,5,7,28,26,2,29
Terek Grozny,9769,6,7,6,7,23,26,-3,27
FK Rubin,9769,7,6,6,8,23,18,5,24
Din Moscow,9769,8,5,7,8,18,24,-6,22
Amkar,9769,9,6,4,10,12,23,-11,22
Rostov,9769,10,5,6,9,13,17,-4,21
Anzhi,9769,11,2,6,12,16,41,-25,12
Loko Moscow,9770,1,12,5,3,32,14,18,41
CSKA Moscow,9770,2,11,4,5,29,18,11,37
Spart Moscow,9770,3,9,6,5,37,27,10,33
Krasnodar,9770,4,9,5,6,29,25,4,32
Zenit,9770,5,7,9,4,22,15,7,30
Terek Grozny,9770,6,8,6,6,22,23,-1,30
Din Moscow,9770,7,5,8,7,18,22,-4,23
FK Rubin,9770,8,5,7,8,22,18,4,22
Amkar,9770,9,5,5,10,12,24,-12,20
Rostov,9770,10,4,6,10,10,20,-10,18
Anzhi,9770,11,2,5,13,15,42,-27,11
Loko Moscow,9771,1,11,5,4,32,16,16,38
Spart Moscow,9771,2,10,6,4,36,25,11,36
CSKA Moscow,9771,3,11,3,6,27,19,8,36
Zenit,9771,4,9,8,3,26,16,10,35
Krasnodar,9771,5,9,4,7,30,31,-1,31
Terek Grozny,9771,6,8,6,6,24,24,0,30
Din Moscow,9771,7,6,6,8,19,24,-5,24
FK Rubin,9771,8,6,5,9,28,20,8,23
Rostov,9771,9,4,6,10,10,18,-8,18
Amkar,9771,10,4,6,10,10,23,-13,18
Anzhi,9771,11,2,5,13,15,41,-26,11
Loko Moscow,9772,1,11,6,3,31,15,16,39
CSKA Moscow,9772,2,11,4,5,28,18,10,37
Krasnodar,9772,3,10,4,6,30,24,6,34
Spart Moscow,9772,4,9,6,5,37,27,10,33
Zenit,9772,5,7,10,3,24,16,8,31
Terek Grozny,9772,6,7,5,8,20,25,-5,26
Din Moscow,9772,7,6,7,7,18,21,-3,25
Amkar,9772,8,6,4,10,11,22,-11,22
FK Rubin,9772,9,5,5,10,21,19,2,20
Rostov,9772,10,4,6,10,11,21,-10,18
Anzhi,9772,11,3,5,12,16,39,-23,14
Loko Moscow,9773,1,11,6,3,32,15,17,39
CSKA Moscow,9773,2,11,4,5,29,20,9,37
Zenit,9773,3,8,8,4,25,17,8,32
Krasnodar,9773,4,9,5,6,30,25,5,32
Spart Moscow,9773,5,8,7,5,36,30,6,31
Terek Grozny,9773,6,8,6,6,23,24,-1,30
Din Moscow,9773,7,5,8,7,19,23,-4,23
FK Rubin,9773,8,5,6,9,21,19,2,21
Rostov,9773,9,4,7,9,11,18,-7,19
Amkar,9773,10,5,4,11,11,23,-12,19
Anzhi,9773,11,2,7,11,18,41,-23,13
Loko Moscow,9774,1,11,5,4,29,13,16,38
CSKA Moscow,9774,2,11,4,5,27,17,10,37
Spart Moscow,9774,3,9,7,4,38,28,10,34
Zenit,9774,4,8,9,3,22,13,9,33
Krasnodar,9774,5,9,4,7,28,25,3,31
Terek Grozny,9774,6,8,6,6,22,22,0,30
Din Moscow,9774,7,6,7,7,19,22,-3,25
FK Rubin,9774,8,6,5,9,22,18,4,23
Rostov,9774,9,4,7,9,12,19,-7,19
Amkar,9774,10,4,4,12,9,26,-17,16
Anzhi,9774,11,2,6,12,14,39,-25,12
Loko Moscow,9775,1,11,6,3,31,14,17,39
CSKA Moscow,9775,2,11,4,5,27,18,9,37
Spart Moscow,9775,3,10,5,5,38,30,8,35
Zenit,9775,4,8,9,3,23,14,9,33
Krasnodar,9775,5,9,5,6,31,27,4,32
Terek Grozny,9775,6,8,6,6,22,23,-1,30
Din Moscow,9775,7,7,6,7,23,23,0,27
FK Rubin,9775,8,5,5,10,23,21,2,20
Rostov,9775,9,4,6,10,11,20,-9,18
Amkar,9775,10,4,4,12,9,24,-15,16
Anzhi,9775,11,2,6,12,15,39,-24,12
Loko Moscow,9776,1,12,6,2,30,11,19,42
CSKA Moscow,9776,2,11,3,6,29,22,7,36
Zenit,9776,3,8,9,3,24,14,10,33
Terek Grozny,9776,4,9,5,6,22,22,0,32
Spart Moscow,9776,5,8,7,5,33,27,6,31
Krasnodar,9776,6,9,4,7,29,25,4,31
FK Rubin,9776,7,6,5,9,24,21,3,23
Din Moscow,9776,8,5,7,8,19,24,-5,22
Rostov,9776,9,5,6,9,12,17,-5,21
Amkar,9776,10,4,5,11,9,23,-14,17
Anzhi,9776,11,2,5,13,16,41,-25,11
Loko Moscow,9777,1,11,6,3,31,15,16,39
CSKA Moscow,9777,2,12,3,5,30,19,11,39
Spart Moscow,9777,3,10,5,5,40,29,11,35
Krasnodar,9777,4,10,4,6,33,27,6,34
Zenit,9777,5,7,9,4,21,15,6,30
Terek Grozny,9777,6,8,5,7,24,26,-2,29
Din Moscow,9777,7,6,6,8,20,24,-4,24
Rostov,9777,8,5,6,9,12,18,-6,21
FK Rubin,9777,9,5,5,10,22,21,1,20
Amkar,9777,10,5,4,11,12,26,-14,19
Anzhi,9777,11,2,5,13,18,43,-25,11
Loko Moscow,9778,1,12,5,3,30,12,18,41
CSKA Moscow,9778,2,11,4,5,30,19,11,37
Krasnodar,9778,3,9,5,6,29,25,4,32
Terek Grozny,9778,4,9,5,6,23,22,1,32
Spart Moscow,9778,5,8,7,5,35,29,6,31
Zenit,9778,6,7,9,4,22,15,7,30
Din Moscow,9778,7,5,8,7,18,22,-4,23
FK Rubin,9778,8,5,7,8,22,18,4,22
Rostov,9778,9,4,7,9,11,18,-7,19
Amkar,9778,10,5,4,11,11,23,-12,19
Anzhi,9778,11,2,5,13,15,43,-28,11
Loko Moscow,9779,1,12,6,2,31,12,19,42
CSKA Moscow,9779,2,11,4,5,28,18,10,37
Spart Moscow,9779,3,10,5,5,40,27,13,35
Zenit,9779,4,7,10,3,22,14,8,31
Terek Grozny,9779,5,8,6,6,23,24,-1,30
Krasnodar,9779,6,8,4,8,29,28,1,28
FK Rubin,9779,7,7,5,8,25,18,7,26
Din Moscow,9779,8,5,6,9,18,25,-7,21
Amkar,9779,9,5,5,10,10,22,-12,20
Rostov,9779,10,4,6,10,10,22,-12,18
Anzhi,9779,11,2,5,13,16,42,-26,11
Loko Moscow,9780,1,12,6,2,34,12,22,42
CSKA Moscow,9780,2,11,3,6,28,20,8,36
Zenit,9780,3,8,9,3,25,14,11,33
Spart Moscow,9780,4,8,7,5,35,28,7,31
Terek Grozny,9780,5,8,6,6,24,24,0,30
Krasnodar,9780,6,8,5,7,28,29,-1,29
Din Moscow,9780,7,5,8,7,18,22,-4,23
FK Rubin,9780,8,5,7,8,22,18,4,22
Amkar,9780,9,5,5,10,12,24,-12,20
Rostov,9780,10,4,7,9,10,17,-7,19
Anzhi,9780,11,2,5,13,15,43,-28,11
Loko Moscow,9781,1,12,5,3,32,13,19,41
CSKA Moscow,9781,2,12,3,5,31,17,14,39
Spart Moscow,9781,3,11,5,4,38,27,11,38
Krasnodar,9781,4,10,4,6,32,25,7,34
Zenit,9781,5,7,8,5,21,16,5,29
Terek Grozny,9781,6,8,5,7,23,26,-3,29
Din Moscow,9781,7,6,6,8,20,24,-4,24
FK Rubin,9781,8,5,5,10,22,22,0,20
Rostov,9781,9,4,6,10,10,18,-8,18
Amkar,9781,10,4,4,12,10,26,-16,16
Anzhi,9781,11,3,5,12,18,43,-25,14
Loko Moscow,9782,1,12,6,2,32,12,20,42
CSKA Moscow,9782,2,11,4,5,27,18,9,37
Zenit,9782,3,7,9,4,22,16,6,30
Terek Grozny,9782,4,8,6,6,23,22,1,30
Spart Moscow,9782,5,8,5,7,37,32,5,29
Krasnodar,9782,6,8,5,7,28,26,2,29
Din Moscow,9782,7,6,7,7,19,22,-3,25
FK Rubin,9782,8,6,6,8,22,17,5,24
Rostov,9782,9,5,6,9,14,20,-6,21
Amkar,9782,10,5,5,10,10,22,-12,20
Anzhi,9782,11,2,5,13,14,41,-27,11
Loko Moscow,9783,1,11,6,3,31,14,17,39
Krasnodar,9783,2,10,4,6,31,25,6,34
CSKA Moscow,9783,3,10,4,6,27,21,6,34
Spart Moscow,9783,4,9,6,5,38,28,10,33
Zenit,9783,5,7,10,3,24,16,8,31
Terek Grozny,9783,6,8,6,6,22,22,0,30
Din Moscow,9783,7,6,6,8,19,25,-6,24
FK Rubin,9783,8,5,5,10,22,21,1,20
Rostov,9783,9,4,7,9,11,18,-7,19
Amkar,9783,10,5,4,11,10,24,-14,19
Anzhi,9783,11,3,6,11,17,38,-21,15
CSKA Moscow,9784,1,12,3,5,28,17,11,39
Spart Moscow,9784,2,11,5,4,41,26,15,38
Loko Moscow,9784,3,11,5,4,30,17,13,38
Zenit,9784,4,8,8,4,23,14,9,32
Terek Grozny,9784,5,9,5,6,24,23,1,32
Krasnodar,9784,6,9,4,7,32,28,4,31
Din Moscow,9784,7,6,6,8,20,25,-5,24
FK Rubin,9784,8,6,5,9,25,20,5,23
Rostov,9784,9,4,6,10,10,20,-10,18
Amkar,9784,10,4,4,12,9,25,-16,16
Anzhi,9784,11,2,5,13,15,42,-27,11
Loko Moscow,9785,1,11,6,3,31,16,15,39
CSKA Moscow,9785,2,10,5,5,26,18,8,35
Krasnodar,9785,3,10,4,6,33,26,7,34
Spart Moscow,9785,4,9,6,5,39,28,11,33
Zenit,9785,5,7,10,3,22,14,8,31
Terek Grozny,9785,6,7,6,7,21,26,-5,27
Din Moscow,9785,7,6,7,7,19,22,-3,25
FK Rubin,9785,8,5,6,9,22,19,3,21
Rostov,9785,9,4,7,9,11,18,-7,19
Amkar,9785,10,5,4,11,12,26,-14,19
Anzhi,9785,11,2,7,11,16,39,-23,13
Loko Moscow,9786,1,12,6,2,32,11,21,42
CSKA Moscow,9786,2,11,4,5,29,18,11,37
Spart Moscow,9786,3,10,6,4,41,26,15,36
Zenit,9786,4,7,9,4,22,17,5,30
Terek Grozny,9786,5,8,6,6,22,22,0,30
Krasnodar,9786,6,8,5,7,29,27,2,29
FK Rubin,9786,7,7,5,8,26,20,6,26
Din Moscow,9786,8,5,6,9,18,26,-8,21
Rostov,9786,9,4,7,9,11,18,-7,19
Amkar,9786,10,4,5,11,9,26,-17,17
Anzhi,9786,11,2,5,13,14,42,-28,11
Loko Moscow,9787,1,12,5,3,31,13,18,41
CSKA Moscow,9787,2,10,4,6,28,21,7,34
Spart Moscow,9787,3,9,6,5,37,27,10,33
Zenit,9787,4,8,8,4,23,15,8,32
Krasnodar,9787,5,9,4,7,29,26,3,31
Terek Grozny,9787,6,8,6,6,24,24,0,30
FK Rubin,9787,7,6,6,8,22,17,5,24
Din Moscow,9787,8,5,7,8,17,24,-7,22
Rostov,9787,9,5,6,9,11,17,-6,21
Amkar,9787,10,4,6,10,11,24,-13,18
Anzhi,9787,11,2,6,12,17,42,-25,12
Loko Moscow,9788,1,12,6,2,31,12,19,42
CSKA Moscow,9788,2,11,4,5,29,17,12,37
Zenit,9788,3,7,10,3,21,13,8,31
Krasnodar,9788,4,9,4,7,31,27,4,31
Spart Moscow,9788,5,8,6,6,34,28,6,30
Terek Grozny,9788,6,7,5,8,21,28,-7,26
Din Moscow,9788,7,6,7,7,19,22,-3,25
Amkar,9788,8,6,4,10,12,22,-10,22
Rostov,9788,9,5,6,9,12,18,-6,21
FK Rubin,9788,10,5,5,10,23,22,1,20
Anzhi,9788,11,3,5,12,18,42,-24,14
Loko Moscow,9789,1,11,5,4,31,15,16,38
Zenit,9789,2,9,8,3,24,13,11,35
Spart Moscow,9789,3,9,6,5,36,26,10,33
CSKA Moscow,9789,4,10,3,7,25,21,4,33
Krasnodar,9789,5,9,5,6,32,28,4,32
Terek Grozny,9789,6,8,6,6,22,23,-1,30
Din Moscow,9789,7,6,7,7,20,22,-2,25
FK Rubin,9789,8,5,6,9,24,22,2,21
Amkar,9789,9,5,5,10,11,23,-12,20
Rostov,9789,10,4,6,10,10,20,-10,18
Anzhi,9789,11,3,5,12,16,38,-22,14
Loko Moscow,9790,1,11,6,3,29,17,12,39
Spart Moscow,9790,2,10,6,4,38,28,10,36
CSKA Moscow,9790,3,10,4,6,27,22,5,34
Zenit,9790,4,8,9,3,25,14,11,33
Krasnodar,9790,5,9,5,6,34,25,9,32
Terek Grozny,9790,6,9,5,6,24,22,2,32
FK Rubin,9790,7,6,6,8,23,18,5,24
Din Moscow,9790,8,5,6,9,17,23,-6,21
Rostov,9790,9,4,6,10,11,19,-8,18
Amkar,9790,10,4,5,11,11,25,-14,17
Anzhi,9790,11,2,6,12,15,41,-26,12
Loko Moscow,9791,1,11,7,2,30,12,18,40
CSKA Moscow,9791,2,11,4,5,28,18,10,37
Krasnodar,9791,3,9,5,6,28,24,4,32
Zenit,9791,4,7,10,3,22,14,8,31
Spart Moscow,9791,5,8,7,5,36,29,7,31
Din Moscow,9791,6,7,6,7,21,23,-2,27
Terek Grozny,9791,7,7,6,7,21,24,-3,27
FK Rubin,9791,8,5,5,10,21,19,2,20
Rostov,9791,9,4,7,9,10,17,-7,19
Amkar,9791,10,4,6,10,11,24,-13,18
Anzhi,9791,11,3,5,12,16,40,-24,14
Loko Moscow,9792,1,11,6,3,32,15,17,39
Spart Moscow,9792,2,11,5,4,42,26,16,38
CSKA Moscow,9792,3,11,4,5,28,19,9,37
Zenit,9792,4,8,9,3,25,16,9,33
Terek Grozny,9792,5,9,5,6,24,24,0,32
Krasnodar,9792,6,8,6,6,28,25,3,30
FK Rubin,9792,7,5,7,8,22,18,4,22
Din Moscow,9792,8,5,7,8,19,26,-7,22
Rostov,9792,9,4,6,10,10,21,-11,18
Amkar,9792,10,4,4,12,10,25,-15,16
Anzhi,9792,11,2,5,13,16,41,-25,11
Loko Moscow,9793,1,11,7,2,31,13,18,40
CSKA Moscow,9793,2,12,3,5,30,19,11,39
Spart Moscow,9793,3,9,5,6,38,30,8,32
Zenit,9793,4,7,9,4,22,15,7,30
Krasnodar,9793,5,8,5,7,29,27,2,29
Terek Grozny,9793,6,7,6,7,21,24,-3,27
Din Moscow,9793,7,6,7,7,20,22,-2,25
FK Rubin,9793,8,6,6,8,22,17,5,24
Amkar,9793,9,6,4,10,12,23,-11,22
Rostov,9793,10,4,6,10,10,20,-10,18
Anzhi,9793,11,2,6,12,16,41,-25,12
Loko Moscow,9794,1,12,5,3,32,13,19,41
CSKA Moscow,9794,2,10,4,6,25,18,7,34
Krasnodar,9794,3,10,4,6,31,26,5,34
Spart Moscow,9794,4,9,6,5,37,28,9,33
Zenit,9794,5,7,9,4,21,15,6,30
Terek Grozny,9794,6,8,6,6,23,23,0,30
Din Moscow,9794,7,6,6,8,23,26,-3,24
FK Rubin,9794,8,5,5,10,23,23,0,20
Amkar,9794,9,5,5,10,11,23,-12,20
Rostov,9794,10,4,7,9,10,17,-7,19
Anzhi,9794,11,3,5,12,15,39,-24,14
Loko Moscow,9795,1,12,6,2,31,12,19,42
CSKA Moscow,9795,2,12,3,5,30,18,12,39
Spart Moscow,9795,3,9,6,5,37,30,7,33
Krasnodar,9795,4,9,4,7,28,25,3,31
Zenit,9795,5,7,9,4,22,17,5,30
Terek Grozny,9795,6,8,6,6,21,22,-1,30
FK Rubin,9795,7,6,5,9,22,18,4,23
Din Moscow,9795,8,5,7,8,18,23,-5,22
Amkar,9795,9,5,4,11,12,24,-12,19
Rostov,9795,10,4,6,10,11,19,-8,18
Anzhi,9795,11,2,6,12,15,39,-24,12
Spart Moscow,9796,1,11,5,4,42,26,16,38
Loko Moscow,9796,2,11,5,4,31,16,15,38
CSKA Moscow,9796,3,11,3,6,28,22,6,36
Zenit,9796,4,9,8,3,29,16,13,35
Krasnodar,9796,5,9,5,6,29,25,4,32
Terek Grozny,9796,6,8,6,6,21,22,-1,30
FK Rubin,9796,7,6,6,8,24,19,5,24
Din Moscow,9796,8,5,6,9,18,28,-10,21
Rostov,9796,9,4,6,10,11,20,-9,18
Amkar,9796,10,4,5,11,9,23,-14,17
Anzhi,9796,11,2,5,13,15,40,-25,11
Loko Moscow,9797,1,11,6,3,31,14,17,39
Spart Moscow,9797,2,11,5,4,38,26,12,38
CSKA Moscow,9797,3,11,4,5,28,19,9,37
Krasnodar,9797,4,10,4,6,31,26,5,34
Zenit,9797,5,7,9,4,22,15,7,30
Terek Grozny,9797,6,7,6,7,22,27,-5,27
Din Moscow,9797,7,6,6,8,23,23,0,24
FK Rubin,9797,8,5,5,10,23,25,-2,20
Amkar,9797,9,5,4,11,14,25,-11,19
Rostov,9797,10,4,6,10,10,19,-9,18
Anzhi,9797,11,2,7,11,17,40,-23,13
Loko Moscow,9798,1,12,6,2,32,11,21,42
Spart Moscow,9798,2,10,5,5,38,27,11,35
CSKA Moscow,9798,3,10,4,6,26,19,7,34
Zenit,9798,4,8,8,4,22,16,6,32
Krasnodar,9798,5,9,5,6,29,24,5,32
Terek Grozny,9798,6,9,5,6,25,25,0,32
Din Moscow,9798,7,5,7,8,17,23,-6,22
FK Rubin,9798,8,5,6,9,21,19,2,21
Amkar,9798,9,5,4,11,12,25,-13,19
Rostov,9798,10,4,6,10,10,19,-9,18
Anzhi,9798,11,2,6,12,17,41,-24,12
Loko Moscow,9799,1,13,5,2,33,13,20,44
CSKA Moscow,9799,2,11,4,5,29,20,9,37
Spart Moscow,9799,3,9,5,6,39,31,8,32
Krasnodar,9799,4,9,4,7,30,26,4,31
Zenit,9799,5,7,9,4,24,17,7,30
Terek Grozny,9799,6,8,6,6,24,24,0,30
Din Moscow,9799,7,6,7,7,20,22,-2,25
FK Rubin,9799,8,5,6,9,21,19,2,21
Amkar,9799,9,5,4,11,13,25,-12,19
Rostov,9799,10,4,6,10,10,22,-12,18
Anzhi,9799,11,2,6,12,16,40,-24,12
Loko Moscow,9800,1,12,6,2,33,12,21,42
Spart Moscow,9800,2,11,5,4,37,25,12,38
CSKA Moscow,9800,3,11,3,6,30,20,10,36
Zenit,9800,4,8,8,4,22,16,6,32
Terek Grozny,9800,5,8,6,6,25,24,1,30
Krasnodar,9800,6,8,5,7,28,26,2,29
Din Moscow,9800,7,6,6,8,19,23,-4,24
FK Rubin,9800,8,6,5,9,23,19,4,23
Rostov,9800,9,4,6,10,10,18,-8,18
Amkar,9800,10,4,4,12,10,28,-18,16
Anzhi,9800,11,2,6,12,17,43,-26,12
Loko Moscow,9801,1,11,6,3,31,14,17,39
CSKA Moscow,9801,2,11,4,5,27,18,9,37
Spart Moscow,9801,3,9,6,5,38,29,9,33
Zenit,9801,4,8,9,3,23,14,9,33
Krasnodar,9801,5,8,6,6,29,26,3,30
Terek Grozny,9801,6,7,7,6,22,24,-2,28
FK Rubin,9801,7,6,6,8,25,19,6,24
Rostov,9801,8,5,6,9,11,17,-6,21
Din Moscow,9801,9,5,6,9,19,27,-8,21
Amkar,9801,10,4,6,10,11,24,-13,18
Anzhi,9801,11,2,6,12,17,41,-24,12
Loko Moscow,9802,1,11,6,3,29,12,17,39
CSKA Moscow,9802,2,11,4,5,30,19,11,37
Spart Moscow,9802,3,10,5,5,40,28,12,35
Krasnodar,9802,4,9,5,6,28,24,4,32
Zenit,9802,5,7,10,3,22,14,8,31
Terek Grozny,9802,6,8,5,7,22,24,-2,29
Din Moscow,9802,7,6,6,8,20,26,-6,24
FK Rubin,9802,8,5,6,9,22,19,3,21
Rostov,9802,9,5,6,9,12,18,-6,21
Amkar,9802,10,5,4,11,11,25,-14,19
Anzhi,9802,11,2,5,13,15,42,-27,11
Loko Moscow,9803,1,12,5,3,32,14,18,41
CSKA Moscow,9803,2,12,3,5,31,20,11,39
Spart Moscow,9803,3,10,6,4,40,26,14,36
Zenit,9803,4,8,8,4,23,15,8,32
Krasnodar,9803,5,9,4,7,31,28,3,31
Terek Grozny,9803,6,7,6,7,21,25,-4,27
Din Moscow,9803,7,6,6,8,19,25,-6,24
FK Rubin,9803,8,5,5,10,22,21,1,20
Rostov,9803,9,4,7,9,11,18,-7,19
Amkar,9803,10,5,4,11,12,25,-13,19
Anzhi,9803,11,2,6,12,16,41,-25,12
Loko Moscow,9804,1,12,6,2,31,11,20,42
CSKA Moscow,9804,2,11,3,6,28,20,8,36
Spart Moscow,9804,3,9,7,4,37,28,9,34
Zenit,9804,4,8,9,3,23,13,10,33
Krasnodar,9804,5,9,4,7,29,26,3,31
Terek Grozny,9804,6,8,5,7,22,24,-2,29
Din Moscow,9804,7,6,6,8,19,23,-4,24
FK Rubin,9804,8,5,5,10,22,21,1,20
Amkar,9804,9,5,5,10,12,23,-11,20
Rostov,9804,10,4,7,9,12,19,-7,19
Anzhi,9804,11,2,5,13,15,42,-27,11
Loko Moscow,9805,1,12,5,3,34,12,22,41
CSKA Moscow,9805,2,10,3,7,26,22,4,33
Zenit,9805,3,8,8,4,23,19,4,32
Krasnodar,9805,4,9,4,7,28,25,3,31
Terek Grozny,9805,5,8,6,6,22,23,-1,30
Spart Moscow,9805,6,8,5,7,36,32,4,29
Din Moscow,9805,7,7,6,7,21,21,0,27
FK Rubin,9805,8,6,5,9,22,19,3,23
Rostov,9805,9,5,6,9,13,19,-6,21
Amkar,9805,10,5,4,11,11,24,-13,19
Anzhi,9805,11,3,6,11,18,38,-20,15
Loko Moscow,9806,1,13,5,2,32,11,21,44
Spart Moscow,9806,2,9,7,4,38,28,10,34
CSKA Moscow,9806,3,10,4,6,28,22,6,34
Zenit,9806,4,8,8,4,25,16,9,32
Krasnodar,9806,5,9,4,7,29,26,3,31
Terek Grozny,9806,6,7,6,7,20,24,-4,27
Din Moscow,9806,7,6,7,7,21,24,-3,25
FK Rubin,9806,8,5,5,10,22,21,1,20
Rostov,9806,9,4,7,9,11,18,-7,19
Amkar,9806,10,5,4,11,11,24,-13,19
Anzhi,9806,11,2,7,11,15,38,-23,13
Loko Moscow,9807,1,12,6,2,30,11,19,42
CSKA Moscow,9807,2,12,3,5,27,17,10,39
Spart Moscow,9807,3,9,6,5,39,30,9,33
Krasnodar,9807,4,9,4,7,30,26,4,31
Zenit,9807,5,7,9,4,21,14,7,30
Terek Grozny,9807,6,8,5,7,23,25,-2,29
Din Moscow,9807,7,5,8,7,19,23,-4,23
FK Rubin,9807,8,5,6,9,23,21,2,21
Amkar,9807,9,5,4,11,14,26,-12,19
Rostov,9807,10,4,6,10,10,20,-10,18
Anzhi,9807,11,3,5,12,16,39,-23,14
Loko Moscow,9808,1,12,6,2,30,11,19,42
CSKA Moscow,9808,2,12,3,5,30,17,13,39
Spart Moscow,9808,3,11,5,4,40,29,11,38
Krasnodar,9808,4,8,6,6,28,25,3,30
Zenit,9808,5,7,8,5,21,18,3,29
Terek Grozny,9808,6,8,5,7,22,25,-3,29
Din Moscow,9808,7,6,6,8,21,25,-4,24
FK Rubin,9808,8,5,6,9,23,20,3,21
Amkar,9808,9,5,4,11,12,23,-11,19
Rostov,9808,10,4,6,10,12,20,-8,18
Anzhi,9808,11,2,5,13,14,40,-26,11
Loko Moscow,9809,1,13,5,2,32,12,20,44
Spart Moscow,9809,2,9,6,5,37,28,9,33
CSKA Moscow,9809,3,10,3,7,26,21,5,33
Zenit,9809,4,8,8,4,23,15,8,32
Krasnodar,9809,5,9,4,7,30,25,5,31
Terek Grozny,9809,6,8,6,6,24,23,1,30
FK Rubin,9809,7,6,5,9,23,21,2,23
Rostov,9809,8,5,6,9,11,17,-6,21
Din Moscow,9809,9,5,6,9,18,25,-7,21
Amkar,9809,10,4,6,10,12,25,-13,18
Anzhi,9809,11,3,5,12,17,41,-24,14
Loko Moscow,9810,1,12,5,3,31,13,18,41
CSKA Moscow,9810,2,12,3,5,31,20,11,39
Zenit,9810,3,8,8,4,24,16,8,32
Krasnodar,9810,4,9,4,7,30,28,2,31
Spart Moscow,9810,5,8,5,7,35,30,5,29
Terek Grozny,9810,6,7,5,8,22,28,-6,26
Din Moscow,9810,7,6,7,7,22,25,-3,25
Amkar,9810,8,6,4,10,12,23,-11,22
FK Rubin,9810,9,5,6,9,25,22,3,21
Rostov,9810,10,5,6,9,11,17,-6,21
Anzhi,9810,11,3,5,12,20,41,-21,14
Loko Moscow,9811,1,12,5,3,31,13,18,41
Spart Moscow,9811,2,10,6,4,38,26,12,36
CSKA Moscow,9811,3,11,3,6,28,22,6,36
Zenit,9811,4,9,8,3,25,13,12,35
Terek Grozny,9811,5,8,6,6,23,23,0,30
Krasnodar,9811,6,8,4,8,28,27,1,28
FK Rubin,9811,7,7,5,8,24,17,7,26
Din Moscow,9811,8,5,6,9,18,26,-8,21
Rostov,9811,9,4,6,10,10,19,-9,18
Amkar,9811,10,4,6,10,9,22,-13,18
Anzhi,9811,11,2,5,13,17,43,-26,11
Loko Moscow,9812,1,12,5,3,32,14,18,41
CSKA Moscow,9812,2,11,4,5,28,19,9,37
Spart Moscow,9812,3,9,5,6,37,32,5,32
Krasnodar,9812,4,9,4,7,31,28,3,31
Zenit,9812,5,7,8,5,22,16,6,29
Terek Grozny,9812,6,7,7,6,22,24,-2,28
Din Moscow,9812,7,6,6,8,19,24,-5,24
FK Rubin,9812,8,6,5,9,23,19,4,23
Rostov,9812,9,5,6,9,12,17,-5,21
Amkar,9812,10,5,5,10,14,24,-10,20
Anzhi,9812,11,2,7,11,16,39,-23,13
Loko Moscow,9813,1,11,7,2,30,12,18,40
Spart Moscow,9813,2,11,5,4,42,29,13,38
CSKA Moscow,9813,3,11,3,6,27,20,7,36
Zenit,9813,4,7,9,4,22,15,7,30
Krasnodar,9813,5,8,6,6,30,27,3,30
Terek Grozny,9813,6,8,6,6,23,24,-1,30
Din Moscow,9813,7,6,6,8,19,24,-5,24
FK Rubin,9813,8,5,6,9,23,20,3,21
Rostov,9813,9,4,6,10,12,21,-9,18
Amkar,9813,10,4,5,11,12,26,-14,17
Anzhi,9813,11,3,5,12,16,38,-22,14
Loko Moscow,9814,1,13,5,2,33,13,20,44
CSKA Moscow,9814,2,11,3,6,28,19,9,36
Spart Moscow,9814,3,9,6,5,37,30,7,33
Zenit,9814,4,8,8,4,24,15,9,32
Krasnodar,9814,5,8,4,8,29,28,1,28
FK Rubin,9814,6,7,5,8,24,18,6,26
Terek Grozny,9814,7,7,5,8,22,28,-6,26
Rostov,9814,8,5,6,9,13,18,-5,21
Din Moscow,9814,9,5,6,9,17,23,-6,21
Amkar,9814,10,5,5,10,14,25,-11,20
Anzhi,9814,11,3,5,12,17,41,-24,14
Loko Moscow,9815,1,11,6,3,32,15,17,39
CSKA Moscow,9815,2,11,3,6,31,20,11,36
Spart Moscow,9815,3,10,5,5,39,28,11,35
Zenit,9815,4,9,8,3,24,14,10,35
Krasnodar,9815,5,9,5,6,33,27,6,32
Terek Grozny,9815,6,7,6,7,21,24,-3,27
Din Moscow,9815,7,5,7,8,18,24,-6,22
Amkar,9815,8,6,4,10,13,23,-10,22
FK Rubin,9815,9,5,6,9,22,21,1,21
Rostov,9815,10,4,6,10,10,20,-10,18
Anzhi,9815,11,2,6,12,16,43,-27,12
Loko Moscow,9816,1,13,5,2,34,12,22,44
CSKA Moscow,9816,2,11,4,5,29,18,11,37
Spart Moscow,9816,3,10,6,4,36,26,10,36
Terek Grozny,9816,4,9,5,6,24,22,2,32
Krasnodar,9816,5,9,4,7,28,25,3,31
Zenit,9816,6,7,9,4,23,18,5,30
FK Rubin,9816,7,6,5,9,24,19,5,23
Din Moscow,9816,8,5,6,9,18,25,-7,21
Rostov,9816,9,4,7,9,11,18,-7,19
Amkar,9816,10,4,4,12,9,25,-16,16
Anzhi,9816,11,2,5,13,14,42,-28,11
Loko Moscow,9817,1,12,6,2,32,12,20,42
CSKA Moscow,9817,2,11,4,5,29,20,9,37
Spart Moscow,9817,3,9,6,5,38,28,10,33
Krasnodar,9817,4,9,5,6,29,25,4,32
Terek Grozny,9817,5,9,5,6,26,23,3,32
Zenit,9817,6,7,9,4,24,18,6,30
Din Moscow,9817,7,6,7,7,19,22,-3,25
FK Rubin,9817,8,5,6,9,22,19,3,21
Rostov,9817,9,4,6,10,10,20,-10,18
Amkar,9817,10,4,5,11,12,26,-14,17
Anzhi,9817,11,2,5,13,14,42,-28,11
Loko Moscow,9818,1,11,5,4,31,15,16,38
Spart Moscow,9818,2,10,6,4,36,26,10,36
Zenit,9818,3,9,8,3,25,14,11,35
CSKA Moscow,9818,4,10,3,7,25,20,5,33
Krasnodar,9818,5,9,4,7,29,28,1,31
Terek Grozny,9818,6,7,5,8,20,24,-4,26
Din Moscow,9818,7,6,6,8,18,22,-4,24
FK Rubin,9818,8,6,5,9,24,18,6,23
Amkar,9818,9,5,5,10,10,22,-12,20
Rostov,9818,10,4,6,10,11,19,-8,18
Anzhi,9818,11,4,5,11,16,37,-21,17
Loko Moscow,9819,1,11,5,4,30,16,14,38
CSKA Moscow,9819,2,11,3,6,26,18,8,36
Zenit,9819,3,9,8,3,25,14,11,35
Spart Moscow,9819,4,9,6,5,37,28,9,33
Krasnodar,9819,5,9,5,6,30,25,5,32
Terek Grozny,9819,6,9,5,6,25,22,3,32
FK Rubin,9819,7,6,6,8,25,18,7,24
Din Moscow,9819,8,6,6,8,19,25,-6,24
Rostov,9819,9,4,6,10,10,19,-9,18
Amkar,9819,10,4,5,11,10,25,-15,17
Anzhi,9819,11,2,5,13,14,41,-27,11
Loko Moscow,9820,1,13,5,2,34,13,21,44
CSKA Moscow,9820,2,11,4,5,27,17,10,37
Terek Grozny,9820,3,9,5,6,22,22,0,32
Spart Moscow,9820,4,8,7,5,34,27,7,31
Zenit,9820,5,7,9,4,22,15,7,30
Krasnodar,9820,6,8,5,7,30,29,1,29
Din Moscow,9820,7,6,7,7,18,21,-3,25
FK Rubin,9820,8,5,6,9,23,20,3,21
Rostov,9820,9,5,6,9,12,18,-6,21
Amkar,9820,10,4,5,11,9,23,-14,17
Anzhi,9820,11,2,5,13,14,40,-26,11
Loko Moscow,9821,1,12,6,2,33,14,19,42
CSKA Moscow,9821,2,11,3,6,27,18,9,36
Spart Moscow,9821,3,10,5,5,40,31,9,35
Zenit,9821,4,8,8,4,23,15,8,32
Krasnodar,9821,5,9,5,6,30,26,4,32
Terek Grozny,9821,6,7,7,6,23,25,-2,28
Din Moscow,9821,7,5,7,8,18,23,-5,22
FK Rubin,9821,8,5,6,9,21,18,3,21
Rostov,9821,9,5,6,9,13,19,-6,21
Amkar,9821,10,4,5,11,12,26,-14,17
Anzhi,9821,11,2,6,12,16,41,-25,12
Loko Moscow,9822,1,12,5,3,31,14,17,41
CSKA Moscow,9822,2,11,3,6,29,19,10,36
Spart Moscow,9822,3,10,5,5,39,29,10,35
Zenit,9822,4,8,8,4,24,16,8,32
Krasnodar,9822,5,9,4,7,30,26,4,31
Terek Grozny,9822,6,8,5,7,24,24,0,29
FK Rubin,9822,7,7,5,8,25,19,6,26
Amkar,9822,8,6,4,10,13,23,-10,22
Din Moscow,9822,9,5,6,9,18,24,-6,21
Rostov,9822,10,4,6,10,12,21,-9,18
Anzhi,9822,11,2,5,13,14,44,-30,11
Loko Moscow,9823,1,13,5,2,36,14,22,44
CSKA Moscow,9823,2,10,4,6,28,21,7,34
Spart Moscow,9823,3,8,7,5,35,28,7,31
Krasnodar,9823,4,9,4,7,30,28,2,31
Zenit,9823,5,7,9,4,25,18,7,30
Terek Grozny,9823,6,7,6,7,23,26,-3,27
Din Moscow,9823,7,5,8,7,18,22,-4,23
FK Rubin,9823,8,5,6,9,22,20,2,21
Amkar,9823,9,5,5,10,12,24,-12,20
Rostov,9823,10,4,7,9,11,18,-7,19
Anzhi,9823,11,4,5,11,19,40,-21,17
Loko Moscow,9824,1,13,5,2,35,12,23,44
CSKA Moscow,9824,2,11,3,6,29,19,10,36
Spart Moscow,9824,3,9,5,6,35,28,7,32
Zenit,9824,4,8,8,4,23,16,7,32
Krasnodar,9824,5,8,5,7,28,28,0,29
Terek Grozny,9824,6,7,6,7,21,24,-3,27
Din Moscow,9824,7,6,7,7,19,22,-3,25
FK Rubin,9824,8,5,7,8,23,19,4,22
Rostov,9824,9,5,6,9,12,18,-6,21
Amkar,9824,10,5,4,11,10,23,-13,19
Anzhi,9824,11,2,6,12,16,42,-26,12
Loko Moscow,9825,1,12,5,3,32,12,20,41
CSKA Moscow,9825,2,12,3,5,31,18,13,39
Spart Moscow,9825,3,10,6,4,39,29,10,36
Krasnodar,9825,4,9,4,7,28,25,3,31
Zenit,9825,5,7,8,5,22,18,4,29
Terek Grozny,9825,6,8,5,7,22,26,-4,29
FK Rubin,9825,7,6,6,8,24,19,5,24
Din Moscow,9825,8,5,7,8,21,26,-5,22
Rostov,9825,9,4,7,9,12,19,-7,19
Amkar,9825,10,4,4,12,10,25,-15,16
Anzhi,9825,11,3,5,12,17,41,-24,14
Loko Moscow,9826,1,11,6,3,30,13,17,39
CSKA Moscow,9826,2,12,3,5,30,18,12,39
Spart Moscow,9826,3,9,6,5,37,28,9,33
Zenit,9826,4,8,8,4,22,15,7,32
Krasnodar,9826,5,8,6,6,28,25,3,30
Terek Grozny,9826,6,8,5,7,23,24,-1,29
FK Rubin,9826,7,6,6,8,22,17,5,24
Din Moscow,9826,8,5,7,8,17,22,-5,22
Rostov,9826,9,5,6,9,13,19,-6,21
Amkar,9826,10,4,4,12,10,27,-17,16
Anzhi,9826,11,3,5,12,16,40,-24,14
Loko Moscow,9827,1,11,6,3,31,15,16,39
CSKA Moscow,9827,2,11,3,6,27,19,8,36
Spart Moscow,9827,3,10,5,5,37,28,9,35
Zenit,9827,4,8,8,4,25,16,9,32
Krasnodar,9827,5,9,5,6,31,26,5,32
Terek Grozny,9827,6,7,6,7,22,25,-3,27
Din Moscow,9827,7,6,6,8,19,23,-4,24
FK Rubin,9827,8,5,5,10,22,21,1,20
Amkar,9827,9,5,5,10,10,22,-12,20
Rostov,9827,10,4,6,10,11,19,-8,18
Anzhi,9827,11,4,5,11,18,39,-21,17
Loko Moscow,9828,1,11,7,2,31,13,18,40
CSKA Moscow,9828,2,11,4,5,29,18,11,37
Spart Moscow,9828,3,9,6,5,36,28,8,33
Zenit,9828,4,7,10,3,23,15,8,31
Krasnodar,9828,5,8,6,6,27,24,3,30
Terek Grozny,9828,6,8,5,7,22,24,-2,29
Din Moscow,9828,7,6,6,8,18,22,-4,24
Amkar,9828,8,6,4,10,13,24,-11,22
FK Rubin,9828,9,5,6,9,21,18,3,21
Rostov,9828,10,4,7,9,10,17,-7,19
Anzhi,9828,11,2,5,13,16,43,-27,11
Loko Moscow,9829,1,13,5,2,34,12,22,44
Spart Moscow,9829,2,11,5,4,39,28,11,38
CSKA Moscow,9829,3,10,4,6,26,19,7,34
Zenit,9829,4,8,8,4,23,15,8,32
Terek Grozny,9829,5,9,5,6,24,22,2,32
Krasnodar,9829,6,9,4,7,29,28,1,31
Din Moscow,9829,7,5,7,8,18,23,-5,22
FK Rubin,9829,8,5,6,9,22,19,3,21
Rostov,9829,9,4,6,10,11,19,-8,18
Amkar,9829,10,4,4,12,10,26,-16,16
Anzhi,9829,11,2,6,12,15,40,-25,12
Loko Moscow,9830,1,12,6,2,30,11,19,42
Spart Moscow,9830,2,10,6,4,38,27,11,36
CSKA Moscow,9830,3,11,3,6,28,19,9,36
Zenit,9830,4,8,9,3,22,13,9,33
Terek Grozny,9830,5,8,6,6,23,24,-1,30
Krasnodar,9830,6,8,4,8,27,27,0,28
FK Rubin,9830,7,7,5,8,25,18,7,26
Din Moscow,9830,8,5,6,9,20,26,-6,21
Rostov,9830,9,4,6,10,10,19,-9,18
Amkar,9830,10,4,6,10,10,23,-13,18
Anzhi,9830,11,2,5,13,16,42,-26,11
Loko Moscow,9831,1,11,5,4,31,16,15,38
CSKA Moscow,9831,2,11,3,6,27,20,7,36
Zenit,9831,3,9,8,3,25,14,11,35
Spart Moscow,9831,4,9,6,5,37,29,8,33
Krasnodar,9831,5,9,5,6,30,25,5,32
Terek Grozny,9831,6,7,6,7,22,25,-3,27
Din Moscow,9831,7,6,6,8,20,23,-3,24
Amkar,9831,8,6,4,10,13,24,-11,22
FK Rubin,9831,9,5,6,9,21,19,2,21
Rostov,9831,10,4,7,9,10,17,-7,19
Anzhi,9831,11,2,6,12,17,41,-24,12
Loko Moscow,9832,1,12,6,2,31,12,19,42
CSKA Moscow,9832,2,11,3,6,30,20,10,36
Spart Moscow,9832,3,10,5,5,38,27,11,35
Zenit,9832,4,8,9,3,24,15,9,33
Terek Grozny,9832,5,8,6,6,23,24,-1,30
Krasnodar,9832,6,8,4,8,28,29,-1,28
FK Rubin,9832,7,7,5,8,28,19,9,26
Din Moscow,9832,8,5,6,9,19,26,-7,21
Amkar,9832,9,5,5,10,12,24,-12,20
Rostov,9832,10,4,6,10,10,20,-10,18
Anzhi,9832,11,2,5,13,15,42,-27,11
Loko Moscow,9833,1,12,5,3,34,16,18,41
CSKA Moscow,9833,2,11,3,6,29,20,9,36
Zenit,9833,3,9,8,3,26,14,12,35
Spart Moscow,9833,4,10,5,5,41,31,10,35
Krasnodar,9833,5,8,5,7,31,29,2,29
Terek Grozny,9833,6,8,5,7,23,24,-1,29
FK Rubin,9833,7,5,7,8,22,18,4,22
Din Moscow,9833,8,5,7,8,19,24,-5,22
Rostov,9833,9,5,6,9,12,17,-5,21
Amkar,9833,10,4,4,12,11,29,-18,16
Anzhi,9833,11,3,5,12,16,42,-26,14
Loko Moscow,9834,1,12,6,2,32,12,20,42
Spart Moscow,9834,2,10,6,4,39,27,12,36
CSKA Moscow,9834,3,11,3,6,28,19,9,36
Zenit,9834,4,8,8,4,22,15,7,32
Krasnodar,9834,5,8,5,7,29,27,2,29
Terek Grozny,9834,6,7,7,6,20,22,-2,28
FK Rubin,9834,7,6,6,8,23,18,5,24
Din Moscow,9834,8,5,7,8,18,24,-6,22
Rostov,9834,9,4,6,10,11,20,-9,18
Amkar,9834,10,4,6,10,9,22,-13,18
Anzhi,9834,11,2,6,12,15,40,-25,12
Loko Moscow,9835,1,13,5,2,33,13,20,44
CSKA Moscow,9835,2,10,4,6,26,19,7,34
Spart Moscow,9835,3,9,5,6,40,30,10,32
Krasnodar,9835,4,9,4,7,31,26,5,31
Zenit,9835,5,7,9,4,23,16,7,30
Terek Grozny,9835,6,8,6,6,21,22,-1,30
Din Moscow,9835,7,5,7,8,19,27,-8,22
FK Rubin,9835,8,5,6,9,22,21,1,21
Rostov,9835,9,5,6,9,13,19,-6,21
Amkar,9835,10,5,5,10,10,22,-12,20
Anzhi,9835,11,3,5,12,15,38,-23,14
Loko Moscow,9836,1,12,6,2,31,12,19,42
CSKA Moscow,9836,2,10,4,6,27,21,6,34
Spart Moscow,9836,3,9,6,5,35,28,7,33
Zenit,9836,4,8,8,4,24,15,9,32
Krasnodar,9836,5,9,5,6,29,25,4,32
Terek Grozny,9836,6,7,5,8,22,26,-4,26
Din Moscow,9836,7,6,7,7,19,21,-2,25
Rostov,9836,8,5,6,9,13,18,-5,21
FK Rubin,9836,9,5,5,10,21,20,1,20
Amkar,9836,10,5,4,11,11,24,-13,19
Anzhi,9836,11,3,6,11,17,39,-22,15
Loko Moscow,9837,1,13,5,2,33,12,21,44
CSKA Moscow,9837,2,12,3,5,29,18,11,39
Spart Moscow,9837,3,9,6,5,36,28,8,33
Zenit,9837,4,7,8,5,21,16,5,29
Krasnodar,9837,5,8,5,7,29,27,2,29
Terek Grozny,9837,6,7,6,7,20,23,-3,27
FK Rubin,9837,7,6,6,8,25,19,6,24
Amkar,9837,8,6,4,10,12,23,-11,22
Din Moscow,9837,9,5,6,9,19,26,-7,21
Rostov,9837,10,4,7,9,10,17,-7,19
Anzhi,9837,11,2,6,12,15,40,-25,12
Loko Moscow,9838,1,11,6,3,29,13,16,39
CSKA Moscow,9838,2,11,4,5,29,20,9,37
Spart Moscow,9838,3,10,5,5,41,28,13,35
Terek Grozny,9838,4,9,5,6,30,23,7,32
Krasnodar,9838,5,9,5,6,31,26,5,32
Zenit,9838,6,7,9,4,21,14,7,30
Din Moscow,9838,7,6,6,8,19,26,-7,24
FK Rubin,9838,8,5,6,9,23,20,3,21
Rostov,9838,9,5,6,9,12,18,-6,21
Amkar,9838,10,4,4,12,10,27,-17,16
Anzhi,9838,11,2,6,12,17,47,-30,12
Loko Moscow,9839,1,12,5,3,31,14,17,41
Spart Moscow,9839,2,10,6,4,37,26,11,36
CSKA Moscow,9839,3,11,3,6,30,21,9,36
Zenit,9839,4,9,8,3,24,13,11,35
Krasnodar,9839,5,8,5,7,28,26,2,29
Terek Grozny,9839,6,7,7,6,22,24,-2,28
Din Moscow,9839,7,5,8,7,19,23,-4,23
FK Rubin,9839,8,5,7,8,22,18,4,22
Rostov,9839,9,4,6,10,10,19,-9,18
Amkar,9839,10,4,5,11,9,23,-14,17
Anzhi,9839,11,2,6,12,19,44,-25,12
Loko Moscow,9840,1,11,5,4,30,20,10,38
CSKA Moscow,9840,2,11,3,6,29,20,9,36
Zenit,9840,3,9,8,3,27,14,13,35
Krasnodar,9840,4,10,4,6,34,24,10,34
Spart Moscow,9840,5,9,6,5,35,27,8,33
Terek Grozny,9840,6,7,6,7,20,23,-3,27
FK Rubin,9840,7,6,5,9,22,19,3,23
Din Moscow,9840,8,5,7,8,17,22,-5,22
Amkar,9840,9,5,5,10,11,22,-11,20
Rostov,9840,10,4,6,10,10,19,-9,18
Anzhi,9840,11,3,5,12,16,41,-25,14
Loko Moscow,9841,1,13,5,2,34,11,23,44
CSKA Moscow,9841,2,11,4,5,29,19,10,37
Spart Moscow,9841,3,10,5,5,40,30,10,35
Zenit,9841,4,7,9,4,22,17,5,30
Terek Grozny,9841,5,8,6,6,23,23,0,30
Krasnodar,9841,6,8,4,8,28,30,-2,28
FK Rubin,9841,7,7,5,8,28,18,10,26
Din Moscow,9841,8,5,6,9,18,27,-9,21
Amkar,9841,9,5,5,10,12,24,-12,20
Rostov,9841,10,4,6,10,12,20,-8,18
Anzhi,9841,11,2,5,13,15,42,-27,11
Loko Moscow,9842,1,12,6,2,32,11,21,42
CSKA Moscow,9842,2,12,3,5,28,17,11,39
Spart Moscow,9842,3,9,7,4,36,26,10,34
Krasnodar,9842,4,9,4,7,29,28,1,31
Zenit,9842,5,7,9,4,21,14,7,30
Terek Grozny,9842,6,8,5,7,21,23,-2,29
Din Moscow,9842,7,5,7,8,18,24,-6,22
FK Rubin,9842,8,5,6,9,22,19,3,21
Rostov,9842,9,4,7,9,10,17,-7,19
Amkar,9842,10,4,5,11,9,23,-14,17
Anzhi,9842,11,3,5,12,15,39,-24,14
Loko Moscow,9843,1,12,6,2,33,13,20,42
CSKA Moscow,9843,2,12,3,5,30,17,13,39
Spart Moscow,9843,3,9,7,4,39,28,11,34
Zenit,9843,4,7,9,4,22,16,6,30
Terek Grozny,9843,5,8,6,6,22,23,-1,30
Krasnodar,9843,6,8,5,7,29,28,1,29
FK Rubin,9843,7,6,6,8,23,18,5,24
Din Moscow,9843,8,5,6,9,19,27,-8,21
Rostov,9843,9,4,7,9,10,17,-7,19
Amkar,9843,10,4,6,10,11,24,-13,18
Anzhi,9843,11,2,5,13,14,41,-27,11
Loko Moscow,9844,1,11,6,3,32,15,17,39
CSKA Moscow,9844,2,12,3,5,28,18,10,39
Spart Moscow,9844,3,9,7,4,41,29,12,34
Krasnodar,9844,4,9,5,6,30,26,4,32
Zenit,9844,5,7,9,4,22,15,7,30
Terek Grozny,9844,6,8,5,7,24,24,0,29
FK Rubin,9844,7,6,6,8,23,17,6,24
Din Moscow,9844,8,5,6,9,18,28,-10,21
Rostov,9844,9,4,7,9,11,18,-7,19
Amkar,9844,10,4,5,11,11,27,-16,17
Anzhi,9844,11,3,5,12,17,40,-23,14
Loko Moscow,9845,1,13,5,2,31,11,20,44
Spart Moscow,9845,2,10,6,4,37,26,11,36
CSKA Moscow,9845,3,11,3,6,27,21,6,36
Zenit,9845,4,8,8,4,25,14,11,32
Krasnodar,9845,5,9,4,7,28,25,3,31
Terek Grozny,9845,6,8,5,7,21,24,-3,29
FK Rubin,9845,7,6,5,9,23,19,4,23
Din Moscow,9845,8,5,6,9,18,25,-7,21
Rostov,9845,9,4,6,10,11,19,-8,18
Amkar,9845,10,4,5,11,9,23,-14,17
Anzhi,9845,11,3,5,12,16,39,-23,14
Loko Moscow,9846,1,13,5,2,34,13,21,44
Spart Moscow,9846,2,11,5,4,39,26,13,38
CSKA Moscow,9846,3,11,3,6,27,19,8,36
Terek Grozny,9846,4,9,5,6,27,23,4,32
Zenit,9846,5,7,8,5,23,17,6,29
Krasnodar,9846,6,8,5,7,28,27,1,29
Din Moscow,9846,7,6,6,8,18,23,-5,24
FK Rubin,9846,8,5,6,9,21,18,3,21
Rostov,9846,9,4,6,10,11,20,-9,18
Amkar,9846,10,4,4,12,10,26,-16,16
Anzhi,9846,11,3,5,12,15,41,-26,14
Loko Moscow,9847,1,12,6,2,32,12,20,42
CSKA Moscow,9847,2,10,4,6,26,20,6,34
Spart Moscow,9847,3,8,8,4,38,30,8,32
Zenit,9847,4,8,8,4,23,15,8,32
Krasnodar,9847,5,8,6,6,29,26,3,30
Terek Grozny,9847,6,8,5,7,23,26,-3,29
Din Moscow,9847,7,6,7,7,21,24,-3,25
FK Rubin,9847,8,5,6,9,23,20,3,21
Amkar,9847,9,5,5,10,14,25,-11,20
Rostov,9847,10,4,7,9,11,18,-7,19
Anzhi,9847,11,2,6,12,16,40,-24,12
Loko Moscow,9848,1,13,5,2,31,11,20,44
Spart Moscow,9848,2,10,5,5,37,26,11,35
CSKA Moscow,9848,3,10,3,7,27,21,6,33
Zenit,9848,4,8,8,4,23,15,8,32
Krasnodar,9848,5,9,4,7,29,26,3,31
Terek Grozny,9848,6,8,6,6,22,23,-1,30
Din Moscow,9848,7,7,6,7,20,22,-2,27
FK Rubin,9848,8,5,5,10,23,21,2,20
Rostov,9848,9,4,6,10,10,19,-9,18
Amkar,9848,10,4,5,11,9,24,-15,17
Anzhi,9848,11,3,5,12,17,40,-23,14
Loko Moscow,9849,1,11,6,3,31,15,16,39
CSKA Moscow,9849,2,11,4,5,30,19,11,37
Krasnodar,9849,3,10,4,6,31,24,7,34
Spart Moscow,9849,4,9,6,5,35,27,8,33
Zenit,9849,5,7,9,4,23,18,5,30
Terek Grozny,9849,6,8,5,7,24,24,0,29
FK Rubin,9849,7,6,5,9,22,19,3,23
Din Moscow,9849,8,5,6,9,17,23,-6,21
Rostov,9849,9,5,6,9,11,17,-6,21
Amkar,9849,10,5,5,10,12,24,-12,20
Anzhi,9849,11,2,6,12,16,42,-26,12
Loko Moscow,9850,1,12,5,3,32,14,18,41
Zenit,9850,2,9,8,3,25,14,11,35
Spart Moscow,9850,3,9,6,5,39,30,9,33
CSKA Moscow,9850,4,10,3,7,26,20,6,33
Terek Grozny,9850,5,9,5,6,24,24,0,32
Krasnodar,9850,6,8,4,8,28,29,-1,28
Din Moscow,9850,7,6,6,8,20,25,-5,24
FK Rubin,9850,8,6,5,9,24,20,4,23
Rostov,9850,9,4,7,9,11,18,-7,19
Amkar,9850,10,5,4,11,13,25,-12,19
Anzhi,9850,11,3,5,12,17,40,-23,14
Loko Moscow,9851,1,12,6,2,33,11,22,42
CSKA Moscow,9851,2,11,3,6,28,20,8,36
Spart Moscow,9851,3,9,7,4,39,28,11,34
Zenit,9851,4,8,9,3,24,13,11,33
Krasnodar,9851,5,8,5,7,28,29,-1,29
Terek Grozny,9851,6,7,6,7,22,26,-4,27
FK Rubin,9851,7,6,6,8,25,19,6,24
Din Moscow,9851,8,5,6,9,19,28,-9,21
Amkar,9851,9,5,5,10,13,24,-11,20
Rostov,9851,10,4,7,9,11,18,-7,19
Anzhi,9851,11,2,6,12,15,41,-26,12
Loko Moscow,9852,1,11,6,3,31,14,17,39
CSKA Moscow,9852,2,11,3,6,26,19,7,36
Spart Moscow,9852,3,9,5,6,40,31,9,32
Krasnodar,9852,4,9,4,7,28,25,3,31
Zenit,9852,5,7,9,4,23,16,7,30
Terek Grozny,9852,6,8,6,6,24,24,0,30
Din Moscow,9852,7,6,7,7,20,23,-3,25
FK Rubin,9852,8,6,6,8,23,18,5,24
Rostov,9852,9,5,6,9,13,19,-6,21
Amkar,9852,10,4,5,11,11,27,-16,17
Anzhi,9852,11,3,5,12,17,40,-23,14
Loko Moscow,9853,1,12,6,2,33,13,20,42
Spart Moscow,9853,2,10,5,5,41,29,12,35
CSKA Moscow,9853,3,10,4,6,28,21,7,34
Zenit,9853,4,7,9,4,22,16,6,30
Krasnodar,9853,5,8,6,6,30,27,3,30
Terek Grozny,9853,6,8,5,7,22,25,-3,29
FK Rubin,9853,7,6,6,8,26,19,7,24
Rostov,9853,8,5,6,9,12,18,-6,21
Din Moscow,9853,9,5,6,9,18,27,-9,21
Amkar,9853,10,5,4,11,12,26,-14,19
Anzhi,9853,11,3,5,12,19,42,-23,14
Loko Moscow,9854,1,12,6,2,32,12,20,42
CSKA Moscow,9854,2,12,3,5,27,17,10,39
Spart Moscow,9854,3,11,5,4,43,26,17,38
Krasnodar,9854,4,9,4,7,30,27,3,31
Zenit,9854,5,7,9,4,22,15,7,30
Terek Grozny,9854,6,8,6,6,24,23,1,30
Din Moscow,9854,7,6,6,8,20,25,-5,24
FK Rubin,9854,8,5,5,10,23,22,1,20
Rostov,9854,9,4,6,10,10,21,-11,18
Amkar,9854,10,4,4,12,9,28,-19,16
Anzhi,9854,11,2,6,12,15,39,-24,12
Loko Moscow,9855,1,11,6,3,32,16,16,39
CSKA Moscow,9855,2,10,4,6,28,21,7,34
Zenit,9855,3,8,9,3,23,14,9,33
Spart Moscow,9855,4,9,5,6,37,36,1,32
Krasnodar,9855,5,9,4,7,31,29,2,31
Din Moscow,9855,6,7,6,7,24,21,3,27
Terek Grozny,9855,7,7,5,8,21,27,-6,26
FK Rubin,9855,8,6,5,9,24,18,6,23
Rostov,9855,9,5,6,9,14,19,-5,21
Amkar,9855,10,5,4,11,13,25,-12,19
Anzhi,9855,11,3,6,11,19,40,-21,15
Loko Moscow,9856,1,12,5,3,31,13,18,41
CSKA Moscow,9856,2,12,3,5,30,19,11,39
Spart Moscow,9856,3,9,6,5,37,27,10,33
Zenit,9856,4,8,8,4,24,16,8,32
Krasnodar,9856,5,9,4,7,29,25,4,31
Terek Grozny,9856,6,8,5,7,22,23,-1,29
Din Moscow,9856,7,6,7,7,20,21,-1,25
FK Rubin,9856,8,5,5,10,21,22,-1,20
Amkar,9856,9,5,4,11,11,24,-13,19
Rostov,9856,10,4,6,10,10,21,-11,18
Anzhi,9856,11,3,5,12,16,40,-24,14
Loko Moscow,9857,1,11,7,2,32,14,18,40
Zenit,9857,2,8,9,3,23,14,9,33
Spart Moscow,9857,3,9,6,5,36,28,8,33
CSKA Moscow,9857,4,10,3,7,26,20,6,33
Krasnodar,9857,5,8,6,6,31,28,3,30
Terek Grozny,9857,6,7,5,8,20,24,-4,26
Din Moscow,9857,7,6,6,8,20,24,-4,24
Amkar,9857,8,6,4,10,11,22,-11,22
FK Rubin,9857,9,5,6,9,23,20,3,21
Rostov,9857,10,4,7,9,10,17,-7,19
Anzhi,9857,11,4,5,11,17,38,-21,17
Loko Moscow,9858,1,12,6,2,31,12,19,42
Spart Moscow,9858,2,11,5,4,37,25,12,38
CSKA Moscow,9858,3,11,3,6,26,18,8,36
Zenit,9858,4,8,8,4,22,14,8,32
Terek Grozny,9858,5,9,5,6,25,24,1,32
Krasnodar,9858,6,8,5,7,28,27,1,29
Din Moscow,9858,7,6,6,8,19,24,-5,24
FK Rubin,9858,8,6,5,9,24,19,5,23
Rostov,9858,9,4,6,10,10,18,-8,18
Amkar,9858,10,4,4,12,10,25,-15,16
Anzhi,9858,11,2,5,13,15,41,-26,11
Loko Moscow,9859,1,13,5,2,33,12,21,44
CSKA Moscow,9859,2,11,3,6,27,19,8,36
Spart Moscow,9859,3,9,6,5,35,27,8,33
Zenit,9859,4,7,8,5,21,15,6,29
Krasnodar,9859,5,8,4,8,28,28,0,28
FK Rubin,9859,6,7,5,8,23,17,6,26
Terek Grozny,9859,7,7,5,8,21,25,-4,26
Din Moscow,9859,8,5,7,8,18,23,-5,22
Amkar,9859,9,6,4,10,11,22,-11,22
Rostov,9859,10,4,6,10,10,18,-8,18
Anzhi,9859,11,4,5,11,18,39,-21,17
Loko Moscow,9860,1,11,6,3,29,13,16,39
Spart Moscow,9860,2,10,5,5,39,28,11,35
CSKA Moscow,9860,3,10,4,6,26,20,6,34
Zenit,9860,4,8,9,3,23,13,10,33
Krasnodar,9860,5,9,5,6,30,25,5,32
Terek Grozny,9860,6,7,7,6,22,24,-2,28
Din Moscow,9860,7,7,6,7,20,22,-2,27
FK Rubin,9860,8,5,6,9,22,19,3,21
Rostov,9860,9,4,6,10,11,20,-9,18
Amkar,9860,10,4,5,11,10,25,-15,17
Anzhi,9860,11,2,7,11,16,39,-23,13
Loko Moscow,9861,1,12,5,3,33,16,17,41
CSKA Moscow,9861,2,12,3,5,29,18,11,39
Spart Moscow,9861,3,10,5,5,38,28,10,35
Zenit,9861,4,8,8,4,24,15,9,32
Krasnodar,9861,5,8,5,7,31,29,2,29
Terek Grozny,9861,6,7,7,6,22,24,-2,28
FK Rubin,9861,7,6,6,8,24,19,5,24
Din Moscow,9861,8,5,6,9,19,26,-7,21
Amkar,9861,9,5,5,10,11,23,-12,20
Rostov,9861,10,4,6,10,10,18,-8,18
Anzhi,9861,11,2,6,12,16,41,-25,12
Loko Moscow,9862,1,12,5,3,32,14,18,41
CSKA Moscow,9862,2,11,3,6,28,21,7,36
Zenit,9862,3,9,8,3,25,14,11,35
Spart Moscow,9862,4,10,5,5,37,27,10,35
Krasnodar,9862,5,9,4,7,29,26,3,31
Terek Grozny,9862,6,7,6,7,22,25,-3,27
FK Rubin,9862,7,6,5,9,22,18,4,23
Din Moscow,9862,8,5,6,9,17,24,-7,21
Amkar,9862,9,5,5,10,13,24,-11,20
Rostov,9862,10,4,6,10,10,19,-9,18
Anzhi,9862,11,3,5,12,17,40,-23,14
Loko Moscow,9863,1,11,5,4,29,14,15,38
CSKA Moscow,9863,2,11,3,6,26,18,8,36
Zenit,9863,3,9,8,3,24,13,11,35
Krasnodar,9863,4,10,4,6,31,24,7,34
Spart Moscow,9863,5,9,6,5,36,28,8,33
Terek Grozny,9863,6,8,5,7,23,24,-1,29
Din Moscow,9863,7,6,7,7,19,22,-3,25
FK Rubin,9863,8,5,5,10,21,21,0,20
Amkar,9863,9,5,4,11,10,24,-14,19
Rostov,9863,10,4,6,10,11,19,-8,18
Anzhi,9863,11,3,5,12,16,39,-23,14
Loko Moscow,9864,1,12,5,3,30,13,17,41
Spart Moscow,9864,2,10,5,5,39,28,11,35
Krasnodar,9864,3,10,4,6,31,25,6,34
CSKA Moscow,9864,4,10,4,6,28,22,6,34
Zenit,9864,5,8,8,4,24,15,9,32
Terek Grozny,9864,6,8,6,6,24,24,0,30
Din Moscow,9864,7,5,7,8,17,24,-7,22
FK Rubin,9864,8,5,6,9,22,19,3,21
Amkar,9864,9,5,4,11,12,26,-14,19
Rostov,9864,10,4,6,10,10,18,-8,18
Anzhi,9864,11,2,7,11,18,41,-23,13
Loko Moscow,9865,1,11,7,2,30,12,18,40
CSKA Moscow,9865,2,11,3,6,27,20,7,36
Zenit,9865,3,8,9,3,23,13,10,33
Spart Moscow,9865,4,8,6,6,36,30,6,30
Krasnodar,9865,5,8,5,7,30,28,2,29
Terek Grozny,9865,6,7,6,7,20,24,-4,27
FK Rubin,9865,7,7,5,8,26,19,7,26
Din Moscow,9865,8,6,6,8,19,24,-5,24
Rostov,9865,9,5,6,9,12,18,-6,21
Amkar,9865,10,5,5,10,12,23,-11,20
Anzhi,9865,11,2,6,12,15,39,-24,12
Loko Moscow,9866,1,13,5,2,32,12,20,44
CSKA Moscow,9866,2,10,4,6,26,20,6,34
Spart Moscow,9866,3,8,7,5,33,26,7,31
Krasnodar,9866,4,9,4,7,31,26,5,31
Zenit,9866,5,7,9,4,23,16,7,30
Terek Grozny,9866,6,7,5,8,20,25,-5,26
FK Rubin,9866,7,6,5,9,24,22,2,23
Din Moscow,9866,8,5,7,8,18,23,-5,22
Amkar,9866,9,6,4,10,11,22,-11,22
Rostov,9866,10,4,7,9,10,17,-7,19
Anzhi,9866,11,4,5,11,18,37,-19,17
Loko Moscow,9867,1,11,6,3,30,13,17,39
CSKA Moscow,9867,2,12,3,5,33,21,12,39
Krasnodar,9867,3,10,4,6,30,25,5,34
Zenit,9867,4,7,9,4,24,18,6,30
Spart Moscow,9867,5,8,6,6,34,31,3,30
Terek Grozny,9867,6,7,7,6,22,24,-2,28
Din Moscow,9867,7,6,6,8,19,23,-4,24
FK Rubin,9867,8,6,5,9,24,20,4,23
Amkar,9867,9,5,5,10,14,23,-9,20
Rostov,9867,10,4,7,9,11,18,-7,19
Anzhi,9867,11,2,6,12,17,42,-25,12
Loko Moscow,9868,1,11,6,3,30,13,17,39
CSKA Moscow,9868,2,11,4,5,29,19,10,37
Spart Moscow,9868,3,9,7,4,37,28,9,34
Krasnodar,9868,4,9,5,6,30,26,4,32
Terek Grozny,9868,5,9,5,6,23,23,0,32
Zenit,9868,6,7,9,4,22,16,6,30
FK Rubin,9868,7,6,6,8,27,21,6,24
Din Moscow,9868,8,5,7,8,21,27,-6,22
Rostov,9868,9,4,7,9,11,18,-7,19
Amkar,9868,10,4,4,12,10,25,-15,16
Anzhi,9868,11,2,6,12,16,40,-24,12
Loko Moscow,9869,1,12,5,3,33,16,17,41
CSKA Moscow,9869,2,12,3,5,29,17,12,39
Spart Moscow,9869,3,10,5,5,40,26,14,35
Krasnodar,9869,4,9,4,7,33,29,4,31
Zenit,9869,5,7,8,5,21,15,6,29
FK Rubin,9869,6,7,5,8,25,19,6,26
Terek Grozny,9869,7,7,5,8,22,26,-4,26
Amkar,9869,8,6,4,10,13,24,-11,22
Din Moscow,9869,9,5,6,9,18,27,-9,21
Rostov,9869,10,4,6,10,10,20,-10,18
Anzhi,9869,11,3,5,12,15,40,-25,14
Loko Moscow,9870,1,12,6,2,32,12,20,42
CSKA Moscow,9870,2,12,3,5,31,20,11,39
Spart Moscow,9870,3,9,7,4,39,28,11,34
Krasnodar,9870,4,8,6,6,30,27,3,30
Terek Grozny,9870,5,8,6,6,23,24,-1,30
Zenit,9870,6,7,8,5,23,18,5,29
Din Moscow,9870,7,5,8,7,19,23,-4,23
FK Rubin,9870,8,5,7,8,24,20,4,22
Rostov,9870,9,4,6,10,11,21,-10,18
Amkar,9870,10,4,6,10,11,24,-13,18
Anzhi,9870,11,2,5,13,16,42,-26,11
Loko Moscow,9871,1,12,5,3,33,12,21,41
CSKA Moscow,9871,2,10,5,5,27,19,8,35
Terek Grozny,9871,3,9,5,6,26,24,2,32
Krasnodar,9871,4,9,4,7,30,27,3,31
Spart Moscow,9871,5,8,6,6,35,29,6,30
Zenit,9871,6,7,9,4,21,17,4,30
Din Moscow,9871,7,6,7,7,20,23,-3,25
FK Rubin,9871,8,6,6,8,25,20,5,24
Rostov,9871,9,5,6,9,11,17,-6,21
Amkar,9871,10,4,5,11,10,26,-16,17
Anzhi,9871,11,2,6,12,18,42,-24,12
Loko Moscow,9872,1,12,5,3,32,14,18,41
CSKA Moscow,9872,2,12,3,5,28,17,11,39
Spart Moscow,9872,3,9,6,5,37,28,9,33
Krasnodar,9872,4,9,5,6,30,25,5,32
Terek Grozny,9872,5,9,5,6,24,22,2,32
Zenit,9872,6,7,8,5,21,16,5,29
Din Moscow,9872,7,6,7,7,18,21,-3,25
FK Rubin,9872,8,5,6,9,21,18,3,21
Amkar,9872,9,5,4,11,11,26,-15,19
Rostov,9872,10,4,6,10,11,20,-9,18
Anzhi,9872,11,2,5,13,14,40,-26,11
Loko Moscow,9873,1,11,6,3,31,17,14,39
CSKA Moscow,9873,2,11,4,5,29,19,10,37
Zenit,9873,3,8,9,3,26,14,12,33
Spart Moscow,9873,4,9,6,5,37,28,9,33
Krasnodar,9873,5,8,5,7,29,29,0,29
Terek Grozny,9873,6,8,5,7,23,25,-2,29
FK Rubin,9873,7,6,6,8,26,19,7,24
Din Moscow,9873,8,5,7,8,20,26,-6,22
Amkar,9873,9,6,4,10,13,22,-9,22
Rostov,9873,10,4,7,9,11,18,-7,19
Anzhi,9873,11,2,5,13,15,43,-28,11
Loko Moscow,9874,1,11,7,2,31,13,18,40
CSKA Moscow,9874,2,11,3,6,28,20,8,36
Spart Moscow,9874,3,9,7,4,38,27,11,34
Zenit,9874,4,8,9,3,25,14,11,33
Krasnodar,9874,5,8,5,7,28,26,2,29
Terek Grozny,9874,6,8,5,7,23,25,-2,29
FK Rubin,9874,7,7,5,8,24,18,6,26
Din Moscow,9874,8,5,6,9,18,26,-8,21
Rostov,9874,9,4,7,9,11,18,-7,19
Amkar,9874,10,4,5,11,11,25,-14,17
Anzhi,9874,11,3,5,12,16,41,-25,14
Loko Moscow,9875,1,12,5,3,31,13,18,41
Spart Moscow,9875,2,10,6,4,37,26,11,36
CSKA Moscow,9875,3,11,3,6,29,20,9,36
Zenit,9875,4,8,8,4,23,15,8,32
Krasnodar,9875,5,9,5,6,30,25,5,32
Terek Grozny,9875,6,8,6,6,21,22,-1,30
FK Rubin,9875,7,5,7,8,23,19,4,22
Din Moscow,9875,8,5,7,8,18,23,-5,22
Rostov,9875,9,4,6,10,10,19,-9,18
Amkar,9875,10,4,5,11,10,24,-14,17
Anzhi,9875,11,2,6,12,15,41,-26,12
Loko Moscow,9876,1,11,6,3,31,14,17,39
Spart Moscow,9876,2,10,5,5,40,28,12,35
Zenit,9876,3,9,8,3,25,15,10,35
CSKA Moscow,9876,4,10,4,6,26,19,7,34
Krasnodar,9876,5,9,5,6,31,26,5,32
Terek Grozny,9876,6,8,5,7,22,24,-2,29
FK Rubin,9876,7,6,5,9,25,22,3,23
Amkar,9876,8,6,4,10,13,24,-11,22
Din Moscow,9876,9,5,6,9,19,28,-9,21
Rostov,9876,10,4,6,10,11,19,-8,18
Anzhi,9876,11,2,6,12,14,38,-24,12
Loko Moscow,9877,1,11,7,2,33,15,18,40
Spart Moscow,9877,2,11,5,4,39,25,14,38
CSKA Moscow,9877,3,11,3,6,28,20,8,36
Zenit,9877,4,8,9,3,25,16,9,33
Krasnodar,9877,5,9,5,6,29,25,4,32
Terek Grozny,9877,6,9,5,6,24,22,2,32
Din Moscow,9877,7,6,6,8,18,24,-6,24
FK Rubin,9877,8,5,5,10,21,19,2,20
Rostov,9877,9,4,6,10,10,19,-9,18
Amkar,9877,10,4,4,12,9,24,-15,16
Anzhi,9877,11,2,5,13,16,43,-27,11
Loko Moscow,9878,1,12,5,3,31,13,18,41
CSKA Moscow,9878,2,11,3,6,27,18,9,36
Spart Moscow,9878,3,9,7,4,40,30,10,34
Krasnodar,9878,4,10,4,6,31,25,6,34
Zenit,9878,5,8,8,4,22,14,8,32
Terek Grozny,9878,6,7,5,8,22,26,-4,26
FK Rubin,9878,7,6,5,9,23,20,3,23
Din Moscow,9878,8,5,6,9,19,26,-7,21
Amkar,9878,9,5,5,10,13,25,-12,20
Rostov,9878,10,4,7,9,12,19,-7,19
Anzhi,9878,11,3,5,12,16,40,-24,14
CSKA Moscow,9879,1,12,3,5,27,17,10,39
Loko Moscow,9879,2,11,5,4,29,15,14,38
Spart Moscow,9879,3,10,6,4,39,27,12,36
Zenit,9879,4,8,8,4,24,14,10,32
Krasnodar,9879,5,9,5,6,30,26,4,32
Terek Grozny,9879,6,8,5,7,21,24,-3,29
Din Moscow,9879,7,6,6,8,18,22,-4,24
FK Rubin,9879,8,5,6,9,23,20,3,21
Rostov,9879,9,4,7,9,11,18,-7,19
Amkar,9879,10,5,4,11,12,26,-14,19
Anzhi,9879,11,2,5,13,14,39,-25,11
Loko Moscow,9880,1,12,6,2,33,12,21,42
Spart Moscow,9880,2,10,5,5,37,29,8,35
CSKA Moscow,9880,3,10,4,6,27,20,7,34
Zenit,9880,4,7,10,3,23,15,8,31
Krasnodar,9880,5,9,4,7,29,27,2,31
Terek Grozny,9880,6,7,6,7,20,25,-5,27
Din Moscow,9880,7,6,6,8,21,23,-2,24
Rostov,9880,8,5,6,9,12,17,-5,21
FK Rubin,9880,9,5,5,10,21,22,-1,20
Amkar,9880,10,5,4,11,13,24,-11,19
Anzhi,9880,11,3,6,11,16,38,-22,15
Loko Moscow,9881,1,12,5,3,31,13,18,41
Spart Moscow,9881,2,10,6,4,40,27,13,36
CSKA Moscow,9881,3,11,3,6,26,19,7,36
Zenit,9881,4,9,8,3,25,13,12,35
Krasnodar,9881,5,8,4,8,27,27,0,28
Terek Grozny,9881,6,7,7,6,22,24,-2,28
Din Moscow,9881,7,6,7,7,20,22,-2,25
FK Rubin,9881,8,6,5,9,23,20,3,23
Rostov,9881,9,4,6,10,11,21,-10,18
Amkar,9881,10,4,5,11,12,27,-15,17
Anzhi,9881,11,2,6,12,14,38,-24,12
Loko Moscow,9882,1,11,6,3,29,12,17,39
CSKA Moscow,9882,2,11,4,5,30,19,11,37
Krasnodar,9882,3,10,4,6,30,25,5,34
Spart Moscow,9882,4,9,6,5,38,29,9,33
Zenit,9882,5,7,10,3,23,15,8,31
Terek Grozny,9882,6,7,5,8,22,26,-4,26
Din Moscow,9882,7,6,7,7,20,23,-3,25
FK Rubin,9882,8,5,6,9,23,20,3,21
Rostov,9882,9,4,7,9,11,18,-7,19
Amkar,9882,10,5,4,11,12,26,-14,19
Anzhi,9882,11,3,5,12,16,41,-25,14
Loko Moscow,9883,1,11,6,3,31,14,17,39
CSKA Moscow,9883,2,11,4,5,34,20,14,37
Krasnodar,9883,3,10,4,6,30,25,5,34
Spart Moscow,9883,4,9,6,5,36,28,8,33
Zenit,9883,5,7,10,3,25,17,8,31
Terek Grozny,9883,6,8,5,7,24,26,-2,29
Din Moscow,9883,7,6,7,7,21,22,-1,25
Rostov,9883,8,5,6,9,12,17,-5,21
FK Rubin,9883,9,5,5,10,21,21,0,20
Amkar,9883,10,4,4,12,9,26,-17,16
Anzhi,9883,11,3,5,12,18,45,-27,14
Loko Moscow,9884,1,12,5,3,32,14,18,41
CSKA Moscow,9884,2,11,3,6,28,19,9,36
Zenit,9884,3,8,8,4,22,14,8,32
Spart Moscow,9884,4,8,7,5,34,27,7,31
Krasnodar,9884,5,9,4,7,30,28,2,31
Terek Grozny,9884,6,8,5,7,24,26,-2,29
Din Moscow,9884,7,7,6,7,20,22,-2,27
FK Rubin,9884,8,6,5,9,24,19,5,23
Rostov,9884,9,4,7,9,11,18,-7,19
Amkar,9884,10,4,5,11,9,23,-14,17
Anzhi,9884,11,3,5,12,19,43,-24,14
Loko Moscow,9885,1,11,6,3,30,14,16,39
CSKA Moscow,9885,2,12,3,5,30,20,10,39
Spart Moscow,9885,3,10,6,4,39,27,12,36
Zenit,9885,4,8,8,4,27,18,9,32
Krasnodar,9885,5,8,6,6,29,26,3,30
Terek Grozny,9885,6,7,6,7,22,25,-3,27
FK Rubin,9885,7,6,6,8,26,20,6,24
Din Moscow,9885,8,5,7,8,20,26,-6,22
Amkar,9885,9,5,4,11,10,24,-14,19
Rostov,9885,10,4,6,10,10,19,-9,18
Anzhi,9885,11,2,6,12,16,40,-24,12
Loko Moscow,9886,1,12,6,2,30,11,19,42
CSKA Moscow,9886,2,10,5,5,26,18,8,35
Spart Moscow,9886,3,9,6,5,38,31,7,33
Zenit,9886,4,7,9,4,22,15,7,30
Krasnodar,9886,5,8,5,7,27,25,2,29
Terek Grozny,9886,6,7,6,7,22,25,-3,27
FK Rubin,9886,7,7,5,8,23,17,6,26
Din Moscow,9886,8,6,6,8,20,23,-3,24
Rostov,9886,9,4,6,10,11,19,-8,18
Amkar,9886,10,4,6,10,13,26,-13,18
Anzhi,9886,11,3,6,11,15,37,-22,15
Loko Moscow,9887,1,11,7,2,30,12,18,40
CSKA Moscow,9887,2,10,5,5,26,18,8,35
Spart Moscow,9887,3,9,6,5,34,28,6,33
Zenit,9887,4,7,10,3,23,15,8,31
Krasnodar,9887,5,8,6,6,28,25,3,30
Din Moscow,9887,6,7,6,7,22,22,0,27
Terek Grozny,9887,7,7,5,8,20,26,-6,26
FK Rubin,9887,8,5,6,9,23,20,3,21
Rostov,9887,9,4,7,9,10,17,-7,19
Amkar,9887,10,5,4,11,10,23,-13,19
Anzhi,9887,11,3,6,11,17,37,-20,15
Loko Moscow,9888,1,11,6,3,30,14,16,39
CSKA Moscow,9888,2,11,4,5,28,19,9,37
Zenit,9888,3,7,10,3,22,14,8,31
Krasnodar,9888,4,9,4,7,31,27,4,31
Terek Grozny,9888,5,8,6,6,22,22,0,30
Spart Moscow,9888,6,8,5,7,33,29,4,29
Din Moscow,9888,7,7,6,7,20,21,-1,27
FK Rubin,9888,8,6,5,9,23,20,3,23
Rostov,9888,9,5,6,9,12,17,-5,21
Amkar,9888,10,5,5,10,10,22,-12,20
Anzhi,9888,11,2,5,13,15,41,-26,11
Loko Moscow,9889,1,11,7,2,33,15,18,40
Spart Moscow,9889,2,10,6,4,39,26,13,36
Zenit,9889,3,8,9,3,23,14,9,33
CSKA Moscow,9889,4,10,3,7,26,20,6,33
Krasnodar,9889,5,9,5,6,31,27,4,32
Terek Grozny,9889,6,8,6,6,21,22,-1,30
Din Moscow,9889,7,5,7,8,18,26,-8,22
FK Rubin,9889,8,5,6,9,22,19,3,21
Rostov,9889,9,4,7,9,11,18,-7,19
Amkar,9889,10,4,5,11,9,23,-14,17
Anzhi,9889,11,3,5,12,16,39,-23,14
Loko Moscow,9890,1,11,7,2,31,13,18,40
CSKA Moscow,9890,2,11,3,6,26,19,7,36
Spart Moscow,9890,3,9,6,5,39,31,8,33
Zenit,9890,4,7,9,4,22,15,7,30
Krasnodar,9890,5,8,5,7,29,27,2,29
Terek Grozny,9890,6,7,6,7,22,25,-3,27
FK Rubin,9890,7,6,6,8,24,19,5,24
Din Moscow,9890,8,5,8,7,21,25,-4,23
Rostov,9890,9,5,6,9,12,18,-6,21
Amkar,9890,10,4,5,11,11,25,-14,17
Anzhi,9890,11,4,5,11,18,38,-20,17
Loko Moscow,9891,1,12,6,2,31,12,19,42
CSKA Moscow,9891,2,11,3,6,27,19,8,36
Spart Moscow,9891,3,9,7,4,36,25,11,34
Zenit,9891,4,8,9,3,24,14,10,33
Krasnodar,9891,5,8,4,8,28,28,0,28
Terek Grozny,9891,6,7,6,7,20,24,-4,27
FK Rubin,9891,7,7,5,8,26,18,8,26
Din Moscow,9891,8,5,7,8,17,23,-6,22
Rostov,9891,9,4,6,10,10,20,-10,18
Amkar,9891,10,4,6,10,9,22,-13,18
Anzhi,9891,11,3,5,12,16,39,-23,14
Loko Moscow,9892,1,12,6,2,30,11,19,42
CSKA Moscow,9892,2,12,3,5,27,17,10,39
Spart Moscow,9892,3,9,6,5,35,27,8,33
Terek Grozny,9892,4,8,6,6,23,24,-1,30
Zenit,9892,5,7,8,5,21,15,6,29
Krasnodar,9892,6,8,5,7,28,26,2,29
Din Moscow,9892,7,6,6,8,20,23,-3,24
FK Rubin,9892,8,6,5,9,24,21,3,23
Amkar,9892,9,5,5,10,11,23,-12,20
Rostov,9892,10,4,7,9,10,17,-7,19
Anzhi,9892,11,2,5,13,16,41,-25,11
Loko Moscow,9893,1,12,6,2,30,11,19,42
CSKA Moscow,9893,2,12,3,5,32,19,13,39
Spart Moscow,9893,3,9,6,5,38,30,8,33
Terek Grozny,9893,4,8,6,6,22,23,-1,30
Zenit,9893,5,7,8,5,23,17,6,29
Krasnodar,9893,6,8,5,7,28,27,1,29
Din Moscow,9893,7,6,6,8,24,27,-3,24
FK Rubin,9893,8,6,5,9,26,22,4,23
Rostov,9893,9,5,6,9,11,17,-6,21
Amkar,9893,10,4,5,11,10,24,-14,17
Anzhi,9893,11,2,6,12,15,42,-27,12
Loko Moscow,9894,1,12,6,2,31,12,19,42
CSKA Moscow,9894,2,11,4,5,28,18,10,37
Spart Moscow,9894,3,9,6,5,40,30,10,33
Zenit,9894,4,7,10,3,21,13,8,31
Krasnodar,9894,5,9,4,7,29,26,3,31
Terek Grozny,9894,6,7,5,8,22,27,-5,26
Din Moscow,9894,7,6,7,7,20,22,-2,25
Amkar,9894,8,6,4,10,15,25,-10,22
FK Rubin,9894,9,5,5,10,21,20,1,20
Rostov,9894,10,4,6,10,11,21,-10,18
Anzhi,9894,11,3,5,12,17,41,-24,14
Loko Moscow,9895,1,11,6,3,29,13,16,39
CSKA Moscow,9895,2,11,4,5,30,19,11,37
Spart Moscow,9895,3,10,5,5,39,27,12,35
Zenit,9895,4,8,8,4,24,17,7,32
Krasnodar,9895,5,8,6,6,28,25,3,30
Terek Grozny,9895,6,7,5,8,21,25,-4,26
FK Rubin,9895,7,6,6,8,25,19,6,24
Amkar,9895,8,6,4,10,13,24,-11,22
Din Moscow,9895,9,5,6,9,18,26,-8,21
Rostov,9895,10,4,6,10,10,20,-10,18
Anzhi,9895,11,3,6,11,16,38,-22,15
Loko Moscow,9896,1,13,5,2,32,11,21,44
Spart Moscow,9896,2,10,6,4,38,26,12,36
CSKA Moscow,9896,3,10,5,5,28,20,8,35
Krasnodar,9896,4,9,4,7,29,27,2,31
Zenit,9896,5,7,9,4,23,16,7,30
Terek Grozny,9896,6,8,5,7,23,24,-1,29
FK Rubin,9896,7,6,5,9,23,19,4,23
Din Moscow,9896,8,5,6,9,17,25,-8,21
Rostov,9896,9,4,7,9,11,18,-7,19
Amkar,9896,10,5,4,11,11,23,-12,19
Anzhi,9896,11,2,6,12,15,41,-26,12
Loko Moscow,9897,1,11,5,4,29,13,16,38
Zenit,9897,2,9,8,3,24,14,10,35
CSKA Moscow,9897,3,10,4,6,27,20,7,34
Krasnodar,9897,4,9,5,6,29,25,4,32
Terek Grozny,9897,5,9,5,6,24,24,0,32
Spart Moscow,9897,6,8,6,6,35,30,5,30
Din Moscow,9897,7,6,7,7,22,25,-3,25
FK Rubin,9897,8,5,7,8,25,21,4,22
Rostov,9897,9,4,7,9,10,17,-7,19
Amkar,9897,10,5,4,11,13,25,-12,19
Anzhi,9897,11,2,6,12,16,40,-24,12
Loko Moscow,9898,1,12,5,3,32,13,19,41
CSKA Moscow,9898,2,11,4,5,27,18,9,37
Krasnodar,9898,3,10,4,6,32,25,7,34
Spart Moscow,9898,4,9,6,5,36,28,8,33
Terek Grozny,9898,5,9,5,6,24,22,2,32
Zenit,9898,6,7,9,4,21,16,5,30
Din Moscow,9898,7,6,7,7,20,23,-3,25
Rostov,9898,8,5,6,9,11,17,-6,21
FK Rubin,9898,9,5,5,10,23,22,1,20
Amkar,9898,10,4,4,12,10,27,-17,16
Anzhi,9898,11,2,5,13,15,40,-25,11
Loko Moscow,9899,1,12,6,2,32,13,19,42
CSKA Moscow,9899,2,12,3,5,30,20,10,39
Spart Moscow,9899,3,8,7,5,37,31,6,31
Krasnodar,9899,4,8,6,6,30,27,3,30
Zenit,9899,5,7,8,5,23,17,6,29
Terek Grozny,9899,6,7,6,7,22,25,-3,27
FK Rubin,9899,7,6,6,8,24,19,5,24
Din Moscow,9899,8,6,6,8,21,24,-3,24
Rostov,9899,9,4,7,9,11,18,-7,19
Amkar,9899,10,4,6,10,10,23,-13,18
Anzhi,9899,11,3,5,12,19,42,-23,14
Loko Moscow,9900,1,12,6,2,32,12,20,42
Spart Moscow,9900,2,11,5,4,45,27,18,38
CSKA Moscow,9900,3,11,4,5,29,20,9,37
Zenit,9900,4,7,10,3,23,15,8,31
Krasnodar,9900,5,8,5,7,28,27,1,29
Terek Grozny,9900,6,7,5,8,20,24,-4,26
FK Rubin,9900,7,5,7,8,23,19,4,22
Din Moscow,9900,8,5,7,8,19,28,-9,22
Amkar,9900,9,5,4,11,11,25,-14,19
Rostov,9900,10,4,6,10,10,20,-10,18
Anzhi,9900,11,3,5,12,17,40,-23,14
Loko Moscow,9901,1,11,5,4,30,15,15,38
Spart Moscow,9901,2,11,5,4,39,27,12,38
CSKA Moscow,9901,3,11,4,5,27,18,9,37
Krasnodar,9901,4,10,4,6,31,25,6,34
Zenit,9901,5,8,8,4,23,14,9,32
Terek Grozny,9901,6,7,7,6,21,23,-2,28
FK Rubin,9901,7,6,5,9,23,20,3,23
Din Moscow,9901,8,5,6,9,18,24,-6,21
Rostov,9901,9,4,6,10,11,20,-9,18
Amkar,9901,10,4,5,11,11,25,-14,17
Anzhi,9901,11,2,7,11,15,38,-23,13
Loko Moscow,9902,1,11,5,4,32,16,16,38
CSKA Moscow,9902,2,11,3,6,27,21,6,36
Zenit,9902,3,9,8,3,26,14,12,35
Spart Moscow,9902,4,10,5,5,37,30,7,35
Krasnodar,9902,5,10,4,6,31,26,5,34
Terek Grozny,9902,6,8,6,6,23,23,0,30
Din Moscow,9902,7,6,6,8,21,23,-2,24
FK Rubin,9902,8,6,5,9,23,19,4,23
Rostov,9902,9,4,6,10,11,19,-8,18
Amkar,9902,10,4,5,11,11,25,-14,17
Anzhi,9902,11,2,5,13,15,41,-26,11
Loko Moscow,9903,1,11,7,2,31,13,18,40
Spart Moscow,9903,2,11,5,4,39,25,14,38
CSKA Moscow,9903,3,11,3,6,29,19,10,36
Zenit,9903,4,8,9,3,23,13,10,33
Krasnodar,9903,5,9,5,6,31,26,5,32
Terek Grozny,9903,6,7,7,6,20,22,-2,28
Din Moscow,9903,7,6,6,8,19,24,-5,24
FK Rubin,9903,8,5,5,10,21,21,0,20
Rostov,9903,9,4,6,10,10,18,-8,18
Amkar,9903,10,4,5,11,9,24,-15,17
Anzhi,9903,11,2,6,12,14,41,-27,12
Loko Moscow,9904,1,11,6,3,30,14,16,39
CSKA Moscow,9904,2,11,3,6,27,18,9,36
Krasnodar,9904,3,10,4,6,31,25,6,34
Zenit,9904,4,8,9,3,22,13,9,33
Terek Grozny,9904,5,9,5,6,24,22,2,32
Spart Moscow,9904,6,8,6,6,36,30,6,30
Din Moscow,9904,7,6,7,7,21,23,-2,25
Rostov,9904,8,5,6,9,12,18,-6,21
FK Rubin,9904,9,5,5,10,21,20,1,20
Amkar,9904,10,5,4,11,10,23,-13,19
Anzhi,9904,11,2,5,13,14,42,-28,11
Loko Moscow,9905,1,12,5,3,30,13,17,41
CSKA Moscow,9905,2,11,3,6,28,21,7,36
Spart Moscow,9905,3,9,6,5,36,28,8,33
Zenit,9905,4,8,8,4,24,14,10,32
Krasnodar,9905,5,9,5,6,31,26,5,32
Terek Grozny,9905,6,8,5,7,25,26,-1,29
FK Rubin,9905,7,6,6,8,25,20,5,24
Din Moscow,9905,8,5,7,8,20,25,-5,22
Amkar,9905,9,5,4,11,11,25,-14,19
Rostov,9905,10,4,6,10,10,18,-8,18
Anzhi,9905,11,3,5,12,18,42,-24,14
Loko Moscow,9906,1,12,6,2,31,12,19,42
CSKA Moscow,9906,2,12,3,5,31,17,14,39
Spart Moscow,9906,3,10,5,5,38,30,8,35
Zenit,9906,4,7,8,5,21,16,5,29
Krasnodar,9906,5,8,5,7,29,27,2,29
Terek Grozny,9906,6,8,5,7,21,23,-2,29
FK Rubin,9906,7,6,6,8,24,19,5,24
Din Moscow,9906,8,5,7,8,19,25,-6,22
Amkar,9906,9,6,4,10,13,22,-9,22
Rostov,9906,10,4,6,10,11,19,-8,18
Anzhi,9906,11,2,5,13,14,42,-28,11
Loko Moscow,9907,1,11,5,4,31,16,15,38
CSKA Moscow,9907,2,11,4,5,28,19,9,37
Spart Moscow,9907,3,9,7,4,37,28,9,34
Zenit,9907,4,8,9,3,25,16,9,33
Krasnodar,9907,5,9,5,6,32,27,5,32
Terek Grozny,9907,6,7,5,8,20,25,-5,26
Din Moscow,9907,7,6,7,7,20,21,-1,25
FK Rubin,9907,8,5,6,9,23,22,1,21
Rostov,9907,9,4,7,9,11,18,-7,19
Amkar,9907,10,5,4,11,13,25,-12,19
Anzhi,9907,11,3,5,12,15,38,-23,14
Loko Moscow,9908,1,11,6,3,30,15,15,39
Spart Moscow,9908,2,10,6,4,41,30,11,36
CSKA Moscow,9908,3,11,3,6,30,19,11,36
Krasnodar,9908,4,10,4,6,31,24,7,34
Zenit,9908,5,8,9,3,24,14,10,33
Terek Grozny,9908,6,7,7,6,22,24,-2,28
FK Rubin,9908,7,6,5,9,22,18,4,23
Din Moscow,9908,8,5,6,9,19,26,-7,21
Rostov,9908,9,4,7,9,12,19,-7,19
Amkar,9908,10,4,5,11,11,25,-14,17
Anzhi,9908,11,2,6,12,15,43,-28,12
Loko Moscow,9909,1,11,6,3,29,12,17,39
Spart Moscow,9909,2,10,6,4,38,28,10,36
CSKA Moscow,9909,3,11,3,6,30,20,10,36
Zenit,9909,4,8,9,3,23,14,9,33
Krasnodar,9909,5,9,5,6,29,25,4,32
Terek Grozny,9909,6,8,5,7,22,24,-2,29
Din Moscow,9909,7,5,8,7,21,25,-4,23
FK Rubin,9909,8,5,7,8,25,21,4,22
Rostov,9909,9,4,6,10,11,19,-8,18
Amkar,9909,10,4,4,12,10,25,-15,16
Anzhi,9909,11,3,5,12,17,42,-25,14
Loko Moscow,9910,1,11,6,3,29,12,17,39
CSKA Moscow,9910,2,11,3,6,29,21,8,36
Spart Moscow,9910,3,10,5,5,42,28,14,35
Zenit,9910,4,8,8,4,23,15,8,32
Krasnodar,9910,5,8,6,6,28,25,3,30
Terek Grozny,9910,6,7,5,8,21,25,-4,26
Din Moscow,9910,7,6,6,8,18,25,-7,24
Amkar,9910,8,6,4,10,12,23,-11,22
FK Rubin,9910,9,5,6,9,22,19,3,21
Rostov,9910,10,4,6,10,11,21,-10,18
Anzhi,9910,11,4,5,11,19,40,-21,17
Loko Moscow,9911,1,12,6,2,34,14,20,42
CSKA Moscow,9911,2,10,4,6,26,19,7,34
Spart Moscow,9911,3,9,5,6,36,29,7,32
Zenit,9911,4,7,10,3,23,15,8,31
Terek Grozny,9911,5,8,6,6,23,24,-1,30
Krasnodar,9911,6,8,4,8,28,30,-2,28
FK Rubin,9911,7,6,6,8,24,17,7,24
Din Moscow,9911,8,5,7,8,18,24,-6,22
Rostov,9911,9,5,6,9,12,17,-5,21
Amkar,9911,10,5,5,10,11,23,-12,20
Anzhi,9911,11,3,5,12,17,40,-23,14
Loko Moscow,9912,1,12,5,3,34,14,20,41
CSKA Moscow,9912,2,11,3,6,28,21,7,36
Spart Moscow,9912,3,10,5,5,40,30,10,35
Krasnodar,9912,4,10,4,6,34,27,7,34
Zenit,9912,5,8,8,4,24,17,7,32
Terek Grozny,9912,6,7,5,8,22,28,-6,26
Din Moscow,9912,7,6,6,8,19,23,-4,24
FK Rubin,9912,8,6,5,9,24,21,3,23
Amkar,9912,9,5,4,11,15,27,-12,19
Rostov,9912,10,4,6,10,11,20,-9,18
Anzhi,9912,11,3,5,12,17,40,-23,14
Loko Moscow,9913,1,11,6,3,31,15,16,39
CSKA Moscow,9913,2,11,3,6,28,18,10,36
Krasnodar,9913,3,10,4,6,31,24,7,34
Zenit,9913,4,8,9,3,24,15,9,33
Spart Moscow,9913,5,9,5,6,37,32,5,32
Terek Grozny,9913,6,7,7,6,22,24,-2,28
Din Moscow,9913,7,6,6,8,19,22,-3,24
Rostov,9913,8,5,6,9,14,20,-6,21
FK Rubin,9913,9,5,5,10,21,21,0,20
Amkar,9913,10,5,5,10,14,24,-10,20
Anzhi,9913,11,2,6,12,14,40,-26,12
Loko Moscow,9914,1,13,5,2,34,12,22,44
Spart Moscow,9914,2,11,5,4,40,27,13,38
CSKA Moscow,9914,3,11,3,6,27,18,9,36
Zenit,9914,4,8,8,4,23,16,7,32
Krasnodar,9914,5,8,4,8,27,27,0,28
Terek Grozny,9914,6,7,6,7,23,26,-3,27
Din Moscow,9914,7,6,6,8,19,24,-5,24
FK Rubin,9914,8,6,5,9,23,19,4,23
Amkar,9914,9,5,4,11,13,27,-14,19
Rostov,9914,10,4,6,10,11,19,-8,18
Anzhi,9914,11,2,6,12,15,40,-25,12
Loko Moscow,9915,1,11,6,3,31,16,15,39
CSKA Moscow,9915,2,12,3,5,27,17,10,39
Spart Moscow,9915,3,10,5,5,36,27,9,35
Krasnodar,9915,4,9,4,7,31,27,4,31
Zenit,9915,5,7,9,4,22,15,7,30
Din Moscow,9915,6,7,6,7,21,22,-1,27
Terek Grozny,9915,7,7,5,8,20,25,-5,26
FK Rubin,9915,8,6,5,9,24,19,5,23
Amkar,9915,9,5,4,11,10,24,-14,19
Rostov,9915,10,4,6,10,10,18,-8,18
Anzhi,9915,11,3,5,12,16,38,-22,14
Loko Moscow,9916,1,11,6,3,31,14,17,39
CSKA Moscow,9916,2,11,4,5,30,20,10,37
Spart Moscow,9916,3,10,5,5,40,29,11,35
Krasnodar,9916,4,10,4,6,30,25,5,34
Zenit,9916,5,7,10,3,24,16,8,31
Terek Grozny,9916,6,7,6,7,21,26,-5,27
Din Moscow,9916,7,6,6,8,19,24,-5,24
FK Rubin,9916,8,5,5,10,21,19,2,20
Amkar,9916,9,5,5,10,13,25,-12,20
Rostov,9916,10,4,6,10,10,19,-9,18
Anzhi,9916,11,3,5,12,18,40,-22,14
Loko Moscow,9917,1,12,6,2,31,12,19,42
CSKA Moscow,9917,2,12,3,5,32,19,13,39
Spart Moscow,9917,3,9,6,5,41,31,10,33
Krasnodar,9917,4,9,5,6,32,26,6,32
Terek Grozny,9917,5,9,5,6,26,24,2,32
Zenit,9917,6,7,8,5,21,15,6,29
Din Moscow,9917,7,7,6,7,24,24,0,27
FK Rubin,9917,8,5,5,10,22,24,-2,20
Rostov,9917,9,4,6,10,10,20,-10,18
Amkar,9917,10,4,5,11,12,27,-15,17
Anzhi,9917,11,2,5,13,17,46,-29,11
Loko Moscow,9918,1,12,5,3,32,14,18,41
CSKA Moscow,9918,2,12,3,5,29,18,11,39
Spart Moscow,9918,3,10,6,4,41,29,12,36
Krasnodar,9918,4,10,4,6,32,25,7,34
Zenit,9918,5,7,8,5,22,18,4,29
Terek Grozny,9918,6,8,5,7,23,26,-3,29
Din Moscow,9918,7,6,6,8,20,24,-4,24
FK Rubin,9918,8,5,5,10,23,21,2,20
Rostov,9918,9,4,6,10,11,21,-10,18
Amkar,9918,10,4,5,11,12,27,-15,17
Anzhi,9918,11,3,5,12,17,39,-22,14
Loko Moscow,9919,1,12,6,2,32,12,20,42
CSKA Moscow,9919,2,10,5,5,27,19,8,35
Zenit,9919,3,7,10,3,23,15,8,31
Spart Moscow,9919,4,8,7,5,36,30,6,31
Krasnodar,9919,5,9,4,7,30,26,4,31
Terek Grozny,9919,6,8,5,7,24,25,-1,29
FK Rubin,9919,7,6,5,9,23,20,3,23
Din Moscow,9919,8,5,7,8,19,25,-6,22
Rostov,9919,9,5,6,9,12,17,-5,21
Amkar,9919,10,4,5,11,11,26,-15,17
Anzhi,9919,11,3,6,11,17,39,-22,15
Loko Moscow,9920,1,11,5,4,30,14,16,38
Spart Moscow,9920,2,10,6,4,37,25,12,36
CSKA Moscow,9920,3,11,3,6,28,18,10,36
Zenit,9920,4,9,8,3,23,13,10,35
Krasnodar,9920,5,10,4,6,31,26,5,34
Terek Grozny,9920,6,8,6,6,21,22,-1,30
Din Moscow,9920,7,6,7,7,19,21,-2,25
FK Rubin,9920,8,5,5,10,22,21,1,20
Rostov,9920,9,4,6,10,10,20,-10,18
Amkar,9920,10,4,4,12,9,24,-15,16
Anzhi,9920,11,2,6,12,14,40,-26,12
Loko Moscow,9921,1,11,5,4,31,18,13,38
CSKA Moscow,9921,2,11,3,6,27,20,7,36
Spart Moscow,9921,3,9,7,4,35,25,10,34
Zenit,9921,4,8,8,4,26,15,11,32
Krasnodar,9921,5,9,5,6,31,27,4,32
Terek Grozny,9921,6,8,5,7,23,24,-1,29
FK Rubin,9921,7,5,7,8,24,20,4,22
Din Moscow,9921,8,5,7,8,18,24,-6,22
Rostov,9921,9,4,7,9,10,17,-7,19
Amkar,9921,10,4,5,11,10,25,-15,17
Anzhi,9921,11,4,5,11,18,38,-20,17
Loko Moscow,9922,1,12,5,3,31,13,18,41
CSKA Moscow,9922,2,11,3,6,31,19,12,36
Spart Moscow,9922,3,10,6,4,39,28,11,36
Zenit,9922,4,9,8,3,24,13,11,35
Krasnodar,9922,5,9,4,7,30,26,4,31
Terek Grozny,9922,6,7,5,8,21,28,-7,26
Din Moscow,9922,7,6,6,8,19,23,-4,24
FK Rubin,9922,8,5,5,10,21,20,1,20
Rostov,9922,9,4,7,9,12,19,-7,19
Amkar,9922,10,5,4,11,12,25,-13,19
Anzhi,9922,11,3,5,12,17,43,-26,14
Loko Moscow,9923,1,13,5,2,33,12,21,44
Spart Moscow,9923,2,10,5,5,38,28,10,35
CSKA Moscow,9923,3,10,5,5,27,19,8,35
Krasnodar,9923,4,9,4,7,29,26,3,31
Zenit,9923,5,7,9,4,22,16,6,30
Terek Grozny,9923,6,7,5,8,21,25,-4,26
FK Rubin,9923,7,6,5,9,23,19,4,23
Amkar,9923,8,6,4,10,14,23,-9,22
Din Moscow,9923,9,5,6,9,18,26,-8,21
Rostov,9923,10,4,6,10,10,19,-9,18
Anzhi,9923,11,3,6,11,16,38,-22,15
Loko Moscow,9924,1,11,6,3,29,13,16,39
CSKA Moscow,9924,2,11,3,6,29,21,8,36
Krasnodar,9924,3,10,4,6,33,24,9,34
Spart Moscow,9924,4,9,6,5,38,29,9,33
Zenit,9924,5,8,9,3,23,14,9,33
Terek Grozny,9924,6,9,5,6,24,23,1,32
FK Rubin,9924,7,6,5,9,23,21,2,23
Din Moscow,9924,8,5,7,8,19,25,-6,22
Amkar,9924,9,5,4,11,12,25,-13,19
Rostov,9924,10,4,6,10,10,19,-9,18
Anzhi,9924,11,2,5,13,16,42,-26,11
Loko Moscow,9925,1,11,6,3,33,16,17,39
Spart Moscow,9925,2,10,6,4,36,26,10,36
CSKA Moscow,9925,3,10,4,6,27,20,7,34
Zenit,9925,4,8,9,3,24,15,9,33
Terek Grozny,9925,5,9,5,6,23,22,1,32
Krasnodar,9925,6,8,5,7,29,28,1,29
FK Rubin,9925,7,6,6,8,23,17,6,24
Din Moscow,9925,8,5,8,7,17,21,-4,23
Rostov,9925,9,4,6,10,11,19,-8,18
Amkar,9925,10,4,4,12,9,24,-15,16
Anzhi,9925,11,3,5,12,17,41,-24,14
Loko Moscow,9926,1,12,5,3,31,13,18,41
Spart Moscow,9926,2,11,5,4,39,27,12,38
CSKA Moscow,9926,3,11,3,6,29,23,6,36
Zenit,9926,4,9,8,3,28,16,12,35
Krasnodar,9926,5,9,4,7,30,25,5,31
Terek Grozny,9926,6,7,6,7,21,25,-4,27
Din Moscow,9926,7,5,7,8,18,23,-5,22
FK Rubin,9926,8,5,6,9,21,20,1,21
Rostov,9926,9,4,6,10,10,19,-9,18
Amkar,9926,10,4,5,11,11,25,-14,17
Anzhi,9926,11,3,5,12,17,39,-22,14
Loko Moscow,9927,1,13,5,2,34,13,21,44
CSKA Moscow,9927,2,11,4,5,27,18,9,37
Spart Moscow,9927,3,9,7,4,37,28,9,34
Krasnodar,9927,4,9,4,7,32,28,4,31
Zenit,9927,5,7,8,5,22,16,6,29
Terek Grozny,9927,6,7,5,8,20,25,-5,26
Din Moscow,9927,7,6,7,7,22,23,-1,25
FK Rubin,9927,8,5,5,10,23,25,-2,20
Rostov,9927,9,4,7,9,11,18,-7,19
Amkar,9927,10,5,4,11,11,24,-13,19
Anzhi,9927,11,3,6,11,17,38,-21,15
Loko Moscow,9928,1,12,5,3,30,14,16,41
Spart Moscow,9928,2,10,6,4,37,27,10,36
CSKA Moscow,9928,3,10,4,6,25,19,6,34
Zenit,9928,4,8,8,4,23,14,9,32
Krasnodar,9928,5,9,4,7,32,28,4,31
Terek Grozny,9928,6,8,6,6,23,24,-1,30
Din Moscow,9928,7,6,6,8,19,23,-4,24
FK Rubin,9928,8,6,5,9,25,20,5,23
Rostov,9928,9,4,6,10,10,18,-8,18
Amkar,9928,10,4,5,11,11,25,-14,17
Anzhi,9928,11,2,7,11,15,38,-23,13
Loko Moscow,9929,1,12,5,3,30,13,17,41
Spart Moscow,9929,2,10,6,4,38,27,11,36
CSKA Moscow,9929,3,10,4,6,26,19,7,34
Krasnodar,9929,4,10,4,6,31,25,6,34
Terek Grozny,9929,5,9,5,6,24,23,1,32
Zenit,9929,6,7,9,4,22,15,7,30
Din Moscow,9929,7,6,6,8,20,24,-4,24
FK Rubin,9929,8,5,5,10,23,22,1,20
Rostov,9929,9,4,7,9,11,18,-7,19
Amkar,9929,10,4,4,12,10,26,-16,16
Anzhi,9929,11,3,5,12,16,39,-23,14
Loko Moscow,9930,1,11,6,3,29,12,17,39
CSKA Moscow,9930,2,11,4,5,26,17,9,37
Krasnodar,9930,3,9,5,6,29,25,4,32
Zenit,9930,4,7,10,3,21,13,8,31
Spart Moscow,9930,5,8,5,7,36,35,1,29
Terek Grozny,9930,6,8,5,7,22,23,-1,29
FK Rubin,9930,7,6,6,8,23,18,5,24
Din Moscow,9930,8,6,6,8,19,23,-4,24
Amkar,9930,9,6,4,10,14,23,-9,22
Rostov,9930,10,5,6,9,14,18,-4,21
Anzhi,9930,11,2,5,13,14,40,-26,11
Loko Moscow,9931,1,12,6,2,32,13,19,42
CSKA Moscow,9931,2,11,3,6,27,21,6,36
Spart Moscow,9931,3,10,5,5,36,27,9,35
Zenit,9931,4,8,8,4,25,15,10,32
Krasnodar,9931,5,9,5,6,30,26,4,32
Terek Grozny,9931,6,7,6,7,22,26,-4,27
Din Moscow,9931,7,6,6,8,18,22,-4,24
FK Rubin,9931,8,5,5,10,22,20,2,20
Amkar,9931,9,5,5,10,13,25,-12,20
Rostov,9931,10,4,6,10,10,18,-8,18
Anzhi,9931,11,3,5,12,17,39,-22,14
CSKA Moscow,9932,1,12,3,5,28,18,10,39
Loko Moscow,9932,2,11,5,4,30,14,16,38
Spart Moscow,9932,3,11,5,4,40,27,13,38
Krasnodar,9932,4,10,4,6,31,25,6,34
Zenit,9932,5,8,8,4,22,14,8,32
Terek Grozny,9932,6,8,6,6,22,23,-1,30
FK Rubin,9932,7,6,5,9,23,19,4,23
Din Moscow,9932,8,5,6,9,17,25,-8,21
Rostov,9932,9,4,6,10,11,20,-9,18
Amkar,9932,10,4,4,12,11,26,-15,16
Anzhi,9932,11,2,6,12,15,39,-24,12
Loko Moscow,9933,1,12,5,3,31,14,17,41
CSKA Moscow,9933,2,11,3,6,29,20,9,36
Zenit,9933,3,9,8,3,25,13,12,35
Spart Moscow,9933,4,8,5,7,34,32,2,29
Krasnodar,9933,5,8,5,7,29,27,2,29
Terek Grozny,9933,6,7,6,7,20,23,-3,27
FK Rubin,9933,7,6,6,8,23,18,5,24
Din Moscow,9933,8,6,6,8,21,22,-1,24
Amkar,9933,9,6,4,10,12,23,-11,22
Rostov,9933,10,5,6,9,11,17,-6,21
Anzhi,9933,11,2,6,12,15,41,-26,12
Loko Moscow,9934,1,11,6,3,30,15,15,39
CSKA Moscow,9934,2,11,3,6,30,21,9,36
Spart Moscow,9934,3,9,7,4,41,31,10,34
Zenit,9934,4,8,9,3,23,13,10,33
Krasnodar,9934,5,9,5,6,31,25,6,32
Terek Grozny,9934,6,8,5,7,21,24,-3,29
Din Moscow,9934,7,5,8,7,20,24,-4,23
FK Rubin,9934,8,5,7,8,22,18,4,22
Rostov,9934,9,4,6,10,12,21,-9,18
Amkar,9934,10,4,5,11,11,25,-14,17
Anzhi,9934,11,3,5,12,18,42,-24,14
Loko Moscow,9935,1,13,5,2,33,13,20,44
Spart Moscow,9935,2,10,5,5,37,26,11,35
CSKA Moscow,9935,3,10,4,6,27,21,6,34
Krasnodar,9935,4,9,4,7,30,27,3,31
Zenit,9935,5,7,9,4,23,16,7,30
Terek Grozny,9935,6,7,5,8,21,25,-4,26
Din Moscow,9935,7,6,6,8,18,24,-6,24
Rostov,9935,8,5,6,9,11,17,-6,21
FK Rubin,9935,9,5,5,10,22,20,2,20
Amkar,9935,10,5,4,11,10,23,-13,19
Anzhi,9935,11,4,5,11,19,39,-20,17
Loko Moscow,9936,1,12,6,2,31,12,19,42
Spart Moscow,9936,2,11,5,4,40,27,13,38
CSKA Moscow,9936,3,10,4,6,27,21,6,34
Zenit,9936,4,8,8,4,26,17,9,32
Krasnodar,9936,5,8,6,6,28,25,3,30
Terek Grozny,9936,6,8,5,7,24,26,-2,29
FK Rubin,9936,7,6,6,8,27,18,9,24
Din Moscow,9936,8,5,6,9,18,29,-11,21
Rostov,9936,9,4,6,10,11,20,-9,18
Amkar,9936,10,4,4,12,10,26,-16,16
Anzhi,9936,11,3,6,11,17,38,-21,15
Loko Moscow,9937,1,12,6,2,30,11,19,42
Spart Moscow,9937,2,11,5,4,41,27,14,38
CSKA Moscow,9937,3,11,4,5,29,19,10,37
Zenit,9937,4,7,10,3,22,14,8,31
Krasnodar,9937,5,9,4,7,28,25,3,31
Terek Grozny,9937,6,8,5,7,25,26,-1,29
Din Moscow,9937,7,6,6,8,20,26,-6,24
FK Rubin,9937,8,5,5,10,23,21,2,20
Amkar,9937,9,5,4,11,14,27,-13,19
Rostov,9937,10,4,6,10,10,19,-9,18
Anzhi,9937,11,2,5,13,16,43,-27,11
Loko Moscow,9938,1,12,5,3,30,12,18,41
CSKA Moscow,9938,2,11,3,6,26,18,8,36
Spart Moscow,9938,3,9,6,5,34,27,7,33
Krasnodar,9938,4,9,5,6,29,25,4,32
Zenit,9938,5,7,8,5,21,15,6,29
Terek Grozny,9938,6,7,5,8,20,29,-9,26
Din Moscow,9938,7,6,6,8,20,23,-3,24
FK Rubin,9938,8,5,6,9,23,21,2,21
Rostov,9938,9,5,6,9,12,17,-5,21
Amkar,9938,10,5,5,10,11,22,-11,20
Anzhi,9938,11,4,5,11,20,37,-17,17
CSKA Moscow,9939,1,12,3,5,28,17,11,39
Loko Moscow,9939,2,11,5,4,32,16,16,38
Spart Moscow,9939,3,10,6,4,40,27,13,36
Zenit,9939,4,8,8,4,23,15,8,32
Krasnodar,9939,5,9,5,6,31,27,4,32
Terek Grozny,9939,6,8,5,7,25,23,2,29
Din Moscow,9939,7,6,6,8,19,25,-6,24
FK Rubin,9939,8,5,6,9,23,20,3,21
Amkar,9939,9,5,5,10,10,22,-12,20
Rostov,9939,10,4,6,10,12,21,-9,18
Anzhi,9939,11,2,5,13,14,44,-30,11
Loko Moscow,9940,1,12,6,2,32,12,20,42
CSKA Moscow,9940,2,12,3,5,28,18,10,39
Spart Moscow,9940,3,10,5,5,38,28,10,35
Krasnodar,9940,4,9,4,7,30,27,3,31
Zenit,9940,5,7,9,4,21,14,7,30
Terek Grozny,9940,6,7,6,7,21,24,-3,27
Din Moscow,9940,7,6,6,8,18,22,-4,24
FK Rubin,9940,8,6,5,9,22,19,3,23
Rostov,9940,9,4,6,10,12,20,-8,18
Amkar,9940,10,4,5,11,9,24,-15,17
Anzhi,9940,11,3,5,12,17,40,-23,14
Loko Moscow,9941,1,12,5,3,30,12,18,41
CSKA Moscow,9941,2,12,3,5,29,17,12,39
Krasnodar,9941,3,10,4,6,31,25,6,34
Spart Moscow,9941,4,9,6,5,37,28,9,33
Zenit,9941,5,7,8,5,21,15,6,29
Terek Grozny,9941,6,8,5,7,23,25,-2,29
FK Rubin,9941,7,6,5,9,23,20,3,23
Din Moscow,9941,8,5,7,8,18,23,-5,22
Rostov,9941,9,5,6,9,11,17,-6,21
Amkar,9941,10,4,4,12,10,26,-16,16
Anzhi,9941,11,3,5,12,17,42,-25,14
Loko Moscow,9942,1,12,6,2,31,12,19,42
CSKA Moscow,9942,2,11,4,5,28,18,10,37
Spart Moscow,9942,3,9,6,5,37,31,6,33
Zenit,9942,4,7,9,4,21,14,7,30
Krasnodar,9942,5,8,6,6,29,26,3,30
Terek Grozny,9942,6,7,7,6,21,23,-2,28
Din Moscow,9942,7,6,6,8,20,23,-3,24
FK Rubin,9942,8,5,6,9,22,20,2,21
Amkar,9942,9,5,5,10,13,23,-10,20
Rostov,9942,10,4,7,9,12,19,-7,19
Anzhi,9942,11,2,6,12,15,40,-25,12
Loko Moscow,9943,1,12,6,2,33,12,21,42
CSKA Moscow,9943,2,11,4,5,27,18,9,37
Spart Moscow,9943,3,10,5,5,39,29,10,35
Krasnodar,9943,4,9,5,6,30,25,5,32
Terek Grozny,9943,5,9,5,6,24,23,1,32
Zenit,9943,6,7,8,5,22,18,4,29
Din Moscow,9943,7,5,7,8,20,26,-6,22
FK Rubin,9943,8,5,6,9,25,23,2,21
Rostov,9943,9,5,6,9,13,18,-5,21
Amkar,9943,10,4,4,12,10,27,-17,16
Anzhi,9943,11,2,6,12,16,40,-24,12
Loko Moscow,9944,1,12,6,2,31,12,19,42
CSKA Moscow,9944,2,11,4,5,29,20,9,37
Spart Moscow,9944,3,9,6,5,36,28,8,33
Krasnodar,9944,4,9,5,6,30,25,5,32
Zenit,9944,5,7,9,4,23,16,7,30
Terek Grozny,9944,6,7,5,8,20,26,-6,26
Din Moscow,9944,7,6,6,8,20,23,-3,24
Rostov,9944,8,5,6,9,12,18,-6,21
FK Rubin,9944,9,5,5,10,22,22,0,20
Amkar,9944,10,5,5,10,11,23,-12,20
Anzhi,9944,11,3,5,12,18,39,-21,14
Loko Moscow,9945,1,12,6,2,33,13,20,42
CSKA Moscow,9945,2,11,4,5,29,19,10,37
Zenit,9945,3,7,10,3,24,16,8,31
Spart Moscow,9945,4,8,7,5,37,30,7,31
Terek Grozny,9945,5,8,6,6,24,23,1,30
Krasnodar,9945,6,8,5,7,28,27,1,29
Din Moscow,9945,7,5,8,7,19,23,-4,23
FK Rubin,9945,8,5,7,8,21,17,4,22
Amkar,9945,9,5,5,10,11,23,-12,20
Rostov,9945,10,4,7,9,12,19,-7,19
Anzhi,9945,11,2,5,13,14,42,-28,11
Loko Moscow,9946,1,13,5,2,33,11,22,44
CSKA Moscow,9946,2,10,4,6,26,19,7,34
Spart Moscow,9946,3,9,5,6,40,33,7,32
Zenit,9946,4,8,8,4,22,16,6,32
Terek Grozny,9946,5,9,5,6,26,23,3,32
Krasnodar,9946,6,8,4,8,27,26,1,28
FK Rubin,9946,7,7,5,8,26,17,9,26
Din Moscow,9946,8,6,6,8,20,27,-7,24
Amkar,9946,9,5,4,11,15,25,-10,19
Rostov,9946,10,4,6,10,10,21,-11,18
Anzhi,9946,11,2,6,12,15,42,-27,12
Loko Moscow,9947,1,12,6,2,33,12,21,42
CSKA Moscow,9947,2,10,5,5,26,18,8,35
Spart Moscow,9947,3,9,6,5,35,27,8,33
Krasnodar,9947,4,9,5,6,30,25,5,32
Zenit,9947,5,7,9,4,21,16,5,30
Terek Grozny,9947,6,7,6,7,22,26,-4,27
Din Moscow,9947,7,6,7,7,19,21,-2,25
FK Rubin,9947,8,5,6,9,21,19,2,21
Rostov,9947,9,4,6,10,10,19,-9,18
Amkar,9947,10,4,6,10,10,23,-13,18
Anzhi,9947,11,3,6,11,18,39,-21,15
Loko Moscow,9948,1,11,6,3,30,14,16,39
CSKA Moscow,9948,2,12,3,5,28,17,11,39
Spart Moscow,9948,3,10,5,5,39,29,10,35
Krasnodar,9948,4,9,4,7,29,25,4,31
Zenit,9948,5,7,9,4,22,15,7,30
FK Rubin,9948,6,7,5,8,23,17,6,26
Terek Grozny,9948,7,7,5,8,22,26,-4,26
Amkar,9948,8,6,4,10,13,24,-11,22
Din Moscow,9948,9,5,6,9,17,24,-7,21
Rostov,9948,10,4,6,10,12,20,-8,18
Anzhi,9948,11,3,5,12,16,40,-24,14
Loko Moscow,9949,1,13,5,2,34,13,21,44
Spart Moscow,9949,2,11,5,4,39,26,13,38
CSKA Moscow,9949,3,11,3,6,27,20,7,36
Zenit,9949,4,8,8,4,24,15,9,32
Krasnodar,9949,5,9,4,7,29,27,2,31
Terek Grozny,9949,6,8,6,6,25,24,1,30
Din Moscow,9949,7,5,7,8,18,25,-7,22
FK Rubin,9949,8,5,6,9,22,19,3,21
Rostov,9949,9,4,6,10,11,19,-8,18
Amkar,9949,10,4,5,11,10,24,-14,17
Anzhi,9949,11,2,5,13,16,43,-27,11
Loko Moscow,9950,1,11,5,4,30,14,16,38
CSKA Moscow,9950,2,11,3,6,29,21,8,36
Spart Moscow,9950,3,9,6,5,36,28,8,33
Zenit,9950,4,8,8,4,24,16,8,32
Krasnodar,9950,5,9,4,7,29,26,3,31
Terek Grozny,9950,6,7,6,7,21,26,-5,27
FK Rubin,9950,7,7,5,8,23,17,6,26
Amkar,9950,8,6,4,10,14,22,-8,22
Din Moscow,9950,9,5,6,9,17,24,-7,21
Rostov,9950,10,4,7,9,11,18,-7,19
Anzhi,9950,11,3,6,11,17,39,-22,15
Loko Moscow,9951,1,13,5,2,35,12,23,44
Spart Moscow,9951,2,10,6,4,41,30,11,36
CSKA Moscow,9951,3,11,3,6,30,19,11,36
Zenit,9951,4,8,8,4,23,16,7,32
Terek Grozny,9951,5,9,5,6,25,23,2,32
Krasnodar,9951,6,8,4,8,30,30,0,28
Din Moscow,9951,7,6,6,8,22,25,-3,24
FK Rubin,9951,8,6,5,9,24,22,2,23
Rostov,9951,9,4,7,9,11,18,-7,19
Amkar,9951,10,4,4,12,12,28,-16,16
Anzhi,9951,11,2,5,13,14,44,-30,11
CSKA Moscow,9952,1,12,3,5,30,17,13,39
Loko Moscow,9952,2,11,5,4,29,14,15,38
Spart Moscow,9952,3,11,5,4,40,28,12,38
Krasnodar,9952,4,10,4,6,32,24,8,34
Zenit,9952,5,8,8,4,22,16,6,32
Terek Grozny,9952,6,8,6,6,24,23,1,30
Din Moscow,9952,7,6,6,8,18,23,-5,24
FK Rubin,9952,8,5,5,10,21,21,0,20
Rostov,9952,9,4,6,10,11,19,-8,18
Amkar,9952,10,4,5,11,12,26,-14,17
Anzhi,9952,11,2,5,13,14,42,-28,11
Loko Moscow,9953,1,13,5,2,33,12,21,44
Spart Moscow,9953,2,11,5,4,41,27,14,38
CSKA Moscow,9953,3,11,4,5,26,17,9,37
Krasnodar,9953,4,9,4,7,29,27,2,31
Zenit,9953,5,7,9,4,21,14,7,30
Terek Grozny,9953,6,7,6,7,22,25,-3,27
Din Moscow,9953,7,5,7,8,20,25,-5,22
FK Rubin,9953,8,5,6,9,22,19,3,21
Rostov,9953,9,4,6,10,10,19,-9,18
Amkar,9953,10,4,5,11,10,26,-16,17
Anzhi,9953,11,3,5,12,16,39,-23,14
Loko Moscow,9954,1,12,5,3,33,14,19,41
Spart Moscow,9954,2,10,5,5,37,27,10,35
CSKA Moscow,9954,3,10,5,5,27,19,8,35
Krasnodar,9954,4,9,4,7,30,27,3,31
Zenit,9954,5,7,9,4,22,16,6,30
Din Moscow,9954,6,7,6,7,21,22,-1,27
Terek Grozny,9954,7,7,6,7,21,25,-4,27
FK Rubin,9954,8,6,5,9,23,20,3,23
Amkar,9954,9,5,4,11,12,25,-13,19
Rostov,9954,10,4,6,10,10,18,-8,18
Anzhi,9954,11,2,7,11,16,39,-23,13
Loko Moscow,9955,1,12,6,2,30,11,19,42
Spart Moscow,9955,2,11,5,4,41,27,14,38
CSKA Moscow,9955,3,11,4,5,29,20,9,37
Zenit,9955,4,7,9,4,22,15,7,30
Krasnodar,9955,5,8,4,8,27,26,1,28
Terek Grozny,9955,6,7,6,7,22,25,-3,27
Din Moscow,9955,7,6,6,8,21,25,-4,24
FK Rubin,9955,8,6,5,9,23,20,3,23
Amkar,9955,9,5,4,11,11,25,-14,19
Rostov,9955,10,4,6,10,10,19,-9,18
Anzhi,9955,11,2,7,11,18,41,-23,13
Loko Moscow,9956,1,12,5,3,31,12,19,41
Spart Moscow,9956,2,11,5,4,39,26,13,38
CSKA Moscow,9956,3,11,3,6,27,19,8,36
Zenit,9956,4,8,8,4,23,15,8,32
Terek Grozny,9956,5,8,5,7,21,24,-3,29
Krasnodar,9956,6,8,4,8,27,29,-2,28
Din Moscow,9956,7,6,6,8,18,24,-6,24
FK Rubin,9956,8,6,5,9,24,18,6,23
Amkar,9956,9,5,4,11,11,23,-12,19
Rostov,9956,10,4,6,10,11,19,-8,18
Anzhi,9956,11,3,5,12,15,38,-23,14
Loko Moscow,9957,1,11,6,3,30,13,17,39
CSKA Moscow,9957,2,11,4,5,26,17,9,37
Krasnodar,9957,3,10,4,6,30,25,5,34
Spart Moscow,9957,4,9,5,6,34,28,6,32
Zenit,9957,5,7,9,4,21,14,7,30
Terek Grozny,9957,6,7,6,7,20,25,-5,27
Din Moscow,9957,7,6,7,7,21,23,-2,25
FK Rubin,9957,8,5,6,9,23,20,3,21
Amkar,9957,9,5,5,10,10,22,-12,20
Rostov,9957,10,4,6,10,10,18,-8,18
Anzhi,9957,11,3,6,11,17,37,-20,15
Loko Moscow,9958,1,12,5,3,32,14,18,41
CSKA Moscow,9958,2,11,3,6,27,18,9,36
Spart Moscow,9958,3,9,7,4,39,28,11,34
Zenit,9958,4,8,8,4,23,16,7,32
Krasnodar,9958,5,9,4,7,30,27,3,31
Terek Grozny,9958,6,7,6,7,22,25,-3,27
FK Rubin,9958,7,7,5,8,28,18,10,26
Din Moscow,9958,8,5,7,8,18,26,-8,22
Amkar,9958,9,5,5,10,11,23,-12,20
Rostov,9958,10,4,6,10,11,21,-10,18
Anzhi,9958,11,2,6,12,16,41,-25,12
Loko Moscow,9959,1,11,7,2,30,12,18,40
CSKA Moscow,9959,2,11,3,6,27,19,8,36
Spart Moscow,9959,3,9,7,4,39,28,11,34
Zenit,9959,4,8,9,3,23,14,9,33
Krasnodar,9959,5,8,6,6,28,25,3,30
Terek Grozny,9959,6,8,6,6,23,23,0,30
FK Rubin,9959,7,6,6,8,26,21,5,24
Din Moscow,9959,8,5,6,9,20,28,-8,21
Rostov,9959,9,4,7,9,11,18,-7,19
Amkar,9959,10,4,6,10,12,25,-13,18
Anzhi,9959,11,2,5,13,15,41,-26,11
Loko Moscow,9960,1,11,5,4,31,16,15,38
CSKA Moscow,9960,2,11,4,5,28,18,10,37
Krasnodar,9960,3,10,4,6,34,26,8,34
Zenit,9960,4,8,9,3,24,15,9,33
Spart Moscow,9960,5,8,7,5,36,29,7,31
Terek Grozny,9960,6,7,5,8,21,25,-4,26
FK Rubin,9960,7,6,5,9,25,22,3,23
Din Moscow,9960,8,5,7,8,19,25,-6,22
Rostov,9960,9,5,6,9,12,18,-6,21
Amkar,9960,10,5,5,10,11,23,-12,20
Anzhi,9960,11,3,5,12,16,40,-24,14
Loko Moscow,9961,1,11,6,3,32,16,16,39
CSKA Moscow,9961,2,12,3,5,28,18,10,39
Spart Moscow,9961,3,9,6,5,36,29,7,33
Krasnodar,9961,4,9,4,7,32,28,4,31
Zenit,9961,5,7,9,4,24,17,7,30
Terek Grozny,9961,6,7,6,7,21,25,-4,27
FK Rubin,9961,7,7,5,8,25,19,6,26
Din Moscow,9961,8,5,7,8,19,24,-5,22
Amkar,9961,9,5,5,10,11,22,-11,20
Rostov,9961,10,4,6,10,10,18,-8,18
Anzhi,9961,11,3,5,12,17,39,-22,14
Loko Moscow,9962,1,12,5,3,32,14,18,41
Spart Moscow,9962,2,11,5,4,39,25,14,38
CSKA Moscow,9962,3,11,3,6,28,20,8,36
Krasnodar,9962,4,10,4,6,34,25,9,34
Zenit,9962,5,8,8,4,24,15,9,32
Terek Grozny,9962,6,7,5,8,22,28,-6,26
Din Moscow,9962,7,6,6,8,19,23,-4,24
FK Rubin,9962,8,5,5,10,21,23,-2,20
Amkar,9962,9,5,4,11,12,26,-14,19
Rostov,9962,10,4,6,10,10,19,-9,18
Anzhi,9962,11,3,5,12,17,40,-23,14
Loko Moscow,9963,1,12,5,3,32,13,19,41
CSKA Moscow,9963,2,12,3,5,29,17,12,39
Spart Moscow,9963,3,10,5,5,35,27,8,35
Zenit,9963,4,8,8,4,23,15,8,32
Terek Grozny,9963,5,8,6,6,21,22,-1,30
Krasnodar,9963,6,8,4,8,27,28,-1,28
Din Moscow,9963,7,6,6,8,19,22,-3,24
FK Rubin,9963,8,6,5,9,23,19,4,23
Amkar,9963,9,5,4,11,11,23,-12,19
Rostov,9963,10,4,6,10,10,18,-8,18
Anzhi,9963,11,2,6,12,14,40,-26,12
Loko Moscow,9964,1,13,5,2,32,12,20,44
Spart Moscow,9964,2,10,5,5,36,27,9,35
CSKA Moscow,9964,3,10,3,7,26,20,6,33
Zenit,9964,4,8,8,4,22,14,8,32
Krasnodar,9964,5,8,5,7,29,27,2,29
Terek Grozny,9964,6,7,7,6,21,23,-2,28
Din Moscow,9964,7,6,6,8,19,22,-3,24
FK Rubin,9964,8,5,6,9,22,20,2,21
Amkar,9964,9,5,5,10,10,22,-12,20
Rostov,9964,10,4,6,10,11,19,-8,18
Anzhi,9964,11,3,6,11,17,39,-22,15
Loko Moscow,9965,1,13,5,2,36,14,22,44
CSKA Moscow,9965,2,10,4,6,28,23,5,34
Zenit,9965,3,8,8,4,27,17,10,32
Krasnodar,9965,4,9,4,7,29,28,1,31
Spart Moscow,9965,5,8,5,7,38,34,4,29
Din Moscow,9965,6,7,6,7,23,22,1,27
Terek Grozny,9965,7,7,6,7,22,25,-3,27
Rostov,9965,8,5,6,9,13,19,-6,21
FK Rubin,9965,9,5,5,10,21,22,-1,20
Amkar,9965,10,5,5,10,14,25,-11,20
Anzhi,9965,11,3,6,11,18,40,-22,15
Loko Moscow,9966,1,12,5,3,32,14,18,41
CSKA Moscow,9966,2,11,3,6,27,19,8,36
Zenit,9966,3,9,8,3,25,14,11,35
Spart Moscow,9966,4,8,6,6,35,32,3,30
Krasnodar,9966,5,8,5,7,29,28,1,29
Din Moscow,9966,6,7,6,7,23,23,0,27
Terek Grozny,9966,7,7,6,7,21,27,-6,27
Amkar,9966,8,6,4,10,16,22,-6,22
FK Rubin,9966,9,5,6,9,23,21,2,21
Rostov,9966,10,4,7,9,11,18,-7,19
Anzhi,9966,11,2,6,12,15,39,-24,12
Loko Moscow,9967,1,12,5,3,31,13,18,41
CSKA Moscow,9967,2,11,4,5,27,18,9,37
Spart Moscow,9967,3,9,6,5,39,30,9,33
Krasnodar,9967,4,9,5,6,29,25,4,32
Zenit,9967,5,7,9,4,22,15,7,30
Terek Grozny,9967,6,8,5,7,21,23,-2,29
Din Moscow,9967,7,6,6,8,20,25,-5,24
FK Rubin,9967,8,5,6,9,21,18,3,21
Rostov,9967,9,5,6,9,11,17,-6,21
Amkar,9967,10,4,5,11,11,25,-14,17
Anzhi,9967,11,3,5,12,15,38,-23,14
Loko Moscow,9968,1,12,6,2,32,13,19,42
CSKA Moscow,9968,2,11,3,6,30,20,10,36
Zenit,9968,3,8,9,3,24,14,10,33
Krasnodar,9968,4,9,4,7,30,27,3,31
Spart Moscow,9968,5,8,6,6,36,30,6,30
Terek Grozny,9968,6,7,5,8,22,26,-4,26
FK Rubin,9968,7,6,5,9,23,19,4,23
Din Moscow,9968,8,5,7,8,19,24,-5,22
Amkar,9968,9,6,4,10,13,24,-11,22
Rostov,9968,10,5,6,9,11,17,-6,21
Anzhi,9968,11,3,5,12,17,43,-26,14
Loko Moscow,9969,1,12,5,3,31,13,18,41
CSKA Moscow,9969,2,11,3,6,29,18,11,36
Spart Moscow,9969,3,10,5,5,38,27,11,35
Krasnodar,9969,4,10,4,6,31,24,7,34
Zenit,9969,5,8,8,4,22,15,7,32
Terek Grozny,9969,6,7,5,8,21,25,-4,26
FK Rubin,9969,7,6,5,9,24,20,4,23
Amkar,9969,8,6,4,10,11,22,-11,22
Din Moscow,9969,9,5,6,9,19,27,-8,21
Rostov,9969,10,4,6,10,10,19,-9,18
Anzhi,9969,11,3,5,12,16,42,-26,14
Loko Moscow,9970,1,11,5,4,31,18,13,38
CSKA Moscow,9970,2,11,4,5,29,18,11,37
Spart Moscow,9970,3,10,5,5,39,28,11,35
Zenit,9970,4,8,8,4,24,16,8,32
Krasnodar,9970,5,9,4,7,32,29,3,31
Terek Grozny,9970,6,8,6,6,22,22,0,30
Din Moscow,9970,7,6,6,8,21,25,-4,24
FK Rubin,9970,8,6,5,9,25,21,4,23
Amkar,9970,9,5,5,10,11,23,-12,20
Rostov,9970,10,4,6,10,10,19,-9,18
Anzhi,9970,11,2,6,12,15,40,-25,12
Loko Moscow,9971,1,12,5,3,30,12,18,41
CSKA Moscow,9971,2,11,3,6,27,22,5,36
Krasnodar,9971,3,10,4,6,29,24,5,34
Zenit,9971,4,8,8,4,25,14,11,32
Spart Moscow,9971,5,9,5,6,39,32,7,32
Terek Grozny,9971,6,8,6,6,22,23,-1,30
Din Moscow,9971,7,6,6,8,19,23,-4,24
FK Rubin,9971,8,6,5,9,22,18,4,23
Amkar,9971,9,5,5,10,12,24,-12,20
Rostov,9971,10,4,6,10,13,21,-8,18
Anzhi,9971,11,2,5,13,15,40,-25,11
Loko Moscow,9972,1,12,5,3,31,16,15,41
CSKA Moscow,9972,2,11,3,6,28,19,9,36
Spart Moscow,9972,3,10,5,5,40,27,13,35
Krasnodar,9972,4,10,4,6,34,25,9,34
Terek Grozny,9972,5,8,6,6,24,22,2,30
Zenit,9972,6,7,8,5,22,18,4,29
Din Moscow,9972,7,6,6,8,19,24,-5,24
Rostov,9972,8,5,6,9,11,17,-6,21
FK Rubin,9972,9,5,5,10,22,22,0,20
Amkar,9972,10,4,5,11,10,26,-16,17
Anzhi,9972,11,3,5,12,16,41,-25,14
Loko Moscow,9973,1,11,7,2,30,12,18,40
CSKA Moscow,9973,2,10,5,5,28,20,8,35
Spart Moscow,9973,3,9,6,5,40,33,7,33
Krasnodar,9973,4,9,5,6,30,24,6,32
Zenit,9973,5,7,10,3,23,15,8,31
Terek Grozny,9973,6,8,5,7,21,23,-2,29
Din Moscow,9973,7,6,7,7,23,24,-1,25
Amkar,9973,8,6,4,10,13,23,-10,22
FK Rubin,9973,9,5,5,10,22,24,-2,20
Rostov,9973,10,4,6,10,13,21,-8,18
Anzhi,9973,11,2,6,12,16,40,-24,12
Loko Moscow,9974,1,11,6,3,32,15,17,39
CSKA Moscow,9974,2,10,5,5,27,19,8,35
Spart Moscow,9974,3,9,7,4,35,26,9,34
Krasnodar,9974,4,10,4,6,31,25,6,34
Terek Grozny,9974,5,9,5,6,22,22,0,32
Zenit,9974,6,7,10,3,23,15,8,31
Din Moscow,9974,7,5,8,7,18,22,-4,23
FK Rubin,9974,8,5,6,9,22,20,2,21
Rostov,9974,9,4,7,9,10,17,-7,19
Amkar,9974,10,4,4,12,10,25,-15,16
Anzhi,9974,11,2,6,12,16,40,-24,12
Loko Moscow,9975,1,11,7,2,31,13,18,40
Spart Moscow,9975,2,9,7,4,40,31,9,34
Zenit,9975,3,8,9,3,24,14,10,33
CSKA Moscow,9975,4,10,3,7,26,21,5,33
Krasnodar,9975,5,8,5,7,28,27,1,29
Terek Grozny,9975,6,8,5,7,23,24,-1,29
FK Rubin,9975,7,6,6,8,25,19,6,24
Din Moscow,9975,8,5,8,7,21,25,-4,23
Rostov,9975,9,4,6,10,13,21,-8,18
Amkar,9975,10,4,5,11,11,26,-15,17
Anzhi,9975,11,4,5,11,17,38,-21,17
Loko Moscow,9976,1,12,5,3,31,13,18,41
CSKA Moscow,9976,2,11,4,5,29,17,12,37
Spart Moscow,9976,3,10,5,5,40,26,14,35
Krasnodar,9976,4,9,5,6,29,25,4,32
Zenit,9976,5,7,9,4,22,15,7,30
Terek Grozny,9976,6,7,6,7,20,23,-3,27
Din Moscow,9976,7,6,6,8,22,25,-3,24
Amkar,9976,8,6,4,10,11,22,-11,22
FK Rubin,9976,9,5,6,9,22,23,-1,21
Rostov,9976,10,4,6,10,10,20,-10,18
Anzhi,9976,11,2,6,12,14,41,-27,12
Loko Moscow,9977,1,12,6,2,32,12,20,42
Spart Moscow,9977,2,10,6,4,36,25,11,36
CSKA Moscow,9977,3,11,3,6,28,20,8,36
Zenit,9977,4,8,8,4,23,16,7,32
Krasnodar,9977,5,9,5,6,30,26,4,32
Terek Grozny,9977,6,7,5,8,20,26,-6,26
Din Moscow,9977,7,6,6,8,18,23,-5,24
FK Rubin,9977,8,5,5,10,22,20,2,20
Amkar,9977,9,5,5,10,12,22,-10,20
Rostov,9977,10,4,6,10,10,18,-8,18
Anzhi,9977,11,3,5,12,16,39,-23,14
Loko Moscow,9978,1,11,6,3,32,16,16,39
CSKA Moscow,9978,2,10,4,6,25,18,7,34
Zenit,9978,3,8,9,3,24,14,10,33
Spart Moscow,9978,4,9,6,5,39,30,9,33
Krasnodar,9978,5,9,5,6,32,26,6,32
Terek Grozny,9978,6,8,6,6,24,24,0,30
Din Moscow,9978,7,7,6,7,24,25,-1,27
FK Rubin,9978,8,5,5,10,23,24,-1,20
Rostov,9978,9,4,7,9,12,19,-7,19
Amkar,9978,10,4,4,12,10,27,-17,16
Anzhi,9978,11,3,6,11,16,38,-22,15
Loko Moscow,9979,1,11,6,3,31,14,17,39
CSKA Moscow,9979,2,11,4,5,29,20,9,37
Spart Moscow,9979,3,10,5,5,38,28,10,35
Krasnodar,9979,4,10,4,6,32,25,7,34
Zenit,9979,5,7,9,4,23,16,7,30
Terek Grozny,9979,6,7,6,7,22,26,-4,27
Din Moscow,9979,7,6,6,8,20,23,-3,24
Amkar,9979,8,6,4,10,13,23,-10,22
FK Rubin,9979,9,5,5,10,21,22,-1,20
Rostov,9979,10,4,6,10,10,19,-9,18
Anzhi,9979,11,2,7,11,18,41,-23,13
Loko Moscow,9980,1,11,6,3,29,13,16,39
Spart Moscow,9980,2,10,5,5,37,27,10,35
CSKA Moscow,9980,3,10,5,5,25,17,8,35
Zenit,9980,4,8,9,3,23,13,10,33
Krasnodar,9980,5,9,5,6,31,25,6,32
Terek Grozny,9980,6,7,6,7,22,27,-5,27
Din Moscow,9980,7,6,7,7,20,22,-2,25
FK Rubin,9980,8,5,6,9,23,22,1,21
Amkar,9980,9,5,4,11,12,23,-11,19
Rostov,9980,10,4,6,10,10,20,-10,18
Anzhi,9980,11,2,7,11,16,39,-23,13
Loko Moscow,9981,1,11,5,4,29,13,16,38
Spart Moscow,9981,2,10,5,5,40,30,10,35
Krasnodar,9981,3,10,4,6,30,24,6,34
CSKA Moscow,9981,4,10,4,6,27,21,6,34
Zenit,9981,5,8,9,3,24,15,9,33
Terek Grozny,9981,6,9,5,6,22,22,0,32
Din Moscow,9981,7,6,7,7,21,23,-2,25
FK Rubin,9981,8,5,6,9,22,20,2,21
Rostov,9981,9,4,6,10,11,20,-9,18
Amkar,9981,10,4,4,12,10,26,-16,16
Anzhi,9981,11,3,5,12,16,38,-22,14
Loko Moscow,9982,1,13,5,2,35,12,23,44
Spart Moscow,9982,2,10,6,4,40,28,12,36
CSKA Moscow,9982,3,11,3,6,29,19,10,36
Zenit,9982,4,8,8,4,23,14,9,32
Krasnodar,9982,5,9,4,7,31,30,1,31
Terek Grozny,9982,6,8,5,7,25,25,0,29
FK Rubin,9982,7,6,5,9,24,20,4,23
Din Moscow,9982,8,5,7,8,19,25,-6,22
Rostov,9982,9,4,6,10,11,21,-10,18
Amkar,9982,10,4,4,12,9,26,-17,16
Anzhi,9982,11,3,5,12,17,43,-26,14
Loko Moscow,9983,1,11,5,4,30,15,15,38
Spart Moscow,9983,2,10,6,4,36,26,10,36
CSKA Moscow,9983,3,11,3,6,28,18,10,36
Zenit,9983,4,9,8,3,24,13,11,35
Krasnodar,9983,5,9,4,7,29,26,3,31
Terek Grozny,9983,6,8,5,7,21,25,-4,29
FK Rubin,9983,7,6,6,8,23,18,5,24
Din Moscow,9983,8,5,7,8,18,23,-5,22
Rostov,9983,9,4,7,9,11,18,-7,19
Amkar,9983,10,4,4,12,9,24,-15,16
Anzhi,9983,11,3,5,12,17,40,-23,14
Loko Moscow,9984,1,13,5,2,32,12,20,44
CSKA Moscow,9984,2,11,3,6,29,19,10,36
Spart Moscow,9984,3,9,5,6,36,29,7,32
Terek Grozny,9984,4,8,6,6,24,25,-1,30
Zenit,9984,5,7,8,5,22,19,3,29
Krasnodar,9984,6,8,4,8,27,26,1,28
FK Rubin,9984,7,7,5,8,24,18,6,26
Rostov,9984,8,5,6,9,13,17,-4,21
Din Moscow,9984,9,5,6,9,18,26,-8,21
Amkar,9984,10,5,4,11,11,24,-13,19
Anzhi,9984,11,3,6,11,18,39,-21,15
Loko Moscow,9985,1,12,5,3,31,13,18,41
CSKA Moscow,9985,2,12,3,5,29,19,10,39
Krasnodar,9985,3,10,4,6,29,24,5,34
Spart Moscow,9985,4,9,6,5,37,27,10,33
Zenit,9985,5,7,8,5,23,17,6,29
Terek Grozny,9985,6,7,7,6,21,23,-2,28
Din Moscow,9985,7,7,6,7,21,22,-1,27
FK Rubin,9985,8,5,5,10,22,20,2,20
Rostov,9985,9,4,6,10,10,21,-11,18
Amkar,9985,10,4,6,10,9,22,-13,18
Anzhi,9985,11,2,6,12,16,40,-24,12
Loko Moscow,9986,1,13,5,2,33,13,20,44
CSKA Moscow,9986,2,11,4,5,27,18,9,37
Krasnodar,9986,3,9,4,7,34,28,6,31
Zenit,9986,4,7,9,4,23,16,7,30
Spart Moscow,9986,5,8,6,6,36,30,6,30
Din Moscow,9986,6,7,6,7,21,21,0,27
Terek Grozny,9986,7,7,6,7,23,26,-3,27
FK Rubin,9986,8,5,5,10,23,26,-3,20
Amkar,9986,9,5,5,10,12,24,-12,20
Rostov,9986,10,4,7,9,12,19,-7,19
Anzhi,9986,11,3,5,12,17,40,-23,14
Loko Moscow,9987,1,12,6,2,33,13,20,42
CSKA Moscow,9987,2,11,3,6,26,18,8,36
Spart Moscow,9987,3,9,6,5,36,28,8,33
Zenit,9987,4,7,8,5,21,16,5,29
Krasnodar,9987,5,8,5,7,30,28,2,29
Terek Grozny,9987,6,8,5,7,22,25,-3,29
FK Rubin,9987,7,6,6,8,24,19,5,24
Din Moscow,9987,8,5,7,8,19,24,-5,22
Rostov,9987,9,4,7,9,11,18,-7,19
Amkar,9987,10,5,4,11,11,24,-13,19
Anzhi,9987,11,4,5,11,17,37,-20,17
Loko Moscow,9988,1,11,6,3,30,13,17,39
Spart Moscow,9988,2,10,5,5,38,28,10,35
Krasnodar,9988,3,10,4,6,31,25,6,34
CSKA Moscow,9988,4,10,4,6,27,21,6,34
Zenit,9988,5,8,9,3,25,15,10,33
Terek Grozny,9988,6,8,5,7,23,25,-2,29
Din Moscow,9988,7,6,7,7,19,21,-2,25
FK Rubin,9988,8,5,6,9,22,20,2,21
Rostov,9988,9,4,6,10,10,20,-10,18
Amkar,9988,10,4,4,12,10,26,-16,16
Anzhi,9988,11,3,6,11,18,39,-21,15
Loko Moscow,9989,1,12,6,2,31,12,19,42
Spart Moscow,9989,2,10,5,5,40,29,11,35
CSKA Moscow,9989,3,10,4,6,26,19,7,34
Zenit,9989,4,8,9,3,23,14,9,33
Krasnodar,9989,5,8,4,8,27,26,1,28
Terek Grozny,9989,6,7,6,7,22,25,-3,27
Din Moscow,9989,7,6,6,8,18,25,-7,24
FK Rubin,9989,8,6,5,9,22,18,4,23
Amkar,9989,9,6,4,10,13,23,-10,22
Rostov,9989,10,4,6,10,11,19,-8,18
Anzhi,9989,11,2,7,11,17,40,-23,13
Loko Moscow,9990,1,11,7,2,32,14,18,40
CSKA Moscow,9990,2,12,3,5,30,17,13,39
Spart Moscow,9990,3,9,6,5,38,31,7,33
Zenit,9990,4,7,9,4,23,18,5,30
Krasnodar,9990,5,8,6,6,29,26,3,30
Terek Grozny,9990,6,8,5,7,22,23,-1,29
Din Moscow,9990,7,7,6,7,24,24,0,27
FK Rubin,9990,8,5,6,9,23,21,2,21
Rostov,9990,9,4,7,9,11,18,-7,19
Amkar,9990,10,4,4,12,10,26,-16,16
Anzhi,9990,11,3,5,12,15,39,-24,14
Loko Moscow,9991,1,12,5,3,33,12,21,41
CSKA Moscow,9991,2,12,3,5,31,18,13,39
Spart Moscow,9991,3,11,5,4,41,27,14,38
Krasnodar,9991,4,10,4,6,31,26,5,34
Zenit,9991,5,7,8,5,21,19,2,29
Terek Grozny,9991,6,7,6,7,20,23,-3,27
FK Rubin,9991,7,6,5,9,24,20,4,23
Din Moscow,9991,8,5,6,9,18,24,-6,21
Rostov,9991,9,4,6,10,10,21,-11,18
Amkar,9991,10,4,5,11,10,24,-14,17
Anzhi,9991,11,3,5,12,16,41,-25,14
Loko Moscow,9992,1,11,6,3,30,14,16,39
CSKA Moscow,9992,2,11,3,6,29,19,10,36
Zenit,9992,3,8,9,3,23,14,9,33
Spart Moscow,9992,4,9,6,5,35,28,7,33
Krasnodar,9992,5,9,5,6,30,25,5,32
Terek Grozny,9992,6,8,5,7,22,26,-4,29
FK Rubin,9992,7,6,6,8,23,17,6,24
Rostov,9992,8,5,6,9,13,17,-4,21
Din Moscow,9992,9,5,6,9,17,25,-8,21
Amkar,9992,10,4,5,11,9,23,-14,17
Anzhi,9992,11,3,5,12,18,41,-23,14
Loko Moscow,9993,1,11,7,2,29,11,18,40
CSKA Moscow,9993,2,11,4,5,29,20,9,37
Krasnodar,9993,3,9,5,6,29,25,4,32
Spart Moscow,9993,4,8,7,5,36,30,6,31
Zenit,9993,5,7,9,4,23,16,7,30
Terek Grozny,9993,6,8,5,7,23,23,0,29
FK Rubin,9993,7,6,5,9,24,20,4,23
Din Moscow,9993,8,5,7,8,19,24,-5,22
Rostov,9993,9,4,7,9,12,19,-7,19
Amkar,9993,10,5,4,11,11,25,-14,19
Anzhi,9993,11,3,6,11,16,38,-22,15
Loko Moscow,9994,1,11,7,2,31,13,18,40
CSKA Moscow,9994,2,12,3,5,27,17,10,39
Spart Moscow,9994,3,10,5,5,39,26,13,35
Zenit,9994,4,7,9,4,22,15,7,30
Krasnodar,9994,5,8,6,6,30,27,3,30
Terek Grozny,9994,6,8,6,6,23,24,-1,30
FK Rubin,9994,7,5,7,8,24,20,4,22
Din Moscow,9994,8,5,7,8,18,24,-6,22
Amkar,9994,9,5,4,11,10,23,-13,19
Rostov,9994,10,4,6,10,10,21,-11,18
Anzhi,9994,11,2,6,12,16,40,-24,12
Loko Moscow,9995,1,11,6,3,30,14,16,39
CSKA Moscow,9995,2,11,4,5,30,21,9,37
Spart Moscow,9995,3,9,6,5,37,26,11,33
Zenit,9995,4,8,8,4,25,16,9,32
Krasnodar,9995,5,8,6,6,29,26,3,30
Terek Grozny,9995,6,7,6,7,21,24,-3,27
FK Rubin,9995,7,6,6,8,24,19,5,24
Din Moscow,9995,8,6,6,8,18,22,-4,24
Rostov,9995,9,4,7,9,10,17,-7,19
Amkar,9995,10,4,5,11,9,26,-17,17
Anzhi,9995,11,3,6,11,19,41,-22,15
Loko Moscow,9996,1,13,5,2,33,12,21,44
CSKA Moscow,9996,2,11,4,5,30,20,10,37
Spart Moscow,9996,3,10,5,5,37,28,9,35
Krasnodar,9996,4,9,4,7,28,25,3,31
Zenit,9996,5,7,9,4,24,18,6,30
Terek Grozny,9996,6,7,6,7,20,23,-3,27
Din Moscow,9996,7,6,7,7,19,21,-2,25
FK Rubin,9996,8,5,6,9,21,18,3,21
Amkar,9996,9,5,4,11,10,23,-13,19
Rostov,9996,10,4,6,10,11,20,-9,18
Anzhi,9996,11,2,6,12,15,40,-25,12
Loko Moscow,9997,1,12,6,2,32,12,20,42
CSKA Moscow,9997,2,11,4,5,29,18,11,37
Spart Moscow,9997,3,10,5,5,40,28,12,35
Terek Grozny,9997,4,9,5,6,24,23,1,32
Zenit,9997,5,7,9,4,22,16,6,30
Krasnodar,9997,6,8,5,7,29,27,2,29
Din Moscow,9997,7,6,6,8,20,25,-5,24
FK Rubin,9997,8,6,5,9,23,20,3,23
Rostov,9997,9,5,6,9,12,18,-6,21
Amkar,9997,10,4,4,12,9,26,-17,16
Anzhi,9997,11,2,5,13,15,42,-27,11
Loko Moscow,9998,1,11,6,3,30,13,17,39
CSKA Moscow,9998,2,11,4,5,26,17,9,37
Zenit,9998,3,8,9,3,22,13,9,33
Krasnodar,9998,4,9,5,6,30,26,4,32
Spart Moscow,9998,5,8,7,5,36,30,6,31
Terek Grozny,9998,6,7,6,7,21,25,-4,27
Din Moscow,9998,7,6,6,8,20,23,-3,24
FK Rubin,9998,8,6,5,9,24,20,4,23
Rostov,9998,9,4,7,9,13,20,-7,19
Amkar,9998,10,4,6,10,9,22,-13,18
Anzhi,9998,11,3,5,12,17,39,-22,14
Loko Moscow,9999,1,12,5,3,35,14,21,41
Spart Moscow,9999,2,11,5,4,42,25,17,38
CSKA Moscow,9999,3,11,3,6,27,21,6,36
Zenit,9999,4,9,8,3,28,15,13,35
Krasnodar,9999,5,8,5,7,28,29,-1,29
Terek Grozny,9999,6,7,7,6,21,23,-2,28
FK Rubin,9999,7,6,6,8,23,18,5,24
Din Moscow,9999,8,5,6,9,17,27,-10,21
Rostov,9999,9,4,6,10,10,19,-9,18
Amkar,9999,10,4,5,11,9,24,-15,17
Anzhi,9999,11,2,6,12,15,40,-25,12
