team,n,rank,w,d,l,gf,ga,gd,pts
Raith,0,1,23,8,5,69,32,37,77
Ayr,0,2,24,4,8,92,42,50,76
Arbroath,0,3,18,8,10,74,49,25,62
Alloa,0,4,17,8,11,56,44,12,59
Stranraer,0,5,15,5,16,57,67,-10,50
East Fife,0,6,14,3,19,50,66,-16,45
Airdrieon,0,7,10,12,14,45,58,-13,42
Forfar,0,8,10,6,20,38,64,-26,36
Albion,0,9,8,6,22,57,80,-23,30
Queen's Park,0,10,6,10,20,40,76,-36,28
Raith,1,1,23,8,5,72,34,38,77
Ayr,1,2,24,4,8,95,42,53,76
Arbroath,1,3,18,8,10,72,48,24,62
Alloa,1,4,17,8,11,58,47,11,59
Stranraer,1,5,15,6,15,56,65,-9,51
East Fife,1,6,13,4,19,48,65,-17,43
Airdrieon,1,7,10,11,15,45,59,-14,41
Forfar,1,8,11,5,20,39,64,-25,38
Albion,1,9,8,6,22,57,83,-26,30
Queen's Park,1,10,6,10,20,39,74,-35,28
Raith,2,1,23,8,5,70,32,38,77
Ayr,2,2,24,4,8,94,45,49,76
Arbroath,2,3,17,8,11,70,49,21,59
Alloa,2,4,17,8,11,56,45,11,59
Stranraer,2,5,15,6,15,57,66,-9,51
East Fife,2,6,13,4,19,49,66,-17,43
Airdrieon,2,7,10,11,15,45,60,-15,41
Forfar,2,8,11,5,20,40,64,-24,38
Queen's Park,2,9,7,10,19,40,72,-32,31
Albion,2,10,8,6,22,60,82,-22,30
Raith,3,1,23,8,5,71,34,37,77
Ayr,3,2,23,4,9,91,44,47,73
Arbroath,3,3,17,8,11,70,49,21,59
Alloa,3,4,17,8,11,58,46,12,59
Stranraer,3,5,15,6,15,56,65,-9,51
East Fife,3,6,13,4,19,48,65,-17,43
Airdrieon,3,7,10,12,14,47,60,-13,42
Forfar,3,8,10,6,20,40,66,-26,36
Albion,3,9,9,6,21,59,79,-20,33
Queen's Park,3,10,7,10,19,40,72,-32,31
Ayr,4,1,24,4,8,92,43,49,76
Raith,4,2,22,8,6,68,34,34,74
Alloa,4,3,18,8,10,58,43,15,62
Arbroath,4,4,17,8,11,70,50,20,59
Stranraer,4,5,16,5,15,56,64,-8,53
Airdrieon,4,6,11,11,14,48,59,-11,44
East Fife,4,7,13,3,20,47,65,-18,42
Forfar,4,8,10,5,21,39,67,-28,35
Queen's Park,4,9,7,10,19,41,72,-31,31
Albion,4,10,8,6,22,58,80,-22,30
Raith,5,1,23,8,5,71,33,38,77
Ayr,5,2,24,4,8,98,42,56,76
Arbroath,5,3,17,8,11,71,51,20,59
Alloa,5,4,17,8,11,57,46,11,59
Stranraer,5,5,15,5,16,55,68,-13,50
East Fife,5,6,14,3,19,51,64,-13,45
Airdrieon,5,7,11,11,14,46,58,-12,44
Forfar,5,8,10,5,21,38,65,-27,35
Queen's Park,5,9,7,10,19,42,73,-31,31
Albion,5,10,8,6,22,57,86,-29,30
Ayr,6,1,24,4,8,92,42,50,76
Raith,6,2,22,8,6,68,34,34,74
Alloa,6,3,18,8,10,58,43,15,62
Arbroath,6,4,17,9,10,71,49,22,60
Stranraer,6,5,16,5,15,57,64,-7,53
Airdrieon,6,6,10,12,14,47,60,-13,42
East Fife,6,7,13,3,20,47,66,-19,42
Forfar,6,8,10,6,20,40,66,-26,36
Albion,6,9,8,6,22,57,80,-23,30
Queen's Park,6,10,6,11,19,40,73,-33,29
Ayr,7,1,24,4,8,94,44,50,76
Raith,7,2,22,9,5,69,33,36,75
Alloa,7,3,17,9,10,57,44,13,60
Arbroath,7,4,17,8,11,71,51,20,59
Stranraer,7,5,15,6,15,56,65,-9,51
East Fife,7,6,13,4,19,48,65,-17,43
Airdrieon,7,7,10,12,14,47,60,-13,42
Forfar,7,8,10,6,20,40,66,-26,36
Queen's Park,7,9,7,10,19,42,73,-31,31
Albion,7,10,8,6,22,59,82,-23,30
Ayr,8,1,23,5,8,91,43,48,74
Raith,8,2,22,8,6,69,34,35,74
Alloa,8,3,18,8,10,58,44,14,62
Arbroath,8,4,17,9,10,70,48,22,60
Stranraer,8,5,16,5,15,58,65,-7,53
Airdrieon,8,6,11,11,14,48,59,-11,44
East Fife,8,7,13,3,20,48,67,-19,42
Forfar,8,8,10,5,21,39,67,-28,35
Albion,8,9,8,7,21,58,79,-21,31
Queen's Park,8,10,6,11,19,39,72,-33,29
Ayr,9,1,24,4,8,99,42,57,76
Raith,9,2,22,9,5,71,35,36,75
Alloa,9,3,17,9,10,59,46,13,60
Arbroath,9,4,17,8,11,71,50,21,59
Stranraer,9,5,16,5,15,59,65,-6,53
Airdrieon,9,6,10,12,14,46,59,-13,42
East Fife,9,7,13,3,20,48,68,-20,42
Forfar,9,8,10,6,20,39,65,-26,36
Queen's Park,9,9,7,10,19,41,73,-32,31
Albion,9,10,8,6,22,57,87,-30,30
Ayr,10,1,24,4,8,93,43,50,76
Raith,10,2,22,9,5,68,32,36,75
Alloa,10,3,17,9,10,56,43,13,60
Arbroath,10,4,17,8,11,70,51,19,59
Stranraer,10,5,15,5,16,58,69,-11,50
East Fife,10,6,14,3,19,52,67,-15,45
Airdrieon,10,7,11,11,14,48,58,-10,44
Forfar,10,8,10,5,21,38,67,-29,35
Queen's Park,10,9,7,10,19,42,72,-30,31
Albion,10,10,8,6,22,58,81,-23,30
Raith,11,1,23,8,5,70,33,37,77
Ayr,11,2,24,4,8,97,43,54,76
Arbroath,11,3,18,8,10,71,48,23,62
Alloa,11,4,17,8,11,57,45,12,59
Stranraer,11,5,16,5,15,56,64,-8,53
Airdrieon,11,6,11,11,14,46,58,-12,44
East Fife,11,7,13,3,20,47,65,-18,42
Forfar,11,8,10,5,21,38,65,-27,35
Albion,11,9,8,6,22,58,85,-27,30
Queen's Park,11,10,6,10,20,39,73,-34,28
Raith,12,1,23,8,5,71,32,39,77
Ayr,12,2,24,4,8,92,43,49,76
Arbroath,12,3,18,8,10,77,49,28,62
Alloa,12,4,17,8,11,56,46,10,59
Stranraer,12,5,15,5,16,55,65,-10,50
East Fife,12,6,14,3,19,48,64,-16,45
Airdrieon,12,7,10,11,15,46,60,-14,41
Forfar,12,8,11,5,20,40,65,-25,38
Albion,12,9,8,6,22,58,80,-22,30
Queen's Park,12,10,6,10,20,40,79,-39,28
Ayr,13,1,24,4,8,92,42,50,76
Raith,13,2,22,9,5,69,33,36,75
Arbroath,13,3,17,9,10,72,50,22,60
Alloa,13,4,17,9,10,57,44,13,60
Stranraer,13,5,16,5,15,60,65,-5,53
Airdrieon,13,6,11,11,14,46,58,-12,44
East Fife,13,7,13,3,20,48,69,-21,42
Forfar,13,8,10,5,21,38,65,-27,35
Albion,13,9,8,6,22,57,80,-23,30
Queen's Park,13,10,6,11,19,41,74,-33,29
Ayr,14,1,24,4,8,95,43,52,76
Raith,14,2,22,8,6,69,34,35,74
Alloa,14,3,18,8,10,58,44,14,62
Arbroath,14,4,17,8,11,70,49,21,59
Stranraer,14,5,15,6,15,55,64,-9,51
Airdrieon,14,6,11,11,14,46,58,-12,44
East Fife,14,7,13,4,19,47,64,-17,43
Forfar,14,8,10,5,21,38,65,-27,35
Queen's Park,14,9,7,10,19,40,72,-32,31
Albion,14,10,8,6,22,58,83,-25,30
Raith,15,1,23,8,5,69,32,37,77
Ayr,15,2,24,4,8,93,43,50,76
Arbroath,15,3,17,8,11,70,51,19,59
Alloa,15,4,17,8,11,56,44,12,59
Stranraer,15,5,15,5,16,55,66,-11,50
East Fife,15,6,14,3,19,49,64,-15,45
Airdrieon,15,7,11,11,14,48,58,-10,44
Forfar,15,8,10,5,21,38,67,-29,35
Queen's Park,15,9,7,10,19,42,72,-30,31
Albion,15,10,8,6,22,58,81,-23,30
Ayr,16,1,24,4,8,93,43,50,76
Raith,16,2,22,9,5,68,32,36,75
Alloa,16,3,17,9,10,56,43,13,60
Arbroath,16,4,17,8,11,70,49,21,59
Stranraer,16,5,16,5,15,58,66,-8,53
Airdrieon,16,6,11,11,14,46,58,-12,44
East Fife,16,7,13,3,20,49,67,-18,42
Forfar,16,8,10,5,21,38,65,-27,35
Queen's Park,16,9,7,10,19,40,72,-32,31
Albion,16,10,8,6,22,58,81,-23,30
Raith,17,1,23,8,5,70,32,38,77
Ayr,17,2,23,4,9,90,44,46,73
Arbroath,17,3,18,8,10,73,50,23,62
Alloa,17,4,17,8,11,56,45,11,59
Stranraer,17,5,15,6,15,56,65,-9,51
East Fife,17,6,13,4,19,48,65,-17,43
Airdrieon,17,7,10,12,14,46,59,-13,42
Forfar,17,8,10,6,20,39,65,-26,36
Albion,17,9,9,6,21,59,78,-19,33
Queen's Park,17,10,6,10,20,41,75,-34,28
Ayr,18,1,23,5,8,92,44,48,74
Raith,18,2,22,8,6,69,34,35,74
Alloa,18,3,18,8,10,58,44,14,62
Arbroath,18,4,17,8,11,71,51,20,59
Stranraer,18,5,15,6,15,56,65,-9,51
Airdrieon,18,6,11,11,14,47,59,-12,44
East Fife,18,7,13,4,19,48,65,-17,43
Forfar,18,8,10,5,21,39,66,-27,35
Albion,18,9,8,7,21,59,80,-21,31
Queen's Park,18,10,7,10,19,42,73,-31,31
Raith,19,1,23,8,5,69,32,37,77
Ayr,19,2,24,4,8,94,42,52,76
Arbroath,19,3,18,8,10,76,50,26,62
Alloa,19,4,17,8,11,56,44,12,59
Stranraer,19,5,15,5,16,55,65,-10,50
East Fife,19,6,14,3,19,48,64,-16,45
Airdrieon,19,7,11,11,14,49,59,-10,44
Forfar,19,8,10,5,21,39,68,-29,35
Albion,19,9,8,6,22,57,82,-25,30
Queen's Park,19,10,6,10,20,41,78,-37,28
Ayr,20,1,23,5,8,91,43,48,74
Raith,20,2,22,8,6,69,35,34,74
Alloa,20,3,18,8,10,59,44,15,62
Arbroath,20,4,17,8,11,71,50,21,59
Stranraer,20,5,15,5,16,57,70,-13,50
East Fife,20,6,14,3,19,53,66,-13,45
Airdrieon,20,7,10,12,14,45,58,-13,42
Forfar,20,8,10,6,20,38,64,-26,36
Albion,20,9,8,7,21,58,79,-21,31
Queen's Park,20,10,7,10,19,41,73,-32,31
Ayr,21,1,23,5,8,90,42,48,74
Raith,21,2,22,8,6,69,34,35,74
Alloa,21,3,18,8,10,58,44,14,62
Arbroath,21,4,17,8,11,71,53,18,59
Stranraer,21,5,15,6,15,56,65,-9,51
Airdrieon,21,6,11,11,14,47,58,-11,44
East Fife,21,7,13,4,19,48,65,-17,43
Forfar,21,8,10,5,21,38,66,-28,35
Albion,21,9,8,7,21,57,78,-21,31
Queen's Park,21,10,7,10,19,44,73,-29,31
Raith,22,1,23,8,5,70,32,38,77
Ayr,22,2,24,4,8,94,44,50,76
Arbroath,22,3,18,8,10,73,50,23,62
Alloa,22,4,17,8,11,56,45,11,59
Stranraer,22,5,16,5,15,58,64,-6,53
Airdrieon,22,6,11,11,14,48,59,-11,44
East Fife,22,7,13,3,20,47,67,-20,42
Forfar,22,8,10,5,21,39,67,-28,35
Albion,22,9,8,6,22,59,82,-23,30
Queen's Park,22,10,6,10,20,41,75,-34,28
Raith,23,1,23,8,5,72,34,38,77
Ayr,23,2,24,4,8,92,43,49,76
Arbroath,23,3,18,8,10,73,50,23,62
Alloa,23,4,17,8,11,58,47,11,59
Stranraer,23,5,15,5,16,56,67,-11,50
East Fife,23,6,14,3,19,50,65,-15,45
Airdrieon,23,7,11,11,14,47,59,-12,44
Forfar,23,8,10,5,21,39,66,-27,35
Albion,23,9,8,6,22,58,80,-22,30
Queen's Park,23,10,6,10,20,41,75,-34,28
Raith,24,1,23,8,5,72,33,39,77
Ayr,24,2,24,4,8,92,43,49,76
Arbroath,24,3,18,8,10,73,50,23,62
Alloa,24,4,17,8,11,57,47,10,59
Stranraer,24,5,16,5,15,57,64,-7,53
Airdrieon,24,6,10,12,14,48,61,-13,42
East Fife,24,7,13,3,20,47,66,-19,42
Forfar,24,8,10,6,20,41,67,-26,36
Albion,24,9,8,6,22,58,80,-22,30
Queen's Park,24,10,6,10,20,41,75,-34,28
Raith,25,1,23,8,5,70,33,37,77
Ayr,25,2,24,4,8,94,42,52,76
Arbroath,25,3,17,9,10,72,50,22,60
Alloa,25,4,17,8,11,57,45,12,59
Stranraer,25,5,15,5,16,58,68,-10,50
East Fife,25,6,14,3,19,51,67,-16,45
Airdrieon,25,7,10,11,15,45,60,-15,41
Forfar,25,8,11,5,20,40,64,-24,38
Albion,25,9,8,6,22,57,82,-25,30
Queen's Park,25,10,6,11,19,41,74,-33,29
Ayr,26,1,23,5,8,91,43,48,74
Raith,26,2,22,8,6,68,33,35,74
Arbroath,26,3,18,8,10,72,48,24,62
Alloa,26,4,18,8,10,57,43,14,62
Stranraer,26,5,15,5,16,55,67,-12,50
East Fife,26,6,14,3,19,50,64,-14,45
Airdrieon,26,7,10,11,15,47,61,-14,41
Forfar,26,8,11,5,20,41,66,-25,38
Albion,26,9,8,7,21,58,79,-21,31
Queen's Park,26,10,6,10,20,39,74,-35,28
Raith,27,1,22,9,5,70,34,36,75
Ayr,27,2,23,5,8,93,45,48,74
Arbroath,27,3,18,8,10,72,49,23,62
Alloa,27,4,17,9,10,58,45,13,60
Stranraer,27,5,15,5,16,55,66,-11,50
East Fife,27,6,14,3,19,49,64,-15,45
Airdrieon,27,7,10,11,15,45,59,-14,41
Forfar,27,8,11,5,20,39,64,-25,38
Albion,27,9,8,7,21,60,81,-21,31
Queen's Park,27,10,6,10,20,40,74,-34,28
Raith,28,1,23,8,5,71,33,38,77
Ayr,28,2,24,4,8,94,43,51,76
Arbroath,28,3,18,8,10,74,50,24,62
Alloa,28,4,17,8,11,57,46,11,59
Stranraer,28,5,15,5,16,57,67,-10,50
East Fife,28,6,14,3,19,50,66,-16,45
Airdrieon,28,7,11,11,14,47,58,-11,44
Forfar,28,8,10,5,21,38,66,-28,35
Albion,28,9,8,6,22,58,82,-24,30
Queen's Park,28,10,6,10,20,41,76,-35,28
Ayr,29,1,23,5,8,91,43,48,74
Raith,29,2,22,8,6,68,33,35,74
Alloa,29,3,18,8,10,57,43,14,62
Arbroath,29,4,17,8,11,71,51,20,59
Stranraer,29,5,16,5,15,56,64,-8,53
Airdrieon,29,6,11,11,14,46,58,-12,44
East Fife,29,7,13,3,20,47,65,-18,42
Forfar,29,8,10,5,21,38,65,-27,35
Albion,29,9,8,7,21,58,79,-21,31
Queen's Park,29,10,7,10,19,42,73,-31,31
Raith,30,1,23,8,5,71,34,37,77
Ayr,30,2,23,4,9,91,44,47,73
Arbroath,30,3,17,8,11,71,52,19,59
Alloa,30,4,17,8,11,58,46,12,59
Stranraer,30,5,15,5,16,55,66,-11,50
East Fife,30,6,14,3,19,49,64,-15,45
Airdrieon,30,7,11,11,14,47,58,-11,44
Forfar,30,8,10,5,21,38,66,-28,35
Albion,30,9,9,6,21,59,79,-20,33
Queen's Park,30,10,7,10,19,43,73,-30,31
Ayr,31,1,24,4,8,91,42,49,76
Raith,31,2,22,9,5,69,33,36,75
Alloa,31,3,17,9,10,57,44,13,60
Arbroath,31,4,17,8,11,71,51,20,59
Stranraer,31,5,15,6,15,56,65,-9,51
Airdrieon,31,6,11,11,14,48,58,-10,44
East Fife,31,7,13,4,19,48,65,-17,43
Forfar,31,8,10,5,21,38,67,-29,35
Queen's Park,31,9,7,10,19,42,73,-31,31
Albion,31,10,8,6,22,57,79,-22,30
Raith,32,1,23,8,5,69,32,37,77
Ayr,32,2,24,4,8,94,44,50,76
Arbroath,32,3,17,8,11,73,52,21,59
Alloa,32,4,17,8,11,56,44,12,59
Stranraer,32,5,15,6,15,55,64,-9,51
Airdrieon,32,6,11,11,14,47,59,-12,44
East Fife,32,7,13,4,19,47,64,-17,43
Forfar,32,8,10,5,21,39,66,-27,35
Queen's Park,32,9,7,10,19,43,75,-32,31
Albion,32,10,8,6,22,59,82,-23,30
Ayr,33,1,24,4,8,94,42,52,76
Raith,33,2,22,9,5,68,32,36,75
Alloa,33,3,17,9,10,56,43,13,60
Arbroath,33,4,17,8,11,70,49,21,59
Stranraer,33,5,15,5,16,58,68,-10,50
East Fife,33,6,14,3,19,51,67,-16,45
Airdrieon,33,7,10,12,14,46,59,-13,42
Forfar,33,8,10,6,20,39,65,-26,36
Queen's Park,33,9,7,10,19,40,72,-32,31
Albion,33,10,8,6,22,57,82,-25,30
Raith,34,1,23,8,5,69,32,37,77
Ayr,34,2,24,4,8,95,42,53,76
Arbroath,34,3,18,8,10,72,49,23,62
Alloa,34,4,17,8,11,56,44,12,59
Stranraer,34,5,15,6,15,56,65,-9,51
Airdrieon,34,6,11,11,14,47,59,-12,44
East Fife,34,7,13,4,19,48,65,-17,43
Forfar,34,8,10,5,21,39,66,-27,35
Albion,34,9,8,6,22,57,83,-26,30
Queen's Park,34,10,6,10,20,40,74,-34,28
Ayr,35,1,24,4,8,92,42,50,76
Raith,35,2,22,9,5,69,33,36,75
Alloa,35,3,17,9,10,57,44,13,60
Arbroath,35,4,17,8,11,72,52,20,59
Stranraer,35,5,15,5,16,57,67,-10,50
East Fife,35,6,14,3,19,50,66,-16,45
Airdrieon,35,7,10,12,14,45,58,-13,42
Forfar,35,8,10,6,20,38,64,-26,36
Queen's Park,35,9,7,10,19,43,74,-31,31
Albion,35,10,8,6,22,57,80,-23,30
Raith,36,1,23,8,5,71,33,38,77
Ayr,36,2,24,4,8,94,42,52,76
Arbroath,36,3,18,8,10,71,48,23,62
Alloa,36,4,17,8,11,57,46,11,59
Stranraer,36,5,15,5,16,55,66,-11,50
East Fife,36,6,14,3,19,49,64,-15,45
Airdrieon,36,7,11,11,14,46,58,-12,44
Forfar,36,8,10,5,21,38,65,-27,35
Albion,36,9,8,6,22,57,82,-25,30
Queen's Park,36,10,6,10,20,39,73,-34,28
Raith,37,1,23,8,5,71,33,38,77
Ayr,37,2,23,5,8,92,44,48,74
Arbroath,37,3,17,8,11,70,51,19,59
Alloa,37,4,17,8,11,57,46,11,59
Stranraer,37,5,15,5,16,55,66,-11,50
East Fife,37,6,14,3,19,49,64,-15,45
Airdrieon,37,7,10,11,15,46,60,-14,41
Forfar,37,8,11,5,20,40,65,-25,38
Albion,37,9,8,7,21,59,80,-21,31
Queen's Park,37,10,7,10,19,42,72,-30,31
Ayr,38,1,24,4,8,91,42,49,76
Raith,38,2,22,8,6,69,34,35,74
Alloa,38,3,18,8,10,58,44,14,62
Arbroath,38,4,17,9,10,71,49,22,60
Stranraer,38,5,16,5,15,58,64,-6,53
Airdrieon,38,6,10,12,14,46,59,-13,42
East Fife,38,7,13,3,20,47,67,-20,42
Forfar,38,8,10,6,20,39,65,-26,36
Albion,38,9,8,6,22,57,79,-22,30
Queen's Park,38,10,6,11,19,40,73,-33,29
Raith,39,1,23,8,5,69,32,37,77
Ayr,39,2,24,4,8,95,46,49,76
Arbroath,39,3,18,8,10,72,49,23,62
Alloa,39,4,17,8,11,56,44,12,59
Stranraer,39,5,16,5,15,59,65,-6,53
Airdrieon,39,6,11,11,14,46,58,-12,44
East Fife,39,7,13,3,20,48,68,-20,42
Forfar,39,8,10,5,21,38,65,-27,35
Albion,39,9,8,6,22,61,83,-22,30
Queen's Park,39,10,6,10,20,40,74,-34,28
Ayr,40,1,24,4,8,95,43,52,76
Raith,40,2,22,9,5,69,33,36,75
Alloa,40,3,17,9,10,57,44,13,60
Arbroath,40,4,17,8,11,71,52,19,59
Stranraer,40,5,15,5,16,56,66,-10,50
East Fife,40,6,14,3,19,49,65,-16,45
Airdrieon,40,7,11,11,14,49,61,-12,44
Forfar,40,8,10,5,21,41,68,-27,35
Queen's Park,40,9,7,10,19,43,73,-30,31
Albion,40,10,8,6,22,58,83,-25,30
Raith,41,1,23,8,5,69,32,37,77
Ayr,41,2,24,4,8,98,43,55,76
Arbroath,41,3,18,8,10,71,48,23,62
Alloa,41,4,17,8,11,56,44,12,59
Stranraer,41,5,15,5,16,56,67,-11,50
East Fife,41,6,14,3,19,50,65,-15,45
Airdrieon,41,7,10,12,14,47,60,-13,42
Forfar,41,8,10,6,20,40,66,-26,36
Albion,41,9,8,6,22,58,86,-28,30
Queen's Park,41,10,6,10,20,39,73,-34,28
Ayr,42,1,24,4,8,92,43,49,76
Raith,42,2,22,8,6,70,35,35,74
Arbroath,42,3,18,8,10,71,48,23,62
Alloa,42,4,18,8,10,59,45,14,62
Stranraer,42,5,15,6,15,56,65,-9,51
Airdrieon,42,6,11,11,14,49,58,-9,44
East Fife,42,7,13,4,19,48,65,-17,43
Forfar,42,8,10,5,21,38,68,-30,35
Albion,42,9,8,6,22,58,80,-22,30
Queen's Park,42,10,6,10,20,39,73,-34,28
Ayr,43,1,24,4,8,94,44,50,76
Raith,43,2,22,8,6,68,33,35,74
Alloa,43,3,18,8,10,57,43,14,62
Arbroath,43,4,17,8,11,71,50,21,59
Stranraer,43,5,15,5,16,56,66,-10,50
East Fife,43,6,14,3,19,49,65,-16,45
Airdrieon,43,7,10,11,15,46,62,-16,41
Forfar,43,8,11,5,20,42,65,-23,38
Queen's Park,43,9,7,10,19,41,73,-32,31
Albion,43,10,8,6,22,59,82,-23,30
Ayr,44,1,24,4,8,92,42,50,76
Raith,44,2,22,9,5,69,33,36,75
Alloa,44,3,17,9,10,57,44,13,60
Arbroath,44,4,17,8,11,71,51,20,59
Stranraer,44,5,15,5,16,55,65,-10,50
East Fife,44,6,14,3,19,48,64,-16,45
Airdrieon,44,7,11,11,14,47,59,-12,44
Forfar,44,8,10,5,21,39,66,-27,35
Queen's Park,44,9,7,10,19,42,73,-31,31
Albion,44,10,8,6,22,57,80,-23,30
Ayr,45,1,24,4,8,92,42,50,76
Raith,45,2,22,8,6,68,33,35,74
Alloa,45,3,18,8,10,57,43,14,62
Arbroath,45,4,17,8,11,71,51,20,59
Stranraer,45,5,15,6,15,56,65,-9,51
Airdrieon,45,6,11,11,14,46,58,-12,44
East Fife,45,7,13,4,19,48,65,-17,43
Forfar,45,8,10,5,21,38,65,-27,35
Queen's Park,45,9,7,10,19,42,73,-31,31
Albion,45,10,8,6,22,57,80,-23,30
Ayr,46,1,24,4,8,93,43,50,76
Raith,46,2,22,8,6,68,33,35,74
Arbroath,46,3,18,8,10,75,49,26,62
Alloa,46,4,18,8,10,57,43,14,62
Stranraer,46,5,15,5,16,55,69,-14,50
East Fife,46,6,14,3,19,52,64,-12,45
Airdrieon,46,7,11,11,14,48,60,-12,44
Forfar,46,8,10,5,21,40,67,-27,35
Albion,46,9,8,6,22,58,81,-23,30
Queen's Park,46,10,6,10,20,40,77,-37,28
Ayr,47,1,24,4,8,95,45,50,76
Raith,47,2,22,8,6,68,33,35,74
Arbroath,47,3,18,8,10,74,50,24,62
Alloa,47,4,18,8,10,57,43,14,62
Stranraer,47,5,15,6,15,55,64,-9,51
East Fife,47,6,13,4,19,47,64,-17,43
Airdrieon,47,7,10,11,15,46,61,-15,41
Forfar,47,8,11,5,20,41,65,-24,38
Albion,47,9,8,6,22,60,83,-23,30
Queen's Park,47,10,6,10,20,41,76,-35,28
Raith,48,1,23,8,5,71,34,37,77
Ayr,48,2,23,5,8,92,44,48,74
Arbroath,48,3,17,8,11,72,51,21,59
Alloa,48,4,17,8,11,58,46,12,59
Stranraer,48,5,16,5,15,59,66,-7,53
Airdrieon,48,6,10,12,14,45,58,-13,42
East Fife,48,7,13,3,20,49,68,-19,42
Forfar,48,8,10,6,20,38,64,-26,36
Albion,48,9,8,7,21,59,80,-21,31
Queen's Park,48,10,7,10,19,42,74,-32,31
Raith,49,1,23,8,5,69,32,37,77
Ayr,49,2,24,4,8,93,43,50,76
Arbroath,49,3,18,8,10,71,48,23,62
Alloa,49,4,17,8,11,56,44,12,59
Stranraer,49,5,15,6,15,58,67,-9,51
East Fife,49,6,13,4,19,50,67,-17,43
Airdrieon,49,7,10,12,14,48,61,-13,42
Forfar,49,8,10,6,20,41,67,-26,36
Albion,49,9,8,6,22,58,81,-23,30
Queen's Park,49,10,6,10,20,39,73,-34,28
Raith,50,1,23,8,5,70,32,38,77
Ayr,50,2,24,4,8,96,42,54,76
Arbroath,50,3,18,8,10,73,50,23,62
Alloa,50,4,17,8,11,56,45,11,59
Stranraer,50,5,15,5,16,57,69,-12,50
East Fife,50,6,14,3,19,52,66,-14,45
Airdrieon,50,7,10,12,14,46,59,-13,42
Forfar,50,8,10,6,20,39,65,-26,36
Albion,50,9,8,6,22,57,84,-27,30
Queen's Park,50,10,6,10,20,41,75,-34,28
Raith,51,1,23,8,5,72,35,37,77
Ayr,51,2,24,4,8,92,43,49,76
Arbroath,51,3,17,8,11,71,50,21,59
Alloa,51,4,17,8,11,59,47,12,59
Stranraer,51,5,15,5,16,55,68,-13,50
East Fife,51,6,14,3,19,51,64,-13,45
Airdrieon,51,7,11,11,14,46,58,-12,44
Forfar,51,8,10,5,21,38,65,-27,35
Queen's Park,51,9,7,10,19,41,73,-32,31
Albion,51,10,8,6,22,58,80,-22,30
Ayr,52,1,24,4,8,95,44,51,76
Raith,52,2,22,8,6,69,34,35,74
Arbroath,52,3,18,8,10,73,48,25,62
Alloa,52,4,18,8,10,58,44,14,62
Stranraer,52,5,15,5,16,55,67,-12,50
East Fife,52,6,14,3,19,50,64,-14,45
Airdrieon,52,7,10,11,15,47,61,-14,41
Forfar,52,8,11,5,20,41,66,-25,38
Albion,52,9,8,6,22,59,83,-24,30
Queen's Park,52,10,6,10,20,39,75,-36,28
Ayr,53,1,24,4,8,97,43,54,76
Raith,53,2,22,9,5,70,34,36,75
Arbroath,53,3,17,9,10,72,50,22,60
Alloa,53,4,17,9,10,58,45,13,60
Stranraer,53,5,15,5,16,55,66,-11,50
East Fife,53,6,14,3,19,49,64,-15,45
Airdrieon,53,7,10,12,14,47,60,-13,42
Forfar,53,8,10,6,20,40,66,-26,36
Albion,53,9,8,6,22,58,85,-27,30
Queen's Park,53,10,6,11,19,41,74,-33,29
Ayr,54,1,24,4,8,95,44,51,76
Raith,54,2,22,9,5,70,34,36,75
Arbroath,54,3,17,9,10,71,49,22,60
Alloa,54,4,17,9,10,58,45,13,60
Stranraer,54,5,15,6,15,57,66,-9,51
Airdrieon,54,6,11,11,14,49,59,-10,44
East Fife,54,7,13,4,19,49,66,-17,43
Forfar,54,8,10,5,21,39,68,-29,35
Albion,54,9,8,6,22,59,83,-24,30
Queen's Park,54,10,6,11,19,40,73,-33,29
Raith,55,1,23,8,5,70,33,37,77
Ayr,55,2,23,5,8,90,42,48,74
Arbroath,55,3,17,9,10,72,50,22,60
Alloa,55,4,17,8,11,57,45,12,59
Stranraer,55,5,16,5,15,58,65,-7,53
Airdrieon,55,6,10,12,14,46,59,-13,42
East Fife,55,7,13,3,20,48,67,-19,42
Forfar,55,8,10,6,20,39,65,-26,36
Albion,55,9,8,7,21,57,78,-21,31
Queen's Park,55,10,6,11,19,41,74,-33,29
Raith,56,1,23,8,5,71,33,38,77
Ayr,56,2,24,4,8,93,44,49,76
Arbroath,56,3,18,8,10,73,48,25,62
Alloa,56,4,17,8,11,57,46,11,59
Stranraer,56,5,16,5,15,57,65,-8,53
Airdrieon,56,6,11,11,14,46,58,-12,44
East Fife,56,7,13,3,20,48,66,-18,42
Forfar,56,8,10,5,21,38,65,-27,35
Albion,56,9,8,6,22,59,81,-22,30
Queen's Park,56,10,6,10,20,39,75,-36,28
Ayr,57,1,24,4,8,98,43,55,76
Raith,57,2,22,9,5,68,32,36,75
Arbroath,57,3,18,8,10,72,49,23,62
Alloa,57,4,17,9,10,56,43,13,60
Stranraer,57,5,15,6,15,56,65,-9,51
Airdrieon,57,6,11,11,14,48,58,-10,44
East Fife,57,7,13,4,19,48,65,-17,43
Forfar,57,8,10,5,21,38,67,-29,35
Albion,57,9,8,6,22,58,86,-28,30
Queen's Park,57,10,6,10,20,40,74,-34,28
Ayr,58,1,24,4,8,94,45,49,76
Raith,58,2,22,9,5,68,32,36,75
Arbroath,58,3,18,8,10,73,49,24,62
Alloa,58,4,17,9,10,56,43,13,60
Stranraer,58,5,15,6,15,56,65,-9,51
Airdrieon,58,6,11,11,14,47,58,-11,44
East Fife,58,7,13,4,19,48,65,-17,43
Forfar,58,8,10,5,21,38,66,-28,35
Albion,58,9,8,6,22,60,82,-22,30
Queen's Park,58,10,6,10,20,40,75,-35,28
Ayr,59,1,24,4,8,93,42,51,76
Raith,59,2,22,8,6,68,35,33,74
Alloa,59,3,18,8,10,59,43,16,62
Arbroath,59,4,17,8,11,71,50,21,59
Stranraer,59,5,15,5,16,56,66,-10,50
East Fife,59,6,14,3,19,49,65,-16,45
Airdrieon,59,7,10,11,15,47,61,-14,41
Forfar,59,8,11,5,20,41,66,-25,38
Queen's Park,59,9,7,10,19,41,73,-32,31
Albion,59,10,8,6,22,57,81,-24,30
Raith,60,1,23,8,5,69,32,37,77
Ayr,60,2,24,4,8,92,43,49,76
Arbroath,60,3,17,9,10,72,50,22,60
Alloa,60,4,17,8,11,56,44,12,59
Stranraer,60,5,15,5,16,55,66,-11,50
East Fife,60,6,14,3,19,49,64,-15,45
Airdrieon,60,7,10,12,14,45,58,-13,42
Forfar,60,8,10,6,20,38,64,-26,36
Albion,60,9,8,6,22,58,80,-22,30
Queen's Park,60,10,6,11,19,41,74,-33,29
Ayr,61,1,24,4,8,94,43,51,76
Raith,61,2,22,8,6,70,35,35,74
Alloa,61,3,18,8,10,59,45,14,62
Arbroath,61,4,17,8,11,70,49,21,59
Stranraer,61,5,15,5,16,58,68,-10,50
East Fife,61,6,14,3,19,51,67,-16,45
Airdrieon,61,7,10,11,15,47,62,-15,41
Forfar,61,8,11,5,20,42,66,-24,38
Queen's Park,61,9,7,10,19,40,72,-32,31
Albion,61,10,8,6,22,58,82,-24,30
Ayr,62,1,24,4,8,93,44,49,76
Raith,62,2,22,8,6,68,34,34,74
Alloa,62,3,18,8,10,58,43,15,62
Arbroath,62,4,17,9,10,70,48,22,60
Stranraer,62,5,15,6,15,57,66,-9,51
Airdrieon,62,6,11,11,14,49,59,-10,44
East Fife,62,7,13,4,19,49,66,-17,43
Forfar,62,8,10,5,21,39,68,-29,35
Albion,62,9,8,6,22,59,81,-22,30
Queen's Park,62,10,6,11,19,39,72,-33,29
Raith,63,1,23,8,5,74,32,42,77
Ayr,63,2,24,4,8,95,43,52,76
Arbroath,63,3,18,8,10,73,48,25,62
Alloa,63,4,17,8,11,56,49,7,59
Stranraer,63,5,15,5,16,55,66,-11,50
East Fife,63,6,14,3,19,49,64,-15,45
Airdrieon,63,7,11,11,14,46,58,-12,44
Forfar,63,8,10,5,21,38,65,-27,35
Albion,63,9,8,6,22,58,83,-25,30
Queen's Park,63,10,6,10,20,39,75,-36,28
Ayr,64,1,24,4,8,96,43,53,76
Raith,64,2,22,9,5,69,33,36,75
Alloa,64,3,17,9,10,57,44,13,60
Arbroath,64,4,17,8,11,70,49,21,59
Stranraer,64,5,15,5,16,55,65,-10,50
East Fife,64,6,14,3,19,48,64,-16,45
Airdrieon,64,7,11,11,14,48,58,-10,44
Forfar,64,8,10,5,21,38,67,-29,35
Queen's Park,64,9,7,10,19,40,72,-32,31
Albion,64,10,8,6,22,58,84,-26,30
Raith,65,1,23,8,5,71,32,39,77
Ayr,65,2,24,4,8,94,44,50,76
Arbroath,65,3,17,8,11,71,50,21,59
Alloa,65,4,17,8,11,56,46,10,59
Stranraer,65,5,15,5,16,55,67,-12,50
East Fife,65,6,14,3,19,50,64,-14,45
Airdrieon,65,7,11,11,14,50,59,-9,44
Forfar,65,8,10,5,21,39,69,-30,35
Queen's Park,65,9,7,10,19,41,73,-32,31
Albion,65,10,8,6,22,59,82,-23,30
Ayr,66,1,24,4,8,94,42,52,76
Raith,66,2,22,9,5,69,33,36,75
Arbroath,66,3,17,9,10,74,52,22,60
Alloa,66,4,17,9,10,57,44,13,60
Stranraer,66,5,15,5,16,55,67,-12,50
East Fife,66,6,14,3,19,50,64,-14,45
Airdrieon,66,7,10,12,14,46,59,-13,42
Forfar,66,8,10,6,20,39,65,-26,36
Albion,66,9,8,6,22,57,82,-25,30
Queen's Park,66,10,6,11,19,43,76,-33,29
Raith,67,1,22,9,5,68,32,36,75
Ayr,67,2,23,5,8,92,44,48,74
Arbroath,67,3,17,9,10,72,50,22,60
Alloa,67,4,17,9,10,56,43,13,60
Stranraer,67,5,15,5,16,56,67,-11,50
East Fife,67,6,14,3,19,50,65,-15,45
Airdrieon,67,7,11,11,14,46,58,-12,44
Forfar,67,8,10,5,21,38,65,-27,35
Albion,67,9,8,7,21,59,80,-21,31
Queen's Park,67,10,6,11,19,41,74,-33,29
Raith,68,1,22,8,6,68,35,33,74
Ayr,68,2,23,4,9,92,45,47,73
Alloa,68,3,18,8,10,59,43,16,62
Arbroath,68,4,17,8,11,71,50,21,59
Stranraer,68,5,15,5,16,56,67,-11,50
East Fife,68,6,14,3,19,50,65,-15,45
Airdrieon,68,7,10,11,15,45,61,-16,41
Forfar,68,8,11,5,20,41,64,-23,38
Albion,68,9,9,6,21,60,80,-20,33
Queen's Park,68,10,7,10,19,41,73,-32,31
Raith,69,1,23,8,5,70,33,37,77
Ayr,69,2,24,4,8,92,42,50,76
Arbroath,69,3,17,9,10,71,49,22,60
Alloa,69,4,17,8,11,57,45,12,59
Stranraer,69,5,15,5,16,55,67,-12,50
East Fife,69,6,14,3,19,50,64,-14,45
Airdrieon,69,7,10,11,15,46,60,-14,41
Forfar,69,8,11,5,20,40,65,-25,38
Albion,69,9,8,6,22,57,80,-23,30
Queen's Park,69,10,6,11,19,40,73,-33,29
Raith,70,1,23,8,5,76,33,43,77
Ayr,70,2,24,4,8,95,42,53,76
Arbroath,70,3,17,8,11,71,50,21,59
Alloa,70,4,17,8,11,57,51,6,59
Stranraer,70,5,16,5,15,56,64,-8,53
Airdrieon,70,6,10,12,14,48,61,-13,42
East Fife,70,7,13,3,20,47,65,-18,42
Forfar,70,8,10,6,20,41,67,-26,36
Queen's Park,70,9,7,10,19,41,73,-32,31
Albion,70,10,8,6,22,57,83,-26,30
Ayr,71,1,24,4,8,92,43,49,76
Raith,71,2,22,9,5,68,32,36,75
Arbroath,71,3,18,8,10,71,48,23,62
Alloa,71,4,17,9,10,56,43,13,60
Stranraer,71,5,16,5,15,57,65,-8,53
Airdrieon,71,6,10,12,14,46,59,-13,42
East Fife,71,7,13,3,20,48,66,-18,42
Forfar,71,8,10,6,20,39,65,-26,36
Albion,71,9,8,6,22,58,80,-22,30
Queen's Park,71,10,6,10,20,39,73,-34,28
Ayr,72,1,24,4,8,91,42,49,76
Raith,72,2,22,9,5,68,32,36,75
Alloa,72,3,17,9,10,56,43,13,60
Arbroath,72,4,17,8,11,71,50,21,59
Stranraer,72,5,15,6,15,58,67,-9,51
Airdrieon,72,6,11,11,14,48,59,-11,44
East Fife,72,7,13,4,19,50,67,-17,43
Forfar,72,8,10,5,21,39,67,-28,35
Queen's Park,72,9,7,10,19,41,73,-32,31
Albion,72,10,8,6,22,57,79,-22,30
Ayr,73,1,24,4,8,94,42,52,76
Raith,73,2,22,9,5,69,33,36,75
Alloa,73,3,17,9,10,57,44,13,60
Arbroath,73,4,17,8,11,70,49,21,59
Stranraer,73,5,16,5,15,57,65,-8,53
Airdrieon,73,6,11,11,14,49,59,-10,44
East Fife,73,7,13,3,20,48,66,-18,42
Forfar,73,8,10,5,21,39,68,-29,35
Queen's Park,73,9,7,10,19,40,72,-32,31
Albion,73,10,8,6,22,57,82,-25,30
Raith,74,1,23,8,5,69,32,37,77
Ayr,74,2,24,4,8,94,43,51,76
Arbroath,74,3,17,8,11,72,52,20,59
Alloa,74,4,17,8,11,56,44,12,59
Stranraer,74,5,15,6,15,57,66,-9,51
East Fife,74,6,13,4,19,49,66,-17,43
Airdrieon,74,7,10,11,15,45,60,-15,41
Forfar,74,8,11,5,20,40,64,-24,38
Queen's Park,74,9,7,10,19,43,74,-31,31
Albion,74,10,8,6,22,58,82,-24,30
Raith,75,1,23,8,5,70,32,38,77
Ayr,75,2,24,4,8,94,43,51,76
Arbroath,75,3,17,9,10,72,50,22,60
Alloa,75,4,17,8,11,56,45,11,59
Stranraer,75,5,16,5,15,57,64,-7,53
Airdrieon,75,6,11,11,14,48,58,-10,44
East Fife,75,7,13,3,20,47,66,-19,42
Forfar,75,8,10,5,21,38,67,-29,35
Albion,75,9,8,6,22,58,82,-24,30
Queen's Park,75,10,6,11,19,41,74,-33,29
Raith,76,1,23,8,5,69,32,37,77
Ayr,76,2,23,5,8,91,43,48,74
Arbroath,76,3,18,8,10,73,49,24,62
Alloa,76,4,17,8,11,56,44,12,59
Stranraer,76,5,16,5,15,58,66,-8,53
East Fife,76,6,13,3,20,49,67,-18,42
Airdrieon,76,7,10,11,15,46,62,-16,41
Forfar,76,8,11,5,20,42,65,-23,38
Albion,76,9,8,7,21,58,79,-21,31
Queen's Park,76,10,6,10,20,40,75,-35,28
Raith,77,1,23,8,5,71,32,39,77
Ayr,77,2,24,4,8,96,44,52,76
Arbroath,77,3,17,8,11,71,51,20,59
Alloa,77,4,17,8,11,56,46,10,59
Stranraer,77,5,16,5,15,57,64,-7,53
Airdrieon,77,6,10,12,14,47,60,-13,42
East Fife,77,7,13,3,20,47,66,-19,42
Forfar,77,8,10,6,20,40,66,-26,36
Queen's Park,77,9,7,10,19,42,73,-31,31
Albion,77,10,8,6,22,59,84,-25,30
Ayr,78,1,24,4,8,92,43,49,76
Raith,78,2,22,9,5,69,33,36,75
Arbroath,78,3,18,8,10,72,49,23,62
Alloa,78,4,17,9,10,57,44,13,60
Stranraer,78,5,15,5,16,56,66,-10,50
East Fife,78,6,14,3,19,49,65,-16,45
Airdrieon,78,7,11,11,14,49,58,-9,44
Forfar,78,8,10,5,21,38,68,-30,35
Albion,78,9,8,6,22,58,80,-22,30
Queen's Park,78,10,6,10,20,40,74,-34,28
Raith,79,1,23,8,5,71,32,39,77
Ayr,79,2,24,4,8,93,42,51,76
Arbroath,79,3,18,8,10,72,49,23,62
Alloa,79,4,17,8,11,56,46,10,59
Stranraer,79,5,15,6,15,57,66,-9,51
Airdrieon,79,6,11,11,14,46,58,-12,44
East Fife,79,7,13,4,19,49,66,-17,43
Forfar,79,8,10,5,21,38,65,-27,35
Albion,79,9,8,6,22,57,81,-24,30
Queen's Park,79,10,6,10,20,40,74,-34,28
Ayr,80,1,24,4,8,93,43,50,76
Raith,80,2,22,9,5,69,33,36,75
Arbroath,80,3,17,9,10,72,50,22,60
Alloa,80,4,17,9,10,57,44,13,60
Stranraer,80,5,15,6,15,57,66,-9,51
East Fife,80,6,13,4,19,49,66,-17,43
Airdrieon,80,7,10,12,14,45,58,-13,42
Forfar,80,8,10,6,20,38,64,-26,36
Albion,80,9,8,6,22,58,81,-23,30
Queen's Park,80,10,6,11,19,41,74,-33,29
Raith,81,1,23,8,5,71,32,39,77
Ayr,81,2,23,5,8,94,46,48,74
Arbroath,81,3,17,8,11,70,49,21,59
Alloa,81,4,17,8,11,56,46,10,59
Stranraer,81,5,15,5,16,55,66,-11,50
East Fife,81,6,14,3,19,49,64,-15,45
Airdrieon,81,7,10,12,14,46,59,-13,42
Forfar,81,8,10,6,20,39,65,-26,36
Albion,81,9,8,7,21,61,82,-21,31
Queen's Park,81,10,7,10,19,40,72,-32,31
Ayr,82,1,24,4,8,93,43,50,76
Raith,82,2,22,9,5,68,32,36,75
Arbroath,82,3,18,8,10,75,49,26,62
Alloa,82,4,17,9,10,56,43,13,60
Stranraer,82,5,15,5,16,56,66,-10,50
East Fife,82,6,14,3,19,49,65,-16,45
Airdrieon,82,7,11,11,14,48,58,-10,44
Forfar,82,8,10,5,21,38,67,-29,35
Albion,82,9,8,6,22,58,81,-23,30
Queen's Park,82,10,6,10,20,40,77,-37,28
Raith,83,1,22,9,5,70,34,36,75
Ayr,83,2,23,5,8,92,44,48,74
Arbroath,83,3,18,8,10,74,49,25,62
Alloa,83,4,17,9,10,58,45,13,60
Stranraer,83,5,15,5,16,57,67,-10,50
East Fife,83,6,14,3,19,50,66,-16,45
Airdrieon,83,7,11,11,14,46,58,-12,44
Forfar,83,8,10,5,21,38,65,-27,35
Albion,83,9,8,7,21,59,80,-21,31
Queen's Park,83,10,6,10,20,40,76,-36,28
Ayr,84,1,24,4,8,97,44,53,76
Raith,84,2,22,9,5,69,33,36,75
Arbroath,84,3,18,8,10,72,48,24,62
Alloa,84,4,17,9,10,57,44,13,60
Stranraer,84,5,15,5,16,55,65,-10,50
East Fife,84,6,14,3,19,48,64,-16,45
Airdrieon,84,7,11,11,14,48,59,-11,44
Forfar,84,8,10,5,21,39,67,-28,35
Albion,84,9,8,6,22,59,85,-26,30
Queen's Park,84,10,6,10,20,39,74,-35,28
Raith,85,1,23,8,5,71,32,39,77
Ayr,85,2,24,4,8,93,43,50,76
Arbroath,85,3,17,9,10,72,50,22,60
Alloa,85,4,17,8,11,56,46,10,59
Stranraer,85,5,16,5,15,57,64,-7,53
Airdrieon,85,6,11,11,14,46,58,-12,44
East Fife,85,7,13,3,20,47,66,-19,42
Forfar,85,8,10,5,21,38,65,-27,35
Albion,85,9,8,6,22,58,81,-23,30
Queen's Park,85,10,6,11,19,41,74,-33,29
Raith,86,1,23,8,5,70,32,38,77
Ayr,86,2,24,4,8,94,42,52,76
Arbroath,86,3,17,8,11,72,51,21,59
Alloa,86,4,17,8,11,56,45,11,59
Stranraer,86,5,15,6,15,57,66,-9,51
East Fife,86,6,13,4,19,49,66,-17,43
Airdrieon,86,7,10,12,14,46,59,-13,42
Forfar,86,8,10,6,20,39,65,-26,36
Queen's Park,86,9,7,10,19,42,74,-32,31
Albion,86,10,8,6,22,57,82,-25,30
Ayr,87,1,24,4,8,94,43,51,76
Raith,87,2,22,9,5,70,34,36,75
Arbroath,87,3,18,8,10,71,48,23,62
Alloa,87,4,17,9,10,58,45,13,60
Stranraer,87,5,15,6,15,56,65,-9,51
Airdrieon,87,6,11,11,14,46,58,-12,44
East Fife,87,7,13,4,19,48,65,-17,43
Forfar,87,8,10,5,21,38,65,-27,35
Albion,87,9,8,6,22,58,82,-24,30
Queen's Park,87,10,6,10,20,39,73,-34,28
Raith,88,1,23,8,5,70,33,37,77
Ayr,88,2,24,4,8,96,43,53,76
Arbroath,88,3,17,8,11,72,56,16,59
Alloa,88,4,17,8,11,57,45,12,59
Stranraer,88,5,15,5,16,56,71,-15,50
East Fife,88,6,14,3,19,54,65,-11,45
Airdrieon,88,7,10,12,14,47,60,-13,42
Forfar,88,8,10,6,20,40,66,-26,36
Queen's Park,88,9,7,10,19,47,74,-27,31
Albion,88,10,8,6,22,58,84,-26,30
Raith,89,1,23,8,5,70,32,38,77
Ayr,89,2,24,4,8,92,43,49,76
Arbroath,89,3,18,8,10,74,49,25,62
Alloa,89,4,17,8,11,56,45,11,59
Stranraer,89,5,15,5,16,55,65,-10,50
East Fife,89,6,14,3,19,48,64,-16,45
Airdrieon,89,7,11,11,14,48,59,-11,44
Forfar,89,8,10,5,21,39,67,-28,35
Albion,89,9,8,6,22,58,80,-22,30
Queen's Park,89,10,6,10,20,40,76,-36,28
Raith,90,1,23,8,5,70,33,37,77
Ayr,90,2,24,4,8,93,43,50,76
Arbroath,90,3,18,8,10,74,49,25,62
Alloa,90,4,17,8,11,57,45,12,59
Stranraer,90,5,15,6,15,57,66,-9,51
East Fife,90,6,13,4,19,49,66,-17,43
Airdrieon,90,7,10,12,14,46,59,-13,42
Forfar,90,8,10,6,20,39,65,-26,36
Albion,90,9,8,6,22,58,81,-23,30
Queen's Park,90,10,6,10,20,40,76,-36,28
Raith,91,1,23,8,5,71,32,39,77
Ayr,91,2,23,4,9,91,45,46,73
Arbroath,91,3,17,9,10,71,49,22,60
Alloa,91,4,17,8,11,56,46,10,59
Stranraer,91,5,15,6,15,55,64,-9,51
East Fife,91,6,13,4,19,47,64,-17,43
Airdrieon,91,7,10,12,14,46,59,-13,42
Forfar,91,8,10,6,20,39,65,-26,36
Albion,91,9,9,6,21,60,79,-19,33
Queen's Park,91,10,6,11,19,40,73,-33,29
Ayr,92,1,24,4,8,93,43,50,76
Raith,92,2,22,8,6,68,33,35,74
Alloa,92,3,18,8,10,57,43,14,62
Arbroath,92,4,17,8,11,71,50,21,59
Stranraer,92,5,15,5,16,55,67,-12,50
East Fife,92,6,14,3,19,50,64,-14,45
Airdrieon,92,7,10,11,15,45,59,-14,41
Forfar,92,8,11,5,20,39,64,-25,38
Queen's Park,92,9,7,10,19,41,73,-32,31
Albion,92,10,8,6,22,58,81,-23,30
Raith,93,1,23,8,5,70,33,37,77
Ayr,93,2,23,5,8,91,43,48,74
Arbroath,93,3,17,9,10,70,48,22,60
Alloa,93,4,17,8,11,57,45,12,59
Stranraer,93,5,15,6,15,58,67,-9,51
Airdrieon,93,6,11,11,14,47,58,-11,44
East Fife,93,7,13,4,19,50,67,-17,43
Forfar,93,8,10,5,21,38,66,-28,35
Albion,93,9,8,7,21,58,79,-21,31
Queen's Park,93,10,6,11,19,39,72,-33,29
Ayr,94,1,24,4,8,95,43,52,76
Raith,94,2,22,9,5,68,32,36,75
Arbroath,94,3,18,8,10,73,50,23,62
Alloa,94,4,17,9,10,56,43,13,60
Stranraer,94,5,16,5,15,57,64,-7,53
Airdrieon,94,6,10,12,14,47,60,-13,42
East Fife,94,7,13,3,20,47,66,-19,42
Forfar,94,8,10,6,20,40,66,-26,36
Albion,94,9,8,6,22,58,83,-25,30
Queen's Park,94,10,6,10,20,41,75,-34,28
Raith,95,1,23,8,5,71,32,39,77
Ayr,95,2,24,4,8,92,43,49,76
Arbroath,95,3,17,8,11,73,52,21,59
Alloa,95,4,17,8,11,56,46,10,59
Stranraer,95,5,15,5,16,56,66,-10,50
East Fife,95,6,14,3,19,49,65,-16,45
Airdrieon,95,7,10,11,15,46,61,-15,41
Forfar,95,8,11,5,20,41,65,-24,38
Queen's Park,95,9,7,10,19,43,75,-32,31
Albion,95,10,8,6,22,58,80,-22,30
Ayr,96,1,24,4,8,95,45,50,76
Raith,96,2,22,8,6,69,35,34,74
Arbroath,96,3,18,8,10,72,49,23,62
Alloa,96,4,18,8,10,59,44,15,62
Stranraer,96,5,15,5,16,55,65,-10,50
East Fife,96,6,14,3,19,48,64,-16,45
Airdrieon,96,7,11,11,14,47,59,-12,44
Forfar,96,8,10,5,21,39,66,-27,35
Albion,96,9,8,6,22,60,83,-23,30
Queen's Park,96,10,6,10,20,40,74,-34,28
Raith,97,1,23,8,5,72,33,39,77
Ayr,97,2,23,5,8,91,43,48,74
Arbroath,97,3,17,8,11,70,49,21,59
Alloa,97,4,17,8,11,57,47,10,59
Stranraer,97,5,15,5,16,55,65,-10,50
East Fife,97,6,14,3,19,48,64,-16,45
Airdrieon,97,7,11,11,14,48,58,-10,44
Forfar,97,8,10,5,21,38,67,-29,35
Albion,97,9,8,7,21,58,79,-21,31
Queen's Park,97,10,7,10,19,40,72,-32,31
Ayr,98,1,24,4,8,96,43,53,76
Raith,98,2,22,9,5,69,33,36,75
Alloa,98,3,17,9,10,57,44,13,60
Arbroath,98,4,17,8,11,70,50,20,59
Stranraer,98,5,15,5,16,55,65,-10,50
East Fife,98,6,14,3,19,48,64,-16,45
Airdrieon,98,7,10,11,15,46,61,-15,41
Forfar,98,8,11,5,20,41,65,-24,38
Queen's Park,98,9,7,10,19,41,72,-31,31
Albion,98,10,8,6,22,58,84,-26,30
Raith,99,1,23,8,5,69,32,37,77
Ayr,99,2,23,4,9,93,46,47,73
Arbroath,99,3,18,8,10,71,48,23,62
Alloa,99,4,17,8,11,56,44,12,59
Stranraer,99,5,16,5,15,58,66,-8,53
Airdrieon,99,6,11,11,14,47,59,-12,44
East Fife,99,7,13,3,20,49,67,-18,42
Forfar,99,8,10,5,21,39,66,-27,35
Albion,99,9,9,6,21,61,81,-20,33
Queen's Park,99,10,6,10,20,39,73,-34,28
Raith,100,1,23,8,5,69,32,37,77
Ayr,100,2,24,4,8,94,44,50,76
Arbroath,100,3,18,8,10,72,48,24,62
Alloa,100,4,17,8,11,56,44,12,59
Stranraer,100,5,15,5,16,55,66,-11,50
East Fife,100,6,14,3,19,49,64,-15,45
Airdrieon,100,7,11,11,14,46,58,-12,44
Forfar,100,8,10,5,21,38,65,-27,35
Albion,100,9,8,6,22,59,82,-23,30
Queen's Park,100,10,6,10,20,39,74,-35,28
Raith,101,1,22,9,5,69,33,36,75
Ayr,101,2,23,4,9,91,45,46,73
Arbroath,101,3,18,8,10,72,49,23,62
Alloa,101,4,17,9,10,57,44,13,60
Stranraer,101,5,16,5,15,56,64,-8,53
Airdrieon,101,6,11,11,14,46,58,-12,44
East Fife,101,7,13,3,20,47,65,-18,42
Forfar,101,8,10,5,21,38,65,-27,35
Albion,101,9,9,6,21,60,79,-19,33
Queen's Park,101,10,6,10,20,40,74,-34,28
Raith,102,1,23,8,5,71,33,38,77
Ayr,102,2,23,5,8,93,45,48,74
Arbroath,102,3,18,8,10,72,49,23,62
Alloa,102,4,17,8,11,57,46,11,59
Stranraer,102,5,15,6,15,57,66,-9,51
Airdrieon,102,6,11,11,14,49,61,-12,44
East Fife,102,7,13,4,19,49,66,-17,43
Forfar,102,8,10,5,21,41,68,-27,35
Albion,102,9,8,7,21,60,81,-21,31
Queen's Park,102,10,6,10,20,40,74,-34,28
Ayr,103,1,23,5,8,92,44,48,74
Raith,103,2,22,8,6,69,35,34,74
Alloa,103,3,18,8,10,59,44,15,62
Arbroath,103,4,17,9,10,71,49,22,60
Stranraer,103,5,15,6,15,56,65,-9,51
East Fife,103,6,13,4,19,48,65,-17,43
Airdrieon,103,7,10,12,14,46,59,-13,42
Forfar,103,8,10,6,20,39,65,-26,36
Albion,103,9,8,7,21,59,80,-21,31
Queen's Park,103,10,6,11,19,40,73,-33,29
Raith,104,1,23,8,5,70,32,38,77
Ayr,104,2,24,4,8,93,43,50,76
Arbroath,104,3,17,9,10,72,50,22,60
Alloa,104,4,17,8,11,56,45,11,59
Stranraer,104,5,15,5,16,55,67,-12,50
East Fife,104,6,14,3,19,50,64,-14,45
Airdrieon,104,7,11,11,14,47,58,-11,44
Forfar,104,8,10,5,21,38,66,-28,35
Albion,104,9,8,6,22,58,81,-23,30
Queen's Park,104,10,6,11,19,41,74,-33,29
Ayr,105,1,24,4,8,93,42,51,76
Raith,105,2,22,9,5,69,33,36,75
Arbroath,105,3,17,9,10,71,49,22,60
Alloa,105,4,17,9,10,57,44,13,60
Stranraer,105,5,15,6,15,57,66,-9,51
Airdrieon,105,6,11,11,14,47,58,-11,44
East Fife,105,7,13,4,19,49,66,-17,43
Forfar,105,8,10,5,21,38,66,-28,35
Albion,105,9,8,6,22,57,81,-24,30
Queen's Park,105,10,6,11,19,40,73,-33,29
Ayr,106,1,24,4,8,97,42,55,76
Raith,106,2,22,8,6,69,36,33,74
Arbroath,106,3,18,8,10,72,49,23,62
Alloa,106,4,18,8,10,60,44,16,62
Stranraer,106,5,15,6,15,56,65,-9,51
East Fife,106,6,13,4,19,48,65,-17,43
Airdrieon,106,7,10,11,15,46,61,-15,41
Forfar,106,8,11,5,20,41,65,-24,38
Albion,106,9,8,6,22,57,85,-28,30
Queen's Park,106,10,6,10,20,40,74,-34,28
Raith,107,1,23,8,5,70,33,37,77
Ayr,107,2,24,4,8,91,42,49,76
Arbroath,107,3,18,8,10,73,50,23,62
Alloa,107,4,17,8,11,57,45,12,59
Stranraer,107,5,15,5,16,56,68,-12,50
East Fife,107,6,14,3,19,51,65,-14,45
Airdrieon,107,7,10,12,14,45,58,-13,42
Forfar,107,8,10,6,20,38,64,-26,36
Albion,107,9,8,6,22,57,79,-22,30
Queen's Park,107,10,6,10,20,41,75,-34,28
Raith,108,1,23,8,5,70,32,38,77
Ayr,108,2,24,4,8,93,42,51,76
Arbroath,108,3,17,8,11,72,52,20,59
Alloa,108,4,17,8,11,56,45,11,59
Stranraer,108,5,15,6,15,56,65,-9,51
Airdrieon,108,6,11,11,14,48,58,-10,44
East Fife,108,7,13,4,19,48,65,-17,43
Forfar,108,8,10,5,21,38,67,-29,35
Queen's Park,108,9,7,10,19,43,74,-31,31
Albion,108,10,8,6,22,57,81,-24,30
Raith,109,1,23,8,5,69,32,37,77
Ayr,109,2,24,4,8,97,42,55,76
Arbroath,109,3,18,8,10,73,50,23,62
Alloa,109,4,17,8,11,56,44,12,59
Stranraer,109,5,16,5,15,59,66,-7,53
East Fife,109,6,13,3,20,49,68,-19,42
Airdrieon,109,7,10,11,15,47,61,-14,41
Forfar,109,8,11,5,20,41,66,-25,38
Albion,109,9,8,6,22,57,85,-28,30
Queen's Park,109,10,6,10,20,41,75,-34,28
Raith,110,1,22,9,5,69,33,36,75
Ayr,110,2,23,4,9,90,45,45,73
Arbroath,110,3,17,9,10,73,51,22,60
Alloa,110,4,17,9,10,57,44,13,60
Stranraer,110,5,15,5,16,56,66,-10,50
East Fife,110,6,14,3,19,49,65,-16,45
Airdrieon,110,7,10,11,15,46,60,-14,41
Forfar,110,8,11,5,20,40,65,-25,38
Albion,110,9,9,6,21,60,78,-18,33
Queen's Park,110,10,6,11,19,42,75,-33,29
Raith,111,1,23,8,5,69,32,37,77
Ayr,111,2,23,5,8,92,44,48,74
Arbroath,111,3,17,8,11,70,49,21,59
Alloa,111,4,17,8,11,56,44,12,59
Stranraer,111,5,15,5,16,56,68,-12,50
East Fife,111,6,14,3,19,51,65,-14,45
Airdrieon,111,7,10,12,14,47,60,-13,42
Forfar,111,8,10,6,20,40,66,-26,36
Albion,111,9,8,7,21,59,80,-21,31
Queen's Park,111,10,7,10,19,40,72,-32,31
Raith,112,1,23,8,5,70,33,37,77
Ayr,112,2,24,4,8,94,42,52,76
Arbroath,112,3,17,8,11,70,49,21,59
Alloa,112,4,17,8,11,57,45,12,59
Stranraer,112,5,15,5,16,56,68,-12,50
East Fife,112,6,14,3,19,51,65,-14,45
Airdrieon,112,7,11,11,14,47,59,-12,44
Forfar,112,8,10,5,21,39,66,-27,35
Queen's Park,112,9,7,10,19,40,72,-32,31
Albion,112,10,8,6,22,57,82,-25,30
Raith,113,1,22,8,6,69,34,35,74
Ayr,113,2,23,4,9,90,43,47,73
Arbroath,113,3,18,8,10,74,50,24,62
Alloa,113,4,18,8,10,58,44,14,62
Stranraer,113,5,16,5,15,58,64,-6,53
Airdrieon,113,6,11,11,14,47,59,-12,44
East Fife,113,7,13,3,20,47,67,-20,42
Forfar,113,8,10,5,21,39,66,-27,35
Albion,113,9,9,6,21,58,78,-20,33
Queen's Park,113,10,6,10,20,41,76,-35,28
Raith,114,1,23,8,5,69,32,37,77
Ayr,114,2,23,5,8,91,43,48,74
Arbroath,114,3,18,8,10,73,50,23,62
Alloa,114,4,17,8,11,56,44,12,59
Stranraer,114,5,16,5,15,57,65,-8,53
Airdrieon,114,6,11,11,14,51,58,-7,44
East Fife,114,7,13,3,20,48,66,-18,42
Forfar,114,8,10,5,21,38,70,-32,35
Albion,114,9,8,7,21,58,79,-21,31
Queen's Park,114,10,6,10,20,41,75,-34,28
Raith,115,1,23,8,5,71,33,38,77
Ayr,115,2,24,4,8,94,44,50,76
Arbroath,115,3,18,8,10,73,49,24,62
Alloa,115,4,17,8,11,57,46,11,59
Stranraer,115,5,15,5,16,57,68,-11,50
East Fife,115,6,14,3,19,51,66,-15,45
Airdrieon,115,7,10,11,15,45,59,-14,41
Forfar,115,8,11,5,20,39,64,-25,38
Albion,115,9,8,6,22,59,82,-23,30
Queen's Park,115,10,6,10,20,40,75,-35,28
Ayr,116,1,24,4,8,92,43,49,76
Raith,116,2,22,8,6,69,36,33,74
Arbroath,116,3,18,8,10,73,49,24,62
Alloa,116,4,18,8,10,60,44,16,62
Stranraer,116,5,16,5,15,58,64,-6,53
Airdrieon,116,6,11,11,14,47,59,-12,44
East Fife,116,7,13,3,20,47,67,-20,42
Forfar,116,8,10,5,21,39,66,-27,35
Albion,116,9,8,6,22,58,80,-22,30
Queen's Park,116,10,6,10,20,40,75,-35,28
Raith,117,1,23,8,5,70,32,38,77
Ayr,117,2,23,5,8,93,45,48,74
Arbroath,117,3,18,8,10,73,49,24,62
Alloa,117,4,17,8,11,56,45,11,59
Stranraer,117,5,15,6,15,57,66,-9,51
Airdrieon,117,6,11,11,14,46,58,-12,44
East Fife,117,7,13,4,19,49,66,-17,43
Forfar,117,8,10,5,21,38,65,-27,35
Albion,117,9,8,7,21,60,81,-21,31
Queen's Park,117,10,6,10,20,40,75,-35,28
Raith,118,1,23,8,5,70,33,37,77
Ayr,118,2,24,4,8,95,44,51,76
Arbroath,118,3,17,9,10,72,50,22,60
Alloa,118,4,17,8,11,57,45,12,59
Stranraer,118,5,16,5,15,57,65,-8,53
Airdrieon,118,6,11,11,14,48,59,-11,44
East Fife,118,7,13,3,20,48,66,-18,42
Forfar,118,8,10,5,21,39,67,-28,35
Albion,118,9,8,6,22,59,83,-24,30
Queen's Park,118,10,6,11,19,41,74,-33,29
Ayr,119,1,24,4,8,92,42,50,76
Raith,119,2,22,8,6,68,34,34,74
Alloa,119,3,18,8,10,58,43,15,62
Arbroath,119,4,17,8,11,70,49,21,59
Stranraer,119,5,16,5,15,58,66,-8,53
Airdrieon,119,6,10,12,14,46,59,-13,42
East Fife,119,7,13,3,20,49,67,-18,42
Forfar,119,8,10,6,20,39,65,-26,36
Queen's Park,119,9,7,10,19,40,72,-32,31
Albion,119,10,8,6,22,57,80,-23,30
Raith,120,1,23,8,5,71,32,39,77
Ayr,120,2,24,4,8,93,44,49,76
Arbroath,120,3,18,8,10,72,48,24,62
Alloa,120,4,17,8,11,56,46,10,59
Stranraer,120,5,16,5,15,56,64,-8,53
Airdrieon,120,6,11,11,14,46,58,-12,44
East Fife,120,7,13,3,20,47,65,-18,42
Forfar,120,8,10,5,21,38,65,-27,35
Albion,120,9,8,6,22,59,81,-22,30
Queen's Park,120,10,6,10,20,39,74,-35,28
Ayr,121,1,24,4,8,93,43,50,76
Raith,121,2,22,8,6,69,36,33,74
Alloa,121,3,18,8,10,60,44,16,62
Arbroath,121,4,17,8,11,70,50,20,59
Stranraer,121,5,16,5,15,58,65,-7,53
Airdrieon,121,6,11,11,14,47,58,-11,44
East Fife,121,7,13,3,20,48,67,-19,42
Forfar,121,8,10,5,21,38,66,-28,35
Queen's Park,121,9,7,10,19,41,72,-31,31
Albion,121,10,8,6,22,58,81,-23,30
Ayr,122,1,24,4,8,92,43,49,76
Raith,122,2,22,8,6,68,33,35,74
Arbroath,122,3,18,8,10,72,48,24,62
Alloa,122,4,18,8,10,57,43,14,62
Stranraer,122,5,15,5,16,56,70,-14,50
East Fife,122,6,14,3,19,53,65,-12,45
Airdrieon,122,7,10,11,15,47,61,-14,41
Forfar,122,8,11,5,20,41,66,-25,38
Albion,122,9,8,6,22,58,80,-22,30
Queen's Park,122,10,6,10,20,39,74,-35,28
Raith,123,1,23,8,5,73,33,40,77
Ayr,123,2,24,4,8,96,42,54,76
Arbroath,123,3,17,8,11,71,50,21,59
Alloa,123,4,17,8,11,57,48,9,59
Stranraer,123,5,15,5,16,55,65,-10,50
East Fife,123,6,14,3,19,48,64,-16,45
Airdrieon,123,7,10,11,15,46,62,-16,41
Forfar,123,8,11,5,20,42,65,-23,38
Queen's Park,123,9,7,10,19,41,73,-32,31
Albion,123,10,8,6,22,57,84,-27,30
Ayr,124,1,24,4,8,91,42,49,76
Raith,124,2,22,8,6,68,33,35,74
Arbroath,124,3,18,8,10,73,49,24,62
Alloa,124,4,18,8,10,57,43,14,62
Stranraer,124,5,15,6,15,56,65,-9,51
East Fife,124,6,13,4,19,48,65,-17,43
Airdrieon,124,7,10,11,15,45,59,-14,41
Forfar,124,8,11,5,20,39,64,-25,38
Albion,124,9,8,6,22,57,79,-22,30
Queen's Park,124,10,6,10,20,40,75,-35,28
Ayr,125,1,24,4,8,93,43,50,76
Raith,125,2,22,9,5,69,33,36,75
Arbroath,125,3,18,8,10,73,49,24,62
Alloa,125,4,17,9,10,57,44,13,60
Stranraer,125,5,15,5,16,56,67,-11,50
East Fife,125,6,14,3,19,50,65,-15,45
Airdrieon,125,7,10,11,15,46,60,-14,41
Forfar,125,8,11,5,20,40,65,-25,38
Albion,125,9,8,6,22,58,81,-23,30
Queen's Park,125,10,6,10,20,40,75,-35,28
Ayr,126,1,23,5,8,92,44,48,74
Raith,126,2,22,8,6,68,33,35,74
Alloa,126,3,18,8,10,57,43,14,62
Arbroath,126,4,17,9,10,71,49,22,60
Stranraer,126,5,16,5,15,57,65,-8,53
Airdrieon,126,6,10,12,14,45,58,-13,42
East Fife,126,7,13,3,20,48,66,-18,42
Forfar,126,8,10,6,20,38,64,-26,36
Albion,126,9,8,7,21,59,80,-21,31
Queen's Park,126,10,6,11,19,40,73,-33,29
Ayr,127,1,24,4,8,93,42,51,76
Raith,127,2,22,9,5,69,33,36,75
Arbroath,127,3,18,8,10,73,50,23,62
Alloa,127,4,17,9,10,57,44,13,60
Stranraer,127,5,15,5,16,57,68,-11,50
East Fife,127,6,14,3,19,51,66,-15,45
Airdrieon,127,7,11,11,14,48,59,-11,44
Forfar,127,8,10,5,21,39,67,-28,35
Albion,127,9,8,6,22,57,81,-24,30
Queen's Park,127,10,6,10,20,41,75,-34,28
Raith,128,1,23,8,5,70,33,37,77
Ayr,128,2,24,4,8,94,44,50,76
Arbroath,128,3,18,8,10,73,50,23,62
Alloa,128,4,17,8,11,57,45,12,59
Stranraer,128,5,16,5,15,57,64,-7,53
Airdrieon,128,6,10,12,14,46,59,-13,42
East Fife,128,7,13,3,20,47,66,-19,42
Forfar,128,8,10,6,20,39,65,-26,36
Albion,128,9,8,6,22,59,82,-23,30
Queen's Park,128,10,6,10,20,41,75,-34,28
Ayr,129,1,24,4,8,93,43,50,76
Raith,129,2,22,8,6,69,35,34,74
Alloa,129,3,18,8,10,59,44,15,62
Arbroath,129,4,17,9,10,72,50,22,60
Stranraer,129,5,15,5,16,55,65,-10,50
East Fife,129,6,14,3,19,48,64,-16,45
Airdrieon,129,7,10,12,14,46,59,-13,42
Forfar,129,8,10,6,20,39,65,-26,36
Albion,129,9,8,6,22,58,81,-23,30
Queen's Park,129,10,6,11,19,41,74,-33,29
Raith,130,1,23,8,5,70,32,38,77
Ayr,130,2,24,4,8,92,42,50,76
Arbroath,130,3,18,8,10,72,49,23,62
Alloa,130,4,17,8,11,56,45,11,59
Stranraer,130,5,15,6,15,57,66,-9,51
Airdrieon,130,6,11,11,14,49,58,-9,44
East Fife,130,7,13,4,19,49,66,-17,43
Forfar,130,8,10,5,21,38,68,-30,35
Albion,130,9,8,6,22,57,80,-23,30
Queen's Park,130,10,6,10,20,40,74,-34,28
Raith,131,1,23,8,5,69,32,37,77
Ayr,131,2,24,4,8,96,43,53,76
Arbroath,131,3,18,8,10,72,49,23,62
Alloa,131,4,17,8,11,56,44,12,59
Stranraer,131,5,15,5,16,55,66,-11,50
East Fife,131,6,14,3,19,49,64,-15,45
Airdrieon,131,7,11,11,14,47,59,-12,44
Forfar,131,8,10,5,21,39,66,-27,35
Albion,131,9,8,6,22,58,84,-26,30
Queen's Park,131,10,6,10,20,40,74,-34,28
Ayr,132,1,24,4,8,92,42,50,76
Raith,132,2,22,9,5,69,33,36,75
Arbroath,132,3,18,8,10,72,49,23,62
Alloa,132,4,17,9,10,57,44,13,60
Stranraer,132,5,16,5,15,58,64,-6,53
Airdrieon,132,6,10,12,14,45,58,-13,42
East Fife,132,7,13,3,20,47,67,-20,42
Forfar,132,8,10,6,20,38,64,-26,36
Albion,132,9,8,6,22,57,80,-23,30
Queen's Park,132,10,6,10,20,40,74,-34,28
Raith,133,1,22,8,6,70,35,35,74
Ayr,133,2,23,4,9,91,44,47,73
Arbroath,133,3,18,8,10,75,51,24,62
Alloa,133,4,18,8,10,59,45,14,62
Stranraer,133,5,15,5,16,55,67,-12,50
East Fife,133,6,14,3,19,50,64,-14,45
Airdrieon,133,7,10,12,14,45,58,-13,42
Forfar,133,8,10,6,20,38,64,-26,36
Albion,133,9,9,6,21,59,79,-20,33
Queen's Park,133,10,6,10,20,42,77,-35,28
Ayr,134,1,24,4,8,97,46,51,76
Raith,134,2,22,8,6,68,33,35,74
Alloa,134,3,18,8,10,57,43,14,62
Arbroath,134,4,17,8,11,71,51,20,59
Stranraer,134,5,15,6,15,57,66,-9,51
Airdrieon,134,6,11,11,14,47,58,-11,44
East Fife,134,7,13,4,19,49,66,-17,43
Forfar,134,8,10,5,21,38,66,-28,35
Queen's Park,134,9,7,10,19,42,73,-31,31
Albion,134,10,8,6,22,61,85,-24,30
Ayr,135,1,24,4,8,95,42,53,76
Raith,135,2,22,8,6,68,33,35,74
Alloa,135,3,18,8,10,57,43,14,62
Arbroath,135,4,17,8,11,72,52,20,59
Stranraer,135,5,15,6,15,56,65,-9,51
East Fife,135,6,13,4,19,48,65,-17,43
Airdrieon,135,7,10,12,14,46,59,-13,42
Forfar,135,8,10,6,20,39,65,-26,36
Queen's Park,135,9,7,10,19,43,74,-31,31
Albion,135,10,8,6,22,57,83,-26,30
Raith,136,1,23,8,5,72,34,38,77
Ayr,136,2,24,4,8,94,43,51,76
Arbroath,136,3,18,8,10,71,48,23,62
Alloa,136,4,17,8,11,58,47,11,59
Stranraer,136,5,15,5,16,56,69,-13,50
East Fife,136,6,14,3,19,52,65,-13,45
Airdrieon,136,7,10,12,14,47,60,-13,42
Forfar,136,8,10,6,20,40,66,-26,36
Albion,136,9,8,6,22,58,82,-24,30
Queen's Park,136,10,6,10,20,39,73,-34,28
Ayr,137,1,24,4,8,93,44,49,76
Raith,137,2,22,9,5,70,34,36,75
Arbroath,137,3,17,9,10,70,48,22,60
Alloa,137,4,17,9,10,58,45,13,60
Stranraer,137,5,16,5,15,57,64,-7,53
Airdrieon,137,6,10,12,14,48,61,-13,42
East Fife,137,7,13,3,20,47,66,-19,42
Forfar,137,8,10,6,20,41,67,-26,36
Albion,137,9,8,6,22,59,81,-22,30
Queen's Park,137,10,6,11,19,39,72,-33,29
Ayr,138,1,24,4,8,94,43,51,76
Raith,138,2,22,8,6,68,33,35,74
Arbroath,138,3,18,8,10,72,49,23,62
Alloa,138,4,18,8,10,57,43,14,62
Stranraer,138,5,15,6,15,57,66,-9,51
East Fife,138,6,13,4,19,49,66,-17,43
Airdrieon,138,7,10,11,15,45,60,-15,41
Forfar,138,8,11,5,20,40,64,-24,38
Albion,138,9,8,6,22,58,82,-24,30
Queen's Park,138,10,6,10,20,40,74,-34,28
Raith,139,1,23,8,5,70,32,38,77
Ayr,139,2,24,4,8,94,44,50,76
Arbroath,139,3,17,9,10,71,49,22,60
Alloa,139,4,17,8,11,56,45,11,59
Stranraer,139,5,16,5,15,59,66,-7,53
Airdrieon,139,6,10,12,14,46,59,-13,42
East Fife,139,7,13,3,20,49,68,-19,42
Forfar,139,8,10,6,20,39,65,-26,36
Albion,139,9,8,6,22,59,82,-23,30
Queen's Park,139,10,6,11,19,40,73,-33,29
Ayr,140,1,24,4,8,93,43,50,76
Raith,140,2,22,9,5,70,34,36,75
Arbroath,140,3,18,8,10,73,48,25,62
Alloa,140,4,17,9,10,58,45,13,60
Stranraer,140,5,15,5,16,56,66,-10,50
East Fife,140,6,14,3,19,49,65,-16,45
Airdrieon,140,7,11,11,14,47,59,-12,44
Forfar,140,8,10,5,21,39,66,-27,35
Albion,140,9,8,6,22,58,81,-23,30
Queen's Park,140,10,6,10,20,39,75,-36,28
Ayr,141,1,24,4,8,93,42,51,76
Raith,141,2,22,8,6,69,35,34,74
Alloa,141,3,18,8,10,59,44,15,62
Arbroath,141,4,17,8,11,72,51,21,59
Stranraer,141,5,16,5,15,60,67,-7,53
East Fife,141,6,13,3,20,50,69,-19,42
Airdrieon,141,7,10,11,15,45,59,-14,41
Forfar,141,8,11,5,20,39,64,-25,38
Queen's Park,141,9,7,10,19,42,74,-32,31
Albion,141,10,8,6,22,57,81,-24,30
Raith,142,1,23,8,5,69,32,37,77
Ayr,142,2,24,4,8,94,43,51,76
Arbroath,142,3,17,8,11,70,49,21,59
Alloa,142,4,17,8,11,56,44,12,59
Stranraer,142,5,15,5,16,56,66,-10,50
East Fife,142,6,14,3,19,49,65,-16,45
Airdrieon,142,7,11,11,14,46,58,-12,44
Forfar,142,8,10,5,21,38,65,-27,35
Queen's Park,142,9,7,10,19,40,72,-32,31
Albion,142,10,8,6,22,58,82,-24,30
Raith,143,1,23,8,5,75,32,43,77
Ayr,143,2,24,4,8,96,46,50,76
Arbroath,143,3,17,8,11,70,51,19,59
Alloa,143,4,17,8,11,56,50,6,59
Stranraer,143,5,15,5,16,55,65,-10,50
East Fife,143,6,14,3,19,48,64,-16,45
Airdrieon,143,7,10,11,15,45,59,-14,41
Forfar,143,8,11,5,20,39,64,-25,38
Queen's Park,143,9,7,10,19,42,72,-30,31
Albion,143,10,8,6,22,61,84,-23,30
Ayr,144,1,24,4,8,97,44,53,76
Raith,144,2,22,9,5,69,33,36,75
Arbroath,144,3,18,8,10,72,49,23,62
Alloa,144,4,17,9,10,57,44,13,60
Stranraer,144,5,15,6,15,55,64,-9,51
East Fife,144,6,13,4,19,47,64,-17,43
Airdrieon,144,7,10,11,15,46,60,-14,41
Forfar,144,8,11,5,20,40,65,-25,38
Albion,144,9,8,6,22,59,85,-26,30
Queen's Park,144,10,6,10,20,40,74,-34,28
Raith,145,1,22,9,5,70,34,36,75
Ayr,145,2,23,4,9,92,45,47,73
Arbroath,145,3,17,9,10,71,49,22,60
Alloa,145,4,17,9,10,58,45,13,60
Stranraer,145,5,15,5,16,55,65,-10,50
East Fife,145,6,14,3,19,48,64,-16,45
Airdrieon,145,7,10,12,14,45,58,-13,42
Forfar,145,8,10,6,20,38,64,-26,36
Albion,145,9,9,6,21,60,80,-20,33
Queen's Park,145,10,6,11,19,40,73,-33,29
Raith,146,1,22,9,5,69,33,36,75
Ayr,146,2,23,4,9,92,45,47,73
Arbroath,146,3,18,8,10,73,49,24,62
Alloa,146,4,17,9,10,57,44,13,60
Stranraer,146,5,15,5,16,55,66,-11,50
East Fife,146,6,14,3,19,49,64,-15,45
Airdrieon,146,7,10,12,14,47,60,-13,42
Forfar,146,8,10,6,20,40,66,-26,36
Albion,146,9,9,6,21,60,80,-20,33
Queen's Park,146,10,6,10,20,40,75,-35,28
Raith,147,1,23,8,5,71,32,39,77
Ayr,147,2,24,4,8,91,42,49,76
Arbroath,147,3,18,8,10,72,49,23,62
Alloa,147,4,17,8,11,56,46,10,59
Stranraer,147,5,15,5,16,58,69,-11,50
East Fife,147,6,14,3,19,52,67,-15,45
Airdrieon,147,7,10,11,15,45,59,-14,41
Forfar,147,8,11,5,20,39,64,-25,38
Albion,147,9,8,6,22,57,79,-22,30
Queen's Park,147,10,6,10,20,40,74,-34,28
Raith,148,1,23,8,5,70,33,37,77
Ayr,148,2,23,4,9,90,44,46,73
Arbroath,148,3,17,8,11,72,52,20,59
Alloa,148,4,17,8,11,57,45,12,59
Stranraer,148,5,15,5,16,55,66,-11,50
East Fife,148,6,14,3,19,49,64,-15,45
Airdrieon,148,7,11,11,14,48,59,-11,44
Forfar,148,8,10,5,21,39,67,-28,35
Albion,148,9,9,6,21,59,78,-19,33
Queen's Park,148,10,7,10,19,43,74,-31,31
Ayr,149,1,24,4,8,94,45,49,76
Raith,149,2,22,8,6,68,33,35,74
Arbroath,149,3,18,8,10,72,49,23,62
Alloa,149,4,18,8,10,57,43,14,62
Stranraer,149,5,15,5,16,55,66,-11,50
East Fife,149,6,14,3,19,49,64,-15,45
Airdrieon,149,7,10,11,15,46,60,-14,41
Forfar,149,8,11,5,20,40,65,-25,38
Albion,149,9,8,6,22,60,82,-22,30
Queen's Park,149,10,6,10,20,40,74,-34,28
Ayr,150,1,24,4,8,96,43,53,76
Raith,150,2,22,9,5,70,34,36,75
Arbroath,150,3,17,9,10,70,48,22,60
Alloa,150,4,17,9,10,58,45,13,60
Stranraer,150,5,16,5,15,58,64,-6,53
Airdrieon,150,6,11,11,14,49,59,-10,44
East Fife,150,7,13,3,20,47,67,-20,42
Forfar,150,8,10,5,21,39,68,-29,35
Albion,150,9,8,6,22,58,84,-26,30
Queen's Park,150,10,6,11,19,39,72,-33,29
Ayr,151,1,24,4,8,93,42,51,76
Raith,151,2,22,8,6,69,35,34,74
Arbroath,151,3,18,8,10,72,48,24,62
Alloa,151,4,18,8,10,59,44,15,62
Stranraer,151,5,15,6,15,55,64,-9,51
Airdrieon,151,6,11,11,14,47,58,-11,44
East Fife,151,7,13,4,19,47,64,-17,43
Forfar,151,8,10,5,21,38,66,-28,35
Albion,151,9,8,6,22,57,81,-24,30
Queen's Park,151,10,6,10,20,39,74,-35,28
Ayr,152,1,24,4,8,92,43,49,76
Raith,152,2,22,8,6,68,35,33,74
Arbroath,152,3,18,8,10,73,48,25,62
Alloa,152,4,18,8,10,59,43,16,62
Stranraer,152,5,15,5,16,57,67,-10,50
East Fife,152,6,14,3,19,50,66,-16,45
Airdrieon,152,7,11,11,14,48,59,-11,44
Forfar,152,8,10,5,21,39,67,-28,35
Albion,152,9,8,6,22,58,80,-22,30
Queen's Park,152,10,6,10,20,39,75,-36,28
Raith,153,1,23,8,5,70,33,37,77
Ayr,153,2,23,4,9,91,44,47,73
Arbroath,153,3,17,9,10,71,49,22,60
Alloa,153,4,17,8,11,57,45,12,59
Stranraer,153,5,16,5,15,59,64,-5,53
Airdrieon,153,6,11,11,14,49,59,-10,44
East Fife,153,7,13,3,20,47,68,-21,42
Forfar,153,8,10,5,21,39,68,-29,35
Albion,153,9,9,6,21,59,79,-20,33
Queen's Park,153,10,6,11,19,40,73,-33,29
Ayr,154,1,24,4,8,94,42,52,76
Raith,154,2,22,9,5,68,32,36,75
Arbroath,154,3,18,8,10,75,49,26,62
Alloa,154,4,17,9,10,56,43,13,60
Stranraer,154,5,16,5,15,58,65,-7,53
Airdrieon,154,6,10,12,14,46,59,-13,42
East Fife,154,7,13,3,20,48,67,-19,42
Forfar,154,8,10,6,20,39,65,-26,36
Albion,154,9,8,6,22,57,82,-25,30
Queen's Park,154,10,6,10,20,40,77,-37,28
Raith,155,1,23,8,5,69,32,37,77
Ayr,155,2,24,4,8,94,42,52,76
Arbroath,155,3,17,8,11,71,50,21,59
Alloa,155,4,17,8,11,56,44,12,59
Stranraer,155,5,15,5,16,56,67,-11,50
East Fife,155,6,14,3,19,50,65,-15,45
Airdrieon,155,7,10,11,15,45,59,-14,41
Forfar,155,8,11,5,20,39,64,-25,38
Queen's Park,155,9,7,10,19,41,73,-32,31
Albion,155,10,8,6,22,57,82,-25,30
Ayr,156,1,24,4,8,93,43,50,76
Raith,156,2,22,8,6,68,34,34,74
Alloa,156,3,18,8,10,58,43,15,62
Arbroath,156,4,17,8,11,71,50,21,59
Stranraer,156,5,15,5,16,55,65,-10,50
East Fife,156,6,14,3,19,48,64,-16,45
Airdrieon,156,7,11,11,14,46,58,-12,44
Forfar,156,8,10,5,21,38,65,-27,35
Queen's Park,156,9,7,10,19,41,73,-32,31
Albion,156,10,8,6,22,58,81,-23,30
Raith,157,1,23,8,5,71,34,37,77
Ayr,157,2,23,4,9,91,45,46,73
Arbroath,157,3,17,9,10,71,49,22,60
Alloa,157,4,17,8,11,58,46,12,59
Stranraer,157,5,15,5,16,55,65,-10,50
East Fife,157,6,14,3,19,48,64,-16,45
Airdrieon,157,7,10,11,15,45,61,-16,41
Forfar,157,8,11,5,20,41,64,-23,38
Albion,157,9,9,6,21,60,79,-19,33
Queen's Park,157,10,6,11,19,40,73,-33,29
Ayr,158,1,24,4,8,94,44,50,76
Raith,158,2,22,9,5,69,33,36,75
Arbroath,158,3,17,9,10,71,49,22,60
Alloa,158,4,17,9,10,57,44,13,60
Stranraer,158,5,15,5,16,56,67,-11,50
East Fife,158,6,14,3,19,50,65,-15,45
Airdrieon,158,7,11,11,14,47,58,-11,44
Forfar,158,8,10,5,21,38,66,-28,35
Albion,158,9,8,6,22,59,82,-23,30
Queen's Park,158,10,6,11,19,40,73,-33,29
Raith,159,1,23,8,5,70,33,37,77
Ayr,159,2,24,4,8,93,43,50,76
Arbroath,159,3,18,8,10,72,48,24,62
Alloa,159,4,17,8,11,57,45,12,59
Stranraer,159,5,16,5,15,59,64,-5,53
Airdrieon,159,6,11,11,14,47,59,-12,44
East Fife,159,7,13,3,20,47,68,-21,42
Forfar,159,8,10,5,21,39,66,-27,35
Albion,159,9,8,6,22,58,81,-23,30
Queen's Park,159,10,6,10,20,39,74,-35,28
Ayr,160,1,24,4,8,93,42,51,76
Raith,160,2,22,9,5,68,32,36,75
Alloa,160,3,17,9,10,56,43,13,60
Arbroath,160,4,17,8,11,72,51,21,59
Stranraer,160,5,15,6,15,56,65,-9,51
East Fife,160,6,13,4,19,48,65,-17,43
Airdrieon,160,7,10,12,14,47,60,-13,42
Forfar,160,8,10,6,20,40,66,-26,36
Queen's Park,160,9,7,10,19,42,74,-32,31
Albion,160,10,8,6,22,57,81,-24,30
Raith,161,1,23,8,5,71,32,39,77
Ayr,161,2,24,4,8,95,43,52,76
Arbroath,161,3,17,9,10,71,49,22,60
Alloa,161,4,17,8,11,56,46,10,59
Stranraer,161,5,15,6,15,56,65,-9,51
Airdrieon,161,6,11,11,14,48,59,-11,44
East Fife,161,7,13,4,19,48,65,-17,43
Forfar,161,8,10,5,21,39,67,-28,35
Albion,161,9,8,6,22,58,83,-25,30
Queen's Park,161,10,6,11,19,40,73,-33,29
Raith,162,1,23,8,5,69,32,37,77
Ayr,162,2,24,4,8,95,43,52,76
Arbroath,162,3,17,9,10,72,50,22,60
Alloa,162,4,17,8,11,56,44,12,59
Stranraer,162,5,16,5,15,61,65,-4,53
Airdrieon,162,6,11,11,14,48,60,-12,44
East Fife,162,7,13,3,20,48,70,-22,42
Forfar,162,8,10,5,21,40,67,-27,35
Albion,162,9,8,6,22,58,83,-25,30
Queen's Park,162,10,6,11,19,41,74,-33,29
Raith,163,1,23,8,5,72,32,40,77
Ayr,163,2,24,4,8,96,42,54,76
Arbroath,163,3,18,8,10,72,49,23,62
Alloa,163,4,17,8,11,56,47,9,59
Stranraer,163,5,15,5,16,56,66,-10,50
East Fife,163,6,14,3,19,49,65,-16,45
Airdrieon,163,7,11,11,14,49,59,-10,44
Forfar,163,8,10,5,21,39,68,-29,35
Albion,163,9,8,6,22,57,84,-27,30
Queen's Park,163,10,6,10,20,40,74,-34,28
Raith,164,1,23,8,5,71,33,38,77
Ayr,164,2,24,4,8,93,42,51,76
Arbroath,164,3,17,9,10,72,50,22,60
Alloa,164,4,17,8,11,57,46,11,59
Stranraer,164,5,16,5,15,58,66,-8,53
Airdrieon,164,6,10,12,14,46,59,-13,42
East Fife,164,7,13,3,20,49,67,-18,42
Forfar,164,8,10,6,20,39,65,-26,36
Albion,164,9,8,6,22,57,81,-24,30
Queen's Park,164,10,6,11,19,41,74,-33,29
Raith,165,1,23,8,5,71,33,38,77
Ayr,165,2,24,4,8,94,42,52,76
Arbroath,165,3,17,8,11,70,49,21,59
Alloa,165,4,17,8,11,57,46,11,59
Stranraer,165,5,15,5,16,55,69,-14,50
East Fife,165,6,14,3,19,52,64,-12,45
Airdrieon,165,7,11,11,14,46,58,-12,44
Forfar,165,8,10,5,21,38,65,-27,35
Queen's Park,165,9,7,10,19,40,72,-32,31
Albion,165,10,8,6,22,57,82,-25,30
Raith,166,1,23,8,5,70,33,37,77
Ayr,166,2,24,4,8,95,43,52,76
Arbroath,166,3,18,8,10,73,48,25,62
Alloa,166,4,17,8,11,57,45,12,59
Stranraer,166,5,15,5,16,55,65,-10,50
East Fife,166,6,14,3,19,48,64,-16,45
Airdrieon,166,7,11,11,14,47,58,-11,44
Forfar,166,8,10,5,21,38,66,-28,35
Albion,166,9,8,6,22,58,83,-25,30
Queen's Park,166,10,6,10,20,39,75,-36,28
Raith,167,1,23,8,5,70,33,37,77
Ayr,167,2,24,4,8,98,44,54,76
Arbroath,167,3,18,8,10,72,48,24,62
Alloa,167,4,17,8,11,57,45,12,59
Stranraer,167,5,15,6,15,55,64,-9,51
Airdrieon,167,6,11,11,14,49,60,-11,44
East Fife,167,7,13,4,19,47,64,-17,43
Forfar,167,8,10,5,21,40,68,-28,35
Albion,167,9,8,6,22,59,86,-27,30
Queen's Park,167,10,6,10,20,39,74,-35,28
Ayr,168,1,24,4,8,96,44,52,76
Raith,168,2,22,9,5,68,32,36,75
Arbroath,168,3,18,8,10,72,48,24,62
Alloa,168,4,17,9,10,56,43,13,60
Stranraer,168,5,15,5,16,57,67,-10,50
East Fife,168,6,14,3,19,50,66,-16,45
Airdrieon,168,7,11,11,14,48,60,-12,44
Forfar,168,8,10,5,21,40,67,-27,35
Albion,168,9,8,6,22,59,84,-25,30
Queen's Park,168,10,6,10,20,39,74,-35,28
Ayr,169,1,24,4,8,98,45,53,76
Raith,169,2,22,9,5,70,34,36,75
Arbroath,169,3,18,8,10,72,48,24,62
Alloa,169,4,17,9,10,58,45,13,60
Stranraer,169,5,16,5,15,57,64,-7,53
Airdrieon,169,6,10,12,14,46,59,-13,42
East Fife,169,7,13,3,20,47,66,-19,42
Forfar,169,8,10,6,20,39,65,-26,36
Albion,169,9,8,6,22,60,86,-26,30
Queen's Park,169,10,6,10,20,39,74,-35,28
Raith,170,1,22,8,6,69,34,35,74
Ayr,170,2,23,4,9,90,44,46,73
Alloa,170,3,18,8,10,58,44,14,62
Arbroath,170,4,17,9,10,71,49,22,60
Stranraer,170,5,15,6,15,56,65,-9,51
East Fife,170,6,13,4,19,48,65,-17,43
Airdrieon,170,7,10,12,14,46,59,-13,42
Forfar,170,8,10,6,20,39,65,-26,36
Albion,170,9,9,6,21,59,78,-19,33
Queen's Park,170,10,6,11,19,40,73,-33,29
Raith,171,1,23,8,5,72,34,38,77
Ayr,171,2,24,4,8,93,43,50,76
Arbroath,171,3,17,8,11,70,49,21,59
Alloa,171,4,17,8,11,58,47,11,59
Stranraer,171,5,15,5,16,56,67,-11,50
East Fife,171,6,14,3,19,50,65,-15,45
Airdrieon,171,7,10,11,15,45,59,-14,41
Forfar,171,8,11,5,20,39,64,-25,38
Queen's Park,171,9,7,10,19,40,72,-32,31
Albion,171,10,8,6,22,58,81,-23,30
Raith,172,1,23,8,5,70,32,38,77
Ayr,172,2,24,4,8,94,42,52,76
Arbroath,172,3,18,8,10,72,49,23,62
Alloa,172,4,17,8,11,56,45,11,59
Stranraer,172,5,15,6,15,57,66,-9,51
Airdrieon,172,6,11,11,14,48,59,-11,44
East Fife,172,7,13,4,19,49,66,-17,43
Forfar,172,8,10,5,21,39,67,-28,35
Albion,172,9,8,6,22,57,82,-25,30
Queen's Park,172,10,6,10,20,40,74,-34,28
Raith,173,1,23,8,5,70,32,38,77
Ayr,173,2,24,4,8,95,43,52,76
Arbroath,173,3,18,8,10,73,48,25,62
Alloa,173,4,17,8,11,56,45,11,59
Stranraer,173,5,15,5,16,57,70,-13,50
East Fife,173,6,14,3,19,53,66,-13,45
Airdrieon,173,7,10,11,15,47,61,-14,41
Forfar,173,8,11,5,20,41,66,-25,38
Albion,173,9,8,6,22,58,83,-25,30
Queen's Park,173,10,6,10,20,39,75,-36,28
Raith,174,1,23,8,5,72,32,40,77
Ayr,174,2,24,4,8,95,45,50,76
Arbroath,174,3,17,8,11,71,50,21,59
Alloa,174,4,17,8,11,56,47,9,59
Stranraer,174,5,15,5,16,55,67,-12,50
East Fife,174,6,14,3,19,50,64,-14,45
Airdrieon,174,7,10,12,14,46,59,-13,42
Forfar,174,8,10,6,20,39,65,-26,36
Queen's Park,174,9,7,10,19,41,73,-32,31
Albion,174,10,8,6,22,60,83,-23,30
Raith,175,1,23,8,5,72,32,40,77
Ayr,175,2,24,4,8,94,42,52,76
Arbroath,175,3,17,8,11,70,49,21,59
Alloa,175,4,17,8,11,56,47,9,59
Stranraer,175,5,16,5,15,59,67,-8,53
Airdrieon,175,6,11,11,14,48,58,-10,44
East Fife,175,7,13,3,20,50,68,-18,42
Forfar,175,8,10,5,21,38,67,-29,35
Queen's Park,175,9,7,10,19,40,72,-32,31
Albion,175,10,8,6,22,57,82,-25,30
Raith,176,1,23,8,5,70,33,37,77
Ayr,176,2,23,5,8,90,42,48,74
Arbroath,176,3,18,8,10,75,49,26,62
Alloa,176,4,17,8,11,57,45,12,59
Stranraer,176,5,15,5,16,56,67,-11,50
East Fife,176,6,14,3,19,50,65,-15,45
Airdrieon,176,7,10,12,14,46,59,-13,42
Forfar,176,8,10,6,20,39,65,-26,36
Albion,176,9,8,7,21,57,78,-21,31
Queen's Park,176,10,6,10,20,40,77,-37,28
Raith,177,1,23,8,5,72,33,39,77
Ayr,177,2,24,4,8,92,42,50,76
Arbroath,177,3,17,9,10,72,50,22,60
Alloa,177,4,17,8,11,57,47,10,59
Stranraer,177,5,16,5,15,57,65,-8,53
Airdrieon,177,6,10,12,14,47,60,-13,42
East Fife,177,7,13,3,20,48,66,-18,42
Forfar,177,8,10,6,20,40,66,-26,36
Albion,177,9,8,6,22,57,80,-23,30
Queen's Park,177,10,6,11,19,41,74,-33,29
Ayr,178,1,24,4,8,94,43,51,76
Raith,178,2,22,9,5,68,32,36,75
Arbroath,178,3,17,9,10,72,50,22,60
Alloa,178,4,17,9,10,56,43,13,60
Stranraer,178,5,16,5,15,57,65,-8,53
Airdrieon,178,6,11,11,14,47,59,-12,44
East Fife,178,7,13,3,20,48,66,-18,42
Forfar,178,8,10,5,21,39,66,-27,35
Albion,178,9,8,6,22,58,82,-24,30
Queen's Park,178,10,6,11,19,41,74,-33,29
Raith,179,1,23,8,5,72,33,39,77
Ayr,179,2,23,5,8,91,43,48,74
Arbroath,179,3,17,8,11,70,49,21,59
Alloa,179,4,17,8,11,57,47,10,59
Stranraer,179,5,16,5,15,59,67,-8,53
Airdrieon,179,6,11,11,14,46,58,-12,44
East Fife,179,7,13,3,20,50,68,-18,42
Forfar,179,8,10,5,21,38,65,-27,35
Albion,179,9,8,7,21,58,79,-21,31
Queen's Park,179,10,7,10,19,40,72,-32,31
Ayr,180,1,24,4,8,93,42,51,76
Raith,180,2,22,9,5,69,33,36,75
Arbroath,180,3,17,9,10,72,50,22,60
Alloa,180,4,17,9,10,57,44,13,60
Stranraer,180,5,15,5,16,56,66,-10,50
East Fife,180,6,14,3,19,49,65,-16,45
Airdrieon,180,7,10,12,14,45,58,-13,42
Forfar,180,8,10,6,20,38,64,-26,36
Albion,180,9,8,6,22,57,81,-24,30
Queen's Park,180,10,6,11,19,41,74,-33,29
Ayr,181,1,24,4,8,92,42,50,76
Raith,181,2,22,9,5,70,34,36,75
Arbroath,181,3,18,8,10,72,48,24,62
Alloa,181,4,17,9,10,58,45,13,60
Stranraer,181,5,15,5,16,55,68,-13,50
East Fife,181,6,14,3,19,51,64,-13,45
Airdrieon,181,7,10,12,14,45,58,-13,42
Forfar,181,8,10,6,20,38,64,-26,36
Albion,181,9,8,6,22,57,80,-23,30
Queen's Park,181,10,6,10,20,39,74,-35,28
Raith,182,1,23,8,5,71,33,38,77
Ayr,182,2,24,4,8,92,43,49,76
Arbroath,182,3,18,8,10,74,51,23,62
Alloa,182,4,17,8,11,57,46,11,59
Stranraer,182,5,15,6,15,56,65,-9,51
East Fife,182,6,13,4,19,48,65,-17,43
Airdrieon,182,7,10,12,14,47,60,-13,42
Forfar,182,8,10,6,20,40,66,-26,36
Albion,182,9,8,6,22,58,80,-22,30
Queen's Park,182,10,6,10,20,42,76,-34,28
Raith,183,1,23,8,5,69,32,37,77
Ayr,183,2,24,4,8,93,44,49,76
Arbroath,183,3,18,8,10,72,48,24,62
Alloa,183,4,17,8,11,56,44,12,59
Stranraer,183,5,15,5,16,55,68,-13,50
East Fife,183,6,14,3,19,51,64,-13,45
Airdrieon,183,7,10,12,14,45,58,-13,42
Forfar,183,8,10,6,20,38,64,-26,36
Albion,183,9,8,6,22,59,81,-22,30
Queen's Park,183,10,6,10,20,39,74,-35,28
Ayr,184,1,24,4,8,92,43,49,76
Raith,184,2,22,9,5,70,34,36,75
Arbroath,184,3,18,8,10,72,48,24,62
Alloa,184,4,17,9,10,58,45,13,60
Stranraer,184,5,16,5,15,58,66,-8,53
Airdrieon,184,6,11,11,14,47,58,-11,44
East Fife,184,7,13,3,20,49,67,-18,42
Forfar,184,8,10,5,21,38,66,-28,35
Albion,184,9,8,6,22,58,80,-22,30
Queen's Park,184,10,6,10,20,39,74,-35,28
Raith,185,1,22,9,5,69,33,36,75
Ayr,185,2,23,5,8,92,44,48,74
Alloa,185,3,17,9,10,57,44,13,60
Arbroath,185,4,17,8,11,71,50,21,59
Stranraer,185,5,15,5,16,55,66,-11,50
East Fife,185,6,14,3,19,49,64,-15,45
Airdrieon,185,7,10,12,14,45,58,-13,42
Forfar,185,8,10,6,20,38,64,-26,36
Albion,185,9,8,7,21,59,80,-21,31
Queen's Park,185,10,7,10,19,41,73,-32,31
Ayr,186,1,24,4,8,93,43,50,76
Raith,186,2,22,8,6,68,34,34,74
Alloa,186,3,18,8,10,58,43,15,62
Arbroath,186,4,17,9,10,70,48,22,60
Stranraer,186,5,16,5,15,58,65,-7,53
Airdrieon,186,6,11,11,14,47,59,-12,44
East Fife,186,7,13,3,20,48,67,-19,42
Forfar,186,8,10,5,21,39,66,-27,35
Albion,186,9,8,6,22,58,81,-23,30
Queen's Park,186,10,6,11,19,39,72,-33,29
Ayr,187,1,24,4,8,94,42,52,76
Raith,187,2,22,8,6,68,35,33,74
Alloa,187,3,18,8,10,59,43,16,62
Arbroath,187,4,17,9,10,72,50,22,60
Stranraer,187,5,16,5,15,56,64,-8,53
Airdrieon,187,6,11,11,14,47,58,-11,44
East Fife,187,7,13,3,20,47,65,-18,42
Forfar,187,8,10,5,21,38,66,-28,35
Albion,187,9,8,6,22,57,82,-25,30
Queen's Park,187,10,6,11,19,41,74,-33,29
Raith,188,1,23,8,5,75,32,43,77
Ayr,188,2,24,4,8,93,42,51,76
Arbroath,188,3,18,8,10,73,48,25,62
Alloa,188,4,17,8,11,56,50,6,59
Stranraer,188,5,15,5,16,56,66,-10,50
East Fife,188,6,14,3,19,49,65,-16,45
Airdrieon,188,7,10,12,14,46,59,-13,42
Forfar,188,8,10,6,20,39,65,-26,36
Albion,188,9,8,6,22,57,81,-24,30
Queen's Park,188,10,6,10,20,39,75,-36,28
Ayr,189,1,24,4,8,92,42,50,76
Raith,189,2,22,8,6,68,33,35,74
Arbroath,189,3,18,8,10,72,49,23,62
Alloa,189,4,18,8,10,57,43,14,62
Stranraer,189,5,15,5,16,55,68,-13,50
East Fife,189,6,14,3,19,51,64,-13,45
Airdrieon,189,7,11,11,14,47,58,-11,44
Forfar,189,8,10,5,21,38,66,-28,35
Albion,189,9,8,6,22,57,80,-23,30
Queen's Park,189,10,6,10,20,40,74,-34,28
Ayr,190,1,24,4,8,91,42,49,76
Raith,190,2,22,8,6,68,33,35,74
Alloa,190,3,18,8,10,57,43,14,62
Arbroath,190,4,17,9,10,71,49,22,60
Stranraer,190,5,15,6,15,56,65,-9,51
East Fife,190,6,13,4,19,48,65,-17,43
Airdrieon,190,7,10,11,15,45,59,-14,41
Forfar,190,8,11,5,20,39,64,-25,38
Albion,190,9,8,6,22,57,79,-22,30
Queen's Park,190,10,6,11,19,40,73,-33,29
Raith,191,1,22,9,5,68,32,36,75
Ayr,191,2,23,5,8,91,43,48,74
Arbroath,191,3,18,8,10,74,51,23,62
Alloa,191,4,17,9,10,56,43,13,60
Stranraer,191,5,16,5,15,60,67,-7,53
Airdrieon,191,6,11,11,14,47,58,-11,44
East Fife,191,7,13,3,20,50,69,-19,42
Forfar,191,8,10,5,21,38,66,-28,35
Albion,191,9,8,7,21,58,79,-21,31
Queen's Park,191,10,6,10,20,42,76,-34,28
Raith,192,1,23,8,5,69,32,37,77
Ayr,192,2,23,5,8,92,44,48,74
Arbroath,192,3,17,9,10,72,50,22,60
Alloa,192,4,17,8,11,56,44,12,59
Stranraer,192,5,15,5,16,56,67,-11,50
East Fife,192,6,14,3,19,50,65,-15,45
Airdrieon,192,7,10,11,15,46,60,-14,41
Forfar,192,8,11,5,20,40,65,-25,38
Albion,192,9,8,7,21,59,80,-21,31
Queen's Park,192,10,6,11,19,41,74,-33,29
Ayr,193,1,24,4,8,94,43,51,76
Raith,193,2,22,9,5,69,33,36,75
Arbroath,193,3,18,8,10,73,49,24,62
Alloa,193,4,17,9,10,57,44,13,60
Stranraer,193,5,15,5,16,55,66,-11,50
East Fife,193,6,14,3,19,49,64,-15,45
Airdrieon,193,7,11,11,14,49,59,-10,44
Forfar,193,8,10,5,21,39,68,-29,35
Albion,193,9,8,6,22,58,82,-24,30
Queen's Park,193,10,6,10,20,40,75,-35,28
Raith,194,1,23,8,5,71,32,39,77
Ayr,194,2,23,4,9,92,45,47,73
Arbroath,194,3,18,8,10,72,49,23,62
Alloa,194,4,17,8,11,56,46,10,59
Stranraer,194,5,15,5,16,55,67,-12,50
East Fife,194,6,14,3,19,50,64,-14,45
Airdrieon,194,7,11,11,14,46,58,-12,44
Forfar,194,8,10,5,21,38,65,-27,35
Albion,194,9,9,6,21,60,80,-20,33
Queen's Park,194,10,6,10,20,40,74,-34,28
Ayr,195,1,24,4,8,94,45,49,76
Raith,195,2,22,9,5,70,34,36,75
Arbroath,195,3,17,9,10,70,48,22,60
Alloa,195,4,17,9,10,58,45,13,60
Stranraer,195,5,15,6,15,56,65,-9,51
East Fife,195,6,13,4,19,48,65,-17,43
Airdrieon,195,7,10,11,15,46,60,-14,41
Forfar,195,8,11,5,20,40,65,-25,38
Albion,195,9,8,6,22,60,82,-22,30
Queen's Park,195,10,6,11,19,39,72,-33,29
Raith,196,1,23,8,5,70,33,37,77
Ayr,196,2,24,4,8,94,42,52,76
Arbroath,196,3,17,9,10,70,48,22,60
Alloa,196,4,17,8,11,57,45,12,59
Stranraer,196,5,16,5,15,57,64,-7,53
East Fife,196,6,13,3,20,47,66,-19,42
Airdrieon,196,7,10,11,15,45,59,-14,41
Forfar,196,8,11,5,20,39,64,-25,38
Albion,196,9,8,6,22,57,82,-25,30
Queen's Park,196,10,6,11,19,39,72,-33,29
Ayr,197,1,23,5,8,92,44,48,74
Raith,197,2,22,8,6,68,33,35,74
Arbroath,197,3,18,8,10,71,48,23,62
Alloa,197,4,18,8,10,57,43,14,62
Stranraer,197,5,16,5,15,58,66,-8,53
Airdrieon,197,6,11,11,14,47,59,-12,44
East Fife,197,7,13,3,20,49,67,-18,42
Forfar,197,8,10,5,21,39,66,-27,35
Albion,197,9,8,7,21,59,80,-21,31
Queen's Park,197,10,6,10,20,39,73,-34,28
Raith,198,1,23,8,5,69,32,37,77
Ayr,198,2,24,4,8,94,43,51,76
Arbroath,198,3,18,8,10,74,49,25,62
Alloa,198,4,17,8,11,56,44,12,59
Stranraer,198,5,16,5,15,58,66,-8,53
Airdrieon,198,6,11,11,14,46,58,-12,44
East Fife,198,7,13,3,20,49,67,-18,42
Forfar,198,8,10,5,21,38,65,-27,35
Albion,198,9,8,6,22,58,82,-24,30
Queen's Park,198,10,6,10,20,40,76,-36,28
Raith,199,1,23,8,5,70,33,37,77
Ayr,199,2,24,4,8,94,43,51,76
Arbroath,199,3,18,8,10,73,50,23,62
Alloa,199,4,17,8,11,57,45,12,59
Stranraer,199,5,15,5,16,55,68,-13,50
East Fife,199,6,14,3,19,51,64,-13,45
Airdrieon,199,7,10,11,15,45,59,-14,41
Forfar,199,8,11,5,20,39,64,-25,38
Albion,199,9,8,6,22,58,82,-24,30
Queen's Park,199,10,6,10,20,41,75,-34,28
Ayr,200,1,24,4,8,94,43,51,76
Raith,200,2,22,8,6,69,34,35,74
Arbroath,200,3,18,8,10,76,50,26,62
Alloa,200,4,18,8,10,58,44,14,62
Stranraer,200,5,16,5,15,58,65,-7,53
East Fife,200,6,13,3,20,48,67,-19,42
Airdrieon,200,7,10,11,15,45,59,-14,41
Forfar,200,8,11,5,20,39,64,-25,38
Albion,200,9,8,6,22,58,82,-24,30
Queen's Park,200,10,6,10,20,41,78,-37,28
Raith,201,1,23,8,5,70,33,37,77
Ayr,201,2,24,4,8,95,43,52,76
Arbroath,201,3,17,8,11,70,49,21,59
Alloa,201,4,17,8,11,57,45,12,59
Stranraer,201,5,16,5,15,57,65,-8,53
East Fife,201,6,13,3,20,48,66,-18,42
Airdrieon,201,7,10,11,15,45,59,-14,41
Forfar,201,8,11,5,20,39,64,-25,38
Queen's Park,201,9,7,10,19,40,72,-32,31
Albion,201,10,8,6,22,58,83,-25,30
Raith,202,1,23,8,5,70,33,37,77
Ayr,202,2,24,4,8,96,44,52,76
Arbroath,202,3,18,8,10,73,50,23,62
Alloa,202,4,17,8,11,57,45,12,59
Stranraer,202,5,15,5,16,56,66,-10,50
East Fife,202,6,14,3,19,49,65,-16,45
Airdrieon,202,7,10,11,15,45,63,-18,41
Forfar,202,8,11,5,20,43,64,-21,38
Albion,202,9,8,6,22,59,84,-25,30
Queen's Park,202,10,6,10,20,41,75,-34,28
Ayr,203,1,24,4,8,92,42,50,76
Raith,203,2,22,8,6,69,35,34,74
Arbroath,203,3,18,8,10,74,48,26,62
Alloa,203,4,18,8,10,59,44,15,62
Stranraer,203,5,15,6,15,56,65,-9,51
East Fife,203,6,13,4,19,48,65,-17,43
Airdrieon,203,7,10,12,14,45,58,-13,42
Forfar,203,8,10,6,20,38,64,-26,36
Albion,203,9,8,6,22,57,80,-23,30
Queen's Park,203,10,6,10,20,39,76,-37,28
Raith,204,1,23,8,5,72,35,37,77
Ayr,204,2,24,4,8,92,42,50,76
Arbroath,204,3,17,9,10,72,50,22,60
Alloa,204,4,17,8,11,59,47,12,59
Stranraer,204,5,15,5,16,55,65,-10,50
East Fife,204,6,14,3,19,48,64,-16,45
Airdrieon,204,7,10,12,14,48,61,-13,42
Forfar,204,8,10,6,20,41,67,-26,36
Albion,204,9,8,6,22,57,80,-23,30
Queen's Park,204,10,6,11,19,41,74,-33,29
Raith,205,1,23,8,5,71,34,37,77
Ayr,205,2,24,4,8,93,42,51,76
Arbroath,205,3,18,8,10,72,48,24,62
Alloa,205,4,17,8,11,58,46,12,59
Stranraer,205,5,15,5,16,56,66,-10,50
East Fife,205,6,14,3,19,49,65,-16,45
Airdrieon,205,7,11,11,14,48,59,-11,44
Forfar,205,8,10,5,21,39,67,-28,35
Albion,205,9,8,6,22,57,81,-24,30
Queen's Park,205,10,6,10,20,39,74,-35,28
Raith,206,1,23,8,5,71,33,38,77
Ayr,206,2,24,4,8,95,43,52,76
Arbroath,206,3,17,8,11,70,49,21,59
Alloa,206,4,17,8,11,57,46,11,59
Stranraer,206,5,16,5,15,58,65,-7,53
Airdrieon,206,6,11,11,14,47,59,-12,44
East Fife,206,7,13,3,20,48,67,-19,42
Forfar,206,8,10,5,21,39,66,-27,35
Queen's Park,206,9,7,10,19,40,72,-32,31
Albion,206,10,8,6,22,58,83,-25,30
Raith,207,1,23,8,5,70,33,37,77
Ayr,207,2,23,5,8,91,43,48,74
Arbroath,207,3,18,8,10,72,49,23,62
Alloa,207,4,17,8,11,57,45,12,59
Stranraer,207,5,16,5,15,58,65,-7,53
Airdrieon,207,6,10,12,14,47,60,-13,42
East Fife,207,7,13,3,20,48,67,-19,42
Forfar,207,8,10,6,20,40,66,-26,36
Albion,207,9,8,7,21,58,79,-21,31
Queen's Park,207,10,6,10,20,40,74,-34,28
Raith,208,1,23,8,5,69,32,37,77
Ayr,208,2,24,4,8,96,42,54,76
Arbroath,208,3,18,8,10,71,48,23,62
Alloa,208,4,17,8,11,56,44,12,59
Stranraer,208,5,15,6,15,56,65,-9,51
Airdrieon,208,6,11,11,14,47,59,-12,44
East Fife,208,7,13,4,19,48,65,-17,43
Forfar,208,8,10,5,21,39,66,-27,35
Albion,208,9,8,6,22,57,84,-27,30
Queen's Park,208,10,6,10,20,39,73,-34,28
Raith,209,1,23,8,5,70,32,38,77
Ayr,209,2,24,4,8,92,43,49,76
Arbroath,209,3,17,9,10,72,50,22,60
Alloa,209,4,17,8,11,56,45,11,59
Stranraer,209,5,15,5,16,55,66,-11,50
East Fife,209,6,14,3,19,49,64,-15,45
Airdrieon,209,7,10,12,14,46,59,-13,42
Forfar,209,8,10,6,20,39,65,-26,36
Albion,209,9,8,6,22,58,80,-22,30
Queen's Park,209,10,6,11,19,41,74,-33,29
Raith,210,1,23,8,5,70,33,37,77
Ayr,210,2,24,4,8,93,42,51,76
Arbroath,210,3,17,8,11,71,50,21,59
Alloa,210,4,17,8,11,57,45,12,59
Stranraer,210,5,16,5,15,58,64,-6,53
Airdrieon,210,6,11,11,14,47,58,-11,44
East Fife,210,7,13,3,20,47,67,-20,42
Forfar,210,8,10,5,21,38,66,-28,35
Queen's Park,210,9,7,10,19,41,73,-32,31
Albion,210,10,8,6,22,57,81,-24,30
Ayr,211,1,23,5,8,92,44,48,74
Raith,211,2,22,8,6,69,34,35,74
Arbroath,211,3,18,8,10,72,49,23,62
Alloa,211,4,18,8,10,58,44,14,62
Stranraer,211,5,15,6,15,56,65,-9,51
East Fife,211,6,13,4,19,48,65,-17,43
Airdrieon,211,7,10,11,15,45,60,-15,41
Forfar,211,8,11,5,20,40,64,-24,38
Albion,211,9,8,7,21,59,80,-21,31
Queen's Park,211,10,6,10,20,40,74,-34,28
Ayr,212,1,23,5,8,91,43,48,74
Raith,212,2,22,8,6,68,33,35,74
Alloa,212,3,18,8,10,57,43,14,62
Arbroath,212,4,17,8,11,71,51,20,59
Stranraer,212,5,16,5,15,56,64,-8,53
Airdrieon,212,6,11,11,14,46,58,-12,44
East Fife,212,7,13,3,20,47,65,-18,42
Forfar,212,8,10,5,21,38,65,-27,35
Albion,212,9,8,7,21,58,79,-21,31
Queen's Park,212,10,7,10,19,42,73,-31,31
Ayr,213,1,24,4,8,100,42,58,76
Raith,213,2,22,9,5,68,32,36,75
Alloa,213,3,17,9,10,56,43,13,60
Arbroath,213,4,17,8,11,71,50,21,59
Stranraer,213,5,15,6,15,56,65,-9,51
Airdrieon,213,6,11,11,14,48,58,-10,44
East Fife,213,7,13,4,19,48,65,-17,43
Forfar,213,8,10,5,21,38,67,-29,35
Queen's Park,213,9,7,10,19,41,73,-32,31
Albion,213,10,8,6,22,57,88,-31,30
Raith,214,1,23,8,5,71,33,38,77
Ayr,214,2,24,4,8,93,43,50,76
Arbroath,214,3,18,8,10,74,50,24,62
Alloa,214,4,17,8,11,57,46,11,59
Stranraer,214,5,15,5,16,55,68,-13,50
East Fife,214,6,14,3,19,51,64,-13,45
Airdrieon,214,7,11,11,14,46,58,-12,44
Forfar,214,8,10,5,21,38,65,-27,35
Albion,214,9,8,6,22,58,81,-23,30
Queen's Park,214,10,6,10,20,41,76,-35,28
Raith,215,1,23,8,5,70,33,37,77
Ayr,215,2,24,4,8,93,42,51,76
Arbroath,215,3,18,8,10,74,50,24,62
Alloa,215,4,17,8,11,57,45,12,59
Stranraer,215,5,15,5,16,55,65,-10,50
East Fife,215,6,14,3,19,48,64,-16,45
Airdrieon,215,7,10,11,15,46,60,-14,41
Forfar,215,8,11,5,20,40,65,-25,38
Albion,215,9,8,6,22,57,81,-24,30
Queen's Park,215,10,6,10,20,41,76,-35,28
Raith,216,1,23,8,5,71,32,39,77
Ayr,216,2,24,4,8,92,43,49,76
Arbroath,216,3,18,8,10,73,49,24,62
Alloa,216,4,17,8,11,56,46,10,59
Stranraer,216,5,15,6,15,58,67,-9,51
Airdrieon,216,6,11,11,14,48,58,-10,44
East Fife,216,7,13,4,19,50,67,-17,43
Forfar,216,8,10,5,21,38,67,-29,35
Albion,216,9,8,6,22,58,80,-22,30
Queen's Park,216,10,6,10,20,40,75,-35,28
Raith,217,1,23,8,5,70,32,38,77
Ayr,217,2,24,4,8,94,44,50,76
Arbroath,217,3,18,8,10,75,49,26,62
Alloa,217,4,17,8,11,56,45,11,59
Stranraer,217,5,16,5,15,57,64,-7,53
Airdrieon,217,6,11,11,14,48,58,-10,44
East Fife,217,7,13,3,20,47,66,-19,42
Forfar,217,8,10,5,21,38,67,-29,35
Albion,217,9,8,6,22,59,82,-23,30
Queen's Park,217,10,6,10,20,40,77,-37,28
Raith,218,1,23,8,5,71,32,39,77
Ayr,218,2,24,4,8,95,45,50,76
Arbroath,218,3,17,9,10,72,50,22,60
Alloa,218,4,17,8,11,56,46,10,59
Stranraer,218,5,15,5,16,56,68,-12,50
East Fife,218,6,14,3,19,51,65,-14,45
Airdrieon,218,7,11,11,14,47,59,-12,44
Forfar,218,8,10,5,21,39,66,-27,35
Albion,218,9,8,6,22,60,83,-23,30
Queen's Park,218,10,6,11,19,41,74,-33,29
Raith,219,1,23,8,5,71,34,37,77
Ayr,219,2,24,4,8,92,43,49,76
Arbroath,219,3,18,8,10,72,49,23,62
Alloa,219,4,17,8,11,58,46,12,59
Stranraer,219,5,15,5,16,55,67,-12,50
East Fife,219,6,14,3,19,50,64,-14,45
Airdrieon,219,7,10,12,14,46,59,-13,42
Forfar,219,8,10,6,20,39,65,-26,36
Albion,219,9,8,6,22,58,80,-22,30
Queen's Park,219,10,6,10,20,40,74,-34,28
Ayr,220,1,24,4,8,94,43,51,76
Raith,220,2,22,8,6,68,35,33,74
Alloa,220,3,18,8,10,59,43,16,62
Arbroath,220,4,17,9,10,70,48,22,60
Stranraer,220,5,15,6,15,56,65,-9,51
Airdrieon,220,6,11,11,14,47,59,-12,44
East Fife,220,7,13,4,19,48,65,-17,43
Forfar,220,8,10,5,21,39,66,-27,35
Albion,220,9,8,6,22,58,82,-24,30
Queen's Park,220,10,6,11,19,39,72,-33,29
Raith,221,1,22,9,5,69,33,36,75
Ayr,221,2,23,5,8,92,44,48,74
Arbroath,221,3,18,8,10,73,49,24,62
Alloa,221,4,17,9,10,57,44,13,60
Stranraer,221,5,15,5,16,55,65,-10,50
East Fife,221,6,14,3,19,48,64,-16,45
Airdrieon,221,7,10,11,15,45,59,-14,41
Forfar,221,8,11,5,20,39,64,-25,38
Albion,221,9,8,7,21,59,80,-21,31
Queen's Park,221,10,6,10,20,40,75,-35,28
Raith,222,1,23,8,5,70,32,38,77
Ayr,222,2,24,4,8,93,43,50,76
Arbroath,222,3,18,8,10,72,48,24,62
Alloa,222,4,17,8,11,56,45,11,59
Stranraer,222,5,15,5,16,56,67,-11,50
East Fife,222,6,14,3,19,50,65,-15,45
Airdrieon,222,7,10,12,14,46,59,-13,42
Forfar,222,8,10,6,20,39,65,-26,36
Albion,222,9,8,6,22,58,81,-23,30
Queen's Park,222,10,6,10,20,39,74,-35,28
Raith,223,1,23,8,5,71,34,37,77
Ayr,223,2,24,4,8,96,43,53,76
Arbroath,223,3,18,8,10,72,48,24,62
Alloa,223,4,17,8,11,58,46,12,59
Stranraer,223,5,15,6,15,55,64,-9,51
Airdrieon,223,6,11,11,14,47,58,-11,44
East Fife,223,7,13,4,19,47,64,-17,43
Forfar,223,8,10,5,21,38,66,-28,35
Albion,223,9,8,6,22,58,84,-26,30
Queen's Park,223,10,6,10,20,39,74,-35,28
Raith,224,1,23,8,5,72,34,38,77
Ayr,224,2,23,4,9,91,45,46,73
Arbroath,224,3,17,8,11,70,50,20,59
Alloa,224,4,17,8,11,58,47,11,59
Stranraer,224,5,15,5,16,56,68,-12,50
East Fife,224,6,14,3,19,51,65,-14,45
Airdrieon,224,7,10,11,15,46,60,-14,41
Forfar,224,8,11,5,20,40,65,-25,38
Albion,224,9,9,6,21,60,79,-19,33
Queen's Park,224,10,7,10,19,41,72,-31,31
Raith,225,1,23,8,5,70,32,38,77
Ayr,225,2,24,4,8,94,44,50,76
Arbroath,225,3,17,9,10,71,49,22,60
Alloa,225,4,17,8,11,56,45,11,59
Stranraer,225,5,16,5,15,56,64,-8,53
Airdrieon,225,6,11,11,14,49,59,-10,44
East Fife,225,7,13,3,20,47,65,-18,42
Forfar,225,8,10,5,21,39,68,-29,35
Albion,225,9,8,6,22,59,82,-23,30
Queen's Park,225,10,6,11,19,40,73,-33,29
Raith,226,1,23,8,5,70,33,37,77
Ayr,226,2,23,4,9,92,45,47,73
Arbroath,226,3,18,8,10,72,48,24,62
Alloa,226,4,17,8,11,57,45,12,59
Stranraer,226,5,16,5,15,58,65,-7,53
Airdrieon,226,6,10,12,14,46,59,-13,42
East Fife,226,7,13,3,20,48,67,-19,42
Forfar,226,8,10,6,20,39,65,-26,36
Albion,226,9,9,6,21,60,80,-20,33
Queen's Park,226,10,6,10,20,39,74,-35,28
Raith,227,1,23,8,5,70,32,38,77
Ayr,227,2,23,5,8,91,43,48,74
Arbroath,227,3,17,8,11,71,51,20,59
Alloa,227,4,17,8,11,56,45,11,59
Stranraer,227,5,15,5,16,55,70,-15,50
East Fife,227,6,14,3,19,53,64,-11,45
Airdrieon,227,7,11,11,14,48,58,-10,44
Forfar,227,8,10,5,21,38,67,-29,35
Albion,227,9,8,7,21,58,79,-21,31
Queen's Park,227,10,7,10,19,42,73,-31,31
Ayr,228,1,24,4,8,97,45,52,76
Raith,228,2,22,8,6,68,33,35,74
Arbroath,228,3,18,8,10,72,48,24,62
Alloa,228,4,18,8,10,57,43,14,62
Stranraer,228,5,15,5,16,56,69,-13,50
East Fife,228,6,14,3,19,52,65,-13,45
Airdrieon,228,7,10,12,14,46,59,-13,42
Forfar,228,8,10,6,20,39,65,-26,36
Albion,228,9,8,6,22,60,85,-25,30
Queen's Park,228,10,6,10,20,39,74,-35,28
Ayr,229,1,23,5,8,91,43,48,74
Raith,229,2,22,8,6,71,36,35,74
Alloa,229,3,18,8,10,60,46,14,62
Arbroath,229,4,17,8,11,71,51,20,59
Stranraer,229,5,15,5,16,55,67,-12,50
East Fife,229,6,14,3,19,50,64,-14,45
Airdrieon,229,7,10,11,15,45,61,-16,41
Forfar,229,8,11,5,20,41,64,-23,38
Albion,229,9,8,7,21,58,79,-21,31
Queen's Park,229,10,7,10,19,42,73,-31,31
Raith,230,1,23,8,5,70,32,38,77
Ayr,230,2,24,4,8,93,44,49,76
Arbroath,230,3,17,8,11,72,51,21,59
Alloa,230,4,17,8,11,56,45,11,59
Stranraer,230,5,16,5,15,56,64,-8,53
East Fife,230,6,13,3,20,47,65,-18,42
Airdrieon,230,7,10,11,15,46,61,-15,41
Forfar,230,8,11,5,20,41,65,-24,38
Queen's Park,230,9,7,10,19,42,74,-32,31
Albion,230,10,8,6,22,59,81,-22,30
Raith,231,1,23,8,5,72,34,38,77
Ayr,231,2,24,4,8,96,42,54,76
Arbroath,231,3,18,8,10,73,49,24,62
Alloa,231,4,17,8,11,58,47,11,59
Stranraer,231,5,15,5,16,56,68,-12,50
East Fife,231,6,14,3,19,51,65,-14,45
Airdrieon,231,7,11,11,14,47,59,-12,44
Forfar,231,8,10,5,21,39,66,-27,35
Albion,231,9,8,6,22,57,84,-27,30
Queen's Park,231,10,6,10,20,40,75,-35,28
Raith,232,1,23,8,5,69,32,37,77
Ayr,232,2,24,4,8,93,43,50,76
Arbroath,232,3,18,8,10,72,48,24,62
Alloa,232,4,17,8,11,56,44,12,59
Stranraer,232,5,16,5,15,58,65,-7,53
Airdrieon,232,6,11,11,14,46,58,-12,44
East Fife,232,7,13,3,20,48,67,-19,42
Forfar,232,8,10,5,21,38,65,-27,35
Albion,232,9,8,6,22,58,81,-23,30
Queen's Park,232,10,6,10,20,39,74,-35,28
Raith,233,1,23,8,5,69,32,37,77
Ayr,233,2,23,5,8,93,45,48,74
Arbroath,233,3,18,8,10,72,49,23,62
Alloa,233,4,17,8,11,56,44,12,59
Stranraer,233,5,15,6,15,58,67,-9,51
Airdrieon,233,6,11,11,14,47,58,-11,44
East Fife,233,7,13,4,19,50,67,-17,43
Forfar,233,8,10,5,21,38,66,-28,35
Albion,233,9,8,7,21,60,81,-21,31
Queen's Park,233,10,6,10,20,40,74,-34,28
Ayr,234,1,24,4,8,95,42,53,76
Raith,234,2,22,8,6,68,34,34,74
Arbroath,234,3,18,8,10,73,50,23,62
Alloa,234,4,18,8,10,58,43,15,62
Stranraer,234,5,15,5,16,56,68,-12,50
East Fife,234,6,14,3,19,51,65,-14,45
Airdrieon,234,7,10,11,15,45,59,-14,41
Forfar,234,8,11,5,20,39,64,-25,38
Albion,234,9,8,6,22,57,83,-26,30
Queen's Park,234,10,6,10,20,41,75,-34,28
Raith,235,1,23,8,5,70,32,38,77
Ayr,235,2,23,4,9,91,44,47,73
Arbroath,235,3,18,8,10,74,51,23,62
Alloa,235,4,17,8,11,56,45,11,59
Stranraer,235,5,16,5,15,59,65,-6,53
Airdrieon,235,6,11,11,14,47,58,-11,44
East Fife,235,7,13,3,20,48,68,-20,42
Forfar,235,8,10,5,21,38,66,-28,35
Albion,235,9,9,6,21,59,79,-20,33
Queen's Park,235,10,6,10,20,42,76,-34,28
Ayr,236,1,24,4,8,94,44,50,76
Raith,236,2,22,8,6,68,33,35,74
Alloa,236,3,18,8,10,57,43,14,62
Arbroath,236,4,17,9,10,70,48,22,60
Stranraer,236,5,15,6,15,56,65,-9,51
East Fife,236,6,13,4,19,48,65,-17,43
Airdrieon,236,7,10,11,15,45,60,-15,41
Forfar,236,8,11,5,20,40,64,-24,38
Albion,236,9,8,6,22,59,82,-23,30
Queen's Park,236,10,6,11,19,39,72,-33,29
Ayr,237,1,24,4,8,96,43,53,76
Raith,237,2,22,9,5,69,33,36,75
Arbroath,237,3,18,8,10,74,50,24,62
Alloa,237,4,17,9,10,57,44,13,60
Stranraer,237,5,16,5,15,58,66,-8,53
Airdrieon,237,6,11,11,14,47,58,-11,44
East Fife,237,7,13,3,20,49,67,-18,42
Forfar,237,8,10,5,21,38,66,-28,35
Albion,237,9,8,6,22,58,84,-26,30
Queen's Park,237,10,6,10,20,41,76,-35,28
Ayr,238,1,24,4,8,92,43,49,76
Raith,238,2,22,8,6,68,34,34,74
Alloa,238,3,18,8,10,58,43,15,62
Arbroath,238,4,17,8,11,71,51,20,59
Stranraer,238,5,16,5,15,57,65,-8,53
Airdrieon,238,6,11,11,14,48,59,-11,44
East Fife,238,7,13,3,20,48,66,-18,42
Forfar,238,8,10,5,21,39,67,-28,35
Queen's Park,238,9,7,10,19,42,73,-31,31
Albion,238,10,8,6,22,58,80,-22,30
Raith,239,1,22,8,6,68,34,34,74
Ayr,239,2,23,4,9,91,44,47,73
Arbroath,239,3,18,8,10,72,48,24,62
Alloa,239,4,18,8,10,58,43,15,62
Stranraer,239,5,16,5,15,58,65,-7,53
Airdrieon,239,6,11,11,14,48,59,-11,44
East Fife,239,7,13,3,20,48,67,-19,42
Forfar,239,8,10,5,21,39,67,-28,35
Albion,239,9,9,6,21,59,79,-20,33
Queen's Park,239,10,6,10,20,39,74,-35,28
Raith,240,1,23,8,5,72,32,40,77
Ayr,240,2,24,4,8,92,43,49,76
Arbroath,240,3,17,9,10,72,50,22,60
Alloa,240,4,17,8,11,56,47,9,59
Stranraer,240,5,15,5,16,56,67,-11,50
East Fife,240,6,14,3,19,50,65,-15,45
Airdrieon,240,7,10,11,15,45,59,-14,41
Forfar,240,8,11,5,20,39,64,-25,38
Albion,240,9,8,6,22,58,80,-22,30
Queen's Park,240,10,6,11,19,41,74,-33,29
Raith,241,1,23,8,5,70,32,38,77
Ayr,241,2,24,4,8,96,43,53,76
Arbroath,241,3,18,8,10,73,48,25,62
Alloa,241,4,17,8,11,56,45,11,59
Stranraer,241,5,15,6,15,57,66,-9,51
East Fife,241,6,13,4,19,49,66,-17,43
Airdrieon,241,7,10,11,15,46,61,-15,41
Forfar,241,8,11,5,20,41,65,-24,38
Albion,241,9,8,6,22,58,84,-26,30
Queen's Park,241,10,6,10,20,39,75,-36,28
Raith,242,1,23,8,5,73,34,39,77
Ayr,242,2,24,4,8,100,43,57,76
Arbroath,242,3,18,8,10,71,48,23,62
Alloa,242,4,17,8,11,58,48,10,59
Stranraer,242,5,16,5,15,58,64,-6,53
Airdrieon,242,6,11,11,14,47,58,-11,44
East Fife,242,7,13,3,20,47,67,-20,42
Forfar,242,8,10,5,21,38,66,-28,35
Albion,242,9,8,6,22,58,88,-30,30
Queen's Park,242,10,6,10,20,39,73,-34,28
Ayr,243,1,23,5,8,91,43,48,74
Raith,243,2,22,8,6,68,35,33,74
Alloa,243,3,18,8,10,59,43,16,62
Arbroath,243,4,17,8,11,72,51,21,59
Stranraer,243,5,15,5,16,55,68,-13,50
East Fife,243,6,14,3,19,51,64,-13,45
Airdrieon,243,7,10,12,14,45,58,-13,42
Forfar,243,8,10,6,20,38,64,-26,36
Albion,243,9,8,7,21,58,79,-21,31
Queen's Park,243,10,7,10,19,42,74,-32,31
Ayr,244,1,24,4,8,95,43,52,76
Raith,244,2,22,9,5,69,33,36,75
Arbroath,244,3,18,8,10,73,48,25,62
Alloa,244,4,17,9,10,57,44,13,60
Stranraer,244,5,16,5,15,56,64,-8,53
Airdrieon,244,6,11,11,14,46,58,-12,44
East Fife,244,7,13,3,20,47,65,-18,42
Forfar,244,8,10,5,21,38,65,-27,35
Albion,244,9,8,6,22,58,83,-25,30
Queen's Park,244,10,6,10,20,39,75,-36,28
Raith,245,1,23,8,5,70,32,38,77
Ayr,245,2,24,4,8,96,42,54,76
Arbroath,245,3,17,8,11,71,50,21,59
Alloa,245,4,17,8,11,56,45,11,59
Stranraer,245,5,15,5,16,56,66,-10,50
East Fife,245,6,14,3,19,49,65,-16,45
Airdrieon,245,7,11,11,14,48,59,-11,44
Forfar,245,8,10,5,21,39,67,-28,35
Queen's Park,245,9,7,10,19,41,73,-32,31
Albion,245,10,8,6,22,57,84,-27,30
Ayr,246,1,24,4,8,93,43,50,76
Raith,246,2,22,9,5,69,33,36,75
Alloa,246,3,17,9,10,57,44,13,60
Arbroath,246,4,17,8,11,71,50,21,59
Stranraer,246,5,15,5,16,55,65,-10,50
East Fife,246,6,14,3,19,48,64,-16,45
Airdrieon,246,7,10,12,14,47,60,-13,42
Forfar,246,8,10,6,20,40,66,-26,36
Queen's Park,246,9,7,10,19,41,73,-32,31
Albion,246,10,8,6,22,58,81,-23,30
Ayr,247,1,24,4,8,94,44,50,76
Raith,247,2,22,9,5,69,33,36,75
Arbroath,247,3,18,8,10,74,49,25,62
Alloa,247,4,17,9,10,57,44,13,60
Stranraer,247,5,15,5,16,56,70,-14,50
East Fife,247,6,14,3,19,53,65,-12,45
Airdrieon,247,7,11,11,14,49,59,-10,44
Forfar,247,8,10,5,21,39,68,-29,35
Albion,247,9,8,6,22,59,82,-23,30
Queen's Park,247,10,6,10,20,40,76,-36,28
Raith,248,1,23,8,5,70,33,37,77
Ayr,248,2,24,4,8,94,43,51,76
Arbroath,248,3,18,8,10,73,49,24,62
Alloa,248,4,17,8,11,57,45,12,59
Stranraer,248,5,16,5,15,56,64,-8,53
Airdrieon,248,6,11,11,14,46,58,-12,44
East Fife,248,7,13,3,20,47,65,-18,42
Forfar,248,8,10,5,21,38,65,-27,35
Albion,248,9,8,6,22,58,82,-24,30
Queen's Park,248,10,6,10,20,40,75,-35,28
Raith,249,1,22,9,5,68,32,36,75
Ayr,249,2,23,5,8,93,45,48,74
Arbroath,249,3,18,8,10,75,49,26,62
Alloa,249,4,17,9,10,56,43,13,60
Stranraer,249,5,15,6,15,57,66,-9,51
Airdrieon,249,6,11,11,14,49,61,-12,44
East Fife,249,7,13,4,19,49,66,-17,43
Forfar,249,8,10,5,21,41,68,-27,35
Albion,249,9,8,7,21,60,81,-21,31
Queen's Park,249,10,6,10,20,40,77,-37,28
Ayr,250,1,24,4,8,94,43,51,76
Raith,250,2,22,8,6,68,33,35,74
Alloa,250,3,18,8,10,57,43,14,62
Arbroath,250,4,17,8,11,72,51,21,59
Stranraer,250,5,15,6,15,56,65,-9,51
East Fife,250,6,13,4,19,48,65,-17,43
Airdrieon,250,7,10,12,14,45,58,-13,42
Forfar,250,8,10,6,20,38,64,-26,36
Queen's Park,250,9,7,10,19,42,74,-32,31
Albion,250,10,8,6,22,58,82,-24,30
Raith,251,1,23,8,5,71,33,38,77
Ayr,251,2,24,4,8,94,43,51,76
Arbroath,251,3,17,9,10,70,48,22,60
Alloa,251,4,17,8,11,57,46,11,59
Stranraer,251,5,15,6,15,58,67,-9,51
Airdrieon,251,6,11,11,14,48,59,-11,44
East Fife,251,7,13,4,19,50,67,-17,43
Forfar,251,8,10,5,21,39,67,-28,35
Albion,251,9,8,6,22,58,82,-24,30
Queen's Park,251,10,6,11,19,39,72,-33,29
Ayr,252,1,24,4,8,95,44,51,76
Raith,252,2,22,8,6,68,37,31,74
Arbroath,252,3,18,8,10,73,49,24,62
Alloa,252,4,18,8,10,61,43,18,62
Stranraer,252,5,15,5,16,55,65,-10,50
East Fife,252,6,14,3,19,48,64,-16,45
Airdrieon,252,7,11,11,14,46,58,-12,44
Forfar,252,8,10,5,21,38,65,-27,35
Albion,252,9,8,6,22,59,83,-24,30
Queen's Park,252,10,6,10,20,40,75,-35,28
Raith,253,1,23,8,5,72,32,40,77
Ayr,253,2,24,4,8,93,42,51,76
Arbroath,253,3,17,9,10,72,50,22,60
Alloa,253,4,17,8,11,56,47,9,59
Stranraer,253,5,15,6,15,56,65,-9,51
Airdrieon,253,6,11,11,14,48,58,-10,44
East Fife,253,7,13,4,19,48,65,-17,43
Forfar,253,8,10,5,21,38,67,-29,35
Albion,253,9,8,6,22,57,81,-24,30
Queen's Park,253,10,6,11,19,41,74,-33,29
Raith,254,1,22,9,5,69,33,36,75
Ayr,254,2,23,5,8,93,45,48,74
Arbroath,254,3,18,8,10,71,48,23,62
Alloa,254,4,17,9,10,57,44,13,60
Stranraer,254,5,15,5,16,56,67,-11,50
East Fife,254,6,14,3,19,50,65,-15,45
Airdrieon,254,7,11,11,14,48,60,-12,44
Forfar,254,8,10,5,21,40,67,-27,35
Albion,254,9,8,7,21,60,81,-21,31
Queen's Park,254,10,6,10,20,39,73,-34,28
Raith,255,1,23,8,5,71,32,39,77
Ayr,255,2,24,4,8,94,43,51,76
Arbroath,255,3,17,8,11,71,52,19,59
Alloa,255,4,17,8,11,56,46,10,59
Stranraer,255,5,16,5,15,57,65,-8,53
Airdrieon,255,6,11,11,14,47,58,-11,44
East Fife,255,7,13,3,20,48,66,-18,42
Forfar,255,8,10,5,21,38,66,-28,35
Queen's Park,255,9,7,10,19,43,73,-30,31
Albion,255,10,8,6,22,58,82,-24,30
Raith,256,1,23,8,5,70,33,37,77
Ayr,256,2,24,4,8,95,42,53,76
Arbroath,256,3,17,8,11,71,51,20,59
Alloa,256,4,17,8,11,57,45,12,59
Stranraer,256,5,16,5,15,57,65,-8,53
East Fife,256,6,13,3,20,48,66,-18,42
Airdrieon,256,7,10,11,15,46,61,-15,41
Forfar,256,8,11,5,20,41,65,-24,38
Queen's Park,256,9,7,10,19,42,73,-31,31
Albion,256,10,8,6,22,57,83,-26,30
Ayr,257,1,24,4,8,92,43,49,76
Raith,257,2,22,9,5,69,33,36,75
Arbroath,257,3,18,8,10,72,49,23,62
Alloa,257,4,17,9,10,57,44,13,60
Stranraer,257,5,15,6,15,56,65,-9,51
Airdrieon,257,6,11,11,14,47,58,-11,44
East Fife,257,7,13,4,19,48,65,-17,43
Forfar,257,8,10,5,21,38,66,-28,35
Albion,257,9,8,6,22,58,80,-22,30
Queen's Park,257,10,6,10,20,40,74,-34,28
Ayr,258,1,24,4,8,94,43,51,76
Raith,258,2,22,9,5,68,32,36,75
Arbroath,258,3,17,9,10,71,49,22,60
Alloa,258,4,17,9,10,56,43,13,60
Stranraer,258,5,15,5,16,55,65,-10,50
East Fife,258,6,14,3,19,48,64,-16,45
Airdrieon,258,7,11,11,14,49,59,-10,44
Forfar,258,8,10,5,21,39,68,-29,35
Albion,258,9,8,6,22,58,82,-24,30
Queen's Park,258,10,6,11,19,40,73,-33,29
Raith,259,1,23,8,5,70,32,38,77
Ayr,259,2,24,4,8,93,44,49,76
Arbroath,259,3,17,9,10,70,48,22,60
Alloa,259,4,17,8,11,56,45,11,59
Stranraer,259,5,16,5,15,59,67,-8,53
Airdrieon,259,6,11,11,14,47,59,-12,44
East Fife,259,7,13,3,20,50,68,-18,42
Forfar,259,8,10,5,21,39,66,-27,35
Albion,259,9,8,6,22,59,81,-22,30
Queen's Park,259,10,6,11,19,39,72,-33,29
Raith,260,1,23,8,5,71,32,39,77
Ayr,260,2,24,4,8,93,44,49,76
Arbroath,260,3,18,8,10,72,48,24,62
Alloa,260,4,17,8,11,56,46,10,59
Stranraer,260,5,15,6,15,56,65,-9,51
East Fife,260,6,13,4,19,48,65,-17,43
Airdrieon,260,7,10,11,15,46,60,-14,41
Forfar,260,8,11,5,20,40,65,-25,38
Albion,260,9,8,6,22,59,81,-22,30
Queen's Park,260,10,6,10,20,39,74,-35,28
Raith,261,1,23,8,5,73,34,39,77
Ayr,261,2,23,5,8,91,43,48,74
Arbroath,261,3,17,8,11,70,51,19,59
Alloa,261,4,17,8,11,58,48,10,59
Stranraer,261,5,15,5,16,57,67,-10,50
East Fife,261,6,14,3,19,50,66,-16,45
Airdrieon,261,7,10,11,15,45,62,-17,41
Forfar,261,8,11,5,20,42,64,-22,38
Albion,261,9,8,7,21,58,79,-21,31
Queen's Park,261,10,7,10,19,42,72,-30,31
Ayr,262,1,24,4,8,93,42,51,76
Raith,262,2,22,9,5,69,33,36,75
Alloa,262,3,17,9,10,57,44,13,60
Arbroath,262,4,17,8,11,71,51,20,59
Stranraer,262,5,16,5,15,59,64,-5,53
Airdrieon,262,6,11,11,14,46,58,-12,44
East Fife,262,7,13,3,20,47,68,-21,42
Forfar,262,8,10,5,21,38,65,-27,35
Queen's Park,262,9,7,10,19,42,73,-31,31
Albion,262,10,8,6,22,57,81,-24,30
Ayr,263,1,24,4,8,96,42,54,76
Raith,263,2,22,8,6,68,33,35,74
Alloa,263,3,18,8,10,57,43,14,62
Arbroath,263,4,17,8,11,70,51,19,59
Stranraer,263,5,15,5,16,55,65,-10,50
East Fife,263,6,14,3,19,48,64,-16,45
Airdrieon,263,7,11,11,14,47,58,-11,44
Forfar,263,8,10,5,21,38,66,-28,35
Queen's Park,263,9,7,10,19,42,72,-30,31
Albion,263,10,8,6,22,57,84,-27,30
Raith,264,1,23,8,5,69,32,37,77
Ayr,264,2,23,5,8,92,44,48,74
Arbroath,264,3,18,8,10,72,48,24,62
Alloa,264,4,17,8,11,56,44,12,59
Stranraer,264,5,16,5,15,57,65,-8,53
East Fife,264,6,13,3,20,48,66,-18,42
Airdrieon,264,7,10,11,15,46,60,-14,41
Forfar,264,8,11,5,20,40,65,-25,38
Albion,264,9,8,7,21,59,80,-21,31
Queen's Park,264,10,6,10,20,39,74,-35,28
Raith,265,1,22,8,6,69,34,35,74
Ayr,265,2,23,4,9,92,45,47,73
Alloa,265,3,18,8,10,58,44,14,62
Arbroath,265,4,17,9,10,71,49,22,60
Stranraer,265,5,16,5,15,56,64,-8,53
Airdrieon,265,6,10,12,14,46,59,-13,42
East Fife,265,7,13,3,20,47,65,-18,42
Forfar,265,8,10,6,20,39,65,-26,36
Albion,265,9,9,6,21,60,80,-20,33
Queen's Park,265,10,6,11,19,40,73,-33,29
Raith,266,1,23,8,5,72,35,37,77
Ayr,266,2,24,4,8,92,42,50,76
Arbroath,266,3,18,8,10,74,49,25,62
Alloa,266,4,17,8,11,59,47,12,59
Stranraer,266,5,15,5,16,55,66,-11,50
East Fife,266,6,14,3,19,49,64,-15,45
Airdrieon,266,7,11,11,14,47,58,-11,44
Forfar,266,8,10,5,21,38,66,-28,35
Albion,266,9,8,6,22,57,80,-23,30
Queen's Park,266,10,6,10,20,40,76,-36,28
Ayr,267,1,24,4,8,97,42,55,76
Raith,267,2,22,8,6,70,35,35,74
Arbroath,267,3,18,8,10,71,48,23,62
Alloa,267,4,18,8,10,59,45,14,62
Stranraer,267,5,15,5,16,55,68,-13,50
East Fife,267,6,14,3,19,51,64,-13,45
Airdrieon,267,7,11,11,14,46,58,-12,44
Forfar,267,8,10,5,21,38,65,-27,35
Albion,267,9,8,6,22,57,85,-28,30
Queen's Park,267,10,6,10,20,39,73,-34,28
Raith,268,1,23,8,5,69,32,37,77
Ayr,268,2,23,5,8,93,45,48,74
Arbroath,268,3,17,9,10,72,50,22,60
Alloa,268,4,17,8,11,56,44,12,59
Stranraer,268,5,16,5,15,57,64,-7,53
Airdrieon,268,6,10,12,14,45,58,-13,42
East Fife,268,7,13,3,20,47,66,-19,42
Forfar,268,8,10,6,20,38,64,-26,36
Albion,268,9,8,7,21,60,81,-21,31
Queen's Park,268,10,6,11,19,41,74,-33,29
Ayr,269,1,24,4,8,98,44,54,76
Raith,269,2,22,8,6,69,34,35,74
Alloa,269,3,18,8,10,58,44,14,62
Arbroath,269,4,17,8,11,70,50,20,59
Stranraer,269,5,15,5,16,57,67,-10,50
East Fife,269,6,14,3,19,50,66,-16,45
Airdrieon,269,7,10,11,15,45,59,-14,41
Forfar,269,8,11,5,20,39,64,-25,38
Queen's Park,269,9,7,10,19,41,72,-31,31
Albion,269,10,8,6,22,59,86,-27,30
Raith,270,1,23,8,5,71,32,39,77
Ayr,270,2,23,5,8,91,43,48,74
Arbroath,270,3,18,8,10,73,49,24,62
Alloa,270,4,17,8,11,56,46,10,59
Stranraer,270,5,15,5,16,55,68,-13,50
East Fife,270,6,14,3,19,51,64,-13,45
Airdrieon,270,7,10,11,15,47,61,-14,41
Forfar,270,8,11,5,20,41,66,-25,38
Albion,270,9,8,7,21,58,79,-21,31
Queen's Park,270,10,6,10,20,40,75,-35,28
Raith,271,1,23,8,5,70,33,37,77
Ayr,271,2,24,4,8,94,44,50,76
Arbroath,271,3,17,8,11,70,49,21,59
Alloa,271,4,17,8,11,57,45,12,59
Stranraer,271,5,15,5,16,57,68,-11,50
East Fife,271,6,14,3,19,51,66,-15,45
Airdrieon,271,7,11,11,14,48,60,-12,44
Forfar,271,8,10,5,21,40,67,-27,35
Queen's Park,271,9,7,10,19,40,72,-32,31
Albion,271,10,8,6,22,59,82,-23,30
Raith,272,1,23,8,5,69,32,37,77
Ayr,272,2,23,4,9,92,45,47,73
Arbroath,272,3,18,8,10,73,49,24,62
Alloa,272,4,17,8,11,56,44,12,59
Stranraer,272,5,15,5,16,55,68,-13,50
East Fife,272,6,14,3,19,51,64,-13,45
Airdrieon,272,7,11,11,14,46,58,-12,44
Forfar,272,8,10,5,21,38,65,-27,35
Albion,272,9,9,6,21,60,80,-20,33
Queen's Park,272,10,6,10,20,40,75,-35,28
Ayr,273,1,24,4,8,94,43,51,76
Raith,273,2,22,9,5,69,33,36,75
Alloa,273,3,17,9,10,57,44,13,60
Arbroath,273,4,17,8,11,72,51,21,59
Stranraer,273,5,16,5,15,57,65,-8,53
Airdrieon,273,6,11,11,14,49,59,-10,44
East Fife,273,7,13,3,20,48,66,-18,42
Forfar,273,8,10,5,21,39,68,-29,35
Queen's Park,273,9,7,10,19,42,74,-32,31
Albion,273,10,8,6,22,58,82,-24,30
Raith,274,1,23,8,5,71,32,39,77
Ayr,274,2,24,4,8,92,43,49,76
Arbroath,274,3,18,8,10,71,48,23,62
Alloa,274,4,17,8,11,56,46,10,59
Stranraer,274,5,15,5,16,55,65,-10,50
East Fife,274,6,14,3,19,48,64,-16,45
Airdrieon,274,7,10,12,14,45,58,-13,42
Forfar,274,8,10,6,20,38,64,-26,36
Albion,274,9,8,6,22,58,80,-22,30
Queen's Park,274,10,6,10,20,39,73,-34,28
Raith,275,1,23,8,5,70,33,37,77
Ayr,275,2,24,4,8,94,42,52,76
Arbroath,275,3,18,8,10,73,49,24,62
Alloa,275,4,17,8,11,57,45,12,59
Stranraer,275,5,15,5,16,56,66,-10,50
East Fife,275,6,14,3,19,49,65,-16,45
Airdrieon,275,7,11,11,14,47,59,-12,44
Forfar,275,8,10,5,21,39,66,-27,35
Albion,275,9,8,6,22,57,82,-25,30
Queen's Park,275,10,6,10,20,40,75,-35,28
Raith,276,1,23,8,5,70,32,38,77
Ayr,276,2,23,5,8,92,44,48,74
Arbroath,276,3,18,8,10,73,48,25,62
Alloa,276,4,17,8,11,56,45,11,59
Stranraer,276,5,15,6,15,56,65,-9,51
Airdrieon,276,6,11,11,14,49,60,-11,44
East Fife,276,7,13,4,19,48,65,-17,43
Forfar,276,8,10,5,21,40,68,-28,35
Albion,276,9,8,7,21,59,80,-21,31
Queen's Park,276,10,6,10,20,39,75,-36,28
Raith,277,1,22,9,5,68,32,36,75
Ayr,277,2,23,5,8,91,43,48,74
Arbroath,277,3,18,8,10,72,49,23,62
Alloa,277,4,17,9,10,56,43,13,60
Stranraer,277,5,15,5,16,55,65,-10,50
East Fife,277,6,14,3,19,48,64,-16,45
Airdrieon,277,7,10,11,15,45,59,-14,41
Forfar,277,8,11,5,20,39,64,-25,38
Albion,277,9,8,7,21,58,79,-21,31
Queen's Park,277,10,6,10,20,40,74,-34,28
Raith,278,1,23,8,5,71,33,38,77
Ayr,278,2,24,4,8,94,42,52,76
Arbroath,278,3,18,8,10,72,48,24,62
Alloa,278,4,17,8,11,57,46,11,59
Stranraer,278,5,15,5,16,56,66,-10,50
East Fife,278,6,14,3,19,49,65,-16,45
Airdrieon,278,7,11,11,14,47,59,-12,44
Forfar,278,8,10,5,21,39,66,-27,35
Albion,278,9,8,6,22,57,82,-25,30
Queen's Park,278,10,6,10,20,39,74,-35,28
Raith,279,1,23,8,5,71,33,38,77
Ayr,279,2,24,4,8,94,45,49,76
Arbroath,279,3,17,9,10,73,51,22,60
Alloa,279,4,17,8,11,57,46,11,59
Stranraer,279,5,15,5,16,55,66,-11,50
East Fife,279,6,14,3,19,49,64,-15,45
Airdrieon,279,7,11,11,14,46,58,-12,44
Forfar,279,8,10,5,21,38,65,-27,35
Albion,279,9,8,6,22,60,82,-22,30
Queen's Park,279,10,6,11,19,42,75,-33,29
Raith,280,1,23,8,5,71,34,37,77
Ayr,280,2,23,5,8,90,42,48,74
Arbroath,280,3,18,8,10,74,50,24,62
Alloa,280,4,17,8,11,58,46,12,59
Stranraer,280,5,15,6,15,57,66,-9,51
East Fife,280,6,13,4,19,49,66,-17,43
Airdrieon,280,7,10,11,15,46,60,-14,41
Forfar,280,8,11,5,20,40,65,-25,38
Albion,280,9,8,7,21,57,78,-21,31
Queen's Park,280,10,6,10,20,41,76,-35,28
Raith,281,1,23,8,5,75,33,42,77
Ayr,281,2,24,4,8,95,42,53,76
Arbroath,281,3,18,8,10,74,50,24,62
Alloa,281,4,17,8,11,57,50,7,59
Stranraer,281,5,15,6,15,56,65,-9,51
Airdrieon,281,6,11,11,14,47,59,-12,44
East Fife,281,7,13,4,19,48,65,-17,43
Forfar,281,8,10,5,21,39,66,-27,35
Albion,281,9,8,6,22,57,83,-26,30
Queen's Park,281,10,6,10,20,41,76,-35,28
Raith,282,1,23,8,5,71,34,37,77
Ayr,282,2,23,4,9,92,45,47,73
Arbroath,282,3,18,8,10,74,50,24,62
Alloa,282,4,17,8,11,58,46,12,59
Stranraer,282,5,15,5,16,57,67,-10,50
East Fife,282,6,14,3,19,50,66,-16,45
Airdrieon,282,7,10,11,15,46,60,-14,41
Forfar,282,8,11,5,20,40,65,-25,38
Albion,282,9,9,6,21,60,80,-20,33
Queen's Park,282,10,6,10,20,41,76,-35,28
Ayr,283,1,24,4,8,95,42,53,76
Raith,283,2,22,8,6,70,36,34,74
Arbroath,283,3,18,8,10,72,49,23,62
Alloa,283,4,18,8,10,60,45,15,62
Stranraer,283,5,16,5,15,56,64,-8,53
Airdrieon,283,6,10,12,14,45,58,-13,42
East Fife,283,7,13,3,20,47,65,-18,42
Forfar,283,8,10,6,20,38,64,-26,36
Albion,283,9,8,6,22,57,83,-26,30
Queen's Park,283,10,6,10,20,40,74,-34,28
Raith,284,1,23,8,5,70,33,37,77
Ayr,284,2,23,5,8,93,45,48,74
Arbroath,284,3,17,8,11,70,50,20,59
Alloa,284,4,17,8,11,57,45,12,59
Stranraer,284,5,15,5,16,55,65,-10,50
East Fife,284,6,14,3,19,48,64,-16,45
Airdrieon,284,7,10,12,14,46,59,-13,42
Forfar,284,8,10,6,20,39,65,-26,36
Albion,284,9,8,7,21,60,81,-21,31
Queen's Park,284,10,7,10,19,41,72,-31,31
Raith,285,1,23,8,5,69,32,37,77
Ayr,285,2,24,4,8,93,43,50,76
Arbroath,285,3,17,9,10,71,49,22,60
Alloa,285,4,17,8,11,56,44,12,59
Stranraer,285,5,15,5,16,55,65,-10,50
East Fife,285,6,14,3,19,48,64,-16,45
Airdrieon,285,7,10,11,15,45,60,-15,41
Forfar,285,8,11,5,20,40,64,-24,38
Albion,285,9,8,6,22,58,81,-23,30
Queen's Park,285,10,6,11,19,40,73,-33,29
Ayr,286,1,24,4,8,93,44,49,76
Raith,286,2,22,8,6,68,34,34,74
Arbroath,286,3,18,8,10,76,49,27,62
Alloa,286,4,18,8,10,58,43,15,62
Stranraer,286,5,15,5,16,56,68,-12,50
East Fife,286,6,14,3,19,51,65,-14,45
Airdrieon,286,7,10,11,15,45,61,-16,41
Forfar,286,8,11,5,20,41,64,-23,38
Albion,286,9,8,6,22,59,81,-22,30
Queen's Park,286,10,6,10,20,40,78,-38,28
Ayr,287,1,24,4,8,95,46,49,76
Raith,287,2,22,8,6,68,33,35,74
Alloa,287,3,18,8,10,57,43,14,62
Arbroath,287,4,17,8,11,71,52,19,59
Stranraer,287,5,16,5,15,58,64,-6,53
East Fife,287,6,13,3,20,47,67,-20,42
Airdrieon,287,7,10,11,15,46,61,-15,41
Forfar,287,8,11,5,20,41,65,-24,38
Queen's Park,287,9,7,10,19,43,73,-30,31
Albion,287,10,8,6,22,61,83,-22,30
Raith,288,1,23,8,5,70,33,37,77
Ayr,288,2,24,4,8,95,43,52,76
Arbroath,288,3,18,8,10,72,49,23,62
Alloa,288,4,17,8,11,57,45,12,59
Stranraer,288,5,16,5,15,57,65,-8,53
East Fife,288,6,13,3,20,48,66,-18,42
Airdrieon,288,7,10,11,15,46,60,-14,41
Forfar,288,8,11,5,20,40,65,-25,38
Albion,288,9,8,6,22,58,83,-25,30
Queen's Park,288,10,6,10,20,40,74,-34,28
Raith,289,1,23,8,5,70,33,37,77
Ayr,289,2,24,4,8,94,43,51,76
Arbroath,289,3,17,9,10,72,50,22,60
Alloa,289,4,17,8,11,57,45,12,59
Stranraer,289,5,16,5,15,57,65,-8,53
Airdrieon,289,6,10,12,14,46,59,-13,42
East Fife,289,7,13,3,20,48,66,-18,42
Forfar,289,8,10,6,20,39,65,-26,36
Albion,289,9,8,6,22,58,82,-24,30
Queen's Park,289,10,6,11,19,41,74,-33,29
Raith,290,1,22,8,6,69,34,35,74
Ayr,290,2,23,4,9,92,45,47,73
Alloa,290,3,18,8,10,58,44,14,62
Arbroath,290,4,17,8,11,71,51,20,59
Stranraer,290,5,15,5,16,55,67,-12,50
East Fife,290,6,14,3,19,50,64,-14,45
Airdrieon,290,7,11,11,14,46,58,-12,44
Forfar,290,8,10,5,21,38,65,-27,35
Albion,290,9,9,6,21,60,80,-20,33
Queen's Park,290,10,7,10,19,42,73,-31,31
Raith,291,1,23,8,5,70,32,38,77
Ayr,291,2,24,4,8,96,42,54,76
Arbroath,291,3,18,8,10,74,49,25,62
Alloa,291,4,17,8,11,56,45,11,59
Stranraer,291,5,16,5,15,58,65,-7,53
Airdrieon,291,6,11,11,14,47,59,-12,44
East Fife,291,7,13,3,20,48,67,-19,42
Forfar,291,8,10,5,21,39,66,-27,35
Albion,291,9,8,6,22,57,84,-27,30
Queen's Park,291,10,6,10,20,40,76,-36,28
Ayr,292,1,24,4,8,93,42,51,76
Raith,292,2,22,8,6,69,34,35,74
Alloa,292,3,18,8,10,58,44,14,62
Arbroath,292,4,17,9,10,72,50,22,60
Stranraer,292,5,15,6,15,56,65,-9,51
East Fife,292,6,13,4,19,48,65,-17,43
Airdrieon,292,7,10,11,15,45,59,-14,41
Forfar,292,8,11,5,20,39,64,-25,38
Albion,292,9,8,6,22,57,81,-24,30
Queen's Park,292,10,6,11,19,41,74,-33,29
Ayr,293,1,24,4,8,93,44,49,76
Raith,293,2,22,8,6,68,34,34,74
Arbroath,293,3,18,8,10,73,49,24,62
Alloa,293,4,18,8,10,58,43,15,62
Stranraer,293,5,15,6,15,56,65,-9,51
Airdrieon,293,6,11,11,14,49,59,-10,44
East Fife,293,7,13,4,19,48,65,-17,43
Forfar,293,8,10,5,21,39,68,-29,35
Albion,293,9,8,6,22,59,81,-22,30
Queen's Park,293,10,6,10,20,40,75,-35,28
Raith,294,1,23,8,5,69,32,37,77
Ayr,294,2,24,4,8,96,44,52,76
Arbroath,294,3,18,8,10,71,48,23,62
Alloa,294,4,17,8,11,56,44,12,59
Stranraer,294,5,16,5,15,56,64,-8,53
East Fife,294,6,13,3,20,47,65,-18,42
Airdrieon,294,7,10,11,15,45,61,-16,41
Forfar,294,8,11,5,20,41,64,-23,38
Albion,294,9,8,6,22,59,84,-25,30
Queen's Park,294,10,6,10,20,39,73,-34,28
Ayr,295,1,24,4,8,92,42,50,76
Raith,295,2,22,9,5,70,34,36,75
Alloa,295,3,17,9,10,58,45,13,60
Arbroath,295,4,17,8,11,70,50,20,59
Stranraer,295,5,15,5,16,55,66,-11,50
East Fife,295,6,14,3,19,49,64,-15,45
Airdrieon,295,7,11,11,14,48,58,-10,44
Forfar,295,8,10,5,21,38,67,-29,35
Queen's Park,295,9,7,10,19,41,72,-31,31
Albion,295,10,8,6,22,57,80,-23,30
Raith,296,1,23,8,5,70,32,38,77
Ayr,296,2,24,4,8,97,44,53,76
Arbroath,296,3,17,8,11,71,50,21,59
Alloa,296,4,17,8,11,56,45,11,59
Stranraer,296,5,16,5,15,57,65,-8,53
Airdrieon,296,6,11,11,14,50,61,-11,44
East Fife,296,7,13,3,20,48,66,-18,42
Forfar,296,8,10,5,21,41,69,-28,35
Queen's Park,296,9,7,10,19,41,73,-32,31
Albion,296,10,8,6,22,59,85,-26,30
Raith,297,1,23,8,5,69,32,37,77
Ayr,297,2,23,4,9,92,45,47,73
Arbroath,297,3,18,8,10,71,48,23,62
Alloa,297,4,17,8,11,56,44,12,59
Stranraer,297,5,15,6,15,56,65,-9,51
Airdrieon,297,6,11,11,14,46,58,-12,44
East Fife,297,7,13,4,19,48,65,-17,43
Forfar,297,8,10,5,21,38,65,-27,35
Albion,297,9,9,6,21,60,80,-20,33
Queen's Park,297,10,6,10,20,39,73,-34,28
Raith,298,1,23,8,5,72,32,40,77
Ayr,298,2,24,4,8,92,43,49,76
Arbroath,298,3,17,9,10,71,49,22,60
Alloa,298,4,17,8,11,56,47,9,59
Stranraer,298,5,15,6,15,57,66,-9,51
Airdrieon,298,6,11,11,14,47,58,-11,44
East Fife,298,7,13,4,19,49,66,-17,43
Forfar,298,8,10,5,21,38,66,-28,35
Albion,298,9,8,6,22,58,80,-22,30
Queen's Park,298,10,6,11,19,40,73,-33,29
Ayr,299,1,24,4,8,94,45,49,76
Raith,299,2,22,8,6,69,34,35,74
Arbroath,299,3,18,8,10,74,48,26,62
Alloa,299,4,18,8,10,58,44,14,62
Stranraer,299,5,16,5,15,56,64,-8,53
Airdrieon,299,6,11,11,14,47,59,-12,44
East Fife,299,7,13,3,20,47,65,-18,42
Forfar,299,8,10,5,21,39,66,-27,35
Albion,299,9,8,6,22,60,82,-22,30
Queen's Park,299,10,6,10,20,39,76,-37,28
Ayr,300,1,24,4,8,93,43,50,76
Raith,300,2,22,8,6,69,35,34,74
Alloa,300,3,18,8,10,59,44,15,62
Arbroath,300,4,17,8,11,71,51,20,59
Stranraer,300,5,15,5,16,55,68,-13,50
East Fife,300,6,14,3,19,51,64,-13,45
Airdrieon,300,7,11,11,14,46,58,-12,44
Forfar,300,8,10,5,21,38,65,-27,35
Queen's Park,300,9,7,10,19,42,73,-31,31
Albion,300,10,8,6,22,58,81,-23,30
Raith,301,1,22,9,5,70,34,36,75
Ayr,301,2,23,5,8,93,45,48,74
Alloa,301,3,17,9,10,58,45,13,60
Arbroath,301,4,17,8,11,70,51,19,59
Stranraer,301,5,15,5,16,55,66,-11,50
East Fife,301,6,14,3,19,49,64,-15,45
Airdrieon,301,7,11,11,14,48,58,-10,44
Forfar,301,8,10,5,21,38,67,-29,35
Albion,301,9,8,7,21,60,81,-21,31
Queen's Park,301,10,7,10,19,42,72,-30,31
Ayr,302,1,24,4,8,91,42,49,76
Raith,302,2,22,8,6,69,35,34,74
Arbroath,302,3,18,8,10,74,50,24,62
Alloa,302,4,18,8,10,59,44,15,62
Stranraer,302,5,15,6,15,56,65,-9,51
Airdrieon,302,6,11,11,14,48,59,-11,44
East Fife,302,7,13,4,19,48,65,-17,43
Forfar,302,8,10,5,21,39,67,-28,35
Albion,302,9,8,6,22,57,79,-22,30
Queen's Park,302,10,6,10,20,41,76,-35,28
Raith,303,1,23,8,5,70,32,38,77
Ayr,303,2,24,4,8,94,44,50,76
Arbroath,303,3,17,8,11,73,52,21,59
Alloa,303,4,17,8,11,56,45,11,59
Stranraer,303,5,15,5,16,55,68,-13,50
East Fife,303,6,14,3,19,51,64,-13,45
Airdrieon,303,7,10,11,15,46,60,-14,41
Forfar,303,8,11,5,20,40,65,-25,38
Queen's Park,303,9,7,10,19,43,75,-32,31
Albion,303,10,8,6,22,59,82,-23,30
Raith,304,1,23,8,5,70,33,37,77
Ayr,304,2,23,5,8,92,44,48,74
Arbroath,304,3,18,8,10,73,50,23,62
Alloa,304,4,17,8,11,57,45,12,59
Stranraer,304,5,15,6,15,58,67,-9,51
Airdrieon,304,6,11,11,14,49,59,-10,44
East Fife,304,7,13,4,19,50,67,-17,43
Forfar,304,8,10,5,21,39,68,-29,35
Albion,304,9,8,7,21,59,80,-21,31
Queen's Park,304,10,6,10,20,41,75,-34,28
Raith,305,1,23,8,5,70,33,37,77
Ayr,305,2,24,4,8,99,42,57,76
Arbroath,305,3,17,9,10,70,48,22,60
Alloa,305,4,17,8,11,57,45,12,59
Stranraer,305,5,15,6,15,56,65,-9,51
Airdrieon,305,6,11,11,14,48,58,-10,44
East Fife,305,7,13,4,19,48,65,-17,43
Forfar,305,8,10,5,21,38,67,-29,35
Albion,305,9,8,6,22,57,87,-30,30
Queen's Park,305,10,6,11,19,39,72,-33,29
Ayr,306,1,24,4,8,95,42,53,76
Raith,306,2,22,8,6,69,34,35,74
Alloa,306,3,18,8,10,58,44,14,62
Arbroath,306,4,17,9,10,70,48,22,60
Stranraer,306,5,16,5,15,57,64,-7,53
Airdrieon,306,6,11,11,14,46,58,-12,44
East Fife,306,7,13,3,20,47,66,-19,42
Forfar,306,8,10,5,21,38,65,-27,35
Albion,306,9,8,6,22,57,83,-26,30
Queen's Park,306,10,6,11,19,39,72,-33,29
Ayr,307,1,24,4,8,94,43,51,76
Raith,307,2,22,9,5,68,32,36,75
Arbroath,307,3,18,8,10,72,48,24,62
Alloa,307,4,17,9,10,56,43,13,60
Stranraer,307,5,15,6,15,56,65,-9,51
Airdrieon,307,6,11,11,14,49,58,-9,44
East Fife,307,7,13,4,19,48,65,-17,43
Forfar,307,8,10,5,21,38,68,-30,35
Albion,307,9,8,6,22,58,82,-24,30
Queen's Park,307,10,6,10,20,39,74,-35,28
Raith,308,1,23,8,5,70,32,38,77
Ayr,308,2,24,4,8,94,42,52,76
Arbroath,308,3,17,9,10,71,49,22,60
Alloa,308,4,17,8,11,56,45,11,59
Stranraer,308,5,15,5,16,58,68,-10,50
East Fife,308,6,14,3,19,51,67,-16,45
Airdrieon,308,7,10,11,15,48,62,-14,41
Forfar,308,8,11,5,20,42,67,-25,38
Albion,308,9,8,6,22,57,82,-25,30
Queen's Park,308,10,6,11,19,40,73,-33,29
Ayr,309,1,24,4,8,97,44,53,76
Raith,309,2,22,8,6,69,34,35,74
Arbroath,309,3,18,8,10,74,50,24,62
Alloa,309,4,18,8,10,58,44,14,62
Stranraer,309,5,16,5,15,56,64,-8,53
Airdrieon,309,6,11,11,14,48,59,-11,44
East Fife,309,7,13,3,20,47,65,-18,42
Forfar,309,8,10,5,21,39,67,-28,35
Albion,309,9,8,6,22,59,85,-26,30
Queen's Park,309,10,6,10,20,41,76,-35,28
Raith,310,1,23,8,5,70,32,38,77
Ayr,310,2,24,4,8,92,43,49,76
Arbroath,310,3,17,8,11,71,51,20,59
Alloa,310,4,17,8,11,56,45,11,59
Stranraer,310,5,15,5,16,58,69,-11,50
East Fife,310,6,14,3,19,52,67,-15,45
Airdrieon,310,7,10,12,14,48,61,-13,42
Forfar,310,8,10,6,20,41,67,-26,36
Queen's Park,310,9,7,10,19,42,73,-31,31
Albion,310,10,8,6,22,58,80,-22,30
Raith,311,1,22,9,5,69,33,36,75
Ayr,311,2,23,4,9,91,44,47,73
Alloa,311,3,17,9,10,57,44,13,60
Arbroath,311,4,17,8,11,70,49,21,59
Stranraer,311,5,16,5,15,57,64,-7,53
Airdrieon,311,6,10,12,14,46,59,-13,42
East Fife,311,7,13,3,20,47,66,-19,42
Forfar,311,8,10,6,20,39,65,-26,36
Albion,311,9,9,6,21,59,79,-20,33
Queen's Park,311,10,7,10,19,40,72,-32,31
Raith,312,1,23,8,5,69,32,37,77
Ayr,312,2,24,4,8,92,42,50,76
Arbroath,312,3,18,8,10,72,49,23,62
Alloa,312,4,17,8,11,56,44,12,59
Stranraer,312,5,16,5,15,56,64,-8,53
East Fife,312,6,13,3,20,47,65,-18,42
Airdrieon,312,7,10,11,15,46,60,-14,41
Forfar,312,8,11,5,20,40,65,-25,38
Albion,312,9,8,6,22,57,80,-23,30
Queen's Park,312,10,6,10,20,40,74,-34,28
Ayr,313,1,24,4,8,92,43,49,76
Raith,313,2,22,9,5,69,33,36,75
Arbroath,313,3,18,8,10,76,49,27,62
Alloa,313,4,17,9,10,57,44,13,60
Stranraer,313,5,15,5,16,56,66,-10,50
East Fife,313,6,14,3,19,49,65,-16,45
Airdrieon,313,7,10,12,14,47,60,-13,42
Forfar,313,8,10,6,20,40,66,-26,36
Albion,313,9,8,6,22,58,80,-22,30
Queen's Park,313,10,6,10,20,40,78,-38,28
Ayr,314,1,24,4,8,93,42,51,76
Raith,314,2,22,9,5,69,33,36,75
Alloa,314,3,17,9,10,57,44,13,60
Arbroath,314,4,17,8,11,71,51,20,59
Stranraer,314,5,16,5,15,59,67,-8,53
East Fife,314,6,13,3,20,50,68,-18,42
Airdrieon,314,7,10,11,15,45,61,-16,41
Forfar,314,8,11,5,20,41,64,-23,38
Queen's Park,314,9,7,10,19,42,73,-31,31
Albion,314,10,8,6,22,57,81,-24,30
Raith,315,1,22,8,6,68,33,35,74
Ayr,315,2,23,4,9,90,44,46,73
Arbroath,315,3,18,8,10,72,49,23,62
Alloa,315,4,18,8,10,57,43,14,62
Stranraer,315,5,16,5,15,57,65,-8,53
East Fife,315,6,13,3,20,48,66,-18,42
Airdrieon,315,7,10,11,15,46,60,-14,41
Forfar,315,8,11,5,20,40,65,-25,38
Albion,315,9,9,6,21,59,78,-19,33
Queen's Park,315,10,6,10,20,40,74,-34,28
Raith,316,1,23,8,5,70,32,38,77
Ayr,316,2,24,4,8,94,44,50,76
Arbroath,316,3,17,9,10,72,50,22,60
Alloa,316,4,17,8,11,56,45,11,59
Stranraer,316,5,16,5,15,56,64,-8,53
East Fife,316,6,13,3,20,47,65,-18,42
Airdrieon,316,7,10,11,15,46,60,-14,41
Forfar,316,8,11,5,20,40,65,-25,38
Albion,316,9,8,6,22,59,82,-23,30
Queen's Park,316,10,6,11,19,41,74,-33,29
Raith,317,1,23,8,5,69,32,37,77
Ayr,317,2,24,4,8,95,43,52,76
Arbroath,317,3,17,8,11,71,51,20,59
Alloa,317,4,17,8,11,56,44,12,59
Stranraer,317,5,15,5,16,55,65,-10,50
East Fife,317,6,14,3,19,48,64,-16,45
Airdrieon,317,7,10,11,15,46,60,-14,41
Forfar,317,8,11,5,20,40,65,-25,38
Queen's Park,317,9,7,10,19,42,73,-31,31
Albion,317,10,8,6,22,58,83,-25,30
Ayr,318,1,24,4,8,96,43,53,76
Raith,318,2,22,9,5,69,33,36,75
Arbroath,318,3,18,8,10,72,48,24,62
Alloa,318,4,17,9,10,57,44,13,60
Stranraer,318,5,16,5,15,56,64,-8,53
Airdrieon,318,6,11,11,14,49,59,-10,44
East Fife,318,7,13,3,20,47,65,-18,42
Forfar,318,8,10,5,21,39,68,-29,35
Albion,318,9,8,6,22,58,84,-26,30
Queen's Park,318,10,6,10,20,39,74,-35,28
Raith,319,1,23,8,5,72,33,39,77
Ayr,319,2,24,4,8,96,42,54,76
Arbroath,319,3,17,8,11,70,50,20,59
Alloa,319,4,17,8,11,57,47,10,59
Stranraer,319,5,15,5,16,55,66,-11,50
East Fife,319,6,14,3,19,49,64,-15,45
Airdrieon,319,7,11,11,14,47,58,-11,44
Forfar,319,8,10,5,21,38,66,-28,35
Queen's Park,319,9,7,10,19,41,72,-31,31
Albion,319,10,8,6,22,57,84,-27,30
Ayr,320,1,24,4,8,92,42,50,76
Raith,320,2,22,8,6,68,33,35,74
Alloa,320,3,18,8,10,57,43,14,62
Arbroath,320,4,17,8,11,70,49,21,59
Stranraer,320,5,15,6,15,55,64,-9,51
Airdrieon,320,6,11,11,14,50,60,-10,44
East Fife,320,7,13,4,19,47,64,-17,43
Forfar,320,8,10,5,21,40,69,-29,35
Queen's Park,320,9,7,10,19,40,72,-32,31
Albion,320,10,8,6,22,57,80,-23,30
Raith,321,1,23,8,5,70,32,38,77
Ayr,321,2,24,4,8,96,44,52,76
Arbroath,321,3,17,8,11,71,51,20,59
Alloa,321,4,17,8,11,56,45,11,59
Stranraer,321,5,16,5,15,56,64,-8,53
Airdrieon,321,6,11,11,14,47,59,-12,44
East Fife,321,7,13,3,20,47,65,-18,42
Forfar,321,8,10,5,21,39,66,-27,35
Queen's Park,321,9,7,10,19,42,73,-31,31
Albion,321,10,8,6,22,59,84,-25,30
Raith,322,1,22,9,5,69,33,36,75
Ayr,322,2,23,5,8,93,45,48,74
Alloa,322,3,17,9,10,57,44,13,60
Arbroath,322,4,17,8,11,70,49,21,59
Stranraer,322,5,15,5,16,55,65,-10,50
East Fife,322,6,14,3,19,48,64,-16,45
Airdrieon,322,7,11,11,14,47,59,-12,44
Forfar,322,8,10,5,21,39,66,-27,35
Albion,322,9,8,7,21,60,81,-21,31
Queen's Park,322,10,7,10,19,40,72,-32,31
Raith,323,1,23,8,5,73,33,40,77
Ayr,323,2,24,4,8,94,43,51,76
Arbroath,323,3,17,8,11,72,51,21,59
Alloa,323,4,17,8,11,57,48,9,59
Stranraer,323,5,15,5,16,55,67,-12,50
East Fife,323,6,14,3,19,50,64,-14,45
Airdrieon,323,7,11,11,14,47,59,-12,44
Forfar,323,8,10,5,21,39,66,-27,35
Queen's Park,323,9,7,10,19,42,74,-32,31
Albion,323,10,8,6,22,58,82,-24,30
Raith,324,1,23,8,5,70,32,38,77
Ayr,324,2,24,4,8,92,42,50,76
Arbroath,324,3,18,8,10,73,49,24,62
Alloa,324,4,17,8,11,56,45,11,59
Stranraer,324,5,16,5,15,58,64,-6,53
East Fife,324,6,13,3,20,47,67,-20,42
Airdrieon,324,7,10,11,15,46,60,-14,41
Forfar,324,8,11,5,20,40,65,-25,38
Albion,324,9,8,6,22,57,80,-23,30
Queen's Park,324,10,6,10,20,40,75,-35,28
Raith,325,1,23,8,5,69,32,37,77
Ayr,325,2,24,4,8,96,42,54,76
Arbroath,325,3,18,8,10,72,49,23,62
Alloa,325,4,17,8,11,56,44,12,59
Stranraer,325,5,15,5,16,55,66,-11,50
East Fife,325,6,14,3,19,49,64,-15,45
Airdrieon,325,7,10,11,15,45,59,-14,41
Forfar,325,8,11,5,20,39,64,-25,38
Albion,325,9,8,6,22,57,84,-27,30
Queen's Park,325,10,6,10,20,40,74,-34,28
Ayr,326,1,24,4,8,96,43,53,76
Raith,326,2,22,8,6,70,35,35,74
Alloa,326,3,18,8,10,59,45,14,62
Arbroath,326,4,17,8,11,70,51,19,59
Stranraer,326,5,15,5,16,55,68,-13,50
East Fife,326,6,14,3,19,51,64,-13,45
Airdrieon,326,7,10,12,14,45,58,-13,42
Forfar,326,8,10,6,20,38,64,-26,36
Queen's Park,326,9,7,10,19,42,72,-30,31
Albion,326,10,8,6,22,58,84,-26,30
Raith,327,1,23,8,5,71,34,37,77
Ayr,327,2,23,5,8,92,44,48,74
Arbroath,327,3,18,8,10,72,49,23,62
Alloa,327,4,17,8,11,58,46,12,59
Stranraer,327,5,15,5,16,55,65,-10,50
East Fife,327,6,14,3,19,48,64,-16,45
Airdrieon,327,7,10,11,15,45,59,-14,41
Forfar,327,8,11,5,20,39,64,-25,38
Albion,327,9,8,7,21,59,80,-21,31
Queen's Park,327,10,6,10,20,40,74,-34,28
Raith,328,1,23,8,5,70,33,37,77
Ayr,328,2,24,4,8,96,43,53,76
Arbroath,328,3,17,8,11,70,50,20,59
Alloa,328,4,17,8,11,57,45,12,59
Stranraer,328,5,16,5,15,59,66,-7,53
Airdrieon,328,6,10,12,14,45,58,-13,42
East Fife,328,7,13,3,20,49,68,-19,42
Forfar,328,8,10,6,20,38,64,-26,36
Queen's Park,328,9,7,10,19,41,72,-31,31
Albion,328,10,8,6,22,58,84,-26,30
Ayr,329,1,23,5,8,91,43,48,74
Raith,329,2,22,8,6,68,33,35,74
Alloa,329,3,18,8,10,57,43,14,62
Arbroath,329,4,17,8,11,71,50,21,59
Stranraer,329,5,16,5,15,57,65,-8,53
East Fife,329,6,13,3,20,48,66,-18,42
Airdrieon,329,7,10,11,15,46,60,-14,41
Forfar,329,8,11,5,20,40,65,-25,38
Albion,329,9,8,7,21,58,79,-21,31
Queen's Park,329,10,7,10,19,41,73,-32,31
Raith,330,1,23,8,5,69,32,37,77
Ayr,330,2,23,5,8,95,47,48,74
Arbroath,330,3,17,8,11,72,51,21,59
Alloa,330,4,17,8,11,56,44,12,59
Stranraer,330,5,15,5,16,55,67,-12,50
East Fife,330,6,14,3,19,50,64,-14,45
Airdrieon,330,7,10,11,15,46,61,-15,41
Forfar,330,8,11,5,20,41,65,-24,38
Albion,330,9,8,7,21,62,83,-21,31
Queen's Park,330,10,7,10,19,42,74,-32,31
Raith,331,1,23,8,5,69,32,37,77
Ayr,331,2,24,4,8,97,44,53,76
Arbroath,331,3,17,8,11,71,50,21,59
Alloa,331,4,17,8,11,56,44,12,59
Stranraer,331,5,15,5,16,55,67,-12,50
East Fife,331,6,14,3,19,50,64,-14,45
Airdrieon,331,7,11,11,14,47,58,-11,44
Forfar,331,8,10,5,21,38,66,-28,35
Queen's Park,331,9,7,10,19,41,73,-32,31
Albion,331,10,8,6,22,59,85,-26,30
Raith,332,1,23,8,5,69,32,37,77
Ayr,332,2,24,4,8,94,43,51,76
Arbroath,332,3,18,8,10,73,49,24,62
Alloa,332,4,17,8,11,56,44,12,59
Stranraer,332,5,15,6,15,57,66,-9,51
East Fife,332,6,13,4,19,49,66,-17,43
Airdrieon,332,7,10,11,15,45,60,-15,41
Forfar,332,8,11,5,20,40,64,-24,38
Albion,332,9,8,6,22,58,82,-24,30
Queen's Park,332,10,6,10,20,40,75,-35,28
Ayr,333,1,24,4,8,93,44,49,76
Raith,333,2,22,9,5,68,32,36,75
Arbroath,333,3,18,8,10,72,48,24,62
Alloa,333,4,17,9,10,56,43,13,60
Stranraer,333,5,15,5,16,55,67,-12,50
East Fife,333,6,14,3,19,50,64,-14,45
Airdrieon,333,7,11,11,14,47,58,-11,44
Forfar,333,8,10,5,21,38,66,-28,35
Albion,333,9,8,6,22,59,81,-22,30
Queen's Park,333,10,6,10,20,39,74,-35,28
Raith,334,1,23,8,5,70,32,38,77
Ayr,334,2,24,4,8,93,44,49,76
Arbroath,334,3,18,8,10,71,48,23,62
Alloa,334,4,17,8,11,56,45,11,59
Stranraer,334,5,15,6,15,56,65,-9,51
Airdrieon,334,6,11,11,14,47,59,-12,44
East Fife,334,7,13,4,19,48,65,-17,43
Forfar,334,8,10,5,21,39,66,-27,35
Albion,334,9,8,6,22,59,81,-22,30
Queen's Park,334,10,6,10,20,39,73,-34,28
Raith,335,1,23,8,5,73,32,41,77
Ayr,335,2,24,4,8,96,42,54,76
Arbroath,335,3,18,8,10,71,48,23,62
Alloa,335,4,17,8,11,56,48,8,59
Stranraer,335,5,16,5,15,57,65,-8,53
East Fife,335,6,13,3,20,48,66,-18,42
Airdrieon,335,7,10,11,15,45,60,-15,41
Forfar,335,8,11,5,20,40,64,-24,38
Albion,335,9,8,6,22,57,84,-27,30
Queen's Park,335,10,6,10,20,39,73,-34,28
Raith,336,1,22,9,5,69,33,36,75
Ayr,336,2,23,4,9,92,47,45,73
Arbroath,336,3,18,8,10,74,50,24,62
Alloa,336,4,17,9,10,57,44,13,60
Stranraer,336,5,15,5,16,59,70,-11,50
East Fife,336,6,14,3,19,53,68,-15,45
Airdrieon,336,7,10,12,14,47,60,-13,42
Forfar,336,8,10,6,20,40,66,-26,36
Albion,336,9,9,6,21,62,80,-18,33
Queen's Park,336,10,6,10,20,41,76,-35,28
Ayr,337,1,24,4,8,92,43,49,76
Raith,337,2,22,9,5,69,33,36,75
Arbroath,337,3,18,8,10,71,48,23,62
Alloa,337,4,17,9,10,57,44,13,60
Stranraer,337,5,15,6,15,56,65,-9,51
East Fife,337,6,13,4,19,48,65,-17,43
Airdrieon,337,7,10,12,14,46,59,-13,42
Forfar,337,8,10,6,20,39,65,-26,36
Albion,337,9,8,6,22,58,80,-22,30
Queen's Park,337,10,6,10,20,39,73,-34,28
Raith,338,1,23,8,5,70,33,37,77
Ayr,338,2,24,4,8,92,42,50,76
Arbroath,338,3,18,8,10,76,49,27,62
Alloa,338,4,17,8,11,57,45,12,59
Stranraer,338,5,15,5,16,55,69,-14,50
East Fife,338,6,14,3,19,52,64,-12,45
Airdrieon,338,7,10,12,14,45,58,-13,42
Forfar,338,8,10,6,20,38,64,-26,36
Albion,338,9,8,6,22,57,80,-23,30
Queen's Park,338,10,6,10,20,40,78,-38,28
Ayr,339,1,24,4,8,93,44,49,76
Raith,339,2,22,9,5,68,32,36,75
Arbroath,339,3,17,9,10,72,50,22,60
Alloa,339,4,17,9,10,56,43,13,60
Stranraer,339,5,15,6,15,57,66,-9,51
Airdrieon,339,6,11,11,14,49,60,-11,44
East Fife,339,7,13,4,19,49,66,-17,43
Forfar,339,8,10,5,21,40,68,-28,35
Albion,339,9,8,6,22,59,81,-22,30
Queen's Park,339,10,6,11,19,41,74,-33,29
Raith,340,1,23,8,5,70,33,37,77
Ayr,340,2,23,4,9,91,46,45,73
Arbroath,340,3,17,9,10,70,48,22,60
Alloa,340,4,17,8,11,57,45,12,59
Stranraer,340,5,15,5,16,57,67,-10,50
East Fife,340,6,14,3,19,50,66,-16,45
Airdrieon,340,7,11,11,14,47,59,-12,44
Forfar,340,8,10,5,21,39,66,-27,35
Albion,340,9,9,6,21,61,79,-18,33
Queen's Park,340,10,6,11,19,39,72,-33,29
Ayr,341,1,23,5,8,91,43,48,74
Raith,341,2,22,8,6,70,35,35,74
Alloa,341,3,18,8,10,59,45,14,62
Arbroath,341,4,17,8,11,71,50,21,59
Stranraer,341,5,15,6,15,57,66,-9,51
East Fife,341,6,13,4,19,49,66,-17,43
Airdrieon,341,7,10,12,14,47,60,-13,42
Forfar,341,8,10,6,20,40,66,-26,36
Albion,341,9,8,7,21,58,79,-21,31
Queen's Park,341,10,7,10,19,41,73,-32,31
Raith,342,1,23,8,5,71,32,39,77
Ayr,342,2,23,4,9,92,46,46,73
Arbroath,342,3,18,8,10,73,50,23,62
Alloa,342,4,17,8,11,56,46,10,59
Stranraer,342,5,15,5,16,55,66,-11,50
East Fife,342,6,14,3,19,49,64,-15,45
Airdrieon,342,7,11,11,14,47,59,-12,44
Forfar,342,8,10,5,21,39,66,-27,35
Albion,342,9,9,6,21,61,80,-19,33
Queen's Park,342,10,6,10,20,41,75,-34,28
Raith,343,1,23,8,5,71,32,39,77
Ayr,343,2,24,4,8,95,44,51,76
Arbroath,343,3,17,9,10,71,49,22,60
Alloa,343,4,17,8,11,56,46,10,59
Stranraer,343,5,15,5,16,55,65,-10,50
East Fife,343,6,14,3,19,48,64,-16,45
Airdrieon,343,7,11,11,14,46,58,-12,44
Forfar,343,8,10,5,21,38,65,-27,35
Albion,343,9,8,6,22,59,83,-24,30
Queen's Park,343,10,6,11,19,40,73,-33,29
Ayr,344,1,24,4,8,94,43,51,76
Raith,344,2,22,8,6,69,34,35,74
Arbroath,344,3,18,8,10,72,48,24,62
Alloa,344,4,18,8,10,58,44,14,62
Stranraer,344,5,16,5,15,58,66,-8,53
Airdrieon,344,6,11,11,14,50,58,-8,44
East Fife,344,7,13,3,20,49,67,-18,42
Forfar,344,8,10,5,21,38,69,-31,35
Albion,344,9,8,6,22,58,82,-24,30
Queen's Park,344,10,6,10,20,39,74,-35,28
Ayr,345,1,24,4,8,95,43,52,76
Raith,345,2,22,8,6,68,35,33,74
Alloa,345,3,18,8,10,59,43,16,62
Arbroath,345,4,17,9,10,70,48,22,60
Stranraer,345,5,16,5,15,57,65,-8,53
Airdrieon,345,6,10,12,14,45,58,-13,42
East Fife,345,7,13,3,20,48,66,-18,42
Forfar,345,8,10,6,20,38,64,-26,36
Albion,345,9,8,6,22,58,83,-25,30
Queen's Park,345,10,6,11,19,39,72,-33,29
Ayr,346,1,24,4,8,94,44,50,76
Raith,346,2,22,8,6,68,33,35,74
Alloa,346,3,18,8,10,57,43,14,62
Arbroath,346,4,17,8,11,70,50,20,59
Stranraer,346,5,15,5,16,55,65,-10,50
East Fife,346,6,14,3,19,48,64,-16,45
Airdrieon,346,7,10,12,14,46,59,-13,42
Forfar,346,8,10,6,20,39,65,-26,36
Queen's Park,346,9,7,10,19,41,72,-31,31
Albion,346,10,8,6,22,59,82,-23,30
Raith,347,1,23,8,5,71,32,39,77
Ayr,347,2,24,4,8,94,42,52,76
Arbroath,347,3,18,8,10,72,49,23,62
Alloa,347,4,17,8,11,56,46,10,59
Stranraer,347,5,15,5,16,57,67,-10,50
East Fife,347,6,14,3,19,50,66,-16,45
Airdrieon,347,7,10,11,15,46,61,-15,41
Forfar,347,8,11,5,20,41,65,-24,38
Albion,347,9,8,6,22,57,82,-25,30
Queen's Park,347,10,6,10,20,40,74,-34,28
Ayr,348,1,24,4,8,93,43,50,76
Raith,348,2,22,8,6,68,34,34,74
Alloa,348,3,18,8,10,58,43,15,62
Arbroath,348,4,17,8,11,70,51,19,59
Stranraer,348,5,16,5,15,57,64,-7,53
Airdrieon,348,6,10,12,14,46,59,-13,42
East Fife,348,7,13,3,20,47,66,-19,42
Forfar,348,8,10,6,20,39,65,-26,36
Queen's Park,348,9,7,10,19,42,72,-30,31
Albion,348,10,8,6,22,58,81,-23,30
Ayr,349,1,24,4,8,95,46,49,76
Raith,349,2,22,9,5,69,33,36,75
Alloa,349,3,17,9,10,57,44,13,60
Arbroath,349,4,17,8,11,71,50,21,59
Stranraer,349,5,16,5,15,58,66,-8,53
Airdrieon,349,6,10,12,14,45,58,-13,42
East Fife,349,7,13,3,20,49,67,-18,42
Forfar,349,8,10,6,20,38,64,-26,36
Queen's Park,349,9,7,10,19,41,73,-32,31
Albion,349,10,8,6,22,61,83,-22,30
Raith,350,1,23,8,5,69,32,37,77
Ayr,350,2,24,4,8,98,43,55,76
Arbroath,350,3,17,8,11,71,52,19,59
Alloa,350,4,17,8,11,56,44,12,59
Stranraer,350,5,16,5,15,58,66,-8,53
Airdrieon,350,6,10,12,14,46,59,-13,42
East Fife,350,7,13,3,20,49,67,-18,42
Forfar,350,8,10,6,20,39,65,-26,36
Queen's Park,350,9,7,10,19,43,73,-30,31
Albion,350,10,8,6,22,58,86,-28,30
Raith,351,1,23,8,5,69,32,37,77
Ayr,351,2,23,5,8,91,43,48,74
Arbroath,351,3,17,9,10,72,50,22,60
Alloa,351,4,17,8,11,56,44,12,59
Stranraer,351,5,15,5,16,55,65,-10,50
East Fife,351,6,14,3,19,48,64,-16,45
Airdrieon,351,7,10,11,15,46,61,-15,41
Forfar,351,8,11,5,20,41,65,-24,38
Albion,351,9,8,7,21,58,79,-21,31
Queen's Park,351,10,6,11,19,41,74,-33,29
Raith,352,1,23,8,5,70,32,38,77
Ayr,352,2,23,5,8,92,44,48,74
Arbroath,352,3,17,9,10,71,49,22,60
Alloa,352,4,17,8,11,56,45,11,59
Stranraer,352,5,16,5,15,58,66,-8,53
Airdrieon,352,6,11,11,14,47,59,-12,44
East Fife,352,7,13,3,20,49,67,-18,42
Forfar,352,8,10,5,21,39,66,-27,35
Albion,352,9,8,7,21,59,80,-21,31
Queen's Park,352,10,6,11,19,40,73,-33,29
Raith,353,1,23,8,5,69,32,37,77
Ayr,353,2,24,4,8,97,44,53,76
Arbroath,353,3,17,9,10,72,50,22,60
Alloa,353,4,17,8,11,56,44,12,59
Stranraer,353,5,15,5,16,56,66,-10,50
East Fife,353,6,14,3,19,49,65,-16,45
Airdrieon,353,7,10,12,14,46,59,-13,42
Forfar,353,8,10,6,20,39,65,-26,36
Albion,353,9,8,6,22,59,85,-26,30
Queen's Park,353,10,6,11,19,41,74,-33,29
Raith,354,1,23,8,5,72,33,39,77
Ayr,354,2,23,5,8,91,43,48,74
Arbroath,354,3,17,9,10,71,49,22,60
Alloa,354,4,17,8,11,57,47,10,59
Stranraer,354,5,16,5,15,57,65,-8,53
East Fife,354,6,13,3,20,48,66,-18,42
Airdrieon,354,7,10,11,15,46,60,-14,41
Forfar,354,8,11,5,20,40,65,-25,38
Albion,354,9,8,7,21,58,79,-21,31
Queen's Park,354,10,6,11,19,40,73,-33,29
Ayr,355,1,24,4,8,94,42,52,76
Raith,355,2,22,9,5,69,33,36,75
Alloa,355,3,17,9,10,57,44,13,60
Arbroath,355,4,17,8,11,72,51,21,59
Stranraer,355,5,16,5,15,57,65,-8,53
Airdrieon,355,6,10,12,14,47,60,-13,42
East Fife,355,7,13,3,20,48,66,-18,42
Forfar,355,8,10,6,20,40,66,-26,36
Queen's Park,355,9,7,10,19,42,74,-32,31
Albion,355,10,8,6,22,57,82,-25,30
Raith,356,1,22,9,5,71,35,36,75
Ayr,356,2,23,4,9,91,46,45,73
Alloa,356,3,17,9,10,59,46,13,60
Arbroath,356,4,17,8,11,71,50,21,59
Stranraer,356,5,15,5,16,56,67,-11,50
East Fife,356,6,14,3,19,50,65,-15,45
Airdrieon,356,7,10,12,14,46,59,-13,42
Forfar,356,8,10,6,20,39,65,-26,36
Albion,356,9,9,6,21,61,79,-18,33
Queen's Park,356,10,7,10,19,41,73,-32,31
Ayr,357,1,24,4,8,96,44,52,76
Raith,357,2,22,9,5,69,33,36,75
Arbroath,357,3,17,9,10,70,48,22,60
Alloa,357,4,17,9,10,57,44,13,60
Stranraer,357,5,16,5,15,59,66,-7,53
Airdrieon,357,6,10,12,14,47,60,-13,42
East Fife,357,7,13,3,20,49,68,-19,42
Forfar,357,8,10,6,20,40,66,-26,36
Albion,357,9,8,6,22,59,84,-25,30
Queen's Park,357,10,6,11,19,39,72,-33,29
Raith,358,1,23,8,5,69,32,37,77
Ayr,358,2,24,4,8,91,42,49,76
Arbroath,358,3,18,8,10,71,48,23,62
Alloa,358,4,17,8,11,56,44,12,59
Stranraer,358,5,15,5,16,55,66,-11,50
East Fife,358,6,14,3,19,49,64,-15,45
Airdrieon,358,7,11,11,14,50,59,-9,44
Forfar,358,8,10,5,21,39,69,-30,35
Albion,358,9,8,6,22,57,79,-22,30
Queen's Park,358,10,6,10,20,39,73,-34,28
Ayr,359,1,24,4,8,94,43,51,76
Raith,359,2,22,9,5,68,32,36,75
Arbroath,359,3,18,8,10,74,49,25,62
Alloa,359,4,17,9,10,56,43,13,60
Stranraer,359,5,15,5,16,57,67,-10,50
East Fife,359,6,14,3,19,50,66,-16,45
Airdrieon,359,7,11,11,14,47,58,-11,44
Forfar,359,8,10,5,21,38,66,-28,35
Albion,359,9,8,6,22,58,82,-24,30
Queen's Park,359,10,6,10,20,40,76,-36,28
Raith,360,1,23,8,5,69,32,37,77
Ayr,360,2,24,4,8,96,43,53,76
Arbroath,360,3,18,8,10,71,48,23,62
Alloa,360,4,17,8,11,56,44,12,59
Stranraer,360,5,15,5,16,55,68,-13,50
East Fife,360,6,14,3,19,51,64,-13,45
Airdrieon,360,7,11,11,14,46,58,-12,44
Forfar,360,8,10,5,21,38,65,-27,35
Albion,360,9,8,6,22,58,84,-26,30
Queen's Park,360,10,6,10,20,39,73,-34,28
Raith,361,1,23,8,5,72,33,39,77
Ayr,361,2,24,4,8,93,42,51,76
Arbroath,361,3,17,8,11,72,52,20,59
Alloa,361,4,17,8,11,57,47,10,59
Stranraer,361,5,16,5,15,59,65,-6,53
Airdrieon,361,6,11,11,14,46,58,-12,44
East Fife,361,7,13,3,20,48,68,-20,42
Forfar,361,8,10,5,21,38,65,-27,35
Queen's Park,361,9,7,10,19,43,74,-31,31
Albion,361,10,8,6,22,57,81,-24,30
Raith,362,1,22,9,5,69,33,36,75
Ayr,362,2,23,4,9,91,44,47,73
Arbroath,362,3,18,8,10,72,49,23,62
Alloa,362,4,17,9,10,57,44,13,60
Stranraer,362,5,15,6,15,57,66,-9,51
East Fife,362,6,13,4,19,49,66,-17,43
Airdrieon,362,7,10,11,15,46,60,-14,41
Forfar,362,8,11,5,20,40,65,-25,38
Albion,362,9,9,6,21,59,79,-20,33
Queen's Park,362,10,6,10,20,40,74,-34,28
Ayr,363,1,24,4,8,93,42,51,76
Raith,363,2,22,8,6,68,35,33,74
Arbroath,363,3,18,8,10,73,49,24,62
Alloa,363,4,18,8,10,59,43,16,62
Stranraer,363,5,15,5,16,58,68,-10,50
East Fife,363,6,14,3,19,51,67,-16,45
Airdrieon,363,7,10,11,15,47,62,-15,41
Forfar,363,8,11,5,20,42,66,-24,38
Albion,363,9,8,6,22,57,81,-24,30
Queen's Park,363,10,6,10,20,40,75,-35,28
Ayr,364,1,24,4,8,92,42,50,76
Raith,364,2,22,9,5,69,33,36,75
Arbroath,364,3,17,9,10,73,51,22,60
Alloa,364,4,17,9,10,57,44,13,60
Stranraer,364,5,15,5,16,55,66,-11,50
East Fife,364,6,14,3,19,49,64,-15,45
Airdrieon,364,7,10,12,14,45,58,-13,42
Forfar,364,8,10,6,20,38,64,-26,36
Albion,364,9,8,6,22,57,80,-23,30
Queen's Park,364,10,6,11,19,42,75,-33,29
Raith,365,1,23,8,5,72,33,39,77
Ayr,365,2,24,4,8,93,43,50,76
Arbroath,365,3,17,9,10,73,51,22,60
Alloa,365,4,17,8,11,57,47,10,59
Stranraer,365,5,15,5,16,55,66,-11,50
East Fife,365,6,14,3,19,49,64,-15,45
Airdrieon,365,7,11,11,14,47,58,-11,44
Forfar,365,8,10,5,21,38,66,-28,35
Albion,365,9,8,6,22,58,81,-23,30
Queen's Park,365,10,6,11,19,42,75,-33,29
Raith,366,1,23,8,5,69,32,37,77
Ayr,366,2,24,4,8,94,42,52,76
Arbroath,366,3,17,9,10,72,50,22,60
Alloa,366,4,17,8,11,56,44,12,59
Stranraer,366,5,16,5,15,59,65,-6,53
Airdrieon,366,6,11,11,14,48,58,-10,44
East Fife,366,7,13,3,20,48,68,-20,42
Forfar,366,8,10,5,21,38,67,-29,35
Albion,366,9,8,6,22,57,82,-25,30
Queen's Park,366,10,6,11,19,41,74,-33,29
Raith,367,1,23,8,5,72,35,37,77
Ayr,367,2,24,4,8,93,43,50,76
Arbroath,367,3,17,9,10,72,50,22,60
Alloa,367,4,17,8,11,59,47,12,59
Stranraer,367,5,15,5,16,56,67,-11,50
East Fife,367,6,14,3,19,50,65,-15,45
Airdrieon,367,7,10,12,14,46,59,-13,42
Forfar,367,8,10,6,20,39,65,-26,36
Albion,367,9,8,6,22,58,81,-23,30
Queen's Park,367,10,6,11,19,41,74,-33,29
Ayr,368,1,24,4,8,94,42,52,76
Raith,368,2,22,8,6,68,33,35,74
Alloa,368,3,18,8,10,57,43,14,62
Arbroath,368,4,17,8,11,71,50,21,59
Stranraer,368,5,15,5,16,55,68,-13,50
East Fife,368,6,14,3,19,51,64,-13,45
Airdrieon,368,7,11,11,14,49,58,-9,44
Forfar,368,8,10,5,21,38,68,-30,35
Queen's Park,368,9,7,10,19,41,73,-32,31
Albion,368,10,8,6,22,57,82,-25,30
Raith,369,1,23,8,5,71,33,38,77
Ayr,369,2,24,4,8,94,44,50,76
Arbroath,369,3,17,9,10,72,50,22,60
Alloa,369,4,17,8,11,57,46,11,59
Stranraer,369,5,15,5,16,55,68,-13,50
East Fife,369,6,14,3,19,51,64,-13,45
Airdrieon,369,7,10,11,15,45,60,-15,41
Forfar,369,8,11,5,20,40,64,-24,38
Albion,369,9,8,6,22,59,82,-23,30
Queen's Park,369,10,6,11,19,41,74,-33,29
Raith,370,1,23,8,5,70,33,37,77
Ayr,370,2,24,4,8,95,44,51,76
Arbroath,370,3,18,8,10,71,48,23,62
Alloa,370,4,17,8,11,57,45,12,59
Stranraer,370,5,15,5,16,55,66,-11,50
East Fife,370,6,14,3,19,49,64,-15,45
Airdrieon,370,7,10,11,15,46,60,-14,41
Forfar,370,8,11,5,20,40,65,-25,38
Albion,370,9,8,6,22,59,83,-24,30
Queen's Park,370,10,6,10,20,39,73,-34,28
Raith,371,1,23,8,5,69,32,37,77
Ayr,371,2,23,5,8,91,43,48,74
Arbroath,371,3,17,8,11,71,53,18,59
Alloa,371,4,17,8,11,56,44,12,59
Stranraer,371,5,15,5,16,57,68,-11,50
East Fife,371,6,14,3,19,51,66,-15,45
Airdrieon,371,7,10,12,14,46,59,-13,42
Forfar,371,8,10,6,20,39,65,-26,36
Albion,371,9,8,7,21,58,79,-21,31
Queen's Park,371,10,7,10,19,44,73,-29,31
Raith,372,1,22,9,5,69,33,36,75
Ayr,372,2,23,5,8,92,44,48,74
Alloa,372,3,17,9,10,57,44,13,60
Arbroath,372,4,17,8,11,71,50,21,59
Stranraer,372,5,15,5,16,55,66,-11,50
East Fife,372,6,14,3,19,49,64,-15,45
Airdrieon,372,7,10,11,15,45,59,-14,41
Forfar,372,8,11,5,20,39,64,-25,38
Albion,372,9,8,7,21,59,80,-21,31
Queen's Park,372,10,7,10,19,41,73,-32,31
Ayr,373,1,24,4,8,94,43,51,76
Raith,373,2,22,9,5,69,33,36,75
Arbroath,373,3,18,8,10,74,50,24,62
Alloa,373,4,17,9,10,57,44,13,60
Stranraer,373,5,15,5,16,56,67,-11,50
East Fife,373,6,14,3,19,50,65,-15,45
Airdrieon,373,7,10,12,14,47,60,-13,42
Forfar,373,8,10,6,20,40,66,-26,36
Albion,373,9,8,6,22,58,82,-24,30
Queen's Park,373,10,6,10,20,41,76,-35,28
Ayr,374,1,24,4,8,94,43,51,76
Raith,374,2,22,8,6,68,33,35,74
Arbroath,374,3,18,8,10,74,49,25,62
Alloa,374,4,18,8,10,57,43,14,62
Stranraer,374,5,16,5,15,57,64,-7,53
Airdrieon,374,6,10,12,14,46,59,-13,42
East Fife,374,7,13,3,20,47,66,-19,42
Forfar,374,8,10,6,20,39,65,-26,36
Albion,374,9,8,6,22,58,82,-24,30
Queen's Park,374,10,6,10,20,40,76,-36,28
Ayr,375,1,24,4,8,93,42,51,76
Raith,375,2,22,9,5,69,33,36,75
Alloa,375,3,17,9,10,57,44,13,60
Arbroath,375,4,17,8,11,71,51,20,59
Stranraer,375,5,15,5,16,56,66,-10,50
East Fife,375,6,14,3,19,49,65,-16,45
Airdrieon,375,7,10,12,14,47,60,-13,42
Forfar,375,8,10,6,20,40,66,-26,36
Queen's Park,375,9,7,10,19,42,73,-31,31
Albion,375,10,8,6,22,57,81,-24,30
Ayr,376,1,24,4,8,95,43,52,76
Raith,376,2,22,8,6,69,34,35,74
Alloa,376,3,18,8,10,58,44,14,62
Arbroath,376,4,17,8,11,70,49,21,59
Stranraer,376,5,15,5,16,56,66,-10,50
East Fife,376,6,14,3,19,49,65,-16,45
Airdrieon,376,7,11,11,14,50,60,-10,44
Forfar,376,8,10,5,21,40,69,-29,35
Queen's Park,376,9,7,10,19,40,72,-32,31
Albion,376,10,8,6,22,58,83,-25,30
Ayr,377,1,24,4,8,97,42,55,76
Raith,377,2,22,8,6,68,33,35,74
Alloa,377,3,18,8,10,57,43,14,62
Arbroath,377,4,17,9,10,72,50,22,60
Stranraer,377,5,15,5,16,56,66,-10,50
East Fife,377,6,14,3,19,49,65,-16,45
Airdrieon,377,7,10,11,15,46,60,-14,41
Forfar,377,8,11,5,20,40,65,-25,38
Albion,377,9,8,6,22,57,85,-28,30
Queen's Park,377,10,6,11,19,41,74,-33,29
Raith,378,1,23,8,5,71,32,39,77
Ayr,378,2,24,4,8,92,43,49,76
Arbroath,378,3,17,8,11,72,51,21,59
Alloa,378,4,17,8,11,56,46,10,59
Stranraer,378,5,16,5,15,58,66,-8,53
Airdrieon,378,6,11,11,14,49,61,-12,44
East Fife,378,7,13,3,20,49,67,-18,42
Forfar,378,8,10,5,21,41,68,-27,35
Queen's Park,378,9,7,10,19,42,74,-32,31
Albion,378,10,8,6,22,58,80,-22,30
Raith,379,1,23,8,5,70,32,38,77
Ayr,379,2,24,4,8,97,44,53,76
Arbroath,379,3,18,8,10,71,48,23,62
Alloa,379,4,17,8,11,56,45,11,59
Stranraer,379,5,15,5,16,56,67,-11,50
East Fife,379,6,14,3,19,50,65,-15,45
Airdrieon,379,7,10,11,15,46,61,-15,41
Forfar,379,8,11,5,20,41,65,-24,38
Albion,379,9,8,6,22,59,85,-26,30
Queen's Park,379,10,6,10,20,39,73,-34,28
Raith,380,1,23,8,5,70,33,37,77
Ayr,380,2,24,4,8,93,43,50,76
Arbroath,380,3,17,8,11,70,50,20,59
Alloa,380,4,17,8,11,57,45,12,59
Stranraer,380,5,15,5,16,55,66,-11,50
East Fife,380,6,14,3,19,49,64,-15,45
Airdrieon,380,7,10,11,15,46,62,-16,41
Forfar,380,8,11,5,20,42,65,-23,38
Queen's Park,380,9,7,10,19,41,72,-31,31
Albion,380,10,8,6,22,58,81,-23,30
Ayr,381,1,23,5,8,92,44,48,74
Raith,381,2,22,8,6,69,34,35,74
Alloa,381,3,18,8,10,58,44,14,62
Arbroath,381,4,17,9,10,73,51,22,60
Stranraer,381,5,16,5,15,59,65,-6,53
Airdrieon,381,6,10,12,14,46,59,-13,42
East Fife,381,7,13,3,20,48,68,-20,42
Forfar,381,8,10,6,20,39,65,-26,36
Albion,381,9,8,7,21,59,80,-21,31
Queen's Park,381,10,6,11,19,42,75,-33,29
Ayr,382,1,24,4,8,94,42,52,76
Raith,382,2,22,9,5,68,32,36,75
Arbroath,382,3,18,8,10,71,48,23,62
Alloa,382,4,17,9,10,56,43,13,60
Stranraer,382,5,15,6,15,55,64,-9,51
East Fife,382,6,13,4,19,47,64,-17,43
Airdrieon,382,7,10,12,14,45,58,-13,42
Forfar,382,8,10,6,20,38,64,-26,36
Albion,382,9,8,6,22,57,82,-25,30
Queen's Park,382,10,6,10,20,39,73,-34,28
Raith,383,1,23,8,5,70,33,37,77
Ayr,383,2,24,4,8,94,44,50,76
Arbroath,383,3,17,8,11,72,51,21,59
Alloa,383,4,17,8,11,57,45,12,59
Stranraer,383,5,15,6,15,56,65,-9,51
Airdrieon,383,6,11,11,14,48,58,-10,44
East Fife,383,7,13,4,19,48,65,-17,43
Forfar,383,8,10,5,21,38,67,-29,35
Queen's Park,383,9,7,10,19,42,74,-32,31
Albion,383,10,8,6,22,59,82,-23,30
Raith,384,1,23,8,5,69,32,37,77
Ayr,384,2,23,4,9,90,45,45,73
Arbroath,384,3,17,8,11,71,50,21,59
Alloa,384,4,17,8,11,56,44,12,59
Stranraer,384,5,16,5,15,57,64,-7,53
Airdrieon,384,6,11,11,14,49,59,-10,44
East Fife,384,7,13,3,20,47,66,-19,42
Forfar,384,8,10,5,21,39,68,-29,35
Albion,384,9,9,6,21,60,78,-18,33
Queen's Park,384,10,7,10,19,41,73,-32,31
Raith,385,1,22,9,5,70,34,36,75
Ayr,385,2,23,5,8,92,44,48,74
Arbroath,385,3,18,8,10,72,49,23,62
Alloa,385,4,17,9,10,58,45,13,60
Stranraer,385,5,16,5,15,56,64,-8,53
Airdrieon,385,6,11,11,14,46,58,-12,44
East Fife,385,7,13,3,20,47,65,-18,42
Forfar,385,8,10,5,21,38,65,-27,35
Albion,385,9,8,7,21,59,80,-21,31
Queen's Park,385,10,6,10,20,40,74,-34,28
Raith,386,1,22,9,5,68,32,36,75
Ayr,386,2,23,5,8,91,43,48,74
Alloa,386,3,17,9,10,56,43,13,60
Arbroath,386,4,17,8,11,70,49,21,59
Stranraer,386,5,15,5,16,56,68,-12,50
East Fife,386,6,14,3,19,51,65,-14,45
Airdrieon,386,7,10,11,15,46,61,-15,41
Forfar,386,8,11,5,20,41,65,-24,38
Albion,386,9,8,7,21,58,79,-21,31
Queen's Park,386,10,7,10,19,40,72,-32,31
Raith,387,1,23,8,5,69,32,37,77
Ayr,387,2,24,4,8,93,44,49,76
Arbroath,387,3,17,8,11,70,51,19,59
Alloa,387,4,17,8,11,56,44,12,59
Stranraer,387,5,16,5,15,56,64,-8,53
East Fife,387,6,13,3,20,47,65,-18,42
Airdrieon,387,7,10,11,15,45,60,-15,41
Forfar,387,8,11,5,20,40,64,-24,38
Queen's Park,387,9,7,10,19,42,72,-30,31
Albion,387,10,8,6,22,59,81,-22,30
Ayr,388,1,24,4,8,94,43,51,76
Raith,388,2,22,9,5,68,32,36,75
Arbroath,388,3,17,9,10,70,48,22,60
Alloa,388,4,17,9,10,56,43,13,60
Stranraer,388,5,16,5,15,57,64,-7,53
Airdrieon,388,6,11,11,14,48,59,-11,44
East Fife,388,7,13,3,20,47,66,-19,42
Forfar,388,8,10,5,21,39,67,-28,35
Albion,388,9,8,6,22,58,82,-24,30
Queen's Park,388,10,6,11,19,39,72,-33,29
Raith,389,1,22,9,5,69,33,36,75
Ayr,389,2,23,4,9,90,44,46,73
Arbroath,389,3,18,8,10,71,48,23,62
Alloa,389,4,17,9,10,57,44,13,60
Stranraer,389,5,15,5,16,55,65,-10,50
East Fife,389,6,14,3,19,48,64,-16,45
Airdrieon,389,7,10,11,15,46,60,-14,41
Forfar,389,8,11,5,20,40,65,-25,38
Albion,389,9,9,6,21,59,78,-19,33
Queen's Park,389,10,6,10,20,39,73,-34,28
Raith,390,1,23,8,5,70,33,37,77
Ayr,390,2,24,4,8,94,44,50,76
Arbroath,390,3,18,8,10,71,48,23,62
Alloa,390,4,17,8,11,57,45,12,59
Stranraer,390,5,15,6,15,56,65,-9,51
Airdrieon,390,6,11,11,14,49,59,-10,44
East Fife,390,7,13,4,19,48,65,-17,43
Forfar,390,8,10,5,21,39,68,-29,35
Albion,390,9,8,6,22,59,82,-23,30
Queen's Park,390,10,6,10,20,39,73,-34,28
Raith,391,1,23,8,5,70,33,37,77
Ayr,391,2,24,4,8,94,44,50,76
Arbroath,391,3,18,8,10,72,48,24,62
Alloa,391,4,17,8,11,57,45,12,59
Stranraer,391,5,15,5,16,56,66,-10,50
East Fife,391,6,14,3,19,49,65,-16,45
Airdrieon,391,7,11,11,14,50,59,-9,44
Forfar,391,8,10,5,21,39,69,-30,35
Albion,391,9,8,6,22,59,82,-23,30
Queen's Park,391,10,6,10,20,39,74,-35,28
Raith,392,1,23,8,5,69,32,37,77
Ayr,392,2,23,4,9,91,45,46,73
Arbroath,392,3,18,8,10,72,48,24,62
Alloa,392,4,17,8,11,56,44,12,59
Stranraer,392,5,15,6,15,56,65,-9,51
East Fife,392,6,13,4,19,48,65,-17,43
Airdrieon,392,7,10,11,15,46,60,-14,41
Forfar,392,8,11,5,20,40,65,-25,38
Albion,392,9,9,6,21,60,79,-19,33
Queen's Park,392,10,6,10,20,39,74,-35,28
Raith,393,1,22,8,6,68,33,35,74
Ayr,393,2,23,4,9,91,45,46,73
Alloa,393,3,18,8,10,57,43,14,62
Arbroath,393,4,17,9,10,71,49,22,60
Stranraer,393,5,16,5,15,59,66,-7,53
East Fife,393,6,13,3,20,49,68,-19,42
Airdrieon,393,7,10,11,15,46,62,-16,41
Forfar,393,8,11,5,20,42,65,-23,38
Albion,393,9,9,6,21,60,79,-19,33
Queen's Park,393,10,6,11,19,40,73,-33,29
Ayr,394,1,24,4,8,93,42,51,76
Raith,394,2,22,9,5,69,33,36,75
Arbroath,394,3,17,9,10,71,49,22,60
Alloa,394,4,17,9,10,57,44,13,60
Stranraer,394,5,15,5,16,56,67,-11,50
East Fife,394,6,14,3,19,50,65,-15,45
Airdrieon,394,7,11,11,14,47,58,-11,44
Forfar,394,8,10,5,21,38,66,-28,35
Albion,394,9,8,6,22,57,81,-24,30
Queen's Park,394,10,6,11,19,40,73,-33,29
Raith,395,1,23,8,5,70,33,37,77
Ayr,395,2,24,4,8,92,42,50,76
Arbroath,395,3,17,8,11,71,54,17,59
Alloa,395,4,17,8,11,57,45,12,59
Stranraer,395,5,15,5,16,55,66,-11,50
East Fife,395,6,14,3,19,49,64,-15,45
Airdrieon,395,7,11,11,14,50,58,-8,44
Forfar,395,8,10,5,21,38,69,-31,35
Queen's Park,395,9,7,10,19,45,73,-28,31
Albion,395,10,8,6,22,57,80,-23,30
Raith,396,1,23,8,5,70,33,37,77
Ayr,396,2,24,4,8,94,42,52,76
Arbroath,396,3,18,8,10,74,50,24,62
Alloa,396,4,17,8,11,57,45,12,59
Stranraer,396,5,15,5,16,57,67,-10,50
East Fife,396,6,14,3,19,50,66,-16,45
Airdrieon,396,7,11,11,14,48,58,-10,44
Forfar,396,8,10,5,21,38,67,-29,35
Albion,396,9,8,6,22,57,82,-25,30
Queen's Park,396,10,6,10,20,41,76,-35,28
Ayr,397,1,24,4,8,98,43,55,76
Raith,397,2,22,9,5,69,33,36,75
Alloa,397,3,17,9,10,57,44,13,60
Arbroath,397,4,17,8,11,71,50,21,59
Stranraer,397,5,15,5,16,58,69,-11,50
East Fife,397,6,14,3,19,52,67,-15,45
Airdrieon,397,7,10,12,14,45,58,-13,42
Forfar,397,8,10,6,20,38,64,-26,36
Queen's Park,397,9,7,10,19,41,73,-32,31
Albion,397,10,8,6,22,58,86,-28,30
Ayr,398,1,24,4,8,94,43,51,76
Raith,398,2,22,9,5,71,35,36,75
Alloa,398,3,17,9,10,59,46,13,60
Arbroath,398,4,17,8,11,70,49,21,59
Stranraer,398,5,16,5,15,59,65,-6,53
Airdrieon,398,6,10,12,14,47,60,-13,42
East Fife,398,7,13,3,20,48,68,-20,42
Forfar,398,8,10,6,20,40,66,-26,36
Queen's Park,398,9,7,10,19,40,72,-32,31
Albion,398,10,8,6,22,58,82,-24,30
Raith,399,1,23,8,5,72,33,39,77
Ayr,399,2,24,4,8,95,43,52,76
Arbroath,399,3,17,9,10,72,50,22,60
Alloa,399,4,17,8,11,57,47,10,59
Stranraer,399,5,15,5,16,56,69,-13,50
East Fife,399,6,14,3,19,52,65,-13,45
Airdrieon,399,7,10,12,14,46,59,-13,42
Forfar,399,8,10,6,20,39,65,-26,36
Albion,399,9,8,6,22,58,83,-25,30
Queen's Park,399,10,6,11,19,41,74,-33,29
Raith,400,1,23,8,5,71,33,38,77
Ayr,400,2,24,4,8,95,44,51,76
Arbroath,400,3,17,9,10,72,50,22,60
Alloa,400,4,17,8,11,57,46,11,59
Stranraer,400,5,16,5,15,56,64,-8,53
Airdrieon,400,6,11,11,14,49,61,-12,44
East Fife,400,7,13,3,20,47,65,-18,42
Forfar,400,8,10,5,21,41,68,-27,35
Albion,400,9,8,6,22,59,83,-24,30
Queen's Park,400,10,6,11,19,41,74,-33,29
Ayr,401,1,24,4,8,92,42,50,76
Raith,401,2,22,9,5,68,32,36,75
Arbroath,401,3,18,8,10,74,49,25,62
Alloa,401,4,17,9,10,56,43,13,60
Stranraer,401,5,15,5,16,56,68,-12,50
East Fife,401,6,14,3,19,51,65,-14,45
Airdrieon,401,7,10,12,14,46,59,-13,42
Forfar,401,8,10,6,20,39,65,-26,36
Albion,401,9,8,6,22,57,80,-23,30
Queen's Park,401,10,6,10,20,40,76,-36,28
Ayr,402,1,24,4,8,96,43,53,76
Raith,402,2,22,9,5,70,34,36,75
Arbroath,402,3,18,8,10,72,49,23,62
Alloa,402,4,17,9,10,58,45,13,60
Stranraer,402,5,16,5,15,56,64,-8,53
Airdrieon,402,6,10,12,14,48,61,-13,42
East Fife,402,7,13,3,20,47,65,-18,42
Forfar,402,8,10,6,20,41,67,-26,36
Albion,402,9,8,6,22,58,84,-26,30
Queen's Park,402,10,6,10,20,40,74,-34,28
Ayr,403,1,24,4,8,95,44,51,76
Raith,403,2,22,8,6,68,33,35,74
Alloa,403,3,18,8,10,57,43,14,62
Arbroath,403,4,17,9,10,70,48,22,60
Stranraer,403,5,15,6,15,57,66,-9,51
Airdrieon,403,6,11,11,14,47,58,-11,44
East Fife,403,7,13,4,19,49,66,-17,43
Forfar,403,8,10,5,21,38,66,-28,35
Albion,403,9,8,6,22,59,83,-24,30
Queen's Park,403,10,6,11,19,39,72,-33,29
Raith,404,1,23,8,5,69,32,37,77
Ayr,404,2,24,4,8,92,43,49,76
Arbroath,404,3,17,8,11,70,53,17,59
Alloa,404,4,17,8,11,56,44,12,59
Stranraer,404,5,15,6,15,57,66,-9,51
Airdrieon,404,6,11,11,14,47,58,-11,44
East Fife,404,7,13,4,19,49,66,-17,43
Forfar,404,8,10,5,21,38,66,-28,35
Queen's Park,404,9,7,10,19,44,72,-28,31
Albion,404,10,8,6,22,58,80,-22,30
Ayr,405,1,24,4,8,95,43,52,76
Raith,405,2,22,8,6,70,35,35,74
Arbroath,405,3,18,8,10,72,48,24,62
Alloa,405,4,18,8,10,59,45,14,62
Stranraer,405,5,16,5,15,60,66,-6,53
Airdrieon,405,6,10,12,14,45,58,-13,42
East Fife,405,7,13,3,20,49,69,-20,42
Forfar,405,8,10,6,20,38,64,-26,36
Albion,405,9,8,6,22,58,83,-25,30
Queen's Park,405,10,6,10,20,39,74,-35,28
Ayr,406,1,24,4,8,96,44,52,76
Raith,406,2,22,9,5,69,33,36,75
Arbroath,406,3,18,8,10,73,50,23,62
Alloa,406,4,17,9,10,57,44,13,60
Stranraer,406,5,16,5,15,58,66,-8,53
Airdrieon,406,6,11,11,14,46,58,-12,44
East Fife,406,7,13,3,20,49,67,-18,42
Forfar,406,8,10,5,21,38,65,-27,35
Albion,406,9,8,6,22,59,84,-25,30
Queen's Park,406,10,6,10,20,41,75,-34,28
Ayr,407,1,24,4,8,93,42,51,76
Raith,407,2,22,9,5,68,32,36,75
Alloa,407,3,17,9,10,56,43,13,60
Arbroath,407,4,17,8,11,70,49,21,59
Stranraer,407,5,15,5,16,56,66,-10,50
East Fife,407,6,14,3,19,49,65,-16,45
Airdrieon,407,7,10,12,14,47,60,-13,42
Forfar,407,8,10,6,20,40,66,-26,36
Queen's Park,407,9,7,10,19,40,72,-32,31
Albion,407,10,8,6,22,57,81,-24,30
Ayr,408,1,24,4,8,92,42,50,76
Raith,408,2,22,8,6,69,34,35,74
Alloa,408,3,18,8,10,58,44,14,62
Arbroath,408,4,17,8,11,70,49,21,59
Stranraer,408,5,15,5,16,57,67,-10,50
East Fife,408,6,14,3,19,50,66,-16,45
Airdrieon,408,7,11,11,14,49,59,-10,44
Forfar,408,8,10,5,21,39,68,-29,35
Queen's Park,408,9,7,10,19,40,72,-32,31
Albion,408,10,8,6,22,57,80,-23,30
Ayr,409,1,24,4,8,97,43,54,76
Raith,409,2,22,9,5,68,32,36,75
Alloa,409,3,17,9,10,56,43,13,60
Arbroath,409,4,17,8,11,70,50,20,59
Stranraer,409,5,15,5,16,55,65,-10,50
East Fife,409,6,14,3,19,48,64,-16,45
Airdrieon,409,7,10,11,15,46,61,-15,41
Forfar,409,8,11,5,20,41,65,-24,38
Queen's Park,409,9,7,10,19,41,72,-31,31
Albion,409,10,8,6,22,58,85,-27,30
Ayr,410,1,24,4,8,93,43,50,76
Raith,410,2,22,9,5,68,32,36,75
Arbroath,410,3,18,8,10,73,49,24,62
Alloa,410,4,17,9,10,56,43,13,60
Stranraer,410,5,15,6,15,57,66,-9,51
Airdrieon,410,6,11,11,14,46,58,-12,44
East Fife,410,7,13,4,19,49,66,-17,43
Forfar,410,8,10,5,21,38,65,-27,35
Albion,410,9,8,6,22,58,81,-23,30
Queen's Park,410,10,6,10,20,40,75,-35,28
Ayr,411,1,24,4,8,97,43,54,76
Raith,411,2,22,9,5,69,33,36,75
Arbroath,411,3,18,8,10,73,48,25,62
Alloa,411,4,17,9,10,57,44,13,60
Stranraer,411,5,15,6,15,56,65,-9,51
Airdrieon,411,6,11,11,14,47,59,-12,44
East Fife,411,7,13,4,19,48,65,-17,43
Forfar,411,8,10,5,21,39,66,-27,35
Albion,411,9,8,6,22,58,85,-27,30
Queen's Park,411,10,6,10,20,39,75,-36,28
Raith,412,1,23,8,5,70,32,38,77
Ayr,412,2,24,4,8,93,42,51,76
Arbroath,412,3,17,8,11,70,51,19,59
Alloa,412,4,17,8,11,56,45,11,59
Stranraer,412,5,15,5,16,55,65,-10,50
East Fife,412,6,14,3,19,48,64,-16,45
Airdrieon,412,7,10,12,14,46,59,-13,42
Forfar,412,8,10,6,20,39,65,-26,36
Queen's Park,412,9,7,10,19,42,72,-30,31
Albion,412,10,8,6,22,57,81,-24,30
Ayr,413,1,24,4,8,95,42,53,76
Raith,413,2,22,9,5,69,33,36,75
Arbroath,413,3,18,8,10,75,50,25,62
Alloa,413,4,17,9,10,57,44,13,60
Stranraer,413,5,15,6,15,55,64,-9,51
East Fife,413,6,13,4,19,47,64,-17,43
Airdrieon,413,7,10,11,15,46,60,-14,41
Forfar,413,8,11,5,20,40,65,-25,38
Albion,413,9,8,6,22,57,83,-26,30
Queen's Park,413,10,6,10,20,41,77,-36,28
Raith,414,1,23,8,5,71,32,39,77
Ayr,414,2,23,4,9,90,43,47,73
Arbroath,414,3,18,8,10,73,48,25,62
Alloa,414,4,17,8,11,56,46,10,59
Stranraer,414,5,15,5,16,56,69,-13,50
East Fife,414,6,14,3,19,52,65,-13,45
Airdrieon,414,7,10,12,14,46,59,-13,42
Forfar,414,8,10,6,20,39,65,-26,36
Albion,414,9,9,6,21,58,78,-20,33
Queen's Park,414,10,6,10,20,39,75,-36,28
Raith,415,1,23,8,5,71,32,39,77
Ayr,415,2,24,4,8,93,43,50,76
Arbroath,415,3,17,9,10,73,51,22,60
Alloa,415,4,17,8,11,56,46,10,59
Stranraer,415,5,15,5,16,56,67,-11,50
East Fife,415,6,14,3,19,50,65,-15,45
Airdrieon,415,7,11,11,14,47,58,-11,44
Forfar,415,8,10,5,21,38,66,-28,35
Albion,415,9,8,6,22,58,81,-23,30
Queen's Park,415,10,6,11,19,42,75,-33,29
Raith,416,1,23,8,5,69,32,37,77
Ayr,416,2,24,4,8,94,43,51,76
Arbroath,416,3,17,8,11,71,51,20,59
Alloa,416,4,17,8,11,56,44,12,59
Stranraer,416,5,16,5,15,58,66,-8,53
East Fife,416,6,13,3,20,49,67,-18,42
Airdrieon,416,7,10,11,15,45,64,-19,41
Forfar,416,8,11,5,20,44,64,-20,38
Queen's Park,416,9,7,10,19,42,73,-31,31
Albion,416,10,8,6,22,58,82,-24,30
Ayr,417,1,24,4,8,93,42,51,76
Raith,417,2,22,9,5,69,33,36,75
Arbroath,417,3,17,9,10,71,49,22,60
Alloa,417,4,17,9,10,57,44,13,60
Stranraer,417,5,15,5,16,55,66,-11,50
East Fife,417,6,14,3,19,49,64,-15,45
Airdrieon,417,7,10,11,15,46,60,-14,41
Forfar,417,8,11,5,20,40,65,-25,38
Albion,417,9,8,6,22,57,81,-24,30
Queen's Park,417,10,6,11,19,40,73,-33,29
Ayr,418,1,23,5,8,93,45,48,74
Raith,418,2,22,8,6,69,34,35,74
Alloa,418,3,18,8,10,58,44,14,62
Arbroath,418,4,17,8,11,72,52,20,59
Stranraer,418,5,15,5,16,55,65,-10,50
East Fife,418,6,14,3,19,48,64,-16,45
Airdrieon,418,7,11,11,14,47,58,-11,44
Forfar,418,8,10,5,21,38,66,-28,35
Albion,418,9,8,7,21,60,81,-21,31
Queen's Park,418,10,7,10,19,43,74,-31,31
Raith,419,1,23,8,5,74,34,40,77
Ayr,419,2,24,4,8,95,43,52,76
Arbroath,419,3,17,9,10,72,50,22,60
Alloa,419,4,17,8,11,58,49,9,59
Stranraer,419,5,15,6,15,57,66,-9,51
Airdrieon,419,6,11,11,14,47,59,-12,44
East Fife,419,7,13,4,19,49,66,-17,43
Forfar,419,8,10,5,21,39,66,-27,35
Albion,419,9,8,6,22,58,83,-25,30
Queen's Park,419,10,6,11,19,41,74,-33,29
Raith,420,1,23,8,5,69,32,37,77
Ayr,420,2,24,4,8,95,42,53,76
Arbroath,420,3,17,9,10,72,50,22,60
Alloa,420,4,17,8,11,56,44,12,59
Stranraer,420,5,15,5,16,55,66,-11,50
East Fife,420,6,14,3,19,49,64,-15,45
Airdrieon,420,7,10,12,14,46,59,-13,42
Forfar,420,8,10,6,20,39,65,-26,36
Albion,420,9,8,6,22,57,83,-26,30
Queen's Park,420,10,6,11,19,41,74,-33,29
Raith,421,1,22,8,6,69,34,35,74
Ayr,421,2,23,4,9,91,44,47,73
Alloa,421,3,18,8,10,58,44,14,62
Arbroath,421,4,17,8,11,71,51,20,59
Stranraer,421,5,15,5,16,55,67,-12,50
East Fife,421,6,14,3,19,50,64,-14,45
Airdrieon,421,7,11,11,14,47,58,-11,44
Forfar,421,8,10,5,21,38,66,-28,35
Albion,421,9,9,6,21,59,79,-20,33
Queen's Park,421,10,7,10,19,42,73,-31,31
Raith,422,1,23,8,5,70,32,38,77
Ayr,422,2,23,5,8,92,44,48,74
Arbroath,422,3,18,8,10,71,48,23,62
Alloa,422,4,17,8,11,56,45,11,59
Stranraer,422,5,15,6,15,56,65,-9,51
East Fife,422,6,13,4,19,48,65,-17,43
Airdrieon,422,7,10,11,15,45,60,-15,41
Forfar,422,8,11,5,20,40,64,-24,38
Albion,422,9,8,7,21,59,80,-21,31
Queen's Park,422,10,6,10,20,39,73,-34,28
Ayr,423,1,24,4,8,96,42,54,76
Raith,423,2,22,9,5,68,32,36,75
Alloa,423,3,17,9,10,56,43,13,60
Arbroath,423,4,17,8,11,71,50,21,59
Stranraer,423,5,16,5,15,57,65,-8,53
Airdrieon,423,6,11,11,14,47,59,-12,44
East Fife,423,7,13,3,20,48,66,-18,42
Forfar,423,8,10,5,21,39,66,-27,35
Queen's Park,423,9,7,10,19,41,73,-32,31
Albion,423,10,8,6,22,57,84,-27,30
Raith,424,1,23,8,5,71,32,39,77
Ayr,424,2,23,4,9,90,44,46,73
Arbroath,424,3,17,8,11,70,50,20,59
Alloa,424,4,17,8,11,56,46,10,59
Stranraer,424,5,15,5,16,57,67,-10,50
East Fife,424,6,14,3,19,50,66,-16,45
Airdrieon,424,7,11,11,14,48,58,-10,44
Forfar,424,8,10,5,21,38,67,-29,35
Albion,424,9,9,6,21,59,78,-19,33
Queen's Park,424,10,7,10,19,41,72,-31,31
Raith,425,1,23,8,5,70,32,38,77
Ayr,425,2,24,4,8,92,43,49,76
Arbroath,425,3,18,8,10,74,49,25,62
Alloa,425,4,17,8,11,56,45,11,59
Stranraer,425,5,15,6,15,57,66,-9,51
East Fife,425,6,13,4,19,49,66,-17,43
Airdrieon,425,7,10,11,15,47,61,-14,41
Forfar,425,8,11,5,20,41,66,-25,38
Albion,425,9,8,6,22,58,80,-22,30
Queen's Park,425,10,6,10,20,40,76,-36,28
Raith,426,1,23,8,5,73,35,38,77
Ayr,426,2,24,4,8,93,43,50,76
Arbroath,426,3,18,8,10,72,48,24,62
Alloa,426,4,17,8,11,59,48,11,59
Stranraer,426,5,16,5,15,57,65,-8,53
Airdrieon,426,6,10,12,14,46,59,-13,42
East Fife,426,7,13,3,20,48,66,-18,42
Forfar,426,8,10,6,20,39,65,-26,36
Albion,426,9,8,6,22,58,81,-23,30
Queen's Park,426,10,6,10,20,39,74,-35,28
Raith,427,1,23,8,5,70,32,38,77
Ayr,427,2,24,4,8,95,44,51,76
Arbroath,427,3,18,8,10,75,49,26,62
Alloa,427,4,17,8,11,56,45,11,59
Stranraer,427,5,15,6,15,55,64,-9,51
East Fife,427,6,13,4,19,47,64,-17,43
Airdrieon,427,7,10,12,14,45,58,-13,42
Forfar,427,8,10,6,20,38,64,-26,36
Albion,427,9,8,6,22,59,83,-24,30
Queen's Park,427,10,6,10,20,40,77,-37,28
Ayr,428,1,24,4,8,92,42,50,76
Raith,428,2,22,9,5,69,33,36,75
Arbroath,428,3,18,8,10,72,48,24,62
Alloa,428,4,17,9,10,57,44,13,60
Stranraer,428,5,16,5,15,57,65,-8,53
Airdrieon,428,6,11,11,14,48,59,-11,44
East Fife,428,7,13,3,20,48,66,-18,42
Forfar,428,8,10,5,21,39,67,-28,35
Albion,428,9,8,6,22,57,80,-23,30
Queen's Park,428,10,6,10,20,39,74,-35,28
Raith,429,1,23,8,5,70,33,37,77
Ayr,429,2,24,4,8,92,42,50,76
Arbroath,429,3,18,8,10,74,48,26,62
Alloa,429,4,17,8,11,57,45,12,59
Stranraer,429,5,15,5,16,56,67,-11,50
East Fife,429,6,14,3,19,50,65,-15,45
Airdrieon,429,7,10,11,15,45,59,-14,41
Forfar,429,8,11,5,20,39,64,-25,38
Albion,429,9,8,6,22,57,80,-23,30
Queen's Park,429,10,6,10,20,39,76,-37,28
Raith,430,1,23,8,5,71,34,37,77
Ayr,430,2,24,4,8,99,44,55,76
Arbroath,430,3,17,8,11,71,51,20,59
Alloa,430,4,17,8,11,58,46,12,59
Stranraer,430,5,15,5,16,55,67,-12,50
East Fife,430,6,14,3,19,50,64,-14,45
Airdrieon,430,7,10,12,14,45,58,-13,42
Forfar,430,8,10,6,20,38,64,-26,36
Queen's Park,430,9,7,10,19,42,73,-31,31
Albion,430,10,8,6,22,59,87,-28,30
Ayr,431,1,24,4,8,93,43,50,76
Raith,431,2,22,8,6,69,34,35,74
Alloa,431,3,18,8,10,58,44,14,62
Arbroath,431,4,17,9,10,74,52,22,60
Stranraer,431,5,15,6,15,56,65,-9,51
Airdrieon,431,6,11,11,14,48,58,-10,44
East Fife,431,7,13,4,19,48,65,-17,43
Forfar,431,8,10,5,21,38,67,-29,35
Albion,431,9,8,6,22,58,81,-23,30
Queen's Park,431,10,6,11,19,43,76,-33,29
Raith,432,1,23,8,5,70,33,37,77
Ayr,432,2,24,4,8,92,43,49,76
Arbroath,432,3,18,8,10,75,49,26,62
Alloa,432,4,17,8,11,57,45,12,59
Stranraer,432,5,15,5,16,55,66,-11,50
East Fife,432,6,14,3,19,49,64,-15,45
Airdrieon,432,7,11,11,14,48,60,-12,44
Forfar,432,8,10,5,21,40,67,-27,35
Albion,432,9,8,6,22,58,80,-22,30
Queen's Park,432,10,6,10,20,40,77,-37,28
Raith,433,1,23,8,5,71,32,39,77
Ayr,433,2,24,4,8,92,42,50,76
Arbroath,433,3,18,8,10,74,48,26,62
Alloa,433,4,17,8,11,56,46,10,59
Stranraer,433,5,15,6,15,55,64,-9,51
Airdrieon,433,6,11,11,14,47,58,-11,44
East Fife,433,7,13,4,19,47,64,-17,43
Forfar,433,8,10,5,21,38,66,-28,35
Albion,433,9,8,6,22,57,80,-23,30
Queen's Park,433,10,6,10,20,39,76,-37,28
Ayr,434,1,24,4,8,95,42,53,76
Raith,434,2,22,8,6,69,34,35,74
Arbroath,434,3,18,8,10,71,48,23,62
Alloa,434,4,18,8,10,58,44,14,62
Stranraer,434,5,15,5,16,56,67,-11,50
East Fife,434,6,14,3,19,50,65,-15,45
Airdrieon,434,7,10,11,15,45,62,-17,41
Forfar,434,8,11,5,20,42,64,-22,38
Albion,434,9,8,6,22,57,83,-26,30
Queen's Park,434,10,6,10,20,39,73,-34,28
Ayr,435,1,24,4,8,93,43,50,76
Raith,435,2,22,8,6,68,36,32,74
Arbroath,435,3,18,8,10,73,48,25,62
Alloa,435,4,18,8,10,60,43,17,62
Stranraer,435,5,15,5,16,56,66,-10,50
East Fife,435,6,14,3,19,49,65,-16,45
Airdrieon,435,7,11,11,14,48,59,-11,44
Forfar,435,8,10,5,21,39,67,-28,35
Albion,435,9,8,6,22,58,81,-23,30
Queen's Park,435,10,6,10,20,39,75,-36,28
Raith,436,1,23,8,5,70,33,37,77
Ayr,436,2,23,5,8,92,44,48,74
Arbroath,436,3,17,8,11,71,52,19,59
Alloa,436,4,17,8,11,57,45,12,59
Stranraer,436,5,15,5,16,56,67,-11,50
East Fife,436,6,14,3,19,50,65,-15,45
Airdrieon,436,7,10,12,14,48,61,-13,42
Forfar,436,8,10,6,20,41,67,-26,36
Albion,436,9,8,7,21,59,80,-21,31
Queen's Park,436,10,7,10,19,43,73,-30,31
Raith,437,1,23,8,5,70,32,38,77
Ayr,437,2,23,4,9,92,46,46,73
Arbroath,437,3,17,9,10,70,48,22,60
Alloa,437,4,17,8,11,56,45,11,59
Stranraer,437,5,15,6,15,56,65,-9,51
Airdrieon,437,6,11,11,14,47,58,-11,44
East Fife,437,7,13,4,19,48,65,-17,43
Forfar,437,8,10,5,21,38,66,-28,35
Albion,437,9,9,6,21,61,80,-19,33
Queen's Park,437,10,6,11,19,39,72,-33,29
Raith,438,1,23,8,5,71,33,38,77
Ayr,438,2,24,4,8,91,42,49,76
Arbroath,438,3,18,8,10,75,50,25,62
Alloa,438,4,17,8,11,57,46,11,59
Stranraer,438,5,15,6,15,57,66,-9,51
Airdrieon,438,6,11,11,14,46,58,-12,44
East Fife,438,7,13,4,19,49,66,-17,43
Forfar,438,8,10,5,21,38,65,-27,35
Albion,438,9,8,6,22,57,79,-22,30
Queen's Park,438,10,6,10,20,41,77,-36,28
Raith,439,1,23,8,5,71,34,37,77
Ayr,439,2,24,4,8,95,43,52,76
Arbroath,439,3,17,8,11,70,50,20,59
Alloa,439,4,17,8,11,58,46,12,59
Stranraer,439,5,16,5,15,57,64,-7,53
East Fife,439,6,13,3,20,47,66,-19,42
Airdrieon,439,7,10,11,15,45,60,-15,41
Forfar,439,8,11,5,20,40,64,-24,38
Queen's Park,439,9,7,10,19,41,72,-31,31
Albion,439,10,8,6,22,58,83,-25,30
Raith,440,1,23,8,5,71,33,38,77
Ayr,440,2,24,4,8,95,44,51,76
Arbroath,440,3,18,8,10,76,49,27,62
Alloa,440,4,17,8,11,57,46,11,59
Stranraer,440,5,16,5,15,56,64,-8,53
East Fife,440,6,13,3,20,47,65,-18,42
Airdrieon,440,7,10,11,15,48,62,-14,41
Forfar,440,8,11,5,20,42,67,-25,38
Albion,440,9,8,6,22,59,83,-24,30
Queen's Park,440,10,6,10,20,40,78,-38,28
Ayr,441,1,24,4,8,92,43,49,76
Raith,441,2,22,9,5,68,32,36,75
Arbroath,441,3,17,9,10,70,48,22,60
Alloa,441,4,17,9,10,56,43,13,60
Stranraer,441,5,15,5,16,55,68,-13,50
East Fife,441,6,14,3,19,51,64,-13,45
Airdrieon,441,7,10,12,14,46,59,-13,42
Forfar,441,8,10,6,20,39,65,-26,36
Albion,441,9,8,6,22,58,80,-22,30
Queen's Park,441,10,6,11,19,39,72,-33,29
Raith,442,1,23,8,5,70,33,37,77
Ayr,442,2,24,4,8,92,43,49,76
Arbroath,442,3,17,8,11,73,52,21,59
Alloa,442,4,17,8,11,57,45,12,59
Stranraer,442,5,15,5,16,56,68,-12,50
East Fife,442,6,14,3,19,51,65,-14,45
Airdrieon,442,7,11,11,14,47,58,-11,44
Forfar,442,8,10,5,21,38,66,-28,35
Queen's Park,442,9,7,10,19,43,75,-32,31
Albion,442,10,8,6,22,58,80,-22,30
Raith,443,1,23,8,5,70,32,38,77
Ayr,443,2,24,4,8,95,44,51,76
Arbroath,443,3,18,8,10,73,48,25,62
Alloa,443,4,17,8,11,56,45,11,59
Stranraer,443,5,15,5,16,56,67,-11,50
East Fife,443,6,14,3,19,50,65,-15,45
Airdrieon,443,7,10,12,14,47,60,-13,42
Forfar,443,8,10,6,20,40,66,-26,36
Albion,443,9,8,6,22,59,83,-24,30
Queen's Park,443,10,6,10,20,39,75,-36,28
Ayr,444,1,24,4,8,96,44,52,76
Raith,444,2,22,8,6,68,33,35,74
Arbroath,444,3,18,8,10,73,48,25,62
Alloa,444,4,18,8,10,57,43,14,62
Stranraer,444,5,15,6,15,56,65,-9,51
Airdrieon,444,6,11,11,14,46,58,-12,44
East Fife,444,7,13,4,19,48,65,-17,43
Forfar,444,8,10,5,21,38,65,-27,35
Albion,444,9,8,6,22,59,84,-25,30
Queen's Park,444,10,6,10,20,39,75,-36,28
Raith,445,1,23,8,5,71,33,38,77
Ayr,445,2,24,4,8,95,44,51,76
Arbroath,445,3,18,8,10,73,50,23,62
Alloa,445,4,17,8,11,57,46,11,59
Stranraer,445,5,15,6,15,57,66,-9,51
East Fife,445,6,13,4,19,49,66,-17,43
Airdrieon,445,7,10,11,15,45,60,-15,41
Forfar,445,8,11,5,20,40,64,-24,38
Albion,445,9,8,6,22,59,83,-24,30
Queen's Park,445,10,6,10,20,41,75,-34,28
Ayr,446,1,24,4,8,93,42,51,76
Raith,446,2,22,8,6,68,34,34,74
Arbroath,446,3,18,8,10,73,50,23,62
Alloa,446,4,18,8,10,58,43,15,62
Stranraer,446,5,16,5,15,58,66,-8,53
Airdrieon,446,6,11,11,14,48,58,-10,44
East Fife,446,7,13,3,20,49,67,-18,42
Forfar,446,8,10,5,21,38,67,-29,35
Albion,446,9,8,6,22,57,81,-24,30
Queen's Park,446,10,6,10,20,41,75,-34,28
Raith,447,1,23,8,5,70,32,38,77
Ayr,447,2,24,4,8,93,44,49,76
Arbroath,447,3,18,8,10,73,49,24,62
Alloa,447,4,17,8,11,56,45,11,59
Stranraer,447,5,15,6,15,56,65,-9,51
East Fife,447,6,13,4,19,48,65,-17,43
Airdrieon,447,7,10,11,15,46,60,-14,41
Forfar,447,8,11,5,20,40,65,-25,38
Albion,447,9,8,6,22,59,81,-22,30
Queen's Park,447,10,6,10,20,40,75,-35,28
Raith,448,1,23,8,5,69,32,37,77
Ayr,448,2,24,4,8,92,43,49,76
Arbroath,448,3,18,8,10,73,49,24,62
Alloa,448,4,17,8,11,56,44,12,59
Stranraer,448,5,15,5,16,55,66,-11,50
East Fife,448,6,14,3,19,49,64,-15,45
Airdrieon,448,7,11,11,14,47,58,-11,44
Forfar,448,8,10,5,21,38,66,-28,35
Albion,448,9,8,6,22,58,80,-22,30
Queen's Park,448,10,6,10,20,40,75,-35,28
Raith,449,1,23,8,5,70,32,38,77
Ayr,449,2,24,4,8,92,43,49,76
Arbroath,449,3,17,8,11,71,52,19,59
Alloa,449,4,17,8,11,56,45,11,59
Stranraer,449,5,15,5,16,56,66,-10,50
East Fife,449,6,14,3,19,49,65,-16,45
Airdrieon,449,7,11,11,14,48,60,-12,44
Forfar,449,8,10,5,21,40,67,-27,35
Queen's Park,449,9,7,10,19,43,73,-30,31
Albion,449,10,8,6,22,58,80,-22,30
Raith,450,1,23,8,5,71,33,38,77
Ayr,450,2,24,4,8,94,43,51,76
Arbroath,450,3,18,8,10,72,48,24,62
Alloa,450,4,17,8,11,57,46,11,59
Stranraer,450,5,16,5,15,57,65,-8,53
Airdrieon,450,6,10,12,14,46,59,-13,42
East Fife,450,7,13,3,20,48,66,-18,42
Forfar,450,8,10,6,20,39,65,-26,36
Albion,450,9,8,6,22,58,82,-24,30
Queen's Park,450,10,6,10,20,39,74,-35,28
Raith,451,1,22,8,6,69,35,34,74
Ayr,451,2,23,4,9,93,46,47,73
Alloa,451,3,18,8,10,59,44,15,62
Arbroath,451,4,17,8,11,70,49,21,59
Stranraer,451,5,15,5,16,57,67,-10,50
East Fife,451,6,14,3,19,50,66,-16,45
Airdrieon,451,7,11,11,14,48,60,-12,44
Forfar,451,8,10,5,21,40,67,-27,35
Albion,451,9,9,6,21,61,81,-20,33
Queen's Park,451,10,7,10,19,40,72,-32,31
Raith,452,1,23,8,5,70,32,38,77
Ayr,452,2,24,4,8,96,43,53,76
Arbroath,452,3,18,8,10,71,48,23,62
Alloa,452,4,17,8,11,56,45,11,59
Stranraer,452,5,15,5,16,56,66,-10,50
East Fife,452,6,14,3,19,49,65,-16,45
Airdrieon,452,7,10,12,14,46,59,-13,42
Forfar,452,8,10,6,20,39,65,-26,36
Albion,452,9,8,6,22,58,84,-26,30
Queen's Park,452,10,6,10,20,39,73,-34,28
Raith,453,1,23,8,5,69,32,37,77
Ayr,453,2,24,4,8,94,44,50,76
Arbroath,453,3,17,9,10,70,48,22,60
Alloa,453,4,17,8,11,56,44,12,59
Stranraer,453,5,15,5,16,58,68,-10,50
East Fife,453,6,14,3,19,51,67,-16,45
Airdrieon,453,7,11,11,14,48,59,-11,44
Forfar,453,8,10,5,21,39,67,-28,35
Albion,453,9,8,6,22,59,82,-23,30
Queen's Park,453,10,6,11,19,39,72,-33,29
Ayr,454,1,24,4,8,95,43,52,76
Raith,454,2,22,8,6,68,33,35,74
Alloa,454,3,18,8,10,57,43,14,62
Arbroath,454,4,17,8,11,71,50,21,59
Stranraer,454,5,15,5,16,58,68,-10,50
East Fife,454,6,14,3,19,51,67,-16,45
Airdrieon,454,7,11,11,14,47,58,-11,44
Forfar,454,8,10,5,21,38,66,-28,35
Queen's Park,454,9,7,10,19,41,73,-32,31
Albion,454,10,8,6,22,58,83,-25,30
Raith,455,1,23,8,5,70,33,37,77
Ayr,455,2,24,4,8,93,43,50,76
Arbroath,455,3,18,8,10,71,48,23,62
Alloa,455,4,17,8,11,57,45,12,59
Stranraer,455,5,15,5,16,56,66,-10,50
East Fife,455,6,14,3,19,49,65,-16,45
Airdrieon,455,7,11,11,14,49,58,-9,44
Forfar,455,8,10,5,21,38,68,-30,35
Albion,455,9,8,6,22,58,81,-23,30
Queen's Park,455,10,6,10,20,39,73,-34,28
Raith,456,1,23,8,5,69,32,37,77
Ayr,456,2,24,4,8,91,42,49,76
Arbroath,456,3,18,8,10,71,48,23,62
Alloa,456,4,17,8,11,56,44,12,59
Stranraer,456,5,16,5,15,58,64,-6,53
Airdrieon,456,6,11,11,14,47,58,-11,44
East Fife,456,7,13,3,20,47,67,-20,42
Forfar,456,8,10,5,21,38,66,-28,35
Albion,456,9,8,6,22,57,79,-22,30
Queen's Park,456,10,6,10,20,39,73,-34,28
Raith,457,1,23,8,5,69,32,37,77
Ayr,457,2,24,4,8,92,43,49,76
Arbroath,457,3,18,8,10,75,48,27,62
Alloa,457,4,17,8,11,56,44,12,59
Stranraer,457,5,15,5,16,57,69,-12,50
East Fife,457,6,14,3,19,52,66,-14,45
Airdrieon,457,7,11,11,14,46,58,-12,44
Forfar,457,8,10,5,21,38,65,-27,35
Albion,457,9,8,6,22,58,80,-22,30
Queen's Park,457,10,6,10,20,39,77,-38,28
Ayr,458,1,24,4,8,93,44,49,76
Raith,458,2,22,8,6,68,33,35,74
Alloa,458,3,18,8,10,57,43,14,62
Arbroath,458,4,17,8,11,70,49,21,59
Stranraer,458,5,15,5,16,56,68,-12,50
East Fife,458,6,14,3,19,51,65,-14,45
Airdrieon,458,7,11,11,14,49,60,-11,44
Forfar,458,8,10,5,21,40,68,-28,35
Queen's Park,458,9,7,10,19,40,72,-32,31
Albion,458,10,8,6,22,59,81,-22,30
Raith,459,1,23,8,5,69,32,37,77
Ayr,459,2,24,4,8,93,42,51,76
Arbroath,459,3,17,8,11,71,50,21,59
Alloa,459,4,17,8,11,56,44,12,59
Stranraer,459,5,15,5,16,57,67,-10,50
East Fife,459,6,14,3,19,50,66,-16,45
Airdrieon,459,7,10,12,14,45,58,-13,42
Forfar,459,8,10,6,20,38,64,-26,36
Queen's Park,459,9,7,10,19,41,73,-32,31
Albion,459,10,8,6,22,57,81,-24,30
Raith,460,1,23,8,5,70,33,37,77
Ayr,460,2,24,4,8,94,43,51,76
Arbroath,460,3,18,8,10,72,48,24,62
Alloa,460,4,17,8,11,57,45,12,59
Stranraer,460,5,15,6,15,56,65,-9,51
East Fife,460,6,13,4,19,48,65,-17,43
Airdrieon,460,7,10,11,15,45,59,-14,41
Forfar,460,8,11,5,20,39,64,-25,38
Albion,460,9,8,6,22,58,82,-24,30
Queen's Park,460,10,6,10,20,39,74,-35,28
Ayr,461,1,24,4,8,93,43,50,76
Raith,461,2,22,9,5,70,34,36,75
Arbroath,461,3,17,9,10,73,51,22,60
Alloa,461,4,17,9,10,58,45,13,60
Stranraer,461,5,15,6,15,57,66,-9,51
Airdrieon,461,6,11,11,14,48,60,-12,44
East Fife,461,7,13,4,19,49,66,-17,43
Forfar,461,8,10,5,21,40,67,-27,35
Albion,461,9,8,6,22,58,81,-23,30
Queen's Park,461,10,6,11,19,42,75,-33,29
Raith,462,1,23,8,5,70,33,37,77
Ayr,462,2,24,4,8,93,44,49,76
Arbroath,462,3,17,9,10,71,49,22,60
Alloa,462,4,17,8,11,57,45,12,59
Stranraer,462,5,15,6,15,57,66,-9,51
Airdrieon,462,6,11,11,14,49,58,-9,44
East Fife,462,7,13,4,19,49,66,-17,43
Forfar,462,8,10,5,21,38,68,-30,35
Albion,462,9,8,6,22,59,81,-22,30
Queen's Park,462,10,6,11,19,40,73,-33,29
Ayr,463,1,24,4,8,94,42,52,76
Raith,463,2,22,8,6,68,35,33,74
Arbroath,463,3,18,8,10,73,48,25,62
Alloa,463,4,18,8,10,59,43,16,62
Stranraer,463,5,16,5,15,56,64,-8,53
East Fife,463,6,13,3,20,47,65,-18,42
Airdrieon,463,7,10,11,15,45,60,-15,41
Forfar,463,8,11,5,20,40,64,-24,38
Albion,463,9,8,6,22,57,82,-25,30
Queen's Park,463,10,6,10,20,39,75,-36,28
Raith,464,1,23,8,5,70,33,37,77
Ayr,464,2,24,4,8,95,42,53,76
Arbroath,464,3,17,9,10,72,50,22,60
Alloa,464,4,17,8,11,57,45,12,59
Stranraer,464,5,15,5,16,56,67,-11,50
East Fife,464,6,14,3,19,50,65,-15,45
Airdrieon,464,7,11,11,14,48,60,-12,44
Forfar,464,8,10,5,21,40,67,-27,35
Albion,464,9,8,6,22,57,83,-26,30
Queen's Park,464,10,6,11,19,41,74,-33,29
Ayr,465,1,24,4,8,93,43,50,76
Raith,465,2,22,8,6,69,34,35,74
Alloa,465,3,18,8,10,58,44,14,62
Arbroath,465,4,17,8,11,70,50,20,59
Stranraer,465,5,15,5,16,56,66,-10,50
East Fife,465,6,14,3,19,49,65,-16,45
Airdrieon,465,7,10,12,14,45,58,-13,42
Forfar,465,8,10,6,20,38,64,-26,36
Queen's Park,465,9,7,10,19,41,72,-31,31
Albion,465,10,8,6,22,58,81,-23,30
Ayr,466,1,24,4,8,93,44,49,76
Raith,466,2,22,8,6,68,33,35,74
Arbroath,466,3,18,8,10,73,49,24,62
Alloa,466,4,18,8,10,57,43,14,62
Stranraer,466,5,15,5,16,56,66,-10,50
East Fife,466,6,14,3,19,49,65,-16,45
Airdrieon,466,7,10,11,15,47,61,-14,41
Forfar,466,8,11,5,20,41,66,-25,38
Albion,466,9,8,6,22,59,81,-22,30
Queen's Park,466,10,6,10,20,40,75,-35,28
Raith,467,1,22,9,5,69,33,36,75
Ayr,467,2,23,5,8,92,44,48,74
Alloa,467,3,17,9,10,57,44,13,60
Arbroath,467,4,17,8,11,71,50,21,59
Stranraer,467,5,15,5,16,56,66,-10,50
East Fife,467,6,14,3,19,49,65,-16,45
Airdrieon,467,7,11,11,14,48,59,-11,44
Forfar,467,8,10,5,21,39,67,-28,35
Albion,467,9,8,7,21,59,80,-21,31
Queen's Park,467,10,7,10,19,41,73,-32,31
Raith,468,1,23,8,5,72,34,38,77
Ayr,468,2,24,4,8,94,42,52,76
Arbroath,468,3,17,8,11,72,51,21,59
Alloa,468,4,17,8,11,58,47,11,59
Stranraer,468,5,15,5,16,55,66,-11,50
East Fife,468,6,14,3,19,49,64,-15,45
Airdrieon,468,7,10,12,14,46,59,-13,42
Forfar,468,8,10,6,20,39,65,-26,36
Queen's Park,468,9,7,10,19,42,74,-32,31
Albion,468,10,8,6,22,57,82,-25,30
Raith,469,1,23,8,5,72,33,39,77
Ayr,469,2,24,4,8,92,43,49,76
Arbroath,469,3,18,8,10,73,50,23,62
Alloa,469,4,17,8,11,57,47,10,59
Stranraer,469,5,15,5,16,55,69,-14,50
East Fife,469,6,14,3,19,52,64,-12,45
Airdrieon,469,7,10,12,14,47,60,-13,42
Forfar,469,8,10,6,20,40,66,-26,36
Albion,469,9,8,6,22,58,80,-22,30
Queen's Park,469,10,6,10,20,41,75,-34,28
Raith,470,1,23,8,5,70,32,38,77
Ayr,470,2,24,4,8,93,43,50,76
Arbroath,470,3,17,9,10,72,50,22,60
Alloa,470,4,17,8,11,56,45,11,59
Stranraer,470,5,15,5,16,55,66,-11,50
East Fife,470,6,14,3,19,49,64,-15,45
Airdrieon,470,7,11,11,14,47,59,-12,44
Forfar,470,8,10,5,21,39,66,-27,35
Albion,470,9,8,6,22,58,81,-23,30
Queen's Park,470,10,6,11,19,41,74,-33,29
Ayr,471,1,23,5,8,93,45,48,74
Raith,471,2,22,8,6,69,35,34,74
Alloa,471,3,18,8,10,59,44,15,62
Arbroath,471,4,17,9,10,71,49,22,60
Stranraer,471,5,16,5,15,56,64,-8,53
Airdrieon,471,6,11,11,14,49,59,-10,44
East Fife,471,7,13,3,20,47,65,-18,42
Forfar,471,8,10,5,21,39,68,-29,35
Albion,471,9,8,7,21,60,81,-21,31
Queen's Park,471,10,6,11,19,40,73,-33,29
Ayr,472,1,24,4,8,94,43,51,76
Raith,472,2,22,9,5,68,32,36,75
Arbroath,472,3,17,9,10,71,49,22,60
Alloa,472,4,17,9,10,56,43,13,60
Stranraer,472,5,15,6,15,56,65,-9,51
Airdrieon,472,6,11,11,14,49,61,-12,44
East Fife,472,7,13,4,19,48,65,-17,43
Forfar,472,8,10,5,21,41,68,-27,35
Albion,472,9,8,6,22,58,82,-24,30
Queen's Park,472,10,6,11,19,40,73,-33,29
Raith,473,1,23,8,5,69,32,37,77
Ayr,473,2,23,4,9,91,44,47,73
Arbroath,473,3,17,8,11,71,50,21,59
Alloa,473,4,17,8,11,56,44,12,59
Stranraer,473,5,15,5,16,55,66,-11,50
East Fife,473,6,14,3,19,49,64,-15,45
Airdrieon,473,7,10,12,14,47,60,-13,42
Forfar,473,8,10,6,20,40,66,-26,36
Albion,473,9,9,6,21,59,79,-20,33
Queen's Park,473,10,7,10,19,41,73,-32,31
Raith,474,1,23,8,5,70,32,38,77
Ayr,474,2,24,4,8,93,43,50,76
Arbroath,474,3,17,8,11,70,50,20,59
Alloa,474,4,17,8,11,56,45,11,59
Stranraer,474,5,15,6,15,58,67,-9,51
East Fife,474,6,13,4,19,50,67,-17,43
Airdrieon,474,7,10,12,14,45,58,-13,42
Forfar,474,8,10,6,20,38,64,-26,36
Queen's Park,474,9,7,10,19,41,72,-31,31
Albion,474,10,8,6,22,58,81,-23,30
Ayr,475,1,24,4,8,94,42,52,76
Raith,475,2,22,8,6,69,37,32,74
Arbroath,475,3,18,8,10,74,49,25,62
Alloa,475,4,18,8,10,61,44,17,62
Stranraer,475,5,15,5,16,58,70,-12,50
East Fife,475,6,14,3,19,53,67,-14,45
Airdrieon,475,7,11,11,14,47,58,-11,44
Forfar,475,8,10,5,21,38,66,-28,35
Albion,475,9,8,6,22,57,82,-25,30
Queen's Park,475,10,6,10,20,40,76,-36,28
Raith,476,1,23,8,5,70,32,38,77
Ayr,476,2,24,4,8,94,43,51,76
Arbroath,476,3,17,8,11,70,50,20,59
Alloa,476,4,17,8,11,56,45,11,59
Stranraer,476,5,16,5,15,56,64,-8,53
Airdrieon,476,6,11,11,14,46,58,-12,44
East Fife,476,7,13,3,20,47,65,-18,42
Forfar,476,8,10,5,21,38,65,-27,35
Queen's Park,476,9,7,10,19,41,72,-31,31
Albion,476,10,8,6,22,58,82,-24,30
Ayr,477,1,24,4,8,95,42,53,76
Raith,477,2,22,9,5,70,34,36,75
Alloa,477,3,17,9,10,58,45,13,60
Arbroath,477,4,17,8,11,71,50,21,59
Stranraer,477,5,16,5,15,56,64,-8,53
Airdrieon,477,6,10,12,14,45,58,-13,42
East Fife,477,7,13,3,20,47,65,-18,42
Forfar,477,8,10,6,20,38,64,-26,36
Queen's Park,477,9,7,10,19,41,73,-32,31
Albion,477,10,8,6,22,57,83,-26,30
Ayr,478,1,24,4,8,94,43,51,76
Raith,478,2,22,9,5,69,33,36,75
Arbroath,478,3,18,8,10,72,49,23,62
Alloa,478,4,17,9,10,57,44,13,60
Stranraer,478,5,15,5,16,56,66,-10,50
East Fife,478,6,14,3,19,49,65,-16,45
Airdrieon,478,7,11,11,14,50,58,-8,44
Forfar,478,8,10,5,21,38,69,-31,35
Albion,478,9,8,6,22,58,82,-24,30
Queen's Park,478,10,6,10,20,40,74,-34,28
Ayr,479,1,23,5,8,92,44,48,74
Raith,479,2,22,8,6,69,34,35,74
Alloa,479,3,18,8,10,58,44,14,62
Arbroath,479,4,17,8,11,70,50,20,59
Stranraer,479,5,15,5,16,56,67,-11,50
East Fife,479,6,14,3,19,50,65,-15,45
Airdrieon,479,7,10,12,14,46,59,-13,42
Forfar,479,8,10,6,20,39,65,-26,36
Albion,479,9,8,7,21,59,80,-21,31
Queen's Park,479,10,7,10,19,41,72,-31,31
Raith,480,1,23,8,5,69,32,37,77
Ayr,480,2,24,4,8,93,43,50,76
Arbroath,480,3,17,9,10,72,50,22,60
Alloa,480,4,17,8,11,56,44,12,59
Stranraer,480,5,16,5,15,58,64,-6,53
Airdrieon,480,6,11,11,14,47,58,-11,44
East Fife,480,7,13,3,20,47,67,-20,42
Forfar,480,8,10,5,21,38,66,-28,35
Albion,480,9,8,6,22,58,81,-23,30
Queen's Park,480,10,6,11,19,41,74,-33,29
Raith,481,1,23,8,5,72,32,40,77
Ayr,481,2,24,4,8,92,43,49,76
Arbroath,481,3,18,8,10,71,48,23,62
Alloa,481,4,17,8,11,56,47,9,59
Stranraer,481,5,15,5,16,55,67,-12,50
East Fife,481,6,14,3,19,50,64,-14,45
Airdrieon,481,7,11,11,14,47,59,-12,44
Forfar,481,8,10,5,21,39,66,-27,35
Albion,481,9,8,6,22,58,80,-22,30
Queen's Park,481,10,6,10,20,39,73,-34,28
Ayr,482,1,24,4,8,93,42,51,76
Raith,482,2,22,8,6,69,35,34,74
Arbroath,482,3,18,8,10,74,48,26,62
Alloa,482,4,18,8,10,59,44,15,62
Stranraer,482,5,15,5,16,55,65,-10,50
East Fife,482,6,14,3,19,48,64,-16,45
Airdrieon,482,7,11,11,14,48,59,-11,44
Forfar,482,8,10,5,21,39,67,-28,35
Albion,482,9,8,6,22,57,81,-24,30
Queen's Park,482,10,6,10,20,39,76,-37,28
Raith,483,1,23,8,5,71,34,37,77
Ayr,483,2,23,4,9,91,44,47,73
Arbroath,483,3,17,8,11,71,50,21,59
Alloa,483,4,17,8,11,58,46,12,59
Stranraer,483,5,16,5,15,59,66,-7,53
Airdrieon,483,6,11,11,14,47,58,-11,44
East Fife,483,7,13,3,20,49,68,-19,42
Forfar,483,8,10,5,21,38,66,-28,35
Albion,483,9,9,6,21,59,79,-20,33
Queen's Park,483,10,7,10,19,41,73,-32,31
Raith,484,1,23,8,5,70,32,38,77
Ayr,484,2,24,4,8,93,44,49,76
Arbroath,484,3,18,8,10,73,48,25,62
Alloa,484,4,17,8,11,56,45,11,59
Stranraer,484,5,16,5,15,57,65,-8,53
Airdrieon,484,6,10,12,14,45,58,-13,42
East Fife,484,7,13,3,20,48,66,-18,42
Forfar,484,8,10,6,20,38,64,-26,36
Albion,484,9,8,6,22,59,81,-22,30
Queen's Park,484,10,6,10,20,39,75,-36,28
Raith,485,1,23,8,5,71,32,39,77
Ayr,485,2,24,4,8,93,43,50,76
Arbroath,485,3,17,9,10,70,48,22,60
Alloa,485,4,17,8,11,56,46,10,59
Stranraer,485,5,16,5,15,56,64,-8,53
Airdrieon,485,6,11,11,14,48,59,-11,44
East Fife,485,7,13,3,20,47,65,-18,42
Forfar,485,8,10,5,21,39,67,-28,35
Albion,485,9,8,6,22,58,81,-23,30
Queen's Park,485,10,6,11,19,39,72,-33,29
Raith,486,1,23,8,5,71,34,37,77
Ayr,486,2,23,5,8,91,43,48,74
Arbroath,486,3,18,8,10,72,49,23,62
Alloa,486,4,17,8,11,58,46,12,59
Stranraer,486,5,15,5,16,55,66,-11,50
East Fife,486,6,14,3,19,49,64,-15,45
Airdrieon,486,7,11,11,14,46,58,-12,44
Forfar,486,8,10,5,21,38,65,-27,35
Albion,486,9,8,7,21,58,79,-21,31
Queen's Park,486,10,6,10,20,40,74,-34,28
Ayr,487,1,24,4,8,97,44,53,76
Raith,487,2,22,9,5,70,34,36,75
Arbroath,487,3,18,8,10,73,49,24,62
Alloa,487,4,17,9,10,58,45,13,60
Stranraer,487,5,16,5,15,57,65,-8,53
Airdrieon,487,6,10,12,14,46,59,-13,42
East Fife,487,7,13,3,20,48,66,-18,42
Forfar,487,8,10,6,20,39,65,-26,36
Albion,487,9,8,6,22,59,85,-26,30
Queen's Park,487,10,6,10,20,40,75,-35,28
Raith,488,1,23,8,5,69,32,37,77
Ayr,488,2,24,4,8,94,43,51,76
Arbroath,488,3,17,8,11,70,49,21,59
Alloa,488,4,17,8,11,56,44,12,59
Stranraer,488,5,15,5,16,56,68,-12,50
East Fife,488,6,14,3,19,51,65,-14,45
Airdrieon,488,7,11,11,14,47,58,-11,44
Forfar,488,8,10,5,21,38,66,-28,35
Queen's Park,488,9,7,10,19,40,72,-32,31
Albion,488,10,8,6,22,58,82,-24,30
Ayr,489,1,24,4,8,95,42,53,76
Raith,489,2,22,8,6,68,33,35,74
Arbroath,489,3,18,8,10,73,50,23,62
Alloa,489,4,18,8,10,57,43,14,62
Stranraer,489,5,15,5,16,57,68,-11,50
East Fife,489,6,14,3,19,51,66,-15,45
Airdrieon,489,7,11,11,14,47,58,-11,44
Forfar,489,8,10,5,21,38,66,-28,35
Albion,489,9,8,6,22,57,83,-26,30
Queen's Park,489,10,6,10,20,41,75,-34,28
Raith,490,1,23,8,5,70,32,38,77
Ayr,490,2,24,4,8,93,43,50,76
Arbroath,490,3,17,9,10,71,49,22,60
Alloa,490,4,17,8,11,56,45,11,59
Stranraer,490,5,16,5,15,60,65,-5,53
Airdrieon,490,6,11,11,14,49,60,-11,44
East Fife,490,7,13,3,20,48,69,-21,42
Forfar,490,8,10,5,21,40,68,-28,35
Albion,490,9,8,6,22,58,81,-23,30
Queen's Park,490,10,6,11,19,40,73,-33,29
Ayr,491,1,23,5,8,91,43,48,74
Raith,491,2,22,8,6,68,33,35,74
Arbroath,491,3,18,8,10,73,49,24,62
Alloa,491,4,18,8,10,57,43,14,62
Stranraer,491,5,15,5,16,55,67,-12,50
East Fife,491,6,14,3,19,50,64,-14,45
Airdrieon,491,7,10,11,15,45,60,-15,41
Forfar,491,8,11,5,20,40,64,-24,38
Albion,491,9,8,7,21,58,79,-21,31
Queen's Park,491,10,6,10,20,40,75,-35,28
Ayr,492,1,24,4,8,93,43,50,76
Raith,492,2,22,9,5,69,33,36,75
Arbroath,492,3,18,8,10,72,49,23,62
Alloa,492,4,17,9,10,57,44,13,60
Stranraer,492,5,16,5,15,56,64,-8,53
Airdrieon,492,6,11,11,14,46,58,-12,44
East Fife,492,7,13,3,20,47,65,-18,42
Forfar,492,8,10,5,21,38,65,-27,35
Albion,492,9,8,6,22,58,81,-23,30
Queen's Park,492,10,6,10,20,40,74,-34,28
Ayr,493,1,24,4,8,95,44,51,76
Raith,493,2,22,8,6,68,37,31,74
Arbroath,493,3,18,8,10,71,48,23,62
Alloa,493,4,18,8,10,61,43,18,62
Stranraer,493,5,16,5,15,58,65,-7,53
Airdrieon,493,6,10,12,14,48,61,-13,42
East Fife,493,7,13,3,20,48,67,-19,42
Forfar,493,8,10,6,20,41,67,-26,36
Albion,493,9,8,6,22,59,83,-24,30
Queen's Park,493,10,6,10,20,39,73,-34,28
Raith,494,1,23,8,5,72,34,38,77
Ayr,494,2,23,5,8,92,44,48,74
Arbroath,494,3,17,8,11,70,50,20,59
Alloa,494,4,17,8,11,58,47,11,59
Stranraer,494,5,15,6,15,57,66,-9,51
East Fife,494,6,13,4,19,49,66,-17,43
Airdrieon,494,7,10,11,15,46,60,-14,41
Forfar,494,8,11,5,20,40,65,-25,38
Albion,494,9,8,7,21,59,80,-21,31
Queen's Park,494,10,7,10,19,41,72,-31,31
Raith,495,1,22,9,5,70,34,36,75
Ayr,495,2,23,5,8,92,44,48,74
Alloa,495,3,17,9,10,58,45,13,60
Arbroath,495,4,17,8,11,70,51,19,59
Stranraer,495,5,15,5,16,56,66,-10,50
East Fife,495,6,14,3,19,49,65,-16,45
Airdrieon,495,7,10,12,14,45,58,-13,42
Forfar,495,8,10,6,20,38,64,-26,36
Albion,495,9,8,7,21,59,80,-21,31
Queen's Park,495,10,7,10,19,42,72,-30,31
Ayr,496,1,23,5,8,91,43,48,74
Raith,496,2,22,8,6,68,33,35,74
Arbroath,496,3,18,8,10,72,49,23,62
Alloa,496,4,18,8,10,57,43,14,62
Stranraer,496,5,15,6,15,56,65,-9,51
Airdrieon,496,6,11,11,14,50,58,-8,44
East Fife,496,7,13,4,19,48,65,-17,43
Forfar,496,8,10,5,21,38,69,-31,35
Albion,496,9,8,7,21,58,79,-21,31
Queen's Park,496,10,6,10,20,40,74,-34,28
Raith,497,1,23,8,5,71,32,39,77
Ayr,497,2,24,4,8,93,43,50,76
Arbroath,497,3,18,8,10,73,50,23,62
Alloa,497,4,17,8,11,56,46,10,59
Stranraer,497,5,15,5,16,56,66,-10,50
East Fife,497,6,14,3,19,49,65,-16,45
Airdrieon,497,7,10,12,14,46,59,-13,42
Forfar,497,8,10,6,20,39,65,-26,36
Albion,497,9,8,6,22,58,81,-23,30
Queen's Park,497,10,6,10,20,41,75,-34,28
Raith,498,1,23,8,5,71,33,38,77
Ayr,498,2,24,4,8,94,43,51,76
Arbroath,498,3,18,8,10,72,49,23,62
Alloa,498,4,17,8,11,57,46,11,59
Stranraer,498,5,15,6,15,56,65,-9,51
East Fife,498,6,13,4,19,48,65,-17,43
Airdrieon,498,7,10,12,14,45,58,-13,42
Forfar,498,8,10,6,20,38,64,-26,36
Albion,498,9,8,6,22,58,82,-24,30
Queen's Park,498,10,6,10,20,40,74,-34,28
Ayr,499,1,24,4,8,99,43,56,76
Raith,499,2,22,9,5,69,33,36,75
Alloa,499,3,17,9,10,57,44,13,60
Arbroath,499,4,17,8,11,72,52,20,59
Stranraer,499,5,15,6,15,56,65,-9,51
East Fife,499,6,13,4,19,48,65,-17,43
Airdrieon,499,7,10,11,15,45,61,-16,41
Forfar,499,8,11,5,20,41,64,-23,38
Queen's Park,499,9,7,10,19,43,74,-31,31
Albion,499,10,8,6,22,58,87,-29,30
Raith,500,1,23,8,5,71,33,38,77
Ayr,500,2,24,4,8,96,44,52,76
Arbroath,500,3,18,8,10,74,48,26,62
Alloa,500,4,17,8,11,57,46,11,59
Stranraer,500,5,16,5,15,57,65,-8,53
Airdrieon,500,6,11,11,14,47,58,-11,44
East Fife,500,7,13,3,20,48,66,-18,42
Forfar,500,8,10,5,21,38,66,-28,35
Albion,500,9,8,6,22,59,84,-25,30
Queen's Park,500,10,6,10,20,39,76,-37,28
Ayr,501,1,24,4,8,92,42,50,76
Raith,501,2,22,8,6,69,34,35,74
Arbroath,501,3,18,8,10,73,49,24,62
Alloa,501,4,18,8,10,58,44,14,62
Stranraer,501,5,15,5,16,58,68,-10,50
East Fife,501,6,14,3,19,51,67,-16,45
Airdrieon,501,7,11,11,14,47,58,-11,44
Forfar,501,8,10,5,21,38,66,-28,35
Albion,501,9,8,6,22,57,80,-23,30
Queen's Park,501,10,6,10,20,40,75,-35,28
Raith,502,1,23,8,5,71,34,37,77
Ayr,502,2,23,4,9,91,44,47,73
Arbroath,502,3,18,8,10,73,48,25,62
Alloa,502,4,17,8,11,58,46,12,59
Stranraer,502,5,16,5,15,56,64,-8,53
Airdrieon,502,6,11,11,14,46,58,-12,44
East Fife,502,7,13,3,20,47,65,-18,42
Forfar,502,8,10,5,21,38,65,-27,35
Albion,502,9,9,6,21,59,79,-20,33
Queen's Park,502,10,6,10,20,39,75,-36,28
Raith,503,1,23,8,5,71,32,39,77
Ayr,503,2,24,4,8,96,42,54,76
Arbroath,503,3,17,9,10,71,49,22,60
Alloa,503,4,17,8,11,56,46,10,59
Stranraer,503,5,15,5,16,55,65,-10,50
East Fife,503,6,14,3,19,48,64,-16,45
Airdrieon,503,7,10,11,15,47,61,-14,41
Forfar,503,8,11,5,20,41,66,-25,38
Albion,503,9,8,6,22,57,84,-27,30
Queen's Park,503,10,6,11,19,40,73,-33,29
Raith,504,1,23,8,5,70,32,38,77
Ayr,504,2,24,4,8,93,42,51,76
Arbroath,504,3,17,8,11,72,53,19,59
Alloa,504,4,17,8,11,56,45,11,59
Stranraer,504,5,15,6,15,56,65,-9,51
East Fife,504,6,13,4,19,48,65,-17,43
Airdrieon,504,7,10,11,15,46,60,-14,41
Forfar,504,8,11,5,20,40,65,-25,38
Queen's Park,504,9,7,10,19,44,74,-30,31
Albion,504,10,8,6,22,57,81,-24,30
Ayr,505,1,24,4,8,94,42,52,76
Raith,505,2,22,8,6,70,36,34,74
Arbroath,505,3,18,8,10,74,48,26,62
Alloa,505,4,18,8,10,60,45,15,62
Stranraer,505,5,15,5,16,56,67,-11,50
East Fife,505,6,14,3,19,50,65,-15,45
Airdrieon,505,7,10,11,15,46,60,-14,41
Forfar,505,8,11,5,20,40,65,-25,38
Albion,505,9,8,6,22,57,82,-25,30
Queen's Park,505,10,6,10,20,39,76,-37,28
Raith,506,1,23,8,5,71,33,38,77
Ayr,506,2,24,4,8,94,42,52,76
Arbroath,506,3,17,8,11,72,51,21,59
Alloa,506,4,17,8,11,57,46,11,59
Stranraer,506,5,16,5,15,58,66,-8,53
Airdrieon,506,6,11,11,14,49,58,-9,44
East Fife,506,7,13,3,20,49,67,-18,42
Forfar,506,8,10,5,21,38,68,-30,35
Queen's Park,506,9,7,10,19,42,74,-32,31
Albion,506,10,8,6,22,57,82,-25,30
Raith,507,1,23,8,5,74,34,40,77
Ayr,507,2,24,4,8,93,43,50,76
Arbroath,507,3,17,8,11,71,50,21,59
Alloa,507,4,17,8,11,58,49,9,59
Stranraer,507,5,16,5,15,56,64,-8,53
Airdrieon,507,6,11,11,14,49,60,-11,44
East Fife,507,7,13,3,20,47,65,-18,42
Forfar,507,8,10,5,21,40,68,-28,35
Queen's Park,507,9,7,10,19,41,73,-32,31
Albion,507,10,8,6,22,58,81,-23,30
Ayr,508,1,24,4,8,95,44,51,76
Raith,508,2,22,8,6,68,34,34,74
Alloa,508,3,18,8,10,58,43,15,62
Arbroath,508,4,17,9,10,70,48,22,60
Stranraer,508,5,15,6,15,57,66,-9,51
East Fife,508,6,13,4,19,49,66,-17,43
Airdrieon,508,7,10,11,15,48,62,-14,41
Forfar,508,8,11,5,20,42,67,-25,38
Albion,508,9,8,6,22,59,83,-24,30
Queen's Park,508,10,6,11,19,39,72,-33,29
Raith,509,1,23,8,5,69,32,37,77
Ayr,509,2,24,4,8,95,43,52,76
Arbroath,509,3,17,8,11,71,50,21,59
Alloa,509,4,17,8,11,56,44,12,59
Stranraer,509,5,16,5,15,58,64,-6,53
Airdrieon,509,6,10,12,14,46,59,-13,42
East Fife,509,7,13,3,20,47,67,-20,42
Forfar,509,8,10,6,20,39,65,-26,36
Queen's Park,509,9,7,10,19,41,73,-32,31
Albion,509,10,8,6,22,58,83,-25,30
Raith,510,1,23,8,5,71,32,39,77
Ayr,510,2,24,4,8,94,44,50,76
Arbroath,510,3,17,9,10,72,50,22,60
Alloa,510,4,17,8,11,56,46,10,59
Stranraer,510,5,15,5,16,57,67,-10,50
East Fife,510,6,14,3,19,50,66,-16,45
Airdrieon,510,7,10,12,14,47,60,-13,42
Forfar,510,8,10,6,20,40,66,-26,36
Albion,510,9,8,6,22,59,82,-23,30
Queen's Park,510,10,6,11,19,41,74,-33,29
Ayr,511,1,24,4,8,94,44,50,76
Raith,511,2,22,8,6,69,34,35,74
Arbroath,511,3,18,8,10,71,48,23,62
Alloa,511,4,18,8,10,58,44,14,62
Stranraer,511,5,15,5,16,56,67,-11,50
East Fife,511,6,14,3,19,50,65,-15,45
Airdrieon,511,7,10,11,15,45,59,-14,41
Forfar,511,8,11,5,20,39,64,-25,38
Albion,511,9,8,6,22,59,82,-23,30
Queen's Park,511,10,6,10,20,39,73,-34,28
Ayr,512,1,24,4,8,96,43,53,76
Raith,512,2,22,9,5,69,33,36,75
Arbroath,512,3,17,9,10,71,49,22,60
Alloa,512,4,17,9,10,57,44,13,60
Stranraer,512,5,16,5,15,57,64,-7,53
Airdrieon,512,6,10,12,14,46,59,-13,42
East Fife,512,7,13,3,20,47,66,-19,42
Forfar,512,8,10,6,20,39,65,-26,36
Albion,512,9,8,6,22,58,84,-26,30
Queen's Park,512,10,6,11,19,40,73,-33,29
Ayr,513,1,24,4,8,93,43,50,76
Raith,513,2,22,8,6,68,33,35,74
Alloa,513,3,18,8,10,57,43,14,62
Arbroath,513,4,17,9,10,71,49,22,60
Stranraer,513,5,15,6,15,56,65,-9,51
Airdrieon,513,6,11,11,14,50,58,-8,44
East Fife,513,7,13,4,19,48,65,-17,43
Forfar,513,8,10,5,21,38,69,-31,35
Albion,513,9,8,6,22,58,81,-23,30
Queen's Park,513,10,6,11,19,40,73,-33,29
Raith,514,1,23,8,5,69,32,37,77
Ayr,514,2,24,4,8,93,43,50,76
Arbroath,514,3,18,8,10,73,50,23,62
Alloa,514,4,17,8,11,56,44,12,59
Stranraer,514,5,16,5,15,57,65,-8,53
Airdrieon,514,6,10,12,14,46,59,-13,42
East Fife,514,7,13,3,20,48,66,-18,42
Forfar,514,8,10,6,20,39,65,-26,36
Albion,514,9,8,6,22,58,81,-23,30
Queen's Park,514,10,6,10,20,41,75,-34,28
Raith,515,1,23,8,5,69,32,37,77
Ayr,515,2,23,4,9,93,46,47,73
Arbroath,515,3,17,9,10,70,48,22,60
Alloa,515,4,17,8,11,56,44,12,59
Stranraer,515,5,16,5,15,58,65,-7,53
East Fife,515,6,13,3,20,48,67,-19,42
Airdrieon,515,7,10,11,15,46,61,-15,41
Forfar,515,8,11,5,20,41,65,-24,38
Albion,515,9,9,6,21,61,81,-20,33
Queen's Park,515,10,6,11,19,39,72,-33,29
Ayr,516,1,24,4,8,95,44,51,76
Raith,516,2,22,9,5,70,34,36,75
Arbroath,516,3,17,9,10,73,51,22,60
Alloa,516,4,17,9,10,58,45,13,60
Stranraer,516,5,15,5,16,56,66,-10,50
East Fife,516,6,14,3,19,49,65,-16,45
Airdrieon,516,7,10,11,15,45,60,-15,41
Forfar,516,8,11,5,20,40,64,-24,38
Albion,516,9,8,6,22,59,83,-24,30
Queen's Park,516,10,6,11,19,42,75,-33,29
Raith,517,1,23,8,5,70,32,38,77
Ayr,517,2,24,4,8,95,42,53,76
Arbroath,517,3,18,8,10,72,48,24,62
Alloa,517,4,17,8,11,56,45,11,59
Stranraer,517,5,15,6,15,57,66,-9,51
East Fife,517,6,13,4,19,49,66,-17,43
Airdrieon,517,7,10,11,15,45,59,-14,41
Forfar,517,8,11,5,20,39,64,-25,38
Albion,517,9,8,6,22,57,83,-26,30
Queen's Park,517,10,6,10,20,39,74,-35,28
Raith,518,1,23,8,5,70,33,37,77
Ayr,518,2,24,4,8,93,42,51,76
Arbroath,518,3,18,8,10,73,48,25,62
Alloa,518,4,17,8,11,57,45,12,59
Stranraer,518,5,16,5,15,59,65,-6,53
Airdrieon,518,6,11,11,14,46,58,-12,44
East Fife,518,7,13,3,20,48,68,-20,42
Forfar,518,8,10,5,21,38,65,-27,35
Albion,518,9,8,6,22,57,81,-24,30
Queen's Park,518,10,6,10,20,39,75,-36,28
Raith,519,1,23,8,5,69,32,37,77
Ayr,519,2,24,4,8,94,42,52,76
Arbroath,519,3,18,8,10,72,49,23,62
Alloa,519,4,17,8,11,56,44,12,59
Stranraer,519,5,15,5,16,56,68,-12,50
East Fife,519,6,14,3,19,51,65,-14,45
Airdrieon,519,7,10,11,15,46,61,-15,41
Forfar,519,8,11,5,20,41,65,-24,38
Albion,519,9,8,6,22,57,82,-25,30
Queen's Park,519,10,6,10,20,40,74,-34,28
Raith,520,1,23,8,5,72,32,40,77
Ayr,520,2,24,4,8,92,42,50,76
Arbroath,520,3,18,8,10,73,49,24,62
Alloa,520,4,17,8,11,56,47,9,59
Stranraer,520,5,16,5,15,57,64,-7,53
Airdrieon,520,6,10,12,14,46,59,-13,42
East Fife,520,7,13,3,20,47,66,-19,42
Forfar,520,8,10,6,20,39,65,-26,36
Albion,520,9,8,6,22,57,80,-23,30
Queen's Park,520,10,6,10,20,40,75,-35,28
Raith,521,1,22,8,6,69,34,35,74
Ayr,521,2,23,4,9,91,44,47,73
Arbroath,521,3,18,8,10,75,49,26,62
Alloa,521,4,18,8,10,58,44,14,62
Stranraer,521,5,15,5,16,56,67,-11,50
East Fife,521,6,14,3,19,50,65,-15,45
Airdrieon,521,7,11,11,14,48,59,-11,44
Forfar,521,8,10,5,21,39,67,-28,35
Albion,521,9,9,6,21,59,79,-20,33
Queen's Park,521,10,6,10,20,40,77,-37,28
Ayr,522,1,24,4,8,96,43,53,76
Raith,522,2,22,9,5,69,33,36,75
Arbroath,522,3,17,9,10,72,50,22,60
Alloa,522,4,17,9,10,57,44,13,60
Stranraer,522,5,15,5,16,56,67,-11,50
East Fife,522,6,14,3,19,50,65,-15,45
Airdrieon,522,7,11,11,14,50,59,-9,44
Forfar,522,8,10,5,21,39,69,-30,35
Albion,522,9,8,6,22,58,84,-26,30
Queen's Park,522,10,6,11,19,41,74,-33,29
Ayr,523,1,24,4,8,95,42,53,76
Raith,523,2,22,8,6,68,34,34,74
Alloa,523,3,18,8,10,58,43,15,62
Arbroath,523,4,17,8,11,70,49,21,59
Stranraer,523,5,15,6,15,56,65,-9,51
Airdrieon,523,6,11,11,14,47,58,-11,44
East Fife,523,7,13,4,19,48,65,-17,43
Forfar,523,8,10,5,21,38,66,-28,35
Queen's Park,523,9,7,10,19,40,72,-32,31
Albion,523,10,8,6,22,57,83,-26,30
Raith,524,1,23,8,5,72,34,38,77
Ayr,524,2,24,4,8,96,45,51,76
Arbroath,524,3,17,8,11,70,49,21,59
Alloa,524,4,17,8,11,58,47,11,59
Stranraer,524,5,15,5,16,55,66,-11,50
East Fife,524,6,14,3,19,49,64,-15,45
Airdrieon,524,7,10,11,15,45,60,-15,41
Forfar,524,8,11,5,20,40,64,-24,38
Queen's Park,524,9,7,10,19,40,72,-32,31
Albion,524,10,8,6,22,60,84,-24,30
Ayr,525,1,24,4,8,95,43,52,76
Raith,525,2,22,9,5,68,32,36,75
Arbroath,525,3,18,8,10,72,48,24,62
Alloa,525,4,17,9,10,56,43,13,60
Stranraer,525,5,15,6,15,56,65,-9,51
East Fife,525,6,13,4,19,48,65,-17,43
Airdrieon,525,7,10,11,15,45,61,-16,41
Forfar,525,8,11,5,20,41,64,-23,38
Albion,525,9,8,6,22,58,83,-25,30
Queen's Park,525,10,6,10,20,39,74,-35,28
Raith,526,1,23,8,5,71,33,38,77
Ayr,526,2,24,4,8,94,43,51,76
Arbroath,526,3,18,8,10,74,49,25,62
Alloa,526,4,17,8,11,57,46,11,59
Stranraer,526,5,15,5,16,56,67,-11,50
East Fife,526,6,14,3,19,50,65,-15,45
Airdrieon,526,7,11,11,14,47,58,-11,44
Forfar,526,8,10,5,21,38,66,-28,35
Albion,526,9,8,6,22,58,82,-24,30
Queen's Park,526,10,6,10,20,40,76,-36,28
Raith,527,1,23,8,5,69,32,37,77
Ayr,527,2,24,4,8,93,44,49,76
Arbroath,527,3,17,8,11,70,50,20,59
Alloa,527,4,17,8,11,56,44,12,59
Stranraer,527,5,16,5,15,59,64,-5,53
Airdrieon,527,6,10,12,14,46,59,-13,42
East Fife,527,7,13,3,20,47,68,-21,42
Forfar,527,8,10,6,20,39,65,-26,36
Queen's Park,527,9,7,10,19,41,72,-31,31
Albion,527,10,8,6,22,59,81,-22,30
Ayr,528,1,24,4,8,94,44,50,76
Raith,528,2,22,9,5,69,33,36,75
Arbroath,528,3,18,8,10,72,48,24,62
Alloa,528,4,17,9,10,57,44,13,60
Stranraer,528,5,15,5,16,57,69,-12,50
East Fife,528,6,14,3,19,52,66,-14,45
Airdrieon,528,7,10,12,14,47,60,-13,42
Forfar,528,8,10,6,20,40,66,-26,36
Albion,528,9,8,6,22,59,82,-23,30
Queen's Park,528,10,6,10,20,39,74,-35,28
Raith,529,1,23,8,5,69,32,37,77
Ayr,529,2,24,4,8,95,45,50,76
Arbroath,529,3,18,8,10,71,48,23,62
Alloa,529,4,17,8,11,56,44,12,59
Stranraer,529,5,15,6,15,55,64,-9,51
Airdrieon,529,6,11,11,14,47,58,-11,44
East Fife,529,7,13,4,19,47,64,-17,43
Forfar,529,8,10,5,21,38,66,-28,35
Albion,529,9,8,6,22,60,83,-23,30
Queen's Park,529,10,6,10,20,39,73,-34,28
Raith,530,1,23,8,5,71,34,37,77
Ayr,530,2,24,4,8,98,42,56,76
Arbroath,530,3,18,8,10,71,48,23,62
Alloa,530,4,17,8,11,58,46,12,59
Stranraer,530,5,15,6,15,55,64,-9,51
Airdrieon,530,6,11,11,14,47,58,-11,44
East Fife,530,7,13,4,19,47,64,-17,43
Forfar,530,8,10,5,21,38,66,-28,35
Albion,530,9,8,6,22,57,86,-29,30
Queen's Park,530,10,6,10,20,39,73,-34,28
Raith,531,1,23,8,5,70,33,37,77
Ayr,531,2,24,4,8,96,44,52,76
Arbroath,531,3,18,8,10,74,49,25,62
Alloa,531,4,17,8,11,57,45,12,59
Stranraer,531,5,15,5,16,56,67,-11,50
East Fife,531,6,14,3,19,50,65,-15,45
Airdrieon,531,7,10,11,15,45,59,-14,41
Forfar,531,8,11,5,20,39,64,-25,38
Albion,531,9,8,6,22,59,84,-25,30
Queen's Park,531,10,6,10,20,40,76,-36,28
Ayr,532,1,24,4,8,93,44,49,76
Raith,532,2,22,9,5,69,33,36,75
Alloa,532,3,17,9,10,57,44,13,60
Arbroath,532,4,17,8,11,70,49,21,59
Stranraer,532,5,15,5,16,55,65,-10,50
East Fife,532,6,14,3,19,48,64,-16,45
Airdrieon,532,7,11,11,14,46,58,-12,44
Forfar,532,8,10,5,21,38,65,-27,35
Queen's Park,532,9,7,10,19,40,72,-32,31
Albion,532,10,8,6,22,59,81,-22,30
Ayr,533,1,24,4,8,95,44,51,76
Raith,533,2,22,8,6,70,35,35,74
Arbroath,533,3,18,8,10,74,51,23,62
Alloa,533,4,18,8,10,59,45,14,62
Stranraer,533,5,16,5,15,58,65,-7,53
Airdrieon,533,6,10,12,14,45,58,-13,42
East Fife,533,7,13,3,20,48,67,-19,42
Forfar,533,8,10,6,20,38,64,-26,36
Albion,533,9,8,6,22,59,83,-24,30
Queen's Park,533,10,6,10,20,42,76,-34,28
Ayr,534,1,24,4,8,95,42,53,76
Raith,534,2,22,9,5,68,32,36,75
Arbroath,534,3,18,8,10,71,48,23,62
Alloa,534,4,17,9,10,56,43,13,60
Stranraer,534,5,16,5,15,57,64,-7,53
East Fife,534,6,13,3,20,47,66,-19,42
Airdrieon,534,7,10,11,15,46,60,-14,41
Forfar,534,8,11,5,20,40,65,-25,38
Albion,534,9,8,6,22,57,83,-26,30
Queen's Park,534,10,6,10,20,39,73,-34,28
Raith,535,1,23,8,5,71,32,39,77
Ayr,535,2,24,4,8,98,42,56,76
Arbroath,535,3,17,8,11,72,51,21,59
Alloa,535,4,17,8,11,56,46,10,59
Stranraer,535,5,15,6,15,55,64,-9,51
East Fife,535,6,13,4,19,47,64,-17,43
Airdrieon,535,7,10,11,15,46,60,-14,41
Forfar,535,8,11,5,20,40,65,-25,38
Queen's Park,535,9,7,10,19,42,74,-32,31
Albion,535,10,8,6,22,57,86,-29,30
Raith,536,1,23,8,5,70,32,38,77
Ayr,536,2,24,4,8,93,42,51,76
Arbroath,536,3,18,8,10,75,49,26,62
Alloa,536,4,17,8,11,56,45,11,59
Stranraer,536,5,15,5,16,55,69,-14,50
East Fife,536,6,14,3,19,52,64,-12,45
Airdrieon,536,7,11,11,14,47,59,-12,44
Forfar,536,8,10,5,21,39,66,-27,35
Albion,536,9,8,6,22,57,81,-24,30
Queen's Park,536,10,6,10,20,40,77,-37,28
Ayr,537,1,24,4,8,92,43,49,76
Raith,537,2,22,8,6,68,33,35,74
Arbroath,537,3,18,8,10,74,48,26,62
Alloa,537,4,18,8,10,57,43,14,62
Stranraer,537,5,15,5,16,56,66,-10,50
East Fife,537,6,14,3,19,49,65,-16,45
Airdrieon,537,7,10,11,15,45,60,-15,41
Forfar,537,8,11,5,20,40,64,-24,38
Albion,537,9,8,6,22,58,80,-22,30
Queen's Park,537,10,6,10,20,39,76,-37,28
Raith,538,1,23,8,5,69,32,37,77
Ayr,538,2,24,4,8,100,44,56,76
Arbroath,538,3,17,9,10,72,50,22,60
Alloa,538,4,17,8,11,56,44,12,59
Stranraer,538,5,15,5,16,56,66,-10,50
East Fife,538,6,14,3,19,49,65,-16,45
Airdrieon,538,7,10,12,14,45,58,-13,42
Forfar,538,8,10,6,20,38,64,-26,36
Albion,538,9,8,6,22,59,88,-29,30
Queen's Park,538,10,6,11,19,41,74,-33,29
Raith,539,1,23,8,5,69,32,37,77
Ayr,539,2,24,4,8,94,42,52,76
Arbroath,539,3,18,8,10,72,49,23,62
Alloa,539,4,17,8,11,56,44,12,59
Stranraer,539,5,15,5,16,55,67,-12,50
East Fife,539,6,14,3,19,50,64,-14,45
Airdrieon,539,7,11,11,14,48,60,-12,44
Forfar,539,8,10,5,21,40,67,-27,35
Albion,539,9,8,6,22,57,82,-25,30
Queen's Park,539,10,6,10,20,40,74,-34,28
Raith,540,1,23,8,5,72,33,39,77
Ayr,540,2,24,4,8,91,42,49,76
Arbroath,540,3,18,8,10,71,48,23,62
Alloa,540,4,17,8,11,57,47,10,59
Stranraer,540,5,15,6,15,58,67,-9,51
East Fife,540,6,13,4,19,50,67,-17,43
Airdrieon,540,7,10,11,15,46,61,-15,41
Forfar,540,8,11,5,20,41,65,-24,38
Albion,540,9,8,6,22,57,79,-22,30
Queen's Park,540,10,6,10,20,39,73,-34,28
Raith,541,1,23,8,5,69,32,37,77
Ayr,541,2,24,4,8,92,43,49,76
Arbroath,541,3,17,8,11,70,49,21,59
Alloa,541,4,17,8,11,56,44,12,59
Stranraer,541,5,15,5,16,55,66,-11,50
East Fife,541,6,14,3,19,49,64,-15,45
Airdrieon,541,7,11,11,14,46,58,-12,44
Forfar,541,8,10,5,21,38,65,-27,35
Queen's Park,541,9,7,10,19,40,72,-32,31
Albion,541,10,8,6,22,58,80,-22,30
Raith,542,1,23,8,5,70,32,38,77
Ayr,542,2,23,4,9,90,43,47,73
Arbroath,542,3,17,8,11,70,49,21,59
Alloa,542,4,17,8,11,56,45,11,59
Stranraer,542,5,15,6,15,55,64,-9,51
Airdrieon,542,6,11,11,14,46,58,-12,44
East Fife,542,7,13,4,19,47,64,-17,43
Forfar,542,8,10,5,21,38,65,-27,35
Albion,542,9,9,6,21,58,78,-20,33
Queen's Park,542,10,7,10,19,40,72,-32,31
Raith,543,1,23,8,5,70,32,38,77
Ayr,543,2,23,4,9,92,45,47,73
Arbroath,543,3,17,8,11,72,52,20,59
Alloa,543,4,17,8,11,56,45,11,59
Stranraer,543,5,15,5,16,56,66,-10,50
East Fife,543,6,14,3,19,49,65,-16,45
Airdrieon,543,7,10,11,15,47,61,-14,41
Forfar,543,8,11,5,20,41,66,-25,38
Albion,543,9,9,6,21,60,80,-20,33
Queen's Park,543,10,7,10,19,43,74,-31,31
Raith,544,1,23,8,5,70,32,38,77
Ayr,544,2,23,4,9,90,44,46,73
Arbroath,544,3,18,8,10,73,50,23,62
Alloa,544,4,17,8,11,56,45,11,59
Stranraer,544,5,15,5,16,57,67,-10,50
East Fife,544,6,14,3,19,50,66,-16,45
Airdrieon,544,7,10,12,14,46,59,-13,42
Forfar,544,8,10,6,20,39,65,-26,36
Albion,544,9,9,6,21,59,78,-19,33
Queen's Park,544,10,6,10,20,41,75,-34,28
Raith,545,1,23,8,5,69,32,37,77
Ayr,545,2,24,4,8,93,42,51,76
Arbroath,545,3,17,9,10,72,50,22,60
Alloa,545,4,17,8,11,56,44,12,59
Stranraer,545,5,15,5,16,56,66,-10,50
East Fife,545,6,14,3,19,49,65,-16,45
Airdrieon,545,7,11,11,14,48,58,-10,44
Forfar,545,8,10,5,21,38,67,-29,35
Albion,545,9,8,6,22,57,81,-24,30
Queen's Park,545,10,6,11,19,41,74,-33,29
Ayr,546,1,24,4,8,97,43,54,76
Raith,546,2,22,9,5,68,32,36,75
Arbroath,546,3,18,8,10,72,49,23,62
Alloa,546,4,17,9,10,56,43,13,60
Stranraer,546,5,16,5,15,58,66,-8,53
East Fife,546,6,13,3,20,49,67,-18,42
Airdrieon,546,7,10,11,15,47,62,-15,41
Forfar,546,8,11,5,20,42,66,-24,38
Albion,546,9,8,6,22,58,85,-27,30
Queen's Park,546,10,6,10,20,40,74,-34,28
Raith,547,1,23,8,5,69,32,37,77
Ayr,547,2,24,4,8,95,43,52,76
Arbroath,547,3,18,8,10,74,48,26,62
Alloa,547,4,17,8,11,56,44,12,59
Stranraer,547,5,15,5,16,56,66,-10,50
East Fife,547,6,14,3,19,49,65,-16,45
Airdrieon,547,7,11,11,14,47,58,-11,44
Forfar,547,8,10,5,21,38,66,-28,35
Albion,547,9,8,6,22,58,83,-25,30
Queen's Park,547,10,6,10,20,39,76,-37,28
Ayr,548,1,24,4,8,93,42,51,76
Raith,548,2,22,8,6,68,33,35,74
Alloa,548,3,18,8,10,57,43,14,62
Arbroath,548,4,17,8,11,71,50,21,59
Stranraer,548,5,16,5,15,57,65,-8,53
East Fife,548,6,13,3,20,48,66,-18,42
Airdrieon,548,7,10,11,15,45,59,-14,41
Forfar,548,8,11,5,20,39,64,-25,38
Queen's Park,548,9,7,10,19,41,73,-32,31
Albion,548,10,8,6,22,57,81,-24,30
Raith,549,1,23,8,5,69,32,37,77
Ayr,549,2,24,4,8,91,42,49,76
Arbroath,549,3,18,8,10,72,49,23,62
Alloa,549,4,17,8,11,56,44,12,59
Stranraer,549,5,16,5,15,57,64,-7,53
Airdrieon,549,6,11,11,14,46,58,-12,44
East Fife,549,7,13,3,20,47,66,-19,42
Forfar,549,8,10,5,21,38,65,-27,35
Albion,549,9,8,6,22,57,79,-22,30
Queen's Park,549,10,6,10,20,40,74,-34,28
Ayr,550,1,24,4,8,93,43,50,76
Raith,550,2,22,9,5,70,34,36,75
Arbroath,550,3,18,8,10,74,50,24,62
Alloa,550,4,17,9,10,58,45,13,60
Stranraer,550,5,15,6,15,57,66,-9,51
East Fife,550,6,13,4,19,49,66,-17,43
Airdrieon,550,7,10,11,15,45,60,-15,41
Forfar,550,8,11,5,20,40,64,-24,38
Albion,550,9,8,6,22,58,81,-23,30
Queen's Park,550,10,6,10,20,41,76,-35,28
Raith,551,1,23,8,5,69,32,37,77
Ayr,551,2,24,4,8,96,42,54,76
Arbroath,551,3,17,9,10,73,51,22,60
Alloa,551,4,17,8,11,56,44,12,59
Stranraer,551,5,15,5,16,56,66,-10,50
East Fife,551,6,14,3,19,49,65,-16,45
Airdrieon,551,7,10,11,15,45,59,-14,41
Forfar,551,8,11,5,20,39,64,-25,38
Albion,551,9,8,6,22,57,84,-27,30
Queen's Park,551,10,6,11,19,42,75,-33,29
Raith,552,1,23,8,5,71,32,39,77
Ayr,552,2,24,4,8,95,42,53,76
Arbroath,552,3,18,8,10,74,48,26,62
Alloa,552,4,17,8,11,56,46,10,59
Stranraer,552,5,15,6,15,56,65,-9,51
East Fife,552,6,13,4,19,48,65,-17,43
Airdrieon,552,7,10,12,14,46,59,-13,42
Forfar,552,8,10,6,20,39,65,-26,36
Albion,552,9,8,6,22,57,83,-26,30
Queen's Park,552,10,6,10,20,39,76,-37,28
Raith,553,1,23,8,5,70,32,38,77
Ayr,553,2,24,4,8,97,44,53,76
Arbroath,553,3,17,8,11,70,50,20,59
Alloa,553,4,17,8,11,56,45,11,59
Stranraer,553,5,15,6,15,58,67,-9,51
East Fife,553,6,13,4,19,50,67,-17,43
Airdrieon,553,7,10,11,15,45,59,-14,41
Forfar,553,8,11,5,20,39,64,-25,38
Queen's Park,553,9,7,10,19,41,72,-31,31
Albion,553,10,8,6,22,59,85,-26,30
Raith,554,1,23,8,5,72,33,39,77
Ayr,554,2,24,4,8,93,43,50,76
Arbroath,554,3,17,8,11,72,51,21,59
Alloa,554,4,17,8,11,57,47,10,59
Stranraer,554,5,16,5,15,58,66,-8,53
Airdrieon,554,6,11,11,14,50,59,-9,44
East Fife,554,7,13,3,20,49,67,-18,42
Forfar,554,8,10,5,21,39,69,-30,35
Queen's Park,554,9,7,10,19,42,74,-32,31
Albion,554,10,8,6,22,58,81,-23,30
Raith,555,1,23,8,5,69,32,37,77
Ayr,555,2,24,4,8,93,43,50,76
Arbroath,555,3,17,8,11,70,49,21,59
Alloa,555,4,17,8,11,56,44,12,59
Stranraer,555,5,16,5,15,57,64,-7,53
Airdrieon,555,6,11,11,14,48,59,-11,44
East Fife,555,7,13,3,20,47,66,-19,42
Forfar,555,8,10,5,21,39,67,-28,35
Queen's Park,555,9,7,10,19,40,72,-32,31
Albion,555,10,8,6,22,58,81,-23,30
Raith,556,1,23,8,5,70,33,37,77
Ayr,556,2,24,4,8,94,45,49,76
Arbroath,556,3,17,8,11,70,49,21,59
Alloa,556,4,17,8,11,57,45,12,59
Stranraer,556,5,15,5,16,56,67,-11,50
East Fife,556,6,14,3,19,50,65,-15,45
Airdrieon,556,7,10,11,15,46,61,-15,41
Forfar,556,8,11,5,20,41,65,-24,38
Queen's Park,556,9,7,10,19,40,72,-32,31
Albion,556,10,8,6,22,60,82,-22,30
Raith,557,1,23,8,5,72,35,37,77
Ayr,557,2,24,4,8,91,42,49,76
Arbroath,557,3,18,8,10,72,49,23,62
Alloa,557,4,17,8,11,59,47,12,59
Stranraer,557,5,16,5,15,60,65,-5,53
Airdrieon,557,6,10,12,14,46,59,-13,42
East Fife,557,7,13,3,20,48,69,-21,42
Forfar,557,8,10,6,20,39,65,-26,36
Albion,557,9,8,6,22,57,79,-22,30
Queen's Park,557,10,6,10,20,40,74,-34,28
Raith,558,1,23,8,5,70,32,38,77
Ayr,558,2,24,4,8,91,42,49,76
Arbroath,558,3,17,8,11,71,50,21,59
Alloa,558,4,17,8,11,56,45,11,59
Stranraer,558,5,16,5,15,57,65,-8,53
East Fife,558,6,13,3,20,48,66,-18,42
Airdrieon,558,7,10,11,15,46,61,-15,41
Forfar,558,8,11,5,20,41,65,-24,38
Queen's Park,558,9,7,10,19,41,73,-32,31
Albion,558,10,8,6,22,57,79,-22,30
Ayr,559,1,24,4,8,94,44,50,76
Raith,559,2,22,8,6,68,35,33,74
Alloa,559,3,18,8,10,59,43,16,62
Arbroath,559,4,17,9,10,71,49,22,60
Stranraer,559,5,15,5,16,56,66,-10,50
East Fife,559,6,14,3,19,49,65,-16,45
Airdrieon,559,7,11,11,14,47,59,-12,44
Forfar,559,8,10,5,21,39,66,-27,35
Albion,559,9,8,6,22,59,82,-23,30
Queen's Park,559,10,6,11,19,40,73,-33,29
Raith,560,1,23,8,5,69,32,37,77
Ayr,560,2,24,4,8,93,42,51,76
Arbroath,560,3,18,8,10,73,48,25,62
Alloa,560,4,17,8,11,56,44,12,59
Stranraer,560,5,15,6,15,55,64,-9,51
Airdrieon,560,6,11,11,14,50,61,-11,44
East Fife,560,7,13,4,19,47,64,-17,43
Forfar,560,8,10,5,21,41,69,-28,35
Albion,560,9,8,6,22,57,81,-24,30
Queen's Park,560,10,6,10,20,39,75,-36,28
Raith,561,1,23,8,5,72,32,40,77
Ayr,561,2,24,4,8,98,42,56,76
Arbroath,561,3,17,9,10,72,50,22,60
Alloa,561,4,17,8,11,56,47,9,59
Stranraer,561,5,16,5,15,58,65,-7,53
Airdrieon,561,6,11,11,14,47,58,-11,44
East Fife,561,7,13,3,20,48,67,-19,42
Forfar,561,8,10,5,21,38,66,-28,35
Albion,561,9,8,6,22,57,86,-29,30
Queen's Park,561,10,6,11,19,41,74,-33,29
Ayr,562,1,24,4,8,94,45,49,76
Raith,562,2,22,9,5,69,33,36,75
Alloa,562,3,17,9,10,57,44,13,60
Arbroath,562,4,17,8,11,71,50,21,59
Stranraer,562,5,15,5,16,56,66,-10,50
East Fife,562,6,14,3,19,49,65,-16,45
Airdrieon,562,7,11,11,14,47,58,-11,44
Forfar,562,8,10,5,21,38,66,-28,35
Queen's Park,562,9,7,10,19,41,73,-32,31
Albion,562,10,8,6,22,60,82,-22,30
Raith,563,1,23,8,5,70,33,37,77
Ayr,563,2,24,4,8,93,44,49,76
Arbroath,563,3,18,8,10,76,49,27,62
Alloa,563,4,17,8,11,57,45,12,59
Stranraer,563,5,16,5,15,56,64,-8,53
East Fife,563,6,13,3,20,47,65,-18,42
Airdrieon,563,7,10,11,15,47,62,-15,41
Forfar,563,8,11,5,20,42,66,-24,38
Albion,563,9,8,6,22,59,81,-22,30
Queen's Park,563,10,6,10,20,40,78,-38,28
Ayr,564,1,24,4,8,92,43,49,76
Raith,564,2,22,9,5,69,33,36,75
Alloa,564,3,17,9,10,57,44,13,60
Arbroath,564,4,17,8,11,70,52,18,59
Stranraer,564,5,15,5,16,55,68,-13,50
East Fife,564,6,14,3,19,51,64,-13,45
Airdrieon,564,7,10,11,15,45,59,-14,41
Forfar,564,8,11,5,20,39,64,-25,38
Queen's Park,564,9,7,10,19,43,72,-29,31
Albion,564,10,8,6,22,58,80,-22,30
Raith,565,1,23,8,5,70,33,37,77
Ayr,565,2,24,4,8,93,43,50,76
Arbroath,565,3,17,8,11,72,51,21,59
Alloa,565,4,17,8,11,57,45,12,59
Stranraer,565,5,15,6,15,56,65,-9,51
East Fife,565,6,13,4,19,48,65,-17,43
Airdrieon,565,7,10,12,14,45,58,-13,42
Forfar,565,8,10,6,20,38,64,-26,36
Queen's Park,565,9,7,10,19,42,74,-32,31
Albion,565,10,8,6,22,58,81,-23,30
Ayr,566,1,23,5,8,93,45,48,74
Raith,566,2,22,8,6,68,34,34,74
Arbroath,566,3,18,8,10,73,48,25,62
Alloa,566,4,18,8,10,58,43,15,62
Stranraer,566,5,16,5,15,57,65,-8,53
Airdrieon,566,6,10,12,14,47,60,-13,42
East Fife,566,7,13,3,20,48,66,-18,42
Forfar,566,8,10,6,20,40,66,-26,36
Albion,566,9,8,7,21,60,81,-21,31
Queen's Park,566,10,6,10,20,39,75,-36,28
Raith,567,1,23,8,5,69,32,37,77
Ayr,567,2,24,4,8,95,42,53,76
Arbroath,567,3,18,8,10,71,48,23,62
Alloa,567,4,17,8,11,56,44,12,59
Stranraer,567,5,15,5,16,56,66,-10,50
East Fife,567,6,14,3,19,49,65,-16,45
Airdrieon,567,7,10,11,15,45,59,-14,41
Forfar,567,8,11,5,20,39,64,-25,38
Albion,567,9,8,6,22,57,83,-26,30
Queen's Park,567,10,6,10,20,39,73,-34,28
Ayr,568,1,24,4,8,98,43,55,76
Raith,568,2,22,9,5,70,34,36,75
Arbroath,568,3,18,8,10,72,48,24,62
Alloa,568,4,17,9,10,58,45,13,60
Stranraer,568,5,15,6,15,56,65,-9,51
East Fife,568,6,13,4,19,48,65,-17,43
Airdrieon,568,7,10,12,14,46,59,-13,42
Forfar,568,8,10,6,20,39,65,-26,36
Albion,568,9,8,6,22,58,86,-28,30
Queen's Park,568,10,6,10,20,39,74,-35,28
Ayr,569,1,24,4,8,94,42,52,76
Raith,569,2,22,9,5,69,33,36,75
Arbroath,569,3,18,8,10,73,49,24,62
Alloa,569,4,17,9,10,57,44,13,60
Stranraer,569,5,15,5,16,58,68,-10,50
East Fife,569,6,14,3,19,51,67,-16,45
Airdrieon,569,7,10,12,14,46,59,-13,42
Forfar,569,8,10,6,20,39,65,-26,36
Albion,569,9,8,6,22,57,82,-25,30
Queen's Park,569,10,6,10,20,40,75,-35,28
Raith,570,1,23,8,5,74,33,41,77
Ayr,570,2,24,4,8,92,43,49,76
Arbroath,570,3,17,8,11,72,52,20,59
Alloa,570,4,17,8,11,57,49,8,59
Stranraer,570,5,16,5,15,57,64,-7,53
Airdrieon,570,6,11,11,14,47,59,-12,44
East Fife,570,7,13,3,20,47,66,-19,42
Forfar,570,8,10,5,21,39,66,-27,35
Queen's Park,570,9,7,10,19,43,74,-31,31
Albion,570,10,8,6,22,58,80,-22,30
Raith,571,1,23,8,5,70,33,37,77
Ayr,571,2,24,4,8,94,43,51,76
Arbroath,571,3,18,8,10,73,48,25,62
Alloa,571,4,17,8,11,57,45,12,59
Stranraer,571,5,15,6,15,57,66,-9,51
Airdrieon,571,6,11,11,14,48,58,-10,44
East Fife,571,7,13,4,19,49,66,-17,43
Forfar,571,8,10,5,21,38,67,-29,35
Albion,571,9,8,6,22,58,82,-24,30
Queen's Park,571,10,6,10,20,39,75,-36,28
Ayr,572,1,24,4,8,91,42,49,76
Raith,572,2,22,9,5,69,33,36,75
Arbroath,572,3,18,8,10,72,49,23,62
Alloa,572,4,17,9,10,57,44,13,60
Stranraer,572,5,15,6,15,56,65,-9,51
Airdrieon,572,6,11,11,14,46,58,-12,44
East Fife,572,7,13,4,19,48,65,-17,43
Forfar,572,8,10,5,21,38,65,-27,35
Albion,572,9,8,6,22,57,79,-22,30
Queen's Park,572,10,6,10,20,40,74,-34,28
Raith,573,1,22,8,6,68,36,32,74
Ayr,573,2,23,4,9,92,45,47,73
Alloa,573,3,18,8,10,60,43,17,62
Arbroath,573,4,17,9,10,72,50,22,60
Stranraer,573,5,15,5,16,56,67,-11,50
East Fife,573,6,14,3,19,50,65,-15,45
Airdrieon,573,7,10,11,15,46,60,-14,41
Forfar,573,8,11,5,20,40,65,-25,38
Albion,573,9,9,6,21,60,80,-20,33
Queen's Park,573,10,6,11,19,41,74,-33,29
Raith,574,1,23,8,5,70,33,37,77
Ayr,574,2,24,4,8,94,43,51,76
Arbroath,574,3,18,8,10,73,50,23,62
Alloa,574,4,17,8,11,57,45,12,59
Stranraer,574,5,15,5,16,55,68,-13,50
East Fife,574,6,14,3,19,51,64,-13,45
Airdrieon,574,7,11,11,14,49,60,-11,44
Forfar,574,8,10,5,21,40,68,-28,35
Albion,574,9,8,6,22,58,82,-24,30
Queen's Park,574,10,6,10,20,41,75,-34,28
Ayr,575,1,24,4,8,96,43,53,76
Raith,575,2,22,8,6,69,35,34,74
Alloa,575,3,18,8,10,59,44,15,62
Arbroath,575,4,17,9,10,72,50,22,60
Stranraer,575,5,15,5,16,55,66,-11,50
East Fife,575,6,14,3,19,49,64,-15,45
Airdrieon,575,7,10,11,15,45,61,-16,41
Forfar,575,8,11,5,20,41,64,-23,38
Albion,575,9,8,6,22,58,84,-26,30
Queen's Park,575,10,6,11,19,41,74,-33,29
Raith,576,1,23,8,5,70,32,38,77
Ayr,576,2,24,4,8,93,43,50,76
Arbroath,576,3,18,8,10,71,48,23,62
Alloa,576,4,17,8,11,56,45,11,59
Stranraer,576,5,16,5,15,57,65,-8,53
Airdrieon,576,6,11,11,14,46,58,-12,44
East Fife,576,7,13,3,20,48,66,-18,42
Forfar,576,8,10,5,21,38,65,-27,35
Albion,576,9,8,6,22,58,81,-23,30
Queen's Park,576,10,6,10,20,39,73,-34,28
Ayr,577,1,23,5,8,92,44,48,74
Raith,577,2,22,8,6,68,33,35,74
Alloa,577,3,18,8,10,57,43,14,62
Arbroath,577,4,17,8,11,72,53,19,59
Stranraer,577,5,15,6,15,56,65,-9,51
East Fife,577,6,13,4,19,48,65,-17,43
Airdrieon,577,7,10,11,15,48,62,-14,41
Forfar,577,8,11,5,20,42,67,-25,38
Albion,577,9,8,7,21,59,80,-21,31
Queen's Park,577,10,7,10,19,44,74,-30,31
Raith,578,1,23,8,5,70,33,37,77
Ayr,578,2,24,4,8,94,43,51,76
Arbroath,578,3,17,9,10,70,48,22,60
Alloa,578,4,17,8,11,57,45,12,59
Stranraer,578,5,16,5,15,57,65,-8,53
East Fife,578,6,13,3,20,48,66,-18,42
Airdrieon,578,7,10,11,15,46,63,-17,41
Forfar,578,8,11,5,20,43,65,-22,38
Albion,578,9,8,6,22,58,82,-24,30
Queen's Park,578,10,6,11,19,39,72,-33,29
Raith,579,1,23,8,5,72,33,39,77
Ayr,579,2,24,4,8,93,43,50,76
Arbroath,579,3,18,8,10,73,48,25,62
Alloa,579,4,17,8,11,57,47,10,59
Stranraer,579,5,15,5,16,55,67,-12,50
East Fife,579,6,14,3,19,50,64,-14,45
Airdrieon,579,7,11,11,14,46,58,-12,44
Forfar,579,8,10,5,21,38,65,-27,35
Albion,579,9,8,6,22,58,81,-23,30
Queen's Park,579,10,6,10,20,39,75,-36,28
Ayr,580,1,24,4,8,94,44,50,76
Raith,580,2,22,9,5,69,33,36,75
Arbroath,580,3,18,8,10,72,49,23,62
Alloa,580,4,17,9,10,57,44,13,60
Stranraer,580,5,15,5,16,55,68,-13,50
East Fife,580,6,14,3,19,51,64,-13,45
Airdrieon,580,7,11,11,14,48,59,-11,44
Forfar,580,8,10,5,21,39,67,-28,35
Albion,580,9,8,6,22,59,82,-23,30
Queen's Park,580,10,6,10,20,40,74,-34,28
Ayr,581,1,24,4,8,94,45,49,76
Raith,581,2,22,9,5,68,32,36,75
Arbroath,581,3,18,8,10,72,49,23,62
Alloa,581,4,17,9,10,56,43,13,60
Stranraer,581,5,15,5,16,55,66,-11,50
East Fife,581,6,14,3,19,49,64,-15,45
Airdrieon,581,7,10,12,14,46,59,-13,42
Forfar,581,8,10,6,20,39,65,-26,36
Albion,581,9,8,6,22,60,82,-22,30
Queen's Park,581,10,6,10,20,40,74,-34,28
Ayr,582,1,24,4,8,95,43,52,76
Raith,582,2,22,8,6,69,34,35,74
Alloa,582,3,18,8,10,58,44,14,62
Arbroath,582,4,17,8,11,70,50,20,59
Stranraer,582,5,15,5,16,56,66,-10,50
East Fife,582,6,14,3,19,49,65,-16,45
Airdrieon,582,7,11,11,14,47,59,-12,44
Forfar,582,8,10,5,21,39,66,-27,35
Queen's Park,582,9,7,10,19,41,72,-31,31
Albion,582,10,8,6,22,58,83,-25,30
Raith,583,1,23,8,5,69,32,37,77
Ayr,583,2,24,4,8,93,43,50,76
Arbroath,583,3,18,8,10,72,49,23,62
Alloa,583,4,17,8,11,56,44,12,59
Stranraer,583,5,15,5,16,55,65,-10,50
East Fife,583,6,14,3,19,48,64,-16,45
Airdrieon,583,7,10,12,14,46,59,-13,42
Forfar,583,8,10,6,20,39,65,-26,36
Albion,583,9,8,6,22,58,81,-23,30
Queen's Park,583,10,6,10,20,40,74,-34,28
Ayr,584,1,24,4,8,93,42,51,76
Raith,584,2,22,9,5,69,33,36,75
Arbroath,584,3,18,8,10,73,50,23,62
Alloa,584,4,17,9,10,57,44,13,60
Stranraer,584,5,15,5,16,58,69,-11,50
East Fife,584,6,14,3,19,52,67,-15,45
Airdrieon,584,7,11,11,14,46,58,-12,44
Forfar,584,8,10,5,21,38,65,-27,35
Albion,584,9,8,6,22,57,81,-24,30
Queen's Park,584,10,6,10,20,41,75,-34,28
Raith,585,1,23,8,5,69,32,37,77
Ayr,585,2,24,4,8,92,43,49,76
Arbroath,585,3,17,9,10,71,49,22,60
Alloa,585,4,17,8,11,56,44,12,59
Stranraer,585,5,16,5,15,57,64,-7,53
East Fife,585,6,13,3,20,47,66,-19,42
Airdrieon,585,7,10,11,15,47,61,-14,41
Forfar,585,8,11,5,20,41,66,-25,38
Albion,585,9,8,6,22,58,80,-22,30
Queen's Park,585,10,6,11,19,40,73,-33,29
Raith,586,1,23,8,5,70,32,38,77
Ayr,586,2,24,4,8,92,42,50,76
Arbroath,586,3,17,8,11,70,50,20,59
Alloa,586,4,17,8,11,56,45,11,59
Stranraer,586,5,16,5,15,57,65,-8,53
Airdrieon,586,6,11,11,14,46,58,-12,44
East Fife,586,7,13,3,20,48,66,-18,42
Forfar,586,8,10,5,21,38,65,-27,35
Queen's Park,586,9,7,10,19,41,72,-31,31
Albion,586,10,8,6,22,57,80,-23,30
Raith,587,1,23,8,5,72,35,37,77
Ayr,587,2,24,4,8,94,42,52,76
Arbroath,587,3,17,8,11,70,51,19,59
Alloa,587,4,17,8,11,59,47,12,59
Stranraer,587,5,15,5,16,55,65,-10,50
East Fife,587,6,14,3,19,48,64,-16,45
Airdrieon,587,7,10,12,14,46,59,-13,42
Forfar,587,8,10,6,20,39,65,-26,36
Queen's Park,587,9,7,10,19,42,72,-30,31
Albion,587,10,8,6,22,57,82,-25,30
Ayr,588,1,24,4,8,92,43,49,76
Raith,588,2,22,9,5,69,33,36,75
Arbroath,588,3,18,8,10,73,48,25,62
Alloa,588,4,17,9,10,57,44,13,60
Stranraer,588,5,15,5,16,57,67,-10,50
East Fife,588,6,14,3,19,50,66,-16,45
Airdrieon,588,7,10,11,15,46,61,-15,41
Forfar,588,8,11,5,20,41,65,-24,38
Albion,588,9,8,6,22,58,80,-22,30
Queen's Park,588,10,6,10,20,39,75,-36,28
Raith,589,1,23,8,5,69,32,37,77
Ayr,589,2,24,4,8,95,42,53,76
Arbroath,589,3,17,8,11,70,52,18,59
Alloa,589,4,17,8,11,56,44,12,59
Stranraer,589,5,16,5,15,58,64,-6,53
Airdrieon,589,6,10,12,14,46,59,-13,42
East Fife,589,7,13,3,20,47,67,-20,42
Forfar,589,8,10,6,20,39,65,-26,36
Queen's Park,589,9,7,10,19,43,72,-29,31
Albion,589,10,8,6,22,57,83,-26,30
Raith,590,1,22,9,5,69,33,36,75
Ayr,590,2,23,5,8,93,45,48,74
Arbroath,590,3,18,8,10,73,49,24,62
Alloa,590,4,17,9,10,57,44,13,60
Stranraer,590,5,15,5,16,55,67,-12,50
East Fife,590,6,14,3,19,50,64,-14,45
Airdrieon,590,7,10,12,14,46,59,-13,42
Forfar,590,8,10,6,20,39,65,-26,36
Albion,590,9,8,7,21,60,81,-21,31
Queen's Park,590,10,6,10,20,40,75,-35,28
Raith,591,1,23,8,5,71,33,38,77
Ayr,591,2,24,4,8,95,43,52,76
Arbroath,591,3,17,9,10,71,49,22,60
Alloa,591,4,17,8,11,57,46,11,59
Stranraer,591,5,15,6,15,56,65,-9,51
Airdrieon,591,6,11,11,14,47,59,-12,44
East Fife,591,7,13,4,19,48,65,-17,43
Forfar,591,8,10,5,21,39,66,-27,35
Albion,591,9,8,6,22,58,83,-25,30
Queen's Park,591,10,6,11,19,40,73,-33,29
Ayr,592,1,24,4,8,96,43,53,76
Raith,592,2,22,9,5,69,33,36,75
Arbroath,592,3,17,9,10,71,49,22,60
Alloa,592,4,17,9,10,57,44,13,60
Stranraer,592,5,15,5,16,55,66,-11,50
East Fife,592,6,14,3,19,49,64,-15,45
Airdrieon,592,7,11,11,14,48,60,-12,44
Forfar,592,8,10,5,21,40,67,-27,35
Albion,592,9,8,6,22,58,84,-26,30
Queen's Park,592,10,6,11,19,40,73,-33,29
Raith,593,1,23,8,5,71,34,37,77
Ayr,593,2,24,4,8,93,43,50,76
Arbroath,593,3,18,8,10,72,49,23,62
Alloa,593,4,17,8,11,58,46,12,59
Stranraer,593,5,15,6,15,56,65,-9,51
Airdrieon,593,6,11,11,14,47,58,-11,44
East Fife,593,7,13,4,19,48,65,-17,43
Forfar,593,8,10,5,21,38,66,-28,35
Albion,593,9,8,6,22,58,81,-23,30
Queen's Park,593,10,6,10,20,40,74,-34,28
Raith,594,1,23,8,5,70,33,37,77
Ayr,594,2,24,4,8,93,43,50,76
Arbroath,594,3,17,8,11,70,49,21,59
Alloa,594,4,17,8,11,57,45,12,59
Stranraer,594,5,16,5,15,57,64,-7,53
Airdrieon,594,6,11,11,14,47,58,-11,44
East Fife,594,7,13,3,20,47,66,-19,42
Forfar,594,8,10,5,21,38,66,-28,35
Queen's Park,594,9,7,10,19,40,72,-32,31
Albion,594,10,8,6,22,58,81,-23,30
Raith,595,1,22,9,5,68,32,36,75
Ayr,595,2,23,4,9,91,45,46,73
Alloa,595,3,17,9,10,56,43,13,60
Arbroath,595,4,17,8,11,72,51,21,59
Stranraer,595,5,15,5,16,55,65,-10,50
East Fife,595,6,14,3,19,48,64,-16,45
Airdrieon,595,7,10,12,14,46,59,-13,42
Forfar,595,8,10,6,20,39,65,-26,36
Albion,595,9,9,6,21,60,79,-19,33
Queen's Park,595,10,7,10,19,42,74,-32,31
Raith,596,1,23,8,5,71,33,38,77
Ayr,596,2,23,4,9,92,45,47,73
Arbroath,596,3,17,9,10,71,49,22,60
Alloa,596,4,17,8,11,57,46,11,59
Stranraer,596,5,15,5,16,56,66,-10,50
East Fife,596,6,14,3,19,49,65,-16,45
Airdrieon,596,7,10,11,15,45,59,-14,41
Forfar,596,8,11,5,20,39,64,-25,38
Albion,596,9,9,6,21,60,80,-20,33
Queen's Park,596,10,6,11,19,40,73,-33,29
Raith,597,1,23,8,5,69,32,37,77
Ayr,597,2,23,5,8,92,44,48,74
Arbroath,597,3,18,8,10,71,48,23,62
Alloa,597,4,17,8,11,56,44,12,59
Stranraer,597,5,15,5,16,56,68,-12,50
East Fife,597,6,14,3,19,51,65,-14,45
Airdrieon,597,7,11,11,14,47,59,-12,44
Forfar,597,8,10,5,21,39,66,-27,35
Albion,597,9,8,7,21,59,80,-21,31
Queen's Park,597,10,6,10,20,39,73,-34,28
Raith,598,1,23,8,5,70,33,37,77
Ayr,598,2,23,4,9,91,45,46,73
Arbroath,598,3,18,8,10,74,49,25,62
Alloa,598,4,17,8,11,57,45,12,59
Stranraer,598,5,15,5,16,56,67,-11,50
East Fife,598,6,14,3,19,50,65,-15,45
Airdrieon,598,7,11,11,14,47,59,-12,44
Forfar,598,8,10,5,21,39,66,-27,35
Albion,598,9,9,6,21,60,79,-19,33
Queen's Park,598,10,6,10,20,40,76,-36,28
Raith,599,1,23,8,5,70,32,38,77
Ayr,599,2,24,4,8,93,44,49,76
Arbroath,599,3,17,9,10,74,52,22,60
Alloa,599,4,17,8,11,56,45,11,59
Stranraer,599,5,15,5,16,56,66,-10,50
East Fife,599,6,14,3,19,49,65,-16,45
Airdrieon,599,7,10,12,14,46,59,-13,42
Forfar,599,8,10,6,20,39,65,-26,36
Albion,599,9,8,6,22,59,81,-22,30
Queen's Park,599,10,6,11,19,43,76,-33,29
Ayr,600,1,24,4,8,94,43,51,76
Raith,600,2,22,9,5,70,34,36,75
Arbroath,600,3,17,9,10,72,50,22,60
Alloa,600,4,17,9,10,58,45,13,60
Stranraer,600,5,15,5,16,56,68,-12,50
East Fife,600,6,14,3,19,51,65,-14,45
Airdrieon,600,7,11,11,14,46,58,-12,44
Forfar,600,8,10,5,21,38,65,-27,35
Albion,600,9,8,6,22,58,82,-24,30
Queen's Park,600,10,6,11,19,41,74,-33,29
Raith,601,1,23,8,5,72,33,39,77
Ayr,601,2,24,4,8,92,42,50,76
Arbroath,601,3,17,9,10,71,49,22,60
Alloa,601,4,17,8,11,57,47,10,59
Stranraer,601,5,15,6,15,56,65,-9,51
Airdrieon,601,6,11,11,14,49,59,-10,44
East Fife,601,7,13,4,19,48,65,-17,43
Forfar,601,8,10,5,21,39,68,-29,35
Albion,601,9,8,6,22,57,80,-23,30
Queen's Park,601,10,6,11,19,40,73,-33,29
Raith,602,1,23,8,5,72,34,38,77
Ayr,602,2,23,5,8,90,42,48,74
Arbroath,602,3,17,9,10,72,50,22,60
Alloa,602,4,17,8,11,58,47,11,59
Stranraer,602,5,15,6,15,56,65,-9,51
East Fife,602,6,13,4,19,48,65,-17,43
Airdrieon,602,7,10,11,15,45,60,-15,41
Forfar,602,8,11,5,20,40,64,-24,38
Albion,602,9,8,7,21,57,78,-21,31
Queen's Park,602,10,6,11,19,41,74,-33,29
Ayr,603,1,24,4,8,94,43,51,76
Raith,603,2,22,8,6,68,33,35,74
Alloa,603,3,18,8,10,57,43,14,62
Arbroath,603,4,17,8,11,71,50,21,59
Stranraer,603,5,15,6,15,56,65,-9,51
Airdrieon,603,6,11,11,14,48,58,-10,44
East Fife,603,7,13,4,19,48,65,-17,43
Forfar,603,8,10,5,21,38,67,-29,35
Queen's Park,603,9,7,10,19,41,73,-32,31
Albion,603,10,8,6,22,58,82,-24,30
Raith,604,1,23,8,5,73,33,40,77
Ayr,604,2,24,4,8,93,44,49,76
Arbroath,604,3,18,8,10,72,49,23,62
Alloa,604,4,17,8,11,57,48,9,59
Stranraer,604,5,15,6,15,56,65,-9,51
Airdrieon,604,6,11,11,14,48,58,-10,44
East Fife,604,7,13,4,19,48,65,-17,43
Forfar,604,8,10,5,21,38,67,-29,35
Albion,604,9,8,6,22,59,81,-22,30
Queen's Park,604,10,6,10,20,40,74,-34,28
Raith,605,1,23,8,5,71,33,38,77
Ayr,605,2,24,4,8,92,43,49,76
Arbroath,605,3,17,9,10,71,49,22,60
Alloa,605,4,17,8,11,57,46,11,59
Stranraer,605,5,15,5,16,56,69,-13,50
East Fife,605,6,14,3,19,52,65,-13,45
Airdrieon,605,7,11,11,14,47,58,-11,44
Forfar,605,8,10,5,21,38,66,-28,35
Albion,605,9,8,6,22,58,80,-22,30
Queen's Park,605,10,6,11,19,40,73,-33,29
Raith,606,1,23,8,5,69,32,37,77
Ayr,606,2,24,4,8,95,44,51,76
Arbroath,606,3,17,8,11,72,52,20,59
Alloa,606,4,17,8,11,56,44,12,59
Stranraer,606,5,15,5,16,57,72,-15,50
East Fife,606,6,14,3,19,55,66,-11,45
Airdrieon,606,7,11,11,14,49,58,-9,44
Forfar,606,8,10,5,21,38,68,-30,35
Queen's Park,606,9,7,10,19,43,74,-31,31
Albion,606,10,8,6,22,59,83,-24,30
Raith,607,1,23,8,5,69,32,37,77
Ayr,607,2,24,4,8,96,44,52,76
Arbroath,607,3,17,8,11,72,51,21,59
Alloa,607,4,17,8,11,56,44,12,59
Stranraer,607,5,15,6,15,57,66,-9,51
East Fife,607,6,13,4,19,49,66,-17,43
Airdrieon,607,7,10,11,15,45,59,-14,41
Forfar,607,8,11,5,20,39,64,-25,38
Queen's Park,607,9,7,10,19,42,74,-32,31
Albion,607,10,8,6,22,59,84,-25,30
Ayr,608,1,24,4,8,93,43,50,76
Raith,608,2,22,8,6,70,35,35,74
Alloa,608,3,18,8,10,59,45,14,62
Arbroath,608,4,17,8,11,70,50,20,59
Stranraer,608,5,16,5,15,59,65,-6,53
Airdrieon,608,6,11,11,14,47,59,-12,44
East Fife,608,7,13,3,20,48,68,-20,42
Forfar,608,8,10,5,21,39,66,-27,35
Queen's Park,608,9,7,10,19,41,72,-31,31
Albion,608,10,8,6,22,58,81,-23,30
Raith,609,1,22,8,6,69,35,34,74
Ayr,609,2,23,4,9,91,44,47,73
Alloa,609,3,18,8,10,59,44,15,62
Arbroath,609,4,17,8,11,71,51,20,59
Stranraer,609,5,15,6,15,56,65,-9,51
East Fife,609,6,13,4,19,48,65,-17,43
Airdrieon,609,7,10,11,15,46,60,-14,41
Forfar,609,8,11,5,20,40,65,-25,38
Albion,609,9,9,6,21,59,79,-20,33
Queen's Park,609,10,7,10,19,42,73,-31,31
Ayr,610,1,24,4,8,97,43,54,76
Raith,610,2,22,9,5,68,32,36,75
Arbroath,610,3,18,8,10,77,48,29,62
Alloa,610,4,17,9,10,56,43,13,60
Stranraer,610,5,16,5,15,60,64,-4,53
East Fife,610,6,13,3,20,47,69,-22,42
Airdrieon,610,7,10,11,15,46,60,-14,41
Forfar,610,8,11,5,20,40,65,-25,38
Albion,610,9,8,6,22,58,85,-27,30
Queen's Park,610,10,6,10,20,39,79,-40,28
Raith,611,1,23,8,5,70,32,38,77
Ayr,611,2,24,4,8,92,43,49,76
Arbroath,611,3,17,9,10,70,48,22,60
Alloa,611,4,17,8,11,56,45,11,59
Stranraer,611,5,15,5,16,57,67,-10,50
East Fife,611,6,14,3,19,50,66,-16,45
Airdrieon,611,7,11,11,14,47,59,-12,44
Forfar,611,8,10,5,21,39,66,-27,35
Albion,611,9,8,6,22,58,80,-22,30
Queen's Park,611,10,6,11,19,39,72,-33,29
Ayr,612,1,24,4,8,93,43,50,76
Raith,612,2,22,8,6,69,34,35,74
Alloa,612,3,18,8,10,58,44,14,62
Arbroath,612,4,17,9,10,70,48,22,60
Stranraer,612,5,16,5,15,56,64,-8,53
Airdrieon,612,6,10,12,14,47,60,-13,42
East Fife,612,7,13,3,20,47,65,-18,42
Forfar,612,8,10,6,20,40,66,-26,36
Albion,612,9,8,6,22,58,81,-23,30
Queen's Park,612,10,6,11,19,39,72,-33,29
Raith,613,1,22,8,6,68,36,32,74
Ayr,613,2,23,4,9,91,44,47,73
Alloa,613,3,18,8,10,60,43,17,62
Arbroath,613,4,17,8,11,71,50,21,59
Stranraer,613,5,15,5,16,56,66,-10,50
East Fife,613,6,14,3,19,49,65,-16,45
Airdrieon,613,7,11,11,14,48,59,-11,44
Forfar,613,8,10,5,21,39,67,-28,35
Albion,613,9,9,6,21,59,79,-20,33
Queen's Park,613,10,7,10,19,41,73,-32,31
Raith,614,1,23,8,5,69,32,37,77
Ayr,614,2,24,4,8,93,43,50,76
Arbroath,614,3,18,8,10,71,48,23,62
Alloa,614,4,17,8,11,56,44,12,59
Stranraer,614,5,16,5,15,56,64,-8,53
Airdrieon,614,6,11,11,14,49,59,-10,44
East Fife,614,7,13,3,20,47,65,-18,42
Forfar,614,8,10,5,21,39,68,-29,35
Albion,614,9,8,6,22,58,81,-23,30
Queen's Park,614,10,6,10,20,39,73,-34,28
Raith,615,1,23,8,5,71,33,38,77
Ayr,615,2,24,4,8,94,43,51,76
Arbroath,615,3,18,8,10,73,50,23,62
Alloa,615,4,17,8,11,57,46,11,59
Stranraer,615,5,16,5,15,58,65,-7,53
Airdrieon,615,6,10,12,14,46,59,-13,42
East Fife,615,7,13,3,20,48,67,-19,42
Forfar,615,8,10,6,20,39,65,-26,36
Albion,615,9,8,6,22,58,82,-24,30
Queen's Park,615,10,6,10,20,41,75,-34,28
Ayr,616,1,24,4,8,94,42,52,76
Raith,616,2,22,8,6,68,33,35,74
Alloa,616,3,18,8,10,57,43,14,62
Arbroath,616,4,17,8,11,71,50,21,59
Stranraer,616,5,16,5,15,56,64,-8,53
Airdrieon,616,6,11,11,14,49,61,-12,44
East Fife,616,7,13,3,20,47,65,-18,42
Forfar,616,8,10,5,21,41,68,-27,35
Queen's Park,616,9,7,10,19,41,73,-32,31
Albion,616,10,8,6,22,57,82,-25,30
Raith,617,1,23,8,5,70,32,38,77
Ayr,617,2,23,4,9,90,44,46,73
Arbroath,617,3,17,8,11,71,52,19,59
Alloa,617,4,17,8,11,56,45,11,59
Stranraer,617,5,15,5,16,56,68,-12,50
East Fife,617,6,14,3,19,51,65,-14,45
Airdrieon,617,7,10,12,14,48,61,-13,42
Forfar,617,8,10,6,20,41,67,-26,36
Albion,617,9,9,6,21,59,78,-19,33
Queen's Park,617,10,7,10,19,43,73,-30,31
Ayr,618,1,24,4,8,92,42,50,76
Raith,618,2,22,8,6,70,36,34,74
Alloa,618,3,18,8,10,60,45,15,62
Arbroath,618,4,17,8,11,70,49,21,59
Stranraer,618,5,15,6,15,56,65,-9,51
Airdrieon,618,6,11,11,14,46,58,-12,44
East Fife,618,7,13,4,19,48,65,-17,43
Forfar,618,8,10,5,21,38,65,-27,35
Queen's Park,618,9,7,10,19,40,72,-32,31
Albion,618,10,8,6,22,57,80,-23,30
Ayr,619,1,24,4,8,93,42,51,76
Raith,619,2,22,8,6,69,34,35,74
Arbroath,619,3,18,8,10,72,49,23,62
Alloa,619,4,18,8,10,58,44,14,62
Stranraer,619,5,16,5,15,57,65,-8,53
East Fife,619,6,13,3,20,48,66,-18,42
Airdrieon,619,7,10,11,15,45,60,-15,41
Forfar,619,8,11,5,20,40,64,-24,38
Albion,619,9,8,6,22,57,81,-24,30
Queen's Park,619,10,6,10,20,40,74,-34,28
Raith,620,1,23,8,5,71,32,39,77
Ayr,620,2,24,4,8,91,42,49,76
Arbroath,620,3,17,8,11,71,50,21,59
Alloa,620,4,17,8,11,56,46,10,59
Stranraer,620,5,16,5,15,58,65,-7,53
Airdrieon,620,6,10,12,14,46,59,-13,42
East Fife,620,7,13,3,20,48,67,-19,42
Forfar,620,8,10,6,20,39,65,-26,36
Queen's Park,620,9,7,10,19,41,73,-32,31
Albion,620,10,8,6,22,57,79,-22,30
Ayr,621,1,24,4,8,98,44,54,76
Raith,621,2,22,9,5,70,34,36,75
Alloa,621,3,17,9,10,58,45,13,60
Arbroath,621,4,17,8,11,71,50,21,59
Stranraer,621,5,16,5,15,58,66,-8,53
Airdrieon,621,6,10,12,14,47,60,-13,42
East Fife,621,7,13,3,20,49,67,-18,42
Forfar,621,8,10,6,20,40,66,-26,36
Queen's Park,621,9,7,10,19,41,73,-32,31
Albion,621,10,8,6,22,59,86,-27,30
Raith,622,1,23,8,5,70,32,38,77
Ayr,622,2,24,4,8,93,43,50,76
Arbroath,622,3,17,8,11,70,50,20,59
Alloa,622,4,17,8,11,56,45,11,59
Stranraer,622,5,15,6,15,56,65,-9,51
Airdrieon,622,6,11,11,14,47,59,-12,44
East Fife,622,7,13,4,19,48,65,-17,43
Forfar,622,8,10,5,21,39,66,-27,35
Queen's Park,622,9,7,10,19,41,72,-31,31
Albion,622,10,8,6,22,58,81,-23,30
Ayr,623,1,24,4,8,93,43,50,76
Raith,623,2,22,9,5,68,32,36,75
Arbroath,623,3,18,8,10,73,48,25,62
Alloa,623,4,17,9,10,56,43,13,60
Stranraer,623,5,15,6,15,57,66,-9,51
East Fife,623,6,13,4,19,49,66,-17,43
Airdrieon,623,7,10,11,15,46,61,-15,41
Forfar,623,8,11,5,20,41,65,-24,38
Albion,623,9,8,6,22,58,81,-23,30
Queen's Park,623,10,6,10,20,39,75,-36,28
Ayr,624,1,24,4,8,94,42,52,76
Raith,624,2,22,8,6,68,34,34,74
Arbroath,624,3,18,8,10,75,48,27,62
Alloa,624,4,18,8,10,58,43,15,62
Stranraer,624,5,15,5,16,55,65,-10,50
East Fife,624,6,14,3,19,48,64,-16,45
Airdrieon,624,7,11,11,14,47,58,-11,44
Forfar,624,8,10,5,21,38,66,-28,35
Albion,624,9,8,6,22,57,82,-25,30
Queen's Park,624,10,6,10,20,39,77,-38,28
Raith,625,1,22,9,5,69,33,36,75
Ayr,625,2,23,5,8,91,43,48,74
Alloa,625,3,17,9,10,57,44,13,60
Arbroath,625,4,17,8,11,72,51,21,59
Stranraer,625,5,15,5,16,56,67,-11,50
East Fife,625,6,14,3,19,50,65,-15,45
Airdrieon,625,7,10,11,15,45,60,-15,41
Forfar,625,8,11,5,20,40,64,-24,38
Albion,625,9,8,7,21,58,79,-21,31
Queen's Park,625,10,7,10,19,42,74,-32,31
Ayr,626,1,24,4,8,97,42,55,76
Raith,626,2,22,8,6,68,33,35,74
Arbroath,626,3,18,8,10,74,50,24,62
Alloa,626,4,18,8,10,57,43,14,62
Stranraer,626,5,15,6,15,56,65,-9,51
East Fife,626,6,13,4,19,48,65,-17,43
Airdrieon,626,7,10,11,15,45,59,-14,41
Forfar,626,8,11,5,20,39,64,-25,38
Albion,626,9,8,6,22,57,85,-28,30
Queen's Park,626,10,6,10,20,41,76,-35,28
Ayr,627,1,24,4,8,94,42,52,76
Raith,627,2,22,8,6,69,34,35,74
Arbroath,627,3,18,8,10,71,48,23,62
Alloa,627,4,18,8,10,58,44,14,62
Stranraer,627,5,15,6,15,56,65,-9,51
East Fife,627,6,13,4,19,48,65,-17,43
Airdrieon,627,7,10,12,14,46,59,-13,42
Forfar,627,8,10,6,20,39,65,-26,36
Albion,627,9,8,6,22,57,82,-25,30
Queen's Park,627,10,6,10,20,39,73,-34,28
Ayr,628,1,24,4,8,94,44,50,76
Raith,628,2,22,9,5,69,33,36,75
Alloa,628,3,17,9,10,57,44,13,60
Arbroath,628,4,17,8,11,70,49,21,59
Stranraer,628,5,16,5,15,57,64,-7,53
Airdrieon,628,6,11,11,14,47,58,-11,44
East Fife,628,7,13,3,20,47,66,-19,42
Forfar,628,8,10,5,21,38,66,-28,35
Queen's Park,628,9,7,10,19,40,72,-32,31
Albion,628,10,8,6,22,59,82,-23,30
Raith,629,1,23,8,5,71,32,39,77
Ayr,629,2,24,4,8,92,42,50,76
Arbroath,629,3,17,8,11,73,52,21,59
Alloa,629,4,17,8,11,56,46,10,59
Stranraer,629,5,16,5,15,59,65,-6,53
East Fife,629,6,13,3,20,48,68,-20,42
Airdrieon,629,7,10,11,15,45,60,-15,41
Forfar,629,8,11,5,20,40,64,-24,38
Queen's Park,629,9,7,10,19,43,75,-32,31
Albion,629,10,8,6,22,57,80,-23,30
Raith,630,1,23,8,5,71,32,39,77
Ayr,630,2,24,4,8,95,43,52,76
Arbroath,630,3,18,8,10,72,49,23,62
Alloa,630,4,17,8,11,56,46,10,59
Stranraer,630,5,15,6,15,56,65,-9,51
East Fife,630,6,13,4,19,48,65,-17,43
Airdrieon,630,7,10,12,14,46,59,-13,42
Forfar,630,8,10,6,20,39,65,-26,36
Albion,630,9,8,6,22,58,83,-25,30
Queen's Park,630,10,6,10,20,40,74,-34,28
Ayr,631,1,24,4,8,91,42,49,76
Raith,631,2,22,8,6,68,33,35,74
Arbroath,631,3,18,8,10,75,49,26,62
Alloa,631,4,18,8,10,57,43,14,62
Stranraer,631,5,15,5,16,57,68,-11,50
East Fife,631,6,14,3,19,51,66,-15,45
Airdrieon,631,7,11,11,14,47,59,-12,44
Forfar,631,8,10,5,21,39,66,-27,35
Albion,631,9,8,6,22,57,79,-22,30
Queen's Park,631,10,6,10,20,40,77,-37,28
Ayr,632,1,24,4,8,92,43,49,76
Raith,632,2,22,9,5,70,34,36,75
Arbroath,632,3,18,8,10,74,50,24,62
Alloa,632,4,17,9,10,58,45,13,60
Stranraer,632,5,16,5,15,58,64,-6,53
Airdrieon,632,6,11,11,14,47,59,-12,44
East Fife,632,7,13,3,20,47,67,-20,42
Forfar,632,8,10,5,21,39,66,-27,35
Albion,632,9,8,6,22,58,80,-22,30
Queen's Park,632,10,6,10,20,41,76,-35,28
Raith,633,1,22,9,5,68,32,36,75
Ayr,633,2,23,4,9,92,46,46,73
Arbroath,633,3,17,9,10,71,49,22,60
Alloa,633,4,17,9,10,56,43,13,60
Stranraer,633,5,15,5,16,56,67,-11,50
East Fife,633,6,14,3,19,50,65,-15,45
Airdrieon,633,7,11,11,14,47,58,-11,44
Forfar,633,8,10,5,21,38,66,-28,35
Albion,633,9,9,6,21,61,80,-19,33
Queen's Park,633,10,6,11,19,40,73,-33,29
Raith,634,1,23,8,5,69,32,37,77
Ayr,634,2,23,4,9,90,43,47,73
Arbroath,634,3,18,8,10,71,48,23,62
Alloa,634,4,17,8,11,56,44,12,59
Stranraer,634,5,16,5,15,59,65,-6,53
Airdrieon,634,6,11,11,14,48,58,-10,44
East Fife,634,7,13,3,20,48,68,-20,42
Forfar,634,8,10,5,21,38,67,-29,35
Albion,634,9,9,6,21,58,78,-20,33
Queen's Park,634,10,6,10,20,39,73,-34,28
Raith,635,1,23,8,5,71,34,37,77
Ayr,635,2,24,4,8,96,46,50,76
Arbroath,635,3,17,8,11,72,51,21,59
Alloa,635,4,17,8,11,58,46,12,59
Stranraer,635,5,15,5,16,56,68,-12,50
East Fife,635,6,14,3,19,51,65,-14,45
Airdrieon,635,7,11,11,14,47,59,-12,44
Forfar,635,8,10,5,21,39,66,-27,35
Queen's Park,635,9,7,10,19,42,74,-32,31
Albion,635,10,8,6,22,61,84,-23,30
Ayr,636,1,24,4,8,93,44,49,76
Raith,636,2,22,9,5,69,33,36,75
Alloa,636,3,17,9,10,57,44,13,60
Arbroath,636,4,17,8,11,71,51,20,59
Stranraer,636,5,15,6,15,56,65,-9,51
East Fife,636,6,13,4,19,48,65,-17,43
Airdrieon,636,7,10,11,15,46,60,-14,41
Forfar,636,8,11,5,20,40,65,-25,38
Queen's Park,636,9,7,10,19,42,73,-31,31
Albion,636,10,8,6,22,59,81,-22,30
Ayr,637,1,24,4,8,94,42,52,76
Raith,637,2,22,9,5,70,34,36,75
Arbroath,637,3,18,8,10,72,48,24,62
Alloa,637,4,17,9,10,58,45,13,60
Stranraer,637,5,15,5,16,55,67,-12,50
East Fife,637,6,14,3,19,50,64,-14,45
Airdrieon,637,7,10,12,14,47,60,-13,42
Forfar,637,8,10,6,20,40,66,-26,36
Albion,637,9,8,6,22,57,82,-25,30
Queen's Park,637,10,6,10,20,39,74,-35,28
Ayr,638,1,24,4,8,93,43,50,76
Raith,638,2,22,9,5,68,32,36,75
Arbroath,638,3,18,8,10,74,48,26,62
Alloa,638,4,17,9,10,56,43,13,60
Stranraer,638,5,16,5,15,57,64,-7,53
East Fife,638,6,13,3,20,47,66,-19,42
Airdrieon,638,7,10,11,15,45,59,-14,41
Forfar,638,8,11,5,20,39,64,-25,38
Albion,638,9,8,6,22,58,81,-23,30
Queen's Park,638,10,6,10,20,39,76,-37,28
Ayr,639,1,24,4,8,94,42,52,76
Raith,639,2,22,9,5,69,33,36,75
Arbroath,639,3,17,9,10,71,49,22,60
Alloa,639,4,17,9,10,57,44,13,60
Stranraer,639,5,15,6,15,56,65,-9,51
Airdrieon,639,6,11,11,14,48,59,-11,44
East Fife,639,7,13,4,19,48,65,-17,43
Forfar,639,8,10,5,21,39,67,-28,35
Albion,639,9,8,6,22,57,82,-25,30
Queen's Park,639,10,6,11,19,40,73,-33,29
Ayr,640,1,24,4,8,95,45,50,76
Raith,640,2,22,9,5,68,32,36,75
Arbroath,640,3,17,9,10,71,49,22,60
Alloa,640,4,17,9,10,56,43,13,60
Stranraer,640,5,15,5,16,56,66,-10,50
East Fife,640,6,14,3,19,49,65,-16,45
Airdrieon,640,7,10,12,14,46,59,-13,42
Forfar,640,8,10,6,20,39,65,-26,36
Albion,640,9,8,6,22,60,83,-23,30
Queen's Park,640,10,6,11,19,40,73,-33,29
Ayr,641,1,24,4,8,96,43,53,76
Raith,641,2,22,9,5,70,34,36,75
Alloa,641,3,17,9,10,58,45,13,60
Arbroath,641,4,17,8,11,71,50,21,59
Stranraer,641,5,15,5,16,55,65,-10,50
East Fife,641,6,14,3,19,48,64,-16,45
Airdrieon,641,7,10,11,15,46,60,-14,41
Forfar,641,8,11,5,20,40,65,-25,38
Queen's Park,641,9,7,10,19,41,73,-32,31
Albion,641,10,8,6,22,58,84,-26,30
Raith,642,1,23,8,5,70,32,38,77
Ayr,642,2,24,4,8,93,43,50,76
Arbroath,642,3,17,9,10,71,49,22,60
Alloa,642,4,17,8,11,56,45,11,59
Stranraer,642,5,15,5,16,57,67,-10,50
East Fife,642,6,14,3,19,50,66,-16,45
Airdrieon,642,7,10,11,15,45,60,-15,41
Forfar,642,8,11,5,20,40,64,-24,38
Albion,642,9,8,6,22,58,81,-23,30
Queen's Park,642,10,6,11,19,40,73,-33,29
Raith,643,1,23,8,5,71,33,38,77
Ayr,643,2,24,4,8,97,46,51,76
Arbroath,643,3,17,9,10,71,49,22,60
Alloa,643,4,17,8,11,57,46,11,59
Stranraer,643,5,15,5,16,56,68,-12,50
East Fife,643,6,14,3,19,51,65,-14,45
Airdrieon,643,7,10,12,14,48,61,-13,42
Forfar,643,8,10,6,20,41,67,-26,36
Albion,643,9,8,6,22,61,85,-24,30
Queen's Park,643,10,6,11,19,40,73,-33,29
Ayr,644,1,24,4,8,94,43,51,76
Raith,644,2,22,9,5,69,33,36,75
Arbroath,644,3,18,8,10,71,48,23,62
Alloa,644,4,17,9,10,57,44,13,60
Stranraer,644,5,15,6,15,56,65,-9,51
East Fife,644,6,13,4,19,48,65,-17,43
Airdrieon,644,7,10,11,15,47,61,-14,41
Forfar,644,8,11,5,20,41,66,-25,38
Albion,644,9,8,6,22,58,82,-24,30
Queen's Park,644,10,6,10,20,39,73,-34,28
Raith,645,1,23,8,5,72,33,39,77
Ayr,645,2,24,4,8,93,43,50,76
Arbroath,645,3,17,9,10,72,50,22,60
Alloa,645,4,17,8,11,57,47,10,59
Stranraer,645,5,16,5,15,62,65,-3,53
East Fife,645,6,13,3,20,48,71,-23,42
Airdrieon,645,7,10,11,15,45,59,-14,41
Forfar,645,8,11,5,20,39,64,-25,38
Albion,645,9,8,6,22,58,81,-23,30
Queen's Park,645,10,6,11,19,41,74,-33,29
Ayr,646,1,24,4,8,95,44,51,76
Raith,646,2,22,8,6,68,33,35,74
Alloa,646,3,18,8,10,57,43,14,62
Arbroath,646,4,17,8,11,70,49,21,59
Stranraer,646,5,15,6,15,55,64,-9,51
East Fife,646,6,13,4,19,47,64,-17,43
Airdrieon,646,7,10,11,15,47,61,-14,41
Forfar,646,8,11,5,20,41,66,-25,38
Queen's Park,646,9,7,10,19,40,72,-32,31
Albion,646,10,8,6,22,59,83,-24,30
Ayr,647,1,24,4,8,93,42,51,76
Raith,647,2,22,9,5,68,32,36,75
Arbroath,647,3,18,8,10,72,49,23,62
Alloa,647,4,17,9,10,56,43,13,60
Stranraer,647,5,15,5,16,56,68,-12,50
East Fife,647,6,14,3,19,51,65,-14,45
Airdrieon,647,7,10,11,15,46,60,-14,41
Forfar,647,8,11,5,20,40,65,-25,38
Albion,647,9,8,6,22,57,81,-24,30
Queen's Park,647,10,6,10,20,40,74,-34,28
Raith,648,1,23,8,5,70,33,37,77
Ayr,648,2,24,4,8,94,43,51,76
Arbroath,648,3,17,8,11,71,50,21,59
Alloa,648,4,17,8,11,57,45,12,59
Stranraer,648,5,15,5,16,55,65,-10,50
East Fife,648,6,14,3,19,48,64,-16,45
Airdrieon,648,7,10,11,15,45,59,-14,41
Forfar,648,8,11,5,20,39,64,-25,38
Queen's Park,648,9,7,10,19,41,73,-32,31
Albion,648,10,8,6,22,58,82,-24,30
Raith,649,1,23,8,5,70,32,38,77
Ayr,649,2,24,4,8,92,42,50,76
Arbroath,649,3,18,8,10,73,48,25,62
Alloa,649,4,17,8,11,56,45,11,59
Stranraer,649,5,16,5,15,57,65,-8,53
Airdrieon,649,6,11,11,14,46,58,-12,44
East Fife,649,7,13,3,20,48,66,-18,42
Forfar,649,8,10,5,21,38,65,-27,35
Albion,649,9,8,6,22,57,80,-23,30
Queen's Park,649,10,6,10,20,39,75,-36,28
Raith,650,1,23,8,5,72,35,37,77
Ayr,650,2,24,4,8,95,43,52,76
Arbroath,650,3,18,8,10,72,48,24,62
Alloa,650,4,17,8,11,59,47,12,59
Stranraer,650,5,15,5,16,55,65,-10,50
East Fife,650,6,14,3,19,48,64,-16,45
Airdrieon,650,7,10,11,15,46,60,-14,41
Forfar,650,8,11,5,20,40,65,-25,38
Albion,650,9,8,6,22,58,83,-25,30
Queen's Park,650,10,6,10,20,39,74,-35,28
Ayr,651,1,24,4,8,93,42,51,76
Raith,651,2,22,8,6,69,34,35,74
Arbroath,651,3,18,8,10,72,49,23,62
Alloa,651,4,18,8,10,58,44,14,62
Stranraer,651,5,15,5,16,55,67,-12,50
East Fife,651,6,14,3,19,50,64,-14,45
Airdrieon,651,7,11,11,14,46,58,-12,44
Forfar,651,8,10,5,21,38,65,-27,35
Albion,651,9,8,6,22,57,81,-24,30
Queen's Park,651,10,6,10,20,40,74,-34,28
Raith,652,1,23,8,5,70,32,38,77
Ayr,652,2,24,4,8,93,43,50,76
Arbroath,652,3,17,9,10,72,50,22,60
Alloa,652,4,17,8,11,56,45,11,59
Stranraer,652,5,15,6,15,56,65,-9,51
Airdrieon,652,6,11,11,14,47,59,-12,44
East Fife,652,7,13,4,19,48,65,-17,43
Forfar,652,8,10,5,21,39,66,-27,35
Albion,652,9,8,6,22,58,81,-23,30
Queen's Park,652,10,6,11,19,41,74,-33,29
Ayr,653,1,24,4,8,92,43,49,76
Raith,653,2,22,9,5,70,34,36,75
Arbroath,653,3,18,8,10,72,49,23,62
Alloa,653,4,17,9,10,58,45,13,60
Stranraer,653,5,16,5,15,57,64,-7,53
East Fife,653,6,13,3,20,47,66,-19,42
Airdrieon,653,7,10,11,15,46,60,-14,41
Forfar,653,8,11,5,20,40,65,-25,38
Albion,653,9,8,6,22,58,80,-22,30
Queen's Park,653,10,6,10,20,40,74,-34,28
Raith,654,1,22,9,5,70,34,36,75
Ayr,654,2,23,4,9,90,43,47,73
Arbroath,654,3,17,9,10,72,50,22,60
Alloa,654,4,17,9,10,58,45,13,60
Stranraer,654,5,15,6,15,56,65,-9,51
Airdrieon,654,6,11,11,14,49,58,-9,44
East Fife,654,7,13,4,19,48,65,-17,43
Forfar,654,8,10,5,21,38,68,-30,35
Albion,654,9,9,6,21,58,78,-20,33
Queen's Park,654,10,6,11,19,41,74,-33,29
Ayr,655,1,24,4,8,93,44,49,76
Raith,655,2,22,9,5,69,33,36,75
Alloa,655,3,17,9,10,57,44,13,60
Arbroath,655,4,17,8,11,71,52,19,59
Stranraer,655,5,15,6,15,57,66,-9,51
East Fife,655,6,13,4,19,49,66,-17,43
Airdrieon,655,7,10,12,14,46,59,-13,42
Forfar,655,8,10,6,20,39,65,-26,36
Queen's Park,655,9,7,10,19,43,73,-30,31
Albion,655,10,8,6,22,59,81,-22,30
Ayr,656,1,24,4,8,92,42,50,76
Raith,656,2,22,9,5,69,33,36,75
Alloa,656,3,17,9,10,57,44,13,60
Arbroath,656,4,17,8,11,70,50,20,59
Stranraer,656,5,16,5,15,57,65,-8,53
Airdrieon,656,6,10,12,14,48,61,-13,42
East Fife,656,7,13,3,20,48,66,-18,42
Forfar,656,8,10,6,20,41,67,-26,36
Queen's Park,656,9,7,10,19,41,72,-31,31
Albion,656,10,8,6,22,57,80,-23,30
Ayr,657,1,24,4,8,93,43,50,76
Raith,657,2,22,9,5,69,33,36,75
Arbroath,657,3,18,8,10,71,48,23,62
Alloa,657,4,17,9,10,57,44,13,60
Stranraer,657,5,15,5,16,55,65,-10,50
East Fife,657,6,14,3,19,48,64,-16,45
Airdrieon,657,7,10,12,14,46,59,-13,42
Forfar,657,8,10,6,20,39,65,-26,36
Albion,657,9,8,6,22,58,81,-23,30
Queen's Park,657,10,6,10,20,39,73,-34,28
Ayr,658,1,24,4,8,93,44,49,76
Raith,658,2,22,8,6,68,34,34,74
Arbroath,658,3,18,8,10,73,48,25,62
Alloa,658,4,18,8,10,58,43,15,62
Stranraer,658,5,15,5,16,55,65,-10,50
East Fife,658,6,14,3,19,48,64,-16,45
Airdrieon,658,7,11,11,14,49,58,-9,44
Forfar,658,8,10,5,21,38,68,-30,35
Albion,658,9,8,6,22,59,81,-22,30
Queen's Park,658,10,6,10,20,39,75,-36,28
Ayr,659,1,24,4,8,96,43,53,76
Raith,659,2,22,9,5,68,32,36,75
Arbroath,659,3,17,9,10,72,50,22,60
Alloa,659,4,17,9,10,56,43,13,60
Stranraer,659,5,15,5,16,56,66,-10,50
East Fife,659,6,14,3,19,49,65,-16,45
Airdrieon,659,7,10,12,14,49,62,-13,42
Forfar,659,8,10,6,20,42,68,-26,36
Albion,659,9,8,6,22,58,84,-26,30
Queen's Park,659,10,6,11,19,41,74,-33,29
Raith,660,1,23,8,5,69,32,37,77
Ayr,660,2,24,4,8,94,44,50,76
Arbroath,660,3,17,8,11,71,51,20,59
Alloa,660,4,17,8,11,56,44,12,59
Stranraer,660,5,15,5,16,55,68,-13,50
East Fife,660,6,14,3,19,51,64,-13,45
Airdrieon,660,7,10,12,14,46,59,-13,42
Forfar,660,8,10,6,20,39,65,-26,36
Queen's Park,660,9,7,10,19,42,73,-31,31
Albion,660,10,8,6,22,59,82,-23,30
Ayr,661,1,24,4,8,95,42,53,76
Raith,661,2,22,9,5,71,35,36,75
Alloa,661,3,17,9,10,59,46,13,60
Arbroath,661,4,17,8,11,71,50,21,59
Stranraer,661,5,15,5,16,55,68,-13,50
East Fife,661,6,14,3,19,51,64,-13,45
Airdrieon,661,7,10,12,14,45,58,-13,42
Forfar,661,8,10,6,20,38,64,-26,36
Queen's Park,661,9,7,10,19,41,73,-32,31
Albion,661,10,8,6,22,57,83,-26,30
Raith,662,1,22,8,6,68,33,35,74
Ayr,662,2,23,4,9,92,45,47,73
Alloa,662,3,18,8,10,57,43,14,62
Arbroath,662,4,17,8,11,70,49,21,59
Stranraer,662,5,15,5,16,56,66,-10,50
East Fife,662,6,14,3,19,49,65,-16,45
Airdrieon,662,7,10,12,14,47,60,-13,42
Forfar,662,8,10,6,20,40,66,-26,36
Albion,662,9,9,6,21,60,80,-20,33
Queen's Park,662,10,7,10,19,40,72,-32,31
Raith,663,1,23,8,5,69,32,37,77
Ayr,663,2,23,4,9,91,45,46,73
Arbroath,663,3,17,9,10,71,49,22,60
Alloa,663,4,17,8,11,56,44,12,59
Stranraer,663,5,15,5,16,55,67,-12,50
East Fife,663,6,14,3,19,50,64,-14,45
Airdrieon,663,7,10,11,15,46,60,-14,41
Forfar,663,8,11,5,20,40,65,-25,38
Albion,663,9,9,6,21,60,79,-19,33
Queen's Park,663,10,6,11,19,40,73,-33,29
Ayr,664,1,24,4,8,92,43,49,76
Raith,664,2,22,9,5,69,33,36,75
Arbroath,664,3,18,8,10,72,48,24,62
Alloa,664,4,17,9,10,57,44,13,60
Stranraer,664,5,15,5,16,55,67,-12,50
East Fife,664,6,14,3,19,50,64,-14,45
Airdrieon,664,7,10,11,15,46,61,-15,41
Forfar,664,8,11,5,20,41,65,-24,38
Albion,664,9,8,6,22,58,80,-22,30
Queen's Park,664,10,6,10,20,39,74,-35,28
Raith,665,1,23,8,5,70,32,38,77
Ayr,665,2,24,4,8,95,45,50,76
Arbroath,665,3,17,8,11,70,53,17,59
Alloa,665,4,17,8,11,56,45,11,59
Stranraer,665,5,15,5,16,55,66,-11,50
East Fife,665,6,14,3,19,49,64,-15,45
Airdrieon,665,7,10,11,15,46,60,-14,41
Forfar,665,8,11,5,20,40,65,-25,38
Queen's Park,665,9,7,10,19,44,72,-28,31
Albion,665,10,8,6,22,60,83,-23,30
Raith,666,1,23,8,5,70,33,37,77
Ayr,666,2,23,4,9,92,45,47,73
Arbroath,666,3,18,8,10,71,48,23,62
Alloa,666,4,17,8,11,57,45,12,59
Stranraer,666,5,16,5,15,58,65,-7,53
East Fife,666,6,13,3,20,48,67,-19,42
Airdrieon,666,7,10,11,15,48,62,-14,41
Forfar,666,8,11,5,20,42,67,-25,38
Albion,666,9,9,6,21,60,80,-20,33
Queen's Park,666,10,6,10,20,39,73,-34,28
Raith,667,1,23,8,5,70,33,37,77
Ayr,667,2,23,4,9,92,46,46,73
Arbroath,667,3,17,9,10,70,48,22,60
Alloa,667,4,17,8,11,57,45,12,59
Stranraer,667,5,16,5,15,57,65,-8,53
Airdrieon,667,6,11,11,14,47,59,-12,44
East Fife,667,7,13,3,20,48,66,-18,42
Forfar,667,8,10,5,21,39,66,-27,35
Albion,667,9,9,6,21,61,80,-19,33
Queen's Park,667,10,6,11,19,39,72,-33,29
Raith,668,1,23,8,5,71,32,39,77
Ayr,668,2,24,4,8,92,43,49,76
Arbroath,668,3,18,8,10,73,50,23,62
Alloa,668,4,17,8,11,56,46,10,59
Stranraer,668,5,15,5,16,55,66,-11,50
East Fife,668,6,14,3,19,49,64,-15,45
Airdrieon,668,7,10,12,14,46,59,-13,42
Forfar,668,8,10,6,20,39,65,-26,36
Albion,668,9,8,6,22,58,80,-22,30
Queen's Park,668,10,6,10,20,41,75,-34,28
Raith,669,1,23,8,5,71,33,38,77
Ayr,669,2,23,4,9,92,45,47,73
Arbroath,669,3,18,8,10,73,48,25,62
Alloa,669,4,17,8,11,57,46,11,59
Stranraer,669,5,15,6,15,57,66,-9,51
Airdrieon,669,6,11,11,14,48,59,-11,44
East Fife,669,7,13,4,19,49,66,-17,43
Forfar,669,8,10,5,21,39,67,-28,35
Albion,669,9,9,6,21,60,80,-20,33
Queen's Park,669,10,6,10,20,39,75,-36,28
Ayr,670,1,24,4,8,93,42,51,76
Raith,670,2,22,8,6,69,35,34,74
Alloa,670,3,18,8,10,59,44,15,62
Arbroath,670,4,17,8,11,71,50,21,59
Stranraer,670,5,15,5,16,56,66,-10,50
East Fife,670,6,14,3,19,49,65,-16,45
Airdrieon,670,7,10,11,15,45,59,-14,41
Forfar,670,8,11,5,20,39,64,-25,38
Queen's Park,670,9,7,10,19,41,73,-32,31
Albion,670,10,8,6,22,57,81,-24,30
Ayr,671,1,24,4,8,94,43,51,76
Raith,671,2,22,9,5,70,34,36,75
Alloa,671,3,17,9,10,58,45,13,60
Arbroath,671,4,17,8,11,70,50,20,59
Stranraer,671,5,15,5,16,56,66,-10,50
East Fife,671,6,14,3,19,49,65,-16,45
Airdrieon,671,7,10,11,15,46,60,-14,41
Forfar,671,8,11,5,20,40,65,-25,38
Queen's Park,671,9,7,10,19,41,72,-31,31
Albion,671,10,8,6,22,58,82,-24,30
Ayr,672,1,24,4,8,93,44,49,76
Raith,672,2,22,8,6,69,34,35,74
Arbroath,672,3,18,8,10,72,48,24,62
Alloa,672,4,18,8,10,58,44,14,62
Stranraer,672,5,15,5,16,55,67,-12,50
East Fife,672,6,14,3,19,50,64,-14,45
Airdrieon,672,7,11,11,14,49,61,-12,44
Forfar,672,8,10,5,21,41,68,-27,35
Albion,672,9,8,6,22,59,81,-22,30
Queen's Park,672,10,6,10,20,39,74,-35,28
Ayr,673,1,24,4,8,94,44,50,76
Raith,673,2,22,9,5,68,32,36,75
Arbroath,673,3,18,8,10,72,49,23,62
Alloa,673,4,17,9,10,56,43,13,60
Stranraer,673,5,16,5,15,58,64,-6,53
Airdrieon,673,6,11,11,14,47,58,-11,44
East Fife,673,7,13,3,20,47,67,-20,42
Forfar,673,8,10,5,21,38,66,-28,35
Albion,673,9,8,6,22,59,82,-23,30
Queen's Park,673,10,6,10,20,40,74,-34,28
Ayr,674,1,24,4,8,93,43,50,76
Raith,674,2,22,9,5,68,32,36,75
Arbroath,674,3,18,8,10,73,49,24,62
Alloa,674,4,17,9,10,56,43,13,60
Stranraer,674,5,16,5,15,59,66,-7,53
Airdrieon,674,6,10,12,14,46,59,-13,42
East Fife,674,7,13,3,20,49,68,-19,42
Forfar,674,8,10,6,20,39,65,-26,36
Albion,674,9,8,6,22,58,81,-23,30
Queen's Park,674,10,6,10,20,40,75,-35,28
Ayr,675,1,24,4,8,96,43,53,76
Raith,675,2,22,9,5,69,33,36,75
Arbroath,675,3,18,8,10,72,49,23,62
Alloa,675,4,17,9,10,57,44,13,60
Stranraer,675,5,16,5,15,57,65,-8,53
Airdrieon,675,6,11,11,14,47,58,-11,44
East Fife,675,7,13,3,20,48,66,-18,42
Forfar,675,8,10,5,21,38,66,-28,35
Albion,675,9,8,6,22,58,84,-26,30
Queen's Park,675,10,6,10,20,40,74,-34,28
Raith,676,1,23,8,5,70,32,38,77
Ayr,676,2,24,4,8,96,43,53,76
Arbroath,676,3,17,9,10,72,50,22,60
Alloa,676,4,17,8,11,56,45,11,59
Stranraer,676,5,15,6,15,57,66,-9,51
Airdrieon,676,6,11,11,14,46,58,-12,44
East Fife,676,7,13,4,19,49,66,-17,43
Forfar,676,8,10,5,21,38,65,-27,35
Albion,676,9,8,6,22,58,84,-26,30
Queen's Park,676,10,6,11,19,41,74,-33,29
Raith,677,1,23,8,5,73,32,41,77
Ayr,677,2,24,4,8,96,44,52,76
Arbroath,677,3,18,8,10,73,50,23,62
Alloa,677,4,17,8,11,56,48,8,59
Stranraer,677,5,15,5,16,56,66,-10,50
East Fife,677,6,14,3,19,49,65,-16,45
Airdrieon,677,7,11,11,14,48,58,-10,44
Forfar,677,8,10,5,21,38,67,-29,35
Albion,677,9,8,6,22,59,84,-25,30
Queen's Park,677,10,6,10,20,41,75,-34,28
Raith,678,1,23,8,5,70,33,37,77
Ayr,678,2,24,4,8,94,42,52,76
Arbroath,678,3,17,8,11,71,50,21,59
Alloa,678,4,17,8,11,57,45,12,59
Stranraer,678,5,15,5,16,56,69,-13,50
East Fife,678,6,14,3,19,52,65,-13,45
Airdrieon,678,7,10,12,14,47,60,-13,42
Forfar,678,8,10,6,20,40,66,-26,36
Queen's Park,678,9,7,10,19,41,73,-32,31
Albion,678,10,8,6,22,57,82,-25,30
Ayr,679,1,24,4,8,93,43,50,76
Raith,679,2,22,9,5,69,33,36,75
Arbroath,679,3,18,8,10,71,48,23,62
Alloa,679,4,17,9,10,57,44,13,60
Stranraer,679,5,16,5,15,57,64,-7,53
East Fife,679,6,13,3,20,47,66,-19,42
Airdrieon,679,7,10,11,15,45,60,-15,41
Forfar,679,8,11,5,20,40,64,-24,38
Albion,679,9,8,6,22,58,81,-23,30
Queen's Park,679,10,6,10,20,39,73,-34,28
Raith,680,1,23,8,5,73,33,40,77
Ayr,680,2,23,5,8,91,43,48,74
Arbroath,680,3,17,8,11,73,52,21,59
Alloa,680,4,17,8,11,57,48,9,59
Stranraer,680,5,16,5,15,58,65,-7,53
East Fife,680,6,13,3,20,48,67,-19,42
Airdrieon,680,7,10,11,15,45,60,-15,41
Forfar,680,8,11,5,20,40,64,-24,38
Albion,680,9,8,7,21,58,79,-21,31
Queen's Park,680,10,7,10,19,43,75,-32,31
Ayr,681,1,24,4,8,95,42,53,76
Raith,681,2,22,9,5,69,33,36,75
Arbroath,681,3,18,8,10,72,48,24,62
Alloa,681,4,17,9,10,57,44,13,60
Stranraer,681,5,15,5,16,56,66,-10,50
East Fife,681,6,14,3,19,49,65,-16,45
Airdrieon,681,7,10,12,14,46,59,-13,42
Forfar,681,8,10,6,20,39,65,-26,36
Albion,681,9,8,6,22,57,83,-26,30
Queen's Park,681,10,6,10,20,39,74,-35,28
Ayr,682,1,24,4,8,94,42,52,76
Raith,682,2,22,8,6,68,33,35,74
Alloa,682,3,18,8,10,57,43,14,62
Arbroath,682,4,17,8,11,70,49,21,59
Stranraer,682,5,15,5,16,55,67,-12,50
East Fife,682,6,14,3,19,50,64,-14,45
Airdrieon,682,7,11,11,14,47,58,-11,44
Forfar,682,8,10,5,21,38,66,-28,35
Queen's Park,682,9,7,10,19,40,72,-32,31
Albion,682,10,8,6,22,57,82,-25,30
Raith,683,1,23,8,5,70,33,37,77
Ayr,683,2,24,4,8,94,43,51,76
Arbroath,683,3,17,9,10,71,49,22,60
Alloa,683,4,17,8,11,57,45,12,59
Stranraer,683,5,16,5,15,61,64,-3,53
East Fife,683,6,13,3,20,47,70,-23,42
Airdrieon,683,7,10,11,15,46,60,-14,41
Forfar,683,8,11,5,20,40,65,-25,38
Albion,683,9,8,6,22,58,82,-24,30
Queen's Park,683,10,6,11,19,40,73,-33,29
Ayr,684,1,23,5,8,93,45,48,74
Raith,684,2,22,8,6,68,33,35,74
Arbroath,684,3,18,8,10,73,50,23,62
Alloa,684,4,18,8,10,57,43,14,62
Stranraer,684,5,16,5,15,59,67,-8,53
Airdrieon,684,6,11,11,14,47,59,-12,44
East Fife,684,7,13,3,20,50,68,-18,42
Forfar,684,8,10,5,21,39,66,-27,35
Albion,684,9,8,7,21,60,81,-21,31
Queen's Park,684,10,6,10,20,41,75,-34,28
Ayr,685,1,24,4,8,93,43,50,76
Raith,685,2,22,8,6,69,35,34,74
Arbroath,685,3,18,8,10,72,48,24,62
Alloa,685,4,18,8,10,59,44,15,62
Stranraer,685,5,16,5,15,58,66,-8,53
Airdrieon,685,6,11,11,14,49,59,-10,44
East Fife,685,7,13,3,20,49,67,-18,42
Forfar,685,8,10,5,21,39,68,-29,35
Albion,685,9,8,6,22,58,81,-23,30
Queen's Park,685,10,6,10,20,39,74,-35,28
Raith,686,1,23,8,5,70,33,37,77
Ayr,686,2,24,4,8,93,43,50,76
Arbroath,686,3,17,9,10,71,49,22,60
Alloa,686,4,17,8,11,57,45,12,59
Stranraer,686,5,15,5,16,55,65,-10,50
East Fife,686,6,14,3,19,48,64,-16,45
Airdrieon,686,7,10,11,15,46,61,-15,41
Forfar,686,8,11,5,20,41,65,-24,38
Albion,686,9,8,6,22,58,81,-23,30
Queen's Park,686,10,6,11,19,40,73,-33,29
Raith,687,1,23,8,5,69,32,37,77
Ayr,687,2,23,4,9,90,43,47,73
Arbroath,687,3,18,8,10,72,49,23,62
Alloa,687,4,17,8,11,56,44,12,59
Stranraer,687,5,15,5,16,57,68,-11,50
East Fife,687,6,14,3,19,51,66,-15,45
Airdrieon,687,7,10,11,15,46,60,-14,41
Forfar,687,8,11,5,20,40,65,-25,38
Albion,687,9,9,6,21,58,78,-20,33
Queen's Park,687,10,6,10,20,40,74,-34,28
Raith,688,1,23,8,5,70,33,37,77
Ayr,688,2,23,5,8,91,43,48,74
Arbroath,688,3,17,8,11,70,49,21,59
Alloa,688,4,17,8,11,57,45,12,59
Stranraer,688,5,15,5,16,57,69,-12,50
East Fife,688,6,14,3,19,52,66,-14,45
Airdrieon,688,7,11,11,14,51,58,-7,44
Forfar,688,8,10,5,21,38,70,-32,35
Albion,688,9,8,7,21,58,79,-21,31
Queen's Park,688,10,7,10,19,40,72,-32,31
Ayr,689,1,24,4,8,95,45,50,76
Raith,689,2,22,9,5,70,34,36,75
Arbroath,689,3,18,8,10,74,49,25,62
Alloa,689,4,17,9,10,58,45,13,60
Stranraer,689,5,15,5,16,56,66,-10,50
East Fife,689,6,14,3,19,49,65,-16,45
Airdrieon,689,7,11,11,14,47,59,-12,44
Forfar,689,8,10,5,21,39,66,-27,35
Albion,689,9,8,6,22,60,83,-23,30
Queen's Park,689,10,6,10,20,40,76,-36,28
Ayr,690,1,24,4,8,96,43,53,76
Raith,690,2,22,8,6,69,35,34,74
Arbroath,690,3,18,8,10,73,48,25,62
Alloa,690,4,18,8,10,59,44,15,62
Stranraer,690,5,15,5,16,59,69,-10,50
East Fife,690,6,14,3,19,52,68,-16,45
Airdrieon,690,7,10,11,15,47,62,-15,41
Forfar,690,8,11,5,20,42,66,-24,38
Albion,690,9,8,6,22,58,84,-26,30
Queen's Park,690,10,6,10,20,39,75,-36,28
Ayr,691,1,24,4,8,94,43,51,76
Raith,691,2,22,9,5,70,34,36,75
Alloa,691,3,17,9,10,58,45,13,60
Arbroath,691,4,17,8,11,72,52,20,59
Stranraer,691,5,16,5,15,57,65,-8,53
Airdrieon,691,6,11,11,14,47,59,-12,44
East Fife,691,7,13,3,20,48,66,-18,42
Forfar,691,8,10,5,21,39,66,-27,35
Queen's Park,691,9,7,10,19,43,74,-31,31
Albion,691,10,8,6,22,58,82,-24,30
Raith,692,1,22,9,5,70,34,36,75
Ayr,692,2,23,4,9,92,45,47,73
Arbroath,692,3,17,9,10,70,48,22,60
Alloa,692,4,17,9,10,58,45,13,60
Stranraer,692,5,15,5,16,55,68,-13,50
East Fife,692,6,14,3,19,51,64,-13,45
Airdrieon,692,7,11,11,14,47,59,-12,44
Forfar,692,8,10,5,21,39,66,-27,35
Albion,692,9,9,6,21,60,80,-20,33
Queen's Park,692,10,6,11,19,39,72,-33,29
Raith,693,1,23,8,5,69,32,37,77
Ayr,693,2,24,4,8,92,43,49,76
Arbroath,693,3,18,8,10,71,48,23,62
Alloa,693,4,17,8,11,56,44,12,59
Stranraer,693,5,16,5,15,56,64,-8,53
Airdrieon,693,6,11,11,14,46,58,-12,44
East Fife,693,7,13,3,20,47,65,-18,42
Forfar,693,8,10,5,21,38,65,-27,35
Albion,693,9,8,6,22,58,80,-22,30
Queen's Park,693,10,6,10,20,39,73,-34,28
Raith,694,1,23,8,5,71,33,38,77
Ayr,694,2,24,4,8,91,42,49,76
Arbroath,694,3,17,8,11,71,50,21,59
Alloa,694,4,17,8,11,57,46,11,59
Stranraer,694,5,15,5,16,57,67,-10,50
East Fife,694,6,14,3,19,50,66,-16,45
Airdrieon,694,7,11,11,14,47,58,-11,44
Forfar,694,8,10,5,21,38,66,-28,35
Queen's Park,694,9,7,10,19,41,73,-32,31
Albion,694,10,8,6,22,57,79,-22,30
Raith,695,1,23,8,5,70,33,37,77
Ayr,695,2,24,4,8,95,43,52,76
Arbroath,695,3,17,9,10,72,50,22,60
Alloa,695,4,17,8,11,57,45,12,59
Stranraer,695,5,15,5,16,55,66,-11,50
East Fife,695,6,14,3,19,49,64,-15,45
Airdrieon,695,7,11,11,14,47,58,-11,44
Forfar,695,8,10,5,21,38,66,-28,35
Albion,695,9,8,6,22,58,83,-25,30
Queen's Park,695,10,6,11,19,41,74,-33,29
Ayr,696,1,24,4,8,92,43,49,76
Raith,696,2,22,9,5,69,33,36,75
Alloa,696,3,17,9,10,57,44,13,60
Arbroath,696,4,17,8,11,71,50,21,59
Stranraer,696,5,16,5,15,58,66,-8,53
Airdrieon,696,6,11,11,14,48,60,-12,44
East Fife,696,7,13,3,20,49,67,-18,42
Forfar,696,8,10,5,21,40,67,-27,35
Queen's Park,696,9,7,10,19,41,73,-32,31
Albion,696,10,8,6,22,58,80,-22,30
Raith,697,1,22,8,6,68,33,35,74
Ayr,697,2,23,4,9,92,46,46,73
Alloa,697,3,18,8,10,57,43,14,62
Arbroath,697,4,17,9,10,72,50,22,60
Stranraer,697,5,15,6,15,57,66,-9,51
Airdrieon,697,6,11,11,14,49,58,-9,44
East Fife,697,7,13,4,19,49,66,-17,43
Forfar,697,8,10,5,21,38,68,-30,35
Albion,697,9,9,6,21,61,80,-19,33
Queen's Park,697,10,6,11,19,41,74,-33,29
Ayr,698,1,24,4,8,98,42,56,76
Raith,698,2,22,9,5,69,33,36,75
Arbroath,698,3,18,8,10,75,49,26,62
Alloa,698,4,17,9,10,57,44,13,60
Stranraer,698,5,15,5,16,55,66,-11,50
East Fife,698,6,14,3,19,49,64,-15,45
Airdrieon,698,7,11,11,14,50,58,-8,44
Forfar,698,8,10,5,21,38,69,-31,35
Albion,698,9,8,6,22,57,86,-29,30
Queen's Park,698,10,6,10,20,40,77,-37,28
Raith,699,1,23,8,5,69,32,37,77
Ayr,699,2,23,4,9,92,45,47,73
Arbroath,699,3,17,9,10,72,50,22,60
Alloa,699,4,17,8,11,56,44,12,59
Stranraer,699,5,16,5,15,57,64,-7,53
Airdrieon,699,6,11,11,14,48,60,-12,44
East Fife,699,7,13,3,20,47,66,-19,42
Forfar,699,8,10,5,21,40,67,-27,35
Albion,699,9,9,6,21,60,80,-20,33
Queen's Park,699,10,6,11,19,41,74,-33,29
Raith,700,1,23,8,5,70,33,37,77
Ayr,700,2,24,4,8,93,43,50,76
Arbroath,700,3,17,9,10,71,49,22,60
Alloa,700,4,17,8,11,57,45,12,59
Stranraer,700,5,15,5,16,55,65,-10,50
East Fife,700,6,14,3,19,48,64,-16,45
Airdrieon,700,7,11,11,14,50,59,-9,44
Forfar,700,8,10,5,21,39,69,-30,35
Albion,700,9,8,6,22,58,81,-23,30
Queen's Park,700,10,6,11,19,40,73,-33,29
Ayr,701,1,24,4,8,94,42,52,76
Raith,701,2,22,9,5,69,33,36,75
Arbroath,701,3,18,8,10,71,48,23,62
Alloa,701,4,17,9,10,57,44,13,60
Stranraer,701,5,15,5,16,55,67,-12,50
East Fife,701,6,14,3,19,50,64,-14,45
Airdrieon,701,7,11,11,14,48,58,-10,44
Forfar,701,8,10,5,21,38,67,-29,35
Albion,701,9,8,6,22,57,82,-25,30
Queen's Park,701,10,6,10,20,39,73,-34,28
Raith,702,1,23,8,5,69,32,37,77
Ayr,702,2,24,4,8,92,42,50,76
Arbroath,702,3,18,8,10,75,50,25,62
Alloa,702,4,17,8,11,56,44,12,59
Stranraer,702,5,15,5,16,56,67,-11,50
East Fife,702,6,14,3,19,50,65,-15,45
Airdrieon,702,7,10,11,15,45,60,-15,41
Forfar,702,8,11,5,20,40,64,-24,38
Albion,702,9,8,6,22,57,80,-23,30
Queen's Park,702,10,6,10,20,41,77,-36,28
Ayr,703,1,24,4,8,94,43,51,76
Raith,703,2,22,8,6,69,34,35,74
Arbroath,703,3,18,8,10,73,49,24,62
Alloa,703,4,18,8,10,58,44,14,62
Stranraer,703,5,15,5,16,56,66,-10,50
East Fife,703,6,14,3,19,49,65,-16,45
Airdrieon,703,7,11,11,14,48,59,-11,44
Forfar,703,8,10,5,21,39,67,-28,35
Albion,703,9,8,6,22,58,82,-24,30
Queen's Park,703,10,6,10,20,40,75,-35,28
Ayr,704,1,24,4,8,94,43,51,76
Raith,704,2,22,9,5,69,33,36,75
Arbroath,704,3,18,8,10,74,50,24,62
Alloa,704,4,17,9,10,57,44,13,60
Stranraer,704,5,15,5,16,56,66,-10,50
East Fife,704,6,14,3,19,49,65,-16,45
Airdrieon,704,7,11,11,14,47,59,-12,44
Forfar,704,8,10,5,21,39,66,-27,35
Albion,704,9,8,6,22,58,82,-24,30
Queen's Park,704,10,6,10,20,41,76,-35,28
Raith,705,1,23,8,5,69,32,37,77
Ayr,705,2,24,4,8,93,43,50,76
Arbroath,705,3,18,8,10,72,49,23,62
Alloa,705,4,17,8,11,56,44,12,59
Stranraer,705,5,16,5,15,56,64,-8,53
East Fife,705,6,13,3,20,47,65,-18,42
Airdrieon,705,7,10,11,15,46,60,-14,41
Forfar,705,8,11,5,20,40,65,-25,38
Albion,705,9,8,6,22,58,81,-23,30
Queen's Park,705,10,6,10,20,40,74,-34,28
Raith,706,1,23,8,5,71,33,38,77
Ayr,706,2,24,4,8,95,43,52,76
Arbroath,706,3,17,9,10,71,49,22,60
Alloa,706,4,17,8,11,57,46,11,59
Stranraer,706,5,15,5,16,55,69,-14,50
East Fife,706,6,14,3,19,52,64,-12,45
Airdrieon,706,7,11,11,14,46,58,-12,44
Forfar,706,8,10,5,21,38,65,-27,35
Albion,706,9,8,6,22,58,83,-25,30
Queen's Park,706,10,6,11,19,40,73,-33,29
Raith,707,1,23,8,5,72,32,40,77
Ayr,707,2,24,4,8,96,43,53,76
Arbroath,707,3,18,8,10,71,48,23,62
Alloa,707,4,17,8,11,56,47,9,59
Stranraer,707,5,15,5,16,57,70,-13,50
East Fife,707,6,14,3,19,53,66,-13,45
Airdrieon,707,7,11,11,14,50,59,-9,44
Forfar,707,8,10,5,21,39,69,-30,35
Albion,707,9,8,6,22,58,84,-26,30
Queen's Park,707,10,6,10,20,39,73,-34,28
Ayr,708,1,24,4,8,97,42,55,76
Raith,708,2,22,8,6,69,34,35,74
Arbroath,708,3,18,8,10,71,48,23,62
Alloa,708,4,18,8,10,58,44,14,62
Stranraer,708,5,16,5,15,57,64,-7,53
Airdrieon,708,6,10,12,14,46,59,-13,42
East Fife,708,7,13,3,20,47,66,-19,42
Forfar,708,8,10,6,20,39,65,-26,36
Albion,708,9,8,6,22,57,85,-28,30
Queen's Park,708,10,6,10,20,39,73,-34,28
Ayr,709,1,24,4,8,92,43,49,76
Raith,709,2,22,9,5,69,33,36,75
Arbroath,709,3,17,9,10,73,51,22,60
Alloa,709,4,17,9,10,57,44,13,60
Stranraer,709,5,15,6,15,56,65,-9,51
Airdrieon,709,6,11,11,14,47,59,-12,44
East Fife,709,7,13,4,19,48,65,-17,43
Forfar,709,8,10,5,21,39,66,-27,35
Albion,709,9,8,6,22,58,80,-22,30
Queen's Park,709,10,6,11,19,42,75,-33,29
Raith,710,1,23,8,5,70,33,37,77
Ayr,710,2,24,4,8,96,43,53,76
Arbroath,710,3,17,9,10,71,49,22,60
Alloa,710,4,17,8,11,57,45,12,59
Stranraer,710,5,15,5,16,56,67,-11,50
East Fife,710,6,14,3,19,50,65,-15,45
Airdrieon,710,7,10,12,14,47,60,-13,42
Forfar,710,8,10,6,20,40,66,-26,36
Albion,710,9,8,6,22,58,84,-26,30
Queen's Park,710,10,6,11,19,40,73,-33,29
Ayr,711,1,24,4,8,96,44,52,76
Raith,711,2,22,9,5,70,34,36,75
Arbroath,711,3,17,9,10,71,49,22,60
Alloa,711,4,17,9,10,58,45,13,60
Stranraer,711,5,16,5,15,58,65,-7,53
East Fife,711,6,13,3,20,48,67,-19,42
Airdrieon,711,7,10,11,15,45,61,-16,41
Forfar,711,8,11,5,20,41,64,-23,38
Albion,711,9,8,6,22,59,84,-25,30
Queen's Park,711,10,6,11,19,40,73,-33,29
Ayr,712,1,24,4,8,95,44,51,76
Raith,712,2,22,9,5,70,34,36,75
Alloa,712,3,17,9,10,58,45,13,60
Arbroath,712,4,17,8,11,70,51,19,59
Stranraer,712,5,15,5,16,57,67,-10,50
East Fife,712,6,14,3,19,50,66,-16,45
Airdrieon,712,7,11,11,14,49,59,-10,44
Forfar,712,8,10,5,21,39,68,-29,35
Queen's Park,712,9,7,10,19,42,72,-30,31
Albion,712,10,8,6,22,59,83,-24,30
Raith,713,1,22,9,5,69,33,36,75
Ayr,713,2,23,4,9,93,46,47,73
Arbroath,713,3,18,8,10,72,48,24,62
Alloa,713,4,17,9,10,57,44,13,60
Stranraer,713,5,15,5,16,55,66,-11,50
East Fife,713,6,14,3,19,49,64,-15,45
Airdrieon,713,7,10,12,14,45,58,-13,42
Forfar,713,8,10,6,20,38,64,-26,36
Albion,713,9,9,6,21,61,81,-20,33
Queen's Park,713,10,6,10,20,39,74,-35,28
Ayr,714,1,24,4,8,93,42,51,76
Raith,714,2,22,9,5,69,33,36,75
Arbroath,714,3,17,9,10,71,49,22,60
Alloa,714,4,17,9,10,57,44,13,60
Stranraer,714,5,15,5,16,56,66,-10,50
East Fife,714,6,14,3,19,49,65,-16,45
Airdrieon,714,7,10,12,14,46,59,-13,42
Forfar,714,8,10,6,20,39,65,-26,36
Albion,714,9,8,6,22,57,81,-24,30
Queen's Park,714,10,6,11,19,40,73,-33,29
Ayr,715,1,24,4,8,95,42,53,76
Raith,715,2,22,9,5,68,32,36,75
Arbroath,715,3,18,8,10,73,49,24,62
Alloa,715,4,17,9,10,56,43,13,60
Stranraer,715,5,15,5,16,55,67,-12,50
East Fife,715,6,14,3,19,50,64,-14,45
Airdrieon,715,7,10,11,15,45,60,-15,41
Forfar,715,8,11,5,20,40,64,-24,38
Albion,715,9,8,6,22,57,83,-26,30
Queen's Park,715,10,6,10,20,40,75,-35,28
Ayr,716,1,24,4,8,92,43,49,76
Raith,716,2,22,9,5,69,33,36,75
Arbroath,716,3,17,9,10,72,50,22,60
Alloa,716,4,17,9,10,57,44,13,60
Stranraer,716,5,16,5,15,57,65,-8,53
East Fife,716,6,13,3,20,48,66,-18,42
Airdrieon,716,7,10,11,15,46,60,-14,41
Forfar,716,8,11,5,20,40,65,-25,38
Albion,716,9,8,6,22,58,80,-22,30
Queen's Park,716,10,6,11,19,41,74,-33,29
Raith,717,1,23,8,5,71,33,38,77
Ayr,717,2,23,4,9,90,43,47,73
Arbroath,717,3,17,9,10,71,49,22,60
Alloa,717,4,17,8,11,57,46,11,59
Stranraer,717,5,16,5,15,56,64,-8,53
Airdrieon,717,6,11,11,14,47,59,-12,44
East Fife,717,7,13,3,20,47,65,-18,42
Forfar,717,8,10,5,21,39,66,-27,35
Albion,717,9,9,6,21,58,78,-20,33
Queen's Park,717,10,6,11,19,40,73,-33,29
Raith,718,1,23,8,5,69,32,37,77
Ayr,718,2,24,4,8,93,43,50,76
Arbroath,718,3,17,8,11,71,50,21,59
Alloa,718,4,17,8,11,56,44,12,59
Stranraer,718,5,15,5,16,56,69,-13,50
East Fife,718,6,14,3,19,52,65,-13,45
Airdrieon,718,7,10,11,15,46,60,-14,41
Forfar,718,8,11,5,20,40,65,-25,38
Queen's Park,718,9,7,10,19,41,73,-32,31
Albion,718,10,8,6,22,58,81,-23,30
Raith,719,1,23,8,5,69,32,37,77
Ayr,719,2,24,4,8,94,43,51,76
Arbroath,719,3,18,8,10,75,49,26,62
Alloa,719,4,17,8,11,56,44,12,59
Stranraer,719,5,15,5,16,56,70,-14,50
East Fife,719,6,14,3,19,53,65,-12,45
Airdrieon,719,7,10,11,15,45,59,-14,41
Forfar,719,8,11,5,20,39,64,-25,38
Albion,719,9,8,6,22,58,82,-24,30
Queen's Park,719,10,6,10,20,40,77,-37,28
Ayr,720,1,24,4,8,96,44,52,76
Raith,720,2,22,8,6,69,34,35,74
Alloa,720,3,18,8,10,58,44,14,62
Arbroath,720,4,17,8,11,73,52,21,59
Stranraer,720,5,15,5,16,56,67,-11,50
East Fife,720,6,14,3,19,50,65,-15,45
Airdrieon,720,7,11,11,14,46,58,-12,44
Forfar,720,8,10,5,21,38,65,-27,35
Queen's Park,720,9,7,10,19,43,75,-32,31
Albion,720,10,8,6,22,59,84,-25,30
Raith,721,1,23,8,5,71,32,39,77
Ayr,721,2,23,4,9,91,44,47,73
Arbroath,721,3,18,8,10,74,50,24,62
Alloa,721,4,17,8,11,56,46,10,59
Stranraer,721,5,15,6,15,55,64,-9,51
East Fife,721,6,13,4,19,47,64,-17,43
Airdrieon,721,7,10,11,15,46,63,-17,41
Forfar,721,8,11,5,20,43,65,-22,38
Albion,721,9,9,6,21,59,79,-20,33
Queen's Park,721,10,6,10,20,41,76,-35,28
Ayr,722,1,23,5,8,91,43,48,74
Raith,722,2,22,8,6,68,34,34,74
Alloa,722,3,18,8,10,58,43,15,62
Arbroath,722,4,17,9,10,74,52,22,60
Stranraer,722,5,16,5,15,60,65,-5,53
Airdrieon,722,6,10,12,14,46,59,-13,42
East Fife,722,7,13,3,20,48,69,-21,42
Forfar,722,8,10,6,20,39,65,-26,36
Albion,722,9,8,7,21,58,79,-21,31
Queen's Park,722,10,6,11,19,43,76,-33,29
Raith,723,1,23,8,5,71,33,38,77
Ayr,723,2,24,4,8,93,43,50,76
Arbroath,723,3,18,8,10,73,49,24,62
Alloa,723,4,17,8,11,57,46,11,59
Stranraer,723,5,16,5,15,58,66,-8,53
Airdrieon,723,6,10,12,14,46,59,-13,42
East Fife,723,7,13,3,20,49,67,-18,42
Forfar,723,8,10,6,20,39,65,-26,36
Albion,723,9,8,6,22,58,81,-23,30
Queen's Park,723,10,6,10,20,40,75,-35,28
Raith,724,1,22,9,5,68,32,36,75
Ayr,724,2,23,4,9,91,44,47,73
Arbroath,724,3,18,8,10,71,48,23,62
Alloa,724,4,17,9,10,56,43,13,60
Stranraer,724,5,15,5,16,55,65,-10,50
East Fife,724,6,14,3,19,48,64,-16,45
Airdrieon,724,7,10,11,15,45,59,-14,41
Forfar,724,8,11,5,20,39,64,-25,38
Albion,724,9,9,6,21,59,79,-20,33
Queen's Park,724,10,6,10,20,39,73,-34,28
Raith,725,1,23,8,5,70,32,38,77
Ayr,725,2,24,4,8,95,42,53,76
Arbroath,725,3,17,8,11,72,51,21,59
Alloa,725,4,17,8,11,56,45,11,59
Stranraer,725,5,15,5,16,55,65,-10,50
East Fife,725,6,14,3,19,48,64,-16,45
Airdrieon,725,7,11,11,14,47,58,-11,44
Forfar,725,8,10,5,21,38,66,-28,35
Queen's Park,725,9,7,10,19,42,74,-32,31
Albion,725,10,8,6,22,57,83,-26,30
Raith,726,1,23,8,5,72,33,39,77
Ayr,726,2,24,4,8,93,43,50,76
Arbroath,726,3,17,8,11,72,51,21,59
Alloa,726,4,17,8,11,57,47,10,59
Stranraer,726,5,15,5,16,57,67,-10,50
East Fife,726,6,14,3,19,50,66,-16,45
Airdrieon,726,7,11,11,14,47,59,-12,44
Forfar,726,8,10,5,21,39,66,-27,35
Queen's Park,726,9,7,10,19,42,74,-32,31
Albion,726,10,8,6,22,58,81,-23,30
Ayr,727,1,23,5,8,91,43,48,74
Raith,727,2,22,8,6,68,34,34,74
Arbroath,727,3,18,8,10,75,48,27,62
Alloa,727,4,18,8,10,58,43,15,62
Stranraer,727,5,15,5,16,56,66,-10,50
East Fife,727,6,14,3,19,49,65,-16,45
Airdrieon,727,7,10,12,14,46,59,-13,42
Forfar,727,8,10,6,20,39,65,-26,36
Albion,727,9,8,7,21,58,79,-21,31
Queen's Park,727,10,6,10,20,39,77,-38,28
Raith,728,1,23,8,5,70,32,38,77
Ayr,728,2,24,4,8,93,43,50,76
Arbroath,728,3,18,8,10,72,49,23,62
Alloa,728,4,17,8,11,56,45,11,59
Stranraer,728,5,16,5,15,56,64,-8,53
Airdrieon,728,6,10,12,14,45,58,-13,42
East Fife,728,7,13,3,20,47,65,-18,42
Forfar,728,8,10,6,20,38,64,-26,36
Albion,728,9,8,6,22,58,81,-23,30
Queen's Park,728,10,6,10,20,40,74,-34,28
Ayr,729,1,24,4,8,93,44,49,76
Raith,729,2,22,9,5,72,36,36,75
Arbroath,729,3,18,8,10,71,48,23,62
Alloa,729,4,17,9,10,60,47,13,60
Stranraer,729,5,16,5,15,58,66,-8,53
Airdrieon,729,6,11,11,14,46,58,-12,44
East Fife,729,7,13,3,20,49,67,-18,42
Forfar,729,8,10,5,21,38,65,-27,35
Albion,729,9,8,6,22,59,81,-22,30
Queen's Park,729,10,6,10,20,39,73,-34,28
Raith,730,1,23,8,5,70,32,38,77
Ayr,730,2,23,5,8,92,44,48,74
Arbroath,730,3,17,9,10,70,48,22,60
Alloa,730,4,17,8,11,56,45,11,59
Stranraer,730,5,16,5,15,59,66,-7,53
East Fife,730,6,13,3,20,49,68,-19,42
Airdrieon,730,7,10,11,15,46,61,-15,41
Forfar,730,8,11,5,20,41,65,-24,38
Albion,730,9,8,7,21,59,80,-21,31
Queen's Park,730,10,6,11,19,39,72,-33,29
Raith,731,1,23,8,5,73,32,41,77
Ayr,731,2,24,4,8,92,43,49,76
Arbroath,731,3,18,8,10,73,49,24,62
Alloa,731,4,17,8,11,56,48,8,59
Stranraer,731,5,16,5,15,58,64,-6,53
Airdrieon,731,6,11,11,14,49,58,-9,44
East Fife,731,7,13,3,20,47,67,-20,42
Forfar,731,8,10,5,21,38,68,-30,35
Albion,731,9,8,6,22,58,80,-22,30
Queen's Park,731,10,6,10,20,40,75,-35,28
Raith,732,1,23,8,5,71,34,37,77
Ayr,732,2,24,4,8,93,42,51,76
Arbroath,732,3,17,9,10,71,49,22,60
Alloa,732,4,17,8,11,58,46,12,59
Stranraer,732,5,15,5,16,57,67,-10,50
East Fife,732,6,14,3,19,50,66,-16,45
Airdrieon,732,7,10,12,14,47,60,-13,42
Forfar,732,8,10,6,20,40,66,-26,36
Albion,732,9,8,6,22,57,81,-24,30
Queen's Park,732,10,6,11,19,40,73,-33,29
Ayr,733,1,24,4,8,96,44,52,76
Raith,733,2,22,9,5,69,33,36,75
Arbroath,733,3,18,8,10,73,49,24,62
Alloa,733,4,17,9,10,57,44,13,60
Stranraer,733,5,16,5,15,58,66,-8,53
Airdrieon,733,6,10,12,14,47,60,-13,42
East Fife,733,7,13,3,20,49,67,-18,42
Forfar,733,8,10,6,20,40,66,-26,36
Albion,733,9,8,6,22,59,84,-25,30
Queen's Park,733,10,6,10,20,40,75,-35,28
Raith,734,1,23,8,5,70,33,37,77
Ayr,734,2,24,4,8,95,42,53,76
Arbroath,734,3,17,9,10,71,49,22,60
Alloa,734,4,17,8,11,57,45,12,59
Stranraer,734,5,16,5,15,59,67,-8,53
Airdrieon,734,6,10,12,14,46,59,-13,42
East Fife,734,7,13,3,20,50,68,-18,42
Forfar,734,8,10,6,20,39,65,-26,36
Albion,734,9,8,6,22,57,83,-26,30
Queen's Park,734,10,6,11,19,40,73,-33,29
Raith,735,1,23,8,5,71,33,38,77
Ayr,735,2,24,4,8,96,44,52,76
Arbroath,735,3,17,8,11,70,49,21,59
Alloa,735,4,17,8,11,57,46,11,59
Stranraer,735,5,15,5,16,56,67,-11,50
East Fife,735,6,14,3,19,50,65,-15,45
Airdrieon,735,7,11,11,14,48,59,-11,44
Forfar,735,8,10,5,21,39,67,-28,35
Queen's Park,735,9,7,10,19,40,72,-32,31
Albion,735,10,8,6,22,59,84,-25,30
Raith,736,1,23,8,5,72,34,38,77
Ayr,736,2,23,4,9,93,46,47,73
Arbroath,736,3,17,8,11,70,49,21,59
Alloa,736,4,17,8,11,58,47,11,59
Stranraer,736,5,15,5,16,55,67,-12,50
East Fife,736,6,14,3,19,50,64,-14,45
Airdrieon,736,7,10,11,15,46,60,-14,41
Forfar,736,8,11,5,20,40,65,-25,38
Albion,736,9,9,6,21,61,81,-20,33
Queen's Park,736,10,7,10,19,40,72,-32,31
Ayr,737,1,24,4,8,93,42,51,76
Raith,737,2,22,8,6,68,33,35,74
Arbroath,737,3,18,8,10,74,51,23,62
Alloa,737,4,18,8,10,57,43,14,62
Stranraer,737,5,16,5,15,56,64,-8,53
Airdrieon,737,6,11,11,14,47,59,-12,44
East Fife,737,7,13,3,20,47,65,-18,42
Forfar,737,8,10,5,21,39,66,-27,35
Albion,737,9,8,6,22,57,81,-24,30
Queen's Park,737,10,6,10,20,42,76,-34,28
Ayr,738,1,24,4,8,92,43,49,76
Raith,738,2,22,8,6,68,34,34,74
Alloa,738,3,18,8,10,58,43,15,62
Arbroath,738,4,17,9,10,73,51,22,60
Stranraer,738,5,15,5,16,55,65,-10,50
East Fife,738,6,14,3,19,48,64,-16,45
Airdrieon,738,7,10,11,15,45,59,-14,41
Forfar,738,8,11,5,20,39,64,-25,38
Albion,738,9,8,6,22,58,80,-22,30
Queen's Park,738,10,6,11,19,42,75,-33,29
Raith,739,1,22,8,6,69,34,35,74
Ayr,739,2,23,4,9,90,44,46,73
Arbroath,739,3,18,8,10,72,48,24,62
Alloa,739,4,18,8,10,58,44,14,62
Stranraer,739,5,16,5,15,56,64,-8,53
Airdrieon,739,6,10,12,14,45,58,-13,42
East Fife,739,7,13,3,20,47,65,-18,42
Forfar,739,8,10,6,20,38,64,-26,36
Albion,739,9,9,6,21,59,78,-19,33
Queen's Park,739,10,6,10,20,39,74,-35,28
Raith,740,1,23,8,5,69,32,37,77
Ayr,740,2,24,4,8,96,42,54,76
Arbroath,740,3,17,9,10,73,51,22,60
Alloa,740,4,17,8,11,56,44,12,59
Stranraer,740,5,16,5,15,58,65,-7,53
East Fife,740,6,13,3,20,48,67,-19,42
Airdrieon,740,7,10,11,15,46,60,-14,41
Forfar,740,8,11,5,20,40,65,-25,38
Albion,740,9,8,6,22,57,84,-27,30
Queen's Park,740,10,6,11,19,42,75,-33,29
Raith,741,1,22,9,5,70,34,36,75
Ayr,741,2,23,5,8,92,44,48,74
Arbroath,741,3,17,9,10,72,50,22,60
Alloa,741,4,17,9,10,58,45,13,60
Stranraer,741,5,15,5,16,57,68,-11,50
East Fife,741,6,14,3,19,51,66,-15,45
Airdrieon,741,7,10,12,14,45,58,-13,42
Forfar,741,8,10,6,20,38,64,-26,36
Albion,741,9,8,7,21,59,80,-21,31
Queen's Park,741,10,6,11,19,41,74,-33,29
Raith,742,1,23,8,5,70,33,37,77
Ayr,742,2,24,4,8,93,43,50,76
Arbroath,742,3,17,8,11,71,50,21,59
Alloa,742,4,17,8,11,57,45,12,59
Stranraer,742,5,15,5,16,55,67,-12,50
East Fife,742,6,14,3,19,50,64,-14,45
Airdrieon,742,7,11,11,14,47,58,-11,44
Forfar,742,8,10,5,21,38,66,-28,35
Queen's Park,742,9,7,10,19,41,73,-32,31
Albion,742,10,8,6,22,58,81,-23,30
Raith,743,1,23,8,5,71,34,37,77
Ayr,743,2,24,4,8,93,42,51,76
Arbroath,743,3,17,8,11,72,51,21,59
Alloa,743,4,17,8,11,58,46,12,59
Stranraer,743,5,15,6,15,56,65,-9,51
Airdrieon,743,6,11,11,14,48,58,-10,44
East Fife,743,7,13,4,19,48,65,-17,43
Forfar,743,8,10,5,21,38,67,-29,35
Queen's Park,743,9,7,10,19,42,74,-32,31
Albion,743,10,8,6,22,57,81,-24,30
Ayr,744,1,24,4,8,94,44,50,76
Raith,744,2,22,9,5,68,32,36,75
Arbroath,744,3,18,8,10,72,48,24,62
Alloa,744,4,17,9,10,56,43,13,60
Stranraer,744,5,15,5,16,57,68,-11,50
East Fife,744,6,14,3,19,51,66,-15,45
Airdrieon,744,7,10,12,14,45,58,-13,42
Forfar,744,8,10,6,20,38,64,-26,36
Albion,744,9,8,6,22,59,82,-23,30
Queen's Park,744,10,6,10,20,39,74,-35,28
Raith,745,1,23,8,5,69,32,37,77
Ayr,745,2,24,4,8,93,42,51,76
Arbroath,745,3,17,8,11,71,51,20,59
Alloa,745,4,17,8,11,56,44,12,59
Stranraer,745,5,15,5,16,55,66,-11,50
East Fife,745,6,14,3,19,49,64,-15,45
Airdrieon,745,7,11,11,14,47,59,-12,44
Forfar,745,8,10,5,21,39,66,-27,35
Queen's Park,745,9,7,10,19,42,73,-31,31
Albion,745,10,8,6,22,57,81,-24,30
Raith,746,1,23,8,5,70,32,38,77
Ayr,746,2,23,4,9,90,43,47,73
Arbroath,746,3,18,8,10,71,48,23,62
Alloa,746,4,17,8,11,56,45,11,59
Stranraer,746,5,16,5,15,57,64,-7,53
Airdrieon,746,6,11,11,14,47,59,-12,44
East Fife,746,7,13,3,20,47,66,-19,42
Forfar,746,8,10,5,21,39,66,-27,35
Albion,746,9,9,6,21,58,78,-20,33
Queen's Park,746,10,6,10,20,39,73,-34,28
Raith,747,1,22,8,6,70,35,35,74
Ayr,747,2,23,4,9,92,45,47,73
Arbroath,747,3,18,8,10,71,48,23,62
Alloa,747,4,18,8,10,59,45,14,62
Stranraer,747,5,15,5,16,55,65,-10,50
East Fife,747,6,14,3,19,48,64,-16,45
Airdrieon,747,7,10,11,15,45,59,-14,41
Forfar,747,8,11,5,20,39,64,-25,38
Albion,747,9,9,6,21,60,80,-20,33
Queen's Park,747,10,6,10,20,39,73,-34,28
Raith,748,1,23,8,5,71,34,37,77
Ayr,748,2,24,4,8,94,42,52,76
Arbroath,748,3,18,8,10,73,48,25,62
Alloa,748,4,17,8,11,58,46,12,59
Stranraer,748,5,15,6,15,57,66,-9,51
East Fife,748,6,13,4,19,49,66,-17,43
Airdrieon,748,7,10,12,14,46,59,-13,42
Forfar,748,8,10,6,20,39,65,-26,36
Albion,748,9,8,6,22,57,82,-25,30
Queen's Park,748,10,6,10,20,39,75,-36,28
Ayr,749,1,23,5,8,91,43,48,74
Raith,749,2,22,8,6,69,35,34,74
Alloa,749,3,18,8,10,59,44,15,62
Arbroath,749,4,17,9,10,74,52,22,60
Stranraer,749,5,15,6,15,56,65,-9,51
East Fife,749,6,13,4,19,48,65,-17,43
Airdrieon,749,7,10,11,15,46,63,-17,41
Forfar,749,8,11,5,20,43,65,-22,38
Albion,749,9,8,7,21,58,79,-21,31
Queen's Park,749,10,6,11,19,43,76,-33,29
Raith,750,1,23,8,5,71,32,39,77
Ayr,750,2,24,4,8,97,42,55,76
Arbroath,750,3,18,8,10,72,49,23,62
Alloa,750,4,17,8,11,56,46,10,59
Stranraer,750,5,15,5,16,55,66,-11,50
East Fife,750,6,14,3,19,49,64,-15,45
Airdrieon,750,7,11,11,14,47,58,-11,44
Forfar,750,8,10,5,21,38,66,-28,35
Albion,750,9,8,6,22,57,85,-28,30
Queen's Park,750,10,6,10,20,40,74,-34,28
Raith,751,1,23,8,5,69,32,37,77
Ayr,751,2,24,4,8,93,43,50,76
Arbroath,751,3,18,8,10,71,48,23,62
Alloa,751,4,17,8,11,56,44,12,59
Stranraer,751,5,15,6,15,56,65,-9,51
East Fife,751,6,13,4,19,48,65,-17,43
Airdrieon,751,7,10,11,15,45,60,-15,41
Forfar,751,8,11,5,20,40,64,-24,38
Albion,751,9,8,6,22,58,81,-23,30
Queen's Park,751,10,6,10,20,39,73,-34,28
Ayr,752,1,24,4,8,95,43,52,76
Raith,752,2,22,9,5,70,34,36,75
Alloa,752,3,17,9,10,58,45,13,60
Arbroath,752,4,17,8,11,71,50,21,59
Stranraer,752,5,15,5,16,56,66,-10,50
East Fife,752,6,14,3,19,49,65,-16,45
Airdrieon,752,7,10,11,15,45,60,-15,41
Forfar,752,8,11,5,20,40,64,-24,38
Queen's Park,752,9,7,10,19,41,73,-32,31
Albion,752,10,8,6,22,58,83,-25,30
Raith,753,1,23,8,5,69,32,37,77
Ayr,753,2,24,4,8,92,42,50,76
Arbroath,753,3,18,8,10,71,48,23,62
Alloa,753,4,17,8,11,56,44,12,59
Stranraer,753,5,15,5,16,56,66,-10,50
East Fife,753,6,14,3,19,49,65,-16,45
Airdrieon,753,7,11,11,14,47,59,-12,44
Forfar,753,8,10,5,21,39,66,-27,35
Albion,753,9,8,6,22,57,80,-23,30
Queen's Park,753,10,6,10,20,39,73,-34,28
Raith,754,1,23,8,5,69,32,37,77
Ayr,754,2,24,4,8,94,42,52,76
Arbroath,754,3,18,8,10,73,48,25,62
Alloa,754,4,17,8,11,56,44,12,59
Stranraer,754,5,15,5,16,56,68,-12,50
East Fife,754,6,14,3,19,51,65,-14,45
Airdrieon,754,7,11,11,14,47,59,-12,44
Forfar,754,8,10,5,21,39,66,-27,35
Albion,754,9,8,6,22,57,82,-25,30
Queen's Park,754,10,6,10,20,39,75,-36,28
Ayr,755,1,24,4,8,95,44,51,76
Raith,755,2,22,9,5,69,33,36,75
Arbroath,755,3,18,8,10,74,50,24,62
Alloa,755,4,17,9,10,57,44,13,60
Stranraer,755,5,16,5,15,57,64,-7,53
Airdrieon,755,6,11,11,14,47,59,-12,44
East Fife,755,7,13,3,20,47,66,-19,42
Forfar,755,8,10,5,21,39,66,-27,35
Albion,755,9,8,6,22,59,83,-24,30
Queen's Park,755,10,6,10,20,41,76,-35,28
Raith,756,1,23,8,5,71,32,39,77
Ayr,756,2,24,4,8,91,42,49,76
Arbroath,756,3,17,8,11,71,53,18,59
Alloa,756,4,17,8,11,56,46,10,59
Stranraer,756,5,15,5,16,55,65,-10,50
East Fife,756,6,14,3,19,48,64,-16,45
Airdrieon,756,7,11,11,14,49,59,-10,44
Forfar,756,8,10,5,21,39,68,-29,35
Queen's Park,756,9,7,10,19,44,73,-29,31
Albion,756,10,8,6,22,57,79,-22,30
Raith,757,1,23,8,5,71,33,38,77
Ayr,757,2,23,4,9,92,45,47,73
Arbroath,757,3,17,9,10,71,49,22,60
Alloa,757,4,17,8,11,57,46,11,59
Stranraer,757,5,16,5,15,59,65,-6,53
Airdrieon,757,6,10,12,14,47,60,-13,42
East Fife,757,7,13,3,20,48,68,-20,42
Forfar,757,8,10,6,20,40,66,-26,36
Albion,757,9,9,6,21,60,80,-20,33
Queen's Park,757,10,6,11,19,40,73,-33,29
Raith,758,1,23,8,5,71,33,38,77
Ayr,758,2,24,4,8,93,42,51,76
Arbroath,758,3,18,8,10,75,48,27,62
Alloa,758,4,17,8,11,57,46,11,59
Stranraer,758,5,15,5,16,56,68,-12,50
East Fife,758,6,14,3,19,51,65,-14,45
Airdrieon,758,7,10,11,15,45,62,-17,41
Forfar,758,8,11,5,20,42,64,-22,38
Albion,758,9,8,6,22,57,81,-24,30
Queen's Park,758,10,6,10,20,39,77,-38,28
Raith,759,1,23,8,5,71,33,38,77
Ayr,759,2,24,4,8,96,42,54,76
Arbroath,759,3,17,9,10,71,49,22,60
Alloa,759,4,17,8,11,57,46,11,59
Stranraer,759,5,15,5,16,56,66,-10,50
East Fife,759,6,14,3,19,49,65,-16,45
Airdrieon,759,7,10,12,14,47,60,-13,42
Forfar,759,8,10,6,20,40,66,-26,36
Albion,759,9,8,6,22,57,84,-27,30
Queen's Park,759,10,6,11,19,40,73,-33,29
Ayr,760,1,24,4,8,93,43,50,76
Raith,760,2,22,8,6,69,34,35,74
Alloa,760,3,18,8,10,58,44,14,62
Arbroath,760,4,17,8,11,71,50,21,59
Stranraer,760,5,15,6,15,55,64,-9,51
Airdrieon,760,6,11,11,14,48,59,-11,44
East Fife,760,7,13,4,19,47,64,-17,43
Forfar,760,8,10,5,21,39,67,-28,35
Queen's Park,760,9,7,10,19,41,73,-32,31
Albion,760,10,8,6,22,58,81,-23,30
Raith,761,1,22,8,6,69,35,34,74
Ayr,761,2,23,4,9,93,47,46,73
Alloa,761,3,18,8,10,59,44,15,62
Arbroath,761,4,17,9,10,72,50,22,60
Stranraer,761,5,16,5,15,58,64,-6,53
East Fife,761,6,13,3,20,47,67,-20,42
Airdrieon,761,7,10,11,15,45,59,-14,41
Forfar,761,8,11,5,20,39,64,-25,38
Albion,761,9,9,6,21,62,81,-19,33
Queen's Park,761,10,6,11,19,41,74,-33,29
Ayr,762,1,24,4,8,93,42,51,76
Raith,762,2,22,9,5,69,33,36,75
Arbroath,762,3,17,9,10,72,50,22,60
Alloa,762,4,17,9,10,57,44,13,60
Stranraer,762,5,15,5,16,56,66,-10,50
East Fife,762,6,14,3,19,49,65,-16,45
Airdrieon,762,7,11,11,14,47,59,-12,44
Forfar,762,8,10,5,21,39,66,-27,35
Albion,762,9,8,6,22,57,81,-24,30
Queen's Park,762,10,6,11,19,41,74,-33,29
Raith,763,1,23,8,5,70,32,38,77
Ayr,763,2,24,4,8,95,45,50,76
Arbroath,763,3,17,8,11,71,50,21,59
Alloa,763,4,17,8,11,56,45,11,59
Stranraer,763,5,15,5,16,57,67,-10,50
East Fife,763,6,14,3,19,50,66,-16,45
Airdrieon,763,7,10,11,15,46,61,-15,41
Forfar,763,8,11,5,20,41,65,-24,38
Queen's Park,763,9,7,10,19,41,73,-32,31
Albion,763,10,8,6,22,60,83,-23,30
Ayr,764,1,24,4,8,92,43,49,76
Raith,764,2,22,9,5,68,32,36,75
Arbroath,764,3,17,9,10,72,50,22,60
Alloa,764,4,17,9,10,56,43,13,60
Stranraer,764,5,15,6,15,57,66,-9,51
East Fife,764,6,13,4,19,49,66,-17,43
Airdrieon,764,7,10,12,14,46,59,-13,42
Forfar,764,8,10,6,20,39,65,-26,36
Albion,764,9,8,6,22,58,80,-22,30
Queen's Park,764,10,6,11,19,41,74,-33,29
Raith,765,1,23,8,5,72,32,40,77
Ayr,765,2,24,4,8,94,42,52,76
Arbroath,765,3,17,9,10,73,51,22,60
Alloa,765,4,17,8,11,56,47,9,59
Stranraer,765,5,15,5,16,56,67,-11,50
East Fife,765,6,14,3,19,50,65,-15,45
Airdrieon,765,7,10,11,15,45,59,-14,41
Forfar,765,8,11,5,20,39,64,-25,38
Albion,765,9,8,6,22,57,82,-25,30
Queen's Park,765,10,6,11,19,42,75,-33,29
Raith,766,1,23,8,5,71,33,38,77
Ayr,766,2,24,4,8,95,45,50,76
Arbroath,766,3,17,8,11,71,51,20,59
Alloa,766,4,17,8,11,57,46,11,59
Stranraer,766,5,15,6,15,57,66,-9,51
Airdrieon,766,6,11,11,14,47,59,-12,44
East Fife,766,7,13,4,19,49,66,-17,43
Forfar,766,8,10,5,21,39,66,-27,35
Queen's Park,766,9,7,10,19,42,73,-31,31
Albion,766,10,8,6,22,60,83,-23,30
Raith,767,1,23,8,5,70,33,37,77
Ayr,767,2,24,4,8,92,43,49,76
Arbroath,767,3,17,8,11,70,49,21,59
Alloa,767,4,17,8,11,57,45,12,59
Stranraer,767,5,15,6,15,56,65,-9,51
Airdrieon,767,6,11,11,14,48,58,-10,44
East Fife,767,7,13,4,19,48,65,-17,43
Forfar,767,8,10,5,21,38,67,-29,35
Queen's Park,767,9,7,10,19,40,72,-32,31
Albion,767,10,8,6,22,58,80,-22,30
Raith,768,1,23,8,5,69,32,37,77
Ayr,768,2,24,4,8,94,43,51,76
Arbroath,768,3,18,8,10,75,50,25,62
Alloa,768,4,17,8,11,56,44,12,59
Stranraer,768,5,15,6,15,56,65,-9,51
Airdrieon,768,6,11,11,14,48,58,-10,44
East Fife,768,7,13,4,19,48,65,-17,43
Forfar,768,8,10,5,21,38,67,-29,35
Albion,768,9,8,6,22,58,82,-24,30
Queen's Park,768,10,6,10,20,41,77,-36,28
Raith,769,1,23,8,5,71,32,39,77
Ayr,769,2,24,4,8,94,43,51,76
Arbroath,769,3,18,8,10,72,49,23,62
Alloa,769,4,17,8,11,56,46,10,59
Stranraer,769,5,15,5,16,57,67,-10,50
East Fife,769,6,14,3,19,50,66,-16,45
Airdrieon,769,7,11,11,14,48,59,-11,44
Forfar,769,8,10,5,21,39,67,-28,35
Albion,769,9,8,6,22,58,82,-24,30
Queen's Park,769,10,6,10,20,40,74,-34,28
Raith,770,1,23,8,5,70,32,38,77
Ayr,770,2,24,4,8,96,46,50,76
Arbroath,770,3,17,8,11,70,49,21,59
Alloa,770,4,17,8,11,56,45,11,59
Stranraer,770,5,16,5,15,57,65,-8,53
Airdrieon,770,6,11,11,14,48,59,-11,44
East Fife,770,7,13,3,20,48,66,-18,42
Forfar,770,8,10,5,21,39,67,-28,35
Queen's Park,770,9,7,10,19,40,72,-32,31
Albion,770,10,8,6,22,61,84,-23,30
Ayr,771,1,24,4,8,96,43,53,76
Raith,771,2,22,9,5,69,33,36,75
Arbroath,771,3,17,9,10,71,49,22,60
Alloa,771,4,17,9,10,57,44,13,60
Stranraer,771,5,16,5,15,57,64,-7,53
Airdrieon,771,6,11,11,14,46,58,-12,44
East Fife,771,7,13,3,20,47,66,-19,42
Forfar,771,8,10,5,21,38,65,-27,35
Albion,771,9,8,6,22,58,84,-26,30
Queen's Park,771,10,6,11,19,40,73,-33,29
Raith,772,1,23,8,5,72,33,39,77
Ayr,772,2,24,4,8,92,43,49,76
Arbroath,772,3,17,8,11,71,51,20,59
Alloa,772,4,17,8,11,57,47,10,59
Stranraer,772,5,16,5,15,57,64,-7,53
East Fife,772,6,13,3,20,47,66,-19,42
Airdrieon,772,7,10,11,15,46,60,-14,41
Forfar,772,8,11,5,20,40,65,-25,38
Queen's Park,772,9,7,10,19,42,73,-31,31
Albion,772,10,8,6,22,58,80,-22,30
Raith,773,1,23,8,5,71,34,37,77
Ayr,773,2,24,4,8,93,42,51,76
Arbroath,773,3,17,8,11,70,54,16,59
Alloa,773,4,17,8,11,58,46,12,59
Stranraer,773,5,16,5,15,56,64,-8,53
Airdrieon,773,6,11,11,14,47,59,-12,44
East Fife,773,7,13,3,20,47,65,-18,42
Forfar,773,8,10,5,21,39,66,-27,35
Queen's Park,773,9,7,10,19,45,72,-27,31
Albion,773,10,8,6,22,57,81,-24,30
Raith,774,1,23,8,5,72,34,38,77
Ayr,774,2,24,4,8,93,44,49,76
Arbroath,774,3,18,8,10,72,49,23,62
Alloa,774,4,17,8,11,58,47,11,59
Stranraer,774,5,15,5,16,56,66,-10,50
East Fife,774,6,14,3,19,49,65,-16,45
Airdrieon,774,7,10,12,14,45,58,-13,42
Forfar,774,8,10,6,20,38,64,-26,36
Albion,774,9,8,6,22,59,81,-22,30
Queen's Park,774,10,6,10,20,40,74,-34,28
Ayr,775,1,24,4,8,93,43,50,76
Raith,775,2,22,9,5,70,34,36,75
Arbroath,775,3,18,8,10,74,48,26,62
Alloa,775,4,17,9,10,58,45,13,60
Stranraer,775,5,15,5,16,55,65,-10,50
East Fife,775,6,14,3,19,48,64,-16,45
Airdrieon,775,7,10,11,15,45,61,-16,41
Forfar,775,8,11,5,20,41,64,-23,38
Albion,775,9,8,6,22,58,81,-23,30
Queen's Park,775,10,6,10,20,39,76,-37,28
Ayr,776,1,24,4,8,95,43,52,76
Raith,776,2,22,8,6,69,35,34,74
Alloa,776,3,18,8,10,59,44,15,62
Arbroath,776,4,17,8,11,70,50,20,59
Stranraer,776,5,15,6,15,57,66,-9,51
Airdrieon,776,6,11,11,14,48,59,-11,44
East Fife,776,7,13,4,19,49,66,-17,43
Forfar,776,8,10,5,21,39,67,-28,35
Queen's Park,776,9,7,10,19,41,72,-31,31
Albion,776,10,8,6,22,58,83,-25,30
Ayr,777,1,24,4,8,92,42,50,76
Raith,777,2,22,9,5,69,33,36,75
Arbroath,777,3,18,8,10,72,48,24,62
Alloa,777,4,17,9,10,57,44,13,60
Stranraer,777,5,15,6,15,58,67,-9,51
Airdrieon,777,6,11,11,14,47,59,-12,44
East Fife,777,7,13,4,19,50,67,-17,43
Forfar,777,8,10,5,21,39,66,-27,35
Albion,777,9,8,6,22,57,80,-23,30
Queen's Park,777,10,6,10,20,39,74,-35,28
Ayr,778,1,24,4,8,91,42,49,76
Raith,778,2,22,8,6,69,34,35,74
Arbroath,778,3,18,8,10,72,48,24,62
Alloa,778,4,18,8,10,58,44,14,62
Stranraer,778,5,15,5,16,55,66,-11,50
East Fife,778,6,14,3,19,49,64,-15,45
Airdrieon,778,7,10,11,15,46,60,-14,41
Forfar,778,8,11,5,20,40,65,-25,38
Albion,778,9,8,6,22,57,79,-22,30
Queen's Park,778,10,6,10,20,39,74,-35,28
Ayr,779,1,24,4,8,92,43,49,76
Raith,779,2,22,8,6,69,34,35,74
Alloa,779,3,18,8,10,58,44,14,62
Arbroath,779,4,17,9,10,70,48,22,60
Stranraer,779,5,15,5,16,56,67,-11,50
East Fife,779,6,14,3,19,50,65,-15,45
Airdrieon,779,7,10,12,14,46,59,-13,42
Forfar,779,8,10,6,20,39,65,-26,36
Albion,779,9,8,6,22,58,80,-22,30
Queen's Park,779,10,6,11,19,39,72,-33,29
Ayr,780,1,24,4,8,94,42,52,76
Raith,780,2,22,9,5,70,34,36,75
Arbroath,780,3,18,8,10,72,48,24,62
Alloa,780,4,17,9,10,58,45,13,60
Stranraer,780,5,15,5,16,56,68,-12,50
East Fife,780,6,14,3,19,51,65,-14,45
Airdrieon,780,7,11,11,14,47,59,-12,44
Forfar,780,8,10,5,21,39,66,-27,35
Albion,780,9,8,6,22,57,82,-25,30
Queen's Park,780,10,6,10,20,39,74,-35,28
Ayr,781,1,24,4,8,93,44,49,76
Raith,781,2,22,8,6,68,34,34,74
Alloa,781,3,18,8,10,58,43,15,62
Arbroath,781,4,17,9,10,71,49,22,60
Stranraer,781,5,15,5,16,56,66,-10,50
East Fife,781,6,14,3,19,49,65,-16,45
Airdrieon,781,7,11,11,14,46,58,-12,44
Forfar,781,8,10,5,21,38,65,-27,35
Albion,781,9,8,6,22,59,81,-22,30
Queen's Park,781,10,6,11,19,40,73,-33,29
Ayr,782,1,24,4,8,97,42,55,76
Raith,782,2,22,9,5,68,32,36,75
Arbroath,782,3,17,9,10,71,49,22,60
Alloa,782,4,17,9,10,56,43,13,60
Stranraer,782,5,15,6,15,56,65,-9,51
Airdrieon,782,6,11,11,14,48,58,-10,44
East Fife,782,7,13,4,19,48,65,-17,43
Forfar,782,8,10,5,21,38,67,-29,35
Albion,782,9,8,6,22,57,85,-28,30
Queen's Park,782,10,6,11,19,40,73,-33,29
Ayr,783,1,24,4,8,94,43,51,76
Raith,783,2,22,9,5,68,32,36,75
Arbroath,783,3,17,9,10,71,49,22,60
Alloa,783,4,17,9,10,56,43,13,60
Stranraer,783,5,15,5,16,57,68,-11,50
East Fife,783,6,14,3,19,51,66,-15,45
Airdrieon,783,7,10,11,15,46,60,-14,41
Forfar,783,8,11,5,20,40,65,-25,38
Albion,783,9,8,6,22,58,82,-24,30
Queen's Park,783,10,6,11,19,40,73,-33,29
Raith,784,1,23,8,5,69,32,37,77
Ayr,784,2,24,4,8,99,43,56,76
Arbroath,784,3,17,8,11,71,53,18,59
Alloa,784,4,17,8,11,56,44,12,59
Stranraer,784,5,15,5,16,56,66,-10,50
East Fife,784,6,14,3,19,49,65,-16,45
Airdrieon,784,7,10,11,15,45,60,-15,41
Forfar,784,8,11,5,20,40,64,-24,38
Queen's Park,784,9,7,10,19,44,73,-29,31
Albion,784,10,8,6,22,58,87,-29,30
Raith,785,1,23,8,5,70,33,37,77
Ayr,785,2,23,4,9,92,45,47,73
Arbroath,785,3,17,8,11,70,49,21,59
Alloa,785,4,17,8,11,57,45,12,59
Stranraer,785,5,15,5,16,55,65,-10,50
East Fife,785,6,14,3,19,48,64,-16,45
Airdrieon,785,7,11,11,14,46,58,-12,44
Forfar,785,8,10,5,21,38,65,-27,35
Albion,785,9,9,6,21,60,80,-20,33
Queen's Park,785,10,7,10,19,40,72,-32,31
Ayr,786,1,24,4,8,93,44,49,76
Raith,786,2,22,9,5,70,34,36,75
Alloa,786,3,17,9,10,58,45,13,60
Arbroath,786,4,17,8,11,70,51,19,59
Stranraer,786,5,15,6,15,56,65,-9,51
East Fife,786,6,13,4,19,48,65,-17,43
Airdrieon,786,7,10,12,14,48,61,-13,42
Forfar,786,8,10,6,20,41,67,-26,36
Queen's Park,786,9,7,10,19,42,72,-30,31
Albion,786,10,8,6,22,59,81,-22,30
Raith,787,1,23,8,5,69,32,37,77
Ayr,787,2,24,4,8,94,44,50,76
Arbroath,787,3,18,8,10,71,48,23,62
Alloa,787,4,17,8,11,56,44,12,59
Stranraer,787,5,15,5,16,55,65,-10,50
East Fife,787,6,14,3,19,48,64,-16,45
Airdrieon,787,7,10,12,14,45,58,-13,42
Forfar,787,8,10,6,20,38,64,-26,36
Albion,787,9,8,6,22,59,82,-23,30
Queen's Park,787,10,6,10,20,39,73,-34,28
Ayr,788,1,24,4,8,93,42,51,76
Raith,788,2,22,8,6,69,34,35,74
Arbroath,788,3,18,8,10,72,48,24,62
Alloa,788,4,18,8,10,58,44,14,62
Stranraer,788,5,15,6,15,56,65,-9,51
Airdrieon,788,6,11,11,14,46,58,-12,44
East Fife,788,7,13,4,19,48,65,-17,43
Forfar,788,8,10,5,21,38,65,-27,35
Albion,788,9,8,6,22,57,81,-24,30
Queen's Park,788,10,6,10,20,39,74,-35,28
Ayr,789,1,24,4,8,91,42,49,76
Raith,789,2,22,9,5,69,33,36,75
Arbroath,789,3,17,9,10,72,50,22,60
Alloa,789,4,17,9,10,57,44,13,60
Stranraer,789,5,15,5,16,56,66,-10,50
East Fife,789,6,14,3,19,49,65,-16,45
Airdrieon,789,7,11,11,14,48,60,-12,44
Forfar,789,8,10,5,21,40,67,-27,35
Albion,789,9,8,6,22,57,79,-22,30
Queen's Park,789,10,6,11,19,41,74,-33,29
Raith,790,1,23,8,5,71,33,38,77
Ayr,790,2,24,4,8,94,42,52,76
Arbroath,790,3,18,8,10,75,49,26,62
Alloa,790,4,17,8,11,57,46,11,59
Stranraer,790,5,16,5,15,57,64,-7,53
Airdrieon,790,6,10,12,14,47,60,-13,42
East Fife,790,7,13,3,20,47,66,-19,42
Forfar,790,8,10,6,20,40,66,-26,36
Albion,790,9,8,6,22,57,82,-25,30
Queen's Park,790,10,6,10,20,40,77,-37,28
Ayr,791,1,24,4,8,94,42,52,76
Raith,791,2,22,8,6,69,34,35,74
Alloa,791,3,18,8,10,58,44,14,62
Arbroath,791,4,17,9,10,72,50,22,60
Stranraer,791,5,15,6,15,56,65,-9,51
East Fife,791,6,13,4,19,48,65,-17,43
Airdrieon,791,7,10,11,15,45,59,-14,41
Forfar,791,8,11,5,20,39,64,-25,38
Albion,791,9,8,6,22,57,82,-25,30
Queen's Park,791,10,6,11,19,41,74,-33,29
Raith,792,1,23,8,5,72,32,40,77
Ayr,792,2,24,4,8,95,42,53,76
Arbroath,792,3,17,8,11,71,50,21,59
Alloa,792,4,17,8,11,56,47,9,59
Stranraer,792,5,15,5,16,55,67,-12,50
East Fife,792,6,14,3,19,50,64,-14,45
Airdrieon,792,7,11,11,14,46,58,-12,44
Forfar,792,8,10,5,21,38,65,-27,35
Queen's Park,792,9,7,10,19,41,73,-32,31
Albion,792,10,8,6,22,57,83,-26,30
Raith,793,1,23,8,5,70,32,38,77
Ayr,793,2,24,4,8,93,42,51,76
Arbroath,793,3,18,8,10,73,48,25,62
Alloa,793,4,17,8,11,56,45,11,59
Stranraer,793,5,15,5,16,55,66,-11,50
East Fife,793,6,14,3,19,49,64,-15,45
Airdrieon,793,7,11,11,14,48,59,-11,44
Forfar,793,8,10,5,21,39,67,-28,35
Albion,793,9,8,6,22,57,81,-24,30
Queen's Park,793,10,6,10,20,39,75,-36,28
Raith,794,1,23,8,5,71,34,37,77
Ayr,794,2,24,4,8,96,42,54,76
Arbroath,794,3,17,8,11,70,50,20,59
Alloa,794,4,17,8,11,58,46,12,59
Stranraer,794,5,15,5,16,56,67,-11,50
East Fife,794,6,14,3,19,50,65,-15,45
Airdrieon,794,7,11,11,14,49,60,-11,44
Forfar,794,8,10,5,21,40,68,-28,35
Queen's Park,794,9,7,10,19,41,72,-31,31
Albion,794,10,8,6,22,57,84,-27,30
Ayr,795,1,24,4,8,93,43,50,76
Raith,795,2,22,8,6,68,35,33,74
Arbroath,795,3,18,8,10,71,48,23,62
Alloa,795,4,18,8,10,59,43,16,62
Stranraer,795,5,15,6,15,57,66,-9,51
Airdrieon,795,6,11,11,14,48,60,-12,44
East Fife,795,7,13,4,19,49,66,-17,43
Forfar,795,8,10,5,21,40,67,-27,35
Albion,795,9,8,6,22,58,81,-23,30
Queen's Park,795,10,6,10,20,39,73,-34,28
Ayr,796,1,24,4,8,92,43,49,76
Raith,796,2,22,9,5,69,33,36,75
Arbroath,796,3,18,8,10,73,48,25,62
Alloa,796,4,17,9,10,57,44,13,60
Stranraer,796,5,16,5,15,57,65,-8,53
East Fife,796,6,13,3,20,48,66,-18,42
Airdrieon,796,7,10,11,15,46,60,-14,41
Forfar,796,8,11,5,20,40,65,-25,38
Albion,796,9,8,6,22,58,80,-22,30
Queen's Park,796,10,6,10,20,39,75,-36,28
Ayr,797,1,24,4,8,93,44,49,76
Raith,797,2,22,8,6,68,34,34,74
Alloa,797,3,18,8,10,58,43,15,62
Arbroath,797,4,17,9,10,71,49,22,60
Stranraer,797,5,15,5,16,57,69,-12,50
East Fife,797,6,14,3,19,52,66,-14,45
Airdrieon,797,7,11,11,14,46,58,-12,44
Forfar,797,8,10,5,21,38,65,-27,35
Albion,797,9,8,6,22,59,81,-22,30
Queen's Park,797,10,6,11,19,40,73,-33,29
Raith,798,1,23,8,5,74,34,40,77
Ayr,798,2,23,5,8,92,44,48,74
Arbroath,798,3,17,8,11,71,51,20,59
Alloa,798,4,17,8,11,58,49,9,59
Stranraer,798,5,16,5,15,56,64,-8,53
East Fife,798,6,13,3,20,47,65,-18,42
Airdrieon,798,7,10,11,15,46,62,-16,41
Forfar,798,8,11,5,20,42,65,-23,38
Albion,798,9,8,7,21,59,80,-21,31
Queen's Park,798,10,7,10,19,42,73,-31,31
Ayr,799,1,24,4,8,95,44,51,76
Raith,799,2,22,8,6,69,34,35,74
Arbroath,799,3,18,8,10,73,50,23,62
Alloa,799,4,18,8,10,58,44,14,62
Stranraer,799,5,16,5,15,56,64,-8,53
Airdrieon,799,6,11,11,14,47,59,-12,44
East Fife,799,7,13,3,20,47,65,-18,42
Forfar,799,8,10,5,21,39,66,-27,35
Albion,799,9,8,6,22,59,83,-24,30
Queen's Park,799,10,6,10,20,41,75,-34,28
Raith,800,1,23,8,5,71,32,39,77
Ayr,800,2,24,4,8,95,42,53,76
Arbroath,800,3,18,8,10,73,50,23,62
Alloa,800,4,17,8,11,56,46,10,59
Stranraer,800,5,15,5,16,55,68,-13,50
East Fife,800,6,14,3,19,51,64,-13,45
Airdrieon,800,7,11,11,14,47,59,-12,44
Forfar,800,8,10,5,21,39,66,-27,35
Albion,800,9,8,6,22,57,83,-26,30
Queen's Park,800,10,6,10,20,41,75,-34,28
Raith,801,1,23,8,5,69,32,37,77
Ayr,801,2,24,4,8,94,44,50,76
Arbroath,801,3,17,9,10,71,49,22,60
Alloa,801,4,17,8,11,56,44,12,59
Stranraer,801,5,15,5,16,57,67,-10,50
East Fife,801,6,14,3,19,50,66,-16,45
Airdrieon,801,7,11,11,14,48,59,-11,44
Forfar,801,8,10,5,21,39,67,-28,35
Albion,801,9,8,6,22,59,82,-23,30
Queen's Park,801,10,6,11,19,40,73,-33,29
Ayr,802,1,24,4,8,92,42,50,76
Raith,802,2,22,8,6,69,35,34,74
Arbroath,802,3,18,8,10,73,50,23,62
Alloa,802,4,18,8,10,59,44,15,62
Stranraer,802,5,16,5,15,57,65,-8,53
East Fife,802,6,13,3,20,48,66,-18,42
Airdrieon,802,7,10,11,15,46,60,-14,41
Forfar,802,8,11,5,20,40,65,-25,38
Albion,802,9,8,6,22,57,80,-23,30
Queen's Park,802,10,6,10,20,41,75,-34,28
Ayr,803,1,24,4,8,94,43,51,76
Raith,803,2,22,9,5,70,34,36,75
Arbroath,803,3,18,8,10,73,48,25,62
Alloa,803,4,17,9,10,58,45,13,60
Stranraer,803,5,15,6,15,56,65,-9,51
East Fife,803,6,13,4,19,48,65,-17,43
Airdrieon,803,7,10,12,14,46,59,-13,42
Forfar,803,8,10,6,20,39,65,-26,36
Albion,803,9,8,6,22,58,82,-24,30
Queen's Park,803,10,6,10,20,39,75,-36,28
Raith,804,1,23,8,5,69,32,37,77
Ayr,804,2,24,4,8,93,43,50,76
Arbroath,804,3,18,8,10,74,51,23,62
Alloa,804,4,17,8,11,56,44,12,59
Stranraer,804,5,15,5,16,56,66,-10,50
East Fife,804,6,14,3,19,49,65,-16,45
Airdrieon,804,7,10,12,14,46,59,-13,42
Forfar,804,8,10,6,20,39,65,-26,36
Albion,804,9,8,6,22,58,81,-23,30
Queen's Park,804,10,6,10,20,42,76,-34,28
Raith,805,1,23,8,5,72,33,39,77
Ayr,805,2,24,4,8,92,43,49,76
Arbroath,805,3,17,8,11,70,51,19,59
Alloa,805,4,17,8,11,57,47,10,59
Stranraer,805,5,15,6,15,57,66,-9,51
Airdrieon,805,6,11,11,14,49,60,-11,44
East Fife,805,7,13,4,19,49,66,-17,43
Forfar,805,8,10,5,21,40,68,-28,35
Queen's Park,805,9,7,10,19,42,72,-30,31
Albion,805,10,8,6,22,58,80,-22,30
Raith,806,1,23,8,5,71,33,38,77
Ayr,806,2,24,4,8,96,43,53,76
Arbroath,806,3,17,8,11,71,51,20,59
Alloa,806,4,17,8,11,57,46,11,59
Stranraer,806,5,16,5,15,57,65,-8,53
Airdrieon,806,6,11,11,14,49,58,-9,44
East Fife,806,7,13,3,20,48,66,-18,42
Forfar,806,8,10,5,21,38,68,-30,35
Queen's Park,806,9,7,10,19,42,73,-31,31
Albion,806,10,8,6,22,58,84,-26,30
Raith,807,1,23,8,5,71,33,38,77
Ayr,807,2,23,5,8,91,43,48,74
Arbroath,807,3,17,8,11,70,49,21,59
Alloa,807,4,17,8,11,57,46,11,59
Stranraer,807,5,15,6,15,55,64,-9,51
East Fife,807,6,13,4,19,47,64,-17,43
Airdrieon,807,7,10,12,14,47,60,-13,42
Forfar,807,8,10,6,20,40,66,-26,36
Albion,807,9,8,7,21,58,79,-21,31
Queen's Park,807,10,7,10,19,40,72,-32,31
Ayr,808,1,24,4,8,95,44,51,76
Raith,808,2,22,9,5,69,33,36,75
Arbroath,808,3,17,9,10,72,50,22,60
Alloa,808,4,17,9,10,57,44,13,60
Stranraer,808,5,16,5,15,57,64,-7,53
Airdrieon,808,6,11,11,14,49,59,-10,44
East Fife,808,7,13,3,20,47,66,-19,42
Forfar,808,8,10,5,21,39,68,-29,35
Albion,808,9,8,6,22,59,83,-24,30
Queen's Park,808,10,6,11,19,41,74,-33,29
Ayr,809,1,24,4,8,92,42,50,76
Raith,809,2,22,9,5,68,32,36,75
Arbroath,809,3,17,9,10,71,49,22,60
Alloa,809,4,17,9,10,56,43,13,60
Stranraer,809,5,15,5,16,56,67,-11,50
East Fife,809,6,14,3,19,50,65,-15,45
Airdrieon,809,7,11,11,14,46,58,-12,44
Forfar,809,8,10,5,21,38,65,-27,35
Albion,809,9,8,6,22,57,80,-23,30
Queen's Park,809,10,6,11,19,40,73,-33,29
Raith,810,1,23,8,5,71,32,39,77
Ayr,810,2,24,4,8,95,43,52,76
Arbroath,810,3,17,9,10,70,48,22,60
Alloa,810,4,17,8,11,56,46,10,59
Stranraer,810,5,15,6,15,57,66,-9,51
Airdrieon,810,6,11,11,14,47,59,-12,44
East Fife,810,7,13,4,19,49,66,-17,43
Forfar,810,8,10,5,21,39,66,-27,35
Albion,810,9,8,6,22,58,83,-25,30
Queen's Park,810,10,6,11,19,39,72,-33,29
Ayr,811,1,24,4,8,96,44,52,76
Raith,811,2,22,8,6,68,33,35,74
Arbroath,811,3,18,8,10,72,48,24,62
Alloa,811,4,18,8,10,57,43,14,62
Stranraer,811,5,15,5,16,56,67,-11,50
East Fife,811,6,14,3,19,50,65,-15,45
Airdrieon,811,7,10,11,15,46,61,-15,41
Forfar,811,8,11,5,20,41,65,-24,38
Albion,811,9,8,6,22,59,84,-25,30
Queen's Park,811,10,6,10,20,39,74,-35,28
Raith,812,1,23,8,5,70,33,37,77
Ayr,812,2,24,4,8,92,43,49,76
Arbroath,812,3,18,8,10,72,49,23,62
Alloa,812,4,17,8,11,57,45,12,59
Stranraer,812,5,15,5,16,56,67,-11,50
East Fife,812,6,14,3,19,50,65,-15,45
Airdrieon,812,7,10,11,15,45,59,-14,41
Forfar,812,8,11,5,20,39,64,-25,38
Albion,812,9,8,6,22,58,80,-22,30
Queen's Park,812,10,6,10,20,40,74,-34,28
Ayr,813,1,24,4,8,91,42,49,76
Raith,813,2,22,9,5,69,33,36,75
Arbroath,813,3,17,9,10,72,50,22,60
Alloa,813,4,17,9,10,57,44,13,60
Stranraer,813,5,15,6,15,56,65,-9,51
East Fife,813,6,13,4,19,48,65,-17,43
Airdrieon,813,7,10,12,14,45,58,-13,42
Forfar,813,8,10,6,20,38,64,-26,36
Albion,813,9,8,6,22,57,79,-22,30
Queen's Park,813,10,6,11,19,41,74,-33,29
Raith,814,1,23,8,5,70,33,37,77
Ayr,814,2,24,4,8,94,43,51,76
Arbroath,814,3,17,9,10,70,48,22,60
Alloa,814,4,17,8,11,57,45,12,59
Stranraer,814,5,16,5,15,58,66,-8,53
East Fife,814,6,13,3,20,49,67,-18,42
Airdrieon,814,7,10,11,15,45,60,-15,41
Forfar,814,8,11,5,20,40,64,-24,38
Albion,814,9,8,6,22,58,82,-24,30
Queen's Park,814,10,6,11,19,39,72,-33,29
Ayr,815,1,24,4,8,94,43,51,76
Raith,815,2,22,8,6,68,34,34,74
Alloa,815,3,18,8,10,58,43,15,62
Arbroath,815,4,17,9,10,72,50,22,60
Stranraer,815,5,15,5,16,57,68,-11,50
East Fife,815,6,14,3,19,51,66,-15,45
Airdrieon,815,7,11,11,14,50,58,-8,44
Forfar,815,8,10,5,21,38,69,-31,35
Albion,815,9,8,6,22,58,82,-24,30
Queen's Park,815,10,6,11,19,41,74,-33,29
Raith,816,1,23,8,5,69,32,37,77
Ayr,816,2,24,4,8,93,42,51,76
Arbroath,816,3,18,8,10,73,49,24,62
Alloa,816,4,17,8,11,56,44,12,59
Stranraer,816,5,15,5,16,56,66,-10,50
East Fife,816,6,14,3,19,49,65,-16,45
Airdrieon,816,7,11,11,14,46,58,-12,44
Forfar,816,8,10,5,21,38,65,-27,35
Albion,816,9,8,6,22,57,81,-24,30
Queen's Park,816,10,6,10,20,40,75,-35,28
Ayr,817,1,24,4,8,93,43,50,76
Raith,817,2,22,8,6,68,33,35,74
Arbroath,817,3,18,8,10,72,49,23,62
Alloa,817,4,18,8,10,57,43,14,62
Stranraer,817,5,15,5,16,55,66,-11,50
East Fife,817,6,14,3,19,49,64,-15,45
Airdrieon,817,7,11,11,14,49,60,-11,44
Forfar,817,8,10,5,21,40,68,-28,35
Albion,817,9,8,6,22,58,81,-23,30
Queen's Park,817,10,6,10,20,40,74,-34,28
Raith,818,1,23,8,5,71,32,39,77
Ayr,818,2,24,4,8,95,43,52,76
Arbroath,818,3,17,9,10,73,51,22,60
Alloa,818,4,17,8,11,56,46,10,59
Stranraer,818,5,15,5,16,55,66,-11,50
East Fife,818,6,14,3,19,49,64,-15,45
Airdrieon,818,7,11,11,14,46,58,-12,44
Forfar,818,8,10,5,21,38,65,-27,35
Albion,818,9,8,6,22,58,83,-25,30
Queen's Park,818,10,6,11,19,42,75,-33,29
Raith,819,1,22,9,5,70,34,36,75
Ayr,819,2,23,4,9,92,46,46,73
Arbroath,819,3,18,8,10,72,48,24,62
Alloa,819,4,17,9,10,58,45,13,60
Stranraer,819,5,15,5,16,56,67,-11,50
East Fife,819,6,14,3,19,50,65,-15,45
Airdrieon,819,7,11,11,14,49,59,-10,44
Forfar,819,8,10,5,21,39,68,-29,35
Albion,819,9,9,6,21,61,80,-19,33
Queen's Park,819,10,6,10,20,39,74,-35,28
Raith,820,1,23,8,5,71,34,37,77
Ayr,820,2,24,4,8,94,44,50,76
Arbroath,820,3,17,8,11,74,53,21,59
Alloa,820,4,17,8,11,58,46,12,59
Stranraer,820,5,15,5,16,56,66,-10,50
East Fife,820,6,14,3,19,49,65,-16,45
Airdrieon,820,7,11,11,14,47,58,-11,44
Forfar,820,8,10,5,21,38,66,-28,35
Queen's Park,820,9,7,10,19,44,76,-32,31
Albion,820,10,8,6,22,59,82,-23,30
Ayr,821,1,24,4,8,94,45,49,76
Raith,821,2,22,8,6,69,34,35,74
Arbroath,821,3,18,8,10,74,48,26,62
Alloa,821,4,18,8,10,58,44,14,62
Stranraer,821,5,15,6,15,56,65,-9,51
East Fife,821,6,13,4,19,48,65,-17,43
Airdrieon,821,7,10,12,14,47,60,-13,42
Forfar,821,8,10,6,20,40,66,-26,36
Albion,821,9,8,6,22,60,82,-22,30
Queen's Park,821,10,6,10,20,39,76,-37,28
Raith,822,1,23,8,5,71,32,39,77
Ayr,822,2,23,5,8,91,43,48,74
Arbroath,822,3,17,8,11,70,49,21,59
Alloa,822,4,17,8,11,56,46,10,59
Stranraer,822,5,15,5,16,57,68,-11,50
East Fife,822,6,14,3,19,51,66,-15,45
Airdrieon,822,7,11,11,14,47,58,-11,44
Forfar,822,8,10,5,21,38,66,-28,35
Albion,822,9,8,7,21,58,79,-21,31
Queen's Park,822,10,7,10,19,40,72,-32,31
Raith,823,1,23,8,5,71,33,38,77
Ayr,823,2,24,4,8,91,42,49,76
Arbroath,823,3,17,8,11,70,49,21,59
Alloa,823,4,17,8,11,57,46,11,59
Stranraer,823,5,15,5,16,56,67,-11,50
East Fife,823,6,14,3,19,50,65,-15,45
Airdrieon,823,7,11,11,14,48,60,-12,44
Forfar,823,8,10,5,21,40,67,-27,35
Queen's Park,823,9,7,10,19,40,72,-32,31
Albion,823,10,8,6,22,57,79,-22,30
Ayr,824,1,24,4,8,94,44,50,76
Raith,824,2,22,9,5,68,32,36,75
Arbroath,824,3,18,8,10,74,49,25,62
Alloa,824,4,17,9,10,56,43,13,60
Stranraer,824,5,15,5,16,55,66,-11,50
East Fife,824,6,14,3,19,49,64,-15,45
Airdrieon,824,7,10,11,15,45,59,-14,41
Forfar,824,8,11,5,20,39,64,-25,38
Albion,824,9,8,6,22,59,82,-23,30
Queen's Park,824,10,6,10,20,40,76,-36,28
Ayr,825,1,24,4,8,96,43,53,76
Raith,825,2,22,9,5,69,33,36,75
Arbroath,825,3,18,8,10,73,50,23,62
Alloa,825,4,17,9,10,57,44,13,60
Stranraer,825,5,16,5,15,57,65,-8,53
Airdrieon,825,6,11,11,14,47,59,-12,44
East Fife,825,7,13,3,20,48,66,-18,42
Forfar,825,8,10,5,21,39,66,-27,35
Albion,825,9,8,6,22,58,84,-26,30
Queen's Park,825,10,6,10,20,41,75,-34,28
Raith,826,1,22,9,5,68,32,36,75
Ayr,826,2,23,5,8,91,43,48,74
Arbroath,826,3,18,8,10,75,48,27,62
Alloa,826,4,17,9,10,56,43,13,60
Stranraer,826,5,15,5,16,56,66,-10,50
East Fife,826,6,14,3,19,49,65,-16,45
Airdrieon,826,7,10,11,15,45,59,-14,41
Forfar,826,8,11,5,20,39,64,-25,38
Albion,826,9,8,7,21,58,79,-21,31
Queen's Park,826,10,6,10,20,39,77,-38,28
Ayr,827,1,24,4,8,94,42,52,76
Raith,827,2,22,9,5,68,32,36,75
Arbroath,827,3,18,8,10,74,48,26,62
Alloa,827,4,17,9,10,56,43,13,60
Stranraer,827,5,16,5,15,60,66,-6,53
Airdrieon,827,6,11,11,14,47,58,-11,44
East Fife,827,7,13,3,20,49,69,-20,42
Forfar,827,8,10,5,21,38,66,-28,35
Albion,827,9,8,6,22,57,82,-25,30
Queen's Park,827,10,6,10,20,39,76,-37,28
Ayr,828,1,24,4,8,94,43,51,76
Raith,828,2,22,9,5,71,35,36,75
Arbroath,828,3,18,8,10,74,48,26,62
Alloa,828,4,17,9,10,59,46,13,60
Stranraer,828,5,15,6,15,56,65,-9,51
East Fife,828,6,13,4,19,48,65,-17,43
Airdrieon,828,7,10,11,15,45,59,-14,41
Forfar,828,8,11,5,20,39,64,-25,38
Albion,828,9,8,6,22,58,82,-24,30
Queen's Park,828,10,6,10,20,39,76,-37,28
Ayr,829,1,24,4,8,93,43,50,76
Raith,829,2,22,9,5,70,34,36,75
Alloa,829,3,17,9,10,58,45,13,60
Arbroath,829,4,17,8,11,70,49,21,59
Stranraer,829,5,16,5,15,56,64,-8,53
Airdrieon,829,6,11,11,14,48,59,-11,44
East Fife,829,7,13,3,20,47,65,-18,42
Forfar,829,8,10,5,21,39,67,-28,35
Queen's Park,829,9,7,10,19,40,72,-32,31
Albion,829,10,8,6,22,58,81,-23,30
Raith,830,1,23,8,5,71,32,39,77
Ayr,830,2,24,4,8,94,43,51,76
Arbroath,830,3,17,8,11,70,52,18,59
Alloa,830,4,17,8,11,56,46,10,59
Stranraer,830,5,15,6,15,55,64,-9,51
East Fife,830,6,13,4,19,47,64,-17,43
Airdrieon,830,7,10,12,14,46,59,-13,42
Forfar,830,8,10,6,20,39,65,-26,36
Queen's Park,830,9,7,10,19,43,72,-29,31
Albion,830,10,8,6,22,58,82,-24,30
Ayr,831,1,24,4,8,93,43,50,76
Raith,831,2,22,8,6,68,33,35,74
Arbroath,831,3,18,8,10,73,50,23,62
Alloa,831,4,18,8,10,57,43,14,62
Stranraer,831,5,15,5,16,55,65,-10,50
East Fife,831,6,14,3,19,48,64,-16,45
Airdrieon,831,7,10,12,14,46,59,-13,42
Forfar,831,8,10,6,20,39,65,-26,36
Albion,831,9,8,6,22,58,81,-23,30
Queen's Park,831,10,6,10,20,41,75,-34,28
Raith,832,1,23,8,5,70,32,38,77
Ayr,832,2,24,4,8,93,44,49,76
Arbroath,832,3,18,8,10,73,50,23,62
Alloa,832,4,17,8,11,56,45,11,59
Stranraer,832,5,15,6,15,58,67,-9,51
East Fife,832,6,13,4,19,50,67,-17,43
Airdrieon,832,7,10,12,14,46,59,-13,42
Forfar,832,8,10,6,20,39,65,-26,36
Albion,832,9,8,6,22,59,81,-22,30
Queen's Park,832,10,6,10,20,41,75,-34,28
Raith,833,1,23,8,5,71,32,39,77
Ayr,833,2,24,4,8,92,42,50,76
Arbroath,833,3,17,8,11,70,50,20,59
Alloa,833,4,17,8,11,56,46,10,59
Stranraer,833,5,15,5,16,55,65,-10,50
East Fife,833,6,14,3,19,48,64,-16,45
Airdrieon,833,7,10,11,15,45,60,-15,41
Forfar,833,8,11,5,20,40,64,-24,38
Queen's Park,833,9,7,10,19,41,72,-31,31
Albion,833,10,8,6,22,57,80,-23,30
Raith,834,1,22,8,6,68,34,34,74
Ayr,834,2,23,4,9,92,45,47,73
Alloa,834,3,18,8,10,58,43,15,62
Arbroath,834,4,17,8,11,72,51,21,59
Stranraer,834,5,15,5,16,55,66,-11,50
East Fife,834,6,14,3,19,49,64,-15,45
Airdrieon,834,7,11,11,14,47,59,-12,44
Forfar,834,8,10,5,21,39,66,-27,35
Albion,834,9,9,6,21,60,80,-20,33
Queen's Park,834,10,7,10,19,42,74,-32,31
Raith,835,1,22,9,5,68,32,36,75
Ayr,835,2,23,5,8,93,45,48,74
Arbroath,835,3,17,9,10,70,48,22,60
Alloa,835,4,17,9,10,56,43,13,60
Stranraer,835,5,15,5,16,55,65,-10,50
East Fife,835,6,14,3,19,48,64,-16,45
Airdrieon,835,7,11,11,14,47,58,-11,44
Forfar,835,8,10,5,21,38,66,-28,35
Albion,835,9,8,7,21,60,81,-21,31
Queen's Park,835,10,6,11,19,39,72,-33,29
Raith,836,1,23,8,5,71,34,37,77
Ayr,836,2,23,4,9,93,46,47,73
Arbroath,836,3,18,8,10,73,49,24,62
Alloa,836,4,17,8,11,58,46,12,59
Stranraer,836,5,15,5,16,55,68,-13,50
East Fife,836,6,14,3,19,51,64,-13,45
Airdrieon,836,7,11,11,14,47,59,-12,44
Forfar,836,8,10,5,21,39,66,-27,35
Albion,836,9,9,6,21,61,81,-20,33
Queen's Park,836,10,6,10,20,40,75,-35,28
Raith,837,1,23,8,5,71,33,38,77
Ayr,837,2,24,4,8,95,45,50,76
Arbroath,837,3,17,9,10,70,48,22,60
Alloa,837,4,17,8,11,57,46,11,59
Stranraer,837,5,15,6,15,57,66,-9,51
East Fife,837,6,13,4,19,49,66,-17,43
Airdrieon,837,7,10,12,14,46,59,-13,42
Forfar,837,8,10,6,20,39,65,-26,36
Albion,837,9,8,6,22,60,83,-23,30
Queen's Park,837,10,6,11,19,39,72,-33,29
Ayr,838,1,23,5,8,93,45,48,74
Raith,838,2,22,8,6,69,34,35,74
Alloa,838,3,18,8,10,58,44,14,62
Arbroath,838,4,17,9,10,72,50,22,60
Stranraer,838,5,15,6,15,57,66,-9,51
Airdrieon,838,6,11,11,14,46,58,-12,44
East Fife,838,7,13,4,19,49,66,-17,43
Forfar,838,8,10,5,21,38,65,-27,35
Albion,838,9,8,7,21,60,81,-21,31
Queen's Park,838,10,6,11,19,41,74,-33,29
Ayr,839,1,24,4,8,97,44,53,76
Raith,839,2,22,9,5,69,33,36,75
Arbroath,839,3,18,8,10,73,49,24,62
Alloa,839,4,17,9,10,57,44,13,60
Stranraer,839,5,16,5,15,58,65,-7,53
Airdrieon,839,6,11,11,14,47,59,-12,44
East Fife,839,7,13,3,20,48,67,-19,42
Forfar,839,8,10,5,21,39,66,-27,35
Albion,839,9,8,6,22,59,85,-26,30
Queen's Park,839,10,6,10,20,40,75,-35,28
Raith,840,1,23,8,5,71,34,37,77
Ayr,840,2,23,4,9,91,45,46,73
Arbroath,840,3,18,8,10,73,50,23,62
Alloa,840,4,17,8,11,58,46,12,59
Stranraer,840,5,15,5,16,55,66,-11,50
East Fife,840,6,14,3,19,49,64,-15,45
Airdrieon,840,7,10,11,15,47,62,-15,41
Forfar,840,8,11,5,20,42,66,-24,38
Albion,840,9,9,6,21,60,79,-19,33
Queen's Park,840,10,6,10,20,41,75,-34,28
Raith,841,1,23,8,5,71,33,38,77
Ayr,841,2,24,4,8,93,42,51,76
Arbroath,841,3,17,9,10,71,49,22,60
Alloa,841,4,17,8,11,57,46,11,59
Stranraer,841,5,15,5,16,57,68,-11,50
East Fife,841,6,14,3,19,51,66,-15,45
Airdrieon,841,7,10,12,14,46,59,-13,42
Forfar,841,8,10,6,20,39,65,-26,36
Albion,841,9,8,6,22,57,81,-24,30
Queen's Park,841,10,6,11,19,40,73,-33,29
Raith,842,1,23,8,5,70,32,38,77
Ayr,842,2,24,4,8,96,42,54,76
Arbroath,842,3,17,8,11,70,49,21,59
Alloa,842,4,17,8,11,56,45,11,59
Stranraer,842,5,15,5,16,56,66,-10,50
East Fife,842,6,14,3,19,49,65,-16,45
Airdrieon,842,7,10,12,14,46,59,-13,42
Forfar,842,8,10,6,20,39,65,-26,36
Queen's Park,842,9,7,10,19,40,72,-32,31
Albion,842,10,8,6,22,57,84,-27,30
Raith,843,1,23,8,5,72,34,38,77
Ayr,843,2,24,4,8,92,43,49,76
Arbroath,843,3,18,8,10,74,51,23,62
Alloa,843,4,17,8,11,58,47,11,59
Stranraer,843,5,16,5,15,56,64,-8,53
East Fife,843,6,13,3,20,47,65,-18,42
Airdrieon,843,7,10,11,15,45,59,-14,41
Forfar,843,8,11,5,20,39,64,-25,38
Albion,843,9,8,6,22,58,80,-22,30
Queen's Park,843,10,6,10,20,42,76,-34,28
Raith,844,1,22,8,6,68,33,35,74
Ayr,844,2,23,4,9,91,44,47,73
Arbroath,844,3,18,8,10,72,49,23,62
Alloa,844,4,18,8,10,57,43,14,62
Stranraer,844,5,15,5,16,55,66,-11,50
East Fife,844,6,14,3,19,49,64,-15,45
Airdrieon,844,7,10,11,15,45,60,-15,41
Forfar,844,8,11,5,20,40,64,-24,38
Albion,844,9,9,6,21,59,79,-20,33
Queen's Park,844,10,6,10,20,40,74,-34,28
Ayr,845,1,24,4,8,95,44,51,76
Raith,845,2,22,8,6,68,34,34,74
Arbroath,845,3,18,8,10,71,48,23,62
Alloa,845,4,18,8,10,58,43,15,62
Stranraer,845,5,15,5,16,55,66,-11,50
East Fife,845,6,14,3,19,49,64,-15,45
Airdrieon,845,7,11,11,14,47,58,-11,44
Forfar,845,8,10,5,21,38,66,-28,35
Albion,845,9,8,6,22,59,83,-24,30
Queen's Park,845,10,6,10,20,39,73,-34,28
Ayr,846,1,23,5,8,91,43,48,74
Raith,846,2,22,8,6,68,33,35,74
Arbroath,846,3,18,8,10,72,49,23,62
Alloa,846,4,18,8,10,57,43,14,62
Stranraer,846,5,15,5,16,55,69,-14,50
East Fife,846,6,14,3,19,52,64,-12,45
Airdrieon,846,7,11,11,14,47,58,-11,44
Forfar,846,8,10,5,21,38,66,-28,35
Albion,846,9,8,7,21,58,79,-21,31
Queen's Park,846,10,6,10,20,40,74,-34,28
Raith,847,1,23,8,5,71,33,38,77
Ayr,847,2,24,4,8,95,43,52,76
Arbroath,847,3,17,8,11,71,50,21,59
Alloa,847,4,17,8,11,57,46,11,59
Stranraer,847,5,15,6,15,56,65,-9,51
East Fife,847,6,13,4,19,48,65,-17,43
Airdrieon,847,7,10,11,15,46,60,-14,41
Forfar,847,8,11,5,20,40,65,-25,38
Queen's Park,847,9,7,10,19,41,73,-32,31
Albion,847,10,8,6,22,58,83,-25,30
Ayr,848,1,24,4,8,95,44,51,76
Raith,848,2,22,8,6,69,34,35,74
Arbroath,848,3,18,8,10,73,50,23,62
Alloa,848,4,18,8,10,58,44,14,62
Stranraer,848,5,16,5,15,57,65,-8,53
Airdrieon,848,6,11,11,14,48,58,-10,44
East Fife,848,7,13,3,20,48,66,-18,42
Forfar,848,8,10,5,21,38,67,-29,35
Albion,848,9,8,6,22,59,83,-24,30
Queen's Park,848,10,6,10,20,41,75,-34,28
Ayr,849,1,24,4,8,94,42,52,76
Raith,849,2,22,8,6,68,33,35,74
Alloa,849,3,18,8,10,57,43,14,62
Arbroath,849,4,17,8,11,71,51,20,59
Stranraer,849,5,15,6,15,56,65,-9,51
East Fife,849,6,13,4,19,48,65,-17,43
Airdrieon,849,7,10,12,14,46,59,-13,42
Forfar,849,8,10,6,20,39,65,-26,36
Queen's Park,849,9,7,10,19,42,73,-31,31
Albion,849,10,8,6,22,57,82,-25,30
Ayr,850,1,24,4,8,95,45,50,76
Raith,850,2,22,8,6,68,33,35,74
Arbroath,850,3,18,8,10,74,49,25,62
Alloa,850,4,18,8,10,57,43,14,62
Stranraer,850,5,15,5,16,55,67,-12,50
East Fife,850,6,14,3,19,50,64,-14,45
Airdrieon,850,7,10,12,14,46,59,-13,42
Forfar,850,8,10,6,20,39,65,-26,36
Albion,850,9,8,6,22,60,83,-23,30
Queen's Park,850,10,6,10,20,40,76,-36,28
Raith,851,1,23,8,5,70,32,38,77
Ayr,851,2,23,5,8,91,43,48,74
Arbroath,851,3,18,8,10,75,52,23,62
Alloa,851,4,17,8,11,56,45,11,59
Stranraer,851,5,15,6,15,55,64,-9,51
East Fife,851,6,13,4,19,47,64,-17,43
Airdrieon,851,7,10,12,14,46,59,-13,42
Forfar,851,8,10,6,20,39,65,-26,36
Albion,851,9,8,7,21,58,79,-21,31
Queen's Park,851,10,6,10,20,43,77,-34,28
Ayr,852,1,24,4,8,97,42,55,76
Raith,852,2,22,8,6,68,34,34,74
Arbroath,852,3,18,8,10,74,49,25,62
Alloa,852,4,18,8,10,58,43,15,62
Stranraer,852,5,15,6,15,55,64,-9,51
East Fife,852,6,13,4,19,47,64,-17,43
Airdrieon,852,7,10,11,15,45,60,-15,41
Forfar,852,8,11,5,20,40,64,-24,38
Albion,852,9,8,6,22,57,85,-28,30
Queen's Park,852,10,6,10,20,40,76,-36,28
Ayr,853,1,24,4,8,96,42,54,76
Raith,853,2,22,9,5,69,33,36,75
Arbroath,853,3,17,9,10,71,49,22,60
Alloa,853,4,17,9,10,57,44,13,60
Stranraer,853,5,16,5,15,58,66,-8,53
East Fife,853,6,13,3,20,49,67,-18,42
Airdrieon,853,7,10,11,15,46,60,-14,41
Forfar,853,8,11,5,20,40,65,-25,38
Albion,853,9,8,6,22,57,84,-27,30
Queen's Park,853,10,6,11,19,40,73,-33,29
Raith,854,1,23,8,5,70,33,37,77
Ayr,854,2,24,4,8,97,45,52,76
Arbroath,854,3,17,9,10,71,49,22,60
Alloa,854,4,17,8,11,57,45,12,59
Stranraer,854,5,15,6,15,57,66,-9,51
East Fife,854,6,13,4,19,49,66,-17,43
Airdrieon,854,7,10,12,14,47,60,-13,42
Forfar,854,8,10,6,20,40,66,-26,36
Albion,854,9,8,6,22,60,85,-25,30
Queen's Park,854,10,6,11,19,40,73,-33,29
Raith,855,1,23,8,5,72,33,39,77
Ayr,855,2,24,4,8,93,42,51,76
Arbroath,855,3,17,9,10,72,50,22,60
Alloa,855,4,17,8,11,57,47,10,59
Stranraer,855,5,15,5,16,56,66,-10,50
East Fife,855,6,14,3,19,49,65,-16,45
Airdrieon,855,7,10,12,14,45,58,-13,42
Forfar,855,8,10,6,20,38,64,-26,36
Albion,855,9,8,6,22,57,81,-24,30
Queen's Park,855,10,6,11,19,41,74,-33,29
Raith,856,1,23,8,5,69,32,37,77
Ayr,856,2,24,4,8,93,43,50,76
Arbroath,856,3,18,8,10,72,48,24,62
Alloa,856,4,17,8,11,56,44,12,59
Stranraer,856,5,16,5,15,56,64,-8,53
Airdrieon,856,6,11,11,14,47,58,-11,44
East Fife,856,7,13,3,20,47,65,-18,42
Forfar,856,8,10,5,21,38,66,-28,35
Albion,856,9,8,6,22,58,81,-23,30
Queen's Park,856,10,6,10,20,39,74,-35,28
Ayr,857,1,24,4,8,98,43,55,76
Raith,857,2,22,9,5,69,33,36,75
Arbroath,857,3,18,8,10,76,48,28,62
Alloa,857,4,17,9,10,57,44,13,60
Stranraer,857,5,15,5,16,57,69,-12,50
East Fife,857,6,14,3,19,52,66,-14,45
Airdrieon,857,7,10,11,15,45,59,-14,41
Forfar,857,8,11,5,20,39,64,-25,38
Albion,857,9,8,6,22,58,86,-28,30
Queen's Park,857,10,6,10,20,39,78,-39,28
Ayr,858,1,24,4,8,95,45,50,76
Raith,858,2,22,8,6,70,35,35,74
Alloa,858,3,18,8,10,59,45,14,62
Arbroath,858,4,17,8,11,72,52,20,59
Stranraer,858,5,15,6,15,57,66,-9,51
East Fife,858,6,13,4,19,49,66,-17,43
Airdrieon,858,7,10,11,15,45,59,-14,41
Forfar,858,8,11,5,20,39,64,-25,38
Queen's Park,858,9,7,10,19,43,74,-31,31
Albion,858,10,8,6,22,60,83,-23,30
Ayr,859,1,24,4,8,99,45,54,76
Raith,859,2,22,8,6,68,33,35,74
Arbroath,859,3,18,8,10,73,50,23,62
Alloa,859,4,18,8,10,57,43,14,62
Stranraer,859,5,15,6,15,56,65,-9,51
East Fife,859,6,13,4,19,48,65,-17,43
Airdrieon,859,7,10,12,14,45,58,-13,42
Forfar,859,8,10,6,20,38,64,-26,36
Albion,859,9,8,6,22,60,87,-27,30
Queen's Park,859,10,6,10,20,41,75,-34,28
Ayr,860,1,24,4,8,92,42,50,76
Raith,860,2,22,8,6,68,33,35,74
Arbroath,860,3,18,8,10,71,48,23,62
Alloa,860,4,18,8,10,57,43,14,62
Stranraer,860,5,16,5,15,58,65,-7,53
Airdrieon,860,6,11,11,14,47,59,-12,44
East Fife,860,7,13,3,20,48,67,-19,42
Forfar,860,8,10,5,21,39,66,-27,35
Albion,860,9,8,6,22,57,80,-23,30
Queen's Park,860,10,6,10,20,39,73,-34,28
Raith,861,1,23,8,5,71,32,39,77
Ayr,861,2,24,4,8,92,43,49,76
Arbroath,861,3,18,8,10,71,48,23,62
Alloa,861,4,17,8,11,56,46,10,59
Stranraer,861,5,16,5,15,58,65,-7,53
Airdrieon,861,6,11,11,14,48,58,-10,44
East Fife,861,7,13,3,20,48,67,-19,42
Forfar,861,8,10,5,21,38,67,-29,35
Albion,861,9,8,6,22,58,80,-22,30
Queen's Park,861,10,6,10,20,39,73,-34,28
Raith,862,1,23,8,5,70,33,37,77
Ayr,862,2,24,4,8,95,45,50,76
Arbroath,862,3,17,8,11,70,49,21,59
Alloa,862,4,17,8,11,57,45,12,59
Stranraer,862,5,16,5,15,60,67,-7,53
Airdrieon,862,6,10,12,14,47,60,-13,42
East Fife,862,7,13,3,20,50,69,-19,42
Forfar,862,8,10,6,20,40,66,-26,36
Queen's Park,862,9,7,10,19,40,72,-32,31
Albion,862,10,8,6,22,60,83,-23,30
Raith,863,1,23,8,5,69,32,37,77
Ayr,863,2,24,4,8,92,42,50,76
Arbroath,863,3,18,8,10,74,50,24,62
Alloa,863,4,17,8,11,56,44,12,59
Stranraer,863,5,15,5,16,55,66,-11,50
East Fife,863,6,14,3,19,49,64,-15,45
Airdrieon,863,7,11,11,14,46,58,-12,44
Forfar,863,8,10,5,21,38,65,-27,35
Albion,863,9,8,6,22,57,80,-23,30
Queen's Park,863,10,6,10,20,41,76,-35,28
Raith,864,1,23,8,5,69,32,37,77
Ayr,864,2,23,5,8,91,43,48,74
Arbroath,864,3,18,8,10,73,49,24,62
Alloa,864,4,17,8,11,56,44,12,59
Stranraer,864,5,15,5,16,56,66,-10,50
East Fife,864,6,14,3,19,49,65,-16,45
Airdrieon,864,7,10,12,14,46,59,-13,42
Forfar,864,8,10,6,20,39,65,-26,36
Albion,864,9,8,7,21,58,79,-21,31
Queen's Park,864,10,6,10,20,40,75,-35,28
Raith,865,1,23,8,5,71,32,39,77
Ayr,865,2,23,5,8,91,43,48,74
Arbroath,865,3,17,8,11,71,52,19,59
Alloa,865,4,17,8,11,56,46,10,59
Stranraer,865,5,15,6,15,57,66,-9,51
Airdrieon,865,6,11,11,14,48,59,-11,44
East Fife,865,7,13,4,19,49,66,-17,43
Forfar,865,8,10,5,21,39,67,-28,35
Albion,865,9,8,7,21,58,79,-21,31
Queen's Park,865,10,7,10,19,43,73,-30,31
Raith,866,1,23,8,5,71,33,38,77
Ayr,866,2,24,4,8,94,42,52,76
Arbroath,866,3,18,8,10,74,50,24,62
Alloa,866,4,17,8,11,57,46,11,59
Stranraer,866,5,15,5,16,55,67,-12,50
East Fife,866,6,14,3,19,50,64,-14,45
Airdrieon,866,7,10,12,14,46,59,-13,42
Forfar,866,8,10,6,20,39,65,-26,36
Albion,866,9,8,6,22,57,82,-25,30
Queen's Park,866,10,6,10,20,41,76,-35,28
Ayr,867,1,24,4,8,95,43,52,76
Raith,867,2,22,8,6,69,36,33,74
Arbroath,867,3,18,8,10,75,49,26,62
Alloa,867,4,18,8,10,60,44,16,62
Stranraer,867,5,15,5,16,56,68,-12,50
East Fife,867,6,14,3,19,51,65,-14,45
Airdrieon,867,7,10,12,14,46,59,-13,42
Forfar,867,8,10,6,20,39,65,-26,36
Albion,867,9,8,6,22,58,83,-25,30
Queen's Park,867,10,6,10,20,40,77,-37,28
Raith,868,1,23,8,5,72,33,39,77
Ayr,868,2,24,4,8,97,43,54,76
Arbroath,868,3,18,8,10,73,48,25,62
Alloa,868,4,17,8,11,57,47,10,59
Stranraer,868,5,15,6,15,57,66,-9,51
Airdrieon,868,6,11,11,14,47,58,-11,44
East Fife,868,7,13,4,19,49,66,-17,43
Forfar,868,8,10,5,21,38,66,-28,35
Albion,868,9,8,6,22,58,85,-27,30
Queen's Park,868,10,6,10,20,39,75,-36,28
Ayr,869,1,24,4,8,92,42,50,76
Raith,869,2,22,9,5,68,32,36,75
Arbroath,869,3,18,8,10,74,49,25,62
Alloa,869,4,17,9,10,56,43,13,60
Stranraer,869,5,16,5,15,59,66,-7,53
Airdrieon,869,6,10,12,14,46,59,-13,42
East Fife,869,7,13,3,20,49,68,-19,42
Forfar,869,8,10,6,20,39,65,-26,36
Albion,869,9,8,6,22,57,80,-23,30
Queen's Park,869,10,6,10,20,40,76,-36,28
Ayr,870,1,24,4,8,94,45,49,76
Raith,870,2,22,8,6,69,34,35,74
Arbroath,870,3,18,8,10,74,48,26,62
Alloa,870,4,18,8,10,58,44,14,62
Stranraer,870,5,16,5,15,56,64,-8,53
Airdrieon,870,6,11,11,14,47,59,-12,44
East Fife,870,7,13,3,20,47,65,-18,42
Forfar,870,8,10,5,21,39,66,-27,35
Albion,870,9,8,6,22,60,82,-22,30
Queen's Park,870,10,6,10,20,39,76,-37,28
Raith,871,1,22,9,5,68,32,36,75
Ayr,871,2,23,5,8,90,42,48,74
Arbroath,871,3,18,8,10,72,49,23,62
Alloa,871,4,17,9,10,56,43,13,60
Stranraer,871,5,15,5,16,56,68,-12,50
East Fife,871,6,14,3,19,51,65,-14,45
Airdrieon,871,7,10,11,15,46,61,-15,41
Forfar,871,8,11,5,20,41,65,-24,38
Albion,871,9,8,7,21,57,78,-21,31
Queen's Park,871,10,6,10,20,40,74,-34,28
Ayr,872,1,24,4,8,94,43,51,76
Raith,872,2,22,9,5,69,33,36,75
Alloa,872,3,17,9,10,57,44,13,60
Arbroath,872,4,17,8,11,70,49,21,59
Stranraer,872,5,15,6,15,56,65,-9,51
Airdrieon,872,6,11,11,14,48,58,-10,44
East Fife,872,7,13,4,19,48,65,-17,43
Forfar,872,8,10,5,21,38,67,-29,35
Queen's Park,872,9,7,10,19,40,72,-32,31
Albion,872,10,8,6,22,58,82,-24,30
Ayr,873,1,24,4,8,95,42,53,76
Raith,873,2,22,9,5,70,34,36,75
Arbroath,873,3,17,9,10,71,49,22,60
Alloa,873,4,17,9,10,58,45,13,60
Stranraer,873,5,15,6,15,56,65,-9,51
Airdrieon,873,6,11,11,14,48,58,-10,44
East Fife,873,7,13,4,19,48,65,-17,43
Forfar,873,8,10,5,21,38,67,-29,35
Albion,873,9,8,6,22,57,83,-26,30
Queen's Park,873,10,6,11,19,40,73,-33,29
Ayr,874,1,24,4,8,94,44,50,76
Raith,874,2,22,8,6,69,37,32,74
Arbroath,874,3,18,8,10,72,49,23,62
Alloa,874,4,18,8,10,61,44,17,62
Stranraer,874,5,16,5,15,59,64,-5,53
East Fife,874,6,13,3,20,47,68,-21,42
Airdrieon,874,7,10,11,15,45,59,-14,41
Forfar,874,8,11,5,20,39,64,-25,38
Albion,874,9,8,6,22,59,82,-23,30
Queen's Park,874,10,6,10,20,40,74,-34,28
Ayr,875,1,24,4,8,94,44,50,76
Raith,875,2,22,8,6,69,34,35,74
Alloa,875,3,18,8,10,58,44,14,62
Arbroath,875,4,17,9,10,72,50,22,60
Stranraer,875,5,16,5,15,57,65,-8,53
Airdrieon,875,6,10,12,14,45,58,-13,42
East Fife,875,7,13,3,20,48,66,-18,42
Forfar,875,8,10,6,20,38,64,-26,36
Albion,875,9,8,6,22,59,82,-23,30
Queen's Park,875,10,6,11,19,41,74,-33,29
Ayr,876,1,24,4,8,94,43,51,76
Raith,876,2,22,8,6,68,34,34,74
Arbroath,876,3,18,8,10,72,49,23,62
Alloa,876,4,18,8,10,58,43,15,62
Stranraer,876,5,15,5,16,56,66,-10,50
East Fife,876,6,14,3,19,49,65,-16,45
Airdrieon,876,7,10,11,15,45,59,-14,41
Forfar,876,8,11,5,20,39,64,-25,38
Albion,876,9,8,6,22,58,82,-24,30
Queen's Park,876,10,6,10,20,40,74,-34,28
Raith,877,1,23,8,5,71,33,38,77
Ayr,877,2,24,4,8,97,42,55,76
Arbroath,877,3,17,8,11,71,52,19,59
Alloa,877,4,17,8,11,57,46,11,59
Stranraer,877,5,16,5,15,58,64,-6,53
Airdrieon,877,6,11,11,14,46,58,-12,44
East Fife,877,7,13,3,20,47,67,-20,42
Forfar,877,8,10,5,21,38,65,-27,35
Queen's Park,877,9,7,10,19,43,73,-30,31
Albion,877,10,8,6,22,57,85,-28,30
Ayr,878,1,24,4,8,92,42,50,76
Raith,878,2,22,9,5,68,32,36,75
Arbroath,878,3,17,9,10,70,48,22,60
Alloa,878,4,17,9,10,56,43,13,60
Stranraer,878,5,16,5,15,58,65,-7,53
Airdrieon,878,6,10,12,14,45,58,-13,42
East Fife,878,7,13,3,20,48,67,-19,42
Forfar,878,8,10,6,20,38,64,-26,36
Albion,878,9,8,6,22,57,80,-23,30
Queen's Park,878,10,6,11,19,39,72,-33,29
Raith,879,1,23,8,5,72,34,38,77
Ayr,879,2,24,4,8,91,42,49,76
Arbroath,879,3,17,8,11,73,52,21,59
Alloa,879,4,17,8,11,58,47,11,59
Stranraer,879,5,15,5,16,55,65,-10,50
East Fife,879,6,14,3,19,48,64,-16,45
Airdrieon,879,7,10,11,15,45,60,-15,41
Forfar,879,8,11,5,20,40,64,-24,38
Queen's Park,879,9,7,10,19,43,75,-32,31
Albion,879,10,8,6,22,57,79,-22,30
Raith,880,1,23,8,5,70,33,37,77
Ayr,880,2,24,4,8,95,45,50,76
Arbroath,880,3,18,8,10,71,48,23,62
Alloa,880,4,17,8,11,57,45,12,59
Stranraer,880,5,15,5,16,56,67,-11,50
East Fife,880,6,14,3,19,50,65,-15,45
Airdrieon,880,7,11,11,14,46,58,-12,44
Forfar,880,8,10,5,21,38,65,-27,35
Albion,880,9,8,6,22,60,83,-23,30
Queen's Park,880,10,6,10,20,39,73,-34,28
Ayr,881,1,24,4,8,94,43,51,76
Raith,881,2,22,8,6,69,34,35,74
Arbroath,881,3,18,8,10,71,48,23,62
Alloa,881,4,18,8,10,58,44,14,62
Stranraer,881,5,15,6,15,55,64,-9,51
East Fife,881,6,13,4,19,47,64,-17,43
Airdrieon,881,7,10,12,14,46,59,-13,42
Forfar,881,8,10,6,20,39,65,-26,36
Albion,881,9,8,6,22,58,82,-24,30
Queen's Park,881,10,6,10,20,39,73,-34,28
Raith,882,1,23,8,5,70,32,38,77
Ayr,882,2,24,4,8,92,42,50,76
Arbroath,882,3,17,9,10,71,49,22,60
Alloa,882,4,17,8,11,56,45,11,59
Stranraer,882,5,16,5,15,60,68,-8,53
East Fife,882,6,13,3,20,51,69,-18,42
Airdrieon,882,7,10,11,15,46,62,-16,41
Forfar,882,8,11,5,20,42,65,-23,38
Albion,882,9,8,6,22,57,80,-23,30
Queen's Park,882,10,6,11,19,40,73,-33,29
Raith,883,1,22,9,5,69,33,36,75
Ayr,883,2,23,4,9,90,44,46,73
Arbroath,883,3,18,8,10,74,48,26,62
Alloa,883,4,17,9,10,57,44,13,60
Stranraer,883,5,15,5,16,57,67,-10,50
East Fife,883,6,14,3,19,50,66,-16,45
Airdrieon,883,7,10,11,15,47,61,-14,41
Forfar,883,8,11,5,20,41,66,-25,38
Albion,883,9,9,6,21,59,78,-19,33
Queen's Park,883,10,6,10,20,39,76,-37,28
Raith,884,1,23,8,5,72,34,38,77
Ayr,884,2,24,4,8,93,44,49,76
Arbroath,884,3,17,8,11,72,51,21,59
Alloa,884,4,17,8,11,58,47,11,59
Stranraer,884,5,15,6,15,55,64,-9,51
East Fife,884,6,13,4,19,47,64,-17,43
Airdrieon,884,7,10,12,14,48,61,-13,42
Forfar,884,8,10,6,20,41,67,-26,36
Queen's Park,884,9,7,10,19,42,74,-32,31
Albion,884,10,8,6,22,59,81,-22,30
Raith,885,1,22,9,5,70,34,36,75
Ayr,885,2,23,4,9,92,47,45,73
Alloa,885,3,17,9,10,58,45,13,60
Arbroath,885,4,17,8,11,70,50,20,59
Stranraer,885,5,16,5,15,58,66,-8,53
Airdrieon,885,6,11,11,14,46,58,-12,44
East Fife,885,7,13,3,20,49,67,-18,42
Forfar,885,8,10,5,21,38,65,-27,35
Albion,885,9,9,6,21,62,80,-18,33
Queen's Park,885,10,7,10,19,41,72,-31,31
Raith,886,1,23,8,5,72,33,39,77
Ayr,886,2,24,4,8,97,44,53,76
Arbroath,886,3,17,8,11,70,49,21,59
Alloa,886,4,17,8,11,57,47,10,59
Stranraer,886,5,15,5,16,55,65,-10,50
East Fife,886,6,14,3,19,48,64,-16,45
Airdrieon,886,7,10,12,14,46,59,-13,42
Forfar,886,8,10,6,20,39,65,-26,36
Queen's Park,886,9,7,10,19,40,72,-32,31
Albion,886,10,8,6,22,59,85,-26,30
Raith,887,1,23,8,5,69,32,37,77
Ayr,887,2,24,4,8,98,45,53,76
Arbroath,887,3,17,8,11,70,49,21,59
Alloa,887,4,17,8,11,56,44,12,59
Stranraer,887,5,15,5,16,55,65,-10,50
East Fife,887,6,14,3,19,48,64,-16,45
Airdrieon,887,7,10,12,14,47,60,-13,42
Forfar,887,8,10,6,20,40,66,-26,36
Queen's Park,887,9,7,10,19,40,72,-32,31
Albion,887,10,8,6,22,60,86,-26,30
Ayr,888,1,24,4,8,94,44,50,76
Raith,888,2,22,8,6,70,35,35,74
Arbroath,888,3,18,8,10,72,49,23,62
Alloa,888,4,18,8,10,59,45,14,62
Stranraer,888,5,15,5,16,55,69,-14,50
East Fife,888,6,14,3,19,52,64,-12,45
Airdrieon,888,7,11,11,14,48,60,-12,44
Forfar,888,8,10,5,21,40,67,-27,35
Albion,888,9,8,6,22,59,82,-23,30
Queen's Park,888,10,6,10,20,40,74,-34,28
Ayr,889,1,24,4,8,93,42,51,76
Raith,889,2,22,9,5,69,33,36,75
Arbroath,889,3,18,8,10,73,49,24,62
Alloa,889,4,17,9,10,57,44,13,60
Stranraer,889,5,15,6,15,56,65,-9,51
Airdrieon,889,6,11,11,14,47,58,-11,44
East Fife,889,7,13,4,19,48,65,-17,43
Forfar,889,8,10,5,21,38,66,-28,35
Albion,889,9,8,6,22,57,81,-24,30
Queen's Park,889,10,6,10,20,40,75,-35,28
Ayr,890,1,24,4,8,94,45,49,76
Raith,890,2,22,8,6,68,33,35,74
Arbroath,890,3,18,8,10,75,51,24,62
Alloa,890,4,18,8,10,57,43,14,62
Stranraer,890,5,15,5,16,55,65,-10,50
East Fife,890,6,14,3,19,48,64,-16,45
Airdrieon,890,7,11,11,14,46,58,-12,44
Forfar,890,8,10,5,21,38,65,-27,35
Albion,890,9,8,6,22,60,82,-22,30
Queen's Park,890,10,6,10,20,42,77,-35,28
Raith,891,1,23,8,5,69,32,37,77
Ayr,891,2,24,4,8,95,44,51,76
Arbroath,891,3,17,8,11,70,49,21,59
Alloa,891,4,17,8,11,56,44,12,59
Stranraer,891,5,16,5,15,57,65,-8,53
East Fife,891,6,13,3,20,48,66,-18,42
Airdrieon,891,7,10,11,15,46,60,-14,41
Forfar,891,8,11,5,20,40,65,-25,38
Queen's Park,891,9,7,10,19,40,72,-32,31
Albion,891,10,8,6,22,59,83,-24,30
Raith,892,1,22,9,5,69,33,36,75
Ayr,892,2,23,4,9,90,43,47,73
Arbroath,892,3,18,8,10,74,51,23,62
Alloa,892,4,17,9,10,57,44,13,60
Stranraer,892,5,16,5,15,58,65,-7,53
East Fife,892,6,13,3,20,48,67,-19,42
Airdrieon,892,7,10,11,15,46,60,-14,41
Forfar,892,8,11,5,20,40,65,-25,38
Albion,892,9,9,6,21,58,78,-20,33
Queen's Park,892,10,6,10,20,42,76,-34,28
Raith,893,1,23,8,5,70,32,38,77
Ayr,893,2,24,4,8,95,43,52,76
Arbroath,893,3,17,9,10,71,49,22,60
Alloa,893,4,17,8,11,56,45,11,59
Stranraer,893,5,15,5,16,56,67,-11,50
East Fife,893,6,14,3,19,50,65,-15,45
Airdrieon,893,7,11,11,14,47,58,-11,44
Forfar,893,8,10,5,21,38,66,-28,35
Albion,893,9,8,6,22,58,83,-25,30
Queen's Park,893,10,6,11,19,40,73,-33,29
Raith,894,1,23,8,5,70,32,38,77
Ayr,894,2,24,4,8,91,42,49,76
Arbroath,894,3,18,8,10,73,50,23,62
Alloa,894,4,17,8,11,56,45,11,59
Stranraer,894,5,15,6,15,55,64,-9,51
East Fife,894,6,13,4,19,47,64,-17,43
Airdrieon,894,7,10,12,14,47,60,-13,42
Forfar,894,8,10,6,20,40,66,-26,36
Albion,894,9,8,6,22,57,79,-22,30
Queen's Park,894,10,6,10,20,41,75,-34,28
Raith,895,1,23,8,5,70,32,38,77
Ayr,895,2,24,4,8,93,43,50,76
Arbroath,895,3,17,9,10,71,49,22,60
Alloa,895,4,17,8,11,56,45,11,59
Stranraer,895,5,15,5,16,55,67,-12,50
East Fife,895,6,14,3,19,50,64,-14,45
Airdrieon,895,7,11,11,14,48,58,-10,44
Forfar,895,8,10,5,21,38,67,-29,35
Albion,895,9,8,6,22,58,81,-23,30
Queen's Park,895,10,6,11,19,40,73,-33,29
Ayr,896,1,24,4,8,92,43,49,76
Raith,896,2,22,8,6,68,33,35,74
Arbroath,896,3,18,8,10,73,50,23,62
Alloa,896,4,18,8,10,57,43,14,62
Stranraer,896,5,15,5,16,56,67,-11,50
East Fife,896,6,14,3,19,50,65,-15,45
Airdrieon,896,7,11,11,14,47,58,-11,44
Forfar,896,8,10,5,21,38,66,-28,35
Albion,896,9,8,6,22,58,80,-22,30
Queen's Park,896,10,6,10,20,41,75,-34,28
Ayr,897,1,24,4,8,94,44,50,76
Raith,897,2,22,9,5,69,33,36,75
Arbroath,897,3,18,8,10,72,49,23,62
Alloa,897,4,17,9,10,57,44,13,60
Stranraer,897,5,15,5,16,55,67,-12,50
East Fife,897,6,14,3,19,50,64,-14,45
Airdrieon,897,7,11,11,14,47,59,-12,44
Forfar,897,8,10,5,21,39,66,-27,35
Albion,897,9,8,6,22,59,82,-23,30
Queen's Park,897,10,6,10,20,40,74,-34,28
Raith,898,1,23,8,5,71,33,38,77
Ayr,898,2,24,4,8,97,43,54,76
Arbroath,898,3,18,8,10,72,48,24,62
Alloa,898,4,17,8,11,57,46,11,59
Stranraer,898,5,15,6,15,56,65,-9,51
East Fife,898,6,13,4,19,48,65,-17,43
Airdrieon,898,7,10,12,14,47,60,-13,42
Forfar,898,8,10,6,20,40,66,-26,36
Albion,898,9,8,6,22,58,85,-27,30
Queen's Park,898,10,6,10,20,39,74,-35,28
Ayr,899,1,24,4,8,95,44,51,76
Raith,899,2,22,8,6,69,34,35,74
Arbroath,899,3,18,8,10,73,50,23,62
Alloa,899,4,18,8,10,58,44,14,62
Stranraer,899,5,15,6,15,56,65,-9,51
East Fife,899,6,13,4,19,48,65,-17,43
Airdrieon,899,7,10,11,15,45,59,-14,41
Forfar,899,8,11,5,20,39,64,-25,38
Albion,899,9,8,6,22,59,83,-24,30
Queen's Park,899,10,6,10,20,41,75,-34,28
Raith,900,1,23,8,5,69,32,37,77
Ayr,900,2,23,5,8,90,42,48,74
Arbroath,900,3,17,9,10,72,50,22,60
Alloa,900,4,17,8,11,56,44,12,59
Stranraer,900,5,15,5,16,56,67,-11,50
East Fife,900,6,14,3,19,50,65,-15,45
Airdrieon,900,7,10,11,15,45,60,-15,41
Forfar,900,8,11,5,20,40,64,-24,38
Albion,900,9,8,7,21,57,78,-21,31
Queen's Park,900,10,6,11,19,41,74,-33,29
Raith,901,1,23,8,5,72,32,40,77
Ayr,901,2,24,4,8,94,42,52,76
Arbroath,901,3,17,9,10,70,48,22,60
Alloa,901,4,17,8,11,56,47,9,59
Stranraer,901,5,15,5,16,56,67,-11,50
East Fife,901,6,14,3,19,50,65,-15,45
Airdrieon,901,7,10,11,15,45,60,-15,41
Forfar,901,8,11,5,20,40,64,-24,38
Albion,901,9,8,6,22,57,82,-25,30
Queen's Park,901,10,6,11,19,39,72,-33,29
Ayr,902,1,24,4,8,97,44,53,76
Raith,902,2,22,8,6,68,33,35,74
Alloa,902,3,18,8,10,57,43,14,62
Arbroath,902,4,17,8,11,71,51,20,59
Stranraer,902,5,15,6,15,55,64,-9,51
Airdrieon,902,6,11,11,14,48,58,-10,44
East Fife,902,7,13,4,19,47,64,-17,43
Forfar,902,8,10,5,21,38,67,-29,35
Queen's Park,902,9,7,10,19,42,73,-31,31
Albion,902,10,8,6,22,59,85,-26,30
Raith,903,1,23,8,5,72,32,40,77
Ayr,903,2,24,4,8,92,42,50,76
Arbroath,903,3,17,8,11,71,50,21,59
Alloa,903,4,17,8,11,56,47,9,59
Stranraer,903,5,15,5,16,56,67,-11,50
East Fife,903,6,14,3,19,50,65,-15,45
Airdrieon,903,7,11,11,14,46,58,-12,44
Forfar,903,8,10,5,21,38,65,-27,35
Queen's Park,903,9,7,10,19,41,73,-32,31
Albion,903,10,8,6,22,57,80,-23,30
Ayr,904,1,24,4,8,92,43,49,76
Raith,904,2,22,9,5,68,32,36,75
Alloa,904,3,17,9,10,56,43,13,60
Arbroath,904,4,17,8,11,71,51,20,59
Stranraer,904,5,15,5,16,57,68,-11,50
East Fife,904,6,14,3,19,51,66,-15,45
Airdrieon,904,7,10,11,15,46,60,-14,41
Forfar,904,8,11,5,20,40,65,-25,38
Queen's Park,904,9,7,10,19,42,73,-31,31
Albion,904,10,8,6,22,58,80,-22,30
Raith,905,1,23,8,5,69,32,37,77
Ayr,905,2,24,4,8,91,42,49,76
Arbroath,905,3,18,8,10,71,48,23,62
Alloa,905,4,17,8,11,56,44,12,59
Stranraer,905,5,15,6,15,56,65,-9,51
Airdrieon,905,6,11,11,14,49,59,-10,44
East Fife,905,7,13,4,19,48,65,-17,43
Forfar,905,8,10,5,21,39,68,-29,35
Albion,905,9,8,6,22,57,79,-22,30
Queen's Park,905,10,6,10,20,39,73,-34,28
Raith,906,1,23,8,5,71,33,38,77
Ayr,906,2,23,4,9,90,45,45,73
Arbroath,906,3,18,8,10,73,49,24,62
Alloa,906,4,17,8,11,57,46,11,59
Stranraer,906,5,15,5,16,55,66,-11,50
East Fife,906,6,14,3,19,49,64,-15,45
Airdrieon,906,7,11,11,14,48,59,-11,44
Forfar,906,8,10,5,21,39,67,-28,35
Albion,906,9,9,6,21,60,78,-18,33
Queen's Park,906,10,6,10,20,40,75,-35,28
Raith,907,1,23,8,5,72,33,39,77
Ayr,907,2,23,5,8,91,43,48,74
Arbroath,907,3,18,8,10,72,49,23,62
Alloa,907,4,17,8,11,57,47,10,59
Stranraer,907,5,15,5,16,57,69,-12,50
East Fife,907,6,14,3,19,52,66,-14,45
Airdrieon,907,7,11,11,14,48,58,-10,44
Forfar,907,8,10,5,21,38,67,-29,35
Albion,907,9,8,7,21,58,79,-21,31
Queen's Park,907,10,6,10,20,40,74,-34,28
Raith,908,1,23,8,5,71,33,38,77
Ayr,908,2,24,4,8,91,42,49,76
Arbroath,908,3,18,8,10,73,48,25,62
Alloa,908,4,17,8,11,57,46,11,59
Stranraer,908,5,16,5,15,57,65,-8,53
East Fife,908,6,13,3,20,48,66,-18,42
Airdrieon,908,7,10,11,15,46,61,-15,41
Forfar,908,8,11,5,20,41,65,-24,38
Albion,908,9,8,6,22,57,79,-22,30
Queen's Park,908,10,6,10,20,39,75,-36,28
Ayr,909,1,24,4,8,95,42,53,76
Raith,909,2,22,8,6,69,34,35,74
Alloa,909,3,18,8,10,58,44,14,62
Arbroath,909,4,17,9,10,72,50,22,60
Stranraer,909,5,15,5,16,56,66,-10,50
East Fife,909,6,14,3,19,49,65,-16,45
Airdrieon,909,7,11,11,14,48,60,-12,44
Forfar,909,8,10,5,21,40,67,-27,35
Albion,909,9,8,6,22,57,83,-26,30
Queen's Park,909,10,6,11,19,41,74,-33,29
Ayr,910,1,23,5,8,92,44,48,74
Raith,910,2,22,8,6,68,33,35,74
Alloa,910,3,18,8,10,57,43,14,62
Arbroath,910,4,17,9,10,72,50,22,60
Stranraer,910,5,15,5,16,57,67,-10,50
East Fife,910,6,14,3,19,50,66,-16,45
Airdrieon,910,7,11,11,14,47,59,-12,44
Forfar,910,8,10,5,21,39,66,-27,35
Albion,910,9,8,7,21,59,80,-21,31
Queen's Park,910,10,6,11,19,41,74,-33,29
Ayr,911,1,24,4,8,95,43,52,76
Raith,911,2,22,9,5,69,33,36,75
Arbroath,911,3,18,8,10,77,51,26,62
Alloa,911,4,17,9,10,57,44,13,60
Stranraer,911,5,15,6,15,56,65,-9,51
East Fife,911,6,13,4,19,48,65,-17,43
Airdrieon,911,7,10,11,15,45,59,-14,41
Forfar,911,8,11,5,20,39,64,-25,38
Albion,911,9,8,6,22,58,83,-25,30
Queen's Park,911,10,6,10,20,42,79,-37,28
Raith,912,1,23,8,5,70,33,37,77
Ayr,912,2,23,4,9,91,45,46,73
Arbroath,912,3,18,8,10,74,48,26,62
Alloa,912,4,17,8,11,57,45,12,59
Stranraer,912,5,15,5,16,57,67,-10,50
East Fife,912,6,14,3,19,50,66,-16,45
Airdrieon,912,7,11,11,14,47,58,-11,44
Forfar,912,8,10,5,21,38,66,-28,35
Albion,912,9,9,6,21,60,79,-19,33
Queen's Park,912,10,6,10,20,39,76,-37,28
Ayr,913,1,24,4,8,95,42,53,76
Raith,913,2,22,9,5,69,33,36,75
Alloa,913,3,17,9,10,57,44,13,60
Arbroath,913,4,17,8,11,70,49,21,59
Stranraer,913,5,15,5,16,58,71,-13,50
East Fife,913,6,14,3,19,54,67,-13,45
Airdrieon,913,7,11,11,14,48,58,-10,44
Forfar,913,8,10,5,21,38,67,-29,35
Queen's Park,913,9,7,10,19,40,72,-32,31
Albion,913,10,8,6,22,57,83,-26,30
Raith,914,1,23,8,5,69,32,37,77
Ayr,914,2,24,4,8,96,42,54,76
Arbroath,914,3,17,9,10,72,50,22,60
Alloa,914,4,17,8,11,56,44,12,59
Stranraer,914,5,15,5,16,56,66,-10,50
East Fife,914,6,14,3,19,49,65,-16,45
Airdrieon,914,7,10,11,15,46,60,-14,41
Forfar,914,8,11,5,20,40,65,-25,38
Albion,914,9,8,6,22,57,84,-27,30
Queen's Park,914,10,6,11,19,41,74,-33,29
Raith,915,1,23,8,5,70,32,38,77
Ayr,915,2,24,4,8,95,44,51,76
Arbroath,915,3,18,8,10,72,49,23,62
Alloa,915,4,17,8,11,56,45,11,59
Stranraer,915,5,15,6,15,57,66,-9,51
Airdrieon,915,6,11,11,14,48,58,-10,44
East Fife,915,7,13,4,19,49,66,-17,43
Forfar,915,8,10,5,21,38,67,-29,35
Albion,915,9,8,6,22,59,83,-24,30
Queen's Park,915,10,6,10,20,40,74,-34,28
Raith,916,1,23,8,5,69,32,37,77
Ayr,916,2,24,4,8,95,44,51,76
Arbroath,916,3,18,8,10,73,49,24,62
Alloa,916,4,17,8,11,56,44,12,59
Stranraer,916,5,15,5,16,56,66,-10,50
East Fife,916,6,14,3,19,49,65,-16,45
Airdrieon,916,7,11,11,14,49,58,-9,44
Forfar,916,8,10,5,21,38,68,-30,35
Albion,916,9,8,6,22,59,83,-24,30
Queen's Park,916,10,6,10,20,40,75,-35,28
Raith,917,1,23,8,5,71,33,38,77
Ayr,917,2,24,4,8,92,43,49,76
Arbroath,917,3,18,8,10,72,48,24,62
Alloa,917,4,17,8,11,57,46,11,59
Stranraer,917,5,15,6,15,55,64,-9,51
East Fife,917,6,13,4,19,47,64,-17,43
Airdrieon,917,7,10,11,15,45,61,-16,41
Forfar,917,8,11,5,20,41,64,-23,38
Albion,917,9,8,6,22,58,80,-22,30
Queen's Park,917,10,6,10,20,39,74,-35,28
Raith,918,1,23,8,5,70,32,38,77
Ayr,918,2,24,4,8,92,43,49,76
Arbroath,918,3,17,9,10,72,50,22,60
Alloa,918,4,17,8,11,56,45,11,59
Stranraer,918,5,16,5,15,56,64,-8,53
East Fife,918,6,13,3,20,47,65,-18,42
Airdrieon,918,7,10,11,15,48,63,-15,41
Forfar,918,8,11,5,20,43,67,-24,38
Albion,918,9,8,6,22,58,80,-22,30
Queen's Park,918,10,6,11,19,41,74,-33,29
Raith,919,1,22,8,6,68,33,35,74
Ayr,919,2,23,4,9,92,45,47,73
Alloa,919,3,18,8,10,57,43,14,62
Arbroath,919,4,17,9,10,71,49,22,60
Stranraer,919,5,15,5,16,56,66,-10,50
East Fife,919,6,14,3,19,49,65,-16,45
Airdrieon,919,7,11,11,14,48,59,-11,44
Forfar,919,8,10,5,21,39,67,-28,35
Albion,919,9,9,6,21,60,80,-20,33
Queen's Park,919,10,6,11,19,40,73,-33,29
Raith,920,1,23,8,5,72,34,38,77
Ayr,920,2,24,4,8,99,43,56,76
Arbroath,920,3,18,8,10,71,48,23,62
Alloa,920,4,17,8,11,58,47,11,59
Stranraer,920,5,15,5,16,57,69,-12,50
East Fife,920,6,14,3,19,52,66,-14,45
Airdrieon,920,7,11,11,14,46,58,-12,44
Forfar,920,8,10,5,21,38,65,-27,35
Albion,920,9,8,6,22,58,87,-29,30
Queen's Park,920,10,6,10,20,39,73,-34,28
Ayr,921,1,24,4,8,92,43,49,76
Raith,921,2,22,8,6,68,34,34,74
Alloa,921,3,18,8,10,58,43,15,62
Arbroath,921,4,17,8,11,71,51,20,59
Stranraer,921,5,16,5,15,57,65,-8,53
East Fife,921,6,13,3,20,48,66,-18,42
Airdrieon,921,7,10,11,15,46,60,-14,41
Forfar,921,8,11,5,20,40,65,-25,38
Queen's Park,921,9,7,10,19,42,73,-31,31
Albion,921,10,8,6,22,58,80,-22,30
Raith,922,1,23,8,5,69,32,37,77
Ayr,922,2,24,4,8,93,43,50,76
Arbroath,922,3,17,9,10,72,50,22,60
Alloa,922,4,17,8,11,56,44,12,59
Stranraer,922,5,15,5,16,55,65,-10,50
East Fife,922,6,14,3,19,48,64,-16,45
Airdrieon,922,7,11,11,14,46,58,-12,44
Forfar,922,8,10,5,21,38,65,-27,35
Albion,922,9,8,6,22,58,81,-23,30
Queen's Park,922,10,6,11,19,41,74,-33,29
Ayr,923,1,24,4,8,94,44,50,76
Raith,923,2,22,8,6,68,33,35,74
Arbroath,923,3,18,8,10,73,48,25,62
Alloa,923,4,18,8,10,57,43,14,62
Stranraer,923,5,15,6,15,57,66,-9,51
Airdrieon,923,6,11,11,14,47,59,-12,44
East Fife,923,7,13,4,19,49,66,-17,43
Forfar,923,8,10,5,21,39,66,-27,35
Albion,923,9,8,6,22,59,82,-23,30
Queen's Park,923,10,6,10,20,39,75,-36,28
Raith,924,1,23,8,5,70,33,37,77
Ayr,924,2,24,4,8,93,44,49,76
Arbroath,924,3,17,9,10,72,50,22,60
Alloa,924,4,17,8,11,57,45,12,59
Stranraer,924,5,15,5,16,57,68,-11,50
East Fife,924,6,14,3,19,51,66,-15,45
Airdrieon,924,7,11,11,14,46,58,-12,44
Forfar,924,8,10,5,21,38,65,-27,35
Albion,924,9,8,6,22,59,81,-22,30
Queen's Park,924,10,6,11,19,41,74,-33,29
Ayr,925,1,24,4,8,94,45,49,76
Raith,925,2,22,9,5,68,32,36,75
Arbroath,925,3,17,9,10,72,50,22,60
Alloa,925,4,17,9,10,56,43,13,60
Stranraer,925,5,15,5,16,55,65,-10,50
East Fife,925,6,14,3,19,48,64,-16,45
Airdrieon,925,7,11,11,14,48,59,-11,44
Forfar,925,8,10,5,21,39,67,-28,35
Albion,925,9,8,6,22,60,82,-22,30
Queen's Park,925,10,6,11,19,41,74,-33,29
Raith,926,1,23,8,5,70,33,37,77
Ayr,926,2,24,4,8,93,43,50,76
Arbroath,926,3,18,8,10,76,49,27,62
Alloa,926,4,17,8,11,57,45,12,59
Stranraer,926,5,15,5,16,56,66,-10,50
East Fife,926,6,14,3,19,49,65,-16,45
Airdrieon,926,7,11,11,14,46,58,-12,44
Forfar,926,8,10,5,21,38,65,-27,35
Albion,926,9,8,6,22,58,81,-23,30
Queen's Park,926,10,6,10,20,40,78,-38,28
Raith,927,1,23,8,5,69,32,37,77
Ayr,927,2,24,4,8,93,43,50,76
Arbroath,927,3,18,8,10,74,49,25,62
Alloa,927,4,17,8,11,56,44,12,59
Stranraer,927,5,16,5,15,56,64,-8,53
East Fife,927,6,13,3,20,47,65,-18,42
Airdrieon,927,7,10,11,15,46,61,-15,41
Forfar,927,8,11,5,20,41,65,-24,38
Albion,927,9,8,6,22,58,81,-23,30
Queen's Park,927,10,6,10,20,40,76,-36,28
Raith,928,1,23,8,5,71,33,38,77
Ayr,928,2,23,5,8,92,44,48,74
Arbroath,928,3,17,9,10,70,48,22,60
Alloa,928,4,17,8,11,57,46,11,59
Stranraer,928,5,15,5,16,55,65,-10,50
East Fife,928,6,14,3,19,48,64,-16,45
Airdrieon,928,7,11,11,14,47,58,-11,44
Forfar,928,8,10,5,21,38,66,-28,35
Albion,928,9,8,7,21,59,80,-21,31
Queen's Park,928,10,6,11,19,39,72,-33,29
Raith,929,1,23,8,5,70,32,38,77
Ayr,929,2,24,4,8,92,42,50,76
Arbroath,929,3,17,9,10,71,49,22,60
Alloa,929,4,17,8,11,56,45,11,59
Stranraer,929,5,15,6,15,57,66,-9,51
East Fife,929,6,13,4,19,49,66,-17,43
Airdrieon,929,7,10,12,14,47,60,-13,42
Forfar,929,8,10,6,20,40,66,-26,36
Albion,929,9,8,6,22,57,80,-23,30
Queen's Park,929,10,6,11,19,40,73,-33,29
Ayr,930,1,24,4,8,98,43,55,76
Raith,930,2,22,8,6,69,34,35,74
Arbroath,930,3,18,8,10,71,48,23,62
Alloa,930,4,18,8,10,58,44,14,62
Stranraer,930,5,15,6,15,55,64,-9,51
Airdrieon,930,6,11,11,14,48,58,-10,44
East Fife,930,7,13,4,19,47,64,-17,43
Forfar,930,8,10,5,21,38,67,-29,35
Albion,930,9,8,6,22,58,86,-28,30
Queen's Park,930,10,6,10,20,39,73,-34,28
Raith,931,1,23,8,5,69,32,37,77
Ayr,931,2,24,4,8,96,43,53,76
Arbroath,931,3,17,9,10,72,50,22,60
Alloa,931,4,17,8,11,56,44,12,59
Stranraer,931,5,15,5,16,56,67,-11,50
East Fife,931,6,14,3,19,50,65,-15,45
Airdrieon,931,7,11,11,14,46,58,-12,44
Forfar,931,8,10,5,21,38,65,-27,35
Albion,931,9,8,6,22,58,84,-26,30
Queen's Park,931,10,6,11,19,41,74,-33,29
Ayr,932,1,24,4,8,93,44,49,76
Raith,932,2,22,9,5,69,33,36,75
Arbroath,932,3,18,8,10,72,48,24,62
Alloa,932,4,17,9,10,57,44,13,60
Stranraer,932,5,16,5,15,59,65,-6,53
Airdrieon,932,6,10,12,14,46,59,-13,42
East Fife,932,7,13,3,20,48,68,-20,42
Forfar,932,8,10,6,20,39,65,-26,36
Albion,932,9,8,6,22,59,81,-22,30
Queen's Park,932,10,6,10,20,39,74,-35,28
Ayr,933,1,24,4,8,96,42,54,76
Raith,933,2,22,9,5,69,33,36,75
Arbroath,933,3,17,9,10,71,49,22,60
Alloa,933,4,17,9,10,57,44,13,60
Stranraer,933,5,15,5,16,57,67,-10,50
East Fife,933,6,14,3,19,50,66,-16,45
Airdrieon,933,7,10,12,14,46,59,-13,42
Forfar,933,8,10,6,20,39,65,-26,36
Albion,933,9,8,6,22,57,84,-27,30
Queen's Park,933,10,6,11,19,40,73,-33,29
Raith,934,1,23,8,5,70,33,37,77
Ayr,934,2,24,4,8,93,42,51,76
Arbroath,934,3,18,8,10,71,48,23,62
Alloa,934,4,17,8,11,57,45,12,59
Stranraer,934,5,15,6,15,56,65,-9,51
East Fife,934,6,13,4,19,48,65,-17,43
Airdrieon,934,7,10,11,15,45,59,-14,41
Forfar,934,8,11,5,20,39,64,-25,38
Albion,934,9,8,6,22,57,81,-24,30
Queen's Park,934,10,6,10,20,39,73,-34,28
Raith,935,1,23,8,5,71,33,38,77
Ayr,935,2,24,4,8,97,43,54,76
Arbroath,935,3,17,9,10,71,49,22,60
Alloa,935,4,17,8,11,57,46,11,59
Stranraer,935,5,15,5,16,55,67,-12,50
East Fife,935,6,14,3,19,50,64,-14,45
Airdrieon,935,7,10,11,15,45,59,-14,41
Forfar,935,8,11,5,20,39,64,-25,38
Albion,935,9,8,6,22,58,85,-27,30
Queen's Park,935,10,6,11,19,40,73,-33,29
Raith,936,1,23,8,5,70,32,38,77
Ayr,936,2,24,4,8,91,42,49,76
Arbroath,936,3,18,8,10,71,48,23,62
Alloa,936,4,17,8,11,56,45,11,59
Stranraer,936,5,15,6,15,56,65,-9,51
Airdrieon,936,6,11,11,14,49,59,-10,44
East Fife,936,7,13,4,19,48,65,-17,43
Forfar,936,8,10,5,21,39,68,-29,35
Albion,936,9,8,6,22,57,79,-22,30
Queen's Park,936,10,6,10,20,39,73,-34,28
Raith,937,1,22,8,6,68,33,35,74
Ayr,937,2,23,4,9,91,44,47,73
Alloa,937,3,18,8,10,57,43,14,62
Arbroath,937,4,17,8,11,71,53,18,59
Stranraer,937,5,16,5,15,60,66,-6,53
Airdrieon,937,6,11,11,14,48,58,-10,44
East Fife,937,7,13,3,20,49,69,-20,42
Forfar,937,8,10,5,21,38,67,-29,35
Albion,937,9,9,6,21,59,79,-20,33
Queen's Park,937,10,7,10,19,44,73,-29,31
Ayr,938,1,24,4,8,93,42,51,76
Raith,938,2,22,8,6,68,33,35,74
Alloa,938,3,18,8,10,57,43,14,62
Arbroath,938,4,17,8,11,71,50,21,59
Stranraer,938,5,16,5,15,58,64,-6,53
East Fife,938,6,13,3,20,47,67,-20,42
Airdrieon,938,7,10,11,15,46,60,-14,41
Forfar,938,8,11,5,20,40,65,-25,38
Queen's Park,938,9,7,10,19,41,73,-32,31
Albion,938,10,8,6,22,57,81,-24,30
Raith,939,1,23,8,5,72,33,39,77
Ayr,939,2,24,4,8,93,44,49,76
Arbroath,939,3,18,8,10,72,48,24,62
Alloa,939,4,17,8,11,57,47,10,59
Stranraer,939,5,15,5,16,55,65,-10,50
East Fife,939,6,14,3,19,48,64,-16,45
Airdrieon,939,7,11,11,14,47,59,-12,44
Forfar,939,8,10,5,21,39,66,-27,35
Albion,939,9,8,6,22,59,81,-22,30
Queen's Park,939,10,6,10,20,39,74,-35,28
Raith,940,1,23,8,5,70,32,38,77
Ayr,940,2,24,4,8,95,43,52,76
Arbroath,940,3,17,9,10,74,52,22,60
Alloa,940,4,17,8,11,56,45,11,59
Stranraer,940,5,15,6,15,57,66,-9,51
East Fife,940,6,13,4,19,49,66,-17,43
Airdrieon,940,7,10,11,15,45,59,-14,41
Forfar,940,8,11,5,20,39,64,-25,38
Albion,940,9,8,6,22,58,83,-25,30
Queen's Park,940,10,6,11,19,43,76,-33,29
Raith,941,1,23,8,5,69,32,37,77
Ayr,941,2,24,4,8,92,42,50,76
Arbroath,941,3,17,8,11,70,49,21,59
Alloa,941,4,17,8,11,56,44,12,59
Stranraer,941,5,15,6,15,57,66,-9,51
East Fife,941,6,13,4,19,49,66,-17,43
Airdrieon,941,7,10,12,14,46,59,-13,42
Forfar,941,8,10,6,20,39,65,-26,36
Queen's Park,941,9,7,10,19,40,72,-32,31
Albion,941,10,8,6,22,57,80,-23,30
Raith,942,1,23,8,5,71,32,39,77
Ayr,942,2,24,4,8,93,42,51,76
Arbroath,942,3,18,8,10,73,49,24,62
Alloa,942,4,17,8,11,56,46,10,59
Stranraer,942,5,15,5,16,55,66,-11,50
East Fife,942,6,14,3,19,49,64,-15,45
Airdrieon,942,7,10,12,14,46,59,-13,42
Forfar,942,8,10,6,20,39,65,-26,36
Albion,942,9,8,6,22,57,81,-24,30
Queen's Park,942,10,6,10,20,40,75,-35,28
Ayr,943,1,24,4,8,96,42,54,76
Raith,943,2,22,8,6,69,35,34,74
Arbroath,943,3,18,8,10,74,50,24,62
Alloa,943,4,18,8,10,59,44,15,62
Stranraer,943,5,16,5,15,56,64,-8,53
Airdrieon,943,6,10,12,14,46,59,-13,42
East Fife,943,7,13,3,20,47,65,-18,42
Forfar,943,8,10,6,20,39,65,-26,36
Albion,943,9,8,6,22,57,84,-27,30
Queen's Park,943,10,6,10,20,41,76,-35,28
Raith,944,1,23,8,5,69,32,37,77
Ayr,944,2,24,4,8,91,42,49,76
Arbroath,944,3,18,8,10,74,49,25,62
Alloa,944,4,17,8,11,56,44,12,59
Stranraer,944,5,15,5,16,57,67,-10,50
East Fife,944,6,14,3,19,50,66,-16,45
Airdrieon,944,7,11,11,14,47,58,-11,44
Forfar,944,8,10,5,21,38,66,-28,35
Albion,944,9,8,6,22,57,79,-22,30
Queen's Park,944,10,6,10,20,40,76,-36,28
Raith,945,1,23,8,5,70,32,38,77
Ayr,945,2,24,4,8,96,44,52,76
Arbroath,945,3,18,8,10,71,48,23,62
Alloa,945,4,17,8,11,56,45,11,59
Stranraer,945,5,15,5,16,56,66,-10,50
East Fife,945,6,14,3,19,49,65,-16,45
Airdrieon,945,7,10,12,14,45,58,-13,42
Forfar,945,8,10,6,20,38,64,-26,36
Albion,945,9,8,6,22,59,84,-25,30
Queen's Park,945,10,6,10,20,39,73,-34,28
Ayr,946,1,24,4,8,92,42,50,76
Raith,946,2,22,9,5,69,33,36,75
Arbroath,946,3,18,8,10,72,48,24,62
Alloa,946,4,17,9,10,57,44,13,60
Stranraer,946,5,15,5,16,56,68,-12,50
East Fife,946,6,14,3,19,51,65,-14,45
Airdrieon,946,7,10,12,14,45,58,-13,42
Forfar,946,8,10,6,20,38,64,-26,36
Albion,946,9,8,6,22,57,80,-23,30
Queen's Park,946,10,6,10,20,39,74,-35,28
Ayr,947,1,24,4,8,95,44,51,76
Raith,947,2,22,8,6,68,33,35,74
Alloa,947,3,18,8,10,57,43,14,62
Arbroath,947,4,17,9,10,71,49,22,60
Stranraer,947,5,15,5,16,55,66,-11,50
East Fife,947,6,14,3,19,49,64,-15,45
Airdrieon,947,7,11,11,14,46,58,-12,44
Forfar,947,8,10,5,21,38,65,-27,35
Albion,947,9,8,6,22,59,83,-24,30
Queen's Park,947,10,6,11,19,40,73,-33,29
Ayr,948,1,24,4,8,92,43,49,76
Raith,948,2,22,8,6,68,33,35,74
Arbroath,948,3,18,8,10,72,49,23,62
Alloa,948,4,18,8,10,57,43,14,62
Stranraer,948,5,15,5,16,55,67,-12,50
East Fife,948,6,14,3,19,50,64,-14,45
Airdrieon,948,7,11,11,14,49,61,-12,44
Forfar,948,8,10,5,21,41,68,-27,35
Albion,948,9,8,6,22,58,80,-22,30
Queen's Park,948,10,6,10,20,40,74,-34,28
Ayr,949,1,24,4,8,94,42,52,76
Raith,949,2,22,9,5,70,34,36,75
Arbroath,949,3,18,8,10,72,48,24,62
Alloa,949,4,17,9,10,58,45,13,60
Stranraer,949,5,16,5,15,57,65,-8,53
Airdrieon,949,6,10,12,14,46,59,-13,42
East Fife,949,7,13,3,20,48,66,-18,42
Forfar,949,8,10,6,20,39,65,-26,36
Albion,949,9,8,6,22,57,82,-25,30
Queen's Park,949,10,6,10,20,39,74,-35,28
Raith,950,1,23,8,5,70,33,37,77
Ayr,950,2,24,4,8,93,42,51,76
Arbroath,950,3,18,8,10,73,49,24,62
Alloa,950,4,17,8,11,57,45,12,59
Stranraer,950,5,16,5,15,59,65,-6,53
Airdrieon,950,6,10,12,14,46,59,-13,42
East Fife,950,7,13,3,20,48,68,-20,42
Forfar,950,8,10,6,20,39,65,-26,36
Albion,950,9,8,6,22,57,81,-24,30
Queen's Park,950,10,6,10,20,40,75,-35,28
Raith,951,1,23,8,5,71,34,37,77
Ayr,951,2,24,4,8,96,43,53,76
Arbroath,951,3,17,8,11,70,49,21,59
Alloa,951,4,17,8,11,58,46,12,59
Stranraer,951,5,15,5,16,56,67,-11,50
East Fife,951,6,14,3,19,50,65,-15,45
Airdrieon,951,7,11,11,14,48,58,-10,44
Forfar,951,8,10,5,21,38,67,-29,35
Queen's Park,951,9,7,10,19,40,72,-32,31
Albion,951,10,8,6,22,58,84,-26,30
Ayr,952,1,24,4,8,94,43,51,76
Raith,952,2,22,9,5,68,32,36,75
Arbroath,952,3,18,8,10,73,48,25,62
Alloa,952,4,17,9,10,56,43,13,60
Stranraer,952,5,15,5,16,58,68,-10,50
East Fife,952,6,14,3,19,51,67,-16,45
Airdrieon,952,7,11,11,14,46,58,-12,44
Forfar,952,8,10,5,21,38,65,-27,35
Albion,952,9,8,6,22,58,82,-24,30
Queen's Park,952,10,6,10,20,39,75,-36,28
Ayr,953,1,24,4,8,92,43,49,76
Raith,953,2,22,9,5,69,33,36,75
Arbroath,953,3,17,9,10,71,49,22,60
Alloa,953,4,17,9,10,57,44,13,60
Stranraer,953,5,15,5,16,55,65,-10,50
East Fife,953,6,14,3,19,48,64,-16,45
Airdrieon,953,7,10,12,14,46,59,-13,42
Forfar,953,8,10,6,20,39,65,-26,36
Albion,953,9,8,6,22,58,80,-22,30
Queen's Park,953,10,6,11,19,40,73,-33,29
Ayr,954,1,24,4,8,92,42,50,76
Raith,954,2,22,8,6,68,33,35,74
Arbroath,954,3,18,8,10,73,50,23,62
Alloa,954,4,18,8,10,57,43,14,62
Stranraer,954,5,16,5,15,57,65,-8,53
Airdrieon,954,6,11,11,14,47,58,-11,44
East Fife,954,7,13,3,20,48,66,-18,42
Forfar,954,8,10,5,21,38,66,-28,35
Albion,954,9,8,6,22,57,80,-23,30
Queen's Park,954,10,6,10,20,41,75,-34,28
Ayr,955,1,24,4,8,96,44,52,76
Raith,955,2,22,8,6,71,37,34,74
Arbroath,955,3,18,8,10,72,49,23,62
Alloa,955,4,18,8,10,61,46,15,62
Stranraer,955,5,15,5,16,56,67,-11,50
East Fife,955,6,14,3,19,50,65,-15,45
Airdrieon,955,7,11,11,14,50,58,-8,44
Forfar,955,8,10,5,21,38,69,-31,35
Albion,955,9,8,6,22,59,84,-25,30
Queen's Park,955,10,6,10,20,40,74,-34,28
Raith,956,1,23,8,5,70,32,38,77
Ayr,956,2,24,4,8,93,42,51,76
Arbroath,956,3,17,8,11,71,50,21,59
Alloa,956,4,17,8,11,56,45,11,59
Stranraer,956,5,16,5,15,57,64,-7,53
Airdrieon,956,6,10,12,14,46,59,-13,42
East Fife,956,7,13,3,20,47,66,-19,42
Forfar,956,8,10,6,20,39,65,-26,36
Queen's Park,956,9,7,10,19,41,73,-32,31
Albion,956,10,8,6,22,57,81,-24,30
Raith,957,1,23,8,5,70,33,37,77
Ayr,957,2,23,5,8,93,45,48,74
Arbroath,957,3,17,8,11,70,52,18,59
Alloa,957,4,17,8,11,57,45,12,59
Stranraer,957,5,16,5,15,58,66,-8,53
Airdrieon,957,6,11,11,14,47,58,-11,44
East Fife,957,7,13,3,20,49,67,-18,42
Forfar,957,8,10,5,21,38,66,-28,35
Albion,957,9,8,7,21,60,81,-21,31
Queen's Park,957,10,7,10,19,43,72,-29,31
Raith,958,1,23,8,5,70,33,37,77
Ayr,958,2,24,4,8,93,42,51,76
Arbroath,958,3,18,8,10,71,48,23,62
Alloa,958,4,17,8,11,57,45,12,59
Stranraer,958,5,15,6,15,57,66,-9,51
Airdrieon,958,6,11,11,14,47,59,-12,44
East Fife,958,7,13,4,19,49,66,-17,43
Forfar,958,8,10,5,21,39,66,-27,35
Albion,958,9,8,6,22,57,81,-24,30
Queen's Park,958,10,6,10,20,39,73,-34,28
Ayr,959,1,24,4,8,94,42,52,76
Raith,959,2,22,8,6,68,33,35,74
Arbroath,959,3,18,8,10,73,49,24,62
Alloa,959,4,18,8,10,57,43,14,62
Stranraer,959,5,16,5,15,56,64,-8,53
Airdrieon,959,6,11,11,14,46,58,-12,44
East Fife,959,7,13,3,20,47,65,-18,42
Forfar,959,8,10,5,21,38,65,-27,35
Albion,959,9,8,6,22,57,82,-25,30
Queen's Park,959,10,6,10,20,40,75,-35,28
Raith,960,1,23,8,5,70,32,38,77
Ayr,960,2,24,4,8,96,43,53,76
Arbroath,960,3,17,8,11,70,49,21,59
Alloa,960,4,17,8,11,56,45,11,59
Stranraer,960,5,16,5,15,58,66,-8,53
Airdrieon,960,6,11,11,14,46,58,-12,44
East Fife,960,7,13,3,20,49,67,-18,42
Forfar,960,8,10,5,21,38,65,-27,35
Queen's Park,960,9,7,10,19,40,72,-32,31
Albion,960,10,8,6,22,58,84,-26,30
Raith,961,1,23,8,5,71,34,37,77
Ayr,961,2,23,5,8,91,43,48,74
Arbroath,961,3,18,8,10,75,48,27,62
Alloa,961,4,17,8,11,58,46,12,59
Stranraer,961,5,16,5,15,56,64,-8,53
East Fife,961,6,13,3,20,47,65,-18,42
Airdrieon,961,7,10,11,15,46,60,-14,41
Forfar,961,8,11,5,20,40,65,-25,38
Albion,961,9,8,7,21,58,79,-21,31
Queen's Park,961,10,6,10,20,39,77,-38,28
Ayr,962,1,24,4,8,94,42,52,76
Raith,962,2,22,9,5,69,33,36,75
Arbroath,962,3,18,8,10,72,48,24,62
Alloa,962,4,17,9,10,57,44,13,60
Stranraer,962,5,15,5,16,56,67,-11,50
East Fife,962,6,14,3,19,50,65,-15,45
Airdrieon,962,7,10,12,14,45,58,-13,42
Forfar,962,8,10,6,20,38,64,-26,36
Albion,962,9,8,6,22,57,82,-25,30
Queen's Park,962,10,6,10,20,39,74,-35,28
Ayr,963,1,24,4,8,95,43,52,76
Raith,963,2,22,9,5,69,33,36,75
Arbroath,963,3,18,8,10,75,49,26,62
Alloa,963,4,17,9,10,57,44,13,60
Stranraer,963,5,15,5,16,56,67,-11,50
East Fife,963,6,14,3,19,50,65,-15,45
Airdrieon,963,7,10,11,15,45,59,-14,41
Forfar,963,8,11,5,20,39,64,-25,38
Albion,963,9,8,6,22,58,83,-25,30
Queen's Park,963,10,6,10,20,40,77,-37,28
Ayr,964,1,24,4,8,95,44,51,76
Raith,964,2,22,9,5,68,32,36,75
Alloa,964,3,17,9,10,56,43,13,60
Arbroath,964,4,17,8,11,70,50,20,59
Stranraer,964,5,15,5,16,56,67,-11,50
East Fife,964,6,14,3,19,50,65,-15,45
Airdrieon,964,7,10,11,15,45,59,-14,41
Forfar,964,8,11,5,20,39,64,-25,38
Queen's Park,964,9,7,10,19,41,72,-31,31
Albion,964,10,8,6,22,59,83,-24,30
Raith,965,1,23,8,5,69,32,37,77
Ayr,965,2,24,4,8,95,43,52,76
Arbroath,965,3,17,9,10,74,52,22,60
Alloa,965,4,17,8,11,56,44,12,59
Stranraer,965,5,15,5,16,55,68,-13,50
East Fife,965,6,14,3,19,51,64,-13,45
Airdrieon,965,7,10,11,15,46,60,-14,41
Forfar,965,8,11,5,20,40,65,-25,38
Albion,965,9,8,6,22,58,83,-25,30
Queen's Park,965,10,6,11,19,43,76,-33,29
Raith,966,1,23,8,5,70,32,38,77
Ayr,966,2,24,4,8,94,42,52,76
Arbroath,966,3,17,9,10,72,50,22,60
Alloa,966,4,17,8,11,56,45,11,59
Stranraer,966,5,15,5,16,57,67,-10,50
East Fife,966,6,14,3,19,50,66,-16,45
Airdrieon,966,7,11,11,14,47,59,-12,44
Forfar,966,8,10,5,21,39,66,-27,35
Albion,966,9,8,6,22,57,82,-25,30
Queen's Park,966,10,6,11,19,41,74,-33,29
Raith,967,1,23,8,5,70,32,38,77
Ayr,967,2,24,4,8,93,42,51,76
Arbroath,967,3,18,8,10,71,48,23,62
Alloa,967,4,17,8,11,56,45,11,59
Stranraer,967,5,15,5,16,56,69,-13,50
East Fife,967,6,14,3,19,52,65,-13,45
Airdrieon,967,7,10,11,15,46,60,-14,41
Forfar,967,8,11,5,20,40,65,-25,38
Albion,967,9,8,6,22,57,81,-24,30
Queen's Park,967,10,6,10,20,39,73,-34,28
Raith,968,1,22,9,5,69,33,36,75
Ayr,968,2,23,5,8,92,44,48,74
Arbroath,968,3,18,8,10,74,49,25,62
Alloa,968,4,17,9,10,57,44,13,60
Stranraer,968,5,15,5,16,55,66,-11,50
East Fife,968,6,14,3,19,49,64,-15,45
Airdrieon,968,7,10,11,15,45,60,-15,41
Forfar,968,8,11,5,20,40,64,-24,38
Albion,968,9,8,7,21,59,80,-21,31
Queen's Park,968,10,6,10,20,40,76,-36,28
Raith,969,1,23,8,5,72,32,40,77
Ayr,969,2,24,4,8,92,42,50,76
Arbroath,969,3,18,8,10,74,48,26,62
Alloa,969,4,17,8,11,56,47,9,59
Stranraer,969,5,15,5,16,56,66,-10,50
East Fife,969,6,14,3,19,49,65,-16,45
Airdrieon,969,7,11,11,14,48,59,-11,44
Forfar,969,8,10,5,21,39,67,-28,35
Albion,969,9,8,6,22,57,80,-23,30
Queen's Park,969,10,6,10,20,39,76,-37,28
Ayr,970,1,24,4,8,93,43,50,76
Raith,970,2,22,9,5,68,32,36,75
Arbroath,970,3,18,8,10,71,48,23,62
Alloa,970,4,17,9,10,56,43,13,60
Stranraer,970,5,15,5,16,55,65,-10,50
East Fife,970,6,14,3,19,48,64,-16,45
Airdrieon,970,7,10,12,14,46,59,-13,42
Forfar,970,8,10,6,20,39,65,-26,36
Albion,970,9,8,6,22,58,81,-23,30
Queen's Park,970,10,6,10,20,39,73,-34,28
Raith,971,1,23,8,5,69,32,37,77
Ayr,971,2,24,4,8,96,43,53,76
Arbroath,971,3,17,8,11,71,50,21,59
Alloa,971,4,17,8,11,56,44,12,59
Stranraer,971,5,15,5,16,57,68,-11,50
East Fife,971,6,14,3,19,51,66,-15,45
Airdrieon,971,7,10,12,14,46,59,-13,42
Forfar,971,8,10,6,20,39,65,-26,36
Queen's Park,971,9,7,10,19,41,73,-32,31
Albion,971,10,8,6,22,58,84,-26,30
Raith,972,1,23,8,5,70,33,37,77
Ayr,972,2,24,4,8,95,43,52,76
Arbroath,972,3,18,8,10,72,49,23,62
Alloa,972,4,17,8,11,57,45,12,59
Stranraer,972,5,15,6,15,56,65,-9,51
Airdrieon,972,6,11,11,14,47,59,-12,44
East Fife,972,7,13,4,19,48,65,-17,43
Forfar,972,8,10,5,21,39,66,-27,35
Albion,972,9,8,6,22,58,83,-25,30
Queen's Park,972,10,6,10,20,40,74,-34,28
Raith,973,1,23,8,5,70,33,37,77
Ayr,973,2,24,4,8,93,43,50,76
Arbroath,973,3,17,8,11,70,50,20,59
Alloa,973,4,17,8,11,57,45,12,59
Stranraer,973,5,16,5,15,60,64,-4,53
Airdrieon,973,6,11,11,14,48,60,-12,44
East Fife,973,7,13,3,20,47,69,-22,42
Forfar,973,8,10,5,21,40,67,-27,35
Queen's Park,973,9,7,10,19,41,72,-31,31
Albion,973,10,8,6,22,58,81,-23,30
Raith,974,1,23,8,5,70,32,38,77
Ayr,974,2,23,4,9,92,46,46,73
Arbroath,974,3,18,8,10,73,49,24,62
Alloa,974,4,17,8,11,56,45,11,59
Stranraer,974,5,15,6,15,56,65,-9,51
East Fife,974,6,13,4,19,48,65,-17,43
Airdrieon,974,7,10,11,15,46,60,-14,41
Forfar,974,8,11,5,20,40,65,-25,38
Albion,974,9,9,6,21,61,80,-19,33
Queen's Park,974,10,6,10,20,40,75,-35,28
Raith,975,1,23,8,5,70,33,37,77
Ayr,975,2,23,5,8,92,44,48,74
Arbroath,975,3,17,8,11,71,53,18,59
Alloa,975,4,17,8,11,57,45,12,59
Stranraer,975,5,15,6,15,57,66,-9,51
Airdrieon,975,6,11,11,14,47,59,-12,44
East Fife,975,7,13,4,19,49,66,-17,43
Forfar,975,8,10,5,21,39,66,-27,35
Albion,975,9,8,7,21,59,80,-21,31
Queen's Park,975,10,7,10,19,44,73,-29,31
Ayr,976,1,24,4,8,94,43,51,76
Raith,976,2,22,8,6,68,33,35,74
Arbroath,976,3,18,8,10,75,51,24,62
Alloa,976,4,18,8,10,57,43,14,62
Stranraer,976,5,16,5,15,57,64,-7,53
Airdrieon,976,6,11,11,14,47,58,-11,44
East Fife,976,7,13,3,20,47,66,-19,42
Forfar,976,8,10,5,21,38,66,-28,35
Albion,976,9,8,6,22,58,82,-24,30
Queen's Park,976,10,6,10,20,42,77,-35,28
Raith,977,1,23,8,5,71,32,39,77
Ayr,977,2,24,4,8,92,43,49,76
Arbroath,977,3,18,8,10,71,48,23,62
Alloa,977,4,17,8,11,56,46,10,59
Stranraer,977,5,15,5,16,55,68,-13,50
East Fife,977,6,14,3,19,51,64,-13,45
Airdrieon,977,7,11,11,14,47,59,-12,44
Forfar,977,8,10,5,21,39,66,-27,35
Albion,977,9,8,6,22,58,80,-22,30
Queen's Park,977,10,6,10,20,39,73,-34,28
Raith,978,1,23,8,5,70,32,38,77
Ayr,978,2,24,4,8,96,43,53,76
Arbroath,978,3,17,8,11,71,50,21,59
Alloa,978,4,17,8,11,56,45,11,59
Stranraer,978,5,15,6,15,56,65,-9,51
Airdrieon,978,6,11,11,14,49,59,-10,44
East Fife,978,7,13,4,19,48,65,-17,43
Forfar,978,8,10,5,21,39,68,-29,35
Queen's Park,978,9,7,10,19,41,73,-32,31
Albion,978,10,8,6,22,58,84,-26,30
Raith,979,1,23,8,5,69,32,37,77
Ayr,979,2,24,4,8,94,42,52,76
Arbroath,979,3,17,8,11,71,50,21,59
Alloa,979,4,17,8,11,56,44,12,59
Stranraer,979,5,16,5,15,59,65,-6,53
Airdrieon,979,6,10,12,14,47,60,-13,42
East Fife,979,7,13,3,20,48,68,-20,42
Forfar,979,8,10,6,20,40,66,-26,36
Queen's Park,979,9,7,10,19,41,73,-32,31
Albion,979,10,8,6,22,57,82,-25,30
Raith,980,1,23,8,5,71,32,39,77
Ayr,980,2,24,4,8,94,43,51,76
Arbroath,980,3,17,8,11,70,49,21,59
Alloa,980,4,17,8,11,56,46,10,59
Stranraer,980,5,16,5,15,57,64,-7,53
Airdrieon,980,6,10,12,14,46,59,-13,42
East Fife,980,7,13,3,20,47,66,-19,42
Forfar,980,8,10,6,20,39,65,-26,36
Queen's Park,980,9,7,10,19,40,72,-32,31
Albion,980,10,8,6,22,58,82,-24,30
Raith,981,1,23,8,5,70,33,37,77
Ayr,981,2,23,5,8,91,43,48,74
Arbroath,981,3,18,8,10,73,50,23,62
Alloa,981,4,17,8,11,57,45,12,59
Stranraer,981,5,15,5,16,55,66,-11,50
East Fife,981,6,14,3,19,49,64,-15,45
Airdrieon,981,7,10,12,14,46,59,-13,42
Forfar,981,8,10,6,20,39,65,-26,36
Albion,981,9,8,7,21,58,79,-21,31
Queen's Park,981,10,6,10,20,41,75,-34,28
Raith,982,1,23,8,5,73,33,40,77
Ayr,982,2,24,4,8,92,42,50,76
Arbroath,982,3,17,8,11,70,49,21,59
Alloa,982,4,17,8,11,57,48,9,59
Stranraer,982,5,16,5,15,57,64,-7,53
East Fife,982,6,13,3,20,47,66,-19,42
Airdrieon,982,7,10,11,15,45,59,-14,41
Forfar,982,8,11,5,20,39,64,-25,38
Queen's Park,982,9,7,10,19,40,72,-32,31
Albion,982,10,8,6,22,57,80,-23,30
Raith,983,1,23,8,5,69,32,37,77
Ayr,983,2,23,5,8,94,46,48,74
Arbroath,983,3,18,8,10,72,49,23,62
Alloa,983,4,17,8,11,56,44,12,59
Stranraer,983,5,15,5,16,57,70,-13,50
East Fife,983,6,14,3,19,53,66,-13,45
Airdrieon,983,7,11,11,14,49,59,-10,44
Forfar,983,8,10,5,21,39,68,-29,35
Albion,983,9,8,7,21,61,82,-21,31
Queen's Park,983,10,6,10,20,40,74,-34,28
Raith,984,1,23,8,5,71,34,37,77
Ayr,984,2,24,4,8,92,43,49,76
Arbroath,984,3,18,8,10,73,50,23,62
Alloa,984,4,17,8,11,58,46,12,59
Stranraer,984,5,15,5,16,57,67,-10,50
East Fife,984,6,14,3,19,50,66,-16,45
Airdrieon,984,7,11,11,14,47,58,-11,44
Forfar,984,8,10,5,21,38,66,-28,35
Albion,984,9,8,6,22,58,80,-22,30
Queen's Park,984,10,6,10,20,41,75,-34,28
Ayr,985,1,24,4,8,94,44,50,76
Raith,985,2,22,9,5,70,34,36,75
Alloa,985,3,17,9,10,58,45,13,60
Arbroath,985,4,17,8,11,71,50,21,59
Stranraer,985,5,15,6,15,57,66,-9,51
East Fife,985,6,13,4,19,49,66,-17,43
Airdrieon,985,7,10,11,15,48,62,-14,41
Forfar,985,8,11,5,20,42,67,-25,38
Queen's Park,985,9,7,10,19,41,73,-32,31
Albion,985,10,8,6,22,59,82,-23,30
Ayr,986,1,24,4,8,92,43,49,76
Raith,986,2,22,8,6,68,34,34,74
Arbroath,986,3,18,8,10,73,48,25,62
Alloa,986,4,18,8,10,58,43,15,62
Stranraer,986,5,16,5,15,58,66,-8,53
Airdrieon,986,6,11,11,14,47,58,-11,44
East Fife,986,7,13,3,20,49,67,-18,42
Forfar,986,8,10,5,21,38,66,-28,35
Albion,986,9,8,6,22,58,80,-22,30
Queen's Park,986,10,6,10,20,39,75,-36,28
Ayr,987,1,24,4,8,94,44,50,76
Raith,987,2,22,9,5,69,33,36,75
Arbroath,987,3,17,9,10,72,50,22,60
Alloa,987,4,17,9,10,57,44,13,60
Stranraer,987,5,15,6,15,57,66,-9,51
East Fife,987,6,13,4,19,49,66,-17,43
Airdrieon,987,7,10,11,15,46,60,-14,41
Forfar,987,8,11,5,20,40,65,-25,38
Albion,987,9,8,6,22,59,82,-23,30
Queen's Park,987,10,6,11,19,41,74,-33,29
Ayr,988,1,24,4,8,95,42,53,76
Raith,988,2,22,9,5,68,32,36,75
Alloa,988,3,17,9,10,56,43,13,60
Arbroath,988,4,17,8,11,70,49,21,59
Stranraer,988,5,16,5,15,58,65,-7,53
Airdrieon,988,6,10,12,14,46,59,-13,42
East Fife,988,7,13,3,20,48,67,-19,42
Forfar,988,8,10,6,20,39,65,-26,36
Queen's Park,988,9,7,10,19,40,72,-32,31
Albion,988,10,8,6,22,57,83,-26,30
Raith,989,1,23,8,5,72,33,39,77
Ayr,989,2,24,4,8,94,43,51,76
Arbroath,989,3,17,8,11,71,50,21,59
Alloa,989,4,17,8,11,57,47,10,59
Stranraer,989,5,15,6,15,56,65,-9,51
Airdrieon,989,6,11,11,14,47,59,-12,44
East Fife,989,7,13,4,19,48,65,-17,43
Forfar,989,8,10,5,21,39,66,-27,35
Queen's Park,989,9,7,10,19,41,73,-32,31
Albion,989,10,8,6,22,58,82,-24,30
Raith,990,1,23,8,5,71,32,39,77
Ayr,990,2,24,4,8,95,43,52,76
Arbroath,990,3,18,8,10,72,49,23,62
Alloa,990,4,17,8,11,56,46,10,59
Stranraer,990,5,15,5,16,56,68,-12,50
East Fife,990,6,14,3,19,51,65,-14,45
Airdrieon,990,7,10,11,15,46,60,-14,41
Forfar,990,8,11,5,20,40,65,-25,38
Albion,990,9,8,6,22,58,83,-25,30
Queen's Park,990,10,6,10,20,40,74,-34,28
Ayr,991,1,24,4,8,95,42,53,76
Raith,991,2,22,9,5,69,33,36,75
Alloa,991,3,17,9,10,57,44,13,60
Arbroath,991,4,17,8,11,71,50,21,59
Stranraer,991,5,15,5,16,57,67,-10,50
East Fife,991,6,14,3,19,50,66,-16,45
Airdrieon,991,7,11,11,14,47,59,-12,44
Forfar,991,8,10,5,21,39,66,-27,35
Queen's Park,991,9,7,10,19,41,73,-32,31
Albion,991,10,8,6,22,57,83,-26,30
Ayr,992,1,24,4,8,95,44,51,76
Raith,992,2,22,9,5,69,33,36,75
Arbroath,992,3,17,9,10,72,50,22,60
Alloa,992,4,17,9,10,57,44,13,60
Stranraer,992,5,15,5,16,56,67,-11,50
East Fife,992,6,14,3,19,50,65,-15,45
Airdrieon,992,7,11,11,14,47,58,-11,44
Forfar,992,8,10,5,21,38,66,-28,35
Albion,992,9,8,6,22,59,83,-24,30
Queen's Park,992,10,6,11,19,41,74,-33,29
Ayr,993,1,23,5,8,92,44,48,74
Raith,993,2,22,8,6,69,35,34,74
Arbroath,993,3,18,8,10,73,49,24,62
Alloa,993,4,18,8,10,59,44,15,62
Stranraer,993,5,15,5,16,56,67,-11,50
East Fife,993,6,14,3,19,50,65,-15,45
Airdrieon,993,7,10,11,15,45,59,-14,41
Forfar,993,8,11,5,20,39,64,-25,38
Albion,993,9,8,7,21,59,80,-21,31
Queen's Park,993,10,6,10,20,40,75,-35,28
Ayr,994,1,24,4,8,94,44,50,76
Raith,994,2,22,8,6,69,35,34,74
Alloa,994,3,18,8,10,59,44,15,62
Arbroath,994,4,17,9,10,70,48,22,60
Stranraer,994,5,15,6,15,57,66,-9,51
Airdrieon,994,6,11,11,14,47,58,-11,44
East Fife,994,7,13,4,19,49,66,-17,43
Forfar,994,8,10,5,21,38,66,-28,35
Albion,994,9,8,6,22,59,82,-23,30
Queen's Park,994,10,6,11,19,39,72,-33,29
Ayr,995,1,24,4,8,96,44,52,76
Raith,995,2,22,9,5,69,33,36,75
Alloa,995,3,17,9,10,57,44,13,60
Arbroath,995,4,17,8,11,70,49,21,59
Stranraer,995,5,16,5,15,57,65,-8,53
Airdrieon,995,6,11,11,14,49,61,-12,44
East Fife,995,7,13,3,20,48,66,-18,42
Forfar,995,8,10,5,21,41,68,-27,35
Queen's Park,995,9,7,10,19,40,72,-32,31
Albion,995,10,8,6,22,59,84,-25,30
Raith,996,1,23,8,5,70,33,37,77
Ayr,996,2,24,4,8,94,44,50,76
Arbroath,996,3,17,9,10,70,48,22,60
Alloa,996,4,17,8,11,57,45,12,59
Stranraer,996,5,15,5,16,56,68,-12,50
East Fife,996,6,14,3,19,51,65,-14,45
Airdrieon,996,7,10,11,15,46,60,-14,41
Forfar,996,8,11,5,20,40,65,-25,38
Albion,996,9,8,6,22,59,82,-23,30
Queen's Park,996,10,6,11,19,39,72,-33,29
Raith,997,1,23,8,5,69,32,37,77
Ayr,997,2,23,4,9,90,43,47,73
Arbroath,997,3,18,8,10,71,48,23,62
Alloa,997,4,17,8,11,56,44,12,59
Stranraer,997,5,15,5,16,57,67,-10,50
East Fife,997,6,14,3,19,50,66,-16,45
Airdrieon,997,7,11,11,14,48,58,-10,44
Forfar,997,8,10,5,21,38,67,-29,35
Albion,997,9,9,6,21,58,78,-20,33
Queen's Park,997,10,6,10,20,39,73,-34,28
Ayr,998,1,24,4,8,96,42,54,76
Raith,998,2,22,9,5,68,32,36,75
Arbroath,998,3,18,8,10,74,49,25,62
Alloa,998,4,17,9,10,56,43,13,60
Stranraer,998,5,16,5,15,56,64,-8,53
East Fife,998,6,13,3,20,47,65,-18,42
Airdrieon,998,7,10,11,15,45,60,-15,41
Forfar,998,8,11,5,20,40,64,-24,38
Albion,998,9,8,6,22,57,84,-27,30
Queen's Park,998,10,6,10,20,40,76,-36,28
Ayr,999,1,24,4,8,96,44,52,76
Raith,999,2,22,9,5,69,33,36,75
Arbroath,999,3,18,8,10,75,49,26,62
Alloa,999,4,17,9,10,57,44,13,60
Stranraer,999,5,15,5,16,56,69,-13,50
East Fife,999,6,14,3,19,52,65,-13,45
Airdrieon,999,7,11,11,14,46,58,-12,44
Forfar,999,8,10,5,21,38,65,-27,35
Albion,999,9,8,6,22,59,84,-25,30
Queen's Park,999,10,6,10,20,40,77,-37,28
Ayr,1000,1,24,4,8,93,42,51,76
Raith,1000,2,22,9,5,71,35,36,75
Arbroath,1000,3,18,8,10,73,48,25,62
Alloa,1000,4,17,9,10,59,46,13,60
Stranraer,1000,5,15,5,16,58,68,-10,50
East Fife,1000,6,14,3,19,51,67,-16,45
Airdrieon,1000,7,11,11,14,47,59,-12,44
Forfar,1000,8,10,5,21,39,66,-27,35
Albion,1000,9,8,6,22,57,81,-24,30
Queen's Park,1000,10,6,10,20,39,75,-36,28
Ayr,1001,1,24,4,8,97,43,54,76
Raith,1001,2,22,9,5,70,34,36,75
Arbroath,1001,3,18,8,10,72,48,24,62
Alloa,1001,4,17,9,10,58,45,13,60
Stranraer,1001,5,15,5,16,55,66,-11,50
East Fife,1001,6,14,3,19,49,64,-15,45
Airdrieon,1001,7,11,11,14,46,58,-12,44
Forfar,1001,8,10,5,21,38,65,-27,35
Albion,1001,9,8,6,22,58,85,-27,30
Queen's Park,1001,10,6,10,20,39,74,-35,28
Raith,1002,1,23,8,5,70,33,37,77
Ayr,1002,2,23,4,9,90,44,46,73
Arbroath,1002,3,18,8,10,72,48,24,62
Alloa,1002,4,17,8,11,57,45,12,59
Stranraer,1002,5,15,6,15,55,64,-9,51
East Fife,1002,6,13,4,19,47,64,-17,43
Airdrieon,1002,7,10,11,15,45,60,-15,41
Forfar,1002,8,11,5,20,40,64,-24,38
Albion,1002,9,9,6,21,59,78,-19,33
Queen's Park,1002,10,6,10,20,39,74,-35,28
Ayr,1003,1,24,4,8,93,42,51,76
Raith,1003,2,22,9,5,68,32,36,75
Arbroath,1003,3,18,8,10,71,48,23,62
Alloa,1003,4,17,9,10,56,43,13,60
Stranraer,1003,5,15,6,15,55,64,-9,51
East Fife,1003,6,13,4,19,47,64,-17,43
Airdrieon,1003,7,10,11,15,47,61,-14,41
Forfar,1003,8,11,5,20,41,66,-25,38
Albion,1003,9,8,6,22,57,81,-24,30
Queen's Park,1003,10,6,10,20,39,73,-34,28
Raith,1004,1,22,9,5,68,32,36,75
Ayr,1004,2,23,5,8,91,43,48,74
Alloa,1004,3,17,9,10,56,43,13,60
Arbroath,1004,4,17,8,11,70,50,20,59
Stranraer,1004,5,15,6,15,56,65,-9,51
East Fife,1004,6,13,4,19,48,65,-17,43
Airdrieon,1004,7,10,12,14,46,59,-13,42
Forfar,1004,8,10,6,20,39,65,-26,36
Albion,1004,9,8,7,21,58,79,-21,31
Queen's Park,1004,10,7,10,19,41,72,-31,31
Raith,1005,1,23,8,5,70,33,37,77
Ayr,1005,2,24,4,8,93,42,51,76
Arbroath,1005,3,17,8,11,71,50,21,59
Alloa,1005,4,17,8,11,57,45,12,59
Stranraer,1005,5,15,5,16,56,70,-14,50
East Fife,1005,6,14,3,19,53,65,-12,45
Airdrieon,1005,7,10,11,15,45,59,-14,41
Forfar,1005,8,11,5,20,39,64,-25,38
Queen's Park,1005,9,7,10,19,41,73,-32,31
Albion,1005,10,8,6,22,57,81,-24,30
Raith,1006,1,22,9,5,70,34,36,75
Ayr,1006,2,23,4,9,92,45,47,73
Arbroath,1006,3,18,8,10,72,49,23,62
Alloa,1006,4,17,9,10,58,45,13,60
Stranraer,1006,5,15,6,15,56,65,-9,51
Airdrieon,1006,6,11,11,14,47,59,-12,44
East Fife,1006,7,13,4,19,48,65,-17,43
Forfar,1006,8,10,5,21,39,66,-27,35
Albion,1006,9,9,6,21,60,80,-20,33
Queen's Park,1006,10,6,10,20,40,74,-34,28
Raith,1007,1,22,9,5,71,35,36,75
Ayr,1007,2,23,5,8,92,44,48,74
Arbroath,1007,3,18,8,10,71,48,23,62
Alloa,1007,4,17,9,10,59,46,13,60
Stranraer,1007,5,16,5,15,56,64,-8,53
Airdrieon,1007,6,10,12,14,46,59,-13,42
East Fife,1007,7,13,3,20,47,65,-18,42
Forfar,1007,8,10,6,20,39,65,-26,36
Albion,1007,9,8,7,21,59,80,-21,31
Queen's Park,1007,10,6,10,20,39,73,-34,28
Raith,1008,1,23,8,5,70,32,38,77
Ayr,1008,2,23,4,9,92,45,47,73
Arbroath,1008,3,17,8,11,70,49,21,59
Alloa,1008,4,17,8,11,56,45,11,59
Stranraer,1008,5,15,5,16,56,66,-10,50
East Fife,1008,6,14,3,19,49,65,-16,45
Airdrieon,1008,7,11,11,14,46,58,-12,44
Forfar,1008,8,10,5,21,38,65,-27,35
Albion,1008,9,9,6,21,60,80,-20,33
Queen's Park,1008,10,7,10,19,40,72,-32,31
Raith,1009,1,23,8,5,69,32,37,77
Ayr,1009,2,24,4,8,92,43,49,76
Arbroath,1009,3,18,8,10,75,51,24,62
Alloa,1009,4,17,8,11,56,44,12,59
Stranraer,1009,5,16,5,15,58,64,-6,53
East Fife,1009,6,13,3,20,47,67,-20,42
Airdrieon,1009,7,10,11,15,46,60,-14,41
Forfar,1009,8,11,5,20,40,65,-25,38
Albion,1009,9,8,6,22,58,80,-22,30
Queen's Park,1009,10,6,10,20,42,77,-35,28
Raith,1010,1,23,8,5,72,32,40,77
Ayr,1010,2,23,4,9,92,46,46,73
Arbroath,1010,3,18,8,10,71,48,23,62
Alloa,1010,4,17,8,11,56,47,9,59
Stranraer,1010,5,15,5,16,56,66,-10,50
East Fife,1010,6,14,3,19,49,65,-16,45
Airdrieon,1010,7,10,11,15,47,61,-14,41
Forfar,1010,8,11,5,20,41,66,-25,38
Albion,1010,9,9,6,21,61,80,-19,33
Queen's Park,1010,10,6,10,20,39,73,-34,28
Raith,1011,1,23,8,5,70,33,37,77
Ayr,1011,2,24,4,8,94,42,52,76
Arbroath,1011,3,17,9,10,70,48,22,60
Alloa,1011,4,17,8,11,57,45,12,59
Stranraer,1011,5,15,5,16,55,65,-10,50
East Fife,1011,6,14,3,19,48,64,-16,45
Airdrieon,1011,7,11,11,14,47,58,-11,44
Forfar,1011,8,10,5,21,38,66,-28,35
Albion,1011,9,8,6,22,57,82,-25,30
Queen's Park,1011,10,6,11,19,39,72,-33,29
Raith,1012,1,22,9,5,69,33,36,75
Ayr,1012,2,23,4,9,91,44,47,73
Arbroath,1012,3,17,9,10,72,50,22,60
Alloa,1012,4,17,9,10,57,44,13,60
Stranraer,1012,5,15,5,16,57,67,-10,50
East Fife,1012,6,14,3,19,50,66,-16,45
Airdrieon,1012,7,11,11,14,47,59,-12,44
Forfar,1012,8,10,5,21,39,66,-27,35
Albion,1012,9,9,6,21,59,79,-20,33
Queen's Park,1012,10,6,11,19,41,74,-33,29
Raith,1013,1,23,8,5,69,32,37,77
Ayr,1013,2,23,4,9,91,44,47,73
Arbroath,1013,3,17,8,11,70,49,21,59
Alloa,1013,4,17,8,11,56,44,12,59
Stranraer,1013,5,15,6,15,57,66,-9,51
Airdrieon,1013,6,11,11,14,47,58,-11,44
East Fife,1013,7,13,4,19,49,66,-17,43
Forfar,1013,8,10,5,21,38,66,-28,35
Albion,1013,9,9,6,21,59,79,-20,33
Queen's Park,1013,10,7,10,19,40,72,-32,31
Ayr,1014,1,24,4,8,93,44,49,76
Raith,1014,2,22,8,6,69,34,35,74
Alloa,1014,3,18,8,10,58,44,14,62
Arbroath,1014,4,17,9,10,72,50,22,60
Stranraer,1014,5,16,5,15,58,66,-8,53
Airdrieon,1014,6,11,11,14,48,59,-11,44
East Fife,1014,7,13,3,20,49,67,-18,42
Forfar,1014,8,10,5,21,39,67,-28,35
Albion,1014,9,8,6,22,59,81,-22,30
Queen's Park,1014,10,6,11,19,41,74,-33,29
Raith,1015,1,23,8,5,69,32,37,77
Ayr,1015,2,23,4,9,92,47,45,73
Arbroath,1015,3,17,9,10,71,49,22,60
Alloa,1015,4,17,8,11,56,44,12,59
Stranraer,1015,5,15,5,16,56,68,-12,50
East Fife,1015,6,14,3,19,51,65,-14,45
Airdrieon,1015,7,10,12,14,45,58,-13,42
Forfar,1015,8,10,6,20,38,64,-26,36
Albion,1015,9,9,6,21,62,80,-18,33
Queen's Park,1015,10,6,11,19,40,73,-33,29
Ayr,1016,1,24,4,8,94,43,51,76
Raith,1016,2,22,8,6,68,34,34,74
Alloa,1016,3,18,8,10,58,43,15,62
Arbroath,1016,4,17,8,11,71,51,20,59
Stranraer,1016,5,15,6,15,57,66,-9,51
East Fife,1016,6,13,4,19,49,66,-17,43
Airdrieon,1016,7,10,12,14,46,59,-13,42
Forfar,1016,8,10,6,20,39,65,-26,36
Queen's Park,1016,9,7,10,19,42,73,-31,31
Albion,1016,10,8,6,22,58,82,-24,30
Ayr,1017,1,24,4,8,92,42,50,76
Raith,1017,2,22,8,6,70,35,35,74
Arbroath,1017,3,18,8,10,72,48,24,62
Alloa,1017,4,18,8,10,59,45,14,62
Stranraer,1017,5,15,6,15,55,64,-9,51
Airdrieon,1017,6,11,11,14,49,59,-10,44
East Fife,1017,7,13,4,19,47,64,-17,43
Forfar,1017,8,10,5,21,39,68,-29,35
Albion,1017,9,8,6,22,57,80,-23,30
Queen's Park,1017,10,6,10,20,39,74,-35,28
Ayr,1018,1,24,4,8,92,43,49,76
Raith,1018,2,22,9,5,68,32,36,75
Arbroath,1018,3,18,8,10,73,50,23,62
Alloa,1018,4,17,9,10,56,43,13,60
Stranraer,1018,5,15,5,16,55,67,-12,50
East Fife,1018,6,14,3,19,50,64,-14,45
Airdrieon,1018,7,11,11,14,48,59,-11,44
Forfar,1018,8,10,5,21,39,67,-28,35
Albion,1018,9,8,6,22,58,80,-22,30
Queen's Park,1018,10,6,10,20,41,75,-34,28
Ayr,1019,1,24,4,8,95,45,50,76
Raith,1019,2,22,9,5,70,34,36,75
Arbroath,1019,3,17,9,10,70,48,22,60
Alloa,1019,4,17,9,10,58,45,13,60
Stranraer,1019,5,15,6,15,56,65,-9,51
East Fife,1019,6,13,4,19,48,65,-17,43
Airdrieon,1019,7,10,12,14,47,60,-13,42
Forfar,1019,8,10,6,20,40,66,-26,36
Albion,1019,9,8,6,22,60,83,-23,30
Queen's Park,1019,10,6,11,19,39,72,-33,29
Ayr,1020,1,24,4,8,95,42,53,76
Raith,1020,2,22,9,5,70,34,36,75
Alloa,1020,3,17,9,10,58,45,13,60
Arbroath,1020,4,17,8,11,70,50,20,59
Stranraer,1020,5,15,5,16,57,67,-10,50
East Fife,1020,6,14,3,19,50,66,-16,45
Airdrieon,1020,7,11,11,14,48,58,-10,44
Forfar,1020,8,10,5,21,38,67,-29,35
Queen's Park,1020,9,7,10,19,41,72,-31,31
Albion,1020,10,8,6,22,57,83,-26,30
Raith,1021,1,23,8,5,69,32,37,77
Ayr,1021,2,24,4,8,95,43,52,76
Arbroath,1021,3,18,8,10,74,48,26,62
Alloa,1021,4,17,8,11,56,44,12,59
Stranraer,1021,5,16,5,15,56,64,-8,53
Airdrieon,1021,6,11,11,14,49,58,-9,44
East Fife,1021,7,13,3,20,47,65,-18,42
Forfar,1021,8,10,5,21,38,68,-30,35
Albion,1021,9,8,6,22,58,83,-25,30
Queen's Park,1021,10,6,10,20,39,76,-37,28
Ayr,1022,1,24,4,8,96,43,53,76
Raith,1022,2,22,8,6,68,33,35,74
Arbroath,1022,3,18,8,10,73,50,23,62
Alloa,1022,4,18,8,10,57,43,14,62
Stranraer,1022,5,15,5,16,57,67,-10,50
East Fife,1022,6,14,3,19,50,66,-16,45
Airdrieon,1022,7,10,11,15,46,60,-14,41
Forfar,1022,8,11,5,20,40,65,-25,38
Albion,1022,9,8,6,22,58,84,-26,30
Queen's Park,1022,10,6,10,20,41,75,-34,28
Raith,1023,1,22,8,6,70,35,35,74
Ayr,1023,2,23,4,9,92,45,47,73
Alloa,1023,3,18,8,10,59,45,14,62
Arbroath,1023,4,17,9,10,71,49,22,60
Stranraer,1023,5,15,5,16,56,66,-10,50
East Fife,1023,6,14,3,19,49,65,-16,45
Airdrieon,1023,7,10,12,14,46,59,-13,42
Forfar,1023,8,10,6,20,39,65,-26,36
Albion,1023,9,9,6,21,60,80,-20,33
Queen's Park,1023,10,6,11,19,40,73,-33,29
Ayr,1024,1,24,4,8,93,44,49,76
Raith,1024,2,22,9,5,70,34,36,75
Alloa,1024,3,17,9,10,58,45,13,60
Arbroath,1024,4,17,8,11,71,50,21,59
Stranraer,1024,5,15,5,16,57,69,-12,50
East Fife,1024,6,14,3,19,52,66,-14,45
Airdrieon,1024,7,10,11,15,45,59,-14,41
Forfar,1024,8,11,5,20,39,64,-25,38
Queen's Park,1024,9,7,10,19,41,73,-32,31
Albion,1024,10,8,6,22,59,81,-22,30
Raith,1025,1,22,9,5,69,33,36,75
Ayr,1025,2,23,5,8,91,43,48,74
Alloa,1025,3,17,9,10,57,44,13,60
Arbroath,1025,4,17,8,11,70,49,21,59
Stranraer,1025,5,15,5,16,56,66,-10,50
East Fife,1025,6,14,3,19,49,65,-16,45
Airdrieon,1025,7,10,11,15,46,60,-14,41
Forfar,1025,8,11,5,20,40,65,-25,38
Albion,1025,9,8,7,21,58,79,-21,31
Queen's Park,1025,10,7,10,19,40,72,-32,31
Ayr,1026,1,24,4,8,95,46,49,76
Raith,1026,2,22,9,5,69,33,36,75
Alloa,1026,3,17,9,10,57,44,13,60
Arbroath,1026,4,17,8,11,71,51,20,59
Stranraer,1026,5,16,5,15,59,65,-6,53
East Fife,1026,6,13,3,20,48,68,-20,42
Airdrieon,1026,7,10,11,15,46,60,-14,41
Forfar,1026,8,11,5,20,40,65,-25,38
Queen's Park,1026,9,7,10,19,42,73,-31,31
Albion,1026,10,8,6,22,61,83,-22,30
Raith,1027,1,23,8,5,69,32,37,77
Ayr,1027,2,24,4,8,92,43,49,76
Arbroath,1027,3,18,8,10,72,48,24,62
Alloa,1027,4,17,8,11,56,44,12,59
Stranraer,1027,5,15,5,16,56,68,-12,50
East Fife,1027,6,14,3,19,51,65,-14,45
Airdrieon,1027,7,10,11,15,45,61,-16,41
Forfar,1027,8,11,5,20,41,64,-23,38
Albion,1027,9,8,6,22,58,80,-22,30
Queen's Park,1027,10,6,10,20,39,74,-35,28
Ayr,1028,1,24,4,8,98,47,51,76
Raith,1028,2,22,9,5,70,34,36,75
Arbroath,1028,3,18,8,10,72,48,24,62
Alloa,1028,4,17,9,10,58,45,13,60
Stranraer,1028,5,15,5,16,57,67,-10,50
East Fife,1028,6,14,3,19,50,66,-16,45
Airdrieon,1028,7,11,11,14,51,61,-10,44
Forfar,1028,8,10,5,21,41,70,-29,35
Albion,1028,9,8,6,22,62,86,-24,30
Queen's Park,1028,10,6,10,20,39,74,-35,28
Ayr,1029,1,24,4,8,93,44,49,76
Raith,1029,2,22,8,6,68,34,34,74
Alloa,1029,3,18,8,10,58,43,15,62
Arbroath,1029,4,17,8,11,70,49,21,59
Stranraer,1029,5,15,6,15,56,65,-9,51
Airdrieon,1029,6,11,11,14,47,58,-11,44
East Fife,1029,7,13,4,19,48,65,-17,43
Forfar,1029,8,10,5,21,38,66,-28,35
Queen's Park,1029,9,7,10,19,40,72,-32,31
Albion,1029,10,8,6,22,59,81,-22,30
Raith,1030,1,23,8,5,71,32,39,77
Ayr,1030,2,24,4,8,94,42,52,76
Arbroath,1030,3,18,8,10,72,48,24,62
Alloa,1030,4,17,8,11,56,46,10,59
Stranraer,1030,5,16,5,15,57,65,-8,53
East Fife,1030,6,13,3,20,48,66,-18,42
Airdrieon,1030,7,10,11,15,45,61,-16,41
Forfar,1030,8,11,5,20,41,64,-23,38
Albion,1030,9,8,6,22,57,82,-25,30
Queen's Park,1030,10,6,10,20,39,74,-35,28
Raith,1031,1,23,8,5,71,33,38,77
Ayr,1031,2,24,4,8,92,42,50,76
Arbroath,1031,3,18,8,10,72,48,24,62
Alloa,1031,4,17,8,11,57,46,11,59
Stranraer,1031,5,15,5,16,56,66,-10,50
East Fife,1031,6,14,3,19,49,65,-16,45
Airdrieon,1031,7,10,12,14,45,58,-13,42
Forfar,1031,8,10,6,20,38,64,-26,36
Albion,1031,9,8,6,22,57,80,-23,30
Queen's Park,1031,10,6,10,20,39,74,-35,28
Raith,1032,1,23,8,5,69,32,37,77
Ayr,1032,2,24,4,8,93,44,49,76
Arbroath,1032,3,18,8,10,72,48,24,62
Alloa,1032,4,17,8,11,56,44,12,59
Stranraer,1032,5,16,5,15,58,65,-7,53
Airdrieon,1032,6,11,11,14,46,58,-12,44
East Fife,1032,7,13,3,20,48,67,-19,42
Forfar,1032,8,10,5,21,38,65,-27,35
Albion,1032,9,8,6,22,59,81,-22,30
Queen's Park,1032,10,6,10,20,39,74,-35,28
Ayr,1033,1,24,4,8,93,42,51,76
Raith,1033,2,22,8,6,69,34,35,74
Alloa,1033,3,18,8,10,58,44,14,62
Arbroath,1033,4,17,9,10,71,49,22,60
Stranraer,1033,5,16,5,15,57,65,-8,53
Airdrieon,1033,6,11,11,14,48,60,-12,44
East Fife,1033,7,13,3,20,48,66,-18,42
Forfar,1033,8,10,5,21,40,67,-27,35
Albion,1033,9,8,6,22,57,81,-24,30
Queen's Park,1033,10,6,11,19,40,73,-33,29
Ayr,1034,1,24,4,8,101,43,58,76
Raith,1034,2,22,8,6,70,36,34,74
Arbroath,1034,3,18,8,10,72,48,24,62
Alloa,1034,4,18,8,10,60,45,15,62
Stranraer,1034,5,16,5,15,57,65,-8,53
Airdrieon,1034,6,10,12,14,46,59,-13,42
East Fife,1034,7,13,3,20,48,66,-18,42
Forfar,1034,8,10,6,20,39,65,-26,36
Albion,1034,9,8,6,22,58,89,-31,30
Queen's Park,1034,10,6,10,20,39,74,-35,28
Raith,1035,1,23,8,5,71,33,38,77
Ayr,1035,2,24,4,8,93,43,50,76
Arbroath,1035,3,17,9,10,71,49,22,60
Alloa,1035,4,17,8,11,57,46,11,59
Stranraer,1035,5,15,5,16,56,66,-10,50
East Fife,1035,6,14,3,19,49,65,-16,45
Airdrieon,1035,7,10,11,15,46,62,-16,41
Forfar,1035,8,11,5,20,42,65,-23,38
Albion,1035,9,8,6,22,58,81,-23,30
Queen's Park,1035,10,6,11,19,40,73,-33,29
Raith,1036,1,23,8,5,70,33,37,77
Ayr,1036,2,24,4,8,95,44,51,76
Arbroath,1036,3,17,8,11,70,49,21,59
Alloa,1036,4,17,8,11,57,45,12,59
Stranraer,1036,5,15,5,16,56,66,-10,50
East Fife,1036,6,14,3,19,49,65,-16,45
Airdrieon,1036,7,10,12,14,47,60,-13,42
Forfar,1036,8,10,6,20,40,66,-26,36
Queen's Park,1036,9,7,10,19,40,72,-32,31
Albion,1036,10,8,6,22,59,83,-24,30
Ayr,1037,1,24,4,8,98,42,56,76
Raith,1037,2,22,9,5,68,32,36,75
Arbroath,1037,3,18,8,10,73,49,24,62
Alloa,1037,4,17,9,10,56,43,13,60
Stranraer,1037,5,15,6,15,57,66,-9,51
East Fife,1037,6,13,4,19,49,66,-17,43
Airdrieon,1037,7,10,12,14,45,58,-13,42
Forfar,1037,8,10,6,20,38,64,-26,36
Albion,1037,9,8,6,22,57,86,-29,30
Queen's Park,1037,10,6,10,20,40,75,-35,28
Ayr,1038,1,23,5,8,91,43,48,74
Raith,1038,2,22,8,6,68,34,34,74
Alloa,1038,3,18,8,10,58,43,15,62
Arbroath,1038,4,17,8,11,71,51,20,59
Stranraer,1038,5,16,5,15,58,65,-7,53
Airdrieon,1038,6,10,12,14,47,60,-13,42
East Fife,1038,7,13,3,20,48,67,-19,42
Forfar,1038,8,10,6,20,40,66,-26,36
Albion,1038,9,8,7,21,58,79,-21,31
Queen's Park,1038,10,7,10,19,42,73,-31,31
Ayr,1039,1,24,4,8,96,46,50,76
Raith,1039,2,22,8,6,69,34,35,74
Alloa,1039,3,18,8,10,58,44,14,62
Arbroath,1039,4,17,8,11,71,50,21,59
Stranraer,1039,5,15,6,15,56,65,-9,51
Airdrieon,1039,6,11,11,14,48,60,-12,44
East Fife,1039,7,13,4,19,48,65,-17,43
Forfar,1039,8,10,5,21,40,67,-27,35
Queen's Park,1039,9,7,10,19,41,73,-32,31
Albion,1039,10,8,6,22,61,84,-23,30
Raith,1040,1,22,8,6,69,34,35,74
Ayr,1040,2,23,4,9,91,44,47,73
Arbroath,1040,3,18,8,10,72,48,24,62
Alloa,1040,4,18,8,10,58,44,14,62
Stranraer,1040,5,16,5,15,56,64,-8,53
Airdrieon,1040,6,10,12,14,47,60,-13,42
East Fife,1040,7,13,3,20,47,65,-18,42
Forfar,1040,8,10,6,20,40,66,-26,36
Albion,1040,9,9,6,21,59,79,-20,33
Queen's Park,1040,10,6,10,20,39,74,-35,28
Raith,1041,1,22,9,5,71,35,36,75
Ayr,1041,2,23,4,9,91,47,44,73
Alloa,1041,3,17,9,10,59,46,13,60
Arbroath,1041,4,17,8,11,71,50,21,59
Stranraer,1041,5,15,5,16,55,67,-12,50
East Fife,1041,6,14,3,19,50,64,-14,45
Airdrieon,1041,7,11,11,14,46,58,-12,44
Forfar,1041,8,10,5,21,38,65,-27,35
Albion,1041,9,9,6,21,62,79,-17,33
Queen's Park,1041,10,7,10,19,41,73,-32,31
Ayr,1042,1,24,4,8,94,43,51,76
Raith,1042,2,22,8,6,69,36,33,74
Arbroath,1042,3,18,8,10,72,49,23,62
Alloa,1042,4,18,8,10,60,44,16,62
Stranraer,1042,5,15,5,16,55,66,-11,50
East Fife,1042,6,14,3,19,49,64,-15,45
Airdrieon,1042,7,11,11,14,48,60,-12,44
Forfar,1042,8,10,5,21,40,67,-27,35
Albion,1042,9,8,6,22,58,82,-24,30
Queen's Park,1042,10,6,10,20,40,74,-34,28
Ayr,1043,1,24,4,8,94,45,49,76
Raith,1043,2,22,8,6,68,33,35,74
Alloa,1043,3,18,8,10,57,43,14,62
Arbroath,1043,4,17,8,11,71,52,19,59
Stranraer,1043,5,16,5,15,58,64,-6,53
East Fife,1043,6,13,3,20,47,67,-20,42
Airdrieon,1043,7,10,11,15,45,59,-14,41
Forfar,1043,8,11,5,20,39,64,-25,38
Queen's Park,1043,9,7,10,19,43,73,-30,31
Albion,1043,10,8,6,22,60,82,-22,30
Raith,1044,1,23,8,5,70,33,37,77
Ayr,1044,2,24,4,8,92,43,49,76
Arbroath,1044,3,18,8,10,71,48,23,62
Alloa,1044,4,17,8,11,57,45,12,59
Stranraer,1044,5,15,6,15,56,65,-9,51
East Fife,1044,6,13,4,19,48,65,-17,43
Airdrieon,1044,7,10,11,15,45,59,-14,41
Forfar,1044,8,11,5,20,39,64,-25,38
Albion,1044,9,8,6,22,58,80,-22,30
Queen's Park,1044,10,6,10,20,39,73,-34,28
Raith,1045,1,23,8,5,71,33,38,77
Ayr,1045,2,24,4,8,94,45,49,76
Arbroath,1045,3,18,8,10,73,50,23,62
Alloa,1045,4,17,8,11,57,46,11,59
Stranraer,1045,5,15,5,16,55,68,-13,50
East Fife,1045,6,14,3,19,51,64,-13,45
Airdrieon,1045,7,11,11,14,47,58,-11,44
Forfar,1045,8,10,5,21,38,66,-28,35
Albion,1045,9,8,6,22,60,82,-22,30
Queen's Park,1045,10,6,10,20,41,75,-34,28
Ayr,1046,1,24,4,8,94,45,49,76
Raith,1046,2,22,8,6,68,33,35,74
Arbroath,1046,3,18,8,10,74,50,24,62
Alloa,1046,4,18,8,10,57,43,14,62
Stranraer,1046,5,15,5,16,55,65,-10,50
East Fife,1046,6,14,3,19,48,64,-16,45
Airdrieon,1046,7,11,11,14,48,59,-11,44
Forfar,1046,8,10,5,21,39,67,-28,35
Albion,1046,9,8,6,22,60,82,-22,30
Queen's Park,1046,10,6,10,20,41,76,-35,28
Raith,1047,1,22,8,6,69,35,34,74
Ayr,1047,2,23,4,9,90,44,46,73
Arbroath,1047,3,18,8,10,72,49,23,62
Alloa,1047,4,18,8,10,59,44,15,62
Stranraer,1047,5,15,5,16,57,67,-10,50
East Fife,1047,6,14,3,19,50,66,-16,45
Airdrieon,1047,7,10,11,15,46,60,-14,41
Forfar,1047,8,11,5,20,40,65,-25,38
Albion,1047,9,9,6,21,59,78,-19,33
Queen's Park,1047,10,6,10,20,40,74,-34,28
Raith,1048,1,23,8,5,71,34,37,77
Ayr,1048,2,23,4,9,90,43,47,73
Arbroath,1048,3,17,9,10,73,51,22,60
Alloa,1048,4,17,8,11,58,46,12,59
Stranraer,1048,5,16,5,15,58,66,-8,53
East Fife,1048,6,13,3,20,49,67,-18,42
Airdrieon,1048,7,10,11,15,45,59,-14,41
Forfar,1048,8,11,5,20,39,64,-25,38
Albion,1048,9,9,6,21,58,78,-20,33
Queen's Park,1048,10,6,11,19,42,75,-33,29
Ayr,1049,1,24,4,8,95,43,52,76
Raith,1049,2,22,9,5,69,33,36,75
Arbroath,1049,3,18,8,10,71,48,23,62
Alloa,1049,4,17,9,10,57,44,13,60
Stranraer,1049,5,15,5,16,56,67,-11,50
East Fife,1049,6,14,3,19,50,65,-15,45
Airdrieon,1049,7,11,11,14,47,58,-11,44
Forfar,1049,8,10,5,21,38,66,-28,35
Albion,1049,9,8,6,22,58,83,-25,30
Queen's Park,1049,10,6,10,20,39,73,-34,28
Raith,1050,1,23,8,5,71,32,39,77
Ayr,1050,2,24,4,8,94,43,51,76
Arbroath,1050,3,18,8,10,72,48,24,62
Alloa,1050,4,17,8,11,56,46,10,59
Stranraer,1050,5,15,6,15,57,66,-9,51
Airdrieon,1050,6,11,11,14,47,59,-12,44
East Fife,1050,7,13,4,19,49,66,-17,43
Forfar,1050,8,10,5,21,39,66,-27,35
Albion,1050,9,8,6,22,58,82,-24,30
Queen's Park,1050,10,6,10,20,39,74,-35,28
Raith,1051,1,23,8,5,70,32,38,77
Ayr,1051,2,24,4,8,92,43,49,76
Arbroath,1051,3,18,8,10,73,50,23,62
Alloa,1051,4,17,8,11,56,45,11,59
Stranraer,1051,5,15,5,16,56,66,-10,50
East Fife,1051,6,14,3,19,49,65,-16,45
Airdrieon,1051,7,10,12,14,47,60,-13,42
Forfar,1051,8,10,6,20,40,66,-26,36
Albion,1051,9,8,6,22,58,80,-22,30
Queen's Park,1051,10,6,10,20,41,75,-34,28
Raith,1052,1,23,8,5,69,32,37,77
Ayr,1052,2,24,4,8,93,44,49,76
Arbroath,1052,3,17,8,11,70,49,21,59
Alloa,1052,4,17,8,11,56,44,12,59
Stranraer,1052,5,16,5,15,57,64,-7,53
Airdrieon,1052,6,10,12,14,47,60,-13,42
East Fife,1052,7,13,3,20,47,66,-19,42
Forfar,1052,8,10,6,20,40,66,-26,36
Queen's Park,1052,9,7,10,19,40,72,-32,31
Albion,1052,10,8,6,22,59,81,-22,30
Raith,1053,1,23,8,5,69,32,37,77
Ayr,1053,2,23,4,9,90,46,44,73
Arbroath,1053,3,17,9,10,72,50,22,60
Alloa,1053,4,17,8,11,56,44,12,59
Stranraer,1053,5,15,6,15,57,66,-9,51
Airdrieon,1053,6,11,11,14,48,59,-11,44
East Fife,1053,7,13,4,19,49,66,-17,43
Forfar,1053,8,10,5,21,39,67,-28,35
Albion,1053,9,9,6,21,61,78,-17,33
Queen's Park,1053,10,6,11,19,41,74,-33,29
Raith,1054,1,23,8,5,70,33,37,77
Ayr,1054,2,24,4,8,94,42,52,76
Arbroath,1054,3,18,8,10,73,48,25,62
Alloa,1054,4,17,8,11,57,45,12,59
Stranraer,1054,5,15,5,16,55,65,-10,50
East Fife,1054,6,14,3,19,48,64,-16,45
Airdrieon,1054,7,10,12,14,46,59,-13,42
Forfar,1054,8,10,6,20,39,65,-26,36
Albion,1054,9,8,6,22,57,82,-25,30
Queen's Park,1054,10,6,10,20,39,75,-36,28
Raith,1055,1,23,8,5,70,32,38,77
Ayr,1055,2,24,4,8,93,43,50,76
Arbroath,1055,3,17,8,11,71,51,20,59
Alloa,1055,4,17,8,11,56,45,11,59
Stranraer,1055,5,15,6,15,56,65,-9,51
East Fife,1055,6,13,4,19,48,65,-17,43
Airdrieon,1055,7,10,11,15,45,60,-15,41
Forfar,1055,8,11,5,20,40,64,-24,38
Queen's Park,1055,9,7,10,19,42,73,-31,31
Albion,1055,10,8,6,22,58,81,-23,30
Raith,1056,1,23,8,5,69,32,37,77
Ayr,1056,2,23,4,9,93,46,47,73
Arbroath,1056,3,17,8,11,70,49,21,59
Alloa,1056,4,17,8,11,56,44,12,59
Stranraer,1056,5,15,6,15,56,65,-9,51
Airdrieon,1056,6,11,11,14,47,58,-11,44
East Fife,1056,7,13,4,19,48,65,-17,43
Forfar,1056,8,10,5,21,38,66,-28,35
Albion,1056,9,9,6,21,61,81,-20,33
Queen's Park,1056,10,7,10,19,40,72,-32,31
Ayr,1057,1,24,4,8,92,42,50,76
Raith,1057,2,22,8,6,68,34,34,74
Alloa,1057,3,18,8,10,58,43,15,62
Arbroath,1057,4,17,8,11,71,51,20,59
Stranraer,1057,5,15,5,16,55,67,-12,50
East Fife,1057,6,14,3,19,50,64,-14,45
Airdrieon,1057,7,10,12,14,45,58,-13,42
Forfar,1057,8,10,6,20,38,64,-26,36
Queen's Park,1057,9,7,10,19,42,73,-31,31
Albion,1057,10,8,6,22,57,80,-23,30
Ayr,1058,1,24,4,8,92,43,49,76
Raith,1058,2,22,9,5,70,34,36,75
Alloa,1058,3,17,9,10,58,45,13,60
Arbroath,1058,4,17,8,11,71,50,21,59
Stranraer,1058,5,16,5,15,59,65,-6,53
Airdrieon,1058,6,11,11,14,46,58,-12,44
East Fife,1058,7,13,3,20,48,68,-20,42
Forfar,1058,8,10,5,21,38,65,-27,35
Queen's Park,1058,9,7,10,19,41,73,-32,31
Albion,1058,10,8,6,22,58,80,-22,30
Raith,1059,1,23,8,5,71,33,38,77
Ayr,1059,2,24,4,8,94,42,52,76
Arbroath,1059,3,18,8,10,72,48,24,62
Alloa,1059,4,17,8,11,57,46,11,59
Stranraer,1059,5,15,6,15,56,65,-9,51
Airdrieon,1059,6,11,11,14,48,59,-11,44
East Fife,1059,7,13,4,19,48,65,-17,43
Forfar,1059,8,10,5,21,39,67,-28,35
Albion,1059,9,8,6,22,57,82,-25,30
Queen's Park,1059,10,6,10,20,39,74,-35,28
Raith,1060,1,23,8,5,69,32,37,77
Ayr,1060,2,24,4,8,95,42,53,76
Arbroath,1060,3,17,9,10,72,50,22,60
Alloa,1060,4,17,8,11,56,44,12,59
Stranraer,1060,5,15,5,16,55,68,-13,50
East Fife,1060,6,14,3,19,51,64,-13,45
Airdrieon,1060,7,11,11,14,47,58,-11,44
Forfar,1060,8,10,5,21,38,66,-28,35
Albion,1060,9,8,6,22,57,83,-26,30
Queen's Park,1060,10,6,11,19,41,74,-33,29
Raith,1061,1,23,8,5,69,32,37,77
Ayr,1061,2,24,4,8,94,42,52,76
Arbroath,1061,3,17,8,11,70,49,21,59
Alloa,1061,4,17,8,11,56,44,12,59
Stranraer,1061,5,15,5,16,55,65,-10,50
East Fife,1061,6,14,3,19,48,64,-16,45
Airdrieon,1061,7,10,12,14,47,60,-13,42
Forfar,1061,8,10,6,20,40,66,-26,36
Queen's Park,1061,9,7,10,19,40,72,-32,31
Albion,1061,10,8,6,22,57,82,-25,30
Raith,1062,1,23,8,5,71,33,38,77
Ayr,1062,2,23,5,8,92,44,48,74
Arbroath,1062,3,17,9,10,72,50,22,60
Alloa,1062,4,17,8,11,57,46,11,59
Stranraer,1062,5,15,6,15,56,65,-9,51
Airdrieon,1062,6,11,11,14,48,59,-11,44
East Fife,1062,7,13,4,19,48,65,-17,43
Forfar,1062,8,10,5,21,39,67,-28,35
Albion,1062,9,8,7,21,59,80,-21,31
Queen's Park,1062,10,6,11,19,41,74,-33,29
Ayr,1063,1,24,4,8,94,42,52,76
Raith,1063,2,22,8,6,70,35,35,74
Alloa,1063,3,18,8,10,59,45,14,62
Arbroath,1063,4,17,8,11,70,49,21,59
Stranraer,1063,5,15,5,16,56,67,-11,50
East Fife,1063,6,14,3,19,50,65,-15,45
Airdrieon,1063,7,11,11,14,48,60,-12,44
Forfar,1063,8,10,5,21,40,67,-27,35
Queen's Park,1063,9,7,10,19,40,72,-32,31
Albion,1063,10,8,6,22,57,82,-25,30
Raith,1064,1,23,8,5,71,34,37,77
Ayr,1064,2,24,4,8,93,42,51,76
Arbroath,1064,3,18,8,10,71,48,23,62
Alloa,1064,4,17,8,11,58,46,12,59
Stranraer,1064,5,15,5,16,55,65,-10,50
East Fife,1064,6,14,3,19,48,64,-16,45
Airdrieon,1064,7,11,11,14,48,59,-11,44
Forfar,1064,8,10,5,21,39,67,-28,35
Albion,1064,9,8,6,22,57,81,-24,30
Queen's Park,1064,10,6,10,20,39,73,-34,28
Raith,1065,1,23,8,5,70,33,37,77
Ayr,1065,2,23,4,9,90,44,46,73
Arbroath,1065,3,17,8,11,71,50,21,59
Alloa,1065,4,17,8,11,57,45,12,59
Stranraer,1065,5,15,6,15,56,65,-9,51
Airdrieon,1065,6,11,11,14,48,59,-11,44
East Fife,1065,7,13,4,19,48,65,-17,43
Forfar,1065,8,10,5,21,39,67,-28,35
Albion,1065,9,9,6,21,59,78,-19,33
Queen's Park,1065,10,7,10,19,41,73,-32,31
Raith,1066,1,23,8,5,70,32,38,77
Ayr,1066,2,24,4,8,95,43,52,76
Arbroath,1066,3,18,8,10,74,50,24,62
Alloa,1066,4,17,8,11,56,45,11,59
Stranraer,1066,5,15,6,15,57,66,-9,51
Airdrieon,1066,6,11,11,14,46,58,-12,44
East Fife,1066,7,13,4,19,49,66,-17,43
Forfar,1066,8,10,5,21,38,65,-27,35
Albion,1066,9,8,6,22,58,83,-25,30
Queen's Park,1066,10,6,10,20,41,76,-35,28
Ayr,1067,1,24,4,8,93,43,50,76
Raith,1067,2,22,9,5,69,33,36,75
Arbroath,1067,3,17,9,10,71,49,22,60
Alloa,1067,4,17,9,10,57,44,13,60
Stranraer,1067,5,15,5,16,55,68,-13,50
East Fife,1067,6,14,3,19,51,64,-13,45
Airdrieon,1067,7,10,12,14,48,61,-13,42
Forfar,1067,8,10,6,20,41,67,-26,36
Albion,1067,9,8,6,22,58,81,-23,30
Queen's Park,1067,10,6,11,19,40,73,-33,29
Raith,1068,1,23,8,5,70,32,38,77
Ayr,1068,2,24,4,8,91,42,49,76
Arbroath,1068,3,17,8,11,70,49,21,59
Alloa,1068,4,17,8,11,56,45,11,59
Stranraer,1068,5,15,5,16,55,65,-10,50
East Fife,1068,6,14,3,19,48,64,-16,45
Airdrieon,1068,7,10,11,15,46,60,-14,41
Forfar,1068,8,11,5,20,40,65,-25,38
Queen's Park,1068,9,7,10,19,40,72,-32,31
Albion,1068,10,8,6,22,57,79,-22,30
Raith,1069,1,23,8,5,70,33,37,77
Ayr,1069,2,24,4,8,94,42,52,76
Arbroath,1069,3,17,9,10,71,49,22,60
Alloa,1069,4,17,8,11,57,45,12,59
Stranraer,1069,5,15,5,16,57,68,-11,50
East Fife,1069,6,14,3,19,51,66,-15,45
Airdrieon,1069,7,10,11,15,45,60,-15,41
Forfar,1069,8,11,5,20,40,64,-24,38
Albion,1069,9,8,6,22,57,82,-25,30
Queen's Park,1069,10,6,11,19,40,73,-33,29
Raith,1070,1,23,8,5,70,33,37,77
Ayr,1070,2,24,4,8,93,43,50,76
Arbroath,1070,3,17,8,11,71,50,21,59
Alloa,1070,4,17,8,11,57,45,12,59
Stranraer,1070,5,16,5,15,56,64,-8,53
Airdrieon,1070,6,11,11,14,48,60,-12,44
East Fife,1070,7,13,3,20,47,65,-18,42
Forfar,1070,8,10,5,21,40,67,-27,35
Queen's Park,1070,9,7,10,19,41,73,-32,31
Albion,1070,10,8,6,22,58,81,-23,30
Ayr,1071,1,24,4,8,94,43,51,76
Raith,1071,2,22,8,6,69,34,35,74
Alloa,1071,3,18,8,10,58,44,14,62
Arbroath,1071,4,17,8,11,71,51,20,59
Stranraer,1071,5,16,5,15,56,64,-8,53
East Fife,1071,6,13,3,20,47,65,-18,42
Airdrieon,1071,7,10,11,15,46,60,-14,41
Forfar,1071,8,11,5,20,40,65,-25,38
Queen's Park,1071,9,7,10,19,42,73,-31,31
Albion,1071,10,8,6,22,58,82,-24,30
Raith,1072,1,23,8,5,69,32,37,77
Ayr,1072,2,23,5,8,92,44,48,74
Arbroath,1072,3,18,8,10,73,49,24,62
Alloa,1072,4,17,8,11,56,44,12,59
Stranraer,1072,5,15,5,16,57,67,-10,50
East Fife,1072,6,14,3,19,50,66,-16,45
Airdrieon,1072,7,11,11,14,46,58,-12,44
Forfar,1072,8,10,5,21,38,65,-27,35
Albion,1072,9,8,7,21,59,80,-21,31
Queen's Park,1072,10,6,10,20,40,75,-35,28
Raith,1073,1,23,8,5,71,33,38,77
Ayr,1073,2,24,4,8,93,43,50,76
Arbroath,1073,3,17,8,11,71,52,19,59
Alloa,1073,4,17,8,11,57,46,11,59
Stranraer,1073,5,15,5,16,57,67,-10,50
East Fife,1073,6,14,3,19,50,66,-16,45
Airdrieon,1073,7,11,11,14,47,58,-11,44
Forfar,1073,8,10,5,21,38,66,-28,35
Queen's Park,1073,9,7,10,19,43,73,-30,31
Albion,1073,10,8,6,22,58,81,-23,30
Raith,1074,1,23,8,5,73,32,41,77
Ayr,1074,2,24,4,8,92,42,50,76
Arbroath,1074,3,18,8,10,73,49,24,62
Alloa,1074,4,17,8,11,56,48,8,59
Stranraer,1074,5,15,5,16,56,68,-12,50
East Fife,1074,6,14,3,19,51,65,-14,45
Airdrieon,1074,7,10,12,14,45,58,-13,42
Forfar,1074,8,10,6,20,38,64,-26,36
Albion,1074,9,8,6,22,57,80,-23,30
Queen's Park,1074,10,6,10,20,40,75,-35,28
Raith,1075,1,23,8,5,70,32,38,77
Ayr,1075,2,23,4,9,92,45,47,73
Arbroath,1075,3,18,8,10,73,48,25,62
Alloa,1075,4,17,8,11,56,45,11,59
Stranraer,1075,5,16,5,15,60,65,-5,53
Airdrieon,1075,6,11,11,14,51,60,-9,44
East Fife,1075,7,13,3,20,48,69,-21,42
Forfar,1075,8,10,5,21,40,70,-30,35
Albion,1075,9,9,6,21,60,80,-20,33
Queen's Park,1075,10,6,10,20,39,75,-36,28
Raith,1076,1,23,8,5,70,32,38,77
Ayr,1076,2,24,4,8,96,43,53,76
Arbroath,1076,3,18,8,10,72,48,24,62
Alloa,1076,4,17,8,11,56,45,11,59
Stranraer,1076,5,15,5,16,56,67,-11,50
East Fife,1076,6,14,3,19,50,65,-15,45
Airdrieon,1076,7,10,12,14,45,58,-13,42
Forfar,1076,8,10,6,20,38,64,-26,36
Albion,1076,9,8,6,22,58,84,-26,30
Queen's Park,1076,10,6,10,20,39,74,-35,28
Ayr,1077,1,24,4,8,93,42,51,76
Raith,1077,2,22,8,6,68,33,35,74
Arbroath,1077,3,18,8,10,75,50,25,62
Alloa,1077,4,18,8,10,57,43,14,62
Stranraer,1077,5,15,5,16,56,66,-10,50
East Fife,1077,6,14,3,19,49,65,-16,45
Airdrieon,1077,7,11,11,14,47,59,-12,44
Forfar,1077,8,10,5,21,39,66,-27,35
Albion,1077,9,8,6,22,57,81,-24,30
Queen's Park,1077,10,6,10,20,41,77,-36,28
Raith,1078,1,23,8,5,71,34,37,77
Ayr,1078,2,24,4,8,93,42,51,76
Arbroath,1078,3,17,8,11,70,49,21,59
Alloa,1078,4,17,8,11,58,46,12,59
Stranraer,1078,5,15,5,16,57,67,-10,50
East Fife,1078,6,14,3,19,50,66,-16,45
Airdrieon,1078,7,11,11,14,48,58,-10,44
Forfar,1078,8,10,5,21,38,67,-29,35
Queen's Park,1078,9,7,10,19,40,72,-32,31
Albion,1078,10,8,6,22,57,81,-24,30
Raith,1079,1,23,8,5,71,34,37,77
Ayr,1079,2,24,4,8,92,43,49,76
Arbroath,1079,3,18,8,10,72,48,24,62
Alloa,1079,4,17,8,11,58,46,12,59
Stranraer,1079,5,16,5,15,57,65,-8,53
Airdrieon,1079,6,11,11,14,47,59,-12,44
East Fife,1079,7,13,3,20,48,66,-18,42
Forfar,1079,8,10,5,21,39,66,-27,35
Albion,1079,9,8,6,22,58,80,-22,30
Queen's Park,1079,10,6,10,20,39,74,-35,28
Raith,1080,1,23,8,5,70,32,38,77
Ayr,1080,2,24,4,8,91,42,49,76
Arbroath,1080,3,18,8,10,73,48,25,62
Alloa,1080,4,17,8,11,56,45,11,59
Stranraer,1080,5,16,5,15,58,65,-7,53
East Fife,1080,6,13,3,20,48,67,-19,42
Airdrieon,1080,7,10,11,15,45,59,-14,41
Forfar,1080,8,11,5,20,39,64,-25,38
Albion,1080,9,8,6,22,57,79,-22,30
Queen's Park,1080,10,6,10,20,39,75,-36,28
Raith,1081,1,23,8,5,69,32,37,77
Ayr,1081,2,24,4,8,93,44,49,76
Arbroath,1081,3,17,9,10,70,48,22,60
Alloa,1081,4,17,8,11,56,44,12,59
Stranraer,1081,5,15,5,16,56,68,-12,50
East Fife,1081,6,14,3,19,51,65,-14,45
Airdrieon,1081,7,11,11,14,48,59,-11,44
Forfar,1081,8,10,5,21,39,67,-28,35
Albion,1081,9,8,6,22,59,81,-22,30
Queen's Park,1081,10,6,11,19,39,72,-33,29
Ayr,1082,1,24,4,8,94,43,51,76
Raith,1082,2,22,9,5,70,34,36,75
Arbroath,1082,3,17,9,10,72,50,22,60
Alloa,1082,4,17,9,10,58,45,13,60
Stranraer,1082,5,15,5,16,57,68,-11,50
East Fife,1082,6,14,3,19,51,66,-15,45
Airdrieon,1082,7,11,11,14,46,58,-12,44
Forfar,1082,8,10,5,21,38,65,-27,35
Albion,1082,9,8,6,22,58,82,-24,30
Queen's Park,1082,10,6,11,19,41,74,-33,29
Ayr,1083,1,24,4,8,92,43,49,76
Raith,1083,2,22,8,6,68,34,34,74
Arbroath,1083,3,18,8,10,74,51,23,62
Alloa,1083,4,18,8,10,58,43,15,62
Stranraer,1083,5,15,5,16,56,66,-10,50
East Fife,1083,6,14,3,19,49,65,-16,45
Airdrieon,1083,7,10,12,14,47,60,-13,42
Forfar,1083,8,10,6,20,40,66,-26,36
Albion,1083,9,8,6,22,58,80,-22,30
Queen's Park,1083,10,6,10,20,42,76,-34,28
Raith,1084,1,23,8,5,69,32,37,77
Ayr,1084,2,24,4,8,93,43,50,76
Arbroath,1084,3,18,8,10,73,49,24,62
Alloa,1084,4,17,8,11,56,44,12,59
Stranraer,1084,5,16,5,15,58,66,-8,53
Airdrieon,1084,6,11,11,14,46,58,-12,44
East Fife,1084,7,13,3,20,49,67,-18,42
Forfar,1084,8,10,5,21,38,65,-27,35
Albion,1084,9,8,6,22,58,81,-23,30
Queen's Park,1084,10,6,10,20,40,75,-35,28
Raith,1085,1,23,8,5,69,32,37,77
Ayr,1085,2,23,5,8,93,45,48,74
Arbroath,1085,3,18,8,10,75,48,27,62
Alloa,1085,4,17,8,11,56,44,12,59
Stranraer,1085,5,15,6,15,56,65,-9,51
East Fife,1085,6,13,4,19,48,65,-17,43
Airdrieon,1085,7,10,11,15,48,62,-14,41
Forfar,1085,8,11,5,20,42,67,-25,38
Albion,1085,9,8,7,21,60,81,-21,31
Queen's Park,1085,10,6,10,20,39,77,-38,28
Raith,1086,1,23,8,5,70,33,37,77
Ayr,1086,2,24,4,8,93,44,49,76
Arbroath,1086,3,17,8,11,71,52,19,59
Alloa,1086,4,17,8,11,57,45,12,59
Stranraer,1086,5,15,5,16,56,66,-10,50
East Fife,1086,6,14,3,19,49,65,-16,45
Airdrieon,1086,7,11,11,14,46,58,-12,44
Forfar,1086,8,10,5,21,38,65,-27,35
Queen's Park,1086,9,7,10,19,43,73,-30,31
Albion,1086,10,8,6,22,59,81,-22,30
Raith,1087,1,23,8,5,70,33,37,77
Ayr,1087,2,24,4,8,93,43,50,76
Arbroath,1087,3,17,8,11,71,50,21,59
Alloa,1087,4,17,8,11,57,45,12,59
Stranraer,1087,5,15,5,16,57,68,-11,50
East Fife,1087,6,14,3,19,51,66,-15,45
Airdrieon,1087,7,11,11,14,47,58,-11,44
Forfar,1087,8,10,5,21,38,66,-28,35
Queen's Park,1087,9,7,10,19,41,73,-32,31
Albion,1087,10,8,6,22,58,81,-23,30
Ayr,1088,1,24,4,8,94,42,52,76
Raith,1088,2,22,9,5,68,32,36,75
Arbroath,1088,3,18,8,10,71,48,23,62
Alloa,1088,4,17,9,10,56,43,13,60
Stranraer,1088,5,15,5,16,55,65,-10,50
East Fife,1088,6,14,3,19,48,64,-16,45
Airdrieon,1088,7,11,11,14,47,59,-12,44
Forfar,1088,8,10,5,21,39,66,-27,35
Albion,1088,9,8,6,22,57,82,-25,30
Queen's Park,1088,10,6,10,20,39,73,-34,28
Ayr,1089,1,24,4,8,96,42,54,76
Raith,1089,2,22,9,5,68,32,36,75
Alloa,1089,3,17,9,10,56,43,13,60
Arbroath,1089,4,17,8,11,71,51,20,59
Stranraer,1089,5,15,5,16,56,67,-11,50
East Fife,1089,6,14,3,19,50,65,-15,45
Airdrieon,1089,7,11,11,14,47,59,-12,44
Forfar,1089,8,10,5,21,39,66,-27,35
Queen's Park,1089,9,7,10,19,42,73,-31,31
Albion,1089,10,8,6,22,57,84,-27,30
Ayr,1090,1,24,4,8,95,43,52,76
Raith,1090,2,22,8,6,68,35,33,74
Alloa,1090,3,18,8,10,59,43,16,62
Arbroath,1090,4,17,9,10,71,49,22,60
Stranraer,1090,5,16,5,15,57,64,-7,53
Airdrieon,1090,6,10,12,14,45,58,-13,42
East Fife,1090,7,13,3,20,47,66,-19,42
Forfar,1090,8,10,6,20,38,64,-26,36
Albion,1090,9,8,6,22,58,83,-25,30
Queen's Park,1090,10,6,11,19,40,73,-33,29
Raith,1091,1,23,8,5,70,32,38,77
Ayr,1091,2,24,4,8,95,43,52,76
Arbroath,1091,3,17,9,10,71,49,22,60
Alloa,1091,4,17,8,11,56,45,11,59
Stranraer,1091,5,15,5,16,56,68,-12,50
East Fife,1091,6,14,3,19,51,65,-14,45
Airdrieon,1091,7,11,11,14,47,58,-11,44
Forfar,1091,8,10,5,21,38,66,-28,35
Albion,1091,9,8,6,22,58,83,-25,30
Queen's Park,1091,10,6,11,19,40,73,-33,29
Raith,1092,1,23,8,5,70,32,38,77
Ayr,1092,2,24,4,8,92,43,49,76
Arbroath,1092,3,17,9,10,72,50,22,60
Alloa,1092,4,17,8,11,56,45,11,59
Stranraer,1092,5,15,5,16,55,65,-10,50
East Fife,1092,6,14,3,19,48,64,-16,45
Airdrieon,1092,7,10,12,14,46,59,-13,42
Forfar,1092,8,10,6,20,39,65,-26,36
Albion,1092,9,8,6,22,58,80,-22,30
Queen's Park,1092,10,6,11,19,41,74,-33,29
Raith,1093,1,22,9,5,69,33,36,75
Ayr,1093,2,23,5,8,91,43,48,74
Arbroath,1093,3,17,9,10,72,50,22,60
Alloa,1093,4,17,9,10,57,44,13,60
Stranraer,1093,5,15,6,15,56,65,-9,51
Airdrieon,1093,6,11,11,14,47,59,-12,44
East Fife,1093,7,13,4,19,48,65,-17,43
Forfar,1093,8,10,5,21,39,66,-27,35
Albion,1093,9,8,7,21,58,79,-21,31
Queen's Park,1093,10,6,11,19,41,74,-33,29
Raith,1094,1,23,8,5,69,32,37,77
Ayr,1094,2,24,4,8,93,43,50,76
Arbroath,1094,3,17,8,11,71,50,21,59
Alloa,1094,4,17,8,11,56,44,12,59
Stranraer,1094,5,15,5,16,56,67,-11,50
East Fife,1094,6,14,3,19,50,65,-15,45
Airdrieon,1094,7,10,11,15,45,59,-14,41
Forfar,1094,8,11,5,20,39,64,-25,38
Queen's Park,1094,9,7,10,19,41,73,-32,31
Albion,1094,10,8,6,22,58,81,-23,30
Raith,1095,1,23,8,5,70,33,37,77
Ayr,1095,2,24,4,8,92,43,49,76
Arbroath,1095,3,18,8,10,74,50,24,62
Alloa,1095,4,17,8,11,57,45,12,59
Stranraer,1095,5,15,6,15,58,67,-9,51
Airdrieon,1095,6,11,11,14,48,59,-11,44
East Fife,1095,7,13,4,19,50,67,-17,43
Forfar,1095,8,10,5,21,39,67,-28,35
Albion,1095,9,8,6,22,58,80,-22,30
Queen's Park,1095,10,6,10,20,41,76,-35,28
Ayr,1096,1,24,4,8,95,42,53,76
Raith,1096,2,22,9,5,68,32,36,75
Arbroath,1096,3,17,9,10,72,50,22,60
Alloa,1096,4,17,9,10,56,43,13,60
Stranraer,1096,5,15,5,16,56,66,-10,50
East Fife,1096,6,14,3,19,49,65,-16,45
Airdrieon,1096,7,10,11,15,46,60,-14,41
Forfar,1096,8,11,5,20,40,65,-25,38
Albion,1096,9,8,6,22,57,83,-26,30
Queen's Park,1096,10,6,11,19,41,74,-33,29
Ayr,1097,1,24,4,8,94,42,52,76
Raith,1097,2,22,9,5,70,34,36,75
Arbroath,1097,3,18,8,10,74,48,26,62
Alloa,1097,4,17,9,10,58,45,13,60
Stranraer,1097,5,15,6,15,57,66,-9,51
East Fife,1097,6,13,4,19,49,66,-17,43
Airdrieon,1097,7,10,12,14,45,58,-13,42
Forfar,1097,8,10,6,20,38,64,-26,36
Albion,1097,9,8,6,22,57,82,-25,30
Queen's Park,1097,10,6,10,20,39,76,-37,28
Raith,1098,1,22,9,5,69,33,36,75
Ayr,1098,2,23,5,8,92,44,48,74
Alloa,1098,3,17,9,10,57,44,13,60
Arbroath,1098,4,17,8,11,71,51,20,59
Stranraer,1098,5,16,5,15,56,64,-8,53
Airdrieon,1098,6,11,11,14,47,59,-12,44
East Fife,1098,7,13,3,20,47,65,-18,42
Forfar,1098,8,10,5,21,39,66,-27,35
Albion,1098,9,8,7,21,59,80,-21,31
Queen's Park,1098,10,7,10,19,42,73,-31,31
Raith,1099,1,23,8,5,69,32,37,77
Ayr,1099,2,24,4,8,93,43,50,76
Arbroath,1099,3,17,9,10,72,50,22,60
Alloa,1099,4,17,8,11,56,44,12,59
Stranraer,1099,5,15,5,16,56,67,-11,50
East Fife,1099,6,14,3,19,50,65,-15,45
Airdrieon,1099,7,10,11,15,46,60,-14,41
Forfar,1099,8,11,5,20,40,65,-25,38
Albion,1099,9,8,6,22,58,81,-23,30
Queen's Park,1099,10,6,11,19,41,74,-33,29
Ayr,1100,1,24,4,8,93,44,49,76
Raith,1100,2,22,9,5,69,33,36,75
Arbroath,1100,3,17,9,10,73,51,22,60
Alloa,1100,4,17,9,10,57,44,13,60
Stranraer,1100,5,15,5,16,55,65,-10,50
East Fife,1100,6,14,3,19,48,64,-16,45
Airdrieon,1100,7,11,11,14,50,58,-8,44
Forfar,1100,8,10,5,21,38,69,-31,35
Albion,1100,9,8,6,22,59,81,-22,30
Queen's Park,1100,10,6,11,19,42,75,-33,29
Raith,1101,1,23,8,5,72,32,40,77
Ayr,1101,2,24,4,8,93,42,51,76
Arbroath,1101,3,18,8,10,73,48,25,62
Alloa,1101,4,17,8,11,56,47,9,59
Stranraer,1101,5,16,5,15,57,64,-7,53
Airdrieon,1101,6,11,11,14,47,58,-11,44
East Fife,1101,7,13,3,20,47,66,-19,42
Forfar,1101,8,10,5,21,38,66,-28,35
Albion,1101,9,8,6,22,57,81,-24,30
Queen's Park,1101,10,6,10,20,39,75,-36,28
Raith,1102,1,23,8,5,69,32,37,77
Ayr,1102,2,24,4,8,96,43,53,76
Arbroath,1102,3,17,8,11,72,51,21,59
Alloa,1102,4,17,8,11,56,44,12,59
Stranraer,1102,5,15,5,16,56,67,-11,50
East Fife,1102,6,14,3,19,50,65,-15,45
Airdrieon,1102,7,10,12,14,46,59,-13,42
Forfar,1102,8,10,6,20,39,65,-26,36
Queen's Park,1102,9,7,10,19,42,74,-32,31
Albion,1102,10,8,6,22,58,84,-26,30
Raith,1103,1,23,8,5,69,32,37,77
Ayr,1103,2,23,4,9,92,45,47,73
Arbroath,1103,3,17,8,11,70,49,21,59
Alloa,1103,4,17,8,11,56,44,12,59
Stranraer,1103,5,16,5,15,60,66,-6,53
Airdrieon,1103,6,11,11,14,49,61,-12,44
East Fife,1103,7,13,3,20,49,69,-20,42
Forfar,1103,8,10,5,21,41,68,-27,35
Albion,1103,9,9,6,21,60,80,-20,33
Queen's Park,1103,10,7,10,19,40,72,-32,31
Raith,1104,1,23,8,5,70,33,37,77
Ayr,1104,2,24,4,8,95,42,53,76
Arbroath,1104,3,17,9,10,72,50,22,60
Alloa,1104,4,17,8,11,57,45,12,59
Stranraer,1104,5,15,5,16,55,66,-11,50
East Fife,1104,6,14,3,19,49,64,-15,45
Airdrieon,1104,7,11,11,14,47,58,-11,44
Forfar,1104,8,10,5,21,38,66,-28,35
Albion,1104,9,8,6,22,57,83,-26,30
Queen's Park,1104,10,6,11,19,41,74,-33,29
Ayr,1105,1,24,4,8,93,44,49,76
Raith,1105,2,22,8,6,69,34,35,74
Alloa,1105,3,18,8,10,58,44,14,62
Arbroath,1105,4,17,8,11,72,51,21,59
Stranraer,1105,5,16,5,15,58,65,-7,53
East Fife,1105,6,13,3,20,48,67,-19,42
Airdrieon,1105,7,10,11,15,47,61,-14,41
Forfar,1105,8,11,5,20,41,66,-25,38
Queen's Park,1105,9,7,10,19,42,74,-32,31
Albion,1105,10,8,6,22,59,81,-22,30
Raith,1106,1,23,8,5,71,33,38,77
Ayr,1106,2,24,4,8,92,43,49,76
Arbroath,1106,3,17,8,11,71,50,21,59
Alloa,1106,4,17,8,11,57,46,11,59
Stranraer,1106,5,15,5,16,55,67,-12,50
East Fife,1106,6,14,3,19,50,64,-14,45
Airdrieon,1106,7,10,12,14,46,59,-13,42
Forfar,1106,8,10,6,20,39,65,-26,36
Queen's Park,1106,9,7,10,19,41,73,-32,31
Albion,1106,10,8,6,22,58,80,-22,30
Ayr,1107,1,23,5,8,94,46,48,74
Raith,1107,2,22,8,6,69,34,35,74
Arbroath,1107,3,18,8,10,71,48,23,62
Alloa,1107,4,18,8,10,58,44,14,62
Stranraer,1107,5,16,5,15,58,65,-7,53
Airdrieon,1107,6,11,11,14,47,59,-12,44
East Fife,1107,7,13,3,20,48,67,-19,42
Forfar,1107,8,10,5,21,39,66,-27,35
Albion,1107,9,8,7,21,61,82,-21,31
Queen's Park,1107,10,6,10,20,39,73,-34,28
Ayr,1108,1,24,4,8,93,44,49,76
Raith,1108,2,22,8,6,69,34,35,74
Arbroath,1108,3,18,8,10,74,49,25,62
Alloa,1108,4,18,8,10,58,44,14,62
Stranraer,1108,5,15,6,15,57,66,-9,51
East Fife,1108,6,13,4,19,49,66,-17,43
Airdrieon,1108,7,10,12,14,46,59,-13,42
Forfar,1108,8,10,6,20,39,65,-26,36
Albion,1108,9,8,6,22,59,81,-22,30
Queen's Park,1108,10,6,10,20,40,76,-36,28
Raith,1109,1,23,8,5,70,33,37,77
Ayr,1109,2,24,4,8,94,43,51,76
Arbroath,1109,3,17,8,11,71,50,21,59
Alloa,1109,4,17,8,11,57,45,12,59
Stranraer,1109,5,15,6,15,59,68,-9,51
East Fife,1109,6,13,4,19,51,68,-17,43
Airdrieon,1109,7,10,12,14,46,59,-13,42
Forfar,1109,8,10,6,20,39,65,-26,36
Queen's Park,1109,9,7,10,19,41,73,-32,31
Albion,1109,10,8,6,22,58,82,-24,30
Raith,1110,1,23,8,5,71,33,38,77
Ayr,1110,2,24,4,8,93,44,49,76
Arbroath,1110,3,17,9,10,72,50,22,60
Alloa,1110,4,17,8,11,57,46,11,59
Stranraer,1110,5,16,5,15,58,66,-8,53
Airdrieon,1110,6,11,11,14,46,58,-12,44
East Fife,1110,7,13,3,20,49,67,-18,42
Forfar,1110,8,10,5,21,38,65,-27,35
Albion,1110,9,8,6,22,59,81,-22,30
Queen's Park,1110,10,6,11,19,41,74,-33,29
Raith,1111,1,23,8,5,70,33,37,77
Ayr,1111,2,23,5,8,90,42,48,74
Arbroath,1111,3,17,8,11,71,50,21,59
Alloa,1111,4,17,8,11,57,45,12,59
Stranraer,1111,5,15,5,16,55,68,-13,50
East Fife,1111,6,14,3,19,51,64,-13,45
Airdrieon,1111,7,11,11,14,48,58,-10,44
Forfar,1111,8,10,5,21,38,67,-29,35
Albion,1111,9,8,7,21,57,78,-21,31
Queen's Park,1111,10,7,10,19,41,73,-32,31
Ayr,1112,1,24,4,8,92,43,49,76
Raith,1112,2,22,9,5,69,33,36,75
Arbroath,1112,3,18,8,10,71,48,23,62
Alloa,1112,4,17,9,10,57,44,13,60
Stranraer,1112,5,15,6,15,56,65,-9,51
Airdrieon,1112,6,11,11,14,49,58,-9,44
East Fife,1112,7,13,4,19,48,65,-17,43
Forfar,1112,8,10,5,21,38,68,-30,35
Albion,1112,9,8,6,22,58,80,-22,30
Queen's Park,1112,10,6,10,20,39,73,-34,28
Raith,1113,1,23,8,5,73,32,41,77
Ayr,1113,2,24,4,8,92,43,49,76
Arbroath,1113,3,17,9,10,71,49,22,60
Alloa,1113,4,17,8,11,56,48,8,59
Stranraer,1113,5,15,6,15,55,64,-9,51
East Fife,1113,6,13,4,19,47,64,-17,43
Airdrieon,1113,7,10,12,14,46,59,-13,42
Forfar,1113,8,10,6,20,39,65,-26,36
Albion,1113,9,8,6,22,58,80,-22,30
Queen's Park,1113,10,6,11,19,40,73,-33,29
Raith,1114,1,23,8,5,71,33,38,77
Ayr,1114,2,23,4,9,91,44,47,73
Arbroath,1114,3,18,8,10,73,50,23,62
Alloa,1114,4,17,8,11,57,46,11,59
Stranraer,1114,5,15,5,16,56,67,-11,50
East Fife,1114,6,14,3,19,50,65,-15,45
Airdrieon,1114,7,10,11,15,45,59,-14,41
Forfar,1114,8,11,5,20,39,64,-25,38
Albion,1114,9,9,6,21,59,79,-20,33
Queen's Park,1114,10,6,10,20,41,75,-34,28
Raith,1115,1,23,8,5,70,32,38,77
Ayr,1115,2,24,4,8,91,42,49,76
Arbroath,1115,3,18,8,10,73,48,25,62
Alloa,1115,4,17,8,11,56,45,11,59
Stranraer,1115,5,16,5,15,58,65,-7,53
Airdrieon,1115,6,10,12,14,46,59,-13,42
East Fife,1115,7,13,3,20,48,67,-19,42
Forfar,1115,8,10,6,20,39,65,-26,36
Albion,1115,9,8,6,22,57,79,-22,30
Queen's Park,1115,10,6,10,20,39,75,-36,28
Ayr,1116,1,24,4,8,94,42,52,76
Raith,1116,2,22,8,6,68,33,35,74
Alloa,1116,3,18,8,10,57,43,14,62
Arbroath,1116,4,17,8,11,71,50,21,59
Stranraer,1116,5,15,5,16,56,68,-12,50
East Fife,1116,6,14,3,19,51,65,-14,45
Airdrieon,1116,7,11,11,14,49,59,-10,44
Forfar,1116,8,10,5,21,39,68,-29,35
Queen's Park,1116,9,7,10,19,41,73,-32,31
Albion,1116,10,8,6,22,57,82,-25,30
Ayr,1117,1,24,4,8,96,42,54,76
Raith,1117,2,22,8,6,69,35,34,74
Arbroath,1117,3,18,8,10,75,49,26,62
Alloa,1117,4,18,8,10,59,44,15,62
Stranraer,1117,5,15,5,16,55,66,-11,50
East Fife,1117,6,14,3,19,49,64,-15,45
Airdrieon,1117,7,11,11,14,48,58,-10,44
Forfar,1117,8,10,5,21,38,67,-29,35
Albion,1117,9,8,6,22,57,84,-27,30
Queen's Park,1117,10,6,10,20,40,77,-37,28
Ayr,1118,1,24,4,8,93,42,51,76
Raith,1118,2,22,8,6,69,34,35,74
Alloa,1118,3,18,8,10,58,44,14,62
Arbroath,1118,4,17,8,11,71,50,21,59
Stranraer,1118,5,16,5,15,57,65,-8,53
Airdrieon,1118,6,11,11,14,48,60,-12,44
East Fife,1118,7,13,3,20,48,66,-18,42
Forfar,1118,8,10,5,21,40,67,-27,35
Queen's Park,1118,9,7,10,19,41,73,-32,31
Albion,1118,10,8,6,22,57,81,-24,30
Ayr,1119,1,24,4,8,93,42,51,76
Raith,1119,2,22,8,6,69,34,35,74
Alloa,1119,3,18,8,10,58,44,14,62
Arbroath,1119,4,17,8,11,71,53,18,59
Stranraer,1119,5,15,5,16,55,67,-12,50
East Fife,1119,6,14,3,19,50,64,-14,45
Airdrieon,1119,7,11,11,14,47,59,-12,44
Forfar,1119,8,10,5,21,39,66,-27,35
Queen's Park,1119,9,7,10,19,44,73,-29,31
Albion,1119,10,8,6,22,57,81,-24,30
Raith,1120,1,23,8,5,70,33,37,77
Ayr,1120,2,23,5,8,92,44,48,74
Arbroath,1120,3,18,8,10,71,48,23,62
Alloa,1120,4,17,8,11,57,45,12,59
Stranraer,1120,5,16,5,15,57,65,-8,53
Airdrieon,1120,6,11,11,14,48,58,-10,44
East Fife,1120,7,13,3,20,48,66,-18,42
Forfar,1120,8,10,5,21,38,67,-29,35
Albion,1120,9,8,7,21,59,80,-21,31
Queen's Park,1120,10,6,10,20,39,73,-34,28
Ayr,1121,1,23,5,8,92,44,48,74
Raith,1121,2,22,8,6,69,34,35,74
Alloa,1121,3,18,8,10,58,44,14,62
Arbroath,1121,4,17,8,11,72,51,21,59
Stranraer,1121,5,16,5,15,58,66,-8,53
Airdrieon,1121,6,10,12,14,45,58,-13,42
East Fife,1121,7,13,3,20,49,67,-18,42
Forfar,1121,8,10,6,20,38,64,-26,36
Albion,1121,9,8,7,21,59,80,-21,31
Queen's Park,1121,10,7,10,19,42,74,-32,31
Raith,1122,1,23,8,5,71,33,38,77
Ayr,1122,2,24,4,8,93,44,49,76
Arbroath,1122,3,17,9,10,70,48,22,60
Alloa,1122,4,17,8,11,57,46,11,59
Stranraer,1122,5,16,5,15,57,64,-7,53
Airdrieon,1122,6,10,12,14,48,61,-13,42
East Fife,1122,7,13,3,20,47,66,-19,42
Forfar,1122,8,10,6,20,41,67,-26,36
Albion,1122,9,8,6,22,59,81,-22,30
Queen's Park,1122,10,6,11,19,39,72,-33,29
Raith,1123,1,23,8,5,71,33,38,77
Ayr,1123,2,24,4,8,93,44,49,76
Arbroath,1123,3,17,9,10,70,48,22,60
Alloa,1123,4,17,8,11,57,46,11,59
Stranraer,1123,5,16,5,15,57,65,-8,53
Airdrieon,1123,6,11,11,14,47,59,-12,44
East Fife,1123,7,13,3,20,48,66,-18,42
Forfar,1123,8,10,5,21,39,66,-27,35
Albion,1123,9,8,6,22,59,81,-22,30
Queen's Park,1123,10,6,11,19,39,72,-33,29
Ayr,1124,1,24,4,8,92,42,50,76
Raith,1124,2,22,9,5,69,33,36,75
Alloa,1124,3,17,9,10,57,44,13,60
Arbroath,1124,4,17,8,11,71,50,21,59
Stranraer,1124,5,15,5,16,55,67,-12,50
East Fife,1124,6,14,3,19,50,64,-14,45
Airdrieon,1124,7,10,11,15,46,61,-15,41
Forfar,1124,8,11,5,20,41,65,-24,38
Queen's Park,1124,9,7,10,19,41,73,-32,31
Albion,1124,10,8,6,22,57,80,-23,30
Raith,1125,1,23,8,5,70,32,38,77
Ayr,1125,2,24,4,8,94,44,50,76
Arbroath,1125,3,17,9,10,71,49,22,60
Alloa,1125,4,17,8,11,56,45,11,59
Stranraer,1125,5,15,6,15,56,65,-9,51
East Fife,1125,6,13,4,19,48,65,-17,43
Airdrieon,1125,7,10,11,15,45,60,-15,41
Forfar,1125,8,11,5,20,40,64,-24,38
Albion,1125,9,8,6,22,59,82,-23,30
Queen's Park,1125,10,6,11,19,40,73,-33,29
Raith,1126,1,23,8,5,69,32,37,77
Ayr,1126,2,24,4,8,92,43,49,76
Arbroath,1126,3,17,8,11,70,52,18,59
Alloa,1126,4,17,8,11,56,44,12,59
Stranraer,1126,5,16,5,15,58,65,-7,53
Airdrieon,1126,6,11,11,14,46,58,-12,44
East Fife,1126,7,13,3,20,48,67,-19,42
Forfar,1126,8,10,5,21,38,65,-27,35
Queen's Park,1126,9,7,10,19,43,72,-29,31
Albion,1126,10,8,6,22,58,80,-22,30
Ayr,1127,1,24,4,8,94,43,51,76
Raith,1127,2,22,8,6,69,34,35,74
Arbroath,1127,3,18,8,10,72,49,23,62
Alloa,1127,4,18,8,10,58,44,14,62
Stranraer,1127,5,15,5,16,56,67,-11,50
East Fife,1127,6,14,3,19,50,65,-15,45
Airdrieon,1127,7,11,11,14,46,58,-12,44
Forfar,1127,8,10,5,21,38,65,-27,35
Albion,1127,9,8,6,22,58,82,-24,30
Queen's Park,1127,10,6,10,20,40,74,-34,28
Raith,1128,1,23,8,5,70,33,37,77
Ayr,1128,2,24,4,8,97,44,53,76
Arbroath,1128,3,18,8,10,73,49,24,62
Alloa,1128,4,17,8,11,57,45,12,59
Stranraer,1128,5,15,5,16,56,66,-10,50
East Fife,1128,6,14,3,19,49,65,-16,45
Airdrieon,1128,7,11,11,14,48,59,-11,44
Forfar,1128,8,10,5,21,39,67,-28,35
Albion,1128,9,8,6,22,59,85,-26,30
Queen's Park,1128,10,6,10,20,40,75,-35,28
Raith,1129,1,23,8,5,71,32,39,77
Ayr,1129,2,24,4,8,92,43,49,76
Arbroath,1129,3,18,8,10,73,48,25,62
Alloa,1129,4,17,8,11,56,46,10,59
Stranraer,1129,5,15,5,16,55,66,-11,50
East Fife,1129,6,14,3,19,49,64,-15,45
Airdrieon,1129,7,10,11,15,45,59,-14,41
Forfar,1129,8,11,5,20,39,64,-25,38
Albion,1129,9,8,6,22,58,80,-22,30
Queen's Park,1129,10,6,10,20,39,75,-36,28
Raith,1130,1,23,8,5,69,32,37,77
Ayr,1130,2,23,5,8,92,44,48,74
Arbroath,1130,3,18,8,10,72,48,24,62
Alloa,1130,4,17,8,11,56,44,12,59
Stranraer,1130,5,15,5,16,56,67,-11,50
East Fife,1130,6,14,3,19,50,65,-15,45
Airdrieon,1130,7,10,12,14,48,61,-13,42
Forfar,1130,8,10,6,20,41,67,-26,36
Albion,1130,9,8,7,21,59,80,-21,31
Queen's Park,1130,10,6,10,20,39,74,-35,28
Raith,1131,1,23,8,5,72,33,39,77
Ayr,1131,2,24,4,8,96,42,54,76
Arbroath,1131,3,18,8,10,72,49,23,62
Alloa,1131,4,17,8,11,57,47,10,59
Stranraer,1131,5,15,6,15,57,66,-9,51
Airdrieon,1131,6,11,11,14,49,60,-11,44
East Fife,1131,7,13,4,19,49,66,-17,43
Forfar,1131,8,10,5,21,40,68,-28,35
Albion,1131,9,8,6,22,57,84,-27,30
Queen's Park,1131,10,6,10,20,40,74,-34,28
Ayr,1132,1,24,4,8,92,42,50,76
Raith,1132,2,22,8,6,71,36,35,74
Arbroath,1132,3,18,8,10,74,51,23,62
Alloa,1132,4,18,8,10,60,46,14,62
Stranraer,1132,5,16,5,15,57,64,-7,53
Airdrieon,1132,6,11,11,14,46,58,-12,44
East Fife,1132,7,13,3,20,47,66,-19,42
Forfar,1132,8,10,5,21,38,65,-27,35
Albion,1132,9,8,6,22,57,80,-23,30
Queen's Park,1132,10,6,10,20,42,76,-34,28
Raith,1133,1,23,8,5,71,32,39,77
Ayr,1133,2,24,4,8,91,42,49,76
Arbroath,1133,3,17,9,10,72,50,22,60
Alloa,1133,4,17,8,11,56,46,10,59
Stranraer,1133,5,15,5,16,56,66,-10,50
East Fife,1133,6,14,3,19,49,65,-16,45
Airdrieon,1133,7,11,11,14,47,59,-12,44
Forfar,1133,8,10,5,21,39,66,-27,35
Albion,1133,9,8,6,22,57,79,-22,30
Queen's Park,1133,10,6,11,19,41,74,-33,29
Ayr,1134,1,24,4,8,98,43,55,76
Raith,1134,2,22,9,5,70,34,36,75
Arbroath,1134,3,17,9,10,72,50,22,60
Alloa,1134,4,17,9,10,58,45,13,60
Stranraer,1134,5,16,5,15,57,64,-7,53
Airdrieon,1134,6,11,11,14,48,59,-11,44
East Fife,1134,7,13,3,20,47,66,-19,42
Forfar,1134,8,10,5,21,39,67,-28,35
Albion,1134,9,8,6,22,58,86,-28,30
Queen's Park,1134,10,6,11,19,41,74,-33,29
Raith,1135,1,23,8,5,70,33,37,77
Ayr,1135,2,24,4,8,92,42,50,76
Arbroath,1135,3,18,8,10,73,48,25,62
Alloa,1135,4,17,8,11,57,45,12,59
Stranraer,1135,5,15,6,15,57,66,-9,51
East Fife,1135,6,13,4,19,49,66,-17,43
Airdrieon,1135,7,10,12,14,46,59,-13,42
Forfar,1135,8,10,6,20,39,65,-26,36
Albion,1135,9,8,6,22,57,80,-23,30
Queen's Park,1135,10,6,10,20,39,75,-36,28
Raith,1136,1,23,8,5,70,32,38,77
Ayr,1136,2,24,4,8,96,44,52,76
Arbroath,1136,3,18,8,10,71,48,23,62
Alloa,1136,4,17,8,11,56,45,11,59
Stranraer,1136,5,15,5,16,55,67,-12,50
East Fife,1136,6,14,3,19,50,64,-14,45
Airdrieon,1136,7,10,12,14,45,58,-13,42
Forfar,1136,8,10,6,20,38,64,-26,36
Albion,1136,9,8,6,22,59,84,-25,30
Queen's Park,1136,10,6,10,20,39,73,-34,28
Raith,1137,1,23,8,5,69,32,37,77
Ayr,1137,2,23,4,9,91,44,47,73
Arbroath,1137,3,18,8,10,72,48,24,62
Alloa,1137,4,17,8,11,56,44,12,59
Stranraer,1137,5,15,5,16,56,66,-10,50
East Fife,1137,6,14,3,19,49,65,-16,45
Airdrieon,1137,7,10,12,14,46,59,-13,42
Forfar,1137,8,10,6,20,39,65,-26,36
Albion,1137,9,9,6,21,59,79,-20,33
Queen's Park,1137,10,6,10,20,39,74,-35,28
Raith,1138,1,23,8,5,72,32,40,77
Ayr,1138,2,24,4,8,93,44,49,76
Arbroath,1138,3,18,8,10,77,48,29,62
Alloa,1138,4,17,8,11,56,47,9,59
Stranraer,1138,5,15,6,15,56,65,-9,51
Airdrieon,1138,6,11,11,14,46,58,-12,44
East Fife,1138,7,13,4,19,48,65,-17,43
Forfar,1138,8,10,5,21,38,65,-27,35
Albion,1138,9,8,6,22,59,81,-22,30
Queen's Park,1138,10,6,10,20,39,79,-40,28
Raith,1139,1,23,8,5,70,32,38,77
Ayr,1139,2,24,4,8,92,43,49,76
Arbroath,1139,3,17,9,10,73,51,22,60
Alloa,1139,4,17,8,11,56,45,11,59
Stranraer,1139,5,15,6,15,56,65,-9,51
East Fife,1139,6,13,4,19,48,65,-17,43
Airdrieon,1139,7,10,12,14,45,58,-13,42
Forfar,1139,8,10,6,20,38,64,-26,36
Albion,1139,9,8,6,22,58,80,-22,30
Queen's Park,1139,10,6,11,19,42,75,-33,29
Ayr,1140,1,24,4,8,95,44,51,76
Raith,1140,2,22,9,5,69,33,36,75
Alloa,1140,3,17,9,10,57,44,13,60
Arbroath,1140,4,17,8,11,70,49,21,59
Stranraer,1140,5,15,6,15,56,65,-9,51
East Fife,1140,6,13,4,19,48,65,-17,43
Airdrieon,1140,7,10,12,14,47,60,-13,42
Forfar,1140,8,10,6,20,40,66,-26,36
Queen's Park,1140,9,7,10,19,40,72,-32,31
Albion,1140,10,8,6,22,59,83,-24,30
Ayr,1141,1,24,4,8,94,43,51,76
Raith,1141,2,22,8,6,69,35,34,74
Arbroath,1141,3,18,8,10,71,48,23,62
Alloa,1141,4,18,8,10,59,44,15,62
Stranraer,1141,5,15,5,16,56,66,-10,50
East Fife,1141,6,14,3,19,49,65,-16,45
Airdrieon,1141,7,10,11,15,45,61,-16,41
Forfar,1141,8,11,5,20,41,64,-23,38
Albion,1141,9,8,6,22,58,82,-24,30
Queen's Park,1141,10,6,10,20,39,73,-34,28
Ayr,1142,1,24,4,8,96,42,54,76
Raith,1142,2,22,9,5,68,32,36,75
Alloa,1142,3,17,9,10,56,43,13,60
Arbroath,1142,4,17,8,11,70,49,21,59
Stranraer,1142,5,16,5,15,56,64,-8,53
Airdrieon,1142,6,10,12,14,46,59,-13,42
East Fife,1142,7,13,3,20,47,65,-18,42
Forfar,1142,8,10,6,20,39,65,-26,36
Queen's Park,1142,9,7,10,19,40,72,-32,31
Albion,1142,10,8,6,22,57,84,-27,30
Raith,1143,1,23,8,5,71,34,37,77
Ayr,1143,2,24,4,8,94,42,52,76
Arbroath,1143,3,18,8,10,72,49,23,62
Alloa,1143,4,17,8,11,58,46,12,59
Stranraer,1143,5,15,5,16,55,67,-12,50
East Fife,1143,6,14,3,19,50,64,-14,45
Airdrieon,1143,7,11,11,14,46,58,-12,44
Forfar,1143,8,10,5,21,38,65,-27,35
Albion,1143,9,8,6,22,57,82,-25,30
Queen's Park,1143,10,6,10,20,40,74,-34,28
Raith,1144,1,23,8,5,70,32,38,77
Ayr,1144,2,23,5,8,94,46,48,74
Arbroath,1144,3,18,8,10,73,50,23,62
Alloa,1144,4,17,8,11,56,45,11,59
Stranraer,1144,5,16,5,15,58,65,-7,53
East Fife,1144,6,13,3,20,48,67,-19,42
Airdrieon,1144,7,10,11,15,45,60,-15,41
Forfar,1144,8,11,5,20,40,64,-24,38
Albion,1144,9,8,7,21,61,82,-21,31
Queen's Park,1144,10,6,10,20,41,75,-34,28
Raith,1145,1,23,8,5,72,32,40,77
Ayr,1145,2,23,5,8,92,44,48,74
Arbroath,1145,3,18,8,10,74,48,26,62
Alloa,1145,4,17,8,11,56,47,9,59
Stranraer,1145,5,16,5,15,57,65,-8,53
Airdrieon,1145,6,11,11,14,47,59,-12,44
East Fife,1145,7,13,3,20,48,66,-18,42
Forfar,1145,8,10,5,21,39,66,-27,35
Albion,1145,9,8,7,21,59,80,-21,31
Queen's Park,1145,10,6,10,20,39,76,-37,28
Raith,1146,1,22,9,5,70,34,36,75
Ayr,1146,2,23,5,8,93,45,48,74
Arbroath,1146,3,18,8,10,71,48,23,62
Alloa,1146,4,17,9,10,58,45,13,60
Stranraer,1146,5,15,5,16,55,65,-10,50
East Fife,1146,6,14,3,19,48,64,-16,45
Airdrieon,1146,7,11,11,14,47,58,-11,44
Forfar,1146,8,10,5,21,38,66,-28,35
Albion,1146,9,8,7,21,60,81,-21,31
Queen's Park,1146,10,6,10,20,39,73,-34,28
Ayr,1147,1,24,4,8,93,44,49,76
Raith,1147,2,22,9,5,70,34,36,75
Arbroath,1147,3,18,8,10,72,48,24,62
Alloa,1147,4,17,9,10,58,45,13,60
Stranraer,1147,5,15,5,16,55,69,-14,50
East Fife,1147,6,14,3,19,52,64,-12,45
Airdrieon,1147,7,11,11,14,47,59,-12,44
Forfar,1147,8,10,5,21,39,66,-27,35
Albion,1147,9,8,6,22,59,81,-22,30
Queen's Park,1147,10,6,10,20,39,74,-35,28
Raith,1148,1,23,8,5,73,32,41,77
Ayr,1148,2,24,4,8,91,42,49,76
Arbroath,1148,3,17,8,11,71,52,19,59
Alloa,1148,4,17,8,11,56,48,8,59
Stranraer,1148,5,16,5,15,58,66,-8,53
Airdrieon,1148,6,10,12,14,46,59,-13,42
East Fife,1148,7,13,3,20,49,67,-18,42
Forfar,1148,8,10,6,20,39,65,-26,36
Queen's Park,1148,9,7,10,19,43,73,-30,31
Albion,1148,10,8,6,22,57,79,-22,30
Ayr,1149,1,24,4,8,94,42,52,76
Raith,1149,2,22,9,5,69,33,36,75
Arbroath,1149,3,18,8,10,73,48,25,62
Alloa,1149,4,17,9,10,57,44,13,60
Stranraer,1149,5,16,5,15,59,66,-7,53
Airdrieon,1149,6,10,12,14,47,60,-13,42
East Fife,1149,7,13,3,20,49,68,-19,42
Forfar,1149,8,10,6,20,40,66,-26,36
Albion,1149,9,8,6,22,57,82,-25,30
Queen's Park,1149,10,6,10,20,39,75,-36,28
Raith,1150,1,23,8,5,69,32,37,77
Ayr,1150,2,24,4,8,95,42,53,76
Arbroath,1150,3,17,8,11,70,49,21,59
Alloa,1150,4,17,8,11,56,44,12,59
Stranraer,1150,5,15,5,16,55,66,-11,50
East Fife,1150,6,14,3,19,49,64,-15,45
Airdrieon,1150,7,11,11,14,49,59,-10,44
Forfar,1150,8,10,5,21,39,68,-29,35
Queen's Park,1150,9,7,10,19,40,72,-32,31
Albion,1150,10,8,6,22,57,83,-26,30
Raith,1151,1,23,8,5,70,32,38,77
Ayr,1151,2,24,4,8,96,43,53,76
Arbroath,1151,3,17,9,10,70,48,22,60
Alloa,1151,4,17,8,11,56,45,11,59
Stranraer,1151,5,15,5,16,55,65,-10,50
East Fife,1151,6,14,3,19,48,64,-16,45
Airdrieon,1151,7,11,11,14,49,58,-9,44
Forfar,1151,8,10,5,21,38,68,-30,35
Albion,1151,9,8,6,22,58,84,-26,30
Queen's Park,1151,10,6,11,19,39,72,-33,29
Raith,1152,1,23,8,5,69,32,37,77
Ayr,1152,2,23,4,9,92,46,46,73
Arbroath,1152,3,18,8,10,73,48,25,62
Alloa,1152,4,17,8,11,56,44,12,59
Stranraer,1152,5,15,5,16,55,65,-10,50
East Fife,1152,6,14,3,19,48,64,-16,45
Airdrieon,1152,7,11,11,14,46,58,-12,44
Forfar,1152,8,10,5,21,38,65,-27,35
Albion,1152,9,9,6,21,61,80,-19,33
Queen's Park,1152,10,6,10,20,39,75,-36,28
Raith,1153,1,23,8,5,70,33,37,77
Ayr,1153,2,23,5,8,92,44,48,74
Arbroath,1153,3,18,8,10,72,49,23,62
Alloa,1153,4,17,8,11,57,45,12,59
Stranraer,1153,5,16,5,15,56,64,-8,53
Airdrieon,1153,6,11,11,14,49,60,-11,44
East Fife,1153,7,13,3,20,47,65,-18,42
Forfar,1153,8,10,5,21,40,68,-28,35
Albion,1153,9,8,7,21,59,80,-21,31
Queen's Park,1153,10,6,10,20,40,74,-34,28
Raith,1154,1,23,8,5,70,33,37,77
Ayr,1154,2,24,4,8,93,44,49,76
Arbroath,1154,3,17,9,10,72,50,22,60
Alloa,1154,4,17,8,11,57,45,12,59
Stranraer,1154,5,15,5,16,56,66,-10,50
East Fife,1154,6,14,3,19,49,65,-16,45
Airdrieon,1154,7,10,11,15,46,60,-14,41
Forfar,1154,8,11,5,20,40,65,-25,38
Albion,1154,9,8,6,22,59,81,-22,30
Queen's Park,1154,10,6,11,19,41,74,-33,29
Raith,1155,1,23,8,5,69,32,37,77
Ayr,1155,2,24,4,8,93,44,49,76
Arbroath,1155,3,18,8,10,74,48,26,62
Alloa,1155,4,17,8,11,56,44,12,59
Stranraer,1155,5,15,5,16,55,65,-10,50
East Fife,1155,6,14,3,19,48,64,-16,45
Airdrieon,1155,7,10,12,14,46,59,-13,42
Forfar,1155,8,10,6,20,39,65,-26,36
Albion,1155,9,8,6,22,59,81,-22,30
Queen's Park,1155,10,6,10,20,39,76,-37,28
Ayr,1156,1,24,4,8,92,43,49,76
Raith,1156,2,22,8,6,69,34,35,74
Alloa,1156,3,18,8,10,58,44,14,62
Arbroath,1156,4,17,8,11,71,50,21,59
Stranraer,1156,5,15,5,16,55,66,-11,50
East Fife,1156,6,14,3,19,49,64,-15,45
Airdrieon,1156,7,10,12,14,45,58,-13,42
Forfar,1156,8,10,6,20,38,64,-26,36
Queen's Park,1156,9,7,10,19,41,73,-32,31
Albion,1156,10,8,6,22,58,80,-22,30
Raith,1157,1,23,8,5,72,32,40,77
Ayr,1157,2,24,4,8,97,45,52,76
Arbroath,1157,3,18,8,10,73,49,24,62
Alloa,1157,4,17,8,11,56,47,9,59
Stranraer,1157,5,15,6,15,56,65,-9,51
Airdrieon,1157,6,11,11,14,46,58,-12,44
East Fife,1157,7,13,4,19,48,65,-17,43
Forfar,1157,8,10,5,21,38,65,-27,35
Albion,1157,9,8,6,22,60,85,-25,30
Queen's Park,1157,10,6,10,20,40,75,-35,28
Ayr,1158,1,24,4,8,94,43,51,76
Raith,1158,2,22,9,5,69,33,36,75
Alloa,1158,3,17,9,10,57,44,13,60
Arbroath,1158,4,17,8,11,71,50,21,59
Stranraer,1158,5,15,5,16,55,65,-10,50
East Fife,1158,6,14,3,19,48,64,-16,45
Airdrieon,1158,7,10,11,15,47,61,-14,41
Forfar,1158,8,11,5,20,41,66,-25,38
Queen's Park,1158,9,7,10,19,41,73,-32,31
Albion,1158,10,8,6,22,58,82,-24,30
Ayr,1159,1,24,4,8,96,43,53,76
Raith,1159,2,22,9,5,69,33,36,75
Arbroath,1159,3,18,8,10,74,49,25,62
Alloa,1159,4,17,9,10,57,44,13,60
Stranraer,1159,5,15,5,16,55,68,-13,50
East Fife,1159,6,14,3,19,51,64,-13,45
Airdrieon,1159,7,11,11,14,50,61,-11,44
Forfar,1159,8,10,5,21,41,69,-28,35
Albion,1159,9,8,6,22,58,84,-26,30
Queen's Park,1159,10,6,10,20,40,76,-36,28
Ayr,1160,1,24,4,8,94,42,52,76
Raith,1160,2,22,9,5,69,33,36,75
Alloa,1160,3,17,9,10,57,44,13,60
Arbroath,1160,4,17,8,11,71,51,20,59
Stranraer,1160,5,15,5,16,57,67,-10,50
East Fife,1160,6,14,3,19,50,66,-16,45
Airdrieon,1160,7,10,11,15,45,59,-14,41
Forfar,1160,8,11,5,20,39,64,-25,38
Queen's Park,1160,9,7,10,19,42,73,-31,31
Albion,1160,10,8,6,22,57,82,-25,30
Ayr,1161,1,24,4,8,92,42,50,76
Raith,1161,2,22,8,6,68,33,35,74
Arbroath,1161,3,18,8,10,75,48,27,62
Alloa,1161,4,18,8,10,57,43,14,62
Stranraer,1161,5,15,6,15,56,65,-9,51
Airdrieon,1161,6,11,11,14,48,59,-11,44
East Fife,1161,7,13,4,19,48,65,-17,43
Forfar,1161,8,10,5,21,39,67,-28,35
Albion,1161,9,8,6,22,57,80,-23,30
Queen's Park,1161,10,6,10,20,39,77,-38,28
Raith,1162,1,23,8,5,72,33,39,77
Ayr,1162,2,24,4,8,95,46,49,76
Arbroath,1162,3,18,8,10,72,49,23,62
Alloa,1162,4,17,8,11,57,47,10,59
Stranraer,1162,5,15,6,15,56,65,-9,51
East Fife,1162,6,13,4,19,48,65,-17,43
Airdrieon,1162,7,10,11,15,45,60,-15,41
Forfar,1162,8,11,5,20,40,64,-24,38
Albion,1162,9,8,6,22,61,83,-22,30
Queen's Park,1162,10,6,10,20,40,74,-34,28
Ayr,1163,1,24,4,8,93,43,50,76
Raith,1163,2,22,9,5,70,34,36,75
Arbroath,1163,3,18,8,10,72,48,24,62
Alloa,1163,4,17,9,10,58,45,13,60
Stranraer,1163,5,15,5,16,56,66,-10,50
East Fife,1163,6,14,3,19,49,65,-16,45
Airdrieon,1163,7,11,11,14,48,59,-11,44
Forfar,1163,8,10,5,21,39,67,-28,35
Albion,1163,9,8,6,22,58,81,-23,30
Queen's Park,1163,10,6,10,20,39,74,-35,28
Ayr,1164,1,24,4,8,94,42,52,76
Raith,1164,2,22,8,6,69,34,35,74
Arbroath,1164,3,18,8,10,73,48,25,62
Alloa,1164,4,18,8,10,58,44,14,62
Stranraer,1164,5,16,5,15,57,65,-8,53
Airdrieon,1164,6,10,12,14,46,59,-13,42
East Fife,1164,7,13,3,20,48,66,-18,42
Forfar,1164,8,10,6,20,39,65,-26,36
Albion,1164,9,8,6,22,57,82,-25,30
Queen's Park,1164,10,6,10,20,39,75,-36,28
Ayr,1165,1,24,4,8,94,43,51,76
Raith,1165,2,22,8,6,69,35,34,74
Arbroath,1165,3,18,8,10,72,49,23,62
Alloa,1165,4,18,8,10,59,44,15,62
Stranraer,1165,5,15,6,15,57,66,-9,51
Airdrieon,1165,6,11,11,14,47,59,-12,44
East Fife,1165,7,13,4,19,49,66,-17,43
Forfar,1165,8,10,5,21,39,66,-27,35
Albion,1165,9,8,6,22,58,82,-24,30
Queen's Park,1165,10,6,10,20,40,74,-34,28
Raith,1166,1,23,8,5,72,33,39,77
Ayr,1166,2,24,4,8,97,42,55,76
Arbroath,1166,3,18,8,10,73,49,24,62
Alloa,1166,4,17,8,11,57,47,10,59
Stranraer,1166,5,16,5,15,56,64,-8,53
Airdrieon,1166,6,10,12,14,48,61,-13,42
East Fife,1166,7,13,3,20,47,65,-18,42
Forfar,1166,8,10,6,20,41,67,-26,36
Albion,1166,9,8,6,22,57,85,-28,30
Queen's Park,1166,10,6,10,20,40,75,-35,28
Raith,1167,1,23,8,5,71,32,39,77
Ayr,1167,2,24,4,8,94,42,52,76
Arbroath,1167,3,18,8,10,73,49,24,62
Alloa,1167,4,17,8,11,56,46,10,59
Stranraer,1167,5,15,6,15,57,66,-9,51
Airdrieon,1167,6,11,11,14,48,60,-12,44
East Fife,1167,7,13,4,19,49,66,-17,43
Forfar,1167,8,10,5,21,40,67,-27,35
Albion,1167,9,8,6,22,57,82,-25,30
Queen's Park,1167,10,6,10,20,40,75,-35,28
Ayr,1168,1,23,5,8,92,44,48,74
Raith,1168,2,22,8,6,68,33,35,74
Arbroath,1168,3,18,8,10,71,48,23,62
Alloa,1168,4,18,8,10,57,43,14,62
Stranraer,1168,5,15,6,15,56,65,-9,51
East Fife,1168,6,13,4,19,48,65,-17,43
Airdrieon,1168,7,10,12,14,46,59,-13,42
Forfar,1168,8,10,6,20,39,65,-26,36
Albion,1168,9,8,7,21,59,80,-21,31
Queen's Park,1168,10,6,10,20,39,73,-34,28
Ayr,1169,1,24,4,8,95,42,53,76
Raith,1169,2,22,8,6,71,36,35,74
Arbroath,1169,3,18,8,10,73,48,25,62
Alloa,1169,4,18,8,10,60,46,14,62
Stranraer,1169,5,15,5,16,57,67,-10,50
East Fife,1169,6,14,3,19,50,66,-16,45
Airdrieon,1169,7,11,11,14,52,60,-8,44
Forfar,1169,8,10,5,21,40,71,-31,35
Albion,1169,9,8,6,22,57,83,-26,30
Queen's Park,1169,10,6,10,20,39,75,-36,28
Raith,1170,1,23,8,5,69,32,37,77
Ayr,1170,2,24,4,8,93,44,49,76
Arbroath,1170,3,18,8,10,73,48,25,62
Alloa,1170,4,17,8,11,56,44,12,59
Stranraer,1170,5,15,5,16,56,66,-10,50
East Fife,1170,6,14,3,19,49,65,-16,45
Airdrieon,1170,7,11,11,14,47,59,-12,44
Forfar,1170,8,10,5,21,39,66,-27,35
Albion,1170,9,8,6,22,59,81,-22,30
Queen's Park,1170,10,6,10,20,39,75,-36,28
Ayr,1171,1,24,4,8,95,43,52,76
Raith,1171,2,22,8,6,68,33,35,74
Alloa,1171,3,18,8,10,57,43,14,62
Arbroath,1171,4,17,8,11,70,50,20,59
Stranraer,1171,5,16,5,15,57,64,-7,53
East Fife,1171,6,13,3,20,47,66,-19,42
Airdrieon,1171,7,10,11,15,45,61,-16,41
Forfar,1171,8,11,5,20,41,64,-23,38
Queen's Park,1171,9,7,10,19,41,72,-31,31
Albion,1171,10,8,6,22,58,83,-25,30
Raith,1172,1,23,8,5,69,32,37,77
Ayr,1172,2,24,4,8,93,42,51,76
Arbroath,1172,3,18,8,10,71,48,23,62
Alloa,1172,4,17,8,11,56,44,12,59
Stranraer,1172,5,15,5,16,56,66,-10,50
East Fife,1172,6,14,3,19,49,65,-16,45
Airdrieon,1172,7,10,12,14,49,62,-13,42
Forfar,1172,8,10,6,20,42,68,-26,36
Albion,1172,9,8,6,22,57,81,-24,30
Queen's Park,1172,10,6,10,20,39,73,-34,28
Raith,1173,1,23,8,5,72,33,39,77
Ayr,1173,2,24,4,8,93,42,51,76
Arbroath,1173,3,18,8,10,72,49,23,62
Alloa,1173,4,17,8,11,57,47,10,59
Stranraer,1173,5,16,5,15,59,65,-6,53
East Fife,1173,6,13,3,20,48,68,-20,42
Airdrieon,1173,7,10,11,15,47,61,-14,41
Forfar,1173,8,11,5,20,41,66,-25,38
Albion,1173,9,8,6,22,57,81,-24,30
Queen's Park,1173,10,6,10,20,40,74,-34,28
Raith,1174,1,23,8,5,69,32,37,77
Ayr,1174,2,24,4,8,96,43,53,76
Arbroath,1174,3,18,8,10,72,48,24,62
Alloa,1174,4,17,8,11,56,44,12,59
Stranraer,1174,5,15,6,15,56,65,-9,51
East Fife,1174,6,13,4,19,48,65,-17,43
Airdrieon,1174,7,10,12,14,46,59,-13,42
Forfar,1174,8,10,6,20,39,65,-26,36
Albion,1174,9,8,6,22,58,84,-26,30
Queen's Park,1174,10,6,10,20,39,74,-35,28
Raith,1175,1,23,8,5,69,32,37,77
Ayr,1175,2,24,4,8,93,43,50,76
Arbroath,1175,3,17,8,11,70,50,20,59
Alloa,1175,4,17,8,11,56,44,12,59
Stranraer,1175,5,15,5,16,55,66,-11,50
East Fife,1175,6,14,3,19,49,64,-15,45
Airdrieon,1175,7,11,11,14,46,58,-12,44
Forfar,1175,8,10,5,21,38,65,-27,35
Queen's Park,1175,9,7,10,19,41,72,-31,31
Albion,1175,10,8,6,22,58,81,-23,30
Raith,1176,1,23,8,5,70,32,38,77
Ayr,1176,2,24,4,8,95,43,52,76
Arbroath,1176,3,17,9,10,71,49,22,60
Alloa,1176,4,17,8,11,56,45,11,59
Stranraer,1176,5,15,5,16,58,69,-11,50
East Fife,1176,6,14,3,19,52,67,-15,45
Airdrieon,1176,7,10,11,15,47,62,-15,41
Forfar,1176,8,11,5,20,42,66,-24,38
Albion,1176,9,8,6,22,58,83,-25,30
Queen's Park,1176,10,6,11,19,40,73,-33,29
Ayr,1177,1,24,4,8,93,44,49,76
Raith,1177,2,22,9,5,69,33,36,75
Arbroath,1177,3,17,9,10,71,49,22,60
Alloa,1177,4,17,9,10,57,44,13,60
Stranraer,1177,5,15,5,16,55,66,-11,50
East Fife,1177,6,14,3,19,49,64,-15,45
Airdrieon,1177,7,11,11,14,47,59,-12,44
Forfar,1177,8,10,5,21,39,66,-27,35
Albion,1177,9,8,6,22,59,81,-22,30
Queen's Park,1177,10,6,11,19,40,73,-33,29
Raith,1178,1,23,8,5,70,32,38,77
Ayr,1178,2,24,4,8,92,43,49,76
Arbroath,1178,3,17,8,11,70,49,21,59
Alloa,1178,4,17,8,11,56,45,11,59
Stranraer,1178,5,15,6,15,57,66,-9,51
Airdrieon,1178,6,11,11,14,48,59,-11,44
East Fife,1178,7,13,4,19,49,66,-17,43
Forfar,1178,8,10,5,21,39,67,-28,35
Queen's Park,1178,9,7,10,19,40,72,-32,31
Albion,1178,10,8,6,22,58,80,-22,30
Raith,1179,1,23,8,5,69,32,37,77
Ayr,1179,2,24,4,8,94,42,52,76
Arbroath,1179,3,18,8,10,75,49,26,62
Alloa,1179,4,17,8,11,56,44,12,59
Stranraer,1179,5,16,5,15,59,65,-6,53
Airdrieon,1179,6,10,12,14,45,58,-13,42
East Fife,1179,7,13,3,20,48,68,-20,42
Forfar,1179,8,10,6,20,38,64,-26,36
Albion,1179,9,8,6,22,57,82,-25,30
Queen's Park,1179,10,6,10,20,40,77,-37,28
Raith,1180,1,23,8,5,70,32,38,77
Ayr,1180,2,24,4,8,92,43,49,76
Arbroath,1180,3,18,8,10,74,49,25,62
Alloa,1180,4,17,8,11,56,45,11,59
Stranraer,1180,5,15,5,16,57,67,-10,50
East Fife,1180,6,14,3,19,50,66,-16,45
Airdrieon,1180,7,11,11,14,49,58,-9,44
Forfar,1180,8,10,5,21,38,68,-30,35
Albion,1180,9,8,6,22,58,80,-22,30
Queen's Park,1180,10,6,10,20,40,76,-36,28
Raith,1181,1,23,8,5,71,33,38,77
Ayr,1181,2,24,4,8,94,42,52,76
Arbroath,1181,3,18,8,10,75,51,24,62
Alloa,1181,4,17,8,11,57,46,11,59
Stranraer,1181,5,15,5,16,55,65,-10,50
East Fife,1181,6,14,3,19,48,64,-16,45
Airdrieon,1181,7,11,11,14,46,58,-12,44
Forfar,1181,8,10,5,21,38,65,-27,35
Albion,1181,9,8,6,22,57,82,-25,30
Queen's Park,1181,10,6,10,20,42,77,-35,28
Raith,1182,1,22,8,6,68,33,35,74
Ayr,1182,2,23,4,9,90,43,47,73
Alloa,1182,3,18,8,10,57,43,14,62
Arbroath,1182,4,17,8,11,72,51,21,59
Stranraer,1182,5,16,5,15,60,64,-4,53
Airdrieon,1182,6,11,11,14,46,58,-12,44
East Fife,1182,7,13,3,20,47,69,-22,42
Forfar,1182,8,10,5,21,38,65,-27,35
Albion,1182,9,9,6,21,58,78,-20,33
Queen's Park,1182,10,7,10,19,42,74,-32,31
Raith,1183,1,23,8,5,70,33,37,77
Ayr,1183,2,24,4,8,97,43,54,76
Arbroath,1183,3,17,8,11,70,50,20,59
Alloa,1183,4,17,8,11,57,45,12,59
Stranraer,1183,5,16,5,15,57,65,-8,53
East Fife,1183,6,13,3,20,48,66,-18,42
Airdrieon,1183,7,10,11,15,45,59,-14,41
Forfar,1183,8,11,5,20,39,64,-25,38
Queen's Park,1183,9,7,10,19,41,72,-31,31
Albion,1183,10,8,6,22,58,85,-27,30
Ayr,1184,1,24,4,8,94,44,50,76
Raith,1184,2,22,8,6,69,34,35,74
Arbroath,1184,3,18,8,10,74,48,26,62
Alloa,1184,4,18,8,10,58,44,14,62
Stranraer,1184,5,15,5,16,57,68,-11,50
East Fife,1184,6,14,3,19,51,66,-15,45
Airdrieon,1184,7,10,11,15,46,61,-15,41
Forfar,1184,8,11,5,20,41,65,-24,38
Albion,1184,9,8,6,22,59,82,-23,30
Queen's Park,1184,10,6,10,20,39,76,-37,28
Raith,1185,1,23,8,5,70,33,37,77
Ayr,1185,2,24,4,8,97,42,55,76
Arbroath,1185,3,17,8,11,71,50,21,59
Alloa,1185,4,17,8,11,57,45,12,59
Stranraer,1185,5,16,5,15,57,65,-8,53
Airdrieon,1185,6,11,11,14,47,59,-12,44
East Fife,1185,7,13,3,20,48,66,-18,42
Forfar,1185,8,10,5,21,39,66,-27,35
Queen's Park,1185,9,7,10,19,41,73,-32,31
Albion,1185,10,8,6,22,57,85,-28,30
Ayr,1186,1,24,4,8,95,43,52,76
Raith,1186,2,22,8,6,69,34,35,74
Alloa,1186,3,18,8,10,58,44,14,62
Arbroath,1186,4,17,9,10,71,49,22,60
Stranraer,1186,5,15,6,15,56,65,-9,51
Airdrieon,1186,6,11,11,14,46,58,-12,44
East Fife,1186,7,13,4,19,48,65,-17,43
Forfar,1186,8,10,5,21,38,65,-27,35
Albion,1186,9,8,6,22,58,83,-25,30
Queen's Park,1186,10,6,11,19,40,73,-33,29
Raith,1187,1,23,8,5,70,32,38,77
Ayr,1187,2,23,5,8,91,43,48,74
Arbroath,1187,3,17,9,10,72,50,22,60
Alloa,1187,4,17,8,11,56,45,11,59
Stranraer,1187,5,15,6,15,57,66,-9,51
Airdrieon,1187,6,11,11,14,46,58,-12,44
East Fife,1187,7,13,4,19,49,66,-17,43
Forfar,1187,8,10,5,21,38,65,-27,35
Albion,1187,9,8,7,21,58,79,-21,31
Queen's Park,1187,10,6,11,19,41,74,-33,29
Ayr,1188,1,24,4,8,92,42,50,76
Raith,1188,2,22,8,6,69,38,31,74
Alloa,1188,3,18,8,10,62,44,18,62
Arbroath,1188,4,17,8,11,72,53,19,59
Stranraer,1188,5,15,5,16,56,66,-10,50
East Fife,1188,6,14,3,19,49,65,-16,45
Airdrieon,1188,7,10,12,14,45,58,-13,42
Forfar,1188,8,10,6,20,38,64,-26,36
Queen's Park,1188,9,7,10,19,44,74,-30,31
Albion,1188,10,8,6,22,57,80,-23,30
Ayr,1189,1,24,4,8,94,45,49,76
Raith,1189,2,22,8,6,68,33,35,74
Arbroath,1189,3,18,8,10,74,50,24,62
Alloa,1189,4,18,8,10,57,43,14,62
Stranraer,1189,5,16,5,15,58,65,-7,53
East Fife,1189,6,13,3,20,48,67,-19,42
Airdrieon,1189,7,10,11,15,46,60,-14,41
Forfar,1189,8,11,5,20,40,65,-25,38
Albion,1189,9,8,6,22,60,82,-22,30
Queen's Park,1189,10,6,10,20,41,76,-35,28
Raith,1190,1,23,8,5,69,32,37,77
Ayr,1190,2,24,4,8,92,43,49,76
Arbroath,1190,3,17,9,10,71,49,22,60
Alloa,1190,4,17,8,11,56,44,12,59
Stranraer,1190,5,15,5,16,56,68,-12,50
East Fife,1190,6,14,3,19,51,65,-14,45
Airdrieon,1190,7,11,11,14,48,59,-11,44
Forfar,1190,8,10,5,21,39,67,-28,35
Albion,1190,9,8,6,22,58,80,-22,30
Queen's Park,1190,10,6,11,19,40,73,-33,29
Ayr,1191,1,24,4,8,92,43,49,76
Raith,1191,2,22,9,5,68,32,36,75
Arbroath,1191,3,18,8,10,72,48,24,62
Alloa,1191,4,17,9,10,56,43,13,60
Stranraer,1191,5,15,5,16,56,66,-10,50
East Fife,1191,6,14,3,19,49,65,-16,45
Airdrieon,1191,7,10,11,15,45,60,-15,41
Forfar,1191,8,11,5,20,40,64,-24,38
Albion,1191,9,8,6,22,58,80,-22,30
Queen's Park,1191,10,6,10,20,39,74,-35,28
Ayr,1192,1,24,4,8,92,43,49,76
Raith,1192,2,22,9,5,68,32,36,75
Arbroath,1192,3,18,8,10,76,48,28,62
Alloa,1192,4,17,9,10,56,43,13,60
Stranraer,1192,5,15,5,16,57,68,-11,50
East Fife,1192,6,14,3,19,51,66,-15,45
Airdrieon,1192,7,10,11,15,45,59,-14,41
Forfar,1192,8,11,5,20,39,64,-25,38
Albion,1192,9,8,6,22,58,80,-22,30
Queen's Park,1192,10,6,10,20,39,78,-39,28
Raith,1193,1,22,8,6,68,34,34,74
Ayr,1193,2,23,4,9,91,44,47,73
Alloa,1193,3,18,8,10,58,43,15,62
Arbroath,1193,4,17,8,11,71,51,20,59
Stranraer,1193,5,15,5,16,56,66,-10,50
East Fife,1193,6,14,3,19,49,65,-16,45
Airdrieon,1193,7,11,11,14,48,59,-11,44
Forfar,1193,8,10,5,21,39,67,-28,35
Albion,1193,9,9,6,21,59,79,-20,33
Queen's Park,1193,10,7,10,19,42,73,-31,31
Raith,1194,1,23,8,5,72,33,39,77
Ayr,1194,2,24,4,8,96,43,53,76
Arbroath,1194,3,18,8,10,75,48,27,62
Alloa,1194,4,17,8,11,57,47,10,59
Stranraer,1194,5,16,5,15,57,65,-8,53
Airdrieon,1194,6,11,11,14,48,59,-11,44
East Fife,1194,7,13,3,20,48,66,-18,42
Forfar,1194,8,10,5,21,39,67,-28,35
Albion,1194,9,8,6,22,58,84,-26,30
Queen's Park,1194,10,6,10,20,39,77,-38,28
Ayr,1195,1,24,4,8,94,42,52,76
Raith,1195,2,22,9,5,70,34,36,75
Arbroath,1195,3,18,8,10,73,48,25,62
Alloa,1195,4,17,9,10,58,45,13,60
Stranraer,1195,5,15,5,16,55,66,-11,50
East Fife,1195,6,14,3,19,49,64,-15,45
Airdrieon,1195,7,10,11,15,45,61,-16,41
Forfar,1195,8,11,5,20,41,64,-23,38
Albion,1195,9,8,6,22,57,82,-25,30
Queen's Park,1195,10,6,10,20,39,75,-36,28
Raith,1196,1,23,8,5,69,32,37,77
Ayr,1196,2,24,4,8,93,44,49,76
Arbroath,1196,3,18,8,10,72,49,23,62
Alloa,1196,4,17,8,11,56,44,12,59
Stranraer,1196,5,16,5,15,57,64,-7,53
East Fife,1196,6,13,3,20,47,66,-19,42
Airdrieon,1196,7,10,11,15,45,59,-14,41
Forfar,1196,8,11,5,20,39,64,-25,38
Albion,1196,9,8,6,22,59,81,-22,30
Queen's Park,1196,10,6,10,20,40,74,-34,28
Raith,1197,1,23,8,5,72,34,38,77
Ayr,1197,2,23,4,9,90,45,45,73
Arbroath,1197,3,17,9,10,73,51,22,60
Alloa,1197,4,17,8,11,58,47,11,59
Stranraer,1197,5,15,5,16,56,66,-10,50
East Fife,1197,6,14,3,19,49,65,-16,45
Airdrieon,1197,7,10,11,15,46,60,-14,41
Forfar,1197,8,11,5,20,40,65,-25,38
Albion,1197,9,9,6,21,60,78,-18,33
Queen's Park,1197,10,6,11,19,42,75,-33,29
Ayr,1198,1,23,5,8,92,44,48,74
Raith,1198,2,22,8,6,69,34,35,74
Arbroath,1198,3,18,8,10,73,50,23,62
Alloa,1198,4,18,8,10,58,44,14,62
Stranraer,1198,5,15,5,16,55,66,-11,50
East Fife,1198,6,14,3,19,49,64,-15,45
Airdrieon,1198,7,11,11,14,46,58,-12,44
Forfar,1198,8,10,5,21,38,65,-27,35
Albion,1198,9,8,7,21,59,80,-21,31
Queen's Park,1198,10,6,10,20,41,75,-34,28
Ayr,1199,1,24,4,8,92,43,49,76
Raith,1199,2,22,9,5,69,33,36,75
Arbroath,1199,3,18,8,10,73,50,23,62
Alloa,1199,4,17,9,10,57,44,13,60
Stranraer,1199,5,15,6,15,56,65,-9,51
East Fife,1199,6,13,4,19,48,65,-17,43
Airdrieon,1199,7,10,12,14,47,60,-13,42
Forfar,1199,8,10,6,20,40,66,-26,36
Albion,1199,9,8,6,22,58,80,-22,30
Queen's Park,1199,10,6,10,20,41,75,-34,28
Raith,1200,1,23,8,5,69,32,37,77
Ayr,1200,2,24,4,8,92,43,49,76
Arbroath,1200,3,18,8,10,72,48,24,62
Alloa,1200,4,17,8,11,56,44,12,59
Stranraer,1200,5,15,5,16,55,67,-12,50
East Fife,1200,6,14,3,19,50,64,-14,45
Airdrieon,1200,7,11,11,14,48,59,-11,44
Forfar,1200,8,10,5,21,39,67,-28,35
Albion,1200,9,8,6,22,58,80,-22,30
Queen's Park,1200,10,6,10,20,39,74,-35,28
Ayr,1201,1,24,4,8,93,42,51,76
Raith,1201,2,22,9,5,68,32,36,75
Alloa,1201,3,17,9,10,56,43,13,60
Arbroath,1201,4,17,8,11,71,51,20,59
Stranraer,1201,5,16,5,15,56,64,-8,53
Airdrieon,1201,6,11,11,14,49,60,-11,44
East Fife,1201,7,13,3,20,47,65,-18,42
Forfar,1201,8,10,5,21,40,68,-28,35
Queen's Park,1201,9,7,10,19,42,73,-31,31
Albion,1201,10,8,6,22,57,81,-24,30
Ayr,1202,1,24,4,8,96,42,54,76
Raith,1202,2,22,8,6,69,35,34,74
Alloa,1202,3,18,8,10,59,44,15,62
Arbroath,1202,4,17,8,11,71,51,20,59
Stranraer,1202,5,16,5,15,58,65,-7,53
Airdrieon,1202,6,11,11,14,46,58,-12,44
East Fife,1202,7,13,3,20,48,67,-19,42
Forfar,1202,8,10,5,21,38,65,-27,35
Queen's Park,1202,9,7,10,19,42,73,-31,31
Albion,1202,10,8,6,22,57,84,-27,30
Raith,1203,1,23,8,5,72,32,40,77
Ayr,1203,2,24,4,8,93,42,51,76
Arbroath,1203,3,18,8,10,74,49,25,62
Alloa,1203,4,17,8,11,56,47,9,59
Stranraer,1203,5,15,5,16,57,68,-11,50
East Fife,1203,6,14,3,19,51,66,-15,45
Airdrieon,1203,7,10,12,14,46,59,-13,42
Forfar,1203,8,10,6,20,39,65,-26,36
Albion,1203,9,8,6,22,57,81,-24,30
Queen's Park,1203,10,6,10,20,40,76,-36,28
Raith,1204,1,23,8,5,69,32,37,77
Ayr,1204,2,23,5,8,92,44,48,74
Arbroath,1204,3,18,8,10,72,49,23,62
Alloa,1204,4,17,8,11,56,44,12,59
Stranraer,1204,5,16,5,15,58,66,-8,53
Airdrieon,1204,6,11,11,14,46,58,-12,44
East Fife,1204,7,13,3,20,49,67,-18,42
Forfar,1204,8,10,5,21,38,65,-27,35
Albion,1204,9,8,7,21,59,80,-21,31
Queen's Park,1204,10,6,10,20,40,74,-34,28
Raith,1205,1,23,8,5,70,32,38,77
Ayr,1205,2,23,5,8,92,44,48,74
Arbroath,1205,3,17,8,11,71,50,21,59
Alloa,1205,4,17,8,11,56,45,11,59
Stranraer,1205,5,16,5,15,58,64,-6,53
Airdrieon,1205,6,10,12,14,47,60,-13,42
East Fife,1205,7,13,3,20,47,67,-20,42
Forfar,1205,8,10,6,20,40,66,-26,36
Albion,1205,9,8,7,21,59,80,-21,31
Queen's Park,1205,10,7,10,19,41,73,-32,31
Raith,1206,1,23,8,5,71,32,39,77
Ayr,1206,2,24,4,8,93,44,49,76
Arbroath,1206,3,17,9,10,74,52,22,60
Alloa,1206,4,17,8,11,56,46,10,59
Stranraer,1206,5,16,5,15,58,65,-7,53
East Fife,1206,6,13,3,20,48,67,-19,42
Airdrieon,1206,7,10,11,15,45,61,-16,41
Forfar,1206,8,11,5,20,41,64,-23,38
Albion,1206,9,8,6,22,59,81,-22,30
Queen's Park,1206,10,6,11,19,43,76,-33,29
Raith,1207,1,23,8,5,73,32,41,77
Ayr,1207,2,24,4,8,92,43,49,76
Arbroath,1207,3,17,9,10,72,50,22,60
Alloa,1207,4,17,8,11,56,48,8,59
Stranraer,1207,5,16,5,15,58,65,-7,53
Airdrieon,1207,6,10,12,14,46,59,-13,42
East Fife,1207,7,13,3,20,48,67,-19,42
Forfar,1207,8,10,6,20,39,65,-26,36
Albion,1207,9,8,6,22,58,80,-22,30
Queen's Park,1207,10,6,11,19,41,74,-33,29
Raith,1208,1,23,8,5,69,32,37,77
Ayr,1208,2,23,4,9,91,44,47,73
Arbroath,1208,3,17,8,11,71,50,21,59
Alloa,1208,4,17,8,11,56,44,12,59
Stranraer,1208,5,15,5,16,57,67,-10,50
East Fife,1208,6,14,3,19,50,66,-16,45
Airdrieon,1208,7,10,12,14,45,58,-13,42
Forfar,1208,8,10,6,20,38,64,-26,36
Albion,1208,9,9,6,21,59,79,-20,33
Queen's Park,1208,10,7,10,19,41,73,-32,31
Ayr,1209,1,23,5,8,91,43,48,74
Raith,1209,2,22,8,6,70,36,34,74
Alloa,1209,3,18,8,10,60,45,15,62
Arbroath,1209,4,17,9,10,70,48,22,60
Stranraer,1209,5,15,6,15,55,64,-9,51
Airdrieon,1209,6,11,11,14,47,58,-11,44
East Fife,1209,7,13,4,19,47,64,-17,43
Forfar,1209,8,10,5,21,38,66,-28,35
Albion,1209,9,8,7,21,58,79,-21,31
Queen's Park,1209,10,6,11,19,39,72,-33,29
Ayr,1210,1,24,4,8,93,42,51,76
Raith,1210,2,22,9,5,69,33,36,75
Arbroath,1210,3,18,8,10,72,49,23,62
Alloa,1210,4,17,9,10,57,44,13,60
Stranraer,1210,5,15,5,16,56,67,-11,50
East Fife,1210,6,14,3,19,50,65,-15,45
Airdrieon,1210,7,11,11,14,47,59,-12,44
Forfar,1210,8,10,5,21,39,66,-27,35
Albion,1210,9,8,6,22,57,81,-24,30
Queen's Park,1210,10,6,10,20,40,74,-34,28
Raith,1211,1,23,8,5,69,32,37,77
Ayr,1211,2,24,4,8,96,42,54,76
Arbroath,1211,3,17,8,11,71,50,21,59
Alloa,1211,4,17,8,11,56,44,12,59
Stranraer,1211,5,16,5,15,58,65,-7,53
Airdrieon,1211,6,10,12,14,45,58,-13,42
East Fife,1211,7,13,3,20,48,67,-19,42
Forfar,1211,8,10,6,20,38,64,-26,36
Queen's Park,1211,9,7,10,19,41,73,-32,31
Albion,1211,10,8,6,22,57,84,-27,30
Raith,1212,1,23,8,5,73,32,41,77
Ayr,1212,2,24,4,8,95,44,51,76
Arbroath,1212,3,18,8,10,71,48,23,62
Alloa,1212,4,17,8,11,56,48,8,59
Stranraer,1212,5,15,5,16,57,67,-10,50
East Fife,1212,6,14,3,19,50,66,-16,45
Airdrieon,1212,7,11,11,14,48,59,-11,44
Forfar,1212,8,10,5,21,39,67,-28,35
Albion,1212,9,8,6,22,59,83,-24,30
Queen's Park,1212,10,6,10,20,39,73,-34,28
Ayr,1213,1,24,4,8,94,42,52,76
Raith,1213,2,22,9,5,69,33,36,75
Arbroath,1213,3,18,8,10,71,48,23,62
Alloa,1213,4,17,9,10,57,44,13,60
Stranraer,1213,5,15,6,15,56,65,-9,51
East Fife,1213,6,13,4,19,48,65,-17,43
Airdrieon,1213,7,10,12,14,47,60,-13,42
Forfar,1213,8,10,6,20,40,66,-26,36
Albion,1213,9,8,6,22,57,82,-25,30
Queen's Park,1213,10,6,10,20,39,73,-34,28
Ayr,1214,1,24,4,8,92,43,49,76
Raith,1214,2,22,8,6,68,34,34,74
Arbroath,1214,3,18,8,10,76,50,26,62
Alloa,1214,4,18,8,10,58,43,15,62
Stranraer,1214,5,15,5,16,56,68,-12,50
East Fife,1214,6,14,3,19,51,65,-14,45
Airdrieon,1214,7,11,11,14,52,59,-7,44
Forfar,1214,8,10,5,21,39,71,-32,35
Albion,1214,9,8,6,22,58,80,-22,30
Queen's Park,1214,10,6,10,20,41,78,-37,28
Raith,1215,1,23,8,5,69,32,37,77
Ayr,1215,2,24,4,8,92,42,50,76
Arbroath,1215,3,18,8,10,71,48,23,62
Alloa,1215,4,17,8,11,56,44,12,59
Stranraer,1215,5,16,5,15,56,64,-8,53
Airdrieon,1215,6,11,11,14,48,60,-12,44
East Fife,1215,7,13,3,20,47,65,-18,42
Forfar,1215,8,10,5,21,40,67,-27,35
Albion,1215,9,8,6,22,57,80,-23,30
Queen's Park,1215,10,6,10,20,39,73,-34,28
Ayr,1216,1,24,4,8,92,43,49,76
Raith,1216,2,22,8,6,68,34,34,74
Alloa,1216,3,18,8,10,58,43,15,62
Arbroath,1216,4,17,9,10,72,50,22,60
Stranraer,1216,5,15,6,15,55,64,-9,51
Airdrieon,1216,6,11,11,14,46,58,-12,44
East Fife,1216,7,13,4,19,47,64,-17,43
Forfar,1216,8,10,5,21,38,65,-27,35
Albion,1216,9,8,6,22,58,80,-22,30
Queen's Park,1216,10,6,11,19,41,74,-33,29
Raith,1217,1,23,8,5,69,32,37,77
Ayr,1217,2,24,4,8,93,44,49,76
Arbroath,1217,3,18,8,10,76,48,28,62
Alloa,1217,4,17,8,11,56,44,12,59
Stranraer,1217,5,15,5,16,55,66,-11,50
East Fife,1217,6,14,3,19,49,64,-15,45
Airdrieon,1217,7,10,11,15,46,60,-14,41
Forfar,1217,8,11,5,20,40,65,-25,38
Albion,1217,9,8,6,22,59,81,-22,30
Queen's Park,1217,10,6,10,20,39,78,-39,28
Ayr,1218,1,24,4,8,94,43,51,76
Raith,1218,2,22,8,6,68,33,35,74
Alloa,1218,3,18,8,10,57,43,14,62
Arbroath,1218,4,17,8,11,72,51,21,59
Stranraer,1218,5,15,5,16,55,65,-10,50
East Fife,1218,6,14,3,19,48,64,-16,45
Airdrieon,1218,7,10,11,15,47,61,-14,41
Forfar,1218,8,11,5,20,41,66,-25,38
Queen's Park,1218,9,7,10,19,42,74,-32,31
Albion,1218,10,8,6,22,58,82,-24,30
Raith,1219,1,23,8,5,71,33,38,77
Ayr,1219,2,24,4,8,91,42,49,76
Arbroath,1219,3,18,8,10,73,49,24,62
Alloa,1219,4,17,8,11,57,46,11,59
Stranraer,1219,5,15,5,16,56,67,-11,50
East Fife,1219,6,14,3,19,50,65,-15,45
Airdrieon,1219,7,11,11,14,46,58,-12,44
Forfar,1219,8,10,5,21,38,65,-27,35
Albion,1219,9,8,6,22,57,79,-22,30
Queen's Park,1219,10,6,10,20,40,75,-35,28
Ayr,1220,1,24,4,8,92,42,50,76
Raith,1220,2,22,8,6,69,34,35,74
Arbroath,1220,3,18,8,10,72,48,24,62
Alloa,1220,4,18,8,10,58,44,14,62
Stranraer,1220,5,15,5,16,57,68,-11,50
East Fife,1220,6,14,3,19,51,66,-15,45
Airdrieon,1220,7,10,12,14,48,61,-13,42
Forfar,1220,8,10,6,20,41,67,-26,36
Albion,1220,9,8,6,22,57,80,-23,30
Queen's Park,1220,10,6,10,20,39,74,-35,28
Raith,1221,1,23,8,5,73,36,37,77
Ayr,1221,2,24,4,8,93,43,50,76
Arbroath,1221,3,17,8,11,71,50,21,59
Alloa,1221,4,17,8,11,60,48,12,59
Stranraer,1221,5,15,5,16,56,67,-11,50
East Fife,1221,6,14,3,19,50,65,-15,45
Airdrieon,1221,7,11,11,14,47,59,-12,44
Forfar,1221,8,10,5,21,39,66,-27,35
Queen's Park,1221,9,7,10,19,41,73,-32,31
Albion,1221,10,8,6,22,58,81,-23,30
Ayr,1222,1,24,4,8,96,43,53,76
Raith,1222,2,22,9,5,68,32,36,75
Arbroath,1222,3,18,8,10,73,49,24,62
Alloa,1222,4,17,9,10,56,43,13,60
Stranraer,1222,5,15,5,16,55,65,-10,50
East Fife,1222,6,14,3,19,48,64,-16,45
Airdrieon,1222,7,11,11,14,47,59,-12,44
Forfar,1222,8,10,5,21,39,66,-27,35
Albion,1222,9,8,6,22,58,84,-26,30
Queen's Park,1222,10,6,10,20,40,75,-35,28
Raith,1223,1,23,8,5,71,34,37,77
Ayr,1223,2,24,4,8,95,44,51,76
Arbroath,1223,3,18,8,10,72,48,24,62
Alloa,1223,4,17,8,11,58,46,12,59
Stranraer,1223,5,15,5,16,57,68,-11,50
East Fife,1223,6,14,3,19,51,66,-15,45
Airdrieon,1223,7,11,11,14,47,58,-11,44
Forfar,1223,8,10,5,21,38,66,-28,35
Albion,1223,9,8,6,22,59,83,-24,30
Queen's Park,1223,10,6,10,20,39,74,-35,28
Ayr,1224,1,24,4,8,97,44,53,76
Raith,1224,2,22,9,5,68,32,36,75
Arbroath,1224,3,18,8,10,71,48,23,62
Alloa,1224,4,17,9,10,56,43,13,60
Stranraer,1224,5,16,5,15,59,67,-8,53
Airdrieon,1224,6,10,12,14,46,59,-13,42
East Fife,1224,7,13,3,20,50,68,-18,42
Forfar,1224,8,10,6,20,39,65,-26,36
Albion,1224,9,8,6,22,59,85,-26,30
Queen's Park,1224,10,6,10,20,39,73,-34,28
Ayr,1225,1,24,4,8,94,43,51,76
Raith,1225,2,22,8,6,68,34,34,74
Alloa,1225,3,18,8,10,58,43,15,62
Arbroath,1225,4,17,9,10,71,49,22,60
Stranraer,1225,5,15,5,16,56,66,-10,50
East Fife,1225,6,14,3,19,49,65,-16,45
Airdrieon,1225,7,11,11,14,47,58,-11,44
Forfar,1225,8,10,5,21,38,66,-28,35
Albion,1225,9,8,6,22,58,82,-24,30
Queen's Park,1225,10,6,11,19,40,73,-33,29
Raith,1226,1,23,8,5,70,33,37,77
Ayr,1226,2,24,4,8,94,44,50,76
Arbroath,1226,3,18,8,10,74,50,24,62
Alloa,1226,4,17,8,11,57,45,12,59
Stranraer,1226,5,15,5,16,55,66,-11,50
East Fife,1226,6,14,3,19,49,64,-15,45
Airdrieon,1226,7,11,11,14,47,59,-12,44
Forfar,1226,8,10,5,21,39,66,-27,35
Albion,1226,9,8,6,22,59,82,-23,30
Queen's Park,1226,10,6,10,20,41,76,-35,28
Ayr,1227,1,23,5,8,90,42,48,74
Raith,1227,2,22,8,6,69,34,35,74
Alloa,1227,3,18,8,10,58,44,14,62
Arbroath,1227,4,17,8,11,72,51,21,59
Stranraer,1227,5,15,6,15,55,64,-9,51
East Fife,1227,6,13,4,19,47,64,-17,43
Airdrieon,1227,7,10,11,15,46,60,-14,41
Forfar,1227,8,11,5,20,40,65,-25,38
Albion,1227,9,8,7,21,57,78,-21,31
Queen's Park,1227,10,7,10,19,42,74,-32,31
Ayr,1228,1,24,4,8,94,44,50,76
Raith,1228,2,22,9,5,68,32,36,75
Arbroath,1228,3,18,8,10,72,48,24,62
Alloa,1228,4,17,9,10,56,43,13,60
Stranraer,1228,5,16,5,15,56,64,-8,53
Airdrieon,1228,6,10,12,14,46,59,-13,42
East Fife,1228,7,13,3,20,47,65,-18,42
Forfar,1228,8,10,6,20,39,65,-26,36
Albion,1228,9,8,6,22,59,82,-23,30
Queen's Park,1228,10,6,10,20,39,74,-35,28
Raith,1229,1,23,8,5,72,32,40,77
Ayr,1229,2,24,4,8,97,44,53,76
Arbroath,1229,3,18,8,10,72,48,24,62
Alloa,1229,4,17,8,11,56,47,9,59
Stranraer,1229,5,15,5,16,55,67,-12,50
East Fife,1229,6,14,3,19,50,64,-14,45
Airdrieon,1229,7,11,11,14,47,58,-11,44
Forfar,1229,8,10,5,21,38,66,-28,35
Albion,1229,9,8,6,22,59,85,-26,30
Queen's Park,1229,10,6,10,20,39,74,-35,28
Raith,1230,1,23,8,5,70,32,38,77
Ayr,1230,2,24,4,8,94,44,50,76
Arbroath,1230,3,17,9,10,72,50,22,60
Alloa,1230,4,17,8,11,56,45,11,59
Stranraer,1230,5,15,6,15,56,65,-9,51
East Fife,1230,6,13,4,19,48,65,-17,43
Airdrieon,1230,7,10,11,15,46,62,-16,41
Forfar,1230,8,11,5,20,42,65,-23,38
Albion,1230,9,8,6,22,59,82,-23,30
Queen's Park,1230,10,6,11,19,41,74,-33,29
Raith,1231,1,23,8,5,69,32,37,77
Ayr,1231,2,24,4,8,97,42,55,76
Arbroath,1231,3,17,8,11,71,51,20,59
Alloa,1231,4,17,8,11,56,44,12,59
Stranraer,1231,5,15,5,16,55,67,-12,50
East Fife,1231,6,14,3,19,50,64,-14,45
Airdrieon,1231,7,10,12,14,46,59,-13,42
Forfar,1231,8,10,6,20,39,65,-26,36
Queen's Park,1231,9,7,10,19,42,73,-31,31
Albion,1231,10,8,6,22,57,85,-28,30
Raith,1232,1,23,8,5,69,32,37,77
Ayr,1232,2,24,4,8,93,43,50,76
Arbroath,1232,3,18,8,10,77,50,27,62
Alloa,1232,4,17,8,11,56,44,12,59
Stranraer,1232,5,15,5,16,56,66,-10,50
East Fife,1232,6,14,3,19,49,65,-16,45
Airdrieon,1232,7,10,11,15,45,60,-15,41
Forfar,1232,8,11,5,20,40,64,-24,38
Albion,1232,9,8,6,22,58,81,-23,30
Queen's Park,1232,10,6,10,20,41,79,-38,28
Ayr,1233,1,24,4,8,93,43,50,76
Raith,1233,2,22,9,5,69,33,36,75
Arbroath,1233,3,18,8,10,73,50,23,62
Alloa,1233,4,17,9,10,57,44,13,60
Stranraer,1233,5,15,5,16,57,67,-10,50
East Fife,1233,6,14,3,19,50,66,-16,45
Airdrieon,1233,7,10,11,15,45,59,-14,41
Forfar,1233,8,11,5,20,39,64,-25,38
Albion,1233,9,8,6,22,58,81,-23,30
Queen's Park,1233,10,6,10,20,41,75,-34,28
Raith,1234,1,23,8,5,71,32,39,77
Ayr,1234,2,24,4,8,92,43,49,76
Arbroath,1234,3,17,9,10,70,48,22,60
Alloa,1234,4,17,8,11,56,46,10,59
Stranraer,1234,5,16,5,15,56,64,-8,53
Airdrieon,1234,6,11,11,14,49,59,-10,44
East Fife,1234,7,13,3,20,47,65,-18,42
Forfar,1234,8,10,5,21,39,68,-29,35
Albion,1234,9,8,6,22,58,80,-22,30
Queen's Park,1234,10,6,11,19,39,72,-33,29
Ayr,1235,1,24,4,8,93,44,49,76
Raith,1235,2,22,8,6,70,35,35,74
Arbroath,1235,3,18,8,10,77,48,29,62
Alloa,1235,4,18,8,10,59,45,14,62
Stranraer,1235,5,15,5,16,56,67,-11,50
East Fife,1235,6,14,3,19,50,65,-15,45
Airdrieon,1235,7,10,12,14,47,60,-13,42
Forfar,1235,8,10,6,20,40,66,-26,36
Albion,1235,9,8,6,22,59,81,-22,30
Queen's Park,1235,10,6,10,20,39,79,-40,28
Ayr,1236,1,24,4,8,93,44,49,76
Raith,1236,2,22,9,5,68,32,36,75
Alloa,1236,3,17,9,10,56,43,13,60
Arbroath,1236,4,17,8,11,70,49,21,59
Stranraer,1236,5,16,5,15,60,65,-5,53
Airdrieon,1236,6,11,11,14,48,58,-10,44
East Fife,1236,7,13,3,20,48,69,-21,42
Forfar,1236,8,10,5,21,38,67,-29,35
Queen's Park,1236,9,7,10,19,40,72,-32,31
Albion,1236,10,8,6,22,59,81,-22,30
Ayr,1237,1,24,4,8,94,43,51,76
Raith,1237,2,22,8,6,69,35,34,74
Arbroath,1237,3,18,8,10,76,48,28,62
Alloa,1237,4,18,8,10,59,44,15,62
Stranraer,1237,5,15,5,16,56,68,-12,50
East Fife,1237,6,14,3,19,51,65,-14,45
Airdrieon,1237,7,10,12,14,46,59,-13,42
Forfar,1237,8,10,6,20,39,65,-26,36
Albion,1237,9,8,6,22,58,82,-24,30
Queen's Park,1237,10,6,10,20,39,78,-39,28
Ayr,1238,1,24,4,8,93,42,51,76
Raith,1238,2,22,8,6,69,34,35,74
Arbroath,1238,3,18,8,10,72,48,24,62
Alloa,1238,4,18,8,10,58,44,14,62
Stranraer,1238,5,16,5,15,58,66,-8,53
Airdrieon,1238,6,10,12,14,47,60,-13,42
East Fife,1238,7,13,3,20,49,67,-18,42
Forfar,1238,8,10,6,20,40,66,-26,36
Albion,1238,9,8,6,22,57,81,-24,30
Queen's Park,1238,10,6,10,20,39,74,-35,28
Ayr,1239,1,24,4,8,94,43,51,76
Raith,1239,2,22,9,5,69,33,36,75
Alloa,1239,3,17,9,10,57,44,13,60
Arbroath,1239,4,17,8,11,71,51,20,59
Stranraer,1239,5,16,5,15,59,65,-6,53
Airdrieon,1239,6,10,12,14,46,59,-13,42
East Fife,1239,7,13,3,20,48,68,-20,42
Forfar,1239,8,10,6,20,39,65,-26,36
Queen's Park,1239,9,7,10,19,42,73,-31,31
Albion,1239,10,8,6,22,58,82,-24,30
Raith,1240,1,23,8,5,70,32,38,77
Ayr,1240,2,24,4,8,94,42,52,76
Arbroath,1240,3,17,8,11,70,49,21,59
Alloa,1240,4,17,8,11,56,45,11,59
Stranraer,1240,5,15,6,15,59,68,-9,51
East Fife,1240,6,13,4,19,51,68,-17,43
Airdrieon,1240,7,10,11,15,46,62,-16,41
Forfar,1240,8,11,5,20,42,65,-23,38
Queen's Park,1240,9,7,10,19,40,72,-32,31
Albion,1240,10,8,6,22,57,82,-25,30
Ayr,1241,1,24,4,8,94,43,51,76
Raith,1241,2,22,8,6,68,36,32,74
Arbroath,1241,3,18,8,10,74,50,24,62
Alloa,1241,4,18,8,10,60,43,17,62
Stranraer,1241,5,15,5,16,56,66,-10,50
East Fife,1241,6,14,3,19,49,65,-16,45
Airdrieon,1241,7,10,11,15,45,59,-14,41
Forfar,1241,8,11,5,20,39,64,-25,38
Albion,1241,9,8,6,22,58,82,-24,30
Queen's Park,1241,10,6,10,20,41,76,-35,28
Ayr,1242,1,24,4,8,93,43,50,76
Raith,1242,2,22,9,5,68,32,36,75
Arbroath,1242,3,18,8,10,73,48,25,62
Alloa,1242,4,17,9,10,56,43,13,60
Stranraer,1242,5,15,5,16,57,67,-10,50
East Fife,1242,6,14,3,19,50,66,-16,45
Airdrieon,1242,7,10,11,15,46,60,-14,41
Forfar,1242,8,11,5,20,40,65,-25,38
Albion,1242,9,8,6,22,58,81,-23,30
Queen's Park,1242,10,6,10,20,39,75,-36,28
Raith,1243,1,23,8,5,75,34,41,77
Ayr,1243,2,24,4,8,95,43,52,76
Arbroath,1243,3,17,8,11,70,49,21,59
Alloa,1243,4,17,8,11,58,50,8,59
Stranraer,1243,5,15,5,16,55,65,-10,50
East Fife,1243,6,14,3,19,48,64,-16,45
Airdrieon,1243,7,10,12,14,47,60,-13,42
Forfar,1243,8,10,6,20,40,66,-26,36
Queen's Park,1243,9,7,10,19,40,72,-32,31
Albion,1243,10,8,6,22,58,83,-25,30
Ayr,1244,1,24,4,8,91,42,49,76
Raith,1244,2,22,8,6,68,33,35,74
Arbroath,1244,3,18,8,10,73,49,24,62
Alloa,1244,4,18,8,10,57,43,14,62
Stranraer,1244,5,15,5,16,56,67,-11,50
East Fife,1244,6,14,3,19,50,65,-15,45
Airdrieon,1244,7,10,12,14,45,58,-13,42
Forfar,1244,8,10,6,20,38,64,-26,36
Albion,1244,9,8,6,22,57,79,-22,30
Queen's Park,1244,10,6,10,20,40,75,-35,28
Raith,1245,1,23,8,5,72,33,39,77
Ayr,1245,2,24,4,8,91,42,49,76
Arbroath,1245,3,18,8,10,74,51,23,62
Alloa,1245,4,17,8,11,57,47,10,59
Stranraer,1245,5,15,5,16,56,68,-12,50
East Fife,1245,6,14,3,19,51,65,-14,45
Airdrieon,1245,7,11,11,14,48,58,-10,44
Forfar,1245,8,10,5,21,38,67,-29,35
Albion,1245,9,8,6,22,57,79,-22,30
Queen's Park,1245,10,6,10,20,42,76,-34,28
Raith,1246,1,23,8,5,70,32,38,77
Ayr,1246,2,23,4,9,90,43,47,73
Arbroath,1246,3,18,8,10,71,48,23,62
Alloa,1246,4,17,8,11,56,45,11,59
Stranraer,1246,5,15,5,16,55,65,-10,50
East Fife,1246,6,14,3,19,48,64,-16,45
Airdrieon,1246,7,10,11,15,46,60,-14,41
Forfar,1246,8,11,5,20,40,65,-25,38
Albion,1246,9,9,6,21,58,78,-20,33
Queen's Park,1246,10,6,10,20,39,73,-34,28
Raith,1247,1,23,8,5,70,32,38,77
Ayr,1247,2,24,4,8,94,45,49,76
Arbroath,1247,3,17,8,11,71,50,21,59
Alloa,1247,4,17,8,11,56,45,11,59
Stranraer,1247,5,15,5,16,56,66,-10,50
East Fife,1247,6,14,3,19,49,65,-16,45
Airdrieon,1247,7,10,11,15,46,61,-15,41
Forfar,1247,8,11,5,20,41,65,-24,38
Queen's Park,1247,9,7,10,19,41,73,-32,31
Albion,1247,10,8,6,22,60,82,-22,30
Raith,1248,1,23,8,5,69,32,37,77
Ayr,1248,2,23,4,9,92,45,47,73
Arbroath,1248,3,18,8,10,74,49,25,62
Alloa,1248,4,17,8,11,56,44,12,59
Stranraer,1248,5,15,5,16,55,65,-10,50
East Fife,1248,6,14,3,19,48,64,-16,45
Airdrieon,1248,7,10,11,15,45,60,-15,41
Forfar,1248,8,11,5,20,40,64,-24,38
Albion,1248,9,9,6,21,60,80,-20,33
Queen's Park,1248,10,6,10,20,40,76,-36,28
Ayr,1249,1,23,5,8,91,43,48,74
Raith,1249,2,22,8,6,69,34,35,74
Arbroath,1249,3,18,8,10,74,49,25,62
Alloa,1249,4,18,8,10,58,44,14,62
Stranraer,1249,5,15,6,15,57,66,-9,51
Airdrieon,1249,6,11,11,14,48,59,-11,44
East Fife,1249,7,13,4,19,49,66,-17,43
Forfar,1249,8,10,5,21,39,67,-28,35
Albion,1249,9,8,7,21,58,79,-21,31
Queen's Park,1249,10,6,10,20,40,76,-36,28
Ayr,1250,1,24,4,8,96,44,52,76
Raith,1250,2,22,9,5,70,34,36,75
Arbroath,1250,3,18,8,10,72,49,23,62
Alloa,1250,4,17,9,10,58,45,13,60
Stranraer,1250,5,16,5,15,56,64,-8,53
Airdrieon,1250,6,11,11,14,47,59,-12,44
East Fife,1250,7,13,3,20,47,65,-18,42
Forfar,1250,8,10,5,21,39,66,-27,35
Albion,1250,9,8,6,22,59,84,-25,30
Queen's Park,1250,10,6,10,20,40,74,-34,28
Raith,1251,1,23,8,5,70,33,37,77
Ayr,1251,2,24,4,8,93,43,50,76
Arbroath,1251,3,18,8,10,75,49,26,62
Alloa,1251,4,17,8,11,57,45,12,59
Stranraer,1251,5,15,6,15,55,64,-9,51
Airdrieon,1251,6,11,11,14,49,58,-9,44
East Fife,1251,7,13,4,19,47,64,-17,43
Forfar,1251,8,10,5,21,38,68,-30,35
Albion,1251,9,8,6,22,58,81,-23,30
Queen's Park,1251,10,6,10,20,40,77,-37,28
Raith,1252,1,23,8,5,71,33,38,77
Ayr,1252,2,24,4,8,95,45,50,76
Arbroath,1252,3,17,9,10,72,50,22,60
Alloa,1252,4,17,8,11,57,46,11,59
Stranraer,1252,5,16,5,15,56,64,-8,53
Airdrieon,1252,6,10,12,14,46,59,-13,42
East Fife,1252,7,13,3,20,47,65,-18,42
Forfar,1252,8,10,6,20,39,65,-26,36
Albion,1252,9,8,6,22,60,83,-23,30
Queen's Park,1252,10,6,11,19,41,74,-33,29
Raith,1253,1,23,8,5,69,32,37,77
Ayr,1253,2,24,4,8,94,44,50,76
Arbroath,1253,3,18,8,10,74,48,26,62
Alloa,1253,4,17,8,11,56,44,12,59
Stranraer,1253,5,15,5,16,57,68,-11,50
East Fife,1253,6,14,3,19,51,66,-15,45
Airdrieon,1253,7,11,11,14,47,59,-12,44
Forfar,1253,8,10,5,21,39,66,-27,35
Albion,1253,9,8,6,22,59,82,-23,30
Queen's Park,1253,10,6,10,20,39,76,-37,28
Ayr,1254,1,24,4,8,96,44,52,76
Raith,1254,2,22,9,5,69,33,36,75
Alloa,1254,3,17,9,10,57,44,13,60
Arbroath,1254,4,17,8,11,70,49,21,59
Stranraer,1254,5,15,6,15,56,65,-9,51
East Fife,1254,6,13,4,19,48,65,-17,43
Airdrieon,1254,7,10,12,14,46,59,-13,42
Forfar,1254,8,10,6,20,39,65,-26,36
Queen's Park,1254,9,7,10,19,40,72,-32,31
Albion,1254,10,8,6,22,59,84,-25,30
Ayr,1255,1,24,4,8,93,44,49,76
Raith,1255,2,22,9,5,69,33,36,75
Arbroath,1255,3,18,8,10,73,48,25,62
Alloa,1255,4,17,9,10,57,44,13,60
Stranraer,1255,5,15,5,16,55,66,-11,50
East Fife,1255,6,14,3,19,49,64,-15,45
Airdrieon,1255,7,10,12,14,46,59,-13,42
Forfar,1255,8,10,6,20,39,65,-26,36
Albion,1255,9,8,6,22,59,81,-22,30
Queen's Park,1255,10,6,10,20,39,75,-36,28
Ayr,1256,1,24,4,8,93,42,51,76
Raith,1256,2,22,9,5,70,34,36,75
Alloa,1256,3,17,9,10,58,45,13,60
Arbroath,1256,4,17,8,11,71,52,19,59
Stranraer,1256,5,15,5,16,56,67,-11,50
East Fife,1256,6,14,3,19,50,65,-15,45
Airdrieon,1256,7,11,11,14,47,59,-12,44
Forfar,1256,8,10,5,21,39,66,-27,35
Queen's Park,1256,9,7,10,19,43,73,-30,31
Albion,1256,10,8,6,22,57,81,-24,30
Raith,1257,1,23,8,5,71,32,39,77
Ayr,1257,2,24,4,8,96,43,53,76
Arbroath,1257,3,18,8,10,72,48,24,62
Alloa,1257,4,17,8,11,56,46,10,59
Stranraer,1257,5,16,5,15,57,65,-8,53
Airdrieon,1257,6,11,11,14,49,60,-11,44
East Fife,1257,7,13,3,20,48,66,-18,42
Forfar,1257,8,10,5,21,40,68,-28,35
Albion,1257,9,8,6,22,58,84,-26,30
Queen's Park,1257,10,6,10,20,39,74,-35,28
Raith,1258,1,23,8,5,70,32,38,77
Ayr,1258,2,24,4,8,94,42,52,76
Arbroath,1258,3,18,8,10,73,49,24,62
Alloa,1258,4,17,8,11,56,45,11,59
Stranraer,1258,5,15,5,16,55,68,-13,50
East Fife,1258,6,14,3,19,51,64,-13,45
Airdrieon,1258,7,11,11,14,47,58,-11,44
Forfar,1258,8,10,5,21,38,66,-28,35
Albion,1258,9,8,6,22,57,82,-25,30
Queen's Park,1258,10,6,10,20,40,75,-35,28
Raith,1259,1,23,8,5,69,32,37,77
Ayr,1259,2,24,4,8,94,43,51,76
Arbroath,1259,3,18,8,10,75,49,26,62
Alloa,1259,4,17,8,11,56,44,12,59
Stranraer,1259,5,15,5,16,55,66,-11,50
East Fife,1259,6,14,3,19,49,64,-15,45
Airdrieon,1259,7,10,11,15,45,60,-15,41
Forfar,1259,8,11,5,20,40,64,-24,38
Albion,1259,9,8,6,22,58,82,-24,30
Queen's Park,1259,10,6,10,20,40,77,-37,28
Raith,1260,1,23,8,5,69,32,37,77
Ayr,1260,2,23,4,9,92,45,47,73
Arbroath,1260,3,18,8,10,74,50,24,62
Alloa,1260,4,17,8,11,56,44,12,59
Stranraer,1260,5,15,5,16,56,66,-10,50
East Fife,1260,6,14,3,19,49,65,-16,45
Airdrieon,1260,7,11,11,14,48,60,-12,44
Forfar,1260,8,10,5,21,40,67,-27,35
Albion,1260,9,9,6,21,60,80,-20,33
Queen's Park,1260,10,6,10,20,41,76,-35,28
Ayr,1261,1,24,4,8,93,43,50,76
Raith,1261,2,22,8,6,68,33,35,74
Arbroath,1261,3,18,8,10,72,49,23,62
Alloa,1261,4,18,8,10,57,43,14,62
Stranraer,1261,5,15,5,16,56,68,-12,50
East Fife,1261,6,14,3,19,51,65,-14,45
Airdrieon,1261,7,10,11,15,45,59,-14,41
Forfar,1261,8,11,5,20,39,64,-25,38
Albion,1261,9,8,6,22,58,81,-23,30
Queen's Park,1261,10,6,10,20,40,74,-34,28
Raith,1262,1,23,8,5,71,32,39,77
Ayr,1262,2,24,4,8,92,42,50,76
Arbroath,1262,3,17,8,11,70,51,19,59
Alloa,1262,4,17,8,11,56,46,10,59
Stranraer,1262,5,16,5,15,57,64,-7,53
Airdrieon,1262,6,11,11,14,47,59,-12,44
East Fife,1262,7,13,3,20,47,66,-19,42
Forfar,1262,8,10,5,21,39,66,-27,35
Queen's Park,1262,9,7,10,19,42,72,-30,31
Albion,1262,10,8,6,22,57,80,-23,30
Raith,1263,1,23,8,5,69,32,37,77
Ayr,1263,2,24,4,8,92,43,49,76
Arbroath,1263,3,18,8,10,74,50,24,62
Alloa,1263,4,17,8,11,56,44,12,59
Stranraer,1263,5,15,5,16,55,66,-11,50
East Fife,1263,6,14,3,19,49,64,-15,45
Airdrieon,1263,7,11,11,14,47,58,-11,44
Forfar,1263,8,10,5,21,38,66,-28,35
Albion,1263,9,8,6,22,58,80,-22,30
Queen's Park,1263,10,6,10,20,41,76,-35,28
Ayr,1264,1,24,4,8,93,42,51,76
Raith,1264,2,22,9,5,68,32,36,75
Arbroath,1264,3,17,9,10,72,50,22,60
Alloa,1264,4,17,9,10,56,43,13,60
Stranraer,1264,5,15,5,16,55,67,-12,50
East Fife,1264,6,14,3,19,50,64,-14,45
Airdrieon,1264,7,11,11,14,46,58,-12,44
Forfar,1264,8,10,5,21,38,65,-27,35
Albion,1264,9,8,6,22,57,81,-24,30
Queen's Park,1264,10,6,11,19,41,74,-33,29
Raith,1265,1,23,8,5,70,33,37,77
Ayr,1265,2,24,4,8,94,44,50,76
Arbroath,1265,3,17,9,10,72,50,22,60
Alloa,1265,4,17,8,11,57,45,12,59
Stranraer,1265,5,16,5,15,56,64,-8,53
East Fife,1265,6,13,3,20,47,65,-18,42
Airdrieon,1265,7,10,11,15,45,60,-15,41
Forfar,1265,8,11,5,20,40,64,-24,38
Albion,1265,9,8,6,22,59,82,-23,30
Queen's Park,1265,10,6,11,19,41,74,-33,29
Raith,1266,1,23,8,5,69,32,37,77
Ayr,1266,2,24,4,8,92,43,49,76
Arbroath,1266,3,17,9,10,71,49,22,60
Alloa,1266,4,17,8,11,56,44,12,59
Stranraer,1266,5,15,5,16,57,67,-10,50
East Fife,1266,6,14,3,19,50,66,-16,45
Airdrieon,1266,7,10,12,14,46,59,-13,42
Forfar,1266,8,10,6,20,39,65,-26,36
Albion,1266,9,8,6,22,58,80,-22,30
Queen's Park,1266,10,6,11,19,40,73,-33,29
Raith,1267,1,23,8,5,70,32,38,77
Ayr,1267,2,24,4,8,94,44,50,76
Arbroath,1267,3,18,8,10,73,49,24,62
Alloa,1267,4,17,8,11,56,45,11,59
Stranraer,1267,5,15,5,16,58,68,-10,50
East Fife,1267,6,14,3,19,51,67,-16,45
Airdrieon,1267,7,10,11,15,45,59,-14,41
Forfar,1267,8,11,5,20,39,64,-25,38
Albion,1267,9,8,6,22,59,82,-23,30
Queen's Park,1267,10,6,10,20,40,75,-35,28
Raith,1268,1,23,8,5,72,33,39,77
Ayr,1268,2,24,4,8,92,43,49,76
Arbroath,1268,3,17,9,10,72,50,22,60
Alloa,1268,4,17,8,11,57,47,10,59
Stranraer,1268,5,15,5,16,55,68,-13,50
East Fife,1268,6,14,3,19,51,64,-13,45
Airdrieon,1268,7,11,11,14,48,58,-10,44
Forfar,1268,8,10,5,21,38,67,-29,35
Albion,1268,9,8,6,22,58,80,-22,30
Queen's Park,1268,10,6,11,19,41,74,-33,29
Raith,1269,1,23,8,5,72,32,40,77
Ayr,1269,2,24,4,8,95,44,51,76
Arbroath,1269,3,17,8,11,71,50,21,59
Alloa,1269,4,17,8,11,56,47,9,59
Stranraer,1269,5,16,5,15,57,64,-7,53
Airdrieon,1269,6,11,11,14,48,60,-12,44
East Fife,1269,7,13,3,20,47,66,-19,42
Forfar,1269,8,10,5,21,40,67,-27,35
Queen's Park,1269,9,7,10,19,41,73,-32,31
Albion,1269,10,8,6,22,59,83,-24,30
Raith,1270,1,23,8,5,69,32,37,77
Ayr,1270,2,23,4,9,90,43,47,73
Arbroath,1270,3,17,9,10,71,49,22,60
Alloa,1270,4,17,8,11,56,44,12,59
Stranraer,1270,5,15,5,16,56,66,-10,50
East Fife,1270,6,14,3,19,49,65,-16,45
Airdrieon,1270,7,11,11,14,46,58,-12,44
Forfar,1270,8,10,5,21,38,65,-27,35
Albion,1270,9,9,6,21,58,78,-20,33
Queen's Park,1270,10,6,11,19,40,73,-33,29
Raith,1271,1,23,8,5,71,32,39,77
Ayr,1271,2,24,4,8,92,43,49,76
Arbroath,1271,3,18,8,10,73,50,23,62
Alloa,1271,4,17,8,11,56,46,10,59
Stranraer,1271,5,15,5,16,56,66,-10,50
East Fife,1271,6,14,3,19,49,65,-16,45
Airdrieon,1271,7,10,12,14,45,58,-13,42
Forfar,1271,8,10,6,20,38,64,-26,36
Albion,1271,9,8,6,22,58,80,-22,30
Queen's Park,1271,10,6,10,20,41,75,-34,28
Raith,1272,1,23,8,5,72,33,39,77
Ayr,1272,2,23,4,9,91,45,46,73
Arbroath,1272,3,17,8,11,71,50,21,59
Alloa,1272,4,17,8,11,57,47,10,59
Stranraer,1272,5,15,5,16,55,69,-14,50
East Fife,1272,6,14,3,19,52,64,-12,45
Airdrieon,1272,7,11,11,14,50,60,-10,44
Forfar,1272,8,10,5,21,40,69,-29,35
Albion,1272,9,9,6,21,60,79,-19,33
Queen's Park,1272,10,7,10,19,41,73,-32,31
Raith,1273,1,23,8,5,71,34,37,77
Ayr,1273,2,24,4,8,96,44,52,76
Arbroath,1273,3,18,8,10,73,48,25,62
Alloa,1273,4,17,8,11,58,46,12,59
Stranraer,1273,5,15,5,16,56,66,-10,50
East Fife,1273,6,14,3,19,49,65,-16,45
Airdrieon,1273,7,10,12,14,46,59,-13,42
Forfar,1273,8,10,6,20,39,65,-26,36
Albion,1273,9,8,6,22,59,84,-25,30
Queen's Park,1273,10,6,10,20,39,75,-36,28
Raith,1274,1,23,8,5,71,34,37,77
Ayr,1274,2,24,4,8,96,43,53,76
Arbroath,1274,3,18,8,10,73,48,25,62
Alloa,1274,4,17,8,11,58,46,12,59
Stranraer,1274,5,15,5,16,56,66,-10,50
East Fife,1274,6,14,3,19,49,65,-16,45
Airdrieon,1274,7,10,11,15,46,60,-14,41
Forfar,1274,8,11,5,20,40,65,-25,38
Albion,1274,9,8,6,22,58,84,-26,30
Queen's Park,1274,10,6,10,20,39,75,-36,28
Ayr,1275,1,24,4,8,95,43,52,76
Raith,1275,2,22,9,5,69,33,36,75
Arbroath,1275,3,17,9,10,70,48,22,60
Alloa,1275,4,17,9,10,57,44,13,60
Stranraer,1275,5,15,5,16,55,65,-10,50
East Fife,1275,6,14,3,19,48,64,-16,45
Airdrieon,1275,7,11,11,14,47,59,-12,44
Forfar,1275,8,10,5,21,39,66,-27,35
Albion,1275,9,8,6,22,58,83,-25,30
Queen's Park,1275,10,6,11,19,39,72,-33,29
Ayr,1276,1,24,4,8,99,43,56,76
Raith,1276,2,22,8,6,68,34,34,74
Alloa,1276,3,18,8,10,58,43,15,62
Arbroath,1276,4,17,9,10,71,49,22,60
Stranraer,1276,5,15,5,16,55,65,-10,50
East Fife,1276,6,14,3,19,48,64,-16,45
Airdrieon,1276,7,10,12,14,46,59,-13,42
Forfar,1276,8,10,6,20,39,65,-26,36
Albion,1276,9,8,6,22,58,87,-29,30
Queen's Park,1276,10,6,11,19,40,73,-33,29
Raith,1277,1,23,8,5,70,32,38,77
Ayr,1277,2,24,4,8,91,42,49,76
Arbroath,1277,3,17,8,11,70,49,21,59
Alloa,1277,4,17,8,11,56,45,11,59
Stranraer,1277,5,15,5,16,55,67,-12,50
East Fife,1277,6,14,3,19,50,64,-14,45
Airdrieon,1277,7,10,11,15,45,59,-14,41
Forfar,1277,8,11,5,20,39,64,-25,38
Queen's Park,1277,9,7,10,19,40,72,-32,31
Albion,1277,10,8,6,22,57,79,-22,30
Raith,1278,1,23,8,5,70,32,38,77
Ayr,1278,2,24,4,8,93,44,49,76
Arbroath,1278,3,17,8,11,71,50,21,59
Alloa,1278,4,17,8,11,56,45,11,59
Stranraer,1278,5,16,5,15,59,66,-7,53
East Fife,1278,6,13,3,20,49,68,-19,42
Airdrieon,1278,7,10,11,15,47,61,-14,41
Forfar,1278,8,11,5,20,41,66,-25,38
Queen's Park,1278,9,7,10,19,41,73,-32,31
Albion,1278,10,8,6,22,59,81,-22,30
Ayr,1279,1,24,4,8,95,44,51,76
Raith,1279,2,22,9,5,70,34,36,75
Arbroath,1279,3,17,9,10,71,49,22,60
Alloa,1279,4,17,9,10,58,45,13,60
Stranraer,1279,5,16,5,15,58,65,-7,53
Airdrieon,1279,6,10,12,14,46,59,-13,42
East Fife,1279,7,13,3,20,48,67,-19,42
Forfar,1279,8,10,6,20,39,65,-26,36
Albion,1279,9,8,6,22,59,83,-24,30
Queen's Park,1279,10,6,11,19,40,73,-33,29
Raith,1280,1,23,8,5,72,33,39,77
Ayr,1280,2,24,4,8,94,45,49,76
Arbroath,1280,3,17,9,10,71,49,22,60
Alloa,1280,4,17,8,11,57,47,10,59
Stranraer,1280,5,15,5,16,55,67,-12,50
East Fife,1280,6,14,3,19,50,64,-14,45
Airdrieon,1280,7,11,11,14,49,59,-10,44
Forfar,1280,8,10,5,21,39,68,-29,35
Albion,1280,9,8,6,22,60,82,-22,30
Queen's Park,1280,10,6,11,19,40,73,-33,29
Ayr,1281,1,24,4,8,96,43,53,76
Raith,1281,2,22,8,6,68,34,34,74
Arbroath,1281,3,18,8,10,71,48,23,62
Alloa,1281,4,18,8,10,58,43,15,62
Stranraer,1281,5,15,6,15,57,66,-9,51
East Fife,1281,6,13,4,19,49,66,-17,43
Airdrieon,1281,7,10,11,15,46,60,-14,41
Forfar,1281,8,11,5,20,40,65,-25,38
Albion,1281,9,8,6,22,58,84,-26,30
Queen's Park,1281,10,6,10,20,39,73,-34,28
Raith,1282,1,23,8,5,71,33,38,77
Ayr,1282,2,24,4,8,93,43,50,76
Arbroath,1282,3,18,8,10,75,48,27,62
Alloa,1282,4,17,8,11,57,46,11,59
Stranraer,1282,5,15,5,16,55,65,-10,50
East Fife,1282,6,14,3,19,48,64,-16,45
Airdrieon,1282,7,10,11,15,47,61,-14,41
Forfar,1282,8,11,5,20,41,66,-25,38
Albion,1282,9,8,6,22,58,81,-23,30
Queen's Park,1282,10,6,10,20,39,77,-38,28
Raith,1283,1,23,8,5,70,33,37,77
Ayr,1283,2,24,4,8,92,43,49,76
Arbroath,1283,3,17,9,10,70,48,22,60
Alloa,1283,4,17,8,11,57,45,12,59
Stranraer,1283,5,15,5,16,56,66,-10,50
East Fife,1283,6,14,3,19,49,65,-16,45
Airdrieon,1283,7,11,11,14,47,59,-12,44
Forfar,1283,8,10,5,21,39,66,-27,35
Albion,1283,9,8,6,22,58,80,-22,30
Queen's Park,1283,10,6,11,19,39,72,-33,29
Ayr,1284,1,24,4,8,94,44,50,76
Raith,1284,2,22,9,5,69,33,36,75
Arbroath,1284,3,17,9,10,72,50,22,60
Alloa,1284,4,17,9,10,57,44,13,60
Stranraer,1284,5,16,5,15,59,67,-8,53
Airdrieon,1284,6,11,11,14,47,58,-11,44
East Fife,1284,7,13,3,20,50,68,-18,42
Forfar,1284,8,10,5,21,38,66,-28,35
Albion,1284,9,8,6,22,59,82,-23,30
Queen's Park,1284,10,6,11,19,41,74,-33,29
Raith,1285,1,23,8,5,69,32,37,77
Ayr,1285,2,24,4,8,93,43,50,76
Arbroath,1285,3,18,8,10,72,49,23,62
Alloa,1285,4,17,8,11,56,44,12,59
Stranraer,1285,5,15,5,16,55,68,-13,50
East Fife,1285,6,14,3,19,51,64,-13,45
Airdrieon,1285,7,10,11,15,45,59,-14,41
Forfar,1285,8,11,5,20,39,64,-25,38
Albion,1285,9,8,6,22,58,81,-23,30
Queen's Park,1285,10,6,10,20,40,74,-34,28
Ayr,1286,1,24,4,8,94,45,49,76
Raith,1286,2,22,8,6,68,33,35,74
Arbroath,1286,3,18,8,10,74,48,26,62
Alloa,1286,4,18,8,10,57,43,14,62
Stranraer,1286,5,15,5,16,56,66,-10,50
East Fife,1286,6,14,3,19,49,65,-16,45
Airdrieon,1286,7,10,12,14,46,59,-13,42
Forfar,1286,8,10,6,20,39,65,-26,36
Albion,1286,9,8,6,22,60,82,-22,30
Queen's Park,1286,10,6,10,20,39,76,-37,28
Ayr,1287,1,24,4,8,94,44,50,76
Raith,1287,2,22,8,6,68,34,34,74
Alloa,1287,3,18,8,10,58,43,15,62
Arbroath,1287,4,17,8,11,71,51,20,59
Stranraer,1287,5,15,6,15,56,65,-9,51
East Fife,1287,6,13,4,19,48,65,-17,43
Airdrieon,1287,7,10,11,15,47,63,-16,41
Forfar,1287,8,11,5,20,43,66,-23,38
Queen's Park,1287,9,7,10,19,42,73,-31,31
Albion,1287,10,8,6,22,59,82,-23,30
Ayr,1288,1,24,4,8,95,42,53,76
Raith,1288,2,22,8,6,68,35,33,74
Alloa,1288,3,18,8,10,59,43,16,62
Arbroath,1288,4,17,8,11,71,50,21,59
Stranraer,1288,5,15,6,15,58,67,-9,51
Airdrieon,1288,6,11,11,14,47,58,-11,44
East Fife,1288,7,13,4,19,50,67,-17,43
Forfar,1288,8,10,5,21,38,66,-28,35
Queen's Park,1288,9,7,10,19,41,73,-32,31
Albion,1288,10,8,6,22,57,83,-26,30
Raith,1289,1,22,8,6,68,33,35,74
Ayr,1289,2,23,4,9,93,47,46,73
Arbroath,1289,3,18,8,10,74,50,24,62
Alloa,1289,4,18,8,10,57,43,14,62
Stranraer,1289,5,15,5,16,55,67,-12,50
East Fife,1289,6,14,3,19,50,64,-14,45
Airdrieon,1289,7,10,11,15,45,60,-15,41
Forfar,1289,8,11,5,20,40,64,-24,38
Albion,1289,9,9,6,21,62,81,-19,33
Queen's Park,1289,10,6,10,20,41,76,-35,28
Ayr,1290,1,24,4,8,95,42,53,76
Raith,1290,2,22,8,6,68,35,33,74
Arbroath,1290,3,18,8,10,72,49,23,62
Alloa,1290,4,18,8,10,59,43,16,62
Stranraer,1290,5,15,5,16,55,67,-12,50
East Fife,1290,6,14,3,19,50,64,-14,45
Airdrieon,1290,7,11,11,14,49,58,-9,44
Forfar,1290,8,10,5,21,38,68,-30,35
Albion,1290,9,8,6,22,57,83,-26,30
Queen's Park,1290,10,6,10,20,40,74,-34,28
Raith,1291,1,23,8,5,71,33,38,77
Ayr,1291,2,24,4,8,95,42,53,76
Arbroath,1291,3,17,8,11,70,49,21,59
Alloa,1291,4,17,8,11,57,46,11,59
Stranraer,1291,5,15,6,15,56,65,-9,51
East Fife,1291,6,13,4,19,48,65,-17,43
Airdrieon,1291,7,10,11,15,46,60,-14,41
Forfar,1291,8,11,5,20,40,65,-25,38
Queen's Park,1291,9,7,10,19,40,72,-32,31
Albion,1291,10,8,6,22,57,83,-26,30
Ayr,1292,1,24,4,8,92,43,49,76
Raith,1292,2,22,8,6,68,33,35,74
Alloa,1292,3,18,8,10,57,43,14,62
Arbroath,1292,4,17,9,10,71,49,22,60
Stranraer,1292,5,16,5,15,57,64,-7,53
Airdrieon,1292,6,10,12,14,49,62,-13,42
East Fife,1292,7,13,3,20,47,66,-19,42
Forfar,1292,8,10,6,20,42,68,-26,36
Albion,1292,9,8,6,22,58,80,-22,30
Queen's Park,1292,10,6,11,19,40,73,-33,29
Ayr,1293,1,24,4,8,96,43,53,76
Raith,1293,2,22,8,6,70,35,35,74
Alloa,1293,3,18,8,10,59,45,14,62
Arbroath,1293,4,17,8,11,72,51,21,59
Stranraer,1293,5,16,5,15,56,64,-8,53
Airdrieon,1293,6,10,12,14,46,59,-13,42
East Fife,1293,7,13,3,20,47,65,-18,42
Forfar,1293,8,10,6,20,39,65,-26,36
Queen's Park,1293,9,7,10,19,42,74,-32,31
Albion,1293,10,8,6,22,58,84,-26,30
Raith,1294,1,23,8,5,69,32,37,77
Ayr,1294,2,24,4,8,95,43,52,76
Arbroath,1294,3,18,8,10,71,48,23,62
Alloa,1294,4,17,8,11,56,44,12,59
Stranraer,1294,5,16,5,15,56,64,-8,53
East Fife,1294,6,13,3,20,47,65,-18,42
Airdrieon,1294,7,10,11,15,45,59,-14,41
Forfar,1294,8,11,5,20,39,64,-25,38
Albion,1294,9,8,6,22,58,83,-25,30
Queen's Park,1294,10,6,10,20,39,73,-34,28
Ayr,1295,1,24,4,8,95,43,52,76
Raith,1295,2,22,8,6,69,35,34,74
Alloa,1295,3,18,8,10,59,44,15,62
Arbroath,1295,4,17,9,10,70,48,22,60
Stranraer,1295,5,15,5,16,55,65,-10,50
East Fife,1295,6,14,3,19,48,64,-16,45
Airdrieon,1295,7,10,11,15,46,60,-14,41
Forfar,1295,8,11,5,20,40,65,-25,38
Albion,1295,9,8,6,22,58,83,-25,30
Queen's Park,1295,10,6,11,19,39,72,-33,29
Ayr,1296,1,24,4,8,95,43,52,76
Raith,1296,2,22,9,5,69,33,36,75
Arbroath,1296,3,17,9,10,70,48,22,60
Alloa,1296,4,17,9,10,57,44,13,60
Stranraer,1296,5,15,5,16,55,67,-12,50
East Fife,1296,6,14,3,19,50,64,-14,45
Airdrieon,1296,7,10,12,14,46,59,-13,42
Forfar,1296,8,10,6,20,39,65,-26,36
Albion,1296,9,8,6,22,58,83,-25,30
Queen's Park,1296,10,6,11,19,39,72,-33,29
Raith,1297,1,23,8,5,72,34,38,77
Ayr,1297,2,24,4,8,94,44,50,76
Arbroath,1297,3,17,9,10,71,49,22,60
Alloa,1297,4,17,8,11,58,47,11,59
Stranraer,1297,5,15,5,16,55,66,-11,50
East Fife,1297,6,14,3,19,49,64,-15,45
Airdrieon,1297,7,11,11,14,49,58,-9,44
Forfar,1297,8,10,5,21,38,68,-30,35
Albion,1297,9,8,6,22,59,82,-23,30
Queen's Park,1297,10,6,11,19,40,73,-33,29
Raith,1298,1,23,8,5,71,33,38,77
Ayr,1298,2,24,4,8,96,44,52,76
Arbroath,1298,3,17,8,11,70,51,19,59
Alloa,1298,4,17,8,11,57,46,11,59
Stranraer,1298,5,16,5,15,58,66,-8,53
East Fife,1298,6,13,3,20,49,67,-18,42
Airdrieon,1298,7,10,11,15,45,59,-14,41
Forfar,1298,8,11,5,20,39,64,-25,38
Queen's Park,1298,9,7,10,19,42,72,-30,31
Albion,1298,10,8,6,22,59,84,-25,30
Raith,1299,1,23,8,5,72,33,39,77
Ayr,1299,2,23,4,9,91,44,47,73
Arbroath,1299,3,18,8,10,73,50,23,62
Alloa,1299,4,17,8,11,57,47,10,59
Stranraer,1299,5,15,5,16,55,66,-11,50
East Fife,1299,6,14,3,19,49,64,-15,45
Airdrieon,1299,7,11,11,14,49,58,-9,44
Forfar,1299,8,10,5,21,38,68,-30,35
Albion,1299,9,9,6,21,59,79,-20,33
Queen's Park,1299,10,6,10,20,41,75,-34,28
Ayr,1300,1,24,4,8,96,42,54,76
Raith,1300,2,22,9,5,68,32,36,75
Arbroath,1300,3,17,9,10,71,49,22,60
Alloa,1300,4,17,9,10,56,43,13,60
Stranraer,1300,5,15,5,16,56,66,-10,50
East Fife,1300,6,14,3,19,49,65,-16,45
Airdrieon,1300,7,10,11,15,47,61,-14,41
Forfar,1300,8,11,5,20,41,66,-25,38
Albion,1300,9,8,6,22,57,84,-27,30
Queen's Park,1300,10,6,11,19,40,73,-33,29
Raith,1301,1,22,8,6,68,33,35,74
Ayr,1301,2,23,4,9,90,44,46,73
Arbroath,1301,3,18,8,10,73,48,25,62
Alloa,1301,4,18,8,10,57,43,14,62
Stranraer,1301,5,15,5,16,55,67,-12,50
East Fife,1301,6,14,3,19,50,64,-14,45
Airdrieon,1301,7,10,11,15,46,61,-15,41
Forfar,1301,8,11,5,20,41,65,-24,38
Albion,1301,9,9,6,21,59,78,-19,33
Queen's Park,1301,10,6,10,20,39,75,-36,28
Raith,1302,1,23,8,5,70,33,37,77
Ayr,1302,2,24,4,8,92,42,50,76
Arbroath,1302,3,18,8,10,73,50,23,62
Alloa,1302,4,17,8,11,57,45,12,59
Stranraer,1302,5,15,5,16,56,69,-13,50
East Fife,1302,6,14,3,19,52,65,-13,45
Airdrieon,1302,7,10,12,14,47,60,-13,42
Forfar,1302,8,10,6,20,40,66,-26,36
Albion,1302,9,8,6,22,57,80,-23,30
Queen's Park,1302,10,6,10,20,41,75,-34,28
Raith,1303,1,23,8,5,70,33,37,77
Ayr,1303,2,24,4,8,95,43,52,76
Arbroath,1303,3,18,8,10,73,49,24,62
Alloa,1303,4,17,8,11,57,45,12,59
Stranraer,1303,5,15,5,16,55,66,-11,50
East Fife,1303,6,14,3,19,49,64,-15,45
Airdrieon,1303,7,11,11,14,47,59,-12,44
Forfar,1303,8,10,5,21,39,66,-27,35
Albion,1303,9,8,6,22,58,83,-25,30
Queen's Park,1303,10,6,10,20,40,75,-35,28
Raith,1304,1,22,9,5,69,33,36,75
Ayr,1304,2,23,5,8,92,44,48,74
Arbroath,1304,3,17,9,10,72,50,22,60
Alloa,1304,4,17,9,10,57,44,13,60
Stranraer,1304,5,16,5,15,58,64,-6,53
Airdrieon,1304,6,11,11,14,47,59,-12,44
East Fife,1304,7,13,3,20,47,67,-20,42
Forfar,1304,8,10,5,21,39,66,-27,35
Albion,1304,9,8,7,21,59,80,-21,31
Queen's Park,1304,10,6,11,19,41,74,-33,29
Raith,1305,1,23,8,5,71,34,37,77
Ayr,1305,2,24,4,8,93,43,50,76
Arbroath,1305,3,18,8,10,72,49,23,62
Alloa,1305,4,17,8,11,58,46,12,59
Stranraer,1305,5,16,5,15,58,64,-6,53
East Fife,1305,6,13,3,20,47,67,-20,42
Airdrieon,1305,7,10,11,15,45,60,-15,41
Forfar,1305,8,11,5,20,40,64,-24,38
Albion,1305,9,8,6,22,58,81,-23,30
Queen's Park,1305,10,6,10,20,40,74,-34,28
Raith,1306,1,23,8,5,71,33,38,77
Ayr,1306,2,24,4,8,93,43,50,76
Arbroath,1306,3,17,9,10,72,50,22,60
Alloa,1306,4,17,8,11,57,46,11,59
Stranraer,1306,5,15,5,16,56,66,-10,50
East Fife,1306,6,14,3,19,49,65,-16,45
Airdrieon,1306,7,11,11,14,47,58,-11,44
Forfar,1306,8,10,5,21,38,66,-28,35
Albion,1306,9,8,6,22,58,81,-23,30
Queen's Park,1306,10,6,11,19,41,74,-33,29
Raith,1307,1,23,8,5,73,33,40,77
Ayr,1307,2,24,4,8,94,43,51,76
Arbroath,1307,3,17,8,11,71,50,21,59
Alloa,1307,4,17,8,11,57,48,9,59
Stranraer,1307,5,15,5,16,56,66,-10,50
East Fife,1307,6,14,3,19,49,65,-16,45
Airdrieon,1307,7,10,12,14,45,58,-13,42
Forfar,1307,8,10,6,20,38,64,-26,36
Queen's Park,1307,9,7,10,19,41,73,-32,31
Albion,1307,10,8,6,22,58,82,-24,30
Ayr,1308,1,24,4,8,97,45,52,76
Raith,1308,2,22,9,5,68,32,36,75
Alloa,1308,3,17,9,10,56,43,13,60
Arbroath,1308,4,17,8,11,70,49,21,59
Stranraer,1308,5,15,5,16,56,67,-11,50
East Fife,1308,6,14,3,19,50,65,-15,45
Airdrieon,1308,7,11,11,14,49,59,-10,44
Forfar,1308,8,10,5,21,39,68,-29,35
Queen's Park,1308,9,7,10,19,40,72,-32,31
Albion,1308,10,8,6,22,60,85,-25,30
Ayr,1309,1,24,4,8,94,44,50,76
Raith,1309,2,22,8,6,68,34,34,74
Alloa,1309,3,18,8,10,58,43,15,62
Arbroath,1309,4,17,8,11,70,49,21,59
Stranraer,1309,5,15,5,16,56,66,-10,50
East Fife,1309,6,14,3,19,49,65,-16,45
Airdrieon,1309,7,11,11,14,47,59,-12,44
Forfar,1309,8,10,5,21,39,66,-27,35
Queen's Park,1309,9,7,10,19,40,72,-32,31
Albion,1309,10,8,6,22,59,82,-23,30
Ayr,1310,1,24,4,8,97,42,55,76
Raith,1310,2,22,8,6,68,33,35,74
Alloa,1310,3,18,8,10,57,43,14,62
Arbroath,1310,4,17,8,11,70,49,21,59
Stranraer,1310,5,16,5,15,60,65,-5,53
Airdrieon,1310,6,11,11,14,46,58,-12,44
East Fife,1310,7,13,3,20,48,69,-21,42
Forfar,1310,8,10,5,21,38,65,-27,35
Queen's Park,1310,9,7,10,19,40,72,-32,31
Albion,1310,10,8,6,22,57,85,-28,30
Raith,1311,1,23,8,5,71,34,37,77
Ayr,1311,2,23,5,8,90,42,48,74
Arbroath,1311,3,18,8,10,73,48,25,62
Alloa,1311,4,17,8,11,58,46,12,59
Stranraer,1311,5,15,5,16,55,66,-11,50
East Fife,1311,6,14,3,19,49,64,-15,45
Airdrieon,1311,7,10,11,15,45,59,-14,41
Forfar,1311,8,11,5,20,39,64,-25,38
Albion,1311,9,8,7,21,57,78,-21,31
Queen's Park,1311,10,6,10,20,39,75,-36,28
Raith,1312,1,22,9,5,68,32,36,75
Ayr,1312,2,23,4,9,91,45,46,73
Arbroath,1312,3,18,8,10,75,51,24,62
Alloa,1312,4,17,9,10,56,43,13,60
Stranraer,1312,5,16,5,15,60,64,-4,53
Airdrieon,1312,6,10,12,14,46,59,-13,42
East Fife,1312,7,13,3,20,47,69,-22,42
Forfar,1312,8,10,6,20,39,65,-26,36
Albion,1312,9,9,6,21,60,79,-19,33
Queen's Park,1312,10,6,10,20,42,77,-35,28
Raith,1313,1,23,8,5,69,32,37,77
Ayr,1313,2,24,4,8,92,43,49,76
Arbroath,1313,3,18,8,10,73,49,24,62
Alloa,1313,4,17,8,11,56,44,12,59
Stranraer,1313,5,16,5,15,57,65,-8,53
East Fife,1313,6,13,3,20,48,66,-18,42
Airdrieon,1313,7,10,11,15,45,59,-14,41
Forfar,1313,8,11,5,20,39,64,-25,38
Albion,1313,9,8,6,22,58,80,-22,30
Queen's Park,1313,10,6,10,20,40,75,-35,28
Ayr,1314,1,24,4,8,94,44,50,76
Raith,1314,2,22,9,5,70,34,36,75
Alloa,1314,3,17,9,10,58,45,13,60
Arbroath,1314,4,17,8,11,70,49,21,59
Stranraer,1314,5,16,5,15,58,66,-8,53
Airdrieon,1314,6,11,11,14,47,58,-11,44
East Fife,1314,7,13,3,20,49,67,-18,42
Forfar,1314,8,10,5,21,38,66,-28,35
Queen's Park,1314,9,7,10,19,40,72,-32,31
Albion,1314,10,8,6,22,59,82,-23,30
Ayr,1315,1,24,4,8,94,43,51,76
Raith,1315,2,22,8,6,68,34,34,74
Arbroath,1315,3,18,8,10,73,50,23,62
Alloa,1315,4,18,8,10,58,43,15,62
Stranraer,1315,5,15,5,16,55,68,-13,50
East Fife,1315,6,14,3,19,51,64,-13,45
Airdrieon,1315,7,11,11,14,47,59,-12,44
Forfar,1315,8,10,5,21,39,66,-27,35
Albion,1315,9,8,6,22,58,82,-24,30
Queen's Park,1315,10,6,10,20,41,75,-34,28
Raith,1316,1,23,8,5,69,32,37,77
Ayr,1316,2,24,4,8,96,44,52,76
Arbroath,1316,3,18,8,10,72,48,24,62
Alloa,1316,4,17,8,11,56,44,12,59
Stranraer,1316,5,16,5,15,56,64,-8,53
Airdrieon,1316,6,11,11,14,47,59,-12,44
East Fife,1316,7,13,3,20,47,65,-18,42
Forfar,1316,8,10,5,21,39,66,-27,35
Albion,1316,9,8,6,22,59,84,-25,30
Queen's Park,1316,10,6,10,20,39,74,-35,28
Ayr,1317,1,24,4,8,92,42,50,76
Raith,1317,2,22,9,5,71,35,36,75
Alloa,1317,3,17,9,10,59,46,13,60
Arbroath,1317,4,17,8,11,72,51,21,59
Stranraer,1317,5,15,6,15,56,65,-9,51
Airdrieon,1317,6,11,11,14,48,58,-10,44
East Fife,1317,7,13,4,19,48,65,-17,43
Forfar,1317,8,10,5,21,38,67,-29,35
Queen's Park,1317,9,7,10,19,42,74,-32,31
Albion,1317,10,8,6,22,57,80,-23,30
Ayr,1318,1,24,4,8,94,43,51,76
Raith,1318,2,22,8,6,68,35,33,74
Alloa,1318,3,18,8,10,59,43,16,62
Arbroath,1318,4,17,9,10,72,50,22,60
Stranraer,1318,5,15,5,16,56,68,-12,50
East Fife,1318,6,14,3,19,51,65,-14,45
Airdrieon,1318,7,10,11,15,45,60,-15,41
Forfar,1318,8,11,5,20,40,64,-24,38
Albion,1318,9,8,6,22,58,82,-24,30
Queen's Park,1318,10,6,11,19,41,74,-33,29
Ayr,1319,1,24,4,8,94,44,50,76
Raith,1319,2,22,8,6,68,33,35,74
Arbroath,1319,3,18,8,10,73,50,23,62
Alloa,1319,4,18,8,10,57,43,14,62
Stranraer,1319,5,16,5,15,57,65,-8,53
Airdrieon,1319,6,11,11,14,48,59,-11,44
East Fife,1319,7,13,3,20,48,66,-18,42
Forfar,1319,8,10,5,21,39,67,-28,35
Albion,1319,9,8,6,22,59,82,-23,30
Queen's Park,1319,10,6,10,20,41,75,-34,28
Raith,1320,1,23,8,5,71,34,37,77
Ayr,1320,2,24,4,8,93,42,51,76
Arbroath,1320,3,18,8,10,73,50,23,62
Alloa,1320,4,17,8,11,58,46,12,59
Stranraer,1320,5,16,5,15,58,65,-7,53
Airdrieon,1320,6,10,12,14,47,60,-13,42
East Fife,1320,7,13,3,20,48,67,-19,42
Forfar,1320,8,10,6,20,40,66,-26,36
Albion,1320,9,8,6,22,57,81,-24,30
Queen's Park,1320,10,6,10,20,41,75,-34,28
Ayr,1321,1,24,4,8,94,44,50,76
Raith,1321,2,22,8,6,68,33,35,74
Arbroath,1321,3,18,8,10,75,50,25,62
Alloa,1321,4,18,8,10,57,43,14,62
Stranraer,1321,5,15,6,15,57,66,-9,51
Airdrieon,1321,6,11,11,14,47,59,-12,44
East Fife,1321,7,13,4,19,49,66,-17,43
Forfar,1321,8,10,5,21,39,66,-27,35
Albion,1321,9,8,6,22,59,82,-23,30
Queen's Park,1321,10,6,10,20,41,77,-36,28
Raith,1322,1,23,8,5,69,32,37,77
Ayr,1322,2,24,4,8,96,43,53,76
Arbroath,1322,3,18,8,10,73,50,23,62
Alloa,1322,4,17,8,11,56,44,12,59
Stranraer,1322,5,16,5,15,56,64,-8,53
Airdrieon,1322,6,11,11,14,46,58,-12,44
East Fife,1322,7,13,3,20,47,65,-18,42
Forfar,1322,8,10,5,21,38,65,-27,35
Albion,1322,9,8,6,22,58,84,-26,30
Queen's Park,1322,10,6,10,20,41,75,-34,28
Raith,1323,1,23,8,5,72,33,39,77
Ayr,1323,2,24,4,8,94,42,52,76
Arbroath,1323,3,18,8,10,73,49,24,62
Alloa,1323,4,17,8,11,57,47,10,59
Stranraer,1323,5,15,6,15,56,65,-9,51
Airdrieon,1323,6,11,11,14,49,58,-9,44
East Fife,1323,7,13,4,19,48,65,-17,43
Forfar,1323,8,10,5,21,38,68,-30,35
Albion,1323,9,8,6,22,57,82,-25,30
Queen's Park,1323,10,6,10,20,40,75,-35,28
Raith,1324,1,23,8,5,71,34,37,77
Ayr,1324,2,24,4,8,93,44,49,76
Arbroath,1324,3,18,8,10,73,49,24,62
Alloa,1324,4,17,8,11,58,46,12,59
Stranraer,1324,5,15,6,15,57,66,-9,51
Airdrieon,1324,6,11,11,14,49,58,-9,44
East Fife,1324,7,13,4,19,49,66,-17,43
Forfar,1324,8,10,5,21,38,68,-30,35
Albion,1324,9,8,6,22,59,81,-22,30
Queen's Park,1324,10,6,10,20,40,75,-35,28
Ayr,1325,1,24,4,8,93,42,51,76
Raith,1325,2,22,8,6,69,34,35,74
Alloa,1325,3,18,8,10,58,44,14,62
Arbroath,1325,4,17,8,11,71,50,21,59
Stranraer,1325,5,16,5,15,56,64,-8,53
Airdrieon,1325,6,10,12,14,45,58,-13,42
East Fife,1325,7,13,3,20,47,65,-18,42
Forfar,1325,8,10,6,20,38,64,-26,36
Queen's Park,1325,9,7,10,19,41,73,-32,31
Albion,1325,10,8,6,22,57,81,-24,30
Ayr,1326,1,24,4,8,92,43,49,76
Raith,1326,2,22,9,5,70,34,36,75
Arbroath,1326,3,18,8,10,73,49,24,62
Alloa,1326,4,17,9,10,58,45,13,60
Stranraer,1326,5,15,5,16,55,66,-11,50
East Fife,1326,6,14,3,19,49,64,-15,45
Airdrieon,1326,7,11,11,14,47,58,-11,44
Forfar,1326,8,10,5,21,38,66,-28,35
Albion,1326,9,8,6,22,58,80,-22,30
Queen's Park,1326,10,6,10,20,40,75,-35,28
Raith,1327,1,22,9,5,70,34,36,75
Ayr,1327,2,23,4,9,90,43,47,73
Arbroath,1327,3,18,8,10,72,48,24,62
Alloa,1327,4,17,9,10,58,45,13,60
Stranraer,1327,5,15,5,16,56,67,-11,50
East Fife,1327,6,14,3,19,50,65,-15,45
Airdrieon,1327,7,11,11,14,46,58,-12,44
Forfar,1327,8,10,5,21,38,65,-27,35
Albion,1327,9,9,6,21,58,78,-20,33
Queen's Park,1327,10,6,10,20,39,74,-35,28
Raith,1328,1,23,8,5,71,32,39,77
Ayr,1328,2,24,4,8,95,44,51,76
Arbroath,1328,3,17,8,11,71,50,21,59
Alloa,1328,4,17,8,11,56,46,10,59
Stranraer,1328,5,15,6,15,55,64,-9,51
Airdrieon,1328,6,11,11,14,47,59,-12,44
East Fife,1328,7,13,4,19,47,64,-17,43
Forfar,1328,8,10,5,21,39,66,-27,35
Queen's Park,1328,9,7,10,19,41,73,-32,31
Albion,1328,10,8,6,22,59,83,-24,30
Raith,1329,1,23,8,5,70,33,37,77
Ayr,1329,2,24,4,8,96,43,53,76
Arbroath,1329,3,17,8,11,70,51,19,59
Alloa,1329,4,17,8,11,57,45,12,59
Stranraer,1329,5,15,5,16,56,66,-10,50
East Fife,1329,6,14,3,19,49,65,-16,45
Airdrieon,1329,7,10,11,15,47,61,-14,41
Forfar,1329,8,11,5,20,41,66,-25,38
Queen's Park,1329,9,7,10,19,42,72,-30,31
Albion,1329,10,8,6,22,58,84,-26,30
Ayr,1330,1,24,4,8,95,43,52,76
Raith,1330,2,22,9,5,68,32,36,75
Arbroath,1330,3,18,8,10,73,49,24,62
Alloa,1330,4,17,9,10,56,43,13,60
Stranraer,1330,5,15,6,15,58,67,-9,51
East Fife,1330,6,13,4,19,50,67,-17,43
Airdrieon,1330,7,10,11,15,45,59,-14,41
Forfar,1330,8,11,5,20,39,64,-25,38
Albion,1330,9,8,6,22,58,83,-25,30
Queen's Park,1330,10,6,10,20,40,75,-35,28
Raith,1331,1,23,8,5,71,32,39,77
Ayr,1331,2,24,4,8,94,43,51,76
Arbroath,1331,3,18,8,10,74,48,26,62
Alloa,1331,4,17,8,11,56,46,10,59
Stranraer,1331,5,15,6,15,57,66,-9,51
Airdrieon,1331,6,11,11,14,47,58,-11,44
East Fife,1331,7,13,4,19,49,66,-17,43
Forfar,1331,8,10,5,21,38,66,-28,35
Albion,1331,9,8,6,22,58,82,-24,30
Queen's Park,1331,10,6,10,20,39,76,-37,28
Raith,1332,1,23,8,5,70,33,37,77
Ayr,1332,2,24,4,8,93,44,49,76
Arbroath,1332,3,18,8,10,73,49,24,62
Alloa,1332,4,17,8,11,57,45,12,59
Stranraer,1332,5,15,6,15,55,64,-9,51
East Fife,1332,6,13,4,19,47,64,-17,43
Airdrieon,1332,7,10,12,14,46,59,-13,42
Forfar,1332,8,10,6,20,39,65,-26,36
Albion,1332,9,8,6,22,59,81,-22,30
Queen's Park,1332,10,6,10,20,40,75,-35,28
Raith,1333,1,23,8,5,70,33,37,77
Ayr,1333,2,24,4,8,94,44,50,76
Arbroath,1333,3,18,8,10,74,49,25,62
Alloa,1333,4,17,8,11,57,45,12,59
Stranraer,1333,5,16,5,15,57,65,-8,53
Airdrieon,1333,6,11,11,14,47,58,-11,44
East Fife,1333,7,13,3,20,48,66,-18,42
Forfar,1333,8,10,5,21,38,66,-28,35
Albion,1333,9,8,6,22,59,82,-23,30
Queen's Park,1333,10,6,10,20,40,76,-36,28
Raith,1334,1,22,9,5,68,32,36,75
Ayr,1334,2,23,5,8,92,44,48,74
Alloa,1334,3,17,9,10,56,43,13,60
Arbroath,1334,4,17,8,11,71,50,21,59
Stranraer,1334,5,16,5,15,59,67,-8,53
Airdrieon,1334,6,10,12,14,46,59,-13,42
East Fife,1334,7,13,3,20,50,68,-18,42
Forfar,1334,8,10,6,20,39,65,-26,36
Albion,1334,9,8,7,21,59,80,-21,31
Queen's Park,1334,10,7,10,19,41,73,-32,31
Raith,1335,1,22,9,5,70,34,36,75
Ayr,1335,2,23,4,9,92,46,46,73
Alloa,1335,3,17,9,10,58,45,13,60
Arbroath,1335,4,17,8,11,72,51,21,59
Stranraer,1335,5,15,6,15,55,64,-9,51
Airdrieon,1335,6,11,11,14,47,59,-12,44
East Fife,1335,7,13,4,19,47,64,-17,43
Forfar,1335,8,10,5,21,39,66,-27,35
Albion,1335,9,9,6,21,61,80,-19,33
Queen's Park,1335,10,7,10,19,42,74,-32,31
Raith,1336,1,23,8,5,70,33,37,77
Ayr,1336,2,24,4,8,93,43,50,76
Arbroath,1336,3,18,8,10,74,49,25,62
Alloa,1336,4,17,8,11,57,45,12,59
Stranraer,1336,5,16,5,15,58,64,-6,53
Airdrieon,1336,6,11,11,14,48,58,-10,44
East Fife,1336,7,13,3,20,47,67,-20,42
Forfar,1336,8,10,5,21,38,67,-29,35
Albion,1336,9,8,6,22,58,81,-23,30
Queen's Park,1336,10,6,10,20,40,76,-36,28
Raith,1337,1,22,9,5,70,34,36,75
Ayr,1337,2,23,4,9,91,44,47,73
Alloa,1337,3,17,9,10,58,45,13,60
Arbroath,1337,4,17,8,11,71,50,21,59
Stranraer,1337,5,16,5,15,56,64,-8,53
Airdrieon,1337,6,11,11,14,48,60,-12,44
East Fife,1337,7,13,3,20,47,65,-18,42
Forfar,1337,8,10,5,21,40,67,-27,35
Albion,1337,9,9,6,21,59,79,-20,33
Queen's Park,1337,10,7,10,19,41,73,-32,31
Ayr,1338,1,24,4,8,92,42,50,76
Raith,1338,2,22,9,5,69,33,36,75
Arbroath,1338,3,17,9,10,71,49,22,60
Alloa,1338,4,17,9,10,57,44,13,60
Stranraer,1338,5,15,6,15,55,64,-9,51
Airdrieon,1338,6,11,11,14,48,58,-10,44
East Fife,1338,7,13,4,19,47,64,-17,43
Forfar,1338,8,10,5,21,38,67,-29,35
Albion,1338,9,8,6,22,57,80,-23,30
Queen's Park,1338,10,6,11,19,40,73,-33,29
Ayr,1339,1,23,5,8,92,44,48,74
Raith,1339,2,22,8,6,68,33,35,74
Arbroath,1339,3,18,8,10,74,48,26,62
Alloa,1339,4,18,8,10,57,43,14,62
Stranraer,1339,5,16,5,15,57,65,-8,53
East Fife,1339,6,13,3,20,48,66,-18,42
Airdrieon,1339,7,10,11,15,45,61,-16,41
Forfar,1339,8,11,5,20,41,64,-23,38
Albion,1339,9,8,7,21,59,80,-21,31
Queen's Park,1339,10,6,10,20,39,76,-37,28
Raith,1340,1,23,8,5,69,32,37,77
Ayr,1340,2,23,4,9,91,48,43,73
Arbroath,1340,3,18,8,10,72,49,23,62
Alloa,1340,4,17,8,11,56,44,12,59
Stranraer,1340,5,15,6,15,56,65,-9,51
Airdrieon,1340,6,11,11,14,46,58,-12,44
East Fife,1340,7,13,4,19,48,65,-17,43
Forfar,1340,8,10,5,21,38,65,-27,35
Albion,1340,9,9,6,21,63,79,-16,33
Queen's Park,1340,10,6,10,20,40,74,-34,28
Ayr,1341,1,23,5,8,92,44,48,74
Raith,1341,2,22,8,6,70,35,35,74
Alloa,1341,3,18,8,10,59,45,14,62
Arbroath,1341,4,17,9,10,71,49,22,60
Stranraer,1341,5,16,5,15,60,64,-4,53
Airdrieon,1341,6,10,12,14,46,59,-13,42
East Fife,1341,7,13,3,20,47,69,-22,42
Forfar,1341,8,10,6,20,39,65,-26,36
Albion,1341,9,8,7,21,59,80,-21,31
Queen's Park,1341,10,6,11,19,40,73,-33,29
Ayr,1342,1,24,4,8,95,43,52,76
Raith,1342,2,22,8,6,68,33,35,74
Arbroath,1342,3,18,8,10,75,50,25,62
Alloa,1342,4,18,8,10,57,43,14,62
Stranraer,1342,5,15,5,16,56,68,-12,50
East Fife,1342,6,14,3,19,51,65,-14,45
Airdrieon,1342,7,10,11,15,45,61,-16,41
Forfar,1342,8,11,5,20,41,64,-23,38
Albion,1342,9,8,6,22,58,83,-25,30
Queen's Park,1342,10,6,10,20,41,77,-36,28
Ayr,1343,1,24,4,8,97,43,54,76
Raith,1343,2,22,9,5,69,33,36,75
Arbroath,1343,3,18,8,10,73,50,23,62
Alloa,1343,4,17,9,10,57,44,13,60
Stranraer,1343,5,15,6,15,56,65,-9,51
Airdrieon,1343,6,11,11,14,46,58,-12,44
East Fife,1343,7,13,4,19,48,65,-17,43
Forfar,1343,8,10,5,21,38,65,-27,35
Albion,1343,9,8,6,22,58,85,-27,30
Queen's Park,1343,10,6,10,20,41,75,-34,28
Ayr,1344,1,24,4,8,91,42,49,76
Raith,1344,2,22,8,6,69,35,34,74
Alloa,1344,3,18,8,10,59,44,15,62
Arbroath,1344,4,17,8,11,72,51,21,59
Stranraer,1344,5,15,5,16,55,67,-12,50
East Fife,1344,6,14,3,19,50,64,-14,45
Airdrieon,1344,7,11,11,14,46,58,-12,44
Forfar,1344,8,10,5,21,38,65,-27,35
Queen's Park,1344,9,7,10,19,42,74,-32,31
Albion,1344,10,8,6,22,57,79,-22,30
Raith,1345,1,23,8,5,69,32,37,77
Ayr,1345,2,23,4,9,93,47,46,73
Arbroath,1345,3,17,8,11,71,50,21,59
Alloa,1345,4,17,8,11,56,44,12,59
Stranraer,1345,5,15,5,16,56,67,-11,50
East Fife,1345,6,14,3,19,50,65,-15,45
Airdrieon,1345,7,10,12,14,46,59,-13,42
Forfar,1345,8,10,6,20,39,65,-26,36
Albion,1345,9,9,6,21,62,81,-19,33
Queen's Park,1345,10,7,10,19,41,73,-32,31
Raith,1346,1,23,8,5,70,33,37,77
Ayr,1346,2,24,4,8,95,43,52,76
Arbroath,1346,3,18,8,10,74,48,26,62
Alloa,1346,4,17,8,11,57,45,12,59
Stranraer,1346,5,15,5,16,55,65,-10,50
East Fife,1346,6,14,3,19,48,64,-16,45
Airdrieon,1346,7,11,11,14,46,58,-12,44
Forfar,1346,8,10,5,21,38,65,-27,35
Albion,1346,9,8,6,22,58,83,-25,30
Queen's Park,1346,10,6,10,20,39,76,-37,28
Raith,1347,1,23,8,5,70,32,38,77
Ayr,1347,2,23,4,9,90,46,44,73
Arbroath,1347,3,18,8,10,72,48,24,62
Alloa,1347,4,17,8,11,56,45,11,59
Stranraer,1347,5,15,6,15,56,65,-9,51
Airdrieon,1347,6,11,11,14,47,58,-11,44
East Fife,1347,7,13,4,19,48,65,-17,43
Forfar,1347,8,10,5,21,38,66,-28,35
Albion,1347,9,9,6,21,61,78,-17,33
Queen's Park,1347,10,6,10,20,39,74,-35,28
Raith,1348,1,23,8,5,70,33,37,77
Ayr,1348,2,24,4,8,96,42,54,76
Arbroath,1348,3,18,8,10,75,50,25,62
Alloa,1348,4,17,8,11,57,45,12,59
Stranraer,1348,5,15,5,16,56,67,-11,50
East Fife,1348,6,14,3,19,50,65,-15,45
Airdrieon,1348,7,10,11,15,45,59,-14,41
Forfar,1348,8,11,5,20,39,64,-25,38
Albion,1348,9,8,6,22,57,84,-27,30
Queen's Park,1348,10,6,10,20,41,77,-36,28
Raith,1349,1,23,8,5,71,32,39,77
Ayr,1349,2,24,4,8,96,43,53,76
Arbroath,1349,3,17,9,10,72,50,22,60
Alloa,1349,4,17,8,11,56,46,10,59
Stranraer,1349,5,15,5,16,56,68,-12,50
East Fife,1349,6,14,3,19,51,65,-14,45
Airdrieon,1349,7,11,11,14,46,58,-12,44
Forfar,1349,8,10,5,21,38,65,-27,35
Albion,1349,9,8,6,22,58,84,-26,30
Queen's Park,1349,10,6,11,19,41,74,-33,29
Ayr,1350,1,24,4,8,96,43,53,76
Raith,1350,2,22,8,6,68,33,35,74
Arbroath,1350,3,18,8,10,75,49,26,62
Alloa,1350,4,18,8,10,57,43,14,62
Stranraer,1350,5,15,5,16,58,68,-10,50
East Fife,1350,6,14,3,19,51,67,-16,45
Airdrieon,1350,7,10,11,15,45,59,-14,41
Forfar,1350,8,11,5,20,39,64,-25,38
Albion,1350,9,8,6,22,58,84,-26,30
Queen's Park,1350,10,6,10,20,40,77,-37,28
Ayr,1351,1,24,4,8,92,42,50,76
Raith,1351,2,22,8,6,69,34,35,74
Arbroath,1351,3,18,8,10,74,48,26,62
Alloa,1351,4,18,8,10,58,44,14,62
Stranraer,1351,5,16,5,15,59,66,-7,53
Airdrieon,1351,6,11,11,14,46,58,-12,44
East Fife,1351,7,13,3,20,49,68,-19,42
Forfar,1351,8,10,5,21,38,65,-27,35
Albion,1351,9,8,6,22,57,80,-23,30
Queen's Park,1351,10,6,10,20,39,76,-37,28
Ayr,1352,1,24,4,8,95,42,53,76
Raith,1352,2,22,8,6,69,34,35,74
Alloa,1352,3,18,8,10,58,44,14,62
Arbroath,1352,4,17,8,11,71,50,21,59
Stranraer,1352,5,15,5,16,56,68,-12,50
East Fife,1352,6,14,3,19,51,65,-14,45
Airdrieon,1352,7,11,11,14,47,59,-12,44
Forfar,1352,8,10,5,21,39,66,-27,35
Queen's Park,1352,9,7,10,19,41,73,-32,31
Albion,1352,10,8,6,22,57,83,-26,30
Ayr,1353,1,24,4,8,93,43,50,76
Raith,1353,2,22,9,5,69,33,36,75
Arbroath,1353,3,17,9,10,71,49,22,60
Alloa,1353,4,17,9,10,57,44,13,60
Stranraer,1353,5,15,6,15,56,65,-9,51
East Fife,1353,6,13,4,19,48,65,-17,43
Airdrieon,1353,7,10,12,14,45,58,-13,42
Forfar,1353,8,10,6,20,38,64,-26,36
Albion,1353,9,8,6,22,58,81,-23,30
Queen's Park,1353,10,6,11,19,40,73,-33,29
Ayr,1354,1,24,4,8,92,43,49,76
Raith,1354,2,22,8,6,68,33,35,74
Alloa,1354,3,18,8,10,57,43,14,62
Arbroath,1354,4,17,8,11,70,49,21,59
Stranraer,1354,5,15,6,15,57,66,-9,51
East Fife,1354,6,13,4,19,49,66,-17,43
Airdrieon,1354,7,10,11,15,48,62,-14,41
Forfar,1354,8,11,5,20,42,67,-25,38
Queen's Park,1354,9,7,10,19,40,72,-32,31
Albion,1354,10,8,6,22,58,80,-22,30
Raith,1355,1,23,8,5,71,33,38,77
Ayr,1355,2,24,4,8,94,43,51,76
Arbroath,1355,3,17,9,10,71,49,22,60
Alloa,1355,4,17,8,11,57,46,11,59
Stranraer,1355,5,15,5,16,56,66,-10,50
East Fife,1355,6,14,3,19,49,65,-16,45
Airdrieon,1355,7,11,11,14,47,58,-11,44
Forfar,1355,8,10,5,21,38,66,-28,35
Albion,1355,9,8,6,22,58,82,-24,30
Queen's Park,1355,10,6,11,19,40,73,-33,29
Raith,1356,1,23,8,5,70,33,37,77
Ayr,1356,2,24,4,8,95,42,53,76
Arbroath,1356,3,18,8,10,73,48,25,62
Alloa,1356,4,17,8,11,57,45,12,59
Stranraer,1356,5,15,6,15,56,65,-9,51
Airdrieon,1356,6,11,11,14,48,60,-12,44
East Fife,1356,7,13,4,19,48,65,-17,43
Forfar,1356,8,10,5,21,40,67,-27,35
Albion,1356,9,8,6,22,57,83,-26,30
Queen's Park,1356,10,6,10,20,39,75,-36,28
Raith,1357,1,23,8,5,69,32,37,77
Ayr,1357,2,24,4,8,95,43,52,76
Arbroath,1357,3,18,8,10,73,50,23,62
Alloa,1357,4,17,8,11,56,44,12,59
Stranraer,1357,5,16,5,15,58,65,-7,53
Airdrieon,1357,6,10,12,14,46,59,-13,42
East Fife,1357,7,13,3,20,48,67,-19,42
Forfar,1357,8,10,6,20,39,65,-26,36
Albion,1357,9,8,6,22,58,83,-25,30
Queen's Park,1357,10,6,10,20,41,75,-34,28
Raith,1358,1,23,8,5,70,33,37,77
Ayr,1358,2,23,5,8,92,44,48,74
Arbroath,1358,3,17,9,10,71,49,22,60
Alloa,1358,4,17,8,11,57,45,12,59
Stranraer,1358,5,15,5,16,55,65,-10,50
East Fife,1358,6,14,3,19,48,64,-16,45
Airdrieon,1358,7,10,11,15,46,60,-14,41
Forfar,1358,8,11,5,20,40,65,-25,38
Albion,1358,9,8,7,21,59,80,-21,31
Queen's Park,1358,10,6,11,19,40,73,-33,29
Ayr,1359,1,24,4,8,98,43,55,76
Raith,1359,2,22,8,6,69,35,34,74
Arbroath,1359,3,18,8,10,72,49,23,62
Alloa,1359,4,18,8,10,59,44,15,62
Stranraer,1359,5,15,5,16,55,65,-10,50
East Fife,1359,6,14,3,19,48,64,-16,45
Airdrieon,1359,7,10,11,15,45,59,-14,41
Forfar,1359,8,11,5,20,39,64,-25,38
Albion,1359,9,8,6,22,58,86,-28,30
Queen's Park,1359,10,6,10,20,40,74,-34,28
Raith,1360,1,23,8,5,72,33,39,77
Ayr,1360,2,24,4,8,93,43,50,76
Arbroath,1360,3,18,8,10,72,49,23,62
Alloa,1360,4,17,8,11,57,47,10,59
Stranraer,1360,5,15,5,16,57,67,-10,50
East Fife,1360,6,14,3,19,50,66,-16,45
Airdrieon,1360,7,11,11,14,49,60,-11,44
Forfar,1360,8,10,5,21,40,68,-28,35
Albion,1360,9,8,6,22,58,81,-23,30
Queen's Park,1360,10,6,10,20,40,74,-34,28
Raith,1361,1,23,8,5,71,32,39,77
Ayr,1361,2,24,4,8,94,44,50,76
Arbroath,1361,3,17,9,10,71,49,22,60
Alloa,1361,4,17,8,11,56,46,10,59
Stranraer,1361,5,15,5,16,56,66,-10,50
East Fife,1361,6,14,3,19,49,65,-16,45
Airdrieon,1361,7,10,11,15,46,61,-15,41
Forfar,1361,8,11,5,20,41,65,-24,38
Albion,1361,9,8,6,22,59,82,-23,30
Queen's Park,1361,10,6,11,19,40,73,-33,29
Raith,1362,1,23,8,5,70,33,37,77
Ayr,1362,2,23,4,9,91,44,47,73
Arbroath,1362,3,17,8,11,70,49,21,59
Alloa,1362,4,17,8,11,57,45,12,59
Stranraer,1362,5,16,5,15,57,65,-8,53
East Fife,1362,6,13,3,20,48,66,-18,42
Airdrieon,1362,7,10,11,15,46,60,-14,41
Forfar,1362,8,11,5,20,40,65,-25,38
Albion,1362,9,9,6,21,59,79,-20,33
Queen's Park,1362,10,7,10,19,40,72,-32,31
Raith,1363,1,23,8,5,71,33,38,77
Ayr,1363,2,24,4,8,94,44,50,76
Arbroath,1363,3,18,8,10,72,49,23,62
Alloa,1363,4,17,8,11,57,46,11,59
Stranraer,1363,5,15,5,16,55,65,-10,50
East Fife,1363,6,14,3,19,48,64,-16,45
Airdrieon,1363,7,11,11,14,47,58,-11,44
Forfar,1363,8,10,5,21,38,66,-28,35
Albion,1363,9,8,6,22,59,82,-23,30
Queen's Park,1363,10,6,10,20,40,74,-34,28
Raith,1364,1,23,8,5,69,32,37,77
Ayr,1364,2,24,4,8,96,45,51,76
Arbroath,1364,3,17,8,11,70,50,20,59
Alloa,1364,4,17,8,11,56,44,12,59
Stranraer,1364,5,16,5,15,60,65,-5,53
Airdrieon,1364,6,11,11,14,47,58,-11,44
East Fife,1364,7,13,3,20,48,69,-21,42
Forfar,1364,8,10,5,21,38,66,-28,35
Queen's Park,1364,9,7,10,19,41,72,-31,31
Albion,1364,10,8,6,22,60,84,-24,30
Ayr,1365,1,24,4,8,95,42,53,76
Raith,1365,2,22,8,6,69,34,35,74
Alloa,1365,3,18,8,10,58,44,14,62
Arbroath,1365,4,17,9,10,72,50,22,60
Stranraer,1365,5,15,6,15,57,66,-9,51
Airdrieon,1365,6,11,11,14,46,58,-12,44
East Fife,1365,7,13,4,19,49,66,-17,43
Forfar,1365,8,10,5,21,38,65,-27,35
Albion,1365,9,8,6,22,57,83,-26,30
Queen's Park,1365,10,6,11,19,41,74,-33,29
Raith,1366,1,23,8,5,69,32,37,77
Ayr,1366,2,24,4,8,93,43,50,76
Arbroath,1366,3,17,8,11,71,50,21,59
Alloa,1366,4,17,8,11,56,44,12,59
Stranraer,1366,5,16,5,15,57,65,-8,53
East Fife,1366,6,13,3,20,48,66,-18,42
Airdrieon,1366,7,10,11,15,46,60,-14,41
Forfar,1366,8,11,5,20,40,65,-25,38
Queen's Park,1366,9,7,10,19,41,73,-32,31
Albion,1366,10,8,6,22,58,81,-23,30
Raith,1367,1,23,8,5,70,33,37,77
Ayr,1367,2,24,4,8,97,43,54,76
Arbroath,1367,3,18,8,10,72,48,24,62
Alloa,1367,4,17,8,11,57,45,12,59
Stranraer,1367,5,15,6,15,56,65,-9,51
Airdrieon,1367,6,11,11,14,48,58,-10,44
East Fife,1367,7,13,4,19,48,65,-17,43
Forfar,1367,8,10,5,21,38,67,-29,35
Albion,1367,9,8,6,22,58,85,-27,30
Queen's Park,1367,10,6,10,20,39,74,-35,28
Raith,1368,1,23,8,5,71,33,38,77
Ayr,1368,2,24,4,8,94,42,52,76
Arbroath,1368,3,18,8,10,71,48,23,62
Alloa,1368,4,17,8,11,57,46,11,59
Stranraer,1368,5,15,5,16,55,66,-11,50
East Fife,1368,6,14,3,19,49,64,-15,45
Airdrieon,1368,7,11,11,14,47,58,-11,44
Forfar,1368,8,10,5,21,38,66,-28,35
Albion,1368,9,8,6,22,57,82,-25,30
Queen's Park,1368,10,6,10,20,39,73,-34,28
Ayr,1369,1,24,4,8,94,44,50,76
Raith,1369,2,22,9,5,68,32,36,75
Arbroath,1369,3,18,8,10,73,48,25,62
Alloa,1369,4,17,9,10,56,43,13,60
Stranraer,1369,5,15,5,16,56,68,-12,50
East Fife,1369,6,14,3,19,51,65,-14,45
Airdrieon,1369,7,11,11,14,49,59,-10,44
Forfar,1369,8,10,5,21,39,68,-29,35
Albion,1369,9,8,6,22,59,82,-23,30
Queen's Park,1369,10,6,10,20,39,75,-36,28
Ayr,1370,1,24,4,8,95,43,52,76
Raith,1370,2,22,8,6,70,35,35,74
Alloa,1370,3,18,8,10,59,45,14,62
Arbroath,1370,4,17,8,11,71,50,21,59
Stranraer,1370,5,15,5,16,56,66,-10,50
East Fife,1370,6,14,3,19,49,65,-16,45
Airdrieon,1370,7,11,11,14,48,60,-12,44
Forfar,1370,8,10,5,21,40,67,-27,35
Queen's Park,1370,9,7,10,19,41,73,-32,31
Albion,1370,10,8,6,22,58,83,-25,30
Raith,1371,1,23,8,5,71,34,37,77
Ayr,1371,2,24,4,8,96,44,52,76
Arbroath,1371,3,17,8,11,71,51,20,59
Alloa,1371,4,17,8,11,58,46,12,59
Stranraer,1371,5,15,5,16,55,67,-12,50
East Fife,1371,6,14,3,19,50,64,-14,45
Airdrieon,1371,7,10,12,14,45,58,-13,42
Forfar,1371,8,10,6,20,38,64,-26,36
Queen's Park,1371,9,7,10,19,42,73,-31,31
Albion,1371,10,8,6,22,59,84,-25,30
Raith,1372,1,23,8,5,71,34,37,77
Ayr,1372,2,24,4,8,95,43,52,76
Arbroath,1372,3,18,8,10,72,48,24,62
Alloa,1372,4,17,8,11,58,46,12,59
Stranraer,1372,5,16,5,15,58,65,-7,53
Airdrieon,1372,6,11,11,14,47,59,-12,44
East Fife,1372,7,13,3,20,48,67,-19,42
Forfar,1372,8,10,5,21,39,66,-27,35
Albion,1372,9,8,6,22,58,83,-25,30
Queen's Park,1372,10,6,10,20,39,74,-35,28
Ayr,1373,1,24,4,8,92,42,50,76
Raith,1373,2,22,8,6,68,33,35,74
Alloa,1373,3,18,8,10,57,43,14,62
Arbroath,1373,4,17,9,10,71,49,22,60
Stranraer,1373,5,15,6,15,57,66,-9,51
East Fife,1373,6,13,4,19,49,66,-17,43
Airdrieon,1373,7,10,11,15,45,59,-14,41
Forfar,1373,8,11,5,20,39,64,-25,38
Albion,1373,9,8,6,22,57,80,-23,30
Queen's Park,1373,10,6,11,19,40,73,-33,29
Ayr,1374,1,24,4,8,97,45,52,76
Raith,1374,2,22,9,5,70,34,36,75
Arbroath,1374,3,18,8,10,73,49,24,62
Alloa,1374,4,17,9,10,58,45,13,60
Stranraer,1374,5,15,5,16,56,68,-12,50
East Fife,1374,6,14,3,19,51,65,-14,45
Airdrieon,1374,7,11,11,14,48,59,-11,44
Forfar,1374,8,10,5,21,39,67,-28,35
Albion,1374,9,8,6,22,60,85,-25,30
Queen's Park,1374,10,6,10,20,40,75,-35,28
Raith,1375,1,23,8,5,69,32,37,77
Ayr,1375,2,24,4,8,95,45,50,76
Arbroath,1375,3,17,8,11,71,50,21,59
Alloa,1375,4,17,8,11,56,44,12,59
Stranraer,1375,5,15,5,16,55,65,-10,50
East Fife,1375,6,14,3,19,48,64,-16,45
Airdrieon,1375,7,11,11,14,47,58,-11,44
Forfar,1375,8,10,5,21,38,66,-28,35
Queen's Park,1375,9,7,10,19,41,73,-32,31
Albion,1375,10,8,6,22,60,83,-23,30
Ayr,1376,1,24,4,8,91,42,49,76
Raith,1376,2,22,8,6,69,34,35,74
Arbroath,1376,3,18,8,10,72,48,24,62
Alloa,1376,4,18,8,10,58,44,14,62
Stranraer,1376,5,15,5,16,55,66,-11,50
East Fife,1376,6,14,3,19,49,64,-15,45
Airdrieon,1376,7,11,11,14,47,58,-11,44
Forfar,1376,8,10,5,21,38,66,-28,35
Albion,1376,9,8,6,22,57,79,-22,30
Queen's Park,1376,10,6,10,20,39,74,-35,28
Raith,1377,1,23,8,5,70,33,37,77
Ayr,1377,2,24,4,8,92,42,50,76
Arbroath,1377,3,18,8,10,71,48,23,62
Alloa,1377,4,17,8,11,57,45,12,59
Stranraer,1377,5,15,5,16,55,65,-10,50
East Fife,1377,6,14,3,19,48,64,-16,45
Airdrieon,1377,7,10,12,14,46,59,-13,42
Forfar,1377,8,10,6,20,39,65,-26,36
Albion,1377,9,8,6,22,57,80,-23,30
Queen's Park,1377,10,6,10,20,39,73,-34,28
Raith,1378,1,23,8,5,71,33,38,77
Ayr,1378,2,23,5,8,92,44,48,74
Arbroath,1378,3,18,8,10,73,50,23,62
Alloa,1378,4,17,8,11,57,46,11,59
Stranraer,1378,5,15,5,16,57,67,-10,50
East Fife,1378,6,14,3,19,50,66,-16,45
Airdrieon,1378,7,11,11,14,47,58,-11,44
Forfar,1378,8,10,5,21,38,66,-28,35
Albion,1378,9,8,7,21,59,80,-21,31
Queen's Park,1378,10,6,10,20,41,75,-34,28
Raith,1379,1,23,8,5,72,33,39,77
Ayr,1379,2,24,4,8,94,42,52,76
Arbroath,1379,3,18,8,10,73,48,25,62
Alloa,1379,4,17,8,11,57,47,10,59
Stranraer,1379,5,16,5,15,56,64,-8,53
East Fife,1379,6,13,3,20,47,65,-18,42
Airdrieon,1379,7,10,11,15,46,60,-14,41
Forfar,1379,8,11,5,20,40,65,-25,38
Albion,1379,9,8,6,22,57,82,-25,30
Queen's Park,1379,10,6,10,20,39,75,-36,28
Raith,1380,1,23,8,5,71,33,38,77
Ayr,1380,2,24,4,8,92,43,49,76
Arbroath,1380,3,17,9,10,70,48,22,60
Alloa,1380,4,17,8,11,57,46,11,59
Stranraer,1380,5,15,6,15,57,66,-9,51
Airdrieon,1380,6,11,11,14,47,59,-12,44
East Fife,1380,7,13,4,19,49,66,-17,43
Forfar,1380,8,10,5,21,39,66,-27,35
Albion,1380,9,8,6,22,58,80,-22,30
Queen's Park,1380,10,6,11,19,39,72,-33,29
Ayr,1381,1,24,4,8,95,43,52,76
Raith,1381,2,22,8,6,68,34,34,74
Alloa,1381,3,18,8,10,58,43,15,62
Arbroath,1381,4,17,9,10,71,49,22,60
Stranraer,1381,5,16,5,15,58,65,-7,53
Airdrieon,1381,6,11,11,14,48,58,-10,44
East Fife,1381,7,13,3,20,48,67,-19,42
Forfar,1381,8,10,5,21,38,67,-29,35
Albion,1381,9,8,6,22,58,83,-25,30
Queen's Park,1381,10,6,11,19,40,73,-33,29
Ayr,1382,1,24,4,8,92,43,49,76
Raith,1382,2,22,9,5,70,34,36,75
Arbroath,1382,3,18,8,10,75,50,25,62
Alloa,1382,4,17,9,10,58,45,13,60
Stranraer,1382,5,15,6,15,57,66,-9,51
Airdrieon,1382,6,11,11,14,48,59,-11,44
East Fife,1382,7,13,4,19,49,66,-17,43
Forfar,1382,8,10,5,21,39,67,-28,35
Albion,1382,9,8,6,22,58,80,-22,30
Queen's Park,1382,10,6,10,20,41,77,-36,28
Raith,1383,1,23,8,5,70,33,37,77
Ayr,1383,2,24,4,8,94,42,52,76
Arbroath,1383,3,17,8,11,70,51,19,59
Alloa,1383,4,17,8,11,57,45,12,59
Stranraer,1383,5,15,5,16,56,66,-10,50
East Fife,1383,6,14,3,19,49,65,-16,45
Airdrieon,1383,7,11,11,14,46,58,-12,44
Forfar,1383,8,10,5,21,38,65,-27,35
Queen's Park,1383,9,7,10,19,42,72,-30,31
Albion,1383,10,8,6,22,57,82,-25,30
Raith,1384,1,23,8,5,70,32,38,77
Ayr,1384,2,24,4,8,92,42,50,76
Arbroath,1384,3,18,8,10,73,49,24,62
Alloa,1384,4,17,8,11,56,45,11,59
Stranraer,1384,5,15,5,16,56,66,-10,50
East Fife,1384,6,14,3,19,49,65,-16,45
Airdrieon,1384,7,11,11,14,48,59,-11,44
Forfar,1384,8,10,5,21,39,67,-28,35
Albion,1384,9,8,6,22,57,80,-23,30
Queen's Park,1384,10,6,10,20,40,75,-35,28
Ayr,1385,1,24,4,8,98,44,54,76
Raith,1385,2,22,8,6,68,34,34,74
Arbroath,1385,3,18,8,10,73,49,24,62
Alloa,1385,4,18,8,10,58,43,15,62
Stranraer,1385,5,15,5,16,55,67,-12,50
East Fife,1385,6,14,3,19,50,64,-14,45
Airdrieon,1385,7,10,11,15,45,61,-16,41
Forfar,1385,8,11,5,20,41,64,-23,38
Albion,1385,9,8,6,22,59,86,-27,30
Queen's Park,1385,10,6,10,20,40,75,-35,28
Ayr,1386,1,24,4,8,93,44,49,76
Raith,1386,2,22,9,5,69,33,36,75
Arbroath,1386,3,18,8,10,73,49,24,62
Alloa,1386,4,17,9,10,57,44,13,60
Stranraer,1386,5,15,6,15,56,65,-9,51
East Fife,1386,6,13,4,19,48,65,-17,43
Airdrieon,1386,7,10,11,15,45,61,-16,41
Forfar,1386,8,11,5,20,41,64,-23,38
Albion,1386,9,8,6,22,59,81,-22,30
Queen's Park,1386,10,6,10,20,40,75,-35,28
Ayr,1387,1,24,4,8,94,43,51,76
Raith,1387,2,22,8,6,68,34,34,74
Alloa,1387,3,18,8,10,58,43,15,62
Arbroath,1387,4,17,9,10,71,49,22,60
Stranraer,1387,5,15,5,16,55,66,-11,50
East Fife,1387,6,14,3,19,49,64,-15,45
Airdrieon,1387,7,10,12,14,45,58,-13,42
Forfar,1387,8,10,6,20,38,64,-26,36
Albion,1387,9,8,6,22,58,82,-24,30
Queen's Park,1387,10,6,11,19,40,73,-33,29
Raith,1388,1,23,8,5,70,33,37,77
Ayr,1388,2,24,4,8,96,43,53,76
Arbroath,1388,3,18,8,10,71,48,23,62
Alloa,1388,4,17,8,11,57,45,12,59
Stranraer,1388,5,15,5,16,57,67,-10,50
East Fife,1388,6,14,3,19,50,66,-16,45
Airdrieon,1388,7,10,12,14,46,59,-13,42
Forfar,1388,8,10,6,20,39,65,-26,36
Albion,1388,9,8,6,22,58,84,-26,30
Queen's Park,1388,10,6,10,20,39,73,-34,28
Ayr,1389,1,23,5,8,91,43,48,74
Raith,1389,2,22,8,6,69,35,34,74
Arbroath,1389,3,18,8,10,72,49,23,62
Alloa,1389,4,18,8,10,59,44,15,62
Stranraer,1389,5,15,5,16,57,69,-12,50
East Fife,1389,6,14,3,19,52,66,-14,45
Airdrieon,1389,7,10,11,15,46,62,-16,41
Forfar,1389,8,11,5,20,42,65,-23,38
Albion,1389,9,8,7,21,58,79,-21,31
Queen's Park,1389,10,6,10,20,40,74,-34,28
Raith,1390,1,23,8,5,71,32,39,77
Ayr,1390,2,24,4,8,95,44,51,76
Arbroath,1390,3,17,9,10,71,49,22,60
Alloa,1390,4,17,8,11,56,46,10,59
Stranraer,1390,5,16,5,15,57,64,-7,53
Airdrieon,1390,6,11,11,14,46,58,-12,44
East Fife,1390,7,13,3,20,47,66,-19,42
Forfar,1390,8,10,5,21,38,65,-27,35
Albion,1390,9,8,6,22,59,83,-24,30
Queen's Park,1390,10,6,11,19,40,73,-33,29
Raith,1391,1,23,8,5,71,32,39,77
Ayr,1391,2,24,4,8,93,42,51,76
Arbroath,1391,3,18,8,10,72,48,24,62
Alloa,1391,4,17,8,11,56,46,10,59
Stranraer,1391,5,15,6,15,56,65,-9,51
East Fife,1391,6,13,4,19,48,65,-17,43
Airdrieon,1391,7,10,12,14,47,60,-13,42
Forfar,1391,8,10,6,20,40,66,-26,36
Albion,1391,9,8,6,22,57,81,-24,30
Queen's Park,1391,10,6,10,20,39,74,-35,28
Raith,1392,1,23,8,5,70,33,37,77
Ayr,1392,2,24,4,8,93,43,50,76
Arbroath,1392,3,17,9,10,71,49,22,60
Alloa,1392,4,17,8,11,57,45,12,59
Stranraer,1392,5,15,6,15,57,66,-9,51
Airdrieon,1392,6,11,11,14,47,59,-12,44
East Fife,1392,7,13,4,19,49,66,-17,43
Forfar,1392,8,10,5,21,39,66,-27,35
Albion,1392,9,8,6,22,58,81,-23,30
Queen's Park,1392,10,6,11,19,40,73,-33,29
Raith,1393,1,23,8,5,69,32,37,77
Ayr,1393,2,24,4,8,91,42,49,76
Arbroath,1393,3,18,8,10,71,48,23,62
Alloa,1393,4,17,8,11,56,44,12,59
Stranraer,1393,5,15,6,15,56,65,-9,51
Airdrieon,1393,6,11,11,14,47,59,-12,44
East Fife,1393,7,13,4,19,48,65,-17,43
Forfar,1393,8,10,5,21,39,66,-27,35
Albion,1393,9,8,6,22,57,79,-22,30
Queen's Park,1393,10,6,10,20,39,73,-34,28
Ayr,1394,1,24,4,8,95,43,52,76
Raith,1394,2,22,8,6,68,33,35,74
Arbroath,1394,3,18,8,10,72,48,24,62
Alloa,1394,4,18,8,10,57,43,14,62
Stranraer,1394,5,15,5,16,55,66,-11,50
East Fife,1394,6,14,3,19,49,64,-15,45
Airdrieon,1394,7,11,11,14,48,58,-10,44
Forfar,1394,8,10,5,21,38,67,-29,35
Albion,1394,9,8,6,22,58,83,-25,30
Queen's Park,1394,10,6,10,20,39,74,-35,28
Ayr,1395,1,24,4,8,94,44,50,76
Raith,1395,2,22,8,6,69,35,34,74
Arbroath,1395,3,18,8,10,73,50,23,62
Alloa,1395,4,18,8,10,59,44,15,62
Stranraer,1395,5,16,5,15,57,65,-8,53
Airdrieon,1395,6,11,11,14,46,58,-12,44
East Fife,1395,7,13,3,20,48,66,-18,42
Forfar,1395,8,10,5,21,38,65,-27,35
Albion,1395,9,8,6,22,59,82,-23,30
Queen's Park,1395,10,6,10,20,41,75,-34,28
Raith,1396,1,23,8,5,70,32,38,77
Ayr,1396,2,24,4,8,96,44,52,76
Arbroath,1396,3,17,8,11,71,51,20,59
Alloa,1396,4,17,8,11,56,45,11,59
Stranraer,1396,5,15,6,15,56,65,-9,51
Airdrieon,1396,6,11,11,14,47,59,-12,44
East Fife,1396,7,13,4,19,48,65,-17,43
Forfar,1396,8,10,5,21,39,66,-27,35
Queen's Park,1396,9,7,10,19,42,73,-31,31
Albion,1396,10,8,6,22,59,84,-25,30
Ayr,1397,1,24,4,8,92,42,50,76
Raith,1397,2,22,8,6,68,36,32,74
Arbroath,1397,3,18,8,10,72,49,23,62
Alloa,1397,4,18,8,10,60,43,17,62
Stranraer,1397,5,16,5,15,56,64,-8,53
Airdrieon,1397,6,11,11,14,46,58,-12,44
East Fife,1397,7,13,3,20,47,65,-18,42
Forfar,1397,8,10,5,21,38,65,-27,35
Albion,1397,9,8,6,22,57,80,-23,30
Queen's Park,1397,10,6,10,20,40,74,-34,28
Raith,1398,1,23,8,5,70,33,37,77
Ayr,1398,2,23,5,8,92,44,48,74
Arbroath,1398,3,17,9,10,71,49,22,60
Alloa,1398,4,17,8,11,57,45,12,59
Stranraer,1398,5,15,6,15,56,65,-9,51
Airdrieon,1398,6,11,11,14,48,59,-11,44
East Fife,1398,7,13,4,19,48,65,-17,43
Forfar,1398,8,10,5,21,39,67,-28,35
Albion,1398,9,8,7,21,59,80,-21,31
Queen's Park,1398,10,6,11,19,40,73,-33,29
Raith,1399,1,23,8,5,70,33,37,77
Ayr,1399,2,24,4,8,97,43,54,76
Arbroath,1399,3,18,8,10,74,50,24,62
Alloa,1399,4,17,8,11,57,45,12,59
Stranraer,1399,5,15,6,15,56,65,-9,51
East Fife,1399,6,13,4,19,48,65,-17,43
Airdrieon,1399,7,10,12,14,46,59,-13,42
Forfar,1399,8,10,6,20,39,65,-26,36
Albion,1399,9,8,6,22,58,85,-27,30
Queen's Park,1399,10,6,10,20,41,76,-35,28
Ayr,1400,1,24,4,8,94,45,49,76
Raith,1400,2,22,8,6,69,34,35,74
Arbroath,1400,3,18,8,10,74,48,26,62
Alloa,1400,4,18,8,10,58,44,14,62
Stranraer,1400,5,16,5,15,61,66,-5,53
Airdrieon,1400,6,11,11,14,47,58,-11,44
East Fife,1400,7,13,3,20,49,70,-21,42
Forfar,1400,8,10,5,21,38,66,-28,35
Albion,1400,9,8,6,22,60,82,-22,30
Queen's Park,1400,10,6,10,20,39,76,-37,28
Raith,1401,1,23,8,5,73,34,39,77
Ayr,1401,2,23,5,8,92,44,48,74
Arbroath,1401,3,17,8,11,71,50,21,59
Alloa,1401,4,17,8,11,58,48,10,59
Stranraer,1401,5,15,6,15,55,64,-9,51
East Fife,1401,6,13,4,19,47,64,-17,43
Airdrieon,1401,7,10,11,15,46,60,-14,41
Forfar,1401,8,11,5,20,40,65,-25,38
Albion,1401,9,8,7,21,59,80,-21,31
Queen's Park,1401,10,7,10,19,41,73,-32,31
Ayr,1402,1,24,4,8,95,42,53,76
Raith,1402,2,22,8,6,68,34,34,74
Arbroath,1402,3,18,8,10,73,48,25,62
Alloa,1402,4,18,8,10,58,43,15,62
Stranraer,1402,5,15,6,15,57,66,-9,51
East Fife,1402,6,13,4,19,49,66,-17,43
Airdrieon,1402,7,10,11,15,45,59,-14,41
Forfar,1402,8,11,5,20,39,64,-25,38
Albion,1402,9,8,6,22,57,83,-26,30
Queen's Park,1402,10,6,10,20,39,75,-36,28
Ayr,1403,1,24,4,8,93,42,51,76
Raith,1403,2,22,9,5,68,32,36,75
Alloa,1403,3,17,9,10,56,43,13,60
Arbroath,1403,4,17,8,11,72,51,21,59
Stranraer,1403,5,15,6,15,55,64,-9,51
Airdrieon,1403,6,11,11,14,48,59,-11,44
East Fife,1403,7,13,4,19,47,64,-17,43
Forfar,1403,8,10,5,21,39,67,-28,35
Queen's Park,1403,9,7,10,19,42,74,-32,31
Albion,1403,10,8,6,22,57,81,-24,30
Ayr,1404,1,24,4,8,92,43,49,76
Raith,1404,2,22,8,6,68,34,34,74
Arbroath,1404,3,18,8,10,75,50,25,62
Alloa,1404,4,18,8,10,58,43,15,62
Stranraer,1404,5,15,5,16,55,68,-13,50
East Fife,1404,6,14,3,19,51,64,-13,45
Airdrieon,1404,7,10,12,14,46,59,-13,42
Forfar,1404,8,10,6,20,39,65,-26,36
Albion,1404,9,8,6,22,58,80,-22,30
Queen's Park,1404,10,6,10,20,41,77,-36,28
Raith,1405,1,23,8,5,71,34,37,77
Ayr,1405,2,24,4,8,94,42,52,76
Arbroath,1405,3,18,8,10,73,49,24,62
Alloa,1405,4,17,8,11,58,46,12,59
Stranraer,1405,5,15,5,16,56,66,-10,50
East Fife,1405,6,14,3,19,49,65,-16,45
Airdrieon,1405,7,10,12,14,45,58,-13,42
Forfar,1405,8,10,6,20,38,64,-26,36
Albion,1405,9,8,6,22,57,82,-25,30
Queen's Park,1405,10,6,10,20,40,75,-35,28
Raith,1406,1,23,8,5,69,32,37,77
Ayr,1406,2,24,4,8,93,43,50,76
Arbroath,1406,3,18,8,10,71,48,23,62
Alloa,1406,4,17,8,11,56,44,12,59
Stranraer,1406,5,15,5,16,55,65,-10,50
East Fife,1406,6,14,3,19,48,64,-16,45
Airdrieon,1406,7,10,11,15,45,59,-14,41
Forfar,1406,8,11,5,20,39,64,-25,38
Albion,1406,9,8,6,22,58,81,-23,30
Queen's Park,1406,10,6,10,20,39,73,-34,28
Raith,1407,1,22,8,6,68,33,35,74
Ayr,1407,2,23,4,9,91,44,47,73
Arbroath,1407,3,18,8,10,73,50,23,62
Alloa,1407,4,18,8,10,57,43,14,62
Stranraer,1407,5,15,6,15,56,65,-9,51
East Fife,1407,6,13,4,19,48,65,-17,43
Airdrieon,1407,7,10,12,14,46,59,-13,42
Forfar,1407,8,10,6,20,39,65,-26,36
Albion,1407,9,9,6,21,59,79,-20,33
Queen's Park,1407,10,6,10,20,41,75,-34,28
Ayr,1408,1,24,4,8,93,43,50,76
Raith,1408,2,22,8,6,68,33,35,74
Arbroath,1408,3,18,8,10,73,50,23,62
Alloa,1408,4,18,8,10,57,43,14,62
Stranraer,1408,5,16,5,15,57,64,-7,53
Airdrieon,1408,6,11,11,14,50,60,-10,44
East Fife,1408,7,13,3,20,47,66,-19,42
Forfar,1408,8,10,5,21,40,69,-29,35
Albion,1408,9,8,6,22,58,81,-23,30
Queen's Park,1408,10,6,10,20,41,75,-34,28
Raith,1409,1,22,8,6,69,34,35,74
Ayr,1409,2,23,4,9,92,48,44,73
Alloa,1409,3,18,8,10,58,44,14,62
Arbroath,1409,4,17,8,11,72,51,21,59
Stranraer,1409,5,15,6,15,58,67,-9,51
East Fife,1409,6,13,4,19,50,67,-17,43
Airdrieon,1409,7,10,12,14,47,60,-13,42
Forfar,1409,8,10,6,20,40,66,-26,36
Albion,1409,9,9,6,21,63,80,-17,33
Queen's Park,1409,10,7,10,19,42,74,-32,31
Raith,1410,1,23,8,5,70,32,38,77
Ayr,1410,2,24,4,8,91,42,49,76
Arbroath,1410,3,17,9,10,71,49,22,60
Alloa,1410,4,17,8,11,56,45,11,59
Stranraer,1410,5,15,5,16,55,65,-10,50
East Fife,1410,6,14,3,19,48,64,-16,45
Airdrieon,1410,7,11,11,14,50,58,-8,44
Forfar,1410,8,10,5,21,38,69,-31,35
Albion,1410,9,8,6,22,57,79,-22,30
Queen's Park,1410,10,6,11,19,40,73,-33,29
Raith,1411,1,23,8,5,72,33,39,77
Ayr,1411,2,24,4,8,97,43,54,76
Arbroath,1411,3,17,9,10,71,49,22,60
Alloa,1411,4,17,8,11,57,47,10,59
Stranraer,1411,5,15,6,15,58,67,-9,51
Airdrieon,1411,6,11,11,14,46,58,-12,44
East Fife,1411,7,13,4,19,50,67,-17,43
Forfar,1411,8,10,5,21,38,65,-27,35
Albion,1411,9,8,6,22,58,85,-27,30
Queen's Park,1411,10,6,11,19,40,73,-33,29
Raith,1412,1,23,8,5,69,32,37,77
Ayr,1412,2,24,4,8,92,43,49,76
Arbroath,1412,3,17,9,10,71,49,22,60
Alloa,1412,4,17,8,11,56,44,12,59
Stranraer,1412,5,15,5,16,55,65,-10,50
East Fife,1412,6,14,3,19,48,64,-16,45
Airdrieon,1412,7,10,12,14,47,60,-13,42
Forfar,1412,8,10,6,20,40,66,-26,36
Albion,1412,9,8,6,22,58,80,-22,30
Queen's Park,1412,10,6,11,19,40,73,-33,29
Raith,1413,1,23,8,5,70,32,38,77
Ayr,1413,2,24,4,8,96,44,52,76
Arbroath,1413,3,17,8,11,72,51,21,59
Alloa,1413,4,17,8,11,56,45,11,59
Stranraer,1413,5,16,5,15,57,65,-8,53
Airdrieon,1413,6,11,11,14,49,60,-11,44
East Fife,1413,7,13,3,20,48,66,-18,42
Forfar,1413,8,10,5,21,40,68,-28,35
Queen's Park,1413,9,7,10,19,42,74,-32,31
Albion,1413,10,8,6,22,59,84,-25,30
Raith,1414,1,23,8,5,71,34,37,77
Ayr,1414,2,24,4,8,91,42,49,76
Arbroath,1414,3,17,9,10,72,50,22,60
Alloa,1414,4,17,8,11,58,46,12,59
Stranraer,1414,5,15,5,16,57,68,-11,50
East Fife,1414,6,14,3,19,51,66,-15,45
Airdrieon,1414,7,10,11,15,45,59,-14,41
Forfar,1414,8,11,5,20,39,64,-25,38
Albion,1414,9,8,6,22,57,79,-22,30
Queen's Park,1414,10,6,11,19,41,74,-33,29
Ayr,1415,1,24,4,8,95,43,52,76
Raith,1415,2,22,9,5,69,33,36,75
Arbroath,1415,3,18,8,10,73,50,23,62
Alloa,1415,4,17,9,10,57,44,13,60
Stranraer,1415,5,15,5,16,56,68,-12,50
East Fife,1415,6,14,3,19,51,65,-14,45
Airdrieon,1415,7,11,11,14,47,58,-11,44
Forfar,1415,8,10,5,21,38,66,-28,35
Albion,1415,9,8,6,22,58,83,-25,30
Queen's Park,1415,10,6,10,20,41,75,-34,28
Ayr,1416,1,24,4,8,92,43,49,76
Raith,1416,2,22,8,6,68,33,35,74
Alloa,1416,3,18,8,10,57,43,14,62
Arbroath,1416,4,17,8,11,70,50,20,59
Stranraer,1416,5,15,5,16,55,67,-12,50
East Fife,1416,6,14,3,19,50,64,-14,45
Airdrieon,1416,7,11,11,14,47,59,-12,44
Forfar,1416,8,10,5,21,39,66,-27,35
Queen's Park,1416,9,7,10,19,41,72,-31,31
Albion,1416,10,8,6,22,58,80,-22,30
Raith,1417,1,22,9,5,68,32,36,75
Ayr,1417,2,23,5,8,91,43,48,74
Arbroath,1417,3,18,8,10,74,48,26,62
Alloa,1417,4,17,9,10,56,43,13,60
Stranraer,1417,5,15,5,16,57,69,-12,50
East Fife,1417,6,14,3,19,52,66,-14,45
Airdrieon,1417,7,11,11,14,48,58,-10,44
Forfar,1417,8,10,5,21,38,67,-29,35
Albion,1417,9,8,7,21,58,79,-21,31
Queen's Park,1417,10,6,10,20,39,76,-37,28
Raith,1418,1,23,8,5,70,32,38,77
Ayr,1418,2,24,4,8,92,42,50,76
Arbroath,1418,3,18,8,10,73,48,25,62
Alloa,1418,4,17,8,11,56,45,11,59
Stranraer,1418,5,15,6,15,55,64,-9,51
Airdrieon,1418,6,11,11,14,47,59,-12,44
East Fife,1418,7,13,4,19,47,64,-17,43
Forfar,1418,8,10,5,21,39,66,-27,35
Albion,1418,9,8,6,22,57,80,-23,30
Queen's Park,1418,10,6,10,20,39,75,-36,28
Ayr,1419,1,24,4,8,94,43,51,76
Raith,1419,2,22,8,6,68,33,35,74
Arbroath,1419,3,18,8,10,71,48,23,62
Alloa,1419,4,18,8,10,57,43,14,62
Stranraer,1419,5,15,6,15,56,65,-9,51
Airdrieon,1419,6,11,11,14,46,58,-12,44
East Fife,1419,7,13,4,19,48,65,-17,43
Forfar,1419,8,10,5,21,38,65,-27,35
Albion,1419,9,8,6,22,58,82,-24,30
Queen's Park,1419,10,6,10,20,39,73,-34,28
Raith,1420,1,23,8,5,71,33,38,77
Ayr,1420,2,24,4,8,93,43,50,76
Arbroath,1420,3,17,9,10,71,49,22,60
Alloa,1420,4,17,8,11,57,46,11,59
Stranraer,1420,5,15,5,16,56,66,-10,50
East Fife,1420,6,14,3,19,49,65,-16,45
Airdrieon,1420,7,11,11,14,46,58,-12,44
Forfar,1420,8,10,5,21,38,65,-27,35
Albion,1420,9,8,6,22,58,81,-23,30
Queen's Park,1420,10,6,11,19,40,73,-33,29
Raith,1421,1,23,8,5,69,32,37,77
Ayr,1421,2,24,4,8,94,44,50,76
Arbroath,1421,3,17,8,11,70,50,20,59
Alloa,1421,4,17,8,11,56,44,12,59
Stranraer,1421,5,16,5,15,56,64,-8,53
East Fife,1421,6,13,3,20,47,65,-18,42
Airdrieon,1421,7,10,11,15,46,60,-14,41
Forfar,1421,8,11,5,20,40,65,-25,38
Queen's Park,1421,9,7,10,19,41,72,-31,31
Albion,1421,10,8,6,22,59,82,-23,30
Raith,1422,1,23,8,5,71,33,38,77
Ayr,1422,2,24,4,8,94,42,52,76
Arbroath,1422,3,18,8,10,72,49,23,62
Alloa,1422,4,17,8,11,57,46,11,59
Stranraer,1422,5,15,6,15,57,66,-9,51
East Fife,1422,6,13,4,19,49,66,-17,43
Airdrieon,1422,7,10,11,15,45,60,-15,41
Forfar,1422,8,11,5,20,40,64,-24,38
Albion,1422,9,8,6,22,57,82,-25,30
Queen's Park,1422,10,6,10,20,40,74,-34,28
Raith,1423,1,23,8,5,69,32,37,77
Ayr,1423,2,24,4,8,94,44,50,76
Arbroath,1423,3,18,8,10,71,48,23,62
Alloa,1423,4,17,8,11,56,44,12,59
Stranraer,1423,5,15,6,15,57,66,-9,51
East Fife,1423,6,13,4,19,49,66,-17,43
Airdrieon,1423,7,10,11,15,45,59,-14,41
Forfar,1423,8,11,5,20,39,64,-25,38
Albion,1423,9,8,6,22,59,82,-23,30
Queen's Park,1423,10,6,10,20,39,73,-34,28
Raith,1424,1,23,8,5,70,32,38,77
Ayr,1424,2,23,4,9,93,46,47,73
Arbroath,1424,3,17,9,10,72,50,22,60
Alloa,1424,4,17,8,11,56,45,11,59
Stranraer,1424,5,15,6,15,57,66,-9,51
Airdrieon,1424,6,11,11,14,46,58,-12,44
East Fife,1424,7,13,4,19,49,66,-17,43
Forfar,1424,8,10,5,21,38,65,-27,35
Albion,1424,9,9,6,21,61,81,-20,33
Queen's Park,1424,10,6,11,19,41,74,-33,29
Ayr,1425,1,24,4,8,92,43,49,76
Raith,1425,2,22,8,6,68,35,33,74
Arbroath,1425,3,18,8,10,72,49,23,62
Alloa,1425,4,18,8,10,59,43,16,62
Stranraer,1425,5,15,6,15,59,68,-9,51
East Fife,1425,6,13,4,19,51,68,-17,43
Airdrieon,1425,7,10,11,15,46,60,-14,41
Forfar,1425,8,11,5,20,40,65,-25,38
Albion,1425,9,8,6,22,58,80,-22,30
Queen's Park,1425,10,6,10,20,40,74,-34,28
Raith,1426,1,22,9,5,68,32,36,75
Ayr,1426,2,23,4,9,92,45,47,73
Alloa,1426,3,17,9,10,56,43,13,60
Arbroath,1426,4,17,8,11,72,51,21,59
Stranraer,1426,5,15,6,15,57,66,-9,51
East Fife,1426,6,13,4,19,49,66,-17,43
Airdrieon,1426,7,10,12,14,46,59,-13,42
Forfar,1426,8,10,6,20,39,65,-26,36
Albion,1426,9,9,6,21,60,80,-20,33
Queen's Park,1426,10,7,10,19,42,74,-32,31
Ayr,1427,1,24,4,8,95,43,52,76
Raith,1427,2,22,8,6,68,34,34,74
Arbroath,1427,3,18,8,10,71,48,23,62
Alloa,1427,4,18,8,10,58,43,15,62
Stranraer,1427,5,15,5,16,55,66,-11,50
East Fife,1427,6,14,3,19,49,64,-15,45
Airdrieon,1427,7,11,11,14,49,59,-10,44
Forfar,1427,8,10,5,21,39,68,-29,35
Albion,1427,9,8,6,22,58,83,-25,30
Queen's Park,1427,10,6,10,20,39,73,-34,28
Raith,1428,1,23,8,5,70,32,38,77
Ayr,1428,2,24,4,8,95,45,50,76
Arbroath,1428,3,18,8,10,73,49,24,62
Alloa,1428,4,17,8,11,56,45,11,59
Stranraer,1428,5,16,5,15,57,65,-8,53
East Fife,1428,6,13,3,20,48,66,-18,42
Airdrieon,1428,7,10,11,15,46,60,-14,41
Forfar,1428,8,11,5,20,40,65,-25,38
Albion,1428,9,8,6,22,60,83,-23,30
Queen's Park,1428,10,6,10,20,40,75,-35,28
Raith,1429,1,23,8,5,71,32,39,77
Ayr,1429,2,24,4,8,93,44,49,76
Arbroath,1429,3,17,8,11,70,49,21,59
Alloa,1429,4,17,8,11,56,46,10,59
Stranraer,1429,5,15,5,16,56,67,-11,50
East Fife,1429,6,14,3,19,50,65,-15,45
Airdrieon,1429,7,11,11,14,46,58,-12,44
Forfar,1429,8,10,5,21,38,65,-27,35
Queen's Park,1429,9,7,10,19,40,72,-32,31
Albion,1429,10,8,6,22,59,81,-22,30
Raith,1430,1,23,8,5,71,32,39,77
Ayr,1430,2,23,5,8,92,44,48,74
Arbroath,1430,3,17,8,11,70,51,19,59
Alloa,1430,4,17,8,11,56,46,10,59
Stranraer,1430,5,16,5,15,57,65,-8,53
Airdrieon,1430,6,11,11,14,47,59,-12,44
East Fife,1430,7,13,3,20,48,66,-18,42
Forfar,1430,8,10,5,21,39,66,-27,35
Albion,1430,9,8,7,21,59,80,-21,31
Queen's Park,1430,10,7,10,19,42,72,-30,31
Raith,1431,1,23,8,5,72,33,39,77
Ayr,1431,2,24,4,8,94,42,52,76
Arbroath,1431,3,17,8,11,71,50,21,59
Alloa,1431,4,17,8,11,57,47,10,59
Stranraer,1431,5,15,5,16,55,66,-11,50
East Fife,1431,6,14,3,19,49,64,-15,45
Airdrieon,1431,7,11,11,14,47,59,-12,44
Forfar,1431,8,10,5,21,39,66,-27,35
Queen's Park,1431,9,7,10,19,41,73,-32,31
Albion,1431,10,8,6,22,57,82,-25,30
Raith,1432,1,23,8,5,71,32,39,77
Ayr,1432,2,24,4,8,94,43,51,76
Arbroath,1432,3,18,8,10,74,48,26,62
Alloa,1432,4,17,8,11,56,46,10,59
Stranraer,1432,5,15,6,15,56,65,-9,51
Airdrieon,1432,6,11,11,14,47,58,-11,44
East Fife,1432,7,13,4,19,48,65,-17,43
Forfar,1432,8,10,5,21,38,66,-28,35
Albion,1432,9,8,6,22,58,82,-24,30
Queen's Park,1432,10,6,10,20,39,76,-37,28
Raith,1433,1,23,8,5,69,32,37,77
Ayr,1433,2,24,4,8,92,43,49,76
Arbroath,1433,3,18,8,10,72,49,23,62
Alloa,1433,4,17,8,11,56,44,12,59
Stranraer,1433,5,15,6,15,56,65,-9,51
East Fife,1433,6,13,4,19,48,65,-17,43
Airdrieon,1433,7,10,11,15,46,60,-14,41
Forfar,1433,8,11,5,20,40,65,-25,38
Albion,1433,9,8,6,22,58,80,-22,30
Queen's Park,1433,10,6,10,20,40,74,-34,28
Ayr,1434,1,23,5,8,92,44,48,74
Raith,1434,2,22,8,6,69,34,35,74
Arbroath,1434,3,18,8,10,73,50,23,62
Alloa,1434,4,18,8,10,58,44,14,62
Stranraer,1434,5,15,6,15,55,64,-9,51
Airdrieon,1434,6,11,11,14,48,59,-11,44
East Fife,1434,7,13,4,19,47,64,-17,43
Forfar,1434,8,10,5,21,39,67,-28,35
Albion,1434,9,8,7,21,59,80,-21,31
Queen's Park,1434,10,6,10,20,41,75,-34,28
Ayr,1435,1,24,4,8,94,43,51,76
Raith,1435,2,22,9,5,69,33,36,75
Alloa,1435,3,17,9,10,57,44,13,60
Arbroath,1435,4,17,8,11,71,50,21,59
Stranraer,1435,5,16,5,15,57,64,-7,53
Airdrieon,1435,6,11,11,14,47,59,-12,44
East Fife,1435,7,13,3,20,47,66,-19,42
Forfar,1435,8,10,5,21,39,66,-27,35
Queen's Park,1435,9,7,10,19,41,73,-32,31
Albion,1435,10,8,6,22,58,82,-24,30
Raith,1436,1,23,8,5,71,32,39,77
Ayr,1436,2,24,4,8,93,42,51,76
Arbroath,1436,3,17,9,10,71,49,22,60
Alloa,1436,4,17,8,11,56,46,10,59
Stranraer,1436,5,15,6,15,55,64,-9,51
East Fife,1436,6,13,4,19,47,64,-17,43
Airdrieon,1436,7,10,11,15,45,60,-15,41
Forfar,1436,8,11,5,20,40,64,-24,38
Albion,1436,9,8,6,22,57,81,-24,30
Queen's Park,1436,10,6,11,19,40,73,-33,29
Ayr,1437,1,24,4,8,95,42,53,76
Raith,1437,2,22,9,5,69,33,36,75
Arbroath,1437,3,17,9,10,72,50,22,60
Alloa,1437,4,17,9,10,57,44,13,60
Stranraer,1437,5,16,5,15,58,65,-7,53
Airdrieon,1437,6,10,12,14,48,61,-13,42
East Fife,1437,7,13,3,20,48,67,-19,42
Forfar,1437,8,10,6,20,41,67,-26,36
Albion,1437,9,8,6,22,57,83,-26,30
Queen's Park,1437,10,6,11,19,41,74,-33,29
Raith,1438,1,23,8,5,71,33,38,77
Ayr,1438,2,24,4,8,95,44,51,76
Arbroath,1438,3,17,9,10,72,50,22,60
Alloa,1438,4,17,8,11,57,46,11,59
Stranraer,1438,5,15,5,16,56,68,-12,50
East Fife,1438,6,14,3,19,51,65,-14,45
Airdrieon,1438,7,11,11,14,48,59,-11,44
Forfar,1438,8,10,5,21,39,67,-28,35
Albion,1438,9,8,6,22,59,83,-24,30
Queen's Park,1438,10,6,11,19,41,74,-33,29
Ayr,1439,1,24,4,8,93,42,51,76
Raith,1439,2,22,8,6,68,34,34,74
Arbroath,1439,3,18,8,10,71,48,23,62
Alloa,1439,4,18,8,10,58,43,15,62
Stranraer,1439,5,15,5,16,55,66,-11,50
East Fife,1439,6,14,3,19,49,64,-15,45
Airdrieon,1439,7,10,11,15,46,60,-14,41
Forfar,1439,8,11,5,20,40,65,-25,38
Albion,1439,9,8,6,22,57,81,-24,30
Queen's Park,1439,10,6,10,20,39,73,-34,28
Raith,1440,1,23,8,5,70,33,37,77
Ayr,1440,2,24,4,8,96,42,54,76
Arbroath,1440,3,17,8,11,71,50,21,59
Alloa,1440,4,17,8,11,57,45,12,59
Stranraer,1440,5,15,5,16,56,66,-10,50
East Fife,1440,6,14,3,19,49,65,-16,45
Airdrieon,1440,7,11,11,14,47,58,-11,44
Forfar,1440,8,10,5,21,38,66,-28,35
Queen's Park,1440,9,7,10,19,41,73,-32,31
Albion,1440,10,8,6,22,57,84,-27,30
Raith,1441,1,22,9,5,68,32,36,75
Ayr,1441,2,23,4,9,93,46,47,73
Arbroath,1441,3,18,8,10,75,49,26,62
Alloa,1441,4,17,9,10,56,43,13,60
Stranraer,1441,5,15,5,16,57,67,-10,50
East Fife,1441,6,14,3,19,50,66,-16,45
Airdrieon,1441,7,10,11,15,46,61,-15,41
Forfar,1441,8,11,5,20,41,65,-24,38
Albion,1441,9,9,6,21,61,81,-20,33
Queen's Park,1441,10,6,10,20,40,77,-37,28
Ayr,1442,1,24,4,8,94,45,49,76
Raith,1442,2,22,9,5,69,33,36,75
Arbroath,1442,3,17,9,10,72,50,22,60
Alloa,1442,4,17,9,10,57,44,13,60
Stranraer,1442,5,16,5,15,61,69,-8,53
Airdrieon,1442,6,11,11,14,48,58,-10,44
East Fife,1442,7,13,3,20,52,70,-18,42
Forfar,1442,8,10,5,21,38,67,-29,35
Albion,1442,9,8,6,22,60,82,-22,30
Queen's Park,1442,10,6,11,19,41,74,-33,29
Ayr,1443,1,24,4,8,93,44,49,76
Raith,1443,2,22,9,5,68,32,36,75
Arbroath,1443,3,17,9,10,71,49,22,60
Alloa,1443,4,17,9,10,56,43,13,60
Stranraer,1443,5,15,6,15,55,64,-9,51
Airdrieon,1443,6,11,11,14,49,58,-9,44
East Fife,1443,7,13,4,19,47,64,-17,43
Forfar,1443,8,10,5,21,38,68,-30,35
Albion,1443,9,8,6,22,59,81,-22,30
Queen's Park,1443,10,6,11,19,40,73,-33,29
Ayr,1444,1,24,4,8,93,43,50,76
Raith,1444,2,22,8,6,68,33,35,74
Alloa,1444,3,18,8,10,57,43,14,62
Arbroath,1444,4,17,9,10,73,51,22,60
Stranraer,1444,5,15,5,16,55,67,-12,50
East Fife,1444,6,14,3,19,50,64,-14,45
Airdrieon,1444,7,10,12,14,47,60,-13,42
Forfar,1444,8,10,6,20,40,66,-26,36
Albion,1444,9,8,6,22,58,81,-23,30
Queen's Park,1444,10,6,11,19,42,75,-33,29
Raith,1445,1,23,8,5,70,32,38,77
Ayr,1445,2,24,4,8,93,42,51,76
Arbroath,1445,3,18,8,10,72,49,23,62
Alloa,1445,4,17,8,11,56,45,11,59
Stranraer,1445,5,15,5,16,56,66,-10,50
East Fife,1445,6,14,3,19,49,65,-16,45
Airdrieon,1445,7,11,11,14,47,58,-11,44
Forfar,1445,8,10,5,21,38,66,-28,35
Albion,1445,9,8,6,22,57,81,-24,30
Queen's Park,1445,10,6,10,20,40,74,-34,28
Ayr,1446,1,24,4,8,92,43,49,76
Raith,1446,2,22,8,6,69,34,35,74
Alloa,1446,3,18,8,10,58,44,14,62
Arbroath,1446,4,17,9,10,71,49,22,60
Stranraer,1446,5,15,6,15,56,65,-9,51
East Fife,1446,6,13,4,19,48,65,-17,43
Airdrieon,1446,7,10,12,14,45,58,-13,42
Forfar,1446,8,10,6,20,38,64,-26,36
Albion,1446,9,8,6,22,58,80,-22,30
Queen's Park,1446,10,6,11,19,40,73,-33,29
Ayr,1447,1,24,4,8,93,43,50,76
Raith,1447,2,22,9,5,69,33,36,75
Arbroath,1447,3,18,8,10,73,50,23,62
Alloa,1447,4,17,9,10,57,44,13,60
Stranraer,1447,5,15,6,15,56,65,-9,51
East Fife,1447,6,13,4,19,48,65,-17,43
Airdrieon,1447,7,10,12,14,49,62,-13,42
Forfar,1447,8,10,6,20,42,68,-26,36
Albion,1447,9,8,6,22,58,81,-23,30
Queen's Park,1447,10,6,10,20,41,75,-34,28
Raith,1448,1,23,8,5,69,32,37,77
Ayr,1448,2,24,4,8,93,44,49,76
Arbroath,1448,3,17,9,10,71,49,22,60
Alloa,1448,4,17,8,11,56,44,12,59
Stranraer,1448,5,16,5,15,59,67,-8,53
Airdrieon,1448,6,11,11,14,48,60,-12,44
East Fife,1448,7,13,3,20,50,68,-18,42
Forfar,1448,8,10,5,21,40,67,-27,35
Albion,1448,9,8,6,22,59,81,-22,30
Queen's Park,1448,10,6,11,19,40,73,-33,29
Ayr,1449,1,24,4,8,93,43,50,76
Raith,1449,2,22,8,6,68,37,31,74
Arbroath,1449,3,18,8,10,73,48,25,62
Alloa,1449,4,18,8,10,61,43,18,62
Stranraer,1449,5,16,5,15,57,65,-8,53
Airdrieon,1449,6,11,11,14,47,58,-11,44
East Fife,1449,7,13,3,20,48,66,-18,42
Forfar,1449,8,10,5,21,38,66,-28,35
Albion,1449,9,8,6,22,58,81,-23,30
Queen's Park,1449,10,6,10,20,39,75,-36,28
Raith,1450,1,23,8,5,69,32,37,77
Ayr,1450,2,24,4,8,92,42,50,76
Arbroath,1450,3,17,8,11,71,50,21,59
Alloa,1450,4,17,8,11,56,44,12,59
Stranraer,1450,5,15,6,15,55,64,-9,51
Airdrieon,1450,6,11,11,14,48,60,-12,44
East Fife,1450,7,13,4,19,47,64,-17,43
Forfar,1450,8,10,5,21,40,67,-27,35
Queen's Park,1450,9,7,10,19,41,73,-32,31
Albion,1450,10,8,6,22,57,80,-23,30
Raith,1451,1,23,8,5,71,33,38,77
Ayr,1451,2,24,4,8,95,43,52,76
Arbroath,1451,3,17,9,10,71,49,22,60
Alloa,1451,4,17,8,11,57,46,11,59
Stranraer,1451,5,15,6,15,58,67,-9,51
Airdrieon,1451,6,11,11,14,46,58,-12,44
East Fife,1451,7,13,4,19,50,67,-17,43
Forfar,1451,8,10,5,21,38,65,-27,35
Albion,1451,9,8,6,22,58,83,-25,30
Queen's Park,1451,10,6,11,19,40,73,-33,29
Raith,1452,1,23,8,5,70,33,37,77
Ayr,1452,2,24,4,8,95,43,52,76
Arbroath,1452,3,17,8,11,71,50,21,59
Alloa,1452,4,17,8,11,57,45,12,59
Stranraer,1452,5,15,5,16,55,65,-10,50
East Fife,1452,6,14,3,19,48,64,-16,45
Airdrieon,1452,7,10,12,14,46,59,-13,42
Forfar,1452,8,10,6,20,39,65,-26,36
Queen's Park,1452,9,7,10,19,41,73,-32,31
Albion,1452,10,8,6,22,58,83,-25,30
Ayr,1453,1,24,4,8,92,42,50,76
Raith,1453,2,22,8,6,69,34,35,74
Alloa,1453,3,18,8,10,58,44,14,62
Arbroath,1453,4,17,8,11,73,52,21,59
Stranraer,1453,5,16,5,15,58,66,-8,53
Airdrieon,1453,6,11,11,14,48,58,-10,44
East Fife,1453,7,13,3,20,49,67,-18,42
Forfar,1453,8,10,5,21,38,67,-29,35
Queen's Park,1453,9,7,10,19,43,75,-32,31
Albion,1453,10,8,6,22,57,80,-23,30
Ayr,1454,1,24,4,8,94,43,51,76
Raith,1454,2,22,8,6,70,35,35,74
Arbroath,1454,3,18,8,10,72,48,24,62
Alloa,1454,4,18,8,10,59,45,14,62
Stranraer,1454,5,16,5,15,59,64,-5,53
Airdrieon,1454,6,10,12,14,47,60,-13,42
East Fife,1454,7,13,3,20,47,68,-21,42
Forfar,1454,8,10,6,20,40,66,-26,36
Albion,1454,9,8,6,22,58,82,-24,30
Queen's Park,1454,10,6,10,20,39,74,-35,28
Ayr,1455,1,24,4,8,95,44,51,76
Raith,1455,2,22,9,5,69,33,36,75
Arbroath,1455,3,18,8,10,73,50,23,62
Alloa,1455,4,17,9,10,57,44,13,60
Stranraer,1455,5,15,5,16,55,65,-10,50
East Fife,1455,6,14,3,19,48,64,-16,45
Airdrieon,1455,7,10,11,15,47,61,-14,41
Forfar,1455,8,11,5,20,41,66,-25,38
Albion,1455,9,8,6,22,59,83,-24,30
Queen's Park,1455,10,6,10,20,41,75,-34,28
Raith,1456,1,23,8,5,69,32,37,77
Ayr,1456,2,24,4,8,98,46,52,76
Arbroath,1456,3,18,8,10,71,48,23,62
Alloa,1456,4,17,8,11,56,44,12,59
Stranraer,1456,5,16,5,15,58,64,-6,53
East Fife,1456,6,13,3,20,47,67,-20,42
Airdrieon,1456,7,10,11,15,45,60,-15,41
Forfar,1456,8,11,5,20,40,64,-24,38
Albion,1456,9,8,6,22,61,86,-25,30
Queen's Park,1456,10,6,10,20,39,73,-34,28
Ayr,1457,1,23,5,8,91,43,48,74
Raith,1457,2,22,8,6,68,33,35,74
Alloa,1457,3,18,8,10,57,43,14,62
Arbroath,1457,4,17,9,10,71,49,22,60
Stranraer,1457,5,15,6,15,56,65,-9,51
East Fife,1457,6,13,4,19,48,65,-17,43
Airdrieon,1457,7,10,12,14,46,59,-13,42
Forfar,1457,8,10,6,20,39,65,-26,36
Albion,1457,9,8,7,21,58,79,-21,31
Queen's Park,1457,10,6,11,19,40,73,-33,29
Ayr,1458,1,24,4,8,94,44,50,76
Raith,1458,2,22,9,5,69,33,36,75
Arbroath,1458,3,18,8,10,74,48,26,62
Alloa,1458,4,17,9,10,57,44,13,60
Stranraer,1458,5,15,5,16,55,66,-11,50
East Fife,1458,6,14,3,19,49,64,-15,45
Airdrieon,1458,7,10,11,15,45,59,-14,41
Forfar,1458,8,11,5,20,39,64,-25,38
Albion,1458,9,8,6,22,59,82,-23,30
Queen's Park,1458,10,6,10,20,39,76,-37,28
Ayr,1459,1,24,4,8,91,42,49,76
Raith,1459,2,22,8,6,68,34,34,74
Arbroath,1459,3,18,8,10,73,50,23,62
Alloa,1459,4,18,8,10,58,43,15,62
Stranraer,1459,5,15,6,15,56,65,-9,51
East Fife,1459,6,13,4,19,48,65,-17,43
Airdrieon,1459,7,10,12,14,46,59,-13,42
Forfar,1459,8,10,6,20,39,65,-26,36
Albion,1459,9,8,6,22,57,79,-22,30
Queen's Park,1459,10,6,10,20,41,75,-34,28
Raith,1460,1,23,8,5,70,32,38,77
Ayr,1460,2,24,4,8,94,44,50,76
Arbroath,1460,3,18,8,10,73,48,25,62
Alloa,1460,4,17,8,11,56,45,11,59
Stranraer,1460,5,16,5,15,57,65,-8,53
Airdrieon,1460,6,10,12,14,45,58,-13,42
East Fife,1460,7,13,3,20,48,66,-18,42
Forfar,1460,8,10,6,20,38,64,-26,36
Albion,1460,9,8,6,22,59,82,-23,30
Queen's Park,1460,10,6,10,20,39,75,-36,28
Ayr,1461,1,24,4,8,93,44,49,76
Raith,1461,2,22,9,5,68,32,36,75
Alloa,1461,3,17,9,10,56,43,13,60
Arbroath,1461,4,17,8,11,71,51,20,59
Stranraer,1461,5,16,5,15,58,66,-8,53
Airdrieon,1461,6,11,11,14,47,59,-12,44
East Fife,1461,7,13,3,20,49,67,-18,42
Forfar,1461,8,10,5,21,39,66,-27,35
Queen's Park,1461,9,7,10,19,42,73,-31,31
Albion,1461,10,8,6,22,59,81,-22,30
Raith,1462,1,22,9,5,71,35,36,75
Ayr,1462,2,23,4,9,91,44,47,73
Alloa,1462,3,17,9,10,59,46,13,60
Arbroath,1462,4,17,8,11,70,49,21,59
Stranraer,1462,5,15,5,16,55,66,-11,50
East Fife,1462,6,14,3,19,49,64,-15,45
Airdrieon,1462,7,11,11,14,47,59,-12,44
Forfar,1462,8,10,5,21,39,66,-27,35
Albion,1462,9,9,6,21,59,79,-20,33
Queen's Park,1462,10,7,10,19,40,72,-32,31
Ayr,1463,1,24,4,8,98,43,55,76
Raith,1463,2,22,9,5,68,32,36,75
Arbroath,1463,3,17,9,10,73,51,22,60
Alloa,1463,4,17,9,10,56,43,13,60
Stranraer,1463,5,15,5,16,56,68,-12,50
East Fife,1463,6,14,3,19,51,65,-14,45
Airdrieon,1463,7,11,11,14,46,58,-12,44
Forfar,1463,8,10,5,21,38,65,-27,35
Albion,1463,9,8,6,22,58,86,-28,30
Queen's Park,1463,10,6,11,19,42,75,-33,29
Raith,1464,1,23,8,5,71,33,38,77
Ayr,1464,2,24,4,8,92,42,50,76
Arbroath,1464,3,18,8,10,72,49,23,62
Alloa,1464,4,17,8,11,57,46,11,59
Stranraer,1464,5,16,5,15,58,65,-7,53
Airdrieon,1464,6,10,12,14,45,58,-13,42
East Fife,1464,7,13,3,20,48,67,-19,42
Forfar,1464,8,10,6,20,38,64,-26,36
Albion,1464,9,8,6,22,57,80,-23,30
Queen's Park,1464,10,6,10,20,40,74,-34,28
Raith,1465,1,23,8,5,70,32,38,77
Ayr,1465,2,23,5,8,92,44,48,74
Arbroath,1465,3,17,8,11,71,50,21,59
Alloa,1465,4,17,8,11,56,45,11,59
Stranraer,1465,5,16,5,15,59,65,-6,53
Airdrieon,1465,6,11,11,14,46,58,-12,44
East Fife,1465,7,13,3,20,48,68,-20,42
Forfar,1465,8,10,5,21,38,65,-27,35
Albion,1465,9,8,7,21,59,80,-21,31
Queen's Park,1465,10,7,10,19,41,73,-32,31
Raith,1466,1,23,8,5,69,32,37,77
Ayr,1466,2,24,4,8,92,42,50,76
Arbroath,1466,3,18,8,10,71,48,23,62
Alloa,1466,4,17,8,11,56,44,12,59
Stranraer,1466,5,16,5,15,57,64,-7,53
Airdrieon,1466,6,11,11,14,46,58,-12,44
East Fife,1466,7,13,3,20,47,66,-19,42
Forfar,1466,8,10,5,21,38,65,-27,35
Albion,1466,9,8,6,22,57,80,-23,30
Queen's Park,1466,10,6,10,20,39,73,-34,28
Ayr,1467,1,24,4,8,93,43,50,76
Raith,1467,2,22,8,6,69,34,35,74
Arbroath,1467,3,18,8,10,72,49,23,62
Alloa,1467,4,18,8,10,58,44,14,62
Stranraer,1467,5,15,6,15,56,65,-9,51
Airdrieon,1467,6,11,11,14,46,58,-12,44
East Fife,1467,7,13,4,19,48,65,-17,43
Forfar,1467,8,10,5,21,38,65,-27,35
Albion,1467,9,8,6,22,58,81,-23,30
Queen's Park,1467,10,6,10,20,40,74,-34,28
Raith,1468,1,23,8,5,74,32,42,77
Ayr,1468,2,24,4,8,94,43,51,76
Arbroath,1468,3,18,8,10,73,48,25,62
Alloa,1468,4,17,8,11,56,49,7,59
Stranraer,1468,5,15,5,16,55,69,-14,50
East Fife,1468,6,14,3,19,52,64,-12,45
Airdrieon,1468,7,10,11,15,47,61,-14,41
Forfar,1468,8,11,5,20,41,66,-25,38
Albion,1468,9,8,6,22,58,82,-24,30
Queen's Park,1468,10,6,10,20,39,75,-36,28
Raith,1469,1,23,8,5,69,32,37,77
Ayr,1469,2,23,5,8,93,45,48,74
Arbroath,1469,3,18,8,10,73,48,25,62
Alloa,1469,4,17,8,11,56,44,12,59
Stranraer,1469,5,15,6,15,56,65,-9,51
Airdrieon,1469,6,11,11,14,46,58,-12,44
East Fife,1469,7,13,4,19,48,65,-17,43
Forfar,1469,8,10,5,21,38,65,-27,35
Albion,1469,9,8,7,21,60,81,-21,31
Queen's Park,1469,10,6,10,20,39,75,-36,28
Raith,1470,1,23,8,5,69,32,37,77
Ayr,1470,2,24,4,8,95,43,52,76
Arbroath,1470,3,18,8,10,74,50,24,62
Alloa,1470,4,17,8,11,56,44,12,59
Stranraer,1470,5,16,5,15,57,65,-8,53
Airdrieon,1470,6,11,11,14,48,59,-11,44
East Fife,1470,7,13,3,20,48,66,-18,42
Forfar,1470,8,10,5,21,39,67,-28,35
Albion,1470,9,8,6,22,58,83,-25,30
Queen's Park,1470,10,6,10,20,41,76,-35,28
Ayr,1471,1,24,4,8,97,44,53,76
Raith,1471,2,22,8,6,68,35,33,74
Alloa,1471,3,18,8,10,59,43,16,62
Arbroath,1471,4,17,9,10,70,48,22,60
Stranraer,1471,5,16,5,15,57,65,-8,53
Airdrieon,1471,6,11,11,14,49,60,-11,44
East Fife,1471,7,13,3,20,48,66,-18,42
Forfar,1471,8,10,5,21,40,68,-28,35
Albion,1471,9,8,6,22,59,85,-26,30
Queen's Park,1471,10,6,11,19,39,72,-33,29
Raith,1472,1,23,8,5,70,33,37,77
Ayr,1472,2,23,5,8,91,43,48,74
Arbroath,1472,3,18,8,10,73,48,25,62
Alloa,1472,4,17,8,11,57,45,12,59
Stranraer,1472,5,16,5,15,58,64,-6,53
East Fife,1472,6,13,3,20,47,67,-20,42
Airdrieon,1472,7,10,11,15,45,59,-14,41
Forfar,1472,8,11,5,20,39,64,-25,38
Albion,1472,9,8,7,21,58,79,-21,31
Queen's Park,1472,10,6,10,20,39,75,-36,28
Raith,1473,1,23,8,5,69,32,37,77
Ayr,1473,2,24,4,8,93,42,51,76
Arbroath,1473,3,18,8,10,74,48,26,62
Alloa,1473,4,17,8,11,56,44,12,59
Stranraer,1473,5,16,5,15,58,65,-7,53
Airdrieon,1473,6,11,11,14,46,58,-12,44
East Fife,1473,7,13,3,20,48,67,-19,42
Forfar,1473,8,10,5,21,38,65,-27,35
Albion,1473,9,8,6,22,57,81,-24,30
Queen's Park,1473,10,6,10,20,39,76,-37,28
Ayr,1474,1,24,4,8,92,42,50,76
Raith,1474,2,22,9,5,70,34,36,75
Alloa,1474,3,17,9,10,58,45,13,60
Arbroath,1474,4,17,8,11,71,50,21,59
Stranraer,1474,5,16,5,15,58,64,-6,53
Airdrieon,1474,6,10,12,14,45,58,-13,42
East Fife,1474,7,13,3,20,47,67,-20,42
Forfar,1474,8,10,6,20,38,64,-26,36
Queen's Park,1474,9,7,10,19,41,73,-32,31
Albion,1474,10,8,6,22,57,80,-23,30
Raith,1475,1,23,8,5,69,32,37,77
Ayr,1475,2,24,4,8,96,42,54,76
Arbroath,1475,3,18,8,10,74,50,24,62
Alloa,1475,4,17,8,11,56,44,12,59
Stranraer,1475,5,15,6,15,55,64,-9,51
Airdrieon,1475,6,11,11,14,47,59,-12,44
East Fife,1475,7,13,4,19,47,64,-17,43
Forfar,1475,8,10,5,21,39,66,-27,35
Albion,1475,9,8,6,22,57,84,-27,30
Queen's Park,1475,10,6,10,20,41,76,-35,28
Raith,1476,1,23,8,5,70,32,38,77
Ayr,1476,2,24,4,8,93,42,51,76
Arbroath,1476,3,17,8,11,72,53,19,59
Alloa,1476,4,17,8,11,56,45,11,59
Stranraer,1476,5,16,5,15,57,65,-8,53
Airdrieon,1476,6,10,12,14,47,60,-13,42
East Fife,1476,7,13,3,20,48,66,-18,42
Forfar,1476,8,10,6,20,40,66,-26,36
Queen's Park,1476,9,7,10,19,44,74,-30,31
Albion,1476,10,8,6,22,57,81,-24,30
Ayr,1477,1,24,4,8,94,42,52,76
Raith,1477,2,22,9,5,70,34,36,75
Alloa,1477,3,17,9,10,58,45,13,60
Arbroath,1477,4,17,8,11,72,52,20,59
Stranraer,1477,5,16,5,15,56,64,-8,53
Airdrieon,1477,6,11,11,14,49,58,-9,44
East Fife,1477,7,13,3,20,47,65,-18,42
Forfar,1477,8,10,5,21,38,68,-30,35
Queen's Park,1477,9,7,10,19,43,74,-31,31
Albion,1477,10,8,6,22,57,82,-25,30
Ayr,1478,1,24,4,8,93,42,51,76
Raith,1478,2,22,8,6,71,36,35,74
Arbroath,1478,3,18,8,10,75,49,26,62
Alloa,1478,4,18,8,10,60,46,14,62
Stranraer,1478,5,15,5,16,55,65,-10,50
East Fife,1478,6,14,3,19,48,64,-16,45
Airdrieon,1478,7,10,11,15,46,61,-15,41
Forfar,1478,8,11,5,20,41,65,-24,38
Albion,1478,9,8,6,22,57,81,-24,30
Queen's Park,1478,10,6,10,20,40,77,-37,28
Raith,1479,1,23,8,5,70,32,38,77
Ayr,1479,2,24,4,8,91,42,49,76
Arbroath,1479,3,18,8,10,71,48,23,62
Alloa,1479,4,17,8,11,56,45,11,59
Stranraer,1479,5,15,6,15,57,66,-9,51
Airdrieon,1479,6,11,11,14,48,60,-12,44
East Fife,1479,7,13,4,19,49,66,-17,43
Forfar,1479,8,10,5,21,40,67,-27,35
Albion,1479,9,8,6,22,57,79,-22,30
Queen's Park,1479,10,6,10,20,39,73,-34,28
Raith,1480,1,23,8,5,71,34,37,77
Ayr,1480,2,24,4,8,96,43,53,76
Arbroath,1480,3,17,9,10,73,51,22,60
Alloa,1480,4,17,8,11,58,46,12,59
Stranraer,1480,5,15,5,16,56,66,-10,50
East Fife,1480,6,14,3,19,49,65,-16,45
Airdrieon,1480,7,10,12,14,46,59,-13,42
Forfar,1480,8,10,6,20,39,65,-26,36
Albion,1480,9,8,6,22,58,84,-26,30
Queen's Park,1480,10,6,11,19,42,75,-33,29
Ayr,1481,1,23,5,8,91,43,48,74
Raith,1481,2,22,8,6,68,36,32,74
Alloa,1481,3,18,8,10,60,43,17,62
Arbroath,1481,4,17,8,11,70,50,20,59
Stranraer,1481,5,16,5,15,58,64,-6,53
Airdrieon,1481,6,11,11,14,49,58,-9,44
East Fife,1481,7,13,3,20,47,67,-20,42
Forfar,1481,8,10,5,21,38,68,-30,35
Albion,1481,9,8,7,21,58,79,-21,31
Queen's Park,1481,10,7,10,19,41,72,-31,31
Raith,1482,1,23,8,5,71,34,37,77
Ayr,1482,2,24,4,8,93,43,50,76
Arbroath,1482,3,18,8,10,73,50,23,62
Alloa,1482,4,17,8,11,58,46,12,59
Stranraer,1482,5,15,5,16,56,66,-10,50
East Fife,1482,6,14,3,19,49,65,-16,45
Airdrieon,1482,7,11,11,14,50,59,-9,44
Forfar,1482,8,10,5,21,39,69,-30,35
Albion,1482,9,8,6,22,58,81,-23,30
Queen's Park,1482,10,6,10,20,41,75,-34,28
Ayr,1483,1,24,4,8,94,43,51,76
Raith,1483,2,22,9,5,71,35,36,75
Arbroath,1483,3,18,8,10,73,48,25,62
Alloa,1483,4,17,9,10,59,46,13,60
Stranraer,1483,5,15,6,15,57,66,-9,51
Airdrieon,1483,6,11,11,14,48,58,-10,44
East Fife,1483,7,13,4,19,49,66,-17,43
Forfar,1483,8,10,5,21,38,67,-29,35
Albion,1483,9,8,6,22,58,82,-24,30
Queen's Park,1483,10,6,10,20,39,75,-36,28
Ayr,1484,1,24,4,8,92,43,49,76
Raith,1484,2,22,9,5,69,33,36,75
Arbroath,1484,3,18,8,10,76,48,28,62
Alloa,1484,4,17,9,10,57,44,13,60
Stranraer,1484,5,16,5,15,57,64,-7,53
East Fife,1484,6,13,3,20,47,66,-19,42
Airdrieon,1484,7,10,11,15,45,60,-15,41
Forfar,1484,8,11,5,20,40,64,-24,38
Albion,1484,9,8,6,22,58,80,-22,30
Queen's Park,1484,10,6,10,20,39,78,-39,28
Ayr,1485,1,24,4,8,94,43,51,76
Raith,1485,2,22,8,6,68,33,35,74
Alloa,1485,3,18,8,10,57,43,14,62
Arbroath,1485,4,17,9,10,72,50,22,60
Stranraer,1485,5,15,6,15,56,65,-9,51
East Fife,1485,6,13,4,19,48,65,-17,43
Airdrieon,1485,7,10,12,14,47,60,-13,42
Forfar,1485,8,10,6,20,40,66,-26,36
Albion,1485,9,8,6,22,58,82,-24,30
Queen's Park,1485,10,6,11,19,41,74,-33,29
Ayr,1486,1,24,4,8,94,45,49,76
Raith,1486,2,22,8,6,69,35,34,74
Alloa,1486,3,18,8,10,59,44,15,62
Arbroath,1486,4,17,9,10,71,49,22,60
Stranraer,1486,5,15,6,15,57,66,-9,51
Airdrieon,1486,6,11,11,14,46,58,-12,44
East Fife,1486,7,13,4,19,49,66,-17,43
Forfar,1486,8,10,5,21,38,65,-27,35
Albion,1486,9,8,6,22,60,82,-22,30
Queen's Park,1486,10,6,11,19,40,73,-33,29
Raith,1487,1,23,8,5,70,33,37,77
Ayr,1487,2,24,4,8,95,45,50,76
Arbroath,1487,3,18,8,10,73,48,25,62
Alloa,1487,4,17,8,11,57,45,12,59
Stranraer,1487,5,16,5,15,58,65,-7,53
East Fife,1487,6,13,3,20,48,67,-19,42
Airdrieon,1487,7,10,11,15,45,59,-14,41
Forfar,1487,8,11,5,20,39,64,-25,38
Albion,1487,9,8,6,22,60,83,-23,30
Queen's Park,1487,10,6,10,20,39,75,-36,28
Raith,1488,1,23,8,5,71,32,39,77
Ayr,1488,2,24,4,8,95,45,50,76
Arbroath,1488,3,18,8,10,73,49,24,62
Alloa,1488,4,17,8,11,56,46,10,59
Stranraer,1488,5,16,5,15,56,64,-8,53
Airdrieon,1488,6,11,11,14,48,58,-10,44
East Fife,1488,7,13,3,20,47,65,-18,42
Forfar,1488,8,10,5,21,38,67,-29,35
Albion,1488,9,8,6,22,60,83,-23,30
Queen's Park,1488,10,6,10,20,40,75,-35,28
Raith,1489,1,23,8,5,72,34,38,77
Ayr,1489,2,24,4,8,96,44,52,76
Arbroath,1489,3,18,8,10,73,49,24,62
Alloa,1489,4,17,8,11,58,47,11,59
Stranraer,1489,5,15,5,16,55,66,-11,50
East Fife,1489,6,14,3,19,49,64,-15,45
Airdrieon,1489,7,11,11,14,48,58,-10,44
Forfar,1489,8,10,5,21,38,67,-29,35
Albion,1489,9,8,6,22,59,84,-25,30
Queen's Park,1489,10,6,10,20,40,75,-35,28
Ayr,1490,1,23,5,8,93,45,48,74
Raith,1490,2,22,8,6,69,35,34,74
Alloa,1490,3,18,8,10,59,44,15,62
Arbroath,1490,4,17,9,10,71,49,22,60
Stranraer,1490,5,15,6,15,56,65,-9,51
East Fife,1490,6,13,4,19,48,65,-17,43
Airdrieon,1490,7,10,12,14,46,59,-13,42
Forfar,1490,8,10,6,20,39,65,-26,36
Albion,1490,9,8,7,21,60,81,-21,31
Queen's Park,1490,10,6,11,19,40,73,-33,29
Raith,1491,1,23,8,5,71,34,37,77
Ayr,1491,2,24,4,8,92,43,49,76
Arbroath,1491,3,17,9,10,72,50,22,60
Alloa,1491,4,17,8,11,58,46,12,59
Stranraer,1491,5,16,5,15,60,66,-6,53
Airdrieon,1491,6,11,11,14,47,58,-11,44
East Fife,1491,7,13,3,20,49,69,-20,42
Forfar,1491,8,10,5,21,38,66,-28,35
Albion,1491,9,8,6,22,58,80,-22,30
Queen's Park,1491,10,6,11,19,41,74,-33,29
Ayr,1492,1,24,4,8,92,42,50,76
Raith,1492,2,22,8,6,69,34,35,74
Arbroath,1492,3,18,8,10,71,48,23,62
Alloa,1492,4,18,8,10,58,44,14,62
Stranraer,1492,5,15,5,16,55,65,-10,50
East Fife,1492,6,14,3,19,48,64,-16,45
Airdrieon,1492,7,11,11,14,47,59,-12,44
Forfar,1492,8,10,5,21,39,66,-27,35
Albion,1492,9,8,6,22,57,80,-23,30
Queen's Park,1492,10,6,10,20,39,73,-34,28
Raith,1493,1,22,9,5,68,32,36,75
Ayr,1493,2,23,5,8,92,44,48,74
Arbroath,1493,3,18,8,10,72,49,23,62
Alloa,1493,4,17,9,10,56,43,13,60
Stranraer,1493,5,15,6,15,56,65,-9,51
East Fife,1493,6,13,4,19,48,65,-17,43
Airdrieon,1493,7,10,11,15,45,59,-14,41
Forfar,1493,8,11,5,20,39,64,-25,38
Albion,1493,9,8,7,21,59,80,-21,31
Queen's Park,1493,10,6,10,20,40,74,-34,28
Raith,1494,1,23,8,5,70,33,37,77
Ayr,1494,2,24,4,8,91,42,49,76
Arbroath,1494,3,17,8,11,71,53,18,59
Alloa,1494,4,17,8,11,57,45,12,59
Stranraer,1494,5,15,5,16,57,68,-11,50
East Fife,1494,6,14,3,19,51,66,-15,45
Airdrieon,1494,7,11,11,14,49,59,-10,44
Forfar,1494,8,10,5,21,39,68,-29,35
Queen's Park,1494,9,7,10,19,44,73,-29,31
Albion,1494,10,8,6,22,57,79,-22,30
Raith,1495,1,22,9,5,68,32,36,75
Ayr,1495,2,23,5,8,91,43,48,74
Arbroath,1495,3,17,9,10,71,49,22,60
Alloa,1495,4,17,9,10,56,43,13,60
Stranraer,1495,5,15,5,16,56,66,-10,50
East Fife,1495,6,14,3,19,49,65,-16,45
Airdrieon,1495,7,11,11,14,49,59,-10,44
Forfar,1495,8,10,5,21,39,68,-29,35
Albion,1495,9,8,7,21,58,79,-21,31
Queen's Park,1495,10,6,11,19,40,73,-33,29
Raith,1496,1,23,8,5,71,34,37,77
Ayr,1496,2,24,4,8,93,44,49,76
Arbroath,1496,3,17,8,11,71,50,21,59
Alloa,1496,4,17,8,11,58,46,12,59
Stranraer,1496,5,16,5,15,56,64,-8,53
Airdrieon,1496,6,11,11,14,46,58,-12,44
East Fife,1496,7,13,3,20,47,65,-18,42
Forfar,1496,8,10,5,21,38,65,-27,35
Queen's Park,1496,9,7,10,19,41,73,-32,31
Albion,1496,10,8,6,22,59,81,-22,30
Ayr,1497,1,24,4,8,94,43,51,76
Raith,1497,2,22,9,5,69,33,36,75
Alloa,1497,3,17,9,10,57,44,13,60
Arbroath,1497,4,17,8,11,71,50,21,59
Stranraer,1497,5,16,5,15,56,64,-8,53
Airdrieon,1497,6,11,11,14,46,58,-12,44
East Fife,1497,7,13,3,20,47,65,-18,42
Forfar,1497,8,10,5,21,38,65,-27,35
Queen's Park,1497,9,7,10,19,41,73,-32,31
Albion,1497,10,8,6,22,58,82,-24,30
Raith,1498,1,23,8,5,70,33,37,77
Ayr,1498,2,24,4,8,94,43,51,76
Arbroath,1498,3,18,8,10,73,48,25,62
Alloa,1498,4,17,8,11,57,45,12,59
Stranraer,1498,5,15,5,16,56,69,-13,50
East Fife,1498,6,14,3,19,52,65,-13,45
Airdrieon,1498,7,11,11,14,50,59,-9,44
Forfar,1498,8,10,5,21,39,69,-30,35
Albion,1498,9,8,6,22,58,82,-24,30
Queen's Park,1498,10,6,10,20,39,75,-36,28
Raith,1499,1,23,8,5,70,32,38,77
Ayr,1499,2,24,4,8,92,43,49,76
Arbroath,1499,3,17,9,10,72,50,22,60
Alloa,1499,4,17,8,11,56,45,11,59
Stranraer,1499,5,15,5,16,55,68,-13,50
East Fife,1499,6,14,3,19,51,64,-13,45
Airdrieon,1499,7,10,12,14,45,58,-13,42
Forfar,1499,8,10,6,20,38,64,-26,36
Albion,1499,9,8,6,22,58,80,-22,30
Queen's Park,1499,10,6,11,19,41,74,-33,29
Raith,1500,1,23,8,5,69,32,37,77
Ayr,1500,2,23,4,9,91,44,47,73
Arbroath,1500,3,18,8,10,72,49,23,62
Alloa,1500,4,17,8,11,56,44,12,59
Stranraer,1500,5,15,6,15,58,67,-9,51
East Fife,1500,6,13,4,19,50,67,-17,43
Airdrieon,1500,7,10,11,15,45,60,-15,41
Forfar,1500,8,11,5,20,40,64,-24,38
Albion,1500,9,9,6,21,59,79,-20,33
Queen's Park,1500,10,6,10,20,40,74,-34,28
Raith,1501,1,23,8,5,72,32,40,77
Ayr,1501,2,24,4,8,96,42,54,76
Arbroath,1501,3,18,8,10,73,49,24,62
Alloa,1501,4,17,8,11,56,47,9,59
Stranraer,1501,5,16,5,15,58,65,-7,53
Airdrieon,1501,6,11,11,14,49,58,-9,44
East Fife,1501,7,13,3,20,48,67,-19,42
Forfar,1501,8,10,5,21,38,68,-30,35
Albion,1501,9,8,6,22,57,84,-27,30
Queen's Park,1501,10,6,10,20,40,75,-35,28
Raith,1502,1,22,9,5,70,34,36,75
Ayr,1502,2,23,4,9,91,44,47,73
Arbroath,1502,3,18,8,10,71,48,23,62
Alloa,1502,4,17,9,10,58,45,13,60
Stranraer,1502,5,15,6,15,57,66,-9,51
Airdrieon,1502,6,11,11,14,47,59,-12,44
East Fife,1502,7,13,4,19,49,66,-17,43
Forfar,1502,8,10,5,21,39,66,-27,35
Albion,1502,9,9,6,21,59,79,-20,33
Queen's Park,1502,10,6,10,20,39,73,-34,28
Raith,1503,1,23,8,5,70,33,37,77
Ayr,1503,2,24,4,8,91,42,49,76
Arbroath,1503,3,18,8,10,74,50,24,62
Alloa,1503,4,17,8,11,57,45,12,59
Stranraer,1503,5,15,5,16,57,68,-11,50
East Fife,1503,6,14,3,19,51,66,-15,45
Airdrieon,1503,7,10,12,14,46,59,-13,42
Forfar,1503,8,10,6,20,39,65,-26,36
Albion,1503,9,8,6,22,57,79,-22,30
Queen's Park,1503,10,6,10,20,41,76,-35,28
Raith,1504,1,23,8,5,72,34,38,77
Ayr,1504,2,24,4,8,93,42,51,76
Arbroath,1504,3,17,8,11,70,49,21,59
Alloa,1504,4,17,8,11,58,47,11,59
Stranraer,1504,5,15,5,16,56,66,-10,50
East Fife,1504,6,14,3,19,49,65,-16,45
Airdrieon,1504,7,11,11,14,46,58,-12,44
Forfar,1504,8,10,5,21,38,65,-27,35
Queen's Park,1504,9,7,10,19,40,72,-32,31
Albion,1504,10,8,6,22,57,81,-24,30
Raith,1505,1,23,8,5,72,33,39,77
Ayr,1505,2,23,5,8,92,44,48,74
Arbroath,1505,3,18,8,10,72,49,23,62
Alloa,1505,4,17,8,11,57,47,10,59
Stranraer,1505,5,16,5,15,57,64,-7,53
East Fife,1505,6,13,3,20,47,66,-19,42
Airdrieon,1505,7,10,11,15,45,59,-14,41
Forfar,1505,8,11,5,20,39,64,-25,38
Albion,1505,9,8,7,21,59,80,-21,31
Queen's Park,1505,10,6,10,20,40,74,-34,28
Raith,1506,1,23,8,5,69,32,37,77
Ayr,1506,2,24,4,8,93,42,51,76
Arbroath,1506,3,18,8,10,73,50,23,62
Alloa,1506,4,17,8,11,56,44,12,59
Stranraer,1506,5,16,5,15,58,65,-7,53
Airdrieon,1506,6,11,11,14,47,59,-12,44
East Fife,1506,7,13,3,20,48,67,-19,42
Forfar,1506,8,10,5,21,39,66,-27,35
Albion,1506,9,8,6,22,57,81,-24,30
Queen's Park,1506,10,6,10,20,41,75,-34,28
Ayr,1507,1,24,4,8,93,43,50,76
Raith,1507,2,22,9,5,69,33,36,75
Arbroath,1507,3,17,9,10,71,49,22,60
Alloa,1507,4,17,9,10,57,44,13,60
Stranraer,1507,5,16,5,15,57,64,-7,53
Airdrieon,1507,6,11,11,14,46,58,-12,44
East Fife,1507,7,13,3,20,47,66,-19,42
Forfar,1507,8,10,5,21,38,65,-27,35
Albion,1507,9,8,6,22,58,81,-23,30
Queen's Park,1507,10,6,11,19,40,73,-33,29
Raith,1508,1,23,8,5,70,33,37,77
Ayr,1508,2,24,4,8,94,44,50,76
Arbroath,1508,3,17,9,10,71,49,22,60
Alloa,1508,4,17,8,11,57,45,12,59
Stranraer,1508,5,15,6,15,56,65,-9,51
Airdrieon,1508,6,11,11,14,49,61,-12,44
East Fife,1508,7,13,4,19,48,65,-17,43
Forfar,1508,8,10,5,21,41,68,-27,35
Albion,1508,9,8,6,22,59,82,-23,30
Queen's Park,1508,10,6,11,19,40,73,-33,29
Ayr,1509,1,24,4,8,99,43,56,76
Raith,1509,2,22,8,6,69,34,35,74
Alloa,1509,3,18,8,10,58,44,14,62
Arbroath,1509,4,17,8,11,70,50,20,59
Stranraer,1509,5,16,5,15,58,65,-7,53
Airdrieon,1509,6,11,11,14,48,60,-12,44
East Fife,1509,7,13,3,20,48,67,-19,42
Forfar,1509,8,10,5,21,40,67,-27,35
Queen's Park,1509,9,7,10,19,41,72,-31,31
Albion,1509,10,8,6,22,58,87,-29,30
Ayr,1510,1,24,4,8,95,43,52,76
Raith,1510,2,22,8,6,68,34,34,74
Arbroath,1510,3,18,8,10,71,48,23,62
Alloa,1510,4,18,8,10,58,43,15,62
Stranraer,1510,5,16,5,15,58,65,-7,53
Airdrieon,1510,6,11,11,14,48,60,-12,44
East Fife,1510,7,13,3,20,48,67,-19,42
Forfar,1510,8,10,5,21,40,67,-27,35
Albion,1510,9,8,6,22,58,83,-25,30
Queen's Park,1510,10,6,10,20,39,73,-34,28
Ayr,1511,1,24,4,8,93,42,51,76
Raith,1511,2,22,8,6,69,34,35,74
Alloa,1511,3,18,8,10,58,44,14,62
Arbroath,1511,4,17,9,10,71,49,22,60
Stranraer,1511,5,15,5,16,56,67,-11,50
East Fife,1511,6,14,3,19,50,65,-15,45
Airdrieon,1511,7,10,12,14,45,58,-13,42
Forfar,1511,8,10,6,20,38,64,-26,36
Albion,1511,9,8,6,22,57,81,-24,30
Queen's Park,1511,10,6,11,19,40,73,-33,29
Raith,1512,1,23,8,5,72,32,40,77
Ayr,1512,2,23,4,9,90,43,47,73
Arbroath,1512,3,18,8,10,71,48,23,62
Alloa,1512,4,17,8,11,56,47,9,59
Stranraer,1512,5,15,6,15,56,65,-9,51
Airdrieon,1512,6,11,11,14,46,58,-12,44
East Fife,1512,7,13,4,19,48,65,-17,43
Forfar,1512,8,10,5,21,38,65,-27,35
Albion,1512,9,9,6,21,58,78,-20,33
Queen's Park,1512,10,6,10,20,39,73,-34,28
Raith,1513,1,23,8,5,70,32,38,77
Ayr,1513,2,23,4,9,91,44,47,73
Arbroath,1513,3,17,8,11,70,51,19,59
Alloa,1513,4,17,8,11,56,45,11,59
Stranraer,1513,5,15,5,16,55,69,-14,50
East Fife,1513,6,14,3,19,52,64,-12,45
Airdrieon,1513,7,10,12,14,47,60,-13,42
Forfar,1513,8,10,6,20,40,66,-26,36
Albion,1513,9,9,6,21,59,79,-20,33
Queen's Park,1513,10,7,10,19,42,72,-30,31
Ayr,1514,1,24,4,8,93,42,51,76
Raith,1514,2,22,9,5,68,32,36,75
Arbroath,1514,3,18,8,10,73,50,23,62
Alloa,1514,4,17,9,10,56,43,13,60
Stranraer,1514,5,16,5,15,56,64,-8,53
East Fife,1514,6,13,3,20,47,65,-18,42
Airdrieon,1514,7,10,11,15,45,59,-14,41
Forfar,1514,8,11,5,20,39,64,-25,38
Albion,1514,9,8,6,22,57,81,-24,30
Queen's Park,1514,10,6,10,20,41,75,-34,28
Ayr,1515,1,24,4,8,93,44,49,76
Raith,1515,2,22,8,6,68,34,34,74
Arbroath,1515,3,18,8,10,73,49,24,62
Alloa,1515,4,18,8,10,58,43,15,62
Stranraer,1515,5,15,5,16,55,65,-10,50
East Fife,1515,6,14,3,19,48,64,-16,45
Airdrieon,1515,7,11,11,14,48,59,-11,44
Forfar,1515,8,10,5,21,39,67,-28,35
Albion,1515,9,8,6,22,59,81,-22,30
Queen's Park,1515,10,6,10,20,40,75,-35,28
Raith,1516,1,22,8,6,69,34,35,74
Ayr,1516,2,23,4,9,92,45,47,73
Arbroath,1516,3,18,8,10,73,50,23,62
Alloa,1516,4,18,8,10,58,44,14,62
Stranraer,1516,5,15,5,16,56,68,-12,50
East Fife,1516,6,14,3,19,51,65,-14,45
Airdrieon,1516,7,11,11,14,47,59,-12,44
Forfar,1516,8,10,5,21,39,66,-27,35
Albion,1516,9,9,6,21,60,80,-20,33
Queen's Park,1516,10,6,10,20,41,75,-34,28
Raith,1517,1,22,9,5,70,34,36,75
Ayr,1517,2,23,5,8,91,43,48,74
Arbroath,1517,3,18,8,10,74,48,26,62
Alloa,1517,4,17,9,10,58,45,13,60
Stranraer,1517,5,15,6,15,58,67,-9,51
East Fife,1517,6,13,4,19,50,67,-17,43
Airdrieon,1517,7,10,12,14,46,59,-13,42
Forfar,1517,8,10,6,20,39,65,-26,36
Albion,1517,9,8,7,21,58,79,-21,31
Queen's Park,1517,10,6,10,20,39,76,-37,28
Raith,1518,1,23,8,5,71,33,38,77
Ayr,1518,2,24,4,8,93,43,50,76
Arbroath,1518,3,17,9,10,72,50,22,60
Alloa,1518,4,17,8,11,57,46,11,59
Stranraer,1518,5,15,5,16,56,66,-10,50
East Fife,1518,6,14,3,19,49,65,-16,45
Airdrieon,1518,7,10,12,14,46,59,-13,42
Forfar,1518,8,10,6,20,39,65,-26,36
Albion,1518,9,8,6,22,58,81,-23,30
Queen's Park,1518,10,6,11,19,41,74,-33,29
Ayr,1519,1,24,4,8,95,43,52,76
Raith,1519,2,22,9,5,69,33,36,75
Arbroath,1519,3,18,8,10,73,48,25,62
Alloa,1519,4,17,9,10,57,44,13,60
Stranraer,1519,5,15,5,16,56,66,-10,50
East Fife,1519,6,14,3,19,49,65,-16,45
Airdrieon,1519,7,10,11,15,45,59,-14,41
Forfar,1519,8,11,5,20,39,64,-25,38
Albion,1519,9,8,6,22,58,83,-25,30
Queen's Park,1519,10,6,10,20,39,75,-36,28
Ayr,1520,1,24,4,8,95,43,52,76
Raith,1520,2,22,9,5,70,34,36,75
Arbroath,1520,3,18,8,10,72,49,23,62
Alloa,1520,4,17,9,10,58,45,13,60
Stranraer,1520,5,15,5,16,56,67,-11,50
East Fife,1520,6,14,3,19,50,65,-15,45
Airdrieon,1520,7,11,11,14,47,58,-11,44
Forfar,1520,8,10,5,21,38,66,-28,35
Albion,1520,9,8,6,22,58,83,-25,30
Queen's Park,1520,10,6,10,20,40,74,-34,28
Raith,1521,1,23,8,5,71,33,38,77
Ayr,1521,2,23,4,9,94,48,46,73
Arbroath,1521,3,17,8,11,70,49,21,59
Alloa,1521,4,17,8,11,57,46,11,59
Stranraer,1521,5,15,6,15,56,65,-9,51
Airdrieon,1521,6,11,11,14,47,58,-11,44
East Fife,1521,7,13,4,19,48,65,-17,43
Forfar,1521,8,10,5,21,38,66,-28,35
Albion,1521,9,9,6,21,63,82,-19,33
Queen's Park,1521,10,7,10,19,40,72,-32,31
Ayr,1522,1,24,4,8,97,43,54,76
Raith,1522,2,22,8,6,68,35,33,74
Arbroath,1522,3,18,8,10,74,50,24,62
Alloa,1522,4,18,8,10,59,43,16,62
Stranraer,1522,5,15,5,16,55,66,-11,50
East Fife,1522,6,14,3,19,49,64,-15,45
Airdrieon,1522,7,11,11,14,46,58,-12,44
Forfar,1522,8,10,5,21,38,65,-27,35
Albion,1522,9,8,6,22,58,85,-27,30
Queen's Park,1522,10,6,10,20,41,76,-35,28
Raith,1523,1,23,8,5,69,32,37,77
Ayr,1523,2,24,4,8,94,42,52,76
Arbroath,1523,3,17,9,10,72,50,22,60
Alloa,1523,4,17,8,11,56,44,12,59
Stranraer,1523,5,15,6,15,56,65,-9,51
Airdrieon,1523,6,11,11,14,47,58,-11,44
East Fife,1523,7,13,4,19,48,65,-17,43
Forfar,1523,8,10,5,21,38,66,-28,35
Albion,1523,9,8,6,22,57,82,-25,30
Queen's Park,1523,10,6,11,19,41,74,-33,29
Ayr,1524,1,24,4,8,93,43,50,76
Raith,1524,2,22,9,5,70,34,36,75
Arbroath,1524,3,17,9,10,71,49,22,60
Alloa,1524,4,17,9,10,58,45,13,60
Stranraer,1524,5,15,5,16,58,68,-10,50
East Fife,1524,6,14,3,19,51,67,-16,45
Airdrieon,1524,7,10,12,14,47,60,-13,42
Forfar,1524,8,10,6,20,40,66,-26,36
Albion,1524,9,8,6,22,58,81,-23,30
Queen's Park,1524,10,6,11,19,40,73,-33,29
Ayr,1525,1,24,4,8,94,44,50,76
Raith,1525,2,22,9,5,70,34,36,75
Alloa,1525,3,17,9,10,58,45,13,60
Arbroath,1525,4,17,8,11,72,51,21,59
Stranraer,1525,5,15,5,16,56,69,-13,50
East Fife,1525,6,14,3,19,52,65,-13,45
Airdrieon,1525,7,10,11,15,45,59,-14,41
Forfar,1525,8,11,5,20,39,64,-25,38
Queen's Park,1525,9,7,10,19,42,74,-32,31
Albion,1525,10,8,6,22,59,82,-23,30
Raith,1526,1,23,8,5,72,32,40,77
Ayr,1526,2,23,5,8,93,45,48,74
Arbroath,1526,3,17,8,11,72,52,20,59
Alloa,1526,4,17,8,11,56,47,9,59
Stranraer,1526,5,15,5,16,57,67,-10,50
East Fife,1526,6,14,3,19,50,66,-16,45
Airdrieon,1526,7,10,12,14,47,60,-13,42
Forfar,1526,8,10,6,20,40,66,-26,36
Albion,1526,9,8,7,21,60,81,-21,31
Queen's Park,1526,10,7,10,19,43,74,-31,31
Raith,1527,1,23,8,5,70,33,37,77
Ayr,1527,2,24,4,8,96,44,52,76
Arbroath,1527,3,18,8,10,73,49,24,62
Alloa,1527,4,17,8,11,57,45,12,59
Stranraer,1527,5,16,5,15,57,64,-7,53
Airdrieon,1527,6,11,11,14,47,59,-12,44
East Fife,1527,7,13,3,20,47,66,-19,42
Forfar,1527,8,10,5,21,39,66,-27,35
Albion,1527,9,8,6,22,59,84,-25,30
Queen's Park,1527,10,6,10,20,40,75,-35,28
Raith,1528,1,22,9,5,69,33,36,75
Ayr,1528,2,23,5,8,92,44,48,74
Alloa,1528,3,17,9,10,57,44,13,60
Arbroath,1528,4,17,8,11,70,49,21,59
Stranraer,1528,5,16,5,15,59,67,-8,53
Airdrieon,1528,6,10,12,14,47,60,-13,42
East Fife,1528,7,13,3,20,50,68,-18,42
Forfar,1528,8,10,6,20,40,66,-26,36
Albion,1528,9,8,7,21,59,80,-21,31
Queen's Park,1528,10,7,10,19,40,72,-32,31
Ayr,1529,1,24,4,8,97,44,53,76
Raith,1529,2,22,9,5,68,32,36,75
Alloa,1529,3,17,9,10,56,43,13,60
Arbroath,1529,4,17,8,11,70,52,18,59
Stranraer,1529,5,15,6,15,56,65,-9,51
East Fife,1529,6,13,4,19,48,65,-17,43
Airdrieon,1529,7,10,11,15,45,60,-15,41
Forfar,1529,8,11,5,20,40,64,-24,38
Queen's Park,1529,9,7,10,19,43,72,-29,31
Albion,1529,10,8,6,22,59,85,-26,30
Ayr,1530,1,24,4,8,97,43,54,76
Raith,1530,2,22,8,6,68,34,34,74
Alloa,1530,3,18,8,10,58,43,15,62
Arbroath,1530,4,17,8,11,71,50,21,59
Stranraer,1530,5,15,5,16,56,66,-10,50
East Fife,1530,6,14,3,19,49,65,-16,45
Airdrieon,1530,7,10,12,14,45,58,-13,42
Forfar,1530,8,10,6,20,38,64,-26,36
Queen's Park,1530,9,7,10,19,41,73,-32,31
Albion,1530,10,8,6,22,58,85,-27,30
Raith,1531,1,23,8,5,72,32,40,77
Ayr,1531,2,24,4,8,96,43,53,76
Arbroath,1531,3,17,8,11,71,50,21,59
Alloa,1531,4,17,8,11,56,47,9,59
Stranraer,1531,5,15,5,16,56,67,-11,50
East Fife,1531,6,14,3,19,50,65,-15,45
Airdrieon,1531,7,10,11,15,45,62,-17,41
Forfar,1531,8,11,5,20,42,64,-22,38
Queen's Park,1531,9,7,10,19,41,73,-32,31
Albion,1531,10,8,6,22,58,84,-26,30
Raith,1532,1,23,8,5,70,33,37,77
Ayr,1532,2,24,4,8,94,42,52,76
Arbroath,1532,3,17,8,11,71,50,21,59
Alloa,1532,4,17,8,11,57,45,12,59
Stranraer,1532,5,15,5,16,56,66,-10,50
East Fife,1532,6,14,3,19,49,65,-16,45
Airdrieon,1532,7,10,11,15,45,59,-14,41
Forfar,1532,8,11,5,20,39,64,-25,38
Queen's Park,1532,9,7,10,19,41,73,-32,31
Albion,1532,10,8,6,22,57,82,-25,30
Raith,1533,1,23,8,5,70,33,37,77
Ayr,1533,2,23,5,8,91,43,48,74
Arbroath,1533,3,17,9,10,72,50,22,60
Alloa,1533,4,17,8,11,57,45,12,59
Stranraer,1533,5,15,5,16,55,65,-10,50
East Fife,1533,6,14,3,19,48,64,-16,45
Airdrieon,1533,7,10,11,15,46,60,-14,41
Forfar,1533,8,11,5,20,40,65,-25,38
Albion,1533,9,8,7,21,58,79,-21,31
Queen's Park,1533,10,6,11,19,41,74,-33,29
Raith,1534,1,23,8,5,70,33,37,77
Ayr,1534,2,24,4,8,96,42,54,76
Arbroath,1534,3,18,8,10,72,48,24,62
Alloa,1534,4,17,8,11,57,45,12,59
Stranraer,1534,5,15,6,15,56,65,-9,51
Airdrieon,1534,6,11,11,14,46,58,-12,44
East Fife,1534,7,13,4,19,48,65,-17,43
Forfar,1534,8,10,5,21,38,65,-27,35
Albion,1534,9,8,6,22,57,84,-27,30
Queen's Park,1534,10,6,10,20,39,74,-35,28
Raith,1535,1,23,8,5,69,32,37,77
Ayr,1535,2,24,4,8,93,42,51,76
Arbroath,1535,3,18,8,10,73,49,24,62
Alloa,1535,4,17,8,11,56,44,12,59
Stranraer,1535,5,15,5,16,56,69,-13,50
East Fife,1535,6,14,3,19,52,65,-13,45
Airdrieon,1535,7,10,12,14,46,59,-13,42
Forfar,1535,8,10,6,20,39,65,-26,36
Albion,1535,9,8,6,22,57,81,-24,30
Queen's Park,1535,10,6,10,20,40,75,-35,28
Raith,1536,1,22,9,5,69,33,36,75
Ayr,1536,2,23,4,9,90,44,46,73
Alloa,1536,3,17,9,10,57,44,13,60
Arbroath,1536,4,17,8,11,71,52,19,59
Stranraer,1536,5,15,6,15,56,65,-9,51
Airdrieon,1536,6,11,11,14,47,59,-12,44
East Fife,1536,7,13,4,19,48,65,-17,43
Forfar,1536,8,10,5,21,39,66,-27,35
Albion,1536,9,9,6,21,59,78,-19,33
Queen's Park,1536,10,7,10,19,43,73,-30,31
Raith,1537,1,23,8,5,69,32,37,77
Ayr,1537,2,24,4,8,94,43,51,76
Arbroath,1537,3,17,9,10,71,49,22,60
Alloa,1537,4,17,8,11,56,44,12,59
Stranraer,1537,5,15,6,15,55,64,-9,51
East Fife,1537,6,13,4,19,47,64,-17,43
Airdrieon,1537,7,10,12,14,47,60,-13,42
Forfar,1537,8,10,6,20,40,66,-26,36
Albion,1537,9,8,6,22,58,82,-24,30
Queen's Park,1537,10,6,11,19,40,73,-33,29
Ayr,1538,1,24,4,8,97,43,54,76
Raith,1538,2,22,8,6,69,34,35,74
Arbroath,1538,3,18,8,10,71,48,23,62
Alloa,1538,4,18,8,10,58,44,14,62
Stranraer,1538,5,15,5,16,56,66,-10,50
East Fife,1538,6,14,3,19,49,65,-16,45
Airdrieon,1538,7,11,11,14,47,59,-12,44
Forfar,1538,8,10,5,21,39,66,-27,35
Albion,1538,9,8,6,22,58,85,-27,30
Queen's Park,1538,10,6,10,20,39,73,-34,28
Ayr,1539,1,24,4,8,96,43,53,76
Raith,1539,2,22,8,6,68,34,34,74
Arbroath,1539,3,18,8,10,74,51,23,62
Alloa,1539,4,18,8,10,58,43,15,62
Stranraer,1539,5,15,5,16,56,66,-10,50
East Fife,1539,6,14,3,19,49,65,-16,45
Airdrieon,1539,7,11,11,14,47,58,-11,44
Forfar,1539,8,10,5,21,38,66,-28,35
Albion,1539,9,8,6,22,58,84,-26,30
Queen's Park,1539,10,6,10,20,42,76,-34,28
Raith,1540,1,22,9,5,68,32,36,75
Ayr,1540,2,23,5,8,91,43,48,74
Arbroath,1540,3,17,9,10,73,51,22,60
Alloa,1540,4,17,9,10,56,43,13,60
Stranraer,1540,5,15,6,15,56,65,-9,51
Airdrieon,1540,6,11,11,14,48,60,-12,44
East Fife,1540,7,13,4,19,48,65,-17,43
Forfar,1540,8,10,5,21,40,67,-27,35
Albion,1540,9,8,7,21,58,79,-21,31
Queen's Park,1540,10,6,11,19,42,75,-33,29
Ayr,1541,1,24,4,8,94,43,51,76
Raith,1541,2,22,8,6,68,33,35,74
Arbroath,1541,3,18,8,10,73,49,24,62
Alloa,1541,4,18,8,10,57,43,14,62
Stranraer,1541,5,15,5,16,56,66,-10,50
East Fife,1541,6,14,3,19,49,65,-16,45
Airdrieon,1541,7,10,12,14,46,59,-13,42
Forfar,1541,8,10,6,20,39,65,-26,36
Albion,1541,9,8,6,22,58,82,-24,30
Queen's Park,1541,10,6,10,20,40,75,-35,28
Raith,1542,1,23,8,5,74,32,42,77
Ayr,1542,2,24,4,8,93,43,50,76
Arbroath,1542,3,17,9,10,73,51,22,60
Alloa,1542,4,17,8,11,56,49,7,59
Stranraer,1542,5,16,5,15,58,65,-7,53
Airdrieon,1542,6,11,11,14,46,58,-12,44
East Fife,1542,7,13,3,20,48,67,-19,42
Forfar,1542,8,10,5,21,38,65,-27,35
Albion,1542,9,8,6,22,58,81,-23,30
Queen's Park,1542,10,6,11,19,42,75,-33,29
Raith,1543,1,22,9,5,68,32,36,75
Ayr,1543,2,23,5,8,90,42,48,74
Arbroath,1543,3,18,8,10,77,49,28,62
Alloa,1543,4,17,9,10,56,43,13,60
Stranraer,1543,5,16,5,15,58,64,-6,53
Airdrieon,1543,6,10,12,14,46,59,-13,42
East Fife,1543,7,13,3,20,47,67,-20,42
Forfar,1543,8,10,6,20,39,65,-26,36
Albion,1543,9,8,7,21,57,78,-21,31
Queen's Park,1543,10,6,10,20,40,79,-39,28
Ayr,1544,1,23,5,8,93,45,48,74
Raith,1544,2,22,8,6,69,34,35,74
Alloa,1544,3,18,8,10,58,44,14,62
Arbroath,1544,4,17,8,11,70,50,20,59
Stranraer,1544,5,15,5,16,55,66,-11,50
East Fife,1544,6,14,3,19,49,64,-15,45
Airdrieon,1544,7,11,11,14,47,59,-12,44
Forfar,1544,8,10,5,21,39,66,-27,35
Albion,1544,9,8,7,21,60,81,-21,31
Queen's Park,1544,10,7,10,19,41,72,-31,31
Ayr,1545,1,23,5,8,92,44,48,74
Raith,1545,2,22,8,6,68,34,34,74
Alloa,1545,3,18,8,10,58,43,15,62
Arbroath,1545,4,17,8,11,71,50,21,59
Stranraer,1545,5,15,5,16,57,67,-10,50
East Fife,1545,6,14,3,19,50,66,-16,45
Airdrieon,1545,7,11,11,14,46,58,-12,44
Forfar,1545,8,10,5,21,38,65,-27,35
Albion,1545,9,8,7,21,59,80,-21,31
Queen's Park,1545,10,7,10,19,41,73,-32,31
Raith,1546,1,23,8,5,70,33,37,77
Ayr,1546,2,24,4,8,94,42,52,76
Arbroath,1546,3,17,8,11,72,51,21,59
Alloa,1546,4,17,8,11,57,45,12,59
Stranraer,1546,5,15,5,16,57,68,-11,50
East Fife,1546,6,14,3,19,51,66,-15,45
Airdrieon,1546,7,10,12,14,45,58,-13,42
Forfar,1546,8,10,6,20,38,64,-26,36
Queen's Park,1546,9,7,10,19,42,74,-32,31
Albion,1546,10,8,6,22,57,82,-25,30
Raith,1547,1,23,8,5,71,32,39,77
Ayr,1547,2,24,4,8,94,45,49,76
Arbroath,1547,3,17,9,10,71,49,22,60
Alloa,1547,4,17,8,11,56,46,10,59
Stranraer,1547,5,16,5,15,57,64,-7,53
Airdrieon,1547,6,10,12,14,46,59,-13,42
East Fife,1547,7,13,3,20,47,66,-19,42
Forfar,1547,8,10,6,20,39,65,-26,36
Albion,1547,9,8,6,22,60,82,-22,30
Queen's Park,1547,10,6,11,19,40,73,-33,29
Raith,1548,1,23,8,5,71,33,38,77
Ayr,1548,2,24,4,8,94,44,50,76
Arbroath,1548,3,18,8,10,72,48,24,62
Alloa,1548,4,17,8,11,57,46,11,59
Stranraer,1548,5,15,5,16,56,67,-11,50
East Fife,1548,6,14,3,19,50,65,-15,45
Airdrieon,1548,7,11,11,14,49,58,-9,44
Forfar,1548,8,10,5,21,38,68,-30,35
Albion,1548,9,8,6,22,59,82,-23,30
Queen's Park,1548,10,6,10,20,39,74,-35,28
Ayr,1549,1,24,4,8,93,43,50,76
Raith,1549,2,22,8,6,70,35,35,74
Alloa,1549,3,18,8,10,59,45,14,62
Arbroath,1549,4,17,8,11,70,50,20,59
Stranraer,1549,5,15,6,15,55,64,-9,51
East Fife,1549,6,13,4,19,47,64,-17,43
Airdrieon,1549,7,10,12,14,45,58,-13,42
Forfar,1549,8,10,6,20,38,64,-26,36
Queen's Park,1549,9,7,10,19,41,72,-31,31
Albion,1549,10,8,6,22,58,81,-23,30
Ayr,1550,1,24,4,8,94,42,52,76
Raith,1550,2,22,8,6,68,33,35,74
Alloa,1550,3,18,8,10,57,43,14,62
Arbroath,1550,4,17,8,11,70,50,20,59
Stranraer,1550,5,15,6,15,57,66,-9,51
East Fife,1550,6,13,4,19,49,66,-17,43
Airdrieon,1550,7,10,11,15,45,59,-14,41
Forfar,1550,8,11,5,20,39,64,-25,38
Queen's Park,1550,9,7,10,19,41,72,-31,31
Albion,1550,10,8,6,22,57,82,-25,30
Ayr,1551,1,24,4,8,96,43,53,76
Raith,1551,2,22,8,6,68,34,34,74
Arbroath,1551,3,18,8,10,72,49,23,62
Alloa,1551,4,18,8,10,58,43,15,62
Stranraer,1551,5,15,5,16,55,67,-12,50
East Fife,1551,6,14,3,19,50,64,-14,45
Airdrieon,1551,7,10,12,14,45,58,-13,42
Forfar,1551,8,10,6,20,38,64,-26,36
Albion,1551,9,8,6,22,58,84,-26,30
Queen's Park,1551,10,6,10,20,40,74,-34,28
Ayr,1552,1,24,4,8,95,42,53,76
Raith,1552,2,22,8,6,69,34,35,74
Alloa,1552,3,18,8,10,58,44,14,62
Arbroath,1552,4,17,9,10,70,48,22,60
Stranraer,1552,5,15,5,16,57,69,-12,50
East Fife,1552,6,14,3,19,52,66,-14,45
Airdrieon,1552,7,10,12,14,45,58,-13,42
Forfar,1552,8,10,6,20,38,64,-26,36
Albion,1552,9,8,6,22,57,83,-26,30
Queen's Park,1552,10,6,11,19,39,72,-33,29
Ayr,1553,1,24,4,8,95,42,53,76
Raith,1553,2,22,8,6,70,35,35,74
Arbroath,1553,3,18,8,10,72,49,23,62
Alloa,1553,4,18,8,10,59,45,14,62
Stranraer,1553,5,15,5,16,55,66,-11,50
East Fife,1553,6,14,3,19,49,64,-15,45
Airdrieon,1553,7,11,11,14,49,59,-10,44
Forfar,1553,8,10,5,21,39,68,-29,35
Albion,1553,9,8,6,22,57,83,-26,30
Queen's Park,1553,10,6,10,20,40,74,-34,28
Raith,1554,1,23,8,5,70,32,38,77
Ayr,1554,2,24,4,8,94,43,51,76
Arbroath,1554,3,18,8,10,73,48,25,62
Alloa,1554,4,17,8,11,56,45,11,59
Stranraer,1554,5,15,6,15,56,65,-9,51
East Fife,1554,6,13,4,19,48,65,-17,43
Airdrieon,1554,7,10,12,14,47,60,-13,42
Forfar,1554,8,10,6,20,40,66,-26,36
Albion,1554,9,8,6,22,58,82,-24,30
Queen's Park,1554,10,6,10,20,39,75,-36,28
Ayr,1555,1,24,4,8,95,44,51,76
Raith,1555,2,22,9,5,69,33,36,75
Arbroath,1555,3,18,8,10,72,49,23,62
Alloa,1555,4,17,9,10,57,44,13,60
Stranraer,1555,5,15,5,16,56,67,-11,50
East Fife,1555,6,14,3,19,50,65,-15,45
Airdrieon,1555,7,11,11,14,48,58,-10,44
Forfar,1555,8,10,5,21,38,67,-29,35
Albion,1555,9,8,6,22,59,83,-24,30
Queen's Park,1555,10,6,10,20,40,74,-34,28
Ayr,1556,1,24,4,8,95,44,51,76
Raith,1556,2,22,8,6,69,35,34,74
Arbroath,1556,3,18,8,10,73,49,24,62
Alloa,1556,4,18,8,10,59,44,15,62
Stranraer,1556,5,15,5,16,56,67,-11,50
East Fife,1556,6,14,3,19,50,65,-15,45
Airdrieon,1556,7,11,11,14,46,58,-12,44
Forfar,1556,8,10,5,21,38,65,-27,35
Albion,1556,9,8,6,22,59,83,-24,30
Queen's Park,1556,10,6,10,20,40,75,-35,28
Ayr,1557,1,24,4,8,93,44,49,76
Raith,1557,2,22,9,5,68,32,36,75
Alloa,1557,3,17,9,10,56,43,13,60
Arbroath,1557,4,17,8,11,71,50,21,59
Stranraer,1557,5,15,5,16,55,68,-13,50
East Fife,1557,6,14,3,19,51,64,-13,45
Airdrieon,1557,7,11,11,14,47,58,-11,44
Forfar,1557,8,10,5,21,38,66,-28,35
Queen's Park,1557,9,7,10,19,41,73,-32,31
Albion,1557,10,8,6,22,59,81,-22,30
Raith,1558,1,23,8,5,70,32,38,77
Ayr,1558,2,23,5,8,91,43,48,74
Arbroath,1558,3,17,9,10,71,49,22,60
Alloa,1558,4,17,8,11,56,45,11,59
Stranraer,1558,5,16,5,15,57,65,-8,53
Airdrieon,1558,6,10,12,14,46,59,-13,42
East Fife,1558,7,13,3,20,48,66,-18,42
Forfar,1558,8,10,6,20,39,65,-26,36
Albion,1558,9,8,7,21,58,79,-21,31
Queen's Park,1558,10,6,11,19,40,73,-33,29
Raith,1559,1,23,8,5,69,32,37,77
Ayr,1559,2,24,4,8,92,42,50,76
Arbroath,1559,3,18,8,10,72,49,23,62
Alloa,1559,4,17,8,11,56,44,12,59
Stranraer,1559,5,16,5,15,58,66,-8,53
East Fife,1559,6,13,3,20,49,67,-18,42
Airdrieon,1559,7,10,11,15,47,61,-14,41
Forfar,1559,8,11,5,20,41,66,-25,38
Albion,1559,9,8,6,22,57,80,-23,30
Queen's Park,1559,10,6,10,20,40,74,-34,28
Raith,1560,1,23,8,5,70,32,38,77
Ayr,1560,2,24,4,8,93,44,49,76
Arbroath,1560,3,18,8,10,73,48,25,62
Alloa,1560,4,17,8,11,56,45,11,59
Stranraer,1560,5,15,6,15,56,65,-9,51
East Fife,1560,6,13,4,19,48,65,-17,43
Airdrieon,1560,7,10,12,14,47,60,-13,42
Forfar,1560,8,10,6,20,40,66,-26,36
Albion,1560,9,8,6,22,59,81,-22,30
Queen's Park,1560,10,6,10,20,39,75,-36,28
Raith,1561,1,23,8,5,71,32,39,77
Ayr,1561,2,24,4,8,94,43,51,76
Arbroath,1561,3,18,8,10,73,48,25,62
Alloa,1561,4,17,8,11,56,46,10,59
Stranraer,1561,5,15,6,15,55,64,-9,51
Airdrieon,1561,6,11,11,14,47,58,-11,44
East Fife,1561,7,13,4,19,47,64,-17,43
Forfar,1561,8,10,5,21,38,66,-28,35
Albion,1561,9,8,6,22,58,82,-24,30
Queen's Park,1561,10,6,10,20,39,75,-36,28
Raith,1562,1,23,8,5,71,34,37,77
Ayr,1562,2,24,4,8,93,44,49,76
Arbroath,1562,3,17,8,11,70,49,21,59
Alloa,1562,4,17,8,11,58,46,12,59
Stranraer,1562,5,15,6,15,56,65,-9,51
Airdrieon,1562,6,11,11,14,47,58,-11,44
East Fife,1562,7,13,4,19,48,65,-17,43
Forfar,1562,8,10,5,21,38,66,-28,35
Queen's Park,1562,9,7,10,19,40,72,-32,31
Albion,1562,10,8,6,22,59,81,-22,30
Ayr,1563,1,24,4,8,95,42,53,76
Raith,1563,2,22,8,6,68,33,35,74
Alloa,1563,3,18,8,10,57,43,14,62
Arbroath,1563,4,17,8,11,70,49,21,59
Stranraer,1563,5,16,5,15,56,64,-8,53
Airdrieon,1563,6,10,12,14,46,59,-13,42
East Fife,1563,7,13,3,20,47,65,-18,42
Forfar,1563,8,10,6,20,39,65,-26,36
Queen's Park,1563,9,7,10,19,40,72,-32,31
Albion,1563,10,8,6,22,57,83,-26,30
Raith,1564,1,22,9,5,68,32,36,75
Ayr,1564,2,23,5,8,91,43,48,74
Arbroath,1564,3,18,8,10,71,48,23,62
Alloa,1564,4,17,9,10,56,43,13,60
Stranraer,1564,5,15,6,15,55,64,-9,51
Airdrieon,1564,6,11,11,14,46,58,-12,44
East Fife,1564,7,13,4,19,47,64,-17,43
Forfar,1564,8,10,5,21,38,65,-27,35
Albion,1564,9,8,7,21,58,79,-21,31
Queen's Park,1564,10,6,10,20,39,73,-34,28
Raith,1565,1,22,9,5,68,32,36,75
Ayr,1565,2,23,5,8,92,44,48,74
Arbroath,1565,3,18,8,10,74,48,26,62
Alloa,1565,4,17,9,10,56,43,13,60
Stranraer,1565,5,15,6,15,56,65,-9,51
Airdrieon,1565,6,11,11,14,48,59,-11,44
East Fife,1565,7,13,4,19,48,65,-17,43
Forfar,1565,8,10,5,21,39,67,-28,35
Albion,1565,9,8,7,21,59,80,-21,31
Queen's Park,1565,10,6,10,20,39,76,-37,28
Ayr,1566,1,24,4,8,94,44,50,76
Raith,1566,2,22,8,6,68,34,34,74
Arbroath,1566,3,18,8,10,71,48,23,62
Alloa,1566,4,18,8,10,58,43,15,62
Stranraer,1566,5,15,6,15,56,65,-9,51
Airdrieon,1566,6,11,11,14,47,59,-12,44
East Fife,1566,7,13,4,19,48,65,-17,43
Forfar,1566,8,10,5,21,39,66,-27,35
Albion,1566,9,8,6,22,59,82,-23,30
Queen's Park,1566,10,6,10,20,39,73,-34,28
Ayr,1567,1,24,4,8,92,43,49,76
Raith,1567,2,22,9,5,69,33,36,75
Alloa,1567,3,17,9,10,57,44,13,60
Arbroath,1567,4,17,8,11,70,51,19,59
Stranraer,1567,5,16,5,15,59,65,-6,53
Airdrieon,1567,6,11,11,14,48,58,-10,44
East Fife,1567,7,13,3,20,48,68,-20,42
Forfar,1567,8,10,5,21,38,67,-29,35
Queen's Park,1567,9,7,10,19,42,72,-30,31
Albion,1567,10,8,6,22,58,80,-22,30
Ayr,1568,1,24,4,8,94,42,52,76
Raith,1568,2,22,9,5,70,34,36,75
Arbroath,1568,3,17,9,10,72,50,22,60
Alloa,1568,4,17,9,10,58,45,13,60
Stranraer,1568,5,16,5,15,59,65,-6,53
Airdrieon,1568,6,11,11,14,48,58,-10,44
East Fife,1568,7,13,3,20,48,68,-20,42
Forfar,1568,8,10,5,21,38,67,-29,35
Albion,1568,9,8,6,22,57,82,-25,30
Queen's Park,1568,10,6,11,19,41,74,-33,29
Raith,1569,1,23,8,5,69,32,37,77
Ayr,1569,2,23,4,9,90,44,46,73
Arbroath,1569,3,18,8,10,72,48,24,62
Alloa,1569,4,17,8,11,56,44,12,59
Stranraer,1569,5,15,6,15,58,67,-9,51
East Fife,1569,6,13,4,19,50,67,-17,43
Airdrieon,1569,7,10,11,15,45,60,-15,41
Forfar,1569,8,11,5,20,40,64,-24,38
Albion,1569,9,9,6,21,59,78,-19,33
Queen's Park,1569,10,6,10,20,39,74,-35,28
Raith,1570,1,23,8,5,71,33,38,77
Ayr,1570,2,24,4,8,92,42,50,76
Arbroath,1570,3,18,8,10,74,49,25,62
Alloa,1570,4,17,8,11,57,46,11,59
Stranraer,1570,5,16,5,15,56,64,-8,53
East Fife,1570,6,13,3,20,47,65,-18,42
Airdrieon,1570,7,10,11,15,45,59,-14,41
Forfar,1570,8,11,5,20,39,64,-25,38
Albion,1570,9,8,6,22,57,80,-23,30
Queen's Park,1570,10,6,10,20,40,76,-36,28
Raith,1571,1,23,8,5,71,33,38,77
Ayr,1571,2,24,4,8,93,43,50,76
Arbroath,1571,3,18,8,10,74,50,24,62
Alloa,1571,4,17,8,11,57,46,11,59
Stranraer,1571,5,15,5,16,56,67,-11,50
East Fife,1571,6,14,3,19,50,65,-15,45
Airdrieon,1571,7,10,12,14,46,59,-13,42
Forfar,1571,8,10,6,20,39,65,-26,36
Albion,1571,9,8,6,22,58,81,-23,30
Queen's Park,1571,10,6,10,20,41,76,-35,28
Ayr,1572,1,24,4,8,92,43,49,76
Raith,1572,2,22,9,5,69,33,36,75
Arbroath,1572,3,18,8,10,71,48,23,62
Alloa,1572,4,17,9,10,57,44,13,60
Stranraer,1572,5,15,5,16,56,68,-12,50
East Fife,1572,6,14,3,19,51,65,-14,45
Airdrieon,1572,7,10,11,15,47,62,-15,41
Forfar,1572,8,11,5,20,42,66,-24,38
Albion,1572,9,8,6,22,58,80,-22,30
Queen's Park,1572,10,6,10,20,39,73,-34,28
Raith,1573,1,23,8,5,69,32,37,77
Ayr,1573,2,24,4,8,94,45,49,76
Arbroath,1573,3,17,8,11,70,50,20,59
Alloa,1573,4,17,8,11,56,44,12,59
Stranraer,1573,5,16,5,15,57,64,-7,53
East Fife,1573,6,13,3,20,47,66,-19,42
Airdrieon,1573,7,10,11,15,46,60,-14,41
Forfar,1573,8,11,5,20,40,65,-25,38
Queen's Park,1573,9,7,10,19,41,72,-31,31
Albion,1573,10,8,6,22,60,82,-22,30
Raith,1574,1,23,8,5,72,32,40,77
Ayr,1574,2,23,5,8,93,45,48,74
Arbroath,1574,3,17,8,11,70,49,21,59
Alloa,1574,4,17,8,11,56,47,9,59
Stranraer,1574,5,15,6,15,55,64,-9,51
Airdrieon,1574,6,11,11,14,48,60,-12,44
East Fife,1574,7,13,4,19,47,64,-17,43
Forfar,1574,8,10,5,21,40,67,-27,35
Albion,1574,9,8,7,21,60,81,-21,31
Queen's Park,1574,10,7,10,19,40,72,-32,31
Raith,1575,1,23,8,5,71,32,39,77
Ayr,1575,2,23,5,8,92,44,48,74
Arbroath,1575,3,17,8,11,70,49,21,59
Alloa,1575,4,17,8,11,56,46,10,59
Stranraer,1575,5,15,6,15,56,65,-9,51
East Fife,1575,6,13,4,19,48,65,-17,43
Airdrieon,1575,7,10,12,14,46,59,-13,42
Forfar,1575,8,10,6,20,39,65,-26,36
Albion,1575,9,8,7,21,59,80,-21,31
Queen's Park,1575,10,7,10,19,40,72,-32,31
Raith,1576,1,23,8,5,71,34,37,77
Ayr,1576,2,24,4,8,92,42,50,76
Arbroath,1576,3,18,8,10,74,50,24,62
Alloa,1576,4,17,8,11,58,46,12,59
Stranraer,1576,5,15,5,16,55,65,-10,50
East Fife,1576,6,14,3,19,48,64,-16,45
Airdrieon,1576,7,11,11,14,49,58,-9,44
Forfar,1576,8,10,5,21,38,68,-30,35
Albion,1576,9,8,6,22,57,80,-23,30
Queen's Park,1576,10,6,10,20,41,76,-35,28
Raith,1577,1,23,8,5,70,32,38,77
Ayr,1577,2,24,4,8,94,43,51,76
Arbroath,1577,3,18,8,10,72,49,23,62
Alloa,1577,4,17,8,11,56,45,11,59
Stranraer,1577,5,15,6,15,55,64,-9,51
Airdrieon,1577,6,11,11,14,47,58,-11,44
East Fife,1577,7,13,4,19,47,64,-17,43
Forfar,1577,8,10,5,21,38,66,-28,35
Albion,1577,9,8,6,22,58,82,-24,30
Queen's Park,1577,10,6,10,20,40,74,-34,28
Raith,1578,1,22,8,6,69,35,34,74
Ayr,1578,2,23,4,9,91,44,47,73
Alloa,1578,3,18,8,10,59,44,15,62
Arbroath,1578,4,17,8,11,70,50,20,59
Stranraer,1578,5,15,5,16,56,68,-12,50
East Fife,1578,6,14,3,19,51,65,-14,45
Airdrieon,1578,7,11,11,14,49,58,-9,44
Forfar,1578,8,10,5,21,38,68,-30,35
Albion,1578,9,9,6,21,59,79,-20,33
Queen's Park,1578,10,7,10,19,41,72,-31,31
Ayr,1579,1,24,4,8,95,42,53,76
Raith,1579,2,22,9,5,69,33,36,75
Arbroath,1579,3,18,8,10,73,49,24,62
Alloa,1579,4,17,9,10,57,44,13,60
Stranraer,1579,5,15,5,16,57,67,-10,50
East Fife,1579,6,14,3,19,50,66,-16,45
Airdrieon,1579,7,10,11,15,46,61,-15,41
Forfar,1579,8,11,5,20,41,65,-24,38
Albion,1579,9,8,6,22,57,83,-26,30
Queen's Park,1579,10,6,10,20,40,75,-35,28
Raith,1580,1,23,8,5,75,34,41,77
Ayr,1580,2,24,4,8,94,45,49,76
Arbroath,1580,3,17,8,11,71,50,21,59
Alloa,1580,4,17,8,11,58,50,8,59
Stranraer,1580,5,15,5,16,55,65,-10,50
East Fife,1580,6,14,3,19,48,64,-16,45
Airdrieon,1580,7,11,11,14,46,58,-12,44
Forfar,1580,8,10,5,21,38,65,-27,35
Queen's Park,1580,9,7,10,19,41,73,-32,31
Albion,1580,10,8,6,22,60,82,-22,30
Raith,1581,1,23,8,5,70,33,37,77
Ayr,1581,2,24,4,8,95,45,50,76
Arbroath,1581,3,18,8,10,75,51,24,62
Alloa,1581,4,17,8,11,57,45,12,59
Stranraer,1581,5,16,5,15,58,66,-8,53
Airdrieon,1581,6,11,11,14,48,58,-10,44
East Fife,1581,7,13,3,20,49,67,-18,42
Forfar,1581,8,10,5,21,38,67,-29,35
Albion,1581,9,8,6,22,60,83,-23,30
Queen's Park,1581,10,6,10,20,42,77,-35,28
Raith,1582,1,23,8,5,72,32,40,77
Ayr,1582,2,24,4,8,92,42,50,76
Arbroath,1582,3,18,8,10,72,48,24,62
Alloa,1582,4,17,8,11,56,47,9,59
Stranraer,1582,5,15,5,16,57,68,-11,50
East Fife,1582,6,14,3,19,51,66,-15,45
Airdrieon,1582,7,11,11,14,47,58,-11,44
Forfar,1582,8,10,5,21,38,66,-28,35
Albion,1582,9,8,6,22,57,80,-23,30
Queen's Park,1582,10,6,10,20,39,74,-35,28
Ayr,1583,1,24,4,8,93,42,51,76
Raith,1583,2,22,9,5,69,33,36,75
Arbroath,1583,3,18,8,10,74,51,23,62
Alloa,1583,4,17,9,10,57,44,13,60
Stranraer,1583,5,15,5,16,57,67,-10,50
East Fife,1583,6,14,3,19,50,66,-16,45
Airdrieon,1583,7,10,12,14,47,60,-13,42
Forfar,1583,8,10,6,20,40,66,-26,36
Albion,1583,9,8,6,22,57,81,-24,30
Queen's Park,1583,10,6,10,20,42,76,-34,28
Raith,1584,1,23,8,5,72,34,38,77
Ayr,1584,2,24,4,8,93,42,51,76
Arbroath,1584,3,17,8,11,71,50,21,59
Alloa,1584,4,17,8,11,58,47,11,59
Stranraer,1584,5,15,5,16,55,68,-13,50
East Fife,1584,6,14,3,19,51,64,-13,45
Airdrieon,1584,7,11,11,14,47,59,-12,44
Forfar,1584,8,10,5,21,39,66,-27,35
Queen's Park,1584,9,7,10,19,41,73,-32,31
Albion,1584,10,8,6,22,57,81,-24,30
Raith,1585,1,23,8,5,70,32,38,77
Ayr,1585,2,24,4,8,94,44,50,76
Arbroath,1585,3,18,8,10,73,49,24,62
Alloa,1585,4,17,8,11,56,45,11,59
Stranraer,1585,5,15,5,16,56,66,-10,50
East Fife,1585,6,14,3,19,49,65,-16,45
Airdrieon,1585,7,10,11,15,45,59,-14,41
Forfar,1585,8,11,5,20,39,64,-25,38
Albion,1585,9,8,6,22,59,82,-23,30
Queen's Park,1585,10,6,10,20,40,75,-35,28
Ayr,1586,1,24,4,8,97,43,54,76
Raith,1586,2,22,9,5,68,32,36,75
Arbroath,1586,3,18,8,10,73,49,24,62
Alloa,1586,4,17,9,10,56,43,13,60
Stranraer,1586,5,15,5,16,58,68,-10,50
East Fife,1586,6,14,3,19,51,67,-16,45
Airdrieon,1586,7,11,11,14,47,58,-11,44
Forfar,1586,8,10,5,21,38,66,-28,35
Albion,1586,9,8,6,22,58,85,-27,30
Queen's Park,1586,10,6,10,20,40,75,-35,28
Raith,1587,1,23,8,5,71,34,37,77
Ayr,1587,2,24,4,8,98,44,54,76
Arbroath,1587,3,18,8,10,71,48,23,62
Alloa,1587,4,17,8,11,58,46,12,59
Stranraer,1587,5,15,6,15,57,66,-9,51
East Fife,1587,6,13,4,19,49,66,-17,43
Airdrieon,1587,7,10,11,15,46,60,-14,41
Forfar,1587,8,11,5,20,40,65,-25,38
Albion,1587,9,8,6,22,59,86,-27,30
Queen's Park,1587,10,6,10,20,39,73,-34,28
Ayr,1588,1,24,4,8,94,44,50,76
Raith,1588,2,22,9,5,69,33,36,75
Arbroath,1588,3,18,8,10,72,49,23,62
Alloa,1588,4,17,9,10,57,44,13,60
Stranraer,1588,5,15,5,16,56,66,-10,50
East Fife,1588,6,14,3,19,49,65,-16,45
Airdrieon,1588,7,11,11,14,49,59,-10,44
Forfar,1588,8,10,5,21,39,68,-29,35
Albion,1588,9,8,6,22,59,82,-23,30
Queen's Park,1588,10,6,10,20,40,74,-34,28
Raith,1589,1,23,8,5,71,34,37,77
Ayr,1589,2,24,4,8,95,42,53,76
Arbroath,1589,3,18,8,10,74,49,25,62
Alloa,1589,4,17,8,11,58,46,12,59
Stranraer,1589,5,15,5,16,56,67,-11,50
East Fife,1589,6,14,3,19,50,65,-15,45
Airdrieon,1589,7,10,11,15,47,62,-15,41
Forfar,1589,8,11,5,20,42,66,-24,38
Albion,1589,9,8,6,22,57,83,-26,30
Queen's Park,1589,10,6,10,20,40,76,-36,28
Ayr,1590,1,24,4,8,93,44,49,76
Raith,1590,2,22,9,5,69,33,36,75
Arbroath,1590,3,18,8,10,73,49,24,62
Alloa,1590,4,17,9,10,57,44,13,60
Stranraer,1590,5,15,5,16,57,67,-10,50
East Fife,1590,6,14,3,19,50,66,-16,45
Airdrieon,1590,7,10,12,14,46,59,-13,42
Forfar,1590,8,10,6,20,39,65,-26,36
Albion,1590,9,8,6,22,59,81,-22,30
Queen's Park,1590,10,6,10,20,40,75,-35,28
Raith,1591,1,23,8,5,70,33,37,77
Ayr,1591,2,24,4,8,95,44,51,76
Arbroath,1591,3,17,8,11,70,49,21,59
Alloa,1591,4,17,8,11,57,45,12,59
Stranraer,1591,5,16,5,15,57,64,-7,53
East Fife,1591,6,13,3,20,47,66,-19,42
Airdrieon,1591,7,10,11,15,45,60,-15,41
Forfar,1591,8,11,5,20,40,64,-24,38
Queen's Park,1591,9,7,10,19,40,72,-32,31
Albion,1591,10,8,6,22,59,83,-24,30
Ayr,1592,1,24,4,8,93,44,49,76
Raith,1592,2,22,8,6,70,36,34,74
Alloa,1592,3,18,8,10,60,45,15,62
Arbroath,1592,4,17,8,11,71,50,21,59
Stranraer,1592,5,15,5,16,55,67,-12,50
East Fife,1592,6,14,3,19,50,64,-14,45
Airdrieon,1592,7,11,11,14,47,59,-12,44
Forfar,1592,8,10,5,21,39,66,-27,35
Queen's Park,1592,9,7,10,19,41,73,-32,31
Albion,1592,10,8,6,22,59,81,-22,30
Raith,1593,1,23,8,5,69,32,37,77
Ayr,1593,2,23,5,8,91,43,48,74
Arbroath,1593,3,17,9,10,72,50,22,60
Alloa,1593,4,17,8,11,56,44,12,59
Stranraer,1593,5,15,5,16,58,68,-10,50
East Fife,1593,6,14,3,19,51,67,-16,45
Airdrieon,1593,7,11,11,14,47,59,-12,44
Forfar,1593,8,10,5,21,39,66,-27,35
Albion,1593,9,8,7,21,58,79,-21,31
Queen's Park,1593,10,6,11,19,41,74,-33,29
Raith,1594,1,23,8,5,71,34,37,77
Ayr,1594,2,23,5,8,90,42,48,74
Arbroath,1594,3,17,9,10,72,50,22,60
Alloa,1594,4,17,8,11,58,46,12,59
Stranraer,1594,5,15,5,16,56,67,-11,50
East Fife,1594,6,14,3,19,50,65,-15,45
Airdrieon,1594,7,10,11,15,47,61,-14,41
Forfar,1594,8,11,5,20,41,66,-25,38
Albion,1594,9,8,7,21,57,78,-21,31
Queen's Park,1594,10,6,11,19,41,74,-33,29
Raith,1595,1,23,8,5,70,32,38,77
Ayr,1595,2,24,4,8,92,43,49,76
Arbroath,1595,3,17,9,10,73,51,22,60
Alloa,1595,4,17,8,11,56,45,11,59
Stranraer,1595,5,16,5,15,59,67,-8,53
East Fife,1595,6,13,3,20,50,68,-18,42
Airdrieon,1595,7,10,11,15,46,60,-14,41
Forfar,1595,8,11,5,20,40,65,-25,38
Albion,1595,9,8,6,22,58,80,-22,30
Queen's Park,1595,10,6,11,19,42,75,-33,29
Raith,1596,1,22,9,5,69,33,36,75
Ayr,1596,2,23,4,9,91,45,46,73
Arbroath,1596,3,18,8,10,72,49,23,62
Alloa,1596,4,17,9,10,57,44,13,60
Stranraer,1596,5,16,5,15,58,65,-7,53
Airdrieon,1596,6,11,11,14,49,58,-9,44
East Fife,1596,7,13,3,20,48,67,-19,42
Forfar,1596,8,10,5,21,38,68,-30,35
Albion,1596,9,9,6,21,60,79,-19,33
Queen's Park,1596,10,6,10,20,40,74,-34,28
Raith,1597,1,22,9,5,68,32,36,75
Ayr,1597,2,23,5,8,90,42,48,74
Arbroath,1597,3,17,9,10,74,52,22,60
Alloa,1597,4,17,9,10,56,43,13,60
Stranraer,1597,5,16,5,15,59,64,-5,53
Airdrieon,1597,6,10,12,14,46,59,-13,42
East Fife,1597,7,13,3,20,47,68,-21,42
Forfar,1597,8,10,6,20,39,65,-26,36
Albion,1597,9,8,7,21,57,78,-21,31
Queen's Park,1597,10,6,11,19,43,76,-33,29
Raith,1598,1,23,8,5,69,32,37,77
Ayr,1598,2,24,4,8,96,43,53,76
Arbroath,1598,3,17,9,10,72,50,22,60
Alloa,1598,4,17,8,11,56,44,12,59
Stranraer,1598,5,15,6,15,56,65,-9,51
East Fife,1598,6,13,4,19,48,65,-17,43
Airdrieon,1598,7,10,11,15,46,60,-14,41
Forfar,1598,8,11,5,20,40,65,-25,38
Albion,1598,9,8,6,22,58,84,-26,30
Queen's Park,1598,10,6,11,19,41,74,-33,29
Raith,1599,1,23,8,5,69,32,37,77
Ayr,1599,2,24,4,8,92,43,49,76
Arbroath,1599,3,17,8,11,71,50,21,59
Alloa,1599,4,17,8,11,56,44,12,59
Stranraer,1599,5,15,5,16,55,66,-11,50
East Fife,1599,6,14,3,19,49,64,-15,45
Airdrieon,1599,7,11,11,14,47,59,-12,44
Forfar,1599,8,10,5,21,39,66,-27,35
Queen's Park,1599,9,7,10,19,41,73,-32,31
Albion,1599,10,8,6,22,58,80,-22,30
Raith,1600,1,23,8,5,72,34,38,77
Ayr,1600,2,24,4,8,92,42,50,76
Arbroath,1600,3,18,8,10,75,51,24,62
Alloa,1600,4,17,8,11,58,47,11,59
Stranraer,1600,5,16,5,15,57,65,-8,53
Airdrieon,1600,6,10,12,14,47,60,-13,42
East Fife,1600,7,13,3,20,48,66,-18,42
Forfar,1600,8,10,6,20,40,66,-26,36
Albion,1600,9,8,6,22,57,80,-23,30
Queen's Park,1600,10,6,10,20,42,77,-35,28
Raith,1601,1,22,9,5,69,33,36,75
Ayr,1601,2,23,5,8,91,43,48,74
Arbroath,1601,3,17,9,10,72,50,22,60
Alloa,1601,4,17,9,10,57,44,13,60
Stranraer,1601,5,15,6,15,56,65,-9,51
Airdrieon,1601,6,11,11,14,49,59,-10,44
East Fife,1601,7,13,4,19,48,65,-17,43
Forfar,1601,8,10,5,21,39,68,-29,35
Albion,1601,9,8,7,21,58,79,-21,31
Queen's Park,1601,10,6,11,19,41,74,-33,29
Raith,1602,1,23,8,5,70,33,37,77
Ayr,1602,2,24,4,8,93,42,51,76
Arbroath,1602,3,17,9,10,72,50,22,60
Alloa,1602,4,17,8,11,57,45,12,59
Stranraer,1602,5,15,5,16,55,66,-11,50
East Fife,1602,6,14,3,19,49,64,-15,45
Airdrieon,1602,7,10,11,15,46,61,-15,41
Forfar,1602,8,11,5,20,41,65,-24,38
Albion,1602,9,8,6,22,57,81,-24,30
Queen's Park,1602,10,6,11,19,41,74,-33,29
Raith,1603,1,23,8,5,71,33,38,77
Ayr,1603,2,24,4,8,97,42,55,76
Arbroath,1603,3,17,8,11,71,51,20,59
Alloa,1603,4,17,8,11,57,46,11,59
Stranraer,1603,5,15,5,16,56,69,-13,50
East Fife,1603,6,14,3,19,52,65,-13,45
Airdrieon,1603,7,10,12,14,46,59,-13,42
Forfar,1603,8,10,6,20,39,65,-26,36
Queen's Park,1603,9,7,10,19,42,73,-31,31
Albion,1603,10,8,6,22,57,85,-28,30
Raith,1604,1,22,9,5,70,34,36,75
Ayr,1604,2,23,4,9,92,45,47,73
Arbroath,1604,3,18,8,10,74,49,25,62
Alloa,1604,4,17,9,10,58,45,13,60
Stranraer,1604,5,16,5,15,57,65,-8,53
Airdrieon,1604,6,10,12,14,47,60,-13,42
East Fife,1604,7,13,3,20,48,66,-18,42
Forfar,1604,8,10,6,20,40,66,-26,36
Albion,1604,9,9,6,21,60,80,-20,33
Queen's Park,1604,10,6,10,20,40,76,-36,28
Ayr,1605,1,24,4,8,92,42,50,76
Raith,1605,2,22,9,5,70,34,36,75
Alloa,1605,3,17,9,10,58,45,13,60
Arbroath,1605,4,17,8,11,70,49,21,59
Stranraer,1605,5,15,5,16,55,67,-12,50
East Fife,1605,6,14,3,19,50,64,-14,45
Airdrieon,1605,7,10,12,14,45,58,-13,42
Forfar,1605,8,10,6,20,38,64,-26,36
Queen's Park,1605,9,7,10,19,40,72,-32,31
Albion,1605,10,8,6,22,57,80,-23,30
Raith,1606,1,22,8,6,69,34,35,74
Ayr,1606,2,23,4,9,91,44,47,73
Arbroath,1606,3,18,8,10,74,51,23,62
Alloa,1606,4,18,8,10,58,44,14,62
Stranraer,1606,5,15,6,15,57,66,-9,51
Airdrieon,1606,6,11,11,14,47,59,-12,44
East Fife,1606,7,13,4,19,49,66,-17,43
Forfar,1606,8,10,5,21,39,66,-27,35
Albion,1606,9,9,6,21,59,79,-20,33
Queen's Park,1606,10,6,10,20,42,76,-34,28
Ayr,1607,1,24,4,8,95,43,52,76
Raith,1607,2,22,8,6,68,33,35,74
Arbroath,1607,3,18,8,10,74,49,25,62
Alloa,1607,4,18,8,10,57,43,14,62
Stranraer,1607,5,16,5,15,57,65,-8,53
Airdrieon,1607,6,11,11,14,48,58,-10,44
East Fife,1607,7,13,3,20,48,66,-18,42
Forfar,1607,8,10,5,21,38,67,-29,35
Albion,1607,9,8,6,22,58,83,-25,30
Queen's Park,1607,10,6,10,20,40,76,-36,28
Raith,1608,1,23,8,5,70,33,37,77
Ayr,1608,2,23,5,8,92,44,48,74
Arbroath,1608,3,17,8,11,72,51,21,59
Alloa,1608,4,17,8,11,57,45,12,59
Stranraer,1608,5,15,5,16,57,67,-10,50
East Fife,1608,6,14,3,19,50,66,-16,45
Airdrieon,1608,7,11,11,14,48,59,-11,44
Forfar,1608,8,10,5,21,39,67,-28,35
Albion,1608,9,8,7,21,59,80,-21,31
Queen's Park,1608,10,7,10,19,42,74,-32,31
Ayr,1609,1,24,4,8,93,43,50,76
Raith,1609,2,22,9,5,69,33,36,75
Arbroath,1609,3,18,8,10,73,50,23,62
Alloa,1609,4,17,9,10,57,44,13,60
Stranraer,1609,5,16,5,15,56,64,-8,53
Airdrieon,1609,6,11,11,14,47,59,-12,44
East Fife,1609,7,13,3,20,47,65,-18,42
Forfar,1609,8,10,5,21,39,66,-27,35
Albion,1609,9,8,6,22,58,81,-23,30
Queen's Park,1609,10,6,10,20,41,75,-34,28
Raith,1610,1,23,8,5,71,32,39,77
Ayr,1610,2,24,4,8,93,43,50,76
Arbroath,1610,3,18,8,10,73,49,24,62
Alloa,1610,4,17,8,11,56,46,10,59
Stranraer,1610,5,15,5,16,56,66,-10,50
East Fife,1610,6,14,3,19,49,65,-16,45
Airdrieon,1610,7,10,12,14,47,60,-13,42
Forfar,1610,8,10,6,20,40,66,-26,36
Albion,1610,9,8,6,22,58,81,-23,30
Queen's Park,1610,10,6,10,20,40,75,-35,28
Ayr,1611,1,24,4,8,92,43,49,76
Raith,1611,2,22,9,5,68,32,36,75
Arbroath,1611,3,18,8,10,71,48,23,62
Alloa,1611,4,17,9,10,56,43,13,60
Stranraer,1611,5,15,5,16,56,66,-10,50
East Fife,1611,6,14,3,19,49,65,-16,45
Airdrieon,1611,7,10,12,14,45,58,-13,42
Forfar,1611,8,10,6,20,38,64,-26,36
Albion,1611,9,8,6,22,58,80,-22,30
Queen's Park,1611,10,6,10,20,39,73,-34,28
Raith,1612,1,23,8,5,70,32,38,77
Ayr,1612,2,23,4,9,91,44,47,73
Arbroath,1612,3,17,9,10,70,48,22,60
Alloa,1612,4,17,8,11,56,45,11,59
Stranraer,1612,5,15,5,16,55,66,-11,50
East Fife,1612,6,14,3,19,49,64,-15,45
Airdrieon,1612,7,11,11,14,48,59,-11,44
Forfar,1612,8,10,5,21,39,67,-28,35
Albion,1612,9,9,6,21,59,79,-20,33
Queen's Park,1612,10,6,11,19,39,72,-33,29
Raith,1613,1,23,8,5,71,33,38,77
Ayr,1613,2,24,4,8,94,44,50,76
Arbroath,1613,3,17,9,10,71,49,22,60
Alloa,1613,4,17,8,11,57,46,11,59
Stranraer,1613,5,15,6,15,55,64,-9,51
Airdrieon,1613,6,11,11,14,48,58,-10,44
East Fife,1613,7,13,4,19,47,64,-17,43
Forfar,1613,8,10,5,21,38,67,-29,35
Albion,1613,9,8,6,22,59,82,-23,30
Queen's Park,1613,10,6,11,19,40,73,-33,29
Ayr,1614,1,24,4,8,94,43,51,76
Raith,1614,2,22,8,6,69,35,34,74
Alloa,1614,3,18,8,10,59,44,15,62
Arbroath,1614,4,17,8,11,71,50,21,59
Stranraer,1614,5,15,5,16,55,67,-12,50
East Fife,1614,6,14,3,19,50,64,-14,45
Airdrieon,1614,7,11,11,14,46,58,-12,44
Forfar,1614,8,10,5,21,38,65,-27,35
Queen's Park,1614,9,7,10,19,41,73,-32,31
Albion,1614,10,8,6,22,58,82,-24,30
Raith,1615,1,23,8,5,71,33,38,77
Ayr,1615,2,24,4,8,97,44,53,76
Arbroath,1615,3,17,8,11,70,52,18,59
Alloa,1615,4,17,8,11,57,46,11,59
Stranraer,1615,5,15,5,16,56,67,-11,50
East Fife,1615,6,14,3,19,50,65,-15,45
Airdrieon,1615,7,10,12,14,45,58,-13,42
Forfar,1615,8,10,6,20,38,64,-26,36
Queen's Park,1615,9,7,10,19,43,72,-29,31
Albion,1615,10,8,6,22,59,85,-26,30
Raith,1616,1,23,8,5,70,32,38,77
Ayr,1616,2,24,4,8,99,44,55,76
Arbroath,1616,3,17,8,11,71,53,18,59
Alloa,1616,4,17,8,11,56,45,11,59
Stranraer,1616,5,16,5,15,57,64,-7,53
Airdrieon,1616,6,11,11,14,47,58,-11,44
East Fife,1616,7,13,3,20,47,66,-19,42
Forfar,1616,8,10,5,21,38,66,-28,35
Queen's Park,1616,9,7,10,19,44,73,-29,31
Albion,1616,10,8,6,22,59,87,-28,30
Ayr,1617,1,24,4,8,94,42,52,76
Raith,1617,2,22,8,6,69,34,35,74
Alloa,1617,3,18,8,10,58,44,14,62
Arbroath,1617,4,17,9,10,72,50,22,60
Stranraer,1617,5,16,5,15,57,64,-7,53
Airdrieon,1617,6,11,11,14,47,59,-12,44
East Fife,1617,7,13,3,20,47,66,-19,42
Forfar,1617,8,10,5,21,39,66,-27,35
Albion,1617,9,8,6,22,57,82,-25,30
Queen's Park,1617,10,6,11,19,41,74,-33,29
Ayr,1618,1,24,4,8,93,43,50,76
Raith,1618,2,22,8,6,69,34,35,74
Arbroath,1618,3,18,8,10,76,49,27,62
Alloa,1618,4,18,8,10,58,44,14,62
Stranraer,1618,5,15,5,16,55,67,-12,50
East Fife,1618,6,14,3,19,50,64,-14,45
Airdrieon,1618,7,11,11,14,48,59,-11,44
Forfar,1618,8,10,5,21,39,67,-28,35
Albion,1618,9,8,6,22,58,81,-23,30
Queen's Park,1618,10,6,10,20,40,78,-38,28
Ayr,1619,1,24,4,8,92,43,49,76
Raith,1619,2,22,8,6,68,33,35,74
Alloa,1619,3,18,8,10,57,43,14,62
Arbroath,1619,4,17,8,11,71,50,21,59
Stranraer,1619,5,15,5,16,55,69,-14,50
East Fife,1619,6,14,3,19,52,64,-12,45
Airdrieon,1619,7,11,11,14,48,59,-11,44
Forfar,1619,8,10,5,21,39,67,-28,35
Queen's Park,1619,9,7,10,19,41,73,-32,31
Albion,1619,10,8,6,22,58,80,-22,30
Raith,1620,1,23,8,5,69,32,37,77
Ayr,1620,2,24,4,8,97,42,55,76
Arbroath,1620,3,17,9,10,71,49,22,60
Alloa,1620,4,17,8,11,56,44,12,59
Stranraer,1620,5,16,5,15,58,65,-7,53
Airdrieon,1620,6,10,12,14,45,58,-13,42
East Fife,1620,7,13,3,20,48,67,-19,42
Forfar,1620,8,10,6,20,38,64,-26,36
Albion,1620,9,8,6,22,57,85,-28,30
Queen's Park,1620,10,6,11,19,40,73,-33,29
Raith,1621,1,23,8,5,71,32,39,77
Ayr,1621,2,24,4,8,93,42,51,76
Arbroath,1621,3,17,8,11,70,51,19,59
Alloa,1621,4,17,8,11,56,46,10,59
Stranraer,1621,5,16,5,15,58,66,-8,53
Airdrieon,1621,6,10,12,14,46,59,-13,42
East Fife,1621,7,13,3,20,49,67,-18,42
Forfar,1621,8,10,6,20,39,65,-26,36
Queen's Park,1621,9,7,10,19,42,72,-30,31
Albion,1621,10,8,6,22,57,81,-24,30
Ayr,1622,1,24,4,8,94,42,52,76
Raith,1622,2,22,9,5,69,33,36,75
Alloa,1622,3,17,9,10,57,44,13,60
Arbroath,1622,4,17,8,11,72,52,20,59
Stranraer,1622,5,15,6,15,56,65,-9,51
Airdrieon,1622,6,11,11,14,47,59,-12,44
East Fife,1622,7,13,4,19,48,65,-17,43
Forfar,1622,8,10,5,21,39,66,-27,35
Queen's Park,1622,9,7,10,19,43,74,-31,31
Albion,1622,10,8,6,22,57,82,-25,30
Raith,1623,1,23,8,5,69,32,37,77
Ayr,1623,2,24,4,8,95,43,52,76
Arbroath,1623,3,18,8,10,72,48,24,62
Alloa,1623,4,17,8,11,56,44,12,59
Stranraer,1623,5,16,5,15,58,65,-7,53
Airdrieon,1623,6,10,12,14,47,60,-13,42
East Fife,1623,7,13,3,20,48,67,-19,42
Forfar,1623,8,10,6,20,40,66,-26,36
Albion,1623,9,8,6,22,58,83,-25,30
Queen's Park,1623,10,6,10,20,39,74,-35,28
Ayr,1624,1,23,5,8,92,44,48,74
Raith,1624,2,22,8,6,69,36,33,74
Arbroath,1624,3,18,8,10,72,49,23,62
Alloa,1624,4,18,8,10,60,44,16,62
Stranraer,1624,5,16,5,15,58,65,-7,53
Airdrieon,1624,6,11,11,14,48,58,-10,44
East Fife,1624,7,13,3,20,48,67,-19,42
Forfar,1624,8,10,5,21,38,67,-29,35
Albion,1624,9,8,7,21,59,80,-21,31
Queen's Park,1624,10,6,10,20,40,74,-34,28
Raith,1625,1,23,8,5,70,32,38,77
Ayr,1625,2,24,4,8,95,43,52,76
Arbroath,1625,3,18,8,10,73,49,24,62
Alloa,1625,4,17,8,11,56,45,11,59
Stranraer,1625,5,15,5,16,56,66,-10,50
East Fife,1625,6,14,3,19,49,65,-16,45
Airdrieon,1625,7,11,11,14,47,59,-12,44
Forfar,1625,8,10,5,21,39,66,-27,35
Albion,1625,9,8,6,22,58,83,-25,30
Queen's Park,1625,10,6,10,20,40,75,-35,28
Raith,1626,1,23,8,5,70,32,38,77
Ayr,1626,2,23,4,9,91,44,47,73
Arbroath,1626,3,18,8,10,72,49,23,62
Alloa,1626,4,17,8,11,56,45,11,59
Stranraer,1626,5,15,5,16,56,66,-10,50
East Fife,1626,6,14,3,19,49,65,-16,45
Airdrieon,1626,7,11,11,14,49,60,-11,44
Forfar,1626,8,10,5,21,40,68,-28,35
Albion,1626,9,9,6,21,59,79,-20,33
Queen's Park,1626,10,6,10,20,40,74,-34,28
Ayr,1627,1,24,4,8,92,43,49,76
Raith,1627,2,22,8,6,68,34,34,74
Arbroath,1627,3,18,8,10,72,48,24,62
Alloa,1627,4,18,8,10,58,43,15,62
Stranraer,1627,5,15,6,15,55,64,-9,51
Airdrieon,1627,6,11,11,14,48,58,-10,44
East Fife,1627,7,13,4,19,47,64,-17,43
Forfar,1627,8,10,5,21,38,67,-29,35
Albion,1627,9,8,6,22,58,80,-22,30
Queen's Park,1627,10,6,10,20,39,74,-35,28
Ayr,1628,1,24,4,8,97,43,54,76
Raith,1628,2,22,9,5,69,33,36,75
Arbroath,1628,3,18,8,10,73,48,25,62
Alloa,1628,4,17,9,10,57,44,13,60
Stranraer,1628,5,15,5,16,56,66,-10,50
East Fife,1628,6,14,3,19,49,65,-16,45
Airdrieon,1628,7,11,11,14,46,58,-12,44
Forfar,1628,8,10,5,21,38,65,-27,35
Albion,1628,9,8,6,22,58,85,-27,30
Queen's Park,1628,10,6,10,20,39,75,-36,28
Raith,1629,1,23,8,5,72,32,40,77
Ayr,1629,2,23,5,8,93,45,48,74
Arbroath,1629,3,17,8,11,71,50,21,59
Alloa,1629,4,17,8,11,56,47,9,59
Stranraer,1629,5,15,5,16,56,67,-11,50
East Fife,1629,6,14,3,19,50,65,-15,45
Airdrieon,1629,7,11,11,14,46,58,-12,44
Forfar,1629,8,10,5,21,38,65,-27,35
Albion,1629,9,8,7,21,60,81,-21,31
Queen's Park,1629,10,7,10,19,41,73,-32,31
Raith,1630,1,23,8,5,72,34,38,77
Ayr,1630,2,24,4,8,95,42,53,76
Arbroath,1630,3,17,8,11,71,50,21,59
Alloa,1630,4,17,8,11,58,47,11,59
Stranraer,1630,5,16,5,15,58,66,-8,53
Airdrieon,1630,6,11,11,14,47,59,-12,44
East Fife,1630,7,13,3,20,49,67,-18,42
Forfar,1630,8,10,5,21,39,66,-27,35
Queen's Park,1630,9,7,10,19,41,73,-32,31
Albion,1630,10,8,6,22,57,83,-26,30
Raith,1631,1,23,8,5,71,34,37,77
Ayr,1631,2,24,4,8,94,43,51,76
Arbroath,1631,3,17,8,11,70,49,21,59
Alloa,1631,4,17,8,11,58,46,12,59
Stranraer,1631,5,15,6,15,58,67,-9,51
Airdrieon,1631,6,11,11,14,47,59,-12,44
East Fife,1631,7,13,4,19,50,67,-17,43
Forfar,1631,8,10,5,21,39,66,-27,35
Queen's Park,1631,9,7,10,19,40,72,-32,31
Albion,1631,10,8,6,22,58,82,-24,30
Raith,1632,1,23,8,5,70,32,38,77
Ayr,1632,2,24,4,8,95,44,51,76
Arbroath,1632,3,17,9,10,71,49,22,60
Alloa,1632,4,17,8,11,56,45,11,59
Stranraer,1632,5,15,5,16,55,67,-12,50
East Fife,1632,6,14,3,19,50,64,-14,45
Airdrieon,1632,7,11,11,14,48,59,-11,44
Forfar,1632,8,10,5,21,39,67,-28,35
Albion,1632,9,8,6,22,59,83,-24,30
Queen's Park,1632,10,6,11,19,40,73,-33,29
Raith,1633,1,23,8,5,72,34,38,77
Ayr,1633,2,24,4,8,92,43,49,76
Arbroath,1633,3,18,8,10,73,49,24,62
Alloa,1633,4,17,8,11,58,47,11,59
Stranraer,1633,5,15,5,16,55,67,-12,50
East Fife,1633,6,14,3,19,50,64,-14,45
Airdrieon,1633,7,11,11,14,47,59,-12,44
Forfar,1633,8,10,5,21,39,66,-27,35
Albion,1633,9,8,6,22,58,80,-22,30
Queen's Park,1633,10,6,10,20,40,75,-35,28
Raith,1634,1,23,8,5,70,33,37,77
Ayr,1634,2,23,5,8,90,42,48,74
Arbroath,1634,3,17,9,10,73,51,22,60
Alloa,1634,4,17,8,11,57,45,12,59
Stranraer,1634,5,15,6,15,57,66,-9,51
East Fife,1634,6,13,4,19,49,66,-17,43
Airdrieon,1634,7,10,11,15,46,61,-15,41
Forfar,1634,8,11,5,20,41,65,-24,38
Albion,1634,9,8,7,21,57,78,-21,31
Queen's Park,1634,10,6,11,19,42,75,-33,29
Raith,1635,1,23,8,5,70,32,38,77
Ayr,1635,2,24,4,8,92,43,49,76
Arbroath,1635,3,17,9,10,70,48,22,60
Alloa,1635,4,17,8,11,56,45,11,59
Stranraer,1635,5,15,5,16,55,66,-11,50
East Fife,1635,6,14,3,19,49,64,-15,45
Airdrieon,1635,7,10,11,15,47,61,-14,41
Forfar,1635,8,11,5,20,41,66,-25,38
Albion,1635,9,8,6,22,58,80,-22,30
Queen's Park,1635,10,6,11,19,39,72,-33,29
Raith,1636,1,23,8,5,70,33,37,77
Ayr,1636,2,24,4,8,93,43,50,76
Arbroath,1636,3,18,8,10,72,49,23,62
Alloa,1636,4,17,8,11,57,45,12,59
Stranraer,1636,5,15,6,15,55,64,-9,51
East Fife,1636,6,13,4,19,47,64,-17,43
Airdrieon,1636,7,10,11,15,48,62,-14,41
Forfar,1636,8,11,5,20,42,67,-25,38
Albion,1636,9,8,6,22,58,81,-23,30
Queen's Park,1636,10,6,10,20,40,74,-34,28
Raith,1637,1,23,8,5,69,32,37,77
Ayr,1637,2,24,4,8,92,43,49,76
Arbroath,1637,3,18,8,10,73,49,24,62
Alloa,1637,4,17,8,11,56,44,12,59
Stranraer,1637,5,16,5,15,57,65,-8,53
Airdrieon,1637,6,11,11,14,49,60,-11,44
East Fife,1637,7,13,3,20,48,66,-18,42
Forfar,1637,8,10,5,21,40,68,-28,35
Albion,1637,9,8,6,22,58,80,-22,30
Queen's Park,1637,10,6,10,20,40,75,-35,28
Ayr,1638,1,24,4,8,97,43,54,76
Raith,1638,2,22,9,5,69,33,36,75
Arbroath,1638,3,18,8,10,72,48,24,62
Alloa,1638,4,17,9,10,57,44,13,60
Stranraer,1638,5,15,6,15,56,65,-9,51
Airdrieon,1638,6,11,11,14,48,58,-10,44
East Fife,1638,7,13,4,19,48,65,-17,43
Forfar,1638,8,10,5,21,38,67,-29,35
Albion,1638,9,8,6,22,58,85,-27,30
Queen's Park,1638,10,6,10,20,39,74,-35,28
Raith,1639,1,23,8,5,69,32,37,77
Ayr,1639,2,23,4,9,91,45,46,73
Arbroath,1639,3,17,9,10,74,52,22,60
Alloa,1639,4,17,8,11,56,44,12,59
Stranraer,1639,5,15,5,16,56,66,-10,50
East Fife,1639,6,14,3,19,49,65,-16,45
Airdrieon,1639,7,10,11,15,45,59,-14,41
Forfar,1639,8,11,5,20,39,64,-25,38
Albion,1639,9,9,6,21,60,79,-19,33
Queen's Park,1639,10,6,11,19,43,76,-33,29
Ayr,1640,1,24,4,8,93,43,50,76
Raith,1640,2,22,8,6,69,35,34,74
Arbroath,1640,3,18,8,10,75,50,25,62
Alloa,1640,4,18,8,10,59,44,15,62
Stranraer,1640,5,16,5,15,57,65,-8,53
Airdrieon,1640,6,11,11,14,47,58,-11,44
East Fife,1640,7,13,3,20,48,66,-18,42
Forfar,1640,8,10,5,21,38,66,-28,35
Albion,1640,9,8,6,22,58,81,-23,30
Queen's Park,1640,10,6,10,20,41,77,-36,28
Raith,1641,1,23,8,5,73,32,41,77
Ayr,1641,2,24,4,8,92,43,49,76
Arbroath,1641,3,17,9,10,71,49,22,60
Alloa,1641,4,17,8,11,56,48,8,59
Stranraer,1641,5,15,5,16,55,65,-10,50
East Fife,1641,6,14,3,19,48,64,-16,45
Airdrieon,1641,7,11,11,14,47,59,-12,44
Forfar,1641,8,10,5,21,39,66,-27,35
Albion,1641,9,8,6,22,58,80,-22,30
Queen's Park,1641,10,6,11,19,40,73,-33,29
Raith,1642,1,23,8,5,71,34,37,77
Ayr,1642,2,24,4,8,97,43,54,76
Arbroath,1642,3,17,8,11,71,50,21,59
Alloa,1642,4,17,8,11,58,46,12,59
Stranraer,1642,5,15,6,15,55,64,-9,51
Airdrieon,1642,6,11,11,14,46,58,-12,44
East Fife,1642,7,13,4,19,47,64,-17,43
Forfar,1642,8,10,5,21,38,65,-27,35
Queen's Park,1642,9,7,10,19,41,73,-32,31
Albion,1642,10,8,6,22,58,85,-27,30
Raith,1643,1,22,8,6,69,34,35,74
Ayr,1643,2,23,4,9,92,45,47,73
Alloa,1643,3,18,8,10,58,44,14,62
Arbroath,1643,4,17,8,11,71,52,19,59
Stranraer,1643,5,15,6,15,56,65,-9,51
Airdrieon,1643,6,11,11,14,47,59,-12,44
East Fife,1643,7,13,4,19,48,65,-17,43
Forfar,1643,8,10,5,21,39,66,-27,35
Albion,1643,9,9,6,21,60,80,-20,33
Queen's Park,1643,10,7,10,19,43,73,-30,31
Ayr,1644,1,24,4,8,96,42,54,76
Raith,1644,2,22,8,6,69,34,35,74
Arbroath,1644,3,18,8,10,71,48,23,62
Alloa,1644,4,18,8,10,58,44,14,62
Stranraer,1644,5,15,6,15,55,64,-9,51
Airdrieon,1644,6,11,11,14,46,58,-12,44
East Fife,1644,7,13,4,19,47,64,-17,43
Forfar,1644,8,10,5,21,38,65,-27,35
Albion,1644,9,8,6,22,57,84,-27,30
Queen's Park,1644,10,6,10,20,39,73,-34,28
Raith,1645,1,23,8,5,73,34,39,77
Ayr,1645,2,24,4,8,96,44,52,76
Arbroath,1645,3,17,8,11,70,49,21,59
Alloa,1645,4,17,8,11,58,48,10,59
Stranraer,1645,5,16,5,15,56,64,-8,53
Airdrieon,1645,6,11,11,14,49,58,-9,44
East Fife,1645,7,13,3,20,47,65,-18,42
Forfar,1645,8,10,5,21,38,68,-30,35
Queen's Park,1645,9,7,10,19,40,72,-32,31
Albion,1645,10,8,6,22,59,84,-25,30
Ayr,1646,1,24,4,8,95,44,51,76
Raith,1646,2,22,9,5,70,34,36,75
Arbroath,1646,3,18,8,10,74,49,25,62
Alloa,1646,4,17,9,10,58,45,13,60
Stranraer,1646,5,15,5,16,56,67,-11,50
East Fife,1646,6,14,3,19,50,65,-15,45
Airdrieon,1646,7,11,11,14,47,58,-11,44
Forfar,1646,8,10,5,21,38,66,-28,35
Albion,1646,9,8,6,22,59,83,-24,30
Queen's Park,1646,10,6,10,20,40,76,-36,28
Raith,1647,1,23,8,5,70,32,38,77
Ayr,1647,2,24,4,8,93,42,51,76
Arbroath,1647,3,18,8,10,73,49,24,62
Alloa,1647,4,17,8,11,56,45,11,59
Stranraer,1647,5,15,5,16,56,67,-11,50
East Fife,1647,6,14,3,19,50,65,-15,45
Airdrieon,1647,7,11,11,14,46,58,-12,44
Forfar,1647,8,10,5,21,38,65,-27,35
Albion,1647,9,8,6,22,57,81,-24,30
Queen's Park,1647,10,6,10,20,40,75,-35,28
Raith,1648,1,23,8,5,70,32,38,77
Ayr,1648,2,24,4,8,94,44,50,76
Arbroath,1648,3,18,8,10,71,48,23,62
Alloa,1648,4,17,8,11,56,45,11,59
Stranraer,1648,5,15,6,15,56,65,-9,51
East Fife,1648,6,13,4,19,48,65,-17,43
Airdrieon,1648,7,10,12,14,45,58,-13,42
Forfar,1648,8,10,6,20,38,64,-26,36
Albion,1648,9,8,6,22,59,82,-23,30
Queen's Park,1648,10,6,10,20,39,73,-34,28
Raith,1649,1,23,8,5,71,33,38,77
Ayr,1649,2,24,4,8,93,42,51,76
Arbroath,1649,3,18,8,10,73,50,23,62
Alloa,1649,4,17,8,11,57,46,11,59
Stranraer,1649,5,16,5,15,56,64,-8,53
Airdrieon,1649,6,10,12,14,45,58,-13,42
East Fife,1649,7,13,3,20,47,65,-18,42
Forfar,1649,8,10,6,20,38,64,-26,36
Albion,1649,9,8,6,22,57,81,-24,30
Queen's Park,1649,10,6,10,20,41,75,-34,28
Ayr,1650,1,24,4,8,93,44,49,76
Raith,1650,2,22,9,5,68,32,36,75
Arbroath,1650,3,18,8,10,73,49,24,62
Alloa,1650,4,17,9,10,56,43,13,60
Stranraer,1650,5,16,5,15,57,65,-8,53
Airdrieon,1650,6,11,11,14,51,59,-8,44
East Fife,1650,7,13,3,20,48,66,-18,42
Forfar,1650,8,10,5,21,39,70,-31,35
Albion,1650,9,8,6,22,59,81,-22,30
Queen's Park,1650,10,6,10,20,40,75,-35,28
Raith,1651,1,23,8,5,73,33,40,77
Ayr,1651,2,24,4,8,92,42,50,76
Arbroath,1651,3,17,9,10,72,50,22,60
Alloa,1651,4,17,8,11,57,48,9,59
Stranraer,1651,5,15,5,16,55,68,-13,50
East Fife,1651,6,14,3,19,51,64,-13,45
Airdrieon,1651,7,10,12,14,45,58,-13,42
Forfar,1651,8,10,6,20,38,64,-26,36
Albion,1651,9,8,6,22,57,80,-23,30
Queen's Park,1651,10,6,11,19,41,74,-33,29
Raith,1652,1,23,8,5,71,32,39,77
Ayr,1652,2,24,4,8,95,43,52,76
Arbroath,1652,3,17,8,11,71,51,20,59
Alloa,1652,4,17,8,11,56,46,10,59
Stranraer,1652,5,15,5,16,56,66,-10,50
East Fife,1652,6,14,3,19,49,65,-16,45
Airdrieon,1652,7,10,11,15,46,60,-14,41
Forfar,1652,8,11,5,20,40,65,-25,38
Queen's Park,1652,9,7,10,19,42,73,-31,31
Albion,1652,10,8,6,22,58,83,-25,30
Raith,1653,1,23,8,5,71,33,38,77
Ayr,1653,2,23,5,8,92,44,48,74
Arbroath,1653,3,17,9,10,72,50,22,60
Alloa,1653,4,17,8,11,57,46,11,59
Stranraer,1653,5,16,5,15,57,64,-7,53
East Fife,1653,6,13,3,20,47,66,-19,42
Airdrieon,1653,7,10,11,15,47,62,-15,41
Forfar,1653,8,11,5,20,42,66,-24,38
Albion,1653,9,8,7,21,59,80,-21,31
Queen's Park,1653,10,6,11,19,41,74,-33,29
Raith,1654,1,22,9,5,70,34,36,75
Ayr,1654,2,23,4,9,92,45,47,73
Arbroath,1654,3,18,8,10,72,49,23,62
Alloa,1654,4,17,9,10,58,45,13,60
Stranraer,1654,5,15,5,16,56,67,-11,50
East Fife,1654,6,14,3,19,50,65,-15,45
Airdrieon,1654,7,11,11,14,46,58,-12,44
Forfar,1654,8,10,5,21,38,65,-27,35
Albion,1654,9,9,6,21,60,80,-20,33
Queen's Park,1654,10,6,10,20,40,74,-34,28
Ayr,1655,1,24,4,8,96,43,53,76
Raith,1655,2,22,9,5,70,34,36,75
Arbroath,1655,3,18,8,10,74,48,26,62
Alloa,1655,4,17,9,10,58,45,13,60
Stranraer,1655,5,15,5,16,55,67,-12,50
East Fife,1655,6,14,3,19,50,64,-14,45
Airdrieon,1655,7,11,11,14,46,58,-12,44
Forfar,1655,8,10,5,21,38,65,-27,35
Albion,1655,9,8,6,22,58,84,-26,30
Queen's Park,1655,10,6,10,20,39,76,-37,28
Raith,1656,1,23,8,5,72,32,40,77
Ayr,1656,2,24,4,8,97,44,53,76
Arbroath,1656,3,17,9,10,73,51,22,60
Alloa,1656,4,17,8,11,56,47,9,59
Stranraer,1656,5,16,5,15,59,65,-6,53
Airdrieon,1656,6,11,11,14,46,58,-12,44
East Fife,1656,7,13,3,20,48,68,-20,42
Forfar,1656,8,10,5,21,38,65,-27,35
Albion,1656,9,8,6,22,59,85,-26,30
Queen's Park,1656,10,6,11,19,42,75,-33,29
Raith,1657,1,23,8,5,70,33,37,77
Ayr,1657,2,23,5,8,90,42,48,74
Arbroath,1657,3,18,8,10,74,48,26,62
Alloa,1657,4,17,8,11,57,45,12,59
Stranraer,1657,5,15,5,16,56,66,-10,50
East Fife,1657,6,14,3,19,49,65,-16,45
Airdrieon,1657,7,10,11,15,45,59,-14,41
Forfar,1657,8,11,5,20,39,64,-25,38
Albion,1657,9,8,7,21,57,78,-21,31
Queen's Park,1657,10,6,10,20,39,76,-37,28
Ayr,1658,1,24,4,8,94,42,52,76
Raith,1658,2,22,9,5,70,34,36,75
Arbroath,1658,3,18,8,10,72,49,23,62
Alloa,1658,4,17,9,10,58,45,13,60
Stranraer,1658,5,15,5,16,56,66,-10,50
East Fife,1658,6,14,3,19,49,65,-16,45
Airdrieon,1658,7,11,11,14,48,59,-11,44
Forfar,1658,8,10,5,21,39,67,-28,35
Albion,1658,9,8,6,22,57,82,-25,30
Queen's Park,1658,10,6,10,20,40,74,-34,28
Raith,1659,1,23,8,5,71,32,39,77
Ayr,1659,2,23,5,8,91,43,48,74
Arbroath,1659,3,17,9,10,71,49,22,60
Alloa,1659,4,17,8,11,56,46,10,59
Stranraer,1659,5,15,5,16,56,66,-10,50
East Fife,1659,6,14,3,19,49,65,-16,45
Airdrieon,1659,7,10,11,15,46,61,-15,41
Forfar,1659,8,11,5,20,41,65,-24,38
Albion,1659,9,8,7,21,58,79,-21,31
Queen's Park,1659,10,6,11,19,40,73,-33,29
Ayr,1660,1,24,4,8,95,43,52,76
Raith,1660,2,22,9,5,69,33,36,75
Alloa,1660,3,17,9,10,57,44,13,60
Arbroath,1660,4,17,8,11,70,49,21,59
Stranraer,1660,5,15,5,16,55,68,-13,50
East Fife,1660,6,14,3,19,51,64,-13,45
Airdrieon,1660,7,10,11,15,46,60,-14,41
Forfar,1660,8,11,5,20,40,65,-25,38
Queen's Park,1660,9,7,10,19,40,72,-32,31
Albion,1660,10,8,6,22,58,83,-25,30
Ayr,1661,1,24,4,8,93,42,51,76
Raith,1661,2,22,8,6,70,36,34,74
Arbroath,1661,3,18,8,10,75,51,24,62
Alloa,1661,4,18,8,10,60,45,15,62
Stranraer,1661,5,15,5,16,55,65,-10,50
East Fife,1661,6,14,3,19,48,64,-16,45
Airdrieon,1661,7,10,12,14,45,58,-13,42
Forfar,1661,8,10,6,20,38,64,-26,36
Albion,1661,9,8,6,22,57,81,-24,30
Queen's Park,1661,10,6,10,20,42,77,-35,28
Raith,1662,1,23,8,5,71,34,37,77
Ayr,1662,2,24,4,8,94,42,52,76
Arbroath,1662,3,18,8,10,76,49,27,62
Alloa,1662,4,17,8,11,58,46,12,59
Stranraer,1662,5,15,5,16,55,66,-11,50
East Fife,1662,6,14,3,19,49,64,-15,45
Airdrieon,1662,7,10,11,15,45,59,-14,41
Forfar,1662,8,11,5,20,39,64,-25,38
Albion,1662,9,8,6,22,57,82,-25,30
Queen's Park,1662,10,6,10,20,40,78,-38,28
Ayr,1663,1,24,4,8,96,42,54,76
Raith,1663,2,22,9,5,69,33,36,75
Arbroath,1663,3,17,9,10,73,51,22,60
Alloa,1663,4,17,9,10,57,44,13,60
Stranraer,1663,5,15,5,16,55,66,-11,50
East Fife,1663,6,14,3,19,49,64,-15,45
Airdrieon,1663,7,10,12,14,48,61,-13,42
Forfar,1663,8,10,6,20,41,67,-26,36
Albion,1663,9,8,6,22,57,84,-27,30
Queen's Park,1663,10,6,11,19,42,75,-33,29
Ayr,1664,1,24,4,8,93,42,51,76
Raith,1664,2,22,8,6,68,33,35,74
Alloa,1664,3,18,8,10,57,43,14,62
Arbroath,1664,4,17,8,11,71,50,21,59
Stranraer,1664,5,16,5,15,58,65,-7,53
Airdrieon,1664,6,11,11,14,46,58,-12,44
East Fife,1664,7,13,3,20,48,67,-19,42
Forfar,1664,8,10,5,21,38,65,-27,35
Queen's Park,1664,9,7,10,19,41,73,-32,31
Albion,1664,10,8,6,22,57,81,-24,30
Raith,1665,1,23,8,5,70,33,37,77
Ayr,1665,2,24,4,8,94,45,49,76
Arbroath,1665,3,18,8,10,74,49,25,62
Alloa,1665,4,17,8,11,57,45,12,59
Stranraer,1665,5,16,5,15,59,65,-6,53
Airdrieon,1665,6,10,12,14,46,59,-13,42
East Fife,1665,7,13,3,20,48,68,-20,42
Forfar,1665,8,10,6,20,39,65,-26,36
Albion,1665,9,8,6,22,60,82,-22,30
Queen's Park,1665,10,6,10,20,40,76,-36,28
Raith,1666,1,23,8,5,71,32,39,77
Ayr,1666,2,24,4,8,97,42,55,76
Arbroath,1666,3,18,8,10,74,49,25,62
Alloa,1666,4,17,8,11,56,46,10,59
Stranraer,1666,5,16,5,15,57,65,-8,53
Airdrieon,1666,6,11,11,14,47,58,-11,44
East Fife,1666,7,13,3,20,48,66,-18,42
Forfar,1666,8,10,5,21,38,66,-28,35
Albion,1666,9,8,6,22,57,85,-28,30
Queen's Park,1666,10,6,10,20,40,76,-36,28
Raith,1667,1,22,8,6,69,34,35,74
Ayr,1667,2,23,4,9,92,45,47,73
Arbroath,1667,3,18,8,10,71,48,23,62
Alloa,1667,4,18,8,10,58,44,14,62
Stranraer,1667,5,15,6,15,56,65,-9,51
East Fife,1667,6,13,4,19,48,65,-17,43
Airdrieon,1667,7,10,12,14,45,58,-13,42
Forfar,1667,8,10,6,20,38,64,-26,36
Albion,1667,9,9,6,21,60,80,-20,33
Queen's Park,1667,10,6,10,20,39,73,-34,28
Raith,1668,1,23,8,5,69,32,37,77
Ayr,1668,2,24,4,8,94,43,51,76
Arbroath,1668,3,17,9,10,71,49,22,60
Alloa,1668,4,17,8,11,56,44,12,59
Stranraer,1668,5,15,5,16,57,69,-12,50
East Fife,1668,6,14,3,19,52,66,-14,45
Airdrieon,1668,7,10,12,14,47,60,-13,42
Forfar,1668,8,10,6,20,40,66,-26,36
Albion,1668,9,8,6,22,58,82,-24,30
Queen's Park,1668,10,6,11,19,40,73,-33,29
Ayr,1669,1,24,4,8,94,44,50,76
Raith,1669,2,22,9,5,70,34,36,75
Alloa,1669,3,17,9,10,58,45,13,60
Arbroath,1669,4,17,8,11,71,50,21,59
Stranraer,1669,5,15,5,16,56,66,-10,50
East Fife,1669,6,14,3,19,49,65,-16,45
Airdrieon,1669,7,10,11,15,46,61,-15,41
Forfar,1669,8,11,5,20,41,65,-24,38
Queen's Park,1669,9,7,10,19,41,73,-32,31
Albion,1669,10,8,6,22,59,82,-23,30
Raith,1670,1,23,8,5,69,32,37,77
Ayr,1670,2,24,4,8,96,42,54,76
Arbroath,1670,3,17,8,11,70,50,20,59
Alloa,1670,4,17,8,11,56,44,12,59
Stranraer,1670,5,16,5,15,56,64,-8,53
Airdrieon,1670,6,11,11,14,49,59,-10,44
East Fife,1670,7,13,3,20,47,65,-18,42
Forfar,1670,8,10,5,21,39,68,-29,35
Queen's Park,1670,9,7,10,19,41,72,-31,31
Albion,1670,10,8,6,22,57,84,-27,30
Raith,1671,1,23,8,5,69,32,37,77
Ayr,1671,2,24,4,8,91,42,49,76
Arbroath,1671,3,18,8,10,75,50,25,62
Alloa,1671,4,17,8,11,56,44,12,59
Stranraer,1671,5,16,5,15,58,64,-6,53
Airdrieon,1671,6,10,12,14,46,59,-13,42
East Fife,1671,7,13,3,20,47,67,-20,42
Forfar,1671,8,10,6,20,39,65,-26,36
Albion,1671,9,8,6,22,57,79,-22,30
Queen's Park,1671,10,6,10,20,41,77,-36,28
Raith,1672,1,22,8,6,68,33,35,74
Ayr,1672,2,23,4,9,92,45,47,73
Arbroath,1672,3,18,8,10,71,48,23,62
Alloa,1672,4,18,8,10,57,43,14,62
Stranraer,1672,5,15,6,15,57,66,-9,51
Airdrieon,1672,6,11,11,14,48,59,-11,44
East Fife,1672,7,13,4,19,49,66,-17,43
Forfar,1672,8,10,5,21,39,67,-28,35
Albion,1672,9,9,6,21,60,80,-20,33
Queen's Park,1672,10,6,10,20,39,73,-34,28
Raith,1673,1,23,8,5,71,33,38,77
Ayr,1673,2,24,4,8,92,42,50,76
Arbroath,1673,3,18,8,10,72,49,23,62
Alloa,1673,4,17,8,11,57,46,11,59
Stranraer,1673,5,15,6,15,55,64,-9,51
East Fife,1673,6,13,4,19,47,64,-17,43
Airdrieon,1673,7,10,11,15,45,59,-14,41
Forfar,1673,8,11,5,20,39,64,-25,38
Albion,1673,9,8,6,22,57,80,-23,30
Queen's Park,1673,10,6,10,20,40,74,-34,28
Ayr,1674,1,24,4,8,96,44,52,76
Raith,1674,2,22,9,5,68,32,36,75
Arbroath,1674,3,18,8,10,73,48,25,62
Alloa,1674,4,17,9,10,56,43,13,60
Stranraer,1674,5,15,5,16,55,65,-10,50
East Fife,1674,6,14,3,19,48,64,-16,45
Airdrieon,1674,7,11,11,14,47,58,-11,44
Forfar,1674,8,10,5,21,38,66,-28,35
Albion,1674,9,8,6,22,59,84,-25,30
Queen's Park,1674,10,6,10,20,39,75,-36,28
Ayr,1675,1,24,4,8,93,42,51,76
Raith,1675,2,22,9,5,70,34,36,75
Arbroath,1675,3,18,8,10,72,49,23,62
Alloa,1675,4,17,9,10,58,45,13,60
Stranraer,1675,5,16,5,15,56,64,-8,53
Airdrieon,1675,6,10,12,14,46,59,-13,42
East Fife,1675,7,13,3,20,47,65,-18,42
Forfar,1675,8,10,6,20,39,65,-26,36
Albion,1675,9,8,6,22,57,81,-24,30
Queen's Park,1675,10,6,10,20,40,74,-34,28
Raith,1676,1,23,8,5,69,32,37,77
Ayr,1676,2,24,4,8,95,43,52,76
Arbroath,1676,3,18,8,10,72,48,24,62
Alloa,1676,4,17,8,11,56,44,12,59
Stranraer,1676,5,15,6,15,56,65,-9,51
Airdrieon,1676,6,11,11,14,48,60,-12,44
East Fife,1676,7,13,4,19,48,65,-17,43
Forfar,1676,8,10,5,21,40,67,-27,35
Albion,1676,9,8,6,22,58,83,-25,30
Queen's Park,1676,10,6,10,20,39,74,-35,28
Raith,1677,1,23,8,5,69,32,37,77
Ayr,1677,2,24,4,8,95,44,51,76
Arbroath,1677,3,17,8,11,72,51,21,59
Alloa,1677,4,17,8,11,56,44,12,59
Stranraer,1677,5,15,5,16,58,68,-10,50
East Fife,1677,6,14,3,19,51,67,-16,45
Airdrieon,1677,7,11,11,14,48,58,-10,44
Forfar,1677,8,10,5,21,38,67,-29,35
Queen's Park,1677,9,7,10,19,42,74,-32,31
Albion,1677,10,8,6,22,59,83,-24,30
Ayr,1678,1,24,4,8,92,43,49,76
Raith,1678,2,22,9,5,69,33,36,75
Alloa,1678,3,17,9,10,57,44,13,60
Arbroath,1678,4,17,8,11,72,51,21,59
Stranraer,1678,5,16,5,15,56,64,-8,53
East Fife,1678,6,13,3,20,47,65,-18,42
Airdrieon,1678,7,10,11,15,46,61,-15,41
Forfar,1678,8,11,5,20,41,65,-24,38
Queen's Park,1678,9,7,10,19,42,74,-32,31
Albion,1678,10,8,6,22,58,80,-22,30
Raith,1679,1,23,8,5,72,33,39,77
Ayr,1679,2,24,4,8,93,43,50,76
Arbroath,1679,3,18,8,10,74,51,23,62
Alloa,1679,4,17,8,11,57,47,10,59
Stranraer,1679,5,15,6,15,57,66,-9,51
East Fife,1679,6,13,4,19,49,66,-17,43
Airdrieon,1679,7,10,12,14,47,60,-13,42
Forfar,1679,8,10,6,20,40,66,-26,36
Albion,1679,9,8,6,22,58,81,-23,30
Queen's Park,1679,10,6,10,20,42,76,-34,28
Raith,1680,1,23,8,5,71,32,39,77
Ayr,1680,2,23,5,8,91,43,48,74
Arbroath,1680,3,17,8,11,70,49,21,59
Alloa,1680,4,17,8,11,56,46,10,59
Stranraer,1680,5,16,5,15,58,66,-8,53
East Fife,1680,6,13,3,20,49,67,-18,42
Airdrieon,1680,7,10,11,15,45,60,-15,41
Forfar,1680,8,11,5,20,40,64,-24,38
Albion,1680,9,8,7,21,58,79,-21,31
Queen's Park,1680,10,7,10,19,40,72,-32,31
Ayr,1681,1,24,4,8,92,43,49,76
Raith,1681,2,22,9,5,69,33,36,75
Arbroath,1681,3,18,8,10,72,49,23,62
Alloa,1681,4,17,9,10,57,44,13,60
Stranraer,1681,5,16,5,15,57,65,-8,53
Airdrieon,1681,6,10,12,14,46,59,-13,42
East Fife,1681,7,13,3,20,48,66,-18,42
Forfar,1681,8,10,6,20,39,65,-26,36
Albion,1681,9,8,6,22,58,80,-22,30
Queen's Park,1681,10,6,10,20,40,74,-34,28
Raith,1682,1,23,8,5,69,32,37,77
Ayr,1682,2,24,4,8,97,42,55,76
Arbroath,1682,3,18,8,10,74,49,25,62
Alloa,1682,4,17,8,11,56,44,12,59
Stranraer,1682,5,15,6,15,56,65,-9,51
East Fife,1682,6,13,4,19,48,65,-17,43
Airdrieon,1682,7,10,12,14,49,62,-13,42
Forfar,1682,8,10,6,20,42,68,-26,36
Albion,1682,9,8,6,22,57,85,-28,30
Queen's Park,1682,10,6,10,20,40,76,-36,28
Ayr,1683,1,24,4,8,98,42,56,76
Raith,1683,2,22,8,6,69,35,34,74
Alloa,1683,3,18,8,10,59,44,15,62
Arbroath,1683,4,17,8,11,70,49,21,59
Stranraer,1683,5,15,5,16,56,67,-11,50
East Fife,1683,6,14,3,19,50,65,-15,45
Airdrieon,1683,7,11,11,14,46,58,-12,44
Forfar,1683,8,10,5,21,38,65,-27,35
Queen's Park,1683,9,7,10,19,40,72,-32,31
Albion,1683,10,8,6,22,57,86,-29,30
Raith,1684,1,23,8,5,70,32,38,77
Ayr,1684,2,24,4,8,93,44,49,76
Arbroath,1684,3,17,8,11,71,50,21,59
Alloa,1684,4,17,8,11,56,45,11,59
Stranraer,1684,5,16,5,15,56,64,-8,53
Airdrieon,1684,6,11,11,14,49,58,-9,44
East Fife,1684,7,13,3,20,47,65,-18,42
Forfar,1684,8,10,5,21,38,68,-30,35
Queen's Park,1684,9,7,10,19,41,73,-32,31
Albion,1684,10,8,6,22,59,81,-22,30
Raith,1685,1,23,8,5,69,32,37,77
Ayr,1685,2,24,4,8,92,42,50,76
Arbroath,1685,3,17,8,11,73,52,21,59
Alloa,1685,4,17,8,11,56,44,12,59
Stranraer,1685,5,15,6,15,55,64,-9,51
East Fife,1685,6,13,4,19,47,64,-17,43
Airdrieon,1685,7,10,11,15,45,60,-15,41
Forfar,1685,8,11,5,20,40,64,-24,38
Queen's Park,1685,9,7,10,19,43,75,-32,31
Albion,1685,10,8,6,22,57,80,-23,30
Raith,1686,1,23,8,5,71,32,39,77
Ayr,1686,2,24,4,8,93,43,50,76
Arbroath,1686,3,18,8,10,73,50,23,62
Alloa,1686,4,17,8,11,56,46,10,59
Stranraer,1686,5,15,6,15,55,64,-9,51
East Fife,1686,6,13,4,19,47,64,-17,43
Airdrieon,1686,7,10,12,14,47,60,-13,42
Forfar,1686,8,10,6,20,40,66,-26,36
Albion,1686,9,8,6,22,58,81,-23,30
Queen's Park,1686,10,6,10,20,41,75,-34,28
Ayr,1687,1,24,4,8,93,43,50,76
Raith,1687,2,22,9,5,69,33,36,75
Alloa,1687,3,17,9,10,57,44,13,60
Arbroath,1687,4,17,8,11,71,50,21,59
Stranraer,1687,5,15,5,16,55,65,-10,50
East Fife,1687,6,14,3,19,48,64,-16,45
Airdrieon,1687,7,10,11,15,46,60,-14,41
Forfar,1687,8,11,5,20,40,65,-25,38
Queen's Park,1687,9,7,10,19,41,73,-32,31
Albion,1687,10,8,6,22,58,81,-23,30
Ayr,1688,1,24,4,8,96,42,54,76
Raith,1688,2,22,8,6,68,36,32,74
Alloa,1688,3,18,8,10,60,43,17,62
Arbroath,1688,4,17,8,11,71,51,20,59
Stranraer,1688,5,16,5,15,58,66,-8,53
Airdrieon,1688,6,11,11,14,46,58,-12,44
East Fife,1688,7,13,3,20,49,67,-18,42
Forfar,1688,8,10,5,21,38,65,-27,35
Queen's Park,1688,9,7,10,19,42,73,-31,31
Albion,1688,10,8,6,22,57,84,-27,30
Raith,1689,1,23,8,5,71,34,37,77
Ayr,1689,2,24,4,8,95,44,51,76
Arbroath,1689,3,18,8,10,71,48,23,62
Alloa,1689,4,17,8,11,58,46,12,59
Stranraer,1689,5,16,5,15,57,65,-8,53
East Fife,1689,6,13,3,20,48,66,-18,42
Airdrieon,1689,7,10,11,15,45,60,-15,41
Forfar,1689,8,11,5,20,40,64,-24,38
Albion,1689,9,8,6,22,59,83,-24,30
Queen's Park,1689,10,6,10,20,39,73,-34,28
Raith,1690,1,22,9,5,69,33,36,75
Ayr,1690,2,23,4,9,92,45,47,73
Alloa,1690,3,17,9,10,57,44,13,60
Arbroath,1690,4,17,8,11,71,51,20,59
Stranraer,1690,5,16,5,15,59,65,-6,53
Airdrieon,1690,6,11,11,14,48,59,-11,44
East Fife,1690,7,13,3,20,48,68,-20,42
Forfar,1690,8,10,5,21,39,67,-28,35
Albion,1690,9,9,6,21,60,80,-20,33
Queen's Park,1690,10,7,10,19,42,73,-31,31
Ayr,1691,1,24,4,8,96,43,53,76
Raith,1691,2,22,9,5,68,32,36,75
Arbroath,1691,3,18,8,10,74,50,24,62
Alloa,1691,4,17,9,10,56,43,13,60
Stranraer,1691,5,15,6,15,57,66,-9,51
Airdrieon,1691,6,11,11,14,46,58,-12,44
East Fife,1691,7,13,4,19,49,66,-17,43
Forfar,1691,8,10,5,21,38,65,-27,35
Albion,1691,9,8,6,22,58,84,-26,30
Queen's Park,1691,10,6,10,20,41,76,-35,28
Raith,1692,1,23,8,5,72,32,40,77
Ayr,1692,2,24,4,8,93,43,50,76
Arbroath,1692,3,18,8,10,74,50,24,62
Alloa,1692,4,17,8,11,56,47,9,59
Stranraer,1692,5,16,5,15,57,65,-8,53
East Fife,1692,6,13,3,20,48,66,-18,42
Airdrieon,1692,7,10,11,15,45,60,-15,41
Forfar,1692,8,11,5,20,40,64,-24,38
Albion,1692,9,8,6,22,58,81,-23,30
Queen's Park,1692,10,6,10,20,41,76,-35,28
Raith,1693,1,23,8,5,69,32,37,77
Ayr,1693,2,24,4,8,95,44,51,76
Arbroath,1693,3,18,8,10,72,48,24,62
Alloa,1693,4,17,8,11,56,44,12,59
Stranraer,1693,5,15,6,15,56,65,-9,51
East Fife,1693,6,13,4,19,48,65,-17,43
Airdrieon,1693,7,10,12,14,47,60,-13,42
Forfar,1693,8,10,6,20,40,66,-26,36
Albion,1693,9,8,6,22,59,83,-24,30
Queen's Park,1693,10,6,10,20,39,74,-35,28
Raith,1694,1,23,8,5,73,33,40,77
Ayr,1694,2,24,4,8,93,44,49,76
Arbroath,1694,3,17,8,11,71,50,21,59
Alloa,1694,4,17,8,11,57,48,9,59
Stranraer,1694,5,15,6,15,55,64,-9,51
Airdrieon,1694,6,11,11,14,46,58,-12,44
East Fife,1694,7,13,4,19,47,64,-17,43
Forfar,1694,8,10,5,21,38,65,-27,35
Queen's Park,1694,9,7,10,19,41,73,-32,31
Albion,1694,10,8,6,22,59,81,-22,30
Ayr,1695,1,24,4,8,93,43,50,76
Raith,1695,2,22,9,5,70,34,36,75
Arbroath,1695,3,18,8,10,73,50,23,62
Alloa,1695,4,17,9,10,58,45,13,60
Stranraer,1695,5,15,5,16,56,66,-10,50
East Fife,1695,6,14,3,19,49,65,-16,45
Airdrieon,1695,7,11,11,14,48,60,-12,44
Forfar,1695,8,10,5,21,40,67,-27,35
Albion,1695,9,8,6,22,58,81,-23,30
Queen's Park,1695,10,6,10,20,41,75,-34,28
Raith,1696,1,23,8,5,73,32,41,77
Ayr,1696,2,23,5,8,91,43,48,74
Arbroath,1696,3,17,8,11,71,50,21,59
Alloa,1696,4,17,8,11,56,48,8,59
Stranraer,1696,5,15,6,15,57,66,-9,51
Airdrieon,1696,6,11,11,14,47,59,-12,44
East Fife,1696,7,13,4,19,49,66,-17,43
Forfar,1696,8,10,5,21,39,66,-27,35
Albion,1696,9,8,7,21,58,79,-21,31
Queen's Park,1696,10,7,10,19,41,73,-32,31
Raith,1697,1,23,8,5,72,33,39,77
Ayr,1697,2,24,4,8,94,42,52,76
Arbroath,1697,3,18,8,10,73,49,24,62
Alloa,1697,4,17,8,11,57,47,10,59
Stranraer,1697,5,16,5,15,58,64,-6,53
Airdrieon,1697,6,10,12,14,47,60,-13,42
East Fife,1697,7,13,3,20,47,67,-20,42
Forfar,1697,8,10,6,20,40,66,-26,36
Albion,1697,9,8,6,22,57,82,-25,30
Queen's Park,1697,10,6,10,20,40,75,-35,28
Raith,1698,1,23,8,5,70,33,37,77
Ayr,1698,2,24,4,8,93,43,50,76
Arbroath,1698,3,17,8,11,71,50,21,59
Alloa,1698,4,17,8,11,57,45,12,59
Stranraer,1698,5,15,5,16,56,66,-10,50
East Fife,1698,6,14,3,19,49,65,-16,45
Airdrieon,1698,7,10,11,15,46,61,-15,41
Forfar,1698,8,11,5,20,41,65,-24,38
Queen's Park,1698,9,7,10,19,41,73,-32,31
Albion,1698,10,8,6,22,58,81,-23,30
Raith,1699,1,23,8,5,71,33,38,77
Ayr,1699,2,23,4,9,91,44,47,73
Arbroath,1699,3,18,8,10,72,49,23,62
Alloa,1699,4,17,8,11,57,46,11,59
Stranraer,1699,5,15,5,16,55,65,-10,50
East Fife,1699,6,14,3,19,48,64,-16,45
Airdrieon,1699,7,10,12,14,45,58,-13,42
Forfar,1699,8,10,6,20,38,64,-26,36
Albion,1699,9,9,6,21,59,79,-20,33
Queen's Park,1699,10,6,10,20,40,74,-34,28
Ayr,1700,1,24,4,8,95,42,53,76
Raith,1700,2,22,9,5,70,34,36,75
Alloa,1700,3,17,9,10,58,45,13,60
Arbroath,1700,4,17,8,11,71,50,21,59
Stranraer,1700,5,15,6,15,56,65,-9,51
East Fife,1700,6,13,4,19,48,65,-17,43
Airdrieon,1700,7,10,12,14,45,58,-13,42
Forfar,1700,8,10,6,20,38,64,-26,36
Queen's Park,1700,9,7,10,19,41,73,-32,31
Albion,1700,10,8,6,22,57,83,-26,30
Raith,1701,1,23,8,5,69,32,37,77
Ayr,1701,2,24,4,8,96,44,52,76
Arbroath,1701,3,18,8,10,72,48,24,62
Alloa,1701,4,17,8,11,56,44,12,59
Stranraer,1701,5,16,5,15,58,66,-8,53
Airdrieon,1701,6,11,11,14,49,58,-9,44
East Fife,1701,7,13,3,20,49,67,-18,42
Forfar,1701,8,10,5,21,38,68,-30,35
Albion,1701,9,8,6,22,59,84,-25,30
Queen's Park,1701,10,6,10,20,39,74,-35,28
Raith,1702,1,22,9,5,69,33,36,75
Ayr,1702,2,23,5,8,91,43,48,74
Arbroath,1702,3,17,9,10,71,49,22,60
Alloa,1702,4,17,9,10,57,44,13,60
Stranraer,1702,5,15,5,16,56,68,-12,50
East Fife,1702,6,14,3,19,51,65,-14,45
Airdrieon,1702,7,11,11,14,47,59,-12,44
Forfar,1702,8,10,5,21,39,66,-27,35
Albion,1702,9,8,7,21,58,79,-21,31
Queen's Park,1702,10,6,11,19,40,73,-33,29
Ayr,1703,1,24,4,8,94,43,51,76
Raith,1703,2,22,8,6,69,34,35,74
Alloa,1703,3,18,8,10,58,44,14,62
Arbroath,1703,4,17,8,11,71,51,20,59
Stranraer,1703,5,15,6,15,55,64,-9,51
Airdrieon,1703,6,11,11,14,47,58,-11,44
East Fife,1703,7,13,4,19,47,64,-17,43
Forfar,1703,8,10,5,21,38,66,-28,35
Queen's Park,1703,9,7,10,19,42,73,-31,31
Albion,1703,10,8,6,22,58,82,-24,30
Raith,1704,1,23,8,5,70,32,38,77
Ayr,1704,2,24,4,8,94,43,51,76
Arbroath,1704,3,17,9,10,72,50,22,60
Alloa,1704,4,17,8,11,56,45,11,59
Stranraer,1704,5,15,6,15,58,67,-9,51
Airdrieon,1704,6,11,11,14,48,60,-12,44
East Fife,1704,7,13,4,19,50,67,-17,43
Forfar,1704,8,10,5,21,40,67,-27,35
Albion,1704,9,8,6,22,58,82,-24,30
Queen's Park,1704,10,6,11,19,41,74,-33,29
Raith,1705,1,23,8,5,69,32,37,77
Ayr,1705,2,24,4,8,93,42,51,76
Arbroath,1705,3,17,8,11,71,50,21,59
Alloa,1705,4,17,8,11,56,44,12,59
Stranraer,1705,5,15,5,16,55,65,-10,50
East Fife,1705,6,14,3,19,48,64,-16,45
Airdrieon,1705,7,11,11,14,47,59,-12,44
Forfar,1705,8,10,5,21,39,66,-27,35
Queen's Park,1705,9,7,10,19,41,73,-32,31
Albion,1705,10,8,6,22,57,81,-24,30
Ayr,1706,1,24,4,8,94,43,51,76
Raith,1706,2,22,8,6,68,33,35,74
Alloa,1706,3,18,8,10,57,43,14,62
Arbroath,1706,4,17,9,10,72,50,22,60
Stranraer,1706,5,16,5,15,57,65,-8,53
Airdrieon,1706,6,11,11,14,47,59,-12,44
East Fife,1706,7,13,3,20,48,66,-18,42
Forfar,1706,8,10,5,21,39,66,-27,35
Albion,1706,9,8,6,22,58,82,-24,30
Queen's Park,1706,10,6,11,19,41,74,-33,29
Ayr,1707,1,24,4,8,93,44,49,76
Raith,1707,2,22,9,5,69,33,36,75
Arbroath,1707,3,18,8,10,72,49,23,62
Alloa,1707,4,17,9,10,57,44,13,60
Stranraer,1707,5,16,5,15,57,64,-7,53
Airdrieon,1707,6,11,11,14,50,59,-9,44
East Fife,1707,7,13,3,20,47,66,-19,42
Forfar,1707,8,10,5,21,39,69,-30,35
Albion,1707,9,8,6,22,59,81,-22,30
Queen's Park,1707,10,6,10,20,40,74,-34,28
Raith,1708,1,23,8,5,70,32,38,77
Ayr,1708,2,24,4,8,93,43,50,76
Arbroath,1708,3,17,9,10,72,50,22,60
Alloa,1708,4,17,8,11,56,45,11,59
Stranraer,1708,5,15,5,16,55,66,-11,50
East Fife,1708,6,14,3,19,49,64,-15,45
Airdrieon,1708,7,10,11,15,46,62,-16,41
Forfar,1708,8,11,5,20,42,65,-23,38
Albion,1708,9,8,6,22,58,81,-23,30
Queen's Park,1708,10,6,11,19,41,74,-33,29
Ayr,1709,1,24,4,8,93,44,49,76
Raith,1709,2,22,8,6,68,33,35,74
Alloa,1709,3,18,8,10,57,43,14,62
Arbroath,1709,4,17,8,11,71,51,20,59
Stranraer,1709,5,15,6,15,56,65,-9,51
Airdrieon,1709,6,11,11,14,47,59,-12,44
East Fife,1709,7,13,4,19,48,65,-17,43
Forfar,1709,8,10,5,21,39,66,-27,35
Queen's Park,1709,9,7,10,19,42,73,-31,31
Albion,1709,10,8,6,22,59,81,-22,30
Raith,1710,1,23,8,5,70,32,38,77
Ayr,1710,2,24,4,8,94,45,49,76
Arbroath,1710,3,17,9,10,70,48,22,60
Alloa,1710,4,17,8,11,56,45,11,59
Stranraer,1710,5,15,5,16,55,66,-11,50
East Fife,1710,6,14,3,19,49,64,-15,45
Airdrieon,1710,7,11,11,14,46,58,-12,44
Forfar,1710,8,10,5,21,38,65,-27,35
Albion,1710,9,8,6,22,60,82,-22,30
Queen's Park,1710,10,6,11,19,39,72,-33,29
Ayr,1711,1,24,4,8,93,42,51,76
Raith,1711,2,22,8,6,68,33,35,74
Alloa,1711,3,18,8,10,57,43,14,62
Arbroath,1711,4,17,9,10,71,49,22,60
Stranraer,1711,5,16,5,15,58,64,-6,53
East Fife,1711,6,13,3,20,47,67,-20,42
Airdrieon,1711,7,10,11,15,45,59,-14,41
Forfar,1711,8,11,5,20,39,64,-25,38
Albion,1711,9,8,6,22,57,81,-24,30
Queen's Park,1711,10,6,11,19,40,73,-33,29
Raith,1712,1,23,8,5,70,33,37,77
Ayr,1712,2,23,5,8,90,42,48,74
Arbroath,1712,3,17,8,11,72,52,20,59
Alloa,1712,4,17,8,11,57,45,12,59
Stranraer,1712,5,16,5,15,58,66,-8,53
Airdrieon,1712,6,11,11,14,46,58,-12,44
East Fife,1712,7,13,3,20,49,67,-18,42
Forfar,1712,8,10,5,21,38,65,-27,35
Albion,1712,9,8,7,21,57,78,-21,31
Queen's Park,1712,10,7,10,19,43,74,-31,31
Raith,1713,1,23,8,5,69,32,37,77
Ayr,1713,2,23,5,8,92,44,48,74
Arbroath,1713,3,17,8,11,70,51,19,59
Alloa,1713,4,17,8,11,56,44,12,59
Stranraer,1713,5,15,5,16,55,66,-11,50
East Fife,1713,6,14,3,19,49,64,-15,45
Airdrieon,1713,7,10,12,14,46,59,-13,42
Forfar,1713,8,10,6,20,39,65,-26,36
Albion,1713,9,8,7,21,59,80,-21,31
Queen's Park,1713,10,7,10,19,42,72,-30,31
Raith,1714,1,23,8,5,70,32,38,77
Ayr,1714,2,24,4,8,94,43,51,76
Arbroath,1714,3,17,9,10,71,49,22,60
Alloa,1714,4,17,8,11,56,45,11,59
Stranraer,1714,5,15,5,16,56,67,-11,50
East Fife,1714,6,14,3,19,50,65,-15,45
Airdrieon,1714,7,11,11,14,49,58,-9,44
Forfar,1714,8,10,5,21,38,68,-30,35
Albion,1714,9,8,6,22,58,82,-24,30
Queen's Park,1714,10,6,11,19,40,73,-33,29
Ayr,1715,1,24,4,8,93,42,51,76
Raith,1715,2,22,9,5,68,32,36,75
Arbroath,1715,3,18,8,10,74,51,23,62
Alloa,1715,4,17,9,10,56,43,13,60
Stranraer,1715,5,15,6,15,55,64,-9,51
East Fife,1715,6,13,4,19,47,64,-17,43
Airdrieon,1715,7,10,11,15,45,61,-16,41
Forfar,1715,8,11,5,20,41,64,-23,38
Albion,1715,9,8,6,22,57,81,-24,30
Queen's Park,1715,10,6,10,20,42,76,-34,28
Ayr,1716,1,24,4,8,93,43,50,76
Raith,1716,2,22,9,5,68,32,36,75
Arbroath,1716,3,17,9,10,73,51,22,60
Alloa,1716,4,17,9,10,56,43,13,60
Stranraer,1716,5,15,5,16,55,67,-12,50
East Fife,1716,6,14,3,19,50,64,-14,45
Airdrieon,1716,7,10,12,14,45,58,-13,42
Forfar,1716,8,10,6,20,38,64,-26,36
Albion,1716,9,8,6,22,58,81,-23,30
Queen's Park,1716,10,6,11,19,42,75,-33,29
Raith,1717,1,23,8,5,70,32,38,77
Ayr,1717,2,24,4,8,94,44,50,76
Arbroath,1717,3,18,8,10,73,49,24,62
Alloa,1717,4,17,8,11,56,45,11,59
Stranraer,1717,5,15,6,15,56,65,-9,51
Airdrieon,1717,6,11,11,14,48,60,-12,44
East Fife,1717,7,13,4,19,48,65,-17,43
Forfar,1717,8,10,5,21,40,67,-27,35
Albion,1717,9,8,6,22,59,82,-23,30
Queen's Park,1717,10,6,10,20,40,75,-35,28
Raith,1718,1,23,8,5,71,33,38,77
Ayr,1718,2,24,4,8,94,44,50,76
Arbroath,1718,3,17,9,10,70,48,22,60
Alloa,1718,4,17,8,11,57,46,11,59
Stranraer,1718,5,16,5,15,56,64,-8,53
East Fife,1718,6,13,3,20,47,65,-18,42
Airdrieon,1718,7,10,11,15,45,59,-14,41
Forfar,1718,8,11,5,20,39,64,-25,38
Albion,1718,9,8,6,22,59,82,-23,30
Queen's Park,1718,10,6,11,19,39,72,-33,29
Raith,1719,1,23,8,5,69,32,37,77
Ayr,1719,2,23,4,9,91,45,46,73
Arbroath,1719,3,17,8,11,70,49,21,59
Alloa,1719,4,17,8,11,56,44,12,59
Stranraer,1719,5,15,5,16,55,66,-11,50
East Fife,1719,6,14,3,19,49,64,-15,45
Airdrieon,1719,7,10,11,15,46,60,-14,41
Forfar,1719,8,11,5,20,40,65,-25,38
Albion,1719,9,9,6,21,60,79,-19,33
Queen's Park,1719,10,7,10,19,40,72,-32,31
Raith,1720,1,22,9,5,68,32,36,75
Ayr,1720,2,23,5,8,91,43,48,74
Arbroath,1720,3,17,9,10,70,48,22,60
Alloa,1720,4,17,9,10,56,43,13,60
Stranraer,1720,5,16,5,15,57,65,-8,53
Airdrieon,1720,6,11,11,14,47,58,-11,44
East Fife,1720,7,13,3,20,48,66,-18,42
Forfar,1720,8,10,5,21,38,66,-28,35
Albion,1720,9,8,7,21,58,79,-21,31
Queen's Park,1720,10,6,11,19,39,72,-33,29
Ayr,1721,1,24,4,8,94,44,50,76
Raith,1721,2,22,8,6,68,34,34,74
Arbroath,1721,3,18,8,10,72,49,23,62
Alloa,1721,4,18,8,10,58,43,15,62
Stranraer,1721,5,15,6,15,56,65,-9,51
Airdrieon,1721,6,11,11,14,50,59,-9,44
East Fife,1721,7,13,4,19,48,65,-17,43
Forfar,1721,8,10,5,21,39,69,-30,35
Albion,1721,9,8,6,22,59,82,-23,30
Queen's Park,1721,10,6,10,20,40,74,-34,28
Ayr,1722,1,24,4,8,93,44,49,76
Raith,1722,2,22,9,5,69,33,36,75
Arbroath,1722,3,17,9,10,71,49,22,60
Alloa,1722,4,17,9,10,57,44,13,60
Stranraer,1722,5,15,5,16,56,66,-10,50
East Fife,1722,6,14,3,19,49,65,-16,45
Airdrieon,1722,7,11,11,14,48,58,-10,44
Forfar,1722,8,10,5,21,38,67,-29,35
Albion,1722,9,8,6,22,59,81,-22,30
Queen's Park,1722,10,6,11,19,40,73,-33,29
Raith,1723,1,23,8,5,70,32,38,77
Ayr,1723,2,24,4,8,92,42,50,76
Arbroath,1723,3,17,8,11,71,50,21,59
Alloa,1723,4,17,8,11,56,45,11,59
Stranraer,1723,5,15,5,16,55,66,-11,50
East Fife,1723,6,14,3,19,49,64,-15,45
Airdrieon,1723,7,11,11,14,46,58,-12,44
Forfar,1723,8,10,5,21,38,65,-27,35
Queen's Park,1723,9,7,10,19,41,73,-32,31
Albion,1723,10,8,6,22,57,80,-23,30
Raith,1724,1,23,8,5,69,32,37,77
Ayr,1724,2,24,4,8,93,43,50,76
Arbroath,1724,3,17,9,10,71,49,22,60
Alloa,1724,4,17,8,11,56,44,12,59
Stranraer,1724,5,16,5,15,57,65,-8,53
East Fife,1724,6,13,3,20,48,66,-18,42
Airdrieon,1724,7,10,11,15,48,62,-14,41
Forfar,1724,8,11,5,20,42,67,-25,38
Albion,1724,9,8,6,22,58,81,-23,30
Queen's Park,1724,10,6,11,19,40,73,-33,29
Ayr,1725,1,24,4,8,92,42,50,76
Raith,1725,2,22,8,6,69,34,35,74
Arbroath,1725,3,18,8,10,74,51,23,62
Alloa,1725,4,18,8,10,58,44,14,62
Stranraer,1725,5,16,5,15,59,64,-5,53
Airdrieon,1725,6,11,11,14,46,58,-12,44
East Fife,1725,7,13,3,20,47,68,-21,42
Forfar,1725,8,10,5,21,38,65,-27,35
Albion,1725,9,8,6,22,57,80,-23,30
Queen's Park,1725,10,6,10,20,42,76,-34,28
Raith,1726,1,23,8,5,72,33,39,77
Ayr,1726,2,24,4,8,95,42,53,76
Arbroath,1726,3,18,8,10,74,49,25,62
Alloa,1726,4,17,8,11,57,47,10,59
Stranraer,1726,5,16,5,15,57,64,-7,53
East Fife,1726,6,13,3,20,47,66,-19,42
Airdrieon,1726,7,10,11,15,45,59,-14,41
Forfar,1726,8,11,5,20,39,64,-25,38
Albion,1726,9,8,6,22,57,83,-26,30
Queen's Park,1726,10,6,10,20,40,76,-36,28
Ayr,1727,1,24,4,8,92,43,49,76
Raith,1727,2,22,8,6,68,33,35,74
Arbroath,1727,3,18,8,10,72,49,23,62
Alloa,1727,4,18,8,10,57,43,14,62
Stranraer,1727,5,15,5,16,55,65,-10,50
East Fife,1727,6,14,3,19,48,64,-16,45
Airdrieon,1727,7,10,11,15,47,63,-16,41
Forfar,1727,8,11,5,20,43,66,-23,38
Albion,1727,9,8,6,22,58,80,-22,30
Queen's Park,1727,10,6,10,20,40,74,-34,28
Raith,1728,1,23,8,5,71,33,38,77
Ayr,1728,2,24,4,8,94,43,51,76
Arbroath,1728,3,17,9,10,72,50,22,60
Alloa,1728,4,17,8,11,57,46,11,59
Stranraer,1728,5,16,5,15,58,65,-7,53
Airdrieon,1728,6,11,11,14,46,58,-12,44
East Fife,1728,7,13,3,20,48,67,-19,42
Forfar,1728,8,10,5,21,38,65,-27,35
Albion,1728,9,8,6,22,58,82,-24,30
Queen's Park,1728,10,6,11,19,41,74,-33,29
Ayr,1729,1,24,4,8,93,43,50,76
Raith,1729,2,22,9,5,70,34,36,75
Arbroath,1729,3,17,9,10,70,48,22,60
Alloa,1729,4,17,9,10,58,45,13,60
Stranraer,1729,5,15,5,16,55,66,-11,50
East Fife,1729,6,14,3,19,49,64,-15,45
Airdrieon,1729,7,11,11,14,48,60,-12,44
Forfar,1729,8,10,5,21,40,67,-27,35
Albion,1729,9,8,6,22,58,81,-23,30
Queen's Park,1729,10,6,11,19,39,72,-33,29
Raith,1730,1,23,8,5,71,33,38,77
Ayr,1730,2,23,5,8,92,44,48,74
Arbroath,1730,3,17,8,11,72,53,19,59
Alloa,1730,4,17,8,11,57,46,11,59
Stranraer,1730,5,16,5,15,58,65,-7,53
Airdrieon,1730,6,10,12,14,45,58,-13,42
East Fife,1730,7,13,3,20,48,67,-19,42
Forfar,1730,8,10,6,20,38,64,-26,36
Albion,1730,9,8,7,21,59,80,-21,31
Queen's Park,1730,10,7,10,19,44,74,-30,31
Raith,1731,1,23,8,5,70,33,37,77
Ayr,1731,2,24,4,8,93,43,50,76
Arbroath,1731,3,18,8,10,73,49,24,62
Alloa,1731,4,17,8,11,57,45,12,59
Stranraer,1731,5,15,6,15,59,68,-9,51
East Fife,1731,6,13,4,19,51,68,-17,43
Airdrieon,1731,7,10,11,15,46,61,-15,41
Forfar,1731,8,11,5,20,41,65,-24,38
Albion,1731,9,8,6,22,58,81,-23,30
Queen's Park,1731,10,6,10,20,40,75,-35,28
Raith,1732,1,23,8,5,71,32,39,77
Ayr,1732,2,24,4,8,92,43,49,76
Arbroath,1732,3,18,8,10,72,49,23,62
Alloa,1732,4,17,8,11,56,46,10,59
Stranraer,1732,5,15,6,15,56,65,-9,51
Airdrieon,1732,6,11,11,14,46,58,-12,44
East Fife,1732,7,13,4,19,48,65,-17,43
Forfar,1732,8,10,5,21,38,65,-27,35
Albion,1732,9,8,6,22,58,80,-22,30
Queen's Park,1732,10,6,10,20,40,74,-34,28
Ayr,1733,1,24,4,8,93,42,51,76
Raith,1733,2,22,8,6,68,33,35,74
Alloa,1733,3,18,8,10,57,43,14,62
Arbroath,1733,4,17,9,10,71,49,22,60
Stranraer,1733,5,15,5,16,55,66,-11,50
East Fife,1733,6,14,3,19,49,64,-15,45
Airdrieon,1733,7,10,11,15,45,59,-14,41
Forfar,1733,8,11,5,20,39,64,-25,38
Albion,1733,9,8,6,22,57,81,-24,30
Queen's Park,1733,10,6,11,19,40,73,-33,29
Raith,1734,1,23,8,5,69,32,37,77
Ayr,1734,2,24,4,8,95,43,52,76
Arbroath,1734,3,17,8,11,72,52,20,59
Alloa,1734,4,17,8,11,56,44,12,59
Stranraer,1734,5,16,5,15,58,66,-8,53
Airdrieon,1734,6,10,12,14,45,58,-13,42
East Fife,1734,7,13,3,20,49,67,-18,42
Forfar,1734,8,10,6,20,38,64,-26,36
Queen's Park,1734,9,7,10,19,43,74,-31,31
Albion,1734,10,8,6,22,58,83,-25,30
Raith,1735,1,23,8,5,69,32,37,77
Ayr,1735,2,24,4,8,96,43,53,76
Arbroath,1735,3,17,8,11,70,49,21,59
Alloa,1735,4,17,8,11,56,44,12,59
Stranraer,1735,5,16,5,15,58,65,-7,53
Airdrieon,1735,6,11,11,14,46,58,-12,44
East Fife,1735,7,13,3,20,48,67,-19,42
Forfar,1735,8,10,5,21,38,65,-27,35
Queen's Park,1735,9,7,10,19,40,72,-32,31
Albion,1735,10,8,6,22,58,84,-26,30
Ayr,1736,1,24,4,8,93,42,51,76
Raith,1736,2,22,8,6,69,34,35,74
Arbroath,1736,3,18,8,10,72,49,23,62
Alloa,1736,4,18,8,10,58,44,14,62
Stranraer,1736,5,15,5,16,55,67,-12,50
East Fife,1736,6,14,3,19,50,64,-14,45
Airdrieon,1736,7,11,11,14,47,59,-12,44
Forfar,1736,8,10,5,21,39,66,-27,35
Albion,1736,9,8,6,22,57,81,-24,30
Queen's Park,1736,10,6,10,20,40,74,-34,28
Raith,1737,1,23,8,5,69,32,37,77
Ayr,1737,2,24,4,8,95,42,53,76
Arbroath,1737,3,18,8,10,73,48,25,62
Alloa,1737,4,17,8,11,56,44,12,59
Stranraer,1737,5,16,5,15,59,64,-5,53
Airdrieon,1737,6,10,12,14,46,59,-13,42
East Fife,1737,7,13,3,20,47,68,-21,42
Forfar,1737,8,10,6,20,39,65,-26,36
Albion,1737,9,8,6,22,57,83,-26,30
Queen's Park,1737,10,6,10,20,39,75,-36,28
Ayr,1738,1,24,4,8,94,45,49,76
Raith,1738,2,22,8,6,68,34,34,74
Alloa,1738,3,18,8,10,58,43,15,62
Arbroath,1738,4,17,9,10,71,49,22,60
Stranraer,1738,5,15,5,16,55,66,-11,50
East Fife,1738,6,14,3,19,49,64,-15,45
Airdrieon,1738,7,11,11,14,50,58,-8,44
Forfar,1738,8,10,5,21,38,69,-31,35
Albion,1738,9,8,6,22,60,82,-22,30
Queen's Park,1738,10,6,11,19,40,73,-33,29
Ayr,1739,1,24,4,8,94,43,51,76
Raith,1739,2,22,9,5,69,33,36,75
Alloa,1739,3,17,9,10,57,44,13,60
Arbroath,1739,4,17,8,11,70,49,21,59
Stranraer,1739,5,15,5,16,55,65,-10,50
East Fife,1739,6,14,3,19,48,64,-16,45
Airdrieon,1739,7,11,11,14,47,59,-12,44
Forfar,1739,8,10,5,21,39,66,-27,35
Queen's Park,1739,9,7,10,19,40,72,-32,31
Albion,1739,10,8,6,22,58,82,-24,30
Raith,1740,1,23,8,5,70,33,37,77
Ayr,1740,2,24,4,8,97,43,54,76
Arbroath,1740,3,17,8,11,70,50,20,59
Alloa,1740,4,17,8,11,57,45,12,59
Stranraer,1740,5,15,5,16,55,67,-12,50
East Fife,1740,6,14,3,19,50,64,-14,45
Airdrieon,1740,7,10,11,15,46,61,-15,41
Forfar,1740,8,11,5,20,41,65,-24,38
Queen's Park,1740,9,7,10,19,41,72,-31,31
Albion,1740,10,8,6,22,58,85,-27,30
Raith,1741,1,22,9,5,69,33,36,75
Ayr,1741,2,23,5,8,92,44,48,74
Arbroath,1741,3,17,9,10,71,49,22,60
Alloa,1741,4,17,9,10,57,44,13,60
Stranraer,1741,5,15,5,16,57,67,-10,50
East Fife,1741,6,14,3,19,50,66,-16,45
Airdrieon,1741,7,11,11,14,48,60,-12,44
Forfar,1741,8,10,5,21,40,67,-27,35
Albion,1741,9,8,7,21,59,80,-21,31
Queen's Park,1741,10,6,11,19,40,73,-33,29
Raith,1742,1,23,8,5,69,32,37,77
Ayr,1742,2,24,4,8,96,42,54,76
Arbroath,1742,3,18,8,10,74,48,26,62
Alloa,1742,4,17,8,11,56,44,12,59
Stranraer,1742,5,15,5,16,56,66,-10,50
East Fife,1742,6,14,3,19,49,65,-16,45
Airdrieon,1742,7,11,11,14,48,58,-10,44
Forfar,1742,8,10,5,21,38,67,-29,35
Albion,1742,9,8,6,22,57,84,-27,30
Queen's Park,1742,10,6,10,20,39,76,-37,28
Raith,1743,1,23,8,5,71,34,37,77
Ayr,1743,2,23,4,9,92,45,47,73
Arbroath,1743,3,18,8,10,71,48,23,62
Alloa,1743,4,17,8,11,58,46,12,59
Stranraer,1743,5,16,5,15,58,65,-7,53
Airdrieon,1743,6,11,11,14,49,58,-9,44
East Fife,1743,7,13,3,20,48,67,-19,42
Forfar,1743,8,10,5,21,38,68,-30,35
Albion,1743,9,9,6,21,60,80,-20,33
Queen's Park,1743,10,6,10,20,39,73,-34,28
Raith,1744,1,23,8,5,71,33,38,77
Ayr,1744,2,24,4,8,91,42,49,76
Arbroath,1744,3,18,8,10,74,48,26,62
Alloa,1744,4,17,8,11,57,46,11,59
Stranraer,1744,5,15,5,16,57,67,-10,50
East Fife,1744,6,14,3,19,50,66,-16,45
Airdrieon,1744,7,11,11,14,48,59,-11,44
Forfar,1744,8,10,5,21,39,67,-28,35
Albion,1744,9,8,6,22,57,79,-22,30
Queen's Park,1744,10,6,10,20,39,76,-37,28
Raith,1745,1,23,8,5,70,33,37,77
Ayr,1745,2,24,4,8,95,43,52,76
Arbroath,1745,3,17,8,11,71,50,21,59
Alloa,1745,4,17,8,11,57,45,12,59
Stranraer,1745,5,15,5,16,56,66,-10,50
East Fife,1745,6,14,3,19,49,65,-16,45
Airdrieon,1745,7,10,11,15,46,60,-14,41
Forfar,1745,8,11,5,20,40,65,-25,38
Queen's Park,1745,9,7,10,19,41,73,-32,31
Albion,1745,10,8,6,22,58,83,-25,30
Ayr,1746,1,24,4,8,96,43,53,76
Raith,1746,2,22,8,6,69,34,35,74
Alloa,1746,3,18,8,10,58,44,14,62
Arbroath,1746,4,17,9,10,72,50,22,60
Stranraer,1746,5,15,5,16,57,67,-10,50
East Fife,1746,6,14,3,19,50,66,-16,45
Airdrieon,1746,7,10,11,15,45,59,-14,41
Forfar,1746,8,11,5,20,39,64,-25,38
Albion,1746,9,8,6,22,58,84,-26,30
Queen's Park,1746,10,6,11,19,41,74,-33,29
Raith,1747,1,23,8,5,71,33,38,77
Ayr,1747,2,24,4,8,95,42,53,76
Arbroath,1747,3,17,8,11,72,52,20,59
Alloa,1747,4,17,8,11,57,46,11,59
Stranraer,1747,5,15,5,16,55,65,-10,50
East Fife,1747,6,14,3,19,48,64,-16,45
Airdrieon,1747,7,11,11,14,46,58,-12,44
Forfar,1747,8,10,5,21,38,65,-27,35
Queen's Park,1747,9,7,10,19,43,74,-31,31
Albion,1747,10,8,6,22,57,83,-26,30
Ayr,1748,1,24,4,8,93,43,50,76
Raith,1748,2,22,8,6,69,34,35,74
Alloa,1748,3,18,8,10,58,44,14,62
Arbroath,1748,4,17,8,11,70,49,21,59
Stranraer,1748,5,15,5,16,55,67,-12,50
East Fife,1748,6,14,3,19,50,64,-14,45
Airdrieon,1748,7,10,11,15,45,59,-14,41
Forfar,1748,8,11,5,20,39,64,-25,38
Queen's Park,1748,9,7,10,19,40,72,-32,31
Albion,1748,10,8,6,22,58,81,-23,30
Raith,1749,1,23,8,5,71,33,38,77
Ayr,1749,2,24,4,8,95,46,49,76
Arbroath,1749,3,17,9,10,71,49,22,60
Alloa,1749,4,17,8,11,57,46,11,59
Stranraer,1749,5,16,5,15,57,64,-7,53
Airdrieon,1749,6,11,11,14,49,58,-9,44
East Fife,1749,7,13,3,20,47,66,-19,42
Forfar,1749,8,10,5,21,38,68,-30,35
Albion,1749,9,8,6,22,61,83,-22,30
Queen's Park,1749,10,6,11,19,40,73,-33,29
Raith,1750,1,23,8,5,73,33,40,77
Ayr,1750,2,24,4,8,93,43,50,76
Arbroath,1750,3,18,8,10,75,51,24,62
Alloa,1750,4,17,8,11,57,48,9,59
Stranraer,1750,5,15,5,16,55,66,-11,50
East Fife,1750,6,14,3,19,49,64,-15,45
Airdrieon,1750,7,11,11,14,49,58,-9,44
Forfar,1750,8,10,5,21,38,68,-30,35
Albion,1750,9,8,6,22,58,81,-23,30
Queen's Park,1750,10,6,10,20,42,77,-35,28
Raith,1751,1,23,8,5,70,33,37,77
Ayr,1751,2,23,5,8,92,44,48,74
Arbroath,1751,3,17,9,10,70,48,22,60
Alloa,1751,4,17,8,11,57,45,12,59
Stranraer,1751,5,16,5,15,58,65,-7,53
Airdrieon,1751,6,11,11,14,48,60,-12,44
East Fife,1751,7,13,3,20,48,67,-19,42
Forfar,1751,8,10,5,21,40,67,-27,35
Albion,1751,9,8,7,21,59,80,-21,31
Queen's Park,1751,10,6,11,19,39,72,-33,29
Raith,1752,1,23,8,5,69,32,37,77
Ayr,1752,2,23,4,9,90,43,47,73
Arbroath,1752,3,17,8,11,71,50,21,59
Alloa,1752,4,17,8,11,56,44,12,59
Stranraer,1752,5,16,5,15,57,64,-7,53
Airdrieon,1752,6,11,11,14,48,58,-10,44
East Fife,1752,7,13,3,20,47,66,-19,42
Forfar,1752,8,10,5,21,38,67,-29,35
Albion,1752,9,9,6,21,58,78,-20,33
Queen's Park,1752,10,7,10,19,41,73,-32,31
Raith,1753,1,23,8,5,72,33,39,77
Ayr,1753,2,23,5,8,92,44,48,74
Arbroath,1753,3,17,9,10,71,49,22,60
Alloa,1753,4,17,8,11,57,47,10,59
Stranraer,1753,5,15,6,15,56,65,-9,51
East Fife,1753,6,13,4,19,48,65,-17,43
Airdrieon,1753,7,10,12,14,45,58,-13,42
Forfar,1753,8,10,6,20,38,64,-26,36
Albion,1753,9,8,7,21,59,80,-21,31
Queen's Park,1753,10,6,11,19,40,73,-33,29
Raith,1754,1,23,8,5,73,32,41,77
Ayr,1754,2,24,4,8,94,42,52,76
Arbroath,1754,3,17,8,11,70,49,21,59
Alloa,1754,4,17,8,11,56,48,8,59
Stranraer,1754,5,15,5,16,55,66,-11,50
East Fife,1754,6,14,3,19,49,64,-15,45
Airdrieon,1754,7,11,11,14,47,58,-11,44
Forfar,1754,8,10,5,21,38,66,-28,35
Queen's Park,1754,9,7,10,19,40,72,-32,31
Albion,1754,10,8,6,22,57,82,-25,30
Ayr,1755,1,24,4,8,94,44,50,76
Raith,1755,2,22,8,6,69,34,35,74
Arbroath,1755,3,18,8,10,74,49,25,62
Alloa,1755,4,18,8,10,58,44,14,62
Stranraer,1755,5,15,6,15,56,65,-9,51
Airdrieon,1755,6,11,11,14,46,58,-12,44
East Fife,1755,7,13,4,19,48,65,-17,43
Forfar,1755,8,10,5,21,38,65,-27,35
Albion,1755,9,8,6,22,59,82,-23,30
Queen's Park,1755,10,6,10,20,40,76,-36,28
Raith,1756,1,23,8,5,71,32,39,77
Ayr,1756,2,24,4,8,92,43,49,76
Arbroath,1756,3,17,9,10,72,50,22,60
Alloa,1756,4,17,8,11,56,46,10,59
Stranraer,1756,5,15,5,16,55,67,-12,50
East Fife,1756,6,14,3,19,50,64,-14,45
Airdrieon,1756,7,11,11,14,46,58,-12,44
Forfar,1756,8,10,5,21,38,65,-27,35
Albion,1756,9,8,6,22,58,80,-22,30
Queen's Park,1756,10,6,11,19,41,74,-33,29
Raith,1757,1,23,8,5,69,32,37,77
Ayr,1757,2,24,4,8,93,43,50,76
Arbroath,1757,3,17,8,11,71,50,21,59
Alloa,1757,4,17,8,11,56,44,12,59
Stranraer,1757,5,15,5,16,56,66,-10,50
East Fife,1757,6,14,3,19,49,65,-16,45
Airdrieon,1757,7,10,12,14,46,59,-13,42
Forfar,1757,8,10,6,20,39,65,-26,36
Queen's Park,1757,9,7,10,19,41,73,-32,31
Albion,1757,10,8,6,22,58,81,-23,30
Raith,1758,1,23,8,5,70,33,37,77
Ayr,1758,2,24,4,8,92,43,49,76
Arbroath,1758,3,17,8,11,72,52,20,59
Alloa,1758,4,17,8,11,57,45,12,59
Stranraer,1758,5,16,5,15,57,65,-8,53
Airdrieon,1758,6,11,11,14,49,59,-10,44
East Fife,1758,7,13,3,20,48,66,-18,42
Forfar,1758,8,10,5,21,39,68,-29,35
Queen's Park,1758,9,7,10,19,43,74,-31,31
Albion,1758,10,8,6,22,58,80,-22,30
Raith,1759,1,23,8,5,70,32,38,77
Ayr,1759,2,24,4,8,93,42,51,76
Arbroath,1759,3,18,8,10,71,48,23,62
Alloa,1759,4,17,8,11,56,45,11,59
Stranraer,1759,5,15,5,16,55,65,-10,50
East Fife,1759,6,14,3,19,48,64,-16,45
Airdrieon,1759,7,11,11,14,46,58,-12,44
Forfar,1759,8,10,5,21,38,65,-27,35
Albion,1759,9,8,6,22,57,81,-24,30
Queen's Park,1759,10,6,10,20,39,73,-34,28
Raith,1760,1,23,8,5,69,32,37,77
Ayr,1760,2,24,4,8,95,44,51,76
Arbroath,1760,3,18,8,10,72,48,24,62
Alloa,1760,4,17,8,11,56,44,12,59
Stranraer,1760,5,16,5,15,59,66,-7,53
Airdrieon,1760,6,10,12,14,46,59,-13,42
East Fife,1760,7,13,3,20,49,68,-19,42
Forfar,1760,8,10,6,20,39,65,-26,36
Albion,1760,9,8,6,22,59,83,-24,30
Queen's Park,1760,10,6,10,20,39,74,-35,28
Raith,1761,1,22,8,6,68,33,35,74
Ayr,1761,2,23,4,9,90,43,47,73
Alloa,1761,3,18,8,10,57,43,14,62
Arbroath,1761,4,17,9,10,71,49,22,60
Stranraer,1761,5,16,5,15,57,64,-7,53
Airdrieon,1761,6,10,12,14,47,60,-13,42
East Fife,1761,7,13,3,20,47,66,-19,42
Forfar,1761,8,10,6,20,40,66,-26,36
Albion,1761,9,9,6,21,58,78,-20,33
Queen's Park,1761,10,6,11,19,40,73,-33,29
Raith,1762,1,23,8,5,70,33,37,77
Ayr,1762,2,24,4,8,95,45,50,76
Arbroath,1762,3,18,8,10,71,48,23,62
Alloa,1762,4,17,8,11,57,45,12,59
Stranraer,1762,5,15,5,16,57,67,-10,50
East Fife,1762,6,14,3,19,50,66,-16,45
Airdrieon,1762,7,11,11,14,46,58,-12,44
Forfar,1762,8,10,5,21,38,65,-27,35
Albion,1762,9,8,6,22,60,83,-23,30
Queen's Park,1762,10,6,10,20,39,73,-34,28
Ayr,1763,1,24,4,8,93,44,49,76
Raith,1763,2,22,9,5,69,33,36,75
Alloa,1763,3,17,9,10,57,44,13,60
Arbroath,1763,4,17,8,11,72,51,21,59
Stranraer,1763,5,15,5,16,55,65,-10,50
East Fife,1763,6,14,3,19,48,64,-16,45
Airdrieon,1763,7,10,12,14,45,58,-13,42
Forfar,1763,8,10,6,20,38,64,-26,36
Queen's Park,1763,9,7,10,19,42,74,-32,31
Albion,1763,10,8,6,22,59,81,-22,30
Raith,1764,1,23,8,5,70,32,38,77
Ayr,1764,2,24,4,8,94,42,52,76
Arbroath,1764,3,17,8,11,72,51,21,59
Alloa,1764,4,17,8,11,56,45,11,59
Stranraer,1764,5,16,5,15,59,67,-8,53
Airdrieon,1764,6,11,11,14,47,59,-12,44
East Fife,1764,7,13,3,20,50,68,-18,42
Forfar,1764,8,10,5,21,39,66,-27,35
Queen's Park,1764,9,7,10,19,42,74,-32,31
Albion,1764,10,8,6,22,57,82,-25,30
Raith,1765,1,23,8,5,72,34,38,77
Ayr,1765,2,24,4,8,94,43,51,76
Arbroath,1765,3,17,9,10,72,50,22,60
Alloa,1765,4,17,8,11,58,47,11,59
Stranraer,1765,5,15,5,16,56,66,-10,50
East Fife,1765,6,14,3,19,49,65,-16,45
Airdrieon,1765,7,11,11,14,48,60,-12,44
Forfar,1765,8,10,5,21,40,67,-27,35
Albion,1765,9,8,6,22,58,82,-24,30
Queen's Park,1765,10,6,11,19,41,74,-33,29
Raith,1766,1,23,8,5,71,33,38,77
Ayr,1766,2,24,4,8,94,43,51,76
Arbroath,1766,3,18,8,10,71,48,23,62
Alloa,1766,4,17,8,11,57,46,11,59
Stranraer,1766,5,15,5,16,57,67,-10,50
East Fife,1766,6,14,3,19,50,66,-16,45
Airdrieon,1766,7,10,12,14,46,59,-13,42
Forfar,1766,8,10,6,20,39,65,-26,36
Albion,1766,9,8,6,22,58,82,-24,30
Queen's Park,1766,10,6,10,20,39,73,-34,28
Raith,1767,1,23,8,5,71,32,39,77
Ayr,1767,2,23,4,9,90,46,44,73
Arbroath,1767,3,18,8,10,72,49,23,62
Alloa,1767,4,17,8,11,56,46,10,59
Stranraer,1767,5,15,5,16,55,65,-10,50
East Fife,1767,6,14,3,19,48,64,-16,45
Airdrieon,1767,7,10,12,14,45,58,-13,42
Forfar,1767,8,10,6,20,38,64,-26,36
Albion,1767,9,9,6,21,61,78,-17,33
Queen's Park,1767,10,6,10,20,40,74,-34,28
Raith,1768,1,23,8,5,72,32,40,77
Ayr,1768,2,24,4,8,93,44,49,76
Arbroath,1768,3,18,8,10,71,48,23,62
Alloa,1768,4,17,8,11,56,47,9,59
Stranraer,1768,5,15,6,15,57,66,-9,51
Airdrieon,1768,6,11,11,14,48,60,-12,44
East Fife,1768,7,13,4,19,49,66,-17,43
Forfar,1768,8,10,5,21,40,67,-27,35
Albion,1768,9,8,6,22,59,81,-22,30
Queen's Park,1768,10,6,10,20,39,73,-34,28
Raith,1769,1,23,8,5,70,32,38,77
Ayr,1769,2,24,4,8,94,43,51,76
Arbroath,1769,3,17,8,11,70,50,20,59
Alloa,1769,4,17,8,11,56,45,11,59
Stranraer,1769,5,15,5,16,56,66,-10,50
East Fife,1769,6,14,3,19,49,65,-16,45
Airdrieon,1769,7,11,11,14,48,59,-11,44
Forfar,1769,8,10,5,21,39,67,-28,35
Queen's Park,1769,9,7,10,19,41,72,-31,31
Albion,1769,10,8,6,22,58,82,-24,30
Ayr,1770,1,24,4,8,96,45,51,76
Raith,1770,2,22,8,6,69,34,35,74
Arbroath,1770,3,18,8,10,73,49,24,62
Alloa,1770,4,18,8,10,58,44,14,62
Stranraer,1770,5,16,5,15,59,67,-8,53
Airdrieon,1770,6,10,12,14,45,58,-13,42
East Fife,1770,7,13,3,20,50,68,-18,42
Forfar,1770,8,10,6,20,38,64,-26,36
Albion,1770,9,8,6,22,60,84,-24,30
Queen's Park,1770,10,6,10,20,40,75,-35,28
Raith,1771,1,23,8,5,70,32,38,77
Ayr,1771,2,23,5,8,92,44,48,74
Arbroath,1771,3,18,8,10,71,48,23,62
Alloa,1771,4,17,8,11,56,45,11,59
Stranraer,1771,5,16,5,15,58,66,-8,53
Airdrieon,1771,6,10,12,14,45,58,-13,42
East Fife,1771,7,13,3,20,49,67,-18,42
Forfar,1771,8,10,6,20,38,64,-26,36
Albion,1771,9,8,7,21,59,80,-21,31
Queen's Park,1771,10,6,10,20,39,73,-34,28
Raith,1772,1,23,8,5,70,33,37,77
Ayr,1772,2,24,4,8,96,43,53,76
Arbroath,1772,3,17,8,11,72,51,21,59
Alloa,1772,4,17,8,11,57,45,12,59
Stranraer,1772,5,15,6,15,56,65,-9,51
Airdrieon,1772,6,11,11,14,48,59,-11,44
East Fife,1772,7,13,4,19,48,65,-17,43
Forfar,1772,8,10,5,21,39,67,-28,35
Queen's Park,1772,9,7,10,19,42,74,-32,31
Albion,1772,10,8,6,22,58,84,-26,30
Ayr,1773,1,24,4,8,93,44,49,76
Raith,1773,2,22,9,5,69,33,36,75
Arbroath,1773,3,18,8,10,72,49,23,62
Alloa,1773,4,17,9,10,57,44,13,60
Stranraer,1773,5,15,5,16,56,69,-13,50
East Fife,1773,6,14,3,19,52,65,-13,45
Airdrieon,1773,7,10,11,15,46,60,-14,41
Forfar,1773,8,11,5,20,40,65,-25,38
Albion,1773,9,8,6,22,59,81,-22,30
Queen's Park,1773,10,6,10,20,40,74,-34,28
Ayr,1774,1,24,4,8,94,44,50,76
Raith,1774,2,22,8,6,69,37,32,74
Alloa,1774,3,18,8,10,61,44,17,62
Arbroath,1774,4,17,8,11,70,49,21,59
Stranraer,1774,5,16,5,15,57,64,-7,53
Airdrieon,1774,6,11,11,14,50,61,-11,44
East Fife,1774,7,13,3,20,47,66,-19,42
Forfar,1774,8,10,5,21,41,69,-28,35
Queen's Park,1774,9,7,10,19,40,72,-32,31
Albion,1774,10,8,6,22,59,82,-23,30
Raith,1775,1,23,8,5,70,33,37,77
Ayr,1775,2,24,4,8,92,42,50,76
Arbroath,1775,3,18,8,10,71,48,23,62
Alloa,1775,4,17,8,11,57,45,12,59
Stranraer,1775,5,16,5,15,61,65,-4,53
Airdrieon,1775,6,10,12,14,46,59,-13,42
East Fife,1775,7,13,3,20,48,70,-22,42
Forfar,1775,8,10,6,20,39,65,-26,36
Albion,1775,9,8,6,22,57,80,-23,30
Queen's Park,1775,10,6,10,20,39,73,-34,28
Ayr,1776,1,23,5,8,91,43,48,74
Raith,1776,2,22,8,6,69,34,35,74
Alloa,1776,3,18,8,10,58,44,14,62
Arbroath,1776,4,17,8,11,70,51,19,59
Stranraer,1776,5,15,5,16,55,66,-11,50
East Fife,1776,6,14,3,19,49,64,-15,45
Airdrieon,1776,7,10,12,14,48,61,-13,42
Forfar,1776,8,10,6,20,41,67,-26,36
Albion,1776,9,8,7,21,58,79,-21,31
Queen's Park,1776,10,7,10,19,42,72,-30,31
Raith,1777,1,23,8,5,71,34,37,77
Ayr,1777,2,24,4,8,94,45,49,76
Arbroath,1777,3,18,8,10,71,48,23,62
Alloa,1777,4,17,8,11,58,46,12,59
Stranraer,1777,5,15,6,15,55,64,-9,51
Airdrieon,1777,6,11,11,14,47,58,-11,44
East Fife,1777,7,13,4,19,47,64,-17,43
Forfar,1777,8,10,5,21,38,66,-28,35
Albion,1777,9,8,6,22,60,82,-22,30
Queen's Park,1777,10,6,10,20,39,73,-34,28
Ayr,1778,1,24,4,8,92,43,49,76
Raith,1778,2,22,8,6,68,33,35,74
Arbroath,1778,3,18,8,10,73,49,24,62
Alloa,1778,4,18,8,10,57,43,14,62
Stranraer,1778,5,15,6,15,56,65,-9,51
Airdrieon,1778,6,11,11,14,48,59,-11,44
East Fife,1778,7,13,4,19,48,65,-17,43
Forfar,1778,8,10,5,21,39,67,-28,35
Albion,1778,9,8,6,22,58,80,-22,30
Queen's Park,1778,10,6,10,20,40,75,-35,28
Raith,1779,1,23,8,5,70,33,37,77
Ayr,1779,2,24,4,8,93,42,51,76
Arbroath,1779,3,18,8,10,72,49,23,62
Alloa,1779,4,17,8,11,57,45,12,59
Stranraer,1779,5,15,5,16,56,66,-10,50
East Fife,1779,6,14,3,19,49,65,-16,45
Airdrieon,1779,7,11,11,14,47,59,-12,44
Forfar,1779,8,10,5,21,39,66,-27,35
Albion,1779,9,8,6,22,57,81,-24,30
Queen's Park,1779,10,6,10,20,40,74,-34,28
Raith,1780,1,23,8,5,71,33,38,77
Ayr,1780,2,24,4,8,94,44,50,76
Arbroath,1780,3,17,9,10,71,49,22,60
Alloa,1780,4,17,8,11,57,46,11,59
Stranraer,1780,5,15,5,16,56,67,-11,50
East Fife,1780,6,14,3,19,50,65,-15,45
Airdrieon,1780,7,11,11,14,49,59,-10,44
Forfar,1780,8,10,5,21,39,68,-29,35
Albion,1780,9,8,6,22,59,82,-23,30
Queen's Park,1780,10,6,11,19,40,73,-33,29
Ayr,1781,1,24,4,8,95,43,52,76
Raith,1781,2,22,9,5,68,32,36,75
Arbroath,1781,3,18,8,10,71,48,23,62
Alloa,1781,4,17,9,10,56,43,13,60
Stranraer,1781,5,15,6,15,56,65,-9,51
East Fife,1781,6,13,4,19,48,65,-17,43
Airdrieon,1781,7,10,11,15,45,60,-15,41
Forfar,1781,8,11,5,20,40,64,-24,38
Albion,1781,9,8,6,22,58,83,-25,30
Queen's Park,1781,10,6,10,20,39,73,-34,28
Ayr,1782,1,24,4,8,92,42,50,76
Raith,1782,2,22,9,5,69,33,36,75
Alloa,1782,3,17,9,10,57,44,13,60
Arbroath,1782,4,17,8,11,70,50,20,59
Stranraer,1782,5,16,5,15,59,67,-8,53
Airdrieon,1782,6,10,12,14,46,59,-13,42
East Fife,1782,7,13,3,20,50,68,-18,42
Forfar,1782,8,10,6,20,39,65,-26,36
Queen's Park,1782,9,7,10,19,41,72,-31,31
Albion,1782,10,8,6,22,57,80,-23,30
Raith,1783,1,23,8,5,70,33,37,77
Ayr,1783,2,24,4,8,92,43,49,76
Arbroath,1783,3,18,8,10,71,48,23,62
Alloa,1783,4,17,8,11,57,45,12,59
Stranraer,1783,5,15,5,16,55,66,-11,50
East Fife,1783,6,14,3,19,49,64,-15,45
Airdrieon,1783,7,10,11,15,45,61,-16,41
Forfar,1783,8,11,5,20,41,64,-23,38
Albion,1783,9,8,6,22,58,80,-22,30
Queen's Park,1783,10,6,10,20,39,73,-34,28
Raith,1784,1,23,8,5,72,33,39,77
Ayr,1784,2,24,4,8,96,42,54,76
Arbroath,1784,3,17,8,11,70,51,19,59
Alloa,1784,4,17,8,11,57,47,10,59
Stranraer,1784,5,15,5,16,56,67,-11,50
East Fife,1784,6,14,3,19,50,65,-15,45
Airdrieon,1784,7,10,12,14,47,60,-13,42
Forfar,1784,8,10,6,20,40,66,-26,36
Queen's Park,1784,9,7,10,19,42,72,-30,31
Albion,1784,10,8,6,22,57,84,-27,30
Raith,1785,1,23,8,5,70,32,38,77
Ayr,1785,2,24,4,8,94,43,51,76
Arbroath,1785,3,17,8,11,70,49,21,59
Alloa,1785,4,17,8,11,56,45,11,59
Stranraer,1785,5,15,5,16,56,67,-11,50
East Fife,1785,6,14,3,19,50,65,-15,45
Airdrieon,1785,7,11,11,14,47,58,-11,44
Forfar,1785,8,10,5,21,38,66,-28,35
Queen's Park,1785,9,7,10,19,40,72,-32,31
Albion,1785,10,8,6,22,58,82,-24,30
Raith,1786,1,23,8,5,69,32,37,77
Ayr,1786,2,23,5,8,91,43,48,74
Arbroath,1786,3,18,8,10,71,48,23,62
Alloa,1786,4,17,8,11,56,44,12,59
Stranraer,1786,5,15,5,16,55,65,-10,50
East Fife,1786,6,14,3,19,48,64,-16,45
Airdrieon,1786,7,11,11,14,46,58,-12,44
Forfar,1786,8,10,5,21,38,65,-27,35
Albion,1786,9,8,7,21,58,79,-21,31
Queen's Park,1786,10,6,10,20,39,73,-34,28
Raith,1787,1,22,9,5,69,33,36,75
Ayr,1787,2,23,4,9,91,44,47,73
Arbroath,1787,3,17,9,10,71,49,22,60
Alloa,1787,4,17,9,10,57,44,13,60
Stranraer,1787,5,15,5,16,55,65,-10,50
East Fife,1787,6,14,3,19,48,64,-16,45
Airdrieon,1787,7,10,11,15,46,61,-15,41
Forfar,1787,8,11,5,20,41,65,-24,38
Albion,1787,9,9,6,21,59,79,-20,33
Queen's Park,1787,10,6,11,19,40,73,-33,29
Raith,1788,1,23,8,5,72,34,38,77
Ayr,1788,2,24,4,8,92,42,50,76
Arbroath,1788,3,17,9,10,70,48,22,60
Alloa,1788,4,17,8,11,58,47,11,59
Stranraer,1788,5,15,5,16,55,68,-13,50
East Fife,1788,6,14,3,19,51,64,-13,45
Airdrieon,1788,7,11,11,14,48,59,-11,44
Forfar,1788,8,10,5,21,39,67,-28,35
Albion,1788,9,8,6,22,57,80,-23,30
Queen's Park,1788,10,6,11,19,39,72,-33,29
Raith,1789,1,23,8,5,70,33,37,77
Ayr,1789,2,24,4,8,95,43,52,76
Arbroath,1789,3,18,8,10,72,49,23,62
Alloa,1789,4,17,8,11,57,45,12,59
Stranraer,1789,5,15,5,16,56,66,-10,50
East Fife,1789,6,14,3,19,49,65,-16,45
Airdrieon,1789,7,11,11,14,48,59,-11,44
Forfar,1789,8,10,5,21,39,67,-28,35
Albion,1789,9,8,6,22,58,83,-25,30
Queen's Park,1789,10,6,10,20,40,74,-34,28
Ayr,1790,1,24,4,8,94,43,51,76
Raith,1790,2,22,8,6,69,35,34,74
Alloa,1790,3,18,8,10,59,44,15,62
Arbroath,1790,4,17,8,11,70,49,21,59
Stranraer,1790,5,15,5,16,56,66,-10,50
East Fife,1790,6,14,3,19,49,65,-16,45
Airdrieon,1790,7,11,11,14,46,58,-12,44
Forfar,1790,8,10,5,21,38,65,-27,35
Queen's Park,1790,9,7,10,19,40,72,-32,31
Albion,1790,10,8,6,22,58,82,-24,30
Raith,1791,1,23,8,5,70,32,38,77
Ayr,1791,2,24,4,8,94,42,52,76
Arbroath,1791,3,18,8,10,71,48,23,62
Alloa,1791,4,17,8,11,56,45,11,59
Stranraer,1791,5,15,6,15,56,65,-9,51
East Fife,1791,6,13,4,19,48,65,-17,43
Airdrieon,1791,7,10,11,15,45,60,-15,41
Forfar,1791,8,11,5,20,40,64,-24,38
Albion,1791,9,8,6,22,57,82,-25,30
Queen's Park,1791,10,6,10,20,39,73,-34,28
Raith,1792,1,23,8,5,70,33,37,77
Ayr,1792,2,24,4,8,94,44,50,76
Arbroath,1792,3,17,9,10,72,50,22,60
Alloa,1792,4,17,8,11,57,45,12,59
Stranraer,1792,5,16,5,15,59,65,-6,53
Airdrieon,1792,6,11,11,14,47,58,-11,44
East Fife,1792,7,13,3,20,48,68,-20,42
Forfar,1792,8,10,5,21,38,66,-28,35
Albion,1792,9,8,6,22,59,82,-23,30
Queen's Park,1792,10,6,11,19,41,74,-33,29
Ayr,1793,1,24,4,8,96,44,52,76
Raith,1793,2,22,8,6,68,33,35,74
Alloa,1793,3,18,8,10,57,43,14,62
Arbroath,1793,4,17,9,10,71,49,22,60
Stranraer,1793,5,16,5,15,60,66,-6,53
Airdrieon,1793,6,11,11,14,48,58,-10,44
East Fife,1793,7,13,3,20,49,69,-20,42
Forfar,1793,8,10,5,21,38,67,-29,35
Albion,1793,9,8,6,22,59,84,-25,30
Queen's Park,1793,10,6,11,19,40,73,-33,29
Raith,1794,1,23,8,5,70,32,38,77
Ayr,1794,2,24,4,8,92,42,50,76
Arbroath,1794,3,18,8,10,74,49,25,62
Alloa,1794,4,17,8,11,56,45,11,59
Stranraer,1794,5,16,5,15,56,64,-8,53
Airdrieon,1794,6,11,11,14,48,59,-11,44
East Fife,1794,7,13,3,20,47,65,-18,42
Forfar,1794,8,10,5,21,39,67,-28,35
Albion,1794,9,8,6,22,57,80,-23,30
Queen's Park,1794,10,6,10,20,40,76,-36,28
Ayr,1795,1,24,4,8,93,43,50,76
Raith,1795,2,22,8,6,69,34,35,74
Arbroath,1795,3,18,8,10,71,48,23,62
Alloa,1795,4,18,8,10,58,44,14,62
Stranraer,1795,5,15,6,15,56,65,-9,51
Airdrieon,1795,6,11,11,14,48,58,-10,44
East Fife,1795,7,13,4,19,48,65,-17,43
Forfar,1795,8,10,5,21,38,67,-29,35
Albion,1795,9,8,6,22,58,81,-23,30
Queen's Park,1795,10,6,10,20,39,73,-34,28
Raith,1796,1,23,8,5,72,32,40,77
Ayr,1796,2,24,4,8,94,43,51,76
Arbroath,1796,3,18,8,10,71,48,23,62
Alloa,1796,4,17,8,11,56,47,9,59
Stranraer,1796,5,15,5,16,56,68,-12,50
East Fife,1796,6,14,3,19,51,65,-14,45
Airdrieon,1796,7,11,11,14,47,59,-12,44
Forfar,1796,8,10,5,21,39,66,-27,35
Albion,1796,9,8,6,22,58,82,-24,30
Queen's Park,1796,10,6,10,20,39,73,-34,28
Raith,1797,1,23,8,5,70,33,37,77
Ayr,1797,2,24,4,8,94,42,52,76
Arbroath,1797,3,18,8,10,73,48,25,62
Alloa,1797,4,17,8,11,57,45,12,59
Stranraer,1797,5,15,6,15,58,67,-9,51
Airdrieon,1797,6,11,11,14,46,58,-12,44
East Fife,1797,7,13,4,19,50,67,-17,43
Forfar,1797,8,10,5,21,38,65,-27,35
Albion,1797,9,8,6,22,57,82,-25,30
Queen's Park,1797,10,6,10,20,39,75,-36,28
Raith,1798,1,23,8,5,71,33,38,77
Ayr,1798,2,23,4,9,90,43,47,73
Arbroath,1798,3,17,9,10,70,48,22,60
Alloa,1798,4,17,8,11,57,46,11,59
Stranraer,1798,5,16,5,15,56,64,-8,53
Airdrieon,1798,6,10,12,14,47,60,-13,42
East Fife,1798,7,13,3,20,47,65,-18,42
Forfar,1798,8,10,6,20,40,66,-26,36
Albion,1798,9,9,6,21,58,78,-20,33
Queen's Park,1798,10,6,11,19,39,72,-33,29
Raith,1799,1,23,8,5,72,32,40,77
Ayr,1799,2,24,4,8,94,44,50,76
Arbroath,1799,3,17,8,11,71,50,21,59
Alloa,1799,4,17,8,11,56,47,9,59
Stranraer,1799,5,16,5,15,60,65,-5,53
Airdrieon,1799,6,11,11,14,47,59,-12,44
East Fife,1799,7,13,3,20,48,69,-21,42
Forfar,1799,8,10,5,21,39,66,-27,35
Queen's Park,1799,9,7,10,19,41,73,-32,31
Albion,1799,10,8,6,22,59,82,-23,30
Ayr,1800,1,24,4,8,95,44,51,76
Raith,1800,2,22,8,6,69,34,35,74
Alloa,1800,3,18,8,10,58,44,14,62
Arbroath,1800,4,17,8,11,70,51,19,59
Stranraer,1800,5,15,5,16,56,67,-11,50
East Fife,1800,6,14,3,19,50,65,-15,45
Airdrieon,1800,7,11,11,14,47,58,-11,44
Forfar,1800,8,10,5,21,38,66,-28,35
Queen's Park,1800,9,7,10,19,42,72,-30,31
Albion,1800,10,8,6,22,59,83,-24,30
Raith,1801,1,23,8,5,69,32,37,77
Ayr,1801,2,24,4,8,94,42,52,76
Arbroath,1801,3,17,9,10,72,50,22,60
Alloa,1801,4,17,8,11,56,44,12,59
Stranraer,1801,5,16,5,15,58,65,-7,53
Airdrieon,1801,6,10,12,14,45,58,-13,42
East Fife,1801,7,13,3,20,48,67,-19,42
Forfar,1801,8,10,6,20,38,64,-26,36
Albion,1801,9,8,6,22,57,82,-25,30
Queen's Park,1801,10,6,11,19,41,74,-33,29
Raith,1802,1,23,8,5,69,32,37,77
Ayr,1802,2,24,4,8,95,44,51,76
Arbroath,1802,3,18,8,10,73,49,24,62
Alloa,1802,4,17,8,11,56,44,12,59
Stranraer,1802,5,15,5,16,56,67,-11,50
East Fife,1802,6,14,3,19,50,65,-15,45
Airdrieon,1802,7,11,11,14,48,59,-11,44
Forfar,1802,8,10,5,21,39,67,-28,35
Albion,1802,9,8,6,22,59,83,-24,30
Queen's Park,1802,10,6,10,20,40,75,-35,28
Raith,1803,1,23,8,5,71,34,37,77
Ayr,1803,2,24,4,8,96,43,53,76
Arbroath,1803,3,18,8,10,72,49,23,62
Alloa,1803,4,17,8,11,58,46,12,59
Stranraer,1803,5,16,5,15,58,66,-8,53
Airdrieon,1803,6,10,12,14,47,60,-13,42
East Fife,1803,7,13,3,20,49,67,-18,42
Forfar,1803,8,10,6,20,40,66,-26,36
Albion,1803,9,8,6,22,58,84,-26,30
Queen's Park,1803,10,6,10,20,40,74,-34,28
Raith,1804,1,23,8,5,70,33,37,77
Ayr,1804,2,24,4,8,93,42,51,76
Arbroath,1804,3,17,9,10,70,48,22,60
Alloa,1804,4,17,8,11,57,45,12,59
Stranraer,1804,5,15,6,15,58,67,-9,51
East Fife,1804,6,13,4,19,50,67,-17,43
Airdrieon,1804,7,10,12,14,48,61,-13,42
Forfar,1804,8,10,6,20,41,67,-26,36
Albion,1804,9,8,6,22,57,81,-24,30
Queen's Park,1804,10,6,11,19,39,72,-33,29
Raith,1805,1,23,8,5,72,33,39,77
Ayr,1805,2,24,4,8,96,42,54,76
Arbroath,1805,3,17,9,10,73,51,22,60
Alloa,1805,4,17,8,11,57,47,10,59
Stranraer,1805,5,15,5,16,56,67,-11,50
East Fife,1805,6,14,3,19,50,65,-15,45
Airdrieon,1805,7,11,11,14,46,58,-12,44
Forfar,1805,8,10,5,21,38,65,-27,35
Albion,1805,9,8,6,22,57,84,-27,30
Queen's Park,1805,10,6,11,19,42,75,-33,29
Raith,1806,1,23,8,5,70,33,37,77
Ayr,1806,2,23,4,9,92,45,47,73
Arbroath,1806,3,17,9,10,71,49,22,60
Alloa,1806,4,17,8,11,57,45,12,59
Stranraer,1806,5,15,5,16,56,66,-10,50
East Fife,1806,6,14,3,19,49,65,-16,45
Airdrieon,1806,7,11,11,14,47,59,-12,44
Forfar,1806,8,10,5,21,39,66,-27,35
Albion,1806,9,9,6,21,60,80,-20,33
Queen's Park,1806,10,6,11,19,40,73,-33,29
Raith,1807,1,23,8,5,71,33,38,77
Ayr,1807,2,24,4,8,94,43,51,76
Arbroath,1807,3,17,8,11,73,53,20,59
Alloa,1807,4,17,8,11,57,46,11,59
Stranraer,1807,5,15,5,16,55,65,-10,50
East Fife,1807,6,14,3,19,48,64,-16,45
Airdrieon,1807,7,11,11,14,47,58,-11,44
Forfar,1807,8,10,5,21,38,66,-28,35
Queen's Park,1807,9,7,10,19,44,75,-31,31
Albion,1807,10,8,6,22,58,82,-24,30
Raith,1808,1,22,9,5,69,33,36,75
Ayr,1808,2,23,5,8,93,45,48,74
Alloa,1808,3,17,9,10,57,44,13,60
Arbroath,1808,4,17,8,11,71,50,21,59
Stranraer,1808,5,15,5,16,55,66,-11,50
East Fife,1808,6,14,3,19,49,64,-15,45
Airdrieon,1808,7,11,11,14,47,59,-12,44
Forfar,1808,8,10,5,21,39,66,-27,35
Albion,1808,9,8,7,21,60,81,-21,31
Queen's Park,1808,10,7,10,19,41,73,-32,31
Raith,1809,1,23,8,5,72,32,40,77
Ayr,1809,2,23,4,9,91,44,47,73
Arbroath,1809,3,17,9,10,72,50,22,60
Alloa,1809,4,17,8,11,56,47,9,59
Stranraer,1809,5,15,6,15,56,65,-9,51
Airdrieon,1809,6,11,11,14,50,59,-9,44
East Fife,1809,7,13,4,19,48,65,-17,43
Forfar,1809,8,10,5,21,39,69,-30,35
Albion,1809,9,9,6,21,59,79,-20,33
Queen's Park,1809,10,6,11,19,41,74,-33,29
Ayr,1810,1,24,4,8,94,43,51,76
Raith,1810,2,22,8,6,68,34,34,74
Alloa,1810,3,18,8,10,58,43,15,62
Arbroath,1810,4,17,8,11,72,51,21,59
Stranraer,1810,5,15,5,16,58,68,-10,50
East Fife,1810,6,14,3,19,51,67,-16,45
Airdrieon,1810,7,10,12,14,46,59,-13,42
Forfar,1810,8,10,6,20,39,65,-26,36
Queen's Park,1810,9,7,10,19,42,74,-32,31
Albion,1810,10,8,6,22,58,82,-24,30
Raith,1811,1,23,8,5,70,32,38,77
Ayr,1811,2,23,5,8,93,45,48,74
Arbroath,1811,3,17,8,11,70,50,20,59
Alloa,1811,4,17,8,11,56,45,11,59
Stranraer,1811,5,16,5,15,57,65,-8,53
Airdrieon,1811,6,10,12,14,47,60,-13,42
East Fife,1811,7,13,3,20,48,66,-18,42
Forfar,1811,8,10,6,20,40,66,-26,36
Albion,1811,9,8,7,21,60,81,-21,31
Queen's Park,1811,10,7,10,19,41,72,-31,31
Raith,1812,1,23,8,5,72,34,38,77
Ayr,1812,2,24,4,8,92,43,49,76
Arbroath,1812,3,18,8,10,71,48,23,62
Alloa,1812,4,17,8,11,58,47,11,59
Stranraer,1812,5,15,5,16,55,67,-12,50
East Fife,1812,6,14,3,19,50,64,-14,45
Airdrieon,1812,7,11,11,14,47,59,-12,44
Forfar,1812,8,10,5,21,39,66,-27,35
Albion,1812,9,8,6,22,58,80,-22,30
Queen's Park,1812,10,6,10,20,39,73,-34,28
Raith,1813,1,23,8,5,71,33,38,77
Ayr,1813,2,23,5,8,92,44,48,74
Arbroath,1813,3,18,8,10,72,49,23,62
Alloa,1813,4,17,8,11,57,46,11,59
Stranraer,1813,5,15,5,16,56,66,-10,50
East Fife,1813,6,14,3,19,49,65,-16,45
Airdrieon,1813,7,11,11,14,49,58,-9,44
Forfar,1813,8,10,5,21,38,68,-30,35
Albion,1813,9,8,7,21,59,80,-21,31
Queen's Park,1813,10,6,10,20,40,74,-34,28
Raith,1814,1,23,8,5,70,32,38,77
Ayr,1814,2,24,4,8,95,44,51,76
Arbroath,1814,3,18,8,10,74,49,25,62
Alloa,1814,4,17,8,11,56,45,11,59
Stranraer,1814,5,15,6,15,57,66,-9,51
East Fife,1814,6,13,4,19,49,66,-17,43
Airdrieon,1814,7,10,12,14,46,59,-13,42
Forfar,1814,8,10,6,20,39,65,-26,36
Albion,1814,9,8,6,22,59,83,-24,30
Queen's Park,1814,10,6,10,20,40,76,-36,28
Raith,1815,1,23,8,5,69,32,37,77
Ayr,1815,2,24,4,8,93,44,49,76
Arbroath,1815,3,17,9,10,73,51,22,60
Alloa,1815,4,17,8,11,56,44,12,59
Stranraer,1815,5,16,5,15,59,65,-6,53
Airdrieon,1815,6,10,12,14,46,59,-13,42
East Fife,1815,7,13,3,20,48,68,-20,42
Forfar,1815,8,10,6,20,39,65,-26,36
Albion,1815,9,8,6,22,59,81,-22,30
Queen's Park,1815,10,6,11,19,42,75,-33,29
Raith,1816,1,23,8,5,71,32,39,77
Ayr,1816,2,23,5,8,93,45,48,74
Arbroath,1816,3,17,9,10,70,48,22,60
Alloa,1816,4,17,8,11,56,46,10,59
Stranraer,1816,5,16,5,15,56,64,-8,53
East Fife,1816,6,13,3,20,47,65,-18,42
Airdrieon,1816,7,10,11,15,45,60,-15,41
Forfar,1816,8,11,5,20,40,64,-24,38
Albion,1816,9,8,7,21,60,81,-21,31
Queen's Park,1816,10,6,11,19,39,72,-33,29
Raith,1817,1,23,8,5,71,32,39,77
Ayr,1817,2,23,5,8,92,44,48,74
Arbroath,1817,3,17,9,10,73,51,22,60
Alloa,1817,4,17,8,11,56,46,10,59
Stranraer,1817,5,15,6,15,55,64,-9,51
Airdrieon,1817,6,11,11,14,47,58,-11,44
East Fife,1817,7,13,4,19,47,64,-17,43
Forfar,1817,8,10,5,21,38,66,-28,35
Albion,1817,9,8,7,21,59,80,-21,31
Queen's Park,1817,10,6,11,19,42,75,-33,29
Raith,1818,1,23,8,5,70,32,38,77
Ayr,1818,2,24,4,8,92,42,50,76
Arbroath,1818,3,17,9,10,71,49,22,60
Alloa,1818,4,17,8,11,56,45,11,59
Stranraer,1818,5,15,5,16,56,66,-10,50
East Fife,1818,6,14,3,19,49,65,-16,45
Airdrieon,1818,7,11,11,14,49,59,-10,44
Forfar,1818,8,10,5,21,39,68,-29,35
Albion,1818,9,8,6,22,57,80,-23,30
Queen's Park,1818,10,6,11,19,40,73,-33,29
Raith,1819,1,23,8,5,69,32,37,77
Ayr,1819,2,24,4,8,91,42,49,76
Arbroath,1819,3,18,8,10,72,49,23,62
Alloa,1819,4,17,8,11,56,44,12,59
Stranraer,1819,5,16,5,15,57,64,-7,53
Airdrieon,1819,6,10,12,14,46,59,-13,42
East Fife,1819,7,13,3,20,47,66,-19,42
Forfar,1819,8,10,6,20,39,65,-26,36
Albion,1819,9,8,6,22,57,79,-22,30
Queen's Park,1819,10,6,10,20,40,74,-34,28
Ayr,1820,1,24,4,8,93,42,51,76
Raith,1820,2,22,9,5,68,32,36,75
Arbroath,1820,3,18,8,10,71,48,23,62
Alloa,1820,4,17,9,10,56,43,13,60
Stranraer,1820,5,15,5,16,55,68,-13,50
East Fife,1820,6,14,3,19,51,64,-13,45
Airdrieon,1820,7,11,11,14,46,58,-12,44
Forfar,1820,8,10,5,21,38,65,-27,35
Albion,1820,9,8,6,22,57,81,-24,30
Queen's Park,1820,10,6,10,20,39,73,-34,28
Ayr,1821,1,24,4,8,94,42,52,76
Raith,1821,2,22,9,5,68,32,36,75
Arbroath,1821,3,18,8,10,72,48,24,62
Alloa,1821,4,17,9,10,56,43,13,60
Stranraer,1821,5,15,5,16,55,65,-10,50
East Fife,1821,6,14,3,19,48,64,-16,45
Airdrieon,1821,7,11,11,14,49,60,-11,44
Forfar,1821,8,10,5,21,40,68,-28,35
Albion,1821,9,8,6,22,57,82,-25,30
Queen's Park,1821,10,6,10,20,39,74,-35,28
Ayr,1822,1,24,4,8,92,42,50,76
Raith,1822,2,22,9,5,69,33,36,75
Arbroath,1822,3,18,8,10,75,49,26,62
Alloa,1822,4,17,9,10,57,44,13,60
Stranraer,1822,5,15,6,15,56,65,-9,51
Airdrieon,1822,6,11,11,14,49,60,-11,44
East Fife,1822,7,13,4,19,48,65,-17,43
Forfar,1822,8,10,5,21,40,68,-28,35
Albion,1822,9,8,6,22,57,80,-23,30
Queen's Park,1822,10,6,10,20,40,77,-37,28
Raith,1823,1,23,8,5,72,32,40,77
Ayr,1823,2,24,4,8,93,42,51,76
Arbroath,1823,3,18,8,10,75,48,27,62
Alloa,1823,4,17,8,11,56,47,9,59
Stranraer,1823,5,15,6,15,57,66,-9,51
Airdrieon,1823,6,11,11,14,47,58,-11,44
East Fife,1823,7,13,4,19,49,66,-17,43
Forfar,1823,8,10,5,21,38,66,-28,35
Albion,1823,9,8,6,22,57,81,-24,30
Queen's Park,1823,10,6,10,20,39,77,-38,28
Ayr,1824,1,24,4,8,94,43,51,76
Raith,1824,2,22,9,5,70,34,36,75
Arbroath,1824,3,18,8,10,73,48,25,62
Alloa,1824,4,17,9,10,58,45,13,60
Stranraer,1824,5,15,6,15,56,65,-9,51
Airdrieon,1824,6,11,11,14,48,59,-11,44
East Fife,1824,7,13,4,19,48,65,-17,43
Forfar,1824,8,10,5,21,39,67,-28,35
Albion,1824,9,8,6,22,58,82,-24,30
Queen's Park,1824,10,6,10,20,39,75,-36,28
Ayr,1825,1,24,4,8,91,42,49,76
Raith,1825,2,22,9,5,69,33,36,75
Arbroath,1825,3,18,8,10,72,48,24,62
Alloa,1825,4,17,9,10,57,44,13,60
Stranraer,1825,5,15,5,16,57,67,-10,50
East Fife,1825,6,14,3,19,50,66,-16,45
Airdrieon,1825,7,10,12,14,47,60,-13,42
Forfar,1825,8,10,6,20,40,66,-26,36
Albion,1825,9,8,6,22,57,79,-22,30
Queen's Park,1825,10,6,10,20,39,74,-35,28
Raith,1826,1,23,8,5,70,33,37,77
Ayr,1826,2,24,4,8,95,46,49,76
Arbroath,1826,3,17,8,11,71,52,19,59
Alloa,1826,4,17,8,11,57,45,12,59
Stranraer,1826,5,16,5,15,58,65,-7,53
East Fife,1826,6,13,3,20,48,67,-19,42
Airdrieon,1826,7,10,11,15,45,59,-14,41
Forfar,1826,8,11,5,20,39,64,-25,38
Queen's Park,1826,9,7,10,19,43,73,-30,31
Albion,1826,10,8,6,22,61,83,-22,30
Raith,1827,1,23,8,5,74,32,42,77
Ayr,1827,2,24,4,8,96,44,52,76
Arbroath,1827,3,17,8,11,70,49,21,59
Alloa,1827,4,17,8,11,56,49,7,59
Stranraer,1827,5,15,5,16,57,68,-11,50
East Fife,1827,6,14,3,19,51,66,-15,45
Airdrieon,1827,7,11,11,14,48,60,-12,44
Forfar,1827,8,10,5,21,40,67,-27,35
Queen's Park,1827,9,7,10,19,40,72,-32,31
Albion,1827,10,8,6,22,59,84,-25,30
Ayr,1828,1,24,4,8,94,42,52,76
Raith,1828,2,22,8,6,69,34,35,74
Arbroath,1828,3,18,8,10,72,49,23,62
Alloa,1828,4,18,8,10,58,44,14,62
Stranraer,1828,5,15,5,16,57,68,-11,50
East Fife,1828,6,14,3,19,51,66,-15,45
Airdrieon,1828,7,10,12,14,45,58,-13,42
Forfar,1828,8,10,6,20,38,64,-26,36
Albion,1828,9,8,6,22,57,82,-25,30
Queen's Park,1828,10,6,10,20,40,74,-34,28
Ayr,1829,1,24,4,8,91,42,49,76
Raith,1829,2,22,8,6,68,34,34,74
Arbroath,1829,3,18,8,10,74,49,25,62
Alloa,1829,4,18,8,10,58,43,15,62
Stranraer,1829,5,15,5,16,55,67,-12,50
East Fife,1829,6,14,3,19,50,64,-14,45
Airdrieon,1829,7,10,11,15,47,61,-14,41
Forfar,1829,8,11,5,20,41,66,-25,38
Albion,1829,9,8,6,22,57,79,-22,30
Queen's Park,1829,10,6,10,20,40,76,-36,28
Ayr,1830,1,24,4,8,93,44,49,76
Raith,1830,2,22,8,6,68,33,35,74
Alloa,1830,3,18,8,10,57,43,14,62
Arbroath,1830,4,17,8,11,72,51,21,59
Stranraer,1830,5,16,5,15,58,65,-7,53
Airdrieon,1830,6,11,11,14,46,58,-12,44
East Fife,1830,7,13,3,20,48,67,-19,42
Forfar,1830,8,10,5,21,38,65,-27,35
Queen's Park,1830,9,7,10,19,42,74,-32,31
Albion,1830,10,8,6,22,59,81,-22,30
Ayr,1831,1,24,4,8,91,42,49,76
Raith,1831,2,22,9,5,68,32,36,75
Arbroath,1831,3,18,8,10,71,48,23,62
Alloa,1831,4,17,9,10,56,43,13,60
Stranraer,1831,5,16,5,15,56,64,-8,53
East Fife,1831,6,13,3,20,47,65,-18,42
Airdrieon,1831,7,10,11,15,45,59,-14,41
Forfar,1831,8,11,5,20,39,64,-25,38
Albion,1831,9,8,6,22,57,79,-22,30
Queen's Park,1831,10,6,10,20,39,73,-34,28
Raith,1832,1,23,8,5,70,32,38,77
Ayr,1832,2,23,5,8,93,45,48,74
Arbroath,1832,3,18,8,10,72,49,23,62
Alloa,1832,4,17,8,11,56,45,11,59
Stranraer,1832,5,15,5,16,56,66,-10,50
East Fife,1832,6,14,3,19,49,65,-16,45
Airdrieon,1832,7,11,11,14,46,58,-12,44
Forfar,1832,8,10,5,21,38,65,-27,35
Albion,1832,9,8,7,21,60,81,-21,31
Queen's Park,1832,10,6,10,20,40,74,-34,28
Raith,1833,1,23,8,5,72,32,40,77
Ayr,1833,2,23,5,8,93,45,48,74
Arbroath,1833,3,17,8,11,72,53,19,59
Alloa,1833,4,17,8,11,56,47,9,59
Stranraer,1833,5,15,5,16,56,66,-10,50
East Fife,1833,6,14,3,19,49,65,-16,45
Airdrieon,1833,7,11,11,14,48,59,-11,44
Forfar,1833,8,10,5,21,39,67,-28,35
Albion,1833,9,8,7,21,60,81,-21,31
Queen's Park,1833,10,7,10,19,44,74,-30,31
Ayr,1834,1,24,4,8,92,43,49,76
Raith,1834,2,22,9,5,68,32,36,75
Arbroath,1834,3,18,8,10,71,48,23,62
Alloa,1834,4,17,9,10,56,43,13,60
Stranraer,1834,5,16,5,15,59,67,-8,53
Airdrieon,1834,6,11,11,14,47,59,-12,44
East Fife,1834,7,13,3,20,50,68,-18,42
Forfar,1834,8,10,5,21,39,66,-27,35
Albion,1834,9,8,6,22,58,80,-22,30
Queen's Park,1834,10,6,10,20,39,73,-34,28
Ayr,1835,1,24,4,8,94,43,51,76
Raith,1835,2,22,9,5,68,32,36,75
Arbroath,1835,3,18,8,10,73,48,25,62
Alloa,1835,4,17,9,10,56,43,13,60
Stranraer,1835,5,15,5,16,58,68,-10,50
East Fife,1835,6,14,3,19,51,67,-16,45
Airdrieon,1835,7,10,11,15,45,59,-14,41
Forfar,1835,8,11,5,20,39,64,-25,38
Albion,1835,9,8,6,22,58,82,-24,30
Queen's Park,1835,10,6,10,20,39,75,-36,28
Raith,1836,1,23,8,5,69,32,37,77
Ayr,1836,2,24,4,8,92,43,49,76
Arbroath,1836,3,18,8,10,72,49,23,62
Alloa,1836,4,17,8,11,56,44,12,59
Stranraer,1836,5,16,5,15,57,65,-8,53
East Fife,1836,6,13,3,20,48,66,-18,42
Airdrieon,1836,7,10,11,15,45,59,-14,41
Forfar,1836,8,11,5,20,39,64,-25,38
Albion,1836,9,8,6,22,58,80,-22,30
Queen's Park,1836,10,6,10,20,40,74,-34,28
Raith,1837,1,23,8,5,71,32,39,77
Ayr,1837,2,24,4,8,92,43,49,76
Arbroath,1837,3,18,8,10,74,48,26,62
Alloa,1837,4,17,8,11,56,46,10,59
Stranraer,1837,5,16,5,15,57,65,-8,53
East Fife,1837,6,13,3,20,48,66,-18,42
Airdrieon,1837,7,10,11,15,45,60,-15,41
Forfar,1837,8,11,5,20,40,64,-24,38
Albion,1837,9,8,6,22,58,80,-22,30
Queen's Park,1837,10,6,10,20,39,76,-37,28
Ayr,1838,1,23,5,8,91,43,48,74
Raith,1838,2,22,8,6,68,33,35,74
Alloa,1838,3,18,8,10,57,43,14,62
Arbroath,1838,4,17,8,11,71,50,21,59
Stranraer,1838,5,15,5,16,55,66,-11,50
East Fife,1838,6,14,3,19,49,64,-15,45
Airdrieon,1838,7,10,12,14,47,60,-13,42
Forfar,1838,8,10,6,20,40,66,-26,36
Albion,1838,9,8,7,21,58,79,-21,31
Queen's Park,1838,10,7,10,19,41,73,-32,31
Raith,1839,1,23,8,5,70,33,37,77
Ayr,1839,2,23,5,8,91,43,48,74
Arbroath,1839,3,18,8,10,75,51,24,62
Alloa,1839,4,17,8,11,57,45,12,59
Stranraer,1839,5,15,5,16,55,68,-13,50
East Fife,1839,6,14,3,19,51,64,-13,45
Airdrieon,1839,7,11,11,14,50,59,-9,44
Forfar,1839,8,10,5,21,39,69,-30,35
Albion,1839,9,8,7,21,58,79,-21,31
Queen's Park,1839,10,6,10,20,42,77,-35,28
Ayr,1840,1,23,5,8,90,42,48,74
Raith,1840,2,22,8,6,69,35,34,74
Alloa,1840,3,18,8,10,59,44,15,62
Arbroath,1840,4,17,9,10,71,49,22,60
Stranraer,1840,5,15,5,16,55,65,-10,50
East Fife,1840,6,14,3,19,48,64,-16,45
Airdrieon,1840,7,11,11,14,47,59,-12,44
Forfar,1840,8,10,5,21,39,66,-27,35
Albion,1840,9,8,7,21,57,78,-21,31
Queen's Park,1840,10,6,11,19,40,73,-33,29
Raith,1841,1,23,8,5,71,32,39,77
Ayr,1841,2,24,4,8,96,42,54,76
Arbroath,1841,3,17,8,11,73,52,21,59
Alloa,1841,4,17,8,11,56,46,10,59
Stranraer,1841,5,16,5,15,58,65,-7,53
Airdrieon,1841,6,11,11,14,48,58,-10,44
East Fife,1841,7,13,3,20,48,67,-19,42
Forfar,1841,8,10,5,21,38,67,-29,35
Queen's Park,1841,9,7,10,19,43,75,-32,31
Albion,1841,10,8,6,22,57,84,-27,30
Ayr,1842,1,24,4,8,93,44,49,76
Raith,1842,2,22,8,6,68,34,34,74
Alloa,1842,3,18,8,10,58,43,15,62
Arbroath,1842,4,17,9,10,71,49,22,60
Stranraer,1842,5,16,5,15,58,65,-7,53
Airdrieon,1842,6,10,12,14,46,59,-13,42
East Fife,1842,7,13,3,20,48,67,-19,42
Forfar,1842,8,10,6,20,39,65,-26,36
Albion,1842,9,8,6,22,59,81,-22,30
Queen's Park,1842,10,6,11,19,40,73,-33,29
Ayr,1843,1,24,4,8,94,43,51,76
Raith,1843,2,22,9,5,68,32,36,75
Arbroath,1843,3,17,9,10,71,49,22,60
Alloa,1843,4,17,9,10,56,43,13,60
Stranraer,1843,5,15,5,16,55,66,-11,50
East Fife,1843,6,14,3,19,49,64,-15,45
Airdrieon,1843,7,10,12,14,46,59,-13,42
Forfar,1843,8,10,6,20,39,65,-26,36
Albion,1843,9,8,6,22,58,82,-24,30
Queen's Park,1843,10,6,11,19,40,73,-33,29
Ayr,1844,1,24,4,8,97,47,50,76
Raith,1844,2,22,9,5,69,33,36,75
Arbroath,1844,3,17,9,10,71,49,22,60
Alloa,1844,4,17,9,10,57,44,13,60
Stranraer,1844,5,15,6,15,56,65,-9,51
Airdrieon,1844,6,11,11,14,49,58,-9,44
East Fife,1844,7,13,4,19,48,65,-17,43
Forfar,1844,8,10,5,21,38,68,-30,35
Albion,1844,9,8,6,22,62,85,-23,30
Queen's Park,1844,10,6,11,19,40,73,-33,29
Raith,1845,1,23,8,5,70,33,37,77
Ayr,1845,2,24,4,8,95,43,52,76
Arbroath,1845,3,17,8,11,70,49,21,59
Alloa,1845,4,17,8,11,57,45,12,59
Stranraer,1845,5,15,5,16,56,66,-10,50
East Fife,1845,6,14,3,19,49,65,-16,45
Airdrieon,1845,7,11,11,14,47,59,-12,44
Forfar,1845,8,10,5,21,39,66,-27,35
Queen's Park,1845,9,7,10,19,40,72,-32,31
Albion,1845,10,8,6,22,58,83,-25,30
Raith,1846,1,23,8,5,70,32,38,77
Ayr,1846,2,24,4,8,93,43,50,76
Arbroath,1846,3,18,8,10,72,49,23,62
Alloa,1846,4,17,8,11,56,45,11,59
Stranraer,1846,5,16,5,15,56,64,-8,53
East Fife,1846,6,13,3,20,47,65,-18,42
Airdrieon,1846,7,10,11,15,47,61,-14,41
Forfar,1846,8,11,5,20,41,66,-25,38
Albion,1846,9,8,6,22,58,81,-23,30
Queen's Park,1846,10,6,10,20,40,74,-34,28
Ayr,1847,1,24,4,8,94,44,50,76
Raith,1847,2,22,8,6,69,34,35,74
Alloa,1847,3,18,8,10,58,44,14,62
Arbroath,1847,4,17,8,11,71,51,20,59
Stranraer,1847,5,15,6,15,55,64,-9,51
Airdrieon,1847,6,11,11,14,50,59,-9,44
East Fife,1847,7,13,4,19,47,64,-17,43
Forfar,1847,8,10,5,21,39,69,-30,35
Queen's Park,1847,9,7,10,19,42,73,-31,31
Albion,1847,10,8,6,22,59,82,-23,30
Ayr,1848,1,24,4,8,99,42,57,76
Raith,1848,2,22,8,6,68,34,34,74
Alloa,1848,3,18,8,10,58,43,15,62
Arbroath,1848,4,17,8,11,70,51,19,59
Stranraer,1848,5,15,5,16,57,67,-10,50
East Fife,1848,6,14,3,19,50,66,-16,45
Airdrieon,1848,7,11,11,14,49,59,-10,44
Forfar,1848,8,10,5,21,39,68,-29,35
Queen's Park,1848,9,7,10,19,42,72,-30,31
Albion,1848,10,8,6,22,57,87,-30,30
Raith,1849,1,23,8,5,70,32,38,77
Ayr,1849,2,24,4,8,93,44,49,76
Arbroath,1849,3,18,8,10,75,49,26,62
Alloa,1849,4,17,8,11,56,45,11,59
Stranraer,1849,5,15,5,16,57,67,-10,50
East Fife,1849,6,14,3,19,50,66,-16,45
Airdrieon,1849,7,10,12,14,45,58,-13,42
Forfar,1849,8,10,6,20,38,64,-26,36
Albion,1849,9,8,6,22,59,81,-22,30
Queen's Park,1849,10,6,10,20,40,77,-37,28
Raith,1850,1,23,8,5,71,32,39,77
Ayr,1850,2,24,4,8,91,42,49,76
Arbroath,1850,3,17,9,10,70,48,22,60
Alloa,1850,4,17,8,11,56,46,10,59
Stranraer,1850,5,15,5,16,56,67,-11,50
East Fife,1850,6,14,3,19,50,65,-15,45
Airdrieon,1850,7,11,11,14,50,60,-10,44
Forfar,1850,8,10,5,21,40,69,-29,35
Albion,1850,9,8,6,22,57,79,-22,30
Queen's Park,1850,10,6,11,19,39,72,-33,29
Raith,1851,1,23,8,5,70,32,38,77
Ayr,1851,2,24,4,8,93,42,51,76
Arbroath,1851,3,17,8,11,72,51,21,59
Alloa,1851,4,17,8,11,56,45,11,59
Stranraer,1851,5,15,5,16,58,68,-10,50
East Fife,1851,6,14,3,19,51,67,-16,45
Airdrieon,1851,7,11,11,14,47,59,-12,44
Forfar,1851,8,10,5,21,39,66,-27,35
Queen's Park,1851,9,7,10,19,42,74,-32,31
Albion,1851,10,8,6,22,57,81,-24,30
Raith,1852,1,23,8,5,71,32,39,77
Ayr,1852,2,24,4,8,94,43,51,76
Arbroath,1852,3,18,8,10,72,48,24,62
Alloa,1852,4,17,8,11,56,46,10,59
Stranraer,1852,5,16,5,15,57,65,-8,53
Airdrieon,1852,6,10,12,14,45,58,-13,42
East Fife,1852,7,13,3,20,48,66,-18,42
Forfar,1852,8,10,6,20,38,64,-26,36
Albion,1852,9,8,6,22,58,82,-24,30
Queen's Park,1852,10,6,10,20,39,74,-35,28
Raith,1853,1,23,8,5,71,32,39,77
Ayr,1853,2,24,4,8,93,43,50,76
Arbroath,1853,3,17,8,11,70,53,17,59
Alloa,1853,4,17,8,11,56,46,10,59
Stranraer,1853,5,15,5,16,55,65,-10,50
East Fife,1853,6,14,3,19,48,64,-16,45
Airdrieon,1853,7,11,11,14,47,59,-12,44
Forfar,1853,8,10,5,21,39,66,-27,35
Queen's Park,1853,9,7,10,19,44,72,-28,31
Albion,1853,10,8,6,22,58,81,-23,30
Ayr,1854,1,24,4,8,95,44,51,76
Raith,1854,2,22,8,6,68,33,35,74
Alloa,1854,3,18,8,10,57,43,14,62
Arbroath,1854,4,17,8,11,71,50,21,59
Stranraer,1854,5,15,5,16,57,69,-12,50
East Fife,1854,6,14,3,19,52,66,-14,45
Airdrieon,1854,7,11,11,14,47,59,-12,44
Forfar,1854,8,10,5,21,39,66,-27,35
Queen's Park,1854,9,7,10,19,41,73,-32,31
Albion,1854,10,8,6,22,59,83,-24,30
Ayr,1855,1,24,4,8,92,43,49,76
Raith,1855,2,22,9,5,68,32,36,75
Arbroath,1855,3,18,8,10,72,49,23,62
Alloa,1855,4,17,9,10,56,43,13,60
Stranraer,1855,5,15,6,15,55,64,-9,51
Airdrieon,1855,6,11,11,14,50,59,-9,44
East Fife,1855,7,13,4,19,47,64,-17,43
Forfar,1855,8,10,5,21,39,69,-30,35
Albion,1855,9,8,6,22,58,80,-22,30
Queen's Park,1855,10,6,10,20,40,74,-34,28
Ayr,1856,1,23,5,8,92,44,48,74
Raith,1856,2,22,8,6,69,35,34,74
Alloa,1856,3,18,8,10,59,44,15,62
Arbroath,1856,4,17,8,11,71,50,21,59
Stranraer,1856,5,16,5,15,58,66,-8,53
Airdrieon,1856,6,11,11,14,49,58,-9,44
East Fife,1856,7,13,3,20,49,67,-18,42
Forfar,1856,8,10,5,21,38,68,-30,35
Albion,1856,9,8,7,21,59,80,-21,31
Queen's Park,1856,10,7,10,19,41,73,-32,31
Raith,1857,1,23,8,5,70,32,38,77
Ayr,1857,2,24,4,8,94,42,52,76
Arbroath,1857,3,18,8,10,72,49,23,62
Alloa,1857,4,17,8,11,56,45,11,59
Stranraer,1857,5,15,5,16,56,66,-10,50
East Fife,1857,6,14,3,19,49,65,-16,45
Airdrieon,1857,7,11,11,14,50,60,-10,44
Forfar,1857,8,10,5,21,40,69,-29,35
Albion,1857,9,8,6,22,57,82,-25,30
Queen's Park,1857,10,6,10,20,40,74,-34,28
Ayr,1858,1,24,4,8,94,43,51,76
Raith,1858,2,22,8,6,69,34,35,74
Arbroath,1858,3,18,8,10,73,48,25,62
Alloa,1858,4,18,8,10,58,44,14,62
Stranraer,1858,5,15,5,16,56,66,-10,50
East Fife,1858,6,14,3,19,49,65,-16,45
Airdrieon,1858,7,11,11,14,48,59,-11,44
Forfar,1858,8,10,5,21,39,67,-28,35
Albion,1858,9,8,6,22,58,82,-24,30
Queen's Park,1858,10,6,10,20,39,75,-36,28
Ayr,1859,1,24,4,8,97,42,55,76
Raith,1859,2,22,9,5,71,35,36,75
Arbroath,1859,3,18,8,10,76,50,26,62
Alloa,1859,4,17,9,10,59,46,13,60
Stranraer,1859,5,15,5,16,57,67,-10,50
East Fife,1859,6,14,3,19,50,66,-16,45
Airdrieon,1859,7,11,11,14,48,59,-11,44
Forfar,1859,8,10,5,21,39,67,-28,35
Albion,1859,9,8,6,22,57,85,-28,30
Queen's Park,1859,10,6,10,20,41,78,-37,28
Raith,1860,1,23,8,5,71,32,39,77
Ayr,1860,2,24,4,8,93,44,49,76
Arbroath,1860,3,17,8,11,72,52,20,59
Alloa,1860,4,17,8,11,56,46,10,59
Stranraer,1860,5,15,5,16,56,66,-10,50
East Fife,1860,6,14,3,19,49,65,-16,45
Airdrieon,1860,7,11,11,14,47,59,-12,44
Forfar,1860,8,10,5,21,39,66,-27,35
Queen's Park,1860,9,7,10,19,43,74,-31,31
Albion,1860,10,8,6,22,59,81,-22,30
Ayr,1861,1,24,4,8,96,43,53,76
Raith,1861,2,22,8,6,68,35,33,74
Alloa,1861,3,18,8,10,59,43,16,62
Arbroath,1861,4,17,9,10,73,51,22,60
Stranraer,1861,5,15,5,16,56,68,-12,50
East Fife,1861,6,14,3,19,51,65,-14,45
Airdrieon,1861,7,10,12,14,47,60,-13,42
Forfar,1861,8,10,6,20,40,66,-26,36
Albion,1861,9,8,6,22,58,84,-26,30
Queen's Park,1861,10,6,11,19,42,75,-33,29
Raith,1862,1,23,8,5,70,32,38,77
Ayr,1862,2,24,4,8,93,43,50,76
Arbroath,1862,3,18,8,10,72,48,24,62
Alloa,1862,4,17,8,11,56,45,11,59
Stranraer,1862,5,15,5,16,57,68,-11,50
East Fife,1862,6,14,3,19,51,66,-15,45
Airdrieon,1862,7,11,11,14,47,58,-11,44
Forfar,1862,8,10,5,21,38,66,-28,35
Albion,1862,9,8,6,22,58,81,-23,30
Queen's Park,1862,10,6,10,20,39,74,-35,28
Ayr,1863,1,24,4,8,95,43,52,76
Raith,1863,2,22,8,6,68,33,35,74
Alloa,1863,3,18,8,10,57,43,14,62
Arbroath,1863,4,17,9,10,72,50,22,60
Stranraer,1863,5,15,6,15,57,66,-9,51
Airdrieon,1863,6,11,11,14,46,58,-12,44
East Fife,1863,7,13,4,19,49,66,-17,43
Forfar,1863,8,10,5,21,38,65,-27,35
Albion,1863,9,8,6,22,58,83,-25,30
Queen's Park,1863,10,6,11,19,41,74,-33,29
Ayr,1864,1,23,5,8,90,42,48,74
Raith,1864,2,22,8,6,68,33,35,74
Alloa,1864,3,18,8,10,57,43,14,62
Arbroath,1864,4,17,8,11,72,51,21,59
Stranraer,1864,5,15,6,15,56,65,-9,51
Airdrieon,1864,6,11,11,14,48,59,-11,44
East Fife,1864,7,13,4,19,48,65,-17,43
Forfar,1864,8,10,5,21,39,67,-28,35
Albion,1864,9,8,7,21,57,78,-21,31
Queen's Park,1864,10,7,10,19,42,74,-32,31
Raith,1865,1,23,8,5,71,34,37,77
Ayr,1865,2,24,4,8,96,44,52,76
Arbroath,1865,3,17,9,10,73,51,22,60
Alloa,1865,4,17,8,11,58,46,12,59
Stranraer,1865,5,15,5,16,56,68,-12,50
East Fife,1865,6,14,3,19,51,65,-14,45
Airdrieon,1865,7,10,12,14,47,60,-13,42
Forfar,1865,8,10,6,20,40,66,-26,36
Albion,1865,9,8,6,22,59,84,-25,30
Queen's Park,1865,10,6,11,19,42,75,-33,29
Raith,1866,1,23,8,5,69,32,37,77
Ayr,1866,2,24,4,8,92,43,49,76
Arbroath,1866,3,18,8,10,73,50,23,62
Alloa,1866,4,17,8,11,56,44,12,59
Stranraer,1866,5,15,5,16,55,66,-11,50
East Fife,1866,6,14,3,19,49,64,-15,45
Airdrieon,1866,7,11,11,14,50,59,-9,44
Forfar,1866,8,10,5,21,39,69,-30,35
Albion,1866,9,8,6,22,58,80,-22,30
Queen's Park,1866,10,6,10,20,41,75,-34,28
Ayr,1867,1,24,4,8,92,43,49,76
Raith,1867,2,22,8,6,69,34,35,74
Arbroath,1867,3,18,8,10,71,48,23,62
Alloa,1867,4,18,8,10,58,44,14,62
Stranraer,1867,5,15,5,16,55,65,-10,50
East Fife,1867,6,14,3,19,48,64,-16,45
Airdrieon,1867,7,11,11,14,47,58,-11,44
Forfar,1867,8,10,5,21,38,66,-28,35
Albion,1867,9,8,6,22,58,80,-22,30
Queen's Park,1867,10,6,10,20,39,73,-34,28
Raith,1868,1,23,8,5,70,32,38,77
Ayr,1868,2,24,4,8,93,44,49,76
Arbroath,1868,3,18,8,10,73,49,24,62
Alloa,1868,4,17,8,11,56,45,11,59
Stranraer,1868,5,16,5,15,57,65,-8,53
Airdrieon,1868,6,11,11,14,50,59,-9,44
East Fife,1868,7,13,3,20,48,66,-18,42
Forfar,1868,8,10,5,21,39,69,-30,35
Albion,1868,9,8,6,22,59,81,-22,30
Queen's Park,1868,10,6,10,20,40,75,-35,28
Raith,1869,1,23,8,5,71,34,37,77
Ayr,1869,2,24,4,8,95,45,50,76
Arbroath,1869,3,17,8,11,71,50,21,59
Alloa,1869,4,17,8,11,58,46,12,59
Stranraer,1869,5,16,5,15,58,66,-8,53
Airdrieon,1869,6,11,11,14,46,58,-12,44
East Fife,1869,7,13,3,20,49,67,-18,42
Forfar,1869,8,10,5,21,38,65,-27,35
Queen's Park,1869,9,7,10,19,41,73,-32,31
Albion,1869,10,8,6,22,60,83,-23,30
Raith,1870,1,23,8,5,69,32,37,77
Ayr,1870,2,24,4,8,95,42,53,76
Arbroath,1870,3,18,8,10,74,50,24,62
Alloa,1870,4,17,8,11,56,44,12,59
Stranraer,1870,5,15,5,16,56,68,-12,50
East Fife,1870,6,14,3,19,51,65,-14,45
Airdrieon,1870,7,10,11,15,45,59,-14,41
Forfar,1870,8,11,5,20,39,64,-25,38
Albion,1870,9,8,6,22,57,83,-26,30
Queen's Park,1870,10,6,10,20,41,76,-35,28
Raith,1871,1,23,8,5,70,32,38,77
Ayr,1871,2,24,4,8,93,42,51,76
Arbroath,1871,3,17,9,10,70,48,22,60
Alloa,1871,4,17,8,11,56,45,11,59
Stranraer,1871,5,16,5,15,57,65,-8,53
Airdrieon,1871,6,11,11,14,47,59,-12,44
East Fife,1871,7,13,3,20,48,66,-18,42
Forfar,1871,8,10,5,21,39,66,-27,35
Albion,1871,9,8,6,22,57,81,-24,30
Queen's Park,1871,10,6,11,19,39,72,-33,29
Ayr,1872,1,24,4,8,93,42,51,76
Raith,1872,2,22,8,6,69,34,35,74
Arbroath,1872,3,18,8,10,71,48,23,62
Alloa,1872,4,18,8,10,58,44,14,62
Stranraer,1872,5,15,6,15,56,65,-9,51
Airdrieon,1872,6,11,11,14,49,59,-10,44
East Fife,1872,7,13,4,19,48,65,-17,43
Forfar,1872,8,10,5,21,39,68,-29,35
Albion,1872,9,8,6,22,57,81,-24,30
Queen's Park,1872,10,6,10,20,39,73,-34,28
Raith,1873,1,23,8,5,70,32,38,77
Ayr,1873,2,24,4,8,95,42,53,76
Arbroath,1873,3,17,8,11,71,52,19,59
Alloa,1873,4,17,8,11,56,45,11,59
Stranraer,1873,5,15,5,16,56,67,-11,50
East Fife,1873,6,14,3,19,50,65,-15,45
Airdrieon,1873,7,11,11,14,50,59,-9,44
Forfar,1873,8,10,5,21,39,69,-30,35
Queen's Park,1873,9,7,10,19,43,73,-30,31
Albion,1873,10,8,6,22,57,83,-26,30
Raith,1874,1,23,8,5,69,32,37,77
Ayr,1874,2,24,4,8,92,42,50,76
Arbroath,1874,3,17,9,10,71,49,22,60
Alloa,1874,4,17,8,11,56,44,12,59
Stranraer,1874,5,16,5,15,57,64,-7,53
Airdrieon,1874,6,10,12,14,47,60,-13,42
East Fife,1874,7,13,3,20,47,66,-19,42
Forfar,1874,8,10,6,20,40,66,-26,36
Albion,1874,9,8,6,22,57,80,-23,30
Queen's Park,1874,10,6,11,19,40,73,-33,29
Raith,1875,1,23,8,5,71,33,38,77
Ayr,1875,2,24,4,8,93,43,50,76
Arbroath,1875,3,17,8,11,71,50,21,59
Alloa,1875,4,17,8,11,57,46,11,59
Stranraer,1875,5,16,5,15,59,66,-7,53
Airdrieon,1875,6,11,11,14,46,58,-12,44
East Fife,1875,7,13,3,20,49,68,-19,42
Forfar,1875,8,10,5,21,38,65,-27,35
Queen's Park,1875,9,7,10,19,41,73,-32,31
Albion,1875,10,8,6,22,58,81,-23,30
Raith,1876,1,23,8,5,70,32,38,77
Ayr,1876,2,24,4,8,92,42,50,76
Arbroath,1876,3,17,8,11,70,49,21,59
Alloa,1876,4,17,8,11,56,45,11,59
Stranraer,1876,5,15,6,15,58,67,-9,51
Airdrieon,1876,6,11,11,14,47,58,-11,44
East Fife,1876,7,13,4,19,50,67,-17,43
Forfar,1876,8,10,5,21,38,66,-28,35
Queen's Park,1876,9,7,10,19,40,72,-32,31
Albion,1876,10,8,6,22,57,80,-23,30
Raith,1877,1,23,8,5,70,32,38,77
Ayr,1877,2,24,4,8,92,43,49,76
Arbroath,1877,3,18,8,10,73,49,24,62
Alloa,1877,4,17,8,11,56,45,11,59
Stranraer,1877,5,15,5,16,55,65,-10,50
East Fife,1877,6,14,3,19,48,64,-16,45
Airdrieon,1877,7,11,11,14,49,59,-10,44
Forfar,1877,8,10,5,21,39,68,-29,35
Albion,1877,9,8,6,22,58,80,-22,30
Queen's Park,1877,10,6,10,20,40,75,-35,28
Raith,1878,1,23,8,5,73,33,40,77
Ayr,1878,2,24,4,8,96,42,54,76
Arbroath,1878,3,18,8,10,72,48,24,62
Alloa,1878,4,17,8,11,57,48,9,59
Stranraer,1878,5,15,5,16,55,67,-12,50
East Fife,1878,6,14,3,19,50,64,-14,45
Airdrieon,1878,7,10,11,15,45,59,-14,41
Forfar,1878,8,11,5,20,39,64,-25,38
Albion,1878,9,8,6,22,57,84,-27,30
Queen's Park,1878,10,6,10,20,39,74,-35,28
Ayr,1879,1,24,4,8,95,44,51,76
Raith,1879,2,22,8,6,69,34,35,74
Alloa,1879,3,18,8,10,58,44,14,62
Arbroath,1879,4,17,8,11,70,49,21,59
Stranraer,1879,5,15,5,16,55,65,-10,50
East Fife,1879,6,14,3,19,48,64,-16,45
Airdrieon,1879,7,11,11,14,49,58,-9,44
Forfar,1879,8,10,5,21,38,68,-30,35
Queen's Park,1879,9,7,10,19,40,72,-32,31
Albion,1879,10,8,6,22,59,83,-24,30
Raith,1880,1,23,8,5,71,34,37,77
Ayr,1880,2,24,4,8,95,42,53,76
Arbroath,1880,3,18,8,10,74,48,26,62
Alloa,1880,4,17,8,11,58,46,12,59
Stranraer,1880,5,15,5,16,55,67,-12,50
East Fife,1880,6,14,3,19,50,64,-14,45
Airdrieon,1880,7,11,11,14,48,59,-11,44
Forfar,1880,8,10,5,21,39,67,-28,35
Albion,1880,9,8,6,22,57,83,-26,30
Queen's Park,1880,10,6,10,20,39,76,-37,28
Ayr,1881,1,24,4,8,93,42,51,76
Raith,1881,2,22,8,6,68,34,34,74
Arbroath,1881,3,18,8,10,73,50,23,62
Alloa,1881,4,18,8,10,58,43,15,62
Stranraer,1881,5,15,5,16,55,67,-12,50
East Fife,1881,6,14,3,19,50,64,-14,45
Airdrieon,1881,7,11,11,14,46,58,-12,44
Forfar,1881,8,10,5,21,38,65,-27,35
Albion,1881,9,8,6,22,57,81,-24,30
Queen's Park,1881,10,6,10,20,41,75,-34,28
Raith,1882,1,23,8,5,70,32,38,77
Ayr,1882,2,24,4,8,94,44,50,76
Arbroath,1882,3,17,8,11,70,49,21,59
Alloa,1882,4,17,8,11,56,45,11,59
Stranraer,1882,5,16,5,15,57,65,-8,53
Airdrieon,1882,6,11,11,14,50,61,-11,44
East Fife,1882,7,13,3,20,48,66,-18,42
Forfar,1882,8,10,5,21,41,69,-28,35
Queen's Park,1882,9,7,10,19,40,72,-32,31
Albion,1882,10,8,6,22,59,82,-23,30
Raith,1883,1,23,8,5,70,32,38,77
Ayr,1883,2,24,4,8,97,42,55,76
Arbroath,1883,3,18,8,10,72,49,23,62
Alloa,1883,4,17,8,11,56,45,11,59
Stranraer,1883,5,15,5,16,56,66,-10,50
East Fife,1883,6,14,3,19,49,65,-16,45
Airdrieon,1883,7,10,11,15,45,59,-14,41
Forfar,1883,8,11,5,20,39,64,-25,38
Albion,1883,9,8,6,22,57,85,-28,30
Queen's Park,1883,10,6,10,20,40,74,-34,28
Raith,1884,1,23,8,5,72,32,40,77
Ayr,1884,2,24,4,8,94,43,51,76
Arbroath,1884,3,18,8,10,72,49,23,62
Alloa,1884,4,17,8,11,56,47,9,59
Stranraer,1884,5,16,5,15,58,66,-8,53
East Fife,1884,6,13,3,20,49,67,-18,42
Airdrieon,1884,7,10,11,15,45,59,-14,41
Forfar,1884,8,11,5,20,39,64,-25,38
Albion,1884,9,8,6,22,58,82,-24,30
Queen's Park,1884,10,6,10,20,40,74,-34,28
Raith,1885,1,23,8,5,70,32,38,77
Ayr,1885,2,24,4,8,94,42,52,76
Arbroath,1885,3,17,8,11,71,51,20,59
Alloa,1885,4,17,8,11,56,45,11,59
Stranraer,1885,5,15,5,16,56,67,-11,50
East Fife,1885,6,14,3,19,50,65,-15,45
Airdrieon,1885,7,11,11,14,47,58,-11,44
Forfar,1885,8,10,5,21,38,66,-28,35
Queen's Park,1885,9,7,10,19,42,73,-31,31
Albion,1885,10,8,6,22,57,82,-25,30
Raith,1886,1,23,8,5,71,33,38,77
Ayr,1886,2,24,4,8,96,42,54,76
Arbroath,1886,3,18,8,10,73,50,23,62
Alloa,1886,4,17,8,11,57,46,11,59
Stranraer,1886,5,16,5,15,57,64,-7,53
Airdrieon,1886,6,10,12,14,45,58,-13,42
East Fife,1886,7,13,3,20,47,66,-19,42
Forfar,1886,8,10,6,20,38,64,-26,36
Albion,1886,9,8,6,22,57,84,-27,30
Queen's Park,1886,10,6,10,20,41,75,-34,28
Raith,1887,1,23,8,5,71,32,39,77
Ayr,1887,2,24,4,8,94,42,52,76
Arbroath,1887,3,17,8,11,72,51,21,59
Alloa,1887,4,17,8,11,56,46,10,59
Stranraer,1887,5,16,5,15,57,64,-7,53
Airdrieon,1887,6,11,11,14,47,58,-11,44
East Fife,1887,7,13,3,20,47,66,-19,42
Forfar,1887,8,10,5,21,38,66,-28,35
Queen's Park,1887,9,7,10,19,42,74,-32,31
Albion,1887,10,8,6,22,57,82,-25,30
Raith,1888,1,23,8,5,70,33,37,77
Ayr,1888,2,24,4,8,99,48,51,76
Arbroath,1888,3,17,8,11,71,51,20,59
Alloa,1888,4,17,8,11,57,45,12,59
Stranraer,1888,5,15,6,15,56,65,-9,51
East Fife,1888,6,13,4,19,48,65,-17,43
Airdrieon,1888,7,10,11,15,46,63,-17,41
Forfar,1888,8,11,5,20,43,65,-22,38
Queen's Park,1888,9,7,10,19,42,73,-31,31
Albion,1888,10,8,6,22,63,87,-24,30
Ayr,1889,1,24,4,8,92,43,49,76
Raith,1889,2,22,9,5,70,34,36,75
Alloa,1889,3,17,9,10,58,45,13,60
Arbroath,1889,4,17,8,11,72,53,19,59
Stranraer,1889,5,15,6,15,55,64,-9,51
East Fife,1889,6,13,4,19,47,64,-17,43
Airdrieon,1889,7,10,11,15,45,61,-16,41
Forfar,1889,8,11,5,20,41,64,-23,38
Queen's Park,1889,9,7,10,19,44,74,-30,31
Albion,1889,10,8,6,22,58,80,-22,30
Raith,1890,1,23,8,5,69,32,37,77
Ayr,1890,2,24,4,8,93,42,51,76
Arbroath,1890,3,17,8,11,71,51,20,59
Alloa,1890,4,17,8,11,56,44,12,59
Stranraer,1890,5,15,6,15,59,68,-9,51
Airdrieon,1890,6,11,11,14,47,58,-11,44
East Fife,1890,7,13,4,19,51,68,-17,43
Forfar,1890,8,10,5,21,38,66,-28,35
Queen's Park,1890,9,7,10,19,42,73,-31,31
Albion,1890,10,8,6,22,57,81,-24,30
Ayr,1891,1,24,4,8,97,42,55,76
Raith,1891,2,22,9,5,69,33,36,75
Arbroath,1891,3,18,8,10,72,48,24,62
Alloa,1891,4,17,9,10,57,44,13,60
Stranraer,1891,5,15,5,16,56,69,-13,50
East Fife,1891,6,14,3,19,52,65,-13,45
Airdrieon,1891,7,11,11,14,47,58,-11,44
Forfar,1891,8,10,5,21,38,66,-28,35
Albion,1891,9,8,6,22,57,85,-28,30
Queen's Park,1891,10,6,10,20,39,74,-35,28
Ayr,1892,1,24,4,8,94,45,49,76
Raith,1892,2,22,9,5,70,34,36,75
Arbroath,1892,3,17,9,10,70,48,22,60
Alloa,1892,4,17,9,10,58,45,13,60
Stranraer,1892,5,15,5,16,55,65,-10,50
East Fife,1892,6,14,3,19,48,64,-16,45
Airdrieon,1892,7,11,11,14,47,59,-12,44
Forfar,1892,8,10,5,21,39,66,-27,35
Albion,1892,9,8,6,22,60,82,-22,30
Queen's Park,1892,10,6,11,19,39,72,-33,29
Ayr,1893,1,24,4,8,94,45,49,76
Raith,1893,2,22,8,6,68,35,33,74
Alloa,1893,3,18,8,10,59,43,16,62
Arbroath,1893,4,17,8,11,70,49,21,59
Stranraer,1893,5,15,6,15,56,65,-9,51
East Fife,1893,6,13,4,19,48,65,-17,43
Airdrieon,1893,7,10,12,14,46,59,-13,42
Forfar,1893,8,10,6,20,39,65,-26,36
Queen's Park,1893,9,7,10,19,40,72,-32,31
Albion,1893,10,8,6,22,60,82,-22,30
Raith,1894,1,23,8,5,71,33,38,77
Ayr,1894,2,24,4,8,92,43,49,76
Arbroath,1894,3,17,9,10,71,49,22,60
Alloa,1894,4,17,8,11,57,46,11,59
Stranraer,1894,5,15,6,15,56,65,-9,51
East Fife,1894,6,13,4,19,48,65,-17,43
Airdrieon,1894,7,10,12,14,46,59,-13,42
Forfar,1894,8,10,6,20,39,65,-26,36
Albion,1894,9,8,6,22,58,80,-22,30
Queen's Park,1894,10,6,11,19,40,73,-33,29
Ayr,1895,1,24,4,8,93,44,49,76
Raith,1895,2,22,9,5,69,33,36,75
Arbroath,1895,3,18,8,10,73,50,23,62
Alloa,1895,4,17,9,10,57,44,13,60
Stranraer,1895,5,15,5,16,56,66,-10,50
East Fife,1895,6,14,3,19,49,65,-16,45
Airdrieon,1895,7,11,11,14,47,58,-11,44
Forfar,1895,8,10,5,21,38,66,-28,35
Albion,1895,9,8,6,22,59,81,-22,30
Queen's Park,1895,10,6,10,20,41,75,-34,28
Raith,1896,1,23,8,5,69,32,37,77
Ayr,1896,2,23,4,9,91,45,46,73
Arbroath,1896,3,17,9,10,71,49,22,60
Alloa,1896,4,17,8,11,56,44,12,59
Stranraer,1896,5,15,5,16,55,66,-11,50
East Fife,1896,6,14,3,19,49,64,-15,45
Airdrieon,1896,7,11,11,14,48,58,-10,44
Forfar,1896,8,10,5,21,38,67,-29,35
Albion,1896,9,9,6,21,60,79,-19,33
Queen's Park,1896,10,6,11,19,40,73,-33,29
Raith,1897,1,23,8,5,69,32,37,77
Ayr,1897,2,24,4,8,93,44,49,76
Arbroath,1897,3,17,8,11,70,49,21,59
Alloa,1897,4,17,8,11,56,44,12,59
Stranraer,1897,5,16,5,15,58,64,-6,53
Airdrieon,1897,6,11,11,14,47,59,-12,44
East Fife,1897,7,13,3,20,47,67,-20,42
Forfar,1897,8,10,5,21,39,66,-27,35
Queen's Park,1897,9,7,10,19,40,72,-32,31
Albion,1897,10,8,6,22,59,81,-22,30
Ayr,1898,1,24,4,8,93,44,49,76
Raith,1898,2,22,8,6,68,33,35,74
Arbroath,1898,3,18,8,10,72,49,23,62
Alloa,1898,4,18,8,10,57,43,14,62
Stranraer,1898,5,15,6,15,56,65,-9,51
Airdrieon,1898,6,11,11,14,48,58,-10,44
East Fife,1898,7,13,4,19,48,65,-17,43
Forfar,1898,8,10,5,21,38,67,-29,35
Albion,1898,9,8,6,22,59,81,-22,30
Queen's Park,1898,10,6,10,20,40,74,-34,28
Raith,1899,1,23,8,5,71,32,39,77
Ayr,1899,2,24,4,8,92,42,50,76
Arbroath,1899,3,18,8,10,71,48,23,62
Alloa,1899,4,17,8,11,56,46,10,59
Stranraer,1899,5,15,5,16,57,67,-10,50
East Fife,1899,6,14,3,19,50,66,-16,45
Airdrieon,1899,7,10,12,14,48,61,-13,42
Forfar,1899,8,10,6,20,41,67,-26,36
Albion,1899,9,8,6,22,57,80,-23,30
Queen's Park,1899,10,6,10,20,39,73,-34,28
Raith,1900,1,23,8,5,69,32,37,77
Ayr,1900,2,24,4,8,95,43,52,76
Arbroath,1900,3,17,9,10,71,49,22,60
Alloa,1900,4,17,8,11,56,44,12,59
Stranraer,1900,5,16,5,15,57,64,-7,53
Airdrieon,1900,6,11,11,14,47,58,-11,44
East Fife,1900,7,13,3,20,47,66,-19,42
Forfar,1900,8,10,5,21,38,66,-28,35
Albion,1900,9,8,6,22,58,83,-25,30
Queen's Park,1900,10,6,11,19,40,73,-33,29
Raith,1901,1,23,8,5,70,33,37,77
Ayr,1901,2,24,4,8,95,45,50,76
Arbroath,1901,3,18,8,10,72,48,24,62
Alloa,1901,4,17,8,11,57,45,12,59
Stranraer,1901,5,16,5,15,56,64,-8,53
Airdrieon,1901,6,11,11,14,48,60,-12,44
East Fife,1901,7,13,3,20,47,65,-18,42
Forfar,1901,8,10,5,21,40,67,-27,35
Albion,1901,9,8,6,22,60,83,-23,30
Queen's Park,1901,10,6,10,20,39,74,-35,28
Raith,1902,1,23,8,5,73,34,39,77
Ayr,1902,2,24,4,8,93,44,49,76
Arbroath,1902,3,18,8,10,73,48,25,62
Alloa,1902,4,17,8,11,58,48,10,59
Stranraer,1902,5,15,6,15,56,65,-9,51
Airdrieon,1902,6,11,11,14,49,58,-9,44
East Fife,1902,7,13,4,19,48,65,-17,43
Forfar,1902,8,10,5,21,38,68,-30,35
Albion,1902,9,8,6,22,59,81,-22,30
Queen's Park,1902,10,6,10,20,39,75,-36,28
Raith,1903,1,22,8,6,68,34,34,74
Ayr,1903,2,23,4,9,91,45,46,73
Alloa,1903,3,18,8,10,58,43,15,62
Arbroath,1903,4,17,8,11,71,51,20,59
Stranraer,1903,5,15,5,16,55,66,-11,50
East Fife,1903,6,14,3,19,49,64,-15,45
Airdrieon,1903,7,11,11,14,48,58,-10,44
Forfar,1903,8,10,5,21,38,67,-29,35
Albion,1903,9,9,6,21,60,79,-19,33
Queen's Park,1903,10,7,10,19,42,73,-31,31
Raith,1904,1,23,8,5,71,33,38,77
Ayr,1904,2,24,4,8,94,44,50,76
Arbroath,1904,3,18,8,10,73,48,25,62
Alloa,1904,4,17,8,11,57,46,11,59
Stranraer,1904,5,15,6,15,58,67,-9,51
Airdrieon,1904,6,11,11,14,48,58,-10,44
East Fife,1904,7,13,4,19,50,67,-17,43
Forfar,1904,8,10,5,21,38,67,-29,35
Albion,1904,9,8,6,22,59,82,-23,30
Queen's Park,1904,10,6,10,20,39,75,-36,28
Raith,1905,1,23,8,5,70,33,37,77
Ayr,1905,2,23,5,8,92,44,48,74
Arbroath,1905,3,17,8,11,71,50,21,59
Alloa,1905,4,17,8,11,57,45,12,59
Stranraer,1905,5,15,6,15,55,64,-9,51
Airdrieon,1905,6,11,11,14,49,60,-11,44
East Fife,1905,7,13,4,19,47,64,-17,43
Forfar,1905,8,10,5,21,40,68,-28,35
Albion,1905,9,8,7,21,59,80,-21,31
Queen's Park,1905,10,7,10,19,41,73,-32,31
Raith,1906,1,23,8,5,71,33,38,77
Ayr,1906,2,24,4,8,92,43,49,76
Arbroath,1906,3,17,8,11,70,51,19,59
Alloa,1906,4,17,8,11,57,46,11,59
Stranraer,1906,5,16,5,15,58,66,-8,53
Airdrieon,1906,6,11,11,14,47,59,-12,44
East Fife,1906,7,13,3,20,49,67,-18,42
Forfar,1906,8,10,5,21,39,66,-27,35
Queen's Park,1906,9,7,10,19,42,72,-30,31
Albion,1906,10,8,6,22,58,80,-22,30
Ayr,1907,1,24,4,8,92,43,49,76
Raith,1907,2,22,8,6,69,34,35,74
Alloa,1907,3,18,8,10,58,44,14,62
Arbroath,1907,4,17,9,10,71,49,22,60
Stranraer,1907,5,15,6,15,57,66,-9,51
East Fife,1907,6,13,4,19,49,66,-17,43
Airdrieon,1907,7,10,12,14,47,60,-13,42
Forfar,1907,8,10,6,20,40,66,-26,36
Albion,1907,9,8,6,22,58,80,-22,30
Queen's Park,1907,10,6,11,19,40,73,-33,29
Raith,1908,1,23,8,5,70,33,37,77
Ayr,1908,2,24,4,8,95,42,53,76
Arbroath,1908,3,18,8,10,74,49,25,62
Alloa,1908,4,17,8,11,57,45,12,59
Stranraer,1908,5,15,5,16,55,67,-12,50
East Fife,1908,6,14,3,19,50,64,-14,45
Airdrieon,1908,7,10,12,14,47,60,-13,42
Forfar,1908,8,10,6,20,40,66,-26,36
Albion,1908,9,8,6,22,57,83,-26,30
Queen's Park,1908,10,6,10,20,40,76,-36,28
Raith,1909,1,23,8,5,71,32,39,77
Ayr,1909,2,24,4,8,94,42,52,76
Arbroath,1909,3,18,8,10,71,48,23,62
Alloa,1909,4,17,8,11,56,46,10,59
Stranraer,1909,5,15,5,16,56,67,-11,50
East Fife,1909,6,14,3,19,50,65,-15,45
Airdrieon,1909,7,10,12,14,46,59,-13,42
Forfar,1909,8,10,6,20,39,65,-26,36
Albion,1909,9,8,6,22,57,82,-25,30
Queen's Park,1909,10,6,10,20,39,73,-34,28
Ayr,1910,1,24,4,8,92,42,50,76
Raith,1910,2,22,9,5,68,32,36,75
Arbroath,1910,3,17,9,10,71,49,22,60
Alloa,1910,4,17,9,10,56,43,13,60
Stranraer,1910,5,16,5,15,57,64,-7,53
Airdrieon,1910,6,11,11,14,47,58,-11,44
East Fife,1910,7,13,3,20,47,66,-19,42
Forfar,1910,8,10,5,21,38,66,-28,35
Albion,1910,9,8,6,22,57,80,-23,30
Queen's Park,1910,10,6,11,19,40,73,-33,29
Raith,1911,1,23,8,5,70,33,37,77
Ayr,1911,2,24,4,8,93,44,49,76
Arbroath,1911,3,17,9,10,72,50,22,60
Alloa,1911,4,17,8,11,57,45,12,59
Stranraer,1911,5,15,6,15,56,65,-9,51
East Fife,1911,6,13,4,19,48,65,-17,43
Airdrieon,1911,7,10,11,15,46,60,-14,41
Forfar,1911,8,11,5,20,40,65,-25,38
Albion,1911,9,8,6,22,59,81,-22,30
Queen's Park,1911,10,6,11,19,41,74,-33,29
Raith,1912,1,23,8,5,70,32,38,77
Ayr,1912,2,24,4,8,98,42,56,76
Arbroath,1912,3,17,9,10,71,49,22,60
Alloa,1912,4,17,8,11,56,45,11,59
Stranraer,1912,5,15,5,16,56,67,-11,50
East Fife,1912,6,14,3,19,50,65,-15,45
Airdrieon,1912,7,11,11,14,47,59,-12,44
Forfar,1912,8,10,5,21,39,66,-27,35
Albion,1912,9,8,6,22,57,86,-29,30
Queen's Park,1912,10,6,11,19,40,73,-33,29
Raith,1913,1,23,8,5,71,32,39,77
Ayr,1913,2,24,4,8,96,43,53,76
Arbroath,1913,3,18,8,10,72,49,23,62
Alloa,1913,4,17,8,11,56,46,10,59
Stranraer,1913,5,15,5,16,55,67,-12,50
East Fife,1913,6,14,3,19,50,64,-14,45
Airdrieon,1913,7,11,11,14,50,61,-11,44
Forfar,1913,8,10,5,21,41,69,-28,35
Albion,1913,9,8,6,22,58,84,-26,30
Queen's Park,1913,10,6,10,20,40,74,-34,28
Raith,1914,1,23,8,5,70,32,38,77
Ayr,1914,2,24,4,8,98,42,56,76
Arbroath,1914,3,18,8,10,74,49,25,62
Alloa,1914,4,17,8,11,56,45,11,59
Stranraer,1914,5,15,5,16,55,65,-10,50
East Fife,1914,6,14,3,19,48,64,-16,45
Airdrieon,1914,7,11,11,14,48,59,-11,44
Forfar,1914,8,10,5,21,39,67,-28,35
Albion,1914,9,8,6,22,57,86,-29,30
Queen's Park,1914,10,6,10,20,40,76,-36,28
Raith,1915,1,23,8,5,72,32,40,77
Ayr,1915,2,23,4,9,92,45,47,73
Arbroath,1915,3,17,9,10,71,49,22,60
Alloa,1915,4,17,8,11,56,47,9,59
Stranraer,1915,5,15,6,15,56,65,-9,51
East Fife,1915,6,13,4,19,48,65,-17,43
Airdrieon,1915,7,10,12,14,46,59,-13,42
Forfar,1915,8,10,6,20,39,65,-26,36
Albion,1915,9,9,6,21,60,80,-20,33
Queen's Park,1915,10,6,11,19,40,73,-33,29
Raith,1916,1,23,8,5,70,32,38,77
Ayr,1916,2,24,4,8,95,42,53,76
Arbroath,1916,3,18,8,10,72,48,24,62
Alloa,1916,4,17,8,11,56,45,11,59
Stranraer,1916,5,15,5,16,56,66,-10,50
East Fife,1916,6,14,3,19,49,65,-16,45
Airdrieon,1916,7,10,12,14,46,59,-13,42
Forfar,1916,8,10,6,20,39,65,-26,36
Albion,1916,9,8,6,22,57,83,-26,30
Queen's Park,1916,10,6,10,20,39,74,-35,28
Raith,1917,1,23,8,5,69,32,37,77
Ayr,1917,2,23,4,9,92,45,47,73
Arbroath,1917,3,18,8,10,71,48,23,62
Alloa,1917,4,17,8,11,56,44,12,59
Stranraer,1917,5,15,6,15,56,65,-9,51
Airdrieon,1917,6,11,11,14,46,58,-12,44
East Fife,1917,7,13,4,19,48,65,-17,43
Forfar,1917,8,10,5,21,38,65,-27,35
Albion,1917,9,9,6,21,60,80,-20,33
Queen's Park,1917,10,6,10,20,39,73,-34,28
Raith,1918,1,23,8,5,72,32,40,77
Ayr,1918,2,23,4,9,91,45,46,73
Arbroath,1918,3,18,8,10,74,51,23,62
Alloa,1918,4,17,8,11,56,47,9,59
Stranraer,1918,5,16,5,15,58,65,-7,53
Airdrieon,1918,6,11,11,14,46,58,-12,44
East Fife,1918,7,13,3,20,48,67,-19,42
Forfar,1918,8,10,5,21,38,65,-27,35
Albion,1918,9,9,6,21,60,79,-19,33
Queen's Park,1918,10,6,10,20,42,76,-34,28
Raith,1919,1,23,8,5,71,34,37,77
Ayr,1919,2,24,4,8,94,42,52,76
Arbroath,1919,3,17,9,10,71,49,22,60
Alloa,1919,4,17,8,11,58,46,12,59
Stranraer,1919,5,15,5,16,57,68,-11,50
East Fife,1919,6,14,3,19,51,66,-15,45
Airdrieon,1919,7,10,11,15,46,60,-14,41
Forfar,1919,8,11,5,20,40,65,-25,38
Albion,1919,9,8,6,22,57,82,-25,30
Queen's Park,1919,10,6,11,19,40,73,-33,29
Raith,1920,1,23,8,5,70,32,38,77
Ayr,1920,2,24,4,8,96,43,53,76
Arbroath,1920,3,18,8,10,72,49,23,62
Alloa,1920,4,17,8,11,56,45,11,59
Stranraer,1920,5,16,5,15,56,64,-8,53
Airdrieon,1920,6,11,11,14,48,59,-11,44
East Fife,1920,7,13,3,20,47,65,-18,42
Forfar,1920,8,10,5,21,39,67,-28,35
Albion,1920,9,8,6,22,58,84,-26,30
Queen's Park,1920,10,6,10,20,40,74,-34,28
Raith,1921,1,22,9,5,68,32,36,75
Ayr,1921,2,23,5,8,91,43,48,74
Alloa,1921,3,17,9,10,56,43,13,60
Arbroath,1921,4,17,8,11,70,50,20,59
Stranraer,1921,5,15,5,16,55,69,-14,50
East Fife,1921,6,14,3,19,52,64,-12,45
Airdrieon,1921,7,10,11,15,46,60,-14,41
Forfar,1921,8,11,5,20,40,65,-25,38
Albion,1921,9,8,7,21,58,79,-21,31
Queen's Park,1921,10,7,10,19,41,72,-31,31
Ayr,1922,1,24,4,8,92,42,50,76
Raith,1922,2,22,9,5,70,34,36,75
Arbroath,1922,3,18,8,10,71,48,23,62
Alloa,1922,4,17,9,10,58,45,13,60
Stranraer,1922,5,15,5,16,56,66,-10,50
East Fife,1922,6,14,3,19,49,65,-16,45
Airdrieon,1922,7,11,11,14,48,60,-12,44
Forfar,1922,8,10,5,21,40,67,-27,35
Albion,1922,9,8,6,22,57,80,-23,30
Queen's Park,1922,10,6,10,20,39,73,-34,28
Raith,1923,1,23,8,5,69,32,37,77
Ayr,1923,2,24,4,8,94,42,52,76
Arbroath,1923,3,17,8,11,71,50,21,59
Alloa,1923,4,17,8,11,56,44,12,59
Stranraer,1923,5,15,6,15,56,65,-9,51
East Fife,1923,6,13,4,19,48,65,-17,43
Airdrieon,1923,7,10,12,14,46,59,-13,42
Forfar,1923,8,10,6,20,39,65,-26,36
Queen's Park,1923,9,7,10,19,41,73,-32,31
Albion,1923,10,8,6,22,57,82,-25,30
Raith,1924,1,23,8,5,69,32,37,77
Ayr,1924,2,24,4,8,92,43,49,76
Arbroath,1924,3,17,9,10,71,49,22,60
Alloa,1924,4,17,8,11,56,44,12,59
Stranraer,1924,5,15,6,15,56,65,-9,51
Airdrieon,1924,6,11,11,14,48,59,-11,44
East Fife,1924,7,13,4,19,48,65,-17,43
Forfar,1924,8,10,5,21,39,67,-28,35
Albion,1924,9,8,6,22,58,80,-22,30
Queen's Park,1924,10,6,11,19,40,73,-33,29
Ayr,1925,1,23,5,8,92,44,48,74
Raith,1925,2,22,8,6,68,33,35,74
Alloa,1925,3,18,8,10,57,43,14,62
Arbroath,1925,4,17,9,10,71,49,22,60
Stranraer,1925,5,15,6,15,56,65,-9,51
Airdrieon,1925,6,11,11,14,49,59,-10,44
East Fife,1925,7,13,4,19,48,65,-17,43
Forfar,1925,8,10,5,21,39,68,-29,35
Albion,1925,9,8,7,21,59,80,-21,31
Queen's Park,1925,10,6,11,19,40,73,-33,29
Raith,1926,1,23,8,5,69,32,37,77
Ayr,1926,2,23,4,9,91,44,47,73
Arbroath,1926,3,17,9,10,71,49,22,60
Alloa,1926,4,17,8,11,56,44,12,59
Stranraer,1926,5,15,5,16,57,67,-10,50
East Fife,1926,6,14,3,19,50,66,-16,45
Airdrieon,1926,7,11,11,14,47,59,-12,44
Forfar,1926,8,10,5,21,39,66,-27,35
Albion,1926,9,9,6,21,59,79,-20,33
Queen's Park,1926,10,6,11,19,40,73,-33,29
Raith,1927,1,22,9,5,68,32,36,75
Ayr,1927,2,23,5,8,91,43,48,74
Arbroath,1927,3,17,9,10,71,49,22,60
Alloa,1927,4,17,9,10,56,43,13,60
Stranraer,1927,5,15,5,16,57,67,-10,50
East Fife,1927,6,14,3,19,50,66,-16,45
Airdrieon,1927,7,10,11,15,45,60,-15,41
Forfar,1927,8,11,5,20,40,64,-24,38
Albion,1927,9,8,7,21,58,79,-21,31
Queen's Park,1927,10,6,11,19,40,73,-33,29
Ayr,1928,1,24,4,8,93,42,51,76
Raith,1928,2,22,8,6,69,34,35,74
Arbroath,1928,3,18,8,10,74,48,26,62
Alloa,1928,4,18,8,10,58,44,14,62
Stranraer,1928,5,15,5,16,55,68,-13,50
East Fife,1928,6,14,3,19,51,64,-13,45
Airdrieon,1928,7,10,12,14,45,58,-13,42
Forfar,1928,8,10,6,20,38,64,-26,36
Albion,1928,9,8,6,22,57,81,-24,30
Queen's Park,1928,10,6,10,20,39,76,-37,28
Raith,1929,1,23,8,5,72,32,40,77
Ayr,1929,2,24,4,8,94,44,50,76
Arbroath,1929,3,17,8,11,70,50,20,59
Alloa,1929,4,17,8,11,56,47,9,59
Stranraer,1929,5,15,6,15,55,64,-9,51
East Fife,1929,6,13,4,19,47,64,-17,43
Airdrieon,1929,7,10,12,14,47,60,-13,42
Forfar,1929,8,10,6,20,40,66,-26,36
Queen's Park,1929,9,7,10,19,41,72,-31,31
Albion,1929,10,8,6,22,59,82,-23,30
Raith,1930,1,23,8,5,70,33,37,77
Ayr,1930,2,24,4,8,92,42,50,76
Arbroath,1930,3,17,8,11,70,49,21,59
Alloa,1930,4,17,8,11,57,45,12,59
Stranraer,1930,5,15,6,15,55,64,-9,51
East Fife,1930,6,13,4,19,47,64,-17,43
Airdrieon,1930,7,10,12,14,47,60,-13,42
Forfar,1930,8,10,6,20,40,66,-26,36
Queen's Park,1930,9,7,10,19,40,72,-32,31
Albion,1930,10,8,6,22,57,80,-23,30
Ayr,1931,1,24,4,8,94,44,50,76
Raith,1931,2,22,8,6,68,33,35,74
Alloa,1931,3,18,8,10,57,43,14,62
Arbroath,1931,4,17,8,11,70,50,20,59
Stranraer,1931,5,15,6,15,56,65,-9,51
East Fife,1931,6,13,4,19,48,65,-17,43
Airdrieon,1931,7,10,11,15,45,59,-14,41
Forfar,1931,8,11,5,20,39,64,-25,38
Queen's Park,1931,9,7,10,19,41,72,-31,31
Albion,1931,10,8,6,22,59,82,-23,30
Raith,1932,1,23,8,5,69,32,37,77
Ayr,1932,2,24,4,8,92,43,49,76
Arbroath,1932,3,17,8,11,72,53,19,59
Alloa,1932,4,17,8,11,56,44,12,59
Stranraer,1932,5,15,6,15,56,65,-9,51
Airdrieon,1932,6,11,11,14,46,58,-12,44
East Fife,1932,7,13,4,19,48,65,-17,43
Forfar,1932,8,10,5,21,38,65,-27,35
Queen's Park,1932,9,7,10,19,44,74,-30,31
Albion,1932,10,8,6,22,58,80,-22,30
Raith,1933,1,23,8,5,69,32,37,77
Ayr,1933,2,24,4,8,95,44,51,76
Arbroath,1933,3,18,8,10,73,48,25,62
Alloa,1933,4,17,8,11,56,44,12,59
Stranraer,1933,5,15,6,15,57,66,-9,51
Airdrieon,1933,6,11,11,14,48,60,-12,44
East Fife,1933,7,13,4,19,49,66,-17,43
Forfar,1933,8,10,5,21,40,67,-27,35
Albion,1933,9,8,6,22,59,83,-24,30
Queen's Park,1933,10,6,10,20,39,75,-36,28
Raith,1934,1,23,8,5,70,33,37,77
Ayr,1934,2,24,4,8,93,42,51,76
Arbroath,1934,3,17,8,11,71,50,21,59
Alloa,1934,4,17,8,11,57,45,12,59
Stranraer,1934,5,15,5,16,58,69,-11,50
East Fife,1934,6,14,3,19,52,67,-15,45
Airdrieon,1934,7,11,11,14,48,59,-11,44
Forfar,1934,8,10,5,21,39,67,-28,35
Queen's Park,1934,9,7,10,19,41,73,-32,31
Albion,1934,10,8,6,22,57,81,-24,30
Raith,1935,1,22,9,5,70,34,36,75
Ayr,1935,2,23,5,8,90,42,48,74
Arbroath,1935,3,18,8,10,73,49,24,62
Alloa,1935,4,17,9,10,58,45,13,60
Stranraer,1935,5,16,5,15,57,65,-8,53
Airdrieon,1935,6,11,11,14,46,58,-12,44
East Fife,1935,7,13,3,20,48,66,-18,42
Forfar,1935,8,10,5,21,38,65,-27,35
Albion,1935,9,8,7,21,57,78,-21,31
Queen's Park,1935,10,6,10,20,40,75,-35,28
Raith,1936,1,23,8,5,70,33,37,77
Ayr,1936,2,24,4,8,95,44,51,76
Arbroath,1936,3,17,9,10,72,50,22,60
Alloa,1936,4,17,8,11,57,45,12,59
Stranraer,1936,5,15,5,16,55,66,-11,50
East Fife,1936,6,14,3,19,49,64,-15,45
Airdrieon,1936,7,11,11,14,47,59,-12,44
Forfar,1936,8,10,5,21,39,66,-27,35
Albion,1936,9,8,6,22,59,83,-24,30
Queen's Park,1936,10,6,11,19,41,74,-33,29
Ayr,1937,1,24,4,8,95,42,53,76
Raith,1937,2,22,8,6,68,34,34,74
Arbroath,1937,3,18,8,10,71,48,23,62
Alloa,1937,4,18,8,10,58,43,15,62
Stranraer,1937,5,16,5,15,59,64,-5,53
Airdrieon,1937,6,11,11,14,49,60,-11,44
East Fife,1937,7,13,3,20,47,68,-21,42
Forfar,1937,8,10,5,21,40,68,-28,35
Albion,1937,9,8,6,22,57,83,-26,30
Queen's Park,1937,10,6,10,20,39,73,-34,28
Raith,1938,1,23,8,5,70,32,38,77
Ayr,1938,2,24,4,8,92,42,50,76
Arbroath,1938,3,17,8,11,71,50,21,59
Alloa,1938,4,17,8,11,56,45,11,59
Stranraer,1938,5,16,5,15,56,64,-8,53
Airdrieon,1938,6,11,11,14,48,60,-12,44
East Fife,1938,7,13,3,20,47,65,-18,42
Forfar,1938,8,10,5,21,40,67,-27,35
Queen's Park,1938,9,7,10,19,41,73,-32,31
Albion,1938,10,8,6,22,57,80,-23,30
Ayr,1939,1,24,4,8,93,44,49,76
Raith,1939,2,22,9,5,68,32,36,75
Arbroath,1939,3,17,9,10,72,50,22,60
Alloa,1939,4,17,9,10,56,43,13,60
Stranraer,1939,5,15,6,15,57,66,-9,51
Airdrieon,1939,6,11,11,14,46,58,-12,44
East Fife,1939,7,13,4,19,49,66,-17,43
Forfar,1939,8,10,5,21,38,65,-27,35
Albion,1939,9,8,6,22,59,81,-22,30
Queen's Park,1939,10,6,11,19,41,74,-33,29
Raith,1940,1,23,8,5,72,32,40,77
Ayr,1940,2,24,4,8,96,44,52,76
Arbroath,1940,3,18,8,10,73,49,24,62
Alloa,1940,4,17,8,11,56,47,9,59
Stranraer,1940,5,15,5,16,55,65,-10,50
East Fife,1940,6,14,3,19,48,64,-16,45
Airdrieon,1940,7,11,11,14,46,58,-12,44
Forfar,1940,8,10,5,21,38,65,-27,35
Albion,1940,9,8,6,22,59,84,-25,30
Queen's Park,1940,10,6,10,20,40,75,-35,28
Raith,1941,1,23,8,5,70,32,38,77
Ayr,1941,2,24,4,8,95,42,53,76
Arbroath,1941,3,18,8,10,73,50,23,62
Alloa,1941,4,17,8,11,56,45,11,59
Stranraer,1941,5,16,5,15,59,65,-6,53
Airdrieon,1941,6,11,11,14,48,58,-10,44
East Fife,1941,7,13,3,20,48,68,-20,42
Forfar,1941,8,10,5,21,38,67,-29,35
Albion,1941,9,8,6,22,57,83,-26,30
Queen's Park,1941,10,6,10,20,41,75,-34,28
Ayr,1942,1,24,4,8,92,43,49,76
Raith,1942,2,22,8,6,69,34,35,74
Arbroath,1942,3,18,8,10,72,49,23,62
Alloa,1942,4,18,8,10,58,44,14,62
Stranraer,1942,5,15,5,16,57,67,-10,50
East Fife,1942,6,14,3,19,50,66,-16,45
Airdrieon,1942,7,11,11,14,48,58,-10,44
Forfar,1942,8,10,5,21,38,67,-29,35
Albion,1942,9,8,6,22,58,80,-22,30
Queen's Park,1942,10,6,10,20,40,74,-34,28
Ayr,1943,1,24,4,8,94,43,51,76
Raith,1943,2,22,8,6,68,33,35,74
Alloa,1943,3,18,8,10,57,43,14,62
Arbroath,1943,4,17,9,10,72,50,22,60
Stranraer,1943,5,15,5,16,56,66,-10,50
East Fife,1943,6,14,3,19,49,65,-16,45
Airdrieon,1943,7,11,11,14,48,59,-11,44
Forfar,1943,8,10,5,21,39,67,-28,35
Albion,1943,9,8,6,22,58,82,-24,30
Queen's Park,1943,10,6,11,19,41,74,-33,29
Raith,1944,1,23,8,5,71,33,38,77
Ayr,1944,2,24,4,8,94,42,52,76
Arbroath,1944,3,18,8,10,72,48,24,62
Alloa,1944,4,17,8,11,57,46,11,59
Stranraer,1944,5,15,5,16,56,67,-11,50
East Fife,1944,6,14,3,19,50,65,-15,45
Airdrieon,1944,7,11,11,14,47,58,-11,44
Forfar,1944,8,10,5,21,38,66,-28,35
Albion,1944,9,8,6,22,57,82,-25,30
Queen's Park,1944,10,6,10,20,39,74,-35,28
Raith,1945,1,23,8,5,70,33,37,77
Ayr,1945,2,23,5,8,91,43,48,74
Arbroath,1945,3,17,9,10,71,49,22,60
Alloa,1945,4,17,8,11,57,45,12,59
Stranraer,1945,5,16,5,15,58,64,-6,53
Airdrieon,1945,6,11,11,14,46,58,-12,44
East Fife,1945,7,13,3,20,47,67,-20,42
Forfar,1945,8,10,5,21,38,65,-27,35
Albion,1945,9,8,7,21,58,79,-21,31
Queen's Park,1945,10,6,11,19,40,73,-33,29
Raith,1946,1,23,8,5,69,32,37,77
Ayr,1946,2,24,4,8,97,43,54,76
Arbroath,1946,3,18,8,10,75,48,27,62
Alloa,1946,4,17,8,11,56,44,12,59
Stranraer,1946,5,15,5,16,56,66,-10,50
East Fife,1946,6,14,3,19,49,65,-16,45
Airdrieon,1946,7,11,11,14,47,58,-11,44
Forfar,1946,8,10,5,21,38,66,-28,35
Albion,1946,9,8,6,22,58,85,-27,30
Queen's Park,1946,10,6,10,20,39,77,-38,28
Raith,1947,1,23,8,5,71,33,38,77
Ayr,1947,2,23,5,8,91,43,48,74
Arbroath,1947,3,17,9,10,71,49,22,60
Alloa,1947,4,17,8,11,57,46,11,59
Stranraer,1947,5,16,5,15,58,66,-8,53
East Fife,1947,6,13,3,20,49,67,-18,42
Airdrieon,1947,7,10,11,15,45,60,-15,41
Forfar,1947,8,11,5,20,40,64,-24,38
Albion,1947,9,8,7,21,58,79,-21,31
Queen's Park,1947,10,6,11,19,40,73,-33,29
Ayr,1948,1,24,4,8,94,42,52,76
Raith,1948,2,22,8,6,68,33,35,74
Alloa,1948,3,18,8,10,57,43,14,62
Arbroath,1948,4,17,9,10,70,48,22,60
Stranraer,1948,5,15,5,16,56,66,-10,50
East Fife,1948,6,14,3,19,49,65,-16,45
Airdrieon,1948,7,11,11,14,48,59,-11,44
Forfar,1948,8,10,5,21,39,67,-28,35
Albion,1948,9,8,6,22,57,82,-25,30
Queen's Park,1948,10,6,11,19,39,72,-33,29
Raith,1949,1,23,8,5,69,32,37,77
Ayr,1949,2,24,4,8,94,45,49,76
Arbroath,1949,3,17,8,11,71,50,21,59
Alloa,1949,4,17,8,11,56,44,12,59
Stranraer,1949,5,16,5,15,56,64,-8,53
Airdrieon,1949,6,10,12,14,47,60,-13,42
East Fife,1949,7,13,3,20,47,65,-18,42
Forfar,1949,8,10,6,20,40,66,-26,36
Queen's Park,1949,9,7,10,19,41,73,-32,31
Albion,1949,10,8,6,22,60,82,-22,30
Raith,1950,1,23,8,5,70,32,38,77
Ayr,1950,2,24,4,8,92,42,50,76
Arbroath,1950,3,18,8,10,71,48,23,62
Alloa,1950,4,17,8,11,56,45,11,59
Stranraer,1950,5,15,6,15,56,65,-9,51
Airdrieon,1950,6,11,11,14,47,58,-11,44
East Fife,1950,7,13,4,19,48,65,-17,43
Forfar,1950,8,10,5,21,38,66,-28,35
Albion,1950,9,8,6,22,57,80,-23,30
Queen's Park,1950,10,6,10,20,39,73,-34,28
Raith,1951,1,23,8,5,70,33,37,77
Ayr,1951,2,24,4,8,92,42,50,76
Arbroath,1951,3,18,8,10,73,49,24,62
Alloa,1951,4,17,8,11,57,45,12,59
Stranraer,1951,5,15,6,15,58,67,-9,51
Airdrieon,1951,6,11,11,14,46,58,-12,44
East Fife,1951,7,13,4,19,50,67,-17,43
Forfar,1951,8,10,5,21,38,65,-27,35
Albion,1951,9,8,6,22,57,80,-23,30
Queen's Park,1951,10,6,10,20,40,75,-35,28
Raith,1952,1,23,8,5,70,33,37,77
Ayr,1952,2,23,5,8,92,44,48,74
Arbroath,1952,3,18,8,10,72,49,23,62
Alloa,1952,4,17,8,11,57,45,12,59
Stranraer,1952,5,15,5,16,56,67,-11,50
East Fife,1952,6,14,3,19,50,65,-15,45
Airdrieon,1952,7,10,11,15,45,60,-15,41
Forfar,1952,8,11,5,20,40,64,-24,38
Albion,1952,9,8,7,21,59,80,-21,31
Queen's Park,1952,10,6,10,20,40,74,-34,28
Raith,1953,1,23,8,5,71,32,39,77
Ayr,1953,2,23,4,9,91,46,45,73
Arbroath,1953,3,18,8,10,72,48,24,62
Alloa,1953,4,17,8,11,56,46,10,59
Stranraer,1953,5,15,5,16,55,66,-11,50
East Fife,1953,6,14,3,19,49,64,-15,45
Airdrieon,1953,7,10,12,14,46,59,-13,42
Forfar,1953,8,10,6,20,39,65,-26,36
Albion,1953,9,9,6,21,61,79,-18,33
Queen's Park,1953,10,6,10,20,39,74,-35,28
Raith,1954,1,23,8,5,69,32,37,77
Ayr,1954,2,24,4,8,94,44,50,76
Arbroath,1954,3,18,8,10,72,49,23,62
Alloa,1954,4,17,8,11,56,44,12,59
Stranraer,1954,5,15,6,15,57,66,-9,51
East Fife,1954,6,13,4,19,49,66,-17,43
Airdrieon,1954,7,10,12,14,46,59,-13,42
Forfar,1954,8,10,6,20,39,65,-26,36
Albion,1954,9,8,6,22,59,82,-23,30
Queen's Park,1954,10,6,10,20,40,74,-34,28
Ayr,1955,1,24,4,8,97,45,52,76
Raith,1955,2,22,8,6,68,34,34,74
Alloa,1955,3,18,8,10,58,43,15,62
Arbroath,1955,4,17,9,10,72,50,22,60
Stranraer,1955,5,15,5,16,56,68,-12,50
East Fife,1955,6,14,3,19,51,65,-14,45
Airdrieon,1955,7,11,11,14,47,59,-12,44
Forfar,1955,8,10,5,21,39,66,-27,35
Albion,1955,9,8,6,22,60,85,-25,30
Queen's Park,1955,10,6,11,19,41,74,-33,29
Raith,1956,1,23,8,5,69,32,37,77
Ayr,1956,2,24,4,8,94,43,51,76
Arbroath,1956,3,17,9,10,72,50,22,60
Alloa,1956,4,17,8,11,56,44,12,59
Stranraer,1956,5,15,6,15,56,65,-9,51
Airdrieon,1956,6,11,11,14,48,59,-11,44
East Fife,1956,7,13,4,19,48,65,-17,43
Forfar,1956,8,10,5,21,39,67,-28,35
Albion,1956,9,8,6,22,58,82,-24,30
Queen's Park,1956,10,6,11,19,41,74,-33,29
Raith,1957,1,23,8,5,70,32,38,77
Ayr,1957,2,24,4,8,93,43,50,76
Arbroath,1957,3,17,8,11,71,50,21,59
Alloa,1957,4,17,8,11,56,45,11,59
Stranraer,1957,5,15,5,16,56,66,-10,50
East Fife,1957,6,14,3,19,49,65,-16,45
Airdrieon,1957,7,11,11,14,46,58,-12,44
Forfar,1957,8,10,5,21,38,65,-27,35
Queen's Park,1957,9,7,10,19,41,73,-32,31
Albion,1957,10,8,6,22,58,81,-23,30
Raith,1958,1,23,8,5,70,33,37,77
Ayr,1958,2,24,4,8,96,44,52,76
Arbroath,1958,3,18,8,10,72,49,23,62
Alloa,1958,4,17,8,11,57,45,12,59
Stranraer,1958,5,15,6,15,57,66,-9,51
East Fife,1958,6,13,4,19,49,66,-17,43
Airdrieon,1958,7,10,11,15,45,60,-15,41
Forfar,1958,8,11,5,20,40,64,-24,38
Albion,1958,9,8,6,22,59,84,-25,30
Queen's Park,1958,10,6,10,20,40,74,-34,28
Ayr,1959,1,24,4,8,94,43,51,76
Raith,1959,2,22,9,5,69,33,36,75
Arbroath,1959,3,18,8,10,72,49,23,62
Alloa,1959,4,17,9,10,57,44,13,60
Stranraer,1959,5,16,5,15,58,65,-7,53
East Fife,1959,6,13,3,20,48,67,-19,42
Airdrieon,1959,7,10,11,15,46,60,-14,41
Forfar,1959,8,11,5,20,40,65,-25,38
Albion,1959,9,8,6,22,58,82,-24,30
Queen's Park,1959,10,6,10,20,40,74,-34,28
Raith,1960,1,23,8,5,71,33,38,77
Ayr,1960,2,24,4,8,91,42,49,76
Arbroath,1960,3,18,8,10,74,48,26,62
Alloa,1960,4,17,8,11,57,46,11,59
Stranraer,1960,5,15,6,15,57,66,-9,51
Airdrieon,1960,6,11,11,14,46,58,-12,44
East Fife,1960,7,13,4,19,49,66,-17,43
Forfar,1960,8,10,5,21,38,65,-27,35
Albion,1960,9,8,6,22,57,79,-22,30
Queen's Park,1960,10,6,10,20,39,76,-37,28
Raith,1961,1,23,8,5,72,33,39,77
Ayr,1961,2,24,4,8,94,44,50,76
Arbroath,1961,3,17,8,11,71,51,20,59
Alloa,1961,4,17,8,11,57,47,10,59
Stranraer,1961,5,15,5,16,58,68,-10,50
East Fife,1961,6,14,3,19,51,67,-16,45
Airdrieon,1961,7,10,12,14,45,58,-13,42
Forfar,1961,8,10,6,20,38,64,-26,36
Queen's Park,1961,9,7,10,19,42,73,-31,31
Albion,1961,10,8,6,22,59,82,-23,30
Ayr,1962,1,24,4,8,92,43,49,76
Raith,1962,2,22,9,5,68,32,36,75
Arbroath,1962,3,18,8,10,77,48,29,62
Alloa,1962,4,17,9,10,56,43,13,60
Stranraer,1962,5,16,5,15,58,66,-8,53
East Fife,1962,6,13,3,20,49,67,-18,42
Airdrieon,1962,7,10,11,15,46,60,-14,41
Forfar,1962,8,11,5,20,40,65,-25,38
Albion,1962,9,8,6,22,58,80,-22,30
Queen's Park,1962,10,6,10,20,39,79,-40,28
Raith,1963,1,23,8,5,72,32,40,77
Ayr,1963,2,24,4,8,93,44,49,76
Arbroath,1963,3,18,8,10,74,48,26,62
Alloa,1963,4,17,8,11,56,47,9,59
Stranraer,1963,5,15,6,15,57,66,-9,51
East Fife,1963,6,13,4,19,49,66,-17,43
Airdrieon,1963,7,10,12,14,46,59,-13,42
Forfar,1963,8,10,6,20,39,65,-26,36
Albion,1963,9,8,6,22,59,81,-22,30
Queen's Park,1963,10,6,10,20,39,76,-37,28
Ayr,1964,1,24,4,8,94,43,51,76
Raith,1964,2,22,9,5,69,33,36,75
Arbroath,1964,3,17,9,10,70,48,22,60
Alloa,1964,4,17,9,10,57,44,13,60
Stranraer,1964,5,15,6,15,55,64,-9,51
Airdrieon,1964,6,11,11,14,47,59,-12,44
East Fife,1964,7,13,4,19,47,64,-17,43
Forfar,1964,8,10,5,21,39,66,-27,35
Albion,1964,9,8,6,22,58,82,-24,30
Queen's Park,1964,10,6,11,19,39,72,-33,29
Raith,1965,1,23,8,5,74,35,39,77
Ayr,1965,2,23,5,8,92,44,48,74
Arbroath,1965,3,17,8,11,71,51,20,59
Alloa,1965,4,17,8,11,59,49,10,59
Stranraer,1965,5,15,5,16,55,66,-11,50
East Fife,1965,6,14,3,19,49,64,-15,45
Airdrieon,1965,7,11,11,14,48,58,-10,44
Forfar,1965,8,10,5,21,38,67,-29,35
Albion,1965,9,8,7,21,59,80,-21,31
Queen's Park,1965,10,7,10,19,42,73,-31,31
Ayr,1966,1,24,4,8,93,44,49,76
Raith,1966,2,22,8,6,69,35,34,74
Arbroath,1966,3,18,8,10,72,49,23,62
Alloa,1966,4,18,8,10,59,44,15,62
Stranraer,1966,5,15,5,16,56,66,-10,50
East Fife,1966,6,14,3,19,49,65,-16,45
Airdrieon,1966,7,11,11,14,48,59,-11,44
Forfar,1966,8,10,5,21,39,67,-28,35
Albion,1966,9,8,6,22,59,81,-22,30
Queen's Park,1966,10,6,10,20,40,74,-34,28
Raith,1967,1,23,8,5,70,32,38,77
Ayr,1967,2,24,4,8,94,43,51,76
Arbroath,1967,3,18,8,10,71,48,23,62
Alloa,1967,4,17,8,11,56,45,11,59
Stranraer,1967,5,15,6,15,56,65,-9,51
Airdrieon,1967,6,11,11,14,46,58,-12,44
East Fife,1967,7,13,4,19,48,65,-17,43
Forfar,1967,8,10,5,21,38,65,-27,35
Albion,1967,9,8,6,22,58,82,-24,30
Queen's Park,1967,10,6,10,20,39,73,-34,28
Ayr,1968,1,24,4,8,95,44,51,76
Raith,1968,2,22,9,5,70,34,36,75
Arbroath,1968,3,17,9,10,72,50,22,60
Alloa,1968,4,17,9,10,58,45,13,60
Stranraer,1968,5,15,6,15,58,67,-9,51
East Fife,1968,6,13,4,19,50,67,-17,43
Airdrieon,1968,7,10,11,15,45,60,-15,41
Forfar,1968,8,11,5,20,40,64,-24,38
Albion,1968,9,8,6,22,59,83,-24,30
Queen's Park,1968,10,6,11,19,41,74,-33,29
Ayr,1969,1,24,4,8,95,44,51,76
Raith,1969,2,22,8,6,70,35,35,74
Arbroath,1969,3,18,8,10,74,48,26,62
Alloa,1969,4,18,8,10,59,45,14,62
Stranraer,1969,5,15,6,15,56,65,-9,51
East Fife,1969,6,13,4,19,48,65,-17,43
Airdrieon,1969,7,10,12,14,45,58,-13,42
Forfar,1969,8,10,6,20,38,64,-26,36
Albion,1969,9,8,6,22,59,83,-24,30
Queen's Park,1969,10,6,10,20,39,76,-37,28
Raith,1970,1,23,8,5,71,32,39,77
Ayr,1970,2,24,4,8,93,42,51,76
Arbroath,1970,3,17,9,10,71,49,22,60
Alloa,1970,4,17,8,11,56,46,10,59
Stranraer,1970,5,16,5,15,56,64,-8,53
East Fife,1970,6,13,3,20,47,65,-18,42
Airdrieon,1970,7,10,11,15,47,62,-15,41
Forfar,1970,8,11,5,20,42,66,-24,38
Albion,1970,9,8,6,22,57,81,-24,30
Queen's Park,1970,10,6,11,19,40,73,-33,29
Raith,1971,1,23,8,5,71,34,37,77
Ayr,1971,2,24,4,8,93,43,50,76
Arbroath,1971,3,18,8,10,75,48,27,62
Alloa,1971,4,17,8,11,58,46,12,59
Stranraer,1971,5,15,5,16,55,65,-10,50
East Fife,1971,6,14,3,19,48,64,-16,45
Airdrieon,1971,7,11,11,14,50,59,-9,44
Forfar,1971,8,10,5,21,39,69,-30,35
Albion,1971,9,8,6,22,58,81,-23,30
Queen's Park,1971,10,6,10,20,39,77,-38,28
Ayr,1972,1,24,4,8,92,42,50,76
Raith,1972,2,22,8,6,70,36,34,74
Arbroath,1972,3,18,8,10,72,48,24,62
Alloa,1972,4,18,8,10,60,45,15,62
Stranraer,1972,5,16,5,15,57,65,-8,53
Airdrieon,1972,6,10,12,14,47,60,-13,42
East Fife,1972,7,13,3,20,48,66,-18,42
Forfar,1972,8,10,6,20,40,66,-26,36
Albion,1972,9,8,6,22,57,80,-23,30
Queen's Park,1972,10,6,10,20,39,74,-35,28
Raith,1973,1,23,8,5,70,33,37,77
Ayr,1973,2,24,4,8,96,45,51,76
Arbroath,1973,3,18,8,10,73,50,23,62
Alloa,1973,4,17,8,11,57,45,12,59
Stranraer,1973,5,15,6,15,57,66,-9,51
East Fife,1973,6,13,4,19,49,66,-17,43
Airdrieon,1973,7,10,12,14,47,60,-13,42
Forfar,1973,8,10,6,20,40,66,-26,36
Albion,1973,9,8,6,22,60,84,-24,30
Queen's Park,1973,10,6,10,20,41,75,-34,28
Raith,1974,1,23,8,5,71,33,38,77
Ayr,1974,2,23,5,8,93,45,48,74
Arbroath,1974,3,17,9,10,71,49,22,60
Alloa,1974,4,17,8,11,57,46,11,59
Stranraer,1974,5,15,5,16,57,67,-10,50
East Fife,1974,6,14,3,19,50,66,-16,45
Airdrieon,1974,7,11,11,14,48,58,-10,44
Forfar,1974,8,10,5,21,38,67,-29,35
Albion,1974,9,8,7,21,60,81,-21,31
Queen's Park,1974,10,6,11,19,40,73,-33,29
Raith,1975,1,23,8,5,72,32,40,77
Ayr,1975,2,23,4,9,91,44,47,73
Arbroath,1975,3,18,8,10,73,48,25,62
Alloa,1975,4,17,8,11,56,47,9,59
Stranraer,1975,5,15,5,16,55,65,-10,50
East Fife,1975,6,14,3,19,48,64,-16,45
Airdrieon,1975,7,11,11,14,46,58,-12,44
Forfar,1975,8,10,5,21,38,65,-27,35
Albion,1975,9,9,6,21,59,79,-20,33
Queen's Park,1975,10,6,10,20,39,75,-36,28
Ayr,1976,1,24,4,8,97,42,55,76
Raith,1976,2,22,9,5,70,34,36,75
Arbroath,1976,3,18,8,10,72,48,24,62
Alloa,1976,4,17,9,10,58,45,13,60
Stranraer,1976,5,15,6,15,57,66,-9,51
East Fife,1976,6,13,4,19,49,66,-17,43
Airdrieon,1976,7,10,11,15,46,60,-14,41
Forfar,1976,8,11,5,20,40,65,-25,38
Albion,1976,9,8,6,22,57,85,-28,30
Queen's Park,1976,10,6,10,20,39,74,-35,28
Ayr,1977,1,24,4,8,92,43,49,76
Raith,1977,2,22,8,6,69,34,35,74
Arbroath,1977,3,18,8,10,73,49,24,62
Alloa,1977,4,18,8,10,58,44,14,62
Stranraer,1977,5,16,5,15,57,65,-8,53
East Fife,1977,6,13,3,20,48,66,-18,42
Airdrieon,1977,7,10,11,15,46,60,-14,41
Forfar,1977,8,11,5,20,40,65,-25,38
Albion,1977,9,8,6,22,58,80,-22,30
Queen's Park,1977,10,6,10,20,40,75,-35,28
Ayr,1978,1,24,4,8,92,43,49,76
Raith,1978,2,22,8,6,69,34,35,74
Alloa,1978,3,18,8,10,58,44,14,62
Arbroath,1978,4,17,8,11,70,51,19,59
Stranraer,1978,5,15,6,15,56,65,-9,51
Airdrieon,1978,6,11,11,14,47,59,-12,44
East Fife,1978,7,13,4,19,48,65,-17,43
Forfar,1978,8,10,5,21,39,66,-27,35
Queen's Park,1978,9,7,10,19,42,72,-30,31
Albion,1978,10,8,6,22,58,80,-22,30
Raith,1979,1,23,8,5,70,32,38,77
Ayr,1979,2,23,4,9,91,44,47,73
Arbroath,1979,3,17,8,11,71,51,20,59
Alloa,1979,4,17,8,11,56,45,11,59
Stranraer,1979,5,16,5,15,59,67,-8,53
Airdrieon,1979,6,11,11,14,47,59,-12,44
East Fife,1979,7,13,3,20,50,68,-18,42
Forfar,1979,8,10,5,21,39,66,-27,35
Albion,1979,9,9,6,21,59,79,-20,33
Queen's Park,1979,10,7,10,19,42,73,-31,31
Ayr,1980,1,24,4,8,94,45,49,76
Raith,1980,2,22,8,6,69,34,35,74
Arbroath,1980,3,18,8,10,72,48,24,62
Alloa,1980,4,18,8,10,58,44,14,62
Stranraer,1980,5,15,6,15,55,64,-9,51
Airdrieon,1980,6,11,11,14,46,58,-12,44
East Fife,1980,7,13,4,19,47,64,-17,43
Forfar,1980,8,10,5,21,38,65,-27,35
Albion,1980,9,8,6,22,60,82,-22,30
Queen's Park,1980,10,6,10,20,39,74,-35,28
Raith,1981,1,23,8,5,70,32,38,77
Ayr,1981,2,24,4,8,93,43,50,76
Arbroath,1981,3,18,8,10,72,48,24,62
Alloa,1981,4,17,8,11,56,45,11,59
Stranraer,1981,5,15,5,16,56,66,-10,50
East Fife,1981,6,14,3,19,49,65,-16,45
Airdrieon,1981,7,10,11,15,45,60,-15,41
Forfar,1981,8,11,5,20,40,64,-24,38
Albion,1981,9,8,6,22,58,81,-23,30
Queen's Park,1981,10,6,10,20,39,74,-35,28
Raith,1982,1,22,8,6,69,35,34,74
Ayr,1982,2,23,4,9,93,48,45,73
Alloa,1982,3,18,8,10,59,44,15,62
Arbroath,1982,4,17,8,11,70,50,20,59
Stranraer,1982,5,15,5,16,56,66,-10,50
East Fife,1982,6,14,3,19,49,65,-16,45
Airdrieon,1982,7,11,11,14,48,59,-11,44
Forfar,1982,8,10,5,21,39,67,-28,35
Albion,1982,9,9,6,21,63,81,-18,33
Queen's Park,1982,10,7,10,19,41,72,-31,31
Ayr,1983,1,24,4,8,94,42,52,76
Raith,1983,2,22,8,6,69,34,35,74
Alloa,1983,3,18,8,10,58,44,14,62
Arbroath,1983,4,17,9,10,71,49,22,60
Stranraer,1983,5,15,5,16,56,67,-11,50
East Fife,1983,6,14,3,19,50,65,-15,45
Airdrieon,1983,7,10,12,14,45,58,-13,42
Forfar,1983,8,10,6,20,38,64,-26,36
Albion,1983,9,8,6,22,57,82,-25,30
Queen's Park,1983,10,6,11,19,40,73,-33,29
Raith,1984,1,23,8,5,70,32,38,77
Ayr,1984,2,24,4,8,91,42,49,76
Arbroath,1984,3,18,8,10,73,50,23,62
Alloa,1984,4,17,8,11,56,45,11,59
Stranraer,1984,5,15,6,15,56,65,-9,51
Airdrieon,1984,6,11,11,14,47,58,-11,44
East Fife,1984,7,13,4,19,48,65,-17,43
Forfar,1984,8,10,5,21,38,66,-28,35
Albion,1984,9,8,6,22,57,79,-22,30
Queen's Park,1984,10,6,10,20,41,75,-34,28
Ayr,1985,1,24,4,8,97,42,55,76
Raith,1985,2,22,8,6,69,34,35,74
Alloa,1985,3,18,8,10,58,44,14,62
Arbroath,1985,4,17,8,11,70,50,20,59
Stranraer,1985,5,15,6,15,57,66,-9,51
East Fife,1985,6,13,4,19,49,66,-17,43
Airdrieon,1985,7,10,12,14,45,58,-13,42
Forfar,1985,8,10,6,20,38,64,-26,36
Queen's Park,1985,9,7,10,19,41,72,-31,31
Albion,1985,10,8,6,22,57,85,-28,30
Raith,1986,1,23,8,5,69,32,37,77
Ayr,1986,2,23,5,8,91,43,48,74
Arbroath,1986,3,17,9,10,73,51,22,60
Alloa,1986,4,17,8,11,56,44,12,59
Stranraer,1986,5,15,5,16,55,65,-10,50
East Fife,1986,6,14,3,19,48,64,-16,45
Airdrieon,1986,7,11,11,14,48,59,-11,44
Forfar,1986,8,10,5,21,39,67,-28,35
Albion,1986,9,8,7,21,58,79,-21,31
Queen's Park,1986,10,6,11,19,42,75,-33,29
Ayr,1987,1,24,4,8,96,43,53,76
Raith,1987,2,22,9,5,69,33,36,75
Arbroath,1987,3,18,8,10,72,48,24,62
Alloa,1987,4,17,9,10,57,44,13,60
Stranraer,1987,5,15,5,16,56,66,-10,50
East Fife,1987,6,14,3,19,49,65,-16,45
Airdrieon,1987,7,11,11,14,47,59,-12,44
Forfar,1987,8,10,5,21,39,66,-27,35
Albion,1987,9,8,6,22,58,84,-26,30
Queen's Park,1987,10,6,10,20,39,74,-35,28
Raith,1988,1,23,8,5,70,32,38,77
Ayr,1988,2,24,4,8,92,42,50,76
Arbroath,1988,3,18,8,10,73,50,23,62
Alloa,1988,4,17,8,11,56,45,11,59
Stranraer,1988,5,16,5,15,58,66,-8,53
Airdrieon,1988,6,11,11,14,47,58,-11,44
East Fife,1988,7,13,3,20,49,67,-18,42
Forfar,1988,8,10,5,21,38,66,-28,35
Albion,1988,9,8,6,22,57,80,-23,30
Queen's Park,1988,10,6,10,20,41,75,-34,28
Raith,1989,1,22,9,5,69,33,36,75
Ayr,1989,2,23,5,8,91,43,48,74
Alloa,1989,3,17,9,10,57,44,13,60
Arbroath,1989,4,17,8,11,71,50,21,59
Stranraer,1989,5,16,5,15,56,64,-8,53
Airdrieon,1989,6,10,12,14,46,59,-13,42
East Fife,1989,7,13,3,20,47,65,-18,42
Forfar,1989,8,10,6,20,39,65,-26,36
Albion,1989,9,8,7,21,58,79,-21,31
Queen's Park,1989,10,7,10,19,41,73,-32,31
Ayr,1990,1,24,4,8,95,45,50,76
Raith,1990,2,22,8,6,68,34,34,74
Arbroath,1990,3,18,8,10,73,49,24,62
Alloa,1990,4,18,8,10,58,43,15,62
Stranraer,1990,5,15,6,15,57,66,-9,51
East Fife,1990,6,13,4,19,49,66,-17,43
Airdrieon,1990,7,10,12,14,47,60,-13,42
Forfar,1990,8,10,6,20,40,66,-26,36
Albion,1990,9,8,6,22,60,83,-23,30
Queen's Park,1990,10,6,10,20,40,75,-35,28
Ayr,1991,1,23,5,8,93,45,48,74
Raith,1991,2,22,8,6,68,33,35,74
Alloa,1991,3,18,8,10,57,43,14,62
Arbroath,1991,4,17,8,11,71,53,18,59
Stranraer,1991,5,16,5,15,56,64,-8,53
East Fife,1991,6,13,3,20,47,65,-18,42
Airdrieon,1991,7,10,11,15,46,60,-14,41
Forfar,1991,8,11,5,20,40,65,-25,38
Albion,1991,9,8,7,21,60,81,-21,31
Queen's Park,1991,10,7,10,19,44,73,-29,31
Raith,1992,1,23,8,5,71,34,37,77
Ayr,1992,2,24,4,8,95,43,52,76
Arbroath,1992,3,18,8,10,73,49,24,62
Alloa,1992,4,17,8,11,58,46,12,59
Stranraer,1992,5,15,5,16,56,66,-10,50
East Fife,1992,6,14,3,19,49,65,-16,45
Airdrieon,1992,7,11,11,14,47,58,-11,44
Forfar,1992,8,10,5,21,38,66,-28,35
Albion,1992,9,8,6,22,58,83,-25,30
Queen's Park,1992,10,6,10,20,40,75,-35,28
Raith,1993,1,23,8,5,70,32,38,77
Ayr,1993,2,24,4,8,95,43,52,76
Arbroath,1993,3,17,9,10,72,50,22,60
Alloa,1993,4,17,8,11,56,45,11,59
Stranraer,1993,5,15,6,15,56,65,-9,51
Airdrieon,1993,6,11,11,14,47,58,-11,44
East Fife,1993,7,13,4,19,48,65,-17,43
Forfar,1993,8,10,5,21,38,66,-28,35
Albion,1993,9,8,6,22,58,83,-25,30
Queen's Park,1993,10,6,11,19,41,74,-33,29
Raith,1994,1,23,8,5,72,32,40,77
Ayr,1994,2,24,4,8,91,42,49,76
Arbroath,1994,3,18,8,10,72,49,23,62
Alloa,1994,4,17,8,11,56,47,9,59
Stranraer,1994,5,16,5,15,56,64,-8,53
East Fife,1994,6,13,3,20,47,65,-18,42
Airdrieon,1994,7,10,11,15,46,60,-14,41
Forfar,1994,8,11,5,20,40,65,-25,38
Albion,1994,9,8,6,22,57,79,-22,30
Queen's Park,1994,10,6,10,20,40,74,-34,28
Raith,1995,1,23,8,5,73,32,41,77
Ayr,1995,2,24,4,8,94,42,52,76
Arbroath,1995,3,17,9,10,70,48,22,60
Alloa,1995,4,17,8,11,56,48,8,59
Stranraer,1995,5,15,5,16,55,68,-13,50
East Fife,1995,6,14,3,19,51,64,-13,45
Airdrieon,1995,7,10,12,14,47,60,-13,42
Forfar,1995,8,10,6,20,40,66,-26,36
Albion,1995,9,8,6,22,57,82,-25,30
Queen's Park,1995,10,6,11,19,39,72,-33,29
Raith,1996,1,22,9,5,69,33,36,75
Ayr,1996,2,23,4,9,95,48,47,73
Arbroath,1996,3,18,8,10,73,48,25,62
Alloa,1996,4,17,9,10,57,44,13,60
Stranraer,1996,5,15,6,15,55,64,-9,51
East Fife,1996,6,13,4,19,47,64,-17,43
Airdrieon,1996,7,10,12,14,46,59,-13,42
Forfar,1996,8,10,6,20,39,65,-26,36
Albion,1996,9,9,6,21,63,83,-20,33
Queen's Park,1996,10,6,10,20,39,75,-36,28
Raith,1997,1,23,8,5,71,32,39,77
Ayr,1997,2,23,4,9,90,44,46,73
Arbroath,1997,3,18,8,10,71,48,23,62
Alloa,1997,4,17,8,11,56,46,10,59
Stranraer,1997,5,16,5,15,58,65,-7,53
Airdrieon,1997,6,11,11,14,48,60,-12,44
East Fife,1997,7,13,3,20,48,67,-19,42
Forfar,1997,8,10,5,21,40,67,-27,35
Albion,1997,9,9,6,21,59,78,-19,33
Queen's Park,1997,10,6,10,20,39,73,-34,28
Ayr,1998,1,24,4,8,98,42,56,76
Raith,1998,2,22,8,6,70,36,34,74
Arbroath,1998,3,18,8,10,72,49,23,62
Alloa,1998,4,18,8,10,60,45,15,62
Stranraer,1998,5,16,5,15,57,65,-8,53
East Fife,1998,6,13,3,20,48,66,-18,42
Airdrieon,1998,7,10,11,15,46,60,-14,41
Forfar,1998,8,11,5,20,40,65,-25,38
Albion,1998,9,8,6,22,57,86,-29,30
Queen's Park,1998,10,6,10,20,40,74,-34,28
Raith,1999,1,23,8,5,71,33,38,77
Ayr,1999,2,23,5,8,90,42,48,74
Arbroath,1999,3,18,8,10,71,48,23,62
Alloa,1999,4,17,8,11,57,46,11,59
Stranraer,1999,5,16,5,15,59,64,-5,53
Airdrieon,1999,6,11,11,14,48,59,-11,44
East Fife,1999,7,13,3,20,47,68,-21,42
Forfar,1999,8,10,5,21,39,67,-28,35
Albion,1999,9,8,7,21,57,78,-21,31
Queen's Park,1999,10,6,10,20,39,73,-34,28
Ayr,2000,1,24,4,8,92,42,50,76
Raith,2000,2,22,8,6,68,33,35,74
Arbroath,2000,3,18,8,10,72,49,23,62
Alloa,2000,4,18,8,10,57,43,14,62
Stranraer,2000,5,15,5,16,55,67,-12,50
East Fife,2000,6,14,3,19,50,64,-14,45
Airdrieon,2000,7,11,11,14,47,59,-12,44
Forfar,2000,8,10,5,21,39,66,-27,35
Albion,2000,9,8,6,22,57,80,-23,30
Queen's Park,2000,10,6,10,20,40,74,-34,28
Raith,2001,1,23,8,5,70,32,38,77
Ayr,2001,2,24,4,8,95,43,52,76
Arbroath,2001,3,17,8,11,70,50,20,59
Alloa,2001,4,17,8,11,56,45,11,59
Stranraer,2001,5,15,5,16,56,66,-10,50
East Fife,2001,6,14,3,19,49,65,-16,45
Airdrieon,2001,7,11,11,14,49,61,-12,44
Forfar,2001,8,10,5,21,41,68,-27,35
Queen's Park,2001,9,7,10,19,41,72,-31,31
Albion,2001,10,8,6,22,58,83,-25,30
Raith,2002,1,23,8,5,71,32,39,77
Ayr,2002,2,24,4,8,94,45,49,76
Arbroath,2002,3,17,8,11,70,49,21,59
Alloa,2002,4,17,8,11,56,46,10,59
Stranraer,2002,5,16,5,15,57,64,-7,53
Airdrieon,2002,6,11,11,14,47,58,-11,44
East Fife,2002,7,13,3,20,47,66,-19,42
Forfar,2002,8,10,5,21,38,66,-28,35
Queen's Park,2002,9,7,10,19,40,72,-32,31
Albion,2002,10,8,6,22,60,82,-22,30
Ayr,2003,1,24,4,8,94,42,52,76
Raith,2003,2,22,9,5,68,32,36,75
Arbroath,2003,3,18,8,10,74,48,26,62
Alloa,2003,4,17,9,10,56,43,13,60
Stranraer,2003,5,16,5,15,58,66,-8,53
Airdrieon,2003,6,11,11,14,49,58,-9,44
East Fife,2003,7,13,3,20,49,67,-18,42
Forfar,2003,8,10,5,21,38,68,-30,35
Albion,2003,9,8,6,22,57,82,-25,30
Queen's Park,2003,10,6,10,20,39,76,-37,28
Raith,2004,1,23,8,5,72,33,39,77
Ayr,2004,2,24,4,8,91,42,49,76
Arbroath,2004,3,17,9,10,70,48,22,60
Alloa,2004,4,17,8,11,57,47,10,59
Stranraer,2004,5,16,5,15,57,65,-8,53
Airdrieon,2004,6,11,11,14,49,58,-9,44
East Fife,2004,7,13,3,20,48,66,-18,42
Forfar,2004,8,10,5,21,38,68,-30,35
Albion,2004,9,8,6,22,57,79,-22,30
Queen's Park,2004,10,6,11,19,39,72,-33,29
Raith,2005,1,23,8,5,69,32,37,77
Ayr,2005,2,24,4,8,93,44,49,76
Arbroath,2005,3,17,8,11,70,49,21,59
Alloa,2005,4,17,8,11,56,44,12,59
Stranraer,2005,5,16,5,15,56,64,-8,53
Airdrieon,2005,6,10,12,14,46,59,-13,42
East Fife,2005,7,13,3,20,47,65,-18,42
Forfar,2005,8,10,6,20,39,65,-26,36
Queen's Park,2005,9,7,10,19,40,72,-32,31
Albion,2005,10,8,6,22,59,81,-22,30
Raith,2006,1,23,8,5,70,33,37,77
Ayr,2006,2,24,4,8,93,42,51,76
Arbroath,2006,3,17,8,11,71,50,21,59
Alloa,2006,4,17,8,11,57,45,12,59
Stranraer,2006,5,15,5,16,57,67,-10,50
East Fife,2006,6,14,3,19,50,66,-16,45
Airdrieon,2006,7,11,11,14,50,61,-11,44
Forfar,2006,8,10,5,21,41,69,-28,35
Queen's Park,2006,9,7,10,19,41,73,-32,31
Albion,2006,10,8,6,22,57,81,-24,30
Ayr,2007,1,24,4,8,93,44,49,76
Raith,2007,2,22,9,5,69,33,36,75
Arbroath,2007,3,18,8,10,72,49,23,62
Alloa,2007,4,17,9,10,57,44,13,60
Stranraer,2007,5,15,5,16,55,66,-11,50
East Fife,2007,6,14,3,19,49,64,-15,45
Airdrieon,2007,7,11,11,14,47,59,-12,44
Forfar,2007,8,10,5,21,39,66,-27,35
Albion,2007,9,8,6,22,59,81,-22,30
Queen's Park,2007,10,6,10,20,40,74,-34,28
Raith,2008,1,23,8,5,70,32,38,77
Ayr,2008,2,24,4,8,95,43,52,76
Arbroath,2008,3,18,8,10,77,49,28,62
Alloa,2008,4,17,8,11,56,45,11,59
Stranraer,2008,5,16,5,15,58,65,-7,53
East Fife,2008,6,13,3,20,48,67,-19,42
Airdrieon,2008,7,10,11,15,46,63,-17,41
Forfar,2008,8,11,5,20,43,65,-22,38
Albion,2008,9,8,6,22,58,83,-25,30
Queen's Park,2008,10,6,10,20,40,79,-39,28
Raith,2009,1,23,8,5,72,35,37,77
Ayr,2009,2,24,4,8,91,42,49,76
Arbroath,2009,3,18,8,10,71,48,23,62
Alloa,2009,4,17,8,11,59,47,12,59
Stranraer,2009,5,15,6,15,56,65,-9,51
East Fife,2009,6,13,4,19,48,65,-17,43
Airdrieon,2009,7,10,12,14,46,59,-13,42
Forfar,2009,8,10,6,20,39,65,-26,36
Albion,2009,9,8,6,22,57,79,-22,30
Queen's Park,2009,10,6,10,20,39,73,-34,28
Raith,2010,1,23,8,5,71,32,39,77
Ayr,2010,2,23,4,9,91,44,47,73
Arbroath,2010,3,17,8,11,71,50,21,59
Alloa,2010,4,17,8,11,56,46,10,59
Stranraer,2010,5,15,5,16,56,66,-10,50
East Fife,2010,6,14,3,19,49,65,-16,45
Airdrieon,2010,7,11,11,14,48,60,-12,44
Forfar,2010,8,10,5,21,40,67,-27,35
Albion,2010,9,9,6,21,59,79,-20,33
Queen's Park,2010,10,7,10,19,41,73,-32,31
Raith,2011,1,23,8,5,70,33,37,77
Ayr,2011,2,24,4,8,96,45,51,76
Arbroath,2011,3,17,8,11,71,50,21,59
Alloa,2011,4,17,8,11,57,45,12,59
Stranraer,2011,5,16,5,15,56,64,-8,53
Airdrieon,2011,6,11,11,14,49,58,-9,44
East Fife,2011,7,13,3,20,47,65,-18,42
Forfar,2011,8,10,5,21,38,68,-30,35
Queen's Park,2011,9,7,10,19,41,73,-32,31
Albion,2011,10,8,6,22,60,84,-24,30
Raith,2012,1,23,8,5,70,33,37,77
Ayr,2012,2,24,4,8,95,42,53,76
Arbroath,2012,3,18,8,10,72,49,23,62
Alloa,2012,4,17,8,11,57,45,12,59
Stranraer,2012,5,16,5,15,58,65,-7,53
East Fife,2012,6,13,3,20,48,67,-19,42
Airdrieon,2012,7,10,11,15,45,60,-15,41
Forfar,2012,8,11,5,20,40,64,-24,38
Albion,2012,9,8,6,22,57,83,-26,30
Queen's Park,2012,10,6,10,20,40,74,-34,28
Raith,2013,1,23,8,5,70,32,38,77
Ayr,2013,2,24,4,8,94,45,49,76
Arbroath,2013,3,18,8,10,73,49,24,62
Alloa,2013,4,17,8,11,56,45,11,59
Stranraer,2013,5,15,5,16,55,65,-10,50
East Fife,2013,6,14,3,19,48,64,-16,45
Airdrieon,2013,7,11,11,14,48,58,-10,44
Forfar,2013,8,10,5,21,38,67,-29,35
Albion,2013,9,8,6,22,60,82,-22,30
Queen's Park,2013,10,6,10,20,40,75,-35,28
Raith,2014,1,23,8,5,70,33,37,77
Ayr,2014,2,23,5,8,91,43,48,74
Arbroath,2014,3,18,8,10,72,49,23,62
Alloa,2014,4,17,8,11,57,45,12,59
Stranraer,2014,5,15,5,16,55,66,-11,50
East Fife,2014,6,14,3,19,49,64,-15,45
Airdrieon,2014,7,10,11,15,45,60,-15,41
Forfar,2014,8,11,5,20,40,64,-24,38
Albion,2014,9,8,7,21,58,79,-21,31
Queen's Park,2014,10,6,10,20,40,74,-34,28
Raith,2015,1,23,8,5,69,32,37,77
Ayr,2015,2,23,5,8,93,45,48,74
Arbroath,2015,3,18,8,10,73,50,23,62
Alloa,2015,4,17,8,11,56,44,12,59
Stranraer,2015,5,15,5,16,56,67,-11,50
East Fife,2015,6,14,3,19,50,65,-15,45
Airdrieon,2015,7,10,12,14,46,59,-13,42
Forfar,2015,8,10,6,20,39,65,-26,36
Albion,2015,9,8,7,21,60,81,-21,31
Queen's Park,2015,10,6,10,20,41,75,-34,28
Raith,2016,1,23,8,5,72,32,40,77
Ayr,2016,2,24,4,8,92,42,50,76
Arbroath,2016,3,17,8,11,72,53,19,59
Alloa,2016,4,17,8,11,56,47,9,59
Stranraer,2016,5,15,5,16,55,66,-11,50
East Fife,2016,6,14,3,19,49,64,-15,45
Airdrieon,2016,7,10,12,14,46,59,-13,42
Forfar,2016,8,10,6,20,39,65,-26,36
Queen's Park,2016,9,7,10,19,44,74,-30,31
Albion,2016,10,8,6,22,57,80,-23,30
Raith,2017,1,23,8,5,69,32,37,77
Ayr,2017,2,24,4,8,93,43,50,76
Arbroath,2017,3,18,8,10,71,48,23,62
Alloa,2017,4,17,8,11,56,44,12,59
Stranraer,2017,5,16,5,15,58,66,-8,53
East Fife,2017,6,13,3,20,49,67,-18,42
Airdrieon,2017,7,10,11,15,45,59,-14,41
Forfar,2017,8,11,5,20,39,64,-25,38
Albion,2017,9,8,6,22,58,81,-23,30
Queen's Park,2017,10,6,10,20,39,73,-34,28
Raith,2018,1,23,8,5,71,33,38,77
Ayr,2018,2,24,4,8,94,43,51,76
Arbroath,2018,3,18,8,10,73,49,24,62
Alloa,2018,4,17,8,11,57,46,11,59
Stranraer,2018,5,15,5,16,57,67,-10,50
East Fife,2018,6,14,3,19,50,66,-16,45
Airdrieon,2018,7,10,12,14,46,59,-13,42
Forfar,2018,8,10,6,20,39,65,-26,36
Albion,2018,9,8,6,22,58,82,-24,30
Queen's Park,2018,10,6,10,20,40,75,-35,28
Raith,2019,1,23,8,5,70,33,37,77
Ayr,2019,2,24,4,8,93,44,49,76
Arbroath,2019,3,17,9,10,70,48,22,60
Alloa,2019,4,17,8,11,57,45,12,59
Stranraer,2019,5,16,5,15,56,64,-8,53
Airdrieon,2019,6,10,12,14,47,60,-13,42
East Fife,2019,7,13,3,20,47,65,-18,42
Forfar,2019,8,10,6,20,40,66,-26,36
Albion,2019,9,8,6,22,59,81,-22,30
Queen's Park,2019,10,6,11,19,39,72,-33,29
Raith,2020,1,22,9,5,70,34,36,75
Ayr,2020,2,23,4,9,91,44,47,73
Alloa,2020,3,17,9,10,58,45,13,60
Arbroath,2020,4,17,8,11,70,49,21,59
Stranraer,2020,5,16,5,15,57,64,-7,53
Airdrieon,2020,6,10,12,14,47,60,-13,42
East Fife,2020,7,13,3,20,47,66,-19,42
Forfar,2020,8,10,6,20,40,66,-26,36
Albion,2020,9,9,6,21,59,79,-20,33
Queen's Park,2020,10,7,10,19,40,72,-32,31
Ayr,2021,1,24,4,8,93,43,50,76
Raith,2021,2,22,9,5,69,33,36,75
Arbroath,2021,3,17,9,10,71,49,22,60
Alloa,2021,4,17,9,10,57,44,13,60
Stranraer,2021,5,16,5,15,57,64,-7,53
Airdrieon,2021,6,11,11,14,49,58,-9,44
East Fife,2021,7,13,3,20,47,66,-19,42
Forfar,2021,8,10,5,21,38,68,-30,35
Albion,2021,9,8,6,22,58,81,-23,30
Queen's Park,2021,10,6,11,19,40,73,-33,29
Raith,2022,1,23,8,5,70,32,38,77
Ayr,2022,2,23,5,8,93,45,48,74
Arbroath,2022,3,17,9,10,72,50,22,60
Alloa,2022,4,17,8,11,56,45,11,59
Stranraer,2022,5,16,5,15,58,66,-8,53
East Fife,2022,6,13,3,20,49,67,-18,42
Airdrieon,2022,7,10,11,15,46,60,-14,41
Forfar,2022,8,11,5,20,40,65,-25,38
Albion,2022,9,8,7,21,60,81,-21,31
Queen's Park,2022,10,6,11,19,41,74,-33,29
Ayr,2023,1,24,4,8,96,45,51,76
Raith,2023,2,22,8,6,69,34,35,74
Alloa,2023,3,18,8,10,58,44,14,62
Arbroath,2023,4,17,8,11,70,49,21,59
Stranraer,2023,5,16,5,15,57,65,-8,53
Airdrieon,2023,6,11,11,14,46,58,-12,44
East Fife,2023,7,13,3,20,48,66,-18,42
Forfar,2023,8,10,5,21,38,65,-27,35
Queen's Park,2023,9,7,10,19,40,72,-32,31
Albion,2023,10,8,6,22,60,84,-24,30
Raith,2024,1,23,8,5,70,33,37,77
Ayr,2024,2,23,4,9,90,44,46,73
Arbroath,2024,3,18,8,10,74,49,25,62
Alloa,2024,4,17,8,11,57,45,12,59
Stranraer,2024,5,16,5,15,57,65,-8,53
Airdrieon,2024,6,10,12,14,46,59,-13,42
East Fife,2024,7,13,3,20,48,66,-18,42
Forfar,2024,8,10,6,20,39,65,-26,36
Albion,2024,9,9,6,21,59,78,-19,33
Queen's Park,2024,10,6,10,20,40,76,-36,28
Ayr,2025,1,24,4,8,94,44,50,76
Raith,2025,2,22,9,5,69,33,36,75
Arbroath,2025,3,18,8,10,73,49,24,62
Alloa,2025,4,17,9,10,57,44,13,60
Stranraer,2025,5,15,6,15,55,64,-9,51
East Fife,2025,6,13,4,19,47,64,-17,43
Airdrieon,2025,7,10,12,14,47,60,-13,42
Forfar,2025,8,10,6,20,40,66,-26,36
Albion,2025,9,8,6,22,59,82,-23,30
Queen's Park,2025,10,6,10,20,40,75,-35,28
Raith,2026,1,23,8,5,70,32,38,77
Ayr,2026,2,24,4,8,96,45,51,76
Arbroath,2026,3,17,8,11,71,51,20,59
Alloa,2026,4,17,8,11,56,45,11,59
Stranraer,2026,5,15,5,16,55,65,-10,50
East Fife,2026,6,14,3,19,48,64,-16,45
Airdrieon,2026,7,10,11,15,45,60,-15,41
Forfar,2026,8,11,5,20,40,64,-24,38
Queen's Park,2026,9,7,10,19,42,73,-31,31
Albion,2026,10,8,6,22,60,84,-24,30
Raith,2027,1,23,8,5,72,32,40,77
Ayr,2027,2,24,4,8,94,43,51,76
Arbroath,2027,3,18,8,10,71,48,23,62
Alloa,2027,4,17,8,11,56,47,9,59
Stranraer,2027,5,15,6,15,55,64,-9,51
Airdrieon,2027,6,11,11,14,49,60,-11,44
East Fife,2027,7,13,4,19,47,64,-17,43
Forfar,2027,8,10,5,21,40,68,-28,35
Albion,2027,9,8,6,22,58,82,-24,30
Queen's Park,2027,10,6,10,20,39,73,-34,28
Raith,2028,1,23,8,5,72,32,40,77
Ayr,2028,2,24,4,8,94,43,51,76
Arbroath,2028,3,18,8,10,71,48,23,62
Alloa,2028,4,17,8,11,56,47,9,59
Stranraer,2028,5,15,6,15,57,66,-9,51
Airdrieon,2028,6,11,11,14,47,59,-12,44
East Fife,2028,7,13,4,19,49,66,-17,43
Forfar,2028,8,10,5,21,39,66,-27,35
Albion,2028,9,8,6,22,58,82,-24,30
Queen's Park,2028,10,6,10,20,39,73,-34,28
Raith,2029,1,23,8,5,71,32,39,77
Ayr,2029,2,23,4,9,92,45,47,73
Arbroath,2029,3,18,8,10,73,48,25,62
Alloa,2029,4,17,8,11,56,46,10,59
Stranraer,2029,5,16,5,15,56,64,-8,53
East Fife,2029,6,13,3,20,47,65,-18,42
Airdrieon,2029,7,10,11,15,47,61,-14,41
Forfar,2029,8,11,5,20,41,66,-25,38
Albion,2029,9,9,6,21,60,80,-20,33
Queen's Park,2029,10,6,10,20,39,75,-36,28
Ayr,2030,1,24,4,8,94,44,50,76
Raith,2030,2,22,8,6,68,34,34,74
Alloa,2030,3,18,8,10,58,43,15,62
Arbroath,2030,4,17,8,11,71,50,21,59
Stranraer,2030,5,15,6,15,58,67,-9,51
East Fife,2030,6,13,4,19,50,67,-17,43
Airdrieon,2030,7,10,11,15,46,60,-14,41
Forfar,2030,8,11,5,20,40,65,-25,38
Queen's Park,2030,9,7,10,19,41,73,-32,31
Albion,2030,10,8,6,22,59,82,-23,30
Ayr,2031,1,24,4,8,95,42,53,76
Raith,2031,2,22,9,5,69,33,36,75
Arbroath,2031,3,18,8,10,72,49,23,62
Alloa,2031,4,17,9,10,57,44,13,60
Stranraer,2031,5,15,5,16,55,68,-13,50
East Fife,2031,6,14,3,19,51,64,-13,45
Airdrieon,2031,7,11,11,14,48,58,-10,44
Forfar,2031,8,10,5,21,38,67,-29,35
Albion,2031,9,8,6,22,57,83,-26,30
Queen's Park,2031,10,6,10,20,40,74,-34,28
Raith,2032,1,23,8,5,72,33,39,77
Ayr,2032,2,23,5,8,91,43,48,74
Arbroath,2032,3,17,8,11,71,50,21,59
Alloa,2032,4,17,8,11,57,47,10,59
Stranraer,2032,5,16,5,15,57,64,-7,53
Airdrieon,2032,6,11,11,14,48,58,-10,44
East Fife,2032,7,13,3,20,47,66,-19,42
Forfar,2032,8,10,5,21,38,67,-29,35
Albion,2032,9,8,7,21,58,79,-21,31
Queen's Park,2032,10,7,10,19,41,73,-32,31
Raith,2033,1,23,8,5,70,33,37,77
Ayr,2033,2,23,4,9,91,45,46,73
Arbroath,2033,3,18,8,10,73,49,24,62
Alloa,2033,4,17,8,11,57,45,12,59
Stranraer,2033,5,15,5,16,55,67,-12,50
East Fife,2033,6,14,3,19,50,64,-14,45
Airdrieon,2033,7,10,11,15,46,60,-14,41
Forfar,2033,8,11,5,20,40,65,-25,38
Albion,2033,9,9,6,21,60,79,-19,33
Queen's Park,2033,10,6,10,20,40,75,-35,28
Raith,2034,1,23,8,5,69,32,37,77
Ayr,2034,2,23,4,9,90,43,47,73
Arbroath,2034,3,17,9,10,73,51,22,60
Alloa,2034,4,17,8,11,56,44,12,59
Stranraer,2034,5,16,5,15,58,65,-7,53
Airdrieon,2034,6,11,11,14,47,59,-12,44
East Fife,2034,7,13,3,20,48,67,-19,42
Forfar,2034,8,10,5,21,39,66,-27,35
Albion,2034,9,9,6,21,58,78,-20,33
Queen's Park,2034,10,6,11,19,42,75,-33,29
Raith,2035,1,23,8,5,72,34,38,77
Ayr,2035,2,23,5,8,92,44,48,74
Arbroath,2035,3,17,8,11,70,50,20,59
Alloa,2035,4,17,8,11,58,47,11,59
Stranraer,2035,5,16,5,15,56,64,-8,53
East Fife,2035,6,13,3,20,47,65,-18,42
Airdrieon,2035,7,10,11,15,46,60,-14,41
Forfar,2035,8,11,5,20,40,65,-25,38
Albion,2035,9,8,7,21,59,80,-21,31
Queen's Park,2035,10,7,10,19,41,72,-31,31
Raith,2036,1,23,8,5,70,32,38,77
Ayr,2036,2,24,4,8,96,43,53,76
Arbroath,2036,3,17,8,11,71,50,21,59
Alloa,2036,4,17,8,11,56,45,11,59
Stranraer,2036,5,16,5,15,57,65,-8,53
Airdrieon,2036,6,11,11,14,49,60,-11,44
East Fife,2036,7,13,3,20,48,66,-18,42
Forfar,2036,8,10,5,21,40,68,-28,35
Queen's Park,2036,9,7,10,19,41,73,-32,31
Albion,2036,10,8,6,22,58,84,-26,30
Raith,2037,1,22,9,5,68,32,36,75
Ayr,2037,2,23,5,8,94,46,48,74
Arbroath,2037,3,18,8,10,72,49,23,62
Alloa,2037,4,17,9,10,56,43,13,60
Stranraer,2037,5,15,5,16,55,65,-10,50
East Fife,2037,6,14,3,19,48,64,-16,45
Airdrieon,2037,7,10,11,15,45,59,-14,41
Forfar,2037,8,11,5,20,39,64,-25,38
Albion,2037,9,8,7,21,61,82,-21,31
Queen's Park,2037,10,6,10,20,40,74,-34,28
Ayr,2038,1,24,4,8,95,43,52,76
Raith,2038,2,22,8,6,68,33,35,74
Arbroath,2038,3,18,8,10,73,48,25,62
Alloa,2038,4,18,8,10,57,43,14,62
Stranraer,2038,5,16,5,15,56,64,-8,53
East Fife,2038,6,13,3,20,47,65,-18,42
Airdrieon,2038,7,10,11,15,45,59,-14,41
Forfar,2038,8,11,5,20,39,64,-25,38
Albion,2038,9,8,6,22,58,83,-25,30
Queen's Park,2038,10,6,10,20,39,75,-36,28
Ayr,2039,1,24,4,8,91,42,49,76
Raith,2039,2,22,9,5,69,33,36,75
Arbroath,2039,3,18,8,10,72,48,24,62
Alloa,2039,4,17,9,10,57,44,13,60
Stranraer,2039,5,15,5,16,57,68,-11,50
East Fife,2039,6,14,3,19,51,66,-15,45
Airdrieon,2039,7,11,11,14,46,58,-12,44
Forfar,2039,8,10,5,21,38,65,-27,35
Albion,2039,9,8,6,22,57,79,-22,30
Queen's Park,2039,10,6,10,20,39,74,-35,28
Raith,2040,1,23,8,5,69,32,37,77
Ayr,2040,2,24,4,8,93,43,50,76
Arbroath,2040,3,18,8,10,75,50,25,62
Alloa,2040,4,17,8,11,56,44,12,59
Stranraer,2040,5,15,5,16,55,66,-11,50
East Fife,2040,6,14,3,19,49,64,-15,45
Airdrieon,2040,7,11,11,14,47,59,-12,44
Forfar,2040,8,10,5,21,39,66,-27,35
Albion,2040,9,8,6,22,58,81,-23,30
Queen's Park,2040,10,6,10,20,41,77,-36,28
Ayr,2041,1,24,4,8,92,42,50,76
Raith,2041,2,22,9,5,70,34,36,75
Arbroath,2041,3,18,8,10,71,48,23,62
Alloa,2041,4,17,9,10,58,45,13,60
Stranraer,2041,5,16,5,15,56,64,-8,53
Airdrieon,2041,6,10,12,14,45,58,-13,42
East Fife,2041,7,13,3,20,47,65,-18,42
Forfar,2041,8,10,6,20,38,64,-26,36
Albion,2041,9,8,6,22,57,80,-23,30
Queen's Park,2041,10,6,10,20,39,73,-34,28
Ayr,2042,1,24,4,8,95,43,52,76
Raith,2042,2,22,9,5,70,34,36,75
Arbroath,2042,3,18,8,10,74,50,24,62
Alloa,2042,4,17,9,10,58,45,13,60
Stranraer,2042,5,16,5,15,57,65,-8,53
Airdrieon,2042,6,11,11,14,48,58,-10,44
East Fife,2042,7,13,3,20,48,66,-18,42
Forfar,2042,8,10,5,21,38,67,-29,35
Albion,2042,9,8,6,22,58,83,-25,30
Queen's Park,2042,10,6,10,20,41,76,-35,28
Raith,2043,1,23,8,5,72,32,40,77
Ayr,2043,2,24,4,8,95,44,51,76
Arbroath,2043,3,18,8,10,71,48,23,62
Alloa,2043,4,17,8,11,56,47,9,59
Stranraer,2043,5,16,5,15,58,66,-8,53
East Fife,2043,6,13,3,20,49,67,-18,42
Airdrieon,2043,7,10,11,15,45,59,-14,41
Forfar,2043,8,11,5,20,39,64,-25,38
Albion,2043,9,8,6,22,59,83,-24,30
Queen's Park,2043,10,6,10,20,39,73,-34,28
Raith,2044,1,23,8,5,72,32,40,77
Ayr,2044,2,24,4,8,93,42,51,76
Arbroath,2044,3,17,8,11,71,50,21,59
Alloa,2044,4,17,8,11,56,47,9,59
Stranraer,2044,5,15,5,16,56,68,-12,50
East Fife,2044,6,14,3,19,51,65,-14,45
Airdrieon,2044,7,10,12,14,45,58,-13,42
Forfar,2044,8,10,6,20,38,64,-26,36
Queen's Park,2044,9,7,10,19,41,73,-32,31
Albion,2044,10,8,6,22,57,81,-24,30
Ayr,2045,1,24,4,8,93,44,49,76
Raith,2045,2,22,9,5,70,34,36,75
Arbroath,2045,3,18,8,10,74,48,26,62
Alloa,2045,4,17,9,10,58,45,13,60
Stranraer,2045,5,16,5,15,56,64,-8,53
Airdrieon,2045,6,11,11,14,47,59,-12,44
East Fife,2045,7,13,3,20,47,65,-18,42
Forfar,2045,8,10,5,21,39,66,-27,35
Albion,2045,9,8,6,22,59,81,-22,30
Queen's Park,2045,10,6,10,20,39,76,-37,28
Raith,2046,1,23,8,5,71,33,38,77
Ayr,2046,2,24,4,8,94,43,51,76
Arbroath,2046,3,18,8,10,75,51,24,62
Alloa,2046,4,17,8,11,57,46,11,59
Stranraer,2046,5,15,6,15,56,65,-9,51
East Fife,2046,6,13,4,19,48,65,-17,43
Airdrieon,2046,7,10,12,14,47,60,-13,42
Forfar,2046,8,10,6,20,40,66,-26,36
Albion,2046,9,8,6,22,58,82,-24,30
Queen's Park,2046,10,6,10,20,42,77,-35,28
Raith,2047,1,23,8,5,70,32,38,77
Ayr,2047,2,24,4,8,94,45,49,76
Arbroath,2047,3,17,9,10,71,49,22,60
Alloa,2047,4,17,8,11,56,45,11,59
Stranraer,2047,5,16,5,15,58,64,-6,53
Airdrieon,2047,6,11,11,14,46,58,-12,44
East Fife,2047,7,13,3,20,47,67,-20,42
Forfar,2047,8,10,5,21,38,65,-27,35
Albion,2047,9,8,6,22,60,82,-22,30
Queen's Park,2047,10,6,11,19,40,73,-33,29
Ayr,2048,1,24,4,8,95,42,53,76
Raith,2048,2,22,9,5,68,32,36,75
Arbroath,2048,3,18,8,10,72,49,23,62
Alloa,2048,4,17,9,10,56,43,13,60
Stranraer,2048,5,15,5,16,57,68,-11,50
East Fife,2048,6,14,3,19,51,66,-15,45
Airdrieon,2048,7,10,11,15,45,59,-14,41
Forfar,2048,8,11,5,20,39,64,-25,38
Albion,2048,9,8,6,22,57,83,-26,30
Queen's Park,2048,10,6,10,20,40,74,-34,28
Ayr,2049,1,24,4,8,96,43,53,76
Raith,2049,2,22,9,5,69,33,36,75
Alloa,2049,3,17,9,10,57,44,13,60
Arbroath,2049,4,17,8,11,70,49,21,59
Stranraer,2049,5,16,5,15,59,66,-7,53
East Fife,2049,6,13,3,20,49,68,-19,42
Airdrieon,2049,7,10,11,15,46,60,-14,41
Forfar,2049,8,11,5,20,40,65,-25,38
Queen's Park,2049,9,7,10,19,40,72,-32,31
Albion,2049,10,8,6,22,58,84,-26,30
Raith,2050,1,23,8,5,70,32,38,77
Ayr,2050,2,24,4,8,96,44,52,76
Arbroath,2050,3,17,8,11,70,49,21,59
Alloa,2050,4,17,8,11,56,45,11,59
Stranraer,2050,5,16,5,15,58,64,-6,53
Airdrieon,2050,6,11,11,14,46,58,-12,44
East Fife,2050,7,13,3,20,47,67,-20,42
Forfar,2050,8,10,5,21,38,65,-27,35
Queen's Park,2050,9,7,10,19,40,72,-32,31
Albion,2050,10,8,6,22,59,84,-25,30
Ayr,2051,1,24,4,8,95,42,53,76
Raith,2051,2,22,9,5,69,33,36,75
Arbroath,2051,3,18,8,10,74,48,26,62
Alloa,2051,4,17,9,10,57,44,13,60
Stranraer,2051,5,15,5,16,56,68,-12,50
East Fife,2051,6,14,3,19,51,65,-14,45
Airdrieon,2051,7,11,11,14,47,58,-11,44
Forfar,2051,8,10,5,21,38,66,-28,35
Albion,2051,9,8,6,22,57,83,-26,30
Queen's Park,2051,10,6,10,20,39,76,-37,28
Raith,2052,1,23,8,5,71,34,37,77
Ayr,2052,2,24,4,8,93,43,50,76
Arbroath,2052,3,18,8,10,73,49,24,62
Alloa,2052,4,17,8,11,58,46,12,59
Stranraer,2052,5,15,6,15,57,66,-9,51
Airdrieon,2052,6,11,11,14,47,58,-11,44
East Fife,2052,7,13,4,19,49,66,-17,43
Forfar,2052,8,10,5,21,38,66,-28,35
Albion,2052,9,8,6,22,58,81,-23,30
Queen's Park,2052,10,6,10,20,40,75,-35,28
Ayr,2053,1,24,4,8,96,43,53,76
Raith,2053,2,22,8,6,68,34,34,74
Arbroath,2053,3,18,8,10,73,50,23,62
Alloa,2053,4,18,8,10,58,43,15,62
Stranraer,2053,5,15,6,15,56,65,-9,51
Airdrieon,2053,6,11,11,14,47,58,-11,44
East Fife,2053,7,13,4,19,48,65,-17,43
Forfar,2053,8,10,5,21,38,66,-28,35
Albion,2053,9,8,6,22,58,84,-26,30
Queen's Park,2053,10,6,10,20,41,75,-34,28
Raith,2054,1,23,8,5,69,32,37,77
Ayr,2054,2,23,5,8,91,43,48,74
Arbroath,2054,3,18,8,10,71,48,23,62
Alloa,2054,4,17,8,11,56,44,12,59
Stranraer,2054,5,16,5,15,57,65,-8,53
East Fife,2054,6,13,3,20,48,66,-18,42
Airdrieon,2054,7,10,11,15,45,59,-14,41
Forfar,2054,8,11,5,20,39,64,-25,38
Albion,2054,9,8,7,21,58,79,-21,31
Queen's Park,2054,10,6,10,20,39,73,-34,28
Ayr,2055,1,24,4,8,96,44,52,76
Raith,2055,2,22,9,5,70,34,36,75
Arbroath,2055,3,18,8,10,72,48,24,62
Alloa,2055,4,17,9,10,58,45,13,60
Stranraer,2055,5,16,5,15,56,64,-8,53
Airdrieon,2055,6,11,11,14,47,59,-12,44
East Fife,2055,7,13,3,20,47,65,-18,42
Forfar,2055,8,10,5,21,39,66,-27,35
Albion,2055,9,8,6,22,59,84,-25,30
Queen's Park,2055,10,6,10,20,39,74,-35,28
Raith,2056,1,23,8,5,70,32,38,77
Ayr,2056,2,24,4,8,92,43,49,76
Arbroath,2056,3,17,8,11,71,50,21,59
Alloa,2056,4,17,8,11,56,45,11,59
Stranraer,2056,5,16,5,15,57,65,-8,53
Airdrieon,2056,6,11,11,14,47,58,-11,44
East Fife,2056,7,13,3,20,48,66,-18,42
Forfar,2056,8,10,5,21,38,66,-28,35
Queen's Park,2056,9,7,10,19,41,73,-32,31
Albion,2056,10,8,6,22,58,80,-22,30
Raith,2057,1,23,8,5,70,33,37,77
Ayr,2057,2,24,4,8,94,43,51,76
Arbroath,2057,3,18,8,10,72,49,23,62
Alloa,2057,4,17,8,11,57,45,12,59
Stranraer,2057,5,16,5,15,57,64,-7,53
Airdrieon,2057,6,11,11,14,48,58,-10,44
East Fife,2057,7,13,3,20,47,66,-19,42
Forfar,2057,8,10,5,21,38,67,-29,35
Albion,2057,9,8,6,22,58,82,-24,30
Queen's Park,2057,10,6,10,20,40,74,-34,28
Ayr,2058,1,24,4,8,94,43,51,76
Raith,2058,2,22,8,6,69,35,34,74
Alloa,2058,3,18,8,10,59,44,15,62
Arbroath,2058,4,17,8,11,70,49,21,59
Stranraer,2058,5,15,6,15,56,65,-9,51
East Fife,2058,6,13,4,19,48,65,-17,43
Airdrieon,2058,7,10,11,15,46,60,-14,41
Forfar,2058,8,11,5,20,40,65,-25,38
Queen's Park,2058,9,7,10,19,40,72,-32,31
Albion,2058,10,8,6,22,58,82,-24,30
Ayr,2059,1,24,4,8,95,43,52,76
Raith,2059,2,22,9,5,69,33,36,75
Arbroath,2059,3,18,8,10,74,48,26,62
Alloa,2059,4,17,9,10,57,44,13,60
Stranraer,2059,5,15,6,15,56,65,-9,51
Airdrieon,2059,6,11,11,14,47,58,-11,44
East Fife,2059,7,13,4,19,48,65,-17,43
Forfar,2059,8,10,5,21,38,66,-28,35
Albion,2059,9,8,6,22,58,83,-25,30
Queen's Park,2059,10,6,10,20,39,76,-37,28
Raith,2060,1,23,8,5,72,34,38,77
Ayr,2060,2,24,4,8,97,44,53,76
Arbroath,2060,3,17,9,10,71,49,22,60
Alloa,2060,4,17,8,11,58,47,11,59
Stranraer,2060,5,16,5,15,56,64,-8,53
Airdrieon,2060,6,11,11,14,46,58,-12,44
East Fife,2060,7,13,3,20,47,65,-18,42
Forfar,2060,8,10,5,21,38,65,-27,35
Albion,2060,9,8,6,22,59,85,-26,30
Queen's Park,2060,10,6,11,19,40,73,-33,29
Ayr,2061,1,24,4,8,92,42,50,76
Raith,2061,2,22,9,5,68,32,36,75
Arbroath,2061,3,17,9,10,71,49,22,60
Alloa,2061,4,17,9,10,56,43,13,60
Stranraer,2061,5,15,5,16,57,67,-10,50
East Fife,2061,6,14,3,19,50,66,-16,45
Airdrieon,2061,7,10,11,15,46,61,-15,41
Forfar,2061,8,11,5,20,41,65,-24,38
Albion,2061,9,8,6,22,57,80,-23,30
Queen's Park,2061,10,6,11,19,40,73,-33,29
Ayr,2062,1,23,5,8,93,45,48,74
Raith,2062,2,22,8,6,68,34,34,74
Alloa,2062,3,18,8,10,58,43,15,62
Arbroath,2062,4,17,8,11,70,49,21,59
Stranraer,2062,5,16,5,15,57,65,-8,53
Airdrieon,2062,6,11,11,14,47,59,-12,44
East Fife,2062,7,13,3,20,48,66,-18,42
Forfar,2062,8,10,5,21,39,66,-27,35
Albion,2062,9,8,7,21,60,81,-21,31
Queen's Park,2062,10,7,10,19,40,72,-32,31
Raith,2063,1,23,8,5,69,32,37,77
Ayr,2063,2,24,4,8,94,44,50,76
Arbroath,2063,3,18,8,10,71,48,23,62
Alloa,2063,4,17,8,11,56,44,12,59
Stranraer,2063,5,15,5,16,56,66,-10,50
East Fife,2063,6,14,3,19,49,65,-16,45
Airdrieon,2063,7,10,12,14,47,60,-13,42
Forfar,2063,8,10,6,20,40,66,-26,36
Albion,2063,9,8,6,22,59,82,-23,30
Queen's Park,2063,10,6,10,20,39,73,-34,28
Ayr,2064,1,24,4,8,94,43,51,76
Raith,2064,2,22,9,5,69,33,36,75
Arbroath,2064,3,18,8,10,71,48,23,62
Alloa,2064,4,17,9,10,57,44,13,60
Stranraer,2064,5,15,5,16,57,70,-13,50
East Fife,2064,6,14,3,19,53,66,-13,45
Airdrieon,2064,7,10,11,15,46,60,-14,41
Forfar,2064,8,11,5,20,40,65,-25,38
Albion,2064,9,8,6,22,58,82,-24,30
Queen's Park,2064,10,6,10,20,39,73,-34,28
Ayr,2065,1,24,4,8,92,43,49,76
Raith,2065,2,22,9,5,70,34,36,75
Alloa,2065,3,17,9,10,58,45,13,60
Arbroath,2065,4,17,8,11,73,52,21,59
Stranraer,2065,5,15,5,16,56,66,-10,50
East Fife,2065,6,14,3,19,49,65,-16,45
Airdrieon,2065,7,10,11,15,45,61,-16,41
Forfar,2065,8,11,5,20,41,64,-23,38
Queen's Park,2065,9,7,10,19,43,75,-32,31
Albion,2065,10,8,6,22,58,80,-22,30
Ayr,2066,1,24,4,8,96,43,53,76
Raith,2066,2,22,8,6,68,33,35,74
Alloa,2066,3,18,8,10,57,43,14,62
Arbroath,2066,4,17,9,10,71,49,22,60
Stranraer,2066,5,16,5,15,57,65,-8,53
Airdrieon,2066,6,10,12,14,46,59,-13,42
East Fife,2066,7,13,3,20,48,66,-18,42
Forfar,2066,8,10,6,20,39,65,-26,36
Albion,2066,9,8,6,22,58,84,-26,30
Queen's Park,2066,10,6,11,19,40,73,-33,29
Ayr,2067,1,24,4,8,91,42,49,76
Raith,2067,2,22,9,5,69,33,36,75
Arbroath,2067,3,17,9,10,72,50,22,60
Alloa,2067,4,17,9,10,57,44,13,60
Stranraer,2067,5,15,6,15,56,65,-9,51
East Fife,2067,6,13,4,19,48,65,-17,43
Airdrieon,2067,7,10,11,15,46,60,-14,41
Forfar,2067,8,11,5,20,40,65,-25,38
Albion,2067,9,8,6,22,57,79,-22,30
Queen's Park,2067,10,6,11,19,41,74,-33,29
Raith,2068,1,23,8,5,70,32,38,77
Ayr,2068,2,24,4,8,93,42,51,76
Arbroath,2068,3,17,9,10,72,50,22,60
Alloa,2068,4,17,8,11,56,45,11,59
Stranraer,2068,5,15,6,15,56,65,-9,51
Airdrieon,2068,6,11,11,14,48,58,-10,44
East Fife,2068,7,13,4,19,48,65,-17,43
Forfar,2068,8,10,5,21,38,67,-29,35
Albion,2068,9,8,6,22,57,81,-24,30
Queen's Park,2068,10,6,11,19,41,74,-33,29
Raith,2069,1,23,8,5,70,33,37,77
Ayr,2069,2,24,4,8,98,43,55,76
Arbroath,2069,3,18,8,10,74,49,25,62
Alloa,2069,4,17,8,11,57,45,12,59
Stranraer,2069,5,15,5,16,55,65,-10,50
East Fife,2069,6,14,3,19,48,64,-16,45
Airdrieon,2069,7,10,12,14,48,61,-13,42
Forfar,2069,8,10,6,20,41,67,-26,36
Albion,2069,9,8,6,22,58,86,-28,30
Queen's Park,2069,10,6,10,20,40,76,-36,28
Raith,2070,1,23,8,5,69,32,37,77
Ayr,2070,2,24,4,8,93,44,49,76
Arbroath,2070,3,17,8,11,71,50,21,59
Alloa,2070,4,17,8,11,56,44,12,59
Stranraer,2070,5,15,6,15,56,65,-9,51
Airdrieon,2070,6,11,11,14,46,58,-12,44
East Fife,2070,7,13,4,19,48,65,-17,43
Forfar,2070,8,10,5,21,38,65,-27,35
Queen's Park,2070,9,7,10,19,41,73,-32,31
Albion,2070,10,8,6,22,59,81,-22,30
Ayr,2071,1,24,4,8,92,43,49,76
Raith,2071,2,22,8,6,68,33,35,74
Arbroath,2071,3,18,8,10,73,48,25,62
Alloa,2071,4,18,8,10,57,43,14,62
Stranraer,2071,5,15,5,16,56,68,-12,50
East Fife,2071,6,14,3,19,51,65,-14,45
Airdrieon,2071,7,10,12,14,48,61,-13,42
Forfar,2071,8,10,6,20,41,67,-26,36
Albion,2071,9,8,6,22,58,80,-22,30
Queen's Park,2071,10,6,10,20,39,75,-36,28
Ayr,2072,1,24,4,8,92,42,50,76
Raith,2072,2,22,9,5,69,33,36,75
Arbroath,2072,3,18,8,10,72,48,24,62
Alloa,2072,4,17,9,10,57,44,13,60
Stranraer,2072,5,16,5,15,62,64,-2,53
Airdrieon,2072,6,10,12,14,46,59,-13,42
East Fife,2072,7,13,3,20,47,71,-24,42
Forfar,2072,8,10,6,20,39,65,-26,36
Albion,2072,9,8,6,22,57,80,-23,30
Queen's Park,2072,10,6,10,20,39,74,-35,28
Raith,2073,1,23,8,5,69,32,37,77
Ayr,2073,2,23,4,9,94,47,47,73
Arbroath,2073,3,17,8,11,71,50,21,59
Alloa,2073,4,17,8,11,56,44,12,59
Stranraer,2073,5,15,5,16,55,65,-10,50
East Fife,2073,6,14,3,19,48,64,-16,45
Airdrieon,2073,7,10,11,15,45,61,-16,41
Forfar,2073,8,11,5,20,41,64,-23,38
Albion,2073,9,9,6,21,62,82,-20,33
Queen's Park,2073,10,7,10,19,41,73,-32,31
Raith,2074,1,23,8,5,70,33,37,77
Ayr,2074,2,24,4,8,94,42,52,76
Arbroath,2074,3,18,8,10,74,50,24,62
Alloa,2074,4,17,8,11,57,45,12,59
Stranraer,2074,5,15,5,16,55,67,-12,50
East Fife,2074,6,14,3,19,50,64,-14,45
Airdrieon,2074,7,10,11,15,46,60,-14,41
Forfar,2074,8,11,5,20,40,65,-25,38
Albion,2074,9,8,6,22,57,82,-25,30
Queen's Park,2074,10,6,10,20,41,76,-35,28
Ayr,2075,1,24,4,8,92,42,50,76
Raith,2075,2,22,9,5,69,33,36,75
Alloa,2075,3,17,9,10,57,44,13,60
Arbroath,2075,4,17,8,11,72,51,21,59
Stranraer,2075,5,15,5,16,55,67,-12,50
East Fife,2075,6,14,3,19,50,64,-14,45
Airdrieon,2075,7,11,11,14,47,59,-12,44
Forfar,2075,8,10,5,21,39,66,-27,35
Queen's Park,2075,9,7,10,19,42,74,-32,31
Albion,2075,10,8,6,22,57,80,-23,30
Raith,2076,1,23,8,5,72,33,39,77
Ayr,2076,2,24,4,8,95,46,49,76
Arbroath,2076,3,18,8,10,72,49,23,62
Alloa,2076,4,17,8,11,57,47,10,59
Stranraer,2076,5,16,5,15,56,64,-8,53
Airdrieon,2076,6,11,11,14,47,58,-11,44
East Fife,2076,7,13,3,20,47,65,-18,42
Forfar,2076,8,10,5,21,38,66,-28,35
Albion,2076,9,8,6,22,61,83,-22,30
Queen's Park,2076,10,6,10,20,40,74,-34,28
Raith,2077,1,23,8,5,69,32,37,77
Ayr,2077,2,24,4,8,94,42,52,76
Arbroath,2077,3,18,8,10,72,49,23,62
Alloa,2077,4,17,8,11,56,44,12,59
Stranraer,2077,5,15,5,16,56,67,-11,50
East Fife,2077,6,14,3,19,50,65,-15,45
Airdrieon,2077,7,11,11,14,47,59,-12,44
Forfar,2077,8,10,5,21,39,66,-27,35
Albion,2077,9,8,6,22,57,82,-25,30
Queen's Park,2077,10,6,10,20,40,74,-34,28
Raith,2078,1,23,8,5,70,33,37,77
Ayr,2078,2,24,4,8,93,42,51,76
Arbroath,2078,3,18,8,10,72,48,24,62
Alloa,2078,4,17,8,11,57,45,12,59
Stranraer,2078,5,16,5,15,57,64,-7,53
Airdrieon,2078,6,11,11,14,47,59,-12,44
East Fife,2078,7,13,3,20,47,66,-19,42
Forfar,2078,8,10,5,21,39,66,-27,35
Albion,2078,9,8,6,22,57,81,-24,30
Queen's Park,2078,10,6,10,20,39,74,-35,28
Ayr,2079,1,24,4,8,94,42,52,76
Raith,2079,2,22,8,6,69,34,35,74
Arbroath,2079,3,18,8,10,71,48,23,62
Alloa,2079,4,18,8,10,58,44,14,62
Stranraer,2079,5,15,6,15,57,66,-9,51
Airdrieon,2079,6,11,11,14,47,58,-11,44
East Fife,2079,7,13,4,19,49,66,-17,43
Forfar,2079,8,10,5,21,38,66,-28,35
Albion,2079,9,8,6,22,57,82,-25,30
Queen's Park,2079,10,6,10,20,39,73,-34,28
Raith,2080,1,23,8,5,69,32,37,77
Ayr,2080,2,24,4,8,93,42,51,76
Arbroath,2080,3,18,8,10,73,49,24,62
Alloa,2080,4,17,8,11,56,44,12,59
Stranraer,2080,5,15,5,16,55,65,-10,50
East Fife,2080,6,14,3,19,48,64,-16,45
Airdrieon,2080,7,11,11,14,47,59,-12,44
Forfar,2080,8,10,5,21,39,66,-27,35
Albion,2080,9,8,6,22,57,81,-24,30
Queen's Park,2080,10,6,10,20,40,75,-35,28
Raith,2081,1,23,8,5,70,33,37,77
Ayr,2081,2,24,4,8,95,44,51,76
Arbroath,2081,3,18,8,10,76,49,27,62
Alloa,2081,4,17,8,11,57,45,12,59
Stranraer,2081,5,15,5,16,55,66,-11,50
East Fife,2081,6,14,3,19,49,64,-15,45
Airdrieon,2081,7,10,11,15,45,59,-14,41
Forfar,2081,8,11,5,20,39,64,-25,38
Albion,2081,9,8,6,22,59,83,-24,30
Queen's Park,2081,10,6,10,20,40,78,-38,28
Raith,2082,1,23,8,5,69,32,37,77
Ayr,2082,2,24,4,8,96,43,53,76
Arbroath,2082,3,17,9,10,71,49,22,60
Alloa,2082,4,17,8,11,56,44,12,59
Stranraer,2082,5,16,5,15,57,64,-7,53
Airdrieon,2082,6,11,11,14,50,58,-8,44
East Fife,2082,7,13,3,20,47,66,-19,42
Forfar,2082,8,10,5,21,38,69,-31,35
Albion,2082,9,8,6,22,58,84,-26,30
Queen's Park,2082,10,6,11,19,40,73,-33,29
Raith,2083,1,22,9,5,69,33,36,75
Ayr,2083,2,23,4,9,90,43,47,73
Alloa,2083,3,17,9,10,57,44,13,60
Arbroath,2083,4,17,8,11,70,50,20,59
Stranraer,2083,5,15,6,15,57,66,-9,51
Airdrieon,2083,6,11,11,14,48,59,-11,44
East Fife,2083,7,13,4,19,49,66,-17,43
Forfar,2083,8,10,5,21,39,67,-28,35
Albion,2083,9,9,6,21,58,78,-20,33
Queen's Park,2083,10,7,10,19,41,72,-31,31
Raith,2084,1,23,8,5,71,33,38,77
Ayr,2084,2,24,4,8,92,43,49,76
Arbroath,2084,3,17,9,10,74,52,22,60
Alloa,2084,4,17,8,11,57,46,11,59
Stranraer,2084,5,15,5,16,56,67,-11,50
East Fife,2084,6,14,3,19,50,65,-15,45
Airdrieon,2084,7,10,12,14,45,58,-13,42
Forfar,2084,8,10,6,20,38,64,-26,36
Albion,2084,9,8,6,22,58,80,-22,30
Queen's Park,2084,10,6,11,19,43,76,-33,29
Ayr,2085,1,24,4,8,91,42,49,76
Raith,2085,2,22,9,5,68,32,36,75
Arbroath,2085,3,18,8,10,72,49,23,62
Alloa,2085,4,17,9,10,56,43,13,60
Stranraer,2085,5,16,5,15,56,64,-8,53
Airdrieon,2085,6,11,11,14,46,58,-12,44
East Fife,2085,7,13,3,20,47,65,-18,42
Forfar,2085,8,10,5,21,38,65,-27,35
Albion,2085,9,8,6,22,57,79,-22,30
Queen's Park,2085,10,6,10,20,40,74,-34,28
Ayr,2086,1,24,4,8,95,45,50,76
Raith,2086,2,22,9,5,68,32,36,75
Alloa,2086,3,17,9,10,56,43,13,60
Arbroath,2086,4,17,8,11,70,49,21,59
Stranraer,2086,5,16,5,15,57,65,-8,53
East Fife,2086,6,13,3,20,48,66,-18,42
Airdrieon,2086,7,10,11,15,47,61,-14,41
Forfar,2086,8,11,5,20,41,66,-25,38
Queen's Park,2086,9,7,10,19,40,72,-32,31
Albion,2086,10,8,6,22,60,83,-23,30
Ayr,2087,1,24,4,8,93,44,49,76
Raith,2087,2,22,9,5,68,32,36,75
Arbroath,2087,3,18,8,10,72,48,24,62
Alloa,2087,4,17,9,10,56,43,13,60
Stranraer,2087,5,15,5,16,56,66,-10,50
East Fife,2087,6,14,3,19,49,65,-16,45
Airdrieon,2087,7,11,11,14,48,60,-12,44
Forfar,2087,8,10,5,21,40,67,-27,35
Albion,2087,9,8,6,22,59,81,-22,30
Queen's Park,2087,10,6,10,20,39,74,-35,28
Raith,2088,1,23,8,5,71,33,38,77
Ayr,2088,2,24,4,8,95,44,51,76
Arbroath,2088,3,17,8,11,73,52,21,59
Alloa,2088,4,17,8,11,57,46,11,59
Stranraer,2088,5,15,5,16,55,68,-13,50
East Fife,2088,6,14,3,19,51,64,-13,45
Airdrieon,2088,7,11,11,14,48,58,-10,44
Forfar,2088,8,10,5,21,38,67,-29,35
Queen's Park,2088,9,7,10,19,43,75,-32,31
Albion,2088,10,8,6,22,59,83,-24,30
Ayr,2089,1,24,4,8,91,42,49,76
Raith,2089,2,22,9,5,69,33,36,75
Alloa,2089,3,17,9,10,57,44,13,60
Arbroath,2089,4,17,8,11,70,49,21,59
Stranraer,2089,5,15,5,16,56,66,-10,50
East Fife,2089,6,14,3,19,49,65,-16,45
Airdrieon,2089,7,11,11,14,47,59,-12,44
Forfar,2089,8,10,5,21,39,66,-27,35
Queen's Park,2089,9,7,10,19,40,72,-32,31
Albion,2089,10,8,6,22,57,79,-22,30
Ayr,2090,1,24,4,8,95,43,52,76
Raith,2090,2,22,9,5,69,33,36,75
Alloa,2090,3,17,9,10,57,44,13,60
Arbroath,2090,4,17,8,11,71,52,19,59
Stranraer,2090,5,16,5,15,56,64,-8,53
Airdrieon,2090,6,11,11,14,48,60,-12,44
East Fife,2090,7,13,3,20,47,65,-18,42
Forfar,2090,8,10,5,21,40,67,-27,35
Queen's Park,2090,9,7,10,19,43,73,-30,31
Albion,2090,10,8,6,22,58,83,-25,30
Raith,2091,1,22,9,5,71,35,36,75
Ayr,2091,2,23,5,8,91,43,48,74
Alloa,2091,3,17,9,10,59,46,13,60
Arbroath,2091,4,17,8,11,71,50,21,59
Stranraer,2091,5,15,5,16,56,66,-10,50
East Fife,2091,6,14,3,19,49,65,-16,45
Airdrieon,2091,7,10,12,14,46,59,-13,42
Forfar,2091,8,10,6,20,39,65,-26,36
Albion,2091,9,8,7,21,58,79,-21,31
Queen's Park,2091,10,7,10,19,41,73,-32,31
Ayr,2092,1,24,4,8,95,42,53,76
Raith,2092,2,22,8,6,69,35,34,74
Arbroath,2092,3,18,8,10,72,49,23,62
Alloa,2092,4,18,8,10,59,44,15,62
Stranraer,2092,5,15,5,16,57,67,-10,50
East Fife,2092,6,14,3,19,50,66,-16,45
Airdrieon,2092,7,11,11,14,47,59,-12,44
Forfar,2092,8,10,5,21,39,66,-27,35
Albion,2092,9,8,6,22,57,83,-26,30
Queen's Park,2092,10,6,10,20,40,74,-34,28
Raith,2093,1,22,9,5,68,32,36,75
Ayr,2093,2,23,4,9,91,46,45,73
Arbroath,2093,3,17,9,10,72,50,22,60
Alloa,2093,4,17,9,10,56,43,13,60
Stranraer,2093,5,15,5,16,55,66,-11,50
East Fife,2093,6,14,3,19,49,64,-15,45
Airdrieon,2093,7,11,11,14,46,58,-12,44
Forfar,2093,8,10,5,21,38,65,-27,35
Albion,2093,9,9,6,21,61,79,-18,33
Queen's Park,2093,10,6,11,19,41,74,-33,29
Ayr,2094,1,24,4,8,95,42,53,76
Raith,2094,2,22,8,6,68,34,34,74
Arbroath,2094,3,18,8,10,72,49,23,62
Alloa,2094,4,18,8,10,58,43,15,62
Stranraer,2094,5,16,5,15,58,64,-6,53
Airdrieon,2094,6,11,11,14,48,59,-11,44
East Fife,2094,7,13,3,20,47,67,-20,42
Forfar,2094,8,10,5,21,39,67,-28,35
Albion,2094,9,8,6,22,57,83,-26,30
Queen's Park,2094,10,6,10,20,40,74,-34,28
Raith,2095,1,23,8,5,69,32,37,77
Ayr,2095,2,23,5,8,91,43,48,74
Arbroath,2095,3,18,8,10,74,48,26,62
Alloa,2095,4,17,8,11,56,44,12,59
Stranraer,2095,5,15,5,16,55,66,-11,50
East Fife,2095,6,14,3,19,49,64,-15,45
Airdrieon,2095,7,11,11,14,47,58,-11,44
Forfar,2095,8,10,5,21,38,66,-28,35
Albion,2095,9,8,7,21,58,79,-21,31
Queen's Park,2095,10,6,10,20,39,76,-37,28
Ayr,2096,1,24,4,8,95,45,50,76
Raith,2096,2,22,8,6,69,35,34,74
Alloa,2096,3,18,8,10,59,44,15,62
Arbroath,2096,4,17,9,10,70,48,22,60
Stranraer,2096,5,15,5,16,55,65,-10,50
East Fife,2096,6,14,3,19,48,64,-16,45
Airdrieon,2096,7,11,11,14,48,58,-10,44
Forfar,2096,8,10,5,21,38,67,-29,35
Albion,2096,9,8,6,22,60,83,-23,30
Queen's Park,2096,10,6,11,19,39,72,-33,29
Raith,2097,1,23,8,5,71,34,37,77
Ayr,2097,2,24,4,8,93,44,49,76
Arbroath,2097,3,18,8,10,72,48,24,62
Alloa,2097,4,17,8,11,58,46,12,59
Stranraer,2097,5,15,6,15,57,66,-9,51
Airdrieon,2097,6,11,11,14,47,59,-12,44
East Fife,2097,7,13,4,19,49,66,-17,43
Forfar,2097,8,10,5,21,39,66,-27,35
Albion,2097,9,8,6,22,59,81,-22,30
Queen's Park,2097,10,6,10,20,39,74,-35,28
Ayr,2098,1,24,4,8,95,43,52,76
Raith,2098,2,22,9,5,69,33,36,75
Arbroath,2098,3,18,8,10,74,49,25,62
Alloa,2098,4,17,9,10,57,44,13,60
Stranraer,2098,5,15,6,15,57,66,-9,51
East Fife,2098,6,13,4,19,49,66,-17,43
Airdrieon,2098,7,10,11,15,46,62,-16,41
Forfar,2098,8,11,5,20,42,65,-23,38
Albion,2098,9,8,6,22,58,83,-25,30
Queen's Park,2098,10,6,10,20,40,76,-36,28
Ayr,2099,1,24,4,8,95,42,53,76
Raith,2099,2,22,8,6,68,34,34,74
Arbroath,2099,3,18,8,10,74,51,23,62
Alloa,2099,4,18,8,10,58,43,15,62
Stranraer,2099,5,15,6,15,55,64,-9,51
East Fife,2099,6,13,4,19,47,64,-17,43
Airdrieon,2099,7,10,12,14,46,59,-13,42
Forfar,2099,8,10,6,20,39,65,-26,36
Albion,2099,9,8,6,22,57,83,-26,30
Queen's Park,2099,10,6,10,20,42,76,-34,28
Ayr,2100,1,24,4,8,93,43,50,76
Raith,2100,2,22,9,5,68,32,36,75
Alloa,2100,3,17,9,10,56,43,13,60
Arbroath,2100,4,17,8,11,71,50,21,59
Stranraer,2100,5,15,6,15,56,65,-9,51
East Fife,2100,6,13,4,19,48,65,-17,43
Airdrieon,2100,7,10,11,15,45,59,-14,41
Forfar,2100,8,11,5,20,39,64,-25,38
Queen's Park,2100,9,7,10,19,41,73,-32,31
Albion,2100,10,8,6,22,58,81,-23,30
Ayr,2101,1,24,4,8,98,42,56,76
Raith,2101,2,22,8,6,71,36,35,74
Alloa,2101,3,18,8,10,60,46,14,62
Arbroath,2101,4,17,8,11,71,50,21,59
Stranraer,2101,5,16,5,15,57,65,-8,53
Airdrieon,2101,6,11,11,14,50,59,-9,44
East Fife,2101,7,13,3,20,48,66,-18,42
Forfar,2101,8,10,5,21,39,69,-30,35
Queen's Park,2101,9,7,10,19,41,73,-32,31
Albion,2101,10,8,6,22,57,86,-29,30
Raith,2102,1,23,8,5,72,32,40,77
Ayr,2102,2,24,4,8,92,43,49,76
Arbroath,2102,3,17,8,11,70,49,21,59
Alloa,2102,4,17,8,11,56,47,9,59
Stranraer,2102,5,16,5,15,57,64,-7,53
Airdrieon,2102,6,11,11,14,47,58,-11,44
East Fife,2102,7,13,3,20,47,66,-19,42
Forfar,2102,8,10,5,21,38,66,-28,35
Queen's Park,2102,9,7,10,19,40,72,-32,31
Albion,2102,10,8,6,22,58,80,-22,30
Raith,2103,1,23,8,5,73,34,39,77
Ayr,2103,2,24,4,8,96,45,51,76
Arbroath,2103,3,17,8,11,72,51,21,59
Alloa,2103,4,17,8,11,58,48,10,59
Stranraer,2103,5,16,5,15,58,65,-7,53
Airdrieon,2103,6,11,11,14,46,58,-12,44
East Fife,2103,7,13,3,20,48,67,-19,42
Forfar,2103,8,10,5,21,38,65,-27,35
Queen's Park,2103,9,7,10,19,42,74,-32,31
Albion,2103,10,8,6,22,60,84,-24,30
Raith,2104,1,22,9,5,69,33,36,75
Ayr,2104,2,23,4,9,92,45,47,73
Alloa,2104,3,17,9,10,57,44,13,60
Arbroath,2104,4,17,8,11,71,50,21,59
Stranraer,2104,5,15,6,15,57,66,-9,51
East Fife,2104,6,13,4,19,49,66,-17,43
Airdrieon,2104,7,10,11,15,45,61,-16,41
Forfar,2104,8,11,5,20,41,64,-23,38
Albion,2104,9,9,6,21,60,80,-20,33
Queen's Park,2104,10,7,10,19,41,73,-32,31
Raith,2105,1,23,8,5,72,34,38,77
Ayr,2105,2,24,4,8,92,42,50,76
Arbroath,2105,3,18,8,10,72,48,24,62
Alloa,2105,4,17,8,11,58,47,11,59
Stranraer,2105,5,15,6,15,56,65,-9,51
Airdrieon,2105,6,11,11,14,46,58,-12,44
East Fife,2105,7,13,4,19,48,65,-17,43
Forfar,2105,8,10,5,21,38,65,-27,35
Albion,2105,9,8,6,22,57,80,-23,30
Queen's Park,2105,10,6,10,20,39,74,-35,28
Raith,2106,1,23,8,5,71,33,38,77
Ayr,2106,2,24,4,8,94,43,51,76
Arbroath,2106,3,17,9,10,72,50,22,60
Alloa,2106,4,17,8,11,57,46,11,59
Stranraer,2106,5,15,6,15,56,65,-9,51
East Fife,2106,6,13,4,19,48,65,-17,43
Airdrieon,2106,7,10,11,15,45,59,-14,41
Forfar,2106,8,11,5,20,39,64,-25,38
Albion,2106,9,8,6,22,58,82,-24,30
Queen's Park,2106,10,6,11,19,41,74,-33,29
Ayr,2107,1,24,4,8,93,43,50,76
Raith,2107,2,22,8,6,69,34,35,74
Arbroath,2107,3,18,8,10,73,49,24,62
Alloa,2107,4,18,8,10,58,44,14,62
Stranraer,2107,5,15,6,15,56,65,-9,51
East Fife,2107,6,13,4,19,48,65,-17,43
Airdrieon,2107,7,10,11,15,45,60,-15,41
Forfar,2107,8,11,5,20,40,64,-24,38
Albion,2107,9,8,6,22,58,81,-23,30
Queen's Park,2107,10,6,10,20,40,75,-35,28
Ayr,2108,1,24,4,8,94,42,52,76
Raith,2108,2,22,9,5,69,33,36,75
Arbroath,2108,3,18,8,10,74,49,25,62
Alloa,2108,4,17,9,10,57,44,13,60
Stranraer,2108,5,16,5,15,56,64,-8,53
Airdrieon,2108,6,11,11,14,47,59,-12,44
East Fife,2108,7,13,3,20,47,65,-18,42
Forfar,2108,8,10,5,21,39,66,-27,35
Albion,2108,9,8,6,22,57,82,-25,30
Queen's Park,2108,10,6,10,20,40,76,-36,28
Raith,2109,1,23,8,5,70,33,37,77
Ayr,2109,2,24,4,8,94,43,51,76
Arbroath,2109,3,17,8,11,71,50,21,59
Alloa,2109,4,17,8,11,57,45,12,59
Stranraer,2109,5,16,5,15,57,64,-7,53
Airdrieon,2109,6,11,11,14,47,58,-11,44
East Fife,2109,7,13,3,20,47,66,-19,42
Forfar,2109,8,10,5,21,38,66,-28,35
Queen's Park,2109,9,7,10,19,41,73,-32,31
Albion,2109,10,8,6,22,58,82,-24,30
Raith,2110,1,23,8,5,70,32,38,77
Ayr,2110,2,24,4,8,95,45,50,76
Arbroath,2110,3,17,8,11,71,50,21,59
Alloa,2110,4,17,8,11,56,45,11,59
Stranraer,2110,5,15,6,15,58,67,-9,51
East Fife,2110,6,13,4,19,50,67,-17,43
Airdrieon,2110,7,10,11,15,45,60,-15,41
Forfar,2110,8,11,5,20,40,64,-24,38
Queen's Park,2110,9,7,10,19,41,73,-32,31
Albion,2110,10,8,6,22,60,83,-23,30
Raith,2111,1,23,8,5,70,33,37,77
Ayr,2111,2,24,4,8,91,42,49,76
Arbroath,2111,3,17,9,10,72,50,22,60
Alloa,2111,4,17,8,11,57,45,12,59
Stranraer,2111,5,16,5,15,58,66,-8,53
Airdrieon,2111,6,10,12,14,46,59,-13,42
East Fife,2111,7,13,3,20,49,67,-18,42
Forfar,2111,8,10,6,20,39,65,-26,36
Albion,2111,9,8,6,22,57,79,-22,30
Queen's Park,2111,10,6,11,19,41,74,-33,29
Raith,2112,1,23,8,5,71,34,37,77
Ayr,2112,2,24,4,8,93,43,50,76
Arbroath,2112,3,17,9,10,71,49,22,60
Alloa,2112,4,17,8,11,58,46,12,59
Stranraer,2112,5,15,5,16,56,68,-12,50
East Fife,2112,6,14,3,19,51,65,-14,45
Airdrieon,2112,7,10,12,14,46,59,-13,42
Forfar,2112,8,10,6,20,39,65,-26,36
Albion,2112,9,8,6,22,58,81,-23,30
Queen's Park,2112,10,6,11,19,40,73,-33,29
Raith,2113,1,23,8,5,70,33,37,77
Ayr,2113,2,23,5,8,93,45,48,74
Arbroath,2113,3,18,8,10,74,50,24,62
Alloa,2113,4,17,8,11,57,45,12,59
Stranraer,2113,5,16,5,15,58,65,-7,53
Airdrieon,2113,6,11,11,14,47,58,-11,44
East Fife,2113,7,13,3,20,48,67,-19,42
Forfar,2113,8,10,5,21,38,66,-28,35
Albion,2113,9,8,7,21,60,81,-21,31
Queen's Park,2113,10,6,10,20,41,76,-35,28
Ayr,2114,1,24,4,8,96,43,53,76
Raith,2114,2,22,8,6,69,35,34,74
Arbroath,2114,3,18,8,10,72,49,23,62
Alloa,2114,4,18,8,10,59,44,15,62
Stranraer,2114,5,16,5,15,57,65,-8,53
Airdrieon,2114,6,10,12,14,46,59,-13,42
East Fife,2114,7,13,3,20,48,66,-18,42
Forfar,2114,8,10,6,20,39,65,-26,36
Albion,2114,9,8,6,22,58,84,-26,30
Queen's Park,2114,10,6,10,20,40,74,-34,28
Ayr,2115,1,24,4,8,92,42,50,76
Raith,2115,2,22,9,5,68,32,36,75
Arbroath,2115,3,18,8,10,72,49,23,62
Alloa,2115,4,17,9,10,56,43,13,60
Stranraer,2115,5,15,5,16,56,67,-11,50
East Fife,2115,6,14,3,19,50,65,-15,45
Airdrieon,2115,7,11,11,14,47,59,-12,44
Forfar,2115,8,10,5,21,39,66,-27,35
Albion,2115,9,8,6,22,57,80,-23,30
Queen's Park,2115,10,6,10,20,40,74,-34,28
Raith,2116,1,23,8,5,71,32,39,77
Ayr,2116,2,23,4,9,91,44,47,73
Arbroath,2116,3,17,8,11,70,51,19,59
Alloa,2116,4,17,8,11,56,46,10,59
Stranraer,2116,5,15,6,15,55,64,-9,51
Airdrieon,2116,6,11,11,14,47,58,-11,44
East Fife,2116,7,13,4,19,47,64,-17,43
Forfar,2116,8,10,5,21,38,66,-28,35
Albion,2116,9,9,6,21,59,79,-20,33
Queen's Park,2116,10,7,10,19,42,72,-30,31
Raith,2117,1,23,8,5,73,33,40,77
Ayr,2117,2,23,4,9,92,45,47,73
Arbroath,2117,3,17,9,10,72,50,22,60
Alloa,2117,4,17,8,11,57,48,9,59
Stranraer,2117,5,15,5,16,56,67,-11,50
East Fife,2117,6,14,3,19,50,65,-15,45
Airdrieon,2117,7,10,12,14,47,60,-13,42
Forfar,2117,8,10,6,20,40,66,-26,36
Albion,2117,9,9,6,21,60,80,-20,33
Queen's Park,2117,10,6,11,19,41,74,-33,29
Raith,2118,1,23,8,5,69,32,37,77
Ayr,2118,2,24,4,8,93,43,50,76
Arbroath,2118,3,18,8,10,72,49,23,62
Alloa,2118,4,17,8,11,56,44,12,59
Stranraer,2118,5,15,5,16,56,68,-12,50
East Fife,2118,6,14,3,19,51,65,-14,45
Airdrieon,2118,7,11,11,14,48,59,-11,44
Forfar,2118,8,10,5,21,39,67,-28,35
Albion,2118,9,8,6,22,58,81,-23,30
Queen's Park,2118,10,6,10,20,40,74,-34,28
Raith,2119,1,22,8,6,69,34,35,74
Ayr,2119,2,23,4,9,90,44,46,73
Alloa,2119,3,18,8,10,58,44,14,62
Arbroath,2119,4,17,9,10,73,51,22,60
Stranraer,2119,5,15,6,15,56,65,-9,51
Airdrieon,2119,6,11,11,14,49,59,-10,44
East Fife,2119,7,13,4,19,48,65,-17,43
Forfar,2119,8,10,5,21,39,68,-29,35
Albion,2119,9,9,6,21,59,78,-19,33
Queen's Park,2119,10,6,11,19,42,75,-33,29
Raith,2120,1,23,8,5,70,32,38,77
Ayr,2120,2,24,4,8,92,43,49,76
Arbroath,2120,3,18,8,10,73,49,24,62
Alloa,2120,4,17,8,11,56,45,11,59
Stranraer,2120,5,15,5,16,55,67,-12,50
East Fife,2120,6,14,3,19,50,64,-14,45
Airdrieon,2120,7,11,11,14,46,58,-12,44
Forfar,2120,8,10,5,21,38,65,-27,35
Albion,2120,9,8,6,22,58,80,-22,30
Queen's Park,2120,10,6,10,20,40,75,-35,28
Raith,2121,1,23,8,5,70,32,38,77
Ayr,2121,2,24,4,8,96,45,51,76
Arbroath,2121,3,17,8,11,71,50,21,59
Alloa,2121,4,17,8,11,56,45,11,59
Stranraer,2121,5,15,6,15,56,65,-9,51
Airdrieon,2121,6,11,11,14,46,58,-12,44
East Fife,2121,7,13,4,19,48,65,-17,43
Forfar,2121,8,10,5,21,38,65,-27,35
Queen's Park,2121,9,7,10,19,41,73,-32,31
Albion,2121,10,8,6,22,60,84,-24,30
Raith,2122,1,23,8,5,71,34,37,77
Ayr,2122,2,24,4,8,94,43,51,76
Arbroath,2122,3,18,8,10,76,50,26,62
Alloa,2122,4,17,8,11,58,46,12,59
Stranraer,2122,5,15,5,16,56,67,-11,50
East Fife,2122,6,14,3,19,50,65,-15,45
Airdrieon,2122,7,11,11,14,46,58,-12,44
Forfar,2122,8,10,5,21,38,65,-27,35
Albion,2122,9,8,6,22,58,82,-24,30
Queen's Park,2122,10,6,10,20,41,78,-37,28
Raith,2123,1,23,8,5,72,33,39,77
Ayr,2123,2,24,4,8,94,44,50,76
Arbroath,2123,3,18,8,10,73,50,23,62
Alloa,2123,4,17,8,11,57,47,10,59
Stranraer,2123,5,15,6,15,57,66,-9,51
Airdrieon,2123,6,11,11,14,48,58,-10,44
East Fife,2123,7,13,4,19,49,66,-17,43
Forfar,2123,8,10,5,21,38,67,-29,35
Albion,2123,9,8,6,22,59,82,-23,30
Queen's Park,2123,10,6,10,20,41,75,-34,28
Raith,2124,1,23,8,5,72,34,38,77
Ayr,2124,2,24,4,8,97,43,54,76
Arbroath,2124,3,18,8,10,71,48,23,62
Alloa,2124,4,17,8,11,58,47,11,59
Stranraer,2124,5,15,5,16,56,70,-14,50
East Fife,2124,6,14,3,19,53,65,-12,45
Airdrieon,2124,7,11,11,14,46,58,-12,44
Forfar,2124,8,10,5,21,38,65,-27,35
Albion,2124,9,8,6,22,58,85,-27,30
Queen's Park,2124,10,6,10,20,39,73,-34,28
Raith,2125,1,22,8,6,68,34,34,74
Ayr,2125,2,23,4,9,91,45,46,73
Arbroath,2125,3,18,8,10,72,49,23,62
Alloa,2125,4,18,8,10,58,43,15,62
Stranraer,2125,5,15,5,16,55,66,-11,50
East Fife,2125,6,14,3,19,49,64,-15,45
Airdrieon,2125,7,10,12,14,46,59,-13,42
Forfar,2125,8,10,6,20,39,65,-26,36
Albion,2125,9,9,6,21,60,79,-19,33
Queen's Park,2125,10,6,10,20,40,74,-34,28
Raith,2126,1,23,8,5,69,32,37,77
Ayr,2126,2,24,4,8,92,43,49,76
Arbroath,2126,3,18,8,10,73,50,23,62
Alloa,2126,4,17,8,11,56,44,12,59
Stranraer,2126,5,16,5,15,58,64,-6,53
Airdrieon,2126,6,10,12,14,47,60,-13,42
East Fife,2126,7,13,3,20,47,67,-20,42
Forfar,2126,8,10,6,20,40,66,-26,36
Albion,2126,9,8,6,22,58,80,-22,30
Queen's Park,2126,10,6,10,20,41,75,-34,28
Raith,2127,1,23,8,5,71,32,39,77
Ayr,2127,2,24,4,8,94,43,51,76
Arbroath,2127,3,17,8,11,70,49,21,59
Alloa,2127,4,17,8,11,56,46,10,59
Stranraer,2127,5,16,5,15,56,64,-8,53
Airdrieon,2127,6,11,11,14,47,58,-11,44
East Fife,2127,7,13,3,20,47,65,-18,42
Forfar,2127,8,10,5,21,38,66,-28,35
Queen's Park,2127,9,7,10,19,40,72,-32,31
Albion,2127,10,8,6,22,58,82,-24,30
Ayr,2128,1,24,4,8,94,44,50,76
Raith,2128,2,22,9,5,68,32,36,75
Arbroath,2128,3,18,8,10,74,48,26,62
Alloa,2128,4,17,9,10,56,43,13,60
Stranraer,2128,5,16,5,15,57,64,-7,53
East Fife,2128,6,13,3,20,47,66,-19,42
Airdrieon,2128,7,10,11,15,45,60,-15,41
Forfar,2128,8,11,5,20,40,64,-24,38
Albion,2128,9,8,6,22,59,82,-23,30
Queen's Park,2128,10,6,10,20,39,76,-37,28
Raith,2129,1,23,8,5,70,33,37,77
Ayr,2129,2,24,4,8,94,42,52,76
Arbroath,2129,3,17,9,10,71,49,22,60
Alloa,2129,4,17,8,11,57,45,12,59
Stranraer,2129,5,15,5,16,56,67,-11,50
East Fife,2129,6,14,3,19,50,65,-15,45
Airdrieon,2129,7,11,11,14,49,59,-10,44
Forfar,2129,8,10,5,21,39,68,-29,35
Albion,2129,9,8,6,22,57,82,-25,30
Queen's Park,2129,10,6,11,19,40,73,-33,29
Raith,2130,1,23,8,5,70,32,38,77
Ayr,2130,2,24,4,8,93,44,49,76
Arbroath,2130,3,17,8,11,70,49,21,59
Alloa,2130,4,17,8,11,56,45,11,59
Stranraer,2130,5,16,5,15,57,65,-8,53
Airdrieon,2130,6,10,12,14,46,59,-13,42
East Fife,2130,7,13,3,20,48,66,-18,42
Forfar,2130,8,10,6,20,39,65,-26,36
Queen's Park,2130,9,7,10,19,40,72,-32,31
Albion,2130,10,8,6,22,59,81,-22,30
Ayr,2131,1,24,4,8,95,43,52,76
Raith,2131,2,22,8,6,69,34,35,74
Alloa,2131,3,18,8,10,58,44,14,62
Arbroath,2131,4,17,8,11,70,51,19,59
Stranraer,2131,5,15,5,16,55,66,-11,50
East Fife,2131,6,14,3,19,49,64,-15,45
Airdrieon,2131,7,10,11,15,45,60,-15,41
Forfar,2131,8,11,5,20,40,64,-24,38
Queen's Park,2131,9,7,10,19,42,72,-30,31
Albion,2131,10,8,6,22,58,83,-25,30
Raith,2132,1,22,9,5,69,33,36,75
Ayr,2132,2,23,4,9,93,46,47,73
Alloa,2132,3,17,9,10,57,44,13,60
Arbroath,2132,4,17,8,11,71,50,21,59
Stranraer,2132,5,15,6,15,55,64,-9,51
East Fife,2132,6,13,4,19,47,64,-17,43
Airdrieon,2132,7,10,11,15,45,59,-14,41
Forfar,2132,8,11,5,20,39,64,-25,38
Albion,2132,9,9,6,21,61,81,-20,33
Queen's Park,2132,10,7,10,19,41,73,-32,31
Ayr,2133,1,24,4,8,93,44,49,76
Raith,2133,2,22,9,5,70,34,36,75
Arbroath,2133,3,18,8,10,72,49,23,62
Alloa,2133,4,17,9,10,58,45,13,60
Stranraer,2133,5,15,6,15,56,65,-9,51
East Fife,2133,6,13,4,19,48,65,-17,43
Airdrieon,2133,7,10,12,14,46,59,-13,42
Forfar,2133,8,10,6,20,39,65,-26,36
Albion,2133,9,8,6,22,59,81,-22,30
Queen's Park,2133,10,6,10,20,40,74,-34,28
Raith,2134,1,23,8,5,70,32,38,77
Ayr,2134,2,24,4,8,94,45,49,76
Arbroath,2134,3,18,8,10,75,48,27,62
Alloa,2134,4,17,8,11,56,45,11,59
Stranraer,2134,5,15,5,16,55,68,-13,50
East Fife,2134,6,14,3,19,51,64,-13,45
Airdrieon,2134,7,10,12,14,46,59,-13,42
Forfar,2134,8,10,6,20,39,65,-26,36
Albion,2134,9,8,6,22,60,82,-22,30
Queen's Park,2134,10,6,10,20,39,77,-38,28
Raith,2135,1,23,8,5,69,32,37,77
Ayr,2135,2,23,5,8,94,46,48,74
Arbroath,2135,3,17,8,11,71,50,21,59
Alloa,2135,4,17,8,11,56,44,12,59
Stranraer,2135,5,15,5,16,55,66,-11,50
East Fife,2135,6,14,3,19,49,64,-15,45
Airdrieon,2135,7,10,11,15,45,59,-14,41
Forfar,2135,8,11,5,20,39,64,-25,38
Albion,2135,9,8,7,21,61,82,-21,31
Queen's Park,2135,10,7,10,19,41,73,-32,31
Ayr,2136,1,23,5,8,95,47,48,74
Raith,2136,2,22,8,6,69,35,34,74
Arbroath,2136,3,18,8,10,75,48,27,62
Alloa,2136,4,18,8,10,59,44,15,62
Stranraer,2136,5,15,5,16,55,65,-10,50
East Fife,2136,6,14,3,19,48,64,-16,45
Airdrieon,2136,7,10,11,15,45,59,-14,41
Forfar,2136,8,11,5,20,39,64,-25,38
Albion,2136,9,8,7,21,62,83,-21,31
Queen's Park,2136,10,6,10,20,39,77,-38,28
Raith,2137,1,23,8,5,70,33,37,77
Ayr,2137,2,24,4,8,94,44,50,76
Arbroath,2137,3,17,9,10,72,50,22,60
Alloa,2137,4,17,8,11,57,45,12,59
Stranraer,2137,5,16,5,15,60,67,-7,53
Airdrieon,2137,6,11,11,14,48,58,-10,44
East Fife,2137,7,13,3,20,50,69,-19,42
Forfar,2137,8,10,5,21,38,67,-29,35
Albion,2137,9,8,6,22,59,82,-23,30
Queen's Park,2137,10,6,11,19,41,74,-33,29
Ayr,2138,1,24,4,8,98,46,52,76
Raith,2138,2,22,9,5,69,33,36,75
Arbroath,2138,3,17,9,10,71,49,22,60
Alloa,2138,4,17,9,10,57,44,13,60
Stranraer,2138,5,15,6,15,56,65,-9,51
East Fife,2138,6,13,4,19,48,65,-17,43
Airdrieon,2138,7,10,12,14,46,59,-13,42
Forfar,2138,8,10,6,20,39,65,-26,36
Albion,2138,9,8,6,22,61,86,-25,30
Queen's Park,2138,10,6,11,19,40,73,-33,29
Raith,2139,1,22,8,6,69,34,35,74
Ayr,2139,2,23,4,9,91,44,47,73
Arbroath,2139,3,18,8,10,71,48,23,62
Alloa,2139,4,18,8,10,58,44,14,62
Stranraer,2139,5,16,5,15,57,65,-8,53
Airdrieon,2139,6,11,11,14,47,59,-12,44
East Fife,2139,7,13,3,20,48,66,-18,42
Forfar,2139,8,10,5,21,39,66,-27,35
Albion,2139,9,9,6,21,59,79,-20,33
Queen's Park,2139,10,6,10,20,39,73,-34,28
Ayr,2140,1,24,4,8,92,43,49,76
Raith,2140,2,22,8,6,68,33,35,74
Alloa,2140,3,18,8,10,57,43,14,62
Arbroath,2140,4,17,8,11,72,51,21,59
Stranraer,2140,5,15,5,16,55,65,-10,50
East Fife,2140,6,14,3,19,48,64,-16,45
Airdrieon,2140,7,11,11,14,47,58,-11,44
Forfar,2140,8,10,5,21,38,66,-28,35
Queen's Park,2140,9,7,10,19,42,74,-32,31
Albion,2140,10,8,6,22,58,80,-22,30
Ayr,2141,1,24,4,8,93,42,51,76
Raith,2141,2,22,9,5,68,32,36,75
Arbroath,2141,3,18,8,10,75,48,27,62
Alloa,2141,4,17,9,10,56,43,13,60
Stranraer,2141,5,15,5,16,56,66,-10,50
East Fife,2141,6,14,3,19,49,65,-16,45
Airdrieon,2141,7,11,11,14,48,60,-12,44
Forfar,2141,8,10,5,21,40,67,-27,35
Albion,2141,9,8,6,22,57,81,-24,30
Queen's Park,2141,10,6,10,20,39,77,-38,28
Ayr,2142,1,24,4,8,95,45,50,76
Raith,2142,2,22,9,5,69,33,36,75
Arbroath,2142,3,18,8,10,71,48,23,62
Alloa,2142,4,17,9,10,57,44,13,60
Stranraer,2142,5,15,5,16,56,67,-11,50
East Fife,2142,6,14,3,19,50,65,-15,45
Airdrieon,2142,7,11,11,14,47,58,-11,44
Forfar,2142,8,10,5,21,38,66,-28,35
Albion,2142,9,8,6,22,60,83,-23,30
Queen's Park,2142,10,6,10,20,39,73,-34,28
Raith,2143,1,23,8,5,70,32,38,77
Ayr,2143,2,24,4,8,92,43,49,76
Arbroath,2143,3,18,8,10,72,49,23,62
Alloa,2143,4,17,8,11,56,45,11,59
Stranraer,2143,5,15,5,16,56,66,-10,50
East Fife,2143,6,14,3,19,49,65,-16,45
Airdrieon,2143,7,11,11,14,48,59,-11,44
Forfar,2143,8,10,5,21,39,67,-28,35
Albion,2143,9,8,6,22,58,80,-22,30
Queen's Park,2143,10,6,10,20,40,74,-34,28
Raith,2144,1,23,8,5,70,32,38,77
Ayr,2144,2,24,4,8,96,42,54,76
Arbroath,2144,3,17,8,11,73,54,19,59
Alloa,2144,4,17,8,11,56,45,11,59
Stranraer,2144,5,16,5,15,59,67,-8,53
Airdrieon,2144,6,11,11,14,47,58,-11,44
East Fife,2144,7,13,3,20,50,68,-18,42
Forfar,2144,8,10,5,21,38,66,-28,35
Queen's Park,2144,9,7,10,19,45,75,-30,31
Albion,2144,10,8,6,22,57,84,-27,30
Raith,2145,1,23,8,5,70,32,38,77
Ayr,2145,2,23,5,8,91,43,48,74
Arbroath,2145,3,17,8,11,70,49,21,59
Alloa,2145,4,17,8,11,56,45,11,59
Stranraer,2145,5,15,6,15,58,67,-9,51
East Fife,2145,6,13,4,19,50,67,-17,43
Airdrieon,2145,7,10,12,14,46,59,-13,42
Forfar,2145,8,10,6,20,39,65,-26,36
Albion,2145,9,8,7,21,58,79,-21,31
Queen's Park,2145,10,7,10,19,40,72,-32,31
Ayr,2146,1,24,4,8,93,43,50,76
Raith,2146,2,22,9,5,68,32,36,75
Arbroath,2146,3,18,8,10,72,49,23,62
Alloa,2146,4,17,9,10,56,43,13,60
Stranraer,2146,5,16,5,15,59,65,-6,53
Airdrieon,2146,6,10,12,14,47,60,-13,42
East Fife,2146,7,13,3,20,48,68,-20,42
Forfar,2146,8,10,6,20,40,66,-26,36
Albion,2146,9,8,6,22,58,81,-23,30
Queen's Park,2146,10,6,10,20,40,74,-34,28
Ayr,2147,1,24,4,8,95,42,53,76
Raith,2147,2,22,9,5,68,32,36,75
Alloa,2147,3,17,9,10,56,43,13,60
Arbroath,2147,4,17,8,11,72,51,21,59
Stranraer,2147,5,15,5,16,55,66,-11,50
East Fife,2147,6,14,3,19,49,64,-15,45
Airdrieon,2147,7,10,11,15,46,62,-16,41
Forfar,2147,8,11,5,20,42,65,-23,38
Queen's Park,2147,9,7,10,19,42,74,-32,31
Albion,2147,10,8,6,22,57,83,-26,30
Ayr,2148,1,24,4,8,93,44,49,76
Raith,2148,2,22,9,5,68,32,36,75
Arbroath,2148,3,18,8,10,77,50,27,62
Alloa,2148,4,17,9,10,56,43,13,60
Stranraer,2148,5,15,5,16,55,65,-10,50
East Fife,2148,6,14,3,19,48,64,-16,45
Airdrieon,2148,7,11,11,14,48,60,-12,44
Forfar,2148,8,10,5,21,40,67,-27,35
Albion,2148,9,8,6,22,59,81,-22,30
Queen's Park,2148,10,6,10,20,41,79,-38,28
Raith,2149,1,23,8,5,69,32,37,77
Ayr,2149,2,24,4,8,94,44,50,76
Arbroath,2149,3,17,8,11,70,50,20,59
Alloa,2149,4,17,8,11,56,44,12,59
Stranraer,2149,5,16,5,15,61,64,-3,53
Airdrieon,2149,6,10,12,14,45,58,-13,42
East Fife,2149,7,13,3,20,47,70,-23,42
Forfar,2149,8,10,6,20,38,64,-26,36
Queen's Park,2149,9,7,10,19,41,72,-31,31
Albion,2149,10,8,6,22,59,82,-23,30
Ayr,2150,1,24,4,8,98,43,55,76
Raith,2150,2,22,8,6,69,34,35,74
Arbroath,2150,3,18,8,10,74,48,26,62
Alloa,2150,4,18,8,10,58,44,14,62
Stranraer,2150,5,16,5,15,56,64,-8,53
Airdrieon,2150,6,11,11,14,48,59,-11,44
East Fife,2150,7,13,3,20,47,65,-18,42
Forfar,2150,8,10,5,21,39,67,-28,35
Albion,2150,9,8,6,22,58,86,-28,30
Queen's Park,2150,10,6,10,20,39,76,-37,28
Raith,2151,1,23,8,5,72,32,40,77
Ayr,2151,2,24,4,8,94,45,49,76
Arbroath,2151,3,18,8,10,73,48,25,62
Alloa,2151,4,17,8,11,56,47,9,59
Stranraer,2151,5,15,5,16,56,66,-10,50
East Fife,2151,6,14,3,19,49,65,-16,45
Airdrieon,2151,7,10,11,15,45,60,-15,41
Forfar,2151,8,11,5,20,40,64,-24,38
Albion,2151,9,8,6,22,60,82,-22,30
Queen's Park,2151,10,6,10,20,39,75,-36,28
Raith,2152,1,23,8,5,71,33,38,77
Ayr,2152,2,24,4,8,99,43,56,76
Arbroath,2152,3,17,9,10,71,49,22,60
Alloa,2152,4,17,8,11,57,46,11,59
Stranraer,2152,5,15,6,15,56,65,-9,51
Airdrieon,2152,6,11,11,14,47,59,-12,44
East Fife,2152,7,13,4,19,48,65,-17,43
Forfar,2152,8,10,5,21,39,66,-27,35
Albion,2152,9,8,6,22,58,87,-29,30
Queen's Park,2152,10,6,11,19,40,73,-33,29
Raith,2153,1,23,8,5,72,33,39,77
Ayr,2153,2,24,4,8,91,42,49,76
Arbroath,2153,3,18,8,10,72,48,24,62
Alloa,2153,4,17,8,11,57,47,10,59
Stranraer,2153,5,15,5,16,56,66,-10,50
East Fife,2153,6,14,3,19,49,65,-16,45
Airdrieon,2153,7,10,11,15,45,59,-14,41
Forfar,2153,8,11,5,20,39,64,-25,38
Albion,2153,9,8,6,22,57,79,-22,30
Queen's Park,2153,10,6,10,20,39,74,-35,28
Raith,2154,1,23,8,5,72,32,40,77
Ayr,2154,2,24,4,8,91,42,49,76
Arbroath,2154,3,17,9,10,72,50,22,60
Alloa,2154,4,17,8,11,56,47,9,59
Stranraer,2154,5,15,5,16,57,67,-10,50
East Fife,2154,6,14,3,19,50,66,-16,45
Airdrieon,2154,7,10,11,15,45,59,-14,41
Forfar,2154,8,11,5,20,39,64,-25,38
Albion,2154,9,8,6,22,57,79,-22,30
Queen's Park,2154,10,6,11,19,41,74,-33,29
Raith,2155,1,23,8,5,69,32,37,77
Ayr,2155,2,24,4,8,95,42,53,76
Arbroath,2155,3,18,8,10,73,49,24,62
Alloa,2155,4,17,8,11,56,44,12,59
Stranraer,2155,5,16,5,15,58,66,-8,53
Airdrieon,2155,6,11,11,14,46,58,-12,44
East Fife,2155,7,13,3,20,49,67,-18,42
Forfar,2155,8,10,5,21,38,65,-27,35
Albion,2155,9,8,6,22,57,83,-26,30
Queen's Park,2155,10,6,10,20,40,75,-35,28
Raith,2156,1,23,8,5,69,32,37,77
Ayr,2156,2,23,4,9,91,45,46,73
Arbroath,2156,3,18,8,10,73,49,24,62
Alloa,2156,4,17,8,11,56,44,12,59
Stranraer,2156,5,16,5,15,57,64,-7,53
Airdrieon,2156,6,11,11,14,49,59,-10,44
East Fife,2156,7,13,3,20,47,66,-19,42
Forfar,2156,8,10,5,21,39,68,-29,35
Albion,2156,9,9,6,21,60,79,-19,33
Queen's Park,2156,10,6,10,20,40,75,-35,28
Raith,2157,1,23,8,5,70,32,38,77
Ayr,2157,2,24,4,8,95,44,51,76
Arbroath,2157,3,18,8,10,74,48,26,62
Alloa,2157,4,17,8,11,56,45,11,59
Stranraer,2157,5,15,5,16,55,66,-11,50
East Fife,2157,6,14,3,19,49,64,-15,45
Airdrieon,2157,7,10,12,14,46,59,-13,42
Forfar,2157,8,10,6,20,39,65,-26,36
Albion,2157,9,8,6,22,59,83,-24,30
Queen's Park,2157,10,6,10,20,39,76,-37,28
Raith,2158,1,23,8,5,73,33,40,77
Ayr,2158,2,24,4,8,95,43,52,76
Arbroath,2158,3,18,8,10,73,50,23,62
Alloa,2158,4,17,8,11,57,48,9,59
Stranraer,2158,5,15,5,16,55,65,-10,50
East Fife,2158,6,14,3,19,48,64,-16,45
Airdrieon,2158,7,11,11,14,48,60,-12,44
Forfar,2158,8,10,5,21,40,67,-27,35
Albion,2158,9,8,6,22,58,83,-25,30
Queen's Park,2158,10,6,10,20,41,75,-34,28
Raith,2159,1,23,8,5,72,32,40,77
Ayr,2159,2,24,4,8,96,42,54,76
Arbroath,2159,3,17,8,11,70,50,20,59
Alloa,2159,4,17,8,11,56,47,9,59
Stranraer,2159,5,16,5,15,59,66,-7,53
Airdrieon,2159,6,10,12,14,46,59,-13,42
East Fife,2159,7,13,3,20,49,68,-19,42
Forfar,2159,8,10,6,20,39,65,-26,36
Queen's Park,2159,9,7,10,19,41,72,-31,31
Albion,2159,10,8,6,22,57,84,-27,30
Ayr,2160,1,24,4,8,97,44,53,76
Raith,2160,2,22,8,6,69,34,35,74
Alloa,2160,3,18,8,10,58,44,14,62
Arbroath,2160,4,17,8,11,70,49,21,59
Stranraer,2160,5,16,5,15,57,65,-8,53
Airdrieon,2160,6,11,11,14,48,59,-11,44
East Fife,2160,7,13,3,20,48,66,-18,42
Forfar,2160,8,10,5,21,39,67,-28,35
Queen's Park,2160,9,7,10,19,40,72,-32,31
Albion,2160,10,8,6,22,59,85,-26,30
Raith,2161,1,23,8,5,72,33,39,77
Ayr,2161,2,24,4,8,93,44,49,76
Arbroath,2161,3,18,8,10,72,49,23,62
Alloa,2161,4,17,8,11,57,47,10,59
Stranraer,2161,5,15,5,16,55,65,-10,50
East Fife,2161,6,14,3,19,48,64,-16,45
Airdrieon,2161,7,10,11,15,45,59,-14,41
Forfar,2161,8,11,5,20,39,64,-25,38
Albion,2161,9,8,6,22,59,81,-22,30
Queen's Park,2161,10,6,10,20,40,74,-34,28
Ayr,2162,1,24,4,8,96,45,51,76
Raith,2162,2,22,9,5,69,33,36,75
Arbroath,2162,3,18,8,10,71,48,23,62
Alloa,2162,4,17,9,10,57,44,13,60
Stranraer,2162,5,16,5,15,57,65,-8,53
Airdrieon,2162,6,11,11,14,48,59,-11,44
East Fife,2162,7,13,3,20,48,66,-18,42
Forfar,2162,8,10,5,21,39,67,-28,35
Albion,2162,9,8,6,22,60,84,-24,30
Queen's Park,2162,10,6,10,20,39,73,-34,28
Raith,2163,1,23,8,5,70,33,37,77
Ayr,2163,2,23,4,9,91,47,44,73
Arbroath,2163,3,17,8,11,71,50,21,59
Alloa,2163,4,17,8,11,57,45,12,59
Stranraer,2163,5,15,6,15,58,67,-9,51
East Fife,2163,6,13,4,19,50,67,-17,43
Airdrieon,2163,7,10,12,14,46,59,-13,42
Forfar,2163,8,10,6,20,39,65,-26,36
Albion,2163,9,9,6,21,62,79,-17,33
Queen's Park,2163,10,7,10,19,41,73,-32,31
Raith,2164,1,23,8,5,71,32,39,77
Ayr,2164,2,24,4,8,94,43,51,76
Arbroath,2164,3,17,9,10,71,49,22,60
Alloa,2164,4,17,8,11,56,46,10,59
Stranraer,2164,5,15,5,16,56,66,-10,50
East Fife,2164,6,14,3,19,49,65,-16,45
Airdrieon,2164,7,11,11,14,47,58,-11,44
Forfar,2164,8,10,5,21,38,66,-28,35
Albion,2164,9,8,6,22,58,82,-24,30
Queen's Park,2164,10,6,11,19,40,73,-33,29
Raith,2165,1,23,8,5,72,32,40,77
Ayr,2165,2,24,4,8,96,42,54,76
Arbroath,2165,3,18,8,10,75,48,27,62
Alloa,2165,4,17,8,11,56,47,9,59
Stranraer,2165,5,16,5,15,60,66,-6,53
Airdrieon,2165,6,10,12,14,45,58,-13,42
East Fife,2165,7,13,3,20,49,69,-20,42
Forfar,2165,8,10,6,20,38,64,-26,36
Albion,2165,9,8,6,22,57,84,-27,30
Queen's Park,2165,10,6,10,20,39,77,-38,28
Raith,2166,1,23,8,5,70,33,37,77
Ayr,2166,2,24,4,8,94,43,51,76
Arbroath,2166,3,17,9,10,71,49,22,60
Alloa,2166,4,17,8,11,57,45,12,59
Stranraer,2166,5,15,6,15,58,67,-9,51
Airdrieon,2166,6,11,11,14,46,58,-12,44
East Fife,2166,7,13,4,19,50,67,-17,43
Forfar,2166,8,10,5,21,38,65,-27,35
Albion,2166,9,8,6,22,58,82,-24,30
Queen's Park,2166,10,6,11,19,40,73,-33,29
Raith,2167,1,22,9,5,68,32,36,75
Ayr,2167,2,23,4,9,91,44,47,73
Arbroath,2167,3,18,8,10,74,48,26,62
Alloa,2167,4,17,9,10,56,43,13,60
Stranraer,2167,5,15,5,16,55,65,-10,50
East Fife,2167,6,14,3,19,48,64,-16,45
Airdrieon,2167,7,10,11,15,45,59,-14,41
Forfar,2167,8,11,5,20,39,64,-25,38
Albion,2167,9,9,6,21,59,79,-20,33
Queen's Park,2167,10,6,10,20,39,76,-37,28
Ayr,2168,1,24,4,8,94,43,51,76
Raith,2168,2,22,9,5,70,34,36,75
Alloa,2168,3,17,9,10,58,45,13,60
Arbroath,2168,4,17,8,11,70,50,20,59
Stranraer,2168,5,15,5,16,56,66,-10,50
East Fife,2168,6,14,3,19,49,65,-16,45
Airdrieon,2168,7,11,11,14,49,58,-9,44
Forfar,2168,8,10,5,21,38,68,-30,35
Queen's Park,2168,9,7,10,19,41,72,-31,31
Albion,2168,10,8,6,22,58,82,-24,30
Ayr,2169,1,24,4,8,93,43,50,76
Raith,2169,2,22,8,6,70,35,35,74
Arbroath,2169,3,18,8,10,72,49,23,62
Alloa,2169,4,18,8,10,59,45,14,62
Stranraer,2169,5,16,5,15,57,64,-7,53
Airdrieon,2169,6,11,11,14,47,59,-12,44
East Fife,2169,7,13,3,20,47,66,-19,42
Forfar,2169,8,10,5,21,39,66,-27,35
Albion,2169,9,8,6,22,58,81,-23,30
Queen's Park,2169,10,6,10,20,40,74,-34,28
Ayr,2170,1,23,5,8,91,43,48,74
Raith,2170,2,22,8,6,70,35,35,74
Alloa,2170,3,18,8,10,59,45,14,62
Arbroath,2170,4,17,9,10,71,49,22,60
Stranraer,2170,5,15,5,16,55,67,-12,50
East Fife,2170,6,14,3,19,50,64,-14,45
Airdrieon,2170,7,11,11,14,46,58,-12,44
Forfar,2170,8,10,5,21,38,65,-27,35
Albion,2170,9,8,7,21,58,79,-21,31
Queen's Park,2170,10,6,11,19,40,73,-33,29
Ayr,2171,1,24,4,8,93,43,50,76
Raith,2171,2,22,8,6,68,33,35,74
Arbroath,2171,3,18,8,10,75,50,25,62
Alloa,2171,4,18,8,10,57,43,14,62
Stranraer,2171,5,16,5,15,56,64,-8,53
Airdrieon,2171,6,11,11,14,47,58,-11,44
East Fife,2171,7,13,3,20,47,65,-18,42
Forfar,2171,8,10,5,21,38,66,-28,35
Albion,2171,9,8,6,22,58,81,-23,30
Queen's Park,2171,10,6,10,20,41,77,-36,28
Raith,2172,1,23,8,5,70,32,38,77
Ayr,2172,2,24,4,8,94,42,52,76
Arbroath,2172,3,18,8,10,74,50,24,62
Alloa,2172,4,17,8,11,56,45,11,59
Stranraer,2172,5,15,6,15,56,65,-9,51
East Fife,2172,6,13,4,19,48,65,-17,43
Airdrieon,2172,7,10,12,14,46,59,-13,42
Forfar,2172,8,10,6,20,39,65,-26,36
Albion,2172,9,8,6,22,57,82,-25,30
Queen's Park,2172,10,6,10,20,41,76,-35,28
Raith,2173,1,23,8,5,69,32,37,77
Ayr,2173,2,24,4,8,92,43,49,76
Arbroath,2173,3,17,9,10,71,49,22,60
Alloa,2173,4,17,8,11,56,44,12,59
Stranraer,2173,5,15,6,15,55,64,-9,51
East Fife,2173,6,13,4,19,47,64,-17,43
Airdrieon,2173,7,10,12,14,45,58,-13,42
Forfar,2173,8,10,6,20,38,64,-26,36
Albion,2173,9,8,6,22,58,80,-22,30
Queen's Park,2173,10,6,11,19,40,73,-33,29
Ayr,2174,1,24,4,8,93,43,50,76
Raith,2174,2,22,9,5,70,34,36,75
Alloa,2174,3,17,9,10,58,45,13,60
Arbroath,2174,4,17,8,11,70,51,19,59
Stranraer,2174,5,16,5,15,58,65,-7,53
Airdrieon,2174,6,11,11,14,46,58,-12,44
East Fife,2174,7,13,3,20,48,67,-19,42
Forfar,2174,8,10,5,21,38,65,-27,35
Queen's Park,2174,9,7,10,19,42,72,-30,31
Albion,2174,10,8,6,22,58,81,-23,30
Raith,2175,1,23,8,5,69,32,37,77
Ayr,2175,2,24,4,8,94,43,51,76
Arbroath,2175,3,18,8,10,73,49,24,62
Alloa,2175,4,17,8,11,56,44,12,59
Stranraer,2175,5,15,5,16,55,65,-10,50
East Fife,2175,6,14,3,19,48,64,-16,45
Airdrieon,2175,7,11,11,14,48,58,-10,44
Forfar,2175,8,10,5,21,38,67,-29,35
Albion,2175,9,8,6,22,58,82,-24,30
Queen's Park,2175,10,6,10,20,40,75,-35,28
Ayr,2176,1,24,4,8,95,45,50,76
Raith,2176,2,22,8,6,68,33,35,74
Arbroath,2176,3,18,8,10,74,48,26,62
Alloa,2176,4,18,8,10,57,43,14,62
Stranraer,2176,5,15,6,15,57,66,-9,51
Airdrieon,2176,6,11,11,14,48,58,-10,44
East Fife,2176,7,13,4,19,49,66,-17,43
Forfar,2176,8,10,5,21,38,67,-29,35
Albion,2176,9,8,6,22,60,83,-23,30
Queen's Park,2176,10,6,10,20,39,76,-37,28
Ayr,2177,1,24,4,8,93,42,51,76
Raith,2177,2,22,9,5,68,32,36,75
Arbroath,2177,3,18,8,10,73,49,24,62
Alloa,2177,4,17,9,10,56,43,13,60
Stranraer,2177,5,15,5,16,56,69,-13,50
East Fife,2177,6,14,3,19,52,65,-13,45
Airdrieon,2177,7,11,11,14,47,59,-12,44
Forfar,2177,8,10,5,21,39,66,-27,35
Albion,2177,9,8,6,22,57,81,-24,30
Queen's Park,2177,10,6,10,20,40,75,-35,28
Ayr,2178,1,23,5,8,91,43,48,74
Raith,2178,2,22,8,6,68,33,35,74
Alloa,2178,3,18,8,10,57,43,14,62
Arbroath,2178,4,17,8,11,71,50,21,59
Stranraer,2178,5,15,6,15,56,65,-9,51
East Fife,2178,6,13,4,19,48,65,-17,43
Airdrieon,2178,7,10,11,15,45,60,-15,41
Forfar,2178,8,11,5,20,40,64,-24,38
Albion,2178,9,8,7,21,58,79,-21,31
Queen's Park,2178,10,7,10,19,41,73,-32,31
Raith,2179,1,23,8,5,69,32,37,77
Ayr,2179,2,23,5,8,92,44,48,74
Arbroath,2179,3,18,8,10,72,49,23,62
Alloa,2179,4,17,8,11,56,44,12,59
Stranraer,2179,5,15,5,16,57,67,-10,50
East Fife,2179,6,14,3,19,50,66,-16,45
Airdrieon,2179,7,11,11,14,48,59,-11,44
Forfar,2179,8,10,5,21,39,67,-28,35
Albion,2179,9,8,7,21,59,80,-21,31
Queen's Park,2179,10,6,10,20,40,74,-34,28
Raith,2180,1,22,8,6,68,33,35,74
Ayr,2180,2,23,4,9,91,44,47,73
Arbroath,2180,3,18,8,10,71,48,23,62
Alloa,2180,4,18,8,10,57,43,14,62
Stranraer,2180,5,15,5,16,56,66,-10,50
East Fife,2180,6,14,3,19,49,65,-16,45
Airdrieon,2180,7,10,12,14,47,60,-13,42
Forfar,2180,8,10,6,20,40,66,-26,36
Albion,2180,9,9,6,21,59,79,-20,33
Queen's Park,2180,10,6,10,20,39,73,-34,28
Ayr,2181,1,24,4,8,94,42,52,76
Raith,2181,2,22,9,5,70,34,36,75
Arbroath,2181,3,17,9,10,72,50,22,60
Alloa,2181,4,17,9,10,58,45,13,60
Stranraer,2181,5,15,5,16,56,66,-10,50
East Fife,2181,6,14,3,19,49,65,-16,45
Airdrieon,2181,7,10,11,15,47,61,-14,41
Forfar,2181,8,11,5,20,41,66,-25,38
Albion,2181,9,8,6,22,57,82,-25,30
Queen's Park,2181,10,6,11,19,41,74,-33,29
Raith,2182,1,23,8,5,71,33,38,77
Ayr,2182,2,24,4,8,93,42,51,76
Arbroath,2182,3,17,8,11,70,53,17,59
Alloa,2182,4,17,8,11,57,46,11,59
Stranraer,2182,5,15,5,16,57,67,-10,50
East Fife,2182,6,14,3,19,50,66,-16,45
Airdrieon,2182,7,10,12,14,45,58,-13,42
Forfar,2182,8,10,6,20,38,64,-26,36
Queen's Park,2182,9,7,10,19,44,72,-28,31
Albion,2182,10,8,6,22,57,81,-24,30
Ayr,2183,1,24,4,8,92,43,49,76
Raith,2183,2,22,9,5,68,32,36,75
Arbroath,2183,3,17,9,10,70,48,22,60
Alloa,2183,4,17,9,10,56,43,13,60
Stranraer,2183,5,15,6,15,57,66,-9,51
Airdrieon,2183,6,11,11,14,47,59,-12,44
East Fife,2183,7,13,4,19,49,66,-17,43
Forfar,2183,8,10,5,21,39,66,-27,35
Albion,2183,9,8,6,22,58,80,-22,30
Queen's Park,2183,10,6,11,19,39,72,-33,29
Raith,2184,1,23,8,5,70,32,38,77
Ayr,2184,2,24,4,8,97,43,54,76
Arbroath,2184,3,17,9,10,72,50,22,60
Alloa,2184,4,17,8,11,56,45,11,59
Stranraer,2184,5,15,6,15,57,66,-9,51
Airdrieon,2184,6,11,11,14,46,58,-12,44
East Fife,2184,7,13,4,19,49,66,-17,43
Forfar,2184,8,10,5,21,38,65,-27,35
Albion,2184,9,8,6,22,58,85,-27,30
Queen's Park,2184,10,6,11,19,41,74,-33,29
Raith,2185,1,23,8,5,69,32,37,77
Ayr,2185,2,24,4,8,94,44,50,76
Arbroath,2185,3,18,8,10,72,49,23,62
Alloa,2185,4,17,8,11,56,44,12,59
Stranraer,2185,5,15,5,16,55,65,-10,50
East Fife,2185,6,14,3,19,48,64,-16,45
Airdrieon,2185,7,10,11,15,46,60,-14,41
Forfar,2185,8,11,5,20,40,65,-25,38
Albion,2185,9,8,6,22,59,82,-23,30
Queen's Park,2185,10,6,10,20,40,74,-34,28
Raith,2186,1,23,8,5,70,33,37,77
Ayr,2186,2,24,4,8,95,44,51,76
Arbroath,2186,3,17,8,11,70,49,21,59
Alloa,2186,4,17,8,11,57,45,12,59
Stranraer,2186,5,15,6,15,55,64,-9,51
East Fife,2186,6,13,4,19,47,64,-17,43
Airdrieon,2186,7,10,11,15,45,59,-14,41
Forfar,2186,8,11,5,20,39,64,-25,38
Queen's Park,2186,9,7,10,19,40,72,-32,31
Albion,2186,10,8,6,22,59,83,-24,30
Raith,2187,1,23,8,5,70,32,38,77
Ayr,2187,2,24,4,8,93,43,50,76
Arbroath,2187,3,17,9,10,72,50,22,60
Alloa,2187,4,17,8,11,56,45,11,59
Stranraer,2187,5,15,5,16,56,67,-11,50
East Fife,2187,6,14,3,19,50,65,-15,45
Airdrieon,2187,7,11,11,14,46,58,-12,44
Forfar,2187,8,10,5,21,38,65,-27,35
Albion,2187,9,8,6,22,58,81,-23,30
Queen's Park,2187,10,6,11,19,41,74,-33,29
Raith,2188,1,23,8,5,73,32,41,77
Ayr,2188,2,23,5,8,91,43,48,74
Arbroath,2188,3,17,8,11,70,49,21,59
Alloa,2188,4,17,8,11,56,48,8,59
Stranraer,2188,5,15,6,15,57,66,-9,51
Airdrieon,2188,6,11,11,14,47,58,-11,44
East Fife,2188,7,13,4,19,49,66,-17,43
Forfar,2188,8,10,5,21,38,66,-28,35
Albion,2188,9,8,7,21,58,79,-21,31
Queen's Park,2188,10,7,10,19,40,72,-32,31
Raith,2189,1,23,8,5,70,32,38,77
Ayr,2189,2,24,4,8,93,43,50,76
Arbroath,2189,3,17,8,11,70,51,19,59
Alloa,2189,4,17,8,11,56,45,11,59
Stranraer,2189,5,15,6,15,57,66,-9,51
East Fife,2189,6,13,4,19,49,66,-17,43
Airdrieon,2189,7,10,11,15,45,59,-14,41
Forfar,2189,8,11,5,20,39,64,-25,38
Queen's Park,2189,9,7,10,19,42,72,-30,31
Albion,2189,10,8,6,22,58,81,-23,30
Raith,2190,1,23,8,5,72,33,39,77
Ayr,2190,2,24,4,8,97,44,53,76
Arbroath,2190,3,18,8,10,72,48,24,62
Alloa,2190,4,17,8,11,57,47,10,59
Stranraer,2190,5,16,5,15,56,64,-8,53
Airdrieon,2190,6,10,12,14,45,58,-13,42
East Fife,2190,7,13,3,20,47,65,-18,42
Forfar,2190,8,10,6,20,38,64,-26,36
Albion,2190,9,8,6,22,59,85,-26,30
Queen's Park,2190,10,6,10,20,39,74,-35,28
Raith,2191,1,23,8,5,72,32,40,77
Ayr,2191,2,24,4,8,94,43,51,76
Arbroath,2191,3,17,9,10,71,49,22,60
Alloa,2191,4,17,8,11,56,47,9,59
Stranraer,2191,5,15,5,16,58,68,-10,50
East Fife,2191,6,14,3,19,51,67,-16,45
Airdrieon,2191,7,11,11,14,46,58,-12,44
Forfar,2191,8,10,5,21,38,65,-27,35
Albion,2191,9,8,6,22,58,82,-24,30
Queen's Park,2191,10,6,11,19,40,73,-33,29
Raith,2192,1,23,8,5,71,32,39,77
Ayr,2192,2,24,4,8,95,43,52,76
Arbroath,2192,3,17,8,11,70,49,21,59
Alloa,2192,4,17,8,11,56,46,10,59
Stranraer,2192,5,15,6,15,55,64,-9,51
East Fife,2192,6,13,4,19,47,64,-17,43
Airdrieon,2192,7,10,12,14,47,60,-13,42
Forfar,2192,8,10,6,20,40,66,-26,36
Queen's Park,2192,9,7,10,19,40,72,-32,31
Albion,2192,10,8,6,22,58,83,-25,30
Raith,2193,1,23,8,5,71,33,38,77
Ayr,2193,2,24,4,8,99,42,57,76
Arbroath,2193,3,17,8,11,71,50,21,59
Alloa,2193,4,17,8,11,57,46,11,59
Stranraer,2193,5,15,5,16,55,65,-10,50
East Fife,2193,6,14,3,19,48,64,-16,45
Airdrieon,2193,7,11,11,14,47,59,-12,44
Forfar,2193,8,10,5,21,39,66,-27,35
Queen's Park,2193,9,7,10,19,41,73,-32,31
Albion,2193,10,8,6,22,57,87,-30,30
Raith,2194,1,23,8,5,69,32,37,77
Ayr,2194,2,24,4,8,91,42,49,76
Arbroath,2194,3,17,8,11,70,53,17,59
Alloa,2194,4,17,8,11,56,44,12,59
Stranraer,2194,5,15,5,16,56,66,-10,50
East Fife,2194,6,14,3,19,49,65,-16,45
Airdrieon,2194,7,11,11,14,51,60,-9,44
Forfar,2194,8,10,5,21,40,70,-30,35
Queen's Park,2194,9,7,10,19,44,72,-28,31
Albion,2194,10,8,6,22,57,79,-22,30
Raith,2195,1,23,8,5,72,32,40,77
Ayr,2195,2,24,4,8,93,43,50,76
Arbroath,2195,3,18,8,10,74,48,26,62
Alloa,2195,4,17,8,11,56,47,9,59
Stranraer,2195,5,15,5,16,56,66,-10,50
East Fife,2195,6,14,3,19,49,65,-16,45
Airdrieon,2195,7,11,11,14,49,58,-9,44
Forfar,2195,8,10,5,21,38,68,-30,35
Albion,2195,9,8,6,22,58,81,-23,30
Queen's Park,2195,10,6,10,20,39,76,-37,28
Ayr,2196,1,23,5,8,92,44,48,74
Raith,2196,2,22,8,6,69,35,34,74
Alloa,2196,3,18,8,10,59,44,15,62
Arbroath,2196,4,17,8,11,70,49,21,59
Stranraer,2196,5,15,5,16,55,65,-10,50
East Fife,2196,6,14,3,19,48,64,-16,45
Airdrieon,2196,7,11,11,14,47,58,-11,44
Forfar,2196,8,10,5,21,38,66,-28,35
Albion,2196,9,8,7,21,59,80,-21,31
Queen's Park,2196,10,7,10,19,40,72,-32,31
Ayr,2197,1,24,4,8,91,42,49,76
Raith,2197,2,22,8,6,70,35,35,74
Alloa,2197,3,18,8,10,59,45,14,62
Arbroath,2197,4,17,8,11,70,52,18,59
Stranraer,2197,5,16,5,15,57,65,-8,53
East Fife,2197,6,13,3,20,48,66,-18,42
Airdrieon,2197,7,10,11,15,45,60,-15,41
Forfar,2197,8,11,5,20,40,64,-24,38
Queen's Park,2197,9,7,10,19,43,72,-29,31
Albion,2197,10,8,6,22,57,79,-22,30
Raith,2198,1,23,8,5,71,32,39,77
Ayr,2198,2,24,4,8,95,43,52,76
Arbroath,2198,3,17,8,11,71,50,21,59
Alloa,2198,4,17,8,11,56,46,10,59
Stranraer,2198,5,15,5,16,55,65,-10,50
East Fife,2198,6,14,3,19,48,64,-16,45
Airdrieon,2198,7,11,11,14,49,61,-12,44
Forfar,2198,8,10,5,21,41,68,-27,35
Queen's Park,2198,9,7,10,19,41,73,-32,31
Albion,2198,10,8,6,22,58,83,-25,30
Raith,2199,1,23,8,5,72,33,39,77
Ayr,2199,2,24,4,8,93,44,49,76
Arbroath,2199,3,17,8,11,70,51,19,59
Alloa,2199,4,17,8,11,57,47,10,59
Stranraer,2199,5,15,6,15,55,64,-9,51
Airdrieon,2199,6,11,11,14,48,59,-11,44
East Fife,2199,7,13,4,19,47,64,-17,43
Forfar,2199,8,10,5,21,39,67,-28,35
Queen's Park,2199,9,7,10,19,42,72,-30,31
Albion,2199,10,8,6,22,59,81,-22,30
Ayr,2200,1,24,4,8,94,44,50,76
Raith,2200,2,22,9,5,69,33,36,75
Arbroath,2200,3,18,8,10,71,48,23,62
Alloa,2200,4,17,9,10,57,44,13,60
Stranraer,2200,5,16,5,15,58,66,-8,53
Airdrieon,2200,6,10,12,14,46,59,-13,42
East Fife,2200,7,13,3,20,49,67,-18,42
Forfar,2200,8,10,6,20,39,65,-26,36
Albion,2200,9,8,6,22,59,82,-23,30
Queen's Park,2200,10,6,10,20,39,73,-34,28
Raith,2201,1,22,9,5,70,34,36,75
Ayr,2201,2,23,5,8,91,43,48,74
Alloa,2201,3,17,9,10,58,45,13,60
Arbroath,2201,4,17,8,11,71,50,21,59
Stranraer,2201,5,16,5,15,57,65,-8,53
Airdrieon,2201,6,11,11,14,46,58,-12,44
East Fife,2201,7,13,3,20,48,66,-18,42
Forfar,2201,8,10,5,21,38,65,-27,35
Albion,2201,9,8,7,21,58,79,-21,31
Queen's Park,2201,10,7,10,19,41,73,-32,31
Ayr,2202,1,24,4,8,96,45,51,76
Raith,2202,2,22,8,6,68,35,33,74
Arbroath,2202,3,18,8,10,73,50,23,62
Alloa,2202,4,18,8,10,59,43,16,62
Stranraer,2202,5,15,5,16,55,66,-11,50
East Fife,2202,6,14,3,19,49,64,-15,45
Airdrieon,2202,7,11,11,14,46,58,-12,44
Forfar,2202,8,10,5,21,38,65,-27,35
Albion,2202,9,8,6,22,60,84,-24,30
Queen's Park,2202,10,6,10,20,41,75,-34,28
Raith,2203,1,22,9,5,70,34,36,75
Ayr,2203,2,23,4,9,93,46,47,73
Arbroath,2203,3,17,9,10,72,50,22,60
Alloa,2203,4,17,9,10,58,45,13,60
Stranraer,2203,5,15,6,15,56,65,-9,51
East Fife,2203,6,13,4,19,48,65,-17,43
Airdrieon,2203,7,10,11,15,45,60,-15,41
Forfar,2203,8,11,5,20,40,64,-24,38
Albion,2203,9,9,6,21,61,81,-20,33
Queen's Park,2203,10,6,11,19,41,74,-33,29
Raith,2204,1,23,8,5,71,33,38,77
Ayr,2204,2,24,4,8,92,43,49,76
Arbroath,2204,3,17,9,10,71,49,22,60
Alloa,2204,4,17,8,11,57,46,11,59
Stranraer,2204,5,15,5,16,56,66,-10,50
East Fife,2204,6,14,3,19,49,65,-16,45
Airdrieon,2204,7,10,11,15,46,61,-15,41
Forfar,2204,8,11,5,20,41,65,-24,38
Albion,2204,9,8,6,22,58,80,-22,30
Queen's Park,2204,10,6,11,19,40,73,-33,29
Ayr,2205,1,24,4,8,93,43,50,76
Raith,2205,2,22,9,5,69,33,36,75
Arbroath,2205,3,18,8,10,74,49,25,62
Alloa,2205,4,17,9,10,57,44,13,60
Stranraer,2205,5,15,6,15,56,65,-9,51
East Fife,2205,6,13,4,19,48,65,-17,43
Airdrieon,2205,7,10,12,14,46,59,-13,42
Forfar,2205,8,10,6,20,39,65,-26,36
Albion,2205,9,8,6,22,58,81,-23,30
Queen's Park,2205,10,6,10,20,40,76,-36,28
Raith,2206,1,23,8,5,71,32,39,77
Ayr,2206,2,24,4,8,93,43,50,76
Arbroath,2206,3,18,8,10,73,49,24,62
Alloa,2206,4,17,8,11,56,46,10,59
Stranraer,2206,5,15,6,15,56,65,-9,51
East Fife,2206,6,13,4,19,48,65,-17,43
Airdrieon,2206,7,10,11,15,46,60,-14,41
Forfar,2206,8,11,5,20,40,65,-25,38
Albion,2206,9,8,6,22,58,81,-23,30
Queen's Park,2206,10,6,10,20,40,75,-35,28
Raith,2207,1,22,8,6,68,33,35,74
Ayr,2207,2,23,4,9,93,46,47,73
Alloa,2207,3,18,8,10,57,43,14,62
Arbroath,2207,4,17,8,11,71,50,21,59
Stranraer,2207,5,16,5,15,57,64,-7,53
Airdrieon,2207,6,11,11,14,46,58,-12,44
East Fife,2207,7,13,3,20,47,66,-19,42
Forfar,2207,8,10,5,21,38,65,-27,35
Albion,2207,9,9,6,21,61,81,-20,33
Queen's Park,2207,10,7,10,19,41,73,-32,31
Raith,2208,1,23,8,5,71,32,39,77
Ayr,2208,2,24,4,8,93,42,51,76
Arbroath,2208,3,18,8,10,72,49,23,62
Alloa,2208,4,17,8,11,56,46,10,59
Stranraer,2208,5,16,5,15,56,64,-8,53
Airdrieon,2208,6,11,11,14,47,58,-11,44
East Fife,2208,7,13,3,20,47,65,-18,42
Forfar,2208,8,10,5,21,38,66,-28,35
Albion,2208,9,8,6,22,57,81,-24,30
Queen's Park,2208,10,6,10,20,40,74,-34,28
Raith,2209,1,23,8,5,71,32,39,77
Ayr,2209,2,24,4,8,94,43,51,76
Arbroath,2209,3,17,9,10,73,51,22,60
Alloa,2209,4,17,8,11,56,46,10,59
Stranraer,2209,5,15,5,16,56,70,-14,50
East Fife,2209,6,14,3,19,53,65,-12,45
Airdrieon,2209,7,10,12,14,45,58,-13,42
Forfar,2209,8,10,6,20,38,64,-26,36
Albion,2209,9,8,6,22,58,82,-24,30
Queen's Park,2209,10,6,11,19,42,75,-33,29
Ayr,2210,1,24,4,8,94,43,51,76
Raith,2210,2,22,8,6,68,33,35,74
Arbroath,2210,3,18,8,10,75,48,27,62
Alloa,2210,4,18,8,10,57,43,14,62
Stranraer,2210,5,15,6,15,56,65,-9,51
East Fife,2210,6,13,4,19,48,65,-17,43
Airdrieon,2210,7,10,11,15,46,60,-14,41
Forfar,2210,8,11,5,20,40,65,-25,38
Albion,2210,9,8,6,22,58,82,-24,30
Queen's Park,2210,10,6,10,20,39,77,-38,28
Raith,2211,1,23,8,5,72,34,38,77
Ayr,2211,2,24,4,8,96,43,53,76
Arbroath,2211,3,17,8,11,71,50,21,59
Alloa,2211,4,17,8,11,58,47,11,59
Stranraer,2211,5,15,5,16,55,65,-10,50
East Fife,2211,6,14,3,19,48,64,-16,45
Airdrieon,2211,7,11,11,14,48,58,-10,44
Forfar,2211,8,10,5,21,38,67,-29,35
Queen's Park,2211,9,7,10,19,41,73,-32,31
Albion,2211,10,8,6,22,58,84,-26,30
Ayr,2212,1,24,4,8,95,45,50,76
Raith,2212,2,22,9,5,68,32,36,75
Arbroath,2212,3,17,9,10,71,49,22,60
Alloa,2212,4,17,9,10,56,43,13,60
Stranraer,2212,5,16,5,15,56,64,-8,53
East Fife,2212,6,13,3,20,47,65,-18,42
Airdrieon,2212,7,10,11,15,45,59,-14,41
Forfar,2212,8,11,5,20,39,64,-25,38
Albion,2212,9,8,6,22,60,83,-23,30
Queen's Park,2212,10,6,11,19,40,73,-33,29
Ayr,2213,1,24,4,8,96,42,54,76
Raith,2213,2,22,9,5,69,33,36,75
Alloa,2213,3,17,9,10,57,44,13,60
Arbroath,2213,4,17,8,11,71,52,19,59
Stranraer,2213,5,16,5,15,57,64,-7,53
Airdrieon,2213,6,11,11,14,48,59,-11,44
East Fife,2213,7,13,3,20,47,66,-19,42
Forfar,2213,8,10,5,21,39,67,-28,35
Queen's Park,2213,9,7,10,19,43,73,-30,31
Albion,2213,10,8,6,22,57,84,-27,30
Ayr,2214,1,24,4,8,94,43,51,76
Raith,2214,2,22,8,6,69,35,34,74
Alloa,2214,3,18,8,10,59,44,15,62
Arbroath,2214,4,17,8,11,70,51,19,59
Stranraer,2214,5,15,5,16,55,67,-12,50
East Fife,2214,6,14,3,19,50,64,-14,45
Airdrieon,2214,7,11,11,14,46,58,-12,44
Forfar,2214,8,10,5,21,38,65,-27,35
Queen's Park,2214,9,7,10,19,42,72,-30,31
Albion,2214,10,8,6,22,58,82,-24,30
Raith,2215,1,23,8,5,71,34,37,77
Ayr,2215,2,23,4,9,91,44,47,73
Arbroath,2215,3,17,8,11,71,51,20,59
Alloa,2215,4,17,8,11,58,46,12,59
Stranraer,2215,5,15,5,16,57,67,-10,50
East Fife,2215,6,14,3,19,50,66,-16,45
Airdrieon,2215,7,10,12,14,47,60,-13,42
Forfar,2215,8,10,6,20,40,66,-26,36
Albion,2215,9,9,6,21,59,79,-20,33
Queen's Park,2215,10,7,10,19,42,73,-31,31
Raith,2216,1,23,8,5,71,34,37,77
Ayr,2216,2,24,4,8,95,43,52,76
Arbroath,2216,3,17,8,11,70,50,20,59
Alloa,2216,4,17,8,11,58,46,12,59
Stranraer,2216,5,16,5,15,58,65,-7,53
Airdrieon,2216,6,11,11,14,49,59,-10,44
East Fife,2216,7,13,3,20,48,67,-19,42
Forfar,2216,8,10,5,21,39,68,-29,35
Queen's Park,2216,9,7,10,19,41,72,-31,31
Albion,2216,10,8,6,22,58,83,-25,30
Raith,2217,1,23,8,5,71,33,38,77
Ayr,2217,2,24,4,8,92,43,49,76
Arbroath,2217,3,18,8,10,71,48,23,62
Alloa,2217,4,17,8,11,57,46,11,59
Stranraer,2217,5,16,5,15,58,65,-7,53
Airdrieon,2217,6,10,12,14,46,59,-13,42
East Fife,2217,7,13,3,20,48,67,-19,42
Forfar,2217,8,10,6,20,39,65,-26,36
Albion,2217,9,8,6,22,58,80,-22,30
Queen's Park,2217,10,6,10,20,39,73,-34,28
Ayr,2218,1,23,5,8,92,44,48,74
Raith,2218,2,22,8,6,68,33,35,74
Alloa,2218,3,18,8,10,57,43,14,62
Arbroath,2218,4,17,9,10,71,49,22,60
Stranraer,2218,5,15,5,16,57,67,-10,50
East Fife,2218,6,14,3,19,50,66,-16,45
Airdrieon,2218,7,11,11,14,46,58,-12,44
Forfar,2218,8,10,5,21,38,65,-27,35
Albion,2218,9,8,7,21,59,80,-21,31
Queen's Park,2218,10,6,11,19,40,73,-33,29
Ayr,2219,1,24,4,8,95,42,53,76
Raith,2219,2,22,9,5,70,34,36,75
Arbroath,2219,3,18,8,10,72,48,24,62
Alloa,2219,4,17,9,10,58,45,13,60
Stranraer,2219,5,15,5,16,55,65,-10,50
East Fife,2219,6,14,3,19,48,64,-16,45
Airdrieon,2219,7,11,11,14,47,59,-12,44
Forfar,2219,8,10,5,21,39,66,-27,35
Albion,2219,9,8,6,22,57,83,-26,30
Queen's Park,2219,10,6,10,20,39,74,-35,28
Ayr,2220,1,24,4,8,93,44,49,76
Raith,2220,2,22,9,5,68,32,36,75
Arbroath,2220,3,17,9,10,71,49,22,60
Alloa,2220,4,17,9,10,56,43,13,60
Stranraer,2220,5,15,5,16,55,66,-11,50
East Fife,2220,6,14,3,19,49,64,-15,45
Airdrieon,2220,7,11,11,14,47,59,-12,44
Forfar,2220,8,10,5,21,39,66,-27,35
Albion,2220,9,8,6,22,59,81,-22,30
Queen's Park,2220,10,6,11,19,40,73,-33,29
Ayr,2221,1,24,4,8,94,45,49,76
Raith,2221,2,22,9,5,70,34,36,75
Alloa,2221,3,17,9,10,58,45,13,60
Arbroath,2221,4,17,8,11,71,54,17,59
Stranraer,2221,5,16,5,15,57,65,-8,53
Airdrieon,2221,6,11,11,14,47,58,-11,44
East Fife,2221,7,13,3,20,48,66,-18,42
Forfar,2221,8,10,5,21,38,66,-28,35
Queen's Park,2221,9,7,10,19,45,73,-28,31
Albion,2221,10,8,6,22,60,82,-22,30
Raith,2222,1,23,8,5,70,32,38,77
Ayr,2222,2,24,4,8,92,42,50,76
Arbroath,2222,3,17,8,11,71,50,21,59
Alloa,2222,4,17,8,11,56,45,11,59
Stranraer,2222,5,15,6,15,56,65,-9,51
Airdrieon,2222,6,11,11,14,48,58,-10,44
East Fife,2222,7,13,4,19,48,65,-17,43
Forfar,2222,8,10,5,21,38,67,-29,35
Queen's Park,2222,9,7,10,19,41,73,-32,31
Albion,2222,10,8,6,22,57,80,-23,30
Raith,2223,1,23,8,5,71,32,39,77
Ayr,2223,2,24,4,8,93,43,50,76
Arbroath,2223,3,17,8,11,71,50,21,59
Alloa,2223,4,17,8,11,56,46,10,59
Stranraer,2223,5,16,5,15,56,64,-8,53
Airdrieon,2223,6,11,11,14,47,59,-12,44
East Fife,2223,7,13,3,20,47,65,-18,42
Forfar,2223,8,10,5,21,39,66,-27,35
Queen's Park,2223,9,7,10,19,41,73,-32,31
Albion,2223,10,8,6,22,58,81,-23,30
Raith,2224,1,23,8,5,70,33,37,77
Ayr,2224,2,24,4,8,95,42,53,76
Arbroath,2224,3,18,8,10,73,49,24,62
Alloa,2224,4,17,8,11,57,45,12,59
Stranraer,2224,5,15,5,16,55,66,-11,50
East Fife,2224,6,14,3,19,49,64,-15,45
Airdrieon,2224,7,11,11,14,47,58,-11,44
Forfar,2224,8,10,5,21,38,66,-28,35
Albion,2224,9,8,6,22,57,83,-26,30
Queen's Park,2224,10,6,10,20,40,75,-35,28
Ayr,2225,1,24,4,8,93,44,49,76
Raith,2225,2,22,8,6,68,33,35,74
Arbroath,2225,3,18,8,10,71,48,23,62
Alloa,2225,4,18,8,10,57,43,14,62
Stranraer,2225,5,15,6,15,56,65,-9,51
Airdrieon,2225,6,11,11,14,50,59,-9,44
East Fife,2225,7,13,4,19,48,65,-17,43
Forfar,2225,8,10,5,21,39,69,-30,35
Albion,2225,9,8,6,22,59,81,-22,30
Queen's Park,2225,10,6,10,20,39,73,-34,28
Ayr,2226,1,24,4,8,95,43,52,76
Raith,2226,2,22,9,5,68,32,36,75
Arbroath,2226,3,18,8,10,73,49,24,62
Alloa,2226,4,17,9,10,56,43,13,60
Stranraer,2226,5,16,5,15,57,65,-8,53
East Fife,2226,6,13,3,20,48,66,-18,42
Airdrieon,2226,7,10,11,15,47,61,-14,41
Forfar,2226,8,11,5,20,41,66,-25,38
Albion,2226,9,8,6,22,58,83,-25,30
Queen's Park,2226,10,6,10,20,40,75,-35,28
Ayr,2227,1,24,4,8,93,42,51,76
Raith,2227,2,22,9,5,68,32,36,75
Arbroath,2227,3,18,8,10,71,48,23,62
Alloa,2227,4,17,9,10,56,43,13,60
Stranraer,2227,5,15,5,16,56,66,-10,50
East Fife,2227,6,14,3,19,49,65,-16,45
Airdrieon,2227,7,11,11,14,47,59,-12,44
Forfar,2227,8,10,5,21,39,66,-27,35
Albion,2227,9,8,6,22,57,81,-24,30
Queen's Park,2227,10,6,10,20,39,73,-34,28
Raith,2228,1,23,8,5,70,33,37,77
Ayr,2228,2,24,4,8,95,46,49,76
Arbroath,2228,3,17,9,10,70,48,22,60
Alloa,2228,4,17,8,11,57,45,12,59
Stranraer,2228,5,15,6,15,57,66,-9,51
Airdrieon,2228,6,11,11,14,49,58,-9,44
East Fife,2228,7,13,4,19,49,66,-17,43
Forfar,2228,8,10,5,21,38,68,-30,35
Albion,2228,9,8,6,22,61,83,-22,30
Queen's Park,2228,10,6,11,19,39,72,-33,29
Raith,2229,1,23,8,5,69,32,37,77
Ayr,2229,2,24,4,8,92,43,49,76
Arbroath,2229,3,17,8,11,71,50,21,59
Alloa,2229,4,17,8,11,56,44,12,59
Stranraer,2229,5,15,5,16,56,66,-10,50
East Fife,2229,6,14,3,19,49,65,-16,45
Airdrieon,2229,7,11,11,14,48,58,-10,44
Forfar,2229,8,10,5,21,38,67,-29,35
Queen's Park,2229,9,7,10,19,41,73,-32,31
Albion,2229,10,8,6,22,58,80,-22,30
Ayr,2230,1,24,4,8,94,42,52,76
Raith,2230,2,22,9,5,68,32,36,75
Alloa,2230,3,17,9,10,56,43,13,60
Arbroath,2230,4,17,8,11,70,49,21,59
Stranraer,2230,5,15,6,15,58,67,-9,51
East Fife,2230,6,13,4,19,50,67,-17,43
Airdrieon,2230,7,10,11,15,45,59,-14,41
Forfar,2230,8,11,5,20,39,64,-25,38
Queen's Park,2230,9,7,10,19,40,72,-32,31
Albion,2230,10,8,6,22,57,82,-25,30
Raith,2231,1,23,8,5,70,32,38,77
Ayr,2231,2,23,5,8,91,43,48,74
Arbroath,2231,3,17,9,10,73,51,22,60
Alloa,2231,4,17,8,11,56,45,11,59
Stranraer,2231,5,16,5,15,57,65,-8,53
Airdrieon,2231,6,10,12,14,46,59,-13,42
East Fife,2231,7,13,3,20,48,66,-18,42
Forfar,2231,8,10,6,20,39,65,-26,36
Albion,2231,9,8,7,21,58,79,-21,31
Queen's Park,2231,10,6,11,19,42,75,-33,29
Raith,2232,1,23,8,5,70,32,38,77
Ayr,2232,2,24,4,8,93,44,49,76
Arbroath,2232,3,17,8,11,70,49,21,59
Alloa,2232,4,17,8,11,56,45,11,59
Stranraer,2232,5,15,6,15,56,65,-9,51
East Fife,2232,6,13,4,19,48,65,-17,43
Airdrieon,2232,7,10,12,14,47,60,-13,42
Forfar,2232,8,10,6,20,40,66,-26,36
Queen's Park,2232,9,7,10,19,40,72,-32,31
Albion,2232,10,8,6,22,59,81,-22,30
Raith,2233,1,23,8,5,71,34,37,77
Ayr,2233,2,23,5,8,92,44,48,74
Arbroath,2233,3,17,8,11,71,50,21,59
Alloa,2233,4,17,8,11,58,46,12,59
Stranraer,2233,5,15,6,15,56,65,-9,51
East Fife,2233,6,13,4,19,48,65,-17,43
Airdrieon,2233,7,10,12,14,46,59,-13,42
Forfar,2233,8,10,6,20,39,65,-26,36
Albion,2233,9,8,7,21,59,80,-21,31
Queen's Park,2233,10,7,10,19,41,73,-32,31
Raith,2234,1,23,8,5,74,32,42,77
Ayr,2234,2,24,4,8,93,43,50,76
Arbroath,2234,3,17,8,11,71,50,21,59
Alloa,2234,4,17,8,11,56,49,7,59
Stranraer,2234,5,15,5,16,55,68,-13,50
East Fife,2234,6,14,3,19,51,64,-13,45
Airdrieon,2234,7,10,11,15,45,59,-14,41
Forfar,2234,8,11,5,20,39,64,-25,38
Queen's Park,2234,9,7,10,19,41,73,-32,31
Albion,2234,10,8,6,22,58,81,-23,30
Raith,2235,1,23,8,5,70,33,37,77
Ayr,2235,2,24,4,8,94,42,52,76
Arbroath,2235,3,17,9,10,73,51,22,60
Alloa,2235,4,17,8,11,57,45,12,59
Stranraer,2235,5,15,5,16,55,65,-10,50
East Fife,2235,6,14,3,19,48,64,-16,45
Airdrieon,2235,7,11,11,14,47,59,-12,44
Forfar,2235,8,10,5,21,39,66,-27,35
Albion,2235,9,8,6,22,57,82,-25,30
Queen's Park,2235,10,6,11,19,42,75,-33,29
Ayr,2236,1,24,4,8,93,43,50,76
Raith,2236,2,22,8,6,68,34,34,74
Arbroath,2236,3,18,8,10,74,50,24,62
Alloa,2236,4,18,8,10,58,43,15,62
Stranraer,2236,5,15,5,16,57,68,-11,50
East Fife,2236,6,14,3,19,51,66,-15,45
Airdrieon,2236,7,10,11,15,45,59,-14,41
Forfar,2236,8,11,5,20,39,64,-25,38
Albion,2236,9,8,6,22,58,81,-23,30
Queen's Park,2236,10,6,10,20,41,76,-35,28
Raith,2237,1,23,8,5,70,32,38,77
Ayr,2237,2,24,4,8,91,42,49,76
Arbroath,2237,3,17,8,11,72,52,20,59
Alloa,2237,4,17,8,11,56,45,11,59
Stranraer,2237,5,15,6,15,55,64,-9,51
Airdrieon,2237,6,11,11,14,49,58,-9,44
East Fife,2237,7,13,4,19,47,64,-17,43
Forfar,2237,8,10,5,21,38,68,-30,35
Queen's Park,2237,9,7,10,19,43,74,-31,31
Albion,2237,10,8,6,22,57,79,-22,30
Ayr,2238,1,24,4,8,95,42,53,76
Raith,2238,2,22,8,6,68,33,35,74
Arbroath,2238,3,18,8,10,73,50,23,62
Alloa,2238,4,18,8,10,57,43,14,62
Stranraer,2238,5,16,5,15,57,64,-7,53
Airdrieon,2238,6,11,11,14,47,59,-12,44
East Fife,2238,7,13,3,20,47,66,-19,42
Forfar,2238,8,10,5,21,39,66,-27,35
Albion,2238,9,8,6,22,57,83,-26,30
Queen's Park,2238,10,6,10,20,41,75,-34,28
Ayr,2239,1,24,4,8,95,45,50,76
Raith,2239,2,22,9,5,70,34,36,75
Arbroath,2239,3,17,9,10,71,49,22,60
Alloa,2239,4,17,9,10,58,45,13,60
Stranraer,2239,5,15,5,16,55,66,-11,50
East Fife,2239,6,14,3,19,49,64,-15,45
Airdrieon,2239,7,10,11,15,45,63,-18,41
Forfar,2239,8,11,5,20,43,64,-21,38
Albion,2239,9,8,6,22,60,83,-23,30
Queen's Park,2239,10,6,11,19,40,73,-33,29
Raith,2240,1,23,8,5,69,32,37,77
Ayr,2240,2,24,4,8,95,43,52,76
Arbroath,2240,3,18,8,10,72,49,23,62
Alloa,2240,4,17,8,11,56,44,12,59
Stranraer,2240,5,15,5,16,55,67,-12,50
East Fife,2240,6,14,3,19,50,64,-14,45
Airdrieon,2240,7,10,12,14,46,59,-13,42
Forfar,2240,8,10,6,20,39,65,-26,36
Albion,2240,9,8,6,22,58,83,-25,30
Queen's Park,2240,10,6,10,20,40,74,-34,28
Ayr,2241,1,23,5,8,90,42,48,74
Raith,2241,2,22,8,6,68,33,35,74
Arbroath,2241,3,18,8,10,72,49,23,62
Alloa,2241,4,18,8,10,57,43,14,62
Stranraer,2241,5,16,5,15,57,64,-7,53
Airdrieon,2241,6,11,11,14,49,61,-12,44
East Fife,2241,7,13,3,20,47,66,-19,42
Forfar,2241,8,10,5,21,41,68,-27,35
Albion,2241,9,8,7,21,57,78,-21,31
Queen's Park,2241,10,6,10,20,40,74,-34,28
Raith,2242,1,23,8,5,70,32,38,77
Ayr,2242,2,24,4,8,95,44,51,76
Arbroath,2242,3,17,8,11,73,52,21,59
Alloa,2242,4,17,8,11,56,45,11,59
Stranraer,2242,5,15,5,16,55,65,-10,50
East Fife,2242,6,14,3,19,48,64,-16,45
Airdrieon,2242,7,10,12,14,46,59,-13,42
Forfar,2242,8,10,6,20,39,65,-26,36
Queen's Park,2242,9,7,10,19,43,75,-32,31
Albion,2242,10,8,6,22,59,83,-24,30
Ayr,2243,1,24,4,8,94,43,51,76
Raith,2243,2,22,8,6,68,33,35,74
Arbroath,2243,3,18,8,10,72,48,24,62
Alloa,2243,4,18,8,10,57,43,14,62
Stranraer,2243,5,15,6,15,55,64,-9,51
Airdrieon,2243,6,11,11,14,48,58,-10,44
East Fife,2243,7,13,4,19,47,64,-17,43
Forfar,2243,8,10,5,21,38,67,-29,35
Albion,2243,9,8,6,22,58,82,-24,30
Queen's Park,2243,10,6,10,20,39,74,-35,28
Ayr,2244,1,24,4,8,95,44,51,76
Raith,2244,2,22,9,5,70,34,36,75
Arbroath,2244,3,17,9,10,71,49,22,60
Alloa,2244,4,17,9,10,58,45,13,60
Stranraer,2244,5,15,5,16,55,66,-11,50
East Fife,2244,6,14,3,19,49,64,-15,45
Airdrieon,2244,7,10,11,15,48,62,-14,41
Forfar,2244,8,11,5,20,42,67,-25,38
Albion,2244,9,8,6,22,59,83,-24,30
Queen's Park,2244,10,6,11,19,40,73,-33,29
Raith,2245,1,23,8,5,70,32,38,77
Ayr,2245,2,24,4,8,94,42,52,76
Arbroath,2245,3,17,8,11,70,50,20,59
Alloa,2245,4,17,8,11,56,45,11,59
Stranraer,2245,5,15,5,16,56,66,-10,50
East Fife,2245,6,14,3,19,49,65,-16,45
Airdrieon,2245,7,11,11,14,46,58,-12,44
Forfar,2245,8,10,5,21,38,65,-27,35
Queen's Park,2245,9,7,10,19,41,72,-31,31
Albion,2245,10,8,6,22,57,82,-25,30
Ayr,2246,1,24,4,8,92,43,49,76
Raith,2246,2,22,9,5,69,33,36,75
Arbroath,2246,3,18,8,10,73,49,24,62
Alloa,2246,4,17,9,10,57,44,13,60
Stranraer,2246,5,16,5,15,56,64,-8,53
Airdrieon,2246,6,11,11,14,50,60,-10,44
East Fife,2246,7,13,3,20,47,65,-18,42
Forfar,2246,8,10,5,21,40,69,-29,35
Albion,2246,9,8,6,22,58,80,-22,30
Queen's Park,2246,10,6,10,20,40,75,-35,28
Raith,2247,1,23,8,5,69,32,37,77
Ayr,2247,2,23,4,9,91,46,45,73
Arbroath,2247,3,18,8,10,74,50,24,62
Alloa,2247,4,17,8,11,56,44,12,59
Stranraer,2247,5,15,6,15,57,66,-9,51
East Fife,2247,6,13,4,19,49,66,-17,43
Airdrieon,2247,7,10,11,15,46,61,-15,41
Forfar,2247,8,11,5,20,41,65,-24,38
Albion,2247,9,9,6,21,61,79,-18,33
Queen's Park,2247,10,6,10,20,41,76,-35,28
Ayr,2248,1,24,4,8,91,42,49,76
Raith,2248,2,22,8,6,68,34,34,74
Arbroath,2248,3,18,8,10,74,51,23,62
Alloa,2248,4,18,8,10,58,43,15,62
Stranraer,2248,5,15,5,16,55,66,-11,50
East Fife,2248,6,14,3,19,49,64,-15,45
Airdrieon,2248,7,11,11,14,47,59,-12,44
Forfar,2248,8,10,5,21,39,66,-27,35
Albion,2248,9,8,6,22,57,79,-22,30
Queen's Park,2248,10,6,10,20,42,76,-34,28
Ayr,2249,1,24,4,8,93,42,51,76
Raith,2249,2,22,8,6,69,35,34,74
Alloa,2249,3,18,8,10,59,44,15,62
Arbroath,2249,4,17,9,10,71,49,22,60
Stranraer,2249,5,15,6,15,56,65,-9,51
Airdrieon,2249,6,11,11,14,47,58,-11,44
East Fife,2249,7,13,4,19,48,65,-17,43
Forfar,2249,8,10,5,21,38,66,-28,35
Albion,2249,9,8,6,22,57,81,-24,30
Queen's Park,2249,10,6,11,19,40,73,-33,29
Raith,2250,1,23,8,5,70,33,37,77
Ayr,2250,2,24,4,8,96,43,53,76
Arbroath,2250,3,17,8,11,71,50,21,59
Alloa,2250,4,17,8,11,57,45,12,59
Stranraer,2250,5,15,5,16,55,65,-10,50
East Fife,2250,6,14,3,19,48,64,-16,45
Airdrieon,2250,7,11,11,14,48,59,-11,44
Forfar,2250,8,10,5,21,39,67,-28,35
Queen's Park,2250,9,7,10,19,41,73,-32,31
Albion,2250,10,8,6,22,58,84,-26,30
Raith,2251,1,23,8,5,69,32,37,77
Ayr,2251,2,24,4,8,95,44,51,76
Arbroath,2251,3,18,8,10,73,48,25,62
Alloa,2251,4,17,8,11,56,44,12,59
Stranraer,2251,5,15,6,15,56,65,-9,51
East Fife,2251,6,13,4,19,48,65,-17,43
Airdrieon,2251,7,10,12,14,46,59,-13,42
Forfar,2251,8,10,6,20,39,65,-26,36
Albion,2251,9,8,6,22,59,83,-24,30
Queen's Park,2251,10,6,10,20,39,75,-36,28
Raith,2252,1,23,8,5,70,33,37,77
Ayr,2252,2,23,5,8,90,42,48,74
Arbroath,2252,3,17,8,11,71,52,19,59
Alloa,2252,4,17,8,11,57,45,12,59
Stranraer,2252,5,15,5,16,57,68,-11,50
East Fife,2252,6,14,3,19,51,66,-15,45
Airdrieon,2252,7,11,11,14,48,58,-10,44
Forfar,2252,8,10,5,21,38,67,-29,35
Albion,2252,9,8,7,21,57,78,-21,31
Queen's Park,2252,10,7,10,19,43,73,-30,31
Raith,2253,1,23,8,5,72,32,40,77
Ayr,2253,2,24,4,8,93,44,49,76
Arbroath,2253,3,18,8,10,72,49,23,62
Alloa,2253,4,17,8,11,56,47,9,59
Stranraer,2253,5,15,5,16,57,68,-11,50
East Fife,2253,6,14,3,19,51,66,-15,45
Airdrieon,2253,7,11,11,14,47,59,-12,44
Forfar,2253,8,10,5,21,39,66,-27,35
Albion,2253,9,8,6,22,59,81,-22,30
Queen's Park,2253,10,6,10,20,40,74,-34,28
Ayr,2254,1,24,4,8,93,42,51,76
Raith,2254,2,22,9,5,69,33,36,75
Alloa,2254,3,17,9,10,57,44,13,60
Arbroath,2254,4,17,8,11,70,49,21,59
Stranraer,2254,5,15,6,15,55,64,-9,51
Airdrieon,2254,6,11,11,14,46,58,-12,44
East Fife,2254,7,13,4,19,47,64,-17,43
Forfar,2254,8,10,5,21,38,65,-27,35
Queen's Park,2254,9,7,10,19,40,72,-32,31
Albion,2254,10,8,6,22,57,81,-24,30
Raith,2255,1,23,8,5,70,33,37,77
Ayr,2255,2,24,4,8,93,44,49,76
Arbroath,2255,3,18,8,10,73,50,23,62
Alloa,2255,4,17,8,11,57,45,12,59
Stranraer,2255,5,15,6,15,57,66,-9,51
East Fife,2255,6,13,4,19,49,66,-17,43
Airdrieon,2255,7,10,11,15,45,59,-14,41
Forfar,2255,8,11,5,20,39,64,-25,38
Albion,2255,9,8,6,22,59,81,-22,30
Queen's Park,2255,10,6,10,20,41,75,-34,28
Ayr,2256,1,24,4,8,97,44,53,76
Raith,2256,2,22,8,6,68,33,35,74
Alloa,2256,3,18,8,10,57,43,14,62
Arbroath,2256,4,17,8,11,70,50,20,59
Stranraer,2256,5,15,5,16,55,66,-11,50
East Fife,2256,6,14,3,19,49,64,-15,45
Airdrieon,2256,7,10,11,15,45,60,-15,41
Forfar,2256,8,11,5,20,40,64,-24,38
Queen's Park,2256,9,7,10,19,41,72,-31,31
Albion,2256,10,8,6,22,59,85,-26,30
Ayr,2257,1,24,4,8,94,42,52,76
Raith,2257,2,22,8,6,69,34,35,74
Alloa,2257,3,18,8,10,58,44,14,62
Arbroath,2257,4,17,9,10,72,50,22,60
Stranraer,2257,5,15,6,15,59,68,-9,51
Airdrieon,2257,6,11,11,14,47,58,-11,44
East Fife,2257,7,13,4,19,51,68,-17,43
Forfar,2257,8,10,5,21,38,66,-28,35
Albion,2257,9,8,6,22,57,82,-25,30
Queen's Park,2257,10,6,11,19,41,74,-33,29
Raith,2258,1,23,8,5,70,32,38,77
Ayr,2258,2,24,4,8,94,45,49,76
Arbroath,2258,3,17,8,11,72,51,21,59
Alloa,2258,4,17,8,11,56,45,11,59
Stranraer,2258,5,15,5,16,55,68,-13,50
East Fife,2258,6,14,3,19,51,64,-13,45
Airdrieon,2258,7,11,11,14,47,59,-12,44
Forfar,2258,8,10,5,21,39,66,-27,35
Queen's Park,2258,9,7,10,19,42,74,-32,31
Albion,2258,10,8,6,22,60,82,-22,30
Ayr,2259,1,24,4,8,95,45,50,76
Raith,2259,2,22,9,5,69,33,36,75
Arbroath,2259,3,18,8,10,73,50,23,62
Alloa,2259,4,17,9,10,57,44,13,60
Stranraer,2259,5,16,5,15,59,65,-6,53
Airdrieon,2259,6,10,12,14,46,59,-13,42
East Fife,2259,7,13,3,20,48,68,-20,42
Forfar,2259,8,10,6,20,39,65,-26,36
Albion,2259,9,8,6,22,60,83,-23,30
Queen's Park,2259,10,6,10,20,41,75,-34,28
Raith,2260,1,23,8,5,70,32,38,77
Ayr,2260,2,24,4,8,93,43,50,76
Arbroath,2260,3,18,8,10,72,48,24,62
Alloa,2260,4,17,8,11,56,45,11,59
Stranraer,2260,5,15,5,16,55,65,-10,50
East Fife,2260,6,14,3,19,48,64,-16,45
Airdrieon,2260,7,10,11,15,47,62,-15,41
Forfar,2260,8,11,5,20,42,66,-24,38
Albion,2260,9,8,6,22,58,81,-23,30
Queen's Park,2260,10,6,10,20,39,74,-35,28
Raith,2261,1,23,8,5,69,32,37,77
Ayr,2261,2,24,4,8,96,43,53,76
Arbroath,2261,3,17,8,11,71,51,20,59
Alloa,2261,4,17,8,11,56,44,12,59
Stranraer,2261,5,16,5,15,57,65,-8,53
Airdrieon,2261,6,11,11,14,47,59,-12,44
East Fife,2261,7,13,3,20,48,66,-18,42
Forfar,2261,8,10,5,21,39,66,-27,35
Queen's Park,2261,9,7,10,19,42,73,-31,31
Albion,2261,10,8,6,22,58,84,-26,30
Ayr,2262,1,24,4,8,94,43,51,76
Raith,2262,2,22,8,6,70,35,35,74
Arbroath,2262,3,18,8,10,72,48,24,62
Alloa,2262,4,18,8,10,59,45,14,62
Stranraer,2262,5,15,5,16,56,68,-12,50
East Fife,2262,6,14,3,19,51,65,-14,45
Airdrieon,2262,7,11,11,14,46,58,-12,44
Forfar,2262,8,10,5,21,38,65,-27,35
Albion,2262,9,8,6,22,58,82,-24,30
Queen's Park,2262,10,6,10,20,39,74,-35,28
Raith,2263,1,23,8,5,69,32,37,77
Ayr,2263,2,24,4,8,93,43,50,76
Arbroath,2263,3,17,8,11,73,52,21,59
Alloa,2263,4,17,8,11,56,44,12,59
Stranraer,2263,5,15,5,16,56,66,-10,50
East Fife,2263,6,14,3,19,49,65,-16,45
Airdrieon,2263,7,11,11,14,47,59,-12,44
Forfar,2263,8,10,5,21,39,66,-27,35
Queen's Park,2263,9,7,10,19,43,75,-32,31
Albion,2263,10,8,6,22,58,81,-23,30
Raith,2264,1,22,8,6,69,34,35,74
Ayr,2264,2,23,4,9,92,47,45,73
Arbroath,2264,3,18,8,10,72,48,24,62
Alloa,2264,4,18,8,10,58,44,14,62
Stranraer,2264,5,16,5,15,56,64,-8,53
Airdrieon,2264,6,11,11,14,47,58,-11,44
East Fife,2264,7,13,3,20,47,65,-18,42
Forfar,2264,8,10,5,21,38,66,-28,35
Albion,2264,9,9,6,21,62,80,-18,33
Queen's Park,2264,10,6,10,20,39,74,-35,28
Raith,2265,1,23,8,5,70,33,37,77
Ayr,2265,2,24,4,8,94,42,52,76
Arbroath,2265,3,17,9,10,72,50,22,60
Alloa,2265,4,17,8,11,57,45,12,59
Stranraer,2265,5,15,5,16,55,67,-12,50
East Fife,2265,6,14,3,19,50,64,-14,45
Airdrieon,2265,7,10,11,15,45,60,-15,41
Forfar,2265,8,11,5,20,40,64,-24,38
Albion,2265,9,8,6,22,57,82,-25,30
Queen's Park,2265,10,6,11,19,41,74,-33,29
Raith,2266,1,23,8,5,70,32,38,77
Ayr,2266,2,24,4,8,96,46,50,76
Arbroath,2266,3,17,8,11,70,50,20,59
Alloa,2266,4,17,8,11,56,45,11,59
Stranraer,2266,5,15,6,15,56,65,-9,51
East Fife,2266,6,13,4,19,48,65,-17,43
Airdrieon,2266,7,10,11,15,46,61,-15,41
Forfar,2266,8,11,5,20,41,65,-24,38
Queen's Park,2266,9,7,10,19,41,72,-31,31
Albion,2266,10,8,6,22,61,84,-23,30
Raith,2267,1,23,8,5,69,32,37,77
Ayr,2267,2,24,4,8,94,44,50,76
Arbroath,2267,3,18,8,10,73,50,23,62
Alloa,2267,4,17,8,11,56,44,12,59
Stranraer,2267,5,15,5,16,57,67,-10,50
East Fife,2267,6,14,3,19,50,66,-16,45
Airdrieon,2267,7,11,11,14,51,58,-7,44
Forfar,2267,8,10,5,21,38,70,-32,35
Albion,2267,9,8,6,22,59,82,-23,30
Queen's Park,2267,10,6,10,20,41,75,-34,28
Ayr,2268,1,24,4,8,94,42,52,76
Raith,2268,2,22,9,5,68,32,36,75
Alloa,2268,3,17,9,10,56,43,13,60
Arbroath,2268,4,17,8,11,71,50,21,59
Stranraer,2268,5,15,6,15,56,65,-9,51
East Fife,2268,6,13,4,19,48,65,-17,43
Airdrieon,2268,7,10,11,15,47,62,-15,41
Forfar,2268,8,11,5,20,42,66,-24,38
Queen's Park,2268,9,7,10,19,41,73,-32,31
Albion,2268,10,8,6,22,57,82,-25,30
Raith,2269,1,23,8,5,71,32,39,77
Ayr,2269,2,24,4,8,94,42,52,76
Arbroath,2269,3,17,8,11,70,50,20,59
Alloa,2269,4,17,8,11,56,46,10,59
Stranraer,2269,5,15,6,15,57,66,-9,51
East Fife,2269,6,13,4,19,49,66,-17,43
Airdrieon,2269,7,10,12,14,46,59,-13,42
Forfar,2269,8,10,6,20,39,65,-26,36
Queen's Park,2269,9,7,10,19,41,72,-31,31
Albion,2269,10,8,6,22,57,82,-25,30
Raith,2270,1,23,8,5,69,32,37,77
Ayr,2270,2,24,4,8,92,42,50,76
Arbroath,2270,3,17,8,11,70,49,21,59
Alloa,2270,4,17,8,11,56,44,12,59
Stranraer,2270,5,15,5,16,56,66,-10,50
East Fife,2270,6,14,3,19,49,65,-16,45
Airdrieon,2270,7,10,11,15,47,61,-14,41
Forfar,2270,8,11,5,20,41,66,-25,38
Queen's Park,2270,9,7,10,19,40,72,-32,31
Albion,2270,10,8,6,22,57,80,-23,30
Ayr,2271,1,24,4,8,93,43,50,76
Raith,2271,2,22,9,5,69,33,36,75
Arbroath,2271,3,18,8,10,73,48,25,62
Alloa,2271,4,17,9,10,57,44,13,60
Stranraer,2271,5,16,5,15,57,65,-8,53
Airdrieon,2271,6,11,11,14,47,59,-12,44
East Fife,2271,7,13,3,20,48,66,-18,42
Forfar,2271,8,10,5,21,39,66,-27,35
Albion,2271,9,8,6,22,58,81,-23,30
Queen's Park,2271,10,6,10,20,39,75,-36,28
Ayr,2272,1,24,4,8,93,43,50,76
Raith,2272,2,22,9,5,69,33,36,75
Arbroath,2272,3,18,8,10,73,50,23,62
Alloa,2272,4,17,9,10,57,44,13,60
Stranraer,2272,5,15,5,16,55,66,-11,50
East Fife,2272,6,14,3,19,49,64,-15,45
Airdrieon,2272,7,10,11,15,45,60,-15,41
Forfar,2272,8,11,5,20,40,64,-24,38
Albion,2272,9,8,6,22,58,81,-23,30
Queen's Park,2272,10,6,10,20,41,75,-34,28
Ayr,2273,1,24,4,8,92,43,49,76
Raith,2273,2,22,8,6,69,36,33,74
Arbroath,2273,3,18,8,10,71,48,23,62
Alloa,2273,4,18,8,10,60,44,16,62
Stranraer,2273,5,16,5,15,58,65,-7,53
East Fife,2273,6,13,3,20,48,67,-19,42
Airdrieon,2273,7,10,11,15,46,60,-14,41
Forfar,2273,8,11,5,20,40,65,-25,38
Albion,2273,9,8,6,22,58,80,-22,30
Queen's Park,2273,10,6,10,20,39,73,-34,28
Raith,2274,1,23,8,5,71,33,38,77
Ayr,2274,2,24,4,8,94,44,50,76
Arbroath,2274,3,17,8,11,71,51,20,59
Alloa,2274,4,17,8,11,57,46,11,59
Stranraer,2274,5,15,5,16,56,68,-12,50
East Fife,2274,6,14,3,19,51,65,-14,45
Airdrieon,2274,7,11,11,14,46,58,-12,44
Forfar,2274,8,10,5,21,38,65,-27,35
Queen's Park,2274,9,7,10,19,42,73,-31,31
Albion,2274,10,8,6,22,59,82,-23,30
Raith,2275,1,23,8,5,70,33,37,77
Ayr,2275,2,24,4,8,93,43,50,76
Arbroath,2275,3,18,8,10,71,48,23,62
Alloa,2275,4,17,8,11,57,45,12,59
Stranraer,2275,5,15,5,16,56,66,-10,50
East Fife,2275,6,14,3,19,49,65,-16,45
Airdrieon,2275,7,10,12,14,46,59,-13,42
Forfar,2275,8,10,6,20,39,65,-26,36
Albion,2275,9,8,6,22,58,81,-23,30
Queen's Park,2275,10,6,10,20,39,73,-34,28
Raith,2276,1,23,8,5,70,33,37,77
Ayr,2276,2,24,4,8,92,42,50,76
Arbroath,2276,3,18,8,10,74,50,24,62
Alloa,2276,4,17,8,11,57,45,12,59
Stranraer,2276,5,15,5,16,58,68,-10,50
East Fife,2276,6,14,3,19,51,67,-16,45
Airdrieon,2276,7,11,11,14,47,59,-12,44
Forfar,2276,8,10,5,21,39,66,-27,35
Albion,2276,9,8,6,22,57,80,-23,30
Queen's Park,2276,10,6,10,20,41,76,-35,28
Raith,2277,1,23,8,5,69,32,37,77
Ayr,2277,2,24,4,8,94,42,52,76
Arbroath,2277,3,17,8,11,71,51,20,59
Alloa,2277,4,17,8,11,56,44,12,59
Stranraer,2277,5,15,6,15,55,64,-9,51
East Fife,2277,6,13,4,19,47,64,-17,43
Airdrieon,2277,7,10,12,14,46,59,-13,42
Forfar,2277,8,10,6,20,39,65,-26,36
Queen's Park,2277,9,7,10,19,42,73,-31,31
Albion,2277,10,8,6,22,57,82,-25,30
Raith,2278,1,23,8,5,69,32,37,77
Ayr,2278,2,24,4,8,96,43,53,76
Arbroath,2278,3,17,9,10,70,48,22,60
Alloa,2278,4,17,8,11,56,44,12,59
Stranraer,2278,5,15,5,16,56,66,-10,50
East Fife,2278,6,14,3,19,49,65,-16,45
Airdrieon,2278,7,11,11,14,48,58,-10,44
Forfar,2278,8,10,5,21,38,67,-29,35
Albion,2278,9,8,6,22,58,84,-26,30
Queen's Park,2278,10,6,11,19,39,72,-33,29
Raith,2279,1,23,8,5,70,32,38,77
Ayr,2279,2,24,4,8,95,42,53,76
Arbroath,2279,3,17,8,11,71,50,21,59
Alloa,2279,4,17,8,11,56,45,11,59
Stranraer,2279,5,16,5,15,57,65,-8,53
Airdrieon,2279,6,11,11,14,48,58,-10,44
East Fife,2279,7,13,3,20,48,66,-18,42
Forfar,2279,8,10,5,21,38,67,-29,35
Queen's Park,2279,9,7,10,19,41,73,-32,31
Albion,2279,10,8,6,22,57,83,-26,30
Raith,2280,1,23,8,5,71,32,39,77
Ayr,2280,2,24,4,8,94,43,51,76
Arbroath,2280,3,17,9,10,71,49,22,60
Alloa,2280,4,17,8,11,56,46,10,59
Stranraer,2280,5,16,5,15,57,65,-8,53
Airdrieon,2280,6,11,11,14,46,58,-12,44
East Fife,2280,7,13,3,20,48,66,-18,42
Forfar,2280,8,10,5,21,38,65,-27,35
Albion,2280,9,8,6,22,58,82,-24,30
Queen's Park,2280,10,6,11,19,40,73,-33,29
Ayr,2281,1,24,4,8,95,43,52,76
Raith,2281,2,22,9,5,69,33,36,75
Arbroath,2281,3,17,9,10,74,52,22,60
Alloa,2281,4,17,9,10,57,44,13,60
Stranraer,2281,5,16,5,15,56,64,-8,53
Airdrieon,2281,6,10,12,14,47,60,-13,42
East Fife,2281,7,13,3,20,47,65,-18,42
Forfar,2281,8,10,6,20,40,66,-26,36
Albion,2281,9,8,6,22,58,83,-25,30
Queen's Park,2281,10,6,11,19,43,76,-33,29
Raith,2282,1,23,8,5,71,32,39,77
Ayr,2282,2,23,5,8,91,43,48,74
Arbroath,2282,3,18,8,10,72,48,24,62
Alloa,2282,4,17,8,11,56,46,10,59
Stranraer,2282,5,16,5,15,56,64,-8,53
East Fife,2282,6,13,3,20,47,65,-18,42
Airdrieon,2282,7,10,11,15,45,59,-14,41
Forfar,2282,8,11,5,20,39,64,-25,38
Albion,2282,9,8,7,21,58,79,-21,31
Queen's Park,2282,10,6,10,20,39,74,-35,28
Ayr,2283,1,24,4,8,94,42,52,76
Raith,2283,2,22,8,6,68,34,34,74
Arbroath,2283,3,18,8,10,73,48,25,62
Alloa,2283,4,18,8,10,58,43,15,62
Stranraer,2283,5,15,5,16,57,67,-10,50
East Fife,2283,6,14,3,19,50,66,-16,45
Airdrieon,2283,7,11,11,14,47,58,-11,44
Forfar,2283,8,10,5,21,38,66,-28,35
Albion,2283,9,8,6,22,57,82,-25,30
Queen's Park,2283,10,6,10,20,39,75,-36,28
Raith,2284,1,23,8,5,71,32,39,77
Ayr,2284,2,24,4,8,92,43,49,76
Arbroath,2284,3,17,8,11,71,52,19,59
Alloa,2284,4,17,8,11,56,46,10,59
Stranraer,2284,5,15,5,16,55,69,-14,50
East Fife,2284,6,14,3,19,52,64,-12,45
Airdrieon,2284,7,11,11,14,47,59,-12,44
Forfar,2284,8,10,5,21,39,66,-27,35
Queen's Park,2284,9,7,10,19,43,73,-30,31
Albion,2284,10,8,6,22,58,80,-22,30
Ayr,2285,1,24,4,8,92,43,49,76
Raith,2285,2,22,8,6,68,34,34,74
Arbroath,2285,3,18,8,10,71,48,23,62
Alloa,2285,4,18,8,10,58,43,15,62
Stranraer,2285,5,15,5,16,56,66,-10,50
East Fife,2285,6,14,3,19,49,65,-16,45
Airdrieon,2285,7,10,11,15,46,60,-14,41
Forfar,2285,8,11,5,20,40,65,-25,38
Albion,2285,9,8,6,22,58,80,-22,30
Queen's Park,2285,10,6,10,20,39,73,-34,28
Raith,2286,1,23,8,5,71,32,39,77
Ayr,2286,2,24,4,8,94,43,51,76
Arbroath,2286,3,17,9,10,70,48,22,60
Alloa,2286,4,17,8,11,56,46,10,59
Stranraer,2286,5,15,5,16,55,65,-10,50
East Fife,2286,6,14,3,19,48,64,-16,45
Airdrieon,2286,7,11,11,14,47,58,-11,44
Forfar,2286,8,10,5,21,38,66,-28,35
Albion,2286,9,8,6,22,58,82,-24,30
Queen's Park,2286,10,6,11,19,39,72,-33,29
Raith,2287,1,22,9,5,69,33,36,75
Ayr,2287,2,23,4,9,91,44,47,73
Alloa,2287,3,17,9,10,57,44,13,60
Arbroath,2287,4,17,8,11,71,51,20,59
Stranraer,2287,5,15,5,16,55,66,-11,50
East Fife,2287,6,14,3,19,49,64,-15,45
Airdrieon,2287,7,11,11,14,47,58,-11,44
Forfar,2287,8,10,5,21,38,66,-28,35
Albion,2287,9,9,6,21,59,79,-20,33
Queen's Park,2287,10,7,10,19,42,73,-31,31
Ayr,2288,1,23,5,8,92,44,48,74
Raith,2288,2,22,8,6,68,33,35,74
Arbroath,2288,3,18,8,10,72,49,23,62
Alloa,2288,4,18,8,10,57,43,14,62
Stranraer,2288,5,15,5,16,56,66,-10,50
East Fife,2288,6,14,3,19,49,65,-16,45
Airdrieon,2288,7,11,11,14,49,60,-11,44
Forfar,2288,8,10,5,21,40,68,-28,35
Albion,2288,9,8,7,21,59,80,-21,31
Queen's Park,2288,10,6,10,20,40,74,-34,28
Ayr,2289,1,24,4,8,92,42,50,76
Raith,2289,2,22,8,6,70,35,35,74
Arbroath,2289,3,18,8,10,73,49,24,62
Alloa,2289,4,18,8,10,59,45,14,62
Stranraer,2289,5,16,5,15,58,65,-7,53
Airdrieon,2289,6,11,11,14,49,58,-9,44
East Fife,2289,7,13,3,20,48,67,-19,42
Forfar,2289,8,10,5,21,38,68,-30,35
Albion,2289,9,8,6,22,57,80,-23,30
Queen's Park,2289,10,6,10,20,40,75,-35,28
Raith,2290,1,23,8,5,71,33,38,77
Ayr,2290,2,24,4,8,92,42,50,76
Arbroath,2290,3,17,8,11,70,49,21,59
Alloa,2290,4,17,8,11,57,46,11,59
Stranraer,2290,5,15,6,15,55,64,-9,51
Airdrieon,2290,6,11,11,14,48,59,-11,44
East Fife,2290,7,13,4,19,47,64,-17,43
Forfar,2290,8,10,5,21,39,67,-28,35
Queen's Park,2290,9,7,10,19,40,72,-32,31
Albion,2290,10,8,6,22,57,80,-23,30
Ayr,2291,1,24,4,8,95,42,53,76
Raith,2291,2,22,9,5,69,33,36,75
Arbroath,2291,3,17,9,10,71,49,22,60
Alloa,2291,4,17,9,10,57,44,13,60
Stranraer,2291,5,16,5,15,58,65,-7,53
Airdrieon,2291,6,10,12,14,46,59,-13,42
East Fife,2291,7,13,3,20,48,67,-19,42
Forfar,2291,8,10,6,20,39,65,-26,36
Albion,2291,9,8,6,22,57,83,-26,30
Queen's Park,2291,10,6,11,19,40,73,-33,29
Raith,2292,1,23,8,5,70,33,37,77
Ayr,2292,2,23,5,8,92,44,48,74
Arbroath,2292,3,17,9,10,71,49,22,60
Alloa,2292,4,17,8,11,57,45,12,59
Stranraer,2292,5,15,5,16,57,67,-10,50
East Fife,2292,6,14,3,19,50,66,-16,45
Airdrieon,2292,7,10,12,14,46,59,-13,42
Forfar,2292,8,10,6,20,39,65,-26,36
Albion,2292,9,8,7,21,59,80,-21,31
Queen's Park,2292,10,6,11,19,40,73,-33,29
Raith,2293,1,23,8,5,71,32,39,77
Ayr,2293,2,24,4,8,95,43,52,76
Arbroath,2293,3,18,8,10,75,50,25,62
Alloa,2293,4,17,8,11,56,46,10,59
Stranraer,2293,5,16,5,15,56,64,-8,53
Airdrieon,2293,6,10,12,14,46,59,-13,42
East Fife,2293,7,13,3,20,47,65,-18,42
Forfar,2293,8,10,6,20,39,65,-26,36
Albion,2293,9,8,6,22,58,83,-25,30
Queen's Park,2293,10,6,10,20,41,77,-36,28
Raith,2294,1,23,8,5,69,32,37,77
Ayr,2294,2,24,4,8,93,42,51,76
Arbroath,2294,3,18,8,10,73,49,24,62
Alloa,2294,4,17,8,11,56,44,12,59
Stranraer,2294,5,15,5,16,56,67,-11,50
East Fife,2294,6,14,3,19,50,65,-15,45
Airdrieon,2294,7,10,11,15,45,60,-15,41
Forfar,2294,8,11,5,20,40,64,-24,38
Albion,2294,9,8,6,22,57,81,-24,30
Queen's Park,2294,10,6,10,20,40,75,-35,28
Raith,2295,1,23,8,5,74,33,41,77
Ayr,2295,2,24,4,8,97,43,54,76
Arbroath,2295,3,17,9,10,71,49,22,60
Alloa,2295,4,17,8,11,57,49,8,59
Stranraer,2295,5,16,5,15,59,66,-7,53
Airdrieon,2295,6,10,12,14,46,59,-13,42
East Fife,2295,7,13,3,20,49,68,-19,42
Forfar,2295,8,10,6,20,39,65,-26,36
Albion,2295,9,8,6,22,58,85,-27,30
Queen's Park,2295,10,6,11,19,40,73,-33,29
Ayr,2296,1,24,4,8,97,44,53,76
Raith,2296,2,22,9,5,69,33,36,75
Arbroath,2296,3,18,8,10,72,48,24,62
Alloa,2296,4,17,9,10,57,44,13,60
Stranraer,2296,5,15,5,16,55,65,-10,50
East Fife,2296,6,14,3,19,48,64,-16,45
Airdrieon,2296,7,11,11,14,46,58,-12,44
Forfar,2296,8,10,5,21,38,65,-27,35
Albion,2296,9,8,6,22,59,85,-26,30
Queen's Park,2296,10,6,10,20,39,74,-35,28
Raith,2297,1,23,8,5,70,32,38,77
Ayr,2297,2,24,4,8,92,42,50,76
Arbroath,2297,3,17,8,11,72,51,21,59
Alloa,2297,4,17,8,11,56,45,11,59
Stranraer,2297,5,15,5,16,57,68,-11,50
East Fife,2297,6,14,3,19,51,66,-15,45
Airdrieon,2297,7,10,12,14,47,60,-13,42
Forfar,2297,8,10,6,20,40,66,-26,36
Queen's Park,2297,9,7,10,19,42,74,-32,31
Albion,2297,10,8,6,22,57,80,-23,30
Raith,2298,1,23,8,5,71,33,38,77
Ayr,2298,2,24,4,8,97,45,52,76
Arbroath,2298,3,18,8,10,73,49,24,62
Alloa,2298,4,17,8,11,57,46,11,59
Stranraer,2298,5,16,5,15,57,65,-8,53
Airdrieon,2298,6,11,11,14,46,58,-12,44
East Fife,2298,7,13,3,20,48,66,-18,42
Forfar,2298,8,10,5,21,38,65,-27,35
Albion,2298,9,8,6,22,60,85,-25,30
Queen's Park,2298,10,6,10,20,40,75,-35,28
Raith,2299,1,23,8,5,69,32,37,77
Ayr,2299,2,23,5,8,93,45,48,74
Arbroath,2299,3,18,8,10,73,49,24,62
Alloa,2299,4,17,8,11,56,44,12,59
Stranraer,2299,5,16,5,15,58,64,-6,53
Airdrieon,2299,6,10,12,14,46,59,-13,42
East Fife,2299,7,13,3,20,47,67,-20,42
Forfar,2299,8,10,6,20,39,65,-26,36
Albion,2299,9,8,7,21,60,81,-21,31
Queen's Park,2299,10,6,10,20,40,75,-35,28
Raith,2300,1,22,9,5,69,33,36,75
Ayr,2300,2,23,4,9,91,44,47,73
Arbroath,2300,3,18,8,10,76,50,26,62
Alloa,2300,4,17,9,10,57,44,13,60
Stranraer,2300,5,15,5,16,55,65,-10,50
East Fife,2300,6,14,3,19,48,64,-16,45
Airdrieon,2300,7,10,12,14,46,59,-13,42
Forfar,2300,8,10,6,20,39,65,-26,36
Albion,2300,9,9,6,21,59,79,-20,33
Queen's Park,2300,10,6,10,20,41,78,-37,28
Raith,2301,1,23,8,5,71,34,37,77
Ayr,2301,2,24,4,8,91,42,49,76
Arbroath,2301,3,17,8,11,71,50,21,59
Alloa,2301,4,17,8,11,58,46,12,59
Stranraer,2301,5,15,6,15,57,66,-9,51
Airdrieon,2301,6,11,11,14,46,58,-12,44
East Fife,2301,7,13,4,19,49,66,-17,43
Forfar,2301,8,10,5,21,38,65,-27,35
Queen's Park,2301,9,7,10,19,41,73,-32,31
Albion,2301,10,8,6,22,57,79,-22,30
Raith,2302,1,23,8,5,70,32,38,77
Ayr,2302,2,23,5,8,90,42,48,74
Arbroath,2302,3,17,8,11,71,50,21,59
Alloa,2302,4,17,8,11,56,45,11,59
Stranraer,2302,5,15,5,16,55,66,-11,50
East Fife,2302,6,14,3,19,49,64,-15,45
Airdrieon,2302,7,11,11,14,47,59,-12,44
Forfar,2302,8,10,5,21,39,66,-27,35
Albion,2302,9,8,7,21,57,78,-21,31
Queen's Park,2302,10,7,10,19,41,73,-32,31
Raith,2303,1,22,9,5,68,32,36,75
Ayr,2303,2,23,5,8,91,43,48,74
Arbroath,2303,3,17,9,10,71,49,22,60
Alloa,2303,4,17,9,10,56,43,13,60
Stranraer,2303,5,15,6,15,56,65,-9,51
Airdrieon,2303,6,11,11,14,48,58,-10,44
East Fife,2303,7,13,4,19,48,65,-17,43
Forfar,2303,8,10,5,21,38,67,-29,35
Albion,2303,9,8,7,21,58,79,-21,31
Queen's Park,2303,10,6,11,19,40,73,-33,29
Ayr,2304,1,24,4,8,91,42,49,76
Raith,2304,2,22,8,6,68,33,35,74
Alloa,2304,3,18,8,10,57,43,14,62
Arbroath,2304,4,17,9,10,73,51,22,60
Stranraer,2304,5,15,5,16,55,65,-10,50
East Fife,2304,6,14,3,19,48,64,-16,45
Airdrieon,2304,7,11,11,14,48,59,-11,44
Forfar,2304,8,10,5,21,39,67,-28,35
Albion,2304,9,8,6,22,57,79,-22,30
Queen's Park,2304,10,6,11,19,42,75,-33,29
Ayr,2305,1,24,4,8,93,42,51,76
Raith,2305,2,22,9,5,68,32,36,75
Arbroath,2305,3,18,8,10,72,49,23,62
Alloa,2305,4,17,9,10,56,43,13,60
Stranraer,2305,5,16,5,15,57,64,-7,53
Airdrieon,2305,6,11,11,14,52,59,-7,44
East Fife,2305,7,13,3,20,47,66,-19,42
Forfar,2305,8,10,5,21,39,71,-32,35
Albion,2305,9,8,6,22,57,81,-24,30
Queen's Park,2305,10,6,10,20,40,74,-34,28
Raith,2306,1,23,8,5,70,32,38,77
Ayr,2306,2,24,4,8,93,43,50,76
Arbroath,2306,3,17,8,11,71,50,21,59
Alloa,2306,4,17,8,11,56,45,11,59
Stranraer,2306,5,15,6,15,55,64,-9,51
Airdrieon,2306,6,11,11,14,51,60,-9,44
East Fife,2306,7,13,4,19,47,64,-17,43
Forfar,2306,8,10,5,21,40,70,-30,35
Queen's Park,2306,9,7,10,19,41,73,-32,31
Albion,2306,10,8,6,22,58,81,-23,30
Ayr,2307,1,23,5,8,93,45,48,74
Raith,2307,2,22,8,6,68,33,35,74
Alloa,2307,3,18,8,10,57,43,14,62
Arbroath,2307,4,17,9,10,71,49,22,60
Stranraer,2307,5,15,5,16,56,66,-10,50
East Fife,2307,6,14,3,19,49,65,-16,45
Airdrieon,2307,7,11,11,14,47,58,-11,44
Forfar,2307,8,10,5,21,38,66,-28,35
Albion,2307,9,8,7,21,60,81,-21,31
Queen's Park,2307,10,6,11,19,40,73,-33,29
Raith,2308,1,23,8,5,69,32,37,77
Ayr,2308,2,23,5,8,92,44,48,74
Arbroath,2308,3,17,8,11,70,49,21,59
Alloa,2308,4,17,8,11,56,44,12,59
Stranraer,2308,5,16,5,15,58,65,-7,53
Airdrieon,2308,6,11,11,14,49,61,-12,44
East Fife,2308,7,13,3,20,48,67,-19,42
Forfar,2308,8,10,5,21,41,68,-27,35
Albion,2308,9,8,7,21,59,80,-21,31
Queen's Park,2308,10,7,10,19,40,72,-32,31
Ayr,2309,1,24,4,8,93,44,49,76
Raith,2309,2,22,9,5,69,33,36,75
Alloa,2309,3,17,9,10,57,44,13,60
Arbroath,2309,4,17,8,11,70,49,21,59
Stranraer,2309,5,15,5,16,56,66,-10,50
East Fife,2309,6,14,3,19,49,65,-16,45
Airdrieon,2309,7,10,11,15,46,61,-15,41
Forfar,2309,8,11,5,20,41,65,-24,38
Queen's Park,2309,9,7,10,19,40,72,-32,31
Albion,2309,10,8,6,22,59,81,-22,30
Ayr,2310,1,24,4,8,95,44,51,76
Raith,2310,2,22,9,5,69,33,36,75
Arbroath,2310,3,18,8,10,73,49,24,62
Alloa,2310,4,17,9,10,57,44,13,60
Stranraer,2310,5,15,5,16,56,66,-10,50
East Fife,2310,6,14,3,19,49,65,-16,45
Airdrieon,2310,7,10,11,15,46,61,-15,41
Forfar,2310,8,11,5,20,41,65,-24,38
Albion,2310,9,8,6,22,59,83,-24,30
Queen's Park,2310,10,6,10,20,40,75,-35,28
Ayr,2311,1,24,4,8,96,44,52,76
Raith,2311,2,22,8,6,69,34,35,74
Arbroath,2311,3,18,8,10,74,49,25,62
Alloa,2311,4,18,8,10,58,44,14,62
Stranraer,2311,5,16,5,15,57,64,-7,53
Airdrieon,2311,6,10,12,14,45,58,-13,42
East Fife,2311,7,13,3,20,47,66,-19,42
Forfar,2311,8,10,6,20,38,64,-26,36
Albion,2311,9,8,6,22,59,84,-25,30
Queen's Park,2311,10,6,10,20,40,76,-36,28
Raith,2312,1,23,8,5,71,34,37,77
Ayr,2312,2,24,4,8,92,43,49,76
Arbroath,2312,3,18,8,10,72,48,24,62
Alloa,2312,4,17,8,11,58,46,12,59
Stranraer,2312,5,15,6,15,57,66,-9,51
East Fife,2312,6,13,4,19,49,66,-17,43
Airdrieon,2312,7,10,12,14,45,58,-13,42
Forfar,2312,8,10,6,20,38,64,-26,36
Albion,2312,9,8,6,22,58,80,-22,30
Queen's Park,2312,10,6,10,20,39,74,-35,28
Ayr,2313,1,24,4,8,95,43,52,76
Raith,2313,2,22,9,5,70,34,36,75
Alloa,2313,3,17,9,10,58,45,13,60
Arbroath,2313,4,17,8,11,71,50,21,59
Stranraer,2313,5,15,5,16,55,67,-12,50
East Fife,2313,6,14,3,19,50,64,-14,45
Airdrieon,2313,7,11,11,14,47,58,-11,44
Forfar,2313,8,10,5,21,38,66,-28,35
Queen's Park,2313,9,7,10,19,41,73,-32,31
Albion,2313,10,8,6,22,58,83,-25,30
Raith,2314,1,22,9,5,69,33,36,75
Ayr,2314,2,23,4,9,91,45,46,73
Arbroath,2314,3,17,9,10,71,49,22,60
Alloa,2314,4,17,9,10,57,44,13,60
Stranraer,2314,5,16,5,15,57,64,-7,53
East Fife,2314,6,13,3,20,47,66,-19,42
Airdrieon,2314,7,10,11,15,46,60,-14,41
Forfar,2314,8,11,5,20,40,65,-25,38
Albion,2314,9,9,6,21,60,79,-19,33
Queen's Park,2314,10,6,11,19,40,73,-33,29
Raith,2315,1,22,9,5,70,34,36,75
Ayr,2315,2,23,4,9,90,44,46,73
Alloa,2315,3,17,9,10,58,45,13,60
Arbroath,2315,4,17,8,11,71,50,21,59
Stranraer,2315,5,15,6,15,57,66,-9,51
East Fife,2315,6,13,4,19,49,66,-17,43
Airdrieon,2315,7,10,11,15,47,61,-14,41
Forfar,2315,8,11,5,20,41,66,-25,38
Albion,2315,9,9,6,21,59,78,-19,33
Queen's Park,2315,10,7,10,19,41,73,-32,31
Raith,2316,1,23,8,5,70,32,38,77
Ayr,2316,2,24,4,8,94,44,50,76
Arbroath,2316,3,17,8,11,70,52,18,59
Alloa,2316,4,17,8,11,56,45,11,59
Stranraer,2316,5,15,5,16,55,66,-11,50
East Fife,2316,6,14,3,19,49,64,-15,45
Airdrieon,2316,7,10,11,15,46,61,-15,41
Forfar,2316,8,11,5,20,41,65,-24,38
Queen's Park,2316,9,7,10,19,43,72,-29,31
Albion,2316,10,8,6,22,59,82,-23,30
Raith,2317,1,23,8,5,73,32,41,77
Ayr,2317,2,24,4,8,95,43,52,76
Arbroath,2317,3,17,8,11,70,49,21,59
Alloa,2317,4,17,8,11,56,48,8,59
Stranraer,2317,5,15,6,15,57,66,-9,51
East Fife,2317,6,13,4,19,49,66,-17,43
Airdrieon,2317,7,10,11,15,46,61,-15,41
Forfar,2317,8,11,5,20,41,65,-24,38
Queen's Park,2317,9,7,10,19,40,72,-32,31
Albion,2317,10,8,6,22,58,83,-25,30
Raith,2318,1,23,8,5,70,33,37,77
Ayr,2318,2,24,4,8,94,42,52,76
Arbroath,2318,3,17,9,10,72,50,22,60
Alloa,2318,4,17,8,11,57,45,12,59
Stranraer,2318,5,15,6,15,55,64,-9,51
Airdrieon,2318,6,11,11,14,47,58,-11,44
East Fife,2318,7,13,4,19,47,64,-17,43
Forfar,2318,8,10,5,21,38,66,-28,35
Albion,2318,9,8,6,22,57,82,-25,30
Queen's Park,2318,10,6,11,19,41,74,-33,29
Raith,2319,1,23,8,5,70,32,38,77
Ayr,2319,2,24,4,8,93,43,50,76
Arbroath,2319,3,18,8,10,72,49,23,62
Alloa,2319,4,17,8,11,56,45,11,59
Stranraer,2319,5,16,5,15,56,64,-8,53
Airdrieon,2319,6,11,11,14,49,58,-9,44
East Fife,2319,7,13,3,20,47,65,-18,42
Forfar,2319,8,10,5,21,38,68,-30,35
Albion,2319,9,8,6,22,58,81,-23,30
Queen's Park,2319,10,6,10,20,40,74,-34,28
Ayr,2320,1,24,4,8,92,42,50,76
Raith,2320,2,22,8,6,68,33,35,74
Alloa,2320,3,18,8,10,57,43,14,62
Arbroath,2320,4,17,8,11,70,49,21,59
Stranraer,2320,5,15,5,16,56,67,-11,50
East Fife,2320,6,14,3,19,50,65,-15,45
Airdrieon,2320,7,10,12,14,48,61,-13,42
Forfar,2320,8,10,6,20,41,67,-26,36
Queen's Park,2320,9,7,10,19,40,72,-32,31
Albion,2320,10,8,6,22,57,80,-23,30
Raith,2321,1,23,8,5,70,33,37,77
Ayr,2321,2,23,5,8,92,44,48,74
Arbroath,2321,3,18,8,10,72,49,23,62
Alloa,2321,4,17,8,11,57,45,12,59
Stranraer,2321,5,16,5,15,60,66,-6,53
Airdrieon,2321,6,11,11,14,47,58,-11,44
East Fife,2321,7,13,3,20,49,69,-20,42
Forfar,2321,8,10,5,21,38,66,-28,35
Albion,2321,9,8,7,21,59,80,-21,31
Queen's Park,2321,10,6,10,20,40,74,-34,28
Raith,2322,1,23,8,5,72,34,38,77
Ayr,2322,2,24,4,8,93,42,51,76
Arbroath,2322,3,17,9,10,72,50,22,60
Alloa,2322,4,17,8,11,58,47,11,59
Stranraer,2322,5,16,5,15,58,64,-6,53
Airdrieon,2322,6,11,11,14,48,59,-11,44
East Fife,2322,7,13,3,20,47,67,-20,42
Forfar,2322,8,10,5,21,39,67,-28,35
Albion,2322,9,8,6,22,57,81,-24,30
Queen's Park,2322,10,6,11,19,41,74,-33,29
Ayr,2323,1,24,4,8,96,44,52,76
Raith,2323,2,22,9,5,68,32,36,75
Alloa,2323,3,17,9,10,56,43,13,60
Arbroath,2323,4,17,8,11,70,50,20,59
Stranraer,2323,5,15,6,15,57,66,-9,51
Airdrieon,2323,6,11,11,14,47,58,-11,44
East Fife,2323,7,13,4,19,49,66,-17,43
Forfar,2323,8,10,5,21,38,66,-28,35
Queen's Park,2323,9,7,10,19,41,72,-31,31
Albion,2323,10,8,6,22,59,84,-25,30
Ayr,2324,1,24,4,8,92,43,49,76
Raith,2324,2,22,9,5,69,33,36,75
Arbroath,2324,3,18,8,10,72,49,23,62
Alloa,2324,4,17,9,10,57,44,13,60
Stranraer,2324,5,15,5,16,55,67,-12,50
East Fife,2324,6,14,3,19,50,64,-14,45
Airdrieon,2324,7,10,12,14,46,59,-13,42
Forfar,2324,8,10,6,20,39,65,-26,36
Albion,2324,9,8,6,22,58,80,-22,30
Queen's Park,2324,10,6,10,20,40,74,-34,28
Raith,2325,1,23,8,5,69,32,37,77
Ayr,2325,2,24,4,8,92,43,49,76
Arbroath,2325,3,17,9,10,72,50,22,60
Alloa,2325,4,17,8,11,56,44,12,59
Stranraer,2325,5,15,5,16,59,71,-12,50
East Fife,2325,6,14,3,19,54,68,-14,45
Airdrieon,2325,7,10,11,15,47,62,-15,41
Forfar,2325,8,11,5,20,42,66,-24,38
Albion,2325,9,8,6,22,58,80,-22,30
Queen's Park,2325,10,6,11,19,41,74,-33,29
Ayr,2326,1,24,4,8,94,42,52,76
Raith,2326,2,22,9,5,68,32,36,75
Arbroath,2326,3,18,8,10,71,48,23,62
Alloa,2326,4,17,9,10,56,43,13,60
Stranraer,2326,5,15,5,16,55,66,-11,50
East Fife,2326,6,14,3,19,49,64,-15,45
Airdrieon,2326,7,11,11,14,48,58,-10,44
Forfar,2326,8,10,5,21,38,67,-29,35
Albion,2326,9,8,6,22,57,82,-25,30
Queen's Park,2326,10,6,10,20,39,73,-34,28
Raith,2327,1,23,8,5,70,33,37,77
Ayr,2327,2,24,4,8,93,43,50,76
Arbroath,2327,3,17,8,11,70,49,21,59
Alloa,2327,4,17,8,11,57,45,12,59
Stranraer,2327,5,15,6,15,56,65,-9,51
East Fife,2327,6,13,4,19,48,65,-17,43
Airdrieon,2327,7,10,11,15,45,60,-15,41
Forfar,2327,8,11,5,20,40,64,-24,38
Queen's Park,2327,9,7,10,19,40,72,-32,31
Albion,2327,10,8,6,22,58,81,-23,30
Ayr,2328,1,24,4,8,94,42,52,76
Raith,2328,2,22,8,6,68,33,35,74
Alloa,2328,3,18,8,10,57,43,14,62
Arbroath,2328,4,17,8,11,70,51,19,59
Stranraer,2328,5,15,5,16,56,66,-10,50
East Fife,2328,6,14,3,19,49,65,-16,45
Airdrieon,2328,7,11,11,14,46,58,-12,44
Forfar,2328,8,10,5,21,38,65,-27,35
Queen's Park,2328,9,7,10,19,42,72,-30,31
Albion,2328,10,8,6,22,57,82,-25,30
Ayr,2329,1,24,4,8,95,42,53,76
Raith,2329,2,22,8,6,69,34,35,74
Alloa,2329,3,18,8,10,58,44,14,62
Arbroath,2329,4,17,8,11,71,50,21,59
Stranraer,2329,5,15,5,16,56,68,-12,50
East Fife,2329,6,14,3,19,51,65,-14,45
Airdrieon,2329,7,10,11,15,46,60,-14,41
Forfar,2329,8,11,5,20,40,65,-25,38
Queen's Park,2329,9,7,10,19,41,73,-32,31
Albion,2329,10,8,6,22,57,83,-26,30
Raith,2330,1,23,8,5,72,33,39,77
Ayr,2330,2,24,4,8,96,43,53,76
Arbroath,2330,3,17,9,10,71,49,22,60
Alloa,2330,4,17,8,11,57,47,10,59
Stranraer,2330,5,15,6,15,57,66,-9,51
Airdrieon,2330,6,11,11,14,51,58,-7,44
East Fife,2330,7,13,4,19,49,66,-17,43
Forfar,2330,8,10,5,21,38,70,-32,35
Albion,2330,9,8,6,22,58,84,-26,30
Queen's Park,2330,10,6,11,19,40,73,-33,29
Ayr,2331,1,24,4,8,94,42,52,76
Raith,2331,2,22,9,5,69,33,36,75
Arbroath,2331,3,18,8,10,72,49,23,62
Alloa,2331,4,17,9,10,57,44,13,60
Stranraer,2331,5,15,6,15,55,64,-9,51
Airdrieon,2331,6,11,11,14,47,59,-12,44
East Fife,2331,7,13,4,19,47,64,-17,43
Forfar,2331,8,10,5,21,39,66,-27,35
Albion,2331,9,8,6,22,57,82,-25,30
Queen's Park,2331,10,6,10,20,40,74,-34,28
Ayr,2332,1,24,4,8,96,43,53,76
Raith,2332,2,22,9,5,70,34,36,75
Arbroath,2332,3,18,8,10,75,49,26,62
Alloa,2332,4,17,9,10,58,45,13,60
Stranraer,2332,5,16,5,15,59,66,-7,53
Airdrieon,2332,6,11,11,14,46,58,-12,44
East Fife,2332,7,13,3,20,49,68,-19,42
Forfar,2332,8,10,5,21,38,65,-27,35
Albion,2332,9,8,6,22,58,84,-26,30
Queen's Park,2332,10,6,10,20,40,77,-37,28
Ayr,2333,1,23,5,8,93,45,48,74
Raith,2333,2,22,8,6,71,36,35,74
Arbroath,2333,3,18,8,10,73,48,25,62
Alloa,2333,4,18,8,10,60,46,14,62
Stranraer,2333,5,15,5,16,57,68,-11,50
East Fife,2333,6,14,3,19,51,66,-15,45
Airdrieon,2333,7,11,11,14,46,58,-12,44
Forfar,2333,8,10,5,21,38,65,-27,35
Albion,2333,9,8,7,21,60,81,-21,31
Queen's Park,2333,10,6,10,20,39,75,-36,28
Raith,2334,1,23,8,5,70,33,37,77
Ayr,2334,2,24,4,8,99,43,56,76
Arbroath,2334,3,18,8,10,73,50,23,62
Alloa,2334,4,17,8,11,57,45,12,59
Stranraer,2334,5,15,6,15,56,65,-9,51
Airdrieon,2334,6,11,11,14,48,58,-10,44
East Fife,2334,7,13,4,19,48,65,-17,43
Forfar,2334,8,10,5,21,38,67,-29,35
Albion,2334,9,8,6,22,58,87,-29,30
Queen's Park,2334,10,6,10,20,41,75,-34,28
Ayr,2335,1,24,4,8,94,42,52,76
Raith,2335,2,22,8,6,70,36,34,74
Alloa,2335,3,18,8,10,60,45,15,62
Arbroath,2335,4,17,9,10,72,50,22,60
Stranraer,2335,5,15,6,15,56,65,-9,51
Airdrieon,2335,6,11,11,14,48,58,-10,44
East Fife,2335,7,13,4,19,48,65,-17,43
Forfar,2335,8,10,5,21,38,67,-29,35
Albion,2335,9,8,6,22,57,82,-25,30
Queen's Park,2335,10,6,11,19,41,74,-33,29
Raith,2336,1,23,8,5,70,32,38,77
Ayr,2336,2,23,4,9,91,44,47,73
Arbroath,2336,3,18,8,10,72,48,24,62
Alloa,2336,4,17,8,11,56,45,11,59
Stranraer,2336,5,15,5,16,55,65,-10,50
East Fife,2336,6,14,3,19,48,64,-16,45
Airdrieon,2336,7,11,11,14,49,58,-9,44
Forfar,2336,8,10,5,21,38,68,-30,35
Albion,2336,9,9,6,21,59,79,-20,33
Queen's Park,2336,10,6,10,20,39,74,-35,28
Raith,2337,1,23,8,5,71,32,39,77
Ayr,2337,2,24,4,8,95,43,52,76
Arbroath,2337,3,17,8,11,70,49,21,59
Alloa,2337,4,17,8,11,56,46,10,59
Stranraer,2337,5,16,5,15,57,64,-7,53
Airdrieon,2337,6,11,11,14,47,58,-11,44
East Fife,2337,7,13,3,20,47,66,-19,42
Forfar,2337,8,10,5,21,38,66,-28,35
Queen's Park,2337,9,7,10,19,40,72,-32,31
Albion,2337,10,8,6,22,58,83,-25,30
Raith,2338,1,23,8,5,70,32,38,77
Ayr,2338,2,24,4,8,97,42,55,76
Arbroath,2338,3,18,8,10,71,48,23,62
Alloa,2338,4,17,8,11,56,45,11,59
Stranraer,2338,5,15,5,16,55,66,-11,50
East Fife,2338,6,14,3,19,49,64,-15,45
Airdrieon,2338,7,11,11,14,47,59,-12,44
Forfar,2338,8,10,5,21,39,66,-27,35
Albion,2338,9,8,6,22,57,85,-28,30
Queen's Park,2338,10,6,10,20,39,73,-34,28
Ayr,2339,1,24,4,8,94,43,51,76
Raith,2339,2,22,8,6,69,34,35,74
Alloa,2339,3,18,8,10,58,44,14,62
Arbroath,2339,4,17,8,11,71,52,19,59
Stranraer,2339,5,15,5,16,56,66,-10,50
East Fife,2339,6,14,3,19,49,65,-16,45
Airdrieon,2339,7,11,11,14,46,58,-12,44
Forfar,2339,8,10,5,21,38,65,-27,35
Queen's Park,2339,9,7,10,19,43,73,-30,31
Albion,2339,10,8,6,22,58,82,-24,30
Raith,2340,1,23,8,5,69,32,37,77
Ayr,2340,2,24,4,8,93,43,50,76
Arbroath,2340,3,17,9,10,72,50,22,60
Alloa,2340,4,17,8,11,56,44,12,59
Stranraer,2340,5,15,6,15,55,64,-9,51
Airdrieon,2340,6,11,11,14,47,59,-12,44
East Fife,2340,7,13,4,19,47,64,-17,43
Forfar,2340,8,10,5,21,39,66,-27,35
Albion,2340,9,8,6,22,58,81,-23,30
Queen's Park,2340,10,6,11,19,41,74,-33,29
Raith,2341,1,23,8,5,71,32,39,77
Ayr,2341,2,24,4,8,96,42,54,76
Arbroath,2341,3,18,8,10,74,50,24,62
Alloa,2341,4,17,8,11,56,46,10,59
Stranraer,2341,5,15,6,15,59,68,-9,51
East Fife,2341,6,13,4,19,51,68,-17,43
Airdrieon,2341,7,10,12,14,45,58,-13,42
Forfar,2341,8,10,6,20,38,64,-26,36
Albion,2341,9,8,6,22,57,84,-27,30
Queen's Park,2341,10,6,10,20,41,76,-35,28
Raith,2342,1,23,8,5,71,32,39,77
Ayr,2342,2,24,4,8,94,42,52,76
Arbroath,2342,3,17,9,10,72,50,22,60
Alloa,2342,4,17,8,11,56,46,10,59
Stranraer,2342,5,15,5,16,55,69,-14,50
East Fife,2342,6,14,3,19,52,64,-12,45
Airdrieon,2342,7,11,11,14,46,58,-12,44
Forfar,2342,8,10,5,21,38,65,-27,35
Albion,2342,9,8,6,22,57,82,-25,30
Queen's Park,2342,10,6,11,19,41,74,-33,29
Raith,2343,1,23,8,5,69,32,37,77
Ayr,2343,2,23,5,8,93,45,48,74
Arbroath,2343,3,17,8,11,70,49,21,59
Alloa,2343,4,17,8,11,56,44,12,59
Stranraer,2343,5,16,5,15,58,65,-7,53
Airdrieon,2343,6,10,12,14,47,60,-13,42
East Fife,2343,7,13,3,20,48,67,-19,42
Forfar,2343,8,10,6,20,40,66,-26,36
Albion,2343,9,8,7,21,60,81,-21,31
Queen's Park,2343,10,7,10,19,40,72,-32,31
Raith,2344,1,23,8,5,71,33,38,77
Ayr,2344,2,24,4,8,93,42,51,76
Arbroath,2344,3,18,8,10,74,49,25,62
Alloa,2344,4,17,8,11,57,46,11,59
Stranraer,2344,5,15,5,16,56,68,-12,50
East Fife,2344,6,14,3,19,51,65,-14,45
Airdrieon,2344,7,10,11,15,45,61,-16,41
Forfar,2344,8,11,5,20,41,64,-23,38
Albion,2344,9,8,6,22,57,81,-24,30
Queen's Park,2344,10,6,10,20,40,76,-36,28
Raith,2345,1,23,8,5,71,32,39,77
Ayr,2345,2,23,5,8,92,44,48,74
Arbroath,2345,3,17,9,10,71,49,22,60
Alloa,2345,4,17,8,11,56,46,10,59
Stranraer,2345,5,15,5,16,56,67,-11,50
East Fife,2345,6,14,3,19,50,65,-15,45
Airdrieon,2345,7,10,12,14,46,59,-13,42
Forfar,2345,8,10,6,20,39,65,-26,36
Albion,2345,9,8,7,21,59,80,-21,31
Queen's Park,2345,10,6,11,19,40,73,-33,29
Raith,2346,1,23,8,5,70,32,38,77
Ayr,2346,2,24,4,8,97,44,53,76
Arbroath,2346,3,17,9,10,74,52,22,60
Alloa,2346,4,17,8,11,56,45,11,59
Stranraer,2346,5,15,5,16,56,68,-12,50
East Fife,2346,6,14,3,19,51,65,-14,45
Airdrieon,2346,7,10,12,14,45,58,-13,42
Forfar,2346,8,10,6,20,38,64,-26,36
Albion,2346,9,8,6,22,59,85,-26,30
Queen's Park,2346,10,6,11,19,43,76,-33,29
Raith,2347,1,23,8,5,69,32,37,77
Ayr,2347,2,24,4,8,97,44,53,76
Arbroath,2347,3,18,8,10,71,48,23,62
Alloa,2347,4,17,8,11,56,44,12,59
Stranraer,2347,5,15,6,15,56,65,-9,51
East Fife,2347,6,13,4,19,48,65,-17,43
Airdrieon,2347,7,10,11,15,46,60,-14,41
Forfar,2347,8,11,5,20,40,65,-25,38
Albion,2347,9,8,6,22,59,85,-26,30
Queen's Park,2347,10,6,10,20,39,73,-34,28
Raith,2348,1,23,8,5,72,33,39,77
Ayr,2348,2,24,4,8,95,43,52,76
Arbroath,2348,3,17,8,11,70,50,20,59
Alloa,2348,4,17,8,11,57,47,10,59
Stranraer,2348,5,15,5,16,57,68,-11,50
East Fife,2348,6,14,3,19,51,66,-15,45
Airdrieon,2348,7,10,12,14,46,59,-13,42
Forfar,2348,8,10,6,20,39,65,-26,36
Queen's Park,2348,9,7,10,19,41,72,-31,31
Albion,2348,10,8,6,22,58,83,-25,30
Raith,2349,1,23,8,5,70,32,38,77
Ayr,2349,2,24,4,8,94,43,51,76
Arbroath,2349,3,17,9,10,72,50,22,60
Alloa,2349,4,17,8,11,56,45,11,59
Stranraer,2349,5,16,5,15,58,66,-8,53
East Fife,2349,6,13,3,20,49,67,-18,42
Airdrieon,2349,7,10,11,15,45,61,-16,41
Forfar,2349,8,11,5,20,41,64,-23,38
Albion,2349,9,8,6,22,58,82,-24,30
Queen's Park,2349,10,6,11,19,41,74,-33,29
Ayr,2350,1,24,4,8,91,42,49,76
Raith,2350,2,22,9,5,68,32,36,75
Arbroath,2350,3,17,9,10,72,50,22,60
Alloa,2350,4,17,9,10,56,43,13,60
Stranraer,2350,5,16,5,15,57,65,-8,53
Airdrieon,2350,6,10,12,14,46,59,-13,42
East Fife,2350,7,13,3,20,48,66,-18,42
Forfar,2350,8,10,6,20,39,65,-26,36
Albion,2350,9,8,6,22,57,79,-22,30
Queen's Park,2350,10,6,11,19,41,74,-33,29
Raith,2351,1,22,8,6,69,35,34,74
Ayr,2351,2,23,4,9,91,44,47,73
Arbroath,2351,3,18,8,10,76,51,25,62
Alloa,2351,4,18,8,10,59,44,15,62
Stranraer,2351,5,16,5,15,56,64,-8,53
Airdrieon,2351,6,10,12,14,45,58,-13,42
East Fife,2351,7,13,3,20,47,65,-18,42
Forfar,2351,8,10,6,20,38,64,-26,36
Albion,2351,9,9,6,21,59,79,-20,33
Queen's Park,2351,10,6,10,20,42,78,-36,28
Raith,2352,1,23,8,5,69,32,37,77
Ayr,2352,2,24,4,8,94,43,51,76
Arbroath,2352,3,18,8,10,74,48,26,62
Alloa,2352,4,17,8,11,56,44,12,59
Stranraer,2352,5,16,5,15,56,64,-8,53
Airdrieon,2352,6,11,11,14,46,58,-12,44
East Fife,2352,7,13,3,20,47,65,-18,42
Forfar,2352,8,10,5,21,38,65,-27,35
Albion,2352,9,8,6,22,58,82,-24,30
Queen's Park,2352,10,6,10,20,39,76,-37,28
Ayr,2353,1,24,4,8,95,45,50,76
Raith,2353,2,22,8,6,68,34,34,74
Alloa,2353,3,18,8,10,58,43,15,62
Arbroath,2353,4,17,8,11,71,51,20,59
Stranraer,2353,5,15,5,16,55,65,-10,50
East Fife,2353,6,14,3,19,48,64,-16,45
Airdrieon,2353,7,11,11,14,48,58,-10,44
Forfar,2353,8,10,5,21,38,67,-29,35
Queen's Park,2353,9,7,10,19,42,73,-31,31
Albion,2353,10,8,6,22,60,83,-23,30
Raith,2354,1,23,8,5,70,32,38,77
Ayr,2354,2,24,4,8,99,46,53,76
Arbroath,2354,3,18,8,10,74,48,26,62
Alloa,2354,4,17,8,11,56,45,11,59
Stranraer,2354,5,15,6,15,56,65,-9,51
Airdrieon,2354,6,11,11,14,48,58,-10,44
East Fife,2354,7,13,4,19,48,65,-17,43
Forfar,2354,8,10,5,21,38,67,-29,35
Albion,2354,9,8,6,22,61,87,-26,30
Queen's Park,2354,10,6,10,20,39,76,-37,28
Raith,2355,1,23,8,5,70,32,38,77
Ayr,2355,2,24,4,8,95,43,52,76
Arbroath,2355,3,18,8,10,74,48,26,62
Alloa,2355,4,17,8,11,56,45,11,59
Stranraer,2355,5,15,5,16,56,69,-13,50
East Fife,2355,6,14,3,19,52,65,-13,45
Airdrieon,2355,7,11,11,14,48,58,-10,44
Forfar,2355,8,10,5,21,38,67,-29,35
Albion,2355,9,8,6,22,58,83,-25,30
Queen's Park,2355,10,6,10,20,39,76,-37,28
Raith,2356,1,23,8,5,72,32,40,77
Ayr,2356,2,24,4,8,94,44,50,76
Arbroath,2356,3,18,8,10,73,49,24,62
Alloa,2356,4,17,8,11,56,47,9,59
Stranraer,2356,5,15,5,16,55,68,-13,50
East Fife,2356,6,14,3,19,51,64,-13,45
Airdrieon,2356,7,10,11,15,47,62,-15,41
Forfar,2356,8,11,5,20,42,66,-24,38
Albion,2356,9,8,6,22,59,82,-23,30
Queen's Park,2356,10,6,10,20,40,75,-35,28
Raith,2357,1,23,8,5,70,32,38,77
Ayr,2357,2,24,4,8,93,42,51,76
Arbroath,2357,3,17,8,11,72,51,21,59
Alloa,2357,4,17,8,11,56,45,11,59
Stranraer,2357,5,16,5,15,56,64,-8,53
Airdrieon,2357,6,11,11,14,48,60,-12,44
East Fife,2357,7,13,3,20,47,65,-18,42
Forfar,2357,8,10,5,21,40,67,-27,35
Queen's Park,2357,9,7,10,19,42,74,-32,31
Albion,2357,10,8,6,22,57,81,-24,30
Ayr,2358,1,24,4,8,94,42,52,76
Raith,2358,2,22,9,5,68,32,36,75
Arbroath,2358,3,18,8,10,74,49,25,62
Alloa,2358,4,17,9,10,56,43,13,60
Stranraer,2358,5,15,5,16,55,69,-14,50
East Fife,2358,6,14,3,19,52,64,-12,45
Airdrieon,2358,7,11,11,14,48,59,-11,44
Forfar,2358,8,10,5,21,39,67,-28,35
Albion,2358,9,8,6,22,57,82,-25,30
Queen's Park,2358,10,6,10,20,40,76,-36,28
Ayr,2359,1,24,4,8,93,44,49,76
Raith,2359,2,22,9,5,69,33,36,75
Arbroath,2359,3,18,8,10,71,48,23,62
Alloa,2359,4,17,9,10,57,44,13,60
Stranraer,2359,5,16,5,15,58,66,-8,53
Airdrieon,2359,6,11,11,14,48,59,-11,44
East Fife,2359,7,13,3,20,49,67,-18,42
Forfar,2359,8,10,5,21,39,67,-28,35
Albion,2359,9,8,6,22,59,81,-22,30
Queen's Park,2359,10,6,10,20,39,73,-34,28
Raith,2360,1,22,9,5,69,33,36,75
Ayr,2360,2,23,4,9,92,45,47,73
Arbroath,2360,3,17,9,10,70,48,22,60
Alloa,2360,4,17,9,10,57,44,13,60
Stranraer,2360,5,15,5,16,57,67,-10,50
East Fife,2360,6,14,3,19,50,66,-16,45
Airdrieon,2360,7,11,11,14,46,58,-12,44
Forfar,2360,8,10,5,21,38,65,-27,35
Albion,2360,9,9,6,21,60,80,-20,33
Queen's Park,2360,10,6,11,19,39,72,-33,29
Ayr,2361,1,24,4,8,94,44,50,76
Raith,2361,2,22,9,5,70,34,36,75
Arbroath,2361,3,18,8,10,73,50,23,62
Alloa,2361,4,17,9,10,58,45,13,60
Stranraer,2361,5,16,5,15,61,66,-5,53
Airdrieon,2361,6,10,12,14,48,61,-13,42
East Fife,2361,7,13,3,20,49,70,-21,42
Forfar,2361,8,10,6,20,41,67,-26,36
Albion,2361,9,8,6,22,59,82,-23,30
Queen's Park,2361,10,6,10,20,41,75,-34,28
Ayr,2362,1,24,4,8,94,42,52,76
Raith,2362,2,22,8,6,68,35,33,74
Alloa,2362,3,18,8,10,59,43,16,62
Arbroath,2362,4,17,8,11,73,52,21,59
Stranraer,2362,5,15,6,15,56,65,-9,51
Airdrieon,2362,6,11,11,14,47,59,-12,44
East Fife,2362,7,13,4,19,48,65,-17,43
Forfar,2362,8,10,5,21,39,66,-27,35
Queen's Park,2362,9,7,10,19,43,75,-32,31
Albion,2362,10,8,6,22,57,82,-25,30
Raith,2363,1,23,8,5,71,33,38,77
Ayr,2363,2,24,4,8,93,43,50,76
Arbroath,2363,3,18,8,10,75,50,25,62
Alloa,2363,4,17,8,11,57,46,11,59
Stranraer,2363,5,15,5,16,55,67,-12,50
East Fife,2363,6,14,3,19,50,64,-14,45
Airdrieon,2363,7,10,12,14,45,58,-13,42
Forfar,2363,8,10,6,20,38,64,-26,36
Albion,2363,9,8,6,22,58,81,-23,30
Queen's Park,2363,10,6,10,20,41,77,-36,28
Raith,2364,1,23,8,5,69,32,37,77
Ayr,2364,2,24,4,8,93,42,51,76
Arbroath,2364,3,18,8,10,73,50,23,62
Alloa,2364,4,17,8,11,56,44,12,59
Stranraer,2364,5,15,6,15,58,67,-9,51
Airdrieon,2364,6,11,11,14,46,58,-12,44
East Fife,2364,7,13,4,19,50,67,-17,43
Forfar,2364,8,10,5,21,38,65,-27,35
Albion,2364,9,8,6,22,57,81,-24,30
Queen's Park,2364,10,6,10,20,41,75,-34,28
Raith,2365,1,23,8,5,69,32,37,77
Ayr,2365,2,24,4,8,94,42,52,76
Arbroath,2365,3,18,8,10,72,49,23,62
Alloa,2365,4,17,8,11,56,44,12,59
Stranraer,2365,5,16,5,15,57,64,-7,53
East Fife,2365,6,13,3,20,47,66,-19,42
Airdrieon,2365,7,10,11,15,46,61,-15,41
Forfar,2365,8,11,5,20,41,65,-24,38
Albion,2365,9,8,6,22,57,82,-25,30
Queen's Park,2365,10,6,10,20,40,74,-34,28
Raith,2366,1,23,8,5,69,32,37,77
Ayr,2366,2,24,4,8,100,42,58,76
Arbroath,2366,3,17,8,11,72,51,21,59
Alloa,2366,4,17,8,11,56,44,12,59
Stranraer,2366,5,15,6,15,56,65,-9,51
Airdrieon,2366,6,11,11,14,49,60,-11,44
East Fife,2366,7,13,4,19,48,65,-17,43
Forfar,2366,8,10,5,21,40,68,-28,35
Queen's Park,2366,9,7,10,19,42,74,-32,31
Albion,2366,10,8,6,22,57,88,-31,30
Raith,2367,1,23,8,5,70,33,37,77
Ayr,2367,2,24,4,8,97,42,55,76
Arbroath,2367,3,18,8,10,73,49,24,62
Alloa,2367,4,17,8,11,57,45,12,59
Stranraer,2367,5,15,5,16,55,65,-10,50
East Fife,2367,6,14,3,19,48,64,-16,45
Airdrieon,2367,7,11,11,14,48,59,-11,44
Forfar,2367,8,10,5,21,39,67,-28,35
Albion,2367,9,8,6,22,57,85,-28,30
Queen's Park,2367,10,6,10,20,40,75,-35,28
Raith,2368,1,23,8,5,70,32,38,77
Ayr,2368,2,24,4,8,91,42,49,76
Arbroath,2368,3,17,9,10,73,51,22,60
Alloa,2368,4,17,8,11,56,45,11,59
Stranraer,2368,5,15,5,16,56,66,-10,50
East Fife,2368,6,14,3,19,49,65,-16,45
Airdrieon,2368,7,11,11,14,48,59,-11,44
Forfar,2368,8,10,5,21,39,67,-28,35
Albion,2368,9,8,6,22,57,79,-22,30
Queen's Park,2368,10,6,11,19,42,75,-33,29
Raith,2369,1,23,8,5,73,33,40,77
Ayr,2369,2,24,4,8,95,42,53,76
Arbroath,2369,3,18,8,10,72,49,23,62
Alloa,2369,4,17,8,11,57,48,9,59
Stranraer,2369,5,16,5,15,57,64,-7,53
Airdrieon,2369,6,11,11,14,49,58,-9,44
East Fife,2369,7,13,3,20,47,66,-19,42
Forfar,2369,8,10,5,21,38,68,-30,35
Albion,2369,9,8,6,22,57,83,-26,30
Queen's Park,2369,10,6,10,20,40,74,-34,28
Ayr,2370,1,24,4,8,96,44,52,76
Raith,2370,2,22,8,6,68,36,32,74
Alloa,2370,3,18,8,10,60,43,17,62
Arbroath,2370,4,17,9,10,72,50,22,60
Stranraer,2370,5,15,6,15,56,65,-9,51
Airdrieon,2370,6,11,11,14,46,58,-12,44
East Fife,2370,7,13,4,19,48,65,-17,43
Forfar,2370,8,10,5,21,38,65,-27,35
Albion,2370,9,8,6,22,59,84,-25,30
Queen's Park,2370,10,6,11,19,41,74,-33,29
Ayr,2371,1,24,4,8,93,44,49,76
Raith,2371,2,22,8,6,68,33,35,74
Arbroath,2371,3,18,8,10,72,49,23,62
Alloa,2371,4,18,8,10,57,43,14,62
Stranraer,2371,5,16,5,15,57,64,-7,53
Airdrieon,2371,6,11,11,14,47,58,-11,44
East Fife,2371,7,13,3,20,47,66,-19,42
Forfar,2371,8,10,5,21,38,66,-28,35
Albion,2371,9,8,6,22,59,81,-22,30
Queen's Park,2371,10,6,10,20,40,74,-34,28
Raith,2372,1,23,8,5,70,32,38,77
Ayr,2372,2,24,4,8,95,44,51,76
Arbroath,2372,3,18,8,10,73,48,25,62
Alloa,2372,4,17,8,11,56,45,11,59
Stranraer,2372,5,15,5,16,56,67,-11,50
East Fife,2372,6,14,3,19,50,65,-15,45
Airdrieon,2372,7,11,11,14,48,58,-10,44
Forfar,2372,8,10,5,21,38,67,-29,35
Albion,2372,9,8,6,22,59,83,-24,30
Queen's Park,2372,10,6,10,20,39,75,-36,28
Raith,2373,1,23,8,5,70,33,37,77
Ayr,2373,2,24,4,8,91,42,49,76
Arbroath,2373,3,17,9,10,72,50,22,60
Alloa,2373,4,17,8,11,57,45,12,59
Stranraer,2373,5,16,5,15,56,64,-8,53
East Fife,2373,6,13,3,20,47,65,-18,42
Airdrieon,2373,7,10,11,15,45,59,-14,41
Forfar,2373,8,11,5,20,39,64,-25,38
Albion,2373,9,8,6,22,57,79,-22,30
Queen's Park,2373,10,6,11,19,41,74,-33,29
Raith,2374,1,23,8,5,71,32,39,77
Ayr,2374,2,24,4,8,94,44,50,76
Arbroath,2374,3,18,8,10,72,49,23,62
Alloa,2374,4,17,8,11,56,46,10,59
Stranraer,2374,5,15,6,15,56,65,-9,51
Airdrieon,2374,6,11,11,14,46,58,-12,44
East Fife,2374,7,13,4,19,48,65,-17,43
Forfar,2374,8,10,5,21,38,65,-27,35
Albion,2374,9,8,6,22,59,82,-23,30
Queen's Park,2374,10,6,10,20,40,74,-34,28
Raith,2375,1,22,9,5,70,34,36,75
Ayr,2375,2,23,4,9,90,44,46,73
Alloa,2375,3,17,9,10,58,45,13,60
Arbroath,2375,4,17,8,11,72,51,21,59
Stranraer,2375,5,16,5,15,56,64,-8,53
East Fife,2375,6,13,3,20,47,65,-18,42
Airdrieon,2375,7,10,11,15,46,60,-14,41
Forfar,2375,8,11,5,20,40,65,-25,38
Albion,2375,9,9,6,21,59,78,-19,33
Queen's Park,2375,10,7,10,19,42,74,-32,31
Ayr,2376,1,24,4,8,94,43,51,76
Raith,2376,2,22,8,6,68,33,35,74
Arbroath,2376,3,18,8,10,72,48,24,62
Alloa,2376,4,18,8,10,57,43,14,62
Stranraer,2376,5,15,5,16,56,67,-11,50
East Fife,2376,6,14,3,19,50,65,-15,45
Airdrieon,2376,7,11,11,14,46,58,-12,44
Forfar,2376,8,10,5,21,38,65,-27,35
Albion,2376,9,8,6,22,58,82,-24,30
Queen's Park,2376,10,6,10,20,39,74,-35,28
Ayr,2377,1,24,4,8,98,43,55,76
Raith,2377,2,22,9,5,69,33,36,75
Arbroath,2377,3,17,9,10,72,50,22,60
Alloa,2377,4,17,9,10,57,44,13,60
Stranraer,2377,5,15,5,16,57,67,-10,50
East Fife,2377,6,14,3,19,50,66,-16,45
Airdrieon,2377,7,10,11,15,45,59,-14,41
Forfar,2377,8,11,5,20,39,64,-25,38
Albion,2377,9,8,6,22,58,86,-28,30
Queen's Park,2377,10,6,11,19,41,74,-33,29
Raith,2378,1,23,8,5,70,33,37,77
Ayr,2378,2,24,4,8,94,42,52,76
Arbroath,2378,3,18,8,10,72,48,24,62
Alloa,2378,4,17,8,11,57,45,12,59
Stranraer,2378,5,15,6,15,56,65,-9,51
Airdrieon,2378,6,11,11,14,47,59,-12,44
East Fife,2378,7,13,4,19,48,65,-17,43
Forfar,2378,8,10,5,21,39,66,-27,35
Albion,2378,9,8,6,22,57,82,-25,30
Queen's Park,2378,10,6,10,20,39,74,-35,28
Raith,2379,1,23,8,5,70,32,38,77
Ayr,2379,2,24,4,8,94,43,51,76
Arbroath,2379,3,17,8,11,73,53,20,59
Alloa,2379,4,17,8,11,56,45,11,59
Stranraer,2379,5,15,5,16,55,66,-11,50
East Fife,2379,6,14,3,19,49,64,-15,45
Airdrieon,2379,7,11,11,14,47,58,-11,44
Forfar,2379,8,10,5,21,38,66,-28,35
Queen's Park,2379,9,7,10,19,44,75,-31,31
Albion,2379,10,8,6,22,58,82,-24,30
Raith,2380,1,22,9,5,68,32,36,75
Ayr,2380,2,23,4,9,91,46,45,73
Arbroath,2380,3,18,8,10,71,48,23,62
Alloa,2380,4,17,9,10,56,43,13,60
Stranraer,2380,5,15,6,15,57,66,-9,51
Airdrieon,2380,6,11,11,14,47,58,-11,44
East Fife,2380,7,13,4,19,49,66,-17,43
Forfar,2380,8,10,5,21,38,66,-28,35
Albion,2380,9,9,6,21,61,79,-18,33
Queen's Park,2380,10,6,10,20,39,73,-34,28
Ayr,2381,1,24,4,8,95,44,51,76
Raith,2381,2,22,8,6,71,36,35,74
Alloa,2381,3,18,8,10,60,46,14,62
Arbroath,2381,4,17,8,11,73,52,21,59
Stranraer,2381,5,15,5,16,57,67,-10,50
East Fife,2381,6,14,3,19,50,66,-16,45
Airdrieon,2381,7,11,11,14,47,58,-11,44
Forfar,2381,8,10,5,21,38,66,-28,35
Queen's Park,2381,9,7,10,19,43,75,-32,31
Albion,2381,10,8,6,22,59,83,-24,30
Ayr,2382,1,24,4,8,94,45,49,76
Raith,2382,2,22,9,5,68,32,36,75
Arbroath,2382,3,18,8,10,72,48,24,62
Alloa,2382,4,17,9,10,56,43,13,60
Stranraer,2382,5,15,5,16,56,67,-11,50
East Fife,2382,6,14,3,19,50,65,-15,45
Airdrieon,2382,7,10,12,14,46,59,-13,42
Forfar,2382,8,10,6,20,39,65,-26,36
Albion,2382,9,8,6,22,60,82,-22,30
Queen's Park,2382,10,6,10,20,39,74,-35,28
Raith,2383,1,23,8,5,72,33,39,77
Ayr,2383,2,23,4,9,93,47,46,73
Arbroath,2383,3,18,8,10,71,48,23,62
Alloa,2383,4,17,8,11,57,47,10,59
Stranraer,2383,5,15,6,15,57,66,-9,51
Airdrieon,2383,6,11,11,14,48,59,-11,44
East Fife,2383,7,13,4,19,49,66,-17,43
Forfar,2383,8,10,5,21,39,67,-28,35
Albion,2383,9,9,6,21,62,81,-19,33
Queen's Park,2383,10,6,10,20,39,73,-34,28
Raith,2384,1,23,8,5,69,32,37,77
Ayr,2384,2,24,4,8,95,43,52,76
Arbroath,2384,3,18,8,10,74,50,24,62
Alloa,2384,4,17,8,11,56,44,12,59
Stranraer,2384,5,15,5,16,55,67,-12,50
East Fife,2384,6,14,3,19,50,64,-14,45
Airdrieon,2384,7,11,11,14,49,60,-11,44
Forfar,2384,8,10,5,21,40,68,-28,35
Albion,2384,9,8,6,22,58,83,-25,30
Queen's Park,2384,10,6,10,20,41,76,-35,28
Ayr,2385,1,23,5,8,92,44,48,74
Raith,2385,2,22,8,6,69,34,35,74
Alloa,2385,3,18,8,10,58,44,14,62
Arbroath,2385,4,17,9,10,71,49,22,60
Stranraer,2385,5,16,5,15,58,64,-6,53
Airdrieon,2385,6,10,12,14,46,59,-13,42
East Fife,2385,7,13,3,20,47,67,-20,42
Forfar,2385,8,10,6,20,39,65,-26,36
Albion,2385,9,8,7,21,59,80,-21,31
Queen's Park,2385,10,6,11,19,40,73,-33,29
Ayr,2386,1,24,4,8,94,44,50,76
Raith,2386,2,22,8,6,68,33,35,74
Arbroath,2386,3,18,8,10,72,49,23,62
Alloa,2386,4,18,8,10,57,43,14,62
Stranraer,2386,5,15,5,16,55,65,-10,50
East Fife,2386,6,14,3,19,48,64,-16,45
Airdrieon,2386,7,11,11,14,47,58,-11,44
Forfar,2386,8,10,5,21,38,66,-28,35
Albion,2386,9,8,6,22,59,82,-23,30
Queen's Park,2386,10,6,10,20,40,74,-34,28
Raith,2387,1,23,8,5,69,32,37,77
Ayr,2387,2,24,4,8,92,43,49,76
Arbroath,2387,3,17,8,11,71,50,21,59
Alloa,2387,4,17,8,11,56,44,12,59
Stranraer,2387,5,16,5,15,57,65,-8,53
Airdrieon,2387,6,11,11,14,47,58,-11,44
East Fife,2387,7,13,3,20,48,66,-18,42
Forfar,2387,8,10,5,21,38,66,-28,35
Queen's Park,2387,9,7,10,19,41,73,-32,31
Albion,2387,10,8,6,22,58,80,-22,30
Raith,2388,1,23,8,5,70,33,37,77
Ayr,2388,2,24,4,8,93,43,50,76
Arbroath,2388,3,18,8,10,72,49,23,62
Alloa,2388,4,17,8,11,57,45,12,59
Stranraer,2388,5,15,5,16,56,66,-10,50
East Fife,2388,6,14,3,19,49,65,-16,45
Airdrieon,2388,7,11,11,14,50,60,-10,44
Forfar,2388,8,10,5,21,40,69,-29,35
Albion,2388,9,8,6,22,58,81,-23,30
Queen's Park,2388,10,6,10,20,40,74,-34,28
Raith,2389,1,23,8,5,70,33,37,77
Ayr,2389,2,24,4,8,97,43,54,76
Arbroath,2389,3,17,8,11,70,50,20,59
Alloa,2389,4,17,8,11,57,45,12,59
Stranraer,2389,5,15,5,16,55,66,-11,50
East Fife,2389,6,14,3,19,49,64,-15,45
Airdrieon,2389,7,10,11,15,45,59,-14,41
Forfar,2389,8,11,5,20,39,64,-25,38
Queen's Park,2389,9,7,10,19,41,72,-31,31
Albion,2389,10,8,6,22,58,85,-27,30
Ayr,2390,1,24,4,8,95,42,53,76
Raith,2390,2,22,9,5,68,32,36,75
Arbroath,2390,3,17,9,10,72,50,22,60
Alloa,2390,4,17,9,10,56,43,13,60
Stranraer,2390,5,15,5,16,55,66,-11,50
East Fife,2390,6,14,3,19,49,64,-15,45
Airdrieon,2390,7,11,11,14,46,58,-12,44
Forfar,2390,8,10,5,21,38,65,-27,35
Albion,2390,9,8,6,22,57,83,-26,30
Queen's Park,2390,10,6,11,19,41,74,-33,29
Raith,2391,1,23,8,5,70,32,38,77
Ayr,2391,2,24,4,8,91,42,49,76
Arbroath,2391,3,17,9,10,72,50,22,60
Alloa,2391,4,17,8,11,56,45,11,59
Stranraer,2391,5,15,6,15,56,65,-9,51
East Fife,2391,6,13,4,19,48,65,-17,43
Airdrieon,2391,7,10,12,14,46,59,-13,42
Forfar,2391,8,10,6,20,39,65,-26,36
Albion,2391,9,8,6,22,57,79,-22,30
Queen's Park,2391,10,6,11,19,41,74,-33,29
Raith,2392,1,23,8,5,70,33,37,77
Ayr,2392,2,23,5,8,92,44,48,74
Arbroath,2392,3,18,8,10,72,49,23,62
Alloa,2392,4,17,8,11,57,45,12,59
Stranraer,2392,5,16,5,15,57,65,-8,53
Airdrieon,2392,6,11,11,14,47,58,-11,44
East Fife,2392,7,13,3,20,48,66,-18,42
Forfar,2392,8,10,5,21,38,66,-28,35
Albion,2392,9,8,7,21,59,80,-21,31
Queen's Park,2392,10,6,10,20,40,74,-34,28
Ayr,2393,1,24,4,8,92,43,49,76
Raith,2393,2,22,9,5,69,33,36,75
Arbroath,2393,3,17,9,10,72,50,22,60
Alloa,2393,4,17,9,10,57,44,13,60
Stranraer,2393,5,15,5,16,55,67,-12,50
East Fife,2393,6,14,3,19,50,64,-14,45
Airdrieon,2393,7,11,11,14,48,58,-10,44
Forfar,2393,8,10,5,21,38,67,-29,35
Albion,2393,9,8,6,22,58,80,-22,30
Queen's Park,2393,10,6,11,19,41,74,-33,29
Ayr,2394,1,24,4,8,92,42,50,76
Raith,2394,2,22,9,5,69,33,36,75
Arbroath,2394,3,18,8,10,72,49,23,62
Alloa,2394,4,17,9,10,57,44,13,60
Stranraer,2394,5,15,5,16,56,66,-10,50
East Fife,2394,6,14,3,19,49,65,-16,45
Airdrieon,2394,7,11,11,14,46,58,-12,44
Forfar,2394,8,10,5,21,38,65,-27,35
Albion,2394,9,8,6,22,57,80,-23,30
Queen's Park,2394,10,6,10,20,40,74,-34,28
Raith,2395,1,23,8,5,73,33,40,77
Ayr,2395,2,24,4,8,93,42,51,76
Arbroath,2395,3,17,8,11,72,51,21,59
Alloa,2395,4,17,8,11,57,48,9,59
Stranraer,2395,5,16,5,15,57,64,-7,53
Airdrieon,2395,6,11,11,14,48,60,-12,44
East Fife,2395,7,13,3,20,47,66,-19,42
Forfar,2395,8,10,5,21,40,67,-27,35
Queen's Park,2395,9,7,10,19,42,74,-32,31
Albion,2395,10,8,6,22,57,81,-24,30
Ayr,2396,1,24,4,8,96,42,54,76
Raith,2396,2,22,9,5,69,33,36,75
Arbroath,2396,3,18,8,10,72,49,23,62
Alloa,2396,4,17,9,10,57,44,13,60
Stranraer,2396,5,15,6,15,57,66,-9,51
Airdrieon,2396,6,11,11,14,50,59,-9,44
East Fife,2396,7,13,4,19,49,66,-17,43
Forfar,2396,8,10,5,21,39,69,-30,35
Albion,2396,9,8,6,22,57,84,-27,30
Queen's Park,2396,10,6,10,20,40,74,-34,28
Raith,2397,1,23,8,5,70,33,37,77
Ayr,2397,2,24,4,8,93,42,51,76
Arbroath,2397,3,18,8,10,72,48,24,62
Alloa,2397,4,17,8,11,57,45,12,59
Stranraer,2397,5,16,5,15,56,64,-8,53
East Fife,2397,6,13,3,20,47,65,-18,42
Airdrieon,2397,7,10,11,15,45,59,-14,41
Forfar,2397,8,11,5,20,39,64,-25,38
Albion,2397,9,8,6,22,57,81,-24,30
Queen's Park,2397,10,6,10,20,39,74,-35,28
Raith,2398,1,23,8,5,70,32,38,77
Ayr,2398,2,24,4,8,94,43,51,76
Arbroath,2398,3,17,9,10,71,49,22,60
Alloa,2398,4,17,8,11,56,45,11,59
Stranraer,2398,5,15,5,16,56,67,-11,50
East Fife,2398,6,14,3,19,50,65,-15,45
Airdrieon,2398,7,11,11,14,48,59,-11,44
Forfar,2398,8,10,5,21,39,67,-28,35
Albion,2398,9,8,6,22,58,82,-24,30
Queen's Park,2398,10,6,11,19,40,73,-33,29
Raith,2399,1,23,8,5,71,32,39,77
Ayr,2399,2,23,5,8,92,44,48,74
Arbroath,2399,3,17,9,10,72,50,22,60
Alloa,2399,4,17,8,11,56,46,10,59
Stranraer,2399,5,16,5,15,57,64,-7,53
Airdrieon,2399,6,11,11,14,48,59,-11,44
East Fife,2399,7,13,3,20,47,66,-19,42
Forfar,2399,8,10,5,21,39,67,-28,35
Albion,2399,9,8,7,21,59,80,-21,31
Queen's Park,2399,10,6,11,19,41,74,-33,29
Raith,2400,1,22,8,6,68,33,35,74
Ayr,2400,2,23,4,9,90,45,45,73
Alloa,2400,3,18,8,10,57,43,14,62
Arbroath,2400,4,17,8,11,72,52,20,59
Stranraer,2400,5,16,5,15,57,65,-8,53
East Fife,2400,6,13,3,20,48,66,-18,42
Airdrieon,2400,7,10,11,15,45,59,-14,41
Forfar,2400,8,11,5,20,39,64,-25,38
Albion,2400,9,9,6,21,60,78,-18,33
Queen's Park,2400,10,7,10,19,43,74,-31,31
Raith,2401,1,23,8,5,69,32,37,77
Ayr,2401,2,23,5,8,91,43,48,74
Arbroath,2401,3,18,8,10,72,48,24,62
Alloa,2401,4,17,8,11,56,44,12,59
Stranraer,2401,5,15,6,15,57,66,-9,51
East Fife,2401,6,13,4,19,49,66,-17,43
Airdrieon,2401,7,10,12,14,46,59,-13,42
Forfar,2401,8,10,6,20,39,65,-26,36
Albion,2401,9,8,7,21,58,79,-21,31
Queen's Park,2401,10,6,10,20,39,74,-35,28
Raith,2402,1,22,9,5,69,33,36,75
Ayr,2402,2,23,5,8,92,44,48,74
Alloa,2402,3,17,9,10,57,44,13,60
Arbroath,2402,4,17,8,11,70,49,21,59
Stranraer,2402,5,16,5,15,56,64,-8,53
Airdrieon,2402,6,10,12,14,45,58,-13,42
East Fife,2402,7,13,3,20,47,65,-18,42
Forfar,2402,8,10,6,20,38,64,-26,36
Albion,2402,9,8,7,21,59,80,-21,31
Queen's Park,2402,10,7,10,19,40,72,-32,31
Raith,2403,1,23,8,5,73,33,40,77
Ayr,2403,2,24,4,8,91,42,49,76
Arbroath,2403,3,17,8,11,72,52,20,59
Alloa,2403,4,17,8,11,57,48,9,59
Stranraer,2403,5,15,5,16,55,65,-10,50
East Fife,2403,6,14,3,19,48,64,-16,45
Airdrieon,2403,7,11,11,14,51,59,-8,44
Forfar,2403,8,10,5,21,39,70,-31,35
Queen's Park,2403,9,7,10,19,43,74,-31,31
Albion,2403,10,8,6,22,57,79,-22,30
Raith,2404,1,23,8,5,74,35,39,77
Ayr,2404,2,24,4,8,92,43,49,76
Arbroath,2404,3,18,8,10,74,49,25,62
Alloa,2404,4,17,8,11,59,49,10,59
Stranraer,2404,5,15,5,16,55,65,-10,50
East Fife,2404,6,14,3,19,48,64,-16,45
Airdrieon,2404,7,11,11,14,46,58,-12,44
Forfar,2404,8,10,5,21,38,65,-27,35
Albion,2404,9,8,6,22,58,80,-22,30
Queen's Park,2404,10,6,10,20,40,76,-36,28
Ayr,2405,1,24,4,8,95,43,52,76
Raith,2405,2,22,9,5,69,33,36,75
Arbroath,2405,3,18,8,10,72,48,24,62
Alloa,2405,4,17,9,10,57,44,13,60
Stranraer,2405,5,15,6,15,56,65,-9,51
Airdrieon,2405,6,11,11,14,48,59,-11,44
East Fife,2405,7,13,4,19,48,65,-17,43
Forfar,2405,8,10,5,21,39,67,-28,35
Albion,2405,9,8,6,22,58,83,-25,30
Queen's Park,2405,10,6,10,20,39,74,-35,28
Raith,2406,1,23,8,5,70,32,38,77
Ayr,2406,2,23,5,8,94,46,48,74
Arbroath,2406,3,17,8,11,70,51,19,59
Alloa,2406,4,17,8,11,56,45,11,59
Stranraer,2406,5,16,5,15,56,64,-8,53
Airdrieon,2406,6,10,12,14,45,58,-13,42
East Fife,2406,7,13,3,20,47,65,-18,42
Forfar,2406,8,10,6,20,38,64,-26,36
Albion,2406,9,8,7,21,61,82,-21,31
Queen's Park,2406,10,7,10,19,42,72,-30,31
Raith,2407,1,23,8,5,69,32,37,77
Ayr,2407,2,24,4,8,93,43,50,76
Arbroath,2407,3,18,8,10,73,50,23,62
Alloa,2407,4,17,8,11,56,44,12,59
Stranraer,2407,5,15,5,16,56,66,-10,50
East Fife,2407,6,14,3,19,49,65,-16,45
Airdrieon,2407,7,11,11,14,47,59,-12,44
Forfar,2407,8,10,5,21,39,66,-27,35
Albion,2407,9,8,6,22,58,81,-23,30
Queen's Park,2407,10,6,10,20,41,75,-34,28
Raith,2408,1,23,8,5,69,32,37,77
Ayr,2408,2,23,4,9,91,46,45,73
Arbroath,2408,3,17,8,11,70,49,21,59
Alloa,2408,4,17,8,11,56,44,12,59
Stranraer,2408,5,16,5,15,56,64,-8,53
Airdrieon,2408,6,11,11,14,46,58,-12,44
East Fife,2408,7,13,3,20,47,65,-18,42
Forfar,2408,8,10,5,21,38,65,-27,35
Albion,2408,9,9,6,21,61,79,-18,33
Queen's Park,2408,10,7,10,19,40,72,-32,31
Raith,2409,1,23,8,5,70,32,38,77
Ayr,2409,2,24,4,8,94,42,52,76
Arbroath,2409,3,18,8,10,76,48,28,62
Alloa,2409,4,17,8,11,56,45,11,59
Stranraer,2409,5,15,5,16,55,66,-11,50
East Fife,2409,6,14,3,19,49,64,-15,45
Airdrieon,2409,7,10,12,14,47,60,-13,42
Forfar,2409,8,10,6,20,40,66,-26,36
Albion,2409,9,8,6,22,57,82,-25,30
Queen's Park,2409,10,6,10,20,39,78,-39,28
Raith,2410,1,23,8,5,70,32,38,77
Ayr,2410,2,24,4,8,93,42,51,76
Arbroath,2410,3,18,8,10,73,48,25,62
Alloa,2410,4,17,8,11,56,45,11,59
Stranraer,2410,5,16,5,15,57,65,-8,53
Airdrieon,2410,6,10,12,14,46,59,-13,42
East Fife,2410,7,13,3,20,48,66,-18,42
Forfar,2410,8,10,6,20,39,65,-26,36
Albion,2410,9,8,6,22,57,81,-24,30
Queen's Park,2410,10,6,10,20,39,75,-36,28
Ayr,2411,1,24,4,8,96,44,52,76
Raith,2411,2,22,8,6,69,35,34,74
Alloa,2411,3,18,8,10,59,44,15,62
Arbroath,2411,4,17,8,11,71,50,21,59
Stranraer,2411,5,15,5,16,58,69,-11,50
East Fife,2411,6,14,3,19,52,67,-15,45
Airdrieon,2411,7,11,11,14,48,60,-12,44
Forfar,2411,8,10,5,21,40,67,-27,35
Queen's Park,2411,9,7,10,19,41,73,-32,31
Albion,2411,10,8,6,22,59,84,-25,30
Raith,2412,1,23,8,5,72,33,39,77
Ayr,2412,2,24,4,8,93,43,50,76
Arbroath,2412,3,17,8,11,70,51,19,59
Alloa,2412,4,17,8,11,57,47,10,59
Stranraer,2412,5,15,5,16,56,66,-10,50
East Fife,2412,6,14,3,19,49,65,-16,45
Airdrieon,2412,7,10,11,15,47,61,-14,41
Forfar,2412,8,11,5,20,41,66,-25,38
Queen's Park,2412,9,7,10,19,42,72,-30,31
Albion,2412,10,8,6,22,58,81,-23,30
Ayr,2413,1,24,4,8,92,43,49,76
Raith,2413,2,22,8,6,68,34,34,74
Arbroath,2413,3,18,8,10,74,48,26,62
Alloa,2413,4,18,8,10,58,43,15,62
Stranraer,2413,5,16,5,15,56,64,-8,53
Airdrieon,2413,6,11,11,14,46,58,-12,44
East Fife,2413,7,13,3,20,47,65,-18,42
Forfar,2413,8,10,5,21,38,65,-27,35
Albion,2413,9,8,6,22,58,80,-22,30
Queen's Park,2413,10,6,10,20,39,76,-37,28
Raith,2414,1,23,8,5,71,33,38,77
Ayr,2414,2,24,4,8,95,43,52,76
Arbroath,2414,3,18,8,10,76,48,28,62
Alloa,2414,4,17,8,11,57,46,11,59
Stranraer,2414,5,15,6,15,56,65,-9,51
East Fife,2414,6,13,4,19,48,65,-17,43
Airdrieon,2414,7,10,12,14,46,59,-13,42
Forfar,2414,8,10,6,20,39,65,-26,36
Albion,2414,9,8,6,22,58,83,-25,30
Queen's Park,2414,10,6,10,20,39,78,-39,28
Ayr,2415,1,24,4,8,97,43,54,76
Raith,2415,2,22,8,6,68,33,35,74
Alloa,2415,3,18,8,10,57,43,14,62
Arbroath,2415,4,17,9,10,72,50,22,60
Stranraer,2415,5,15,6,15,56,65,-9,51
East Fife,2415,6,13,4,19,48,65,-17,43
Airdrieon,2415,7,10,12,14,45,58,-13,42
Forfar,2415,8,10,6,20,38,64,-26,36
Albion,2415,9,8,6,22,58,85,-27,30
Queen's Park,2415,10,6,11,19,41,74,-33,29
Raith,2416,1,23,8,5,69,32,37,77
Ayr,2416,2,24,4,8,95,45,50,76
Arbroath,2416,3,18,8,10,74,49,25,62
Alloa,2416,4,17,8,11,56,44,12,59
Stranraer,2416,5,15,5,16,55,66,-11,50
East Fife,2416,6,14,3,19,49,64,-15,45
Airdrieon,2416,7,10,12,14,46,59,-13,42
Forfar,2416,8,10,6,20,39,65,-26,36
Albion,2416,9,8,6,22,60,83,-23,30
Queen's Park,2416,10,6,10,20,40,76,-36,28
Raith,2417,1,23,8,5,69,32,37,77
Ayr,2417,2,24,4,8,96,42,54,76
Arbroath,2417,3,17,8,11,72,51,21,59
Alloa,2417,4,17,8,11,56,44,12,59
Stranraer,2417,5,15,5,16,57,67,-10,50
East Fife,2417,6,14,3,19,50,66,-16,45
Airdrieon,2417,7,10,12,14,46,59,-13,42
Forfar,2417,8,10,6,20,39,65,-26,36
Queen's Park,2417,9,7,10,19,42,74,-32,31
Albion,2417,10,8,6,22,57,84,-27,30
Raith,2418,1,23,8,5,69,32,37,77
Ayr,2418,2,24,4,8,93,42,51,76
Arbroath,2418,3,18,8,10,72,49,23,62
Alloa,2418,4,17,8,11,56,44,12,59
Stranraer,2418,5,15,6,15,57,66,-9,51
Airdrieon,2418,6,11,11,14,48,58,-10,44
East Fife,2418,7,13,4,19,49,66,-17,43
Forfar,2418,8,10,5,21,38,67,-29,35
Albion,2418,9,8,6,22,57,81,-24,30
Queen's Park,2418,10,6,10,20,40,74,-34,28
Raith,2419,1,23,8,5,70,33,37,77
Ayr,2419,2,24,4,8,93,44,49,76
Arbroath,2419,3,17,8,11,71,51,20,59
Alloa,2419,4,17,8,11,57,45,12,59
Stranraer,2419,5,15,5,16,55,65,-10,50
East Fife,2419,6,14,3,19,48,64,-16,45
Airdrieon,2419,7,10,11,15,46,60,-14,41
Forfar,2419,8,11,5,20,40,65,-25,38
Queen's Park,2419,9,7,10,19,42,73,-31,31
Albion,2419,10,8,6,22,59,81,-22,30
Raith,2420,1,23,8,5,69,32,37,77
Ayr,2420,2,23,5,8,91,43,48,74
Arbroath,2420,3,18,8,10,75,48,27,62
Alloa,2420,4,17,8,11,56,44,12,59
Stranraer,2420,5,15,5,16,58,68,-10,50
East Fife,2420,6,14,3,19,51,67,-16,45
Airdrieon,2420,7,11,11,14,48,60,-12,44
Forfar,2420,8,10,5,21,40,67,-27,35
Albion,2420,9,8,7,21,58,79,-21,31
Queen's Park,2420,10,6,10,20,39,77,-38,28
Raith,2421,1,23,8,5,71,32,39,77
Ayr,2421,2,24,4,8,93,43,50,76
Arbroath,2421,3,18,8,10,73,48,25,62
Alloa,2421,4,17,8,11,56,46,10,59
Stranraer,2421,5,15,5,16,55,65,-10,50
East Fife,2421,6,14,3,19,48,64,-16,45
Airdrieon,2421,7,10,12,14,46,59,-13,42
Forfar,2421,8,10,6,20,39,65,-26,36
Albion,2421,9,8,6,22,58,81,-23,30
Queen's Park,2421,10,6,10,20,39,75,-36,28
Raith,2422,1,23,8,5,69,32,37,77
Ayr,2422,2,23,5,8,91,43,48,74
Arbroath,2422,3,17,8,11,71,52,19,59
Alloa,2422,4,17,8,11,56,44,12,59
Stranraer,2422,5,15,5,16,55,66,-11,50
East Fife,2422,6,14,3,19,49,64,-15,45
Airdrieon,2422,7,10,11,15,47,62,-15,41
Forfar,2422,8,11,5,20,42,66,-24,38
Albion,2422,9,8,7,21,58,79,-21,31
Queen's Park,2422,10,7,10,19,43,73,-30,31
Ayr,2423,1,24,4,8,98,45,53,76
Raith,2423,2,22,8,6,69,34,35,74
Alloa,2423,3,18,8,10,58,44,14,62
Arbroath,2423,4,17,9,10,73,51,22,60
Stranraer,2423,5,15,5,16,56,66,-10,50
East Fife,2423,6,14,3,19,49,65,-16,45
Airdrieon,2423,7,11,11,14,48,58,-10,44
Forfar,2423,8,10,5,21,38,67,-29,35
Albion,2423,9,8,6,22,60,86,-26,30
Queen's Park,2423,10,6,11,19,42,75,-33,29
Raith,2424,1,23,8,5,70,33,37,77
Ayr,2424,2,24,4,8,93,43,50,76
Arbroath,2424,3,17,9,10,71,49,22,60
Alloa,2424,4,17,8,11,57,45,12,59
Stranraer,2424,5,15,6,15,55,64,-9,51
Airdrieon,2424,6,11,11,14,47,58,-11,44
East Fife,2424,7,13,4,19,47,64,-17,43
Forfar,2424,8,10,5,21,38,66,-28,35
Albion,2424,9,8,6,22,58,81,-23,30
Queen's Park,2424,10,6,11,19,40,73,-33,29
Ayr,2425,1,24,4,8,94,42,52,76
Raith,2425,2,22,9,5,70,34,36,75
Alloa,2425,3,17,9,10,58,45,13,60
Arbroath,2425,4,17,8,11,71,50,21,59
Stranraer,2425,5,15,5,16,55,66,-11,50
East Fife,2425,6,14,3,19,49,64,-15,45
Airdrieon,2425,7,10,11,15,45,59,-14,41
Forfar,2425,8,11,5,20,39,64,-25,38
Queen's Park,2425,9,7,10,19,41,73,-32,31
Albion,2425,10,8,6,22,57,82,-25,30
Ayr,2426,1,24,4,8,98,43,55,76
Raith,2426,2,22,9,5,70,34,36,75
Arbroath,2426,3,18,8,10,73,50,23,62
Alloa,2426,4,17,9,10,58,45,13,60
Stranraer,2426,5,15,6,15,57,66,-9,51
Airdrieon,2426,6,11,11,14,48,58,-10,44
East Fife,2426,7,13,4,19,49,66,-17,43
Forfar,2426,8,10,5,21,38,67,-29,35
Albion,2426,9,8,6,22,58,86,-28,30
Queen's Park,2426,10,6,10,20,41,75,-34,28
Ayr,2427,1,24,4,8,93,44,49,76
Raith,2427,2,22,8,6,68,33,35,74
Alloa,2427,3,18,8,10,57,43,14,62
Arbroath,2427,4,17,9,10,71,49,22,60
Stranraer,2427,5,16,5,15,59,67,-8,53
Airdrieon,2427,6,10,12,14,47,60,-13,42
East Fife,2427,7,13,3,20,50,68,-18,42
Forfar,2427,8,10,6,20,40,66,-26,36
Albion,2427,9,8,6,22,59,81,-22,30
Queen's Park,2427,10,6,11,19,40,73,-33,29
Raith,2428,1,22,9,5,68,32,36,75
Ayr,2428,2,23,4,9,90,44,46,73
Alloa,2428,3,17,9,10,56,43,13,60
Arbroath,2428,4,17,8,11,71,50,21,59
Stranraer,2428,5,16,5,15,58,66,-8,53
Airdrieon,2428,6,11,11,14,48,59,-11,44
East Fife,2428,7,13,3,20,49,67,-18,42
Forfar,2428,8,10,5,21,39,67,-28,35
Albion,2428,9,9,6,21,59,78,-19,33
Queen's Park,2428,10,7,10,19,41,73,-32,31
Raith,2429,1,23,8,5,69,32,37,77
Ayr,2429,2,24,4,8,93,42,51,76
Arbroath,2429,3,17,8,11,71,51,20,59
Alloa,2429,4,17,8,11,56,44,12,59
Stranraer,2429,5,15,5,16,55,66,-11,50
East Fife,2429,6,14,3,19,49,64,-15,45
Airdrieon,2429,7,10,11,15,48,62,-14,41
Forfar,2429,8,11,5,20,42,67,-25,38
Queen's Park,2429,9,7,10,19,42,73,-31,31
Albion,2429,10,8,6,22,57,81,-24,30
Raith,2430,1,23,8,5,71,34,37,77
Ayr,2430,2,24,4,8,94,44,50,76
Arbroath,2430,3,17,8,11,70,50,20,59
Alloa,2430,4,17,8,11,58,46,12,59
Stranraer,2430,5,16,5,15,58,66,-8,53
Airdrieon,2430,6,10,12,14,46,59,-13,42
East Fife,2430,7,13,3,20,49,67,-18,42
Forfar,2430,8,10,6,20,39,65,-26,36
Queen's Park,2430,9,7,10,19,41,72,-31,31
Albion,2430,10,8,6,22,59,82,-23,30
Raith,2431,1,23,8,5,71,32,39,77
Ayr,2431,2,24,4,8,95,43,52,76
Arbroath,2431,3,17,9,10,71,49,22,60
Alloa,2431,4,17,8,11,56,46,10,59
Stranraer,2431,5,16,5,15,57,65,-8,53
East Fife,2431,6,13,3,20,48,66,-18,42
Airdrieon,2431,7,10,11,15,45,59,-14,41
Forfar,2431,8,11,5,20,39,64,-25,38
Albion,2431,9,8,6,22,58,83,-25,30
Queen's Park,2431,10,6,11,19,40,73,-33,29
Raith,2432,1,23,8,5,70,32,38,77
Ayr,2432,2,24,4,8,93,42,51,76
Arbroath,2432,3,17,9,10,70,48,22,60
Alloa,2432,4,17,8,11,56,45,11,59
Stranraer,2432,5,16,5,15,57,64,-7,53
Airdrieon,2432,6,10,12,14,45,58,-13,42
East Fife,2432,7,13,3,20,47,66,-19,42
Forfar,2432,8,10,6,20,38,64,-26,36
Albion,2432,9,8,6,22,57,81,-24,30
Queen's Park,2432,10,6,11,19,39,72,-33,29
Ayr,2433,1,24,4,8,95,42,53,76
Raith,2433,2,22,9,5,70,34,36,75
Arbroath,2433,3,18,8,10,74,51,23,62
Alloa,2433,4,17,9,10,58,45,13,60
Stranraer,2433,5,15,5,16,56,66,-10,50
East Fife,2433,6,14,3,19,49,65,-16,45
Airdrieon,2433,7,10,12,14,46,59,-13,42
Forfar,2433,8,10,6,20,39,65,-26,36
Albion,2433,9,8,6,22,57,83,-26,30
Queen's Park,2433,10,6,10,20,42,76,-34,28
Ayr,2434,1,24,4,8,94,45,49,76
Raith,2434,2,22,8,6,69,35,34,74
Arbroath,2434,3,18,8,10,72,48,24,62
Alloa,2434,4,18,8,10,59,44,15,62
Stranraer,2434,5,15,5,16,56,67,-11,50
East Fife,2434,6,14,3,19,50,65,-15,45
Airdrieon,2434,7,11,11,14,47,59,-12,44
Forfar,2434,8,10,5,21,39,66,-27,35
Albion,2434,9,8,6,22,60,82,-22,30
Queen's Park,2434,10,6,10,20,39,74,-35,28
Raith,2435,1,23,8,5,70,33,37,77
Ayr,2435,2,24,4,8,93,42,51,76
Arbroath,2435,3,18,8,10,71,48,23,62
Alloa,2435,4,17,8,11,57,45,12,59
Stranraer,2435,5,16,5,15,58,66,-8,53
Airdrieon,2435,6,11,11,14,48,58,-10,44
East Fife,2435,7,13,3,20,49,67,-18,42
Forfar,2435,8,10,5,21,38,67,-29,35
Albion,2435,9,8,6,22,57,81,-24,30
Queen's Park,2435,10,6,10,20,39,73,-34,28
Raith,2436,1,23,8,5,71,34,37,77
Ayr,2436,2,24,4,8,94,42,52,76
Arbroath,2436,3,18,8,10,72,48,24,62
Alloa,2436,4,17,8,11,58,46,12,59
Stranraer,2436,5,15,5,16,55,66,-11,50
East Fife,2436,6,14,3,19,49,64,-15,45
Airdrieon,2436,7,11,11,14,46,58,-12,44
Forfar,2436,8,10,5,21,38,65,-27,35
Albion,2436,9,8,6,22,57,82,-25,30
Queen's Park,2436,10,6,10,20,39,74,-35,28
Ayr,2437,1,24,4,8,94,42,52,76
Raith,2437,2,22,9,5,69,33,36,75
Arbroath,2437,3,17,9,10,71,49,22,60
Alloa,2437,4,17,9,10,57,44,13,60
Stranraer,2437,5,16,5,15,57,65,-8,53
Airdrieon,2437,6,11,11,14,47,58,-11,44
East Fife,2437,7,13,3,20,48,66,-18,42
Forfar,2437,8,10,5,21,38,66,-28,35
Albion,2437,9,8,6,22,57,82,-25,30
Queen's Park,2437,10,6,11,19,40,73,-33,29
Ayr,2438,1,24,4,8,95,42,53,76
Raith,2438,2,22,8,6,68,33,35,74
Arbroath,2438,3,18,8,10,73,50,23,62
Alloa,2438,4,18,8,10,57,43,14,62
Stranraer,2438,5,15,5,16,55,65,-10,50
East Fife,2438,6,14,3,19,48,64,-16,45
Airdrieon,2438,7,10,12,14,46,59,-13,42
Forfar,2438,8,10,6,20,39,65,-26,36
Albion,2438,9,8,6,22,57,83,-26,30
Queen's Park,2438,10,6,10,20,41,75,-34,28
Raith,2439,1,23,8,5,69,32,37,77
Ayr,2439,2,23,5,8,92,44,48,74
Arbroath,2439,3,17,8,11,70,51,19,59
Alloa,2439,4,17,8,11,56,44,12,59
Stranraer,2439,5,15,6,15,56,65,-9,51
Airdrieon,2439,6,11,11,14,51,58,-7,44
East Fife,2439,7,13,4,19,48,65,-17,43
Forfar,2439,8,10,5,21,38,70,-32,35
Albion,2439,9,8,7,21,59,80,-21,31
Queen's Park,2439,10,7,10,19,42,72,-30,31
Raith,2440,1,22,9,5,68,32,36,75
Ayr,2440,2,23,4,9,90,43,47,73
Arbroath,2440,3,18,8,10,74,48,26,62
Alloa,2440,4,17,9,10,56,43,13,60
Stranraer,2440,5,16,5,15,57,65,-8,53
Airdrieon,2440,6,11,11,14,46,58,-12,44
East Fife,2440,7,13,3,20,48,66,-18,42
Forfar,2440,8,10,5,21,38,65,-27,35
Albion,2440,9,9,6,21,58,78,-20,33
Queen's Park,2440,10,6,10,20,39,76,-37,28
Raith,2441,1,23,8,5,70,32,38,77
Ayr,2441,2,24,4,8,94,42,52,76
Arbroath,2441,3,17,8,11,72,51,21,59
Alloa,2441,4,17,8,11,56,45,11,59
Stranraer,2441,5,15,5,16,56,67,-11,50
East Fife,2441,6,14,3,19,50,65,-15,45
Airdrieon,2441,7,10,11,15,46,60,-14,41
Forfar,2441,8,11,5,20,40,65,-25,38
Queen's Park,2441,9,7,10,19,42,74,-32,31
Albion,2441,10,8,6,22,57,82,-25,30
Raith,2442,1,23,8,5,72,33,39,77
Ayr,2442,2,23,4,9,91,45,46,73
Arbroath,2442,3,18,8,10,73,48,25,62
Alloa,2442,4,17,8,11,57,47,10,59
Stranraer,2442,5,16,5,15,58,66,-8,53
Airdrieon,2442,6,11,11,14,48,60,-12,44
East Fife,2442,7,13,3,20,49,67,-18,42
Forfar,2442,8,10,5,21,40,67,-27,35
Albion,2442,9,9,6,21,60,79,-19,33
Queen's Park,2442,10,6,10,20,39,75,-36,28
Raith,2443,1,23,8,5,69,32,37,77
Ayr,2443,2,23,4,9,91,45,46,73
Arbroath,2443,3,17,8,11,70,49,21,59
Alloa,2443,4,17,8,11,56,44,12,59
Stranraer,2443,5,15,5,16,56,66,-10,50
East Fife,2443,6,14,3,19,49,65,-16,45
Airdrieon,2443,7,11,11,14,49,60,-11,44
Forfar,2443,8,10,5,21,40,68,-28,35
Albion,2443,9,9,6,21,60,79,-19,33
Queen's Park,2443,10,7,10,19,40,72,-32,31
Raith,2444,1,23,8,5,70,32,38,77
Ayr,2444,2,24,4,8,94,42,52,76
Arbroath,2444,3,17,8,11,73,52,21,59
Alloa,2444,4,17,8,11,56,45,11,59
Stranraer,2444,5,15,5,16,55,65,-10,50
East Fife,2444,6,14,3,19,48,64,-16,45
Airdrieon,2444,7,11,11,14,48,59,-11,44
Forfar,2444,8,10,5,21,39,67,-28,35
Queen's Park,2444,9,7,10,19,43,75,-32,31
Albion,2444,10,8,6,22,57,82,-25,30
Ayr,2445,1,24,4,8,92,42,50,76
Raith,2445,2,22,8,6,68,34,34,74
Alloa,2445,3,18,8,10,58,43,15,62
Arbroath,2445,4,17,9,10,70,48,22,60
Stranraer,2445,5,15,5,16,56,67,-11,50
East Fife,2445,6,14,3,19,50,65,-15,45
Airdrieon,2445,7,11,11,14,46,58,-12,44
Forfar,2445,8,10,5,21,38,65,-27,35
Albion,2445,9,8,6,22,57,80,-23,30
Queen's Park,2445,10,6,11,19,39,72,-33,29
Raith,2446,1,23,8,5,69,32,37,77
Ayr,2446,2,24,4,8,95,43,52,76
Arbroath,2446,3,17,8,11,70,49,21,59
Alloa,2446,4,17,8,11,56,44,12,59
Stranraer,2446,5,15,5,16,56,66,-10,50
East Fife,2446,6,14,3,19,49,65,-16,45
Airdrieon,2446,7,10,11,15,46,60,-14,41
Forfar,2446,8,11,5,20,40,65,-25,38
Queen's Park,2446,9,7,10,19,40,72,-32,31
Albion,2446,10,8,6,22,58,83,-25,30
Raith,2447,1,23,8,5,71,33,38,77
Ayr,2447,2,24,4,8,92,42,50,76
Arbroath,2447,3,17,9,10,71,49,22,60
Alloa,2447,4,17,8,11,57,46,11,59
Stranraer,2447,5,15,6,15,58,67,-9,51
Airdrieon,2447,6,11,11,14,47,59,-12,44
East Fife,2447,7,13,4,19,50,67,-17,43
Forfar,2447,8,10,5,21,39,66,-27,35
Albion,2447,9,8,6,22,57,80,-23,30
Queen's Park,2447,10,6,11,19,40,73,-33,29
Raith,2448,1,23,8,5,71,32,39,77
Ayr,2448,2,23,4,9,92,45,47,73
Arbroath,2448,3,18,8,10,73,50,23,62
Alloa,2448,4,17,8,11,56,46,10,59
Stranraer,2448,5,15,6,15,56,65,-9,51
Airdrieon,2448,6,11,11,14,46,58,-12,44
East Fife,2448,7,13,4,19,48,65,-17,43
Forfar,2448,8,10,5,21,38,65,-27,35
Albion,2448,9,9,6,21,60,80,-20,33
Queen's Park,2448,10,6,10,20,41,75,-34,28
Raith,2449,1,23,8,5,69,32,37,77
Ayr,2449,2,24,4,8,96,45,51,76
Arbroath,2449,3,18,8,10,72,49,23,62
Alloa,2449,4,17,8,11,56,44,12,59
Stranraer,2449,5,15,5,16,57,68,-11,50
East Fife,2449,6,14,3,19,51,66,-15,45
Airdrieon,2449,7,10,12,14,47,60,-13,42
Forfar,2449,8,10,6,20,40,66,-26,36
Albion,2449,9,8,6,22,60,84,-24,30
Queen's Park,2449,10,6,10,20,40,74,-34,28
Raith,2450,1,23,8,5,71,34,37,77
Ayr,2450,2,24,4,8,93,43,50,76
Arbroath,2450,3,17,9,10,72,50,22,60
Alloa,2450,4,17,8,11,58,46,12,59
Stranraer,2450,5,15,5,16,56,66,-10,50
East Fife,2450,6,14,3,19,49,65,-16,45
Airdrieon,2450,7,10,12,14,45,58,-13,42
Forfar,2450,8,10,6,20,38,64,-26,36
Albion,2450,9,8,6,22,58,81,-23,30
Queen's Park,2450,10,6,11,19,41,74,-33,29
Ayr,2451,1,24,4,8,92,43,49,76
Raith,2451,2,22,8,6,69,34,35,74
Alloa,2451,3,18,8,10,58,44,14,62
Arbroath,2451,4,17,8,11,70,50,20,59
Stranraer,2451,5,16,5,15,58,65,-7,53
Airdrieon,2451,6,11,11,14,47,59,-12,44
East Fife,2451,7,13,3,20,48,67,-19,42
Forfar,2451,8,10,5,21,39,66,-27,35
Queen's Park,2451,9,7,10,19,41,72,-31,31
Albion,2451,10,8,6,22,58,80,-22,30
Ayr,2452,1,24,4,8,93,43,50,76
Raith,2452,2,22,8,6,68,34,34,74
Arbroath,2452,3,18,8,10,73,48,25,62
Alloa,2452,4,18,8,10,58,43,15,62
Stranraer,2452,5,15,5,16,55,65,-10,50
East Fife,2452,6,14,3,19,48,64,-16,45
Airdrieon,2452,7,10,12,14,46,59,-13,42
Forfar,2452,8,10,6,20,39,65,-26,36
Albion,2452,9,8,6,22,58,81,-23,30
Queen's Park,2452,10,6,10,20,39,75,-36,28
Raith,2453,1,23,8,5,71,33,38,77
Ayr,2453,2,24,4,8,95,43,52,76
Arbroath,2453,3,18,8,10,72,48,24,62
Alloa,2453,4,17,8,11,57,46,11,59
Stranraer,2453,5,15,6,15,56,65,-9,51
Airdrieon,2453,6,11,11,14,48,59,-11,44
East Fife,2453,7,13,4,19,48,65,-17,43
Forfar,2453,8,10,5,21,39,67,-28,35
Albion,2453,9,8,6,22,58,83,-25,30
Queen's Park,2453,10,6,10,20,39,74,-35,28
Raith,2454,1,23,8,5,70,33,37,77
Ayr,2454,2,24,4,8,95,42,53,76
Arbroath,2454,3,17,8,11,71,50,21,59
Alloa,2454,4,17,8,11,57,45,12,59
Stranraer,2454,5,16,5,15,59,66,-7,53
Airdrieon,2454,6,10,12,14,45,58,-13,42
East Fife,2454,7,13,3,20,49,68,-19,42
Forfar,2454,8,10,6,20,38,64,-26,36
Queen's Park,2454,9,7,10,19,41,73,-32,31
Albion,2454,10,8,6,22,57,83,-26,30
Raith,2455,1,23,8,5,71,32,39,77
Ayr,2455,2,23,4,9,91,44,47,73
Arbroath,2455,3,17,9,10,72,50,22,60
Alloa,2455,4,17,8,11,56,46,10,59
Stranraer,2455,5,15,5,16,56,67,-11,50
East Fife,2455,6,14,3,19,50,65,-15,45
Airdrieon,2455,7,11,11,14,46,58,-12,44
Forfar,2455,8,10,5,21,38,65,-27,35
Albion,2455,9,9,6,21,59,79,-20,33
Queen's Park,2455,10,6,11,19,41,74,-33,29
Ayr,2456,1,24,4,8,93,42,51,76
Raith,2456,2,22,9,5,69,33,36,75
Arbroath,2456,3,18,8,10,73,50,23,62
Alloa,2456,4,17,9,10,57,44,13,60
Stranraer,2456,5,15,6,15,57,66,-9,51
East Fife,2456,6,13,4,19,49,66,-17,43
Airdrieon,2456,7,10,11,15,47,62,-15,41
Forfar,2456,8,11,5,20,42,66,-24,38
Albion,2456,9,8,6,22,57,81,-24,30
Queen's Park,2456,10,6,10,20,41,75,-34,28
Ayr,2457,1,24,4,8,93,43,50,76
Raith,2457,2,22,8,6,69,34,35,74
Alloa,2457,3,18,8,10,58,44,14,62
Arbroath,2457,4,17,8,11,71,51,20,59
Stranraer,2457,5,15,5,16,55,65,-10,50
East Fife,2457,6,14,3,19,48,64,-16,45
Airdrieon,2457,7,11,11,14,46,58,-12,44
Forfar,2457,8,10,5,21,38,65,-27,35
Queen's Park,2457,9,7,10,19,42,73,-31,31
Albion,2457,10,8,6,22,58,81,-23,30
Ayr,2458,1,24,4,8,95,45,50,76
Raith,2458,2,22,8,6,68,33,35,74
Alloa,2458,3,18,8,10,57,43,14,62
Arbroath,2458,4,17,8,11,72,51,21,59
Stranraer,2458,5,15,5,16,55,65,-10,50
East Fife,2458,6,14,3,19,48,64,-16,45
Airdrieon,2458,7,10,12,14,46,59,-13,42
Forfar,2458,8,10,6,20,39,65,-26,36
Queen's Park,2458,9,7,10,19,42,74,-32,31
Albion,2458,10,8,6,22,60,83,-23,30
Ayr,2459,1,24,4,8,92,43,49,76
Raith,2459,2,22,9,5,69,33,36,75
Alloa,2459,3,17,9,10,57,44,13,60
Arbroath,2459,4,17,8,11,71,51,20,59
Stranraer,2459,5,16,5,15,58,64,-6,53
Airdrieon,2459,6,10,12,14,46,59,-13,42
East Fife,2459,7,13,3,20,47,67,-20,42
Forfar,2459,8,10,6,20,39,65,-26,36
Queen's Park,2459,9,7,10,19,42,73,-31,31
Albion,2459,10,8,6,22,58,80,-22,30
Raith,2460,1,23,8,5,70,33,37,77
Ayr,2460,2,24,4,8,95,43,52,76
Arbroath,2460,3,17,9,10,71,49,22,60
Alloa,2460,4,17,8,11,57,45,12,59
Stranraer,2460,5,16,5,15,57,65,-8,53
East Fife,2460,6,13,3,20,48,66,-18,42
Airdrieon,2460,7,10,11,15,46,60,-14,41
Forfar,2460,8,11,5,20,40,65,-25,38
Albion,2460,9,8,6,22,58,83,-25,30
Queen's Park,2460,10,6,11,19,40,73,-33,29
Raith,2461,1,23,8,5,72,33,39,77
Ayr,2461,2,23,4,9,91,46,45,73
Arbroath,2461,3,18,8,10,71,48,23,62
Alloa,2461,4,17,8,11,57,47,10,59
Stranraer,2461,5,15,6,15,56,65,-9,51
East Fife,2461,6,13,4,19,48,65,-17,43
Airdrieon,2461,7,10,12,14,47,60,-13,42
Forfar,2461,8,10,6,20,40,66,-26,36
Albion,2461,9,9,6,21,61,79,-18,33
Queen's Park,2461,10,6,10,20,39,73,-34,28
Ayr,2462,1,24,4,8,92,42,50,76
Raith,2462,2,22,9,5,71,35,36,75
Arbroath,2462,3,18,8,10,72,48,24,62
Alloa,2462,4,17,9,10,59,46,13,60
Stranraer,2462,5,15,6,15,56,65,-9,51
East Fife,2462,6,13,4,19,48,65,-17,43
Airdrieon,2462,7,10,11,15,46,60,-14,41
Forfar,2462,8,11,5,20,40,65,-25,38
Albion,2462,9,8,6,22,57,80,-23,30
Queen's Park,2462,10,6,10,20,39,74,-35,28
Raith,2463,1,23,8,5,70,33,37,77
Ayr,2463,2,24,4,8,93,43,50,76
Arbroath,2463,3,17,9,10,71,49,22,60
Alloa,2463,4,17,8,11,57,45,12,59
Stranraer,2463,5,15,6,15,57,66,-9,51
Airdrieon,2463,6,11,11,14,47,58,-11,44
East Fife,2463,7,13,4,19,49,66,-17,43
Forfar,2463,8,10,5,21,38,66,-28,35
Albion,2463,9,8,6,22,58,81,-23,30
Queen's Park,2463,10,6,11,19,40,73,-33,29
Ayr,2464,1,24,4,8,93,42,51,76
Raith,2464,2,22,9,5,70,34,36,75
Alloa,2464,3,17,9,10,58,45,13,60
Arbroath,2464,4,17,8,11,70,49,21,59
Stranraer,2464,5,15,6,15,57,66,-9,51
East Fife,2464,6,13,4,19,49,66,-17,43
Airdrieon,2464,7,10,11,15,46,60,-14,41
Forfar,2464,8,11,5,20,40,65,-25,38
Queen's Park,2464,9,7,10,19,40,72,-32,31
Albion,2464,10,8,6,22,57,81,-24,30
Raith,2465,1,23,8,5,69,32,37,77
Ayr,2465,2,24,4,8,92,42,50,76
Arbroath,2465,3,18,8,10,73,49,24,62
Alloa,2465,4,17,8,11,56,44,12,59
Stranraer,2465,5,15,6,15,57,66,-9,51
Airdrieon,2465,6,11,11,14,48,60,-12,44
East Fife,2465,7,13,4,19,49,66,-17,43
Forfar,2465,8,10,5,21,40,67,-27,35
Albion,2465,9,8,6,22,57,80,-23,30
Queen's Park,2465,10,6,10,20,40,75,-35,28
Raith,2466,1,23,8,5,70,33,37,77
Ayr,2466,2,23,4,9,93,46,47,73
Arbroath,2466,3,17,8,11,70,49,21,59
Alloa,2466,4,17,8,11,57,45,12,59
Stranraer,2466,5,15,6,15,57,66,-9,51
Airdrieon,2466,6,11,11,14,47,59,-12,44
East Fife,2466,7,13,4,19,49,66,-17,43
Forfar,2466,8,10,5,21,39,66,-27,35
Albion,2466,9,9,6,21,61,81,-20,33
Queen's Park,2466,10,7,10,19,40,72,-32,31
Raith,2467,1,23,8,5,70,32,38,77
Ayr,2467,2,24,4,8,94,43,51,76
Arbroath,2467,3,17,8,11,70,49,21,59
Alloa,2467,4,17,8,11,56,45,11,59
Stranraer,2467,5,16,5,15,57,65,-8,53
East Fife,2467,6,13,3,20,48,66,-18,42
Airdrieon,2467,7,10,11,15,45,60,-15,41
Forfar,2467,8,11,5,20,40,64,-24,38
Queen's Park,2467,9,7,10,19,40,72,-32,31
Albion,2467,10,8,6,22,58,82,-24,30
Ayr,2468,1,24,4,8,96,43,53,76
Raith,2468,2,22,8,6,68,33,35,74
Arbroath,2468,3,18,8,10,72,48,24,62
Alloa,2468,4,18,8,10,57,43,14,62
Stranraer,2468,5,15,6,15,57,66,-9,51
Airdrieon,2468,6,11,11,14,47,59,-12,44
East Fife,2468,7,13,4,19,49,66,-17,43
Forfar,2468,8,10,5,21,39,66,-27,35
Albion,2468,9,8,6,22,58,84,-26,30
Queen's Park,2468,10,6,10,20,39,74,-35,28
Raith,2469,1,23,8,5,70,33,37,77
Ayr,2469,2,24,4,8,94,44,50,76
Arbroath,2469,3,18,8,10,75,48,27,62
Alloa,2469,4,17,8,11,57,45,12,59
Stranraer,2469,5,15,6,15,58,67,-9,51
East Fife,2469,6,13,4,19,50,67,-17,43
Airdrieon,2469,7,10,11,15,46,60,-14,41
Forfar,2469,8,11,5,20,40,65,-25,38
Albion,2469,9,8,6,22,59,82,-23,30
Queen's Park,2469,10,6,10,20,39,77,-38,28
Raith,2470,1,23,8,5,69,32,37,77
Ayr,2470,2,23,5,8,93,45,48,74
Arbroath,2470,3,18,8,10,74,50,24,62
Alloa,2470,4,17,8,11,56,44,12,59
Stranraer,2470,5,16,5,15,58,65,-7,53
Airdrieon,2470,6,11,11,14,47,58,-11,44
East Fife,2470,7,13,3,20,48,67,-19,42
Forfar,2470,8,10,5,21,38,66,-28,35
Albion,2470,9,8,7,21,60,81,-21,31
Queen's Park,2470,10,6,10,20,41,76,-35,28
Raith,2471,1,23,8,5,70,32,38,77
Ayr,2471,2,24,4,8,93,42,51,76
Arbroath,2471,3,17,9,10,73,51,22,60
Alloa,2471,4,17,8,11,56,45,11,59
Stranraer,2471,5,15,5,16,56,66,-10,50
East Fife,2471,6,14,3,19,49,65,-16,45
Airdrieon,2471,7,11,11,14,49,61,-12,44
Forfar,2471,8,10,5,21,41,68,-27,35
Albion,2471,9,8,6,22,57,81,-24,30
Queen's Park,2471,10,6,11,19,42,75,-33,29
Raith,2472,1,22,9,5,70,34,36,75
Ayr,2472,2,23,4,9,93,47,46,73
Arbroath,2472,3,18,8,10,74,48,26,62
Alloa,2472,4,17,9,10,58,45,13,60
Stranraer,2472,5,15,5,16,56,66,-10,50
East Fife,2472,6,14,3,19,49,65,-16,45
Airdrieon,2472,7,11,11,14,47,58,-11,44
Forfar,2472,8,10,5,21,38,66,-28,35
Albion,2472,9,9,6,21,62,81,-19,33
Queen's Park,2472,10,6,10,20,39,76,-37,28
Raith,2473,1,23,8,5,69,32,37,77
Ayr,2473,2,24,4,8,94,44,50,76
Arbroath,2473,3,18,8,10,71,48,23,62
Alloa,2473,4,17,8,11,56,44,12,59
Stranraer,2473,5,15,5,16,56,66,-10,50
East Fife,2473,6,14,3,19,49,65,-16,45
Airdrieon,2473,7,10,12,14,47,60,-13,42
Forfar,2473,8,10,6,20,40,66,-26,36
Albion,2473,9,8,6,22,59,82,-23,30
Queen's Park,2473,10,6,10,20,39,73,-34,28
Raith,2474,1,23,8,5,69,32,37,77
Ayr,2474,2,24,4,8,97,43,54,76
Arbroath,2474,3,17,8,11,71,50,21,59
Alloa,2474,4,17,8,11,56,44,12,59
Stranraer,2474,5,15,6,15,56,65,-9,51
Airdrieon,2474,6,11,11,14,48,58,-10,44
East Fife,2474,7,13,4,19,48,65,-17,43
Forfar,2474,8,10,5,21,38,67,-29,35
Queen's Park,2474,9,7,10,19,41,73,-32,31
Albion,2474,10,8,6,22,58,85,-27,30
Raith,2475,1,23,8,5,69,32,37,77
Ayr,2475,2,24,4,8,94,43,51,76
Arbroath,2475,3,18,8,10,73,50,23,62
Alloa,2475,4,17,8,11,56,44,12,59
Stranraer,2475,5,15,6,15,55,64,-9,51
East Fife,2475,6,13,4,19,47,64,-17,43
Airdrieon,2475,7,10,11,15,45,59,-14,41
Forfar,2475,8,11,5,20,39,64,-25,38
Albion,2475,9,8,6,22,58,82,-24,30
Queen's Park,2475,10,6,10,20,41,75,-34,28
Raith,2476,1,23,8,5,71,33,38,77
Ayr,2476,2,24,4,8,93,44,49,76
Arbroath,2476,3,17,9,10,71,49,22,60
Alloa,2476,4,17,8,11,57,46,11,59
Stranraer,2476,5,15,5,16,55,66,-11,50
East Fife,2476,6,14,3,19,49,64,-15,45
Airdrieon,2476,7,10,11,15,46,61,-15,41
Forfar,2476,8,11,5,20,41,65,-24,38
Albion,2476,9,8,6,22,59,81,-22,30
Queen's Park,2476,10,6,11,19,40,73,-33,29
Raith,2477,1,23,8,5,71,34,37,77
Ayr,2477,2,24,4,8,94,44,50,76
Arbroath,2477,3,17,8,11,71,51,20,59
Alloa,2477,4,17,8,11,58,46,12,59
Stranraer,2477,5,15,5,16,56,66,-10,50
East Fife,2477,6,14,3,19,49,65,-16,45
Airdrieon,2477,7,10,12,14,45,58,-13,42
Forfar,2477,8,10,6,20,38,64,-26,36
Queen's Park,2477,9,7,10,19,42,73,-31,31
Albion,2477,10,8,6,22,59,82,-23,30
Raith,2478,1,23,8,5,69,32,37,77
Ayr,2478,2,23,5,8,94,46,48,74
Arbroath,2478,3,18,8,10,74,49,25,62
Alloa,2478,4,17,8,11,56,44,12,59
Stranraer,2478,5,16,5,15,58,66,-8,53
East Fife,2478,6,13,3,20,49,67,-18,42
Airdrieon,2478,7,10,11,15,47,61,-14,41
Forfar,2478,8,11,5,20,41,66,-25,38
Albion,2478,9,8,7,21,61,82,-21,31
Queen's Park,2478,10,6,10,20,40,76,-36,28
Ayr,2479,1,24,4,8,95,42,53,76
Raith,2479,2,22,8,6,69,34,35,74
Arbroath,2479,3,18,8,10,74,49,25,62
Alloa,2479,4,18,8,10,58,44,14,62
Stranraer,2479,5,15,6,15,56,65,-9,51
Airdrieon,2479,6,11,11,14,50,59,-9,44
East Fife,2479,7,13,4,19,48,65,-17,43
Forfar,2479,8,10,5,21,39,69,-30,35
Albion,2479,9,8,6,22,57,83,-26,30
Queen's Park,2479,10,6,10,20,40,76,-36,28
Ayr,2480,1,24,4,8,95,42,53,76
Raith,2480,2,22,9,5,70,34,36,75
Arbroath,2480,3,18,8,10,72,49,23,62
Alloa,2480,4,17,9,10,58,45,13,60
Stranraer,2480,5,16,5,15,58,64,-6,53
East Fife,2480,6,13,3,20,47,67,-20,42
Airdrieon,2480,7,10,11,15,48,62,-14,41
Forfar,2480,8,11,5,20,42,67,-25,38
Albion,2480,9,8,6,22,57,83,-26,30
Queen's Park,2480,10,6,10,20,40,74,-34,28
Ayr,2481,1,24,4,8,94,44,50,76
Raith,2481,2,22,8,6,68,38,30,74
Arbroath,2481,3,18,8,10,77,49,28,62
Alloa,2481,4,18,8,10,62,43,19,62
Stranraer,2481,5,15,5,16,55,65,-10,50
East Fife,2481,6,14,3,19,48,64,-16,45
Airdrieon,2481,7,11,11,14,49,60,-11,44
Forfar,2481,8,10,5,21,40,68,-28,35
Albion,2481,9,8,6,22,59,82,-23,30
Queen's Park,2481,10,6,10,20,40,79,-39,28
Raith,2482,1,23,8,5,70,32,38,77
Ayr,2482,2,24,4,8,95,42,53,76
Arbroath,2482,3,17,9,10,70,48,22,60
Alloa,2482,4,17,8,11,56,45,11,59
Stranraer,2482,5,16,5,15,56,64,-8,53
East Fife,2482,6,13,3,20,47,65,-18,42
Airdrieon,2482,7,10,11,15,45,59,-14,41
Forfar,2482,8,11,5,20,39,64,-25,38
Albion,2482,9,8,6,22,57,83,-26,30
Queen's Park,2482,10,6,11,19,39,72,-33,29
Ayr,2483,1,24,4,8,96,43,53,76
Raith,2483,2,22,8,6,69,34,35,74
Alloa,2483,3,18,8,10,58,44,14,62
Arbroath,2483,4,17,8,11,72,51,21,59
Stranraer,2483,5,15,6,15,57,66,-9,51
East Fife,2483,6,13,4,19,49,66,-17,43
Airdrieon,2483,7,10,12,14,45,58,-13,42
Forfar,2483,8,10,6,20,38,64,-26,36
Queen's Park,2483,9,7,10,19,42,74,-32,31
Albion,2483,10,8,6,22,58,84,-26,30
Ayr,2484,1,24,4,8,95,42,53,76
Raith,2484,2,22,9,5,68,32,36,75
Alloa,2484,3,17,9,10,56,43,13,60
Arbroath,2484,4,17,8,11,71,50,21,59
Stranraer,2484,5,15,6,15,56,65,-9,51
East Fife,2484,6,13,4,19,48,65,-17,43
Airdrieon,2484,7,10,11,15,45,60,-15,41
Forfar,2484,8,11,5,20,40,64,-24,38
Queen's Park,2484,9,7,10,19,41,73,-32,31
Albion,2484,10,8,6,22,57,83,-26,30
Raith,2485,1,23,8,5,70,32,38,77
Ayr,2485,2,23,4,9,91,44,47,73
Arbroath,2485,3,17,9,10,71,49,22,60
Alloa,2485,4,17,8,11,56,45,11,59
Stranraer,2485,5,15,5,16,55,67,-12,50
East Fife,2485,6,14,3,19,50,64,-14,45
Airdrieon,2485,7,10,11,15,45,61,-16,41
Forfar,2485,8,11,5,20,41,64,-23,38
Albion,2485,9,9,6,21,59,79,-20,33
Queen's Park,2485,10,6,11,19,40,73,-33,29
Raith,2486,1,23,8,5,69,32,37,77
Ayr,2486,2,24,4,8,95,43,52,76
Arbroath,2486,3,18,8,10,73,49,24,62
Alloa,2486,4,17,8,11,56,44,12,59
Stranraer,2486,5,15,5,16,57,67,-10,50
East Fife,2486,6,14,3,19,50,66,-16,45
Airdrieon,2486,7,11,11,14,48,60,-12,44
Forfar,2486,8,10,5,21,40,67,-27,35
Albion,2486,9,8,6,22,58,83,-25,30
Queen's Park,2486,10,6,10,20,40,75,-35,28
Raith,2487,1,23,8,5,71,32,39,77
Ayr,2487,2,24,4,8,93,42,51,76
Arbroath,2487,3,18,8,10,74,50,24,62
Alloa,2487,4,17,8,11,56,46,10,59
Stranraer,2487,5,15,5,16,56,67,-11,50
East Fife,2487,6,14,3,19,50,65,-15,45
Airdrieon,2487,7,11,11,14,47,59,-12,44
Forfar,2487,8,10,5,21,39,66,-27,35
Albion,2487,9,8,6,22,57,81,-24,30
Queen's Park,2487,10,6,10,20,41,76,-35,28
Raith,2488,1,23,8,5,71,33,38,77
Ayr,2488,2,23,4,9,90,45,45,73
Arbroath,2488,3,18,8,10,74,48,26,62
Alloa,2488,4,17,8,11,57,46,11,59
Stranraer,2488,5,15,5,16,55,67,-12,50
East Fife,2488,6,14,3,19,50,64,-14,45
Airdrieon,2488,7,10,12,14,46,59,-13,42
Forfar,2488,8,10,6,20,39,65,-26,36
Albion,2488,9,9,6,21,60,78,-18,33
Queen's Park,2488,10,6,10,20,39,76,-37,28
Raith,2489,1,23,8,5,72,32,40,77
Ayr,2489,2,24,4,8,92,43,49,76
Arbroath,2489,3,18,8,10,72,49,23,62
Alloa,2489,4,17,8,11,56,47,9,59
Stranraer,2489,5,15,5,16,55,67,-12,50
East Fife,2489,6,14,3,19,50,64,-14,45
Airdrieon,2489,7,11,11,14,46,58,-12,44
Forfar,2489,8,10,5,21,38,65,-27,35
Albion,2489,9,8,6,22,58,80,-22,30
Queen's Park,2489,10,6,10,20,40,74,-34,28
Ayr,2490,1,24,4,8,95,43,52,76
Raith,2490,2,22,9,5,69,33,36,75
Arbroath,2490,3,18,8,10,75,49,26,62
Alloa,2490,4,17,9,10,57,44,13,60
Stranraer,2490,5,15,6,15,56,65,-9,51
Airdrieon,2490,6,11,11,14,48,58,-10,44
East Fife,2490,7,13,4,19,48,65,-17,43
Forfar,2490,8,10,5,21,38,67,-29,35
Albion,2490,9,8,6,22,58,83,-25,30
Queen's Park,2490,10,6,10,20,40,77,-37,28
Ayr,2491,1,24,4,8,95,42,53,76
Raith,2491,2,22,8,6,68,35,33,74
Alloa,2491,3,18,8,10,59,43,16,62
Arbroath,2491,4,17,9,10,72,50,22,60
Stranraer,2491,5,16,5,15,58,66,-8,53
East Fife,2491,6,13,3,20,49,67,-18,42
Airdrieon,2491,7,10,11,15,48,62,-14,41
Forfar,2491,8,11,5,20,42,67,-25,38
Albion,2491,9,8,6,22,57,83,-26,30
Queen's Park,2491,10,6,11,19,41,74,-33,29
Raith,2492,1,22,9,5,69,33,36,75
Ayr,2492,2,23,4,9,91,45,46,73
Arbroath,2492,3,17,9,10,73,51,22,60
Alloa,2492,4,17,9,10,57,44,13,60
Stranraer,2492,5,15,6,15,56,65,-9,51
Airdrieon,2492,6,11,11,14,46,58,-12,44
East Fife,2492,7,13,4,19,48,65,-17,43
Forfar,2492,8,10,5,21,38,65,-27,35
Albion,2492,9,9,6,21,60,79,-19,33
Queen's Park,2492,10,6,11,19,42,75,-33,29
Raith,2493,1,23,8,5,70,32,38,77
Ayr,2493,2,24,4,8,93,44,49,76
Arbroath,2493,3,17,9,10,72,50,22,60
Alloa,2493,4,17,8,11,56,45,11,59
Stranraer,2493,5,15,5,16,56,66,-10,50
East Fife,2493,6,14,3,19,49,65,-16,45
Airdrieon,2493,7,10,12,14,46,59,-13,42
Forfar,2493,8,10,6,20,39,65,-26,36
Albion,2493,9,8,6,22,59,81,-22,30
Queen's Park,2493,10,6,11,19,41,74,-33,29
Ayr,2494,1,23,5,8,93,45,48,74
Raith,2494,2,22,8,6,68,34,34,74
Arbroath,2494,3,18,8,10,72,49,23,62
Alloa,2494,4,18,8,10,58,43,15,62
Stranraer,2494,5,15,5,16,55,67,-12,50
East Fife,2494,6,14,3,19,50,64,-14,45
Airdrieon,2494,7,11,11,14,48,60,-12,44
Forfar,2494,8,10,5,21,40,67,-27,35
Albion,2494,9,8,7,21,60,81,-21,31
Queen's Park,2494,10,6,10,20,40,74,-34,28
Raith,2495,1,22,9,5,69,33,36,75
Ayr,2495,2,23,4,9,90,47,43,73
Alloa,2495,3,17,9,10,57,44,13,60
Arbroath,2495,4,17,8,11,71,52,19,59
Stranraer,2495,5,15,6,15,55,64,-9,51
East Fife,2495,6,13,4,19,47,64,-17,43
Airdrieon,2495,7,10,11,15,45,60,-15,41
Forfar,2495,8,11,5,20,40,64,-24,38
Albion,2495,9,9,6,21,62,78,-16,33
Queen's Park,2495,10,7,10,19,43,73,-30,31
Ayr,2496,1,24,4,8,94,42,52,76
Raith,2496,2,22,8,6,68,35,33,74
Alloa,2496,3,18,8,10,59,43,16,62
Arbroath,2496,4,17,8,11,72,51,21,59
Stranraer,2496,5,16,5,15,56,64,-8,53
Airdrieon,2496,6,11,11,14,46,58,-12,44
East Fife,2496,7,13,3,20,47,65,-18,42
Forfar,2496,8,10,5,21,38,65,-27,35
Queen's Park,2496,9,7,10,19,42,74,-32,31
Albion,2496,10,8,6,22,57,82,-25,30
Ayr,2497,1,24,4,8,93,44,49,76
Raith,2497,2,22,8,6,68,33,35,74
Arbroath,2497,3,18,8,10,73,49,24,62
Alloa,2497,4,18,8,10,57,43,14,62
Stranraer,2497,5,15,5,16,56,71,-15,50
East Fife,2497,6,14,3,19,54,65,-11,45
Airdrieon,2497,7,10,12,14,46,59,-13,42
Forfar,2497,8,10,6,20,39,65,-26,36
Albion,2497,9,8,6,22,59,81,-22,30
Queen's Park,2497,10,6,10,20,40,75,-35,28
Ayr,2498,1,24,4,8,98,43,55,76
Raith,2498,2,22,9,5,69,33,36,75
Arbroath,2498,3,18,8,10,76,51,25,62
Alloa,2498,4,17,9,10,57,44,13,60
Stranraer,2498,5,15,5,16,56,66,-10,50
East Fife,2498,6,14,3,19,49,65,-16,45
Airdrieon,2498,7,11,11,14,48,58,-10,44
Forfar,2498,8,10,5,21,38,67,-29,35
Albion,2498,9,8,6,22,58,86,-28,30
Queen's Park,2498,10,6,10,20,42,78,-36,28
Ayr,2499,1,24,4,8,93,42,51,76
Raith,2499,2,22,9,5,70,34,36,75
Alloa,2499,3,17,9,10,58,45,13,60
Arbroath,2499,4,17,8,11,71,50,21,59
Stranraer,2499,5,16,5,15,56,64,-8,53
Airdrieon,2499,6,11,11,14,47,58,-11,44
East Fife,2499,7,13,3,20,47,65,-18,42
Forfar,2499,8,10,5,21,38,66,-28,35
Queen's Park,2499,9,7,10,19,41,73,-32,31
Albion,2499,10,8,6,22,57,81,-24,30
Raith,2500,1,23,8,5,70,33,37,77
Ayr,2500,2,24,4,8,93,43,50,76
Arbroath,2500,3,17,9,10,72,50,22,60
Alloa,2500,4,17,8,11,57,45,12,59
Stranraer,2500,5,15,5,16,55,65,-10,50
East Fife,2500,6,14,3,19,48,64,-16,45
Airdrieon,2500,7,11,11,14,47,59,-12,44
Forfar,2500,8,10,5,21,39,66,-27,35
Albion,2500,9,8,6,22,58,81,-23,30
Queen's Park,2500,10,6,11,19,41,74,-33,29
Raith,2501,1,23,8,5,70,33,37,77
Ayr,2501,2,24,4,8,96,44,52,76
Arbroath,2501,3,18,8,10,71,48,23,62
Alloa,2501,4,17,8,11,57,45,12,59
Stranraer,2501,5,15,5,16,55,67,-12,50
East Fife,2501,6,14,3,19,50,64,-14,45
Airdrieon,2501,7,10,11,15,45,59,-14,41
Forfar,2501,8,11,5,20,39,64,-25,38
Albion,2501,9,8,6,22,59,84,-25,30
Queen's Park,2501,10,6,10,20,39,73,-34,28
Ayr,2502,1,24,4,8,95,43,52,76
Raith,2502,2,22,9,5,68,32,36,75
Arbroath,2502,3,17,9,10,73,51,22,60
Alloa,2502,4,17,9,10,56,43,13,60
Stranraer,2502,5,15,5,16,56,68,-12,50
East Fife,2502,6,14,3,19,51,65,-14,45
Airdrieon,2502,7,11,11,14,47,59,-12,44
Forfar,2502,8,10,5,21,39,66,-27,35
Albion,2502,9,8,6,22,58,83,-25,30
Queen's Park,2502,10,6,11,19,42,75,-33,29
Ayr,2503,1,23,5,8,94,46,48,74
Raith,2503,2,22,8,6,69,34,35,74
Alloa,2503,3,18,8,10,58,44,14,62
Arbroath,2503,4,17,9,10,72,50,22,60
Stranraer,2503,5,15,5,16,55,66,-11,50
East Fife,2503,6,14,3,19,49,64,-15,45
Airdrieon,2503,7,10,11,15,45,61,-16,41
Forfar,2503,8,11,5,20,41,64,-23,38
Albion,2503,9,8,7,21,61,82,-21,31
Queen's Park,2503,10,6,11,19,41,74,-33,29
Raith,2504,1,23,8,5,70,32,38,77
Ayr,2504,2,24,4,8,98,45,53,76
Arbroath,2504,3,18,8,10,73,49,24,62
Alloa,2504,4,17,8,11,56,45,11,59
Stranraer,2504,5,15,5,16,55,66,-11,50
East Fife,2504,6,14,3,19,49,64,-15,45
Airdrieon,2504,7,11,11,14,48,58,-10,44
Forfar,2504,8,10,5,21,38,67,-29,35
Albion,2504,9,8,6,22,60,86,-26,30
Queen's Park,2504,10,6,10,20,40,75,-35,28
Raith,2505,1,22,9,5,68,32,36,75
Ayr,2505,2,23,5,8,91,43,48,74
Arbroath,2505,3,18,8,10,71,48,23,62
Alloa,2505,4,17,9,10,56,43,13,60
Stranraer,2505,5,16,5,15,57,64,-7,53
Airdrieon,2505,6,11,11,14,47,59,-12,44
East Fife,2505,7,13,3,20,47,66,-19,42
Forfar,2505,8,10,5,21,39,66,-27,35
Albion,2505,9,8,7,21,58,79,-21,31
Queen's Park,2505,10,6,10,20,39,73,-34,28
Raith,2506,1,23,8,5,71,34,37,77
Ayr,2506,2,24,4,8,97,42,55,76
Arbroath,2506,3,18,8,10,73,50,23,62
Alloa,2506,4,17,8,11,58,46,12,59
Stranraer,2506,5,15,6,15,57,66,-9,51
Airdrieon,2506,6,11,11,14,47,59,-12,44
East Fife,2506,7,13,4,19,49,66,-17,43
Forfar,2506,8,10,5,21,39,66,-27,35
Albion,2506,9,8,6,22,57,85,-28,30
Queen's Park,2506,10,6,10,20,41,75,-34,28
Raith,2507,1,23,8,5,69,32,37,77
Ayr,2507,2,24,4,8,95,44,51,76
Arbroath,2507,3,17,9,10,72,50,22,60
Alloa,2507,4,17,8,11,56,44,12,59
Stranraer,2507,5,15,5,16,55,65,-10,50
East Fife,2507,6,14,3,19,48,64,-16,45
Airdrieon,2507,7,11,11,14,47,58,-11,44
Forfar,2507,8,10,5,21,38,66,-28,35
Albion,2507,9,8,6,22,59,83,-24,30
Queen's Park,2507,10,6,11,19,41,74,-33,29
Raith,2508,1,23,8,5,69,32,37,77
Ayr,2508,2,24,4,8,95,44,51,76
Arbroath,2508,3,18,8,10,72,49,23,62
Alloa,2508,4,17,8,11,56,44,12,59
Stranraer,2508,5,16,5,15,59,66,-7,53
Airdrieon,2508,6,10,12,14,45,58,-13,42
East Fife,2508,7,13,3,20,49,68,-19,42
Forfar,2508,8,10,6,20,38,64,-26,36
Albion,2508,9,8,6,22,59,83,-24,30
Queen's Park,2508,10,6,10,20,40,74,-34,28
Raith,2509,1,23,8,5,69,32,37,77
Ayr,2509,2,24,4,8,93,42,51,76
Arbroath,2509,3,18,8,10,74,50,24,62
Alloa,2509,4,17,8,11,56,44,12,59
Stranraer,2509,5,15,6,15,55,64,-9,51
East Fife,2509,6,13,4,19,47,64,-17,43
Airdrieon,2509,7,10,12,14,46,59,-13,42
Forfar,2509,8,10,6,20,39,65,-26,36
Albion,2509,9,8,6,22,57,81,-24,30
Queen's Park,2509,10,6,10,20,41,76,-35,28
Ayr,2510,1,24,4,8,94,44,50,76
Raith,2510,2,22,9,5,69,33,36,75
Alloa,2510,3,17,9,10,57,44,13,60
Arbroath,2510,4,17,8,11,71,50,21,59
Stranraer,2510,5,15,5,16,57,67,-10,50
East Fife,2510,6,14,3,19,50,66,-16,45
Airdrieon,2510,7,11,11,14,49,58,-9,44
Forfar,2510,8,10,5,21,38,68,-30,35
Queen's Park,2510,9,7,10,19,41,73,-32,31
Albion,2510,10,8,6,22,59,82,-23,30
Raith,2511,1,23,8,5,72,35,37,77
Ayr,2511,2,23,5,8,92,44,48,74
Arbroath,2511,3,17,9,10,71,49,22,60
Alloa,2511,4,17,8,11,59,47,12,59
Stranraer,2511,5,15,5,16,55,65,-10,50
East Fife,2511,6,14,3,19,48,64,-16,45
Airdrieon,2511,7,10,12,14,46,59,-13,42
Forfar,2511,8,10,6,20,39,65,-26,36
Albion,2511,9,8,7,21,59,80,-21,31
Queen's Park,2511,10,6,11,19,40,73,-33,29
Raith,2512,1,23,8,5,71,32,39,77
Ayr,2512,2,24,4,8,93,42,51,76
Arbroath,2512,3,18,8,10,71,48,23,62
Alloa,2512,4,17,8,11,56,46,10,59
Stranraer,2512,5,16,5,15,57,65,-8,53
Airdrieon,2512,6,11,11,14,49,59,-10,44
East Fife,2512,7,13,3,20,48,66,-18,42
Forfar,2512,8,10,5,21,39,68,-29,35
Albion,2512,9,8,6,22,57,81,-24,30
Queen's Park,2512,10,6,10,20,39,73,-34,28
Ayr,2513,1,24,4,8,93,42,51,76
Raith,2513,2,22,9,5,69,33,36,75
Arbroath,2513,3,18,8,10,74,51,23,62
Alloa,2513,4,17,9,10,57,44,13,60
Stranraer,2513,5,15,5,16,56,67,-11,50
East Fife,2513,6,14,3,19,50,65,-15,45
Airdrieon,2513,7,10,11,15,46,61,-15,41
Forfar,2513,8,11,5,20,41,65,-24,38
Albion,2513,9,8,6,22,57,81,-24,30
Queen's Park,2513,10,6,10,20,42,76,-34,28
Ayr,2514,1,24,4,8,98,42,56,76
Raith,2514,2,22,8,6,68,33,35,74
Arbroath,2514,3,18,8,10,76,50,26,62
Alloa,2514,4,18,8,10,57,43,14,62
Stranraer,2514,5,16,5,15,58,65,-7,53
East Fife,2514,6,13,3,20,48,67,-19,42
Airdrieon,2514,7,10,11,15,46,60,-14,41
Forfar,2514,8,11,5,20,40,65,-25,38
Albion,2514,9,8,6,22,57,86,-29,30
Queen's Park,2514,10,6,10,20,41,78,-37,28
Raith,2515,1,23,8,5,69,32,37,77
Ayr,2515,2,24,4,8,95,45,50,76
Arbroath,2515,3,18,8,10,73,49,24,62
Alloa,2515,4,17,8,11,56,44,12,59
Stranraer,2515,5,16,5,15,58,64,-6,53
East Fife,2515,6,13,3,20,47,67,-20,42
Airdrieon,2515,7,10,11,15,46,60,-14,41
Forfar,2515,8,11,5,20,40,65,-25,38
Albion,2515,9,8,6,22,60,83,-23,30
Queen's Park,2515,10,6,10,20,40,75,-35,28
Ayr,2516,1,24,4,8,97,42,55,76
Raith,2516,2,22,8,6,69,34,35,74
Arbroath,2516,3,18,8,10,72,49,23,62
Alloa,2516,4,18,8,10,58,44,14,62
Stranraer,2516,5,15,5,16,56,66,-10,50
East Fife,2516,6,14,3,19,49,65,-16,45
Airdrieon,2516,7,11,11,14,46,58,-12,44
Forfar,2516,8,10,5,21,38,65,-27,35
Albion,2516,9,8,6,22,57,85,-28,30
Queen's Park,2516,10,6,10,20,40,74,-34,28
Raith,2517,1,23,8,5,72,32,40,77
Ayr,2517,2,24,4,8,92,43,49,76
Arbroath,2517,3,18,8,10,73,48,25,62
Alloa,2517,4,17,8,11,56,47,9,59
Stranraer,2517,5,15,6,15,56,65,-9,51
Airdrieon,2517,6,11,11,14,48,59,-11,44
East Fife,2517,7,13,4,19,48,65,-17,43
Forfar,2517,8,10,5,21,39,67,-28,35
Albion,2517,9,8,6,22,58,80,-22,30
Queen's Park,2517,10,6,10,20,39,75,-36,28
Raith,2518,1,22,9,5,70,34,36,75
Ayr,2518,2,23,4,9,92,45,47,73
Arbroath,2518,3,18,8,10,71,48,23,62
Alloa,2518,4,17,9,10,58,45,13,60
Stranraer,2518,5,16,5,15,57,65,-8,53
Airdrieon,2518,6,10,12,14,45,58,-13,42
East Fife,2518,7,13,3,20,48,66,-18,42
Forfar,2518,8,10,6,20,38,64,-26,36
Albion,2518,9,9,6,21,60,80,-20,33
Queen's Park,2518,10,6,10,20,39,73,-34,28
Raith,2519,1,23,8,5,71,33,38,77
Ayr,2519,2,23,5,8,91,43,48,74
Arbroath,2519,3,17,8,11,70,49,21,59
Alloa,2519,4,17,8,11,57,46,11,59
Stranraer,2519,5,15,5,16,55,65,-10,50
East Fife,2519,6,14,3,19,48,64,-16,45
Airdrieon,2519,7,11,11,14,48,59,-11,44
Forfar,2519,8,10,5,21,39,67,-28,35
Albion,2519,9,8,7,21,58,79,-21,31
Queen's Park,2519,10,7,10,19,40,72,-32,31
Raith,2520,1,23,8,5,70,33,37,77
Ayr,2520,2,23,4,9,93,46,47,73
Arbroath,2520,3,18,8,10,71,48,23,62
Alloa,2520,4,17,8,11,57,45,12,59
Stranraer,2520,5,16,5,15,57,64,-7,53
Airdrieon,2520,6,10,12,14,46,59,-13,42
East Fife,2520,7,13,3,20,47,66,-19,42
Forfar,2520,8,10,6,20,39,65,-26,36
Albion,2520,9,9,6,21,61,81,-20,33
Queen's Park,2520,10,6,10,20,39,73,-34,28
Raith,2521,1,22,9,5,68,32,36,75
Ayr,2521,2,23,4,9,93,46,47,73
Arbroath,2521,3,17,9,10,71,49,22,60
Alloa,2521,4,17,9,10,56,43,13,60
Stranraer,2521,5,15,5,16,55,65,-10,50
East Fife,2521,6,14,3,19,48,64,-16,45
Airdrieon,2521,7,10,11,15,45,59,-14,41
Forfar,2521,8,11,5,20,39,64,-25,38
Albion,2521,9,9,6,21,61,81,-20,33
Queen's Park,2521,10,6,11,19,40,73,-33,29
Ayr,2522,1,24,4,8,92,42,50,76
Raith,2522,2,22,9,5,69,33,36,75
Arbroath,2522,3,18,8,10,73,49,24,62
Alloa,2522,4,17,9,10,57,44,13,60
Stranraer,2522,5,16,5,15,59,66,-7,53
Airdrieon,2522,6,10,12,14,46,59,-13,42
East Fife,2522,7,13,3,20,49,68,-19,42
Forfar,2522,8,10,6,20,39,65,-26,36
Albion,2522,9,8,6,22,57,80,-23,30
Queen's Park,2522,10,6,10,20,40,75,-35,28
Raith,2523,1,23,8,5,72,32,40,77
Ayr,2523,2,24,4,8,97,44,53,76
Arbroath,2523,3,18,8,10,72,48,24,62
Alloa,2523,4,17,8,11,56,47,9,59
Stranraer,2523,5,15,6,15,56,65,-9,51
Airdrieon,2523,6,11,11,14,49,59,-10,44
East Fife,2523,7,13,4,19,48,65,-17,43
Forfar,2523,8,10,5,21,39,68,-29,35
Albion,2523,9,8,6,22,59,85,-26,30
Queen's Park,2523,10,6,10,20,39,74,-35,28
Ayr,2524,1,24,4,8,92,42,50,76
Raith,2524,2,22,9,5,68,32,36,75
Arbroath,2524,3,18,8,10,72,49,23,62
Alloa,2524,4,17,9,10,56,43,13,60
Stranraer,2524,5,16,5,15,58,64,-6,53
Airdrieon,2524,6,11,11,14,46,58,-12,44
East Fife,2524,7,13,3,20,47,67,-20,42
Forfar,2524,8,10,5,21,38,65,-27,35
Albion,2524,9,8,6,22,57,80,-23,30
Queen's Park,2524,10,6,10,20,40,74,-34,28
Ayr,2525,1,24,4,8,94,43,51,76
Raith,2525,2,22,9,5,70,34,36,75
Arbroath,2525,3,18,8,10,72,49,23,62
Alloa,2525,4,17,9,10,58,45,13,60
Stranraer,2525,5,15,5,16,57,67,-10,50
East Fife,2525,6,14,3,19,50,66,-16,45
Airdrieon,2525,7,11,11,14,49,58,-9,44
Forfar,2525,8,10,5,21,38,68,-30,35
Albion,2525,9,8,6,22,58,82,-24,30
Queen's Park,2525,10,6,10,20,40,74,-34,28
Raith,2526,1,23,8,5,73,33,40,77
Ayr,2526,2,23,4,9,91,44,47,73
Arbroath,2526,3,18,8,10,71,48,23,62
Alloa,2526,4,17,8,11,57,48,9,59
Stranraer,2526,5,15,6,15,55,64,-9,51
East Fife,2526,6,13,4,19,47,64,-17,43
Airdrieon,2526,7,10,11,15,46,60,-14,41
Forfar,2526,8,11,5,20,40,65,-25,38
Albion,2526,9,9,6,21,59,79,-20,33
Queen's Park,2526,10,6,10,20,39,73,-34,28
Ayr,2527,1,24,4,8,95,45,50,76
Raith,2527,2,22,9,5,68,32,36,75
Alloa,2527,3,17,9,10,56,43,13,60
Arbroath,2527,4,17,8,11,71,50,21,59
Stranraer,2527,5,15,5,16,57,69,-12,50
East Fife,2527,6,14,3,19,52,66,-14,45
Airdrieon,2527,7,11,11,14,48,58,-10,44
Forfar,2527,8,10,5,21,38,67,-29,35
Queen's Park,2527,9,7,10,19,41,73,-32,31
Albion,2527,10,8,6,22,60,83,-23,30
Raith,2528,1,23,8,5,70,33,37,77
Ayr,2528,2,23,4,9,93,47,46,73
Arbroath,2528,3,18,8,10,74,50,24,62
Alloa,2528,4,17,8,11,57,45,12,59
Stranraer,2528,5,15,5,16,56,66,-10,50
East Fife,2528,6,14,3,19,49,65,-16,45
Airdrieon,2528,7,11,11,14,47,59,-12,44
Forfar,2528,8,10,5,21,39,66,-27,35
Albion,2528,9,9,6,21,62,81,-19,33
Queen's Park,2528,10,6,10,20,41,76,-35,28
Raith,2529,1,23,8,5,69,32,37,77
Ayr,2529,2,24,4,8,95,43,52,76
Arbroath,2529,3,17,8,11,71,50,21,59
Alloa,2529,4,17,8,11,56,44,12,59
Stranraer,2529,5,15,5,16,57,67,-10,50
East Fife,2529,6,14,3,19,50,66,-16,45
Airdrieon,2529,7,11,11,14,47,58,-11,44
Forfar,2529,8,10,5,21,38,66,-28,35
Queen's Park,2529,9,7,10,19,41,73,-32,31
Albion,2529,10,8,6,22,58,83,-25,30
Raith,2530,1,23,8,5,70,32,38,77
Ayr,2530,2,24,4,8,93,44,49,76
Arbroath,2530,3,17,8,11,72,51,21,59
Alloa,2530,4,17,8,11,56,45,11,59
Stranraer,2530,5,16,5,15,56,64,-8,53
Airdrieon,2530,6,11,11,14,48,58,-10,44
East Fife,2530,7,13,3,20,47,65,-18,42
Forfar,2530,8,10,5,21,38,67,-29,35
Queen's Park,2530,9,7,10,19,42,74,-32,31
Albion,2530,10,8,6,22,59,81,-22,30
Ayr,2531,1,24,4,8,92,43,49,76
Raith,2531,2,22,9,5,71,35,36,75
Arbroath,2531,3,18,8,10,75,50,25,62
Alloa,2531,4,17,9,10,59,46,13,60
Stranraer,2531,5,15,5,16,55,68,-13,50
East Fife,2531,6,14,3,19,51,64,-13,45
Airdrieon,2531,7,11,11,14,47,58,-11,44
Forfar,2531,8,10,5,21,38,66,-28,35
Albion,2531,9,8,6,22,58,80,-22,30
Queen's Park,2531,10,6,10,20,41,77,-36,28
Ayr,2532,1,24,4,8,98,42,56,76
Raith,2532,2,22,8,6,68,33,35,74
Alloa,2532,3,18,8,10,57,43,14,62
Arbroath,2532,4,17,8,11,70,50,20,59
Stranraer,2532,5,15,6,15,56,65,-9,51
East Fife,2532,6,13,4,19,48,65,-17,43
Airdrieon,2532,7,10,11,15,46,60,-14,41
Forfar,2532,8,11,5,20,40,65,-25,38
Queen's Park,2532,9,7,10,19,41,72,-31,31
Albion,2532,10,8,6,22,57,86,-29,30
Raith,2533,1,23,8,5,69,32,37,77
Ayr,2533,2,24,4,8,91,42,49,76
Arbroath,2533,3,18,8,10,72,49,23,62
Alloa,2533,4,17,8,11,56,44,12,59
Stranraer,2533,5,15,5,16,56,67,-11,50
East Fife,2533,6,14,3,19,50,65,-15,45
Airdrieon,2533,7,10,12,14,46,59,-13,42
Forfar,2533,8,10,6,20,39,65,-26,36
Albion,2533,9,8,6,22,57,79,-22,30
Queen's Park,2533,10,6,10,20,40,74,-34,28
Raith,2534,1,23,8,5,70,33,37,77
Ayr,2534,2,24,4,8,94,44,50,76
Arbroath,2534,3,18,8,10,72,49,23,62
Alloa,2534,4,17,8,11,57,45,12,59
Stranraer,2534,5,15,6,15,57,66,-9,51
East Fife,2534,6,13,4,19,49,66,-17,43
Airdrieon,2534,7,10,12,14,46,59,-13,42
Forfar,2534,8,10,6,20,39,65,-26,36
Albion,2534,9,8,6,22,59,82,-23,30
Queen's Park,2534,10,6,10,20,40,74,-34,28
Ayr,2535,1,24,4,8,96,42,54,76
Raith,2535,2,22,9,5,69,33,36,75
Arbroath,2535,3,18,8,10,72,49,23,62
Alloa,2535,4,17,9,10,57,44,13,60
Stranraer,2535,5,16,5,15,60,66,-6,53
Airdrieon,2535,6,10,12,14,45,58,-13,42
East Fife,2535,7,13,3,20,49,69,-20,42
Forfar,2535,8,10,6,20,38,64,-26,36
Albion,2535,9,8,6,22,57,84,-27,30
Queen's Park,2535,10,6,10,20,40,74,-34,28
Raith,2536,1,23,8,5,70,33,37,77
Ayr,2536,2,24,4,8,94,43,51,76
Arbroath,2536,3,18,8,10,72,49,23,62
Alloa,2536,4,17,8,11,57,45,12,59
Stranraer,2536,5,16,5,15,57,65,-8,53
East Fife,2536,6,13,3,20,48,66,-18,42
Airdrieon,2536,7,10,11,15,45,60,-15,41
Forfar,2536,8,11,5,20,40,64,-24,38
Albion,2536,9,8,6,22,58,82,-24,30
Queen's Park,2536,10,6,10,20,40,74,-34,28
Ayr,2537,1,24,4,8,97,44,53,76
Raith,2537,2,22,9,5,69,33,36,75
Arbroath,2537,3,17,9,10,71,49,22,60
Alloa,2537,4,17,9,10,57,44,13,60
Stranraer,2537,5,15,5,16,55,66,-11,50
East Fife,2537,6,14,3,19,49,64,-15,45
Airdrieon,2537,7,11,11,14,49,59,-10,44
Forfar,2537,8,10,5,21,39,68,-29,35
Albion,2537,9,8,6,22,59,85,-26,30
Queen's Park,2537,10,6,11,19,40,73,-33,29
Raith,2538,1,23,8,5,71,33,38,77
Ayr,2538,2,24,4,8,93,43,50,76
Arbroath,2538,3,18,8,10,73,49,24,62
Alloa,2538,4,17,8,11,57,46,11,59
Stranraer,2538,5,15,5,16,55,65,-10,50
East Fife,2538,6,14,3,19,48,64,-16,45
Airdrieon,2538,7,11,11,14,46,58,-12,44
Forfar,2538,8,10,5,21,38,65,-27,35
Albion,2538,9,8,6,22,58,81,-23,30
Queen's Park,2538,10,6,10,20,40,75,-35,28
Raith,2539,1,23,8,5,70,32,38,77
Ayr,2539,2,24,4,8,98,43,55,76
Arbroath,2539,3,18,8,10,71,48,23,62
Alloa,2539,4,17,8,11,56,45,11,59
Stranraer,2539,5,15,5,16,56,66,-10,50
East Fife,2539,6,14,3,19,49,65,-16,45
Airdrieon,2539,7,11,11,14,47,58,-11,44
Forfar,2539,8,10,5,21,38,66,-28,35
Albion,2539,9,8,6,22,58,86,-28,30
Queen's Park,2539,10,6,10,20,39,73,-34,28
Raith,2540,1,23,8,5,70,32,38,77
Ayr,2540,2,24,4,8,94,43,51,76
Arbroath,2540,3,18,8,10,74,49,25,62
Alloa,2540,4,17,8,11,56,45,11,59
Stranraer,2540,5,16,5,15,57,65,-8,53
East Fife,2540,6,13,3,20,48,66,-18,42
Airdrieon,2540,7,10,11,15,46,60,-14,41
Forfar,2540,8,11,5,20,40,65,-25,38
Albion,2540,9,8,6,22,58,82,-24,30
Queen's Park,2540,10,6,10,20,40,76,-36,28
Raith,2541,1,23,8,5,71,33,38,77
Ayr,2541,2,24,4,8,93,43,50,76
Arbroath,2541,3,18,8,10,73,49,24,62
Alloa,2541,4,17,8,11,57,46,11,59
Stranraer,2541,5,16,5,15,59,66,-7,53
Airdrieon,2541,6,10,12,14,47,60,-13,42
East Fife,2541,7,13,3,20,49,68,-19,42
Forfar,2541,8,10,6,20,40,66,-26,36
Albion,2541,9,8,6,22,58,81,-23,30
Queen's Park,2541,10,6,10,20,40,75,-35,28
Raith,2542,1,23,8,5,69,32,37,77
Ayr,2542,2,23,4,9,90,45,45,73
Arbroath,2542,3,18,8,10,71,48,23,62
Alloa,2542,4,17,8,11,56,44,12,59
Stranraer,2542,5,15,5,16,55,67,-12,50
East Fife,2542,6,14,3,19,50,64,-14,45
Airdrieon,2542,7,10,12,14,47,60,-13,42
Forfar,2542,8,10,6,20,40,66,-26,36
Albion,2542,9,9,6,21,60,78,-18,33
Queen's Park,2542,10,6,10,20,39,73,-34,28
Ayr,2543,1,24,4,8,95,43,52,76
Raith,2543,2,22,8,6,68,33,35,74
Arbroath,2543,3,18,8,10,72,49,23,62
Alloa,2543,4,18,8,10,57,43,14,62
Stranraer,2543,5,15,5,16,55,65,-10,50
East Fife,2543,6,14,3,19,48,64,-16,45
Airdrieon,2543,7,11,11,14,47,59,-12,44
Forfar,2543,8,10,5,21,39,66,-27,35
Albion,2543,9,8,6,22,58,83,-25,30
Queen's Park,2543,10,6,10,20,40,74,-34,28
Raith,2544,1,23,8,5,69,32,37,77
Ayr,2544,2,23,5,8,92,44,48,74
Arbroath,2544,3,17,8,11,71,51,20,59
Alloa,2544,4,17,8,11,56,44,12,59
Stranraer,2544,5,15,5,16,56,66,-10,50
East Fife,2544,6,14,3,19,49,65,-16,45
Airdrieon,2544,7,11,11,14,48,58,-10,44
Forfar,2544,8,10,5,21,38,67,-29,35
Albion,2544,9,8,7,21,59,80,-21,31
Queen's Park,2544,10,7,10,19,42,73,-31,31
Ayr,2545,1,24,4,8,95,43,52,76
Raith,2545,2,22,8,6,68,33,35,74
Arbroath,2545,3,18,8,10,73,49,24,62
Alloa,2545,4,18,8,10,57,43,14,62
Stranraer,2545,5,15,5,16,55,66,-11,50
East Fife,2545,6,14,3,19,49,64,-15,45
Airdrieon,2545,7,11,11,14,49,59,-10,44
Forfar,2545,8,10,5,21,39,68,-29,35
Albion,2545,9,8,6,22,58,83,-25,30
Queen's Park,2545,10,6,10,20,40,75,-35,28
Ayr,2546,1,24,4,8,92,43,49,76
Raith,2546,2,22,9,5,68,32,36,75
Arbroath,2546,3,17,9,10,71,49,22,60
Alloa,2546,4,17,9,10,56,43,13,60
Stranraer,2546,5,15,5,16,55,69,-14,50
East Fife,2546,6,14,3,19,52,64,-12,45
Airdrieon,2546,7,10,12,14,46,59,-13,42
Forfar,2546,8,10,6,20,39,65,-26,36
Albion,2546,9,8,6,22,58,80,-22,30
Queen's Park,2546,10,6,11,19,40,73,-33,29
Raith,2547,1,23,8,5,70,32,38,77
Ayr,2547,2,24,4,8,94,45,49,76
Arbroath,2547,3,17,9,10,72,50,22,60
Alloa,2547,4,17,8,11,56,45,11,59
Stranraer,2547,5,15,5,16,55,68,-13,50
East Fife,2547,6,14,3,19,51,64,-13,45
Airdrieon,2547,7,11,11,14,48,58,-10,44
Forfar,2547,8,10,5,21,38,67,-29,35
Albion,2547,9,8,6,22,60,82,-22,30
Queen's Park,2547,10,6,11,19,41,74,-33,29
Raith,2548,1,22,8,6,69,34,35,74
Ayr,2548,2,23,4,9,91,45,46,73
Arbroath,2548,3,18,8,10,73,49,24,62
Alloa,2548,4,18,8,10,58,44,14,62
Stranraer,2548,5,15,5,16,58,69,-11,50
East Fife,2548,6,14,3,19,52,67,-15,45
Airdrieon,2548,7,11,11,14,47,59,-12,44
Forfar,2548,8,10,5,21,39,66,-27,35
Albion,2548,9,9,6,21,60,79,-19,33
Queen's Park,2548,10,6,10,20,40,75,-35,28
Raith,2549,1,23,8,5,70,33,37,77
Ayr,2549,2,24,4,8,91,42,49,76
Arbroath,2549,3,18,8,10,73,48,25,62
Alloa,2549,4,17,8,11,57,45,12,59
Stranraer,2549,5,15,5,16,56,68,-12,50
East Fife,2549,6,14,3,19,51,65,-14,45
Airdrieon,2549,7,10,12,14,46,59,-13,42
Forfar,2549,8,10,6,20,39,65,-26,36
Albion,2549,9,8,6,22,57,79,-22,30
Queen's Park,2549,10,6,10,20,39,75,-36,28
Raith,2550,1,23,8,5,70,32,38,77
Ayr,2550,2,23,5,8,91,43,48,74
Arbroath,2550,3,17,9,10,70,48,22,60
Alloa,2550,4,17,8,11,56,45,11,59
Stranraer,2550,5,15,6,15,55,64,-9,51
East Fife,2550,6,13,4,19,47,64,-17,43
Airdrieon,2550,7,10,11,15,46,60,-14,41
Forfar,2550,8,11,5,20,40,65,-25,38
Albion,2550,9,8,7,21,58,79,-21,31
Queen's Park,2550,10,6,11,19,39,72,-33,29
Ayr,2551,1,24,4,8,97,44,53,76
Raith,2551,2,22,8,6,68,34,34,74
Alloa,2551,3,18,8,10,58,43,15,62
Arbroath,2551,4,17,8,11,72,51,21,59
Stranraer,2551,5,16,5,15,58,66,-8,53
Airdrieon,2551,6,11,11,14,47,58,-11,44
East Fife,2551,7,13,3,20,49,67,-18,42
Forfar,2551,8,10,5,21,38,66,-28,35
Queen's Park,2551,9,7,10,19,42,74,-32,31
Albion,2551,10,8,6,22,59,85,-26,30
Raith,2552,1,23,8,5,70,32,38,77
Ayr,2552,2,24,4,8,95,43,52,76
Arbroath,2552,3,18,8,10,72,49,23,62
Alloa,2552,4,17,8,11,56,45,11,59
Stranraer,2552,5,15,5,16,57,67,-10,50
East Fife,2552,6,14,3,19,50,66,-16,45
Airdrieon,2552,7,11,11,14,47,58,-11,44
Forfar,2552,8,10,5,21,38,66,-28,35
Albion,2552,9,8,6,22,58,83,-25,30
Queen's Park,2552,10,6,10,20,40,74,-34,28
Raith,2553,1,23,8,5,70,33,37,77
Ayr,2553,2,24,4,8,93,44,49,76
Arbroath,2553,3,17,9,10,71,49,22,60
Alloa,2553,4,17,8,11,57,45,12,59
Stranraer,2553,5,16,5,15,57,65,-8,53
Airdrieon,2553,6,11,11,14,47,59,-12,44
East Fife,2553,7,13,3,20,48,66,-18,42
Forfar,2553,8,10,5,21,39,66,-27,35
Albion,2553,9,8,6,22,59,81,-22,30
Queen's Park,2553,10,6,11,19,40,73,-33,29
Raith,2554,1,23,8,5,71,33,38,77
Ayr,2554,2,23,5,8,94,46,48,74
Arbroath,2554,3,17,8,11,70,50,20,59
Alloa,2554,4,17,8,11,57,46,11,59
Stranraer,2554,5,15,6,15,55,64,-9,51
East Fife,2554,6,13,4,19,47,64,-17,43
Airdrieon,2554,7,10,12,14,47,60,-13,42
Forfar,2554,8,10,6,20,40,66,-26,36
Albion,2554,9,8,7,21,61,82,-21,31
Queen's Park,2554,10,7,10,19,41,72,-31,31
Ayr,2555,1,24,4,8,94,42,52,76
Raith,2555,2,22,8,6,69,34,35,74
Alloa,2555,3,18,8,10,58,44,14,62
Arbroath,2555,4,17,9,10,70,48,22,60
Stranraer,2555,5,15,5,16,56,68,-12,50
East Fife,2555,6,14,3,19,51,65,-14,45
Airdrieon,2555,7,11,11,14,47,59,-12,44
Forfar,2555,8,10,5,21,39,66,-27,35
Albion,2555,9,8,6,22,57,82,-25,30
Queen's Park,2555,10,6,11,19,39,72,-33,29
Ayr,2556,1,24,4,8,94,44,50,76
Raith,2556,2,22,9,5,72,36,36,75
Alloa,2556,3,17,9,10,60,47,13,60
Arbroath,2556,4,17,8,11,70,49,21,59
Stranraer,2556,5,15,5,16,57,67,-10,50
East Fife,2556,6,14,3,19,50,66,-16,45
Airdrieon,2556,7,11,11,14,46,58,-12,44
Forfar,2556,8,10,5,21,38,65,-27,35
Queen's Park,2556,9,7,10,19,40,72,-32,31
Albion,2556,10,8,6,22,59,82,-23,30
Raith,2557,1,23,8,5,69,32,37,77
Ayr,2557,2,24,4,8,96,44,52,76
Arbroath,2557,3,18,8,10,73,48,25,62
Alloa,2557,4,17,8,11,56,44,12,59
Stranraer,2557,5,15,5,16,55,65,-10,50
East Fife,2557,6,14,3,19,48,64,-16,45
Airdrieon,2557,7,11,11,14,46,58,-12,44
Forfar,2557,8,10,5,21,38,65,-27,35
Albion,2557,9,8,6,22,59,84,-25,30
Queen's Park,2557,10,6,10,20,39,75,-36,28
Ayr,2558,1,24,4,8,96,42,54,76
Raith,2558,2,22,9,5,68,32,36,75
Arbroath,2558,3,18,8,10,72,49,23,62
Alloa,2558,4,17,9,10,56,43,13,60
Stranraer,2558,5,15,6,15,57,66,-9,51
Airdrieon,2558,6,11,11,14,47,59,-12,44
East Fife,2558,7,13,4,19,49,66,-17,43
Forfar,2558,8,10,5,21,39,66,-27,35
Albion,2558,9,8,6,22,57,84,-27,30
Queen's Park,2558,10,6,10,20,40,74,-34,28
Raith,2559,1,23,8,5,71,33,38,77
Ayr,2559,2,24,4,8,93,43,50,76
Arbroath,2559,3,17,9,10,72,50,22,60
Alloa,2559,4,17,8,11,57,46,11,59
Stranraer,2559,5,15,6,15,56,65,-9,51
Airdrieon,2559,6,11,11,14,46,58,-12,44
East Fife,2559,7,13,4,19,48,65,-17,43
Forfar,2559,8,10,5,21,38,65,-27,35
Albion,2559,9,8,6,22,58,81,-23,30
Queen's Park,2559,10,6,11,19,41,74,-33,29
Ayr,2560,1,24,4,8,91,42,49,76
Raith,2560,2,22,8,6,69,34,35,74
Arbroath,2560,3,18,8,10,73,50,23,62
Alloa,2560,4,18,8,10,58,44,14,62
Stranraer,2560,5,16,5,15,57,65,-8,53
East Fife,2560,6,13,3,20,48,66,-18,42
Airdrieon,2560,7,10,11,15,45,59,-14,41
Forfar,2560,8,11,5,20,39,64,-25,38
Albion,2560,9,8,6,22,57,79,-22,30
Queen's Park,2560,10,6,10,20,41,75,-34,28
Ayr,2561,1,24,4,8,99,44,55,76
Raith,2561,2,22,9,5,68,32,36,75
Alloa,2561,3,17,9,10,56,43,13,60
Arbroath,2561,4,17,8,11,70,49,21,59
Stranraer,2561,5,15,5,16,56,66,-10,50
East Fife,2561,6,14,3,19,49,65,-16,45
Airdrieon,2561,7,11,11,14,47,58,-11,44
Forfar,2561,8,10,5,21,38,66,-28,35
Queen's Park,2561,9,7,10,19,40,72,-32,31
Albion,2561,10,8,6,22,59,87,-28,30
Ayr,2562,1,24,4,8,94,42,52,76
Raith,2562,2,22,8,6,68,34,34,74
Alloa,2562,3,18,8,10,58,43,15,62
Arbroath,2562,4,17,9,10,71,49,22,60
Stranraer,2562,5,15,6,15,57,66,-9,51
East Fife,2562,6,13,4,19,49,66,-17,43
Airdrieon,2562,7,10,11,15,45,60,-15,41
Forfar,2562,8,11,5,20,40,64,-24,38
Albion,2562,9,8,6,22,57,82,-25,30
Queen's Park,2562,10,6,11,19,40,73,-33,29
Ayr,2563,1,24,4,8,94,42,52,76
Raith,2563,2,22,9,5,69,33,36,75
Alloa,2563,3,17,9,10,57,44,13,60
Arbroath,2563,4,17,8,11,72,52,20,59
Stranraer,2563,5,15,6,15,57,66,-9,51
East Fife,2563,6,13,4,19,49,66,-17,43
Airdrieon,2563,7,10,11,15,45,59,-14,41
Forfar,2563,8,11,5,20,39,64,-25,38
Queen's Park,2563,9,7,10,19,43,74,-31,31
Albion,2563,10,8,6,22,57,82,-25,30
Raith,2564,1,23,8,5,69,32,37,77
Ayr,2564,2,23,5,8,91,43,48,74
Arbroath,2564,3,18,8,10,73,49,24,62
Alloa,2564,4,17,8,11,56,44,12,59
Stranraer,2564,5,15,5,16,56,66,-10,50
East Fife,2564,6,14,3,19,49,65,-16,45
Airdrieon,2564,7,10,12,14,47,60,-13,42
Forfar,2564,8,10,6,20,40,66,-26,36
Albion,2564,9,8,7,21,58,79,-21,31
Queen's Park,2564,10,6,10,20,40,75,-35,28
Ayr,2565,1,24,4,8,93,43,50,76
Raith,2565,2,22,9,5,70,34,36,75
Arbroath,2565,3,18,8,10,72,48,24,62
Alloa,2565,4,17,9,10,58,45,13,60
Stranraer,2565,5,15,6,15,56,65,-9,51
East Fife,2565,6,13,4,19,48,65,-17,43
Airdrieon,2565,7,10,12,14,45,58,-13,42
Forfar,2565,8,10,6,20,38,64,-26,36
Albion,2565,9,8,6,22,58,81,-23,30
Queen's Park,2565,10,6,10,20,39,74,-35,28
Raith,2566,1,23,8,5,72,33,39,77
Ayr,2566,2,24,4,8,91,42,49,76
Arbroath,2566,3,18,8,10,72,48,24,62
Alloa,2566,4,17,8,11,57,47,10,59
Stranraer,2566,5,15,5,16,55,66,-11,50
East Fife,2566,6,14,3,19,49,64,-15,45
Airdrieon,2566,7,11,11,14,47,59,-12,44
Forfar,2566,8,10,5,21,39,66,-27,35
Albion,2566,9,8,6,22,57,79,-22,30
Queen's Park,2566,10,6,10,20,39,74,-35,28
Ayr,2567,1,24,4,8,95,42,53,76
Raith,2567,2,22,8,6,69,34,35,74
Alloa,2567,3,18,8,10,58,44,14,62
Arbroath,2567,4,17,9,10,71,49,22,60
Stranraer,2567,5,16,5,15,59,66,-7,53
Airdrieon,2567,6,11,11,14,48,58,-10,44
East Fife,2567,7,13,3,20,49,68,-19,42
Forfar,2567,8,10,5,21,38,67,-29,35
Albion,2567,9,8,6,22,57,83,-26,30
Queen's Park,2567,10,6,11,19,40,73,-33,29
Raith,2568,1,23,8,5,70,32,38,77
Ayr,2568,2,24,4,8,92,43,49,76
Arbroath,2568,3,18,8,10,72,49,23,62
Alloa,2568,4,17,8,11,56,45,11,59
Stranraer,2568,5,15,6,15,56,65,-9,51
East Fife,2568,6,13,4,19,48,65,-17,43
Airdrieon,2568,7,10,12,14,47,60,-13,42
Forfar,2568,8,10,6,20,40,66,-26,36
Albion,2568,9,8,6,22,58,80,-22,30
Queen's Park,2568,10,6,10,20,40,74,-34,28
Raith,2569,1,23,8,5,70,33,37,77
Ayr,2569,2,23,5,8,90,42,48,74
Arbroath,2569,3,18,8,10,72,49,23,62
Alloa,2569,4,17,8,11,57,45,12,59
Stranraer,2569,5,15,5,16,55,65,-10,50
East Fife,2569,6,14,3,19,48,64,-16,45
Airdrieon,2569,7,10,12,14,46,59,-13,42
Forfar,2569,8,10,6,20,39,65,-26,36
Albion,2569,9,8,7,21,57,78,-21,31
Queen's Park,2569,10,6,10,20,40,74,-34,28
Ayr,2570,1,24,4,8,93,44,49,76
Raith,2570,2,22,9,5,69,33,36,75
Arbroath,2570,3,17,9,10,71,49,22,60
Alloa,2570,4,17,9,10,57,44,13,60
Stranraer,2570,5,15,5,16,56,66,-10,50
East Fife,2570,6,14,3,19,49,65,-16,45
Airdrieon,2570,7,10,12,14,47,60,-13,42
Forfar,2570,8,10,6,20,40,66,-26,36
Albion,2570,9,8,6,22,59,81,-22,30
Queen's Park,2570,10,6,11,19,40,73,-33,29
Ayr,2571,1,24,4,8,93,42,51,76
Raith,2571,2,22,8,6,71,36,35,74
Alloa,2571,3,18,8,10,60,46,14,62
Arbroath,2571,4,17,9,10,71,49,22,60
Stranraer,2571,5,15,5,16,56,67,-11,50
East Fife,2571,6,14,3,19,50,65,-15,45
Airdrieon,2571,7,11,11,14,47,59,-12,44
Forfar,2571,8,10,5,21,39,66,-27,35
Albion,2571,9,8,6,22,57,81,-24,30
Queen's Park,2571,10,6,11,19,40,73,-33,29
Ayr,2572,1,24,4,8,91,42,49,76
Raith,2572,2,22,9,5,69,33,36,75
Arbroath,2572,3,18,8,10,73,48,25,62
Alloa,2572,4,17,9,10,57,44,13,60
Stranraer,2572,5,15,6,15,57,66,-9,51
Airdrieon,2572,6,11,11,14,47,58,-11,44
East Fife,2572,7,13,4,19,49,66,-17,43
Forfar,2572,8,10,5,21,38,66,-28,35
Albion,2572,9,8,6,22,57,79,-22,30
Queen's Park,2572,10,6,10,20,39,75,-36,28
Ayr,2573,1,24,4,8,94,43,51,76
Raith,2573,2,22,9,5,68,32,36,75
Arbroath,2573,3,17,9,10,70,48,22,60
Alloa,2573,4,17,9,10,56,43,13,60
Stranraer,2573,5,15,5,16,56,66,-10,50
East Fife,2573,6,14,3,19,49,65,-16,45
Airdrieon,2573,7,10,11,15,45,59,-14,41
Forfar,2573,8,11,5,20,39,64,-25,38
Albion,2573,9,8,6,22,58,82,-24,30
Queen's Park,2573,10,6,11,19,39,72,-33,29
Ayr,2574,1,24,4,8,93,44,49,76
Raith,2574,2,22,9,5,69,33,36,75
Arbroath,2574,3,18,8,10,73,48,25,62
Alloa,2574,4,17,9,10,57,44,13,60
Stranraer,2574,5,16,5,15,59,64,-5,53
Airdrieon,2574,6,10,12,14,46,59,-13,42
East Fife,2574,7,13,3,20,47,68,-21,42
Forfar,2574,8,10,6,20,39,65,-26,36
Albion,2574,9,8,6,22,59,81,-22,30
Queen's Park,2574,10,6,10,20,39,75,-36,28
Ayr,2575,1,24,4,8,94,43,51,76
Raith,2575,2,22,8,6,68,33,35,74
Alloa,2575,3,18,8,10,57,43,14,62
Arbroath,2575,4,17,9,10,71,49,22,60
Stranraer,2575,5,16,5,15,57,64,-7,53
East Fife,2575,6,13,3,20,47,66,-19,42
Airdrieon,2575,7,10,11,15,45,61,-16,41
Forfar,2575,8,11,5,20,41,64,-23,38
Albion,2575,9,8,6,22,58,82,-24,30
Queen's Park,2575,10,6,11,19,40,73,-33,29
Ayr,2576,1,24,4,8,94,43,51,76
Raith,2576,2,22,9,5,70,34,36,75
Arbroath,2576,3,17,9,10,71,49,22,60
Alloa,2576,4,17,9,10,58,45,13,60
Stranraer,2576,5,15,6,15,56,65,-9,51
East Fife,2576,6,13,4,19,48,65,-17,43
Airdrieon,2576,7,10,11,15,46,62,-16,41
Forfar,2576,8,11,5,20,42,65,-23,38
Albion,2576,9,8,6,22,58,82,-24,30
Queen's Park,2576,10,6,11,19,40,73,-33,29
Ayr,2577,1,24,4,8,93,42,51,76
Raith,2577,2,22,9,5,69,33,36,75
Arbroath,2577,3,18,8,10,72,48,24,62
Alloa,2577,4,17,9,10,57,44,13,60
Stranraer,2577,5,15,5,16,56,66,-10,50
East Fife,2577,6,14,3,19,49,65,-16,45
Airdrieon,2577,7,11,11,14,48,58,-10,44
Forfar,2577,8,10,5,21,38,67,-29,35
Albion,2577,9,8,6,22,57,81,-24,30
Queen's Park,2577,10,6,10,20,39,74,-35,28
Raith,2578,1,23,8,5,70,32,38,77
Ayr,2578,2,24,4,8,94,42,52,76
Arbroath,2578,3,17,8,11,71,52,19,59
Alloa,2578,4,17,8,11,56,45,11,59
Stranraer,2578,5,16,5,15,57,64,-7,53
Airdrieon,2578,6,11,11,14,49,58,-9,44
East Fife,2578,7,13,3,20,47,66,-19,42
Forfar,2578,8,10,5,21,38,68,-30,35
Queen's Park,2578,9,7,10,19,43,73,-30,31
Albion,2578,10,8,6,22,57,82,-25,30
Ayr,2579,1,24,4,8,93,44,49,76
Raith,2579,2,22,9,5,70,34,36,75
Arbroath,2579,3,18,8,10,71,48,23,62
Alloa,2579,4,17,9,10,58,45,13,60
Stranraer,2579,5,15,5,16,56,66,-10,50
East Fife,2579,6,14,3,19,49,65,-16,45
Airdrieon,2579,7,11,11,14,47,58,-11,44
Forfar,2579,8,10,5,21,38,66,-28,35
Albion,2579,9,8,6,22,59,81,-22,30
Queen's Park,2579,10,6,10,20,39,73,-34,28
Raith,2580,1,23,8,5,70,33,37,77
Ayr,2580,2,24,4,8,96,42,54,76
Arbroath,2580,3,18,8,10,71,48,23,62
Alloa,2580,4,17,8,11,57,45,12,59
Stranraer,2580,5,15,6,15,56,65,-9,51
East Fife,2580,6,13,4,19,48,65,-17,43
Airdrieon,2580,7,10,12,14,46,59,-13,42
Forfar,2580,8,10,6,20,39,65,-26,36
Albion,2580,9,8,6,22,57,84,-27,30
Queen's Park,2580,10,6,10,20,39,73,-34,28
Raith,2581,1,23,8,5,70,33,37,77
Ayr,2581,2,23,4,9,90,44,46,73
Arbroath,2581,3,17,8,11,70,49,21,59
Alloa,2581,4,17,8,11,57,45,12,59
Stranraer,2581,5,15,6,15,56,65,-9,51
East Fife,2581,6,13,4,19,48,65,-17,43
Airdrieon,2581,7,10,12,14,47,60,-13,42
Forfar,2581,8,10,6,20,40,66,-26,36
Albion,2581,9,9,6,21,59,78,-19,33
Queen's Park,2581,10,7,10,19,40,72,-32,31
Raith,2582,1,23,8,5,71,34,37,77
Ayr,2582,2,24,4,8,94,44,50,76
Arbroath,2582,3,18,8,10,72,48,24,62
Alloa,2582,4,17,8,11,58,46,12,59
Stranraer,2582,5,16,5,15,56,64,-8,53
East Fife,2582,6,13,3,20,47,65,-18,42
Airdrieon,2582,7,10,11,15,46,60,-14,41
Forfar,2582,8,11,5,20,40,65,-25,38
Albion,2582,9,8,6,22,59,82,-23,30
Queen's Park,2582,10,6,10,20,39,74,-35,28
Raith,2583,1,23,8,5,70,33,37,77
Ayr,2583,2,24,4,8,94,42,52,76
Arbroath,2583,3,17,8,11,70,52,18,59
Alloa,2583,4,17,8,11,57,45,12,59
Stranraer,2583,5,15,6,15,56,65,-9,51
Airdrieon,2583,6,11,11,14,48,59,-11,44
East Fife,2583,7,13,4,19,48,65,-17,43
Forfar,2583,8,10,5,21,39,67,-28,35
Queen's Park,2583,9,7,10,19,43,72,-29,31
Albion,2583,10,8,6,22,57,82,-25,30
Ayr,2584,1,24,4,8,93,42,51,76
Raith,2584,2,22,9,5,68,32,36,75
Arbroath,2584,3,18,8,10,74,49,25,62
Alloa,2584,4,17,9,10,56,43,13,60
Stranraer,2584,5,15,5,16,56,66,-10,50
East Fife,2584,6,14,3,19,49,65,-16,45
Airdrieon,2584,7,11,11,14,46,58,-12,44
Forfar,2584,8,10,5,21,38,65,-27,35
Albion,2584,9,8,6,22,57,81,-24,30
Queen's Park,2584,10,6,10,20,40,76,-36,28
Ayr,2585,1,24,4,8,98,42,56,76
Raith,2585,2,22,9,5,69,33,36,75
Arbroath,2585,3,18,8,10,74,49,25,62
Alloa,2585,4,17,9,10,57,44,13,60
Stranraer,2585,5,15,6,15,57,66,-9,51
Airdrieon,2585,6,11,11,14,48,59,-11,44
East Fife,2585,7,13,4,19,49,66,-17,43
Forfar,2585,8,10,5,21,39,67,-28,35
Albion,2585,9,8,6,22,57,86,-29,30
Queen's Park,2585,10,6,10,20,40,76,-36,28
Ayr,2586,1,24,4,8,93,42,51,76
Raith,2586,2,22,8,6,68,34,34,74
Arbroath,2586,3,18,8,10,74,51,23,62
Alloa,2586,4,18,8,10,58,43,15,62
Stranraer,2586,5,15,5,16,56,68,-12,50
East Fife,2586,6,14,3,19,51,65,-14,45
Airdrieon,2586,7,10,11,15,45,59,-14,41
Forfar,2586,8,11,5,20,39,64,-25,38
Albion,2586,9,8,6,22,57,81,-24,30
Queen's Park,2586,10,6,10,20,42,76,-34,28
Raith,2587,1,22,9,5,68,32,36,75
Ayr,2587,2,23,4,9,92,47,45,73
Alloa,2587,3,17,9,10,56,43,13,60
Arbroath,2587,4,17,8,11,74,53,21,59
Stranraer,2587,5,15,5,16,55,66,-11,50
East Fife,2587,6,14,3,19,49,64,-15,45
Airdrieon,2587,7,10,11,15,45,59,-14,41
Forfar,2587,8,11,5,20,39,64,-25,38
Albion,2587,9,9,6,21,62,80,-18,33
Queen's Park,2587,10,7,10,19,44,76,-32,31
Raith,2588,1,23,8,5,73,34,39,77
Ayr,2588,2,24,4,8,94,44,50,76
Arbroath,2588,3,17,8,11,70,51,19,59
Alloa,2588,4,17,8,11,58,48,10,59
Stranraer,2588,5,16,5,15,57,65,-8,53
East Fife,2588,6,13,3,20,48,66,-18,42
Airdrieon,2588,7,10,11,15,46,61,-15,41
Forfar,2588,8,11,5,20,41,65,-24,38
Queen's Park,2588,9,7,10,19,42,72,-30,31
Albion,2588,10,8,6,22,59,82,-23,30
Ayr,2589,1,24,4,8,95,44,51,76
Raith,2589,2,22,9,5,69,33,36,75
Arbroath,2589,3,18,8,10,73,48,25,62
Alloa,2589,4,17,9,10,57,44,13,60
Stranraer,2589,5,15,5,16,56,66,-10,50
East Fife,2589,6,14,3,19,49,65,-16,45
Airdrieon,2589,7,11,11,14,47,58,-11,44
Forfar,2589,8,10,5,21,38,66,-28,35
Albion,2589,9,8,6,22,59,83,-24,30
Queen's Park,2589,10,6,10,20,39,75,-36,28
Raith,2590,1,23,8,5,72,34,38,77
Ayr,2590,2,24,4,8,94,42,52,76
Arbroath,2590,3,17,8,11,71,50,21,59
Alloa,2590,4,17,8,11,58,47,11,59
Stranraer,2590,5,15,5,16,55,67,-12,50
East Fife,2590,6,14,3,19,50,64,-14,45
Airdrieon,2590,7,11,11,14,46,58,-12,44
Forfar,2590,8,10,5,21,38,65,-27,35
Queen's Park,2590,9,7,10,19,41,73,-32,31
Albion,2590,10,8,6,22,57,82,-25,30
Ayr,2591,1,24,4,8,92,43,49,76
Raith,2591,2,22,8,6,69,34,35,74
Alloa,2591,3,18,8,10,58,44,14,62
Arbroath,2591,4,17,9,10,71,49,22,60
Stranraer,2591,5,15,5,16,56,66,-10,50
East Fife,2591,6,14,3,19,49,65,-16,45
Airdrieon,2591,7,11,11,14,50,61,-11,44
Forfar,2591,8,10,5,21,41,69,-28,35
Albion,2591,9,8,6,22,58,80,-22,30
Queen's Park,2591,10,6,11,19,40,73,-33,29
Ayr,2592,1,24,4,8,96,45,51,76
Raith,2592,2,22,8,6,68,33,35,74
Alloa,2592,3,18,8,10,57,43,14,62
Arbroath,2592,4,17,8,11,71,51,20,59
Stranraer,2592,5,15,5,16,57,68,-11,50
East Fife,2592,6,14,3,19,51,66,-15,45
Airdrieon,2592,7,11,11,14,49,59,-10,44
Forfar,2592,8,10,5,21,39,68,-29,35
Queen's Park,2592,9,7,10,19,42,73,-31,31
Albion,2592,10,8,6,22,60,84,-24,30
Raith,2593,1,23,8,5,73,33,40,77
Ayr,2593,2,24,4,8,95,42,53,76
Arbroath,2593,3,17,8,11,72,51,21,59
Alloa,2593,4,17,8,11,57,48,9,59
Stranraer,2593,5,15,6,15,57,66,-9,51
East Fife,2593,6,13,4,19,49,66,-17,43
Airdrieon,2593,7,10,12,14,45,58,-13,42
Forfar,2593,8,10,6,20,38,64,-26,36
Queen's Park,2593,9,7,10,19,42,74,-32,31
Albion,2593,10,8,6,22,57,83,-26,30
Raith,2594,1,23,8,5,70,32,38,77
Ayr,2594,2,24,4,8,93,43,50,76
Arbroath,2594,3,17,9,10,72,50,22,60
Alloa,2594,4,17,8,11,56,45,11,59
Stranraer,2594,5,16,5,15,57,64,-7,53
Airdrieon,2594,6,11,11,14,46,58,-12,44
East Fife,2594,7,13,3,20,47,66,-19,42
Forfar,2594,8,10,5,21,38,65,-27,35
Albion,2594,9,8,6,22,58,81,-23,30
Queen's Park,2594,10,6,11,19,41,74,-33,29
Raith,2595,1,23,8,5,69,32,37,77
Ayr,2595,2,24,4,8,95,42,53,76
Arbroath,2595,3,18,8,10,71,48,23,62
Alloa,2595,4,17,8,11,56,44,12,59
Stranraer,2595,5,15,6,15,56,65,-9,51
Airdrieon,2595,6,11,11,14,46,58,-12,44
East Fife,2595,7,13,4,19,48,65,-17,43
Forfar,2595,8,10,5,21,38,65,-27,35
Albion,2595,9,8,6,22,57,83,-26,30
Queen's Park,2595,10,6,10,20,39,73,-34,28
Raith,2596,1,23,8,5,70,32,38,77
Ayr,2596,2,24,4,8,91,42,49,76
Arbroath,2596,3,18,8,10,75,50,25,62
Alloa,2596,4,17,8,11,56,45,11,59
Stranraer,2596,5,15,5,16,55,65,-10,50
East Fife,2596,6,14,3,19,48,64,-16,45
Airdrieon,2596,7,11,11,14,48,59,-11,44
Forfar,2596,8,10,5,21,39,67,-28,35
Albion,2596,9,8,6,22,57,79,-22,30
Queen's Park,2596,10,6,10,20,41,77,-36,28
Ayr,2597,1,24,4,8,96,43,53,76
Raith,2597,2,22,9,5,68,32,36,75
Arbroath,2597,3,18,8,10,71,48,23,62
Alloa,2597,4,17,9,10,56,43,13,60
Stranraer,2597,5,16,5,15,56,64,-8,53
Airdrieon,2597,6,10,12,14,47,60,-13,42
East Fife,2597,7,13,3,20,47,65,-18,42
Forfar,2597,8,10,6,20,40,66,-26,36
Albion,2597,9,8,6,22,58,84,-26,30
Queen's Park,2597,10,6,10,20,39,73,-34,28
Raith,2598,1,23,8,5,70,32,38,77
Ayr,2598,2,24,4,8,94,44,50,76
Arbroath,2598,3,18,8,10,73,50,23,62
Alloa,2598,4,17,8,11,56,45,11,59
Stranraer,2598,5,16,5,15,59,65,-6,53
Airdrieon,2598,6,10,12,14,46,59,-13,42
East Fife,2598,7,13,3,20,48,68,-20,42
Forfar,2598,8,10,6,20,39,65,-26,36
Albion,2598,9,8,6,22,59,82,-23,30
Queen's Park,2598,10,6,10,20,41,75,-34,28
Ayr,2599,1,24,4,8,93,43,50,76
Raith,2599,2,22,9,5,71,35,36,75
Arbroath,2599,3,18,8,10,72,49,23,62
Alloa,2599,4,17,9,10,59,46,13,60
Stranraer,2599,5,15,6,15,56,65,-9,51
Airdrieon,2599,6,11,11,14,49,58,-9,44
East Fife,2599,7,13,4,19,48,65,-17,43
Forfar,2599,8,10,5,21,38,68,-30,35
Albion,2599,9,8,6,22,58,81,-23,30
Queen's Park,2599,10,6,10,20,40,74,-34,28
Raith,2600,1,22,8,6,68,34,34,74
Ayr,2600,2,23,4,9,93,46,47,73
Arbroath,2600,3,18,8,10,72,49,23,62
Alloa,2600,4,18,8,10,58,43,15,62
Stranraer,2600,5,15,5,16,55,67,-12,50
East Fife,2600,6,14,3,19,50,64,-14,45
Airdrieon,2600,7,10,12,14,46,59,-13,42
Forfar,2600,8,10,6,20,39,65,-26,36
Albion,2600,9,9,6,21,61,81,-20,33
Queen's Park,2600,10,6,10,20,40,74,-34,28
Raith,2601,1,23,8,5,73,32,41,77
Ayr,2601,2,24,4,8,93,42,51,76
Arbroath,2601,3,17,9,10,72,50,22,60
Alloa,2601,4,17,8,11,56,48,8,59
Stranraer,2601,5,16,5,15,57,65,-8,53
Airdrieon,2601,6,11,11,14,47,59,-12,44
East Fife,2601,7,13,3,20,48,66,-18,42
Forfar,2601,8,10,5,21,39,66,-27,35
Albion,2601,9,8,6,22,57,81,-24,30
Queen's Park,2601,10,6,11,19,41,74,-33,29
Raith,2602,1,23,8,5,70,32,38,77
Ayr,2602,2,24,4,8,93,42,51,76
Arbroath,2602,3,18,8,10,73,50,23,62
Alloa,2602,4,17,8,11,56,45,11,59
Stranraer,2602,5,15,5,16,55,65,-10,50
East Fife,2602,6,14,3,19,48,64,-16,45
Airdrieon,2602,7,10,12,14,45,58,-13,42
Forfar,2602,8,10,6,20,38,64,-26,36
Albion,2602,9,8,6,22,57,81,-24,30
Queen's Park,2602,10,6,10,20,41,75,-34,28
Raith,2603,1,23,8,5,70,33,37,77
Ayr,2603,2,24,4,8,93,44,49,76
Arbroath,2603,3,17,8,11,71,50,21,59
Alloa,2603,4,17,8,11,57,45,12,59
Stranraer,2603,5,16,5,15,57,64,-7,53
Airdrieon,2603,6,11,11,14,48,58,-10,44
East Fife,2603,7,13,3,20,47,66,-19,42
Forfar,2603,8,10,5,21,38,67,-29,35
Queen's Park,2603,9,7,10,19,41,73,-32,31
Albion,2603,10,8,6,22,59,81,-22,30
Raith,2604,1,22,8,6,68,34,34,74
Ayr,2604,2,23,4,9,92,45,47,73
Arbroath,2604,3,18,8,10,74,48,26,62
Alloa,2604,4,18,8,10,58,43,15,62
Stranraer,2604,5,15,6,15,57,66,-9,51
East Fife,2604,6,13,4,19,49,66,-17,43
Airdrieon,2604,7,10,12,14,47,60,-13,42
Forfar,2604,8,10,6,20,40,66,-26,36
Albion,2604,9,9,6,21,60,80,-20,33
Queen's Park,2604,10,6,10,20,39,76,-37,28
Ayr,2605,1,24,4,8,92,43,49,76
Raith,2605,2,22,9,5,69,33,36,75
Alloa,2605,3,17,9,10,57,44,13,60
Arbroath,2605,4,17,8,11,71,50,21,59
Stranraer,2605,5,15,5,16,56,66,-10,50
East Fife,2605,6,14,3,19,49,65,-16,45
Airdrieon,2605,7,10,11,15,45,60,-15,41
Forfar,2605,8,11,5,20,40,64,-24,38
Queen's Park,2605,9,7,10,19,41,73,-32,31
Albion,2605,10,8,6,22,58,80,-22,30
Raith,2606,1,22,9,5,68,32,36,75
Ayr,2606,2,23,5,8,91,43,48,74
Arbroath,2606,3,18,8,10,73,50,23,62
Alloa,2606,4,17,9,10,56,43,13,60
Stranraer,2606,5,15,5,16,58,69,-11,50
East Fife,2606,6,14,3,19,52,67,-15,45
Airdrieon,2606,7,10,11,15,46,60,-14,41
Forfar,2606,8,11,5,20,40,65,-25,38
Albion,2606,9,8,7,21,58,79,-21,31
Queen's Park,2606,10,6,10,20,41,75,-34,28
Ayr,2607,1,24,4,8,93,43,50,76
Raith,2607,2,22,8,6,69,34,35,74
Arbroath,2607,3,18,8,10,72,49,23,62
Alloa,2607,4,18,8,10,58,44,14,62
Stranraer,2607,5,16,5,15,57,65,-8,53
Airdrieon,2607,6,11,11,14,46,58,-12,44
East Fife,2607,7,13,3,20,48,66,-18,42
Forfar,2607,8,10,5,21,38,65,-27,35
Albion,2607,9,8,6,22,58,81,-23,30
Queen's Park,2607,10,6,10,20,40,74,-34,28
Raith,2608,1,23,8,5,70,32,38,77
Ayr,2608,2,24,4,8,93,43,50,76
Arbroath,2608,3,18,8,10,71,48,23,62
Alloa,2608,4,17,8,11,56,45,11,59
Stranraer,2608,5,15,6,15,56,65,-9,51
Airdrieon,2608,6,11,11,14,46,58,-12,44
East Fife,2608,7,13,4,19,48,65,-17,43
Forfar,2608,8,10,5,21,38,65,-27,35
Albion,2608,9,8,6,22,58,81,-23,30
Queen's Park,2608,10,6,10,20,39,73,-34,28
Raith,2609,1,23,8,5,72,34,38,77
Ayr,2609,2,24,4,8,92,43,49,76
Arbroath,2609,3,17,8,11,71,52,19,59
Alloa,2609,4,17,8,11,58,47,11,59
Stranraer,2609,5,15,5,16,56,68,-12,50
East Fife,2609,6,14,3,19,51,65,-14,45
Airdrieon,2609,7,11,11,14,50,59,-9,44
Forfar,2609,8,10,5,21,39,69,-30,35
Queen's Park,2609,9,7,10,19,43,73,-30,31
Albion,2609,10,8,6,22,58,80,-22,30
Raith,2610,1,23,8,5,70,33,37,77
Ayr,2610,2,24,4,8,93,42,51,76
Arbroath,2610,3,17,8,11,71,50,21,59
Alloa,2610,4,17,8,11,57,45,12,59
Stranraer,2610,5,15,5,16,57,69,-12,50
East Fife,2610,6,14,3,19,52,66,-14,45
Airdrieon,2610,7,11,11,14,46,58,-12,44
Forfar,2610,8,10,5,21,38,65,-27,35
Queen's Park,2610,9,7,10,19,41,73,-32,31
Albion,2610,10,8,6,22,57,81,-24,30
Ayr,2611,1,24,4,8,94,42,52,76
Raith,2611,2,22,9,5,70,34,36,75
Arbroath,2611,3,18,8,10,71,48,23,62
Alloa,2611,4,17,9,10,58,45,13,60
Stranraer,2611,5,15,5,16,56,66,-10,50
East Fife,2611,6,14,3,19,49,65,-16,45
Airdrieon,2611,7,11,11,14,49,59,-10,44
Forfar,2611,8,10,5,21,39,68,-29,35
Albion,2611,9,8,6,22,57,82,-25,30
Queen's Park,2611,10,6,10,20,39,73,-34,28
Raith,2612,1,23,8,5,72,32,40,77
Ayr,2612,2,24,4,8,94,42,52,76
Arbroath,2612,3,17,8,11,71,50,21,59
Alloa,2612,4,17,8,11,56,47,9,59
Stranraer,2612,5,16,5,15,58,65,-7,53
East Fife,2612,6,13,3,20,48,67,-19,42
Airdrieon,2612,7,10,11,15,45,59,-14,41
Forfar,2612,8,11,5,20,39,64,-25,38
Queen's Park,2612,9,7,10,19,41,73,-32,31
Albion,2612,10,8,6,22,57,82,-25,30
Raith,2613,1,23,8,5,71,32,39,77
Ayr,2613,2,23,5,8,92,44,48,74
Arbroath,2613,3,17,8,11,70,49,21,59
Alloa,2613,4,17,8,11,56,46,10,59
Stranraer,2613,5,15,5,16,56,67,-11,50
East Fife,2613,6,14,3,19,50,65,-15,45
Airdrieon,2613,7,11,11,14,46,58,-12,44
Forfar,2613,8,10,5,21,38,65,-27,35
Albion,2613,9,8,7,21,59,80,-21,31
Queen's Park,2613,10,7,10,19,40,72,-32,31
Ayr,2614,1,24,4,8,96,43,53,76
Raith,2614,2,22,9,5,69,33,36,75
Alloa,2614,3,17,9,10,57,44,13,60
Arbroath,2614,4,17,8,11,70,51,19,59
Stranraer,2614,5,16,5,15,59,67,-8,53
Airdrieon,2614,6,11,11,14,47,59,-12,44
East Fife,2614,7,13,3,20,50,68,-18,42
Forfar,2614,8,10,5,21,39,66,-27,35
Queen's Park,2614,9,7,10,19,42,72,-30,31
Albion,2614,10,8,6,22,58,84,-26,30
Raith,2615,1,23,8,5,74,33,41,77
Ayr,2615,2,24,4,8,93,43,50,76
Arbroath,2615,3,17,8,11,70,49,21,59
Alloa,2615,4,17,8,11,57,49,8,59
Stranraer,2615,5,16,5,15,56,64,-8,53
East Fife,2615,6,13,3,20,47,65,-18,42
Airdrieon,2615,7,10,11,15,45,60,-15,41
Forfar,2615,8,11,5,20,40,64,-24,38
Queen's Park,2615,9,7,10,19,40,72,-32,31
Albion,2615,10,8,6,22,58,81,-23,30
Raith,2616,1,23,8,5,71,33,38,77
Ayr,2616,2,24,4,8,93,43,50,76
Arbroath,2616,3,18,8,10,73,49,24,62
Alloa,2616,4,17,8,11,57,46,11,59
Stranraer,2616,5,16,5,15,58,65,-7,53
Airdrieon,2616,6,11,11,14,47,58,-11,44
East Fife,2616,7,13,3,20,48,67,-19,42
Forfar,2616,8,10,5,21,38,66,-28,35
Albion,2616,9,8,6,22,58,81,-23,30
Queen's Park,2616,10,6,10,20,40,75,-35,28
Raith,2617,1,23,8,5,69,32,37,77
Ayr,2617,2,23,4,9,93,47,46,73
Arbroath,2617,3,18,8,10,71,48,23,62
Alloa,2617,4,17,8,11,56,44,12,59
Stranraer,2617,5,15,5,16,55,66,-11,50
East Fife,2617,6,14,3,19,49,64,-15,45
Airdrieon,2617,7,11,11,14,48,58,-10,44
Forfar,2617,8,10,5,21,38,67,-29,35
Albion,2617,9,9,6,21,62,81,-19,33
Queen's Park,2617,10,6,10,20,39,73,-34,28
Ayr,2618,1,24,4,8,93,43,50,76
Raith,2618,2,22,9,5,69,33,36,75
Arbroath,2618,3,17,9,10,70,48,22,60
Alloa,2618,4,17,9,10,57,44,13,60
Stranraer,2618,5,15,5,16,55,67,-12,50
East Fife,2618,6,14,3,19,50,64,-14,45
Airdrieon,2618,7,10,12,14,46,59,-13,42
Forfar,2618,8,10,6,20,39,65,-26,36
Albion,2618,9,8,6,22,58,81,-23,30
Queen's Park,2618,10,6,11,19,39,72,-33,29
Ayr,2619,1,24,4,8,92,42,50,76
Raith,2619,2,22,8,6,69,34,35,74
Arbroath,2619,3,18,8,10,71,48,23,62
Alloa,2619,4,18,8,10,58,44,14,62
Stranraer,2619,5,15,5,16,57,68,-11,50
East Fife,2619,6,14,3,19,51,66,-15,45
Airdrieon,2619,7,10,11,15,45,59,-14,41
Forfar,2619,8,11,5,20,39,64,-25,38
Albion,2619,9,8,6,22,57,80,-23,30
Queen's Park,2619,10,6,10,20,39,73,-34,28
Raith,2620,1,22,8,6,69,34,35,74
Ayr,2620,2,23,4,9,91,44,47,73
Arbroath,2620,3,18,8,10,71,48,23,62
Alloa,2620,4,18,8,10,58,44,14,62
Stranraer,2620,5,15,6,15,57,66,-9,51
Airdrieon,2620,6,11,11,14,49,58,-9,44
East Fife,2620,7,13,4,19,49,66,-17,43
Forfar,2620,8,10,5,21,38,68,-30,35
Albion,2620,9,9,6,21,59,79,-20,33
Queen's Park,2620,10,6,10,20,39,73,-34,28
Raith,2621,1,23,8,5,70,33,37,77
Ayr,2621,2,23,5,8,92,44,48,74
Arbroath,2621,3,17,9,10,71,49,22,60
Alloa,2621,4,17,8,11,57,45,12,59
Stranraer,2621,5,16,5,15,58,66,-8,53
Airdrieon,2621,6,11,11,14,46,58,-12,44
East Fife,2621,7,13,3,20,49,67,-18,42
Forfar,2621,8,10,5,21,38,65,-27,35
Albion,2621,9,8,7,21,59,80,-21,31
Queen's Park,2621,10,6,11,19,40,73,-33,29
Raith,2622,1,23,8,5,70,33,37,77
Ayr,2622,2,24,4,8,93,44,49,76
Arbroath,2622,3,17,9,10,72,50,22,60
Alloa,2622,4,17,8,11,57,45,12,59
Stranraer,2622,5,16,5,15,58,65,-7,53
Airdrieon,2622,6,11,11,14,46,58,-12,44
East Fife,2622,7,13,3,20,48,67,-19,42
Forfar,2622,8,10,5,21,38,65,-27,35
Albion,2622,9,8,6,22,59,81,-22,30
Queen's Park,2622,10,6,11,19,41,74,-33,29
Raith,2623,1,23,8,5,70,33,37,77
Ayr,2623,2,24,4,8,93,43,50,76
Arbroath,2623,3,17,8,11,71,50,21,59
Alloa,2623,4,17,8,11,57,45,12,59
Stranraer,2623,5,16,5,15,57,64,-7,53
East Fife,2623,6,13,3,20,47,66,-19,42
Airdrieon,2623,7,10,11,15,46,60,-14,41
Forfar,2623,8,11,5,20,40,65,-25,38
Queen's Park,2623,9,7,10,19,41,73,-32,31
Albion,2623,10,8,6,22,58,81,-23,30
Ayr,2624,1,24,4,8,95,42,53,76
Raith,2624,2,22,9,5,69,33,36,75
Alloa,2624,3,17,9,10,57,44,13,60
Arbroath,2624,4,17,8,11,70,50,20,59
Stranraer,2624,5,15,6,15,57,66,-9,51
East Fife,2624,6,13,4,19,49,66,-17,43
Airdrieon,2624,7,10,12,14,46,59,-13,42
Forfar,2624,8,10,6,20,39,65,-26,36
Queen's Park,2624,9,7,10,19,41,72,-31,31
Albion,2624,10,8,6,22,57,83,-26,30
Raith,2625,1,23,8,5,70,33,37,77
Ayr,2625,2,24,4,8,92,43,49,76
Arbroath,2625,3,18,8,10,72,49,23,62
Alloa,2625,4,17,8,11,57,45,12,59
Stranraer,2625,5,15,6,15,57,66,-9,51
Airdrieon,2625,6,11,11,14,46,58,-12,44
East Fife,2625,7,13,4,19,49,66,-17,43
Forfar,2625,8,10,5,21,38,65,-27,35
Albion,2625,9,8,6,22,58,80,-22,30
Queen's Park,2625,10,6,10,20,40,74,-34,28
Ayr,2626,1,24,4,8,92,42,50,76
Raith,2626,2,22,8,6,68,34,34,74
Alloa,2626,3,18,8,10,58,43,15,62
Arbroath,2626,4,17,8,11,72,51,21,59
Stranraer,2626,5,16,5,15,57,64,-7,53
Airdrieon,2626,6,10,12,14,47,60,-13,42
East Fife,2626,7,13,3,20,47,66,-19,42
Forfar,2626,8,10,6,20,40,66,-26,36
Queen's Park,2626,9,7,10,19,42,74,-32,31
Albion,2626,10,8,6,22,57,80,-23,30
Ayr,2627,1,23,5,8,92,44,48,74
Raith,2627,2,22,8,6,68,34,34,74
Arbroath,2627,3,18,8,10,74,49,25,62
Alloa,2627,4,18,8,10,58,43,15,62
Stranraer,2627,5,16,5,15,58,66,-8,53
East Fife,2627,6,13,3,20,49,67,-18,42
Airdrieon,2627,7,10,11,15,45,59,-14,41
Forfar,2627,8,11,5,20,39,64,-25,38
Albion,2627,9,8,7,21,59,80,-21,31
Queen's Park,2627,10,6,10,20,40,76,-36,28
Raith,2628,1,23,8,5,72,33,39,77
Ayr,2628,2,24,4,8,93,44,49,76
Arbroath,2628,3,18,8,10,73,49,24,62
Alloa,2628,4,17,8,11,57,47,10,59
Stranraer,2628,5,15,5,16,55,65,-10,50
East Fife,2628,6,14,3,19,48,64,-16,45
Airdrieon,2628,7,10,11,15,46,60,-14,41
Forfar,2628,8,11,5,20,40,65,-25,38
Albion,2628,9,8,6,22,59,81,-22,30
Queen's Park,2628,10,6,10,20,40,75,-35,28
Raith,2629,1,23,8,5,69,32,37,77
Ayr,2629,2,24,4,8,94,44,50,76
Arbroath,2629,3,17,9,10,71,49,22,60
Alloa,2629,4,17,8,11,56,44,12,59
Stranraer,2629,5,15,5,16,55,65,-10,50
East Fife,2629,6,14,3,19,48,64,-16,45
Airdrieon,2629,7,11,11,14,48,60,-12,44
Forfar,2629,8,10,5,21,40,67,-27,35
Albion,2629,9,8,6,22,59,82,-23,30
Queen's Park,2629,10,6,11,19,40,73,-33,29
Raith,2630,1,23,8,5,70,33,37,77
Ayr,2630,2,23,5,8,91,43,48,74
Arbroath,2630,3,18,8,10,71,48,23,62
Alloa,2630,4,17,8,11,57,45,12,59
Stranraer,2630,5,16,5,15,56,64,-8,53
East Fife,2630,6,13,3,20,47,65,-18,42
Airdrieon,2630,7,10,11,15,47,61,-14,41
Forfar,2630,8,11,5,20,41,66,-25,38
Albion,2630,9,8,7,21,58,79,-21,31
Queen's Park,2630,10,6,10,20,39,73,-34,28
Raith,2631,1,23,8,5,70,32,38,77
Ayr,2631,2,24,4,8,91,42,49,76
Arbroath,2631,3,18,8,10,74,50,24,62
Alloa,2631,4,17,8,11,56,45,11,59
Stranraer,2631,5,15,5,16,57,68,-11,50
East Fife,2631,6,14,3,19,51,66,-15,45
Airdrieon,2631,7,11,11,14,49,58,-9,44
Forfar,2631,8,10,5,21,38,68,-30,35
Albion,2631,9,8,6,22,57,79,-22,30
Queen's Park,2631,10,6,10,20,41,76,-35,28
Raith,2632,1,22,9,5,69,33,36,75
Ayr,2632,2,23,4,9,91,46,45,73
Alloa,2632,3,17,9,10,57,44,13,60
Arbroath,2632,4,17,8,11,70,50,20,59
Stranraer,2632,5,15,5,16,57,67,-10,50
East Fife,2632,6,14,3,19,50,66,-16,45
Airdrieon,2632,7,10,11,15,46,60,-14,41
Forfar,2632,8,11,5,20,40,65,-25,38
Albion,2632,9,9,6,21,61,79,-18,33
Queen's Park,2632,10,7,10,19,41,72,-31,31
Ayr,2633,1,24,4,8,94,42,52,76
Raith,2633,2,22,9,5,69,33,36,75
Arbroath,2633,3,18,8,10,74,51,23,62
Alloa,2633,4,17,9,10,57,44,13,60
Stranraer,2633,5,15,5,16,56,67,-11,50
East Fife,2633,6,14,3,19,50,65,-15,45
Airdrieon,2633,7,10,12,14,46,59,-13,42
Forfar,2633,8,10,6,20,39,65,-26,36
Albion,2633,9,8,6,22,57,82,-25,30
Queen's Park,2633,10,6,10,20,42,76,-34,28
Raith,2634,1,23,8,5,71,33,38,77
Ayr,2634,2,24,4,8,97,42,55,76
Arbroath,2634,3,17,9,10,71,49,22,60
Alloa,2634,4,17,8,11,57,46,11,59
Stranraer,2634,5,16,5,15,57,65,-8,53
East Fife,2634,6,13,3,20,48,66,-18,42
Airdrieon,2634,7,10,11,15,47,62,-15,41
Forfar,2634,8,11,5,20,42,66,-24,38
Albion,2634,9,8,6,22,57,85,-28,30
Queen's Park,2634,10,6,11,19,40,73,-33,29
Ayr,2635,1,24,4,8,94,43,51,76
Raith,2635,2,22,8,6,69,34,35,74
Alloa,2635,3,18,8,10,58,44,14,62
Arbroath,2635,4,17,9,10,71,49,22,60
Stranraer,2635,5,15,5,16,55,65,-10,50
East Fife,2635,6,14,3,19,48,64,-16,45
Airdrieon,2635,7,11,11,14,47,59,-12,44
Forfar,2635,8,10,5,21,39,66,-27,35
Albion,2635,9,8,6,22,58,82,-24,30
Queen's Park,2635,10,6,11,19,40,73,-33,29
Raith,2636,1,23,8,5,69,32,37,77
Ayr,2636,2,23,5,8,91,43,48,74
Arbroath,2636,3,17,8,11,70,51,19,59
Alloa,2636,4,17,8,11,56,44,12,59
Stranraer,2636,5,16,5,15,56,64,-8,53
East Fife,2636,6,13,3,20,47,65,-18,42
Airdrieon,2636,7,10,11,15,46,61,-15,41
Forfar,2636,8,11,5,20,41,65,-24,38
Albion,2636,9,8,7,21,58,79,-21,31
Queen's Park,2636,10,7,10,19,42,72,-30,31
Ayr,2637,1,24,4,8,93,42,51,76
Raith,2637,2,22,8,6,68,33,35,74
Alloa,2637,3,18,8,10,57,43,14,62
Arbroath,2637,4,17,8,11,70,49,21,59
Stranraer,2637,5,15,5,16,56,66,-10,50
East Fife,2637,6,14,3,19,49,65,-16,45
Airdrieon,2637,7,11,11,14,47,58,-11,44
Forfar,2637,8,10,5,21,38,66,-28,35
Queen's Park,2637,9,7,10,19,40,72,-32,31
Albion,2637,10,8,6,22,57,81,-24,30
Raith,2638,1,23,8,5,71,32,39,77
Ayr,2638,2,24,4,8,93,42,51,76
Arbroath,2638,3,18,8,10,71,48,23,62
Alloa,2638,4,17,8,11,56,46,10,59
Stranraer,2638,5,16,5,15,57,65,-8,53
Airdrieon,2638,6,11,11,14,47,59,-12,44
East Fife,2638,7,13,3,20,48,66,-18,42
Forfar,2638,8,10,5,21,39,66,-27,35
Albion,2638,9,8,6,22,57,81,-24,30
Queen's Park,2638,10,6,10,20,39,73,-34,28
Raith,2639,1,23,8,5,69,32,37,77
Ayr,2639,2,24,4,8,94,45,49,76
Arbroath,2639,3,18,8,10,72,49,23,62
Alloa,2639,4,17,8,11,56,44,12,59
Stranraer,2639,5,16,5,15,59,66,-7,53
Airdrieon,2639,6,10,12,14,46,59,-13,42
East Fife,2639,7,13,3,20,49,68,-19,42
Forfar,2639,8,10,6,20,39,65,-26,36
Albion,2639,9,8,6,22,60,82,-22,30
Queen's Park,2639,10,6,10,20,40,74,-34,28
Raith,2640,1,23,8,5,71,34,37,77
Ayr,2640,2,24,4,8,93,44,49,76
Arbroath,2640,3,17,9,10,70,48,22,60
Alloa,2640,4,17,8,11,58,46,12,59
Stranraer,2640,5,15,6,15,57,66,-9,51
Airdrieon,2640,6,11,11,14,46,58,-12,44
East Fife,2640,7,13,4,19,49,66,-17,43
Forfar,2640,8,10,5,21,38,65,-27,35
Albion,2640,9,8,6,22,59,81,-22,30
Queen's Park,2640,10,6,11,19,39,72,-33,29
Raith,2641,1,23,8,5,71,32,39,77
Ayr,2641,2,24,4,8,93,43,50,76
Arbroath,2641,3,18,8,10,71,48,23,62
Alloa,2641,4,17,8,11,56,46,10,59
Stranraer,2641,5,15,5,16,55,68,-13,50
East Fife,2641,6,14,3,19,51,64,-13,45
Airdrieon,2641,7,10,11,15,47,61,-14,41
Forfar,2641,8,11,5,20,41,66,-25,38
Albion,2641,9,8,6,22,58,81,-23,30
Queen's Park,2641,10,6,10,20,39,73,-34,28
Ayr,2642,1,24,4,8,95,44,51,76
Raith,2642,2,22,8,6,69,34,35,74
Alloa,2642,3,18,8,10,58,44,14,62
Arbroath,2642,4,17,9,10,73,51,22,60
Stranraer,2642,5,15,5,16,56,66,-10,50
East Fife,2642,6,14,3,19,49,65,-16,45
Airdrieon,2642,7,11,11,14,48,58,-10,44
Forfar,2642,8,10,5,21,38,67,-29,35
Albion,2642,9,8,6,22,59,83,-24,30
Queen's Park,2642,10,6,11,19,42,75,-33,29
Raith,2643,1,23,8,5,70,32,38,77
Ayr,2643,2,24,4,8,93,44,49,76
Arbroath,2643,3,18,8,10,73,49,24,62
Alloa,2643,4,17,8,11,56,45,11,59
Stranraer,2643,5,15,5,16,55,65,-10,50
East Fife,2643,6,14,3,19,48,64,-16,45
Airdrieon,2643,7,10,11,15,47,63,-16,41
Forfar,2643,8,11,5,20,43,66,-23,38
Albion,2643,9,8,6,22,59,81,-22,30
Queen's Park,2643,10,6,10,20,40,75,-35,28
Raith,2644,1,23,8,5,71,32,39,77
Ayr,2644,2,24,4,8,95,42,53,76
Arbroath,2644,3,17,9,10,71,49,22,60
Alloa,2644,4,17,8,11,56,46,10,59
Stranraer,2644,5,15,5,16,55,66,-11,50
East Fife,2644,6,14,3,19,49,64,-15,45
Airdrieon,2644,7,11,11,14,47,58,-11,44
Forfar,2644,8,10,5,21,38,66,-28,35
Albion,2644,9,8,6,22,57,83,-26,30
Queen's Park,2644,10,6,11,19,40,73,-33,29
Raith,2645,1,23,8,5,71,32,39,77
Ayr,2645,2,24,4,8,93,43,50,76
Arbroath,2645,3,17,9,10,71,49,22,60
Alloa,2645,4,17,8,11,56,46,10,59
Stranraer,2645,5,16,5,15,57,65,-8,53
Airdrieon,2645,6,11,11,14,49,58,-9,44
East Fife,2645,7,13,3,20,48,66,-18,42
Forfar,2645,8,10,5,21,38,68,-30,35
Albion,2645,9,8,6,22,58,81,-23,30
Queen's Park,2645,10,6,11,19,40,73,-33,29
Ayr,2646,1,24,4,8,94,44,50,76
Raith,2646,2,22,8,6,68,33,35,74
Alloa,2646,3,18,8,10,57,43,14,62
Arbroath,2646,4,17,9,10,72,50,22,60
Stranraer,2646,5,15,6,15,56,65,-9,51
Airdrieon,2646,6,11,11,14,47,59,-12,44
East Fife,2646,7,13,4,19,48,65,-17,43
Forfar,2646,8,10,5,21,39,66,-27,35
Albion,2646,9,8,6,22,59,82,-23,30
Queen's Park,2646,10,6,11,19,41,74,-33,29
Raith,2647,1,23,8,5,69,32,37,77
Ayr,2647,2,24,4,8,95,42,53,76
Arbroath,2647,3,17,8,11,72,52,20,59
Alloa,2647,4,17,8,11,56,44,12,59
Stranraer,2647,5,15,5,16,56,68,-12,50
East Fife,2647,6,14,3,19,51,65,-14,45
Airdrieon,2647,7,11,11,14,47,59,-12,44
Forfar,2647,8,10,5,21,39,66,-27,35
Queen's Park,2647,9,7,10,19,43,74,-31,31
Albion,2647,10,8,6,22,57,83,-26,30
Raith,2648,1,23,8,5,70,33,37,77
Ayr,2648,2,24,4,8,95,43,52,76
Arbroath,2648,3,17,9,10,70,48,22,60
Alloa,2648,4,17,8,11,57,45,12,59
Stranraer,2648,5,16,5,15,57,65,-8,53
Airdrieon,2648,6,11,11,14,48,60,-12,44
East Fife,2648,7,13,3,20,48,66,-18,42
Forfar,2648,8,10,5,21,40,67,-27,35
Albion,2648,9,8,6,22,58,83,-25,30
Queen's Park,2648,10,6,11,19,39,72,-33,29
Raith,2649,1,23,8,5,70,33,37,77
Ayr,2649,2,24,4,8,93,42,51,76
Arbroath,2649,3,17,9,10,70,48,22,60
Alloa,2649,4,17,8,11,57,45,12,59
Stranraer,2649,5,16,5,15,56,64,-8,53
Airdrieon,2649,6,10,12,14,45,58,-13,42
East Fife,2649,7,13,3,20,47,65,-18,42
Forfar,2649,8,10,6,20,38,64,-26,36
Albion,2649,9,8,6,22,57,81,-24,30
Queen's Park,2649,10,6,11,19,39,72,-33,29
Raith,2650,1,23,8,5,70,33,37,77
Ayr,2650,2,24,4,8,91,42,49,76
Arbroath,2650,3,18,8,10,74,49,25,62
Alloa,2650,4,17,8,11,57,45,12,59
Stranraer,2650,5,15,5,16,56,67,-11,50
East Fife,2650,6,14,3,19,50,65,-15,45
Airdrieon,2650,7,11,11,14,46,58,-12,44
Forfar,2650,8,10,5,21,38,65,-27,35
Albion,2650,9,8,6,22,57,79,-22,30
Queen's Park,2650,10,6,10,20,40,76,-36,28
Raith,2651,1,23,8,5,70,33,37,77
Ayr,2651,2,24,4,8,93,43,50,76
Arbroath,2651,3,17,9,10,71,49,22,60
Alloa,2651,4,17,8,11,57,45,12,59
Stranraer,2651,5,15,6,15,57,66,-9,51
East Fife,2651,6,13,4,19,49,66,-17,43
Airdrieon,2651,7,10,12,14,46,59,-13,42
Forfar,2651,8,10,6,20,39,65,-26,36
Albion,2651,9,8,6,22,58,81,-23,30
Queen's Park,2651,10,6,11,19,40,73,-33,29
Ayr,2652,1,23,5,8,91,43,48,74
Raith,2652,2,22,8,6,68,33,35,74
Alloa,2652,3,18,8,10,57,43,14,62
Arbroath,2652,4,17,8,11,71,50,21,59
Stranraer,2652,5,15,6,15,57,66,-9,51
East Fife,2652,6,13,4,19,49,66,-17,43
Airdrieon,2652,7,10,12,14,48,61,-13,42
Forfar,2652,8,10,6,20,41,67,-26,36
Albion,2652,9,8,7,21,58,79,-21,31
Queen's Park,2652,10,7,10,19,41,73,-32,31
Ayr,2653,1,24,4,8,95,43,52,76
Raith,2653,2,22,9,5,69,33,36,75
Alloa,2653,3,17,9,10,57,44,13,60
Arbroath,2653,4,17,8,11,70,49,21,59
Stranraer,2653,5,16,5,15,57,64,-7,53
Airdrieon,2653,6,11,11,14,48,58,-10,44
East Fife,2653,7,13,3,20,47,66,-19,42
Forfar,2653,8,10,5,21,38,67,-29,35
Queen's Park,2653,9,7,10,19,40,72,-32,31
Albion,2653,10,8,6,22,58,83,-25,30
Raith,2654,1,23,8,5,70,33,37,77
Ayr,2654,2,24,4,8,92,43,49,76
Arbroath,2654,3,17,9,10,72,50,22,60
Alloa,2654,4,17,8,11,57,45,12,59
Stranraer,2654,5,16,5,15,56,64,-8,53
Airdrieon,2654,6,11,11,14,47,59,-12,44
East Fife,2654,7,13,3,20,47,65,-18,42
Forfar,2654,8,10,5,21,39,66,-27,35
Albion,2654,9,8,6,22,58,80,-22,30
Queen's Park,2654,10,6,11,19,41,74,-33,29
Raith,2655,1,23,8,5,69,32,37,77
Ayr,2655,2,23,5,8,92,44,48,74
Arbroath,2655,3,17,8,11,71,50,21,59
Alloa,2655,4,17,8,11,56,44,12,59
Stranraer,2655,5,16,5,15,58,66,-8,53
East Fife,2655,6,13,3,20,49,67,-18,42
Airdrieon,2655,7,10,11,15,46,60,-14,41
Forfar,2655,8,11,5,20,40,65,-25,38
Albion,2655,9,8,7,21,59,80,-21,31
Queen's Park,2655,10,7,10,19,41,73,-32,31
Raith,2656,1,23,8,5,71,33,38,77
Ayr,2656,2,24,4,8,95,42,53,76
Arbroath,2656,3,18,8,10,73,49,24,62
Alloa,2656,4,17,8,11,57,46,11,59
Stranraer,2656,5,15,6,15,56,65,-9,51
Airdrieon,2656,6,11,11,14,46,58,-12,44
East Fife,2656,7,13,4,19,48,65,-17,43
Forfar,2656,8,10,5,21,38,65,-27,35
Albion,2656,9,8,6,22,57,83,-26,30
Queen's Park,2656,10,6,10,20,40,75,-35,28
Raith,2657,1,23,8,5,70,32,38,77
Ayr,2657,2,23,5,8,92,44,48,74
Arbroath,2657,3,17,9,10,70,48,22,60
Alloa,2657,4,17,8,11,56,45,11,59
Stranraer,2657,5,15,5,16,58,68,-10,50
East Fife,2657,6,14,3,19,51,67,-16,45
Airdrieon,2657,7,11,11,14,47,58,-11,44
Forfar,2657,8,10,5,21,38,66,-28,35
Albion,2657,9,8,7,21,59,80,-21,31
Queen's Park,2657,10,6,11,19,39,72,-33,29
Ayr,2658,1,24,4,8,93,42,51,76
Raith,2658,2,22,8,6,69,39,30,74
Arbroath,2658,3,18,8,10,75,51,24,62
Alloa,2658,4,18,8,10,63,44,19,62
Stranraer,2658,5,15,5,16,57,67,-10,50
East Fife,2658,6,14,3,19,50,66,-16,45
Airdrieon,2658,7,11,11,14,47,59,-12,44
Forfar,2658,8,10,5,21,39,66,-27,35
Albion,2658,9,8,6,22,57,81,-24,30
Queen's Park,2658,10,6,10,20,42,77,-35,28
Ayr,2659,1,24,4,8,92,43,49,76
Raith,2659,2,22,9,5,69,33,36,75
Arbroath,2659,3,18,8,10,77,51,26,62
Alloa,2659,4,17,9,10,57,44,13,60
Stranraer,2659,5,16,5,15,58,66,-8,53
Airdrieon,2659,6,11,11,14,47,58,-11,44
East Fife,2659,7,13,3,20,49,67,-18,42
Forfar,2659,8,10,5,21,38,66,-28,35
Albion,2659,9,8,6,22,58,80,-22,30
Queen's Park,2659,10,6,10,20,42,79,-37,28
Raith,2660,1,23,8,5,69,32,37,77
Ayr,2660,2,24,4,8,92,43,49,76
Arbroath,2660,3,18,8,10,73,50,23,62
Alloa,2660,4,17,8,11,56,44,12,59
Stranraer,2660,5,15,5,16,56,67,-11,50
East Fife,2660,6,14,3,19,50,65,-15,45
Airdrieon,2660,7,10,12,14,46,59,-13,42
Forfar,2660,8,10,6,20,39,65,-26,36
Albion,2660,9,8,6,22,58,80,-22,30
Queen's Park,2660,10,6,10,20,41,75,-34,28
Raith,2661,1,23,8,5,70,32,38,77
Ayr,2661,2,24,4,8,93,44,49,76
Arbroath,2661,3,18,8,10,72,48,24,62
Alloa,2661,4,17,8,11,56,45,11,59
Stranraer,2661,5,15,5,16,57,67,-10,50
East Fife,2661,6,14,3,19,50,66,-16,45
Airdrieon,2661,7,11,11,14,48,58,-10,44
Forfar,2661,8,10,5,21,38,67,-29,35
Albion,2661,9,8,6,22,59,81,-22,30
Queen's Park,2661,10,6,10,20,39,74,-35,28
Ayr,2662,1,23,5,8,92,44,48,74
Raith,2662,2,22,8,6,69,35,34,74
Arbroath,2662,3,18,8,10,71,48,23,62
Alloa,2662,4,18,8,10,59,44,15,62
Stranraer,2662,5,15,5,16,55,65,-10,50
East Fife,2662,6,14,3,19,48,64,-16,45
Airdrieon,2662,7,11,11,14,47,59,-12,44
Forfar,2662,8,10,5,21,39,66,-27,35
Albion,2662,9,8,7,21,59,80,-21,31
Queen's Park,2662,10,6,10,20,39,73,-34,28
Ayr,2663,1,24,4,8,94,42,52,76
Raith,2663,2,22,9,5,70,34,36,75
Arbroath,2663,3,18,8,10,74,48,26,62
Alloa,2663,4,17,9,10,58,45,13,60
Stranraer,2663,5,15,5,16,55,66,-11,50
East Fife,2663,6,14,3,19,49,64,-15,45
Airdrieon,2663,7,11,11,14,48,59,-11,44
Forfar,2663,8,10,5,21,39,67,-28,35
Albion,2663,9,8,6,22,57,82,-25,30
Queen's Park,2663,10,6,10,20,39,76,-37,28
Ayr,2664,1,24,4,8,92,43,49,76
Raith,2664,2,22,9,5,68,32,36,75
Arbroath,2664,3,17,9,10,72,50,22,60
Alloa,2664,4,17,9,10,56,43,13,60
Stranraer,2664,5,16,5,15,56,64,-8,53
Airdrieon,2664,6,11,11,14,47,59,-12,44
East Fife,2664,7,13,3,20,47,65,-18,42
Forfar,2664,8,10,5,21,39,66,-27,35
Albion,2664,9,8,6,22,58,80,-22,30
Queen's Park,2664,10,6,11,19,41,74,-33,29
Ayr,2665,1,24,4,8,94,43,51,76
Raith,2665,2,22,9,5,68,32,36,75
Arbroath,2665,3,17,9,10,72,50,22,60
Alloa,2665,4,17,9,10,56,43,13,60
Stranraer,2665,5,16,5,15,56,64,-8,53
Airdrieon,2665,6,10,12,14,48,61,-13,42
East Fife,2665,7,13,3,20,47,65,-18,42
Forfar,2665,8,10,6,20,41,67,-26,36
Albion,2665,9,8,6,22,58,82,-24,30
Queen's Park,2665,10,6,11,19,41,74,-33,29
Raith,2666,1,23,8,5,73,34,39,77
Ayr,2666,2,24,4,8,94,43,51,76
Arbroath,2666,3,18,8,10,73,50,23,62
Alloa,2666,4,17,8,11,58,48,10,59
Stranraer,2666,5,16,5,15,57,64,-7,53
Airdrieon,2666,6,11,11,14,47,59,-12,44
East Fife,2666,7,13,3,20,47,66,-19,42
Forfar,2666,8,10,5,21,39,66,-27,35
Albion,2666,9,8,6,22,58,82,-24,30
Queen's Park,2666,10,6,10,20,41,75,-34,28
Raith,2667,1,23,8,5,70,33,37,77
Ayr,2667,2,23,5,8,93,45,48,74
Arbroath,2667,3,17,8,11,70,50,20,59
Alloa,2667,4,17,8,11,57,45,12,59
Stranraer,2667,5,15,5,16,56,67,-11,50
East Fife,2667,6,14,3,19,50,65,-15,45
Airdrieon,2667,7,10,12,14,45,58,-13,42
Forfar,2667,8,10,6,20,38,64,-26,36
Albion,2667,9,8,7,21,60,81,-21,31
Queen's Park,2667,10,7,10,19,41,72,-31,31
Raith,2668,1,23,8,5,70,32,38,77
Ayr,2668,2,24,4,8,99,43,56,76
Arbroath,2668,3,17,9,10,72,50,22,60
Alloa,2668,4,17,8,11,56,45,11,59
Stranraer,2668,5,16,5,15,57,65,-8,53
East Fife,2668,6,13,3,20,48,66,-18,42
Airdrieon,2668,7,10,11,15,46,60,-14,41
Forfar,2668,8,11,5,20,40,65,-25,38
Albion,2668,9,8,6,22,58,87,-29,30
Queen's Park,2668,10,6,11,19,41,74,-33,29
Raith,2669,1,23,8,5,69,32,37,77
Ayr,2669,2,24,4,8,93,43,50,76
Arbroath,2669,3,18,8,10,73,50,23,62
Alloa,2669,4,17,8,11,56,44,12,59
Stranraer,2669,5,15,5,16,55,66,-11,50
East Fife,2669,6,14,3,19,49,64,-15,45
Airdrieon,2669,7,10,11,15,46,60,-14,41
Forfar,2669,8,11,5,20,40,65,-25,38
Albion,2669,9,8,6,22,58,81,-23,30
Queen's Park,2669,10,6,10,20,41,75,-34,28
Ayr,2670,1,24,4,8,91,42,49,76
Raith,2670,2,22,9,5,68,32,36,75
Arbroath,2670,3,18,8,10,73,48,25,62
Alloa,2670,4,17,9,10,56,43,13,60
Stranraer,2670,5,15,6,15,57,66,-9,51
East Fife,2670,6,13,4,19,49,66,-17,43
Airdrieon,2670,7,10,12,14,45,58,-13,42
Forfar,2670,8,10,6,20,38,64,-26,36
Albion,2670,9,8,6,22,57,79,-22,30
Queen's Park,2670,10,6,10,20,39,75,-36,28
Raith,2671,1,23,8,5,73,32,41,77
Ayr,2671,2,24,4,8,92,43,49,76
Arbroath,2671,3,17,9,10,70,48,22,60
Alloa,2671,4,17,8,11,56,48,8,59
Stranraer,2671,5,15,5,16,56,66,-10,50
East Fife,2671,6,14,3,19,49,65,-16,45
Airdrieon,2671,7,11,11,14,47,58,-11,44
Forfar,2671,8,10,5,21,38,66,-28,35
Albion,2671,9,8,6,22,58,80,-22,30
Queen's Park,2671,10,6,11,19,39,72,-33,29
Ayr,2672,1,24,4,8,94,43,51,76
Raith,2672,2,22,9,5,69,33,36,75
Arbroath,2672,3,17,9,10,70,48,22,60
Alloa,2672,4,17,9,10,57,44,13,60
Stranraer,2672,5,16,5,15,57,65,-8,53
East Fife,2672,6,13,3,20,48,66,-18,42
Airdrieon,2672,7,10,11,15,46,60,-14,41
Forfar,2672,8,11,5,20,40,65,-25,38
Albion,2672,9,8,6,22,58,82,-24,30
Queen's Park,2672,10,6,11,19,39,72,-33,29
Ayr,2673,1,24,4,8,96,45,51,76
Raith,2673,2,22,8,6,71,36,35,74
Alloa,2673,3,18,8,10,60,46,14,62
Arbroath,2673,4,17,9,10,72,50,22,60
Stranraer,2673,5,15,5,16,55,66,-11,50
East Fife,2673,6,14,3,19,49,64,-15,45
Airdrieon,2673,7,10,11,15,46,62,-16,41
Forfar,2673,8,11,5,20,42,65,-23,38
Albion,2673,9,8,6,22,60,84,-24,30
Queen's Park,2673,10,6,11,19,41,74,-33,29
Ayr,2674,1,24,4,8,95,43,52,76
Raith,2674,2,22,9,5,68,32,36,75
Arbroath,2674,3,18,8,10,71,48,23,62
Alloa,2674,4,17,9,10,56,43,13,60
Stranraer,2674,5,15,6,15,57,66,-9,51
East Fife,2674,6,13,4,19,49,66,-17,43
Airdrieon,2674,7,10,11,15,47,61,-14,41
Forfar,2674,8,11,5,20,41,66,-25,38
Albion,2674,9,8,6,22,58,83,-25,30
Queen's Park,2674,10,6,10,20,39,73,-34,28
Ayr,2675,1,24,4,8,94,42,52,76
Raith,2675,2,22,8,6,68,35,33,74
Alloa,2675,3,18,8,10,59,43,16,62
Arbroath,2675,4,17,9,10,71,49,22,60
Stranraer,2675,5,16,5,15,57,65,-8,53
Airdrieon,2675,6,11,11,14,47,59,-12,44
East Fife,2675,7,13,3,20,48,66,-18,42
Forfar,2675,8,10,5,21,39,66,-27,35
Albion,2675,9,8,6,22,57,82,-25,30
Queen's Park,2675,10,6,11,19,40,73,-33,29
Ayr,2676,1,24,4,8,94,42,52,76
Raith,2676,2,22,9,5,68,32,36,75
Alloa,2676,3,17,9,10,56,43,13,60
Arbroath,2676,4,17,8,11,70,50,20,59
Stranraer,2676,5,15,5,16,57,68,-11,50
East Fife,2676,6,14,3,19,51,66,-15,45
Airdrieon,2676,7,11,11,14,46,58,-12,44
Forfar,2676,8,10,5,21,38,65,-27,35
Queen's Park,2676,9,7,10,19,41,72,-31,31
Albion,2676,10,8,6,22,57,82,-25,30
Raith,2677,1,22,8,6,68,33,35,74
Ayr,2677,2,23,4,9,90,44,46,73
Alloa,2677,3,18,8,10,57,43,14,62
Arbroath,2677,4,17,8,11,72,52,20,59
Stranraer,2677,5,15,6,15,56,65,-9,51
Airdrieon,2677,6,11,11,14,48,60,-12,44
East Fife,2677,7,13,4,19,48,65,-17,43
Forfar,2677,8,10,5,21,40,67,-27,35
Albion,2677,9,9,6,21,59,78,-19,33
Queen's Park,2677,10,7,10,19,43,74,-31,31
Ayr,2678,1,24,4,8,93,43,50,76
Raith,2678,2,22,8,6,68,34,34,74
Alloa,2678,3,18,8,10,58,43,15,62
Arbroath,2678,4,17,9,10,71,49,22,60
Stranraer,2678,5,15,5,16,55,66,-11,50
East Fife,2678,6,14,3,19,49,64,-15,45
Airdrieon,2678,7,11,11,14,51,59,-8,44
Forfar,2678,8,10,5,21,39,70,-31,35
Albion,2678,9,8,6,22,58,81,-23,30
Queen's Park,2678,10,6,11,19,40,73,-33,29
Ayr,2679,1,24,4,8,93,44,49,76
Raith,2679,2,22,8,6,70,36,34,74
Alloa,2679,3,18,8,10,60,45,15,62
Arbroath,2679,4,17,9,10,71,49,22,60
Stranraer,2679,5,16,5,15,58,65,-7,53
Airdrieon,2679,6,11,11,14,46,58,-12,44
East Fife,2679,7,13,3,20,48,67,-19,42
Forfar,2679,8,10,5,21,38,65,-27,35
Albion,2679,9,8,6,22,59,81,-22,30
Queen's Park,2679,10,6,11,19,40,73,-33,29
Raith,2680,1,23,8,5,71,32,39,77
Ayr,2680,2,24,4,8,93,44,49,76
Arbroath,2680,3,17,8,11,71,50,21,59
Alloa,2680,4,17,8,11,56,46,10,59
Stranraer,2680,5,15,5,16,57,67,-10,50
East Fife,2680,6,14,3,19,50,66,-16,45
Airdrieon,2680,7,11,11,14,47,59,-12,44
Forfar,2680,8,10,5,21,39,66,-27,35
Queen's Park,2680,9,7,10,19,41,73,-32,31
Albion,2680,10,8,6,22,59,81,-22,30
Ayr,2681,1,24,4,8,93,43,50,76
Raith,2681,2,22,8,6,69,34,35,74
Alloa,2681,3,18,8,10,58,44,14,62
Arbroath,2681,4,17,9,10,72,50,22,60
Stranraer,2681,5,16,5,15,59,67,-8,53
Airdrieon,2681,6,10,12,14,46,59,-13,42
East Fife,2681,7,13,3,20,50,68,-18,42
Forfar,2681,8,10,6,20,39,65,-26,36
Albion,2681,9,8,6,22,58,81,-23,30
Queen's Park,2681,10,6,11,19,41,74,-33,29
Ayr,2682,1,24,4,8,92,43,49,76
Raith,2682,2,22,8,6,68,34,34,74
Arbroath,2682,3,18,8,10,72,49,23,62
Alloa,2682,4,18,8,10,58,43,15,62
Stranraer,2682,5,15,5,16,55,66,-11,50
East Fife,2682,6,14,3,19,49,64,-15,45
Airdrieon,2682,7,10,11,15,45,59,-14,41
Forfar,2682,8,11,5,20,39,64,-25,38
Albion,2682,9,8,6,22,58,80,-22,30
Queen's Park,2682,10,6,10,20,40,74,-34,28
Ayr,2683,1,23,5,8,91,43,48,74
Raith,2683,2,22,8,6,71,36,35,74
Arbroath,2683,3,18,8,10,74,48,26,62
Alloa,2683,4,18,8,10,60,46,14,62
Stranraer,2683,5,16,5,15,56,64,-8,53
East Fife,2683,6,13,3,20,47,65,-18,42
Airdrieon,2683,7,10,11,15,46,60,-14,41
Forfar,2683,8,11,5,20,40,65,-25,38
Albion,2683,9,8,7,21,58,79,-21,31
Queen's Park,2683,10,6,10,20,39,76,-37,28
Raith,2684,1,23,8,5,71,32,39,77
Ayr,2684,2,24,4,8,94,43,51,76
Arbroath,2684,3,17,8,11,71,50,21,59
Alloa,2684,4,17,8,11,56,46,10,59
Stranraer,2684,5,15,5,16,56,67,-11,50
East Fife,2684,6,14,3,19,50,65,-15,45
Airdrieon,2684,7,11,11,14,47,58,-11,44
Forfar,2684,8,10,5,21,38,66,-28,35
Queen's Park,2684,9,7,10,19,41,73,-32,31
Albion,2684,10,8,6,22,58,82,-24,30
Ayr,2685,1,24,4,8,96,45,51,76
Raith,2685,2,22,8,6,68,34,34,74
Arbroath,2685,3,18,8,10,74,50,24,62
Alloa,2685,4,18,8,10,58,43,15,62
Stranraer,2685,5,15,6,15,57,66,-9,51
East Fife,2685,6,13,4,19,49,66,-17,43
Airdrieon,2685,7,10,11,15,45,60,-15,41
Forfar,2685,8,11,5,20,40,64,-24,38
Albion,2685,9,8,6,22,60,84,-24,30
Queen's Park,2685,10,6,10,20,41,76,-35,28
Ayr,2686,1,24,4,8,93,43,50,76
Raith,2686,2,22,9,5,69,33,36,75
Alloa,2686,3,17,9,10,57,44,13,60
Arbroath,2686,4,17,8,11,72,52,20,59
Stranraer,2686,5,15,6,15,57,66,-9,51
East Fife,2686,6,13,4,19,49,66,-17,43
Airdrieon,2686,7,10,12,14,46,59,-13,42
Forfar,2686,8,10,6,20,39,65,-26,36
Queen's Park,2686,9,7,10,19,43,74,-31,31
Albion,2686,10,8,6,22,58,81,-23,30
Ayr,2687,1,24,4,8,98,42,56,76
Raith,2687,2,22,8,6,70,36,34,74
Alloa,2687,3,18,8,10,60,45,15,62
Arbroath,2687,4,17,8,11,70,51,19,59
Stranraer,2687,5,16,5,15,57,64,-7,53
East Fife,2687,6,13,3,20,47,66,-19,42
Airdrieon,2687,7,10,11,15,45,59,-14,41
Forfar,2687,8,11,5,20,39,64,-25,38
Queen's Park,2687,9,7,10,19,42,72,-30,31
Albion,2687,10,8,6,22,57,86,-29,30
Raith,2688,1,23,8,5,69,32,37,77
Ayr,2688,2,24,4,8,95,42,53,76
Arbroath,2688,3,18,8,10,74,49,25,62
Alloa,2688,4,17,8,11,56,44,12,59
Stranraer,2688,5,15,5,16,56,66,-10,50
East Fife,2688,6,14,3,19,49,65,-16,45
Airdrieon,2688,7,11,11,14,50,58,-8,44
Forfar,2688,8,10,5,21,38,69,-31,35
Albion,2688,9,8,6,22,57,83,-26,30
Queen's Park,2688,10,6,10,20,40,76,-36,28
Raith,2689,1,23,8,5,71,34,37,77
Ayr,2689,2,24,4,8,93,42,51,76
Arbroath,2689,3,17,8,11,70,50,20,59
Alloa,2689,4,17,8,11,58,46,12,59
Stranraer,2689,5,15,5,16,55,65,-10,50
East Fife,2689,6,14,3,19,48,64,-16,45
Airdrieon,2689,7,11,11,14,46,58,-12,44
Forfar,2689,8,10,5,21,38,65,-27,35
Queen's Park,2689,9,7,10,19,41,72,-31,31
Albion,2689,10,8,6,22,57,81,-24,30
Ayr,2690,1,24,4,8,94,43,51,76
Raith,2690,2,22,9,5,68,32,36,75
Alloa,2690,3,17,9,10,56,43,13,60
Arbroath,2690,4,17,8,11,71,50,21,59
Stranraer,2690,5,16,5,15,57,65,-8,53
Airdrieon,2690,6,10,12,14,46,59,-13,42
East Fife,2690,7,13,3,20,48,66,-18,42
Forfar,2690,8,10,6,20,39,65,-26,36
Queen's Park,2690,9,7,10,19,41,73,-32,31
Albion,2690,10,8,6,22,58,82,-24,30
Raith,2691,1,23,8,5,73,34,39,77
Ayr,2691,2,24,4,8,92,43,49,76
Arbroath,2691,3,17,9,10,71,49,22,60
Alloa,2691,4,17,8,11,58,48,10,59
Stranraer,2691,5,16,5,15,57,64,-7,53
Airdrieon,2691,6,11,11,14,46,58,-12,44
East Fife,2691,7,13,3,20,47,66,-19,42
Forfar,2691,8,10,5,21,38,65,-27,35
Albion,2691,9,8,6,22,58,80,-22,30
Queen's Park,2691,10,6,11,19,40,73,-33,29
Raith,2692,1,23,8,5,72,33,39,77
Ayr,2692,2,24,4,8,93,43,50,76
Arbroath,2692,3,17,8,11,71,50,21,59
Alloa,2692,4,17,8,11,57,47,10,59
Stranraer,2692,5,16,5,15,58,64,-6,53
Airdrieon,2692,6,11,11,14,48,58,-10,44
East Fife,2692,7,13,3,20,47,67,-20,42
Forfar,2692,8,10,5,21,38,67,-29,35
Queen's Park,2692,9,7,10,19,41,73,-32,31
Albion,2692,10,8,6,22,58,81,-23,30
Raith,2693,1,23,8,5,70,33,37,77
Ayr,2693,2,24,4,8,94,45,49,76
Arbroath,2693,3,17,8,11,70,49,21,59
Alloa,2693,4,17,8,11,57,45,12,59
Stranraer,2693,5,15,6,15,56,65,-9,51
Airdrieon,2693,6,11,11,14,48,58,-10,44
East Fife,2693,7,13,4,19,48,65,-17,43
Forfar,2693,8,10,5,21,38,67,-29,35
Queen's Park,2693,9,7,10,19,40,72,-32,31
Albion,2693,10,8,6,22,60,82,-22,30
Raith,2694,1,23,8,5,69,32,37,77
Ayr,2694,2,23,4,9,90,44,46,73
Arbroath,2694,3,17,9,10,71,49,22,60
Alloa,2694,4,17,8,11,56,44,12,59
Stranraer,2694,5,15,5,16,57,67,-10,50
East Fife,2694,6,14,3,19,50,66,-16,45
Airdrieon,2694,7,11,11,14,48,58,-10,44
Forfar,2694,8,10,5,21,38,67,-29,35
Albion,2694,9,9,6,21,59,78,-19,33
Queen's Park,2694,10,6,11,19,40,73,-33,29
Ayr,2695,1,24,4,8,93,43,50,76
Raith,2695,2,22,9,5,71,35,36,75
Alloa,2695,3,17,9,10,59,46,13,60
Arbroath,2695,4,17,8,11,71,50,21,59
Stranraer,2695,5,15,5,16,58,69,-11,50
East Fife,2695,6,14,3,19,52,67,-15,45
Airdrieon,2695,7,10,12,14,46,59,-13,42
Forfar,2695,8,10,6,20,39,65,-26,36
Queen's Park,2695,9,7,10,19,41,73,-32,31
Albion,2695,10,8,6,22,58,81,-23,30
Raith,2696,1,23,8,5,70,33,37,77
Ayr,2696,2,24,4,8,93,44,49,76
Arbroath,2696,3,18,8,10,72,49,23,62
Alloa,2696,4,17,8,11,57,45,12,59
Stranraer,2696,5,16,5,15,59,67,-8,53
East Fife,2696,6,13,3,20,50,68,-18,42
Airdrieon,2696,7,10,11,15,45,60,-15,41
Forfar,2696,8,11,5,20,40,64,-24,38
Albion,2696,9,8,6,22,59,81,-22,30
Queen's Park,2696,10,6,10,20,40,74,-34,28
Raith,2697,1,23,8,5,69,32,37,77
Ayr,2697,2,24,4,8,96,44,52,76
Arbroath,2697,3,17,8,11,70,49,21,59
Alloa,2697,4,17,8,11,56,44,12,59
Stranraer,2697,5,15,5,16,55,66,-11,50
East Fife,2697,6,14,3,19,49,64,-15,45
Airdrieon,2697,7,11,11,14,48,59,-11,44
Forfar,2697,8,10,5,21,39,67,-28,35
Queen's Park,2697,9,7,10,19,40,72,-32,31
Albion,2697,10,8,6,22,59,84,-25,30
Ayr,2698,1,24,4,8,93,44,49,76
Raith,2698,2,22,8,6,68,35,33,74
Alloa,2698,3,18,8,10,59,43,16,62
Arbroath,2698,4,17,8,11,71,51,20,59
Stranraer,2698,5,16,5,15,57,64,-7,53
Airdrieon,2698,6,11,11,14,48,59,-11,44
East Fife,2698,7,13,3,20,47,66,-19,42
Forfar,2698,8,10,5,21,39,67,-28,35
Queen's Park,2698,9,7,10,19,42,73,-31,31
Albion,2698,10,8,6,22,59,81,-22,30
Raith,2699,1,23,8,5,70,33,37,77
Ayr,2699,2,24,4,8,97,43,54,76
Arbroath,2699,3,18,8,10,75,50,25,62
Alloa,2699,4,17,8,11,57,45,12,59
Stranraer,2699,5,15,5,16,56,66,-10,50
East Fife,2699,6,14,3,19,49,65,-16,45
Airdrieon,2699,7,11,11,14,47,58,-11,44
Forfar,2699,8,10,5,21,38,66,-28,35
Albion,2699,9,8,6,22,58,85,-27,30
Queen's Park,2699,10,6,10,20,41,77,-36,28
Raith,2700,1,22,8,6,68,33,35,74
Ayr,2700,2,23,4,9,91,45,46,73
Alloa,2700,3,18,8,10,57,43,14,62
Arbroath,2700,4,17,9,10,71,49,22,60
Stranraer,2700,5,15,5,16,55,65,-10,50
East Fife,2700,6,14,3,19,48,64,-16,45
Airdrieon,2700,7,10,11,15,46,60,-14,41
Forfar,2700,8,11,5,20,40,65,-25,38
Albion,2700,9,9,6,21,60,79,-19,33
Queen's Park,2700,10,6,11,19,40,73,-33,29
Raith,2701,1,23,8,5,72,32,40,77
Ayr,2701,2,24,4,8,92,43,49,76
Arbroath,2701,3,18,8,10,74,50,24,62
Alloa,2701,4,17,8,11,56,47,9,59
Stranraer,2701,5,15,5,16,56,68,-12,50
East Fife,2701,6,14,3,19,51,65,-14,45
Airdrieon,2701,7,11,11,14,47,58,-11,44
Forfar,2701,8,10,5,21,38,66,-28,35
Albion,2701,9,8,6,22,58,80,-22,30
Queen's Park,2701,10,6,10,20,41,76,-35,28
Ayr,2702,1,24,4,8,95,42,53,76
Raith,2702,2,22,8,6,68,33,35,74
Arbroath,2702,3,18,8,10,72,49,23,62
Alloa,2702,4,18,8,10,57,43,14,62
Stranraer,2702,5,16,5,15,59,67,-8,53
Airdrieon,2702,6,11,11,14,50,58,-8,44
East Fife,2702,7,13,3,20,50,68,-18,42
Forfar,2702,8,10,5,21,38,69,-31,35
Albion,2702,9,8,6,22,57,83,-26,30
Queen's Park,2702,10,6,10,20,40,74,-34,28
Raith,2703,1,23,8,5,70,32,38,77
Ayr,2703,2,24,4,8,96,43,53,76
Arbroath,2703,3,18,8,10,74,48,26,62
Alloa,2703,4,17,8,11,56,45,11,59
Stranraer,2703,5,16,5,15,58,65,-7,53
Airdrieon,2703,6,11,11,14,48,58,-10,44
East Fife,2703,7,13,3,20,48,67,-19,42
Forfar,2703,8,10,5,21,38,67,-29,35
Albion,2703,9,8,6,22,58,84,-26,30
Queen's Park,2703,10,6,10,20,39,76,-37,28
Ayr,2704,1,24,4,8,99,42,57,76
Raith,2704,2,22,8,6,68,33,35,74
Arbroath,2704,3,18,8,10,73,48,25,62
Alloa,2704,4,18,8,10,57,43,14,62
Stranraer,2704,5,15,5,16,56,66,-10,50
East Fife,2704,6,14,3,19,49,65,-16,45
Airdrieon,2704,7,10,12,14,46,59,-13,42
Forfar,2704,8,10,6,20,39,65,-26,36
Albion,2704,9,8,6,22,57,87,-30,30
Queen's Park,2704,10,6,10,20,39,75,-36,28
Ayr,2705,1,24,4,8,93,43,50,76
Raith,2705,2,22,9,5,70,34,36,75
Arbroath,2705,3,18,8,10,74,48,26,62
Alloa,2705,4,17,9,10,58,45,13,60
Stranraer,2705,5,15,6,15,56,65,-9,51
East Fife,2705,6,13,4,19,48,65,-17,43
Airdrieon,2705,7,10,12,14,46,59,-13,42
Forfar,2705,8,10,6,20,39,65,-26,36
Albion,2705,9,8,6,22,58,81,-23,30
Queen's Park,2705,10,6,10,20,39,76,-37,28
Raith,2706,1,23,8,5,70,33,37,77
Ayr,2706,2,24,4,8,95,43,52,76
Arbroath,2706,3,17,8,11,74,53,21,59
Alloa,2706,4,17,8,11,57,45,12,59
Stranraer,2706,5,15,6,15,58,67,-9,51
Airdrieon,2706,6,11,11,14,48,60,-12,44
East Fife,2706,7,13,4,19,50,67,-17,43
Forfar,2706,8,10,5,21,40,67,-27,35
Queen's Park,2706,9,7,10,19,44,76,-32,31
Albion,2706,10,8,6,22,58,83,-25,30
Raith,2707,1,23,8,5,72,32,40,77
Ayr,2707,2,23,4,9,92,45,47,73
Arbroath,2707,3,17,9,10,71,49,22,60
Alloa,2707,4,17,8,11,56,47,9,59
Stranraer,2707,5,16,5,15,59,66,-7,53
Airdrieon,2707,6,11,11,14,48,60,-12,44
East Fife,2707,7,13,3,20,49,68,-19,42
Forfar,2707,8,10,5,21,40,67,-27,35
Albion,2707,9,9,6,21,60,80,-20,33
Queen's Park,2707,10,6,11,19,40,73,-33,29
Raith,2708,1,23,8,5,72,32,40,77
Ayr,2708,2,24,4,8,92,43,49,76
Arbroath,2708,3,17,9,10,72,50,22,60
Alloa,2708,4,17,8,11,56,47,9,59
Stranraer,2708,5,15,5,16,55,68,-13,50
East Fife,2708,6,14,3,19,51,64,-13,45
Airdrieon,2708,7,10,11,15,45,60,-15,41
Forfar,2708,8,11,5,20,40,64,-24,38
Albion,2708,9,8,6,22,58,80,-22,30
Queen's Park,2708,10,6,11,19,41,74,-33,29
Ayr,2709,1,24,4,8,93,43,50,76
Raith,2709,2,22,8,6,69,34,35,74
Arbroath,2709,3,18,8,10,71,48,23,62
Alloa,2709,4,18,8,10,58,44,14,62
Stranraer,2709,5,15,5,16,56,67,-11,50
East Fife,2709,6,14,3,19,50,65,-15,45
Airdrieon,2709,7,10,12,14,45,58,-13,42
Forfar,2709,8,10,6,20,38,64,-26,36
Albion,2709,9,8,6,22,58,81,-23,30
Queen's Park,2709,10,6,10,20,39,73,-34,28
Ayr,2710,1,24,4,8,93,42,51,76
Raith,2710,2,22,9,5,69,33,36,75
Alloa,2710,3,17,9,10,57,44,13,60
Arbroath,2710,4,17,8,11,71,51,20,59
Stranraer,2710,5,15,5,16,55,67,-12,50
East Fife,2710,6,14,3,19,50,64,-14,45
Airdrieon,2710,7,10,11,15,45,59,-14,41
Forfar,2710,8,11,5,20,39,64,-25,38
Queen's Park,2710,9,7,10,19,42,73,-31,31
Albion,2710,10,8,6,22,57,81,-24,30
Ayr,2711,1,24,4,8,96,44,52,76
Raith,2711,2,22,8,6,69,34,35,74
Alloa,2711,3,18,8,10,58,44,14,62
Arbroath,2711,4,17,8,11,70,49,21,59
Stranraer,2711,5,15,5,16,56,66,-10,50
East Fife,2711,6,14,3,19,49,65,-16,45
Airdrieon,2711,7,11,11,14,46,58,-12,44
Forfar,2711,8,10,5,21,38,65,-27,35
Queen's Park,2711,9,7,10,19,40,72,-32,31
Albion,2711,10,8,6,22,59,84,-25,30
Raith,2712,1,23,8,5,70,33,37,77
Ayr,2712,2,24,4,8,94,43,51,76
Arbroath,2712,3,18,8,10,75,48,27,62
Alloa,2712,4,17,8,11,57,45,12,59
Stranraer,2712,5,15,5,16,56,66,-10,50
East Fife,2712,6,14,3,19,49,65,-16,45
Airdrieon,2712,7,11,11,14,46,58,-12,44
Forfar,2712,8,10,5,21,38,65,-27,35
Albion,2712,9,8,6,22,58,82,-24,30
Queen's Park,2712,10,6,10,20,39,77,-38,28
Ayr,2713,1,23,5,8,92,44,48,74
Raith,2713,2,22,8,6,68,33,35,74
Arbroath,2713,3,18,8,10,73,48,25,62
Alloa,2713,4,18,8,10,57,43,14,62
Stranraer,2713,5,16,5,15,56,64,-8,53
East Fife,2713,6,13,3,20,47,65,-18,42
Airdrieon,2713,7,10,11,15,47,61,-14,41
Forfar,2713,8,11,5,20,41,66,-25,38
Albion,2713,9,8,7,21,59,80,-21,31
Queen's Park,2713,10,6,10,20,39,75,-36,28
Raith,2714,1,23,8,5,69,32,37,77
Ayr,2714,2,24,4,8,96,44,52,76
Arbroath,2714,3,17,8,11,70,51,19,59
Alloa,2714,4,17,8,11,56,44,12,59
Stranraer,2714,5,15,5,16,56,66,-10,50
East Fife,2714,6,14,3,19,49,65,-16,45
Airdrieon,2714,7,11,11,14,47,59,-12,44
Forfar,2714,8,10,5,21,39,66,-27,35
Queen's Park,2714,9,7,10,19,42,72,-30,31
Albion,2714,10,8,6,22,59,84,-25,30
Raith,2715,1,23,8,5,70,32,38,77
Ayr,2715,2,24,4,8,94,42,52,76
Arbroath,2715,3,18,8,10,75,48,27,62
Alloa,2715,4,17,8,11,56,45,11,59
Stranraer,2715,5,15,6,15,57,66,-9,51
Airdrieon,2715,6,11,11,14,46,58,-12,44
East Fife,2715,7,13,4,19,49,66,-17,43
Forfar,2715,8,10,5,21,38,65,-27,35
Albion,2715,9,8,6,22,57,82,-25,30
Queen's Park,2715,10,6,10,20,39,77,-38,28
Ayr,2716,1,24,4,8,92,43,49,76
Raith,2716,2,22,8,6,68,33,35,74
Arbroath,2716,3,18,8,10,72,48,24,62
Alloa,2716,4,18,8,10,57,43,14,62
Stranraer,2716,5,15,5,16,55,67,-12,50
East Fife,2716,6,14,3,19,50,64,-14,45
Airdrieon,2716,7,11,11,14,48,58,-10,44
Forfar,2716,8,10,5,21,38,67,-29,35
Albion,2716,9,8,6,22,58,80,-22,30
Queen's Park,2716,10,6,10,20,39,74,-35,28
Raith,2717,1,23,8,5,71,33,38,77
Ayr,2717,2,24,4,8,95,44,51,76
Arbroath,2717,3,17,8,11,73,52,21,59
Alloa,2717,4,17,8,11,57,46,11,59
Stranraer,2717,5,15,5,16,56,70,-14,50
East Fife,2717,6,14,3,19,53,65,-12,45
Airdrieon,2717,7,11,11,14,46,58,-12,44
Forfar,2717,8,10,5,21,38,65,-27,35
Queen's Park,2717,9,7,10,19,43,75,-32,31
Albion,2717,10,8,6,22,59,83,-24,30
Raith,2718,1,23,8,5,70,32,38,77
Ayr,2718,2,24,4,8,92,42,50,76
Arbroath,2718,3,17,9,10,72,50,22,60
Alloa,2718,4,17,8,11,56,45,11,59
Stranraer,2718,5,15,6,15,58,67,-9,51
East Fife,2718,6,13,4,19,50,67,-17,43
Airdrieon,2718,7,10,12,14,45,58,-13,42
Forfar,2718,8,10,6,20,38,64,-26,36
Albion,2718,9,8,6,22,57,80,-23,30
Queen's Park,2718,10,6,11,19,41,74,-33,29
Raith,2719,1,22,9,5,69,33,36,75
Ayr,2719,2,23,5,8,93,45,48,74
Arbroath,2719,3,18,8,10,73,50,23,62
Alloa,2719,4,17,9,10,57,44,13,60
Stranraer,2719,5,15,5,16,56,66,-10,50
East Fife,2719,6,14,3,19,49,65,-16,45
Airdrieon,2719,7,10,12,14,47,60,-13,42
Forfar,2719,8,10,6,20,40,66,-26,36
Albion,2719,9,8,7,21,60,81,-21,31
Queen's Park,2719,10,6,10,20,41,75,-34,28
Raith,2720,1,23,8,5,71,33,38,77
Ayr,2720,2,24,4,8,93,44,49,76
Arbroath,2720,3,18,8,10,72,48,24,62
Alloa,2720,4,17,8,11,57,46,11,59
Stranraer,2720,5,16,5,15,59,67,-8,53
Airdrieon,2720,6,11,11,14,48,59,-11,44
East Fife,2720,7,13,3,20,50,68,-18,42
Forfar,2720,8,10,5,21,39,67,-28,35
Albion,2720,9,8,6,22,59,81,-22,30
Queen's Park,2720,10,6,10,20,39,74,-35,28
Raith,2721,1,23,8,5,71,32,39,77
Ayr,2721,2,24,4,8,93,43,50,76
Arbroath,2721,3,17,8,11,70,49,21,59
Alloa,2721,4,17,8,11,56,46,10,59
Stranraer,2721,5,15,5,16,55,67,-12,50
East Fife,2721,6,14,3,19,50,64,-14,45
Airdrieon,2721,7,10,11,15,45,60,-15,41
Forfar,2721,8,11,5,20,40,64,-24,38
Queen's Park,2721,9,7,10,19,40,72,-32,31
Albion,2721,10,8,6,22,58,81,-23,30
Raith,2722,1,23,8,5,70,33,37,77
Ayr,2722,2,24,4,8,97,43,54,76
Arbroath,2722,3,17,9,10,70,48,22,60
Alloa,2722,4,17,8,11,57,45,12,59
Stranraer,2722,5,15,5,16,55,66,-11,50
East Fife,2722,6,14,3,19,49,64,-15,45
Airdrieon,2722,7,10,11,15,45,59,-14,41
Forfar,2722,8,11,5,20,39,64,-25,38
Albion,2722,9,8,6,22,58,85,-27,30
Queen's Park,2722,10,6,11,19,39,72,-33,29
Ayr,2723,1,24,4,8,96,43,53,76
Raith,2723,2,22,9,5,68,32,36,75
Arbroath,2723,3,18,8,10,72,49,23,62
Alloa,2723,4,17,9,10,56,43,13,60
Stranraer,2723,5,15,6,15,56,65,-9,51
Airdrieon,2723,6,11,11,14,47,59,-12,44
East Fife,2723,7,13,4,19,48,65,-17,43
Forfar,2723,8,10,5,21,39,66,-27,35
Albion,2723,9,8,6,22,58,84,-26,30
Queen's Park,2723,10,6,10,20,40,74,-34,28
Raith,2724,1,23,8,5,70,32,38,77
Ayr,2724,2,24,4,8,94,42,52,76
Arbroath,2724,3,18,8,10,73,50,23,62
Alloa,2724,4,17,8,11,56,45,11,59
Stranraer,2724,5,15,6,15,57,66,-9,51
Airdrieon,2724,6,11,11,14,49,60,-11,44
East Fife,2724,7,13,4,19,49,66,-17,43
Forfar,2724,8,10,5,21,40,68,-28,35
Albion,2724,9,8,6,22,57,82,-25,30
Queen's Park,2724,10,6,10,20,41,75,-34,28
Raith,2725,1,22,8,6,69,35,34,74
Ayr,2725,2,23,4,9,91,45,46,73
Arbroath,2725,3,18,8,10,72,49,23,62
Alloa,2725,4,18,8,10,59,44,15,62
Stranraer,2725,5,15,5,16,55,68,-13,50
East Fife,2725,6,14,3,19,51,64,-13,45
Airdrieon,2725,7,10,11,15,45,60,-15,41
Forfar,2725,8,11,5,20,40,64,-24,38
Albion,2725,9,9,6,21,60,79,-19,33
Queen's Park,2725,10,6,10,20,40,74,-34,28
Ayr,2726,1,24,4,8,96,43,53,76
Raith,2726,2,22,9,5,68,32,36,75
Arbroath,2726,3,18,8,10,72,49,23,62
Alloa,2726,4,17,9,10,56,43,13,60
Stranraer,2726,5,15,6,15,56,65,-9,51
Airdrieon,2726,6,11,11,14,47,59,-12,44
East Fife,2726,7,13,4,19,48,65,-17,43
Forfar,2726,8,10,5,21,39,66,-27,35
Albion,2726,9,8,6,22,58,84,-26,30
Queen's Park,2726,10,6,10,20,40,74,-34,28
Ayr,2727,1,24,4,8,96,46,50,76
Raith,2727,2,22,9,5,69,33,36,75
Arbroath,2727,3,17,9,10,73,51,22,60
Alloa,2727,4,17,9,10,57,44,13,60
Stranraer,2727,5,15,5,16,55,65,-10,50
East Fife,2727,6,14,3,19,48,64,-16,45
Airdrieon,2727,7,11,11,14,47,59,-12,44
Forfar,2727,8,10,5,21,39,66,-27,35
Albion,2727,9,8,6,22,61,84,-23,30
Queen's Park,2727,10,6,11,19,42,75,-33,29
Raith,2728,1,23,8,5,71,32,39,77
Ayr,2728,2,24,4,8,93,43,50,76
Arbroath,2728,3,18,8,10,72,48,24,62
Alloa,2728,4,17,8,11,56,46,10,59
Stranraer,2728,5,15,5,16,55,65,-10,50
East Fife,2728,6,14,3,19,48,64,-16,45
Airdrieon,2728,7,11,11,14,47,58,-11,44
Forfar,2728,8,10,5,21,38,66,-28,35
Albion,2728,9,8,6,22,58,81,-23,30
Queen's Park,2728,10,6,10,20,39,74,-35,28
Raith,2729,1,23,8,5,70,33,37,77
Ayr,2729,2,24,4,8,95,43,52,76
Arbroath,2729,3,17,9,10,71,49,22,60
Alloa,2729,4,17,8,11,57,45,12,59
Stranraer,2729,5,15,6,15,56,65,-9,51
East Fife,2729,6,13,4,19,48,65,-17,43
Airdrieon,2729,7,10,12,14,45,58,-13,42
Forfar,2729,8,10,6,20,38,64,-26,36
Albion,2729,9,8,6,22,58,83,-25,30
Queen's Park,2729,10,6,11,19,40,73,-33,29
Ayr,2730,1,24,4,8,97,43,54,76
Raith,2730,2,22,9,5,69,33,36,75
Arbroath,2730,3,18,8,10,74,49,25,62
Alloa,2730,4,17,9,10,57,44,13,60
Stranraer,2730,5,16,5,15,56,64,-8,53
East Fife,2730,6,13,3,20,47,65,-18,42
Airdrieon,2730,7,10,11,15,46,61,-15,41
Forfar,2730,8,11,5,20,41,65,-24,38
Albion,2730,9,8,6,22,58,85,-27,30
Queen's Park,2730,10,6,10,20,40,76,-36,28
Ayr,2731,1,24,4,8,94,44,50,76
Raith,2731,2,22,9,5,69,33,36,75
Arbroath,2731,3,17,9,10,72,50,22,60
Alloa,2731,4,17,9,10,57,44,13,60
Stranraer,2731,5,16,5,15,57,64,-7,53
Airdrieon,2731,6,11,11,14,49,59,-10,44
East Fife,2731,7,13,3,20,47,66,-19,42
Forfar,2731,8,10,5,21,39,68,-29,35
Albion,2731,9,8,6,22,59,82,-23,30
Queen's Park,2731,10,6,11,19,41,74,-33,29
Raith,2732,1,23,8,5,71,33,38,77
Ayr,2732,2,24,4,8,96,44,52,76
Arbroath,2732,3,18,8,10,71,48,23,62
Alloa,2732,4,17,8,11,57,46,11,59
Stranraer,2732,5,16,5,15,58,66,-8,53
Airdrieon,2732,6,10,12,14,46,59,-13,42
East Fife,2732,7,13,3,20,49,67,-18,42
Forfar,2732,8,10,6,20,39,65,-26,36
Albion,2732,9,8,6,22,59,84,-25,30
Queen's Park,2732,10,6,10,20,39,73,-34,28
Raith,2733,1,23,8,5,69,32,37,77
Ayr,2733,2,24,4,8,96,43,53,76
Arbroath,2733,3,18,8,10,72,48,24,62
Alloa,2733,4,17,8,11,56,44,12,59
Stranraer,2733,5,16,5,15,58,65,-7,53
Airdrieon,2733,6,10,12,14,46,59,-13,42
East Fife,2733,7,13,3,20,48,67,-19,42
Forfar,2733,8,10,6,20,39,65,-26,36
Albion,2733,9,8,6,22,58,84,-26,30
Queen's Park,2733,10,6,10,20,39,74,-35,28
Ayr,2734,1,24,4,8,95,43,52,76
Raith,2734,2,22,9,5,69,33,36,75
Alloa,2734,3,17,9,10,57,44,13,60
Arbroath,2734,4,17,8,11,71,53,18,59
Stranraer,2734,5,15,5,16,56,69,-13,50
East Fife,2734,6,14,3,19,52,65,-13,45
Airdrieon,2734,7,11,11,14,47,58,-11,44
Forfar,2734,8,10,5,21,38,66,-28,35
Queen's Park,2734,9,7,10,19,44,73,-29,31
Albion,2734,10,8,6,22,58,83,-25,30
Raith,2735,1,23,8,5,70,32,38,77
Ayr,2735,2,24,4,8,96,42,54,76
Arbroath,2735,3,18,8,10,72,48,24,62
Alloa,2735,4,17,8,11,56,45,11,59
Stranraer,2735,5,15,6,15,56,65,-9,51
East Fife,2735,6,13,4,19,48,65,-17,43
Airdrieon,2735,7,10,11,15,45,60,-15,41
Forfar,2735,8,11,5,20,40,64,-24,38
Albion,2735,9,8,6,22,57,84,-27,30
Queen's Park,2735,10,6,10,20,39,74,-35,28
Raith,2736,1,23,8,5,73,34,39,77
Ayr,2736,2,23,5,8,91,43,48,74
Arbroath,2736,3,17,8,11,70,49,21,59
Alloa,2736,4,17,8,11,58,48,10,59
Stranraer,2736,5,15,5,16,55,67,-12,50
East Fife,2736,6,14,3,19,50,64,-14,45
Airdrieon,2736,7,11,11,14,47,59,-12,44
Forfar,2736,8,10,5,21,39,66,-27,35
Albion,2736,9,8,7,21,58,79,-21,31
Queen's Park,2736,10,7,10,19,40,72,-32,31
Raith,2737,1,23,8,5,71,34,37,77
Ayr,2737,2,24,4,8,92,42,50,76
Arbroath,2737,3,18,8,10,72,48,24,62
Alloa,2737,4,17,8,11,58,46,12,59
Stranraer,2737,5,15,6,15,55,64,-9,51
Airdrieon,2737,6,11,11,14,48,59,-11,44
East Fife,2737,7,13,4,19,47,64,-17,43
Forfar,2737,8,10,5,21,39,67,-28,35
Albion,2737,9,8,6,22,57,80,-23,30
Queen's Park,2737,10,6,10,20,39,74,-35,28
Ayr,2738,1,24,4,8,96,45,51,76
Raith,2738,2,22,8,6,68,35,33,74
Arbroath,2738,3,18,8,10,75,48,27,62
Alloa,2738,4,18,8,10,59,43,16,62
Stranraer,2738,5,15,6,15,56,65,-9,51
Airdrieon,2738,6,11,11,14,47,59,-12,44
East Fife,2738,7,13,4,19,48,65,-17,43
Forfar,2738,8,10,5,21,39,66,-27,35
Albion,2738,9,8,6,22,60,84,-24,30
Queen's Park,2738,10,6,10,20,39,77,-38,28
Ayr,2739,1,24,4,8,94,43,51,76
Raith,2739,2,22,9,5,68,32,36,75
Arbroath,2739,3,17,9,10,71,49,22,60
Alloa,2739,4,17,9,10,56,43,13,60
Stranraer,2739,5,15,5,16,56,70,-14,50
East Fife,2739,6,14,3,19,53,65,-12,45
Airdrieon,2739,7,11,11,14,46,58,-12,44
Forfar,2739,8,10,5,21,38,65,-27,35
Albion,2739,9,8,6,22,58,82,-24,30
Queen's Park,2739,10,6,11,19,40,73,-33,29
Raith,2740,1,23,8,5,70,32,38,77
Ayr,2740,2,24,4,8,92,42,50,76
Arbroath,2740,3,18,8,10,73,49,24,62
Alloa,2740,4,17,8,11,56,45,11,59
Stranraer,2740,5,15,5,16,55,66,-11,50
East Fife,2740,6,14,3,19,49,64,-15,45
Airdrieon,2740,7,10,12,14,45,58,-13,42
Forfar,2740,8,10,6,20,38,64,-26,36
Albion,2740,9,8,6,22,57,80,-23,30
Queen's Park,2740,10,6,10,20,40,75,-35,28
Raith,2741,1,23,8,5,70,33,37,77
Ayr,2741,2,23,5,8,94,46,48,74
Arbroath,2741,3,18,8,10,73,49,24,62
Alloa,2741,4,17,8,11,57,45,12,59
Stranraer,2741,5,15,5,16,55,67,-12,50
East Fife,2741,6,14,3,19,50,64,-14,45
Airdrieon,2741,7,10,12,14,45,58,-13,42
Forfar,2741,8,10,6,20,38,64,-26,36
Albion,2741,9,8,7,21,61,82,-21,31
Queen's Park,2741,10,6,10,20,40,75,-35,28
Raith,2742,1,23,8,5,70,32,38,77
Ayr,2742,2,24,4,8,93,44,49,76
Arbroath,2742,3,17,8,11,70,50,20,59
Alloa,2742,4,17,8,11,56,45,11,59
Stranraer,2742,5,15,5,16,55,68,-13,50
East Fife,2742,6,14,3,19,51,64,-13,45
Airdrieon,2742,7,11,11,14,46,58,-12,44
Forfar,2742,8,10,5,21,38,65,-27,35
Queen's Park,2742,9,7,10,19,41,72,-31,31
Albion,2742,10,8,6,22,59,81,-22,30
Raith,2743,1,23,8,5,71,32,39,77
Ayr,2743,2,24,4,8,98,43,55,76
Arbroath,2743,3,18,8,10,72,48,24,62
Alloa,2743,4,17,8,11,56,46,10,59
Stranraer,2743,5,16,5,15,58,65,-7,53
Airdrieon,2743,6,11,11,14,47,58,-11,44
East Fife,2743,7,13,3,20,48,67,-19,42
Forfar,2743,8,10,5,21,38,66,-28,35
Albion,2743,9,8,6,22,58,86,-28,30
Queen's Park,2743,10,6,10,20,39,74,-35,28
Raith,2744,1,22,9,5,69,33,36,75
Ayr,2744,2,23,5,8,92,44,48,74
Arbroath,2744,3,18,8,10,74,48,26,62
Alloa,2744,4,17,9,10,57,44,13,60
Stranraer,2744,5,15,5,16,55,66,-11,50
East Fife,2744,6,14,3,19,49,64,-15,45
Airdrieon,2744,7,11,11,14,49,61,-12,44
Forfar,2744,8,10,5,21,41,68,-27,35
Albion,2744,9,8,7,21,59,80,-21,31
Queen's Park,2744,10,6,10,20,39,76,-37,28
Raith,2745,1,23,8,5,69,32,37,77
Ayr,2745,2,24,4,8,93,43,50,76
Arbroath,2745,3,17,8,11,71,51,20,59
Alloa,2745,4,17,8,11,56,44,12,59
Stranraer,2745,5,16,5,15,57,64,-7,53
Airdrieon,2745,6,11,11,14,46,58,-12,44
East Fife,2745,7,13,3,20,47,66,-19,42
Forfar,2745,8,10,5,21,38,65,-27,35
Queen's Park,2745,9,7,10,19,42,73,-31,31
Albion,2745,10,8,6,22,58,81,-23,30
Raith,2746,1,23,8,5,71,32,39,77
Ayr,2746,2,24,4,8,92,43,49,76
Arbroath,2746,3,18,8,10,72,49,23,62
Alloa,2746,4,17,8,11,56,46,10,59
Stranraer,2746,5,16,5,15,56,64,-8,53
Airdrieon,2746,6,11,11,14,46,58,-12,44
East Fife,2746,7,13,3,20,47,65,-18,42
Forfar,2746,8,10,5,21,38,65,-27,35
Albion,2746,9,8,6,22,58,80,-22,30
Queen's Park,2746,10,6,10,20,40,74,-34,28
Raith,2747,1,23,8,5,70,33,37,77
Ayr,2747,2,24,4,8,92,43,49,76
Arbroath,2747,3,18,8,10,73,48,25,62
Alloa,2747,4,17,8,11,57,45,12,59
Stranraer,2747,5,15,6,15,56,65,-9,51
Airdrieon,2747,6,11,11,14,47,59,-12,44
East Fife,2747,7,13,4,19,48,65,-17,43
Forfar,2747,8,10,5,21,39,66,-27,35
Albion,2747,9,8,6,22,58,80,-22,30
Queen's Park,2747,10,6,10,20,39,75,-36,28
Raith,2748,1,23,8,5,70,33,37,77
Ayr,2748,2,23,5,8,90,42,48,74
Arbroath,2748,3,18,8,10,71,48,23,62
Alloa,2748,4,17,8,11,57,45,12,59
Stranraer,2748,5,16,5,15,57,65,-8,53
Airdrieon,2748,6,11,11,14,48,59,-11,44
East Fife,2748,7,13,3,20,48,66,-18,42
Forfar,2748,8,10,5,21,39,67,-28,35
Albion,2748,9,8,7,21,57,78,-21,31
Queen's Park,2748,10,6,10,20,39,73,-34,28
Ayr,2749,1,24,4,8,93,44,49,76
Raith,2749,2,22,9,5,68,32,36,75
Arbroath,2749,3,18,8,10,73,49,24,62
Alloa,2749,4,17,9,10,56,43,13,60
Stranraer,2749,5,15,5,16,55,66,-11,50
East Fife,2749,6,14,3,19,49,64,-15,45
Airdrieon,2749,7,10,12,14,46,59,-13,42
Forfar,2749,8,10,6,20,39,65,-26,36
Albion,2749,9,8,6,22,59,81,-22,30
Queen's Park,2749,10,6,10,20,40,75,-35,28
Ayr,2750,1,24,4,8,95,44,51,76
Raith,2750,2,22,9,5,69,33,36,75
Arbroath,2750,3,17,9,10,71,49,22,60
Alloa,2750,4,17,9,10,57,44,13,60
Stranraer,2750,5,15,5,16,55,66,-11,50
East Fife,2750,6,14,3,19,49,64,-15,45
Airdrieon,2750,7,10,11,15,45,59,-14,41
Forfar,2750,8,11,5,20,39,64,-25,38
Albion,2750,9,8,6,22,59,83,-24,30
Queen's Park,2750,10,6,11,19,40,73,-33,29
Ayr,2751,1,24,4,8,98,43,55,76
Raith,2751,2,22,8,6,68,34,34,74
Arbroath,2751,3,18,8,10,72,48,24,62
Alloa,2751,4,18,8,10,58,43,15,62
Stranraer,2751,5,16,5,15,60,67,-7,53
Airdrieon,2751,6,10,12,14,45,58,-13,42
East Fife,2751,7,13,3,20,50,69,-19,42
Forfar,2751,8,10,6,20,38,64,-26,36
Albion,2751,9,8,6,22,58,86,-28,30
Queen's Park,2751,10,6,10,20,39,74,-35,28
Raith,2752,1,23,8,5,69,32,37,77
Ayr,2752,2,23,5,8,93,45,48,74
Arbroath,2752,3,17,9,10,71,49,22,60
Alloa,2752,4,17,8,11,56,44,12,59
Stranraer,2752,5,16,5,15,56,64,-8,53
Airdrieon,2752,6,10,12,14,45,58,-13,42
East Fife,2752,7,13,3,20,47,65,-18,42
Forfar,2752,8,10,6,20,38,64,-26,36
Albion,2752,9,8,7,21,60,81,-21,31
Queen's Park,2752,10,6,11,19,40,73,-33,29
Ayr,2753,1,24,4,8,95,44,51,76
Raith,2753,2,22,8,6,68,33,35,74
Arbroath,2753,3,18,8,10,73,48,25,62
Alloa,2753,4,18,8,10,57,43,14,62
Stranraer,2753,5,15,5,16,55,65,-10,50
East Fife,2753,6,14,3,19,48,64,-16,45
Airdrieon,2753,7,10,11,15,45,59,-14,41
Forfar,2753,8,11,5,20,39,64,-25,38
Albion,2753,9,8,6,22,59,83,-24,30
Queen's Park,2753,10,6,10,20,39,75,-36,28
Raith,2754,1,22,9,5,68,32,36,75
Ayr,2754,2,23,5,8,91,43,48,74
Arbroath,2754,3,18,8,10,71,48,23,62
Alloa,2754,4,17,9,10,56,43,13,60
Stranraer,2754,5,15,5,16,56,66,-10,50
East Fife,2754,6,14,3,19,49,65,-16,45
Airdrieon,2754,7,11,11,14,49,59,-10,44
Forfar,2754,8,10,5,21,39,68,-29,35
Albion,2754,9,8,7,21,58,79,-21,31
Queen's Park,2754,10,6,10,20,39,73,-34,28
Raith,2755,1,23,8,5,71,34,37,77
Ayr,2755,2,23,4,9,93,46,47,73
Arbroath,2755,3,18,8,10,73,49,24,62
Alloa,2755,4,17,8,11,58,46,12,59
Stranraer,2755,5,15,6,15,56,65,-9,51
East Fife,2755,6,13,4,19,48,65,-17,43
Airdrieon,2755,7,10,11,15,45,59,-14,41
Forfar,2755,8,11,5,20,39,64,-25,38
Albion,2755,9,9,6,21,61,81,-20,33
Queen's Park,2755,10,6,10,20,40,75,-35,28
Raith,2756,1,23,8,5,69,32,37,77
Ayr,2756,2,24,4,8,92,42,50,76
Arbroath,2756,3,17,8,11,70,50,20,59
Alloa,2756,4,17,8,11,56,44,12,59
Stranraer,2756,5,16,5,15,57,64,-7,53
Airdrieon,2756,6,11,11,14,49,58,-9,44
East Fife,2756,7,13,3,20,47,66,-19,42
Forfar,2756,8,10,5,21,38,68,-30,35
Queen's Park,2756,9,7,10,19,41,72,-31,31
Albion,2756,10,8,6,22,57,80,-23,30
Ayr,2757,1,24,4,8,94,44,50,76
Raith,2757,2,22,9,5,69,33,36,75
Arbroath,2757,3,18,8,10,73,48,25,62
Alloa,2757,4,17,9,10,57,44,13,60
Stranraer,2757,5,16,5,15,58,66,-8,53
Airdrieon,2757,6,11,11,14,47,58,-11,44
East Fife,2757,7,13,3,20,49,67,-18,42
Forfar,2757,8,10,5,21,38,66,-28,35
Albion,2757,9,8,6,22,59,82,-23,30
Queen's Park,2757,10,6,10,20,39,75,-36,28
Ayr,2758,1,24,4,8,95,43,52,76
Raith,2758,2,22,9,5,70,34,36,75
Alloa,2758,3,17,9,10,58,45,13,60
Arbroath,2758,4,17,8,11,73,54,19,59
Stranraer,2758,5,16,5,15,58,65,-7,53
Airdrieon,2758,6,11,11,14,48,58,-10,44
East Fife,2758,7,13,3,20,48,67,-19,42
Forfar,2758,8,10,5,21,38,67,-29,35
Queen's Park,2758,9,7,10,19,45,75,-30,31
Albion,2758,10,8,6,22,58,83,-25,30
Ayr,2759,1,24,4,8,92,43,49,76
Raith,2759,2,22,9,5,69,33,36,75
Arbroath,2759,3,18,8,10,74,49,25,62
Alloa,2759,4,17,9,10,57,44,13,60
Stranraer,2759,5,16,5,15,58,65,-7,53
Airdrieon,2759,6,11,11,14,48,60,-12,44
East Fife,2759,7,13,3,20,48,67,-19,42
Forfar,2759,8,10,5,21,40,67,-27,35
Albion,2759,9,8,6,22,58,80,-22,30
Queen's Park,2759,10,6,10,20,40,76,-36,28
Ayr,2760,1,23,5,8,93,45,48,74
Raith,2760,2,22,8,6,68,33,35,74
Alloa,2760,3,18,8,10,57,43,14,62
Arbroath,2760,4,17,8,11,70,49,21,59
Stranraer,2760,5,15,6,15,55,64,-9,51
East Fife,2760,6,13,4,19,47,64,-17,43
Airdrieon,2760,7,10,11,15,47,61,-14,41
Forfar,2760,8,11,5,20,41,66,-25,38
Albion,2760,9,8,7,21,60,81,-21,31
Queen's Park,2760,10,7,10,19,40,72,-32,31
Ayr,2761,1,23,5,8,92,44,48,74
Raith,2761,2,22,8,6,68,34,34,74
Arbroath,2761,3,18,8,10,72,49,23,62
Alloa,2761,4,18,8,10,58,43,15,62
Stranraer,2761,5,15,5,16,56,67,-11,50
East Fife,2761,6,14,3,19,50,65,-15,45
Airdrieon,2761,7,10,11,15,45,59,-14,41
Forfar,2761,8,11,5,20,39,64,-25,38
Albion,2761,9,8,7,21,59,80,-21,31
Queen's Park,2761,10,6,10,20,40,74,-34,28
Raith,2762,1,23,8,5,70,33,37,77
Ayr,2762,2,23,4,9,90,43,47,73
Arbroath,2762,3,17,9,10,71,49,22,60
Alloa,2762,4,17,8,11,57,45,12,59
Stranraer,2762,5,15,6,15,57,66,-9,51
East Fife,2762,6,13,4,19,49,66,-17,43
Airdrieon,2762,7,10,12,14,46,59,-13,42
Forfar,2762,8,10,6,20,39,65,-26,36
Albion,2762,9,9,6,21,58,78,-20,33
Queen's Park,2762,10,6,11,19,40,73,-33,29
Ayr,2763,1,24,4,8,92,43,49,76
Raith,2763,2,22,9,5,71,35,36,75
Arbroath,2763,3,18,8,10,72,48,24,62
Alloa,2763,4,17,9,10,59,46,13,60
Stranraer,2763,5,15,6,15,56,65,-9,51
Airdrieon,2763,6,11,11,14,47,59,-12,44
East Fife,2763,7,13,4,19,48,65,-17,43
Forfar,2763,8,10,5,21,39,66,-27,35
Albion,2763,9,8,6,22,58,80,-22,30
Queen's Park,2763,10,6,10,20,39,74,-35,28
Raith,2764,1,23,8,5,73,34,39,77
Ayr,2764,2,24,4,8,94,43,51,76
Arbroath,2764,3,18,8,10,71,48,23,62
Alloa,2764,4,17,8,11,58,48,10,59
Stranraer,2764,5,16,5,15,56,64,-8,53
Airdrieon,2764,6,10,12,14,47,60,-13,42
East Fife,2764,7,13,3,20,47,65,-18,42
Forfar,2764,8,10,6,20,40,66,-26,36
Albion,2764,9,8,6,22,58,82,-24,30
Queen's Park,2764,10,6,10,20,39,73,-34,28
Raith,2765,1,23,8,5,69,32,37,77
Ayr,2765,2,24,4,8,95,44,51,76
Arbroath,2765,3,18,8,10,72,49,23,62
Alloa,2765,4,17,8,11,56,44,12,59
Stranraer,2765,5,15,5,16,55,67,-12,50
East Fife,2765,6,14,3,19,50,64,-14,45
Airdrieon,2765,7,10,11,15,46,62,-16,41
Forfar,2765,8,11,5,20,42,65,-23,38
Albion,2765,9,8,6,22,59,83,-24,30
Queen's Park,2765,10,6,10,20,40,74,-34,28
Raith,2766,1,23,8,5,70,33,37,77
Ayr,2766,2,24,4,8,94,44,50,76
Arbroath,2766,3,18,8,10,73,49,24,62
Alloa,2766,4,17,8,11,57,45,12,59
Stranraer,2766,5,15,5,16,55,65,-10,50
East Fife,2766,6,14,3,19,48,64,-16,45
Airdrieon,2766,7,11,11,14,46,58,-12,44
Forfar,2766,8,10,5,21,38,65,-27,35
Albion,2766,9,8,6,22,59,82,-23,30
Queen's Park,2766,10,6,10,20,40,75,-35,28
Ayr,2767,1,24,4,8,95,45,50,76
Raith,2767,2,22,8,6,68,36,32,74
Arbroath,2767,3,18,8,10,75,49,26,62
Alloa,2767,4,18,8,10,60,43,17,62
Stranraer,2767,5,15,6,15,56,65,-9,51
East Fife,2767,6,13,4,19,48,65,-17,43
Airdrieon,2767,7,10,12,14,46,59,-13,42
Forfar,2767,8,10,6,20,39,65,-26,36
Albion,2767,9,8,6,22,60,83,-23,30
Queen's Park,2767,10,6,10,20,40,77,-37,28
Raith,2768,1,23,8,5,71,32,39,77
Ayr,2768,2,23,5,8,92,44,48,74
Arbroath,2768,3,18,8,10,73,49,24,62
Alloa,2768,4,17,8,11,56,46,10,59
Stranraer,2768,5,16,5,15,57,65,-8,53
Airdrieon,2768,6,11,11,14,47,59,-12,44
East Fife,2768,7,13,3,20,48,66,-18,42
Forfar,2768,8,10,5,21,39,66,-27,35
Albion,2768,9,8,7,21,59,80,-21,31
Queen's Park,2768,10,6,10,20,40,75,-35,28
Raith,2769,1,22,9,5,68,32,36,75
Ayr,2769,2,23,5,8,91,43,48,74
Arbroath,2769,3,18,8,10,76,48,28,62
Alloa,2769,4,17,9,10,56,43,13,60
Stranraer,2769,5,15,6,15,57,66,-9,51
East Fife,2769,6,13,4,19,49,66,-17,43
Airdrieon,2769,7,10,11,15,46,60,-14,41
Forfar,2769,8,11,5,20,40,65,-25,38
Albion,2769,9,8,7,21,58,79,-21,31
Queen's Park,2769,10,6,10,20,39,78,-39,28
Ayr,2770,1,24,4,8,94,43,51,76
Raith,2770,2,22,8,6,68,34,34,74
Arbroath,2770,3,18,8,10,74,51,23,62
Alloa,2770,4,18,8,10,58,43,15,62
Stranraer,2770,5,15,5,16,55,65,-10,50
East Fife,2770,6,14,3,19,48,64,-16,45
Airdrieon,2770,7,11,11,14,48,59,-11,44
Forfar,2770,8,10,5,21,39,67,-28,35
Albion,2770,9,8,6,22,58,82,-24,30
Queen's Park,2770,10,6,10,20,42,76,-34,28
Raith,2771,1,23,8,5,69,32,37,77
Ayr,2771,2,23,4,9,91,44,47,73
Arbroath,2771,3,18,8,10,73,48,25,62
Alloa,2771,4,17,8,11,56,44,12,59
Stranraer,2771,5,15,5,16,55,67,-12,50
East Fife,2771,6,14,3,19,50,64,-14,45
Airdrieon,2771,7,11,11,14,47,59,-12,44
Forfar,2771,8,10,5,21,39,66,-27,35
Albion,2771,9,9,6,21,59,79,-20,33
Queen's Park,2771,10,6,10,20,39,75,-36,28
Raith,2772,1,23,8,5,72,35,37,77
Ayr,2772,2,24,4,8,94,43,51,76
Arbroath,2772,3,18,8,10,73,49,24,62
Alloa,2772,4,17,8,11,59,47,12,59
Stranraer,2772,5,15,5,16,56,66,-10,50
East Fife,2772,6,14,3,19,49,65,-16,45
Airdrieon,2772,7,11,11,14,47,58,-11,44
Forfar,2772,8,10,5,21,38,66,-28,35
Albion,2772,9,8,6,22,58,82,-24,30
Queen's Park,2772,10,6,10,20,40,75,-35,28
Raith,2773,1,23,8,5,69,32,37,77
Ayr,2773,2,24,4,8,94,43,51,76
Arbroath,2773,3,17,9,10,71,49,22,60
Alloa,2773,4,17,8,11,56,44,12,59
Stranraer,2773,5,15,5,16,56,67,-11,50
East Fife,2773,6,14,3,19,50,65,-15,45
Airdrieon,2773,7,11,11,14,48,60,-12,44
Forfar,2773,8,10,5,21,40,67,-27,35
Albion,2773,9,8,6,22,58,82,-24,30
Queen's Park,2773,10,6,11,19,40,73,-33,29
Ayr,2774,1,24,4,8,92,43,49,76
Raith,2774,2,22,9,5,68,32,36,75
Arbroath,2774,3,17,9,10,70,48,22,60
Alloa,2774,4,17,9,10,56,43,13,60
Stranraer,2774,5,16,5,15,57,64,-7,53
Airdrieon,2774,6,11,11,14,48,58,-10,44
East Fife,2774,7,13,3,20,47,66,-19,42
Forfar,2774,8,10,5,21,38,67,-29,35
Albion,2774,9,8,6,22,58,80,-22,30
Queen's Park,2774,10,6,11,19,39,72,-33,29
Raith,2775,1,23,8,5,69,32,37,77
Ayr,2775,2,24,4,8,96,43,53,76
Arbroath,2775,3,18,8,10,71,48,23,62
Alloa,2775,4,17,8,11,56,44,12,59
Stranraer,2775,5,15,6,15,59,68,-9,51
East Fife,2775,6,13,4,19,51,68,-17,43
Airdrieon,2775,7,10,12,14,46,59,-13,42
Forfar,2775,8,10,6,20,39,65,-26,36
Albion,2775,9,8,6,22,58,84,-26,30
Queen's Park,2775,10,6,10,20,39,73,-34,28
Raith,2776,1,23,8,5,70,33,37,77
Ayr,2776,2,24,4,8,95,44,51,76
Arbroath,2776,3,17,9,10,70,48,22,60
Alloa,2776,4,17,8,11,57,45,12,59
Stranraer,2776,5,16,5,15,60,66,-6,53
Airdrieon,2776,6,11,11,14,48,59,-11,44
East Fife,2776,7,13,3,20,49,69,-20,42
Forfar,2776,8,10,5,21,39,67,-28,35
Albion,2776,9,8,6,22,59,83,-24,30
Queen's Park,2776,10,6,11,19,39,72,-33,29
Ayr,2777,1,24,4,8,94,42,52,76
Raith,2777,2,22,8,6,68,36,32,74
Arbroath,2777,3,18,8,10,73,48,25,62
Alloa,2777,4,18,8,10,60,43,17,62
Stranraer,2777,5,16,5,15,57,65,-8,53
East Fife,2777,6,13,3,20,48,66,-18,42
Airdrieon,2777,7,10,11,15,45,62,-17,41
Forfar,2777,8,11,5,20,42,64,-22,38
Albion,2777,9,8,6,22,57,82,-25,30
Queen's Park,2777,10,6,10,20,39,75,-36,28
Ayr,2778,1,24,4,8,95,43,52,76
Raith,2778,2,22,8,6,69,34,35,74
Alloa,2778,3,18,8,10,58,44,14,62
Arbroath,2778,4,17,8,11,70,51,19,59
Stranraer,2778,5,15,6,15,57,66,-9,51
Airdrieon,2778,6,11,11,14,50,58,-8,44
East Fife,2778,7,13,4,19,49,66,-17,43
Forfar,2778,8,10,5,21,38,69,-31,35
Queen's Park,2778,9,7,10,19,42,72,-30,31
Albion,2778,10,8,6,22,58,83,-25,30
Raith,2779,1,23,8,5,69,32,37,77
Ayr,2779,2,24,4,8,94,43,51,76
Arbroath,2779,3,17,9,10,70,48,22,60
Alloa,2779,4,17,8,11,56,44,12,59
Stranraer,2779,5,16,5,15,57,65,-8,53
Airdrieon,2779,6,10,12,14,47,60,-13,42
East Fife,2779,7,13,3,20,48,66,-18,42
Forfar,2779,8,10,6,20,40,66,-26,36
Albion,2779,9,8,6,22,58,82,-24,30
Queen's Park,2779,10,6,11,19,39,72,-33,29
Raith,2780,1,23,8,5,72,32,40,77
Ayr,2780,2,24,4,8,98,46,52,76
Arbroath,2780,3,17,9,10,73,51,22,60
Alloa,2780,4,17,8,11,56,47,9,59
Stranraer,2780,5,15,5,16,56,66,-10,50
East Fife,2780,6,14,3,19,49,65,-16,45
Airdrieon,2780,7,11,11,14,46,58,-12,44
Forfar,2780,8,10,5,21,38,65,-27,35
Albion,2780,9,8,6,22,61,86,-25,30
Queen's Park,2780,10,6,11,19,42,75,-33,29
Raith,2781,1,23,8,5,70,33,37,77
Ayr,2781,2,23,4,9,91,44,47,73
Arbroath,2781,3,18,8,10,73,50,23,62
Alloa,2781,4,17,8,11,57,45,12,59
Stranraer,2781,5,15,5,16,56,67,-11,50
East Fife,2781,6,14,3,19,50,65,-15,45
Airdrieon,2781,7,10,12,14,48,61,-13,42
Forfar,2781,8,10,6,20,41,67,-26,36
Albion,2781,9,9,6,21,59,79,-20,33
Queen's Park,2781,10,6,10,20,41,75,-34,28
Raith,2782,1,23,8,5,70,33,37,77
Ayr,2782,2,24,4,8,93,42,51,76
Arbroath,2782,3,17,8,11,71,50,21,59
Alloa,2782,4,17,8,11,57,45,12,59
Stranraer,2782,5,16,5,15,56,64,-8,53
Airdrieon,2782,6,10,12,14,46,59,-13,42
East Fife,2782,7,13,3,20,47,65,-18,42
Forfar,2782,8,10,6,20,39,65,-26,36
Queen's Park,2782,9,7,10,19,41,73,-32,31
Albion,2782,10,8,6,22,57,81,-24,30
Raith,2783,1,23,8,5,70,33,37,77
Ayr,2783,2,24,4,8,93,43,50,76
Arbroath,2783,3,18,8,10,72,49,23,62
Alloa,2783,4,17,8,11,57,45,12,59
Stranraer,2783,5,15,5,16,56,66,-10,50
East Fife,2783,6,14,3,19,49,65,-16,45
Airdrieon,2783,7,10,12,14,47,60,-13,42
Forfar,2783,8,10,6,20,40,66,-26,36
Albion,2783,9,8,6,22,58,81,-23,30
Queen's Park,2783,10,6,10,20,40,74,-34,28
Ayr,2784,1,24,4,8,92,43,49,76
Raith,2784,2,22,9,5,68,32,36,75
Alloa,2784,3,17,9,10,56,43,13,60
Arbroath,2784,4,17,8,11,73,52,21,59
Stranraer,2784,5,15,6,15,57,66,-9,51
East Fife,2784,6,13,4,19,49,66,-17,43
Airdrieon,2784,7,10,11,15,45,59,-14,41
Forfar,2784,8,11,5,20,39,64,-25,38
Queen's Park,2784,9,7,10,19,43,75,-32,31
Albion,2784,10,8,6,22,58,80,-22,30
Raith,2785,1,23,8,5,70,33,37,77
Ayr,2785,2,24,4,8,94,42,52,76
Arbroath,2785,3,18,8,10,73,48,25,62
Alloa,2785,4,17,8,11,57,45,12,59
Stranraer,2785,5,15,5,16,56,66,-10,50
East Fife,2785,6,14,3,19,49,65,-16,45
Airdrieon,2785,7,11,11,14,47,59,-12,44
Forfar,2785,8,10,5,21,39,66,-27,35
Albion,2785,9,8,6,22,57,82,-25,30
Queen's Park,2785,10,6,10,20,39,75,-36,28
Raith,2786,1,23,8,5,70,32,38,77
Ayr,2786,2,24,4,8,93,44,49,76
Arbroath,2786,3,18,8,10,71,48,23,62
Alloa,2786,4,17,8,11,56,45,11,59
Stranraer,2786,5,15,6,15,56,65,-9,51
East Fife,2786,6,13,4,19,48,65,-17,43
Airdrieon,2786,7,10,11,15,45,59,-14,41
Forfar,2786,8,11,5,20,39,64,-25,38
Albion,2786,9,8,6,22,59,81,-22,30
Queen's Park,2786,10,6,10,20,39,73,-34,28
Raith,2787,1,23,8,5,69,32,37,77
Ayr,2787,2,23,5,8,92,44,48,74
Arbroath,2787,3,17,8,11,71,50,21,59
Alloa,2787,4,17,8,11,56,44,12,59
Stranraer,2787,5,15,5,16,55,68,-13,50
East Fife,2787,6,14,3,19,51,64,-13,45
Airdrieon,2787,7,11,11,14,48,58,-10,44
Forfar,2787,8,10,5,21,38,67,-29,35
Albion,2787,9,8,7,21,59,80,-21,31
Queen's Park,2787,10,7,10,19,41,73,-32,31
Ayr,2788,1,24,4,8,95,43,52,76
Raith,2788,2,22,9,5,69,33,36,75
Alloa,2788,3,17,9,10,57,44,13,60
Arbroath,2788,4,17,8,11,70,50,20,59
Stranraer,2788,5,15,5,16,58,68,-10,50
East Fife,2788,6,14,3,19,51,67,-16,45
Airdrieon,2788,7,11,11,14,46,58,-12,44
Forfar,2788,8,10,5,21,38,65,-27,35
Queen's Park,2788,9,7,10,19,41,72,-31,31
Albion,2788,10,8,6,22,58,83,-25,30
Raith,2789,1,23,8,5,70,32,38,77
Ayr,2789,2,24,4,8,92,43,49,76
Arbroath,2789,3,17,8,11,73,52,21,59
Alloa,2789,4,17,8,11,56,45,11,59
Stranraer,2789,5,15,5,16,57,68,-11,50
East Fife,2789,6,14,3,19,51,66,-15,45
Airdrieon,2789,7,10,11,15,45,59,-14,41
Forfar,2789,8,11,5,20,39,64,-25,38
Queen's Park,2789,9,7,10,19,43,75,-32,31
Albion,2789,10,8,6,22,58,80,-22,30
Raith,2790,1,22,9,5,69,33,36,75
Ayr,2790,2,23,4,9,92,45,47,73
Arbroath,2790,3,18,8,10,73,49,24,62
Alloa,2790,4,17,9,10,57,44,13,60
Stranraer,2790,5,15,5,16,55,65,-10,50
East Fife,2790,6,14,3,19,48,64,-16,45
Airdrieon,2790,7,11,11,14,49,58,-9,44
Forfar,2790,8,10,5,21,38,68,-30,35
Albion,2790,9,9,6,21,60,80,-20,33
Queen's Park,2790,10,6,10,20,40,75,-35,28
Ayr,2791,1,24,4,8,92,42,50,76
Raith,2791,2,22,8,6,68,33,35,74
Arbroath,2791,3,18,8,10,72,49,23,62
Alloa,2791,4,18,8,10,57,43,14,62
Stranraer,2791,5,15,6,15,56,65,-9,51
Airdrieon,2791,6,11,11,14,46,58,-12,44
East Fife,2791,7,13,4,19,48,65,-17,43
Forfar,2791,8,10,5,21,38,65,-27,35
Albion,2791,9,8,6,22,57,80,-23,30
Queen's Park,2791,10,6,10,20,40,74,-34,28
Ayr,2792,1,24,4,8,91,42,49,76
Raith,2792,2,22,9,5,69,33,36,75
Arbroath,2792,3,18,8,10,74,50,24,62
Alloa,2792,4,17,9,10,57,44,13,60
Stranraer,2792,5,15,5,16,55,65,-10,50
East Fife,2792,6,14,3,19,48,64,-16,45
Airdrieon,2792,7,11,11,14,46,58,-12,44
Forfar,2792,8,10,5,21,38,65,-27,35
Albion,2792,9,8,6,22,57,79,-22,30
Queen's Park,2792,10,6,10,20,41,76,-35,28
Raith,2793,1,23,8,5,70,32,38,77
Ayr,2793,2,24,4,8,93,43,50,76
Arbroath,2793,3,17,9,10,71,49,22,60
Alloa,2793,4,17,8,11,56,45,11,59
Stranraer,2793,5,16,5,15,58,66,-8,53
Airdrieon,2793,6,10,12,14,46,59,-13,42
East Fife,2793,7,13,3,20,49,67,-18,42
Forfar,2793,8,10,6,20,39,65,-26,36
Albion,2793,9,8,6,22,58,81,-23,30
Queen's Park,2793,10,6,11,19,40,73,-33,29
Ayr,2794,1,24,4,8,92,42,50,76
Raith,2794,2,22,9,5,69,33,36,75
Arbroath,2794,3,17,9,10,71,49,22,60
Alloa,2794,4,17,9,10,57,44,13,60
Stranraer,2794,5,15,5,16,55,66,-11,50
East Fife,2794,6,14,3,19,49,64,-15,45
Airdrieon,2794,7,10,11,15,45,59,-14,41
Forfar,2794,8,11,5,20,39,64,-25,38
Albion,2794,9,8,6,22,57,80,-23,30
Queen's Park,2794,10,6,11,19,40,73,-33,29
Ayr,2795,1,24,4,8,95,43,52,76
Raith,2795,2,22,8,6,68,33,35,74
Arbroath,2795,3,18,8,10,72,49,23,62
Alloa,2795,4,18,8,10,57,43,14,62
Stranraer,2795,5,15,5,16,55,65,-10,50
East Fife,2795,6,14,3,19,48,64,-16,45
Airdrieon,2795,7,11,11,14,47,59,-12,44
Forfar,2795,8,10,5,21,39,66,-27,35
Albion,2795,9,8,6,22,58,83,-25,30
Queen's Park,2795,10,6,10,20,40,74,-34,28
Ayr,2796,1,24,4,8,92,42,50,76
Raith,2796,2,22,9,5,68,32,36,75
Arbroath,2796,3,17,9,10,71,49,22,60
Alloa,2796,4,17,9,10,56,43,13,60
Stranraer,2796,5,15,5,16,56,66,-10,50
East Fife,2796,6,14,3,19,49,65,-16,45
Airdrieon,2796,7,11,11,14,46,58,-12,44
Forfar,2796,8,10,5,21,38,65,-27,35
Albion,2796,9,8,6,22,57,80,-23,30
Queen's Park,2796,10,6,11,19,40,73,-33,29
Ayr,2797,1,23,5,8,91,43,48,74
Raith,2797,2,22,8,6,69,34,35,74
Alloa,2797,3,18,8,10,58,44,14,62
Arbroath,2797,4,17,9,10,71,49,22,60
Stranraer,2797,5,15,5,16,55,65,-10,50
East Fife,2797,6,14,3,19,48,64,-16,45
Airdrieon,2797,7,10,11,15,46,60,-14,41
Forfar,2797,8,11,5,20,40,65,-25,38
Albion,2797,9,8,7,21,58,79,-21,31
Queen's Park,2797,10,6,11,19,40,73,-33,29
Raith,2798,1,23,8,5,70,32,38,77
Ayr,2798,2,24,4,8,96,43,53,76
Arbroath,2798,3,18,8,10,73,49,24,62
Alloa,2798,4,17,8,11,56,45,11,59
Stranraer,2798,5,15,5,16,55,66,-11,50
East Fife,2798,6,14,3,19,49,64,-15,45
Airdrieon,2798,7,10,11,15,46,60,-14,41
Forfar,2798,8,11,5,20,40,65,-25,38
Albion,2798,9,8,6,22,58,84,-26,30
Queen's Park,2798,10,6,10,20,40,75,-35,28
Raith,2799,1,23,8,5,69,32,37,77
Ayr,2799,2,24,4,8,93,42,51,76
Arbroath,2799,3,17,8,11,72,51,21,59
Alloa,2799,4,17,8,11,56,44,12,59
Stranraer,2799,5,15,6,15,57,66,-9,51
Airdrieon,2799,6,11,11,14,46,58,-12,44
East Fife,2799,7,13,4,19,49,66,-17,43
Forfar,2799,8,10,5,21,38,65,-27,35
Queen's Park,2799,9,7,10,19,42,74,-32,31
Albion,2799,10,8,6,22,57,81,-24,30
Raith,2800,1,23,8,5,71,33,38,77
Ayr,2800,2,24,4,8,96,43,53,76
Arbroath,2800,3,18,8,10,72,49,23,62
Alloa,2800,4,17,8,11,57,46,11,59
Stranraer,2800,5,16,5,15,59,64,-5,53
Airdrieon,2800,6,11,11,14,47,59,-12,44
East Fife,2800,7,13,3,20,47,68,-21,42
Forfar,2800,8,10,5,21,39,66,-27,35
Albion,2800,9,8,6,22,58,84,-26,30
Queen's Park,2800,10,6,10,20,40,74,-34,28
Raith,2801,1,23,8,5,73,34,39,77
Ayr,2801,2,24,4,8,93,43,50,76
Arbroath,2801,3,18,8,10,72,49,23,62
Alloa,2801,4,17,8,11,58,48,10,59
Stranraer,2801,5,15,5,16,57,68,-11,50
East Fife,2801,6,14,3,19,51,66,-15,45
Airdrieon,2801,7,10,12,14,46,59,-13,42
Forfar,2801,8,10,6,20,39,65,-26,36
Albion,2801,9,8,6,22,58,81,-23,30
Queen's Park,2801,10,6,10,20,40,74,-34,28
Raith,2802,1,23,8,5,69,32,37,77
Ayr,2802,2,24,4,8,92,42,50,76
Arbroath,2802,3,17,8,11,71,50,21,59
Alloa,2802,4,17,8,11,56,44,12,59
Stranraer,2802,5,16,5,15,58,65,-7,53
East Fife,2802,6,13,3,20,48,67,-19,42
Airdrieon,2802,7,10,11,15,45,60,-15,41
Forfar,2802,8,11,5,20,40,64,-24,38
Queen's Park,2802,9,7,10,19,41,73,-32,31
Albion,2802,10,8,6,22,57,80,-23,30
Raith,2803,1,23,8,5,70,33,37,77
Ayr,2803,2,24,4,8,93,42,51,76
Arbroath,2803,3,18,8,10,72,49,23,62
Alloa,2803,4,17,8,11,57,45,12,59
Stranraer,2803,5,16,5,15,56,64,-8,53
Airdrieon,2803,6,11,11,14,46,58,-12,44
East Fife,2803,7,13,3,20,47,65,-18,42
Forfar,2803,8,10,5,21,38,65,-27,35
Albion,2803,9,8,6,22,57,81,-24,30
Queen's Park,2803,10,6,10,20,40,74,-34,28
Raith,2804,1,22,8,6,69,34,35,74
Ayr,2804,2,23,4,9,92,45,47,73
Alloa,2804,3,18,8,10,58,44,14,62
Arbroath,2804,4,17,8,11,71,50,21,59
Stranraer,2804,5,15,5,16,57,68,-11,50
East Fife,2804,6,14,3,19,51,66,-15,45
Airdrieon,2804,7,11,11,14,46,58,-12,44
Forfar,2804,8,10,5,21,38,65,-27,35
Albion,2804,9,9,6,21,60,80,-20,33
Queen's Park,2804,10,7,10,19,41,73,-32,31
Raith,2805,1,23,8,5,70,33,37,77
Ayr,2805,2,23,5,8,92,44,48,74
Arbroath,2805,3,17,9,10,70,48,22,60
Alloa,2805,4,17,8,11,57,45,12,59
Stranraer,2805,5,15,5,16,55,65,-10,50
East Fife,2805,6,14,3,19,48,64,-16,45
Airdrieon,2805,7,10,12,14,47,60,-13,42
Forfar,2805,8,10,6,20,40,66,-26,36
Albion,2805,9,8,7,21,59,80,-21,31
Queen's Park,2805,10,6,11,19,39,72,-33,29
Ayr,2806,1,24,4,8,93,43,50,76
Raith,2806,2,22,9,5,70,34,36,75
Arbroath,2806,3,18,8,10,74,49,25,62
Alloa,2806,4,17,9,10,58,45,13,60
Stranraer,2806,5,15,5,16,55,66,-11,50
East Fife,2806,6,14,3,19,49,64,-15,45
Airdrieon,2806,7,10,12,14,46,59,-13,42
Forfar,2806,8,10,6,20,39,65,-26,36
Albion,2806,9,8,6,22,58,81,-23,30
Queen's Park,2806,10,6,10,20,40,76,-36,28
Ayr,2807,1,24,4,8,95,43,52,76
Raith,2807,2,22,8,6,69,37,32,74
Alloa,2807,3,18,8,10,61,44,17,62
Arbroath,2807,4,17,9,10,71,49,22,60
Stranraer,2807,5,15,6,15,57,66,-9,51
Airdrieon,2807,6,11,11,14,47,58,-11,44
East Fife,2807,7,13,4,19,49,66,-17,43
Forfar,2807,8,10,5,21,38,66,-28,35
Albion,2807,9,8,6,22,58,83,-25,30
Queen's Park,2807,10,6,11,19,40,73,-33,29
Raith,2808,1,23,8,5,70,32,38,77
Ayr,2808,2,24,4,8,94,45,49,76
Arbroath,2808,3,17,8,11,70,52,18,59
Alloa,2808,4,17,8,11,56,45,11,59
Stranraer,2808,5,16,5,15,58,64,-6,53
East Fife,2808,6,13,3,20,47,67,-20,42
Airdrieon,2808,7,10,11,15,45,60,-15,41
Forfar,2808,8,11,5,20,40,64,-24,38
Queen's Park,2808,9,7,10,19,43,72,-29,31
Albion,2808,10,8,6,22,60,82,-22,30
Ayr,2809,1,24,4,8,92,43,49,76
Raith,2809,2,22,8,6,68,35,33,74
Alloa,2809,3,18,8,10,59,43,16,62
Arbroath,2809,4,17,9,10,71,49,22,60
Stranraer,2809,5,15,6,15,58,67,-9,51
East Fife,2809,6,13,4,19,50,67,-17,43
Airdrieon,2809,7,10,11,15,45,61,-16,41
Forfar,2809,8,11,5,20,41,64,-23,38
Albion,2809,9,8,6,22,58,80,-22,30
Queen's Park,2809,10,6,11,19,40,73,-33,29
Raith,2810,1,23,8,5,70,33,37,77
Ayr,2810,2,23,5,8,91,43,48,74
Arbroath,2810,3,17,9,10,70,48,22,60
Alloa,2810,4,17,8,11,57,45,12,59
Stranraer,2810,5,16,5,15,59,66,-7,53
Airdrieon,2810,6,11,11,14,48,58,-10,44
East Fife,2810,7,13,3,20,49,68,-19,42
Forfar,2810,8,10,5,21,38,67,-29,35
Albion,2810,9,8,7,21,58,79,-21,31
Queen's Park,2810,10,6,11,19,39,72,-33,29
Raith,2811,1,23,8,5,71,33,38,77
Ayr,2811,2,24,4,8,94,45,49,76
Arbroath,2811,3,17,8,11,71,50,21,59
Alloa,2811,4,17,8,11,57,46,11,59
Stranraer,2811,5,16,5,15,56,64,-8,53
Airdrieon,2811,6,10,12,14,46,59,-13,42
East Fife,2811,7,13,3,20,47,65,-18,42
Forfar,2811,8,10,6,20,39,65,-26,36
Queen's Park,2811,9,7,10,19,41,73,-32,31
Albion,2811,10,8,6,22,60,82,-22,30
Raith,2812,1,23,8,5,73,32,41,77
Ayr,2812,2,24,4,8,93,43,50,76
Arbroath,2812,3,17,9,10,72,50,22,60
Alloa,2812,4,17,8,11,56,48,8,59
Stranraer,2812,5,15,5,16,56,67,-11,50
East Fife,2812,6,14,3,19,50,65,-15,45
Airdrieon,2812,7,11,11,14,47,59,-12,44
Forfar,2812,8,10,5,21,39,66,-27,35
Albion,2812,9,8,6,22,58,81,-23,30
Queen's Park,2812,10,6,11,19,41,74,-33,29
Raith,2813,1,22,9,5,71,35,36,75
Ayr,2813,2,23,5,8,92,44,48,74
Alloa,2813,3,17,9,10,59,46,13,60
Arbroath,2813,4,17,8,11,72,51,21,59
Stranraer,2813,5,15,5,16,55,66,-11,50
East Fife,2813,6,14,3,19,49,64,-15,45
Airdrieon,2813,7,11,11,14,46,58,-12,44
Forfar,2813,8,10,5,21,38,65,-27,35
Albion,2813,9,8,7,21,59,80,-21,31
Queen's Park,2813,10,7,10,19,42,74,-32,31
Ayr,2814,1,24,4,8,91,42,49,76
Raith,2814,2,22,8,6,68,33,35,74
Alloa,2814,3,18,8,10,57,43,14,62
Arbroath,2814,4,17,8,11,71,50,21,59
Stranraer,2814,5,16,5,15,58,64,-6,53
Airdrieon,2814,6,11,11,14,48,58,-10,44
East Fife,2814,7,13,3,20,47,67,-20,42
Forfar,2814,8,10,5,21,38,67,-29,35
Queen's Park,2814,9,7,10,19,41,73,-32,31
Albion,2814,10,8,6,22,57,79,-22,30
Raith,2815,1,23,8,5,70,32,38,77
Ayr,2815,2,24,4,8,94,42,52,76
Arbroath,2815,3,17,8,11,70,49,21,59
Alloa,2815,4,17,8,11,56,45,11,59
Stranraer,2815,5,16,5,15,59,67,-8,53
Airdrieon,2815,6,11,11,14,47,58,-11,44
East Fife,2815,7,13,3,20,50,68,-18,42
Forfar,2815,8,10,5,21,38,66,-28,35
Queen's Park,2815,9,7,10,19,40,72,-32,31
Albion,2815,10,8,6,22,57,82,-25,30
Raith,2816,1,23,8,5,70,33,37,77
Ayr,2816,2,24,4,8,96,45,51,76
Arbroath,2816,3,18,8,10,73,48,25,62
Alloa,2816,4,17,8,11,57,45,12,59
Stranraer,2816,5,15,5,16,56,66,-10,50
East Fife,2816,6,14,3,19,49,65,-16,45
Airdrieon,2816,7,11,11,14,46,58,-12,44
Forfar,2816,8,10,5,21,38,65,-27,35
Albion,2816,9,8,6,22,60,84,-24,30
Queen's Park,2816,10,6,10,20,39,75,-36,28
Raith,2817,1,23,8,5,71,34,37,77
Ayr,2817,2,24,4,8,91,42,49,76
Arbroath,2817,3,17,9,10,71,49,22,60
Alloa,2817,4,17,8,11,58,46,12,59
Stranraer,2817,5,15,5,16,55,67,-12,50
East Fife,2817,6,14,3,19,50,64,-14,45
Airdrieon,2817,7,10,12,14,46,59,-13,42
Forfar,2817,8,10,6,20,39,65,-26,36
Albion,2817,9,8,6,22,57,79,-22,30
Queen's Park,2817,10,6,11,19,40,73,-33,29
Ayr,2818,1,24,4,8,93,43,50,76
Raith,2818,2,22,8,6,69,34,35,74
Arbroath,2818,3,18,8,10,72,49,23,62
Alloa,2818,4,18,8,10,58,44,14,62
Stranraer,2818,5,15,6,15,57,66,-9,51
East Fife,2818,6,13,4,19,49,66,-17,43
Airdrieon,2818,7,10,12,14,47,60,-13,42
Forfar,2818,8,10,6,20,40,66,-26,36
Albion,2818,9,8,6,22,58,81,-23,30
Queen's Park,2818,10,6,10,20,40,74,-34,28
Raith,2819,1,23,8,5,71,32,39,77
Ayr,2819,2,24,4,8,95,44,51,76
Arbroath,2819,3,17,9,10,71,49,22,60
Alloa,2819,4,17,8,11,56,46,10,59
Stranraer,2819,5,15,6,15,57,66,-9,51
East Fife,2819,6,13,4,19,49,66,-17,43
Airdrieon,2819,7,10,12,14,47,60,-13,42
Forfar,2819,8,10,6,20,40,66,-26,36
Albion,2819,9,8,6,22,59,83,-24,30
Queen's Park,2819,10,6,11,19,40,73,-33,29
Ayr,2820,1,24,4,8,93,43,50,76
Raith,2820,2,22,8,6,69,34,35,74
Alloa,2820,3,18,8,10,58,44,14,62
Arbroath,2820,4,17,9,10,71,49,22,60
Stranraer,2820,5,15,6,15,57,66,-9,51
Airdrieon,2820,6,11,11,14,48,60,-12,44
East Fife,2820,7,13,4,19,49,66,-17,43
Forfar,2820,8,10,5,21,40,67,-27,35
Albion,2820,9,8,6,22,58,81,-23,30
Queen's Park,2820,10,6,11,19,40,73,-33,29
Raith,2821,1,23,8,5,69,32,37,77
Ayr,2821,2,24,4,8,95,44,51,76
Arbroath,2821,3,18,8,10,73,49,24,62
Alloa,2821,4,17,8,11,56,44,12,59
Stranraer,2821,5,15,5,16,55,66,-11,50
East Fife,2821,6,14,3,19,49,64,-15,45
Airdrieon,2821,7,11,11,14,47,58,-11,44
Forfar,2821,8,10,5,21,38,66,-28,35
Albion,2821,9,8,6,22,59,83,-24,30
Queen's Park,2821,10,6,10,20,40,75,-35,28
Raith,2822,1,23,8,5,70,32,38,77
Ayr,2822,2,24,4,8,94,42,52,76
Arbroath,2822,3,17,8,11,71,51,20,59
Alloa,2822,4,17,8,11,56,45,11,59
Stranraer,2822,5,15,6,15,56,65,-9,51
East Fife,2822,6,13,4,19,48,65,-17,43
Airdrieon,2822,7,10,12,14,46,59,-13,42
Forfar,2822,8,10,6,20,39,65,-26,36
Queen's Park,2822,9,7,10,19,42,73,-31,31
Albion,2822,10,8,6,22,57,82,-25,30
Ayr,2823,1,24,4,8,94,43,51,76
Raith,2823,2,22,8,6,69,35,34,74
Arbroath,2823,3,18,8,10,73,50,23,62
Alloa,2823,4,18,8,10,59,44,15,62
Stranraer,2823,5,15,5,16,55,66,-11,50
East Fife,2823,6,14,3,19,49,64,-15,45
Airdrieon,2823,7,10,11,15,45,61,-16,41
Forfar,2823,8,11,5,20,41,64,-23,38
Albion,2823,9,8,6,22,58,82,-24,30
Queen's Park,2823,10,6,10,20,41,75,-34,28
Raith,2824,1,23,8,5,70,33,37,77
Ayr,2824,2,24,4,8,91,42,49,76
Arbroath,2824,3,18,8,10,75,50,25,62
Alloa,2824,4,17,8,11,57,45,12,59
Stranraer,2824,5,15,6,15,57,66,-9,51
East Fife,2824,6,13,4,19,49,66,-17,43
Airdrieon,2824,7,10,12,14,45,58,-13,42
Forfar,2824,8,10,6,20,38,64,-26,36
Albion,2824,9,8,6,22,57,79,-22,30
Queen's Park,2824,10,6,10,20,41,77,-36,28
Ayr,2825,1,24,4,8,93,43,50,76
Raith,2825,2,22,8,6,69,34,35,74
Arbroath,2825,3,18,8,10,76,48,28,62
Alloa,2825,4,18,8,10,58,44,14,62
Stranraer,2825,5,15,5,16,56,66,-10,50
East Fife,2825,6,14,3,19,49,65,-16,45
Airdrieon,2825,7,10,12,14,46,59,-13,42
Forfar,2825,8,10,6,20,39,65,-26,36
Albion,2825,9,8,6,22,58,81,-23,30
Queen's Park,2825,10,6,10,20,39,78,-39,28
Raith,2826,1,23,8,5,73,32,41,77
Ayr,2826,2,24,4,8,99,44,55,76
Arbroath,2826,3,18,8,10,71,48,23,62
Alloa,2826,4,17,8,11,56,48,8,59
Stranraer,2826,5,16,5,15,57,65,-8,53
Airdrieon,2826,6,11,11,14,48,59,-11,44
East Fife,2826,7,13,3,20,48,66,-18,42
Forfar,2826,8,10,5,21,39,67,-28,35
Albion,2826,9,8,6,22,59,87,-28,30
Queen's Park,2826,10,6,10,20,39,73,-34,28
Ayr,2827,1,24,4,8,96,42,54,76
Raith,2827,2,22,9,5,70,34,36,75
Arbroath,2827,3,17,9,10,71,49,22,60
Alloa,2827,4,17,9,10,58,45,13,60
Stranraer,2827,5,15,6,15,56,65,-9,51
Airdrieon,2827,6,11,11,14,47,58,-11,44
East Fife,2827,7,13,4,19,48,65,-17,43
Forfar,2827,8,10,5,21,38,66,-28,35
Albion,2827,9,8,6,22,57,84,-27,30
Queen's Park,2827,10,6,11,19,40,73,-33,29
Raith,2828,1,23,8,5,72,34,38,77
Ayr,2828,2,24,4,8,96,43,53,76
Arbroath,2828,3,18,8,10,77,51,26,62
Alloa,2828,4,17,8,11,58,47,11,59
Stranraer,2828,5,16,5,15,58,64,-6,53
Airdrieon,2828,6,11,11,14,47,58,-11,44
East Fife,2828,7,13,3,20,47,67,-20,42
Forfar,2828,8,10,5,21,38,66,-28,35
Albion,2828,9,8,6,22,58,84,-26,30
Queen's Park,2828,10,6,10,20,42,79,-37,28
Raith,2829,1,23,8,5,72,33,39,77
Ayr,2829,2,24,4,8,95,44,51,76
Arbroath,2829,3,18,8,10,71,48,23,62
Alloa,2829,4,17,8,11,57,47,10,59
Stranraer,2829,5,15,6,15,56,65,-9,51
Airdrieon,2829,6,11,11,14,47,58,-11,44
East Fife,2829,7,13,4,19,48,65,-17,43
Forfar,2829,8,10,5,21,38,66,-28,35
Albion,2829,9,8,6,22,59,83,-24,30
Queen's Park,2829,10,6,10,20,39,73,-34,28
Ayr,2830,1,24,4,8,94,42,52,76
Raith,2830,2,22,9,5,70,34,36,75
Arbroath,2830,3,18,8,10,72,49,23,62
Alloa,2830,4,17,9,10,58,45,13,60
Stranraer,2830,5,16,5,15,59,66,-7,53
Airdrieon,2830,6,11,11,14,47,58,-11,44
East Fife,2830,7,13,3,20,49,68,-19,42
Forfar,2830,8,10,5,21,38,66,-28,35
Albion,2830,9,8,6,22,57,82,-25,30
Queen's Park,2830,10,6,10,20,40,74,-34,28
Raith,2831,1,23,8,5,71,33,38,77
Ayr,2831,2,23,4,9,91,44,47,73
Arbroath,2831,3,18,8,10,73,48,25,62
Alloa,2831,4,17,8,11,57,46,11,59
Stranraer,2831,5,16,5,15,59,66,-7,53
Airdrieon,2831,6,11,11,14,48,58,-10,44
East Fife,2831,7,13,3,20,49,68,-19,42
Forfar,2831,8,10,5,21,38,67,-29,35
Albion,2831,9,9,6,21,59,79,-20,33
Queen's Park,2831,10,6,10,20,39,75,-36,28
Ayr,2832,1,24,4,8,94,43,51,76
Raith,2832,2,22,9,5,69,33,36,75
Arbroath,2832,3,18,8,10,73,50,23,62
Alloa,2832,4,17,9,10,57,44,13,60
Stranraer,2832,5,15,5,16,56,68,-12,50
East Fife,2832,6,14,3,19,51,65,-14,45
Airdrieon,2832,7,11,11,14,47,58,-11,44
Forfar,2832,8,10,5,21,38,66,-28,35
Albion,2832,9,8,6,22,58,82,-24,30
Queen's Park,2832,10,6,10,20,41,75,-34,28
Raith,2833,1,23,8,5,70,32,38,77
Ayr,2833,2,24,4,8,94,44,50,76
Arbroath,2833,3,18,8,10,72,49,23,62
Alloa,2833,4,17,8,11,56,45,11,59
Stranraer,2833,5,15,5,16,57,67,-10,50
East Fife,2833,6,14,3,19,50,66,-16,45
Airdrieon,2833,7,11,11,14,48,60,-12,44
Forfar,2833,8,10,5,21,40,67,-27,35
Albion,2833,9,8,6,22,59,82,-23,30
Queen's Park,2833,10,6,10,20,40,74,-34,28
Raith,2834,1,23,8,5,72,32,40,77
Ayr,2834,2,23,5,8,92,44,48,74
Arbroath,2834,3,18,8,10,71,48,23,62
Alloa,2834,4,17,8,11,56,47,9,59
Stranraer,2834,5,15,5,16,57,70,-13,50
East Fife,2834,6,14,3,19,53,66,-13,45
Airdrieon,2834,7,10,11,15,45,59,-14,41
Forfar,2834,8,11,5,20,39,64,-25,38
Albion,2834,9,8,7,21,59,80,-21,31
Queen's Park,2834,10,6,10,20,39,73,-34,28
Ayr,2835,1,24,4,8,93,42,51,76
Raith,2835,2,22,9,5,69,33,36,75
Arbroath,2835,3,18,8,10,73,48,25,62
Alloa,2835,4,17,9,10,57,44,13,60
Stranraer,2835,5,16,5,15,57,65,-8,53
Airdrieon,2835,6,11,11,14,48,59,-11,44
East Fife,2835,7,13,3,20,48,66,-18,42
Forfar,2835,8,10,5,21,39,67,-28,35
Albion,2835,9,8,6,22,57,81,-24,30
Queen's Park,2835,10,6,10,20,39,75,-36,28
Raith,2836,1,23,8,5,71,33,38,77
Ayr,2836,2,24,4,8,93,42,51,76
Arbroath,2836,3,18,8,10,74,48,26,62
Alloa,2836,4,17,8,11,57,46,11,59
Stranraer,2836,5,15,5,16,56,67,-11,50
East Fife,2836,6,14,3,19,50,65,-15,45
Airdrieon,2836,7,10,12,14,45,58,-13,42
Forfar,2836,8,10,6,20,38,64,-26,36
Albion,2836,9,8,6,22,57,81,-24,30
Queen's Park,2836,10,6,10,20,39,76,-37,28
Ayr,2837,1,23,5,8,94,46,48,74
Raith,2837,2,22,8,6,70,35,35,74
Arbroath,2837,3,18,8,10,71,48,23,62
Alloa,2837,4,18,8,10,59,45,14,62
Stranraer,2837,5,15,5,16,55,65,-10,50
East Fife,2837,6,14,3,19,48,64,-16,45
Airdrieon,2837,7,11,11,14,47,58,-11,44
Forfar,2837,8,10,5,21,38,66,-28,35
Albion,2837,9,8,7,21,61,82,-21,31
Queen's Park,2837,10,6,10,20,39,73,-34,28
Raith,2838,1,23,8,5,72,33,39,77
Ayr,2838,2,24,4,8,93,44,49,76
Arbroath,2838,3,18,8,10,72,48,24,62
Alloa,2838,4,17,8,11,57,47,10,59
Stranraer,2838,5,16,5,15,57,64,-7,53
Airdrieon,2838,6,11,11,14,46,58,-12,44
East Fife,2838,7,13,3,20,47,66,-19,42
Forfar,2838,8,10,5,21,38,65,-27,35
Albion,2838,9,8,6,22,59,81,-22,30
Queen's Park,2838,10,6,10,20,39,74,-35,28
Raith,2839,1,23,8,5,73,33,40,77
Ayr,2839,2,24,4,8,95,42,53,76
Arbroath,2839,3,18,8,10,72,49,23,62
Alloa,2839,4,17,8,11,57,48,9,59
Stranraer,2839,5,15,5,16,58,68,-10,50
East Fife,2839,6,14,3,19,51,67,-16,45
Airdrieon,2839,7,10,11,15,45,60,-15,41
Forfar,2839,8,11,5,20,40,64,-24,38
Albion,2839,9,8,6,22,57,83,-26,30
Queen's Park,2839,10,6,10,20,40,74,-34,28
Ayr,2840,1,24,4,8,94,43,51,76
Raith,2840,2,22,8,6,69,34,35,74
Arbroath,2840,3,18,8,10,72,49,23,62
Alloa,2840,4,18,8,10,58,44,14,62
Stranraer,2840,5,15,6,15,57,66,-9,51
Airdrieon,2840,6,11,11,14,46,58,-12,44
East Fife,2840,7,13,4,19,49,66,-17,43
Forfar,2840,8,10,5,21,38,65,-27,35
Albion,2840,9,8,6,22,58,82,-24,30
Queen's Park,2840,10,6,10,20,40,74,-34,28
Raith,2841,1,23,8,5,70,33,37,77
Ayr,2841,2,24,4,8,96,42,54,76
Arbroath,2841,3,17,8,11,70,51,19,59
Alloa,2841,4,17,8,11,57,45,12,59
Stranraer,2841,5,15,5,16,55,65,-10,50
East Fife,2841,6,14,3,19,48,64,-16,45
Airdrieon,2841,7,11,11,14,47,58,-11,44
Forfar,2841,8,10,5,21,38,66,-28,35
Queen's Park,2841,9,7,10,19,42,72,-30,31
Albion,2841,10,8,6,22,57,84,-27,30
Ayr,2842,1,24,4,8,94,42,52,76
Raith,2842,2,22,9,5,69,33,36,75
Arbroath,2842,3,17,9,10,72,50,22,60
Alloa,2842,4,17,9,10,57,44,13,60
Stranraer,2842,5,15,5,16,57,68,-11,50
East Fife,2842,6,14,3,19,51,66,-15,45
Airdrieon,2842,7,11,11,14,46,58,-12,44
Forfar,2842,8,10,5,21,38,65,-27,35
Albion,2842,9,8,6,22,57,82,-25,30
Queen's Park,2842,10,6,11,19,41,74,-33,29
Ayr,2843,1,24,4,8,95,44,51,76
Raith,2843,2,22,8,6,69,35,34,74
Alloa,2843,3,18,8,10,59,44,15,62
Arbroath,2843,4,17,9,10,71,49,22,60
Stranraer,2843,5,16,5,15,61,68,-7,53
East Fife,2843,6,13,3,20,51,70,-19,42
Airdrieon,2843,7,10,11,15,45,61,-16,41
Forfar,2843,8,11,5,20,41,64,-23,38
Albion,2843,9,8,6,22,59,83,-24,30
Queen's Park,2843,10,6,11,19,40,73,-33,29
Ayr,2844,1,24,4,8,96,42,54,76
Raith,2844,2,22,9,5,68,32,36,75
Arbroath,2844,3,18,8,10,75,48,27,62
Alloa,2844,4,17,9,10,56,43,13,60
Stranraer,2844,5,15,5,16,56,68,-12,50
East Fife,2844,6,14,3,19,51,65,-14,45
Airdrieon,2844,7,10,11,15,45,59,-14,41
Forfar,2844,8,11,5,20,39,64,-25,38
Albion,2844,9,8,6,22,57,84,-27,30
Queen's Park,2844,10,6,10,20,39,77,-38,28
Ayr,2845,1,24,4,8,97,43,54,76
Raith,2845,2,22,8,6,68,35,33,74
Alloa,2845,3,18,8,10,59,43,16,62
Arbroath,2845,4,17,9,10,71,49,22,60
Stranraer,2845,5,15,5,16,56,66,-10,50
East Fife,2845,6,14,3,19,49,65,-16,45
Airdrieon,2845,7,11,11,14,51,59,-8,44
Forfar,2845,8,10,5,21,39,70,-31,35
Albion,2845,9,8,6,22,58,85,-27,30
Queen's Park,2845,10,6,11,19,40,73,-33,29
Ayr,2846,1,24,4,8,97,44,53,76
Raith,2846,2,22,9,5,69,33,36,75
Arbroath,2846,3,18,8,10,73,50,23,62
Alloa,2846,4,17,9,10,57,44,13,60
Stranraer,2846,5,15,5,16,56,66,-10,50
East Fife,2846,6,14,3,19,49,65,-16,45
Airdrieon,2846,7,11,11,14,46,58,-12,44
Forfar,2846,8,10,5,21,38,65,-27,35
Albion,2846,9,8,6,22,59,85,-26,30
Queen's Park,2846,10,6,10,20,41,75,-34,28
Ayr,2847,1,24,4,8,92,42,50,76
Raith,2847,2,22,8,6,68,33,35,74
Alloa,2847,3,18,8,10,57,43,14,62
Arbroath,2847,4,17,8,11,70,50,20,59
Stranraer,2847,5,16,5,15,57,65,-8,53
Airdrieon,2847,6,11,11,14,48,60,-12,44
East Fife,2847,7,13,3,20,48,66,-18,42
Forfar,2847,8,10,5,21,40,67,-27,35
Queen's Park,2847,9,7,10,19,41,72,-31,31
Albion,2847,10,8,6,22,57,80,-23,30
Raith,2848,1,23,8,5,72,34,38,77
Ayr,2848,2,24,4,8,100,43,57,76
Arbroath,2848,3,18,8,10,74,49,25,62
Alloa,2848,4,17,8,11,58,47,11,59
Stranraer,2848,5,15,5,16,55,65,-10,50
East Fife,2848,6,14,3,19,48,64,-16,45
Airdrieon,2848,7,11,11,14,51,58,-7,44
Forfar,2848,8,10,5,21,38,70,-32,35
Albion,2848,9,8,6,22,58,88,-30,30
Queen's Park,2848,10,6,10,20,40,76,-36,28
Ayr,2849,1,24,4,8,94,44,50,76
Raith,2849,2,22,9,5,69,33,36,75
Arbroath,2849,3,17,9,10,73,51,22,60
Alloa,2849,4,17,9,10,57,44,13,60
Stranraer,2849,5,15,5,16,56,67,-11,50
East Fife,2849,6,14,3,19,50,65,-15,45
Airdrieon,2849,7,11,11,14,47,59,-12,44
Forfar,2849,8,10,5,21,39,66,-27,35
Albion,2849,9,8,6,22,59,82,-23,30
Queen's Park,2849,10,6,11,19,42,75,-33,29
Raith,2850,1,23,8,5,70,32,38,77
Ayr,2850,2,24,4,8,94,44,50,76
Arbroath,2850,3,17,9,10,71,49,22,60
Alloa,2850,4,17,8,11,56,45,11,59
Stranraer,2850,5,16,5,15,57,64,-7,53
Airdrieon,2850,6,10,12,14,45,58,-13,42
East Fife,2850,7,13,3,20,47,66,-19,42
Forfar,2850,8,10,6,20,38,64,-26,36
Albion,2850,9,8,6,22,59,82,-23,30
Queen's Park,2850,10,6,11,19,40,73,-33,29
Ayr,2851,1,24,4,8,96,42,54,76
Raith,2851,2,22,8,6,69,34,35,74
Alloa,2851,3,18,8,10,58,44,14,62
Arbroath,2851,4,17,8,11,71,52,19,59
Stranraer,2851,5,15,5,16,55,66,-11,50
East Fife,2851,6,14,3,19,49,64,-15,45
Airdrieon,2851,7,11,11,14,47,59,-12,44
Forfar,2851,8,10,5,21,39,66,-27,35
Queen's Park,2851,9,7,10,19,43,73,-30,31
Albion,2851,10,8,6,22,57,84,-27,30
Raith,2852,1,23,8,5,69,32,37,77
Ayr,2852,2,24,4,8,93,44,49,76
Arbroath,2852,3,18,8,10,72,48,24,62
Alloa,2852,4,17,8,11,56,44,12,59
Stranraer,2852,5,16,5,15,58,66,-8,53
Airdrieon,2852,6,10,12,14,46,59,-13,42
East Fife,2852,7,13,3,20,49,67,-18,42
Forfar,2852,8,10,6,20,39,65,-26,36
Albion,2852,9,8,6,22,59,81,-22,30
Queen's Park,2852,10,6,10,20,39,74,-35,28
Ayr,2853,1,24,4,8,95,44,51,76
Raith,2853,2,22,9,5,69,33,36,75
Arbroath,2853,3,17,9,10,70,48,22,60
Alloa,2853,4,17,9,10,57,44,13,60
Stranraer,2853,5,15,6,15,56,65,-9,51
Airdrieon,2853,6,11,11,14,46,58,-12,44
East Fife,2853,7,13,4,19,48,65,-17,43
Forfar,2853,8,10,5,21,38,65,-27,35
Albion,2853,9,8,6,22,59,83,-24,30
Queen's Park,2853,10,6,11,19,39,72,-33,29
Raith,2854,1,23,8,5,71,32,39,77
Ayr,2854,2,24,4,8,92,42,50,76
Arbroath,2854,3,18,8,10,72,49,23,62
Alloa,2854,4,17,8,11,56,46,10,59
Stranraer,2854,5,16,5,15,56,64,-8,53
Airdrieon,2854,6,11,11,14,47,59,-12,44
East Fife,2854,7,13,3,20,47,65,-18,42
Forfar,2854,8,10,5,21,39,66,-27,35
Albion,2854,9,8,6,22,57,80,-23,30
Queen's Park,2854,10,6,10,20,40,74,-34,28
Raith,2855,1,23,8,5,70,32,38,77
Ayr,2855,2,24,4,8,93,43,50,76
Arbroath,2855,3,18,8,10,71,48,23,62
Alloa,2855,4,17,8,11,56,45,11,59
Stranraer,2855,5,15,6,15,56,65,-9,51
Airdrieon,2855,6,11,11,14,46,58,-12,44
East Fife,2855,7,13,4,19,48,65,-17,43
Forfar,2855,8,10,5,21,38,65,-27,35
Albion,2855,9,8,6,22,58,81,-23,30
Queen's Park,2855,10,6,10,20,39,73,-34,28
Raith,2856,1,23,8,5,71,33,38,77
Ayr,2856,2,23,5,8,93,45,48,74
Arbroath,2856,3,17,8,11,70,51,19,59
Alloa,2856,4,17,8,11,57,46,11,59
Stranraer,2856,5,15,6,15,56,65,-9,51
Airdrieon,2856,6,11,11,14,48,58,-10,44
East Fife,2856,7,13,4,19,48,65,-17,43
Forfar,2856,8,10,5,21,38,67,-29,35
Albion,2856,9,8,7,21,60,81,-21,31
Queen's Park,2856,10,7,10,19,42,72,-30,31
Raith,2857,1,23,8,5,72,32,40,77
Ayr,2857,2,23,4,9,91,44,47,73
Arbroath,2857,3,18,8,10,71,48,23,62
Alloa,2857,4,17,8,11,56,47,9,59
Stranraer,2857,5,15,6,15,56,65,-9,51
Airdrieon,2857,6,11,11,14,48,59,-11,44
East Fife,2857,7,13,4,19,48,65,-17,43
Forfar,2857,8,10,5,21,39,67,-28,35
Albion,2857,9,9,6,21,59,79,-20,33
Queen's Park,2857,10,6,10,20,39,73,-34,28
Ayr,2858,1,24,4,8,94,42,52,76
Raith,2858,2,22,9,5,68,32,36,75
Arbroath,2858,3,18,8,10,72,49,23,62
Alloa,2858,4,17,9,10,56,43,13,60
Stranraer,2858,5,15,5,16,55,68,-13,50
East Fife,2858,6,14,3,19,51,64,-13,45
Airdrieon,2858,7,11,11,14,46,58,-12,44
Forfar,2858,8,10,5,21,38,65,-27,35
Albion,2858,9,8,6,22,57,82,-25,30
Queen's Park,2858,10,6,10,20,40,74,-34,28
Raith,2859,1,23,8,5,70,32,38,77
Ayr,2859,2,23,5,8,92,44,48,74
Arbroath,2859,3,18,8,10,73,49,24,62
Alloa,2859,4,17,8,11,56,45,11,59
Stranraer,2859,5,15,6,15,56,65,-9,51
East Fife,2859,6,13,4,19,48,65,-17,43
Airdrieon,2859,7,10,11,15,46,60,-14,41
Forfar,2859,8,11,5,20,40,65,-25,38
Albion,2859,9,8,7,21,59,80,-21,31
Queen's Park,2859,10,6,10,20,40,75,-35,28
Ayr,2860,1,24,4,8,92,42,50,76
Raith,2860,2,22,8,6,69,34,35,74
Alloa,2860,3,18,8,10,58,44,14,62
Arbroath,2860,4,17,8,11,70,52,18,59
Stranraer,2860,5,15,5,16,56,66,-10,50
East Fife,2860,6,14,3,19,49,65,-16,45
Airdrieon,2860,7,10,11,15,46,60,-14,41
Forfar,2860,8,11,5,20,40,65,-25,38
Queen's Park,2860,9,7,10,19,43,72,-29,31
Albion,2860,10,8,6,22,57,80,-23,30
Ayr,2861,1,23,5,8,93,45,48,74
Raith,2861,2,22,8,6,68,35,33,74
Alloa,2861,3,18,8,10,59,43,16,62
Arbroath,2861,4,17,8,11,70,51,19,59
Stranraer,2861,5,15,6,15,55,64,-9,51
East Fife,2861,6,13,4,19,47,64,-17,43
Airdrieon,2861,7,10,12,14,45,58,-13,42
Forfar,2861,8,10,6,20,38,64,-26,36
Albion,2861,9,8,7,21,60,81,-21,31
Queen's Park,2861,10,7,10,19,42,72,-30,31
Raith,2862,1,23,8,5,70,32,38,77
Ayr,2862,2,24,4,8,95,46,49,76
Arbroath,2862,3,18,8,10,74,49,25,62
Alloa,2862,4,17,8,11,56,45,11,59
Stranraer,2862,5,15,5,16,55,65,-10,50
East Fife,2862,6,14,3,19,48,64,-16,45
Airdrieon,2862,7,11,11,14,47,59,-12,44
Forfar,2862,8,10,5,21,39,66,-27,35
Albion,2862,9,8,6,22,61,83,-22,30
Queen's Park,2862,10,6,10,20,40,76,-36,28
Raith,2863,1,23,8,5,71,32,39,77
Ayr,2863,2,24,4,8,92,43,49,76
Arbroath,2863,3,17,8,11,71,53,18,59
Alloa,2863,4,17,8,11,56,46,10,59
Stranraer,2863,5,15,5,16,56,66,-10,50
East Fife,2863,6,14,3,19,49,65,-16,45
Airdrieon,2863,7,11,11,14,46,58,-12,44
Forfar,2863,8,10,5,21,38,65,-27,35
Queen's Park,2863,9,7,10,19,44,73,-29,31
Albion,2863,10,8,6,22,58,80,-22,30
Raith,2864,1,23,8,5,70,32,38,77
Ayr,2864,2,24,4,8,95,44,51,76
Arbroath,2864,3,18,8,10,72,48,24,62
Alloa,2864,4,17,8,11,56,45,11,59
Stranraer,2864,5,16,5,15,57,65,-8,53
Airdrieon,2864,6,11,11,14,46,58,-12,44
East Fife,2864,7,13,3,20,48,66,-18,42
Forfar,2864,8,10,5,21,38,65,-27,35
Albion,2864,9,8,6,22,59,83,-24,30
Queen's Park,2864,10,6,10,20,39,74,-35,28
Ayr,2865,1,24,4,8,92,43,49,76
Raith,2865,2,22,8,6,68,33,35,74
Arbroath,2865,3,18,8,10,73,48,25,62
Alloa,2865,4,18,8,10,57,43,14,62
Stranraer,2865,5,15,6,15,56,65,-9,51
Airdrieon,2865,6,11,11,14,46,58,-12,44
East Fife,2865,7,13,4,19,48,65,-17,43
Forfar,2865,8,10,5,21,38,65,-27,35
Albion,2865,9,8,6,22,58,80,-22,30
Queen's Park,2865,10,6,10,20,39,75,-36,28
Ayr,2866,1,24,4,8,97,44,53,76
Raith,2866,2,22,8,6,69,34,35,74
Arbroath,2866,3,18,8,10,71,48,23,62
Alloa,2866,4,18,8,10,58,44,14,62
Stranraer,2866,5,15,5,16,56,67,-11,50
East Fife,2866,6,14,3,19,50,65,-15,45
Airdrieon,2866,7,10,11,15,45,59,-14,41
Forfar,2866,8,11,5,20,39,64,-25,38
Albion,2866,9,8,6,22,59,85,-26,30
Queen's Park,2866,10,6,10,20,39,73,-34,28
Raith,2867,1,23,8,5,71,32,39,77
Ayr,2867,2,24,4,8,98,43,55,76
Arbroath,2867,3,18,8,10,72,49,23,62
Alloa,2867,4,17,8,11,56,46,10,59
Stranraer,2867,5,15,5,16,56,70,-14,50
East Fife,2867,6,14,3,19,53,65,-12,45
Airdrieon,2867,7,10,12,14,46,59,-13,42
Forfar,2867,8,10,6,20,39,65,-26,36
Albion,2867,9,8,6,22,58,86,-28,30
Queen's Park,2867,10,6,10,20,40,74,-34,28
Raith,2868,1,23,8,5,70,32,38,77
Ayr,2868,2,24,4,8,94,43,51,76
Arbroath,2868,3,17,8,11,71,51,20,59
Alloa,2868,4,17,8,11,56,45,11,59
Stranraer,2868,5,15,5,16,59,69,-10,50
East Fife,2868,6,14,3,19,52,68,-16,45
Airdrieon,2868,7,11,11,14,48,59,-11,44
Forfar,2868,8,10,5,21,39,67,-28,35
Queen's Park,2868,9,7,10,19,42,73,-31,31
Albion,2868,10,8,6,22,58,82,-24,30
Raith,2869,1,23,8,5,69,32,37,77
Ayr,2869,2,23,4,9,92,45,47,73
Arbroath,2869,3,17,8,11,72,52,20,59
Alloa,2869,4,17,8,11,56,44,12,59
Stranraer,2869,5,16,5,15,57,65,-8,53
East Fife,2869,6,13,3,20,48,66,-18,42
Airdrieon,2869,7,10,11,15,45,60,-15,41
Forfar,2869,8,11,5,20,40,64,-24,38
Albion,2869,9,9,6,21,60,80,-20,33
Queen's Park,2869,10,7,10,19,43,74,-31,31
Raith,2870,1,23,8,5,70,33,37,77
Ayr,2870,2,24,4,8,95,42,53,76
Arbroath,2870,3,17,8,11,70,49,21,59
Alloa,2870,4,17,8,11,57,45,12,59
Stranraer,2870,5,15,5,16,55,65,-10,50
East Fife,2870,6,14,3,19,48,64,-16,45
Airdrieon,2870,7,11,11,14,50,58,-8,44
Forfar,2870,8,10,5,21,38,69,-31,35
Queen's Park,2870,9,7,10,19,40,72,-32,31
Albion,2870,10,8,6,22,57,83,-26,30
Raith,2871,1,23,8,5,70,32,38,77
Ayr,2871,2,24,4,8,92,43,49,76
Arbroath,2871,3,18,8,10,71,48,23,62
Alloa,2871,4,17,8,11,56,45,11,59
Stranraer,2871,5,15,6,15,56,65,-9,51
East Fife,2871,6,13,4,19,48,65,-17,43
Airdrieon,2871,7,10,11,15,45,59,-14,41
Forfar,2871,8,11,5,20,39,64,-25,38
Albion,2871,9,8,6,22,58,80,-22,30
Queen's Park,2871,10,6,10,20,39,73,-34,28
Ayr,2872,1,24,4,8,95,43,52,76
Raith,2872,2,22,8,6,69,34,35,74
Arbroath,2872,3,18,8,10,71,48,23,62
Alloa,2872,4,18,8,10,58,44,14,62
Stranraer,2872,5,15,5,16,55,66,-11,50
East Fife,2872,6,14,3,19,49,64,-15,45
Airdrieon,2872,7,11,11,14,48,59,-11,44
Forfar,2872,8,10,5,21,39,67,-28,35
Albion,2872,9,8,6,22,58,83,-25,30
Queen's Park,2872,10,6,10,20,39,73,-34,28
Raith,2873,1,23,8,5,70,32,38,77
Ayr,2873,2,24,4,8,93,44,49,76
Arbroath,2873,3,17,8,11,70,51,19,59
Alloa,2873,4,17,8,11,56,45,11,59
Stranraer,2873,5,16,5,15,58,64,-6,53
Airdrieon,2873,6,10,12,14,48,61,-13,42
East Fife,2873,7,13,3,20,47,67,-20,42
Forfar,2873,8,10,6,20,41,67,-26,36
Queen's Park,2873,9,7,10,19,42,72,-30,31
Albion,2873,10,8,6,22,59,81,-22,30
Ayr,2874,1,24,4,8,95,43,52,76
Raith,2874,2,22,9,5,68,32,36,75
Alloa,2874,3,17,9,10,56,43,13,60
Arbroath,2874,4,17,8,11,72,54,18,59
Stranraer,2874,5,16,5,15,59,66,-7,53
Airdrieon,2874,6,10,12,14,45,58,-13,42
East Fife,2874,7,13,3,20,49,68,-19,42
Forfar,2874,8,10,6,20,38,64,-26,36
Queen's Park,2874,9,7,10,19,45,74,-29,31
Albion,2874,10,8,6,22,58,83,-25,30
Ayr,2875,1,24,4,8,97,44,53,76
Raith,2875,2,22,8,6,69,34,35,74
Arbroath,2875,3,18,8,10,71,48,23,62
Alloa,2875,4,18,8,10,58,44,14,62
Stranraer,2875,5,16,5,15,57,65,-8,53
Airdrieon,2875,6,11,11,14,48,59,-11,44
East Fife,2875,7,13,3,20,48,66,-18,42
Forfar,2875,8,10,5,21,39,67,-28,35
Albion,2875,9,8,6,22,59,85,-26,30
Queen's Park,2875,10,6,10,20,39,73,-34,28
Ayr,2876,1,24,4,8,94,43,51,76
Raith,2876,2,22,9,5,69,33,36,75
Alloa,2876,3,17,9,10,57,44,13,60
Arbroath,2876,4,17,8,11,70,49,21,59
Stranraer,2876,5,15,6,15,56,65,-9,51
Airdrieon,2876,6,11,11,14,46,58,-12,44
East Fife,2876,7,13,4,19,48,65,-17,43
Forfar,2876,8,10,5,21,38,65,-27,35
Queen's Park,2876,9,7,10,19,40,72,-32,31
Albion,2876,10,8,6,22,58,82,-24,30
Ayr,2877,1,24,4,8,93,42,51,76
Raith,2877,2,22,9,5,68,32,36,75
Arbroath,2877,3,17,9,10,71,49,22,60
Alloa,2877,4,17,9,10,56,43,13,60
Stranraer,2877,5,15,5,16,58,68,-10,50
East Fife,2877,6,14,3,19,51,67,-16,45
Airdrieon,2877,7,10,11,15,46,60,-14,41
Forfar,2877,8,11,5,20,40,65,-25,38
Albion,2877,9,8,6,22,57,81,-24,30
Queen's Park,2877,10,6,11,19,40,73,-33,29
Raith,2878,1,23,8,5,72,33,39,77
Ayr,2878,2,24,4,8,93,42,51,76
Arbroath,2878,3,17,8,11,71,51,20,59
Alloa,2878,4,17,8,11,57,47,10,59
Stranraer,2878,5,15,5,16,55,66,-11,50
East Fife,2878,6,14,3,19,49,64,-15,45
Airdrieon,2878,7,11,11,14,48,59,-11,44
Forfar,2878,8,10,5,21,39,67,-28,35
Queen's Park,2878,9,7,10,19,42,73,-31,31
Albion,2878,10,8,6,22,57,81,-24,30
Raith,2879,1,23,8,5,71,32,39,77
Ayr,2879,2,23,5,8,91,43,48,74
Arbroath,2879,3,18,8,10,75,50,25,62
Alloa,2879,4,17,8,11,56,46,10,59
Stranraer,2879,5,15,6,15,56,65,-9,51
Airdrieon,2879,6,11,11,14,46,58,-12,44
East Fife,2879,7,13,4,19,48,65,-17,43
Forfar,2879,8,10,5,21,38,65,-27,35
Albion,2879,9,8,7,21,58,79,-21,31
Queen's Park,2879,10,6,10,20,41,77,-36,28
Raith,2880,1,23,8,5,69,32,37,77
Ayr,2880,2,24,4,8,95,42,53,76
Arbroath,2880,3,17,8,11,72,52,20,59
Alloa,2880,4,17,8,11,56,44,12,59
Stranraer,2880,5,15,5,16,55,66,-11,50
East Fife,2880,6,14,3,19,49,64,-15,45
Airdrieon,2880,7,10,11,15,45,59,-14,41
Forfar,2880,8,11,5,20,39,64,-25,38
Queen's Park,2880,9,7,10,19,43,74,-31,31
Albion,2880,10,8,6,22,57,83,-26,30
Raith,2881,1,23,8,5,70,33,37,77
Ayr,2881,2,24,4,8,96,44,52,76
Arbroath,2881,3,18,8,10,73,48,25,62
Alloa,2881,4,17,8,11,57,45,12,59
Stranraer,2881,5,16,5,15,57,64,-7,53
Airdrieon,2881,6,11,11,14,48,58,-10,44
East Fife,2881,7,13,3,20,47,66,-19,42
Forfar,2881,8,10,5,21,38,67,-29,35
Albion,2881,9,8,6,22,59,84,-25,30
Queen's Park,2881,10,6,10,20,39,75,-36,28
Ayr,2882,1,24,4,8,91,42,49,76
Raith,2882,2,22,9,5,69,33,36,75
Alloa,2882,3,17,9,10,57,44,13,60
Arbroath,2882,4,17,8,11,70,49,21,59
Stranraer,2882,5,16,5,15,57,65,-8,53
Airdrieon,2882,6,10,12,14,46,59,-13,42
East Fife,2882,7,13,3,20,48,66,-18,42
Forfar,2882,8,10,6,20,39,65,-26,36
Queen's Park,2882,9,7,10,19,40,72,-32,31
Albion,2882,10,8,6,22,57,79,-22,30
Ayr,2883,1,24,4,8,95,44,51,76
Raith,2883,2,22,8,6,68,33,35,74
Arbroath,2883,3,18,8,10,72,49,23,62
Alloa,2883,4,18,8,10,57,43,14,62
Stranraer,2883,5,15,5,16,57,68,-11,50
East Fife,2883,6,14,3,19,51,66,-15,45
Airdrieon,2883,7,10,12,14,45,58,-13,42
Forfar,2883,8,10,6,20,38,64,-26,36
Albion,2883,9,8,6,22,59,83,-24,30
Queen's Park,2883,10,6,10,20,40,74,-34,28
Raith,2884,1,23,8,5,71,33,38,77
Ayr,2884,2,24,4,8,95,44,51,76
Arbroath,2884,3,17,9,10,70,48,22,60
Alloa,2884,4,17,8,11,57,46,11,59
Stranraer,2884,5,15,5,16,56,66,-10,50
East Fife,2884,6,14,3,19,49,65,-16,45
Airdrieon,2884,7,10,11,15,46,61,-15,41
Forfar,2884,8,11,5,20,41,65,-24,38
Albion,2884,9,8,6,22,59,83,-24,30
Queen's Park,2884,10,6,11,19,39,72,-33,29
Ayr,2885,1,24,4,8,92,43,49,76
Raith,2885,2,22,8,6,69,34,35,74
Alloa,2885,3,18,8,10,58,44,14,62
Arbroath,2885,4,17,8,11,71,50,21,59
Stranraer,2885,5,15,5,16,55,65,-10,50
East Fife,2885,6,14,3,19,48,64,-16,45
Airdrieon,2885,7,11,11,14,47,59,-12,44
Forfar,2885,8,10,5,21,39,66,-27,35
Queen's Park,2885,9,7,10,19,41,73,-32,31
Albion,2885,10,8,6,22,58,80,-22,30
Ayr,2886,1,24,4,8,93,44,49,76
Raith,2886,2,22,9,5,69,33,36,75
Alloa,2886,3,17,9,10,57,44,13,60
Arbroath,2886,4,17,8,11,71,51,20,59
Stranraer,2886,5,16,5,15,57,65,-8,53
Airdrieon,2886,6,11,11,14,47,59,-12,44
East Fife,2886,7,13,3,20,48,66,-18,42
Forfar,2886,8,10,5,21,39,66,-27,35
Queen's Park,2886,9,7,10,19,42,73,-31,31
Albion,2886,10,8,6,22,59,81,-22,30
Raith,2887,1,23,8,5,69,32,37,77
Ayr,2887,2,24,4,8,95,43,52,76
Arbroath,2887,3,17,8,11,70,51,19,59
Alloa,2887,4,17,8,11,56,44,12,59
Stranraer,2887,5,15,6,15,56,65,-9,51
East Fife,2887,6,13,4,19,48,65,-17,43
Airdrieon,2887,7,10,12,14,48,61,-13,42
Forfar,2887,8,10,6,20,41,67,-26,36
Queen's Park,2887,9,7,10,19,42,72,-30,31
Albion,2887,10,8,6,22,58,83,-25,30
Raith,2888,1,23,8,5,70,32,38,77
Ayr,2888,2,24,4,8,95,44,51,76
Arbroath,2888,3,17,8,11,71,50,21,59
Alloa,2888,4,17,8,11,56,45,11,59
Stranraer,2888,5,15,5,16,57,67,-10,50
East Fife,2888,6,14,3,19,50,66,-16,45
Airdrieon,2888,7,10,12,14,45,58,-13,42
Forfar,2888,8,10,6,20,38,64,-26,36
Queen's Park,2888,9,7,10,19,41,73,-32,31
Albion,2888,10,8,6,22,59,83,-24,30
Raith,2889,1,23,8,5,70,32,38,77
Ayr,2889,2,24,4,8,94,42,52,76
Arbroath,2889,3,18,8,10,71,48,23,62
Alloa,2889,4,17,8,11,56,45,11,59
Stranraer,2889,5,16,5,15,59,65,-6,53
Airdrieon,2889,6,10,12,14,46,59,-13,42
East Fife,2889,7,13,3,20,48,68,-20,42
Forfar,2889,8,10,6,20,39,65,-26,36
Albion,2889,9,8,6,22,57,82,-25,30
Queen's Park,2889,10,6,10,20,39,73,-34,28
Raith,2890,1,23,8,5,71,32,39,77
Ayr,2890,2,24,4,8,97,44,53,76
Arbroath,2890,3,18,8,10,73,50,23,62
Alloa,2890,4,17,8,11,56,46,10,59
Stranraer,2890,5,15,5,16,55,67,-12,50
East Fife,2890,6,14,3,19,50,64,-14,45
Airdrieon,2890,7,11,11,14,47,59,-12,44
Forfar,2890,8,10,5,21,39,66,-27,35
Albion,2890,9,8,6,22,59,85,-26,30
Queen's Park,2890,10,6,10,20,41,75,-34,28
Raith,2891,1,23,8,5,71,32,39,77
Ayr,2891,2,23,4,9,90,45,45,73
Arbroath,2891,3,17,8,11,70,50,20,59
Alloa,2891,4,17,8,11,56,46,10,59
Stranraer,2891,5,16,5,15,57,65,-8,53
Airdrieon,2891,6,11,11,14,47,58,-11,44
East Fife,2891,7,13,3,20,48,66,-18,42
Forfar,2891,8,10,5,21,38,66,-28,35
Albion,2891,9,9,6,21,60,78,-18,33
Queen's Park,2891,10,7,10,19,41,72,-31,31
Ayr,2892,1,24,4,8,93,43,50,76
Raith,2892,2,22,8,6,68,34,34,74
Alloa,2892,3,18,8,10,58,43,15,62
Arbroath,2892,4,17,8,11,70,50,20,59
Stranraer,2892,5,15,6,15,56,65,-9,51
East Fife,2892,6,13,4,19,48,65,-17,43
Airdrieon,2892,7,10,12,14,46,59,-13,42
Forfar,2892,8,10,6,20,39,65,-26,36
Queen's Park,2892,9,7,10,19,41,72,-31,31
Albion,2892,10,8,6,22,58,81,-23,30
Ayr,2893,1,24,4,8,93,42,51,76
Raith,2893,2,22,8,6,68,33,35,74
Arbroath,2893,3,18,8,10,72,48,24,62
Alloa,2893,4,18,8,10,57,43,14,62
Stranraer,2893,5,16,5,15,57,65,-8,53
Airdrieon,2893,6,11,11,14,47,59,-12,44
East Fife,2893,7,13,3,20,48,66,-18,42
Forfar,2893,8,10,5,21,39,66,-27,35
Albion,2893,9,8,6,22,57,81,-24,30
Queen's Park,2893,10,6,10,20,39,74,-35,28
Ayr,2894,1,24,4,8,94,43,51,76
Raith,2894,2,22,9,5,70,34,36,75
Arbroath,2894,3,18,8,10,74,50,24,62
Alloa,2894,4,17,9,10,58,45,13,60
Stranraer,2894,5,15,5,16,56,66,-10,50
East Fife,2894,6,14,3,19,49,65,-16,45
Airdrieon,2894,7,10,11,15,45,59,-14,41
Forfar,2894,8,11,5,20,39,64,-25,38
Albion,2894,9,8,6,22,58,82,-24,30
Queen's Park,2894,10,6,10,20,41,76,-35,28
Raith,2895,1,23,8,5,72,34,38,77
Ayr,2895,2,24,4,8,95,43,52,76
Arbroath,2895,3,17,9,10,72,50,22,60
Alloa,2895,4,17,8,11,58,47,11,59
Stranraer,2895,5,15,5,16,56,67,-11,50
East Fife,2895,6,14,3,19,50,65,-15,45
Airdrieon,2895,7,10,11,15,46,60,-14,41
Forfar,2895,8,11,5,20,40,65,-25,38
Albion,2895,9,8,6,22,58,83,-25,30
Queen's Park,2895,10,6,11,19,41,74,-33,29
Ayr,2896,1,24,4,8,93,42,51,76
Raith,2896,2,22,8,6,68,34,34,74
Arbroath,2896,3,18,8,10,74,48,26,62
Alloa,2896,4,18,8,10,58,43,15,62
Stranraer,2896,5,16,5,15,58,65,-7,53
East Fife,2896,6,13,3,20,48,67,-19,42
Airdrieon,2896,7,10,11,15,45,60,-15,41
Forfar,2896,8,11,5,20,40,64,-24,38
Albion,2896,9,8,6,22,57,81,-24,30
Queen's Park,2896,10,6,10,20,39,76,-37,28
Ayr,2897,1,24,4,8,92,43,49,76
Raith,2897,2,22,8,6,68,33,35,74
Alloa,2897,3,18,8,10,57,43,14,62
Arbroath,2897,4,17,9,10,72,50,22,60
Stranraer,2897,5,15,5,16,57,69,-12,50
East Fife,2897,6,14,3,19,52,66,-14,45
Airdrieon,2897,7,11,11,14,48,59,-11,44
Forfar,2897,8,10,5,21,39,67,-28,35
Albion,2897,9,8,6,22,58,80,-22,30
Queen's Park,2897,10,6,11,19,41,74,-33,29
Ayr,2898,1,24,4,8,95,42,53,76
Raith,2898,2,22,9,5,68,32,36,75
Alloa,2898,3,17,9,10,56,43,13,60
Arbroath,2898,4,17,8,11,70,51,19,59
Stranraer,2898,5,16,5,15,57,64,-7,53
Airdrieon,2898,6,11,11,14,46,58,-12,44
East Fife,2898,7,13,3,20,47,66,-19,42
Forfar,2898,8,10,5,21,38,65,-27,35
Queen's Park,2898,9,7,10,19,42,72,-30,31
Albion,2898,10,8,6,22,57,83,-26,30
Raith,2899,1,23,8,5,71,34,37,77
Ayr,2899,2,24,4,8,96,43,53,76
Arbroath,2899,3,17,8,11,70,49,21,59
Alloa,2899,4,17,8,11,58,46,12,59
Stranraer,2899,5,15,5,16,57,67,-10,50
East Fife,2899,6,14,3,19,50,66,-16,45
Airdrieon,2899,7,11,11,14,48,59,-11,44
Forfar,2899,8,10,5,21,39,67,-28,35
Queen's Park,2899,9,7,10,19,40,72,-32,31
Albion,2899,10,8,6,22,58,84,-26,30
Raith,2900,1,22,8,6,68,33,35,74
Ayr,2900,2,23,4,9,92,47,45,73
Arbroath,2900,3,18,8,10,73,49,24,62
Alloa,2900,4,18,8,10,57,43,14,62
Stranraer,2900,5,15,6,15,55,64,-9,51
East Fife,2900,6,13,4,19,47,64,-17,43
Airdrieon,2900,7,10,12,14,46,59,-13,42
Forfar,2900,8,10,6,20,39,65,-26,36
Albion,2900,9,9,6,21,62,80,-18,33
Queen's Park,2900,10,6,10,20,40,75,-35,28
Raith,2901,1,23,8,5,71,33,38,77
Ayr,2901,2,24,4,8,95,44,51,76
Arbroath,2901,3,17,8,11,72,51,21,59
Alloa,2901,4,17,8,11,57,46,11,59
Stranraer,2901,5,15,6,15,57,66,-9,51
East Fife,2901,6,13,4,19,49,66,-17,43
Airdrieon,2901,7,10,11,15,46,60,-14,41
Forfar,2901,8,11,5,20,40,65,-25,38
Queen's Park,2901,9,7,10,19,42,74,-32,31
Albion,2901,10,8,6,22,59,83,-24,30
Ayr,2902,1,23,5,8,92,44,48,74
Raith,2902,2,22,8,6,69,34,35,74
Arbroath,2902,3,18,8,10,73,50,23,62
Alloa,2902,4,18,8,10,58,44,14,62
Stranraer,2902,5,15,5,16,57,67,-10,50
East Fife,2902,6,14,3,19,50,66,-16,45
Airdrieon,2902,7,11,11,14,48,60,-12,44
Forfar,2902,8,10,5,21,40,67,-27,35
Albion,2902,9,8,7,21,59,80,-21,31
Queen's Park,2902,10,6,10,20,41,75,-34,28
Ayr,2903,1,24,4,8,93,44,49,76
Raith,2903,2,22,9,5,69,33,36,75
Arbroath,2903,3,18,8,10,71,48,23,62
Alloa,2903,4,17,9,10,57,44,13,60
Stranraer,2903,5,15,5,16,56,66,-10,50
East Fife,2903,6,14,3,19,49,65,-16,45
Airdrieon,2903,7,11,11,14,46,58,-12,44
Forfar,2903,8,10,5,21,38,65,-27,35
Albion,2903,9,8,6,22,59,81,-22,30
Queen's Park,2903,10,6,10,20,39,73,-34,28
Ayr,2904,1,24,4,8,99,43,56,76
Raith,2904,2,22,8,6,68,33,35,74
Arbroath,2904,3,18,8,10,75,52,23,62
Alloa,2904,4,18,8,10,57,43,14,62
Stranraer,2904,5,16,5,15,57,65,-8,53
East Fife,2904,6,13,3,20,48,66,-18,42
Airdrieon,2904,7,10,11,15,46,60,-14,41
Forfar,2904,8,11,5,20,40,65,-25,38
Albion,2904,9,8,6,22,58,87,-29,30
Queen's Park,2904,10,6,10,20,43,77,-34,28
Raith,2905,1,22,8,6,69,34,35,74
Ayr,2905,2,23,4,9,92,45,47,73
Alloa,2905,3,18,8,10,58,44,14,62
Arbroath,2905,4,17,8,11,72,52,20,59
Stranraer,2905,5,15,5,16,56,66,-10,50
East Fife,2905,6,14,3,19,49,65,-16,45
Airdrieon,2905,7,11,11,14,48,60,-12,44
Forfar,2905,8,10,5,21,40,67,-27,35
Albion,2905,9,9,6,21,60,80,-20,33
Queen's Park,2905,10,7,10,19,43,74,-31,31
Raith,2906,1,23,8,5,70,33,37,77
Ayr,2906,2,24,4,8,94,45,49,76
Arbroath,2906,3,17,8,11,70,52,18,59
Alloa,2906,4,17,8,11,57,45,12,59
Stranraer,2906,5,16,5,15,57,65,-8,53
Airdrieon,2906,6,10,12,14,47,60,-13,42
East Fife,2906,7,13,3,20,48,66,-18,42
Forfar,2906,8,10,6,20,40,66,-26,36
Queen's Park,2906,9,7,10,19,43,72,-29,31
Albion,2906,10,8,6,22,60,82,-22,30
Ayr,2907,1,24,4,8,97,42,55,76
Raith,2907,2,22,9,5,69,33,36,75
Alloa,2907,3,17,9,10,57,44,13,60
Arbroath,2907,4,17,8,11,71,50,21,59
Stranraer,2907,5,16,5,15,58,65,-7,53
Airdrieon,2907,6,10,12,14,46,59,-13,42
East Fife,2907,7,13,3,20,48,67,-19,42
Forfar,2907,8,10,6,20,39,65,-26,36
Queen's Park,2907,9,7,10,19,41,73,-32,31
Albion,2907,10,8,6,22,57,85,-28,30
Raith,2908,1,23,8,5,69,32,37,77
Ayr,2908,2,24,4,8,95,43,52,76
Arbroath,2908,3,18,8,10,72,49,23,62
Alloa,2908,4,17,8,11,56,44,12,59
Stranraer,2908,5,16,5,15,56,64,-8,53
Airdrieon,2908,6,11,11,14,49,59,-10,44
East Fife,2908,7,13,3,20,47,65,-18,42
Forfar,2908,8,10,5,21,39,68,-29,35
Albion,2908,9,8,6,22,58,83,-25,30
Queen's Park,2908,10,6,10,20,40,74,-34,28
Ayr,2909,1,24,4,8,96,43,53,76
Raith,2909,2,22,9,5,71,35,36,75
Arbroath,2909,3,18,8,10,73,49,24,62
Alloa,2909,4,17,9,10,59,46,13,60
Stranraer,2909,5,15,5,16,56,67,-11,50
East Fife,2909,6,14,3,19,50,65,-15,45
Airdrieon,2909,7,10,11,15,45,60,-15,41
Forfar,2909,8,11,5,20,40,64,-24,38
Albion,2909,9,8,6,22,58,84,-26,30
Queen's Park,2909,10,6,10,20,40,75,-35,28
Ayr,2910,1,23,5,8,93,45,48,74
Raith,2910,2,22,8,6,68,34,34,74
Alloa,2910,3,18,8,10,58,43,15,62
Arbroath,2910,4,17,9,10,71,49,22,60
Stranraer,2910,5,15,5,16,56,67,-11,50
East Fife,2910,6,14,3,19,50,65,-15,45
Airdrieon,2910,7,10,11,15,45,59,-14,41
Forfar,2910,8,11,5,20,39,64,-25,38
Albion,2910,9,8,7,21,60,81,-21,31
Queen's Park,2910,10,6,11,19,40,73,-33,29
Ayr,2911,1,24,4,8,95,45,50,76
Raith,2911,2,22,9,5,70,34,36,75
Arbroath,2911,3,18,8,10,73,50,23,62
Alloa,2911,4,17,9,10,58,45,13,60
Stranraer,2911,5,15,5,16,56,66,-10,50
East Fife,2911,6,14,3,19,49,65,-16,45
Airdrieon,2911,7,11,11,14,46,58,-12,44
Forfar,2911,8,10,5,21,38,65,-27,35
Albion,2911,9,8,6,22,60,83,-23,30
Queen's Park,2911,10,6,10,20,41,75,-34,28
Ayr,2912,1,24,4,8,93,42,51,76
Raith,2912,2,22,9,5,69,33,36,75
Arbroath,2912,3,18,8,10,71,48,23,62
Alloa,2912,4,17,9,10,57,44,13,60
Stranraer,2912,5,15,6,15,57,66,-9,51
East Fife,2912,6,13,4,19,49,66,-17,43
Airdrieon,2912,7,10,11,15,45,60,-15,41
Forfar,2912,8,11,5,20,40,64,-24,38
Albion,2912,9,8,6,22,57,81,-24,30
Queen's Park,2912,10,6,10,20,39,73,-34,28
Ayr,2913,1,24,4,8,91,42,49,76
Raith,2913,2,22,9,5,69,33,36,75
Arbroath,2913,3,18,8,10,72,49,23,62
Alloa,2913,4,17,9,10,57,44,13,60
Stranraer,2913,5,15,6,15,56,65,-9,51
Airdrieon,2913,6,11,11,14,48,59,-11,44
East Fife,2913,7,13,4,19,48,65,-17,43
Forfar,2913,8,10,5,21,39,67,-28,35
Albion,2913,9,8,6,22,57,79,-22,30
Queen's Park,2913,10,6,10,20,40,74,-34,28
Ayr,2914,1,24,4,8,94,42,52,76
Raith,2914,2,22,9,5,68,32,36,75
Arbroath,2914,3,17,9,10,71,49,22,60
Alloa,2914,4,17,9,10,56,43,13,60
Stranraer,2914,5,15,5,16,57,67,-10,50
East Fife,2914,6,14,3,19,50,66,-16,45
Airdrieon,2914,7,10,12,14,47,60,-13,42
Forfar,2914,8,10,6,20,40,66,-26,36
Albion,2914,9,8,6,22,57,82,-25,30
Queen's Park,2914,10,6,11,19,40,73,-33,29
Raith,2915,1,23,8,5,72,32,40,77
Ayr,2915,2,24,4,8,91,42,49,76
Arbroath,2915,3,18,8,10,72,48,24,62
Alloa,2915,4,17,8,11,56,47,9,59
Stranraer,2915,5,15,6,15,59,68,-9,51
East Fife,2915,6,13,4,19,51,68,-17,43
Airdrieon,2915,7,10,12,14,45,58,-13,42
Forfar,2915,8,10,6,20,38,64,-26,36
Albion,2915,9,8,6,22,57,79,-22,30
Queen's Park,2915,10,6,10,20,39,74,-35,28
Raith,2916,1,22,9,5,68,32,36,75
Ayr,2916,2,23,4,9,90,44,46,73
Alloa,2916,3,17,9,10,56,43,13,60
Arbroath,2916,4,17,8,11,70,49,21,59
Stranraer,2916,5,15,5,16,56,67,-11,50
East Fife,2916,6,14,3,19,50,65,-15,45
Airdrieon,2916,7,11,11,14,48,58,-10,44
Forfar,2916,8,10,5,21,38,67,-29,35
Albion,2916,9,9,6,21,59,78,-19,33
Queen's Park,2916,10,7,10,19,40,72,-32,31
Ayr,2917,1,24,4,8,94,43,51,76
Raith,2917,2,22,9,5,68,32,36,75
Alloa,2917,3,17,9,10,56,43,13,60
Arbroath,2917,4,17,8,11,72,51,21,59
Stranraer,2917,5,15,5,16,57,67,-10,50
East Fife,2917,6,14,3,19,50,66,-16,45
Airdrieon,2917,7,11,11,14,47,59,-12,44
Forfar,2917,8,10,5,21,39,66,-27,35
Queen's Park,2917,9,7,10,19,42,74,-32,31
Albion,2917,10,8,6,22,58,82,-24,30
Raith,2918,1,22,9,5,70,34,36,75
Ayr,2918,2,23,5,8,93,45,48,74
Arbroath,2918,3,18,8,10,72,48,24,62
Alloa,2918,4,17,9,10,58,45,13,60
Stranraer,2918,5,15,6,15,56,65,-9,51
Airdrieon,2918,6,11,11,14,47,58,-11,44
East Fife,2918,7,13,4,19,48,65,-17,43
Forfar,2918,8,10,5,21,38,66,-28,35
Albion,2918,9,8,7,21,60,81,-21,31
Queen's Park,2918,10,6,10,20,39,74,-35,28
Raith,2919,1,23,8,5,69,32,37,77
Ayr,2919,2,24,4,8,91,42,49,76
Arbroath,2919,3,18,8,10,72,48,24,62
Alloa,2919,4,17,8,11,56,44,12,59
Stranraer,2919,5,15,5,16,57,68,-11,50
East Fife,2919,6,14,3,19,51,66,-15,45
Airdrieon,2919,7,11,11,14,46,58,-12,44
Forfar,2919,8,10,5,21,38,65,-27,35
Albion,2919,9,8,6,22,57,79,-22,30
Queen's Park,2919,10,6,10,20,39,74,-35,28
Raith,2920,1,23,8,5,71,33,38,77
Ayr,2920,2,24,4,8,94,43,51,76
Arbroath,2920,3,17,8,11,70,49,21,59
Alloa,2920,4,17,8,11,57,46,11,59
Stranraer,2920,5,15,5,16,56,66,-10,50
East Fife,2920,6,14,3,19,49,65,-16,45
Airdrieon,2920,7,11,11,14,48,59,-11,44
Forfar,2920,8,10,5,21,39,67,-28,35
Queen's Park,2920,9,7,10,19,40,72,-32,31
Albion,2920,10,8,6,22,58,82,-24,30
Ayr,2921,1,24,4,8,93,42,51,76
Raith,2921,2,22,9,5,69,33,36,75
Alloa,2921,3,17,9,10,57,44,13,60
Arbroath,2921,4,17,8,11,72,52,20,59
Stranraer,2921,5,15,6,15,57,66,-9,51
East Fife,2921,6,13,4,19,49,66,-17,43
Airdrieon,2921,7,10,12,14,47,60,-13,42
Forfar,2921,8,10,6,20,40,66,-26,36
Queen's Park,2921,9,7,10,19,43,74,-31,31
Albion,2921,10,8,6,22,57,81,-24,30
Ayr,2922,1,24,4,8,95,43,52,76
Raith,2922,2,22,9,5,72,36,36,75
Arbroath,2922,3,18,8,10,72,48,24,62
Alloa,2922,4,17,9,10,60,47,13,60
Stranraer,2922,5,15,5,16,57,68,-11,50
East Fife,2922,6,14,3,19,51,66,-15,45
Airdrieon,2922,7,10,11,15,46,60,-14,41
Forfar,2922,8,11,5,20,40,65,-25,38
Albion,2922,9,8,6,22,58,83,-25,30
Queen's Park,2922,10,6,10,20,39,74,-35,28
Ayr,2923,1,24,4,8,94,42,52,76
Raith,2923,2,22,9,5,68,32,36,75
Arbroath,2923,3,18,8,10,72,49,23,62
Alloa,2923,4,17,9,10,56,43,13,60
Stranraer,2923,5,15,6,15,56,65,-9,51
East Fife,2923,6,13,4,19,48,65,-17,43
Airdrieon,2923,7,10,12,14,46,59,-13,42
Forfar,2923,8,10,6,20,39,65,-26,36
Albion,2923,9,8,6,22,57,82,-25,30
Queen's Park,2923,10,6,10,20,40,74,-34,28
Ayr,2924,1,24,4,8,94,42,52,76
Raith,2924,2,22,8,6,69,34,35,74
Alloa,2924,3,18,8,10,58,44,14,62
Arbroath,2924,4,17,8,11,71,52,19,59
Stranraer,2924,5,15,6,15,56,65,-9,51
East Fife,2924,6,13,4,19,48,65,-17,43
Airdrieon,2924,7,10,12,14,48,61,-13,42
Forfar,2924,8,10,6,20,41,67,-26,36
Queen's Park,2924,9,7,10,19,43,73,-30,31
Albion,2924,10,8,6,22,57,82,-25,30
Raith,2925,1,23,8,5,70,32,38,77
Ayr,2925,2,24,4,8,94,42,52,76
Arbroath,2925,3,17,9,10,70,48,22,60
Alloa,2925,4,17,8,11,56,45,11,59
Stranraer,2925,5,15,5,16,56,67,-11,50
East Fife,2925,6,14,3,19,50,65,-15,45
Airdrieon,2925,7,11,11,14,47,58,-11,44
Forfar,2925,8,10,5,21,38,66,-28,35
Albion,2925,9,8,6,22,57,82,-25,30
Queen's Park,2925,10,6,11,19,39,72,-33,29
Ayr,2926,1,24,4,8,93,44,49,76
Raith,2926,2,22,8,6,68,33,35,74
Alloa,2926,3,18,8,10,57,43,14,62
Arbroath,2926,4,17,8,11,70,49,21,59
Stranraer,2926,5,16,5,15,57,64,-7,53
Airdrieon,2926,6,10,12,14,45,58,-13,42
East Fife,2926,7,13,3,20,47,66,-19,42
Forfar,2926,8,10,6,20,38,64,-26,36
Queen's Park,2926,9,7,10,19,40,72,-32,31
Albion,2926,10,8,6,22,59,81,-22,30
Ayr,2927,1,24,4,8,93,44,49,76
Raith,2927,2,22,9,5,69,33,36,75
Arbroath,2927,3,18,8,10,73,48,25,62
Alloa,2927,4,17,9,10,57,44,13,60
Stranraer,2927,5,15,5,16,57,68,-11,50
East Fife,2927,6,14,3,19,51,66,-15,45
Airdrieon,2927,7,10,12,14,45,58,-13,42
Forfar,2927,8,10,6,20,38,64,-26,36
Albion,2927,9,8,6,22,59,81,-22,30
Queen's Park,2927,10,6,10,20,39,75,-36,28
Raith,2928,1,23,8,5,72,35,37,77
Ayr,2928,2,23,5,8,92,44,48,74
Arbroath,2928,3,17,9,10,71,49,22,60
Alloa,2928,4,17,8,11,59,47,12,59
Stranraer,2928,5,15,6,15,56,65,-9,51
Airdrieon,2928,6,11,11,14,49,61,-12,44
East Fife,2928,7,13,4,19,48,65,-17,43
Forfar,2928,8,10,5,21,41,68,-27,35
Albion,2928,9,8,7,21,59,80,-21,31
Queen's Park,2928,10,6,11,19,40,73,-33,29
Raith,2929,1,23,8,5,71,32,39,77
Ayr,2929,2,24,4,8,92,42,50,76
Arbroath,2929,3,18,8,10,74,50,24,62
Alloa,2929,4,17,8,11,56,46,10,59
Stranraer,2929,5,15,5,16,56,66,-10,50
East Fife,2929,6,14,3,19,49,65,-16,45
Airdrieon,2929,7,11,11,14,48,59,-11,44
Forfar,2929,8,10,5,21,39,67,-28,35
Albion,2929,9,8,6,22,57,80,-23,30
Queen's Park,2929,10,6,10,20,41,76,-35,28
Raith,2930,1,23,8,5,69,32,37,77
Ayr,2930,2,24,4,8,95,43,52,76
Arbroath,2930,3,18,8,10,73,50,23,62
Alloa,2930,4,17,8,11,56,44,12,59
Stranraer,2930,5,15,5,16,55,65,-10,50
East Fife,2930,6,14,3,19,48,64,-16,45
Airdrieon,2930,7,11,11,14,47,58,-11,44
Forfar,2930,8,10,5,21,38,66,-28,35
Albion,2930,9,8,6,22,58,83,-25,30
Queen's Park,2930,10,6,10,20,41,75,-34,28
Raith,2931,1,22,9,5,68,32,36,75
Ayr,2931,2,23,4,9,92,45,47,73
Arbroath,2931,3,18,8,10,72,48,24,62
Alloa,2931,4,17,9,10,56,43,13,60
Stranraer,2931,5,15,5,16,56,67,-11,50
East Fife,2931,6,14,3,19,50,65,-15,45
Airdrieon,2931,7,11,11,14,48,59,-11,44
Forfar,2931,8,10,5,21,39,67,-28,35
Albion,2931,9,9,6,21,60,80,-20,33
Queen's Park,2931,10,6,10,20,39,74,-35,28
Raith,2932,1,23,8,5,69,32,37,77
Ayr,2932,2,24,4,8,94,44,50,76
Arbroath,2932,3,17,8,11,70,52,18,59
Alloa,2932,4,17,8,11,56,44,12,59
Stranraer,2932,5,16,5,15,58,65,-7,53
Airdrieon,2932,6,10,12,14,46,59,-13,42
East Fife,2932,7,13,3,20,48,67,-19,42
Forfar,2932,8,10,6,20,39,65,-26,36
Queen's Park,2932,9,7,10,19,43,72,-29,31
Albion,2932,10,8,6,22,59,82,-23,30
Ayr,2933,1,24,4,8,94,43,51,76
Raith,2933,2,22,9,5,68,32,36,75
Alloa,2933,3,17,9,10,56,43,13,60
Arbroath,2933,4,17,8,11,72,51,21,59
Stranraer,2933,5,15,5,16,57,67,-10,50
East Fife,2933,6,14,3,19,50,66,-16,45
Airdrieon,2933,7,10,11,15,45,59,-14,41
Forfar,2933,8,11,5,20,39,64,-25,38
Queen's Park,2933,9,7,10,19,42,74,-32,31
Albion,2933,10,8,6,22,58,82,-24,30
Ayr,2934,1,24,4,8,94,43,51,76
Raith,2934,2,22,8,6,70,36,34,74
Alloa,2934,3,18,8,10,60,45,15,62
Arbroath,2934,4,17,9,10,71,49,22,60
Stranraer,2934,5,15,5,16,55,65,-10,50
East Fife,2934,6,14,3,19,48,64,-16,45
Airdrieon,2934,7,11,11,14,48,59,-11,44
Forfar,2934,8,10,5,21,39,67,-28,35
Albion,2934,9,8,6,22,58,82,-24,30
Queen's Park,2934,10,6,11,19,40,73,-33,29
Raith,2935,1,23,8,5,70,33,37,77
Ayr,2935,2,23,5,8,90,42,48,74
Arbroath,2935,3,17,9,10,71,49,22,60
Alloa,2935,4,17,8,11,57,45,12,59
Stranraer,2935,5,15,6,15,57,66,-9,51
Airdrieon,2935,6,11,11,14,47,59,-12,44
East Fife,2935,7,13,4,19,49,66,-17,43
Forfar,2935,8,10,5,21,39,66,-27,35
Albion,2935,9,8,7,21,57,78,-21,31
Queen's Park,2935,10,6,11,19,40,73,-33,29
Raith,2936,1,23,8,5,71,33,38,77
Ayr,2936,2,24,4,8,93,43,50,76
Arbroath,2936,3,18,8,10,74,49,25,62
Alloa,2936,4,17,8,11,57,46,11,59
Stranraer,2936,5,15,6,15,57,66,-9,51
Airdrieon,2936,6,11,11,14,47,59,-12,44
East Fife,2936,7,13,4,19,49,66,-17,43
Forfar,2936,8,10,5,21,39,66,-27,35
Albion,2936,9,8,6,22,58,81,-23,30
Queen's Park,2936,10,6,10,20,40,76,-36,28
Ayr,2937,1,24,4,8,94,44,50,76
Raith,2937,2,22,8,6,69,34,35,74
Arbroath,2937,3,18,8,10,72,48,24,62
Alloa,2937,4,18,8,10,58,44,14,62
Stranraer,2937,5,15,5,16,56,67,-11,50
East Fife,2937,6,14,3,19,50,65,-15,45
Airdrieon,2937,7,10,12,14,46,59,-13,42
Forfar,2937,8,10,6,20,39,65,-26,36
Albion,2937,9,8,6,22,59,82,-23,30
Queen's Park,2937,10,6,10,20,39,74,-35,28
Ayr,2938,1,24,4,8,93,42,51,76
Raith,2938,2,22,8,6,68,35,33,74
Alloa,2938,3,18,8,10,59,43,16,62
Arbroath,2938,4,17,8,11,71,51,20,59
Stranraer,2938,5,15,6,15,56,65,-9,51
Airdrieon,2938,6,11,11,14,47,59,-12,44
East Fife,2938,7,13,4,19,48,65,-17,43
Forfar,2938,8,10,5,21,39,66,-27,35
Queen's Park,2938,9,7,10,19,42,73,-31,31
Albion,2938,10,8,6,22,57,81,-24,30
Ayr,2939,1,24,4,8,95,43,52,76
Raith,2939,2,22,9,5,68,32,36,75
Arbroath,2939,3,17,9,10,71,49,22,60
Alloa,2939,4,17,9,10,56,43,13,60
Stranraer,2939,5,16,5,15,58,64,-6,53
East Fife,2939,6,13,3,20,47,67,-20,42
Airdrieon,2939,7,10,11,15,46,60,-14,41
Forfar,2939,8,11,5,20,40,65,-25,38
Albion,2939,9,8,6,22,58,83,-25,30
Queen's Park,2939,10,6,11,19,40,73,-33,29
Ayr,2940,1,24,4,8,92,42,50,76
Raith,2940,2,22,9,5,69,33,36,75
Arbroath,2940,3,18,8,10,73,48,25,62
Alloa,2940,4,17,9,10,57,44,13,60
Stranraer,2940,5,15,5,16,55,68,-13,50
East Fife,2940,6,14,3,19,51,64,-13,45
Airdrieon,2940,7,10,11,15,46,60,-14,41
Forfar,2940,8,11,5,20,40,65,-25,38
Albion,2940,9,8,6,22,57,80,-23,30
Queen's Park,2940,10,6,10,20,39,75,-36,28
Raith,2941,1,23,8,5,71,32,39,77
Ayr,2941,2,24,4,8,94,42,52,76
Arbroath,2941,3,17,8,11,70,49,21,59
Alloa,2941,4,17,8,11,56,46,10,59
Stranraer,2941,5,16,5,15,57,65,-8,53
Airdrieon,2941,6,10,12,14,46,59,-13,42
East Fife,2941,7,13,3,20,48,66,-18,42
Forfar,2941,8,10,6,20,39,65,-26,36
Queen's Park,2941,9,7,10,19,40,72,-32,31
Albion,2941,10,8,6,22,57,82,-25,30
Ayr,2942,1,24,4,8,93,43,50,76
Raith,2942,2,22,9,5,68,32,36,75
Arbroath,2942,3,17,9,10,70,48,22,60
Alloa,2942,4,17,9,10,56,43,13,60
Stranraer,2942,5,15,5,16,55,66,-11,50
East Fife,2942,6,14,3,19,49,64,-15,45
Airdrieon,2942,7,11,11,14,47,58,-11,44
Forfar,2942,8,10,5,21,38,66,-28,35
Albion,2942,9,8,6,22,58,81,-23,30
Queen's Park,2942,10,6,11,19,39,72,-33,29
Raith,2943,1,23,8,5,70,32,38,77
Ayr,2943,2,24,4,8,96,44,52,76
Arbroath,2943,3,17,8,11,70,50,20,59
Alloa,2943,4,17,8,11,56,45,11,59
Stranraer,2943,5,15,5,16,55,67,-12,50
East Fife,2943,6,14,3,19,50,64,-14,45
Airdrieon,2943,7,11,11,14,48,58,-10,44
Forfar,2943,8,10,5,21,38,67,-29,35
Queen's Park,2943,9,7,10,19,41,72,-31,31
Albion,2943,10,8,6,22,59,84,-25,30
Ayr,2944,1,23,5,8,92,44,48,74
Raith,2944,2,22,8,6,68,34,34,74
Arbroath,2944,3,18,8,10,72,48,24,62
Alloa,2944,4,18,8,10,58,43,15,62
Stranraer,2944,5,15,5,16,56,66,-10,50
East Fife,2944,6,14,3,19,49,65,-16,45
Airdrieon,2944,7,10,12,14,46,59,-13,42
Forfar,2944,8,10,6,20,39,65,-26,36
Albion,2944,9,8,7,21,59,80,-21,31
Queen's Park,2944,10,6,10,20,39,74,-35,28
Ayr,2945,1,24,4,8,94,45,49,76
Raith,2945,2,22,9,5,70,34,36,75
Arbroath,2945,3,17,9,10,72,50,22,60
Alloa,2945,4,17,9,10,58,45,13,60
Stranraer,2945,5,16,5,15,57,65,-8,53
Airdrieon,2945,6,11,11,14,48,59,-11,44
East Fife,2945,7,13,3,20,48,66,-18,42
Forfar,2945,8,10,5,21,39,67,-28,35
Albion,2945,9,8,6,22,60,82,-22,30
Queen's Park,2945,10,6,11,19,41,74,-33,29
Raith,2946,1,22,8,6,68,35,33,74
Ayr,2946,2,23,4,9,90,43,47,73
Alloa,2946,3,18,8,10,59,43,16,62
Arbroath,2946,4,17,9,10,71,49,22,60
Stranraer,2946,5,16,5,15,57,65,-8,53
Airdrieon,2946,6,11,11,14,47,59,-12,44
East Fife,2946,7,13,3,20,48,66,-18,42
Forfar,2946,8,10,5,21,39,66,-27,35
Albion,2946,9,9,6,21,58,78,-20,33
Queen's Park,2946,10,6,11,19,40,73,-33,29
Raith,2947,1,23,8,5,70,32,38,77
Ayr,2947,2,23,5,8,91,43,48,74
Arbroath,2947,3,17,9,10,71,49,22,60
Alloa,2947,4,17,8,11,56,45,11,59
Stranraer,2947,5,16,5,15,57,65,-8,53
East Fife,2947,6,13,3,20,48,66,-18,42
Airdrieon,2947,7,10,11,15,46,60,-14,41
Forfar,2947,8,11,5,20,40,65,-25,38
Albion,2947,9,8,7,21,58,79,-21,31
Queen's Park,2947,10,6,11,19,40,73,-33,29
Ayr,2948,1,24,4,8,96,43,53,76
Raith,2948,2,22,8,6,69,34,35,74
Arbroath,2948,3,18,8,10,73,48,25,62
Alloa,2948,4,18,8,10,58,44,14,62
Stranraer,2948,5,15,6,15,55,64,-9,51
Airdrieon,2948,6,11,11,14,49,61,-12,44
East Fife,2948,7,13,4,19,47,64,-17,43
Forfar,2948,8,10,5,21,41,68,-27,35
Albion,2948,9,8,6,22,58,84,-26,30
Queen's Park,2948,10,6,10,20,39,75,-36,28
Ayr,2949,1,24,4,8,93,44,49,76
Raith,2949,2,22,9,5,69,33,36,75
Arbroath,2949,3,18,8,10,72,48,24,62
Alloa,2949,4,17,9,10,57,44,13,60
Stranraer,2949,5,15,5,16,55,65,-10,50
East Fife,2949,6,14,3,19,48,64,-16,45
Airdrieon,2949,7,11,11,14,46,58,-12,44
Forfar,2949,8,10,5,21,38,65,-27,35
Albion,2949,9,8,6,22,59,81,-22,30
Queen's Park,2949,10,6,10,20,39,74,-35,28
Raith,2950,1,23,8,5,71,33,38,77
Ayr,2950,2,24,4,8,96,42,54,76
Arbroath,2950,3,18,8,10,72,48,24,62
Alloa,2950,4,17,8,11,57,46,11,59
Stranraer,2950,5,15,5,16,56,74,-18,50
East Fife,2950,6,14,3,19,57,65,-8,45
Airdrieon,2950,7,11,11,14,53,58,-5,44
Forfar,2950,8,10,5,21,38,72,-34,35
Albion,2950,9,8,6,22,57,84,-27,30
Queen's Park,2950,10,6,10,20,39,74,-35,28
Ayr,2951,1,24,4,8,97,42,55,76
Raith,2951,2,22,9,5,70,34,36,75
Arbroath,2951,3,18,8,10,73,50,23,62
Alloa,2951,4,17,9,10,58,45,13,60
Stranraer,2951,5,15,5,16,56,67,-11,50
East Fife,2951,6,14,3,19,50,65,-15,45
Airdrieon,2951,7,10,12,14,45,58,-13,42
Forfar,2951,8,10,6,20,38,64,-26,36
Albion,2951,9,8,6,22,57,85,-28,30
Queen's Park,2951,10,6,10,20,41,75,-34,28
Ayr,2952,1,24,4,8,93,43,50,76
Raith,2952,2,22,8,6,68,33,35,74
Alloa,2952,3,18,8,10,57,43,14,62
Arbroath,2952,4,17,9,10,71,49,22,60
Stranraer,2952,5,16,5,15,56,64,-8,53
Airdrieon,2952,6,11,11,14,49,59,-10,44
East Fife,2952,7,13,3,20,47,65,-18,42
Forfar,2952,8,10,5,21,39,68,-29,35
Albion,2952,9,8,6,22,58,81,-23,30
Queen's Park,2952,10,6,11,19,40,73,-33,29
Raith,2953,1,23,8,5,69,32,37,77
Ayr,2953,2,24,4,8,94,42,52,76
Arbroath,2953,3,17,9,10,70,48,22,60
Alloa,2953,4,17,8,11,56,44,12,59
Stranraer,2953,5,15,5,16,56,67,-11,50
East Fife,2953,6,14,3,19,50,65,-15,45
Airdrieon,2953,7,10,12,14,48,61,-13,42
Forfar,2953,8,10,6,20,41,67,-26,36
Albion,2953,9,8,6,22,57,82,-25,30
Queen's Park,2953,10,6,11,19,39,72,-33,29
Ayr,2954,1,24,4,8,93,43,50,76
Raith,2954,2,22,8,6,68,33,35,74
Alloa,2954,3,18,8,10,57,43,14,62
Arbroath,2954,4,17,8,11,72,52,20,59
Stranraer,2954,5,16,5,15,56,64,-8,53
East Fife,2954,6,13,3,20,47,65,-18,42
Airdrieon,2954,7,10,11,15,45,59,-14,41
Forfar,2954,8,11,5,20,39,64,-25,38
Queen's Park,2954,9,7,10,19,43,74,-31,31
Albion,2954,10,8,6,22,58,81,-23,30
Raith,2955,1,23,8,5,69,32,37,77
Ayr,2955,2,24,4,8,94,43,51,76
Arbroath,2955,3,17,9,10,71,49,22,60
Alloa,2955,4,17,8,11,56,44,12,59
Stranraer,2955,5,15,5,16,55,68,-13,50
East Fife,2955,6,14,3,19,51,64,-13,45
Airdrieon,2955,7,10,12,14,46,59,-13,42
Forfar,2955,8,10,6,20,39,65,-26,36
Albion,2955,9,8,6,22,58,82,-24,30
Queen's Park,2955,10,6,11,19,40,73,-33,29
Ayr,2956,1,24,4,8,94,44,50,76
Raith,2956,2,22,8,6,69,35,34,74
Arbroath,2956,3,18,8,10,75,49,26,62
Alloa,2956,4,18,8,10,59,44,15,62
Stranraer,2956,5,15,5,16,55,66,-11,50
East Fife,2956,6,14,3,19,49,64,-15,45
Airdrieon,2956,7,10,11,15,46,60,-14,41
Forfar,2956,8,11,5,20,40,65,-25,38
Albion,2956,9,8,6,22,59,82,-23,30
Queen's Park,2956,10,6,10,20,40,77,-37,28
Raith,2957,1,23,8,5,71,32,39,77
Ayr,2957,2,24,4,8,95,43,52,76
Arbroath,2957,3,17,9,10,71,49,22,60
Alloa,2957,4,17,8,11,56,46,10,59
Stranraer,2957,5,15,5,16,57,67,-10,50
East Fife,2957,6,14,3,19,50,66,-16,45
Airdrieon,2957,7,10,12,14,45,58,-13,42
Forfar,2957,8,10,6,20,38,64,-26,36
Albion,2957,9,8,6,22,58,83,-25,30
Queen's Park,2957,10,6,11,19,40,73,-33,29
Raith,2958,1,23,8,5,70,33,37,77
Ayr,2958,2,23,4,9,91,45,46,73
Arbroath,2958,3,17,9,10,71,49,22,60
Alloa,2958,4,17,8,11,57,45,12,59
Stranraer,2958,5,15,5,16,55,69,-14,50
East Fife,2958,6,14,3,19,52,64,-12,45
Airdrieon,2958,7,10,12,14,45,58,-13,42
Forfar,2958,8,10,6,20,38,64,-26,36
Albion,2958,9,9,6,21,60,79,-19,33
Queen's Park,2958,10,6,11,19,40,73,-33,29
Raith,2959,1,23,8,5,70,32,38,77
Ayr,2959,2,23,5,8,93,45,48,74
Arbroath,2959,3,17,8,11,72,51,21,59
Alloa,2959,4,17,8,11,56,45,11,59
Stranraer,2959,5,16,5,15,57,65,-8,53
Airdrieon,2959,6,11,11,14,47,58,-11,44
East Fife,2959,7,13,3,20,48,66,-18,42
Forfar,2959,8,10,5,21,38,66,-28,35
Albion,2959,9,8,7,21,60,81,-21,31
Queen's Park,2959,10,7,10,19,42,74,-32,31
Raith,2960,1,22,9,5,68,32,36,75
Ayr,2960,2,23,4,9,91,45,46,73
Arbroath,2960,3,17,9,10,70,48,22,60
Alloa,2960,4,17,9,10,56,43,13,60
Stranraer,2960,5,16,5,15,58,64,-6,53
East Fife,2960,6,13,3,20,47,67,-20,42
Airdrieon,2960,7,10,11,15,45,60,-15,41
Forfar,2960,8,11,5,20,40,64,-24,38
Albion,2960,9,9,6,21,60,79,-19,33
Queen's Park,2960,10,6,11,19,39,72,-33,29
Ayr,2961,1,24,4,8,94,44,50,76
Raith,2961,2,22,8,6,68,34,34,74
Arbroath,2961,3,18,8,10,72,49,23,62
Alloa,2961,4,18,8,10,58,43,15,62
Stranraer,2961,5,16,5,15,59,67,-8,53
Airdrieon,2961,6,11,11,14,46,58,-12,44
East Fife,2961,7,13,3,20,50,68,-18,42
Forfar,2961,8,10,5,21,38,65,-27,35
Albion,2961,9,8,6,22,59,82,-23,30
Queen's Park,2961,10,6,10,20,40,74,-34,28
Ayr,2962,1,24,4,8,94,43,51,76
Raith,2962,2,22,9,5,69,33,36,75
Alloa,2962,3,17,9,10,57,44,13,60
Arbroath,2962,4,17,8,11,72,51,21,59
Stranraer,2962,5,16,5,15,57,65,-8,53
East Fife,2962,6,13,3,20,48,66,-18,42
Airdrieon,2962,7,10,11,15,47,61,-14,41
Forfar,2962,8,11,5,20,41,66,-25,38
Queen's Park,2962,9,7,10,19,42,74,-32,31
Albion,2962,10,8,6,22,58,82,-24,30
Raith,2963,1,23,8,5,70,33,37,77
Ayr,2963,2,24,4,8,95,42,53,76
Arbroath,2963,3,17,9,10,71,49,22,60
Alloa,2963,4,17,8,11,57,45,12,59
Stranraer,2963,5,16,5,15,58,66,-8,53
Airdrieon,2963,6,10,12,14,45,58,-13,42
East Fife,2963,7,13,3,20,49,67,-18,42
Forfar,2963,8,10,6,20,38,64,-26,36
Albion,2963,9,8,6,22,57,83,-26,30
Queen's Park,2963,10,6,11,19,40,73,-33,29
Ayr,2964,1,24,4,8,91,42,49,76
Raith,2964,2,22,9,5,68,32,36,75
Alloa,2964,3,17,9,10,56,43,13,60
Arbroath,2964,4,17,8,11,71,50,21,59
Stranraer,2964,5,15,5,16,56,67,-11,50
East Fife,2964,6,14,3,19,50,65,-15,45
Airdrieon,2964,7,11,11,14,47,59,-12,44
Forfar,2964,8,10,5,21,39,66,-27,35
Queen's Park,2964,9,7,10,19,41,73,-32,31
Albion,2964,10,8,6,22,57,79,-22,30
Raith,2965,1,23,8,5,73,33,40,77
Ayr,2965,2,24,4,8,93,42,51,76
Arbroath,2965,3,17,9,10,73,51,22,60
Alloa,2965,4,17,8,11,57,48,9,59
Stranraer,2965,5,15,5,16,56,68,-12,50
East Fife,2965,6,14,3,19,51,65,-14,45
Airdrieon,2965,7,10,11,15,45,59,-14,41
Forfar,2965,8,11,5,20,39,64,-25,38
Albion,2965,9,8,6,22,57,81,-24,30
Queen's Park,2965,10,6,11,19,42,75,-33,29
Raith,2966,1,23,8,5,71,34,37,77
Ayr,2966,2,23,4,9,91,46,45,73
Arbroath,2966,3,17,8,11,70,52,18,59
Alloa,2966,4,17,8,11,58,46,12,59
Stranraer,2966,5,15,5,16,56,66,-10,50
East Fife,2966,6,14,3,19,49,65,-16,45
Airdrieon,2966,7,11,11,14,46,58,-12,44
Forfar,2966,8,10,5,21,38,65,-27,35
Albion,2966,9,9,6,21,61,79,-18,33
Queen's Park,2966,10,7,10,19,43,72,-29,31
Ayr,2967,1,23,5,8,92,44,48,74
Raith,2967,2,22,8,6,69,35,34,74
Alloa,2967,3,18,8,10,59,44,15,62
Arbroath,2967,4,17,8,11,70,50,20,59
Stranraer,2967,5,16,5,15,56,64,-8,53
East Fife,2967,6,13,3,20,47,65,-18,42
Airdrieon,2967,7,10,11,15,46,60,-14,41
Forfar,2967,8,11,5,20,40,65,-25,38
Albion,2967,9,8,7,21,59,80,-21,31
Queen's Park,2967,10,7,10,19,41,72,-31,31
Ayr,2968,1,24,4,8,95,44,51,76
Raith,2968,2,22,8,6,69,34,35,74
Alloa,2968,3,18,8,10,58,44,14,62
Arbroath,2968,4,17,8,11,71,51,20,59
Stranraer,2968,5,16,5,15,56,64,-8,53
Airdrieon,2968,6,10,12,14,45,58,-13,42
East Fife,2968,7,13,3,20,47,65,-18,42
Forfar,2968,8,10,6,20,38,64,-26,36
Queen's Park,2968,9,7,10,19,42,73,-31,31
Albion,2968,10,8,6,22,59,83,-24,30
Ayr,2969,1,24,4,8,94,42,52,76
Raith,2969,2,22,8,6,69,34,35,74
Arbroath,2969,3,18,8,10,72,48,24,62
Alloa,2969,4,18,8,10,58,44,14,62
Stranraer,2969,5,15,5,16,55,65,-10,50
East Fife,2969,6,14,3,19,48,64,-16,45
Airdrieon,2969,7,11,11,14,46,58,-12,44
Forfar,2969,8,10,5,21,38,65,-27,35
Albion,2969,9,8,6,22,57,82,-25,30
Queen's Park,2969,10,6,10,20,39,74,-35,28
Raith,2970,1,23,8,5,72,33,39,77
Ayr,2970,2,23,5,8,92,44,48,74
Arbroath,2970,3,18,8,10,72,48,24,62
Alloa,2970,4,17,8,11,57,47,10,59
Stranraer,2970,5,15,6,15,57,66,-9,51
Airdrieon,2970,6,11,11,14,49,58,-9,44
East Fife,2970,7,13,4,19,49,66,-17,43
Forfar,2970,8,10,5,21,38,68,-30,35
Albion,2970,9,8,7,21,59,80,-21,31
Queen's Park,2970,10,6,10,20,39,74,-35,28
Ayr,2971,1,24,4,8,94,42,52,76
Raith,2971,2,22,8,6,68,34,34,74
Alloa,2971,3,18,8,10,58,43,15,62
Arbroath,2971,4,17,8,11,70,51,19,59
Stranraer,2971,5,16,5,15,57,64,-7,53
Airdrieon,2971,6,11,11,14,48,59,-11,44
East Fife,2971,7,13,3,20,47,66,-19,42
Forfar,2971,8,10,5,21,39,67,-28,35
Queen's Park,2971,9,7,10,19,42,72,-30,31
Albion,2971,10,8,6,22,57,82,-25,30
Ayr,2972,1,24,4,8,95,42,53,76
Raith,2972,2,22,9,5,69,33,36,75
Arbroath,2972,3,18,8,10,73,50,23,62
Alloa,2972,4,17,9,10,57,44,13,60
Stranraer,2972,5,15,6,15,55,64,-9,51
Airdrieon,2972,6,11,11,14,47,58,-11,44
East Fife,2972,7,13,4,19,47,64,-17,43
Forfar,2972,8,10,5,21,38,66,-28,35
Albion,2972,9,8,6,22,57,83,-26,30
Queen's Park,2972,10,6,10,20,41,75,-34,28
Ayr,2973,1,24,4,8,97,43,54,76
Raith,2973,2,22,8,6,70,35,35,74
Alloa,2973,3,18,8,10,59,45,14,62
Arbroath,2973,4,17,9,10,71,49,22,60
Stranraer,2973,5,15,5,16,57,67,-10,50
East Fife,2973,6,14,3,19,50,66,-16,45
Airdrieon,2973,7,11,11,14,48,60,-12,44
Forfar,2973,8,10,5,21,40,67,-27,35
Albion,2973,9,8,6,22,58,85,-27,30
Queen's Park,2973,10,6,11,19,40,73,-33,29
Ayr,2974,1,24,4,8,93,43,50,76
Raith,2974,2,22,9,5,69,33,36,75
Alloa,2974,3,17,9,10,57,44,13,60
Arbroath,2974,4,17,8,11,71,50,21,59
Stranraer,2974,5,15,5,16,56,67,-11,50
East Fife,2974,6,14,3,19,50,65,-15,45
Airdrieon,2974,7,10,11,15,45,61,-16,41
Forfar,2974,8,11,5,20,41,64,-23,38
Queen's Park,2974,9,7,10,19,41,73,-32,31
Albion,2974,10,8,6,22,58,81,-23,30
Raith,2975,1,23,8,5,69,32,37,77
Ayr,2975,2,24,4,8,95,43,52,76
Arbroath,2975,3,18,8,10,71,48,23,62
Alloa,2975,4,17,8,11,56,44,12,59
Stranraer,2975,5,16,5,15,59,64,-5,53
Airdrieon,2975,6,11,11,14,47,59,-12,44
East Fife,2975,7,13,3,20,47,68,-21,42
Forfar,2975,8,10,5,21,39,66,-27,35
Albion,2975,9,8,6,22,58,83,-25,30
Queen's Park,2975,10,6,10,20,39,73,-34,28
Raith,2976,1,23,8,5,70,32,38,77
Ayr,2976,2,24,4,8,92,42,50,76
Arbroath,2976,3,17,8,11,70,49,21,59
Alloa,2976,4,17,8,11,56,45,11,59
Stranraer,2976,5,16,5,15,56,64,-8,53
Airdrieon,2976,6,11,11,14,47,59,-12,44
East Fife,2976,7,13,3,20,47,65,-18,42
Forfar,2976,8,10,5,21,39,66,-27,35
Queen's Park,2976,9,7,10,19,40,72,-32,31
Albion,2976,10,8,6,22,57,80,-23,30
Ayr,2977,1,24,4,8,92,42,50,76
Raith,2977,2,22,9,5,69,33,36,75
Alloa,2977,3,17,9,10,57,44,13,60
Arbroath,2977,4,17,8,11,71,50,21,59
Stranraer,2977,5,15,5,16,55,69,-14,50
East Fife,2977,6,14,3,19,52,64,-12,45
Airdrieon,2977,7,10,11,15,47,62,-15,41
Forfar,2977,8,11,5,20,42,66,-24,38
Queen's Park,2977,9,7,10,19,41,73,-32,31
Albion,2977,10,8,6,22,57,80,-23,30
Ayr,2978,1,24,4,8,96,46,50,76
Raith,2978,2,22,8,6,70,35,35,74
Arbroath,2978,3,18,8,10,76,50,26,62
Alloa,2978,4,18,8,10,59,45,14,62
Stranraer,2978,5,15,5,16,55,66,-11,50
East Fife,2978,6,14,3,19,49,64,-15,45
Airdrieon,2978,7,11,11,14,48,60,-12,44
Forfar,2978,8,10,5,21,40,67,-27,35
Albion,2978,9,8,6,22,61,84,-23,30
Queen's Park,2978,10,6,10,20,41,78,-37,28
Raith,2979,1,23,8,5,69,32,37,77
Ayr,2979,2,24,4,8,95,42,53,76
Arbroath,2979,3,18,8,10,73,48,25,62
Alloa,2979,4,17,8,11,56,44,12,59
Stranraer,2979,5,15,5,16,57,67,-10,50
East Fife,2979,6,14,3,19,50,66,-16,45
Airdrieon,2979,7,10,12,14,46,59,-13,42
Forfar,2979,8,10,6,20,39,65,-26,36
Albion,2979,9,8,6,22,57,83,-26,30
Queen's Park,2979,10,6,10,20,39,75,-36,28
Raith,2980,1,22,9,5,70,34,36,75
Ayr,2980,2,23,5,8,91,43,48,74
Arbroath,2980,3,18,8,10,72,48,24,62
Alloa,2980,4,17,9,10,58,45,13,60
Stranraer,2980,5,15,5,16,56,66,-10,50
East Fife,2980,6,14,3,19,49,65,-16,45
Airdrieon,2980,7,10,12,14,46,59,-13,42
Forfar,2980,8,10,6,20,39,65,-26,36
Albion,2980,9,8,7,21,58,79,-21,31
Queen's Park,2980,10,6,10,20,39,74,-35,28
Ayr,2981,1,24,4,8,96,43,53,76
Raith,2981,2,22,9,5,70,34,36,75
Arbroath,2981,3,18,8,10,71,48,23,62
Alloa,2981,4,17,9,10,58,45,13,60
Stranraer,2981,5,16,5,15,58,66,-8,53
East Fife,2981,6,13,3,20,49,67,-18,42
Airdrieon,2981,7,10,11,15,46,60,-14,41
Forfar,2981,8,11,5,20,40,65,-25,38
Albion,2981,9,8,6,22,58,84,-26,30
Queen's Park,2981,10,6,10,20,39,73,-34,28
Raith,2982,1,23,8,5,70,33,37,77
Ayr,2982,2,24,4,8,98,44,54,76
Arbroath,2982,3,17,8,11,73,52,21,59
Alloa,2982,4,17,8,11,57,45,12,59
Stranraer,2982,5,16,5,15,56,64,-8,53
Airdrieon,2982,6,11,11,14,46,58,-12,44
East Fife,2982,7,13,3,20,47,65,-18,42
Forfar,2982,8,10,5,21,38,65,-27,35
Queen's Park,2982,9,7,10,19,43,75,-32,31
Albion,2982,10,8,6,22,59,86,-27,30
Raith,2983,1,23,8,5,71,34,37,77
Ayr,2983,2,24,4,8,96,44,52,76
Arbroath,2983,3,18,8,10,73,49,24,62
Alloa,2983,4,17,8,11,58,46,12,59
Stranraer,2983,5,15,6,15,56,65,-9,51
East Fife,2983,6,13,4,19,48,65,-17,43
Airdrieon,2983,7,10,11,15,45,60,-15,41
Forfar,2983,8,11,5,20,40,64,-24,38
Albion,2983,9,8,6,22,59,84,-25,30
Queen's Park,2983,10,6,10,20,40,75,-35,28
Raith,2984,1,22,9,5,69,33,36,75
Ayr,2984,2,23,4,9,92,46,46,73
Arbroath,2984,3,18,8,10,73,50,23,62
Alloa,2984,4,17,9,10,57,44,13,60
Stranraer,2984,5,15,6,15,55,64,-9,51
East Fife,2984,6,13,4,19,47,64,-17,43
Airdrieon,2984,7,10,12,14,47,60,-13,42
Forfar,2984,8,10,6,20,40,66,-26,36
Albion,2984,9,9,6,21,61,80,-19,33
Queen's Park,2984,10,6,10,20,41,75,-34,28
Raith,2985,1,23,8,5,73,32,41,77
Ayr,2985,2,24,4,8,95,42,53,76
Arbroath,2985,3,18,8,10,75,49,26,62
Alloa,2985,4,17,8,11,56,48,8,59
Stranraer,2985,5,15,5,16,55,67,-12,50
East Fife,2985,6,14,3,19,50,64,-14,45
Airdrieon,2985,7,11,11,14,48,60,-12,44
Forfar,2985,8,10,5,21,40,67,-27,35
Albion,2985,9,8,6,22,57,83,-26,30
Queen's Park,2985,10,6,10,20,40,77,-37,28
Ayr,2986,1,24,4,8,93,42,51,76
Raith,2986,2,22,9,5,68,32,36,75
Arbroath,2986,3,18,8,10,73,48,25,62
Alloa,2986,4,17,9,10,56,43,13,60
Stranraer,2986,5,16,5,15,56,64,-8,53
Airdrieon,2986,6,11,11,14,49,58,-9,44
East Fife,2986,7,13,3,20,47,65,-18,42
Forfar,2986,8,10,5,21,38,68,-30,35
Albion,2986,9,8,6,22,57,81,-24,30
Queen's Park,2986,10,6,10,20,39,75,-36,28
Ayr,2987,1,24,4,8,93,44,49,76
Raith,2987,2,22,8,6,68,33,35,74
Arbroath,2987,3,18,8,10,71,48,23,62
Alloa,2987,4,18,8,10,57,43,14,62
Stranraer,2987,5,15,5,16,56,67,-11,50
East Fife,2987,6,14,3,19,50,65,-15,45
Airdrieon,2987,7,10,12,14,45,58,-13,42
Forfar,2987,8,10,6,20,38,64,-26,36
Albion,2987,9,8,6,22,59,81,-22,30
Queen's Park,2987,10,6,10,20,39,73,-34,28
Ayr,2988,1,23,5,8,91,43,48,74
Raith,2988,2,22,8,6,69,35,34,74
Alloa,2988,3,18,8,10,59,44,15,62
Arbroath,2988,4,17,9,10,71,49,22,60
Stranraer,2988,5,16,5,15,58,64,-6,53
East Fife,2988,6,13,3,20,47,67,-20,42
Airdrieon,2988,7,10,11,15,47,62,-15,41
Forfar,2988,8,11,5,20,42,66,-24,38
Albion,2988,9,8,7,21,58,79,-21,31
Queen's Park,2988,10,6,11,19,40,73,-33,29
Ayr,2989,1,24,4,8,95,42,53,76
Raith,2989,2,22,9,5,69,33,36,75
Arbroath,2989,3,18,8,10,71,48,23,62
Alloa,2989,4,17,9,10,57,44,13,60
Stranraer,2989,5,15,5,16,55,68,-13,50
East Fife,2989,6,14,3,19,51,64,-13,45
Airdrieon,2989,7,10,11,15,46,60,-14,41
Forfar,2989,8,11,5,20,40,65,-25,38
Albion,2989,9,8,6,22,57,83,-26,30
Queen's Park,2989,10,6,10,20,39,73,-34,28
Ayr,2990,1,24,4,8,95,45,50,76
Raith,2990,2,22,9,5,69,33,36,75
Alloa,2990,3,17,9,10,57,44,13,60
Arbroath,2990,4,17,8,11,72,51,21,59
Stranraer,2990,5,15,5,16,55,66,-11,50
East Fife,2990,6,14,3,19,49,64,-15,45
Airdrieon,2990,7,11,11,14,46,58,-12,44
Forfar,2990,8,10,5,21,38,65,-27,35
Queen's Park,2990,9,7,10,19,42,74,-32,31
Albion,2990,10,8,6,22,60,83,-23,30
Raith,2991,1,23,8,5,71,32,39,77
Ayr,2991,2,24,4,8,93,44,49,76
Arbroath,2991,3,17,8,11,71,50,21,59
Alloa,2991,4,17,8,11,56,46,10,59
Stranraer,2991,5,15,5,16,55,66,-11,50
East Fife,2991,6,14,3,19,49,64,-15,45
Airdrieon,2991,7,11,11,14,47,59,-12,44
Forfar,2991,8,10,5,21,39,66,-27,35
Queen's Park,2991,9,7,10,19,41,73,-32,31
Albion,2991,10,8,6,22,59,81,-22,30
Raith,2992,1,23,8,5,69,32,37,77
Ayr,2992,2,24,4,8,96,43,53,76
Arbroath,2992,3,18,8,10,72,48,24,62
Alloa,2992,4,17,8,11,56,44,12,59
Stranraer,2992,5,16,5,15,57,64,-7,53
Airdrieon,2992,6,10,12,14,48,61,-13,42
East Fife,2992,7,13,3,20,47,66,-19,42
Forfar,2992,8,10,6,20,41,67,-26,36
Albion,2992,9,8,6,22,58,84,-26,30
Queen's Park,2992,10,6,10,20,39,74,-35,28
Ayr,2993,1,24,4,8,93,44,49,76
Raith,2993,2,22,9,5,69,33,36,75
Arbroath,2993,3,17,9,10,72,50,22,60
Alloa,2993,4,17,9,10,57,44,13,60
Stranraer,2993,5,15,6,15,57,66,-9,51
East Fife,2993,6,13,4,19,49,66,-17,43
Airdrieon,2993,7,10,12,14,46,59,-13,42
Forfar,2993,8,10,6,20,39,65,-26,36
Albion,2993,9,8,6,22,59,81,-22,30
Queen's Park,2993,10,6,11,19,41,74,-33,29
Raith,2994,1,23,8,5,69,32,37,77
Ayr,2994,2,24,4,8,94,42,52,76
Arbroath,2994,3,17,8,11,70,51,19,59
Alloa,2994,4,17,8,11,56,44,12,59
Stranraer,2994,5,15,6,15,58,67,-9,51
East Fife,2994,6,13,4,19,50,67,-17,43
Airdrieon,2994,7,10,11,15,45,59,-14,41
Forfar,2994,8,11,5,20,39,64,-25,38
Queen's Park,2994,9,7,10,19,42,72,-30,31
Albion,2994,10,8,6,22,57,82,-25,30
Raith,2995,1,23,8,5,71,32,39,77
Ayr,2995,2,24,4,8,94,42,52,76
Arbroath,2995,3,17,9,10,72,50,22,60
Alloa,2995,4,17,8,11,56,46,10,59
Stranraer,2995,5,15,5,16,56,68,-12,50
East Fife,2995,6,14,3,19,51,65,-14,45
Airdrieon,2995,7,11,11,14,48,60,-12,44
Forfar,2995,8,10,5,21,40,67,-27,35
Albion,2995,9,8,6,22,57,82,-25,30
Queen's Park,2995,10,6,11,19,41,74,-33,29
Raith,2996,1,23,8,5,72,32,40,77
Ayr,2996,2,23,4,9,92,45,47,73
Arbroath,2996,3,18,8,10,73,50,23,62
Alloa,2996,4,17,8,11,56,47,9,59
Stranraer,2996,5,15,5,16,55,65,-10,50
East Fife,2996,6,14,3,19,48,64,-16,45
Airdrieon,2996,7,10,11,15,46,60,-14,41
Forfar,2996,8,11,5,20,40,65,-25,38
Albion,2996,9,9,6,21,60,80,-20,33
Queen's Park,2996,10,6,10,20,41,75,-34,28
Ayr,2997,1,24,4,8,94,42,52,76
Raith,2997,2,22,9,5,69,33,36,75
Arbroath,2997,3,18,8,10,72,48,24,62
Alloa,2997,4,17,9,10,57,44,13,60
Stranraer,2997,5,15,5,16,55,68,-13,50
East Fife,2997,6,14,3,19,51,64,-13,45
Airdrieon,2997,7,11,11,14,47,59,-12,44
Forfar,2997,8,10,5,21,39,66,-27,35
Albion,2997,9,8,6,22,57,82,-25,30
Queen's Park,2997,10,6,10,20,39,74,-35,28
Raith,2998,1,23,8,5,69,32,37,77
Ayr,2998,2,24,4,8,92,43,49,76
Arbroath,2998,3,18,8,10,72,49,23,62
Alloa,2998,4,17,8,11,56,44,12,59
Stranraer,2998,5,15,5,16,55,66,-11,50
East Fife,2998,6,14,3,19,49,64,-15,45
Airdrieon,2998,7,10,12,14,46,59,-13,42
Forfar,2998,8,10,6,20,39,65,-26,36
Albion,2998,9,8,6,22,58,80,-22,30
Queen's Park,2998,10,6,10,20,40,74,-34,28
Ayr,2999,1,24,4,8,94,42,52,76
Raith,2999,2,22,8,6,69,34,35,74
Alloa,2999,3,18,8,10,58,44,14,62
Arbroath,2999,4,17,9,10,72,50,22,60
Stranraer,2999,5,15,5,16,55,66,-11,50
East Fife,2999,6,14,3,19,49,64,-15,45
Airdrieon,2999,7,11,11,14,48,58,-10,44
Forfar,2999,8,10,5,21,38,67,-29,35
Albion,2999,9,8,6,22,57,82,-25,30
Queen's Park,2999,10,6,11,19,41,74,-33,29
Raith,3000,1,23,8,5,73,32,41,77
Ayr,3000,2,23,4,9,91,44,47,73
Arbroath,3000,3,17,9,10,71,49,22,60
Alloa,3000,4,17,8,11,56,48,8,59
Stranraer,3000,5,16,5,15,57,65,-8,53
Airdrieon,3000,6,11,11,14,47,58,-11,44
East Fife,3000,7,13,3,20,48,66,-18,42
Forfar,3000,8,10,5,21,38,66,-28,35
Albion,3000,9,9,6,21,59,79,-20,33
Queen's Park,3000,10,6,11,19,40,73,-33,29
Ayr,3001,1,24,4,8,94,42,52,76
Raith,3001,2,22,8,6,68,36,32,74
Alloa,3001,3,18,8,10,60,43,17,62
Arbroath,3001,4,17,8,11,72,52,20,59
Stranraer,3001,5,15,5,16,56,67,-11,50
East Fife,3001,6,14,3,19,50,65,-15,45
Airdrieon,3001,7,11,11,14,47,58,-11,44
Forfar,3001,8,10,5,21,38,66,-28,35
Queen's Park,3001,9,7,10,19,43,74,-31,31
Albion,3001,10,8,6,22,57,82,-25,30
Raith,3002,1,23,8,5,71,33,38,77
Ayr,3002,2,24,4,8,96,46,50,76
Arbroath,3002,3,17,9,10,72,50,22,60
Alloa,3002,4,17,8,11,57,46,11,59
Stranraer,3002,5,16,5,15,57,65,-8,53
Airdrieon,3002,6,10,12,14,47,60,-13,42
East Fife,3002,7,13,3,20,48,66,-18,42
Forfar,3002,8,10,6,20,40,66,-26,36
Albion,3002,9,8,6,22,61,84,-23,30
Queen's Park,3002,10,6,11,19,41,74,-33,29
Raith,3003,1,23,8,5,69,32,37,77
Ayr,3003,2,24,4,8,92,43,49,76
Arbroath,3003,3,17,9,10,71,49,22,60
Alloa,3003,4,17,8,11,56,44,12,59
Stranraer,3003,5,15,5,16,56,66,-10,50
East Fife,3003,6,14,3,19,49,65,-16,45
Airdrieon,3003,7,11,11,14,47,58,-11,44
Forfar,3003,8,10,5,21,38,66,-28,35
Albion,3003,9,8,6,22,58,80,-22,30
Queen's Park,3003,10,6,11,19,40,73,-33,29
Ayr,3004,1,24,4,8,93,42,51,76
Raith,3004,2,22,8,6,72,37,35,74
Arbroath,3004,3,18,8,10,73,50,23,62
Alloa,3004,4,18,8,10,61,47,14,62
Stranraer,3004,5,15,5,16,55,66,-11,50
East Fife,3004,6,14,3,19,49,64,-15,45
Airdrieon,3004,7,10,12,14,47,60,-13,42
Forfar,3004,8,10,6,20,40,66,-26,36
Albion,3004,9,8,6,22,57,81,-24,30
Queen's Park,3004,10,6,10,20,41,75,-34,28
Raith,3005,1,23,8,5,70,32,38,77
Ayr,3005,2,24,4,8,92,43,49,76
Arbroath,3005,3,17,8,11,70,49,21,59
Alloa,3005,4,17,8,11,56,45,11,59
Stranraer,3005,5,15,5,16,56,66,-10,50
East Fife,3005,6,14,3,19,49,65,-16,45
Airdrieon,3005,7,10,12,14,45,58,-13,42
Forfar,3005,8,10,6,20,38,64,-26,36
Queen's Park,3005,9,7,10,19,40,72,-32,31
Albion,3005,10,8,6,22,58,80,-22,30
Ayr,3006,1,24,4,8,93,44,49,76
Raith,3006,2,22,8,6,69,34,35,74
Alloa,3006,3,18,8,10,58,44,14,62
Arbroath,3006,4,17,9,10,73,51,22,60
Stranraer,3006,5,15,5,16,55,65,-10,50
East Fife,3006,6,14,3,19,48,64,-16,45
Airdrieon,3006,7,10,11,15,45,59,-14,41
Forfar,3006,8,11,5,20,39,64,-25,38
Albion,3006,9,8,6,22,59,81,-22,30
Queen's Park,3006,10,6,11,19,42,75,-33,29
Ayr,3007,1,24,4,8,96,44,52,76
Raith,3007,2,22,9,5,69,33,36,75
Arbroath,3007,3,17,9,10,73,51,22,60
Alloa,3007,4,17,9,10,57,44,13,60
Stranraer,3007,5,15,5,16,56,67,-11,50
East Fife,3007,6,14,3,19,50,65,-15,45
Airdrieon,3007,7,10,11,15,46,60,-14,41
Forfar,3007,8,11,5,20,40,65,-25,38
Albion,3007,9,8,6,22,59,84,-25,30
Queen's Park,3007,10,6,11,19,42,75,-33,29
Ayr,3008,1,24,4,8,93,43,50,76
Raith,3008,2,22,9,5,68,32,36,75
Arbroath,3008,3,18,8,10,73,49,24,62
Alloa,3008,4,17,9,10,56,43,13,60
Stranraer,3008,5,15,6,15,56,65,-9,51
East Fife,3008,6,13,4,19,48,65,-17,43
Airdrieon,3008,7,10,11,15,45,59,-14,41
Forfar,3008,8,11,5,20,39,64,-25,38
Albion,3008,9,8,6,22,58,81,-23,30
Queen's Park,3008,10,6,10,20,40,75,-35,28
Raith,3009,1,23,8,5,69,32,37,77
Ayr,3009,2,24,4,8,93,44,49,76
Arbroath,3009,3,18,8,10,71,48,23,62
Alloa,3009,4,17,8,11,56,44,12,59
Stranraer,3009,5,16,5,15,57,64,-7,53
Airdrieon,3009,6,11,11,14,46,58,-12,44
East Fife,3009,7,13,3,20,47,66,-19,42
Forfar,3009,8,10,5,21,38,65,-27,35
Albion,3009,9,8,6,22,59,81,-22,30
Queen's Park,3009,10,6,10,20,39,73,-34,28
Raith,3010,1,23,8,5,72,32,40,77
Ayr,3010,2,24,4,8,94,42,52,76
Arbroath,3010,3,17,9,10,72,50,22,60
Alloa,3010,4,17,8,11,56,47,9,59
Stranraer,3010,5,15,6,15,56,65,-9,51
East Fife,3010,6,13,4,19,48,65,-17,43
Airdrieon,3010,7,10,12,14,46,59,-13,42
Forfar,3010,8,10,6,20,39,65,-26,36
Albion,3010,9,8,6,22,57,82,-25,30
Queen's Park,3010,10,6,11,19,41,74,-33,29
Raith,3011,1,23,8,5,69,32,37,77
Ayr,3011,2,24,4,8,96,44,52,76
Arbroath,3011,3,17,8,11,71,51,20,59
Alloa,3011,4,17,8,11,56,44,12,59
Stranraer,3011,5,16,5,15,56,64,-8,53
East Fife,3011,6,13,3,20,47,65,-18,42
Airdrieon,3011,7,10,11,15,46,60,-14,41
Forfar,3011,8,11,5,20,40,65,-25,38
Queen's Park,3011,9,7,10,19,42,73,-31,31
Albion,3011,10,8,6,22,59,84,-25,30
Raith,3012,1,23,8,5,71,34,37,77
Ayr,3012,2,24,4,8,92,43,49,76
Arbroath,3012,3,17,9,10,72,50,22,60
Alloa,3012,4,17,8,11,58,46,12,59
Stranraer,3012,5,16,5,15,57,64,-7,53
Airdrieon,3012,6,10,12,14,46,59,-13,42
East Fife,3012,7,13,3,20,47,66,-19,42
Forfar,3012,8,10,6,20,39,65,-26,36
Albion,3012,9,8,6,22,58,80,-22,30
Queen's Park,3012,10,6,11,19,41,74,-33,29
Raith,3013,1,23,8,5,70,33,37,77
Ayr,3013,2,24,4,8,91,42,49,76
Arbroath,3013,3,18,8,10,75,49,26,62
Alloa,3013,4,17,8,11,57,45,12,59
Stranraer,3013,5,15,6,15,56,65,-9,51
East Fife,3013,6,13,4,19,48,65,-17,43
Airdrieon,3013,7,10,11,15,46,61,-15,41
Forfar,3013,8,11,5,20,41,65,-24,38
Albion,3013,9,8,6,22,57,79,-22,30
Queen's Park,3013,10,6,10,20,40,77,-37,28
Ayr,3014,1,23,5,8,92,44,48,74
Raith,3014,2,22,8,6,69,35,34,74
Alloa,3014,3,18,8,10,59,44,15,62
Arbroath,3014,4,17,8,11,71,52,19,59
Stranraer,3014,5,15,5,16,56,67,-11,50
East Fife,3014,6,14,3,19,50,65,-15,45
Airdrieon,3014,7,10,11,15,45,59,-14,41
Forfar,3014,8,11,5,20,39,64,-25,38
Albion,3014,9,8,7,21,59,80,-21,31
Queen's Park,3014,10,7,10,19,43,73,-30,31
Ayr,3015,1,24,4,8,97,42,55,76
Raith,3015,2,22,8,6,68,33,35,74
Alloa,3015,3,18,8,10,57,43,14,62
Arbroath,3015,4,17,8,11,72,52,20,59
Stranraer,3015,5,15,6,15,56,65,-9,51
Airdrieon,3015,6,11,11,14,50,59,-9,44
East Fife,3015,7,13,4,19,48,65,-17,43
Forfar,3015,8,10,5,21,39,69,-30,35
Queen's Park,3015,9,7,10,19,43,74,-31,31
Albion,3015,10,8,6,22,57,85,-28,30
Ayr,3016,1,24,4,8,94,43,51,76
Raith,3016,2,22,9,5,68,32,36,75
Arbroath,3016,3,18,8,10,72,48,24,62
Alloa,3016,4,17,9,10,56,43,13,60
Stranraer,3016,5,16,5,15,56,64,-8,53
Airdrieon,3016,6,11,11,14,49,61,-12,44
East Fife,3016,7,13,3,20,47,65,-18,42
Forfar,3016,8,10,5,21,41,68,-27,35
Albion,3016,9,8,6,22,58,82,-24,30
Queen's Park,3016,10,6,10,20,39,74,-35,28
Raith,3017,1,23,8,5,70,32,38,77
Ayr,3017,2,24,4,8,92,43,49,76
Arbroath,3017,3,18,8,10,73,48,25,62
Alloa,3017,4,17,8,11,56,45,11,59
Stranraer,3017,5,15,6,15,56,65,-9,51
East Fife,3017,6,13,4,19,48,65,-17,43
Airdrieon,3017,7,10,11,15,47,61,-14,41
Forfar,3017,8,11,5,20,41,66,-25,38
Albion,3017,9,8,6,22,58,80,-22,30
Queen's Park,3017,10,6,10,20,39,75,-36,28
Raith,3018,1,23,8,5,71,32,39,77
Ayr,3018,2,24,4,8,95,44,51,76
Arbroath,3018,3,18,8,10,71,48,23,62
Alloa,3018,4,17,8,11,56,46,10,59
Stranraer,3018,5,15,5,16,55,65,-10,50
East Fife,3018,6,14,3,19,48,64,-16,45
Airdrieon,3018,7,11,11,14,47,58,-11,44
Forfar,3018,8,10,5,21,38,66,-28,35
Albion,3018,9,8,6,22,59,83,-24,30
Queen's Park,3018,10,6,10,20,39,73,-34,28
Ayr,3019,1,24,4,8,93,43,50,76
Raith,3019,2,22,9,5,70,34,36,75
Arbroath,3019,3,18,8,10,74,50,24,62
Alloa,3019,4,17,9,10,58,45,13,60
Stranraer,3019,5,15,5,16,56,68,-12,50
East Fife,3019,6,14,3,19,51,65,-14,45
Airdrieon,3019,7,11,11,14,47,58,-11,44
Forfar,3019,8,10,5,21,38,66,-28,35
Albion,3019,9,8,6,22,58,81,-23,30
Queen's Park,3019,10,6,10,20,41,76,-35,28
Ayr,3020,1,24,4,8,98,44,54,76
Raith,3020,2,22,9,5,68,32,36,75
Arbroath,3020,3,18,8,10,72,49,23,62
Alloa,3020,4,17,9,10,56,43,13,60
Stranraer,3020,5,15,5,16,55,65,-10,50
East Fife,3020,6,14,3,19,48,64,-16,45
Airdrieon,3020,7,11,11,14,48,59,-11,44
Forfar,3020,8,10,5,21,39,67,-28,35
Albion,3020,9,8,6,22,59,86,-27,30
Queen's Park,3020,10,6,10,20,40,74,-34,28
Raith,3021,1,23,8,5,70,32,38,77
Ayr,3021,2,23,5,8,91,43,48,74
Arbroath,3021,3,18,8,10,73,48,25,62
Alloa,3021,4,17,8,11,56,45,11,59
Stranraer,3021,5,16,5,15,60,64,-4,53
Airdrieon,3021,6,11,11,14,46,58,-12,44
East Fife,3021,7,13,3,20,47,69,-22,42
Forfar,3021,8,10,5,21,38,65,-27,35
Albion,3021,9,8,7,21,58,79,-21,31
Queen's Park,3021,10,6,10,20,39,75,-36,28
Raith,3022,1,23,8,5,72,33,39,77
Ayr,3022,2,24,4,8,93,43,50,76
Arbroath,3022,3,17,9,10,71,49,22,60
Alloa,3022,4,17,8,11,57,47,10,59
Stranraer,3022,5,15,6,15,56,65,-9,51
Airdrieon,3022,6,11,11,14,48,58,-10,44
East Fife,3022,7,13,4,19,48,65,-17,43
Forfar,3022,8,10,5,21,38,67,-29,35
Albion,3022,9,8,6,22,58,81,-23,30
Queen's Park,3022,10,6,11,19,40,73,-33,29
Ayr,3023,1,24,4,8,94,42,52,76
Raith,3023,2,22,8,6,68,33,35,74
Arbroath,3023,3,18,8,10,72,49,23,62
Alloa,3023,4,18,8,10,57,43,14,62
Stranraer,3023,5,15,6,15,56,65,-9,51
Airdrieon,3023,6,11,11,14,47,58,-11,44
East Fife,3023,7,13,4,19,48,65,-17,43
Forfar,3023,8,10,5,21,38,66,-28,35
Albion,3023,9,8,6,22,57,82,-25,30
Queen's Park,3023,10,6,10,20,40,74,-34,28
Raith,3024,1,23,8,5,71,33,38,77
Ayr,3024,2,24,4,8,94,43,51,76
Arbroath,3024,3,18,8,10,72,49,23,62
Alloa,3024,4,17,8,11,57,46,11,59
Stranraer,3024,5,15,6,15,56,65,-9,51
Airdrieon,3024,6,11,11,14,48,60,-12,44
East Fife,3024,7,13,4,19,48,65,-17,43
Forfar,3024,8,10,5,21,40,67,-27,35
Albion,3024,9,8,6,22,58,82,-24,30
Queen's Park,3024,10,6,10,20,40,74,-34,28
Ayr,3025,1,24,4,8,94,42,52,76
Raith,3025,2,22,8,6,69,34,35,74
Alloa,3025,3,18,8,10,58,44,14,62
Arbroath,3025,4,17,8,11,71,50,21,59
Stranraer,3025,5,16,5,15,58,65,-7,53
Airdrieon,3025,6,11,11,14,47,58,-11,44
East Fife,3025,7,13,3,20,48,67,-19,42
Forfar,3025,8,10,5,21,38,66,-28,35
Queen's Park,3025,9,7,10,19,41,73,-32,31
Albion,3025,10,8,6,22,57,82,-25,30
Raith,3026,1,23,8,5,70,33,37,77
Ayr,3026,2,24,4,8,94,42,52,76
Arbroath,3026,3,17,8,11,70,49,21,59
Alloa,3026,4,17,8,11,57,45,12,59
Stranraer,3026,5,15,6,15,56,65,-9,51
Airdrieon,3026,6,11,11,14,49,58,-9,44
East Fife,3026,7,13,4,19,48,65,-17,43
Forfar,3026,8,10,5,21,38,68,-30,35
Queen's Park,3026,9,7,10,19,40,72,-32,31
Albion,3026,10,8,6,22,57,82,-25,30
Ayr,3027,1,24,4,8,95,42,53,76
Raith,3027,2,22,9,5,69,33,36,75
Alloa,3027,3,17,9,10,57,44,13,60
Arbroath,3027,4,17,8,11,71,50,21,59
Stranraer,3027,5,15,5,16,56,69,-13,50
East Fife,3027,6,14,3,19,52,65,-13,45
Airdrieon,3027,7,10,11,15,47,61,-14,41
Forfar,3027,8,11,5,20,41,66,-25,38
Queen's Park,3027,9,7,10,19,41,73,-32,31
Albion,3027,10,8,6,22,57,83,-26,30
Ayr,3028,1,24,4,8,94,45,49,76
Raith,3028,2,22,8,6,69,35,34,74
Alloa,3028,3,18,8,10,59,44,15,62
Arbroath,3028,4,17,8,11,71,50,21,59
Stranraer,3028,5,15,5,16,57,68,-11,50
East Fife,3028,6,14,3,19,51,66,-15,45
Airdrieon,3028,7,10,11,15,46,60,-14,41
Forfar,3028,8,11,5,20,40,65,-25,38
Queen's Park,3028,9,7,10,19,41,73,-32,31
Albion,3028,10,8,6,22,60,82,-22,30
Raith,3029,1,22,9,5,69,33,36,75
Ayr,3029,2,23,5,8,91,43,48,74
Arbroath,3029,3,18,8,10,74,48,26,62
Alloa,3029,4,17,9,10,57,44,13,60
Stranraer,3029,5,15,6,15,57,66,-9,51
East Fife,3029,6,13,4,19,49,66,-17,43
Airdrieon,3029,7,10,11,15,45,60,-15,41
Forfar,3029,8,11,5,20,40,64,-24,38
Albion,3029,9,8,7,21,58,79,-21,31
Queen's Park,3029,10,6,10,20,39,76,-37,28
Raith,3030,1,23,8,5,69,32,37,77
Ayr,3030,2,24,4,8,93,42,51,76
Arbroath,3030,3,18,8,10,75,48,27,62
Alloa,3030,4,17,8,11,56,44,12,59
Stranraer,3030,5,16,5,15,56,64,-8,53
Airdrieon,3030,6,11,11,14,47,58,-11,44
East Fife,3030,7,13,3,20,47,65,-18,42
Forfar,3030,8,10,5,21,38,66,-28,35
Albion,3030,9,8,6,22,57,81,-24,30
Queen's Park,3030,10,6,10,20,39,77,-38,28
Raith,3031,1,23,8,5,70,32,38,77
Ayr,3031,2,24,4,8,94,43,51,76
Arbroath,3031,3,17,9,10,71,49,22,60
Alloa,3031,4,17,8,11,56,45,11,59
Stranraer,3031,5,16,5,15,56,64,-8,53
Airdrieon,3031,6,11,11,14,46,58,-12,44
East Fife,3031,7,13,3,20,47,65,-18,42
Forfar,3031,8,10,5,21,38,65,-27,35
Albion,3031,9,8,6,22,58,82,-24,30
Queen's Park,3031,10,6,11,19,40,73,-33,29
Raith,3032,1,23,8,5,69,32,37,77
Ayr,3032,2,24,4,8,93,43,50,76
Arbroath,3032,3,18,8,10,73,48,25,62
Alloa,3032,4,17,8,11,56,44,12,59
Stranraer,3032,5,15,5,16,56,66,-10,50
East Fife,3032,6,14,3,19,49,65,-16,45
Airdrieon,3032,7,10,11,15,46,60,-14,41
Forfar,3032,8,11,5,20,40,65,-25,38
Albion,3032,9,8,6,22,58,81,-23,30
Queen's Park,3032,10,6,10,20,39,75,-36,28
Raith,3033,1,23,8,5,73,32,41,77
Ayr,3033,2,24,4,8,92,43,49,76
Arbroath,3033,3,18,8,10,73,48,25,62
Alloa,3033,4,17,8,11,56,48,8,59
Stranraer,3033,5,16,5,15,56,64,-8,53
Airdrieon,3033,6,11,11,14,47,59,-12,44
East Fife,3033,7,13,3,20,47,65,-18,42
Forfar,3033,8,10,5,21,39,66,-27,35
Albion,3033,9,8,6,22,58,80,-22,30
Queen's Park,3033,10,6,10,20,39,75,-36,28
Ayr,3034,1,24,4,8,95,43,52,76
Raith,3034,2,22,8,6,69,35,34,74
Alloa,3034,3,18,8,10,59,44,15,62
Arbroath,3034,4,17,9,10,72,50,22,60
Stranraer,3034,5,15,5,16,56,68,-12,50
East Fife,3034,6,14,3,19,51,65,-14,45
Airdrieon,3034,7,10,11,15,47,61,-14,41
Forfar,3034,8,11,5,20,41,66,-25,38
Albion,3034,9,8,6,22,58,83,-25,30
Queen's Park,3034,10,6,11,19,41,74,-33,29
Raith,3035,1,23,8,5,69,32,37,77
Ayr,3035,2,23,5,8,93,45,48,74
Arbroath,3035,3,18,8,10,73,49,24,62
Alloa,3035,4,17,8,11,56,44,12,59
Stranraer,3035,5,15,6,15,57,66,-9,51
Airdrieon,3035,6,11,11,14,49,58,-9,44
East Fife,3035,7,13,4,19,49,66,-17,43
Forfar,3035,8,10,5,21,38,68,-30,35
Albion,3035,9,8,7,21,60,81,-21,31
Queen's Park,3035,10,6,10,20,40,75,-35,28
Raith,3036,1,23,8,5,71,32,39,77
Ayr,3036,2,23,4,9,94,47,47,73
Arbroath,3036,3,17,9,10,71,49,22,60
Alloa,3036,4,17,8,11,56,46,10,59
Stranraer,3036,5,15,5,16,55,67,-12,50
East Fife,3036,6,14,3,19,50,64,-14,45
Airdrieon,3036,7,11,11,14,48,59,-11,44
Forfar,3036,8,10,5,21,39,67,-28,35
Albion,3036,9,9,6,21,62,82,-20,33
Queen's Park,3036,10,6,11,19,40,73,-33,29
Raith,3037,1,23,8,5,71,32,39,77
Ayr,3037,2,24,4,8,94,44,50,76
Arbroath,3037,3,17,8,11,71,50,21,59
Alloa,3037,4,17,8,11,56,46,10,59
Stranraer,3037,5,15,5,16,55,66,-11,50
East Fife,3037,6,14,3,19,49,64,-15,45
Airdrieon,3037,7,11,11,14,48,58,-10,44
Forfar,3037,8,10,5,21,38,67,-29,35
Queen's Park,3037,9,7,10,19,41,73,-32,31
Albion,3037,10,8,6,22,59,82,-23,30
Raith,3038,1,23,8,5,73,33,40,77
Ayr,3038,2,24,4,8,94,42,52,76
Arbroath,3038,3,18,8,10,73,50,23,62
Alloa,3038,4,17,8,11,57,48,9,59
Stranraer,3038,5,15,5,16,56,67,-11,50
East Fife,3038,6,14,3,19,50,65,-15,45
Airdrieon,3038,7,11,11,14,46,58,-12,44
Forfar,3038,8,10,5,21,38,65,-27,35
Albion,3038,9,8,6,22,57,82,-25,30
Queen's Park,3038,10,6,10,20,41,75,-34,28
Raith,3039,1,23,8,5,71,32,39,77
Ayr,3039,2,24,4,8,95,43,52,76
Arbroath,3039,3,17,9,10,71,49,22,60
Alloa,3039,4,17,8,11,56,46,10,59
Stranraer,3039,5,16,5,15,57,65,-8,53
East Fife,3039,6,13,3,20,48,66,-18,42
Airdrieon,3039,7,10,11,15,45,60,-15,41
Forfar,3039,8,11,5,20,40,64,-24,38
Albion,3039,9,8,6,22,58,83,-25,30
Queen's Park,3039,10,6,11,19,40,73,-33,29
Ayr,3040,1,23,5,8,92,44,48,74
Raith,3040,2,22,8,6,68,33,35,74
Alloa,3040,3,18,8,10,57,43,14,62
Arbroath,3040,4,17,9,10,72,50,22,60
Stranraer,3040,5,15,5,16,56,68,-12,50
East Fife,3040,6,14,3,19,51,65,-14,45
Airdrieon,3040,7,11,11,14,51,58,-7,44
Forfar,3040,8,10,5,21,38,70,-32,35
Albion,3040,9,8,7,21,59,80,-21,31
Queen's Park,3040,10,6,11,19,41,74,-33,29
Ayr,3041,1,24,4,8,94,43,51,76
Raith,3041,2,22,8,6,68,34,34,74
Alloa,3041,3,18,8,10,58,43,15,62
Arbroath,3041,4,17,8,11,71,50,21,59
Stranraer,3041,5,15,6,15,55,64,-9,51
East Fife,3041,6,13,4,19,47,64,-17,43
Airdrieon,3041,7,10,11,15,45,59,-14,41
Forfar,3041,8,11,5,20,39,64,-25,38
Queen's Park,3041,9,7,10,19,41,73,-32,31
Albion,3041,10,8,6,22,58,82,-24,30
Raith,3042,1,23,8,5,69,32,37,77
Ayr,3042,2,24,4,8,98,43,55,76
Arbroath,3042,3,17,8,11,71,51,20,59
Alloa,3042,4,17,8,11,56,44,12,59
Stranraer,3042,5,16,5,15,57,65,-8,53
East Fife,3042,6,13,3,20,48,66,-18,42
Airdrieon,3042,7,10,11,15,46,60,-14,41
Forfar,3042,8,11,5,20,40,65,-25,38
Queen's Park,3042,9,7,10,19,42,73,-31,31
Albion,3042,10,8,6,22,58,86,-28,30
Raith,3043,1,23,8,5,69,32,37,77
Ayr,3043,2,23,5,8,90,42,48,74
Arbroath,3043,3,18,8,10,73,49,24,62
Alloa,3043,4,17,8,11,56,44,12,59
Stranraer,3043,5,16,5,15,57,65,-8,53
Airdrieon,3043,6,11,11,14,47,58,-11,44
East Fife,3043,7,13,3,20,48,66,-18,42
Forfar,3043,8,10,5,21,38,66,-28,35
Albion,3043,9,8,7,21,57,78,-21,31
Queen's Park,3043,10,6,10,20,40,75,-35,28
Raith,3044,1,23,8,5,69,32,37,77
Ayr,3044,2,23,4,9,93,47,46,73
Arbroath,3044,3,17,8,11,70,50,20,59
Alloa,3044,4,17,8,11,56,44,12,59
Stranraer,3044,5,16,5,15,57,65,-8,53
Airdrieon,3044,6,10,12,14,46,59,-13,42
East Fife,3044,7,13,3,20,48,66,-18,42
Forfar,3044,8,10,6,20,39,65,-26,36
Albion,3044,9,9,6,21,62,81,-19,33
Queen's Park,3044,10,7,10,19,41,72,-31,31
Raith,3045,1,23,8,5,71,33,38,77
Ayr,3045,2,23,4,9,92,45,47,73
Arbroath,3045,3,17,8,11,71,51,20,59
Alloa,3045,4,17,8,11,57,46,11,59
Stranraer,3045,5,15,5,16,55,67,-12,50
East Fife,3045,6,14,3,19,50,64,-14,45
Airdrieon,3045,7,10,12,14,48,61,-13,42
Forfar,3045,8,10,6,20,41,67,-26,36
Albion,3045,9,9,6,21,60,80,-20,33
Queen's Park,3045,10,7,10,19,42,73,-31,31
Ayr,3046,1,24,4,8,93,43,50,76
Raith,3046,2,22,8,6,68,35,33,74
Arbroath,3046,3,18,8,10,74,51,23,62
Alloa,3046,4,18,8,10,59,43,16,62
Stranraer,3046,5,15,5,16,56,66,-10,50
East Fife,3046,6,14,3,19,49,65,-16,45
Airdrieon,3046,7,10,12,14,47,60,-13,42
Forfar,3046,8,10,6,20,40,66,-26,36
Albion,3046,9,8,6,22,58,81,-23,30
Queen's Park,3046,10,6,10,20,42,76,-34,28
Raith,3047,1,23,8,5,69,32,37,77
Ayr,3047,2,24,4,8,92,43,49,76
Arbroath,3047,3,18,8,10,72,49,23,62
Alloa,3047,4,17,8,11,56,44,12,59
Stranraer,3047,5,16,5,15,58,65,-7,53
Airdrieon,3047,6,11,11,14,47,58,-11,44
East Fife,3047,7,13,3,20,48,67,-19,42
Forfar,3047,8,10,5,21,38,66,-28,35
Albion,3047,9,8,6,22,58,80,-22,30
Queen's Park,3047,10,6,10,20,40,74,-34,28
Raith,3048,1,23,8,5,71,33,38,77
Ayr,3048,2,24,4,8,93,42,51,76
Arbroath,3048,3,17,8,11,71,50,21,59
Alloa,3048,4,17,8,11,57,46,11,59
Stranraer,3048,5,15,5,16,56,68,-12,50
East Fife,3048,6,14,3,19,51,65,-14,45
Airdrieon,3048,7,11,11,14,47,58,-11,44
Forfar,3048,8,10,5,21,38,66,-28,35
Queen's Park,3048,9,7,10,19,41,73,-32,31
Albion,3048,10,8,6,22,57,81,-24,30
Raith,3049,1,23,8,5,70,32,38,77
Ayr,3049,2,24,4,8,97,42,55,76
Arbroath,3049,3,17,8,11,72,51,21,59
Alloa,3049,4,17,8,11,56,45,11,59
Stranraer,3049,5,15,5,16,56,66,-10,50
East Fife,3049,6,14,3,19,49,65,-16,45
Airdrieon,3049,7,11,11,14,49,59,-10,44
Forfar,3049,8,10,5,21,39,68,-29,35
Queen's Park,3049,9,7,10,19,42,74,-32,31
Albion,3049,10,8,6,22,57,85,-28,30
Ayr,3050,1,24,4,8,95,44,51,76
Raith,3050,2,22,9,5,71,35,36,75
Arbroath,3050,3,17,9,10,71,49,22,60
Alloa,3050,4,17,9,10,59,46,13,60
Stranraer,3050,5,15,6,15,56,65,-9,51
East Fife,3050,6,13,4,19,48,65,-17,43
Airdrieon,3050,7,10,11,15,45,60,-15,41
Forfar,3050,8,11,5,20,40,64,-24,38
Albion,3050,9,8,6,22,59,83,-24,30
Queen's Park,3050,10,6,11,19,40,73,-33,29
Raith,3051,1,23,8,5,70,33,37,77
Ayr,3051,2,24,4,8,95,42,53,76
Arbroath,3051,3,17,9,10,73,51,22,60
Alloa,3051,4,17,8,11,57,45,12,59
Stranraer,3051,5,15,5,16,56,67,-11,50
East Fife,3051,6,14,3,19,50,65,-15,45
Airdrieon,3051,7,11,11,14,47,59,-12,44
Forfar,3051,8,10,5,21,39,66,-27,35
Albion,3051,9,8,6,22,57,83,-26,30
Queen's Park,3051,10,6,11,19,42,75,-33,29
Ayr,3052,1,24,4,8,93,44,49,76
Raith,3052,2,22,9,5,68,32,36,75
Alloa,3052,3,17,9,10,56,43,13,60
Arbroath,3052,4,17,8,11,71,50,21,59
Stranraer,3052,5,15,5,16,55,65,-10,50
East Fife,3052,6,14,3,19,48,64,-16,45
Airdrieon,3052,7,10,11,15,45,59,-14,41
Forfar,3052,8,11,5,20,39,64,-25,38
Queen's Park,3052,9,7,10,19,41,73,-32,31
Albion,3052,10,8,6,22,59,81,-22,30
Ayr,3053,1,24,4,8,96,44,52,76
Raith,3053,2,22,9,5,69,33,36,75
Arbroath,3053,3,18,8,10,72,48,24,62
Alloa,3053,4,17,9,10,57,44,13,60
Stranraer,3053,5,15,5,16,55,65,-10,50
East Fife,3053,6,14,3,19,48,64,-16,45
Airdrieon,3053,7,11,11,14,49,58,-9,44
Forfar,3053,8,10,5,21,38,68,-30,35
Albion,3053,9,8,6,22,59,84,-25,30
Queen's Park,3053,10,6,10,20,39,74,-35,28
Ayr,3054,1,24,4,8,99,42,57,76
Raith,3054,2,22,9,5,69,33,36,75
Arbroath,3054,3,17,9,10,70,48,22,60
Alloa,3054,4,17,9,10,57,44,13,60
Stranraer,3054,5,15,5,16,55,66,-11,50
East Fife,3054,6,14,3,19,49,64,-15,45
Airdrieon,3054,7,11,11,14,48,59,-11,44
Forfar,3054,8,10,5,21,39,67,-28,35
Albion,3054,9,8,6,22,57,87,-30,30
Queen's Park,3054,10,6,11,19,39,72,-33,29
Ayr,3055,1,24,4,8,92,43,49,76
Raith,3055,2,22,8,6,69,35,34,74
Alloa,3055,3,18,8,10,59,44,15,62
Arbroath,3055,4,17,8,11,70,52,18,59
Stranraer,3055,5,16,5,15,57,64,-7,53
Airdrieon,3055,6,11,11,14,47,59,-12,44
East Fife,3055,7,13,3,20,47,66,-19,42
Forfar,3055,8,10,5,21,39,66,-27,35
Queen's Park,3055,9,7,10,19,43,72,-29,31
Albion,3055,10,8,6,22,58,80,-22,30
Raith,3056,1,23,8,5,72,33,39,77
Ayr,3056,2,24,4,8,92,43,49,76
Arbroath,3056,3,18,8,10,75,48,27,62
Alloa,3056,4,17,8,11,57,47,10,59
Stranraer,3056,5,15,6,15,57,66,-9,51
Airdrieon,3056,6,11,11,14,48,59,-11,44
East Fife,3056,7,13,4,19,49,66,-17,43
Forfar,3056,8,10,5,21,39,67,-28,35
Albion,3056,9,8,6,22,58,80,-22,30
Queen's Park,3056,10,6,10,20,39,77,-38,28
Raith,3057,1,23,8,5,72,32,40,77
Ayr,3057,2,24,4,8,93,43,50,76
Arbroath,3057,3,17,8,11,71,50,21,59
Alloa,3057,4,17,8,11,56,47,9,59
Stranraer,3057,5,16,5,15,57,65,-8,53
Airdrieon,3057,6,10,12,14,45,58,-13,42
East Fife,3057,7,13,3,20,48,66,-18,42
Forfar,3057,8,10,6,20,38,64,-26,36
Queen's Park,3057,9,7,10,19,41,73,-32,31
Albion,3057,10,8,6,22,58,81,-23,30
Raith,3058,1,23,8,5,72,33,39,77
Ayr,3058,2,24,4,8,92,43,49,76
Arbroath,3058,3,17,8,11,71,50,21,59
Alloa,3058,4,17,8,11,57,47,10,59
Stranraer,3058,5,15,5,16,55,65,-10,50
East Fife,3058,6,14,3,19,48,64,-16,45
Airdrieon,3058,7,11,11,14,46,58,-12,44
Forfar,3058,8,10,5,21,38,65,-27,35
Queen's Park,3058,9,7,10,19,41,73,-32,31
Albion,3058,10,8,6,22,58,80,-22,30
Ayr,3059,1,24,4,8,96,44,52,76
Raith,3059,2,22,8,6,68,33,35,74
Alloa,3059,3,18,8,10,57,43,14,62
Arbroath,3059,4,17,9,10,72,50,22,60
Stranraer,3059,5,15,6,15,58,67,-9,51
East Fife,3059,6,13,4,19,50,67,-17,43
Airdrieon,3059,7,10,12,14,48,61,-13,42
Forfar,3059,8,10,6,20,41,67,-26,36
Albion,3059,9,8,6,22,59,84,-25,30
Queen's Park,3059,10,6,11,19,41,74,-33,29
Ayr,3060,1,24,4,8,97,42,55,76
Raith,3060,2,22,9,5,70,34,36,75
Arbroath,3060,3,18,8,10,74,50,24,62
Alloa,3060,4,17,9,10,58,45,13,60
Stranraer,3060,5,15,6,15,55,64,-9,51
East Fife,3060,6,13,4,19,47,64,-17,43
Airdrieon,3060,7,10,12,14,45,58,-13,42
Forfar,3060,8,10,6,20,38,64,-26,36
Albion,3060,9,8,6,22,57,85,-28,30
Queen's Park,3060,10,6,10,20,41,76,-35,28
Raith,3061,1,23,8,5,73,33,40,77
Ayr,3061,2,24,4,8,94,42,52,76
Arbroath,3061,3,18,8,10,73,48,25,62
Alloa,3061,4,17,8,11,57,48,9,59
Stranraer,3061,5,15,6,15,56,65,-9,51
East Fife,3061,6,13,4,19,48,65,-17,43
Airdrieon,3061,7,10,11,15,46,60,-14,41
Forfar,3061,8,11,5,20,40,65,-25,38
Albion,3061,9,8,6,22,57,82,-25,30
Queen's Park,3061,10,6,10,20,39,75,-36,28
Ayr,3062,1,24,4,8,94,44,50,76
Raith,3062,2,22,8,6,70,35,35,74
Arbroath,3062,3,18,8,10,74,49,25,62
Alloa,3062,4,18,8,10,59,45,14,62
Stranraer,3062,5,15,6,15,56,65,-9,51
Airdrieon,3062,6,11,11,14,47,59,-12,44
East Fife,3062,7,13,4,19,48,65,-17,43
Forfar,3062,8,10,5,21,39,66,-27,35
Albion,3062,9,8,6,22,59,82,-23,30
Queen's Park,3062,10,6,10,20,40,76,-36,28
Ayr,3063,1,24,4,8,96,42,54,76
Raith,3063,2,22,9,5,68,32,36,75
Arbroath,3063,3,17,9,10,72,50,22,60
Alloa,3063,4,17,9,10,56,43,13,60
Stranraer,3063,5,15,5,16,55,68,-13,50
East Fife,3063,6,14,3,19,51,64,-13,45
Airdrieon,3063,7,11,11,14,47,59,-12,44
Forfar,3063,8,10,5,21,39,66,-27,35
Albion,3063,9,8,6,22,57,84,-27,30
Queen's Park,3063,10,6,11,19,41,74,-33,29
Raith,3064,1,23,8,5,71,32,39,77
Ayr,3064,2,24,4,8,94,44,50,76
Arbroath,3064,3,17,8,11,71,51,20,59
Alloa,3064,4,17,8,11,56,46,10,59
Stranraer,3064,5,15,5,16,56,66,-10,50
East Fife,3064,6,14,3,19,49,65,-16,45
Airdrieon,3064,7,11,11,14,48,58,-10,44
Forfar,3064,8,10,5,21,38,67,-29,35
Queen's Park,3064,9,7,10,19,42,73,-31,31
Albion,3064,10,8,6,22,59,82,-23,30
Ayr,3065,1,24,4,8,98,44,54,76
Raith,3065,2,22,8,6,69,34,35,74
Alloa,3065,3,18,8,10,58,44,14,62
Arbroath,3065,4,17,8,11,70,49,21,59
Stranraer,3065,5,15,5,16,55,67,-12,50
East Fife,3065,6,14,3,19,50,64,-14,45
Airdrieon,3065,7,10,12,14,46,59,-13,42
Forfar,3065,8,10,6,20,39,65,-26,36
Queen's Park,3065,9,7,10,19,40,72,-32,31
Albion,3065,10,8,6,22,59,86,-27,30
Ayr,3066,1,24,4,8,97,44,53,76
Raith,3066,2,22,8,6,68,34,34,74
Alloa,3066,3,18,8,10,58,43,15,62
Arbroath,3066,4,17,8,11,71,53,18,59
Stranraer,3066,5,15,6,15,55,64,-9,51
East Fife,3066,6,13,4,19,47,64,-17,43
Airdrieon,3066,7,10,12,14,47,60,-13,42
Forfar,3066,8,10,6,20,40,66,-26,36
Queen's Park,3066,9,7,10,19,44,73,-29,31
Albion,3066,10,8,6,22,59,85,-26,30
Raith,3067,1,23,8,5,71,34,37,77
Ayr,3067,2,24,4,8,93,43,50,76
Arbroath,3067,3,18,8,10,73,49,24,62
Alloa,3067,4,17,8,11,58,46,12,59
Stranraer,3067,5,15,5,16,57,67,-10,50
East Fife,3067,6,14,3,19,50,66,-16,45
Airdrieon,3067,7,10,11,15,46,60,-14,41
Forfar,3067,8,11,5,20,40,65,-25,38
Albion,3067,9,8,6,22,58,81,-23,30
Queen's Park,3067,10,6,10,20,40,75,-35,28
Raith,3068,1,23,8,5,70,32,38,77
Ayr,3068,2,24,4,8,95,42,53,76
Arbroath,3068,3,18,8,10,71,48,23,62
Alloa,3068,4,17,8,11,56,45,11,59
Stranraer,3068,5,16,5,15,56,64,-8,53
Airdrieon,3068,6,10,12,14,48,61,-13,42
East Fife,3068,7,13,3,20,47,65,-18,42
Forfar,3068,8,10,6,20,41,67,-26,36
Albion,3068,9,8,6,22,57,83,-26,30
Queen's Park,3068,10,6,10,20,39,73,-34,28
Ayr,3069,1,24,4,8,94,43,51,76
Raith,3069,2,22,8,6,68,33,35,74
Alloa,3069,3,18,8,10,57,43,14,62
Arbroath,3069,4,17,8,11,70,49,21,59
Stranraer,3069,5,16,5,15,58,64,-6,53
Airdrieon,3069,6,11,11,14,46,58,-12,44
East Fife,3069,7,13,3,20,47,67,-20,42
Forfar,3069,8,10,5,21,38,65,-27,35
Queen's Park,3069,9,7,10,19,40,72,-32,31
Albion,3069,10,8,6,22,58,82,-24,30
Ayr,3070,1,23,5,8,91,43,48,74
Raith,3070,2,22,8,6,69,35,34,74
Alloa,3070,3,18,8,10,59,44,15,62
Arbroath,3070,4,17,8,11,70,50,20,59
Stranraer,3070,5,15,5,16,55,69,-14,50
East Fife,3070,6,14,3,19,52,64,-12,45
Airdrieon,3070,7,11,11,14,47,59,-12,44
Forfar,3070,8,10,5,21,39,66,-27,35
Albion,3070,9,8,7,21,58,79,-21,31
Queen's Park,3070,10,7,10,19,41,72,-31,31
Ayr,3071,1,24,4,8,95,44,51,76
Raith,3071,2,22,9,5,69,33,36,75
Alloa,3071,3,17,9,10,57,44,13,60
Arbroath,3071,4,17,8,11,71,51,20,59
Stranraer,3071,5,15,6,15,56,65,-9,51
Airdrieon,3071,6,11,11,14,48,59,-11,44
East Fife,3071,7,13,4,19,48,65,-17,43
Forfar,3071,8,10,5,21,39,67,-28,35
Queen's Park,3071,9,7,10,19,42,73,-31,31
Albion,3071,10,8,6,22,59,83,-24,30
Raith,3072,1,23,8,5,70,33,37,77
Ayr,3072,2,23,4,9,90,44,46,73
Arbroath,3072,3,18,8,10,72,49,23,62
Alloa,3072,4,17,8,11,57,45,12,59
Stranraer,3072,5,15,5,16,57,67,-10,50
East Fife,3072,6,14,3,19,50,66,-16,45
Airdrieon,3072,7,11,11,14,47,58,-11,44
Forfar,3072,8,10,5,21,38,66,-28,35
Albion,3072,9,9,6,21,59,78,-19,33
Queen's Park,3072,10,6,10,20,40,74,-34,28
Raith,3073,1,23,8,5,73,33,40,77
Ayr,3073,2,24,4,8,94,42,52,76
Arbroath,3073,3,17,9,10,72,50,22,60
Alloa,3073,4,17,8,11,57,48,9,59
Stranraer,3073,5,15,6,15,56,65,-9,51
Airdrieon,3073,6,11,11,14,47,59,-12,44
East Fife,3073,7,13,4,19,48,65,-17,43
Forfar,3073,8,10,5,21,39,66,-27,35
Albion,3073,9,8,6,22,57,82,-25,30
Queen's Park,3073,10,6,11,19,41,74,-33,29
Ayr,3074,1,24,4,8,94,44,50,76
Raith,3074,2,22,8,6,68,34,34,74
Arbroath,3074,3,18,8,10,72,49,23,62
Alloa,3074,4,18,8,10,58,43,15,62
Stranraer,3074,5,15,5,16,56,66,-10,50
East Fife,3074,6,14,3,19,49,65,-16,45
Airdrieon,3074,7,11,11,14,47,59,-12,44
Forfar,3074,8,10,5,21,39,66,-27,35
Albion,3074,9,8,6,22,59,82,-23,30
Queen's Park,3074,10,6,10,20,40,74,-34,28
Ayr,3075,1,24,4,8,96,45,51,76
Raith,3075,2,22,9,5,68,32,36,75
Alloa,3075,3,17,9,10,56,43,13,60
Arbroath,3075,4,17,8,11,72,54,18,59
Stranraer,3075,5,15,5,16,55,66,-11,50
East Fife,3075,6,14,3,19,49,64,-15,45
Airdrieon,3075,7,10,11,15,47,61,-14,41
Forfar,3075,8,11,5,20,41,66,-25,38
Queen's Park,3075,9,7,10,19,45,74,-29,31
Albion,3075,10,8,6,22,60,84,-24,30
Ayr,3076,1,23,5,8,92,44,48,74
Raith,3076,2,22,8,6,68,33,35,74
Arbroath,3076,3,18,8,10,71,48,23,62
Alloa,3076,4,18,8,10,57,43,14,62
Stranraer,3076,5,15,5,16,56,68,-12,50
East Fife,3076,6,14,3,19,51,65,-14,45
Airdrieon,3076,7,10,12,14,46,59,-13,42
Forfar,3076,8,10,6,20,39,65,-26,36
Albion,3076,9,8,7,21,59,80,-21,31
Queen's Park,3076,10,6,10,20,39,73,-34,28
Raith,3077,1,23,8,5,70,32,38,77
Ayr,3077,2,24,4,8,95,45,50,76
Arbroath,3077,3,18,8,10,71,48,23,62
Alloa,3077,4,17,8,11,56,45,11,59
Stranraer,3077,5,16,5,15,58,65,-7,53
Airdrieon,3077,6,11,11,14,46,58,-12,44
East Fife,3077,7,13,3,20,48,67,-19,42
Forfar,3077,8,10,5,21,38,65,-27,35
Albion,3077,9,8,6,22,60,83,-23,30
Queen's Park,3077,10,6,10,20,39,73,-34,28
Ayr,3078,1,24,4,8,92,42,50,76
Raith,3078,2,22,9,5,69,33,36,75
Arbroath,3078,3,18,8,10,77,48,29,62
Alloa,3078,4,17,9,10,57,44,13,60
Stranraer,3078,5,15,6,15,56,65,-9,51
East Fife,3078,6,13,4,19,48,65,-17,43
Airdrieon,3078,7,10,12,14,46,59,-13,42
Forfar,3078,8,10,6,20,39,65,-26,36
Albion,3078,9,8,6,22,57,80,-23,30
Queen's Park,3078,10,6,10,20,39,79,-40,28
Raith,3079,1,23,8,5,73,32,41,77
Ayr,3079,2,24,4,8,94,42,52,76
Arbroath,3079,3,17,8,11,71,51,20,59
Alloa,3079,4,17,8,11,56,48,8,59
Stranraer,3079,5,16,5,15,57,64,-7,53
Airdrieon,3079,6,11,11,14,47,59,-12,44
East Fife,3079,7,13,3,20,47,66,-19,42
Forfar,3079,8,10,5,21,39,66,-27,35
Queen's Park,3079,9,7,10,19,42,73,-31,31
Albion,3079,10,8,6,22,57,82,-25,30
Raith,3080,1,23,8,5,71,33,38,77
Ayr,3080,2,24,4,8,96,42,54,76
Arbroath,3080,3,18,8,10,73,49,24,62
Alloa,3080,4,17,8,11,57,46,11,59
Stranraer,3080,5,15,5,16,56,67,-11,50
East Fife,3080,6,14,3,19,50,65,-15,45
Airdrieon,3080,7,10,12,14,46,59,-13,42
Forfar,3080,8,10,6,20,39,65,-26,36
Albion,3080,9,8,6,22,57,84,-27,30
Queen's Park,3080,10,6,10,20,40,75,-35,28
Raith,3081,1,23,8,5,72,34,38,77
Ayr,3081,2,24,4,8,94,43,51,76
Arbroath,3081,3,17,8,11,72,51,21,59
Alloa,3081,4,17,8,11,58,47,11,59
Stranraer,3081,5,15,5,16,55,66,-11,50
East Fife,3081,6,14,3,19,49,64,-15,45
Airdrieon,3081,7,10,12,14,45,58,-13,42
Forfar,3081,8,10,6,20,38,64,-26,36
Queen's Park,3081,9,7,10,19,42,74,-32,31
Albion,3081,10,8,6,22,58,82,-24,30
Raith,3082,1,22,9,5,70,34,36,75
Ayr,3082,2,23,5,8,91,43,48,74
Alloa,3082,3,17,9,10,58,45,13,60
Arbroath,3082,4,17,8,11,70,52,18,59
Stranraer,3082,5,15,5,16,56,67,-11,50
East Fife,3082,6,14,3,19,50,65,-15,45
Airdrieon,3082,7,10,12,14,46,59,-13,42
Forfar,3082,8,10,6,20,39,65,-26,36
Albion,3082,9,8,7,21,58,79,-21,31
Queen's Park,3082,10,7,10,19,43,72,-29,31
Raith,3083,1,23,8,5,70,33,37,77
Ayr,3083,2,24,4,8,93,42,51,76
Arbroath,3083,3,18,8,10,72,49,23,62
Alloa,3083,4,17,8,11,57,45,12,59
Stranraer,3083,5,15,6,15,56,65,-9,51
East Fife,3083,6,13,4,19,48,65,-17,43
Airdrieon,3083,7,10,11,15,45,60,-15,41
Forfar,3083,8,11,5,20,40,64,-24,38
Albion,3083,9,8,6,22,57,81,-24,30
Queen's Park,3083,10,6,10,20,40,74,-34,28
Ayr,3084,1,24,4,8,91,42,49,76
Raith,3084,2,22,8,6,69,34,35,74
Arbroath,3084,3,18,8,10,71,48,23,62
Alloa,3084,4,18,8,10,58,44,14,62
Stranraer,3084,5,15,5,16,56,67,-11,50
East Fife,3084,6,14,3,19,50,65,-15,45
Airdrieon,3084,7,10,11,15,46,61,-15,41
Forfar,3084,8,11,5,20,41,65,-24,38
Albion,3084,9,8,6,22,57,79,-22,30
Queen's Park,3084,10,6,10,20,39,73,-34,28
Raith,3085,1,23,8,5,74,33,41,77
Ayr,3085,2,23,5,8,91,43,48,74
Arbroath,3085,3,17,8,11,71,50,21,59
Alloa,3085,4,17,8,11,57,49,8,59
Stranraer,3085,5,15,5,16,55,65,-10,50
East Fife,3085,6,14,3,19,48,64,-16,45
Airdrieon,3085,7,10,11,15,45,60,-15,41
Forfar,3085,8,11,5,20,40,64,-24,38
Albion,3085,9,8,7,21,58,79,-21,31
Queen's Park,3085,10,7,10,19,41,73,-32,31
Ayr,3086,1,24,4,8,94,42,52,76
Raith,3086,2,22,9,5,69,33,36,75
Arbroath,3086,3,18,8,10,73,50,23,62
Alloa,3086,4,17,9,10,57,44,13,60
Stranraer,3086,5,16,5,15,56,64,-8,53
Airdrieon,3086,6,11,11,14,46,58,-12,44
East Fife,3086,7,13,3,20,47,65,-18,42
Forfar,3086,8,10,5,21,38,65,-27,35
Albion,3086,9,8,6,22,57,82,-25,30
Queen's Park,3086,10,6,10,20,41,75,-34,28
Raith,3087,1,23,8,5,70,32,38,77
Ayr,3087,2,23,5,8,91,43,48,74
Arbroath,3087,3,17,9,10,70,48,22,60
Alloa,3087,4,17,8,11,56,45,11,59
Stranraer,3087,5,15,5,16,57,68,-11,50
East Fife,3087,6,14,3,19,51,66,-15,45
Airdrieon,3087,7,11,11,14,46,58,-12,44
Forfar,3087,8,10,5,21,38,65,-27,35
Albion,3087,9,8,7,21,58,79,-21,31
Queen's Park,3087,10,6,11,19,39,72,-33,29
Ayr,3088,1,24,4,8,97,44,53,76
Raith,3088,2,22,8,6,68,33,35,74
Alloa,3088,3,18,8,10,57,43,14,62
Arbroath,3088,4,17,8,11,73,52,21,59
Stranraer,3088,5,16,5,15,58,65,-7,53
Airdrieon,3088,6,11,11,14,47,58,-11,44
East Fife,3088,7,13,3,20,48,67,-19,42
Forfar,3088,8,10,5,21,38,66,-28,35
Queen's Park,3088,9,7,10,19,43,75,-32,31
Albion,3088,10,8,6,22,59,85,-26,30
Raith,3089,1,23,8,5,70,32,38,77
Ayr,3089,2,23,5,8,92,44,48,74
Arbroath,3089,3,18,8,10,73,49,24,62
Alloa,3089,4,17,8,11,56,45,11,59
Stranraer,3089,5,15,5,16,55,67,-12,50
East Fife,3089,6,14,3,19,50,64,-14,45
Airdrieon,3089,7,10,12,14,47,60,-13,42
Forfar,3089,8,10,6,20,40,66,-26,36
Albion,3089,9,8,7,21,59,80,-21,31
Queen's Park,3089,10,6,10,20,40,75,-35,28
Raith,3090,1,23,8,5,69,32,37,77
Ayr,3090,2,24,4,8,95,43,52,76
Arbroath,3090,3,17,8,11,70,51,19,59
Alloa,3090,4,17,8,11,56,44,12,59
Stranraer,3090,5,15,5,16,55,67,-12,50
East Fife,3090,6,14,3,19,50,64,-14,45
Airdrieon,3090,7,10,11,15,45,60,-15,41
Forfar,3090,8,11,5,20,40,64,-24,38
Queen's Park,3090,9,7,10,19,42,72,-30,31
Albion,3090,10,8,6,22,58,83,-25,30
Raith,3091,1,22,8,6,70,35,35,74
Ayr,3091,2,23,4,9,90,44,46,73
Alloa,3091,3,18,8,10,59,45,14,62
Arbroath,3091,4,17,9,10,71,49,22,60
Stranraer,3091,5,15,5,16,55,65,-10,50
East Fife,3091,6,14,3,19,48,64,-16,45
Airdrieon,3091,7,10,11,15,45,59,-14,41
Forfar,3091,8,11,5,20,39,64,-25,38
Albion,3091,9,9,6,21,59,78,-19,33
Queen's Park,3091,10,6,11,19,40,73,-33,29
Ayr,3092,1,24,4,8,93,42,51,76
Raith,3092,2,22,9,5,69,33,36,75
Alloa,3092,3,17,9,10,57,44,13,60
Arbroath,3092,4,17,8,11,73,52,21,59
Stranraer,3092,5,15,5,16,55,67,-12,50
East Fife,3092,6,14,3,19,50,64,-14,45
Airdrieon,3092,7,11,11,14,48,60,-12,44
Forfar,3092,8,10,5,21,40,67,-27,35
Queen's Park,3092,9,7,10,19,43,75,-32,31
Albion,3092,10,8,6,22,57,81,-24,30
Raith,3093,1,22,8,6,70,35,35,74
Ayr,3093,2,23,4,9,90,43,47,73
Arbroath,3093,3,18,8,10,71,48,23,62
Alloa,3093,4,18,8,10,59,45,14,62
Stranraer,3093,5,16,5,15,57,64,-7,53
Airdrieon,3093,6,10,12,14,46,59,-13,42
East Fife,3093,7,13,3,20,47,66,-19,42
Forfar,3093,8,10,6,20,39,65,-26,36
Albion,3093,9,9,6,21,58,78,-20,33
Queen's Park,3093,10,6,10,20,39,73,-34,28
Raith,3094,1,22,9,5,69,33,36,75
Ayr,3094,2,23,4,9,90,44,46,73
Alloa,3094,3,17,9,10,57,44,13,60
Arbroath,3094,4,17,8,11,71,50,21,59
Stranraer,3094,5,15,5,16,57,67,-10,50
East Fife,3094,6,14,3,19,50,66,-16,45
Airdrieon,3094,7,10,12,14,47,60,-13,42
Forfar,3094,8,10,6,20,40,66,-26,36
Albion,3094,9,9,6,21,59,78,-19,33
Queen's Park,3094,10,7,10,19,41,73,-32,31
Raith,3095,1,23,8,5,71,33,38,77
Ayr,3095,2,24,4,8,94,43,51,76
Arbroath,3095,3,17,8,11,70,49,21,59
Alloa,3095,4,17,8,11,57,46,11,59
Stranraer,3095,5,15,5,16,55,65,-10,50
East Fife,3095,6,14,3,19,48,64,-16,45
Airdrieon,3095,7,10,12,14,46,59,-13,42
Forfar,3095,8,10,6,20,39,65,-26,36
Queen's Park,3095,9,7,10,19,40,72,-32,31
Albion,3095,10,8,6,22,58,82,-24,30
Ayr,3096,1,24,4,8,93,43,50,76
Raith,3096,2,22,9,5,68,32,36,75
Alloa,3096,3,17,9,10,56,43,13,60
Arbroath,3096,4,17,8,11,71,52,19,59
Stranraer,3096,5,16,5,15,56,64,-8,53
Airdrieon,3096,6,11,11,14,47,59,-12,44
East Fife,3096,7,13,3,20,47,65,-18,42
Forfar,3096,8,10,5,21,39,66,-27,35
Queen's Park,3096,9,7,10,19,43,73,-30,31
Albion,3096,10,8,6,22,58,81,-23,30
Raith,3097,1,23,8,5,70,32,38,77
Ayr,3097,2,24,4,8,93,42,51,76
Arbroath,3097,3,17,8,11,71,50,21,59
Alloa,3097,4,17,8,11,56,45,11,59
Stranraer,3097,5,15,5,16,55,66,-11,50
East Fife,3097,6,14,3,19,49,64,-15,45
Airdrieon,3097,7,11,11,14,46,58,-12,44
Forfar,3097,8,10,5,21,38,65,-27,35
Queen's Park,3097,9,7,10,19,41,73,-32,31
Albion,3097,10,8,6,22,57,81,-24,30
Ayr,3098,1,24,4,8,95,44,51,76
Raith,3098,2,22,8,6,69,34,35,74
Arbroath,3098,3,18,8,10,73,50,23,62
Alloa,3098,4,18,8,10,58,44,14,62
Stranraer,3098,5,16,5,15,56,64,-8,53
East Fife,3098,6,13,3,20,47,65,-18,42
Airdrieon,3098,7,10,11,15,45,59,-14,41
Forfar,3098,8,11,5,20,39,64,-25,38
Albion,3098,9,8,6,22,59,83,-24,30
Queen's Park,3098,10,6,10,20,41,75,-34,28
Raith,3099,1,22,8,6,68,34,34,74
Ayr,3099,2,23,4,9,91,46,45,73
Arbroath,3099,3,18,8,10,72,48,24,62
Alloa,3099,4,18,8,10,58,43,15,62
Stranraer,3099,5,16,5,15,58,65,-7,53
Airdrieon,3099,6,11,11,14,48,59,-11,44
East Fife,3099,7,13,3,20,48,67,-19,42
Forfar,3099,8,10,5,21,39,67,-28,35
Albion,3099,9,9,6,21,61,79,-18,33
Queen's Park,3099,10,6,10,20,39,74,-35,28
Raith,3100,1,23,8,5,72,33,39,77
Ayr,3100,2,24,4,8,96,44,52,76
Arbroath,3100,3,17,8,11,70,51,19,59
Alloa,3100,4,17,8,11,57,47,10,59
Stranraer,3100,5,16,5,15,58,66,-8,53
Airdrieon,3100,6,11,11,14,46,58,-12,44
East Fife,3100,7,13,3,20,49,67,-18,42
Forfar,3100,8,10,5,21,38,65,-27,35
Queen's Park,3100,9,7,10,19,42,72,-30,31
Albion,3100,10,8,6,22,59,84,-25,30
Raith,3101,1,23,8,5,71,33,38,77
Ayr,3101,2,24,4,8,97,42,55,76
Arbroath,3101,3,17,8,11,71,50,21,59
Alloa,3101,4,17,8,11,57,46,11,59
Stranraer,3101,5,15,6,15,56,65,-9,51
Airdrieon,3101,6,11,11,14,47,58,-11,44
East Fife,3101,7,13,4,19,48,65,-17,43
Forfar,3101,8,10,5,21,38,66,-28,35
Queen's Park,3101,9,7,10,19,41,73,-32,31
Albion,3101,10,8,6,22,57,85,-28,30
Raith,3102,1,23,8,5,70,32,38,77
Ayr,3102,2,24,4,8,95,43,52,76
Arbroath,3102,3,17,8,11,72,51,21,59
Alloa,3102,4,17,8,11,56,45,11,59
Stranraer,3102,5,15,6,15,55,64,-9,51
East Fife,3102,6,13,4,19,47,64,-17,43
Airdrieon,3102,7,10,12,14,47,60,-13,42
Forfar,3102,8,10,6,20,40,66,-26,36
Queen's Park,3102,9,7,10,19,42,74,-32,31
Albion,3102,10,8,6,22,58,83,-25,30
Ayr,3103,1,23,5,8,93,45,48,74
Raith,3103,2,22,8,6,70,35,35,74
Arbroath,3103,3,18,8,10,71,48,23,62
Alloa,3103,4,18,8,10,59,45,14,62
Stranraer,3103,5,15,5,16,56,67,-11,50
East Fife,3103,6,14,3,19,50,65,-15,45
Airdrieon,3103,7,11,11,14,48,58,-10,44
Forfar,3103,8,10,5,21,38,67,-29,35
Albion,3103,9,8,7,21,60,81,-21,31
Queen's Park,3103,10,6,10,20,39,73,-34,28
Raith,3104,1,22,9,5,68,32,36,75
Ayr,3104,2,23,4,9,93,49,44,73
Arbroath,3104,3,17,9,10,72,50,22,60
Alloa,3104,4,17,9,10,56,43,13,60
Stranraer,3104,5,15,5,16,55,66,-11,50
East Fife,3104,6,14,3,19,49,64,-15,45
Airdrieon,3104,7,10,12,14,49,62,-13,42
Forfar,3104,8,10,6,20,42,68,-26,36
Albion,3104,9,9,6,21,64,81,-17,33
Queen's Park,3104,10,6,11,19,41,74,-33,29
Ayr,3105,1,24,4,8,95,43,52,76
Raith,3105,2,22,9,5,69,33,36,75
Arbroath,3105,3,18,8,10,74,50,24,62
Alloa,3105,4,17,9,10,57,44,13,60
Stranraer,3105,5,15,5,16,58,68,-10,50
East Fife,3105,6,14,3,19,51,67,-16,45
Airdrieon,3105,7,11,11,14,46,58,-12,44
Forfar,3105,8,10,5,21,38,65,-27,35
Albion,3105,9,8,6,22,58,83,-25,30
Queen's Park,3105,10,6,10,20,41,76,-35,28
Raith,3106,1,22,8,6,68,35,33,74
Ayr,3106,2,23,4,9,92,46,46,73
Alloa,3106,3,18,8,10,59,43,16,62
Arbroath,3106,4,17,9,10,71,49,22,60
Stranraer,3106,5,16,5,15,57,65,-8,53
Airdrieon,3106,6,11,11,14,49,60,-11,44
East Fife,3106,7,13,3,20,48,66,-18,42
Forfar,3106,8,10,5,21,40,68,-28,35
Albion,3106,9,9,6,21,61,80,-19,33
Queen's Park,3106,10,6,11,19,40,73,-33,29
Raith,3107,1,23,8,5,70,32,38,77
Ayr,3107,2,24,4,8,93,44,49,76
Arbroath,3107,3,17,8,11,70,49,21,59
Alloa,3107,4,17,8,11,56,45,11,59
Stranraer,3107,5,15,6,15,55,64,-9,51
Airdrieon,3107,6,11,11,14,47,59,-12,44
East Fife,3107,7,13,4,19,47,64,-17,43
Forfar,3107,8,10,5,21,39,66,-27,35
Queen's Park,3107,9,7,10,19,40,72,-32,31
Albion,3107,10,8,6,22,59,81,-22,30
Ayr,3108,1,24,4,8,93,42,51,76
Raith,3108,2,22,8,6,69,35,34,74
Arbroath,3108,3,18,8,10,73,49,24,62
Alloa,3108,4,18,8,10,59,44,15,62
Stranraer,3108,5,15,5,16,55,66,-11,50
East Fife,3108,6,14,3,19,49,64,-15,45
Airdrieon,3108,7,11,11,14,48,58,-10,44
Forfar,3108,8,10,5,21,38,67,-29,35
Albion,3108,9,8,6,22,57,81,-24,30
Queen's Park,3108,10,6,10,20,40,75,-35,28
Raith,3109,1,23,8,5,71,33,38,77
Ayr,3109,2,24,4,8,93,42,51,76
Arbroath,3109,3,18,8,10,74,50,24,62
Alloa,3109,4,17,8,11,57,46,11,59
Stranraer,3109,5,15,5,16,55,68,-13,50
East Fife,3109,6,14,3,19,51,64,-13,45
Airdrieon,3109,7,11,11,14,46,58,-12,44
Forfar,3109,8,10,5,21,38,65,-27,35
Albion,3109,9,8,6,22,57,81,-24,30
Queen's Park,3109,10,6,10,20,41,76,-35,28
Ayr,3110,1,24,4,8,96,43,53,76
Raith,3110,2,22,8,6,68,35,33,74
Arbroath,3110,3,18,8,10,72,49,23,62
Alloa,3110,4,18,8,10,59,43,16,62
Stranraer,3110,5,15,6,15,56,65,-9,51
Airdrieon,3110,6,11,11,14,48,60,-12,44
East Fife,3110,7,13,4,19,48,65,-17,43
Forfar,3110,8,10,5,21,40,67,-27,35
Albion,3110,9,8,6,22,58,84,-26,30
Queen's Park,3110,10,6,10,20,40,74,-34,28
Ayr,3111,1,24,4,8,93,43,50,76
Raith,3111,2,22,9,5,69,33,36,75
Arbroath,3111,3,17,9,10,71,49,22,60
Alloa,3111,4,17,9,10,57,44,13,60
Stranraer,3111,5,15,5,16,56,68,-12,50
East Fife,3111,6,14,3,19,51,65,-14,45
Airdrieon,3111,7,11,11,14,49,58,-9,44
Forfar,3111,8,10,5,21,38,68,-30,35
Albion,3111,9,8,6,22,58,81,-23,30
Queen's Park,3111,10,6,11,19,40,73,-33,29
Raith,3112,1,23,8,5,73,32,41,77
Ayr,3112,2,24,4,8,92,43,49,76
Arbroath,3112,3,17,8,11,70,49,21,59
Alloa,3112,4,17,8,11,56,48,8,59
Stranraer,3112,5,16,5,15,57,65,-8,53
Airdrieon,3112,6,11,11,14,48,58,-10,44
East Fife,3112,7,13,3,20,48,66,-18,42
Forfar,3112,8,10,5,21,38,67,-29,35
Queen's Park,3112,9,7,10,19,40,72,-32,31
Albion,3112,10,8,6,22,58,80,-22,30
Ayr,3113,1,24,4,8,93,44,49,76
Raith,3113,2,22,9,5,68,32,36,75
Arbroath,3113,3,18,8,10,72,49,23,62
Alloa,3113,4,17,9,10,56,43,13,60
Stranraer,3113,5,16,5,15,56,64,-8,53
Airdrieon,3113,6,10,12,14,47,60,-13,42
East Fife,3113,7,13,3,20,47,65,-18,42
Forfar,3113,8,10,6,20,40,66,-26,36
Albion,3113,9,8,6,22,59,81,-22,30
Queen's Park,3113,10,6,10,20,40,74,-34,28
Ayr,3114,1,23,5,8,92,44,48,74
Raith,3114,2,22,8,6,68,34,34,74
Arbroath,3114,3,18,8,10,72,48,24,62
Alloa,3114,4,18,8,10,58,43,15,62
Stranraer,3114,5,15,5,16,56,66,-10,50
East Fife,3114,6,14,3,19,49,65,-16,45
Airdrieon,3114,7,10,12,14,47,60,-13,42
Forfar,3114,8,10,6,20,40,66,-26,36
Albion,3114,9,8,7,21,59,80,-21,31
Queen's Park,3114,10,6,10,20,39,74,-35,28
Raith,3115,1,23,8,5,70,33,37,77
Ayr,3115,2,24,4,8,98,45,53,76
Arbroath,3115,3,18,8,10,72,49,23,62
Alloa,3115,4,17,8,11,57,45,12,59
Stranraer,3115,5,15,5,16,57,67,-10,50
East Fife,3115,6,14,3,19,50,66,-16,45
Airdrieon,3115,7,11,11,14,46,58,-12,44
Forfar,3115,8,10,5,21,38,65,-27,35
Albion,3115,9,8,6,22,60,86,-26,30
Queen's Park,3115,10,6,10,20,40,74,-34,28
Ayr,3116,1,24,4,8,96,43,53,76
Raith,3116,2,22,9,5,69,33,36,75
Arbroath,3116,3,18,8,10,74,48,26,62
Alloa,3116,4,17,9,10,57,44,13,60
Stranraer,3116,5,15,5,16,56,66,-10,50
East Fife,3116,6,14,3,19,49,65,-16,45
Airdrieon,3116,7,11,11,14,46,58,-12,44
Forfar,3116,8,10,5,21,38,65,-27,35
Albion,3116,9,8,6,22,58,84,-26,30
Queen's Park,3116,10,6,10,20,39,76,-37,28
Raith,3117,1,23,8,5,71,32,39,77
Ayr,3117,2,23,4,9,93,46,47,73
Arbroath,3117,3,17,9,10,74,52,22,60
Alloa,3117,4,17,8,11,56,46,10,59
Stranraer,3117,5,15,5,16,55,65,-10,50
East Fife,3117,6,14,3,19,48,64,-16,45
Airdrieon,3117,7,11,11,14,47,58,-11,44
Forfar,3117,8,10,5,21,38,66,-28,35
Albion,3117,9,9,6,21,61,81,-20,33
Queen's Park,3117,10,6,11,19,43,76,-33,29
Ayr,3118,1,24,4,8,94,44,50,76
Raith,3118,2,22,8,6,70,35,35,74
Arbroath,3118,3,18,8,10,72,48,24,62
Alloa,3118,4,18,8,10,59,45,14,62
Stranraer,3118,5,16,5,15,58,66,-8,53
East Fife,3118,6,13,3,20,49,67,-18,42
Airdrieon,3118,7,10,11,15,45,59,-14,41
Forfar,3118,8,11,5,20,39,64,-25,38
Albion,3118,9,8,6,22,59,82,-23,30
Queen's Park,3118,10,6,10,20,39,74,-35,28
Ayr,3119,1,24,4,8,92,43,49,76
Raith,3119,2,22,8,6,69,35,34,74
Alloa,3119,3,18,8,10,59,44,15,62
Arbroath,3119,4,17,8,11,71,50,21,59
Stranraer,3119,5,15,5,16,56,69,-13,50
East Fife,3119,6,14,3,19,52,65,-13,45
Airdrieon,3119,7,11,11,14,47,59,-12,44
Forfar,3119,8,10,5,21,39,66,-27,35
Queen's Park,3119,9,7,10,19,41,73,-32,31
Albion,3119,10,8,6,22,58,80,-22,30
Ayr,3120,1,24,4,8,94,45,49,76
Raith,3120,2,22,8,6,68,33,35,74
Arbroath,3120,3,18,8,10,74,51,23,62
Alloa,3120,4,18,8,10,57,43,14,62
Stranraer,3120,5,16,5,15,59,66,-7,53
East Fife,3120,6,13,3,20,49,68,-19,42
Airdrieon,3120,7,10,11,15,47,61,-14,41
Forfar,3120,8,11,5,20,41,66,-25,38
Albion,3120,9,8,6,22,60,82,-22,30
Queen's Park,3120,10,6,10,20,42,76,-34,28
Raith,3121,1,23,8,5,70,33,37,77
Ayr,3121,2,24,4,8,94,43,51,76
Arbroath,3121,3,17,9,10,71,49,22,60
Alloa,3121,4,17,8,11,57,45,12,59
Stranraer,3121,5,16,5,15,57,65,-8,53
East Fife,3121,6,13,3,20,48,66,-18,42
Airdrieon,3121,7,10,11,15,46,60,-14,41
Forfar,3121,8,11,5,20,40,65,-25,38
Albion,3121,9,8,6,22,58,82,-24,30
Queen's Park,3121,10,6,11,19,40,73,-33,29
Raith,3122,1,23,8,5,72,32,40,77
Ayr,3122,2,24,4,8,91,42,49,76
Arbroath,3122,3,18,8,10,71,48,23,62
Alloa,3122,4,17,8,11,56,47,9,59
Stranraer,3122,5,16,5,15,56,64,-8,53
Airdrieon,3122,6,11,11,14,46,58,-12,44
East Fife,3122,7,13,3,20,47,65,-18,42
Forfar,3122,8,10,5,21,38,65,-27,35
Albion,3122,9,8,6,22,57,79,-22,30
Queen's Park,3122,10,6,10,20,39,73,-34,28
Ayr,3123,1,24,4,8,96,43,53,76
Raith,3123,2,22,8,6,69,35,34,74
Alloa,3123,3,18,8,10,59,44,15,62
Arbroath,3123,4,17,9,10,74,52,22,60
Stranraer,3123,5,16,5,15,59,66,-7,53
Airdrieon,3123,6,11,11,14,46,58,-12,44
East Fife,3123,7,13,3,20,49,68,-19,42
Forfar,3123,8,10,5,21,38,65,-27,35
Albion,3123,9,8,6,22,58,84,-26,30
Queen's Park,3123,10,6,11,19,43,76,-33,29
Raith,3124,1,23,8,5,72,32,40,77
Ayr,3124,2,24,4,8,92,42,50,76
Arbroath,3124,3,18,8,10,74,51,23,62
Alloa,3124,4,17,8,11,56,47,9,59
Stranraer,3124,5,15,6,15,56,65,-9,51
Airdrieon,3124,6,11,11,14,46,58,-12,44
East Fife,3124,7,13,4,19,48,65,-17,43
Forfar,3124,8,10,5,21,38,65,-27,35
Albion,3124,9,8,6,22,57,80,-23,30
Queen's Park,3124,10,6,10,20,42,76,-34,28
Raith,3125,1,23,8,5,71,32,39,77
Ayr,3125,2,24,4,8,94,42,52,76
Arbroath,3125,3,18,8,10,72,49,23,62
Alloa,3125,4,17,8,11,56,46,10,59
Stranraer,3125,5,15,5,16,56,66,-10,50
East Fife,3125,6,14,3,19,49,65,-16,45
Airdrieon,3125,7,10,11,15,45,60,-15,41
Forfar,3125,8,11,5,20,40,64,-24,38
Albion,3125,9,8,6,22,57,82,-25,30
Queen's Park,3125,10,6,10,20,40,74,-34,28
Ayr,3126,1,24,4,8,93,44,49,76
Raith,3126,2,22,9,5,71,35,36,75
Alloa,3126,3,17,9,10,59,46,13,60
Arbroath,3126,4,17,8,11,71,52,19,59
Stranraer,3126,5,16,5,15,57,65,-8,53
Airdrieon,3126,6,11,11,14,47,59,-12,44
East Fife,3126,7,13,3,20,48,66,-18,42
Forfar,3126,8,10,5,21,39,66,-27,35
Queen's Park,3126,9,7,10,19,43,73,-30,31
Albion,3126,10,8,6,22,59,81,-22,30
Raith,3127,1,23,8,5,69,32,37,77
Ayr,3127,2,24,4,8,92,43,49,76
Arbroath,3127,3,18,8,10,74,49,25,62
Alloa,3127,4,17,8,11,56,44,12,59
Stranraer,3127,5,15,6,15,56,65,-9,51
Airdrieon,3127,6,11,11,14,47,59,-12,44
East Fife,3127,7,13,4,19,48,65,-17,43
Forfar,3127,8,10,5,21,39,66,-27,35
Albion,3127,9,8,6,22,58,80,-22,30
Queen's Park,3127,10,6,10,20,40,76,-36,28
Ayr,3128,1,24,4,8,97,43,54,76
Raith,3128,2,22,8,6,68,33,35,74
Arbroath,3128,3,18,8,10,73,48,25,62
Alloa,3128,4,18,8,10,57,43,14,62
Stranraer,3128,5,15,5,16,55,66,-11,50
East Fife,3128,6,14,3,19,49,64,-15,45
Airdrieon,3128,7,11,11,14,46,58,-12,44
Forfar,3128,8,10,5,21,38,65,-27,35
Albion,3128,9,8,6,22,58,85,-27,30
Queen's Park,3128,10,6,10,20,39,75,-36,28
Raith,3129,1,23,8,5,69,32,37,77
Ayr,3129,2,24,4,8,93,42,51,76
Arbroath,3129,3,17,9,10,70,48,22,60
Alloa,3129,4,17,8,11,56,44,12,59
Stranraer,3129,5,16,5,15,56,64,-8,53
Airdrieon,3129,6,11,11,14,48,59,-11,44
East Fife,3129,7,13,3,20,47,65,-18,42
Forfar,3129,8,10,5,21,39,67,-28,35
Albion,3129,9,8,6,22,57,81,-24,30
Queen's Park,3129,10,6,11,19,39,72,-33,29
Raith,3130,1,23,8,5,70,32,38,77
Ayr,3130,2,24,4,8,95,45,50,76
Arbroath,3130,3,17,8,11,72,51,21,59
Alloa,3130,4,17,8,11,56,45,11,59
Stranraer,3130,5,16,5,15,58,65,-7,53
Airdrieon,3130,6,11,11,14,47,58,-11,44
East Fife,3130,7,13,3,20,48,67,-19,42
Forfar,3130,8,10,5,21,38,66,-28,35
Queen's Park,3130,9,7,10,19,42,74,-32,31
Albion,3130,10,8,6,22,60,83,-23,30
Ayr,3131,1,24,4,8,93,43,50,76
Raith,3131,2,22,9,5,70,34,36,75
Arbroath,3131,3,17,9,10,72,50,22,60
Alloa,3131,4,17,9,10,58,45,13,60
Stranraer,3131,5,15,6,15,56,65,-9,51
Airdrieon,3131,6,11,11,14,47,59,-12,44
East Fife,3131,7,13,4,19,48,65,-17,43
Forfar,3131,8,10,5,21,39,66,-27,35
Albion,3131,9,8,6,22,58,81,-23,30
Queen's Park,3131,10,6,11,19,41,74,-33,29
Ayr,3132,1,24,4,8,93,44,49,76
Raith,3132,2,22,9,5,69,33,36,75
Alloa,3132,3,17,9,10,57,44,13,60
Arbroath,3132,4,17,8,11,71,50,21,59
Stranraer,3132,5,15,6,15,57,66,-9,51
Airdrieon,3132,6,11,11,14,47,59,-12,44
East Fife,3132,7,13,4,19,49,66,-17,43
Forfar,3132,8,10,5,21,39,66,-27,35
Queen's Park,3132,9,7,10,19,41,73,-32,31
Albion,3132,10,8,6,22,59,81,-22,30
Ayr,3133,1,23,5,8,92,44,48,74
Raith,3133,2,22,8,6,68,33,35,74
Alloa,3133,3,18,8,10,57,43,14,62
Arbroath,3133,4,17,8,11,71,50,21,59
Stranraer,3133,5,15,6,15,57,66,-9,51
East Fife,3133,6,13,4,19,49,66,-17,43
Airdrieon,3133,7,10,12,14,45,58,-13,42
Forfar,3133,8,10,6,20,38,64,-26,36
Albion,3133,9,8,7,21,59,80,-21,31
Queen's Park,3133,10,7,10,19,41,73,-32,31
Raith,3134,1,22,8,6,68,33,35,74
Ayr,3134,2,23,4,9,90,44,46,73
Arbroath,3134,3,18,8,10,74,50,24,62
Alloa,3134,4,18,8,10,57,43,14,62
Stranraer,3134,5,15,6,15,56,65,-9,51
Airdrieon,3134,6,11,11,14,47,59,-12,44
East Fife,3134,7,13,4,19,48,65,-17,43
Forfar,3134,8,10,5,21,39,66,-27,35
Albion,3134,9,9,6,21,59,78,-19,33
Queen's Park,3134,10,6,10,20,41,76,-35,28
Ayr,3135,1,23,5,8,90,42,48,74
Raith,3135,2,22,8,6,69,34,35,74
Arbroath,3135,3,18,8,10,72,49,23,62
Alloa,3135,4,18,8,10,58,44,14,62
Stranraer,3135,5,15,5,16,56,67,-11,50
East Fife,3135,6,14,3,19,50,65,-15,45
Airdrieon,3135,7,11,11,14,47,58,-11,44
Forfar,3135,8,10,5,21,38,66,-28,35
Albion,3135,9,8,7,21,57,78,-21,31
Queen's Park,3135,10,6,10,20,40,74,-34,28
Ayr,3136,1,24,4,8,93,43,50,76
Raith,3136,2,22,9,5,69,33,36,75
Arbroath,3136,3,17,9,10,71,49,22,60
Alloa,3136,4,17,9,10,57,44,13,60
Stranraer,3136,5,15,6,15,57,66,-9,51
East Fife,3136,6,13,4,19,49,66,-17,43
Airdrieon,3136,7,10,11,15,47,61,-14,41
Forfar,3136,8,11,5,20,41,66,-25,38
Albion,3136,9,8,6,22,58,81,-23,30
Queen's Park,3136,10,6,11,19,40,73,-33,29
Ayr,3137,1,24,4,8,95,44,51,76
Raith,3137,2,22,9,5,70,34,36,75
Alloa,3137,3,17,9,10,58,45,13,60
Arbroath,3137,4,17,8,11,70,51,19,59
Stranraer,3137,5,16,5,15,58,66,-8,53
Airdrieon,3137,6,11,11,14,49,59,-10,44
East Fife,3137,7,13,3,20,49,67,-18,42
Forfar,3137,8,10,5,21,39,68,-29,35
Queen's Park,3137,9,7,10,19,42,72,-30,31
Albion,3137,10,8,6,22,59,83,-24,30
Raith,3138,1,22,8,6,68,33,35,74
Ayr,3138,2,23,4,9,90,43,47,73
Alloa,3138,3,18,8,10,57,43,14,62
Arbroath,3138,4,17,9,10,70,48,22,60
Stranraer,3138,5,15,5,16,56,66,-10,50
East Fife,3138,6,14,3,19,49,65,-16,45
Airdrieon,3138,7,10,11,15,45,59,-14,41
Forfar,3138,8,11,5,20,39,64,-25,38
Albion,3138,9,9,6,21,58,78,-20,33
Queen's Park,3138,10,6,11,19,39,72,-33,29
Ayr,3139,1,24,4,8,93,42,51,76
Raith,3139,2,22,8,6,68,33,35,74
Arbroath,3139,3,18,8,10,74,50,24,62
Alloa,3139,4,18,8,10,57,43,14,62
Stranraer,3139,5,15,5,16,55,67,-12,50
East Fife,3139,6,14,3,19,50,64,-14,45
Airdrieon,3139,7,11,11,14,47,59,-12,44
Forfar,3139,8,10,5,21,39,66,-27,35
Albion,3139,9,8,6,22,57,81,-24,30
Queen's Park,3139,10,6,10,20,41,76,-35,28
Raith,3140,1,23,8,5,70,32,38,77
Ayr,3140,2,24,4,8,94,42,52,76
Arbroath,3140,3,18,8,10,72,49,23,62
Alloa,3140,4,17,8,11,56,45,11,59
Stranraer,3140,5,15,5,16,55,66,-11,50
East Fife,3140,6,14,3,19,49,64,-15,45
Airdrieon,3140,7,11,11,14,47,58,-11,44
Forfar,3140,8,10,5,21,38,66,-28,35
Albion,3140,9,8,6,22,57,82,-25,30
Queen's Park,3140,10,6,10,20,40,74,-34,28
Ayr,3141,1,24,4,8,95,46,49,76
Raith,3141,2,22,9,5,71,35,36,75
Arbroath,3141,3,18,8,10,74,49,25,62
Alloa,3141,4,17,9,10,59,46,13,60
Stranraer,3141,5,15,5,16,56,66,-10,50
East Fife,3141,6,14,3,19,49,65,-16,45
Airdrieon,3141,7,11,11,14,47,58,-11,44
Forfar,3141,8,10,5,21,38,66,-28,35
Albion,3141,9,8,6,22,61,83,-22,30
Queen's Park,3141,10,6,10,20,40,76,-36,28
Ayr,3142,1,24,4,8,92,43,49,76
Raith,3142,2,22,8,6,68,33,35,74
Alloa,3142,3,18,8,10,57,43,14,62
Arbroath,3142,4,17,8,11,70,49,21,59
Stranraer,3142,5,16,5,15,59,66,-7,53
Airdrieon,3142,6,10,12,14,46,59,-13,42
East Fife,3142,7,13,3,20,49,68,-19,42
Forfar,3142,8,10,6,20,39,65,-26,36
Queen's Park,3142,9,7,10,19,40,72,-32,31
Albion,3142,10,8,6,22,58,80,-22,30
Raith,3143,1,22,9,5,68,32,36,75
Ayr,3143,2,23,5,8,91,43,48,74
Arbroath,3143,3,17,9,10,70,48,22,60
Alloa,3143,4,17,9,10,56,43,13,60
Stranraer,3143,5,15,5,16,57,68,-11,50
East Fife,3143,6,14,3,19,51,66,-15,45
Airdrieon,3143,7,11,11,14,46,58,-12,44
Forfar,3143,8,10,5,21,38,65,-27,35
Albion,3143,9,8,7,21,58,79,-21,31
Queen's Park,3143,10,6,11,19,39,72,-33,29
Ayr,3144,1,24,4,8,93,42,51,76
Raith,3144,2,22,8,6,68,33,35,74
Arbroath,3144,3,18,8,10,75,48,27,62
Alloa,3144,4,18,8,10,57,43,14,62
Stranraer,3144,5,16,5,15,57,65,-8,53
Airdrieon,3144,6,11,11,14,46,58,-12,44
East Fife,3144,7,13,3,20,48,66,-18,42
Forfar,3144,8,10,5,21,38,65,-27,35
Albion,3144,9,8,6,22,57,81,-24,30
Queen's Park,3144,10,6,10,20,39,77,-38,28
Ayr,3145,1,24,4,8,95,44,51,76
Raith,3145,2,22,8,6,68,33,35,74
Arbroath,3145,3,18,8,10,73,48,25,62
Alloa,3145,4,18,8,10,57,43,14,62
Stranraer,3145,5,15,5,16,55,67,-12,50
East Fife,3145,6,14,3,19,50,64,-14,45
Airdrieon,3145,7,11,11,14,46,58,-12,44
Forfar,3145,8,10,5,21,38,65,-27,35
Albion,3145,9,8,6,22,59,83,-24,30
Queen's Park,3145,10,6,10,20,39,75,-36,28
Raith,3146,1,23,8,5,71,33,38,77
Ayr,3146,2,24,4,8,98,43,55,76
Arbroath,3146,3,17,8,11,70,49,21,59
Alloa,3146,4,17,8,11,57,46,11,59
Stranraer,3146,5,15,6,15,57,66,-9,51
Airdrieon,3146,6,11,11,14,46,58,-12,44
East Fife,3146,7,13,4,19,49,66,-17,43
Forfar,3146,8,10,5,21,38,65,-27,35
Queen's Park,3146,9,7,10,19,40,72,-32,31
Albion,3146,10,8,6,22,58,86,-28,30
Ayr,3147,1,24,4,8,94,43,51,76
Raith,3147,2,22,8,6,68,33,35,74
Alloa,3147,3,18,8,10,57,43,14,62
Arbroath,3147,4,17,8,11,73,52,21,59
Stranraer,3147,5,15,5,16,56,66,-10,50
East Fife,3147,6,14,3,19,49,65,-16,45
Airdrieon,3147,7,11,11,14,47,59,-12,44
Forfar,3147,8,10,5,21,39,66,-27,35
Queen's Park,3147,9,7,10,19,43,75,-32,31
Albion,3147,10,8,6,22,58,82,-24,30
Ayr,3148,1,24,4,8,94,45,49,76
Raith,3148,2,22,8,6,69,34,35,74
Arbroath,3148,3,18,8,10,72,49,23,62
Alloa,3148,4,18,8,10,58,44,14,62
Stranraer,3148,5,16,5,15,56,64,-8,53
Airdrieon,3148,6,11,11,14,47,58,-11,44
East Fife,3148,7,13,3,20,47,65,-18,42
Forfar,3148,8,10,5,21,38,66,-28,35
Albion,3148,9,8,6,22,60,82,-22,30
Queen's Park,3148,10,6,10,20,40,74,-34,28
Raith,3149,1,23,8,5,69,32,37,77
Ayr,3149,2,24,4,8,95,44,51,76
Arbroath,3149,3,18,8,10,73,49,24,62
Alloa,3149,4,17,8,11,56,44,12,59
Stranraer,3149,5,15,6,15,55,64,-9,51
Airdrieon,3149,6,11,11,14,48,59,-11,44
East Fife,3149,7,13,4,19,47,64,-17,43
Forfar,3149,8,10,5,21,39,67,-28,35
Albion,3149,9,8,6,22,59,83,-24,30
Queen's Park,3149,10,6,10,20,40,75,-35,28
Raith,3150,1,23,8,5,70,32,38,77
Ayr,3150,2,24,4,8,95,43,52,76
Arbroath,3150,3,17,8,11,71,51,20,59
Alloa,3150,4,17,8,11,56,45,11,59
Stranraer,3150,5,15,6,15,56,65,-9,51
East Fife,3150,6,13,4,19,48,65,-17,43
Airdrieon,3150,7,10,12,14,46,59,-13,42
Forfar,3150,8,10,6,20,39,65,-26,36
Queen's Park,3150,9,7,10,19,42,73,-31,31
Albion,3150,10,8,6,22,58,83,-25,30
Raith,3151,1,23,8,5,72,32,40,77
Ayr,3151,2,24,4,8,94,43,51,76
Arbroath,3151,3,17,8,11,71,50,21,59
Alloa,3151,4,17,8,11,56,47,9,59
Stranraer,3151,5,15,5,16,56,67,-11,50
East Fife,3151,6,14,3,19,50,65,-15,45
Airdrieon,3151,7,10,11,15,45,59,-14,41
Forfar,3151,8,11,5,20,39,64,-25,38
Queen's Park,3151,9,7,10,19,41,73,-32,31
Albion,3151,10,8,6,22,58,82,-24,30
Raith,3152,1,23,8,5,73,33,40,77
Ayr,3152,2,24,4,8,91,42,49,76
Arbroath,3152,3,18,8,10,74,49,25,62
Alloa,3152,4,17,8,11,57,48,9,59
Stranraer,3152,5,16,5,15,56,64,-8,53
Airdrieon,3152,6,11,11,14,48,60,-12,44
East Fife,3152,7,13,3,20,47,65,-18,42
Forfar,3152,8,10,5,21,40,67,-27,35
Albion,3152,9,8,6,22,57,79,-22,30
Queen's Park,3152,10,6,10,20,40,76,-36,28
Raith,3153,1,23,8,5,71,32,39,77
Ayr,3153,2,23,5,8,91,43,48,74
Arbroath,3153,3,18,8,10,71,48,23,62
Alloa,3153,4,17,8,11,56,46,10,59
Stranraer,3153,5,15,6,15,57,66,-9,51
Airdrieon,3153,6,11,11,14,48,59,-11,44
East Fife,3153,7,13,4,19,49,66,-17,43
Forfar,3153,8,10,5,21,39,67,-28,35
Albion,3153,9,8,7,21,58,79,-21,31
Queen's Park,3153,10,6,10,20,39,73,-34,28
Raith,3154,1,23,8,5,69,32,37,77
Ayr,3154,2,24,4,8,96,44,52,76
Arbroath,3154,3,18,8,10,73,50,23,62
Alloa,3154,4,17,8,11,56,44,12,59
Stranraer,3154,5,15,6,15,57,66,-9,51
Airdrieon,3154,6,11,11,14,49,59,-10,44
East Fife,3154,7,13,4,19,49,66,-17,43
Forfar,3154,8,10,5,21,39,68,-29,35
Albion,3154,9,8,6,22,59,84,-25,30
Queen's Park,3154,10,6,10,20,41,75,-34,28
Raith,3155,1,23,8,5,71,32,39,77
Ayr,3155,2,24,4,8,94,43,51,76
Arbroath,3155,3,17,8,11,71,50,21,59
Alloa,3155,4,17,8,11,56,46,10,59
Stranraer,3155,5,16,5,15,56,64,-8,53
Airdrieon,3155,6,11,11,14,46,58,-12,44
East Fife,3155,7,13,3,20,47,65,-18,42
Forfar,3155,8,10,5,21,38,65,-27,35
Queen's Park,3155,9,7,10,19,41,73,-32,31
Albion,3155,10,8,6,22,58,82,-24,30
Raith,3156,1,23,8,5,70,33,37,77
Ayr,3156,2,24,4,8,92,43,49,76
Arbroath,3156,3,18,8,10,71,48,23,62
Alloa,3156,4,17,8,11,57,45,12,59
Stranraer,3156,5,15,5,16,58,68,-10,50
East Fife,3156,6,14,3,19,51,67,-16,45
Airdrieon,3156,7,11,11,14,46,58,-12,44
Forfar,3156,8,10,5,21,38,65,-27,35
Albion,3156,9,8,6,22,58,80,-22,30
Queen's Park,3156,10,6,10,20,39,73,-34,28
Raith,3157,1,23,8,5,70,32,38,77
Ayr,3157,2,24,4,8,92,43,49,76
Arbroath,3157,3,18,8,10,74,49,25,62
Alloa,3157,4,17,8,11,56,45,11,59
Stranraer,3157,5,15,5,16,55,67,-12,50
East Fife,3157,6,14,3,19,50,64,-14,45
Airdrieon,3157,7,11,11,14,51,58,-7,44
Forfar,3157,8,10,5,21,38,70,-32,35
Albion,3157,9,8,6,22,58,80,-22,30
Queen's Park,3157,10,6,10,20,40,76,-36,28
Ayr,3158,1,24,4,8,95,44,51,76
Raith,3158,2,22,9,5,69,33,36,75
Arbroath,3158,3,17,9,10,70,48,22,60
Alloa,3158,4,17,9,10,57,44,13,60
Stranraer,3158,5,15,5,16,55,65,-10,50
East Fife,3158,6,14,3,19,48,64,-16,45
Airdrieon,3158,7,11,11,14,46,58,-12,44
Forfar,3158,8,10,5,21,38,65,-27,35
Albion,3158,9,8,6,22,59,83,-24,30
Queen's Park,3158,10,6,11,19,39,72,-33,29
Raith,3159,1,22,9,5,68,32,36,75
Ayr,3159,2,23,4,9,91,44,47,73
Alloa,3159,3,17,9,10,56,43,13,60
Arbroath,3159,4,17,8,11,70,50,20,59
Stranraer,3159,5,16,5,15,57,65,-8,53
Airdrieon,3159,6,11,11,14,46,58,-12,44
East Fife,3159,7,13,3,20,48,66,-18,42
Forfar,3159,8,10,5,21,38,65,-27,35
Albion,3159,9,9,6,21,59,79,-20,33
Queen's Park,3159,10,7,10,19,41,72,-31,31
Raith,3160,1,23,8,5,69,32,37,77
Ayr,3160,2,23,4,9,90,43,47,73
Arbroath,3160,3,17,8,11,71,50,21,59
Alloa,3160,4,17,8,11,56,44,12,59
Stranraer,3160,5,15,6,15,56,65,-9,51
East Fife,3160,6,13,4,19,48,65,-17,43
Airdrieon,3160,7,10,11,15,45,59,-14,41
Forfar,3160,8,11,5,20,39,64,-25,38
Albion,3160,9,9,6,21,58,78,-20,33
Queen's Park,3160,10,7,10,19,41,73,-32,31
Raith,3161,1,23,8,5,72,33,39,77
Ayr,3161,2,24,4,8,94,43,51,76
Arbroath,3161,3,18,8,10,73,49,24,62
Alloa,3161,4,17,8,11,57,47,10,59
Stranraer,3161,5,15,5,16,55,66,-11,50
East Fife,3161,6,14,3,19,49,64,-15,45
Airdrieon,3161,7,10,12,14,46,59,-13,42
Forfar,3161,8,10,6,20,39,65,-26,36
Albion,3161,9,8,6,22,58,82,-24,30
Queen's Park,3161,10,6,10,20,40,75,-35,28
Ayr,3162,1,24,4,8,95,43,52,76
Raith,3162,2,22,8,6,68,33,35,74
Arbroath,3162,3,18,8,10,74,51,23,62
Alloa,3162,4,18,8,10,57,43,14,62
Stranraer,3162,5,15,5,16,55,65,-10,50
East Fife,3162,6,14,3,19,48,64,-16,45
Airdrieon,3162,7,10,11,15,45,60,-15,41
Forfar,3162,8,11,5,20,40,64,-24,38
Albion,3162,9,8,6,22,58,83,-25,30
Queen's Park,3162,10,6,10,20,42,76,-34,28
Raith,3163,1,23,8,5,69,32,37,77
Ayr,3163,2,24,4,8,92,42,50,76
Arbroath,3163,3,18,8,10,73,49,24,62
Alloa,3163,4,17,8,11,56,44,12,59
Stranraer,3163,5,15,5,16,57,67,-10,50
East Fife,3163,6,14,3,19,50,66,-16,45
Airdrieon,3163,7,10,12,14,47,60,-13,42
Forfar,3163,8,10,6,20,40,66,-26,36
Albion,3163,9,8,6,22,57,80,-23,30
Queen's Park,3163,10,6,10,20,40,75,-35,28
Raith,3164,1,23,8,5,70,33,37,77
Ayr,3164,2,23,5,8,93,45,48,74
Arbroath,3164,3,18,8,10,75,49,26,62
Alloa,3164,4,17,8,11,57,45,12,59
Stranraer,3164,5,16,5,15,56,64,-8,53
Airdrieon,3164,6,10,12,14,46,59,-13,42
East Fife,3164,7,13,3,20,47,65,-18,42
Forfar,3164,8,10,6,20,39,65,-26,36
Albion,3164,9,8,7,21,60,81,-21,31
Queen's Park,3164,10,6,10,20,40,77,-37,28
Ayr,3165,1,24,4,8,91,42,49,76
Raith,3165,2,22,8,6,70,35,35,74
Arbroath,3165,3,18,8,10,75,50,25,62
Alloa,3165,4,18,8,10,59,45,14,62
Stranraer,3165,5,15,5,16,55,67,-12,50
East Fife,3165,6,14,3,19,50,64,-14,45
Airdrieon,3165,7,11,11,14,49,59,-10,44
Forfar,3165,8,10,5,21,39,68,-29,35
Albion,3165,9,8,6,22,57,79,-22,30
Queen's Park,3165,10,6,10,20,41,77,-36,28
Raith,3166,1,23,8,5,71,32,39,77
Ayr,3166,2,24,4,8,95,43,52,76
Arbroath,3166,3,17,8,11,73,52,21,59
Alloa,3166,4,17,8,11,56,46,10,59
Stranraer,3166,5,15,6,15,57,66,-9,51
Airdrieon,3166,6,11,11,14,48,59,-11,44
East Fife,3166,7,13,4,19,49,66,-17,43
Forfar,3166,8,10,5,21,39,67,-28,35
Queen's Park,3166,9,7,10,19,43,75,-32,31
Albion,3166,10,8,6,22,58,83,-25,30
Ayr,3167,1,23,5,8,92,44,48,74
Raith,3167,2,22,8,6,69,34,35,74
Alloa,3167,3,18,8,10,58,44,14,62
Arbroath,3167,4,17,9,10,72,50,22,60
Stranraer,3167,5,15,5,16,55,67,-12,50
East Fife,3167,6,14,3,19,50,64,-14,45
Airdrieon,3167,7,11,11,14,48,60,-12,44
Forfar,3167,8,10,5,21,40,67,-27,35
Albion,3167,9,8,7,21,59,80,-21,31
Queen's Park,3167,10,6,11,19,41,74,-33,29
Raith,3168,1,23,8,5,70,32,38,77
Ayr,3168,2,24,4,8,92,42,50,76
Arbroath,3168,3,17,8,11,70,50,20,59
Alloa,3168,4,17,8,11,56,45,11,59
Stranraer,3168,5,16,5,15,57,64,-7,53
Airdrieon,3168,6,11,11,14,47,59,-12,44
East Fife,3168,7,13,3,20,47,66,-19,42
Forfar,3168,8,10,5,21,39,66,-27,35
Queen's Park,3168,9,7,10,19,41,72,-31,31
Albion,3168,10,8,6,22,57,80,-23,30
Raith,3169,1,23,8,5,70,32,38,77
Ayr,3169,2,24,4,8,93,43,50,76
Arbroath,3169,3,18,8,10,72,48,24,62
Alloa,3169,4,17,8,11,56,45,11,59
Stranraer,3169,5,16,5,15,56,64,-8,53
East Fife,3169,6,13,3,20,47,65,-18,42
Airdrieon,3169,7,10,11,15,46,60,-14,41
Forfar,3169,8,11,5,20,40,65,-25,38
Albion,3169,9,8,6,22,58,81,-23,30
Queen's Park,3169,10,6,10,20,39,74,-35,28
Raith,3170,1,22,8,6,68,33,35,74
Ayr,3170,2,23,4,9,90,44,46,73
Arbroath,3170,3,18,8,10,71,48,23,62
Alloa,3170,4,18,8,10,57,43,14,62
Stranraer,3170,5,15,5,16,55,66,-11,50
East Fife,3170,6,14,3,19,49,64,-15,45
Airdrieon,3170,7,11,11,14,46,58,-12,44
Forfar,3170,8,10,5,21,38,65,-27,35
Albion,3170,9,9,6,21,59,78,-19,33
Queen's Park,3170,10,6,10,20,39,73,-34,28
Raith,3171,1,23,8,5,71,32,39,77
Ayr,3171,2,24,4,8,95,45,50,76
Arbroath,3171,3,18,8,10,73,48,25,62
Alloa,3171,4,17,8,11,56,46,10,59
Stranraer,3171,5,16,5,15,57,65,-8,53
Airdrieon,3171,6,11,11,14,47,58,-11,44
East Fife,3171,7,13,3,20,48,66,-18,42
Forfar,3171,8,10,5,21,38,66,-28,35
Albion,3171,9,8,6,22,60,83,-23,30
Queen's Park,3171,10,6,10,20,39,75,-36,28
Ayr,3172,1,24,4,8,93,42,51,76
Raith,3172,2,22,8,6,71,36,35,74
Arbroath,3172,3,18,8,10,72,48,24,62
Alloa,3172,4,18,8,10,60,46,14,62
Stranraer,3172,5,16,5,15,58,64,-6,53
Airdrieon,3172,6,11,11,14,48,58,-10,44
East Fife,3172,7,13,3,20,47,67,-20,42
Forfar,3172,8,10,5,21,38,67,-29,35
Albion,3172,9,8,6,22,57,81,-24,30
Queen's Park,3172,10,6,10,20,39,74,-35,28
Raith,3173,1,23,8,5,73,35,38,77
Ayr,3173,2,24,4,8,92,43,49,76
Arbroath,3173,3,18,8,10,72,49,23,62
Alloa,3173,4,17,8,11,59,48,11,59
Stranraer,3173,5,16,5,15,56,64,-8,53
East Fife,3173,6,13,3,20,47,65,-18,42
Airdrieon,3173,7,10,11,15,45,59,-14,41
Forfar,3173,8,11,5,20,39,64,-25,38
Albion,3173,9,8,6,22,58,80,-22,30
Queen's Park,3173,10,6,10,20,40,74,-34,28
Raith,3174,1,23,8,5,73,33,40,77
Ayr,3174,2,23,5,8,93,45,48,74
Arbroath,3174,3,17,8,11,70,51,19,59
Alloa,3174,4,17,8,11,57,48,9,59
Stranraer,3174,5,15,6,15,56,65,-9,51
Airdrieon,3174,6,11,11,14,48,58,-10,44
East Fife,3174,7,13,4,19,48,65,-17,43
Forfar,3174,8,10,5,21,38,67,-29,35
Albion,3174,9,8,7,21,60,81,-21,31
Queen's Park,3174,10,7,10,19,42,72,-30,31
Ayr,3175,1,24,4,8,94,44,50,76
Raith,3175,2,22,9,5,68,32,36,75
Alloa,3175,3,17,9,10,56,43,13,60
Arbroath,3175,4,17,8,11,70,53,17,59
Stranraer,3175,5,15,5,16,56,67,-11,50
East Fife,3175,6,14,3,19,50,65,-15,45
Airdrieon,3175,7,11,11,14,47,59,-12,44
Forfar,3175,8,10,5,21,39,66,-27,35
Queen's Park,3175,9,7,10,19,44,72,-28,31
Albion,3175,10,8,6,22,59,82,-23,30
Raith,3176,1,23,8,5,72,32,40,77
Ayr,3176,2,24,4,8,96,44,52,76
Arbroath,3176,3,17,9,10,72,50,22,60
Alloa,3176,4,17,8,11,56,47,9,59
Stranraer,3176,5,15,5,16,55,67,-12,50
East Fife,3176,6,14,3,19,50,64,-14,45
Airdrieon,3176,7,10,12,14,47,60,-13,42
Forfar,3176,8,10,6,20,40,66,-26,36
Albion,3176,9,8,6,22,59,84,-25,30
Queen's Park,3176,10,6,11,19,41,74,-33,29
Ayr,3177,1,24,4,8,95,42,53,76
Raith,3177,2,22,8,6,69,34,35,74
Arbroath,3177,3,18,8,10,73,49,24,62
Alloa,3177,4,18,8,10,58,44,14,62
Stranraer,3177,5,15,5,16,55,65,-10,50
East Fife,3177,6,14,3,19,48,64,-16,45
Airdrieon,3177,7,10,11,15,46,60,-14,41
Forfar,3177,8,11,5,20,40,65,-25,38
Albion,3177,9,8,6,22,57,83,-26,30
Queen's Park,3177,10,6,10,20,40,75,-35,28
Ayr,3178,1,24,4,8,93,42,51,76
Raith,3178,2,22,9,5,69,33,36,75
Arbroath,3178,3,17,9,10,71,49,22,60
Alloa,3178,4,17,9,10,57,44,13,60
Stranraer,3178,5,15,5,16,56,67,-11,50
East Fife,3178,6,14,3,19,50,65,-15,45
Airdrieon,3178,7,11,11,14,46,58,-12,44
Forfar,3178,8,10,5,21,38,65,-27,35
Albion,3178,9,8,6,22,57,81,-24,30
Queen's Park,3178,10,6,11,19,40,73,-33,29
Raith,3179,1,23,8,5,71,32,39,77
Ayr,3179,2,24,4,8,97,43,54,76
Arbroath,3179,3,18,8,10,73,48,25,62
Alloa,3179,4,17,8,11,56,46,10,59
Stranraer,3179,5,16,5,15,57,65,-8,53
Airdrieon,3179,6,11,11,14,47,59,-12,44
East Fife,3179,7,13,3,20,48,66,-18,42
Forfar,3179,8,10,5,21,39,66,-27,35
Albion,3179,9,8,6,22,58,85,-27,30
Queen's Park,3179,10,6,10,20,39,75,-36,28
Raith,3180,1,23,8,5,70,33,37,77
Ayr,3180,2,24,4,8,94,43,51,76
Arbroath,3180,3,18,8,10,72,48,24,62
Alloa,3180,4,17,8,11,57,45,12,59
Stranraer,3180,5,15,5,16,56,67,-11,50
East Fife,3180,6,14,3,19,50,65,-15,45
Airdrieon,3180,7,10,11,15,46,61,-15,41
Forfar,3180,8,11,5,20,41,65,-24,38
Albion,3180,9,8,6,22,58,82,-24,30
Queen's Park,3180,10,6,10,20,39,74,-35,28
Ayr,3181,1,24,4,8,92,42,50,76
Raith,3181,2,22,9,5,68,32,36,75
Alloa,3181,3,17,9,10,56,43,13,60
Arbroath,3181,4,17,8,11,70,51,19,59
Stranraer,3181,5,15,5,16,56,66,-10,50
East Fife,3181,6,14,3,19,49,65,-16,45
Airdrieon,3181,7,11,11,14,47,58,-11,44
Forfar,3181,8,10,5,21,38,66,-28,35
Queen's Park,3181,9,7,10,19,42,72,-30,31
Albion,3181,10,8,6,22,57,80,-23,30
Raith,3182,1,23,8,5,70,33,37,77
Ayr,3182,2,24,4,8,93,43,50,76
Arbroath,3182,3,18,8,10,72,48,24,62
Alloa,3182,4,17,8,11,57,45,12,59
Stranraer,3182,5,15,6,15,55,64,-9,51
East Fife,3182,6,13,4,19,47,64,-17,43
Airdrieon,3182,7,10,12,14,45,58,-13,42
Forfar,3182,8,10,6,20,38,64,-26,36
Albion,3182,9,8,6,22,58,81,-23,30
Queen's Park,3182,10,6,10,20,39,74,-35,28
Raith,3183,1,23,8,5,72,33,39,77
Ayr,3183,2,24,4,8,93,44,49,76
Arbroath,3183,3,17,8,11,71,50,21,59
Alloa,3183,4,17,8,11,57,47,10,59
Stranraer,3183,5,15,5,16,55,66,-11,50
East Fife,3183,6,14,3,19,49,64,-15,45
Airdrieon,3183,7,10,11,15,45,62,-17,41
Forfar,3183,8,11,5,20,42,64,-22,38
Queen's Park,3183,9,7,10,19,41,73,-32,31
Albion,3183,10,8,6,22,59,81,-22,30
Ayr,3184,1,24,4,8,92,43,49,76
Raith,3184,2,22,8,6,68,35,33,74
Alloa,3184,3,18,8,10,59,43,16,62
Arbroath,3184,4,17,8,11,71,50,21,59
Stranraer,3184,5,16,5,15,57,64,-7,53
Airdrieon,3184,6,10,12,14,46,59,-13,42
East Fife,3184,7,13,3,20,47,66,-19,42
Forfar,3184,8,10,6,20,39,65,-26,36
Queen's Park,3184,9,7,10,19,41,73,-32,31
Albion,3184,10,8,6,22,58,80,-22,30
Ayr,3185,1,24,4,8,95,45,50,76
Raith,3185,2,22,9,5,71,35,36,75
Arbroath,3185,3,17,9,10,70,48,22,60
Alloa,3185,4,17,9,10,59,46,13,60
Stranraer,3185,5,16,5,15,58,65,-7,53
East Fife,3185,6,13,3,20,48,67,-19,42
Airdrieon,3185,7,10,11,15,46,60,-14,41
Forfar,3185,8,11,5,20,40,65,-25,38
Albion,3185,9,8,6,22,60,83,-23,30
Queen's Park,3185,10,6,11,19,39,72,-33,29
Raith,3186,1,22,9,5,69,33,36,75
Ayr,3186,2,23,5,8,93,45,48,74
Arbroath,3186,3,17,9,10,72,50,22,60
Alloa,3186,4,17,9,10,57,44,13,60
Stranraer,3186,5,15,5,16,55,65,-10,50
East Fife,3186,6,14,3,19,48,64,-16,45
Airdrieon,3186,7,11,11,14,49,59,-10,44
Forfar,3186,8,10,5,21,39,68,-29,35
Albion,3186,9,8,7,21,60,81,-21,31
Queen's Park,3186,10,6,11,19,41,74,-33,29
Raith,3187,1,23,8,5,71,33,38,77
Ayr,3187,2,23,4,9,91,44,47,73
Arbroath,3187,3,17,8,11,70,49,21,59
Alloa,3187,4,17,8,11,57,46,11,59
Stranraer,3187,5,15,5,16,56,67,-11,50
East Fife,3187,6,14,3,19,50,65,-15,45
Airdrieon,3187,7,11,11,14,49,60,-11,44
Forfar,3187,8,10,5,21,40,68,-28,35
Albion,3187,9,9,6,21,59,79,-20,33
Queen's Park,3187,10,7,10,19,40,72,-32,31
Raith,3188,1,22,9,5,68,32,36,75
Ayr,3188,2,23,5,8,92,44,48,74
Arbroath,3188,3,17,9,10,70,48,22,60
Alloa,3188,4,17,9,10,56,43,13,60
Stranraer,3188,5,15,5,16,55,67,-12,50
East Fife,3188,6,14,3,19,50,64,-14,45
Airdrieon,3188,7,11,11,14,47,59,-12,44
Forfar,3188,8,10,5,21,39,66,-27,35
Albion,3188,9,8,7,21,59,80,-21,31
Queen's Park,3188,10,6,11,19,39,72,-33,29
Raith,3189,1,23,8,5,71,33,38,77
Ayr,3189,2,24,4,8,92,43,49,76
Arbroath,3189,3,18,8,10,74,49,25,62
Alloa,3189,4,17,8,11,57,46,11,59
Stranraer,3189,5,16,5,15,56,64,-8,53
Airdrieon,3189,6,11,11,14,48,59,-11,44
East Fife,3189,7,13,3,20,47,65,-18,42
Forfar,3189,8,10,5,21,39,67,-28,35
Albion,3189,9,8,6,22,58,80,-22,30
Queen's Park,3189,10,6,10,20,40,76,-36,28
Raith,3190,1,23,8,5,70,32,38,77
Ayr,3190,2,24,4,8,96,43,53,76
Arbroath,3190,3,18,8,10,75,48,27,62
Alloa,3190,4,17,8,11,56,45,11,59
Stranraer,3190,5,16,5,15,57,64,-7,53
Airdrieon,3190,6,11,11,14,46,58,-12,44
East Fife,3190,7,13,3,20,47,66,-19,42
Forfar,3190,8,10,5,21,38,65,-27,35
Albion,3190,9,8,6,22,58,84,-26,30
Queen's Park,3190,10,6,10,20,39,77,-38,28
Ayr,3191,1,24,4,8,95,43,52,76
Raith,3191,2,22,9,5,69,33,36,75
Alloa,3191,3,17,9,10,57,44,13,60
Arbroath,3191,4,17,8,11,70,50,20,59
Stranraer,3191,5,15,5,16,56,69,-13,50
East Fife,3191,6,14,3,19,52,65,-13,45
Airdrieon,3191,7,10,11,15,45,62,-17,41
Forfar,3191,8,11,5,20,42,64,-22,38
Queen's Park,3191,9,7,10,19,41,72,-31,31
Albion,3191,10,8,6,22,58,83,-25,30
Raith,3192,1,22,9,5,70,34,36,75
Ayr,3192,2,23,4,9,93,46,47,73
Arbroath,3192,3,18,8,10,72,49,23,62
Alloa,3192,4,17,9,10,58,45,13,60
Stranraer,3192,5,15,6,15,55,64,-9,51
Airdrieon,3192,6,11,11,14,49,60,-11,44
East Fife,3192,7,13,4,19,47,64,-17,43
Forfar,3192,8,10,5,21,40,68,-28,35
Albion,3192,9,9,6,21,61,81,-20,33
Queen's Park,3192,10,6,10,20,40,74,-34,28
Ayr,3193,1,24,4,8,95,44,51,76
Raith,3193,2,22,9,5,69,33,36,75
Alloa,3193,3,17,9,10,57,44,13,60
Arbroath,3193,4,17,8,11,71,51,20,59
Stranraer,3193,5,15,5,16,55,66,-11,50
East Fife,3193,6,14,3,19,49,64,-15,45
Airdrieon,3193,7,11,11,14,46,58,-12,44
Forfar,3193,8,10,5,21,38,65,-27,35
Queen's Park,3193,9,7,10,19,42,73,-31,31
Albion,3193,10,8,6,22,59,83,-24,30
Raith,3194,1,23,8,5,72,34,38,77
Ayr,3194,2,24,4,8,93,44,49,76
Arbroath,3194,3,17,8,11,71,50,21,59
Alloa,3194,4,17,8,11,58,47,11,59
Stranraer,3194,5,16,5,15,59,65,-6,53
East Fife,3194,6,13,3,20,48,68,-20,42
Airdrieon,3194,7,10,11,15,45,60,-15,41
Forfar,3194,8,11,5,20,40,64,-24,38
Queen's Park,3194,9,7,10,19,41,73,-32,31
Albion,3194,10,8,6,22,59,81,-22,30
Raith,3195,1,23,8,5,71,33,38,77
Ayr,3195,2,24,4,8,92,43,49,76
Arbroath,3195,3,17,8,11,71,51,20,59
Alloa,3195,4,17,8,11,57,46,11,59
Stranraer,3195,5,15,6,15,55,64,-9,51
Airdrieon,3195,6,11,11,14,48,59,-11,44
East Fife,3195,7,13,4,19,47,64,-17,43
Forfar,3195,8,10,5,21,39,67,-28,35
Queen's Park,3195,9,7,10,19,42,73,-31,31
Albion,3195,10,8,6,22,58,80,-22,30
Raith,3196,1,23,8,5,70,33,37,77
Ayr,3196,2,24,4,8,93,44,49,76
Arbroath,3196,3,17,9,10,72,50,22,60
Alloa,3196,4,17,8,11,57,45,12,59
Stranraer,3196,5,15,5,16,56,66,-10,50
East Fife,3196,6,14,3,19,49,65,-16,45
Airdrieon,3196,7,10,12,14,45,58,-13,42
Forfar,3196,8,10,6,20,38,64,-26,36
Albion,3196,9,8,6,22,59,81,-22,30
Queen's Park,3196,10,6,11,19,41,74,-33,29
Raith,3197,1,23,8,5,70,33,37,77
Ayr,3197,2,24,4,8,95,45,50,76
Arbroath,3197,3,17,8,11,73,52,21,59
Alloa,3197,4,17,8,11,57,45,12,59
Stranraer,3197,5,15,5,16,57,67,-10,50
East Fife,3197,6,14,3,19,50,66,-16,45
Airdrieon,3197,7,11,11,14,47,58,-11,44
Forfar,3197,8,10,5,21,38,66,-28,35
Queen's Park,3197,9,7,10,19,43,75,-32,31
Albion,3197,10,8,6,22,60,83,-23,30
Ayr,3198,1,24,4,8,94,42,52,76
Raith,3198,2,22,9,5,69,33,36,75
Alloa,3198,3,17,9,10,57,44,13,60
Arbroath,3198,4,17,8,11,70,50,20,59
Stranraer,3198,5,16,5,15,58,66,-8,53
Airdrieon,3198,6,11,11,14,46,58,-12,44
East Fife,3198,7,13,3,20,49,67,-18,42
Forfar,3198,8,10,5,21,38,65,-27,35
Queen's Park,3198,9,7,10,19,41,72,-31,31
Albion,3198,10,8,6,22,57,82,-25,30
Raith,3199,1,23,8,5,69,32,37,77
Ayr,3199,2,23,5,8,92,44,48,74
Arbroath,3199,3,17,9,10,71,49,22,60
Alloa,3199,4,17,8,11,56,44,12,59
Stranraer,3199,5,15,5,16,55,65,-10,50
East Fife,3199,6,14,3,19,48,64,-16,45
Airdrieon,3199,7,10,11,15,45,59,-14,41
Forfar,3199,8,11,5,20,39,64,-25,38
Albion,3199,9,8,7,21,59,80,-21,31
Queen's Park,3199,10,6,11,19,40,73,-33,29
Raith,3200,1,23,8,5,72,32,40,77
Ayr,3200,2,24,4,8,94,43,51,76
Arbroath,3200,3,18,8,10,75,48,27,62
Alloa,3200,4,17,8,11,56,47,9,59
Stranraer,3200,5,15,5,16,57,70,-13,50
East Fife,3200,6,14,3,19,53,66,-13,45
Airdrieon,3200,7,10,12,14,46,59,-13,42
Forfar,3200,8,10,6,20,39,65,-26,36
Albion,3200,9,8,6,22,58,82,-24,30
Queen's Park,3200,10,6,10,20,39,77,-38,28
Ayr,3201,1,24,4,8,94,43,51,76
Raith,3201,2,22,8,6,68,33,35,74
Arbroath,3201,3,18,8,10,72,49,23,62
Alloa,3201,4,18,8,10,57,43,14,62
Stranraer,3201,5,15,6,15,55,64,-9,51
Airdrieon,3201,6,11,11,14,49,58,-9,44
East Fife,3201,7,13,4,19,47,64,-17,43
Forfar,3201,8,10,5,21,38,68,-30,35
Albion,3201,9,8,6,22,58,82,-24,30
Queen's Park,3201,10,6,10,20,40,74,-34,28
Raith,3202,1,23,8,5,69,32,37,77
Ayr,3202,2,24,4,8,95,43,52,76
Arbroath,3202,3,17,9,10,71,49,22,60
Alloa,3202,4,17,8,11,56,44,12,59
Stranraer,3202,5,15,5,16,56,66,-10,50
East Fife,3202,6,14,3,19,49,65,-16,45
Airdrieon,3202,7,10,11,15,45,60,-15,41
Forfar,3202,8,11,5,20,40,64,-24,38
Albion,3202,9,8,6,22,58,83,-25,30
Queen's Park,3202,10,6,11,19,40,73,-33,29
Ayr,3203,1,24,4,8,94,42,52,76
Raith,3203,2,22,8,6,68,33,35,74
Arbroath,3203,3,18,8,10,72,49,23,62
Alloa,3203,4,18,8,10,57,43,14,62
Stranraer,3203,5,15,5,16,55,66,-11,50
East Fife,3203,6,14,3,19,49,64,-15,45
Airdrieon,3203,7,10,12,14,46,59,-13,42
Forfar,3203,8,10,6,20,39,65,-26,36
Albion,3203,9,8,6,22,57,82,-25,30
Queen's Park,3203,10,6,10,20,40,74,-34,28
Ayr,3204,1,24,4,8,96,44,52,76
Raith,3204,2,22,8,6,69,34,35,74
Arbroath,3204,3,18,8,10,73,50,23,62
Alloa,3204,4,18,8,10,58,44,14,62
Stranraer,3204,5,15,5,16,55,67,-12,50
East Fife,3204,6,14,3,19,50,64,-14,45
Airdrieon,3204,7,11,11,14,47,59,-12,44
Forfar,3204,8,10,5,21,39,66,-27,35
Albion,3204,9,8,6,22,59,84,-25,30
Queen's Park,3204,10,6,10,20,41,75,-34,28
Ayr,3205,1,24,4,8,92,43,49,76
Raith,3205,2,22,9,5,68,32,36,75
Arbroath,3205,3,17,9,10,72,50,22,60
Alloa,3205,4,17,9,10,56,43,13,60
Stranraer,3205,5,16,5,15,56,64,-8,53
East Fife,3205,6,13,3,20,47,65,-18,42
Airdrieon,3205,7,10,11,15,45,59,-14,41
Forfar,3205,8,11,5,20,39,64,-25,38
Albion,3205,9,8,6,22,58,80,-22,30
Queen's Park,3205,10,6,11,19,41,74,-33,29
Ayr,3206,1,23,5,8,93,45,48,74
Raith,3206,2,22,8,6,68,33,35,74
Arbroath,3206,3,18,8,10,71,48,23,62
Alloa,3206,4,18,8,10,57,43,14,62
Stranraer,3206,5,16,5,15,58,64,-6,53
East Fife,3206,6,13,3,20,47,67,-20,42
Airdrieon,3206,7,10,11,15,45,59,-14,41
Forfar,3206,8,11,5,20,39,64,-25,38
Albion,3206,9,8,7,21,60,81,-21,31
Queen's Park,3206,10,6,10,20,39,73,-34,28
Raith,3207,1,23,8,5,72,33,39,77
Ayr,3207,2,24,4,8,94,43,51,76
Arbroath,3207,3,18,8,10,74,51,23,62
Alloa,3207,4,17,8,11,57,47,10,59
Stranraer,3207,5,15,5,16,55,66,-11,50
East Fife,3207,6,14,3,19,49,64,-15,45
Airdrieon,3207,7,10,12,14,46,59,-13,42
Forfar,3207,8,10,6,20,39,65,-26,36
Albion,3207,9,8,6,22,58,82,-24,30
Queen's Park,3207,10,6,10,20,42,76,-34,28
Ayr,3208,1,23,5,8,91,43,48,74
Raith,3208,2,22,8,6,68,33,35,74
Alloa,3208,3,18,8,10,57,43,14,62
Arbroath,3208,4,17,8,11,71,50,21,59
Stranraer,3208,5,15,5,16,56,67,-11,50
East Fife,3208,6,14,3,19,50,65,-15,45
Airdrieon,3208,7,11,11,14,47,58,-11,44
Forfar,3208,8,10,5,21,38,66,-28,35
Albion,3208,9,8,7,21,58,79,-21,31
Queen's Park,3208,10,7,10,19,41,73,-32,31
Ayr,3209,1,24,4,8,92,42,50,76
Raith,3209,2,22,9,5,69,33,36,75
Arbroath,3209,3,18,8,10,71,48,23,62
Alloa,3209,4,17,9,10,57,44,13,60
Stranraer,3209,5,15,6,15,57,66,-9,51
Airdrieon,3209,6,11,11,14,46,58,-12,44
East Fife,3209,7,13,4,19,49,66,-17,43
Forfar,3209,8,10,5,21,38,65,-27,35
Albion,3209,9,8,6,22,57,80,-23,30
Queen's Park,3209,10,6,10,20,39,73,-34,28
Raith,3210,1,23,8,5,70,32,38,77
Ayr,3210,2,24,4,8,95,42,53,76
Arbroath,3210,3,18,8,10,72,49,23,62
Alloa,3210,4,17,8,11,56,45,11,59
Stranraer,3210,5,16,5,15,57,65,-8,53
Airdrieon,3210,6,11,11,14,46,58,-12,44
East Fife,3210,7,13,3,20,48,66,-18,42
Forfar,3210,8,10,5,21,38,65,-27,35
Albion,3210,9,8,6,22,57,83,-26,30
Queen's Park,3210,10,6,10,20,40,74,-34,28
Ayr,3211,1,24,4,8,96,44,52,76
Raith,3211,2,22,9,5,70,34,36,75
Alloa,3211,3,17,9,10,58,45,13,60
Arbroath,3211,4,17,8,11,70,51,19,59
Stranraer,3211,5,15,6,15,58,67,-9,51
East Fife,3211,6,13,4,19,50,67,-17,43
Airdrieon,3211,7,10,11,15,48,62,-14,41
Forfar,3211,8,11,5,20,42,67,-25,38
Queen's Park,3211,9,7,10,19,42,72,-30,31
Albion,3211,10,8,6,22,59,84,-25,30
Raith,3212,1,23,8,5,69,32,37,77
Ayr,3212,2,23,5,8,92,44,48,74
Arbroath,3212,3,18,8,10,72,49,23,62
Alloa,3212,4,17,8,11,56,44,12,59
Stranraer,3212,5,15,5,16,56,67,-11,50
East Fife,3212,6,14,3,19,50,65,-15,45
Airdrieon,3212,7,10,11,15,45,63,-18,41
Forfar,3212,8,11,5,20,43,64,-21,38
Albion,3212,9,8,7,21,59,80,-21,31
Queen's Park,3212,10,6,10,20,40,74,-34,28
Raith,3213,1,23,8,5,69,32,37,77
Ayr,3213,2,23,5,8,93,45,48,74
Arbroath,3213,3,17,8,11,71,50,21,59
Alloa,3213,4,17,8,11,56,44,12,59
Stranraer,3213,5,15,5,16,57,68,-11,50
East Fife,3213,6,14,3,19,51,66,-15,45
Airdrieon,3213,7,10,12,14,45,58,-13,42
Forfar,3213,8,10,6,20,38,64,-26,36
Albion,3213,9,8,7,21,60,81,-21,31
Queen's Park,3213,10,7,10,19,41,73,-32,31
Raith,3214,1,23,8,5,70,32,38,77
Ayr,3214,2,24,4,8,94,43,51,76
Arbroath,3214,3,17,9,10,73,51,22,60
Alloa,3214,4,17,8,11,56,45,11,59
Stranraer,3214,5,15,6,15,57,66,-9,51
East Fife,3214,6,13,4,19,49,66,-17,43
Airdrieon,3214,7,10,12,14,47,60,-13,42
Forfar,3214,8,10,6,20,40,66,-26,36
Albion,3214,9,8,6,22,58,82,-24,30
Queen's Park,3214,10,6,11,19,42,75,-33,29
Raith,3215,1,23,8,5,69,32,37,77
Ayr,3215,2,24,4,8,95,43,52,76
Arbroath,3215,3,17,9,10,71,49,22,60
Alloa,3215,4,17,8,11,56,44,12,59
Stranraer,3215,5,15,5,16,56,68,-12,50
East Fife,3215,6,14,3,19,51,65,-14,45
Airdrieon,3215,7,11,11,14,50,60,-10,44
Forfar,3215,8,10,5,21,40,69,-29,35
Albion,3215,9,8,6,22,58,83,-25,30
Queen's Park,3215,10,6,11,19,40,73,-33,29
Raith,3216,1,23,8,5,71,33,38,77
Ayr,3216,2,24,4,8,92,42,50,76
Arbroath,3216,3,17,8,11,70,49,21,59
Alloa,3216,4,17,8,11,57,46,11,59
Stranraer,3216,5,16,5,15,59,64,-5,53
Airdrieon,3216,6,10,12,14,48,61,-13,42
East Fife,3216,7,13,3,20,47,68,-21,42
Forfar,3216,8,10,6,20,41,67,-26,36
Queen's Park,3216,9,7,10,19,40,72,-32,31
Albion,3216,10,8,6,22,57,80,-23,30
Ayr,3217,1,24,4,8,94,43,51,76
Raith,3217,2,22,9,5,69,33,36,75
Alloa,3217,3,17,9,10,57,44,13,60
Arbroath,3217,4,17,8,11,70,49,21,59
Stranraer,3217,5,16,5,15,58,65,-7,53
East Fife,3217,6,13,3,20,48,67,-19,42
Airdrieon,3217,7,10,11,15,47,61,-14,41
Forfar,3217,8,11,5,20,41,66,-25,38
Queen's Park,3217,9,7,10,19,40,72,-32,31
Albion,3217,10,8,6,22,58,82,-24,30
Ayr,3218,1,24,4,8,94,44,50,76
Raith,3218,2,22,9,5,70,34,36,75
Arbroath,3218,3,17,9,10,70,48,22,60
Alloa,3218,4,17,9,10,58,45,13,60
Stranraer,3218,5,15,5,16,56,67,-11,50
East Fife,3218,6,14,3,19,50,65,-15,45
Airdrieon,3218,7,10,12,14,45,58,-13,42
Forfar,3218,8,10,6,20,38,64,-26,36
Albion,3218,9,8,6,22,59,82,-23,30
Queen's Park,3218,10,6,11,19,39,72,-33,29
Ayr,3219,1,24,4,8,96,44,52,76
Raith,3219,2,22,8,6,68,34,34,74
Alloa,3219,3,18,8,10,58,43,15,62
Arbroath,3219,4,17,9,10,71,49,22,60
Stranraer,3219,5,15,5,16,56,67,-11,50
East Fife,3219,6,14,3,19,50,65,-15,45
Airdrieon,3219,7,10,11,15,45,59,-14,41
Forfar,3219,8,11,5,20,39,64,-25,38
Albion,3219,9,8,6,22,59,84,-25,30
Queen's Park,3219,10,6,11,19,40,73,-33,29
Ayr,3220,1,24,4,8,95,42,53,76
Raith,3220,2,22,8,6,69,34,35,74
Arbroath,3220,3,18,8,10,72,48,24,62
Alloa,3220,4,18,8,10,58,44,14,62
Stranraer,3220,5,16,5,15,57,65,-8,53
Airdrieon,3220,6,11,11,14,46,58,-12,44
East Fife,3220,7,13,3,20,48,66,-18,42
Forfar,3220,8,10,5,21,38,65,-27,35
Albion,3220,9,8,6,22,57,83,-26,30
Queen's Park,3220,10,6,10,20,39,74,-35,28
Raith,3221,1,23,8,5,72,32,40,77
Ayr,3221,2,24,4,8,91,42,49,76
Arbroath,3221,3,18,8,10,72,49,23,62
Alloa,3221,4,17,8,11,56,47,9,59
Stranraer,3221,5,15,5,16,57,68,-11,50
East Fife,3221,6,14,3,19,51,66,-15,45
Airdrieon,3221,7,10,12,14,46,59,-13,42
Forfar,3221,8,10,6,20,39,65,-26,36
Albion,3221,9,8,6,22,57,79,-22,30
Queen's Park,3221,10,6,10,20,40,74,-34,28
Ayr,3222,1,24,4,8,91,42,49,76
Raith,3222,2,22,9,5,68,32,36,75
Arbroath,3222,3,17,9,10,71,49,22,60
Alloa,3222,4,17,9,10,56,43,13,60
Stranraer,3222,5,16,5,15,58,66,-8,53
Airdrieon,3222,6,11,11,14,46,58,-12,44
East Fife,3222,7,13,3,20,49,67,-18,42
Forfar,3222,8,10,5,21,38,65,-27,35
Albion,3222,9,8,6,22,57,79,-22,30
Queen's Park,3222,10,6,11,19,40,73,-33,29
Ayr,3223,1,24,4,8,93,43,50,76
Raith,3223,2,22,9,5,69,33,36,75
Arbroath,3223,3,17,9,10,72,50,22,60
Alloa,3223,4,17,9,10,57,44,13,60
Stranraer,3223,5,16,5,15,57,65,-8,53
Airdrieon,3223,6,10,12,14,46,59,-13,42
East Fife,3223,7,13,3,20,48,66,-18,42
Forfar,3223,8,10,6,20,39,65,-26,36
Albion,3223,9,8,6,22,58,81,-23,30
Queen's Park,3223,10,6,11,19,41,74,-33,29
Ayr,3224,1,24,4,8,93,43,50,76
Raith,3224,2,22,9,5,68,32,36,75
Alloa,3224,3,17,9,10,56,43,13,60
Arbroath,3224,4,17,8,11,70,51,19,59
Stranraer,3224,5,15,5,16,56,69,-13,50
East Fife,3224,6,14,3,19,52,65,-13,45
Airdrieon,3224,7,10,12,14,45,58,-13,42
Forfar,3224,8,10,6,20,38,64,-26,36
Queen's Park,3224,9,7,10,19,42,72,-30,31
Albion,3224,10,8,6,22,58,81,-23,30
Raith,3225,1,23,8,5,72,32,40,77
Ayr,3225,2,24,4,8,95,42,53,76
Arbroath,3225,3,18,8,10,74,50,24,62
Alloa,3225,4,17,8,11,56,47,9,59
Stranraer,3225,5,15,6,15,56,65,-9,51
East Fife,3225,6,13,4,19,48,65,-17,43
Airdrieon,3225,7,10,12,14,46,59,-13,42
Forfar,3225,8,10,6,20,39,65,-26,36
Albion,3225,9,8,6,22,57,83,-26,30
Queen's Park,3225,10,6,10,20,41,76,-35,28
Raith,3226,1,23,8,5,74,33,41,77
Ayr,3226,2,24,4,8,93,44,49,76
Arbroath,3226,3,18,8,10,74,48,26,62
Alloa,3226,4,17,8,11,57,49,8,59
Stranraer,3226,5,16,5,15,56,64,-8,53
Airdrieon,3226,6,10,12,14,48,61,-13,42
East Fife,3226,7,13,3,20,47,65,-18,42
Forfar,3226,8,10,6,20,41,67,-26,36
Albion,3226,9,8,6,22,59,81,-22,30
Queen's Park,3226,10,6,10,20,39,76,-37,28
Raith,3227,1,23,8,5,69,32,37,77
Ayr,3227,2,24,4,8,93,43,50,76
Arbroath,3227,3,18,8,10,71,48,23,62
Alloa,3227,4,17,8,11,56,44,12,59
Stranraer,3227,5,15,5,16,56,66,-10,50
East Fife,3227,6,14,3,19,49,65,-16,45
Airdrieon,3227,7,10,12,14,45,58,-13,42
Forfar,3227,8,10,6,20,38,64,-26,36
Albion,3227,9,8,6,22,58,81,-23,30
Queen's Park,3227,10,6,10,20,39,73,-34,28
Raith,3228,1,23,8,5,70,32,38,77
Ayr,3228,2,24,4,8,94,45,49,76
Arbroath,3228,3,17,8,11,71,51,20,59
Alloa,3228,4,17,8,11,56,45,11,59
Stranraer,3228,5,15,5,16,56,67,-11,50
East Fife,3228,6,14,3,19,50,65,-15,45
Airdrieon,3228,7,10,11,15,45,59,-14,41
Forfar,3228,8,11,5,20,39,64,-25,38
Queen's Park,3228,9,7,10,19,42,73,-31,31
Albion,3228,10,8,6,22,60,82,-22,30
Raith,3229,1,23,8,5,70,32,38,77
Ayr,3229,2,24,4,8,95,43,52,76
Arbroath,3229,3,17,9,10,71,49,22,60
Alloa,3229,4,17,8,11,56,45,11,59
Stranraer,3229,5,15,5,16,56,66,-10,50
East Fife,3229,6,14,3,19,49,65,-16,45
Airdrieon,3229,7,10,11,15,45,60,-15,41
Forfar,3229,8,11,5,20,40,64,-24,38
Albion,3229,9,8,6,22,58,83,-25,30
Queen's Park,3229,10,6,11,19,40,73,-33,29
Ayr,3230,1,24,4,8,92,42,50,76
Raith,3230,2,22,8,6,69,35,34,74
Arbroath,3230,3,18,8,10,72,49,23,62
Alloa,3230,4,18,8,10,59,44,15,62
Stranraer,3230,5,16,5,15,59,64,-5,53
Airdrieon,3230,6,11,11,14,47,59,-12,44
East Fife,3230,7,13,3,20,47,68,-21,42
Forfar,3230,8,10,5,21,39,66,-27,35
Albion,3230,9,8,6,22,57,80,-23,30
Queen's Park,3230,10,6,10,20,40,74,-34,28
Raith,3231,1,23,8,5,70,32,38,77
Ayr,3231,2,24,4,8,96,44,52,76
Arbroath,3231,3,17,8,11,70,49,21,59
Alloa,3231,4,17,8,11,56,45,11,59
Stranraer,3231,5,16,5,15,56,64,-8,53
East Fife,3231,6,13,3,20,47,65,-18,42
Airdrieon,3231,7,10,11,15,45,60,-15,41
Forfar,3231,8,11,5,20,40,64,-24,38
Queen's Park,3231,9,7,10,19,40,72,-32,31
Albion,3231,10,8,6,22,59,84,-25,30
Raith,3232,1,23,8,5,70,33,37,77
Ayr,3232,2,24,4,8,94,44,50,76
Arbroath,3232,3,17,8,11,70,49,21,59
Alloa,3232,4,17,8,11,57,45,12,59
Stranraer,3232,5,16,5,15,57,64,-7,53
Airdrieon,3232,6,10,12,14,46,59,-13,42
East Fife,3232,7,13,3,20,47,66,-19,42
Forfar,3232,8,10,6,20,39,65,-26,36
Queen's Park,3232,9,7,10,19,40,72,-32,31
Albion,3232,10,8,6,22,59,82,-23,30
Raith,3233,1,23,8,5,69,32,37,77
Ayr,3233,2,24,4,8,93,43,50,76
Arbroath,3233,3,17,8,11,71,50,21,59
Alloa,3233,4,17,8,11,56,44,12,59
Stranraer,3233,5,15,6,15,56,65,-9,51
East Fife,3233,6,13,4,19,48,65,-17,43
Airdrieon,3233,7,10,12,14,48,61,-13,42
Forfar,3233,8,10,6,20,41,67,-26,36
Queen's Park,3233,9,7,10,19,41,73,-32,31
Albion,3233,10,8,6,22,58,81,-23,30
Raith,3234,1,23,8,5,70,32,38,77
Ayr,3234,2,23,5,8,92,44,48,74
Arbroath,3234,3,18,8,10,76,49,27,62
Alloa,3234,4,17,8,11,56,45,11,59
Stranraer,3234,5,16,5,15,56,64,-8,53
Airdrieon,3234,6,11,11,14,46,58,-12,44
East Fife,3234,7,13,3,20,47,65,-18,42
Forfar,3234,8,10,5,21,38,65,-27,35
Albion,3234,9,8,7,21,59,80,-21,31
Queen's Park,3234,10,6,10,20,40,78,-38,28
Raith,3235,1,23,8,5,72,32,40,77
Ayr,3235,2,24,4,8,93,42,51,76
Arbroath,3235,3,17,9,10,71,49,22,60
Alloa,3235,4,17,8,11,56,47,9,59
Stranraer,3235,5,15,5,16,55,66,-11,50
East Fife,3235,6,14,3,19,49,64,-15,45
Airdrieon,3235,7,10,11,15,45,59,-14,41
Forfar,3235,8,11,5,20,39,64,-25,38
Albion,3235,9,8,6,22,57,81,-24,30
Queen's Park,3235,10,6,11,19,40,73,-33,29
Ayr,3236,1,24,4,8,94,43,51,76
Raith,3236,2,22,8,6,70,35,35,74
Arbroath,3236,3,18,8,10,75,50,25,62
Alloa,3236,4,18,8,10,59,45,14,62
Stranraer,3236,5,15,6,15,56,65,-9,51
Airdrieon,3236,6,11,11,14,47,59,-12,44
East Fife,3236,7,13,4,19,48,65,-17,43
Forfar,3236,8,10,5,21,39,66,-27,35
Albion,3236,9,8,6,22,58,82,-24,30
Queen's Park,3236,10,6,10,20,41,77,-36,28
Raith,3237,1,23,8,5,71,32,39,77
Ayr,3237,2,24,4,8,94,45,49,76
Arbroath,3237,3,18,8,10,72,49,23,62
Alloa,3237,4,17,8,11,56,46,10,59
Stranraer,3237,5,16,5,15,57,64,-7,53
Airdrieon,3237,6,10,12,14,46,59,-13,42
East Fife,3237,7,13,3,20,47,66,-19,42
Forfar,3237,8,10,6,20,39,65,-26,36
Albion,3237,9,8,6,22,60,82,-22,30
Queen's Park,3237,10,6,10,20,40,74,-34,28
Ayr,3238,1,24,4,8,94,44,50,76
Raith,3238,2,22,8,6,68,33,35,74
Arbroath,3238,3,18,8,10,72,48,24,62
Alloa,3238,4,18,8,10,57,43,14,62
Stranraer,3238,5,15,5,16,55,66,-11,50
East Fife,3238,6,14,3,19,49,64,-15,45
Airdrieon,3238,7,11,11,14,46,58,-12,44
Forfar,3238,8,10,5,21,38,65,-27,35
Albion,3238,9,8,6,22,59,82,-23,30
Queen's Park,3238,10,6,10,20,39,74,-35,28
Raith,3239,1,23,8,5,69,32,37,77
Ayr,3239,2,24,4,8,96,45,51,76
Arbroath,3239,3,18,8,10,71,48,23,62
Alloa,3239,4,17,8,11,56,44,12,59
Stranraer,3239,5,15,5,16,56,67,-11,50
East Fife,3239,6,14,3,19,50,65,-15,45
Airdrieon,3239,7,11,11,14,46,58,-12,44
Forfar,3239,8,10,5,21,38,65,-27,35
Albion,3239,9,8,6,22,60,84,-24,30
Queen's Park,3239,10,6,10,20,39,73,-34,28
Raith,3240,1,23,8,5,69,32,37,77
Ayr,3240,2,24,4,8,93,43,50,76
Arbroath,3240,3,17,9,10,73,51,22,60
Alloa,3240,4,17,8,11,56,44,12,59
Stranraer,3240,5,16,5,15,57,64,-7,53
East Fife,3240,6,13,3,20,47,66,-19,42
Airdrieon,3240,7,10,11,15,46,60,-14,41
Forfar,3240,8,11,5,20,40,65,-25,38
Albion,3240,9,8,6,22,58,81,-23,30
Queen's Park,3240,10,6,11,19,42,75,-33,29
Ayr,3241,1,23,5,8,90,42,48,74
Raith,3241,2,22,8,6,69,36,33,74
Arbroath,3241,3,18,8,10,74,50,24,62
Alloa,3241,4,18,8,10,60,44,16,62
Stranraer,3241,5,15,5,16,56,67,-11,50
East Fife,3241,6,14,3,19,50,65,-15,45
Airdrieon,3241,7,11,11,14,46,58,-12,44
Forfar,3241,8,10,5,21,38,65,-27,35
Albion,3241,9,8,7,21,57,78,-21,31
Queen's Park,3241,10,6,10,20,41,76,-35,28
Ayr,3242,1,24,4,8,92,43,49,76
Raith,3242,2,22,9,5,70,34,36,75
Arbroath,3242,3,17,9,10,72,50,22,60
Alloa,3242,4,17,9,10,58,45,13,60
Stranraer,3242,5,15,6,15,57,66,-9,51
East Fife,3242,6,13,4,19,49,66,-17,43
Airdrieon,3242,7,10,11,15,45,59,-14,41
Forfar,3242,8,11,5,20,39,64,-25,38
Albion,3242,9,8,6,22,58,80,-22,30
Queen's Park,3242,10,6,11,19,41,74,-33,29
Raith,3243,1,23,8,5,72,33,39,77
Ayr,3243,2,24,4,8,94,42,52,76
Arbroath,3243,3,17,8,11,72,53,19,59
Alloa,3243,4,17,8,11,57,47,10,59
Stranraer,3243,5,15,5,16,55,66,-11,50
East Fife,3243,6,14,3,19,49,64,-15,45
Airdrieon,3243,7,11,11,14,47,58,-11,44
Forfar,3243,8,10,5,21,38,66,-28,35
Queen's Park,3243,9,7,10,19,44,74,-30,31
Albion,3243,10,8,6,22,57,82,-25,30
Ayr,3244,1,24,4,8,98,42,56,76
Raith,3244,2,22,9,5,68,32,36,75
Arbroath,3244,3,17,9,10,71,49,22,60
Alloa,3244,4,17,9,10,56,43,13,60
Stranraer,3244,5,16,5,15,58,66,-8,53
East Fife,3244,6,13,3,20,49,67,-18,42
Airdrieon,3244,7,10,11,15,46,60,-14,41
Forfar,3244,8,11,5,20,40,65,-25,38
Albion,3244,9,8,6,22,57,86,-29,30
Queen's Park,3244,10,6,11,19,40,73,-33,29
Ayr,3245,1,24,4,8,98,42,56,76
Raith,3245,2,22,8,6,69,34,35,74
Alloa,3245,3,18,8,10,58,44,14,62
Arbroath,3245,4,17,8,11,71,51,20,59
Stranraer,3245,5,15,5,16,56,68,-12,50
East Fife,3245,6,14,3,19,51,65,-14,45
Airdrieon,3245,7,11,11,14,48,59,-11,44
Forfar,3245,8,10,5,21,39,67,-28,35
Queen's Park,3245,9,7,10,19,42,73,-31,31
Albion,3245,10,8,6,22,57,86,-29,30
Raith,3246,1,23,8,5,72,32,40,77
Ayr,3246,2,24,4,8,94,43,51,76
Arbroath,3246,3,18,8,10,72,49,23,62
Alloa,3246,4,17,8,11,56,47,9,59
Stranraer,3246,5,15,6,15,57,66,-9,51
Airdrieon,3246,6,11,11,14,47,58,-11,44
East Fife,3246,7,13,4,19,49,66,-17,43
Forfar,3246,8,10,5,21,38,66,-28,35
Albion,3246,9,8,6,22,58,82,-24,30
Queen's Park,3246,10,6,10,20,40,74,-34,28
Ayr,3247,1,24,4,8,96,42,54,76
Raith,3247,2,22,8,6,68,34,34,74
Alloa,3247,3,18,8,10,58,43,15,62
Arbroath,3247,4,17,8,11,71,52,19,59
Stranraer,3247,5,16,5,15,56,64,-8,53
Airdrieon,3247,6,10,12,14,46,59,-13,42
East Fife,3247,7,13,3,20,47,65,-18,42
Forfar,3247,8,10,6,20,39,65,-26,36
Queen's Park,3247,9,7,10,19,43,73,-30,31
Albion,3247,10,8,6,22,57,84,-27,30
Raith,3248,1,23,8,5,72,33,39,77
Ayr,3248,2,24,4,8,93,43,50,76
Arbroath,3248,3,17,8,11,70,51,19,59
Alloa,3248,4,17,8,11,57,47,10,59
Stranraer,3248,5,15,6,15,57,66,-9,51
East Fife,3248,6,13,4,19,49,66,-17,43
Airdrieon,3248,7,10,12,14,46,59,-13,42
Forfar,3248,8,10,6,20,39,65,-26,36
Queen's Park,3248,9,7,10,19,42,72,-30,31
Albion,3248,10,8,6,22,58,81,-23,30
Raith,3249,1,23,8,5,69,32,37,77
Ayr,3249,2,24,4,8,92,43,49,76
Arbroath,3249,3,17,8,11,70,49,21,59
Alloa,3249,4,17,8,11,56,44,12,59
Stranraer,3249,5,15,5,16,55,65,-10,50
East Fife,3249,6,14,3,19,48,64,-16,45
Airdrieon,3249,7,10,12,14,46,59,-13,42
Forfar,3249,8,10,6,20,39,65,-26,36
Queen's Park,3249,9,7,10,19,40,72,-32,31
Albion,3249,10,8,6,22,58,80,-22,30
Raith,3250,1,22,8,6,69,34,35,74
Ayr,3250,2,23,4,9,90,48,42,73
Arbroath,3250,3,18,8,10,73,49,24,62
Alloa,3250,4,18,8,10,58,44,14,62
Stranraer,3250,5,15,6,15,58,67,-9,51
East Fife,3250,6,13,4,19,50,67,-17,43
Airdrieon,3250,7,10,12,14,46,59,-13,42
Forfar,3250,8,10,6,20,39,65,-26,36
Albion,3250,9,9,6,21,63,78,-15,33
Queen's Park,3250,10,6,10,20,40,75,-35,28
Raith,3251,1,23,8,5,70,32,38,77
Ayr,3251,2,23,4,9,92,45,47,73
Arbroath,3251,3,17,8,11,70,49,21,59
Alloa,3251,4,17,8,11,56,45,11,59
Stranraer,3251,5,15,5,16,55,67,-12,50
East Fife,3251,6,14,3,19,50,64,-14,45
Airdrieon,3251,7,11,11,14,48,60,-12,44
Forfar,3251,8,10,5,21,40,67,-27,35
Albion,3251,9,9,6,21,60,80,-20,33
Queen's Park,3251,10,7,10,19,40,72,-32,31
Raith,3252,1,23,8,5,71,32,39,77
Ayr,3252,2,23,4,9,90,45,45,73
Arbroath,3252,3,17,8,11,70,49,21,59
Alloa,3252,4,17,8,11,56,46,10,59
Stranraer,3252,5,15,5,16,55,65,-10,50
East Fife,3252,6,14,3,19,48,64,-16,45
Airdrieon,3252,7,10,11,15,46,61,-15,41
Forfar,3252,8,11,5,20,41,65,-24,38
Albion,3252,9,9,6,21,60,78,-18,33
Queen's Park,3252,10,7,10,19,40,72,-32,31
Raith,3253,1,23,8,5,69,32,37,77
Ayr,3253,2,24,4,8,94,43,51,76
Arbroath,3253,3,17,8,11,70,50,20,59
Alloa,3253,4,17,8,11,56,44,12,59
Stranraer,3253,5,15,6,15,56,65,-9,51
East Fife,3253,6,13,4,19,48,65,-17,43
Airdrieon,3253,7,10,11,15,45,60,-15,41
Forfar,3253,8,11,5,20,40,64,-24,38
Queen's Park,3253,9,7,10,19,41,72,-31,31
Albion,3253,10,8,6,22,58,82,-24,30
Ayr,3254,1,23,5,8,92,44,48,74
Raith,3254,2,22,8,6,69,34,35,74
Alloa,3254,3,18,8,10,58,44,14,62
Arbroath,3254,4,17,8,11,70,49,21,59
Stranraer,3254,5,16,5,15,59,64,-5,53
East Fife,3254,6,13,3,20,47,68,-21,42
Airdrieon,3254,7,10,11,15,45,59,-14,41
Forfar,3254,8,11,5,20,39,64,-25,38
Albion,3254,9,8,7,21,59,80,-21,31
Queen's Park,3254,10,7,10,19,40,72,-32,31
Raith,3255,1,23,8,5,72,32,40,77
Ayr,3255,2,24,4,8,92,42,50,76
Arbroath,3255,3,17,9,10,71,49,22,60
Alloa,3255,4,17,8,11,56,47,9,59
Stranraer,3255,5,15,5,16,56,66,-10,50
East Fife,3255,6,14,3,19,49,65,-16,45
Airdrieon,3255,7,11,11,14,47,59,-12,44
Forfar,3255,8,10,5,21,39,66,-27,35
Albion,3255,9,8,6,22,57,80,-23,30
Queen's Park,3255,10,6,11,19,40,73,-33,29
Ayr,3256,1,24,4,8,94,42,52,76
Raith,3256,2,22,9,5,69,33,36,75
Alloa,3256,3,17,9,10,57,44,13,60
Arbroath,3256,4,17,8,11,72,51,21,59
Stranraer,3256,5,15,6,15,56,65,-9,51
East Fife,3256,6,13,4,19,48,65,-17,43
Airdrieon,3256,7,10,11,15,45,59,-14,41
Forfar,3256,8,11,5,20,39,64,-25,38
Queen's Park,3256,9,7,10,19,42,74,-32,31
Albion,3256,10,8,6,22,57,82,-25,30
Ayr,3257,1,24,4,8,94,43,51,76
Raith,3257,2,22,8,6,69,34,35,74
Arbroath,3257,3,18,8,10,72,48,24,62
Alloa,3257,4,18,8,10,58,44,14,62
Stranraer,3257,5,15,5,16,56,66,-10,50
East Fife,3257,6,14,3,19,49,65,-16,45
Airdrieon,3257,7,11,11,14,46,58,-12,44
Forfar,3257,8,10,5,21,38,65,-27,35
Albion,3257,9,8,6,22,58,82,-24,30
Queen's Park,3257,10,6,10,20,39,74,-35,28
Raith,3258,1,23,8,5,70,33,37,77
Ayr,3258,2,24,4,8,96,43,53,76
Arbroath,3258,3,18,8,10,72,49,23,62
Alloa,3258,4,17,8,11,57,45,12,59
Stranraer,3258,5,16,5,15,59,66,-7,53
Airdrieon,3258,6,11,11,14,46,58,-12,44
East Fife,3258,7,13,3,20,49,68,-19,42
Forfar,3258,8,10,5,21,38,65,-27,35
Albion,3258,9,8,6,22,58,84,-26,30
Queen's Park,3258,10,6,10,20,40,74,-34,28
Ayr,3259,1,24,4,8,97,42,55,76
Raith,3259,2,22,8,6,68,33,35,74
Arbroath,3259,3,18,8,10,72,49,23,62
Alloa,3259,4,18,8,10,57,43,14,62
Stranraer,3259,5,15,5,16,57,68,-11,50
East Fife,3259,6,14,3,19,51,66,-15,45
Airdrieon,3259,7,11,11,14,49,60,-11,44
Forfar,3259,8,10,5,21,40,68,-28,35
Albion,3259,9,8,6,22,57,85,-28,30
Queen's Park,3259,10,6,10,20,40,74,-34,28
Raith,3260,1,23,8,5,70,32,38,77
Ayr,3260,2,24,4,8,94,45,49,76
Arbroath,3260,3,18,8,10,72,49,23,62
Alloa,3260,4,17,8,11,56,45,11,59
Stranraer,3260,5,15,5,16,56,66,-10,50
East Fife,3260,6,14,3,19,49,65,-16,45
Airdrieon,3260,7,10,11,15,46,62,-16,41
Forfar,3260,8,11,5,20,42,65,-23,38
Albion,3260,9,8,6,22,60,82,-22,30
Queen's Park,3260,10,6,10,20,40,74,-34,28
Raith,3261,1,23,8,5,70,33,37,77
Ayr,3261,2,24,4,8,95,43,52,76
Arbroath,3261,3,18,8,10,72,49,23,62
Alloa,3261,4,17,8,11,57,45,12,59
Stranraer,3261,5,15,5,16,56,66,-10,50
East Fife,3261,6,14,3,19,49,65,-16,45
Airdrieon,3261,7,10,11,15,45,59,-14,41
Forfar,3261,8,11,5,20,39,64,-25,38
Albion,3261,9,8,6,22,58,83,-25,30
Queen's Park,3261,10,6,10,20,40,74,-34,28
Ayr,3262,1,24,4,8,94,42,52,76
Raith,3262,2,22,8,6,68,33,35,74
Alloa,3262,3,18,8,10,57,43,14,62
Arbroath,3262,4,17,8,11,70,50,20,59
Stranraer,3262,5,15,6,15,56,65,-9,51
Airdrieon,3262,6,11,11,14,47,59,-12,44
East Fife,3262,7,13,4,19,48,65,-17,43
Forfar,3262,8,10,5,21,39,66,-27,35
Queen's Park,3262,9,7,10,19,41,72,-31,31
Albion,3262,10,8,6,22,57,82,-25,30
Raith,3263,1,23,8,5,70,32,38,77
Ayr,3263,2,24,4,8,93,44,49,76
Arbroath,3263,3,17,8,11,70,49,21,59
Alloa,3263,4,17,8,11,56,45,11,59
Stranraer,3263,5,15,5,16,56,67,-11,50
East Fife,3263,6,14,3,19,50,65,-15,45
Airdrieon,3263,7,11,11,14,47,58,-11,44
Forfar,3263,8,10,5,21,38,66,-28,35
Queen's Park,3263,9,7,10,19,40,72,-32,31
Albion,3263,10,8,6,22,59,81,-22,30
Raith,3264,1,23,8,5,71,34,37,77
Ayr,3264,2,24,4,8,97,42,55,76
Arbroath,3264,3,18,8,10,74,48,26,62
Alloa,3264,4,17,8,11,58,46,12,59
Stranraer,3264,5,15,5,16,56,67,-11,50
East Fife,3264,6,14,3,19,50,65,-15,45
Airdrieon,3264,7,11,11,14,46,58,-12,44
Forfar,3264,8,10,5,21,38,65,-27,35
Albion,3264,9,8,6,22,57,85,-28,30
Queen's Park,3264,10,6,10,20,39,76,-37,28
Ayr,3265,1,24,4,8,93,44,49,76
Raith,3265,2,22,9,5,70,34,36,75
Arbroath,3265,3,18,8,10,72,49,23,62
Alloa,3265,4,17,9,10,58,45,13,60
Stranraer,3265,5,15,5,16,56,66,-10,50
East Fife,3265,6,14,3,19,49,65,-16,45
Airdrieon,3265,7,11,11,14,48,60,-12,44
Forfar,3265,8,10,5,21,40,67,-27,35
Albion,3265,9,8,6,22,59,81,-22,30
Queen's Park,3265,10,6,10,20,40,74,-34,28
Ayr,3266,1,24,4,8,98,44,54,76
Raith,3266,2,22,8,6,69,34,35,74
Alloa,3266,3,18,8,10,58,44,14,62
Arbroath,3266,4,17,8,11,70,50,20,59
Stranraer,3266,5,16,5,15,58,65,-7,53
Airdrieon,3266,6,11,11,14,49,58,-9,44
East Fife,3266,7,13,3,20,48,67,-19,42
Forfar,3266,8,10,5,21,38,68,-30,35
Queen's Park,3266,9,7,10,19,41,72,-31,31
Albion,3266,10,8,6,22,59,86,-27,30
Ayr,3267,1,23,5,8,90,42,48,74
Raith,3267,2,22,8,6,69,34,35,74
Arbroath,3267,3,18,8,10,72,49,23,62
Alloa,3267,4,18,8,10,58,44,14,62
Stranraer,3267,5,16,5,15,57,65,-8,53
Airdrieon,3267,6,11,11,14,48,59,-11,44
East Fife,3267,7,13,3,20,48,66,-18,42
Forfar,3267,8,10,5,21,39,67,-28,35
Albion,3267,9,8,7,21,57,78,-21,31
Queen's Park,3267,10,6,10,20,40,74,-34,28
Raith,3268,1,23,8,5,70,32,38,77
Ayr,3268,2,24,4,8,96,43,53,76
Arbroath,3268,3,18,8,10,72,49,23,62
Alloa,3268,4,17,8,11,56,45,11,59
Stranraer,3268,5,15,6,15,58,67,-9,51
Airdrieon,3268,6,11,11,14,47,58,-11,44
East Fife,3268,7,13,4,19,50,67,-17,43
Forfar,3268,8,10,5,21,38,66,-28,35
Albion,3268,9,8,6,22,58,84,-26,30
Queen's Park,3268,10,6,10,20,40,74,-34,28
Raith,3269,1,23,8,5,69,32,37,77
Ayr,3269,2,24,4,8,94,45,49,76
Arbroath,3269,3,17,8,11,71,50,21,59
Alloa,3269,4,17,8,11,56,44,12,59
Stranraer,3269,5,15,5,16,56,67,-11,50
East Fife,3269,6,14,3,19,50,65,-15,45
Airdrieon,3269,7,10,12,14,46,59,-13,42
Forfar,3269,8,10,6,20,39,65,-26,36
Queen's Park,3269,9,7,10,19,41,73,-32,31
Albion,3269,10,8,6,22,60,82,-22,30
Ayr,3270,1,24,4,8,95,43,52,76
Raith,3270,2,22,9,5,68,32,36,75
Arbroath,3270,3,17,9,10,73,51,22,60
Alloa,3270,4,17,9,10,56,43,13,60
Stranraer,3270,5,15,5,16,55,66,-11,50
East Fife,3270,6,14,3,19,49,64,-15,45
Airdrieon,3270,7,10,12,14,45,58,-13,42
Forfar,3270,8,10,6,20,38,64,-26,36
Albion,3270,9,8,6,22,58,83,-25,30
Queen's Park,3270,10,6,11,19,42,75,-33,29
Ayr,3271,1,24,4,8,91,42,49,76
Raith,3271,2,22,8,6,68,35,33,74
Arbroath,3271,3,18,8,10,73,49,24,62
Alloa,3271,4,18,8,10,59,43,16,62
Stranraer,3271,5,15,6,15,55,64,-9,51
East Fife,3271,6,13,4,19,47,64,-17,43
Airdrieon,3271,7,10,12,14,47,60,-13,42
Forfar,3271,8,10,6,20,40,66,-26,36
Albion,3271,9,8,6,22,57,79,-22,30
Queen's Park,3271,10,6,10,20,40,75,-35,28
Raith,3272,1,23,8,5,70,32,38,77
Ayr,3272,2,23,5,8,90,42,48,74
Arbroath,3272,3,18,8,10,73,49,24,62
Alloa,3272,4,17,8,11,56,45,11,59
Stranraer,3272,5,15,6,15,56,65,-9,51
Airdrieon,3272,6,11,11,14,48,58,-10,44
East Fife,3272,7,13,4,19,48,65,-17,43
Forfar,3272,8,10,5,21,38,67,-29,35
Albion,3272,9,8,7,21,57,78,-21,31
Queen's Park,3272,10,6,10,20,40,75,-35,28
Raith,3273,1,23,8,5,70,33,37,77
Ayr,3273,2,24,4,8,94,45,49,76
Arbroath,3273,3,17,9,10,71,49,22,60
Alloa,3273,4,17,8,11,57,45,12,59
Stranraer,3273,5,15,5,16,55,66,-11,50
East Fife,3273,6,14,3,19,49,64,-15,45
Airdrieon,3273,7,11,11,14,47,59,-12,44
Forfar,3273,8,10,5,21,39,66,-27,35
Albion,3273,9,8,6,22,60,82,-22,30
Queen's Park,3273,10,6,11,19,40,73,-33,29
Ayr,3274,1,24,4,8,94,43,51,76
Raith,3274,2,22,9,5,68,32,36,75
Arbroath,3274,3,18,8,10,73,49,24,62
Alloa,3274,4,17,9,10,56,43,13,60
Stranraer,3274,5,15,5,16,55,65,-10,50
East Fife,3274,6,14,3,19,48,64,-16,45
Airdrieon,3274,7,11,11,14,49,59,-10,44
Forfar,3274,8,10,5,21,39,68,-29,35
Albion,3274,9,8,6,22,58,82,-24,30
Queen's Park,3274,10,6,10,20,40,75,-35,28
Ayr,3275,1,23,5,8,94,46,48,74
Raith,3275,2,22,8,6,68,34,34,74
Arbroath,3275,3,18,8,10,72,49,23,62
Alloa,3275,4,18,8,10,58,43,15,62
Stranraer,3275,5,15,5,16,56,67,-11,50
East Fife,3275,6,14,3,19,50,65,-15,45
Airdrieon,3275,7,10,12,14,46,59,-13,42
Forfar,3275,8,10,6,20,39,65,-26,36
Albion,3275,9,8,7,21,61,82,-21,31
Queen's Park,3275,10,6,10,20,40,74,-34,28
Ayr,3276,1,24,4,8,96,42,54,76
Raith,3276,2,22,9,5,70,34,36,75
Arbroath,3276,3,18,8,10,72,48,24,62
Alloa,3276,4,17,9,10,58,45,13,60
Stranraer,3276,5,15,6,15,56,65,-9,51
East Fife,3276,6,13,4,19,48,65,-17,43
Airdrieon,3276,7,10,11,15,45,59,-14,41
Forfar,3276,8,11,5,20,39,64,-25,38
Albion,3276,9,8,6,22,57,84,-27,30
Queen's Park,3276,10,6,10,20,39,74,-35,28
Raith,3277,1,23,8,5,69,32,37,77
Ayr,3277,2,24,4,8,93,42,51,76
Arbroath,3277,3,18,8,10,74,50,24,62
Alloa,3277,4,17,8,11,56,44,12,59
Stranraer,3277,5,16,5,15,58,66,-8,53
Airdrieon,3277,6,11,11,14,49,59,-10,44
East Fife,3277,7,13,3,20,49,67,-18,42
Forfar,3277,8,10,5,21,39,68,-29,35
Albion,3277,9,8,6,22,57,81,-24,30
Queen's Park,3277,10,6,10,20,41,76,-35,28
Ayr,3278,1,24,4,8,94,45,49,76
Raith,3278,2,22,9,5,70,34,36,75
Arbroath,3278,3,17,9,10,71,49,22,60
Alloa,3278,4,17,9,10,58,45,13,60
Stranraer,3278,5,16,5,15,59,65,-6,53
Airdrieon,3278,6,11,11,14,49,59,-10,44
East Fife,3278,7,13,3,20,48,68,-20,42
Forfar,3278,8,10,5,21,39,68,-29,35
Albion,3278,9,8,6,22,60,82,-22,30
Queen's Park,3278,10,6,11,19,40,73,-33,29
Ayr,3279,1,24,4,8,91,42,49,76
Raith,3279,2,22,8,6,69,34,35,74
Arbroath,3279,3,18,8,10,75,51,24,62
Alloa,3279,4,18,8,10,58,44,14,62
Stranraer,3279,5,15,5,16,55,65,-10,50
East Fife,3279,6,14,3,19,48,64,-16,45
Airdrieon,3279,7,11,11,14,48,59,-11,44
Forfar,3279,8,10,5,21,39,67,-28,35
Albion,3279,9,8,6,22,57,79,-22,30
Queen's Park,3279,10,6,10,20,42,77,-35,28
Raith,3280,1,23,8,5,70,32,38,77
Ayr,3280,2,24,4,8,97,43,54,76
Arbroath,3280,3,17,9,10,70,48,22,60
Alloa,3280,4,17,8,11,56,45,11,59
Stranraer,3280,5,15,5,16,55,65,-10,50
East Fife,3280,6,14,3,19,48,64,-16,45
Airdrieon,3280,7,11,11,14,47,59,-12,44
Forfar,3280,8,10,5,21,39,66,-27,35
Albion,3280,9,8,6,22,58,85,-27,30
Queen's Park,3280,10,6,11,19,39,72,-33,29
Ayr,3281,1,24,4,8,92,42,50,76
Raith,3281,2,22,8,6,69,35,34,74
Alloa,3281,3,18,8,10,59,44,15,62
Arbroath,3281,4,17,8,11,73,52,21,59
Stranraer,3281,5,16,5,15,57,64,-7,53
East Fife,3281,6,13,3,20,47,66,-19,42
Airdrieon,3281,7,10,11,15,46,60,-14,41
Forfar,3281,8,11,5,20,40,65,-25,38
Queen's Park,3281,9,7,10,19,43,75,-32,31
Albion,3281,10,8,6,22,57,80,-23,30
Ayr,3282,1,24,4,8,92,43,49,76
Raith,3282,2,22,9,5,68,32,36,75
Arbroath,3282,3,17,9,10,72,50,22,60
Alloa,3282,4,17,9,10,56,43,13,60
Stranraer,3282,5,15,6,15,57,66,-9,51
Airdrieon,3282,6,11,11,14,46,58,-12,44
East Fife,3282,7,13,4,19,49,66,-17,43
Forfar,3282,8,10,5,21,38,65,-27,35
Albion,3282,9,8,6,22,58,80,-22,30
Queen's Park,3282,10,6,11,19,41,74,-33,29
Raith,3283,1,23,8,5,70,32,38,77
Ayr,3283,2,24,4,8,93,43,50,76
Arbroath,3283,3,18,8,10,72,49,23,62
Alloa,3283,4,17,8,11,56,45,11,59
Stranraer,3283,5,15,5,16,56,66,-10,50
East Fife,3283,6,14,3,19,49,65,-16,45
Airdrieon,3283,7,11,11,14,47,59,-12,44
Forfar,3283,8,10,5,21,39,66,-27,35
Albion,3283,9,8,6,22,58,81,-23,30
Queen's Park,3283,10,6,10,20,40,74,-34,28
Raith,3284,1,23,8,5,70,32,38,77
Ayr,3284,2,24,4,8,93,43,50,76
Arbroath,3284,3,18,8,10,71,48,23,62
Alloa,3284,4,17,8,11,56,45,11,59
Stranraer,3284,5,16,5,15,57,65,-8,53
Airdrieon,3284,6,10,12,14,47,60,-13,42
East Fife,3284,7,13,3,20,48,66,-18,42
Forfar,3284,8,10,6,20,40,66,-26,36
Albion,3284,9,8,6,22,58,81,-23,30
Queen's Park,3284,10,6,10,20,39,73,-34,28
Ayr,3285,1,24,4,8,93,43,50,76
Raith,3285,2,22,8,6,68,33,35,74
Alloa,3285,3,18,8,10,57,43,14,62
Arbroath,3285,4,17,9,10,72,50,22,60
Stranraer,3285,5,15,6,15,59,68,-9,51
Airdrieon,3285,6,11,11,14,49,60,-11,44
East Fife,3285,7,13,4,19,51,68,-17,43
Forfar,3285,8,10,5,21,40,68,-28,35
Albion,3285,9,8,6,22,58,81,-23,30
Queen's Park,3285,10,6,11,19,41,74,-33,29
Raith,3286,1,22,8,6,68,34,34,74
Ayr,3286,2,23,4,9,91,45,46,73
Alloa,3286,3,18,8,10,58,43,15,62
Arbroath,3286,4,17,9,10,72,50,22,60
Stranraer,3286,5,16,5,15,59,67,-8,53
Airdrieon,3286,6,10,12,14,46,59,-13,42
East Fife,3286,7,13,3,20,50,68,-18,42
Forfar,3286,8,10,6,20,39,65,-26,36
Albion,3286,9,9,6,21,60,79,-19,33
Queen's Park,3286,10,6,11,19,41,74,-33,29
Raith,3287,1,23,8,5,71,32,39,77
Ayr,3287,2,24,4,8,91,42,49,76
Arbroath,3287,3,18,8,10,72,49,23,62
Alloa,3287,4,17,8,11,56,46,10,59
Stranraer,3287,5,15,5,16,56,67,-11,50
East Fife,3287,6,14,3,19,50,65,-15,45
Airdrieon,3287,7,11,11,14,47,59,-12,44
Forfar,3287,8,10,5,21,39,66,-27,35
Albion,3287,9,8,6,22,57,79,-22,30
Queen's Park,3287,10,6,10,20,40,74,-34,28
Ayr,3288,1,23,5,8,94,46,48,74
Raith,3288,2,22,8,6,71,36,35,74
Alloa,3288,3,18,8,10,60,46,14,62
Arbroath,3288,4,17,8,11,71,50,21,59
Stranraer,3288,5,15,5,16,55,65,-10,50
East Fife,3288,6,14,3,19,48,64,-16,45
Airdrieon,3288,7,11,11,14,46,58,-12,44
Forfar,3288,8,10,5,21,38,65,-27,35
Albion,3288,9,8,7,21,61,82,-21,31
Queen's Park,3288,10,7,10,19,41,73,-32,31
Ayr,3289,1,24,4,8,93,43,50,76
Raith,3289,2,22,9,5,69,33,36,75
Arbroath,3289,3,17,9,10,73,51,22,60
Alloa,3289,4,17,9,10,57,44,13,60
Stranraer,3289,5,15,5,16,55,66,-11,50
East Fife,3289,6,14,3,19,49,64,-15,45
Airdrieon,3289,7,11,11,14,47,58,-11,44
Forfar,3289,8,10,5,21,38,66,-28,35
Albion,3289,9,8,6,22,58,81,-23,30
Queen's Park,3289,10,6,11,19,42,75,-33,29
Ayr,3290,1,24,4,8,97,43,54,76
Raith,3290,2,22,8,6,68,33,35,74
Arbroath,3290,3,18,8,10,72,49,23,62
Alloa,3290,4,18,8,10,57,43,14,62
Stranraer,3290,5,15,5,16,56,67,-11,50
East Fife,3290,6,14,3,19,50,65,-15,45
Airdrieon,3290,7,10,12,14,46,59,-13,42
Forfar,3290,8,10,6,20,39,65,-26,36
Albion,3290,9,8,6,22,58,85,-27,30
Queen's Park,3290,10,6,10,20,40,74,-34,28
Raith,3291,1,23,8,5,71,34,37,77
Ayr,3291,2,23,5,8,91,43,48,74
Arbroath,3291,3,17,9,10,72,50,22,60
Alloa,3291,4,17,8,11,58,46,12,59
Stranraer,3291,5,16,5,15,59,65,-6,53
Airdrieon,3291,6,11,11,14,47,58,-11,44
East Fife,3291,7,13,3,20,48,68,-20,42
Forfar,3291,8,10,5,21,38,66,-28,35
Albion,3291,9,8,7,21,58,79,-21,31
Queen's Park,3291,10,6,11,19,41,74,-33,29
Raith,3292,1,22,9,5,69,33,36,75
Ayr,3292,2,23,4,9,90,43,47,73
Alloa,3292,3,17,9,10,57,44,13,60
Arbroath,3292,4,17,8,11,72,52,20,59
Stranraer,3292,5,15,6,15,57,66,-9,51
Airdrieon,3292,6,11,11,14,48,58,-10,44
East Fife,3292,7,13,4,19,49,66,-17,43
Forfar,3292,8,10,5,21,38,67,-29,35
Albion,3292,9,9,6,21,58,78,-20,33
Queen's Park,3292,10,7,10,19,43,74,-31,31
Raith,3293,1,23,8,5,70,32,38,77
Ayr,3293,2,24,4,8,93,43,50,76
Arbroath,3293,3,18,8,10,71,48,23,62
Alloa,3293,4,17,8,11,56,45,11,59
Stranraer,3293,5,15,6,15,56,65,-9,51
Airdrieon,3293,6,11,11,14,48,60,-12,44
East Fife,3293,7,13,4,19,48,65,-17,43
Forfar,3293,8,10,5,21,40,67,-27,35
Albion,3293,9,8,6,22,58,81,-23,30
Queen's Park,3293,10,6,10,20,39,73,-34,28
Raith,3294,1,23,8,5,72,34,38,77
Ayr,3294,2,24,4,8,94,43,51,76
Arbroath,3294,3,17,8,11,72,53,19,59
Alloa,3294,4,17,8,11,58,47,11,59
Stranraer,3294,5,15,6,15,56,65,-9,51
East Fife,3294,6,13,4,19,48,65,-17,43
Airdrieon,3294,7,10,12,14,46,59,-13,42
Forfar,3294,8,10,6,20,39,65,-26,36
Queen's Park,3294,9,7,10,19,44,74,-30,31
Albion,3294,10,8,6,22,58,82,-24,30
Ayr,3295,1,24,4,8,95,46,49,76
Raith,3295,2,22,8,6,69,35,34,74
Arbroath,3295,3,18,8,10,73,49,24,62
Alloa,3295,4,18,8,10,59,44,15,62
Stranraer,3295,5,15,6,15,55,64,-9,51
Airdrieon,3295,6,11,11,14,47,59,-12,44
East Fife,3295,7,13,4,19,47,64,-17,43
Forfar,3295,8,10,5,21,39,66,-27,35
Albion,3295,9,8,6,22,61,83,-22,30
Queen's Park,3295,10,6,10,20,40,75,-35,28
Raith,3296,1,23,8,5,70,33,37,77
Ayr,3296,2,24,4,8,94,43,51,76
Arbroath,3296,3,17,9,10,74,52,22,60
Alloa,3296,4,17,8,11,57,45,12,59
Stranraer,3296,5,15,6,15,56,65,-9,51
Airdrieon,3296,6,11,11,14,47,58,-11,44
East Fife,3296,7,13,4,19,48,65,-17,43
Forfar,3296,8,10,5,21,38,66,-28,35
Albion,3296,9,8,6,22,58,82,-24,30
Queen's Park,3296,10,6,11,19,43,76,-33,29
Ayr,3297,1,24,4,8,95,44,51,76
Raith,3297,2,22,8,6,68,33,35,74
Arbroath,3297,3,18,8,10,72,49,23,62
Alloa,3297,4,18,8,10,57,43,14,62
Stranraer,3297,5,15,5,16,55,66,-11,50
East Fife,3297,6,14,3,19,49,64,-15,45
Airdrieon,3297,7,11,11,14,47,58,-11,44
Forfar,3297,8,10,5,21,38,66,-28,35
Albion,3297,9,8,6,22,59,83,-24,30
Queen's Park,3297,10,6,10,20,40,74,-34,28
Ayr,3298,1,24,4,8,95,46,49,76
Raith,3298,2,22,8,6,68,34,34,74
Alloa,3298,3,18,8,10,58,43,15,62
Arbroath,3298,4,17,9,10,71,49,22,60
Stranraer,3298,5,15,5,16,55,65,-10,50
East Fife,3298,6,14,3,19,48,64,-16,45
Airdrieon,3298,7,11,11,14,47,58,-11,44
Forfar,3298,8,10,5,21,38,66,-28,35
Albion,3298,9,8,6,22,61,83,-22,30
Queen's Park,3298,10,6,11,19,40,73,-33,29
Ayr,3299,1,24,4,8,96,44,52,76
Raith,3299,2,22,9,5,70,34,36,75
Arbroath,3299,3,18,8,10,71,48,23,62
Alloa,3299,4,17,9,10,58,45,13,60
Stranraer,3299,5,15,5,16,57,68,-11,50
East Fife,3299,6,14,3,19,51,66,-15,45
Airdrieon,3299,7,10,12,14,45,58,-13,42
Forfar,3299,8,10,6,20,38,64,-26,36
Albion,3299,9,8,6,22,59,84,-25,30
Queen's Park,3299,10,6,10,20,39,73,-34,28
Raith,3300,1,23,8,5,69,32,37,77
Ayr,3300,2,24,4,8,91,42,49,76
Arbroath,3300,3,18,8,10,72,49,23,62
Alloa,3300,4,17,8,11,56,44,12,59
Stranraer,3300,5,15,6,15,56,65,-9,51
Airdrieon,3300,6,11,11,14,47,58,-11,44
East Fife,3300,7,13,4,19,48,65,-17,43
Forfar,3300,8,10,5,21,38,66,-28,35
Albion,3300,9,8,6,22,57,79,-22,30
Queen's Park,3300,10,6,10,20,40,74,-34,28
Ayr,3301,1,23,5,8,92,44,48,74
Raith,3301,2,22,8,6,70,35,35,74
Arbroath,3301,3,18,8,10,73,49,24,62
Alloa,3301,4,18,8,10,59,45,14,62
Stranraer,3301,5,16,5,15,58,65,-7,53
East Fife,3301,6,13,3,20,48,67,-19,42
Airdrieon,3301,7,10,11,15,45,60,-15,41
Forfar,3301,8,11,5,20,40,64,-24,38
Albion,3301,9,8,7,21,59,80,-21,31
Queen's Park,3301,10,6,10,20,40,75,-35,28
Raith,3302,1,23,8,5,70,33,37,77
Ayr,3302,2,24,4,8,95,43,52,76
Arbroath,3302,3,18,8,10,74,49,25,62
Alloa,3302,4,17,8,11,57,45,12,59
Stranraer,3302,5,16,5,15,57,65,-8,53
Airdrieon,3302,6,10,12,14,45,58,-13,42
East Fife,3302,7,13,3,20,48,66,-18,42
Forfar,3302,8,10,6,20,38,64,-26,36
Albion,3302,9,8,6,22,58,83,-25,30
Queen's Park,3302,10,6,10,20,40,76,-36,28
Raith,3303,1,23,8,5,71,32,39,77
Ayr,3303,2,24,4,8,96,44,52,76
Arbroath,3303,3,17,9,10,71,49,22,60
Alloa,3303,4,17,8,11,56,46,10,59
Stranraer,3303,5,15,5,16,55,65,-10,50
East Fife,3303,6,14,3,19,48,64,-16,45
Airdrieon,3303,7,10,11,15,46,60,-14,41
Forfar,3303,8,11,5,20,40,65,-25,38
Albion,3303,9,8,6,22,59,84,-25,30
Queen's Park,3303,10,6,11,19,40,73,-33,29
Raith,3304,1,23,8,5,70,33,37,77
Ayr,3304,2,24,4,8,91,42,49,76
Arbroath,3304,3,18,8,10,74,49,25,62
Alloa,3304,4,17,8,11,57,45,12,59
Stranraer,3304,5,16,5,15,56,64,-8,53
Airdrieon,3304,6,11,11,14,48,58,-10,44
East Fife,3304,7,13,3,20,47,65,-18,42
Forfar,3304,8,10,5,21,38,67,-29,35
Albion,3304,9,8,6,22,57,79,-22,30
Queen's Park,3304,10,6,10,20,40,76,-36,28
Raith,3305,1,23,8,5,70,33,37,77
Ayr,3305,2,24,4,8,94,42,52,76
Arbroath,3305,3,17,9,10,70,48,22,60
Alloa,3305,4,17,8,11,57,45,12,59
Stranraer,3305,5,16,5,15,56,64,-8,53
East Fife,3305,6,13,3,20,47,65,-18,42
Airdrieon,3305,7,10,11,15,45,60,-15,41
Forfar,3305,8,11,5,20,40,64,-24,38
Albion,3305,9,8,6,22,57,82,-25,30
Queen's Park,3305,10,6,11,19,39,72,-33,29
Raith,3306,1,23,8,5,72,33,39,77
Ayr,3306,2,24,4,8,93,43,50,76
Arbroath,3306,3,18,8,10,73,50,23,62
Alloa,3306,4,17,8,11,57,47,10,59
Stranraer,3306,5,15,6,15,56,65,-9,51
Airdrieon,3306,6,11,11,14,48,60,-12,44
East Fife,3306,7,13,4,19,48,65,-17,43
Forfar,3306,8,10,5,21,40,67,-27,35
Albion,3306,9,8,6,22,58,81,-23,30
Queen's Park,3306,10,6,10,20,41,75,-34,28
Raith,3307,1,22,9,5,68,32,36,75
Ayr,3307,2,23,4,9,93,46,47,73
Arbroath,3307,3,17,9,10,71,49,22,60
Alloa,3307,4,17,9,10,56,43,13,60
Stranraer,3307,5,15,6,15,55,64,-9,51
East Fife,3307,6,13,4,19,47,64,-17,43
Airdrieon,3307,7,10,11,15,46,60,-14,41
Forfar,3307,8,11,5,20,40,65,-25,38
Albion,3307,9,9,6,21,61,81,-20,33
Queen's Park,3307,10,6,11,19,40,73,-33,29
Ayr,3308,1,24,4,8,97,43,54,76
Raith,3308,2,22,9,5,70,34,36,75
Arbroath,3308,3,18,8,10,72,48,24,62
Alloa,3308,4,17,9,10,58,45,13,60
Stranraer,3308,5,15,5,16,55,65,-10,50
East Fife,3308,6,14,3,19,48,64,-16,45
Airdrieon,3308,7,10,11,15,45,59,-14,41
Forfar,3308,8,11,5,20,39,64,-25,38
Albion,3308,9,8,6,22,58,85,-27,30
Queen's Park,3308,10,6,10,20,39,74,-35,28
Ayr,3309,1,24,4,8,94,43,51,76
Raith,3309,2,22,9,5,69,33,36,75
Arbroath,3309,3,17,9,10,71,49,22,60
Alloa,3309,4,17,9,10,57,44,13,60
Stranraer,3309,5,15,5,16,55,65,-10,50
East Fife,3309,6,14,3,19,48,64,-16,45
Airdrieon,3309,7,10,11,15,45,60,-15,41
Forfar,3309,8,11,5,20,40,64,-24,38
Albion,3309,9,8,6,22,58,82,-24,30
Queen's Park,3309,10,6,11,19,40,73,-33,29
Raith,3310,1,22,8,6,70,36,34,74
Ayr,3310,2,23,4,9,92,46,46,73
Alloa,3310,3,18,8,10,60,45,15,62
Arbroath,3310,4,17,8,11,72,52,20,59
Stranraer,3310,5,16,5,15,57,64,-7,53
Airdrieon,3310,6,11,11,14,46,58,-12,44
East Fife,3310,7,13,3,20,47,66,-19,42
Forfar,3310,8,10,5,21,38,65,-27,35
Albion,3310,9,9,6,21,61,80,-19,33
Queen's Park,3310,10,7,10,19,43,74,-31,31
Ayr,3311,1,23,5,8,93,45,48,74
Raith,3311,2,22,8,6,70,35,35,74
Alloa,3311,3,18,8,10,59,45,14,62
Arbroath,3311,4,17,8,11,70,49,21,59
Stranraer,3311,5,15,5,16,56,66,-10,50
East Fife,3311,6,14,3,19,49,65,-16,45
Airdrieon,3311,7,11,11,14,50,59,-9,44
Forfar,3311,8,10,5,21,39,69,-30,35
Albion,3311,9,8,7,21,60,81,-21,31
Queen's Park,3311,10,7,10,19,40,72,-32,31
Raith,3312,1,23,8,5,69,32,37,77
Ayr,3312,2,23,5,8,92,44,48,74
Arbroath,3312,3,18,8,10,72,49,23,62
Alloa,3312,4,17,8,11,56,44,12,59
Stranraer,3312,5,15,6,15,55,64,-9,51
Airdrieon,3312,6,11,11,14,48,59,-11,44
East Fife,3312,7,13,4,19,47,64,-17,43
Forfar,3312,8,10,5,21,39,67,-28,35
Albion,3312,9,8,7,21,59,80,-21,31
Queen's Park,3312,10,6,10,20,40,74,-34,28
Ayr,3313,1,24,4,8,95,43,52,76
Raith,3313,2,22,9,5,69,33,36,75
Arbroath,3313,3,17,9,10,70,48,22,60
Alloa,3313,4,17,9,10,57,44,13,60
Stranraer,3313,5,15,5,16,56,67,-11,50
East Fife,3313,6,14,3,19,50,65,-15,45
Airdrieon,3313,7,10,12,14,46,59,-13,42
Forfar,3313,8,10,6,20,39,65,-26,36
Albion,3313,9,8,6,22,58,83,-25,30
Queen's Park,3313,10,6,11,19,39,72,-33,29
Raith,3314,1,23,8,5,70,32,38,77
Ayr,3314,2,24,4,8,94,45,49,76
Arbroath,3314,3,17,8,11,74,53,21,59
Alloa,3314,4,17,8,11,56,45,11,59
Stranraer,3314,5,15,6,15,55,64,-9,51
Airdrieon,3314,6,11,11,14,48,59,-11,44
East Fife,3314,7,13,4,19,47,64,-17,43
Forfar,3314,8,10,5,21,39,67,-28,35
Queen's Park,3314,9,7,10,19,44,76,-32,31
Albion,3314,10,8,6,22,60,82,-22,30
Raith,3315,1,22,9,5,70,34,36,75
Ayr,3315,2,23,4,9,90,43,47,73
Arbroath,3315,3,18,8,10,71,48,23,62
Alloa,3315,4,17,9,10,58,45,13,60
Stranraer,3315,5,15,5,16,56,66,-10,50
East Fife,3315,6,14,3,19,49,65,-16,45
Airdrieon,3315,7,10,11,15,46,60,-14,41
Forfar,3315,8,11,5,20,40,65,-25,38
Albion,3315,9,9,6,21,58,78,-20,33
Queen's Park,3315,10,6,10,20,39,73,-34,28
Raith,3316,1,23,8,5,70,33,37,77
Ayr,3316,2,24,4,8,92,43,49,76
Arbroath,3316,3,18,8,10,72,49,23,62
Alloa,3316,4,17,8,11,57,45,12,59
Stranraer,3316,5,16,5,15,58,66,-8,53
East Fife,3316,6,13,3,20,49,67,-18,42
Airdrieon,3316,7,10,11,15,46,60,-14,41
Forfar,3316,8,11,5,20,40,65,-25,38
Albion,3316,9,8,6,22,58,80,-22,30
Queen's Park,3316,10,6,10,20,40,74,-34,28
Raith,3317,1,23,8,5,70,32,38,77
Ayr,3317,2,24,4,8,92,43,49,76
Arbroath,3317,3,17,9,10,70,48,22,60
Alloa,3317,4,17,8,11,56,45,11,59
Stranraer,3317,5,16,5,15,57,65,-8,53
Airdrieon,3317,6,11,11,14,46,58,-12,44
East Fife,3317,7,13,3,20,48,66,-18,42
Forfar,3317,8,10,5,21,38,65,-27,35
Albion,3317,9,8,6,22,58,80,-22,30
Queen's Park,3317,10,6,11,19,39,72,-33,29
Ayr,3318,1,24,4,8,94,43,51,76
Raith,3318,2,22,9,5,68,32,36,75
Arbroath,3318,3,18,8,10,72,48,24,62
Alloa,3318,4,17,9,10,56,43,13,60
Stranraer,3318,5,16,5,15,58,66,-8,53
Airdrieon,3318,6,10,12,14,45,58,-13,42
East Fife,3318,7,13,3,20,49,67,-18,42
Forfar,3318,8,10,6,20,38,64,-26,36
Albion,3318,9,8,6,22,58,82,-24,30
Queen's Park,3318,10,6,10,20,39,74,-35,28
Raith,3319,1,23,8,5,69,32,37,77
Ayr,3319,2,23,5,8,90,42,48,74
Arbroath,3319,3,18,8,10,71,48,23,62
Alloa,3319,4,17,8,11,56,44,12,59
Stranraer,3319,5,16,5,15,57,64,-7,53
East Fife,3319,6,13,3,20,47,66,-19,42
Airdrieon,3319,7,10,11,15,46,60,-14,41
Forfar,3319,8,11,5,20,40,65,-25,38
Albion,3319,9,8,7,21,57,78,-21,31
Queen's Park,3319,10,6,10,20,39,73,-34,28
Ayr,3320,1,24,4,8,93,44,49,76
Raith,3320,2,22,9,5,68,32,36,75
Arbroath,3320,3,18,8,10,72,49,23,62
Alloa,3320,4,17,9,10,56,43,13,60
Stranraer,3320,5,15,5,16,55,68,-13,50
East Fife,3320,6,14,3,19,51,64,-13,45
Airdrieon,3320,7,11,11,14,48,58,-10,44
Forfar,3320,8,10,5,21,38,67,-29,35
Albion,3320,9,8,6,22,59,81,-22,30
Queen's Park,3320,10,6,10,20,40,74,-34,28
Raith,3321,1,23,8,5,71,32,39,77
Ayr,3321,2,24,4,8,91,42,49,76
Arbroath,3321,3,17,8,11,71,50,21,59
Alloa,3321,4,17,8,11,56,46,10,59
Stranraer,3321,5,15,5,16,55,68,-13,50
East Fife,3321,6,14,3,19,51,64,-13,45
Airdrieon,3321,7,10,12,14,46,59,-13,42
Forfar,3321,8,10,6,20,39,65,-26,36
Queen's Park,3321,9,7,10,19,41,73,-32,31
Albion,3321,10,8,6,22,57,79,-22,30
Raith,3322,1,23,8,5,71,32,39,77
Ayr,3322,2,24,4,8,91,42,49,76
Arbroath,3322,3,17,8,11,70,51,19,59
Alloa,3322,4,17,8,11,56,46,10,59
Stranraer,3322,5,16,5,15,60,64,-4,53
Airdrieon,3322,6,11,11,14,46,58,-12,44
East Fife,3322,7,13,3,20,47,69,-22,42
Forfar,3322,8,10,5,21,38,65,-27,35
Queen's Park,3322,9,7,10,19,42,72,-30,31
Albion,3322,10,8,6,22,57,79,-22,30
Ayr,3323,1,24,4,8,93,42,51,76
Raith,3323,2,22,9,5,69,33,36,75
Alloa,3323,3,17,9,10,57,44,13,60
Arbroath,3323,4,17,8,11,71,50,21,59
Stranraer,3323,5,16,5,15,58,65,-7,53
Airdrieon,3323,6,10,12,14,46,59,-13,42
East Fife,3323,7,13,3,20,48,67,-19,42
Forfar,3323,8,10,6,20,39,65,-26,36
Queen's Park,3323,9,7,10,19,41,73,-32,31
Albion,3323,10,8,6,22,57,81,-24,30
Raith,3324,1,23,8,5,70,32,38,77
Ayr,3324,2,24,4,8,91,42,49,76
Arbroath,3324,3,17,9,10,71,49,22,60
Alloa,3324,4,17,8,11,56,45,11,59
Stranraer,3324,5,16,5,15,57,65,-8,53
Airdrieon,3324,6,11,11,14,47,59,-12,44
East Fife,3324,7,13,3,20,48,66,-18,42
Forfar,3324,8,10,5,21,39,66,-27,35
Albion,3324,9,8,6,22,57,79,-22,30
Queen's Park,3324,10,6,11,19,40,73,-33,29
Raith,3325,1,23,8,5,71,33,38,77
Ayr,3325,2,24,4,8,94,42,52,76
Arbroath,3325,3,18,8,10,73,50,23,62
Alloa,3325,4,17,8,11,57,46,11,59
Stranraer,3325,5,15,5,16,57,67,-10,50
East Fife,3325,6,14,3,19,50,66,-16,45
Airdrieon,3325,7,10,12,14,45,58,-13,42
Forfar,3325,8,10,6,20,38,64,-26,36
Albion,3325,9,8,6,22,57,82,-25,30
Queen's Park,3325,10,6,10,20,41,75,-34,28
Raith,3326,1,23,8,5,71,33,38,77
Ayr,3326,2,24,4,8,94,43,51,76
Arbroath,3326,3,18,8,10,74,50,24,62
Alloa,3326,4,17,8,11,57,46,11,59
Stranraer,3326,5,15,6,15,55,64,-9,51
Airdrieon,3326,6,11,11,14,46,58,-12,44
East Fife,3326,7,13,4,19,47,64,-17,43
Forfar,3326,8,10,5,21,38,65,-27,35
Albion,3326,9,8,6,22,58,82,-24,30
Queen's Park,3326,10,6,10,20,41,76,-35,28
Raith,3327,1,23,8,5,69,32,37,77
Ayr,3327,2,24,4,8,95,42,53,76
Arbroath,3327,3,18,8,10,72,48,24,62
Alloa,3327,4,17,8,11,56,44,12,59
Stranraer,3327,5,15,5,16,56,66,-10,50
East Fife,3327,6,14,3,19,49,65,-16,45
Airdrieon,3327,7,10,11,15,46,60,-14,41
Forfar,3327,8,11,5,20,40,65,-25,38
Albion,3327,9,8,6,22,57,83,-26,30
Queen's Park,3327,10,6,10,20,39,74,-35,28
Raith,3328,1,22,9,5,69,33,36,75
Ayr,3328,2,23,5,8,92,44,48,74
Arbroath,3328,3,18,8,10,74,50,24,62
Alloa,3328,4,17,9,10,57,44,13,60
Stranraer,3328,5,16,5,15,58,65,-7,53
Airdrieon,3328,6,11,11,14,48,58,-10,44
East Fife,3328,7,13,3,20,48,67,-19,42
Forfar,3328,8,10,5,21,38,67,-29,35
Albion,3328,9,8,7,21,59,80,-21,31
Queen's Park,3328,10,6,10,20,41,76,-35,28
Raith,3329,1,23,8,5,72,32,40,77
Ayr,3329,2,24,4,8,93,43,50,76
Arbroath,3329,3,17,9,10,71,49,22,60
Alloa,3329,4,17,8,11,56,47,9,59
Stranraer,3329,5,15,5,16,56,67,-11,50
East Fife,3329,6,14,3,19,50,65,-15,45
Airdrieon,3329,7,11,11,14,47,58,-11,44
Forfar,3329,8,10,5,21,38,66,-28,35
Albion,3329,9,8,6,22,58,81,-23,30
Queen's Park,3329,10,6,11,19,40,73,-33,29
Ayr,3330,1,24,4,8,95,42,53,76
Raith,3330,2,22,8,6,68,36,32,74
Alloa,3330,3,18,8,10,60,43,17,62
Arbroath,3330,4,17,9,10,71,49,22,60
Stranraer,3330,5,15,5,16,55,65,-10,50
East Fife,3330,6,14,3,19,48,64,-16,45
Airdrieon,3330,7,10,11,15,46,60,-14,41
Forfar,3330,8,11,5,20,40,65,-25,38
Albion,3330,9,8,6,22,57,83,-26,30
Queen's Park,3330,10,6,11,19,40,73,-33,29
Raith,3331,1,23,8,5,70,33,37,77
Ayr,3331,2,24,4,8,94,42,52,76
Arbroath,3331,3,17,8,11,72,51,21,59
Alloa,3331,4,17,8,11,57,45,12,59
Stranraer,3331,5,16,5,15,58,64,-6,53
Airdrieon,3331,6,11,11,14,48,59,-11,44
East Fife,3331,7,13,3,20,47,67,-20,42
Forfar,3331,8,10,5,21,39,67,-28,35
Queen's Park,3331,9,7,10,19,42,74,-32,31
Albion,3331,10,8,6,22,57,82,-25,30
Raith,3332,1,23,8,5,70,33,37,77
Ayr,3332,2,24,4,8,94,44,50,76
Arbroath,3332,3,17,9,10,71,49,22,60
Alloa,3332,4,17,8,11,57,45,12,59
Stranraer,3332,5,15,5,16,57,67,-10,50
East Fife,3332,6,14,3,19,50,66,-16,45
Airdrieon,3332,7,10,12,14,47,60,-13,42
Forfar,3332,8,10,6,20,40,66,-26,36
Albion,3332,9,8,6,22,59,82,-23,30
Queen's Park,3332,10,6,11,19,40,73,-33,29
Raith,3333,1,23,8,5,71,33,38,77
Ayr,3333,2,24,4,8,95,43,52,76
Arbroath,3333,3,18,8,10,72,49,23,62
Alloa,3333,4,17,8,11,57,46,11,59
Stranraer,3333,5,15,5,16,55,65,-10,50
East Fife,3333,6,14,3,19,48,64,-16,45
Airdrieon,3333,7,11,11,14,47,59,-12,44
Forfar,3333,8,10,5,21,39,66,-27,35
Albion,3333,9,8,6,22,58,83,-25,30
Queen's Park,3333,10,6,10,20,40,74,-34,28
Raith,3334,1,23,8,5,72,33,39,77
Ayr,3334,2,23,4,9,92,45,47,73
Arbroath,3334,3,18,8,10,73,50,23,62
Alloa,3334,4,17,8,11,57,47,10,59
Stranraer,3334,5,15,5,16,55,66,-11,50
East Fife,3334,6,14,3,19,49,64,-15,45
Airdrieon,3334,7,11,11,14,46,58,-12,44
Forfar,3334,8,10,5,21,38,65,-27,35
Albion,3334,9,9,6,21,60,80,-20,33
Queen's Park,3334,10,6,10,20,41,75,-34,28
Raith,3335,1,23,8,5,71,33,38,77
Ayr,3335,2,24,4,8,91,42,49,76
Arbroath,3335,3,18,8,10,73,50,23,62
Alloa,3335,4,17,8,11,57,46,11,59
Stranraer,3335,5,15,5,16,55,66,-11,50
East Fife,3335,6,14,3,19,49,64,-15,45
Airdrieon,3335,7,10,11,15,45,59,-14,41
Forfar,3335,8,11,5,20,39,64,-25,38
Albion,3335,9,8,6,22,57,79,-22,30
Queen's Park,3335,10,6,10,20,41,75,-34,28
Raith,3336,1,23,8,5,71,33,38,77
Ayr,3336,2,24,4,8,92,42,50,76
Arbroath,3336,3,17,8,11,70,50,20,59
Alloa,3336,4,17,8,11,57,46,11,59
Stranraer,3336,5,15,6,15,57,66,-9,51
East Fife,3336,6,13,4,19,49,66,-17,43
Airdrieon,3336,7,10,12,14,46,59,-13,42
Forfar,3336,8,10,6,20,39,65,-26,36
Queen's Park,3336,9,7,10,19,41,72,-31,31
Albion,3336,10,8,6,22,57,80,-23,30
Ayr,3337,1,23,5,8,91,43,48,74
Raith,3337,2,22,8,6,69,34,35,74
Alloa,3337,3,18,8,10,58,44,14,62
Arbroath,3337,4,17,8,11,71,50,21,59
Stranraer,3337,5,15,6,15,57,66,-9,51
Airdrieon,3337,6,11,11,14,46,58,-12,44
East Fife,3337,7,13,4,19,49,66,-17,43
Forfar,3337,8,10,5,21,38,65,-27,35
Albion,3337,9,8,7,21,58,79,-21,31
Queen's Park,3337,10,7,10,19,41,73,-32,31
Raith,3338,1,23,8,5,69,32,37,77
Ayr,3338,2,23,5,8,93,45,48,74
Arbroath,3338,3,17,9,10,70,48,22,60
Alloa,3338,4,17,8,11,56,44,12,59
Stranraer,3338,5,15,5,16,56,67,-11,50
East Fife,3338,6,14,3,19,50,65,-15,45
Airdrieon,3338,7,11,11,14,49,60,-11,44
Forfar,3338,8,10,5,21,40,68,-28,35
Albion,3338,9,8,7,21,60,81,-21,31
Queen's Park,3338,10,6,11,19,39,72,-33,29
Raith,3339,1,23,8,5,72,33,39,77
Ayr,3339,2,24,4,8,95,43,52,76
Arbroath,3339,3,17,8,11,71,51,20,59
Alloa,3339,4,17,8,11,57,47,10,59
Stranraer,3339,5,16,5,15,58,64,-6,53
Airdrieon,3339,6,11,11,14,48,59,-11,44
East Fife,3339,7,13,3,20,47,67,-20,42
Forfar,3339,8,10,5,21,39,67,-28,35
Queen's Park,3339,9,7,10,19,42,73,-31,31
Albion,3339,10,8,6,22,58,83,-25,30
Raith,3340,1,23,8,5,70,33,37,77
Ayr,3340,2,23,4,9,91,45,46,73
Arbroath,3340,3,18,8,10,71,48,23,62
Alloa,3340,4,17,8,11,57,45,12,59
Stranraer,3340,5,16,5,15,60,68,-8,53
Airdrieon,3340,6,10,12,14,46,59,-13,42
East Fife,3340,7,13,3,20,51,69,-18,42
Forfar,3340,8,10,6,20,39,65,-26,36
Albion,3340,9,9,6,21,60,79,-19,33
Queen's Park,3340,10,6,10,20,39,73,-34,28
Raith,3341,1,23,8,5,71,32,39,77
Ayr,3341,2,24,4,8,94,43,51,76
Arbroath,3341,3,18,8,10,73,49,24,62
Alloa,3341,4,17,8,11,56,46,10,59
Stranraer,3341,5,15,5,16,56,67,-11,50
East Fife,3341,6,14,3,19,50,65,-15,45
Airdrieon,3341,7,11,11,14,48,60,-12,44
Forfar,3341,8,10,5,21,40,67,-27,35
Albion,3341,9,8,6,22,58,82,-24,30
Queen's Park,3341,10,6,10,20,40,75,-35,28
Raith,3342,1,23,8,5,71,32,39,77
Ayr,3342,2,23,4,9,92,45,47,73
Arbroath,3342,3,17,9,10,71,49,22,60
Alloa,3342,4,17,8,11,56,46,10,59
Stranraer,3342,5,15,6,15,57,66,-9,51
Airdrieon,3342,6,11,11,14,47,58,-11,44
East Fife,3342,7,13,4,19,49,66,-17,43
Forfar,3342,8,10,5,21,38,66,-28,35
Albion,3342,9,9,6,21,60,80,-20,33
Queen's Park,3342,10,6,11,19,40,73,-33,29
Ayr,3343,1,24,4,8,94,44,50,76
Raith,3343,2,22,9,5,70,34,36,75
Arbroath,3343,3,18,8,10,72,48,24,62
Alloa,3343,4,17,9,10,58,45,13,60
Stranraer,3343,5,16,5,15,60,66,-6,53
Airdrieon,3343,6,11,11,14,48,58,-10,44
East Fife,3343,7,13,3,20,49,69,-20,42
Forfar,3343,8,10,5,21,38,67,-29,35
Albion,3343,9,8,6,22,59,82,-23,30
Queen's Park,3343,10,6,10,20,39,74,-35,28
Raith,3344,1,23,8,5,70,33,37,77
Ayr,3344,2,24,4,8,93,44,49,76
Arbroath,3344,3,18,8,10,72,48,24,62
Alloa,3344,4,17,8,11,57,45,12,59
Stranraer,3344,5,15,5,16,55,65,-10,50
East Fife,3344,6,14,3,19,48,64,-16,45
Airdrieon,3344,7,11,11,14,46,58,-12,44
Forfar,3344,8,10,5,21,38,65,-27,35
Albion,3344,9,8,6,22,59,81,-22,30
Queen's Park,3344,10,6,10,20,39,74,-35,28
Ayr,3345,1,24,4,8,95,42,53,76
Raith,3345,2,22,9,5,68,32,36,75
Arbroath,3345,3,17,9,10,70,48,22,60
Alloa,3345,4,17,9,10,56,43,13,60
Stranraer,3345,5,16,5,15,57,64,-7,53
Airdrieon,3345,6,11,11,14,49,58,-9,44
East Fife,3345,7,13,3,20,47,66,-19,42
Forfar,3345,8,10,5,21,38,68,-30,35
Albion,3345,9,8,6,22,57,83,-26,30
Queen's Park,3345,10,6,11,19,39,72,-33,29
Raith,3346,1,22,9,5,70,34,36,75
Ayr,3346,2,23,5,8,93,45,48,74
Alloa,3346,3,17,9,10,58,45,13,60
Arbroath,3346,4,17,8,11,70,49,21,59
Stranraer,3346,5,15,6,15,57,66,-9,51
East Fife,3346,6,13,4,19,49,66,-17,43
Airdrieon,3346,7,10,12,14,48,61,-13,42
Forfar,3346,8,10,6,20,41,67,-26,36
Albion,3346,9,8,7,21,60,81,-21,31
Queen's Park,3346,10,7,10,19,40,72,-32,31
Raith,3347,1,23,8,5,70,32,38,77
Ayr,3347,2,24,4,8,96,43,53,76
Arbroath,3347,3,17,9,10,71,49,22,60
Alloa,3347,4,17,8,11,56,45,11,59
Stranraer,3347,5,16,5,15,57,64,-7,53
East Fife,3347,6,13,3,20,47,66,-19,42
Airdrieon,3347,7,10,11,15,46,61,-15,41
Forfar,3347,8,11,5,20,41,65,-24,38
Albion,3347,9,8,6,22,58,84,-26,30
Queen's Park,3347,10,6,11,19,40,73,-33,29
Ayr,3348,1,24,4,8,97,42,55,76
Raith,3348,2,22,8,6,69,35,34,74
Alloa,3348,3,18,8,10,59,44,15,62
Arbroath,3348,4,17,9,10,71,49,22,60
Stranraer,3348,5,15,5,16,56,66,-10,50
East Fife,3348,6,14,3,19,49,65,-16,45
Airdrieon,3348,7,11,11,14,48,58,-10,44
Forfar,3348,8,10,5,21,38,67,-29,35
Albion,3348,9,8,6,22,57,85,-28,30
Queen's Park,3348,10,6,11,19,40,73,-33,29
Ayr,3349,1,24,4,8,94,42,52,76
Raith,3349,2,22,9,5,70,34,36,75
Arbroath,3349,3,18,8,10,73,48,25,62
Alloa,3349,4,17,9,10,58,45,13,60
Stranraer,3349,5,15,5,16,56,67,-11,50
East Fife,3349,6,14,3,19,50,65,-15,45
Airdrieon,3349,7,10,12,14,46,59,-13,42
Forfar,3349,8,10,6,20,39,65,-26,36
Albion,3349,9,8,6,22,57,82,-25,30
Queen's Park,3349,10,6,10,20,39,75,-36,28
Ayr,3350,1,24,4,8,92,43,49,76
Raith,3350,2,22,9,5,68,32,36,75
Arbroath,3350,3,18,8,10,73,49,24,62
Alloa,3350,4,17,9,10,56,43,13,60
Stranraer,3350,5,15,6,15,55,64,-9,51
East Fife,3350,6,13,4,19,47,64,-17,43
Airdrieon,3350,7,10,11,15,46,60,-14,41
Forfar,3350,8,11,5,20,40,65,-25,38
Albion,3350,9,8,6,22,58,80,-22,30
Queen's Park,3350,10,6,10,20,40,75,-35,28
Ayr,3351,1,24,4,8,96,42,54,76
Raith,3351,2,22,8,6,68,33,35,74
Arbroath,3351,3,18,8,10,73,48,25,62
Alloa,3351,4,18,8,10,57,43,14,62
Stranraer,3351,5,15,5,16,55,65,-10,50
East Fife,3351,6,14,3,19,48,64,-16,45
Airdrieon,3351,7,11,11,14,48,58,-10,44
Forfar,3351,8,10,5,21,38,67,-29,35
Albion,3351,9,8,6,22,57,84,-27,30
Queen's Park,3351,10,6,10,20,39,75,-36,28
Raith,3352,1,23,8,5,69,32,37,77
Ayr,3352,2,24,4,8,98,44,54,76
Arbroath,3352,3,17,9,10,72,50,22,60
Alloa,3352,4,17,8,11,56,44,12,59
Stranraer,3352,5,15,5,16,56,66,-10,50
East Fife,3352,6,14,3,19,49,65,-16,45
Airdrieon,3352,7,10,11,15,45,59,-14,41
Forfar,3352,8,11,5,20,39,64,-25,38
Albion,3352,9,8,6,22,59,86,-27,30
Queen's Park,3352,10,6,11,19,41,74,-33,29
Ayr,3353,1,24,4,8,97,42,55,76
Raith,3353,2,22,8,6,69,34,35,74
Alloa,3353,3,18,8,10,58,44,14,62
Arbroath,3353,4,17,8,11,70,50,20,59
Stranraer,3353,5,16,5,15,56,64,-8,53
East Fife,3353,6,13,3,20,47,65,-18,42
Airdrieon,3353,7,10,11,15,46,60,-14,41
Forfar,3353,8,11,5,20,40,65,-25,38
Queen's Park,3353,9,7,10,19,41,72,-31,31
Albion,3353,10,8,6,22,57,85,-28,30
Raith,3354,1,23,8,5,70,33,37,77
Ayr,3354,2,24,4,8,96,42,54,76
Arbroath,3354,3,17,9,10,71,49,22,60
Alloa,3354,4,17,8,11,57,45,12,59
Stranraer,3354,5,16,5,15,59,67,-8,53
Airdrieon,3354,6,11,11,14,48,59,-11,44
East Fife,3354,7,13,3,20,50,68,-18,42
Forfar,3354,8,10,5,21,39,67,-28,35
Albion,3354,9,8,6,22,57,84,-27,30
Queen's Park,3354,10,6,11,19,40,73,-33,29
Raith,3355,1,23,8,5,70,32,38,77
Ayr,3355,2,24,4,8,93,43,50,76
Arbroath,3355,3,17,9,10,71,49,22,60
Alloa,3355,4,17,8,11,56,45,11,59
Stranraer,3355,5,15,5,16,55,65,-10,50
East Fife,3355,6,14,3,19,48,64,-16,45
Airdrieon,3355,7,10,11,15,46,61,-15,41
Forfar,3355,8,11,5,20,41,65,-24,38
Albion,3355,9,8,6,22,58,81,-23,30
Queen's Park,3355,10,6,11,19,40,73,-33,29
Raith,3356,1,23,8,5,69,32,37,77
Ayr,3356,2,24,4,8,94,43,51,76
Arbroath,3356,3,17,9,10,71,49,22,60
Alloa,3356,4,17,8,11,56,44,12,59
Stranraer,3356,5,16,5,15,56,64,-8,53
Airdrieon,3356,6,10,12,14,46,59,-13,42
East Fife,3356,7,13,3,20,47,65,-18,42
Forfar,3356,8,10,6,20,39,65,-26,36
Albion,3356,9,8,6,22,58,82,-24,30
Queen's Park,3356,10,6,11,19,40,73,-33,29
Ayr,3357,1,24,4,8,93,43,50,76
Raith,3357,2,22,8,6,70,35,35,74
Arbroath,3357,3,18,8,10,76,49,27,62
Alloa,3357,4,18,8,10,59,45,14,62
Stranraer,3357,5,15,5,16,56,70,-14,50
East Fife,3357,6,14,3,19,53,65,-12,45
Airdrieon,3357,7,11,11,14,47,58,-11,44
Forfar,3357,8,10,5,21,38,66,-28,35
Albion,3357,9,8,6,22,58,81,-23,30
Queen's Park,3357,10,6,10,20,40,78,-38,28
Raith,3358,1,23,8,5,69,32,37,77
Ayr,3358,2,24,4,8,96,42,54,76
Arbroath,3358,3,18,8,10,72,48,24,62
Alloa,3358,4,17,8,11,56,44,12,59
Stranraer,3358,5,15,5,16,58,68,-10,50
East Fife,3358,6,14,3,19,51,67,-16,45
Airdrieon,3358,7,11,11,14,48,58,-10,44
Forfar,3358,8,10,5,21,38,67,-29,35
Albion,3358,9,8,6,22,57,84,-27,30
Queen's Park,3358,10,6,10,20,39,74,-35,28
Ayr,3359,1,24,4,8,95,44,51,76
Raith,3359,2,22,9,5,69,33,36,75
Arbroath,3359,3,18,8,10,71,48,23,62
Alloa,3359,4,17,9,10,57,44,13,60
Stranraer,3359,5,15,5,16,56,68,-12,50
East Fife,3359,6,14,3,19,51,65,-14,45
Airdrieon,3359,7,10,11,15,45,60,-15,41
Forfar,3359,8,11,5,20,40,64,-24,38
Albion,3359,9,8,6,22,59,83,-24,30
Queen's Park,3359,10,6,10,20,39,73,-34,28
Raith,3360,1,23,8,5,72,35,37,77
Ayr,3360,2,24,4,8,95,43,52,76
Arbroath,3360,3,18,8,10,75,51,24,62
Alloa,3360,4,17,8,11,59,47,12,59
Stranraer,3360,5,15,5,16,55,68,-13,50
East Fife,3360,6,14,3,19,51,64,-13,45
Airdrieon,3360,7,11,11,14,47,58,-11,44
Forfar,3360,8,10,5,21,38,66,-28,35
Albion,3360,9,8,6,22,58,83,-25,30
Queen's Park,3360,10,6,10,20,42,77,-35,28
Raith,3361,1,23,8,5,71,33,38,77
Ayr,3361,2,23,5,8,92,44,48,74
Arbroath,3361,3,17,9,10,71,49,22,60
Alloa,3361,4,17,8,11,57,46,11,59
Stranraer,3361,5,15,6,15,56,65,-9,51
East Fife,3361,6,13,4,19,48,65,-17,43
Airdrieon,3361,7,10,12,14,45,58,-13,42
Forfar,3361,8,10,6,20,38,64,-26,36
Albion,3361,9,8,7,21,59,80,-21,31
Queen's Park,3361,10,6,11,19,40,73,-33,29
Raith,3362,1,23,8,5,69,32,37,77
Ayr,3362,2,23,5,8,91,43,48,74
Arbroath,3362,3,18,8,10,73,50,23,62
Alloa,3362,4,17,8,11,56,44,12,59
Stranraer,3362,5,15,6,15,56,65,-9,51
Airdrieon,3362,6,11,11,14,48,58,-10,44
East Fife,3362,7,13,4,19,48,65,-17,43
Forfar,3362,8,10,5,21,38,67,-29,35
Albion,3362,9,8,7,21,58,79,-21,31
Queen's Park,3362,10,6,10,20,41,75,-34,28
Raith,3363,1,23,8,5,70,33,37,77
Ayr,3363,2,24,4,8,95,42,53,76
Arbroath,3363,3,17,8,11,70,50,20,59
Alloa,3363,4,17,8,11,57,45,12,59
Stranraer,3363,5,16,5,15,60,65,-5,53
Airdrieon,3363,6,11,11,14,47,58,-11,44
East Fife,3363,7,13,3,20,48,69,-21,42
Forfar,3363,8,10,5,21,38,66,-28,35
Queen's Park,3363,9,7,10,19,41,72,-31,31
Albion,3363,10,8,6,22,57,83,-26,30
Ayr,3364,1,24,4,8,94,43,51,76
Raith,3364,2,22,8,6,69,35,34,74
Alloa,3364,3,18,8,10,59,44,15,62
Arbroath,3364,4,17,8,11,71,50,21,59
Stranraer,3364,5,16,5,15,57,65,-8,53
Airdrieon,3364,6,11,11,14,47,59,-12,44
East Fife,3364,7,13,3,20,48,66,-18,42
Forfar,3364,8,10,5,21,39,66,-27,35
Queen's Park,3364,9,7,10,19,41,73,-32,31
Albion,3364,10,8,6,22,58,82,-24,30
Raith,3365,1,23,8,5,69,32,37,77
Ayr,3365,2,24,4,8,93,44,49,76
Arbroath,3365,3,17,8,11,71,50,21,59
Alloa,3365,4,17,8,11,56,44,12,59
Stranraer,3365,5,15,6,15,57,66,-9,51
East Fife,3365,6,13,4,19,49,66,-17,43
Airdrieon,3365,7,10,11,15,45,59,-14,41
Forfar,3365,8,11,5,20,39,64,-25,38
Queen's Park,3365,9,7,10,19,41,73,-32,31
Albion,3365,10,8,6,22,59,81,-22,30
Ayr,3366,1,24,4,8,94,43,51,76
Raith,3366,2,22,9,5,70,34,36,75
Alloa,3366,3,17,9,10,58,45,13,60
Arbroath,3366,4,17,8,11,73,53,20,59
Stranraer,3366,5,16,5,15,58,64,-6,53
Airdrieon,3366,6,11,11,14,49,58,-9,44
East Fife,3366,7,13,3,20,47,67,-20,42
Forfar,3366,8,10,5,21,38,68,-30,35
Queen's Park,3366,9,7,10,19,44,75,-31,31
Albion,3366,10,8,6,22,58,82,-24,30
Ayr,3367,1,24,4,8,94,43,51,76
Raith,3367,2,22,9,5,69,33,36,75
Alloa,3367,3,17,9,10,57,44,13,60
Arbroath,3367,4,17,8,11,71,50,21,59
Stranraer,3367,5,15,6,15,56,65,-9,51
East Fife,3367,6,13,4,19,48,65,-17,43
Airdrieon,3367,7,10,12,14,45,58,-13,42
Forfar,3367,8,10,6,20,38,64,-26,36
Queen's Park,3367,9,7,10,19,41,73,-32,31
Albion,3367,10,8,6,22,58,82,-24,30
Raith,3368,1,23,8,5,71,33,38,77
Ayr,3368,2,23,4,9,91,44,47,73
Arbroath,3368,3,17,8,11,72,51,21,59
Alloa,3368,4,17,8,11,57,46,11,59
Stranraer,3368,5,15,5,16,56,66,-10,50
East Fife,3368,6,14,3,19,49,65,-16,45
Airdrieon,3368,7,10,12,14,48,61,-13,42
Forfar,3368,8,10,6,20,41,67,-26,36
Albion,3368,9,9,6,21,59,79,-20,33
Queen's Park,3368,10,7,10,19,42,74,-32,31
Ayr,3369,1,24,4,8,94,43,51,76
Raith,3369,2,22,9,5,70,34,36,75
Arbroath,3369,3,17,9,10,71,49,22,60
Alloa,3369,4,17,9,10,58,45,13,60
Stranraer,3369,5,15,5,16,56,67,-11,50
East Fife,3369,6,14,3,19,50,65,-15,45
Airdrieon,3369,7,10,11,15,47,61,-14,41
Forfar,3369,8,11,5,20,41,66,-25,38
Albion,3369,9,8,6,22,58,82,-24,30
Queen's Park,3369,10,6,11,19,40,73,-33,29
Ayr,3370,1,24,4,8,93,43,50,76
Raith,3370,2,22,8,6,69,34,35,74
Arbroath,3370,3,18,8,10,73,50,23,62
Alloa,3370,4,18,8,10,58,44,14,62
Stranraer,3370,5,16,5,15,57,64,-7,53
Airdrieon,3370,6,11,11,14,47,58,-11,44
East Fife,3370,7,13,3,20,47,66,-19,42
Forfar,3370,8,10,5,21,38,66,-28,35
Albion,3370,9,8,6,22,58,81,-23,30
Queen's Park,3370,10,6,10,20,41,75,-34,28
Ayr,3371,1,24,4,8,94,43,51,76
Raith,3371,2,22,9,5,69,33,36,75
Arbroath,3371,3,18,8,10,72,48,24,62
Alloa,3371,4,17,9,10,57,44,13,60
Stranraer,3371,5,15,6,15,57,66,-9,51
Airdrieon,3371,6,11,11,14,47,59,-12,44
East Fife,3371,7,13,4,19,49,66,-17,43
Forfar,3371,8,10,5,21,39,66,-27,35
Albion,3371,9,8,6,22,58,82,-24,30
Queen's Park,3371,10,6,10,20,39,74,-35,28
Raith,3372,1,22,8,6,69,35,34,74
Ayr,3372,2,23,4,9,91,44,47,73
Arbroath,3372,3,18,8,10,72,49,23,62
Alloa,3372,4,18,8,10,59,44,15,62
Stranraer,3372,5,16,5,15,56,64,-8,53
Airdrieon,3372,6,11,11,14,48,59,-11,44
East Fife,3372,7,13,3,20,47,65,-18,42
Forfar,3372,8,10,5,21,39,67,-28,35
Albion,3372,9,9,6,21,59,79,-20,33
Queen's Park,3372,10,6,10,20,40,74,-34,28
Ayr,3373,1,24,4,8,93,43,50,76
Raith,3373,2,22,8,6,68,34,34,74
Alloa,3373,3,18,8,10,58,43,15,62
Arbroath,3373,4,17,9,10,70,48,22,60
Stranraer,3373,5,15,6,15,56,65,-9,51
Airdrieon,3373,6,11,11,14,48,59,-11,44
East Fife,3373,7,13,4,19,48,65,-17,43
Forfar,3373,8,10,5,21,39,67,-28,35
Albion,3373,9,8,6,22,58,81,-23,30
Queen's Park,3373,10,6,11,19,39,72,-33,29
Raith,3374,1,23,8,5,70,33,37,77
Ayr,3374,2,24,4,8,93,44,49,76
Arbroath,3374,3,17,9,10,72,50,22,60
Alloa,3374,4,17,8,11,57,45,12,59
Stranraer,3374,5,15,6,15,56,65,-9,51
Airdrieon,3374,6,11,11,14,47,58,-11,44
East Fife,3374,7,13,4,19,48,65,-17,43
Forfar,3374,8,10,5,21,38,66,-28,35
Albion,3374,9,8,6,22,59,81,-22,30
Queen's Park,3374,10,6,11,19,41,74,-33,29
Ayr,3375,1,24,4,8,92,43,49,76
Raith,3375,2,22,8,6,68,34,34,74
Alloa,3375,3,18,8,10,58,43,15,62
Arbroath,3375,4,17,8,11,70,49,21,59
Stranraer,3375,5,16,5,15,58,64,-6,53
East Fife,3375,6,13,3,20,47,67,-20,42
Airdrieon,3375,7,10,11,15,45,59,-14,41
Forfar,3375,8,11,5,20,39,64,-25,38
Queen's Park,3375,9,7,10,19,40,72,-32,31
Albion,3375,10,8,6,22,58,80,-22,30
Ayr,3376,1,24,4,8,97,43,54,76
Raith,3376,2,22,9,5,68,32,36,75
Alloa,3376,3,17,9,10,56,43,13,60
Arbroath,3376,4,17,8,11,71,50,21,59
Stranraer,3376,5,15,6,15,55,64,-9,51
East Fife,3376,6,13,4,19,47,64,-17,43
Airdrieon,3376,7,10,12,14,46,59,-13,42
Forfar,3376,8,10,6,20,39,65,-26,36
Queen's Park,3376,9,7,10,19,41,73,-32,31
Albion,3376,10,8,6,22,58,85,-27,30
Raith,3377,1,23,8,5,70,33,37,77
Ayr,3377,2,24,4,8,94,42,52,76
Arbroath,3377,3,17,9,10,72,50,22,60
Alloa,3377,4,17,8,11,57,45,12,59
Stranraer,3377,5,16,5,15,59,65,-6,53
Airdrieon,3377,6,11,11,14,49,59,-10,44
East Fife,3377,7,13,3,20,48,68,-20,42
Forfar,3377,8,10,5,21,39,68,-29,35
Albion,3377,9,8,6,22,57,82,-25,30
Queen's Park,3377,10,6,11,19,41,74,-33,29
Ayr,3378,1,24,4,8,93,43,50,76
Raith,3378,2,22,9,5,69,33,36,75
Alloa,3378,3,17,9,10,57,44,13,60
Arbroath,3378,4,17,8,11,71,50,21,59
Stranraer,3378,5,15,5,16,58,68,-10,50
East Fife,3378,6,14,3,19,51,67,-16,45
Airdrieon,3378,7,10,11,15,45,61,-16,41
Forfar,3378,8,11,5,20,41,64,-23,38
Queen's Park,3378,9,7,10,19,41,73,-32,31
Albion,3378,10,8,6,22,58,81,-23,30
Ayr,3379,1,24,4,8,93,44,49,76
Raith,3379,2,22,9,5,68,32,36,75
Arbroath,3379,3,17,9,10,73,51,22,60
Alloa,3379,4,17,9,10,56,43,13,60
Stranraer,3379,5,15,6,15,55,64,-9,51
Airdrieon,3379,6,11,11,14,48,58,-10,44
East Fife,3379,7,13,4,19,47,64,-17,43
Forfar,3379,8,10,5,21,38,67,-29,35
Albion,3379,9,8,6,22,59,81,-22,30
Queen's Park,3379,10,6,11,19,42,75,-33,29
Ayr,3380,1,24,4,8,91,42,49,76
Raith,3380,2,22,9,5,69,33,36,75
Arbroath,3380,3,18,8,10,72,49,23,62
Alloa,3380,4,17,9,10,57,44,13,60
Stranraer,3380,5,15,5,16,56,69,-13,50
East Fife,3380,6,14,3,19,52,65,-13,45
Airdrieon,3380,7,11,11,14,47,58,-11,44
Forfar,3380,8,10,5,21,38,66,-28,35
Albion,3380,9,8,6,22,57,79,-22,30
Queen's Park,3380,10,6,10,20,40,74,-34,28
Raith,3381,1,23,8,5,69,32,37,77
Ayr,3381,2,23,4,9,91,45,46,73
Arbroath,3381,3,17,9,10,72,50,22,60
Alloa,3381,4,17,8,11,56,44,12,59
Stranraer,3381,5,15,5,16,57,68,-11,50
East Fife,3381,6,14,3,19,51,66,-15,45
Airdrieon,3381,7,10,12,14,46,59,-13,42
Forfar,3381,8,10,6,20,39,65,-26,36
Albion,3381,9,9,6,21,60,79,-19,33
Queen's Park,3381,10,6,11,19,41,74,-33,29
Raith,3382,1,23,8,5,70,32,38,77
Ayr,3382,2,23,5,8,93,45,48,74
Arbroath,3382,3,17,9,10,71,49,22,60
Alloa,3382,4,17,8,11,56,45,11,59
Stranraer,3382,5,15,5,16,55,65,-10,50
East Fife,3382,6,14,3,19,48,64,-16,45
Airdrieon,3382,7,10,11,15,45,59,-14,41
Forfar,3382,8,11,5,20,39,64,-25,38
Albion,3382,9,8,7,21,60,81,-21,31
Queen's Park,3382,10,6,11,19,40,73,-33,29
Raith,3383,1,23,8,5,70,33,37,77
Ayr,3383,2,24,4,8,96,44,52,76
Arbroath,3383,3,17,9,10,71,49,22,60
Alloa,3383,4,17,8,11,57,45,12,59
Stranraer,3383,5,15,5,16,55,71,-16,50
East Fife,3383,6,14,3,19,54,64,-10,45
Airdrieon,3383,7,10,11,15,45,59,-14,41
Forfar,3383,8,11,5,20,39,64,-25,38
Albion,3383,9,8,6,22,59,84,-25,30
Queen's Park,3383,10,6,11,19,40,73,-33,29
Raith,3384,1,23,8,5,70,32,38,77
Ayr,3384,2,24,4,8,94,43,51,76
Arbroath,3384,3,17,9,10,71,49,22,60
Alloa,3384,4,17,8,11,56,45,11,59
Stranraer,3384,5,16,5,15,58,64,-6,53
Airdrieon,3384,6,10,12,14,46,59,-13,42
East Fife,3384,7,13,3,20,47,67,-20,42
Forfar,3384,8,10,6,20,39,65,-26,36
Albion,3384,9,8,6,22,58,82,-24,30
Queen's Park,3384,10,6,11,19,40,73,-33,29
Raith,3385,1,23,8,5,71,34,37,77
Ayr,3385,2,23,5,8,92,44,48,74
Arbroath,3385,3,17,9,10,71,49,22,60
Alloa,3385,4,17,8,11,58,46,12,59
Stranraer,3385,5,15,5,16,55,66,-11,50
East Fife,3385,6,14,3,19,49,64,-15,45
Airdrieon,3385,7,10,12,14,47,60,-13,42
Forfar,3385,8,10,6,20,40,66,-26,36
Albion,3385,9,8,7,21,59,80,-21,31
Queen's Park,3385,10,6,11,19,40,73,-33,29
Raith,3386,1,23,8,5,72,33,39,77
Ayr,3386,2,24,4,8,93,43,50,76
Arbroath,3386,3,18,8,10,71,48,23,62
Alloa,3386,4,17,8,11,57,47,10,59
Stranraer,3386,5,16,5,15,60,65,-5,53
East Fife,3386,6,13,3,20,48,69,-21,42
Airdrieon,3386,7,10,11,15,46,60,-14,41
Forfar,3386,8,11,5,20,40,65,-25,38
Albion,3386,9,8,6,22,58,81,-23,30
Queen's Park,3386,10,6,10,20,39,73,-34,28
Raith,3387,1,23,8,5,70,33,37,77
Ayr,3387,2,24,4,8,95,42,53,76
Arbroath,3387,3,18,8,10,75,51,24,62
Alloa,3387,4,17,8,11,57,45,12,59
Stranraer,3387,5,16,5,15,58,66,-8,53
East Fife,3387,6,13,3,20,49,67,-18,42
Airdrieon,3387,7,10,11,15,45,59,-14,41
Forfar,3387,8,11,5,20,39,64,-25,38
Albion,3387,9,8,6,22,57,83,-26,30
Queen's Park,3387,10,6,10,20,42,77,-35,28
Raith,3388,1,23,8,5,70,32,38,77
Ayr,3388,2,24,4,8,93,44,49,76
Arbroath,3388,3,18,8,10,71,48,23,62
Alloa,3388,4,17,8,11,56,45,11,59
Stranraer,3388,5,15,5,16,58,68,-10,50
East Fife,3388,6,14,3,19,51,67,-16,45
Airdrieon,3388,7,11,11,14,49,61,-12,44
Forfar,3388,8,10,5,21,41,68,-27,35
Albion,3388,9,8,6,22,59,81,-22,30
Queen's Park,3388,10,6,10,20,39,73,-34,28
Ayr,3389,1,24,4,8,93,42,51,76
Raith,3389,2,22,9,5,70,34,36,75
Arbroath,3389,3,18,8,10,74,50,24,62
Alloa,3389,4,17,9,10,58,45,13,60
Stranraer,3389,5,15,6,15,57,66,-9,51
East Fife,3389,6,13,4,19,49,66,-17,43
Airdrieon,3389,7,10,12,14,46,59,-13,42
Forfar,3389,8,10,6,20,39,65,-26,36
Albion,3389,9,8,6,22,57,81,-24,30
Queen's Park,3389,10,6,10,20,41,76,-35,28
Ayr,3390,1,24,4,8,92,42,50,76
Raith,3390,2,22,9,5,70,34,36,75
Arbroath,3390,3,18,8,10,77,50,27,62
Alloa,3390,4,17,9,10,58,45,13,60
Stranraer,3390,5,15,5,16,56,68,-12,50
East Fife,3390,6,14,3,19,51,65,-14,45
Airdrieon,3390,7,11,11,14,48,59,-11,44
Forfar,3390,8,10,5,21,39,67,-28,35
Albion,3390,9,8,6,22,57,80,-23,30
Queen's Park,3390,10,6,10,20,41,79,-38,28
Raith,3391,1,23,8,5,69,32,37,77
Ayr,3391,2,24,4,8,96,42,54,76
Arbroath,3391,3,17,9,10,71,49,22,60
Alloa,3391,4,17,8,11,56,44,12,59
Stranraer,3391,5,15,6,15,56,65,-9,51
Airdrieon,3391,6,11,11,14,47,58,-11,44
East Fife,3391,7,13,4,19,48,65,-17,43
Forfar,3391,8,10,5,21,38,66,-28,35
Albion,3391,9,8,6,22,57,84,-27,30
Queen's Park,3391,10,6,11,19,40,73,-33,29
Ayr,3392,1,24,4,8,95,44,51,76
Raith,3392,2,22,8,6,68,33,35,74
Arbroath,3392,3,18,8,10,73,50,23,62
Alloa,3392,4,18,8,10,57,43,14,62
Stranraer,3392,5,15,5,16,57,67,-10,50
East Fife,3392,6,14,3,19,50,66,-16,45
Airdrieon,3392,7,11,11,14,46,58,-12,44
Forfar,3392,8,10,5,21,38,65,-27,35
Albion,3392,9,8,6,22,59,83,-24,30
Queen's Park,3392,10,6,10,20,41,75,-34,28
Raith,3393,1,23,8,5,71,32,39,77
Ayr,3393,2,24,4,8,93,43,50,76
Arbroath,3393,3,17,8,11,70,49,21,59
Alloa,3393,4,17,8,11,56,46,10,59
Stranraer,3393,5,16,5,15,58,66,-8,53
Airdrieon,3393,6,11,11,14,49,59,-10,44
East Fife,3393,7,13,3,20,49,67,-18,42
Forfar,3393,8,10,5,21,39,68,-29,35
Queen's Park,3393,9,7,10,19,40,72,-32,31
Albion,3393,10,8,6,22,58,81,-23,30
Ayr,3394,1,23,5,8,91,43,48,74
Raith,3394,2,22,8,6,68,33,35,74
Arbroath,3394,3,18,8,10,72,49,23,62
Alloa,3394,4,18,8,10,57,43,14,62
Stranraer,3394,5,15,5,16,56,66,-10,50
East Fife,3394,6,14,3,19,49,65,-16,45
Airdrieon,3394,7,11,11,14,47,58,-11,44
Forfar,3394,8,10,5,21,38,66,-28,35
Albion,3394,9,8,7,21,58,79,-21,31
Queen's Park,3394,10,6,10,20,40,74,-34,28
Raith,3395,1,23,8,5,71,33,38,77
Ayr,3395,2,23,4,9,91,44,47,73
Arbroath,3395,3,17,8,11,71,50,21,59
Alloa,3395,4,17,8,11,57,46,11,59
Stranraer,3395,5,16,5,15,57,64,-7,53
Airdrieon,3395,6,11,11,14,48,59,-11,44
East Fife,3395,7,13,3,20,47,66,-19,42
Forfar,3395,8,10,5,21,39,67,-28,35
Albion,3395,9,9,6,21,59,79,-20,33
Queen's Park,3395,10,7,10,19,41,73,-32,31
Raith,3396,1,23,8,5,72,33,39,77
Ayr,3396,2,23,4,9,91,44,47,73
Arbroath,3396,3,18,8,10,74,51,23,62
Alloa,3396,4,17,8,11,57,47,10,59
Stranraer,3396,5,15,5,16,55,67,-12,50
East Fife,3396,6,14,3,19,50,64,-14,45
Airdrieon,3396,7,10,12,14,46,59,-13,42
Forfar,3396,8,10,6,20,39,65,-26,36
Albion,3396,9,9,6,21,59,79,-20,33
Queen's Park,3396,10,6,10,20,42,76,-34,28
Ayr,3397,1,24,4,8,91,42,49,76
Raith,3397,2,22,9,5,69,33,36,75
Arbroath,3397,3,18,8,10,73,48,25,62
Alloa,3397,4,17,9,10,57,44,13,60
Stranraer,3397,5,15,5,16,55,65,-10,50
East Fife,3397,6,14,3,19,48,64,-16,45
Airdrieon,3397,7,11,11,14,47,58,-11,44
Forfar,3397,8,10,5,21,38,66,-28,35
Albion,3397,9,8,6,22,57,79,-22,30
Queen's Park,3397,10,6,10,20,39,75,-36,28
Raith,3398,1,23,8,5,69,32,37,77
Ayr,3398,2,23,5,8,90,42,48,74
Arbroath,3398,3,17,8,11,70,49,21,59
Alloa,3398,4,17,8,11,56,44,12,59
Stranraer,3398,5,16,5,15,57,64,-7,53
Airdrieon,3398,6,11,11,14,47,58,-11,44
East Fife,3398,7,13,3,20,47,66,-19,42
Forfar,3398,8,10,5,21,38,66,-28,35
Albion,3398,9,8,7,21,57,78,-21,31
Queen's Park,3398,10,7,10,19,40,72,-32,31
Raith,3399,1,23,8,5,69,32,37,77
Ayr,3399,2,23,5,8,91,43,48,74
Arbroath,3399,3,17,9,10,72,50,22,60
Alloa,3399,4,17,8,11,56,44,12,59
Stranraer,3399,5,16,5,15,57,64,-7,53
Airdrieon,3399,6,11,11,14,49,60,-11,44
East Fife,3399,7,13,3,20,47,66,-19,42
Forfar,3399,8,10,5,21,40,68,-28,35
Albion,3399,9,8,7,21,58,79,-21,31
Queen's Park,3399,10,6,11,19,41,74,-33,29
Raith,3400,1,23,8,5,70,33,37,77
Ayr,3400,2,24,4,8,94,42,52,76
Arbroath,3400,3,18,8,10,72,49,23,62
Alloa,3400,4,17,8,11,57,45,12,59
Stranraer,3400,5,15,5,16,56,68,-12,50
East Fife,3400,6,14,3,19,51,65,-14,45
Airdrieon,3400,7,11,11,14,46,58,-12,44
Forfar,3400,8,10,5,21,38,65,-27,35
Albion,3400,9,8,6,22,57,82,-25,30
Queen's Park,3400,10,6,10,20,40,74,-34,28
Raith,3401,1,22,8,6,69,35,34,74
Ayr,3401,2,23,4,9,92,46,46,73
Arbroath,3401,3,18,8,10,73,50,23,62
Alloa,3401,4,18,8,10,59,44,15,62
Stranraer,3401,5,15,5,16,56,68,-12,50
East Fife,3401,6,14,3,19,51,65,-14,45
Airdrieon,3401,7,11,11,14,48,60,-12,44
Forfar,3401,8,10,5,21,40,67,-27,35
Albion,3401,9,9,6,21,61,80,-19,33
Queen's Park,3401,10,6,10,20,41,75,-34,28
Raith,3402,1,23,8,5,70,32,38,77
Ayr,3402,2,24,4,8,94,44,50,76
Arbroath,3402,3,17,9,10,71,49,22,60
Alloa,3402,4,17,8,11,56,45,11,59
Stranraer,3402,5,15,6,15,55,64,-9,51
East Fife,3402,6,13,4,19,47,64,-17,43
Airdrieon,3402,7,10,12,14,46,59,-13,42
Forfar,3402,8,10,6,20,39,65,-26,36
Albion,3402,9,8,6,22,59,82,-23,30
Queen's Park,3402,10,6,11,19,40,73,-33,29
Ayr,3403,1,24,4,8,97,43,54,76
Raith,3403,2,22,9,5,68,32,36,75
Arbroath,3403,3,17,9,10,70,48,22,60
Alloa,3403,4,17,9,10,56,43,13,60
Stranraer,3403,5,16,5,15,57,65,-8,53
Airdrieon,3403,6,11,11,14,50,59,-9,44
East Fife,3403,7,13,3,20,48,66,-18,42
Forfar,3403,8,10,5,21,39,69,-30,35
Albion,3403,9,8,6,22,58,85,-27,30
Queen's Park,3403,10,6,11,19,39,72,-33,29
Raith,3404,1,22,8,6,68,34,34,74
Ayr,3404,2,23,4,9,92,45,47,73
Alloa,3404,3,18,8,10,58,43,15,62
Arbroath,3404,4,17,8,11,71,51,20,59
Stranraer,3404,5,15,6,15,56,65,-9,51
Airdrieon,3404,6,11,11,14,48,58,-10,44
East Fife,3404,7,13,4,19,48,65,-17,43
Forfar,3404,8,10,5,21,38,67,-29,35
Albion,3404,9,9,6,21,60,80,-20,33
Queen's Park,3404,10,7,10,19,42,73,-31,31
Raith,3405,1,23,8,5,69,32,37,77
Ayr,3405,2,23,4,9,92,45,47,73
Arbroath,3405,3,18,8,10,74,49,25,62
Alloa,3405,4,17,8,11,56,44,12,59
Stranraer,3405,5,16,5,15,56,64,-8,53
Airdrieon,3405,6,11,11,14,48,58,-10,44
East Fife,3405,7,13,3,20,47,65,-18,42
Forfar,3405,8,10,5,21,38,67,-29,35
Albion,3405,9,9,6,21,60,80,-20,33
Queen's Park,3405,10,6,10,20,40,76,-36,28
Ayr,3406,1,24,4,8,93,42,51,76
Raith,3406,2,22,8,6,68,33,35,74
Alloa,3406,3,18,8,10,57,43,14,62
Arbroath,3406,4,17,8,11,70,50,20,59
Stranraer,3406,5,15,5,16,57,67,-10,50
East Fife,3406,6,14,3,19,50,66,-16,45
Airdrieon,3406,7,11,11,14,46,58,-12,44
Forfar,3406,8,10,5,21,38,65,-27,35
Queen's Park,3406,9,7,10,19,41,72,-31,31
Albion,3406,10,8,6,22,57,81,-24,30
Ayr,3407,1,24,4,8,96,45,51,76
Raith,3407,2,22,8,6,70,35,35,74
Alloa,3407,3,18,8,10,59,45,14,62
Arbroath,3407,4,17,8,11,71,50,21,59
Stranraer,3407,5,15,5,16,55,66,-11,50
East Fife,3407,6,14,3,19,49,64,-15,45
Airdrieon,3407,7,11,11,14,46,58,-12,44
Forfar,3407,8,10,5,21,38,65,-27,35
Queen's Park,3407,9,7,10,19,41,73,-32,31
Albion,3407,10,8,6,22,60,84,-24,30
Ayr,3408,1,24,4,8,92,43,49,76
Raith,3408,2,22,9,5,69,33,36,75
Alloa,3408,3,17,9,10,57,44,13,60
Arbroath,3408,4,17,8,11,70,50,20,59
Stranraer,3408,5,15,6,15,55,64,-9,51
Airdrieon,3408,6,11,11,14,47,59,-12,44
East Fife,3408,7,13,4,19,47,64,-17,43
Forfar,3408,8,10,5,21,39,66,-27,35
Queen's Park,3408,9,7,10,19,41,72,-31,31
Albion,3408,10,8,6,22,58,80,-22,30
Raith,3409,1,23,8,5,71,34,37,77
Ayr,3409,2,23,5,8,93,45,48,74
Arbroath,3409,3,17,8,11,70,52,18,59
Alloa,3409,4,17,8,11,58,46,12,59
Stranraer,3409,5,16,5,15,56,64,-8,53
Airdrieon,3409,6,10,12,14,46,59,-13,42
East Fife,3409,7,13,3,20,47,65,-18,42
Forfar,3409,8,10,6,20,39,65,-26,36
Albion,3409,9,8,7,21,60,81,-21,31
Queen's Park,3409,10,7,10,19,43,72,-29,31
Raith,3410,1,22,9,5,70,34,36,75
Ayr,3410,2,23,5,8,93,45,48,74
Arbroath,3410,3,18,8,10,71,48,23,62
Alloa,3410,4,17,9,10,58,45,13,60
Stranraer,3410,5,15,5,16,55,68,-13,50
East Fife,3410,6,14,3,19,51,64,-13,45
Airdrieon,3410,7,10,12,14,48,61,-13,42
Forfar,3410,8,10,6,20,41,67,-26,36
Albion,3410,9,8,7,21,60,81,-21,31
Queen's Park,3410,10,6,10,20,39,73,-34,28
Ayr,3411,1,24,4,8,98,43,55,76
Raith,3411,2,22,8,6,68,34,34,74
Arbroath,3411,3,18,8,10,73,50,23,62
Alloa,3411,4,18,8,10,58,43,15,62
Stranraer,3411,5,15,5,16,55,65,-10,50
East Fife,3411,6,14,3,19,48,64,-16,45
Airdrieon,3411,7,10,11,15,45,60,-15,41
Forfar,3411,8,11,5,20,40,64,-24,38
Albion,3411,9,8,6,22,58,86,-28,30
Queen's Park,3411,10,6,10,20,41,75,-34,28
Ayr,3412,1,24,4,8,93,42,51,76
Raith,3412,2,22,9,5,68,32,36,75
Alloa,3412,3,17,9,10,56,43,13,60
Arbroath,3412,4,17,8,11,70,49,21,59
Stranraer,3412,5,15,6,15,58,67,-9,51
Airdrieon,3412,6,11,11,14,46,58,-12,44
East Fife,3412,7,13,4,19,50,67,-17,43
Forfar,3412,8,10,5,21,38,65,-27,35
Queen's Park,3412,9,7,10,19,40,72,-32,31
Albion,3412,10,8,6,22,57,81,-24,30
Raith,3413,1,23,8,5,72,33,39,77
Ayr,3413,2,24,4,8,94,43,51,76
Arbroath,3413,3,17,8,11,72,52,20,59
Alloa,3413,4,17,8,11,57,47,10,59
Stranraer,3413,5,15,5,16,56,67,-11,50
East Fife,3413,6,14,3,19,50,65,-15,45
Airdrieon,3413,7,11,11,14,49,59,-10,44
Forfar,3413,8,10,5,21,39,68,-29,35
Queen's Park,3413,9,7,10,19,43,74,-31,31
Albion,3413,10,8,6,22,58,82,-24,30
Raith,3414,1,22,9,5,69,33,36,75
Ayr,3414,2,23,5,8,93,45,48,74
Arbroath,3414,3,17,9,10,72,50,22,60
Alloa,3414,4,17,9,10,57,44,13,60
Stranraer,3414,5,15,6,15,58,67,-9,51
East Fife,3414,6,13,4,19,50,67,-17,43
Airdrieon,3414,7,10,11,15,46,60,-14,41
Forfar,3414,8,11,5,20,40,65,-25,38
Albion,3414,9,8,7,21,60,81,-21,31
Queen's Park,3414,10,6,11,19,41,74,-33,29
Raith,3415,1,22,8,6,70,35,35,74
Ayr,3415,2,23,4,9,91,45,46,73
Alloa,3415,3,18,8,10,59,45,14,62
Arbroath,3415,4,17,9,10,71,49,22,60
Stranraer,3415,5,16,5,15,57,64,-7,53
Airdrieon,3415,6,10,12,14,46,59,-13,42
East Fife,3415,7,13,3,20,47,66,-19,42
Forfar,3415,8,10,6,20,39,65,-26,36
Albion,3415,9,9,6,21,60,79,-19,33
Queen's Park,3415,10,6,11,19,40,73,-33,29
Raith,3416,1,23,8,5,71,32,39,77
Ayr,3416,2,24,4,8,91,42,49,76
Arbroath,3416,3,18,8,10,73,49,24,62
Alloa,3416,4,17,8,11,56,46,10,59
Stranraer,3416,5,15,5,16,55,68,-13,50
East Fife,3416,6,14,3,19,51,64,-13,45
Airdrieon,3416,7,11,11,14,46,58,-12,44
Forfar,3416,8,10,5,21,38,65,-27,35
Albion,3416,9,8,6,22,57,79,-22,30
Queen's Park,3416,10,6,10,20,40,75,-35,28
Ayr,3417,1,24,4,8,93,42,51,76
Raith,3417,2,22,9,5,70,34,36,75
Alloa,3417,3,17,9,10,58,45,13,60
Arbroath,3417,4,17,8,11,72,51,21,59
Stranraer,3417,5,16,5,15,57,65,-8,53
East Fife,3417,6,13,3,20,48,66,-18,42
Airdrieon,3417,7,10,11,15,45,60,-15,41
Forfar,3417,8,11,5,20,40,64,-24,38
Queen's Park,3417,9,7,10,19,42,74,-32,31
Albion,3417,10,8,6,22,57,81,-24,30
Ayr,3418,1,24,4,8,94,42,52,76
Raith,3418,2,22,8,6,68,33,35,74
Arbroath,3418,3,18,8,10,71,48,23,62
Alloa,3418,4,18,8,10,57,43,14,62
Stranraer,3418,5,15,6,15,56,65,-9,51
East Fife,3418,6,13,4,19,48,65,-17,43
Airdrieon,3418,7,10,11,15,46,61,-15,41
Forfar,3418,8,11,5,20,41,65,-24,38
Albion,3418,9,8,6,22,57,82,-25,30
Queen's Park,3418,10,6,10,20,39,73,-34,28
Raith,3419,1,23,8,5,70,32,38,77
Ayr,3419,2,23,5,8,91,43,48,74
Arbroath,3419,3,17,8,11,70,50,20,59
Alloa,3419,4,17,8,11,56,45,11,59
Stranraer,3419,5,15,5,16,57,68,-11,50
East Fife,3419,6,14,3,19,51,66,-15,45
Airdrieon,3419,7,11,11,14,47,59,-12,44
Forfar,3419,8,10,5,21,39,66,-27,35
Albion,3419,9,8,7,21,58,79,-21,31
Queen's Park,3419,10,7,10,19,41,72,-31,31
Ayr,3420,1,24,4,8,95,43,52,76
Raith,3420,2,22,9,5,69,33,36,75
Alloa,3420,3,17,9,10,57,44,13,60
Arbroath,3420,4,17,8,11,70,50,20,59
Stranraer,3420,5,15,6,15,57,66,-9,51
East Fife,3420,6,13,4,19,49,66,-17,43
Airdrieon,3420,7,10,11,15,46,60,-14,41
Forfar,3420,8,11,5,20,40,65,-25,38
Queen's Park,3420,9,7,10,19,41,72,-31,31
Albion,3420,10,8,6,22,58,83,-25,30
Raith,3421,1,23,8,5,69,32,37,77
Ayr,3421,2,23,4,9,91,45,46,73
Arbroath,3421,3,17,9,10,73,51,22,60
Alloa,3421,4,17,8,11,56,44,12,59
Stranraer,3421,5,15,6,15,56,65,-9,51
Airdrieon,3421,6,11,11,14,48,59,-11,44
East Fife,3421,7,13,4,19,48,65,-17,43
Forfar,3421,8,10,5,21,39,67,-28,35
Albion,3421,9,9,6,21,60,79,-19,33
Queen's Park,3421,10,6,11,19,42,75,-33,29
Raith,3422,1,23,8,5,72,33,39,77
Ayr,3422,2,24,4,8,93,44,49,76
Arbroath,3422,3,17,9,10,72,50,22,60
Alloa,3422,4,17,8,11,57,47,10,59
Stranraer,3422,5,15,5,16,55,66,-11,50
East Fife,3422,6,14,3,19,49,64,-15,45
Airdrieon,3422,7,11,11,14,47,58,-11,44
Forfar,3422,8,10,5,21,38,66,-28,35
Albion,3422,9,8,6,22,59,81,-22,30
Queen's Park,3422,10,6,11,19,41,74,-33,29
Raith,3423,1,22,9,5,69,33,36,75
Ayr,3423,2,23,4,9,90,44,46,73
Arbroath,3423,3,18,8,10,74,49,25,62
Alloa,3423,4,17,9,10,57,44,13,60
Stranraer,3423,5,15,6,15,57,66,-9,51
East Fife,3423,6,13,4,19,49,66,-17,43
Airdrieon,3423,7,10,12,14,46,59,-13,42
Forfar,3423,8,10,6,20,39,65,-26,36
Albion,3423,9,9,6,21,59,78,-19,33
Queen's Park,3423,10,6,10,20,40,76,-36,28
Raith,3424,1,23,8,5,70,32,38,77
Ayr,3424,2,24,4,8,94,42,52,76
Arbroath,3424,3,17,8,11,70,49,21,59
Alloa,3424,4,17,8,11,56,45,11,59
Stranraer,3424,5,15,5,16,55,65,-10,50
East Fife,3424,6,14,3,19,48,64,-16,45
Airdrieon,3424,7,11,11,14,47,59,-12,44
Forfar,3424,8,10,5,21,39,66,-27,35
Queen's Park,3424,9,7,10,19,40,72,-32,31
Albion,3424,10,8,6,22,57,82,-25,30
Raith,3425,1,23,8,5,70,32,38,77
Ayr,3425,2,24,4,8,94,43,51,76
Arbroath,3425,3,17,8,11,71,50,21,59
Alloa,3425,4,17,8,11,56,45,11,59
Stranraer,3425,5,16,5,15,57,65,-8,53
Airdrieon,3425,6,11,11,14,47,58,-11,44
East Fife,3425,7,13,3,20,48,66,-18,42
Forfar,3425,8,10,5,21,38,66,-28,35
Queen's Park,3425,9,7,10,19,41,73,-32,31
Albion,3425,10,8,6,22,58,82,-24,30
Ayr,3426,1,24,4,8,92,42,50,76
Raith,3426,2,22,9,5,69,33,36,75
Arbroath,3426,3,17,9,10,71,49,22,60
Alloa,3426,4,17,9,10,57,44,13,60
Stranraer,3426,5,15,5,16,57,68,-11,50
East Fife,3426,6,14,3,19,51,66,-15,45
Airdrieon,3426,7,11,11,14,47,58,-11,44
Forfar,3426,8,10,5,21,38,66,-28,35
Albion,3426,9,8,6,22,57,80,-23,30
Queen's Park,3426,10,6,11,19,40,73,-33,29
Raith,3427,1,23,8,5,73,32,41,77
Ayr,3427,2,24,4,8,95,43,52,76
Arbroath,3427,3,17,9,10,72,50,22,60
Alloa,3427,4,17,8,11,56,48,8,59
Stranraer,3427,5,16,5,15,58,66,-8,53
Airdrieon,3427,6,10,12,14,47,60,-13,42
East Fife,3427,7,13,3,20,49,67,-18,42
Forfar,3427,8,10,6,20,40,66,-26,36
Albion,3427,9,8,6,22,58,83,-25,30
Queen's Park,3427,10,6,11,19,41,74,-33,29
Ayr,3428,1,24,4,8,93,43,50,76
Raith,3428,2,22,9,5,69,33,36,75
Alloa,3428,3,17,9,10,57,44,13,60
Arbroath,3428,4,17,8,11,70,50,20,59
Stranraer,3428,5,16,5,15,59,64,-5,53
East Fife,3428,6,13,3,20,47,68,-21,42
Airdrieon,3428,7,10,11,15,46,61,-15,41
Forfar,3428,8,11,5,20,41,65,-24,38
Queen's Park,3428,9,7,10,19,41,72,-31,31
Albion,3428,10,8,6,22,58,81,-23,30
Raith,3429,1,23,8,5,71,33,38,77
Ayr,3429,2,24,4,8,95,42,53,76
Arbroath,3429,3,18,8,10,74,49,25,62
Alloa,3429,4,17,8,11,57,46,11,59
Stranraer,3429,5,16,5,15,58,65,-7,53
Airdrieon,3429,6,10,12,14,46,59,-13,42
East Fife,3429,7,13,3,20,48,67,-19,42
Forfar,3429,8,10,6,20,39,65,-26,36
Albion,3429,9,8,6,22,57,83,-26,30
Queen's Park,3429,10,6,10,20,40,76,-36,28
Raith,3430,1,23,8,5,69,32,37,77
Ayr,3430,2,24,4,8,94,43,51,76
Arbroath,3430,3,18,8,10,76,50,26,62
Alloa,3430,4,17,8,11,56,44,12,59
Stranraer,3430,5,15,5,16,56,66,-10,50
East Fife,3430,6,14,3,19,49,65,-16,45
Airdrieon,3430,7,10,11,15,47,62,-15,41
Forfar,3430,8,11,5,20,42,66,-24,38
Albion,3430,9,8,6,22,58,82,-24,30
Queen's Park,3430,10,6,10,20,41,78,-37,28
Raith,3431,1,22,9,5,69,33,36,75
Ayr,3431,2,23,4,9,90,43,47,73
Alloa,3431,3,17,9,10,57,44,13,60
Arbroath,3431,4,17,8,11,71,50,21,59
Stranraer,3431,5,15,5,16,56,66,-10,50
East Fife,3431,6,14,3,19,49,65,-16,45
Airdrieon,3431,7,11,11,14,47,58,-11,44
Forfar,3431,8,10,5,21,38,66,-28,35
Albion,3431,9,9,6,21,58,78,-20,33
Queen's Park,3431,10,7,10,19,41,73,-32,31
Raith,3432,1,23,8,5,71,32,39,77
Ayr,3432,2,24,4,8,91,42,49,76
Arbroath,3432,3,18,8,10,73,49,24,62
Alloa,3432,4,17,8,11,56,46,10,59
Stranraer,3432,5,15,5,16,55,68,-13,50
East Fife,3432,6,14,3,19,51,64,-13,45
Airdrieon,3432,7,11,11,14,47,58,-11,44
Forfar,3432,8,10,5,21,38,66,-28,35
Albion,3432,9,8,6,22,57,79,-22,30
Queen's Park,3432,10,6,10,20,40,75,-35,28
Raith,3433,1,23,8,5,73,34,39,77
Ayr,3433,2,24,4,8,92,43,49,76
Arbroath,3433,3,17,8,11,70,50,20,59
Alloa,3433,4,17,8,11,58,48,10,59
Stranraer,3433,5,15,6,15,55,64,-9,51
Airdrieon,3433,6,11,11,14,47,59,-12,44
East Fife,3433,7,13,4,19,47,64,-17,43
Forfar,3433,8,10,5,21,39,66,-27,35
Queen's Park,3433,9,7,10,19,41,72,-31,31
Albion,3433,10,8,6,22,58,80,-22,30
Raith,3434,1,23,8,5,70,33,37,77
Ayr,3434,2,24,4,8,97,42,55,76
Arbroath,3434,3,18,8,10,74,48,26,62
Alloa,3434,4,17,8,11,57,45,12,59
Stranraer,3434,5,16,5,15,58,65,-7,53
East Fife,3434,6,13,3,20,48,67,-19,42
Airdrieon,3434,7,10,11,15,46,60,-14,41
Forfar,3434,8,11,5,20,40,65,-25,38
Albion,3434,9,8,6,22,57,85,-28,30
Queen's Park,3434,10,6,10,20,39,76,-37,28
Raith,3435,1,23,8,5,71,32,39,77
Ayr,3435,2,23,4,9,91,44,47,73
Arbroath,3435,3,18,8,10,73,49,24,62
Alloa,3435,4,17,8,11,56,46,10,59
Stranraer,3435,5,15,5,16,55,66,-11,50
East Fife,3435,6,14,3,19,49,64,-15,45
Airdrieon,3435,7,11,11,14,49,59,-10,44
Forfar,3435,8,10,5,21,39,68,-29,35
Albion,3435,9,9,6,21,59,79,-20,33
Queen's Park,3435,10,6,10,20,40,75,-35,28
Raith,3436,1,23,8,5,70,32,38,77
Ayr,3436,2,24,4,8,95,42,53,76
Arbroath,3436,3,18,8,10,73,49,24,62
Alloa,3436,4,17,8,11,56,45,11,59
Stranraer,3436,5,15,5,16,56,66,-10,50
East Fife,3436,6,14,3,19,49,65,-16,45
Airdrieon,3436,7,11,11,14,48,59,-11,44
Forfar,3436,8,10,5,21,39,67,-28,35
Albion,3436,9,8,6,22,57,83,-26,30
Queen's Park,3436,10,6,10,20,40,75,-35,28
Ayr,3437,1,23,5,8,92,44,48,74
Raith,3437,2,22,8,6,68,34,34,74
Alloa,3437,3,18,8,10,58,43,15,62
Arbroath,3437,4,17,8,11,70,49,21,59
Stranraer,3437,5,15,5,16,55,67,-12,50
East Fife,3437,6,14,3,19,50,64,-14,45
Airdrieon,3437,7,10,11,15,45,60,-15,41
Forfar,3437,8,11,5,20,40,64,-24,38
Albion,3437,9,8,7,21,59,80,-21,31
Queen's Park,3437,10,7,10,19,40,72,-32,31
Raith,3438,1,23,8,5,71,32,39,77
Ayr,3438,2,24,4,8,96,43,53,76
Arbroath,3438,3,18,8,10,73,49,24,62
Alloa,3438,4,17,8,11,56,46,10,59
Stranraer,3438,5,15,5,16,56,66,-10,50
East Fife,3438,6,14,3,19,49,65,-16,45
Airdrieon,3438,7,11,11,14,48,59,-11,44
Forfar,3438,8,10,5,21,39,67,-28,35
Albion,3438,9,8,6,22,58,84,-26,30
Queen's Park,3438,10,6,10,20,40,75,-35,28
Raith,3439,1,23,8,5,70,33,37,77
Ayr,3439,2,24,4,8,93,42,51,76
Arbroath,3439,3,18,8,10,73,50,23,62
Alloa,3439,4,17,8,11,57,45,12,59
Stranraer,3439,5,15,5,16,56,69,-13,50
East Fife,3439,6,14,3,19,52,65,-13,45
Airdrieon,3439,7,10,11,15,46,60,-14,41
Forfar,3439,8,11,5,20,40,65,-25,38
Albion,3439,9,8,6,22,57,81,-24,30
Queen's Park,3439,10,6,10,20,41,75,-34,28
Ayr,3440,1,24,4,8,96,43,53,76
Raith,3440,2,22,9,5,69,33,36,75
Arbroath,3440,3,18,8,10,72,49,23,62
Alloa,3440,4,17,9,10,57,44,13,60
Stranraer,3440,5,15,6,15,55,64,-9,51
East Fife,3440,6,13,4,19,47,64,-17,43
Airdrieon,3440,7,10,11,15,46,60,-14,41
Forfar,3440,8,11,5,20,40,65,-25,38
Albion,3440,9,8,6,22,58,84,-26,30
Queen's Park,3440,10,6,10,20,40,74,-34,28
Ayr,3441,1,24,4,8,92,43,49,76
Raith,3441,2,22,8,6,69,35,34,74
Alloa,3441,3,18,8,10,59,44,15,62
Arbroath,3441,4,17,8,11,70,49,21,59
Stranraer,3441,5,15,6,15,56,65,-9,51
East Fife,3441,6,13,4,19,48,65,-17,43
Airdrieon,3441,7,10,11,15,45,59,-14,41
Forfar,3441,8,11,5,20,39,64,-25,38
Queen's Park,3441,9,7,10,19,40,72,-32,31
Albion,3441,10,8,6,22,58,80,-22,30
Raith,3442,1,23,8,5,69,32,37,77
Ayr,3442,2,24,4,8,92,42,50,76
Arbroath,3442,3,18,8,10,73,49,24,62
Alloa,3442,4,17,8,11,56,44,12,59
Stranraer,3442,5,15,5,16,55,69,-14,50
East Fife,3442,6,14,3,19,52,64,-12,45
Airdrieon,3442,7,11,11,14,47,58,-11,44
Forfar,3442,8,10,5,21,38,66,-28,35
Albion,3442,9,8,6,22,57,80,-23,30
Queen's Park,3442,10,6,10,20,40,75,-35,28
Ayr,3443,1,24,4,8,97,44,53,76
Raith,3443,2,22,9,5,70,34,36,75
Alloa,3443,3,17,9,10,58,45,13,60
Arbroath,3443,4,17,8,11,71,51,20,59
Stranraer,3443,5,16,5,15,58,66,-8,53
Airdrieon,3443,6,11,11,14,50,59,-9,44
East Fife,3443,7,13,3,20,49,67,-18,42
Forfar,3443,8,10,5,21,39,69,-30,35
Queen's Park,3443,9,7,10,19,42,73,-31,31
Albion,3443,10,8,6,22,59,85,-26,30
Ayr,3444,1,24,4,8,92,42,50,76
Raith,3444,2,22,8,6,68,34,34,74
Arbroath,3444,3,18,8,10,72,49,23,62
Alloa,3444,4,18,8,10,58,43,15,62
Stranraer,3444,5,15,5,16,55,67,-12,50
East Fife,3444,6,14,3,19,50,64,-14,45
Airdrieon,3444,7,10,11,15,46,60,-14,41
Forfar,3444,8,11,5,20,40,65,-25,38
Albion,3444,9,8,6,22,57,80,-23,30
Queen's Park,3444,10,6,10,20,40,74,-34,28
Ayr,3445,1,24,4,8,92,43,49,76
Raith,3445,2,22,8,6,69,34,35,74
Arbroath,3445,3,18,8,10,73,48,25,62
Alloa,3445,4,18,8,10,58,44,14,62
Stranraer,3445,5,15,5,16,56,66,-10,50
East Fife,3445,6,14,3,19,49,65,-16,45
Airdrieon,3445,7,10,12,14,48,61,-13,42
Forfar,3445,8,10,6,20,41,67,-26,36
Albion,3445,9,8,6,22,58,80,-22,30
Queen's Park,3445,10,6,10,20,39,75,-36,28
Raith,3446,1,23,8,5,69,32,37,77
Ayr,3446,2,24,4,8,95,44,51,76
Arbroath,3446,3,18,8,10,72,49,23,62
Alloa,3446,4,17,8,11,56,44,12,59
Stranraer,3446,5,16,5,15,58,65,-7,53
Airdrieon,3446,6,10,12,14,45,58,-13,42
East Fife,3446,7,13,3,20,48,67,-19,42
Forfar,3446,8,10,6,20,38,64,-26,36
Albion,3446,9,8,6,22,59,83,-24,30
Queen's Park,3446,10,6,10,20,40,74,-34,28
Ayr,3447,1,24,4,8,93,43,50,76
Raith,3447,2,22,9,5,68,32,36,75
Arbroath,3447,3,17,9,10,70,48,22,60
Alloa,3447,4,17,9,10,56,43,13,60
Stranraer,3447,5,15,5,16,57,67,-10,50
East Fife,3447,6,14,3,19,50,66,-16,45
Airdrieon,3447,7,10,11,15,45,59,-14,41
Forfar,3447,8,11,5,20,39,64,-25,38
Albion,3447,9,8,6,22,58,81,-23,30
Queen's Park,3447,10,6,11,19,39,72,-33,29
Raith,3448,1,22,9,5,69,33,36,75
Ayr,3448,2,23,4,9,91,44,47,73
Arbroath,3448,3,18,8,10,72,49,23,62
Alloa,3448,4,17,9,10,57,44,13,60
Stranraer,3448,5,15,5,16,57,67,-10,50
East Fife,3448,6,14,3,19,50,66,-16,45
Airdrieon,3448,7,11,11,14,49,58,-9,44
Forfar,3448,8,10,5,21,38,68,-30,35
Albion,3448,9,9,6,21,59,79,-20,33
Queen's Park,3448,10,6,10,20,40,74,-34,28
Raith,3449,1,23,8,5,70,33,37,77
Ayr,3449,2,24,4,8,94,45,49,76
Arbroath,3449,3,17,9,10,71,49,22,60
Alloa,3449,4,17,8,11,57,45,12,59
Stranraer,3449,5,16,5,15,58,65,-7,53
Airdrieon,3449,6,10,12,14,46,59,-13,42
East Fife,3449,7,13,3,20,48,67,-19,42
Forfar,3449,8,10,6,20,39,65,-26,36
Albion,3449,9,8,6,22,60,82,-22,30
Queen's Park,3449,10,6,11,19,40,73,-33,29
Raith,3450,1,23,8,5,72,34,38,77
Ayr,3450,2,24,4,8,95,42,53,76
Arbroath,3450,3,18,8,10,75,49,26,62
Alloa,3450,4,17,8,11,58,47,11,59
Stranraer,3450,5,16,5,15,56,64,-8,53
East Fife,3450,6,13,3,20,47,65,-18,42
Airdrieon,3450,7,10,11,15,47,61,-14,41
Forfar,3450,8,11,5,20,41,66,-25,38
Albion,3450,9,8,6,22,57,83,-26,30
Queen's Park,3450,10,6,10,20,40,77,-37,28
Ayr,3451,1,24,4,8,95,44,51,76
Raith,3451,2,22,8,6,69,34,35,74
Alloa,3451,3,18,8,10,58,44,14,62
Arbroath,3451,4,17,8,11,71,51,20,59
Stranraer,3451,5,16,5,15,58,65,-7,53
Airdrieon,3451,6,11,11,14,47,59,-12,44
East Fife,3451,7,13,3,20,48,67,-19,42
Forfar,3451,8,10,5,21,39,66,-27,35
Queen's Park,3451,9,7,10,19,42,73,-31,31
Albion,3451,10,8,6,22,59,83,-24,30
Raith,3452,1,23,8,5,70,33,37,77
Ayr,3452,2,23,5,8,91,43,48,74
Arbroath,3452,3,18,8,10,71,48,23,62
Alloa,3452,4,17,8,11,57,45,12,59
Stranraer,3452,5,16,5,15,58,64,-6,53
Airdrieon,3452,6,11,11,14,47,58,-11,44
East Fife,3452,7,13,3,20,47,67,-20,42
Forfar,3452,8,10,5,21,38,66,-28,35
Albion,3452,9,8,7,21,58,79,-21,31
Queen's Park,3452,10,6,10,20,39,73,-34,28
Raith,3453,1,23,8,5,70,32,38,77
Ayr,3453,2,24,4,8,94,44,50,76
Arbroath,3453,3,18,8,10,72,49,23,62
Alloa,3453,4,17,8,11,56,45,11,59
Stranraer,3453,5,15,5,16,55,65,-10,50
East Fife,3453,6,14,3,19,48,64,-16,45
Airdrieon,3453,7,10,11,15,45,59,-14,41
Forfar,3453,8,11,5,20,39,64,-25,38
Albion,3453,9,8,6,22,59,82,-23,30
Queen's Park,3453,10,6,10,20,40,74,-34,28
Ayr,3454,1,24,4,8,92,43,49,76
Raith,3454,2,22,9,5,68,32,36,75
Arbroath,3454,3,17,9,10,71,49,22,60
Alloa,3454,4,17,9,10,56,43,13,60
Stranraer,3454,5,15,6,15,56,65,-9,51
East Fife,3454,6,13,4,19,48,65,-17,43
Airdrieon,3454,7,10,11,15,45,59,-14,41
Forfar,3454,8,11,5,20,39,64,-25,38
Albion,3454,9,8,6,22,58,80,-22,30
Queen's Park,3454,10,6,11,19,40,73,-33,29
Ayr,3455,1,24,4,8,94,44,50,76
Raith,3455,2,22,8,6,68,33,35,74
Alloa,3455,3,18,8,10,57,43,14,62
Arbroath,3455,4,17,8,11,73,52,21,59
Stranraer,3455,5,15,6,15,58,67,-9,51
Airdrieon,3455,6,11,11,14,48,59,-11,44
East Fife,3455,7,13,4,19,50,67,-17,43
Forfar,3455,8,10,5,21,39,67,-28,35
Queen's Park,3455,9,7,10,19,43,75,-32,31
Albion,3455,10,8,6,22,59,82,-23,30
Raith,3456,1,23,8,5,69,32,37,77
Ayr,3456,2,24,4,8,93,43,50,76
Arbroath,3456,3,18,8,10,71,48,23,62
Alloa,3456,4,17,8,11,56,44,12,59
Stranraer,3456,5,15,5,16,56,66,-10,50
East Fife,3456,6,14,3,19,49,65,-16,45
Airdrieon,3456,7,11,11,14,47,59,-12,44
Forfar,3456,8,10,5,21,39,66,-27,35
Albion,3456,9,8,6,22,58,81,-23,30
Queen's Park,3456,10,6,10,20,39,73,-34,28
Raith,3457,1,23,8,5,69,32,37,77
Ayr,3457,2,24,4,8,93,44,49,76
Arbroath,3457,3,18,8,10,72,48,24,62
Alloa,3457,4,17,8,11,56,44,12,59
Stranraer,3457,5,15,5,16,55,66,-11,50
East Fife,3457,6,14,3,19,49,64,-15,45
Airdrieon,3457,7,11,11,14,47,58,-11,44
Forfar,3457,8,10,5,21,38,66,-28,35
Albion,3457,9,8,6,22,59,81,-22,30
Queen's Park,3457,10,6,10,20,39,74,-35,28
Raith,3458,1,23,8,5,71,33,38,77
Ayr,3458,2,24,4,8,94,44,50,76
Arbroath,3458,3,18,8,10,74,51,23,62
Alloa,3458,4,17,8,11,57,46,11,59
Stranraer,3458,5,15,5,16,56,67,-11,50
East Fife,3458,6,14,3,19,50,65,-15,45
Airdrieon,3458,7,11,11,14,47,59,-12,44
Forfar,3458,8,10,5,21,39,66,-27,35
Albion,3458,9,8,6,22,59,82,-23,30
Queen's Park,3458,10,6,10,20,42,76,-34,28
Ayr,3459,1,23,5,8,92,44,48,74
Raith,3459,2,22,8,6,68,33,35,74
Alloa,3459,3,18,8,10,57,43,14,62
Arbroath,3459,4,17,9,10,71,49,22,60
Stranraer,3459,5,16,5,15,57,65,-8,53
East Fife,3459,6,13,3,20,48,66,-18,42
Airdrieon,3459,7,10,11,15,46,62,-16,41
Forfar,3459,8,11,5,20,42,65,-23,38
Albion,3459,9,8,7,21,59,80,-21,31
Queen's Park,3459,10,6,11,19,40,73,-33,29
Raith,3460,1,23,8,5,74,33,41,77
Ayr,3460,2,24,4,8,92,43,49,76
Arbroath,3460,3,18,8,10,74,48,26,62
Alloa,3460,4,17,8,11,57,49,8,59
Stranraer,3460,5,15,5,16,55,65,-10,50
East Fife,3460,6,14,3,19,48,64,-16,45
Airdrieon,3460,7,10,11,15,45,59,-14,41
Forfar,3460,8,11,5,20,39,64,-25,38
Albion,3460,9,8,6,22,58,80,-22,30
Queen's Park,3460,10,6,10,20,39,76,-37,28
Ayr,3461,1,24,4,8,95,44,51,76
Raith,3461,2,22,8,6,69,34,35,74
Arbroath,3461,3,18,8,10,73,50,23,62
Alloa,3461,4,18,8,10,58,44,14,62
Stranraer,3461,5,16,5,15,56,64,-8,53
Airdrieon,3461,6,11,11,14,48,59,-11,44
East Fife,3461,7,13,3,20,47,65,-18,42
Forfar,3461,8,10,5,21,39,67,-28,35
Albion,3461,9,8,6,22,59,83,-24,30
Queen's Park,3461,10,6,10,20,41,75,-34,28
Ayr,3462,1,24,4,8,96,42,54,76
Raith,3462,2,22,8,6,68,34,34,74
Alloa,3462,3,18,8,10,58,43,15,62
Arbroath,3462,4,17,8,11,70,49,21,59
Stranraer,3462,5,16,5,15,58,65,-7,53
Airdrieon,3462,6,11,11,14,48,58,-10,44
East Fife,3462,7,13,3,20,48,67,-19,42
Forfar,3462,8,10,5,21,38,67,-29,35
Queen's Park,3462,9,7,10,19,40,72,-32,31
Albion,3462,10,8,6,22,57,84,-27,30
Raith,3463,1,23,8,5,69,32,37,77
Ayr,3463,2,24,4,8,95,43,52,76
Arbroath,3463,3,17,9,10,72,50,22,60
Alloa,3463,4,17,8,11,56,44,12,59
Stranraer,3463,5,15,5,16,55,67,-12,50
East Fife,3463,6,14,3,19,50,64,-14,45
Airdrieon,3463,7,10,11,15,47,61,-14,41
Forfar,3463,8,11,5,20,41,66,-25,38
Albion,3463,9,8,6,22,58,83,-25,30
Queen's Park,3463,10,6,11,19,41,74,-33,29
Raith,3464,1,23,8,5,72,34,38,77
Ayr,3464,2,24,4,8,94,45,49,76
Arbroath,3464,3,18,8,10,72,48,24,62
Alloa,3464,4,17,8,11,58,47,11,59
Stranraer,3464,5,16,5,15,57,65,-8,53
Airdrieon,3464,6,11,11,14,48,58,-10,44
East Fife,3464,7,13,3,20,48,66,-18,42
Forfar,3464,8,10,5,21,38,67,-29,35
Albion,3464,9,8,6,22,60,82,-22,30
Queen's Park,3464,10,6,10,20,39,74,-35,28
Raith,3465,1,23,8,5,71,32,39,77
Ayr,3465,2,24,4,8,94,43,51,76
Arbroath,3465,3,17,9,10,72,50,22,60
Alloa,3465,4,17,8,11,56,46,10,59
Stranraer,3465,5,15,5,16,55,67,-12,50
East Fife,3465,6,14,3,19,50,64,-14,45
Airdrieon,3465,7,10,11,15,45,61,-16,41
Forfar,3465,8,11,5,20,41,64,-23,38
Albion,3465,9,8,6,22,58,82,-24,30
Queen's Park,3465,10,6,11,19,41,74,-33,29
Ayr,3466,1,24,4,8,95,43,52,76
Raith,3466,2,22,8,6,70,35,35,74
Arbroath,3466,3,18,8,10,72,49,23,62
Alloa,3466,4,18,8,10,59,45,14,62
Stranraer,3466,5,16,5,15,56,64,-8,53
Airdrieon,3466,6,10,12,14,49,62,-13,42
East Fife,3466,7,13,3,20,47,65,-18,42
Forfar,3466,8,10,6,20,42,68,-26,36
Albion,3466,9,8,6,22,58,83,-25,30
Queen's Park,3466,10,6,10,20,40,74,-34,28
Ayr,3467,1,24,4,8,93,43,50,76
Raith,3467,2,22,9,5,69,33,36,75
Arbroath,3467,3,18,8,10,74,49,25,62
Alloa,3467,4,17,9,10,57,44,13,60
Stranraer,3467,5,15,6,15,56,65,-9,51
East Fife,3467,6,13,4,19,48,65,-17,43
Airdrieon,3467,7,10,12,14,46,59,-13,42
Forfar,3467,8,10,6,20,39,65,-26,36
Albion,3467,9,8,6,22,58,81,-23,30
Queen's Park,3467,10,6,10,20,40,76,-36,28
Raith,3468,1,23,8,5,69,32,37,77
Ayr,3468,2,23,4,9,91,45,46,73
Arbroath,3468,3,17,9,10,72,50,22,60
Alloa,3468,4,17,8,11,56,44,12,59
Stranraer,3468,5,15,5,16,59,69,-10,50
East Fife,3468,6,14,3,19,52,68,-16,45
Airdrieon,3468,7,11,11,14,49,60,-11,44
Forfar,3468,8,10,5,21,40,68,-28,35
Albion,3468,9,9,6,21,60,79,-19,33
Queen's Park,3468,10,6,11,19,41,74,-33,29
Ayr,3469,1,24,4,8,96,43,53,76
Raith,3469,2,22,8,6,69,34,35,74
Arbroath,3469,3,18,8,10,72,49,23,62
Alloa,3469,4,18,8,10,58,44,14,62
Stranraer,3469,5,16,5,15,58,65,-7,53
Airdrieon,3469,6,11,11,14,49,59,-10,44
East Fife,3469,7,13,3,20,48,67,-19,42
Forfar,3469,8,10,5,21,39,68,-29,35
Albion,3469,9,8,6,22,58,84,-26,30
Queen's Park,3469,10,6,10,20,40,74,-34,28
Raith,3470,1,23,8,5,70,33,37,77
Ayr,3470,2,23,5,8,92,44,48,74
Arbroath,3470,3,17,9,10,71,49,22,60
Alloa,3470,4,17,8,11,57,45,12,59
Stranraer,3470,5,15,6,15,56,65,-9,51
Airdrieon,3470,6,11,11,14,48,60,-12,44
East Fife,3470,7,13,4,19,48,65,-17,43
Forfar,3470,8,10,5,21,40,67,-27,35
Albion,3470,9,8,7,21,59,80,-21,31
Queen's Park,3470,10,6,11,19,40,73,-33,29
Raith,3471,1,23,8,5,70,32,38,77
Ayr,3471,2,24,4,8,93,42,51,76
Arbroath,3471,3,18,8,10,73,49,24,62
Alloa,3471,4,17,8,11,56,45,11,59
Stranraer,3471,5,15,6,15,56,65,-9,51
Airdrieon,3471,6,11,11,14,49,58,-9,44
East Fife,3471,7,13,4,19,48,65,-17,43
Forfar,3471,8,10,5,21,38,68,-30,35
Albion,3471,9,8,6,22,57,81,-24,30
Queen's Park,3471,10,6,10,20,40,75,-35,28
Raith,3472,1,23,8,5,71,33,38,77
Ayr,3472,2,24,4,8,92,43,49,76
Arbroath,3472,3,17,9,10,71,49,22,60
Alloa,3472,4,17,8,11,57,46,11,59
Stranraer,3472,5,16,5,15,58,65,-7,53
Airdrieon,3472,6,11,11,14,47,58,-11,44
East Fife,3472,7,13,3,20,48,67,-19,42
Forfar,3472,8,10,5,21,38,66,-28,35
Albion,3472,9,8,6,22,58,80,-22,30
Queen's Park,3472,10,6,11,19,40,73,-33,29
Ayr,3473,1,24,4,8,93,44,49,76
Raith,3473,2,22,8,6,69,34,35,74
Arbroath,3473,3,18,8,10,72,49,23,62
Alloa,3473,4,18,8,10,58,44,14,62
Stranraer,3473,5,16,5,15,57,64,-7,53
Airdrieon,3473,6,11,11,14,46,58,-12,44
East Fife,3473,7,13,3,20,47,66,-19,42
Forfar,3473,8,10,5,21,38,65,-27,35
Albion,3473,9,8,6,22,59,81,-22,30
Queen's Park,3473,10,6,10,20,40,74,-34,28
Ayr,3474,1,24,4,8,92,42,50,76
Raith,3474,2,22,9,5,68,32,36,75
Arbroath,3474,3,17,9,10,73,51,22,60
Alloa,3474,4,17,9,10,56,43,13,60
Stranraer,3474,5,15,6,15,56,65,-9,51
Airdrieon,3474,6,11,11,14,49,58,-9,44
East Fife,3474,7,13,4,19,48,65,-17,43
Forfar,3474,8,10,5,21,38,68,-30,35
Albion,3474,9,8,6,22,57,80,-23,30
Queen's Park,3474,10,6,11,19,42,75,-33,29
Raith,3475,1,23,8,5,69,32,37,77
Ayr,3475,2,24,4,8,96,42,54,76
Arbroath,3475,3,18,8,10,74,50,24,62
Alloa,3475,4,17,8,11,56,44,12,59
Stranraer,3475,5,15,5,16,58,68,-10,50
East Fife,3475,6,14,3,19,51,67,-16,45
Airdrieon,3475,7,11,11,14,49,60,-11,44
Forfar,3475,8,10,5,21,40,68,-28,35
Albion,3475,9,8,6,22,57,84,-27,30
Queen's Park,3475,10,6,10,20,41,76,-35,28
Raith,3476,1,23,8,5,69,32,37,77
Ayr,3476,2,24,4,8,91,42,49,76
Arbroath,3476,3,18,8,10,73,48,25,62
Alloa,3476,4,17,8,11,56,44,12,59
Stranraer,3476,5,16,5,15,58,64,-6,53
East Fife,3476,6,13,3,20,47,67,-20,42
Airdrieon,3476,7,10,11,15,46,61,-15,41
Forfar,3476,8,11,5,20,41,65,-24,38
Albion,3476,9,8,6,22,57,79,-22,30
Queen's Park,3476,10,6,10,20,39,75,-36,28
Raith,3477,1,23,8,5,71,32,39,77
Ayr,3477,2,24,4,8,93,44,49,76
Arbroath,3477,3,17,8,11,70,51,19,59
Alloa,3477,4,17,8,11,56,46,10,59
Stranraer,3477,5,16,5,15,57,65,-8,53
Airdrieon,3477,6,11,11,14,46,58,-12,44
East Fife,3477,7,13,3,20,48,66,-18,42
Forfar,3477,8,10,5,21,38,65,-27,35
Queen's Park,3477,9,7,10,19,42,72,-30,31
Albion,3477,10,8,6,22,59,81,-22,30
Raith,3478,1,23,8,5,71,33,38,77
Ayr,3478,2,24,4,8,92,43,49,76
Arbroath,3478,3,17,8,11,71,50,21,59
Alloa,3478,4,17,8,11,57,46,11,59
Stranraer,3478,5,16,5,15,57,65,-8,53
Airdrieon,3478,6,11,11,14,46,58,-12,44
East Fife,3478,7,13,3,20,48,66,-18,42
Forfar,3478,8,10,5,21,38,65,-27,35
Queen's Park,3478,9,7,10,19,41,73,-32,31
Albion,3478,10,8,6,22,58,80,-22,30
Ayr,3479,1,24,4,8,98,43,55,76
Raith,3479,2,22,9,5,69,33,36,75
Alloa,3479,3,17,9,10,57,44,13,60
Arbroath,3479,4,17,8,11,71,51,20,59
Stranraer,3479,5,15,5,16,56,68,-12,50
East Fife,3479,6,14,3,19,51,65,-14,45
Airdrieon,3479,7,11,11,14,48,58,-10,44
Forfar,3479,8,10,5,21,38,67,-29,35
Queen's Park,3479,9,7,10,19,42,73,-31,31
Albion,3479,10,8,6,22,58,86,-28,30
Raith,3480,1,22,9,5,70,34,36,75
Ayr,3480,2,23,5,8,93,45,48,74
Alloa,3480,3,17,9,10,58,45,13,60
Arbroath,3480,4,17,8,11,71,53,18,59
Stranraer,3480,5,16,5,15,57,65,-8,53
Airdrieon,3480,6,10,12,14,45,58,-13,42
East Fife,3480,7,13,3,20,48,66,-18,42
Forfar,3480,8,10,6,20,38,64,-26,36
Albion,3480,9,8,7,21,60,81,-21,31
Queen's Park,3480,10,7,10,19,44,73,-29,31
Raith,3481,1,23,8,5,70,33,37,77
Ayr,3481,2,24,4,8,94,42,52,76
Arbroath,3481,3,17,9,10,70,48,22,60
Alloa,3481,4,17,8,11,57,45,12,59
Stranraer,3481,5,16,5,15,59,66,-7,53
Airdrieon,3481,6,10,12,14,46,59,-13,42
East Fife,3481,7,13,3,20,49,68,-19,42
Forfar,3481,8,10,6,20,39,65,-26,36
Albion,3481,9,8,6,22,57,82,-25,30
Queen's Park,3481,10,6,11,19,39,72,-33,29
Raith,3482,1,23,8,5,69,32,37,77
Ayr,3482,2,24,4,8,94,43,51,76
Arbroath,3482,3,18,8,10,74,51,23,62
Alloa,3482,4,17,8,11,56,44,12,59
Stranraer,3482,5,15,5,16,56,68,-12,50
East Fife,3482,6,14,3,19,51,65,-14,45
Airdrieon,3482,7,11,11,14,46,58,-12,44
Forfar,3482,8,10,5,21,38,65,-27,35
Albion,3482,9,8,6,22,58,82,-24,30
Queen's Park,3482,10,6,10,20,42,76,-34,28
Ayr,3483,1,24,4,8,96,42,54,76
Raith,3483,2,22,9,5,69,33,36,75
Arbroath,3483,3,18,8,10,71,48,23,62
Alloa,3483,4,17,9,10,57,44,13,60
Stranraer,3483,5,15,6,15,59,68,-9,51
Airdrieon,3483,6,11,11,14,47,59,-12,44
East Fife,3483,7,13,4,19,51,68,-17,43
Forfar,3483,8,10,5,21,39,66,-27,35
Albion,3483,9,8,6,22,57,84,-27,30
Queen's Park,3483,10,6,10,20,39,73,-34,28
Raith,3484,1,23,8,5,73,33,40,77
Ayr,3484,2,24,4,8,92,43,49,76
Arbroath,3484,3,17,9,10,71,49,22,60
Alloa,3484,4,17,8,11,57,48,9,59
Stranraer,3484,5,15,5,16,57,67,-10,50
East Fife,3484,6,14,3,19,50,66,-16,45
Airdrieon,3484,7,11,11,14,47,59,-12,44
Forfar,3484,8,10,5,21,39,66,-27,35
Albion,3484,9,8,6,22,58,80,-22,30
Queen's Park,3484,10,6,11,19,40,73,-33,29
Raith,3485,1,23,8,5,70,32,38,77
Ayr,3485,2,24,4,8,94,44,50,76
Arbroath,3485,3,17,9,10,71,49,22,60
Alloa,3485,4,17,8,11,56,45,11,59
Stranraer,3485,5,15,6,15,57,66,-9,51
Airdrieon,3485,6,11,11,14,47,59,-12,44
East Fife,3485,7,13,4,19,49,66,-17,43
Forfar,3485,8,10,5,21,39,66,-27,35
Albion,3485,9,8,6,22,59,82,-23,30
Queen's Park,3485,10,6,11,19,40,73,-33,29
Raith,3486,1,23,8,5,70,33,37,77
Ayr,3486,2,24,4,8,94,43,51,76
Arbroath,3486,3,18,8,10,74,51,23,62
Alloa,3486,4,17,8,11,57,45,12,59
Stranraer,3486,5,15,5,16,55,65,-10,50
East Fife,3486,6,14,3,19,48,64,-16,45
Airdrieon,3486,7,10,11,15,46,60,-14,41
Forfar,3486,8,11,5,20,40,65,-25,38
Albion,3486,9,8,6,22,58,82,-24,30
Queen's Park,3486,10,6,10,20,42,76,-34,28
Raith,3487,1,23,8,5,69,32,37,77
Ayr,3487,2,23,5,8,93,45,48,74
Arbroath,3487,3,17,9,10,71,49,22,60
Alloa,3487,4,17,8,11,56,44,12,59
Stranraer,3487,5,15,5,16,57,67,-10,50
East Fife,3487,6,14,3,19,50,66,-16,45
Airdrieon,3487,7,11,11,14,47,58,-11,44
Forfar,3487,8,10,5,21,38,66,-28,35
Albion,3487,9,8,7,21,60,81,-21,31
Queen's Park,3487,10,6,11,19,40,73,-33,29
Ayr,3488,1,24,4,8,93,44,49,76
Raith,3488,2,22,8,6,68,33,35,74
Arbroath,3488,3,18,8,10,73,48,25,62
Alloa,3488,4,18,8,10,57,43,14,62
Stranraer,3488,5,16,5,15,59,67,-8,53
Airdrieon,3488,6,10,12,14,48,61,-13,42
East Fife,3488,7,13,3,20,50,68,-18,42
Forfar,3488,8,10,6,20,41,67,-26,36
Albion,3488,9,8,6,22,59,81,-22,30
Queen's Park,3488,10,6,10,20,39,75,-36,28
Raith,3489,1,23,8,5,70,33,37,77
Ayr,3489,2,24,4,8,95,45,50,76
Arbroath,3489,3,17,8,11,71,53,18,59
Alloa,3489,4,17,8,11,57,45,12,59
Stranraer,3489,5,15,5,16,56,67,-11,50
East Fife,3489,6,14,3,19,50,65,-15,45
Airdrieon,3489,7,11,11,14,47,59,-12,44
Forfar,3489,8,10,5,21,39,66,-27,35
Queen's Park,3489,9,7,10,19,44,73,-29,31
Albion,3489,10,8,6,22,60,83,-23,30
Ayr,3490,1,24,4,8,93,42,51,76
Raith,3490,2,22,8,6,68,33,35,74
Alloa,3490,3,18,8,10,57,43,14,62
Arbroath,3490,4,17,9,10,70,48,22,60
Stranraer,3490,5,15,6,15,56,65,-9,51
East Fife,3490,6,13,4,19,48,65,-17,43
Airdrieon,3490,7,10,12,14,46,59,-13,42
Forfar,3490,8,10,6,20,39,65,-26,36
Albion,3490,9,8,6,22,57,81,-24,30
Queen's Park,3490,10,6,11,19,39,72,-33,29
Raith,3491,1,23,8,5,70,32,38,77
Ayr,3491,2,24,4,8,92,42,50,76
Arbroath,3491,3,18,8,10,74,48,26,62
Alloa,3491,4,17,8,11,56,45,11,59
Stranraer,3491,5,15,6,15,56,65,-9,51
Airdrieon,3491,6,11,11,14,49,58,-9,44
East Fife,3491,7,13,4,19,48,65,-17,43
Forfar,3491,8,10,5,21,38,68,-30,35
Albion,3491,9,8,6,22,57,80,-23,30
Queen's Park,3491,10,6,10,20,39,76,-37,28
Raith,3492,1,22,9,5,69,33,36,75
Ayr,3492,2,23,4,9,92,45,47,73
Arbroath,3492,3,17,9,10,72,50,22,60
Alloa,3492,4,17,9,10,57,44,13,60
Stranraer,3492,5,15,6,15,55,64,-9,51
Airdrieon,3492,6,11,11,14,46,58,-12,44
East Fife,3492,7,13,4,19,47,64,-17,43
Forfar,3492,8,10,5,21,38,65,-27,35
Albion,3492,9,9,6,21,60,80,-20,33
Queen's Park,3492,10,6,11,19,41,74,-33,29
Ayr,3493,1,24,4,8,95,45,50,76
Raith,3493,2,22,9,5,70,34,36,75
Arbroath,3493,3,18,8,10,74,49,25,62
Alloa,3493,4,17,9,10,58,45,13,60
Stranraer,3493,5,15,6,15,56,65,-9,51
East Fife,3493,6,13,4,19,48,65,-17,43
Airdrieon,3493,7,10,12,14,48,61,-13,42
Forfar,3493,8,10,6,20,41,67,-26,36
Albion,3493,9,8,6,22,60,83,-23,30
Queen's Park,3493,10,6,10,20,40,76,-36,28
Ayr,3494,1,24,4,8,94,44,50,76
Raith,3494,2,22,8,6,69,34,35,74
Arbroath,3494,3,18,8,10,71,48,23,62
Alloa,3494,4,18,8,10,58,44,14,62
Stranraer,3494,5,15,5,16,55,65,-10,50
East Fife,3494,6,14,3,19,48,64,-16,45
Airdrieon,3494,7,11,11,14,47,59,-12,44
Forfar,3494,8,10,5,21,39,66,-27,35
Albion,3494,9,8,6,22,59,82,-23,30
Queen's Park,3494,10,6,10,20,39,73,-34,28
Ayr,3495,1,24,4,8,95,44,51,76
Raith,3495,2,22,9,5,69,33,36,75
Arbroath,3495,3,18,8,10,73,48,25,62
Alloa,3495,4,17,9,10,57,44,13,60
Stranraer,3495,5,15,5,16,55,66,-11,50
East Fife,3495,6,14,3,19,49,64,-15,45
Airdrieon,3495,7,11,11,14,50,58,-8,44
Forfar,3495,8,10,5,21,38,69,-31,35
Albion,3495,9,8,6,22,59,83,-24,30
Queen's Park,3495,10,6,10,20,39,75,-36,28
Raith,3496,1,23,8,5,69,32,37,77
Ayr,3496,2,24,4,8,98,43,55,76
Arbroath,3496,3,17,9,10,71,49,22,60
Alloa,3496,4,17,8,11,56,44,12,59
Stranraer,3496,5,15,5,16,55,66,-11,50
East Fife,3496,6,14,3,19,49,64,-15,45
Airdrieon,3496,7,11,11,14,47,59,-12,44
Forfar,3496,8,10,5,21,39,66,-27,35
Albion,3496,9,8,6,22,58,86,-28,30
Queen's Park,3496,10,6,11,19,40,73,-33,29
Raith,3497,1,23,8,5,71,34,37,77
Ayr,3497,2,24,4,8,95,43,52,76
Arbroath,3497,3,17,8,11,71,50,21,59
Alloa,3497,4,17,8,11,58,46,12,59
Stranraer,3497,5,15,6,15,56,65,-9,51
Airdrieon,3497,6,11,11,14,47,58,-11,44
East Fife,3497,7,13,4,19,48,65,-17,43
Forfar,3497,8,10,5,21,38,66,-28,35
Queen's Park,3497,9,7,10,19,41,73,-32,31
Albion,3497,10,8,6,22,58,83,-25,30
Raith,3498,1,23,8,5,72,34,38,77
Ayr,3498,2,24,4,8,96,43,53,76
Arbroath,3498,3,18,8,10,74,49,25,62
Alloa,3498,4,17,8,11,58,47,11,59
Stranraer,3498,5,15,5,16,57,67,-10,50
East Fife,3498,6,14,3,19,50,66,-16,45
Airdrieon,3498,7,10,11,15,46,61,-15,41
Forfar,3498,8,11,5,20,41,65,-24,38
Albion,3498,9,8,6,22,58,84,-26,30
Queen's Park,3498,10,6,10,20,40,76,-36,28
Raith,3499,1,23,8,5,72,32,40,77
Ayr,3499,2,24,4,8,92,42,50,76
Arbroath,3499,3,18,8,10,73,49,24,62
Alloa,3499,4,17,8,11,56,47,9,59
Stranraer,3499,5,15,6,15,57,66,-9,51
East Fife,3499,6,13,4,19,49,66,-17,43
Airdrieon,3499,7,10,12,14,47,60,-13,42
Forfar,3499,8,10,6,20,40,66,-26,36
Albion,3499,9,8,6,22,57,80,-23,30
Queen's Park,3499,10,6,10,20,40,75,-35,28
Raith,3500,1,23,8,5,72,32,40,77
Ayr,3500,2,24,4,8,94,42,52,76
Arbroath,3500,3,17,8,11,73,52,21,59
Alloa,3500,4,17,8,11,56,47,9,59
Stranraer,3500,5,16,5,15,59,67,-8,53
East Fife,3500,6,13,3,20,50,68,-18,42
Airdrieon,3500,7,10,11,15,46,60,-14,41
Forfar,3500,8,11,5,20,40,65,-25,38
Queen's Park,3500,9,7,10,19,43,75,-32,31
Albion,3500,10,8,6,22,57,82,-25,30
Ayr,3501,1,24,4,8,93,43,50,76
Raith,3501,2,22,9,5,69,33,36,75
Arbroath,3501,3,17,9,10,71,49,22,60
Alloa,3501,4,17,9,10,57,44,13,60
Stranraer,3501,5,16,5,15,56,64,-8,53
Airdrieon,3501,6,10,12,14,47,60,-13,42
East Fife,3501,7,13,3,20,47,65,-18,42
Forfar,3501,8,10,6,20,40,66,-26,36
Albion,3501,9,8,6,22,58,81,-23,30
Queen's Park,3501,10,6,11,19,40,73,-33,29
Raith,3502,1,23,8,5,70,33,37,77
Ayr,3502,2,24,4,8,96,42,54,76
Arbroath,3502,3,18,8,10,74,48,26,62
Alloa,3502,4,17,8,11,57,45,12,59
Stranraer,3502,5,15,5,16,56,67,-11,50
East Fife,3502,6,14,3,19,50,65,-15,45
Airdrieon,3502,7,10,12,14,45,58,-13,42
Forfar,3502,8,10,6,20,38,64,-26,36
Albion,3502,9,8,6,22,57,84,-27,30
Queen's Park,3502,10,6,10,20,39,76,-37,28
Raith,3503,1,23,8,5,70,32,38,77
Ayr,3503,2,24,4,8,98,43,55,76
Arbroath,3503,3,17,9,10,73,51,22,60
Alloa,3503,4,17,8,11,56,45,11,59
Stranraer,3503,5,16,5,15,58,64,-6,53
East Fife,3503,6,13,3,20,47,67,-20,42
Airdrieon,3503,7,10,11,15,46,60,-14,41
Forfar,3503,8,11,5,20,40,65,-25,38
Albion,3503,9,8,6,22,58,86,-28,30
Queen's Park,3503,10,6,11,19,42,75,-33,29
Raith,3504,1,23,8,5,69,32,37,77
Ayr,3504,2,23,4,9,93,47,46,73
Arbroath,3504,3,18,8,10,74,49,25,62
Alloa,3504,4,17,8,11,56,44,12,59
Stranraer,3504,5,16,5,15,57,65,-8,53
Airdrieon,3504,6,11,11,14,48,58,-10,44
East Fife,3504,7,13,3,20,48,66,-18,42
Forfar,3504,8,10,5,21,38,67,-29,35
Albion,3504,9,9,6,21,62,81,-19,33
Queen's Park,3504,10,6,10,20,40,76,-36,28
Raith,3505,1,23,8,5,71,33,38,77
Ayr,3505,2,24,4,8,95,43,52,76
Arbroath,3505,3,17,8,11,73,53,20,59
Alloa,3505,4,17,8,11,57,46,11,59
Stranraer,3505,5,16,5,15,58,65,-7,53
East Fife,3505,6,13,3,20,48,67,-19,42
Airdrieon,3505,7,10,11,15,45,61,-16,41
Forfar,3505,8,11,5,20,41,64,-23,38
Queen's Park,3505,9,7,10,19,44,75,-31,31
Albion,3505,10,8,6,22,58,83,-25,30
Raith,3506,1,23,8,5,69,32,37,77
Ayr,3506,2,23,5,8,91,43,48,74
Arbroath,3506,3,18,8,10,73,49,24,62
Alloa,3506,4,17,8,11,56,44,12,59
Stranraer,3506,5,15,5,16,57,68,-11,50
East Fife,3506,6,14,3,19,51,66,-15,45
Airdrieon,3506,7,11,11,14,47,59,-12,44
Forfar,3506,8,10,5,21,39,66,-27,35
Albion,3506,9,8,7,21,58,79,-21,31
Queen's Park,3506,10,6,10,20,40,75,-35,28
Raith,3507,1,23,8,5,70,33,37,77
Ayr,3507,2,24,4,8,94,42,52,76
Arbroath,3507,3,17,9,10,71,49,22,60
Alloa,3507,4,17,8,11,57,45,12,59
Stranraer,3507,5,16,5,15,59,66,-7,53
Airdrieon,3507,6,11,11,14,48,59,-11,44
East Fife,3507,7,13,3,20,49,68,-19,42
Forfar,3507,8,10,5,21,39,67,-28,35
Albion,3507,9,8,6,22,57,82,-25,30
Queen's Park,3507,10,6,11,19,40,73,-33,29
Raith,3508,1,23,8,5,69,32,37,77
Ayr,3508,2,23,5,8,91,43,48,74
Arbroath,3508,3,17,9,10,72,50,22,60
Alloa,3508,4,17,8,11,56,44,12,59
Stranraer,3508,5,15,6,15,56,65,-9,51
Airdrieon,3508,6,11,11,14,48,58,-10,44
East Fife,3508,7,13,4,19,48,65,-17,43
Forfar,3508,8,10,5,21,38,67,-29,35
Albion,3508,9,8,7,21,58,79,-21,31
Queen's Park,3508,10,6,11,19,41,74,-33,29
Raith,3509,1,22,9,5,69,33,36,75
Ayr,3509,2,23,5,8,92,44,48,74
Alloa,3509,3,17,9,10,57,44,13,60
Arbroath,3509,4,17,8,11,70,49,21,59
Stranraer,3509,5,15,6,15,57,66,-9,51
East Fife,3509,6,13,4,19,49,66,-17,43
Airdrieon,3509,7,10,12,14,46,59,-13,42
Forfar,3509,8,10,6,20,39,65,-26,36
Albion,3509,9,8,7,21,59,80,-21,31
Queen's Park,3509,10,7,10,19,40,72,-32,31
Ayr,3510,1,24,4,8,92,43,49,76
Raith,3510,2,22,9,5,68,32,36,75
Alloa,3510,3,17,9,10,56,43,13,60
Arbroath,3510,4,17,8,11,70,49,21,59
Stranraer,3510,5,16,5,15,59,65,-6,53
Airdrieon,3510,6,11,11,14,48,60,-12,44
East Fife,3510,7,13,3,20,48,68,-20,42
Forfar,3510,8,10,5,21,40,67,-27,35
Queen's Park,3510,9,7,10,19,40,72,-32,31
Albion,3510,10,8,6,22,58,80,-22,30
Raith,3511,1,23,8,5,69,32,37,77
Ayr,3511,2,23,4,9,90,45,45,73
Arbroath,3511,3,18,8,10,73,50,23,62
Alloa,3511,4,17,8,11,56,44,12,59
Stranraer,3511,5,16,5,15,57,65,-8,53
Airdrieon,3511,6,11,11,14,49,60,-11,44
East Fife,3511,7,13,3,20,48,66,-18,42
Forfar,3511,8,10,5,21,40,68,-28,35
Albion,3511,9,9,6,21,60,78,-18,33
Queen's Park,3511,10,6,10,20,41,75,-34,28
Ayr,3512,1,24,4,8,94,42,52,76
Raith,3512,2,22,9,5,68,32,36,75
Arbroath,3512,3,17,9,10,72,50,22,60
Alloa,3512,4,17,9,10,56,43,13,60
Stranraer,3512,5,15,5,16,55,65,-10,50
East Fife,3512,6,14,3,19,48,64,-16,45
Airdrieon,3512,7,11,11,14,47,59,-12,44
Forfar,3512,8,10,5,21,39,66,-27,35
Albion,3512,9,8,6,22,57,82,-25,30
Queen's Park,3512,10,6,11,19,41,74,-33,29
Raith,3513,1,23,8,5,70,33,37,77
Ayr,3513,2,24,4,8,94,43,51,76
Arbroath,3513,3,17,8,11,71,50,21,59
Alloa,3513,4,17,8,11,57,45,12,59
Stranraer,3513,5,16,5,15,57,65,-8,53
East Fife,3513,6,13,3,20,48,66,-18,42
Airdrieon,3513,7,10,11,15,46,60,-14,41
Forfar,3513,8,11,5,20,40,65,-25,38
Queen's Park,3513,9,7,10,19,41,73,-32,31
Albion,3513,10,8,6,22,58,82,-24,30
Raith,3514,1,23,8,5,71,33,38,77
Ayr,3514,2,24,4,8,95,44,51,76
Arbroath,3514,3,18,8,10,76,48,28,62
Alloa,3514,4,17,8,11,57,46,11,59
Stranraer,3514,5,16,5,15,57,65,-8,53
Airdrieon,3514,6,11,11,14,47,59,-12,44
East Fife,3514,7,13,3,20,48,66,-18,42
Forfar,3514,8,10,5,21,39,66,-27,35
Albion,3514,9,8,6,22,59,83,-24,30
Queen's Park,3514,10,6,10,20,39,78,-39,28
Raith,3515,1,23,8,5,69,32,37,77
Ayr,3515,2,24,4,8,94,44,50,76
Arbroath,3515,3,17,9,10,70,48,22,60
Alloa,3515,4,17,8,11,56,44,12,59
Stranraer,3515,5,15,5,16,55,65,-10,50
East Fife,3515,6,14,3,19,48,64,-16,45
Airdrieon,3515,7,11,11,14,47,58,-11,44
Forfar,3515,8,10,5,21,38,66,-28,35
Albion,3515,9,8,6,22,59,82,-23,30
Queen's Park,3515,10,6,11,19,39,72,-33,29
Ayr,3516,1,24,4,8,93,42,51,76
Raith,3516,2,22,8,6,68,34,34,74
Alloa,3516,3,18,8,10,58,43,15,62
Arbroath,3516,4,17,9,10,70,48,22,60
Stranraer,3516,5,15,6,15,55,64,-9,51
East Fife,3516,6,13,4,19,47,64,-17,43
Airdrieon,3516,7,10,12,14,45,58,-13,42
Forfar,3516,8,10,6,20,38,64,-26,36
Albion,3516,9,8,6,22,57,81,-24,30
Queen's Park,3516,10,6,11,19,39,72,-33,29
Raith,3517,1,23,8,5,72,33,39,77
Ayr,3517,2,23,4,9,91,45,46,73
Arbroath,3517,3,17,8,11,70,50,20,59
Alloa,3517,4,17,8,11,57,47,10,59
Stranraer,3517,5,15,6,15,56,65,-9,51
East Fife,3517,6,13,4,19,48,65,-17,43
Airdrieon,3517,7,10,12,14,46,59,-13,42
Forfar,3517,8,10,6,20,39,65,-26,36
Albion,3517,9,9,6,21,60,79,-19,33
Queen's Park,3517,10,7,10,19,41,72,-31,31
Ayr,3518,1,24,4,8,96,43,53,76
Raith,3518,2,22,9,5,70,34,36,75
Alloa,3518,3,17,9,10,58,45,13,60
Arbroath,3518,4,17,8,11,70,51,19,59
Stranraer,3518,5,16,5,15,57,64,-7,53
East Fife,3518,6,13,3,20,47,66,-19,42
Airdrieon,3518,7,10,11,15,45,60,-15,41
Forfar,3518,8,11,5,20,40,64,-24,38
Queen's Park,3518,9,7,10,19,42,72,-30,31
Albion,3518,10,8,6,22,58,84,-26,30
Raith,3519,1,22,8,6,68,34,34,74
Ayr,3519,2,23,4,9,93,46,47,73
Alloa,3519,3,18,8,10,58,43,15,62
Arbroath,3519,4,17,8,11,70,49,21,59
Stranraer,3519,5,15,6,15,55,64,-9,51
East Fife,3519,6,13,4,19,47,64,-17,43
Airdrieon,3519,7,10,11,15,46,60,-14,41
Forfar,3519,8,11,5,20,40,65,-25,38
Albion,3519,9,9,6,21,61,81,-20,33
Queen's Park,3519,10,7,10,19,40,72,-32,31
Ayr,3520,1,24,4,8,93,42,51,76
Raith,3520,2,22,9,5,70,34,36,75
Arbroath,3520,3,18,8,10,74,50,24,62
Alloa,3520,4,17,9,10,58,45,13,60
Stranraer,3520,5,16,5,15,59,66,-7,53
East Fife,3520,6,13,3,20,49,68,-19,42
Airdrieon,3520,7,10,11,15,47,62,-15,41
Forfar,3520,8,11,5,20,42,66,-24,38
Albion,3520,9,8,6,22,57,81,-24,30
Queen's Park,3520,10,6,10,20,41,76,-35,28
Raith,3521,1,23,8,5,70,32,38,77
Ayr,3521,2,24,4,8,93,44,49,76
Arbroath,3521,3,18,8,10,73,48,25,62
Alloa,3521,4,17,8,11,56,45,11,59
Stranraer,3521,5,15,5,16,55,67,-12,50
East Fife,3521,6,14,3,19,50,64,-14,45
Airdrieon,3521,7,10,11,15,45,59,-14,41
Forfar,3521,8,11,5,20,39,64,-25,38
Albion,3521,9,8,6,22,59,81,-22,30
Queen's Park,3521,10,6,10,20,39,75,-36,28
Ayr,3522,1,24,4,8,92,43,49,76
Raith,3522,2,22,8,6,68,33,35,74
Alloa,3522,3,18,8,10,57,43,14,62
Arbroath,3522,4,17,8,11,70,50,20,59
Stranraer,3522,5,15,5,16,56,67,-11,50
East Fife,3522,6,14,3,19,50,65,-15,45
Airdrieon,3522,7,11,11,14,47,58,-11,44
Forfar,3522,8,10,5,21,38,66,-28,35
Queen's Park,3522,9,7,10,19,41,72,-31,31
Albion,3522,10,8,6,22,58,80,-22,30
Raith,3523,1,23,8,5,71,34,37,77
Ayr,3523,2,23,5,8,92,44,48,74
Arbroath,3523,3,18,8,10,75,49,26,62
Alloa,3523,4,17,8,11,58,46,12,59
Stranraer,3523,5,15,5,16,55,65,-10,50
East Fife,3523,6,14,3,19,48,64,-16,45
Airdrieon,3523,7,11,11,14,50,59,-9,44
Forfar,3523,8,10,5,21,39,69,-30,35
Albion,3523,9,8,7,21,59,80,-21,31
Queen's Park,3523,10,6,10,20,40,77,-37,28
Raith,3524,1,23,8,5,69,32,37,77
Ayr,3524,2,24,4,8,92,43,49,76
Arbroath,3524,3,18,8,10,71,48,23,62
Alloa,3524,4,17,8,11,56,44,12,59
Stranraer,3524,5,15,5,16,56,67,-11,50
East Fife,3524,6,14,3,19,50,65,-15,45
Airdrieon,3524,7,11,11,14,48,58,-10,44
Forfar,3524,8,10,5,21,38,67,-29,35
Albion,3524,9,8,6,22,58,80,-22,30
Queen's Park,3524,10,6,10,20,39,73,-34,28
Ayr,3525,1,23,5,8,92,44,48,74
Raith,3525,2,22,8,6,69,34,35,74
Arbroath,3525,3,18,8,10,72,49,23,62
Alloa,3525,4,18,8,10,58,44,14,62
Stranraer,3525,5,15,5,16,55,65,-10,50
East Fife,3525,6,14,3,19,48,64,-16,45
Airdrieon,3525,7,11,11,14,48,58,-10,44
Forfar,3525,8,10,5,21,38,67,-29,35
Albion,3525,9,8,7,21,59,80,-21,31
Queen's Park,3525,10,6,10,20,40,74,-34,28
Raith,3526,1,23,8,5,69,32,37,77
Ayr,3526,2,24,4,8,95,44,51,76
Arbroath,3526,3,18,8,10,72,49,23,62
Alloa,3526,4,17,8,11,56,44,12,59
Stranraer,3526,5,16,5,15,59,64,-5,53
Airdrieon,3526,6,11,11,14,47,59,-12,44
East Fife,3526,7,13,3,20,47,68,-21,42
Forfar,3526,8,10,5,21,39,66,-27,35
Albion,3526,9,8,6,22,59,83,-24,30
Queen's Park,3526,10,6,10,20,40,74,-34,28
Raith,3527,1,23,8,5,69,32,37,77
Ayr,3527,2,24,4,8,92,43,49,76
Arbroath,3527,3,18,8,10,73,48,25,62
Alloa,3527,4,17,8,11,56,44,12,59
Stranraer,3527,5,15,5,16,55,65,-10,50
East Fife,3527,6,14,3,19,48,64,-16,45
Airdrieon,3527,7,10,11,15,45,60,-15,41
Forfar,3527,8,11,5,20,40,64,-24,38
Albion,3527,9,8,6,22,58,80,-22,30
Queen's Park,3527,10,6,10,20,39,75,-36,28
Raith,3528,1,22,9,5,69,33,36,75
Ayr,3528,2,23,4,9,91,44,47,73
Arbroath,3528,3,18,8,10,73,48,25,62
Alloa,3528,4,17,9,10,57,44,13,60
Stranraer,3528,5,15,5,16,56,68,-12,50
East Fife,3528,6,14,3,19,51,65,-14,45
Airdrieon,3528,7,10,11,15,47,61,-14,41
Forfar,3528,8,11,5,20,41,66,-25,38
Albion,3528,9,9,6,21,59,79,-20,33
Queen's Park,3528,10,6,10,20,39,75,-36,28
Raith,3529,1,23,8,5,70,32,38,77
Ayr,3529,2,24,4,8,96,44,52,76
Arbroath,3529,3,18,8,10,72,49,23,62
Alloa,3529,4,17,8,11,56,45,11,59
Stranraer,3529,5,16,5,15,57,65,-8,53
East Fife,3529,6,13,3,20,48,66,-18,42
Airdrieon,3529,7,10,11,15,45,60,-15,41
Forfar,3529,8,11,5,20,40,64,-24,38
Albion,3529,9,8,6,22,59,84,-25,30
Queen's Park,3529,10,6,10,20,40,74,-34,28
Raith,3530,1,23,8,5,69,32,37,77
Ayr,3530,2,24,4,8,94,43,51,76
Arbroath,3530,3,17,8,11,70,51,19,59
Alloa,3530,4,17,8,11,56,44,12,59
Stranraer,3530,5,15,5,16,56,67,-11,50
East Fife,3530,6,14,3,19,50,65,-15,45
Airdrieon,3530,7,11,11,14,50,60,-10,44
Forfar,3530,8,10,5,21,40,69,-29,35
Queen's Park,3530,9,7,10,19,42,72,-30,31
Albion,3530,10,8,6,22,58,82,-24,30
Raith,3531,1,23,8,5,70,32,38,77
Ayr,3531,2,24,4,8,95,44,51,76
Arbroath,3531,3,18,8,10,71,48,23,62
Alloa,3531,4,17,8,11,56,45,11,59
Stranraer,3531,5,15,5,16,55,66,-11,50
East Fife,3531,6,14,3,19,49,64,-15,45
Airdrieon,3531,7,11,11,14,48,60,-12,44
Forfar,3531,8,10,5,21,40,67,-27,35
Albion,3531,9,8,6,22,59,83,-24,30
Queen's Park,3531,10,6,10,20,39,73,-34,28
Raith,3532,1,23,8,5,72,33,39,77
Ayr,3532,2,24,4,8,93,43,50,76
Arbroath,3532,3,18,8,10,74,48,26,62
Alloa,3532,4,17,8,11,57,47,10,59
Stranraer,3532,5,15,5,16,55,66,-11,50
East Fife,3532,6,14,3,19,49,64,-15,45
Airdrieon,3532,7,11,11,14,49,59,-10,44
Forfar,3532,8,10,5,21,39,68,-29,35
Albion,3532,9,8,6,22,58,81,-23,30
Queen's Park,3532,10,6,10,20,39,76,-37,28
Raith,3533,1,23,8,5,72,33,39,77
Ayr,3533,2,24,4,8,95,43,52,76
Arbroath,3533,3,17,8,11,71,51,20,59
Alloa,3533,4,17,8,11,57,47,10,59
Stranraer,3533,5,15,6,15,57,66,-9,51
Airdrieon,3533,6,11,11,14,48,59,-11,44
East Fife,3533,7,13,4,19,49,66,-17,43
Forfar,3533,8,10,5,21,39,67,-28,35
Queen's Park,3533,9,7,10,19,42,73,-31,31
Albion,3533,10,8,6,22,58,83,-25,30
Ayr,3534,1,24,4,8,94,43,51,76
Raith,3534,2,22,9,5,69,33,36,75
Arbroath,3534,3,18,8,10,71,48,23,62
Alloa,3534,4,17,9,10,57,44,13,60
Stranraer,3534,5,15,5,16,56,66,-10,50
East Fife,3534,6,14,3,19,49,65,-16,45
Airdrieon,3534,7,11,11,14,46,58,-12,44
Forfar,3534,8,10,5,21,38,65,-27,35
Albion,3534,9,8,6,22,58,82,-24,30
Queen's Park,3534,10,6,10,20,39,73,-34,28
Ayr,3535,1,23,5,8,92,44,48,74
Raith,3535,2,22,8,6,68,33,35,74
Alloa,3535,3,18,8,10,57,43,14,62
Arbroath,3535,4,17,9,10,72,50,22,60
Stranraer,3535,5,15,5,16,55,67,-12,50
East Fife,3535,6,14,3,19,50,64,-14,45
Airdrieon,3535,7,10,11,15,46,60,-14,41
Forfar,3535,8,11,5,20,40,65,-25,38
Albion,3535,9,8,7,21,59,80,-21,31
Queen's Park,3535,10,6,11,19,41,74,-33,29
Ayr,3536,1,24,4,8,94,43,51,76
Raith,3536,2,22,8,6,68,34,34,74
Alloa,3536,3,18,8,10,58,43,15,62
Arbroath,3536,4,17,9,10,74,52,22,60
Stranraer,3536,5,15,5,16,57,67,-10,50
East Fife,3536,6,14,3,19,50,66,-16,45
Airdrieon,3536,7,10,12,14,45,58,-13,42
Forfar,3536,8,10,6,20,38,64,-26,36
Albion,3536,9,8,6,22,58,82,-24,30
Queen's Park,3536,10,6,11,19,43,76,-33,29
Ayr,3537,1,24,4,8,91,42,49,76
Raith,3537,2,22,8,6,70,35,35,74
Alloa,3537,3,18,8,10,59,45,14,62
Arbroath,3537,4,17,9,10,73,51,22,60
Stranraer,3537,5,15,5,16,55,66,-11,50
East Fife,3537,6,14,3,19,49,64,-15,45
Airdrieon,3537,7,10,11,15,46,60,-14,41
Forfar,3537,8,11,5,20,40,65,-25,38
Albion,3537,9,8,6,22,57,79,-22,30
Queen's Park,3537,10,6,11,19,42,75,-33,29
Raith,3538,1,23,8,5,71,32,39,77
Ayr,3538,2,24,4,8,93,42,51,76
Arbroath,3538,3,18,8,10,74,48,26,62
Alloa,3538,4,17,8,11,56,46,10,59
Stranraer,3538,5,15,5,16,55,65,-10,50
East Fife,3538,6,14,3,19,48,64,-16,45
Airdrieon,3538,7,11,11,14,47,59,-12,44
Forfar,3538,8,10,5,21,39,66,-27,35
Albion,3538,9,8,6,22,57,81,-24,30
Queen's Park,3538,10,6,10,20,39,76,-37,28
Raith,3539,1,23,8,5,71,32,39,77
Ayr,3539,2,24,4,8,94,42,52,76
Arbroath,3539,3,17,8,11,70,49,21,59
Alloa,3539,4,17,8,11,56,46,10,59
Stranraer,3539,5,16,5,15,58,65,-7,53
Airdrieon,3539,6,11,11,14,50,59,-9,44
East Fife,3539,7,13,3,20,48,67,-19,42
Forfar,3539,8,10,5,21,39,69,-30,35
Queen's Park,3539,9,7,10,19,40,72,-32,31
Albion,3539,10,8,6,22,57,82,-25,30
Ayr,3540,1,24,4,8,93,43,50,76
Raith,3540,2,22,9,5,69,33,36,75
Arbroath,3540,3,18,8,10,73,49,24,62
Alloa,3540,4,17,9,10,57,44,13,60
Stranraer,3540,5,15,5,16,55,68,-13,50
East Fife,3540,6,14,3,19,51,64,-13,45
Airdrieon,3540,7,11,11,14,48,58,-10,44
Forfar,3540,8,10,5,21,38,67,-29,35
Albion,3540,9,8,6,22,58,81,-23,30
Queen's Park,3540,10,6,10,20,40,75,-35,28
Ayr,3541,1,24,4,8,97,42,55,76
Raith,3541,2,22,9,5,69,33,36,75
Arbroath,3541,3,18,8,10,71,48,23,62
Alloa,3541,4,17,9,10,57,44,13,60
Stranraer,3541,5,16,5,15,57,65,-8,53
Airdrieon,3541,6,11,11,14,48,58,-10,44
East Fife,3541,7,13,3,20,48,66,-18,42
Forfar,3541,8,10,5,21,38,67,-29,35
Albion,3541,9,8,6,22,57,85,-28,30
Queen's Park,3541,10,6,10,20,39,73,-34,28
Raith,3542,1,23,8,5,72,32,40,77
Ayr,3542,2,24,4,8,92,43,49,76
Arbroath,3542,3,17,9,10,70,48,22,60
Alloa,3542,4,17,8,11,56,47,9,59
Stranraer,3542,5,15,5,16,56,66,-10,50
East Fife,3542,6,14,3,19,49,65,-16,45
Airdrieon,3542,7,10,11,15,46,60,-14,41
Forfar,3542,8,11,5,20,40,65,-25,38
Albion,3542,9,8,6,22,58,80,-22,30
Queen's Park,3542,10,6,11,19,39,72,-33,29
Raith,3543,1,23,8,5,71,32,39,77
Ayr,3543,2,24,4,8,94,43,51,76
Arbroath,3543,3,17,8,11,70,49,21,59
Alloa,3543,4,17,8,11,56,46,10,59
Stranraer,3543,5,15,5,16,55,67,-12,50
East Fife,3543,6,14,3,19,50,64,-14,45
Airdrieon,3543,7,10,12,14,45,58,-13,42
Forfar,3543,8,10,6,20,38,64,-26,36
Queen's Park,3543,9,7,10,19,40,72,-32,31
Albion,3543,10,8,6,22,58,82,-24,30
Raith,3544,1,23,8,5,70,32,38,77
Ayr,3544,2,24,4,8,95,44,51,76
Arbroath,3544,3,18,8,10,72,49,23,62
Alloa,3544,4,17,8,11,56,45,11,59
Stranraer,3544,5,16,5,15,57,65,-8,53
Airdrieon,3544,6,11,11,14,48,60,-12,44
East Fife,3544,7,13,3,20,48,66,-18,42
Forfar,3544,8,10,5,21,40,67,-27,35
Albion,3544,9,8,6,22,59,83,-24,30
Queen's Park,3544,10,6,10,20,40,74,-34,28
Raith,3545,1,23,8,5,70,32,38,77
Ayr,3545,2,24,4,8,94,42,52,76
Arbroath,3545,3,17,8,11,72,51,21,59
Alloa,3545,4,17,8,11,56,45,11,59
Stranraer,3545,5,15,5,16,56,66,-10,50
East Fife,3545,6,14,3,19,49,65,-16,45
Airdrieon,3545,7,10,11,15,45,61,-16,41
Forfar,3545,8,11,5,20,41,64,-23,38
Queen's Park,3545,9,7,10,19,42,74,-32,31
Albion,3545,10,8,6,22,57,82,-25,30
Ayr,3546,1,24,4,8,93,43,50,76
Raith,3546,2,22,9,5,70,34,36,75
Arbroath,3546,3,18,8,10,72,48,24,62
Alloa,3546,4,17,9,10,58,45,13,60
Stranraer,3546,5,15,5,16,56,69,-13,50
East Fife,3546,6,14,3,19,52,65,-13,45
Airdrieon,3546,7,10,12,14,46,59,-13,42
Forfar,3546,8,10,6,20,39,65,-26,36
Albion,3546,9,8,6,22,58,81,-23,30
Queen's Park,3546,10,6,10,20,39,74,-35,28
Ayr,3547,1,24,4,8,98,45,53,76
Raith,3547,2,22,8,6,69,35,34,74
Arbroath,3547,3,18,8,10,72,48,24,62
Alloa,3547,4,18,8,10,59,44,15,62
Stranraer,3547,5,15,5,16,55,67,-12,50
East Fife,3547,6,14,3,19,50,64,-14,45
Airdrieon,3547,7,11,11,14,48,58,-10,44
Forfar,3547,8,10,5,21,38,67,-29,35
Albion,3547,9,8,6,22,60,86,-26,30
Queen's Park,3547,10,6,10,20,39,74,-35,28
Raith,3548,1,23,8,5,72,32,40,77
Ayr,3548,2,24,4,8,93,42,51,76
Arbroath,3548,3,17,9,10,72,50,22,60
Alloa,3548,4,17,8,11,56,47,9,59
Stranraer,3548,5,15,5,16,55,67,-12,50
East Fife,3548,6,14,3,19,50,64,-14,45
Airdrieon,3548,7,10,11,15,45,60,-15,41
Forfar,3548,8,11,5,20,40,64,-24,38
Albion,3548,9,8,6,22,57,81,-24,30
Queen's Park,3548,10,6,11,19,41,74,-33,29
Raith,3549,1,23,8,5,71,34,37,77
Ayr,3549,2,24,4,8,92,42,50,76
Arbroath,3549,3,18,8,10,75,49,26,62
Alloa,3549,4,17,8,11,58,46,12,59
Stranraer,3549,5,15,5,16,57,68,-11,50
East Fife,3549,6,14,3,19,51,66,-15,45
Airdrieon,3549,7,10,11,15,45,59,-14,41
Forfar,3549,8,11,5,20,39,64,-25,38
Albion,3549,9,8,6,22,57,80,-23,30
Queen's Park,3549,10,6,10,20,40,77,-37,28
Raith,3550,1,22,8,6,68,34,34,74
Ayr,3550,2,23,4,9,91,44,47,73
Alloa,3550,3,18,8,10,58,43,15,62
Arbroath,3550,4,17,8,11,72,53,19,59
Stranraer,3550,5,15,5,16,56,67,-11,50
East Fife,3550,6,14,3,19,50,65,-15,45
Airdrieon,3550,7,10,11,15,45,60,-15,41
Forfar,3550,8,11,5,20,40,64,-24,38
Albion,3550,9,9,6,21,59,79,-20,33
Queen's Park,3550,10,7,10,19,44,74,-30,31
Raith,3551,1,23,8,5,70,32,38,77
Ayr,3551,2,24,4,8,94,43,51,76
Arbroath,3551,3,17,8,11,71,50,21,59
Alloa,3551,4,17,8,11,56,45,11,59
Stranraer,3551,5,15,5,16,56,67,-11,50
East Fife,3551,6,14,3,19,50,65,-15,45
Airdrieon,3551,7,11,11,14,50,58,-8,44
Forfar,3551,8,10,5,21,38,69,-31,35
Queen's Park,3551,9,7,10,19,41,73,-32,31
Albion,3551,10,8,6,22,58,82,-24,30
Ayr,3552,1,24,4,8,94,44,50,76
Raith,3552,2,22,9,5,69,33,36,75
Arbroath,3552,3,18,8,10,73,48,25,62
Alloa,3552,4,17,9,10,57,44,13,60
Stranraer,3552,5,15,6,15,56,65,-9,51
Airdrieon,3552,6,11,11,14,49,60,-11,44
East Fife,3552,7,13,4,19,48,65,-17,43
Forfar,3552,8,10,5,21,40,68,-28,35
Albion,3552,9,8,6,22,59,82,-23,30
Queen's Park,3552,10,6,10,20,39,75,-36,28
Ayr,3553,1,24,4,8,92,42,50,76
Raith,3553,2,22,9,5,69,33,36,75
Alloa,3553,3,17,9,10,57,44,13,60
Arbroath,3553,4,17,8,11,70,49,21,59
Stranraer,3553,5,15,6,15,57,66,-9,51
Airdrieon,3553,6,11,11,14,46,58,-12,44
East Fife,3553,7,13,4,19,49,66,-17,43
Forfar,3553,8,10,5,21,38,65,-27,35
Queen's Park,3553,9,7,10,19,40,72,-32,31
Albion,3553,10,8,6,22,57,80,-23,30
Ayr,3554,1,24,4,8,94,42,52,76
Raith,3554,2,22,8,6,69,34,35,74
Alloa,3554,3,18,8,10,58,44,14,62
Arbroath,3554,4,17,8,11,72,51,21,59
Stranraer,3554,5,15,6,15,56,65,-9,51
Airdrieon,3554,6,11,11,14,47,59,-12,44
East Fife,3554,7,13,4,19,48,65,-17,43
Forfar,3554,8,10,5,21,39,66,-27,35
Queen's Park,3554,9,7,10,19,42,74,-32,31
Albion,3554,10,8,6,22,57,82,-25,30
Ayr,3555,1,24,4,8,95,43,52,76
Raith,3555,2,22,8,6,68,34,34,74
Arbroath,3555,3,18,8,10,72,48,24,62
Alloa,3555,4,18,8,10,58,43,15,62
Stranraer,3555,5,16,5,15,56,64,-8,53
East Fife,3555,6,13,3,20,47,65,-18,42
Airdrieon,3555,7,10,11,15,45,60,-15,41
Forfar,3555,8,11,5,20,40,64,-24,38
Albion,3555,9,8,6,22,58,83,-25,30
Queen's Park,3555,10,6,10,20,39,74,-35,28
Ayr,3556,1,24,4,8,99,43,56,76
Raith,3556,2,22,8,6,68,34,34,74
Arbroath,3556,3,18,8,10,72,49,23,62
Alloa,3556,4,18,8,10,58,43,15,62
Stranraer,3556,5,16,5,15,58,65,-7,53
Airdrieon,3556,6,11,11,14,49,58,-9,44
East Fife,3556,7,13,3,20,48,67,-19,42
Forfar,3556,8,10,5,21,38,68,-30,35
Albion,3556,9,8,6,22,58,87,-29,30
Queen's Park,3556,10,6,10,20,40,74,-34,28
Raith,3557,1,22,9,5,70,34,36,75
Ayr,3557,2,23,4,9,92,45,47,73
Alloa,3557,3,17,9,10,58,45,13,60
Arbroath,3557,4,17,8,11,72,51,21,59
Stranraer,3557,5,15,5,16,56,68,-12,50
East Fife,3557,6,14,3,19,51,65,-14,45
Airdrieon,3557,7,10,11,15,45,61,-16,41
Forfar,3557,8,11,5,20,41,64,-23,38
Albion,3557,9,9,6,21,60,80,-20,33
Queen's Park,3557,10,7,10,19,42,74,-32,31
Ayr,3558,1,24,4,8,93,42,51,76
Raith,3558,2,22,9,5,69,33,36,75
Alloa,3558,3,17,9,10,57,44,13,60
Arbroath,3558,4,17,8,11,70,49,21,59
Stranraer,3558,5,16,5,15,58,65,-7,53
Airdrieon,3558,6,11,11,14,46,58,-12,44
East Fife,3558,7,13,3,20,48,67,-19,42
Forfar,3558,8,10,5,21,38,65,-27,35
Queen's Park,3558,9,7,10,19,40,72,-32,31
Albion,3558,10,8,6,22,57,81,-24,30
Raith,3559,1,23,8,5,69,32,37,77
Ayr,3559,2,24,4,8,92,42,50,76
Arbroath,3559,3,17,8,11,73,52,21,59
Alloa,3559,4,17,8,11,56,44,12,59
Stranraer,3559,5,15,5,16,56,66,-10,50
East Fife,3559,6,14,3,19,49,65,-16,45
Airdrieon,3559,7,10,11,15,47,62,-15,41
Forfar,3559,8,11,5,20,42,66,-24,38
Queen's Park,3559,9,7,10,19,43,75,-32,31
Albion,3559,10,8,6,22,57,80,-23,30
Raith,3560,1,23,8,5,71,32,39,77
Ayr,3560,2,24,4,8,92,43,49,76
Arbroath,3560,3,17,8,11,70,49,21,59
Alloa,3560,4,17,8,11,56,46,10,59
Stranraer,3560,5,15,5,16,55,65,-10,50
East Fife,3560,6,14,3,19,48,64,-16,45
Airdrieon,3560,7,10,12,14,46,59,-13,42
Forfar,3560,8,10,6,20,39,65,-26,36
Queen's Park,3560,9,7,10,19,40,72,-32,31
Albion,3560,10,8,6,22,58,80,-22,30
Ayr,3561,1,24,4,8,91,42,49,76
Raith,3561,2,22,9,5,69,33,36,75
Arbroath,3561,3,17,9,10,71,49,22,60
Alloa,3561,4,17,9,10,57,44,13,60
Stranraer,3561,5,15,5,16,56,66,-10,50
East Fife,3561,6,14,3,19,49,65,-16,45
Airdrieon,3561,7,10,12,14,45,58,-13,42
Forfar,3561,8,10,6,20,38,64,-26,36
Albion,3561,9,8,6,22,57,79,-22,30
Queen's Park,3561,10,6,11,19,40,73,-33,29
Raith,3562,1,22,9,5,68,32,36,75
Ayr,3562,2,23,5,8,92,44,48,74
Alloa,3562,3,17,9,10,56,43,13,60
Arbroath,3562,4,17,8,11,71,51,20,59
Stranraer,3562,5,16,5,15,57,65,-8,53
Airdrieon,3562,6,11,11,14,48,58,-10,44
East Fife,3562,7,13,3,20,48,66,-18,42
Forfar,3562,8,10,5,21,38,67,-29,35
Albion,3562,9,8,7,21,59,80,-21,31
Queen's Park,3562,10,7,10,19,42,73,-31,31
Raith,3563,1,23,8,5,71,33,38,77
Ayr,3563,2,24,4,8,95,43,52,76
Arbroath,3563,3,17,8,11,70,49,21,59
Alloa,3563,4,17,8,11,57,46,11,59
Stranraer,3563,5,15,5,16,55,67,-12,50
East Fife,3563,6,14,3,19,50,64,-14,45
Airdrieon,3563,7,10,11,15,45,60,-15,41
Forfar,3563,8,11,5,20,40,64,-24,38
Queen's Park,3563,9,7,10,19,40,72,-32,31
Albion,3563,10,8,6,22,58,83,-25,30
Ayr,3564,1,24,4,8,94,44,50,76
Raith,3564,2,22,8,6,69,34,35,74
Arbroath,3564,3,18,8,10,72,48,24,62
Alloa,3564,4,18,8,10,58,44,14,62
Stranraer,3564,5,15,5,16,55,65,-10,50
East Fife,3564,6,14,3,19,48,64,-16,45
Airdrieon,3564,7,10,12,14,46,59,-13,42
Forfar,3564,8,10,6,20,39,65,-26,36
Albion,3564,9,8,6,22,59,82,-23,30
Queen's Park,3564,10,6,10,20,39,74,-35,28
Raith,3565,1,23,8,5,71,32,39,77
Ayr,3565,2,24,4,8,92,43,49,76
Arbroath,3565,3,17,9,10,71,49,22,60
Alloa,3565,4,17,8,11,56,46,10,59
Stranraer,3565,5,16,5,15,57,65,-8,53
Airdrieon,3565,6,10,12,14,45,58,-13,42
East Fife,3565,7,13,3,20,48,66,-18,42
Forfar,3565,8,10,6,20,38,64,-26,36
Albion,3565,9,8,6,22,58,80,-22,30
Queen's Park,3565,10,6,11,19,40,73,-33,29
Raith,3566,1,23,8,5,70,33,37,77
Ayr,3566,2,23,5,8,90,42,48,74
Arbroath,3566,3,18,8,10,73,49,24,62
Alloa,3566,4,17,8,11,57,45,12,59
Stranraer,3566,5,15,5,16,56,67,-11,50
East Fife,3566,6,14,3,19,50,65,-15,45
Airdrieon,3566,7,10,12,14,45,58,-13,42
Forfar,3566,8,10,6,20,38,64,-26,36
Albion,3566,9,8,7,21,57,78,-21,31
Queen's Park,3566,10,6,10,20,40,75,-35,28
Raith,3567,1,23,8,5,71,33,38,77
Ayr,3567,2,24,4,8,92,43,49,76
Arbroath,3567,3,17,8,11,71,51,20,59
Alloa,3567,4,17,8,11,57,46,11,59
Stranraer,3567,5,15,5,16,55,65,-10,50
East Fife,3567,6,14,3,19,48,64,-16,45
Airdrieon,3567,7,11,11,14,48,59,-11,44
Forfar,3567,8,10,5,21,39,67,-28,35
Queen's Park,3567,9,7,10,19,42,73,-31,31
Albion,3567,10,8,6,22,58,80,-22,30
Raith,3568,1,23,8,5,70,32,38,77
Ayr,3568,2,24,4,8,96,42,54,76
Arbroath,3568,3,17,9,10,70,48,22,60
Alloa,3568,4,17,8,11,56,45,11,59
Stranraer,3568,5,15,5,16,55,65,-10,50
East Fife,3568,6,14,3,19,48,64,-16,45
Airdrieon,3568,7,11,11,14,48,58,-10,44
Forfar,3568,8,10,5,21,38,67,-29,35
Albion,3568,9,8,6,22,57,84,-27,30
Queen's Park,3568,10,6,11,19,39,72,-33,29
Raith,3569,1,23,8,5,70,32,38,77
Ayr,3569,2,24,4,8,94,42,52,76
Arbroath,3569,3,17,9,10,71,49,22,60
Alloa,3569,4,17,8,11,56,45,11,59
Stranraer,3569,5,15,5,16,56,66,-10,50
East Fife,3569,6,14,3,19,49,65,-16,45
Airdrieon,3569,7,11,11,14,47,58,-11,44
Forfar,3569,8,10,5,21,38,66,-28,35
Albion,3569,9,8,6,22,57,82,-25,30
Queen's Park,3569,10,6,11,19,40,73,-33,29
Ayr,3570,1,24,4,8,94,44,50,76
Raith,3570,2,22,8,6,69,34,35,74
Alloa,3570,3,18,8,10,58,44,14,62
Arbroath,3570,4,17,9,10,72,50,22,60
Stranraer,3570,5,15,5,16,56,66,-10,50
East Fife,3570,6,14,3,19,49,65,-16,45
Airdrieon,3570,7,10,11,15,45,59,-14,41
Forfar,3570,8,11,5,20,39,64,-25,38
Albion,3570,9,8,6,22,59,82,-23,30
Queen's Park,3570,10,6,11,19,41,74,-33,29
Raith,3571,1,23,8,5,70,33,37,77
Ayr,3571,2,24,4,8,94,43,51,76
Arbroath,3571,3,18,8,10,72,48,24,62
Alloa,3571,4,17,8,11,57,45,12,59
Stranraer,3571,5,15,6,15,57,66,-9,51
East Fife,3571,6,13,4,19,49,66,-17,43
Airdrieon,3571,7,10,11,15,45,59,-14,41
Forfar,3571,8,11,5,20,39,64,-25,38
Albion,3571,9,8,6,22,58,82,-24,30
Queen's Park,3571,10,6,10,20,39,74,-35,28
Raith,3572,1,23,8,5,70,33,37,77
Ayr,3572,2,24,4,8,97,43,54,76
Arbroath,3572,3,18,8,10,74,49,25,62
Alloa,3572,4,17,8,11,57,45,12,59
Stranraer,3572,5,15,6,15,57,66,-9,51
Airdrieon,3572,6,11,11,14,48,58,-10,44
East Fife,3572,7,13,4,19,49,66,-17,43
Forfar,3572,8,10,5,21,38,67,-29,35
Albion,3572,9,8,6,22,58,85,-27,30
Queen's Park,3572,10,6,10,20,40,76,-36,28
Raith,3573,1,22,9,5,69,33,36,75
Ayr,3573,2,23,4,9,92,46,46,73
Alloa,3573,3,17,9,10,57,44,13,60
Arbroath,3573,4,17,8,11,71,50,21,59
Stranraer,3573,5,16,5,15,57,64,-7,53
Airdrieon,3573,6,11,11,14,47,58,-11,44
East Fife,3573,7,13,3,20,47,66,-19,42
Forfar,3573,8,10,5,21,38,66,-28,35
Albion,3573,9,9,6,21,61,80,-19,33
Queen's Park,3573,10,7,10,19,41,73,-32,31
Raith,3574,1,23,8,5,70,32,38,77
Ayr,3574,2,24,4,8,96,45,51,76
Arbroath,3574,3,18,8,10,73,49,24,62
Alloa,3574,4,17,8,11,56,45,11,59
Stranraer,3574,5,15,5,16,56,67,-11,50
East Fife,3574,6,14,3,19,50,65,-15,45
Airdrieon,3574,7,11,11,14,50,58,-8,44
Forfar,3574,8,10,5,21,38,69,-31,35
Albion,3574,9,8,6,22,60,84,-24,30
Queen's Park,3574,10,6,10,20,40,75,-35,28
Raith,3575,1,23,8,5,71,32,39,77
Ayr,3575,2,24,4,8,95,43,52,76
Arbroath,3575,3,17,9,10,70,48,22,60
Alloa,3575,4,17,8,11,56,46,10,59
Stranraer,3575,5,15,6,15,57,66,-9,51
Airdrieon,3575,6,11,11,14,47,58,-11,44
East Fife,3575,7,13,4,19,49,66,-17,43
Forfar,3575,8,10,5,21,38,66,-28,35
Albion,3575,9,8,6,22,58,83,-25,30
Queen's Park,3575,10,6,11,19,39,72,-33,29
Ayr,3576,1,24,4,8,95,42,53,76
Raith,3576,2,22,8,6,70,35,35,74
Arbroath,3576,3,18,8,10,72,48,24,62
Alloa,3576,4,18,8,10,59,45,14,62
Stranraer,3576,5,15,6,15,55,64,-9,51
Airdrieon,3576,6,11,11,14,48,58,-10,44
East Fife,3576,7,13,4,19,47,64,-17,43
Forfar,3576,8,10,5,21,38,67,-29,35
Albion,3576,9,8,6,22,57,83,-26,30
Queen's Park,3576,10,6,10,20,39,74,-35,28
Raith,3577,1,22,9,5,69,33,36,75
Ayr,3577,2,23,5,8,94,46,48,74
Arbroath,3577,3,17,9,10,72,50,22,60
Alloa,3577,4,17,9,10,57,44,13,60
Stranraer,3577,5,15,5,16,55,67,-12,50
East Fife,3577,6,14,3,19,50,64,-14,45
Airdrieon,3577,7,11,11,14,46,58,-12,44
Forfar,3577,8,10,5,21,38,65,-27,35
Albion,3577,9,8,7,21,61,82,-21,31
Queen's Park,3577,10,6,11,19,41,74,-33,29
Ayr,3578,1,24,4,8,94,42,52,76
Raith,3578,2,22,9,5,70,34,36,75
Arbroath,3578,3,18,8,10,73,49,24,62
Alloa,3578,4,17,9,10,58,45,13,60
Stranraer,3578,5,15,5,16,56,66,-10,50
East Fife,3578,6,14,3,19,49,65,-16,45
Airdrieon,3578,7,10,11,15,45,59,-14,41
Forfar,3578,8,11,5,20,39,64,-25,38
Albion,3578,9,8,6,22,57,82,-25,30
Queen's Park,3578,10,6,10,20,40,75,-35,28
Raith,3579,1,23,8,5,70,32,38,77
Ayr,3579,2,23,4,9,90,43,47,73
Arbroath,3579,3,18,8,10,73,49,24,62
Alloa,3579,4,17,8,11,56,45,11,59
Stranraer,3579,5,16,5,15,58,65,-7,53
Airdrieon,3579,6,11,11,14,47,59,-12,44
East Fife,3579,7,13,3,20,48,67,-19,42
Forfar,3579,8,10,5,21,39,66,-27,35
Albion,3579,9,9,6,21,58,78,-20,33
Queen's Park,3579,10,6,10,20,40,75,-35,28
Raith,3580,1,23,8,5,70,32,38,77
Ayr,3580,2,24,4,8,97,44,53,76
Arbroath,3580,3,17,8,11,72,51,21,59
Alloa,3580,4,17,8,11,56,45,11,59
Stranraer,3580,5,15,5,16,56,66,-10,50
East Fife,3580,6,14,3,19,49,65,-16,45
Airdrieon,3580,7,11,11,14,48,59,-11,44
Forfar,3580,8,10,5,21,39,67,-28,35
Queen's Park,3580,9,7,10,19,42,74,-32,31
Albion,3580,10,8,6,22,59,85,-26,30
Ayr,3581,1,23,5,8,92,44,48,74
Raith,3581,2,22,8,6,68,34,34,74
Alloa,3581,3,18,8,10,58,43,15,62
Arbroath,3581,4,17,9,10,71,49,22,60
Stranraer,3581,5,15,5,16,56,66,-10,50
East Fife,3581,6,14,3,19,49,65,-16,45
Airdrieon,3581,7,11,11,14,47,59,-12,44
Forfar,3581,8,10,5,21,39,66,-27,35
Albion,3581,9,8,7,21,59,80,-21,31
Queen's Park,3581,10,6,11,19,40,73,-33,29
Ayr,3582,1,24,4,8,98,43,55,76
Raith,3582,2,22,9,5,69,33,36,75
Arbroath,3582,3,18,8,10,74,49,25,62
Alloa,3582,4,17,9,10,57,44,13,60
Stranraer,3582,5,16,5,15,56,64,-8,53
East Fife,3582,6,13,3,20,47,65,-18,42
Airdrieon,3582,7,10,11,15,45,59,-14,41
Forfar,3582,8,11,5,20,39,64,-25,38
Albion,3582,9,8,6,22,58,86,-28,30
Queen's Park,3582,10,6,10,20,40,76,-36,28
Ayr,3583,1,24,4,8,93,44,49,76
Raith,3583,2,22,8,6,69,35,34,74
Arbroath,3583,3,18,8,10,73,50,23,62
Alloa,3583,4,18,8,10,59,44,15,62
Stranraer,3583,5,15,5,16,55,65,-10,50
East Fife,3583,6,14,3,19,48,64,-16,45
Airdrieon,3583,7,11,11,14,50,58,-8,44
Forfar,3583,8,10,5,21,38,69,-31,35
Albion,3583,9,8,6,22,59,81,-22,30
Queen's Park,3583,10,6,10,20,41,75,-34,28
Ayr,3584,1,23,5,8,91,43,48,74
Raith,3584,2,22,8,6,69,34,35,74
Alloa,3584,3,18,8,10,58,44,14,62
Arbroath,3584,4,17,8,11,71,50,21,59
Stranraer,3584,5,15,6,15,56,65,-9,51
East Fife,3584,6,13,4,19,48,65,-17,43
Airdrieon,3584,7,10,11,15,46,60,-14,41
Forfar,3584,8,11,5,20,40,65,-25,38
Albion,3584,9,8,7,21,58,79,-21,31
Queen's Park,3584,10,7,10,19,41,73,-32,31
Raith,3585,1,23,8,5,71,34,37,77
Ayr,3585,2,24,4,8,91,42,49,76
Arbroath,3585,3,18,8,10,72,48,24,62
Alloa,3585,4,17,8,11,58,46,12,59
Stranraer,3585,5,15,5,16,56,67,-11,50
East Fife,3585,6,14,3,19,50,65,-15,45
Airdrieon,3585,7,10,12,14,46,59,-13,42
Forfar,3585,8,10,6,20,39,65,-26,36
Albion,3585,9,8,6,22,57,79,-22,30
Queen's Park,3585,10,6,10,20,39,74,-35,28
Raith,3586,1,23,8,5,75,32,43,77
Ayr,3586,2,24,4,8,94,43,51,76
Arbroath,3586,3,18,8,10,72,49,23,62
Alloa,3586,4,17,8,11,56,50,6,59
Stranraer,3586,5,16,5,15,57,65,-8,53
Airdrieon,3586,6,10,12,14,46,59,-13,42
East Fife,3586,7,13,3,20,48,66,-18,42
Forfar,3586,8,10,6,20,39,65,-26,36
Albion,3586,9,8,6,22,58,82,-24,30
Queen's Park,3586,10,6,10,20,40,74,-34,28
Ayr,3587,1,24,4,8,94,45,49,76
Raith,3587,2,22,9,5,70,34,36,75
Arbroath,3587,3,17,9,10,71,49,22,60
Alloa,3587,4,17,9,10,58,45,13,60
Stranraer,3587,5,15,6,15,56,65,-9,51
East Fife,3587,6,13,4,19,48,65,-17,43
Airdrieon,3587,7,10,11,15,46,62,-16,41
Forfar,3587,8,11,5,20,42,65,-23,38
Albion,3587,9,8,6,22,60,82,-22,30
Queen's Park,3587,10,6,11,19,40,73,-33,29
Ayr,3588,1,24,4,8,92,43,49,76
Raith,3588,2,22,8,6,68,34,34,74
Arbroath,3588,3,18,8,10,74,50,24,62
Alloa,3588,4,18,8,10,58,43,15,62
Stranraer,3588,5,15,5,16,55,65,-10,50
East Fife,3588,6,14,3,19,48,64,-16,45
Airdrieon,3588,7,11,11,14,46,58,-12,44
Forfar,3588,8,10,5,21,38,65,-27,35
Albion,3588,9,8,6,22,58,80,-22,30
Queen's Park,3588,10,6,10,20,41,76,-35,28
Raith,3589,1,23,8,5,70,33,37,77
Ayr,3589,2,24,4,8,93,43,50,76
Arbroath,3589,3,17,8,11,70,50,20,59
Alloa,3589,4,17,8,11,57,45,12,59
Stranraer,3589,5,15,6,15,57,66,-9,51
Airdrieon,3589,6,11,11,14,47,59,-12,44
East Fife,3589,7,13,4,19,49,66,-17,43
Forfar,3589,8,10,5,21,39,66,-27,35
Queen's Park,3589,9,7,10,19,41,72,-31,31
Albion,3589,10,8,6,22,58,81,-23,30
Ayr,3590,1,24,4,8,92,43,49,76
Raith,3590,2,22,9,5,69,33,36,75
Arbroath,3590,3,18,8,10,74,48,26,62
Alloa,3590,4,17,9,10,57,44,13,60
Stranraer,3590,5,16,5,15,57,65,-8,53
Airdrieon,3590,6,11,11,14,48,59,-11,44
East Fife,3590,7,13,3,20,48,66,-18,42
Forfar,3590,8,10,5,21,39,67,-28,35
Albion,3590,9,8,6,22,58,80,-22,30
Queen's Park,3590,10,6,10,20,39,76,-37,28
Raith,3591,1,22,9,5,69,33,36,75
Ayr,3591,2,23,5,8,92,44,48,74
Arbroath,3591,3,17,9,10,72,50,22,60
Alloa,3591,4,17,9,10,57,44,13,60
Stranraer,3591,5,15,5,16,55,67,-12,50
East Fife,3591,6,14,3,19,50,64,-14,45
Airdrieon,3591,7,10,11,15,46,60,-14,41
Forfar,3591,8,11,5,20,40,65,-25,38
Albion,3591,9,8,7,21,59,80,-21,31
Queen's Park,3591,10,6,11,19,41,74,-33,29
Raith,3592,1,23,8,5,70,33,37,77
Ayr,3592,2,23,4,9,90,43,47,73
Arbroath,3592,3,17,8,11,71,50,21,59
Alloa,3592,4,17,8,11,57,45,12,59
Stranraer,3592,5,15,5,16,56,66,-10,50
East Fife,3592,6,14,3,19,49,65,-16,45
Airdrieon,3592,7,11,11,14,47,59,-12,44
Forfar,3592,8,10,5,21,39,66,-27,35
Albion,3592,9,9,6,21,58,78,-20,33
Queen's Park,3592,10,7,10,19,41,73,-32,31
Raith,3593,1,23,8,5,71,33,38,77
Ayr,3593,2,24,4,8,93,44,49,76
Arbroath,3593,3,18,8,10,71,48,23,62
Alloa,3593,4,17,8,11,57,46,11,59
Stranraer,3593,5,16,5,15,56,64,-8,53
Airdrieon,3593,6,11,11,14,48,59,-11,44
East Fife,3593,7,13,3,20,47,65,-18,42
Forfar,3593,8,10,5,21,39,67,-28,35
Albion,3593,9,8,6,22,59,81,-22,30
Queen's Park,3593,10,6,10,20,39,73,-34,28
Ayr,3594,1,24,4,8,92,43,49,76
Raith,3594,2,22,8,6,69,35,34,74
Arbroath,3594,3,18,8,10,74,48,26,62
Alloa,3594,4,18,8,10,59,44,15,62
Stranraer,3594,5,15,5,16,56,66,-10,50
East Fife,3594,6,14,3,19,49,65,-16,45
Airdrieon,3594,7,10,12,14,45,58,-13,42
Forfar,3594,8,10,6,20,38,64,-26,36
Albion,3594,9,8,6,22,58,80,-22,30
Queen's Park,3594,10,6,10,20,39,76,-37,28
Raith,3595,1,23,8,5,69,32,37,77
Ayr,3595,2,23,4,9,90,45,45,73
Arbroath,3595,3,18,8,10,72,48,24,62
Alloa,3595,4,17,8,11,56,44,12,59
Stranraer,3595,5,15,5,16,56,66,-10,50
East Fife,3595,6,14,3,19,49,65,-16,45
Airdrieon,3595,7,11,11,14,47,59,-12,44
Forfar,3595,8,10,5,21,39,66,-27,35
Albion,3595,9,9,6,21,60,78,-18,33
Queen's Park,3595,10,6,10,20,39,74,-35,28
Raith,3596,1,23,8,5,74,33,41,77
Ayr,3596,2,24,4,8,95,42,53,76
Arbroath,3596,3,18,8,10,72,48,24,62
Alloa,3596,4,17,8,11,57,49,8,59
Stranraer,3596,5,15,5,16,55,65,-10,50
East Fife,3596,6,14,3,19,48,64,-16,45
Airdrieon,3596,7,11,11,14,47,58,-11,44
Forfar,3596,8,10,5,21,38,66,-28,35
Albion,3596,9,8,6,22,57,83,-26,30
Queen's Park,3596,10,6,10,20,39,74,-35,28
Raith,3597,1,23,8,5,72,32,40,77
Ayr,3597,2,24,4,8,94,44,50,76
Arbroath,3597,3,17,9,10,72,50,22,60
Alloa,3597,4,17,8,11,56,47,9,59
Stranraer,3597,5,16,5,15,58,65,-7,53
Airdrieon,3597,6,10,12,14,46,59,-13,42
East Fife,3597,7,13,3,20,48,67,-19,42
Forfar,3597,8,10,6,20,39,65,-26,36
Albion,3597,9,8,6,22,59,82,-23,30
Queen's Park,3597,10,6,11,19,41,74,-33,29
Ayr,3598,1,24,4,8,95,44,51,76
Raith,3598,2,22,9,5,69,33,36,75
Alloa,3598,3,17,9,10,57,44,13,60
Arbroath,3598,4,17,8,11,70,49,21,59
Stranraer,3598,5,15,6,15,56,65,-9,51
East Fife,3598,6,13,4,19,48,65,-17,43
Airdrieon,3598,7,10,11,15,45,59,-14,41
Forfar,3598,8,11,5,20,39,64,-25,38
Queen's Park,3598,9,7,10,19,40,72,-32,31
Albion,3598,10,8,6,22,59,83,-24,30
Raith,3599,1,23,8,5,70,33,37,77
Ayr,3599,2,24,4,8,93,44,49,76
Arbroath,3599,3,18,8,10,71,48,23,62
Alloa,3599,4,17,8,11,57,45,12,59
Stranraer,3599,5,15,6,15,56,65,-9,51
Airdrieon,3599,6,11,11,14,48,58,-10,44
East Fife,3599,7,13,4,19,48,65,-17,43
Forfar,3599,8,10,5,21,38,67,-29,35
Albion,3599,9,8,6,22,59,81,-22,30
Queen's Park,3599,10,6,10,20,39,73,-34,28
Ayr,3600,1,24,4,8,93,42,51,76
Raith,3600,2,22,8,6,68,33,35,74
Arbroath,3600,3,18,8,10,71,48,23,62
Alloa,3600,4,18,8,10,57,43,14,62
Stranraer,3600,5,15,5,16,56,66,-10,50
East Fife,3600,6,14,3,19,49,65,-16,45
Airdrieon,3600,7,10,11,15,46,63,-17,41
Forfar,3600,8,11,5,20,43,65,-22,38
Albion,3600,9,8,6,22,57,81,-24,30
Queen's Park,3600,10,6,10,20,39,73,-34,28
Raith,3601,1,23,8,5,70,33,37,77
Ayr,3601,2,24,4,8,94,45,49,76
Arbroath,3601,3,17,9,10,71,49,22,60
Alloa,3601,4,17,8,11,57,45,12,59
Stranraer,3601,5,15,5,16,55,65,-10,50
East Fife,3601,6,14,3,19,48,64,-16,45
Airdrieon,3601,7,11,11,14,46,58,-12,44
Forfar,3601,8,10,5,21,38,65,-27,35
Albion,3601,9,8,6,22,60,82,-22,30
Queen's Park,3601,10,6,11,19,40,73,-33,29
Raith,3602,1,23,8,5,70,32,38,77
Ayr,3602,2,24,4,8,92,42,50,76
Arbroath,3602,3,17,9,10,70,48,22,60
Alloa,3602,4,17,8,11,56,45,11,59
Stranraer,3602,5,15,5,16,56,68,-12,50
East Fife,3602,6,14,3,19,51,65,-14,45
Airdrieon,3602,7,10,11,15,46,61,-15,41
Forfar,3602,8,11,5,20,41,65,-24,38
Albion,3602,9,8,6,22,57,80,-23,30
Queen's Park,3602,10,6,11,19,39,72,-33,29
Raith,3603,1,23,8,5,70,33,37,77
Ayr,3603,2,23,4,9,90,43,47,73
Arbroath,3603,3,17,8,11,71,53,18,59
Alloa,3603,4,17,8,11,57,45,12,59
Stranraer,3603,5,15,6,15,57,66,-9,51
Airdrieon,3603,6,11,11,14,48,59,-11,44
East Fife,3603,7,13,4,19,49,66,-17,43
Forfar,3603,8,10,5,21,39,67,-28,35
Albion,3603,9,9,6,21,58,78,-20,33
Queen's Park,3603,10,7,10,19,44,73,-29,31
Raith,3604,1,23,8,5,70,33,37,77
Ayr,3604,2,24,4,8,97,43,54,76
Arbroath,3604,3,17,9,10,71,49,22,60
Alloa,3604,4,17,8,11,57,45,12,59
Stranraer,3604,5,15,5,16,55,70,-15,50
East Fife,3604,6,14,3,19,53,64,-11,45
Airdrieon,3604,7,11,11,14,50,58,-8,44
Forfar,3604,8,10,5,21,38,69,-31,35
Albion,3604,9,8,6,22,58,85,-27,30
Queen's Park,3604,10,6,11,19,40,73,-33,29
Raith,3605,1,23,8,5,72,32,40,77
Ayr,3605,2,24,4,8,94,42,52,76
Arbroath,3605,3,18,8,10,73,48,25,62
Alloa,3605,4,17,8,11,56,47,9,59
Stranraer,3605,5,15,5,16,55,65,-10,50
East Fife,3605,6,14,3,19,48,64,-16,45
Airdrieon,3605,7,10,11,15,46,60,-14,41
Forfar,3605,8,11,5,20,40,65,-25,38
Albion,3605,9,8,6,22,57,82,-25,30
Queen's Park,3605,10,6,10,20,39,75,-36,28
Raith,3606,1,23,8,5,70,33,37,77
Ayr,3606,2,24,4,8,96,45,51,76
Arbroath,3606,3,17,8,11,71,50,21,59
Alloa,3606,4,17,8,11,57,45,12,59
Stranraer,3606,5,16,5,15,59,66,-7,53
Airdrieon,3606,6,11,11,14,46,58,-12,44
East Fife,3606,7,13,3,20,49,68,-19,42
Forfar,3606,8,10,5,21,38,65,-27,35
Queen's Park,3606,9,7,10,19,41,73,-32,31
Albion,3606,10,8,6,22,60,84,-24,30
Raith,3607,1,22,9,5,70,34,36,75
Ayr,3607,2,23,5,8,91,43,48,74
Arbroath,3607,3,18,8,10,74,48,26,62
Alloa,3607,4,17,9,10,58,45,13,60
Stranraer,3607,5,15,5,16,55,65,-10,50
East Fife,3607,6,14,3,19,48,64,-16,45
Airdrieon,3607,7,11,11,14,46,58,-12,44
Forfar,3607,8,10,5,21,38,65,-27,35
Albion,3607,9,8,7,21,58,79,-21,31
Queen's Park,3607,10,6,10,20,39,76,-37,28
Ayr,3608,1,24,4,8,93,43,50,76
Raith,3608,2,22,8,6,68,34,34,74
Arbroath,3608,3,18,8,10,74,50,24,62
Alloa,3608,4,18,8,10,58,43,15,62
Stranraer,3608,5,16,5,15,57,65,-8,53
Airdrieon,3608,6,11,11,14,46,58,-12,44
East Fife,3608,7,13,3,20,48,66,-18,42
Forfar,3608,8,10,5,21,38,65,-27,35
Albion,3608,9,8,6,22,58,81,-23,30
Queen's Park,3608,10,6,10,20,41,76,-35,28
Raith,3609,1,23,8,5,72,34,38,77
Ayr,3609,2,24,4,8,93,43,50,76
Arbroath,3609,3,17,9,10,73,51,22,60
Alloa,3609,4,17,8,11,58,47,11,59
Stranraer,3609,5,15,6,15,57,66,-9,51
East Fife,3609,6,13,4,19,49,66,-17,43
Airdrieon,3609,7,10,12,14,45,58,-13,42
Forfar,3609,8,10,6,20,38,64,-26,36
Albion,3609,9,8,6,22,58,81,-23,30
Queen's Park,3609,10,6,11,19,42,75,-33,29
Ayr,3610,1,24,4,8,97,45,52,76
Raith,3610,2,22,8,6,69,34,35,74
Alloa,3610,3,18,8,10,58,44,14,62
Arbroath,3610,4,17,9,10,71,49,22,60
Stranraer,3610,5,16,5,15,57,65,-8,53
Airdrieon,3610,6,11,11,14,46,58,-12,44
East Fife,3610,7,13,3,20,48,66,-18,42
Forfar,3610,8,10,5,21,38,65,-27,35
Albion,3610,9,8,6,22,60,85,-25,30
Queen's Park,3610,10,6,11,19,40,73,-33,29
Ayr,3611,1,24,4,8,94,43,51,76
Raith,3611,2,22,9,5,70,34,36,75
Arbroath,3611,3,18,8,10,74,51,23,62
Alloa,3611,4,17,9,10,58,45,13,60
Stranraer,3611,5,15,5,16,55,67,-12,50
East Fife,3611,6,14,3,19,50,64,-14,45
Airdrieon,3611,7,10,11,15,45,59,-14,41
Forfar,3611,8,11,5,20,39,64,-25,38
Albion,3611,9,8,6,22,58,82,-24,30
Queen's Park,3611,10,6,10,20,42,76,-34,28
Ayr,3612,1,24,4,8,95,42,53,76
Raith,3612,2,22,9,5,69,33,36,75
Arbroath,3612,3,18,8,10,74,48,26,62
Alloa,3612,4,17,9,10,57,44,13,60
Stranraer,3612,5,15,5,16,55,68,-13,50
East Fife,3612,6,14,3,19,51,64,-13,45
Airdrieon,3612,7,11,11,14,46,58,-12,44
Forfar,3612,8,10,5,21,38,65,-27,35
Albion,3612,9,8,6,22,57,83,-26,30
Queen's Park,3612,10,6,10,20,39,76,-37,28
Ayr,3613,1,24,4,8,95,43,52,76
Raith,3613,2,22,8,6,69,34,35,74
Alloa,3613,3,18,8,10,58,44,14,62
Arbroath,3613,4,17,9,10,70,48,22,60
Stranraer,3613,5,15,5,16,55,66,-11,50
East Fife,3613,6,14,3,19,49,64,-15,45
Airdrieon,3613,7,10,12,14,45,58,-13,42
Forfar,3613,8,10,6,20,38,64,-26,36
Albion,3613,9,8,6,22,58,83,-25,30
Queen's Park,3613,10,6,11,19,39,72,-33,29
Ayr,3614,1,24,4,8,91,42,49,76
Raith,3614,2,22,9,5,69,33,36,75
Arbroath,3614,3,18,8,10,72,49,23,62
Alloa,3614,4,17,9,10,57,44,13,60
Stranraer,3614,5,15,5,16,58,68,-10,50
East Fife,3614,6,14,3,19,51,67,-16,45
Airdrieon,3614,7,11,11,14,48,58,-10,44
Forfar,3614,8,10,5,21,38,67,-29,35
Albion,3614,9,8,6,22,57,79,-22,30
Queen's Park,3614,10,6,10,20,40,74,-34,28
Raith,3615,1,23,8,5,71,32,39,77
Ayr,3615,2,24,4,8,95,42,53,76
Arbroath,3615,3,18,8,10,73,50,23,62
Alloa,3615,4,17,8,11,56,46,10,59
Stranraer,3615,5,15,6,15,56,65,-9,51
Airdrieon,3615,6,11,11,14,47,58,-11,44
East Fife,3615,7,13,4,19,48,65,-17,43
Forfar,3615,8,10,5,21,38,66,-28,35
Albion,3615,9,8,6,22,57,83,-26,30
Queen's Park,3615,10,6,10,20,41,75,-34,28
Ayr,3616,1,24,4,8,94,44,50,76
Raith,3616,2,22,9,5,69,33,36,75
Alloa,3616,3,17,9,10,57,44,13,60
Arbroath,3616,4,17,8,11,72,51,21,59
Stranraer,3616,5,15,5,16,57,67,-10,50
East Fife,3616,6,14,3,19,50,66,-16,45
Airdrieon,3616,7,11,11,14,46,58,-12,44
Forfar,3616,8,10,5,21,38,65,-27,35
Queen's Park,3616,9,7,10,19,42,74,-32,31
Albion,3616,10,8,6,22,59,82,-23,30
Ayr,3617,1,24,4,8,93,43,50,76
Raith,3617,2,22,8,6,69,34,35,74
Arbroath,3617,3,18,8,10,74,49,25,62
Alloa,3617,4,18,8,10,58,44,14,62
Stranraer,3617,5,16,5,15,57,64,-7,53
Airdrieon,3617,6,10,12,14,45,58,-13,42
East Fife,3617,7,13,3,20,47,66,-19,42
Forfar,3617,8,10,6,20,38,64,-26,36
Albion,3617,9,8,6,22,58,81,-23,30
Queen's Park,3617,10,6,10,20,40,76,-36,28
Raith,3618,1,23,8,5,71,33,38,77
Ayr,3618,2,24,4,8,93,43,50,76
Arbroath,3618,3,17,9,10,70,48,22,60
Alloa,3618,4,17,8,11,57,46,11,59
Stranraer,3618,5,16,5,15,56,64,-8,53
Airdrieon,3618,6,11,11,14,46,58,-12,44
East Fife,3618,7,13,3,20,47,65,-18,42
Forfar,3618,8,10,5,21,38,65,-27,35
Albion,3618,9,8,6,22,58,81,-23,30
Queen's Park,3618,10,6,11,19,39,72,-33,29
Raith,3619,1,23,8,5,70,33,37,77
Ayr,3619,2,23,4,9,90,43,47,73
Arbroath,3619,3,18,8,10,73,49,24,62
Alloa,3619,4,17,8,11,57,45,12,59
Stranraer,3619,5,16,5,15,56,64,-8,53
East Fife,3619,6,13,3,20,47,65,-18,42
Airdrieon,3619,7,10,11,15,45,59,-14,41
Forfar,3619,8,11,5,20,39,64,-25,38
Albion,3619,9,9,6,21,58,78,-20,33
Queen's Park,3619,10,6,10,20,40,75,-35,28
Raith,3620,1,23,8,5,70,32,38,77
Ayr,3620,2,23,4,9,91,44,47,73
Arbroath,3620,3,17,9,10,71,49,22,60
Alloa,3620,4,17,8,11,56,45,11,59
Stranraer,3620,5,15,5,16,55,65,-10,50
East Fife,3620,6,14,3,19,48,64,-16,45
Airdrieon,3620,7,11,11,14,47,59,-12,44
Forfar,3620,8,10,5,21,39,66,-27,35
Albion,3620,9,9,6,21,59,79,-20,33
Queen's Park,3620,10,6,11,19,40,73,-33,29
Ayr,3621,1,24,4,8,94,43,51,76
Raith,3621,2,22,8,6,69,34,35,74
Alloa,3621,3,18,8,10,58,44,14,62
Arbroath,3621,4,17,8,11,70,49,21,59
Stranraer,3621,5,15,6,15,56,65,-9,51
Airdrieon,3621,6,11,11,14,47,59,-12,44
East Fife,3621,7,13,4,19,48,65,-17,43
Forfar,3621,8,10,5,21,39,66,-27,35
Queen's Park,3621,9,7,10,19,40,72,-32,31
Albion,3621,10,8,6,22,58,82,-24,30
Raith,3622,1,23,8,5,70,33,37,77
Ayr,3622,2,24,4,8,96,42,54,76
Arbroath,3622,3,18,8,10,72,48,24,62
Alloa,3622,4,17,8,11,57,45,12,59
Stranraer,3622,5,15,6,15,56,65,-9,51
Airdrieon,3622,6,11,11,14,48,58,-10,44
East Fife,3622,7,13,4,19,48,65,-17,43
Forfar,3622,8,10,5,21,38,67,-29,35
Albion,3622,9,8,6,22,57,84,-27,30
Queen's Park,3622,10,6,10,20,39,74,-35,28
Ayr,3623,1,24,4,8,93,42,51,76
Raith,3623,2,22,9,5,69,33,36,75
Alloa,3623,3,17,9,10,57,44,13,60
Arbroath,3623,4,17,8,11,71,50,21,59
Stranraer,3623,5,15,5,16,56,67,-11,50
East Fife,3623,6,14,3,19,50,65,-15,45
Airdrieon,3623,7,11,11,14,46,58,-12,44
Forfar,3623,8,10,5,21,38,65,-27,35
Queen's Park,3623,9,7,10,19,41,73,-32,31
Albion,3623,10,8,6,22,57,81,-24,30
Raith,3624,1,23,8,5,70,32,38,77
Ayr,3624,2,24,4,8,93,42,51,76
Arbroath,3624,3,17,8,11,71,52,19,59
Alloa,3624,4,17,8,11,56,45,11,59
Stranraer,3624,5,15,6,15,57,66,-9,51
Airdrieon,3624,6,11,11,14,46,58,-12,44
East Fife,3624,7,13,4,19,49,66,-17,43
Forfar,3624,8,10,5,21,38,65,-27,35
Queen's Park,3624,9,7,10,19,43,73,-30,31
Albion,3624,10,8,6,22,57,81,-24,30
Ayr,3625,1,24,4,8,92,42,50,76
Raith,3625,2,22,9,5,69,33,36,75
Alloa,3625,3,17,9,10,57,44,13,60
Arbroath,3625,4,17,8,11,70,49,21,59
Stranraer,3625,5,16,5,15,58,64,-6,53
Airdrieon,3625,6,10,12,14,46,59,-13,42
East Fife,3625,7,13,3,20,47,67,-20,42
Forfar,3625,8,10,6,20,39,65,-26,36
Queen's Park,3625,9,7,10,19,40,72,-32,31
Albion,3625,10,8,6,22,57,80,-23,30
Raith,3626,1,23,8,5,70,33,37,77
Ayr,3626,2,24,4,8,92,42,50,76
Arbroath,3626,3,18,8,10,71,48,23,62
Alloa,3626,4,17,8,11,57,45,12,59
Stranraer,3626,5,16,5,15,56,64,-8,53
East Fife,3626,6,13,3,20,47,65,-18,42
Airdrieon,3626,7,10,11,15,45,59,-14,41
Forfar,3626,8,11,5,20,39,64,-25,38
Albion,3626,9,8,6,22,57,80,-23,30
Queen's Park,3626,10,6,10,20,39,73,-34,28
Ayr,3627,1,24,4,8,92,43,49,76
Raith,3627,2,22,8,6,68,33,35,74
Alloa,3627,3,18,8,10,57,43,14,62
Arbroath,3627,4,17,9,10,71,49,22,60
Stranraer,3627,5,16,5,15,58,66,-8,53
Airdrieon,3627,6,10,12,14,47,60,-13,42
East Fife,3627,7,13,3,20,49,67,-18,42
Forfar,3627,8,10,6,20,40,66,-26,36
Albion,3627,9,8,6,22,58,80,-22,30
Queen's Park,3627,10,6,11,19,40,73,-33,29
Ayr,3628,1,23,5,8,93,45,48,74
Raith,3628,2,22,8,6,68,33,35,74
Alloa,3628,3,18,8,10,57,43,14,62
Arbroath,3628,4,17,8,11,70,51,19,59
Stranraer,3628,5,15,5,16,56,67,-11,50
East Fife,3628,6,14,3,19,50,65,-15,45
Airdrieon,3628,7,10,11,15,45,59,-14,41
Forfar,3628,8,11,5,20,39,64,-25,38
Albion,3628,9,8,7,21,60,81,-21,31
Queen's Park,3628,10,7,10,19,42,72,-30,31
Ayr,3629,1,24,4,8,95,44,51,76
Raith,3629,2,22,9,5,70,34,36,75
Arbroath,3629,3,18,8,10,74,50,24,62
Alloa,3629,4,17,9,10,58,45,13,60
Stranraer,3629,5,15,6,15,57,66,-9,51
East Fife,3629,6,13,4,19,49,66,-17,43
Airdrieon,3629,7,10,12,14,46,59,-13,42
Forfar,3629,8,10,6,20,39,65,-26,36
Albion,3629,9,8,6,22,59,83,-24,30
Queen's Park,3629,10,6,10,20,41,76,-35,28
Raith,3630,1,23,8,5,70,32,38,77
Ayr,3630,2,24,4,8,95,43,52,76
Arbroath,3630,3,18,8,10,74,49,25,62
Alloa,3630,4,17,8,11,56,45,11,59
Stranraer,3630,5,16,5,15,57,65,-8,53
East Fife,3630,6,13,3,20,48,66,-18,42
Airdrieon,3630,7,10,11,15,45,61,-16,41
Forfar,3630,8,11,5,20,41,64,-23,38
Albion,3630,9,8,6,22,58,83,-25,30
Queen's Park,3630,10,6,10,20,40,76,-36,28
Raith,3631,1,22,8,6,68,33,35,74
Ayr,3631,2,23,4,9,92,46,46,73
Alloa,3631,3,18,8,10,57,43,14,62
Arbroath,3631,4,17,8,11,70,49,21,59
Stranraer,3631,5,15,6,15,55,64,-9,51
Airdrieon,3631,6,11,11,14,47,58,-11,44
East Fife,3631,7,13,4,19,47,64,-17,43
Forfar,3631,8,10,5,21,38,66,-28,35
Albion,3631,9,9,6,21,61,80,-19,33
Queen's Park,3631,10,7,10,19,40,72,-32,31
Raith,3632,1,22,9,5,69,33,36,75
Ayr,3632,2,23,5,8,90,42,48,74
Arbroath,3632,3,18,8,10,73,50,23,62
Alloa,3632,4,17,9,10,57,44,13,60
Stranraer,3632,5,15,5,16,55,67,-12,50
East Fife,3632,6,14,3,19,50,64,-14,45
Airdrieon,3632,7,11,11,14,48,58,-10,44
Forfar,3632,8,10,5,21,38,67,-29,35
Albion,3632,9,8,7,21,57,78,-21,31
Queen's Park,3632,10,6,10,20,41,75,-34,28
Raith,3633,1,23,8,5,71,33,38,77
Ayr,3633,2,24,4,8,92,43,49,76
Arbroath,3633,3,18,8,10,74,50,24,62
Alloa,3633,4,17,8,11,57,46,11,59
Stranraer,3633,5,15,5,16,56,67,-11,50
East Fife,3633,6,14,3,19,50,65,-15,45
Airdrieon,3633,7,10,11,15,45,59,-14,41
Forfar,3633,8,11,5,20,39,64,-25,38
Albion,3633,9,8,6,22,58,80,-22,30
Queen's Park,3633,10,6,10,20,41,76,-35,28
Raith,3634,1,23,8,5,69,32,37,77
Ayr,3634,2,24,4,8,94,43,51,76
Arbroath,3634,3,17,9,10,71,49,22,60
Alloa,3634,4,17,8,11,56,44,12,59
Stranraer,3634,5,15,6,15,56,65,-9,51
Airdrieon,3634,6,11,11,14,47,59,-12,44
East Fife,3634,7,13,4,19,48,65,-17,43
Forfar,3634,8,10,5,21,39,66,-27,35
Albion,3634,9,8,6,22,58,82,-24,30
Queen's Park,3634,10,6,11,19,40,73,-33,29
Ayr,3635,1,24,4,8,94,43,51,76
Raith,3635,2,22,9,5,69,33,36,75
Arbroath,3635,3,18,8,10,73,50,23,62
Alloa,3635,4,17,9,10,57,44,13,60
Stranraer,3635,5,15,6,15,57,66,-9,51
Airdrieon,3635,6,11,11,14,49,58,-9,44
East Fife,3635,7,13,4,19,49,66,-17,43
Forfar,3635,8,10,5,21,38,68,-30,35
Albion,3635,9,8,6,22,58,82,-24,30
Queen's Park,3635,10,6,10,20,41,75,-34,28
Ayr,3636,1,24,4,8,93,44,49,76
Raith,3636,2,22,9,5,69,33,36,75
Arbroath,3636,3,18,8,10,72,49,23,62
Alloa,3636,4,17,9,10,57,44,13,60
Stranraer,3636,5,16,5,15,59,66,-7,53
Airdrieon,3636,6,11,11,14,47,59,-12,44
East Fife,3636,7,13,3,20,49,68,-19,42
Forfar,3636,8,10,5,21,39,66,-27,35
Albion,3636,9,8,6,22,59,81,-22,30
Queen's Park,3636,10,6,10,20,40,74,-34,28
Raith,3637,1,23,8,5,70,32,38,77
Ayr,3637,2,24,4,8,92,43,49,76
Arbroath,3637,3,18,8,10,71,48,23,62
Alloa,3637,4,17,8,11,56,45,11,59
Stranraer,3637,5,16,5,15,59,67,-8,53
Airdrieon,3637,6,11,11,14,49,60,-11,44
East Fife,3637,7,13,3,20,50,68,-18,42
Forfar,3637,8,10,5,21,40,68,-28,35
Albion,3637,9,8,6,22,58,80,-22,30
Queen's Park,3637,10,6,10,20,39,73,-34,28
Ayr,3638,1,24,4,8,92,43,49,76
Raith,3638,2,22,8,6,68,34,34,74
Arbroath,3638,3,18,8,10,73,49,24,62
Alloa,3638,4,18,8,10,58,43,15,62
Stranraer,3638,5,16,5,15,57,65,-8,53
Airdrieon,3638,6,11,11,14,46,58,-12,44
East Fife,3638,7,13,3,20,48,66,-18,42
Forfar,3638,8,10,5,21,38,65,-27,35
Albion,3638,9,8,6,22,58,80,-22,30
Queen's Park,3638,10,6,10,20,40,75,-35,28
Raith,3639,1,23,8,5,71,32,39,77
Ayr,3639,2,23,4,9,93,46,47,73
Arbroath,3639,3,18,8,10,75,48,27,62
Alloa,3639,4,17,8,11,56,46,10,59
Stranraer,3639,5,15,6,15,55,64,-9,51
Airdrieon,3639,6,11,11,14,47,59,-12,44
East Fife,3639,7,13,4,19,47,64,-17,43
Forfar,3639,8,10,5,21,39,66,-27,35
Albion,3639,9,9,6,21,61,81,-20,33
Queen's Park,3639,10,6,10,20,39,77,-38,28
Raith,3640,1,23,8,5,71,32,39,77
Ayr,3640,2,23,5,8,92,44,48,74
Arbroath,3640,3,18,8,10,72,49,23,62
Alloa,3640,4,17,8,11,56,46,10,59
Stranraer,3640,5,15,6,15,57,66,-9,51
East Fife,3640,6,13,4,19,49,66,-17,43
Airdrieon,3640,7,10,11,15,46,61,-15,41
Forfar,3640,8,11,5,20,41,65,-24,38
Albion,3640,9,8,7,21,59,80,-21,31
Queen's Park,3640,10,6,10,20,40,74,-34,28
Raith,3641,1,23,8,5,69,32,37,77
Ayr,3641,2,24,4,8,91,42,49,76
Arbroath,3641,3,17,8,11,71,51,20,59
Alloa,3641,4,17,8,11,56,44,12,59
Stranraer,3641,5,15,5,16,56,66,-10,50
East Fife,3641,6,14,3,19,49,65,-16,45
Airdrieon,3641,7,11,11,14,48,58,-10,44
Forfar,3641,8,10,5,21,38,67,-29,35
Queen's Park,3641,9,7,10,19,42,73,-31,31
Albion,3641,10,8,6,22,57,79,-22,30
Raith,3642,1,23,8,5,73,32,41,77
Ayr,3642,2,24,4,8,94,43,51,76
Arbroath,3642,3,17,9,10,73,51,22,60
Alloa,3642,4,17,8,11,56,48,8,59
Stranraer,3642,5,15,5,16,55,65,-10,50
East Fife,3642,6,14,3,19,48,64,-16,45
Airdrieon,3642,7,11,11,14,46,58,-12,44
Forfar,3642,8,10,5,21,38,65,-27,35
Albion,3642,9,8,6,22,58,82,-24,30
Queen's Park,3642,10,6,11,19,42,75,-33,29
Raith,3643,1,23,8,5,71,34,37,77
Ayr,3643,2,24,4,8,92,43,49,76
Arbroath,3643,3,18,8,10,71,48,23,62
Alloa,3643,4,17,8,11,58,46,12,59
Stranraer,3643,5,15,5,16,55,66,-11,50
East Fife,3643,6,14,3,19,49,64,-15,45
Airdrieon,3643,7,10,12,14,46,59,-13,42
Forfar,3643,8,10,6,20,39,65,-26,36
Albion,3643,9,8,6,22,58,80,-22,30
Queen's Park,3643,10,6,10,20,39,73,-34,28
Ayr,3644,1,24,4,8,96,42,54,76
Raith,3644,2,22,8,6,69,35,34,74
Alloa,3644,3,18,8,10,59,44,15,62
Arbroath,3644,4,17,8,11,71,50,21,59
Stranraer,3644,5,16,5,15,58,65,-7,53
Airdrieon,3644,6,11,11,14,47,58,-11,44
East Fife,3644,7,13,3,20,48,67,-19,42
Forfar,3644,8,10,5,21,38,66,-28,35
Queen's Park,3644,9,7,10,19,41,73,-32,31
Albion,3644,10,8,6,22,57,84,-27,30
Raith,3645,1,23,8,5,70,33,37,77
Ayr,3645,2,24,4,8,94,44,50,76
Arbroath,3645,3,18,8,10,73,48,25,62
Alloa,3645,4,17,8,11,57,45,12,59
Stranraer,3645,5,16,5,15,57,65,-8,53
Airdrieon,3645,6,11,11,14,46,58,-12,44
East Fife,3645,7,13,3,20,48,66,-18,42
Forfar,3645,8,10,5,21,38,65,-27,35
Albion,3645,9,8,6,22,59,82,-23,30
Queen's Park,3645,10,6,10,20,39,75,-36,28
Ayr,3646,1,24,4,8,94,44,50,76
Raith,3646,2,22,9,5,69,33,36,75
Alloa,3646,3,17,9,10,57,44,13,60
Arbroath,3646,4,17,8,11,71,50,21,59
Stranraer,3646,5,15,6,15,56,65,-9,51
East Fife,3646,6,13,4,19,48,65,-17,43
Airdrieon,3646,7,10,12,14,46,59,-13,42
Forfar,3646,8,10,6,20,39,65,-26,36
Queen's Park,3646,9,7,10,19,41,73,-32,31
Albion,3646,10,8,6,22,59,82,-23,30
Raith,3647,1,22,9,5,68,32,36,75
Ayr,3647,2,23,5,8,93,45,48,74
Alloa,3647,3,17,9,10,56,43,13,60
Arbroath,3647,4,17,8,11,71,53,18,59
Stranraer,3647,5,16,5,15,57,65,-8,53
Airdrieon,3647,6,10,12,14,46,59,-13,42
East Fife,3647,7,13,3,20,48,66,-18,42
Forfar,3647,8,10,6,20,39,65,-26,36
Albion,3647,9,8,7,21,60,81,-21,31
Queen's Park,3647,10,7,10,19,44,73,-29,31
Raith,3648,1,23,8,5,70,32,38,77
Ayr,3648,2,24,4,8,93,43,50,76
Arbroath,3648,3,18,8,10,74,49,25,62
Alloa,3648,4,17,8,11,56,45,11,59
Stranraer,3648,5,16,5,15,56,64,-8,53
Airdrieon,3648,6,11,11,14,48,58,-10,44
East Fife,3648,7,13,3,20,47,65,-18,42
Forfar,3648,8,10,5,21,38,67,-29,35
Albion,3648,9,8,6,22,58,81,-23,30
Queen's Park,3648,10,6,10,20,40,76,-36,28
Raith,3649,1,23,8,5,70,32,38,77
Ayr,3649,2,24,4,8,93,44,49,76
Arbroath,3649,3,17,8,11,71,50,21,59
Alloa,3649,4,17,8,11,56,45,11,59
Stranraer,3649,5,16,5,15,57,64,-7,53
Airdrieon,3649,6,11,11,14,48,58,-10,44
East Fife,3649,7,13,3,20,47,66,-19,42
Forfar,3649,8,10,5,21,38,67,-29,35
Queen's Park,3649,9,7,10,19,41,73,-32,31
Albion,3649,10,8,6,22,59,81,-22,30
Raith,3650,1,23,8,5,70,32,38,77
Ayr,3650,2,24,4,8,95,44,51,76
Arbroath,3650,3,17,8,11,71,52,19,59
Alloa,3650,4,17,8,11,56,45,11,59
Stranraer,3650,5,15,6,15,57,66,-9,51
East Fife,3650,6,13,4,19,49,66,-17,43
Airdrieon,3650,7,10,11,15,46,60,-14,41
Forfar,3650,8,11,5,20,40,65,-25,38
Queen's Park,3650,9,7,10,19,43,73,-30,31
Albion,3650,10,8,6,22,59,83,-24,30
Ayr,3651,1,24,4,8,92,43,49,76
Raith,3651,2,22,8,6,68,33,35,74
Arbroath,3651,3,18,8,10,72,49,23,62
Alloa,3651,4,18,8,10,57,43,14,62
Stranraer,3651,5,16,5,15,58,64,-6,53
Airdrieon,3651,6,10,12,14,45,58,-13,42
East Fife,3651,7,13,3,20,47,67,-20,42
Forfar,3651,8,10,6,20,38,64,-26,36
Albion,3651,9,8,6,22,58,80,-22,30
Queen's Park,3651,10,6,10,20,40,74,-34,28
Raith,3652,1,22,9,5,68,32,36,75
Ayr,3652,2,23,5,8,93,45,48,74
Arbroath,3652,3,18,8,10,72,49,23,62
Alloa,3652,4,17,9,10,56,43,13,60
Stranraer,3652,5,15,6,15,58,67,-9,51
East Fife,3652,6,13,4,19,50,67,-17,43
Airdrieon,3652,7,10,12,14,47,60,-13,42
Forfar,3652,8,10,6,20,40,66,-26,36
Albion,3652,9,8,7,21,60,81,-21,31
Queen's Park,3652,10,6,10,20,40,74,-34,28
Ayr,3653,1,24,4,8,94,43,51,76
Raith,3653,2,22,9,5,70,34,36,75
Alloa,3653,3,17,9,10,58,45,13,60
Arbroath,3653,4,17,8,11,71,51,20,59
Stranraer,3653,5,15,6,15,55,64,-9,51
East Fife,3653,6,13,4,19,47,64,-17,43
Airdrieon,3653,7,10,12,14,47,60,-13,42
Forfar,3653,8,10,6,20,40,66,-26,36
Queen's Park,3653,9,7,10,19,42,73,-31,31
Albion,3653,10,8,6,22,58,82,-24,30
Ayr,3654,1,24,4,8,96,47,49,76
Raith,3654,2,22,9,5,68,32,36,75
Arbroath,3654,3,18,8,10,71,48,23,62
Alloa,3654,4,17,9,10,56,43,13,60
Stranraer,3654,5,15,5,16,56,66,-10,50
East Fife,3654,6,14,3,19,49,65,-16,45
Airdrieon,3654,7,11,11,14,48,58,-10,44
Forfar,3654,8,10,5,21,38,67,-29,35
Albion,3654,9,8,6,22,62,84,-22,30
Queen's Park,3654,10,6,10,20,39,73,-34,28
Ayr,3655,1,24,4,8,95,45,50,76
Raith,3655,2,22,8,6,68,33,35,74
Arbroath,3655,3,18,8,10,75,51,24,62
Alloa,3655,4,18,8,10,57,43,14,62
Stranraer,3655,5,15,5,16,57,67,-10,50
East Fife,3655,6,14,3,19,50,66,-16,45
Airdrieon,3655,7,11,11,14,48,60,-12,44
Forfar,3655,8,10,5,21,40,67,-27,35
Albion,3655,9,8,6,22,60,83,-23,30
Queen's Park,3655,10,6,10,20,42,77,-35,28
Raith,3656,1,23,8,5,70,33,37,77
Ayr,3656,2,23,5,8,93,45,48,74
Arbroath,3656,3,17,8,11,71,52,19,59
Alloa,3656,4,17,8,11,57,45,12,59
Stranraer,3656,5,16,5,15,57,64,-7,53
Airdrieon,3656,6,11,11,14,48,60,-12,44
East Fife,3656,7,13,3,20,47,66,-19,42
Forfar,3656,8,10,5,21,40,67,-27,35
Albion,3656,9,8,7,21,60,81,-21,31
Queen's Park,3656,10,7,10,19,43,73,-30,31
Raith,3657,1,23,8,5,71,32,39,77
Ayr,3657,2,24,4,8,92,43,49,76
Arbroath,3657,3,18,8,10,73,48,25,62
Alloa,3657,4,17,8,11,56,46,10,59
Stranraer,3657,5,15,5,16,58,68,-10,50
East Fife,3657,6,14,3,19,51,67,-16,45
Airdrieon,3657,7,10,12,14,45,58,-13,42
Forfar,3657,8,10,6,20,38,64,-26,36
Albion,3657,9,8,6,22,58,80,-22,30
Queen's Park,3657,10,6,10,20,39,75,-36,28
Raith,3658,1,23,8,5,70,32,38,77
Ayr,3658,2,24,4,8,94,42,52,76
Arbroath,3658,3,18,8,10,71,48,23,62
Alloa,3658,4,17,8,11,56,45,11,59
Stranraer,3658,5,15,5,16,56,66,-10,50
East Fife,3658,6,14,3,19,49,65,-16,45
Airdrieon,3658,7,11,11,14,48,58,-10,44
Forfar,3658,8,10,5,21,38,67,-29,35
Albion,3658,9,8,6,22,57,82,-25,30
Queen's Park,3658,10,6,10,20,39,73,-34,28
Raith,3659,1,23,8,5,69,32,37,77
Ayr,3659,2,24,4,8,94,43,51,76
Arbroath,3659,3,17,9,10,72,50,22,60
Alloa,3659,4,17,8,11,56,44,12,59
Stranraer,3659,5,16,5,15,57,65,-8,53
Airdrieon,3659,6,11,11,14,46,58,-12,44
East Fife,3659,7,13,3,20,48,66,-18,42
Forfar,3659,8,10,5,21,38,65,-27,35
Albion,3659,9,8,6,22,58,82,-24,30
Queen's Park,3659,10,6,11,19,41,74,-33,29
Ayr,3660,1,24,4,8,93,42,51,76
Raith,3660,2,22,9,5,69,33,36,75
Arbroath,3660,3,18,8,10,72,48,24,62
Alloa,3660,4,17,9,10,57,44,13,60
Stranraer,3660,5,15,5,16,56,66,-10,50
East Fife,3660,6,14,3,19,49,65,-16,45
Airdrieon,3660,7,11,11,14,47,58,-11,44
Forfar,3660,8,10,5,21,38,66,-28,35
Albion,3660,9,8,6,22,57,81,-24,30
Queen's Park,3660,10,6,10,20,39,74,-35,28
Raith,3661,1,23,8,5,69,32,37,77
Ayr,3661,2,24,4,8,92,42,50,76
Arbroath,3661,3,18,8,10,71,48,23,62
Alloa,3661,4,17,8,11,56,44,12,59
Stranraer,3661,5,16,5,15,58,65,-7,53
Airdrieon,3661,6,11,11,14,46,58,-12,44
East Fife,3661,7,13,3,20,48,67,-19,42
Forfar,3661,8,10,5,21,38,65,-27,35
Albion,3661,9,8,6,22,57,80,-23,30
Queen's Park,3661,10,6,10,20,39,73,-34,28
Raith,3662,1,23,8,5,69,32,37,77
Ayr,3662,2,23,5,8,92,44,48,74
Arbroath,3662,3,18,8,10,74,51,23,62
Alloa,3662,4,17,8,11,56,44,12,59
Stranraer,3662,5,15,5,16,56,66,-10,50
East Fife,3662,6,14,3,19,49,65,-16,45
Airdrieon,3662,7,10,12,14,45,58,-13,42
Forfar,3662,8,10,6,20,38,64,-26,36
Albion,3662,9,8,7,21,59,80,-21,31
Queen's Park,3662,10,6,10,20,42,76,-34,28
Raith,3663,1,23,8,5,71,33,38,77
Ayr,3663,2,24,4,8,93,44,49,76
Arbroath,3663,3,18,8,10,73,49,24,62
Alloa,3663,4,17,8,11,57,46,11,59
Stranraer,3663,5,16,5,15,58,65,-7,53
Airdrieon,3663,6,11,11,14,47,59,-12,44
East Fife,3663,7,13,3,20,48,67,-19,42
Forfar,3663,8,10,5,21,39,66,-27,35
Albion,3663,9,8,6,22,59,81,-22,30
Queen's Park,3663,10,6,10,20,40,75,-35,28
Raith,3664,1,23,8,5,70,32,38,77
Ayr,3664,2,23,5,8,93,45,48,74
Arbroath,3664,3,18,8,10,72,49,23,62
Alloa,3664,4,17,8,11,56,45,11,59
Stranraer,3664,5,15,5,16,57,67,-10,50
East Fife,3664,6,14,3,19,50,66,-16,45
Airdrieon,3664,7,11,11,14,47,58,-11,44
Forfar,3664,8,10,5,21,38,66,-28,35
Albion,3664,9,8,7,21,60,81,-21,31
Queen's Park,3664,10,6,10,20,40,74,-34,28
Raith,3665,1,23,8,5,70,32,38,77
Ayr,3665,2,24,4,8,99,44,55,76
Arbroath,3665,3,18,8,10,72,48,24,62
Alloa,3665,4,17,8,11,56,45,11,59
Stranraer,3665,5,15,5,16,56,66,-10,50
East Fife,3665,6,14,3,19,49,65,-16,45
Airdrieon,3665,7,10,12,14,46,59,-13,42
Forfar,3665,8,10,6,20,39,65,-26,36
Albion,3665,9,8,6,22,59,87,-28,30
Queen's Park,3665,10,6,10,20,39,74,-35,28
Ayr,3666,1,24,4,8,95,43,52,76
Raith,3666,2,22,8,6,68,33,35,74
Arbroath,3666,3,18,8,10,72,49,23,62
Alloa,3666,4,18,8,10,57,43,14,62
Stranraer,3666,5,15,6,15,57,66,-9,51
Airdrieon,3666,6,11,11,14,46,58,-12,44
East Fife,3666,7,13,4,19,49,66,-17,43
Forfar,3666,8,10,5,21,38,65,-27,35
Albion,3666,9,8,6,22,58,83,-25,30
Queen's Park,3666,10,6,10,20,40,74,-34,28
Ayr,3667,1,24,4,8,92,42,50,76
Raith,3667,2,22,9,5,70,34,36,75
Arbroath,3667,3,18,8,10,73,49,24,62
Alloa,3667,4,17,9,10,58,45,13,60
Stranraer,3667,5,15,5,16,55,65,-10,50
East Fife,3667,6,14,3,19,48,64,-16,45
Airdrieon,3667,7,10,11,15,46,60,-14,41
Forfar,3667,8,11,5,20,40,65,-25,38
Albion,3667,9,8,6,22,57,80,-23,30
Queen's Park,3667,10,6,10,20,40,75,-35,28
Ayr,3668,1,24,4,8,93,43,50,76
Raith,3668,2,22,9,5,69,33,36,75
Arbroath,3668,3,18,8,10,73,49,24,62
Alloa,3668,4,17,9,10,57,44,13,60
Stranraer,3668,5,16,5,15,58,65,-7,53
Airdrieon,3668,6,11,11,14,47,59,-12,44
East Fife,3668,7,13,3,20,48,67,-19,42
Forfar,3668,8,10,5,21,39,66,-27,35
Albion,3668,9,8,6,22,58,81,-23,30
Queen's Park,3668,10,6,10,20,40,75,-35,28
Raith,3669,1,23,8,5,70,32,38,77
Ayr,3669,2,24,4,8,92,42,50,76
Arbroath,3669,3,17,9,10,71,49,22,60
Alloa,3669,4,17,8,11,56,45,11,59
Stranraer,3669,5,15,5,16,55,66,-11,50
East Fife,3669,6,14,3,19,49,64,-15,45
Airdrieon,3669,7,11,11,14,50,59,-9,44
Forfar,3669,8,10,5,21,39,69,-30,35
Albion,3669,9,8,6,22,57,80,-23,30
Queen's Park,3669,10,6,11,19,40,73,-33,29
Ayr,3670,1,24,4,8,95,44,51,76
Raith,3670,2,22,8,6,70,35,35,74
Arbroath,3670,3,18,8,10,73,49,24,62
Alloa,3670,4,18,8,10,59,45,14,62
Stranraer,3670,5,15,6,15,56,65,-9,51
Airdrieon,3670,6,11,11,14,47,58,-11,44
East Fife,3670,7,13,4,19,48,65,-17,43
Forfar,3670,8,10,5,21,38,66,-28,35
Albion,3670,9,8,6,22,59,83,-24,30
Queen's Park,3670,10,6,10,20,40,75,-35,28
Raith,3671,1,23,8,5,69,32,37,77
Ayr,3671,2,24,4,8,96,43,53,76
Arbroath,3671,3,17,9,10,71,49,22,60
Alloa,3671,4,17,8,11,56,44,12,59
Stranraer,3671,5,15,5,16,55,67,-12,50
East Fife,3671,6,14,3,19,50,64,-14,45
Airdrieon,3671,7,11,11,14,47,58,-11,44
Forfar,3671,8,10,5,21,38,66,-28,35
Albion,3671,9,8,6,22,58,84,-26,30
Queen's Park,3671,10,6,11,19,40,73,-33,29
Raith,3672,1,23,8,5,69,32,37,77
Ayr,3672,2,24,4,8,96,45,51,76
Arbroath,3672,3,17,9,10,72,50,22,60
Alloa,3672,4,17,8,11,56,44,12,59
Stranraer,3672,5,15,5,16,55,65,-10,50
East Fife,3672,6,14,3,19,48,64,-16,45
Airdrieon,3672,7,10,12,14,46,59,-13,42
Forfar,3672,8,10,6,20,39,65,-26,36
Albion,3672,9,8,6,22,60,84,-24,30
Queen's Park,3672,10,6,11,19,41,74,-33,29
Raith,3673,1,23,8,5,70,33,37,77
Ayr,3673,2,24,4,8,92,43,49,76
Arbroath,3673,3,17,8,11,71,52,19,59
Alloa,3673,4,17,8,11,57,45,12,59
Stranraer,3673,5,15,6,15,56,65,-9,51
East Fife,3673,6,13,4,19,48,65,-17,43
Airdrieon,3673,7,10,12,14,48,61,-13,42
Forfar,3673,8,10,6,20,41,67,-26,36
Queen's Park,3673,9,7,10,19,43,73,-30,31
Albion,3673,10,8,6,22,58,80,-22,30
Raith,3674,1,23,8,5,69,32,37,77
Ayr,3674,2,24,4,8,92,42,50,76
Arbroath,3674,3,18,8,10,74,50,24,62
Alloa,3674,4,17,8,11,56,44,12,59
Stranraer,3674,5,15,5,16,55,67,-12,50
East Fife,3674,6,14,3,19,50,64,-14,45
Airdrieon,3674,7,11,11,14,48,60,-12,44
Forfar,3674,8,10,5,21,40,67,-27,35
Albion,3674,9,8,6,22,57,80,-23,30
Queen's Park,3674,10,6,10,20,41,76,-35,28
Ayr,3675,1,23,5,8,92,44,48,74
Raith,3675,2,22,8,6,68,33,35,74
Alloa,3675,3,18,8,10,57,43,14,62
Arbroath,3675,4,17,8,11,71,50,21,59
Stranraer,3675,5,15,5,16,55,65,-10,50
East Fife,3675,6,14,3,19,48,64,-16,45
Airdrieon,3675,7,11,11,14,48,60,-12,44
Forfar,3675,8,10,5,21,40,67,-27,35
Albion,3675,9,8,7,21,59,80,-21,31
Queen's Park,3675,10,7,10,19,41,73,-32,31
Raith,3676,1,23,8,5,71,33,38,77
Ayr,3676,2,24,4,8,96,46,50,76
Arbroath,3676,3,17,9,10,71,49,22,60
Alloa,3676,4,17,8,11,57,46,11,59
Stranraer,3676,5,15,6,15,56,65,-9,51
Airdrieon,3676,6,11,11,14,48,58,-10,44
East Fife,3676,7,13,4,19,48,65,-17,43
Forfar,3676,8,10,5,21,38,67,-29,35
Albion,3676,9,8,6,22,61,84,-23,30
Queen's Park,3676,10,6,11,19,40,73,-33,29
Raith,3677,1,23,8,5,69,32,37,77
Ayr,3677,2,24,4,8,93,43,50,76
Arbroath,3677,3,18,8,10,74,48,26,62
Alloa,3677,4,17,8,11,56,44,12,59
Stranraer,3677,5,15,5,16,55,68,-13,50
East Fife,3677,6,14,3,19,51,64,-13,45
Airdrieon,3677,7,10,12,14,45,58,-13,42
Forfar,3677,8,10,6,20,38,64,-26,36
Albion,3677,9,8,6,22,58,81,-23,30
Queen's Park,3677,10,6,10,20,39,76,-37,28
Raith,3678,1,23,8,5,69,32,37,77
Ayr,3678,2,23,4,9,90,43,47,73
Arbroath,3678,3,17,9,10,71,49,22,60
Alloa,3678,4,17,8,11,56,44,12,59
Stranraer,3678,5,15,5,16,55,67,-12,50
East Fife,3678,6,14,3,19,50,64,-14,45
Airdrieon,3678,7,11,11,14,46,58,-12,44
Forfar,3678,8,10,5,21,38,65,-27,35
Albion,3678,9,9,6,21,58,78,-20,33
Queen's Park,3678,10,6,11,19,40,73,-33,29
Raith,3679,1,23,8,5,71,32,39,77
Ayr,3679,2,24,4,8,94,43,51,76
Arbroath,3679,3,17,9,10,71,49,22,60
Alloa,3679,4,17,8,11,56,46,10,59
Stranraer,3679,5,16,5,15,57,64,-7,53
Airdrieon,3679,6,11,11,14,46,58,-12,44
East Fife,3679,7,13,3,20,47,66,-19,42
Forfar,3679,8,10,5,21,38,65,-27,35
Albion,3679,9,8,6,22,58,82,-24,30
Queen's Park,3679,10,6,11,19,40,73,-33,29
Raith,3680,1,23,8,5,71,33,38,77
Ayr,3680,2,24,4,8,98,42,56,76
Arbroath,3680,3,18,8,10,72,48,24,62
Alloa,3680,4,17,8,11,57,46,11,59
Stranraer,3680,5,15,6,15,57,66,-9,51
Airdrieon,3680,6,11,11,14,47,59,-12,44
East Fife,3680,7,13,4,19,49,66,-17,43
Forfar,3680,8,10,5,21,39,66,-27,35
Albion,3680,9,8,6,22,57,86,-29,30
Queen's Park,3680,10,6,10,20,39,74,-35,28
Ayr,3681,1,24,4,8,96,43,53,76
Raith,3681,2,22,9,5,69,33,36,75
Arbroath,3681,3,18,8,10,71,48,23,62
Alloa,3681,4,17,9,10,57,44,13,60
Stranraer,3681,5,16,5,15,58,65,-7,53
Airdrieon,3681,6,10,12,14,46,59,-13,42
East Fife,3681,7,13,3,20,48,67,-19,42
Forfar,3681,8,10,6,20,39,65,-26,36
Albion,3681,9,8,6,22,58,84,-26,30
Queen's Park,3681,10,6,10,20,39,73,-34,28
Ayr,3682,1,24,4,8,93,42,51,76
Raith,3682,2,22,9,5,68,32,36,75
Arbroath,3682,3,18,8,10,74,50,24,62
Alloa,3682,4,17,9,10,56,43,13,60
Stranraer,3682,5,15,5,16,56,66,-10,50
East Fife,3682,6,14,3,19,49,65,-16,45
Airdrieon,3682,7,10,11,15,46,61,-15,41
Forfar,3682,8,11,5,20,41,65,-24,38
Albion,3682,9,8,6,22,57,81,-24,30
Queen's Park,3682,10,6,10,20,41,76,-35,28
Raith,3683,1,23,8,5,70,33,37,77
Ayr,3683,2,24,4,8,97,46,51,76
Arbroath,3683,3,17,9,10,71,49,22,60
Alloa,3683,4,17,8,11,57,45,12,59
Stranraer,3683,5,15,5,16,57,67,-10,50
East Fife,3683,6,14,3,19,50,66,-16,45
Airdrieon,3683,7,11,11,14,47,59,-12,44
Forfar,3683,8,10,5,21,39,66,-27,35
Albion,3683,9,8,6,22,61,85,-24,30
Queen's Park,3683,10,6,11,19,40,73,-33,29
Raith,3684,1,23,8,5,71,33,38,77
Ayr,3684,2,23,4,9,91,46,45,73
Arbroath,3684,3,18,8,10,72,48,24,62
Alloa,3684,4,17,8,11,57,46,11,59
Stranraer,3684,5,16,5,15,56,64,-8,53
East Fife,3684,6,13,3,20,47,65,-18,42
Airdrieon,3684,7,10,11,15,45,60,-15,41
Forfar,3684,8,11,5,20,40,64,-24,38
Albion,3684,9,9,6,21,61,79,-18,33
Queen's Park,3684,10,6,10,20,39,74,-35,28
Raith,3685,1,23,8,5,69,32,37,77
Ayr,3685,2,24,4,8,93,44,49,76
Arbroath,3685,3,18,8,10,71,48,23,62
Alloa,3685,4,17,8,11,56,44,12,59
Stranraer,3685,5,16,5,15,58,64,-6,53
East Fife,3685,6,13,3,20,47,67,-20,42
Airdrieon,3685,7,10,11,15,46,61,-15,41
Forfar,3685,8,11,5,20,41,65,-24,38
Albion,3685,9,8,6,22,59,81,-22,30
Queen's Park,3685,10,6,10,20,39,73,-34,28
Raith,3686,1,23,8,5,71,32,39,77
Ayr,3686,2,24,4,8,96,43,53,76
Arbroath,3686,3,18,8,10,72,49,23,62
Alloa,3686,4,17,8,11,56,46,10,59
Stranraer,3686,5,15,5,16,56,66,-10,50
East Fife,3686,6,14,3,19,49,65,-16,45
Airdrieon,3686,7,11,11,14,49,59,-10,44
Forfar,3686,8,10,5,21,39,68,-29,35
Albion,3686,9,8,6,22,58,84,-26,30
Queen's Park,3686,10,6,10,20,40,74,-34,28
Ayr,3687,1,24,4,8,95,43,52,76
Raith,3687,2,22,9,5,68,32,36,75
Arbroath,3687,3,18,8,10,71,48,23,62
Alloa,3687,4,17,9,10,56,43,13,60
Stranraer,3687,5,16,5,15,57,64,-7,53
Airdrieon,3687,6,11,11,14,47,58,-11,44
East Fife,3687,7,13,3,20,47,66,-19,42
Forfar,3687,8,10,5,21,38,66,-28,35
Albion,3687,9,8,6,22,58,83,-25,30
Queen's Park,3687,10,6,10,20,39,73,-34,28
Raith,3688,1,22,9,5,69,33,36,75
Ayr,3688,2,23,4,9,92,46,46,73
Arbroath,3688,3,17,9,10,72,50,22,60
Alloa,3688,4,17,9,10,57,44,13,60
Stranraer,3688,5,15,5,16,55,66,-11,50
East Fife,3688,6,14,3,19,49,64,-15,45
Airdrieon,3688,7,10,11,15,45,61,-16,41
Forfar,3688,8,11,5,20,41,64,-23,38
Albion,3688,9,9,6,21,61,80,-19,33
Queen's Park,3688,10,6,11,19,41,74,-33,29
Ayr,3689,1,23,5,8,91,43,48,74
Raith,3689,2,22,8,6,68,34,34,74
Alloa,3689,3,18,8,10,58,43,15,62
Arbroath,3689,4,17,9,10,72,50,22,60
Stranraer,3689,5,15,6,15,57,66,-9,51
East Fife,3689,6,13,4,19,49,66,-17,43
Airdrieon,3689,7,10,12,14,46,59,-13,42
Forfar,3689,8,10,6,20,39,65,-26,36
Albion,3689,9,8,7,21,58,79,-21,31
Queen's Park,3689,10,6,11,19,41,74,-33,29
Ayr,3690,1,24,4,8,94,42,52,76
Raith,3690,2,22,9,5,69,33,36,75
Arbroath,3690,3,18,8,10,76,48,28,62
Alloa,3690,4,17,9,10,57,44,13,60
Stranraer,3690,5,15,5,16,56,66,-10,50
East Fife,3690,6,14,3,19,49,65,-16,45
Airdrieon,3690,7,10,12,14,47,60,-13,42
Forfar,3690,8,10,6,20,40,66,-26,36
Albion,3690,9,8,6,22,57,82,-25,30
Queen's Park,3690,10,6,10,20,39,78,-39,28
Raith,3691,1,23,8,5,71,33,38,77
Ayr,3691,2,24,4,8,95,44,51,76
Arbroath,3691,3,17,8,11,71,50,21,59
Alloa,3691,4,17,8,11,57,46,11,59
Stranraer,3691,5,15,5,16,55,68,-13,50
East Fife,3691,6,14,3,19,51,64,-13,45
Airdrieon,3691,7,11,11,14,47,58,-11,44
Forfar,3691,8,10,5,21,38,66,-28,35
Queen's Park,3691,9,7,10,19,41,73,-32,31
Albion,3691,10,8,6,22,59,83,-24,30
Raith,3692,1,23,8,5,70,32,38,77
Ayr,3692,2,23,4,9,92,45,47,73
Arbroath,3692,3,18,8,10,72,49,23,62
Alloa,3692,4,17,8,11,56,45,11,59
Stranraer,3692,5,15,5,16,56,67,-11,50
East Fife,3692,6,14,3,19,50,65,-15,45
Airdrieon,3692,7,11,11,14,47,58,-11,44
Forfar,3692,8,10,5,21,38,66,-28,35
Albion,3692,9,9,6,21,60,80,-20,33
Queen's Park,3692,10,6,10,20,40,74,-34,28
Ayr,3693,1,24,4,8,92,43,49,76
Raith,3693,2,22,9,5,68,32,36,75
Arbroath,3693,3,17,9,10,71,49,22,60
Alloa,3693,4,17,9,10,56,43,13,60
Stranraer,3693,5,16,5,15,57,64,-7,53
Airdrieon,3693,6,10,12,14,46,59,-13,42
East Fife,3693,7,13,3,20,47,66,-19,42
Forfar,3693,8,10,6,20,39,65,-26,36
Albion,3693,9,8,6,22,58,80,-22,30
Queen's Park,3693,10,6,11,19,40,73,-33,29
Raith,3694,1,23,8,5,69,32,37,77
Ayr,3694,2,23,4,9,90,45,45,73
Arbroath,3694,3,18,8,10,73,50,23,62
Alloa,3694,4,17,8,11,56,44,12,59
Stranraer,3694,5,15,6,15,56,65,-9,51
Airdrieon,3694,6,11,11,14,47,58,-11,44
East Fife,3694,7,13,4,19,48,65,-17,43
Forfar,3694,8,10,5,21,38,66,-28,35
Albion,3694,9,9,6,21,60,78,-18,33
Queen's Park,3694,10,6,10,20,41,75,-34,28
Raith,3695,1,23,8,5,71,32,39,77
Ayr,3695,2,24,4,8,93,43,50,76
Arbroath,3695,3,17,8,11,70,50,20,59
Alloa,3695,4,17,8,11,56,46,10,59
Stranraer,3695,5,15,5,16,56,68,-12,50
East Fife,3695,6,14,3,19,51,65,-14,45
Airdrieon,3695,7,11,11,14,48,60,-12,44
Forfar,3695,8,10,5,21,40,67,-27,35
Queen's Park,3695,9,7,10,19,41,72,-31,31
Albion,3695,10,8,6,22,58,81,-23,30
Raith,3696,1,23,8,5,71,32,39,77
Ayr,3696,2,23,4,9,91,44,47,73
Arbroath,3696,3,18,8,10,73,50,23,62
Alloa,3696,4,17,8,11,56,46,10,59
Stranraer,3696,5,16,5,15,58,65,-7,53
Airdrieon,3696,6,11,11,14,46,58,-12,44
East Fife,3696,7,13,3,20,48,67,-19,42
Forfar,3696,8,10,5,21,38,65,-27,35
Albion,3696,9,9,6,21,59,79,-20,33
Queen's Park,3696,10,6,10,20,41,75,-34,28
Raith,3697,1,22,9,5,69,33,36,75
Ayr,3697,2,23,5,8,91,43,48,74
Arbroath,3697,3,17,9,10,73,51,22,60
Alloa,3697,4,17,9,10,57,44,13,60
Stranraer,3697,5,15,5,16,57,67,-10,50
East Fife,3697,6,14,3,19,50,66,-16,45
Airdrieon,3697,7,11,11,14,48,60,-12,44
Forfar,3697,8,10,5,21,40,67,-27,35
Albion,3697,9,8,7,21,58,79,-21,31
Queen's Park,3697,10,6,11,19,42,75,-33,29
Raith,3698,1,23,8,5,70,32,38,77
Ayr,3698,2,24,4,8,94,45,49,76
Arbroath,3698,3,17,8,11,71,51,20,59
Alloa,3698,4,17,8,11,56,45,11,59
Stranraer,3698,5,16,5,15,57,65,-8,53
Airdrieon,3698,6,11,11,14,46,58,-12,44
East Fife,3698,7,13,3,20,48,66,-18,42
Forfar,3698,8,10,5,21,38,65,-27,35
Queen's Park,3698,9,7,10,19,42,73,-31,31
Albion,3698,10,8,6,22,60,82,-22,30
Raith,3699,1,23,8,5,69,32,37,77
Ayr,3699,2,24,4,8,92,42,50,76
Arbroath,3699,3,17,9,10,71,49,22,60
Alloa,3699,4,17,8,11,56,44,12,59
Stranraer,3699,5,16,5,15,56,64,-8,53
Airdrieon,3699,6,10,12,14,46,59,-13,42
East Fife,3699,7,13,3,20,47,65,-18,42
Forfar,3699,8,10,6,20,39,65,-26,36
Albion,3699,9,8,6,22,57,80,-23,30
Queen's Park,3699,10,6,11,19,40,73,-33,29
Raith,3700,1,23,8,5,69,32,37,77
Ayr,3700,2,23,5,8,91,43,48,74
Arbroath,3700,3,18,8,10,73,49,24,62
Alloa,3700,4,17,8,11,56,44,12,59
Stranraer,3700,5,15,5,16,55,65,-10,50
East Fife,3700,6,14,3,19,48,64,-16,45
Airdrieon,3700,7,11,11,14,47,59,-12,44
Forfar,3700,8,10,5,21,39,66,-27,35
Albion,3700,9,8,7,21,58,79,-21,31
Queen's Park,3700,10,6,10,20,40,75,-35,28
Ayr,3701,1,24,4,8,93,43,50,76
Raith,3701,2,22,8,6,68,33,35,74
Alloa,3701,3,18,8,10,57,43,14,62
Arbroath,3701,4,17,8,11,70,52,18,59
Stranraer,3701,5,15,5,16,56,67,-11,50
East Fife,3701,6,14,3,19,50,65,-15,45
Airdrieon,3701,7,11,11,14,49,58,-9,44
Forfar,3701,8,10,5,21,38,68,-30,35
Queen's Park,3701,9,7,10,19,43,72,-29,31
Albion,3701,10,8,6,22,58,81,-23,30
Ayr,3702,1,24,4,8,94,42,52,76
Raith,3702,2,22,9,5,69,33,36,75
Alloa,3702,3,17,9,10,57,44,13,60
Arbroath,3702,4,17,8,11,72,51,21,59
Stranraer,3702,5,15,5,16,55,65,-10,50
East Fife,3702,6,14,3,19,48,64,-16,45
Airdrieon,3702,7,10,12,14,45,58,-13,42
Forfar,3702,8,10,6,20,38,64,-26,36
Queen's Park,3702,9,7,10,19,42,74,-32,31
Albion,3702,10,8,6,22,57,82,-25,30
Raith,3703,1,23,8,5,71,33,38,77
Ayr,3703,2,24,4,8,94,43,51,76
Arbroath,3703,3,17,8,11,71,50,21,59
Alloa,3703,4,17,8,11,57,46,11,59
Stranraer,3703,5,15,5,16,55,66,-11,50
East Fife,3703,6,14,3,19,49,64,-15,45
Airdrieon,3703,7,10,11,15,46,62,-16,41
Forfar,3703,8,11,5,20,42,65,-23,38
Queen's Park,3703,9,7,10,19,41,73,-32,31
Albion,3703,10,8,6,22,58,82,-24,30
Ayr,3704,1,24,4,8,96,46,50,76
Raith,3704,2,22,9,5,69,33,36,75
Alloa,3704,3,17,9,10,57,44,13,60
Arbroath,3704,4,17,8,11,72,51,21,59
Stranraer,3704,5,15,6,15,56,65,-9,51
Airdrieon,3704,6,11,11,14,47,58,-11,44
East Fife,3704,7,13,4,19,48,65,-17,43
Forfar,3704,8,10,5,21,38,66,-28,35
Queen's Park,3704,9,7,10,19,42,74,-32,31
Albion,3704,10,8,6,22,61,84,-23,30
Ayr,3705,1,24,4,8,95,42,53,76
Raith,3705,2,22,9,5,69,33,36,75
Arbroath,3705,3,18,8,10,73,49,24,62
Alloa,3705,4,17,9,10,57,44,13,60
Stranraer,3705,5,15,5,16,56,66,-10,50
East Fife,3705,6,14,3,19,49,65,-16,45
Airdrieon,3705,7,11,11,14,46,58,-12,44
Forfar,3705,8,10,5,21,38,65,-27,35
Albion,3705,9,8,6,22,57,83,-26,30
Queen's Park,3705,10,6,10,20,40,75,-35,28
Raith,3706,1,23,8,5,70,33,37,77
Ayr,3706,2,23,5,8,91,43,48,74
Arbroath,3706,3,17,9,10,72,50,22,60
Alloa,3706,4,17,8,11,57,45,12,59
Stranraer,3706,5,16,5,15,58,66,-8,53
Airdrieon,3706,6,11,11,14,47,58,-11,44
East Fife,3706,7,13,3,20,49,67,-18,42
Forfar,3706,8,10,5,21,38,66,-28,35
Albion,3706,9,8,7,21,58,79,-21,31
Queen's Park,3706,10,6,11,19,41,74,-33,29
Ayr,3707,1,24,4,8,93,43,50,76
Raith,3707,2,22,9,5,69,33,36,75
Arbroath,3707,3,17,9,10,72,50,22,60
Alloa,3707,4,17,9,10,57,44,13,60
Stranraer,3707,5,15,5,16,55,67,-12,50
East Fife,3707,6,14,3,19,50,64,-14,45
Airdrieon,3707,7,10,11,15,46,60,-14,41
Forfar,3707,8,11,5,20,40,65,-25,38
Albion,3707,9,8,6,22,58,81,-23,30
Queen's Park,3707,10,6,11,19,41,74,-33,29
Raith,3708,1,23,8,5,71,32,39,77
Ayr,3708,2,24,4,8,96,42,54,76
Arbroath,3708,3,18,8,10,72,49,23,62
Alloa,3708,4,17,8,11,56,46,10,59
Stranraer,3708,5,15,5,16,56,66,-10,50
East Fife,3708,6,14,3,19,49,65,-16,45
Airdrieon,3708,7,11,11,14,48,59,-11,44
Forfar,3708,8,10,5,21,39,67,-28,35
Albion,3708,9,8,6,22,57,84,-27,30
Queen's Park,3708,10,6,10,20,40,74,-34,28
Raith,3709,1,23,8,5,71,32,39,77
Ayr,3709,2,24,4,8,96,44,52,76
Arbroath,3709,3,17,9,10,70,48,22,60
Alloa,3709,4,17,8,11,56,46,10,59
Stranraer,3709,5,15,5,16,55,66,-11,50
East Fife,3709,6,14,3,19,49,64,-15,45
Airdrieon,3709,7,11,11,14,47,58,-11,44
Forfar,3709,8,10,5,21,38,66,-28,35
Albion,3709,9,8,6,22,59,84,-25,30
Queen's Park,3709,10,6,11,19,39,72,-33,29
Raith,3710,1,23,8,5,70,33,37,77
Ayr,3710,2,24,4,8,93,42,51,76
Arbroath,3710,3,17,8,11,70,49,21,59
Alloa,3710,4,17,8,11,57,45,12,59
Stranraer,3710,5,16,5,15,57,65,-8,53
Airdrieon,3710,6,11,11,14,46,58,-12,44
East Fife,3710,7,13,3,20,48,66,-18,42
Forfar,3710,8,10,5,21,38,65,-27,35
Queen's Park,3710,9,7,10,19,40,72,-32,31
Albion,3710,10,8,6,22,57,81,-24,30
Raith,3711,1,23,8,5,69,32,37,77
Ayr,3711,2,24,4,8,94,42,52,76
Arbroath,3711,3,17,9,10,71,49,22,60
Alloa,3711,4,17,8,11,56,44,12,59
Stranraer,3711,5,15,5,16,56,66,-10,50
East Fife,3711,6,14,3,19,49,65,-16,45
Airdrieon,3711,7,10,11,15,45,59,-14,41
Forfar,3711,8,11,5,20,39,64,-25,38
Albion,3711,9,8,6,22,57,82,-25,30
Queen's Park,3711,10,6,11,19,40,73,-33,29
Raith,3712,1,23,8,5,70,33,37,77
Ayr,3712,2,24,4,8,96,44,52,76
Arbroath,3712,3,17,8,11,71,52,19,59
Alloa,3712,4,17,8,11,57,45,12,59
Stranraer,3712,5,15,5,16,57,67,-10,50
East Fife,3712,6,14,3,19,50,66,-16,45
Airdrieon,3712,7,10,11,15,46,60,-14,41
Forfar,3712,8,11,5,20,40,65,-25,38
Queen's Park,3712,9,7,10,19,43,73,-30,31
Albion,3712,10,8,6,22,59,84,-25,30
Raith,3713,1,23,8,5,69,32,37,77
Ayr,3713,2,24,4,8,94,45,49,76
Arbroath,3713,3,17,9,10,70,48,22,60
Alloa,3713,4,17,8,11,56,44,12,59
Stranraer,3713,5,16,5,15,56,64,-8,53
Airdrieon,3713,6,11,11,14,46,58,-12,44
East Fife,3713,7,13,3,20,47,65,-18,42
Forfar,3713,8,10,5,21,38,65,-27,35
Albion,3713,9,8,6,22,60,82,-22,30
Queen's Park,3713,10,6,11,19,39,72,-33,29
Raith,3714,1,23,8,5,70,33,37,77
Ayr,3714,2,23,5,8,92,44,48,74
Arbroath,3714,3,18,8,10,72,48,24,62
Alloa,3714,4,17,8,11,57,45,12,59
Stranraer,3714,5,15,6,15,56,65,-9,51
East Fife,3714,6,13,4,19,48,65,-17,43
Airdrieon,3714,7,10,12,14,45,58,-13,42
Forfar,3714,8,10,6,20,38,64,-26,36
Albion,3714,9,8,7,21,59,80,-21,31
Queen's Park,3714,10,6,10,20,39,74,-35,28
Ayr,3715,1,23,5,8,91,43,48,74
Raith,3715,2,22,8,6,68,33,35,74
Arbroath,3715,3,18,8,10,71,48,23,62
Alloa,3715,4,18,8,10,57,43,14,62
Stranraer,3715,5,15,5,16,56,66,-10,50
East Fife,3715,6,14,3,19,49,65,-16,45
Airdrieon,3715,7,10,11,15,47,61,-14,41
Forfar,3715,8,11,5,20,41,66,-25,38
Albion,3715,9,8,7,21,58,79,-21,31
Queen's Park,3715,10,6,10,20,39,73,-34,28
Ayr,3716,1,24,4,8,91,42,49,76
Raith,3716,2,22,9,5,69,33,36,75
Arbroath,3716,3,17,9,10,73,51,22,60
Alloa,3716,4,17,9,10,57,44,13,60
Stranraer,3716,5,15,6,15,55,64,-9,51
Airdrieon,3716,6,11,11,14,48,59,-11,44
East Fife,3716,7,13,4,19,47,64,-17,43
Forfar,3716,8,10,5,21,39,67,-28,35
Albion,3716,9,8,6,22,57,79,-22,30
Queen's Park,3716,10,6,11,19,42,75,-33,29
Raith,3717,1,23,8,5,69,32,37,77
Ayr,3717,2,24,4,8,93,44,49,76
Arbroath,3717,3,17,9,10,71,49,22,60
Alloa,3717,4,17,8,11,56,44,12,59
Stranraer,3717,5,15,6,15,56,65,-9,51
East Fife,3717,6,13,4,19,48,65,-17,43
Airdrieon,3717,7,10,12,14,46,59,-13,42
Forfar,3717,8,10,6,20,39,65,-26,36
Albion,3717,9,8,6,22,59,81,-22,30
Queen's Park,3717,10,6,11,19,40,73,-33,29
Raith,3718,1,23,8,5,72,32,40,77
Ayr,3718,2,24,4,8,95,43,52,76
Arbroath,3718,3,17,8,11,71,52,19,59
Alloa,3718,4,17,8,11,56,47,9,59
Stranraer,3718,5,15,5,16,55,65,-10,50
East Fife,3718,6,14,3,19,48,64,-16,45
Airdrieon,3718,7,10,12,14,46,59,-13,42
Forfar,3718,8,10,6,20,39,65,-26,36
Queen's Park,3718,9,7,10,19,43,73,-30,31
Albion,3718,10,8,6,22,58,83,-25,30
Raith,3719,1,23,8,5,70,32,38,77
Ayr,3719,2,24,4,8,96,42,54,76
Arbroath,3719,3,17,9,10,73,51,22,60
Alloa,3719,4,17,8,11,56,45,11,59
Stranraer,3719,5,16,5,15,58,64,-6,53
Airdrieon,3719,6,11,11,14,47,59,-12,44
East Fife,3719,7,13,3,20,47,67,-20,42
Forfar,3719,8,10,5,21,39,66,-27,35
Albion,3719,9,8,6,22,57,84,-27,30
Queen's Park,3719,10,6,11,19,42,75,-33,29
Raith,3720,1,22,8,6,69,36,33,74
Ayr,3720,2,23,4,9,92,45,47,73
Arbroath,3720,3,18,8,10,74,49,25,62
Alloa,3720,4,18,8,10,60,44,16,62
Stranraer,3720,5,15,5,16,55,65,-10,50
East Fife,3720,6,14,3,19,48,64,-16,45
Airdrieon,3720,7,10,11,15,45,60,-15,41
Forfar,3720,8,11,5,20,40,64,-24,38
Albion,3720,9,9,6,21,60,80,-20,33
Queen's Park,3720,10,6,10,20,40,76,-36,28
Raith,3721,1,23,8,5,72,32,40,77
Ayr,3721,2,23,4,9,93,47,46,73
Arbroath,3721,3,17,8,11,71,50,21,59
Alloa,3721,4,17,8,11,56,47,9,59
Stranraer,3721,5,15,5,16,55,67,-12,50
East Fife,3721,6,14,3,19,50,64,-14,45
Airdrieon,3721,7,11,11,14,47,58,-11,44
Forfar,3721,8,10,5,21,38,66,-28,35
Albion,3721,9,9,6,21,62,81,-19,33
Queen's Park,3721,10,7,10,19,41,73,-32,31
Raith,3722,1,23,8,5,69,32,37,77
Ayr,3722,2,23,5,8,91,43,48,74
Arbroath,3722,3,17,9,10,71,49,22,60
Alloa,3722,4,17,8,11,56,44,12,59
Stranraer,3722,5,15,5,16,56,66,-10,50
East Fife,3722,6,14,3,19,49,65,-16,45
Airdrieon,3722,7,11,11,14,46,58,-12,44
Forfar,3722,8,10,5,21,38,65,-27,35
Albion,3722,9,8,7,21,58,79,-21,31
Queen's Park,3722,10,6,11,19,40,73,-33,29
Raith,3723,1,23,8,5,69,32,37,77
Ayr,3723,2,23,5,8,91,43,48,74
Arbroath,3723,3,18,8,10,72,49,23,62
Alloa,3723,4,17,8,11,56,44,12,59
Stranraer,3723,5,16,5,15,59,66,-7,53
Airdrieon,3723,6,10,12,14,48,61,-13,42
East Fife,3723,7,13,3,20,49,68,-19,42
Forfar,3723,8,10,6,20,41,67,-26,36
Albion,3723,9,8,7,21,58,79,-21,31
Queen's Park,3723,10,6,10,20,40,74,-34,28
Ayr,3724,1,24,4,8,95,42,53,76
Raith,3724,2,22,8,6,69,34,35,74
Alloa,3724,3,18,8,10,58,44,14,62
Arbroath,3724,4,17,8,11,73,52,21,59
Stranraer,3724,5,15,5,16,56,67,-11,50
East Fife,3724,6,14,3,19,50,65,-15,45
Airdrieon,3724,7,11,11,14,50,61,-11,44
Forfar,3724,8,10,5,21,41,69,-28,35
Queen's Park,3724,9,7,10,19,43,75,-32,31
Albion,3724,10,8,6,22,57,83,-26,30
Ayr,3725,1,24,4,8,94,42,52,76
Raith,3725,2,22,9,5,70,34,36,75
Arbroath,3725,3,18,8,10,75,48,27,62
Alloa,3725,4,17,9,10,58,45,13,60
Stranraer,3725,5,15,5,16,55,65,-10,50
East Fife,3725,6,14,3,19,48,64,-16,45
Airdrieon,3725,7,11,11,14,46,58,-12,44
Forfar,3725,8,10,5,21,38,65,-27,35
Albion,3725,9,8,6,22,57,82,-25,30
Queen's Park,3725,10,6,10,20,39,77,-38,28
Raith,3726,1,23,8,5,72,32,40,77
Ayr,3726,2,24,4,8,95,43,52,76
Arbroath,3726,3,18,8,10,72,49,23,62
Alloa,3726,4,17,8,11,56,47,9,59
Stranraer,3726,5,15,6,15,56,65,-9,51
East Fife,3726,6,13,4,19,48,65,-17,43
Airdrieon,3726,7,10,12,14,45,58,-13,42
Forfar,3726,8,10,6,20,38,64,-26,36
Albion,3726,9,8,6,22,58,83,-25,30
Queen's Park,3726,10,6,10,20,40,74,-34,28
Ayr,3727,1,24,4,8,95,42,53,76
Raith,3727,2,22,9,5,68,32,36,75
Alloa,3727,3,17,9,10,56,43,13,60
Arbroath,3727,4,17,8,11,71,50,21,59
Stranraer,3727,5,16,5,15,61,65,-4,53
East Fife,3727,6,13,3,20,48,70,-22,42
Airdrieon,3727,7,10,11,15,45,60,-15,41
Forfar,3727,8,11,5,20,40,64,-24,38
Queen's Park,3727,9,7,10,19,41,73,-32,31
Albion,3727,10,8,6,22,57,83,-26,30
Raith,3728,1,23,8,5,70,32,38,77
Ayr,3728,2,24,4,8,92,43,49,76
Arbroath,3728,3,18,8,10,73,49,24,62
Alloa,3728,4,17,8,11,56,45,11,59
Stranraer,3728,5,16,5,15,57,64,-7,53
Airdrieon,3728,6,11,11,14,48,59,-11,44
East Fife,3728,7,13,3,20,47,66,-19,42
Forfar,3728,8,10,5,21,39,67,-28,35
Albion,3728,9,8,6,22,58,80,-22,30
Queen's Park,3728,10,6,10,20,40,75,-35,28
Raith,3729,1,23,8,5,71,32,39,77
Ayr,3729,2,24,4,8,95,43,52,76
Arbroath,3729,3,18,8,10,73,48,25,62
Alloa,3729,4,17,8,11,56,46,10,59
Stranraer,3729,5,15,5,16,55,65,-10,50
East Fife,3729,6,14,3,19,48,64,-16,45
Airdrieon,3729,7,10,11,15,45,60,-15,41
Forfar,3729,8,11,5,20,40,64,-24,38
Albion,3729,9,8,6,22,58,83,-25,30
Queen's Park,3729,10,6,10,20,39,75,-36,28
Raith,3730,1,23,8,5,70,32,38,77
Ayr,3730,2,23,4,9,91,44,47,73
Arbroath,3730,3,17,8,11,70,51,19,59
Alloa,3730,4,17,8,11,56,45,11,59
Stranraer,3730,5,15,5,16,55,65,-10,50
East Fife,3730,6,14,3,19,48,64,-16,45
Airdrieon,3730,7,10,11,15,45,59,-14,41
Forfar,3730,8,11,5,20,39,64,-25,38
Albion,3730,9,9,6,21,59,79,-20,33
Queen's Park,3730,10,7,10,19,42,72,-30,31
Raith,3731,1,23,8,5,71,32,39,77
Ayr,3731,2,23,4,9,91,45,46,73
Arbroath,3731,3,18,8,10,73,49,24,62
Alloa,3731,4,17,8,11,56,46,10,59
Stranraer,3731,5,16,5,15,56,64,-8,53
East Fife,3731,6,13,3,20,47,65,-18,42
Airdrieon,3731,7,10,11,15,46,60,-14,41
Forfar,3731,8,11,5,20,40,65,-25,38
Albion,3731,9,9,6,21,60,79,-19,33
Queen's Park,3731,10,6,10,20,40,75,-35,28
Raith,3732,1,23,8,5,71,32,39,77
Ayr,3732,2,24,4,8,93,44,49,76
Arbroath,3732,3,17,9,10,72,50,22,60
Alloa,3732,4,17,8,11,56,46,10,59
Stranraer,3732,5,15,5,16,55,65,-10,50
East Fife,3732,6,14,3,19,48,64,-16,45
Airdrieon,3732,7,11,11,14,47,59,-12,44
Forfar,3732,8,10,5,21,39,66,-27,35
Albion,3732,9,8,6,22,59,81,-22,30
Queen's Park,3732,10,6,11,19,41,74,-33,29
Raith,3733,1,23,8,5,69,32,37,77
Ayr,3733,2,23,4,9,92,45,47,73
Arbroath,3733,3,18,8,10,76,49,27,62
Alloa,3733,4,17,8,11,56,44,12,59
Stranraer,3733,5,15,6,15,56,65,-9,51
East Fife,3733,6,13,4,19,48,65,-17,43
Airdrieon,3733,7,10,12,14,46,59,-13,42
Forfar,3733,8,10,6,20,39,65,-26,36
Albion,3733,9,9,6,21,60,80,-20,33
Queen's Park,3733,10,6,10,20,40,78,-38,28
Ayr,3734,1,24,4,8,92,42,50,76
Raith,3734,2,22,9,5,69,33,36,75
Arbroath,3734,3,18,8,10,74,50,24,62
Alloa,3734,4,17,9,10,57,44,13,60
Stranraer,3734,5,15,5,16,56,68,-12,50
East Fife,3734,6,14,3,19,51,65,-14,45
Airdrieon,3734,7,11,11,14,47,58,-11,44
Forfar,3734,8,10,5,21,38,66,-28,35
Albion,3734,9,8,6,22,57,80,-23,30
Queen's Park,3734,10,6,10,20,41,76,-35,28
Raith,3735,1,23,8,5,71,32,39,77
Ayr,3735,2,24,4,8,94,42,52,76
Arbroath,3735,3,17,9,10,71,49,22,60
Alloa,3735,4,17,8,11,56,46,10,59
Stranraer,3735,5,15,5,16,55,65,-10,50
East Fife,3735,6,14,3,19,48,64,-16,45
Airdrieon,3735,7,11,11,14,46,58,-12,44
Forfar,3735,8,10,5,21,38,65,-27,35
Albion,3735,9,8,6,22,57,82,-25,30
Queen's Park,3735,10,6,11,19,40,73,-33,29
Raith,3736,1,23,8,5,69,32,37,77
Ayr,3736,2,24,4,8,92,43,49,76
Arbroath,3736,3,18,8,10,72,48,24,62
Alloa,3736,4,17,8,11,56,44,12,59
Stranraer,3736,5,15,6,15,56,65,-9,51
East Fife,3736,6,13,4,19,48,65,-17,43
Airdrieon,3736,7,10,12,14,45,58,-13,42
Forfar,3736,8,10,6,20,38,64,-26,36
Albion,3736,9,8,6,22,58,80,-22,30
Queen's Park,3736,10,6,10,20,39,74,-35,28
Raith,3737,1,23,8,5,70,33,37,77
Ayr,3737,2,24,4,8,93,43,50,76
Arbroath,3737,3,18,8,10,73,49,24,62
Alloa,3737,4,17,8,11,57,45,12,59
Stranraer,3737,5,15,5,16,55,67,-12,50
East Fife,3737,6,14,3,19,50,64,-14,45
Airdrieon,3737,7,10,12,14,46,59,-13,42
Forfar,3737,8,10,6,20,39,65,-26,36
Albion,3737,9,8,6,22,58,81,-23,30
Queen's Park,3737,10,6,10,20,40,75,-35,28
Raith,3738,1,23,8,5,70,33,37,77
Ayr,3738,2,24,4,8,96,43,53,76
Arbroath,3738,3,18,8,10,72,48,24,62
Alloa,3738,4,17,8,11,57,45,12,59
Stranraer,3738,5,15,5,16,56,66,-10,50
East Fife,3738,6,14,3,19,49,65,-16,45
Airdrieon,3738,7,10,11,15,46,60,-14,41
Forfar,3738,8,11,5,20,40,65,-25,38
Albion,3738,9,8,6,22,58,84,-26,30
Queen's Park,3738,10,6,10,20,39,74,-35,28
Ayr,3739,1,24,4,8,94,43,51,76
Raith,3739,2,22,8,6,68,34,34,74
Alloa,3739,3,18,8,10,58,43,15,62
Arbroath,3739,4,17,9,10,71,49,22,60
Stranraer,3739,5,16,5,15,58,66,-8,53
Airdrieon,3739,6,11,11,14,49,59,-10,44
East Fife,3739,7,13,3,20,49,67,-18,42
Forfar,3739,8,10,5,21,39,68,-29,35
Albion,3739,9,8,6,22,58,82,-24,30
Queen's Park,3739,10,6,11,19,40,73,-33,29
Raith,3740,1,23,8,5,70,32,38,77
Ayr,3740,2,24,4,8,94,43,51,76
Arbroath,3740,3,17,9,10,71,49,22,60
Alloa,3740,4,17,8,11,56,45,11,59
Stranraer,3740,5,16,5,15,59,67,-8,53
Airdrieon,3740,6,11,11,14,48,60,-12,44
East Fife,3740,7,13,3,20,50,68,-18,42
Forfar,3740,8,10,5,21,40,67,-27,35
Albion,3740,9,8,6,22,58,82,-24,30
Queen's Park,3740,10,6,11,19,40,73,-33,29
Ayr,3741,1,24,4,8,95,44,51,76
Raith,3741,2,22,9,5,71,35,36,75
Alloa,3741,3,17,9,10,59,46,13,60
Arbroath,3741,4,17,8,11,71,50,21,59
Stranraer,3741,5,15,5,16,55,66,-11,50
East Fife,3741,6,14,3,19,49,64,-15,45
Airdrieon,3741,7,11,11,14,47,59,-12,44
Forfar,3741,8,10,5,21,39,66,-27,35
Queen's Park,3741,9,7,10,19,41,73,-32,31
Albion,3741,10,8,6,22,59,83,-24,30
Ayr,3742,1,24,4,8,94,43,51,76
Raith,3742,2,22,9,5,68,32,36,75
Arbroath,3742,3,18,8,10,73,50,23,62
Alloa,3742,4,17,9,10,56,43,13,60
Stranraer,3742,5,15,5,16,56,67,-11,50
East Fife,3742,6,14,3,19,50,65,-15,45
Airdrieon,3742,7,10,12,14,46,59,-13,42
Forfar,3742,8,10,6,20,39,65,-26,36
Albion,3742,9,8,6,22,58,82,-24,30
Queen's Park,3742,10,6,10,20,41,75,-34,28
Raith,3743,1,23,8,5,70,32,38,77
Ayr,3743,2,24,4,8,93,43,50,76
Arbroath,3743,3,17,8,11,71,50,21,59
Alloa,3743,4,17,8,11,56,45,11,59
Stranraer,3743,5,15,5,16,55,66,-11,50
East Fife,3743,6,14,3,19,49,64,-15,45
Airdrieon,3743,7,11,11,14,47,58,-11,44
Forfar,3743,8,10,5,21,38,66,-28,35
Queen's Park,3743,9,7,10,19,41,73,-32,31
Albion,3743,10,8,6,22,58,81,-23,30
Raith,3744,1,23,8,5,71,32,39,77
Ayr,3744,2,24,4,8,97,42,55,76
Arbroath,3744,3,18,8,10,71,48,23,62
Alloa,3744,4,17,8,11,56,46,10,59
Stranraer,3744,5,15,5,16,56,67,-11,50
East Fife,3744,6,14,3,19,50,65,-15,45
Airdrieon,3744,7,11,11,14,46,58,-12,44
Forfar,3744,8,10,5,21,38,65,-27,35
Albion,3744,9,8,6,22,57,85,-28,30
Queen's Park,3744,10,6,10,20,39,73,-34,28
Raith,3745,1,22,9,5,69,33,36,75
Ayr,3745,2,23,4,9,93,46,47,73
Alloa,3745,3,17,9,10,57,44,13,60
Arbroath,3745,4,17,8,11,71,50,21,59
Stranraer,3745,5,15,5,16,56,66,-10,50
East Fife,3745,6,14,3,19,49,65,-16,45
Airdrieon,3745,7,11,11,14,47,58,-11,44
Forfar,3745,8,10,5,21,38,66,-28,35
Albion,3745,9,9,6,21,61,81,-20,33
Queen's Park,3745,10,7,10,19,41,73,-32,31
Raith,3746,1,22,9,5,69,33,36,75
Ayr,3746,2,23,5,8,93,45,48,74
Arbroath,3746,3,17,9,10,71,49,22,60
Alloa,3746,4,17,9,10,57,44,13,60
Stranraer,3746,5,15,5,16,55,67,-12,50
East Fife,3746,6,14,3,19,50,64,-14,45
Airdrieon,3746,7,10,12,14,46,59,-13,42
Forfar,3746,8,10,6,20,39,65,-26,36
Albion,3746,9,8,7,21,60,81,-21,31
Queen's Park,3746,10,6,11,19,40,73,-33,29
Ayr,3747,1,23,5,8,90,42,48,74
Raith,3747,2,22,8,6,68,33,35,74
Alloa,3747,3,18,8,10,57,43,14,62
Arbroath,3747,4,17,8,11,73,52,21,59
Stranraer,3747,5,15,5,16,56,66,-10,50
East Fife,3747,6,14,3,19,49,65,-16,45
Airdrieon,3747,7,11,11,14,47,59,-12,44
Forfar,3747,8,10,5,21,39,66,-27,35
Albion,3747,9,8,7,21,57,78,-21,31
Queen's Park,3747,10,7,10,19,43,75,-32,31
Ayr,3748,1,24,4,8,92,43,49,76
Raith,3748,2,22,9,5,68,32,36,75
Arbroath,3748,3,18,8,10,74,50,24,62
Alloa,3748,4,17,9,10,56,43,13,60
Stranraer,3748,5,15,6,15,56,65,-9,51
Airdrieon,3748,6,11,11,14,48,58,-10,44
East Fife,3748,7,13,4,19,48,65,-17,43
Forfar,3748,8,10,5,21,38,67,-29,35
Albion,3748,9,8,6,22,58,80,-22,30
Queen's Park,3748,10,6,10,20,41,76,-35,28
Ayr,3749,1,24,4,8,91,42,49,76
Raith,3749,2,22,9,5,69,33,36,75
Arbroath,3749,3,18,8,10,71,48,23,62
Alloa,3749,4,17,9,10,57,44,13,60
Stranraer,3749,5,16,5,15,58,65,-7,53
East Fife,3749,6,13,3,20,48,67,-19,42
Airdrieon,3749,7,10,11,15,45,59,-14,41
Forfar,3749,8,11,5,20,39,64,-25,38
Albion,3749,9,8,6,22,57,79,-22,30
Queen's Park,3749,10,6,10,20,39,73,-34,28
Raith,3750,1,23,8,5,70,32,38,77
Ayr,3750,2,24,4,8,96,43,53,76
Arbroath,3750,3,17,9,10,72,50,22,60
Alloa,3750,4,17,8,11,56,45,11,59
Stranraer,3750,5,15,5,16,56,67,-11,50
East Fife,3750,6,14,3,19,50,65,-15,45
Airdrieon,3750,7,11,11,14,47,59,-12,44
Forfar,3750,8,10,5,21,39,66,-27,35
Albion,3750,9,8,6,22,58,84,-26,30
Queen's Park,3750,10,6,11,19,41,74,-33,29
Ayr,3751,1,24,4,8,92,43,49,76
Raith,3751,2,22,8,6,68,33,35,74
Arbroath,3751,3,18,8,10,72,49,23,62
Alloa,3751,4,18,8,10,57,43,14,62
Stranraer,3751,5,16,5,15,57,64,-7,53
Airdrieon,3751,6,11,11,14,47,58,-11,44
East Fife,3751,7,13,3,20,47,66,-19,42
Forfar,3751,8,10,5,21,38,66,-28,35
Albion,3751,9,8,6,22,58,80,-22,30
Queen's Park,3751,10,6,10,20,40,74,-34,28
Raith,3752,1,23,8,5,73,33,40,77
Ayr,3752,2,24,4,8,92,43,49,76
Arbroath,3752,3,17,9,10,72,50,22,60
Alloa,3752,4,17,8,11,57,48,9,59
Stranraer,3752,5,16,5,15,57,65,-8,53
Airdrieon,3752,6,11,11,14,47,59,-12,44
East Fife,3752,7,13,3,20,48,66,-18,42
Forfar,3752,8,10,5,21,39,66,-27,35
Albion,3752,9,8,6,22,58,80,-22,30
Queen's Park,3752,10,6,11,19,41,74,-33,29
Raith,3753,1,23,8,5,71,32,39,77
Ayr,3753,2,24,4,8,93,42,51,76
Arbroath,3753,3,18,8,10,72,49,23,62
Alloa,3753,4,17,8,11,56,46,10,59
Stranraer,3753,5,15,5,16,55,65,-10,50
East Fife,3753,6,14,3,19,48,64,-16,45
Airdrieon,3753,7,10,11,15,46,60,-14,41
Forfar,3753,8,11,5,20,40,65,-25,38
Albion,3753,9,8,6,22,57,81,-24,30
Queen's Park,3753,10,6,10,20,40,74,-34,28
Raith,3754,1,22,9,5,69,33,36,75
Ayr,3754,2,23,4,9,90,45,45,73
Arbroath,3754,3,18,8,10,73,49,24,62
Alloa,3754,4,17,9,10,57,44,13,60
Stranraer,3754,5,15,6,15,57,66,-9,51
Airdrieon,3754,6,11,11,14,47,58,-11,44
East Fife,3754,7,13,4,19,49,66,-17,43
Forfar,3754,8,10,5,21,38,66,-28,35
Albion,3754,9,9,6,21,60,78,-18,33
Queen's Park,3754,10,6,10,20,40,75,-35,28
Raith,3755,1,23,8,5,71,33,38,77
Ayr,3755,2,24,4,8,96,43,53,76
Arbroath,3755,3,17,8,11,71,50,21,59
Alloa,3755,4,17,8,11,57,46,11,59
Stranraer,3755,5,16,5,15,59,66,-7,53
Airdrieon,3755,6,11,11,14,47,59,-12,44
East Fife,3755,7,13,3,20,49,68,-19,42
Forfar,3755,8,10,5,21,39,66,-27,35
Queen's Park,3755,9,7,10,19,41,73,-32,31
Albion,3755,10,8,6,22,58,84,-26,30
Raith,3756,1,23,8,5,73,32,41,77
Ayr,3756,2,24,4,8,93,42,51,76
Arbroath,3756,3,18,8,10,73,49,24,62
Alloa,3756,4,17,8,11,56,48,8,59
Stranraer,3756,5,15,5,16,55,65,-10,50
East Fife,3756,6,14,3,19,48,64,-16,45
Airdrieon,3756,7,10,12,14,45,58,-13,42
Forfar,3756,8,10,6,20,38,64,-26,36
Albion,3756,9,8,6,22,57,81,-24,30
Queen's Park,3756,10,6,10,20,40,75,-35,28
Raith,3757,1,23,8,5,69,32,37,77
Ayr,3757,2,24,4,8,93,43,50,76
Arbroath,3757,3,17,9,10,73,51,22,60
Alloa,3757,4,17,8,11,56,44,12,59
Stranraer,3757,5,16,5,15,59,64,-5,53
East Fife,3757,6,13,3,20,47,68,-21,42
Airdrieon,3757,7,10,11,15,46,61,-15,41
Forfar,3757,8,11,5,20,41,65,-24,38
Albion,3757,9,8,6,22,58,81,-23,30
Queen's Park,3757,10,6,11,19,42,75,-33,29
Ayr,3758,1,24,4,8,94,43,51,76
Raith,3758,2,22,8,6,70,35,35,74
Alloa,3758,3,18,8,10,59,45,14,62
Arbroath,3758,4,17,8,11,72,51,21,59
Stranraer,3758,5,15,6,15,56,65,-9,51
East Fife,3758,6,13,4,19,48,65,-17,43
Airdrieon,3758,7,10,11,15,47,61,-14,41
Forfar,3758,8,11,5,20,41,66,-25,38
Queen's Park,3758,9,7,10,19,42,74,-32,31
Albion,3758,10,8,6,22,58,82,-24,30
Raith,3759,1,23,8,5,71,34,37,77
Ayr,3759,2,24,4,8,95,45,50,76
Arbroath,3759,3,18,8,10,74,50,24,62
Alloa,3759,4,17,8,11,58,46,12,59
Stranraer,3759,5,16,5,15,60,65,-5,53
East Fife,3759,6,13,3,20,48,69,-21,42
Airdrieon,3759,7,10,11,15,45,59,-14,41
Forfar,3759,8,11,5,20,39,64,-25,38
Albion,3759,9,8,6,22,60,83,-23,30
Queen's Park,3759,10,6,10,20,41,76,-35,28
Raith,3760,1,23,8,5,70,33,37,77
Ayr,3760,2,24,4,8,95,42,53,76
Arbroath,3760,3,17,8,11,71,51,20,59
Alloa,3760,4,17,8,11,57,45,12,59
Stranraer,3760,5,15,5,16,55,65,-10,50
East Fife,3760,6,14,3,19,48,64,-16,45
Airdrieon,3760,7,10,11,15,45,59,-14,41
Forfar,3760,8,11,5,20,39,64,-25,38
Queen's Park,3760,9,7,10,19,42,73,-31,31
Albion,3760,10,8,6,22,57,83,-26,30
Raith,3761,1,23,8,5,71,32,39,77
Ayr,3761,2,24,4,8,95,44,51,76
Arbroath,3761,3,18,8,10,73,49,24,62
Alloa,3761,4,17,8,11,56,46,10,59
Stranraer,3761,5,16,5,15,56,64,-8,53
Airdrieon,3761,6,11,11,14,49,58,-9,44
East Fife,3761,7,13,3,20,47,65,-18,42
Forfar,3761,8,10,5,21,38,68,-30,35
Albion,3761,9,8,6,22,59,83,-24,30
Queen's Park,3761,10,6,10,20,40,75,-35,28
Raith,3762,1,22,9,5,68,32,36,75
Ayr,3762,2,23,4,9,92,45,47,73
Arbroath,3762,3,18,8,10,77,48,29,62
Alloa,3762,4,17,9,10,56,43,13,60
Stranraer,3762,5,15,5,16,57,67,-10,50
East Fife,3762,6,14,3,19,50,66,-16,45
Airdrieon,3762,7,10,11,15,45,60,-15,41
Forfar,3762,8,11,5,20,40,64,-24,38
Albion,3762,9,9,6,21,60,80,-20,33
Queen's Park,3762,10,6,10,20,39,79,-40,28
Raith,3763,1,23,8,5,74,33,41,77
Ayr,3763,2,23,4,9,92,45,47,73
Arbroath,3763,3,18,8,10,73,49,24,62
Alloa,3763,4,17,8,11,57,49,8,59
Stranraer,3763,5,15,5,16,56,66,-10,50
East Fife,3763,6,14,3,19,49,65,-16,45
Airdrieon,3763,7,11,11,14,47,59,-12,44
Forfar,3763,8,10,5,21,39,66,-27,35
Albion,3763,9,9,6,21,60,80,-20,33
Queen's Park,3763,10,6,10,20,40,75,-35,28
Raith,3764,1,23,8,5,69,32,37,77
Ayr,3764,2,23,4,9,91,45,46,73
Arbroath,3764,3,18,8,10,74,49,25,62
Alloa,3764,4,17,8,11,56,44,12,59
Stranraer,3764,5,15,6,15,56,65,-9,51
East Fife,3764,6,13,4,19,48,65,-17,43
Airdrieon,3764,7,10,11,15,45,60,-15,41
Forfar,3764,8,11,5,20,40,64,-24,38
Albion,3764,9,9,6,21,60,79,-19,33
Queen's Park,3764,10,6,10,20,40,76,-36,28
Ayr,3765,1,23,5,8,93,45,48,74
Raith,3765,2,22,8,6,68,35,33,74
Alloa,3765,3,18,8,10,59,43,16,62
Arbroath,3765,4,17,8,11,70,51,19,59
Stranraer,3765,5,15,6,15,59,68,-9,51
East Fife,3765,6,13,4,19,51,68,-17,43
Airdrieon,3765,7,10,11,15,47,63,-16,41
Forfar,3765,8,11,5,20,43,66,-23,38
Albion,3765,9,8,7,21,60,81,-21,31
Queen's Park,3765,10,7,10,19,42,72,-30,31
Ayr,3766,1,24,4,8,93,43,50,76
Raith,3766,2,22,9,5,69,33,36,75
Arbroath,3766,3,18,8,10,72,49,23,62
Alloa,3766,4,17,9,10,57,44,13,60
Stranraer,3766,5,16,5,15,57,65,-8,53
Airdrieon,3766,6,10,12,14,46,59,-13,42
East Fife,3766,7,13,3,20,48,66,-18,42
Forfar,3766,8,10,6,20,39,65,-26,36
Albion,3766,9,8,6,22,58,81,-23,30
Queen's Park,3766,10,6,10,20,40,74,-34,28
Raith,3767,1,23,8,5,73,32,41,77
Ayr,3767,2,23,4,9,91,44,47,73
Arbroath,3767,3,17,8,11,70,49,21,59
Alloa,3767,4,17,8,11,56,48,8,59
Stranraer,3767,5,15,5,16,56,67,-11,50
East Fife,3767,6,14,3,19,50,65,-15,45
Airdrieon,3767,7,10,12,14,47,60,-13,42
Forfar,3767,8,10,6,20,40,66,-26,36
Albion,3767,9,9,6,21,59,79,-20,33
Queen's Park,3767,10,7,10,19,40,72,-32,31
Raith,3768,1,22,9,5,69,33,36,75
Ayr,3768,2,23,4,9,92,45,47,73
Arbroath,3768,3,18,8,10,72,49,23,62
Alloa,3768,4,17,9,10,57,44,13,60
Stranraer,3768,5,15,6,15,56,65,-9,51
Airdrieon,3768,6,11,11,14,47,59,-12,44
East Fife,3768,7,13,4,19,48,65,-17,43
Forfar,3768,8,10,5,21,39,66,-27,35
Albion,3768,9,9,6,21,60,80,-20,33
Queen's Park,3768,10,6,10,20,40,74,-34,28
Raith,3769,1,22,8,6,68,33,35,74
Ayr,3769,2,23,4,9,92,45,47,73
Arbroath,3769,3,18,8,10,72,49,23,62
Alloa,3769,4,18,8,10,57,43,14,62
Stranraer,3769,5,15,6,15,57,66,-9,51
East Fife,3769,6,13,4,19,49,66,-17,43
Airdrieon,3769,7,10,11,15,45,59,-14,41
Forfar,3769,8,11,5,20,39,64,-25,38
Albion,3769,9,9,6,21,60,80,-20,33
Queen's Park,3769,10,6,10,20,40,74,-34,28
Ayr,3770,1,24,4,8,92,43,49,76
Raith,3770,2,22,9,5,70,34,36,75
Alloa,3770,3,17,9,10,58,45,13,60
Arbroath,3770,4,17,8,11,70,49,21,59
Stranraer,3770,5,15,5,16,55,67,-12,50
East Fife,3770,6,14,3,19,50,64,-14,45
Airdrieon,3770,7,11,11,14,46,58,-12,44
Forfar,3770,8,10,5,21,38,65,-27,35
Queen's Park,3770,9,7,10,19,40,72,-32,31
Albion,3770,10,8,6,22,58,80,-22,30
Raith,3771,1,23,8,5,71,32,39,77
Ayr,3771,2,24,4,8,97,42,55,76
Arbroath,3771,3,17,8,11,72,52,20,59
Alloa,3771,4,17,8,11,56,46,10,59
Stranraer,3771,5,15,6,15,58,67,-9,51
East Fife,3771,6,13,4,19,50,67,-17,43
Airdrieon,3771,7,10,12,14,46,59,-13,42
Forfar,3771,8,10,6,20,39,65,-26,36
Queen's Park,3771,9,7,10,19,43,74,-31,31
Albion,3771,10,8,6,22,57,85,-28,30
Ayr,3772,1,24,4,8,95,42,53,76
Raith,3772,2,22,9,5,69,33,36,75
Arbroath,3772,3,18,8,10,72,49,23,62
Alloa,3772,4,17,9,10,57,44,13,60
Stranraer,3772,5,15,6,15,57,66,-9,51
Airdrieon,3772,6,11,11,14,49,60,-11,44
East Fife,3772,7,13,4,19,49,66,-17,43
Forfar,3772,8,10,5,21,40,68,-28,35
Albion,3772,9,8,6,22,57,83,-26,30
Queen's Park,3772,10,6,10,20,40,74,-34,28
Raith,3773,1,23,8,5,71,32,39,77
Ayr,3773,2,24,4,8,97,46,51,76
Arbroath,3773,3,17,8,11,71,50,21,59
Alloa,3773,4,17,8,11,56,46,10,59
Stranraer,3773,5,16,5,15,57,64,-7,53
Airdrieon,3773,6,11,11,14,46,58,-12,44
East Fife,3773,7,13,3,20,47,66,-19,42
Forfar,3773,8,10,5,21,38,65,-27,35
Queen's Park,3773,9,7,10,19,41,73,-32,31
Albion,3773,10,8,6,22,61,85,-24,30
Raith,3774,1,23,8,5,69,32,37,77
Ayr,3774,2,24,4,8,93,42,51,76
Arbroath,3774,3,18,8,10,73,48,25,62
Alloa,3774,4,17,8,11,56,44,12,59
Stranraer,3774,5,16,5,15,59,64,-5,53
East Fife,3774,6,13,3,20,47,68,-21,42
Airdrieon,3774,7,10,11,15,46,61,-15,41
Forfar,3774,8,11,5,20,41,65,-24,38
Albion,3774,9,8,6,22,57,81,-24,30
Queen's Park,3774,10,6,10,20,39,75,-36,28
Raith,3775,1,23,8,5,71,32,39,77
Ayr,3775,2,24,4,8,95,42,53,76
Arbroath,3775,3,17,8,11,71,52,19,59
Alloa,3775,4,17,8,11,56,46,10,59
Stranraer,3775,5,16,5,15,57,64,-7,53
Airdrieon,3775,6,11,11,14,47,58,-11,44
East Fife,3775,7,13,3,20,47,66,-19,42
Forfar,3775,8,10,5,21,38,66,-28,35
Queen's Park,3775,9,7,10,19,43,73,-30,31
Albion,3775,10,8,6,22,57,83,-26,30
Raith,3776,1,23,8,5,70,33,37,77
Ayr,3776,2,24,4,8,94,44,50,76
Arbroath,3776,3,18,8,10,74,49,25,62
Alloa,3776,4,17,8,11,57,45,12,59
Stranraer,3776,5,15,6,15,58,67,-9,51
East Fife,3776,6,13,4,19,50,67,-17,43
Airdrieon,3776,7,10,11,15,46,60,-14,41
Forfar,3776,8,11,5,20,40,65,-25,38
Albion,3776,9,8,6,22,59,82,-23,30
Queen's Park,3776,10,6,10,20,40,76,-36,28
Raith,3777,1,23,8,5,74,35,39,77
Ayr,3777,2,23,5,8,91,43,48,74
Arbroath,3777,3,17,9,10,73,51,22,60
Alloa,3777,4,17,8,11,59,49,10,59
Stranraer,3777,5,16,5,15,57,65,-8,53
Airdrieon,3777,6,11,11,14,47,58,-11,44
East Fife,3777,7,13,3,20,48,66,-18,42
Forfar,3777,8,10,5,21,38,66,-28,35
Albion,3777,9,8,7,21,58,79,-21,31
Queen's Park,3777,10,6,11,19,42,75,-33,29
Raith,3778,1,23,8,5,69,32,37,77
Ayr,3778,2,24,4,8,96,43,53,76
Arbroath,3778,3,17,8,11,71,50,21,59
Alloa,3778,4,17,8,11,56,44,12,59
Stranraer,3778,5,15,6,15,56,65,-9,51
East Fife,3778,6,13,4,19,48,65,-17,43
Airdrieon,3778,7,10,12,14,45,58,-13,42
Forfar,3778,8,10,6,20,38,64,-26,36
Queen's Park,3778,9,7,10,19,41,73,-32,31
Albion,3778,10,8,6,22,58,84,-26,30
Ayr,3779,1,24,4,8,92,43,49,76
Raith,3779,2,22,9,5,69,33,36,75
Alloa,3779,3,17,9,10,57,44,13,60
Arbroath,3779,4,17,8,11,70,51,19,59
Stranraer,3779,5,15,5,16,55,67,-12,50
East Fife,3779,6,14,3,19,50,64,-14,45
Airdrieon,3779,7,10,12,14,46,59,-13,42
Forfar,3779,8,10,6,20,39,65,-26,36
Queen's Park,3779,9,7,10,19,42,72,-30,31
Albion,3779,10,8,6,22,58,80,-22,30
Ayr,3780,1,24,4,8,92,43,49,76
Raith,3780,2,22,8,6,69,34,35,74
Alloa,3780,3,18,8,10,58,44,14,62
Arbroath,3780,4,17,9,10,71,49,22,60
Stranraer,3780,5,15,5,16,55,66,-11,50
East Fife,3780,6,14,3,19,49,64,-15,45
Airdrieon,3780,7,10,12,14,46,59,-13,42
Forfar,3780,8,10,6,20,39,65,-26,36
Albion,3780,9,8,6,22,58,80,-22,30
Queen's Park,3780,10,6,11,19,40,73,-33,29
Raith,3781,1,23,8,5,72,33,39,77
Ayr,3781,2,24,4,8,94,42,52,76
Arbroath,3781,3,17,8,11,70,50,20,59
Alloa,3781,4,17,8,11,57,47,10,59
Stranraer,3781,5,16,5,15,57,64,-7,53
Airdrieon,3781,6,11,11,14,47,59,-12,44
East Fife,3781,7,13,3,20,47,66,-19,42
Forfar,3781,8,10,5,21,39,66,-27,35
Queen's Park,3781,9,7,10,19,41,72,-31,31
Albion,3781,10,8,6,22,57,82,-25,30
Raith,3782,1,23,8,5,71,34,37,77
Ayr,3782,2,23,5,8,93,45,48,74
Arbroath,3782,3,18,8,10,71,48,23,62
Alloa,3782,4,17,8,11,58,46,12,59
Stranraer,3782,5,15,5,16,55,66,-11,50
East Fife,3782,6,14,3,19,49,64,-15,45
Airdrieon,3782,7,10,12,14,46,59,-13,42
Forfar,3782,8,10,6,20,39,65,-26,36
Albion,3782,9,8,7,21,60,81,-21,31
Queen's Park,3782,10,6,10,20,39,73,-34,28
Raith,3783,1,23,8,5,70,32,38,77
Ayr,3783,2,24,4,8,94,43,51,76
Arbroath,3783,3,18,8,10,73,49,24,62
Alloa,3783,4,17,8,11,56,45,11,59
Stranraer,3783,5,15,5,16,56,67,-11,50
East Fife,3783,6,14,3,19,50,65,-15,45
Airdrieon,3783,7,11,11,14,47,58,-11,44
Forfar,3783,8,10,5,21,38,66,-28,35
Albion,3783,9,8,6,22,58,82,-24,30
Queen's Park,3783,10,6,10,20,40,75,-35,28
Raith,3784,1,23,8,5,69,32,37,77
Ayr,3784,2,24,4,8,94,43,51,76
Arbroath,3784,3,17,9,10,72,50,22,60
Alloa,3784,4,17,8,11,56,44,12,59
Stranraer,3784,5,15,6,15,57,66,-9,51
East Fife,3784,6,13,4,19,49,66,-17,43
Airdrieon,3784,7,10,12,14,45,58,-13,42
Forfar,3784,8,10,6,20,38,64,-26,36
Albion,3784,9,8,6,22,58,82,-24,30
Queen's Park,3784,10,6,11,19,41,74,-33,29
Ayr,3785,1,24,4,8,94,42,52,76
Raith,3785,2,22,8,6,69,34,35,74
Arbroath,3785,3,18,8,10,72,49,23,62
Alloa,3785,4,18,8,10,58,44,14,62
Stranraer,3785,5,15,6,15,56,65,-9,51
East Fife,3785,6,13,4,19,48,65,-17,43
Airdrieon,3785,7,10,11,15,45,60,-15,41
Forfar,3785,8,11,5,20,40,64,-24,38
Albion,3785,9,8,6,22,57,82,-25,30
Queen's Park,3785,10,6,10,20,40,74,-34,28
Ayr,3786,1,24,4,8,95,43,52,76
Raith,3786,2,22,8,6,68,34,34,74
Arbroath,3786,3,18,8,10,74,49,25,62
Alloa,3786,4,18,8,10,58,43,15,62
Stranraer,3786,5,15,5,16,57,67,-10,50
East Fife,3786,6,14,3,19,50,66,-16,45
Airdrieon,3786,7,11,11,14,46,58,-12,44
Forfar,3786,8,10,5,21,38,65,-27,35
Albion,3786,9,8,6,22,58,83,-25,30
Queen's Park,3786,10,6,10,20,40,76,-36,28
Raith,3787,1,23,8,5,70,33,37,77
Ayr,3787,2,23,5,8,95,47,48,74
Arbroath,3787,3,18,8,10,72,49,23,62
Alloa,3787,4,17,8,11,57,45,12,59
Stranraer,3787,5,15,5,16,55,65,-10,50
East Fife,3787,6,14,3,19,48,64,-16,45
Airdrieon,3787,7,10,11,15,45,59,-14,41
Forfar,3787,8,11,5,20,39,64,-25,38
Albion,3787,9,8,7,21,62,83,-21,31
Queen's Park,3787,10,6,10,20,40,74,-34,28
Raith,3788,1,23,8,5,70,33,37,77
Ayr,3788,2,24,4,8,96,45,51,76
Arbroath,3788,3,17,8,11,70,50,20,59
Alloa,3788,4,17,8,11,57,45,12,59
Stranraer,3788,5,15,6,15,56,65,-9,51
Airdrieon,3788,6,11,11,14,46,58,-12,44
East Fife,3788,7,13,4,19,48,65,-17,43
Forfar,3788,8,10,5,21,38,65,-27,35
Queen's Park,3788,9,7,10,19,41,72,-31,31
Albion,3788,10,8,6,22,60,84,-24,30
Raith,3789,1,23,8,5,70,33,37,77
Ayr,3789,2,24,4,8,96,43,53,76
Arbroath,3789,3,17,8,11,70,49,21,59
Alloa,3789,4,17,8,11,57,45,12,59
Stranraer,3789,5,15,6,15,55,64,-9,51
East Fife,3789,6,13,4,19,47,64,-17,43
Airdrieon,3789,7,10,12,14,45,58,-13,42
Forfar,3789,8,10,6,20,38,64,-26,36
Queen's Park,3789,9,7,10,19,40,72,-32,31
Albion,3789,10,8,6,22,58,84,-26,30
Raith,3790,1,23,8,5,71,33,38,77
Ayr,3790,2,24,4,8,93,43,50,76
Arbroath,3790,3,17,8,11,71,50,21,59
Alloa,3790,4,17,8,11,57,46,11,59
Stranraer,3790,5,15,5,16,56,66,-10,50
East Fife,3790,6,14,3,19,49,65,-16,45
Airdrieon,3790,7,10,11,15,45,60,-15,41
Forfar,3790,8,11,5,20,40,64,-24,38
Queen's Park,3790,9,7,10,19,41,73,-32,31
Albion,3790,10,8,6,22,58,81,-23,30
Ayr,3791,1,24,4,8,96,45,51,76
Raith,3791,2,22,9,5,68,32,36,75
Arbroath,3791,3,17,9,10,71,49,22,60
Alloa,3791,4,17,9,10,56,43,13,60
Stranraer,3791,5,16,5,15,57,65,-8,53
Airdrieon,3791,6,10,12,14,46,59,-13,42
East Fife,3791,7,13,3,20,48,66,-18,42
Forfar,3791,8,10,6,20,39,65,-26,36
Albion,3791,9,8,6,22,60,84,-24,30
Queen's Park,3791,10,6,11,19,40,73,-33,29
Raith,3792,1,23,8,5,72,33,39,77
Ayr,3792,2,24,4,8,94,44,50,76
Arbroath,3792,3,18,8,10,74,48,26,62
Alloa,3792,4,17,8,11,57,47,10,59
Stranraer,3792,5,15,5,16,55,66,-11,50
East Fife,3792,6,14,3,19,49,64,-15,45
Airdrieon,3792,7,11,11,14,46,58,-12,44
Forfar,3792,8,10,5,21,38,65,-27,35
Albion,3792,9,8,6,22,59,82,-23,30
Queen's Park,3792,10,6,10,20,39,76,-37,28
Raith,3793,1,23,8,5,69,32,37,77
Ayr,3793,2,24,4,8,93,44,49,76
Arbroath,3793,3,18,8,10,72,48,24,62
Alloa,3793,4,17,8,11,56,44,12,59
Stranraer,3793,5,15,6,15,56,65,-9,51
Airdrieon,3793,6,11,11,14,48,59,-11,44
East Fife,3793,7,13,4,19,48,65,-17,43
Forfar,3793,8,10,5,21,39,67,-28,35
Albion,3793,9,8,6,22,59,81,-22,30
Queen's Park,3793,10,6,10,20,39,74,-35,28
Raith,3794,1,23,8,5,69,32,37,77
Ayr,3794,2,24,4,8,95,44,51,76
Arbroath,3794,3,17,9,10,71,49,22,60
Alloa,3794,4,17,8,11,56,44,12,59
Stranraer,3794,5,15,5,16,56,67,-11,50
East Fife,3794,6,14,3,19,50,65,-15,45
Airdrieon,3794,7,10,12,14,45,58,-13,42
Forfar,3794,8,10,6,20,38,64,-26,36
Albion,3794,9,8,6,22,59,83,-24,30
Queen's Park,3794,10,6,11,19,40,73,-33,29
Raith,3795,1,22,9,5,68,32,36,75
Ayr,3795,2,23,4,9,91,44,47,73
Arbroath,3795,3,18,8,10,73,50,23,62
Alloa,3795,4,17,9,10,56,43,13,60
Stranraer,3795,5,15,5,16,55,65,-10,50
East Fife,3795,6,14,3,19,48,64,-16,45
Airdrieon,3795,7,10,11,15,46,60,-14,41
Forfar,3795,8,11,5,20,40,65,-25,38
Albion,3795,9,9,6,21,59,79,-20,33
Queen's Park,3795,10,6,10,20,41,75,-34,28
Ayr,3796,1,24,4,8,93,43,50,76
Raith,3796,2,22,8,6,68,33,35,74
Arbroath,3796,3,18,8,10,73,50,23,62
Alloa,3796,4,18,8,10,57,43,14,62
Stranraer,3796,5,16,5,15,57,65,-8,53
East Fife,3796,6,13,3,20,48,66,-18,42
Airdrieon,3796,7,10,11,15,46,60,-14,41
Forfar,3796,8,11,5,20,40,65,-25,38
Albion,3796,9,8,6,22,58,81,-23,30
Queen's Park,3796,10,6,10,20,41,75,-34,28
Ayr,3797,1,24,4,8,94,43,51,76
Raith,3797,2,22,8,6,68,33,35,74
Arbroath,3797,3,18,8,10,73,48,25,62
Alloa,3797,4,18,8,10,57,43,14,62
Stranraer,3797,5,15,5,16,56,66,-10,50
East Fife,3797,6,14,3,19,49,65,-16,45
Airdrieon,3797,7,10,11,15,45,59,-14,41
Forfar,3797,8,11,5,20,39,64,-25,38
Albion,3797,9,8,6,22,58,82,-24,30
Queen's Park,3797,10,6,10,20,39,75,-36,28
Raith,3798,1,23,8,5,69,32,37,77
Ayr,3798,2,23,5,8,91,43,48,74
Arbroath,3798,3,18,8,10,72,49,23,62
Alloa,3798,4,17,8,11,56,44,12,59
Stranraer,3798,5,16,5,15,58,66,-8,53
Airdrieon,3798,6,11,11,14,47,59,-12,44
East Fife,3798,7,13,3,20,49,67,-18,42
Forfar,3798,8,10,5,21,39,66,-27,35
Albion,3798,9,8,7,21,58,79,-21,31
Queen's Park,3798,10,6,10,20,40,74,-34,28
Raith,3799,1,22,8,6,69,34,35,74
Ayr,3799,2,23,4,9,90,45,45,73
Alloa,3799,3,18,8,10,58,44,14,62
Arbroath,3799,4,17,8,11,70,49,21,59
Stranraer,3799,5,15,6,15,56,65,-9,51
East Fife,3799,6,13,4,19,48,65,-17,43
Airdrieon,3799,7,10,11,15,45,61,-16,41
Forfar,3799,8,11,5,20,41,64,-23,38
Albion,3799,9,9,6,21,60,78,-18,33
Queen's Park,3799,10,7,10,19,40,72,-32,31
Raith,3800,1,22,9,5,68,32,36,75
Ayr,3800,2,23,5,8,93,45,48,74
Arbroath,3800,3,17,9,10,70,48,22,60
Alloa,3800,4,17,9,10,56,43,13,60
Stranraer,3800,5,15,6,15,56,65,-9,51
Airdrieon,3800,6,11,11,14,48,60,-12,44
East Fife,3800,7,13,4,19,48,65,-17,43
Forfar,3800,8,10,5,21,40,67,-27,35
Albion,3800,9,8,7,21,60,81,-21,31
Queen's Park,3800,10,6,11,19,39,72,-33,29
Ayr,3801,1,24,4,8,98,43,55,76
Raith,3801,2,22,9,5,69,33,36,75
Arbroath,3801,3,18,8,10,74,48,26,62
Alloa,3801,4,17,9,10,57,44,13,60
Stranraer,3801,5,16,5,15,57,64,-7,53
Airdrieon,3801,6,10,12,14,47,60,-13,42
East Fife,3801,7,13,3,20,47,66,-19,42
Forfar,3801,8,10,6,20,40,66,-26,36
Albion,3801,9,8,6,22,58,86,-28,30
Queen's Park,3801,10,6,10,20,39,76,-37,28
Ayr,3802,1,24,4,8,96,43,53,76
Raith,3802,2,22,8,6,69,35,34,74
Arbroath,3802,3,18,8,10,73,49,24,62
Alloa,3802,4,18,8,10,59,44,15,62
Stranraer,3802,5,16,5,15,58,65,-7,53
Airdrieon,3802,6,11,11,14,46,58,-12,44
East Fife,3802,7,13,3,20,48,67,-19,42
Forfar,3802,8,10,5,21,38,65,-27,35
Albion,3802,9,8,6,22,58,84,-26,30
Queen's Park,3802,10,6,10,20,40,75,-35,28
Raith,3803,1,23,8,5,72,34,38,77
Ayr,3803,2,24,4,8,94,43,51,76
Arbroath,3803,3,17,9,10,71,49,22,60
Alloa,3803,4,17,8,11,58,47,11,59
Stranraer,3803,5,15,6,15,57,66,-9,51
Airdrieon,3803,6,11,11,14,47,58,-11,44
East Fife,3803,7,13,4,19,49,66,-17,43
Forfar,3803,8,10,5,21,38,66,-28,35
Albion,3803,9,8,6,22,58,82,-24,30
Queen's Park,3803,10,6,11,19,40,73,-33,29
Ayr,3804,1,24,4,8,93,42,51,76
Raith,3804,2,22,8,6,68,34,34,74
Alloa,3804,3,18,8,10,58,43,15,62
Arbroath,3804,4,17,8,11,70,53,17,59
Stranraer,3804,5,15,5,16,56,70,-14,50
East Fife,3804,6,14,3,19,53,65,-12,45
Airdrieon,3804,7,11,11,14,48,60,-12,44
Forfar,3804,8,10,5,21,40,67,-27,35
Queen's Park,3804,9,7,10,19,44,72,-28,31
Albion,3804,10,8,6,22,57,81,-24,30
Ayr,3805,1,24,4,8,95,43,52,76
Raith,3805,2,22,8,6,68,33,35,74
Alloa,3805,3,18,8,10,57,43,14,62
Arbroath,3805,4,17,8,11,70,52,18,59
Stranraer,3805,5,15,5,16,56,69,-13,50
East Fife,3805,6,14,3,19,52,65,-13,45
Airdrieon,3805,7,11,11,14,49,58,-9,44
Forfar,3805,8,10,5,21,38,68,-30,35
Queen's Park,3805,9,7,10,19,43,72,-29,31
Albion,3805,10,8,6,22,58,83,-25,30
Raith,3806,1,23,8,5,70,32,38,77
Ayr,3806,2,24,4,8,92,43,49,76
Arbroath,3806,3,18,8,10,73,50,23,62
Alloa,3806,4,17,8,11,56,45,11,59
Stranraer,3806,5,16,5,15,57,64,-7,53
East Fife,3806,6,13,3,20,47,66,-19,42
Airdrieon,3806,7,10,11,15,45,59,-14,41
Forfar,3806,8,11,5,20,39,64,-25,38
Albion,3806,9,8,6,22,58,80,-22,30
Queen's Park,3806,10,6,10,20,41,75,-34,28
Raith,3807,1,23,8,5,70,33,37,77
Ayr,3807,2,24,4,8,94,45,49,76
Arbroath,3807,3,18,8,10,72,49,23,62
Alloa,3807,4,17,8,11,57,45,12,59
Stranraer,3807,5,15,5,16,57,69,-12,50
East Fife,3807,6,14,3,19,52,66,-14,45
Airdrieon,3807,7,11,11,14,46,58,-12,44
Forfar,3807,8,10,5,21,38,65,-27,35
Albion,3807,9,8,6,22,60,82,-22,30
Queen's Park,3807,10,6,10,20,40,74,-34,28
Raith,3808,1,23,8,5,69,32,37,77
Ayr,3808,2,24,4,8,94,43,51,76
Arbroath,3808,3,17,8,11,70,51,19,59
Alloa,3808,4,17,8,11,56,44,12,59
Stranraer,3808,5,15,6,15,58,67,-9,51
East Fife,3808,6,13,4,19,50,67,-17,43
Airdrieon,3808,7,10,12,14,47,60,-13,42
Forfar,3808,8,10,6,20,40,66,-26,36
Queen's Park,3808,9,7,10,19,42,72,-30,31
Albion,3808,10,8,6,22,58,82,-24,30
Raith,3809,1,23,8,5,69,32,37,77
Ayr,3809,2,24,4,8,93,44,49,76
Arbroath,3809,3,18,8,10,71,48,23,62
Alloa,3809,4,17,8,11,56,44,12,59
Stranraer,3809,5,16,5,15,56,64,-8,53
Airdrieon,3809,6,11,11,14,48,59,-11,44
East Fife,3809,7,13,3,20,47,65,-18,42
Forfar,3809,8,10,5,21,39,67,-28,35
Albion,3809,9,8,6,22,59,81,-22,30
Queen's Park,3809,10,6,10,20,39,73,-34,28
Raith,3810,1,23,8,5,69,32,37,77
Ayr,3810,2,24,4,8,93,43,50,76
Arbroath,3810,3,17,9,10,71,49,22,60
Alloa,3810,4,17,8,11,56,44,12,59
Stranraer,3810,5,16,5,15,60,66,-6,53
Airdrieon,3810,6,11,11,14,47,58,-11,44
East Fife,3810,7,13,3,20,49,69,-20,42
Forfar,3810,8,10,5,21,38,66,-28,35
Albion,3810,9,8,6,22,58,81,-23,30
Queen's Park,3810,10,6,11,19,40,73,-33,29
Ayr,3811,1,23,5,8,93,45,48,74
Raith,3811,2,22,8,6,69,35,34,74
Arbroath,3811,3,18,8,10,72,48,24,62
Alloa,3811,4,18,8,10,59,44,15,62
Stranraer,3811,5,15,6,15,55,64,-9,51
East Fife,3811,6,13,4,19,47,64,-17,43
Airdrieon,3811,7,10,11,15,45,60,-15,41
Forfar,3811,8,11,5,20,40,64,-24,38
Albion,3811,9,8,7,21,60,81,-21,31
Queen's Park,3811,10,6,10,20,39,74,-35,28
Raith,3812,1,23,8,5,70,33,37,77
Ayr,3812,2,24,4,8,91,42,49,76
Arbroath,3812,3,18,8,10,73,50,23,62
Alloa,3812,4,17,8,11,57,45,12,59
Stranraer,3812,5,16,5,15,60,65,-5,53
Airdrieon,3812,6,11,11,14,46,58,-12,44
East Fife,3812,7,13,3,20,48,69,-21,42
Forfar,3812,8,10,5,21,38,65,-27,35
Albion,3812,9,8,6,22,57,79,-22,30
Queen's Park,3812,10,6,10,20,41,75,-34,28
Ayr,3813,1,24,4,8,95,43,52,76
Raith,3813,2,22,9,5,68,32,36,75
Arbroath,3813,3,18,8,10,72,48,24,62
Alloa,3813,4,17,9,10,56,43,13,60
Stranraer,3813,5,16,5,15,57,64,-7,53
Airdrieon,3813,6,10,12,14,47,60,-13,42
East Fife,3813,7,13,3,20,47,66,-19,42
Forfar,3813,8,10,6,20,40,66,-26,36
Albion,3813,9,8,6,22,58,83,-25,30
Queen's Park,3813,10,6,10,20,39,74,-35,28
Raith,3814,1,23,8,5,71,34,37,77
Ayr,3814,2,24,4,8,96,44,52,76
Arbroath,3814,3,17,8,11,71,51,20,59
Alloa,3814,4,17,8,11,58,46,12,59
Stranraer,3814,5,15,6,15,56,65,-9,51
East Fife,3814,6,13,4,19,48,65,-17,43
Airdrieon,3814,7,10,11,15,46,62,-16,41
Forfar,3814,8,11,5,20,42,65,-23,38
Queen's Park,3814,9,7,10,19,42,73,-31,31
Albion,3814,10,8,6,22,59,84,-25,30
Ayr,3815,1,24,4,8,94,44,50,76
Raith,3815,2,22,8,6,69,34,35,74
Arbroath,3815,3,18,8,10,72,49,23,62
Alloa,3815,4,18,8,10,58,44,14,62
Stranraer,3815,5,16,5,15,58,65,-7,53
Airdrieon,3815,6,11,11,14,51,59,-8,44
East Fife,3815,7,13,3,20,48,67,-19,42
Forfar,3815,8,10,5,21,39,70,-31,35
Albion,3815,9,8,6,22,59,82,-23,30
Queen's Park,3815,10,6,10,20,40,74,-34,28
Ayr,3816,1,24,4,8,94,43,51,76
Raith,3816,2,22,9,5,69,33,36,75
Arbroath,3816,3,18,8,10,71,48,23,62
Alloa,3816,4,17,9,10,57,44,13,60
Stranraer,3816,5,15,5,16,55,65,-10,50
East Fife,3816,6,14,3,19,48,64,-16,45
Airdrieon,3816,7,11,11,14,49,61,-12,44
Forfar,3816,8,10,5,21,41,68,-27,35
Albion,3816,9,8,6,22,58,82,-24,30
Queen's Park,3816,10,6,10,20,39,73,-34,28
Raith,3817,1,23,8,5,69,32,37,77
Ayr,3817,2,24,4,8,96,43,53,76
Arbroath,3817,3,17,9,10,73,51,22,60
Alloa,3817,4,17,8,11,56,44,12,59
Stranraer,3817,5,16,5,15,56,64,-8,53
Airdrieon,3817,6,10,12,14,46,59,-13,42
East Fife,3817,7,13,3,20,47,65,-18,42
Forfar,3817,8,10,6,20,39,65,-26,36
Albion,3817,9,8,6,22,58,84,-26,30
Queen's Park,3817,10,6,11,19,42,75,-33,29
Raith,3818,1,23,8,5,72,32,40,77
Ayr,3818,2,23,4,9,90,43,47,73
Arbroath,3818,3,18,8,10,73,50,23,62
Alloa,3818,4,17,8,11,56,47,9,59
Stranraer,3818,5,15,5,16,56,66,-10,50
East Fife,3818,6,14,3,19,49,65,-16,45
Airdrieon,3818,7,10,12,14,46,59,-13,42
Forfar,3818,8,10,6,20,39,65,-26,36
Albion,3818,9,9,6,21,58,78,-20,33
Queen's Park,3818,10,6,10,20,41,75,-34,28
Ayr,3819,1,24,4,8,93,43,50,76
Raith,3819,2,22,8,6,68,34,34,74
Alloa,3819,3,18,8,10,58,43,15,62
Arbroath,3819,4,17,8,11,71,50,21,59
Stranraer,3819,5,15,5,16,55,66,-11,50
East Fife,3819,6,14,3,19,49,64,-15,45
Airdrieon,3819,7,10,11,15,45,59,-14,41
Forfar,3819,8,11,5,20,39,64,-25,38
Queen's Park,3819,9,7,10,19,41,73,-32,31
Albion,3819,10,8,6,22,58,81,-23,30
Raith,3820,1,23,8,5,72,34,38,77
Ayr,3820,2,24,4,8,94,42,52,76
Arbroath,3820,3,17,8,11,72,51,21,59
Alloa,3820,4,17,8,11,58,47,11,59
Stranraer,3820,5,15,5,16,56,66,-10,50
East Fife,3820,6,14,3,19,49,65,-16,45
Airdrieon,3820,7,10,12,14,45,58,-13,42
Forfar,3820,8,10,6,20,38,64,-26,36
Queen's Park,3820,9,7,10,19,42,74,-32,31
Albion,3820,10,8,6,22,57,82,-25,30
Raith,3821,1,23,8,5,71,32,39,77
Ayr,3821,2,24,4,8,93,43,50,76
Arbroath,3821,3,18,8,10,74,50,24,62
Alloa,3821,4,17,8,11,56,46,10,59
Stranraer,3821,5,15,5,16,56,67,-11,50
East Fife,3821,6,14,3,19,50,65,-15,45
Airdrieon,3821,7,11,11,14,47,59,-12,44
Forfar,3821,8,10,5,21,39,66,-27,35
Albion,3821,9,8,6,22,58,81,-23,30
Queen's Park,3821,10,6,10,20,41,76,-35,28
Ayr,3822,1,24,4,8,96,46,50,76
Raith,3822,2,22,8,6,68,33,35,74
Arbroath,3822,3,18,8,10,73,50,23,62
Alloa,3822,4,18,8,10,57,43,14,62
Stranraer,3822,5,15,5,16,55,66,-11,50
East Fife,3822,6,14,3,19,49,64,-15,45
Airdrieon,3822,7,11,11,14,47,58,-11,44
Forfar,3822,8,10,5,21,38,66,-28,35
Albion,3822,9,8,6,22,61,84,-23,30
Queen's Park,3822,10,6,10,20,41,75,-34,28
Raith,3823,1,23,8,5,69,32,37,77
Ayr,3823,2,24,4,8,96,43,53,76
Arbroath,3823,3,18,8,10,73,50,23,62
Alloa,3823,4,17,8,11,56,44,12,59
Stranraer,3823,5,15,5,16,55,66,-11,50
East Fife,3823,6,14,3,19,49,64,-15,45
Airdrieon,3823,7,10,12,14,46,59,-13,42
Forfar,3823,8,10,6,20,39,65,-26,36
Albion,3823,9,8,6,22,58,84,-26,30
Queen's Park,3823,10,6,10,20,41,75,-34,28
Raith,3824,1,23,8,5,70,33,37,77
Ayr,3824,2,24,4,8,94,42,52,76
Arbroath,3824,3,18,8,10,72,48,24,62
Alloa,3824,4,17,8,11,57,45,12,59
Stranraer,3824,5,16,5,15,61,65,-4,53
Airdrieon,3824,6,11,11,14,47,59,-12,44
East Fife,3824,7,13,3,20,48,70,-22,42
Forfar,3824,8,10,5,21,39,66,-27,35
Albion,3824,9,8,6,22,57,82,-25,30
Queen's Park,3824,10,6,10,20,39,74,-35,28
Ayr,3825,1,24,4,8,93,43,50,76
Raith,3825,2,22,8,6,69,35,34,74
Alloa,3825,3,18,8,10,59,44,15,62
Arbroath,3825,4,17,9,10,72,50,22,60
Stranraer,3825,5,15,5,16,55,66,-11,50
East Fife,3825,6,14,3,19,49,64,-15,45
Airdrieon,3825,7,11,11,14,47,58,-11,44
Forfar,3825,8,10,5,21,38,66,-28,35
Albion,3825,9,8,6,22,58,81,-23,30
Queen's Park,3825,10,6,11,19,41,74,-33,29
Ayr,3826,1,24,4,8,98,42,56,76
Raith,3826,2,22,8,6,68,34,34,74
Alloa,3826,3,18,8,10,58,43,15,62
Arbroath,3826,4,17,8,11,72,51,21,59
Stranraer,3826,5,15,5,16,56,66,-10,50
East Fife,3826,6,14,3,19,49,65,-16,45
Airdrieon,3826,7,10,12,14,48,61,-13,42
Forfar,3826,8,10,6,20,41,67,-26,36
Queen's Park,3826,9,7,10,19,42,74,-32,31
Albion,3826,10,8,6,22,57,86,-29,30
Raith,3827,1,23,8,5,70,32,38,77
Ayr,3827,2,24,4,8,95,43,52,76
Arbroath,3827,3,17,8,11,72,51,21,59
Alloa,3827,4,17,8,11,56,45,11,59
Stranraer,3827,5,15,5,16,56,66,-10,50
East Fife,3827,6,14,3,19,49,65,-16,45
Airdrieon,3827,7,10,12,14,46,59,-13,42
Forfar,3827,8,10,6,20,39,65,-26,36
Queen's Park,3827,9,7,10,19,42,74,-32,31
Albion,3827,10,8,6,22,58,83,-25,30
Ayr,3828,1,24,4,8,95,43,52,76
Raith,3828,2,22,8,6,70,35,35,74
Alloa,3828,3,18,8,10,59,45,14,62
Arbroath,3828,4,17,8,11,71,50,21,59
Stranraer,3828,5,16,5,15,57,65,-8,53
Airdrieon,3828,6,11,11,14,48,58,-10,44
East Fife,3828,7,13,3,20,48,66,-18,42
Forfar,3828,8,10,5,21,38,67,-29,35
Queen's Park,3828,9,7,10,19,41,73,-32,31
Albion,3828,10,8,6,22,58,83,-25,30
Ayr,3829,1,24,4,8,92,43,49,76
Raith,3829,2,22,8,6,68,34,34,74
Alloa,3829,3,18,8,10,58,43,15,62
Arbroath,3829,4,17,8,11,70,49,21,59
Stranraer,3829,5,16,5,15,57,64,-7,53
East Fife,3829,6,13,3,20,47,66,-19,42
Airdrieon,3829,7,10,11,15,46,60,-14,41
Forfar,3829,8,11,5,20,40,65,-25,38
Queen's Park,3829,9,7,10,19,40,72,-32,31
Albion,3829,10,8,6,22,58,80,-22,30
Raith,3830,1,22,8,6,68,33,35,74
Ayr,3830,2,23,4,9,92,45,47,73
Arbroath,3830,3,18,8,10,71,48,23,62
Alloa,3830,4,18,8,10,57,43,14,62
Stranraer,3830,5,16,5,15,57,65,-8,53
Airdrieon,3830,6,11,11,14,49,58,-9,44
East Fife,3830,7,13,3,20,48,66,-18,42
Forfar,3830,8,10,5,21,38,68,-30,35
Albion,3830,9,9,6,21,60,80,-20,33
Queen's Park,3830,10,6,10,20,39,73,-34,28
Raith,3831,1,23,8,5,69,32,37,77
Ayr,3831,2,24,4,8,94,44,50,76
Arbroath,3831,3,18,8,10,73,48,25,62
Alloa,3831,4,17,8,11,56,44,12,59
Stranraer,3831,5,16,5,15,57,65,-8,53
Airdrieon,3831,6,10,12,14,46,59,-13,42
East Fife,3831,7,13,3,20,48,66,-18,42
Forfar,3831,8,10,6,20,39,65,-26,36
Albion,3831,9,8,6,22,59,82,-23,30
Queen's Park,3831,10,6,10,20,39,75,-36,28
Raith,3832,1,23,8,5,72,33,39,77
Ayr,3832,2,24,4,8,96,43,53,76
Arbroath,3832,3,18,8,10,73,49,24,62
Alloa,3832,4,17,8,11,57,47,10,59
Stranraer,3832,5,15,5,16,55,65,-10,50
East Fife,3832,6,14,3,19,48,64,-16,45
Airdrieon,3832,7,11,11,14,47,58,-11,44
Forfar,3832,8,10,5,21,38,66,-28,35
Albion,3832,9,8,6,22,58,84,-26,30
Queen's Park,3832,10,6,10,20,40,75,-35,28
Raith,3833,1,22,9,5,68,32,36,75
Ayr,3833,2,23,5,8,92,44,48,74
Alloa,3833,3,17,9,10,56,43,13,60
Arbroath,3833,4,17,8,11,70,51,19,59
Stranraer,3833,5,15,5,16,55,66,-11,50
East Fife,3833,6,14,3,19,49,64,-15,45
Airdrieon,3833,7,11,11,14,47,58,-11,44
Forfar,3833,8,10,5,21,38,66,-28,35
Albion,3833,9,8,7,21,59,80,-21,31
Queen's Park,3833,10,7,10,19,42,72,-30,31
Ayr,3834,1,24,4,8,95,44,51,76
Raith,3834,2,22,9,5,70,34,36,75
Arbroath,3834,3,18,8,10,71,48,23,62
Alloa,3834,4,17,9,10,58,45,13,60
Stranraer,3834,5,15,5,16,55,66,-11,50
East Fife,3834,6,14,3,19,49,64,-15,45
Airdrieon,3834,7,11,11,14,48,58,-10,44
Forfar,3834,8,10,5,21,38,67,-29,35
Albion,3834,9,8,6,22,59,83,-24,30
Queen's Park,3834,10,6,10,20,39,73,-34,28
Ayr,3835,1,24,4,8,93,42,51,76
Raith,3835,2,22,9,5,69,33,36,75
Alloa,3835,3,17,9,10,57,44,13,60
Arbroath,3835,4,17,8,11,71,50,21,59
Stranraer,3835,5,16,5,15,57,65,-8,53
Airdrieon,3835,6,11,11,14,47,59,-12,44
East Fife,3835,7,13,3,20,48,66,-18,42
Forfar,3835,8,10,5,21,39,66,-27,35
Queen's Park,3835,9,7,10,19,41,73,-32,31
Albion,3835,10,8,6,22,57,81,-24,30
Ayr,3836,1,23,5,8,93,45,48,74
Raith,3836,2,22,8,6,68,33,35,74
Arbroath,3836,3,18,8,10,72,48,24,62
Alloa,3836,4,18,8,10,57,43,14,62
Stranraer,3836,5,15,5,16,56,66,-10,50
East Fife,3836,6,14,3,19,49,65,-16,45
Airdrieon,3836,7,11,11,14,47,58,-11,44
Forfar,3836,8,10,5,21,38,66,-28,35
Albion,3836,9,8,7,21,60,81,-21,31
Queen's Park,3836,10,6,10,20,39,74,-35,28
Ayr,3837,1,24,4,8,94,45,49,76
Raith,3837,2,22,9,5,69,33,36,75
Arbroath,3837,3,18,8,10,71,48,23,62
Alloa,3837,4,17,9,10,57,44,13,60
Stranraer,3837,5,15,6,15,57,66,-9,51
Airdrieon,3837,6,11,11,14,47,58,-11,44
East Fife,3837,7,13,4,19,49,66,-17,43
Forfar,3837,8,10,5,21,38,66,-28,35
Albion,3837,9,8,6,22,60,82,-22,30
Queen's Park,3837,10,6,10,20,39,73,-34,28
Ayr,3838,1,24,4,8,95,44,51,76
Raith,3838,2,22,8,6,69,34,35,74
Alloa,3838,3,18,8,10,58,44,14,62
Arbroath,3838,4,17,9,10,72,50,22,60
Stranraer,3838,5,16,5,15,56,64,-8,53
Airdrieon,3838,6,11,11,14,48,59,-11,44
East Fife,3838,7,13,3,20,47,65,-18,42
Forfar,3838,8,10,5,21,39,67,-28,35
Albion,3838,9,8,6,22,59,83,-24,30
Queen's Park,3838,10,6,11,19,41,74,-33,29
Raith,3839,1,23,8,5,69,32,37,77
Ayr,3839,2,24,4,8,93,44,49,76
Arbroath,3839,3,18,8,10,72,48,24,62
Alloa,3839,4,17,8,11,56,44,12,59
Stranraer,3839,5,16,5,15,57,64,-7,53
East Fife,3839,6,13,3,20,47,66,-19,42
Airdrieon,3839,7,10,11,15,46,60,-14,41
Forfar,3839,8,11,5,20,40,65,-25,38
Albion,3839,9,8,6,22,59,81,-22,30
Queen's Park,3839,10,6,10,20,39,74,-35,28
Ayr,3840,1,24,4,8,92,42,50,76
Raith,3840,2,22,8,6,68,33,35,74
Arbroath,3840,3,18,8,10,73,49,24,62
Alloa,3840,4,18,8,10,57,43,14,62
Stranraer,3840,5,15,5,16,57,67,-10,50
East Fife,3840,6,14,3,19,50,66,-16,45
Airdrieon,3840,7,11,11,14,48,59,-11,44
Forfar,3840,8,10,5,21,39,67,-28,35
Albion,3840,9,8,6,22,57,80,-23,30
Queen's Park,3840,10,6,10,20,40,75,-35,28
Ayr,3841,1,24,4,8,92,42,50,76
Raith,3841,2,22,9,5,70,34,36,75
Arbroath,3841,3,18,8,10,73,50,23,62
Alloa,3841,4,17,9,10,58,45,13,60
Stranraer,3841,5,16,5,15,57,65,-8,53
East Fife,3841,6,13,3,20,48,66,-18,42
Airdrieon,3841,7,10,11,15,45,61,-16,41
Forfar,3841,8,11,5,20,41,64,-23,38
Albion,3841,9,8,6,22,57,80,-23,30
Queen's Park,3841,10,6,10,20,41,75,-34,28
Ayr,3842,1,24,4,8,94,42,52,76
Raith,3842,2,22,9,5,69,33,36,75
Arbroath,3842,3,17,9,10,71,49,22,60
Alloa,3842,4,17,9,10,57,44,13,60
Stranraer,3842,5,16,5,15,58,64,-6,53
Airdrieon,3842,6,11,11,14,47,58,-11,44
East Fife,3842,7,13,3,20,47,67,-20,42
Forfar,3842,8,10,5,21,38,66,-28,35
Albion,3842,9,8,6,22,57,82,-25,30
Queen's Park,3842,10,6,11,19,40,73,-33,29
Ayr,3843,1,24,4,8,96,43,53,76
Raith,3843,2,22,9,5,72,36,36,75
Alloa,3843,3,17,9,10,60,47,13,60
Arbroath,3843,4,17,8,11,71,50,21,59
Stranraer,3843,5,15,6,15,56,65,-9,51
East Fife,3843,6,13,4,19,48,65,-17,43
Airdrieon,3843,7,10,12,14,46,59,-13,42
Forfar,3843,8,10,6,20,39,65,-26,36
Queen's Park,3843,9,7,10,19,41,73,-32,31
Albion,3843,10,8,6,22,58,84,-26,30
Raith,3844,1,23,8,5,69,32,37,77
Ayr,3844,2,24,4,8,92,43,49,76
Arbroath,3844,3,18,8,10,73,48,25,62
Alloa,3844,4,17,8,11,56,44,12,59
Stranraer,3844,5,16,5,15,56,64,-8,53
Airdrieon,3844,6,10,12,14,47,60,-13,42
East Fife,3844,7,13,3,20,47,65,-18,42
Forfar,3844,8,10,6,20,40,66,-26,36
Albion,3844,9,8,6,22,58,80,-22,30
Queen's Park,3844,10,6,10,20,39,75,-36,28
Ayr,3845,1,24,4,8,93,43,50,76
Raith,3845,2,22,9,5,69,33,36,75
Arbroath,3845,3,17,9,10,70,48,22,60
Alloa,3845,4,17,9,10,57,44,13,60
Stranraer,3845,5,16,5,15,57,64,-7,53
East Fife,3845,6,13,3,20,47,66,-19,42
Airdrieon,3845,7,10,11,15,46,61,-15,41
Forfar,3845,8,11,5,20,41,65,-24,38
Albion,3845,9,8,6,22,58,81,-23,30
Queen's Park,3845,10,6,11,19,39,72,-33,29
Ayr,3846,1,24,4,8,92,43,49,76
Raith,3846,2,22,9,5,69,33,36,75
Alloa,3846,3,17,9,10,57,44,13,60
Arbroath,3846,4,17,8,11,70,49,21,59
Stranraer,3846,5,15,5,16,55,65,-10,50
East Fife,3846,6,14,3,19,48,64,-16,45
Airdrieon,3846,7,10,11,15,46,60,-14,41
Forfar,3846,8,11,5,20,40,65,-25,38
Queen's Park,3846,9,7,10,19,40,72,-32,31
Albion,3846,10,8,6,22,58,80,-22,30
Raith,3847,1,23,8,5,71,33,38,77
Ayr,3847,2,24,4,8,96,42,54,76
Arbroath,3847,3,18,8,10,77,49,28,62
Alloa,3847,4,17,8,11,57,46,11,59
Stranraer,3847,5,16,5,15,56,64,-8,53
Airdrieon,3847,6,10,12,14,46,59,-13,42
East Fife,3847,7,13,3,20,47,65,-18,42
Forfar,3847,8,10,6,20,39,65,-26,36
Albion,3847,9,8,6,22,57,84,-27,30
Queen's Park,3847,10,6,10,20,40,79,-39,28
Ayr,3848,1,24,4,8,97,43,54,76
Raith,3848,2,22,9,5,69,33,36,75
Arbroath,3848,3,18,8,10,73,50,23,62
Alloa,3848,4,17,9,10,57,44,13,60
Stranraer,3848,5,15,6,15,56,65,-9,51
East Fife,3848,6,13,4,19,48,65,-17,43
Airdrieon,3848,7,10,12,14,46,59,-13,42
Forfar,3848,8,10,6,20,39,65,-26,36
Albion,3848,9,8,6,22,58,85,-27,30
Queen's Park,3848,10,6,10,20,41,75,-34,28
Raith,3849,1,23,8,5,69,32,37,77
Ayr,3849,2,24,4,8,94,45,49,76
Arbroath,3849,3,17,8,11,70,49,21,59
Alloa,3849,4,17,8,11,56,44,12,59
Stranraer,3849,5,15,6,15,56,65,-9,51
Airdrieon,3849,6,11,11,14,47,59,-12,44
East Fife,3849,7,13,4,19,48,65,-17,43
Forfar,3849,8,10,5,21,39,66,-27,35
Queen's Park,3849,9,7,10,19,40,72,-32,31
Albion,3849,10,8,6,22,60,82,-22,30
Raith,3850,1,23,8,5,71,32,39,77
Ayr,3850,2,24,4,8,92,42,50,76
Arbroath,3850,3,17,8,11,70,49,21,59
Alloa,3850,4,17,8,11,56,46,10,59
Stranraer,3850,5,15,6,15,57,66,-9,51
East Fife,3850,6,13,4,19,49,66,-17,43
Airdrieon,3850,7,10,11,15,45,60,-15,41
Forfar,3850,8,11,5,20,40,64,-24,38
Queen's Park,3850,9,7,10,19,40,72,-32,31
Albion,3850,10,8,6,22,57,80,-23,30
Ayr,3851,1,24,4,8,94,44,50,76
Raith,3851,2,22,9,5,68,32,36,75
Arbroath,3851,3,18,8,10,73,49,24,62
Alloa,3851,4,17,9,10,56,43,13,60
Stranraer,3851,5,15,5,16,56,66,-10,50
East Fife,3851,6,14,3,19,49,65,-16,45
Airdrieon,3851,7,10,11,15,46,60,-14,41
Forfar,3851,8,11,5,20,40,65,-25,38
Albion,3851,9,8,6,22,59,82,-23,30
Queen's Park,3851,10,6,10,20,40,75,-35,28
Ayr,3852,1,24,4,8,93,42,51,76
Raith,3852,2,22,9,5,70,34,36,75
Arbroath,3852,3,17,9,10,71,49,22,60
Alloa,3852,4,17,9,10,58,45,13,60
Stranraer,3852,5,16,5,15,59,67,-8,53
Airdrieon,3852,6,11,11,14,48,58,-10,44
East Fife,3852,7,13,3,20,50,68,-18,42
Forfar,3852,8,10,5,21,38,67,-29,35
Albion,3852,9,8,6,22,57,81,-24,30
Queen's Park,3852,10,6,11,19,40,73,-33,29
Raith,3853,1,23,8,5,70,33,37,77
Ayr,3853,2,24,4,8,95,44,51,76
Arbroath,3853,3,18,8,10,73,48,25,62
Alloa,3853,4,17,8,11,57,45,12,59
Stranraer,3853,5,15,5,16,57,68,-11,50
East Fife,3853,6,14,3,19,51,66,-15,45
Airdrieon,3853,7,10,12,14,46,59,-13,42
Forfar,3853,8,10,6,20,39,65,-26,36
Albion,3853,9,8,6,22,59,83,-24,30
Queen's Park,3853,10,6,10,20,39,75,-36,28
Raith,3854,1,23,8,5,71,34,37,77
Ayr,3854,2,24,4,8,95,43,52,76
Arbroath,3854,3,17,9,10,72,50,22,60
Alloa,3854,4,17,8,11,58,46,12,59
Stranraer,3854,5,15,5,16,56,66,-10,50
East Fife,3854,6,14,3,19,49,65,-16,45
Airdrieon,3854,7,10,11,15,46,60,-14,41
Forfar,3854,8,11,5,20,40,65,-25,38
Albion,3854,9,8,6,22,58,83,-25,30
Queen's Park,3854,10,6,11,19,41,74,-33,29
Ayr,3855,1,24,4,8,94,44,50,76
Raith,3855,2,22,9,5,70,34,36,75
Alloa,3855,3,17,9,10,58,45,13,60
Arbroath,3855,4,17,8,11,70,49,21,59
Stranraer,3855,5,15,6,15,56,65,-9,51
East Fife,3855,6,13,4,19,48,65,-17,43
Airdrieon,3855,7,10,11,15,45,60,-15,41
Forfar,3855,8,11,5,20,40,64,-24,38
Queen's Park,3855,9,7,10,19,40,72,-32,31
Albion,3855,10,8,6,22,59,82,-23,30
Ayr,3856,1,24,4,8,92,42,50,76
Raith,3856,2,22,8,6,70,35,35,74
Alloa,3856,3,18,8,10,59,45,14,62
Arbroath,3856,4,17,8,11,70,49,21,59
Stranraer,3856,5,15,5,16,55,66,-11,50
East Fife,3856,6,14,3,19,49,64,-15,45
Airdrieon,3856,7,10,12,14,46,59,-13,42
Forfar,3856,8,10,6,20,39,65,-26,36
Queen's Park,3856,9,7,10,19,40,72,-32,31
Albion,3856,10,8,6,22,57,80,-23,30
Ayr,3857,1,24,4,8,94,44,50,76
Raith,3857,2,22,9,5,68,32,36,75
Arbroath,3857,3,18,8,10,72,48,24,62
Alloa,3857,4,17,9,10,56,43,13,60
Stranraer,3857,5,16,5,15,56,64,-8,53
Airdrieon,3857,6,11,11,14,48,60,-12,44
East Fife,3857,7,13,3,20,47,65,-18,42
Forfar,3857,8,10,5,21,40,67,-27,35
Albion,3857,9,8,6,22,59,82,-23,30
Queen's Park,3857,10,6,10,20,39,74,-35,28
Ayr,3858,1,24,4,8,97,43,54,76
Raith,3858,2,22,8,6,70,35,35,74
Arbroath,3858,3,18,8,10,73,49,24,62
Alloa,3858,4,18,8,10,59,45,14,62
Stranraer,3858,5,16,5,15,58,66,-8,53
Airdrieon,3858,6,11,11,14,47,58,-11,44
East Fife,3858,7,13,3,20,49,67,-18,42
Forfar,3858,8,10,5,21,38,66,-28,35
Albion,3858,9,8,6,22,58,85,-27,30
Queen's Park,3858,10,6,10,20,40,75,-35,28
Raith,3859,1,22,9,5,68,32,36,75
Ayr,3859,2,23,5,8,92,44,48,74
Alloa,3859,3,17,9,10,56,43,13,60
Arbroath,3859,4,17,8,11,70,50,20,59
Stranraer,3859,5,15,6,15,57,66,-9,51
Airdrieon,3859,6,11,11,14,51,58,-7,44
East Fife,3859,7,13,4,19,49,66,-17,43
Forfar,3859,8,10,5,21,38,70,-32,35
Albion,3859,9,8,7,21,59,80,-21,31
Queen's Park,3859,10,7,10,19,41,72,-31,31
Ayr,3860,1,24,4,8,93,43,50,76
Raith,3860,2,22,8,6,68,34,34,74
Arbroath,3860,3,18,8,10,73,50,23,62
Alloa,3860,4,18,8,10,58,43,15,62
Stranraer,3860,5,15,5,16,57,67,-10,50
East Fife,3860,6,14,3,19,50,66,-16,45
Airdrieon,3860,7,11,11,14,47,59,-12,44
Forfar,3860,8,10,5,21,39,66,-27,35
Albion,3860,9,8,6,22,58,81,-23,30
Queen's Park,3860,10,6,10,20,41,75,-34,28
Raith,3861,1,23,8,5,70,33,37,77
Ayr,3861,2,24,4,8,93,44,49,76
Arbroath,3861,3,17,9,10,73,51,22,60
Alloa,3861,4,17,8,11,57,45,12,59
Stranraer,3861,5,15,5,16,56,67,-11,50
East Fife,3861,6,14,3,19,50,65,-15,45
Airdrieon,3861,7,11,11,14,47,58,-11,44
Forfar,3861,8,10,5,21,38,66,-28,35
Albion,3861,9,8,6,22,59,81,-22,30
Queen's Park,3861,10,6,11,19,42,75,-33,29
Ayr,3862,1,24,4,8,94,44,50,76
Raith,3862,2,22,8,6,70,36,34,74
Arbroath,3862,3,18,8,10,73,49,24,62
Alloa,3862,4,18,8,10,60,45,15,62
Stranraer,3862,5,16,5,15,56,64,-8,53
Airdrieon,3862,6,10,12,14,47,60,-13,42
East Fife,3862,7,13,3,20,47,65,-18,42
Forfar,3862,8,10,6,20,40,66,-26,36
Albion,3862,9,8,6,22,59,82,-23,30
Queen's Park,3862,10,6,10,20,40,75,-35,28
Raith,3863,1,23,8,5,70,32,38,77
Ayr,3863,2,24,4,8,95,42,53,76
Arbroath,3863,3,18,8,10,73,49,24,62
Alloa,3863,4,17,8,11,56,45,11,59
Stranraer,3863,5,15,6,15,56,65,-9,51
Airdrieon,3863,6,11,11,14,48,58,-10,44
East Fife,3863,7,13,4,19,48,65,-17,43
Forfar,3863,8,10,5,21,38,67,-29,35
Albion,3863,9,8,6,22,57,83,-26,30
Queen's Park,3863,10,6,10,20,40,75,-35,28
Raith,3864,1,23,8,5,69,32,37,77
Ayr,3864,2,24,4,8,95,42,53,76
Arbroath,3864,3,17,9,10,72,50,22,60
Alloa,3864,4,17,8,11,56,44,12,59
Stranraer,3864,5,16,5,15,59,64,-5,53
East Fife,3864,6,13,3,20,47,68,-21,42
Airdrieon,3864,7,10,11,15,45,59,-14,41
Forfar,3864,8,11,5,20,39,64,-25,38
Albion,3864,9,8,6,22,57,83,-26,30
Queen's Park,3864,10,6,11,19,41,74,-33,29
Ayr,3865,1,24,4,8,94,43,51,76
Raith,3865,2,22,9,5,68,32,36,75
Arbroath,3865,3,18,8,10,73,49,24,62
Alloa,3865,4,17,9,10,56,43,13,60
Stranraer,3865,5,15,5,16,55,66,-11,50
East Fife,3865,6,14,3,19,49,64,-15,45
Airdrieon,3865,7,10,11,15,45,60,-15,41
Forfar,3865,8,11,5,20,40,64,-24,38
Albion,3865,9,8,6,22,58,82,-24,30
Queen's Park,3865,10,6,10,20,40,75,-35,28
Ayr,3866,1,24,4,8,96,43,53,76
Raith,3866,2,22,9,5,69,33,36,75
Arbroath,3866,3,18,8,10,74,48,26,62
Alloa,3866,4,17,9,10,57,44,13,60
Stranraer,3866,5,16,5,15,58,65,-7,53
Airdrieon,3866,6,11,11,14,46,58,-12,44
East Fife,3866,7,13,3,20,48,67,-19,42
Forfar,3866,8,10,5,21,38,65,-27,35
Albion,3866,9,8,6,22,58,84,-26,30
Queen's Park,3866,10,6,10,20,39,76,-37,28
Raith,3867,1,23,8,5,69,32,37,77
Ayr,3867,2,24,4,8,95,44,51,76
Arbroath,3867,3,18,8,10,71,48,23,62
Alloa,3867,4,17,8,11,56,44,12,59
Stranraer,3867,5,15,5,16,57,69,-12,50
East Fife,3867,6,14,3,19,52,66,-14,45
Airdrieon,3867,7,10,11,15,45,59,-14,41
Forfar,3867,8,11,5,20,39,64,-25,38
Albion,3867,9,8,6,22,59,83,-24,30
Queen's Park,3867,10,6,10,20,39,73,-34,28
Raith,3868,1,23,8,5,69,32,37,77
Ayr,3868,2,24,4,8,94,43,51,76
Arbroath,3868,3,18,8,10,79,51,28,62
Alloa,3868,4,17,8,11,56,44,12,59
Stranraer,3868,5,15,6,15,56,65,-9,51
East Fife,3868,6,13,4,19,48,65,-17,43
Airdrieon,3868,7,10,11,15,46,61,-15,41
Forfar,3868,8,11,5,20,41,65,-24,38
Albion,3868,9,8,6,22,58,82,-24,30
Queen's Park,3868,10,6,10,20,42,81,-39,28
Raith,3869,1,23,8,5,74,32,42,77
Ayr,3869,2,23,5,8,92,44,48,74
Arbroath,3869,3,17,9,10,72,50,22,60
Alloa,3869,4,17,8,11,56,49,7,59
Stranraer,3869,5,15,5,16,55,65,-10,50
East Fife,3869,6,14,3,19,48,64,-16,45
Airdrieon,3869,7,10,12,14,46,59,-13,42
Forfar,3869,8,10,6,20,39,65,-26,36
Albion,3869,9,8,7,21,59,80,-21,31
Queen's Park,3869,10,6,11,19,41,74,-33,29
Ayr,3870,1,24,4,8,97,43,54,76
Raith,3870,2,22,8,6,69,34,35,74
Alloa,3870,3,18,8,10,58,44,14,62
Arbroath,3870,4,17,9,10,72,50,22,60
Stranraer,3870,5,15,5,16,55,68,-13,50
East Fife,3870,6,14,3,19,51,64,-13,45
Airdrieon,3870,7,11,11,14,49,58,-9,44
Forfar,3870,8,10,5,21,38,68,-30,35
Albion,3870,9,8,6,22,58,85,-27,30
Queen's Park,3870,10,6,11,19,41,74,-33,29
Ayr,3871,1,24,4,8,92,42,50,76
Raith,3871,2,22,9,5,69,33,36,75
Arbroath,3871,3,17,9,10,72,50,22,60
Alloa,3871,4,17,9,10,57,44,13,60
Stranraer,3871,5,16,5,15,57,64,-7,53
Airdrieon,3871,6,11,11,14,46,58,-12,44
East Fife,3871,7,13,3,20,47,66,-19,42
Forfar,3871,8,10,5,21,38,65,-27,35
Albion,3871,9,8,6,22,57,80,-23,30
Queen's Park,3871,10,6,11,19,41,74,-33,29
Ayr,3872,1,24,4,8,94,45,49,76
Raith,3872,2,22,9,5,69,33,36,75
Arbroath,3872,3,18,8,10,72,49,23,62
Alloa,3872,4,17,9,10,57,44,13,60
Stranraer,3872,5,16,5,15,57,65,-8,53
East Fife,3872,6,13,3,20,48,66,-18,42
Airdrieon,3872,7,10,11,15,46,60,-14,41
Forfar,3872,8,11,5,20,40,65,-25,38
Albion,3872,9,8,6,22,60,82,-22,30
Queen's Park,3872,10,6,10,20,40,74,-34,28
Ayr,3873,1,24,4,8,93,44,49,76
Raith,3873,2,22,9,5,70,34,36,75
Alloa,3873,3,17,9,10,58,45,13,60
Arbroath,3873,4,17,8,11,72,51,21,59
Stranraer,3873,5,15,5,16,55,65,-10,50
East Fife,3873,6,14,3,19,48,64,-16,45
Airdrieon,3873,7,11,11,14,47,59,-12,44
Forfar,3873,8,10,5,21,39,66,-27,35
Queen's Park,3873,9,7,10,19,42,74,-32,31
Albion,3873,10,8,6,22,59,81,-22,30
Raith,3874,1,23,8,5,70,33,37,77
Ayr,3874,2,24,4,8,92,42,50,76
Arbroath,3874,3,17,9,10,70,48,22,60
Alloa,3874,4,17,8,11,57,45,12,59
Stranraer,3874,5,15,5,16,56,67,-11,50
East Fife,3874,6,14,3,19,50,65,-15,45
Airdrieon,3874,7,10,11,15,46,63,-17,41
Forfar,3874,8,11,5,20,43,65,-22,38
Albion,3874,9,8,6,22,57,80,-23,30
Queen's Park,3874,10,6,11,19,39,72,-33,29
Raith,3875,1,23,8,5,69,32,37,77
Ayr,3875,2,24,4,8,94,42,52,76
Arbroath,3875,3,18,8,10,73,49,24,62
Alloa,3875,4,17,8,11,56,44,12,59
Stranraer,3875,5,16,5,15,57,64,-7,53
Airdrieon,3875,6,10,12,14,47,60,-13,42
East Fife,3875,7,13,3,20,47,66,-19,42
Forfar,3875,8,10,6,20,40,66,-26,36
Albion,3875,9,8,6,22,57,82,-25,30
Queen's Park,3875,10,6,10,20,40,75,-35,28
Raith,3876,1,23,8,5,72,35,37,77
Ayr,3876,2,24,4,8,94,43,51,76
Arbroath,3876,3,17,8,11,71,50,21,59
Alloa,3876,4,17,8,11,59,47,12,59
Stranraer,3876,5,15,6,15,57,66,-9,51
East Fife,3876,6,13,4,19,49,66,-17,43
Airdrieon,3876,7,10,11,15,46,60,-14,41
Forfar,3876,8,11,5,20,40,65,-25,38
Queen's Park,3876,9,7,10,19,41,73,-32,31
Albion,3876,10,8,6,22,58,82,-24,30
Raith,3877,1,23,8,5,69,32,37,77
Ayr,3877,2,24,4,8,94,44,50,76
Arbroath,3877,3,18,8,10,72,48,24,62
Alloa,3877,4,17,8,11,56,44,12,59
Stranraer,3877,5,16,5,15,57,64,-7,53
East Fife,3877,6,13,3,20,47,66,-19,42
Airdrieon,3877,7,10,11,15,46,60,-14,41
Forfar,3877,8,11,5,20,40,65,-25,38
Albion,3877,9,8,6,22,59,82,-23,30
Queen's Park,3877,10,6,10,20,39,74,-35,28
Raith,3878,1,23,8,5,69,32,37,77
Ayr,3878,2,24,4,8,92,42,50,76
Arbroath,3878,3,17,9,10,72,50,22,60
Alloa,3878,4,17,8,11,56,44,12,59
Stranraer,3878,5,15,6,15,56,65,-9,51
Airdrieon,3878,6,11,11,14,48,60,-12,44
East Fife,3878,7,13,4,19,48,65,-17,43
Forfar,3878,8,10,5,21,40,67,-27,35
Albion,3878,9,8,6,22,57,80,-23,30
Queen's Park,3878,10,6,11,19,41,74,-33,29
Raith,3879,1,22,8,6,68,33,35,74
Ayr,3879,2,23,4,9,90,43,47,73
Arbroath,3879,3,18,8,10,74,51,23,62
Alloa,3879,4,18,8,10,57,43,14,62
Stranraer,3879,5,15,6,15,57,66,-9,51
Airdrieon,3879,6,11,11,14,46,58,-12,44
East Fife,3879,7,13,4,19,49,66,-17,43
Forfar,3879,8,10,5,21,38,65,-27,35
Albion,3879,9,9,6,21,58,78,-20,33
Queen's Park,3879,10,6,10,20,42,76,-34,28
Raith,3880,1,23,8,5,71,32,39,77
Ayr,3880,2,24,4,8,92,42,50,76
Arbroath,3880,3,17,9,10,72,50,22,60
Alloa,3880,4,17,8,11,56,46,10,59
Stranraer,3880,5,15,5,16,55,67,-12,50
East Fife,3880,6,14,3,19,50,64,-14,45
Airdrieon,3880,7,11,11,14,46,58,-12,44
Forfar,3880,8,10,5,21,38,65,-27,35
Albion,3880,9,8,6,22,57,80,-23,30
Queen's Park,3880,10,6,11,19,41,74,-33,29
Raith,3881,1,23,8,5,69,32,37,77
Ayr,3881,2,24,4,8,95,42,53,76
Arbroath,3881,3,18,8,10,73,49,24,62
Alloa,3881,4,17,8,11,56,44,12,59
Stranraer,3881,5,15,6,15,55,64,-9,51
East Fife,3881,6,13,4,19,47,64,-17,43
Airdrieon,3881,7,10,11,15,46,60,-14,41
Forfar,3881,8,11,5,20,40,65,-25,38
Albion,3881,9,8,6,22,57,83,-26,30
Queen's Park,3881,10,6,10,20,40,75,-35,28
Raith,3882,1,23,8,5,72,34,38,77
Ayr,3882,2,24,4,8,95,42,53,76
Arbroath,3882,3,18,8,10,72,48,24,62
Alloa,3882,4,17,8,11,58,47,11,59
Stranraer,3882,5,15,5,16,55,65,-10,50
East Fife,3882,6,14,3,19,48,64,-16,45
Airdrieon,3882,7,11,11,14,50,60,-10,44
Forfar,3882,8,10,5,21,40,69,-29,35
Albion,3882,9,8,6,22,57,83,-26,30
Queen's Park,3882,10,6,10,20,39,74,-35,28
Raith,3883,1,23,8,5,70,32,38,77
Ayr,3883,2,24,4,8,95,44,51,76
Arbroath,3883,3,17,8,11,73,52,21,59
Alloa,3883,4,17,8,11,56,45,11,59
Stranraer,3883,5,15,5,16,57,67,-10,50
East Fife,3883,6,14,3,19,50,66,-16,45
Airdrieon,3883,7,10,12,14,47,60,-13,42
Forfar,3883,8,10,6,20,40,66,-26,36
Queen's Park,3883,9,7,10,19,43,75,-32,31
Albion,3883,10,8,6,22,59,83,-24,30
Raith,3884,1,23,8,5,73,34,39,77
Ayr,3884,2,24,4,8,93,43,50,76
Arbroath,3884,3,17,8,11,70,50,20,59
Alloa,3884,4,17,8,11,58,48,10,59
Stranraer,3884,5,16,5,15,57,65,-8,53
Airdrieon,3884,6,11,11,14,47,58,-11,44
East Fife,3884,7,13,3,20,48,66,-18,42
Forfar,3884,8,10,5,21,38,66,-28,35
Queen's Park,3884,9,7,10,19,41,72,-31,31
Albion,3884,10,8,6,22,58,81,-23,30
Raith,3885,1,23,8,5,71,34,37,77
Ayr,3885,2,24,4,8,95,43,52,76
Arbroath,3885,3,17,8,11,71,50,21,59
Alloa,3885,4,17,8,11,58,46,12,59
Stranraer,3885,5,15,6,15,56,65,-9,51
East Fife,3885,6,13,4,19,48,65,-17,43
Airdrieon,3885,7,10,12,14,45,58,-13,42
Forfar,3885,8,10,6,20,38,64,-26,36
Queen's Park,3885,9,7,10,19,41,73,-32,31
Albion,3885,10,8,6,22,58,83,-25,30
Raith,3886,1,23,8,5,69,32,37,77
Ayr,3886,2,24,4,8,95,44,51,76
Arbroath,3886,3,17,8,11,70,49,21,59
Alloa,3886,4,17,8,11,56,44,12,59
Stranraer,3886,5,16,5,15,58,65,-7,53
Airdrieon,3886,6,10,12,14,46,59,-13,42
East Fife,3886,7,13,3,20,48,67,-19,42
Forfar,3886,8,10,6,20,39,65,-26,36
Queen's Park,3886,9,7,10,19,40,72,-32,31
Albion,3886,10,8,6,22,59,83,-24,30
Raith,3887,1,23,8,5,69,32,37,77
Ayr,3887,2,23,4,9,90,44,46,73
Arbroath,3887,3,18,8,10,71,48,23,62
Alloa,3887,4,17,8,11,56,44,12,59
Stranraer,3887,5,15,6,15,57,66,-9,51
East Fife,3887,6,13,4,19,49,66,-17,43
Airdrieon,3887,7,10,11,15,46,60,-14,41
Forfar,3887,8,11,5,20,40,65,-25,38
Albion,3887,9,9,6,21,59,78,-19,33
Queen's Park,3887,10,6,10,20,39,73,-34,28
Ayr,3888,1,24,4,8,97,44,53,76
Raith,3888,2,22,9,5,69,33,36,75
Alloa,3888,3,17,9,10,57,44,13,60
Arbroath,3888,4,17,8,11,70,50,20,59
Stranraer,3888,5,15,5,16,55,66,-11,50
East Fife,3888,6,14,3,19,49,64,-15,45
Airdrieon,3888,7,10,12,14,47,60,-13,42
Forfar,3888,8,10,6,20,40,66,-26,36
Queen's Park,3888,9,7,10,19,41,72,-31,31
Albion,3888,10,8,6,22,59,85,-26,30
Raith,3889,1,23,8,5,71,33,38,77
Ayr,3889,2,24,4,8,95,45,50,76
Arbroath,3889,3,18,8,10,72,49,23,62
Alloa,3889,4,17,8,11,57,46,11,59
Stranraer,3889,5,16,5,15,58,66,-8,53
East Fife,3889,6,13,3,20,49,67,-18,42
Airdrieon,3889,7,10,11,15,45,60,-15,41
Forfar,3889,8,11,5,20,40,64,-24,38
Albion,3889,9,8,6,22,60,83,-23,30
Queen's Park,3889,10,6,10,20,40,74,-34,28
Ayr,3890,1,24,4,8,96,42,54,76
Raith,3890,2,22,8,6,69,35,34,74
Alloa,3890,3,18,8,10,59,44,15,62
Arbroath,3890,4,17,9,10,70,48,22,60
Stranraer,3890,5,15,5,16,56,67,-11,50
East Fife,3890,6,14,3,19,50,65,-15,45
Airdrieon,3890,7,11,11,14,49,58,-9,44
Forfar,3890,8,10,5,21,38,68,-30,35
Albion,3890,9,8,6,22,57,84,-27,30
Queen's Park,3890,10,6,11,19,39,72,-33,29
Raith,3891,1,23,8,5,70,33,37,77
Ayr,3891,2,24,4,8,96,44,52,76
Arbroath,3891,3,18,8,10,73,49,24,62
Alloa,3891,4,17,8,11,57,45,12,59
Stranraer,3891,5,15,6,15,56,65,-9,51
East Fife,3891,6,13,4,19,48,65,-17,43
Airdrieon,3891,7,10,12,14,46,59,-13,42
Forfar,3891,8,10,6,20,39,65,-26,36
Albion,3891,9,8,6,22,59,84,-25,30
Queen's Park,3891,10,6,10,20,40,75,-35,28
Raith,3892,1,23,8,5,71,33,38,77
Ayr,3892,2,24,4,8,93,42,51,76
Arbroath,3892,3,17,9,10,73,51,22,60
Alloa,3892,4,17,8,11,57,46,11,59
Stranraer,3892,5,15,6,15,55,64,-9,51
Airdrieon,3892,6,11,11,14,47,59,-12,44
East Fife,3892,7,13,4,19,47,64,-17,43
Forfar,3892,8,10,5,21,39,66,-27,35
Albion,3892,9,8,6,22,57,81,-24,30
Queen's Park,3892,10,6,11,19,42,75,-33,29
Raith,3893,1,23,8,5,70,33,37,77
Ayr,3893,2,23,4,9,91,46,45,73
Arbroath,3893,3,17,8,11,70,50,20,59
Alloa,3893,4,17,8,11,57,45,12,59
Stranraer,3893,5,15,5,16,57,67,-10,50
East Fife,3893,6,14,3,19,50,66,-16,45
Airdrieon,3893,7,10,11,15,46,60,-14,41
Forfar,3893,8,11,5,20,40,65,-25,38
Albion,3893,9,9,6,21,61,79,-18,33
Queen's Park,3893,10,7,10,19,41,72,-31,31
Raith,3894,1,23,8,5,70,32,38,77
Ayr,3894,2,24,4,8,94,44,50,76
Arbroath,3894,3,17,8,11,72,52,20,59
Alloa,3894,4,17,8,11,56,45,11,59
Stranraer,3894,5,15,5,16,56,66,-10,50
East Fife,3894,6,14,3,19,49,65,-16,45
Airdrieon,3894,7,10,11,15,46,60,-14,41
Forfar,3894,8,11,5,20,40,65,-25,38
Queen's Park,3894,9,7,10,19,43,74,-31,31
Albion,3894,10,8,6,22,59,82,-23,30
Ayr,3895,1,24,4,8,93,44,49,76
Raith,3895,2,22,8,6,68,33,35,74
Alloa,3895,3,18,8,10,57,43,14,62
Arbroath,3895,4,17,8,11,71,50,21,59
Stranraer,3895,5,15,5,16,55,66,-11,50
East Fife,3895,6,14,3,19,49,64,-15,45
Airdrieon,3895,7,11,11,14,48,58,-10,44
Forfar,3895,8,10,5,21,38,67,-29,35
Queen's Park,3895,9,7,10,19,41,73,-32,31
Albion,3895,10,8,6,22,59,81,-22,30
Raith,3896,1,23,8,5,70,32,38,77
Ayr,3896,2,24,4,8,92,43,49,76
Arbroath,3896,3,17,8,11,70,51,19,59
Alloa,3896,4,17,8,11,56,45,11,59
Stranraer,3896,5,16,5,15,57,64,-7,53
East Fife,3896,6,13,3,20,47,66,-19,42
Airdrieon,3896,7,10,11,15,47,61,-14,41
Forfar,3896,8,11,5,20,41,66,-25,38
Queen's Park,3896,9,7,10,19,42,72,-30,31
Albion,3896,10,8,6,22,58,80,-22,30
Raith,3897,1,23,8,5,70,32,38,77
Ayr,3897,2,24,4,8,93,44,49,76
Arbroath,3897,3,17,8,11,71,50,21,59
Alloa,3897,4,17,8,11,56,45,11,59
Stranraer,3897,5,15,5,16,55,68,-13,50
East Fife,3897,6,14,3,19,51,64,-13,45
Airdrieon,3897,7,11,11,14,48,59,-11,44
Forfar,3897,8,10,5,21,39,67,-28,35
Queen's Park,3897,9,7,10,19,41,73,-32,31
Albion,3897,10,8,6,22,59,81,-22,30
Ayr,3898,1,24,4,8,96,42,54,76
Raith,3898,2,22,9,5,70,34,36,75
Arbroath,3898,3,18,8,10,73,48,25,62
Alloa,3898,4,17,9,10,58,45,13,60
Stranraer,3898,5,15,6,15,57,66,-9,51
East Fife,3898,6,13,4,19,49,66,-17,43
Airdrieon,3898,7,10,12,14,46,59,-13,42
Forfar,3898,8,10,6,20,39,65,-26,36
Albion,3898,9,8,6,22,57,84,-27,30
Queen's Park,3898,10,6,10,20,39,75,-36,28
Raith,3899,1,23,8,5,69,32,37,77
Ayr,3899,2,24,4,8,98,44,54,76
Arbroath,3899,3,17,9,10,70,48,22,60
Alloa,3899,4,17,8,11,56,44,12,59
Stranraer,3899,5,15,5,16,55,66,-11,50
East Fife,3899,6,14,3,19,49,64,-15,45
Airdrieon,3899,7,11,11,14,48,58,-10,44
Forfar,3899,8,10,5,21,38,67,-29,35
Albion,3899,9,8,6,22,59,86,-27,30
Queen's Park,3899,10,6,11,19,39,72,-33,29
Raith,3900,1,23,8,5,70,32,38,77
Ayr,3900,2,24,4,8,94,42,52,76
Arbroath,3900,3,17,8,11,71,52,19,59
Alloa,3900,4,17,8,11,56,45,11,59
Stranraer,3900,5,15,5,16,57,67,-10,50
East Fife,3900,6,14,3,19,50,66,-16,45
Airdrieon,3900,7,11,11,14,46,58,-12,44
Forfar,3900,8,10,5,21,38,65,-27,35
Queen's Park,3900,9,7,10,19,43,73,-30,31
Albion,3900,10,8,6,22,57,82,-25,30
Raith,3901,1,23,8,5,70,33,37,77
Ayr,3901,2,24,4,8,93,43,50,76
Arbroath,3901,3,17,9,10,71,49,22,60
Alloa,3901,4,17,8,11,57,45,12,59
Stranraer,3901,5,16,5,15,57,65,-8,53
Airdrieon,3901,6,10,12,14,47,60,-13,42
East Fife,3901,7,13,3,20,48,66,-18,42
Forfar,3901,8,10,6,20,40,66,-26,36
Albion,3901,9,8,6,22,58,81,-23,30
Queen's Park,3901,10,6,11,19,40,73,-33,29
Raith,3902,1,23,8,5,69,32,37,77
Ayr,3902,2,24,4,8,96,42,54,76
Arbroath,3902,3,18,8,10,75,51,24,62
Alloa,3902,4,17,8,11,56,44,12,59
Stranraer,3902,5,16,5,15,56,64,-8,53
Airdrieon,3902,6,11,11,14,47,58,-11,44
East Fife,3902,7,13,3,20,47,65,-18,42
Forfar,3902,8,10,5,21,38,66,-28,35
Albion,3902,9,8,6,22,57,84,-27,30
Queen's Park,3902,10,6,10,20,42,77,-35,28
Raith,3903,1,23,8,5,72,35,37,77
Ayr,3903,2,24,4,8,94,42,52,76
Arbroath,3903,3,18,8,10,71,48,23,62
Alloa,3903,4,17,8,11,59,47,12,59
Stranraer,3903,5,15,5,16,56,66,-10,50
East Fife,3903,6,14,3,19,49,65,-16,45
Airdrieon,3903,7,11,11,14,48,59,-11,44
Forfar,3903,8,10,5,21,39,67,-28,35
Albion,3903,9,8,6,22,57,82,-25,30
Queen's Park,3903,10,6,10,20,39,73,-34,28
Raith,3904,1,23,8,5,70,33,37,77
Ayr,3904,2,24,4,8,92,43,49,76
Arbroath,3904,3,18,8,10,72,48,24,62
Alloa,3904,4,17,8,11,57,45,12,59
Stranraer,3904,5,15,5,16,56,66,-10,50
East Fife,3904,6,14,3,19,49,65,-16,45
Airdrieon,3904,7,10,11,15,46,60,-14,41
Forfar,3904,8,11,5,20,40,65,-25,38
Albion,3904,9,8,6,22,58,80,-22,30
Queen's Park,3904,10,6,10,20,39,74,-35,28
Ayr,3905,1,24,4,8,95,43,52,76
Raith,3905,2,22,8,6,68,33,35,74
Arbroath,3905,3,18,8,10,72,49,23,62
Alloa,3905,4,18,8,10,57,43,14,62
Stranraer,3905,5,16,5,15,58,64,-6,53
Airdrieon,3905,6,10,12,14,47,60,-13,42
East Fife,3905,7,13,3,20,47,67,-20,42
Forfar,3905,8,10,6,20,40,66,-26,36
Albion,3905,9,8,6,22,58,83,-25,30
Queen's Park,3905,10,6,10,20,40,74,-34,28
Raith,3906,1,23,8,5,69,32,37,77
Ayr,3906,2,24,4,8,93,42,51,76
Arbroath,3906,3,18,8,10,74,48,26,62
Alloa,3906,4,17,8,11,56,44,12,59
Stranraer,3906,5,15,6,15,57,66,-9,51
Airdrieon,3906,6,11,11,14,48,58,-10,44
East Fife,3906,7,13,4,19,49,66,-17,43
Forfar,3906,8,10,5,21,38,67,-29,35
Albion,3906,9,8,6,22,57,81,-24,30
Queen's Park,3906,10,6,10,20,39,76,-37,28
Raith,3907,1,23,8,5,70,33,37,77
Ayr,3907,2,24,4,8,94,43,51,76
Arbroath,3907,3,17,8,11,70,50,20,59
Alloa,3907,4,17,8,11,57,45,12,59
Stranraer,3907,5,15,6,15,56,65,-9,51
East Fife,3907,6,13,4,19,48,65,-17,43
Airdrieon,3907,7,10,12,14,46,59,-13,42
Forfar,3907,8,10,6,20,39,65,-26,36
Queen's Park,3907,9,7,10,19,41,72,-31,31
Albion,3907,10,8,6,22,58,82,-24,30
Raith,3908,1,22,9,5,69,33,36,75
Ayr,3908,2,23,5,8,91,43,48,74
Arbroath,3908,3,18,8,10,72,48,24,62
Alloa,3908,4,17,9,10,57,44,13,60
Stranraer,3908,5,15,6,15,59,68,-9,51
East Fife,3908,6,13,4,19,51,68,-17,43
Airdrieon,3908,7,10,11,15,45,60,-15,41
Forfar,3908,8,11,5,20,40,64,-24,38
Albion,3908,9,8,7,21,58,79,-21,31
Queen's Park,3908,10,6,10,20,39,74,-35,28
Ayr,3909,1,24,4,8,97,42,55,76
Raith,3909,2,22,9,5,70,34,36,75
Arbroath,3909,3,18,8,10,71,48,23,62
Alloa,3909,4,17,9,10,58,45,13,60
Stranraer,3909,5,15,5,16,55,67,-12,50
East Fife,3909,6,14,3,19,50,64,-14,45
Airdrieon,3909,7,10,12,14,45,58,-13,42
Forfar,3909,8,10,6,20,38,64,-26,36
Albion,3909,9,8,6,22,57,85,-28,30
Queen's Park,3909,10,6,10,20,39,73,-34,28
Raith,3910,1,23,8,5,69,32,37,77
Ayr,3910,2,24,4,8,94,44,50,76
Arbroath,3910,3,18,8,10,76,49,27,62
Alloa,3910,4,17,8,11,56,44,12,59
Stranraer,3910,5,15,5,16,55,65,-10,50
East Fife,3910,6,14,3,19,48,64,-16,45
Airdrieon,3910,7,10,12,14,46,59,-13,42
Forfar,3910,8,10,6,20,39,65,-26,36
Albion,3910,9,8,6,22,59,82,-23,30
Queen's Park,3910,10,6,10,20,40,78,-38,28
Raith,3911,1,23,8,5,70,32,38,77
Ayr,3911,2,24,4,8,93,44,49,76
Arbroath,3911,3,17,8,11,71,50,21,59
Alloa,3911,4,17,8,11,56,45,11,59
Stranraer,3911,5,16,5,15,58,65,-7,53
Airdrieon,3911,6,11,11,14,49,58,-9,44
East Fife,3911,7,13,3,20,48,67,-19,42
Forfar,3911,8,10,5,21,38,68,-30,35
Queen's Park,3911,9,7,10,19,41,73,-32,31
Albion,3911,10,8,6,22,59,81,-22,30
Raith,3912,1,23,8,5,70,32,38,77
Ayr,3912,2,24,4,8,91,42,49,76
Arbroath,3912,3,17,9,10,72,50,22,60
Alloa,3912,4,17,8,11,56,45,11,59
Stranraer,3912,5,15,5,16,56,67,-11,50
East Fife,3912,6,14,3,19,50,65,-15,45
Airdrieon,3912,7,10,12,14,47,60,-13,42
Forfar,3912,8,10,6,20,40,66,-26,36
Albion,3912,9,8,6,22,57,79,-22,30
Queen's Park,3912,10,6,11,19,41,74,-33,29
Raith,3913,1,23,8,5,71,33,38,77
Ayr,3913,2,24,4,8,97,42,55,76
Arbroath,3913,3,17,9,10,72,50,22,60
Alloa,3913,4,17,8,11,57,46,11,59
Stranraer,3913,5,15,6,15,56,65,-9,51
Airdrieon,3913,6,11,11,14,52,59,-7,44
East Fife,3913,7,13,4,19,48,65,-17,43
Forfar,3913,8,10,5,21,39,71,-32,35
Albion,3913,9,8,6,22,57,85,-28,30
Queen's Park,3913,10,6,11,19,41,74,-33,29
Raith,3914,1,23,8,5,70,32,38,77
Ayr,3914,2,24,4,8,97,44,53,76
Arbroath,3914,3,18,8,10,72,49,23,62
Alloa,3914,4,17,8,11,56,45,11,59
Stranraer,3914,5,15,5,16,55,68,-13,50
East Fife,3914,6,14,3,19,51,64,-13,45
Airdrieon,3914,7,11,11,14,50,58,-8,44
Forfar,3914,8,10,5,21,38,69,-31,35
Albion,3914,9,8,6,22,59,85,-26,30
Queen's Park,3914,10,6,10,20,40,74,-34,28
Raith,3915,1,23,8,5,70,32,38,77
Ayr,3915,2,23,5,8,91,43,48,74
Arbroath,3915,3,17,8,11,70,50,20,59
Alloa,3915,4,17,8,11,56,45,11,59
Stranraer,3915,5,16,5,15,57,65,-8,53
Airdrieon,3915,6,11,11,14,47,59,-12,44
East Fife,3915,7,13,3,20,48,66,-18,42
Forfar,3915,8,10,5,21,39,66,-27,35
Albion,3915,9,8,7,21,58,79,-21,31
Queen's Park,3915,10,7,10,19,41,72,-31,31
Raith,3916,1,23,8,5,69,32,37,77
Ayr,3916,2,24,4,8,95,43,52,76
Arbroath,3916,3,17,9,10,70,48,22,60
Alloa,3916,4,17,8,11,56,44,12,59
Stranraer,3916,5,15,6,15,55,64,-9,51
Airdrieon,3916,6,11,11,14,47,58,-11,44
East Fife,3916,7,13,4,19,47,64,-17,43
Forfar,3916,8,10,5,21,38,66,-28,35
Albion,3916,9,8,6,22,58,83,-25,30
Queen's Park,3916,10,6,11,19,39,72,-33,29
Raith,3917,1,23,8,5,70,33,37,77
Ayr,3917,2,24,4,8,97,42,55,76
Arbroath,3917,3,17,8,11,70,51,19,59
Alloa,3917,4,17,8,11,57,45,12,59
Stranraer,3917,5,15,5,16,57,67,-10,50
East Fife,3917,6,14,3,19,50,66,-16,45
Airdrieon,3917,7,11,11,14,47,59,-12,44
Forfar,3917,8,10,5,21,39,66,-27,35
Queen's Park,3917,9,7,10,19,42,72,-30,31
Albion,3917,10,8,6,22,57,85,-28,30
Raith,3918,1,23,8,5,70,33,37,77
Ayr,3918,2,24,4,8,93,42,51,76
Arbroath,3918,3,17,9,10,72,50,22,60
Alloa,3918,4,17,8,11,57,45,12,59
Stranraer,3918,5,15,6,15,56,65,-9,51
Airdrieon,3918,6,11,11,14,47,59,-12,44
East Fife,3918,7,13,4,19,48,65,-17,43
Forfar,3918,8,10,5,21,39,66,-27,35
Albion,3918,9,8,6,22,57,81,-24,30
Queen's Park,3918,10,6,11,19,41,74,-33,29
Raith,3919,1,23,8,5,70,33,37,77
Ayr,3919,2,24,4,8,94,43,51,76
Arbroath,3919,3,17,9,10,71,49,22,60
Alloa,3919,4,17,8,11,57,45,12,59
Stranraer,3919,5,15,5,16,55,66,-11,50
East Fife,3919,6,14,3,19,49,64,-15,45
Airdrieon,3919,7,11,11,14,47,58,-11,44
Forfar,3919,8,10,5,21,38,66,-28,35
Albion,3919,9,8,6,22,58,82,-24,30
Queen's Park,3919,10,6,11,19,40,73,-33,29
Raith,3920,1,23,8,5,69,32,37,77
Ayr,3920,2,24,4,8,94,42,52,76
Arbroath,3920,3,18,8,10,72,48,24,62
Alloa,3920,4,17,8,11,56,44,12,59
Stranraer,3920,5,15,6,15,56,65,-9,51
East Fife,3920,6,13,4,19,48,65,-17,43
Airdrieon,3920,7,10,11,15,46,60,-14,41
Forfar,3920,8,11,5,20,40,65,-25,38
Albion,3920,9,8,6,22,57,82,-25,30
Queen's Park,3920,10,6,10,20,39,74,-35,28
Ayr,3921,1,24,4,8,93,44,49,76
Raith,3921,2,22,9,5,69,33,36,75
Alloa,3921,3,17,9,10,57,44,13,60
Arbroath,3921,4,17,8,11,71,50,21,59
Stranraer,3921,5,15,5,16,56,66,-10,50
East Fife,3921,6,14,3,19,49,65,-16,45
Airdrieon,3921,7,11,11,14,46,58,-12,44
Forfar,3921,8,10,5,21,38,65,-27,35
Queen's Park,3921,9,7,10,19,41,73,-32,31
Albion,3921,10,8,6,22,59,81,-22,30
Raith,3922,1,23,8,5,69,32,37,77
Ayr,3922,2,24,4,8,92,42,50,76
Arbroath,3922,3,18,8,10,72,48,24,62
Alloa,3922,4,17,8,11,56,44,12,59
Stranraer,3922,5,15,5,16,56,66,-10,50
East Fife,3922,6,14,3,19,49,65,-16,45
Airdrieon,3922,7,10,12,14,47,60,-13,42
Forfar,3922,8,10,6,20,40,66,-26,36
Albion,3922,9,8,6,22,57,80,-23,30
Queen's Park,3922,10,6,10,20,39,74,-35,28
Raith,3923,1,23,8,5,71,32,39,77
Ayr,3923,2,24,4,8,97,44,53,76
Arbroath,3923,3,18,8,10,71,48,23,62
Alloa,3923,4,17,8,11,56,46,10,59
Stranraer,3923,5,15,5,16,57,67,-10,50
East Fife,3923,6,14,3,19,50,66,-16,45
Airdrieon,3923,7,10,11,15,45,60,-15,41
Forfar,3923,8,11,5,20,40,64,-24,38
Albion,3923,9,8,6,22,59,85,-26,30
Queen's Park,3923,10,6,10,20,39,73,-34,28
Ayr,3924,1,24,4,8,96,42,54,76
Raith,3924,2,22,9,5,70,34,36,75
Arbroath,3924,3,18,8,10,74,51,23,62
Alloa,3924,4,17,9,10,58,45,13,60
Stranraer,3924,5,16,5,15,58,66,-8,53
Airdrieon,3924,6,11,11,14,46,58,-12,44
East Fife,3924,7,13,3,20,49,67,-18,42
Forfar,3924,8,10,5,21,38,65,-27,35
Albion,3924,9,8,6,22,57,84,-27,30
Queen's Park,3924,10,6,10,20,42,76,-34,28
Ayr,3925,1,24,4,8,92,42,50,76
Raith,3925,2,22,8,6,68,33,35,74
Alloa,3925,3,18,8,10,57,43,14,62
Arbroath,3925,4,17,8,11,70,51,19,59
Stranraer,3925,5,15,5,16,57,67,-10,50
East Fife,3925,6,14,3,19,50,66,-16,45
Airdrieon,3925,7,10,12,14,46,59,-13,42
Forfar,3925,8,10,6,20,39,65,-26,36
Queen's Park,3925,9,7,10,19,42,72,-30,31
Albion,3925,10,8,6,22,57,80,-23,30
Ayr,3926,1,24,4,8,92,43,49,76
Raith,3926,2,22,9,5,69,33,36,75
Arbroath,3926,3,18,8,10,73,48,25,62
Alloa,3926,4,17,9,10,57,44,13,60
Stranraer,3926,5,15,6,15,55,64,-9,51
Airdrieon,3926,6,11,11,14,46,58,-12,44
East Fife,3926,7,13,4,19,47,64,-17,43
Forfar,3926,8,10,5,21,38,65,-27,35
Albion,3926,9,8,6,22,58,80,-22,30
Queen's Park,3926,10,6,10,20,39,75,-36,28
Raith,3927,1,23,8,5,70,33,37,77
Ayr,3927,2,24,4,8,91,42,49,76
Arbroath,3927,3,17,8,11,70,51,19,59
Alloa,3927,4,17,8,11,57,45,12,59
Stranraer,3927,5,16,5,15,57,65,-8,53
Airdrieon,3927,6,11,11,14,49,59,-10,44
East Fife,3927,7,13,3,20,48,66,-18,42
Forfar,3927,8,10,5,21,39,68,-29,35
Queen's Park,3927,9,7,10,19,42,72,-30,31
Albion,3927,10,8,6,22,57,79,-22,30
Raith,3928,1,23,8,5,70,33,37,77
Ayr,3928,2,24,4,8,94,42,52,76
Arbroath,3928,3,18,8,10,73,49,24,62
Alloa,3928,4,17,8,11,57,45,12,59
Stranraer,3928,5,15,6,15,55,64,-9,51
East Fife,3928,6,13,4,19,47,64,-17,43
Airdrieon,3928,7,10,12,14,46,59,-13,42
Forfar,3928,8,10,6,20,39,65,-26,36
Albion,3928,9,8,6,22,57,82,-25,30
Queen's Park,3928,10,6,10,20,40,75,-35,28
Ayr,3929,1,24,4,8,96,44,52,76
Raith,3929,2,22,8,6,69,34,35,74
Alloa,3929,3,18,8,10,58,44,14,62
Arbroath,3929,4,17,8,11,70,49,21,59
Stranraer,3929,5,15,6,15,57,66,-9,51
Airdrieon,3929,6,11,11,14,49,58,-9,44
East Fife,3929,7,13,4,19,49,66,-17,43
Forfar,3929,8,10,5,21,38,68,-30,35
Queen's Park,3929,9,7,10,19,40,72,-32,31
Albion,3929,10,8,6,22,59,84,-25,30
Raith,3930,1,23,8,5,71,33,38,77
Ayr,3930,2,24,4,8,94,43,51,76
Arbroath,3930,3,17,8,11,70,49,21,59
Alloa,3930,4,17,8,11,57,46,11,59
Stranraer,3930,5,15,6,15,56,65,-9,51
East Fife,3930,6,13,4,19,48,65,-17,43
Airdrieon,3930,7,10,11,15,45,59,-14,41
Forfar,3930,8,11,5,20,39,64,-25,38
Queen's Park,3930,9,7,10,19,40,72,-32,31
Albion,3930,10,8,6,22,58,82,-24,30
Raith,3931,1,23,8,5,70,32,38,77
Ayr,3931,2,24,4,8,96,43,53,76
Arbroath,3931,3,17,8,11,70,49,21,59
Alloa,3931,4,17,8,11,56,45,11,59
Stranraer,3931,5,15,5,16,58,68,-10,50
East Fife,3931,6,14,3,19,51,67,-16,45
Airdrieon,3931,7,10,11,15,46,62,-16,41
Forfar,3931,8,11,5,20,42,65,-23,38
Queen's Park,3931,9,7,10,19,40,72,-32,31
Albion,3931,10,8,6,22,58,84,-26,30
Ayr,3932,1,24,4,8,96,43,53,76
Raith,3932,2,22,9,5,68,32,36,75
Arbroath,3932,3,18,8,10,71,48,23,62
Alloa,3932,4,17,9,10,56,43,13,60
Stranraer,3932,5,15,5,16,55,66,-11,50
East Fife,3932,6,14,3,19,49,64,-15,45
Airdrieon,3932,7,10,11,15,45,59,-14,41
Forfar,3932,8,11,5,20,39,64,-25,38
Albion,3932,9,8,6,22,58,84,-26,30
Queen's Park,3932,10,6,10,20,39,73,-34,28
Ayr,3933,1,24,4,8,94,44,50,76
Raith,3933,2,22,9,5,69,33,36,75
Arbroath,3933,3,18,8,10,72,49,23,62
Alloa,3933,4,17,9,10,57,44,13,60
Stranraer,3933,5,16,5,15,56,64,-8,53
Airdrieon,3933,6,11,11,14,46,58,-12,44
East Fife,3933,7,13,3,20,47,65,-18,42
Forfar,3933,8,10,5,21,38,65,-27,35
Albion,3933,9,8,6,22,59,82,-23,30
Queen's Park,3933,10,6,10,20,40,74,-34,28
Ayr,3934,1,24,4,8,95,42,53,76
Raith,3934,2,22,9,5,69,33,36,75
Arbroath,3934,3,18,8,10,74,51,23,62
Alloa,3934,4,17,9,10,57,44,13,60
Stranraer,3934,5,15,5,16,55,67,-12,50
East Fife,3934,6,14,3,19,50,64,-14,45
Airdrieon,3934,7,10,12,14,47,60,-13,42
Forfar,3934,8,10,6,20,40,66,-26,36
Albion,3934,9,8,6,22,57,83,-26,30
Queen's Park,3934,10,6,10,20,42,76,-34,28
Ayr,3935,1,24,4,8,94,44,50,76
Raith,3935,2,22,9,5,69,33,36,75
Arbroath,3935,3,17,9,10,71,49,22,60
Alloa,3935,4,17,9,10,57,44,13,60
Stranraer,3935,5,16,5,15,56,64,-8,53
Airdrieon,3935,6,10,12,14,46,59,-13,42
East Fife,3935,7,13,3,20,47,65,-18,42
Forfar,3935,8,10,6,20,39,65,-26,36
Albion,3935,9,8,6,22,59,82,-23,30
Queen's Park,3935,10,6,11,19,40,73,-33,29
Ayr,3936,1,24,4,8,95,42,53,76
Raith,3936,2,22,9,5,68,32,36,75
Arbroath,3936,3,17,9,10,70,48,22,60
Alloa,3936,4,17,9,10,56,43,13,60
Stranraer,3936,5,15,6,15,56,65,-9,51
Airdrieon,3936,6,11,11,14,49,60,-11,44
East Fife,3936,7,13,4,19,48,65,-17,43
Forfar,3936,8,10,5,21,40,68,-28,35
Albion,3936,9,8,6,22,57,83,-26,30
Queen's Park,3936,10,6,11,19,39,72,-33,29
Ayr,3937,1,24,4,8,93,44,49,76
Raith,3937,2,22,9,5,70,34,36,75
Arbroath,3937,3,18,8,10,72,48,24,62
Alloa,3937,4,17,9,10,58,45,13,60
Stranraer,3937,5,16,5,15,57,65,-8,53
Airdrieon,3937,6,11,11,14,47,59,-12,44
East Fife,3937,7,13,3,20,48,66,-18,42
Forfar,3937,8,10,5,21,39,66,-27,35
Albion,3937,9,8,6,22,59,81,-22,30
Queen's Park,3937,10,6,10,20,39,74,-35,28
Ayr,3938,1,23,5,8,90,42,48,74
Raith,3938,2,22,8,6,68,35,33,74
Arbroath,3938,3,18,8,10,74,49,25,62
Alloa,3938,4,18,8,10,59,43,16,62
Stranraer,3938,5,15,5,16,56,66,-10,50
East Fife,3938,6,14,3,19,49,65,-16,45
Airdrieon,3938,7,10,11,15,46,61,-15,41
Forfar,3938,8,11,5,20,41,65,-24,38
Albion,3938,9,8,7,21,57,78,-21,31
Queen's Park,3938,10,6,10,20,40,76,-36,28
Raith,3939,1,23,8,5,72,32,40,77
Ayr,3939,2,24,4,8,92,43,49,76
Arbroath,3939,3,17,9,10,72,50,22,60
Alloa,3939,4,17,8,11,56,47,9,59
Stranraer,3939,5,15,6,15,57,66,-9,51
East Fife,3939,6,13,4,19,49,66,-17,43
Airdrieon,3939,7,10,12,14,46,59,-13,42
Forfar,3939,8,10,6,20,39,65,-26,36
Albion,3939,9,8,6,22,58,80,-22,30
Queen's Park,3939,10,6,11,19,41,74,-33,29
Raith,3940,1,23,8,5,70,32,38,77
Ayr,3940,2,24,4,8,94,43,51,76
Arbroath,3940,3,17,8,11,70,49,21,59
Alloa,3940,4,17,8,11,56,45,11,59
Stranraer,3940,5,15,5,16,56,67,-11,50
East Fife,3940,6,14,3,19,50,65,-15,45
Airdrieon,3940,7,11,11,14,47,59,-12,44
Forfar,3940,8,10,5,21,39,66,-27,35
Queen's Park,3940,9,7,10,19,40,72,-32,31
Albion,3940,10,8,6,22,58,82,-24,30
Raith,3941,1,23,8,5,70,32,38,77
Ayr,3941,2,23,4,9,90,43,47,73
Arbroath,3941,3,18,8,10,71,48,23,62
Alloa,3941,4,17,8,11,56,45,11,59
Stranraer,3941,5,15,5,16,55,66,-11,50
East Fife,3941,6,14,3,19,49,64,-15,45
Airdrieon,3941,7,10,12,14,46,59,-13,42
Forfar,3941,8,10,6,20,39,65,-26,36
Albion,3941,9,9,6,21,58,78,-20,33
Queen's Park,3941,10,6,10,20,39,73,-34,28
Raith,3942,1,23,8,5,72,32,40,77
Ayr,3942,2,24,4,8,96,43,53,76
Arbroath,3942,3,17,9,10,72,50,22,60
Alloa,3942,4,17,8,11,56,47,9,59
Stranraer,3942,5,15,5,16,55,65,-10,50
East Fife,3942,6,14,3,19,48,64,-16,45
Airdrieon,3942,7,11,11,14,46,58,-12,44
Forfar,3942,8,10,5,21,38,65,-27,35
Albion,3942,9,8,6,22,58,84,-26,30
Queen's Park,3942,10,6,11,19,41,74,-33,29
Ayr,3943,1,24,4,8,92,42,50,76
Raith,3943,2,22,8,6,69,34,35,74
Alloa,3943,3,18,8,10,58,44,14,62
Arbroath,3943,4,17,8,11,71,50,21,59
Stranraer,3943,5,16,5,15,58,65,-7,53
Airdrieon,3943,6,11,11,14,47,58,-11,44
East Fife,3943,7,13,3,20,48,67,-19,42
Forfar,3943,8,10,5,21,38,66,-28,35
Queen's Park,3943,9,7,10,19,41,73,-32,31
Albion,3943,10,8,6,22,57,80,-23,30
Raith,3944,1,23,8,5,72,34,38,77
Ayr,3944,2,24,4,8,97,44,53,76
Arbroath,3944,3,18,8,10,74,48,26,62
Alloa,3944,4,17,8,11,58,47,11,59
Stranraer,3944,5,15,5,16,57,67,-10,50
East Fife,3944,6,14,3,19,50,66,-16,45
Airdrieon,3944,7,10,12,14,46,59,-13,42
Forfar,3944,8,10,6,20,39,65,-26,36
Albion,3944,9,8,6,22,59,85,-26,30
Queen's Park,3944,10,6,10,20,39,76,-37,28
Raith,3945,1,23,8,5,70,32,38,77
Ayr,3945,2,24,4,8,92,43,49,76
Arbroath,3945,3,18,8,10,73,48,25,62
Alloa,3945,4,17,8,11,56,45,11,59
Stranraer,3945,5,16,5,15,56,64,-8,53
Airdrieon,3945,6,11,11,14,47,59,-12,44
East Fife,3945,7,13,3,20,47,65,-18,42
Forfar,3945,8,10,5,21,39,66,-27,35
Albion,3945,9,8,6,22,58,80,-22,30
Queen's Park,3945,10,6,10,20,39,75,-36,28
Raith,3946,1,23,8,5,70,32,38,77
Ayr,3946,2,24,4,8,94,43,51,76
Arbroath,3946,3,18,8,10,72,48,24,62
Alloa,3946,4,17,8,11,56,45,11,59
Stranraer,3946,5,15,5,16,56,67,-11,50
East Fife,3946,6,14,3,19,50,65,-15,45
Airdrieon,3946,7,10,12,14,47,60,-13,42
Forfar,3946,8,10,6,20,40,66,-26,36
Albion,3946,9,8,6,22,58,82,-24,30
Queen's Park,3946,10,6,10,20,39,74,-35,28
Ayr,3947,1,24,4,8,92,42,50,76
Raith,3947,2,22,9,5,69,33,36,75
Alloa,3947,3,17,9,10,57,44,13,60
Arbroath,3947,4,17,8,11,70,51,19,59
Stranraer,3947,5,16,5,15,57,64,-7,53
Airdrieon,3947,6,10,12,14,45,58,-13,42
East Fife,3947,7,13,3,20,47,66,-19,42
Forfar,3947,8,10,6,20,38,64,-26,36
Queen's Park,3947,9,7,10,19,42,72,-30,31
Albion,3947,10,8,6,22,57,80,-23,30
Raith,3948,1,23,8,5,70,33,37,77
Ayr,3948,2,24,4,8,92,42,50,76
Arbroath,3948,3,18,8,10,76,49,27,62
Alloa,3948,4,17,8,11,57,45,12,59
Stranraer,3948,5,15,5,16,55,66,-11,50
East Fife,3948,6,14,3,19,49,64,-15,45
Airdrieon,3948,7,11,11,14,46,58,-12,44
Forfar,3948,8,10,5,21,38,65,-27,35
Albion,3948,9,8,6,22,57,80,-23,30
Queen's Park,3948,10,6,10,20,40,78,-38,28
Ayr,3949,1,24,4,8,95,44,51,76
Raith,3949,2,22,9,5,69,33,36,75
Alloa,3949,3,17,9,10,57,44,13,60
Arbroath,3949,4,17,8,11,70,50,20,59
Stranraer,3949,5,15,5,16,55,65,-10,50
East Fife,3949,6,14,3,19,48,64,-16,45
Airdrieon,3949,7,11,11,14,47,58,-11,44
Forfar,3949,8,10,5,21,38,66,-28,35
Queen's Park,3949,9,7,10,19,41,72,-31,31
Albion,3949,10,8,6,22,59,83,-24,30
Ayr,3950,1,24,4,8,97,43,54,76
Raith,3950,2,22,8,6,68,34,34,74
Alloa,3950,3,18,8,10,58,43,15,62
Arbroath,3950,4,17,8,11,70,50,20,59
Stranraer,3950,5,15,5,16,55,65,-10,50
East Fife,3950,6,14,3,19,48,64,-16,45
Airdrieon,3950,7,10,11,15,46,60,-14,41
Forfar,3950,8,11,5,20,40,65,-25,38
Queen's Park,3950,9,7,10,19,41,72,-31,31
Albion,3950,10,8,6,22,58,85,-27,30
Raith,3951,1,23,8,5,69,32,37,77
Ayr,3951,2,23,4,9,92,45,47,73
Arbroath,3951,3,17,8,11,70,49,21,59
Alloa,3951,4,17,8,11,56,44,12,59
Stranraer,3951,5,15,5,16,57,68,-11,50
East Fife,3951,6,14,3,19,51,66,-15,45
Airdrieon,3951,7,10,12,14,46,59,-13,42
Forfar,3951,8,10,6,20,39,65,-26,36
Albion,3951,9,9,6,21,60,80,-20,33
Queen's Park,3951,10,7,10,19,40,72,-32,31
Ayr,3952,1,24,4,8,93,42,51,76
Raith,3952,2,22,9,5,70,34,36,75
Arbroath,3952,3,17,9,10,71,49,22,60
Alloa,3952,4,17,9,10,58,45,13,60
Stranraer,3952,5,16,5,15,58,65,-7,53
Airdrieon,3952,6,10,12,14,48,61,-13,42
East Fife,3952,7,13,3,20,48,67,-19,42
Forfar,3952,8,10,6,20,41,67,-26,36
Albion,3952,9,8,6,22,57,81,-24,30
Queen's Park,3952,10,6,11,19,40,73,-33,29
Raith,3953,1,23,8,5,70,33,37,77
Ayr,3953,2,24,4,8,93,44,49,76
Arbroath,3953,3,18,8,10,71,48,23,62
Alloa,3953,4,17,8,11,57,45,12,59
Stranraer,3953,5,15,5,16,55,65,-10,50
East Fife,3953,6,14,3,19,48,64,-16,45
Airdrieon,3953,7,10,11,15,46,60,-14,41
Forfar,3953,8,11,5,20,40,65,-25,38
Albion,3953,9,8,6,22,59,81,-22,30
Queen's Park,3953,10,6,10,20,39,73,-34,28
Raith,3954,1,23,8,5,70,32,38,77
Ayr,3954,2,24,4,8,93,42,51,76
Arbroath,3954,3,17,8,11,71,50,21,59
Alloa,3954,4,17,8,11,56,45,11,59
Stranraer,3954,5,15,5,16,55,66,-11,50
East Fife,3954,6,14,3,19,49,64,-15,45
Airdrieon,3954,7,11,11,14,46,58,-12,44
Forfar,3954,8,10,5,21,38,65,-27,35
Queen's Park,3954,9,7,10,19,41,73,-32,31
Albion,3954,10,8,6,22,57,81,-24,30
Ayr,3955,1,24,4,8,96,42,54,76
Raith,3955,2,22,9,5,69,33,36,75
Alloa,3955,3,17,9,10,57,44,13,60
Arbroath,3955,4,17,8,11,71,50,21,59
Stranraer,3955,5,15,5,16,55,67,-12,50
East Fife,3955,6,14,3,19,50,64,-14,45
Airdrieon,3955,7,11,11,14,47,58,-11,44
Forfar,3955,8,10,5,21,38,66,-28,35
Queen's Park,3955,9,7,10,19,41,73,-32,31
Albion,3955,10,8,6,22,57,84,-27,30
Raith,3956,1,23,8,5,69,32,37,77
Ayr,3956,2,24,4,8,91,42,49,76
Arbroath,3956,3,18,8,10,74,49,25,62
Alloa,3956,4,17,8,11,56,44,12,59
Stranraer,3956,5,15,5,16,56,67,-11,50
East Fife,3956,6,14,3,19,50,65,-15,45
Airdrieon,3956,7,11,11,14,48,58,-10,44
Forfar,3956,8,10,5,21,38,67,-29,35
Albion,3956,9,8,6,22,57,79,-22,30
Queen's Park,3956,10,6,10,20,40,76,-36,28
Raith,3957,1,23,8,5,73,33,40,77
Ayr,3957,2,23,5,8,91,43,48,74
Arbroath,3957,3,17,9,10,72,50,22,60
Alloa,3957,4,17,8,11,57,48,9,59
Stranraer,3957,5,15,6,15,55,64,-9,51
Airdrieon,3957,6,11,11,14,46,58,-12,44
East Fife,3957,7,13,4,19,47,64,-17,43
Forfar,3957,8,10,5,21,38,65,-27,35
Albion,3957,9,8,7,21,58,79,-21,31
Queen's Park,3957,10,6,11,19,41,74,-33,29
Raith,3958,1,23,8,5,71,32,39,77
Ayr,3958,2,23,4,9,92,45,47,73
Arbroath,3958,3,17,9,10,72,50,22,60
Alloa,3958,4,17,8,11,56,46,10,59
Stranraer,3958,5,16,5,15,57,65,-8,53
East Fife,3958,6,13,3,20,48,66,-18,42
Airdrieon,3958,7,10,11,15,45,60,-15,41
Forfar,3958,8,11,5,20,40,64,-24,38
Albion,3958,9,9,6,21,60,80,-20,33
Queen's Park,3958,10,6,11,19,41,74,-33,29
Ayr,3959,1,24,4,8,95,44,51,76
Raith,3959,2,22,8,6,68,33,35,74
Alloa,3959,3,18,8,10,57,43,14,62
Arbroath,3959,4,17,9,10,70,48,22,60
Stranraer,3959,5,16,5,15,57,64,-7,53
East Fife,3959,6,13,3,20,47,66,-19,42
Airdrieon,3959,7,10,11,15,45,59,-14,41
Forfar,3959,8,11,5,20,39,64,-25,38
Albion,3959,9,8,6,22,59,83,-24,30
Queen's Park,3959,10,6,11,19,39,72,-33,29
Raith,3960,1,23,8,5,69,32,37,77
Ayr,3960,2,24,4,8,93,44,49,76
Arbroath,3960,3,18,8,10,73,49,24,62
Alloa,3960,4,17,8,11,56,44,12,59
Stranraer,3960,5,15,5,16,56,67,-11,50
East Fife,3960,6,14,3,19,50,65,-15,45
Airdrieon,3960,7,11,11,14,46,58,-12,44
Forfar,3960,8,10,5,21,38,65,-27,35
Albion,3960,9,8,6,22,59,81,-22,30
Queen's Park,3960,10,6,10,20,40,75,-35,28
Raith,3961,1,22,9,5,68,32,36,75
Ayr,3961,2,23,4,9,91,46,45,73
Alloa,3961,3,17,9,10,56,43,13,60
Arbroath,3961,4,17,8,11,70,50,20,59
Stranraer,3961,5,15,5,16,55,65,-10,50
East Fife,3961,6,14,3,19,48,64,-16,45
Airdrieon,3961,7,11,11,14,48,58,-10,44
Forfar,3961,8,10,5,21,38,67,-29,35
Albion,3961,9,9,6,21,61,79,-18,33
Queen's Park,3961,10,7,10,19,41,72,-31,31
Ayr,3962,1,24,4,8,94,42,52,76
Raith,3962,2,22,9,5,69,33,36,75
Alloa,3962,3,17,9,10,57,44,13,60
Arbroath,3962,4,17,8,11,72,51,21,59
Stranraer,3962,5,15,5,16,55,68,-13,50
East Fife,3962,6,14,3,19,51,64,-13,45
Airdrieon,3962,7,11,11,14,48,58,-10,44
Forfar,3962,8,10,5,21,38,67,-29,35
Queen's Park,3962,9,7,10,19,42,74,-32,31
Albion,3962,10,8,6,22,57,82,-25,30
Raith,3963,1,23,8,5,72,34,38,77
Ayr,3963,2,24,4,8,92,42,50,76
Arbroath,3963,3,17,8,11,71,50,21,59
Alloa,3963,4,17,8,11,58,47,11,59
Stranraer,3963,5,15,6,15,55,64,-9,51
Airdrieon,3963,6,11,11,14,48,59,-11,44
East Fife,3963,7,13,4,19,47,64,-17,43
Forfar,3963,8,10,5,21,39,67,-28,35
Queen's Park,3963,9,7,10,19,41,73,-32,31
Albion,3963,10,8,6,22,57,80,-23,30
Ayr,3964,1,24,4,8,92,43,49,76
Raith,3964,2,22,8,6,69,35,34,74
Alloa,3964,3,18,8,10,59,44,15,62
Arbroath,3964,4,17,9,10,71,49,22,60
Stranraer,3964,5,16,5,15,58,65,-7,53
Airdrieon,3964,6,10,12,14,46,59,-13,42
East Fife,3964,7,13,3,20,48,67,-19,42
Forfar,3964,8,10,6,20,39,65,-26,36
Albion,3964,9,8,6,22,58,80,-22,30
Queen's Park,3964,10,6,11,19,40,73,-33,29
Raith,3965,1,23,8,5,69,32,37,77
Ayr,3965,2,24,4,8,100,45,55,76
Arbroath,3965,3,18,8,10,73,50,23,62
Alloa,3965,4,17,8,11,56,44,12,59
Stranraer,3965,5,15,5,16,55,66,-11,50
East Fife,3965,6,14,3,19,49,64,-15,45
Airdrieon,3965,7,10,11,15,46,60,-14,41
Forfar,3965,8,11,5,20,40,65,-25,38
Albion,3965,9,8,6,22,60,88,-28,30
Queen's Park,3965,10,6,10,20,41,75,-34,28
Raith,3966,1,23,8,5,72,33,39,77
Ayr,3966,2,24,4,8,92,42,50,76
Arbroath,3966,3,18,8,10,76,50,26,62
Alloa,3966,4,17,8,11,57,47,10,59
Stranraer,3966,5,16,5,15,58,66,-8,53
Airdrieon,3966,6,11,11,14,47,59,-12,44
East Fife,3966,7,13,3,20,49,67,-18,42
Forfar,3966,8,10,5,21,39,66,-27,35
Albion,3966,9,8,6,22,57,80,-23,30
Queen's Park,3966,10,6,10,20,41,78,-37,28
Ayr,3967,1,24,4,8,97,43,54,76
Raith,3967,2,22,9,5,68,32,36,75
Arbroath,3967,3,18,8,10,72,49,23,62
Alloa,3967,4,17,9,10,56,43,13,60
Stranraer,3967,5,15,6,15,56,65,-9,51
East Fife,3967,6,13,4,19,48,65,-17,43
Airdrieon,3967,7,10,11,15,46,60,-14,41
Forfar,3967,8,11,5,20,40,65,-25,38
Albion,3967,9,8,6,22,58,85,-27,30
Queen's Park,3967,10,6,10,20,40,74,-34,28
Ayr,3968,1,24,4,8,93,44,49,76
Raith,3968,2,22,8,6,68,33,35,74
Alloa,3968,3,18,8,10,57,43,14,62
Arbroath,3968,4,17,8,11,71,51,20,59
Stranraer,3968,5,16,5,15,58,66,-8,53
Airdrieon,3968,6,11,11,14,49,58,-9,44
East Fife,3968,7,13,3,20,49,67,-18,42
Forfar,3968,8,10,5,21,38,68,-30,35
Queen's Park,3968,9,7,10,19,42,73,-31,31
Albion,3968,10,8,6,22,59,81,-22,30
Raith,3969,1,23,8,5,70,33,37,77
Ayr,3969,2,24,4,8,95,44,51,76
Arbroath,3969,3,18,8,10,73,48,25,62
Alloa,3969,4,17,8,11,57,45,12,59
Stranraer,3969,5,16,5,15,57,65,-8,53
Airdrieon,3969,6,10,12,14,47,60,-13,42
East Fife,3969,7,13,3,20,48,66,-18,42
Forfar,3969,8,10,6,20,40,66,-26,36
Albion,3969,9,8,6,22,59,83,-24,30
Queen's Park,3969,10,6,10,20,39,75,-36,28
Raith,3970,1,23,8,5,70,33,37,77
Ayr,3970,2,24,4,8,92,43,49,76
Arbroath,3970,3,17,8,11,72,54,18,59
Alloa,3970,4,17,8,11,57,45,12,59
Stranraer,3970,5,15,5,16,55,65,-10,50
East Fife,3970,6,14,3,19,48,64,-16,45
Airdrieon,3970,7,11,11,14,47,58,-11,44
Forfar,3970,8,10,5,21,38,66,-28,35
Queen's Park,3970,9,7,10,19,45,74,-29,31
Albion,3970,10,8,6,22,58,80,-22,30
Ayr,3971,1,23,5,8,93,45,48,74
Raith,3971,2,22,8,6,69,34,35,74
Alloa,3971,3,18,8,10,58,44,14,62
Arbroath,3971,4,17,8,11,71,53,18,59
Stranraer,3971,5,16,5,15,58,66,-8,53
Airdrieon,3971,6,11,11,14,46,58,-12,44
East Fife,3971,7,13,3,20,49,67,-18,42
Forfar,3971,8,10,5,21,38,65,-27,35
Albion,3971,9,8,7,21,60,81,-21,31
Queen's Park,3971,10,7,10,19,44,73,-29,31
Raith,3972,1,23,8,5,70,33,37,77
Ayr,3972,2,24,4,8,94,42,52,76
Arbroath,3972,3,18,8,10,76,51,25,62
Alloa,3972,4,17,8,11,57,45,12,59
Stranraer,3972,5,16,5,15,57,65,-8,53
East Fife,3972,6,13,3,20,48,66,-18,42
Airdrieon,3972,7,10,11,15,45,60,-15,41
Forfar,3972,8,11,5,20,40,64,-24,38
Albion,3972,9,8,6,22,57,82,-25,30
Queen's Park,3972,10,6,10,20,42,78,-36,28
Ayr,3973,1,24,4,8,92,42,50,76
Raith,3973,2,22,8,6,68,33,35,74
Arbroath,3973,3,18,8,10,74,48,26,62
Alloa,3973,4,18,8,10,57,43,14,62
Stranraer,3973,5,15,5,16,55,66,-11,50
East Fife,3973,6,14,3,19,49,64,-15,45
Airdrieon,3973,7,10,11,15,47,62,-15,41
Forfar,3973,8,11,5,20,42,66,-24,38
Albion,3973,9,8,6,22,57,80,-23,30
Queen's Park,3973,10,6,10,20,39,76,-37,28
Ayr,3974,1,24,4,8,93,42,51,76
Raith,3974,2,22,9,5,69,33,36,75
Arbroath,3974,3,18,8,10,74,49,25,62
Alloa,3974,4,17,9,10,57,44,13,60
Stranraer,3974,5,15,5,16,56,70,-14,50
East Fife,3974,6,14,3,19,53,65,-12,45
Airdrieon,3974,7,11,11,14,52,61,-9,44
Forfar,3974,8,10,5,21,41,71,-30,35
Albion,3974,9,8,6,22,57,81,-24,30
Queen's Park,3974,10,6,10,20,40,76,-36,28
Raith,3975,1,23,8,5,70,33,37,77
Ayr,3975,2,23,5,8,92,44,48,74
Arbroath,3975,3,18,8,10,73,49,24,62
Alloa,3975,4,17,8,11,57,45,12,59
Stranraer,3975,5,15,5,16,56,66,-10,50
East Fife,3975,6,14,3,19,49,65,-16,45
Airdrieon,3975,7,11,11,14,48,58,-10,44
Forfar,3975,8,10,5,21,38,67,-29,35
Albion,3975,9,8,7,21,59,80,-21,31
Queen's Park,3975,10,6,10,20,40,75,-35,28
Raith,3976,1,23,8,5,69,32,37,77
Ayr,3976,2,24,4,8,94,44,50,76
Arbroath,3976,3,17,9,10,70,48,22,60
Alloa,3976,4,17,8,11,56,44,12,59
Stranraer,3976,5,15,5,16,56,66,-10,50
East Fife,3976,6,14,3,19,49,65,-16,45
Airdrieon,3976,7,10,12,14,47,60,-13,42
Forfar,3976,8,10,6,20,40,66,-26,36
Albion,3976,9,8,6,22,59,82,-23,30
Queen's Park,3976,10,6,11,19,39,72,-33,29
Raith,3977,1,23,8,5,70,32,38,77
Ayr,3977,2,24,4,8,93,43,50,76
Arbroath,3977,3,18,8,10,73,50,23,62
Alloa,3977,4,17,8,11,56,45,11,59
Stranraer,3977,5,16,5,15,56,64,-8,53
East Fife,3977,6,13,3,20,47,65,-18,42
Airdrieon,3977,7,10,11,15,45,60,-15,41
Forfar,3977,8,11,5,20,40,64,-24,38
Albion,3977,9,8,6,22,58,81,-23,30
Queen's Park,3977,10,6,10,20,41,75,-34,28
Raith,3978,1,23,8,5,71,33,38,77
Ayr,3978,2,24,4,8,92,43,49,76
Arbroath,3978,3,18,8,10,71,48,23,62
Alloa,3978,4,17,8,11,57,46,11,59
Stranraer,3978,5,16,5,15,57,65,-8,53
Airdrieon,3978,6,11,11,14,50,58,-8,44
East Fife,3978,7,13,3,20,48,66,-18,42
Forfar,3978,8,10,5,21,38,69,-31,35
Albion,3978,9,8,6,22,58,80,-22,30
Queen's Park,3978,10,6,10,20,39,73,-34,28
Raith,3979,1,23,8,5,69,32,37,77
Ayr,3979,2,23,5,8,91,43,48,74
Arbroath,3979,3,18,8,10,72,49,23,62
Alloa,3979,4,17,8,11,56,44,12,59
Stranraer,3979,5,15,5,16,55,66,-11,50
East Fife,3979,6,14,3,19,49,64,-15,45
Airdrieon,3979,7,10,11,15,46,60,-14,41
Forfar,3979,8,11,5,20,40,65,-25,38
Albion,3979,9,8,7,21,58,79,-21,31
Queen's Park,3979,10,6,10,20,40,74,-34,28
Raith,3980,1,23,8,5,70,32,38,77
Ayr,3980,2,23,5,8,90,42,48,74
Arbroath,3980,3,18,8,10,74,50,24,62
Alloa,3980,4,17,8,11,56,45,11,59
Stranraer,3980,5,15,5,16,56,67,-11,50
East Fife,3980,6,14,3,19,50,65,-15,45
Airdrieon,3980,7,11,11,14,46,58,-12,44
Forfar,3980,8,10,5,21,38,65,-27,35
Albion,3980,9,8,7,21,57,78,-21,31
Queen's Park,3980,10,6,10,20,41,76,-35,28
Raith,3981,1,23,8,5,71,32,39,77
Ayr,3981,2,24,4,8,95,43,52,76
Arbroath,3981,3,17,8,11,71,51,20,59
Alloa,3981,4,17,8,11,56,46,10,59
Stranraer,3981,5,15,6,15,56,65,-9,51
Airdrieon,3981,6,11,11,14,46,58,-12,44
East Fife,3981,7,13,4,19,48,65,-17,43
Forfar,3981,8,10,5,21,38,65,-27,35
Queen's Park,3981,9,7,10,19,42,73,-31,31
Albion,3981,10,8,6,22,58,83,-25,30
Raith,3982,1,23,8,5,71,34,37,77
Ayr,3982,2,24,4,8,92,43,49,76
Arbroath,3982,3,18,8,10,71,48,23,62
Alloa,3982,4,17,8,11,58,46,12,59
Stranraer,3982,5,15,5,16,58,68,-10,50
East Fife,3982,6,14,3,19,51,67,-16,45
Airdrieon,3982,7,11,11,14,47,59,-12,44
Forfar,3982,8,10,5,21,39,66,-27,35
Albion,3982,9,8,6,22,58,80,-22,30
Queen's Park,3982,10,6,10,20,39,73,-34,28
Raith,3983,1,23,8,5,71,34,37,77
Ayr,3983,2,23,5,8,91,43,48,74
Arbroath,3983,3,17,8,11,71,50,21,59
Alloa,3983,4,17,8,11,58,46,12,59
Stranraer,3983,5,15,6,15,57,66,-9,51
Airdrieon,3983,6,11,11,14,47,58,-11,44
East Fife,3983,7,13,4,19,49,66,-17,43
Forfar,3983,8,10,5,21,38,66,-28,35
Albion,3983,9,8,7,21,58,79,-21,31
Queen's Park,3983,10,7,10,19,41,73,-32,31
Raith,3984,1,23,8,5,71,33,38,77
Ayr,3984,2,24,4,8,99,42,57,76
Arbroath,3984,3,18,8,10,72,48,24,62
Alloa,3984,4,17,8,11,57,46,11,59
Stranraer,3984,5,15,5,16,56,67,-11,50
East Fife,3984,6,14,3,19,50,65,-15,45
Airdrieon,3984,7,11,11,14,49,58,-9,44
Forfar,3984,8,10,5,21,38,68,-30,35
Albion,3984,9,8,6,22,57,87,-30,30
Queen's Park,3984,10,6,10,20,39,74,-35,28
Raith,3985,1,23,8,5,69,32,37,77
Ayr,3985,2,24,4,8,94,45,49,76
Arbroath,3985,3,17,9,10,71,49,22,60
Alloa,3985,4,17,8,11,56,44,12,59
Stranraer,3985,5,15,6,15,58,67,-9,51
Airdrieon,3985,6,11,11,14,46,58,-12,44
East Fife,3985,7,13,4,19,50,67,-17,43
Forfar,3985,8,10,5,21,38,65,-27,35
Albion,3985,9,8,6,22,60,82,-22,30
Queen's Park,3985,10,6,11,19,40,73,-33,29
Raith,3986,1,23,8,5,70,33,37,77
Ayr,3986,2,24,4,8,92,42,50,76
Arbroath,3986,3,17,8,11,70,49,21,59
Alloa,3986,4,17,8,11,57,45,12,59
Stranraer,3986,5,15,6,15,56,65,-9,51
East Fife,3986,6,13,4,19,48,65,-17,43
Airdrieon,3986,7,10,11,15,46,60,-14,41
Forfar,3986,8,11,5,20,40,65,-25,38
Queen's Park,3986,9,7,10,19,40,72,-32,31
Albion,3986,10,8,6,22,57,80,-23,30
Raith,3987,1,23,8,5,70,32,38,77
Ayr,3987,2,24,4,8,95,44,51,76
Arbroath,3987,3,17,8,11,71,50,21,59
Alloa,3987,4,17,8,11,56,45,11,59
Stranraer,3987,5,15,5,16,56,68,-12,50
East Fife,3987,6,14,3,19,51,65,-14,45
Airdrieon,3987,7,11,11,14,47,58,-11,44
Forfar,3987,8,10,5,21,38,66,-28,35
Queen's Park,3987,9,7,10,19,41,73,-32,31
Albion,3987,10,8,6,22,59,83,-24,30
Raith,3988,1,23,8,5,69,32,37,77
Ayr,3988,2,23,4,9,90,44,46,73
Arbroath,3988,3,18,8,10,73,48,25,62
Alloa,3988,4,17,8,11,56,44,12,59
Stranraer,3988,5,15,5,16,56,66,-10,50
East Fife,3988,6,14,3,19,49,65,-16,45
Airdrieon,3988,7,11,11,14,46,58,-12,44
Forfar,3988,8,10,5,21,38,65,-27,35
Albion,3988,9,9,6,21,59,78,-19,33
Queen's Park,3988,10,6,10,20,39,75,-36,28
Raith,3989,1,23,8,5,70,33,37,77
Ayr,3989,2,24,4,8,92,43,49,76
Arbroath,3989,3,17,9,10,71,49,22,60
Alloa,3989,4,17,8,11,57,45,12,59
Stranraer,3989,5,15,5,16,57,67,-10,50
East Fife,3989,6,14,3,19,50,66,-16,45
Airdrieon,3989,7,11,11,14,46,58,-12,44
Forfar,3989,8,10,5,21,38,65,-27,35
Albion,3989,9,8,6,22,58,80,-22,30
Queen's Park,3989,10,6,11,19,40,73,-33,29
Raith,3990,1,23,8,5,70,33,37,77
Ayr,3990,2,24,4,8,94,42,52,76
Arbroath,3990,3,17,8,11,70,50,20,59
Alloa,3990,4,17,8,11,57,45,12,59
Stranraer,3990,5,15,5,16,55,68,-13,50
East Fife,3990,6,14,3,19,51,64,-13,45
Airdrieon,3990,7,10,12,14,45,58,-13,42
Forfar,3990,8,10,6,20,38,64,-26,36
Queen's Park,3990,9,7,10,19,41,72,-31,31
Albion,3990,10,8,6,22,57,82,-25,30
Ayr,3991,1,24,4,8,91,42,49,76
Raith,3991,2,22,9,5,69,33,36,75
Alloa,3991,3,17,9,10,57,44,13,60
Arbroath,3991,4,17,8,11,71,50,21,59
Stranraer,3991,5,15,6,15,56,65,-9,51
East Fife,3991,6,13,4,19,48,65,-17,43
Airdrieon,3991,7,10,12,14,48,61,-13,42
Forfar,3991,8,10,6,20,41,67,-26,36
Queen's Park,3991,9,7,10,19,41,73,-32,31
Albion,3991,10,8,6,22,57,79,-22,30
Raith,3992,1,22,9,5,69,33,36,75
Ayr,3992,2,23,4,9,93,46,47,73
Alloa,3992,3,17,9,10,57,44,13,60
Arbroath,3992,4,17,8,11,71,51,20,59
Stranraer,3992,5,16,5,15,56,64,-8,53
Airdrieon,3992,6,11,11,14,47,59,-12,44
East Fife,3992,7,13,3,20,47,65,-18,42
Forfar,3992,8,10,5,21,39,66,-27,35
Albion,3992,9,9,6,21,61,81,-20,33
Queen's Park,3992,10,7,10,19,42,73,-31,31
Ayr,3993,1,24,4,8,94,43,51,76
Raith,3993,2,22,9,5,69,33,36,75
Alloa,3993,3,17,9,10,57,44,13,60
Arbroath,3993,4,17,8,11,71,50,21,59
Stranraer,3993,5,16,5,15,57,64,-7,53
Airdrieon,3993,6,11,11,14,48,58,-10,44
East Fife,3993,7,13,3,20,47,66,-19,42
Forfar,3993,8,10,5,21,38,67,-29,35
Queen's Park,3993,9,7,10,19,41,73,-32,31
Albion,3993,10,8,6,22,58,82,-24,30
Raith,3994,1,23,8,5,70,32,38,77
Ayr,3994,2,24,4,8,96,42,54,76
Arbroath,3994,3,17,9,10,71,49,22,60
Alloa,3994,4,17,8,11,56,45,11,59
Stranraer,3994,5,15,5,16,55,65,-10,50
East Fife,3994,6,14,3,19,48,64,-16,45
Airdrieon,3994,7,10,11,15,45,61,-16,41
Forfar,3994,8,11,5,20,41,64,-23,38
Albion,3994,9,8,6,22,57,84,-27,30
Queen's Park,3994,10,6,11,19,40,73,-33,29
Ayr,3995,1,24,4,8,95,42,53,76
Raith,3995,2,22,8,6,69,34,35,74
Alloa,3995,3,18,8,10,58,44,14,62
Arbroath,3995,4,17,9,10,71,49,22,60
Stranraer,3995,5,15,6,15,56,65,-9,51
East Fife,3995,6,13,4,19,48,65,-17,43
Airdrieon,3995,7,10,11,15,46,60,-14,41
Forfar,3995,8,11,5,20,40,65,-25,38
Albion,3995,9,8,6,22,57,83,-26,30
Queen's Park,3995,10,6,11,19,40,73,-33,29
Raith,3996,1,23,8,5,72,32,40,77
Ayr,3996,2,24,4,8,91,42,49,76
Arbroath,3996,3,18,8,10,73,48,25,62
Alloa,3996,4,17,8,11,56,47,9,59
Stranraer,3996,5,15,5,16,55,65,-10,50
East Fife,3996,6,14,3,19,48,64,-16,45
Airdrieon,3996,7,10,12,14,45,58,-13,42
Forfar,3996,8,10,6,20,38,64,-26,36
Albion,3996,9,8,6,22,57,79,-22,30
Queen's Park,3996,10,6,10,20,39,75,-36,28
Ayr,3997,1,24,4,8,97,42,55,76
Raith,3997,2,22,8,6,69,35,34,74
Alloa,3997,3,18,8,10,59,44,15,62
Arbroath,3997,4,17,8,11,70,49,21,59
Stranraer,3997,5,15,6,15,56,65,-9,51
Airdrieon,3997,6,11,11,14,46,58,-12,44
East Fife,3997,7,13,4,19,48,65,-17,43
Forfar,3997,8,10,5,21,38,65,-27,35
Queen's Park,3997,9,7,10,19,40,72,-32,31
Albion,3997,10,8,6,22,57,85,-28,30
Raith,3998,1,23,8,5,70,32,38,77
Ayr,3998,2,24,4,8,93,44,49,76
Arbroath,3998,3,17,9,10,70,48,22,60
Alloa,3998,4,17,8,11,56,45,11,59
Stranraer,3998,5,15,6,15,56,65,-9,51
East Fife,3998,6,13,4,19,48,65,-17,43
Airdrieon,3998,7,10,12,14,45,58,-13,42
Forfar,3998,8,10,6,20,38,64,-26,36
Albion,3998,9,8,6,22,59,81,-22,30
Queen's Park,3998,10,6,11,19,39,72,-33,29
Raith,3999,1,23,8,5,69,32,37,77
Ayr,3999,2,24,4,8,91,42,49,76
Arbroath,3999,3,17,8,11,70,49,21,59
Alloa,3999,4,17,8,11,56,44,12,59
Stranraer,3999,5,15,5,16,57,67,-10,50
East Fife,3999,6,14,3,19,50,66,-16,45
Airdrieon,3999,7,10,12,14,45,58,-13,42
Forfar,3999,8,10,6,20,38,64,-26,36
Queen's Park,3999,9,7,10,19,40,72,-32,31
Albion,3999,10,8,6,22,57,79,-22,30
Ayr,4000,1,24,4,8,96,44,52,76
Raith,4000,2,22,9,5,69,33,36,75
Arbroath,4000,3,17,9,10,72,50,22,60
Alloa,4000,4,17,9,10,57,44,13,60
Stranraer,4000,5,15,5,16,56,66,-10,50
East Fife,4000,6,14,3,19,49,65,-16,45
Airdrieon,4000,7,10,12,14,48,61,-13,42
Forfar,4000,8,10,6,20,41,67,-26,36
Albion,4000,9,8,6,22,59,84,-25,30
Queen's Park,4000,10,6,11,19,41,74,-33,29
Ayr,4001,1,24,4,8,95,42,53,76
Raith,4001,2,22,9,5,69,33,36,75
Alloa,4001,3,17,9,10,57,44,13,60
Arbroath,4001,4,17,8,11,73,53,20,59
Stranraer,4001,5,16,5,15,59,64,-5,53
Airdrieon,4001,6,11,11,14,47,58,-11,44
East Fife,4001,7,13,3,20,47,68,-21,42
Forfar,4001,8,10,5,21,38,66,-28,35
Queen's Park,4001,9,7,10,19,44,75,-31,31
Albion,4001,10,8,6,22,57,83,-26,30
Ayr,4002,1,24,4,8,97,45,52,76
Raith,4002,2,22,8,6,69,34,35,74
Alloa,4002,3,18,8,10,58,44,14,62
Arbroath,4002,4,17,9,10,70,48,22,60
Stranraer,4002,5,15,5,16,55,65,-10,50
East Fife,4002,6,14,3,19,48,64,-16,45
Airdrieon,4002,7,10,11,15,47,61,-14,41
Forfar,4002,8,11,5,20,41,66,-25,38
Albion,4002,9,8,6,22,60,85,-25,30
Queen's Park,4002,10,6,11,19,39,72,-33,29
Ayr,4003,1,23,5,8,91,43,48,74
Raith,4003,2,22,8,6,68,33,35,74
Arbroath,4003,3,18,8,10,74,49,25,62
Alloa,4003,4,18,8,10,57,43,14,62
Stranraer,4003,5,15,6,15,56,65,-9,51
East Fife,4003,6,13,4,19,48,65,-17,43
Airdrieon,4003,7,10,12,14,47,60,-13,42
Forfar,4003,8,10,6,20,40,66,-26,36
Albion,4003,9,8,7,21,58,79,-21,31
Queen's Park,4003,10,6,10,20,40,76,-36,28
Raith,4004,1,23,8,5,70,33,37,77
Ayr,4004,2,24,4,8,98,44,54,76
Arbroath,4004,3,17,8,11,72,51,21,59
Alloa,4004,4,17,8,11,57,45,12,59
Stranraer,4004,5,15,6,15,56,65,-9,51
East Fife,4004,6,13,4,19,48,65,-17,43
Airdrieon,4004,7,10,12,14,45,58,-13,42
Forfar,4004,8,10,6,20,38,64,-26,36
Queen's Park,4004,9,7,10,19,42,74,-32,31
Albion,4004,10,8,6,22,59,86,-27,30
Raith,4005,1,23,8,5,71,33,38,77
Ayr,4005,2,23,5,8,90,42,48,74
Arbroath,4005,3,18,8,10,71,48,23,62
Alloa,4005,4,17,8,11,57,46,11,59
Stranraer,4005,5,15,5,16,56,67,-11,50
East Fife,4005,6,14,3,19,50,65,-15,45
Airdrieon,4005,7,10,11,15,47,61,-14,41
Forfar,4005,8,11,5,20,41,66,-25,38
Albion,4005,9,8,7,21,57,78,-21,31
Queen's Park,4005,10,6,10,20,39,73,-34,28
Raith,4006,1,23,8,5,71,33,38,77
Ayr,4006,2,24,4,8,93,42,51,76
Arbroath,4006,3,18,8,10,75,48,27,62
Alloa,4006,4,17,8,11,57,46,11,59
Stranraer,4006,5,15,5,16,57,69,-12,50
East Fife,4006,6,14,3,19,52,66,-14,45
Airdrieon,4006,7,10,11,15,45,61,-16,41
Forfar,4006,8,11,5,20,41,64,-23,38
Albion,4006,9,8,6,22,57,81,-24,30
Queen's Park,4006,10,6,10,20,39,77,-38,28
Raith,4007,1,23,8,5,71,34,37,77
Ayr,4007,2,23,4,9,90,44,46,73
Arbroath,4007,3,17,9,10,71,49,22,60
Alloa,4007,4,17,8,11,58,46,12,59
Stranraer,4007,5,15,6,15,55,64,-9,51
Airdrieon,4007,6,11,11,14,47,59,-12,44
East Fife,4007,7,13,4,19,47,64,-17,43
Forfar,4007,8,10,5,21,39,66,-27,35
Albion,4007,9,9,6,21,59,78,-19,33
Queen's Park,4007,10,6,11,19,40,73,-33,29
Raith,4008,1,23,8,5,70,32,38,77
Ayr,4008,2,23,4,9,91,44,47,73
Arbroath,4008,3,17,8,11,71,50,21,59
Alloa,4008,4,17,8,11,56,45,11,59
Stranraer,4008,5,15,5,16,56,66,-10,50
East Fife,4008,6,14,3,19,49,65,-16,45
Airdrieon,4008,7,10,12,14,45,58,-13,42
Forfar,4008,8,10,6,20,38,64,-26,36
Albion,4008,9,9,6,21,59,79,-20,33
Queen's Park,4008,10,7,10,19,41,73,-32,31
Ayr,4009,1,24,4,8,92,42,50,76
Raith,4009,2,22,9,5,69,33,36,75
Arbroath,4009,3,18,8,10,74,48,26,62
Alloa,4009,4,17,9,10,57,44,13,60
Stranraer,4009,5,15,5,16,55,65,-10,50
East Fife,4009,6,14,3,19,48,64,-16,45
Airdrieon,4009,7,10,11,15,46,60,-14,41
Forfar,4009,8,11,5,20,40,65,-25,38
Albion,4009,9,8,6,22,57,80,-23,30
Queen's Park,4009,10,6,10,20,39,76,-37,28
Ayr,4010,1,24,4,8,93,42,51,76
Raith,4010,2,22,9,5,69,33,36,75
Arbroath,4010,3,18,8,10,72,49,23,62
Alloa,4010,4,17,9,10,57,44,13,60
Stranraer,4010,5,15,6,15,56,65,-9,51
Airdrieon,4010,6,11,11,14,46,58,-12,44
East Fife,4010,7,13,4,19,48,65,-17,43
Forfar,4010,8,10,5,21,38,65,-27,35
Albion,4010,9,8,6,22,57,81,-24,30
Queen's Park,4010,10,6,10,20,40,74,-34,28
Ayr,4011,1,24,4,8,94,42,52,76
Raith,4011,2,22,9,5,68,32,36,75
Arbroath,4011,3,17,9,10,72,50,22,60
Alloa,4011,4,17,9,10,56,43,13,60
Stranraer,4011,5,15,5,16,56,66,-10,50
East Fife,4011,6,14,3,19,49,65,-16,45
Airdrieon,4011,7,11,11,14,49,61,-12,44
Forfar,4011,8,10,5,21,41,68,-27,35
Albion,4011,9,8,6,22,57,82,-25,30
Queen's Park,4011,10,6,11,19,41,74,-33,29
Ayr,4012,1,24,4,8,93,42,51,76
Raith,4012,2,22,9,5,69,33,36,75
Arbroath,4012,3,17,9,10,71,49,22,60
Alloa,4012,4,17,9,10,57,44,13,60
Stranraer,4012,5,15,5,16,56,67,-11,50
East Fife,4012,6,14,3,19,50,65,-15,45
Airdrieon,4012,7,11,11,14,49,59,-10,44
Forfar,4012,8,10,5,21,39,68,-29,35
Albion,4012,9,8,6,22,57,81,-24,30
Queen's Park,4012,10,6,11,19,40,73,-33,29
Raith,4013,1,23,8,5,69,32,37,77
Ayr,4013,2,24,4,8,94,43,51,76
Arbroath,4013,3,17,8,11,71,50,21,59
Alloa,4013,4,17,8,11,56,44,12,59
Stranraer,4013,5,15,6,15,56,65,-9,51
Airdrieon,4013,6,11,11,14,47,59,-12,44
East Fife,4013,7,13,4,19,48,65,-17,43
Forfar,4013,8,10,5,21,39,66,-27,35
Queen's Park,4013,9,7,10,19,41,73,-32,31
Albion,4013,10,8,6,22,58,82,-24,30
Raith,4014,1,23,8,5,70,32,38,77
Ayr,4014,2,24,4,8,96,46,50,76
Arbroath,4014,3,17,8,11,70,49,21,59
Alloa,4014,4,17,8,11,56,45,11,59
Stranraer,4014,5,16,5,15,56,64,-8,53
East Fife,4014,6,13,3,20,47,65,-18,42
Airdrieon,4014,7,10,11,15,45,61,-16,41
Forfar,4014,8,11,5,20,41,64,-23,38
Queen's Park,4014,9,7,10,19,40,72,-32,31
Albion,4014,10,8,6,22,61,84,-23,30
Ayr,4015,1,24,4,8,93,44,49,76
Raith,4015,2,22,9,5,69,33,36,75
Arbroath,4015,3,18,8,10,73,49,24,62
Alloa,4015,4,17,9,10,57,44,13,60
Stranraer,4015,5,15,6,15,56,65,-9,51
Airdrieon,4015,6,11,11,14,47,59,-12,44
East Fife,4015,7,13,4,19,48,65,-17,43
Forfar,4015,8,10,5,21,39,66,-27,35
Albion,4015,9,8,6,22,59,81,-22,30
Queen's Park,4015,10,6,10,20,40,75,-35,28
Raith,4016,1,23,8,5,71,33,38,77
Ayr,4016,2,24,4,8,95,43,52,76
Arbroath,4016,3,18,8,10,71,48,23,62
Alloa,4016,4,17,8,11,57,46,11,59
Stranraer,4016,5,16,5,15,57,65,-8,53
Airdrieon,4016,6,10,12,14,46,59,-13,42
East Fife,4016,7,13,3,20,48,66,-18,42
Forfar,4016,8,10,6,20,39,65,-26,36
Albion,4016,9,8,6,22,58,83,-25,30
Queen's Park,4016,10,6,10,20,39,73,-34,28
Raith,4017,1,23,8,5,69,32,37,77
Ayr,4017,2,24,4,8,92,43,49,76
Arbroath,4017,3,17,9,10,72,50,22,60
Alloa,4017,4,17,8,11,56,44,12,59
Stranraer,4017,5,15,5,16,55,67,-12,50
East Fife,4017,6,14,3,19,50,64,-14,45
Airdrieon,4017,7,10,11,15,46,60,-14,41
Forfar,4017,8,11,5,20,40,65,-25,38
Albion,4017,9,8,6,22,58,80,-22,30
Queen's Park,4017,10,6,11,19,41,74,-33,29
Raith,4018,1,22,8,6,68,33,35,74
Ayr,4018,2,23,4,9,91,44,47,73
Alloa,4018,3,18,8,10,57,43,14,62
Arbroath,4018,4,17,9,10,71,49,22,60
Stranraer,4018,5,15,6,15,56,65,-9,51
Airdrieon,4018,6,11,11,14,47,59,-12,44
East Fife,4018,7,13,4,19,48,65,-17,43
Forfar,4018,8,10,5,21,39,66,-27,35
Albion,4018,9,9,6,21,59,79,-20,33
Queen's Park,4018,10,6,11,19,40,73,-33,29
Ayr,4019,1,24,4,8,93,42,51,76
Raith,4019,2,22,8,6,68,35,33,74
Alloa,4019,3,18,8,10,59,43,16,62
Arbroath,4019,4,17,8,11,71,50,21,59
Stranraer,4019,5,15,5,16,55,65,-10,50
East Fife,4019,6,14,3,19,48,64,-16,45
Airdrieon,4019,7,10,11,15,47,63,-16,41
Forfar,4019,8,11,5,20,43,66,-23,38
Queen's Park,4019,9,7,10,19,41,73,-32,31
Albion,4019,10,8,6,22,57,81,-24,30
Raith,4020,1,22,9,5,70,34,36,75
Ayr,4020,2,23,5,8,93,45,48,74
Arbroath,4020,3,18,8,10,72,48,24,62
Alloa,4020,4,17,9,10,58,45,13,60
Stranraer,4020,5,16,5,15,58,64,-6,53
Airdrieon,4020,6,10,12,14,46,59,-13,42
East Fife,4020,7,13,3,20,47,67,-20,42
Forfar,4020,8,10,6,20,39,65,-26,36
Albion,4020,9,8,7,21,60,81,-21,31
Queen's Park,4020,10,6,10,20,39,74,-35,28
Raith,4021,1,23,8,5,69,32,37,77
Ayr,4021,2,24,4,8,94,43,51,76
Arbroath,4021,3,17,8,11,70,49,21,59
Alloa,4021,4,17,8,11,56,44,12,59
Stranraer,4021,5,15,6,15,56,65,-9,51
East Fife,4021,6,13,4,19,48,65,-17,43
Airdrieon,4021,7,10,11,15,45,59,-14,41
Forfar,4021,8,11,5,20,39,64,-25,38
Queen's Park,4021,9,7,10,19,40,72,-32,31
Albion,4021,10,8,6,22,58,82,-24,30
Ayr,4022,1,24,4,8,93,42,51,76
Raith,4022,2,22,9,5,69,33,36,75
Arbroath,4022,3,17,9,10,71,49,22,60
Alloa,4022,4,17,9,10,57,44,13,60
Stranraer,4022,5,16,5,15,58,64,-6,53
Airdrieon,4022,6,11,11,14,47,58,-11,44
East Fife,4022,7,13,3,20,47,67,-20,42
Forfar,4022,8,10,5,21,38,66,-28,35
Albion,4022,9,8,6,22,57,81,-24,30
Queen's Park,4022,10,6,11,19,40,73,-33,29
Ayr,4023,1,24,4,8,94,43,51,76
Raith,4023,2,22,9,5,69,33,36,75
Arbroath,4023,3,18,8,10,73,48,25,62
Alloa,4023,4,17,9,10,57,44,13,60
Stranraer,4023,5,16,5,15,58,66,-8,53
Airdrieon,4023,6,11,11,14,47,58,-11,44
East Fife,4023,7,13,3,20,49,67,-18,42
Forfar,4023,8,10,5,21,38,66,-28,35
Albion,4023,9,8,6,22,58,82,-24,30
Queen's Park,4023,10,6,10,20,39,75,-36,28
Ayr,4024,1,24,4,8,96,45,51,76
Raith,4024,2,22,9,5,68,32,36,75
Arbroath,4024,3,17,9,10,71,49,22,60
Alloa,4024,4,17,9,10,56,43,13,60
Stranraer,4024,5,15,5,16,55,66,-11,50
East Fife,4024,6,14,3,19,49,64,-15,45
Airdrieon,4024,7,11,11,14,48,59,-11,44
Forfar,4024,8,10,5,21,39,67,-28,35
Albion,4024,9,8,6,22,60,84,-24,30
Queen's Park,4024,10,6,11,19,40,73,-33,29
Raith,4025,1,23,8,5,69,32,37,77
Ayr,4025,2,24,4,8,96,43,53,76
Arbroath,4025,3,17,8,11,70,49,21,59
Alloa,4025,4,17,8,11,56,44,12,59
Stranraer,4025,5,15,5,16,55,65,-10,50
East Fife,4025,6,14,3,19,48,64,-16,45
Airdrieon,4025,7,10,11,15,46,60,-14,41
Forfar,4025,8,11,5,20,40,65,-25,38
Queen's Park,4025,9,7,10,19,40,72,-32,31
Albion,4025,10,8,6,22,58,84,-26,30
Raith,4026,1,22,9,5,69,33,36,75
Ayr,4026,2,23,5,8,93,45,48,74
Alloa,4026,3,17,9,10,57,44,13,60
Arbroath,4026,4,17,8,11,73,52,21,59
Stranraer,4026,5,15,6,15,56,65,-9,51
Airdrieon,4026,6,11,11,14,46,58,-12,44
East Fife,4026,7,13,4,19,48,65,-17,43
Forfar,4026,8,10,5,21,38,65,-27,35
Albion,4026,9,8,7,21,60,81,-21,31
Queen's Park,4026,10,7,10,19,43,75,-32,31
Raith,4027,1,23,8,5,70,33,37,77
Ayr,4027,2,24,4,8,93,43,50,76
Arbroath,4027,3,18,8,10,74,50,24,62
Alloa,4027,4,17,8,11,57,45,12,59
Stranraer,4027,5,15,5,16,55,66,-11,50
East Fife,4027,6,14,3,19,49,64,-15,45
Airdrieon,4027,7,11,11,14,46,58,-12,44
Forfar,4027,8,10,5,21,38,65,-27,35
Albion,4027,9,8,6,22,58,81,-23,30
Queen's Park,4027,10,6,10,20,41,76,-35,28
Ayr,4028,1,24,4,8,93,43,50,76
Raith,4028,2,22,9,5,68,32,36,75
Arbroath,4028,3,18,8,10,72,48,24,62
Alloa,4028,4,17,9,10,56,43,13,60
Stranraer,4028,5,16,5,15,58,64,-6,53
East Fife,4028,6,13,3,20,47,67,-20,42
Airdrieon,4028,7,10,11,15,45,59,-14,41
Forfar,4028,8,11,5,20,39,64,-25,38
Albion,4028,9,8,6,22,58,81,-23,30
Queen's Park,4028,10,6,10,20,39,74,-35,28
Raith,4029,1,23,8,5,70,32,38,77
Ayr,4029,2,23,4,9,92,45,47,73
Arbroath,4029,3,18,8,10,72,48,24,62
Alloa,4029,4,17,8,11,56,45,11,59
Stranraer,4029,5,15,6,15,55,64,-9,51
East Fife,4029,6,13,4,19,47,64,-17,43
Airdrieon,4029,7,10,12,14,46,59,-13,42
Forfar,4029,8,10,6,20,39,65,-26,36
Albion,4029,9,9,6,21,60,80,-20,33
Queen's Park,4029,10,6,10,20,39,74,-35,28
Ayr,4030,1,24,4,8,93,42,51,76
Raith,4030,2,22,9,5,70,34,36,75
Alloa,4030,3,17,9,10,58,45,13,60
Arbroath,4030,4,17,8,11,71,50,21,59
Stranraer,4030,5,15,5,16,55,66,-11,50
East Fife,4030,6,14,3,19,49,64,-15,45
Airdrieon,4030,7,11,11,14,46,58,-12,44
Forfar,4030,8,10,5,21,38,65,-27,35
Queen's Park,4030,9,7,10,19,41,73,-32,31
Albion,4030,10,8,6,22,57,81,-24,30
Ayr,4031,1,24,4,8,93,44,49,76
Raith,4031,2,22,8,6,68,33,35,74
Alloa,4031,3,18,8,10,57,43,14,62
Arbroath,4031,4,17,9,10,72,50,22,60
Stranraer,4031,5,15,6,15,56,65,-9,51
East Fife,4031,6,13,4,19,48,65,-17,43
Airdrieon,4031,7,10,11,15,45,61,-16,41
Forfar,4031,8,11,5,20,41,64,-23,38
Albion,4031,9,8,6,22,59,81,-22,30
Queen's Park,4031,10,6,11,19,41,74,-33,29
Raith,4032,1,23,8,5,70,33,37,77
Ayr,4032,2,23,5,8,91,43,48,74
Arbroath,4032,3,18,8,10,76,48,28,62
Alloa,4032,4,17,8,11,57,45,12,59
Stranraer,4032,5,16,5,15,57,65,-8,53
Airdrieon,4032,6,11,11,14,48,58,-10,44
East Fife,4032,7,13,3,20,48,66,-18,42
Forfar,4032,8,10,5,21,38,67,-29,35
Albion,4032,9,8,7,21,58,79,-21,31
Queen's Park,4032,10,6,10,20,39,78,-39,28
Raith,4033,1,23,8,5,71,34,37,77
Ayr,4033,2,24,4,8,94,44,50,76
Arbroath,4033,3,18,8,10,72,49,23,62
Alloa,4033,4,17,8,11,58,46,12,59
Stranraer,4033,5,16,5,15,58,65,-7,53
East Fife,4033,6,13,3,20,48,67,-19,42
Airdrieon,4033,7,10,11,15,45,60,-15,41
Forfar,4033,8,11,5,20,40,64,-24,38
Albion,4033,9,8,6,22,59,82,-23,30
Queen's Park,4033,10,6,10,20,40,74,-34,28
Raith,4034,1,23,8,5,70,32,38,77
Ayr,4034,2,24,4,8,95,45,50,76
Arbroath,4034,3,17,8,11,72,51,21,59
Alloa,4034,4,17,8,11,56,45,11,59
Stranraer,4034,5,15,5,16,56,67,-11,50
East Fife,4034,6,14,3,19,50,65,-15,45
Airdrieon,4034,7,11,11,14,47,58,-11,44
Forfar,4034,8,10,5,21,38,66,-28,35
Queen's Park,4034,9,7,10,19,42,74,-32,31
Albion,4034,10,8,6,22,60,83,-23,30
Raith,4035,1,23,8,5,69,32,37,77
Ayr,4035,2,24,4,8,97,42,55,76
Arbroath,4035,3,18,8,10,73,49,24,62
Alloa,4035,4,17,8,11,56,44,12,59
Stranraer,4035,5,15,6,15,55,64,-9,51
Airdrieon,4035,6,11,11,14,47,58,-11,44
East Fife,4035,7,13,4,19,47,64,-17,43
Forfar,4035,8,10,5,21,38,66,-28,35
Albion,4035,9,8,6,22,57,85,-28,30
Queen's Park,4035,10,6,10,20,40,75,-35,28
Raith,4036,1,23,8,5,71,34,37,77
Ayr,4036,2,24,4,8,91,42,49,76
Arbroath,4036,3,17,9,10,72,50,22,60
Alloa,4036,4,17,8,11,58,46,12,59
Stranraer,4036,5,15,5,16,55,65,-10,50
East Fife,4036,6,14,3,19,48,64,-16,45
Airdrieon,4036,7,11,11,14,46,58,-12,44
Forfar,4036,8,10,5,21,38,65,-27,35
Albion,4036,9,8,6,22,57,79,-22,30
Queen's Park,4036,10,6,11,19,41,74,-33,29
Raith,4037,1,22,8,6,70,35,35,74
Ayr,4037,2,23,4,9,92,45,47,73
Alloa,4037,3,18,8,10,59,45,14,62
Arbroath,4037,4,17,9,10,72,50,22,60
Stranraer,4037,5,15,6,15,56,65,-9,51
East Fife,4037,6,13,4,19,48,65,-17,43
Airdrieon,4037,7,10,11,15,45,59,-14,41
Forfar,4037,8,11,5,20,39,64,-25,38
Albion,4037,9,9,6,21,60,80,-20,33
Queen's Park,4037,10,6,11,19,41,74,-33,29
Raith,4038,1,22,9,5,69,33,36,75
Ayr,4038,2,23,4,9,93,46,47,73
Alloa,4038,3,17,9,10,57,44,13,60
Arbroath,4038,4,17,8,11,71,54,17,59
Stranraer,4038,5,15,5,16,55,67,-12,50
East Fife,4038,6,14,3,19,50,64,-14,45
Airdrieon,4038,7,11,11,14,48,59,-11,44
Forfar,4038,8,10,5,21,39,67,-28,35
Albion,4038,9,9,6,21,61,81,-20,33
Queen's Park,4038,10,7,10,19,45,73,-28,31
Raith,4039,1,23,8,5,71,33,38,77
Ayr,4039,2,24,4,8,94,43,51,76
Arbroath,4039,3,17,8,11,70,49,21,59
Alloa,4039,4,17,8,11,57,46,11,59
Stranraer,4039,5,16,5,15,57,65,-8,53
Airdrieon,4039,6,11,11,14,49,58,-9,44
East Fife,4039,7,13,3,20,48,66,-18,42
Forfar,4039,8,10,5,21,38,68,-30,35
Queen's Park,4039,9,7,10,19,40,72,-32,31
Albion,4039,10,8,6,22,58,82,-24,30
Raith,4040,1,23,8,5,70,33,37,77
Ayr,4040,2,23,5,8,93,45,48,74
Arbroath,4040,3,18,8,10,73,49,24,62
Alloa,4040,4,17,8,11,57,45,12,59
Stranraer,4040,5,15,6,15,55,64,-9,51
Airdrieon,4040,6,11,11,14,46,58,-12,44
East Fife,4040,7,13,4,19,47,64,-17,43
Forfar,4040,8,10,5,21,38,65,-27,35
Albion,4040,9,8,7,21,60,81,-21,31
Queen's Park,4040,10,6,10,20,40,75,-35,28
Ayr,4041,1,24,4,8,96,42,54,76
Raith,4041,2,22,9,5,69,33,36,75
Arbroath,4041,3,18,8,10,72,49,23,62
Alloa,4041,4,17,9,10,57,44,13,60
Stranraer,4041,5,16,5,15,58,65,-7,53
Airdrieon,4041,6,11,11,14,49,58,-9,44
East Fife,4041,7,13,3,20,48,67,-19,42
Forfar,4041,8,10,5,21,38,68,-30,35
Albion,4041,9,8,6,22,57,84,-27,30
Queen's Park,4041,10,6,10,20,40,74,-34,28
Raith,4042,1,23,8,5,70,33,37,77
Ayr,4042,2,24,4,8,95,43,52,76
Arbroath,4042,3,18,8,10,72,48,24,62
Alloa,4042,4,17,8,11,57,45,12,59
Stranraer,4042,5,15,5,16,57,67,-10,50
East Fife,4042,6,14,3,19,50,66,-16,45
Airdrieon,4042,7,10,12,14,47,60,-13,42
Forfar,4042,8,10,6,20,40,66,-26,36
Albion,4042,9,8,6,22,58,83,-25,30
Queen's Park,4042,10,6,10,20,39,74,-35,28
Ayr,4043,1,24,4,8,93,43,50,76
Raith,4043,2,22,8,6,68,33,35,74
Alloa,4043,3,18,8,10,57,43,14,62
Arbroath,4043,4,17,9,10,71,49,22,60
Stranraer,4043,5,15,5,16,56,68,-12,50
East Fife,4043,6,14,3,19,51,65,-14,45
Airdrieon,4043,7,10,12,14,46,59,-13,42
Forfar,4043,8,10,6,20,39,65,-26,36
Albion,4043,9,8,6,22,58,81,-23,30
Queen's Park,4043,10,6,11,19,40,73,-33,29
Raith,4044,1,22,9,5,68,32,36,75
Ayr,4044,2,23,5,8,92,44,48,74
Arbroath,4044,3,18,8,10,73,49,24,62
Alloa,4044,4,17,9,10,56,43,13,60
Stranraer,4044,5,16,5,15,56,64,-8,53
Airdrieon,4044,6,11,11,14,49,59,-10,44
East Fife,4044,7,13,3,20,47,65,-18,42
Forfar,4044,8,10,5,21,39,68,-29,35
Albion,4044,9,8,7,21,59,80,-21,31
Queen's Park,4044,10,6,10,20,40,75,-35,28
Raith,4045,1,23,8,5,70,32,38,77
Ayr,4045,2,24,4,8,95,43,52,76
Arbroath,4045,3,17,8,11,70,49,21,59
Alloa,4045,4,17,8,11,56,45,11,59
Stranraer,4045,5,16,5,15,58,65,-7,53
Airdrieon,4045,6,11,11,14,49,58,-9,44
East Fife,4045,7,13,3,20,48,67,-19,42
Forfar,4045,8,10,5,21,38,68,-30,35
Queen's Park,4045,9,7,10,19,40,72,-32,31
Albion,4045,10,8,6,22,58,83,-25,30
Ayr,4046,1,24,4,8,96,42,54,76
Raith,4046,2,22,9,5,68,32,36,75
Arbroath,4046,3,18,8,10,72,48,24,62
Alloa,4046,4,17,9,10,56,43,13,60
Stranraer,4046,5,16,5,15,57,64,-7,53
Airdrieon,4046,6,11,11,14,50,62,-12,44
East Fife,4046,7,13,3,20,47,66,-19,42
Forfar,4046,8,10,5,21,42,69,-27,35
Albion,4046,9,8,6,22,57,84,-27,30
Queen's Park,4046,10,6,10,20,39,74,-35,28
Raith,4047,1,23,8,5,70,33,37,77
Ayr,4047,2,23,4,9,91,45,46,73
Arbroath,4047,3,17,9,10,72,50,22,60
Alloa,4047,4,17,8,11,57,45,12,59
Stranraer,4047,5,16,5,15,59,64,-5,53
Airdrieon,4047,6,10,12,14,46,59,-13,42
East Fife,4047,7,13,3,20,47,68,-21,42
Forfar,4047,8,10,6,20,39,65,-26,36
Albion,4047,9,9,6,21,60,79,-19,33
Queen's Park,4047,10,6,11,19,41,74,-33,29
Raith,4048,1,23,8,5,70,33,37,77
Ayr,4048,2,24,4,8,94,44,50,76
Arbroath,4048,3,18,8,10,72,48,24,62
Alloa,4048,4,17,8,11,57,45,12,59
Stranraer,4048,5,15,5,16,56,69,-13,50
East Fife,4048,6,14,3,19,52,65,-13,45
Airdrieon,4048,7,10,11,15,45,60,-15,41
Forfar,4048,8,11,5,20,40,64,-24,38
Albion,4048,9,8,6,22,59,82,-23,30
Queen's Park,4048,10,6,10,20,39,74,-35,28
Ayr,4049,1,24,4,8,92,43,49,76
Raith,4049,2,22,9,5,69,33,36,75
Arbroath,4049,3,18,8,10,71,48,23,62
Alloa,4049,4,17,9,10,57,44,13,60
Stranraer,4049,5,15,6,15,56,65,-9,51
Airdrieon,4049,6,11,11,14,47,59,-12,44
East Fife,4049,7,13,4,19,48,65,-17,43
Forfar,4049,8,10,5,21,39,66,-27,35
Albion,4049,9,8,6,22,58,80,-22,30
Queen's Park,4049,10,6,10,20,39,73,-34,28
Raith,4050,1,23,8,5,71,32,39,77
Ayr,4050,2,24,4,8,95,45,50,76
Arbroath,4050,3,17,8,11,71,50,21,59
Alloa,4050,4,17,8,11,56,46,10,59
Stranraer,4050,5,15,6,15,57,66,-9,51
East Fife,4050,6,13,4,19,49,66,-17,43
Airdrieon,4050,7,10,11,15,45,63,-18,41
Forfar,4050,8,11,5,20,43,64,-21,38
Queen's Park,4050,9,7,10,19,41,73,-32,31
Albion,4050,10,8,6,22,60,83,-23,30
Raith,4051,1,23,8,5,71,33,38,77
Ayr,4051,2,24,4,8,96,44,52,76
Arbroath,4051,3,18,8,10,72,48,24,62
Alloa,4051,4,17,8,11,57,46,11,59
Stranraer,4051,5,15,5,16,55,67,-12,50
East Fife,4051,6,14,3,19,50,64,-14,45
Airdrieon,4051,7,11,11,14,47,59,-12,44
Forfar,4051,8,10,5,21,39,66,-27,35
Albion,4051,9,8,6,22,59,84,-25,30
Queen's Park,4051,10,6,10,20,39,74,-35,28
Raith,4052,1,23,8,5,70,32,38,77
Ayr,4052,2,24,4,8,94,44,50,76
Arbroath,4052,3,17,9,10,71,49,22,60
Alloa,4052,4,17,8,11,56,45,11,59
Stranraer,4052,5,15,5,16,57,67,-10,50
East Fife,4052,6,14,3,19,50,66,-16,45
Airdrieon,4052,7,11,11,14,47,59,-12,44
Forfar,4052,8,10,5,21,39,66,-27,35
Albion,4052,9,8,6,22,59,82,-23,30
Queen's Park,4052,10,6,11,19,40,73,-33,29
Raith,4053,1,23,8,5,71,33,38,77
Ayr,4053,2,23,5,8,91,43,48,74
Arbroath,4053,3,17,8,11,71,51,20,59
Alloa,4053,4,17,8,11,57,46,11,59
Stranraer,4053,5,15,5,16,55,65,-10,50
East Fife,4053,6,14,3,19,48,64,-16,45
Airdrieon,4053,7,10,12,14,45,58,-13,42
Forfar,4053,8,10,6,20,38,64,-26,36
Albion,4053,9,8,7,21,58,79,-21,31
Queen's Park,4053,10,7,10,19,42,73,-31,31
Raith,4054,1,23,8,5,71,33,38,77
Ayr,4054,2,24,4,8,95,42,53,76
Arbroath,4054,3,18,8,10,72,48,24,62
Alloa,4054,4,17,8,11,57,46,11,59
Stranraer,4054,5,15,5,16,55,67,-12,50
East Fife,4054,6,14,3,19,50,64,-14,45
Airdrieon,4054,7,10,11,15,46,62,-16,41
Forfar,4054,8,11,5,20,42,65,-23,38
Albion,4054,9,8,6,22,57,83,-26,30
Queen's Park,4054,10,6,10,20,39,74,-35,28
Ayr,4055,1,24,4,8,91,42,49,76
Raith,4055,2,22,9,5,70,34,36,75
Arbroath,4055,3,18,8,10,71,48,23,62
Alloa,4055,4,17,9,10,58,45,13,60
Stranraer,4055,5,15,5,16,55,65,-10,50
East Fife,4055,6,14,3,19,48,64,-16,45
Airdrieon,4055,7,10,12,14,46,59,-13,42
Forfar,4055,8,10,6,20,39,65,-26,36
Albion,4055,9,8,6,22,57,79,-22,30
Queen's Park,4055,10,6,10,20,39,73,-34,28
Raith,4056,1,23,8,5,71,32,39,77
Ayr,4056,2,24,4,8,95,43,52,76
Arbroath,4056,3,18,8,10,73,50,23,62
Alloa,4056,4,17,8,11,56,46,10,59
Stranraer,4056,5,16,5,15,57,65,-8,53
Airdrieon,4056,6,11,11,14,47,58,-11,44
East Fife,4056,7,13,3,20,48,66,-18,42
Forfar,4056,8,10,5,21,38,66,-28,35
Albion,4056,9,8,6,22,58,83,-25,30
Queen's Park,4056,10,6,10,20,41,75,-34,28
Ayr,4057,1,23,5,8,91,43,48,74
Raith,4057,2,22,8,6,69,34,35,74
Alloa,4057,3,18,8,10,58,44,14,62
Arbroath,4057,4,17,9,10,71,49,22,60
Stranraer,4057,5,15,5,16,55,69,-14,50
East Fife,4057,6,14,3,19,52,64,-12,45
Airdrieon,4057,7,10,12,14,46,59,-13,42
Forfar,4057,8,10,6,20,39,65,-26,36
Albion,4057,9,8,7,21,58,79,-21,31
Queen's Park,4057,10,6,11,19,40,73,-33,29
Raith,4058,1,23,8,5,71,32,39,77
Ayr,4058,2,24,4,8,97,42,55,76
Arbroath,4058,3,17,9,10,72,50,22,60
Alloa,4058,4,17,8,11,56,46,10,59
Stranraer,4058,5,15,5,16,56,67,-11,50
East Fife,4058,6,14,3,19,50,65,-15,45
Airdrieon,4058,7,10,11,15,45,62,-17,41
Forfar,4058,8,11,5,20,42,64,-22,38
Albion,4058,9,8,6,22,57,85,-28,30
Queen's Park,4058,10,6,11,19,41,74,-33,29
Raith,4059,1,23,8,5,69,32,37,77
Ayr,4059,2,23,5,8,93,45,48,74
Arbroath,4059,3,17,8,11,71,50,21,59
Alloa,4059,4,17,8,11,56,44,12,59
Stranraer,4059,5,15,5,16,56,66,-10,50
East Fife,4059,6,14,3,19,49,65,-16,45
Airdrieon,4059,7,11,11,14,48,58,-10,44
Forfar,4059,8,10,5,21,38,67,-29,35
Albion,4059,9,8,7,21,60,81,-21,31
Queen's Park,4059,10,7,10,19,41,73,-32,31
Raith,4060,1,23,8,5,73,35,38,77
Ayr,4060,2,24,4,8,93,44,49,76
Arbroath,4060,3,17,8,11,70,50,20,59
Alloa,4060,4,17,8,11,59,48,11,59
Stranraer,4060,5,15,5,16,56,69,-13,50
East Fife,4060,6,14,3,19,52,65,-13,45
Airdrieon,4060,7,10,12,14,45,58,-13,42
Forfar,4060,8,10,6,20,38,64,-26,36
Queen's Park,4060,9,7,10,19,41,72,-31,31
Albion,4060,10,8,6,22,59,81,-22,30
Ayr,4061,1,24,4,8,93,42,51,76
Raith,4061,2,22,8,6,68,33,35,74
Alloa,4061,3,18,8,10,57,43,14,62
Arbroath,4061,4,17,8,11,70,50,20,59
Stranraer,4061,5,15,5,16,55,67,-12,50
East Fife,4061,6,14,3,19,50,64,-14,45
Airdrieon,4061,7,11,11,14,48,59,-11,44
Forfar,4061,8,10,5,21,39,67,-28,35
Queen's Park,4061,9,7,10,19,41,72,-31,31
Albion,4061,10,8,6,22,57,81,-24,30
Raith,4062,1,22,8,6,68,33,35,74
Ayr,4062,2,23,4,9,92,45,47,73
Arbroath,4062,3,18,8,10,73,48,25,62
Alloa,4062,4,18,8,10,57,43,14,62
Stranraer,4062,5,16,5,15,56,64,-8,53
Airdrieon,4062,6,10,12,14,46,59,-13,42
East Fife,4062,7,13,3,20,47,65,-18,42
Forfar,4062,8,10,6,20,39,65,-26,36
Albion,4062,9,9,6,21,60,80,-20,33
Queen's Park,4062,10,6,10,20,39,75,-36,28
Raith,4063,1,23,8,5,70,33,37,77
Ayr,4063,2,24,4,8,91,42,49,76
Arbroath,4063,3,18,8,10,71,48,23,62
Alloa,4063,4,17,8,11,57,45,12,59
Stranraer,4063,5,15,6,15,57,66,-9,51
Airdrieon,4063,6,11,11,14,49,61,-12,44
East Fife,4063,7,13,4,19,49,66,-17,43
Forfar,4063,8,10,5,21,41,68,-27,35
Albion,4063,9,8,6,22,57,79,-22,30
Queen's Park,4063,10,6,10,20,39,73,-34,28
Raith,4064,1,23,8,5,71,33,38,77
Ayr,4064,2,24,4,8,95,43,52,76
Arbroath,4064,3,17,8,11,71,50,21,59
Alloa,4064,4,17,8,11,57,46,11,59
Stranraer,4064,5,16,5,15,56,64,-8,53
East Fife,4064,6,13,3,20,47,65,-18,42
Airdrieon,4064,7,10,11,15,45,59,-14,41
Forfar,4064,8,11,5,20,39,64,-25,38
Queen's Park,4064,9,7,10,19,41,73,-32,31
Albion,4064,10,8,6,22,58,83,-25,30
Ayr,4065,1,24,4,8,94,44,50,76
Raith,4065,2,22,9,5,68,32,36,75
Arbroath,4065,3,18,8,10,72,49,23,62
Alloa,4065,4,17,9,10,56,43,13,60
Stranraer,4065,5,15,5,16,56,66,-10,50
East Fife,4065,6,14,3,19,49,65,-16,45
Airdrieon,4065,7,11,11,14,48,59,-11,44
Forfar,4065,8,10,5,21,39,67,-28,35
Albion,4065,9,8,6,22,59,82,-23,30
Queen's Park,4065,10,6,10,20,40,74,-34,28
Raith,4066,1,23,8,5,71,32,39,77
Ayr,4066,2,24,4,8,95,44,51,76
Arbroath,4066,3,18,8,10,71,48,23,62
Alloa,4066,4,17,8,11,56,46,10,59
Stranraer,4066,5,15,5,16,57,67,-10,50
East Fife,4066,6,14,3,19,50,66,-16,45
Airdrieon,4066,7,10,12,14,47,60,-13,42
Forfar,4066,8,10,6,20,40,66,-26,36
Albion,4066,9,8,6,22,59,83,-24,30
Queen's Park,4066,10,6,10,20,39,73,-34,28
Raith,4067,1,23,8,5,69,32,37,77
Ayr,4067,2,24,4,8,95,45,50,76
Arbroath,4067,3,18,8,10,72,49,23,62
Alloa,4067,4,17,8,11,56,44,12,59
Stranraer,4067,5,15,5,16,57,67,-10,50
East Fife,4067,6,14,3,19,50,66,-16,45
Airdrieon,4067,7,11,11,14,46,58,-12,44
Forfar,4067,8,10,5,21,38,65,-27,35
Albion,4067,9,8,6,22,60,83,-23,30
Queen's Park,4067,10,6,10,20,40,74,-34,28
Raith,4068,1,23,8,5,70,32,38,77
Ayr,4068,2,24,4,8,94,42,52,76
Arbroath,4068,3,17,8,11,70,50,20,59
Alloa,4068,4,17,8,11,56,45,11,59
Stranraer,4068,5,15,5,16,55,67,-12,50
East Fife,4068,6,14,3,19,50,64,-14,45
Airdrieon,4068,7,11,11,14,49,58,-9,44
Forfar,4068,8,10,5,21,38,68,-30,35
Queen's Park,4068,9,7,10,19,41,72,-31,31
Albion,4068,10,8,6,22,57,82,-25,30
Ayr,4069,1,24,4,8,94,43,51,76
Raith,4069,2,22,9,5,68,32,36,75
Arbroath,4069,3,17,9,10,71,49,22,60
Alloa,4069,4,17,9,10,56,43,13,60
Stranraer,4069,5,15,5,16,55,65,-10,50
East Fife,4069,6,14,3,19,48,64,-16,45
Airdrieon,4069,7,10,12,14,47,60,-13,42
Forfar,4069,8,10,6,20,40,66,-26,36
Albion,4069,9,8,6,22,58,82,-24,30
Queen's Park,4069,10,6,11,19,40,73,-33,29
Ayr,4070,1,24,4,8,95,42,53,76
Raith,4070,2,22,8,6,68,35,33,74
Alloa,4070,3,18,8,10,59,43,16,62
Arbroath,4070,4,17,8,11,71,51,20,59
Stranraer,4070,5,16,5,15,58,64,-6,53
Airdrieon,4070,6,11,11,14,50,59,-9,44
East Fife,4070,7,13,3,20,47,67,-20,42
Forfar,4070,8,10,5,21,39,69,-30,35
Queen's Park,4070,9,7,10,19,42,73,-31,31
Albion,4070,10,8,6,22,57,83,-26,30
Ayr,4071,1,24,4,8,94,44,50,76
Raith,4071,2,22,8,6,68,33,35,74
Arbroath,4071,3,18,8,10,76,48,28,62
Alloa,4071,4,18,8,10,57,43,14,62
Stranraer,4071,5,16,5,15,58,64,-6,53
Airdrieon,4071,6,11,11,14,47,58,-11,44
East Fife,4071,7,13,3,20,47,67,-20,42
Forfar,4071,8,10,5,21,38,66,-28,35
Albion,4071,9,8,6,22,59,82,-23,30
Queen's Park,4071,10,6,10,20,39,78,-39,28
Raith,4072,1,23,8,5,71,34,37,77
Ayr,4072,2,24,4,8,94,43,51,76
Arbroath,4072,3,18,8,10,74,48,26,62
Alloa,4072,4,17,8,11,58,46,12,59
Stranraer,4072,5,15,5,16,55,65,-10,50
East Fife,4072,6,14,3,19,48,64,-16,45
Airdrieon,4072,7,11,11,14,49,59,-10,44
Forfar,4072,8,10,5,21,39,68,-29,35
Albion,4072,9,8,6,22,58,82,-24,30
Queen's Park,4072,10,6,10,20,39,76,-37,28
Raith,4073,1,23,8,5,71,33,38,77
Ayr,4073,2,24,4,8,92,43,49,76
Arbroath,4073,3,18,8,10,74,51,23,62
Alloa,4073,4,17,8,11,57,46,11,59
Stranraer,4073,5,15,6,15,55,64,-9,51
East Fife,4073,6,13,4,19,47,64,-17,43
Airdrieon,4073,7,10,11,15,47,61,-14,41
Forfar,4073,8,11,5,20,41,66,-25,38
Albion,4073,9,8,6,22,58,80,-22,30
Queen's Park,4073,10,6,10,20,42,76,-34,28
Ayr,4074,1,24,4,8,92,43,49,76
Raith,4074,2,22,8,6,70,35,35,74
Arbroath,4074,3,18,8,10,72,49,23,62
Alloa,4074,4,18,8,10,59,45,14,62
Stranraer,4074,5,15,6,15,59,68,-9,51
Airdrieon,4074,6,11,11,14,49,58,-9,44
East Fife,4074,7,13,4,19,51,68,-17,43
Forfar,4074,8,10,5,21,38,68,-30,35
Albion,4074,9,8,6,22,58,80,-22,30
Queen's Park,4074,10,6,10,20,40,74,-34,28
Ayr,4075,1,24,4,8,95,42,53,76
Raith,4075,2,22,8,6,68,33,35,74
Alloa,4075,3,18,8,10,57,43,14,62
Arbroath,4075,4,17,9,10,71,49,22,60
Stranraer,4075,5,15,5,16,56,67,-11,50
East Fife,4075,6,14,3,19,50,65,-15,45
Airdrieon,4075,7,11,11,14,48,59,-11,44
Forfar,4075,8,10,5,21,39,67,-28,35
Albion,4075,9,8,6,22,57,83,-26,30
Queen's Park,4075,10,6,11,19,40,73,-33,29
Raith,4076,1,23,8,5,71,33,38,77
Ayr,4076,2,24,4,8,93,43,50,76
Arbroath,4076,3,17,9,10,71,49,22,60
Alloa,4076,4,17,8,11,57,46,11,59
Stranraer,4076,5,15,5,16,57,67,-10,50
East Fife,4076,6,14,3,19,50,66,-16,45
Airdrieon,4076,7,10,11,15,45,60,-15,41
Forfar,4076,8,11,5,20,40,64,-24,38
Albion,4076,9,8,6,22,58,81,-23,30
Queen's Park,4076,10,6,11,19,40,73,-33,29
Raith,4077,1,23,8,5,71,33,38,77
Ayr,4077,2,24,4,8,95,45,50,76
Arbroath,4077,3,17,8,11,70,51,19,59
Alloa,4077,4,17,8,11,57,46,11,59
Stranraer,4077,5,16,5,15,56,64,-8,53
Airdrieon,4077,6,11,11,14,47,59,-12,44
East Fife,4077,7,13,3,20,47,65,-18,42
Forfar,4077,8,10,5,21,39,66,-27,35
Queen's Park,4077,9,7,10,19,42,72,-30,31
Albion,4077,10,8,6,22,60,83,-23,30
Raith,4078,1,23,8,5,71,33,38,77
Ayr,4078,2,24,4,8,95,45,50,76
Arbroath,4078,3,18,8,10,74,48,26,62
Alloa,4078,4,17,8,11,57,46,11,59
Stranraer,4078,5,15,6,15,56,65,-9,51
Airdrieon,4078,6,11,11,14,47,59,-12,44
East Fife,4078,7,13,4,19,48,65,-17,43
Forfar,4078,8,10,5,21,39,66,-27,35
Albion,4078,9,8,6,22,60,83,-23,30
Queen's Park,4078,10,6,10,20,39,76,-37,28
Raith,4079,1,23,8,5,69,32,37,77
Ayr,4079,2,24,4,8,92,42,50,76
Arbroath,4079,3,18,8,10,72,49,23,62
Alloa,4079,4,17,8,11,56,44,12,59
Stranraer,4079,5,16,5,15,58,65,-7,53
Airdrieon,4079,6,10,12,14,46,59,-13,42
East Fife,4079,7,13,3,20,48,67,-19,42
Forfar,4079,8,10,6,20,39,65,-26,36
Albion,4079,9,8,6,22,57,80,-23,30
Queen's Park,4079,10,6,10,20,40,74,-34,28
Raith,4080,1,23,8,5,70,32,38,77
Ayr,4080,2,23,5,8,93,45,48,74
Arbroath,4080,3,18,8,10,75,51,24,62
Alloa,4080,4,17,8,11,56,45,11,59
Stranraer,4080,5,15,5,16,55,66,-11,50
East Fife,4080,6,14,3,19,49,64,-15,45
Airdrieon,4080,7,10,12,14,45,58,-13,42
Forfar,4080,8,10,6,20,38,64,-26,36
Albion,4080,9,8,7,21,60,81,-21,31
Queen's Park,4080,10,6,10,20,42,77,-35,28
Raith,4081,1,23,8,5,69,32,37,77
Ayr,4081,2,23,5,8,94,46,48,74
Arbroath,4081,3,18,8,10,72,48,24,62
Alloa,4081,4,17,8,11,56,44,12,59
Stranraer,4081,5,15,6,15,57,66,-9,51
Airdrieon,4081,6,11,11,14,46,58,-12,44
East Fife,4081,7,13,4,19,49,66,-17,43
Forfar,4081,8,10,5,21,38,65,-27,35
Albion,4081,9,8,7,21,61,82,-21,31
Queen's Park,4081,10,6,10,20,39,74,-35,28
Ayr,4082,1,24,4,8,97,45,52,76
Raith,4082,2,22,9,5,69,33,36,75
Arbroath,4082,3,17,9,10,72,50,22,60
Alloa,4082,4,17,9,10,57,44,13,60
Stranraer,4082,5,16,5,15,57,65,-8,53
Airdrieon,4082,6,11,11,14,49,59,-10,44
East Fife,4082,7,13,3,20,48,66,-18,42
Forfar,4082,8,10,5,21,39,68,-29,35
Albion,4082,9,8,6,22,60,85,-25,30
Queen's Park,4082,10,6,11,19,41,74,-33,29
Ayr,4083,1,24,4,8,94,43,51,76
Raith,4083,2,22,9,5,69,33,36,75
Alloa,4083,3,17,9,10,57,44,13,60
Arbroath,4083,4,17,8,11,71,50,21,59
Stranraer,4083,5,15,6,15,55,64,-9,51
East Fife,4083,6,13,4,19,47,64,-17,43
Airdrieon,4083,7,10,11,15,45,59,-14,41
Forfar,4083,8,11,5,20,39,64,-25,38
Queen's Park,4083,9,7,10,19,41,73,-32,31
Albion,4083,10,8,6,22,58,82,-24,30
Ayr,4084,1,24,4,8,93,43,50,76
Raith,4084,2,22,8,6,68,34,34,74
Arbroath,4084,3,18,8,10,72,49,23,62
Alloa,4084,4,18,8,10,58,43,15,62
Stranraer,4084,5,15,5,16,56,68,-12,50
East Fife,4084,6,14,3,19,51,65,-14,45
Airdrieon,4084,7,11,11,14,47,58,-11,44
Forfar,4084,8,10,5,21,38,66,-28,35
Albion,4084,9,8,6,22,58,81,-23,30
Queen's Park,4084,10,6,10,20,40,74,-34,28
Ayr,4085,1,24,4,8,94,43,51,76
Raith,4085,2,22,8,6,70,35,35,74
Alloa,4085,3,18,8,10,59,45,14,62
Arbroath,4085,4,17,8,11,71,50,21,59
Stranraer,4085,5,15,5,16,55,66,-11,50
East Fife,4085,6,14,3,19,49,64,-15,45
Airdrieon,4085,7,11,11,14,47,59,-12,44
Forfar,4085,8,10,5,21,39,66,-27,35
Queen's Park,4085,9,7,10,19,41,73,-32,31
Albion,4085,10,8,6,22,58,82,-24,30
Raith,4086,1,22,8,6,68,34,34,74
Ayr,4086,2,23,4,9,91,45,46,73
Alloa,4086,3,18,8,10,58,43,15,62
Arbroath,4086,4,17,9,10,72,50,22,60
Stranraer,4086,5,16,5,15,58,65,-7,53
Airdrieon,4086,6,11,11,14,48,59,-11,44
East Fife,4086,7,13,3,20,48,67,-19,42
Forfar,4086,8,10,5,21,39,67,-28,35
Albion,4086,9,9,6,21,60,79,-19,33
Queen's Park,4086,10,6,11,19,41,74,-33,29
Raith,4087,1,23,8,5,71,32,39,77
Ayr,4087,2,23,4,9,94,48,46,73
Arbroath,4087,3,18,8,10,71,48,23,62
Alloa,4087,4,17,8,11,56,46,10,59
Stranraer,4087,5,15,5,16,57,70,-13,50
East Fife,4087,6,14,3,19,53,66,-13,45
Airdrieon,4087,7,11,11,14,48,59,-11,44
Forfar,4087,8,10,5,21,39,67,-28,35
Albion,4087,9,9,6,21,63,82,-19,33
Queen's Park,4087,10,6,10,20,39,73,-34,28
Raith,4088,1,23,8,5,69,32,37,77
Ayr,4088,2,24,4,8,93,44,49,76
Arbroath,4088,3,17,8,11,70,50,20,59
Alloa,4088,4,17,8,11,56,44,12,59
Stranraer,4088,5,15,5,16,55,65,-10,50
East Fife,4088,6,14,3,19,48,64,-16,45
Airdrieon,4088,7,11,11,14,46,58,-12,44
Forfar,4088,8,10,5,21,38,65,-27,35
Queen's Park,4088,9,7,10,19,41,72,-31,31
Albion,4088,10,8,6,22,59,81,-22,30
Raith,4089,1,23,8,5,69,32,37,77
Ayr,4089,2,24,4,8,93,42,51,76
Arbroath,4089,3,17,9,10,71,49,22,60
Alloa,4089,4,17,8,11,56,44,12,59
Stranraer,4089,5,15,5,16,55,65,-10,50
East Fife,4089,6,14,3,19,48,64,-16,45
Airdrieon,4089,7,11,11,14,47,59,-12,44
Forfar,4089,8,10,5,21,39,66,-27,35
Albion,4089,9,8,6,22,57,81,-24,30
Queen's Park,4089,10,6,11,19,40,73,-33,29
Raith,4090,1,23,8,5,71,33,38,77
Ayr,4090,2,24,4,8,94,43,51,76
Arbroath,4090,3,18,8,10,72,49,23,62
Alloa,4090,4,17,8,11,57,46,11,59
Stranraer,4090,5,15,5,16,56,67,-11,50
East Fife,4090,6,14,3,19,50,65,-15,45
Airdrieon,4090,7,11,11,14,46,58,-12,44
Forfar,4090,8,10,5,21,38,65,-27,35
Albion,4090,9,8,6,22,58,82,-24,30
Queen's Park,4090,10,6,10,20,40,74,-34,28
Ayr,4091,1,24,4,8,92,43,49,76
Raith,4091,2,22,9,5,69,33,36,75
Arbroath,4091,3,18,8,10,71,48,23,62
Alloa,4091,4,17,9,10,57,44,13,60
Stranraer,4091,5,15,5,16,55,66,-11,50
East Fife,4091,6,14,3,19,49,64,-15,45
Airdrieon,4091,7,11,11,14,47,58,-11,44
Forfar,4091,8,10,5,21,38,66,-28,35
Albion,4091,9,8,6,22,58,80,-22,30
Queen's Park,4091,10,6,10,20,39,73,-34,28
Raith,4092,1,23,8,5,71,33,38,77
Ayr,4092,2,23,5,8,93,45,48,74
Arbroath,4092,3,18,8,10,76,50,26,62
Alloa,4092,4,17,8,11,57,46,11,59
Stranraer,4092,5,15,5,16,55,66,-11,50
East Fife,4092,6,14,3,19,49,64,-15,45
Airdrieon,4092,7,11,11,14,46,58,-12,44
Forfar,4092,8,10,5,21,38,65,-27,35
Albion,4092,9,8,7,21,60,81,-21,31
Queen's Park,4092,10,6,10,20,41,78,-37,28
Ayr,4093,1,24,4,8,94,42,52,76
Raith,4093,2,22,8,6,68,33,35,74
Alloa,4093,3,18,8,10,57,43,14,62
Arbroath,4093,4,17,9,10,72,50,22,60
Stranraer,4093,5,15,5,16,55,68,-13,50
East Fife,4093,6,14,3,19,51,64,-13,45
Airdrieon,4093,7,10,11,15,46,60,-14,41
Forfar,4093,8,11,5,20,40,65,-25,38
Albion,4093,9,8,6,22,57,82,-25,30
Queen's Park,4093,10,6,11,19,41,74,-33,29
Ayr,4094,1,24,4,8,96,43,53,76
Raith,4094,2,22,9,5,71,35,36,75
Alloa,4094,3,17,9,10,59,46,13,60
Arbroath,4094,4,17,8,11,70,50,20,59
Stranraer,4094,5,16,5,15,57,65,-8,53
East Fife,4094,6,13,3,20,48,66,-18,42
Airdrieon,4094,7,10,11,15,47,61,-14,41
Forfar,4094,8,11,5,20,41,66,-25,38
Queen's Park,4094,9,7,10,19,41,72,-31,31
Albion,4094,10,8,6,22,58,84,-26,30
Ayr,4095,1,24,4,8,93,43,50,76
Raith,4095,2,22,8,6,68,34,34,74
Alloa,4095,3,18,8,10,58,43,15,62
Arbroath,4095,4,17,8,11,70,49,21,59
Stranraer,4095,5,15,6,15,57,66,-9,51
Airdrieon,4095,6,11,11,14,49,59,-10,44
East Fife,4095,7,13,4,19,49,66,-17,43
Forfar,4095,8,10,5,21,39,68,-29,35
Queen's Park,4095,9,7,10,19,40,72,-32,31
Albion,4095,10,8,6,22,58,81,-23,30
Ayr,4096,1,24,4,8,95,45,50,76
Raith,4096,2,22,8,6,68,34,34,74
Arbroath,4096,3,18,8,10,74,49,25,62
Alloa,4096,4,18,8,10,58,43,15,62
Stranraer,4096,5,15,5,16,55,67,-12,50
East Fife,4096,6,14,3,19,50,64,-14,45
Airdrieon,4096,7,11,11,14,47,58,-11,44
Forfar,4096,8,10,5,21,38,66,-28,35
Albion,4096,9,8,6,22,60,83,-23,30
Queen's Park,4096,10,6,10,20,40,76,-36,28
Raith,4097,1,23,8,5,70,33,37,77
Ayr,4097,2,23,4,9,93,46,47,73
Arbroath,4097,3,18,8,10,74,48,26,62
Alloa,4097,4,17,8,11,57,45,12,59
Stranraer,4097,5,15,5,16,57,67,-10,50
East Fife,4097,6,14,3,19,50,66,-16,45
Airdrieon,4097,7,10,12,14,45,58,-13,42
Forfar,4097,8,10,6,20,38,64,-26,36
Albion,4097,9,9,6,21,61,81,-20,33
Queen's Park,4097,10,6,10,20,39,76,-37,28
Ayr,4098,1,24,4,8,93,42,51,76
Raith,4098,2,22,9,5,69,33,36,75
Alloa,4098,3,17,9,10,57,44,13,60
Arbroath,4098,4,17,8,11,71,51,20,59
Stranraer,4098,5,15,5,16,56,66,-10,50
East Fife,4098,6,14,3,19,49,65,-16,45
Airdrieon,4098,7,11,11,14,47,59,-12,44
Forfar,4098,8,10,5,21,39,66,-27,35
Queen's Park,4098,9,7,10,19,42,73,-31,31
Albion,4098,10,8,6,22,57,81,-24,30
Raith,4099,1,22,9,5,69,33,36,75
Ayr,4099,2,23,5,8,92,44,48,74
Arbroath,4099,3,18,8,10,72,49,23,62
Alloa,4099,4,17,9,10,57,44,13,60
Stranraer,4099,5,15,6,15,57,66,-9,51
East Fife,4099,6,13,4,19,49,66,-17,43
Airdrieon,4099,7,10,12,14,45,58,-13,42
Forfar,4099,8,10,6,20,38,64,-26,36
Albion,4099,9,8,7,21,59,80,-21,31
Queen's Park,4099,10,6,10,20,40,74,-34,28
Raith,4100,1,22,9,5,69,33,36,75
Ayr,4100,2,23,5,8,92,44,48,74
Arbroath,4100,3,18,8,10,73,49,24,62
Alloa,4100,4,17,9,10,57,44,13,60
Stranraer,4100,5,15,5,16,56,67,-11,50
East Fife,4100,6,14,3,19,50,65,-15,45
Airdrieon,4100,7,11,11,14,46,58,-12,44
Forfar,4100,8,10,5,21,38,65,-27,35
Albion,4100,9,8,7,21,59,80,-21,31
Queen's Park,4100,10,6,10,20,40,75,-35,28
Raith,4101,1,23,8,5,70,32,38,77
Ayr,4101,2,24,4,8,95,44,51,76
Arbroath,4101,3,17,9,10,72,50,22,60
Alloa,4101,4,17,8,11,56,45,11,59
Stranraer,4101,5,15,5,16,56,67,-11,50
East Fife,4101,6,14,3,19,50,65,-15,45
Airdrieon,4101,7,10,11,15,46,60,-14,41
Forfar,4101,8,11,5,20,40,65,-25,38
Albion,4101,9,8,6,22,59,83,-24,30
Queen's Park,4101,10,6,11,19,41,74,-33,29
Raith,4102,1,23,8,5,71,33,38,77
Ayr,4102,2,24,4,8,97,42,55,76
Arbroath,4102,3,18,8,10,72,49,23,62
Alloa,4102,4,17,8,11,57,46,11,59
Stranraer,4102,5,16,5,15,58,65,-7,53
Airdrieon,4102,6,11,11,14,47,58,-11,44
East Fife,4102,7,13,3,20,48,67,-19,42
Forfar,4102,8,10,5,21,38,66,-28,35
Albion,4102,9,8,6,22,57,85,-28,30
Queen's Park,4102,10,6,10,20,40,74,-34,28
Raith,4103,1,23,8,5,71,32,39,77
Ayr,4103,2,24,4,8,92,42,50,76
Arbroath,4103,3,18,8,10,74,49,25,62
Alloa,4103,4,17,8,11,56,46,10,59
Stranraer,4103,5,16,5,15,56,64,-8,53
Airdrieon,4103,6,11,11,14,46,58,-12,44
East Fife,4103,7,13,3,20,47,65,-18,42
Forfar,4103,8,10,5,21,38,65,-27,35
Albion,4103,9,8,6,22,57,80,-23,30
Queen's Park,4103,10,6,10,20,40,76,-36,28
Raith,4104,1,23,8,5,71,34,37,77
Ayr,4104,2,23,5,8,91,43,48,74
Arbroath,4104,3,18,8,10,72,48,24,62
Alloa,4104,4,17,8,11,58,46,12,59
Stranraer,4104,5,15,5,16,57,67,-10,50
East Fife,4104,6,14,3,19,50,66,-16,45
Airdrieon,4104,7,11,11,14,48,59,-11,44
Forfar,4104,8,10,5,21,39,67,-28,35
Albion,4104,9,8,7,21,58,79,-21,31
Queen's Park,4104,10,6,10,20,39,74,-35,28
Raith,4105,1,23,8,5,72,33,39,77
Ayr,4105,2,24,4,8,94,44,50,76
Arbroath,4105,3,17,9,10,72,50,22,60
Alloa,4105,4,17,8,11,57,47,10,59
Stranraer,4105,5,15,5,16,57,67,-10,50
East Fife,4105,6,14,3,19,50,66,-16,45
Airdrieon,4105,7,11,11,14,49,60,-11,44
Forfar,4105,8,10,5,21,40,68,-28,35
Albion,4105,9,8,6,22,59,82,-23,30
Queen's Park,4105,10,6,11,19,41,74,-33,29
Ayr,4106,1,24,4,8,93,42,51,76
Raith,4106,2,22,8,6,70,36,34,74
Alloa,4106,3,18,8,10,60,45,15,62
Arbroath,4106,4,17,8,11,70,50,20,59
Stranraer,4106,5,15,5,16,56,66,-10,50
East Fife,4106,6,14,3,19,49,65,-16,45
Airdrieon,4106,7,11,11,14,49,59,-10,44
Forfar,4106,8,10,5,21,39,68,-29,35
Queen's Park,4106,9,7,10,19,41,72,-31,31
Albion,4106,10,8,6,22,57,81,-24,30
Raith,4107,1,23,8,5,71,33,38,77
Ayr,4107,2,24,4,8,93,43,50,76
Arbroath,4107,3,17,8,11,71,50,21,59
Alloa,4107,4,17,8,11,57,46,11,59
Stranraer,4107,5,15,5,16,57,68,-11,50
East Fife,4107,6,14,3,19,51,66,-15,45
Airdrieon,4107,7,11,11,14,46,58,-12,44
Forfar,4107,8,10,5,21,38,65,-27,35
Queen's Park,4107,9,7,10,19,41,73,-32,31
Albion,4107,10,8,6,22,58,81,-23,30
Raith,4108,1,23,8,5,72,32,40,77
Ayr,4108,2,24,4,8,93,43,50,76
Arbroath,4108,3,18,8,10,75,49,26,62
Alloa,4108,4,17,8,11,56,47,9,59
Stranraer,4108,5,16,5,15,56,64,-8,53
East Fife,4108,6,13,3,20,47,65,-18,42
Airdrieon,4108,7,10,11,15,47,61,-14,41
Forfar,4108,8,11,5,20,41,66,-25,38
Albion,4108,9,8,6,22,58,81,-23,30
Queen's Park,4108,10,6,10,20,40,77,-37,28
Ayr,4109,1,24,4,8,95,42,53,76
Raith,4109,2,22,8,6,68,34,34,74
Alloa,4109,3,18,8,10,58,43,15,62
Arbroath,4109,4,17,8,11,70,50,20,59
Stranraer,4109,5,16,5,15,57,65,-8,53
Airdrieon,4109,6,11,11,14,47,58,-11,44
East Fife,4109,7,13,3,20,48,66,-18,42
Forfar,4109,8,10,5,21,38,66,-28,35
Queen's Park,4109,9,7,10,19,41,72,-31,31
Albion,4109,10,8,6,22,57,83,-26,30
Ayr,4110,1,24,4,8,94,42,52,76
Raith,4110,2,22,8,6,70,35,35,74
Arbroath,4110,3,18,8,10,76,53,23,62
Alloa,4110,4,18,8,10,59,45,14,62
Stranraer,4110,5,15,6,15,57,66,-9,51
Airdrieon,4110,6,11,11,14,48,58,-10,44
East Fife,4110,7,13,4,19,49,66,-17,43
Forfar,4110,8,10,5,21,38,67,-29,35
Albion,4110,9,8,6,22,57,82,-25,30
Queen's Park,4110,10,6,10,20,44,78,-34,28
Ayr,4111,1,24,4,8,96,43,53,76
Raith,4111,2,22,8,6,69,34,35,74
Alloa,4111,3,18,8,10,58,44,14,62
Arbroath,4111,4,17,8,11,71,51,20,59
Stranraer,4111,5,15,6,15,56,65,-9,51
Airdrieon,4111,6,11,11,14,49,60,-11,44
East Fife,4111,7,13,4,19,48,65,-17,43
Forfar,4111,8,10,5,21,40,68,-28,35
Queen's Park,4111,9,7,10,19,42,73,-31,31
Albion,4111,10,8,6,22,58,84,-26,30
Raith,4112,1,23,8,5,69,32,37,77
Ayr,4112,2,24,4,8,94,43,51,76
Arbroath,4112,3,17,8,11,72,52,20,59
Alloa,4112,4,17,8,11,56,44,12,59
Stranraer,4112,5,16,5,15,56,64,-8,53
East Fife,4112,6,13,3,20,47,65,-18,42
Airdrieon,4112,7,10,11,15,46,60,-14,41
Forfar,4112,8,11,5,20,40,65,-25,38
Queen's Park,4112,9,7,10,19,43,74,-31,31
Albion,4112,10,8,6,22,58,82,-24,30
Raith,4113,1,23,8,5,69,32,37,77
Ayr,4113,2,24,4,8,93,43,50,76
Arbroath,4113,3,18,8,10,72,49,23,62
Alloa,4113,4,17,8,11,56,44,12,59
Stranraer,4113,5,15,5,16,57,67,-10,50
East Fife,4113,6,14,3,19,50,66,-16,45
Airdrieon,4113,7,11,11,14,47,59,-12,44
Forfar,4113,8,10,5,21,39,66,-27,35
Albion,4113,9,8,6,22,58,81,-23,30
Queen's Park,4113,10,6,10,20,40,74,-34,28
Raith,4114,1,23,8,5,70,33,37,77
Ayr,4114,2,24,4,8,94,44,50,76
Arbroath,4114,3,17,8,11,70,53,17,59
Alloa,4114,4,17,8,11,57,45,12,59
Stranraer,4114,5,15,5,16,56,66,-10,50
East Fife,4114,6,14,3,19,49,65,-16,45
Airdrieon,4114,7,11,11,14,48,58,-10,44
Forfar,4114,8,10,5,21,38,67,-29,35
Queen's Park,4114,9,7,10,19,44,72,-28,31
Albion,4114,10,8,6,22,59,82,-23,30
Raith,4115,1,23,8,5,69,32,37,77
Ayr,4115,2,24,4,8,95,45,50,76
Arbroath,4115,3,18,8,10,72,48,24,62
Alloa,4115,4,17,8,11,56,44,12,59
Stranraer,4115,5,15,5,16,56,66,-10,50
East Fife,4115,6,14,3,19,49,65,-16,45
Airdrieon,4115,7,11,11,14,51,61,-10,44
Forfar,4115,8,10,5,21,41,70,-29,35
Albion,4115,9,8,6,22,60,83,-23,30
Queen's Park,4115,10,6,10,20,39,74,-35,28
Raith,4116,1,23,8,5,72,33,39,77
Ayr,4116,2,23,4,9,91,44,47,73
Arbroath,4116,3,18,8,10,74,50,24,62
Alloa,4116,4,17,8,11,57,47,10,59
Stranraer,4116,5,16,5,15,57,65,-8,53
Airdrieon,4116,6,10,12,14,46,59,-13,42
East Fife,4116,7,13,3,20,48,66,-18,42
Forfar,4116,8,10,6,20,39,65,-26,36
Albion,4116,9,9,6,21,59,79,-20,33
Queen's Park,4116,10,6,10,20,41,76,-35,28
Raith,4117,1,23,8,5,70,33,37,77
Ayr,4117,2,24,4,8,97,43,54,76
Arbroath,4117,3,18,8,10,71,48,23,62
Alloa,4117,4,17,8,11,57,45,12,59
Stranraer,4117,5,16,5,15,58,66,-8,53
Airdrieon,4117,6,11,11,14,48,58,-10,44
East Fife,4117,7,13,3,20,49,67,-18,42
Forfar,4117,8,10,5,21,38,67,-29,35
Albion,4117,9,8,6,22,58,85,-27,30
Queen's Park,4117,10,6,10,20,39,73,-34,28
Raith,4118,1,23,8,5,70,32,38,77
Ayr,4118,2,24,4,8,92,43,49,76
Arbroath,4118,3,18,8,10,72,48,24,62
Alloa,4118,4,17,8,11,56,45,11,59
Stranraer,4118,5,16,5,15,58,65,-7,53
Airdrieon,4118,6,11,11,14,48,58,-10,44
East Fife,4118,7,13,3,20,48,67,-19,42
Forfar,4118,8,10,5,21,38,67,-29,35
Albion,4118,9,8,6,22,58,80,-22,30
Queen's Park,4118,10,6,10,20,39,74,-35,28
Raith,4119,1,23,8,5,69,32,37,77
Ayr,4119,2,24,4,8,92,42,50,76
Arbroath,4119,3,18,8,10,75,49,26,62
Alloa,4119,4,17,8,11,56,44,12,59
Stranraer,4119,5,15,6,15,58,67,-9,51
East Fife,4119,6,13,4,19,50,67,-17,43
Airdrieon,4119,7,10,11,15,48,62,-14,41
Forfar,4119,8,11,5,20,42,67,-25,38
Albion,4119,9,8,6,22,57,80,-23,30
Queen's Park,4119,10,6,10,20,40,77,-37,28
Ayr,4120,1,24,4,8,96,42,54,76
Raith,4120,2,22,9,5,69,33,36,75
Arbroath,4120,3,17,9,10,73,51,22,60
Alloa,4120,4,17,9,10,57,44,13,60
Stranraer,4120,5,15,5,16,56,66,-10,50
East Fife,4120,6,14,3,19,49,65,-16,45
Airdrieon,4120,7,11,11,14,46,58,-12,44
Forfar,4120,8,10,5,21,38,65,-27,35
Albion,4120,9,8,6,22,57,84,-27,30
Queen's Park,4120,10,6,11,19,42,75,-33,29
Ayr,4121,1,24,4,8,93,42,51,76
Raith,4121,2,22,9,5,69,33,36,75
Alloa,4121,3,17,9,10,57,44,13,60
Arbroath,4121,4,17,8,11,71,50,21,59
Stranraer,4121,5,15,5,16,55,65,-10,50
East Fife,4121,6,14,3,19,48,64,-16,45
Airdrieon,4121,7,10,11,15,45,59,-14,41
Forfar,4121,8,11,5,20,39,64,-25,38
Queen's Park,4121,9,7,10,19,41,73,-32,31
Albion,4121,10,8,6,22,57,81,-24,30
Raith,4122,1,23,8,5,71,32,39,77
Ayr,4122,2,24,4,8,93,44,49,76
Arbroath,4122,3,17,8,11,71,51,20,59
Alloa,4122,4,17,8,11,56,46,10,59
Stranraer,4122,5,16,5,15,57,65,-8,53
East Fife,4122,6,13,3,20,48,66,-18,42
Airdrieon,4122,7,10,11,15,45,59,-14,41
Forfar,4122,8,11,5,20,39,64,-25,38
Queen's Park,4122,9,7,10,19,42,73,-31,31
Albion,4122,10,8,6,22,59,81,-22,30
Raith,4123,1,23,8,5,72,33,39,77
Ayr,4123,2,23,4,9,92,46,46,73
Arbroath,4123,3,18,8,10,71,48,23,62
Alloa,4123,4,17,8,11,57,47,10,59
Stranraer,4123,5,15,5,16,55,66,-11,50
East Fife,4123,6,14,3,19,49,64,-15,45
Airdrieon,4123,7,11,11,14,48,59,-11,44
Forfar,4123,8,10,5,21,39,67,-28,35
Albion,4123,9,9,6,21,61,80,-19,33
Queen's Park,4123,10,6,10,20,39,73,-34,28
Raith,4124,1,23,8,5,70,33,37,77
Ayr,4124,2,24,4,8,93,42,51,76
Arbroath,4124,3,17,9,10,72,50,22,60
Alloa,4124,4,17,8,11,57,45,12,59
Stranraer,4124,5,15,6,15,57,66,-9,51
Airdrieon,4124,6,11,11,14,49,58,-9,44
East Fife,4124,7,13,4,19,49,66,-17,43
Forfar,4124,8,10,5,21,38,68,-30,35
Albion,4124,9,8,6,22,57,81,-24,30
Queen's Park,4124,10,6,11,19,41,74,-33,29
Raith,4125,1,23,8,5,70,33,37,77
Ayr,4125,2,24,4,8,95,42,53,76
Arbroath,4125,3,18,8,10,72,48,24,62
Alloa,4125,4,17,8,11,57,45,12,59
Stranraer,4125,5,15,5,16,57,67,-10,50
East Fife,4125,6,14,3,19,50,66,-16,45
Airdrieon,4125,7,11,11,14,47,58,-11,44
Forfar,4125,8,10,5,21,38,66,-28,35
Albion,4125,9,8,6,22,57,83,-26,30
Queen's Park,4125,10,6,10,20,39,74,-35,28
Ayr,4126,1,24,4,8,94,43,51,76
Raith,4126,2,22,8,6,69,36,33,74
Alloa,4126,3,18,8,10,60,44,16,62
Arbroath,4126,4,17,9,10,70,48,22,60
Stranraer,4126,5,15,6,15,59,68,-9,51
Airdrieon,4126,6,11,11,14,46,58,-12,44
East Fife,4126,7,13,4,19,51,68,-17,43
Forfar,4126,8,10,5,21,38,65,-27,35
Albion,4126,9,8,6,22,58,82,-24,30
Queen's Park,4126,10,6,11,19,39,72,-33,29
Raith,4127,1,23,8,5,71,33,38,77
Ayr,4127,2,24,4,8,96,42,54,76
Arbroath,4127,3,18,8,10,71,48,23,62
Alloa,4127,4,17,8,11,57,46,11,59
Stranraer,4127,5,15,6,15,57,66,-9,51
Airdrieon,4127,6,11,11,14,51,59,-8,44
East Fife,4127,7,13,4,19,49,66,-17,43
Forfar,4127,8,10,5,21,39,70,-31,35
Albion,4127,9,8,6,22,57,84,-27,30
Queen's Park,4127,10,6,10,20,39,73,-34,28
Raith,4128,1,23,8,5,73,32,41,77
Ayr,4128,2,24,4,8,95,44,51,76
Arbroath,4128,3,18,8,10,72,49,23,62
Alloa,4128,4,17,8,11,56,48,8,59
Stranraer,4128,5,15,5,16,56,69,-13,50
East Fife,4128,6,14,3,19,52,65,-13,45
Airdrieon,4128,7,11,11,14,48,60,-12,44
Forfar,4128,8,10,5,21,40,67,-27,35
Albion,4128,9,8,6,22,59,83,-24,30
Queen's Park,4128,10,6,10,20,40,74,-34,28
Raith,4129,1,23,8,5,71,33,38,77
Ayr,4129,2,24,4,8,92,43,49,76
Arbroath,4129,3,17,9,10,72,50,22,60
Alloa,4129,4,17,8,11,57,46,11,59
Stranraer,4129,5,15,5,16,56,67,-11,50
East Fife,4129,6,14,3,19,50,65,-15,45
Airdrieon,4129,7,10,11,15,45,59,-14,41
Forfar,4129,8,11,5,20,39,64,-25,38
Albion,4129,9,8,6,22,58,80,-22,30
Queen's Park,4129,10,6,11,19,41,74,-33,29
Ayr,4130,1,24,4,8,96,44,52,76
Raith,4130,2,22,8,6,69,34,35,74
Alloa,4130,3,18,8,10,58,44,14,62
Arbroath,4130,4,17,8,11,71,50,21,59
Stranraer,4130,5,15,6,15,56,65,-9,51
Airdrieon,4130,6,11,11,14,48,58,-10,44
East Fife,4130,7,13,4,19,48,65,-17,43
Forfar,4130,8,10,5,21,38,67,-29,35
Queen's Park,4130,9,7,10,19,41,73,-32,31
Albion,4130,10,8,6,22,59,84,-25,30
Raith,4131,1,23,8,5,69,32,37,77
Ayr,4131,2,24,4,8,94,42,52,76
Arbroath,4131,3,17,9,10,71,49,22,60
Alloa,4131,4,17,8,11,56,44,12,59
Stranraer,4131,5,16,5,15,56,64,-8,53
Airdrieon,4131,6,11,11,14,48,59,-11,44
East Fife,4131,7,13,3,20,47,65,-18,42
Forfar,4131,8,10,5,21,39,67,-28,35
Albion,4131,9,8,6,22,57,82,-25,30
Queen's Park,4131,10,6,11,19,40,73,-33,29
Raith,4132,1,23,8,5,70,33,37,77
Ayr,4132,2,24,4,8,95,43,52,76
Arbroath,4132,3,18,8,10,74,49,25,62
Alloa,4132,4,17,8,11,57,45,12,59
Stranraer,4132,5,16,5,15,58,66,-8,53
Airdrieon,4132,6,10,12,14,47,60,-13,42
East Fife,4132,7,13,3,20,49,67,-18,42
Forfar,4132,8,10,6,20,40,66,-26,36
Albion,4132,9,8,6,22,58,83,-25,30
Queen's Park,4132,10,6,10,20,40,76,-36,28
Ayr,4133,1,24,4,8,93,43,50,76
Raith,4133,2,22,8,6,69,35,34,74
Alloa,4133,3,18,8,10,59,44,15,62
Arbroath,4133,4,17,9,10,72,50,22,60
Stranraer,4133,5,16,5,15,57,64,-7,53
Airdrieon,4133,6,10,12,14,46,59,-13,42
East Fife,4133,7,13,3,20,47,66,-19,42
Forfar,4133,8,10,6,20,39,65,-26,36
Albion,4133,9,8,6,22,58,81,-23,30
Queen's Park,4133,10,6,11,19,41,74,-33,29
Raith,4134,1,23,8,5,69,32,37,77
Ayr,4134,2,23,5,8,90,42,48,74
Arbroath,4134,3,18,8,10,73,49,24,62
Alloa,4134,4,17,8,11,56,44,12,59
Stranraer,4134,5,15,5,16,56,66,-10,50
East Fife,4134,6,14,3,19,49,65,-16,45
Airdrieon,4134,7,11,11,14,46,58,-12,44
Forfar,4134,8,10,5,21,38,65,-27,35
Albion,4134,9,8,7,21,57,78,-21,31
Queen's Park,4134,10,6,10,20,40,75,-35,28
Raith,4135,1,23,8,5,72,32,40,77
Ayr,4135,2,24,4,8,94,45,49,76
Arbroath,4135,3,17,8,11,72,51,21,59
Alloa,4135,4,17,8,11,56,47,9,59
Stranraer,4135,5,15,5,16,55,65,-10,50
East Fife,4135,6,14,3,19,48,64,-16,45
Airdrieon,4135,7,11,11,14,47,59,-12,44
Forfar,4135,8,10,5,21,39,66,-27,35
Queen's Park,4135,9,7,10,19,42,74,-32,31
Albion,4135,10,8,6,22,60,82,-22,30
Ayr,4136,1,24,4,8,96,43,53,76
Raith,4136,2,22,9,5,69,33,36,75
Arbroath,4136,3,18,8,10,72,49,23,62
Alloa,4136,4,17,9,10,57,44,13,60
Stranraer,4136,5,16,5,15,58,65,-7,53
Airdrieon,4136,6,11,11,14,47,59,-12,44
East Fife,4136,7,13,3,20,48,67,-19,42
Forfar,4136,8,10,5,21,39,66,-27,35
Albion,4136,9,8,6,22,58,84,-26,30
Queen's Park,4136,10,6,10,20,40,74,-34,28
Raith,4137,1,23,8,5,69,32,37,77
Ayr,4137,2,23,5,8,92,44,48,74
Arbroath,4137,3,18,8,10,71,48,23,62
Alloa,4137,4,17,8,11,56,44,12,59
Stranraer,4137,5,15,6,15,56,65,-9,51
Airdrieon,4137,6,11,11,14,47,59,-12,44
East Fife,4137,7,13,4,19,48,65,-17,43
Forfar,4137,8,10,5,21,39,66,-27,35
Albion,4137,9,8,7,21,59,80,-21,31
Queen's Park,4137,10,6,10,20,39,73,-34,28
Raith,4138,1,23,8,5,71,32,39,77
Ayr,4138,2,24,4,8,93,43,50,76
Arbroath,4138,3,18,8,10,73,48,25,62
Alloa,4138,4,17,8,11,56,46,10,59
Stranraer,4138,5,15,5,16,57,67,-10,50
East Fife,4138,6,14,3,19,50,66,-16,45
Airdrieon,4138,7,10,11,15,45,59,-14,41
Forfar,4138,8,11,5,20,39,64,-25,38
Albion,4138,9,8,6,22,58,81,-23,30
Queen's Park,4138,10,6,10,20,39,75,-36,28
Raith,4139,1,23,8,5,72,34,38,77
Ayr,4139,2,24,4,8,95,44,51,76
Arbroath,4139,3,18,8,10,74,48,26,62
Alloa,4139,4,17,8,11,58,47,11,59
Stranraer,4139,5,15,6,15,56,65,-9,51
Airdrieon,4139,6,11,11,14,47,58,-11,44
East Fife,4139,7,13,4,19,48,65,-17,43
Forfar,4139,8,10,5,21,38,66,-28,35
Albion,4139,9,8,6,22,59,83,-24,30
Queen's Park,4139,10,6,10,20,39,76,-37,28
Ayr,4140,1,23,5,8,92,44,48,74
Raith,4140,2,22,8,6,68,34,34,74
Arbroath,4140,3,18,8,10,73,48,25,62
Alloa,4140,4,18,8,10,58,43,15,62
Stranraer,4140,5,15,5,16,55,69,-14,50
East Fife,4140,6,14,3,19,52,64,-12,45
Airdrieon,4140,7,10,12,14,45,58,-13,42
Forfar,4140,8,10,6,20,38,64,-26,36
Albion,4140,9,8,7,21,59,80,-21,31
Queen's Park,4140,10,6,10,20,39,75,-36,28
Raith,4141,1,23,8,5,69,32,37,77
Ayr,4141,2,23,5,8,90,42,48,74
Arbroath,4141,3,18,8,10,71,48,23,62
Alloa,4141,4,17,8,11,56,44,12,59
Stranraer,4141,5,15,5,16,56,66,-10,50
East Fife,4141,6,14,3,19,49,65,-16,45
Airdrieon,4141,7,10,11,15,46,60,-14,41
Forfar,4141,8,11,5,20,40,65,-25,38
Albion,4141,9,8,7,21,57,78,-21,31
Queen's Park,4141,10,6,10,20,39,73,-34,28
Raith,4142,1,23,8,5,70,33,37,77
Ayr,4142,2,24,4,8,93,44,49,76
Arbroath,4142,3,18,8,10,72,48,24,62
Alloa,4142,4,17,8,11,57,45,12,59
Stranraer,4142,5,15,6,15,58,67,-9,51
Airdrieon,4142,6,11,11,14,49,61,-12,44
East Fife,4142,7,13,4,19,50,67,-17,43
Forfar,4142,8,10,5,21,41,68,-27,35
Albion,4142,9,8,6,22,59,81,-22,30
Queen's Park,4142,10,6,10,20,39,74,-35,28
Ayr,4143,1,24,4,8,95,42,53,76
Raith,4143,2,22,8,6,69,34,35,74
Arbroath,4143,3,18,8,10,72,49,23,62
Alloa,4143,4,18,8,10,58,44,14,62
Stranraer,4143,5,16,5,15,56,64,-8,53
Airdrieon,4143,6,11,11,14,48,59,-11,44
East Fife,4143,7,13,3,20,47,65,-18,42
Forfar,4143,8,10,5,21,39,67,-28,35
Albion,4143,9,8,6,22,57,83,-26,30
Queen's Park,4143,10,6,10,20,40,74,-34,28
Raith,4144,1,23,8,5,71,33,38,77
Ayr,4144,2,24,4,8,93,44,49,76
Arbroath,4144,3,17,9,10,71,49,22,60
Alloa,4144,4,17,8,11,57,46,11,59
Stranraer,4144,5,15,5,16,55,66,-11,50
East Fife,4144,6,14,3,19,49,64,-15,45
Airdrieon,4144,7,11,11,14,49,59,-10,44
Forfar,4144,8,10,5,21,39,68,-29,35
Albion,4144,9,8,6,22,59,81,-22,30
Queen's Park,4144,10,6,11,19,40,73,-33,29
Raith,4145,1,23,8,5,70,33,37,77
Ayr,4145,2,23,5,8,92,44,48,74
Arbroath,4145,3,17,8,11,70,50,20,59
Alloa,4145,4,17,8,11,57,45,12,59
Stranraer,4145,5,15,5,16,56,68,-12,50
East Fife,4145,6,14,3,19,51,65,-14,45
Airdrieon,4145,7,10,12,14,47,60,-13,42
Forfar,4145,8,10,6,20,40,66,-26,36
Albion,4145,9,8,7,21,59,80,-21,31
Queen's Park,4145,10,7,10,19,41,72,-31,31
Ayr,4146,1,24,4,8,95,45,50,76
Raith,4146,2,22,8,6,69,34,35,74
Arbroath,4146,3,18,8,10,73,49,24,62
Alloa,4146,4,18,8,10,58,44,14,62
Stranraer,4146,5,16,5,15,57,64,-7,53
Airdrieon,4146,6,11,11,14,49,59,-10,44
East Fife,4146,7,13,3,20,47,66,-19,42
Forfar,4146,8,10,5,21,39,68,-29,35
Albion,4146,9,8,6,22,60,83,-23,30
Queen's Park,4146,10,6,10,20,40,75,-35,28
Raith,4147,1,23,8,5,70,33,37,77
Ayr,4147,2,24,4,8,93,43,50,76
Arbroath,4147,3,18,8,10,77,48,29,62
Alloa,4147,4,17,8,11,57,45,12,59
Stranraer,4147,5,16,5,15,57,65,-8,53
East Fife,4147,6,13,3,20,48,66,-18,42
Airdrieon,4147,7,10,11,15,46,62,-16,41
Forfar,4147,8,11,5,20,42,65,-23,38
Albion,4147,9,8,6,22,58,81,-23,30
Queen's Park,4147,10,6,10,20,39,79,-40,28
Raith,4148,1,23,8,5,72,32,40,77
Ayr,4148,2,24,4,8,92,42,50,76
Arbroath,4148,3,17,9,10,71,49,22,60
Alloa,4148,4,17,8,11,56,47,9,59
Stranraer,4148,5,15,6,15,57,66,-9,51
Airdrieon,4148,6,11,11,14,50,60,-10,44
East Fife,4148,7,13,4,19,49,66,-17,43
Forfar,4148,8,10,5,21,40,69,-29,35
Albion,4148,9,8,6,22,57,80,-23,30
Queen's Park,4148,10,6,11,19,40,73,-33,29
Ayr,4149,1,23,5,8,92,44,48,74
Raith,4149,2,22,8,6,68,35,33,74
Alloa,4149,3,18,8,10,59,43,16,62
Arbroath,4149,4,17,8,11,71,52,19,59
Stranraer,4149,5,16,5,15,56,64,-8,53
Airdrieon,4149,6,11,11,14,49,59,-10,44
East Fife,4149,7,13,3,20,47,65,-18,42
Forfar,4149,8,10,5,21,39,68,-29,35
Albion,4149,9,8,7,21,59,80,-21,31
Queen's Park,4149,10,7,10,19,43,73,-30,31
Ayr,4150,1,24,4,8,98,42,56,76
Raith,4150,2,22,8,6,71,36,35,74
Arbroath,4150,3,18,8,10,73,48,25,62
Alloa,4150,4,18,8,10,60,46,14,62
Stranraer,4150,5,15,6,15,56,65,-9,51
East Fife,4150,6,13,4,19,48,65,-17,43
Airdrieon,4150,7,10,11,15,45,60,-15,41
Forfar,4150,8,11,5,20,40,64,-24,38
Albion,4150,9,8,6,22,57,86,-29,30
Queen's Park,4150,10,6,10,20,39,75,-36,28
Ayr,4151,1,24,4,8,94,45,49,76
Raith,4151,2,22,8,6,69,35,34,74
Arbroath,4151,3,18,8,10,76,48,28,62
Alloa,4151,4,18,8,10,59,44,15,62
Stranraer,4151,5,15,5,16,57,67,-10,50
East Fife,4151,6,14,3,19,50,66,-16,45
Airdrieon,4151,7,10,12,14,47,60,-13,42
Forfar,4151,8,10,6,20,40,66,-26,36
Albion,4151,9,8,6,22,60,82,-22,30
Queen's Park,4151,10,6,10,20,39,78,-39,28
Ayr,4152,1,24,4,8,94,45,49,76
Raith,4152,2,22,9,5,68,32,36,75
Alloa,4152,3,17,9,10,56,43,13,60
Arbroath,4152,4,17,8,11,71,50,21,59
Stranraer,4152,5,16,5,15,57,65,-8,53
Airdrieon,4152,6,11,11,14,48,60,-12,44
East Fife,4152,7,13,3,20,48,66,-18,42
Forfar,4152,8,10,5,21,40,67,-27,35
Queen's Park,4152,9,7,10,19,41,73,-32,31
Albion,4152,10,8,6,22,60,82,-22,30
Raith,4153,1,23,8,5,72,34,38,77
Ayr,4153,2,23,4,9,92,45,47,73
Arbroath,4153,3,18,8,10,71,48,23,62
Alloa,4153,4,17,8,11,58,47,11,59
Stranraer,4153,5,15,5,16,55,65,-10,50
East Fife,4153,6,14,3,19,48,64,-16,45
Airdrieon,4153,7,11,11,14,49,59,-10,44
Forfar,4153,8,10,5,21,39,68,-29,35
Albion,4153,9,9,6,21,60,80,-20,33
Queen's Park,4153,10,6,10,20,39,73,-34,28
Raith,4154,1,23,8,5,70,32,38,77
Ayr,4154,2,23,4,9,91,44,47,73
Arbroath,4154,3,17,8,11,71,51,20,59
Alloa,4154,4,17,8,11,56,45,11,59
Stranraer,4154,5,15,6,15,56,65,-9,51
Airdrieon,4154,6,11,11,14,48,58,-10,44
East Fife,4154,7,13,4,19,48,65,-17,43
Forfar,4154,8,10,5,21,38,67,-29,35
Albion,4154,9,9,6,21,59,79,-20,33
Queen's Park,4154,10,7,10,19,42,73,-31,31
Ayr,4155,1,24,4,8,95,43,52,76
Raith,4155,2,22,9,5,69,33,36,75
Arbroath,4155,3,17,9,10,71,49,22,60
Alloa,4155,4,17,9,10,57,44,13,60
Stranraer,4155,5,15,6,15,56,65,-9,51
East Fife,4155,6,13,4,19,48,65,-17,43
Airdrieon,4155,7,10,11,15,45,59,-14,41
Forfar,4155,8,11,5,20,39,64,-25,38
Albion,4155,9,8,6,22,58,83,-25,30
Queen's Park,4155,10,6,11,19,40,73,-33,29
Ayr,4156,1,24,4,8,94,44,50,76
Raith,4156,2,22,8,6,68,34,34,74
Arbroath,4156,3,18,8,10,74,49,25,62
Alloa,4156,4,18,8,10,58,43,15,62
Stranraer,4156,5,16,5,15,57,64,-7,53
Airdrieon,4156,6,10,12,14,47,60,-13,42
East Fife,4156,7,13,3,20,47,66,-19,42
Forfar,4156,8,10,6,20,40,66,-26,36
Albion,4156,9,8,6,22,59,82,-23,30
Queen's Park,4156,10,6,10,20,40,76,-36,28
Raith,4157,1,23,8,5,69,32,37,77
Ayr,4157,2,24,4,8,93,44,49,76
Arbroath,4157,3,18,8,10,74,48,26,62
Alloa,4157,4,17,8,11,56,44,12,59
Stranraer,4157,5,15,6,15,58,67,-9,51
East Fife,4157,6,13,4,19,50,67,-17,43
Airdrieon,4157,7,10,11,15,45,61,-16,41
Forfar,4157,8,11,5,20,41,64,-23,38
Albion,4157,9,8,6,22,59,81,-22,30
Queen's Park,4157,10,6,10,20,39,76,-37,28
Raith,4158,1,22,8,6,68,33,35,74
Ayr,4158,2,23,4,9,91,45,46,73
Alloa,4158,3,18,8,10,57,43,14,62
Arbroath,4158,4,17,9,10,72,50,22,60
Stranraer,4158,5,15,5,16,55,65,-10,50
East Fife,4158,6,14,3,19,48,64,-16,45
Airdrieon,4158,7,10,12,14,45,58,-13,42
Forfar,4158,8,10,6,20,38,64,-26,36
Albion,4158,9,9,6,21,60,79,-19,33
Queen's Park,4158,10,6,11,19,41,74,-33,29
Raith,4159,1,22,9,5,71,35,36,75
Ayr,4159,2,23,5,8,93,45,48,74
Alloa,4159,3,17,9,10,59,46,13,60
Arbroath,4159,4,17,8,11,70,49,21,59
Stranraer,4159,5,16,5,15,59,66,-7,53
East Fife,4159,6,13,3,20,49,68,-19,42
Airdrieon,4159,7,10,11,15,45,60,-15,41
Forfar,4159,8,11,5,20,40,64,-24,38
Albion,4159,9,8,7,21,60,81,-21,31
Queen's Park,4159,10,7,10,19,40,72,-32,31
Raith,4160,1,22,9,5,69,33,36,75
Ayr,4160,2,23,5,8,91,43,48,74
Alloa,4160,3,17,9,10,57,44,13,60
Arbroath,4160,4,17,8,11,71,50,21,59
Stranraer,4160,5,16,5,15,58,66,-8,53
Airdrieon,4160,6,11,11,14,49,60,-11,44
East Fife,4160,7,13,3,20,49,67,-18,42
Forfar,4160,8,10,5,21,40,68,-28,35
Albion,4160,9,8,7,21,58,79,-21,31
Queen's Park,4160,10,7,10,19,41,73,-32,31
Ayr,4161,1,24,4,8,93,42,51,76
Raith,4161,2,22,8,6,71,36,35,74
Alloa,4161,3,18,8,10,60,46,14,62
Arbroath,4161,4,17,9,10,71,49,22,60
Stranraer,4161,5,15,6,15,56,65,-9,51
Airdrieon,4161,6,11,11,14,46,58,-12,44
East Fife,4161,7,13,4,19,48,65,-17,43
Forfar,4161,8,10,5,21,38,65,-27,35
Albion,4161,9,8,6,22,57,81,-24,30
Queen's Park,4161,10,6,11,19,40,73,-33,29
Raith,4162,1,23,8,5,71,33,38,77
Ayr,4162,2,24,4,8,94,42,52,76
Arbroath,4162,3,18,8,10,72,49,23,62
Alloa,4162,4,17,8,11,57,46,11,59
Stranraer,4162,5,15,5,16,55,66,-11,50
East Fife,4162,6,14,3,19,49,64,-15,45
Airdrieon,4162,7,10,12,14,46,59,-13,42
Forfar,4162,8,10,6,20,39,65,-26,36
Albion,4162,9,8,6,22,57,82,-25,30
Queen's Park,4162,10,6,10,20,40,74,-34,28
Raith,4163,1,22,9,5,69,33,36,75
Ayr,4163,2,23,5,8,94,46,48,74
Alloa,4163,3,17,9,10,57,44,13,60
Arbroath,4163,4,17,8,11,71,50,21,59
Stranraer,4163,5,15,5,16,55,65,-10,50
East Fife,4163,6,14,3,19,48,64,-16,45
Airdrieon,4163,7,11,11,14,50,62,-12,44
Forfar,4163,8,10,5,21,42,69,-27,35
Albion,4163,9,8,7,21,61,82,-21,31
Queen's Park,4163,10,7,10,19,41,73,-32,31
Raith,4164,1,23,8,5,69,32,37,77
Ayr,4164,2,24,4,8,91,42,49,76
Arbroath,4164,3,17,9,10,72,50,22,60
Alloa,4164,4,17,8,11,56,44,12,59
Stranraer,4164,5,15,5,16,56,66,-10,50
East Fife,4164,6,14,3,19,49,65,-16,45
Airdrieon,4164,7,11,11,14,46,58,-12,44
Forfar,4164,8,10,5,21,38,65,-27,35
Albion,4164,9,8,6,22,57,79,-22,30
Queen's Park,4164,10,6,11,19,41,74,-33,29
Raith,4165,1,23,8,5,70,32,38,77
Ayr,4165,2,23,4,9,92,45,47,73
Arbroath,4165,3,17,8,11,71,50,21,59
Alloa,4165,4,17,8,11,56,45,11,59
Stranraer,4165,5,16,5,15,57,65,-8,53
East Fife,4165,6,13,3,20,48,66,-18,42
Airdrieon,4165,7,10,11,15,45,60,-15,41
Forfar,4165,8,11,5,20,40,64,-24,38
Albion,4165,9,9,6,21,60,80,-20,33
Queen's Park,4165,10,7,10,19,41,73,-32,31
Ayr,4166,1,24,4,8,92,42,50,76
Raith,4166,2,22,8,6,68,33,35,74
Arbroath,4166,3,18,8,10,74,50,24,62
Alloa,4166,4,18,8,10,57,43,14,62
Stranraer,4166,5,16,5,15,60,64,-4,53
East Fife,4166,6,13,3,20,47,69,-22,42
Airdrieon,4166,7,10,11,15,48,63,-15,41
Forfar,4166,8,11,5,20,43,67,-24,38
Albion,4166,9,8,6,22,57,80,-23,30
Queen's Park,4166,10,6,10,20,41,76,-35,28
Ayr,4167,1,24,4,8,92,43,49,76
Raith,4167,2,22,8,6,69,34,35,74
Alloa,4167,3,18,8,10,58,44,14,62
Arbroath,4167,4,17,8,11,70,49,21,59
Stranraer,4167,5,16,5,15,56,64,-8,53
Airdrieon,4167,6,10,12,14,47,60,-13,42
East Fife,4167,7,13,3,20,47,65,-18,42
Forfar,4167,8,10,6,20,40,66,-26,36
Queen's Park,4167,9,7,10,19,40,72,-32,31
Albion,4167,10,8,6,22,58,80,-22,30
Ayr,4168,1,24,4,8,93,44,49,76
Raith,4168,2,22,8,6,68,34,34,74
Alloa,4168,3,18,8,10,58,43,15,62
Arbroath,4168,4,17,9,10,72,50,22,60
Stranraer,4168,5,15,6,15,56,65,-9,51
East Fife,4168,6,13,4,19,48,65,-17,43
Airdrieon,4168,7,10,12,14,46,59,-13,42
Forfar,4168,8,10,6,20,39,65,-26,36
Albion,4168,9,8,6,22,59,81,-22,30
Queen's Park,4168,10,6,11,19,41,74,-33,29
Raith,4169,1,23,8,5,71,33,38,77
Ayr,4169,2,24,4,8,95,45,50,76
Arbroath,4169,3,17,8,11,71,51,20,59
Alloa,4169,4,17,8,11,57,46,11,59
Stranraer,4169,5,15,6,15,56,65,-9,51
Airdrieon,4169,6,11,11,14,48,59,-11,44
East Fife,4169,7,13,4,19,48,65,-17,43
Forfar,4169,8,10,5,21,39,67,-28,35
Queen's Park,4169,9,7,10,19,42,73,-31,31
Albion,4169,10,8,6,22,60,83,-23,30
Raith,4170,1,23,8,5,70,32,38,77
Ayr,4170,2,24,4,8,93,42,51,76
Arbroath,4170,3,17,9,10,71,49,22,60
Alloa,4170,4,17,8,11,56,45,11,59
Stranraer,4170,5,15,5,16,55,67,-12,50
East Fife,4170,6,14,3,19,50,64,-14,45
Airdrieon,4170,7,10,12,14,46,59,-13,42
Forfar,4170,8,10,6,20,39,65,-26,36
Albion,4170,9,8,6,22,57,81,-24,30
Queen's Park,4170,10,6,11,19,40,73,-33,29
Raith,4171,1,22,8,6,69,36,33,74
Ayr,4171,2,23,4,9,90,43,47,73
Arbroath,4171,3,18,8,10,76,49,27,62
Alloa,4171,4,18,8,10,60,44,16,62
Stranraer,4171,5,15,5,16,56,68,-12,50
East Fife,4171,6,14,3,19,51,65,-14,45
Airdrieon,4171,7,11,11,14,47,58,-11,44
Forfar,4171,8,10,5,21,38,66,-28,35
Albion,4171,9,9,6,21,58,78,-20,33
Queen's Park,4171,10,6,10,20,40,78,-38,28
Raith,4172,1,23,8,5,70,32,38,77
Ayr,4172,2,24,4,8,93,43,50,76
Arbroath,4172,3,18,8,10,74,51,23,62
Alloa,4172,4,17,8,11,56,45,11,59
Stranraer,4172,5,15,6,15,56,65,-9,51
Airdrieon,4172,6,11,11,14,47,58,-11,44
East Fife,4172,7,13,4,19,48,65,-17,43
Forfar,4172,8,10,5,21,38,66,-28,35
Albion,4172,9,8,6,22,58,81,-23,30
Queen's Park,4172,10,6,10,20,42,76,-34,28
Raith,4173,1,23,8,5,70,32,38,77
Ayr,4173,2,24,4,8,92,43,49,76
Arbroath,4173,3,17,9,10,71,49,22,60
Alloa,4173,4,17,8,11,56,45,11,59
Stranraer,4173,5,16,5,15,57,65,-8,53
East Fife,4173,6,13,3,20,48,66,-18,42
Airdrieon,4173,7,10,11,15,46,60,-14,41
Forfar,4173,8,11,5,20,40,65,-25,38
Albion,4173,9,8,6,22,58,80,-22,30
Queen's Park,4173,10,6,11,19,40,73,-33,29
Raith,4174,1,22,8,6,68,33,35,74
Ayr,4174,2,23,4,9,92,45,47,73
Arbroath,4174,3,18,8,10,71,48,23,62
Alloa,4174,4,18,8,10,57,43,14,62
Stranraer,4174,5,15,5,16,56,66,-10,50
East Fife,4174,6,14,3,19,49,65,-16,45
Airdrieon,4174,7,10,11,15,45,62,-17,41
Forfar,4174,8,11,5,20,42,64,-22,38
Albion,4174,9,9,6,21,60,80,-20,33
Queen's Park,4174,10,6,10,20,39,73,-34,28
Raith,4175,1,23,8,5,72,32,40,77
Ayr,4175,2,24,4,8,94,44,50,76
Arbroath,4175,3,17,9,10,71,49,22,60
Alloa,4175,4,17,8,11,56,47,9,59
Stranraer,4175,5,15,6,15,56,65,-9,51
Airdrieon,4175,6,11,11,14,46,58,-12,44
East Fife,4175,7,13,4,19,48,65,-17,43
Forfar,4175,8,10,5,21,38,65,-27,35
Albion,4175,9,8,6,22,59,82,-23,30
Queen's Park,4175,10,6,11,19,40,73,-33,29
Raith,4176,1,22,9,5,68,32,36,75
Ayr,4176,2,23,4,9,91,46,45,73
Arbroath,4176,3,17,9,10,71,49,22,60
Alloa,4176,4,17,9,10,56,43,13,60
Stranraer,4176,5,15,6,15,58,67,-9,51
Airdrieon,4176,6,11,11,14,46,58,-12,44
East Fife,4176,7,13,4,19,50,67,-17,43
Forfar,4176,8,10,5,21,38,65,-27,35
Albion,4176,9,9,6,21,61,79,-18,33
Queen's Park,4176,10,6,11,19,40,73,-33,29
Raith,4177,1,23,8,5,69,32,37,77
Ayr,4177,2,23,5,8,92,44,48,74
Arbroath,4177,3,18,8,10,72,48,24,62
Alloa,4177,4,17,8,11,56,44,12,59
Stranraer,4177,5,15,5,16,56,67,-11,50
East Fife,4177,6,14,3,19,50,65,-15,45
Airdrieon,4177,7,11,11,14,46,58,-12,44
Forfar,4177,8,10,5,21,38,65,-27,35
Albion,4177,9,8,7,21,59,80,-21,31
Queen's Park,4177,10,6,10,20,39,74,-35,28
Raith,4178,1,23,8,5,71,33,38,77
Ayr,4178,2,24,4,8,99,42,57,76
Arbroath,4178,3,17,8,11,71,51,20,59
Alloa,4178,4,17,8,11,57,46,11,59
Stranraer,4178,5,15,5,16,56,68,-12,50
East Fife,4178,6,14,3,19,51,65,-14,45
Airdrieon,4178,7,11,11,14,46,58,-12,44
Forfar,4178,8,10,5,21,38,65,-27,35
Queen's Park,4178,9,7,10,19,42,73,-31,31
Albion,4178,10,8,6,22,57,87,-30,30
Ayr,4179,1,24,4,8,92,42,50,76
Raith,4179,2,22,8,6,68,34,34,74
Alloa,4179,3,18,8,10,58,43,15,62
Arbroath,4179,4,17,8,11,70,50,20,59
Stranraer,4179,5,15,6,15,57,66,-9,51
East Fife,4179,6,13,4,19,49,66,-17,43
Airdrieon,4179,7,10,11,15,45,59,-14,41
Forfar,4179,8,11,5,20,39,64,-25,38
Queen's Park,4179,9,7,10,19,41,72,-31,31
Albion,4179,10,8,6,22,57,80,-23,30
Raith,4180,1,23,8,5,72,32,40,77
Ayr,4180,2,24,4,8,97,42,55,76
Arbroath,4180,3,17,8,11,70,49,21,59
Alloa,4180,4,17,8,11,56,47,9,59
Stranraer,4180,5,16,5,15,60,65,-5,53
Airdrieon,4180,6,11,11,14,49,58,-9,44
East Fife,4180,7,13,3,20,48,69,-21,42
Forfar,4180,8,10,5,21,38,68,-30,35
Queen's Park,4180,9,7,10,19,40,72,-32,31
Albion,4180,10,8,6,22,57,85,-28,30
Ayr,4181,1,24,4,8,95,44,51,76
Raith,4181,2,22,9,5,68,32,36,75
Arbroath,4181,3,18,8,10,72,48,24,62
Alloa,4181,4,17,9,10,56,43,13,60
Stranraer,4181,5,15,5,16,55,65,-10,50
East Fife,4181,6,14,3,19,48,64,-16,45
Airdrieon,4181,7,10,12,14,47,60,-13,42
Forfar,4181,8,10,6,20,40,66,-26,36
Albion,4181,9,8,6,22,59,83,-24,30
Queen's Park,4181,10,6,10,20,39,74,-35,28
Ayr,4182,1,24,4,8,94,44,50,76
Raith,4182,2,22,9,5,69,33,36,75
Arbroath,4182,3,18,8,10,74,51,23,62
Alloa,4182,4,17,9,10,57,44,13,60
Stranraer,4182,5,16,5,15,59,65,-6,53
Airdrieon,4182,6,11,11,14,47,58,-11,44
East Fife,4182,7,13,3,20,48,68,-20,42
Forfar,4182,8,10,5,21,38,66,-28,35
Albion,4182,9,8,6,22,59,82,-23,30
Queen's Park,4182,10,6,10,20,42,76,-34,28
Raith,4183,1,23,8,5,71,33,38,77
Ayr,4183,2,24,4,8,93,43,50,76
Arbroath,4183,3,18,8,10,71,48,23,62
Alloa,4183,4,17,8,11,57,46,11,59
Stranraer,4183,5,15,6,15,57,66,-9,51
East Fife,4183,6,13,4,19,49,66,-17,43
Airdrieon,4183,7,10,11,15,45,59,-14,41
Forfar,4183,8,11,5,20,39,64,-25,38
Albion,4183,9,8,6,22,58,81,-23,30
Queen's Park,4183,10,6,10,20,39,73,-34,28
Raith,4184,1,23,8,5,72,33,39,77
Ayr,4184,2,23,4,9,92,46,46,73
Arbroath,4184,3,18,8,10,73,50,23,62
Alloa,4184,4,17,8,11,57,47,10,59
Stranraer,4184,5,15,5,16,55,65,-10,50
East Fife,4184,6,14,3,19,48,64,-16,45
Airdrieon,4184,7,10,11,15,46,61,-15,41
Forfar,4184,8,11,5,20,41,65,-24,38
Albion,4184,9,9,6,21,61,80,-19,33
Queen's Park,4184,10,6,10,20,41,75,-34,28
Raith,4185,1,23,8,5,70,33,37,77
Ayr,4185,2,24,4,8,94,44,50,76
Arbroath,4185,3,18,8,10,73,49,24,62
Alloa,4185,4,17,8,11,57,45,12,59
Stranraer,4185,5,15,5,16,57,67,-10,50
East Fife,4185,6,14,3,19,50,66,-16,45
Airdrieon,4185,7,11,11,14,47,58,-11,44
Forfar,4185,8,10,5,21,38,66,-28,35
Albion,4185,9,8,6,22,59,82,-23,30
Queen's Park,4185,10,6,10,20,40,75,-35,28
Raith,4186,1,23,8,5,72,32,40,77
Ayr,4186,2,24,4,8,93,44,49,76
Arbroath,4186,3,18,8,10,74,51,23,62
Alloa,4186,4,17,8,11,56,47,9,59
Stranraer,4186,5,15,6,15,55,64,-9,51
Airdrieon,4186,6,11,11,14,47,58,-11,44
East Fife,4186,7,13,4,19,47,64,-17,43
Forfar,4186,8,10,5,21,38,66,-28,35
Albion,4186,9,8,6,22,59,81,-22,30
Queen's Park,4186,10,6,10,20,42,76,-34,28
Raith,4187,1,23,8,5,69,32,37,77
Ayr,4187,2,24,4,8,98,44,54,76
Arbroath,4187,3,18,8,10,74,48,26,62
Alloa,4187,4,17,8,11,56,44,12,59
Stranraer,4187,5,16,5,15,57,65,-8,53
Airdrieon,4187,6,11,11,14,46,58,-12,44
East Fife,4187,7,13,3,20,48,66,-18,42
Forfar,4187,8,10,5,21,38,65,-27,35
Albion,4187,9,8,6,22,59,86,-27,30
Queen's Park,4187,10,6,10,20,39,76,-37,28
Raith,4188,1,23,8,5,70,32,38,77
Ayr,4188,2,23,5,8,91,43,48,74
Arbroath,4188,3,17,9,10,71,49,22,60
Alloa,4188,4,17,8,11,56,45,11,59
Stranraer,4188,5,15,5,16,56,67,-11,50
East Fife,4188,6,14,3,19,50,65,-15,45
Airdrieon,4188,7,11,11,14,48,59,-11,44
Forfar,4188,8,10,5,21,39,67,-28,35
Albion,4188,9,8,7,21,58,79,-21,31
Queen's Park,4188,10,6,11,19,40,73,-33,29
Raith,4189,1,22,9,5,69,33,36,75
Ayr,4189,2,23,5,8,90,42,48,74
Arbroath,4189,3,17,9,10,70,48,22,60
Alloa,4189,4,17,9,10,57,44,13,60
Stranraer,4189,5,15,6,15,57,66,-9,51
Airdrieon,4189,6,11,11,14,46,58,-12,44
East Fife,4189,7,13,4,19,49,66,-17,43
Forfar,4189,8,10,5,21,38,65,-27,35
Albion,4189,9,8,7,21,57,78,-21,31
Queen's Park,4189,10,6,11,19,39,72,-33,29
Ayr,4190,1,24,4,8,95,43,52,76
Raith,4190,2,22,8,6,70,35,35,74
Arbroath,4190,3,18,8,10,72,49,23,62
Alloa,4190,4,18,8,10,59,45,14,62
Stranraer,4190,5,15,6,15,56,65,-9,51
East Fife,4190,6,13,4,19,48,65,-17,43
Airdrieon,4190,7,10,12,14,47,60,-13,42
Forfar,4190,8,10,6,20,40,66,-26,36
Albion,4190,9,8,6,22,58,83,-25,30
Queen's Park,4190,10,6,10,20,40,74,-34,28
Ayr,4191,1,24,4,8,93,43,50,76
Raith,4191,2,22,9,5,70,34,36,75
Arbroath,4191,3,18,8,10,74,50,24,62
Alloa,4191,4,17,9,10,58,45,13,60
Stranraer,4191,5,16,5,15,57,65,-8,53
Airdrieon,4191,6,10,12,14,46,59,-13,42
East Fife,4191,7,13,3,20,48,66,-18,42
Forfar,4191,8,10,6,20,39,65,-26,36
Albion,4191,9,8,6,22,58,81,-23,30
Queen's Park,4191,10,6,10,20,41,76,-35,28
Raith,4192,1,23,8,5,70,32,38,77
Ayr,4192,2,24,4,8,97,44,53,76
Arbroath,4192,3,18,8,10,71,48,23,62
Alloa,4192,4,17,8,11,56,45,11,59
Stranraer,4192,5,16,5,15,58,65,-7,53
Airdrieon,4192,6,11,11,14,47,58,-11,44
East Fife,4192,7,13,3,20,48,67,-19,42
Forfar,4192,8,10,5,21,38,66,-28,35
Albion,4192,9,8,6,22,59,85,-26,30
Queen's Park,4192,10,6,10,20,39,73,-34,28
Ayr,4193,1,24,4,8,95,46,49,76
Raith,4193,2,22,9,5,69,33,36,75
Alloa,4193,3,17,9,10,57,44,13,60
Arbroath,4193,4,17,8,11,71,50,21,59
Stranraer,4193,5,15,5,16,56,66,-10,50
East Fife,4193,6,14,3,19,49,65,-16,45
Airdrieon,4193,7,10,12,14,45,58,-13,42
Forfar,4193,8,10,6,20,38,64,-26,36
Queen's Park,4193,9,7,10,19,41,73,-32,31
Albion,4193,10,8,6,22,61,83,-22,30
Raith,4194,1,23,8,5,70,32,38,77
Ayr,4194,2,24,4,8,91,42,49,76
Arbroath,4194,3,18,8,10,73,49,24,62
Alloa,4194,4,17,8,11,56,45,11,59
Stranraer,4194,5,16,5,15,58,66,-8,53
Airdrieon,4194,6,11,11,14,47,59,-12,44
East Fife,4194,7,13,3,20,49,67,-18,42
Forfar,4194,8,10,5,21,39,66,-27,35
Albion,4194,9,8,6,22,57,79,-22,30
Queen's Park,4194,10,6,10,20,40,75,-35,28
Ayr,4195,1,24,4,8,94,43,51,76
Raith,4195,2,22,9,5,70,34,36,75
Arbroath,4195,3,18,8,10,73,49,24,62
Alloa,4195,4,17,9,10,58,45,13,60
Stranraer,4195,5,15,6,15,56,65,-9,51
Airdrieon,4195,6,11,11,14,46,58,-12,44
East Fife,4195,7,13,4,19,48,65,-17,43
Forfar,4195,8,10,5,21,38,65,-27,35
Albion,4195,9,8,6,22,58,82,-24,30
Queen's Park,4195,10,6,10,20,40,75,-35,28
Ayr,4196,1,23,5,8,93,45,48,74
Raith,4196,2,22,8,6,69,34,35,74
Alloa,4196,3,18,8,10,58,44,14,62
Arbroath,4196,4,17,9,10,72,50,22,60
Stranraer,4196,5,16,5,15,59,65,-6,53
East Fife,4196,6,13,3,20,48,68,-20,42
Airdrieon,4196,7,10,11,15,45,59,-14,41
Forfar,4196,8,11,5,20,39,64,-25,38
Albion,4196,9,8,7,21,60,81,-21,31
Queen's Park,4196,10,6,11,19,41,74,-33,29
Raith,4197,1,23,8,5,70,32,38,77
Ayr,4197,2,24,4,8,93,43,50,76
Arbroath,4197,3,18,8,10,74,48,26,62
Alloa,4197,4,17,8,11,56,45,11,59
Stranraer,4197,5,15,5,16,57,67,-10,50
East Fife,4197,6,14,3,19,50,66,-16,45
Airdrieon,4197,7,10,11,15,45,59,-14,41
Forfar,4197,8,11,5,20,39,64,-25,38
Albion,4197,9,8,6,22,58,81,-23,30
Queen's Park,4197,10,6,10,20,39,76,-37,28
Raith,4198,1,23,8,5,72,33,39,77
Ayr,4198,2,24,4,8,92,43,49,76
Arbroath,4198,3,17,8,11,72,51,21,59
Alloa,4198,4,17,8,11,57,47,10,59
Stranraer,4198,5,15,5,16,55,66,-11,50
East Fife,4198,6,14,3,19,49,64,-15,45
Airdrieon,4198,7,10,12,14,45,58,-13,42
Forfar,4198,8,10,6,20,38,64,-26,36
Queen's Park,4198,9,7,10,19,42,74,-32,31
Albion,4198,10,8,6,22,58,80,-22,30
Ayr,4199,1,24,4,8,98,43,55,76
Raith,4199,2,22,9,5,68,32,36,75
Arbroath,4199,3,18,8,10,72,49,23,62
Alloa,4199,4,17,9,10,56,43,13,60
Stranraer,4199,5,15,6,15,55,64,-9,51
East Fife,4199,6,13,4,19,47,64,-17,43
Airdrieon,4199,7,10,12,14,46,59,-13,42
Forfar,4199,8,10,6,20,39,65,-26,36
Albion,4199,9,8,6,22,58,86,-28,30
Queen's Park,4199,10,6,10,20,40,74,-34,28
Raith,4200,1,23,8,5,72,32,40,77
Ayr,4200,2,24,4,8,92,42,50,76
Arbroath,4200,3,17,8,11,72,52,20,59
Alloa,4200,4,17,8,11,56,47,9,59
Stranraer,4200,5,16,5,15,57,65,-8,53
Airdrieon,4200,6,11,11,14,47,59,-12,44
East Fife,4200,7,13,3,20,48,66,-18,42
Forfar,4200,8,10,5,21,39,66,-27,35
Queen's Park,4200,9,7,10,19,43,74,-31,31
Albion,4200,10,8,6,22,57,80,-23,30
Raith,4201,1,23,8,5,69,32,37,77
Ayr,4201,2,23,5,8,92,44,48,74
Arbroath,4201,3,18,8,10,72,48,24,62
Alloa,4201,4,17,8,11,56,44,12,59
Stranraer,4201,5,15,6,15,55,64,-9,51
Airdrieon,4201,6,11,11,14,48,58,-10,44
East Fife,4201,7,13,4,19,47,64,-17,43
Forfar,4201,8,10,5,21,38,67,-29,35
Albion,4201,9,8,7,21,59,80,-21,31
Queen's Park,4201,10,6,10,20,39,74,-35,28
Raith,4202,1,23,8,5,71,33,38,77
Ayr,4202,2,24,4,8,92,43,49,76
Arbroath,4202,3,18,8,10,74,49,25,62
Alloa,4202,4,17,8,11,57,46,11,59
Stranraer,4202,5,15,5,16,57,68,-11,50
East Fife,4202,6,14,3,19,51,66,-15,45
Airdrieon,4202,7,10,11,15,45,59,-14,41
Forfar,4202,8,11,5,20,39,64,-25,38
Albion,4202,9,8,6,22,58,80,-22,30
Queen's Park,4202,10,6,10,20,40,76,-36,28
Raith,4203,1,23,8,5,71,34,37,77
Ayr,4203,2,24,4,8,92,43,49,76
Arbroath,4203,3,18,8,10,72,49,23,62
Alloa,4203,4,17,8,11,58,46,12,59
Stranraer,4203,5,15,6,15,56,65,-9,51
East Fife,4203,6,13,4,19,48,65,-17,43
Airdrieon,4203,7,10,11,15,45,60,-15,41
Forfar,4203,8,11,5,20,40,64,-24,38
Albion,4203,9,8,6,22,58,80,-22,30
Queen's Park,4203,10,6,10,20,40,74,-34,28
Ayr,4204,1,24,4,8,95,44,51,76
Raith,4204,2,22,8,6,68,33,35,74
Alloa,4204,3,18,8,10,57,43,14,62
Arbroath,4204,4,17,8,11,70,49,21,59
Stranraer,4204,5,16,5,15,58,65,-7,53
Airdrieon,4204,6,11,11,14,47,59,-12,44
East Fife,4204,7,13,3,20,48,67,-19,42
Forfar,4204,8,10,5,21,39,66,-27,35
Queen's Park,4204,9,7,10,19,40,72,-32,31
Albion,4204,10,8,6,22,59,83,-24,30
Ayr,4205,1,24,4,8,95,43,52,76
Raith,4205,2,22,8,6,70,35,35,74
Arbroath,4205,3,18,8,10,73,50,23,62
Alloa,4205,4,18,8,10,59,45,14,62
Stranraer,4205,5,15,5,16,55,67,-12,50
East Fife,4205,6,14,3,19,50,64,-14,45
Airdrieon,4205,7,11,11,14,46,58,-12,44
Forfar,4205,8,10,5,21,38,65,-27,35
Albion,4205,9,8,6,22,58,83,-25,30
Queen's Park,4205,10,6,10,20,41,75,-34,28
Raith,4206,1,23,8,5,71,32,39,77
Ayr,4206,2,24,4,8,95,44,51,76
Arbroath,4206,3,17,9,10,72,50,22,60
Alloa,4206,4,17,8,11,56,46,10,59
Stranraer,4206,5,15,5,16,56,67,-11,50
East Fife,4206,6,14,3,19,50,65,-15,45
Airdrieon,4206,7,10,12,14,46,59,-13,42
Forfar,4206,8,10,6,20,39,65,-26,36
Albion,4206,9,8,6,22,59,83,-24,30
Queen's Park,4206,10,6,11,19,41,74,-33,29
Ayr,4207,1,24,4,8,93,43,50,76
Raith,4207,2,22,8,6,68,34,34,74
Arbroath,4207,3,18,8,10,71,48,23,62
Alloa,4207,4,18,8,10,58,43,15,62
Stranraer,4207,5,15,5,16,55,65,-10,50
East Fife,4207,6,14,3,19,48,64,-16,45
Airdrieon,4207,7,11,11,14,48,60,-12,44
Forfar,4207,8,10,5,21,40,67,-27,35
Albion,4207,9,8,6,22,58,81,-23,30
Queen's Park,4207,10,6,10,20,39,73,-34,28
Ayr,4208,1,24,4,8,97,48,49,76
Raith,4208,2,22,9,5,68,32,36,75
Arbroath,4208,3,18,8,10,71,48,23,62
Alloa,4208,4,17,9,10,56,43,13,60
Stranraer,4208,5,16,5,15,57,64,-7,53
Airdrieon,4208,6,11,11,14,47,58,-11,44
East Fife,4208,7,13,3,20,47,66,-19,42
Forfar,4208,8,10,5,21,38,66,-28,35
Albion,4208,9,8,6,22,63,85,-22,30
Queen's Park,4208,10,6,10,20,39,73,-34,28
Raith,4209,1,23,8,5,71,32,39,77
Ayr,4209,2,23,4,9,91,44,47,73
Arbroath,4209,3,17,8,11,71,50,21,59
Alloa,4209,4,17,8,11,56,46,10,59
Stranraer,4209,5,15,5,16,56,66,-10,50
East Fife,4209,6,14,3,19,49,65,-16,45
Airdrieon,4209,7,10,12,14,45,58,-13,42
Forfar,4209,8,10,6,20,38,64,-26,36
Albion,4209,9,9,6,21,59,79,-20,33
Queen's Park,4209,10,7,10,19,41,73,-32,31
Ayr,4210,1,24,4,8,95,45,50,76
Raith,4210,2,22,8,6,69,34,35,74
Alloa,4210,3,18,8,10,58,44,14,62
Arbroath,4210,4,17,8,11,70,49,21,59
Stranraer,4210,5,15,5,16,55,65,-10,50
East Fife,4210,6,14,3,19,48,64,-16,45
Airdrieon,4210,7,10,12,14,46,59,-13,42
Forfar,4210,8,10,6,20,39,65,-26,36
Queen's Park,4210,9,7,10,19,40,72,-32,31
Albion,4210,10,8,6,22,60,83,-23,30
Ayr,4211,1,24,4,8,96,43,53,76
Raith,4211,2,22,8,6,69,34,35,74
Alloa,4211,3,18,8,10,58,44,14,62
Arbroath,4211,4,17,8,11,71,52,19,59
Stranraer,4211,5,15,5,16,57,69,-12,50
East Fife,4211,6,14,3,19,52,66,-14,45
Airdrieon,4211,7,11,11,14,49,58,-9,44
Forfar,4211,8,10,5,21,38,68,-30,35
Queen's Park,4211,9,7,10,19,43,73,-30,31
Albion,4211,10,8,6,22,58,84,-26,30
Raith,4212,1,23,8,5,71,32,39,77
Ayr,4212,2,24,4,8,92,43,49,76
Arbroath,4212,3,18,8,10,72,48,24,62
Alloa,4212,4,17,8,11,56,46,10,59
Stranraer,4212,5,15,5,16,55,66,-11,50
East Fife,4212,6,14,3,19,49,64,-15,45
Airdrieon,4212,7,11,11,14,47,59,-12,44
Forfar,4212,8,10,5,21,39,66,-27,35
Albion,4212,9,8,6,22,58,80,-22,30
Queen's Park,4212,10,6,10,20,39,74,-35,28
Ayr,4213,1,24,4,8,95,43,52,76
Raith,4213,2,22,8,6,68,33,35,74
Alloa,4213,3,18,8,10,57,43,14,62
Arbroath,4213,4,17,8,11,72,51,21,59
Stranraer,4213,5,15,5,16,56,66,-10,50
East Fife,4213,6,14,3,19,49,65,-16,45
Airdrieon,4213,7,10,12,14,47,60,-13,42
Forfar,4213,8,10,6,20,40,66,-26,36
Queen's Park,4213,9,7,10,19,42,74,-32,31
Albion,4213,10,8,6,22,58,83,-25,30
Ayr,4214,1,24,4,8,95,43,52,76
Raith,4214,2,22,9,5,69,33,36,75
Arbroath,4214,3,18,8,10,72,49,23,62
Alloa,4214,4,17,9,10,57,44,13,60
Stranraer,4214,5,15,6,15,58,67,-9,51
Airdrieon,4214,6,11,11,14,48,58,-10,44
East Fife,4214,7,13,4,19,50,67,-17,43
Forfar,4214,8,10,5,21,38,67,-29,35
Albion,4214,9,8,6,22,58,83,-25,30
Queen's Park,4214,10,6,10,20,40,74,-34,28
Raith,4215,1,23,8,5,69,32,37,77
Ayr,4215,2,24,4,8,95,43,52,76
Arbroath,4215,3,18,8,10,73,49,24,62
Alloa,4215,4,17,8,11,56,44,12,59
Stranraer,4215,5,15,6,15,56,65,-9,51
Airdrieon,4215,6,11,11,14,48,59,-11,44
East Fife,4215,7,13,4,19,48,65,-17,43
Forfar,4215,8,10,5,21,39,67,-28,35
Albion,4215,9,8,6,22,58,83,-25,30
Queen's Park,4215,10,6,10,20,40,75,-35,28
Raith,4216,1,23,8,5,72,32,40,77
Ayr,4216,2,24,4,8,93,42,51,76
Arbroath,4216,3,18,8,10,73,50,23,62
Alloa,4216,4,17,8,11,56,47,9,59
Stranraer,4216,5,16,5,15,58,66,-8,53
Airdrieon,4216,6,10,12,14,45,58,-13,42
East Fife,4216,7,13,3,20,49,67,-18,42
Forfar,4216,8,10,6,20,38,64,-26,36
Albion,4216,9,8,6,22,57,81,-24,30
Queen's Park,4216,10,6,10,20,41,75,-34,28
Raith,4217,1,23,8,5,69,32,37,77
Ayr,4217,2,23,5,8,92,44,48,74
Arbroath,4217,3,17,8,11,70,49,21,59
Alloa,4217,4,17,8,11,56,44,12,59
Stranraer,4217,5,15,6,15,57,66,-9,51
Airdrieon,4217,6,11,11,14,48,59,-11,44
East Fife,4217,7,13,4,19,49,66,-17,43
Forfar,4217,8,10,5,21,39,67,-28,35
Albion,4217,9,8,7,21,59,80,-21,31
Queen's Park,4217,10,7,10,19,40,72,-32,31
Raith,4218,1,23,8,5,70,32,38,77
Ayr,4218,2,24,4,8,95,43,52,76
Arbroath,4218,3,18,8,10,71,48,23,62
Alloa,4218,4,17,8,11,56,45,11,59
Stranraer,4218,5,16,5,15,57,64,-7,53
Airdrieon,4218,6,10,12,14,47,60,-13,42
East Fife,4218,7,13,3,20,47,66,-19,42
Forfar,4218,8,10,6,20,40,66,-26,36
Albion,4218,9,8,6,22,58,83,-25,30
Queen's Park,4218,10,6,10,20,39,73,-34,28
Raith,4219,1,23,8,5,72,32,40,77
Ayr,4219,2,23,5,8,92,44,48,74
Arbroath,4219,3,17,8,11,71,50,21,59
Alloa,4219,4,17,8,11,56,47,9,59
Stranraer,4219,5,15,5,16,56,66,-10,50
East Fife,4219,6,14,3,19,49,65,-16,45
Airdrieon,4219,7,11,11,14,48,58,-10,44
Forfar,4219,8,10,5,21,38,67,-29,35
Albion,4219,9,8,7,21,59,80,-21,31
Queen's Park,4219,10,7,10,19,41,73,-32,31
Ayr,4220,1,24,4,8,93,42,51,76
Raith,4220,2,22,9,5,69,33,36,75
Arbroath,4220,3,17,9,10,70,48,22,60
Alloa,4220,4,17,9,10,57,44,13,60
Stranraer,4220,5,16,5,15,58,66,-8,53
Airdrieon,4220,6,11,11,14,47,59,-12,44
East Fife,4220,7,13,3,20,49,67,-18,42
Forfar,4220,8,10,5,21,39,66,-27,35
Albion,4220,9,8,6,22,57,81,-24,30
Queen's Park,4220,10,6,11,19,39,72,-33,29
Raith,4221,1,23,8,5,70,32,38,77
Ayr,4221,2,24,4,8,92,43,49,76
Arbroath,4221,3,17,9,10,72,50,22,60
Alloa,4221,4,17,8,11,56,45,11,59
Stranraer,4221,5,16,5,15,58,66,-8,53
Airdrieon,4221,6,10,12,14,46,59,-13,42
East Fife,4221,7,13,3,20,49,67,-18,42
Forfar,4221,8,10,6,20,39,65,-26,36
Albion,4221,9,8,6,22,58,80,-22,30
Queen's Park,4221,10,6,11,19,41,74,-33,29
Ayr,4222,1,24,4,8,94,43,51,76
Raith,4222,2,22,9,5,69,33,36,75
Arbroath,4222,3,17,9,10,72,50,22,60
Alloa,4222,4,17,9,10,57,44,13,60
Stranraer,4222,5,15,5,16,57,69,-12,50
East Fife,4222,6,14,3,19,52,66,-14,45
Airdrieon,4222,7,11,11,14,46,58,-12,44
Forfar,4222,8,10,5,21,38,65,-27,35
Albion,4222,9,8,6,22,58,82,-24,30
Queen's Park,4222,10,6,11,19,41,74,-33,29
Raith,4223,1,23,8,5,70,32,38,77
Ayr,4223,2,23,5,8,91,43,48,74
Arbroath,4223,3,18,8,10,73,50,23,62
Alloa,4223,4,17,8,11,56,45,11,59
Stranraer,4223,5,15,6,15,58,67,-9,51
East Fife,4223,6,13,4,19,50,67,-17,43
Airdrieon,4223,7,10,12,14,46,59,-13,42
Forfar,4223,8,10,6,20,39,65,-26,36
Albion,4223,9,8,7,21,58,79,-21,31
Queen's Park,4223,10,6,10,20,41,75,-34,28
Raith,4224,1,23,8,5,71,33,38,77
Ayr,4224,2,24,4,8,93,44,49,76
Arbroath,4224,3,17,9,10,71,49,22,60
Alloa,4224,4,17,8,11,57,46,11,59
Stranraer,4224,5,16,5,15,58,66,-8,53
East Fife,4224,6,13,3,20,49,67,-18,42
Airdrieon,4224,7,10,11,15,46,61,-15,41
Forfar,4224,8,11,5,20,41,65,-24,38
Albion,4224,9,8,6,22,59,81,-22,30
Queen's Park,4224,10,6,11,19,40,73,-33,29
Raith,4225,1,23,8,5,70,33,37,77
Ayr,4225,2,23,4,9,91,44,47,73
Arbroath,4225,3,17,9,10,72,50,22,60
Alloa,4225,4,17,8,11,57,45,12,59
Stranraer,4225,5,15,6,15,56,65,-9,51
Airdrieon,4225,6,11,11,14,47,58,-11,44
East Fife,4225,7,13,4,19,48,65,-17,43
Forfar,4225,8,10,5,21,38,66,-28,35
Albion,4225,9,9,6,21,59,79,-20,33
Queen's Park,4225,10,6,11,19,41,74,-33,29
Ayr,4226,1,24,4,8,95,42,53,76
Raith,4226,2,22,8,6,69,35,34,74
Arbroath,4226,3,18,8,10,72,49,23,62
Alloa,4226,4,18,8,10,59,44,15,62
Stranraer,4226,5,16,5,15,58,66,-8,53
East Fife,4226,6,13,3,20,49,67,-18,42
Airdrieon,4226,7,10,11,15,46,62,-16,41
Forfar,4226,8,11,5,20,42,65,-23,38
Albion,4226,9,8,6,22,57,83,-26,30
Queen's Park,4226,10,6,10,20,40,74,-34,28
Raith,4227,1,23,8,5,70,33,37,77
Ayr,4227,2,24,4,8,91,42,49,76
Arbroath,4227,3,18,8,10,74,49,25,62
Alloa,4227,4,17,8,11,57,45,12,59
Stranraer,4227,5,15,5,16,56,67,-11,50
East Fife,4227,6,14,3,19,50,65,-15,45
Airdrieon,4227,7,11,11,14,47,58,-11,44
Forfar,4227,8,10,5,21,38,66,-28,35
Albion,4227,9,8,6,22,57,79,-22,30
Queen's Park,4227,10,6,10,20,40,76,-36,28
Ayr,4228,1,24,4,8,96,43,53,76
Raith,4228,2,22,9,5,68,32,36,75
Arbroath,4228,3,18,8,10,72,48,24,62
Alloa,4228,4,17,9,10,56,43,13,60
Stranraer,4228,5,15,5,16,55,65,-10,50
East Fife,4228,6,14,3,19,48,64,-16,45
Airdrieon,4228,7,10,12,14,45,58,-13,42
Forfar,4228,8,10,6,20,38,64,-26,36
Albion,4228,9,8,6,22,58,84,-26,30
Queen's Park,4228,10,6,10,20,39,74,-35,28
Raith,4229,1,23,8,5,70,33,37,77
Ayr,4229,2,23,5,8,91,43,48,74
Arbroath,4229,3,17,9,10,71,49,22,60
Alloa,4229,4,17,8,11,57,45,12,59
Stranraer,4229,5,15,5,16,56,66,-10,50
East Fife,4229,6,14,3,19,49,65,-16,45
Airdrieon,4229,7,10,11,15,45,60,-15,41
Forfar,4229,8,11,5,20,40,64,-24,38
Albion,4229,9,8,7,21,58,79,-21,31
Queen's Park,4229,10,6,11,19,40,73,-33,29
Ayr,4230,1,24,4,8,92,43,49,76
Raith,4230,2,22,9,5,72,36,36,75
Arbroath,4230,3,17,9,10,72,50,22,60
Alloa,4230,4,17,9,10,60,47,13,60
Stranraer,4230,5,15,6,15,55,64,-9,51
East Fife,4230,6,13,4,19,47,64,-17,43
Airdrieon,4230,7,10,11,15,48,62,-14,41
Forfar,4230,8,11,5,20,42,67,-25,38
Albion,4230,9,8,6,22,58,80,-22,30
Queen's Park,4230,10,6,11,19,41,74,-33,29
Raith,4231,1,23,8,5,69,32,37,77
Ayr,4231,2,24,4,8,91,42,49,76
Arbroath,4231,3,18,8,10,73,49,24,62
Alloa,4231,4,17,8,11,56,44,12,59
Stranraer,4231,5,15,5,16,56,66,-10,50
East Fife,4231,6,14,3,19,49,65,-16,45
Airdrieon,4231,7,11,11,14,46,58,-12,44
Forfar,4231,8,10,5,21,38,65,-27,35
Albion,4231,9,8,6,22,57,79,-22,30
Queen's Park,4231,10,6,10,20,40,75,-35,28
Ayr,4232,1,24,4,8,95,43,52,76
Raith,4232,2,22,8,6,68,33,35,74
Arbroath,4232,3,18,8,10,71,48,23,62
Alloa,4232,4,18,8,10,57,43,14,62
Stranraer,4232,5,15,5,16,56,69,-13,50
East Fife,4232,6,14,3,19,52,65,-13,45
Airdrieon,4232,7,11,11,14,47,59,-12,44
Forfar,4232,8,10,5,21,39,66,-27,35
Albion,4232,9,8,6,22,58,83,-25,30
Queen's Park,4232,10,6,10,20,39,73,-34,28
Raith,4233,1,23,8,5,70,32,38,77
Ayr,4233,2,24,4,8,94,43,51,76
Arbroath,4233,3,18,8,10,72,49,23,62
Alloa,4233,4,17,8,11,56,45,11,59
Stranraer,4233,5,15,5,16,56,67,-11,50
East Fife,4233,6,14,3,19,50,65,-15,45
Airdrieon,4233,7,10,12,14,48,61,-13,42
Forfar,4233,8,10,6,20,41,67,-26,36
Albion,4233,9,8,6,22,58,82,-24,30
Queen's Park,4233,10,6,10,20,40,74,-34,28
Raith,4234,1,23,8,5,70,33,37,77
Ayr,4234,2,24,4,8,92,43,49,76
Arbroath,4234,3,18,8,10,74,51,23,62
Alloa,4234,4,17,8,11,57,45,12,59
Stranraer,4234,5,15,5,16,55,65,-10,50
East Fife,4234,6,14,3,19,48,64,-16,45
Airdrieon,4234,7,10,11,15,45,59,-14,41
Forfar,4234,8,11,5,20,39,64,-25,38
Albion,4234,9,8,6,22,58,80,-22,30
Queen's Park,4234,10,6,10,20,42,76,-34,28
Raith,4235,1,23,8,5,70,32,38,77
Ayr,4235,2,24,4,8,95,45,50,76
Arbroath,4235,3,17,8,11,71,50,21,59
Alloa,4235,4,17,8,11,56,45,11,59
Stranraer,4235,5,15,5,16,55,66,-11,50
East Fife,4235,6,14,3,19,49,64,-15,45
Airdrieon,4235,7,11,11,14,50,58,-8,44
Forfar,4235,8,10,5,21,38,69,-31,35
Queen's Park,4235,9,7,10,19,41,73,-32,31
Albion,4235,10,8,6,22,60,83,-23,30
Raith,4236,1,23,8,5,69,32,37,77
Ayr,4236,2,24,4,8,95,43,52,76
Arbroath,4236,3,17,8,11,71,51,20,59
Alloa,4236,4,17,8,11,56,44,12,59
Stranraer,4236,5,15,5,16,58,68,-10,50
East Fife,4236,6,14,3,19,51,67,-16,45
Airdrieon,4236,7,10,11,15,45,59,-14,41
Forfar,4236,8,11,5,20,39,64,-25,38
Queen's Park,4236,9,7,10,19,42,73,-31,31
Albion,4236,10,8,6,22,58,83,-25,30
Raith,4237,1,23,8,5,70,32,38,77
Ayr,4237,2,24,4,8,97,43,54,76
Arbroath,4237,3,18,8,10,72,48,24,62
Alloa,4237,4,17,8,11,56,45,11,59
Stranraer,4237,5,16,5,15,57,65,-8,53
East Fife,4237,6,13,3,20,48,66,-18,42
Airdrieon,4237,7,10,11,15,46,60,-14,41
Forfar,4237,8,11,5,20,40,65,-25,38
Albion,4237,9,8,6,22,58,85,-27,30
Queen's Park,4237,10,6,10,20,39,74,-35,28
Raith,4238,1,23,8,5,69,32,37,77
Ayr,4238,2,23,5,8,93,45,48,74
Arbroath,4238,3,17,8,11,70,50,20,59
Alloa,4238,4,17,8,11,56,44,12,59
Stranraer,4238,5,15,5,16,56,66,-10,50
East Fife,4238,6,14,3,19,49,65,-16,45
Airdrieon,4238,7,11,11,14,48,59,-11,44
Forfar,4238,8,10,5,21,39,67,-28,35
Albion,4238,9,8,7,21,60,81,-21,31
Queen's Park,4238,10,7,10,19,41,72,-31,31
Raith,4239,1,23,8,5,70,32,38,77
Ayr,4239,2,24,4,8,95,42,53,76
Arbroath,4239,3,17,9,10,70,48,22,60
Alloa,4239,4,17,8,11,56,45,11,59
Stranraer,4239,5,15,5,16,56,66,-10,50
East Fife,4239,6,14,3,19,49,65,-16,45
Airdrieon,4239,7,11,11,14,47,59,-12,44
Forfar,4239,8,10,5,21,39,66,-27,35
Albion,4239,9,8,6,22,57,83,-26,30
Queen's Park,4239,10,6,11,19,39,72,-33,29
Raith,4240,1,23,8,5,73,33,40,77
Ayr,4240,2,24,4,8,95,44,51,76
Arbroath,4240,3,17,8,11,71,51,20,59
Alloa,4240,4,17,8,11,57,48,9,59
Stranraer,4240,5,15,5,16,56,66,-10,50
East Fife,4240,6,14,3,19,49,65,-16,45
Airdrieon,4240,7,11,11,14,47,58,-11,44
Forfar,4240,8,10,5,21,38,66,-28,35
Queen's Park,4240,9,7,10,19,42,73,-31,31
Albion,4240,10,8,6,22,59,83,-24,30
Raith,4241,1,23,8,5,69,32,37,77
Ayr,4241,2,24,4,8,94,42,52,76
Arbroath,4241,3,18,8,10,72,48,24,62
Alloa,4241,4,17,8,11,56,44,12,59
Stranraer,4241,5,16,5,15,60,64,-4,53
Airdrieon,4241,6,11,11,14,46,58,-12,44
East Fife,4241,7,13,3,20,47,69,-22,42
Forfar,4241,8,10,5,21,38,65,-27,35
Albion,4241,9,8,6,22,57,82,-25,30
Queen's Park,4241,10,6,10,20,39,74,-35,28
Ayr,4242,1,24,4,8,93,42,51,76
Raith,4242,2,22,9,5,69,33,36,75
Alloa,4242,3,17,9,10,57,44,13,60
Arbroath,4242,4,17,8,11,71,51,20,59
Stranraer,4242,5,15,6,15,56,65,-9,51
East Fife,4242,6,13,4,19,48,65,-17,43
Airdrieon,4242,7,10,12,14,46,59,-13,42
Forfar,4242,8,10,6,20,39,65,-26,36
Queen's Park,4242,9,7,10,19,42,73,-31,31
Albion,4242,10,8,6,22,57,81,-24,30
Raith,4243,1,23,8,5,69,32,37,77
Ayr,4243,2,24,4,8,93,42,51,76
Arbroath,4243,3,17,8,11,70,49,21,59
Alloa,4243,4,17,8,11,56,44,12,59
Stranraer,4243,5,16,5,15,58,65,-7,53
Airdrieon,4243,6,11,11,14,48,58,-10,44
East Fife,4243,7,13,3,20,48,67,-19,42
Forfar,4243,8,10,5,21,38,67,-29,35
Queen's Park,4243,9,7,10,19,40,72,-32,31
Albion,4243,10,8,6,22,57,81,-24,30
Ayr,4244,1,24,4,8,95,44,51,76
Raith,4244,2,22,8,6,68,34,34,74
Alloa,4244,3,18,8,10,58,43,15,62
Arbroath,4244,4,17,8,11,72,51,21,59
Stranraer,4244,5,16,5,15,59,65,-6,53
East Fife,4244,6,13,3,20,48,68,-20,42
Airdrieon,4244,7,10,11,15,45,59,-14,41
Forfar,4244,8,11,5,20,39,64,-25,38
Queen's Park,4244,9,7,10,19,42,74,-32,31
Albion,4244,10,8,6,22,59,83,-24,30
Raith,4245,1,23,8,5,69,32,37,77
Ayr,4245,2,24,4,8,93,44,49,76
Arbroath,4245,3,17,8,11,71,50,21,59
Alloa,4245,4,17,8,11,56,44,12,59
Stranraer,4245,5,16,5,15,57,65,-8,53
Airdrieon,4245,6,10,12,14,46,59,-13,42
East Fife,4245,7,13,3,20,48,66,-18,42
Forfar,4245,8,10,6,20,39,65,-26,36
Queen's Park,4245,9,7,10,19,41,73,-32,31
Albion,4245,10,8,6,22,59,81,-22,30
Raith,4246,1,23,8,5,73,33,40,77
Ayr,4246,2,24,4,8,91,42,49,76
Arbroath,4246,3,18,8,10,71,48,23,62
Alloa,4246,4,17,8,11,57,48,9,59
Stranraer,4246,5,15,5,16,55,66,-11,50
East Fife,4246,6,14,3,19,49,64,-15,45
Airdrieon,4246,7,10,11,15,45,59,-14,41
Forfar,4246,8,11,5,20,39,64,-25,38
Albion,4246,9,8,6,22,57,79,-22,30
Queen's Park,4246,10,6,10,20,39,73,-34,28
Ayr,4247,1,24,4,8,95,42,53,76
Raith,4247,2,22,8,6,69,34,35,74
Alloa,4247,3,18,8,10,58,44,14,62
Arbroath,4247,4,17,8,11,70,50,20,59
Stranraer,4247,5,15,5,16,55,65,-10,50
East Fife,4247,6,14,3,19,48,64,-16,45
Airdrieon,4247,7,10,12,14,45,58,-13,42
Forfar,4247,8,10,6,20,38,64,-26,36
Queen's Park,4247,9,7,10,19,41,72,-31,31
Albion,4247,10,8,6,22,57,83,-26,30
Ayr,4248,1,24,4,8,93,43,50,76
Raith,4248,2,22,8,6,68,33,35,74
Arbroath,4248,3,18,8,10,72,49,23,62
Alloa,4248,4,18,8,10,57,43,14,62
Stranraer,4248,5,15,5,16,55,65,-10,50
East Fife,4248,6,14,3,19,48,64,-16,45
Airdrieon,4248,7,10,12,14,47,60,-13,42
Forfar,4248,8,10,6,20,40,66,-26,36
Albion,4248,9,8,6,22,58,81,-23,30
Queen's Park,4248,10,6,10,20,40,74,-34,28
Raith,4249,1,23,8,5,70,33,37,77
Ayr,4249,2,24,4,8,95,45,50,76
Arbroath,4249,3,18,8,10,73,48,25,62
Alloa,4249,4,17,8,11,57,45,12,59
Stranraer,4249,5,16,5,15,58,65,-7,53
Airdrieon,4249,6,10,12,14,47,60,-13,42
East Fife,4249,7,13,3,20,48,67,-19,42
Forfar,4249,8,10,6,20,40,66,-26,36
Albion,4249,9,8,6,22,60,83,-23,30
Queen's Park,4249,10,6,10,20,39,75,-36,28
Ayr,4250,1,24,4,8,94,43,51,76
Raith,4250,2,22,9,5,69,33,36,75
Alloa,4250,3,17,9,10,57,44,13,60
Arbroath,4250,4,17,8,11,70,49,21,59
Stranraer,4250,5,15,5,16,55,66,-11,50
East Fife,4250,6,14,3,19,49,64,-15,45
Airdrieon,4250,7,10,12,14,46,59,-13,42
Forfar,4250,8,10,6,20,39,65,-26,36
Queen's Park,4250,9,7,10,19,40,72,-32,31
Albion,4250,10,8,6,22,58,82,-24,30
Raith,4251,1,23,8,5,72,33,39,77
Ayr,4251,2,23,4,9,92,45,47,73
Arbroath,4251,3,17,8,11,70,50,20,59
Alloa,4251,4,17,8,11,57,47,10,59
Stranraer,4251,5,15,5,16,56,66,-10,50
East Fife,4251,6,14,3,19,49,65,-16,45
Airdrieon,4251,7,11,11,14,46,58,-12,44
Forfar,4251,8,10,5,21,38,65,-27,35
Albion,4251,9,9,6,21,60,80,-20,33
Queen's Park,4251,10,7,10,19,41,72,-31,31
Raith,4252,1,23,8,5,71,32,39,77
Ayr,4252,2,24,4,8,92,43,49,76
Arbroath,4252,3,18,8,10,73,48,25,62
Alloa,4252,4,17,8,11,56,46,10,59
Stranraer,4252,5,15,5,16,55,68,-13,50
East Fife,4252,6,14,3,19,51,64,-13,45
Airdrieon,4252,7,11,11,14,48,59,-11,44
Forfar,4252,8,10,5,21,39,67,-28,35
Albion,4252,9,8,6,22,58,80,-22,30
Queen's Park,4252,10,6,10,20,39,75,-36,28
Raith,4253,1,23,8,5,69,32,37,77
Ayr,4253,2,24,4,8,95,45,50,76
Arbroath,4253,3,17,8,11,71,50,21,59
Alloa,4253,4,17,8,11,56,44,12,59
Stranraer,4253,5,16,5,15,58,65,-7,53
Airdrieon,4253,6,10,12,14,46,59,-13,42
East Fife,4253,7,13,3,20,48,67,-19,42
Forfar,4253,8,10,6,20,39,65,-26,36
Queen's Park,4253,9,7,10,19,41,73,-32,31
Albion,4253,10,8,6,22,60,83,-23,30
Ayr,4254,1,24,4,8,95,42,53,76
Raith,4254,2,22,8,6,68,33,35,74
Alloa,4254,3,18,8,10,57,43,14,62
Arbroath,4254,4,17,9,10,71,49,22,60
Stranraer,4254,5,15,5,16,56,66,-10,50
East Fife,4254,6,14,3,19,49,65,-16,45
Airdrieon,4254,7,10,12,14,46,59,-13,42
Forfar,4254,8,10,6,20,39,65,-26,36
Albion,4254,9,8,6,22,57,83,-26,30
Queen's Park,4254,10,6,11,19,40,73,-33,29
Raith,4255,1,23,8,5,69,32,37,77
Ayr,4255,2,23,4,9,91,44,47,73
Arbroath,4255,3,17,8,11,72,52,20,59
Alloa,4255,4,17,8,11,56,44,12,59
Stranraer,4255,5,15,5,16,56,66,-10,50
East Fife,4255,6,14,3,19,49,65,-16,45
Airdrieon,4255,7,10,11,15,45,59,-14,41
Forfar,4255,8,11,5,20,39,64,-25,38
Albion,4255,9,9,6,21,59,79,-20,33
Queen's Park,4255,10,7,10,19,43,74,-31,31
Ayr,4256,1,24,4,8,93,42,51,76
Raith,4256,2,22,8,6,69,35,34,74
Arbroath,4256,3,18,8,10,73,49,24,62
Alloa,4256,4,18,8,10,59,44,15,62
Stranraer,4256,5,15,5,16,55,66,-11,50
East Fife,4256,6,14,3,19,49,64,-15,45
Airdrieon,4256,7,10,11,15,45,59,-14,41
Forfar,4256,8,11,5,20,39,64,-25,38
Albion,4256,9,8,6,22,57,81,-24,30
Queen's Park,4256,10,6,10,20,40,75,-35,28
Ayr,4257,1,24,4,8,94,42,52,76
Raith,4257,2,22,9,5,70,34,36,75
Arbroath,4257,3,18,8,10,73,49,24,62
Alloa,4257,4,17,9,10,58,45,13,60
Stranraer,4257,5,16,5,15,57,65,-8,53
East Fife,4257,6,13,3,20,48,66,-18,42
Airdrieon,4257,7,10,11,15,45,61,-16,41
Forfar,4257,8,11,5,20,41,64,-23,38
Albion,4257,9,8,6,22,57,82,-25,30
Queen's Park,4257,10,6,10,20,40,75,-35,28
Raith,4258,1,23,8,5,70,32,38,77
Ayr,4258,2,24,4,8,92,42,50,76
Arbroath,4258,3,18,8,10,73,50,23,62
Alloa,4258,4,17,8,11,56,45,11,59
Stranraer,4258,5,15,6,15,56,65,-9,51
Airdrieon,4258,6,11,11,14,48,59,-11,44
East Fife,4258,7,13,4,19,48,65,-17,43
Forfar,4258,8,10,5,21,39,67,-28,35
Albion,4258,9,8,6,22,57,80,-23,30
Queen's Park,4258,10,6,10,20,41,75,-34,28
Raith,4259,1,23,8,5,70,33,37,77
Ayr,4259,2,24,4,8,94,44,50,76
Arbroath,4259,3,17,9,10,70,48,22,60
Alloa,4259,4,17,8,11,57,45,12,59
Stranraer,4259,5,15,5,16,56,66,-10,50
East Fife,4259,6,14,3,19,49,65,-16,45
Airdrieon,4259,7,11,11,14,48,58,-10,44
Forfar,4259,8,10,5,21,38,67,-29,35
Albion,4259,9,8,6,22,59,82,-23,30
Queen's Park,4259,10,6,11,19,39,72,-33,29
Raith,4260,1,22,8,6,68,35,33,74
Ayr,4260,2,23,4,9,90,43,47,73
Alloa,4260,3,18,8,10,59,43,16,62
Arbroath,4260,4,17,8,11,71,52,19,59
Stranraer,4260,5,15,6,15,56,65,-9,51
Airdrieon,4260,6,11,11,14,46,58,-12,44
East Fife,4260,7,13,4,19,48,65,-17,43
Forfar,4260,8,10,5,21,38,65,-27,35
Albion,4260,9,9,6,21,58,78,-20,33
Queen's Park,4260,10,7,10,19,43,73,-30,31
Ayr,4261,1,24,4,8,94,44,50,76
Raith,4261,2,22,9,5,69,33,36,75
Arbroath,4261,3,17,9,10,73,51,22,60
Alloa,4261,4,17,9,10,57,44,13,60
Stranraer,4261,5,16,5,15,57,65,-8,53
East Fife,4261,6,13,3,20,48,66,-18,42
Airdrieon,4261,7,10,11,15,45,59,-14,41
Forfar,4261,8,11,5,20,39,64,-25,38
Albion,4261,9,8,6,22,59,82,-23,30
Queen's Park,4261,10,6,11,19,42,75,-33,29
Raith,4262,1,23,8,5,70,33,37,77
Ayr,4262,2,24,4,8,92,42,50,76
Arbroath,4262,3,18,8,10,71,48,23,62
Alloa,4262,4,17,8,11,57,45,12,59
Stranraer,4262,5,16,5,15,57,65,-8,53
Airdrieon,4262,6,11,11,14,46,58,-12,44
East Fife,4262,7,13,3,20,48,66,-18,42
Forfar,4262,8,10,5,21,38,65,-27,35
Albion,4262,9,8,6,22,57,80,-23,30
Queen's Park,4262,10,6,10,20,39,73,-34,28
Ayr,4263,1,24,4,8,93,42,51,76
Raith,4263,2,22,9,5,68,32,36,75
Arbroath,4263,3,17,9,10,73,51,22,60
Alloa,4263,4,17,9,10,56,43,13,60
Stranraer,4263,5,15,6,15,57,66,-9,51
East Fife,4263,6,13,4,19,49,66,-17,43
Airdrieon,4263,7,10,12,14,47,60,-13,42
Forfar,4263,8,10,6,20,40,66,-26,36
Albion,4263,9,8,6,22,57,81,-24,30
Queen's Park,4263,10,6,11,19,42,75,-33,29
Raith,4264,1,23,8,5,70,32,38,77
Ayr,4264,2,24,4,8,93,42,51,76
Arbroath,4264,3,17,9,10,72,50,22,60
Alloa,4264,4,17,8,11,56,45,11,59
Stranraer,4264,5,15,5,16,56,70,-14,50
East Fife,4264,6,14,3,19,53,65,-12,45
Airdrieon,4264,7,10,12,14,46,59,-13,42
Forfar,4264,8,10,6,20,39,65,-26,36
Albion,4264,9,8,6,22,57,81,-24,30
Queen's Park,4264,10,6,11,19,41,74,-33,29
Raith,4265,1,23,8,5,73,32,41,77
Ayr,4265,2,24,4,8,91,42,49,76
Arbroath,4265,3,17,8,11,70,52,18,59
Alloa,4265,4,17,8,11,56,48,8,59
Stranraer,4265,5,15,5,16,56,66,-10,50
East Fife,4265,6,14,3,19,49,65,-16,45
Airdrieon,4265,7,11,11,14,48,58,-10,44
Forfar,4265,8,10,5,21,38,67,-29,35
Queen's Park,4265,9,7,10,19,43,72,-29,31
Albion,4265,10,8,6,22,57,79,-22,30
Ayr,4266,1,24,4,8,94,44,50,76
Raith,4266,2,22,9,5,69,33,36,75
Alloa,4266,3,17,9,10,57,44,13,60
Arbroath,4266,4,17,8,11,71,50,21,59
Stranraer,4266,5,15,5,16,55,66,-11,50
East Fife,4266,6,14,3,19,49,64,-15,45
Airdrieon,4266,7,11,11,14,48,59,-11,44
Forfar,4266,8,10,5,21,39,67,-28,35
Queen's Park,4266,9,7,10,19,41,73,-32,31
Albion,4266,10,8,6,22,59,82,-23,30
Raith,4267,1,23,8,5,70,33,37,77
Ayr,4267,2,24,4,8,94,42,52,76
Arbroath,4267,3,18,8,10,71,48,23,62
Alloa,4267,4,17,8,11,57,45,12,59
Stranraer,4267,5,15,5,16,55,66,-11,50
East Fife,4267,6,14,3,19,49,64,-15,45
Airdrieon,4267,7,11,11,14,47,58,-11,44
Forfar,4267,8,10,5,21,38,66,-28,35
Albion,4267,9,8,6,22,57,82,-25,30
Queen's Park,4267,10,6,10,20,39,73,-34,28
Ayr,4268,1,24,4,8,95,42,53,76
Raith,4268,2,22,8,6,68,33,35,74
Arbroath,4268,3,18,8,10,73,49,24,62
Alloa,4268,4,18,8,10,57,43,14,62
Stranraer,4268,5,15,5,16,56,67,-11,50
East Fife,4268,6,14,3,19,50,65,-15,45
Airdrieon,4268,7,10,12,14,46,59,-13,42
Forfar,4268,8,10,6,20,39,65,-26,36
Albion,4268,9,8,6,22,57,83,-26,30
Queen's Park,4268,10,6,10,20,40,75,-35,28
Ayr,4269,1,24,4,8,95,42,53,76
Raith,4269,2,22,8,6,68,33,35,74
Alloa,4269,3,18,8,10,57,43,14,62
Arbroath,4269,4,17,8,11,71,50,21,59
Stranraer,4269,5,16,5,15,59,65,-6,53
Airdrieon,4269,6,11,11,14,48,58,-10,44
East Fife,4269,7,13,3,20,48,68,-20,42
Forfar,4269,8,10,5,21,38,67,-29,35
Queen's Park,4269,9,7,10,19,41,73,-32,31
Albion,4269,10,8,6,22,57,83,-26,30
Raith,4270,1,23,8,5,70,33,37,77
Ayr,4270,2,24,4,8,94,44,50,76
Arbroath,4270,3,18,8,10,73,50,23,62
Alloa,4270,4,17,8,11,57,45,12,59
Stranraer,4270,5,16,5,15,58,65,-7,53
Airdrieon,4270,6,11,11,14,49,59,-10,44
East Fife,4270,7,13,3,20,48,67,-19,42
Forfar,4270,8,10,5,21,39,68,-29,35
Albion,4270,9,8,6,22,59,82,-23,30
Queen's Park,4270,10,6,10,20,41,75,-34,28
Raith,4271,1,23,8,5,71,34,37,77
Ayr,4271,2,23,4,9,91,44,47,73
Arbroath,4271,3,18,8,10,73,49,24,62
Alloa,4271,4,17,8,11,58,46,12,59
Stranraer,4271,5,15,5,16,56,67,-11,50
East Fife,4271,6,14,3,19,50,65,-15,45
Airdrieon,4271,7,10,11,15,45,59,-14,41
Forfar,4271,8,11,5,20,39,64,-25,38
Albion,4271,9,9,6,21,59,79,-20,33
Queen's Park,4271,10,6,10,20,40,75,-35,28
Raith,4272,1,23,8,5,70,33,37,77
Ayr,4272,2,24,4,8,94,43,51,76
Arbroath,4272,3,18,8,10,71,48,23,62
Alloa,4272,4,17,8,11,57,45,12,59
Stranraer,4272,5,15,5,16,57,67,-10,50
East Fife,4272,6,14,3,19,50,66,-16,45
Airdrieon,4272,7,11,11,14,46,58,-12,44
Forfar,4272,8,10,5,21,38,65,-27,35
Albion,4272,9,8,6,22,58,82,-24,30
Queen's Park,4272,10,6,10,20,39,73,-34,28
Ayr,4273,1,24,4,8,93,44,49,76
Raith,4273,2,22,9,5,70,34,36,75
Arbroath,4273,3,18,8,10,71,48,23,62
Alloa,4273,4,17,9,10,58,45,13,60
Stranraer,4273,5,16,5,15,57,64,-7,53
Airdrieon,4273,6,10,12,14,47,60,-13,42
East Fife,4273,7,13,3,20,47,66,-19,42
Forfar,4273,8,10,6,20,40,66,-26,36
Albion,4273,9,8,6,22,59,81,-22,30
Queen's Park,4273,10,6,10,20,39,73,-34,28
Raith,4274,1,23,8,5,71,34,37,77
Ayr,4274,2,24,4,8,95,43,52,76
Arbroath,4274,3,17,8,11,70,50,20,59
Alloa,4274,4,17,8,11,58,46,12,59
Stranraer,4274,5,15,5,16,56,67,-11,50
East Fife,4274,6,14,3,19,50,65,-15,45
Airdrieon,4274,7,10,12,14,47,60,-13,42
Forfar,4274,8,10,6,20,40,66,-26,36
Queen's Park,4274,9,7,10,19,41,72,-31,31
Albion,4274,10,8,6,22,58,83,-25,30
Ayr,4275,1,24,4,8,94,42,52,76
Raith,4275,2,22,9,5,68,32,36,75
Alloa,4275,3,17,9,10,56,43,13,60
Arbroath,4275,4,17,8,11,71,53,18,59
Stranraer,4275,5,15,6,15,56,65,-9,51
Airdrieon,4275,6,11,11,14,46,58,-12,44
East Fife,4275,7,13,4,19,48,65,-17,43
Forfar,4275,8,10,5,21,38,65,-27,35
Queen's Park,4275,9,7,10,19,44,73,-29,31
Albion,4275,10,8,6,22,57,82,-25,30
Raith,4276,1,23,8,5,70,33,37,77
Ayr,4276,2,24,4,8,95,42,53,76
Arbroath,4276,3,17,9,10,71,49,22,60
Alloa,4276,4,17,8,11,57,45,12,59
Stranraer,4276,5,16,5,15,59,66,-7,53
East Fife,4276,6,13,3,20,49,68,-19,42
Airdrieon,4276,7,10,11,15,45,61,-16,41
Forfar,4276,8,11,5,20,41,64,-23,38
Albion,4276,9,8,6,22,57,83,-26,30
Queen's Park,4276,10,6,11,19,40,73,-33,29
Ayr,4277,1,24,4,8,93,42,51,76
Raith,4277,2,22,8,6,68,35,33,74
Alloa,4277,3,18,8,10,59,43,16,62
Arbroath,4277,4,17,8,11,71,50,21,59
Stranraer,4277,5,15,6,15,56,65,-9,51
Airdrieon,4277,6,11,11,14,46,58,-12,44
East Fife,4277,7,13,4,19,48,65,-17,43
Forfar,4277,8,10,5,21,38,65,-27,35
Queen's Park,4277,9,7,10,19,41,73,-32,31
Albion,4277,10,8,6,22,57,81,-24,30
Raith,4278,1,23,8,5,70,33,37,77
Ayr,4278,2,24,4,8,93,42,51,76
Arbroath,4278,3,17,8,11,70,49,21,59
Alloa,4278,4,17,8,11,57,45,12,59
Stranraer,4278,5,16,5,15,57,64,-7,53
Airdrieon,4278,6,10,12,14,46,59,-13,42
East Fife,4278,7,13,3,20,47,66,-19,42
Forfar,4278,8,10,6,20,39,65,-26,36
Queen's Park,4278,9,7,10,19,40,72,-32,31
Albion,4278,10,8,6,22,57,81,-24,30
Raith,4279,1,23,8,5,69,32,37,77
Ayr,4279,2,24,4,8,94,42,52,76
Arbroath,4279,3,18,8,10,75,51,24,62
Alloa,4279,4,17,8,11,56,44,12,59
Stranraer,4279,5,15,5,16,56,66,-10,50
East Fife,4279,6,14,3,19,49,65,-16,45
Airdrieon,4279,7,11,11,14,47,59,-12,44
Forfar,4279,8,10,5,21,39,66,-27,35
Albion,4279,9,8,6,22,57,82,-25,30
Queen's Park,4279,10,6,10,20,42,77,-35,28
Raith,4280,1,23,8,5,70,33,37,77
Ayr,4280,2,24,4,8,97,43,54,76
Arbroath,4280,3,18,8,10,72,49,23,62
Alloa,4280,4,17,8,11,57,45,12,59
Stranraer,4280,5,15,5,16,56,67,-11,50
East Fife,4280,6,14,3,19,50,65,-15,45
Airdrieon,4280,7,10,11,15,45,61,-16,41
Forfar,4280,8,11,5,20,41,64,-23,38
Albion,4280,9,8,6,22,58,85,-27,30
Queen's Park,4280,10,6,10,20,40,74,-34,28
Raith,4281,1,23,8,5,70,32,38,77
Ayr,4281,2,23,5,8,91,43,48,74
Arbroath,4281,3,17,8,11,70,50,20,59
Alloa,4281,4,17,8,11,56,45,11,59
Stranraer,4281,5,15,5,16,56,66,-10,50
East Fife,4281,6,14,3,19,49,65,-16,45
Airdrieon,4281,7,10,12,14,47,60,-13,42
Forfar,4281,8,10,6,20,40,66,-26,36
Albion,4281,9,8,7,21,58,79,-21,31
Queen's Park,4281,10,7,10,19,41,72,-31,31
Ayr,4282,1,24,4,8,95,44,51,76
Raith,4282,2,22,9,5,69,33,36,75
Alloa,4282,3,17,9,10,57,44,13,60
Arbroath,4282,4,17,8,11,70,49,21,59
Stranraer,4282,5,15,5,16,55,65,-10,50
East Fife,4282,6,14,3,19,48,64,-16,45
Airdrieon,4282,7,10,11,15,45,59,-14,41
Forfar,4282,8,11,5,20,39,64,-25,38
Queen's Park,4282,9,7,10,19,40,72,-32,31
Albion,4282,10,8,6,22,59,83,-24,30
Raith,4283,1,23,8,5,71,32,39,77
Ayr,4283,2,23,5,8,92,44,48,74
Arbroath,4283,3,18,8,10,73,49,24,62
Alloa,4283,4,17,8,11,56,46,10,59
Stranraer,4283,5,16,5,15,58,65,-7,53
East Fife,4283,6,13,3,20,48,67,-19,42
Airdrieon,4283,7,10,11,15,45,61,-16,41
Forfar,4283,8,11,5,20,41,64,-23,38
Albion,4283,9,8,7,21,59,80,-21,31
Queen's Park,4283,10,6,10,20,40,75,-35,28
Raith,4284,1,23,8,5,71,34,37,77
Ayr,4284,2,24,4,8,94,43,51,76
Arbroath,4284,3,17,8,11,70,49,21,59
Alloa,4284,4,17,8,11,58,46,12,59
Stranraer,4284,5,15,5,16,56,66,-10,50
East Fife,4284,6,14,3,19,49,65,-16,45
Airdrieon,4284,7,10,11,15,45,59,-14,41
Forfar,4284,8,11,5,20,39,64,-25,38
Queen's Park,4284,9,7,10,19,40,72,-32,31
Albion,4284,10,8,6,22,58,82,-24,30
Ayr,4285,1,24,4,8,96,42,54,76
Raith,4285,2,22,8,6,70,36,34,74
Alloa,4285,3,18,8,10,60,45,15,62
Arbroath,4285,4,17,9,10,72,50,22,60
Stranraer,4285,5,15,5,16,55,67,-12,50
East Fife,4285,6,14,3,19,50,64,-14,45
Airdrieon,4285,7,10,11,15,47,64,-17,41
Forfar,4285,8,11,5,20,44,66,-22,38
Albion,4285,9,8,6,22,57,84,-27,30
Queen's Park,4285,10,6,11,19,41,74,-33,29
Raith,4286,1,23,8,5,70,32,38,77
Ayr,4286,2,23,5,8,92,44,48,74
Arbroath,4286,3,18,8,10,72,49,23,62
Alloa,4286,4,17,8,11,56,45,11,59
Stranraer,4286,5,15,5,16,55,68,-13,50
East Fife,4286,6,14,3,19,51,64,-13,45
Airdrieon,4286,7,10,12,14,47,60,-13,42
Forfar,4286,8,10,6,20,40,66,-26,36
Albion,4286,9,8,7,21,59,80,-21,31
Queen's Park,4286,10,6,10,20,40,74,-34,28
Ayr,4287,1,24,4,8,94,43,51,76
Raith,4287,2,22,8,6,68,33,35,74
Alloa,4287,3,18,8,10,57,43,14,62
Arbroath,4287,4,17,8,11,70,49,21,59
Stranraer,4287,5,16,5,15,56,64,-8,53
Airdrieon,4287,6,11,11,14,49,58,-9,44
East Fife,4287,7,13,3,20,47,65,-18,42
Forfar,4287,8,10,5,21,38,68,-30,35
Queen's Park,4287,9,7,10,19,40,72,-32,31
Albion,4287,10,8,6,22,58,82,-24,30
Ayr,4288,1,24,4,8,93,43,50,76
Raith,4288,2,22,9,5,69,33,36,75
Arbroath,4288,3,18,8,10,73,48,25,62
Alloa,4288,4,17,9,10,57,44,13,60
Stranraer,4288,5,15,6,15,56,65,-9,51
Airdrieon,4288,6,11,11,14,48,60,-12,44
East Fife,4288,7,13,4,19,48,65,-17,43
Forfar,4288,8,10,5,21,40,67,-27,35
Albion,4288,9,8,6,22,58,81,-23,30
Queen's Park,4288,10,6,10,20,39,75,-36,28
Raith,4289,1,23,8,5,69,32,37,77
Ayr,4289,2,24,4,8,94,43,51,76
Arbroath,4289,3,17,8,11,70,52,18,59
Alloa,4289,4,17,8,11,56,44,12,59
Stranraer,4289,5,15,6,15,56,65,-9,51
East Fife,4289,6,13,4,19,48,65,-17,43
Airdrieon,4289,7,10,12,14,45,58,-13,42
Forfar,4289,8,10,6,20,38,64,-26,36
Queen's Park,4289,9,7,10,19,43,72,-29,31
Albion,4289,10,8,6,22,58,82,-24,30
Raith,4290,1,23,8,5,69,32,37,77
Ayr,4290,2,24,4,8,95,43,52,76
Arbroath,4290,3,17,9,10,72,50,22,60
Alloa,4290,4,17,8,11,56,44,12,59
Stranraer,4290,5,15,6,15,56,65,-9,51
East Fife,4290,6,13,4,19,48,65,-17,43
Airdrieon,4290,7,10,11,15,46,61,-15,41
Forfar,4290,8,11,5,20,41,65,-24,38
Albion,4290,9,8,6,22,58,83,-25,30
Queen's Park,4290,10,6,11,19,41,74,-33,29
Raith,4291,1,23,8,5,70,33,37,77
Ayr,4291,2,24,4,8,93,44,49,76
Arbroath,4291,3,17,9,10,71,49,22,60
Alloa,4291,4,17,8,11,57,45,12,59
Stranraer,4291,5,15,6,15,56,65,-9,51
Airdrieon,4291,6,11,11,14,46,58,-12,44
East Fife,4291,7,13,4,19,48,65,-17,43
Forfar,4291,8,10,5,21,38,65,-27,35
Albion,4291,9,8,6,22,59,81,-22,30
Queen's Park,4291,10,6,11,19,40,73,-33,29
Ayr,4292,1,24,4,8,92,42,50,76
Raith,4292,2,22,9,5,71,35,36,75
Arbroath,4292,3,18,8,10,72,49,23,62
Alloa,4292,4,17,9,10,59,46,13,60
Stranraer,4292,5,16,5,15,57,64,-7,53
Airdrieon,4292,6,11,11,14,48,59,-11,44
East Fife,4292,7,13,3,20,47,66,-19,42
Forfar,4292,8,10,5,21,39,67,-28,35
Albion,4292,9,8,6,22,57,80,-23,30
Queen's Park,4292,10,6,10,20,40,74,-34,28
Ayr,4293,1,24,4,8,95,43,52,76
Raith,4293,2,22,9,5,69,33,36,75
Arbroath,4293,3,18,8,10,71,48,23,62
Alloa,4293,4,17,9,10,57,44,13,60
Stranraer,4293,5,15,5,16,55,65,-10,50
East Fife,4293,6,14,3,19,48,64,-16,45
Airdrieon,4293,7,11,11,14,50,60,-10,44
Forfar,4293,8,10,5,21,40,69,-29,35
Albion,4293,9,8,6,22,58,83,-25,30
Queen's Park,4293,10,6,10,20,39,73,-34,28
Raith,4294,1,23,8,5,73,34,39,77
Ayr,4294,2,24,4,8,94,42,52,76
Arbroath,4294,3,18,8,10,73,49,24,62
Alloa,4294,4,17,8,11,58,48,10,59
Stranraer,4294,5,16,5,15,58,64,-6,53
Airdrieon,4294,6,10,12,14,46,59,-13,42
East Fife,4294,7,13,3,20,47,67,-20,42
Forfar,4294,8,10,6,20,39,65,-26,36
Albion,4294,9,8,6,22,57,82,-25,30
Queen's Park,4294,10,6,10,20,40,75,-35,28
Raith,4295,1,23,8,5,70,32,38,77
Ayr,4295,2,24,4,8,96,46,50,76
Arbroath,4295,3,18,8,10,72,48,24,62
Alloa,4295,4,17,8,11,56,45,11,59
Stranraer,4295,5,15,6,15,56,65,-9,51
Airdrieon,4295,6,11,11,14,48,59,-11,44
East Fife,4295,7,13,4,19,48,65,-17,43
Forfar,4295,8,10,5,21,39,67,-28,35
Albion,4295,9,8,6,22,61,84,-23,30
Queen's Park,4295,10,6,10,20,39,74,-35,28
Raith,4296,1,23,8,5,71,32,39,77
Ayr,4296,2,23,5,8,91,43,48,74
Arbroath,4296,3,17,8,11,72,51,21,59
Alloa,4296,4,17,8,11,56,46,10,59
Stranraer,4296,5,15,5,16,55,67,-12,50
East Fife,4296,6,14,3,19,50,64,-14,45
Airdrieon,4296,7,10,11,15,45,60,-15,41
Forfar,4296,8,11,5,20,40,64,-24,38
Albion,4296,9,8,7,21,58,79,-21,31
Queen's Park,4296,10,7,10,19,42,74,-32,31
Raith,4297,1,23,8,5,70,32,38,77
Ayr,4297,2,24,4,8,91,42,49,76
Arbroath,4297,3,18,8,10,73,49,24,62
Alloa,4297,4,17,8,11,56,45,11,59
Stranraer,4297,5,16,5,15,59,66,-7,53
East Fife,4297,6,13,3,20,49,68,-19,42
Airdrieon,4297,7,10,11,15,48,62,-14,41
Forfar,4297,8,11,5,20,42,67,-25,38
Albion,4297,9,8,6,22,57,79,-22,30
Queen's Park,4297,10,6,10,20,40,75,-35,28
Ayr,4298,1,24,4,8,94,43,51,76
Raith,4298,2,22,9,5,69,33,36,75
Alloa,4298,3,17,9,10,57,44,13,60
Arbroath,4298,4,17,8,11,71,50,21,59
Stranraer,4298,5,16,5,15,59,66,-7,53
Airdrieon,4298,6,11,11,14,48,59,-11,44
East Fife,4298,7,13,3,20,49,68,-19,42
Forfar,4298,8,10,5,21,39,67,-28,35
Queen's Park,4298,9,7,10,19,41,73,-32,31
Albion,4298,10,8,6,22,58,82,-24,30
Raith,4299,1,23,8,5,70,33,37,77
Ayr,4299,2,24,4,8,94,44,50,76
Arbroath,4299,3,18,8,10,71,48,23,62
Alloa,4299,4,17,8,11,57,45,12,59
Stranraer,4299,5,16,5,15,56,64,-8,53
East Fife,4299,6,13,3,20,47,65,-18,42
Airdrieon,4299,7,10,11,15,45,59,-14,41
Forfar,4299,8,11,5,20,39,64,-25,38
Albion,4299,9,8,6,22,59,82,-23,30
Queen's Park,4299,10,6,10,20,39,73,-34,28
Raith,4300,1,23,8,5,70,32,38,77
Ayr,4300,2,24,4,8,93,43,50,76
Arbroath,4300,3,18,8,10,73,49,24,62
Alloa,4300,4,17,8,11,56,45,11,59
Stranraer,4300,5,15,5,16,55,65,-10,50
East Fife,4300,6,14,3,19,48,64,-16,45
Airdrieon,4300,7,10,11,15,45,59,-14,41
Forfar,4300,8,11,5,20,39,64,-25,38
Albion,4300,9,8,6,22,58,81,-23,30
Queen's Park,4300,10,6,10,20,40,75,-35,28
Raith,4301,1,23,8,5,71,33,38,77
Ayr,4301,2,24,4,8,92,42,50,76
Arbroath,4301,3,17,9,10,72,50,22,60
Alloa,4301,4,17,8,11,57,46,11,59
Stranraer,4301,5,16,5,15,57,65,-8,53
Airdrieon,4301,6,11,11,14,46,58,-12,44
East Fife,4301,7,13,3,20,48,66,-18,42
Forfar,4301,8,10,5,21,38,65,-27,35
Albion,4301,9,8,6,22,57,80,-23,30
Queen's Park,4301,10,6,11,19,41,74,-33,29
Ayr,4302,1,24,4,8,96,43,53,76
Raith,4302,2,22,8,6,69,34,35,74
Arbroath,4302,3,18,8,10,73,50,23,62
Alloa,4302,4,18,8,10,58,44,14,62
Stranraer,4302,5,15,5,16,57,67,-10,50
East Fife,4302,6,14,3,19,50,66,-16,45
Airdrieon,4302,7,11,11,14,47,58,-11,44
Forfar,4302,8,10,5,21,38,66,-28,35
Albion,4302,9,8,6,22,58,84,-26,30
Queen's Park,4302,10,6,10,20,41,75,-34,28
Raith,4303,1,22,9,5,69,33,36,75
Ayr,4303,2,23,5,8,92,44,48,74
Arbroath,4303,3,18,8,10,73,48,25,62
Alloa,4303,4,17,9,10,57,44,13,60
Stranraer,4303,5,15,5,16,55,67,-12,50
East Fife,4303,6,14,3,19,50,64,-14,45
Airdrieon,4303,7,11,11,14,46,58,-12,44
Forfar,4303,8,10,5,21,38,65,-27,35
Albion,4303,9,8,7,21,59,80,-21,31
Queen's Park,4303,10,6,10,20,39,75,-36,28
Ayr,4304,1,24,4,8,95,42,53,76
Raith,4304,2,22,9,5,69,33,36,75
Alloa,4304,3,17,9,10,57,44,13,60
Arbroath,4304,4,17,8,11,70,49,21,59
Stranraer,4304,5,15,5,16,55,66,-11,50
East Fife,4304,6,14,3,19,49,64,-15,45
Airdrieon,4304,7,11,11,14,49,60,-11,44
Forfar,4304,8,10,5,21,40,68,-28,35
Queen's Park,4304,9,7,10,19,40,72,-32,31
Albion,4304,10,8,6,22,57,83,-26,30
Ayr,4305,1,24,4,8,94,43,51,76
Raith,4305,2,22,9,5,71,35,36,75
Arbroath,4305,3,18,8,10,72,48,24,62
Alloa,4305,4,17,9,10,59,46,13,60
Stranraer,4305,5,15,5,16,55,67,-12,50
East Fife,4305,6,14,3,19,50,64,-14,45
Airdrieon,4305,7,11,11,14,48,60,-12,44
Forfar,4305,8,10,5,21,40,67,-27,35
Albion,4305,9,8,6,22,58,82,-24,30
Queen's Park,4305,10,6,10,20,39,74,-35,28
Raith,4306,1,23,8,5,72,33,39,77
Ayr,4306,2,23,5,8,91,43,48,74
Arbroath,4306,3,18,8,10,72,49,23,62
Alloa,4306,4,17,8,11,57,47,10,59
Stranraer,4306,5,15,5,16,55,65,-10,50
East Fife,4306,6,14,3,19,48,64,-16,45
Airdrieon,4306,7,10,11,15,46,60,-14,41
Forfar,4306,8,11,5,20,40,65,-25,38
Albion,4306,9,8,7,21,58,79,-21,31
Queen's Park,4306,10,6,10,20,40,74,-34,28
Raith,4307,1,23,8,5,72,33,39,77
Ayr,4307,2,24,4,8,91,42,49,76
Arbroath,4307,3,18,8,10,74,50,24,62
Alloa,4307,4,17,8,11,57,47,10,59
Stranraer,4307,5,16,5,15,57,65,-8,53
Airdrieon,4307,6,10,12,14,45,58,-13,42
East Fife,4307,7,13,3,20,48,66,-18,42
Forfar,4307,8,10,6,20,38,64,-26,36
Albion,4307,9,8,6,22,57,79,-22,30
Queen's Park,4307,10,6,10,20,41,76,-35,28
Raith,4308,1,23,8,5,71,33,38,77
Ayr,4308,2,24,4,8,94,43,51,76
Arbroath,4308,3,18,8,10,71,48,23,62
Alloa,4308,4,17,8,11,57,46,11,59
Stranraer,4308,5,16,5,15,58,66,-8,53
East Fife,4308,6,13,3,20,49,67,-18,42
Airdrieon,4308,7,10,11,15,45,60,-15,41
Forfar,4308,8,11,5,20,40,64,-24,38
Albion,4308,9,8,6,22,58,82,-24,30
Queen's Park,4308,10,6,10,20,39,73,-34,28
Ayr,4309,1,24,4,8,92,42,50,76
Raith,4309,2,22,9,5,69,33,36,75
Arbroath,4309,3,18,8,10,73,49,24,62
Alloa,4309,4,17,9,10,57,44,13,60
Stranraer,4309,5,15,6,15,55,64,-9,51
Airdrieon,4309,6,11,11,14,47,59,-12,44
East Fife,4309,7,13,4,19,47,64,-17,43
Forfar,4309,8,10,5,21,39,66,-27,35
Albion,4309,9,8,6,22,57,80,-23,30
Queen's Park,4309,10,6,10,20,40,75,-35,28
Raith,4310,1,23,8,5,73,34,39,77
Ayr,4310,2,24,4,8,94,42,52,76
Arbroath,4310,3,18,8,10,72,49,23,62
Alloa,4310,4,17,8,11,58,48,10,59
Stranraer,4310,5,16,5,15,57,65,-8,53
Airdrieon,4310,6,11,11,14,49,58,-9,44
East Fife,4310,7,13,3,20,48,66,-18,42
Forfar,4310,8,10,5,21,38,68,-30,35
Albion,4310,9,8,6,22,57,82,-25,30
Queen's Park,4310,10,6,10,20,40,74,-34,28
Raith,4311,1,22,8,6,69,36,33,74
Ayr,4311,2,23,4,9,91,44,47,73
Arbroath,4311,3,18,8,10,73,49,24,62
Alloa,4311,4,18,8,10,60,44,16,62
Stranraer,4311,5,15,6,15,56,65,-9,51
Airdrieon,4311,6,11,11,14,48,60,-12,44
East Fife,4311,7,13,4,19,48,65,-17,43
Forfar,4311,8,10,5,21,40,67,-27,35
Albion,4311,9,9,6,21,59,79,-20,33
Queen's Park,4311,10,6,10,20,40,75,-35,28
Raith,4312,1,23,8,5,71,33,38,77
Ayr,4312,2,24,4,8,94,43,51,76
Arbroath,4312,3,17,9,10,71,49,22,60
Alloa,4312,4,17,8,11,57,46,11,59
Stranraer,4312,5,15,5,16,58,69,-11,50
East Fife,4312,6,14,3,19,52,67,-15,45
Airdrieon,4312,7,10,11,15,47,61,-14,41
Forfar,4312,8,11,5,20,41,66,-25,38
Albion,4312,9,8,6,22,58,82,-24,30
Queen's Park,4312,10,6,11,19,40,73,-33,29
Ayr,4313,1,24,4,8,94,44,50,76
Raith,4313,2,22,9,5,69,33,36,75
Alloa,4313,3,17,9,10,57,44,13,60
Arbroath,4313,4,17,8,11,72,51,21,59
Stranraer,4313,5,15,6,15,56,65,-9,51
Airdrieon,4313,6,11,11,14,48,60,-12,44
East Fife,4313,7,13,4,19,48,65,-17,43
Forfar,4313,8,10,5,21,40,67,-27,35
Queen's Park,4313,9,7,10,19,42,74,-32,31
Albion,4313,10,8,6,22,59,82,-23,30
Ayr,4314,1,24,4,8,94,45,49,76
Raith,4314,2,22,9,5,68,32,36,75
Alloa,4314,3,17,9,10,56,43,13,60
Arbroath,4314,4,17,8,11,72,51,21,59
Stranraer,4314,5,15,5,16,55,66,-11,50
East Fife,4314,6,14,3,19,49,64,-15,45
Airdrieon,4314,7,10,12,14,46,59,-13,42
Forfar,4314,8,10,6,20,39,65,-26,36
Queen's Park,4314,9,7,10,19,42,74,-32,31
Albion,4314,10,8,6,22,60,82,-22,30
Raith,4315,1,23,8,5,69,32,37,77
Ayr,4315,2,24,4,8,93,42,51,76
Arbroath,4315,3,18,8,10,74,51,23,62
Alloa,4315,4,17,8,11,56,44,12,59
Stranraer,4315,5,15,5,16,55,68,-13,50
East Fife,4315,6,14,3,19,51,64,-13,45
Airdrieon,4315,7,10,12,14,48,61,-13,42
Forfar,4315,8,10,6,20,41,67,-26,36
Albion,4315,9,8,6,22,57,81,-24,30
Queen's Park,4315,10,6,10,20,42,76,-34,28
Raith,4316,1,23,8,5,74,32,42,77
Ayr,4316,2,24,4,8,94,43,51,76
Arbroath,4316,3,18,8,10,71,48,23,62
Alloa,4316,4,17,8,11,56,49,7,59
Stranraer,4316,5,15,6,15,57,66,-9,51
Airdrieon,4316,6,11,11,14,48,58,-10,44
East Fife,4316,7,13,4,19,49,66,-17,43
Forfar,4316,8,10,5,21,38,67,-29,35
Albion,4316,9,8,6,22,58,82,-24,30
Queen's Park,4316,10,6,10,20,39,73,-34,28
Raith,4317,1,23,8,5,72,32,40,77
Ayr,4317,2,24,4,8,95,44,51,76
Arbroath,4317,3,17,8,11,71,50,21,59
Alloa,4317,4,17,8,11,56,47,9,59
Stranraer,4317,5,15,5,16,55,66,-11,50
East Fife,4317,6,14,3,19,49,64,-15,45
Airdrieon,4317,7,11,11,14,48,60,-12,44
Forfar,4317,8,10,5,21,40,67,-27,35
Queen's Park,4317,9,7,10,19,41,73,-32,31
Albion,4317,10,8,6,22,59,83,-24,30
Ayr,4318,1,24,4,8,94,42,52,76
Raith,4318,2,22,8,6,68,33,35,74
Alloa,4318,3,18,8,10,57,43,14,62
Arbroath,4318,4,17,8,11,71,50,21,59
Stranraer,4318,5,16,5,15,58,66,-8,53
East Fife,4318,6,13,3,20,49,67,-18,42
Airdrieon,4318,7,10,11,15,45,61,-16,41
Forfar,4318,8,11,5,20,41,64,-23,38
Queen's Park,4318,9,7,10,19,41,73,-32,31
Albion,4318,10,8,6,22,57,82,-25,30
Ayr,4319,1,24,4,8,93,43,50,76
Raith,4319,2,22,8,6,69,34,35,74
Arbroath,4319,3,18,8,10,73,48,25,62
Alloa,4319,4,18,8,10,58,44,14,62
Stranraer,4319,5,16,5,15,57,64,-7,53
East Fife,4319,6,13,3,20,47,66,-19,42
Airdrieon,4319,7,10,11,15,45,60,-15,41
Forfar,4319,8,11,5,20,40,64,-24,38
Albion,4319,9,8,6,22,58,81,-23,30
Queen's Park,4319,10,6,10,20,39,75,-36,28
Ayr,4320,1,23,5,8,91,43,48,74
Raith,4320,2,22,8,6,68,33,35,74
Arbroath,4320,3,18,8,10,72,48,24,62
Alloa,4320,4,18,8,10,57,43,14,62
Stranraer,4320,5,15,5,16,56,68,-12,50
East Fife,4320,6,14,3,19,51,65,-14,45
Airdrieon,4320,7,10,11,15,47,62,-15,41
Forfar,4320,8,11,5,20,42,66,-24,38
Albion,4320,9,8,7,21,58,79,-21,31
Queen's Park,4320,10,6,10,20,39,74,-35,28
Raith,4321,1,23,8,5,71,32,39,77
Ayr,4321,2,23,4,9,92,46,46,73
Arbroath,4321,3,17,9,10,70,48,22,60
Alloa,4321,4,17,8,11,56,46,10,59
Stranraer,4321,5,15,6,15,55,64,-9,51
East Fife,4321,6,13,4,19,47,64,-17,43
Airdrieon,4321,7,10,11,15,46,60,-14,41
Forfar,4321,8,11,5,20,40,65,-25,38
Albion,4321,9,9,6,21,61,80,-19,33
Queen's Park,4321,10,6,11,19,39,72,-33,29
Ayr,4322,1,24,4,8,94,42,52,76
Raith,4322,2,22,9,5,70,34,36,75
Arbroath,4322,3,17,9,10,72,50,22,60
Alloa,4322,4,17,9,10,58,45,13,60
Stranraer,4322,5,15,6,15,56,65,-9,51
Airdrieon,4322,6,11,11,14,46,58,-12,44
East Fife,4322,7,13,4,19,48,65,-17,43
Forfar,4322,8,10,5,21,38,65,-27,35
Albion,4322,9,8,6,22,57,82,-25,30
Queen's Park,4322,10,6,11,19,41,74,-33,29
Ayr,4323,1,24,4,8,96,44,52,76
Raith,4323,2,22,9,5,69,33,36,75
Arbroath,4323,3,17,9,10,71,49,22,60
Alloa,4323,4,17,9,10,57,44,13,60
Stranraer,4323,5,16,5,15,58,66,-8,53
Airdrieon,4323,6,10,12,14,47,60,-13,42
East Fife,4323,7,13,3,20,49,67,-18,42
Forfar,4323,8,10,6,20,40,66,-26,36
Albion,4323,9,8,6,22,59,84,-25,30
Queen's Park,4323,10,6,11,19,40,73,-33,29
Ayr,4324,1,24,4,8,96,45,51,76
Raith,4324,2,22,8,6,68,34,34,74
Alloa,4324,3,18,8,10,58,43,15,62
Arbroath,4324,4,17,9,10,73,51,22,60
Stranraer,4324,5,15,5,16,55,67,-12,50
East Fife,4324,6,14,3,19,50,64,-14,45
Airdrieon,4324,7,11,11,14,48,59,-11,44
Forfar,4324,8,10,5,21,39,67,-28,35
Albion,4324,9,8,6,22,60,84,-24,30
Queen's Park,4324,10,6,11,19,42,75,-33,29
Ayr,4325,1,24,4,8,95,43,52,76
Raith,4325,2,22,9,5,69,33,36,75
Arbroath,4325,3,18,8,10,73,50,23,62
Alloa,4325,4,17,9,10,57,44,13,60
Stranraer,4325,5,16,5,15,58,65,-7,53
East Fife,4325,6,13,3,20,48,67,-19,42
Airdrieon,4325,7,10,11,15,45,59,-14,41
Forfar,4325,8,11,5,20,39,64,-25,38
Albion,4325,9,8,6,22,58,83,-25,30
Queen's Park,4325,10,6,10,20,41,75,-34,28
Raith,4326,1,22,9,5,69,33,36,75
Ayr,4326,2,23,5,8,91,43,48,74
Arbroath,4326,3,18,8,10,73,49,24,62
Alloa,4326,4,17,9,10,57,44,13,60
Stranraer,4326,5,15,6,15,56,65,-9,51
Airdrieon,4326,6,11,11,14,48,60,-12,44
East Fife,4326,7,13,4,19,48,65,-17,43
Forfar,4326,8,10,5,21,40,67,-27,35
Albion,4326,9,8,7,21,58,79,-21,31
Queen's Park,4326,10,6,10,20,40,75,-35,28
Raith,4327,1,22,9,5,69,33,36,75
Ayr,4327,2,23,5,8,92,44,48,74
Arbroath,4327,3,18,8,10,73,50,23,62
Alloa,4327,4,17,9,10,57,44,13,60
Stranraer,4327,5,15,6,15,56,65,-9,51
Airdrieon,4327,6,11,11,14,48,58,-10,44
East Fife,4327,7,13,4,19,48,65,-17,43
Forfar,4327,8,10,5,21,38,67,-29,35
Albion,4327,9,8,7,21,59,80,-21,31
Queen's Park,4327,10,6,10,20,41,75,-34,28
Raith,4328,1,22,8,6,70,36,34,74
Ayr,4328,2,23,4,9,91,45,46,73
Arbroath,4328,3,18,8,10,71,48,23,62
Alloa,4328,4,18,8,10,60,45,15,62
Stranraer,4328,5,15,5,16,56,67,-11,50
East Fife,4328,6,14,3,19,50,65,-15,45
Airdrieon,4328,7,10,11,15,46,61,-15,41
Forfar,4328,8,11,5,20,41,65,-24,38
Albion,4328,9,9,6,21,60,79,-19,33
Queen's Park,4328,10,6,10,20,39,73,-34,28
Raith,4329,1,23,8,5,69,32,37,77
Ayr,4329,2,24,4,8,91,42,49,76
Arbroath,4329,3,18,8,10,72,49,23,62
Alloa,4329,4,17,8,11,56,44,12,59
Stranraer,4329,5,15,6,15,56,65,-9,51
East Fife,4329,6,13,4,19,48,65,-17,43
Airdrieon,4329,7,10,11,15,45,61,-16,41
Forfar,4329,8,11,5,20,41,64,-23,38
Albion,4329,9,8,6,22,57,79,-22,30
Queen's Park,4329,10,6,10,20,40,74,-34,28
Ayr,4330,1,24,4,8,93,44,49,76
Raith,4330,2,22,9,5,69,33,36,75
Alloa,4330,3,17,9,10,57,44,13,60
Arbroath,4330,4,17,8,11,71,50,21,59
Stranraer,4330,5,15,5,16,56,67,-11,50
East Fife,4330,6,14,3,19,50,65,-15,45
Airdrieon,4330,7,11,11,14,48,58,-10,44
Forfar,4330,8,10,5,21,38,67,-29,35
Queen's Park,4330,9,7,10,19,41,73,-32,31
Albion,4330,10,8,6,22,59,81,-22,30
Raith,4331,1,23,8,5,73,32,41,77
Ayr,4331,2,24,4,8,96,42,54,76
Arbroath,4331,3,17,9,10,70,48,22,60
Alloa,4331,4,17,8,11,56,48,8,59
Stranraer,4331,5,15,6,15,56,65,-9,51
East Fife,4331,6,13,4,19,48,65,-17,43
Airdrieon,4331,7,10,11,15,45,59,-14,41
Forfar,4331,8,11,5,20,39,64,-25,38
Albion,4331,9,8,6,22,57,84,-27,30
Queen's Park,4331,10,6,11,19,39,72,-33,29
Raith,4332,1,23,8,5,69,32,37,77
Ayr,4332,2,24,4,8,94,45,49,76
Arbroath,4332,3,18,8,10,73,50,23,62
Alloa,4332,4,17,8,11,56,44,12,59
Stranraer,4332,5,15,6,15,57,66,-9,51
East Fife,4332,6,13,4,19,49,66,-17,43
Airdrieon,4332,7,10,12,14,46,59,-13,42
Forfar,4332,8,10,6,20,39,65,-26,36
Albion,4332,9,8,6,22,60,82,-22,30
Queen's Park,4332,10,6,10,20,41,75,-34,28
Ayr,4333,1,24,4,8,93,43,50,76
Raith,4333,2,22,9,5,69,33,36,75
Arbroath,4333,3,17,9,10,71,49,22,60
Alloa,4333,4,17,9,10,57,44,13,60
Stranraer,4333,5,16,5,15,57,64,-7,53
Airdrieon,4333,6,11,11,14,49,60,-11,44
East Fife,4333,7,13,3,20,47,66,-19,42
Forfar,4333,8,10,5,21,40,68,-28,35
Albion,4333,9,8,6,22,58,81,-23,30
Queen's Park,4333,10,6,11,19,40,73,-33,29
Raith,4334,1,23,8,5,70,33,37,77
Ayr,4334,2,23,4,9,91,44,47,73
Arbroath,4334,3,18,8,10,75,49,26,62
Alloa,4334,4,17,8,11,57,45,12,59
Stranraer,4334,5,15,5,16,56,68,-12,50
East Fife,4334,6,14,3,19,51,65,-14,45
Airdrieon,4334,7,11,11,14,47,59,-12,44
Forfar,4334,8,10,5,21,39,66,-27,35
Albion,4334,9,9,6,21,59,79,-20,33
Queen's Park,4334,10,6,10,20,40,77,-37,28
Ayr,4335,1,24,4,8,95,43,52,76
Raith,4335,2,22,9,5,69,33,36,75
Arbroath,4335,3,18,8,10,73,49,24,62
Alloa,4335,4,17,9,10,57,44,13,60
Stranraer,4335,5,15,5,16,57,67,-10,50
East Fife,4335,6,14,3,19,50,66,-16,45
Airdrieon,4335,7,10,11,15,46,60,-14,41
Forfar,4335,8,11,5,20,40,65,-25,38
Albion,4335,9,8,6,22,58,83,-25,30
Queen's Park,4335,10,6,10,20,40,75,-35,28
Raith,4336,1,23,8,5,70,32,38,77
Ayr,4336,2,24,4,8,94,43,51,76
Arbroath,4336,3,17,8,11,72,52,20,59
Alloa,4336,4,17,8,11,56,45,11,59
Stranraer,4336,5,15,6,15,55,64,-9,51
Airdrieon,4336,6,11,11,14,47,59,-12,44
East Fife,4336,7,13,4,19,47,64,-17,43
Forfar,4336,8,10,5,21,39,66,-27,35
Queen's Park,4336,9,7,10,19,43,74,-31,31
Albion,4336,10,8,6,22,58,82,-24,30
Raith,4337,1,23,8,5,71,34,37,77
Ayr,4337,2,24,4,8,92,43,49,76
Arbroath,4337,3,18,8,10,72,49,23,62
Alloa,4337,4,17,8,11,58,46,12,59
Stranraer,4337,5,15,5,16,56,68,-12,50
East Fife,4337,6,14,3,19,51,65,-14,45
Airdrieon,4337,7,11,11,14,46,58,-12,44
Forfar,4337,8,10,5,21,38,65,-27,35
Albion,4337,9,8,6,22,58,80,-22,30
Queen's Park,4337,10,6,10,20,40,74,-34,28
Raith,4338,1,23,8,5,70,33,37,77
Ayr,4338,2,24,4,8,91,42,49,76
Arbroath,4338,3,17,9,10,72,50,22,60
Alloa,4338,4,17,8,11,57,45,12,59
Stranraer,4338,5,15,5,16,56,67,-11,50
East Fife,4338,6,14,3,19,50,65,-15,45
Airdrieon,4338,7,10,11,15,46,60,-14,41
Forfar,4338,8,11,5,20,40,65,-25,38
Albion,4338,9,8,6,22,57,79,-22,30
Queen's Park,4338,10,6,11,19,41,74,-33,29
Raith,4339,1,23,8,5,70,32,38,77
Ayr,4339,2,24,4,8,94,43,51,76
Arbroath,4339,3,18,8,10,72,48,24,62
Alloa,4339,4,17,8,11,56,45,11,59
Stranraer,4339,5,15,5,16,57,68,-11,50
East Fife,4339,6,14,3,19,51,66,-15,45
Airdrieon,4339,7,10,11,15,45,59,-14,41
Forfar,4339,8,11,5,20,39,64,-25,38
Albion,4339,9,8,6,22,58,82,-24,30
Queen's Park,4339,10,6,10,20,39,74,-35,28
Raith,4340,1,23,8,5,70,32,38,77
Ayr,4340,2,23,5,8,91,43,48,74
Arbroath,4340,3,17,8,11,71,51,20,59
Alloa,4340,4,17,8,11,56,45,11,59
Stranraer,4340,5,15,5,16,55,68,-13,50
East Fife,4340,6,14,3,19,51,64,-13,45
Airdrieon,4340,7,11,11,14,46,58,-12,44
Forfar,4340,8,10,5,21,38,65,-27,35
Albion,4340,9,8,7,21,58,79,-21,31
Queen's Park,4340,10,7,10,19,42,73,-31,31
Raith,4341,1,22,8,6,69,36,33,74
Ayr,4341,2,23,4,9,90,45,45,73
Arbroath,4341,3,18,8,10,72,48,24,62
Alloa,4341,4,18,8,10,60,44,16,62
Stranraer,4341,5,15,5,16,56,67,-11,50
East Fife,4341,6,14,3,19,50,65,-15,45
Airdrieon,4341,7,11,11,14,48,58,-10,44
Forfar,4341,8,10,5,21,38,67,-29,35
Albion,4341,9,9,6,21,60,78,-18,33
Queen's Park,4341,10,6,10,20,39,74,-35,28
Ayr,4342,1,24,4,8,96,43,53,76
Raith,4342,2,22,9,5,69,33,36,75
Arbroath,4342,3,18,8,10,71,48,23,62
Alloa,4342,4,17,9,10,57,44,13,60
Stranraer,4342,5,15,5,16,55,66,-11,50
East Fife,4342,6,14,3,19,49,64,-15,45
Airdrieon,4342,7,11,11,14,47,59,-12,44
Forfar,4342,8,10,5,21,39,66,-27,35
Albion,4342,9,8,6,22,58,84,-26,30
Queen's Park,4342,10,6,10,20,39,73,-34,28
Raith,4343,1,23,8,5,70,32,38,77
Ayr,4343,2,24,4,8,91,42,49,76
Arbroath,4343,3,17,8,11,71,50,21,59
Alloa,4343,4,17,8,11,56,45,11,59
Stranraer,4343,5,16,5,15,58,66,-8,53
Airdrieon,4343,6,11,11,14,48,59,-11,44
East Fife,4343,7,13,3,20,49,67,-18,42
Forfar,4343,8,10,5,21,39,67,-28,35
Queen's Park,4343,9,7,10,19,41,73,-32,31
Albion,4343,10,8,6,22,57,79,-22,30
Raith,4344,1,23,8,5,70,33,37,77
Ayr,4344,2,24,4,8,93,44,49,76
Arbroath,4344,3,18,8,10,72,48,24,62
Alloa,4344,4,17,8,11,57,45,12,59
Stranraer,4344,5,16,5,15,56,64,-8,53
Airdrieon,4344,6,11,11,14,46,58,-12,44
East Fife,4344,7,13,3,20,47,65,-18,42
Forfar,4344,8,10,5,21,38,65,-27,35
Albion,4344,9,8,6,22,59,81,-22,30
Queen's Park,4344,10,6,10,20,39,74,-35,28
Raith,4345,1,23,8,5,69,32,37,77
Ayr,4345,2,23,4,9,91,44,47,73
Arbroath,4345,3,18,8,10,74,48,26,62
Alloa,4345,4,17,8,11,56,44,12,59
Stranraer,4345,5,15,5,16,56,68,-12,50
East Fife,4345,6,14,3,19,51,65,-14,45
Airdrieon,4345,7,10,11,15,46,61,-15,41
Forfar,4345,8,11,5,20,41,65,-24,38
Albion,4345,9,9,6,21,59,79,-20,33
Queen's Park,4345,10,6,10,20,39,76,-37,28
Raith,4346,1,23,8,5,69,32,37,77
Ayr,4346,2,24,4,8,92,43,49,76
Arbroath,4346,3,18,8,10,72,48,24,62
Alloa,4346,4,17,8,11,56,44,12,59
Stranraer,4346,5,16,5,15,59,66,-7,53
Airdrieon,4346,6,11,11,14,47,58,-11,44
East Fife,4346,7,13,3,20,49,68,-19,42
Forfar,4346,8,10,5,21,38,66,-28,35
Albion,4346,9,8,6,22,58,80,-22,30
Queen's Park,4346,10,6,10,20,39,74,-35,28
Raith,4347,1,23,8,5,69,32,37,77
Ayr,4347,2,23,5,8,91,43,48,74
Arbroath,4347,3,18,8,10,72,49,23,62
Alloa,4347,4,17,8,11,56,44,12,59
Stranraer,4347,5,15,5,16,55,65,-10,50
East Fife,4347,6,14,3,19,48,64,-16,45
Airdrieon,4347,7,10,11,15,46,60,-14,41
Forfar,4347,8,11,5,20,40,65,-25,38
Albion,4347,9,8,7,21,58,79,-21,31
Queen's Park,4347,10,6,10,20,40,74,-34,28
Raith,4348,1,22,8,6,68,33,35,74
Ayr,4348,2,23,4,9,90,43,47,73
Alloa,4348,3,18,8,10,57,43,14,62
Arbroath,4348,4,17,9,10,70,48,22,60
Stranraer,4348,5,16,5,15,56,64,-8,53
Airdrieon,4348,6,11,11,14,47,59,-12,44
East Fife,4348,7,13,3,20,47,65,-18,42
Forfar,4348,8,10,5,21,39,66,-27,35
Albion,4348,9,9,6,21,58,78,-20,33
Queen's Park,4348,10,6,11,19,39,72,-33,29
Ayr,4349,1,24,4,8,97,43,54,76
Raith,4349,2,22,8,6,68,34,34,74
Alloa,4349,3,18,8,10,58,43,15,62
Arbroath,4349,4,17,8,11,70,50,20,59
Stranraer,4349,5,15,5,16,55,65,-10,50
East Fife,4349,6,14,3,19,48,64,-16,45
Airdrieon,4349,7,11,11,14,46,58,-12,44
Forfar,4349,8,10,5,21,38,65,-27,35
Queen's Park,4349,9,7,10,19,41,72,-31,31
Albion,4349,10,8,6,22,58,85,-27,30
Raith,4350,1,23,8,5,69,32,37,77
Ayr,4350,2,24,4,8,93,43,50,76
Arbroath,4350,3,18,8,10,72,48,24,62
Alloa,4350,4,17,8,11,56,44,12,59
Stranraer,4350,5,16,5,15,58,66,-8,53
Airdrieon,4350,6,11,11,14,47,58,-11,44
East Fife,4350,7,13,3,20,49,67,-18,42
Forfar,4350,8,10,5,21,38,66,-28,35
Albion,4350,9,8,6,22,58,81,-23,30
Queen's Park,4350,10,6,10,20,39,74,-35,28
Raith,4351,1,23,8,5,70,32,38,77
Ayr,4351,2,23,4,9,92,45,47,73
Arbroath,4351,3,17,9,10,72,50,22,60
Alloa,4351,4,17,8,11,56,45,11,59
Stranraer,4351,5,15,5,16,56,66,-10,50
East Fife,4351,6,14,3,19,49,65,-16,45
Airdrieon,4351,7,10,12,14,47,60,-13,42
Forfar,4351,8,10,6,20,40,66,-26,36
Albion,4351,9,9,6,21,60,80,-20,33
Queen's Park,4351,10,6,11,19,41,74,-33,29
Ayr,4352,1,24,4,8,92,43,49,76
Raith,4352,2,22,9,5,70,34,36,75
Arbroath,4352,3,18,8,10,72,48,24,62
Alloa,4352,4,17,9,10,58,45,13,60
Stranraer,4352,5,15,5,16,55,65,-10,50
East Fife,4352,6,14,3,19,48,64,-16,45
Airdrieon,4352,7,11,11,14,46,58,-12,44
Forfar,4352,8,10,5,21,38,65,-27,35
Albion,4352,9,8,6,22,58,80,-22,30
Queen's Park,4352,10,6,10,20,39,74,-35,28
Raith,4353,1,23,8,5,69,32,37,77
Ayr,4353,2,24,4,8,93,44,49,76
Arbroath,4353,3,17,9,10,70,48,22,60
Alloa,4353,4,17,8,11,56,44,12,59
Stranraer,4353,5,15,5,16,56,66,-10,50
East Fife,4353,6,14,3,19,49,65,-16,45
Airdrieon,4353,7,11,11,14,46,58,-12,44
Forfar,4353,8,10,5,21,38,65,-27,35
Albion,4353,9,8,6,22,59,81,-22,30
Queen's Park,4353,10,6,11,19,39,72,-33,29
Raith,4354,1,23,8,5,70,33,37,77
Ayr,4354,2,24,4,8,92,42,50,76
Arbroath,4354,3,18,8,10,72,49,23,62
Alloa,4354,4,17,8,11,57,45,12,59
Stranraer,4354,5,15,5,16,55,66,-11,50
East Fife,4354,6,14,3,19,49,64,-15,45
Airdrieon,4354,7,11,11,14,46,58,-12,44
Forfar,4354,8,10,5,21,38,65,-27,35
Albion,4354,9,8,6,22,57,80,-23,30
Queen's Park,4354,10,6,10,20,40,74,-34,28
Ayr,4355,1,24,4,8,96,43,53,76
Raith,4355,2,22,8,6,68,35,33,74
Arbroath,4355,3,18,8,10,75,50,25,62
Alloa,4355,4,18,8,10,59,43,16,62
Stranraer,4355,5,15,5,16,56,67,-11,50
East Fife,4355,6,14,3,19,50,65,-15,45
Airdrieon,4355,7,10,12,14,47,60,-13,42
Forfar,4355,8,10,6,20,40,66,-26,36
Albion,4355,9,8,6,22,58,84,-26,30
Queen's Park,4355,10,6,10,20,41,77,-36,28
Raith,4356,1,23,8,5,69,32,37,77
Ayr,4356,2,24,4,8,92,42,50,76
Arbroath,4356,3,17,9,10,71,49,22,60
Alloa,4356,4,17,8,11,56,44,12,59
Stranraer,4356,5,16,5,15,57,65,-8,53
East Fife,4356,6,13,3,20,48,66,-18,42
Airdrieon,4356,7,10,11,15,45,59,-14,41
Forfar,4356,8,11,5,20,39,64,-25,38
Albion,4356,9,8,6,22,57,80,-23,30
Queen's Park,4356,10,6,11,19,40,73,-33,29
Raith,4357,1,23,8,5,70,32,38,77
Ayr,4357,2,24,4,8,92,43,49,76
Arbroath,4357,3,18,8,10,72,49,23,62
Alloa,4357,4,17,8,11,56,45,11,59
Stranraer,4357,5,15,5,16,55,65,-10,50
East Fife,4357,6,14,3,19,48,64,-16,45
Airdrieon,4357,7,10,11,15,46,60,-14,41
Forfar,4357,8,11,5,20,40,65,-25,38
Albion,4357,9,8,6,22,58,80,-22,30
Queen's Park,4357,10,6,10,20,40,74,-34,28
Raith,4358,1,23,8,5,70,33,37,77
Ayr,4358,2,24,4,8,94,43,51,76
Arbroath,4358,3,18,8,10,72,48,24,62
Alloa,4358,4,17,8,11,57,45,12,59
Stranraer,4358,5,15,5,16,55,65,-10,50
East Fife,4358,6,14,3,19,48,64,-16,45
Airdrieon,4358,7,11,11,14,47,58,-11,44
Forfar,4358,8,10,5,21,38,66,-28,35
Albion,4358,9,8,6,22,58,82,-24,30
Queen's Park,4358,10,6,10,20,39,74,-35,28
Raith,4359,1,23,8,5,70,32,38,77
Ayr,4359,2,24,4,8,93,42,51,76
Arbroath,4359,3,17,9,10,74,52,22,60
Alloa,4359,4,17,8,11,56,45,11,59
Stranraer,4359,5,15,5,16,55,65,-10,50
East Fife,4359,6,14,3,19,48,64,-16,45
Airdrieon,4359,7,11,11,14,46,58,-12,44
Forfar,4359,8,10,5,21,38,65,-27,35
Albion,4359,9,8,6,22,57,81,-24,30
Queen's Park,4359,10,6,11,19,43,76,-33,29
Raith,4360,1,23,8,5,71,32,39,77
Ayr,4360,2,23,5,8,91,43,48,74
Arbroath,4360,3,17,9,10,72,50,22,60
Alloa,4360,4,17,8,11,56,46,10,59
Stranraer,4360,5,15,5,16,56,66,-10,50
East Fife,4360,6,14,3,19,49,65,-16,45
Airdrieon,4360,7,11,11,14,46,58,-12,44
Forfar,4360,8,10,5,21,38,65,-27,35
Albion,4360,9,8,7,21,58,79,-21,31
Queen's Park,4360,10,6,11,19,41,74,-33,29
Raith,4361,1,23,8,5,69,32,37,77
Ayr,4361,2,23,4,9,90,43,47,73
Arbroath,4361,3,17,9,10,72,50,22,60
Alloa,4361,4,17,8,11,56,44,12,59
Stranraer,4361,5,15,6,15,57,66,-9,51
Airdrieon,4361,6,11,11,14,46,58,-12,44
East Fife,4361,7,13,4,19,49,66,-17,43
Forfar,4361,8,10,5,21,38,65,-27,35
Albion,4361,9,9,6,21,58,78,-20,33
Queen's Park,4361,10,6,11,19,41,74,-33,29
Raith,4362,1,23,8,5,70,32,38,77
Ayr,4362,2,24,4,8,93,42,51,76
Arbroath,4362,3,18,8,10,72,49,23,62
Alloa,4362,4,17,8,11,56,45,11,59
Stranraer,4362,5,15,5,16,55,67,-12,50
East Fife,4362,6,14,3,19,50,64,-14,45
Airdrieon,4362,7,11,11,14,46,58,-12,44
Forfar,4362,8,10,5,21,38,65,-27,35
Albion,4362,9,8,6,22,57,81,-24,30
Queen's Park,4362,10,6,10,20,40,74,-34,28
Raith,4363,1,23,8,5,71,32,39,77
Ayr,4363,2,24,4,8,92,43,49,76
Arbroath,4363,3,17,9,10,72,50,22,60
Alloa,4363,4,17,8,11,56,46,10,59
Stranraer,4363,5,15,5,16,57,68,-11,50
East Fife,4363,6,14,3,19,51,66,-15,45
Airdrieon,4363,7,11,11,14,47,58,-11,44
Forfar,4363,8,10,5,21,38,66,-28,35
Albion,4363,9,8,6,22,58,80,-22,30
Queen's Park,4363,10,6,11,19,41,74,-33,29
Ayr,4364,1,24,4,8,95,43,52,76
Raith,4364,2,22,8,6,70,35,35,74
Arbroath,4364,3,18,8,10,72,49,23,62
Alloa,4364,4,18,8,10,59,45,14,62
Stranraer,4364,5,16,5,15,57,64,-7,53
Airdrieon,4364,6,10,12,14,47,60,-13,42
East Fife,4364,7,13,3,20,47,66,-19,42
Forfar,4364,8,10,6,20,40,66,-26,36
Albion,4364,9,8,6,22,58,83,-25,30
Queen's Park,4364,10,6,10,20,40,74,-34,28
Raith,4365,1,23,8,5,72,34,38,77
Ayr,4365,2,24,4,8,92,43,49,76
Arbroath,4365,3,17,8,11,70,50,20,59
Alloa,4365,4,17,8,11,58,47,11,59
Stranraer,4365,5,15,6,15,55,64,-9,51
East Fife,4365,6,13,4,19,47,64,-17,43
Airdrieon,4365,7,10,11,15,45,59,-14,41
Forfar,4365,8,11,5,20,39,64,-25,38
Queen's Park,4365,9,7,10,19,41,72,-31,31
Albion,4365,10,8,6,22,58,80,-22,30
Ayr,4366,1,24,4,8,95,45,50,76
Raith,4366,2,22,9,5,69,33,36,75
Arbroath,4366,3,18,8,10,73,50,23,62
Alloa,4366,4,17,9,10,57,44,13,60
Stranraer,4366,5,16,5,15,58,66,-8,53
Airdrieon,4366,6,11,11,14,47,59,-12,44
East Fife,4366,7,13,3,20,49,67,-18,42
Forfar,4366,8,10,5,21,39,66,-27,35
Albion,4366,9,8,6,22,60,83,-23,30
Queen's Park,4366,10,6,10,20,41,75,-34,28
Raith,4367,1,23,8,5,69,32,37,77
Ayr,4367,2,24,4,8,93,43,50,76
Arbroath,4367,3,17,8,11,70,51,19,59
Alloa,4367,4,17,8,11,56,44,12,59
Stranraer,4367,5,15,5,16,55,66,-11,50
East Fife,4367,6,14,3,19,49,64,-15,45
Airdrieon,4367,7,11,11,14,48,59,-11,44
Forfar,4367,8,10,5,21,39,67,-28,35
Queen's Park,4367,9,7,10,19,42,72,-30,31
Albion,4367,10,8,6,22,58,81,-23,30
Ayr,4368,1,24,4,8,94,42,52,76
Raith,4368,2,22,8,6,68,33,35,74
Arbroath,4368,3,18,8,10,75,50,25,62
Alloa,4368,4,18,8,10,57,43,14,62
Stranraer,4368,5,16,5,15,57,65,-8,53
Airdrieon,4368,6,10,12,14,46,59,-13,42
East Fife,4368,7,13,3,20,48,66,-18,42
Forfar,4368,8,10,6,20,39,65,-26,36
Albion,4368,9,8,6,22,57,82,-25,30
Queen's Park,4368,10,6,10,20,41,77,-36,28
Ayr,4369,1,24,4,8,94,45,49,76
Raith,4369,2,22,9,5,71,35,36,75
Arbroath,4369,3,18,8,10,74,48,26,62
Alloa,4369,4,17,9,10,59,46,13,60
Stranraer,4369,5,15,5,16,55,65,-10,50
East Fife,4369,6,14,3,19,48,64,-16,45
Airdrieon,4369,7,11,11,14,47,59,-12,44
Forfar,4369,8,10,5,21,39,66,-27,35
Albion,4369,9,8,6,22,60,82,-22,30
Queen's Park,4369,10,6,10,20,39,76,-37,28
Raith,4370,1,23,8,5,70,32,38,77
Ayr,4370,2,24,4,8,93,44,49,76
Arbroath,4370,3,17,9,10,71,49,22,60
Alloa,4370,4,17,8,11,56,45,11,59
Stranraer,4370,5,15,6,15,58,67,-9,51
Airdrieon,4370,6,11,11,14,47,58,-11,44
East Fife,4370,7,13,4,19,50,67,-17,43
Forfar,4370,8,10,5,21,38,66,-28,35
Albion,4370,9,8,6,22,59,81,-22,30
Queen's Park,4370,10,6,11,19,40,73,-33,29
Raith,4371,1,22,9,5,70,34,36,75
Ayr,4371,2,23,5,8,91,43,48,74
Alloa,4371,3,17,9,10,58,45,13,60
Arbroath,4371,4,17,8,11,70,49,21,59
Stranraer,4371,5,16,5,15,57,65,-8,53
East Fife,4371,6,13,3,20,48,66,-18,42
Airdrieon,4371,7,10,11,15,46,60,-14,41
Forfar,4371,8,11,5,20,40,65,-25,38
Albion,4371,9,8,7,21,58,79,-21,31
Queen's Park,4371,10,7,10,19,40,72,-32,31
Raith,4372,1,23,8,5,70,33,37,77
Ayr,4372,2,24,4,8,95,45,50,76
Arbroath,4372,3,17,8,11,71,51,20,59
Alloa,4372,4,17,8,11,57,45,12,59
Stranraer,4372,5,15,6,15,57,66,-9,51
Airdrieon,4372,6,11,11,14,46,58,-12,44
East Fife,4372,7,13,4,19,49,66,-17,43
Forfar,4372,8,10,5,21,38,65,-27,35
Queen's Park,4372,9,7,10,19,42,73,-31,31
Albion,4372,10,8,6,22,60,83,-23,30
Ayr,4373,1,24,4,8,92,43,49,76
Raith,4373,2,22,9,5,68,32,36,75
Arbroath,4373,3,18,8,10,73,49,24,62
Alloa,4373,4,17,9,10,56,43,13,60
Stranraer,4373,5,15,5,16,57,68,-11,50
East Fife,4373,6,14,3,19,51,66,-15,45
Airdrieon,4373,7,10,11,15,45,59,-14,41
Forfar,4373,8,11,5,20,39,64,-25,38
Albion,4373,9,8,6,22,58,80,-22,30
Queen's Park,4373,10,6,10,20,40,75,-35,28
Raith,4374,1,23,8,5,70,33,37,77
Ayr,4374,2,23,5,8,91,43,48,74
Arbroath,4374,3,17,9,10,72,50,22,60
Alloa,4374,4,17,8,11,57,45,12,59
Stranraer,4374,5,15,6,15,57,66,-9,51
East Fife,4374,6,13,4,19,49,66,-17,43
Airdrieon,4374,7,10,11,15,45,60,-15,41
Forfar,4374,8,11,5,20,40,64,-24,38
Albion,4374,9,8,7,21,58,79,-21,31
Queen's Park,4374,10,6,11,19,41,74,-33,29
Raith,4375,1,23,8,5,70,32,38,77
Ayr,4375,2,24,4,8,92,43,49,76
Arbroath,4375,3,17,9,10,72,50,22,60
Alloa,4375,4,17,8,11,56,45,11,59
Stranraer,4375,5,16,5,15,58,65,-7,53
Airdrieon,4375,6,10,12,14,47,60,-13,42
East Fife,4375,7,13,3,20,48,67,-19,42
Forfar,4375,8,10,6,20,40,66,-26,36
Albion,4375,9,8,6,22,58,80,-22,30
Queen's Park,4375,10,6,11,19,41,74,-33,29
Raith,4376,1,23,8,5,70,33,37,77
Ayr,4376,2,24,4,8,93,43,50,76
Arbroath,4376,3,18,8,10,72,48,24,62
Alloa,4376,4,17,8,11,57,45,12,59
Stranraer,4376,5,15,5,16,55,71,-16,50
East Fife,4376,6,14,3,19,54,64,-10,45
Airdrieon,4376,7,11,11,14,46,58,-12,44
Forfar,4376,8,10,5,21,38,65,-27,35
Albion,4376,9,8,6,22,58,81,-23,30
Queen's Park,4376,10,6,10,20,39,74,-35,28
Ayr,4377,1,24,4,8,94,44,50,76
Raith,4377,2,22,8,6,69,34,35,74
Alloa,4377,3,18,8,10,58,44,14,62
Arbroath,4377,4,17,9,10,72,50,22,60
Stranraer,4377,5,15,6,15,56,65,-9,51
Airdrieon,4377,6,11,11,14,50,60,-10,44
East Fife,4377,7,13,4,19,48,65,-17,43
Forfar,4377,8,10,5,21,40,69,-29,35
Albion,4377,9,8,6,22,59,82,-23,30
Queen's Park,4377,10,6,11,19,41,74,-33,29
Ayr,4378,1,24,4,8,91,42,49,76
Raith,4378,2,22,9,5,69,33,36,75
Alloa,4378,3,17,9,10,57,44,13,60
Arbroath,4378,4,17,8,11,71,50,21,59
Stranraer,4378,5,15,5,16,55,66,-11,50
East Fife,4378,6,14,3,19,49,64,-15,45
Airdrieon,4378,7,11,11,14,48,59,-11,44
Forfar,4378,8,10,5,21,39,67,-28,35
Queen's Park,4378,9,7,10,19,41,73,-32,31
Albion,4378,10,8,6,22,57,79,-22,30
Ayr,4379,1,24,4,8,92,42,50,76
Raith,4379,2,22,9,5,69,33,36,75
Alloa,4379,3,17,9,10,57,44,13,60
Arbroath,4379,4,17,8,11,70,49,21,59
Stranraer,4379,5,15,6,15,57,66,-9,51
Airdrieon,4379,6,11,11,14,47,58,-11,44
East Fife,4379,7,13,4,19,49,66,-17,43
Forfar,4379,8,10,5,21,38,66,-28,35
Queen's Park,4379,9,7,10,19,40,72,-32,31
Albion,4379,10,8,6,22,57,80,-23,30
Ayr,4380,1,24,4,8,92,43,49,76
Raith,4380,2,22,8,6,70,35,35,74
Alloa,4380,3,18,8,10,59,45,14,62
Arbroath,4380,4,17,9,10,72,50,22,60
Stranraer,4380,5,15,5,16,55,66,-11,50
East Fife,4380,6,14,3,19,49,64,-15,45
Airdrieon,4380,7,11,11,14,49,60,-11,44
Forfar,4380,8,10,5,21,40,68,-28,35
Albion,4380,9,8,6,22,58,80,-22,30
Queen's Park,4380,10,6,11,19,41,74,-33,29
Ayr,4381,1,24,4,8,93,44,49,76
Raith,4381,2,22,9,5,69,33,36,75
Alloa,4381,3,17,9,10,57,44,13,60
Arbroath,4381,4,17,8,11,70,50,20,59
Stranraer,4381,5,15,5,16,55,65,-10,50
East Fife,4381,6,14,3,19,48,64,-16,45
Airdrieon,4381,7,11,11,14,48,60,-12,44
Forfar,4381,8,10,5,21,40,67,-27,35
Queen's Park,4381,9,7,10,19,41,72,-31,31
Albion,4381,10,8,6,22,59,81,-22,30
Raith,4382,1,23,8,5,72,34,38,77
Ayr,4382,2,24,4,8,98,44,54,76
Arbroath,4382,3,18,8,10,73,50,23,62
Alloa,4382,4,17,8,11,58,47,11,59
Stranraer,4382,5,15,6,15,57,66,-9,51
East Fife,4382,6,13,4,19,49,66,-17,43
Airdrieon,4382,7,10,11,15,45,59,-14,41
Forfar,4382,8,11,5,20,39,64,-25,38
Albion,4382,9,8,6,22,59,86,-27,30
Queen's Park,4382,10,6,10,20,41,75,-34,28
Raith,4383,1,23,8,5,70,32,38,77
Ayr,4383,2,24,4,8,95,45,50,76
Arbroath,4383,3,17,9,10,71,49,22,60
Alloa,4383,4,17,8,11,56,45,11,59
Stranraer,4383,5,15,6,15,56,65,-9,51
Airdrieon,4383,6,11,11,14,48,58,-10,44
East Fife,4383,7,13,4,19,48,65,-17,43
Forfar,4383,8,10,5,21,38,67,-29,35
Albion,4383,9,8,6,22,60,83,-23,30
Queen's Park,4383,10,6,11,19,40,73,-33,29
Raith,4384,1,23,8,5,71,33,38,77
Ayr,4384,2,24,4,8,92,42,50,76
Arbroath,4384,3,17,8,11,70,49,21,59
Alloa,4384,4,17,8,11,57,46,11,59
Stranraer,4384,5,15,6,15,55,64,-9,51
Airdrieon,4384,6,11,11,14,47,58,-11,44
East Fife,4384,7,13,4,19,47,64,-17,43
Forfar,4384,8,10,5,21,38,66,-28,35
Queen's Park,4384,9,7,10,19,40,72,-32,31
Albion,4384,10,8,6,22,57,80,-23,30
Raith,4385,1,23,8,5,70,33,37,77
Ayr,4385,2,23,4,9,91,44,47,73
Arbroath,4385,3,17,8,11,70,49,21,59
Alloa,4385,4,17,8,11,57,45,12,59
Stranraer,4385,5,16,5,15,58,64,-6,53
East Fife,4385,6,13,3,20,47,67,-20,42
Airdrieon,4385,7,10,11,15,45,59,-14,41
Forfar,4385,8,11,5,20,39,64,-25,38
Albion,4385,9,9,6,21,59,79,-20,33
Queen's Park,4385,10,7,10,19,40,72,-32,31
Raith,4386,1,23,8,5,70,32,38,77
Ayr,4386,2,24,4,8,93,42,51,76
Arbroath,4386,3,18,8,10,71,48,23,62
Alloa,4386,4,17,8,11,56,45,11,59
Stranraer,4386,5,16,5,15,56,64,-8,53
Airdrieon,4386,6,11,11,14,50,59,-9,44
East Fife,4386,7,13,3,20,47,65,-18,42
Forfar,4386,8,10,5,21,39,69,-30,35
Albion,4386,9,8,6,22,57,81,-24,30
Queen's Park,4386,10,6,10,20,39,73,-34,28
Ayr,4387,1,24,4,8,93,43,50,76
Raith,4387,2,22,8,6,69,34,35,74
Arbroath,4387,3,18,8,10,73,49,24,62
Alloa,4387,4,18,8,10,58,44,14,62
Stranraer,4387,5,15,5,16,56,66,-10,50
East Fife,4387,6,14,3,19,49,65,-16,45
Airdrieon,4387,7,10,12,14,45,58,-13,42
Forfar,4387,8,10,6,20,38,64,-26,36
Albion,4387,9,8,6,22,58,81,-23,30
Queen's Park,4387,10,6,10,20,40,75,-35,28
Ayr,4388,1,24,4,8,94,43,51,76
Raith,4388,2,22,8,6,69,34,35,74
Alloa,4388,3,18,8,10,58,44,14,62
Arbroath,4388,4,17,9,10,70,48,22,60
Stranraer,4388,5,16,5,15,57,65,-8,53
Airdrieon,4388,6,11,11,14,47,58,-11,44
East Fife,4388,7,13,3,20,48,66,-18,42
Forfar,4388,8,10,5,21,38,66,-28,35
Albion,4388,9,8,6,22,58,82,-24,30
Queen's Park,4388,10,6,11,19,39,72,-33,29
Ayr,4389,1,24,4,8,93,42,51,76
Raith,4389,2,22,8,6,68,33,35,74
Alloa,4389,3,18,8,10,57,43,14,62
Arbroath,4389,4,17,9,10,71,49,22,60
Stranraer,4389,5,15,5,16,55,66,-11,50
East Fife,4389,6,14,3,19,49,64,-15,45
Airdrieon,4389,7,11,11,14,47,59,-12,44
Forfar,4389,8,10,5,21,39,66,-27,35
Albion,4389,9,8,6,22,57,81,-24,30
Queen's Park,4389,10,6,11,19,40,73,-33,29
Raith,4390,1,23,8,5,70,33,37,77
Ayr,4390,2,23,4,9,92,45,47,73
Arbroath,4390,3,17,9,10,70,48,22,60
Alloa,4390,4,17,8,11,57,45,12,59
Stranraer,4390,5,15,5,16,56,68,-12,50
East Fife,4390,6,14,3,19,51,65,-14,45
Airdrieon,4390,7,10,12,14,46,59,-13,42
Forfar,4390,8,10,6,20,39,65,-26,36
Albion,4390,9,9,6,21,60,80,-20,33
Queen's Park,4390,10,6,11,19,39,72,-33,29
Raith,4391,1,23,8,5,70,33,37,77
Ayr,4391,2,24,4,8,93,44,49,76
Arbroath,4391,3,17,8,11,71,51,20,59
Alloa,4391,4,17,8,11,57,45,12,59
Stranraer,4391,5,15,6,15,56,65,-9,51
Airdrieon,4391,6,11,11,14,47,59,-12,44
East Fife,4391,7,13,4,19,48,65,-17,43
Forfar,4391,8,10,5,21,39,66,-27,35
Queen's Park,4391,9,7,10,19,42,73,-31,31
Albion,4391,10,8,6,22,59,81,-22,30
Ayr,4392,1,24,4,8,97,43,54,76
Raith,4392,2,22,9,5,69,33,36,75
Arbroath,4392,3,17,9,10,72,50,22,60
Alloa,4392,4,17,9,10,57,44,13,60
Stranraer,4392,5,15,5,16,56,68,-12,50
East Fife,4392,6,14,3,19,51,65,-14,45
Airdrieon,4392,7,11,11,14,47,59,-12,44
Forfar,4392,8,10,5,21,39,66,-27,35
Albion,4392,9,8,6,22,58,85,-27,30
Queen's Park,4392,10,6,11,19,41,74,-33,29
Raith,4393,1,22,9,5,69,33,36,75
Ayr,4393,2,23,5,8,92,44,48,74
Alloa,4393,3,17,9,10,57,44,13,60
Arbroath,4393,4,17,8,11,71,52,19,59
Stranraer,4393,5,15,5,16,56,66,-10,50
East Fife,4393,6,14,3,19,49,65,-16,45
Airdrieon,4393,7,10,12,14,45,58,-13,42
Forfar,4393,8,10,6,20,38,64,-26,36
Albion,4393,9,8,7,21,59,80,-21,31
Queen's Park,4393,10,7,10,19,43,73,-30,31
Raith,4394,1,23,8,5,71,32,39,77
Ayr,4394,2,24,4,8,92,42,50,76
Arbroath,4394,3,17,8,11,72,51,21,59
Alloa,4394,4,17,8,11,56,46,10,59
Stranraer,4394,5,16,5,15,59,65,-6,53
Airdrieon,4394,6,11,11,14,46,58,-12,44
East Fife,4394,7,13,3,20,48,68,-20,42
Forfar,4394,8,10,5,21,38,65,-27,35
Queen's Park,4394,9,7,10,19,42,74,-32,31
Albion,4394,10,8,6,22,57,80,-23,30
Ayr,4395,1,24,4,8,93,43,50,76
Raith,4395,2,22,8,6,69,34,35,74
Arbroath,4395,3,18,8,10,72,48,24,62
Alloa,4395,4,18,8,10,58,44,14,62
Stranraer,4395,5,15,5,16,56,68,-12,50
East Fife,4395,6,14,3,19,51,65,-14,45
Airdrieon,4395,7,10,12,14,46,59,-13,42
Forfar,4395,8,10,6,20,39,65,-26,36
Albion,4395,9,8,6,22,58,81,-23,30
Queen's Park,4395,10,6,10,20,39,74,-35,28
Raith,4396,1,23,8,5,70,33,37,77
Ayr,4396,2,23,4,9,90,44,46,73
Arbroath,4396,3,17,8,11,70,49,21,59
Alloa,4396,4,17,8,11,57,45,12,59
Stranraer,4396,5,15,5,16,55,66,-11,50
East Fife,4396,6,14,3,19,49,64,-15,45
Airdrieon,4396,7,10,12,14,46,59,-13,42
Forfar,4396,8,10,6,20,39,65,-26,36
Albion,4396,9,9,6,21,59,78,-19,33
Queen's Park,4396,10,7,10,19,40,72,-32,31
Raith,4397,1,22,9,5,68,32,36,75
Ayr,4397,2,23,5,8,91,43,48,74
Arbroath,4397,3,17,9,10,71,49,22,60
Alloa,4397,4,17,9,10,56,43,13,60
Stranraer,4397,5,15,5,16,56,66,-10,50
East Fife,4397,6,14,3,19,49,65,-16,45
Airdrieon,4397,7,11,11,14,46,58,-12,44
Forfar,4397,8,10,5,21,38,65,-27,35
Albion,4397,9,8,7,21,58,79,-21,31
Queen's Park,4397,10,6,11,19,40,73,-33,29
Ayr,4398,1,24,4,8,97,42,55,76
Raith,4398,2,22,8,6,68,33,35,74
Alloa,4398,3,18,8,10,57,43,14,62
Arbroath,4398,4,17,8,11,71,50,21,59
Stranraer,4398,5,15,5,16,56,67,-11,50
East Fife,4398,6,14,3,19,50,65,-15,45
Airdrieon,4398,7,11,11,14,48,60,-12,44
Forfar,4398,8,10,5,21,40,67,-27,35
Queen's Park,4398,9,7,10,19,41,73,-32,31
Albion,4398,10,8,6,22,57,85,-28,30
Raith,4399,1,23,8,5,69,32,37,77
Ayr,4399,2,24,4,8,97,42,55,76
Arbroath,4399,3,17,9,10,71,49,22,60
Alloa,4399,4,17,8,11,56,44,12,59
Stranraer,4399,5,16,5,15,57,65,-8,53
Airdrieon,4399,6,11,11,14,47,59,-12,44
East Fife,4399,7,13,3,20,48,66,-18,42
Forfar,4399,8,10,5,21,39,66,-27,35
Albion,4399,9,8,6,22,57,85,-28,30
Queen's Park,4399,10,6,11,19,40,73,-33,29
Ayr,4400,1,24,4,8,95,43,52,76
Raith,4400,2,22,8,6,68,33,35,74
Alloa,4400,3,18,8,10,57,43,14,62
Arbroath,4400,4,17,8,11,71,51,20,59
Stranraer,4400,5,16,5,15,60,68,-8,53
Airdrieon,4400,6,11,11,14,47,58,-11,44
East Fife,4400,7,13,3,20,51,69,-18,42
Forfar,4400,8,10,5,21,38,66,-28,35
Queen's Park,4400,9,7,10,19,42,73,-31,31
Albion,4400,10,8,6,22,58,83,-25,30
Raith,4401,1,22,8,6,69,36,33,74
Ayr,4401,2,23,4,9,90,43,47,73
Arbroath,4401,3,18,8,10,72,49,23,62
Alloa,4401,4,18,8,10,60,44,16,62
Stranraer,4401,5,16,5,15,58,66,-8,53
Airdrieon,4401,6,10,12,14,47,60,-13,42
East Fife,4401,7,13,3,20,49,67,-18,42
Forfar,4401,8,10,6,20,40,66,-26,36
Albion,4401,9,9,6,21,58,78,-20,33
Queen's Park,4401,10,6,10,20,40,74,-34,28
Raith,4402,1,23,8,5,69,32,37,77
Ayr,4402,2,24,4,8,94,43,51,76
Arbroath,4402,3,17,9,10,70,48,22,60
Alloa,4402,4,17,8,11,56,44,12,59
Stranraer,4402,5,15,6,15,56,65,-9,51
Airdrieon,4402,6,11,11,14,48,58,-10,44
East Fife,4402,7,13,4,19,48,65,-17,43
Forfar,4402,8,10,5,21,38,67,-29,35
Albion,4402,9,8,6,22,58,82,-24,30
Queen's Park,4402,10,6,11,19,39,72,-33,29
Raith,4403,1,23,8,5,72,32,40,77
Ayr,4403,2,24,4,8,96,45,51,76
Arbroath,4403,3,18,8,10,71,48,23,62
Alloa,4403,4,17,8,11,56,47,9,59
Stranraer,4403,5,15,5,16,55,67,-12,50
East Fife,4403,6,14,3,19,50,64,-14,45
Airdrieon,4403,7,10,11,15,46,60,-14,41
Forfar,4403,8,11,5,20,40,65,-25,38
Albion,4403,9,8,6,22,60,84,-24,30
Queen's Park,4403,10,6,10,20,39,73,-34,28
Raith,4404,1,23,8,5,69,32,37,77
Ayr,4404,2,24,4,8,96,44,52,76
Arbroath,4404,3,18,8,10,73,50,23,62
Alloa,4404,4,17,8,11,56,44,12,59
Stranraer,4404,5,15,5,16,57,67,-10,50
East Fife,4404,6,14,3,19,50,66,-16,45
Airdrieon,4404,7,11,11,14,47,58,-11,44
Forfar,4404,8,10,5,21,38,66,-28,35
Albion,4404,9,8,6,22,59,84,-25,30
Queen's Park,4404,10,6,10,20,41,75,-34,28
Ayr,4405,1,24,4,8,94,43,51,76
Raith,4405,2,22,9,5,68,32,36,75
Arbroath,4405,3,17,9,10,71,49,22,60
Alloa,4405,4,17,9,10,56,43,13,60
Stranraer,4405,5,16,5,15,56,64,-8,53
Airdrieon,4405,6,11,11,14,48,58,-10,44
East Fife,4405,7,13,3,20,47,65,-18,42
Forfar,4405,8,10,5,21,38,67,-29,35
Albion,4405,9,8,6,22,58,82,-24,30
Queen's Park,4405,10,6,11,19,40,73,-33,29
Ayr,4406,1,24,4,8,96,46,50,76
Raith,4406,2,22,8,6,68,33,35,74
Arbroath,4406,3,18,8,10,73,50,23,62
Alloa,4406,4,18,8,10,57,43,14,62
Stranraer,4406,5,15,5,16,56,68,-12,50
East Fife,4406,6,14,3,19,51,65,-14,45
Airdrieon,4406,7,10,11,15,45,59,-14,41
Forfar,4406,8,11,5,20,39,64,-25,38
Albion,4406,9,8,6,22,61,84,-23,30
Queen's Park,4406,10,6,10,20,41,75,-34,28
Ayr,4407,1,24,4,8,93,42,51,76
Raith,4407,2,22,8,6,69,34,35,74
Alloa,4407,3,18,8,10,58,44,14,62
Arbroath,4407,4,17,8,11,71,50,21,59
Stranraer,4407,5,15,5,16,56,70,-14,50
East Fife,4407,6,14,3,19,53,65,-12,45
Airdrieon,4407,7,11,11,14,49,59,-10,44
Forfar,4407,8,10,5,21,39,68,-29,35
Queen's Park,4407,9,7,10,19,41,73,-32,31
Albion,4407,10,8,6,22,57,81,-24,30
Raith,4408,1,23,8,5,69,32,37,77
Ayr,4408,2,24,4,8,93,43,50,76
Arbroath,4408,3,17,8,11,71,51,20,59
Alloa,4408,4,17,8,11,56,44,12,59
Stranraer,4408,5,16,5,15,58,65,-7,53
Airdrieon,4408,6,10,12,14,45,58,-13,42
East Fife,4408,7,13,3,20,48,67,-19,42
Forfar,4408,8,10,6,20,38,64,-26,36
Queen's Park,4408,9,7,10,19,42,73,-31,31
Albion,4408,10,8,6,22,58,81,-23,30
Raith,4409,1,23,8,5,71,32,39,77
Ayr,4409,2,24,4,8,93,43,50,76
Arbroath,4409,3,18,8,10,71,48,23,62
Alloa,4409,4,17,8,11,56,46,10,59
Stranraer,4409,5,15,5,16,56,66,-10,50
East Fife,4409,6,14,3,19,49,65,-16,45
Airdrieon,4409,7,10,11,15,45,59,-14,41
Forfar,4409,8,11,5,20,39,64,-25,38
Albion,4409,9,8,6,22,58,81,-23,30
Queen's Park,4409,10,6,10,20,39,73,-34,28
Raith,4410,1,23,8,5,70,33,37,77
Ayr,4410,2,24,4,8,93,42,51,76
Arbroath,4410,3,18,8,10,72,49,23,62
Alloa,4410,4,17,8,11,57,45,12,59
Stranraer,4410,5,15,5,16,55,67,-12,50
East Fife,4410,6,14,3,19,50,64,-14,45
Airdrieon,4410,7,11,11,14,47,59,-12,44
Forfar,4410,8,10,5,21,39,66,-27,35
Albion,4410,9,8,6,22,57,81,-24,30
Queen's Park,4410,10,6,10,20,40,74,-34,28
Raith,4411,1,23,8,5,69,32,37,77
Ayr,4411,2,24,4,8,96,45,51,76
Arbroath,4411,3,17,9,10,71,49,22,60
Alloa,4411,4,17,8,11,56,44,12,59
Stranraer,4411,5,15,5,16,55,66,-11,50
East Fife,4411,6,14,3,19,49,64,-15,45
Airdrieon,4411,7,10,12,14,45,58,-13,42
Forfar,4411,8,10,6,20,38,64,-26,36
Albion,4411,9,8,6,22,60,84,-24,30
Queen's Park,4411,10,6,11,19,40,73,-33,29
Raith,4412,1,23,8,5,70,32,38,77
Ayr,4412,2,23,4,9,90,44,46,73
Arbroath,4412,3,18,8,10,72,48,24,62
Alloa,4412,4,17,8,11,56,45,11,59
Stranraer,4412,5,15,5,16,56,66,-10,50
East Fife,4412,6,14,3,19,49,65,-16,45
Airdrieon,4412,7,11,11,14,47,58,-11,44
Forfar,4412,8,10,5,21,38,66,-28,35
Albion,4412,9,9,6,21,59,78,-19,33
Queen's Park,4412,10,6,10,20,39,74,-35,28
Raith,4413,1,23,8,5,70,33,37,77
Ayr,4413,2,24,4,8,94,43,51,76
Arbroath,4413,3,18,8,10,72,48,24,62
Alloa,4413,4,17,8,11,57,45,12,59
Stranraer,4413,5,15,5,16,55,66,-11,50
East Fife,4413,6,14,3,19,49,64,-15,45
Airdrieon,4413,7,10,11,15,45,60,-15,41
Forfar,4413,8,11,5,20,40,64,-24,38
Albion,4413,9,8,6,22,58,82,-24,30
Queen's Park,4413,10,6,10,20,39,74,-35,28
Raith,4414,1,23,8,5,70,33,37,77
Ayr,4414,2,23,4,9,91,44,47,73
Arbroath,4414,3,17,9,10,70,48,22,60
Alloa,4414,4,17,8,11,57,45,12,59
Stranraer,4414,5,15,6,15,56,65,-9,51
East Fife,4414,6,13,4,19,48,65,-17,43
Airdrieon,4414,7,10,11,15,45,59,-14,41
Forfar,4414,8,11,5,20,39,64,-25,38
Albion,4414,9,9,6,21,59,79,-20,33
Queen's Park,4414,10,6,11,19,39,72,-33,29
Raith,4415,1,23,8,5,71,33,38,77
Ayr,4415,2,24,4,8,94,44,50,76
Arbroath,4415,3,17,8,11,71,50,21,59
Alloa,4415,4,17,8,11,57,46,11,59
Stranraer,4415,5,15,6,15,56,65,-9,51
Airdrieon,4415,6,11,11,14,49,58,-9,44
East Fife,4415,7,13,4,19,48,65,-17,43
Forfar,4415,8,10,5,21,38,68,-30,35
Queen's Park,4415,9,7,10,19,41,73,-32,31
Albion,4415,10,8,6,22,59,82,-23,30
Ayr,4416,1,24,4,8,95,42,53,76
Raith,4416,2,22,9,5,68,32,36,75
Arbroath,4416,3,17,9,10,71,49,22,60
Alloa,4416,4,17,9,10,56,43,13,60
Stranraer,4416,5,15,6,15,58,67,-9,51
Airdrieon,4416,6,11,11,14,48,59,-11,44
East Fife,4416,7,13,4,19,50,67,-17,43
Forfar,4416,8,10,5,21,39,67,-28,35
Albion,4416,9,8,6,22,57,83,-26,30
Queen's Park,4416,10,6,11,19,40,73,-33,29
Raith,4417,1,23,8,5,70,32,38,77
Ayr,4417,2,24,4,8,95,43,52,76
Arbroath,4417,3,17,8,11,71,50,21,59
Alloa,4417,4,17,8,11,56,45,11,59
Stranraer,4417,5,15,5,16,55,66,-11,50
East Fife,4417,6,14,3,19,49,64,-15,45
Airdrieon,4417,7,10,11,15,46,60,-14,41
Forfar,4417,8,11,5,20,40,65,-25,38
Queen's Park,4417,9,7,10,19,41,73,-32,31
Albion,4417,10,8,6,22,58,83,-25,30
Raith,4418,1,23,8,5,70,33,37,77
Ayr,4418,2,24,4,8,98,44,54,76
Arbroath,4418,3,17,8,11,70,51,19,59
Alloa,4418,4,17,8,11,57,45,12,59
Stranraer,4418,5,16,5,15,57,65,-8,53
Airdrieon,4418,6,11,11,14,48,59,-11,44
East Fife,4418,7,13,3,20,48,66,-18,42
Forfar,4418,8,10,5,21,39,67,-28,35
Queen's Park,4418,9,7,10,19,42,72,-30,31
Albion,4418,10,8,6,22,59,86,-27,30
Raith,4419,1,22,9,5,69,33,36,75
Ayr,4419,2,23,4,9,92,45,47,73
Arbroath,4419,3,18,8,10,74,49,25,62
Alloa,4419,4,17,9,10,57,44,13,60
Stranraer,4419,5,15,5,16,57,68,-11,50
East Fife,4419,6,14,3,19,51,66,-15,45
Airdrieon,4419,7,10,11,15,46,60,-14,41
Forfar,4419,8,11,5,20,40,65,-25,38
Albion,4419,9,9,6,21,60,80,-20,33
Queen's Park,4419,10,6,10,20,40,76,-36,28
Raith,4420,1,23,8,5,70,33,37,77
Ayr,4420,2,23,5,8,93,45,48,74
Arbroath,4420,3,18,8,10,72,48,24,62
Alloa,4420,4,17,8,11,57,45,12,59
Stranraer,4420,5,15,6,15,55,64,-9,51
East Fife,4420,6,13,4,19,47,64,-17,43
Airdrieon,4420,7,10,12,14,46,59,-13,42
Forfar,4420,8,10,6,20,39,65,-26,36
Albion,4420,9,8,7,21,60,81,-21,31
Queen's Park,4420,10,6,10,20,39,74,-35,28
Ayr,4421,1,24,4,8,94,44,50,76
Raith,4421,2,22,8,6,69,36,33,74
Alloa,4421,3,18,8,10,60,44,16,62
Arbroath,4421,4,17,8,11,70,49,21,59
Stranraer,4421,5,16,5,15,58,66,-8,53
East Fife,4421,6,13,3,20,49,67,-18,42
Airdrieon,4421,7,10,11,15,46,60,-14,41
Forfar,4421,8,11,5,20,40,65,-25,38
Queen's Park,4421,9,7,10,19,40,72,-32,31
Albion,4421,10,8,6,22,59,82,-23,30
Raith,4422,1,23,8,5,69,32,37,77
Ayr,4422,2,24,4,8,94,43,51,76
Arbroath,4422,3,17,8,11,71,50,21,59
Alloa,4422,4,17,8,11,56,44,12,59
Stranraer,4422,5,15,6,15,56,65,-9,51
Airdrieon,4422,6,11,11,14,48,58,-10,44
East Fife,4422,7,13,4,19,48,65,-17,43
Forfar,4422,8,10,5,21,38,67,-29,35
Queen's Park,4422,9,7,10,19,41,73,-32,31
Albion,4422,10,8,6,22,58,82,-24,30
Ayr,4423,1,24,4,8,95,43,52,76
Raith,4423,2,22,8,6,69,34,35,74
Alloa,4423,3,18,8,10,58,44,14,62
Arbroath,4423,4,17,8,11,71,52,19,59
Stranraer,4423,5,15,5,16,55,65,-10,50
East Fife,4423,6,14,3,19,48,64,-16,45
Airdrieon,4423,7,10,12,14,47,60,-13,42
Forfar,4423,8,10,6,20,40,66,-26,36
Queen's Park,4423,9,7,10,19,43,73,-30,31
Albion,4423,10,8,6,22,58,83,-25,30
Raith,4424,1,23,8,5,71,32,39,77
Ayr,4424,2,24,4,8,93,42,51,76
Arbroath,4424,3,17,8,11,72,51,21,59
Alloa,4424,4,17,8,11,56,46,10,59
Stranraer,4424,5,15,5,16,57,69,-12,50
East Fife,4424,6,14,3,19,52,66,-14,45
Airdrieon,4424,7,11,11,14,47,58,-11,44
Forfar,4424,8,10,5,21,38,66,-28,35
Queen's Park,4424,9,7,10,19,42,74,-32,31
Albion,4424,10,8,6,22,57,81,-24,30
Raith,4425,1,23,8,5,72,34,38,77
Ayr,4425,2,24,4,8,95,43,52,76
Arbroath,4425,3,18,8,10,72,49,23,62
Alloa,4425,4,17,8,11,58,47,11,59
Stranraer,4425,5,16,5,15,58,65,-7,53
East Fife,4425,6,13,3,20,48,67,-19,42
Airdrieon,4425,7,10,11,15,45,60,-15,41
Forfar,4425,8,11,5,20,40,64,-24,38
Albion,4425,9,8,6,22,58,83,-25,30
Queen's Park,4425,10,6,10,20,40,74,-34,28
Raith,4426,1,23,8,5,73,32,41,77
Ayr,4426,2,24,4,8,95,43,52,76
Arbroath,4426,3,18,8,10,75,49,26,62
Alloa,4426,4,17,8,11,56,48,8,59
Stranraer,4426,5,15,5,16,56,66,-10,50
East Fife,4426,6,14,3,19,49,65,-16,45
Airdrieon,4426,7,11,11,14,47,58,-11,44
Forfar,4426,8,10,5,21,38,66,-28,35
Albion,4426,9,8,6,22,58,83,-25,30
Queen's Park,4426,10,6,10,20,40,77,-37,28
Raith,4427,1,23,8,5,71,33,38,77
Ayr,4427,2,24,4,8,92,43,49,76
Arbroath,4427,3,17,8,11,70,50,20,59
Alloa,4427,4,17,8,11,57,46,11,59
Stranraer,4427,5,15,6,15,57,66,-9,51
Airdrieon,4427,6,11,11,14,48,59,-11,44
East Fife,4427,7,13,4,19,49,66,-17,43
Forfar,4427,8,10,5,21,39,67,-28,35
Queen's Park,4427,9,7,10,19,41,72,-31,31
Albion,4427,10,8,6,22,58,80,-22,30
Raith,4428,1,23,8,5,71,33,38,77
Ayr,4428,2,24,4,8,91,42,49,76
Arbroath,4428,3,18,8,10,73,48,25,62
Alloa,4428,4,17,8,11,57,46,11,59
Stranraer,4428,5,16,5,15,58,64,-6,53
East Fife,4428,6,13,3,20,47,67,-20,42
Airdrieon,4428,7,10,11,15,46,61,-15,41
Forfar,4428,8,11,5,20,41,65,-24,38
Albion,4428,9,8,6,22,57,79,-22,30
Queen's Park,4428,10,6,10,20,39,75,-36,28
Raith,4429,1,23,8,5,71,32,39,77
Ayr,4429,2,24,4,8,94,45,49,76
Arbroath,4429,3,17,8,11,70,49,21,59
Alloa,4429,4,17,8,11,56,46,10,59
Stranraer,4429,5,15,5,16,56,66,-10,50
East Fife,4429,6,14,3,19,49,65,-16,45
Airdrieon,4429,7,11,11,14,48,58,-10,44
Forfar,4429,8,10,5,21,38,67,-29,35
Queen's Park,4429,9,7,10,19,40,72,-32,31
Albion,4429,10,8,6,22,60,82,-22,30
Raith,4430,1,23,8,5,70,33,37,77
Ayr,4430,2,24,4,8,94,43,51,76
Arbroath,4430,3,18,8,10,73,49,24,62
Alloa,4430,4,17,8,11,57,45,12,59
Stranraer,4430,5,15,5,16,55,66,-11,50
East Fife,4430,6,14,3,19,49,64,-15,45
Airdrieon,4430,7,11,11,14,47,59,-12,44
Forfar,4430,8,10,5,21,39,66,-27,35
Albion,4430,9,8,6,22,58,82,-24,30
Queen's Park,4430,10,6,10,20,40,75,-35,28
Raith,4431,1,23,8,5,71,32,39,77
Ayr,4431,2,24,4,8,96,44,52,76
Arbroath,4431,3,17,8,11,70,52,18,59
Alloa,4431,4,17,8,11,56,46,10,59
Stranraer,4431,5,15,5,16,55,66,-11,50
East Fife,4431,6,14,3,19,49,64,-15,45
Airdrieon,4431,7,11,11,14,47,59,-12,44
Forfar,4431,8,10,5,21,39,66,-27,35
Queen's Park,4431,9,7,10,19,43,72,-29,31
Albion,4431,10,8,6,22,59,84,-25,30
Raith,4432,1,23,8,5,72,35,37,77
Ayr,4432,2,24,4,8,94,45,49,76
Arbroath,4432,3,17,9,10,72,50,22,60
Alloa,4432,4,17,8,11,59,47,12,59
Stranraer,4432,5,15,6,15,55,64,-9,51
East Fife,4432,6,13,4,19,47,64,-17,43
Airdrieon,4432,7,10,12,14,46,59,-13,42
Forfar,4432,8,10,6,20,39,65,-26,36
Albion,4432,9,8,6,22,60,82,-22,30
Queen's Park,4432,10,6,11,19,41,74,-33,29
Ayr,4433,1,24,4,8,93,43,50,76
Raith,4433,2,22,9,5,70,34,36,75
Arbroath,4433,3,17,9,10,71,49,22,60
Alloa,4433,4,17,9,10,58,45,13,60
Stranraer,4433,5,15,6,15,58,67,-9,51
East Fife,4433,6,13,4,19,50,67,-17,43
Airdrieon,4433,7,10,11,15,46,60,-14,41
Forfar,4433,8,11,5,20,40,65,-25,38
Albion,4433,9,8,6,22,58,81,-23,30
Queen's Park,4433,10,6,11,19,40,73,-33,29
Ayr,4434,1,24,4,8,97,43,54,76
Raith,4434,2,22,8,6,68,33,35,74
Alloa,4434,3,18,8,10,57,43,14,62
Arbroath,4434,4,17,8,11,72,53,19,59
Stranraer,4434,5,15,6,15,55,64,-9,51
Airdrieon,4434,6,11,11,14,47,59,-12,44
East Fife,4434,7,13,4,19,47,64,-17,43
Forfar,4434,8,10,5,21,39,66,-27,35
Queen's Park,4434,9,7,10,19,44,74,-30,31
Albion,4434,10,8,6,22,58,85,-27,30
Raith,4435,1,23,8,5,69,32,37,77
Ayr,4435,2,24,4,8,94,42,52,76
Arbroath,4435,3,17,9,10,72,50,22,60
Alloa,4435,4,17,8,11,56,44,12,59
Stranraer,4435,5,15,6,15,56,65,-9,51
East Fife,4435,6,13,4,19,48,65,-17,43
Airdrieon,4435,7,10,11,15,45,59,-14,41
Forfar,4435,8,11,5,20,39,64,-25,38
Albion,4435,9,8,6,22,57,82,-25,30
Queen's Park,4435,10,6,11,19,41,74,-33,29
Ayr,4436,1,24,4,8,95,43,52,76
Raith,4436,2,22,9,5,69,33,36,75
Arbroath,4436,3,17,9,10,71,49,22,60
Alloa,4436,4,17,9,10,57,44,13,60
Stranraer,4436,5,15,5,16,56,69,-13,50
East Fife,4436,6,14,3,19,52,65,-13,45
Airdrieon,4436,7,11,11,14,46,58,-12,44
Forfar,4436,8,10,5,21,38,65,-27,35
Albion,4436,9,8,6,22,58,83,-25,30
Queen's Park,4436,10,6,11,19,40,73,-33,29
Ayr,4437,1,24,4,8,95,42,53,76
Raith,4437,2,22,8,6,68,34,34,74
Alloa,4437,3,18,8,10,58,43,15,62
Arbroath,4437,4,17,8,11,71,50,21,59
Stranraer,4437,5,15,5,16,56,67,-11,50
East Fife,4437,6,14,3,19,50,65,-15,45
Airdrieon,4437,7,10,11,15,46,60,-14,41
Forfar,4437,8,11,5,20,40,65,-25,38
Queen's Park,4437,9,7,10,19,41,73,-32,31
Albion,4437,10,8,6,22,57,83,-26,30
Raith,4438,1,23,8,5,71,32,39,77
Ayr,4438,2,24,4,8,92,43,49,76
Arbroath,4438,3,17,8,11,70,49,21,59
Alloa,4438,4,17,8,11,56,46,10,59
Stranraer,4438,5,15,6,15,57,66,-9,51
Airdrieon,4438,6,11,11,14,49,58,-9,44
East Fife,4438,7,13,4,19,49,66,-17,43
Forfar,4438,8,10,5,21,38,68,-30,35
Queen's Park,4438,9,7,10,19,40,72,-32,31
Albion,4438,10,8,6,22,58,80,-22,30
Raith,4439,1,23,8,5,72,33,39,77
Ayr,4439,2,24,4,8,95,43,52,76
Arbroath,4439,3,17,9,10,72,50,22,60
Alloa,4439,4,17,8,11,57,47,10,59
Stranraer,4439,5,15,5,16,55,67,-12,50
East Fife,4439,6,14,3,19,50,64,-14,45
Airdrieon,4439,7,10,11,15,46,60,-14,41
Forfar,4439,8,11,5,20,40,65,-25,38
Albion,4439,9,8,6,22,58,83,-25,30
Queen's Park,4439,10,6,11,19,41,74,-33,29
Raith,4440,1,23,8,5,70,32,38,77
Ayr,4440,2,24,4,8,94,43,51,76
Arbroath,4440,3,17,8,11,70,49,21,59
Alloa,4440,4,17,8,11,56,45,11,59
Stranraer,4440,5,16,5,15,57,65,-8,53
Airdrieon,4440,6,11,11,14,47,58,-11,44
East Fife,4440,7,13,3,20,48,66,-18,42
Forfar,4440,8,10,5,21,38,66,-28,35
Queen's Park,4440,9,7,10,19,40,72,-32,31
Albion,4440,10,8,6,22,58,82,-24,30
Raith,4441,1,23,8,5,69,32,37,77
Ayr,4441,2,24,4,8,93,43,50,76
Arbroath,4441,3,17,9,10,70,48,22,60
Alloa,4441,4,17,8,11,56,44,12,59
Stranraer,4441,5,16,5,15,56,64,-8,53
Airdrieon,4441,6,11,11,14,46,58,-12,44
East Fife,4441,7,13,3,20,47,65,-18,42
Forfar,4441,8,10,5,21,38,65,-27,35
Albion,4441,9,8,6,22,58,81,-23,30
Queen's Park,4441,10,6,11,19,39,72,-33,29
Ayr,4442,1,24,4,8,93,42,51,76
Raith,4442,2,22,9,5,70,34,36,75
Arbroath,4442,3,18,8,10,75,48,27,62
Alloa,4442,4,17,9,10,58,45,13,60
Stranraer,4442,5,16,5,15,56,64,-8,53
Airdrieon,4442,6,11,11,14,48,60,-12,44
East Fife,4442,7,13,3,20,47,65,-18,42
Forfar,4442,8,10,5,21,40,67,-27,35
Albion,4442,9,8,6,22,57,81,-24,30
Queen's Park,4442,10,6,10,20,39,77,-38,28
Ayr,4443,1,23,5,8,91,43,48,74
Raith,4443,2,22,8,6,68,33,35,74
Arbroath,4443,3,18,8,10,73,49,24,62
Alloa,4443,4,18,8,10,57,43,14,62
Stranraer,4443,5,16,5,15,57,65,-8,53
Airdrieon,4443,6,11,11,14,48,59,-11,44
East Fife,4443,7,13,3,20,48,66,-18,42
Forfar,4443,8,10,5,21,39,67,-28,35
Albion,4443,9,8,7,21,58,79,-21,31
Queen's Park,4443,10,6,10,20,40,75,-35,28
Raith,4444,1,23,8,5,71,33,38,77
Ayr,4444,2,24,4,8,96,44,52,76
Arbroath,4444,3,17,9,10,72,50,22,60
Alloa,4444,4,17,8,11,57,46,11,59
Stranraer,4444,5,16,5,15,59,67,-8,53
Airdrieon,4444,6,11,11,14,48,60,-12,44
East Fife,4444,7,13,3,20,50,68,-18,42
Forfar,4444,8,10,5,21,40,67,-27,35
Albion,4444,9,8,6,22,59,84,-25,30
Queen's Park,4444,10,6,11,19,41,74,-33,29
Ayr,4445,1,24,4,8,96,44,52,76
Raith,4445,2,22,9,5,69,33,36,75
Arbroath,4445,3,17,9,10,72,50,22,60
Alloa,4445,4,17,9,10,57,44,13,60
Stranraer,4445,5,15,5,16,56,70,-14,50
East Fife,4445,6,14,3,19,53,65,-12,45
Airdrieon,4445,7,11,11,14,47,59,-12,44
Forfar,4445,8,10,5,21,39,66,-27,35
Albion,4445,9,8,6,22,59,84,-25,30
Queen's Park,4445,10,6,11,19,41,74,-33,29
Raith,4446,1,23,8,5,72,32,40,77
Ayr,4446,2,24,4,8,97,42,55,76
Arbroath,4446,3,17,8,11,71,50,21,59
Alloa,4446,4,17,8,11,56,47,9,59
Stranraer,4446,5,15,5,16,56,67,-11,50
East Fife,4446,6,14,3,19,50,65,-15,45
Airdrieon,4446,7,11,11,14,47,59,-12,44
Forfar,4446,8,10,5,21,39,66,-27,35
Queen's Park,4446,9,7,10,19,41,73,-32,31
Albion,4446,10,8,6,22,57,85,-28,30
Raith,4447,1,23,8,5,70,33,37,77
Ayr,4447,2,24,4,8,95,44,51,76
Arbroath,4447,3,18,8,10,73,49,24,62
Alloa,4447,4,17,8,11,57,45,12,59
Stranraer,4447,5,16,5,15,56,64,-8,53
Airdrieon,4447,6,10,12,14,46,59,-13,42
East Fife,4447,7,13,3,20,47,65,-18,42
Forfar,4447,8,10,6,20,39,65,-26,36
Albion,4447,9,8,6,22,59,83,-24,30
Queen's Park,4447,10,6,10,20,40,75,-35,28
Ayr,4448,1,24,4,8,93,42,51,76
Raith,4448,2,22,8,6,70,35,35,74
Arbroath,4448,3,18,8,10,74,50,24,62
Alloa,4448,4,18,8,10,59,45,14,62
Stranraer,4448,5,15,5,16,55,66,-11,50
East Fife,4448,6,14,3,19,49,64,-15,45
Airdrieon,4448,7,11,11,14,50,58,-8,44
Forfar,4448,8,10,5,21,38,69,-31,35
Albion,4448,9,8,6,22,57,81,-24,30
Queen's Park,4448,10,6,10,20,41,76,-35,28
Ayr,4449,1,24,4,8,98,44,54,76
Raith,4449,2,22,9,5,70,34,36,75
Arbroath,4449,3,18,8,10,72,48,24,62
Alloa,4449,4,17,9,10,58,45,13,60
Stranraer,4449,5,15,6,15,56,65,-9,51
East Fife,4449,6,13,4,19,48,65,-17,43
Airdrieon,4449,7,10,12,14,46,59,-13,42
Forfar,4449,8,10,6,20,39,65,-26,36
Albion,4449,9,8,6,22,59,86,-27,30
Queen's Park,4449,10,6,10,20,39,74,-35,28
Raith,4450,1,23,8,5,71,33,38,77
Ayr,4450,2,24,4,8,96,43,53,76
Arbroath,4450,3,18,8,10,73,48,25,62
Alloa,4450,4,17,8,11,57,46,11,59
Stranraer,4450,5,15,5,16,55,65,-10,50
East Fife,4450,6,14,3,19,48,64,-16,45
Airdrieon,4450,7,11,11,14,47,59,-12,44
Forfar,4450,8,10,5,21,39,66,-27,35
Albion,4450,9,8,6,22,58,84,-26,30
Queen's Park,4450,10,6,10,20,39,75,-36,28
Raith,4451,1,23,8,5,70,33,37,77
Ayr,4451,2,24,4,8,95,42,53,76
Arbroath,4451,3,18,8,10,74,48,26,62
Alloa,4451,4,17,8,11,57,45,12,59
Stranraer,4451,5,15,6,15,56,65,-9,51
Airdrieon,4451,6,11,11,14,49,59,-10,44
East Fife,4451,7,13,4,19,48,65,-17,43
Forfar,4451,8,10,5,21,39,68,-29,35
Albion,4451,9,8,6,22,57,83,-26,30
Queen's Park,4451,10,6,10,20,39,76,-37,28
Raith,4452,1,23,8,5,70,33,37,77
Ayr,4452,2,23,5,8,94,46,48,74
Arbroath,4452,3,18,8,10,73,50,23,62
Alloa,4452,4,17,8,11,57,45,12,59
Stranraer,4452,5,15,6,15,57,66,-9,51
Airdrieon,4452,6,11,11,14,47,58,-11,44
East Fife,4452,7,13,4,19,49,66,-17,43
Forfar,4452,8,10,5,21,38,66,-28,35
Albion,4452,9,8,7,21,61,82,-21,31
Queen's Park,4452,10,6,10,20,41,75,-34,28
Raith,4453,1,23,8,5,71,33,38,77
Ayr,4453,2,24,4,8,94,43,51,76
Arbroath,4453,3,18,8,10,72,48,24,62
Alloa,4453,4,17,8,11,57,46,11,59
Stranraer,4453,5,15,5,16,56,66,-10,50
East Fife,4453,6,14,3,19,49,65,-16,45
Airdrieon,4453,7,11,11,14,46,58,-12,44
Forfar,4453,8,10,5,21,38,65,-27,35
Albion,4453,9,8,6,22,58,82,-24,30
Queen's Park,4453,10,6,10,20,39,74,-35,28
Raith,4454,1,23,8,5,72,32,40,77
Ayr,4454,2,24,4,8,94,43,51,76
Arbroath,4454,3,18,8,10,72,48,24,62
Alloa,4454,4,17,8,11,56,47,9,59
Stranraer,4454,5,15,5,16,55,66,-11,50
East Fife,4454,6,14,3,19,49,64,-15,45
Airdrieon,4454,7,10,11,15,45,60,-15,41
Forfar,4454,8,11,5,20,40,64,-24,38
Albion,4454,9,8,6,22,58,82,-24,30
Queen's Park,4454,10,6,10,20,39,74,-35,28
Ayr,4455,1,24,4,8,91,42,49,76
Raith,4455,2,22,8,6,68,33,35,74
Alloa,4455,3,18,8,10,57,43,14,62
Arbroath,4455,4,17,9,10,70,48,22,60
Stranraer,4455,5,15,6,15,57,66,-9,51
Airdrieon,4455,6,11,11,14,49,59,-10,44
East Fife,4455,7,13,4,19,49,66,-17,43
Forfar,4455,8,10,5,21,39,68,-29,35
Albion,4455,9,8,6,22,57,79,-22,30
Queen's Park,4455,10,6,11,19,39,72,-33,29
Raith,4456,1,23,8,5,71,33,38,77
Ayr,4456,2,24,4,8,94,45,49,76
Arbroath,4456,3,17,9,10,71,49,22,60
Alloa,4456,4,17,8,11,57,46,11,59
Stranraer,4456,5,16,5,15,59,66,-7,53
Airdrieon,4456,6,10,12,14,46,59,-13,42
East Fife,4456,7,13,3,20,49,68,-19,42
Forfar,4456,8,10,6,20,39,65,-26,36
Albion,4456,9,8,6,22,60,82,-22,30
Queen's Park,4456,10,6,11,19,40,73,-33,29
Ayr,4457,1,24,4,8,91,42,49,76
Raith,4457,2,22,9,5,69,33,36,75
Arbroath,4457,3,17,9,10,71,49,22,60
Alloa,4457,4,17,9,10,57,44,13,60
Stranraer,4457,5,16,5,15,56,64,-8,53
East Fife,4457,6,13,3,20,47,65,-18,42
Airdrieon,4457,7,10,11,15,47,62,-15,41
Forfar,4457,8,11,5,20,42,66,-24,38
Albion,4457,9,8,6,22,57,79,-22,30
Queen's Park,4457,10,6,11,19,40,73,-33,29
Raith,4458,1,22,9,5,69,33,36,75
Ayr,4458,2,23,4,9,91,44,47,73
Arbroath,4458,3,17,9,10,71,49,22,60
Alloa,4458,4,17,9,10,57,44,13,60
Stranraer,4458,5,15,5,16,55,67,-12,50
East Fife,4458,6,14,3,19,50,64,-14,45
Airdrieon,4458,7,11,11,14,47,58,-11,44
Forfar,4458,8,10,5,21,38,66,-28,35
Albion,4458,9,9,6,21,59,79,-20,33
Queen's Park,4458,10,6,11,19,40,73,-33,29
Raith,4459,1,23,8,5,70,32,38,77
Ayr,4459,2,24,4,8,94,43,51,76
Arbroath,4459,3,17,8,11,70,50,20,59
Alloa,4459,4,17,8,11,56,45,11,59
Stranraer,4459,5,15,6,15,56,65,-9,51
East Fife,4459,6,13,4,19,48,65,-17,43
Airdrieon,4459,7,10,11,15,46,60,-14,41
Forfar,4459,8,11,5,20,40,65,-25,38
Queen's Park,4459,9,7,10,19,41,72,-31,31
Albion,4459,10,8,6,22,58,82,-24,30
Raith,4460,1,23,8,5,73,36,37,77
Ayr,4460,2,24,4,8,96,43,53,76
Arbroath,4460,3,18,8,10,73,50,23,62
Alloa,4460,4,17,8,11,60,48,12,59
Stranraer,4460,5,16,5,15,58,66,-8,53
Airdrieon,4460,6,11,11,14,48,59,-11,44
East Fife,4460,7,13,3,20,49,67,-18,42
Forfar,4460,8,10,5,21,39,67,-28,35
Albion,4460,9,8,6,22,58,84,-26,30
Queen's Park,4460,10,6,10,20,41,75,-34,28
Raith,4461,1,23,8,5,70,32,38,77
Ayr,4461,2,24,4,8,95,44,51,76
Arbroath,4461,3,18,8,10,76,48,28,62
Alloa,4461,4,17,8,11,56,45,11,59
Stranraer,4461,5,16,5,15,56,64,-8,53
Airdrieon,4461,6,11,11,14,46,58,-12,44
East Fife,4461,7,13,3,20,47,65,-18,42
Forfar,4461,8,10,5,21,38,65,-27,35
Albion,4461,9,8,6,22,59,83,-24,30
Queen's Park,4461,10,6,10,20,39,78,-39,28
Raith,4462,1,23,8,5,71,32,39,77
Ayr,4462,2,23,4,9,90,44,46,73
Arbroath,4462,3,18,8,10,71,48,23,62
Alloa,4462,4,17,8,11,56,46,10,59
Stranraer,4462,5,15,5,16,57,69,-12,50
East Fife,4462,6,14,3,19,52,66,-14,45
Airdrieon,4462,7,10,12,14,45,58,-13,42
Forfar,4462,8,10,6,20,38,64,-26,36
Albion,4462,9,9,6,21,59,78,-19,33
Queen's Park,4462,10,6,10,20,39,73,-34,28
Ayr,4463,1,24,4,8,95,45,50,76
Raith,4463,2,22,9,5,68,32,36,75
Arbroath,4463,3,18,8,10,72,49,23,62
Alloa,4463,4,17,9,10,56,43,13,60
Stranraer,4463,5,15,5,16,55,65,-10,50
East Fife,4463,6,14,3,19,48,64,-16,45
Airdrieon,4463,7,10,11,15,46,62,-16,41
Forfar,4463,8,11,5,20,42,65,-23,38
Albion,4463,9,8,6,22,60,83,-23,30
Queen's Park,4463,10,6,10,20,40,74,-34,28
Ayr,4464,1,24,4,8,93,42,51,76
Raith,4464,2,22,9,5,69,33,36,75
Arbroath,4464,3,18,8,10,73,49,24,62
Alloa,4464,4,17,9,10,57,44,13,60
Stranraer,4464,5,15,5,16,56,66,-10,50
East Fife,4464,6,14,3,19,49,65,-16,45
Airdrieon,4464,7,11,11,14,48,60,-12,44
Forfar,4464,8,10,5,21,40,67,-27,35
Albion,4464,9,8,6,22,57,81,-24,30
Queen's Park,4464,10,6,10,20,40,75,-35,28
Raith,4465,1,23,8,5,70,33,37,77
Ayr,4465,2,24,4,8,95,43,52,76
Arbroath,4465,3,17,8,11,70,51,19,59
Alloa,4465,4,17,8,11,57,45,12,59
Stranraer,4465,5,15,6,15,55,64,-9,51
Airdrieon,4465,6,11,11,14,47,58,-11,44
East Fife,4465,7,13,4,19,47,64,-17,43
Forfar,4465,8,10,5,21,38,66,-28,35
Queen's Park,4465,9,7,10,19,42,72,-30,31
Albion,4465,10,8,6,22,58,83,-25,30
Raith,4466,1,23,8,5,71,33,38,77
Ayr,4466,2,23,5,8,91,43,48,74
Arbroath,4466,3,17,8,11,70,51,19,59
Alloa,4466,4,17,8,11,57,46,11,59
Stranraer,4466,5,16,5,15,57,65,-8,53
Airdrieon,4466,6,11,11,14,46,58,-12,44
East Fife,4466,7,13,3,20,48,66,-18,42
Forfar,4466,8,10,5,21,38,65,-27,35
Albion,4466,9,8,7,21,58,79,-21,31
Queen's Park,4466,10,7,10,19,42,72,-30,31
Raith,4467,1,23,8,5,71,33,38,77
Ayr,4467,2,24,4,8,92,43,49,76
Arbroath,4467,3,17,9,10,71,49,22,60
Alloa,4467,4,17,8,11,57,46,11,59
Stranraer,4467,5,16,5,15,58,66,-8,53
Airdrieon,4467,6,10,12,14,45,58,-13,42
East Fife,4467,7,13,3,20,49,67,-18,42
Forfar,4467,8,10,6,20,38,64,-26,36
Albion,4467,9,8,6,22,58,80,-22,30
Queen's Park,4467,10,6,11,19,40,73,-33,29
Raith,4468,1,23,8,5,70,32,38,77
Ayr,4468,2,24,4,8,93,42,51,76
Arbroath,4468,3,17,9,10,71,49,22,60
Alloa,4468,4,17,8,11,56,45,11,59
Stranraer,4468,5,16,5,15,57,64,-7,53
Airdrieon,4468,6,11,11,14,46,58,-12,44
East Fife,4468,7,13,3,20,47,66,-19,42
Forfar,4468,8,10,5,21,38,65,-27,35
Albion,4468,9,8,6,22,57,81,-24,30
Queen's Park,4468,10,6,11,19,40,73,-33,29
Ayr,4469,1,24,4,8,95,45,50,76
Raith,4469,2,22,9,5,68,32,36,75
Arbroath,4469,3,18,8,10,71,48,23,62
Alloa,4469,4,17,9,10,56,43,13,60
Stranraer,4469,5,15,6,15,56,65,-9,51
East Fife,4469,6,13,4,19,48,65,-17,43
Airdrieon,4469,7,10,12,14,45,58,-13,42
Forfar,4469,8,10,6,20,38,64,-26,36
Albion,4469,9,8,6,22,60,83,-23,30
Queen's Park,4469,10,6,10,20,39,73,-34,28
Raith,4470,1,23,8,5,71,32,39,77
Ayr,4470,2,24,4,8,92,42,50,76
Arbroath,4470,3,17,9,10,71,49,22,60
Alloa,4470,4,17,8,11,56,46,10,59
Stranraer,4470,5,15,5,16,55,66,-11,50
East Fife,4470,6,14,3,19,49,64,-15,45
Airdrieon,4470,7,10,11,15,45,59,-14,41
Forfar,4470,8,11,5,20,39,64,-25,38
Albion,4470,9,8,6,22,57,80,-23,30
Queen's Park,4470,10,6,11,19,40,73,-33,29
Ayr,4471,1,24,4,8,93,43,50,76
Raith,4471,2,22,9,5,69,33,36,75
Alloa,4471,3,17,9,10,57,44,13,60
Arbroath,4471,4,17,8,11,70,52,18,59
Stranraer,4471,5,15,6,15,57,66,-9,51
East Fife,4471,6,13,4,19,49,66,-17,43
Airdrieon,4471,7,10,11,15,46,61,-15,41
Forfar,4471,8,11,5,20,41,65,-24,38
Queen's Park,4471,9,7,10,19,43,72,-29,31
Albion,4471,10,8,6,22,58,81,-23,30
Raith,4472,1,23,8,5,71,33,38,77
Ayr,4472,2,23,4,9,93,46,47,73
Arbroath,4472,3,17,9,10,71,49,22,60
Alloa,4472,4,17,8,11,57,46,11,59
Stranraer,4472,5,16,5,15,57,64,-7,53
Airdrieon,4472,6,11,11,14,48,58,-10,44
East Fife,4472,7,13,3,20,47,66,-19,42
Forfar,4472,8,10,5,21,38,67,-29,35
Albion,4472,9,9,6,21,61,81,-20,33
Queen's Park,4472,10,6,11,19,40,73,-33,29
Raith,4473,1,23,8,5,69,32,37,77
Ayr,4473,2,24,4,8,94,43,51,76
Arbroath,4473,3,18,8,10,73,48,25,62
Alloa,4473,4,17,8,11,56,44,12,59
Stranraer,4473,5,15,5,16,56,68,-12,50
East Fife,4473,6,14,3,19,51,65,-14,45
Airdrieon,4473,7,10,11,15,45,59,-14,41
Forfar,4473,8,11,5,20,39,64,-25,38
Albion,4473,9,8,6,22,58,82,-24,30
Queen's Park,4473,10,6,10,20,39,75,-36,28
Raith,4474,1,22,9,5,69,33,36,75
Ayr,4474,2,23,4,9,91,44,47,73
Alloa,4474,3,17,9,10,57,44,13,60
Arbroath,4474,4,17,8,11,70,49,21,59
Stranraer,4474,5,15,5,16,56,66,-10,50
East Fife,4474,6,14,3,19,49,65,-16,45
Airdrieon,4474,7,10,12,14,45,58,-13,42
Forfar,4474,8,10,6,20,38,64,-26,36
Albion,4474,9,9,6,21,59,79,-20,33
Queen's Park,4474,10,7,10,19,40,72,-32,31
Ayr,4475,1,24,4,8,93,44,49,76
Raith,4475,2,22,9,5,69,33,36,75
Arbroath,4475,3,18,8,10,73,49,24,62
Alloa,4475,4,17,9,10,57,44,13,60
Stranraer,4475,5,15,5,16,55,67,-12,50
East Fife,4475,6,14,3,19,50,64,-14,45
Airdrieon,4475,7,11,11,14,46,58,-12,44
Forfar,4475,8,10,5,21,38,65,-27,35
Albion,4475,9,8,6,22,59,81,-22,30
Queen's Park,4475,10,6,10,20,40,75,-35,28
Raith,4476,1,23,8,5,70,32,38,77
Ayr,4476,2,24,4,8,93,42,51,76
Arbroath,4476,3,17,8,11,70,51,19,59
Alloa,4476,4,17,8,11,56,45,11,59
Stranraer,4476,5,15,5,16,56,67,-11,50
East Fife,4476,6,14,3,19,50,65,-15,45
Airdrieon,4476,7,10,12,14,46,59,-13,42
Forfar,4476,8,10,6,20,39,65,-26,36
Queen's Park,4476,9,7,10,19,42,72,-30,31
Albion,4476,10,8,6,22,57,81,-24,30
Raith,4477,1,23,8,5,72,32,40,77
Ayr,4477,2,24,4,8,93,42,51,76
Arbroath,4477,3,17,8,11,71,51,20,59
Alloa,4477,4,17,8,11,56,47,9,59
Stranraer,4477,5,16,5,15,59,66,-7,53
Airdrieon,4477,6,10,12,14,46,59,-13,42
East Fife,4477,7,13,3,20,49,68,-19,42
Forfar,4477,8,10,6,20,39,65,-26,36
Queen's Park,4477,9,7,10,19,42,73,-31,31
Albion,4477,10,8,6,22,57,81,-24,30
Raith,4478,1,23,8,5,69,32,37,77
Ayr,4478,2,24,4,8,93,43,50,76
Arbroath,4478,3,18,8,10,72,48,24,62
Alloa,4478,4,17,8,11,56,44,12,59
Stranraer,4478,5,15,5,16,55,69,-14,50
East Fife,4478,6,14,3,19,52,64,-12,45
Airdrieon,4478,7,11,11,14,50,61,-11,44
Forfar,4478,8,10,5,21,41,69,-28,35
Albion,4478,9,8,6,22,58,81,-23,30
Queen's Park,4478,10,6,10,20,39,74,-35,28
Raith,4479,1,23,8,5,70,32,38,77
Ayr,4479,2,24,4,8,99,44,55,76
Arbroath,4479,3,18,8,10,71,48,23,62
Alloa,4479,4,17,8,11,56,45,11,59
Stranraer,4479,5,15,6,15,56,65,-9,51
Airdrieon,4479,6,11,11,14,47,58,-11,44
East Fife,4479,7,13,4,19,48,65,-17,43
Forfar,4479,8,10,5,21,38,66,-28,35
Albion,4479,9,8,6,22,59,87,-28,30
Queen's Park,4479,10,6,10,20,39,73,-34,28
Raith,4480,1,23,8,5,72,34,38,77
Ayr,4480,2,24,4,8,98,42,56,76
Arbroath,4480,3,18,8,10,72,48,24,62
Alloa,4480,4,17,8,11,58,47,11,59
Stranraer,4480,5,15,5,16,55,65,-10,50
East Fife,4480,6,14,3,19,48,64,-16,45
Airdrieon,4480,7,10,11,15,45,60,-15,41
Forfar,4480,8,11,5,20,40,64,-24,38
Albion,4480,9,8,6,22,57,86,-29,30
Queen's Park,4480,10,6,10,20,39,74,-35,28
Raith,4481,1,23,8,5,70,32,38,77
Ayr,4481,2,24,4,8,94,42,52,76
Arbroath,4481,3,17,9,10,73,51,22,60
Alloa,4481,4,17,8,11,56,45,11,59
Stranraer,4481,5,15,5,16,55,68,-13,50
East Fife,4481,6,14,3,19,51,64,-13,45
Airdrieon,4481,7,11,11,14,47,59,-12,44
Forfar,4481,8,10,5,21,39,66,-27,35
Albion,4481,9,8,6,22,57,82,-25,30
Queen's Park,4481,10,6,11,19,42,75,-33,29
Raith,4482,1,23,8,5,69,32,37,77
Ayr,4482,2,24,4,8,97,42,55,76
Arbroath,4482,3,18,8,10,72,49,23,62
Alloa,4482,4,17,8,11,56,44,12,59
Stranraer,4482,5,15,6,15,55,64,-9,51
East Fife,4482,6,13,4,19,47,64,-17,43
Airdrieon,4482,7,10,11,15,46,60,-14,41
Forfar,4482,8,11,5,20,40,65,-25,38
Albion,4482,9,8,6,22,57,85,-28,30
Queen's Park,4482,10,6,10,20,40,74,-34,28
Ayr,4483,1,24,4,8,94,42,52,76
Raith,4483,2,22,8,6,69,37,32,74
Arbroath,4483,3,18,8,10,71,48,23,62
Alloa,4483,4,18,8,10,61,44,17,62
Stranraer,4483,5,16,5,15,57,64,-7,53
Airdrieon,4483,6,11,11,14,47,59,-12,44
East Fife,4483,7,13,3,20,47,66,-19,42
Forfar,4483,8,10,5,21,39,66,-27,35
Albion,4483,9,8,6,22,57,82,-25,30
Queen's Park,4483,10,6,10,20,39,73,-34,28
Ayr,4484,1,24,4,8,95,44,51,76
Raith,4484,2,22,9,5,68,32,36,75
Arbroath,4484,3,18,8,10,76,51,25,62
Alloa,4484,4,17,9,10,56,43,13,60
Stranraer,4484,5,15,5,16,55,66,-11,50
East Fife,4484,6,14,3,19,49,64,-15,45
Airdrieon,4484,7,11,11,14,47,59,-12,44
Forfar,4484,8,10,5,21,39,66,-27,35
Albion,4484,9,8,6,22,59,83,-24,30
Queen's Park,4484,10,6,10,20,42,78,-36,28
Ayr,4485,1,24,4,8,92,43,49,76
Raith,4485,2,22,9,5,68,32,36,75
Arbroath,4485,3,18,8,10,72,48,24,62
Alloa,4485,4,17,9,10,56,43,13,60
Stranraer,4485,5,15,5,16,55,66,-11,50
East Fife,4485,6,14,3,19,49,64,-15,45
Airdrieon,4485,7,10,12,14,45,58,-13,42
Forfar,4485,8,10,6,20,38,64,-26,36
Albion,4485,9,8,6,22,58,80,-22,30
Queen's Park,4485,10,6,10,20,39,74,-35,28
Raith,4486,1,23,8,5,69,32,37,77
Ayr,4486,2,24,4,8,94,43,51,76
Arbroath,4486,3,17,8,11,71,50,21,59
Alloa,4486,4,17,8,11,56,44,12,59
Stranraer,4486,5,16,5,15,57,64,-7,53
Airdrieon,4486,6,11,11,14,50,58,-8,44
East Fife,4486,7,13,3,20,47,66,-19,42
Forfar,4486,8,10,5,21,38,69,-31,35
Queen's Park,4486,9,7,10,19,41,73,-32,31
Albion,4486,10,8,6,22,58,82,-24,30
Ayr,4487,1,24,4,8,97,43,54,76
Raith,4487,2,22,8,6,68,35,33,74
Alloa,4487,3,18,8,10,59,43,16,62
Arbroath,4487,4,17,9,10,72,50,22,60
Stranraer,4487,5,15,6,15,57,66,-9,51
East Fife,4487,6,13,4,19,49,66,-17,43
Airdrieon,4487,7,10,11,15,46,60,-14,41
Forfar,4487,8,11,5,20,40,65,-25,38
Albion,4487,9,8,6,22,58,85,-27,30
Queen's Park,4487,10,6,11,19,41,74,-33,29
Raith,4488,1,23,8,5,72,32,40,77
Ayr,4488,2,24,4,8,94,44,50,76
Arbroath,4488,3,18,8,10,74,51,23,62
Alloa,4488,4,17,8,11,56,47,9,59
Stranraer,4488,5,15,6,15,56,65,-9,51
East Fife,4488,6,13,4,19,48,65,-17,43
Airdrieon,4488,7,10,11,15,46,60,-14,41
Forfar,4488,8,11,5,20,40,65,-25,38
Albion,4488,9,8,6,22,59,82,-23,30
Queen's Park,4488,10,6,10,20,42,76,-34,28
Raith,4489,1,23,8,5,72,35,37,77
Ayr,4489,2,24,4,8,94,43,51,76
Arbroath,4489,3,17,8,11,70,49,21,59
Alloa,4489,4,17,8,11,59,47,12,59
Stranraer,4489,5,15,5,16,55,67,-12,50
East Fife,4489,6,14,3,19,50,64,-14,45
Airdrieon,4489,7,11,11,14,47,58,-11,44
Forfar,4489,8,10,5,21,38,66,-28,35
Queen's Park,4489,9,7,10,19,40,72,-32,31
Albion,4489,10,8,6,22,58,82,-24,30
Raith,4490,1,23,8,5,72,32,40,77
Ayr,4490,2,24,4,8,95,43,52,76
Arbroath,4490,3,17,9,10,71,49,22,60
Alloa,4490,4,17,8,11,56,47,9,59
Stranraer,4490,5,16,5,15,58,65,-7,53
East Fife,4490,6,13,3,20,48,67,-19,42
Airdrieon,4490,7,10,11,15,45,59,-14,41
Forfar,4490,8,11,5,20,39,64,-25,38
Albion,4490,9,8,6,22,58,83,-25,30
Queen's Park,4490,10,6,11,19,40,73,-33,29
Ayr,4491,1,24,4,8,96,43,53,76
Raith,4491,2,22,8,6,69,35,34,74
Arbroath,4491,3,18,8,10,73,49,24,62
Alloa,4491,4,18,8,10,59,44,15,62
Stranraer,4491,5,15,5,16,56,66,-10,50
East Fife,4491,6,14,3,19,49,65,-16,45
Airdrieon,4491,7,10,12,14,45,58,-13,42
Forfar,4491,8,10,6,20,38,64,-26,36
Albion,4491,9,8,6,22,58,84,-26,30
Queen's Park,4491,10,6,10,20,40,75,-35,28
Raith,4492,1,23,8,5,70,32,38,77
Ayr,4492,2,24,4,8,93,44,49,76
Arbroath,4492,3,17,8,11,71,50,21,59
Alloa,4492,4,17,8,11,56,45,11,59
Stranraer,4492,5,16,5,15,56,64,-8,53
Airdrieon,4492,6,10,12,14,47,60,-13,42
East Fife,4492,7,13,3,20,47,65,-18,42
Forfar,4492,8,10,6,20,40,66,-26,36
Queen's Park,4492,9,7,10,19,41,73,-32,31
Albion,4492,10,8,6,22,59,81,-22,30
Raith,4493,1,23,8,5,70,32,38,77
Ayr,4493,2,24,4,8,93,43,50,76
Arbroath,4493,3,17,9,10,72,50,22,60
Alloa,4493,4,17,8,11,56,45,11,59
Stranraer,4493,5,16,5,15,57,64,-7,53
East Fife,4493,6,13,3,20,47,66,-19,42
Airdrieon,4493,7,10,11,15,45,59,-14,41
Forfar,4493,8,11,5,20,39,64,-25,38
Albion,4493,9,8,6,22,58,81,-23,30
Queen's Park,4493,10,6,11,19,41,74,-33,29
Ayr,4494,1,24,4,8,97,44,53,76
Raith,4494,2,22,9,5,69,33,36,75
Arbroath,4494,3,18,8,10,74,48,26,62
Alloa,4494,4,17,9,10,57,44,13,60
Stranraer,4494,5,16,5,15,57,64,-7,53
East Fife,4494,6,13,3,20,47,66,-19,42
Airdrieon,4494,7,10,11,15,45,59,-14,41
Forfar,4494,8,11,5,20,39,64,-25,38
Albion,4494,9,8,6,22,59,85,-26,30
Queen's Park,4494,10,6,10,20,39,76,-37,28
Ayr,4495,1,24,4,8,93,44,49,76
Raith,4495,2,22,8,6,68,34,34,74
Alloa,4495,3,18,8,10,58,43,15,62
Arbroath,4495,4,17,8,11,72,54,18,59
Stranraer,4495,5,15,5,16,56,67,-11,50
East Fife,4495,6,14,3,19,50,65,-15,45
Airdrieon,4495,7,11,11,14,46,58,-12,44
Forfar,4495,8,10,5,21,38,65,-27,35
Queen's Park,4495,9,7,10,19,45,74,-29,31
Albion,4495,10,8,6,22,59,81,-22,30
Raith,4496,1,23,8,5,71,32,39,77
Ayr,4496,2,24,4,8,93,42,51,76
Arbroath,4496,3,17,8,11,71,50,21,59
Alloa,4496,4,17,8,11,56,46,10,59
Stranraer,4496,5,15,6,15,58,67,-9,51
Airdrieon,4496,6,11,11,14,48,60,-12,44
East Fife,4496,7,13,4,19,50,67,-17,43
Forfar,4496,8,10,5,21,40,67,-27,35
Queen's Park,4496,9,7,10,19,41,73,-32,31
Albion,4496,10,8,6,22,57,81,-24,30
Raith,4497,1,23,8,5,70,33,37,77
Ayr,4497,2,24,4,8,95,43,52,76
Arbroath,4497,3,17,8,11,70,49,21,59
Alloa,4497,4,17,8,11,57,45,12,59
Stranraer,4497,5,15,6,15,59,68,-9,51
Airdrieon,4497,6,11,11,14,48,60,-12,44
East Fife,4497,7,13,4,19,51,68,-17,43
Forfar,4497,8,10,5,21,40,67,-27,35
Queen's Park,4497,9,7,10,19,40,72,-32,31
Albion,4497,10,8,6,22,58,83,-25,30
Raith,4498,1,23,8,5,69,32,37,77
Ayr,4498,2,24,4,8,97,44,53,76
Arbroath,4498,3,18,8,10,74,49,25,62
Alloa,4498,4,17,8,11,56,44,12,59
Stranraer,4498,5,15,6,15,56,65,-9,51
East Fife,4498,6,13,4,19,48,65,-17,43
Airdrieon,4498,7,10,11,15,46,60,-14,41
Forfar,4498,8,11,5,20,40,65,-25,38
Albion,4498,9,8,6,22,59,85,-26,30
Queen's Park,4498,10,6,10,20,40,76,-36,28
Raith,4499,1,23,8,5,72,32,40,77
Ayr,4499,2,24,4,8,94,44,50,76
Arbroath,4499,3,18,8,10,73,48,25,62
Alloa,4499,4,17,8,11,56,47,9,59
Stranraer,4499,5,16,5,15,57,65,-8,53
Airdrieon,4499,6,11,11,14,47,59,-12,44
East Fife,4499,7,13,3,20,48,66,-18,42
Forfar,4499,8,10,5,21,39,66,-27,35
Albion,4499,9,8,6,22,59,82,-23,30
Queen's Park,4499,10,6,10,20,39,75,-36,28
Ayr,4500,1,24,4,8,96,44,52,76
Raith,4500,2,22,8,6,69,35,34,74
Arbroath,4500,3,18,8,10,75,52,23,62
Alloa,4500,4,18,8,10,59,44,15,62
Stranraer,4500,5,15,5,16,56,66,-10,50
East Fife,4500,6,14,3,19,49,65,-16,45
Airdrieon,4500,7,11,11,14,47,58,-11,44
Forfar,4500,8,10,5,21,38,66,-28,35
Albion,4500,9,8,6,22,59,84,-25,30
Queen's Park,4500,10,6,10,20,43,77,-34,28
Ayr,4501,1,24,4,8,94,43,51,76
Raith,4501,2,22,8,6,68,33,35,74
Arbroath,4501,3,18,8,10,74,51,23,62
Alloa,4501,4,18,8,10,57,43,14,62
Stranraer,4501,5,15,5,16,56,66,-10,50
East Fife,4501,6,14,3,19,49,65,-16,45
Airdrieon,4501,7,10,12,14,46,59,-13,42
Forfar,4501,8,10,6,20,39,65,-26,36
Albion,4501,9,8,6,22,58,82,-24,30
Queen's Park,4501,10,6,10,20,42,76,-34,28
Ayr,4502,1,24,4,8,99,43,56,76
Raith,4502,2,22,9,5,70,34,36,75
Alloa,4502,3,17,9,10,58,45,13,60
Arbroath,4502,4,17,8,11,72,51,21,59
Stranraer,4502,5,15,5,16,57,67,-10,50
East Fife,4502,6,14,3,19,50,66,-16,45
Airdrieon,4502,7,11,11,14,49,58,-9,44
Forfar,4502,8,10,5,21,38,68,-30,35
Queen's Park,4502,9,7,10,19,42,74,-32,31
Albion,4502,10,8,6,22,58,87,-29,30
Raith,4503,1,23,8,5,70,32,38,77
Ayr,4503,2,24,4,8,94,43,51,76
Arbroath,4503,3,18,8,10,71,48,23,62
Alloa,4503,4,17,8,11,56,45,11,59
Stranraer,4503,5,15,5,16,55,68,-13,50
East Fife,4503,6,14,3,19,51,64,-13,45
Airdrieon,4503,7,11,11,14,50,58,-8,44
Forfar,4503,8,10,5,21,38,69,-31,35
Albion,4503,9,8,6,22,58,82,-24,30
Queen's Park,4503,10,6,10,20,39,73,-34,28
Raith,4504,1,23,8,5,71,33,38,77
Ayr,4504,2,24,4,8,92,42,50,76
Arbroath,4504,3,17,8,11,72,51,21,59
Alloa,4504,4,17,8,11,57,46,11,59
Stranraer,4504,5,16,5,15,56,64,-8,53
Airdrieon,4504,6,11,11,14,46,58,-12,44
East Fife,4504,7,13,3,20,47,65,-18,42
Forfar,4504,8,10,5,21,38,65,-27,35
Queen's Park,4504,9,7,10,19,42,74,-32,31
Albion,4504,10,8,6,22,57,80,-23,30
Ayr,4505,1,24,4,8,95,42,53,76
Raith,4505,2,22,9,5,69,33,36,75
Alloa,4505,3,17,9,10,57,44,13,60
Arbroath,4505,4,17,8,11,71,52,19,59
Stranraer,4505,5,15,5,16,57,68,-11,50
East Fife,4505,6,14,3,19,51,66,-15,45
Airdrieon,4505,7,10,12,14,46,59,-13,42
Forfar,4505,8,10,6,20,39,65,-26,36
Queen's Park,4505,9,7,10,19,43,73,-30,31
Albion,4505,10,8,6,22,57,83,-26,30
Ayr,4506,1,24,4,8,95,42,53,76
Raith,4506,2,22,8,6,69,34,35,74
Arbroath,4506,3,18,8,10,74,51,23,62
Alloa,4506,4,18,8,10,58,44,14,62
Stranraer,4506,5,16,5,15,57,65,-8,53
East Fife,4506,6,13,3,20,48,66,-18,42
Airdrieon,4506,7,10,11,15,47,62,-15,41
Forfar,4506,8,11,5,20,42,66,-24,38
Albion,4506,9,8,6,22,57,83,-26,30
Queen's Park,4506,10,6,10,20,42,76,-34,28
Raith,4507,1,23,8,5,72,33,39,77
Ayr,4507,2,24,4,8,92,42,50,76
Arbroath,4507,3,18,8,10,72,48,24,62
Alloa,4507,4,17,8,11,57,47,10,59
Stranraer,4507,5,16,5,15,57,65,-8,53
Airdrieon,4507,6,10,12,14,46,59,-13,42
East Fife,4507,7,13,3,20,48,66,-18,42
Forfar,4507,8,10,6,20,39,65,-26,36
Albion,4507,9,8,6,22,57,80,-23,30
Queen's Park,4507,10,6,10,20,39,74,-35,28
Raith,4508,1,23,8,5,72,32,40,77
Ayr,4508,2,24,4,8,94,44,50,76
Arbroath,4508,3,17,9,10,70,48,22,60
Alloa,4508,4,17,8,11,56,47,9,59
Stranraer,4508,5,16,5,15,59,67,-8,53
East Fife,4508,6,13,3,20,50,68,-18,42
Airdrieon,4508,7,10,11,15,46,60,-14,41
Forfar,4508,8,11,5,20,40,65,-25,38
Albion,4508,9,8,6,22,59,82,-23,30
Queen's Park,4508,10,6,11,19,39,72,-33,29
Raith,4509,1,22,9,5,69,33,36,75
Ayr,4509,2,23,4,9,90,44,46,73
Alloa,4509,3,17,9,10,57,44,13,60
Arbroath,4509,4,17,8,11,71,50,21,59
Stranraer,4509,5,15,5,16,56,66,-10,50
East Fife,4509,6,14,3,19,49,65,-16,45
Airdrieon,4509,7,10,12,14,45,58,-13,42
Forfar,4509,8,10,6,20,38,64,-26,36
Albion,4509,9,9,6,21,59,78,-19,33
Queen's Park,4509,10,7,10,19,41,73,-32,31
Ayr,4510,1,24,4,8,94,45,49,76
Raith,4510,2,22,9,5,69,33,36,75
Arbroath,4510,3,18,8,10,74,49,25,62
Alloa,4510,4,17,9,10,57,44,13,60
Stranraer,4510,5,15,6,15,56,65,-9,51
Airdrieon,4510,6,11,11,14,46,58,-12,44
East Fife,4510,7,13,4,19,48,65,-17,43
Forfar,4510,8,10,5,21,38,65,-27,35
Albion,4510,9,8,6,22,60,82,-22,30
Queen's Park,4510,10,6,10,20,40,76,-36,28
Raith,4511,1,23,8,5,70,32,38,77
Ayr,4511,2,23,4,9,91,44,47,73
Arbroath,4511,3,17,8,11,70,49,21,59
Alloa,4511,4,17,8,11,56,45,11,59
Stranraer,4511,5,16,5,15,57,64,-7,53
Airdrieon,4511,6,11,11,14,48,58,-10,44
East Fife,4511,7,13,3,20,47,66,-19,42
Forfar,4511,8,10,5,21,38,67,-29,35
Albion,4511,9,9,6,21,59,79,-20,33
Queen's Park,4511,10,7,10,19,40,72,-32,31
Ayr,4512,1,24,4,8,93,43,50,76
Raith,4512,2,22,8,6,70,37,33,74
Arbroath,4512,3,18,8,10,71,48,23,62
Alloa,4512,4,18,8,10,61,45,16,62
Stranraer,4512,5,15,6,15,55,64,-9,51
East Fife,4512,6,13,4,19,47,64,-17,43
Airdrieon,4512,7,10,12,14,46,59,-13,42
Forfar,4512,8,10,6,20,39,65,-26,36
Albion,4512,9,8,6,22,58,81,-23,30
Queen's Park,4512,10,6,10,20,39,73,-34,28
Ayr,4513,1,24,4,8,95,42,53,76
Raith,4513,2,22,9,5,69,33,36,75
Arbroath,4513,3,17,9,10,72,50,22,60
Alloa,4513,4,17,9,10,57,44,13,60
Stranraer,4513,5,15,5,16,56,66,-10,50
East Fife,4513,6,14,3,19,49,65,-16,45
Airdrieon,4513,7,10,12,14,45,58,-13,42
Forfar,4513,8,10,6,20,38,64,-26,36
Albion,4513,9,8,6,22,57,83,-26,30
Queen's Park,4513,10,6,11,19,41,74,-33,29
Ayr,4514,1,24,4,8,94,44,50,76
Raith,4514,2,22,9,5,69,33,36,75
Alloa,4514,3,17,9,10,57,44,13,60
Arbroath,4514,4,17,8,11,71,50,21,59
Stranraer,4514,5,15,5,16,56,67,-11,50
East Fife,4514,6,14,3,19,50,65,-15,45
Airdrieon,4514,7,10,11,15,46,60,-14,41
Forfar,4514,8,11,5,20,40,65,-25,38
Queen's Park,4514,9,7,10,19,41,73,-32,31
Albion,4514,10,8,6,22,59,82,-23,30
Ayr,4515,1,24,4,8,92,43,49,76
Raith,4515,2,22,8,6,70,35,35,74
Alloa,4515,3,18,8,10,59,45,14,62
Arbroath,4515,4,17,9,10,73,51,22,60
Stranraer,4515,5,16,5,15,58,66,-8,53
Airdrieon,4515,6,10,12,14,46,59,-13,42
East Fife,4515,7,13,3,20,49,67,-18,42
Forfar,4515,8,10,6,20,39,65,-26,36
Albion,4515,9,8,6,22,58,80,-22,30
Queen's Park,4515,10,6,11,19,42,75,-33,29
Raith,4516,1,23,8,5,69,32,37,77
Ayr,4516,2,24,4,8,93,42,51,76
Arbroath,4516,3,17,8,11,71,50,21,59
Alloa,4516,4,17,8,11,56,44,12,59
Stranraer,4516,5,15,5,16,56,66,-10,50
East Fife,4516,6,14,3,19,49,65,-16,45
Airdrieon,4516,7,10,12,14,45,58,-13,42
Forfar,4516,8,10,6,20,38,64,-26,36
Queen's Park,4516,9,7,10,19,41,73,-32,31
Albion,4516,10,8,6,22,57,81,-24,30
Raith,4517,1,23,8,5,69,32,37,77
Ayr,4517,2,24,4,8,92,42,50,76
Arbroath,4517,3,18,8,10,72,48,24,62
Alloa,4517,4,17,8,11,56,44,12,59
Stranraer,4517,5,15,6,15,56,65,-9,51
Airdrieon,4517,6,11,11,14,48,58,-10,44
East Fife,4517,7,13,4,19,48,65,-17,43
Forfar,4517,8,10,5,21,38,67,-29,35
Albion,4517,9,8,6,22,57,80,-23,30
Queen's Park,4517,10,6,10,20,39,74,-35,28
Raith,4518,1,23,8,5,71,32,39,77
Ayr,4518,2,24,4,8,93,44,49,76
Arbroath,4518,3,17,9,10,71,49,22,60
Alloa,4518,4,17,8,11,56,46,10,59
Stranraer,4518,5,15,6,15,55,64,-9,51
East Fife,4518,6,13,4,19,47,64,-17,43
Airdrieon,4518,7,10,11,15,45,59,-14,41
Forfar,4518,8,11,5,20,39,64,-25,38
Albion,4518,9,8,6,22,59,81,-22,30
Queen's Park,4518,10,6,11,19,40,73,-33,29
Ayr,4519,1,24,4,8,97,44,53,76
Raith,4519,2,22,9,5,69,33,36,75
Arbroath,4519,3,18,8,10,72,48,24,62
Alloa,4519,4,17,9,10,57,44,13,60
Stranraer,4519,5,15,5,16,55,65,-10,50
East Fife,4519,6,14,3,19,48,64,-16,45
Airdrieon,4519,7,11,11,14,47,58,-11,44
Forfar,4519,8,10,5,21,38,66,-28,35
Albion,4519,9,8,6,22,59,85,-26,30
Queen's Park,4519,10,6,10,20,39,74,-35,28
Ayr,4520,1,24,4,8,96,42,54,76
Raith,4520,2,22,8,6,68,33,35,74
Arbroath,4520,3,18,8,10,71,48,23,62
Alloa,4520,4,18,8,10,57,43,14,62
Stranraer,4520,5,16,5,15,58,64,-6,53
East Fife,4520,6,13,3,20,47,67,-20,42
Airdrieon,4520,7,10,11,15,47,61,-14,41
Forfar,4520,8,11,5,20,41,66,-25,38
Albion,4520,9,8,6,22,57,84,-27,30
Queen's Park,4520,10,6,10,20,39,73,-34,28
Raith,4521,1,23,8,5,70,33,37,77
Ayr,4521,2,24,4,8,92,42,50,76
Arbroath,4521,3,18,8,10,71,48,23,62
Alloa,4521,4,17,8,11,57,45,12,59
Stranraer,4521,5,15,5,16,56,67,-11,50
East Fife,4521,6,14,3,19,50,65,-15,45
Airdrieon,4521,7,11,11,14,47,58,-11,44
Forfar,4521,8,10,5,21,38,66,-28,35
Albion,4521,9,8,6,22,57,80,-23,30
Queen's Park,4521,10,6,10,20,39,73,-34,28
Ayr,4522,1,24,4,8,93,43,50,76
Raith,4522,2,22,9,5,69,33,36,75
Arbroath,4522,3,18,8,10,72,49,23,62
Alloa,4522,4,17,9,10,57,44,13,60
Stranraer,4522,5,15,6,15,56,65,-9,51
East Fife,4522,6,13,4,19,48,65,-17,43
Airdrieon,4522,7,10,11,15,46,60,-14,41
Forfar,4522,8,11,5,20,40,65,-25,38
Albion,4522,9,8,6,22,58,81,-23,30
Queen's Park,4522,10,6,10,20,40,74,-34,28
Raith,4523,1,22,8,6,69,34,35,74
Ayr,4523,2,23,4,9,91,44,47,73
Arbroath,4523,3,18,8,10,73,49,24,62
Alloa,4523,4,18,8,10,58,44,14,62
Stranraer,4523,5,15,6,15,55,64,-9,51
East Fife,4523,6,13,4,19,47,64,-17,43
Airdrieon,4523,7,10,11,15,45,61,-16,41
Forfar,4523,8,11,5,20,41,64,-23,38
Albion,4523,9,9,6,21,59,79,-20,33
Queen's Park,4523,10,6,10,20,40,75,-35,28
Raith,4524,1,23,8,5,69,32,37,77
Ayr,4524,2,24,4,8,93,42,51,76
Arbroath,4524,3,18,8,10,73,49,24,62
Alloa,4524,4,17,8,11,56,44,12,59
Stranraer,4524,5,15,5,16,55,66,-11,50
East Fife,4524,6,14,3,19,49,64,-15,45
Airdrieon,4524,7,11,11,14,48,60,-12,44
Forfar,4524,8,10,5,21,40,67,-27,35
Albion,4524,9,8,6,22,57,81,-24,30
Queen's Park,4524,10,6,10,20,40,75,-35,28
Raith,4525,1,22,8,6,69,34,35,74
Ayr,4525,2,23,4,9,91,45,46,73
Alloa,4525,3,18,8,10,58,44,14,62
Arbroath,4525,4,17,9,10,71,49,22,60
Stranraer,4525,5,15,5,16,56,67,-11,50
East Fife,4525,6,14,3,19,50,65,-15,45
Airdrieon,4525,7,11,11,14,48,59,-11,44
Forfar,4525,8,10,5,21,39,67,-28,35
Albion,4525,9,9,6,21,60,79,-19,33
Queen's Park,4525,10,6,11,19,40,73,-33,29
Ayr,4526,1,24,4,8,100,43,57,76
Raith,4526,2,22,8,6,68,33,35,74
Alloa,4526,3,18,8,10,57,43,14,62
Arbroath,4526,4,17,8,11,70,49,21,59
Stranraer,4526,5,15,5,16,57,69,-12,50
East Fife,4526,6,14,3,19,52,66,-14,45
Airdrieon,4526,7,11,11,14,46,58,-12,44
Forfar,4526,8,10,5,21,38,65,-27,35
Queen's Park,4526,9,7,10,19,40,72,-32,31
Albion,4526,10,8,6,22,58,88,-30,30
Ayr,4527,1,24,4,8,96,45,51,76
Raith,4527,2,22,9,5,69,33,36,75
Alloa,4527,3,17,9,10,57,44,13,60
Arbroath,4527,4,17,8,11,71,51,20,59
Stranraer,4527,5,15,5,16,55,65,-10,50
East Fife,4527,6,14,3,19,48,64,-16,45
Airdrieon,4527,7,10,11,15,47,61,-14,41
Forfar,4527,8,11,5,20,41,66,-25,38
Queen's Park,4527,9,7,10,19,42,73,-31,31
Albion,4527,10,8,6,22,60,84,-24,30
Ayr,4528,1,24,4,8,93,43,50,76
Raith,4528,2,22,8,6,69,34,35,74
Alloa,4528,3,18,8,10,58,44,14,62
Arbroath,4528,4,17,9,10,72,50,22,60
Stranraer,4528,5,15,5,16,55,67,-12,50
East Fife,4528,6,14,3,19,50,64,-14,45
Airdrieon,4528,7,10,11,15,45,59,-14,41
Forfar,4528,8,11,5,20,39,64,-25,38
Albion,4528,9,8,6,22,58,81,-23,30
Queen's Park,4528,10,6,11,19,41,74,-33,29
Raith,4529,1,23,8,5,69,32,37,77
Ayr,4529,2,24,4,8,95,43,52,76
Arbroath,4529,3,18,8,10,73,49,24,62
Alloa,4529,4,17,8,11,56,44,12,59
Stranraer,4529,5,15,5,16,56,66,-10,50
East Fife,4529,6,14,3,19,49,65,-16,45
Airdrieon,4529,7,10,12,14,46,59,-13,42
Forfar,4529,8,10,6,20,39,65,-26,36
Albion,4529,9,8,6,22,58,83,-25,30
Queen's Park,4529,10,6,10,20,40,75,-35,28
Raith,4530,1,22,9,5,68,32,36,75
Ayr,4530,2,23,5,8,91,43,48,74
Arbroath,4530,3,18,8,10,73,48,25,62
Alloa,4530,4,17,9,10,56,43,13,60
Stranraer,4530,5,16,5,15,57,65,-8,53
Airdrieon,4530,6,10,12,14,45,58,-13,42
East Fife,4530,7,13,3,20,48,66,-18,42
Forfar,4530,8,10,6,20,38,64,-26,36
Albion,4530,9,8,7,21,58,79,-21,31
Queen's Park,4530,10,6,10,20,39,75,-36,28
Raith,4531,1,22,8,6,68,33,35,74
Ayr,4531,2,23,4,9,94,47,47,73
Alloa,4531,3,18,8,10,57,43,14,62
Arbroath,4531,4,17,8,11,70,50,20,59
Stranraer,4531,5,15,5,16,55,66,-11,50
East Fife,4531,6,14,3,19,49,64,-15,45
Airdrieon,4531,7,10,12,14,45,58,-13,42
Forfar,4531,8,10,6,20,38,64,-26,36
Albion,4531,9,9,6,21,62,82,-20,33
Queen's Park,4531,10,7,10,19,41,72,-31,31
Ayr,4532,1,24,4,8,95,44,51,76
Raith,4532,2,22,9,5,68,32,36,75
Arbroath,4532,3,18,8,10,73,50,23,62
Alloa,4532,4,17,9,10,56,43,13,60
Stranraer,4532,5,15,6,15,56,65,-9,51
East Fife,4532,6,13,4,19,48,65,-17,43
Airdrieon,4532,7,10,11,15,45,59,-14,41
Forfar,4532,8,11,5,20,39,64,-25,38
Albion,4532,9,8,6,22,59,83,-24,30
Queen's Park,4532,10,6,10,20,41,75,-34,28
Ayr,4533,1,24,4,8,92,43,49,76
Raith,4533,2,22,9,5,69,33,36,75
Arbroath,4533,3,17,9,10,71,49,22,60
Alloa,4533,4,17,9,10,57,44,13,60
Stranraer,4533,5,15,5,16,55,66,-11,50
East Fife,4533,6,14,3,19,49,64,-15,45
Airdrieon,4533,7,11,11,14,46,58,-12,44
Forfar,4533,8,10,5,21,38,65,-27,35
Albion,4533,9,8,6,22,58,80,-22,30
Queen's Park,4533,10,6,11,19,40,73,-33,29
Raith,4534,1,23,8,5,71,33,38,77
Ayr,4534,2,24,4,8,91,42,49,76
Arbroath,4534,3,18,8,10,75,50,25,62
Alloa,4534,4,17,8,11,57,46,11,59
Stranraer,4534,5,16,5,15,57,64,-7,53
Airdrieon,4534,6,11,11,14,47,59,-12,44
East Fife,4534,7,13,3,20,47,66,-19,42
Forfar,4534,8,10,5,21,39,66,-27,35
Albion,4534,9,8,6,22,57,79,-22,30
Queen's Park,4534,10,6,10,20,41,77,-36,28
Raith,4535,1,23,8,5,70,33,37,77
Ayr,4535,2,24,4,8,92,43,49,76
Arbroath,4535,3,18,8,10,73,50,23,62
Alloa,4535,4,17,8,11,57,45,12,59
Stranraer,4535,5,15,6,15,56,65,-9,51
Airdrieon,4535,6,11,11,14,47,59,-12,44
East Fife,4535,7,13,4,19,48,65,-17,43
Forfar,4535,8,10,5,21,39,66,-27,35
Albion,4535,9,8,6,22,58,80,-22,30
Queen's Park,4535,10,6,10,20,41,75,-34,28
Ayr,4536,1,24,4,8,92,43,49,76
Raith,4536,2,22,9,5,68,32,36,75
Alloa,4536,3,17,9,10,56,43,13,60
Arbroath,4536,4,17,8,11,71,50,21,59
Stranraer,4536,5,15,5,16,56,66,-10,50
East Fife,4536,6,14,3,19,49,65,-16,45
Airdrieon,4536,7,10,12,14,46,59,-13,42
Forfar,4536,8,10,6,20,39,65,-26,36
Queen's Park,4536,9,7,10,19,41,73,-32,31
Albion,4536,10,8,6,22,58,80,-22,30
Ayr,4537,1,24,4,8,93,42,51,76
Raith,4537,2,22,8,6,68,33,35,74
Arbroath,4537,3,18,8,10,75,49,26,62
Alloa,4537,4,18,8,10,57,43,14,62
Stranraer,4537,5,15,5,16,56,66,-10,50
East Fife,4537,6,14,3,19,49,65,-16,45
Airdrieon,4537,7,11,11,14,46,58,-12,44
Forfar,4537,8,10,5,21,38,65,-27,35
Albion,4537,9,8,6,22,57,81,-24,30
Queen's Park,4537,10,6,10,20,40,77,-37,28
Ayr,4538,1,24,4,8,94,43,51,76
Raith,4538,2,22,9,5,70,34,36,75
Arbroath,4538,3,17,9,10,72,50,22,60
Alloa,4538,4,17,9,10,58,45,13,60
Stranraer,4538,5,15,5,16,55,66,-11,50
East Fife,4538,6,14,3,19,49,64,-15,45
Airdrieon,4538,7,11,11,14,47,58,-11,44
Forfar,4538,8,10,5,21,38,66,-28,35
Albion,4538,9,8,6,22,58,82,-24,30
Queen's Park,4538,10,6,11,19,41,74,-33,29
Ayr,4539,1,23,5,8,92,44,48,74
Raith,4539,2,22,8,6,68,33,35,74
Alloa,4539,3,18,8,10,57,43,14,62
Arbroath,4539,4,17,8,11,71,50,21,59
Stranraer,4539,5,15,5,16,56,67,-11,50
East Fife,4539,6,14,3,19,50,65,-15,45
Airdrieon,4539,7,11,11,14,46,58,-12,44
Forfar,4539,8,10,5,21,38,65,-27,35
Albion,4539,9,8,7,21,59,80,-21,31
Queen's Park,4539,10,7,10,19,41,73,-32,31
Raith,4540,1,23,8,5,72,32,40,77
Ayr,4540,2,24,4,8,95,43,52,76
Arbroath,4540,3,17,8,11,71,52,19,59
Alloa,4540,4,17,8,11,56,47,9,59
Stranraer,4540,5,15,6,15,57,66,-9,51
East Fife,4540,6,13,4,19,49,66,-17,43
Airdrieon,4540,7,10,11,15,45,60,-15,41
Forfar,4540,8,11,5,20,40,64,-24,38
Queen's Park,4540,9,7,10,19,43,73,-30,31
Albion,4540,10,8,6,22,58,83,-25,30
Ayr,4541,1,24,4,8,95,44,51,76
Raith,4541,2,22,8,6,68,33,35,74
Arbroath,4541,3,18,8,10,72,49,23,62
Alloa,4541,4,18,8,10,57,43,14,62
Stranraer,4541,5,15,5,16,56,66,-10,50
East Fife,4541,6,14,3,19,49,65,-16,45
Airdrieon,4541,7,11,11,14,47,58,-11,44
Forfar,4541,8,10,5,21,38,66,-28,35
Albion,4541,9,8,6,22,59,83,-24,30
Queen's Park,4541,10,6,10,20,40,74,-34,28
Ayr,4542,1,24,4,8,95,46,49,76
Raith,4542,2,22,9,5,68,32,36,75
Alloa,4542,3,17,9,10,56,43,13,60
Arbroath,4542,4,17,8,11,71,50,21,59
Stranraer,4542,5,15,5,16,56,68,-12,50
East Fife,4542,6,14,3,19,51,65,-14,45
Airdrieon,4542,7,11,11,14,46,58,-12,44
Forfar,4542,8,10,5,21,38,65,-27,35
Queen's Park,4542,9,7,10,19,41,73,-32,31
Albion,4542,10,8,6,22,61,83,-22,30
Ayr,4543,1,24,4,8,92,43,49,76
Raith,4543,2,22,9,5,69,33,36,75
Alloa,4543,3,17,9,10,57,44,13,60
Arbroath,4543,4,17,8,11,70,51,19,59
Stranraer,4543,5,16,5,15,58,64,-6,53
East Fife,4543,6,13,3,20,47,67,-20,42
Airdrieon,4543,7,10,11,15,46,62,-16,41
Forfar,4543,8,11,5,20,42,65,-23,38
Queen's Park,4543,9,7,10,19,42,72,-30,31
Albion,4543,10,8,6,22,58,80,-22,30
Raith,4544,1,23,8,5,73,33,40,77
Ayr,4544,2,24,4,8,95,43,52,76
Arbroath,4544,3,17,9,10,72,50,22,60
Alloa,4544,4,17,8,11,57,48,9,59
Stranraer,4544,5,16,5,15,61,64,-3,53
East Fife,4544,6,13,3,20,47,70,-23,42
Airdrieon,4544,7,10,11,15,46,60,-14,41
Forfar,4544,8,11,5,20,40,65,-25,38
Albion,4544,9,8,6,22,58,83,-25,30
Queen's Park,4544,10,6,11,19,41,74,-33,29
Raith,4545,1,23,8,5,70,32,38,77
Ayr,4545,2,24,4,8,96,45,51,76
Arbroath,4545,3,17,9,10,71,49,22,60
Alloa,4545,4,17,8,11,56,45,11,59
Stranraer,4545,5,16,5,15,58,64,-6,53
Airdrieon,4545,6,10,12,14,45,58,-13,42
East Fife,4545,7,13,3,20,47,67,-20,42
Forfar,4545,8,10,6,20,38,64,-26,36
Albion,4545,9,8,6,22,60,84,-24,30
Queen's Park,4545,10,6,11,19,40,73,-33,29
Raith,4546,1,23,8,5,69,32,37,77
Ayr,4546,2,24,4,8,93,43,50,76
Arbroath,4546,3,17,8,11,71,51,20,59
Alloa,4546,4,17,8,11,56,44,12,59
Stranraer,4546,5,15,5,16,56,66,-10,50
East Fife,4546,6,14,3,19,49,65,-16,45
Airdrieon,4546,7,11,11,14,48,60,-12,44
Forfar,4546,8,10,5,21,40,67,-27,35
Queen's Park,4546,9,7,10,19,42,73,-31,31
Albion,4546,10,8,6,22,58,81,-23,30
Raith,4547,1,23,8,5,69,32,37,77
Ayr,4547,2,24,4,8,94,42,52,76
Arbroath,4547,3,17,9,10,73,51,22,60
Alloa,4547,4,17,8,11,56,44,12,59
Stranraer,4547,5,15,5,16,56,67,-11,50
East Fife,4547,6,14,3,19,50,65,-15,45
Airdrieon,4547,7,11,11,14,46,58,-12,44
Forfar,4547,8,10,5,21,38,65,-27,35
Albion,4547,9,8,6,22,57,82,-25,30
Queen's Park,4547,10,6,11,19,42,75,-33,29
Raith,4548,1,22,9,5,69,33,36,75
Ayr,4548,2,23,5,8,92,44,48,74
Arbroath,4548,3,18,8,10,72,48,24,62
Alloa,4548,4,17,9,10,57,44,13,60
Stranraer,4548,5,16,5,15,57,65,-8,53
Airdrieon,4548,6,11,11,14,49,58,-9,44
East Fife,4548,7,13,3,20,48,66,-18,42
Forfar,4548,8,10,5,21,38,68,-30,35
Albion,4548,9,8,7,21,59,80,-21,31
Queen's Park,4548,10,6,10,20,39,74,-35,28
Raith,4549,1,22,9,5,69,33,36,75
Ayr,4549,2,23,4,9,91,46,45,73
Arbroath,4549,3,18,8,10,72,48,24,62
Alloa,4549,4,17,9,10,57,44,13,60
Stranraer,4549,5,16,5,15,58,66,-8,53
Airdrieon,4549,6,11,11,14,47,59,-12,44
East Fife,4549,7,13,3,20,49,67,-18,42
Forfar,4549,8,10,5,21,39,66,-27,35
Albion,4549,9,9,6,21,61,79,-18,33
Queen's Park,4549,10,6,10,20,39,74,-35,28
Ayr,4550,1,24,4,8,97,42,55,76
Raith,4550,2,22,9,5,69,33,36,75
Arbroath,4550,3,18,8,10,73,50,23,62
Alloa,4550,4,17,9,10,57,44,13,60
Stranraer,4550,5,15,5,16,56,66,-10,50
East Fife,4550,6,14,3,19,49,65,-16,45
Airdrieon,4550,7,11,11,14,47,59,-12,44
Forfar,4550,8,10,5,21,39,66,-27,35
Albion,4550,9,8,6,22,57,85,-28,30
Queen's Park,4550,10,6,10,20,41,75,-34,28
Ayr,4551,1,24,4,8,93,43,50,76
Raith,4551,2,22,8,6,68,33,35,74
Arbroath,4551,3,18,8,10,71,48,23,62
Alloa,4551,4,18,8,10,57,43,14,62
Stranraer,4551,5,15,5,16,56,66,-10,50
East Fife,4551,6,14,3,19,49,65,-16,45
Airdrieon,4551,7,11,11,14,47,59,-12,44
Forfar,4551,8,10,5,21,39,66,-27,35
Albion,4551,9,8,6,22,58,81,-23,30
Queen's Park,4551,10,6,10,20,39,73,-34,28
Raith,4552,1,23,8,5,70,33,37,77
Ayr,4552,2,24,4,8,92,42,50,76
Arbroath,4552,3,18,8,10,72,48,24,62
Alloa,4552,4,17,8,11,57,45,12,59
Stranraer,4552,5,16,5,15,58,64,-6,53
Airdrieon,4552,6,11,11,14,50,58,-8,44
East Fife,4552,7,13,3,20,47,67,-20,42
Forfar,4552,8,10,5,21,38,69,-31,35
Albion,4552,9,8,6,22,57,80,-23,30
Queen's Park,4552,10,6,10,20,39,74,-35,28
Ayr,4553,1,24,4,8,92,43,49,76
Raith,4553,2,22,8,6,68,34,34,74
Alloa,4553,3,18,8,10,58,43,15,62
Arbroath,4553,4,17,9,10,74,52,22,60
Stranraer,4553,5,16,5,15,57,65,-8,53
East Fife,4553,6,13,3,20,48,66,-18,42
Airdrieon,4553,7,10,11,15,47,61,-14,41
Forfar,4553,8,11,5,20,41,66,-25,38
Albion,4553,9,8,6,22,58,80,-22,30
Queen's Park,4553,10,6,11,19,43,76,-33,29
Raith,4554,1,23,8,5,70,32,38,77
Ayr,4554,2,24,4,8,92,43,49,76
Arbroath,4554,3,17,9,10,71,49,22,60
Alloa,4554,4,17,8,11,56,45,11,59
Stranraer,4554,5,15,6,15,56,65,-9,51
East Fife,4554,6,13,4,19,48,65,-17,43
Airdrieon,4554,7,10,12,14,46,59,-13,42
Forfar,4554,8,10,6,20,39,65,-26,36
Albion,4554,9,8,6,22,58,80,-22,30
Queen's Park,4554,10,6,11,19,40,73,-33,29
Ayr,4555,1,24,4,8,92,43,49,76
Raith,4555,2,22,9,5,68,32,36,75
Alloa,4555,3,17,9,10,56,43,13,60
Arbroath,4555,4,17,8,11,70,49,21,59
Stranraer,4555,5,15,5,16,56,69,-13,50
East Fife,4555,6,14,3,19,52,65,-13,45
Airdrieon,4555,7,10,11,15,47,61,-14,41
Forfar,4555,8,11,5,20,41,66,-25,38
Queen's Park,4555,9,7,10,19,40,72,-32,31
Albion,4555,10,8,6,22,58,80,-22,30
Ayr,4556,1,24,4,8,92,43,49,76
Raith,4556,2,22,8,6,69,35,34,74
Arbroath,4556,3,18,8,10,72,49,23,62
Alloa,4556,4,18,8,10,59,44,15,62
Stranraer,4556,5,15,6,15,56,65,-9,51
Airdrieon,4556,6,11,11,14,49,58,-9,44
East Fife,4556,7,13,4,19,48,65,-17,43
Forfar,4556,8,10,5,21,38,68,-30,35
Albion,4556,9,8,6,22,58,80,-22,30
Queen's Park,4556,10,6,10,20,40,74,-34,28
Raith,4557,1,23,8,5,71,34,37,77
Ayr,4557,2,24,4,8,94,43,51,76
Arbroath,4557,3,17,8,11,72,51,21,59
Alloa,4557,4,17,8,11,58,46,12,59
Stranraer,4557,5,15,6,15,58,67,-9,51
Airdrieon,4557,6,11,11,14,49,58,-9,44
East Fife,4557,7,13,4,19,50,67,-17,43
Forfar,4557,8,10,5,21,38,68,-30,35
Queen's Park,4557,9,7,10,19,42,74,-32,31
Albion,4557,10,8,6,22,58,82,-24,30
Raith,4558,1,23,8,5,69,32,37,77
Ayr,4558,2,23,5,8,90,42,48,74
Arbroath,4558,3,18,8,10,73,48,25,62
Alloa,4558,4,17,8,11,56,44,12,59
Stranraer,4558,5,15,5,16,55,72,-17,50
East Fife,4558,6,14,3,19,55,64,-9,45
Airdrieon,4558,7,10,11,15,46,60,-14,41
Forfar,4558,8,11,5,20,40,65,-25,38
Albion,4558,9,8,7,21,57,78,-21,31
Queen's Park,4558,10,6,10,20,39,75,-36,28
Ayr,4559,1,24,4,8,93,43,50,76
Raith,4559,2,22,8,6,68,33,35,74
Alloa,4559,3,18,8,10,57,43,14,62
Arbroath,4559,4,17,8,11,70,50,20,59
Stranraer,4559,5,16,5,15,56,64,-8,53
Airdrieon,4559,6,10,12,14,48,61,-13,42
East Fife,4559,7,13,3,20,47,65,-18,42
Forfar,4559,8,10,6,20,41,67,-26,36
Queen's Park,4559,9,7,10,19,41,72,-31,31
Albion,4559,10,8,6,22,58,81,-23,30
Raith,4560,1,23,8,5,71,33,38,77
Ayr,4560,2,24,4,8,94,42,52,76
Arbroath,4560,3,17,9,10,70,48,22,60
Alloa,4560,4,17,8,11,57,46,11,59
Stranraer,4560,5,15,6,15,56,65,-9,51
Airdrieon,4560,6,11,11,14,46,58,-12,44
East Fife,4560,7,13,4,19,48,65,-17,43
Forfar,4560,8,10,5,21,38,65,-27,35
Albion,4560,9,8,6,22,57,82,-25,30
Queen's Park,4560,10,6,11,19,39,72,-33,29
Ayr,4561,1,24,4,8,92,43,49,76
Raith,4561,2,22,8,6,69,34,35,74
Arbroath,4561,3,18,8,10,71,48,23,62
Alloa,4561,4,18,8,10,58,44,14,62
Stranraer,4561,5,15,5,16,56,66,-10,50
East Fife,4561,6,14,3,19,49,65,-16,45
Airdrieon,4561,7,11,11,14,47,59,-12,44
Forfar,4561,8,10,5,21,39,66,-27,35
Albion,4561,9,8,6,22,58,80,-22,30
Queen's Park,4561,10,6,10,20,39,73,-34,28
Ayr,4562,1,24,4,8,96,43,53,76
Raith,4562,2,22,9,5,70,34,36,75
Arbroath,4562,3,18,8,10,72,48,24,62
Alloa,4562,4,17,9,10,58,45,13,60
Stranraer,4562,5,15,5,16,57,68,-11,50
East Fife,4562,6,14,3,19,51,66,-15,45
Airdrieon,4562,7,11,11,14,46,58,-12,44
Forfar,4562,8,10,5,21,38,65,-27,35
Albion,4562,9,8,6,22,58,84,-26,30
Queen's Park,4562,10,6,10,20,39,74,-35,28
Raith,4563,1,22,9,5,70,34,36,75
Ayr,4563,2,23,4,9,90,44,46,73
Arbroath,4563,3,17,9,10,72,50,22,60
Alloa,4563,4,17,9,10,58,45,13,60
Stranraer,4563,5,16,5,15,59,65,-6,53
East Fife,4563,6,13,3,20,48,68,-20,42
Airdrieon,4563,7,10,11,15,46,60,-14,41
Forfar,4563,8,11,5,20,40,65,-25,38
Albion,4563,9,9,6,21,59,78,-19,33
Queen's Park,4563,10,6,11,19,41,74,-33,29
Ayr,4564,1,24,4,8,94,42,52,76
Raith,4564,2,22,8,6,69,34,35,74
Alloa,4564,3,18,8,10,58,44,14,62
Arbroath,4564,4,17,9,10,72,50,22,60
Stranraer,4564,5,15,5,16,55,66,-11,50
East Fife,4564,6,14,3,19,49,64,-15,45
Airdrieon,4564,7,11,11,14,47,59,-12,44
Forfar,4564,8,10,5,21,39,66,-27,35
Albion,4564,9,8,6,22,57,82,-25,30
Queen's Park,4564,10,6,11,19,41,74,-33,29
Raith,4565,1,23,8,5,70,32,38,77
Ayr,4565,2,24,4,8,94,43,51,76
Arbroath,4565,3,17,8,11,71,53,18,59
Alloa,4565,4,17,8,11,56,45,11,59
Stranraer,4565,5,16,5,15,58,65,-7,53
Airdrieon,4565,6,11,11,14,50,61,-11,44
East Fife,4565,7,13,3,20,48,67,-19,42
Forfar,4565,8,10,5,21,41,69,-28,35
Queen's Park,4565,9,7,10,19,44,73,-29,31
Albion,4565,10,8,6,22,58,82,-24,30
Raith,4566,1,23,8,5,74,32,42,77
Ayr,4566,2,24,4,8,92,43,49,76
Arbroath,4566,3,18,8,10,72,48,24,62
Alloa,4566,4,17,8,11,56,49,7,59
Stranraer,4566,5,16,5,15,58,66,-8,53
Airdrieon,4566,6,10,12,14,45,58,-13,42
East Fife,4566,7,13,3,20,49,67,-18,42
Forfar,4566,8,10,6,20,38,64,-26,36
Albion,4566,9,8,6,22,58,80,-22,30
Queen's Park,4566,10,6,10,20,39,74,-35,28
Ayr,4567,1,24,4,8,95,42,53,76
Raith,4567,2,22,9,5,69,33,36,75
Arbroath,4567,3,18,8,10,72,49,23,62
Alloa,4567,4,17,9,10,57,44,13,60
Stranraer,4567,5,15,5,16,56,66,-10,50
East Fife,4567,6,14,3,19,49,65,-16,45
Airdrieon,4567,7,10,12,14,45,58,-13,42
Forfar,4567,8,10,6,20,38,64,-26,36
Albion,4567,9,8,6,22,57,83,-26,30
Queen's Park,4567,10,6,10,20,40,74,-34,28
Raith,4568,1,23,8,5,72,32,40,77
Ayr,4568,2,24,4,8,94,42,52,76
Arbroath,4568,3,18,8,10,73,50,23,62
Alloa,4568,4,17,8,11,56,47,9,59
Stranraer,4568,5,15,5,16,55,67,-12,50
East Fife,4568,6,14,3,19,50,64,-14,45
Airdrieon,4568,7,10,11,15,45,61,-16,41
Forfar,4568,8,11,5,20,41,64,-23,38
Albion,4568,9,8,6,22,57,82,-25,30
Queen's Park,4568,10,6,10,20,41,75,-34,28
Raith,4569,1,23,8,5,71,32,39,77
Ayr,4569,2,24,4,8,96,43,53,76
Arbroath,4569,3,18,8,10,72,48,24,62
Alloa,4569,4,17,8,11,56,46,10,59
Stranraer,4569,5,15,5,16,56,67,-11,50
East Fife,4569,6,14,3,19,50,65,-15,45
Airdrieon,4569,7,11,11,14,47,58,-11,44
Forfar,4569,8,10,5,21,38,66,-28,35
Albion,4569,9,8,6,22,58,84,-26,30
Queen's Park,4569,10,6,10,20,39,74,-35,28
Raith,4570,1,23,8,5,71,32,39,77
Ayr,4570,2,23,5,8,92,44,48,74
Arbroath,4570,3,17,8,11,71,50,21,59
Alloa,4570,4,17,8,11,56,46,10,59
Stranraer,4570,5,16,5,15,58,65,-7,53
Airdrieon,4570,6,11,11,14,48,59,-11,44
East Fife,4570,7,13,3,20,48,67,-19,42
Forfar,4570,8,10,5,21,39,67,-28,35
Albion,4570,9,8,7,21,59,80,-21,31
Queen's Park,4570,10,7,10,19,41,73,-32,31
Raith,4571,1,22,9,5,70,34,36,75
Ayr,4571,2,23,5,8,91,43,48,74
Arbroath,4571,3,18,8,10,73,49,24,62
Alloa,4571,4,17,9,10,58,45,13,60
Stranraer,4571,5,15,5,16,55,68,-13,50
East Fife,4571,6,14,3,19,51,64,-13,45
Airdrieon,4571,7,11,11,14,48,58,-10,44
Forfar,4571,8,10,5,21,38,67,-29,35
Albion,4571,9,8,7,21,58,79,-21,31
Queen's Park,4571,10,6,10,20,40,75,-35,28
Ayr,4572,1,24,4,8,94,44,50,76
Raith,4572,2,22,8,6,68,33,35,74
Arbroath,4572,3,18,8,10,72,48,24,62
Alloa,4572,4,18,8,10,57,43,14,62
Stranraer,4572,5,15,5,16,56,66,-10,50
East Fife,4572,6,14,3,19,49,65,-16,45
Airdrieon,4572,7,11,11,14,49,58,-9,44
Forfar,4572,8,10,5,21,38,68,-30,35
Albion,4572,9,8,6,22,59,82,-23,30
Queen's Park,4572,10,6,10,20,39,74,-35,28
Ayr,4573,1,24,4,8,94,42,52,76
Raith,4573,2,22,8,6,68,33,35,74
Arbroath,4573,3,18,8,10,73,50,23,62
Alloa,4573,4,18,8,10,57,43,14,62
Stranraer,4573,5,16,5,15,57,65,-8,53
East Fife,4573,6,13,3,20,48,66,-18,42
Airdrieon,4573,7,10,11,15,46,60,-14,41
Forfar,4573,8,11,5,20,40,65,-25,38
Albion,4573,9,8,6,22,57,82,-25,30
Queen's Park,4573,10,6,10,20,41,75,-34,28
Ayr,4574,1,24,4,8,95,42,53,76
Raith,4574,2,22,9,5,68,32,36,75
Arbroath,4574,3,18,8,10,74,50,24,62
Alloa,4574,4,17,9,10,56,43,13,60
Stranraer,4574,5,15,5,16,56,66,-10,50
East Fife,4574,6,14,3,19,49,65,-16,45
Airdrieon,4574,7,11,11,14,48,59,-11,44
Forfar,4574,8,10,5,21,39,67,-28,35
Albion,4574,9,8,6,22,57,83,-26,30
Queen's Park,4574,10,6,10,20,41,76,-35,28
Raith,4575,1,23,8,5,71,32,39,77
Ayr,4575,2,24,4,8,93,44,49,76
Arbroath,4575,3,18,8,10,72,48,24,62
Alloa,4575,4,17,8,11,56,46,10,59
Stranraer,4575,5,16,5,15,57,65,-8,53
Airdrieon,4575,6,11,11,14,46,58,-12,44
East Fife,4575,7,13,3,20,48,66,-18,42
Forfar,4575,8,10,5,21,38,65,-27,35
Albion,4575,9,8,6,22,59,81,-22,30
Queen's Park,4575,10,6,10,20,39,74,-35,28
Raith,4576,1,23,8,5,69,32,37,77
Ayr,4576,2,24,4,8,94,45,49,76
Arbroath,4576,3,18,8,10,73,50,23,62
Alloa,4576,4,17,8,11,56,44,12,59
Stranraer,4576,5,15,6,15,56,65,-9,51
Airdrieon,4576,6,11,11,14,48,59,-11,44
East Fife,4576,7,13,4,19,48,65,-17,43
Forfar,4576,8,10,5,21,39,67,-28,35
Albion,4576,9,8,6,22,60,82,-22,30
Queen's Park,4576,10,6,10,20,41,75,-34,28
Raith,4577,1,23,8,5,71,34,37,77
Ayr,4577,2,24,4,8,92,43,49,76
Arbroath,4577,3,17,9,10,72,50,22,60
Alloa,4577,4,17,8,11,58,46,12,59
Stranraer,4577,5,16,5,15,58,66,-8,53
Airdrieon,4577,6,11,11,14,47,58,-11,44
East Fife,4577,7,13,3,20,49,67,-18,42
Forfar,4577,8,10,5,21,38,66,-28,35
Albion,4577,9,8,6,22,58,80,-22,30
Queen's Park,4577,10,6,11,19,41,74,-33,29
Ayr,4578,1,24,4,8,94,44,50,76
Raith,4578,2,22,9,5,69,33,36,75
Arbroath,4578,3,18,8,10,73,49,24,62
Alloa,4578,4,17,9,10,57,44,13,60
Stranraer,4578,5,15,5,16,56,66,-10,50
East Fife,4578,6,14,3,19,49,65,-16,45
Airdrieon,4578,7,10,11,15,48,62,-14,41
Forfar,4578,8,11,5,20,42,67,-25,38
Albion,4578,9,8,6,22,59,82,-23,30
Queen's Park,4578,10,6,10,20,40,75,-35,28
Ayr,4579,1,24,4,8,94,45,49,76
Raith,4579,2,22,8,6,68,34,34,74
Arbroath,4579,3,18,8,10,73,50,23,62
Alloa,4579,4,18,8,10,58,43,15,62
Stranraer,4579,5,16,5,15,57,65,-8,53
Airdrieon,4579,6,11,11,14,47,58,-11,44
East Fife,4579,7,13,3,20,48,66,-18,42
Forfar,4579,8,10,5,21,38,66,-28,35
Albion,4579,9,8,6,22,60,82,-22,30
Queen's Park,4579,10,6,10,20,41,75,-34,28
Ayr,4580,1,24,4,8,92,42,50,76
Raith,4580,2,22,9,5,69,33,36,75
Arbroath,4580,3,17,9,10,72,50,22,60
Alloa,4580,4,17,9,10,57,44,13,60
Stranraer,4580,5,15,6,15,56,65,-9,51
East Fife,4580,6,13,4,19,48,65,-17,43
Airdrieon,4580,7,10,12,14,46,59,-13,42
Forfar,4580,8,10,6,20,39,65,-26,36
Albion,4580,9,8,6,22,57,80,-23,30
Queen's Park,4580,10,6,11,19,41,74,-33,29
Raith,4581,1,23,8,5,70,32,38,77
Ayr,4581,2,24,4,8,95,42,53,76
Arbroath,4581,3,18,8,10,73,49,24,62
Alloa,4581,4,17,8,11,56,45,11,59
Stranraer,4581,5,15,5,16,56,69,-13,50
East Fife,4581,6,14,3,19,52,65,-13,45
Airdrieon,4581,7,11,11,14,47,58,-11,44
Forfar,4581,8,10,5,21,38,66,-28,35
Albion,4581,9,8,6,22,57,83,-26,30
Queen's Park,4581,10,6,10,20,40,75,-35,28
Raith,4582,1,23,8,5,70,33,37,77
Ayr,4582,2,24,4,8,93,43,50,76
Arbroath,4582,3,17,8,11,73,54,19,59
Alloa,4582,4,17,8,11,57,45,12,59
Stranraer,4582,5,16,5,15,58,64,-6,53
Airdrieon,4582,6,10,12,14,47,60,-13,42
East Fife,4582,7,13,3,20,47,67,-20,42
Forfar,4582,8,10,6,20,40,66,-26,36
Queen's Park,4582,9,7,10,19,45,75,-30,31
Albion,4582,10,8,6,22,58,81,-23,30
Ayr,4583,1,24,4,8,93,43,50,76
Raith,4583,2,22,8,6,69,35,34,74
Alloa,4583,3,18,8,10,59,44,15,62
Arbroath,4583,4,17,9,10,71,49,22,60
Stranraer,4583,5,16,5,15,59,65,-6,53
East Fife,4583,6,13,3,20,48,68,-20,42
Airdrieon,4583,7,10,11,15,47,61,-14,41
Forfar,4583,8,11,5,20,41,66,-25,38
Albion,4583,9,8,6,22,58,81,-23,30
Queen's Park,4583,10,6,11,19,40,73,-33,29
Ayr,4584,1,24,4,8,93,43,50,76
Raith,4584,2,22,9,5,69,33,36,75
Arbroath,4584,3,18,8,10,73,50,23,62
Alloa,4584,4,17,9,10,57,44,13,60
Stranraer,4584,5,15,5,16,56,66,-10,50
East Fife,4584,6,14,3,19,49,65,-16,45
Airdrieon,4584,7,10,11,15,47,61,-14,41
Forfar,4584,8,11,5,20,41,66,-25,38
Albion,4584,9,8,6,22,58,81,-23,30
Queen's Park,4584,10,6,10,20,41,75,-34,28
Ayr,4585,1,24,4,8,92,42,50,76
Raith,4585,2,22,9,5,68,32,36,75
Arbroath,4585,3,18,8,10,72,49,23,62
Alloa,4585,4,17,9,10,56,43,13,60
Stranraer,4585,5,15,5,16,57,67,-10,50
East Fife,4585,6,14,3,19,50,66,-16,45
Airdrieon,4585,7,10,11,15,46,60,-14,41
Forfar,4585,8,11,5,20,40,65,-25,38
Albion,4585,9,8,6,22,57,80,-23,30
Queen's Park,4585,10,6,10,20,40,74,-34,28
Ayr,4586,1,24,4,8,93,43,50,76
Raith,4586,2,22,8,6,69,34,35,74
Arbroath,4586,3,18,8,10,72,48,24,62
Alloa,4586,4,18,8,10,58,44,14,62
Stranraer,4586,5,16,5,15,57,64,-7,53
Airdrieon,4586,6,11,11,14,47,58,-11,44
East Fife,4586,7,13,3,20,47,66,-19,42
Forfar,4586,8,10,5,21,38,66,-28,35
Albion,4586,9,8,6,22,58,81,-23,30
Queen's Park,4586,10,6,10,20,39,74,-35,28
Raith,4587,1,23,8,5,73,32,41,77
Ayr,4587,2,23,4,9,90,43,47,73
Arbroath,4587,3,17,8,11,70,49,21,59
Alloa,4587,4,17,8,11,56,48,8,59
Stranraer,4587,5,16,5,15,57,65,-8,53
Airdrieon,4587,6,10,12,14,45,58,-13,42
East Fife,4587,7,13,3,20,48,66,-18,42
Forfar,4587,8,10,6,20,38,64,-26,36
Albion,4587,9,9,6,21,58,78,-20,33
Queen's Park,4587,10,7,10,19,40,72,-32,31
Raith,4588,1,22,9,5,69,33,36,75
Ayr,4588,2,23,5,8,92,44,48,74
Arbroath,4588,3,18,8,10,74,49,25,62
Alloa,4588,4,17,9,10,57,44,13,60
Stranraer,4588,5,15,5,16,55,66,-11,50
East Fife,4588,6,14,3,19,49,64,-15,45
Airdrieon,4588,7,11,11,14,48,59,-11,44
Forfar,4588,8,10,5,21,39,67,-28,35
Albion,4588,9,8,7,21,59,80,-21,31
Queen's Park,4588,10,6,10,20,40,76,-36,28
Raith,4589,1,23,8,5,71,32,39,77
Ayr,4589,2,23,5,8,92,44,48,74
Arbroath,4589,3,17,9,10,71,49,22,60
Alloa,4589,4,17,8,11,56,46,10,59
Stranraer,4589,5,16,5,15,56,64,-8,53
Airdrieon,4589,6,11,11,14,47,58,-11,44
East Fife,4589,7,13,3,20,47,65,-18,42
Forfar,4589,8,10,5,21,38,66,-28,35
Albion,4589,9,8,7,21,59,80,-21,31
Queen's Park,4589,10,6,11,19,40,73,-33,29
Raith,4590,1,22,9,5,69,33,36,75
Ayr,4590,2,23,4,9,92,45,47,73
Arbroath,4590,3,18,8,10,72,49,23,62
Alloa,4590,4,17,9,10,57,44,13,60
Stranraer,4590,5,15,6,15,58,67,-9,51
East Fife,4590,6,13,4,19,50,67,-17,43
Airdrieon,4590,7,10,11,15,45,59,-14,41
Forfar,4590,8,11,5,20,39,64,-25,38
Albion,4590,9,9,6,21,60,80,-20,33
Queen's Park,4590,10,6,10,20,40,74,-34,28
Raith,4591,1,23,8,5,71,32,39,77
Ayr,4591,2,24,4,8,95,43,52,76
Arbroath,4591,3,18,8,10,71,48,23,62
Alloa,4591,4,17,8,11,56,46,10,59
Stranraer,4591,5,15,6,15,57,66,-9,51
East Fife,4591,6,13,4,19,49,66,-17,43
Airdrieon,4591,7,10,12,14,45,58,-13,42
Forfar,4591,8,10,6,20,38,64,-26,36
Albion,4591,9,8,6,22,58,83,-25,30
Queen's Park,4591,10,6,10,20,39,73,-34,28
Ayr,4592,1,24,4,8,95,43,52,76
Raith,4592,2,22,9,5,69,33,36,75
Alloa,4592,3,17,9,10,57,44,13,60
Arbroath,4592,4,17,8,11,71,50,21,59
Stranraer,4592,5,16,5,15,57,64,-7,53
East Fife,4592,6,13,3,20,47,66,-19,42
Airdrieon,4592,7,10,11,15,46,60,-14,41
Forfar,4592,8,11,5,20,40,65,-25,38
Queen's Park,4592,9,7,10,19,41,73,-32,31
Albion,4592,10,8,6,22,58,83,-25,30
Raith,4593,1,23,8,5,69,32,37,77
Ayr,4593,2,24,4,8,95,43,52,76
Arbroath,4593,3,18,8,10,73,48,25,62
Alloa,4593,4,17,8,11,56,44,12,59
Stranraer,4593,5,16,5,15,60,67,-7,53
Airdrieon,4593,6,11,11,14,48,58,-10,44
East Fife,4593,7,13,3,20,50,69,-19,42
Forfar,4593,8,10,5,21,38,67,-29,35
Albion,4593,9,8,6,22,58,83,-25,30
Queen's Park,4593,10,6,10,20,39,75,-36,28
Raith,4594,1,22,9,5,68,32,36,75
Ayr,4594,2,23,5,8,92,44,48,74
Arbroath,4594,3,18,8,10,73,49,24,62
Alloa,4594,4,17,9,10,56,43,13,60
Stranraer,4594,5,16,5,15,59,67,-8,53
East Fife,4594,6,13,3,20,50,68,-18,42
Airdrieon,4594,7,10,11,15,45,59,-14,41
Forfar,4594,8,11,5,20,39,64,-25,38
Albion,4594,9,8,7,21,59,80,-21,31
Queen's Park,4594,10,6,10,20,40,75,-35,28
Ayr,4595,1,24,4,8,94,42,52,76
Raith,4595,2,22,8,6,68,34,34,74
Arbroath,4595,3,18,8,10,73,49,24,62
Alloa,4595,4,18,8,10,58,43,15,62
Stranraer,4595,5,15,6,15,56,65,-9,51
Airdrieon,4595,6,11,11,14,48,59,-11,44
East Fife,4595,7,13,4,19,48,65,-17,43
Forfar,4595,8,10,5,21,39,67,-28,35
Albion,4595,9,8,6,22,57,82,-25,30
Queen's Park,4595,10,6,10,20,40,75,-35,28
Raith,4596,1,23,8,5,69,32,37,77
Ayr,4596,2,24,4,8,92,42,50,76
Arbroath,4596,3,17,9,10,75,53,22,60
Alloa,4596,4,17,8,11,56,44,12,59
Stranraer,4596,5,15,5,16,57,67,-10,50
East Fife,4596,6,14,3,19,50,66,-16,45
Airdrieon,4596,7,11,11,14,49,59,-10,44
Forfar,4596,8,10,5,21,39,68,-29,35
Albion,4596,9,8,6,22,57,80,-23,30
Queen's Park,4596,10,6,11,19,44,77,-33,29
Ayr,4597,1,24,4,8,96,43,53,76
Raith,4597,2,22,8,6,70,35,35,74
Alloa,4597,3,18,8,10,59,45,14,62
Arbroath,4597,4,17,9,10,72,50,22,60
Stranraer,4597,5,15,5,16,55,65,-10,50
East Fife,4597,6,14,3,19,48,64,-16,45
Airdrieon,4597,7,11,11,14,50,58,-8,44
Forfar,4597,8,10,5,21,38,69,-31,35
Albion,4597,9,8,6,22,58,84,-26,30
Queen's Park,4597,10,6,11,19,41,74,-33,29
Raith,4598,1,23,8,5,70,33,37,77
Ayr,4598,2,23,4,9,91,45,46,73
Arbroath,4598,3,17,9,10,71,49,22,60
Alloa,4598,4,17,8,11,57,45,12,59
Stranraer,4598,5,15,5,16,55,66,-11,50
East Fife,4598,6,14,3,19,49,64,-15,45
Airdrieon,4598,7,10,11,15,46,62,-16,41
Forfar,4598,8,11,5,20,42,65,-23,38
Albion,4598,9,9,6,21,60,79,-19,33
Queen's Park,4598,10,6,11,19,40,73,-33,29
Raith,4599,1,23,8,5,70,33,37,77
Ayr,4599,2,24,4,8,97,42,55,76
Arbroath,4599,3,17,9,10,72,50,22,60
Alloa,4599,4,17,8,11,57,45,12,59
Stranraer,4599,5,15,6,15,56,65,-9,51
Airdrieon,4599,6,11,11,14,46,58,-12,44
East Fife,4599,7,13,4,19,48,65,-17,43
Forfar,4599,8,10,5,21,38,65,-27,35
Albion,4599,9,8,6,22,57,85,-28,30
Queen's Park,4599,10,6,11,19,41,74,-33,29
Ayr,4600,1,24,4,8,92,43,49,76
Raith,4600,2,22,8,6,69,34,35,74
Alloa,4600,3,18,8,10,58,44,14,62
Arbroath,4600,4,17,9,10,72,50,22,60
Stranraer,4600,5,16,5,15,56,64,-8,53
East Fife,4600,6,13,3,20,47,65,-18,42
Airdrieon,4600,7,10,11,15,47,61,-14,41
Forfar,4600,8,11,5,20,41,66,-25,38
Albion,4600,9,8,6,22,58,80,-22,30
Queen's Park,4600,10,6,11,19,41,74,-33,29
Raith,4601,1,23,8,5,71,33,38,77
Ayr,4601,2,23,5,8,94,46,48,74
Arbroath,4601,3,18,8,10,72,48,24,62
Alloa,4601,4,17,8,11,57,46,11,59
Stranraer,4601,5,15,6,15,56,65,-9,51
East Fife,4601,6,13,4,19,48,65,-17,43
Airdrieon,4601,7,10,11,15,46,61,-15,41
Forfar,4601,8,11,5,20,41,65,-24,38
Albion,4601,9,8,7,21,61,82,-21,31
Queen's Park,4601,10,6,10,20,39,74,-35,28
Raith,4602,1,23,8,5,69,32,37,77
Ayr,4602,2,23,5,8,93,45,48,74
Arbroath,4602,3,17,8,11,71,51,20,59
Alloa,4602,4,17,8,11,56,44,12,59
Stranraer,4602,5,15,5,16,55,65,-10,50
East Fife,4602,6,14,3,19,48,64,-16,45
Airdrieon,4602,7,10,11,15,45,61,-16,41
Forfar,4602,8,11,5,20,41,64,-23,38
Albion,4602,9,8,7,21,60,81,-21,31
Queen's Park,4602,10,7,10,19,42,73,-31,31
Raith,4603,1,23,8,5,71,34,37,77
Ayr,4603,2,24,4,8,95,43,52,76
Arbroath,4603,3,18,8,10,72,49,23,62
Alloa,4603,4,17,8,11,58,46,12,59
Stranraer,4603,5,16,5,15,58,66,-8,53
Airdrieon,4603,6,11,11,14,47,58,-11,44
East Fife,4603,7,13,3,20,49,67,-18,42
Forfar,4603,8,10,5,21,38,66,-28,35
Albion,4603,9,8,6,22,58,83,-25,30
Queen's Park,4603,10,6,10,20,40,74,-34,28
Raith,4604,1,23,8,5,69,32,37,77
Ayr,4604,2,24,4,8,93,42,51,76
Arbroath,4604,3,17,8,11,71,50,21,59
Alloa,4604,4,17,8,11,56,44,12,59
Stranraer,4604,5,15,6,15,57,66,-9,51
East Fife,4604,6,13,4,19,49,66,-17,43
Airdrieon,4604,7,10,12,14,46,59,-13,42
Forfar,4604,8,10,6,20,39,65,-26,36
Queen's Park,4604,9,7,10,19,41,73,-32,31
Albion,4604,10,8,6,22,57,81,-24,30
Ayr,4605,1,23,5,8,92,44,48,74
Raith,4605,2,22,8,6,68,34,34,74
Alloa,4605,3,18,8,10,58,43,15,62
Arbroath,4605,4,17,9,10,70,48,22,60
Stranraer,4605,5,16,5,15,56,64,-8,53
Airdrieon,4605,6,11,11,14,49,58,-9,44
East Fife,4605,7,13,3,20,47,65,-18,42
Forfar,4605,8,10,5,21,38,68,-30,35
Albion,4605,9,8,7,21,59,80,-21,31
Queen's Park,4605,10,6,11,19,39,72,-33,29
Ayr,4606,1,24,4,8,93,44,49,76
Raith,4606,2,22,9,5,68,32,36,75
Arbroath,4606,3,18,8,10,71,48,23,62
Alloa,4606,4,17,9,10,56,43,13,60
Stranraer,4606,5,15,5,16,55,67,-12,50
East Fife,4606,6,14,3,19,50,64,-14,45
Airdrieon,4606,7,11,11,14,47,59,-12,44
Forfar,4606,8,10,5,21,39,66,-27,35
Albion,4606,9,8,6,22,59,81,-22,30
Queen's Park,4606,10,6,10,20,39,73,-34,28
Raith,4607,1,23,8,5,71,33,38,77
Ayr,4607,2,24,4,8,92,43,49,76
Arbroath,4607,3,17,8,11,71,50,21,59
Alloa,4607,4,17,8,11,57,46,11,59
Stranraer,4607,5,16,5,15,58,64,-6,53
Airdrieon,4607,6,11,11,14,51,59,-8,44
East Fife,4607,7,13,3,20,47,67,-20,42
Forfar,4607,8,10,5,21,39,70,-31,35
Queen's Park,4607,9,7,10,19,41,73,-32,31
Albion,4607,10,8,6,22,58,80,-22,30
Raith,4608,1,23,8,5,71,32,39,77
Ayr,4608,2,23,5,8,93,45,48,74
Arbroath,4608,3,18,8,10,73,49,24,62
Alloa,4608,4,17,8,11,56,46,10,59
Stranraer,4608,5,15,6,15,56,65,-9,51
East Fife,4608,6,13,4,19,48,65,-17,43
Airdrieon,4608,7,10,11,15,45,59,-14,41
Forfar,4608,8,11,5,20,39,64,-25,38
Albion,4608,9,8,7,21,60,81,-21,31
Queen's Park,4608,10,6,10,20,40,75,-35,28
Ayr,4609,1,24,4,8,92,43,49,76
Raith,4609,2,22,9,5,69,33,36,75
Arbroath,4609,3,18,8,10,72,49,23,62
Alloa,4609,4,17,9,10,57,44,13,60
Stranraer,4609,5,16,5,15,56,64,-8,53
Airdrieon,4609,6,10,12,14,46,59,-13,42
East Fife,4609,7,13,3,20,47,65,-18,42
Forfar,4609,8,10,6,20,39,65,-26,36
Albion,4609,9,8,6,22,58,80,-22,30
Queen's Park,4609,10,6,10,20,40,74,-34,28
Ayr,4610,1,24,4,8,93,44,49,76
Raith,4610,2,22,8,6,69,34,35,74
Arbroath,4610,3,18,8,10,73,50,23,62
Alloa,4610,4,18,8,10,58,44,14,62
Stranraer,4610,5,15,5,16,56,67,-11,50
East Fife,4610,6,14,3,19,50,65,-15,45
Airdrieon,4610,7,11,11,14,47,59,-12,44
Forfar,4610,8,10,5,21,39,66,-27,35
Albion,4610,9,8,6,22,59,81,-22,30
Queen's Park,4610,10,6,10,20,41,75,-34,28
Raith,4611,1,22,9,5,68,32,36,75
Ayr,4611,2,23,5,8,93,45,48,74
Arbroath,4611,3,18,8,10,72,49,23,62
Alloa,4611,4,17,9,10,56,43,13,60
Stranraer,4611,5,16,5,15,56,64,-8,53
Airdrieon,4611,6,10,12,14,46,59,-13,42
East Fife,4611,7,13,3,20,47,65,-18,42
Forfar,4611,8,10,6,20,39,65,-26,36
Albion,4611,9,8,7,21,60,81,-21,31
Queen's Park,4611,10,6,10,20,40,74,-34,28
Raith,4612,1,23,8,5,69,32,37,77
Ayr,4612,2,24,4,8,95,43,52,76
Arbroath,4612,3,17,8,11,70,50,20,59
Alloa,4612,4,17,8,11,56,44,12,59
Stranraer,4612,5,16,5,15,56,64,-8,53
Airdrieon,4612,6,11,11,14,46,58,-12,44
East Fife,4612,7,13,3,20,47,65,-18,42
Forfar,4612,8,10,5,21,38,65,-27,35
Queen's Park,4612,9,7,10,19,41,72,-31,31
Albion,4612,10,8,6,22,58,83,-25,30
Ayr,4613,1,24,4,8,95,44,51,76
Raith,4613,2,22,9,5,68,32,36,75
Alloa,4613,3,17,9,10,56,43,13,60
Arbroath,4613,4,17,8,11,72,51,21,59
Stranraer,4613,5,15,5,16,55,67,-12,50
East Fife,4613,6,14,3,19,50,64,-14,45
Airdrieon,4613,7,10,11,15,46,60,-14,41
Forfar,4613,8,11,5,20,40,65,-25,38
Queen's Park,4613,9,7,10,19,42,74,-32,31
Albion,4613,10,8,6,22,59,83,-24,30
Ayr,4614,1,24,4,8,94,44,50,76
Raith,4614,2,22,9,5,69,33,36,75
Arbroath,4614,3,18,8,10,75,49,26,62
Alloa,4614,4,17,9,10,57,44,13,60
Stranraer,4614,5,16,5,15,57,65,-8,53
East Fife,4614,6,13,3,20,48,66,-18,42
Airdrieon,4614,7,10,11,15,45,59,-14,41
Forfar,4614,8,11,5,20,39,64,-25,38
Albion,4614,9,8,6,22,59,82,-23,30
Queen's Park,4614,10,6,10,20,40,77,-37,28
Ayr,4615,1,24,4,8,100,42,58,76
Raith,4615,2,22,9,5,69,33,36,75
Arbroath,4615,3,17,9,10,71,49,22,60
Alloa,4615,4,17,9,10,57,44,13,60
Stranraer,4615,5,15,5,16,56,66,-10,50
East Fife,4615,6,14,3,19,49,65,-16,45
Airdrieon,4615,7,11,11,14,47,58,-11,44
Forfar,4615,8,10,5,21,38,66,-28,35
Albion,4615,9,8,6,22,57,88,-31,30
Queen's Park,4615,10,6,11,19,40,73,-33,29
Raith,4616,1,23,8,5,71,32,39,77
Ayr,4616,2,23,5,8,93,45,48,74
Arbroath,4616,3,18,8,10,71,48,23,62
Alloa,4616,4,17,8,11,56,46,10,59
Stranraer,4616,5,15,5,16,55,67,-12,50
East Fife,4616,6,14,3,19,50,64,-14,45
Airdrieon,4616,7,10,12,14,47,60,-13,42
Forfar,4616,8,10,6,20,40,66,-26,36
Albion,4616,9,8,7,21,60,81,-21,31
Queen's Park,4616,10,6,10,20,39,73,-34,28
Ayr,4617,1,24,4,8,94,43,51,76
Raith,4617,2,22,9,5,69,33,36,75
Arbroath,4617,3,18,8,10,75,48,27,62
Alloa,4617,4,17,9,10,57,44,13,60
Stranraer,4617,5,15,6,15,56,65,-9,51
Airdrieon,4617,6,11,11,14,49,58,-9,44
East Fife,4617,7,13,4,19,48,65,-17,43
Forfar,4617,8,10,5,21,38,68,-30,35
Albion,4617,9,8,6,22,58,82,-24,30
Queen's Park,4617,10,6,10,20,39,77,-38,28
Raith,4618,1,23,8,5,70,33,37,77
Ayr,4618,2,24,4,8,94,43,51,76
Arbroath,4618,3,17,8,11,71,50,21,59
Alloa,4618,4,17,8,11,57,45,12,59
Stranraer,4618,5,15,5,16,55,65,-10,50
East Fife,4618,6,14,3,19,48,64,-16,45
Airdrieon,4618,7,11,11,14,47,58,-11,44
Forfar,4618,8,10,5,21,38,66,-28,35
Queen's Park,4618,9,7,10,19,41,73,-32,31
Albion,4618,10,8,6,22,58,82,-24,30
Ayr,4619,1,24,4,8,93,42,51,76
Raith,4619,2,22,9,5,68,32,36,75
Arbroath,4619,3,18,8,10,72,49,23,62
Alloa,4619,4,17,9,10,56,43,13,60
Stranraer,4619,5,15,5,16,55,66,-11,50
East Fife,4619,6,14,3,19,49,64,-15,45
Airdrieon,4619,7,10,11,15,46,60,-14,41
Forfar,4619,8,11,5,20,40,65,-25,38
Albion,4619,9,8,6,22,57,81,-24,30
Queen's Park,4619,10,6,10,20,40,74,-34,28
Raith,4620,1,23,8,5,70,32,38,77
Ayr,4620,2,24,4,8,95,42,53,76
Arbroath,4620,3,17,8,11,70,51,19,59
Alloa,4620,4,17,8,11,56,45,11,59
Stranraer,4620,5,16,5,15,56,64,-8,53
Airdrieon,4620,6,11,11,14,48,58,-10,44
East Fife,4620,7,13,3,20,47,65,-18,42
Forfar,4620,8,10,5,21,38,67,-29,35
Queen's Park,4620,9,7,10,19,42,72,-30,31
Albion,4620,10,8,6,22,57,83,-26,30
Ayr,4621,1,24,4,8,93,42,51,76
Raith,4621,2,22,9,5,68,32,36,75
Arbroath,4621,3,18,8,10,74,49,25,62
Alloa,4621,4,17,9,10,56,43,13,60
Stranraer,4621,5,15,6,15,56,65,-9,51
East Fife,4621,6,13,4,19,48,65,-17,43
Airdrieon,4621,7,10,12,14,46,59,-13,42
Forfar,4621,8,10,6,20,39,65,-26,36
Albion,4621,9,8,6,22,57,81,-24,30
Queen's Park,4621,10,6,10,20,40,76,-36,28
Raith,4622,1,23,8,5,71,32,39,77
Ayr,4622,2,24,4,8,94,43,51,76
Arbroath,4622,3,17,9,10,70,48,22,60
Alloa,4622,4,17,8,11,56,46,10,59
Stranraer,4622,5,15,5,16,56,67,-11,50
East Fife,4622,6,14,3,19,50,65,-15,45
Airdrieon,4622,7,11,11,14,47,58,-11,44
Forfar,4622,8,10,5,21,38,66,-28,35
Albion,4622,9,8,6,22,58,82,-24,30
Queen's Park,4622,10,6,11,19,39,72,-33,29
Raith,4623,1,23,8,5,71,32,39,77
Ayr,4623,2,24,4,8,95,44,51,76
Arbroath,4623,3,18,8,10,72,49,23,62
Alloa,4623,4,17,8,11,56,46,10,59
Stranraer,4623,5,15,5,16,56,66,-10,50
East Fife,4623,6,14,3,19,49,65,-16,45
Airdrieon,4623,7,10,12,14,45,58,-13,42
Forfar,4623,8,10,6,20,38,64,-26,36
Albion,4623,9,8,6,22,59,83,-24,30
Queen's Park,4623,10,6,10,20,40,74,-34,28
Raith,4624,1,23,8,5,70,33,37,77
Ayr,4624,2,24,4,8,95,42,53,76
Arbroath,4624,3,18,8,10,73,48,25,62
Alloa,4624,4,17,8,11,57,45,12,59
Stranraer,4624,5,15,5,16,55,69,-14,50
East Fife,4624,6,14,3,19,52,64,-12,45
Airdrieon,4624,7,11,11,14,47,59,-12,44
Forfar,4624,8,10,5,21,39,66,-27,35
Albion,4624,9,8,6,22,57,83,-26,30
Queen's Park,4624,10,6,10,20,39,75,-36,28
Raith,4625,1,23,8,5,70,33,37,77
Ayr,4625,2,23,5,8,93,45,48,74
Arbroath,4625,3,17,8,11,72,51,21,59
Alloa,4625,4,17,8,11,57,45,12,59
Stranraer,4625,5,15,6,15,55,64,-9,51
Airdrieon,4625,6,11,11,14,47,58,-11,44
East Fife,4625,7,13,4,19,47,64,-17,43
Forfar,4625,8,10,5,21,38,66,-28,35
Albion,4625,9,8,7,21,60,81,-21,31
Queen's Park,4625,10,7,10,19,42,74,-32,31
Raith,4626,1,23,8,5,70,32,38,77
Ayr,4626,2,24,4,8,94,42,52,76
Arbroath,4626,3,18,8,10,72,48,24,62
Alloa,4626,4,17,8,11,56,45,11,59
Stranraer,4626,5,15,5,16,56,70,-14,50
East Fife,4626,6,14,3,19,53,65,-12,45
Airdrieon,4626,7,10,12,14,47,60,-13,42
Forfar,4626,8,10,6,20,40,66,-26,36
Albion,4626,9,8,6,22,57,82,-25,30
Queen's Park,4626,10,6,10,20,39,74,-35,28
Raith,4627,1,23,8,5,69,32,37,77
Ayr,4627,2,24,4,8,93,42,51,76
Arbroath,4627,3,17,8,11,70,50,20,59
Alloa,4627,4,17,8,11,56,44,12,59
Stranraer,4627,5,16,5,15,56,64,-8,53
East Fife,4627,6,13,3,20,47,65,-18,42
Airdrieon,4627,7,10,11,15,45,60,-15,41
Forfar,4627,8,11,5,20,40,64,-24,38
Queen's Park,4627,9,7,10,19,41,72,-31,31
Albion,4627,10,8,6,22,57,81,-24,30
Raith,4628,1,23,8,5,72,32,40,77
Ayr,4628,2,24,4,8,92,42,50,76
Arbroath,4628,3,18,8,10,77,48,29,62
Alloa,4628,4,17,8,11,56,47,9,59
Stranraer,4628,5,16,5,15,57,65,-8,53
Airdrieon,4628,6,10,12,14,45,58,-13,42
East Fife,4628,7,13,3,20,48,66,-18,42
Forfar,4628,8,10,6,20,38,64,-26,36
Albion,4628,9,8,6,22,57,80,-23,30
Queen's Park,4628,10,6,10,20,39,79,-40,28
Raith,4629,1,23,8,5,71,33,38,77
Ayr,4629,2,24,4,8,97,46,51,76
Arbroath,4629,3,17,9,10,73,51,22,60
Alloa,4629,4,17,8,11,57,46,11,59
Stranraer,4629,5,16,5,15,56,64,-8,53
Airdrieon,4629,6,11,11,14,47,59,-12,44
East Fife,4629,7,13,3,20,47,65,-18,42
Forfar,4629,8,10,5,21,39,66,-27,35
Albion,4629,9,8,6,22,61,85,-24,30
Queen's Park,4629,10,6,11,19,42,75,-33,29
Raith,4630,1,23,8,5,69,32,37,77
Ayr,4630,2,24,4,8,92,43,49,76
Arbroath,4630,3,17,9,10,73,51,22,60
Alloa,4630,4,17,8,11,56,44,12,59
Stranraer,4630,5,15,5,16,56,66,-10,50
East Fife,4630,6,14,3,19,49,65,-16,45
Airdrieon,4630,7,11,11,14,46,58,-12,44
Forfar,4630,8,10,5,21,38,65,-27,35
Albion,4630,9,8,6,22,58,80,-22,30
Queen's Park,4630,10,6,11,19,42,75,-33,29
Ayr,4631,1,24,4,8,93,42,51,76
Raith,4631,2,22,8,6,68,33,35,74
Arbroath,4631,3,18,8,10,75,49,26,62
Alloa,4631,4,18,8,10,57,43,14,62
Stranraer,4631,5,16,5,15,57,64,-7,53
Airdrieon,4631,6,11,11,14,47,59,-12,44
East Fife,4631,7,13,3,20,47,66,-19,42
Forfar,4631,8,10,5,21,39,66,-27,35
Albion,4631,9,8,6,22,57,81,-24,30
Queen's Park,4631,10,6,10,20,40,77,-37,28
Ayr,4632,1,24,4,8,95,42,53,76
Raith,4632,2,22,8,6,69,34,35,74
Arbroath,4632,3,18,8,10,72,48,24,62
Alloa,4632,4,18,8,10,58,44,14,62
Stranraer,4632,5,15,5,16,56,66,-10,50
East Fife,4632,6,14,3,19,49,65,-16,45
Airdrieon,4632,7,11,11,14,47,59,-12,44
Forfar,4632,8,10,5,21,39,66,-27,35
Albion,4632,9,8,6,22,57,83,-26,30
Queen's Park,4632,10,6,10,20,39,74,-35,28
Ayr,4633,1,24,4,8,94,45,49,76
Raith,4633,2,22,9,5,69,33,36,75
Arbroath,4633,3,18,8,10,74,48,26,62
Alloa,4633,4,17,9,10,57,44,13,60
Stranraer,4633,5,15,5,16,55,66,-11,50
East Fife,4633,6,14,3,19,49,64,-15,45
Airdrieon,4633,7,10,11,15,46,62,-16,41
Forfar,4633,8,11,5,20,42,65,-23,38
Albion,4633,9,8,6,22,60,82,-22,30
Queen's Park,4633,10,6,10,20,39,76,-37,28
Ayr,4634,1,24,4,8,92,43,49,76
Raith,4634,2,22,9,5,71,35,36,75
Alloa,4634,3,17,9,10,59,46,13,60
Arbroath,4634,4,17,8,11,72,51,21,59
Stranraer,4634,5,16,5,15,57,65,-8,53
Airdrieon,4634,6,11,11,14,47,58,-11,44
East Fife,4634,7,13,3,20,48,66,-18,42
Forfar,4634,8,10,5,21,38,66,-28,35
Queen's Park,4634,9,7,10,19,42,74,-32,31
Albion,4634,10,8,6,22,58,80,-22,30
Ayr,4635,1,24,4,8,92,43,49,76
Raith,4635,2,22,9,5,70,34,36,75
Arbroath,4635,3,18,8,10,74,48,26,62
Alloa,4635,4,17,9,10,58,45,13,60
Stranraer,4635,5,15,5,16,56,67,-11,50
East Fife,4635,6,14,3,19,50,65,-15,45
Airdrieon,4635,7,11,11,14,47,58,-11,44
Forfar,4635,8,10,5,21,38,66,-28,35
Albion,4635,9,8,6,22,58,80,-22,30
Queen's Park,4635,10,6,10,20,39,76,-37,28
Raith,4636,1,23,8,5,72,32,40,77
Ayr,4636,2,24,4,8,94,42,52,76
Arbroath,4636,3,17,9,10,70,48,22,60
Alloa,4636,4,17,8,11,56,47,9,59
Stranraer,4636,5,15,6,15,55,64,-9,51
Airdrieon,4636,6,11,11,14,47,59,-12,44
East Fife,4636,7,13,4,19,47,64,-17,43
Forfar,4636,8,10,5,21,39,66,-27,35
Albion,4636,9,8,6,22,57,82,-25,30
Queen's Park,4636,10,6,11,19,39,72,-33,29
Raith,4637,1,22,8,6,70,36,34,74
Ayr,4637,2,23,4,9,91,44,47,73
Alloa,4637,3,18,8,10,60,45,15,62
Arbroath,4637,4,17,9,10,71,49,22,60
Stranraer,4637,5,15,5,16,56,68,-12,50
East Fife,4637,6,14,3,19,51,65,-14,45
Airdrieon,4637,7,10,12,14,46,59,-13,42
Forfar,4637,8,10,6,20,39,65,-26,36
Albion,4637,9,9,6,21,59,79,-20,33
Queen's Park,4637,10,6,11,19,40,73,-33,29
Raith,4638,1,23,8,5,69,32,37,77
Ayr,4638,2,23,4,9,93,46,47,73
Arbroath,4638,3,17,9,10,72,50,22,60
Alloa,4638,4,17,8,11,56,44,12,59
Stranraer,4638,5,15,6,15,56,65,-9,51
East Fife,4638,6,13,4,19,48,65,-17,43
Airdrieon,4638,7,10,12,14,45,58,-13,42
Forfar,4638,8,10,6,20,38,64,-26,36
Albion,4638,9,9,6,21,61,81,-20,33
Queen's Park,4638,10,6,11,19,41,74,-33,29
Ayr,4639,1,24,4,8,99,43,56,76
Raith,4639,2,22,9,5,69,33,36,75
Alloa,4639,3,17,9,10,57,44,13,60
Arbroath,4639,4,17,8,11,71,51,20,59
Stranraer,4639,5,15,5,16,57,68,-11,50
East Fife,4639,6,14,3,19,51,66,-15,45
Airdrieon,4639,7,11,11,14,48,59,-11,44
Forfar,4639,8,10,5,21,39,67,-28,35
Queen's Park,4639,9,7,10,19,42,73,-31,31
Albion,4639,10,8,6,22,58,87,-29,30
Ayr,4640,1,24,4,8,99,44,55,76
Raith,4640,2,22,8,6,69,34,35,74
Alloa,4640,3,18,8,10,58,44,14,62
Arbroath,4640,4,17,9,10,70,48,22,60
Stranraer,4640,5,15,5,16,55,67,-12,50
East Fife,4640,6,14,3,19,50,64,-14,45
Airdrieon,4640,7,10,12,14,48,61,-13,42
Forfar,4640,8,10,6,20,41,67,-26,36
Albion,4640,9,8,6,22,59,87,-28,30
Queen's Park,4640,10,6,11,19,39,72,-33,29
Ayr,4641,1,24,4,8,92,43,49,76
Raith,4641,2,22,8,6,69,34,35,74
Alloa,4641,3,18,8,10,58,44,14,62
Arbroath,4641,4,17,8,11,72,51,21,59
Stranraer,4641,5,16,5,15,59,65,-6,53
Airdrieon,4641,6,11,11,14,47,58,-11,44
East Fife,4641,7,13,3,20,48,68,-20,42
Forfar,4641,8,10,5,21,38,66,-28,35
Queen's Park,4641,9,7,10,19,42,74,-32,31
Albion,4641,10,8,6,22,58,80,-22,30
Raith,4642,1,23,8,5,69,32,37,77
Ayr,4642,2,24,4,8,98,42,56,76
Arbroath,4642,3,18,8,10,72,49,23,62
Alloa,4642,4,17,8,11,56,44,12,59
Stranraer,4642,5,15,5,16,55,66,-11,50
East Fife,4642,6,14,3,19,49,64,-15,45
Airdrieon,4642,7,11,11,14,47,59,-12,44
Forfar,4642,8,10,5,21,39,66,-27,35
Albion,4642,9,8,6,22,57,86,-29,30
Queen's Park,4642,10,6,10,20,40,74,-34,28
Ayr,4643,1,24,4,8,95,43,52,76
Raith,4643,2,22,8,6,68,33,35,74
Alloa,4643,3,18,8,10,57,43,14,62
Arbroath,4643,4,17,9,10,71,49,22,60
Stranraer,4643,5,15,6,15,55,64,-9,51
East Fife,4643,6,13,4,19,47,64,-17,43
Airdrieon,4643,7,10,12,14,47,60,-13,42
Forfar,4643,8,10,6,20,40,66,-26,36
Albion,4643,9,8,6,22,58,83,-25,30
Queen's Park,4643,10,6,11,19,40,73,-33,29
Ayr,4644,1,24,4,8,93,43,50,76
Raith,4644,2,22,8,6,68,35,33,74
Arbroath,4644,3,18,8,10,71,48,23,62
Alloa,4644,4,18,8,10,59,43,16,62
Stranraer,4644,5,16,5,15,57,65,-8,53
Airdrieon,4644,6,11,11,14,46,58,-12,44
East Fife,4644,7,13,3,20,48,66,-18,42
Forfar,4644,8,10,5,21,38,65,-27,35
Albion,4644,9,8,6,22,58,81,-23,30
Queen's Park,4644,10,6,10,20,39,73,-34,28
Raith,4645,1,22,9,5,68,32,36,75
Ayr,4645,2,23,4,9,90,43,47,73
Arbroath,4645,3,18,8,10,71,48,23,62
Alloa,4645,4,17,9,10,56,43,13,60
Stranraer,4645,5,15,5,16,55,67,-12,50
East Fife,4645,6,14,3,19,50,64,-14,45
Airdrieon,4645,7,11,11,14,47,59,-12,44
Forfar,4645,8,10,5,21,39,66,-27,35
Albion,4645,9,9,6,21,58,78,-20,33
Queen's Park,4645,10,6,10,20,39,73,-34,28
Ayr,4646,1,24,4,8,93,44,49,76
Raith,4646,2,22,9,5,69,33,36,75
Alloa,4646,3,17,9,10,57,44,13,60
Arbroath,4646,4,17,8,11,71,50,21,59
Stranraer,4646,5,15,5,16,56,68,-12,50
East Fife,4646,6,14,3,19,51,65,-14,45
Airdrieon,4646,7,10,11,15,45,60,-15,41
Forfar,4646,8,11,5,20,40,64,-24,38
Queen's Park,4646,9,7,10,19,41,73,-32,31
Albion,4646,10,8,6,22,59,81,-22,30
Raith,4647,1,22,9,5,68,32,36,75
Ayr,4647,2,23,5,8,91,43,48,74
Arbroath,4647,3,18,8,10,73,50,23,62
Alloa,4647,4,17,9,10,56,43,13,60
Stranraer,4647,5,16,5,15,57,64,-7,53
Airdrieon,4647,6,11,11,14,47,59,-12,44
East Fife,4647,7,13,3,20,47,66,-19,42
Forfar,4647,8,10,5,21,39,66,-27,35
Albion,4647,9,8,7,21,58,79,-21,31
Queen's Park,4647,10,6,10,20,41,75,-34,28
Ayr,4648,1,24,4,8,92,42,50,76
Raith,4648,2,22,8,6,68,33,35,74
Alloa,4648,3,18,8,10,57,43,14,62
Arbroath,4648,4,17,9,10,71,49,22,60
Stranraer,4648,5,16,5,15,57,64,-7,53
Airdrieon,4648,6,11,11,14,52,60,-8,44
East Fife,4648,7,13,3,20,47,66,-19,42
Forfar,4648,8,10,5,21,40,71,-31,35
Albion,4648,9,8,6,22,57,80,-23,30
Queen's Park,4648,10,6,11,19,40,73,-33,29
Ayr,4649,1,23,5,8,92,44,48,74
Raith,4649,2,22,8,6,68,33,35,74
Arbroath,4649,3,18,8,10,72,49,23,62
Alloa,4649,4,18,8,10,57,43,14,62
Stranraer,4649,5,16,5,15,57,65,-8,53
East Fife,4649,6,13,3,20,48,66,-18,42
Airdrieon,4649,7,10,11,15,45,60,-15,41
Forfar,4649,8,11,5,20,40,64,-24,38
Albion,4649,9,8,7,21,59,80,-21,31
Queen's Park,4649,10,6,10,20,40,74,-34,28
Raith,4650,1,23,8,5,71,34,37,77
Ayr,4650,2,23,4,9,91,44,47,73
Arbroath,4650,3,17,8,11,71,50,21,59
Alloa,4650,4,17,8,11,58,46,12,59
Stranraer,4650,5,16,5,15,58,65,-7,53
East Fife,4650,6,13,3,20,48,67,-19,42
Airdrieon,4650,7,10,11,15,46,60,-14,41
Forfar,4650,8,11,5,20,40,65,-25,38
Albion,4650,9,9,6,21,59,79,-20,33
Queen's Park,4650,10,7,10,19,41,73,-32,31
Raith,4651,1,23,8,5,69,32,37,77
Ayr,4651,2,24,4,8,95,45,50,76
Arbroath,4651,3,17,8,11,71,50,21,59
Alloa,4651,4,17,8,11,56,44,12,59
Stranraer,4651,5,16,5,15,57,64,-7,53
East Fife,4651,6,13,3,20,47,66,-19,42
Airdrieon,4651,7,10,11,15,46,60,-14,41
Forfar,4651,8,11,5,20,40,65,-25,38
Queen's Park,4651,9,7,10,19,41,73,-32,31
Albion,4651,10,8,6,22,60,83,-23,30
Raith,4652,1,23,8,5,70,32,38,77
Ayr,4652,2,24,4,8,94,45,49,76
Arbroath,4652,3,18,8,10,74,48,26,62
Alloa,4652,4,17,8,11,56,45,11,59
Stranraer,4652,5,16,5,15,58,66,-8,53
Airdrieon,4652,6,11,11,14,46,58,-12,44
East Fife,4652,7,13,3,20,49,67,-18,42
Forfar,4652,8,10,5,21,38,65,-27,35
Albion,4652,9,8,6,22,60,82,-22,30
Queen's Park,4652,10,6,10,20,39,76,-37,28
Raith,4653,1,23,8,5,71,32,39,77
Ayr,4653,2,24,4,8,96,42,54,76
Arbroath,4653,3,17,8,11,70,51,19,59
Alloa,4653,4,17,8,11,56,46,10,59
Stranraer,4653,5,15,5,16,56,66,-10,50
East Fife,4653,6,14,3,19,49,65,-16,45
Airdrieon,4653,7,11,11,14,46,58,-12,44
Forfar,4653,8,10,5,21,38,65,-27,35
Queen's Park,4653,9,7,10,19,42,72,-30,31
Albion,4653,10,8,6,22,57,84,-27,30
Ayr,4654,1,24,4,8,93,43,50,76
Raith,4654,2,22,9,5,70,34,36,75
Arbroath,4654,3,18,8,10,72,49,23,62
Alloa,4654,4,17,9,10,58,45,13,60
Stranraer,4654,5,15,5,16,55,66,-11,50
East Fife,4654,6,14,3,19,49,64,-15,45
Airdrieon,4654,7,10,12,14,45,58,-13,42
Forfar,4654,8,10,6,20,38,64,-26,36
Albion,4654,9,8,6,22,58,81,-23,30
Queen's Park,4654,10,6,10,20,40,74,-34,28
Ayr,4655,1,24,4,8,92,42,50,76
Raith,4655,2,22,9,5,68,32,36,75
Alloa,4655,3,17,9,10,56,43,13,60
Arbroath,4655,4,17,8,11,70,52,18,59
Stranraer,4655,5,15,5,16,56,66,-10,50
East Fife,4655,6,14,3,19,49,65,-16,45
Airdrieon,4655,7,11,11,14,47,58,-11,44
Forfar,4655,8,10,5,21,38,66,-28,35
Queen's Park,4655,9,7,10,19,43,72,-29,31
Albion,4655,10,8,6,22,57,80,-23,30
Ayr,4656,1,24,4,8,100,43,57,76
Raith,4656,2,22,8,6,68,34,34,74
Alloa,4656,3,18,8,10,58,43,15,62
Arbroath,4656,4,17,8,11,71,51,20,59
Stranraer,4656,5,15,6,15,56,65,-9,51
Airdrieon,4656,6,11,11,14,47,59,-12,44
East Fife,4656,7,13,4,19,48,65,-17,43
Forfar,4656,8,10,5,21,39,66,-27,35
Queen's Park,4656,9,7,10,19,42,73,-31,31
Albion,4656,10,8,6,22,58,88,-30,30
Raith,4657,1,23,8,5,71,33,38,77
Ayr,4657,2,24,4,8,93,42,51,76
Arbroath,4657,3,17,8,11,71,50,21,59
Alloa,4657,4,17,8,11,57,46,11,59
Stranraer,4657,5,16,5,15,58,66,-8,53
Airdrieon,4657,6,11,11,14,46,58,-12,44
East Fife,4657,7,13,3,20,49,67,-18,42
Forfar,4657,8,10,5,21,38,65,-27,35
Queen's Park,4657,9,7,10,19,41,73,-32,31
Albion,4657,10,8,6,22,57,81,-24,30
Raith,4658,1,23,8,5,71,32,39,77
Ayr,4658,2,23,4,9,90,43,47,73
Arbroath,4658,3,18,8,10,73,48,25,62
Alloa,4658,4,17,8,11,56,46,10,59
Stranraer,4658,5,16,5,15,57,64,-7,53
Airdrieon,4658,6,11,11,14,48,58,-10,44
East Fife,4658,7,13,3,20,47,66,-19,42
Forfar,4658,8,10,5,21,38,67,-29,35
Albion,4658,9,9,6,21,58,78,-20,33
Queen's Park,4658,10,6,10,20,39,75,-36,28
Raith,4659,1,23,8,5,71,33,38,77
Ayr,4659,2,24,4,8,94,43,51,76
Arbroath,4659,3,18,8,10,74,48,26,62
Alloa,4659,4,17,8,11,57,46,11,59
Stranraer,4659,5,16,5,15,57,64,-7,53
Airdrieon,4659,6,11,11,14,46,58,-12,44
East Fife,4659,7,13,3,20,47,66,-19,42
Forfar,4659,8,10,5,21,38,65,-27,35
Albion,4659,9,8,6,22,58,82,-24,30
Queen's Park,4659,10,6,10,20,39,76,-37,28
Raith,4660,1,23,8,5,69,32,37,77
Ayr,4660,2,23,5,8,92,44,48,74
Arbroath,4660,3,18,8,10,72,48,24,62
Alloa,4660,4,17,8,11,56,44,12,59
Stranraer,4660,5,15,5,16,55,65,-10,50
East Fife,4660,6,14,3,19,48,64,-16,45
Airdrieon,4660,7,10,12,14,46,59,-13,42
Forfar,4660,8,10,6,20,39,65,-26,36
Albion,4660,9,8,7,21,59,80,-21,31
Queen's Park,4660,10,6,10,20,39,74,-35,28
Raith,4661,1,22,8,6,68,33,35,74
Ayr,4661,2,23,4,9,91,44,47,73
Arbroath,4661,3,18,8,10,72,49,23,62
Alloa,4661,4,18,8,10,57,43,14,62
Stranraer,4661,5,15,5,16,56,66,-10,50
East Fife,4661,6,14,3,19,49,65,-16,45
Airdrieon,4661,7,11,11,14,46,58,-12,44
Forfar,4661,8,10,5,21,38,65,-27,35
Albion,4661,9,9,6,21,59,79,-20,33
Queen's Park,4661,10,6,10,20,40,74,-34,28
Raith,4662,1,22,9,5,69,33,36,75
Ayr,4662,2,23,5,8,92,44,48,74
Alloa,4662,3,17,9,10,57,44,13,60
Arbroath,4662,4,17,8,11,70,50,20,59
Stranraer,4662,5,16,5,15,58,65,-7,53
Airdrieon,4662,6,10,12,14,47,60,-13,42
East Fife,4662,7,13,3,20,48,67,-19,42
Forfar,4662,8,10,6,20,40,66,-26,36
Albion,4662,9,8,7,21,59,80,-21,31
Queen's Park,4662,10,7,10,19,41,72,-31,31
Raith,4663,1,23,8,5,71,33,38,77
Ayr,4663,2,24,4,8,98,42,56,76
Arbroath,4663,3,17,8,11,70,51,19,59
Alloa,4663,4,17,8,11,57,46,11,59
Stranraer,4663,5,15,6,15,57,66,-9,51
East Fife,4663,6,13,4,19,49,66,-17,43
Airdrieon,4663,7,10,11,15,45,59,-14,41
Forfar,4663,8,11,5,20,39,64,-25,38
Queen's Park,4663,9,7,10,19,42,72,-30,31
Albion,4663,10,8,6,22,57,86,-29,30
Raith,4664,1,22,8,6,70,35,35,74
Ayr,4664,2,23,4,9,91,44,47,73
Alloa,4664,3,18,8,10,59,45,14,62
Arbroath,4664,4,17,8,11,70,49,21,59
Stranraer,4664,5,16,5,15,57,65,-8,53
Airdrieon,4664,6,11,11,14,48,60,-12,44
East Fife,4664,7,13,3,20,48,66,-18,42
Forfar,4664,8,10,5,21,40,67,-27,35
Albion,4664,9,9,6,21,59,79,-20,33
Queen's Park,4664,10,7,10,19,40,72,-32,31
Raith,4665,1,23,8,5,72,35,37,77
Ayr,4665,2,24,4,8,94,43,51,76
Arbroath,4665,3,18,8,10,74,49,25,62
Alloa,4665,4,17,8,11,59,47,12,59
Stranraer,4665,5,15,6,15,57,66,-9,51
East Fife,4665,6,13,4,19,49,66,-17,43
Airdrieon,4665,7,10,12,14,46,59,-13,42
Forfar,4665,8,10,6,20,39,65,-26,36
Albion,4665,9,8,6,22,58,82,-24,30
Queen's Park,4665,10,6,10,20,40,76,-36,28
Raith,4666,1,23,8,5,69,32,37,77
Ayr,4666,2,24,4,8,93,43,50,76
Arbroath,4666,3,17,9,10,71,49,22,60
Alloa,4666,4,17,8,11,56,44,12,59
Stranraer,4666,5,15,6,15,55,64,-9,51
Airdrieon,4666,6,11,11,14,46,58,-12,44
East Fife,4666,7,13,4,19,47,64,-17,43
Forfar,4666,8,10,5,21,38,65,-27,35
Albion,4666,9,8,6,22,58,81,-23,30
Queen's Park,4666,10,6,11,19,40,73,-33,29
Ayr,4667,1,24,4,8,97,43,54,76
Raith,4667,2,22,8,6,69,34,35,74
Arbroath,4667,3,18,8,10,72,49,23,62
Alloa,4667,4,18,8,10,58,44,14,62
Stranraer,4667,5,15,5,16,57,67,-10,50
East Fife,4667,6,14,3,19,50,66,-16,45
Airdrieon,4667,7,11,11,14,48,59,-11,44
Forfar,4667,8,10,5,21,39,67,-28,35
Albion,4667,9,8,6,22,58,85,-27,30
Queen's Park,4667,10,6,10,20,40,74,-34,28
Raith,4668,1,23,8,5,71,33,38,77
Ayr,4668,2,24,4,8,93,42,51,76
Arbroath,4668,3,17,9,10,73,51,22,60
Alloa,4668,4,17,8,11,57,46,11,59
Stranraer,4668,5,15,5,16,57,68,-11,50
East Fife,4668,6,14,3,19,51,66,-15,45
Airdrieon,4668,7,10,11,15,45,61,-16,41
Forfar,4668,8,11,5,20,41,64,-23,38
Albion,4668,9,8,6,22,57,81,-24,30
Queen's Park,4668,10,6,11,19,42,75,-33,29
Ayr,4669,1,24,4,8,97,43,54,76
Raith,4669,2,22,8,6,68,34,34,74
Arbroath,4669,3,18,8,10,72,49,23,62
Alloa,4669,4,18,8,10,58,43,15,62
Stranraer,4669,5,15,5,16,56,68,-12,50
East Fife,4669,6,14,3,19,51,65,-14,45
Airdrieon,4669,7,11,11,14,47,58,-11,44
Forfar,4669,8,10,5,21,38,66,-28,35
Albion,4669,9,8,6,22,58,85,-27,30
Queen's Park,4669,10,6,10,20,40,74,-34,28
Raith,4670,1,23,8,5,69,32,37,77
Ayr,4670,2,24,4,8,97,42,55,76
Arbroath,4670,3,17,8,11,71,51,20,59
Alloa,4670,4,17,8,11,56,44,12,59
Stranraer,4670,5,15,5,16,55,65,-10,50
East Fife,4670,6,14,3,19,48,64,-16,45
Airdrieon,4670,7,11,11,14,47,59,-12,44
Forfar,4670,8,10,5,21,39,66,-27,35
Queen's Park,4670,9,7,10,19,42,73,-31,31
Albion,4670,10,8,6,22,57,85,-28,30
Ayr,4671,1,24,4,8,94,45,49,76
Raith,4671,2,22,9,5,69,33,36,75
Arbroath,4671,3,17,9,10,71,49,22,60
Alloa,4671,4,17,9,10,57,44,13,60
Stranraer,4671,5,15,5,16,56,67,-11,50
East Fife,4671,6,14,3,19,50,65,-15,45
Airdrieon,4671,7,10,12,14,45,58,-13,42
Forfar,4671,8,10,6,20,38,64,-26,36
Albion,4671,9,8,6,22,60,82,-22,30
Queen's Park,4671,10,6,11,19,40,73,-33,29
Raith,4672,1,23,8,5,71,32,39,77
Ayr,4672,2,24,4,8,92,42,50,76
Arbroath,4672,3,18,8,10,72,49,23,62
Alloa,4672,4,17,8,11,56,46,10,59
Stranraer,4672,5,15,5,16,56,66,-10,50
East Fife,4672,6,14,3,19,49,65,-16,45
Airdrieon,4672,7,11,11,14,48,58,-10,44
Forfar,4672,8,10,5,21,38,67,-29,35
Albion,4672,9,8,6,22,57,80,-23,30
Queen's Park,4672,10,6,10,20,40,74,-34,28
Raith,4673,1,23,8,5,69,32,37,77
Ayr,4673,2,24,4,8,94,43,51,76
Arbroath,4673,3,18,8,10,73,49,24,62
Alloa,4673,4,17,8,11,56,44,12,59
Stranraer,4673,5,16,5,15,56,64,-8,53
East Fife,4673,6,13,3,20,47,65,-18,42
Airdrieon,4673,7,10,11,15,45,59,-14,41
Forfar,4673,8,11,5,20,39,64,-25,38
Albion,4673,9,8,6,22,58,82,-24,30
Queen's Park,4673,10,6,10,20,40,75,-35,28
Ayr,4674,1,24,4,8,97,44,53,76
Raith,4674,2,22,8,6,70,35,35,74
Alloa,4674,3,18,8,10,59,45,14,62
Arbroath,4674,4,17,9,10,70,48,22,60
Stranraer,4674,5,15,6,15,57,66,-9,51
Airdrieon,4674,6,11,11,14,51,61,-10,44
East Fife,4674,7,13,4,19,49,66,-17,43
Forfar,4674,8,10,5,21,41,70,-29,35
Albion,4674,9,8,6,22,59,85,-26,30
Queen's Park,4674,10,6,11,19,39,72,-33,29
Ayr,4675,1,24,4,8,94,43,51,76
Raith,4675,2,22,8,6,69,34,35,74
Alloa,4675,3,18,8,10,58,44,14,62
Arbroath,4675,4,17,9,10,72,50,22,60
Stranraer,4675,5,15,5,16,55,66,-11,50
East Fife,4675,6,14,3,19,49,64,-15,45
Airdrieon,4675,7,11,11,14,47,58,-11,44
Forfar,4675,8,10,5,21,38,66,-28,35
Albion,4675,9,8,6,22,58,82,-24,30
Queen's Park,4675,10,6,11,19,41,74,-33,29
Raith,4676,1,23,8,5,71,32,39,77
Ayr,4676,2,24,4,8,94,44,50,76
Arbroath,4676,3,18,8,10,72,49,23,62
Alloa,4676,4,17,8,11,56,46,10,59
Stranraer,4676,5,15,5,16,57,67,-10,50
East Fife,4676,6,14,3,19,50,66,-16,45
Airdrieon,4676,7,10,11,15,46,62,-16,41
Forfar,4676,8,11,5,20,42,65,-23,38
Albion,4676,9,8,6,22,59,82,-23,30
Queen's Park,4676,10,6,10,20,40,74,-34,28
Raith,4677,1,23,8,5,70,32,38,77
Ayr,4677,2,24,4,8,95,43,52,76
Arbroath,4677,3,17,9,10,72,50,22,60
Alloa,4677,4,17,8,11,56,45,11,59
Stranraer,4677,5,15,6,15,57,66,-9,51
East Fife,4677,6,13,4,19,49,66,-17,43
Airdrieon,4677,7,10,12,14,45,58,-13,42
Forfar,4677,8,10,6,20,38,64,-26,36
Albion,4677,9,8,6,22,58,83,-25,30
Queen's Park,4677,10,6,11,19,41,74,-33,29
Raith,4678,1,23,8,5,72,35,37,77
Ayr,4678,2,23,4,9,92,46,46,73
Arbroath,4678,3,17,9,10,71,49,22,60
Alloa,4678,4,17,8,11,59,47,12,59
Stranraer,4678,5,15,6,15,57,66,-9,51
East Fife,4678,6,13,4,19,49,66,-17,43
Airdrieon,4678,7,10,11,15,45,59,-14,41
Forfar,4678,8,11,5,20,39,64,-25,38
Albion,4678,9,9,6,21,61,80,-19,33
Queen's Park,4678,10,6,11,19,40,73,-33,29
Raith,4679,1,23,8,5,72,33,39,77
Ayr,4679,2,24,4,8,95,44,51,76
Arbroath,4679,3,18,8,10,74,50,24,62
Alloa,4679,4,17,8,11,57,47,10,59
Stranraer,4679,5,15,5,16,57,68,-11,50
East Fife,4679,6,14,3,19,51,66,-15,45
Airdrieon,4679,7,11,11,14,50,60,-10,44
Forfar,4679,8,10,5,21,40,69,-29,35
Albion,4679,9,8,6,22,59,83,-24,30
Queen's Park,4679,10,6,10,20,41,76,-35,28
Raith,4680,1,23,8,5,70,33,37,77
Ayr,4680,2,24,4,8,92,43,49,76
Arbroath,4680,3,18,8,10,74,51,23,62
Alloa,4680,4,17,8,11,57,45,12,59
Stranraer,4680,5,15,5,16,56,67,-11,50
East Fife,4680,6,14,3,19,50,65,-15,45
Airdrieon,4680,7,11,11,14,47,59,-12,44
Forfar,4680,8,10,5,21,39,66,-27,35
Albion,4680,9,8,6,22,58,80,-22,30
Queen's Park,4680,10,6,10,20,42,76,-34,28
Raith,4681,1,23,8,5,72,33,39,77
Ayr,4681,2,24,4,8,93,44,49,76
Arbroath,4681,3,17,9,10,71,49,22,60
Alloa,4681,4,17,8,11,57,47,10,59
Stranraer,4681,5,15,5,16,56,67,-11,50
East Fife,4681,6,14,3,19,50,65,-15,45
Airdrieon,4681,7,11,11,14,47,59,-12,44
Forfar,4681,8,10,5,21,39,66,-27,35
Albion,4681,9,8,6,22,59,81,-22,30
Queen's Park,4681,10,6,11,19,40,73,-33,29
Raith,4682,1,23,8,5,72,33,39,77
Ayr,4682,2,23,5,8,92,44,48,74
Arbroath,4682,3,17,9,10,72,50,22,60
Alloa,4682,4,17,8,11,57,47,10,59
Stranraer,4682,5,15,6,15,57,66,-9,51
Airdrieon,4682,6,11,11,14,49,59,-10,44
East Fife,4682,7,13,4,19,49,66,-17,43
Forfar,4682,8,10,5,21,39,68,-29,35
Albion,4682,9,8,7,21,59,80,-21,31
Queen's Park,4682,10,6,11,19,41,74,-33,29
Raith,4683,1,23,8,5,69,32,37,77
Ayr,4683,2,24,4,8,94,43,51,76
Arbroath,4683,3,17,8,11,70,49,21,59
Alloa,4683,4,17,8,11,56,44,12,59
Stranraer,4683,5,16,5,15,59,67,-8,53
Airdrieon,4683,6,10,12,14,46,59,-13,42
East Fife,4683,7,13,3,20,50,68,-18,42
Forfar,4683,8,10,6,20,39,65,-26,36
Queen's Park,4683,9,7,10,19,40,72,-32,31
Albion,4683,10,8,6,22,58,82,-24,30
Raith,4684,1,23,8,5,69,32,37,77
Ayr,4684,2,24,4,8,98,42,56,76
Arbroath,4684,3,17,8,11,71,50,21,59
Alloa,4684,4,17,8,11,56,44,12,59
Stranraer,4684,5,15,5,16,56,67,-11,50
East Fife,4684,6,14,3,19,50,65,-15,45
Airdrieon,4684,7,10,12,14,47,60,-13,42
Forfar,4684,8,10,6,20,40,66,-26,36
Queen's Park,4684,9,7,10,19,41,73,-32,31
Albion,4684,10,8,6,22,57,86,-29,30
Ayr,4685,1,24,4,8,92,43,49,76
Raith,4685,2,22,8,6,69,34,35,74
Arbroath,4685,3,18,8,10,71,48,23,62
Alloa,4685,4,18,8,10,58,44,14,62
Stranraer,4685,5,16,5,15,56,64,-8,53
Airdrieon,4685,6,11,11,14,47,59,-12,44
East Fife,4685,7,13,3,20,47,65,-18,42
Forfar,4685,8,10,5,21,39,66,-27,35
Albion,4685,9,8,6,22,58,80,-22,30
Queen's Park,4685,10,6,10,20,39,73,-34,28
Ayr,4686,1,24,4,8,93,44,49,76
Raith,4686,2,22,8,6,68,34,34,74
Alloa,4686,3,18,8,10,58,43,15,62
Arbroath,4686,4,17,8,11,71,50,21,59
Stranraer,4686,5,16,5,15,57,64,-7,53
Airdrieon,4686,6,10,12,14,47,60,-13,42
East Fife,4686,7,13,3,20,47,66,-19,42
Forfar,4686,8,10,6,20,40,66,-26,36
Queen's Park,4686,9,7,10,19,41,73,-32,31
Albion,4686,10,8,6,22,59,81,-22,30
Ayr,4687,1,24,4,8,94,45,49,76
Raith,4687,2,22,8,6,70,36,34,74
Arbroath,4687,3,18,8,10,72,48,24,62
Alloa,4687,4,18,8,10,60,45,15,62
Stranraer,4687,5,15,5,16,56,67,-11,50
East Fife,4687,6,14,3,19,50,65,-15,45
Airdrieon,4687,7,11,11,14,47,58,-11,44
Forfar,4687,8,10,5,21,38,66,-28,35
Albion,4687,9,8,6,22,60,82,-22,30
Queen's Park,4687,10,6,10,20,39,74,-35,28
Raith,4688,1,23,8,5,70,33,37,77
Ayr,4688,2,24,4,8,94,42,52,76
Arbroath,4688,3,18,8,10,72,48,24,62
Alloa,4688,4,17,8,11,57,45,12,59
Stranraer,4688,5,15,5,16,56,67,-11,50
East Fife,4688,6,14,3,19,50,65,-15,45
Airdrieon,4688,7,10,11,15,47,61,-14,41
Forfar,4688,8,11,5,20,41,66,-25,38
Albion,4688,9,8,6,22,57,82,-25,30
Queen's Park,4688,10,6,10,20,39,74,-35,28
Ayr,4689,1,24,4,8,97,42,55,76
Raith,4689,2,22,8,6,69,34,35,74
Arbroath,4689,3,18,8,10,71,48,23,62
Alloa,4689,4,18,8,10,58,44,14,62
Stranraer,4689,5,15,6,15,56,65,-9,51
Airdrieon,4689,6,11,11,14,48,58,-10,44
East Fife,4689,7,13,4,19,48,65,-17,43
Forfar,4689,8,10,5,21,38,67,-29,35
Albion,4689,9,8,6,22,57,85,-28,30
Queen's Park,4689,10,6,10,20,39,73,-34,28
Ayr,4690,1,24,4,8,92,42,50,76
Raith,4690,2,22,8,6,69,35,34,74
Arbroath,4690,3,18,8,10,75,49,26,62
Alloa,4690,4,18,8,10,59,44,15,62
Stranraer,4690,5,15,5,16,56,68,-12,50
East Fife,4690,6,14,3,19,51,65,-14,45
Airdrieon,4690,7,11,11,14,48,58,-10,44
Forfar,4690,8,10,5,21,38,67,-29,35
Albion,4690,9,8,6,22,57,80,-23,30
Queen's Park,4690,10,6,10,20,40,77,-37,28
Ayr,4691,1,24,4,8,94,42,52,76
Raith,4691,2,22,8,6,68,33,35,74
Arbroath,4691,3,18,8,10,73,49,24,62
Alloa,4691,4,18,8,10,57,43,14,62
Stranraer,4691,5,15,5,16,56,68,-12,50
East Fife,4691,6,14,3,19,51,65,-14,45
Airdrieon,4691,7,11,11,14,47,59,-12,44
Forfar,4691,8,10,5,21,39,66,-27,35
Albion,4691,9,8,6,22,57,82,-25,30
Queen's Park,4691,10,6,10,20,40,75,-35,28
Ayr,4692,1,24,4,8,95,44,51,76
Raith,4692,2,22,8,6,69,35,34,74
Arbroath,4692,3,18,8,10,72,49,23,62
Alloa,4692,4,18,8,10,59,44,15,62
Stranraer,4692,5,16,5,15,58,66,-8,53
Airdrieon,4692,6,10,12,14,46,59,-13,42
East Fife,4692,7,13,3,20,49,67,-18,42
Forfar,4692,8,10,6,20,39,65,-26,36
Albion,4692,9,8,6,22,59,83,-24,30
Queen's Park,4692,10,6,10,20,40,74,-34,28
Ayr,4693,1,24,4,8,93,43,50,76
Raith,4693,2,22,8,6,69,34,35,74
Arbroath,4693,3,18,8,10,71,48,23,62
Alloa,4693,4,18,8,10,58,44,14,62
Stranraer,4693,5,16,5,15,60,64,-4,53
Airdrieon,4693,6,10,12,14,45,58,-13,42
East Fife,4693,7,13,3,20,47,69,-22,42
Forfar,4693,8,10,6,20,38,64,-26,36
Albion,4693,9,8,6,22,58,81,-23,30
Queen's Park,4693,10,6,10,20,39,73,-34,28
Raith,4694,1,23,8,5,71,32,39,77
Ayr,4694,2,24,4,8,94,42,52,76
Arbroath,4694,3,18,8,10,72,49,23,62
Alloa,4694,4,17,8,11,56,46,10,59
Stranraer,4694,5,15,5,16,55,65,-10,50
East Fife,4694,6,14,3,19,48,64,-16,45
Airdrieon,4694,7,10,11,15,45,59,-14,41
Forfar,4694,8,11,5,20,39,64,-25,38
Albion,4694,9,8,6,22,57,82,-25,30
Queen's Park,4694,10,6,10,20,40,74,-34,28
Raith,4695,1,23,8,5,70,33,37,77
Ayr,4695,2,23,5,8,91,43,48,74
Arbroath,4695,3,17,8,11,71,51,20,59
Alloa,4695,4,17,8,11,57,45,12,59
Stranraer,4695,5,15,6,15,56,65,-9,51
Airdrieon,4695,6,11,11,14,47,59,-12,44
East Fife,4695,7,13,4,19,48,65,-17,43
Forfar,4695,8,10,5,21,39,66,-27,35
Albion,4695,9,8,7,21,58,79,-21,31
Queen's Park,4695,10,7,10,19,42,73,-31,31
Ayr,4696,1,24,4,8,94,42,52,76
Raith,4696,2,22,8,6,68,35,33,74
Arbroath,4696,3,18,8,10,73,50,23,62
Alloa,4696,4,18,8,10,59,43,16,62
Stranraer,4696,5,16,5,15,58,65,-7,53
Airdrieon,4696,6,11,11,14,49,58,-9,44
East Fife,4696,7,13,3,20,48,67,-19,42
Forfar,4696,8,10,5,21,38,68,-30,35
Albion,4696,9,8,6,22,57,82,-25,30
Queen's Park,4696,10,6,10,20,41,75,-34,28
Raith,4697,1,23,8,5,72,33,39,77
Ayr,4697,2,24,4,8,92,42,50,76
Arbroath,4697,3,17,8,11,70,49,21,59
Alloa,4697,4,17,8,11,57,47,10,59
Stranraer,4697,5,16,5,15,58,65,-7,53
Airdrieon,4697,6,10,12,14,47,60,-13,42
East Fife,4697,7,13,3,20,48,67,-19,42
Forfar,4697,8,10,6,20,40,66,-26,36
Queen's Park,4697,9,7,10,19,40,72,-32,31
Albion,4697,10,8,6,22,57,80,-23,30
Raith,4698,1,23,8,5,71,34,37,77
Ayr,4698,2,24,4,8,95,44,51,76
Arbroath,4698,3,18,8,10,72,48,24,62
Alloa,4698,4,17,8,11,58,46,12,59
Stranraer,4698,5,15,5,16,57,68,-11,50
East Fife,4698,6,14,3,19,51,66,-15,45
Airdrieon,4698,7,10,12,14,47,60,-13,42
Forfar,4698,8,10,6,20,40,66,-26,36
Albion,4698,9,8,6,22,59,83,-24,30
Queen's Park,4698,10,6,10,20,39,74,-35,28
Ayr,4699,1,24,4,8,95,42,53,76
Raith,4699,2,22,8,6,68,34,34,74
Alloa,4699,3,18,8,10,58,43,15,62
Arbroath,4699,4,17,9,10,71,49,22,60
Stranraer,4699,5,15,5,16,55,65,-10,50
East Fife,4699,6,14,3,19,48,64,-16,45
Airdrieon,4699,7,11,11,14,47,58,-11,44
Forfar,4699,8,10,5,21,38,66,-28,35
Albion,4699,9,8,6,22,57,83,-26,30
Queen's Park,4699,10,6,11,19,40,73,-33,29
Raith,4700,1,23,8,5,71,33,38,77
Ayr,4700,2,24,4,8,94,45,49,76
Arbroath,4700,3,18,8,10,72,48,24,62
Alloa,4700,4,17,8,11,57,46,11,59
Stranraer,4700,5,15,6,15,56,65,-9,51
Airdrieon,4700,6,11,11,14,47,59,-12,44
East Fife,4700,7,13,4,19,48,65,-17,43
Forfar,4700,8,10,5,21,39,66,-27,35
Albion,4700,9,8,6,22,60,82,-22,30
Queen's Park,4700,10,6,10,20,39,74,-35,28
Raith,4701,1,23,8,5,74,34,40,77
Ayr,4701,2,24,4,8,93,42,51,76
Arbroath,4701,3,17,9,10,72,50,22,60
Alloa,4701,4,17,8,11,58,49,9,59
Stranraer,4701,5,15,5,16,55,65,-10,50
East Fife,4701,6,14,3,19,48,64,-16,45
Airdrieon,4701,7,10,11,15,45,60,-15,41
Forfar,4701,8,11,5,20,40,64,-24,38
Albion,4701,9,8,6,22,57,81,-24,30
Queen's Park,4701,10,6,11,19,41,74,-33,29
Raith,4702,1,23,8,5,69,32,37,77
Ayr,4702,2,24,4,8,98,46,52,76
Arbroath,4702,3,18,8,10,71,48,23,62
Alloa,4702,4,17,8,11,56,44,12,59
Stranraer,4702,5,15,6,15,57,66,-9,51
Airdrieon,4702,6,11,11,14,47,59,-12,44
East Fife,4702,7,13,4,19,49,66,-17,43
Forfar,4702,8,10,5,21,39,66,-27,35
Albion,4702,9,8,6,22,61,86,-25,30
Queen's Park,4702,10,6,10,20,39,73,-34,28
Raith,4703,1,23,8,5,71,32,39,77
Ayr,4703,2,24,4,8,93,43,50,76
Arbroath,4703,3,18,8,10,73,48,25,62
Alloa,4703,4,17,8,11,56,46,10,59
Stranraer,4703,5,15,6,15,55,64,-9,51
East Fife,4703,6,13,4,19,47,64,-17,43
Airdrieon,4703,7,10,11,15,47,61,-14,41
Forfar,4703,8,11,5,20,41,66,-25,38
Albion,4703,9,8,6,22,58,81,-23,30
Queen's Park,4703,10,6,10,20,39,75,-36,28
Raith,4704,1,22,9,5,69,33,36,75
Ayr,4704,2,23,5,8,91,43,48,74
Arbroath,4704,3,17,9,10,71,49,22,60
Alloa,4704,4,17,9,10,57,44,13,60
Stranraer,4704,5,15,5,16,56,67,-11,50
East Fife,4704,6,14,3,19,50,65,-15,45
Airdrieon,4704,7,11,11,14,47,59,-12,44
Forfar,4704,8,10,5,21,39,66,-27,35
Albion,4704,9,8,7,21,58,79,-21,31
Queen's Park,4704,10,6,11,19,40,73,-33,29
Raith,4705,1,23,8,5,69,32,37,77
Ayr,4705,2,24,4,8,92,42,50,76
Arbroath,4705,3,18,8,10,71,48,23,62
Alloa,4705,4,17,8,11,56,44,12,59
Stranraer,4705,5,15,5,16,56,68,-12,50
East Fife,4705,6,14,3,19,51,65,-14,45
Airdrieon,4705,7,10,12,14,46,59,-13,42
Forfar,4705,8,10,6,20,39,65,-26,36
Albion,4705,9,8,6,22,57,80,-23,30
Queen's Park,4705,10,6,10,20,39,73,-34,28
Raith,4706,1,23,8,5,71,34,37,77
Ayr,4706,2,24,4,8,96,44,52,76
Arbroath,4706,3,17,9,10,70,48,22,60
Alloa,4706,4,17,8,11,58,46,12,59
Stranraer,4706,5,16,5,15,56,64,-8,53
Airdrieon,4706,6,11,11,14,48,59,-11,44
East Fife,4706,7,13,3,20,47,65,-18,42
Forfar,4706,8,10,5,21,39,67,-28,35
Albion,4706,9,8,6,22,59,84,-25,30
Queen's Park,4706,10,6,11,19,39,72,-33,29
Raith,4707,1,22,9,5,69,33,36,75
Ayr,4707,2,23,5,8,91,43,48,74
Arbroath,4707,3,18,8,10,74,48,26,62
Alloa,4707,4,17,9,10,57,44,13,60
Stranraer,4707,5,15,5,16,55,65,-10,50
East Fife,4707,6,14,3,19,48,64,-16,45
Airdrieon,4707,7,11,11,14,46,58,-12,44
Forfar,4707,8,10,5,21,38,65,-27,35
Albion,4707,9,8,7,21,58,79,-21,31
Queen's Park,4707,10,6,10,20,39,76,-37,28
Raith,4708,1,23,8,5,73,34,39,77
Ayr,4708,2,24,4,8,92,43,49,76
Arbroath,4708,3,17,9,10,72,50,22,60
Alloa,4708,4,17,8,11,58,48,10,59
Stranraer,4708,5,15,6,15,56,65,-9,51
East Fife,4708,6,13,4,19,48,65,-17,43
Airdrieon,4708,7,10,11,15,45,59,-14,41
Forfar,4708,8,11,5,20,39,64,-25,38
Albion,4708,9,8,6,22,58,80,-22,30
Queen's Park,4708,10,6,11,19,41,74,-33,29
Ayr,4709,1,24,4,8,98,42,56,76
Raith,4709,2,22,9,5,68,32,36,75
Arbroath,4709,3,18,8,10,72,49,23,62
Alloa,4709,4,17,9,10,56,43,13,60
Stranraer,4709,5,15,5,16,56,66,-10,50
East Fife,4709,6,14,3,19,49,65,-16,45
Airdrieon,4709,7,10,12,14,46,59,-13,42
Forfar,4709,8,10,6,20,39,65,-26,36
Albion,4709,9,8,6,22,57,86,-29,30
Queen's Park,4709,10,6,10,20,40,74,-34,28
Ayr,4710,1,24,4,8,95,43,52,76
Raith,4710,2,22,8,6,68,34,34,74
Arbroath,4710,3,18,8,10,73,48,25,62
Alloa,4710,4,18,8,10,58,43,15,62
Stranraer,4710,5,15,5,16,58,68,-10,50
East Fife,4710,6,14,3,19,51,67,-16,45
Airdrieon,4710,7,11,11,14,49,60,-11,44
Forfar,4710,8,10,5,21,40,68,-28,35
Albion,4710,9,8,6,22,58,83,-25,30
Queen's Park,4710,10,6,10,20,39,75,-36,28
Ayr,4711,1,24,4,8,92,42,50,76
Raith,4711,2,22,9,5,68,32,36,75
Arbroath,4711,3,18,8,10,76,50,26,62
Alloa,4711,4,17,9,10,56,43,13,60
Stranraer,4711,5,15,5,16,58,68,-10,50
East Fife,4711,6,14,3,19,51,67,-16,45
Airdrieon,4711,7,10,11,15,46,60,-14,41
Forfar,4711,8,11,5,20,40,65,-25,38
Albion,4711,9,8,6,22,57,80,-23,30
Queen's Park,4711,10,6,10,20,41,78,-37,28
Raith,4712,1,23,8,5,72,32,40,77
Ayr,4712,2,24,4,8,96,42,54,76
Arbroath,4712,3,18,8,10,72,48,24,62
Alloa,4712,4,17,8,11,56,47,9,59
Stranraer,4712,5,16,5,15,56,64,-8,53
East Fife,4712,6,13,3,20,47,65,-18,42
Airdrieon,4712,7,10,11,15,46,60,-14,41
Forfar,4712,8,11,5,20,40,65,-25,38
Albion,4712,9,8,6,22,57,84,-27,30
Queen's Park,4712,10,6,10,20,39,74,-35,28
Raith,4713,1,23,8,5,70,33,37,77
Ayr,4713,2,23,5,8,91,43,48,74
Arbroath,4713,3,17,8,11,70,49,21,59
Alloa,4713,4,17,8,11,57,45,12,59
Stranraer,4713,5,15,5,16,55,66,-11,50
East Fife,4713,6,14,3,19,49,64,-15,45
Airdrieon,4713,7,10,12,14,45,58,-13,42
Forfar,4713,8,10,6,20,38,64,-26,36
Albion,4713,9,8,7,21,58,79,-21,31
Queen's Park,4713,10,7,10,19,40,72,-32,31
Ayr,4714,1,24,4,8,93,43,50,76
Raith,4714,2,22,9,5,68,32,36,75
Arbroath,4714,3,18,8,10,74,51,23,62
Alloa,4714,4,17,9,10,56,43,13,60
Stranraer,4714,5,15,5,16,57,68,-11,50
East Fife,4714,6,14,3,19,51,66,-15,45
Airdrieon,4714,7,10,12,14,47,60,-13,42
Forfar,4714,8,10,6,20,40,66,-26,36
Albion,4714,9,8,6,22,58,81,-23,30
Queen's Park,4714,10,6,10,20,42,76,-34,28
Raith,4715,1,23,8,5,74,34,40,77
Ayr,4715,2,24,4,8,93,42,51,76
Arbroath,4715,3,18,8,10,72,48,24,62
Alloa,4715,4,17,8,11,58,49,9,59
Stranraer,4715,5,15,5,16,56,66,-10,50
East Fife,4715,6,14,3,19,49,65,-16,45
Airdrieon,4715,7,10,12,14,46,59,-13,42
Forfar,4715,8,10,6,20,39,65,-26,36
Albion,4715,9,8,6,22,57,81,-24,30
Queen's Park,4715,10,6,10,20,39,74,-35,28
Raith,4716,1,22,9,5,69,33,36,75
Ayr,4716,2,23,4,9,90,44,46,73
Arbroath,4716,3,18,8,10,73,49,24,62
Alloa,4716,4,17,9,10,57,44,13,60
Stranraer,4716,5,15,6,15,56,65,-9,51
Airdrieon,4716,6,11,11,14,48,59,-11,44
East Fife,4716,7,13,4,19,48,65,-17,43
Forfar,4716,8,10,5,21,39,67,-28,35
Albion,4716,9,9,6,21,59,78,-19,33
Queen's Park,4716,10,6,10,20,40,75,-35,28
Raith,4717,1,23,8,5,69,32,37,77
Ayr,4717,2,24,4,8,92,43,49,76
Arbroath,4717,3,18,8,10,71,48,23,62
Alloa,4717,4,17,8,11,56,44,12,59
Stranraer,4717,5,15,5,16,55,66,-11,50
East Fife,4717,6,14,3,19,49,64,-15,45
Airdrieon,4717,7,11,11,14,48,58,-10,44
Forfar,4717,8,10,5,21,38,67,-29,35
Albion,4717,9,8,6,22,58,80,-22,30
Queen's Park,4717,10,6,10,20,39,73,-34,28
Raith,4718,1,23,8,5,69,32,37,77
Ayr,4718,2,24,4,8,95,43,52,76
Arbroath,4718,3,18,8,10,71,48,23,62
Alloa,4718,4,17,8,11,56,44,12,59
Stranraer,4718,5,15,5,16,55,68,-13,50
East Fife,4718,6,14,3,19,51,64,-13,45
Airdrieon,4718,7,11,11,14,47,59,-12,44
Forfar,4718,8,10,5,21,39,66,-27,35
Albion,4718,9,8,6,22,58,83,-25,30
Queen's Park,4718,10,6,10,20,39,73,-34,28
Raith,4719,1,23,8,5,72,33,39,77
Ayr,4719,2,24,4,8,94,42,52,76
Arbroath,4719,3,18,8,10,73,48,25,62
Alloa,4719,4,17,8,11,57,47,10,59
Stranraer,4719,5,15,5,16,58,68,-10,50
East Fife,4719,6,14,3,19,51,67,-16,45
Airdrieon,4719,7,10,12,14,46,59,-13,42
Forfar,4719,8,10,6,20,39,65,-26,36
Albion,4719,9,8,6,22,57,82,-25,30
Queen's Park,4719,10,6,10,20,39,75,-36,28
Ayr,4720,1,24,4,8,94,43,51,76
Raith,4720,2,22,8,6,69,34,35,74
Alloa,4720,3,18,8,10,58,44,14,62
Arbroath,4720,4,17,8,11,70,50,20,59
Stranraer,4720,5,15,5,16,55,68,-13,50
East Fife,4720,6,14,3,19,51,64,-13,45
Airdrieon,4720,7,10,12,14,46,59,-13,42
Forfar,4720,8,10,6,20,39,65,-26,36
Queen's Park,4720,9,7,10,19,41,72,-31,31
Albion,4720,10,8,6,22,58,82,-24,30
Raith,4721,1,23,8,5,71,34,37,77
Ayr,4721,2,23,4,9,91,44,47,73
Arbroath,4721,3,17,8,11,70,49,21,59
Alloa,4721,4,17,8,11,58,46,12,59
Stranraer,4721,5,16,5,15,58,66,-8,53
Airdrieon,4721,6,10,12,14,45,58,-13,42
East Fife,4721,7,13,3,20,49,67,-18,42
Forfar,4721,8,10,6,20,38,64,-26,36
Albion,4721,9,9,6,21,59,79,-20,33
Queen's Park,4721,10,7,10,19,40,72,-32,31
Ayr,4722,1,24,4,8,92,43,49,76
Raith,4722,2,22,9,5,69,33,36,75
Alloa,4722,3,17,9,10,57,44,13,60
Arbroath,4722,4,17,8,11,70,50,20,59
Stranraer,4722,5,15,6,15,57,66,-9,51
Airdrieon,4722,6,11,11,14,47,59,-12,44
East Fife,4722,7,13,4,19,49,66,-17,43
Forfar,4722,8,10,5,21,39,66,-27,35
Queen's Park,4722,9,7,10,19,41,72,-31,31
Albion,4722,10,8,6,22,58,80,-22,30
Raith,4723,1,23,8,5,71,32,39,77
Ayr,4723,2,24,4,8,91,42,49,76
Arbroath,4723,3,18,8,10,73,50,23,62
Alloa,4723,4,17,8,11,56,46,10,59
Stranraer,4723,5,16,5,15,57,65,-8,53
Airdrieon,4723,6,10,12,14,46,59,-13,42
East Fife,4723,7,13,3,20,48,66,-18,42
Forfar,4723,8,10,6,20,39,65,-26,36
Albion,4723,9,8,6,22,57,79,-22,30
Queen's Park,4723,10,6,10,20,41,75,-34,28
Raith,4724,1,23,8,5,69,32,37,77
Ayr,4724,2,24,4,8,93,43,50,76
Arbroath,4724,3,17,8,11,70,49,21,59
Alloa,4724,4,17,8,11,56,44,12,59
Stranraer,4724,5,15,5,16,56,66,-10,50
East Fife,4724,6,14,3,19,49,65,-16,45
Airdrieon,4724,7,11,11,14,47,59,-12,44
Forfar,4724,8,10,5,21,39,66,-27,35
Queen's Park,4724,9,7,10,19,40,72,-32,31
Albion,4724,10,8,6,22,58,81,-23,30
Ayr,4725,1,24,4,8,94,43,51,76
Raith,4725,2,22,8,6,69,34,35,74
Arbroath,4725,3,18,8,10,73,49,24,62
Alloa,4725,4,18,8,10,58,44,14,62
Stranraer,4725,5,15,6,15,60,69,-9,51
East Fife,4725,6,13,4,19,52,69,-17,43
Airdrieon,4725,7,10,11,15,47,61,-14,41
Forfar,4725,8,11,5,20,41,66,-25,38
Albion,4725,9,8,6,22,58,82,-24,30
Queen's Park,4725,10,6,10,20,40,75,-35,28
Raith,4726,1,23,8,5,70,33,37,77
Ayr,4726,2,24,4,8,94,42,52,76
Arbroath,4726,3,18,8,10,73,49,24,62
Alloa,4726,4,17,8,11,57,45,12,59
Stranraer,4726,5,15,6,15,57,66,-9,51
Airdrieon,4726,6,11,11,14,47,58,-11,44
East Fife,4726,7,13,4,19,49,66,-17,43
Forfar,4726,8,10,5,21,38,66,-28,35
Albion,4726,9,8,6,22,57,82,-25,30
Queen's Park,4726,10,6,10,20,40,75,-35,28
Raith,4727,1,22,9,5,69,33,36,75
Ayr,4727,2,23,5,8,91,43,48,74
Alloa,4727,3,17,9,10,57,44,13,60
Arbroath,4727,4,17,8,11,71,50,21,59
Stranraer,4727,5,16,5,15,58,65,-7,53
Airdrieon,4727,6,11,11,14,46,58,-12,44
East Fife,4727,7,13,3,20,48,67,-19,42
Forfar,4727,8,10,5,21,38,65,-27,35
Albion,4727,9,8,7,21,58,79,-21,31
Queen's Park,4727,10,7,10,19,41,73,-32,31
Ayr,4728,1,24,4,8,97,44,53,76
Raith,4728,2,22,9,5,69,33,36,75
Alloa,4728,3,17,9,10,57,44,13,60
Arbroath,4728,4,17,8,11,71,50,21,59
Stranraer,4728,5,15,6,15,55,64,-9,51
East Fife,4728,6,13,4,19,47,64,-17,43
Airdrieon,4728,7,10,11,15,46,61,-15,41
Forfar,4728,8,11,5,20,41,65,-24,38
Queen's Park,4728,9,7,10,19,41,73,-32,31
Albion,4728,10,8,6,22,59,85,-26,30
Ayr,4729,1,24,4,8,92,43,49,76
Raith,4729,2,22,8,6,68,33,35,74
Arbroath,4729,3,18,8,10,73,49,24,62
Alloa,4729,4,18,8,10,57,43,14,62
Stranraer,4729,5,16,5,15,57,64,-7,53
Airdrieon,4729,6,11,11,14,48,59,-11,44
East Fife,4729,7,13,3,20,47,66,-19,42
Forfar,4729,8,10,5,21,39,67,-28,35
Albion,4729,9,8,6,22,58,80,-22,30
Queen's Park,4729,10,6,10,20,40,75,-35,28
Raith,4730,1,23,8,5,70,33,37,77
Ayr,4730,2,24,4,8,95,43,52,76
Arbroath,4730,3,18,8,10,72,48,24,62
Alloa,4730,4,17,8,11,57,45,12,59
Stranraer,4730,5,15,5,16,55,66,-11,50
East Fife,4730,6,14,3,19,49,64,-15,45
Airdrieon,4730,7,10,12,14,46,59,-13,42
Forfar,4730,8,10,6,20,39,65,-26,36
Albion,4730,9,8,6,22,58,83,-25,30
Queen's Park,4730,10,6,10,20,39,74,-35,28
Raith,4731,1,23,8,5,70,33,37,77
Ayr,4731,2,24,4,8,92,43,49,76
Arbroath,4731,3,17,9,10,70,48,22,60
Alloa,4731,4,17,8,11,57,45,12,59
Stranraer,4731,5,15,5,16,55,65,-10,50
East Fife,4731,6,14,3,19,48,64,-16,45
Airdrieon,4731,7,11,11,14,50,60,-10,44
Forfar,4731,8,10,5,21,40,69,-29,35
Albion,4731,9,8,6,22,58,80,-22,30
Queen's Park,4731,10,6,11,19,39,72,-33,29
Raith,4732,1,22,8,6,68,33,35,74
Ayr,4732,2,23,4,9,90,43,47,73
Arbroath,4732,3,18,8,10,72,49,23,62
Alloa,4732,4,18,8,10,57,43,14,62
Stranraer,4732,5,15,6,15,55,64,-9,51
East Fife,4732,6,13,4,19,47,64,-17,43
Airdrieon,4732,7,10,11,15,46,60,-14,41
Forfar,4732,8,11,5,20,40,65,-25,38
Albion,4732,9,9,6,21,58,78,-20,33
Queen's Park,4732,10,6,10,20,40,74,-34,28
Raith,4733,1,23,8,5,69,32,37,77
Ayr,4733,2,24,4,8,94,42,52,76
Arbroath,4733,3,18,8,10,74,49,25,62
Alloa,4733,4,17,8,11,56,44,12,59
Stranraer,4733,5,16,5,15,58,65,-7,53
East Fife,4733,6,13,3,20,48,67,-19,42
Airdrieon,4733,7,10,11,15,46,61,-15,41
Forfar,4733,8,11,5,20,41,65,-24,38
Albion,4733,9,8,6,22,57,82,-25,30
Queen's Park,4733,10,6,10,20,40,76,-36,28
Raith,4734,1,23,8,5,71,33,38,77
Ayr,4734,2,23,5,8,91,43,48,74
Arbroath,4734,3,18,8,10,74,49,25,62
Alloa,4734,4,17,8,11,57,46,11,59
Stranraer,4734,5,16,5,15,56,64,-8,53
Airdrieon,4734,6,11,11,14,47,58,-11,44
East Fife,4734,7,13,3,20,47,65,-18,42
Forfar,4734,8,10,5,21,38,66,-28,35
Albion,4734,9,8,7,21,58,79,-21,31
Queen's Park,4734,10,6,10,20,40,76,-36,28
Raith,4735,1,23,8,5,69,32,37,77
Ayr,4735,2,24,4,8,94,44,50,76
Arbroath,4735,3,17,8,11,74,53,21,59
Alloa,4735,4,17,8,11,56,44,12,59
Stranraer,4735,5,16,5,15,59,65,-6,53
Airdrieon,4735,6,11,11,14,46,58,-12,44
East Fife,4735,7,13,3,20,48,68,-20,42
Forfar,4735,8,10,5,21,38,65,-27,35
Queen's Park,4735,9,7,10,19,44,76,-32,31
Albion,4735,10,8,6,22,59,82,-23,30
Ayr,4736,1,24,4,8,93,42,51,76
Raith,4736,2,22,8,6,68,33,35,74
Alloa,4736,3,18,8,10,57,43,14,62
Arbroath,4736,4,17,9,10,71,49,22,60
Stranraer,4736,5,15,5,16,55,68,-13,50
East Fife,4736,6,14,3,19,51,64,-13,45
Airdrieon,4736,7,10,11,15,45,59,-14,41
Forfar,4736,8,11,5,20,39,64,-25,38
Albion,4736,9,8,6,22,57,81,-24,30
Queen's Park,4736,10,6,11,19,40,73,-33,29
Ayr,4737,1,24,4,8,93,42,51,76
Raith,4737,2,22,9,5,69,33,36,75
Arbroath,4737,3,17,9,10,72,50,22,60
Alloa,4737,4,17,9,10,57,44,13,60
Stranraer,4737,5,15,5,16,55,66,-11,50
East Fife,4737,6,14,3,19,49,64,-15,45
Airdrieon,4737,7,11,11,14,48,60,-12,44
Forfar,4737,8,10,5,21,40,67,-27,35
Albion,4737,9,8,6,22,57,81,-24,30
Queen's Park,4737,10,6,11,19,41,74,-33,29
Ayr,4738,1,24,4,8,92,43,49,76
Raith,4738,2,22,8,6,68,34,34,74
Alloa,4738,3,18,8,10,58,43,15,62
Arbroath,4738,4,17,8,11,73,52,21,59
Stranraer,4738,5,15,5,16,55,65,-10,50
East Fife,4738,6,14,3,19,48,64,-16,45
Airdrieon,4738,7,11,11,14,46,58,-12,44
Forfar,4738,8,10,5,21,38,65,-27,35
Queen's Park,4738,9,7,10,19,43,75,-32,31
Albion,4738,10,8,6,22,58,80,-22,30
Raith,4739,1,23,8,5,71,33,38,77
Ayr,4739,2,24,4,8,94,43,51,76
Arbroath,4739,3,17,8,11,72,51,21,59
Alloa,4739,4,17,8,11,57,46,11,59
Stranraer,4739,5,15,5,16,58,68,-10,50
East Fife,4739,6,14,3,19,51,67,-16,45
Airdrieon,4739,7,11,11,14,47,58,-11,44
Forfar,4739,8,10,5,21,38,66,-28,35
Queen's Park,4739,9,7,10,19,42,74,-32,31
Albion,4739,10,8,6,22,58,82,-24,30
Ayr,4740,1,24,4,8,92,43,49,76
Raith,4740,2,22,9,5,70,34,36,75
Alloa,4740,3,17,9,10,58,45,13,60
Arbroath,4740,4,17,8,11,71,50,21,59
Stranraer,4740,5,15,5,16,55,65,-10,50
East Fife,4740,6,14,3,19,48,64,-16,45
Airdrieon,4740,7,11,11,14,47,58,-11,44
Forfar,4740,8,10,5,21,38,66,-28,35
Queen's Park,4740,9,7,10,19,41,73,-32,31
Albion,4740,10,8,6,22,58,80,-22,30
Raith,4741,1,23,8,5,70,33,37,77
Ayr,4741,2,24,4,8,93,42,51,76
Arbroath,4741,3,18,8,10,72,49,23,62
Alloa,4741,4,17,8,11,57,45,12,59
Stranraer,4741,5,16,5,15,60,66,-6,53
Airdrieon,4741,6,10,12,14,46,59,-13,42
East Fife,4741,7,13,3,20,49,69,-20,42
Forfar,4741,8,10,6,20,39,65,-26,36
Albion,4741,9,8,6,22,57,81,-24,30
Queen's Park,4741,10,6,10,20,40,74,-34,28
Raith,4742,1,23,8,5,70,32,38,77
Ayr,4742,2,24,4,8,92,43,49,76
Arbroath,4742,3,17,9,10,71,49,22,60
Alloa,4742,4,17,8,11,56,45,11,59
Stranraer,4742,5,15,6,15,56,65,-9,51
Airdrieon,4742,6,11,11,14,48,58,-10,44
East Fife,4742,7,13,4,19,48,65,-17,43
Forfar,4742,8,10,5,21,38,67,-29,35
Albion,4742,9,8,6,22,58,80,-22,30
Queen's Park,4742,10,6,11,19,40,73,-33,29
Raith,4743,1,23,8,5,70,33,37,77
Ayr,4743,2,23,4,9,92,45,47,73
Arbroath,4743,3,18,8,10,71,48,23,62
Alloa,4743,4,17,8,11,57,45,12,59
Stranraer,4743,5,15,5,16,56,67,-11,50
East Fife,4743,6,14,3,19,50,65,-15,45
Airdrieon,4743,7,10,12,14,45,58,-13,42
Forfar,4743,8,10,6,20,38,64,-26,36
Albion,4743,9,9,6,21,60,80,-20,33
Queen's Park,4743,10,6,10,20,39,73,-34,28
Ayr,4744,1,24,4,8,93,43,50,76
Raith,4744,2,22,8,6,70,35,35,74
Alloa,4744,3,18,8,10,59,45,14,62
Arbroath,4744,4,17,8,11,70,52,18,59
Stranraer,4744,5,15,6,15,59,68,-9,51
East Fife,4744,6,13,4,19,51,68,-17,43
Airdrieon,4744,7,10,11,15,45,59,-14,41
Forfar,4744,8,11,5,20,39,64,-25,38
Queen's Park,4744,9,7,10,19,43,72,-29,31
Albion,4744,10,8,6,22,58,81,-23,30
Raith,4745,1,23,8,5,71,34,37,77
Ayr,4745,2,24,4,8,93,42,51,76
Arbroath,4745,3,17,9,10,71,49,22,60
Alloa,4745,4,17,8,11,58,46,12,59
Stranraer,4745,5,15,6,15,56,65,-9,51
East Fife,4745,6,13,4,19,48,65,-17,43
Airdrieon,4745,7,10,12,14,46,59,-13,42
Forfar,4745,8,10,6,20,39,65,-26,36
Albion,4745,9,8,6,22,57,81,-24,30
Queen's Park,4745,10,6,11,19,40,73,-33,29
Ayr,4746,1,24,4,8,92,42,50,76
Raith,4746,2,22,8,6,69,34,35,74
Arbroath,4746,3,18,8,10,73,49,24,62
Alloa,4746,4,18,8,10,58,44,14,62
Stranraer,4746,5,15,6,15,57,66,-9,51
East Fife,4746,6,13,4,19,49,66,-17,43
Airdrieon,4746,7,10,12,14,45,58,-13,42
Forfar,4746,8,10,6,20,38,64,-26,36
Albion,4746,9,8,6,22,57,80,-23,30
Queen's Park,4746,10,6,10,20,40,75,-35,28
Raith,4747,1,23,8,5,69,32,37,77
Ayr,4747,2,24,4,8,93,43,50,76
Arbroath,4747,3,17,8,11,70,49,21,59
Alloa,4747,4,17,8,11,56,44,12,59
Stranraer,4747,5,15,6,15,56,65,-9,51
Airdrieon,4747,6,11,11,14,47,59,-12,44
East Fife,4747,7,13,4,19,48,65,-17,43
Forfar,4747,8,10,5,21,39,66,-27,35
Queen's Park,4747,9,7,10,19,40,72,-32,31
Albion,4747,10,8,6,22,58,81,-23,30
Raith,4748,1,23,8,5,71,33,38,77
Ayr,4748,2,24,4,8,92,43,49,76
Arbroath,4748,3,17,9,10,71,49,22,60
Alloa,4748,4,17,8,11,57,46,11,59
Stranraer,4748,5,15,5,16,55,66,-11,50
East Fife,4748,6,14,3,19,49,64,-15,45
Airdrieon,4748,7,10,11,15,45,59,-14,41
Forfar,4748,8,11,5,20,39,64,-25,38
Albion,4748,9,8,6,22,58,80,-22,30
Queen's Park,4748,10,6,11,19,40,73,-33,29
Raith,4749,1,23,8,5,70,32,38,77
Ayr,4749,2,23,4,9,93,46,47,73
Arbroath,4749,3,17,9,10,72,50,22,60
Alloa,4749,4,17,8,11,56,45,11,59
Stranraer,4749,5,15,6,15,56,65,-9,51
East Fife,4749,6,13,4,19,48,65,-17,43
Airdrieon,4749,7,10,12,14,46,59,-13,42
Forfar,4749,8,10,6,20,39,65,-26,36
Albion,4749,9,9,6,21,61,81,-20,33
Queen's Park,4749,10,6,11,19,41,74,-33,29
Ayr,4750,1,24,4,8,95,46,49,76
Raith,4750,2,22,9,5,68,32,36,75
Alloa,4750,3,17,9,10,56,43,13,60
Arbroath,4750,4,17,8,11,70,51,19,59
Stranraer,4750,5,16,5,15,58,65,-7,53
Airdrieon,4750,6,11,11,14,49,58,-9,44
East Fife,4750,7,13,3,20,48,67,-19,42
Forfar,4750,8,10,5,21,38,68,-30,35
Queen's Park,4750,9,7,10,19,42,72,-30,31
Albion,4750,10,8,6,22,61,83,-22,30
Ayr,4751,1,24,4,8,95,43,52,76
Raith,4751,2,22,9,5,69,33,36,75
Arbroath,4751,3,18,8,10,72,49,23,62
Alloa,4751,4,17,9,10,57,44,13,60
Stranraer,4751,5,16,5,15,58,66,-8,53
Airdrieon,4751,6,10,12,14,46,59,-13,42
East Fife,4751,7,13,3,20,49,67,-18,42
Forfar,4751,8,10,6,20,39,65,-26,36
Albion,4751,9,8,6,22,58,83,-25,30
Queen's Park,4751,10,6,10,20,40,74,-34,28
Ayr,4752,1,24,4,8,93,44,49,76
Raith,4752,2,22,8,6,68,35,33,74
Arbroath,4752,3,18,8,10,74,49,25,62
Alloa,4752,4,18,8,10,59,43,16,62
Stranraer,4752,5,15,6,15,55,64,-9,51
East Fife,4752,6,13,4,19,47,64,-17,43
Airdrieon,4752,7,10,12,14,46,59,-13,42
Forfar,4752,8,10,6,20,39,65,-26,36
Albion,4752,9,8,6,22,59,81,-22,30
Queen's Park,4752,10,6,10,20,40,76,-36,28
Raith,4753,1,23,8,5,72,34,38,77
Ayr,4753,2,24,4,8,92,43,49,76
Arbroath,4753,3,17,8,11,72,52,20,59
Alloa,4753,4,17,8,11,58,47,11,59
Stranraer,4753,5,16,5,15,58,65,-7,53
Airdrieon,4753,6,11,11,14,46,58,-12,44
East Fife,4753,7,13,3,20,48,67,-19,42
Forfar,4753,8,10,5,21,38,65,-27,35
Queen's Park,4753,9,7,10,19,43,74,-31,31
Albion,4753,10,8,6,22,58,80,-22,30
Ayr,4754,1,24,4,8,92,43,49,76
Raith,4754,2,22,8,6,68,33,35,74
Alloa,4754,3,18,8,10,57,43,14,62
Arbroath,4754,4,17,9,10,72,50,22,60
Stranraer,4754,5,15,6,15,56,65,-9,51
Airdrieon,4754,6,11,11,14,46,58,-12,44
East Fife,4754,7,13,4,19,48,65,-17,43
Forfar,4754,8,10,5,21,38,65,-27,35
Albion,4754,9,8,6,22,58,80,-22,30
Queen's Park,4754,10,6,11,19,41,74,-33,29
Ayr,4755,1,24,4,8,94,44,50,76
Raith,4755,2,22,9,5,70,34,36,75
Alloa,4755,3,17,9,10,58,45,13,60
Arbroath,4755,4,17,8,11,71,53,18,59
Stranraer,4755,5,15,5,16,56,66,-10,50
East Fife,4755,6,14,3,19,49,65,-16,45
Airdrieon,4755,7,10,11,15,46,60,-14,41
Forfar,4755,8,11,5,20,40,65,-25,38
Queen's Park,4755,9,7,10,19,44,73,-29,31
Albion,4755,10,8,6,22,59,82,-23,30
Ayr,4756,1,24,4,8,93,44,49,76
Raith,4756,2,22,9,5,69,33,36,75
Alloa,4756,3,17,9,10,57,44,13,60
Arbroath,4756,4,17,8,11,71,50,21,59
Stranraer,4756,5,15,5,16,56,67,-11,50
East Fife,4756,6,14,3,19,50,65,-15,45
Airdrieon,4756,7,11,11,14,48,58,-10,44
Forfar,4756,8,10,5,21,38,67,-29,35
Queen's Park,4756,9,7,10,19,41,73,-32,31
Albion,4756,10,8,6,22,59,81,-22,30
Ayr,4757,1,24,4,8,96,44,52,76
Raith,4757,2,22,8,6,69,34,35,74
Arbroath,4757,3,18,8,10,72,48,24,62
Alloa,4757,4,18,8,10,58,44,14,62
Stranraer,4757,5,15,5,16,56,66,-10,50
East Fife,4757,6,14,3,19,49,65,-16,45
Airdrieon,4757,7,11,11,14,46,58,-12,44
Forfar,4757,8,10,5,21,38,65,-27,35
Albion,4757,9,8,6,22,59,84,-25,30
Queen's Park,4757,10,6,10,20,39,74,-35,28
Ayr,4758,1,24,4,8,95,42,53,76
Raith,4758,2,22,8,6,68,34,34,74
Alloa,4758,3,18,8,10,58,43,15,62
Arbroath,4758,4,17,8,11,70,49,21,59
Stranraer,4758,5,15,6,15,56,65,-9,51
East Fife,4758,6,13,4,19,48,65,-17,43
Airdrieon,4758,7,10,12,14,48,61,-13,42
Forfar,4758,8,10,6,20,41,67,-26,36
Queen's Park,4758,9,7,10,19,40,72,-32,31
Albion,4758,10,8,6,22,57,83,-26,30
Raith,4759,1,23,8,5,71,33,38,77
Ayr,4759,2,24,4,8,93,43,50,76
Arbroath,4759,3,17,9,10,72,50,22,60
Alloa,4759,4,17,8,11,57,46,11,59
Stranraer,4759,5,15,5,16,56,67,-11,50
East Fife,4759,6,14,3,19,50,65,-15,45
Airdrieon,4759,7,10,12,14,45,58,-13,42
Forfar,4759,8,10,6,20,38,64,-26,36
Albion,4759,9,8,6,22,58,81,-23,30
Queen's Park,4759,10,6,11,19,41,74,-33,29
Ayr,4760,1,24,4,8,96,44,52,76
Raith,4760,2,22,9,5,69,33,36,75
Arbroath,4760,3,18,8,10,73,48,25,62
Alloa,4760,4,17,9,10,57,44,13,60
Stranraer,4760,5,16,5,15,58,66,-8,53
Airdrieon,4760,6,10,12,14,46,59,-13,42
East Fife,4760,7,13,3,20,49,67,-18,42
Forfar,4760,8,10,6,20,39,65,-26,36
Albion,4760,9,8,6,22,59,84,-25,30
Queen's Park,4760,10,6,10,20,39,75,-36,28
Raith,4761,1,23,8,5,70,32,38,77
Ayr,4761,2,24,4,8,95,44,51,76
Arbroath,4761,3,18,8,10,74,48,26,62
Alloa,4761,4,17,8,11,56,45,11,59
Stranraer,4761,5,16,5,15,58,65,-7,53
East Fife,4761,6,13,3,20,48,67,-19,42
Airdrieon,4761,7,10,11,15,45,61,-16,41
Forfar,4761,8,11,5,20,41,64,-23,38
Albion,4761,9,8,6,22,59,83,-24,30
Queen's Park,4761,10,6,10,20,39,76,-37,28
Ayr,4762,1,24,4,8,93,42,51,76
Raith,4762,2,22,9,5,69,33,36,75
Arbroath,4762,3,18,8,10,72,49,23,62
Alloa,4762,4,17,9,10,57,44,13,60
Stranraer,4762,5,16,5,15,57,65,-8,53
East Fife,4762,6,13,3,20,48,66,-18,42
Airdrieon,4762,7,10,11,15,46,60,-14,41
Forfar,4762,8,11,5,20,40,65,-25,38
Albion,4762,9,8,6,22,57,81,-24,30
Queen's Park,4762,10,6,10,20,40,74,-34,28
Ayr,4763,1,24,4,8,93,44,49,76
Raith,4763,2,22,8,6,68,33,35,74
Arbroath,4763,3,18,8,10,75,49,26,62
Alloa,4763,4,18,8,10,57,43,14,62
Stranraer,4763,5,15,5,16,56,66,-10,50
East Fife,4763,6,14,3,19,49,65,-16,45
Airdrieon,4763,7,11,11,14,50,59,-9,44
Forfar,4763,8,10,5,21,39,69,-30,35
Albion,4763,9,8,6,22,59,81,-22,30
Queen's Park,4763,10,6,10,20,40,77,-37,28
Ayr,4764,1,24,4,8,93,43,50,76
Raith,4764,2,22,9,5,70,34,36,75
Arbroath,4764,3,18,8,10,73,49,24,62
Alloa,4764,4,17,9,10,58,45,13,60
Stranraer,4764,5,16,5,15,57,65,-8,53
Airdrieon,4764,6,10,12,14,47,60,-13,42
East Fife,4764,7,13,3,20,48,66,-18,42
Forfar,4764,8,10,6,20,40,66,-26,36
Albion,4764,9,8,6,22,58,81,-23,30
Queen's Park,4764,10,6,10,20,40,75,-35,28
Raith,4765,1,23,8,5,72,34,38,77
Ayr,4765,2,23,5,8,91,43,48,74
Arbroath,4765,3,18,8,10,73,50,23,62
Alloa,4765,4,17,8,11,58,47,11,59
Stranraer,4765,5,15,5,16,56,66,-10,50
East Fife,4765,6,14,3,19,49,65,-16,45
Airdrieon,4765,7,10,11,15,46,60,-14,41
Forfar,4765,8,11,5,20,40,65,-25,38
Albion,4765,9,8,7,21,58,79,-21,31
Queen's Park,4765,10,6,10,20,41,75,-34,28
Ayr,4766,1,24,4,8,93,43,50,76
Raith,4766,2,22,8,6,68,36,32,74
Arbroath,4766,3,18,8,10,73,48,25,62
Alloa,4766,4,18,8,10,60,43,17,62
Stranraer,4766,5,16,5,15,59,64,-5,53
East Fife,4766,6,13,3,20,47,68,-21,42
Airdrieon,4766,7,10,11,15,45,59,-14,41
Forfar,4766,8,11,5,20,39,64,-25,38
Albion,4766,9,8,6,22,58,81,-23,30
Queen's Park,4766,10,6,10,20,39,75,-36,28
Raith,4767,1,22,9,5,69,33,36,75
Ayr,4767,2,23,5,8,92,44,48,74
Arbroath,4767,3,17,9,10,70,48,22,60
Alloa,4767,4,17,9,10,57,44,13,60
Stranraer,4767,5,15,5,16,56,66,-10,50
East Fife,4767,6,14,3,19,49,65,-16,45
Airdrieon,4767,7,11,11,14,48,59,-11,44
Forfar,4767,8,10,5,21,39,67,-28,35
Albion,4767,9,8,7,21,59,80,-21,31
Queen's Park,4767,10,6,11,19,39,72,-33,29
Raith,4768,1,23,8,5,72,34,38,77
Ayr,4768,2,23,5,8,91,43,48,74
Arbroath,4768,3,18,8,10,73,50,23,62
Alloa,4768,4,17,8,11,58,47,11,59
Stranraer,4768,5,15,5,16,55,66,-11,50
East Fife,4768,6,14,3,19,49,64,-15,45
Airdrieon,4768,7,11,11,14,47,59,-12,44
Forfar,4768,8,10,5,21,39,66,-27,35
Albion,4768,9,8,7,21,58,79,-21,31
Queen's Park,4768,10,6,10,20,41,75,-34,28
Raith,4769,1,23,8,5,70,33,37,77
Ayr,4769,2,24,4,8,93,43,50,76
Arbroath,4769,3,17,9,10,70,48,22,60
Alloa,4769,4,17,8,11,57,45,12,59
Stranraer,4769,5,16,5,15,60,64,-4,53
Airdrieon,4769,6,11,11,14,50,58,-8,44
East Fife,4769,7,13,3,20,47,69,-22,42
Forfar,4769,8,10,5,21,38,69,-31,35
Albion,4769,9,8,6,22,58,81,-23,30
Queen's Park,4769,10,6,11,19,39,72,-33,29
Raith,4770,1,22,9,5,68,32,36,75
Ayr,4770,2,23,5,8,91,43,48,74
Arbroath,4770,3,18,8,10,74,51,23,62
Alloa,4770,4,17,9,10,56,43,13,60
Stranraer,4770,5,15,6,15,57,66,-9,51
East Fife,4770,6,13,4,19,49,66,-17,43
Airdrieon,4770,7,10,11,15,46,60,-14,41
Forfar,4770,8,11,5,20,40,65,-25,38
Albion,4770,9,8,7,21,58,79,-21,31
Queen's Park,4770,10,6,10,20,42,76,-34,28
Raith,4771,1,23,8,5,70,33,37,77
Ayr,4771,2,24,4,8,94,43,51,76
Arbroath,4771,3,18,8,10,72,48,24,62
Alloa,4771,4,17,8,11,57,45,12,59
Stranraer,4771,5,15,5,16,55,67,-12,50
East Fife,4771,6,14,3,19,50,64,-14,45
Airdrieon,4771,7,11,11,14,48,58,-10,44
Forfar,4771,8,10,5,21,38,67,-29,35
Albion,4771,9,8,6,22,58,82,-24,30
Queen's Park,4771,10,6,10,20,39,74,-35,28
Raith,4772,1,23,8,5,73,34,39,77
Ayr,4772,2,24,4,8,93,42,51,76
Arbroath,4772,3,18,8,10,73,49,24,62
Alloa,4772,4,17,8,11,58,48,10,59
Stranraer,4772,5,16,5,15,56,64,-8,53
Airdrieon,4772,6,11,11,14,48,58,-10,44
East Fife,4772,7,13,3,20,47,65,-18,42
Forfar,4772,8,10,5,21,38,67,-29,35
Albion,4772,9,8,6,22,57,81,-24,30
Queen's Park,4772,10,6,10,20,40,75,-35,28
Raith,4773,1,23,8,5,70,33,37,77
Ayr,4773,2,24,4,8,94,42,52,76
Arbroath,4773,3,18,8,10,74,50,24,62
Alloa,4773,4,17,8,11,57,45,12,59
Stranraer,4773,5,15,6,15,56,65,-9,51
East Fife,4773,6,13,4,19,48,65,-17,43
Airdrieon,4773,7,10,11,15,46,60,-14,41
Forfar,4773,8,11,5,20,40,65,-25,38
Albion,4773,9,8,6,22,57,82,-25,30
Queen's Park,4773,10,6,10,20,41,76,-35,28
Raith,4774,1,23,8,5,70,32,38,77
Ayr,4774,2,24,4,8,93,43,50,76
Arbroath,4774,3,17,8,11,70,51,19,59
Alloa,4774,4,17,8,11,56,45,11,59
Stranraer,4774,5,15,5,16,56,66,-10,50
East Fife,4774,6,14,3,19,49,65,-16,45
Airdrieon,4774,7,11,11,14,48,60,-12,44
Forfar,4774,8,10,5,21,40,67,-27,35
Queen's Park,4774,9,7,10,19,42,72,-30,31
Albion,4774,10,8,6,22,58,81,-23,30
Raith,4775,1,22,9,5,69,33,36,75
Ayr,4775,2,23,4,9,93,46,47,73
Arbroath,4775,3,18,8,10,72,49,23,62
Alloa,4775,4,17,9,10,57,44,13,60
Stranraer,4775,5,15,5,16,56,66,-10,50
East Fife,4775,6,14,3,19,49,65,-16,45
Airdrieon,4775,7,10,12,14,46,59,-13,42
Forfar,4775,8,10,6,20,39,65,-26,36
Albion,4775,9,9,6,21,61,81,-20,33
Queen's Park,4775,10,6,10,20,40,74,-34,28
Raith,4776,1,23,8,5,70,33,37,77
Ayr,4776,2,24,4,8,96,43,53,76
Arbroath,4776,3,17,8,11,71,50,21,59
Alloa,4776,4,17,8,11,57,45,12,59
Stranraer,4776,5,16,5,15,57,65,-8,53
Airdrieon,4776,6,11,11,14,48,60,-12,44
East Fife,4776,7,13,3,20,48,66,-18,42
Forfar,4776,8,10,5,21,40,67,-27,35
Queen's Park,4776,9,7,10,19,41,73,-32,31
Albion,4776,10,8,6,22,58,84,-26,30
Raith,4777,1,23,8,5,71,32,39,77
Ayr,4777,2,23,5,8,93,45,48,74
Arbroath,4777,3,17,9,10,72,50,22,60
Alloa,4777,4,17,8,11,56,46,10,59
Stranraer,4777,5,16,5,15,57,65,-8,53
Airdrieon,4777,6,11,11,14,47,59,-12,44
East Fife,4777,7,13,3,20,48,66,-18,42
Forfar,4777,8,10,5,21,39,66,-27,35
Albion,4777,9,8,7,21,60,81,-21,31
Queen's Park,4777,10,6,11,19,41,74,-33,29
Raith,4778,1,23,8,5,70,33,37,77
Ayr,4778,2,24,4,8,95,44,51,76
Arbroath,4778,3,18,8,10,72,49,23,62
Alloa,4778,4,17,8,11,57,45,12,59
Stranraer,4778,5,15,6,15,57,66,-9,51
Airdrieon,4778,6,11,11,14,46,58,-12,44
East Fife,4778,7,13,4,19,49,66,-17,43
Forfar,4778,8,10,5,21,38,65,-27,35
Albion,4778,9,8,6,22,59,83,-24,30
Queen's Park,4778,10,6,10,20,40,74,-34,28
Raith,4779,1,23,8,5,73,34,39,77
Ayr,4779,2,24,4,8,92,43,49,76
Arbroath,4779,3,17,8,11,72,51,21,59
Alloa,4779,4,17,8,11,58,48,10,59
Stranraer,4779,5,15,5,16,56,66,-10,50
East Fife,4779,6,14,3,19,49,65,-16,45
Airdrieon,4779,7,10,12,14,45,58,-13,42
Forfar,4779,8,10,6,20,38,64,-26,36
Queen's Park,4779,9,7,10,19,42,74,-32,31
Albion,4779,10,8,6,22,58,80,-22,30
Ayr,4780,1,24,4,8,93,43,50,76
Raith,4780,2,22,9,5,69,33,36,75
Alloa,4780,3,17,9,10,57,44,13,60
Arbroath,4780,4,17,8,11,71,50,21,59
Stranraer,4780,5,15,5,16,58,68,-10,50
East Fife,4780,6,14,3,19,51,67,-16,45
Airdrieon,4780,7,11,11,14,47,59,-12,44
Forfar,4780,8,10,5,21,39,66,-27,35
Queen's Park,4780,9,7,10,19,41,73,-32,31
Albion,4780,10,8,6,22,58,81,-23,30
Ayr,4781,1,24,4,8,93,42,51,76
Raith,4781,2,22,9,5,69,33,36,75
Arbroath,4781,3,17,9,10,73,51,22,60
Alloa,4781,4,17,9,10,57,44,13,60
Stranraer,4781,5,15,5,16,55,66,-11,50
East Fife,4781,6,14,3,19,49,64,-15,45
Airdrieon,4781,7,11,11,14,46,58,-12,44
Forfar,4781,8,10,5,21,38,65,-27,35
Albion,4781,9,8,6,22,57,81,-24,30
Queen's Park,4781,10,6,11,19,42,75,-33,29
Raith,4782,1,23,8,5,69,32,37,77
Ayr,4782,2,24,4,8,92,42,50,76
Arbroath,4782,3,17,8,11,71,50,21,59
Alloa,4782,4,17,8,11,56,44,12,59
Stranraer,4782,5,16,5,15,58,66,-8,53
Airdrieon,4782,6,11,11,14,48,59,-11,44
East Fife,4782,7,13,3,20,49,67,-18,42
Forfar,4782,8,10,5,21,39,67,-28,35
Queen's Park,4782,9,7,10,19,41,73,-32,31
Albion,4782,10,8,6,22,57,80,-23,30
Ayr,4783,1,24,4,8,94,44,50,76
Raith,4783,2,22,8,6,68,35,33,74
Arbroath,4783,3,18,8,10,75,48,27,62
Alloa,4783,4,18,8,10,59,43,16,62
Stranraer,4783,5,16,5,15,57,64,-7,53
Airdrieon,4783,6,11,11,14,47,58,-11,44
East Fife,4783,7,13,3,20,47,66,-19,42
Forfar,4783,8,10,5,21,38,66,-28,35
Albion,4783,9,8,6,22,59,82,-23,30
Queen's Park,4783,10,6,10,20,39,77,-38,28
Ayr,4784,1,24,4,8,92,43,49,76
Raith,4784,2,22,9,5,68,32,36,75
Alloa,4784,3,17,9,10,56,43,13,60
Arbroath,4784,4,17,8,11,71,51,20,59
Stranraer,4784,5,15,5,16,56,66,-10,50
East Fife,4784,6,14,3,19,49,65,-16,45
Airdrieon,4784,7,11,11,14,48,60,-12,44
Forfar,4784,8,10,5,21,40,67,-27,35
Queen's Park,4784,9,7,10,19,42,73,-31,31
Albion,4784,10,8,6,22,58,80,-22,30
Raith,4785,1,23,8,5,69,32,37,77
Ayr,4785,2,24,4,8,93,43,50,76
Arbroath,4785,3,18,8,10,73,49,24,62
Alloa,4785,4,17,8,11,56,44,12,59
Stranraer,4785,5,15,5,16,56,66,-10,50
East Fife,4785,6,14,3,19,49,65,-16,45
Airdrieon,4785,7,10,12,14,46,59,-13,42
Forfar,4785,8,10,6,20,39,65,-26,36
Albion,4785,9,8,6,22,58,81,-23,30
Queen's Park,4785,10,6,10,20,40,75,-35,28
Raith,4786,1,23,8,5,70,33,37,77
Ayr,4786,2,24,4,8,93,44,49,76
Arbroath,4786,3,18,8,10,72,49,23,62
Alloa,4786,4,17,8,11,57,45,12,59
Stranraer,4786,5,16,5,15,56,64,-8,53
Airdrieon,4786,6,11,11,14,47,58,-11,44
East Fife,4786,7,13,3,20,47,65,-18,42
Forfar,4786,8,10,5,21,38,66,-28,35
Albion,4786,9,8,6,22,59,81,-22,30
Queen's Park,4786,10,6,10,20,40,74,-34,28
Raith,4787,1,23,8,5,72,33,39,77
Ayr,4787,2,23,4,9,91,44,47,73
Arbroath,4787,3,18,8,10,72,49,23,62
Alloa,4787,4,17,8,11,57,47,10,59
Stranraer,4787,5,15,6,15,57,66,-9,51
East Fife,4787,6,13,4,19,49,66,-17,43
Airdrieon,4787,7,10,12,14,47,60,-13,42
Forfar,4787,8,10,6,20,40,66,-26,36
Albion,4787,9,9,6,21,59,79,-20,33
Queen's Park,4787,10,6,10,20,40,74,-34,28
Ayr,4788,1,24,4,8,92,42,50,76
Raith,4788,2,22,8,6,69,34,35,74
Arbroath,4788,3,18,8,10,72,48,24,62
Alloa,4788,4,18,8,10,58,44,14,62
Stranraer,4788,5,16,5,15,56,64,-8,53
Airdrieon,4788,6,11,11,14,46,58,-12,44
East Fife,4788,7,13,3,20,47,65,-18,42
Forfar,4788,8,10,5,21,38,65,-27,35
Albion,4788,9,8,6,22,57,80,-23,30
Queen's Park,4788,10,6,10,20,39,74,-35,28
Raith,4789,1,22,8,6,69,35,34,74
Ayr,4789,2,23,4,9,91,44,47,73
Alloa,4789,3,18,8,10,59,44,15,62
Arbroath,4789,4,17,8,11,71,51,20,59
Stranraer,4789,5,15,5,16,57,68,-11,50
East Fife,4789,6,14,3,19,51,66,-15,45
Airdrieon,4789,7,10,12,14,46,59,-13,42
Forfar,4789,8,10,6,20,39,65,-26,36
Albion,4789,9,9,6,21,59,79,-20,33
Queen's Park,4789,10,7,10,19,42,73,-31,31
Raith,4790,1,23,8,5,69,32,37,77
Ayr,4790,2,24,4,8,92,43,49,76
Arbroath,4790,3,18,8,10,72,48,24,62
Alloa,4790,4,17,8,11,56,44,12,59
Stranraer,4790,5,15,5,16,57,68,-11,50
East Fife,4790,6,14,3,19,51,66,-15,45
Airdrieon,4790,7,10,12,14,46,59,-13,42
Forfar,4790,8,10,6,20,39,65,-26,36
Albion,4790,9,8,6,22,58,80,-22,30
Queen's Park,4790,10,6,10,20,39,74,-35,28
Raith,4791,1,23,8,5,70,33,37,77
Ayr,4791,2,24,4,8,98,45,53,76
Arbroath,4791,3,18,8,10,74,50,24,62
Alloa,4791,4,17,8,11,57,45,12,59
Stranraer,4791,5,16,5,15,58,65,-7,53
Airdrieon,4791,6,11,11,14,48,59,-11,44
East Fife,4791,7,13,3,20,48,67,-19,42
Forfar,4791,8,10,5,21,39,67,-28,35
Albion,4791,9,8,6,22,60,86,-26,30
Queen's Park,4791,10,6,10,20,41,76,-35,28
Raith,4792,1,23,8,5,71,33,38,77
Ayr,4792,2,24,4,8,96,42,54,76
Arbroath,4792,3,17,8,11,71,50,21,59
Alloa,4792,4,17,8,11,57,46,11,59
Stranraer,4792,5,15,5,16,55,66,-11,50
East Fife,4792,6,14,3,19,49,64,-15,45
Airdrieon,4792,7,10,11,15,45,59,-14,41
Forfar,4792,8,11,5,20,39,64,-25,38
Queen's Park,4792,9,7,10,19,41,73,-32,31
Albion,4792,10,8,6,22,57,84,-27,30
Raith,4793,1,22,9,5,68,32,36,75
Ayr,4793,2,23,4,9,90,43,47,73
Alloa,4793,3,17,9,10,56,43,13,60
Arbroath,4793,4,17,8,11,70,52,18,59
Stranraer,4793,5,15,6,15,56,65,-9,51
Airdrieon,4793,6,11,11,14,46,58,-12,44
East Fife,4793,7,13,4,19,48,65,-17,43
Forfar,4793,8,10,5,21,38,65,-27,35
Albion,4793,9,9,6,21,58,78,-20,33
Queen's Park,4793,10,7,10,19,43,72,-29,31
Ayr,4794,1,24,4,8,97,45,52,76
Raith,4794,2,22,8,6,68,34,34,74
Alloa,4794,3,18,8,10,58,43,15,62
Arbroath,4794,4,17,8,11,72,51,21,59
Stranraer,4794,5,15,6,15,58,67,-9,51
Airdrieon,4794,6,11,11,14,48,58,-10,44
East Fife,4794,7,13,4,19,50,67,-17,43
Forfar,4794,8,10,5,21,38,67,-29,35
Queen's Park,4794,9,7,10,19,42,74,-32,31
Albion,4794,10,8,6,22,60,85,-25,30
Ayr,4795,1,24,4,8,93,43,50,76
Raith,4795,2,22,8,6,68,33,35,74
Arbroath,4795,3,18,8,10,72,48,24,62
Alloa,4795,4,18,8,10,57,43,14,62
Stranraer,4795,5,16,5,15,57,64,-7,53
Airdrieon,4795,6,11,11,14,53,58,-5,44
East Fife,4795,7,13,3,20,47,66,-19,42
Forfar,4795,8,10,5,21,38,72,-34,35
Albion,4795,9,8,6,22,58,81,-23,30
Queen's Park,4795,10,6,10,20,39,74,-35,28
Ayr,4796,1,24,4,8,92,43,49,76
Raith,4796,2,22,8,6,68,38,30,74
Arbroath,4796,3,18,8,10,74,50,24,62
Alloa,4796,4,18,8,10,62,43,19,62
Stranraer,4796,5,15,6,15,55,64,-9,51
East Fife,4796,6,13,4,19,47,64,-17,43
Airdrieon,4796,7,10,12,14,46,59,-13,42
Forfar,4796,8,10,6,20,39,65,-26,36
Albion,4796,9,8,6,22,58,80,-22,30
Queen's Park,4796,10,6,10,20,41,76,-35,28
Raith,4797,1,23,8,5,70,32,38,77
Ayr,4797,2,23,4,9,93,46,47,73
Arbroath,4797,3,17,9,10,72,50,22,60
Alloa,4797,4,17,8,11,56,45,11,59
Stranraer,4797,5,15,6,15,57,66,-9,51
Airdrieon,4797,6,11,11,14,48,58,-10,44
East Fife,4797,7,13,4,19,49,66,-17,43
Forfar,4797,8,10,5,21,38,67,-29,35
Albion,4797,9,9,6,21,61,81,-20,33
Queen's Park,4797,10,6,11,19,41,74,-33,29
Raith,4798,1,23,8,5,69,32,37,77
Ayr,4798,2,24,4,8,97,42,55,76
Arbroath,4798,3,18,8,10,74,48,26,62
Alloa,4798,4,17,8,11,56,44,12,59
Stranraer,4798,5,15,5,16,56,66,-10,50
East Fife,4798,6,14,3,19,49,65,-16,45
Airdrieon,4798,7,11,11,14,48,58,-10,44
Forfar,4798,8,10,5,21,38,67,-29,35
Albion,4798,9,8,6,22,57,85,-28,30
Queen's Park,4798,10,6,10,20,39,76,-37,28
Ayr,4799,1,23,5,8,93,45,48,74
Raith,4799,2,22,8,6,68,35,33,74
Arbroath,4799,3,18,8,10,74,50,24,62
Alloa,4799,4,18,8,10,59,43,16,62
Stranraer,4799,5,16,5,15,57,65,-8,53
Airdrieon,4799,6,11,11,14,46,58,-12,44
East Fife,4799,7,13,3,20,48,66,-18,42
Forfar,4799,8,10,5,21,38,65,-27,35
Albion,4799,9,8,7,21,60,81,-21,31
Queen's Park,4799,10,6,10,20,41,76,-35,28
Raith,4800,1,23,8,5,72,34,38,77
Ayr,4800,2,24,4,8,93,42,51,76
Arbroath,4800,3,17,9,10,72,50,22,60
Alloa,4800,4,17,8,11,58,47,11,59
Stranraer,4800,5,15,5,16,56,67,-11,50
East Fife,4800,6,14,3,19,50,65,-15,45
Airdrieon,4800,7,11,11,14,47,58,-11,44
Forfar,4800,8,10,5,21,38,66,-28,35
Albion,4800,9,8,6,22,57,81,-24,30
Queen's Park,4800,10,6,11,19,41,74,-33,29
Ayr,4801,1,24,4,8,93,42,51,76
Raith,4801,2,22,9,5,69,33,36,75
Arbroath,4801,3,18,8,10,73,50,23,62
Alloa,4801,4,17,9,10,57,44,13,60
Stranraer,4801,5,16,5,15,57,65,-8,53
Airdrieon,4801,6,10,12,14,46,59,-13,42
East Fife,4801,7,13,3,20,48,66,-18,42
Forfar,4801,8,10,6,20,39,65,-26,36
Albion,4801,9,8,6,22,57,81,-24,30
Queen's Park,4801,10,6,10,20,41,75,-34,28
Raith,4802,1,23,8,5,72,32,40,77
Ayr,4802,2,24,4,8,95,46,49,76
Arbroath,4802,3,18,8,10,73,48,25,62
Alloa,4802,4,17,8,11,56,47,9,59
Stranraer,4802,5,15,6,15,56,65,-9,51
Airdrieon,4802,6,11,11,14,48,59,-11,44
East Fife,4802,7,13,4,19,48,65,-17,43
Forfar,4802,8,10,5,21,39,67,-28,35
Albion,4802,9,8,6,22,61,83,-22,30
Queen's Park,4802,10,6,10,20,39,75,-36,28
Raith,4803,1,23,8,5,69,32,37,77
Ayr,4803,2,24,4,8,94,44,50,76
Arbroath,4803,3,17,9,10,74,52,22,60
Alloa,4803,4,17,8,11,56,44,12,59
Stranraer,4803,5,15,6,15,56,65,-9,51
East Fife,4803,6,13,4,19,48,65,-17,43
Airdrieon,4803,7,10,12,14,46,59,-13,42
Forfar,4803,8,10,6,20,39,65,-26,36
Albion,4803,9,8,6,22,59,82,-23,30
Queen's Park,4803,10,6,11,19,43,76,-33,29
Raith,4804,1,23,8,5,71,33,38,77
Ayr,4804,2,24,4,8,94,42,52,76
Arbroath,4804,3,17,8,11,70,50,20,59
Alloa,4804,4,17,8,11,57,46,11,59
Stranraer,4804,5,15,5,16,56,68,-12,50
East Fife,4804,6,14,3,19,51,65,-14,45
Airdrieon,4804,7,10,12,14,46,59,-13,42
Forfar,4804,8,10,6,20,39,65,-26,36
Queen's Park,4804,9,7,10,19,41,72,-31,31
Albion,4804,10,8,6,22,57,82,-25,30
Ayr,4805,1,24,4,8,96,42,54,76
Raith,4805,2,22,9,5,69,33,36,75
Alloa,4805,3,17,9,10,57,44,13,60
Arbroath,4805,4,17,8,11,71,50,21,59
Stranraer,4805,5,15,6,15,57,66,-9,51
Airdrieon,4805,6,11,11,14,48,59,-11,44
East Fife,4805,7,13,4,19,49,66,-17,43
Forfar,4805,8,10,5,21,39,67,-28,35
Queen's Park,4805,9,7,10,19,41,73,-32,31
Albion,4805,10,8,6,22,57,84,-27,30
Raith,4806,1,23,8,5,70,33,37,77
Ayr,4806,2,24,4,8,93,44,49,76
Arbroath,4806,3,18,8,10,72,48,24,62
Alloa,4806,4,17,8,11,57,45,12,59
Stranraer,4806,5,16,5,15,58,66,-8,53
Airdrieon,4806,6,10,12,14,46,59,-13,42
East Fife,4806,7,13,3,20,49,67,-18,42
Forfar,4806,8,10,6,20,39,65,-26,36
Albion,4806,9,8,6,22,59,81,-22,30
Queen's Park,4806,10,6,10,20,39,74,-35,28
Raith,4807,1,23,8,5,70,32,38,77
Ayr,4807,2,24,4,8,93,42,51,76
Arbroath,4807,3,18,8,10,72,49,23,62
Alloa,4807,4,17,8,11,56,45,11,59
Stranraer,4807,5,16,5,15,58,65,-7,53
East Fife,4807,6,13,3,20,48,67,-19,42
Airdrieon,4807,7,10,11,15,45,60,-15,41
Forfar,4807,8,11,5,20,40,64,-24,38
Albion,4807,9,8,6,22,57,81,-24,30
Queen's Park,4807,10,6,10,20,40,74,-34,28
Raith,4808,1,23,8,5,69,32,37,77
Ayr,4808,2,23,5,8,92,44,48,74
Arbroath,4808,3,18,8,10,76,50,26,62
Alloa,4808,4,17,8,11,56,44,12,59
Stranraer,4808,5,15,6,15,56,65,-9,51
East Fife,4808,6,13,4,19,48,65,-17,43
Airdrieon,4808,7,10,12,14,47,60,-13,42
Forfar,4808,8,10,6,20,40,66,-26,36
Albion,4808,9,8,7,21,59,80,-21,31
Queen's Park,4808,10,6,10,20,41,78,-37,28
Ayr,4809,1,24,4,8,92,43,49,76
Raith,4809,2,22,9,5,70,34,36,75
Arbroath,4809,3,18,8,10,72,49,23,62
Alloa,4809,4,17,9,10,58,45,13,60
Stranraer,4809,5,16,5,15,58,64,-6,53
Airdrieon,4809,6,10,12,14,46,59,-13,42
East Fife,4809,7,13,3,20,47,67,-20,42
Forfar,4809,8,10,6,20,39,65,-26,36
Albion,4809,9,8,6,22,58,80,-22,30
Queen's Park,4809,10,6,10,20,40,74,-34,28
Raith,4810,1,23,8,5,70,32,38,77
Ayr,4810,2,24,4,8,93,43,50,76
Arbroath,4810,3,17,8,11,70,51,19,59
Alloa,4810,4,17,8,11,56,45,11,59
Stranraer,4810,5,15,5,16,59,69,-10,50
East Fife,4810,6,14,3,19,52,68,-16,45
Airdrieon,4810,7,10,12,14,46,59,-13,42
Forfar,4810,8,10,6,20,39,65,-26,36
Queen's Park,4810,9,7,10,19,42,72,-30,31
Albion,4810,10,8,6,22,58,81,-23,30
Ayr,4811,1,24,4,8,94,43,51,76
Raith,4811,2,22,9,5,69,33,36,75
Arbroath,4811,3,18,8,10,74,49,25,62
Alloa,4811,4,17,9,10,57,44,13,60
Stranraer,4811,5,15,5,16,55,65,-10,50
East Fife,4811,6,14,3,19,48,64,-16,45
Airdrieon,4811,7,10,11,15,45,59,-14,41
Forfar,4811,8,11,5,20,39,64,-25,38
Albion,4811,9,8,6,22,58,82,-24,30
Queen's Park,4811,10,6,10,20,40,76,-36,28
Raith,4812,1,23,8,5,70,32,38,77
Ayr,4812,2,23,4,9,90,45,45,73
Arbroath,4812,3,18,8,10,73,49,24,62
Alloa,4812,4,17,8,11,56,45,11,59
Stranraer,4812,5,16,5,15,59,66,-7,53
Airdrieon,4812,6,11,11,14,46,58,-12,44
East Fife,4812,7,13,3,20,49,68,-19,42
Forfar,4812,8,10,5,21,38,65,-27,35
Albion,4812,9,9,6,21,60,78,-18,33
Queen's Park,4812,10,6,10,20,40,75,-35,28
Ayr,4813,1,24,4,8,94,43,51,76
Raith,4813,2,22,8,6,69,35,34,74
Arbroath,4813,3,18,8,10,72,48,24,62
Alloa,4813,4,18,8,10,59,44,15,62
Stranraer,4813,5,15,5,16,55,65,-10,50
East Fife,4813,6,14,3,19,48,64,-16,45
Airdrieon,4813,7,11,11,14,48,58,-10,44
Forfar,4813,8,10,5,21,38,67,-29,35
Albion,4813,9,8,6,22,58,82,-24,30
Queen's Park,4813,10,6,10,20,39,74,-35,28
Raith,4814,1,23,8,5,69,32,37,77
Ayr,4814,2,24,4,8,94,42,52,76
Arbroath,4814,3,17,8,11,71,51,20,59
Alloa,4814,4,17,8,11,56,44,12,59
Stranraer,4814,5,15,6,15,56,65,-9,51
Airdrieon,4814,6,11,11,14,48,58,-10,44
East Fife,4814,7,13,4,19,48,65,-17,43
Forfar,4814,8,10,5,21,38,67,-29,35
Queen's Park,4814,9,7,10,19,42,73,-31,31
Albion,4814,10,8,6,22,57,82,-25,30
Raith,4815,1,23,8,5,70,32,38,77
Ayr,4815,2,24,4,8,94,45,49,76
Arbroath,4815,3,18,8,10,72,49,23,62
Alloa,4815,4,17,8,11,56,45,11,59
Stranraer,4815,5,15,6,15,55,64,-9,51
East Fife,4815,6,13,4,19,47,64,-17,43
Airdrieon,4815,7,10,11,15,45,59,-14,41
Forfar,4815,8,11,5,20,39,64,-25,38
Albion,4815,9,8,6,22,60,82,-22,30
Queen's Park,4815,10,6,10,20,40,74,-34,28
Ayr,4816,1,24,4,8,95,45,50,76
Raith,4816,2,22,9,5,69,33,36,75
Alloa,4816,3,17,9,10,57,44,13,60
Arbroath,4816,4,17,8,11,70,49,21,59
Stranraer,4816,5,15,5,16,56,67,-11,50
East Fife,4816,6,14,3,19,50,65,-15,45
Airdrieon,4816,7,10,11,15,46,60,-14,41
Forfar,4816,8,11,5,20,40,65,-25,38
Queen's Park,4816,9,7,10,19,40,72,-32,31
Albion,4816,10,8,6,22,60,83,-23,30
Ayr,4817,1,24,4,8,95,42,53,76
Raith,4817,2,22,8,6,69,36,33,74
Arbroath,4817,3,18,8,10,72,48,24,62
Alloa,4817,4,18,8,10,60,44,16,62
Stranraer,4817,5,15,5,16,55,66,-11,50
East Fife,4817,6,14,3,19,49,64,-15,45
Airdrieon,4817,7,11,11,14,46,58,-12,44
Forfar,4817,8,10,5,21,38,65,-27,35
Albion,4817,9,8,6,22,57,83,-26,30
Queen's Park,4817,10,6,10,20,39,74,-35,28
Raith,4818,1,23,8,5,69,32,37,77
Ayr,4818,2,24,4,8,92,42,50,76
Arbroath,4818,3,18,8,10,72,49,23,62
Alloa,4818,4,17,8,11,56,44,12,59
Stranraer,4818,5,16,5,15,58,66,-8,53
Airdrieon,4818,6,11,11,14,46,58,-12,44
East Fife,4818,7,13,3,20,49,67,-18,42
Forfar,4818,8,10,5,21,38,65,-27,35
Albion,4818,9,8,6,22,57,80,-23,30
Queen's Park,4818,10,6,10,20,40,74,-34,28
Raith,4819,1,23,8,5,70,33,37,77
Ayr,4819,2,24,4,8,93,42,51,76
Arbroath,4819,3,18,8,10,71,48,23,62
Alloa,4819,4,17,8,11,57,45,12,59
Stranraer,4819,5,15,5,16,55,67,-12,50
East Fife,4819,6,14,3,19,50,64,-14,45
Airdrieon,4819,7,11,11,14,46,58,-12,44
Forfar,4819,8,10,5,21,38,65,-27,35
Albion,4819,9,8,6,22,57,81,-24,30
Queen's Park,4819,10,6,10,20,39,73,-34,28
Raith,4820,1,22,9,5,69,33,36,75
Ayr,4820,2,23,5,8,91,43,48,74
Alloa,4820,3,17,9,10,57,44,13,60
Arbroath,4820,4,17,8,11,71,50,21,59
Stranraer,4820,5,15,6,15,57,66,-9,51
Airdrieon,4820,6,11,11,14,46,58,-12,44
East Fife,4820,7,13,4,19,49,66,-17,43
Forfar,4820,8,10,5,21,38,65,-27,35
Albion,4820,9,8,7,21,58,79,-21,31
Queen's Park,4820,10,7,10,19,41,73,-32,31
Raith,4821,1,23,8,5,70,32,38,77
Ayr,4821,2,24,4,8,93,44,49,76
Arbroath,4821,3,18,8,10,72,49,23,62
Alloa,4821,4,17,8,11,56,45,11,59
Stranraer,4821,5,16,5,15,57,65,-8,53
Airdrieon,4821,6,11,11,14,46,58,-12,44
East Fife,4821,7,13,3,20,48,66,-18,42
Forfar,4821,8,10,5,21,38,65,-27,35
Albion,4821,9,8,6,22,59,81,-22,30
Queen's Park,4821,10,6,10,20,40,74,-34,28
Raith,4822,1,22,9,5,69,33,36,75
Ayr,4822,2,23,4,9,90,43,47,73
Arbroath,4822,3,18,8,10,74,50,24,62
Alloa,4822,4,17,9,10,57,44,13,60
Stranraer,4822,5,15,6,15,57,66,-9,51
East Fife,4822,6,13,4,19,49,66,-17,43
Airdrieon,4822,7,10,12,14,48,61,-13,42
Forfar,4822,8,10,6,20,41,67,-26,36
Albion,4822,9,9,6,21,58,78,-20,33
Queen's Park,4822,10,6,10,20,41,76,-35,28
Raith,4823,1,23,8,5,73,33,40,77
Ayr,4823,2,23,4,9,92,45,47,73
Arbroath,4823,3,17,8,11,70,49,21,59
Alloa,4823,4,17,8,11,57,48,9,59
Stranraer,4823,5,15,6,15,56,65,-9,51
East Fife,4823,6,13,4,19,48,65,-17,43
Airdrieon,4823,7,10,12,14,45,58,-13,42
Forfar,4823,8,10,6,20,38,64,-26,36
Albion,4823,9,9,6,21,60,80,-20,33
Queen's Park,4823,10,7,10,19,40,72,-32,31
Ayr,4824,1,24,4,8,92,42,50,76
Raith,4824,2,22,8,6,68,35,33,74
Arbroath,4824,3,18,8,10,72,48,24,62
Alloa,4824,4,18,8,10,59,43,16,62
Stranraer,4824,5,16,5,15,56,64,-8,53
Airdrieon,4824,6,11,11,14,46,58,-12,44
East Fife,4824,7,13,3,20,47,65,-18,42
Forfar,4824,8,10,5,21,38,65,-27,35
Albion,4824,9,8,6,22,57,80,-23,30
Queen's Park,4824,10,6,10,20,39,74,-35,28
Ayr,4825,1,23,5,8,91,43,48,74
Raith,4825,2,22,8,6,68,33,35,74
Alloa,4825,3,18,8,10,57,43,14,62
Arbroath,4825,4,17,9,10,73,51,22,60
Stranraer,4825,5,16,5,15,59,66,-7,53
Airdrieon,4825,6,11,11,14,48,59,-11,44
East Fife,4825,7,13,3,20,49,68,-19,42
Forfar,4825,8,10,5,21,39,67,-28,35
Albion,4825,9,8,7,21,58,79,-21,31
Queen's Park,4825,10,6,11,19,42,75,-33,29
Raith,4826,1,22,8,6,69,34,35,74
Ayr,4826,2,23,4,9,91,44,47,73
Arbroath,4826,3,18,8,10,72,49,23,62
Alloa,4826,4,18,8,10,58,44,14,62
Stranraer,4826,5,16,5,15,57,65,-8,53
Airdrieon,4826,6,11,11,14,50,59,-9,44
East Fife,4826,7,13,3,20,48,66,-18,42
Forfar,4826,8,10,5,21,39,69,-30,35
Albion,4826,9,9,6,21,59,79,-20,33
Queen's Park,4826,10,6,10,20,40,74,-34,28
Ayr,4827,1,24,4,8,91,42,49,76
Raith,4827,2,22,8,6,69,34,35,74
Arbroath,4827,3,18,8,10,71,48,23,62
Alloa,4827,4,18,8,10,58,44,14,62
Stranraer,4827,5,15,6,15,56,65,-9,51
Airdrieon,4827,6,11,11,14,48,59,-11,44
East Fife,4827,7,13,4,19,48,65,-17,43
Forfar,4827,8,10,5,21,39,67,-28,35
Albion,4827,9,8,6,22,57,79,-22,30
Queen's Park,4827,10,6,10,20,39,73,-34,28
Ayr,4828,1,24,4,8,93,44,49,76
Raith,4828,2,22,9,5,69,33,36,75
Arbroath,4828,3,18,8,10,72,49,23,62
Alloa,4828,4,17,9,10,57,44,13,60
Stranraer,4828,5,16,5,15,56,64,-8,53
Airdrieon,4828,6,10,12,14,45,58,-13,42
East Fife,4828,7,13,3,20,47,65,-18,42
Forfar,4828,8,10,6,20,38,64,-26,36
Albion,4828,9,8,6,22,59,81,-22,30
Queen's Park,4828,10,6,10,20,40,74,-34,28
Ayr,4829,1,24,4,8,93,44,49,76
Raith,4829,2,22,8,6,69,34,35,74
Alloa,4829,3,18,8,10,58,44,14,62
Arbroath,4829,4,17,9,10,72,50,22,60
Stranraer,4829,5,15,5,16,56,66,-10,50
East Fife,4829,6,14,3,19,49,65,-16,45
Airdrieon,4829,7,10,11,15,47,61,-14,41
Forfar,4829,8,11,5,20,41,66,-25,38
Albion,4829,9,8,6,22,59,81,-22,30
Queen's Park,4829,10,6,11,19,41,74,-33,29
Ayr,4830,1,23,5,8,92,44,48,74
Raith,4830,2,22,8,6,69,35,34,74
Alloa,4830,3,18,8,10,59,44,15,62
Arbroath,4830,4,17,9,10,73,51,22,60
Stranraer,4830,5,16,5,15,58,65,-7,53
Airdrieon,4830,6,11,11,14,46,58,-12,44
East Fife,4830,7,13,3,20,48,67,-19,42
Forfar,4830,8,10,5,21,38,65,-27,35
Albion,4830,9,8,7,21,59,80,-21,31
Queen's Park,4830,10,6,11,19,42,75,-33,29
Raith,4831,1,23,8,5,71,33,38,77
Ayr,4831,2,24,4,8,93,44,49,76
Arbroath,4831,3,18,8,10,72,49,23,62
Alloa,4831,4,17,8,11,57,46,11,59
Stranraer,4831,5,15,5,16,55,67,-12,50
East Fife,4831,6,14,3,19,50,64,-14,45
Airdrieon,4831,7,11,11,14,47,58,-11,44
Forfar,4831,8,10,5,21,38,66,-28,35
Albion,4831,9,8,6,22,59,81,-22,30
Queen's Park,4831,10,6,10,20,40,74,-34,28
Ayr,4832,1,24,4,8,95,42,53,76
Raith,4832,2,22,8,6,69,34,35,74
Arbroath,4832,3,18,8,10,73,50,23,62
Alloa,4832,4,18,8,10,58,44,14,62
Stranraer,4832,5,15,5,16,56,67,-11,50
East Fife,4832,6,14,3,19,50,65,-15,45
Airdrieon,4832,7,10,12,14,47,60,-13,42
Forfar,4832,8,10,6,20,40,66,-26,36
Albion,4832,9,8,6,22,57,83,-26,30
Queen's Park,4832,10,6,10,20,41,75,-34,28
Ayr,4833,1,24,4,8,94,43,51,76
Raith,4833,2,22,8,6,68,34,34,74
Arbroath,4833,3,18,8,10,71,48,23,62
Alloa,4833,4,18,8,10,58,43,15,62
Stranraer,4833,5,16,5,15,57,65,-8,53
East Fife,4833,6,13,3,20,48,66,-18,42
Airdrieon,4833,7,10,11,15,46,60,-14,41
Forfar,4833,8,11,5,20,40,65,-25,38
Albion,4833,9,8,6,22,58,82,-24,30
Queen's Park,4833,10,6,10,20,39,73,-34,28
Ayr,4834,1,24,4,8,95,43,52,76
Raith,4834,2,22,9,5,68,32,36,75
Arbroath,4834,3,18,8,10,75,48,27,62
Alloa,4834,4,17,9,10,56,43,13,60
Stranraer,4834,5,15,5,16,55,66,-11,50
East Fife,4834,6,14,3,19,49,64,-15,45
Airdrieon,4834,7,10,12,14,45,58,-13,42
Forfar,4834,8,10,6,20,38,64,-26,36
Albion,4834,9,8,6,22,58,83,-25,30
Queen's Park,4834,10,6,10,20,39,77,-38,28
Ayr,4835,1,23,5,8,93,45,48,74
Raith,4835,2,22,8,6,69,34,35,74
Arbroath,4835,3,18,8,10,73,48,25,62
Alloa,4835,4,18,8,10,58,44,14,62
Stranraer,4835,5,16,5,15,60,66,-6,53
Airdrieon,4835,6,10,12,14,45,58,-13,42
East Fife,4835,7,13,3,20,49,69,-20,42
Forfar,4835,8,10,6,20,38,64,-26,36
Albion,4835,9,8,7,21,60,81,-21,31
Queen's Park,4835,10,6,10,20,39,75,-36,28
Raith,4836,1,23,8,5,71,34,37,77
Ayr,4836,2,24,4,8,96,44,52,76
Arbroath,4836,3,18,8,10,73,49,24,62
Alloa,4836,4,17,8,11,58,46,12,59
Stranraer,4836,5,16,5,15,58,65,-7,53
Airdrieon,4836,6,11,11,14,48,60,-12,44
East Fife,4836,7,13,3,20,48,67,-19,42
Forfar,4836,8,10,5,21,40,67,-27,35
Albion,4836,9,8,6,22,59,84,-25,30
Queen's Park,4836,10,6,10,20,40,75,-35,28
Ayr,4837,1,24,4,8,92,42,50,76
Raith,4837,2,22,9,5,69,33,36,75
Arbroath,4837,3,18,8,10,73,49,24,62
Alloa,4837,4,17,9,10,57,44,13,60
Stranraer,4837,5,15,5,16,56,66,-10,50
East Fife,4837,6,14,3,19,49,65,-16,45
Airdrieon,4837,7,11,11,14,49,59,-10,44
Forfar,4837,8,10,5,21,39,68,-29,35
Albion,4837,9,8,6,22,57,80,-23,30
Queen's Park,4837,10,6,10,20,40,75,-35,28
Ayr,4838,1,24,4,8,93,43,50,76
Raith,4838,2,22,9,5,70,34,36,75
Alloa,4838,3,17,9,10,58,45,13,60
Arbroath,4838,4,17,8,11,71,50,21,59
Stranraer,4838,5,15,5,16,56,67,-11,50
East Fife,4838,6,14,3,19,50,65,-15,45
Airdrieon,4838,7,11,11,14,46,58,-12,44
Forfar,4838,8,10,5,21,38,65,-27,35
Queen's Park,4838,9,7,10,19,41,73,-32,31
Albion,4838,10,8,6,22,58,81,-23,30
Raith,4839,1,23,8,5,71,32,39,77
Ayr,4839,2,24,4,8,95,42,53,76
Arbroath,4839,3,17,8,11,70,49,21,59
Alloa,4839,4,17,8,11,56,46,10,59
Stranraer,4839,5,15,6,15,56,65,-9,51
Airdrieon,4839,6,11,11,14,46,58,-12,44
East Fife,4839,7,13,4,19,48,65,-17,43
Forfar,4839,8,10,5,21,38,65,-27,35
Queen's Park,4839,9,7,10,19,40,72,-32,31
Albion,4839,10,8,6,22,57,83,-26,30
Raith,4840,1,23,8,5,70,33,37,77
Ayr,4840,2,24,4,8,93,43,50,76
Arbroath,4840,3,17,8,11,73,52,21,59
Alloa,4840,4,17,8,11,57,45,12,59
Stranraer,4840,5,16,5,15,57,64,-7,53
Airdrieon,4840,6,10,12,14,46,59,-13,42
East Fife,4840,7,13,3,20,47,66,-19,42
Forfar,4840,8,10,6,20,39,65,-26,36
Queen's Park,4840,9,7,10,19,43,75,-32,31
Albion,4840,10,8,6,22,58,81,-23,30
Ayr,4841,1,23,5,8,93,45,48,74
Raith,4841,2,22,8,6,68,33,35,74
Arbroath,4841,3,18,8,10,74,49,25,62
Alloa,4841,4,18,8,10,57,43,14,62
Stranraer,4841,5,15,6,15,56,65,-9,51
Airdrieon,4841,6,11,11,14,48,60,-12,44
East Fife,4841,7,13,4,19,48,65,-17,43
Forfar,4841,8,10,5,21,40,67,-27,35
Albion,4841,9,8,7,21,60,81,-21,31
Queen's Park,4841,10,6,10,20,40,76,-36,28
Raith,4842,1,23,8,5,69,32,37,77
Ayr,4842,2,24,4,8,95,44,51,76
Arbroath,4842,3,18,8,10,72,49,23,62
Alloa,4842,4,17,8,11,56,44,12,59
Stranraer,4842,5,16,5,15,59,64,-5,53
Airdrieon,4842,6,11,11,14,49,58,-9,44
East Fife,4842,7,13,3,20,47,68,-21,42
Forfar,4842,8,10,5,21,38,68,-30,35
Albion,4842,9,8,6,22,59,83,-24,30
Queen's Park,4842,10,6,10,20,40,74,-34,28
Ayr,4843,1,23,5,8,92,44,48,74
Raith,4843,2,22,8,6,69,34,35,74
Alloa,4843,3,18,8,10,58,44,14,62
Arbroath,4843,4,17,8,11,70,49,21,59
Stranraer,4843,5,16,5,15,58,66,-8,53
East Fife,4843,6,13,3,20,49,67,-18,42
Airdrieon,4843,7,10,11,15,46,60,-14,41
Forfar,4843,8,11,5,20,40,65,-25,38
Albion,4843,9,8,7,21,59,80,-21,31
Queen's Park,4843,10,7,10,19,40,72,-32,31
Ayr,4844,1,23,5,8,91,43,48,74
Raith,4844,2,22,8,6,68,33,35,74
Arbroath,4844,3,18,8,10,73,49,24,62
Alloa,4844,4,18,8,10,57,43,14,62
Stranraer,4844,5,15,5,16,56,67,-11,50
East Fife,4844,6,14,3,19,50,65,-15,45
Airdrieon,4844,7,10,12,14,45,58,-13,42
Forfar,4844,8,10,6,20,38,64,-26,36
Albion,4844,9,8,7,21,58,79,-21,31
Queen's Park,4844,10,6,10,20,40,75,-35,28
Raith,4845,1,23,8,5,69,32,37,77
Ayr,4845,2,24,4,8,93,44,49,76
Arbroath,4845,3,18,8,10,72,49,23,62
Alloa,4845,4,17,8,11,56,44,12,59
Stranraer,4845,5,15,5,16,55,66,-11,50
East Fife,4845,6,14,3,19,49,64,-15,45
Airdrieon,4845,7,10,11,15,45,59,-14,41
Forfar,4845,8,11,5,20,39,64,-25,38
Albion,4845,9,8,6,22,59,81,-22,30
Queen's Park,4845,10,6,10,20,40,74,-34,28
Ayr,4846,1,24,4,8,95,42,53,76
Raith,4846,2,22,9,5,70,34,36,75
Arbroath,4846,3,17,9,10,72,50,22,60
Alloa,4846,4,17,9,10,58,45,13,60
Stranraer,4846,5,15,6,15,56,65,-9,51
East Fife,4846,6,13,4,19,48,65,-17,43
Airdrieon,4846,7,10,12,14,48,61,-13,42
Forfar,4846,8,10,6,20,41,67,-26,36
Albion,4846,9,8,6,22,57,83,-26,30
Queen's Park,4846,10,6,11,19,41,74,-33,29
Raith,4847,1,23,8,5,69,32,37,77
Ayr,4847,2,24,4,8,93,42,51,76
Arbroath,4847,3,17,9,10,71,49,22,60
Alloa,4847,4,17,8,11,56,44,12,59
Stranraer,4847,5,15,5,16,55,68,-13,50
East Fife,4847,6,14,3,19,51,64,-13,45
Airdrieon,4847,7,10,12,14,46,59,-13,42
Forfar,4847,8,10,6,20,39,65,-26,36
Albion,4847,9,8,6,22,57,81,-24,30
Queen's Park,4847,10,6,11,19,40,73,-33,29
Ayr,4848,1,24,4,8,97,42,55,76
Raith,4848,2,22,8,6,69,35,34,74
Arbroath,4848,3,18,8,10,74,50,24,62
Alloa,4848,4,18,8,10,59,44,15,62
Stranraer,4848,5,15,6,15,55,64,-9,51
East Fife,4848,6,13,4,19,47,64,-17,43
Airdrieon,4848,7,10,11,15,47,63,-16,41
Forfar,4848,8,11,5,20,43,66,-23,38
Albion,4848,9,8,6,22,57,85,-28,30
Queen's Park,4848,10,6,10,20,41,76,-35,28
Raith,4849,1,23,8,5,69,32,37,77
Ayr,4849,2,24,4,8,92,43,49,76
Arbroath,4849,3,18,8,10,71,48,23,62
Alloa,4849,4,17,8,11,56,44,12,59
Stranraer,4849,5,15,5,16,57,67,-10,50
East Fife,4849,6,14,3,19,50,66,-16,45
Airdrieon,4849,7,11,11,14,47,58,-11,44
Forfar,4849,8,10,5,21,38,66,-28,35
Albion,4849,9,8,6,22,58,80,-22,30
Queen's Park,4849,10,6,10,20,39,73,-34,28
Raith,4850,1,23,8,5,69,32,37,77
Ayr,4850,2,23,5,8,91,43,48,74
Arbroath,4850,3,17,8,11,72,51,21,59
Alloa,4850,4,17,8,11,56,44,12,59
Stranraer,4850,5,15,6,15,57,66,-9,51
Airdrieon,4850,6,11,11,14,46,58,-12,44
East Fife,4850,7,13,4,19,49,66,-17,43
Forfar,4850,8,10,5,21,38,65,-27,35
Albion,4850,9,8,7,21,58,79,-21,31
Queen's Park,4850,10,7,10,19,42,74,-32,31
Raith,4851,1,23,8,5,70,33,37,77
Ayr,4851,2,24,4,8,94,45,49,76
Arbroath,4851,3,17,8,11,71,51,20,59
Alloa,4851,4,17,8,11,57,45,12,59
Stranraer,4851,5,15,5,16,57,67,-10,50
East Fife,4851,6,14,3,19,50,66,-16,45
Airdrieon,4851,7,10,11,15,46,62,-16,41
Forfar,4851,8,11,5,20,42,65,-23,38
Queen's Park,4851,9,7,10,19,42,73,-31,31
Albion,4851,10,8,6,22,60,82,-22,30
Ayr,4852,1,24,4,8,96,43,53,76
Raith,4852,2,22,8,6,68,33,35,74
Alloa,4852,3,18,8,10,57,43,14,62
Arbroath,4852,4,17,9,10,70,48,22,60
Stranraer,4852,5,16,5,15,59,67,-8,53
Airdrieon,4852,6,11,11,14,46,58,-12,44
East Fife,4852,7,13,3,20,50,68,-18,42
Forfar,4852,8,10,5,21,38,65,-27,35
Albion,4852,9,8,6,22,58,84,-26,30
Queen's Park,4852,10,6,11,19,39,72,-33,29
Raith,4853,1,23,8,5,69,32,37,77
Ayr,4853,2,24,4,8,93,43,50,76
Arbroath,4853,3,17,8,11,70,49,21,59
Alloa,4853,4,17,8,11,56,44,12,59
Stranraer,4853,5,15,6,15,55,64,-9,51
Airdrieon,4853,6,11,11,14,47,58,-11,44
East Fife,4853,7,13,4,19,47,64,-17,43
Forfar,4853,8,10,5,21,38,66,-28,35
Queen's Park,4853,9,7,10,19,40,72,-32,31
Albion,4853,10,8,6,22,58,81,-23,30
Raith,4854,1,23,8,5,71,32,39,77
Ayr,4854,2,24,4,8,92,43,49,76
Arbroath,4854,3,18,8,10,74,49,25,62
Alloa,4854,4,17,8,11,56,46,10,59
Stranraer,4854,5,15,5,16,55,66,-11,50
East Fife,4854,6,14,3,19,49,64,-15,45
Airdrieon,4854,7,10,12,14,46,59,-13,42
Forfar,4854,8,10,6,20,39,65,-26,36
Albion,4854,9,8,6,22,58,80,-22,30
Queen's Park,4854,10,6,10,20,40,76,-36,28
Raith,4855,1,23,8,5,71,32,39,77
Ayr,4855,2,24,4,8,98,43,55,76
Arbroath,4855,3,17,8,11,70,51,19,59
Alloa,4855,4,17,8,11,56,46,10,59
Stranraer,4855,5,16,5,15,58,66,-8,53
Airdrieon,4855,6,11,11,14,46,58,-12,44
East Fife,4855,7,13,3,20,49,67,-18,42
Forfar,4855,8,10,5,21,38,65,-27,35
Queen's Park,4855,9,7,10,19,42,72,-30,31
Albion,4855,10,8,6,22,58,86,-28,30
Ayr,4856,1,24,4,8,93,44,49,76
Raith,4856,2,22,9,5,70,34,36,75
Arbroath,4856,3,17,9,10,71,49,22,60
Alloa,4856,4,17,9,10,58,45,13,60
Stranraer,4856,5,15,5,16,55,65,-10,50
East Fife,4856,6,14,3,19,48,64,-16,45
Airdrieon,4856,7,11,11,14,49,58,-9,44
Forfar,4856,8,10,5,21,38,68,-30,35
Albion,4856,9,8,6,22,59,81,-22,30
Queen's Park,4856,10,6,11,19,40,73,-33,29
Ayr,4857,1,24,4,8,96,43,53,76
Raith,4857,2,22,9,5,69,33,36,75
Arbroath,4857,3,17,9,10,71,49,22,60
Alloa,4857,4,17,9,10,57,44,13,60
Stranraer,4857,5,16,5,15,57,65,-8,53
East Fife,4857,6,13,3,20,48,66,-18,42
Airdrieon,4857,7,10,11,15,46,60,-14,41
Forfar,4857,8,11,5,20,40,65,-25,38
Albion,4857,9,8,6,22,58,84,-26,30
Queen's Park,4857,10,6,11,19,40,73,-33,29
Raith,4858,1,23,8,5,71,34,37,77
Ayr,4858,2,24,4,8,93,43,50,76
Arbroath,4858,3,17,9,10,71,49,22,60
Alloa,4858,4,17,8,11,58,46,12,59
Stranraer,4858,5,16,5,15,57,65,-8,53
East Fife,4858,6,13,3,20,48,66,-18,42
Airdrieon,4858,7,10,11,15,45,59,-14,41
Forfar,4858,8,11,5,20,39,64,-25,38
Albion,4858,9,8,6,22,58,81,-23,30
Queen's Park,4858,10,6,11,19,40,73,-33,29
Raith,4859,1,23,8,5,71,32,39,77
Ayr,4859,2,23,5,8,92,44,48,74
Arbroath,4859,3,17,8,11,74,53,21,59
Alloa,4859,4,17,8,11,56,46,10,59
Stranraer,4859,5,15,6,15,57,66,-9,51
Airdrieon,4859,6,11,11,14,47,59,-12,44
East Fife,4859,7,13,4,19,49,66,-17,43
Forfar,4859,8,10,5,21,39,66,-27,35
Albion,4859,9,8,7,21,59,80,-21,31
Queen's Park,4859,10,7,10,19,44,76,-32,31
Raith,4860,1,23,8,5,70,32,38,77
Ayr,4860,2,23,4,9,93,46,47,73
Arbroath,4860,3,18,8,10,73,50,23,62
Alloa,4860,4,17,8,11,56,45,11,59
Stranraer,4860,5,15,6,15,56,65,-9,51
Airdrieon,4860,6,11,11,14,48,58,-10,44
East Fife,4860,7,13,4,19,48,65,-17,43
Forfar,4860,8,10,5,21,38,67,-29,35
Albion,4860,9,9,6,21,61,81,-20,33
Queen's Park,4860,10,6,10,20,41,75,-34,28
Raith,4861,1,23,8,5,69,32,37,77
Ayr,4861,2,24,4,8,96,43,53,76
Arbroath,4861,3,18,8,10,74,49,25,62
Alloa,4861,4,17,8,11,56,44,12,59
Stranraer,4861,5,15,6,15,56,65,-9,51
East Fife,4861,6,13,4,19,48,65,-17,43
Airdrieon,4861,7,10,12,14,46,59,-13,42
Forfar,4861,8,10,6,20,39,65,-26,36
Albion,4861,9,8,6,22,58,84,-26,30
Queen's Park,4861,10,6,10,20,40,76,-36,28
Raith,4862,1,23,8,5,69,32,37,77
Ayr,4862,2,24,4,8,92,43,49,76
Arbroath,4862,3,18,8,10,72,49,23,62
Alloa,4862,4,17,8,11,56,44,12,59
Stranraer,4862,5,15,5,16,56,67,-11,50
East Fife,4862,6,14,3,19,50,65,-15,45
Airdrieon,4862,7,10,12,14,46,59,-13,42
Forfar,4862,8,10,6,20,39,65,-26,36
Albion,4862,9,8,6,22,58,80,-22,30
Queen's Park,4862,10,6,10,20,40,74,-34,28
Raith,4863,1,23,8,5,71,34,37,77
Ayr,4863,2,24,4,8,93,44,49,76
Arbroath,4863,3,18,8,10,72,49,23,62
Alloa,4863,4,17,8,11,58,46,12,59
Stranraer,4863,5,16,5,15,56,64,-8,53
Airdrieon,4863,6,11,11,14,49,60,-11,44
East Fife,4863,7,13,3,20,47,65,-18,42
Forfar,4863,8,10,5,21,40,68,-28,35
Albion,4863,9,8,6,22,59,81,-22,30
Queen's Park,4863,10,6,10,20,40,74,-34,28
Raith,4864,1,23,8,5,70,33,37,77
Ayr,4864,2,24,4,8,93,43,50,76
Arbroath,4864,3,18,8,10,72,48,24,62
Alloa,4864,4,17,8,11,57,45,12,59
Stranraer,4864,5,15,5,16,55,65,-10,50
East Fife,4864,6,14,3,19,48,64,-16,45
Airdrieon,4864,7,11,11,14,48,58,-10,44
Forfar,4864,8,10,5,21,38,67,-29,35
Albion,4864,9,8,6,22,58,81,-23,30
Queen's Park,4864,10,6,10,20,39,74,-35,28
Raith,4865,1,22,9,5,68,32,36,75
Ayr,4865,2,23,5,8,93,45,48,74
Arbroath,4865,3,17,9,10,71,49,22,60
Alloa,4865,4,17,9,10,56,43,13,60
Stranraer,4865,5,15,5,16,56,67,-11,50
East Fife,4865,6,14,3,19,50,65,-15,45
Airdrieon,4865,7,11,11,14,46,58,-12,44
Forfar,4865,8,10,5,21,38,65,-27,35
Albion,4865,9,8,7,21,60,81,-21,31
Queen's Park,4865,10,6,11,19,40,73,-33,29
Ayr,4866,1,24,4,8,91,42,49,76
Raith,4866,2,22,9,5,68,32,36,75
Arbroath,4866,3,18,8,10,73,48,25,62
Alloa,4866,4,17,9,10,56,43,13,60
Stranraer,4866,5,16,5,15,57,65,-8,53
Airdrieon,4866,6,11,11,14,48,59,-11,44
East Fife,4866,7,13,3,20,48,66,-18,42
Forfar,4866,8,10,5,21,39,67,-28,35
Albion,4866,9,8,6,22,57,79,-22,30
Queen's Park,4866,10,6,10,20,39,75,-36,28
Raith,4867,1,23,8,5,73,33,40,77
Ayr,4867,2,24,4,8,93,44,49,76
Arbroath,4867,3,18,8,10,74,49,25,62
Alloa,4867,4,17,8,11,57,48,9,59
Stranraer,4867,5,15,6,15,56,65,-9,51
Airdrieon,4867,6,11,11,14,48,58,-10,44
East Fife,4867,7,13,4,19,48,65,-17,43
Forfar,4867,8,10,5,21,38,67,-29,35
Albion,4867,9,8,6,22,59,81,-22,30
Queen's Park,4867,10,6,10,20,40,76,-36,28
Ayr,4868,1,24,4,8,95,43,52,76
Raith,4868,2,22,8,6,69,34,35,74
Alloa,4868,3,18,8,10,58,44,14,62
Arbroath,4868,4,17,9,10,71,49,22,60
Stranraer,4868,5,16,5,15,58,65,-7,53
Airdrieon,4868,6,10,12,14,48,61,-13,42
East Fife,4868,7,13,3,20,48,67,-19,42
Forfar,4868,8,10,6,20,41,67,-26,36
Albion,4868,9,8,6,22,58,83,-25,30
Queen's Park,4868,10,6,11,19,40,73,-33,29
Raith,4869,1,23,8,5,69,32,37,77
Ayr,4869,2,23,4,9,91,44,47,73
Arbroath,4869,3,18,8,10,74,48,26,62
Alloa,4869,4,17,8,11,56,44,12,59
Stranraer,4869,5,16,5,15,57,64,-7,53
Airdrieon,4869,6,11,11,14,47,59,-12,44
East Fife,4869,7,13,3,20,47,66,-19,42
Forfar,4869,8,10,5,21,39,66,-27,35
Albion,4869,9,9,6,21,59,79,-20,33
Queen's Park,4869,10,6,10,20,39,76,-37,28
Raith,4870,1,22,9,5,69,33,36,75
Ayr,4870,2,23,4,9,91,45,46,73
Arbroath,4870,3,18,8,10,72,48,24,62
Alloa,4870,4,17,9,10,57,44,13,60
Stranraer,4870,5,16,5,15,57,65,-8,53
Airdrieon,4870,6,11,11,14,48,59,-11,44
East Fife,4870,7,13,3,20,48,66,-18,42
Forfar,4870,8,10,5,21,39,67,-28,35
Albion,4870,9,9,6,21,60,79,-19,33
Queen's Park,4870,10,6,10,20,39,74,-35,28
Ayr,4871,1,24,4,8,95,45,50,76
Raith,4871,2,22,8,6,68,34,34,74
Alloa,4871,3,18,8,10,58,43,15,62
Arbroath,4871,4,17,9,10,72,50,22,60
Stranraer,4871,5,15,5,16,55,66,-11,50
East Fife,4871,6,14,3,19,49,64,-15,45
Airdrieon,4871,7,11,11,14,46,58,-12,44
Forfar,4871,8,10,5,21,38,65,-27,35
Albion,4871,9,8,6,22,60,83,-23,30
Queen's Park,4871,10,6,11,19,41,74,-33,29
Raith,4872,1,23,8,5,72,32,40,77
Ayr,4872,2,23,5,8,91,43,48,74
Arbroath,4872,3,17,9,10,70,48,22,60
Alloa,4872,4,17,8,11,56,47,9,59
Stranraer,4872,5,16,5,15,57,64,-7,53
Airdrieon,4872,6,11,11,14,46,58,-12,44
East Fife,4872,7,13,3,20,47,66,-19,42
Forfar,4872,8,10,5,21,38,65,-27,35
Albion,4872,9,8,7,21,58,79,-21,31
Queen's Park,4872,10,6,11,19,39,72,-33,29
Ayr,4873,1,24,4,8,94,45,49,76
Raith,4873,2,22,8,6,69,34,35,74
Alloa,4873,3,18,8,10,58,44,14,62
Arbroath,4873,4,17,8,11,72,51,21,59
Stranraer,4873,5,15,5,16,55,66,-11,50
East Fife,4873,6,14,3,19,49,64,-15,45
Airdrieon,4873,7,10,12,14,46,59,-13,42
Forfar,4873,8,10,6,20,39,65,-26,36
Queen's Park,4873,9,7,10,19,42,74,-32,31
Albion,4873,10,8,6,22,60,82,-22,30
Ayr,4874,1,24,4,8,93,43,50,76
Raith,4874,2,22,8,6,70,35,35,74
Alloa,4874,3,18,8,10,59,45,14,62
Arbroath,4874,4,17,8,11,71,52,19,59
Stranraer,4874,5,15,5,16,55,66,-11,50
East Fife,4874,6,14,3,19,49,64,-15,45
Airdrieon,4874,7,10,11,15,46,60,-14,41
Forfar,4874,8,11,5,20,40,65,-25,38
Queen's Park,4874,9,7,10,19,43,73,-30,31
Albion,4874,10,8,6,22,58,81,-23,30
Raith,4875,1,22,9,5,69,33,36,75
Ayr,4875,2,23,5,8,92,44,48,74
Arbroath,4875,3,18,8,10,71,48,23,62
Alloa,4875,4,17,9,10,57,44,13,60
Stranraer,4875,5,16,5,15,56,64,-8,53
Airdrieon,4875,6,10,12,14,46,59,-13,42
East Fife,4875,7,13,3,20,47,65,-18,42
Forfar,4875,8,10,6,20,39,65,-26,36
Albion,4875,9,8,7,21,59,80,-21,31
Queen's Park,4875,10,6,10,20,39,73,-34,28
Raith,4876,1,23,8,5,72,33,39,77
Ayr,4876,2,24,4,8,97,42,55,76
Arbroath,4876,3,18,8,10,74,50,24,62
Alloa,4876,4,17,8,11,57,47,10,59
Stranraer,4876,5,15,6,15,56,65,-9,51
East Fife,4876,6,13,4,19,48,65,-17,43
Airdrieon,4876,7,10,11,15,45,59,-14,41
Forfar,4876,8,11,5,20,39,64,-25,38
Albion,4876,9,8,6,22,57,85,-28,30
Queen's Park,4876,10,6,10,20,41,76,-35,28
Ayr,4877,1,24,4,8,97,44,53,76
Raith,4877,2,22,8,6,68,34,34,74
Arbroath,4877,3,18,8,10,71,48,23,62
Alloa,4877,4,18,8,10,58,43,15,62
Stranraer,4877,5,15,5,16,56,68,-12,50
East Fife,4877,6,14,3,19,51,65,-14,45
Airdrieon,4877,7,11,11,14,48,60,-12,44
Forfar,4877,8,10,5,21,40,67,-27,35
Albion,4877,9,8,6,22,59,85,-26,30
Queen's Park,4877,10,6,10,20,39,73,-34,28
Raith,4878,1,22,9,5,70,34,36,75
Ayr,4878,2,23,5,8,91,43,48,74
Arbroath,4878,3,18,8,10,71,48,23,62
Alloa,4878,4,17,9,10,58,45,13,60
Stranraer,4878,5,15,5,16,55,66,-11,50
East Fife,4878,6,14,3,19,49,64,-15,45
Airdrieon,4878,7,10,12,14,46,59,-13,42
Forfar,4878,8,10,6,20,39,65,-26,36
Albion,4878,9,8,7,21,58,79,-21,31
Queen's Park,4878,10,6,10,20,39,73,-34,28
Ayr,4879,1,24,4,8,98,45,53,76
Raith,4879,2,22,8,6,68,33,35,74
Alloa,4879,3,18,8,10,57,43,14,62
Arbroath,4879,4,17,9,10,71,49,22,60
Stranraer,4879,5,15,5,16,56,69,-13,50
East Fife,4879,6,14,3,19,52,65,-13,45
Airdrieon,4879,7,11,11,14,49,61,-12,44
Forfar,4879,8,10,5,21,41,68,-27,35
Albion,4879,9,8,6,22,60,86,-26,30
Queen's Park,4879,10,6,11,19,40,73,-33,29
Raith,4880,1,23,8,5,72,35,37,77
Ayr,4880,2,24,4,8,94,44,50,76
Arbroath,4880,3,17,8,11,72,52,20,59
Alloa,4880,4,17,8,11,59,47,12,59
Stranraer,4880,5,16,5,15,57,65,-8,53
East Fife,4880,6,13,3,20,48,66,-18,42
Airdrieon,4880,7,10,11,15,46,60,-14,41
Forfar,4880,8,11,5,20,40,65,-25,38
Queen's Park,4880,9,7,10,19,43,74,-31,31
Albion,4880,10,8,6,22,59,82,-23,30
Raith,4881,1,23,8,5,70,33,37,77
Ayr,4881,2,24,4,8,93,43,50,76
Arbroath,4881,3,17,8,11,70,49,21,59
Alloa,4881,4,17,8,11,57,45,12,59
Stranraer,4881,5,16,5,15,56,64,-8,53
East Fife,4881,6,13,3,20,47,65,-18,42
Airdrieon,4881,7,10,11,15,46,60,-14,41
Forfar,4881,8,11,5,20,40,65,-25,38
Queen's Park,4881,9,7,10,19,40,72,-32,31
Albion,4881,10,8,6,22,58,81,-23,30
Ayr,4882,1,24,4,8,93,43,50,76
Raith,4882,2,22,9,5,68,32,36,75
Alloa,4882,3,17,9,10,56,43,13,60
Arbroath,4882,4,17,8,11,72,51,21,59
Stranraer,4882,5,15,5,16,56,67,-11,50
East Fife,4882,6,14,3,19,50,65,-15,45
Airdrieon,4882,7,11,11,14,50,58,-8,44
Forfar,4882,8,10,5,21,38,69,-31,35
Queen's Park,4882,9,7,10,19,42,74,-32,31
Albion,4882,10,8,6,22,58,81,-23,30
Raith,4883,1,23,8,5,70,32,38,77
Ayr,4883,2,24,4,8,93,44,49,76
Arbroath,4883,3,18,8,10,72,49,23,62
Alloa,4883,4,17,8,11,56,45,11,59
Stranraer,4883,5,16,5,15,58,65,-7,53
Airdrieon,4883,6,10,12,14,47,60,-13,42
East Fife,4883,7,13,3,20,48,67,-19,42
Forfar,4883,8,10,6,20,40,66,-26,36
Albion,4883,9,8,6,22,59,81,-22,30
Queen's Park,4883,10,6,10,20,40,74,-34,28
Raith,4884,1,23,8,5,70,33,37,77
Ayr,4884,2,24,4,8,92,42,50,76
Arbroath,4884,3,18,8,10,71,48,23,62
Alloa,4884,4,17,8,11,57,45,12,59
Stranraer,4884,5,15,5,16,56,66,-10,50
East Fife,4884,6,14,3,19,49,65,-16,45
Airdrieon,4884,7,10,11,15,45,59,-14,41
Forfar,4884,8,11,5,20,39,64,-25,38
Albion,4884,9,8,6,22,57,80,-23,30
Queen's Park,4884,10,6,10,20,39,73,-34,28
Ayr,4885,1,24,4,8,92,42,50,76
Raith,4885,2,22,8,6,68,33,35,74
Alloa,4885,3,18,8,10,57,43,14,62
Arbroath,4885,4,17,9,10,71,49,22,60
Stranraer,4885,5,15,5,16,55,67,-12,50
East Fife,4885,6,14,3,19,50,64,-14,45
Airdrieon,4885,7,10,12,14,46,59,-13,42
Forfar,4885,8,10,6,20,39,65,-26,36
Albion,4885,9,8,6,22,57,80,-23,30
Queen's Park,4885,10,6,11,19,40,73,-33,29
Raith,4886,1,23,8,5,70,32,38,77
Ayr,4886,2,24,4,8,94,43,51,76
Arbroath,4886,3,18,8,10,73,48,25,62
Alloa,4886,4,17,8,11,56,45,11,59
Stranraer,4886,5,15,6,15,56,65,-9,51
Airdrieon,4886,6,11,11,14,46,58,-12,44
East Fife,4886,7,13,4,19,48,65,-17,43
Forfar,4886,8,10,5,21,38,65,-27,35
Albion,4886,9,8,6,22,58,82,-24,30
Queen's Park,4886,10,6,10,20,39,75,-36,28
Raith,4887,1,23,8,5,73,33,40,77
Ayr,4887,2,24,4,8,96,43,53,76
Arbroath,4887,3,18,8,10,72,48,24,62
Alloa,4887,4,17,8,11,57,48,9,59
Stranraer,4887,5,16,5,15,57,65,-8,53
Airdrieon,4887,6,10,12,14,45,58,-13,42
East Fife,4887,7,13,3,20,48,66,-18,42
Forfar,4887,8,10,6,20,38,64,-26,36
Albion,4887,9,8,6,22,58,84,-26,30
Queen's Park,4887,10,6,10,20,39,74,-35,28
Ayr,4888,1,24,4,8,97,42,55,76
Raith,4888,2,22,9,5,69,33,36,75
Arbroath,4888,3,18,8,10,71,48,23,62
Alloa,4888,4,17,9,10,57,44,13,60
Stranraer,4888,5,15,6,15,57,66,-9,51
Airdrieon,4888,6,11,11,14,49,60,-11,44
East Fife,4888,7,13,4,19,49,66,-17,43
Forfar,4888,8,10,5,21,40,68,-28,35
Albion,4888,9,8,6,22,57,85,-28,30
Queen's Park,4888,10,6,10,20,39,73,-34,28
Ayr,4889,1,24,4,8,96,43,53,76
Raith,4889,2,22,9,5,69,33,36,75
Arbroath,4889,3,17,9,10,74,52,22,60
Alloa,4889,4,17,9,10,57,44,13,60
Stranraer,4889,5,15,5,16,55,65,-10,50
East Fife,4889,6,14,3,19,48,64,-16,45
Airdrieon,4889,7,11,11,14,48,59,-11,44
Forfar,4889,8,10,5,21,39,67,-28,35
Albion,4889,9,8,6,22,58,84,-26,30
Queen's Park,4889,10,6,11,19,43,76,-33,29
Ayr,4890,1,24,4,8,92,42,50,76
Raith,4890,2,22,8,6,68,34,34,74
Alloa,4890,3,18,8,10,58,43,15,62
Arbroath,4890,4,17,8,11,70,51,19,59
Stranraer,4890,5,15,5,16,57,67,-10,50
East Fife,4890,6,14,3,19,50,66,-16,45
Airdrieon,4890,7,10,12,14,46,59,-13,42
Forfar,4890,8,10,6,20,39,65,-26,36
Queen's Park,4890,9,7,10,19,42,72,-30,31
Albion,4890,10,8,6,22,57,80,-23,30
Raith,4891,1,23,8,5,70,33,37,77
Ayr,4891,2,24,4,8,96,43,53,76
Arbroath,4891,3,18,8,10,74,48,26,62
Alloa,4891,4,17,8,11,57,45,12,59
Stranraer,4891,5,15,5,16,56,67,-11,50
East Fife,4891,6,14,3,19,50,65,-15,45
Airdrieon,4891,7,11,11,14,47,58,-11,44
Forfar,4891,8,10,5,21,38,66,-28,35
Albion,4891,9,8,6,22,58,84,-26,30
Queen's Park,4891,10,6,10,20,39,76,-37,28
Raith,4892,1,23,8,5,70,33,37,77
Ayr,4892,2,24,4,8,94,43,51,76
Arbroath,4892,3,18,8,10,72,48,24,62
Alloa,4892,4,17,8,11,57,45,12,59
Stranraer,4892,5,15,5,16,55,65,-10,50
East Fife,4892,6,14,3,19,48,64,-16,45
Airdrieon,4892,7,10,12,14,48,61,-13,42
Forfar,4892,8,10,6,20,41,67,-26,36
Albion,4892,9,8,6,22,58,82,-24,30
Queen's Park,4892,10,6,10,20,39,74,-35,28
Ayr,4893,1,24,4,8,94,42,52,76
Raith,4893,2,22,9,5,68,32,36,75
Arbroath,4893,3,17,9,10,72,50,22,60
Alloa,4893,4,17,9,10,56,43,13,60
Stranraer,4893,5,16,5,15,56,64,-8,53
Airdrieon,4893,6,11,11,14,47,58,-11,44
East Fife,4893,7,13,3,20,47,65,-18,42
Forfar,4893,8,10,5,21,38,66,-28,35
Albion,4893,9,8,6,22,57,82,-25,30
Queen's Park,4893,10,6,11,19,41,74,-33,29
Ayr,4894,1,24,4,8,93,42,51,76
Raith,4894,2,22,8,6,68,33,35,74
Alloa,4894,3,18,8,10,57,43,14,62
Arbroath,4894,4,17,8,11,72,52,20,59
Stranraer,4894,5,15,6,15,56,65,-9,51
Airdrieon,4894,6,11,11,14,47,59,-12,44
East Fife,4894,7,13,4,19,48,65,-17,43
Forfar,4894,8,10,5,21,39,66,-27,35
Queen's Park,4894,9,7,10,19,43,74,-31,31
Albion,4894,10,8,6,22,57,81,-24,30
Ayr,4895,1,24,4,8,94,43,51,76
Raith,4895,2,22,8,6,68,33,35,74
Arbroath,4895,3,18,8,10,72,49,23,62
Alloa,4895,4,18,8,10,57,43,14,62
Stranraer,4895,5,15,6,15,58,67,-9,51
East Fife,4895,6,13,4,19,50,67,-17,43
Airdrieon,4895,7,10,11,15,46,62,-16,41
Forfar,4895,8,11,5,20,42,65,-23,38
Albion,4895,9,8,6,22,58,82,-24,30
Queen's Park,4895,10,6,10,20,40,74,-34,28
Raith,4896,1,22,9,5,69,33,36,75
Ayr,4896,2,23,5,8,91,43,48,74
Alloa,4896,3,17,9,10,57,44,13,60
Arbroath,4896,4,17,8,11,70,52,18,59
Stranraer,4896,5,16,5,15,57,64,-7,53
Airdrieon,4896,6,11,11,14,46,58,-12,44
East Fife,4896,7,13,3,20,47,66,-19,42
Forfar,4896,8,10,5,21,38,65,-27,35
Albion,4896,9,8,7,21,58,79,-21,31
Queen's Park,4896,10,7,10,19,43,72,-29,31
Raith,4897,1,23,8,5,71,34,37,77
Ayr,4897,2,24,4,8,92,43,49,76
Arbroath,4897,3,17,8,11,71,50,21,59
Alloa,4897,4,17,8,11,58,46,12,59
Stranraer,4897,5,15,6,15,57,66,-9,51
East Fife,4897,6,13,4,19,49,66,-17,43
Airdrieon,4897,7,10,11,15,45,59,-14,41
Forfar,4897,8,11,5,20,39,64,-25,38
Queen's Park,4897,9,7,10,19,41,73,-32,31
Albion,4897,10,8,6,22,58,80,-22,30
Ayr,4898,1,24,4,8,94,43,51,76
Raith,4898,2,22,8,6,70,35,35,74
Alloa,4898,3,18,8,10,59,45,14,62
Arbroath,4898,4,17,8,11,71,50,21,59
Stranraer,4898,5,15,6,15,55,64,-9,51
Airdrieon,4898,6,11,11,14,48,58,-10,44
East Fife,4898,7,13,4,19,47,64,-17,43
Forfar,4898,8,10,5,21,38,67,-29,35
Queen's Park,4898,9,7,10,19,41,73,-32,31
Albion,4898,10,8,6,22,58,82,-24,30
Ayr,4899,1,24,4,8,96,44,52,76
Raith,4899,2,22,8,6,69,34,35,74
Alloa,4899,3,18,8,10,58,44,14,62
Arbroath,4899,4,17,8,11,73,52,21,59
Stranraer,4899,5,15,6,15,57,66,-9,51
Airdrieon,4899,6,11,11,14,48,59,-11,44
East Fife,4899,7,13,4,19,49,66,-17,43
Forfar,4899,8,10,5,21,39,67,-28,35
Queen's Park,4899,9,7,10,19,43,75,-32,31
Albion,4899,10,8,6,22,59,84,-25,30
Raith,4900,1,23,8,5,71,32,39,77
Ayr,4900,2,24,4,8,96,42,54,76
Arbroath,4900,3,17,9,10,72,50,22,60
Alloa,4900,4,17,8,11,56,46,10,59
Stranraer,4900,5,15,5,16,56,67,-11,50
East Fife,4900,6,14,3,19,50,65,-15,45
Airdrieon,4900,7,11,11,14,49,60,-11,44
Forfar,4900,8,10,5,21,40,68,-28,35
Albion,4900,9,8,6,22,57,84,-27,30
Queen's Park,4900,10,6,11,19,41,74,-33,29
Raith,4901,1,22,9,5,68,32,36,75
Ayr,4901,2,23,5,8,91,43,48,74
Arbroath,4901,3,17,9,10,75,53,22,60
Alloa,4901,4,17,9,10,56,43,13,60
Stranraer,4901,5,16,5,15,56,64,-8,53
Airdrieon,4901,6,10,12,14,48,61,-13,42
East Fife,4901,7,13,3,20,47,65,-18,42
Forfar,4901,8,10,6,20,41,67,-26,36
Albion,4901,9,8,7,21,58,79,-21,31
Queen's Park,4901,10,6,11,19,44,77,-33,29
Raith,4902,1,23,8,5,69,32,37,77
Ayr,4902,2,24,4,8,91,42,49,76
Arbroath,4902,3,18,8,10,72,49,23,62
Alloa,4902,4,17,8,11,56,44,12,59
Stranraer,4902,5,16,5,15,58,65,-7,53
Airdrieon,4902,6,11,11,14,50,59,-9,44
East Fife,4902,7,13,3,20,48,67,-19,42
Forfar,4902,8,10,5,21,39,69,-30,35
Albion,4902,9,8,6,22,57,79,-22,30
Queen's Park,4902,10,6,10,20,40,74,-34,28
Raith,4903,1,23,8,5,72,34,38,77
Ayr,4903,2,24,4,8,92,43,49,76
Arbroath,4903,3,17,8,11,70,50,20,59
Alloa,4903,4,17,8,11,58,47,11,59
Stranraer,4903,5,16,5,15,56,64,-8,53
Airdrieon,4903,6,11,11,14,49,60,-11,44
East Fife,4903,7,13,3,20,47,65,-18,42
Forfar,4903,8,10,5,21,40,68,-28,35
Queen's Park,4903,9,7,10,19,41,72,-31,31
Albion,4903,10,8,6,22,58,80,-22,30
Raith,4904,1,22,9,5,69,33,36,75
Ayr,4904,2,23,5,8,91,43,48,74
Arbroath,4904,3,18,8,10,74,50,24,62
Alloa,4904,4,17,9,10,57,44,13,60
Stranraer,4904,5,16,5,15,56,64,-8,53
Airdrieon,4904,6,10,12,14,45,58,-13,42
East Fife,4904,7,13,3,20,47,65,-18,42
Forfar,4904,8,10,6,20,38,64,-26,36
Albion,4904,9,8,7,21,58,79,-21,31
Queen's Park,4904,10,6,10,20,41,76,-35,28
Raith,4905,1,23,8,5,73,34,39,77
Ayr,4905,2,24,4,8,94,42,52,76
Arbroath,4905,3,18,8,10,73,48,25,62
Alloa,4905,4,17,8,11,58,48,10,59
Stranraer,4905,5,15,5,16,55,66,-11,50
East Fife,4905,6,14,3,19,49,64,-15,45
Airdrieon,4905,7,10,11,15,46,60,-14,41
Forfar,4905,8,11,5,20,40,65,-25,38
Albion,4905,9,8,6,22,57,82,-25,30
Queen's Park,4905,10,6,10,20,39,75,-36,28
Raith,4906,1,23,8,5,69,32,37,77
Ayr,4906,2,24,4,8,95,43,52,76
Arbroath,4906,3,17,9,10,72,50,22,60
Alloa,4906,4,17,8,11,56,44,12,59
Stranraer,4906,5,16,5,15,60,64,-4,53
Airdrieon,4906,6,11,11,14,48,58,-10,44
East Fife,4906,7,13,3,20,47,69,-22,42
Forfar,4906,8,10,5,21,38,67,-29,35
Albion,4906,9,8,6,22,58,83,-25,30
Queen's Park,4906,10,6,11,19,41,74,-33,29
Raith,4907,1,23,8,5,72,33,39,77
Ayr,4907,2,24,4,8,93,43,50,76
Arbroath,4907,3,18,8,10,72,49,23,62
Alloa,4907,4,17,8,11,57,47,10,59
Stranraer,4907,5,16,5,15,57,65,-8,53
Airdrieon,4907,6,11,11,14,48,60,-12,44
East Fife,4907,7,13,3,20,48,66,-18,42
Forfar,4907,8,10,5,21,40,67,-27,35
Albion,4907,9,8,6,22,58,81,-23,30
Queen's Park,4907,10,6,10,20,40,74,-34,28
Raith,4908,1,23,8,5,69,32,37,77
Ayr,4908,2,24,4,8,93,44,49,76
Arbroath,4908,3,17,9,10,73,51,22,60
Alloa,4908,4,17,8,11,56,44,12,59
Stranraer,4908,5,15,6,15,56,65,-9,51
East Fife,4908,6,13,4,19,48,65,-17,43
Airdrieon,4908,7,10,11,15,46,61,-15,41
Forfar,4908,8,11,5,20,41,65,-24,38
Albion,4908,9,8,6,22,59,81,-22,30
Queen's Park,4908,10,6,11,19,42,75,-33,29
Raith,4909,1,23,8,5,73,34,39,77
Ayr,4909,2,24,4,8,94,45,49,76
Arbroath,4909,3,18,8,10,73,49,24,62
Alloa,4909,4,17,8,11,58,48,10,59
Stranraer,4909,5,15,5,16,55,65,-10,50
East Fife,4909,6,14,3,19,48,64,-16,45
Airdrieon,4909,7,11,11,14,47,59,-12,44
Forfar,4909,8,10,5,21,39,66,-27,35
Albion,4909,9,8,6,22,60,82,-22,30
Queen's Park,4909,10,6,10,20,40,75,-35,28
Ayr,4910,1,24,4,8,93,44,49,76
Raith,4910,2,22,8,6,68,33,35,74
Alloa,4910,3,18,8,10,57,43,14,62
Arbroath,4910,4,17,8,11,70,50,20,59
Stranraer,4910,5,15,5,16,56,68,-12,50
East Fife,4910,6,14,3,19,51,65,-14,45
Airdrieon,4910,7,11,11,14,48,59,-11,44
Forfar,4910,8,10,5,21,39,67,-28,35
Queen's Park,4910,9,7,10,19,41,72,-31,31
Albion,4910,10,8,6,22,59,81,-22,30
Ayr,4911,1,24,4,8,95,44,51,76
Raith,4911,2,22,8,6,69,34,35,74
Arbroath,4911,3,18,8,10,71,48,23,62
Alloa,4911,4,18,8,10,58,44,14,62
Stranraer,4911,5,15,5,16,55,65,-10,50
East Fife,4911,6,14,3,19,48,64,-16,45
Airdrieon,4911,7,10,11,15,45,61,-16,41
Forfar,4911,8,11,5,20,41,64,-23,38
Albion,4911,9,8,6,22,59,83,-24,30
Queen's Park,4911,10,6,10,20,39,73,-34,28
Ayr,4912,1,24,4,8,95,43,52,76
Raith,4912,2,22,9,5,69,33,36,75
Arbroath,4912,3,17,9,10,71,49,22,60
Alloa,4912,4,17,9,10,57,44,13,60
Stranraer,4912,5,15,5,16,55,65,-10,50
East Fife,4912,6,14,3,19,48,64,-16,45
Airdrieon,4912,7,10,11,15,46,60,-14,41
Forfar,4912,8,11,5,20,40,65,-25,38
Albion,4912,9,8,6,22,58,83,-25,30
Queen's Park,4912,10,6,11,19,40,73,-33,29
Ayr,4913,1,24,4,8,99,44,55,76
Raith,4913,2,22,8,6,68,33,35,74
Arbroath,4913,3,18,8,10,72,49,23,62
Alloa,4913,4,18,8,10,57,43,14,62
Stranraer,4913,5,15,5,16,55,65,-10,50
East Fife,4913,6,14,3,19,48,64,-16,45
Airdrieon,4913,7,11,11,14,48,59,-11,44
Forfar,4913,8,10,5,21,39,67,-28,35
Albion,4913,9,8,6,22,59,87,-28,30
Queen's Park,4913,10,6,10,20,40,74,-34,28
Raith,4914,1,23,8,5,72,33,39,77
Ayr,4914,2,24,4,8,92,43,49,76
Arbroath,4914,3,18,8,10,74,48,26,62
Alloa,4914,4,17,8,11,57,47,10,59
Stranraer,4914,5,15,5,16,57,67,-10,50
East Fife,4914,6,14,3,19,50,66,-16,45
Airdrieon,4914,7,11,11,14,46,58,-12,44
Forfar,4914,8,10,5,21,38,65,-27,35
Albion,4914,9,8,6,22,58,80,-22,30
Queen's Park,4914,10,6,10,20,39,76,-37,28
Raith,4915,1,23,8,5,71,32,39,77
Ayr,4915,2,24,4,8,93,43,50,76
Arbroath,4915,3,17,9,10,73,51,22,60
Alloa,4915,4,17,8,11,56,46,10,59
Stranraer,4915,5,16,5,15,58,64,-6,53
Airdrieon,4915,6,11,11,14,46,58,-12,44
East Fife,4915,7,13,3,20,47,67,-20,42
Forfar,4915,8,10,5,21,38,65,-27,35
Albion,4915,9,8,6,22,58,81,-23,30
Queen's Park,4915,10,6,11,19,42,75,-33,29
Raith,4916,1,23,8,5,70,33,37,77
Ayr,4916,2,24,4,8,93,42,51,76
Arbroath,4916,3,17,9,10,70,48,22,60
Alloa,4916,4,17,8,11,57,45,12,59
Stranraer,4916,5,15,5,16,56,66,-10,50
East Fife,4916,6,14,3,19,49,65,-16,45
Airdrieon,4916,7,11,11,14,46,58,-12,44
Forfar,4916,8,10,5,21,38,65,-27,35
Albion,4916,9,8,6,22,57,81,-24,30
Queen's Park,4916,10,6,11,19,39,72,-33,29
Raith,4917,1,23,8,5,71,32,39,77
Ayr,4917,2,24,4,8,93,42,51,76
Arbroath,4917,3,18,8,10,71,48,23,62
Alloa,4917,4,17,8,11,56,46,10,59
Stranraer,4917,5,15,5,16,55,66,-11,50
East Fife,4917,6,14,3,19,49,64,-15,45
Airdrieon,4917,7,11,11,14,48,60,-12,44
Forfar,4917,8,10,5,21,40,67,-27,35
Albion,4917,9,8,6,22,57,81,-24,30
Queen's Park,4917,10,6,10,20,39,73,-34,28
Raith,4918,1,23,8,5,71,32,39,77
Ayr,4918,2,23,4,9,91,46,45,73
Arbroath,4918,3,18,8,10,72,48,24,62
Alloa,4918,4,17,8,11,56,46,10,59
Stranraer,4918,5,16,5,15,56,64,-8,53
East Fife,4918,6,13,3,20,47,65,-18,42
Airdrieon,4918,7,10,11,15,45,59,-14,41
Forfar,4918,8,11,5,20,39,64,-25,38
Albion,4918,9,9,6,21,61,79,-18,33
Queen's Park,4918,10,6,10,20,39,74,-35,28
Ayr,4919,1,24,4,8,94,44,50,76
Raith,4919,2,22,8,6,68,33,35,74
Alloa,4919,3,18,8,10,57,43,14,62
Arbroath,4919,4,17,8,11,70,49,21,59
Stranraer,4919,5,15,5,16,56,67,-11,50
East Fife,4919,6,14,3,19,50,65,-15,45
Airdrieon,4919,7,10,12,14,46,59,-13,42
Forfar,4919,8,10,6,20,39,65,-26,36
Queen's Park,4919,9,7,10,19,40,72,-32,31
Albion,4919,10,8,6,22,59,82,-23,30
Raith,4920,1,23,8,5,71,32,39,77
Ayr,4920,2,24,4,8,93,44,49,76
Arbroath,4920,3,17,8,11,71,50,21,59
Alloa,4920,4,17,8,11,56,46,10,59
Stranraer,4920,5,15,5,16,57,68,-11,50
East Fife,4920,6,14,3,19,51,66,-15,45
Airdrieon,4920,7,10,11,15,46,60,-14,41
Forfar,4920,8,11,5,20,40,65,-25,38
Queen's Park,4920,9,7,10,19,41,73,-32,31
Albion,4920,10,8,6,22,59,81,-22,30
Raith,4921,1,23,8,5,70,32,38,77
Ayr,4921,2,24,4,8,95,43,52,76
Arbroath,4921,3,17,9,10,71,49,22,60
Alloa,4921,4,17,8,11,56,45,11,59
Stranraer,4921,5,15,6,15,56,65,-9,51
East Fife,4921,6,13,4,19,48,65,-17,43
Airdrieon,4921,7,10,11,15,45,59,-14,41
Forfar,4921,8,11,5,20,39,64,-25,38
Albion,4921,9,8,6,22,58,83,-25,30
Queen's Park,4921,10,6,11,19,40,73,-33,29
Raith,4922,1,23,8,5,71,34,37,77
Ayr,4922,2,24,4,8,92,42,50,76
Arbroath,4922,3,18,8,10,73,50,23,62
Alloa,4922,4,17,8,11,58,46,12,59
Stranraer,4922,5,16,5,15,58,64,-6,53
Airdrieon,4922,6,11,11,14,46,58,-12,44
East Fife,4922,7,13,3,20,47,67,-20,42
Forfar,4922,8,10,5,21,38,65,-27,35
Albion,4922,9,8,6,22,57,80,-23,30
Queen's Park,4922,10,6,10,20,41,75,-34,28
Ayr,4923,1,24,4,8,95,43,52,76
Raith,4923,2,22,9,5,68,32,36,75
Arbroath,4923,3,18,8,10,73,50,23,62
Alloa,4923,4,17,9,10,56,43,13,60
Stranraer,4923,5,15,5,16,55,66,-11,50
East Fife,4923,6,14,3,19,49,64,-15,45
Airdrieon,4923,7,11,11,14,48,60,-12,44
Forfar,4923,8,10,5,21,40,67,-27,35
Albion,4923,9,8,6,22,58,83,-25,30
Queen's Park,4923,10,6,10,20,41,75,-34,28
Raith,4924,1,23,8,5,70,32,38,77
Ayr,4924,2,24,4,8,95,46,49,76
Arbroath,4924,3,17,9,10,70,48,22,60
Alloa,4924,4,17,8,11,56,45,11,59
Stranraer,4924,5,15,6,15,56,65,-9,51
East Fife,4924,6,13,4,19,48,65,-17,43
Airdrieon,4924,7,10,11,15,46,60,-14,41
Forfar,4924,8,11,5,20,40,65,-25,38
Albion,4924,9,8,6,22,61,83,-22,30
Queen's Park,4924,10,6,11,19,39,72,-33,29
Ayr,4925,1,24,4,8,94,43,51,76
Raith,4925,2,22,9,5,69,33,36,75
Arbroath,4925,3,17,9,10,72,50,22,60
Alloa,4925,4,17,9,10,57,44,13,60
Stranraer,4925,5,16,5,15,58,65,-7,53
Airdrieon,4925,6,11,11,14,48,60,-12,44
East Fife,4925,7,13,3,20,48,67,-19,42
Forfar,4925,8,10,5,21,40,67,-27,35
Albion,4925,9,8,6,22,58,82,-24,30
Queen's Park,4925,10,6,11,19,41,74,-33,29
Raith,4926,1,23,8,5,70,32,38,77
Ayr,4926,2,24,4,8,95,42,53,76
Arbroath,4926,3,18,8,10,74,48,26,62
Alloa,4926,4,17,8,11,56,45,11,59
Stranraer,4926,5,15,5,16,55,65,-10,50
East Fife,4926,6,14,3,19,48,64,-16,45
Airdrieon,4926,7,10,11,15,45,59,-14,41
Forfar,4926,8,11,5,20,39,64,-25,38
Albion,4926,9,8,6,22,57,83,-26,30
Queen's Park,4926,10,6,10,20,39,76,-37,28
Raith,4927,1,23,8,5,72,32,40,77
Ayr,4927,2,24,4,8,95,44,51,76
Arbroath,4927,3,18,8,10,72,49,23,62
Alloa,4927,4,17,8,11,56,47,9,59
Stranraer,4927,5,15,5,16,57,67,-10,50
East Fife,4927,6,14,3,19,50,66,-16,45
Airdrieon,4927,7,11,11,14,47,58,-11,44
Forfar,4927,8,10,5,21,38,66,-28,35
Albion,4927,9,8,6,22,59,83,-24,30
Queen's Park,4927,10,6,10,20,40,74,-34,28
Raith,4928,1,23,8,5,70,32,38,77
Ayr,4928,2,24,4,8,91,42,49,76
Arbroath,4928,3,17,8,11,70,49,21,59
Alloa,4928,4,17,8,11,56,45,11,59
Stranraer,4928,5,16,5,15,56,64,-8,53
Airdrieon,4928,6,10,12,14,46,59,-13,42
East Fife,4928,7,13,3,20,47,65,-18,42
Forfar,4928,8,10,6,20,39,65,-26,36
Queen's Park,4928,9,7,10,19,40,72,-32,31
Albion,4928,10,8,6,22,57,79,-22,30
Ayr,4929,1,24,4,8,94,45,49,76
Raith,4929,2,22,9,5,69,33,36,75
Arbroath,4929,3,18,8,10,74,49,25,62
Alloa,4929,4,17,9,10,57,44,13,60
Stranraer,4929,5,15,5,16,56,66,-10,50
East Fife,4929,6,14,3,19,49,65,-16,45
Airdrieon,4929,7,10,11,15,45,60,-15,41
Forfar,4929,8,11,5,20,40,64,-24,38
Albion,4929,9,8,6,22,60,82,-22,30
Queen's Park,4929,10,6,10,20,40,76,-36,28
Raith,4930,1,23,8,5,70,32,38,77
Ayr,4930,2,24,4,8,95,43,52,76
Arbroath,4930,3,18,8,10,72,49,23,62
Alloa,4930,4,17,8,11,56,45,11,59
Stranraer,4930,5,16,5,15,57,64,-7,53
Airdrieon,4930,6,11,11,14,48,58,-10,44
East Fife,4930,7,13,3,20,47,66,-19,42
Forfar,4930,8,10,5,21,38,67,-29,35
Albion,4930,9,8,6,22,58,83,-25,30
Queen's Park,4930,10,6,10,20,40,74,-34,28
Ayr,4931,1,24,4,8,96,43,53,76
Raith,4931,2,22,9,5,69,33,36,75
Arbroath,4931,3,18,8,10,73,48,25,62
Alloa,4931,4,17,9,10,57,44,13,60
Stranraer,4931,5,16,5,15,56,64,-8,53
Airdrieon,4931,6,11,11,14,47,58,-11,44
East Fife,4931,7,13,3,20,47,65,-18,42
Forfar,4931,8,10,5,21,38,66,-28,35
Albion,4931,9,8,6,22,58,84,-26,30
Queen's Park,4931,10,6,10,20,39,75,-36,28
Raith,4932,1,23,8,5,72,33,39,77
Ayr,4932,2,24,4,8,93,42,51,76
Arbroath,4932,3,18,8,10,72,49,23,62
Alloa,4932,4,17,8,11,57,47,10,59
Stranraer,4932,5,16,5,15,58,65,-7,53
Airdrieon,4932,6,10,12,14,45,58,-13,42
East Fife,4932,7,13,3,20,48,67,-19,42
Forfar,4932,8,10,6,20,38,64,-26,36
Albion,4932,9,8,6,22,57,81,-24,30
Queen's Park,4932,10,6,10,20,40,74,-34,28
Raith,4933,1,23,8,5,71,32,39,77
Ayr,4933,2,24,4,8,94,43,51,76
Arbroath,4933,3,17,9,10,71,49,22,60
Alloa,4933,4,17,8,11,56,46,10,59
Stranraer,4933,5,16,5,15,57,64,-7,53
East Fife,4933,6,13,3,20,47,66,-19,42
Airdrieon,4933,7,10,11,15,45,59,-14,41
Forfar,4933,8,11,5,20,39,64,-25,38
Albion,4933,9,8,6,22,58,82,-24,30
Queen's Park,4933,10,6,11,19,40,73,-33,29
Raith,4934,1,23,8,5,69,32,37,77
Ayr,4934,2,23,4,9,91,44,47,73
Arbroath,4934,3,17,9,10,71,49,22,60
Alloa,4934,4,17,8,11,56,44,12,59
Stranraer,4934,5,15,5,16,55,69,-14,50
East Fife,4934,6,14,3,19,52,64,-12,45
Airdrieon,4934,7,11,11,14,46,58,-12,44
Forfar,4934,8,10,5,21,38,65,-27,35
Albion,4934,9,9,6,21,59,79,-20,33
Queen's Park,4934,10,6,11,19,40,73,-33,29
Raith,4935,1,23,8,5,70,32,38,77
Ayr,4935,2,23,4,9,91,46,45,73
Arbroath,4935,3,17,8,11,71,51,20,59
Alloa,4935,4,17,8,11,56,45,11,59
Stranraer,4935,5,15,5,16,57,69,-12,50
East Fife,4935,6,14,3,19,52,66,-14,45
Airdrieon,4935,7,11,11,14,46,58,-12,44
Forfar,4935,8,10,5,21,38,65,-27,35
Albion,4935,9,9,6,21,61,79,-18,33
Queen's Park,4935,10,7,10,19,42,73,-31,31
Raith,4936,1,23,8,5,71,32,39,77
Ayr,4936,2,24,4,8,96,42,54,76
Arbroath,4936,3,18,8,10,73,50,23,62
Alloa,4936,4,17,8,11,56,46,10,59
Stranraer,4936,5,15,5,16,56,66,-10,50
East Fife,4936,6,14,3,19,49,65,-16,45
Airdrieon,4936,7,11,11,14,47,59,-12,44
Forfar,4936,8,10,5,21,39,66,-27,35
Albion,4936,9,8,6,22,57,84,-27,30
Queen's Park,4936,10,6,10,20,41,75,-34,28
Raith,4937,1,23,8,5,70,33,37,77
Ayr,4937,2,23,5,8,92,44,48,74
Arbroath,4937,3,18,8,10,74,49,25,62
Alloa,4937,4,17,8,11,57,45,12,59
Stranraer,4937,5,16,5,15,59,65,-6,53
Airdrieon,4937,6,11,11,14,49,58,-9,44
East Fife,4937,7,13,3,20,48,68,-20,42
Forfar,4937,8,10,5,21,38,68,-30,35
Albion,4937,9,8,7,21,59,80,-21,31
Queen's Park,4937,10,6,10,20,40,76,-36,28
Ayr,4938,1,24,4,8,95,44,51,76
Raith,4938,2,22,8,6,68,33,35,74
Arbroath,4938,3,18,8,10,75,49,26,62
Alloa,4938,4,18,8,10,57,43,14,62
Stranraer,4938,5,15,5,16,56,66,-10,50
East Fife,4938,6,14,3,19,49,65,-16,45
Airdrieon,4938,7,11,11,14,47,58,-11,44
Forfar,4938,8,10,5,21,38,66,-28,35
Albion,4938,9,8,6,22,59,83,-24,30
Queen's Park,4938,10,6,10,20,40,77,-37,28
Raith,4939,1,23,8,5,72,33,39,77
Ayr,4939,2,24,4,8,94,42,52,76
Arbroath,4939,3,18,8,10,71,48,23,62
Alloa,4939,4,17,8,11,57,47,10,59
Stranraer,4939,5,15,5,16,56,66,-10,50
East Fife,4939,6,14,3,19,49,65,-16,45
Airdrieon,4939,7,11,11,14,49,59,-10,44
Forfar,4939,8,10,5,21,39,68,-29,35
Albion,4939,9,8,6,22,57,82,-25,30
Queen's Park,4939,10,6,10,20,39,73,-34,28
Raith,4940,1,23,8,5,71,33,38,77
Ayr,4940,2,24,4,8,93,43,50,76
Arbroath,4940,3,17,9,10,71,49,22,60
Alloa,4940,4,17,8,11,57,46,11,59
Stranraer,4940,5,15,6,15,57,66,-9,51
East Fife,4940,6,13,4,19,49,66,-17,43
Airdrieon,4940,7,10,11,15,45,60,-15,41
Forfar,4940,8,11,5,20,40,64,-24,38
Albion,4940,9,8,6,22,58,81,-23,30
Queen's Park,4940,10,6,11,19,40,73,-33,29
Raith,4941,1,23,8,5,72,34,38,77
Ayr,4941,2,24,4,8,92,43,49,76
Arbroath,4941,3,18,8,10,72,49,23,62
Alloa,4941,4,17,8,11,58,47,11,59
Stranraer,4941,5,16,5,15,56,64,-8,53
Airdrieon,4941,6,11,11,14,48,59,-11,44
East Fife,4941,7,13,3,20,47,65,-18,42
Forfar,4941,8,10,5,21,39,67,-28,35
Albion,4941,9,8,6,22,58,80,-22,30
Queen's Park,4941,10,6,10,20,40,74,-34,28
Raith,4942,1,23,8,5,70,32,38,77
Ayr,4942,2,24,4,8,92,43,49,76
Arbroath,4942,3,18,8,10,71,48,23,62
Alloa,4942,4,17,8,11,56,45,11,59
Stranraer,4942,5,15,5,16,56,66,-10,50
East Fife,4942,6,14,3,19,49,65,-16,45
Airdrieon,4942,7,10,12,14,46,59,-13,42
Forfar,4942,8,10,6,20,39,65,-26,36
Albion,4942,9,8,6,22,58,80,-22,30
Queen's Park,4942,10,6,10,20,39,73,-34,28
Raith,4943,1,22,9,5,71,35,36,75
Ayr,4943,2,23,5,8,91,43,48,74
Arbroath,4943,3,18,8,10,72,49,23,62
Alloa,4943,4,17,9,10,59,46,13,60
Stranraer,4943,5,16,5,15,58,64,-6,53
Airdrieon,4943,6,11,11,14,47,58,-11,44
East Fife,4943,7,13,3,20,47,67,-20,42
Forfar,4943,8,10,5,21,38,66,-28,35
Albion,4943,9,8,7,21,58,79,-21,31
Queen's Park,4943,10,6,10,20,40,74,-34,28
Ayr,4944,1,24,4,8,98,43,55,76
Raith,4944,2,22,9,5,71,35,36,75
Arbroath,4944,3,18,8,10,72,49,23,62
Alloa,4944,4,17,9,10,59,46,13,60
Stranraer,4944,5,15,5,16,56,68,-12,50
East Fife,4944,6,14,3,19,51,65,-14,45
Airdrieon,4944,7,11,11,14,50,59,-9,44
Forfar,4944,8,10,5,21,39,69,-30,35
Albion,4944,9,8,6,22,58,86,-28,30
Queen's Park,4944,10,6,10,20,40,74,-34,28
Ayr,4945,1,24,4,8,94,44,50,76
Raith,4945,2,22,9,5,68,32,36,75
Arbroath,4945,3,17,9,10,70,48,22,60
Alloa,4945,4,17,9,10,56,43,13,60
Stranraer,4945,5,15,6,15,56,65,-9,51
Airdrieon,4945,6,11,11,14,46,58,-12,44
East Fife,4945,7,13,4,19,48,65,-17,43
Forfar,4945,8,10,5,21,38,65,-27,35
Albion,4945,9,8,6,22,59,82,-23,30
Queen's Park,4945,10,6,11,19,39,72,-33,29
Raith,4946,1,23,8,5,71,32,39,77
Ayr,4946,2,24,4,8,92,42,50,76
Arbroath,4946,3,18,8,10,72,49,23,62
Alloa,4946,4,17,8,11,56,46,10,59
Stranraer,4946,5,15,6,15,56,65,-9,51
Airdrieon,4946,6,11,11,14,47,59,-12,44
East Fife,4946,7,13,4,19,48,65,-17,43
Forfar,4946,8,10,5,21,39,66,-27,35
Albion,4946,9,8,6,22,57,80,-23,30
Queen's Park,4946,10,6,10,20,40,74,-34,28
Ayr,4947,1,24,4,8,94,43,51,76
Raith,4947,2,22,8,6,69,34,35,74
Alloa,4947,3,18,8,10,58,44,14,62
Arbroath,4947,4,17,8,11,70,49,21,59
Stranraer,4947,5,15,5,16,55,68,-13,50
East Fife,4947,6,14,3,19,51,64,-13,45
Airdrieon,4947,7,11,11,14,49,59,-10,44
Forfar,4947,8,10,5,21,39,68,-29,35
Queen's Park,4947,9,7,10,19,40,72,-32,31
Albion,4947,10,8,6,22,58,82,-24,30
Ayr,4948,1,24,4,8,92,43,49,76
Raith,4948,2,22,8,6,69,35,34,74
Arbroath,4948,3,18,8,10,73,48,25,62
Alloa,4948,4,18,8,10,59,44,15,62
Stranraer,4948,5,15,6,15,56,65,-9,51
East Fife,4948,6,13,4,19,48,65,-17,43
Airdrieon,4948,7,10,12,14,47,60,-13,42
Forfar,4948,8,10,6,20,40,66,-26,36
Albion,4948,9,8,6,22,58,80,-22,30
Queen's Park,4948,10,6,10,20,39,75,-36,28
Raith,4949,1,23,8,5,70,32,38,77
Ayr,4949,2,23,4,9,91,44,47,73
Arbroath,4949,3,18,8,10,73,48,25,62
Alloa,4949,4,17,8,11,56,45,11,59
Stranraer,4949,5,15,6,15,57,66,-9,51
Airdrieon,4949,6,11,11,14,48,60,-12,44
East Fife,4949,7,13,4,19,49,66,-17,43
Forfar,4949,8,10,5,21,40,67,-27,35
Albion,4949,9,9,6,21,59,79,-20,33
Queen's Park,4949,10,6,10,20,39,75,-36,28
Ayr,4950,1,24,4,8,95,43,52,76
Raith,4950,2,22,9,5,69,33,36,75
Arbroath,4950,3,17,9,10,71,49,22,60
Alloa,4950,4,17,9,10,57,44,13,60
Stranraer,4950,5,15,6,15,57,66,-9,51
Airdrieon,4950,6,11,11,14,48,58,-10,44
East Fife,4950,7,13,4,19,49,66,-17,43
Forfar,4950,8,10,5,21,38,67,-29,35
Albion,4950,9,8,6,22,58,83,-25,30
Queen's Park,4950,10,6,11,19,40,73,-33,29
Ayr,4951,1,24,4,8,93,43,50,76
Raith,4951,2,22,8,6,69,34,35,74
Arbroath,4951,3,18,8,10,73,49,24,62
Alloa,4951,4,18,8,10,58,44,14,62
Stranraer,4951,5,16,5,15,57,65,-8,53
East Fife,4951,6,13,3,20,48,66,-18,42
Airdrieon,4951,7,10,11,15,46,61,-15,41
Forfar,4951,8,11,5,20,41,65,-24,38
Albion,4951,9,8,6,22,58,81,-23,30
Queen's Park,4951,10,6,10,20,40,75,-35,28
Raith,4952,1,23,8,5,70,33,37,77
Ayr,4952,2,23,4,9,93,46,47,73
Arbroath,4952,3,18,8,10,73,48,25,62
Alloa,4952,4,17,8,11,57,45,12,59
Stranraer,4952,5,15,5,16,56,66,-10,50
East Fife,4952,6,14,3,19,49,65,-16,45
Airdrieon,4952,7,10,12,14,46,59,-13,42
Forfar,4952,8,10,6,20,39,65,-26,36
Albion,4952,9,9,6,21,61,81,-20,33
Queen's Park,4952,10,6,10,20,39,75,-36,28
Raith,4953,1,23,8,5,71,32,39,77
Ayr,4953,2,23,5,8,92,44,48,74
Arbroath,4953,3,18,8,10,73,48,25,62
Alloa,4953,4,17,8,11,56,46,10,59
Stranraer,4953,5,16,5,15,57,65,-8,53
Airdrieon,4953,6,11,11,14,48,59,-11,44
East Fife,4953,7,13,3,20,48,66,-18,42
Forfar,4953,8,10,5,21,39,67,-28,35
Albion,4953,9,8,7,21,59,80,-21,31
Queen's Park,4953,10,6,10,20,39,75,-36,28
Ayr,4954,1,24,4,8,93,42,51,76
Raith,4954,2,22,9,5,69,33,36,75
Arbroath,4954,3,17,9,10,70,48,22,60
Alloa,4954,4,17,9,10,57,44,13,60
Stranraer,4954,5,15,5,16,57,68,-11,50
East Fife,4954,6,14,3,19,51,66,-15,45
Airdrieon,4954,7,10,12,14,45,58,-13,42
Forfar,4954,8,10,6,20,38,64,-26,36
Albion,4954,9,8,6,22,57,81,-24,30
Queen's Park,4954,10,6,11,19,39,72,-33,29
Raith,4955,1,23,8,5,69,32,37,77
Ayr,4955,2,24,4,8,94,44,50,76
Arbroath,4955,3,18,8,10,73,49,24,62
Alloa,4955,4,17,8,11,56,44,12,59
Stranraer,4955,5,15,5,16,55,65,-10,50
East Fife,4955,6,14,3,19,48,64,-16,45
Airdrieon,4955,7,11,11,14,47,58,-11,44
Forfar,4955,8,10,5,21,38,66,-28,35
Albion,4955,9,8,6,22,59,82,-23,30
Queen's Park,4955,10,6,10,20,40,75,-35,28
Raith,4956,1,23,8,5,69,32,37,77
Ayr,4956,2,24,4,8,95,45,50,76
Arbroath,4956,3,17,9,10,71,49,22,60
Alloa,4956,4,17,8,11,56,44,12,59
Stranraer,4956,5,15,5,16,55,67,-12,50
East Fife,4956,6,14,3,19,50,64,-14,45
Airdrieon,4956,7,11,11,14,48,60,-12,44
Forfar,4956,8,10,5,21,40,67,-27,35
Albion,4956,9,8,6,22,60,83,-23,30
Queen's Park,4956,10,6,11,19,40,73,-33,29
Ayr,4957,1,24,4,8,95,43,52,76
Raith,4957,2,22,9,5,70,34,36,75
Arbroath,4957,3,18,8,10,74,50,24,62
Alloa,4957,4,17,9,10,58,45,13,60
Stranraer,4957,5,15,5,16,55,66,-11,50
East Fife,4957,6,14,3,19,49,64,-15,45
Airdrieon,4957,7,11,11,14,47,59,-12,44
Forfar,4957,8,10,5,21,39,66,-27,35
Albion,4957,9,8,6,22,58,83,-25,30
Queen's Park,4957,10,6,10,20,41,76,-35,28
Raith,4958,1,23,8,5,70,32,38,77
Ayr,4958,2,24,4,8,95,44,51,76
Arbroath,4958,3,17,8,11,70,50,20,59
Alloa,4958,4,17,8,11,56,45,11,59
Stranraer,4958,5,15,5,16,58,68,-10,50
East Fife,4958,6,14,3,19,51,67,-16,45
Airdrieon,4958,7,11,11,14,48,60,-12,44
Forfar,4958,8,10,5,21,40,67,-27,35
Queen's Park,4958,9,7,10,19,41,72,-31,31
Albion,4958,10,8,6,22,59,83,-24,30
Ayr,4959,1,24,4,8,96,42,54,76
Raith,4959,2,22,8,6,69,34,35,74
Alloa,4959,3,18,8,10,58,44,14,62
Arbroath,4959,4,17,9,10,71,49,22,60
Stranraer,4959,5,15,6,15,57,66,-9,51
Airdrieon,4959,6,11,11,14,47,58,-11,44
East Fife,4959,7,13,4,19,49,66,-17,43
Forfar,4959,8,10,5,21,38,66,-28,35
Albion,4959,9,8,6,22,57,84,-27,30
Queen's Park,4959,10,6,11,19,40,73,-33,29
Raith,4960,1,23,8,5,71,32,39,77
Ayr,4960,2,24,4,8,94,43,51,76
Arbroath,4960,3,17,8,11,72,51,21,59
Alloa,4960,4,17,8,11,56,46,10,59
Stranraer,4960,5,15,6,15,56,65,-9,51
Airdrieon,4960,6,11,11,14,46,58,-12,44
East Fife,4960,7,13,4,19,48,65,-17,43
Forfar,4960,8,10,5,21,38,65,-27,35
Queen's Park,4960,9,7,10,19,42,74,-32,31
Albion,4960,10,8,6,22,58,82,-24,30
Ayr,4961,1,24,4,8,94,44,50,76
Raith,4961,2,22,9,5,68,32,36,75
Alloa,4961,3,17,9,10,56,43,13,60
Arbroath,4961,4,17,8,11,71,50,21,59
Stranraer,4961,5,16,5,15,59,67,-8,53
East Fife,4961,6,13,3,20,50,68,-18,42
Airdrieon,4961,7,10,11,15,45,59,-14,41
Forfar,4961,8,11,5,20,39,64,-25,38
Queen's Park,4961,9,7,10,19,41,73,-32,31
Albion,4961,10,8,6,22,59,82,-23,30
Raith,4962,1,23,8,5,72,32,40,77
Ayr,4962,2,23,5,8,92,44,48,74
Arbroath,4962,3,18,8,10,72,49,23,62
Alloa,4962,4,17,8,11,56,47,9,59
Stranraer,4962,5,15,6,15,56,65,-9,51
East Fife,4962,6,13,4,19,48,65,-17,43
Airdrieon,4962,7,10,12,14,47,60,-13,42
Forfar,4962,8,10,6,20,40,66,-26,36
Albion,4962,9,8,7,21,59,80,-21,31
Queen's Park,4962,10,6,10,20,40,74,-34,28
Ayr,4963,1,24,4,8,93,44,49,76
Raith,4963,2,22,9,5,68,32,36,75
Arbroath,4963,3,18,8,10,72,48,24,62
Alloa,4963,4,17,9,10,56,43,13,60
Stranraer,4963,5,16,5,15,58,65,-7,53
Airdrieon,4963,6,11,11,14,50,60,-10,44
East Fife,4963,7,13,3,20,48,67,-19,42
Forfar,4963,8,10,5,21,40,69,-29,35
Albion,4963,9,8,6,22,59,81,-22,30
Queen's Park,4963,10,6,10,20,39,74,-35,28
Raith,4964,1,23,8,5,70,32,38,77
Ayr,4964,2,24,4,8,95,44,51,76
Arbroath,4964,3,18,8,10,74,48,26,62
Alloa,4964,4,17,8,11,56,45,11,59
Stranraer,4964,5,16,5,15,59,64,-5,53
Airdrieon,4964,6,11,11,14,46,58,-12,44
East Fife,4964,7,13,3,20,47,68,-21,42
Forfar,4964,8,10,5,21,38,65,-27,35
Albion,4964,9,8,6,22,59,83,-24,30
Queen's Park,4964,10,6,10,20,39,76,-37,28
Ayr,4965,1,24,4,8,93,42,51,76
Raith,4965,2,22,8,6,69,34,35,74
Arbroath,4965,3,18,8,10,74,49,25,62
Alloa,4965,4,18,8,10,58,44,14,62
Stranraer,4965,5,15,6,15,55,64,-9,51
East Fife,4965,6,13,4,19,47,64,-17,43
Airdrieon,4965,7,10,11,15,45,59,-14,41
Forfar,4965,8,11,5,20,39,64,-25,38
Albion,4965,9,8,6,22,57,81,-24,30
Queen's Park,4965,10,6,10,20,40,76,-36,28
Ayr,4966,1,24,4,8,95,43,52,76
Raith,4966,2,22,8,6,69,34,35,74
Alloa,4966,3,18,8,10,58,44,14,62
Arbroath,4966,4,17,8,11,70,50,20,59
Stranraer,4966,5,15,6,15,56,65,-9,51
Airdrieon,4966,6,11,11,14,47,58,-11,44
East Fife,4966,7,13,4,19,48,65,-17,43
Forfar,4966,8,10,5,21,38,66,-28,35
Queen's Park,4966,9,7,10,19,41,72,-31,31
Albion,4966,10,8,6,22,58,83,-25,30
Raith,4967,1,23,8,5,71,33,38,77
Ayr,4967,2,24,4,8,94,43,51,76
Arbroath,4967,3,17,8,11,71,50,21,59
Alloa,4967,4,17,8,11,57,46,11,59
Stranraer,4967,5,15,5,16,55,67,-12,50
East Fife,4967,6,14,3,19,50,64,-14,45
Airdrieon,4967,7,10,12,14,46,59,-13,42
Forfar,4967,8,10,6,20,39,65,-26,36
Queen's Park,4967,9,7,10,19,41,73,-32,31
Albion,4967,10,8,6,22,58,82,-24,30
Raith,4968,1,23,8,5,70,32,38,77
Ayr,4968,2,24,4,8,92,43,49,76
Arbroath,4968,3,17,9,10,73,51,22,60
Alloa,4968,4,17,8,11,56,45,11,59
Stranraer,4968,5,15,6,15,58,67,-9,51
Airdrieon,4968,6,11,11,14,49,58,-9,44
East Fife,4968,7,13,4,19,50,67,-17,43
Forfar,4968,8,10,5,21,38,68,-30,35
Albion,4968,9,8,6,22,58,80,-22,30
Queen's Park,4968,10,6,11,19,42,75,-33,29
Raith,4969,1,23,8,5,70,33,37,77
Ayr,4969,2,24,4,8,94,43,51,76
Arbroath,4969,3,17,9,10,71,49,22,60
Alloa,4969,4,17,8,11,57,45,12,59
Stranraer,4969,5,15,5,16,55,65,-10,50
East Fife,4969,6,14,3,19,48,64,-16,45
Airdrieon,4969,7,11,11,14,47,59,-12,44
Forfar,4969,8,10,5,21,39,66,-27,35
Albion,4969,9,8,6,22,58,82,-24,30
Queen's Park,4969,10,6,11,19,40,73,-33,29
Raith,4970,1,22,9,5,69,33,36,75
Ayr,4970,2,23,4,9,91,46,45,73
Arbroath,4970,3,18,8,10,74,50,24,62
Alloa,4970,4,17,9,10,57,44,13,60
Stranraer,4970,5,15,5,16,56,68,-12,50
East Fife,4970,6,14,3,19,51,65,-14,45
Airdrieon,4970,7,10,11,15,45,59,-14,41
Forfar,4970,8,11,5,20,39,64,-25,38
Albion,4970,9,9,6,21,61,79,-18,33
Queen's Park,4970,10,6,10,20,41,76,-35,28
Raith,4971,1,23,8,5,70,33,37,77
Ayr,4971,2,24,4,8,92,42,50,76
Arbroath,4971,3,17,8,11,72,51,21,59
Alloa,4971,4,17,8,11,57,45,12,59
Stranraer,4971,5,15,6,15,59,68,-9,51
Airdrieon,4971,6,11,11,14,46,58,-12,44
East Fife,4971,7,13,4,19,51,68,-17,43
Forfar,4971,8,10,5,21,38,65,-27,35
Queen's Park,4971,9,7,10,19,42,74,-32,31
Albion,4971,10,8,6,22,57,80,-23,30
Ayr,4972,1,24,4,8,95,45,50,76
Raith,4972,2,22,9,5,70,34,36,75
Arbroath,4972,3,18,8,10,74,48,26,62
Alloa,4972,4,17,9,10,58,45,13,60
Stranraer,4972,5,15,5,16,55,65,-10,50
East Fife,4972,6,14,3,19,48,64,-16,45
Airdrieon,4972,7,11,11,14,47,58,-11,44
Forfar,4972,8,10,5,21,38,66,-28,35
Albion,4972,9,8,6,22,60,83,-23,30
Queen's Park,4972,10,6,10,20,39,76,-37,28
Raith,4973,1,23,8,5,71,33,38,77
Ayr,4973,2,24,4,8,97,42,55,76
Arbroath,4973,3,17,8,11,71,50,21,59
Alloa,4973,4,17,8,11,57,46,11,59
Stranraer,4973,5,15,5,16,57,68,-11,50
East Fife,4973,6,14,3,19,51,66,-15,45
Airdrieon,4973,7,11,11,14,48,58,-10,44
Forfar,4973,8,10,5,21,38,67,-29,35
Queen's Park,4973,9,7,10,19,41,73,-32,31
Albion,4973,10,8,6,22,57,85,-28,30
Raith,4974,1,23,8,5,69,32,37,77
Ayr,4974,2,24,4,8,96,46,50,76
Arbroath,4974,3,17,9,10,70,48,22,60
Alloa,4974,4,17,8,11,56,44,12,59
Stranraer,4974,5,15,5,16,56,67,-11,50
East Fife,4974,6,14,3,19,50,65,-15,45
Airdrieon,4974,7,11,11,14,49,60,-11,44
Forfar,4974,8,10,5,21,40,68,-28,35
Albion,4974,9,8,6,22,61,84,-23,30
Queen's Park,4974,10,6,11,19,39,72,-33,29
Raith,4975,1,23,8,5,69,32,37,77
Ayr,4975,2,24,4,8,92,43,49,76
Arbroath,4975,3,18,8,10,72,48,24,62
Alloa,4975,4,17,8,11,56,44,12,59
Stranraer,4975,5,16,5,15,56,64,-8,53
Airdrieon,4975,6,11,11,14,48,59,-11,44
East Fife,4975,7,13,3,20,47,65,-18,42
Forfar,4975,8,10,5,21,39,67,-28,35
Albion,4975,9,8,6,22,58,80,-22,30
Queen's Park,4975,10,6,10,20,39,74,-35,28
Ayr,4976,1,24,4,8,96,44,52,76
Raith,4976,2,22,8,6,69,35,34,74
Alloa,4976,3,18,8,10,59,44,15,62
Arbroath,4976,4,17,8,11,71,50,21,59
Stranraer,4976,5,16,5,15,56,64,-8,53
Airdrieon,4976,6,11,11,14,48,59,-11,44
East Fife,4976,7,13,3,20,47,65,-18,42
Forfar,4976,8,10,5,21,39,67,-28,35
Queen's Park,4976,9,7,10,19,41,73,-32,31
Albion,4976,10,8,6,22,59,84,-25,30
Raith,4977,1,23,8,5,70,32,38,77
Ayr,4977,2,24,4,8,93,43,50,76
Arbroath,4977,3,17,8,11,73,53,20,59
Alloa,4977,4,17,8,11,56,45,11,59
Stranraer,4977,5,15,5,16,57,68,-11,50
East Fife,4977,6,14,3,19,51,66,-15,45
Airdrieon,4977,7,10,12,14,46,59,-13,42
Forfar,4977,8,10,6,20,39,65,-26,36
Queen's Park,4977,9,7,10,19,44,75,-31,31
Albion,4977,10,8,6,22,58,81,-23,30
Raith,4978,1,23,8,5,72,32,40,77
Ayr,4978,2,24,4,8,96,42,54,76
Arbroath,4978,3,18,8,10,73,49,24,62
Alloa,4978,4,17,8,11,56,47,9,59
Stranraer,4978,5,15,5,16,56,66,-10,50
East Fife,4978,6,14,3,19,49,65,-16,45
Airdrieon,4978,7,11,11,14,47,58,-11,44
Forfar,4978,8,10,5,21,38,66,-28,35
Albion,4978,9,8,6,22,57,84,-27,30
Queen's Park,4978,10,6,10,20,40,75,-35,28
Raith,4979,1,23,8,5,70,33,37,77
Ayr,4979,2,24,4,8,93,42,51,76
Arbroath,4979,3,17,8,11,72,52,20,59
Alloa,4979,4,17,8,11,57,45,12,59
Stranraer,4979,5,15,5,16,56,67,-11,50
East Fife,4979,6,14,3,19,50,65,-15,45
Airdrieon,4979,7,10,12,14,46,59,-13,42
Forfar,4979,8,10,6,20,39,65,-26,36
Queen's Park,4979,9,7,10,19,43,74,-31,31
Albion,4979,10,8,6,22,57,81,-24,30
Raith,4980,1,23,8,5,72,32,40,77
Ayr,4980,2,24,4,8,97,46,51,76
Arbroath,4980,3,17,9,10,71,49,22,60
Alloa,4980,4,17,8,11,56,47,9,59
Stranraer,4980,5,15,5,16,55,68,-13,50
East Fife,4980,6,14,3,19,51,64,-13,45
Airdrieon,4980,7,11,11,14,46,58,-12,44
Forfar,4980,8,10,5,21,38,65,-27,35
Albion,4980,9,8,6,22,61,85,-24,30
Queen's Park,4980,10,6,11,19,40,73,-33,29
Raith,4981,1,23,8,5,71,32,39,77
Ayr,4981,2,24,4,8,94,43,51,76
Arbroath,4981,3,18,8,10,73,50,23,62
Alloa,4981,4,17,8,11,56,46,10,59
Stranraer,4981,5,15,6,15,57,66,-9,51
Airdrieon,4981,6,11,11,14,48,58,-10,44
East Fife,4981,7,13,4,19,49,66,-17,43
Forfar,4981,8,10,5,21,38,67,-29,35
Albion,4981,9,8,6,22,58,82,-24,30
Queen's Park,4981,10,6,10,20,41,75,-34,28
Raith,4982,1,23,8,5,70,33,37,77
Ayr,4982,2,24,4,8,97,44,53,76
Arbroath,4982,3,17,8,11,72,51,21,59
Alloa,4982,4,17,8,11,57,45,12,59
Stranraer,4982,5,16,5,15,57,65,-8,53
Airdrieon,4982,6,11,11,14,46,58,-12,44
East Fife,4982,7,13,3,20,48,66,-18,42
Forfar,4982,8,10,5,21,38,65,-27,35
Queen's Park,4982,9,7,10,19,42,74,-32,31
Albion,4982,10,8,6,22,59,85,-26,30
Raith,4983,1,23,8,5,70,33,37,77
Ayr,4983,2,24,4,8,94,43,51,76
Arbroath,4983,3,17,8,11,71,51,20,59
Alloa,4983,4,17,8,11,57,45,12,59
Stranraer,4983,5,16,5,15,57,65,-8,53
Airdrieon,4983,6,11,11,14,47,58,-11,44
East Fife,4983,7,13,3,20,48,66,-18,42
Forfar,4983,8,10,5,21,38,66,-28,35
Queen's Park,4983,9,7,10,19,42,73,-31,31
Albion,4983,10,8,6,22,58,82,-24,30
Raith,4984,1,23,8,5,71,32,39,77
Ayr,4984,2,24,4,8,94,42,52,76
Arbroath,4984,3,17,9,10,72,50,22,60
Alloa,4984,4,17,8,11,56,46,10,59
Stranraer,4984,5,16,5,15,58,65,-7,53
East Fife,4984,6,13,3,20,48,67,-19,42
Airdrieon,4984,7,10,11,15,45,59,-14,41
Forfar,4984,8,11,5,20,39,64,-25,38
Albion,4984,9,8,6,22,57,82,-25,30
Queen's Park,4984,10,6,11,19,41,74,-33,29
Raith,4985,1,22,9,5,69,33,36,75
Ayr,4985,2,23,5,8,93,45,48,74
Arbroath,4985,3,18,8,10,74,49,25,62
Alloa,4985,4,17,9,10,57,44,13,60
Stranraer,4985,5,15,5,16,56,68,-12,50
East Fife,4985,6,14,3,19,51,65,-14,45
Airdrieon,4985,7,11,11,14,47,58,-11,44
Forfar,4985,8,10,5,21,38,66,-28,35
Albion,4985,9,8,7,21,60,81,-21,31
Queen's Park,4985,10,6,10,20,40,76,-36,28
Raith,4986,1,23,8,5,70,33,37,77
Ayr,4986,2,24,4,8,94,44,50,76
Arbroath,4986,3,18,8,10,72,49,23,62
Alloa,4986,4,17,8,11,57,45,12,59
Stranraer,4986,5,15,6,15,58,67,-9,51
Airdrieon,4986,6,11,11,14,48,59,-11,44
East Fife,4986,7,13,4,19,50,67,-17,43
Forfar,4986,8,10,5,21,39,67,-28,35
Albion,4986,9,8,6,22,59,82,-23,30
Queen's Park,4986,10,6,10,20,40,74,-34,28
Raith,4987,1,23,8,5,70,32,38,77
Ayr,4987,2,24,4,8,98,44,54,76
Arbroath,4987,3,17,9,10,70,48,22,60
Alloa,4987,4,17,8,11,56,45,11,59
Stranraer,4987,5,15,5,16,57,67,-10,50
East Fife,4987,6,14,3,19,50,66,-16,45
Airdrieon,4987,7,11,11,14,47,58,-11,44
Forfar,4987,8,10,5,21,38,66,-28,35
Albion,4987,9,8,6,22,59,86,-27,30
Queen's Park,4987,10,6,11,19,39,72,-33,29
Ayr,4988,1,24,4,8,96,44,52,76
Raith,4988,2,22,9,5,69,33,36,75
Arbroath,4988,3,18,8,10,71,48,23,62
Alloa,4988,4,17,9,10,57,44,13,60
Stranraer,4988,5,15,5,16,55,67,-12,50
East Fife,4988,6,14,3,19,50,64,-14,45
Airdrieon,4988,7,10,12,14,45,58,-13,42
Forfar,4988,8,10,6,20,38,64,-26,36
Albion,4988,9,8,6,22,59,84,-25,30
Queen's Park,4988,10,6,10,20,39,73,-34,28
Raith,4989,1,23,8,5,70,32,38,77
Ayr,4989,2,24,4,8,92,43,49,76
Arbroath,4989,3,18,8,10,73,48,25,62
Alloa,4989,4,17,8,11,56,45,11,59
Stranraer,4989,5,16,5,15,60,64,-4,53
Airdrieon,4989,6,10,12,14,46,59,-13,42
East Fife,4989,7,13,3,20,47,69,-22,42
Forfar,4989,8,10,6,20,39,65,-26,36
Albion,4989,9,8,6,22,58,80,-22,30
Queen's Park,4989,10,6,10,20,39,75,-36,28
Ayr,4990,1,24,4,8,94,44,50,76
Raith,4990,2,22,9,5,68,32,36,75
Alloa,4990,3,17,9,10,56,43,13,60
Arbroath,4990,4,17,8,11,72,51,21,59
Stranraer,4990,5,15,5,16,56,66,-10,50
East Fife,4990,6,14,3,19,49,65,-16,45
Airdrieon,4990,7,10,11,15,45,59,-14,41
Forfar,4990,8,11,5,20,39,64,-25,38
Queen's Park,4990,9,7,10,19,42,74,-32,31
Albion,4990,10,8,6,22,59,82,-23,30
Ayr,4991,1,24,4,8,94,42,52,76
Raith,4991,2,22,9,5,68,32,36,75
Alloa,4991,3,17,9,10,56,43,13,60
Arbroath,4991,4,17,8,11,70,49,21,59
Stranraer,4991,5,15,5,16,56,67,-11,50
East Fife,4991,6,14,3,19,50,65,-15,45
Airdrieon,4991,7,10,12,14,45,58,-13,42
Forfar,4991,8,10,6,20,38,64,-26,36
Queen's Park,4991,9,7,10,19,40,72,-32,31
Albion,4991,10,8,6,22,57,82,-25,30
Ayr,4992,1,24,4,8,93,43,50,76
Raith,4992,2,22,9,5,68,32,36,75
Alloa,4992,3,17,9,10,56,43,13,60
Arbroath,4992,4,17,8,11,70,50,20,59
Stranraer,4992,5,15,5,16,55,67,-12,50
East Fife,4992,6,14,3,19,50,64,-14,45
Airdrieon,4992,7,11,11,14,48,60,-12,44
Forfar,4992,8,10,5,21,40,67,-27,35
Queen's Park,4992,9,7,10,19,41,72,-31,31
Albion,4992,10,8,6,22,58,81,-23,30
Raith,4993,1,22,9,5,69,33,36,75
Ayr,4993,2,23,4,9,90,44,46,73
Arbroath,4993,3,17,9,10,71,49,22,60
Alloa,4993,4,17,9,10,57,44,13,60
Stranraer,4993,5,16,5,15,58,66,-8,53
Airdrieon,4993,6,11,11,14,46,58,-12,44
East Fife,4993,7,13,3,20,49,67,-18,42
Forfar,4993,8,10,5,21,38,65,-27,35
Albion,4993,9,9,6,21,59,78,-19,33
Queen's Park,4993,10,6,11,19,40,73,-33,29
Raith,4994,1,23,8,5,71,33,38,77
Ayr,4994,2,23,5,8,92,44,48,74
Arbroath,4994,3,18,8,10,72,48,24,62
Alloa,4994,4,17,8,11,57,46,11,59
Stranraer,4994,5,15,5,16,56,67,-11,50
East Fife,4994,6,14,3,19,50,65,-15,45
Airdrieon,4994,7,11,11,14,48,59,-11,44
Forfar,4994,8,10,5,21,39,67,-28,35
Albion,4994,9,8,7,21,59,80,-21,31
Queen's Park,4994,10,6,10,20,39,74,-35,28
Ayr,4995,1,24,4,8,94,44,50,76
Raith,4995,2,22,8,6,69,34,35,74
Arbroath,4995,3,18,8,10,74,48,26,62
Alloa,4995,4,18,8,10,58,44,14,62
Stranraer,4995,5,15,6,15,57,66,-9,51
Airdrieon,4995,6,11,11,14,46,58,-12,44
East Fife,4995,7,13,4,19,49,66,-17,43
Forfar,4995,8,10,5,21,38,65,-27,35
Albion,4995,9,8,6,22,59,82,-23,30
Queen's Park,4995,10,6,10,20,39,76,-37,28
Raith,4996,1,23,8,5,69,32,37,77
Ayr,4996,2,24,4,8,92,42,50,76
Arbroath,4996,3,17,9,10,70,48,22,60
Alloa,4996,4,17,8,11,56,44,12,59
Stranraer,4996,5,15,5,16,57,67,-10,50
East Fife,4996,6,14,3,19,50,66,-16,45
Airdrieon,4996,7,10,12,14,46,59,-13,42
Forfar,4996,8,10,6,20,39,65,-26,36
Albion,4996,9,8,6,22,57,80,-23,30
Queen's Park,4996,10,6,11,19,39,72,-33,29
Raith,4997,1,23,8,5,71,32,39,77
Ayr,4997,2,24,4,8,94,42,52,76
Arbroath,4997,3,18,8,10,73,49,24,62
Alloa,4997,4,17,8,11,56,46,10,59
Stranraer,4997,5,15,5,16,58,68,-10,50
East Fife,4997,6,14,3,19,51,67,-16,45
Airdrieon,4997,7,10,12,14,48,61,-13,42
Forfar,4997,8,10,6,20,41,67,-26,36
Albion,4997,9,8,6,22,57,82,-25,30
Queen's Park,4997,10,6,10,20,40,75,-35,28
Raith,4998,1,23,8,5,70,32,38,77
Ayr,4998,2,24,4,8,95,43,52,76
Arbroath,4998,3,17,9,10,71,49,22,60
Alloa,4998,4,17,8,11,56,45,11,59
Stranraer,4998,5,15,5,16,57,67,-10,50
East Fife,4998,6,14,3,19,50,66,-16,45
Airdrieon,4998,7,11,11,14,46,58,-12,44
Forfar,4998,8,10,5,21,38,65,-27,35
Albion,4998,9,8,6,22,58,83,-25,30
Queen's Park,4998,10,6,11,19,40,73,-33,29
Raith,4999,1,23,8,5,69,32,37,77
Ayr,4999,2,24,4,8,93,42,51,76
Arbroath,4999,3,18,8,10,73,48,25,62
Alloa,4999,4,17,8,11,56,44,12,59
Stranraer,4999,5,16,5,15,57,65,-8,53
Airdrieon,4999,6,11,11,14,49,58,-9,44
East Fife,4999,7,13,3,20,48,66,-18,42
Forfar,4999,8,10,5,21,38,68,-30,35
Albion,4999,9,8,6,22,57,81,-24,30
Queen's Park,4999,10,6,10,20,39,75,-36,28
Ayr,5000,1,24,4,8,92,42,50,76
Raith,5000,2,22,9,5,69,33,36,75
Arbroath,5000,3,18,8,10,72,48,24,62
Alloa,5000,4,17,9,10,57,44,13,60
Stranraer,5000,5,16,5,15,58,64,-6,53
Airdrieon,5000,6,10,12,14,46,59,-13,42
East Fife,5000,7,13,3,20,47,67,-20,42
Forfar,5000,8,10,6,20,39,65,-26,36
Albion,5000,9,8,6,22,57,80,-23,30
Queen's Park,5000,10,6,10,20,39,74,-35,28
Ayr,5001,1,24,4,8,94,44,50,76
Raith,5001,2,22,8,6,69,36,33,74
Arbroath,5001,3,18,8,10,75,50,25,62
Alloa,5001,4,18,8,10,60,44,16,62
Stranraer,5001,5,16,5,15,57,64,-7,53
East Fife,5001,6,13,3,20,47,66,-19,42
Airdrieon,5001,7,10,11,15,45,60,-15,41
Forfar,5001,8,11,5,20,40,64,-24,38
Albion,5001,9,8,6,22,59,82,-23,30
Queen's Park,5001,10,6,10,20,41,77,-36,28
Raith,5002,1,23,8,5,70,32,38,77
Ayr,5002,2,24,4,8,93,44,49,76
Arbroath,5002,3,17,9,10,72,50,22,60
Alloa,5002,4,17,8,11,56,45,11,59
Stranraer,5002,5,16,5,15,58,65,-7,53
Airdrieon,5002,6,11,11,14,47,58,-11,44
East Fife,5002,7,13,3,20,48,67,-19,42
Forfar,5002,8,10,5,21,38,66,-28,35
Albion,5002,9,8,6,22,59,81,-22,30
Queen's Park,5002,10,6,11,19,41,74,-33,29
Raith,5003,1,23,8,5,72,35,37,77
Ayr,5003,2,24,4,8,96,43,53,76
Arbroath,5003,3,18,8,10,74,51,23,62
Alloa,5003,4,17,8,11,59,47,12,59
Stranraer,5003,5,15,6,15,55,64,-9,51
Airdrieon,5003,6,11,11,14,46,58,-12,44
East Fife,5003,7,13,4,19,47,64,-17,43
Forfar,5003,8,10,5,21,38,65,-27,35
Albion,5003,9,8,6,22,58,84,-26,30
Queen's Park,5003,10,6,10,20,42,76,-34,28
Ayr,5004,1,24,4,8,95,45,50,76
Raith,5004,2,22,9,5,69,33,36,75
Alloa,5004,3,17,9,10,57,44,13,60
Arbroath,5004,4,17,8,11,70,50,20,59
Stranraer,5004,5,15,5,16,56,68,-12,50
East Fife,5004,6,14,3,19,51,65,-14,45
Airdrieon,5004,7,11,11,14,49,58,-9,44
Forfar,5004,8,10,5,21,38,68,-30,35
Queen's Park,5004,9,7,10,19,41,72,-31,31
Albion,5004,10,8,6,22,60,83,-23,30
Raith,5005,1,23,8,5,70,33,37,77
Ayr,5005,2,24,4,8,92,42,50,76
Arbroath,5005,3,17,9,10,72,50,22,60
Alloa,5005,4,17,8,11,57,45,12,59
Stranraer,5005,5,15,5,16,55,65,-10,50
East Fife,5005,6,14,3,19,48,64,-16,45
Airdrieon,5005,7,11,11,14,47,58,-11,44
Forfar,5005,8,10,5,21,38,66,-28,35
Albion,5005,9,8,6,22,57,80,-23,30
Queen's Park,5005,10,6,11,19,41,74,-33,29
Raith,5006,1,23,8,5,70,33,37,77
Ayr,5006,2,23,5,8,91,43,48,74
Arbroath,5006,3,18,8,10,73,48,25,62
Alloa,5006,4,17,8,11,57,45,12,59
Stranraer,5006,5,15,6,15,56,65,-9,51
East Fife,5006,6,13,4,19,48,65,-17,43
Airdrieon,5006,7,10,12,14,45,58,-13,42
Forfar,5006,8,10,6,20,38,64,-26,36
Albion,5006,9,8,7,21,58,79,-21,31
Queen's Park,5006,10,6,10,20,39,75,-36,28
Ayr,5007,1,24,4,8,95,43,52,76
Raith,5007,2,22,8,6,68,34,34,74
Arbroath,5007,3,18,8,10,73,50,23,62
Alloa,5007,4,18,8,10,58,43,15,62
Stranraer,5007,5,15,6,15,57,66,-9,51
Airdrieon,5007,6,11,11,14,49,58,-9,44
East Fife,5007,7,13,4,19,49,66,-17,43
Forfar,5007,8,10,5,21,38,68,-30,35
Albion,5007,9,8,6,22,58,83,-25,30
Queen's Park,5007,10,6,10,20,41,75,-34,28
Ayr,5008,1,24,4,8,96,42,54,76
Raith,5008,2,22,9,5,68,32,36,75
Arbroath,5008,3,18,8,10,72,48,24,62
Alloa,5008,4,17,9,10,56,43,13,60
Stranraer,5008,5,16,5,15,60,65,-5,53
Airdrieon,5008,6,11,11,14,48,58,-10,44
East Fife,5008,7,13,3,20,48,69,-21,42
Forfar,5008,8,10,5,21,38,67,-29,35
Albion,5008,9,8,6,22,57,84,-27,30
Queen's Park,5008,10,6,10,20,39,74,-35,28
Raith,5009,1,23,8,5,71,32,39,77
Ayr,5009,2,24,4,8,91,42,49,76
Arbroath,5009,3,17,8,11,70,49,21,59
Alloa,5009,4,17,8,11,56,46,10,59
Stranraer,5009,5,15,5,16,56,67,-11,50
East Fife,5009,6,14,3,19,50,65,-15,45
Airdrieon,5009,7,11,11,14,48,58,-10,44
Forfar,5009,8,10,5,21,38,67,-29,35
Queen's Park,5009,9,7,10,19,40,72,-32,31
Albion,5009,10,8,6,22,57,79,-22,30
Raith,5010,1,22,9,5,70,34,36,75
Ayr,5010,2,23,5,8,94,46,48,74
Arbroath,5010,3,17,9,10,71,49,22,60
Alloa,5010,4,17,9,10,58,45,13,60
Stranraer,5010,5,16,5,15,57,65,-8,53
Airdrieon,5010,6,10,12,14,46,59,-13,42
East Fife,5010,7,13,3,20,48,66,-18,42
Forfar,5010,8,10,6,20,39,65,-26,36
Albion,5010,9,8,7,21,61,82,-21,31
Queen's Park,5010,10,6,11,19,40,73,-33,29
Raith,5011,1,23,8,5,70,33,37,77
Ayr,5011,2,23,5,8,91,43,48,74
Arbroath,5011,3,17,8,11,70,49,21,59
Alloa,5011,4,17,8,11,57,45,12,59
Stranraer,5011,5,15,6,15,57,66,-9,51
Airdrieon,5011,6,11,11,14,48,60,-12,44
East Fife,5011,7,13,4,19,49,66,-17,43
Forfar,5011,8,10,5,21,40,67,-27,35
Albion,5011,9,8,7,21,58,79,-21,31
Queen's Park,5011,10,7,10,19,40,72,-32,31
Ayr,5012,1,24,4,8,92,43,49,76
Raith,5012,2,22,9,5,68,32,36,75
Arbroath,5012,3,18,8,10,73,48,25,62
Alloa,5012,4,17,9,10,56,43,13,60
Stranraer,5012,5,16,5,15,59,66,-7,53
Airdrieon,5012,6,10,12,14,47,60,-13,42
East Fife,5012,7,13,3,20,49,68,-19,42
Forfar,5012,8,10,6,20,40,66,-26,36
Albion,5012,9,8,6,22,58,80,-22,30
Queen's Park,5012,10,6,10,20,39,75,-36,28
Raith,5013,1,23,8,5,71,32,39,77
Ayr,5013,2,24,4,8,92,43,49,76
Arbroath,5013,3,17,8,11,72,53,19,59
Alloa,5013,4,17,8,11,56,46,10,59
Stranraer,5013,5,15,5,16,55,66,-11,50
East Fife,5013,6,14,3,19,49,64,-15,45
Airdrieon,5013,7,10,12,14,46,59,-13,42
Forfar,5013,8,10,6,20,39,65,-26,36
Queen's Park,5013,9,7,10,19,44,74,-30,31
Albion,5013,10,8,6,22,58,80,-22,30
Raith,5014,1,23,8,5,69,32,37,77
Ayr,5014,2,24,4,8,93,42,51,76
Arbroath,5014,3,18,8,10,73,50,23,62
Alloa,5014,4,17,8,11,56,44,12,59
Stranraer,5014,5,16,5,15,56,64,-8,53
East Fife,5014,6,13,3,20,47,65,-18,42
Airdrieon,5014,7,10,11,15,46,61,-15,41
Forfar,5014,8,11,5,20,41,65,-24,38
Albion,5014,9,8,6,22,57,81,-24,30
Queen's Park,5014,10,6,10,20,41,75,-34,28
Raith,5015,1,22,9,5,68,32,36,75
Ayr,5015,2,23,4,9,91,44,47,73
Arbroath,5015,3,17,9,10,71,49,22,60
Alloa,5015,4,17,9,10,56,43,13,60
Stranraer,5015,5,15,5,16,56,66,-10,50
East Fife,5015,6,14,3,19,49,65,-16,45
Airdrieon,5015,7,10,11,15,47,61,-14,41
Forfar,5015,8,11,5,20,41,66,-25,38
Albion,5015,9,9,6,21,59,79,-20,33
Queen's Park,5015,10,6,11,19,40,73,-33,29
Raith,5016,1,23,8,5,71,33,38,77
Ayr,5016,2,24,4,8,93,42,51,76
Arbroath,5016,3,18,8,10,72,48,24,62
Alloa,5016,4,17,8,11,57,46,11,59
Stranraer,5016,5,15,5,16,56,66,-10,50
East Fife,5016,6,14,3,19,49,65,-16,45
Airdrieon,5016,7,10,12,14,45,58,-13,42
Forfar,5016,8,10,6,20,38,64,-26,36
Albion,5016,9,8,6,22,57,81,-24,30
Queen's Park,5016,10,6,10,20,39,74,-35,28
Ayr,5017,1,24,4,8,93,42,51,76
Raith,5017,2,22,9,5,69,33,36,75
Arbroath,5017,3,18,8,10,73,50,23,62
Alloa,5017,4,17,9,10,57,44,13,60
Stranraer,5017,5,16,5,15,59,64,-5,53
East Fife,5017,6,13,3,20,47,68,-21,42
Airdrieon,5017,7,10,11,15,45,59,-14,41
Forfar,5017,8,11,5,20,39,64,-25,38
Albion,5017,9,8,6,22,57,81,-24,30
Queen's Park,5017,10,6,10,20,41,75,-34,28
Ayr,5018,1,24,4,8,96,42,54,76
Raith,5018,2,22,8,6,70,35,35,74
Alloa,5018,3,18,8,10,59,45,14,62
Arbroath,5018,4,17,9,10,71,49,22,60
Stranraer,5018,5,15,5,16,57,67,-10,50
East Fife,5018,6,14,3,19,50,66,-16,45
Airdrieon,5018,7,10,12,14,46,59,-13,42
Forfar,5018,8,10,6,20,39,65,-26,36
Albion,5018,9,8,6,22,57,84,-27,30
Queen's Park,5018,10,6,11,19,40,73,-33,29
Raith,5019,1,23,8,5,71,33,38,77
Ayr,5019,2,24,4,8,93,42,51,76
Arbroath,5019,3,18,8,10,74,49,25,62
Alloa,5019,4,17,8,11,57,46,11,59
Stranraer,5019,5,15,5,16,56,68,-12,50
East Fife,5019,6,14,3,19,51,65,-14,45
Airdrieon,5019,7,11,11,14,46,58,-12,44
Forfar,5019,8,10,5,21,38,65,-27,35
Albion,5019,9,8,6,22,57,81,-24,30
Queen's Park,5019,10,6,10,20,40,76,-36,28
Raith,5020,1,22,9,5,68,32,36,75
Ayr,5020,2,23,4,9,93,46,47,73
Arbroath,5020,3,18,8,10,73,49,24,62
Alloa,5020,4,17,9,10,56,43,13,60
Stranraer,5020,5,15,5,16,57,67,-10,50
East Fife,5020,6,14,3,19,50,66,-16,45
Airdrieon,5020,7,11,11,14,46,58,-12,44
Forfar,5020,8,10,5,21,38,65,-27,35
Albion,5020,9,9,6,21,61,81,-20,33
Queen's Park,5020,10,6,10,20,40,75,-35,28
Raith,5021,1,23,8,5,70,32,38,77
Ayr,5021,2,24,4,8,93,43,50,76
Arbroath,5021,3,18,8,10,72,49,23,62
Alloa,5021,4,17,8,11,56,45,11,59
Stranraer,5021,5,15,5,16,57,67,-10,50
East Fife,5021,6,14,3,19,50,66,-16,45
Airdrieon,5021,7,10,12,14,48,61,-13,42
Forfar,5021,8,10,6,20,41,67,-26,36
Albion,5021,9,8,6,22,58,81,-23,30
Queen's Park,5021,10,6,10,20,40,74,-34,28
Ayr,5022,1,24,4,8,93,44,49,76
Raith,5022,2,22,9,5,69,33,36,75
Arbroath,5022,3,18,8,10,73,50,23,62
Alloa,5022,4,17,9,10,57,44,13,60
Stranraer,5022,5,16,5,15,59,66,-7,53
East Fife,5022,6,13,3,20,49,68,-19,42
Airdrieon,5022,7,10,11,15,45,60,-15,41
Forfar,5022,8,11,5,20,40,64,-24,38
Albion,5022,9,8,6,22,59,81,-22,30
Queen's Park,5022,10,6,10,20,41,75,-34,28
Raith,5023,1,23,8,5,71,32,39,77
Ayr,5023,2,24,4,8,91,42,49,76
Arbroath,5023,3,17,9,10,71,49,22,60
Alloa,5023,4,17,8,11,56,46,10,59
Stranraer,5023,5,16,5,15,56,64,-8,53
East Fife,5023,6,13,3,20,47,65,-18,42
Airdrieon,5023,7,10,11,15,46,60,-14,41
Forfar,5023,8,11,5,20,40,65,-25,38
Albion,5023,9,8,6,22,57,79,-22,30
Queen's Park,5023,10,6,11,19,40,73,-33,29
Ayr,5024,1,24,4,8,93,43,50,76
Raith,5024,2,22,8,6,68,33,35,74
Alloa,5024,3,18,8,10,57,43,14,62
Arbroath,5024,4,17,8,11,70,49,21,59
Stranraer,5024,5,15,6,15,55,64,-9,51
Airdrieon,5024,6,11,11,14,46,58,-12,44
East Fife,5024,7,13,4,19,47,64,-17,43
Forfar,5024,8,10,5,21,38,65,-27,35
Queen's Park,5024,9,7,10,19,40,72,-32,31
Albion,5024,10,8,6,22,58,81,-23,30
Raith,5025,1,23,8,5,69,32,37,77
Ayr,5025,2,24,4,8,95,45,50,76
Arbroath,5025,3,18,8,10,73,49,24,62
Alloa,5025,4,17,8,11,56,44,12,59
Stranraer,5025,5,15,5,16,56,66,-10,50
East Fife,5025,6,14,3,19,49,65,-16,45
Airdrieon,5025,7,10,11,15,45,60,-15,41
Forfar,5025,8,11,5,20,40,64,-24,38
Albion,5025,9,8,6,22,60,83,-23,30
Queen's Park,5025,10,6,10,20,40,75,-35,28
Raith,5026,1,23,8,5,71,32,39,77
Ayr,5026,2,24,4,8,94,42,52,76
Arbroath,5026,3,17,9,10,73,51,22,60
Alloa,5026,4,17,8,11,56,46,10,59
Stranraer,5026,5,16,5,15,58,65,-7,53
Airdrieon,5026,6,11,11,14,47,58,-11,44
East Fife,5026,7,13,3,20,48,67,-19,42
Forfar,5026,8,10,5,21,38,66,-28,35
Albion,5026,9,8,6,22,57,82,-25,30
Queen's Park,5026,10,6,11,19,42,75,-33,29
Raith,5027,1,22,9,5,68,32,36,75
Ayr,5027,2,23,4,9,92,46,46,73
Arbroath,5027,3,18,8,10,76,50,26,62
Alloa,5027,4,17,9,10,56,43,13,60
Stranraer,5027,5,15,6,15,56,65,-9,51
Airdrieon,5027,6,11,11,14,46,58,-12,44
East Fife,5027,7,13,4,19,48,65,-17,43
Forfar,5027,8,10,5,21,38,65,-27,35
Albion,5027,9,9,6,21,61,80,-19,33
Queen's Park,5027,10,6,10,20,41,78,-37,28
Raith,5028,1,23,8,5,70,32,38,77
Ayr,5028,2,24,4,8,93,43,50,76
Arbroath,5028,3,18,8,10,74,48,26,62
Alloa,5028,4,17,8,11,56,45,11,59
Stranraer,5028,5,15,5,16,58,70,-12,50
East Fife,5028,6,14,3,19,53,67,-14,45
Airdrieon,5028,7,10,11,15,45,60,-15,41
Forfar,5028,8,11,5,20,40,64,-24,38
Albion,5028,9,8,6,22,58,81,-23,30
Queen's Park,5028,10,6,10,20,39,76,-37,28
Ayr,5029,1,24,4,8,95,42,53,76
Raith,5029,2,22,8,6,68,34,34,74
Arbroath,5029,3,18,8,10,72,49,23,62
Alloa,5029,4,18,8,10,58,43,15,62
Stranraer,5029,5,16,5,15,58,64,-6,53
East Fife,5029,6,13,3,20,47,67,-20,42
Airdrieon,5029,7,10,11,15,45,60,-15,41
Forfar,5029,8,11,5,20,40,64,-24,38
Albion,5029,9,8,6,22,57,83,-26,30
Queen's Park,5029,10,6,10,20,40,74,-34,28
Raith,5030,1,23,8,5,70,32,38,77
Ayr,5030,2,24,4,8,95,44,51,76
Arbroath,5030,3,17,8,11,70,49,21,59
Alloa,5030,4,17,8,11,56,45,11,59
Stranraer,5030,5,16,5,15,57,65,-8,53
Airdrieon,5030,6,11,11,14,47,59,-12,44
East Fife,5030,7,13,3,20,48,66,-18,42
Forfar,5030,8,10,5,21,39,66,-27,35
Queen's Park,5030,9,7,10,19,40,72,-32,31
Albion,5030,10,8,6,22,59,83,-24,30
Raith,5031,1,23,8,5,70,33,37,77
Ayr,5031,2,24,4,8,96,44,52,76
Arbroath,5031,3,18,8,10,73,49,24,62
Alloa,5031,4,17,8,11,57,45,12,59
Stranraer,5031,5,16,5,15,57,64,-7,53
Airdrieon,5031,6,11,11,14,50,59,-9,44
East Fife,5031,7,13,3,20,47,66,-19,42
Forfar,5031,8,10,5,21,39,69,-30,35
Albion,5031,9,8,6,22,59,84,-25,30
Queen's Park,5031,10,6,10,20,40,75,-35,28
Ayr,5032,1,24,4,8,96,45,51,76
Raith,5032,2,22,9,5,69,33,36,75
Arbroath,5032,3,18,8,10,71,48,23,62
Alloa,5032,4,17,9,10,57,44,13,60
Stranraer,5032,5,15,5,16,57,67,-10,50
East Fife,5032,6,14,3,19,50,66,-16,45
Airdrieon,5032,7,10,12,14,46,59,-13,42
Forfar,5032,8,10,6,20,39,65,-26,36
Albion,5032,9,8,6,22,60,84,-24,30
Queen's Park,5032,10,6,10,20,39,73,-34,28
Raith,5033,1,23,8,5,69,32,37,77
Ayr,5033,2,24,4,8,93,43,50,76
Arbroath,5033,3,18,8,10,73,48,25,62
Alloa,5033,4,17,8,11,56,44,12,59
Stranraer,5033,5,15,5,16,55,66,-11,50
East Fife,5033,6,14,3,19,49,64,-15,45
Airdrieon,5033,7,10,11,15,46,60,-14,41
Forfar,5033,8,11,5,20,40,65,-25,38
Albion,5033,9,8,6,22,58,81,-23,30
Queen's Park,5033,10,6,10,20,39,75,-36,28
Ayr,5034,1,24,4,8,97,45,52,76
Raith,5034,2,22,9,5,70,34,36,75
Arbroath,5034,3,18,8,10,71,48,23,62
Alloa,5034,4,17,9,10,58,45,13,60
Stranraer,5034,5,15,5,16,55,65,-10,50
East Fife,5034,6,14,3,19,48,64,-16,45
Airdrieon,5034,7,10,12,14,46,59,-13,42
Forfar,5034,8,10,6,20,39,65,-26,36
Albion,5034,9,8,6,22,60,85,-25,30
Queen's Park,5034,10,6,10,20,39,73,-34,28
Raith,5035,1,23,8,5,72,33,39,77
Ayr,5035,2,23,5,8,91,43,48,74
Arbroath,5035,3,18,8,10,72,49,23,62
Alloa,5035,4,17,8,11,57,47,10,59
Stranraer,5035,5,15,5,16,57,67,-10,50
East Fife,5035,6,14,3,19,50,66,-16,45
Airdrieon,5035,7,11,11,14,48,58,-10,44
Forfar,5035,8,10,5,21,38,67,-29,35
Albion,5035,9,8,7,21,58,79,-21,31
Queen's Park,5035,10,6,10,20,40,74,-34,28
Ayr,5036,1,24,4,8,95,43,52,76
Raith,5036,2,22,9,5,70,34,36,75
Arbroath,5036,3,18,8,10,72,49,23,62
Alloa,5036,4,17,9,10,58,45,13,60
Stranraer,5036,5,15,5,16,55,66,-11,50
East Fife,5036,6,14,3,19,49,64,-15,45
Airdrieon,5036,7,11,11,14,48,59,-11,44
Forfar,5036,8,10,5,21,39,67,-28,35
Albion,5036,9,8,6,22,58,83,-25,30
Queen's Park,5036,10,6,10,20,40,74,-34,28
Ayr,5037,1,24,4,8,92,43,49,76
Raith,5037,2,22,9,5,70,34,36,75
Arbroath,5037,3,18,8,10,71,48,23,62
Alloa,5037,4,17,9,10,58,45,13,60
Stranraer,5037,5,15,5,16,56,68,-12,50
East Fife,5037,6,14,3,19,51,65,-14,45
Airdrieon,5037,7,11,11,14,47,59,-12,44
Forfar,5037,8,10,5,21,39,66,-27,35
Albion,5037,9,8,6,22,58,80,-22,30
Queen's Park,5037,10,6,10,20,39,73,-34,28
Raith,5038,1,22,9,5,69,33,36,75
Ayr,5038,2,23,4,9,90,44,46,73
Alloa,5038,3,17,9,10,57,44,13,60
Arbroath,5038,4,17,8,11,72,51,21,59
Stranraer,5038,5,16,5,15,58,65,-7,53
Airdrieon,5038,6,11,11,14,46,58,-12,44
East Fife,5038,7,13,3,20,48,67,-19,42
Forfar,5038,8,10,5,21,38,65,-27,35
Albion,5038,9,9,6,21,59,78,-19,33
Queen's Park,5038,10,7,10,19,42,74,-32,31
Raith,5039,1,22,9,5,69,33,36,75
Ayr,5039,2,23,5,8,93,45,48,74
Arbroath,5039,3,17,9,10,71,49,22,60
Alloa,5039,4,17,9,10,57,44,13,60
Stranraer,5039,5,15,5,16,55,67,-12,50
East Fife,5039,6,14,3,19,50,64,-14,45
Airdrieon,5039,7,11,11,14,48,58,-10,44
Forfar,5039,8,10,5,21,38,67,-29,35
Albion,5039,9,8,7,21,60,81,-21,31
Queen's Park,5039,10,6,11,19,40,73,-33,29
Raith,5040,1,23,8,5,70,32,38,77
Ayr,5040,2,23,4,9,91,44,47,73
Arbroath,5040,3,17,9,10,71,49,22,60
Alloa,5040,4,17,8,11,56,45,11,59
Stranraer,5040,5,15,6,15,55,64,-9,51
East Fife,5040,6,13,4,19,47,64,-17,43
Airdrieon,5040,7,10,11,15,46,61,-15,41
Forfar,5040,8,11,5,20,41,65,-24,38
Albion,5040,9,9,6,21,59,79,-20,33
Queen's Park,5040,10,6,11,19,40,73,-33,29
Raith,5041,1,23,8,5,72,34,38,77
Ayr,5041,2,24,4,8,92,43,49,76
Arbroath,5041,3,18,8,10,72,49,23,62
Alloa,5041,4,17,8,11,58,47,11,59
Stranraer,5041,5,15,5,16,56,66,-10,50
East Fife,5041,6,14,3,19,49,65,-16,45
Airdrieon,5041,7,10,12,14,45,58,-13,42
Forfar,5041,8,10,6,20,38,64,-26,36
Albion,5041,9,8,6,22,58,80,-22,30
Queen's Park,5041,10,6,10,20,40,74,-34,28
Raith,5042,1,22,8,6,69,35,34,74
Ayr,5042,2,23,4,9,92,45,47,73
Alloa,5042,3,18,8,10,59,44,15,62
Arbroath,5042,4,17,9,10,70,48,22,60
Stranraer,5042,5,15,5,16,56,69,-13,50
East Fife,5042,6,14,3,19,52,65,-13,45
Airdrieon,5042,7,11,11,14,47,58,-11,44
Forfar,5042,8,10,5,21,38,66,-28,35
Albion,5042,9,9,6,21,60,80,-20,33
Queen's Park,5042,10,6,11,19,39,72,-33,29
Ayr,5043,1,24,4,8,93,43,50,76
Raith,5043,2,22,8,6,69,34,35,74
Arbroath,5043,3,18,8,10,76,49,27,62
Alloa,5043,4,18,8,10,58,44,14,62
Stranraer,5043,5,15,5,16,55,65,-10,50
East Fife,5043,6,14,3,19,48,64,-16,45
Airdrieon,5043,7,11,11,14,47,59,-12,44
Forfar,5043,8,10,5,21,39,66,-27,35
Albion,5043,9,8,6,22,58,81,-23,30
Queen's Park,5043,10,6,10,20,40,78,-38,28
Ayr,5044,1,24,4,8,93,43,50,76
Raith,5044,2,22,8,6,68,34,34,74
Arbroath,5044,3,18,8,10,72,49,23,62
Alloa,5044,4,18,8,10,58,43,15,62
Stranraer,5044,5,15,5,16,58,69,-11,50
East Fife,5044,6,14,3,19,52,67,-15,45
Airdrieon,5044,7,10,12,14,45,58,-13,42
Forfar,5044,8,10,6,20,38,64,-26,36
Albion,5044,9,8,6,22,58,81,-23,30
Queen's Park,5044,10,6,10,20,40,74,-34,28
Ayr,5045,1,24,4,8,93,43,50,76
Raith,5045,2,22,8,6,69,35,34,74
Arbroath,5045,3,18,8,10,73,50,23,62
Alloa,5045,4,18,8,10,59,44,15,62
Stranraer,5045,5,15,5,16,55,65,-10,50
East Fife,5045,6,14,3,19,48,64,-16,45
Airdrieon,5045,7,11,11,14,47,58,-11,44
Forfar,5045,8,10,5,21,38,66,-28,35
Albion,5045,9,8,6,22,58,81,-23,30
Queen's Park,5045,10,6,10,20,41,75,-34,28
Ayr,5046,1,24,4,8,94,43,51,76
Raith,5046,2,22,9,5,69,33,36,75
Arbroath,5046,3,18,8,10,71,48,23,62
Alloa,5046,4,17,9,10,57,44,13,60
Stranraer,5046,5,16,5,15,58,65,-7,53
Airdrieon,5046,6,11,11,14,48,58,-10,44
East Fife,5046,7,13,3,20,48,67,-19,42
Forfar,5046,8,10,5,21,38,67,-29,35
Albion,5046,9,8,6,22,58,82,-24,30
Queen's Park,5046,10,6,10,20,39,73,-34,28
Raith,5047,1,23,8,5,70,33,37,77
Ayr,5047,2,24,4,8,94,45,49,76
Arbroath,5047,3,17,9,10,71,49,22,60
Alloa,5047,4,17,8,11,57,45,12,59
Stranraer,5047,5,15,6,15,57,66,-9,51
Airdrieon,5047,6,11,11,14,47,59,-12,44
East Fife,5047,7,13,4,19,49,66,-17,43
Forfar,5047,8,10,5,21,39,66,-27,35
Albion,5047,9,8,6,22,60,82,-22,30
Queen's Park,5047,10,6,11,19,40,73,-33,29
Ayr,5048,1,24,4,8,94,43,51,76
Raith,5048,2,22,9,5,69,33,36,75
Arbroath,5048,3,17,9,10,73,51,22,60
Alloa,5048,4,17,9,10,57,44,13,60
Stranraer,5048,5,15,6,15,57,66,-9,51
East Fife,5048,6,13,4,19,49,66,-17,43
Airdrieon,5048,7,10,12,14,45,58,-13,42
Forfar,5048,8,10,6,20,38,64,-26,36
Albion,5048,9,8,6,22,58,82,-24,30
Queen's Park,5048,10,6,11,19,42,75,-33,29
Raith,5049,1,23,8,5,71,33,38,77
Ayr,5049,2,24,4,8,91,42,49,76
Arbroath,5049,3,17,9,10,71,49,22,60
Alloa,5049,4,17,8,11,57,46,11,59
Stranraer,5049,5,15,5,16,57,69,-12,50
East Fife,5049,6,14,3,19,52,66,-14,45
Airdrieon,5049,7,11,11,14,48,60,-12,44
Forfar,5049,8,10,5,21,40,67,-27,35
Albion,5049,9,8,6,22,57,79,-22,30
Queen's Park,5049,10,6,11,19,40,73,-33,29
Raith,5050,1,23,8,5,74,32,42,77
Ayr,5050,2,24,4,8,95,42,53,76
Arbroath,5050,3,18,8,10,71,48,23,62
Alloa,5050,4,17,8,11,56,49,7,59
Stranraer,5050,5,15,5,16,55,66,-11,50
East Fife,5050,6,14,3,19,49,64,-15,45
Airdrieon,5050,7,10,11,15,46,61,-15,41
Forfar,5050,8,11,5,20,41,65,-24,38
Albion,5050,9,8,6,22,57,83,-26,30
Queen's Park,5050,10,6,10,20,39,73,-34,28
Raith,5051,1,23,8,5,70,33,37,77
Ayr,5051,2,23,4,9,91,45,46,73
Arbroath,5051,3,18,8,10,74,51,23,62
Alloa,5051,4,17,8,11,57,45,12,59
Stranraer,5051,5,15,5,16,55,65,-10,50
East Fife,5051,6,14,3,19,48,64,-16,45
Airdrieon,5051,7,11,11,14,47,59,-12,44
Forfar,5051,8,10,5,21,39,66,-27,35
Albion,5051,9,9,6,21,60,79,-19,33
Queen's Park,5051,10,6,10,20,42,76,-34,28
Raith,5052,1,23,8,5,71,33,38,77
Ayr,5052,2,24,4,8,97,43,54,76
Arbroath,5052,3,18,8,10,73,48,25,62
Alloa,5052,4,17,8,11,57,46,11,59
Stranraer,5052,5,15,5,16,56,67,-11,50
East Fife,5052,6,14,3,19,50,65,-15,45
Airdrieon,5052,7,11,11,14,48,59,-11,44
Forfar,5052,8,10,5,21,39,67,-28,35
Albion,5052,9,8,6,22,58,85,-27,30
Queen's Park,5052,10,6,10,20,39,75,-36,28
Ayr,5053,1,24,4,8,91,42,49,76
Raith,5053,2,22,9,5,69,33,36,75
Alloa,5053,3,17,9,10,57,44,13,60
Arbroath,5053,4,17,8,11,71,50,21,59
Stranraer,5053,5,15,5,16,55,65,-10,50
East Fife,5053,6,14,3,19,48,64,-16,45
Airdrieon,5053,7,10,11,15,46,60,-14,41
Forfar,5053,8,11,5,20,40,65,-25,38
Queen's Park,5053,9,7,10,19,41,73,-32,31
Albion,5053,10,8,6,22,57,79,-22,30
Ayr,5054,1,24,4,8,92,42,50,76
Raith,5054,2,22,8,6,70,35,35,74
Alloa,5054,3,18,8,10,59,45,14,62
Arbroath,5054,4,17,8,11,71,52,19,59
Stranraer,5054,5,15,5,16,55,68,-13,50
East Fife,5054,6,14,3,19,51,64,-13,45
Airdrieon,5054,7,10,11,15,46,60,-14,41
Forfar,5054,8,11,5,20,40,65,-25,38
Queen's Park,5054,9,7,10,19,43,73,-30,31
Albion,5054,10,8,6,22,57,80,-23,30
Raith,5055,1,23,8,5,71,33,38,77
Ayr,5055,2,24,4,8,92,43,49,76
Arbroath,5055,3,17,9,10,71,49,22,60
Alloa,5055,4,17,8,11,57,46,11,59
Stranraer,5055,5,15,5,16,57,68,-11,50
East Fife,5055,6,14,3,19,51,66,-15,45
Airdrieon,5055,7,11,11,14,48,58,-10,44
Forfar,5055,8,10,5,21,38,67,-29,35
Albion,5055,9,8,6,22,58,80,-22,30
Queen's Park,5055,10,6,11,19,40,73,-33,29
Ayr,5056,1,23,5,8,91,43,48,74
Raith,5056,2,22,8,6,68,35,33,74
Alloa,5056,3,18,8,10,59,43,16,62
Arbroath,5056,4,17,9,10,72,50,22,60
Stranraer,5056,5,15,5,16,56,66,-10,50
East Fife,5056,6,14,3,19,49,65,-16,45
Airdrieon,5056,7,10,11,15,46,60,-14,41
Forfar,5056,8,11,5,20,40,65,-25,38
Albion,5056,9,8,7,21,58,79,-21,31
Queen's Park,5056,10,6,11,19,41,74,-33,29
Raith,5057,1,23,8,5,71,33,38,77
Ayr,5057,2,24,4,8,94,42,52,76
Arbroath,5057,3,18,8,10,71,48,23,62
Alloa,5057,4,17,8,11,57,46,11,59
Stranraer,5057,5,15,5,16,56,67,-11,50
East Fife,5057,6,14,3,19,50,65,-15,45
Airdrieon,5057,7,11,11,14,48,59,-11,44
Forfar,5057,8,10,5,21,39,67,-28,35
Albion,5057,9,8,6,22,57,82,-25,30
Queen's Park,5057,10,6,10,20,39,73,-34,28
Ayr,5058,1,24,4,8,99,43,56,76
Raith,5058,2,22,9,5,70,34,36,75
Alloa,5058,3,17,9,10,58,45,13,60
Arbroath,5058,4,17,8,11,71,50,21,59
Stranraer,5058,5,15,5,16,55,67,-12,50
East Fife,5058,6,14,3,19,50,64,-14,45
Airdrieon,5058,7,11,11,14,48,59,-11,44
Forfar,5058,8,10,5,21,39,67,-28,35
Queen's Park,5058,9,7,10,19,41,73,-32,31
Albion,5058,10,8,6,22,58,87,-29,30
Ayr,5059,1,24,4,8,91,42,49,76
Raith,5059,2,22,8,6,68,33,35,74
Arbroath,5059,3,18,8,10,72,48,24,62
Alloa,5059,4,18,8,10,57,43,14,62
Stranraer,5059,5,15,5,16,56,67,-11,50
East Fife,5059,6,14,3,19,50,65,-15,45
Airdrieon,5059,7,10,12,14,46,59,-13,42
Forfar,5059,8,10,6,20,39,65,-26,36
Albion,5059,9,8,6,22,57,79,-22,30
Queen's Park,5059,10,6,10,20,39,74,-35,28
Raith,5060,1,23,8,5,69,32,37,77
Ayr,5060,2,24,4,8,92,42,50,76
Arbroath,5060,3,17,8,11,70,50,20,59
Alloa,5060,4,17,8,11,56,44,12,59
Stranraer,5060,5,15,6,15,55,64,-9,51
Airdrieon,5060,6,11,11,14,48,59,-11,44
East Fife,5060,7,13,4,19,47,64,-17,43
Forfar,5060,8,10,5,21,39,67,-28,35
Queen's Park,5060,9,7,10,19,41,72,-31,31
Albion,5060,10,8,6,22,57,80,-23,30
Ayr,5061,1,24,4,8,96,45,51,76
Raith,5061,2,22,9,5,69,33,36,75
Arbroath,5061,3,17,9,10,71,49,22,60
Alloa,5061,4,17,9,10,57,44,13,60
Stranraer,5061,5,15,5,16,56,66,-10,50
East Fife,5061,6,14,3,19,49,65,-16,45
Airdrieon,5061,7,11,11,14,47,59,-12,44
Forfar,5061,8,10,5,21,39,66,-27,35
Albion,5061,9,8,6,22,60,84,-24,30
Queen's Park,5061,10,6,11,19,40,73,-33,29
Raith,5062,1,23,8,5,70,33,37,77
Ayr,5062,2,23,4,9,91,44,47,73
Arbroath,5062,3,17,8,11,70,50,20,59
Alloa,5062,4,17,8,11,57,45,12,59
Stranraer,5062,5,16,5,15,58,65,-7,53
Airdrieon,5062,6,11,11,14,49,59,-10,44
East Fife,5062,7,13,3,20,48,67,-19,42
Forfar,5062,8,10,5,21,39,68,-29,35
Albion,5062,9,9,6,21,59,79,-20,33
Queen's Park,5062,10,7,10,19,41,72,-31,31
Raith,5063,1,23,8,5,70,32,38,77
Ayr,5063,2,24,4,8,94,43,51,76
Arbroath,5063,3,18,8,10,74,49,25,62
Alloa,5063,4,17,8,11,56,45,11,59
Stranraer,5063,5,15,5,16,56,66,-10,50
East Fife,5063,6,14,3,19,49,65,-16,45
Airdrieon,5063,7,10,12,14,45,58,-13,42
Forfar,5063,8,10,6,20,38,64,-26,36
Albion,5063,9,8,6,22,58,82,-24,30
Queen's Park,5063,10,6,10,20,40,76,-36,28
Raith,5064,1,23,8,5,71,33,38,77
Ayr,5064,2,23,5,8,91,43,48,74
Arbroath,5064,3,18,8,10,74,48,26,62
Alloa,5064,4,17,8,11,57,46,11,59
Stranraer,5064,5,15,6,15,56,65,-9,51
Airdrieon,5064,6,11,11,14,48,59,-11,44
East Fife,5064,7,13,4,19,48,65,-17,43
Forfar,5064,8,10,5,21,39,67,-28,35
Albion,5064,9,8,7,21,58,79,-21,31
Queen's Park,5064,10,6,10,20,39,76,-37,28
Ayr,5065,1,23,5,8,92,44,48,74
Raith,5065,2,22,8,6,69,34,35,74
Arbroath,5065,3,18,8,10,72,48,24,62
Alloa,5065,4,18,8,10,58,44,14,62
Stranraer,5065,5,15,5,16,55,65,-10,50
East Fife,5065,6,14,3,19,48,64,-16,45
Airdrieon,5065,7,10,12,14,46,59,-13,42
Forfar,5065,8,10,6,20,39,65,-26,36
Albion,5065,9,8,7,21,59,80,-21,31
Queen's Park,5065,10,6,10,20,39,74,-35,28
Ayr,5066,1,24,4,8,96,43,53,76
Raith,5066,2,22,9,5,68,32,36,75
Arbroath,5066,3,18,8,10,74,50,24,62
Alloa,5066,4,17,9,10,56,43,13,60
Stranraer,5066,5,16,5,15,60,64,-4,53
Airdrieon,5066,6,10,12,14,46,59,-13,42
East Fife,5066,7,13,3,20,47,69,-22,42
Forfar,5066,8,10,6,20,39,65,-26,36
Albion,5066,9,8,6,22,58,84,-26,30
Queen's Park,5066,10,6,10,20,41,76,-35,28
Ayr,5067,1,24,4,8,92,43,49,76
Raith,5067,2,22,8,6,68,33,35,74
Alloa,5067,3,18,8,10,57,43,14,62
Arbroath,5067,4,17,9,10,72,50,22,60
Stranraer,5067,5,15,5,16,55,65,-10,50
East Fife,5067,6,14,3,19,48,64,-16,45
Airdrieon,5067,7,10,11,15,47,62,-15,41
Forfar,5067,8,11,5,20,42,66,-24,38
Albion,5067,9,8,6,22,58,80,-22,30
Queen's Park,5067,10,6,11,19,41,74,-33,29
Raith,5068,1,23,8,5,70,33,37,77
Ayr,5068,2,24,4,8,94,42,52,76
Arbroath,5068,3,18,8,10,73,49,24,62
Alloa,5068,4,17,8,11,57,45,12,59
Stranraer,5068,5,15,5,16,55,67,-12,50
East Fife,5068,6,14,3,19,50,64,-14,45
Airdrieon,5068,7,11,11,14,47,58,-11,44
Forfar,5068,8,10,5,21,38,66,-28,35
Albion,5068,9,8,6,22,57,82,-25,30
Queen's Park,5068,10,6,10,20,40,75,-35,28
Raith,5069,1,23,8,5,70,32,38,77
Ayr,5069,2,24,4,8,94,43,51,76
Arbroath,5069,3,18,8,10,73,49,24,62
Alloa,5069,4,17,8,11,56,45,11,59
Stranraer,5069,5,15,6,15,56,65,-9,51
Airdrieon,5069,6,11,11,14,48,60,-12,44
East Fife,5069,7,13,4,19,48,65,-17,43
Forfar,5069,8,10,5,21,40,67,-27,35
Albion,5069,9,8,6,22,58,82,-24,30
Queen's Park,5069,10,6,10,20,40,75,-35,28
Raith,5070,1,23,8,5,73,32,41,77
Ayr,5070,2,23,4,9,92,46,46,73
Arbroath,5070,3,17,9,10,72,50,22,60
Alloa,5070,4,17,8,11,56,48,8,59
Stranraer,5070,5,15,5,16,57,68,-11,50
East Fife,5070,6,14,3,19,51,66,-15,45
Airdrieon,5070,7,10,12,14,47,60,-13,42
Forfar,5070,8,10,6,20,40,66,-26,36
Albion,5070,9,9,6,21,61,80,-19,33
Queen's Park,5070,10,6,11,19,41,74,-33,29
Raith,5071,1,23,8,5,72,35,37,77
Ayr,5071,2,24,4,8,92,42,50,76
Arbroath,5071,3,18,8,10,74,50,24,62
Alloa,5071,4,17,8,11,59,47,12,59
Stranraer,5071,5,16,5,15,56,64,-8,53
Airdrieon,5071,6,10,12,14,45,58,-13,42
East Fife,5071,7,13,3,20,47,65,-18,42
Forfar,5071,8,10,6,20,38,64,-26,36
Albion,5071,9,8,6,22,57,80,-23,30
Queen's Park,5071,10,6,10,20,41,76,-35,28
Ayr,5072,1,24,4,8,94,43,51,76
Raith,5072,2,22,9,5,68,32,36,75
Alloa,5072,3,17,9,10,56,43,13,60
Arbroath,5072,4,17,8,11,70,49,21,59
Stranraer,5072,5,16,5,15,59,65,-6,53
Airdrieon,5072,6,11,11,14,48,58,-10,44
East Fife,5072,7,13,3,20,48,68,-20,42
Forfar,5072,8,10,5,21,38,67,-29,35
Queen's Park,5072,9,7,10,19,40,72,-32,31
Albion,5072,10,8,6,22,58,82,-24,30
Raith,5073,1,23,8,5,72,32,40,77
Ayr,5073,2,24,4,8,93,43,50,76
Arbroath,5073,3,18,8,10,73,50,23,62
Alloa,5073,4,17,8,11,56,47,9,59
Stranraer,5073,5,15,6,15,57,66,-9,51
Airdrieon,5073,6,11,11,14,48,60,-12,44
East Fife,5073,7,13,4,19,49,66,-17,43
Forfar,5073,8,10,5,21,40,67,-27,35
Albion,5073,9,8,6,22,58,81,-23,30
Queen's Park,5073,10,6,10,20,41,75,-34,28
Raith,5074,1,23,8,5,70,32,38,77
Ayr,5074,2,24,4,8,93,42,51,76
Arbroath,5074,3,17,8,11,71,50,21,59
Alloa,5074,4,17,8,11,56,45,11,59
Stranraer,5074,5,15,6,15,57,66,-9,51
East Fife,5074,6,13,4,19,49,66,-17,43
Airdrieon,5074,7,10,12,14,48,61,-13,42
Forfar,5074,8,10,6,20,41,67,-26,36
Queen's Park,5074,9,7,10,19,41,73,-32,31
Albion,5074,10,8,6,22,57,81,-24,30
Ayr,5075,1,24,4,8,97,42,55,76
Raith,5075,2,22,8,6,68,35,33,74
Arbroath,5075,3,18,8,10,73,49,24,62
Alloa,5075,4,18,8,10,59,43,16,62
Stranraer,5075,5,15,6,15,56,65,-9,51
East Fife,5075,6,13,4,19,48,65,-17,43
Airdrieon,5075,7,10,12,14,47,60,-13,42
Forfar,5075,8,10,6,20,40,66,-26,36
Albion,5075,9,8,6,22,57,85,-28,30
Queen's Park,5075,10,6,10,20,40,75,-35,28
Ayr,5076,1,24,4,8,93,44,49,76
Raith,5076,2,22,8,6,69,34,35,74
Arbroath,5076,3,18,8,10,72,48,24,62
Alloa,5076,4,18,8,10,58,44,14,62
Stranraer,5076,5,16,5,15,57,65,-8,53
Airdrieon,5076,6,11,11,14,48,59,-11,44
East Fife,5076,7,13,3,20,48,66,-18,42
Forfar,5076,8,10,5,21,39,67,-28,35
Albion,5076,9,8,6,22,59,81,-22,30
Queen's Park,5076,10,6,10,20,39,74,-35,28
Raith,5077,1,23,8,5,71,32,39,77
Ayr,5077,2,24,4,8,92,43,49,76
Arbroath,5077,3,18,8,10,72,49,23,62
Alloa,5077,4,17,8,11,56,46,10,59
Stranraer,5077,5,15,5,16,57,67,-10,50
East Fife,5077,6,14,3,19,50,66,-16,45
Airdrieon,5077,7,11,11,14,47,58,-11,44
Forfar,5077,8,10,5,21,38,66,-28,35
Albion,5077,9,8,6,22,58,80,-22,30
Queen's Park,5077,10,6,10,20,40,74,-34,28
Ayr,5078,1,24,4,8,98,45,53,76
Raith,5078,2,22,9,5,68,32,36,75
Arbroath,5078,3,18,8,10,72,49,23,62
Alloa,5078,4,17,9,10,56,43,13,60
Stranraer,5078,5,16,5,15,59,67,-8,53
Airdrieon,5078,6,10,12,14,46,59,-13,42
East Fife,5078,7,13,3,20,50,68,-18,42
Forfar,5078,8,10,6,20,39,65,-26,36
Albion,5078,9,8,6,22,60,86,-26,30
Queen's Park,5078,10,6,10,20,40,74,-34,28
Raith,5079,1,23,8,5,72,32,40,77
Ayr,5079,2,23,5,8,91,43,48,74
Arbroath,5079,3,17,9,10,72,50,22,60
Alloa,5079,4,17,8,11,56,47,9,59
Stranraer,5079,5,15,5,16,55,66,-11,50
East Fife,5079,6,14,3,19,49,64,-15,45
Airdrieon,5079,7,11,11,14,48,58,-10,44
Forfar,5079,8,10,5,21,38,67,-29,35
Albion,5079,9,8,7,21,58,79,-21,31
Queen's Park,5079,10,6,11,19,41,74,-33,29
Ayr,5080,1,24,4,8,92,42,50,76
Raith,5080,2,22,8,6,68,33,35,74
Alloa,5080,3,18,8,10,57,43,14,62
Arbroath,5080,4,17,8,11,70,49,21,59
Stranraer,5080,5,16,5,15,58,66,-8,53
Airdrieon,5080,6,11,11,14,48,60,-12,44
East Fife,5080,7,13,3,20,49,67,-18,42
Forfar,5080,8,10,5,21,40,67,-27,35
Queen's Park,5080,9,7,10,19,40,72,-32,31
Albion,5080,10,8,6,22,57,80,-23,30
Raith,5081,1,23,8,5,70,32,38,77
Ayr,5081,2,24,4,8,94,43,51,76
Arbroath,5081,3,18,8,10,71,48,23,62
Alloa,5081,4,17,8,11,56,45,11,59
Stranraer,5081,5,16,5,15,59,66,-7,53
Airdrieon,5081,6,11,11,14,49,60,-11,44
East Fife,5081,7,13,3,20,49,68,-19,42
Forfar,5081,8,10,5,21,40,68,-28,35
Albion,5081,9,8,6,22,58,82,-24,30
Queen's Park,5081,10,6,10,20,39,73,-34,28
Raith,5082,1,23,8,5,69,32,37,77
Ayr,5082,2,24,4,8,95,44,51,76
Arbroath,5082,3,17,8,11,71,50,21,59
Alloa,5082,4,17,8,11,56,44,12,59
Stranraer,5082,5,15,5,16,57,67,-10,50
East Fife,5082,6,14,3,19,50,66,-16,45
Airdrieon,5082,7,10,12,14,46,59,-13,42
Forfar,5082,8,10,6,20,39,65,-26,36
Queen's Park,5082,9,7,10,19,41,73,-32,31
Albion,5082,10,8,6,22,59,83,-24,30
Ayr,5083,1,24,4,8,94,44,50,76
Raith,5083,2,22,9,5,69,33,36,75
Arbroath,5083,3,18,8,10,74,50,24,62
Alloa,5083,4,17,9,10,57,44,13,60
Stranraer,5083,5,15,5,16,56,66,-10,50
East Fife,5083,6,14,3,19,49,65,-16,45
Airdrieon,5083,7,10,11,15,46,60,-14,41
Forfar,5083,8,11,5,20,40,65,-25,38
Albion,5083,9,8,6,22,59,82,-23,30
Queen's Park,5083,10,6,10,20,41,76,-35,28
Ayr,5084,1,24,4,8,93,44,49,76
Raith,5084,2,22,8,6,69,34,35,74
Arbroath,5084,3,18,8,10,73,48,25,62
Alloa,5084,4,18,8,10,58,44,14,62
Stranraer,5084,5,15,5,16,56,66,-10,50
East Fife,5084,6,14,3,19,49,65,-16,45
Airdrieon,5084,7,10,12,14,45,58,-13,42
Forfar,5084,8,10,6,20,38,64,-26,36
Albion,5084,9,8,6,22,59,81,-22,30
Queen's Park,5084,10,6,10,20,39,75,-36,28
Raith,5085,1,23,8,5,71,34,37,77
Ayr,5085,2,24,4,8,92,43,49,76
Arbroath,5085,3,17,9,10,72,50,22,60
Alloa,5085,4,17,8,11,58,46,12,59
Stranraer,5085,5,15,5,16,57,67,-10,50
East Fife,5085,6,14,3,19,50,66,-16,45
Airdrieon,5085,7,10,12,14,47,60,-13,42
Forfar,5085,8,10,6,20,40,66,-26,36
Albion,5085,9,8,6,22,58,80,-22,30
Queen's Park,5085,10,6,11,19,41,74,-33,29
Raith,5086,1,23,8,5,70,32,38,77
Ayr,5086,2,24,4,8,93,44,49,76
Arbroath,5086,3,17,8,11,72,51,21,59
Alloa,5086,4,17,8,11,56,45,11,59
Stranraer,5086,5,15,5,16,56,67,-11,50
East Fife,5086,6,14,3,19,50,65,-15,45
Airdrieon,5086,7,10,11,15,45,59,-14,41
Forfar,5086,8,11,5,20,39,64,-25,38
Queen's Park,5086,9,7,10,19,42,74,-32,31
Albion,5086,10,8,6,22,59,81,-22,30
Raith,5087,1,23,8,5,69,32,37,77
Ayr,5087,2,24,4,8,92,42,50,76
Arbroath,5087,3,17,9,10,70,48,22,60
Alloa,5087,4,17,8,11,56,44,12,59
Stranraer,5087,5,15,6,15,55,64,-9,51
Airdrieon,5087,6,11,11,14,48,60,-12,44
East Fife,5087,7,13,4,19,47,64,-17,43
Forfar,5087,8,10,5,21,40,67,-27,35
Albion,5087,9,8,6,22,57,80,-23,30
Queen's Park,5087,10,6,11,19,39,72,-33,29
Raith,5088,1,23,8,5,71,34,37,77
Ayr,5088,2,24,4,8,93,42,51,76
Arbroath,5088,3,18,8,10,72,48,24,62
Alloa,5088,4,17,8,11,58,46,12,59
Stranraer,5088,5,15,6,15,56,65,-9,51
Airdrieon,5088,6,11,11,14,48,59,-11,44
East Fife,5088,7,13,4,19,48,65,-17,43
Forfar,5088,8,10,5,21,39,67,-28,35
Albion,5088,9,8,6,22,57,81,-24,30
Queen's Park,5088,10,6,10,20,39,74,-35,28
Raith,5089,1,23,8,5,71,33,38,77
Ayr,5089,2,24,4,8,93,44,49,76
Arbroath,5089,3,17,9,10,72,50,22,60
Alloa,5089,4,17,8,11,57,46,11,59
Stranraer,5089,5,16,5,15,57,65,-8,53
Airdrieon,5089,6,11,11,14,47,59,-12,44
East Fife,5089,7,13,3,20,48,66,-18,42
Forfar,5089,8,10,5,21,39,66,-27,35
Albion,5089,9,8,6,22,59,81,-22,30
Queen's Park,5089,10,6,11,19,41,74,-33,29
Raith,5090,1,23,8,5,70,33,37,77
Ayr,5090,2,24,4,8,92,43,49,76
Arbroath,5090,3,17,8,11,72,53,19,59
Alloa,5090,4,17,8,11,57,45,12,59
Stranraer,5090,5,15,6,15,56,65,-9,51
East Fife,5090,6,13,4,19,48,65,-17,43
Airdrieon,5090,7,10,12,14,45,58,-13,42
Forfar,5090,8,10,6,20,38,64,-26,36
Queen's Park,5090,9,7,10,19,44,74,-30,31
Albion,5090,10,8,6,22,58,80,-22,30
Ayr,5091,1,24,4,8,96,42,54,76
Raith,5091,2,22,9,5,70,34,36,75
Arbroath,5091,3,17,9,10,70,48,22,60
Alloa,5091,4,17,9,10,58,45,13,60
Stranraer,5091,5,16,5,15,57,65,-8,53
Airdrieon,5091,6,11,11,14,48,59,-11,44
East Fife,5091,7,13,3,20,48,66,-18,42
Forfar,5091,8,10,5,21,39,67,-28,35
Albion,5091,9,8,6,22,57,84,-27,30
Queen's Park,5091,10,6,11,19,39,72,-33,29
Ayr,5092,1,24,4,8,92,43,49,76
Raith,5092,2,22,9,5,70,34,36,75
Alloa,5092,3,17,9,10,58,45,13,60
Arbroath,5092,4,17,8,11,70,54,16,59
Stranraer,5092,5,15,5,16,56,66,-10,50
East Fife,5092,6,14,3,19,49,65,-16,45
Airdrieon,5092,7,11,11,14,46,58,-12,44
Forfar,5092,8,10,5,21,38,65,-27,35
Queen's Park,5092,9,7,10,19,45,72,-27,31
Albion,5092,10,8,6,22,58,80,-22,30
Raith,5093,1,23,8,5,70,33,37,77
Ayr,5093,2,24,4,8,94,43,51,76
Arbroath,5093,3,17,8,11,70,50,20,59
Alloa,5093,4,17,8,11,57,45,12,59
Stranraer,5093,5,15,6,15,55,64,-9,51
East Fife,5093,6,13,4,19,47,64,-17,43
Airdrieon,5093,7,10,12,14,46,59,-13,42
Forfar,5093,8,10,6,20,39,65,-26,36
Queen's Park,5093,9,7,10,19,41,72,-31,31
Albion,5093,10,8,6,22,58,82,-24,30
Ayr,5094,1,24,4,8,93,43,50,76
Raith,5094,2,22,9,5,69,33,36,75
Arbroath,5094,3,17,9,10,71,49,22,60
Alloa,5094,4,17,9,10,57,44,13,60
Stranraer,5094,5,15,5,16,55,65,-10,50
East Fife,5094,6,14,3,19,48,64,-16,45
Airdrieon,5094,7,11,11,14,47,58,-11,44
Forfar,5094,8,10,5,21,38,66,-28,35
Albion,5094,9,8,6,22,58,81,-23,30
Queen's Park,5094,10,6,11,19,40,73,-33,29
Raith,5095,1,23,8,5,71,34,37,77
Ayr,5095,2,24,4,8,92,43,49,76
Arbroath,5095,3,18,8,10,74,51,23,62
Alloa,5095,4,17,8,11,58,46,12,59
Stranraer,5095,5,15,6,15,55,64,-9,51
Airdrieon,5095,6,11,11,14,46,58,-12,44
East Fife,5095,7,13,4,19,47,64,-17,43
Forfar,5095,8,10,5,21,38,65,-27,35
Albion,5095,9,8,6,22,58,80,-22,30
Queen's Park,5095,10,6,10,20,42,76,-34,28
Raith,5096,1,23,8,5,70,33,37,77
Ayr,5096,2,23,5,8,93,45,48,74
Arbroath,5096,3,17,9,10,71,49,22,60
Alloa,5096,4,17,8,11,57,45,12,59
Stranraer,5096,5,15,5,16,55,66,-11,50
East Fife,5096,6,14,3,19,49,64,-15,45
Airdrieon,5096,7,11,11,14,47,59,-12,44
Forfar,5096,8,10,5,21,39,66,-27,35
Albion,5096,9,8,7,21,60,81,-21,31
Queen's Park,5096,10,6,11,19,40,73,-33,29
Raith,5097,1,23,8,5,71,33,38,77
Ayr,5097,2,24,4,8,94,42,52,76
Arbroath,5097,3,18,8,10,75,50,25,62
Alloa,5097,4,17,8,11,57,46,11,59
Stranraer,5097,5,16,5,15,58,66,-8,53
Airdrieon,5097,6,10,12,14,46,59,-13,42
East Fife,5097,7,13,3,20,49,67,-18,42
Forfar,5097,8,10,6,20,39,65,-26,36
Albion,5097,9,8,6,22,57,82,-25,30
Queen's Park,5097,10,6,10,20,41,77,-36,28
Ayr,5098,1,24,4,8,93,43,50,76
Raith,5098,2,22,9,5,70,34,36,75
Arbroath,5098,3,18,8,10,72,49,23,62
Alloa,5098,4,17,9,10,58,45,13,60
Stranraer,5098,5,16,5,15,57,65,-8,53
East Fife,5098,6,13,3,20,48,66,-18,42
Airdrieon,5098,7,10,11,15,45,59,-14,41
Forfar,5098,8,11,5,20,39,64,-25,38
Albion,5098,9,8,6,22,58,81,-23,30
Queen's Park,5098,10,6,10,20,40,74,-34,28
Raith,5099,1,23,8,5,72,33,39,77
Ayr,5099,2,23,5,8,91,43,48,74
Arbroath,5099,3,17,8,11,70,50,20,59
Alloa,5099,4,17,8,11,57,47,10,59
Stranraer,5099,5,15,5,16,56,66,-10,50
East Fife,5099,6,14,3,19,49,65,-16,45
Airdrieon,5099,7,11,11,14,47,59,-12,44
Forfar,5099,8,10,5,21,39,66,-27,35
Albion,5099,9,8,7,21,58,79,-21,31
Queen's Park,5099,10,7,10,19,41,72,-31,31
Raith,5100,1,23,8,5,71,32,39,77
Ayr,5100,2,24,4,8,95,46,49,76
Arbroath,5100,3,18,8,10,75,48,27,62
Alloa,5100,4,17,8,11,56,46,10,59
Stranraer,5100,5,15,5,16,55,65,-10,50
East Fife,5100,6,14,3,19,48,64,-16,45
Airdrieon,5100,7,11,11,14,48,59,-11,44
Forfar,5100,8,10,5,21,39,67,-28,35
Albion,5100,9,8,6,22,61,83,-22,30
Queen's Park,5100,10,6,10,20,39,77,-38,28
Raith,5101,1,22,9,5,70,34,36,75
Ayr,5101,2,23,5,8,94,46,48,74
Arbroath,5101,3,17,9,10,71,49,22,60
Alloa,5101,4,17,9,10,58,45,13,60
Stranraer,5101,5,15,5,16,57,69,-12,50
East Fife,5101,6,14,3,19,52,66,-14,45
Airdrieon,5101,7,10,11,15,45,59,-14,41
Forfar,5101,8,11,5,20,39,64,-25,38
Albion,5101,9,8,7,21,61,82,-21,31
Queen's Park,5101,10,6,11,19,40,73,-33,29
Raith,5102,1,23,8,5,71,34,37,77
Ayr,5102,2,24,4,8,94,43,51,76
Arbroath,5102,3,17,8,11,72,51,21,59
Alloa,5102,4,17,8,11,58,46,12,59
Stranraer,5102,5,15,5,16,55,67,-12,50
East Fife,5102,6,14,3,19,50,64,-14,45
Airdrieon,5102,7,10,11,15,45,61,-16,41
Forfar,5102,8,11,5,20,41,64,-23,38
Queen's Park,5102,9,7,10,19,42,74,-32,31
Albion,5102,10,8,6,22,58,82,-24,30
Raith,5103,1,23,8,5,71,32,39,77
Ayr,5103,2,24,4,8,95,44,51,76
Arbroath,5103,3,18,8,10,72,48,24,62
Alloa,5103,4,17,8,11,56,46,10,59
Stranraer,5103,5,15,5,16,56,67,-11,50
East Fife,5103,6,14,3,19,50,65,-15,45
Airdrieon,5103,7,11,11,14,46,58,-12,44
Forfar,5103,8,10,5,21,38,65,-27,35
Albion,5103,9,8,6,22,59,83,-24,30
Queen's Park,5103,10,6,10,20,39,74,-35,28
Raith,5104,1,23,8,5,71,34,37,77
Ayr,5104,2,24,4,8,92,43,49,76
Arbroath,5104,3,17,8,11,71,50,21,59
Alloa,5104,4,17,8,11,58,46,12,59
Stranraer,5104,5,15,5,16,55,65,-10,50
East Fife,5104,6,14,3,19,48,64,-16,45
Airdrieon,5104,7,10,11,15,47,61,-14,41
Forfar,5104,8,11,5,20,41,66,-25,38
Queen's Park,5104,9,7,10,19,41,73,-32,31
Albion,5104,10,8,6,22,58,80,-22,30
Raith,5105,1,22,9,5,70,34,36,75
Ayr,5105,2,23,4,9,94,47,47,73
Arbroath,5105,3,18,8,10,71,48,23,62
Alloa,5105,4,17,9,10,58,45,13,60
Stranraer,5105,5,16,5,15,58,65,-7,53
Airdrieon,5105,6,11,11,14,47,59,-12,44
East Fife,5105,7,13,3,20,48,67,-19,42
Forfar,5105,8,10,5,21,39,66,-27,35
Albion,5105,9,9,6,21,62,82,-20,33
Queen's Park,5105,10,6,10,20,39,73,-34,28
Raith,5106,1,23,8,5,71,32,39,77
Ayr,5106,2,24,4,8,93,43,50,76
Arbroath,5106,3,17,9,10,70,48,22,60
Alloa,5106,4,17,8,11,56,46,10,59
Stranraer,5106,5,15,6,15,57,66,-9,51
Airdrieon,5106,6,11,11,14,47,58,-11,44
East Fife,5106,7,13,4,19,49,66,-17,43
Forfar,5106,8,10,5,21,38,66,-28,35
Albion,5106,9,8,6,22,58,81,-23,30
Queen's Park,5106,10,6,11,19,39,72,-33,29
Raith,5107,1,23,8,5,69,32,37,77
Ayr,5107,2,24,4,8,92,43,49,76
Arbroath,5107,3,18,8,10,74,48,26,62
Alloa,5107,4,17,8,11,56,44,12,59
Stranraer,5107,5,15,5,16,55,66,-11,50
East Fife,5107,6,14,3,19,49,64,-15,45
Airdrieon,5107,7,11,11,14,47,59,-12,44
Forfar,5107,8,10,5,21,39,66,-27,35
Albion,5107,9,8,6,22,58,80,-22,30
Queen's Park,5107,10,6,10,20,39,76,-37,28
Raith,5108,1,23,8,5,69,32,37,77
Ayr,5108,2,24,4,8,93,43,50,76
Arbroath,5108,3,17,9,10,72,50,22,60
Alloa,5108,4,17,8,11,56,44,12,59
Stranraer,5108,5,15,6,15,56,65,-9,51
Airdrieon,5108,6,11,11,14,47,58,-11,44
East Fife,5108,7,13,4,19,48,65,-17,43
Forfar,5108,8,10,5,21,38,66,-28,35
Albion,5108,9,8,6,22,58,81,-23,30
Queen's Park,5108,10,6,11,19,41,74,-33,29
Ayr,5109,1,24,4,8,92,43,49,76
Raith,5109,2,22,8,6,68,33,35,74
Alloa,5109,3,18,8,10,57,43,14,62
Arbroath,5109,4,17,9,10,72,50,22,60
Stranraer,5109,5,16,5,15,58,65,-7,53
East Fife,5109,6,13,3,20,48,67,-19,42
Airdrieon,5109,7,10,11,15,45,60,-15,41
Forfar,5109,8,11,5,20,40,64,-24,38
Albion,5109,9,8,6,22,58,80,-22,30
Queen's Park,5109,10,6,11,19,41,74,-33,29
Raith,5110,1,23,8,5,69,32,37,77
Ayr,5110,2,24,4,8,96,43,53,76
Arbroath,5110,3,17,9,10,72,50,22,60
Alloa,5110,4,17,8,11,56,44,12,59
Stranraer,5110,5,16,5,15,60,65,-5,53
East Fife,5110,6,13,3,20,48,69,-21,42
Airdrieon,5110,7,10,11,15,46,60,-14,41
Forfar,5110,8,11,5,20,40,65,-25,38
Albion,5110,9,8,6,22,58,84,-26,30
Queen's Park,5110,10,6,11,19,41,74,-33,29
Ayr,5111,1,24,4,8,94,45,49,76
Raith,5111,2,22,8,6,68,34,34,74
Alloa,5111,3,18,8,10,58,43,15,62
Arbroath,5111,4,17,8,11,70,50,20,59
Stranraer,5111,5,16,5,15,58,64,-6,53
East Fife,5111,6,13,3,20,47,67,-20,42
Airdrieon,5111,7,10,11,15,46,60,-14,41
Forfar,5111,8,11,5,20,40,65,-25,38
Queen's Park,5111,9,7,10,19,41,72,-31,31
Albion,5111,10,8,6,22,60,82,-22,30
Raith,5112,1,23,8,5,70,32,38,77
Ayr,5112,2,24,4,8,94,44,50,76
Arbroath,5112,3,17,9,10,72,50,22,60
Alloa,5112,4,17,8,11,56,45,11,59
Stranraer,5112,5,16,5,15,57,65,-8,53
East Fife,5112,6,13,3,20,48,66,-18,42
Airdrieon,5112,7,10,11,15,46,61,-15,41
Forfar,5112,8,11,5,20,41,65,-24,38
Albion,5112,9,8,6,22,59,82,-23,30
Queen's Park,5112,10,6,11,19,41,74,-33,29
Raith,5113,1,23,8,5,71,33,38,77
Ayr,5113,2,24,4,8,94,44,50,76
Arbroath,5113,3,17,9,10,71,49,22,60
Alloa,5113,4,17,8,11,57,46,11,59
Stranraer,5113,5,15,5,16,55,66,-11,50
East Fife,5113,6,14,3,19,49,64,-15,45
Airdrieon,5113,7,10,11,15,47,61,-14,41
Forfar,5113,8,11,5,20,41,66,-25,38
Albion,5113,9,8,6,22,59,82,-23,30
Queen's Park,5113,10,6,11,19,40,73,-33,29
Raith,5114,1,23,8,5,70,33,37,77
Ayr,5114,2,24,4,8,92,42,50,76
Arbroath,5114,3,18,8,10,73,50,23,62
Alloa,5114,4,17,8,11,57,45,12,59
Stranraer,5114,5,15,5,16,57,70,-13,50
East Fife,5114,6,14,3,19,53,66,-13,45
Airdrieon,5114,7,10,12,14,46,59,-13,42
Forfar,5114,8,10,6,20,39,65,-26,36
Albion,5114,9,8,6,22,57,80,-23,30
Queen's Park,5114,10,6,10,20,41,75,-34,28
Raith,5115,1,23,8,5,71,34,37,77
Ayr,5115,2,24,4,8,92,42,50,76
Arbroath,5115,3,18,8,10,72,49,23,62
Alloa,5115,4,17,8,11,58,46,12,59
Stranraer,5115,5,15,5,16,55,65,-10,50
East Fife,5115,6,14,3,19,48,64,-16,45
Airdrieon,5115,7,11,11,14,48,58,-10,44
Forfar,5115,8,10,5,21,38,67,-29,35
Albion,5115,9,8,6,22,57,80,-23,30
Queen's Park,5115,10,6,10,20,40,74,-34,28
Ayr,5116,1,24,4,8,94,44,50,76
Raith,5116,2,22,8,6,68,34,34,74
Arbroath,5116,3,18,8,10,73,50,23,62
Alloa,5116,4,18,8,10,58,43,15,62
Stranraer,5116,5,15,5,16,55,66,-11,50
East Fife,5116,6,14,3,19,49,64,-15,45
Airdrieon,5116,7,11,11,14,46,58,-12,44
Forfar,5116,8,10,5,21,38,65,-27,35
Albion,5116,9,8,6,22,59,82,-23,30
Queen's Park,5116,10,6,10,20,41,75,-34,28
Raith,5117,1,23,8,5,71,34,37,77
Ayr,5117,2,24,4,8,93,43,50,76
Arbroath,5117,3,17,9,10,71,49,22,60
Alloa,5117,4,17,8,11,58,46,12,59
Stranraer,5117,5,15,6,15,56,65,-9,51
Airdrieon,5117,6,11,11,14,46,58,-12,44
East Fife,5117,7,13,4,19,48,65,-17,43
Forfar,5117,8,10,5,21,38,65,-27,35
Albion,5117,9,8,6,22,58,81,-23,30
Queen's Park,5117,10,6,11,19,40,73,-33,29
Raith,5118,1,23,8,5,71,32,39,77
Ayr,5118,2,24,4,8,95,43,52,76
Arbroath,5118,3,18,8,10,72,48,24,62
Alloa,5118,4,17,8,11,56,46,10,59
Stranraer,5118,5,15,5,16,55,67,-12,50
East Fife,5118,6,14,3,19,50,64,-14,45
Airdrieon,5118,7,10,12,14,46,59,-13,42
Forfar,5118,8,10,6,20,39,65,-26,36
Albion,5118,9,8,6,22,58,83,-25,30
Queen's Park,5118,10,6,10,20,39,74,-35,28
Raith,5119,1,23,8,5,71,33,38,77
Ayr,5119,2,24,4,8,93,42,51,76
Arbroath,5119,3,17,8,11,70,50,20,59
Alloa,5119,4,17,8,11,57,46,11,59
Stranraer,5119,5,15,5,16,56,66,-10,50
East Fife,5119,6,14,3,19,49,65,-16,45
Airdrieon,5119,7,10,11,15,45,59,-14,41
Forfar,5119,8,11,5,20,39,64,-25,38
Queen's Park,5119,9,7,10,19,41,72,-31,31
Albion,5119,10,8,6,22,57,81,-24,30
Raith,5120,1,22,9,5,69,33,36,75
Ayr,5120,2,23,4,9,91,44,47,73
Arbroath,5120,3,18,8,10,73,48,25,62
Alloa,5120,4,17,9,10,57,44,13,60
Stranraer,5120,5,15,6,15,56,65,-9,51
Airdrieon,5120,6,11,11,14,49,61,-12,44
East Fife,5120,7,13,4,19,48,65,-17,43
Forfar,5120,8,10,5,21,41,68,-27,35
Albion,5120,9,9,6,21,59,79,-20,33
Queen's Park,5120,10,6,10,20,39,75,-36,28
Ayr,5121,1,24,4,8,92,42,50,76
Raith,5121,2,22,8,6,69,36,33,74
Arbroath,5121,3,18,8,10,71,48,23,62
Alloa,5121,4,18,8,10,60,44,16,62
Stranraer,5121,5,16,5,15,56,64,-8,53
Airdrieon,5121,6,10,12,14,46,59,-13,42
East Fife,5121,7,13,3,20,47,65,-18,42
Forfar,5121,8,10,6,20,39,65,-26,36
Albion,5121,9,8,6,22,57,80,-23,30
Queen's Park,5121,10,6,10,20,39,73,-34,28
Ayr,5122,1,24,4,8,92,42,50,76
Raith,5122,2,22,8,6,70,35,35,74
Arbroath,5122,3,18,8,10,73,49,24,62
Alloa,5122,4,18,8,10,59,45,14,62
Stranraer,5122,5,15,6,15,56,65,-9,51
Airdrieon,5122,6,11,11,14,48,58,-10,44
East Fife,5122,7,13,4,19,48,65,-17,43
Forfar,5122,8,10,5,21,38,67,-29,35
Albion,5122,9,8,6,22,57,80,-23,30
Queen's Park,5122,10,6,10,20,40,75,-35,28
Raith,5123,1,23,8,5,69,32,37,77
Ayr,5123,2,23,5,8,90,42,48,74
Arbroath,5123,3,18,8,10,73,48,25,62
Alloa,5123,4,17,8,11,56,44,12,59
Stranraer,5123,5,15,6,15,55,64,-9,51
East Fife,5123,6,13,4,19,47,64,-17,43
Airdrieon,5123,7,10,11,15,45,60,-15,41
Forfar,5123,8,11,5,20,40,64,-24,38
Albion,5123,9,8,7,21,57,78,-21,31
Queen's Park,5123,10,6,10,20,39,75,-36,28
Raith,5124,1,23,8,5,70,33,37,77
Ayr,5124,2,23,4,9,91,45,46,73
Arbroath,5124,3,17,9,10,70,48,22,60
Alloa,5124,4,17,8,11,57,45,12,59
Stranraer,5124,5,15,5,16,55,66,-11,50
East Fife,5124,6,14,3,19,49,64,-15,45
Airdrieon,5124,7,10,12,14,46,59,-13,42
Forfar,5124,8,10,6,20,39,65,-26,36
Albion,5124,9,9,6,21,60,79,-19,33
Queen's Park,5124,10,6,11,19,39,72,-33,29
Raith,5125,1,23,8,5,70,33,37,77
Ayr,5125,2,24,4,8,94,44,50,76
Arbroath,5125,3,18,8,10,73,49,24,62
Alloa,5125,4,17,8,11,57,45,12,59
Stranraer,5125,5,15,5,16,58,68,-10,50
East Fife,5125,6,14,3,19,51,67,-16,45
Airdrieon,5125,7,11,11,14,47,58,-11,44
Forfar,5125,8,10,5,21,38,66,-28,35
Albion,5125,9,8,6,22,59,82,-23,30
Queen's Park,5125,10,6,10,20,40,75,-35,28
Raith,5126,1,23,8,5,70,32,38,77
Ayr,5126,2,24,4,8,94,43,51,76
Arbroath,5126,3,18,8,10,72,48,24,62
Alloa,5126,4,17,8,11,56,45,11,59
Stranraer,5126,5,16,5,15,56,64,-8,53
Airdrieon,5126,6,10,12,14,46,59,-13,42
East Fife,5126,7,13,3,20,47,65,-18,42
Forfar,5126,8,10,6,20,39,65,-26,36
Albion,5126,9,8,6,22,58,82,-24,30
Queen's Park,5126,10,6,10,20,39,74,-35,28
Ayr,5127,1,24,4,8,95,43,52,76
Raith,5127,2,22,8,6,68,33,35,74
Alloa,5127,3,18,8,10,57,43,14,62
Arbroath,5127,4,17,8,11,71,50,21,59
Stranraer,5127,5,15,6,15,55,64,-9,51
East Fife,5127,6,13,4,19,47,64,-17,43
Airdrieon,5127,7,10,12,14,45,58,-13,42
Forfar,5127,8,10,6,20,38,64,-26,36
Queen's Park,5127,9,7,10,19,41,73,-32,31
Albion,5127,10,8,6,22,58,83,-25,30
Raith,5128,1,23,8,5,71,34,37,77
Ayr,5128,2,23,4,9,90,45,45,73
Arbroath,5128,3,18,8,10,73,48,25,62
Alloa,5128,4,17,8,11,58,46,12,59
Stranraer,5128,5,15,5,16,57,68,-11,50
East Fife,5128,6,14,3,19,51,66,-15,45
Airdrieon,5128,7,10,11,15,46,62,-16,41
Forfar,5128,8,11,5,20,42,65,-23,38
Albion,5128,9,9,6,21,60,78,-18,33
Queen's Park,5128,10,6,10,20,39,75,-36,28
Raith,5129,1,23,8,5,71,34,37,77
Ayr,5129,2,24,4,8,94,43,51,76
Arbroath,5129,3,17,8,11,71,51,20,59
Alloa,5129,4,17,8,11,58,46,12,59
Stranraer,5129,5,15,6,15,56,65,-9,51
East Fife,5129,6,13,4,19,48,65,-17,43
Airdrieon,5129,7,10,12,14,46,59,-13,42
Forfar,5129,8,10,6,20,39,65,-26,36
Queen's Park,5129,9,7,10,19,42,73,-31,31
Albion,5129,10,8,6,22,58,82,-24,30
Raith,5130,1,23,8,5,71,32,39,77
Ayr,5130,2,24,4,8,95,42,53,76
Arbroath,5130,3,17,9,10,73,51,22,60
Alloa,5130,4,17,8,11,56,46,10,59
Stranraer,5130,5,15,6,15,55,64,-9,51
East Fife,5130,6,13,4,19,47,64,-17,43
Airdrieon,5130,7,10,12,14,45,58,-13,42
Forfar,5130,8,10,6,20,38,64,-26,36
Albion,5130,9,8,6,22,57,83,-26,30
Queen's Park,5130,10,6,11,19,42,75,-33,29
Ayr,5131,1,24,4,8,93,44,49,76
Raith,5131,2,22,8,6,68,33,35,74
Arbroath,5131,3,18,8,10,71,48,23,62
Alloa,5131,4,18,8,10,57,43,14,62
Stranraer,5131,5,15,5,16,55,65,-10,50
East Fife,5131,6,14,3,19,48,64,-16,45
Airdrieon,5131,7,10,11,15,45,60,-15,41
Forfar,5131,8,11,5,20,40,64,-24,38
Albion,5131,9,8,6,22,59,81,-22,30
Queen's Park,5131,10,6,10,20,39,73,-34,28
Ayr,5132,1,24,4,8,92,43,49,76
Raith,5132,2,22,9,5,69,33,36,75
Arbroath,5132,3,17,9,10,72,50,22,60
Alloa,5132,4,17,9,10,57,44,13,60
Stranraer,5132,5,15,5,16,55,66,-11,50
East Fife,5132,6,14,3,19,49,64,-15,45
Airdrieon,5132,7,10,11,15,47,61,-14,41
Forfar,5132,8,11,5,20,41,66,-25,38
Albion,5132,9,8,6,22,58,80,-22,30
Queen's Park,5132,10,6,11,19,41,74,-33,29
Raith,5133,1,23,8,5,71,32,39,77
Ayr,5133,2,24,4,8,93,43,50,76
Arbroath,5133,3,17,9,10,71,49,22,60
Alloa,5133,4,17,8,11,56,46,10,59
Stranraer,5133,5,16,5,15,58,64,-6,53
Airdrieon,5133,6,11,11,14,46,58,-12,44
East Fife,5133,7,13,3,20,47,67,-20,42
Forfar,5133,8,10,5,21,38,65,-27,35
Albion,5133,9,8,6,22,58,81,-23,30
Queen's Park,5133,10,6,11,19,40,73,-33,29
Ayr,5134,1,24,4,8,93,43,50,76
Raith,5134,2,22,9,5,68,32,36,75
Arbroath,5134,3,18,8,10,74,49,25,62
Alloa,5134,4,17,9,10,56,43,13,60
Stranraer,5134,5,15,5,16,56,66,-10,50
East Fife,5134,6,14,3,19,49,65,-16,45
Airdrieon,5134,7,11,11,14,49,60,-11,44
Forfar,5134,8,10,5,21,40,68,-28,35
Albion,5134,9,8,6,22,58,81,-23,30
Queen's Park,5134,10,6,10,20,40,76,-36,28
Raith,5135,1,23,8,5,72,32,40,77
Ayr,5135,2,24,4,8,97,42,55,76
Arbroath,5135,3,18,8,10,72,48,24,62
Alloa,5135,4,17,8,11,56,47,9,59
Stranraer,5135,5,16,5,15,57,65,-8,53
East Fife,5135,6,13,3,20,48,66,-18,42
Airdrieon,5135,7,10,11,15,45,60,-15,41
Forfar,5135,8,11,5,20,40,64,-24,38
Albion,5135,9,8,6,22,57,85,-28,30
Queen's Park,5135,10,6,10,20,39,74,-35,28
Ayr,5136,1,24,4,8,92,43,49,76
Raith,5136,2,22,8,6,68,33,35,74
Arbroath,5136,3,18,8,10,76,48,28,62
Alloa,5136,4,18,8,10,57,43,14,62
Stranraer,5136,5,15,6,15,56,65,-9,51
East Fife,5136,6,13,4,19,48,65,-17,43
Airdrieon,5136,7,10,12,14,46,59,-13,42
Forfar,5136,8,10,6,20,39,65,-26,36
Albion,5136,9,8,6,22,58,80,-22,30
Queen's Park,5136,10,6,10,20,39,78,-39,28
Raith,5137,1,23,8,5,70,32,38,77
Ayr,5137,2,23,5,8,91,43,48,74
Arbroath,5137,3,18,8,10,71,48,23,62
Alloa,5137,4,17,8,11,56,45,11,59
Stranraer,5137,5,15,5,16,56,66,-10,50
East Fife,5137,6,14,3,19,49,65,-16,45
Airdrieon,5137,7,10,11,15,47,61,-14,41
Forfar,5137,8,11,5,20,41,66,-25,38
Albion,5137,9,8,7,21,58,79,-21,31
Queen's Park,5137,10,6,10,20,39,73,-34,28
Raith,5138,1,23,8,5,71,34,37,77
Ayr,5138,2,24,4,8,92,42,50,76
Arbroath,5138,3,18,8,10,75,48,27,62
Alloa,5138,4,17,8,11,58,46,12,59
Stranraer,5138,5,15,5,16,55,65,-10,50
East Fife,5138,6,14,3,19,48,64,-16,45
Airdrieon,5138,7,10,11,15,45,59,-14,41
Forfar,5138,8,11,5,20,39,64,-25,38
Albion,5138,9,8,6,22,57,80,-23,30
Queen's Park,5138,10,6,10,20,39,77,-38,28
Raith,5139,1,23,8,5,70,33,37,77
Ayr,5139,2,24,4,8,92,43,49,76
Arbroath,5139,3,17,8,11,71,51,20,59
Alloa,5139,4,17,8,11,57,45,12,59
Stranraer,5139,5,15,5,16,57,67,-10,50
East Fife,5139,6,14,3,19,50,66,-16,45
Airdrieon,5139,7,11,11,14,49,58,-9,44
Forfar,5139,8,10,5,21,38,68,-30,35
Queen's Park,5139,9,7,10,19,42,73,-31,31
Albion,5139,10,8,6,22,58,80,-22,30
Raith,5140,1,23,8,5,72,33,39,77
Ayr,5140,2,24,4,8,94,43,51,76
Arbroath,5140,3,17,9,10,71,49,22,60
Alloa,5140,4,17,8,11,57,47,10,59
Stranraer,5140,5,15,5,16,55,66,-11,50
East Fife,5140,6,14,3,19,49,64,-15,45
Airdrieon,5140,7,11,11,14,50,59,-9,44
Forfar,5140,8,10,5,21,39,69,-30,35
Albion,5140,9,8,6,22,58,82,-24,30
Queen's Park,5140,10,6,11,19,40,73,-33,29
Ayr,5141,1,24,4,8,95,44,51,76
Raith,5141,2,22,8,6,69,34,35,74
Arbroath,5141,3,18,8,10,73,49,24,62
Alloa,5141,4,18,8,10,58,44,14,62
Stranraer,5141,5,15,5,16,55,66,-11,50
East Fife,5141,6,14,3,19,49,64,-15,45
Airdrieon,5141,7,11,11,14,46,58,-12,44
Forfar,5141,8,10,5,21,38,65,-27,35
Albion,5141,9,8,6,22,59,83,-24,30
Queen's Park,5141,10,6,10,20,40,75,-35,28
Raith,5142,1,23,8,5,71,33,38,77
Ayr,5142,2,24,4,8,94,42,52,76
Arbroath,5142,3,18,8,10,73,50,23,62
Alloa,5142,4,17,8,11,57,46,11,59
Stranraer,5142,5,15,5,16,55,65,-10,50
East Fife,5142,6,14,3,19,48,64,-16,45
Airdrieon,5142,7,11,11,14,47,59,-12,44
Forfar,5142,8,10,5,21,39,66,-27,35
Albion,5142,9,8,6,22,57,82,-25,30
Queen's Park,5142,10,6,10,20,41,75,-34,28
Ayr,5143,1,24,4,8,93,42,51,76
Raith,5143,2,22,8,6,68,34,34,74
Arbroath,5143,3,18,8,10,73,49,24,62
Alloa,5143,4,18,8,10,58,43,15,62
Stranraer,5143,5,15,5,16,55,65,-10,50
East Fife,5143,6,14,3,19,48,64,-16,45
Airdrieon,5143,7,11,11,14,48,58,-10,44
Forfar,5143,8,10,5,21,38,67,-29,35
Albion,5143,9,8,6,22,57,81,-24,30
Queen's Park,5143,10,6,10,20,40,75,-35,28
Raith,5144,1,23,8,5,70,33,37,77
Ayr,5144,2,24,4,8,93,43,50,76
Arbroath,5144,3,17,9,10,71,49,22,60
Alloa,5144,4,17,8,11,57,45,12,59
Stranraer,5144,5,15,6,15,56,65,-9,51
East Fife,5144,6,13,4,19,48,65,-17,43
Airdrieon,5144,7,10,11,15,45,60,-15,41
Forfar,5144,8,11,5,20,40,64,-24,38
Albion,5144,9,8,6,22,58,81,-23,30
Queen's Park,5144,10,6,11,19,40,73,-33,29
Raith,5145,1,23,8,5,71,34,37,77
Ayr,5145,2,24,4,8,93,42,51,76
Arbroath,5145,3,18,8,10,74,48,26,62
Alloa,5145,4,17,8,11,58,46,12,59
Stranraer,5145,5,15,6,15,55,64,-9,51
Airdrieon,5145,6,11,11,14,46,58,-12,44
East Fife,5145,7,13,4,19,47,64,-17,43
Forfar,5145,8,10,5,21,38,65,-27,35
Albion,5145,9,8,6,22,57,81,-24,30
Queen's Park,5145,10,6,10,20,39,76,-37,28
Raith,5146,1,23,8,5,70,32,38,77
Ayr,5146,2,24,4,8,93,42,51,76
Arbroath,5146,3,17,8,11,72,51,21,59
Alloa,5146,4,17,8,11,56,45,11,59
Stranraer,5146,5,15,6,15,57,66,-9,51
Airdrieon,5146,6,11,11,14,47,59,-12,44
East Fife,5146,7,13,4,19,49,66,-17,43
Forfar,5146,8,10,5,21,39,66,-27,35
Queen's Park,5146,9,7,10,19,42,74,-32,31
Albion,5146,10,8,6,22,57,81,-24,30
Raith,5147,1,23,8,5,69,32,37,77
Ayr,5147,2,23,5,8,94,46,48,74
Arbroath,5147,3,17,8,11,71,52,19,59
Alloa,5147,4,17,8,11,56,44,12,59
Stranraer,5147,5,16,5,15,59,64,-5,53
Airdrieon,5147,6,11,11,14,49,59,-10,44
East Fife,5147,7,13,3,20,47,68,-21,42
Forfar,5147,8,10,5,21,39,68,-29,35
Albion,5147,9,8,7,21,61,82,-21,31
Queen's Park,5147,10,7,10,19,43,73,-30,31
Raith,5148,1,23,8,5,69,32,37,77
Ayr,5148,2,24,4,8,94,42,52,76
Arbroath,5148,3,18,8,10,72,49,23,62
Alloa,5148,4,17,8,11,56,44,12,59
Stranraer,5148,5,16,5,15,58,64,-6,53
Airdrieon,5148,6,10,12,14,47,60,-13,42
East Fife,5148,7,13,3,20,47,67,-20,42
Forfar,5148,8,10,6,20,40,66,-26,36
Albion,5148,9,8,6,22,57,82,-25,30
Queen's Park,5148,10,6,10,20,40,74,-34,28
Ayr,5149,1,24,4,8,96,43,53,76
Raith,5149,2,22,9,5,71,35,36,75
Arbroath,5149,3,18,8,10,74,49,25,62
Alloa,5149,4,17,9,10,59,46,13,60
Stranraer,5149,5,15,5,16,55,66,-11,50
East Fife,5149,6,14,3,19,49,64,-15,45
Airdrieon,5149,7,11,11,14,47,59,-12,44
Forfar,5149,8,10,5,21,39,66,-27,35
Albion,5149,9,8,6,22,58,84,-26,30
Queen's Park,5149,10,6,10,20,40,76,-36,28
Ayr,5150,1,24,4,8,92,43,49,76
Raith,5150,2,22,8,6,69,34,35,74
Alloa,5150,3,18,8,10,58,44,14,62
Arbroath,5150,4,17,8,11,70,49,21,59
Stranraer,5150,5,16,5,15,57,64,-7,53
Airdrieon,5150,6,11,11,14,47,58,-11,44
East Fife,5150,7,13,3,20,47,66,-19,42
Forfar,5150,8,10,5,21,38,66,-28,35
Queen's Park,5150,9,7,10,19,40,72,-32,31
Albion,5150,10,8,6,22,58,80,-22,30
Raith,5151,1,23,8,5,73,32,41,77
Ayr,5151,2,24,4,8,94,44,50,76
Arbroath,5151,3,17,8,11,71,50,21,59
Alloa,5151,4,17,8,11,56,48,8,59
Stranraer,5151,5,15,5,16,57,67,-10,50
East Fife,5151,6,14,3,19,50,66,-16,45
Airdrieon,5151,7,10,12,14,46,59,-13,42
Forfar,5151,8,10,6,20,39,65,-26,36
Queen's Park,5151,9,7,10,19,41,73,-32,31
Albion,5151,10,8,6,22,59,82,-23,30
Raith,5152,1,23,8,5,69,32,37,77
Ayr,5152,2,24,4,8,94,43,51,76
Arbroath,5152,3,17,9,10,72,50,22,60
Alloa,5152,4,17,8,11,56,44,12,59
Stranraer,5152,5,16,5,15,57,64,-7,53
East Fife,5152,6,13,3,20,47,66,-19,42
Airdrieon,5152,7,10,11,15,45,59,-14,41
Forfar,5152,8,11,5,20,39,64,-25,38
Albion,5152,9,8,6,22,58,82,-24,30
Queen's Park,5152,10,6,11,19,41,74,-33,29
Raith,5153,1,23,8,5,69,32,37,77
Ayr,5153,2,24,4,8,97,42,55,76
Arbroath,5153,3,17,9,10,71,49,22,60
Alloa,5153,4,17,8,11,56,44,12,59
Stranraer,5153,5,15,5,16,55,65,-10,50
East Fife,5153,6,14,3,19,48,64,-16,45
Airdrieon,5153,7,11,11,14,47,59,-12,44
Forfar,5153,8,10,5,21,39,66,-27,35
Albion,5153,9,8,6,22,57,85,-28,30
Queen's Park,5153,10,6,11,19,40,73,-33,29
Ayr,5154,1,24,4,8,94,42,52,76
Raith,5154,2,22,8,6,68,33,35,74
Arbroath,5154,3,18,8,10,72,48,24,62
Alloa,5154,4,18,8,10,57,43,14,62
Stranraer,5154,5,15,5,16,55,65,-10,50
East Fife,5154,6,14,3,19,48,64,-16,45
Airdrieon,5154,7,10,12,14,47,60,-13,42
Forfar,5154,8,10,6,20,40,66,-26,36
Albion,5154,9,8,6,22,57,82,-25,30
Queen's Park,5154,10,6,10,20,39,74,-35,28
Raith,5155,1,22,9,5,69,33,36,75
Ayr,5155,2,23,4,9,91,44,47,73
Alloa,5155,3,17,9,10,57,44,13,60
Arbroath,5155,4,17,8,11,73,54,19,59
Stranraer,5155,5,15,5,16,55,65,-10,50
East Fife,5155,6,14,3,19,48,64,-16,45
Airdrieon,5155,7,11,11,14,48,60,-12,44
Forfar,5155,8,10,5,21,40,67,-27,35
Albion,5155,9,9,6,21,59,79,-20,33
Queen's Park,5155,10,7,10,19,45,75,-30,31
Raith,5156,1,23,8,5,70,32,38,77
Ayr,5156,2,24,4,8,95,42,53,76
Arbroath,5156,3,17,8,11,71,51,20,59
Alloa,5156,4,17,8,11,56,45,11,59
Stranraer,5156,5,16,5,15,56,64,-8,53
Airdrieon,5156,6,11,11,14,48,59,-11,44
East Fife,5156,7,13,3,20,47,65,-18,42
Forfar,5156,8,10,5,21,39,67,-28,35
Queen's Park,5156,9,7,10,19,42,73,-31,31
Albion,5156,10,8,6,22,57,83,-26,30
Raith,5157,1,22,9,5,69,33,36,75
Ayr,5157,2,23,4,9,92,45,47,73
Arbroath,5157,3,18,8,10,72,49,23,62
Alloa,5157,4,17,9,10,57,44,13,60
Stranraer,5157,5,15,5,16,55,66,-11,50
East Fife,5157,6,14,3,19,49,64,-15,45
Airdrieon,5157,7,11,11,14,48,59,-11,44
Forfar,5157,8,10,5,21,39,67,-28,35
Albion,5157,9,9,6,21,60,80,-20,33
Queen's Park,5157,10,6,10,20,40,74,-34,28
Ayr,5158,1,24,4,8,93,43,50,76
Raith,5158,2,22,9,5,69,33,36,75
Arbroath,5158,3,18,8,10,73,50,23,62
Alloa,5158,4,17,9,10,57,44,13,60
Stranraer,5158,5,16,5,15,56,64,-8,53
Airdrieon,5158,6,10,12,14,46,59,-13,42
East Fife,5158,7,13,3,20,47,65,-18,42
Forfar,5158,8,10,6,20,39,65,-26,36
Albion,5158,9,8,6,22,58,81,-23,30
Queen's Park,5158,10,6,10,20,41,75,-34,28
Raith,5159,1,23,8,5,70,32,38,77
Ayr,5159,2,24,4,8,92,43,49,76
Arbroath,5159,3,18,8,10,76,48,28,62
Alloa,5159,4,17,8,11,56,45,11,59
Stranraer,5159,5,15,5,16,55,67,-12,50
East Fife,5159,6,14,3,19,50,64,-14,45
Airdrieon,5159,7,11,11,14,46,58,-12,44
Forfar,5159,8,10,5,21,38,65,-27,35
Albion,5159,9,8,6,22,58,80,-22,30
Queen's Park,5159,10,6,10,20,39,78,-39,28
Ayr,5160,1,24,4,8,92,42,50,76
Raith,5160,2,22,9,5,69,33,36,75
Arbroath,5160,3,18,8,10,73,48,25,62
Alloa,5160,4,17,9,10,57,44,13,60
Stranraer,5160,5,16,5,15,56,64,-8,53
Airdrieon,5160,6,10,12,14,46,59,-13,42
East Fife,5160,7,13,3,20,47,65,-18,42
Forfar,5160,8,10,6,20,39,65,-26,36
Albion,5160,9,8,6,22,57,80,-23,30
Queen's Park,5160,10,6,10,20,39,75,-36,28
Raith,5161,1,23,8,5,69,32,37,77
Ayr,5161,2,24,4,8,94,44,50,76
Arbroath,5161,3,18,8,10,74,50,24,62
Alloa,5161,4,17,8,11,56,44,12,59
Stranraer,5161,5,15,6,15,55,64,-9,51
East Fife,5161,6,13,4,19,47,64,-17,43
Airdrieon,5161,7,10,11,15,46,60,-14,41
Forfar,5161,8,11,5,20,40,65,-25,38
Albion,5161,9,8,6,22,59,82,-23,30
Queen's Park,5161,10,6,10,20,41,76,-35,28
Ayr,5162,1,24,4,8,93,42,51,76
Raith,5162,2,22,8,6,70,37,33,74
Alloa,5162,3,18,8,10,61,45,16,62
Arbroath,5162,4,17,8,11,72,52,20,59
Stranraer,5162,5,15,5,16,56,67,-11,50
East Fife,5162,6,14,3,19,50,65,-15,45
Airdrieon,5162,7,10,11,15,45,59,-14,41
Forfar,5162,8,11,5,20,39,64,-25,38
Queen's Park,5162,9,7,10,19,43,74,-31,31
Albion,5162,10,8,6,22,57,81,-24,30
Raith,5163,1,23,8,5,70,32,38,77
Ayr,5163,2,24,4,8,94,45,49,76
Arbroath,5163,3,17,9,10,70,48,22,60
Alloa,5163,4,17,8,11,56,45,11,59
Stranraer,5163,5,15,6,15,56,65,-9,51
East Fife,5163,6,13,4,19,48,65,-17,43
Airdrieon,5163,7,10,12,14,47,60,-13,42
Forfar,5163,8,10,6,20,40,66,-26,36
Albion,5163,9,8,6,22,60,82,-22,30
Queen's Park,5163,10,6,11,19,39,72,-33,29
Ayr,5164,1,24,4,8,94,43,51,76
Raith,5164,2,22,9,5,69,33,36,75
Arbroath,5164,3,18,8,10,71,48,23,62
Alloa,5164,4,17,9,10,57,44,13,60
Stranraer,5164,5,15,5,16,55,66,-11,50
East Fife,5164,6,14,3,19,49,64,-15,45
Airdrieon,5164,7,11,11,14,47,59,-12,44
Forfar,5164,8,10,5,21,39,66,-27,35
Albion,5164,9,8,6,22,58,82,-24,30
Queen's Park,5164,10,6,10,20,39,73,-34,28
Raith,5165,1,23,8,5,70,32,38,77
Ayr,5165,2,24,4,8,97,45,52,76
Arbroath,5165,3,18,8,10,72,49,23,62
Alloa,5165,4,17,8,11,56,45,11,59
Stranraer,5165,5,16,5,15,57,64,-7,53
Airdrieon,5165,6,11,11,14,47,58,-11,44
East Fife,5165,7,13,3,20,47,66,-19,42
Forfar,5165,8,10,5,21,38,66,-28,35
Albion,5165,9,8,6,22,60,85,-25,30
Queen's Park,5165,10,6,10,20,40,74,-34,28
Raith,5166,1,23,8,5,69,32,37,77
Ayr,5166,2,23,5,8,90,42,48,74
Arbroath,5166,3,18,8,10,72,49,23,62
Alloa,5166,4,17,8,11,56,44,12,59
Stranraer,5166,5,15,5,16,55,66,-11,50
East Fife,5166,6,14,3,19,49,64,-15,45
Airdrieon,5166,7,10,12,14,46,59,-13,42
Forfar,5166,8,10,6,20,39,65,-26,36
Albion,5166,9,8,7,21,57,78,-21,31
Queen's Park,5166,10,6,10,20,40,74,-34,28
Raith,5167,1,23,8,5,70,33,37,77
Ayr,5167,2,24,4,8,93,42,51,76
Arbroath,5167,3,17,8,11,71,50,21,59
Alloa,5167,4,17,8,11,57,45,12,59
Stranraer,5167,5,16,5,15,58,66,-8,53
East Fife,5167,6,13,3,20,49,67,-18,42
Airdrieon,5167,7,10,11,15,45,62,-17,41
Forfar,5167,8,11,5,20,42,64,-22,38
Queen's Park,5167,9,7,10,19,41,73,-32,31
Albion,5167,10,8,6,22,57,81,-24,30
Raith,5168,1,23,8,5,70,32,38,77
Ayr,5168,2,24,4,8,97,44,53,76
Arbroath,5168,3,18,8,10,72,48,24,62
Alloa,5168,4,17,8,11,56,45,11,59
Stranraer,5168,5,16,5,15,57,64,-7,53
East Fife,5168,6,13,3,20,47,66,-19,42
Airdrieon,5168,7,10,11,15,46,60,-14,41
Forfar,5168,8,11,5,20,40,65,-25,38
Albion,5168,9,8,6,22,59,85,-26,30
Queen's Park,5168,10,6,10,20,39,74,-35,28
Raith,5169,1,23,8,5,70,32,38,77
Ayr,5169,2,23,5,8,91,43,48,74
Arbroath,5169,3,17,8,11,71,50,21,59
Alloa,5169,4,17,8,11,56,45,11,59
Stranraer,5169,5,16,5,15,58,64,-6,53
East Fife,5169,6,13,3,20,47,67,-20,42
Airdrieon,5169,7,10,11,15,46,61,-15,41
Forfar,5169,8,11,5,20,41,65,-24,38
Albion,5169,9,8,7,21,58,79,-21,31
Queen's Park,5169,10,7,10,19,41,73,-32,31
Ayr,5170,1,24,4,8,96,44,52,76
Raith,5170,2,22,9,5,69,33,36,75
Arbroath,5170,3,17,9,10,71,49,22,60
Alloa,5170,4,17,9,10,57,44,13,60
Stranraer,5170,5,16,5,15,58,66,-8,53
Airdrieon,5170,6,10,12,14,45,58,-13,42
East Fife,5170,7,13,3,20,49,67,-18,42
Forfar,5170,8,10,6,20,38,64,-26,36
Albion,5170,9,8,6,22,59,84,-25,30
Queen's Park,5170,10,6,11,19,40,73,-33,29
Ayr,5171,1,24,4,8,91,42,49,76
Raith,5171,2,22,8,6,68,33,35,74
Alloa,5171,3,18,8,10,57,43,14,62
Arbroath,5171,4,17,8,11,70,49,21,59
Stranraer,5171,5,15,6,15,56,65,-9,51
East Fife,5171,6,13,4,19,48,65,-17,43
Airdrieon,5171,7,10,12,14,46,59,-13,42
Forfar,5171,8,10,6,20,39,65,-26,36
Queen's Park,5171,9,7,10,19,40,72,-32,31
Albion,5171,10,8,6,22,57,79,-22,30
Ayr,5172,1,24,4,8,91,42,49,76
Raith,5172,2,22,9,5,70,34,36,75
Arbroath,5172,3,18,8,10,73,48,25,62
Alloa,5172,4,17,9,10,58,45,13,60
Stranraer,5172,5,15,5,16,55,66,-11,50
East Fife,5172,6,14,3,19,49,64,-15,45
Airdrieon,5172,7,11,11,14,47,58,-11,44
Forfar,5172,8,10,5,21,38,66,-28,35
Albion,5172,9,8,6,22,57,79,-22,30
Queen's Park,5172,10,6,10,20,39,75,-36,28
Ayr,5173,1,24,4,8,93,43,50,76
Raith,5173,2,22,8,6,69,35,34,74
Alloa,5173,3,18,8,10,59,44,15,62
Arbroath,5173,4,17,8,11,70,49,21,59
Stranraer,5173,5,16,5,15,57,65,-8,53
East Fife,5173,6,13,3,20,48,66,-18,42
Airdrieon,5173,7,10,11,15,47,61,-14,41
Forfar,5173,8,11,5,20,41,66,-25,38
Queen's Park,5173,9,7,10,19,40,72,-32,31
Albion,5173,10,8,6,22,58,81,-23,30
Ayr,5174,1,24,4,8,94,44,50,76
Raith,5174,2,22,8,6,68,33,35,74
Alloa,5174,3,18,8,10,57,43,14,62
Arbroath,5174,4,17,9,10,71,49,22,60
Stranraer,5174,5,16,5,15,57,65,-8,53
Airdrieon,5174,6,11,11,14,47,58,-11,44
East Fife,5174,7,13,3,20,48,66,-18,42
Forfar,5174,8,10,5,21,38,66,-28,35
Albion,5174,9,8,6,22,59,82,-23,30
Queen's Park,5174,10,6,11,19,40,73,-33,29
Raith,5175,1,23,8,5,71,32,39,77
Ayr,5175,2,24,4,8,96,45,51,76
Arbroath,5175,3,18,8,10,72,49,23,62
Alloa,5175,4,17,8,11,56,46,10,59
Stranraer,5175,5,16,5,15,56,64,-8,53
Airdrieon,5175,6,10,12,14,45,58,-13,42
East Fife,5175,7,13,3,20,47,65,-18,42
Forfar,5175,8,10,6,20,38,64,-26,36
Albion,5175,9,8,6,22,60,84,-24,30
Queen's Park,5175,10,6,10,20,40,74,-34,28
Ayr,5176,1,24,4,8,92,42,50,76
Raith,5176,2,22,9,5,68,32,36,75
Alloa,5176,3,17,9,10,56,43,13,60
Arbroath,5176,4,17,8,11,71,50,21,59
Stranraer,5176,5,16,5,15,58,65,-7,53
Airdrieon,5176,6,11,11,14,47,58,-11,44
East Fife,5176,7,13,3,20,48,67,-19,42
Forfar,5176,8,10,5,21,38,66,-28,35
Queen's Park,5176,9,7,10,19,41,73,-32,31
Albion,5176,10,8,6,22,57,80,-23,30
Ayr,5177,1,24,4,8,94,42,52,76
Raith,5177,2,22,9,5,70,34,36,75
Arbroath,5177,3,17,9,10,71,49,22,60
Alloa,5177,4,17,9,10,58,45,13,60
Stranraer,5177,5,15,5,16,55,65,-10,50
East Fife,5177,6,14,3,19,48,64,-16,45
Airdrieon,5177,7,11,11,14,48,60,-12,44
Forfar,5177,8,10,5,21,40,67,-27,35
Albion,5177,9,8,6,22,57,82,-25,30
Queen's Park,5177,10,6,11,19,40,73,-33,29
Ayr,5178,1,23,5,8,91,43,48,74
Raith,5178,2,22,8,6,69,34,35,74
Alloa,5178,3,18,8,10,58,44,14,62
Arbroath,5178,4,17,8,11,70,49,21,59
Stranraer,5178,5,16,5,15,57,64,-7,53
East Fife,5178,6,13,3,20,47,66,-19,42
Airdrieon,5178,7,10,11,15,46,60,-14,41
Forfar,5178,8,11,5,20,40,65,-25,38
Albion,5178,9,8,7,21,58,79,-21,31
Queen's Park,5178,10,7,10,19,40,72,-32,31
Raith,5179,1,23,8,5,69,32,37,77
Ayr,5179,2,24,4,8,94,43,51,76
Arbroath,5179,3,18,8,10,75,49,26,62
Alloa,5179,4,17,8,11,56,44,12,59
Stranraer,5179,5,16,5,15,58,66,-8,53
East Fife,5179,6,13,3,20,49,67,-18,42
Airdrieon,5179,7,10,11,15,46,60,-14,41
Forfar,5179,8,11,5,20,40,65,-25,38
Albion,5179,9,8,6,22,58,82,-24,30
Queen's Park,5179,10,6,10,20,40,77,-37,28
Raith,5180,1,23,8,5,70,32,38,77
Ayr,5180,2,23,5,8,91,43,48,74
Arbroath,5180,3,17,9,10,71,49,22,60
Alloa,5180,4,17,8,11,56,45,11,59
Stranraer,5180,5,15,5,16,56,67,-11,50
East Fife,5180,6,14,3,19,50,65,-15,45
Airdrieon,5180,7,11,11,14,47,58,-11,44
Forfar,5180,8,10,5,21,38,66,-28,35
Albion,5180,9,8,7,21,58,79,-21,31
Queen's Park,5180,10,6,11,19,40,73,-33,29
Raith,5181,1,23,8,5,72,32,40,77
Ayr,5181,2,24,4,8,95,42,53,76
Arbroath,5181,3,17,9,10,71,49,22,60
Alloa,5181,4,17,8,11,56,47,9,59
Stranraer,5181,5,16,5,15,60,65,-5,53
East Fife,5181,6,13,3,20,48,69,-21,42
Airdrieon,5181,7,10,11,15,46,60,-14,41
Forfar,5181,8,11,5,20,40,65,-25,38
Albion,5181,9,8,6,22,57,83,-26,30
Queen's Park,5181,10,6,11,19,40,73,-33,29
Raith,5182,1,23,8,5,70,32,38,77
Ayr,5182,2,24,4,8,93,44,49,76
Arbroath,5182,3,18,8,10,74,49,25,62
Alloa,5182,4,17,8,11,56,45,11,59
Stranraer,5182,5,15,5,16,55,65,-10,50
East Fife,5182,6,14,3,19,48,64,-16,45
Airdrieon,5182,7,10,12,14,46,59,-13,42
Forfar,5182,8,10,6,20,39,65,-26,36
Albion,5182,9,8,6,22,59,81,-22,30
Queen's Park,5182,10,6,10,20,40,76,-36,28
Raith,5183,1,23,8,5,71,34,37,77
Ayr,5183,2,24,4,8,95,44,51,76
Arbroath,5183,3,18,8,10,73,50,23,62
Alloa,5183,4,17,8,11,58,46,12,59
Stranraer,5183,5,15,6,15,57,66,-9,51
East Fife,5183,6,13,4,19,49,66,-17,43
Airdrieon,5183,7,10,11,15,46,61,-15,41
Forfar,5183,8,11,5,20,41,65,-24,38
Albion,5183,9,8,6,22,59,83,-24,30
Queen's Park,5183,10,6,10,20,41,75,-34,28
Raith,5184,1,23,8,5,70,33,37,77
Ayr,5184,2,24,4,8,94,43,51,76
Arbroath,5184,3,17,9,10,72,50,22,60
Alloa,5184,4,17,8,11,57,45,12,59
Stranraer,5184,5,15,5,16,55,65,-10,50
East Fife,5184,6,14,3,19,48,64,-16,45
Airdrieon,5184,7,11,11,14,48,59,-11,44
Forfar,5184,8,10,5,21,39,67,-28,35
Albion,5184,9,8,6,22,58,82,-24,30
Queen's Park,5184,10,6,11,19,41,74,-33,29
Raith,5185,1,23,8,5,70,33,37,77
Ayr,5185,2,23,4,9,92,45,47,73
Arbroath,5185,3,18,8,10,74,51,23,62
Alloa,5185,4,17,8,11,57,45,12,59
Stranraer,5185,5,15,6,15,57,66,-9,51
East Fife,5185,6,13,4,19,49,66,-17,43
Airdrieon,5185,7,10,11,15,45,59,-14,41
Forfar,5185,8,11,5,20,39,64,-25,38
Albion,5185,9,9,6,21,60,80,-20,33
Queen's Park,5185,10,6,10,20,42,76,-34,28
Raith,5186,1,23,8,5,72,33,39,77
Ayr,5186,2,24,4,8,98,42,56,76
Arbroath,5186,3,18,8,10,72,49,23,62
Alloa,5186,4,17,8,11,57,47,10,59
Stranraer,5186,5,15,5,16,56,66,-10,50
East Fife,5186,6,14,3,19,49,65,-16,45
Airdrieon,5186,7,10,11,15,45,59,-14,41
Forfar,5186,8,11,5,20,39,64,-25,38
Albion,5186,9,8,6,22,57,86,-29,30
Queen's Park,5186,10,6,10,20,40,74,-34,28
Ayr,5187,1,24,4,8,95,42,53,76
Raith,5187,2,22,8,6,68,33,35,74
Arbroath,5187,3,18,8,10,72,49,23,62
Alloa,5187,4,18,8,10,57,43,14,62
Stranraer,5187,5,15,5,16,57,67,-10,50
East Fife,5187,6,14,3,19,50,66,-16,45
Airdrieon,5187,7,11,11,14,48,59,-11,44
Forfar,5187,8,10,5,21,39,67,-28,35
Albion,5187,9,8,6,22,57,83,-26,30
Queen's Park,5187,10,6,10,20,40,74,-34,28
Raith,5188,1,23,8,5,69,32,37,77
Ayr,5188,2,24,4,8,95,42,53,76
Arbroath,5188,3,18,8,10,73,49,24,62
Alloa,5188,4,17,8,11,56,44,12,59
Stranraer,5188,5,15,6,15,57,66,-9,51
Airdrieon,5188,6,11,11,14,47,58,-11,44
East Fife,5188,7,13,4,19,49,66,-17,43
Forfar,5188,8,10,5,21,38,66,-28,35
Albion,5188,9,8,6,22,57,83,-26,30
Queen's Park,5188,10,6,10,20,40,75,-35,28
Raith,5189,1,23,8,5,70,33,37,77
Ayr,5189,2,24,4,8,93,44,49,76
Arbroath,5189,3,17,9,10,72,50,22,60
Alloa,5189,4,17,8,11,57,45,12,59
Stranraer,5189,5,15,5,16,55,66,-11,50
East Fife,5189,6,14,3,19,49,64,-15,45
Airdrieon,5189,7,11,11,14,47,59,-12,44
Forfar,5189,8,10,5,21,39,66,-27,35
Albion,5189,9,8,6,22,59,81,-22,30
Queen's Park,5189,10,6,11,19,41,74,-33,29
Raith,5190,1,22,9,5,68,32,36,75
Ayr,5190,2,23,5,8,93,45,48,74
Alloa,5190,3,17,9,10,56,43,13,60
Arbroath,5190,4,17,8,11,72,51,21,59
Stranraer,5190,5,15,5,16,55,66,-11,50
East Fife,5190,6,14,3,19,49,64,-15,45
Airdrieon,5190,7,10,11,15,45,59,-14,41
Forfar,5190,8,11,5,20,39,64,-25,38
Albion,5190,9,8,7,21,60,81,-21,31
Queen's Park,5190,10,7,10,19,42,74,-32,31
Ayr,5191,1,24,4,8,95,42,53,76
Raith,5191,2,22,9,5,68,32,36,75
Alloa,5191,3,17,9,10,56,43,13,60
Arbroath,5191,4,17,8,11,70,52,18,59
Stranraer,5191,5,16,5,15,58,65,-7,53
Airdrieon,5191,6,11,11,14,49,60,-11,44
East Fife,5191,7,13,3,20,48,67,-19,42
Forfar,5191,8,10,5,21,40,68,-28,35
Queen's Park,5191,9,7,10,19,43,72,-29,31
Albion,5191,10,8,6,22,57,83,-26,30
Ayr,5192,1,23,5,8,92,44,48,74
Raith,5192,2,22,8,6,68,33,35,74
Arbroath,5192,3,18,8,10,72,49,23,62
Alloa,5192,4,18,8,10,57,43,14,62
Stranraer,5192,5,16,5,15,57,64,-7,53
East Fife,5192,6,13,3,20,47,66,-19,42
Airdrieon,5192,7,10,11,15,47,61,-14,41
Forfar,5192,8,11,5,20,41,66,-25,38
Albion,5192,9,8,7,21,59,80,-21,31
Queen's Park,5192,10,6,10,20,40,74,-34,28
Ayr,5193,1,24,4,8,97,44,53,76
Raith,5193,2,22,9,5,69,33,36,75
Arbroath,5193,3,18,8,10,74,48,26,62
Alloa,5193,4,17,9,10,57,44,13,60
Stranraer,5193,5,16,5,15,58,65,-7,53
East Fife,5193,6,13,3,20,48,67,-19,42
Airdrieon,5193,7,10,11,15,45,60,-15,41
Forfar,5193,8,11,5,20,40,64,-24,38
Albion,5193,9,8,6,22,59,85,-26,30
Queen's Park,5193,10,6,10,20,39,76,-37,28
Raith,5194,1,23,8,5,70,33,37,77
Ayr,5194,2,24,4,8,96,43,53,76
Arbroath,5194,3,18,8,10,75,49,26,62
Alloa,5194,4,17,8,11,57,45,12,59
Stranraer,5194,5,15,6,15,55,64,-9,51
Airdrieon,5194,6,11,11,14,47,58,-11,44
East Fife,5194,7,13,4,19,47,64,-17,43
Forfar,5194,8,10,5,21,38,66,-28,35
Albion,5194,9,8,6,22,58,84,-26,30
Queen's Park,5194,10,6,10,20,40,77,-37,28
Raith,5195,1,23,8,5,72,32,40,77
Ayr,5195,2,24,4,8,94,43,51,76
Arbroath,5195,3,18,8,10,72,49,23,62
Alloa,5195,4,17,8,11,56,47,9,59
Stranraer,5195,5,15,6,15,59,68,-9,51
East Fife,5195,6,13,4,19,51,68,-17,43
Airdrieon,5195,7,10,11,15,46,60,-14,41
Forfar,5195,8,11,5,20,40,65,-25,38
Albion,5195,9,8,6,22,58,82,-24,30
Queen's Park,5195,10,6,10,20,40,74,-34,28
Raith,5196,1,23,8,5,71,32,39,77
Ayr,5196,2,24,4,8,92,42,50,76
Arbroath,5196,3,17,9,10,71,49,22,60
Alloa,5196,4,17,8,11,56,46,10,59
Stranraer,5196,5,16,5,15,57,65,-8,53
Airdrieon,5196,6,11,11,14,47,58,-11,44
East Fife,5196,7,13,3,20,48,66,-18,42
Forfar,5196,8,10,5,21,38,66,-28,35
Albion,5196,9,8,6,22,57,80,-23,30
Queen's Park,5196,10,6,11,19,40,73,-33,29
Raith,5197,1,23,8,5,69,32,37,77
Ayr,5197,2,24,4,8,93,43,50,76
Arbroath,5197,3,17,8,11,72,52,20,59
Alloa,5197,4,17,8,11,56,44,12,59
Stranraer,5197,5,15,5,16,56,66,-10,50
East Fife,5197,6,14,3,19,49,65,-16,45
Airdrieon,5197,7,11,11,14,48,60,-12,44
Forfar,5197,8,10,5,21,40,67,-27,35
Queen's Park,5197,9,7,10,19,43,74,-31,31
Albion,5197,10,8,6,22,58,81,-23,30
Raith,5198,1,23,8,5,72,34,38,77
Ayr,5198,2,24,4,8,93,42,51,76
Arbroath,5198,3,18,8,10,72,48,24,62
Alloa,5198,4,17,8,11,58,47,11,59
Stranraer,5198,5,15,6,15,57,66,-9,51
East Fife,5198,6,13,4,19,49,66,-17,43
Airdrieon,5198,7,10,11,15,46,60,-14,41
Forfar,5198,8,11,5,20,40,65,-25,38
Albion,5198,9,8,6,22,57,81,-24,30
Queen's Park,5198,10,6,10,20,39,74,-35,28
Raith,5199,1,22,9,5,68,32,36,75
Ayr,5199,2,23,4,9,90,43,47,73
Arbroath,5199,3,18,8,10,74,50,24,62
Alloa,5199,4,17,9,10,56,43,13,60
Stranraer,5199,5,15,6,15,56,65,-9,51
East Fife,5199,6,13,4,19,48,65,-17,43
Airdrieon,5199,7,10,12,14,47,60,-13,42
Forfar,5199,8,10,6,20,40,66,-26,36
Albion,5199,9,9,6,21,58,78,-20,33
Queen's Park,5199,10,6,10,20,41,76,-35,28
Raith,5200,1,23,8,5,71,32,39,77
Ayr,5200,2,24,4,8,95,44,51,76
Arbroath,5200,3,17,8,11,71,50,21,59
Alloa,5200,4,17,8,11,56,46,10,59
Stranraer,5200,5,15,6,15,55,64,-9,51
Airdrieon,5200,6,11,11,14,51,58,-7,44
East Fife,5200,7,13,4,19,47,64,-17,43
Forfar,5200,8,10,5,21,38,70,-32,35
Queen's Park,5200,9,7,10,19,41,73,-32,31
Albion,5200,10,8,6,22,59,83,-24,30
Raith,5201,1,23,8,5,71,33,38,77
Ayr,5201,2,24,4,8,96,42,54,76
Arbroath,5201,3,18,8,10,72,48,24,62
Alloa,5201,4,17,8,11,57,46,11,59
Stranraer,5201,5,15,6,15,57,66,-9,51
Airdrieon,5201,6,11,11,14,47,59,-12,44
East Fife,5201,7,13,4,19,49,66,-17,43
Forfar,5201,8,10,5,21,39,66,-27,35
Albion,5201,9,8,6,22,57,84,-27,30
Queen's Park,5201,10,6,10,20,39,74,-35,28
Raith,5202,1,23,8,5,69,32,37,77
Ayr,5202,2,23,5,8,92,44,48,74
Arbroath,5202,3,17,8,11,71,51,20,59
Alloa,5202,4,17,8,11,56,44,12,59
Stranraer,5202,5,16,5,15,56,64,-8,53
Airdrieon,5202,6,10,12,14,45,58,-13,42
East Fife,5202,7,13,3,20,47,65,-18,42
Forfar,5202,8,10,6,20,38,64,-26,36
Albion,5202,9,8,7,21,59,80,-21,31
Queen's Park,5202,10,7,10,19,42,73,-31,31
Raith,5203,1,23,8,5,71,32,39,77
Ayr,5203,2,24,4,8,94,43,51,76
Arbroath,5203,3,17,9,10,74,52,22,60
Alloa,5203,4,17,8,11,56,46,10,59
Stranraer,5203,5,16,5,15,59,64,-5,53
Airdrieon,5203,6,10,12,14,45,58,-13,42
East Fife,5203,7,13,3,20,47,68,-21,42
Forfar,5203,8,10,6,20,38,64,-26,36
Albion,5203,9,8,6,22,58,82,-24,30
Queen's Park,5203,10,6,11,19,43,76,-33,29
Ayr,5204,1,24,4,8,92,43,49,76
Raith,5204,2,22,8,6,69,34,35,74
Alloa,5204,3,18,8,10,58,44,14,62
Arbroath,5204,4,17,9,10,72,50,22,60
Stranraer,5204,5,15,5,16,55,66,-11,50
East Fife,5204,6,14,3,19,49,64,-15,45
Airdrieon,5204,7,11,11,14,47,58,-11,44
Forfar,5204,8,10,5,21,38,66,-28,35
Albion,5204,9,8,6,22,58,80,-22,30
Queen's Park,5204,10,6,11,19,41,74,-33,29
Raith,5205,1,22,9,5,69,33,36,75
Ayr,5205,2,23,5,8,92,44,48,74
Alloa,5205,3,17,9,10,57,44,13,60
Arbroath,5205,4,17,8,11,70,51,19,59
Stranraer,5205,5,16,5,15,57,65,-8,53
East Fife,5205,6,13,3,20,48,66,-18,42
Airdrieon,5205,7,10,11,15,45,59,-14,41
Forfar,5205,8,11,5,20,39,64,-25,38
Albion,5205,9,8,7,21,59,80,-21,31
Queen's Park,5205,10,7,10,19,42,72,-30,31
Raith,5206,1,23,8,5,70,32,38,77
Ayr,5206,2,24,4,8,93,43,50,76
Arbroath,5206,3,18,8,10,73,48,25,62
Alloa,5206,4,17,8,11,56,45,11,59
Stranraer,5206,5,15,5,16,55,65,-10,50
East Fife,5206,6,14,3,19,48,64,-16,45
Airdrieon,5206,7,10,11,15,46,61,-15,41
Forfar,5206,8,11,5,20,41,65,-24,38
Albion,5206,9,8,6,22,58,81,-23,30
Queen's Park,5206,10,6,10,20,39,75,-36,28
Raith,5207,1,22,8,6,68,33,35,74
Ayr,5207,2,23,4,9,90,43,47,73
Arbroath,5207,3,18,8,10,72,48,24,62
Alloa,5207,4,18,8,10,57,43,14,62
Stranraer,5207,5,16,5,15,57,65,-8,53
Airdrieon,5207,6,10,12,14,45,58,-13,42
East Fife,5207,7,13,3,20,48,66,-18,42
Forfar,5207,8,10,6,20,38,64,-26,36
Albion,5207,9,9,6,21,58,78,-20,33
Queen's Park,5207,10,6,10,20,39,74,-35,28
Ayr,5208,1,24,4,8,94,45,49,76
Raith,5208,2,22,8,6,68,33,35,74
Alloa,5208,3,18,8,10,57,43,14,62
Arbroath,5208,4,17,9,10,70,48,22,60
Stranraer,5208,5,15,5,16,56,66,-10,50
East Fife,5208,6,14,3,19,49,65,-16,45
Airdrieon,5208,7,10,12,14,46,59,-13,42
Forfar,5208,8,10,6,20,39,65,-26,36
Albion,5208,9,8,6,22,60,82,-22,30
Queen's Park,5208,10,6,11,19,39,72,-33,29
Raith,5209,1,23,8,5,71,32,39,77
Ayr,5209,2,24,4,8,94,42,52,76
Arbroath,5209,3,17,8,11,71,50,21,59
Alloa,5209,4,17,8,11,56,46,10,59
Stranraer,5209,5,16,5,15,57,65,-8,53
Airdrieon,5209,6,10,12,14,46,59,-13,42
East Fife,5209,7,13,3,20,48,66,-18,42
Forfar,5209,8,10,6,20,39,65,-26,36
Queen's Park,5209,9,7,10,19,41,73,-32,31
Albion,5209,10,8,6,22,57,82,-25,30
Ayr,5210,1,24,4,8,95,44,51,76
Raith,5210,2,22,8,6,69,34,35,74
Arbroath,5210,3,18,8,10,71,48,23,62
Alloa,5210,4,18,8,10,58,44,14,62
Stranraer,5210,5,16,5,15,58,66,-8,53
Airdrieon,5210,6,11,11,14,47,59,-12,44
East Fife,5210,7,13,3,20,49,67,-18,42
Forfar,5210,8,10,5,21,39,66,-27,35
Albion,5210,9,8,6,22,59,83,-24,30
Queen's Park,5210,10,6,10,20,39,73,-34,28
Ayr,5211,1,24,4,8,94,44,50,76
Raith,5211,2,22,8,6,68,34,34,74
Arbroath,5211,3,18,8,10,72,48,24,62
Alloa,5211,4,18,8,10,58,43,15,62
Stranraer,5211,5,15,6,15,56,65,-9,51
Airdrieon,5211,6,11,11,14,46,58,-12,44
East Fife,5211,7,13,4,19,48,65,-17,43
Forfar,5211,8,10,5,21,38,65,-27,35
Albion,5211,9,8,6,22,59,82,-23,30
Queen's Park,5211,10,6,10,20,39,74,-35,28
Raith,5212,1,23,8,5,70,33,37,77
Ayr,5212,2,24,4,8,92,43,49,76
Arbroath,5212,3,17,8,11,70,49,21,59
Alloa,5212,4,17,8,11,57,45,12,59
Stranraer,5212,5,16,5,15,56,64,-8,53
East Fife,5212,6,13,3,20,47,65,-18,42
Airdrieon,5212,7,10,11,15,45,60,-15,41
Forfar,5212,8,11,5,20,40,64,-24,38
Queen's Park,5212,9,7,10,19,40,72,-32,31
Albion,5212,10,8,6,22,58,80,-22,30
Raith,5213,1,23,8,5,73,34,39,77
Ayr,5213,2,23,5,8,92,44,48,74
Arbroath,5213,3,18,8,10,72,48,24,62
Alloa,5213,4,17,8,11,58,48,10,59
Stranraer,5213,5,16,5,15,58,65,-7,53
Airdrieon,5213,6,10,12,14,47,60,-13,42
East Fife,5213,7,13,3,20,48,67,-19,42
Forfar,5213,8,10,6,20,40,66,-26,36
Albion,5213,9,8,7,21,59,80,-21,31
Queen's Park,5213,10,6,10,20,39,74,-35,28
Ayr,5214,1,24,4,8,98,42,56,76
Raith,5214,2,22,9,5,70,34,36,75
Arbroath,5214,3,17,9,10,71,49,22,60
Alloa,5214,4,17,9,10,58,45,13,60
Stranraer,5214,5,15,6,15,55,64,-9,51
Airdrieon,5214,6,11,11,14,48,59,-11,44
East Fife,5214,7,13,4,19,47,64,-17,43
Forfar,5214,8,10,5,21,39,67,-28,35
Albion,5214,9,8,6,22,57,86,-29,30
Queen's Park,5214,10,6,11,19,40,73,-33,29
Raith,5215,1,22,9,5,69,33,36,75
Ayr,5215,2,23,4,9,91,45,46,73
Arbroath,5215,3,18,8,10,74,50,24,62
Alloa,5215,4,17,9,10,57,44,13,60
Stranraer,5215,5,15,6,15,56,65,-9,51
East Fife,5215,6,13,4,19,48,65,-17,43
Airdrieon,5215,7,10,12,14,46,59,-13,42
Forfar,5215,8,10,6,20,39,65,-26,36
Albion,5215,9,9,6,21,60,79,-19,33
Queen's Park,5215,10,6,10,20,41,76,-35,28
Ayr,5216,1,24,4,8,97,42,55,76
Raith,5216,2,22,9,5,69,33,36,75
Arbroath,5216,3,18,8,10,71,48,23,62
Alloa,5216,4,17,9,10,57,44,13,60
Stranraer,5216,5,16,5,15,57,64,-7,53
Airdrieon,5216,6,10,12,14,45,58,-13,42
East Fife,5216,7,13,3,20,47,66,-19,42
Forfar,5216,8,10,6,20,38,64,-26,36
Albion,5216,9,8,6,22,57,85,-28,30
Queen's Park,5216,10,6,10,20,39,73,-34,28
Raith,5217,1,22,8,6,68,33,35,74
Ayr,5217,2,23,4,9,90,43,47,73
Arbroath,5217,3,18,8,10,72,49,23,62
Alloa,5217,4,18,8,10,57,43,14,62
Stranraer,5217,5,15,5,16,56,69,-13,50
East Fife,5217,6,14,3,19,52,65,-13,45
Airdrieon,5217,7,11,11,14,48,59,-11,44
Forfar,5217,8,10,5,21,39,67,-28,35
Albion,5217,9,9,6,21,58,78,-20,33
Queen's Park,5217,10,6,10,20,40,74,-34,28
Raith,5218,1,23,8,5,72,33,39,77
Ayr,5218,2,24,4,8,94,42,52,76
Arbroath,5218,3,18,8,10,71,48,23,62
Alloa,5218,4,17,8,11,57,47,10,59
Stranraer,5218,5,15,5,16,55,66,-11,50
East Fife,5218,6,14,3,19,49,64,-15,45
Airdrieon,5218,7,11,11,14,47,59,-12,44
Forfar,5218,8,10,5,21,39,66,-27,35
Albion,5218,9,8,6,22,57,82,-25,30
Queen's Park,5218,10,6,10,20,39,73,-34,28
Ayr,5219,1,24,4,8,91,42,49,76
Raith,5219,2,22,9,5,68,32,36,75
Arbroath,5219,3,17,9,10,72,50,22,60
Alloa,5219,4,17,9,10,56,43,13,60
Stranraer,5219,5,15,5,16,55,66,-11,50
East Fife,5219,6,14,3,19,49,64,-15,45
Airdrieon,5219,7,10,12,14,47,60,-13,42
Forfar,5219,8,10,6,20,40,66,-26,36
Albion,5219,9,8,6,22,57,79,-22,30
Queen's Park,5219,10,6,11,19,41,74,-33,29
Raith,5220,1,22,8,6,70,36,34,74
Ayr,5220,2,23,4,9,92,46,46,73
Alloa,5220,3,18,8,10,60,45,15,62
Arbroath,5220,4,17,8,11,70,50,20,59
Stranraer,5220,5,15,6,15,57,66,-9,51
East Fife,5220,6,13,4,19,49,66,-17,43
Airdrieon,5220,7,10,11,15,46,60,-14,41
Forfar,5220,8,11,5,20,40,65,-25,38
Albion,5220,9,9,6,21,61,80,-19,33
Queen's Park,5220,10,7,10,19,41,72,-31,31
Ayr,5221,1,24,4,8,93,42,51,76
Raith,5221,2,22,9,5,68,32,36,75
Alloa,5221,3,17,9,10,56,43,13,60
Arbroath,5221,4,17,8,11,70,49,21,59
Stranraer,5221,5,15,5,16,55,67,-12,50
East Fife,5221,6,14,3,19,50,64,-14,45
Airdrieon,5221,7,10,11,15,45,62,-17,41
Forfar,5221,8,11,5,20,42,64,-22,38
Queen's Park,5221,9,7,10,19,40,72,-32,31
Albion,5221,10,8,6,22,57,81,-24,30
Ayr,5222,1,24,4,8,94,43,51,76
Raith,5222,2,22,8,6,68,33,35,74
Arbroath,5222,3,18,8,10,74,49,25,62
Alloa,5222,4,18,8,10,57,43,14,62
Stranraer,5222,5,16,5,15,56,64,-8,53
Airdrieon,5222,6,10,12,14,47,60,-13,42
East Fife,5222,7,13,3,20,47,65,-18,42
Forfar,5222,8,10,6,20,40,66,-26,36
Albion,5222,9,8,6,22,58,82,-24,30
Queen's Park,5222,10,6,10,20,40,76,-36,28
Raith,5223,1,23,8,5,70,32,38,77
Ayr,5223,2,24,4,8,93,44,49,76
Arbroath,5223,3,17,8,11,70,51,19,59
Alloa,5223,4,17,8,11,56,45,11,59
Stranraer,5223,5,16,5,15,57,65,-8,53
East Fife,5223,6,13,3,20,48,66,-18,42
Airdrieon,5223,7,10,11,15,45,59,-14,41
Forfar,5223,8,11,5,20,39,64,-25,38
Queen's Park,5223,9,7,10,19,42,72,-30,31
Albion,5223,10,8,6,22,59,81,-22,30
Raith,5224,1,23,8,5,71,34,37,77
Ayr,5224,2,23,5,8,91,43,48,74
Arbroath,5224,3,17,8,11,71,50,21,59
Alloa,5224,4,17,8,11,58,46,12,59
Stranraer,5224,5,16,5,15,56,64,-8,53
Airdrieon,5224,6,10,12,14,47,60,-13,42
East Fife,5224,7,13,3,20,47,65,-18,42
Forfar,5224,8,10,6,20,40,66,-26,36
Albion,5224,9,8,7,21,58,79,-21,31
Queen's Park,5224,10,7,10,19,41,73,-32,31
Raith,5225,1,23,8,5,71,32,39,77
Ayr,5225,2,23,5,8,92,44,48,74
Arbroath,5225,3,17,8,11,71,50,21,59
Alloa,5225,4,17,8,11,56,46,10,59
Stranraer,5225,5,15,5,16,56,68,-12,50
East Fife,5225,6,14,3,19,51,65,-14,45
Airdrieon,5225,7,11,11,14,47,59,-12,44
Forfar,5225,8,10,5,21,39,66,-27,35
Albion,5225,9,8,7,21,59,80,-21,31
Queen's Park,5225,10,7,10,19,41,73,-32,31
Raith,5226,1,22,9,5,70,34,36,75
Ayr,5226,2,23,5,8,91,43,48,74
Arbroath,5226,3,17,9,10,72,50,22,60
Alloa,5226,4,17,9,10,58,45,13,60
Stranraer,5226,5,15,5,16,55,67,-12,50
East Fife,5226,6,14,3,19,50,64,-14,45
Airdrieon,5226,7,10,12,14,46,59,-13,42
Forfar,5226,8,10,6,20,39,65,-26,36
Albion,5226,9,8,7,21,58,79,-21,31
Queen's Park,5226,10,6,11,19,41,74,-33,29
Ayr,5227,1,24,4,8,95,46,49,76
Raith,5227,2,22,9,5,69,33,36,75
Arbroath,5227,3,18,8,10,72,48,24,62
Alloa,5227,4,17,9,10,57,44,13,60
Stranraer,5227,5,16,5,15,56,64,-8,53
Airdrieon,5227,6,11,11,14,49,58,-9,44
East Fife,5227,7,13,3,20,47,65,-18,42
Forfar,5227,8,10,5,21,38,68,-30,35
Albion,5227,9,8,6,22,61,83,-22,30
Queen's Park,5227,10,6,10,20,39,74,-35,28
Ayr,5228,1,24,4,8,93,43,50,76
Raith,5228,2,22,9,5,68,32,36,75
Alloa,5228,3,17,9,10,56,43,13,60
Arbroath,5228,4,17,8,11,70,49,21,59
Stranraer,5228,5,16,5,15,58,64,-6,53
Airdrieon,5228,6,10,12,14,47,60,-13,42
East Fife,5228,7,13,3,20,47,67,-20,42
Forfar,5228,8,10,6,20,40,66,-26,36
Queen's Park,5228,9,7,10,19,40,72,-32,31
Albion,5228,10,8,6,22,58,81,-23,30
Ayr,5229,1,24,4,8,93,43,50,76
Raith,5229,2,22,8,6,69,35,34,74
Arbroath,5229,3,18,8,10,71,48,23,62
Alloa,5229,4,18,8,10,59,44,15,62
Stranraer,5229,5,16,5,15,57,65,-8,53
East Fife,5229,6,13,3,20,48,66,-18,42
Airdrieon,5229,7,10,11,15,45,59,-14,41
Forfar,5229,8,11,5,20,39,64,-25,38
Albion,5229,9,8,6,22,58,81,-23,30
Queen's Park,5229,10,6,10,20,39,73,-34,28
Ayr,5230,1,24,4,8,94,44,50,76
Raith,5230,2,22,9,5,68,32,36,75
Arbroath,5230,3,18,8,10,73,49,24,62
Alloa,5230,4,17,9,10,56,43,13,60
Stranraer,5230,5,16,5,15,56,64,-8,53
East Fife,5230,6,13,3,20,47,65,-18,42
Airdrieon,5230,7,10,11,15,47,63,-16,41
Forfar,5230,8,11,5,20,43,66,-23,38
Albion,5230,9,8,6,22,59,82,-23,30
Queen's Park,5230,10,6,10,20,40,75,-35,28
Raith,5231,1,23,8,5,71,33,38,77
Ayr,5231,2,24,4,8,96,42,54,76
Arbroath,5231,3,18,8,10,72,49,23,62
Alloa,5231,4,17,8,11,57,46,11,59
Stranraer,5231,5,15,5,16,56,66,-10,50
East Fife,5231,6,14,3,19,49,65,-16,45
Airdrieon,5231,7,10,12,14,46,59,-13,42
Forfar,5231,8,10,6,20,39,65,-26,36
Albion,5231,9,8,6,22,57,84,-27,30
Queen's Park,5231,10,6,10,20,40,74,-34,28
Raith,5232,1,23,8,5,70,32,38,77
Ayr,5232,2,24,4,8,92,42,50,76
Arbroath,5232,3,17,9,10,72,50,22,60
Alloa,5232,4,17,8,11,56,45,11,59
Stranraer,5232,5,15,5,16,56,67,-11,50
East Fife,5232,6,14,3,19,50,65,-15,45
Airdrieon,5232,7,10,11,15,45,59,-14,41
Forfar,5232,8,11,5,20,39,64,-25,38
Albion,5232,9,8,6,22,57,80,-23,30
Queen's Park,5232,10,6,11,19,41,74,-33,29
Ayr,5233,1,24,4,8,99,45,54,76
Raith,5233,2,22,8,6,69,35,34,74
Alloa,5233,3,18,8,10,59,44,15,62
Arbroath,5233,4,17,9,10,72,50,22,60
Stranraer,5233,5,16,5,15,57,65,-8,53
Airdrieon,5233,6,11,11,14,47,58,-11,44
East Fife,5233,7,13,3,20,48,66,-18,42
Forfar,5233,8,10,5,21,38,66,-28,35
Albion,5233,9,8,6,22,60,87,-27,30
Queen's Park,5233,10,6,11,19,41,74,-33,29
Raith,5234,1,23,8,5,71,32,39,77
Ayr,5234,2,24,4,8,95,43,52,76
Arbroath,5234,3,18,8,10,71,48,23,62
Alloa,5234,4,17,8,11,56,46,10,59
Stranraer,5234,5,15,6,15,55,64,-9,51
East Fife,5234,6,13,4,19,47,64,-17,43
Airdrieon,5234,7,10,11,15,45,60,-15,41
Forfar,5234,8,11,5,20,40,64,-24,38
Albion,5234,9,8,6,22,58,83,-25,30
Queen's Park,5234,10,6,10,20,39,73,-34,28
Ayr,5235,1,24,4,8,97,43,54,76
Raith,5235,2,22,8,6,68,33,35,74
Arbroath,5235,3,18,8,10,72,48,24,62
Alloa,5235,4,18,8,10,57,43,14,62
Stranraer,5235,5,16,5,15,57,65,-8,53
Airdrieon,5235,6,11,11,14,47,59,-12,44
East Fife,5235,7,13,3,20,48,66,-18,42
Forfar,5235,8,10,5,21,39,66,-27,35
Albion,5235,9,8,6,22,58,85,-27,30
Queen's Park,5235,10,6,10,20,39,74,-35,28
Raith,5236,1,23,8,5,70,32,38,77
Ayr,5236,2,24,4,8,97,44,53,76
Arbroath,5236,3,18,8,10,74,51,23,62
Alloa,5236,4,17,8,11,56,45,11,59
Stranraer,5236,5,15,5,16,55,66,-11,50
East Fife,5236,6,14,3,19,49,64,-15,45
Airdrieon,5236,7,10,12,14,46,59,-13,42
Forfar,5236,8,10,6,20,39,65,-26,36
Albion,5236,9,8,6,22,59,85,-26,30
Queen's Park,5236,10,6,10,20,42,76,-34,28
Ayr,5237,1,24,4,8,92,43,49,76
Raith,5237,2,22,9,5,68,32,36,75
Alloa,5237,3,17,9,10,56,43,13,60
Arbroath,5237,4,17,8,11,71,50,21,59
Stranraer,5237,5,15,5,16,55,65,-10,50
East Fife,5237,6,14,3,19,48,64,-16,45
Airdrieon,5237,7,10,11,15,45,61,-16,41
Forfar,5237,8,11,5,20,41,64,-23,38
Queen's Park,5237,9,7,10,19,41,73,-32,31
Albion,5237,10,8,6,22,58,80,-22,30
Ayr,5238,1,24,4,8,92,43,49,76
Raith,5238,2,22,9,5,68,32,36,75
Arbroath,5238,3,18,8,10,72,48,24,62
Alloa,5238,4,17,9,10,56,43,13,60
Stranraer,5238,5,15,6,15,56,65,-9,51
East Fife,5238,6,13,4,19,48,65,-17,43
Airdrieon,5238,7,10,12,14,47,60,-13,42
Forfar,5238,8,10,6,20,40,66,-26,36
Albion,5238,9,8,6,22,58,80,-22,30
Queen's Park,5238,10,6,10,20,39,74,-35,28
Raith,5239,1,23,8,5,71,34,37,77
Ayr,5239,2,24,4,8,92,43,49,76
Arbroath,5239,3,18,8,10,75,52,23,62
Alloa,5239,4,17,8,11,58,46,12,59
Stranraer,5239,5,15,5,16,56,66,-10,50
East Fife,5239,6,14,3,19,49,65,-16,45
Airdrieon,5239,7,11,11,14,48,59,-11,44
Forfar,5239,8,10,5,21,39,67,-28,35
Albion,5239,9,8,6,22,58,80,-22,30
Queen's Park,5239,10,6,10,20,43,77,-34,28
Raith,5240,1,23,8,5,69,32,37,77
Ayr,5240,2,24,4,8,91,42,49,76
Arbroath,5240,3,17,9,10,72,50,22,60
Alloa,5240,4,17,8,11,56,44,12,59
Stranraer,5240,5,15,5,16,57,67,-10,50
East Fife,5240,6,14,3,19,50,66,-16,45
Airdrieon,5240,7,11,11,14,46,58,-12,44
Forfar,5240,8,10,5,21,38,65,-27,35
Albion,5240,9,8,6,22,57,79,-22,30
Queen's Park,5240,10,6,11,19,41,74,-33,29
Raith,5241,1,23,8,5,71,33,38,77
Ayr,5241,2,24,4,8,94,42,52,76
Arbroath,5241,3,17,8,11,70,50,20,59
Alloa,5241,4,17,8,11,57,46,11,59
Stranraer,5241,5,15,5,16,55,65,-10,50
East Fife,5241,6,14,3,19,48,64,-16,45
Airdrieon,5241,7,11,11,14,47,58,-11,44
Forfar,5241,8,10,5,21,38,66,-28,35
Queen's Park,5241,9,7,10,19,41,72,-31,31
Albion,5241,10,8,6,22,57,82,-25,30
Ayr,5242,1,24,4,8,93,43,50,76
Raith,5242,2,22,9,5,69,33,36,75
Alloa,5242,3,17,9,10,57,44,13,60
Arbroath,5242,4,17,8,11,73,52,21,59
Stranraer,5242,5,15,5,16,55,67,-12,50
East Fife,5242,6,14,3,19,50,64,-14,45
Airdrieon,5242,7,10,12,14,45,58,-13,42
Forfar,5242,8,10,6,20,38,64,-26,36
Queen's Park,5242,9,7,10,19,43,75,-32,31
Albion,5242,10,8,6,22,58,81,-23,30
Ayr,5243,1,23,5,8,92,44,48,74
Raith,5243,2,22,8,6,71,37,34,74
Alloa,5243,3,18,8,10,61,46,15,62
Arbroath,5243,4,17,8,11,71,52,19,59
Stranraer,5243,5,16,5,15,58,65,-7,53
East Fife,5243,6,13,3,20,48,67,-19,42
Airdrieon,5243,7,10,11,15,46,60,-14,41
Forfar,5243,8,11,5,20,40,65,-25,38
Albion,5243,9,8,7,21,59,80,-21,31
Queen's Park,5243,10,7,10,19,43,73,-30,31
Ayr,5244,1,24,4,8,95,43,52,76
Raith,5244,2,22,9,5,69,33,36,75
Arbroath,5244,3,17,9,10,71,49,22,60
Alloa,5244,4,17,9,10,57,44,13,60
Stranraer,5244,5,15,5,16,55,68,-13,50
East Fife,5244,6,14,3,19,51,64,-13,45
Airdrieon,5244,7,10,11,15,45,62,-17,41
Forfar,5244,8,11,5,20,42,64,-22,38
Albion,5244,9,8,6,22,58,83,-25,30
Queen's Park,5244,10,6,11,19,40,73,-33,29
Raith,5245,1,23,8,5,70,32,38,77
Ayr,5245,2,24,4,8,94,43,51,76
Arbroath,5245,3,17,9,10,73,51,22,60
Alloa,5245,4,17,8,11,56,45,11,59
Stranraer,5245,5,15,5,16,55,65,-10,50
East Fife,5245,6,14,3,19,48,64,-16,45
Airdrieon,5245,7,10,12,14,45,58,-13,42
Forfar,5245,8,10,6,20,38,64,-26,36
Albion,5245,9,8,6,22,58,82,-24,30
Queen's Park,5245,10,6,11,19,42,75,-33,29
Raith,5246,1,23,8,5,70,32,38,77
Ayr,5246,2,24,4,8,94,43,51,76
Arbroath,5246,3,17,9,10,71,49,22,60
Alloa,5246,4,17,8,11,56,45,11,59
Stranraer,5246,5,15,5,16,56,66,-10,50
East Fife,5246,6,14,3,19,49,65,-16,45
Airdrieon,5246,7,10,11,15,46,60,-14,41
Forfar,5246,8,11,5,20,40,65,-25,38
Albion,5246,9,8,6,22,58,82,-24,30
Queen's Park,5246,10,6,11,19,40,73,-33,29
Raith,5247,1,23,8,5,69,32,37,77
Ayr,5247,2,23,5,8,90,42,48,74
Arbroath,5247,3,18,8,10,72,48,24,62
Alloa,5247,4,17,8,11,56,44,12,59
Stranraer,5247,5,15,5,16,55,65,-10,50
East Fife,5247,6,14,3,19,48,64,-16,45
Airdrieon,5247,7,10,11,15,46,60,-14,41
Forfar,5247,8,11,5,20,40,65,-25,38
Albion,5247,9,8,7,21,57,78,-21,31
Queen's Park,5247,10,6,10,20,39,74,-35,28
Raith,5248,1,23,8,5,70,32,38,77
Ayr,5248,2,24,4,8,91,42,49,76
Arbroath,5248,3,18,8,10,71,48,23,62
Alloa,5248,4,17,8,11,56,45,11,59
Stranraer,5248,5,16,5,15,58,65,-7,53
Airdrieon,5248,6,11,11,14,47,59,-12,44
East Fife,5248,7,13,3,20,48,67,-19,42
Forfar,5248,8,10,5,21,39,66,-27,35
Albion,5248,9,8,6,22,57,79,-22,30
Queen's Park,5248,10,6,10,20,39,73,-34,28
Raith,5249,1,23,8,5,70,33,37,77
Ayr,5249,2,24,4,8,95,43,52,76
Arbroath,5249,3,17,9,10,71,49,22,60
Alloa,5249,4,17,8,11,57,45,12,59
Stranraer,5249,5,15,5,16,57,68,-11,50
East Fife,5249,6,14,3,19,51,66,-15,45
Airdrieon,5249,7,11,11,14,46,58,-12,44
Forfar,5249,8,10,5,21,38,65,-27,35
Albion,5249,9,8,6,22,58,83,-25,30
Queen's Park,5249,10,6,11,19,40,73,-33,29
Raith,5250,1,22,9,5,69,33,36,75
Ayr,5250,2,23,4,9,94,47,47,73
Arbroath,5250,3,18,8,10,71,48,23,62
Alloa,5250,4,17,9,10,57,44,13,60
Stranraer,5250,5,15,5,16,55,68,-13,50
East Fife,5250,6,14,3,19,51,64,-13,45
Airdrieon,5250,7,10,12,14,46,59,-13,42
Forfar,5250,8,10,6,20,39,65,-26,36
Albion,5250,9,9,6,21,62,82,-20,33
Queen's Park,5250,10,6,10,20,39,73,-34,28
Ayr,5251,1,24,4,8,93,43,50,76
Raith,5251,2,22,9,5,70,34,36,75
Arbroath,5251,3,18,8,10,73,48,25,62
Alloa,5251,4,17,9,10,58,45,13,60
Stranraer,5251,5,15,5,16,55,67,-12,50
East Fife,5251,6,14,3,19,50,64,-14,45
Airdrieon,5251,7,10,11,15,46,60,-14,41
Forfar,5251,8,11,5,20,40,65,-25,38
Albion,5251,9,8,6,22,58,81,-23,30
Queen's Park,5251,10,6,10,20,39,75,-36,28
Raith,5252,1,22,8,6,68,34,34,74
Ayr,5252,2,23,4,9,91,45,46,73
Arbroath,5252,3,18,8,10,73,49,24,62
Alloa,5252,4,18,8,10,58,43,15,62
Stranraer,5252,5,15,6,15,56,65,-9,51
Airdrieon,5252,6,11,11,14,46,58,-12,44
East Fife,5252,7,13,4,19,48,65,-17,43
Forfar,5252,8,10,5,21,38,65,-27,35
Albion,5252,9,9,6,21,60,79,-19,33
Queen's Park,5252,10,6,10,20,40,75,-35,28
Ayr,5253,1,23,5,8,92,44,48,74
Raith,5253,2,22,8,6,68,33,35,74
Arbroath,5253,3,18,8,10,74,48,26,62
Alloa,5253,4,18,8,10,57,43,14,62
Stranraer,5253,5,15,6,15,57,66,-9,51
Airdrieon,5253,6,11,11,14,47,58,-11,44
East Fife,5253,7,13,4,19,49,66,-17,43
Forfar,5253,8,10,5,21,38,66,-28,35
Albion,5253,9,8,7,21,59,80,-21,31
Queen's Park,5253,10,6,10,20,39,76,-37,28
Ayr,5254,1,23,5,8,91,43,48,74
Raith,5254,2,22,8,6,69,34,35,74
Arbroath,5254,3,18,8,10,73,48,25,62
Alloa,5254,4,18,8,10,58,44,14,62
Stranraer,5254,5,16,5,15,58,65,-7,53
Airdrieon,5254,6,11,11,14,49,61,-12,44
East Fife,5254,7,13,3,20,48,67,-19,42
Forfar,5254,8,10,5,21,41,68,-27,35
Albion,5254,9,8,7,21,58,79,-21,31
Queen's Park,5254,10,6,10,20,39,75,-36,28
Ayr,5255,1,24,4,8,93,43,50,76
Raith,5255,2,22,9,5,69,33,36,75
Arbroath,5255,3,18,8,10,74,49,25,62
Alloa,5255,4,17,9,10,57,44,13,60
Stranraer,5255,5,15,5,16,55,65,-10,50
East Fife,5255,6,14,3,19,48,64,-16,45
Airdrieon,5255,7,10,12,14,45,58,-13,42
Forfar,5255,8,10,6,20,38,64,-26,36
Albion,5255,9,8,6,22,58,81,-23,30
Queen's Park,5255,10,6,10,20,40,76,-36,28
Raith,5256,1,23,8,5,70,32,38,77
Ayr,5256,2,23,5,8,90,42,48,74
Arbroath,5256,3,17,9,10,71,49,22,60
Alloa,5256,4,17,8,11,56,45,11,59
Stranraer,5256,5,16,5,15,60,66,-6,53
Airdrieon,5256,6,11,11,14,46,58,-12,44
East Fife,5256,7,13,3,20,49,69,-20,42
Forfar,5256,8,10,5,21,38,65,-27,35
Albion,5256,9,8,7,21,57,78,-21,31
Queen's Park,5256,10,6,11,19,40,73,-33,29
Ayr,5257,1,24,4,8,93,42,51,76
Raith,5257,2,22,9,5,69,33,36,75
Arbroath,5257,3,18,8,10,72,48,24,62
Alloa,5257,4,17,9,10,57,44,13,60
Stranraer,5257,5,16,5,15,57,64,-7,53
Airdrieon,5257,6,11,11,14,48,58,-10,44
East Fife,5257,7,13,3,20,47,66,-19,42
Forfar,5257,8,10,5,21,38,67,-29,35
Albion,5257,9,8,6,22,57,81,-24,30
Queen's Park,5257,10,6,10,20,39,74,-35,28
Raith,5258,1,23,8,5,70,33,37,77
Ayr,5258,2,24,4,8,95,43,52,76
Arbroath,5258,3,18,8,10,76,50,26,62
Alloa,5258,4,17,8,11,57,45,12,59
Stranraer,5258,5,15,5,16,57,68,-11,50
East Fife,5258,6,14,3,19,51,66,-15,45
Airdrieon,5258,7,11,11,14,46,58,-12,44
Forfar,5258,8,10,5,21,38,65,-27,35
Albion,5258,9,8,6,22,58,83,-25,30
Queen's Park,5258,10,6,10,20,41,78,-37,28
Ayr,5259,1,24,4,8,93,44,49,76
Raith,5259,2,22,8,6,68,33,35,74
Alloa,5259,3,18,8,10,57,43,14,62
Arbroath,5259,4,17,9,10,72,50,22,60
Stranraer,5259,5,15,5,16,56,66,-10,50
East Fife,5259,6,14,3,19,49,65,-16,45
Airdrieon,5259,7,11,11,14,47,58,-11,44
Forfar,5259,8,10,5,21,38,66,-28,35
Albion,5259,9,8,6,22,59,81,-22,30
Queen's Park,5259,10,6,11,19,41,74,-33,29
Raith,5260,1,23,8,5,70,32,38,77
Ayr,5260,2,23,5,8,92,44,48,74
Arbroath,5260,3,17,8,11,71,50,21,59
Alloa,5260,4,17,8,11,56,45,11,59
Stranraer,5260,5,15,5,16,57,68,-11,50
East Fife,5260,6,14,3,19,51,66,-15,45
Airdrieon,5260,7,10,11,15,45,59,-14,41
Forfar,5260,8,11,5,20,39,64,-25,38
Albion,5260,9,8,7,21,59,80,-21,31
Queen's Park,5260,10,7,10,19,41,73,-32,31
Raith,5261,1,23,8,5,72,34,38,77
Ayr,5261,2,23,5,8,94,46,48,74
Arbroath,5261,3,18,8,10,71,48,23,62
Alloa,5261,4,17,8,11,58,47,11,59
Stranraer,5261,5,15,6,15,57,66,-9,51
East Fife,5261,6,13,4,19,49,66,-17,43
Airdrieon,5261,7,10,12,14,45,58,-13,42
Forfar,5261,8,10,6,20,38,64,-26,36
Albion,5261,9,8,7,21,61,82,-21,31
Queen's Park,5261,10,6,10,20,39,73,-34,28
Raith,5262,1,23,8,5,72,32,40,77
Ayr,5262,2,24,4,8,98,44,54,76
Arbroath,5262,3,18,8,10,74,48,26,62
Alloa,5262,4,17,8,11,56,47,9,59
Stranraer,5262,5,15,5,16,55,67,-12,50
East Fife,5262,6,14,3,19,50,64,-14,45
Airdrieon,5262,7,11,11,14,46,58,-12,44
Forfar,5262,8,10,5,21,38,65,-27,35
Albion,5262,9,8,6,22,59,86,-27,30
Queen's Park,5262,10,6,10,20,39,76,-37,28
Raith,5263,1,23,8,5,70,32,38,77
Ayr,5263,2,24,4,8,94,42,52,76
Arbroath,5263,3,18,8,10,71,48,23,62
Alloa,5263,4,17,8,11,56,45,11,59
Stranraer,5263,5,15,5,16,57,67,-10,50
East Fife,5263,6,14,3,19,50,66,-16,45
Airdrieon,5263,7,11,11,14,46,58,-12,44
Forfar,5263,8,10,5,21,38,65,-27,35
Albion,5263,9,8,6,22,57,82,-25,30
Queen's Park,5263,10,6,10,20,39,73,-34,28
Ayr,5264,1,24,4,8,93,43,50,76
Raith,5264,2,22,8,6,68,33,35,74
Arbroath,5264,3,18,8,10,74,48,26,62
Alloa,5264,4,18,8,10,57,43,14,62
Stranraer,5264,5,15,6,15,55,64,-9,51
East Fife,5264,6,13,4,19,47,64,-17,43
Airdrieon,5264,7,10,12,14,46,59,-13,42
Forfar,5264,8,10,6,20,39,65,-26,36
Albion,5264,9,8,6,22,58,81,-23,30
Queen's Park,5264,10,6,10,20,39,76,-37,28
Raith,5265,1,23,8,5,71,32,39,77
Ayr,5265,2,24,4,8,94,42,52,76
Arbroath,5265,3,17,9,10,72,50,22,60
Alloa,5265,4,17,8,11,56,46,10,59
Stranraer,5265,5,15,6,15,56,65,-9,51
Airdrieon,5265,6,11,11,14,46,58,-12,44
East Fife,5265,7,13,4,19,48,65,-17,43
Forfar,5265,8,10,5,21,38,65,-27,35
Albion,5265,9,8,6,22,57,82,-25,30
Queen's Park,5265,10,6,11,19,41,74,-33,29
Raith,5266,1,23,8,5,70,32,38,77
Ayr,5266,2,24,4,8,96,44,52,76
Arbroath,5266,3,17,9,10,71,49,22,60
Alloa,5266,4,17,8,11,56,45,11,59
Stranraer,5266,5,16,5,15,58,66,-8,53
Airdrieon,5266,6,11,11,14,49,60,-11,44
East Fife,5266,7,13,3,20,49,67,-18,42
Forfar,5266,8,10,5,21,40,68,-28,35
Albion,5266,9,8,6,22,59,84,-25,30
Queen's Park,5266,10,6,11,19,40,73,-33,29
Ayr,5267,1,24,4,8,93,43,50,76
Raith,5267,2,22,9,5,69,33,36,75
Arbroath,5267,3,17,9,10,72,50,22,60
Alloa,5267,4,17,9,10,57,44,13,60
Stranraer,5267,5,15,6,15,56,65,-9,51
East Fife,5267,6,13,4,19,48,65,-17,43
Airdrieon,5267,7,10,11,15,47,62,-15,41
Forfar,5267,8,11,5,20,42,66,-24,38
Albion,5267,9,8,6,22,58,81,-23,30
Queen's Park,5267,10,6,11,19,41,74,-33,29
Raith,5268,1,23,8,5,71,34,37,77
Ayr,5268,2,24,4,8,94,43,51,76
Arbroath,5268,3,18,8,10,72,49,23,62
Alloa,5268,4,17,8,11,58,46,12,59
Stranraer,5268,5,16,5,15,57,65,-8,53
Airdrieon,5268,6,10,12,14,46,59,-13,42
East Fife,5268,7,13,3,20,48,66,-18,42
Forfar,5268,8,10,6,20,39,65,-26,36
Albion,5268,9,8,6,22,58,82,-24,30
Queen's Park,5268,10,6,10,20,40,74,-34,28
Raith,5269,1,23,8,5,70,33,37,77
Ayr,5269,2,24,4,8,92,43,49,76
Arbroath,5269,3,18,8,10,73,50,23,62
Alloa,5269,4,17,8,11,57,45,12,59
Stranraer,5269,5,15,6,15,56,65,-9,51
East Fife,5269,6,13,4,19,48,65,-17,43
Airdrieon,5269,7,10,11,15,46,60,-14,41
Forfar,5269,8,11,5,20,40,65,-25,38
Albion,5269,9,8,6,22,58,80,-22,30
Queen's Park,5269,10,6,10,20,41,75,-34,28
Ayr,5270,1,24,4,8,95,43,52,76
Raith,5270,2,22,8,6,70,35,35,74
Alloa,5270,3,18,8,10,59,45,14,62
Arbroath,5270,4,17,9,10,70,48,22,60
Stranraer,5270,5,15,6,15,57,66,-9,51
Airdrieon,5270,6,11,11,14,47,58,-11,44
East Fife,5270,7,13,4,19,49,66,-17,43
Forfar,5270,8,10,5,21,38,66,-28,35
Albion,5270,9,8,6,22,58,83,-25,30
Queen's Park,5270,10,6,11,19,39,72,-33,29
Raith,5271,1,23,8,5,72,32,40,77
Ayr,5271,2,24,4,8,92,43,49,76
Arbroath,5271,3,17,9,10,71,49,22,60
Alloa,5271,4,17,8,11,56,47,9,59
Stranraer,5271,5,16,5,15,56,64,-8,53
East Fife,5271,6,13,3,20,47,65,-18,42
Airdrieon,5271,7,10,11,15,45,59,-14,41
Forfar,5271,8,11,5,20,39,64,-25,38
Albion,5271,9,8,6,22,58,80,-22,30
Queen's Park,5271,10,6,11,19,40,73,-33,29
Ayr,5272,1,24,4,8,94,44,50,76
Raith,5272,2,22,8,6,68,33,35,74
Arbroath,5272,3,18,8,10,72,49,23,62
Alloa,5272,4,18,8,10,57,43,14,62
Stranraer,5272,5,15,5,16,55,65,-10,50
East Fife,5272,6,14,3,19,48,64,-16,45
Airdrieon,5272,7,11,11,14,47,59,-12,44
Forfar,5272,8,10,5,21,39,66,-27,35
Albion,5272,9,8,6,22,59,82,-23,30
Queen's Park,5272,10,6,10,20,40,74,-34,28
Ayr,5273,1,23,5,8,91,43,48,74
Raith,5273,2,22,8,6,69,35,34,74
Alloa,5273,3,18,8,10,59,44,15,62
Arbroath,5273,4,17,9,10,72,50,22,60
Stranraer,5273,5,15,6,15,56,65,-9,51
East Fife,5273,6,13,4,19,48,65,-17,43
Airdrieon,5273,7,10,12,14,46,59,-13,42
Forfar,5273,8,10,6,20,39,65,-26,36
Albion,5273,9,8,7,21,58,79,-21,31
Queen's Park,5273,10,6,11,19,41,74,-33,29
Raith,5274,1,23,8,5,70,32,38,77
Ayr,5274,2,24,4,8,95,45,50,76
Arbroath,5274,3,17,9,10,71,49,22,60
Alloa,5274,4,17,8,11,56,45,11,59
Stranraer,5274,5,16,5,15,57,65,-8,53
Airdrieon,5274,6,11,11,14,49,59,-10,44
East Fife,5274,7,13,3,20,48,66,-18,42
Forfar,5274,8,10,5,21,39,68,-29,35
Albion,5274,9,8,6,22,60,83,-23,30
Queen's Park,5274,10,6,11,19,40,73,-33,29
Raith,5275,1,23,8,5,73,32,41,77
Ayr,5275,2,24,4,8,97,43,54,76
Arbroath,5275,3,17,8,11,71,50,21,59
Alloa,5275,4,17,8,11,56,48,8,59
Stranraer,5275,5,15,6,15,57,66,-9,51
East Fife,5275,6,13,4,19,49,66,-17,43
Airdrieon,5275,7,10,12,14,46,59,-13,42
Forfar,5275,8,10,6,20,39,65,-26,36
Queen's Park,5275,9,7,10,19,41,73,-32,31
Albion,5275,10,8,6,22,58,85,-27,30
Raith,5276,1,23,8,5,70,33,37,77
Ayr,5276,2,24,4,8,95,43,52,76
Arbroath,5276,3,17,9,10,71,49,22,60
Alloa,5276,4,17,8,11,57,45,12,59
Stranraer,5276,5,16,5,15,57,65,-8,53
Airdrieon,5276,6,11,11,14,46,58,-12,44
East Fife,5276,7,13,3,20,48,66,-18,42
Forfar,5276,8,10,5,21,38,65,-27,35
Albion,5276,9,8,6,22,58,83,-25,30
Queen's Park,5276,10,6,11,19,40,73,-33,29
Raith,5277,1,23,8,5,70,33,37,77
Ayr,5277,2,24,4,8,95,42,53,76
Arbroath,5277,3,18,8,10,75,48,27,62
Alloa,5277,4,17,8,11,57,45,12,59
Stranraer,5277,5,16,5,15,57,64,-7,53
Airdrieon,5277,6,11,11,14,48,58,-10,44
East Fife,5277,7,13,3,20,47,66,-19,42
Forfar,5277,8,10,5,21,38,67,-29,35
Albion,5277,9,8,6,22,57,83,-26,30
Queen's Park,5277,10,6,10,20,39,77,-38,28
Raith,5278,1,23,8,5,71,34,37,77
Ayr,5278,2,23,4,9,91,44,47,73
Arbroath,5278,3,18,8,10,74,48,26,62
Alloa,5278,4,17,8,11,58,46,12,59
Stranraer,5278,5,15,6,15,57,66,-9,51
East Fife,5278,6,13,4,19,49,66,-17,43
Airdrieon,5278,7,10,11,15,46,60,-14,41
Forfar,5278,8,11,5,20,40,65,-25,38
Albion,5278,9,9,6,21,59,79,-20,33
Queen's Park,5278,10,6,10,20,39,76,-37,28
Raith,5279,1,23,8,5,70,33,37,77
Ayr,5279,2,24,4,8,92,43,49,76
Arbroath,5279,3,18,8,10,74,50,24,62
Alloa,5279,4,17,8,11,57,45,12,59
Stranraer,5279,5,16,5,15,58,66,-8,53
Airdrieon,5279,6,10,12,14,45,58,-13,42
East Fife,5279,7,13,3,20,49,67,-18,42
Forfar,5279,8,10,6,20,38,64,-26,36
Albion,5279,9,8,6,22,58,80,-22,30
Queen's Park,5279,10,6,10,20,41,76,-35,28
Ayr,5280,1,24,4,8,93,43,50,76
Raith,5280,2,22,9,5,68,32,36,75
Alloa,5280,3,17,9,10,56,43,13,60
Arbroath,5280,4,17,8,11,71,50,21,59
Stranraer,5280,5,15,6,15,56,65,-9,51
East Fife,5280,6,13,4,19,48,65,-17,43
Airdrieon,5280,7,10,12,14,47,60,-13,42
Forfar,5280,8,10,6,20,40,66,-26,36
Queen's Park,5280,9,7,10,19,41,73,-32,31
Albion,5280,10,8,6,22,58,81,-23,30
Raith,5281,1,22,8,6,68,33,35,74
Ayr,5281,2,23,4,9,92,45,47,73
Arbroath,5281,3,18,8,10,75,50,25,62
Alloa,5281,4,18,8,10,57,43,14,62
Stranraer,5281,5,15,5,16,58,69,-11,50
East Fife,5281,6,14,3,19,52,67,-15,45
Airdrieon,5281,7,10,12,14,46,59,-13,42
Forfar,5281,8,10,6,20,39,65,-26,36
Albion,5281,9,9,6,21,60,80,-20,33
Queen's Park,5281,10,6,10,20,41,77,-36,28
Raith,5282,1,23,8,5,69,32,37,77
Ayr,5282,2,24,4,8,91,42,49,76
Arbroath,5282,3,17,8,11,73,52,21,59
Alloa,5282,4,17,8,11,56,44,12,59
Stranraer,5282,5,15,5,16,55,65,-10,50
East Fife,5282,6,14,3,19,48,64,-16,45
Airdrieon,5282,7,10,12,14,47,60,-13,42
Forfar,5282,8,10,6,20,40,66,-26,36
Queen's Park,5282,9,7,10,19,43,75,-32,31
Albion,5282,10,8,6,22,57,79,-22,30
Raith,5283,1,23,8,5,72,34,38,77
Ayr,5283,2,23,4,9,91,44,47,73
Arbroath,5283,3,17,8,11,70,50,20,59
Alloa,5283,4,17,8,11,58,47,11,59
Stranraer,5283,5,15,5,16,57,67,-10,50
East Fife,5283,6,14,3,19,50,66,-16,45
Airdrieon,5283,7,10,12,14,45,58,-13,42
Forfar,5283,8,10,6,20,38,64,-26,36
Albion,5283,9,9,6,21,59,79,-20,33
Queen's Park,5283,10,7,10,19,41,72,-31,31
Ayr,5284,1,24,4,8,95,42,53,76
Raith,5284,2,22,8,6,70,35,35,74
Arbroath,5284,3,18,8,10,73,49,24,62
Alloa,5284,4,18,8,10,59,45,14,62
Stranraer,5284,5,15,6,15,56,65,-9,51
East Fife,5284,6,13,4,19,48,65,-17,43
Airdrieon,5284,7,10,12,14,47,60,-13,42
Forfar,5284,8,10,6,20,40,66,-26,36
Albion,5284,9,8,6,22,57,83,-26,30
Queen's Park,5284,10,6,10,20,40,75,-35,28
Raith,5285,1,23,8,5,69,32,37,77
Ayr,5285,2,24,4,8,95,43,52,76
Arbroath,5285,3,18,8,10,72,49,23,62
Alloa,5285,4,17,8,11,56,44,12,59
Stranraer,5285,5,15,5,16,55,68,-13,50
East Fife,5285,6,14,3,19,51,64,-13,45
Airdrieon,5285,7,11,11,14,47,58,-11,44
Forfar,5285,8,10,5,21,38,66,-28,35
Albion,5285,9,8,6,22,58,83,-25,30
Queen's Park,5285,10,6,10,20,40,74,-34,28
Raith,5286,1,23,8,5,71,32,39,77
Ayr,5286,2,24,4,8,91,42,49,76
Arbroath,5286,3,18,8,10,73,49,24,62
Alloa,5286,4,17,8,11,56,46,10,59
Stranraer,5286,5,15,6,15,56,65,-9,51
East Fife,5286,6,13,4,19,48,65,-17,43
Airdrieon,5286,7,10,11,15,46,60,-14,41
Forfar,5286,8,11,5,20,40,65,-25,38
Albion,5286,9,8,6,22,57,79,-22,30
Queen's Park,5286,10,6,10,20,40,75,-35,28
Ayr,5287,1,24,4,8,92,43,49,76
Raith,5287,2,22,9,5,68,32,36,75
Arbroath,5287,3,18,8,10,73,50,23,62
Alloa,5287,4,17,9,10,56,43,13,60
Stranraer,5287,5,15,6,15,57,66,-9,51
Airdrieon,5287,6,11,11,14,49,59,-10,44
East Fife,5287,7,13,4,19,49,66,-17,43
Forfar,5287,8,10,5,21,39,68,-29,35
Albion,5287,9,8,6,22,58,80,-22,30
Queen's Park,5287,10,6,10,20,41,75,-34,28
Raith,5288,1,23,8,5,69,32,37,77
Ayr,5288,2,24,4,8,95,42,53,76
Arbroath,5288,3,18,8,10,74,49,25,62
Alloa,5288,4,17,8,11,56,44,12,59
Stranraer,5288,5,15,5,16,55,66,-11,50
East Fife,5288,6,14,3,19,49,64,-15,45
Airdrieon,5288,7,11,11,14,46,58,-12,44
Forfar,5288,8,10,5,21,38,65,-27,35
Albion,5288,9,8,6,22,57,83,-26,30
Queen's Park,5288,10,6,10,20,40,76,-36,28
Raith,5289,1,23,8,5,70,33,37,77
Ayr,5289,2,24,4,8,93,44,49,76
Arbroath,5289,3,18,8,10,75,48,27,62
Alloa,5289,4,17,8,11,57,45,12,59
Stranraer,5289,5,15,5,16,59,69,-10,50
East Fife,5289,6,14,3,19,52,68,-16,45
Airdrieon,5289,7,10,11,15,45,59,-14,41
Forfar,5289,8,11,5,20,39,64,-25,38
Albion,5289,9,8,6,22,59,81,-22,30
Queen's Park,5289,10,6,10,20,39,77,-38,28
Ayr,5290,1,24,4,8,92,43,49,76
Raith,5290,2,22,8,6,69,34,35,74
Arbroath,5290,3,18,8,10,72,48,24,62
Alloa,5290,4,18,8,10,58,44,14,62
Stranraer,5290,5,15,6,15,56,65,-9,51
Airdrieon,5290,6,11,11,14,48,59,-11,44
East Fife,5290,7,13,4,19,48,65,-17,43
Forfar,5290,8,10,5,21,39,67,-28,35
Albion,5290,9,8,6,22,58,80,-22,30
Queen's Park,5290,10,6,10,20,39,74,-35,28
Raith,5291,1,23,8,5,70,32,38,77
Ayr,5291,2,24,4,8,92,43,49,76
Arbroath,5291,3,18,8,10,71,48,23,62
Alloa,5291,4,17,8,11,56,45,11,59
Stranraer,5291,5,16,5,15,56,64,-8,53
Airdrieon,5291,6,11,11,14,48,59,-11,44
East Fife,5291,7,13,3,20,47,65,-18,42
Forfar,5291,8,10,5,21,39,67,-28,35
Albion,5291,9,8,6,22,58,80,-22,30
Queen's Park,5291,10,6,10,20,39,73,-34,28
Raith,5292,1,23,8,5,70,32,38,77
Ayr,5292,2,24,4,8,95,43,52,76
Arbroath,5292,3,17,8,11,71,50,21,59
Alloa,5292,4,17,8,11,56,45,11,59
Stranraer,5292,5,16,5,15,57,65,-8,53
East Fife,5292,6,13,3,20,48,66,-18,42
Airdrieon,5292,7,10,11,15,45,59,-14,41
Forfar,5292,8,11,5,20,39,64,-25,38
Queen's Park,5292,9,7,10,19,41,73,-32,31
Albion,5292,10,8,6,22,58,83,-25,30
Raith,5293,1,23,8,5,71,32,39,77
Ayr,5293,2,24,4,8,94,43,51,76
Arbroath,5293,3,18,8,10,72,48,24,62
Alloa,5293,4,17,8,11,56,46,10,59
Stranraer,5293,5,16,5,15,58,66,-8,53
Airdrieon,5293,6,10,12,14,46,59,-13,42
East Fife,5293,7,13,3,20,49,67,-18,42
Forfar,5293,8,10,6,20,39,65,-26,36
Albion,5293,9,8,6,22,58,82,-24,30
Queen's Park,5293,10,6,10,20,39,74,-35,28
Raith,5294,1,23,8,5,71,32,39,77
Ayr,5294,2,23,5,8,92,44,48,74
Arbroath,5294,3,17,9,10,71,49,22,60
Alloa,5294,4,17,8,11,56,46,10,59
Stranraer,5294,5,16,5,15,58,66,-8,53
Airdrieon,5294,6,10,12,14,46,59,-13,42
East Fife,5294,7,13,3,20,49,67,-18,42
Forfar,5294,8,10,6,20,39,65,-26,36
Albion,5294,9,8,7,21,59,80,-21,31
Queen's Park,5294,10,6,11,19,40,73,-33,29
Ayr,5295,1,24,4,8,95,45,50,76
Raith,5295,2,22,9,5,69,33,36,75
Arbroath,5295,3,17,9,10,71,49,22,60
Alloa,5295,4,17,9,10,57,44,13,60
Stranraer,5295,5,16,5,15,58,66,-8,53
Airdrieon,5295,6,11,11,14,47,59,-12,44
East Fife,5295,7,13,3,20,49,67,-18,42
Forfar,5295,8,10,5,21,39,66,-27,35
Albion,5295,9,8,6,22,60,83,-23,30
Queen's Park,5295,10,6,11,19,40,73,-33,29
Raith,5296,1,22,9,5,69,33,36,75
Ayr,5296,2,23,5,8,93,45,48,74
Arbroath,5296,3,18,8,10,75,49,26,62
Alloa,5296,4,17,9,10,57,44,13,60
Stranraer,5296,5,15,6,15,55,64,-9,51
East Fife,5296,6,13,4,19,47,64,-17,43
Airdrieon,5296,7,10,11,15,46,60,-14,41
Forfar,5296,8,11,5,20,40,65,-25,38
Albion,5296,9,8,7,21,60,81,-21,31
Queen's Park,5296,10,6,10,20,40,77,-37,28
Raith,5297,1,23,8,5,72,32,40,77
Ayr,5297,2,24,4,8,98,44,54,76
Arbroath,5297,3,18,8,10,74,50,24,62
Alloa,5297,4,17,8,11,56,47,9,59
Stranraer,5297,5,15,5,16,55,67,-12,50
East Fife,5297,6,14,3,19,50,64,-14,45
Airdrieon,5297,7,10,12,14,46,59,-13,42
Forfar,5297,8,10,6,20,39,65,-26,36
Albion,5297,9,8,6,22,59,86,-27,30
Queen's Park,5297,10,6,10,20,41,76,-35,28
Raith,5298,1,23,8,5,73,33,40,77
Ayr,5298,2,24,4,8,94,43,51,76
Arbroath,5298,3,18,8,10,72,49,23,62
Alloa,5298,4,17,8,11,57,48,9,59
Stranraer,5298,5,16,5,15,58,64,-6,53
East Fife,5298,6,13,3,20,47,67,-20,42
Airdrieon,5298,7,10,11,15,46,61,-15,41
Forfar,5298,8,11,5,20,41,65,-24,38
Albion,5298,9,8,6,22,58,82,-24,30
Queen's Park,5298,10,6,10,20,40,74,-34,28
Raith,5299,1,23,8,5,70,32,38,77
Ayr,5299,2,24,4,8,92,42,50,76
Arbroath,5299,3,18,8,10,73,49,24,62
Alloa,5299,4,17,8,11,56,45,11,59
Stranraer,5299,5,15,5,16,55,69,-14,50
East Fife,5299,6,14,3,19,52,64,-12,45
Airdrieon,5299,7,11,11,14,49,58,-9,44
Forfar,5299,8,10,5,21,38,68,-30,35
Albion,5299,9,8,6,22,57,80,-23,30
Queen's Park,5299,10,6,10,20,40,75,-35,28
Ayr,5300,1,24,4,8,95,43,52,76
Raith,5300,2,22,9,5,68,32,36,75
Arbroath,5300,3,18,8,10,72,49,23,62
Alloa,5300,4,17,9,10,56,43,13,60
Stranraer,5300,5,15,5,16,56,68,-12,50
East Fife,5300,6,14,3,19,51,65,-14,45
Airdrieon,5300,7,10,12,14,46,59,-13,42
Forfar,5300,8,10,6,20,39,65,-26,36
Albion,5300,9,8,6,22,58,83,-25,30
Queen's Park,5300,10,6,10,20,40,74,-34,28
Ayr,5301,1,24,4,8,96,42,54,76
Raith,5301,2,22,8,6,68,34,34,74
Alloa,5301,3,18,8,10,58,43,15,62
Arbroath,5301,4,17,8,11,71,51,20,59
Stranraer,5301,5,16,5,15,60,66,-6,53
Airdrieon,5301,6,11,11,14,50,59,-9,44
East Fife,5301,7,13,3,20,49,69,-20,42
Forfar,5301,8,10,5,21,39,69,-30,35
Queen's Park,5301,9,7,10,19,42,73,-31,31
Albion,5301,10,8,6,22,57,84,-27,30
Ayr,5302,1,24,4,8,96,45,51,76
Raith,5302,2,22,9,5,69,33,36,75
Arbroath,5302,3,18,8,10,72,49,23,62
Alloa,5302,4,17,9,10,57,44,13,60
Stranraer,5302,5,15,5,16,57,67,-10,50
East Fife,5302,6,14,3,19,50,66,-16,45
Airdrieon,5302,7,10,11,15,47,62,-15,41
Forfar,5302,8,11,5,20,42,66,-24,38
Albion,5302,9,8,6,22,60,84,-24,30
Queen's Park,5302,10,6,10,20,40,74,-34,28
Ayr,5303,1,24,4,8,97,43,54,76
Raith,5303,2,22,8,6,68,34,34,74
Alloa,5303,3,18,8,10,58,43,15,62
Arbroath,5303,4,17,8,11,72,51,21,59
Stranraer,5303,5,15,6,15,57,66,-9,51
East Fife,5303,6,13,4,19,49,66,-17,43
Airdrieon,5303,7,10,12,14,46,59,-13,42
Forfar,5303,8,10,6,20,39,65,-26,36
Queen's Park,5303,9,7,10,19,42,74,-32,31
Albion,5303,10,8,6,22,58,85,-27,30
Raith,5304,1,23,8,5,71,32,39,77
Ayr,5304,2,24,4,8,92,42,50,76
Arbroath,5304,3,18,8,10,73,50,23,62
Alloa,5304,4,17,8,11,56,46,10,59
Stranraer,5304,5,15,5,16,56,66,-10,50
East Fife,5304,6,14,3,19,49,65,-16,45
Airdrieon,5304,7,11,11,14,46,58,-12,44
Forfar,5304,8,10,5,21,38,65,-27,35
Albion,5304,9,8,6,22,57,80,-23,30
Queen's Park,5304,10,6,10,20,41,75,-34,28
Ayr,5305,1,24,4,8,94,45,49,76
Raith,5305,2,22,8,6,69,34,35,74
Alloa,5305,3,18,8,10,58,44,14,62
Arbroath,5305,4,17,9,10,71,49,22,60
Stranraer,5305,5,16,5,15,58,66,-8,53
Airdrieon,5305,6,10,12,14,46,59,-13,42
East Fife,5305,7,13,3,20,49,67,-18,42
Forfar,5305,8,10,6,20,39,65,-26,36
Albion,5305,9,8,6,22,60,82,-22,30
Queen's Park,5305,10,6,11,19,40,73,-33,29
Ayr,5306,1,24,4,8,92,42,50,76
Raith,5306,2,22,9,5,70,34,36,75
Alloa,5306,3,17,9,10,58,45,13,60
Arbroath,5306,4,17,8,11,71,50,21,59
Stranraer,5306,5,15,5,16,55,66,-11,50
East Fife,5306,6,14,3,19,49,64,-15,45
Airdrieon,5306,7,10,12,14,46,59,-13,42
Forfar,5306,8,10,6,20,39,65,-26,36
Queen's Park,5306,9,7,10,19,41,73,-32,31
Albion,5306,10,8,6,22,57,80,-23,30
Raith,5307,1,22,9,5,70,34,36,75
Ayr,5307,2,23,5,8,93,45,48,74
Arbroath,5307,3,18,8,10,75,48,27,62
Alloa,5307,4,17,9,10,58,45,13,60
Stranraer,5307,5,15,5,16,56,70,-14,50
East Fife,5307,6,14,3,19,53,65,-12,45
Airdrieon,5307,7,11,11,14,47,59,-12,44
Forfar,5307,8,10,5,21,39,66,-27,35
Albion,5307,9,8,7,21,60,81,-21,31
Queen's Park,5307,10,6,10,20,39,77,-38,28
Raith,5308,1,23,8,5,70,32,38,77
Ayr,5308,2,23,5,8,92,44,48,74
Arbroath,5308,3,17,8,11,71,50,21,59
Alloa,5308,4,17,8,11,56,45,11,59
Stranraer,5308,5,16,5,15,58,64,-6,53
Airdrieon,5308,6,11,11,14,48,59,-11,44
East Fife,5308,7,13,3,20,47,67,-20,42
Forfar,5308,8,10,5,21,39,67,-28,35
Albion,5308,9,8,7,21,59,80,-21,31
Queen's Park,5308,10,7,10,19,41,73,-32,31
Raith,5309,1,23,8,5,70,33,37,77
Ayr,5309,2,24,4,8,91,42,49,76
Arbroath,5309,3,17,8,11,71,51,20,59
Alloa,5309,4,17,8,11,57,45,12,59
Stranraer,5309,5,16,5,15,57,64,-7,53
East Fife,5309,6,13,3,20,47,66,-19,42
Airdrieon,5309,7,10,11,15,45,59,-14,41
Forfar,5309,8,11,5,20,39,64,-25,38
Queen's Park,5309,9,7,10,19,42,73,-31,31
Albion,5309,10,8,6,22,57,79,-22,30
Ayr,5310,1,24,4,8,93,42,51,76
Raith,5310,2,22,8,6,68,33,35,74
Alloa,5310,3,18,8,10,57,43,14,62
Arbroath,5310,4,17,8,11,71,51,20,59
Stranraer,5310,5,16,5,15,58,65,-7,53
Airdrieon,5310,6,11,11,14,47,59,-12,44
East Fife,5310,7,13,3,20,48,67,-19,42
Forfar,5310,8,10,5,21,39,66,-27,35
Queen's Park,5310,9,7,10,19,42,73,-31,31
Albion,5310,10,8,6,22,57,81,-24,30
Ayr,5311,1,24,4,8,92,43,49,76
Raith,5311,2,22,9,5,69,33,36,75
Arbroath,5311,3,17,9,10,72,50,22,60
Alloa,5311,4,17,9,10,57,44,13,60
Stranraer,5311,5,15,5,16,57,68,-11,50
East Fife,5311,6,14,3,19,51,66,-15,45
Airdrieon,5311,7,11,11,14,47,59,-12,44
Forfar,5311,8,10,5,21,39,66,-27,35
Albion,5311,9,8,6,22,58,80,-22,30
Queen's Park,5311,10,6,11,19,41,74,-33,29
Raith,5312,1,22,9,5,68,32,36,75
Ayr,5312,2,23,4,9,90,43,47,73
Arbroath,5312,3,17,9,10,71,49,22,60
Alloa,5312,4,17,9,10,56,43,13,60
Stranraer,5312,5,16,5,15,57,65,-8,53
Airdrieon,5312,6,10,12,14,46,59,-13,42
East Fife,5312,7,13,3,20,48,66,-18,42
Forfar,5312,8,10,6,20,39,65,-26,36
Albion,5312,9,9,6,21,58,78,-20,33
Queen's Park,5312,10,6,11,19,40,73,-33,29
Raith,5313,1,23,8,5,71,33,38,77
Ayr,5313,2,24,4,8,92,43,49,76
Arbroath,5313,3,17,9,10,73,51,22,60
Alloa,5313,4,17,8,11,57,46,11,59
Stranraer,5313,5,15,6,15,57,66,-9,51
Airdrieon,5313,6,11,11,14,47,59,-12,44
East Fife,5313,7,13,4,19,49,66,-17,43
Forfar,5313,8,10,5,21,39,66,-27,35
Albion,5313,9,8,6,22,58,80,-22,30
Queen's Park,5313,10,6,11,19,42,75,-33,29
Raith,5314,1,23,8,5,70,32,38,77
Ayr,5314,2,24,4,8,95,42,53,76
Arbroath,5314,3,18,8,10,74,51,23,62
Alloa,5314,4,17,8,11,56,45,11,59
Stranraer,5314,5,15,5,16,56,66,-10,50
East Fife,5314,6,14,3,19,49,65,-16,45
Airdrieon,5314,7,11,11,14,47,59,-12,44
Forfar,5314,8,10,5,21,39,66,-27,35
Albion,5314,9,8,6,22,57,83,-26,30
Queen's Park,5314,10,6,10,20,42,76,-34,28
Raith,5315,1,23,8,5,71,32,39,77
Ayr,5315,2,24,4,8,95,43,52,76
Arbroath,5315,3,18,8,10,71,48,23,62
Alloa,5315,4,17,8,11,56,46,10,59
Stranraer,5315,5,15,5,16,56,66,-10,50
East Fife,5315,6,14,3,19,49,65,-16,45
Airdrieon,5315,7,11,11,14,47,59,-12,44
Forfar,5315,8,10,5,21,39,66,-27,35
Albion,5315,9,8,6,22,58,83,-25,30
Queen's Park,5315,10,6,10,20,39,73,-34,28
Raith,5316,1,23,8,5,70,33,37,77
Ayr,5316,2,24,4,8,95,43,52,76
Arbroath,5316,3,17,9,10,71,49,22,60
Alloa,5316,4,17,8,11,57,45,12,59
Stranraer,5316,5,16,5,15,57,64,-7,53
Airdrieon,5316,6,11,11,14,46,58,-12,44
East Fife,5316,7,13,3,20,47,66,-19,42
Forfar,5316,8,10,5,21,38,65,-27,35
Albion,5316,9,8,6,22,58,83,-25,30
Queen's Park,5316,10,6,11,19,40,73,-33,29
Ayr,5317,1,24,4,8,94,44,50,76
Raith,5317,2,22,8,6,68,33,35,74
Arbroath,5317,3,18,8,10,71,48,23,62
Alloa,5317,4,18,8,10,57,43,14,62
Stranraer,5317,5,16,5,15,58,66,-8,53
East Fife,5317,6,13,3,20,49,67,-18,42
Airdrieon,5317,7,10,11,15,46,60,-14,41
Forfar,5317,8,11,5,20,40,65,-25,38
Albion,5317,9,8,6,22,59,82,-23,30
Queen's Park,5317,10,6,10,20,39,73,-34,28
Ayr,5318,1,24,4,8,92,42,50,76
Raith,5318,2,22,8,6,69,35,34,74
Alloa,5318,3,18,8,10,59,44,15,62
Arbroath,5318,4,17,8,11,70,49,21,59
Stranraer,5318,5,16,5,15,57,65,-8,53
East Fife,5318,6,13,3,20,48,66,-18,42
Airdrieon,5318,7,10,11,15,45,59,-14,41
Forfar,5318,8,11,5,20,39,64,-25,38
Queen's Park,5318,9,7,10,19,40,72,-32,31
Albion,5318,10,8,6,22,57,80,-23,30
Raith,5319,1,23,8,5,70,32,38,77
Ayr,5319,2,24,4,8,92,43,49,76
Arbroath,5319,3,17,8,11,70,50,20,59
Alloa,5319,4,17,8,11,56,45,11,59
Stranraer,5319,5,15,6,15,56,65,-9,51
East Fife,5319,6,13,4,19,48,65,-17,43
Airdrieon,5319,7,10,12,14,46,59,-13,42
Forfar,5319,8,10,6,20,39,65,-26,36
Queen's Park,5319,9,7,10,19,41,72,-31,31
Albion,5319,10,8,6,22,58,80,-22,30
Raith,5320,1,23,8,5,69,32,37,77
Ayr,5320,2,24,4,8,95,43,52,76
Arbroath,5320,3,18,8,10,71,48,23,62
Alloa,5320,4,17,8,11,56,44,12,59
Stranraer,5320,5,15,5,16,55,65,-10,50
East Fife,5320,6,14,3,19,48,64,-16,45
Airdrieon,5320,7,11,11,14,47,58,-11,44
Forfar,5320,8,10,5,21,38,66,-28,35
Albion,5320,9,8,6,22,58,83,-25,30
Queen's Park,5320,10,6,10,20,39,73,-34,28
Ayr,5321,1,24,4,8,93,42,51,76
Raith,5321,2,22,8,6,68,34,34,74
Arbroath,5321,3,18,8,10,73,49,24,62
Alloa,5321,4,18,8,10,58,43,15,62
Stranraer,5321,5,16,5,15,56,64,-8,53
East Fife,5321,6,13,3,20,47,65,-18,42
Airdrieon,5321,7,10,11,15,46,60,-14,41
Forfar,5321,8,11,5,20,40,65,-25,38
Albion,5321,9,8,6,22,57,81,-24,30
Queen's Park,5321,10,6,10,20,40,75,-35,28
Raith,5322,1,22,9,5,70,34,36,75
Ayr,5322,2,23,4,9,92,45,47,73
Arbroath,5322,3,17,9,10,71,49,22,60
Alloa,5322,4,17,9,10,58,45,13,60
Stranraer,5322,5,16,5,15,57,65,-8,53
Airdrieon,5322,6,11,11,14,46,58,-12,44
East Fife,5322,7,13,3,20,48,66,-18,42
Forfar,5322,8,10,5,21,38,65,-27,35
Albion,5322,9,9,6,21,60,80,-20,33
Queen's Park,5322,10,6,11,19,40,73,-33,29
Ayr,5323,1,24,4,8,96,44,52,76
Raith,5323,2,22,9,5,70,34,36,75
Arbroath,5323,3,17,9,10,71,49,22,60
Alloa,5323,4,17,9,10,58,45,13,60
Stranraer,5323,5,16,5,15,59,65,-6,53
Airdrieon,5323,6,11,11,14,46,58,-12,44
East Fife,5323,7,13,3,20,48,68,-20,42
Forfar,5323,8,10,5,21,38,65,-27,35
Albion,5323,9,8,6,22,59,84,-25,30
Queen's Park,5323,10,6,11,19,40,73,-33,29
Raith,5324,1,23,8,5,70,32,38,77
Ayr,5324,2,23,5,8,92,44,48,74
Arbroath,5324,3,18,8,10,72,48,24,62
Alloa,5324,4,17,8,11,56,45,11,59
Stranraer,5324,5,15,6,15,57,66,-9,51
East Fife,5324,6,13,4,19,49,66,-17,43
Airdrieon,5324,7,10,11,15,47,61,-14,41
Forfar,5324,8,11,5,20,41,66,-25,38
Albion,5324,9,8,7,21,59,80,-21,31
Queen's Park,5324,10,6,10,20,39,74,-35,28
Ayr,5325,1,24,4,8,94,43,51,76
Raith,5325,2,22,8,6,68,34,34,74
Alloa,5325,3,18,8,10,58,43,15,62
Arbroath,5325,4,17,9,10,71,49,22,60
Stranraer,5325,5,15,5,16,55,65,-10,50
East Fife,5325,6,14,3,19,48,64,-16,45
Airdrieon,5325,7,11,11,14,46,58,-12,44
Forfar,5325,8,10,5,21,38,65,-27,35
Albion,5325,9,8,6,22,58,82,-24,30
Queen's Park,5325,10,6,11,19,40,73,-33,29
Raith,5326,1,23,8,5,71,32,39,77
Ayr,5326,2,23,4,9,91,44,47,73
Arbroath,5326,3,18,8,10,72,49,23,62
Alloa,5326,4,17,8,11,56,46,10,59
Stranraer,5326,5,15,6,15,56,65,-9,51
East Fife,5326,6,13,4,19,48,65,-17,43
Airdrieon,5326,7,10,12,14,45,58,-13,42
Forfar,5326,8,10,6,20,38,64,-26,36
Albion,5326,9,9,6,21,59,79,-20,33
Queen's Park,5326,10,6,10,20,40,74,-34,28
Raith,5327,1,23,8,5,70,33,37,77
Ayr,5327,2,24,4,8,93,44,49,76
Arbroath,5327,3,18,8,10,74,48,26,62
Alloa,5327,4,17,8,11,57,45,12,59
Stranraer,5327,5,16,5,15,57,65,-8,53
East Fife,5327,6,13,3,20,48,66,-18,42
Airdrieon,5327,7,10,11,15,45,59,-14,41
Forfar,5327,8,11,5,20,39,64,-25,38
Albion,5327,9,8,6,22,59,81,-22,30
Queen's Park,5327,10,6,10,20,39,76,-37,28
Ayr,5328,1,24,4,8,93,44,49,76
Raith,5328,2,22,9,5,68,32,36,75
Arbroath,5328,3,17,9,10,72,50,22,60
Alloa,5328,4,17,9,10,56,43,13,60
Stranraer,5328,5,15,5,16,56,66,-10,50
East Fife,5328,6,14,3,19,49,65,-16,45
Airdrieon,5328,7,11,11,14,47,58,-11,44
Forfar,5328,8,10,5,21,38,66,-28,35
Albion,5328,9,8,6,22,59,81,-22,30
Queen's Park,5328,10,6,11,19,41,74,-33,29
Ayr,5329,1,24,4,8,91,42,49,76
Raith,5329,2,22,9,5,69,33,36,75
Arbroath,5329,3,18,8,10,72,49,23,62
Alloa,5329,4,17,9,10,57,44,13,60
Stranraer,5329,5,15,5,16,55,68,-13,50
East Fife,5329,6,14,3,19,51,64,-13,45
Airdrieon,5329,7,11,11,14,47,58,-11,44
Forfar,5329,8,10,5,21,38,66,-28,35
Albion,5329,9,8,6,22,57,79,-22,30
Queen's Park,5329,10,6,10,20,40,74,-34,28
Ayr,5330,1,24,4,8,94,43,51,76
Raith,5330,2,22,9,5,69,33,36,75
Arbroath,5330,3,17,9,10,71,49,22,60
Alloa,5330,4,17,9,10,57,44,13,60
Stranraer,5330,5,15,5,16,55,67,-12,50
East Fife,5330,6,14,3,19,50,64,-14,45
Airdrieon,5330,7,10,11,15,46,61,-15,41
Forfar,5330,8,11,5,20,41,65,-24,38
Albion,5330,9,8,6,22,58,82,-24,30
Queen's Park,5330,10,6,11,19,40,73,-33,29
Raith,5331,1,23,8,5,72,34,38,77
Ayr,5331,2,24,4,8,93,42,51,76
Arbroath,5331,3,18,8,10,72,48,24,62
Alloa,5331,4,17,8,11,58,47,11,59
Stranraer,5331,5,16,5,15,58,64,-6,53
Airdrieon,5331,6,11,11,14,46,58,-12,44
East Fife,5331,7,13,3,20,47,67,-20,42
Forfar,5331,8,10,5,21,38,65,-27,35
Albion,5331,9,8,6,22,57,81,-24,30
Queen's Park,5331,10,6,10,20,39,74,-35,28
Ayr,5332,1,24,4,8,92,43,49,76
Raith,5332,2,22,9,5,68,32,36,75
Arbroath,5332,3,17,9,10,70,48,22,60
Alloa,5332,4,17,9,10,56,43,13,60
Stranraer,5332,5,16,5,15,58,65,-7,53
East Fife,5332,6,13,3,20,48,67,-19,42
Airdrieon,5332,7,10,11,15,45,60,-15,41
Forfar,5332,8,11,5,20,40,64,-24,38
Albion,5332,9,8,6,22,58,80,-22,30
Queen's Park,5332,10,6,11,19,39,72,-33,29
Raith,5333,1,23,8,5,70,32,38,77
Ayr,5333,2,23,4,9,91,45,46,73
Arbroath,5333,3,18,8,10,72,48,24,62
Alloa,5333,4,17,8,11,56,45,11,59
Stranraer,5333,5,15,6,15,56,65,-9,51
Airdrieon,5333,6,11,11,14,49,58,-9,44
East Fife,5333,7,13,4,19,48,65,-17,43
Forfar,5333,8,10,5,21,38,68,-30,35
Albion,5333,9,9,6,21,60,79,-19,33
Queen's Park,5333,10,6,10,20,39,74,-35,28
Raith,5334,1,22,9,5,70,34,36,75
Ayr,5334,2,23,4,9,90,45,45,73
Arbroath,5334,3,18,8,10,72,48,24,62
Alloa,5334,4,17,9,10,58,45,13,60
Stranraer,5334,5,16,5,15,58,65,-7,53
Airdrieon,5334,6,11,11,14,46,58,-12,44
East Fife,5334,7,13,3,20,48,67,-19,42
Forfar,5334,8,10,5,21,38,65,-27,35
Albion,5334,9,9,6,21,60,78,-18,33
Queen's Park,5334,10,6,10,20,39,74,-35,28
Raith,5335,1,23,8,5,70,32,38,77
Ayr,5335,2,24,4,8,94,43,51,76
Arbroath,5335,3,17,8,11,71,51,20,59
Alloa,5335,4,17,8,11,56,45,11,59
Stranraer,5335,5,15,6,15,56,65,-9,51
Airdrieon,5335,6,11,11,14,48,60,-12,44
East Fife,5335,7,13,4,19,48,65,-17,43
Forfar,5335,8,10,5,21,40,67,-27,35
Queen's Park,5335,9,7,10,19,42,73,-31,31
Albion,5335,10,8,6,22,58,82,-24,30
Ayr,5336,1,24,4,8,93,44,49,76
Raith,5336,2,22,9,5,68,32,36,75
Arbroath,5336,3,18,8,10,72,49,23,62
Alloa,5336,4,17,9,10,56,43,13,60
Stranraer,5336,5,16,5,15,58,64,-6,53
Airdrieon,5336,6,10,12,14,46,59,-13,42
East Fife,5336,7,13,3,20,47,67,-20,42
Forfar,5336,8,10,6,20,39,65,-26,36
Albion,5336,9,8,6,22,59,81,-22,30
Queen's Park,5336,10,6,10,20,40,74,-34,28
Ayr,5337,1,24,4,8,91,42,49,76
Raith,5337,2,22,8,6,69,34,35,74
Alloa,5337,3,18,8,10,58,44,14,62
Arbroath,5337,4,17,8,11,71,52,19,59
Stranraer,5337,5,15,6,15,55,64,-9,51
Airdrieon,5337,6,11,11,14,46,58,-12,44
East Fife,5337,7,13,4,19,47,64,-17,43
Forfar,5337,8,10,5,21,38,65,-27,35
Queen's Park,5337,9,7,10,19,43,73,-30,31
Albion,5337,10,8,6,22,57,79,-22,30
Raith,5338,1,22,8,6,68,34,34,74
Ayr,5338,2,23,4,9,92,45,47,73
Alloa,5338,3,18,8,10,58,43,15,62
Arbroath,5338,4,17,8,11,71,54,17,59
Stranraer,5338,5,15,5,16,57,67,-10,50
East Fife,5338,6,14,3,19,50,66,-16,45
Airdrieon,5338,7,11,11,14,48,60,-12,44
Forfar,5338,8,10,5,21,40,67,-27,35
Albion,5338,9,9,6,21,60,80,-20,33
Queen's Park,5338,10,7,10,19,45,73,-28,31
Raith,5339,1,23,8,5,69,32,37,77
Ayr,5339,2,24,4,8,93,43,50,76
Arbroath,5339,3,17,9,10,71,49,22,60
Alloa,5339,4,17,8,11,56,44,12,59
Stranraer,5339,5,15,5,16,55,67,-12,50
East Fife,5339,6,14,3,19,50,64,-14,45
Airdrieon,5339,7,11,11,14,50,59,-9,44
Forfar,5339,8,10,5,21,39,69,-30,35
Albion,5339,9,8,6,22,58,81,-23,30
Queen's Park,5339,10,6,11,19,40,73,-33,29
Raith,5340,1,23,8,5,71,32,39,77
Ayr,5340,2,24,4,8,94,42,52,76
Arbroath,5340,3,17,8,11,72,52,20,59
Alloa,5340,4,17,8,11,56,46,10,59
Stranraer,5340,5,15,5,16,56,67,-11,50
East Fife,5340,6,14,3,19,50,65,-15,45
Airdrieon,5340,7,11,11,14,48,59,-11,44
Forfar,5340,8,10,5,21,39,67,-28,35
Queen's Park,5340,9,7,10,19,43,74,-31,31
Albion,5340,10,8,6,22,57,82,-25,30
Raith,5341,1,23,8,5,70,32,38,77
Ayr,5341,2,24,4,8,93,43,50,76
Arbroath,5341,3,17,8,11,72,52,20,59
Alloa,5341,4,17,8,11,56,45,11,59
Stranraer,5341,5,15,5,16,55,66,-11,50
East Fife,5341,6,14,3,19,49,64,-15,45
Airdrieon,5341,7,11,11,14,49,59,-10,44
Forfar,5341,8,10,5,21,39,68,-29,35
Queen's Park,5341,9,7,10,19,43,74,-31,31
Albion,5341,10,8,6,22,58,81,-23,30
Raith,5342,1,23,8,5,69,32,37,77
Ayr,5342,2,24,4,8,96,43,53,76
Arbroath,5342,3,18,8,10,72,48,24,62
Alloa,5342,4,17,8,11,56,44,12,59
Stranraer,5342,5,16,5,15,58,66,-8,53
East Fife,5342,6,13,3,20,49,67,-18,42
Airdrieon,5342,7,10,11,15,45,59,-14,41
Forfar,5342,8,11,5,20,39,64,-25,38
Albion,5342,9,8,6,22,58,84,-26,30
Queen's Park,5342,10,6,10,20,39,74,-35,28
Raith,5343,1,22,9,5,69,33,36,75
Ayr,5343,2,23,5,8,93,45,48,74
Arbroath,5343,3,18,8,10,71,48,23,62
Alloa,5343,4,17,9,10,57,44,13,60
Stranraer,5343,5,16,5,15,56,64,-8,53
Airdrieon,5343,6,11,11,14,47,59,-12,44
East Fife,5343,7,13,3,20,47,65,-18,42
Forfar,5343,8,10,5,21,39,66,-27,35
Albion,5343,9,8,7,21,60,81,-21,31
Queen's Park,5343,10,6,10,20,39,73,-34,28
Raith,5344,1,23,8,5,72,32,40,77
Ayr,5344,2,24,4,8,91,42,49,76
Arbroath,5344,3,18,8,10,73,48,25,62
Alloa,5344,4,17,8,11,56,47,9,59
Stranraer,5344,5,15,5,16,56,66,-10,50
East Fife,5344,6,14,3,19,49,65,-16,45
Airdrieon,5344,7,10,11,15,46,60,-14,41
Forfar,5344,8,11,5,20,40,65,-25,38
Albion,5344,9,8,6,22,57,79,-22,30
Queen's Park,5344,10,6,10,20,39,75,-36,28
Raith,5345,1,23,8,5,71,32,39,77
Ayr,5345,2,24,4,8,94,43,51,76
Arbroath,5345,3,17,9,10,71,49,22,60
Alloa,5345,4,17,8,11,56,46,10,59
Stranraer,5345,5,15,5,16,56,67,-11,50
East Fife,5345,6,14,3,19,50,65,-15,45
Airdrieon,5345,7,10,11,15,45,59,-14,41
Forfar,5345,8,11,5,20,39,64,-25,38
Albion,5345,9,8,6,22,58,82,-24,30
Queen's Park,5345,10,6,11,19,40,73,-33,29
Raith,5346,1,23,8,5,70,33,37,77
Ayr,5346,2,24,4,8,92,43,49,76
Arbroath,5346,3,18,8,10,71,48,23,62
Alloa,5346,4,17,8,11,57,45,12,59
Stranraer,5346,5,15,6,15,56,65,-9,51
Airdrieon,5346,6,11,11,14,47,59,-12,44
East Fife,5346,7,13,4,19,48,65,-17,43
Forfar,5346,8,10,5,21,39,66,-27,35
Albion,5346,9,8,6,22,58,80,-22,30
Queen's Park,5346,10,6,10,20,39,73,-34,28
Raith,5347,1,23,8,5,71,33,38,77
Ayr,5347,2,24,4,8,91,42,49,76
Arbroath,5347,3,18,8,10,74,51,23,62
Alloa,5347,4,17,8,11,57,46,11,59
Stranraer,5347,5,15,6,15,56,65,-9,51
East Fife,5347,6,13,4,19,48,65,-17,43
Airdrieon,5347,7,10,12,14,45,58,-13,42
Forfar,5347,8,10,6,20,38,64,-26,36
Albion,5347,9,8,6,22,57,79,-22,30
Queen's Park,5347,10,6,10,20,42,76,-34,28
Raith,5348,1,23,8,5,72,33,39,77
Ayr,5348,2,24,4,8,95,43,52,76
Arbroath,5348,3,17,9,10,71,49,22,60
Alloa,5348,4,17,8,11,57,47,10,59
Stranraer,5348,5,15,6,15,56,65,-9,51
East Fife,5348,6,13,4,19,48,65,-17,43
Airdrieon,5348,7,10,12,14,45,58,-13,42
Forfar,5348,8,10,6,20,38,64,-26,36
Albion,5348,9,8,6,22,58,83,-25,30
Queen's Park,5348,10,6,11,19,40,73,-33,29
Raith,5349,1,22,9,5,70,34,36,75
Ayr,5349,2,23,5,8,91,43,48,74
Arbroath,5349,3,17,9,10,70,48,22,60
Alloa,5349,4,17,9,10,58,45,13,60
Stranraer,5349,5,15,5,16,56,67,-11,50
East Fife,5349,6,14,3,19,50,65,-15,45
Airdrieon,5349,7,10,11,15,46,61,-15,41
Forfar,5349,8,11,5,20,41,65,-24,38
Albion,5349,9,8,7,21,58,79,-21,31
Queen's Park,5349,10,6,11,19,39,72,-33,29
Raith,5350,1,23,8,5,69,32,37,77
Ayr,5350,2,24,4,8,95,43,52,76
Arbroath,5350,3,17,9,10,71,49,22,60
Alloa,5350,4,17,8,11,56,44,12,59
Stranraer,5350,5,15,5,16,55,65,-10,50
East Fife,5350,6,14,3,19,48,64,-16,45
Airdrieon,5350,7,11,11,14,51,60,-9,44
Forfar,5350,8,10,5,21,40,70,-30,35
Albion,5350,9,8,6,22,58,83,-25,30
Queen's Park,5350,10,6,11,19,40,73,-33,29
Raith,5351,1,23,8,5,69,32,37,77
Ayr,5351,2,24,4,8,93,42,51,76
Arbroath,5351,3,17,8,11,70,49,21,59
Alloa,5351,4,17,8,11,56,44,12,59
Stranraer,5351,5,16,5,15,58,65,-7,53
Airdrieon,5351,6,11,11,14,47,59,-12,44
East Fife,5351,7,13,3,20,48,67,-19,42
Forfar,5351,8,10,5,21,39,66,-27,35
Queen's Park,5351,9,7,10,19,40,72,-32,31
Albion,5351,10,8,6,22,57,81,-24,30
Raith,5352,1,23,8,5,70,33,37,77
Ayr,5352,2,24,4,8,93,43,50,76
Arbroath,5352,3,17,9,10,70,48,22,60
Alloa,5352,4,17,8,11,57,45,12,59
Stranraer,5352,5,15,5,16,57,68,-11,50
East Fife,5352,6,14,3,19,51,66,-15,45
Airdrieon,5352,7,10,11,15,45,59,-14,41
Forfar,5352,8,11,5,20,39,64,-25,38
Albion,5352,9,8,6,22,58,81,-23,30
Queen's Park,5352,10,6,11,19,39,72,-33,29
Raith,5353,1,23,8,5,70,32,38,77
Ayr,5353,2,24,4,8,92,42,50,76
Arbroath,5353,3,18,8,10,72,49,23,62
Alloa,5353,4,17,8,11,56,45,11,59
Stranraer,5353,5,15,5,16,55,65,-10,50
East Fife,5353,6,14,3,19,48,64,-16,45
Airdrieon,5353,7,10,12,14,45,58,-13,42
Forfar,5353,8,10,6,20,38,64,-26,36
Albion,5353,9,8,6,22,57,80,-23,30
Queen's Park,5353,10,6,10,20,40,74,-34,28
Raith,5354,1,23,8,5,70,33,37,77
Ayr,5354,2,24,4,8,92,43,49,76
Arbroath,5354,3,17,9,10,72,50,22,60
Alloa,5354,4,17,8,11,57,45,12,59
Stranraer,5354,5,15,5,16,55,66,-11,50
East Fife,5354,6,14,3,19,49,64,-15,45
Airdrieon,5354,7,10,12,14,46,59,-13,42
Forfar,5354,8,10,6,20,39,65,-26,36
Albion,5354,9,8,6,22,58,80,-22,30
Queen's Park,5354,10,6,11,19,41,74,-33,29
Raith,5355,1,23,8,5,71,34,37,77
Ayr,5355,2,23,4,9,91,44,47,73
Arbroath,5355,3,18,8,10,73,50,23,62
Alloa,5355,4,17,8,11,58,46,12,59
Stranraer,5355,5,16,5,15,57,65,-8,53
Airdrieon,5355,6,10,12,14,46,59,-13,42
East Fife,5355,7,13,3,20,48,66,-18,42
Forfar,5355,8,10,6,20,39,65,-26,36
Albion,5355,9,9,6,21,59,79,-20,33
Queen's Park,5355,10,6,10,20,41,75,-34,28
Ayr,5356,1,24,4,8,92,43,49,76
Raith,5356,2,22,9,5,68,32,36,75
Arbroath,5356,3,18,8,10,74,48,26,62
Alloa,5356,4,17,9,10,56,43,13,60
Stranraer,5356,5,15,6,15,56,65,-9,51
East Fife,5356,6,13,4,19,48,65,-17,43
Airdrieon,5356,7,10,11,15,47,61,-14,41
Forfar,5356,8,11,5,20,41,66,-25,38
Albion,5356,9,8,6,22,58,80,-22,30
Queen's Park,5356,10,6,10,20,39,76,-37,28
Ayr,5357,1,24,4,8,95,44,51,76
Raith,5357,2,22,9,5,69,33,36,75
Alloa,5357,3,17,9,10,57,44,13,60
Arbroath,5357,4,17,8,11,70,49,21,59
Stranraer,5357,5,16,5,15,58,65,-7,53
East Fife,5357,6,13,3,20,48,67,-19,42
Airdrieon,5357,7,10,11,15,46,61,-15,41
Forfar,5357,8,11,5,20,41,65,-24,38
Queen's Park,5357,9,7,10,19,40,72,-32,31
Albion,5357,10,8,6,22,59,83,-24,30
Raith,5358,1,23,8,5,70,33,37,77
Ayr,5358,2,24,4,8,92,43,49,76
Arbroath,5358,3,17,9,10,72,50,22,60
Alloa,5358,4,17,8,11,57,45,12,59
Stranraer,5358,5,16,5,15,57,65,-8,53
Airdrieon,5358,6,10,12,14,47,60,-13,42
East Fife,5358,7,13,3,20,48,66,-18,42
Forfar,5358,8,10,6,20,40,66,-26,36
Albion,5358,9,8,6,22,58,80,-22,30
Queen's Park,5358,10,6,11,19,41,74,-33,29
Ayr,5359,1,24,4,8,94,42,52,76
Raith,5359,2,22,9,5,70,34,36,75
Alloa,5359,3,17,9,10,58,45,13,60
Arbroath,5359,4,17,8,11,71,51,20,59
Stranraer,5359,5,15,5,16,55,67,-12,50
East Fife,5359,6,14,3,19,50,64,-14,45
Airdrieon,5359,7,10,12,14,47,60,-13,42
Forfar,5359,8,10,6,20,40,66,-26,36
Queen's Park,5359,9,7,10,19,42,73,-31,31
Albion,5359,10,8,6,22,57,82,-25,30
Raith,5360,1,23,8,5,70,33,37,77
Ayr,5360,2,23,5,8,93,45,48,74
Arbroath,5360,3,17,8,11,71,50,21,59
Alloa,5360,4,17,8,11,57,45,12,59
Stranraer,5360,5,15,6,15,57,66,-9,51
Airdrieon,5360,6,11,11,14,47,58,-11,44
East Fife,5360,7,13,4,19,49,66,-17,43
Forfar,5360,8,10,5,21,38,66,-28,35
Albion,5360,9,8,7,21,60,81,-21,31
Queen's Park,5360,10,7,10,19,41,73,-32,31
Ayr,5361,1,24,4,8,95,44,51,76
Raith,5361,2,22,9,5,70,34,36,75
Alloa,5361,3,17,9,10,58,45,13,60
Arbroath,5361,4,17,8,11,70,51,19,59
Stranraer,5361,5,15,5,16,56,67,-11,50
East Fife,5361,6,14,3,19,50,65,-15,45
Airdrieon,5361,7,11,11,14,47,58,-11,44
Forfar,5361,8,10,5,21,38,66,-28,35
Queen's Park,5361,9,7,10,19,42,72,-30,31
Albion,5361,10,8,6,22,59,83,-24,30
Raith,5362,1,23,8,5,70,33,37,77
Ayr,5362,2,24,4,8,94,44,50,76
Arbroath,5362,3,18,8,10,71,48,23,62
Alloa,5362,4,17,8,11,57,45,12,59
Stranraer,5362,5,15,5,16,55,68,-13,50
East Fife,5362,6,14,3,19,51,64,-13,45
Airdrieon,5362,7,11,11,14,47,59,-12,44
Forfar,5362,8,10,5,21,39,66,-27,35
Albion,5362,9,8,6,22,59,82,-23,30
Queen's Park,5362,10,6,10,20,39,73,-34,28
Raith,5363,1,23,8,5,69,32,37,77
Ayr,5363,2,24,4,8,91,42,49,76
Arbroath,5363,3,17,9,10,72,50,22,60
Alloa,5363,4,17,8,11,56,44,12,59
Stranraer,5363,5,15,5,16,56,67,-11,50
East Fife,5363,6,14,3,19,50,65,-15,45
Airdrieon,5363,7,10,11,15,45,60,-15,41
Forfar,5363,8,11,5,20,40,64,-24,38
Albion,5363,9,8,6,22,57,79,-22,30
Queen's Park,5363,10,6,11,19,41,74,-33,29
Ayr,5364,1,24,4,8,94,42,52,76
Raith,5364,2,22,9,5,70,34,36,75
Alloa,5364,3,17,9,10,58,45,13,60
Arbroath,5364,4,17,8,11,71,51,20,59
Stranraer,5364,5,15,5,16,56,68,-12,50
East Fife,5364,6,14,3,19,51,65,-14,45
Airdrieon,5364,7,11,11,14,46,58,-12,44
Forfar,5364,8,10,5,21,38,65,-27,35
Queen's Park,5364,9,7,10,19,42,73,-31,31
Albion,5364,10,8,6,22,57,82,-25,30
Raith,5365,1,23,8,5,70,32,38,77
Ayr,5365,2,23,4,9,93,46,47,73
Arbroath,5365,3,18,8,10,75,50,25,62
Alloa,5365,4,17,8,11,56,45,11,59
Stranraer,5365,5,16,5,15,58,64,-6,53
East Fife,5365,6,13,3,20,47,67,-20,42
Airdrieon,5365,7,10,11,15,45,59,-14,41
Forfar,5365,8,11,5,20,39,64,-25,38
Albion,5365,9,9,6,21,61,81,-20,33
Queen's Park,5365,10,6,10,20,41,77,-36,28
Raith,5366,1,23,8,5,70,33,37,77
Ayr,5366,2,24,4,8,93,42,51,76
Arbroath,5366,3,18,8,10,72,49,23,62
Alloa,5366,4,17,8,11,57,45,12,59
Stranraer,5366,5,16,5,15,57,65,-8,53
Airdrieon,5366,6,11,11,14,47,58,-11,44
East Fife,5366,7,13,3,20,48,66,-18,42
Forfar,5366,8,10,5,21,38,66,-28,35
Albion,5366,9,8,6,22,57,81,-24,30
Queen's Park,5366,10,6,10,20,40,74,-34,28
Raith,5367,1,22,9,5,69,33,36,75
Ayr,5367,2,23,5,8,91,43,48,74
Arbroath,5367,3,17,9,10,70,48,22,60
Alloa,5367,4,17,9,10,57,44,13,60
Stranraer,5367,5,15,5,16,55,65,-10,50
East Fife,5367,6,14,3,19,48,64,-16,45
Airdrieon,5367,7,10,12,14,47,60,-13,42
Forfar,5367,8,10,6,20,40,66,-26,36
Albion,5367,9,8,7,21,58,79,-21,31
Queen's Park,5367,10,6,11,19,39,72,-33,29
Ayr,5368,1,24,4,8,94,43,51,76
Raith,5368,2,22,9,5,69,33,36,75
Arbroath,5368,3,18,8,10,73,49,24,62
Alloa,5368,4,17,9,10,57,44,13,60
Stranraer,5368,5,15,6,15,57,66,-9,51
Airdrieon,5368,6,11,11,14,47,59,-12,44
East Fife,5368,7,13,4,19,49,66,-17,43
Forfar,5368,8,10,5,21,39,66,-27,35
Albion,5368,9,8,6,22,58,82,-24,30
Queen's Park,5368,10,6,10,20,40,75,-35,28
Raith,5369,1,23,8,5,69,32,37,77
Ayr,5369,2,24,4,8,92,42,50,76
Arbroath,5369,3,18,8,10,72,49,23,62
Alloa,5369,4,17,8,11,56,44,12,59
Stranraer,5369,5,15,5,16,56,67,-11,50
East Fife,5369,6,14,3,19,50,65,-15,45
Airdrieon,5369,7,10,12,14,46,59,-13,42
Forfar,5369,8,10,6,20,39,65,-26,36
Albion,5369,9,8,6,22,57,80,-23,30
Queen's Park,5369,10,6,10,20,40,74,-34,28
Ayr,5370,1,24,4,8,95,42,53,76
Raith,5370,2,22,8,6,68,33,35,74
Arbroath,5370,3,18,8,10,71,48,23,62
Alloa,5370,4,18,8,10,57,43,14,62
Stranraer,5370,5,16,5,15,57,65,-8,53
Airdrieon,5370,6,11,11,14,47,59,-12,44
East Fife,5370,7,13,3,20,48,66,-18,42
Forfar,5370,8,10,5,21,39,66,-27,35
Albion,5370,9,8,6,22,57,83,-26,30
Queen's Park,5370,10,6,10,20,39,73,-34,28
Raith,5371,1,23,8,5,70,33,37,77
Ayr,5371,2,23,5,8,93,45,48,74
Arbroath,5371,3,18,8,10,71,48,23,62
Alloa,5371,4,17,8,11,57,45,12,59
Stranraer,5371,5,15,6,15,55,64,-9,51
Airdrieon,5371,6,11,11,14,47,58,-11,44
East Fife,5371,7,13,4,19,47,64,-17,43
Forfar,5371,8,10,5,21,38,66,-28,35
Albion,5371,9,8,7,21,60,81,-21,31
Queen's Park,5371,10,6,10,20,39,73,-34,28
Raith,5372,1,23,8,5,71,32,39,77
Ayr,5372,2,24,4,8,96,42,54,76
Arbroath,5372,3,18,8,10,76,49,27,62
Alloa,5372,4,17,8,11,56,46,10,59
Stranraer,5372,5,15,5,16,57,67,-10,50
East Fife,5372,6,14,3,19,50,66,-16,45
Airdrieon,5372,7,11,11,14,47,58,-11,44
Forfar,5372,8,10,5,21,38,66,-28,35
Albion,5372,9,8,6,22,57,84,-27,30
Queen's Park,5372,10,6,10,20,40,78,-38,28
Raith,5373,1,23,8,5,70,33,37,77
Ayr,5373,2,24,4,8,93,43,50,76
Arbroath,5373,3,18,8,10,72,48,24,62
Alloa,5373,4,17,8,11,57,45,12,59
Stranraer,5373,5,15,5,16,55,66,-11,50
East Fife,5373,6,14,3,19,49,64,-15,45
Airdrieon,5373,7,11,11,14,46,58,-12,44
Forfar,5373,8,10,5,21,38,65,-27,35
Albion,5373,9,8,6,22,58,81,-23,30
Queen's Park,5373,10,6,10,20,39,74,-35,28
Ayr,5374,1,24,4,8,92,43,49,76
Raith,5374,2,22,8,6,70,35,35,74
Alloa,5374,3,18,8,10,59,45,14,62
Arbroath,5374,4,17,8,11,71,50,21,59
Stranraer,5374,5,15,5,16,56,67,-11,50
East Fife,5374,6,14,3,19,50,65,-15,45
Airdrieon,5374,7,11,11,14,47,58,-11,44
Forfar,5374,8,10,5,21,38,66,-28,35
Queen's Park,5374,9,7,10,19,41,73,-32,31
Albion,5374,10,8,6,22,58,80,-22,30
Ayr,5375,1,24,4,8,93,44,49,76
Raith,5375,2,22,8,6,68,34,34,74
Arbroath,5375,3,18,8,10,75,48,27,62
Alloa,5375,4,18,8,10,58,43,15,62
Stranraer,5375,5,15,6,15,55,64,-9,51
Airdrieon,5375,6,11,11,14,48,58,-10,44
East Fife,5375,7,13,4,19,47,64,-17,43
Forfar,5375,8,10,5,21,38,67,-29,35
Albion,5375,9,8,6,22,59,81,-22,30
Queen's Park,5375,10,6,10,20,39,77,-38,28
Ayr,5376,1,24,4,8,95,43,52,76
Raith,5376,2,22,8,6,68,33,35,74
Alloa,5376,3,18,8,10,57,43,14,62
Arbroath,5376,4,17,8,11,71,50,21,59
Stranraer,5376,5,15,5,16,55,67,-12,50
East Fife,5376,6,14,3,19,50,64,-14,45
Airdrieon,5376,7,10,12,14,46,59,-13,42
Forfar,5376,8,10,6,20,39,65,-26,36
Queen's Park,5376,9,7,10,19,41,73,-32,31
Albion,5376,10,8,6,22,58,83,-25,30
Raith,5377,1,23,8,5,70,32,38,77
Ayr,5377,2,24,4,8,94,42,52,76
Arbroath,5377,3,17,9,10,71,49,22,60
Alloa,5377,4,17,8,11,56,45,11,59
Stranraer,5377,5,15,5,16,56,67,-11,50
East Fife,5377,6,14,3,19,50,65,-15,45
Airdrieon,5377,7,10,12,14,46,59,-13,42
Forfar,5377,8,10,6,20,39,65,-26,36
Albion,5377,9,8,6,22,57,82,-25,30
Queen's Park,5377,10,6,11,19,40,73,-33,29
Ayr,5378,1,24,4,8,96,43,53,76
Raith,5378,2,22,9,5,70,34,36,75
Arbroath,5378,3,18,8,10,73,49,24,62
Alloa,5378,4,17,9,10,58,45,13,60
Stranraer,5378,5,16,5,15,57,64,-7,53
Airdrieon,5378,6,10,12,14,47,60,-13,42
East Fife,5378,7,13,3,20,47,66,-19,42
Forfar,5378,8,10,6,20,40,66,-26,36
Albion,5378,9,8,6,22,58,84,-26,30
Queen's Park,5378,10,6,10,20,40,75,-35,28
Raith,5379,1,23,8,5,70,32,38,77
Ayr,5379,2,24,4,8,94,43,51,76
Arbroath,5379,3,17,9,10,70,48,22,60
Alloa,5379,4,17,8,11,56,45,11,59
Stranraer,5379,5,15,5,16,56,68,-12,50
East Fife,5379,6,14,3,19,51,65,-14,45
Airdrieon,5379,7,10,12,14,47,60,-13,42
Forfar,5379,8,10,6,20,40,66,-26,36
Albion,5379,9,8,6,22,58,82,-24,30
Queen's Park,5379,10,6,11,19,39,72,-33,29
Raith,5380,1,23,8,5,69,32,37,77
Ayr,5380,2,23,4,9,93,47,46,73
Arbroath,5380,3,18,8,10,72,49,23,62
Alloa,5380,4,17,8,11,56,44,12,59
Stranraer,5380,5,15,6,15,57,66,-9,51
East Fife,5380,6,13,4,19,49,66,-17,43
Airdrieon,5380,7,10,12,14,45,58,-13,42
Forfar,5380,8,10,6,20,38,64,-26,36
Albion,5380,9,9,6,21,62,81,-19,33
Queen's Park,5380,10,6,10,20,40,74,-34,28
Raith,5381,1,23,8,5,71,33,38,77
Ayr,5381,2,24,4,8,95,42,53,76
Arbroath,5381,3,17,8,11,71,50,21,59
Alloa,5381,4,17,8,11,57,46,11,59
Stranraer,5381,5,16,5,15,58,66,-8,53
Airdrieon,5381,6,10,12,14,46,59,-13,42
East Fife,5381,7,13,3,20,49,67,-18,42
Forfar,5381,8,10,6,20,39,65,-26,36
Queen's Park,5381,9,7,10,19,41,73,-32,31
Albion,5381,10,8,6,22,57,83,-26,30
Ayr,5382,1,24,4,8,96,46,50,76
Raith,5382,2,22,8,6,68,36,32,74
Alloa,5382,3,18,8,10,60,43,17,62
Arbroath,5382,4,17,8,11,70,49,21,59
Stranraer,5382,5,15,5,16,56,66,-10,50
East Fife,5382,6,14,3,19,49,65,-16,45
Airdrieon,5382,7,10,11,15,45,59,-14,41
Forfar,5382,8,11,5,20,39,64,-25,38
Queen's Park,5382,9,7,10,19,40,72,-32,31
Albion,5382,10,8,6,22,61,84,-23,30
Raith,5383,1,23,8,5,70,33,37,77
Ayr,5383,2,24,4,8,92,43,49,76
Arbroath,5383,3,17,8,11,72,53,19,59
Alloa,5383,4,17,8,11,57,45,12,59
Stranraer,5383,5,16,5,15,57,65,-8,53
Airdrieon,5383,6,10,12,14,47,60,-13,42
East Fife,5383,7,13,3,20,48,66,-18,42
Forfar,5383,8,10,6,20,40,66,-26,36
Queen's Park,5383,9,7,10,19,44,74,-30,31
Albion,5383,10,8,6,22,58,80,-22,30
Ayr,5384,1,24,4,8,99,42,57,76
Raith,5384,2,22,9,5,69,33,36,75
Alloa,5384,3,17,9,10,57,44,13,60
Arbroath,5384,4,17,8,11,71,50,21,59
Stranraer,5384,5,15,5,16,55,65,-10,50
East Fife,5384,6,14,3,19,48,64,-16,45
Airdrieon,5384,7,10,11,15,46,60,-14,41
Forfar,5384,8,11,5,20,40,65,-25,38
Queen's Park,5384,9,7,10,19,41,73,-32,31
Albion,5384,10,8,6,22,57,87,-30,30
Raith,5385,1,23,8,5,70,32,38,77
Ayr,5385,2,23,4,9,90,47,43,73
Arbroath,5385,3,17,9,10,71,49,22,60
Alloa,5385,4,17,8,11,56,45,11,59
Stranraer,5385,5,16,5,15,57,65,-8,53
Airdrieon,5385,6,11,11,14,48,59,-11,44
East Fife,5385,7,13,3,20,48,66,-18,42
Forfar,5385,8,10,5,21,39,67,-28,35
Albion,5385,9,9,6,21,62,78,-16,33
Queen's Park,5385,10,6,11,19,40,73,-33,29
Raith,5386,1,22,9,5,68,32,36,75
Ayr,5386,2,23,5,8,92,44,48,74
Arbroath,5386,3,18,8,10,71,48,23,62
Alloa,5386,4,17,9,10,56,43,13,60
Stranraer,5386,5,15,6,15,56,65,-9,51
Airdrieon,5386,6,11,11,14,50,60,-10,44
East Fife,5386,7,13,4,19,48,65,-17,43
Forfar,5386,8,10,5,21,40,69,-29,35
Albion,5386,9,8,7,21,59,80,-21,31
Queen's Park,5386,10,6,10,20,39,73,-34,28
Ayr,5387,1,24,4,8,96,44,52,76
Raith,5387,2,22,8,6,68,33,35,74
Alloa,5387,3,18,8,10,57,43,14,62
Arbroath,5387,4,17,9,10,71,49,22,60
Stranraer,5387,5,15,5,16,56,67,-11,50
East Fife,5387,6,14,3,19,50,65,-15,45
Airdrieon,5387,7,10,11,15,46,61,-15,41
Forfar,5387,8,11,5,20,41,65,-24,38
Albion,5387,9,8,6,22,59,84,-25,30
Queen's Park,5387,10,6,11,19,40,73,-33,29
Raith,5388,1,23,8,5,71,33,38,77
Ayr,5388,2,24,4,8,93,43,50,76
Arbroath,5388,3,18,8,10,71,48,23,62
Alloa,5388,4,17,8,11,57,46,11,59
Stranraer,5388,5,16,5,15,59,66,-7,53
Airdrieon,5388,6,10,12,14,45,58,-13,42
East Fife,5388,7,13,3,20,49,68,-19,42
Forfar,5388,8,10,6,20,38,64,-26,36
Albion,5388,9,8,6,22,58,81,-23,30
Queen's Park,5388,10,6,10,20,39,73,-34,28
Raith,5389,1,23,8,5,71,32,39,77
Ayr,5389,2,24,4,8,92,43,49,76
Arbroath,5389,3,18,8,10,74,49,25,62
Alloa,5389,4,17,8,11,56,46,10,59
Stranraer,5389,5,15,6,15,56,65,-9,51
East Fife,5389,6,13,4,19,48,65,-17,43
Airdrieon,5389,7,10,11,15,47,61,-14,41
Forfar,5389,8,11,5,20,41,66,-25,38
Albion,5389,9,8,6,22,58,80,-22,30
Queen's Park,5389,10,6,10,20,40,76,-36,28
Raith,5390,1,23,8,5,73,32,41,77
Ayr,5390,2,23,4,9,93,46,47,73
Arbroath,5390,3,17,8,11,70,51,19,59
Alloa,5390,4,17,8,11,56,48,8,59
Stranraer,5390,5,15,6,15,56,65,-9,51
East Fife,5390,6,13,4,19,48,65,-17,43
Airdrieon,5390,7,10,12,14,47,60,-13,42
Forfar,5390,8,10,6,20,40,66,-26,36
Albion,5390,9,9,6,21,61,81,-20,33
Queen's Park,5390,10,7,10,19,42,72,-30,31
Ayr,5391,1,24,4,8,95,44,51,76
Raith,5391,2,22,9,5,71,35,36,75
Arbroath,5391,3,18,8,10,73,48,25,62
Alloa,5391,4,17,9,10,59,46,13,60
Stranraer,5391,5,15,6,15,57,66,-9,51
East Fife,5391,6,13,4,19,49,66,-17,43
Airdrieon,5391,7,10,11,15,45,60,-15,41
Forfar,5391,8,11,5,20,40,64,-24,38
Albion,5391,9,8,6,22,59,83,-24,30
Queen's Park,5391,10,6,10,20,39,75,-36,28
Ayr,5392,1,24,4,8,93,43,50,76
Raith,5392,2,22,9,5,69,33,36,75
Arbroath,5392,3,18,8,10,74,50,24,62
Alloa,5392,4,17,9,10,57,44,13,60
Stranraer,5392,5,15,5,16,57,67,-10,50
East Fife,5392,6,14,3,19,50,66,-16,45
Airdrieon,5392,7,11,11,14,47,58,-11,44
Forfar,5392,8,10,5,21,38,66,-28,35
Albion,5392,9,8,6,22,58,81,-23,30
Queen's Park,5392,10,6,10,20,41,76,-35,28
Raith,5393,1,23,8,5,70,33,37,77
Ayr,5393,2,24,4,8,92,42,50,76
Arbroath,5393,3,17,9,10,72,50,22,60
Alloa,5393,4,17,8,11,57,45,12,59
Stranraer,5393,5,15,5,16,56,68,-12,50
East Fife,5393,6,14,3,19,51,65,-14,45
Airdrieon,5393,7,11,11,14,48,58,-10,44
Forfar,5393,8,10,5,21,38,67,-29,35
Albion,5393,9,8,6,22,57,80,-23,30
Queen's Park,5393,10,6,11,19,41,74,-33,29
Raith,5394,1,23,8,5,70,32,38,77
Ayr,5394,2,24,4,8,93,43,50,76
Arbroath,5394,3,18,8,10,73,48,25,62
Alloa,5394,4,17,8,11,56,45,11,59
Stranraer,5394,5,15,6,15,57,66,-9,51
Airdrieon,5394,6,11,11,14,46,58,-12,44
East Fife,5394,7,13,4,19,49,66,-17,43
Forfar,5394,8,10,5,21,38,65,-27,35
Albion,5394,9,8,6,22,58,81,-23,30
Queen's Park,5394,10,6,10,20,39,75,-36,28
Raith,5395,1,22,8,6,69,34,35,74
Ayr,5395,2,23,4,9,91,47,44,73
Arbroath,5395,3,18,8,10,72,48,24,62
Alloa,5395,4,18,8,10,58,44,14,62
Stranraer,5395,5,16,5,15,59,65,-6,53
Airdrieon,5395,6,11,11,14,47,58,-11,44
East Fife,5395,7,13,3,20,48,68,-20,42
Forfar,5395,8,10,5,21,38,66,-28,35
Albion,5395,9,9,6,21,62,79,-17,33
Queen's Park,5395,10,6,10,20,39,74,-35,28
Ayr,5396,1,24,4,8,93,43,50,76
Raith,5396,2,22,9,5,68,32,36,75
Arbroath,5396,3,18,8,10,74,49,25,62
Alloa,5396,4,17,9,10,56,43,13,60
Stranraer,5396,5,16,5,15,56,64,-8,53
East Fife,5396,6,13,3,20,47,65,-18,42
Airdrieon,5396,7,10,11,15,45,59,-14,41
Forfar,5396,8,11,5,20,39,64,-25,38
Albion,5396,9,8,6,22,58,81,-23,30
Queen's Park,5396,10,6,10,20,40,76,-36,28
Raith,5397,1,23,8,5,69,32,37,77
Ayr,5397,2,24,4,8,96,43,53,76
Arbroath,5397,3,17,8,11,70,49,21,59
Alloa,5397,4,17,8,11,56,44,12,59
Stranraer,5397,5,15,5,16,56,66,-10,50
East Fife,5397,6,14,3,19,49,65,-16,45
Airdrieon,5397,7,10,12,14,47,60,-13,42
Forfar,5397,8,10,6,20,40,66,-26,36
Queen's Park,5397,9,7,10,19,40,72,-32,31
Albion,5397,10,8,6,22,58,84,-26,30
Raith,5398,1,23,8,5,70,33,37,77
Ayr,5398,2,24,4,8,96,44,52,76
Arbroath,5398,3,17,8,11,71,51,20,59
Alloa,5398,4,17,8,11,57,45,12,59
Stranraer,5398,5,15,6,15,56,65,-9,51
East Fife,5398,6,13,4,19,48,65,-17,43
Airdrieon,5398,7,10,12,14,47,60,-13,42
Forfar,5398,8,10,6,20,40,66,-26,36
Queen's Park,5398,9,7,10,19,42,73,-31,31
Albion,5398,10,8,6,22,59,84,-25,30
Raith,5399,1,23,8,5,72,33,39,77
Ayr,5399,2,24,4,8,94,45,49,76
Arbroath,5399,3,18,8,10,73,49,24,62
Alloa,5399,4,17,8,11,57,47,10,59
Stranraer,5399,5,15,5,16,55,65,-10,50
East Fife,5399,6,14,3,19,48,64,-16,45
Airdrieon,5399,7,11,11,14,49,61,-12,44
Forfar,5399,8,10,5,21,41,68,-27,35
Albion,5399,9,8,6,22,60,82,-22,30
Queen's Park,5399,10,6,10,20,40,75,-35,28
Raith,5400,1,23,8,5,69,32,37,77
Ayr,5400,2,24,4,8,95,42,53,76
Arbroath,5400,3,18,8,10,72,49,23,62
Alloa,5400,4,17,8,11,56,44,12,59
Stranraer,5400,5,15,5,16,56,68,-12,50
East Fife,5400,6,14,3,19,51,65,-14,45
Airdrieon,5400,7,11,11,14,47,58,-11,44
Forfar,5400,8,10,5,21,38,66,-28,35
Albion,5400,9,8,6,22,57,83,-26,30
Queen's Park,5400,10,6,10,20,40,74,-34,28
Raith,5401,1,22,9,5,68,32,36,75
Ayr,5401,2,23,4,9,91,45,46,73
Arbroath,5401,3,18,8,10,71,48,23,62
Alloa,5401,4,17,9,10,56,43,13,60
Stranraer,5401,5,15,5,16,56,67,-11,50
East Fife,5401,6,14,3,19,50,65,-15,45
Airdrieon,5401,7,10,12,14,46,59,-13,42
Forfar,5401,8,10,6,20,39,65,-26,36
Albion,5401,9,9,6,21,60,79,-19,33
Queen's Park,5401,10,6,10,20,39,73,-34,28
Raith,5402,1,23,8,5,70,33,37,77
Ayr,5402,2,24,4,8,92,42,50,76
Arbroath,5402,3,17,8,11,71,51,20,59
Alloa,5402,4,17,8,11,57,45,12,59
Stranraer,5402,5,16,5,15,58,65,-7,53
Airdrieon,5402,6,11,11,14,47,58,-11,44
East Fife,5402,7,13,3,20,48,67,-19,42
Forfar,5402,8,10,5,21,38,66,-28,35
Queen's Park,5402,9,7,10,19,42,73,-31,31
Albion,5402,10,8,6,22,57,80,-23,30
Raith,5403,1,23,8,5,71,32,39,77
Ayr,5403,2,24,4,8,92,43,49,76
Arbroath,5403,3,17,8,11,71,50,21,59
Alloa,5403,4,17,8,11,56,46,10,59
Stranraer,5403,5,16,5,15,56,64,-8,53
East Fife,5403,6,13,3,20,47,65,-18,42
Airdrieon,5403,7,10,11,15,47,61,-14,41
Forfar,5403,8,11,5,20,41,66,-25,38
Queen's Park,5403,9,7,10,19,41,73,-32,31
Albion,5403,10,8,6,22,58,80,-22,30
Raith,5404,1,23,8,5,70,33,37,77
Ayr,5404,2,24,4,8,94,45,49,76
Arbroath,5404,3,17,8,11,71,50,21,59
Alloa,5404,4,17,8,11,57,45,12,59
Stranraer,5404,5,16,5,15,57,65,-8,53
Airdrieon,5404,6,10,12,14,46,59,-13,42
East Fife,5404,7,13,3,20,48,66,-18,42
Forfar,5404,8,10,6,20,39,65,-26,36
Queen's Park,5404,9,7,10,19,41,73,-32,31
Albion,5404,10,8,6,22,60,82,-22,30
Raith,5405,1,23,8,5,71,33,38,77
Ayr,5405,2,24,4,8,97,44,53,76
Arbroath,5405,3,17,8,11,70,49,21,59
Alloa,5405,4,17,8,11,57,46,11,59
Stranraer,5405,5,16,5,15,57,64,-7,53
East Fife,5405,6,13,3,20,47,66,-19,42
Airdrieon,5405,7,10,11,15,46,60,-14,41
Forfar,5405,8,11,5,20,40,65,-25,38
Queen's Park,5405,9,7,10,19,40,72,-32,31
Albion,5405,10,8,6,22,59,85,-26,30
Raith,5406,1,22,8,6,70,35,35,74
Ayr,5406,2,23,4,9,91,45,46,73
Alloa,5406,3,18,8,10,59,45,14,62
Arbroath,5406,4,17,8,11,70,51,19,59
Stranraer,5406,5,15,5,16,55,65,-10,50
East Fife,5406,6,14,3,19,48,64,-16,45
Airdrieon,5406,7,11,11,14,46,58,-12,44
Forfar,5406,8,10,5,21,38,65,-27,35
Albion,5406,9,9,6,21,60,79,-19,33
Queen's Park,5406,10,7,10,19,42,72,-30,31
Raith,5407,1,23,8,5,69,32,37,77
Ayr,5407,2,24,4,8,95,43,52,76
Arbroath,5407,3,17,8,11,70,50,20,59
Alloa,5407,4,17,8,11,56,44,12,59
Stranraer,5407,5,16,5,15,57,64,-7,53
East Fife,5407,6,13,3,20,47,66,-19,42
Airdrieon,5407,7,10,11,15,45,60,-15,41
Forfar,5407,8,11,5,20,40,64,-24,38
Queen's Park,5407,9,7,10,19,41,72,-31,31
Albion,5407,10,8,6,22,58,83,-25,30
Ayr,5408,1,24,4,8,93,42,51,76
Raith,5408,2,22,8,6,68,33,35,74
Alloa,5408,3,18,8,10,57,43,14,62
Arbroath,5408,4,17,9,10,71,49,22,60
Stranraer,5408,5,16,5,15,60,66,-6,53
Airdrieon,5408,6,11,11,14,46,58,-12,44
East Fife,5408,7,13,3,20,49,69,-20,42
Forfar,5408,8,10,5,21,38,65,-27,35
Albion,5408,9,8,6,22,57,81,-24,30
Queen's Park,5408,10,6,11,19,40,73,-33,29
Ayr,5409,1,24,4,8,95,46,49,76
Raith,5409,2,22,9,5,69,33,36,75
Alloa,5409,3,17,9,10,57,44,13,60
Arbroath,5409,4,17,8,11,71,52,19,59
Stranraer,5409,5,15,5,16,55,65,-10,50
East Fife,5409,6,14,3,19,48,64,-16,45
Airdrieon,5409,7,10,11,15,46,61,-15,41
Forfar,5409,8,11,5,20,41,65,-24,38
Queen's Park,5409,9,7,10,19,43,73,-30,31
Albion,5409,10,8,6,22,61,83,-22,30
Ayr,5410,1,24,4,8,99,42,57,76
Raith,5410,2,22,8,6,69,34,35,74
Alloa,5410,3,18,8,10,58,44,14,62
Arbroath,5410,4,17,8,11,72,51,21,59
Stranraer,5410,5,15,5,16,55,66,-11,50
East Fife,5410,6,14,3,19,49,64,-15,45
Airdrieon,5410,7,10,12,14,46,59,-13,42
Forfar,5410,8,10,6,20,39,65,-26,36
Queen's Park,5410,9,7,10,19,42,74,-32,31
Albion,5410,10,8,6,22,57,87,-30,30
Ayr,5411,1,24,4,8,94,43,51,76
Raith,5411,2,22,9,5,69,33,36,75
Arbroath,5411,3,18,8,10,71,48,23,62
Alloa,5411,4,17,9,10,57,44,13,60
Stranraer,5411,5,16,5,15,57,65,-8,53
East Fife,5411,6,13,3,20,48,66,-18,42
Airdrieon,5411,7,10,11,15,45,60,-15,41
Forfar,5411,8,11,5,20,40,64,-24,38
Albion,5411,9,8,6,22,58,82,-24,30
Queen's Park,5411,10,6,10,20,39,73,-34,28
Raith,5412,1,23,8,5,69,32,37,77
Ayr,5412,2,24,4,8,94,44,50,76
Arbroath,5412,3,17,9,10,70,48,22,60
Alloa,5412,4,17,8,11,56,44,12,59
Stranraer,5412,5,16,5,15,57,65,-8,53
Airdrieon,5412,6,10,12,14,47,60,-13,42
East Fife,5412,7,13,3,20,48,66,-18,42
Forfar,5412,8,10,6,20,40,66,-26,36
Albion,5412,9,8,6,22,59,82,-23,30
Queen's Park,5412,10,6,11,19,39,72,-33,29
Ayr,5413,1,24,4,8,97,43,54,76
Raith,5413,2,22,8,6,69,34,35,74
Arbroath,5413,3,18,8,10,72,49,23,62
Alloa,5413,4,18,8,10,58,44,14,62
Stranraer,5413,5,16,5,15,56,64,-8,53
East Fife,5413,6,13,3,20,47,65,-18,42
Airdrieon,5413,7,10,11,15,46,60,-14,41
Forfar,5413,8,11,5,20,40,65,-25,38
Albion,5413,9,8,6,22,58,85,-27,30
Queen's Park,5413,10,6,10,20,40,74,-34,28
Raith,5414,1,23,8,5,70,33,37,77
Ayr,5414,2,24,4,8,95,43,52,76
Arbroath,5414,3,18,8,10,71,48,23,62
Alloa,5414,4,17,8,11,57,45,12,59
Stranraer,5414,5,15,6,15,58,67,-9,51
Airdrieon,5414,6,11,11,14,47,58,-11,44
East Fife,5414,7,13,4,19,50,67,-17,43
Forfar,5414,8,10,5,21,38,66,-28,35
Albion,5414,9,8,6,22,58,83,-25,30
Queen's Park,5414,10,6,10,20,39,73,-34,28
Ayr,5415,1,24,4,8,92,43,49,76
Raith,5415,2,22,8,6,69,34,35,74
Alloa,5415,3,18,8,10,58,44,14,62
Arbroath,5415,4,17,8,11,71,51,20,59
Stranraer,5415,5,15,5,16,55,67,-12,50
East Fife,5415,6,14,3,19,50,64,-14,45
Airdrieon,5415,7,10,12,14,46,59,-13,42
Forfar,5415,8,10,6,20,39,65,-26,36
Queen's Park,5415,9,7,10,19,42,73,-31,31
Albion,5415,10,8,6,22,58,80,-22,30
Raith,5416,1,23,8,5,70,33,37,77
Ayr,5416,2,24,4,8,95,42,53,76
Arbroath,5416,3,18,8,10,72,49,23,62
Alloa,5416,4,17,8,11,57,45,12,59
Stranraer,5416,5,15,5,16,55,68,-13,50
East Fife,5416,6,14,3,19,51,64,-13,45
Airdrieon,5416,7,10,11,15,45,59,-14,41
Forfar,5416,8,11,5,20,39,64,-25,38
Albion,5416,9,8,6,22,57,83,-26,30
Queen's Park,5416,10,6,10,20,40,74,-34,28
Ayr,5417,1,24,4,8,92,43,49,76
Raith,5417,2,22,9,5,69,33,36,75
Arbroath,5417,3,17,9,10,70,48,22,60
Alloa,5417,4,17,9,10,57,44,13,60
Stranraer,5417,5,15,5,16,56,66,-10,50
East Fife,5417,6,14,3,19,49,65,-16,45
Airdrieon,5417,7,10,11,15,47,61,-14,41
Forfar,5417,8,11,5,20,41,66,-25,38
Albion,5417,9,8,6,22,58,80,-22,30
Queen's Park,5417,10,6,11,19,39,72,-33,29
Ayr,5418,1,24,4,8,96,43,53,76
Raith,5418,2,22,9,5,70,34,36,75
Arbroath,5418,3,18,8,10,74,50,24,62
Alloa,5418,4,17,9,10,58,45,13,60
Stranraer,5418,5,15,5,16,55,69,-14,50
East Fife,5418,6,14,3,19,52,64,-12,45
Airdrieon,5418,7,10,11,15,45,59,-14,41
Forfar,5418,8,11,5,20,39,64,-25,38
Albion,5418,9,8,6,22,58,84,-26,30
Queen's Park,5418,10,6,10,20,41,76,-35,28
Ayr,5419,1,24,4,8,94,44,50,76
Raith,5419,2,22,9,5,68,32,36,75
Arbroath,5419,3,18,8,10,72,49,23,62
Alloa,5419,4,17,9,10,56,43,13,60
Stranraer,5419,5,16,5,15,58,65,-7,53
Airdrieon,5419,6,11,11,14,48,60,-12,44
East Fife,5419,7,13,3,20,48,67,-19,42
Forfar,5419,8,10,5,21,40,67,-27,35
Albion,5419,9,8,6,22,59,82,-23,30
Queen's Park,5419,10,6,10,20,40,74,-34,28
Raith,5420,1,23,8,5,69,32,37,77
Ayr,5420,2,24,4,8,91,42,49,76
Arbroath,5420,3,17,9,10,70,48,22,60
Alloa,5420,4,17,8,11,56,44,12,59
Stranraer,5420,5,15,6,15,57,66,-9,51
Airdrieon,5420,6,11,11,14,49,59,-10,44
East Fife,5420,7,13,4,19,49,66,-17,43
Forfar,5420,8,10,5,21,39,68,-29,35
Albion,5420,9,8,6,22,57,79,-22,30
Queen's Park,5420,10,6,11,19,39,72,-33,29
Raith,5421,1,23,8,5,70,33,37,77
Ayr,5421,2,24,4,8,95,42,53,76
Arbroath,5421,3,17,9,10,71,49,22,60
Alloa,5421,4,17,8,11,57,45,12,59
Stranraer,5421,5,15,6,15,58,67,-9,51
Airdrieon,5421,6,11,11,14,46,58,-12,44
East Fife,5421,7,13,4,19,50,67,-17,43
Forfar,5421,8,10,5,21,38,65,-27,35
Albion,5421,9,8,6,22,57,83,-26,30
Queen's Park,5421,10,6,11,19,40,73,-33,29
Ayr,5422,1,24,4,8,94,42,52,76
Raith,5422,2,22,9,5,69,33,36,75
Alloa,5422,3,17,9,10,57,44,13,60
Arbroath,5422,4,17,8,11,70,50,20,59
Stranraer,5422,5,16,5,15,58,66,-8,53
Airdrieon,5422,6,10,12,14,47,60,-13,42
East Fife,5422,7,13,3,20,49,67,-18,42
Forfar,5422,8,10,6,20,40,66,-26,36
Queen's Park,5422,9,7,10,19,41,72,-31,31
Albion,5422,10,8,6,22,57,82,-25,30
Raith,5423,1,23,8,5,70,33,37,77
Ayr,5423,2,24,4,8,95,44,51,76
Arbroath,5423,3,17,8,11,71,50,21,59
Alloa,5423,4,17,8,11,57,45,12,59
Stranraer,5423,5,15,5,16,56,67,-11,50
East Fife,5423,6,14,3,19,50,65,-15,45
Airdrieon,5423,7,11,11,14,47,59,-12,44
Forfar,5423,8,10,5,21,39,66,-27,35
Queen's Park,5423,9,7,10,19,41,73,-32,31
Albion,5423,10,8,6,22,59,83,-24,30
Raith,5424,1,23,8,5,70,32,38,77
Ayr,5424,2,23,4,9,91,45,46,73
Arbroath,5424,3,18,8,10,71,48,23,62
Alloa,5424,4,17,8,11,56,45,11,59
Stranraer,5424,5,16,5,15,56,64,-8,53
Airdrieon,5424,6,11,11,14,46,58,-12,44
East Fife,5424,7,13,3,20,47,65,-18,42
Forfar,5424,8,10,5,21,38,65,-27,35
Albion,5424,9,9,6,21,60,79,-19,33
Queen's Park,5424,10,6,10,20,39,73,-34,28
Raith,5425,1,23,8,5,70,32,38,77
Ayr,5425,2,24,4,8,92,42,50,76
Arbroath,5425,3,18,8,10,72,48,24,62
Alloa,5425,4,17,8,11,56,45,11,59
Stranraer,5425,5,15,5,16,56,66,-10,50
East Fife,5425,6,14,3,19,49,65,-16,45
Airdrieon,5425,7,11,11,14,47,58,-11,44
Forfar,5425,8,10,5,21,38,66,-28,35
Albion,5425,9,8,6,22,57,80,-23,30
Queen's Park,5425,10,6,10,20,39,74,-35,28
Ayr,5426,1,24,4,8,93,44,49,76
Raith,5426,2,22,9,5,68,32,36,75
Arbroath,5426,3,18,8,10,72,49,23,62
Alloa,5426,4,17,9,10,56,43,13,60
Stranraer,5426,5,15,5,16,55,65,-10,50
East Fife,5426,6,14,3,19,48,64,-16,45
Airdrieon,5426,7,10,12,14,45,58,-13,42
Forfar,5426,8,10,6,20,38,64,-26,36
Albion,5426,9,8,6,22,59,81,-22,30
Queen's Park,5426,10,6,10,20,40,74,-34,28
Raith,5427,1,23,8,5,70,32,38,77
Ayr,5427,2,23,4,9,92,45,47,73
Arbroath,5427,3,17,9,10,71,49,22,60
Alloa,5427,4,17,8,11,56,45,11,59
Stranraer,5427,5,15,5,16,55,65,-10,50
East Fife,5427,6,14,3,19,48,64,-16,45
Airdrieon,5427,7,11,11,14,47,58,-11,44
Forfar,5427,8,10,5,21,38,66,-28,35
Albion,5427,9,9,6,21,60,80,-20,33
Queen's Park,5427,10,6,11,19,40,73,-33,29
Raith,5428,1,22,9,5,69,33,36,75
Ayr,5428,2,23,4,9,91,44,47,73
Arbroath,5428,3,17,9,10,70,48,22,60
Alloa,5428,4,17,9,10,57,44,13,60
Stranraer,5428,5,15,6,15,56,65,-9,51
Airdrieon,5428,6,11,11,14,47,58,-11,44
East Fife,5428,7,13,4,19,48,65,-17,43
Forfar,5428,8,10,5,21,38,66,-28,35
Albion,5428,9,9,6,21,59,79,-20,33
Queen's Park,5428,10,6,11,19,39,72,-33,29
Ayr,5429,1,24,4,8,97,43,54,76
Raith,5429,2,22,8,6,68,33,35,74
Alloa,5429,3,18,8,10,57,43,14,62
Arbroath,5429,4,17,8,11,71,50,21,59
Stranraer,5429,5,15,5,16,55,70,-15,50
East Fife,5429,6,14,3,19,53,64,-11,45
Airdrieon,5429,7,11,11,14,49,59,-10,44
Forfar,5429,8,10,5,21,39,68,-29,35
Queen's Park,5429,9,7,10,19,41,73,-32,31
Albion,5429,10,8,6,22,58,85,-27,30
Ayr,5430,1,24,4,8,93,42,51,76
Raith,5430,2,22,8,6,68,33,35,74
Alloa,5430,3,18,8,10,57,43,14,62
Arbroath,5430,4,17,8,11,71,52,19,59
Stranraer,5430,5,15,5,16,59,69,-10,50
East Fife,5430,6,14,3,19,52,68,-16,45
Airdrieon,5430,7,10,11,15,45,59,-14,41
Forfar,5430,8,11,5,20,39,64,-25,38
Queen's Park,5430,9,7,10,19,43,73,-30,31
Albion,5430,10,8,6,22,57,81,-24,30
Ayr,5431,1,24,4,8,92,42,50,76
Raith,5431,2,22,9,5,70,34,36,75
Alloa,5431,3,17,9,10,58,45,13,60
Arbroath,5431,4,17,8,11,72,53,19,59
Stranraer,5431,5,16,5,15,61,66,-5,53
East Fife,5431,6,13,3,20,49,70,-21,42
Airdrieon,5431,7,10,11,15,45,59,-14,41
Forfar,5431,8,11,5,20,39,64,-25,38
Queen's Park,5431,9,7,10,19,44,74,-30,31
Albion,5431,10,8,6,22,57,80,-23,30
Raith,5432,1,23,8,5,70,32,38,77
Ayr,5432,2,24,4,8,95,43,52,76
Arbroath,5432,3,17,9,10,71,49,22,60
Alloa,5432,4,17,8,11,56,45,11,59
Stranraer,5432,5,15,6,15,57,66,-9,51
Airdrieon,5432,6,11,11,14,49,58,-9,44
East Fife,5432,7,13,4,19,49,66,-17,43
Forfar,5432,8,10,5,21,38,68,-30,35
Albion,5432,9,8,6,22,58,83,-25,30
Queen's Park,5432,10,6,11,19,40,73,-33,29
Ayr,5433,1,24,4,8,93,44,49,76
Raith,5433,2,22,9,5,68,32,36,75
Arbroath,5433,3,18,8,10,71,48,23,62
Alloa,5433,4,17,9,10,56,43,13,60
Stranraer,5433,5,15,5,16,56,67,-11,50
East Fife,5433,6,14,3,19,50,65,-15,45
Airdrieon,5433,7,10,12,14,46,59,-13,42
Forfar,5433,8,10,6,20,39,65,-26,36
Albion,5433,9,8,6,22,59,81,-22,30
Queen's Park,5433,10,6,10,20,39,73,-34,28
Ayr,5434,1,24,4,8,93,43,50,76
Raith,5434,2,22,9,5,69,33,36,75
Alloa,5434,3,17,9,10,57,44,13,60
Arbroath,5434,4,17,8,11,71,51,20,59
Stranraer,5434,5,16,5,15,57,65,-8,53
Airdrieon,5434,6,11,11,14,47,58,-11,44
East Fife,5434,7,13,3,20,48,66,-18,42
Forfar,5434,8,10,5,21,38,66,-28,35
Queen's Park,5434,9,7,10,19,42,73,-31,31
Albion,5434,10,8,6,22,58,81,-23,30
Ayr,5435,1,24,4,8,93,44,49,76
Raith,5435,2,22,9,5,70,34,36,75
Arbroath,5435,3,17,9,10,70,48,22,60
Alloa,5435,4,17,9,10,58,45,13,60
Stranraer,5435,5,16,5,15,59,65,-6,53
East Fife,5435,6,13,3,20,48,68,-20,42
Airdrieon,5435,7,10,11,15,46,61,-15,41
Forfar,5435,8,11,5,20,41,65,-24,38
Albion,5435,9,8,6,22,59,81,-22,30
Queen's Park,5435,10,6,11,19,39,72,-33,29
Raith,5436,1,23,8,5,71,32,39,77
Ayr,5436,2,24,4,8,95,44,51,76
Arbroath,5436,3,18,8,10,71,48,23,62
Alloa,5436,4,17,8,11,56,46,10,59
Stranraer,5436,5,16,5,15,57,65,-8,53
Airdrieon,5436,6,11,11,14,50,58,-8,44
East Fife,5436,7,13,3,20,48,66,-18,42
Forfar,5436,8,10,5,21,38,69,-31,35
Albion,5436,9,8,6,22,59,83,-24,30
Queen's Park,5436,10,6,10,20,39,73,-34,28
Raith,5437,1,23,8,5,70,33,37,77
Ayr,5437,2,23,5,8,92,44,48,74
Arbroath,5437,3,17,8,11,70,50,20,59
Alloa,5437,4,17,8,11,57,45,12,59
Stranraer,5437,5,16,5,15,58,66,-8,53
Airdrieon,5437,6,10,12,14,46,59,-13,42
East Fife,5437,7,13,3,20,49,67,-18,42
Forfar,5437,8,10,6,20,39,65,-26,36
Albion,5437,9,8,7,21,59,80,-21,31
Queen's Park,5437,10,7,10,19,41,72,-31,31
Ayr,5438,1,24,4,8,94,43,51,76
Raith,5438,2,22,8,6,69,34,35,74
Alloa,5438,3,18,8,10,58,44,14,62
Arbroath,5438,4,17,8,11,71,52,19,59
Stranraer,5438,5,15,6,15,57,66,-9,51
East Fife,5438,6,13,4,19,49,66,-17,43
Airdrieon,5438,7,10,12,14,46,59,-13,42
Forfar,5438,8,10,6,20,39,65,-26,36
Queen's Park,5438,9,7,10,19,43,73,-30,31
Albion,5438,10,8,6,22,58,82,-24,30
Ayr,5439,1,24,4,8,93,42,51,76
Raith,5439,2,22,9,5,69,33,36,75
Alloa,5439,3,17,9,10,57,44,13,60
Arbroath,5439,4,17,8,11,70,49,21,59
Stranraer,5439,5,15,5,16,57,67,-10,50
East Fife,5439,6,14,3,19,50,66,-16,45
Airdrieon,5439,7,10,11,15,46,61,-15,41
Forfar,5439,8,11,5,20,41,65,-24,38
Queen's Park,5439,9,7,10,19,40,72,-32,31
Albion,5439,10,8,6,22,57,81,-24,30
Raith,5440,1,23,8,5,69,32,37,77
Ayr,5440,2,24,4,8,94,44,50,76
Arbroath,5440,3,18,8,10,74,50,24,62
Alloa,5440,4,17,8,11,56,44,12,59
Stranraer,5440,5,15,5,16,57,67,-10,50
East Fife,5440,6,14,3,19,50,66,-16,45
Airdrieon,5440,7,11,11,14,47,58,-11,44
Forfar,5440,8,10,5,21,38,66,-28,35
Albion,5440,9,8,6,22,59,82,-23,30
Queen's Park,5440,10,6,10,20,41,76,-35,28
Ayr,5441,1,24,4,8,94,43,51,76
Raith,5441,2,22,9,5,69,33,36,75
Arbroath,5441,3,18,8,10,75,49,26,62
Alloa,5441,4,17,9,10,57,44,13,60
Stranraer,5441,5,16,5,15,58,66,-8,53
East Fife,5441,6,13,3,20,49,67,-18,42
Airdrieon,5441,7,10,11,15,45,59,-14,41
Forfar,5441,8,11,5,20,39,64,-25,38
Albion,5441,9,8,6,22,58,82,-24,30
Queen's Park,5441,10,6,10,20,40,77,-37,28
Raith,5442,1,23,8,5,70,32,38,77
Ayr,5442,2,24,4,8,92,42,50,76
Arbroath,5442,3,18,8,10,73,48,25,62
Alloa,5442,4,17,8,11,56,45,11,59
Stranraer,5442,5,15,5,16,56,66,-10,50
East Fife,5442,6,14,3,19,49,65,-16,45
Airdrieon,5442,7,10,11,15,45,60,-15,41
Forfar,5442,8,11,5,20,40,64,-24,38
Albion,5442,9,8,6,22,57,80,-23,30
Queen's Park,5442,10,6,10,20,39,75,-36,28
Raith,5443,1,23,8,5,71,32,39,77
Ayr,5443,2,24,4,8,95,44,51,76
Arbroath,5443,3,17,9,10,70,48,22,60
Alloa,5443,4,17,8,11,56,46,10,59
Stranraer,5443,5,15,5,16,55,65,-10,50
East Fife,5443,6,14,3,19,48,64,-16,45
Airdrieon,5443,7,10,11,15,45,60,-15,41
Forfar,5443,8,11,5,20,40,64,-24,38
Albion,5443,9,8,6,22,59,83,-24,30
Queen's Park,5443,10,6,11,19,39,72,-33,29
Ayr,5444,1,24,4,8,94,43,51,76
Raith,5444,2,22,8,6,70,36,34,74
Arbroath,5444,3,18,8,10,73,48,25,62
Alloa,5444,4,18,8,10,60,45,15,62
Stranraer,5444,5,16,5,15,56,64,-8,53
Airdrieon,5444,6,10,12,14,45,58,-13,42
East Fife,5444,7,13,3,20,47,65,-18,42
Forfar,5444,8,10,6,20,38,64,-26,36
Albion,5444,9,8,6,22,58,82,-24,30
Queen's Park,5444,10,6,10,20,39,75,-36,28
Raith,5445,1,23,8,5,71,34,37,77
Ayr,5445,2,24,4,8,93,43,50,76
Arbroath,5445,3,17,9,10,72,50,22,60
Alloa,5445,4,17,8,11,58,46,12,59
Stranraer,5445,5,16,5,15,57,65,-8,53
East Fife,5445,6,13,3,20,48,66,-18,42
Airdrieon,5445,7,10,11,15,46,60,-14,41
Forfar,5445,8,11,5,20,40,65,-25,38
Albion,5445,9,8,6,22,58,81,-23,30
Queen's Park,5445,10,6,11,19,41,74,-33,29
Ayr,5446,1,24,4,8,96,43,53,76
Raith,5446,2,22,8,6,69,35,34,74
Alloa,5446,3,18,8,10,59,44,15,62
Arbroath,5446,4,17,9,10,71,49,22,60
Stranraer,5446,5,15,5,16,57,67,-10,50
East Fife,5446,6,14,3,19,50,66,-16,45
Airdrieon,5446,7,10,12,14,46,59,-13,42
Forfar,5446,8,10,6,20,39,65,-26,36
Albion,5446,9,8,6,22,58,84,-26,30
Queen's Park,5446,10,6,11,19,40,73,-33,29
Ayr,5447,1,23,5,8,91,43,48,74
Raith,5447,2,22,8,6,68,33,35,74
Arbroath,5447,3,18,8,10,76,50,26,62
Alloa,5447,4,18,8,10,57,43,14,62
Stranraer,5447,5,15,5,16,56,66,-10,50
East Fife,5447,6,14,3,19,49,65,-16,45
Airdrieon,5447,7,11,11,14,48,59,-11,44
Forfar,5447,8,10,5,21,39,67,-28,35
Albion,5447,9,8,7,21,58,79,-21,31
Queen's Park,5447,10,6,10,20,41,78,-37,28
Raith,5448,1,23,8,5,69,32,37,77
Ayr,5448,2,23,4,9,92,45,47,73
Arbroath,5448,3,17,8,11,71,50,21,59
Alloa,5448,4,17,8,11,56,44,12,59
Stranraer,5448,5,16,5,15,57,65,-8,53
East Fife,5448,6,13,3,20,48,66,-18,42
Airdrieon,5448,7,10,11,15,46,61,-15,41
Forfar,5448,8,11,5,20,41,65,-24,38
Albion,5448,9,9,6,21,60,80,-20,33
Queen's Park,5448,10,7,10,19,41,73,-32,31
Raith,5449,1,23,8,5,69,32,37,77
Ayr,5449,2,24,4,8,99,43,56,76
Arbroath,5449,3,18,8,10,73,50,23,62
Alloa,5449,4,17,8,11,56,44,12,59
Stranraer,5449,5,15,5,16,55,66,-11,50
East Fife,5449,6,14,3,19,49,64,-15,45
Airdrieon,5449,7,11,11,14,49,60,-11,44
Forfar,5449,8,10,5,21,40,68,-28,35
Albion,5449,9,8,6,22,58,87,-29,30
Queen's Park,5449,10,6,10,20,41,75,-34,28
Raith,5450,1,23,8,5,71,34,37,77
Ayr,5450,2,24,4,8,95,44,51,76
Arbroath,5450,3,17,8,11,70,50,20,59
Alloa,5450,4,17,8,11,58,46,12,59
Stranraer,5450,5,16,5,15,58,65,-7,53
Airdrieon,5450,6,11,11,14,46,58,-12,44
East Fife,5450,7,13,3,20,48,67,-19,42
Forfar,5450,8,10,5,21,38,65,-27,35
Queen's Park,5450,9,7,10,19,41,72,-31,31
Albion,5450,10,8,6,22,59,83,-24,30
Raith,5451,1,23,8,5,70,33,37,77
Ayr,5451,2,24,4,8,96,42,54,76
Arbroath,5451,3,17,8,11,71,51,20,59
Alloa,5451,4,17,8,11,57,45,12,59
Stranraer,5451,5,15,5,16,56,67,-11,50
East Fife,5451,6,14,3,19,50,65,-15,45
Airdrieon,5451,7,11,11,14,50,62,-12,44
Forfar,5451,8,10,5,21,42,69,-27,35
Queen's Park,5451,9,7,10,19,42,73,-31,31
Albion,5451,10,8,6,22,57,84,-27,30
Ayr,5452,1,24,4,8,96,44,52,76
Raith,5452,2,22,8,6,68,33,35,74
Arbroath,5452,3,18,8,10,71,48,23,62
Alloa,5452,4,18,8,10,57,43,14,62
Stranraer,5452,5,16,5,15,59,65,-6,53
Airdrieon,5452,6,10,12,14,45,58,-13,42
East Fife,5452,7,13,3,20,48,68,-20,42
Forfar,5452,8,10,6,20,38,64,-26,36
Albion,5452,9,8,6,22,59,84,-25,30
Queen's Park,5452,10,6,10,20,39,73,-34,28
Ayr,5453,1,24,4,8,94,43,51,76
Raith,5453,2,22,8,6,68,34,34,74
Arbroath,5453,3,18,8,10,72,48,24,62
Alloa,5453,4,18,8,10,58,43,15,62
Stranraer,5453,5,16,5,15,59,66,-7,53
Airdrieon,5453,6,11,11,14,48,60,-12,44
East Fife,5453,7,13,3,20,49,68,-19,42
Forfar,5453,8,10,5,21,40,67,-27,35
Albion,5453,9,8,6,22,58,82,-24,30
Queen's Park,5453,10,6,10,20,39,74,-35,28
Raith,5454,1,23,8,5,72,34,38,77
Ayr,5454,2,24,4,8,94,43,51,76
Arbroath,5454,3,18,8,10,74,49,25,62
Alloa,5454,4,17,8,11,58,47,11,59
Stranraer,5454,5,15,6,15,56,65,-9,51
Airdrieon,5454,6,11,11,14,48,60,-12,44
East Fife,5454,7,13,4,19,48,65,-17,43
Forfar,5454,8,10,5,21,40,67,-27,35
Albion,5454,9,8,6,22,58,82,-24,30
Queen's Park,5454,10,6,10,20,40,76,-36,28
Raith,5455,1,23,8,5,70,32,38,77
Ayr,5455,2,24,4,8,94,43,51,76
Arbroath,5455,3,17,9,10,72,50,22,60
Alloa,5455,4,17,8,11,56,45,11,59
Stranraer,5455,5,15,6,15,55,64,-9,51
East Fife,5455,6,13,4,19,47,64,-17,43
Airdrieon,5455,7,10,11,15,45,59,-14,41
Forfar,5455,8,11,5,20,39,64,-25,38
Albion,5455,9,8,6,22,58,82,-24,30
Queen's Park,5455,10,6,11,19,41,74,-33,29
Raith,5456,1,23,8,5,69,32,37,77
Ayr,5456,2,23,5,8,92,44,48,74
Arbroath,5456,3,18,8,10,73,50,23,62
Alloa,5456,4,17,8,11,56,44,12,59
Stranraer,5456,5,15,5,16,56,66,-10,50
East Fife,5456,6,14,3,19,49,65,-16,45
Airdrieon,5456,7,11,11,14,48,59,-11,44
Forfar,5456,8,10,5,21,39,67,-28,35
Albion,5456,9,8,7,21,59,80,-21,31
Queen's Park,5456,10,6,10,20,41,75,-34,28
Raith,5457,1,22,9,5,69,33,36,75
Ayr,5457,2,23,4,9,92,45,47,73
Arbroath,5457,3,18,8,10,75,50,25,62
Alloa,5457,4,17,9,10,57,44,13,60
Stranraer,5457,5,15,5,16,56,67,-11,50
East Fife,5457,6,14,3,19,50,65,-15,45
Airdrieon,5457,7,11,11,14,49,59,-10,44
Forfar,5457,8,10,5,21,39,68,-29,35
Albion,5457,9,9,6,21,60,80,-20,33
Queen's Park,5457,10,6,10,20,41,77,-36,28
Ayr,5458,1,24,4,8,94,42,52,76
Raith,5458,2,22,9,5,70,34,36,75
Arbroath,5458,3,18,8,10,76,49,27,62
Alloa,5458,4,17,9,10,58,45,13,60
Stranraer,5458,5,15,5,16,56,66,-10,50
East Fife,5458,6,14,3,19,49,65,-16,45
Airdrieon,5458,7,11,11,14,47,58,-11,44
Forfar,5458,8,10,5,21,38,66,-28,35
Albion,5458,9,8,6,22,57,82,-25,30
Queen's Park,5458,10,6,10,20,40,78,-38,28
Raith,5459,1,23,8,5,71,32,39,77
Ayr,5459,2,24,4,8,98,44,54,76
Arbroath,5459,3,17,9,10,71,49,22,60
Alloa,5459,4,17,8,11,56,46,10,59
Stranraer,5459,5,15,5,16,56,66,-10,50
East Fife,5459,6,14,3,19,49,65,-16,45
Airdrieon,5459,7,10,11,15,45,60,-15,41
Forfar,5459,8,11,5,20,40,64,-24,38
Albion,5459,9,8,6,22,59,86,-27,30
Queen's Park,5459,10,6,11,19,40,73,-33,29
Ayr,5460,1,24,4,8,94,45,49,76
Raith,5460,2,22,9,5,69,33,36,75
Arbroath,5460,3,18,8,10,73,49,24,62
Alloa,5460,4,17,9,10,57,44,13,60
Stranraer,5460,5,15,6,15,56,65,-9,51
Airdrieon,5460,6,11,11,14,48,60,-12,44
East Fife,5460,7,13,4,19,48,65,-17,43
Forfar,5460,8,10,5,21,40,67,-27,35
Albion,5460,9,8,6,22,60,82,-22,30
Queen's Park,5460,10,6,10,20,40,75,-35,28
Raith,5461,1,23,8,5,74,32,42,77
Ayr,5461,2,23,4,9,90,44,46,73
Arbroath,5461,3,18,8,10,73,48,25,62
Alloa,5461,4,17,8,11,56,49,7,59
Stranraer,5461,5,15,5,16,56,66,-10,50
East Fife,5461,6,14,3,19,49,65,-16,45
Airdrieon,5461,7,11,11,14,47,59,-12,44
Forfar,5461,8,10,5,21,39,66,-27,35
Albion,5461,9,9,6,21,59,78,-19,33
Queen's Park,5461,10,6,10,20,39,75,-36,28
Ayr,5462,1,24,4,8,94,45,49,76
Raith,5462,2,22,8,6,69,35,34,74
Alloa,5462,3,18,8,10,59,44,15,62
Arbroath,5462,4,17,8,11,71,50,21,59
Stranraer,5462,5,16,5,15,58,65,-7,53
Airdrieon,5462,6,11,11,14,48,59,-11,44
East Fife,5462,7,13,3,20,48,67,-19,42
Forfar,5462,8,10,5,21,39,67,-28,35
Queen's Park,5462,9,7,10,19,41,73,-32,31
Albion,5462,10,8,6,22,60,82,-22,30
Ayr,5463,1,24,4,8,95,42,53,76
Raith,5463,2,22,8,6,69,34,35,74
Alloa,5463,3,18,8,10,58,44,14,62
Arbroath,5463,4,17,9,10,72,50,22,60
Stranraer,5463,5,15,5,16,56,67,-11,50
East Fife,5463,6,14,3,19,50,65,-15,45
Airdrieon,5463,7,11,11,14,46,58,-12,44
Forfar,5463,8,10,5,21,38,65,-27,35
Albion,5463,9,8,6,22,57,83,-26,30
Queen's Park,5463,10,6,11,19,41,74,-33,29
Raith,5464,1,23,8,5,71,33,38,77
Ayr,5464,2,23,4,9,91,44,47,73
Arbroath,5464,3,17,8,11,70,50,20,59
Alloa,5464,4,17,8,11,57,46,11,59
Stranraer,5464,5,16,5,15,57,65,-8,53
Airdrieon,5464,6,10,12,14,46,59,-13,42
East Fife,5464,7,13,3,20,48,66,-18,42
Forfar,5464,8,10,6,20,39,65,-26,36
Albion,5464,9,9,6,21,59,79,-20,33
Queen's Park,5464,10,7,10,19,41,72,-31,31
Ayr,5465,1,24,4,8,91,42,49,76
Raith,5465,2,22,8,6,69,34,35,74
Alloa,5465,3,18,8,10,58,44,14,62
Arbroath,5465,4,17,9,10,71,49,22,60
Stranraer,5465,5,15,5,16,55,66,-11,50
East Fife,5465,6,14,3,19,49,64,-15,45
Airdrieon,5465,7,10,12,14,46,59,-13,42
Forfar,5465,8,10,6,20,39,65,-26,36
Albion,5465,9,8,6,22,57,79,-22,30
Queen's Park,5465,10,6,11,19,40,73,-33,29
Ayr,5466,1,24,4,8,94,43,51,76
Raith,5466,2,22,8,6,69,34,35,74
Alloa,5466,3,18,8,10,58,44,14,62
Arbroath,5466,4,17,8,11,70,50,20,59
Stranraer,5466,5,15,5,16,55,67,-12,50
East Fife,5466,6,14,3,19,50,64,-14,45
Airdrieon,5466,7,11,11,14,48,59,-11,44
Forfar,5466,8,10,5,21,39,67,-28,35
Queen's Park,5466,9,7,10,19,41,72,-31,31
Albion,5466,10,8,6,22,58,82,-24,30
Raith,5467,1,23,8,5,70,32,38,77
Ayr,5467,2,24,4,8,94,43,51,76
Arbroath,5467,3,18,8,10,73,49,24,62
Alloa,5467,4,17,8,11,56,45,11,59
Stranraer,5467,5,15,5,16,56,66,-10,50
East Fife,5467,6,14,3,19,49,65,-16,45
Airdrieon,5467,7,11,11,14,46,58,-12,44
Forfar,5467,8,10,5,21,38,65,-27,35
Albion,5467,9,8,6,22,58,82,-24,30
Queen's Park,5467,10,6,10,20,40,75,-35,28
Raith,5468,1,23,8,5,72,35,37,77
Ayr,5468,2,24,4,8,94,42,52,76
Arbroath,5468,3,17,9,10,73,51,22,60
Alloa,5468,4,17,8,11,59,47,12,59
Stranraer,5468,5,15,5,16,55,67,-12,50
East Fife,5468,6,14,3,19,50,64,-14,45
Airdrieon,5468,7,10,12,14,45,58,-13,42
Forfar,5468,8,10,6,20,38,64,-26,36
Albion,5468,9,8,6,22,57,82,-25,30
Queen's Park,5468,10,6,11,19,42,75,-33,29
Ayr,5469,1,24,4,8,94,42,52,76
Raith,5469,2,22,8,6,69,34,35,74
Alloa,5469,3,18,8,10,58,44,14,62
Arbroath,5469,4,17,8,11,72,53,19,59
Stranraer,5469,5,15,6,15,56,65,-9,51
East Fife,5469,6,13,4,19,48,65,-17,43
Airdrieon,5469,7,10,12,14,47,60,-13,42
Forfar,5469,8,10,6,20,40,66,-26,36
Queen's Park,5469,9,7,10,19,44,74,-30,31
Albion,5469,10,8,6,22,57,82,-25,30
Ayr,5470,1,24,4,8,93,42,51,76
Raith,5470,2,22,9,5,69,33,36,75
Arbroath,5470,3,18,8,10,71,48,23,62
Alloa,5470,4,17,9,10,57,44,13,60
Stranraer,5470,5,15,5,16,58,68,-10,50
East Fife,5470,6,14,3,19,51,67,-16,45
Airdrieon,5470,7,10,11,15,45,61,-16,41
Forfar,5470,8,11,5,20,41,64,-23,38
Albion,5470,9,8,6,22,57,81,-24,30
Queen's Park,5470,10,6,10,20,39,73,-34,28
Raith,5471,1,23,8,5,71,32,39,77
Ayr,5471,2,24,4,8,92,42,50,76
Arbroath,5471,3,17,8,11,71,50,21,59
Alloa,5471,4,17,8,11,56,46,10,59
Stranraer,5471,5,15,5,16,56,67,-11,50
East Fife,5471,6,14,3,19,50,65,-15,45
Airdrieon,5471,7,11,11,14,47,58,-11,44
Forfar,5471,8,10,5,21,38,66,-28,35
Queen's Park,5471,9,7,10,19,41,73,-32,31
Albion,5471,10,8,6,22,57,80,-23,30
Raith,5472,1,23,8,5,70,33,37,77
Ayr,5472,2,24,4,8,93,43,50,76
Arbroath,5472,3,17,9,10,71,49,22,60
Alloa,5472,4,17,8,11,57,45,12,59
Stranraer,5472,5,15,6,15,56,65,-9,51
Airdrieon,5472,6,11,11,14,46,58,-12,44
East Fife,5472,7,13,4,19,48,65,-17,43
Forfar,5472,8,10,5,21,38,65,-27,35
Albion,5472,9,8,6,22,58,81,-23,30
Queen's Park,5472,10,6,11,19,40,73,-33,29
Ayr,5473,1,24,4,8,94,43,51,76
Raith,5473,2,22,8,6,69,34,35,74
Arbroath,5473,3,18,8,10,73,48,25,62
Alloa,5473,4,18,8,10,58,44,14,62
Stranraer,5473,5,15,5,16,56,69,-13,50
East Fife,5473,6,14,3,19,52,65,-13,45
Airdrieon,5473,7,10,12,14,46,59,-13,42
Forfar,5473,8,10,6,20,39,65,-26,36
Albion,5473,9,8,6,22,58,82,-24,30
Queen's Park,5473,10,6,10,20,39,75,-36,28
Ayr,5474,1,23,5,8,92,44,48,74
Raith,5474,2,22,8,6,69,34,35,74
Alloa,5474,3,18,8,10,58,44,14,62
Arbroath,5474,4,17,8,11,70,52,18,59
Stranraer,5474,5,16,5,15,58,64,-6,53
East Fife,5474,6,13,3,20,47,67,-20,42
Airdrieon,5474,7,10,11,15,45,59,-14,41
Forfar,5474,8,11,5,20,39,64,-25,38
Albion,5474,9,8,7,21,59,80,-21,31
Queen's Park,5474,10,7,10,19,43,72,-29,31
Raith,5475,1,23,8,5,70,32,38,77
Ayr,5475,2,24,4,8,94,43,51,76
Arbroath,5475,3,17,8,11,72,51,21,59
Alloa,5475,4,17,8,11,56,45,11,59
Stranraer,5475,5,15,5,16,55,65,-10,50
East Fife,5475,6,14,3,19,48,64,-16,45
Airdrieon,5475,7,10,12,14,47,60,-13,42
Forfar,5475,8,10,6,20,40,66,-26,36
Queen's Park,5475,9,7,10,19,42,74,-32,31
Albion,5475,10,8,6,22,58,82,-24,30
Raith,5476,1,23,8,5,69,32,37,77
Ayr,5476,2,24,4,8,92,42,50,76
Arbroath,5476,3,17,8,11,71,50,21,59
Alloa,5476,4,17,8,11,56,44,12,59
Stranraer,5476,5,15,5,16,55,65,-10,50
East Fife,5476,6,14,3,19,48,64,-16,45
Airdrieon,5476,7,11,11,14,47,59,-12,44
Forfar,5476,8,10,5,21,39,66,-27,35
Queen's Park,5476,9,7,10,19,41,73,-32,31
Albion,5476,10,8,6,22,57,80,-23,30
Raith,5477,1,22,9,5,69,33,36,75
Ayr,5477,2,23,5,8,90,42,48,74
Arbroath,5477,3,18,8,10,71,48,23,62
Alloa,5477,4,17,9,10,57,44,13,60
Stranraer,5477,5,15,5,16,55,67,-12,50
East Fife,5477,6,14,3,19,50,64,-14,45
Airdrieon,5477,7,11,11,14,47,59,-12,44
Forfar,5477,8,10,5,21,39,66,-27,35
Albion,5477,9,8,7,21,57,78,-21,31
Queen's Park,5477,10,6,10,20,39,73,-34,28
Raith,5478,1,23,8,5,69,32,37,77
Ayr,5478,2,24,4,8,98,43,55,76
Arbroath,5478,3,18,8,10,71,48,23,62
Alloa,5478,4,17,8,11,56,44,12,59
Stranraer,5478,5,16,5,15,58,65,-7,53
East Fife,5478,6,13,3,20,48,67,-19,42
Airdrieon,5478,7,10,11,15,47,61,-14,41
Forfar,5478,8,11,5,20,41,66,-25,38
Albion,5478,9,8,6,22,58,86,-28,30
Queen's Park,5478,10,6,10,20,39,73,-34,28
Ayr,5479,1,23,5,8,92,44,48,74
Raith,5479,2,22,8,6,69,36,33,74
Arbroath,5479,3,18,8,10,73,49,24,62
Alloa,5479,4,18,8,10,60,44,16,62
Stranraer,5479,5,15,6,15,55,64,-9,51
Airdrieon,5479,6,11,11,14,46,58,-12,44
East Fife,5479,7,13,4,19,47,64,-17,43
Forfar,5479,8,10,5,21,38,65,-27,35
Albion,5479,9,8,7,21,59,80,-21,31
Queen's Park,5479,10,6,10,20,40,75,-35,28
Ayr,5480,1,24,4,8,94,43,51,76
Raith,5480,2,22,9,5,69,33,36,75
Arbroath,5480,3,18,8,10,72,49,23,62
Alloa,5480,4,17,9,10,57,44,13,60
Stranraer,5480,5,15,5,16,57,67,-10,50
East Fife,5480,6,14,3,19,50,66,-16,45
Airdrieon,5480,7,11,11,14,48,59,-11,44
Forfar,5480,8,10,5,21,39,67,-28,35
Albion,5480,9,8,6,22,58,82,-24,30
Queen's Park,5480,10,6,10,20,40,74,-34,28
Raith,5481,1,23,8,5,70,32,38,77
Ayr,5481,2,23,4,9,92,45,47,73
Arbroath,5481,3,18,8,10,71,48,23,62
Alloa,5481,4,17,8,11,56,45,11,59
Stranraer,5481,5,16,5,15,57,65,-8,53
Airdrieon,5481,6,10,12,14,46,59,-13,42
East Fife,5481,7,13,3,20,48,66,-18,42
Forfar,5481,8,10,6,20,39,65,-26,36
Albion,5481,9,9,6,21,60,80,-20,33
Queen's Park,5481,10,6,10,20,39,73,-34,28
Raith,5482,1,23,8,5,70,32,38,77
Ayr,5482,2,24,4,8,95,43,52,76
Arbroath,5482,3,18,8,10,72,49,23,62
Alloa,5482,4,17,8,11,56,45,11,59
Stranraer,5482,5,15,5,16,56,66,-10,50
East Fife,5482,6,14,3,19,49,65,-16,45
Airdrieon,5482,7,11,11,14,48,60,-12,44
Forfar,5482,8,10,5,21,40,67,-27,35
Albion,5482,9,8,6,22,58,83,-25,30
Queen's Park,5482,10,6,10,20,40,74,-34,28
Ayr,5483,1,24,4,8,91,42,49,76
Raith,5483,2,22,8,6,69,35,34,74
Alloa,5483,3,18,8,10,59,44,15,62
Arbroath,5483,4,17,9,10,71,49,22,60
Stranraer,5483,5,15,6,15,56,65,-9,51
Airdrieon,5483,6,11,11,14,47,58,-11,44
East Fife,5483,7,13,4,19,48,65,-17,43
Forfar,5483,8,10,5,21,38,66,-28,35
Albion,5483,9,8,6,22,57,79,-22,30
Queen's Park,5483,10,6,11,19,40,73,-33,29
Raith,5484,1,22,9,5,70,34,36,75
Ayr,5484,2,23,4,9,91,45,46,73
Alloa,5484,3,17,9,10,58,45,13,60
Arbroath,5484,4,17,8,11,70,50,20,59
Stranraer,5484,5,15,5,16,56,66,-10,50
East Fife,5484,6,14,3,19,49,65,-16,45
Airdrieon,5484,7,10,12,14,46,59,-13,42
Forfar,5484,8,10,6,20,39,65,-26,36
Albion,5484,9,9,6,21,60,79,-19,33
Queen's Park,5484,10,7,10,19,41,72,-31,31
Raith,5485,1,23,8,5,69,32,37,77
Ayr,5485,2,24,4,8,96,43,53,76
Arbroath,5485,3,18,8,10,73,49,24,62
Alloa,5485,4,17,8,11,56,44,12,59
Stranraer,5485,5,15,5,16,56,67,-11,50
East Fife,5485,6,14,3,19,50,65,-15,45
Airdrieon,5485,7,11,11,14,48,60,-12,44
Forfar,5485,8,10,5,21,40,67,-27,35
Albion,5485,9,8,6,22,58,84,-26,30
Queen's Park,5485,10,6,10,20,40,75,-35,28
Raith,5486,1,23,8,5,69,32,37,77
Ayr,5486,2,24,4,8,92,43,49,76
Arbroath,5486,3,18,8,10,71,48,23,62
Alloa,5486,4,17,8,11,56,44,12,59
Stranraer,5486,5,16,5,15,58,66,-8,53
Airdrieon,5486,6,11,11,14,48,60,-12,44
East Fife,5486,7,13,3,20,49,67,-18,42
Forfar,5486,8,10,5,21,40,67,-27,35
Albion,5486,9,8,6,22,58,80,-22,30
Queen's Park,5486,10,6,10,20,39,73,-34,28
Ayr,5487,1,24,4,8,95,43,52,76
Raith,5487,2,22,8,6,69,34,35,74
Arbroath,5487,3,18,8,10,72,48,24,62
Alloa,5487,4,18,8,10,58,44,14,62
Stranraer,5487,5,15,6,15,57,66,-9,51
East Fife,5487,6,13,4,19,49,66,-17,43
Airdrieon,5487,7,10,12,14,47,60,-13,42
Forfar,5487,8,10,6,20,40,66,-26,36
Albion,5487,9,8,6,22,58,83,-25,30
Queen's Park,5487,10,6,10,20,39,74,-35,28
Raith,5488,1,23,8,5,69,32,37,77
Ayr,5488,2,24,4,8,95,45,50,76
Arbroath,5488,3,18,8,10,74,51,23,62
Alloa,5488,4,17,8,11,56,44,12,59
Stranraer,5488,5,16,5,15,56,64,-8,53
Airdrieon,5488,6,11,11,14,48,58,-10,44
East Fife,5488,7,13,3,20,47,65,-18,42
Forfar,5488,8,10,5,21,38,67,-29,35
Albion,5488,9,8,6,22,60,83,-23,30
Queen's Park,5488,10,6,10,20,42,76,-34,28
Ayr,5489,1,24,4,8,92,42,50,76
Raith,5489,2,22,9,5,68,32,36,75
Arbroath,5489,3,18,8,10,73,49,24,62
Alloa,5489,4,17,9,10,56,43,13,60
Stranraer,5489,5,16,5,15,56,64,-8,53
East Fife,5489,6,13,3,20,47,65,-18,42
Airdrieon,5489,7,10,11,15,48,62,-14,41
Forfar,5489,8,11,5,20,42,67,-25,38
Albion,5489,9,8,6,22,57,80,-23,30
Queen's Park,5489,10,6,10,20,40,75,-35,28
Ayr,5490,1,23,5,8,91,43,48,74
Raith,5490,2,22,8,6,68,33,35,74
Alloa,5490,3,18,8,10,57,43,14,62
Arbroath,5490,4,17,8,11,70,49,21,59
Stranraer,5490,5,15,5,16,55,66,-11,50
East Fife,5490,6,14,3,19,49,64,-15,45
Airdrieon,5490,7,10,12,14,48,61,-13,42
Forfar,5490,8,10,6,20,41,67,-26,36
Albion,5490,9,8,7,21,58,79,-21,31
Queen's Park,5490,10,7,10,19,40,72,-32,31
Raith,5491,1,23,8,5,70,32,38,77
Ayr,5491,2,24,4,8,92,43,49,76
Arbroath,5491,3,17,9,10,71,49,22,60
Alloa,5491,4,17,8,11,56,45,11,59
Stranraer,5491,5,15,6,15,56,65,-9,51
Airdrieon,5491,6,11,11,14,49,58,-9,44
East Fife,5491,7,13,4,19,48,65,-17,43
Forfar,5491,8,10,5,21,38,68,-30,35
Albion,5491,9,8,6,22,58,80,-22,30
Queen's Park,5491,10,6,11,19,40,73,-33,29
Raith,5492,1,23,8,5,70,32,38,77
Ayr,5492,2,24,4,8,92,42,50,76
Arbroath,5492,3,18,8,10,73,48,25,62
Alloa,5492,4,17,8,11,56,45,11,59
Stranraer,5492,5,15,6,15,56,65,-9,51
East Fife,5492,6,13,4,19,48,65,-17,43
Airdrieon,5492,7,10,11,15,45,59,-14,41
Forfar,5492,8,11,5,20,39,64,-25,38
Albion,5492,9,8,6,22,57,80,-23,30
Queen's Park,5492,10,6,10,20,39,75,-36,28
Raith,5493,1,23,8,5,69,32,37,77
Ayr,5493,2,23,4,9,90,44,46,73
Arbroath,5493,3,18,8,10,71,48,23,62
Alloa,5493,4,17,8,11,56,44,12,59
Stranraer,5493,5,15,5,16,56,66,-10,50
East Fife,5493,6,14,3,19,49,65,-16,45
Airdrieon,5493,7,11,11,14,46,58,-12,44
Forfar,5493,8,10,5,21,38,65,-27,35
Albion,5493,9,9,6,21,59,78,-19,33
Queen's Park,5493,10,6,10,20,39,73,-34,28
Ayr,5494,1,24,4,8,92,42,50,76
Raith,5494,2,22,9,5,69,33,36,75
Alloa,5494,3,17,9,10,57,44,13,60
Arbroath,5494,4,17,8,11,71,51,20,59
Stranraer,5494,5,16,5,15,57,64,-7,53
Airdrieon,5494,6,10,12,14,46,59,-13,42
East Fife,5494,7,13,3,20,47,66,-19,42
Forfar,5494,8,10,6,20,39,65,-26,36
Queen's Park,5494,9,7,10,19,42,73,-31,31
Albion,5494,10,8,6,22,57,80,-23,30
Raith,5495,1,23,8,5,70,33,37,77
Ayr,5495,2,24,4,8,95,43,52,76
Arbroath,5495,3,18,8,10,73,50,23,62
Alloa,5495,4,17,8,11,57,45,12,59
Stranraer,5495,5,15,5,16,55,67,-12,50
East Fife,5495,6,14,3,19,50,64,-14,45
Airdrieon,5495,7,10,11,15,46,62,-16,41
Forfar,5495,8,11,5,20,42,65,-23,38
Albion,5495,9,8,6,22,58,83,-25,30
Queen's Park,5495,10,6,10,20,41,75,-34,28
Raith,5496,1,23,8,5,70,32,38,77
Ayr,5496,2,24,4,8,94,43,51,76
Arbroath,5496,3,18,8,10,71,48,23,62
Alloa,5496,4,17,8,11,56,45,11,59
Stranraer,5496,5,16,5,15,56,64,-8,53
Airdrieon,5496,6,11,11,14,47,59,-12,44
East Fife,5496,7,13,3,20,47,65,-18,42
Forfar,5496,8,10,5,21,39,66,-27,35
Albion,5496,9,8,6,22,58,82,-24,30
Queen's Park,5496,10,6,10,20,39,73,-34,28
Raith,5497,1,23,8,5,69,32,37,77
Ayr,5497,2,24,4,8,93,44,49,76
Arbroath,5497,3,17,8,11,71,50,21,59
Alloa,5497,4,17,8,11,56,44,12,59
Stranraer,5497,5,15,6,15,56,65,-9,51
East Fife,5497,6,13,4,19,48,65,-17,43
Airdrieon,5497,7,10,11,15,47,61,-14,41
Forfar,5497,8,11,5,20,41,66,-25,38
Queen's Park,5497,9,7,10,19,41,73,-32,31
Albion,5497,10,8,6,22,59,81,-22,30
Ayr,5498,1,24,4,8,93,42,51,76
Raith,5498,2,22,9,5,69,33,36,75
Arbroath,5498,3,18,8,10,73,49,24,62
Alloa,5498,4,17,9,10,57,44,13,60
Stranraer,5498,5,15,5,16,55,65,-10,50
East Fife,5498,6,14,3,19,48,64,-16,45
Airdrieon,5498,7,11,11,14,47,59,-12,44
Forfar,5498,8,10,5,21,39,66,-27,35
Albion,5498,9,8,6,22,57,81,-24,30
Queen's Park,5498,10,6,10,20,40,75,-35,28
Ayr,5499,1,24,4,8,94,43,51,76
Raith,5499,2,22,9,5,68,32,36,75
Alloa,5499,3,17,9,10,56,43,13,60
Arbroath,5499,4,17,8,11,70,50,20,59
Stranraer,5499,5,15,5,16,55,65,-10,50
East Fife,5499,6,14,3,19,48,64,-16,45
Airdrieon,5499,7,11,11,14,47,59,-12,44
Forfar,5499,8,10,5,21,39,66,-27,35
Queen's Park,5499,9,7,10,19,41,72,-31,31
Albion,5499,10,8,6,22,58,82,-24,30
Ayr,5500,1,24,4,8,93,43,50,76
Raith,5500,2,22,9,5,69,33,36,75
Arbroath,5500,3,17,9,10,70,48,22,60
Alloa,5500,4,17,9,10,57,44,13,60
Stranraer,5500,5,15,5,16,56,66,-10,50
East Fife,5500,6,14,3,19,49,65,-16,45
Airdrieon,5500,7,11,11,14,47,58,-11,44
Forfar,5500,8,10,5,21,38,66,-28,35
Albion,5500,9,8,6,22,58,81,-23,30
Queen's Park,5500,10,6,11,19,39,72,-33,29
Raith,5501,1,23,8,5,71,32,39,77
Ayr,5501,2,24,4,8,92,43,49,76
Arbroath,5501,3,18,8,10,74,49,25,62
Alloa,5501,4,17,8,11,56,46,10,59
Stranraer,5501,5,15,5,16,56,66,-10,50
East Fife,5501,6,14,3,19,49,65,-16,45
Airdrieon,5501,7,10,12,14,45,58,-13,42
Forfar,5501,8,10,6,20,38,64,-26,36
Albion,5501,9,8,6,22,58,80,-22,30
Queen's Park,5501,10,6,10,20,40,76,-36,28
Ayr,5502,1,24,4,8,94,43,51,76
Raith,5502,2,22,9,5,68,32,36,75
Arbroath,5502,3,17,9,10,70,48,22,60
Alloa,5502,4,17,9,10,56,43,13,60
Stranraer,5502,5,16,5,15,57,65,-8,53
Airdrieon,5502,6,11,11,14,47,59,-12,44
East Fife,5502,7,13,3,20,48,66,-18,42
Forfar,5502,8,10,5,21,39,66,-27,35
Albion,5502,9,8,6,22,58,82,-24,30
Queen's Park,5502,10,6,11,19,39,72,-33,29
Ayr,5503,1,24,4,8,94,42,52,76
Raith,5503,2,22,8,6,69,34,35,74
Alloa,5503,3,18,8,10,58,44,14,62
Arbroath,5503,4,17,9,10,74,52,22,60
Stranraer,5503,5,16,5,15,57,65,-8,53
Airdrieon,5503,6,10,12,14,47,60,-13,42
East Fife,5503,7,13,3,20,48,66,-18,42
Forfar,5503,8,10,6,20,40,66,-26,36
Albion,5503,9,8,6,22,57,82,-25,30
Queen's Park,5503,10,6,11,19,43,76,-33,29
Raith,5504,1,23,8,5,73,33,40,77
Ayr,5504,2,24,4,8,92,42,50,76
Arbroath,5504,3,18,8,10,74,48,26,62
Alloa,5504,4,17,8,11,57,48,9,59
Stranraer,5504,5,15,6,15,57,66,-9,51
East Fife,5504,6,13,4,19,49,66,-17,43
Airdrieon,5504,7,10,12,14,46,59,-13,42
Forfar,5504,8,10,6,20,39,65,-26,36
Albion,5504,9,8,6,22,57,80,-23,30
Queen's Park,5504,10,6,10,20,39,76,-37,28
Ayr,5505,1,24,4,8,94,43,51,76
Raith,5505,2,22,9,5,70,34,36,75
Arbroath,5505,3,18,8,10,72,48,24,62
Alloa,5505,4,17,9,10,58,45,13,60
Stranraer,5505,5,15,6,15,56,65,-9,51
Airdrieon,5505,6,11,11,14,49,58,-9,44
East Fife,5505,7,13,4,19,48,65,-17,43
Forfar,5505,8,10,5,21,38,68,-30,35
Albion,5505,9,8,6,22,58,82,-24,30
Queen's Park,5505,10,6,10,20,39,74,-35,28
Raith,5506,1,23,8,5,70,32,38,77
Ayr,5506,2,24,4,8,92,42,50,76
Arbroath,5506,3,18,8,10,73,50,23,62
Alloa,5506,4,17,8,11,56,45,11,59
Stranraer,5506,5,15,6,15,56,65,-9,51
Airdrieon,5506,6,11,11,14,48,60,-12,44
East Fife,5506,7,13,4,19,48,65,-17,43
Forfar,5506,8,10,5,21,40,67,-27,35
Albion,5506,9,8,6,22,57,80,-23,30
Queen's Park,5506,10,6,10,20,41,75,-34,28
Ayr,5507,1,24,4,8,94,44,50,76
Raith,5507,2,22,8,6,68,33,35,74
Alloa,5507,3,18,8,10,57,43,14,62
Arbroath,5507,4,17,9,10,71,49,22,60
Stranraer,5507,5,16,5,15,57,65,-8,53
East Fife,5507,6,13,3,20,48,66,-18,42
Airdrieon,5507,7,10,11,15,45,59,-14,41
Forfar,5507,8,11,5,20,39,64,-25,38
Albion,5507,9,8,6,22,59,82,-23,30
Queen's Park,5507,10,6,11,19,40,73,-33,29
Raith,5508,1,23,8,5,71,32,39,77
Ayr,5508,2,23,4,9,91,44,47,73
Arbroath,5508,3,18,8,10,72,48,24,62
Alloa,5508,4,17,8,11,56,46,10,59
Stranraer,5508,5,15,5,16,56,66,-10,50
East Fife,5508,6,14,3,19,49,65,-16,45
Airdrieon,5508,7,11,11,14,46,58,-12,44
Forfar,5508,8,10,5,21,38,65,-27,35
Albion,5508,9,9,6,21,59,79,-20,33
Queen's Park,5508,10,6,10,20,39,74,-35,28
Raith,5509,1,22,9,5,70,34,36,75
Ayr,5509,2,23,4,9,90,45,45,73
Arbroath,5509,3,17,9,10,71,49,22,60
Alloa,5509,4,17,9,10,58,45,13,60
Stranraer,5509,5,15,5,16,57,68,-11,50
East Fife,5509,6,14,3,19,51,66,-15,45
Airdrieon,5509,7,10,11,15,45,60,-15,41
Forfar,5509,8,11,5,20,40,64,-24,38
Albion,5509,9,9,6,21,60,78,-18,33
Queen's Park,5509,10,6,11,19,40,73,-33,29
Raith,5510,1,23,8,5,71,33,38,77
Ayr,5510,2,24,4,8,95,43,52,76
Arbroath,5510,3,17,9,10,70,48,22,60
Alloa,5510,4,17,8,11,57,46,11,59
Stranraer,5510,5,15,5,16,57,67,-10,50
East Fife,5510,6,14,3,19,50,66,-16,45
Airdrieon,5510,7,10,11,15,45,59,-14,41
Forfar,5510,8,11,5,20,39,64,-25,38
Albion,5510,9,8,6,22,58,83,-25,30
Queen's Park,5510,10,6,11,19,39,72,-33,29
Raith,5511,1,23,8,5,70,33,37,77
Ayr,5511,2,23,4,9,92,45,47,73
Arbroath,5511,3,17,9,10,71,49,22,60
Alloa,5511,4,17,8,11,57,45,12,59
Stranraer,5511,5,15,5,16,55,65,-10,50
East Fife,5511,6,14,3,19,48,64,-16,45
Airdrieon,5511,7,11,11,14,47,58,-11,44
Forfar,5511,8,10,5,21,38,66,-28,35
Albion,5511,9,9,6,21,60,80,-20,33
Queen's Park,5511,10,6,11,19,40,73,-33,29
Ayr,5512,1,24,4,8,95,43,52,76
Raith,5512,2,22,8,6,69,35,34,74
Arbroath,5512,3,18,8,10,73,49,24,62
Alloa,5512,4,18,8,10,59,44,15,62
Stranraer,5512,5,16,5,15,57,65,-8,53
East Fife,5512,6,13,3,20,48,66,-18,42
Airdrieon,5512,7,10,11,15,45,59,-14,41
Forfar,5512,8,11,5,20,39,64,-25,38
Albion,5512,9,8,6,22,58,83,-25,30
Queen's Park,5512,10,6,10,20,40,75,-35,28
Ayr,5513,1,24,4,8,95,42,53,76
Raith,5513,2,22,8,6,69,35,34,74
Alloa,5513,3,18,8,10,59,44,15,62
Arbroath,5513,4,17,8,11,71,50,21,59
Stranraer,5513,5,15,6,15,58,67,-9,51
Airdrieon,5513,6,11,11,14,46,58,-12,44
East Fife,5513,7,13,4,19,50,67,-17,43
Forfar,5513,8,10,5,21,38,65,-27,35
Queen's Park,5513,9,7,10,19,41,73,-32,31
Albion,5513,10,8,6,22,57,83,-26,30
Raith,5514,1,22,9,5,69,33,36,75
Ayr,5514,2,23,4,9,90,44,46,73
Alloa,5514,3,17,9,10,57,44,13,60
Arbroath,5514,4,17,8,11,71,50,21,59
Stranraer,5514,5,16,5,15,58,64,-6,53
East Fife,5514,6,13,3,20,47,67,-20,42
Airdrieon,5514,7,10,11,15,45,59,-14,41
Forfar,5514,8,11,5,20,39,64,-25,38
Albion,5514,9,9,6,21,59,78,-19,33
Queen's Park,5514,10,7,10,19,41,73,-32,31
Raith,5515,1,23,8,5,71,34,37,77
Ayr,5515,2,24,4,8,96,45,51,76
Arbroath,5515,3,17,8,11,71,51,20,59
Alloa,5515,4,17,8,11,58,46,12,59
Stranraer,5515,5,15,5,16,55,66,-11,50
East Fife,5515,6,14,3,19,49,64,-15,45
Airdrieon,5515,7,11,11,14,48,59,-11,44
Forfar,5515,8,10,5,21,39,67,-28,35
Queen's Park,5515,9,7,10,19,42,73,-31,31
Albion,5515,10,8,6,22,60,84,-24,30
Raith,5516,1,23,8,5,69,32,37,77
Ayr,5516,2,24,4,8,91,42,49,76
Arbroath,5516,3,17,9,10,72,50,22,60
Alloa,5516,4,17,8,11,56,44,12,59
Stranraer,5516,5,16,5,15,57,64,-7,53
Airdrieon,5516,6,11,11,14,46,58,-12,44
East Fife,5516,7,13,3,20,47,66,-19,42
Forfar,5516,8,10,5,21,38,65,-27,35
Albion,5516,9,8,6,22,57,79,-22,30
Queen's Park,5516,10,6,11,19,41,74,-33,29
Ayr,5517,1,24,4,8,95,45,50,76
Raith,5517,2,22,9,5,68,32,36,75
Arbroath,5517,3,17,9,10,72,50,22,60
Alloa,5517,4,17,9,10,56,43,13,60
Stranraer,5517,5,15,6,15,58,67,-9,51
Airdrieon,5517,6,11,11,14,47,59,-12,44
East Fife,5517,7,13,4,19,50,67,-17,43
Forfar,5517,8,10,5,21,39,66,-27,35
Albion,5517,9,8,6,22,60,83,-23,30
Queen's Park,5517,10,6,11,19,41,74,-33,29
Raith,5518,1,23,8,5,69,32,37,77
Ayr,5518,2,24,4,8,92,42,50,76
Arbroath,5518,3,17,8,11,70,49,21,59
Alloa,5518,4,17,8,11,56,44,12,59
Stranraer,5518,5,15,5,16,55,65,-10,50
East Fife,5518,6,14,3,19,48,64,-16,45
Airdrieon,5518,7,10,12,14,46,59,-13,42
Forfar,5518,8,10,6,20,39,65,-26,36
Queen's Park,5518,9,7,10,19,40,72,-32,31
Albion,5518,10,8,6,22,57,80,-23,30
Raith,5519,1,23,8,5,69,32,37,77
Ayr,5519,2,24,4,8,94,43,51,76
Arbroath,5519,3,17,8,11,70,51,19,59
Alloa,5519,4,17,8,11,56,44,12,59
Stranraer,5519,5,15,6,15,56,65,-9,51
East Fife,5519,6,13,4,19,48,65,-17,43
Airdrieon,5519,7,10,11,15,46,60,-14,41
Forfar,5519,8,11,5,20,40,65,-25,38
Queen's Park,5519,9,7,10,19,42,72,-30,31
Albion,5519,10,8,6,22,58,82,-24,30
Raith,5520,1,23,8,5,69,32,37,77
Ayr,5520,2,24,4,8,94,44,50,76
Arbroath,5520,3,18,8,10,73,49,24,62
Alloa,5520,4,17,8,11,56,44,12,59
Stranraer,5520,5,15,6,15,57,66,-9,51
Airdrieon,5520,6,11,11,14,47,59,-12,44
East Fife,5520,7,13,4,19,49,66,-17,43
Forfar,5520,8,10,5,21,39,66,-27,35
Albion,5520,9,8,6,22,59,82,-23,30
Queen's Park,5520,10,6,10,20,40,75,-35,28
Raith,5521,1,23,8,5,72,33,39,77
Ayr,5521,2,24,4,8,92,43,49,76
Arbroath,5521,3,17,8,11,71,50,21,59
Alloa,5521,4,17,8,11,57,47,10,59
Stranraer,5521,5,15,5,16,55,65,-10,50
East Fife,5521,6,14,3,19,48,64,-16,45
Airdrieon,5521,7,10,11,15,45,60,-15,41
Forfar,5521,8,11,5,20,40,64,-24,38
Queen's Park,5521,9,7,10,19,41,73,-32,31
Albion,5521,10,8,6,22,58,80,-22,30
Ayr,5522,1,24,4,8,91,42,49,76
Raith,5522,2,22,8,6,68,33,35,74
Arbroath,5522,3,18,8,10,72,49,23,62
Alloa,5522,4,18,8,10,57,43,14,62
Stranraer,5522,5,15,5,16,55,66,-11,50
East Fife,5522,6,14,3,19,49,64,-15,45
Airdrieon,5522,7,11,11,14,46,58,-12,44
Forfar,5522,8,10,5,21,38,65,-27,35
Albion,5522,9,8,6,22,57,79,-22,30
Queen's Park,5522,10,6,10,20,40,74,-34,28
Raith,5523,1,23,8,5,69,32,37,77
Ayr,5523,2,24,4,8,93,44,49,76
Arbroath,5523,3,18,8,10,71,48,23,62
Alloa,5523,4,17,8,11,56,44,12,59
Stranraer,5523,5,16,5,15,60,66,-6,53
Airdrieon,5523,6,11,11,14,46,58,-12,44
East Fife,5523,7,13,3,20,49,69,-20,42
Forfar,5523,8,10,5,21,38,65,-27,35
Albion,5523,9,8,6,22,59,81,-22,30
Queen's Park,5523,10,6,10,20,39,73,-34,28
Raith,5524,1,23,8,5,71,33,38,77
Ayr,5524,2,24,4,8,92,42,50,76
Arbroath,5524,3,17,9,10,70,48,22,60
Alloa,5524,4,17,8,11,57,46,11,59
Stranraer,5524,5,16,5,15,56,64,-8,53
Airdrieon,5524,6,11,11,14,48,60,-12,44
East Fife,5524,7,13,3,20,47,65,-18,42
Forfar,5524,8,10,5,21,40,67,-27,35
Albion,5524,9,8,6,22,57,80,-23,30
Queen's Park,5524,10,6,11,19,39,72,-33,29
Raith,5525,1,23,8,5,70,33,37,77
Ayr,5525,2,24,4,8,93,43,50,76
Arbroath,5525,3,18,8,10,71,48,23,62
Alloa,5525,4,17,8,11,57,45,12,59
Stranraer,5525,5,15,5,16,56,67,-11,50
East Fife,5525,6,14,3,19,50,65,-15,45
Airdrieon,5525,7,10,11,15,46,60,-14,41
Forfar,5525,8,11,5,20,40,65,-25,38
Albion,5525,9,8,6,22,58,81,-23,30
Queen's Park,5525,10,6,10,20,39,73,-34,28
Raith,5526,1,23,8,5,69,32,37,77
Ayr,5526,2,24,4,8,94,43,51,76
Arbroath,5526,3,18,8,10,75,50,25,62
Alloa,5526,4,17,8,11,56,44,12,59
Stranraer,5526,5,15,5,16,58,69,-11,50
East Fife,5526,6,14,3,19,52,67,-15,45
Airdrieon,5526,7,11,11,14,48,58,-10,44
Forfar,5526,8,10,5,21,38,67,-29,35
Albion,5526,9,8,6,22,58,82,-24,30
Queen's Park,5526,10,6,10,20,41,77,-36,28
Raith,5527,1,23,8,5,69,32,37,77
Ayr,5527,2,23,4,9,90,43,47,73
Arbroath,5527,3,18,8,10,72,49,23,62
Alloa,5527,4,17,8,11,56,44,12,59
Stranraer,5527,5,15,6,15,57,66,-9,51
Airdrieon,5527,6,11,11,14,51,58,-7,44
East Fife,5527,7,13,4,19,49,66,-17,43
Forfar,5527,8,10,5,21,38,70,-32,35
Albion,5527,9,9,6,21,58,78,-20,33
Queen's Park,5527,10,6,10,20,40,74,-34,28
Raith,5528,1,23,8,5,71,32,39,77
Ayr,5528,2,24,4,8,96,42,54,76
Arbroath,5528,3,17,8,11,70,49,21,59
Alloa,5528,4,17,8,11,56,46,10,59
Stranraer,5528,5,15,5,16,55,65,-10,50
East Fife,5528,6,14,3,19,48,64,-16,45
Airdrieon,5528,7,10,12,14,45,58,-13,42
Forfar,5528,8,10,6,20,38,64,-26,36
Queen's Park,5528,9,7,10,19,40,72,-32,31
Albion,5528,10,8,6,22,57,84,-27,30
Raith,5529,1,23,8,5,71,33,38,77
Ayr,5529,2,23,4,9,93,46,47,73
Arbroath,5529,3,17,8,11,70,52,18,59
Alloa,5529,4,17,8,11,57,46,11,59
Stranraer,5529,5,15,5,16,57,71,-14,50
East Fife,5529,6,14,3,19,54,66,-12,45
Airdrieon,5529,7,10,11,15,46,60,-14,41
Forfar,5529,8,11,5,20,40,65,-25,38
Albion,5529,9,9,6,21,61,81,-20,33
Queen's Park,5529,10,7,10,19,43,72,-29,31
Ayr,5530,1,24,4,8,102,46,56,76
Raith,5530,2,22,9,5,69,33,36,75
Alloa,5530,3,17,9,10,57,44,13,60
Arbroath,5530,4,17,8,11,71,50,21,59
Stranraer,5530,5,15,5,16,56,66,-10,50
East Fife,5530,6,14,3,19,49,65,-16,45
Airdrieon,5530,7,11,11,14,50,61,-11,44
Forfar,5530,8,10,5,21,41,69,-28,35
Queen's Park,5530,9,7,10,19,41,73,-32,31
Albion,5530,10,8,6,22,61,90,-29,30
Raith,5531,1,22,8,6,68,33,35,74
Ayr,5531,2,23,4,9,92,46,46,73
Arbroath,5531,3,18,8,10,73,50,23,62
Alloa,5531,4,18,8,10,57,43,14,62
Stranraer,5531,5,15,5,16,56,68,-12,50
East Fife,5531,6,14,3,19,51,65,-14,45
Airdrieon,5531,7,10,12,14,46,59,-13,42
Forfar,5531,8,10,6,20,39,65,-26,36
Albion,5531,9,9,6,21,61,80,-19,33
Queen's Park,5531,10,6,10,20,41,75,-34,28
Raith,5532,1,23,8,5,70,33,37,77
Ayr,5532,2,24,4,8,92,42,50,76
Arbroath,5532,3,17,9,10,73,51,22,60
Alloa,5532,4,17,8,11,57,45,12,59
Stranraer,5532,5,15,5,16,55,68,-13,50
East Fife,5532,6,14,3,19,51,64,-13,45
Airdrieon,5532,7,11,11,14,47,58,-11,44
Forfar,5532,8,10,5,21,38,66,-28,35
Albion,5532,9,8,6,22,57,80,-23,30
Queen's Park,5532,10,6,11,19,42,75,-33,29
Raith,5533,1,23,8,5,71,33,38,77
Ayr,5533,2,23,5,8,91,43,48,74
Arbroath,5533,3,18,8,10,71,48,23,62
Alloa,5533,4,17,8,11,57,46,11,59
Stranraer,5533,5,15,5,16,55,67,-12,50
East Fife,5533,6,14,3,19,50,64,-14,45
Airdrieon,5533,7,11,11,14,48,58,-10,44
Forfar,5533,8,10,5,21,38,67,-29,35
Albion,5533,9,8,7,21,58,79,-21,31
Queen's Park,5533,10,6,10,20,39,73,-34,28
Ayr,5534,1,24,4,8,95,42,53,76
Raith,5534,2,22,9,5,70,34,36,75
Arbroath,5534,3,18,8,10,71,48,23,62
Alloa,5534,4,17,9,10,58,45,13,60
Stranraer,5534,5,15,5,16,55,66,-11,50
East Fife,5534,6,14,3,19,49,64,-15,45
Airdrieon,5534,7,10,12,14,47,60,-13,42
Forfar,5534,8,10,6,20,40,66,-26,36
Albion,5534,9,8,6,22,57,83,-26,30
Queen's Park,5534,10,6,10,20,39,73,-34,28
Raith,5535,1,23,8,5,72,33,39,77
Ayr,5535,2,24,4,8,95,42,53,76
Arbroath,5535,3,18,8,10,74,49,25,62
Alloa,5535,4,17,8,11,57,47,10,59
Stranraer,5535,5,15,5,16,56,66,-10,50
East Fife,5535,6,14,3,19,49,65,-16,45
Airdrieon,5535,7,10,11,15,45,61,-16,41
Forfar,5535,8,11,5,20,41,64,-23,38
Albion,5535,9,8,6,22,57,83,-26,30
Queen's Park,5535,10,6,10,20,40,76,-36,28
Raith,5536,1,23,8,5,70,32,38,77
Ayr,5536,2,24,4,8,94,44,50,76
Arbroath,5536,3,17,8,11,72,51,21,59
Alloa,5536,4,17,8,11,56,45,11,59
Stranraer,5536,5,15,5,16,55,66,-11,50
East Fife,5536,6,14,3,19,49,64,-15,45
Airdrieon,5536,7,11,11,14,49,59,-10,44
Forfar,5536,8,10,5,21,39,68,-29,35
Queen's Park,5536,9,7,10,19,42,74,-32,31
Albion,5536,10,8,6,22,59,82,-23,30
Ayr,5537,1,24,4,8,100,44,56,76
Raith,5537,2,22,9,5,68,32,36,75
Arbroath,5537,3,18,8,10,72,49,23,62
Alloa,5537,4,17,9,10,56,43,13,60
Stranraer,5537,5,15,6,15,57,66,-9,51
East Fife,5537,6,13,4,19,49,66,-17,43
Airdrieon,5537,7,10,11,15,46,60,-14,41
Forfar,5537,8,11,5,20,40,65,-25,38
Albion,5537,9,8,6,22,59,88,-29,30
Queen's Park,5537,10,6,10,20,40,74,-34,28
Ayr,5538,1,24,4,8,95,42,53,76
Raith,5538,2,22,9,5,69,33,36,75
Arbroath,5538,3,18,8,10,72,49,23,62
Alloa,5538,4,17,9,10,57,44,13,60
Stranraer,5538,5,15,5,16,57,67,-10,50
East Fife,5538,6,14,3,19,50,66,-16,45
Airdrieon,5538,7,11,11,14,48,60,-12,44
Forfar,5538,8,10,5,21,40,67,-27,35
Albion,5538,9,8,6,22,57,83,-26,30
Queen's Park,5538,10,6,10,20,40,74,-34,28
Ayr,5539,1,24,4,8,95,43,52,76
Raith,5539,2,22,9,5,68,32,36,75
Arbroath,5539,3,17,9,10,72,50,22,60
Alloa,5539,4,17,9,10,56,43,13,60
Stranraer,5539,5,15,5,16,55,66,-11,50
East Fife,5539,6,14,3,19,49,64,-15,45
Airdrieon,5539,7,11,11,14,47,58,-11,44
Forfar,5539,8,10,5,21,38,66,-28,35
Albion,5539,9,8,6,22,58,83,-25,30
Queen's Park,5539,10,6,11,19,41,74,-33,29
Raith,5540,1,23,8,5,69,32,37,77
Ayr,5540,2,24,4,8,95,43,52,76
Arbroath,5540,3,17,9,10,72,50,22,60
Alloa,5540,4,17,8,11,56,44,12,59
Stranraer,5540,5,15,5,16,55,66,-11,50
East Fife,5540,6,14,3,19,49,64,-15,45
Airdrieon,5540,7,10,11,15,46,60,-14,41
Forfar,5540,8,11,5,20,40,65,-25,38
Albion,5540,9,8,6,22,58,83,-25,30
Queen's Park,5540,10,6,11,19,41,74,-33,29
Raith,5541,1,23,8,5,71,33,38,77
Ayr,5541,2,24,4,8,93,43,50,76
Arbroath,5541,3,18,8,10,71,48,23,62
Alloa,5541,4,17,8,11,57,46,11,59
Stranraer,5541,5,15,5,16,55,65,-10,50
East Fife,5541,6,14,3,19,48,64,-16,45
Airdrieon,5541,7,10,12,14,46,59,-13,42
Forfar,5541,8,10,6,20,39,65,-26,36
Albion,5541,9,8,6,22,58,81,-23,30
Queen's Park,5541,10,6,10,20,39,73,-34,28
Raith,5542,1,23,8,5,70,32,38,77
Ayr,5542,2,23,5,8,90,42,48,74
Arbroath,5542,3,17,8,11,70,49,21,59
Alloa,5542,4,17,8,11,56,45,11,59
Stranraer,5542,5,15,5,16,56,66,-10,50
East Fife,5542,6,14,3,19,49,65,-16,45
Airdrieon,5542,7,10,11,15,45,59,-14,41
Forfar,5542,8,11,5,20,39,64,-25,38
Albion,5542,9,8,7,21,57,78,-21,31
Queen's Park,5542,10,7,10,19,40,72,-32,31
Ayr,5543,1,24,4,8,92,42,50,76
Raith,5543,2,22,8,6,68,37,31,74
Alloa,5543,3,18,8,10,61,43,18,62
Arbroath,5543,4,17,8,11,72,53,19,59
Stranraer,5543,5,15,5,16,56,66,-10,50
East Fife,5543,6,14,3,19,49,65,-16,45
Airdrieon,5543,7,10,12,14,47,60,-13,42
Forfar,5543,8,10,6,20,40,66,-26,36
Queen's Park,5543,9,7,10,19,44,74,-30,31
Albion,5543,10,8,6,22,57,80,-23,30
Ayr,5544,1,24,4,8,92,42,50,76
Raith,5544,2,22,9,5,69,33,36,75
Arbroath,5544,3,17,9,10,71,49,22,60
Alloa,5544,4,17,9,10,57,44,13,60
Stranraer,5544,5,16,5,15,58,65,-7,53
Airdrieon,5544,6,11,11,14,46,58,-12,44
East Fife,5544,7,13,3,20,48,67,-19,42
Forfar,5544,8,10,5,21,38,65,-27,35
Albion,5544,9,8,6,22,57,80,-23,30
Queen's Park,5544,10,6,11,19,40,73,-33,29
Raith,5545,1,22,9,5,70,34,36,75
Ayr,5545,2,23,5,8,91,43,48,74
Arbroath,5545,3,18,8,10,72,49,23,62
Alloa,5545,4,17,9,10,58,45,13,60
Stranraer,5545,5,15,6,15,57,66,-9,51
Airdrieon,5545,6,11,11,14,49,58,-9,44
East Fife,5545,7,13,4,19,49,66,-17,43
Forfar,5545,8,10,5,21,38,68,-30,35
Albion,5545,9,8,7,21,58,79,-21,31
Queen's Park,5545,10,6,10,20,40,74,-34,28
Raith,5546,1,23,8,5,70,33,37,77
Ayr,5546,2,24,4,8,94,45,49,76
Arbroath,5546,3,18,8,10,72,49,23,62
Alloa,5546,4,17,8,11,57,45,12,59
Stranraer,5546,5,15,5,16,56,67,-11,50
East Fife,5546,6,14,3,19,50,65,-15,45
Airdrieon,5546,7,11,11,14,48,60,-12,44
Forfar,5546,8,10,5,21,40,67,-27,35
Albion,5546,9,8,6,22,60,82,-22,30
Queen's Park,5546,10,6,10,20,40,74,-34,28
Raith,5547,1,22,9,5,69,33,36,75
Ayr,5547,2,23,4,9,92,46,46,73
Arbroath,5547,3,18,8,10,73,50,23,62
Alloa,5547,4,17,9,10,57,44,13,60
Stranraer,5547,5,15,6,15,55,64,-9,51
East Fife,5547,6,13,4,19,47,64,-17,43
Airdrieon,5547,7,10,12,14,45,58,-13,42
Forfar,5547,8,10,6,20,38,64,-26,36
Albion,5547,9,9,6,21,61,80,-19,33
Queen's Park,5547,10,6,10,20,41,75,-34,28
Raith,5548,1,23,8,5,69,32,37,77
Ayr,5548,2,24,4,8,93,43,50,76
Arbroath,5548,3,17,8,11,71,50,21,59
Alloa,5548,4,17,8,11,56,44,12,59
Stranraer,5548,5,16,5,15,57,65,-8,53
Airdrieon,5548,6,11,11,14,50,61,-11,44
East Fife,5548,7,13,3,20,48,66,-18,42
Forfar,5548,8,10,5,21,41,69,-28,35
Queen's Park,5548,9,7,10,19,41,73,-32,31
Albion,5548,10,8,6,22,58,81,-23,30
Ayr,5549,1,24,4,8,96,45,51,76
Raith,5549,2,22,8,6,68,35,33,74
Arbroath,5549,3,18,8,10,74,49,25,62
Alloa,5549,4,18,8,10,59,43,16,62
Stranraer,5549,5,15,5,16,56,68,-12,50
East Fife,5549,6,14,3,19,51,65,-14,45
Airdrieon,5549,7,11,11,14,48,60,-12,44
Forfar,5549,8,10,5,21,40,67,-27,35
Albion,5549,9,8,6,22,60,84,-24,30
Queen's Park,5549,10,6,10,20,40,76,-36,28
Raith,5550,1,23,8,5,71,32,39,77
Ayr,5550,2,24,4,8,92,43,49,76
Arbroath,5550,3,17,8,11,70,50,20,59
Alloa,5550,4,17,8,11,56,46,10,59
Stranraer,5550,5,15,5,16,56,66,-10,50
East Fife,5550,6,14,3,19,49,65,-16,45
Airdrieon,5550,7,10,12,14,46,59,-13,42
Forfar,5550,8,10,6,20,39,65,-26,36
Queen's Park,5550,9,7,10,19,41,72,-31,31
Albion,5550,10,8,6,22,58,80,-22,30
Raith,5551,1,23,8,5,72,32,40,77
Ayr,5551,2,24,4,8,94,44,50,76
Arbroath,5551,3,18,8,10,73,50,23,62
Alloa,5551,4,17,8,11,56,47,9,59
Stranraer,5551,5,16,5,15,57,65,-8,53
Airdrieon,5551,6,11,11,14,47,58,-11,44
East Fife,5551,7,13,3,20,48,66,-18,42
Forfar,5551,8,10,5,21,38,66,-28,35
Albion,5551,9,8,6,22,59,82,-23,30
Queen's Park,5551,10,6,10,20,41,75,-34,28
Raith,5552,1,23,8,5,70,32,38,77
Ayr,5552,2,24,4,8,95,43,52,76
Arbroath,5552,3,17,8,11,71,52,19,59
Alloa,5552,4,17,8,11,56,45,11,59
Stranraer,5552,5,16,5,15,60,65,-5,53
Airdrieon,5552,6,10,12,14,46,59,-13,42
East Fife,5552,7,13,3,20,48,69,-21,42
Forfar,5552,8,10,6,20,39,65,-26,36
Queen's Park,5552,9,7,10,19,43,73,-30,31
Albion,5552,10,8,6,22,58,83,-25,30
Raith,5553,1,23,8,5,70,32,38,77
Ayr,5553,2,24,4,8,96,45,51,76
Arbroath,5553,3,17,9,10,71,49,22,60
Alloa,5553,4,17,8,11,56,45,11,59
Stranraer,5553,5,15,5,16,55,66,-11,50
East Fife,5553,6,14,3,19,49,64,-15,45
Airdrieon,5553,7,11,11,14,48,58,-10,44
Forfar,5553,8,10,5,21,38,67,-29,35
Albion,5553,9,8,6,22,60,84,-24,30
Queen's Park,5553,10,6,11,19,40,73,-33,29
Ayr,5554,1,24,4,8,93,44,49,76
Raith,5554,2,22,9,5,69,33,36,75
Alloa,5554,3,17,9,10,57,44,13,60
Arbroath,5554,4,17,8,11,72,52,20,59
Stranraer,5554,5,16,5,15,57,65,-8,53
Airdrieon,5554,6,11,11,14,49,60,-11,44
East Fife,5554,7,13,3,20,48,66,-18,42
Forfar,5554,8,10,5,21,40,68,-28,35
Queen's Park,5554,9,7,10,19,43,74,-31,31
Albion,5554,10,8,6,22,59,81,-22,30
Raith,5555,1,23,8,5,70,33,37,77
Ayr,5555,2,24,4,8,92,42,50,76
Arbroath,5555,3,18,8,10,73,49,24,62
Alloa,5555,4,17,8,11,57,45,12,59
Stranraer,5555,5,16,5,15,58,66,-8,53
Airdrieon,5555,6,11,11,14,46,58,-12,44
East Fife,5555,7,13,3,20,49,67,-18,42
Forfar,5555,8,10,5,21,38,65,-27,35
Albion,5555,9,8,6,22,57,80,-23,30
Queen's Park,5555,10,6,10,20,40,75,-35,28
Raith,5556,1,23,8,5,71,33,38,77
Ayr,5556,2,24,4,8,97,44,53,76
Arbroath,5556,3,18,8,10,73,49,24,62
Alloa,5556,4,17,8,11,57,46,11,59
Stranraer,5556,5,15,5,16,55,66,-11,50
East Fife,5556,6,14,3,19,49,64,-15,45
Airdrieon,5556,7,10,11,15,46,60,-14,41
Forfar,5556,8,11,5,20,40,65,-25,38
Albion,5556,9,8,6,22,59,85,-26,30
Queen's Park,5556,10,6,10,20,40,75,-35,28
Ayr,5557,1,24,4,8,94,44,50,76
Raith,5557,2,22,8,6,69,35,34,74
Arbroath,5557,3,18,8,10,73,49,24,62
Alloa,5557,4,18,8,10,59,44,15,62
Stranraer,5557,5,16,5,15,59,65,-6,53
Airdrieon,5557,6,10,12,14,46,59,-13,42
East Fife,5557,7,13,3,20,48,68,-20,42
Forfar,5557,8,10,6,20,39,65,-26,36
Albion,5557,9,8,6,22,59,82,-23,30
Queen's Park,5557,10,6,10,20,40,75,-35,28
Raith,5558,1,23,8,5,69,32,37,77
Ayr,5558,2,24,4,8,95,43,52,76
Arbroath,5558,3,18,8,10,71,48,23,62
Alloa,5558,4,17,8,11,56,44,12,59
Stranraer,5558,5,16,5,15,58,66,-8,53
Airdrieon,5558,6,11,11,14,47,58,-11,44
East Fife,5558,7,13,3,20,49,67,-18,42
Forfar,5558,8,10,5,21,38,66,-28,35
Albion,5558,9,8,6,22,58,83,-25,30
Queen's Park,5558,10,6,10,20,39,73,-34,28
Raith,5559,1,23,8,5,69,32,37,77
Ayr,5559,2,23,5,8,92,44,48,74
Arbroath,5559,3,17,9,10,71,49,22,60
Alloa,5559,4,17,8,11,56,44,12,59
Stranraer,5559,5,16,5,15,58,65,-7,53
East Fife,5559,6,13,3,20,48,67,-19,42
Airdrieon,5559,7,10,11,15,45,59,-14,41
Forfar,5559,8,11,5,20,39,64,-25,38
Albion,5559,9,8,7,21,59,80,-21,31
Queen's Park,5559,10,6,11,19,40,73,-33,29
Ayr,5560,1,24,4,8,95,42,53,76
Raith,5560,2,22,8,6,70,35,35,74
Arbroath,5560,3,18,8,10,76,50,26,62
Alloa,5560,4,18,8,10,59,45,14,62
Stranraer,5560,5,15,5,16,56,66,-10,50
East Fife,5560,6,14,3,19,49,65,-16,45
Airdrieon,5560,7,11,11,14,47,58,-11,44
Forfar,5560,8,10,5,21,38,66,-28,35
Albion,5560,9,8,6,22,57,83,-26,30
Queen's Park,5560,10,6,10,20,41,78,-37,28
Raith,5561,1,23,8,5,70,33,37,77
Ayr,5561,2,24,4,8,93,43,50,76
Arbroath,5561,3,17,8,11,70,50,20,59
Alloa,5561,4,17,8,11,57,45,12,59
Stranraer,5561,5,15,5,16,56,68,-12,50
East Fife,5561,6,14,3,19,51,65,-14,45
Airdrieon,5561,7,11,11,14,50,58,-8,44
Forfar,5561,8,10,5,21,38,69,-31,35
Queen's Park,5561,9,7,10,19,41,72,-31,31
Albion,5561,10,8,6,22,58,81,-23,30
Raith,5562,1,22,9,5,69,33,36,75
Ayr,5562,2,23,5,8,92,44,48,74
Alloa,5562,3,17,9,10,57,44,13,60
Arbroath,5562,4,17,8,11,71,50,21,59
Stranraer,5562,5,15,5,16,55,65,-10,50
East Fife,5562,6,14,3,19,48,64,-16,45
Airdrieon,5562,7,11,11,14,46,58,-12,44
Forfar,5562,8,10,5,21,38,65,-27,35
Albion,5562,9,8,7,21,59,80,-21,31
Queen's Park,5562,10,7,10,19,41,73,-32,31
Raith,5563,1,23,8,5,71,33,38,77
Ayr,5563,2,24,4,8,92,43,49,76
Arbroath,5563,3,17,9,10,72,50,22,60
Alloa,5563,4,17,8,11,57,46,11,59
Stranraer,5563,5,15,6,15,56,65,-9,51
East Fife,5563,6,13,4,19,48,65,-17,43
Airdrieon,5563,7,10,11,15,45,61,-16,41
Forfar,5563,8,11,5,20,41,64,-23,38
Albion,5563,9,8,6,22,58,80,-22,30
Queen's Park,5563,10,6,11,19,41,74,-33,29
Raith,5564,1,23,8,5,71,32,39,77
Ayr,5564,2,24,4,8,97,43,54,76
Arbroath,5564,3,17,8,11,71,52,19,59
Alloa,5564,4,17,8,11,56,46,10,59
Stranraer,5564,5,15,5,16,56,67,-11,50
East Fife,5564,6,14,3,19,50,65,-15,45
Airdrieon,5564,7,10,12,14,46,59,-13,42
Forfar,5564,8,10,6,20,39,65,-26,36
Queen's Park,5564,9,7,10,19,43,73,-30,31
Albion,5564,10,8,6,22,58,85,-27,30
Ayr,5565,1,24,4,8,94,44,50,76
Raith,5565,2,22,8,6,69,36,33,74
Arbroath,5565,3,18,8,10,75,48,27,62
Alloa,5565,4,18,8,10,60,44,16,62
Stranraer,5565,5,15,6,15,57,66,-9,51
East Fife,5565,6,13,4,19,49,66,-17,43
Airdrieon,5565,7,10,11,15,45,62,-17,41
Forfar,5565,8,11,5,20,42,64,-22,38
Albion,5565,9,8,6,22,59,82,-23,30
Queen's Park,5565,10,6,10,20,39,77,-38,28
Raith,5566,1,23,8,5,72,34,38,77
Ayr,5566,2,23,4,9,92,45,47,73
Arbroath,5566,3,17,8,11,71,50,21,59
Alloa,5566,4,17,8,11,58,47,11,59
Stranraer,5566,5,15,5,16,55,66,-11,50
East Fife,5566,6,14,3,19,49,64,-15,45
Airdrieon,5566,7,11,11,14,46,58,-12,44
Forfar,5566,8,10,5,21,38,65,-27,35
Albion,5566,9,9,6,21,60,80,-20,33
Queen's Park,5566,10,7,10,19,41,73,-32,31
Ayr,5567,1,24,4,8,94,42,52,76
Raith,5567,2,22,8,6,68,35,33,74
Alloa,5567,3,18,8,10,59,43,16,62
Arbroath,5567,4,17,9,10,72,50,22,60
Stranraer,5567,5,15,6,15,56,65,-9,51
East Fife,5567,6,13,4,19,48,65,-17,43
Airdrieon,5567,7,10,11,15,46,61,-15,41
Forfar,5567,8,11,5,20,41,65,-24,38
Albion,5567,9,8,6,22,57,82,-25,30
Queen's Park,5567,10,6,11,19,41,74,-33,29
Ayr,5568,1,24,4,8,92,43,49,76
Raith,5568,2,22,8,6,68,35,33,74
Alloa,5568,3,18,8,10,59,43,16,62
Arbroath,5568,4,17,8,11,70,50,20,59
Stranraer,5568,5,15,5,16,56,66,-10,50
East Fife,5568,6,14,3,19,49,65,-16,45
Airdrieon,5568,7,10,12,14,45,58,-13,42
Forfar,5568,8,10,6,20,38,64,-26,36
Queen's Park,5568,9,7,10,19,41,72,-31,31
Albion,5568,10,8,6,22,58,80,-22,30
Raith,5569,1,23,8,5,70,33,37,77
Ayr,5569,2,24,4,8,92,42,50,76
Arbroath,5569,3,18,8,10,73,50,23,62
Alloa,5569,4,17,8,11,57,45,12,59
Stranraer,5569,5,15,5,16,56,67,-11,50
East Fife,5569,6,14,3,19,50,65,-15,45
Airdrieon,5569,7,10,11,15,47,62,-15,41
Forfar,5569,8,11,5,20,42,66,-24,38
Albion,5569,9,8,6,22,57,80,-23,30
Queen's Park,5569,10,6,10,20,41,75,-34,28
Raith,5570,1,23,8,5,70,32,38,77
Ayr,5570,2,23,4,9,91,44,47,73
Arbroath,5570,3,18,8,10,72,48,24,62
Alloa,5570,4,17,8,11,56,45,11,59
Stranraer,5570,5,15,6,15,58,67,-9,51
Airdrieon,5570,6,11,11,14,48,59,-11,44
East Fife,5570,7,13,4,19,50,67,-17,43
Forfar,5570,8,10,5,21,39,67,-28,35
Albion,5570,9,9,6,21,59,79,-20,33
Queen's Park,5570,10,6,10,20,39,74,-35,28
Raith,5571,1,23,8,5,73,32,41,77
Ayr,5571,2,23,5,8,94,46,48,74
Arbroath,5571,3,17,9,10,72,50,22,60
Alloa,5571,4,17,8,11,56,48,8,59
Stranraer,5571,5,15,5,16,55,66,-11,50
East Fife,5571,6,14,3,19,49,64,-15,45
Airdrieon,5571,7,10,11,15,45,59,-14,41
Forfar,5571,8,11,5,20,39,64,-25,38
Albion,5571,9,8,7,21,61,82,-21,31
Queen's Park,5571,10,6,11,19,41,74,-33,29
Raith,5572,1,23,8,5,71,32,39,77
Ayr,5572,2,24,4,8,94,42,52,76
Arbroath,5572,3,18,8,10,74,49,25,62
Alloa,5572,4,17,8,11,56,46,10,59
Stranraer,5572,5,15,6,15,56,65,-9,51
East Fife,5572,6,13,4,19,48,65,-17,43
Airdrieon,5572,7,10,12,14,46,59,-13,42
Forfar,5572,8,10,6,20,39,65,-26,36
Albion,5572,9,8,6,22,57,82,-25,30
Queen's Park,5572,10,6,10,20,40,76,-36,28
Ayr,5573,1,24,4,8,91,42,49,76
Raith,5573,2,22,9,5,68,32,36,75
Arbroath,5573,3,18,8,10,73,49,24,62
Alloa,5573,4,17,9,10,56,43,13,60
Stranraer,5573,5,16,5,15,58,66,-8,53
Airdrieon,5573,6,10,12,14,46,59,-13,42
East Fife,5573,7,13,3,20,49,67,-18,42
Forfar,5573,8,10,6,20,39,65,-26,36
Albion,5573,9,8,6,22,57,79,-22,30
Queen's Park,5573,10,6,10,20,40,75,-35,28
Raith,5574,1,23,8,5,71,33,38,77
Ayr,5574,2,23,5,8,92,44,48,74
Arbroath,5574,3,18,8,10,73,50,23,62
Alloa,5574,4,17,8,11,57,46,11,59
Stranraer,5574,5,15,5,16,55,68,-13,50
East Fife,5574,6,14,3,19,51,64,-13,45
Airdrieon,5574,7,10,11,15,46,61,-15,41
Forfar,5574,8,11,5,20,41,65,-24,38
Albion,5574,9,8,7,21,59,80,-21,31
Queen's Park,5574,10,6,10,20,41,75,-34,28
Ayr,5575,1,24,4,8,92,43,49,76
Raith,5575,2,22,8,6,70,35,35,74
Arbroath,5575,3,18,8,10,73,48,25,62
Alloa,5575,4,18,8,10,59,45,14,62
Stranraer,5575,5,15,5,16,57,67,-10,50
East Fife,5575,6,14,3,19,50,66,-16,45
Airdrieon,5575,7,10,12,14,45,58,-13,42
Forfar,5575,8,10,6,20,38,64,-26,36
Albion,5575,9,8,6,22,58,80,-22,30
Queen's Park,5575,10,6,10,20,39,75,-36,28
Raith,5576,1,23,8,5,70,32,38,77
Ayr,5576,2,23,4,9,91,48,43,73
Arbroath,5576,3,18,8,10,71,48,23,62
Alloa,5576,4,17,8,11,56,45,11,59
Stranraer,5576,5,15,6,15,57,66,-9,51
East Fife,5576,6,13,4,19,49,66,-17,43
Airdrieon,5576,7,10,12,14,46,59,-13,42
Forfar,5576,8,10,6,20,39,65,-26,36
Albion,5576,9,9,6,21,63,79,-16,33
Queen's Park,5576,10,6,10,20,39,73,-34,28
Ayr,5577,1,24,4,8,92,43,49,76
Raith,5577,2,22,8,6,68,35,33,74
Arbroath,5577,3,18,8,10,74,49,25,62
Alloa,5577,4,18,8,10,59,43,16,62
Stranraer,5577,5,15,5,16,57,68,-11,50
East Fife,5577,6,14,3,19,51,66,-15,45
Airdrieon,5577,7,11,11,14,46,58,-12,44
Forfar,5577,8,10,5,21,38,65,-27,35
Albion,5577,9,8,6,22,58,80,-22,30
Queen's Park,5577,10,6,10,20,40,76,-36,28
Raith,5578,1,23,8,5,71,32,39,77
Ayr,5578,2,23,5,8,92,44,48,74
Arbroath,5578,3,17,8,11,70,49,21,59
Alloa,5578,4,17,8,11,56,46,10,59
Stranraer,5578,5,15,5,16,56,66,-10,50
East Fife,5578,6,14,3,19,49,65,-16,45
Airdrieon,5578,7,11,11,14,48,58,-10,44
Forfar,5578,8,10,5,21,38,67,-29,35
Albion,5578,9,8,7,21,59,80,-21,31
Queen's Park,5578,10,7,10,19,40,72,-32,31
Raith,5579,1,23,8,5,70,33,37,77
Ayr,5579,2,24,4,8,92,43,49,76
Arbroath,5579,3,17,8,11,71,51,20,59
Alloa,5579,4,17,8,11,57,45,12,59
Stranraer,5579,5,15,5,16,57,67,-10,50
East Fife,5579,6,14,3,19,50,66,-16,45
Airdrieon,5579,7,11,11,14,46,58,-12,44
Forfar,5579,8,10,5,21,38,65,-27,35
Queen's Park,5579,9,7,10,19,42,73,-31,31
Albion,5579,10,8,6,22,58,80,-22,30
Raith,5580,1,23,8,5,75,33,42,77
Ayr,5580,2,24,4,8,93,43,50,76
Arbroath,5580,3,18,8,10,73,48,25,62
Alloa,5580,4,17,8,11,57,50,7,59
Stranraer,5580,5,15,6,15,56,65,-9,51
Airdrieon,5580,6,11,11,14,47,58,-11,44
East Fife,5580,7,13,4,19,48,65,-17,43
Forfar,5580,8,10,5,21,38,66,-28,35
Albion,5580,9,8,6,22,58,81,-23,30
Queen's Park,5580,10,6,10,20,39,75,-36,28
Ayr,5581,1,23,5,8,92,44,48,74
Raith,5581,2,22,8,6,69,34,35,74
Arbroath,5581,3,18,8,10,73,48,25,62
Alloa,5581,4,18,8,10,58,44,14,62
Stranraer,5581,5,15,5,16,55,65,-10,50
East Fife,5581,6,14,3,19,48,64,-16,45
Airdrieon,5581,7,11,11,14,46,58,-12,44
Forfar,5581,8,10,5,21,38,65,-27,35
Albion,5581,9,8,7,21,59,80,-21,31
Queen's Park,5581,10,6,10,20,39,75,-36,28
Ayr,5582,1,24,4,8,95,42,53,76
Raith,5582,2,22,8,6,68,33,35,74
Arbroath,5582,3,18,8,10,74,50,24,62
Alloa,5582,4,18,8,10,57,43,14,62
Stranraer,5582,5,16,5,15,56,64,-8,53
East Fife,5582,6,13,3,20,47,65,-18,42
Airdrieon,5582,7,10,11,15,45,59,-14,41
Forfar,5582,8,11,5,20,39,64,-25,38
Albion,5582,9,8,6,22,57,83,-26,30
Queen's Park,5582,10,6,10,20,41,76,-35,28
Raith,5583,1,23,8,5,70,32,38,77
Ayr,5583,2,23,4,9,93,46,47,73
Arbroath,5583,3,17,8,11,70,49,21,59
Alloa,5583,4,17,8,11,56,45,11,59
Stranraer,5583,5,15,5,16,55,66,-11,50
East Fife,5583,6,14,3,19,49,64,-15,45
Airdrieon,5583,7,10,12,14,46,59,-13,42
Forfar,5583,8,10,6,20,39,65,-26,36
Albion,5583,9,9,6,21,61,81,-20,33
Queen's Park,5583,10,7,10,19,40,72,-32,31
Ayr,5584,1,24,4,8,95,42,53,76
Raith,5584,2,22,8,6,68,34,34,74
Arbroath,5584,3,18,8,10,72,49,23,62
Alloa,5584,4,18,8,10,58,43,15,62
Stranraer,5584,5,15,5,16,56,67,-11,50
East Fife,5584,6,14,3,19,50,65,-15,45
Airdrieon,5584,7,10,11,15,45,59,-14,41
Forfar,5584,8,11,5,20,39,64,-25,38
Albion,5584,9,8,6,22,57,83,-26,30
Queen's Park,5584,10,6,10,20,40,74,-34,28
Ayr,5585,1,24,4,8,96,42,54,76
Raith,5585,2,22,8,6,69,34,35,74
Alloa,5585,3,18,8,10,58,44,14,62
Arbroath,5585,4,17,9,10,71,49,22,60
Stranraer,5585,5,15,6,15,57,66,-9,51
East Fife,5585,6,13,4,19,49,66,-17,43
Airdrieon,5585,7,10,12,14,48,61,-13,42
Forfar,5585,8,10,6,20,41,67,-26,36
Albion,5585,9,8,6,22,57,84,-27,30
Queen's Park,5585,10,6,11,19,40,73,-33,29
Raith,5586,1,23,8,5,70,32,38,77
Ayr,5586,2,24,4,8,94,43,51,76
Arbroath,5586,3,17,8,11,71,50,21,59
Alloa,5586,4,17,8,11,56,45,11,59
Stranraer,5586,5,15,6,15,55,64,-9,51
Airdrieon,5586,6,11,11,14,47,58,-11,44
East Fife,5586,7,13,4,19,47,64,-17,43
Forfar,5586,8,10,5,21,38,66,-28,35
Queen's Park,5586,9,7,10,19,41,73,-32,31
Albion,5586,10,8,6,22,58,82,-24,30
Ayr,5587,1,24,4,8,95,44,51,76
Raith,5587,2,22,9,5,68,32,36,75
Arbroath,5587,3,17,9,10,72,50,22,60
Alloa,5587,4,17,9,10,56,43,13,60
Stranraer,5587,5,15,6,15,59,68,-9,51
Airdrieon,5587,6,11,11,14,48,60,-12,44
East Fife,5587,7,13,4,19,51,68,-17,43
Forfar,5587,8,10,5,21,40,67,-27,35
Albion,5587,9,8,6,22,59,83,-24,30
Queen's Park,5587,10,6,11,19,41,74,-33,29
Raith,5588,1,23,8,5,70,32,38,77
Ayr,5588,2,24,4,8,93,43,50,76
Arbroath,5588,3,18,8,10,74,51,23,62
Alloa,5588,4,17,8,11,56,45,11,59
Stranraer,5588,5,15,5,16,55,65,-10,50
East Fife,5588,6,14,3,19,48,64,-16,45
Airdrieon,5588,7,10,12,14,48,61,-13,42
Forfar,5588,8,10,6,20,41,67,-26,36
Albion,5588,9,8,6,22,58,81,-23,30
Queen's Park,5588,10,6,10,20,42,76,-34,28
Raith,5589,1,22,9,5,68,32,36,75
Ayr,5589,2,23,5,8,92,44,48,74
Arbroath,5589,3,17,9,10,70,48,22,60
Alloa,5589,4,17,9,10,56,43,13,60
Stranraer,5589,5,15,5,16,56,66,-10,50
East Fife,5589,6,14,3,19,49,65,-16,45
Airdrieon,5589,7,10,11,15,46,62,-16,41
Forfar,5589,8,11,5,20,42,65,-23,38
Albion,5589,9,8,7,21,59,80,-21,31
Queen's Park,5589,10,6,11,19,39,72,-33,29
Raith,5590,1,23,8,5,71,33,38,77
Ayr,5590,2,24,4,8,92,42,50,76
Arbroath,5590,3,18,8,10,73,48,25,62
Alloa,5590,4,17,8,11,57,46,11,59
Stranraer,5590,5,16,5,15,58,66,-8,53
Airdrieon,5590,6,11,11,14,48,60,-12,44
East Fife,5590,7,13,3,20,49,67,-18,42
Forfar,5590,8,10,5,21,40,67,-27,35
Albion,5590,9,8,6,22,57,80,-23,30
Queen's Park,5590,10,6,10,20,39,75,-36,28
Raith,5591,1,23,8,5,74,33,41,77
Ayr,5591,2,23,5,8,91,43,48,74
Arbroath,5591,3,17,9,10,72,50,22,60
Alloa,5591,4,17,8,11,57,49,8,59
Stranraer,5591,5,16,5,15,56,64,-8,53
Airdrieon,5591,6,10,12,14,46,59,-13,42
East Fife,5591,7,13,3,20,47,65,-18,42
Forfar,5591,8,10,6,20,39,65,-26,36
Albion,5591,9,8,7,21,58,79,-21,31
Queen's Park,5591,10,6,11,19,41,74,-33,29
Raith,5592,1,23,8,5,72,33,39,77
Ayr,5592,2,24,4,8,94,45,49,76
Arbroath,5592,3,17,8,11,71,51,20,59
Alloa,5592,4,17,8,11,57,47,10,59
Stranraer,5592,5,16,5,15,58,65,-7,53
Airdrieon,5592,6,11,11,14,48,59,-11,44
East Fife,5592,7,13,3,20,48,67,-19,42
Forfar,5592,8,10,5,21,39,67,-28,35
Queen's Park,5592,9,7,10,19,42,73,-31,31
Albion,5592,10,8,6,22,60,82,-22,30
Ayr,5593,1,24,4,8,92,43,49,76
Raith,5593,2,22,9,5,70,34,36,75
Arbroath,5593,3,18,8,10,73,50,23,62
Alloa,5593,4,17,9,10,58,45,13,60
Stranraer,5593,5,15,5,16,56,66,-10,50
East Fife,5593,6,14,3,19,49,65,-16,45
Airdrieon,5593,7,11,11,14,48,59,-11,44
Forfar,5593,8,10,5,21,39,67,-28,35
Albion,5593,9,8,6,22,58,80,-22,30
Queen's Park,5593,10,6,10,20,41,75,-34,28
Ayr,5594,1,24,4,8,92,43,49,76
Raith,5594,2,22,9,5,69,33,36,75
Arbroath,5594,3,18,8,10,73,49,24,62
Alloa,5594,4,17,9,10,57,44,13,60
Stranraer,5594,5,16,5,15,57,65,-8,53
East Fife,5594,6,13,3,20,48,66,-18,42
Airdrieon,5594,7,10,11,15,45,59,-14,41
Forfar,5594,8,11,5,20,39,64,-25,38
Albion,5594,9,8,6,22,58,80,-22,30
Queen's Park,5594,10,6,10,20,40,75,-35,28
Raith,5595,1,23,8,5,70,32,38,77
Ayr,5595,2,23,5,8,90,42,48,74
Arbroath,5595,3,17,9,10,71,49,22,60
Alloa,5595,4,17,8,11,56,45,11,59
Stranraer,5595,5,15,6,15,56,65,-9,51
East Fife,5595,6,13,4,19,48,65,-17,43
Airdrieon,5595,7,10,12,14,47,60,-13,42
Forfar,5595,8,10,6,20,40,66,-26,36
Albion,5595,9,8,7,21,57,78,-21,31
Queen's Park,5595,10,6,11,19,40,73,-33,29
Ayr,5596,1,24,4,8,94,42,52,76
Raith,5596,2,22,9,5,70,34,36,75
Alloa,5596,3,17,9,10,58,45,13,60
Arbroath,5596,4,17,8,11,71,50,21,59
Stranraer,5596,5,15,5,16,55,68,-13,50
East Fife,5596,6,14,3,19,51,64,-13,45
Airdrieon,5596,7,11,11,14,46,58,-12,44
Forfar,5596,8,10,5,21,38,65,-27,35
Queen's Park,5596,9,7,10,19,41,73,-32,31
Albion,5596,10,8,6,22,57,82,-25,30
Raith,5597,1,23,8,5,70,32,38,77
Ayr,5597,2,24,4,8,95,42,53,76
Arbroath,5597,3,17,9,10,71,49,22,60
Alloa,5597,4,17,8,11,56,45,11,59
Stranraer,5597,5,16,5,15,58,64,-6,53
East Fife,5597,6,13,3,20,47,67,-20,42
Airdrieon,5597,7,10,11,15,47,61,-14,41
Forfar,5597,8,11,5,20,41,66,-25,38
Albion,5597,9,8,6,22,57,83,-26,30
Queen's Park,5597,10,6,11,19,40,73,-33,29
Raith,5598,1,23,8,5,70,32,38,77
Ayr,5598,2,24,4,8,93,44,49,76
Arbroath,5598,3,17,8,11,70,49,21,59
Alloa,5598,4,17,8,11,56,45,11,59
Stranraer,5598,5,16,5,15,58,65,-7,53
Airdrieon,5598,6,11,11,14,46,58,-12,44
East Fife,5598,7,13,3,20,48,67,-19,42
Forfar,5598,8,10,5,21,38,65,-27,35
Queen's Park,5598,9,7,10,19,40,72,-32,31
Albion,5598,10,8,6,22,59,81,-22,30
Ayr,5599,1,24,4,8,92,42,50,76
Raith,5599,2,22,8,6,68,33,35,74
Arbroath,5599,3,18,8,10,74,50,24,62
Alloa,5599,4,18,8,10,57,43,14,62
Stranraer,5599,5,15,5,16,55,66,-11,50
East Fife,5599,6,14,3,19,49,64,-15,45
Airdrieon,5599,7,11,11,14,48,60,-12,44
Forfar,5599,8,10,5,21,40,67,-27,35
Albion,5599,9,8,6,22,57,80,-23,30
Queen's Park,5599,10,6,10,20,41,76,-35,28
Raith,5600,1,23,8,5,72,33,39,77
Ayr,5600,2,24,4,8,94,43,51,76
Arbroath,5600,3,18,8,10,75,50,25,62
Alloa,5600,4,17,8,11,57,47,10,59
Stranraer,5600,5,16,5,15,57,65,-8,53
Airdrieon,5600,6,11,11,14,47,58,-11,44
East Fife,5600,7,13,3,20,48,66,-18,42
Forfar,5600,8,10,5,21,38,66,-28,35
Albion,5600,9,8,6,22,58,82,-24,30
Queen's Park,5600,10,6,10,20,41,77,-36,28
Ayr,5601,1,24,4,8,93,43,50,76
Raith,5601,2,22,8,6,69,34,35,74
Alloa,5601,3,18,8,10,58,44,14,62
Arbroath,5601,4,17,8,11,72,51,21,59
Stranraer,5601,5,15,5,16,55,67,-12,50
East Fife,5601,6,14,3,19,50,64,-14,45
Airdrieon,5601,7,10,11,15,45,60,-15,41
Forfar,5601,8,11,5,20,40,64,-24,38
Queen's Park,5601,9,7,10,19,42,74,-32,31
Albion,5601,10,8,6,22,58,81,-23,30
Raith,5602,1,23,8,5,70,33,37,77
Ayr,5602,2,24,4,8,93,43,50,76
Arbroath,5602,3,18,8,10,75,48,27,62
Alloa,5602,4,17,8,11,57,45,12,59
Stranraer,5602,5,16,5,15,56,64,-8,53
Airdrieon,5602,6,10,12,14,46,59,-13,42
East Fife,5602,7,13,3,20,47,65,-18,42
Forfar,5602,8,10,6,20,39,65,-26,36
Albion,5602,9,8,6,22,58,81,-23,30
Queen's Park,5602,10,6,10,20,39,77,-38,28
Ayr,5603,1,24,4,8,92,43,49,76
Raith,5603,2,22,9,5,69,33,36,75
Arbroath,5603,3,17,9,10,72,50,22,60
Alloa,5603,4,17,9,10,57,44,13,60
Stranraer,5603,5,15,5,16,55,67,-12,50
East Fife,5603,6,14,3,19,50,64,-14,45
Airdrieon,5603,7,10,12,14,45,58,-13,42
Forfar,5603,8,10,6,20,38,64,-26,36
Albion,5603,9,8,6,22,58,80,-22,30
Queen's Park,5603,10,6,11,19,41,74,-33,29
Ayr,5604,1,23,5,8,91,43,48,74
Raith,5604,2,22,8,6,69,34,35,74
Arbroath,5604,3,18,8,10,72,49,23,62
Alloa,5604,4,18,8,10,58,44,14,62
Stranraer,5604,5,15,5,16,55,67,-12,50
East Fife,5604,6,14,3,19,50,64,-14,45
Airdrieon,5604,7,11,11,14,48,58,-10,44
Forfar,5604,8,10,5,21,38,67,-29,35
Albion,5604,9,8,7,21,58,79,-21,31
Queen's Park,5604,10,6,10,20,40,74,-34,28
Raith,5605,1,22,9,5,69,33,36,75
Ayr,5605,2,23,4,9,91,44,47,73
Alloa,5605,3,17,9,10,57,44,13,60
Arbroath,5605,4,17,8,11,71,51,20,59
Stranraer,5605,5,15,5,16,55,65,-10,50
East Fife,5605,6,14,3,19,48,64,-16,45
Airdrieon,5605,7,11,11,14,48,60,-12,44
Forfar,5605,8,10,5,21,40,67,-27,35
Albion,5605,9,9,6,21,59,79,-20,33
Queen's Park,5605,10,7,10,19,42,73,-31,31
Raith,5606,1,23,8,5,69,32,37,77
Ayr,5606,2,24,4,8,93,42,51,76
Arbroath,5606,3,17,8,11,71,52,19,59
Alloa,5606,4,17,8,11,56,44,12,59
Stranraer,5606,5,15,6,15,56,65,-9,51
Airdrieon,5606,6,11,11,14,46,58,-12,44
East Fife,5606,7,13,4,19,48,65,-17,43
Forfar,5606,8,10,5,21,38,65,-27,35
Queen's Park,5606,9,7,10,19,43,73,-30,31
Albion,5606,10,8,6,22,57,81,-24,30
Raith,5607,1,23,8,5,69,32,37,77
Ayr,5607,2,24,4,8,94,43,51,76
Arbroath,5607,3,17,8,11,71,52,19,59
Alloa,5607,4,17,8,11,56,44,12,59
Stranraer,5607,5,15,5,16,55,65,-10,50
East Fife,5607,6,14,3,19,48,64,-16,45
Airdrieon,5607,7,10,11,15,46,60,-14,41
Forfar,5607,8,11,5,20,40,65,-25,38
Queen's Park,5607,9,7,10,19,43,73,-30,31
Albion,5607,10,8,6,22,58,82,-24,30
Raith,5608,1,22,9,5,69,33,36,75
Ayr,5608,2,23,4,9,91,44,47,73
Alloa,5608,3,17,9,10,57,44,13,60
Arbroath,5608,4,17,8,11,71,50,21,59
Stranraer,5608,5,15,5,16,57,68,-11,50
East Fife,5608,6,14,3,19,51,66,-15,45
Airdrieon,5608,7,11,11,14,49,60,-11,44
Forfar,5608,8,10,5,21,40,68,-28,35
Albion,5608,9,9,6,21,59,79,-20,33
Queen's Park,5608,10,7,10,19,41,73,-32,31
Raith,5609,1,23,8,5,70,33,37,77
Ayr,5609,2,24,4,8,93,43,50,76
Arbroath,5609,3,18,8,10,72,49,23,62
Alloa,5609,4,17,8,11,57,45,12,59
Stranraer,5609,5,15,5,16,55,65,-10,50
East Fife,5609,6,14,3,19,48,64,-16,45
Airdrieon,5609,7,11,11,14,49,58,-9,44
Forfar,5609,8,10,5,21,38,68,-30,35
Albion,5609,9,8,6,22,58,81,-23,30
Queen's Park,5609,10,6,10,20,40,74,-34,28
Raith,5610,1,23,8,5,71,33,38,77
Ayr,5610,2,24,4,8,94,44,50,76
Arbroath,5610,3,17,9,10,71,49,22,60
Alloa,5610,4,17,8,11,57,46,11,59
Stranraer,5610,5,15,5,16,56,68,-12,50
East Fife,5610,6,14,3,19,51,65,-14,45
Airdrieon,5610,7,11,11,14,47,58,-11,44
Forfar,5610,8,10,5,21,38,66,-28,35
Albion,5610,9,8,6,22,59,82,-23,30
Queen's Park,5610,10,6,11,19,40,73,-33,29
Raith,5611,1,23,8,5,70,32,38,77
Ayr,5611,2,24,4,8,93,42,51,76
Arbroath,5611,3,17,8,11,70,49,21,59
Alloa,5611,4,17,8,11,56,45,11,59
Stranraer,5611,5,15,5,16,55,66,-11,50
East Fife,5611,6,14,3,19,49,64,-15,45
Airdrieon,5611,7,11,11,14,49,59,-10,44
Forfar,5611,8,10,5,21,39,68,-29,35
Queen's Park,5611,9,7,10,19,40,72,-32,31
Albion,5611,10,8,6,22,57,81,-24,30
Raith,5612,1,23,8,5,70,32,38,77
Ayr,5612,2,24,4,8,93,44,49,76
Arbroath,5612,3,18,8,10,73,49,24,62
Alloa,5612,4,17,8,11,56,45,11,59
Stranraer,5612,5,15,5,16,56,67,-11,50
East Fife,5612,6,14,3,19,50,65,-15,45
Airdrieon,5612,7,11,11,14,50,59,-9,44
Forfar,5612,8,10,5,21,39,69,-30,35
Albion,5612,9,8,6,22,59,81,-22,30
Queen's Park,5612,10,6,10,20,40,75,-35,28
Ayr,5613,1,23,5,8,92,44,48,74
Raith,5613,2,22,8,6,68,36,32,74
Alloa,5613,3,18,8,10,60,43,17,62
Arbroath,5613,4,17,8,11,71,51,20,59
Stranraer,5613,5,16,5,15,58,65,-7,53
Airdrieon,5613,6,11,11,14,46,58,-12,44
East Fife,5613,7,13,3,20,48,67,-19,42
Forfar,5613,8,10,5,21,38,65,-27,35
Albion,5613,9,8,7,21,59,80,-21,31
Queen's Park,5613,10,7,10,19,42,73,-31,31
Raith,5614,1,22,8,6,69,34,35,74
Ayr,5614,2,23,4,9,90,43,47,73
Alloa,5614,3,18,8,10,58,44,14,62
Arbroath,5614,4,17,8,11,71,51,20,59
Stranraer,5614,5,15,5,16,55,65,-10,50
East Fife,5614,6,14,3,19,48,64,-16,45
Airdrieon,5614,7,10,12,14,45,58,-13,42
Forfar,5614,8,10,6,20,38,64,-26,36
Albion,5614,9,9,6,21,58,78,-20,33
Queen's Park,5614,10,7,10,19,42,73,-31,31
Ayr,5615,1,24,4,8,95,46,49,76
Raith,5615,2,22,9,5,69,33,36,75
Arbroath,5615,3,17,9,10,70,48,22,60
Alloa,5615,4,17,9,10,57,44,13,60
Stranraer,5615,5,15,5,16,55,66,-11,50
East Fife,5615,6,14,3,19,49,64,-15,45
Airdrieon,5615,7,11,11,14,49,58,-9,44
Forfar,5615,8,10,5,21,38,68,-30,35
Albion,5615,9,8,6,22,61,83,-22,30
Queen's Park,5615,10,6,11,19,39,72,-33,29
Raith,5616,1,23,8,5,71,33,38,77
Ayr,5616,2,24,4,8,91,42,49,76
Arbroath,5616,3,17,8,11,70,51,19,59
Alloa,5616,4,17,8,11,57,46,11,59
Stranraer,5616,5,16,5,15,56,64,-8,53
Airdrieon,5616,6,11,11,14,46,58,-12,44
East Fife,5616,7,13,3,20,47,65,-18,42
Forfar,5616,8,10,5,21,38,65,-27,35
Queen's Park,5616,9,7,10,19,42,72,-30,31
Albion,5616,10,8,6,22,57,79,-22,30
Ayr,5617,1,24,4,8,92,42,50,76
Raith,5617,2,22,8,6,70,35,35,74
Arbroath,5617,3,18,8,10,73,48,25,62
Alloa,5617,4,18,8,10,59,45,14,62
Stranraer,5617,5,15,6,15,55,64,-9,51
East Fife,5617,6,13,4,19,47,64,-17,43
Airdrieon,5617,7,10,11,15,47,62,-15,41
Forfar,5617,8,11,5,20,42,66,-24,38
Albion,5617,9,8,6,22,57,80,-23,30
Queen's Park,5617,10,6,10,20,39,75,-36,28
Raith,5618,1,23,8,5,69,32,37,77
Ayr,5618,2,24,4,8,94,42,52,76
Arbroath,5618,3,17,8,11,71,50,21,59
Alloa,5618,4,17,8,11,56,44,12,59
Stranraer,5618,5,15,5,16,57,67,-10,50
East Fife,5618,6,14,3,19,50,66,-16,45
Airdrieon,5618,7,10,11,15,46,60,-14,41
Forfar,5618,8,11,5,20,40,65,-25,38
Queen's Park,5618,9,7,10,19,41,73,-32,31
Albion,5618,10,8,6,22,57,82,-25,30
Ayr,5619,1,24,4,8,94,42,52,76
Raith,5619,2,22,8,6,68,34,34,74
Alloa,5619,3,18,8,10,58,43,15,62
Arbroath,5619,4,17,8,11,70,51,19,59
Stranraer,5619,5,16,5,15,57,65,-8,53
East Fife,5619,6,13,3,20,48,66,-18,42
Airdrieon,5619,7,10,11,15,45,59,-14,41
Forfar,5619,8,11,5,20,39,64,-25,38
Queen's Park,5619,9,7,10,19,42,72,-30,31
Albion,5619,10,8,6,22,57,82,-25,30
Ayr,5620,1,24,4,8,91,42,49,76
Raith,5620,2,22,8,6,68,34,34,74
Arbroath,5620,3,18,8,10,71,48,23,62
Alloa,5620,4,18,8,10,58,43,15,62
Stranraer,5620,5,15,5,16,56,66,-10,50
East Fife,5620,6,14,3,19,49,65,-16,45
Airdrieon,5620,7,11,11,14,47,58,-11,44
Forfar,5620,8,10,5,21,38,66,-28,35
Albion,5620,9,8,6,22,57,79,-22,30
Queen's Park,5620,10,6,10,20,39,73,-34,28
Raith,5621,1,22,9,5,69,33,36,75
Ayr,5621,2,23,4,9,92,46,46,73
Arbroath,5621,3,18,8,10,74,49,25,62
Alloa,5621,4,17,9,10,57,44,13,60
Stranraer,5621,5,16,5,15,59,65,-6,53
Airdrieon,5621,6,11,11,14,47,59,-12,44
East Fife,5621,7,13,3,20,48,68,-20,42
Forfar,5621,8,10,5,21,39,66,-27,35
Albion,5621,9,9,6,21,61,80,-19,33
Queen's Park,5621,10,6,10,20,40,76,-36,28
Raith,5622,1,23,8,5,69,32,37,77
Ayr,5622,2,24,4,8,95,43,52,76
Arbroath,5622,3,17,9,10,73,51,22,60
Alloa,5622,4,17,8,11,56,44,12,59
Stranraer,5622,5,15,6,15,56,65,-9,51
East Fife,5622,6,13,4,19,48,65,-17,43
Airdrieon,5622,7,10,12,14,45,58,-13,42
Forfar,5622,8,10,6,20,38,64,-26,36
Albion,5622,9,8,6,22,58,83,-25,30
Queen's Park,5622,10,6,11,19,42,75,-33,29
Raith,5623,1,23,8,5,70,32,38,77
Ayr,5623,2,24,4,8,95,43,52,76
Arbroath,5623,3,17,8,11,70,49,21,59
Alloa,5623,4,17,8,11,56,45,11,59
Stranraer,5623,5,15,5,16,58,68,-10,50
East Fife,5623,6,14,3,19,51,67,-16,45
Airdrieon,5623,7,10,11,15,46,60,-14,41
Forfar,5623,8,11,5,20,40,65,-25,38
Queen's Park,5623,9,7,10,19,40,72,-32,31
Albion,5623,10,8,6,22,58,83,-25,30
Raith,5624,1,23,8,5,75,32,43,77
Ayr,5624,2,24,4,8,94,44,50,76
Arbroath,5624,3,17,8,11,71,51,20,59
Alloa,5624,4,17,8,11,56,50,6,59
Stranraer,5624,5,16,5,15,57,65,-8,53
Airdrieon,5624,6,11,11,14,47,59,-12,44
East Fife,5624,7,13,3,20,48,66,-18,42
Forfar,5624,8,10,5,21,39,66,-27,35
Queen's Park,5624,9,7,10,19,42,73,-31,31
Albion,5624,10,8,6,22,59,82,-23,30
Ayr,5625,1,24,4,8,97,44,53,76
Raith,5625,2,22,9,5,68,32,36,75
Alloa,5625,3,17,9,10,56,43,13,60
Arbroath,5625,4,17,8,11,72,51,21,59
Stranraer,5625,5,15,5,16,55,65,-10,50
East Fife,5625,6,14,3,19,48,64,-16,45
Airdrieon,5625,7,10,11,15,46,60,-14,41
Forfar,5625,8,11,5,20,40,65,-25,38
Queen's Park,5625,9,7,10,19,42,74,-32,31
Albion,5625,10,8,6,22,59,85,-26,30
Raith,5626,1,23,8,5,71,32,39,77
Ayr,5626,2,24,4,8,95,43,52,76
Arbroath,5626,3,17,9,10,71,49,22,60
Alloa,5626,4,17,8,11,56,46,10,59
Stranraer,5626,5,15,6,15,57,66,-9,51
East Fife,5626,6,13,4,19,49,66,-17,43
Airdrieon,5626,7,10,12,14,46,59,-13,42
Forfar,5626,8,10,6,20,39,65,-26,36
Albion,5626,9,8,6,22,58,83,-25,30
Queen's Park,5626,10,6,11,19,40,73,-33,29
Raith,5627,1,23,8,5,70,33,37,77
Ayr,5627,2,24,4,8,93,44,49,76
Arbroath,5627,3,18,8,10,72,49,23,62
Alloa,5627,4,17,8,11,57,45,12,59
Stranraer,5627,5,15,5,16,55,67,-12,50
East Fife,5627,6,14,3,19,50,64,-14,45
Airdrieon,5627,7,10,11,15,46,63,-17,41
Forfar,5627,8,11,5,20,43,65,-22,38
Albion,5627,9,8,6,22,59,81,-22,30
Queen's Park,5627,10,6,10,20,40,74,-34,28
Ayr,5628,1,24,4,8,92,43,49,76
Raith,5628,2,22,8,6,69,34,35,74
Arbroath,5628,3,18,8,10,75,49,26,62
Alloa,5628,4,18,8,10,58,44,14,62
Stranraer,5628,5,16,5,15,56,64,-8,53
East Fife,5628,6,13,3,20,47,65,-18,42
Airdrieon,5628,7,10,11,15,47,62,-15,41
Forfar,5628,8,11,5,20,42,66,-24,38
Albion,5628,9,8,6,22,58,80,-22,30
Queen's Park,5628,10,6,10,20,40,77,-37,28
Ayr,5629,1,24,4,8,93,43,50,76
Raith,5629,2,22,9,5,69,33,36,75
Arbroath,5629,3,18,8,10,73,50,23,62
Alloa,5629,4,17,9,10,57,44,13,60
Stranraer,5629,5,15,5,16,56,67,-11,50
East Fife,5629,6,14,3,19,50,65,-15,45
Airdrieon,5629,7,10,12,14,48,61,-13,42
Forfar,5629,8,10,6,20,41,67,-26,36
Albion,5629,9,8,6,22,58,81,-23,30
Queen's Park,5629,10,6,10,20,41,75,-34,28
Ayr,5630,1,24,4,8,95,42,53,76
Raith,5630,2,22,8,6,68,34,34,74
Alloa,5630,3,18,8,10,58,43,15,62
Arbroath,5630,4,17,9,10,73,51,22,60
Stranraer,5630,5,16,5,15,56,64,-8,53
Airdrieon,5630,6,11,11,14,46,58,-12,44
East Fife,5630,7,13,3,20,47,65,-18,42
Forfar,5630,8,10,5,21,38,65,-27,35
Albion,5630,9,8,6,22,57,83,-26,30
Queen's Park,5630,10,6,11,19,42,75,-33,29
Ayr,5631,1,24,4,8,95,43,52,76
Raith,5631,2,22,8,6,68,35,33,74
Alloa,5631,3,18,8,10,59,43,16,62
Arbroath,5631,4,17,8,11,71,50,21,59
Stranraer,5631,5,15,5,16,57,70,-13,50
East Fife,5631,6,14,3,19,53,66,-13,45
Airdrieon,5631,7,11,11,14,47,58,-11,44
Forfar,5631,8,10,5,21,38,66,-28,35
Queen's Park,5631,9,7,10,19,41,73,-32,31
Albion,5631,10,8,6,22,58,83,-25,30
Ayr,5632,1,24,4,8,93,42,51,76
Raith,5632,2,22,8,6,70,35,35,74
Alloa,5632,3,18,8,10,59,45,14,62
Arbroath,5632,4,17,8,11,71,51,20,59
Stranraer,5632,5,15,5,16,56,67,-11,50
East Fife,5632,6,14,3,19,50,65,-15,45
Airdrieon,5632,7,11,11,14,47,59,-12,44
Forfar,5632,8,10,5,21,39,66,-27,35
Queen's Park,5632,9,7,10,19,42,73,-31,31
Albion,5632,10,8,6,22,57,81,-24,30
Raith,5633,1,23,8,5,70,32,38,77
Ayr,5633,2,24,4,8,94,45,49,76
Arbroath,5633,3,18,8,10,71,48,23,62
Alloa,5633,4,17,8,11,56,45,11,59
Stranraer,5633,5,15,5,16,56,67,-11,50
East Fife,5633,6,14,3,19,50,65,-15,45
Airdrieon,5633,7,10,12,14,46,59,-13,42
Forfar,5633,8,10,6,20,39,65,-26,36
Albion,5633,9,8,6,22,60,82,-22,30
Queen's Park,5633,10,6,10,20,39,73,-34,28
Ayr,5634,1,24,4,8,94,42,52,76
Raith,5634,2,22,8,6,69,34,35,74
Alloa,5634,3,18,8,10,58,44,14,62
Arbroath,5634,4,17,8,11,71,50,21,59
Stranraer,5634,5,15,6,15,57,66,-9,51
Airdrieon,5634,6,11,11,14,46,58,-12,44
East Fife,5634,7,13,4,19,49,66,-17,43
Forfar,5634,8,10,5,21,38,65,-27,35
Queen's Park,5634,9,7,10,19,41,73,-32,31
Albion,5634,10,8,6,22,57,82,-25,30
Raith,5635,1,23,8,5,70,32,38,77
Ayr,5635,2,24,4,8,95,43,52,76
Arbroath,5635,3,17,8,11,70,51,19,59
Alloa,5635,4,17,8,11,56,45,11,59
Stranraer,5635,5,15,5,16,55,65,-10,50
East Fife,5635,6,14,3,19,48,64,-16,45
Airdrieon,5635,7,10,11,15,47,61,-14,41
Forfar,5635,8,11,5,20,41,66,-25,38
Queen's Park,5635,9,7,10,19,42,72,-30,31
Albion,5635,10,8,6,22,58,83,-25,30
Ayr,5636,1,24,4,8,94,44,50,76
Raith,5636,2,22,9,5,69,33,36,75
Arbroath,5636,3,18,8,10,74,49,25,62
Alloa,5636,4,17,9,10,57,44,13,60
Stranraer,5636,5,15,5,16,56,68,-12,50
East Fife,5636,6,14,3,19,51,65,-14,45
Airdrieon,5636,7,11,11,14,49,58,-9,44
Forfar,5636,8,10,5,21,38,68,-30,35
Albion,5636,9,8,6,22,59,82,-23,30
Queen's Park,5636,10,6,10,20,40,76,-36,28
Ayr,5637,1,24,4,8,96,44,52,76
Raith,5637,2,22,9,5,68,32,36,75
Arbroath,5637,3,18,8,10,72,49,23,62
Alloa,5637,4,17,9,10,56,43,13,60
Stranraer,5637,5,15,6,15,57,66,-9,51
Airdrieon,5637,6,11,11,14,47,58,-11,44
East Fife,5637,7,13,4,19,49,66,-17,43
Forfar,5637,8,10,5,21,38,66,-28,35
Albion,5637,9,8,6,22,59,84,-25,30
Queen's Park,5637,10,6,10,20,40,74,-34,28
Raith,5638,1,23,8,5,70,32,38,77
Ayr,5638,2,24,4,8,94,44,50,76
Arbroath,5638,3,17,8,11,71,50,21,59
Alloa,5638,4,17,8,11,56,45,11,59
Stranraer,5638,5,16,5,15,57,65,-8,53
Airdrieon,5638,6,11,11,14,47,58,-11,44
East Fife,5638,7,13,3,20,48,66,-18,42
Forfar,5638,8,10,5,21,38,66,-28,35
Queen's Park,5638,9,7,10,19,41,73,-32,31
Albion,5638,10,8,6,22,59,82,-23,30
Raith,5639,1,23,8,5,70,32,38,77
Ayr,5639,2,23,4,9,91,44,47,73
Arbroath,5639,3,17,8,11,70,50,20,59
Alloa,5639,4,17,8,11,56,45,11,59
Stranraer,5639,5,15,5,16,55,66,-11,50
East Fife,5639,6,14,3,19,49,64,-15,45
Airdrieon,5639,7,11,11,14,48,60,-12,44
Forfar,5639,8,10,5,21,40,67,-27,35
Albion,5639,9,9,6,21,59,79,-20,33
Queen's Park,5639,10,7,10,19,41,72,-31,31
Ayr,5640,1,24,4,8,93,44,49,76
Raith,5640,2,22,9,5,69,33,36,75
Arbroath,5640,3,18,8,10,71,48,23,62
Alloa,5640,4,17,9,10,57,44,13,60
Stranraer,5640,5,15,5,16,55,67,-12,50
East Fife,5640,6,14,3,19,50,64,-14,45
Airdrieon,5640,7,10,11,15,45,60,-15,41
Forfar,5640,8,11,5,20,40,64,-24,38
Albion,5640,9,8,6,22,59,81,-22,30
Queen's Park,5640,10,6,10,20,39,73,-34,28
Raith,5641,1,23,8,5,71,33,38,77
Ayr,5641,2,24,4,8,94,44,50,76
Arbroath,5641,3,18,8,10,72,48,24,62
Alloa,5641,4,17,8,11,57,46,11,59
Stranraer,5641,5,15,5,16,55,67,-12,50
East Fife,5641,6,14,3,19,50,64,-14,45
Airdrieon,5641,7,10,12,14,46,59,-13,42
Forfar,5641,8,10,6,20,39,65,-26,36
Albion,5641,9,8,6,22,59,82,-23,30
Queen's Park,5641,10,6,10,20,39,74,-35,28
Ayr,5642,1,24,4,8,91,42,49,76
Raith,5642,2,22,9,5,69,33,36,75
Arbroath,5642,3,18,8,10,74,51,23,62
Alloa,5642,4,17,9,10,57,44,13,60
Stranraer,5642,5,15,5,16,56,66,-10,50
East Fife,5642,6,14,3,19,49,65,-16,45
Airdrieon,5642,7,11,11,14,48,58,-10,44
Forfar,5642,8,10,5,21,38,67,-29,35
Albion,5642,9,8,6,22,57,79,-22,30
Queen's Park,5642,10,6,10,20,42,76,-34,28
Raith,5643,1,23,8,5,71,32,39,77
Ayr,5643,2,23,5,8,92,44,48,74
Arbroath,5643,3,18,8,10,71,48,23,62
Alloa,5643,4,17,8,11,56,46,10,59
Stranraer,5643,5,15,5,16,56,66,-10,50
East Fife,5643,6,14,3,19,49,65,-16,45
Airdrieon,5643,7,11,11,14,49,60,-11,44
Forfar,5643,8,10,5,21,40,68,-28,35
Albion,5643,9,8,7,21,59,80,-21,31
Queen's Park,5643,10,6,10,20,39,73,-34,28
Ayr,5644,1,24,4,8,95,44,51,76
Raith,5644,2,22,8,6,69,34,35,74
Alloa,5644,3,18,8,10,58,44,14,62
Arbroath,5644,4,17,8,11,70,50,20,59
Stranraer,5644,5,15,5,16,55,67,-12,50
East Fife,5644,6,14,3,19,50,64,-14,45
Airdrieon,5644,7,11,11,14,49,58,-9,44
Forfar,5644,8,10,5,21,38,68,-30,35
Queen's Park,5644,9,7,10,19,41,72,-31,31
Albion,5644,10,8,6,22,59,83,-24,30
Raith,5645,1,23,8,5,69,32,37,77
Ayr,5645,2,24,4,8,98,44,54,76
Arbroath,5645,3,18,8,10,75,49,26,62
Alloa,5645,4,17,8,11,56,44,12,59
Stranraer,5645,5,15,5,16,55,65,-10,50
East Fife,5645,6,14,3,19,48,64,-16,45
Airdrieon,5645,7,11,11,14,49,58,-9,44
Forfar,5645,8,10,5,21,38,68,-30,35
Albion,5645,9,8,6,22,59,86,-27,30
Queen's Park,5645,10,6,10,20,40,77,-37,28
Raith,5646,1,23,8,5,71,34,37,77
Ayr,5646,2,24,4,8,91,42,49,76
Arbroath,5646,3,18,8,10,73,49,24,62
Alloa,5646,4,17,8,11,58,46,12,59
Stranraer,5646,5,15,5,16,56,67,-11,50
East Fife,5646,6,14,3,19,50,65,-15,45
Airdrieon,5646,7,11,11,14,47,59,-12,44
Forfar,5646,8,10,5,21,39,66,-27,35
Albion,5646,9,8,6,22,57,79,-22,30
Queen's Park,5646,10,6,10,20,40,75,-35,28
Ayr,5647,1,24,4,8,96,44,52,76
Raith,5647,2,22,8,6,68,33,35,74
Arbroath,5647,3,18,8,10,74,48,26,62
Alloa,5647,4,18,8,10,57,43,14,62
Stranraer,5647,5,15,5,16,55,65,-10,50
East Fife,5647,6,14,3,19,48,64,-16,45
Airdrieon,5647,7,10,11,15,45,59,-14,41
Forfar,5647,8,11,5,20,39,64,-25,38
Albion,5647,9,8,6,22,59,84,-25,30
Queen's Park,5647,10,6,10,20,39,76,-37,28
Ayr,5648,1,24,4,8,94,42,52,76
Raith,5648,2,22,9,5,69,33,36,75
Arbroath,5648,3,18,8,10,75,51,24,62
Alloa,5648,4,17,9,10,57,44,13,60
Stranraer,5648,5,16,5,15,56,64,-8,53
Airdrieon,5648,6,11,11,14,49,58,-9,44
East Fife,5648,7,13,3,20,47,65,-18,42
Forfar,5648,8,10,5,21,38,68,-30,35
Albion,5648,9,8,6,22,57,82,-25,30
Queen's Park,5648,10,6,10,20,42,77,-35,28
Raith,5649,1,22,9,5,70,34,36,75
Ayr,5649,2,23,5,8,92,44,48,74
Arbroath,5649,3,18,8,10,73,48,25,62
Alloa,5649,4,17,9,10,58,45,13,60
Stranraer,5649,5,16,5,15,60,64,-4,53
Airdrieon,5649,6,11,11,14,48,59,-11,44
East Fife,5649,7,13,3,20,47,69,-22,42
Forfar,5649,8,10,5,21,39,67,-28,35
Albion,5649,9,8,7,21,59,80,-21,31
Queen's Park,5649,10,6,10,20,39,75,-36,28
Raith,5650,1,23,8,5,71,32,39,77
Ayr,5650,2,24,4,8,94,43,51,76
Arbroath,5650,3,18,8,10,75,50,25,62
Alloa,5650,4,17,8,11,56,46,10,59
Stranraer,5650,5,15,5,16,56,66,-10,50
East Fife,5650,6,14,3,19,49,65,-16,45
Airdrieon,5650,7,10,12,14,45,58,-13,42
Forfar,5650,8,10,6,20,38,64,-26,36
Albion,5650,9,8,6,22,58,82,-24,30
Queen's Park,5650,10,6,10,20,41,77,-36,28
Ayr,5651,1,24,4,8,100,43,57,76
Raith,5651,2,22,8,6,68,34,34,74
Alloa,5651,3,18,8,10,58,43,15,62
Arbroath,5651,4,17,9,10,71,49,22,60
Stranraer,5651,5,15,5,16,55,66,-11,50
East Fife,5651,6,14,3,19,49,64,-15,45
Airdrieon,5651,7,10,12,14,46,59,-13,42
Forfar,5651,8,10,6,20,39,65,-26,36
Albion,5651,9,8,6,22,58,88,-30,30
Queen's Park,5651,10,6,11,19,40,73,-33,29
Raith,5652,1,23,8,5,70,32,38,77
Ayr,5652,2,24,4,8,92,43,49,76
Arbroath,5652,3,17,8,11,70,50,20,59
Alloa,5652,4,17,8,11,56,45,11,59
Stranraer,5652,5,16,5,15,58,66,-8,53
Airdrieon,5652,6,11,11,14,47,58,-11,44
East Fife,5652,7,13,3,20,49,67,-18,42
Forfar,5652,8,10,5,21,38,66,-28,35
Queen's Park,5652,9,7,10,19,41,72,-31,31
Albion,5652,10,8,6,22,58,80,-22,30
Raith,5653,1,22,9,5,68,32,36,75
Ayr,5653,2,23,4,9,92,46,46,73
Alloa,5653,3,17,9,10,56,43,13,60
Arbroath,5653,4,17,8,11,71,50,21,59
Stranraer,5653,5,15,5,16,56,67,-11,50
East Fife,5653,6,14,3,19,50,65,-15,45
Airdrieon,5653,7,11,11,14,47,58,-11,44
Forfar,5653,8,10,5,21,38,66,-28,35
Albion,5653,9,9,6,21,61,80,-19,33
Queen's Park,5653,10,7,10,19,41,73,-32,31
Raith,5654,1,23,8,5,69,32,37,77
Ayr,5654,2,23,5,8,91,43,48,74
Arbroath,5654,3,18,8,10,72,49,23,62
Alloa,5654,4,17,8,11,56,44,12,59
Stranraer,5654,5,16,5,15,57,64,-7,53
Airdrieon,5654,6,11,11,14,46,58,-12,44
East Fife,5654,7,13,3,20,47,66,-19,42
Forfar,5654,8,10,5,21,38,65,-27,35
Albion,5654,9,8,7,21,58,79,-21,31
Queen's Park,5654,10,6,10,20,40,74,-34,28
Ayr,5655,1,24,4,8,95,43,52,76
Raith,5655,2,22,8,6,68,34,34,74
Arbroath,5655,3,18,8,10,72,48,24,62
Alloa,5655,4,18,8,10,58,43,15,62
Stranraer,5655,5,15,5,16,55,65,-10,50
East Fife,5655,6,14,3,19,48,64,-16,45
Airdrieon,5655,7,10,12,14,46,59,-13,42
Forfar,5655,8,10,6,20,39,65,-26,36
Albion,5655,9,8,6,22,58,83,-25,30
Queen's Park,5655,10,6,10,20,39,74,-35,28
Raith,5656,1,23,8,5,71,32,39,77
Ayr,5656,2,23,4,9,91,44,47,73
Arbroath,5656,3,18,8,10,74,51,23,62
Alloa,5656,4,17,8,11,56,46,10,59
Stranraer,5656,5,15,5,16,56,68,-12,50
East Fife,5656,6,14,3,19,51,65,-14,45
Airdrieon,5656,7,10,11,15,45,60,-15,41
Forfar,5656,8,11,5,20,40,64,-24,38
Albion,5656,9,9,6,21,59,79,-20,33
Queen's Park,5656,10,6,10,20,42,76,-34,28
Raith,5657,1,23,8,5,72,32,40,77
Ayr,5657,2,24,4,8,94,44,50,76
Arbroath,5657,3,17,8,11,70,50,20,59
Alloa,5657,4,17,8,11,56,47,9,59
Stranraer,5657,5,16,5,15,56,64,-8,53
Airdrieon,5657,6,11,11,14,47,59,-12,44
East Fife,5657,7,13,3,20,47,65,-18,42
Forfar,5657,8,10,5,21,39,66,-27,35
Queen's Park,5657,9,7,10,19,41,72,-31,31
Albion,5657,10,8,6,22,59,82,-23,30
Raith,5658,1,23,8,5,71,34,37,77
Ayr,5658,2,24,4,8,93,44,49,76
Arbroath,5658,3,17,8,11,70,49,21,59
Alloa,5658,4,17,8,11,58,46,12,59
Stranraer,5658,5,16,5,15,57,65,-8,53
Airdrieon,5658,6,11,11,14,47,59,-12,44
East Fife,5658,7,13,3,20,48,66,-18,42
Forfar,5658,8,10,5,21,39,66,-27,35
Queen's Park,5658,9,7,10,19,40,72,-32,31
Albion,5658,10,8,6,22,59,81,-22,30
Ayr,5659,1,24,4,8,92,43,49,76
Raith,5659,2,22,8,6,69,34,35,74
Alloa,5659,3,18,8,10,58,44,14,62
Arbroath,5659,4,17,8,11,70,49,21,59
Stranraer,5659,5,15,6,15,55,64,-9,51
East Fife,5659,6,13,4,19,47,64,-17,43
Airdrieon,5659,7,10,11,15,45,59,-14,41
Forfar,5659,8,11,5,20,39,64,-25,38
Queen's Park,5659,9,7,10,19,40,72,-32,31
Albion,5659,10,8,6,22,58,80,-22,30
Raith,5660,1,23,8,5,70,32,38,77
Ayr,5660,2,24,4,8,92,42,50,76
Arbroath,5660,3,18,8,10,72,48,24,62
Alloa,5660,4,17,8,11,56,45,11,59
Stranraer,5660,5,15,5,16,55,66,-11,50
East Fife,5660,6,14,3,19,49,64,-15,45
Airdrieon,5660,7,10,11,15,45,59,-14,41
Forfar,5660,8,11,5,20,39,64,-25,38
Albion,5660,9,8,6,22,57,80,-23,30
Queen's Park,5660,10,6,10,20,39,74,-35,28
Raith,5661,1,23,8,5,72,33,39,77
Ayr,5661,2,24,4,8,95,44,51,76
Arbroath,5661,3,18,8,10,72,49,23,62
Alloa,5661,4,17,8,11,57,47,10,59
Stranraer,5661,5,15,5,16,55,66,-11,50
East Fife,5661,6,14,3,19,49,64,-15,45
Airdrieon,5661,7,11,11,14,47,59,-12,44
Forfar,5661,8,10,5,21,39,66,-27,35
Albion,5661,9,8,6,22,59,83,-24,30
Queen's Park,5661,10,6,10,20,40,74,-34,28
Ayr,5662,1,24,4,8,97,44,53,76
Raith,5662,2,22,8,6,68,33,35,74
Alloa,5662,3,18,8,10,57,43,14,62
Arbroath,5662,4,17,8,11,70,50,20,59
Stranraer,5662,5,15,5,16,56,68,-12,50
East Fife,5662,6,14,3,19,51,65,-14,45
Airdrieon,5662,7,11,11,14,49,59,-10,44
Forfar,5662,8,10,5,21,39,68,-29,35
Queen's Park,5662,9,7,10,19,41,72,-31,31
Albion,5662,10,8,6,22,59,85,-26,30
Raith,5663,1,22,8,6,68,33,35,74
Ayr,5663,2,23,4,9,92,46,46,73
Arbroath,5663,3,18,8,10,73,49,24,62
Alloa,5663,4,18,8,10,57,43,14,62
Stranraer,5663,5,16,5,15,58,64,-6,53
Airdrieon,5663,6,11,11,14,47,58,-11,44
East Fife,5663,7,13,3,20,47,67,-20,42
Forfar,5663,8,10,5,21,38,66,-28,35
Albion,5663,9,9,6,21,61,80,-19,33
Queen's Park,5663,10,6,10,20,40,75,-35,28
Raith,5664,1,23,8,5,70,33,37,77
Ayr,5664,2,24,4,8,99,42,57,76
Arbroath,5664,3,17,8,11,71,50,21,59
Alloa,5664,4,17,8,11,57,45,12,59
Stranraer,5664,5,16,5,15,57,65,-8,53
Airdrieon,5664,6,10,12,14,46,59,-13,42
East Fife,5664,7,13,3,20,48,66,-18,42
Forfar,5664,8,10,6,20,39,65,-26,36
Queen's Park,5664,9,7,10,19,41,73,-32,31
Albion,5664,10,8,6,22,57,87,-30,30
Ayr,5665,1,24,4,8,97,42,55,76
Raith,5665,2,22,8,6,69,34,35,74
Arbroath,5665,3,18,8,10,74,49,25,62
Alloa,5665,4,18,8,10,58,44,14,62
Stranraer,5665,5,16,5,15,58,66,-8,53
Airdrieon,5665,6,10,12,14,46,59,-13,42
East Fife,5665,7,13,3,20,49,67,-18,42
Forfar,5665,8,10,6,20,39,65,-26,36
Albion,5665,9,8,6,22,57,85,-28,30
Queen's Park,5665,10,6,10,20,40,76,-36,28
Ayr,5666,1,24,4,8,93,43,50,76
Raith,5666,2,22,8,6,68,34,34,74
Alloa,5666,3,18,8,10,58,43,15,62
Arbroath,5666,4,17,9,10,71,49,22,60
Stranraer,5666,5,15,5,16,56,66,-10,50
East Fife,5666,6,14,3,19,49,65,-16,45
Airdrieon,5666,7,10,11,15,45,61,-16,41
Forfar,5666,8,11,5,20,41,64,-23,38
Albion,5666,9,8,6,22,58,81,-23,30
Queen's Park,5666,10,6,11,19,40,73,-33,29
Raith,5667,1,23,8,5,72,34,38,77
Ayr,5667,2,23,4,9,91,44,47,73
Arbroath,5667,3,17,9,10,71,49,22,60
Alloa,5667,4,17,8,11,58,47,11,59
Stranraer,5667,5,15,5,16,56,66,-10,50
East Fife,5667,6,14,3,19,49,65,-16,45
Airdrieon,5667,7,11,11,14,46,58,-12,44
Forfar,5667,8,10,5,21,38,65,-27,35
Albion,5667,9,9,6,21,59,79,-20,33
Queen's Park,5667,10,6,11,19,40,73,-33,29
Raith,5668,1,23,8,5,69,32,37,77
Ayr,5668,2,23,4,9,91,45,46,73
Arbroath,5668,3,18,8,10,71,48,23,62
Alloa,5668,4,17,8,11,56,44,12,59
Stranraer,5668,5,15,5,16,56,66,-10,50
East Fife,5668,6,14,3,19,49,65,-16,45
Airdrieon,5668,7,10,12,14,45,58,-13,42
Forfar,5668,8,10,6,20,38,64,-26,36
Albion,5668,9,9,6,21,60,79,-19,33
Queen's Park,5668,10,6,10,20,39,73,-34,28
Raith,5669,1,22,9,5,68,32,36,75
Ayr,5669,2,23,5,8,92,44,48,74
Arbroath,5669,3,18,8,10,72,49,23,62
Alloa,5669,4,17,9,10,56,43,13,60
Stranraer,5669,5,16,5,15,58,64,-6,53
Airdrieon,5669,6,10,12,14,46,59,-13,42
East Fife,5669,7,13,3,20,47,67,-20,42
Forfar,5669,8,10,6,20,39,65,-26,36
Albion,5669,9,8,7,21,59,80,-21,31
Queen's Park,5669,10,6,10,20,40,74,-34,28
Ayr,5670,1,24,4,8,92,42,50,76
Raith,5670,2,22,8,6,69,34,35,74
Arbroath,5670,3,18,8,10,71,48,23,62
Alloa,5670,4,18,8,10,58,44,14,62
Stranraer,5670,5,15,5,16,56,67,-11,50
East Fife,5670,6,14,3,19,50,65,-15,45
Airdrieon,5670,7,11,11,14,47,58,-11,44
Forfar,5670,8,10,5,21,38,66,-28,35
Albion,5670,9,8,6,22,57,80,-23,30
Queen's Park,5670,10,6,10,20,39,73,-34,28
Ayr,5671,1,23,5,8,90,42,48,74
Raith,5671,2,22,8,6,68,34,34,74
Alloa,5671,3,18,8,10,58,43,15,62
Arbroath,5671,4,17,9,10,72,50,22,60
Stranraer,5671,5,15,6,15,56,65,-9,51
Airdrieon,5671,6,11,11,14,46,58,-12,44
East Fife,5671,7,13,4,19,48,65,-17,43
Forfar,5671,8,10,5,21,38,65,-27,35
Albion,5671,9,8,7,21,57,78,-21,31
Queen's Park,5671,10,6,11,19,41,74,-33,29
Raith,5672,1,23,8,5,71,32,39,77
Ayr,5672,2,23,5,8,91,43,48,74
Arbroath,5672,3,18,8,10,72,49,23,62
Alloa,5672,4,17,8,11,56,46,10,59
Stranraer,5672,5,16,5,15,59,66,-7,53
Airdrieon,5672,6,11,11,14,46,58,-12,44
East Fife,5672,7,13,3,20,49,68,-19,42
Forfar,5672,8,10,5,21,38,65,-27,35
Albion,5672,9,8,7,21,58,79,-21,31
Queen's Park,5672,10,6,10,20,40,74,-34,28
Raith,5673,1,23,8,5,72,33,39,77
Ayr,5673,2,24,4,8,91,42,49,76
Arbroath,5673,3,17,8,11,70,49,21,59
Alloa,5673,4,17,8,11,57,47,10,59
Stranraer,5673,5,16,5,15,60,65,-5,53
Airdrieon,5673,6,11,11,14,52,58,-6,44
East Fife,5673,7,13,3,20,48,69,-21,42
Forfar,5673,8,10,5,21,38,71,-33,35
Queen's Park,5673,9,7,10,19,40,72,-32,31
Albion,5673,10,8,6,22,57,79,-22,30
Raith,5674,1,23,8,5,73,33,40,77
Ayr,5674,2,23,4,9,90,43,47,73
Arbroath,5674,3,17,9,10,71,49,22,60
Alloa,5674,4,17,8,11,57,48,9,59
Stranraer,5674,5,15,5,16,56,67,-11,50
East Fife,5674,6,14,3,19,50,65,-15,45
Airdrieon,5674,7,11,11,14,46,58,-12,44
Forfar,5674,8,10,5,21,38,65,-27,35
Albion,5674,9,9,6,21,58,78,-20,33
Queen's Park,5674,10,6,11,19,40,73,-33,29
Raith,5675,1,23,8,5,70,33,37,77
Ayr,5675,2,24,4,8,95,44,51,76
Arbroath,5675,3,17,9,10,73,51,22,60
Alloa,5675,4,17,8,11,57,45,12,59
Stranraer,5675,5,15,6,15,56,65,-9,51
Airdrieon,5675,6,11,11,14,48,58,-10,44
East Fife,5675,7,13,4,19,48,65,-17,43
Forfar,5675,8,10,5,21,38,67,-29,35
Albion,5675,9,8,6,22,59,83,-24,30
Queen's Park,5675,10,6,11,19,42,75,-33,29
Raith,5676,1,23,8,5,69,32,37,77
Ayr,5676,2,24,4,8,93,43,50,76
Arbroath,5676,3,17,9,10,72,50,22,60
Alloa,5676,4,17,8,11,56,44,12,59
Stranraer,5676,5,15,5,16,55,65,-10,50
East Fife,5676,6,14,3,19,48,64,-16,45
Airdrieon,5676,7,10,12,14,46,59,-13,42
Forfar,5676,8,10,6,20,39,65,-26,36
Albion,5676,9,8,6,22,58,81,-23,30
Queen's Park,5676,10,6,11,19,41,74,-33,29
Raith,5677,1,23,8,5,70,32,38,77
Ayr,5677,2,24,4,8,94,43,51,76
Arbroath,5677,3,18,8,10,72,49,23,62
Alloa,5677,4,17,8,11,56,45,11,59
Stranraer,5677,5,15,5,16,56,66,-10,50
East Fife,5677,6,14,3,19,49,65,-16,45
Airdrieon,5677,7,11,11,14,47,59,-12,44
Forfar,5677,8,10,5,21,39,66,-27,35
Albion,5677,9,8,6,22,58,82,-24,30
Queen's Park,5677,10,6,10,20,40,74,-34,28
Raith,5678,1,23,8,5,70,33,37,77
Ayr,5678,2,24,4,8,96,42,54,76
Arbroath,5678,3,18,8,10,74,48,26,62
Alloa,5678,4,17,8,11,57,45,12,59
Stranraer,5678,5,15,5,16,55,66,-11,50
East Fife,5678,6,14,3,19,49,64,-15,45
Airdrieon,5678,7,11,11,14,47,59,-12,44
Forfar,5678,8,10,5,21,39,66,-27,35
Albion,5678,9,8,6,22,57,84,-27,30
Queen's Park,5678,10,6,10,20,39,76,-37,28
Raith,5679,1,23,8,5,73,33,40,77
Ayr,5679,2,23,5,8,92,44,48,74
Arbroath,5679,3,17,9,10,70,48,22,60
Alloa,5679,4,17,8,11,57,48,9,59
Stranraer,5679,5,16,5,15,58,65,-7,53
East Fife,5679,6,13,3,20,48,67,-19,42
Airdrieon,5679,7,10,11,15,46,60,-14,41
Forfar,5679,8,11,5,20,40,65,-25,38
Albion,5679,9,8,7,21,59,80,-21,31
Queen's Park,5679,10,6,11,19,39,72,-33,29
Raith,5680,1,23,8,5,72,32,40,77
Ayr,5680,2,24,4,8,95,45,50,76
Arbroath,5680,3,17,8,11,70,49,21,59
Alloa,5680,4,17,8,11,56,47,9,59
Stranraer,5680,5,15,5,16,55,66,-11,50
East Fife,5680,6,14,3,19,49,64,-15,45
Airdrieon,5680,7,10,11,15,47,61,-14,41
Forfar,5680,8,11,5,20,41,66,-25,38
Queen's Park,5680,9,7,10,19,40,72,-32,31
Albion,5680,10,8,6,22,60,83,-23,30
Ayr,5681,1,24,4,8,93,43,50,76
Raith,5681,2,22,9,5,71,35,36,75
Arbroath,5681,3,17,9,10,71,49,22,60
Alloa,5681,4,17,9,10,59,46,13,60
Stranraer,5681,5,15,5,16,55,66,-11,50
East Fife,5681,6,14,3,19,49,64,-15,45
Airdrieon,5681,7,11,11,14,50,59,-9,44
Forfar,5681,8,10,5,21,39,69,-30,35
Albion,5681,9,8,6,22,58,81,-23,30
Queen's Park,5681,10,6,11,19,40,73,-33,29
Raith,5682,1,22,9,5,69,33,36,75
Ayr,5682,2,23,5,8,93,45,48,74
Arbroath,5682,3,17,9,10,73,51,22,60
Alloa,5682,4,17,9,10,57,44,13,60
Stranraer,5682,5,16,5,15,58,66,-8,53
Airdrieon,5682,6,10,12,14,45,58,-13,42
East Fife,5682,7,13,3,20,49,67,-18,42
Forfar,5682,8,10,6,20,38,64,-26,36
Albion,5682,9,8,7,21,60,81,-21,31
Queen's Park,5682,10,6,11,19,42,75,-33,29
Ayr,5683,1,24,4,8,93,43,50,76
Raith,5683,2,22,8,6,68,33,35,74
Arbroath,5683,3,18,8,10,72,49,23,62
Alloa,5683,4,18,8,10,57,43,14,62
Stranraer,5683,5,15,5,16,56,67,-11,50
East Fife,5683,6,14,3,19,50,65,-15,45
Airdrieon,5683,7,10,11,15,45,61,-16,41
Forfar,5683,8,11,5,20,41,64,-23,38
Albion,5683,9,8,6,22,58,81,-23,30
Queen's Park,5683,10,6,10,20,40,74,-34,28
Ayr,5684,1,24,4,8,93,43,50,76
Raith,5684,2,22,9,5,69,33,36,75
Arbroath,5684,3,18,8,10,72,48,24,62
Alloa,5684,4,17,9,10,57,44,13,60
Stranraer,5684,5,15,5,16,55,66,-11,50
East Fife,5684,6,14,3,19,49,64,-15,45
Airdrieon,5684,7,11,11,14,48,60,-12,44
Forfar,5684,8,10,5,21,40,67,-27,35
Albion,5684,9,8,6,22,58,81,-23,30
Queen's Park,5684,10,6,10,20,39,74,-35,28
Raith,5685,1,23,8,5,71,33,38,77
Ayr,5685,2,24,4,8,95,44,51,76
Arbroath,5685,3,18,8,10,75,48,27,62
Alloa,5685,4,17,8,11,57,46,11,59
Stranraer,5685,5,15,5,16,56,67,-11,50
East Fife,5685,6,14,3,19,50,65,-15,45
Airdrieon,5685,7,11,11,14,47,59,-12,44
Forfar,5685,8,10,5,21,39,66,-27,35
Albion,5685,9,8,6,22,59,83,-24,30
Queen's Park,5685,10,6,10,20,39,77,-38,28
Ayr,5686,1,24,4,8,92,43,49,76
Raith,5686,2,22,8,6,69,34,35,74
Alloa,5686,3,18,8,10,58,44,14,62
Arbroath,5686,4,17,8,11,71,50,21,59
Stranraer,5686,5,15,6,15,56,65,-9,51
Airdrieon,5686,6,11,11,14,47,59,-12,44
East Fife,5686,7,13,4,19,48,65,-17,43
Forfar,5686,8,10,5,21,39,66,-27,35
Queen's Park,5686,9,7,10,19,41,73,-32,31
Albion,5686,10,8,6,22,58,80,-22,30
Ayr,5687,1,24,4,8,97,44,53,76
Raith,5687,2,22,9,5,68,32,36,75
Arbroath,5687,3,18,8,10,73,48,25,62
Alloa,5687,4,17,9,10,56,43,13,60
Stranraer,5687,5,15,6,15,56,65,-9,51
East Fife,5687,6,13,4,19,48,65,-17,43
Airdrieon,5687,7,10,12,14,45,58,-13,42
Forfar,5687,8,10,6,20,38,64,-26,36
Albion,5687,9,8,6,22,59,85,-26,30
Queen's Park,5687,10,6,10,20,39,75,-36,28
Raith,5688,1,23,8,5,70,32,38,77
Ayr,5688,2,24,4,8,93,44,49,76
Arbroath,5688,3,17,9,10,70,48,22,60
Alloa,5688,4,17,8,11,56,45,11,59
Stranraer,5688,5,16,5,15,57,65,-8,53
East Fife,5688,6,13,3,20,48,66,-18,42
Airdrieon,5688,7,10,11,15,45,60,-15,41
Forfar,5688,8,11,5,20,40,64,-24,38
Albion,5688,9,8,6,22,59,81,-22,30
Queen's Park,5688,10,6,11,19,39,72,-33,29
Raith,5689,1,23,8,5,70,33,37,77
Ayr,5689,2,24,4,8,93,43,50,76
Arbroath,5689,3,17,9,10,72,50,22,60
Alloa,5689,4,17,8,11,57,45,12,59
Stranraer,5689,5,15,6,15,56,65,-9,51
East Fife,5689,6,13,4,19,48,65,-17,43
Airdrieon,5689,7,10,11,15,45,59,-14,41
Forfar,5689,8,11,5,20,39,64,-25,38
Albion,5689,9,8,6,22,58,81,-23,30
Queen's Park,5689,10,6,11,19,41,74,-33,29
Ayr,5690,1,24,4,8,94,43,51,76
Raith,5690,2,22,9,5,70,34,36,75
Alloa,5690,3,17,9,10,58,45,13,60
Arbroath,5690,4,17,8,11,70,52,18,59
Stranraer,5690,5,15,6,15,56,65,-9,51
East Fife,5690,6,13,4,19,48,65,-17,43
Airdrieon,5690,7,10,11,15,46,60,-14,41
Forfar,5690,8,11,5,20,40,65,-25,38
Queen's Park,5690,9,7,10,19,43,72,-29,31
Albion,5690,10,8,6,22,58,82,-24,30
Raith,5691,1,23,8,5,70,33,37,77
Ayr,5691,2,24,4,8,92,42,50,76
Arbroath,5691,3,17,8,11,71,51,20,59
Alloa,5691,4,17,8,11,57,45,12,59
Stranraer,5691,5,15,6,15,56,65,-9,51
Airdrieon,5691,6,11,11,14,47,58,-11,44
East Fife,5691,7,13,4,19,48,65,-17,43
Forfar,5691,8,10,5,21,38,66,-28,35
Queen's Park,5691,9,7,10,19,42,73,-31,31
Albion,5691,10,8,6,22,57,80,-23,30
Raith,5692,1,23,8,5,71,32,39,77
Ayr,5692,2,24,4,8,95,43,52,76
Arbroath,5692,3,17,8,11,73,52,21,59
Alloa,5692,4,17,8,11,56,46,10,59
Stranraer,5692,5,16,5,15,58,66,-8,53
Airdrieon,5692,6,11,11,14,46,58,-12,44
East Fife,5692,7,13,3,20,49,67,-18,42
Forfar,5692,8,10,5,21,38,65,-27,35
Queen's Park,5692,9,7,10,19,43,75,-32,31
Albion,5692,10,8,6,22,58,83,-25,30
Ayr,5693,1,23,5,8,91,43,48,74
Raith,5693,2,22,8,6,68,34,34,74
Alloa,5693,3,18,8,10,58,43,15,62
Arbroath,5693,4,17,8,11,70,50,20,59
Stranraer,5693,5,15,5,16,55,67,-12,50
East Fife,5693,6,14,3,19,50,64,-14,45
Airdrieon,5693,7,11,11,14,48,59,-11,44
Forfar,5693,8,10,5,21,39,67,-28,35
Albion,5693,9,8,7,21,58,79,-21,31
Queen's Park,5693,10,7,10,19,41,72,-31,31
Raith,5694,1,23,8,5,71,33,38,77
Ayr,5694,2,24,4,8,92,43,49,76
Arbroath,5694,3,18,8,10,75,50,25,62
Alloa,5694,4,17,8,11,57,46,11,59
Stranraer,5694,5,15,5,16,56,67,-11,50
East Fife,5694,6,14,3,19,50,65,-15,45
Airdrieon,5694,7,11,11,14,46,58,-12,44
Forfar,5694,8,10,5,21,38,65,-27,35
Albion,5694,9,8,6,22,58,80,-22,30
Queen's Park,5694,10,6,10,20,41,77,-36,28
Ayr,5695,1,24,4,8,97,44,53,76
Raith,5695,2,22,9,5,69,33,36,75
Arbroath,5695,3,17,9,10,72,50,22,60
Alloa,5695,4,17,9,10,57,44,13,60
Stranraer,5695,5,15,5,16,55,66,-11,50
East Fife,5695,6,14,3,19,49,64,-15,45
Airdrieon,5695,7,11,11,14,46,58,-12,44
Forfar,5695,8,10,5,21,38,65,-27,35
Albion,5695,9,8,6,22,59,85,-26,30
Queen's Park,5695,10,6,11,19,41,74,-33,29
Raith,5696,1,23,8,5,73,33,40,77
Ayr,5696,2,24,4,8,93,43,50,76
Arbroath,5696,3,18,8,10,75,50,25,62
Alloa,5696,4,17,8,11,57,48,9,59
Stranraer,5696,5,15,5,16,56,66,-10,50
East Fife,5696,6,14,3,19,49,65,-16,45
Airdrieon,5696,7,10,12,14,45,58,-13,42
Forfar,5696,8,10,6,20,38,64,-26,36
Albion,5696,9,8,6,22,58,81,-23,30
Queen's Park,5696,10,6,10,20,41,77,-36,28
Raith,5697,1,23,8,5,72,33,39,77
Ayr,5697,2,23,4,9,91,44,47,73
Arbroath,5697,3,17,8,11,70,49,21,59
Alloa,5697,4,17,8,11,57,47,10,59
Stranraer,5697,5,15,6,15,57,66,-9,51
East Fife,5697,6,13,4,19,49,66,-17,43
Airdrieon,5697,7,10,12,14,46,59,-13,42
Forfar,5697,8,10,6,20,39,65,-26,36
Albion,5697,9,9,6,21,59,79,-20,33
Queen's Park,5697,10,7,10,19,40,72,-32,31
Ayr,5698,1,24,4,8,95,43,52,76
Raith,5698,2,22,8,6,68,34,34,74
Alloa,5698,3,18,8,10,58,43,15,62
Arbroath,5698,4,17,8,11,71,51,20,59
Stranraer,5698,5,15,6,15,56,65,-9,51
East Fife,5698,6,13,4,19,48,65,-17,43
Airdrieon,5698,7,10,11,15,46,61,-15,41
Forfar,5698,8,11,5,20,41,65,-24,38
Queen's Park,5698,9,7,10,19,42,73,-31,31
Albion,5698,10,8,6,22,58,83,-25,30
Raith,5699,1,23,8,5,72,32,40,77
Ayr,5699,2,23,4,9,91,44,47,73
Arbroath,5699,3,17,9,10,71,49,22,60
Alloa,5699,4,17,8,11,56,47,9,59
Stranraer,5699,5,15,5,16,58,69,-11,50
East Fife,5699,6,14,3,19,52,67,-15,45
Airdrieon,5699,7,11,11,14,50,60,-10,44
Forfar,5699,8,10,5,21,40,69,-29,35
Albion,5699,9,9,6,21,59,79,-20,33
Queen's Park,5699,10,6,11,19,40,73,-33,29
Raith,5700,1,23,8,5,70,33,37,77
Ayr,5700,2,23,4,9,92,46,46,73
Arbroath,5700,3,17,8,11,70,50,20,59
Alloa,5700,4,17,8,11,57,45,12,59
Stranraer,5700,5,15,6,15,56,65,-9,51
East Fife,5700,6,13,4,19,48,65,-17,43
Airdrieon,5700,7,10,11,15,45,59,-14,41
Forfar,5700,8,11,5,20,39,64,-25,38
Albion,5700,9,9,6,21,61,80,-19,33
Queen's Park,5700,10,7,10,19,41,72,-31,31
Raith,5701,1,22,9,5,69,33,36,75
Ayr,5701,2,23,5,8,91,43,48,74
Alloa,5701,3,17,9,10,57,44,13,60
Arbroath,5701,4,17,8,11,70,50,20,59
Stranraer,5701,5,15,5,16,55,67,-12,50
East Fife,5701,6,14,3,19,50,64,-14,45
Airdrieon,5701,7,11,11,14,46,58,-12,44
Forfar,5701,8,10,5,21,38,65,-27,35
Albion,5701,9,8,7,21,58,79,-21,31
Queen's Park,5701,10,7,10,19,41,72,-31,31
Raith,5702,1,23,8,5,70,32,38,77
Ayr,5702,2,23,5,8,93,45,48,74
Arbroath,5702,3,18,8,10,71,48,23,62
Alloa,5702,4,17,8,11,56,45,11,59
Stranraer,5702,5,15,5,16,56,66,-10,50
East Fife,5702,6,14,3,19,49,65,-16,45
Airdrieon,5702,7,11,11,14,49,60,-11,44
Forfar,5702,8,10,5,21,40,68,-28,35
Albion,5702,9,8,7,21,60,81,-21,31
Queen's Park,5702,10,6,10,20,39,73,-34,28
Ayr,5703,1,24,4,8,93,43,50,76
Raith,5703,2,22,9,5,70,34,36,75
Arbroath,5703,3,17,9,10,71,49,22,60
Alloa,5703,4,17,9,10,58,45,13,60
Stranraer,5703,5,16,5,15,57,65,-8,53
Airdrieon,5703,6,11,11,14,48,60,-12,44
East Fife,5703,7,13,3,20,48,66,-18,42
Forfar,5703,8,10,5,21,40,67,-27,35
Albion,5703,9,8,6,22,58,81,-23,30
Queen's Park,5703,10,6,11,19,40,73,-33,29
Ayr,5704,1,24,4,8,93,43,50,76
Raith,5704,2,22,8,6,68,33,35,74
Arbroath,5704,3,18,8,10,72,48,24,62
Alloa,5704,4,18,8,10,57,43,14,62
Stranraer,5704,5,16,5,15,56,64,-8,53
Airdrieon,5704,6,11,11,14,46,58,-12,44
East Fife,5704,7,13,3,20,47,65,-18,42
Forfar,5704,8,10,5,21,38,65,-27,35
Albion,5704,9,8,6,22,58,81,-23,30
Queen's Park,5704,10,6,10,20,39,74,-35,28
Ayr,5705,1,24,4,8,92,42,50,76
Raith,5705,2,22,9,5,68,32,36,75
Arbroath,5705,3,17,9,10,72,50,22,60
Alloa,5705,4,17,9,10,56,43,13,60
Stranraer,5705,5,16,5,15,59,65,-6,53
Airdrieon,5705,6,10,12,14,48,61,-13,42
East Fife,5705,7,13,3,20,48,68,-20,42
Forfar,5705,8,10,6,20,41,67,-26,36
Albion,5705,9,8,6,22,57,80,-23,30
Queen's Park,5705,10,6,11,19,41,74,-33,29
Raith,5706,1,23,8,5,72,34,38,77
Ayr,5706,2,24,4,8,92,43,49,76
Arbroath,5706,3,18,8,10,72,49,23,62
Alloa,5706,4,17,8,11,58,47,11,59
Stranraer,5706,5,15,5,16,55,67,-12,50
East Fife,5706,6,14,3,19,50,64,-14,45
Airdrieon,5706,7,11,11,14,46,58,-12,44
Forfar,5706,8,10,5,21,38,65,-27,35
Albion,5706,9,8,6,22,58,80,-22,30
Queen's Park,5706,10,6,10,20,40,74,-34,28
Raith,5707,1,23,8,5,72,33,39,77
Ayr,5707,2,24,4,8,95,44,51,76
Arbroath,5707,3,18,8,10,75,49,26,62
Alloa,5707,4,17,8,11,57,47,10,59
Stranraer,5707,5,15,5,16,55,66,-11,50
East Fife,5707,6,14,3,19,49,64,-15,45
Airdrieon,5707,7,11,11,14,49,61,-12,44
Forfar,5707,8,10,5,21,41,68,-27,35
Albion,5707,9,8,6,22,59,83,-24,30
Queen's Park,5707,10,6,10,20,40,77,-37,28
Ayr,5708,1,24,4,8,93,42,51,76
Raith,5708,2,22,9,5,68,32,36,75
Arbroath,5708,3,18,8,10,72,48,24,62
Alloa,5708,4,17,9,10,56,43,13,60
Stranraer,5708,5,15,5,16,55,67,-12,50
East Fife,5708,6,14,3,19,50,64,-14,45
Airdrieon,5708,7,11,11,14,46,58,-12,44
Forfar,5708,8,10,5,21,38,65,-27,35
Albion,5708,9,8,6,22,57,81,-24,30
Queen's Park,5708,10,6,10,20,39,74,-35,28
Ayr,5709,1,24,4,8,95,45,50,76
Raith,5709,2,22,8,6,68,33,35,74
Alloa,5709,3,18,8,10,57,43,14,62
Arbroath,5709,4,17,9,10,72,50,22,60
Stranraer,5709,5,16,5,15,57,65,-8,53
Airdrieon,5709,6,11,11,14,46,58,-12,44
East Fife,5709,7,13,3,20,48,66,-18,42
Forfar,5709,8,10,5,21,38,65,-27,35
Albion,5709,9,8,6,22,60,83,-23,30
Queen's Park,5709,10,6,11,19,41,74,-33,29
Raith,5710,1,23,8,5,72,33,39,77
Ayr,5710,2,24,4,8,91,42,49,76
Arbroath,5710,3,18,8,10,72,49,23,62
Alloa,5710,4,17,8,11,57,47,10,59
Stranraer,5710,5,15,6,15,59,68,-9,51
Airdrieon,5710,6,11,11,14,46,58,-12,44
East Fife,5710,7,13,4,19,51,68,-17,43
Forfar,5710,8,10,5,21,38,65,-27,35
Albion,5710,9,8,6,22,57,79,-22,30
Queen's Park,5710,10,6,10,20,40,74,-34,28
Ayr,5711,1,24,4,8,95,46,49,76
Raith,5711,2,22,9,5,68,32,36,75
Alloa,5711,3,17,9,10,56,43,13,60
Arbroath,5711,4,17,8,11,70,49,21,59
Stranraer,5711,5,16,5,15,56,64,-8,53
East Fife,5711,6,13,3,20,47,65,-18,42
Airdrieon,5711,7,10,11,15,46,63,-17,41
Forfar,5711,8,11,5,20,43,65,-22,38
Queen's Park,5711,9,7,10,19,40,72,-32,31
Albion,5711,10,8,6,22,61,83,-22,30
Ayr,5712,1,24,4,8,96,42,54,76
Raith,5712,2,22,9,5,68,32,36,75
Arbroath,5712,3,18,8,10,73,50,23,62
Alloa,5712,4,17,9,10,56,43,13,60
Stranraer,5712,5,15,5,16,56,66,-10,50
East Fife,5712,6,14,3,19,49,65,-16,45
Airdrieon,5712,7,10,11,15,46,60,-14,41
Forfar,5712,8,11,5,20,40,65,-25,38
Albion,5712,9,8,6,22,57,84,-27,30
Queen's Park,5712,10,6,10,20,41,75,-34,28
Raith,5713,1,23,8,5,70,33,37,77
Ayr,5713,2,24,4,8,97,44,53,76
Arbroath,5713,3,17,8,11,71,53,18,59
Alloa,5713,4,17,8,11,57,45,12,59
Stranraer,5713,5,15,5,16,56,67,-11,50
East Fife,5713,6,14,3,19,50,65,-15,45
Airdrieon,5713,7,11,11,14,50,58,-8,44
Forfar,5713,8,10,5,21,38,69,-31,35
Queen's Park,5713,9,7,10,19,44,73,-29,31
Albion,5713,10,8,6,22,59,85,-26,30
Raith,5714,1,22,9,5,68,32,36,75
Ayr,5714,2,23,4,9,91,46,45,73
Alloa,5714,3,17,9,10,56,43,13,60
Arbroath,5714,4,17,8,11,72,51,21,59
Stranraer,5714,5,16,5,15,58,64,-6,53
Airdrieon,5714,6,11,11,14,46,58,-12,44
East Fife,5714,7,13,3,20,47,67,-20,42
Forfar,5714,8,10,5,21,38,65,-27,35
Albion,5714,9,9,6,21,61,79,-18,33
Queen's Park,5714,10,7,10,19,42,74,-32,31
Ayr,5715,1,24,4,8,93,43,50,76
Raith,5715,2,22,9,5,70,34,36,75
Arbroath,5715,3,17,9,10,70,48,22,60
Alloa,5715,4,17,9,10,58,45,13,60
Stranraer,5715,5,16,5,15,56,64,-8,53
Airdrieon,5715,6,11,11,14,48,58,-10,44
East Fife,5715,7,13,3,20,47,65,-18,42
Forfar,5715,8,10,5,21,38,67,-29,35
Albion,5715,9,8,6,22,58,81,-23,30
Queen's Park,5715,10,6,11,19,39,72,-33,29
Ayr,5716,1,24,4,8,94,42,52,76
Raith,5716,2,22,8,6,68,34,34,74
Alloa,5716,3,18,8,10,58,43,15,62
Arbroath,5716,4,17,8,11,70,49,21,59
Stranraer,5716,5,15,5,16,56,66,-10,50
East Fife,5716,6,14,3,19,49,65,-16,45
Airdrieon,5716,7,11,11,14,49,59,-10,44
Forfar,5716,8,10,5,21,39,68,-29,35
Queen's Park,5716,9,7,10,19,40,72,-32,31
Albion,5716,10,8,6,22,57,82,-25,30
Raith,5717,1,23,8,5,71,32,39,77
Ayr,5717,2,24,4,8,93,44,49,76
Arbroath,5717,3,17,9,10,71,49,22,60
Alloa,5717,4,17,8,11,56,46,10,59
Stranraer,5717,5,15,6,15,56,65,-9,51
Airdrieon,5717,6,11,11,14,47,58,-11,44
East Fife,5717,7,13,4,19,48,65,-17,43
Forfar,5717,8,10,5,21,38,66,-28,35
Albion,5717,9,8,6,22,59,81,-22,30
Queen's Park,5717,10,6,11,19,40,73,-33,29
Raith,5718,1,23,8,5,70,32,38,77
Ayr,5718,2,24,4,8,94,45,49,76
Arbroath,5718,3,17,8,11,70,49,21,59
Alloa,5718,4,17,8,11,56,45,11,59
Stranraer,5718,5,16,5,15,57,64,-7,53
East Fife,5718,6,13,3,20,47,66,-19,42
Airdrieon,5718,7,10,11,15,45,60,-15,41
Forfar,5718,8,11,5,20,40,64,-24,38
Queen's Park,5718,9,7,10,19,40,72,-32,31
Albion,5718,10,8,6,22,60,82,-22,30
Raith,5719,1,22,9,5,69,33,36,75
Ayr,5719,2,23,5,8,90,42,48,74
Arbroath,5719,3,17,9,10,71,49,22,60
Alloa,5719,4,17,9,10,57,44,13,60
Stranraer,5719,5,16,5,15,57,64,-7,53
East Fife,5719,6,13,3,20,47,66,-19,42
Airdrieon,5719,7,10,11,15,46,60,-14,41
Forfar,5719,8,11,5,20,40,65,-25,38
Albion,5719,9,8,7,21,57,78,-21,31
Queen's Park,5719,10,6,11,19,40,73,-33,29
Raith,5720,1,23,8,5,71,32,39,77
Ayr,5720,2,23,5,8,91,43,48,74
Arbroath,5720,3,18,8,10,72,49,23,62
Alloa,5720,4,17,8,11,56,46,10,59
Stranraer,5720,5,15,5,16,56,68,-12,50
East Fife,5720,6,14,3,19,51,65,-14,45
Airdrieon,5720,7,10,12,14,46,59,-13,42
Forfar,5720,8,10,6,20,39,65,-26,36
Albion,5720,9,8,7,21,58,79,-21,31
Queen's Park,5720,10,6,10,20,40,74,-34,28
Raith,5721,1,23,8,5,70,32,38,77
Ayr,5721,2,24,4,8,92,43,49,76
Arbroath,5721,3,18,8,10,74,50,24,62
Alloa,5721,4,17,8,11,56,45,11,59
Stranraer,5721,5,15,5,16,55,68,-13,50
East Fife,5721,6,14,3,19,51,64,-13,45
Airdrieon,5721,7,11,11,14,48,60,-12,44
Forfar,5721,8,10,5,21,40,67,-27,35
Albion,5721,9,8,6,22,58,80,-22,30
Queen's Park,5721,10,6,10,20,41,76,-35,28
Raith,5722,1,23,8,5,70,32,38,77
Ayr,5722,2,24,4,8,95,44,51,76
Arbroath,5722,3,17,9,10,71,49,22,60
Alloa,5722,4,17,8,11,56,45,11,59
Stranraer,5722,5,15,5,16,56,66,-10,50
East Fife,5722,6,14,3,19,49,65,-16,45
Airdrieon,5722,7,10,11,15,45,59,-14,41
Forfar,5722,8,11,5,20,39,64,-25,38
Albion,5722,9,8,6,22,59,83,-24,30
Queen's Park,5722,10,6,11,19,40,73,-33,29
Ayr,5723,1,24,4,8,95,43,52,76
Raith,5723,2,22,8,6,70,36,34,74
Alloa,5723,3,18,8,10,60,45,15,62
Arbroath,5723,4,17,9,10,70,48,22,60
Stranraer,5723,5,15,5,16,55,65,-10,50
East Fife,5723,6,14,3,19,48,64,-16,45
Airdrieon,5723,7,11,11,14,48,59,-11,44
Forfar,5723,8,10,5,21,39,67,-28,35
Albion,5723,9,8,6,22,58,83,-25,30
Queen's Park,5723,10,6,11,19,39,72,-33,29
Raith,5724,1,23,8,5,71,32,39,77
Ayr,5724,2,24,4,8,92,42,50,76
Arbroath,5724,3,18,8,10,73,49,24,62
Alloa,5724,4,17,8,11,56,46,10,59
Stranraer,5724,5,15,5,16,57,67,-10,50
East Fife,5724,6,14,3,19,50,66,-16,45
Airdrieon,5724,7,10,11,15,47,61,-14,41
Forfar,5724,8,11,5,20,41,66,-25,38
Albion,5724,9,8,6,22,57,80,-23,30
Queen's Park,5724,10,6,10,20,40,75,-35,28
Raith,5725,1,23,8,5,69,32,37,77
Ayr,5725,2,24,4,8,94,43,51,76
Arbroath,5725,3,17,8,11,70,50,20,59
Alloa,5725,4,17,8,11,56,44,12,59
Stranraer,5725,5,16,5,15,59,64,-5,53
East Fife,5725,6,13,3,20,47,68,-21,42
Airdrieon,5725,7,10,11,15,46,61,-15,41
Forfar,5725,8,11,5,20,41,65,-24,38
Queen's Park,5725,9,7,10,19,41,72,-31,31
Albion,5725,10,8,6,22,58,82,-24,30
Raith,5726,1,23,8,5,71,33,38,77
Ayr,5726,2,24,4,8,94,42,52,76
Arbroath,5726,3,17,8,11,70,50,20,59
Alloa,5726,4,17,8,11,57,46,11,59
Stranraer,5726,5,15,5,16,56,66,-10,50
East Fife,5726,6,14,3,19,49,65,-16,45
Airdrieon,5726,7,11,11,14,47,58,-11,44
Forfar,5726,8,10,5,21,38,66,-28,35
Queen's Park,5726,9,7,10,19,41,72,-31,31
Albion,5726,10,8,6,22,57,82,-25,30
Ayr,5727,1,24,4,8,95,43,52,76
Raith,5727,2,22,9,5,69,33,36,75
Arbroath,5727,3,18,8,10,73,48,25,62
Alloa,5727,4,17,9,10,57,44,13,60
Stranraer,5727,5,16,5,15,60,68,-8,53
East Fife,5727,6,13,3,20,51,69,-18,42
Airdrieon,5727,7,10,11,15,46,60,-14,41
Forfar,5727,8,11,5,20,40,65,-25,38
Albion,5727,9,8,6,22,58,83,-25,30
Queen's Park,5727,10,6,10,20,39,75,-36,28
Raith,5728,1,23,8,5,70,32,38,77
Ayr,5728,2,24,4,8,94,42,52,76
Arbroath,5728,3,17,8,11,71,52,19,59
Alloa,5728,4,17,8,11,56,45,11,59
Stranraer,5728,5,15,5,16,55,65,-10,50
East Fife,5728,6,14,3,19,48,64,-16,45
Airdrieon,5728,7,10,11,15,45,59,-14,41
Forfar,5728,8,11,5,20,39,64,-25,38
Queen's Park,5728,9,7,10,19,43,73,-30,31
Albion,5728,10,8,6,22,57,82,-25,30
Ayr,5729,1,24,4,8,95,44,51,76
Raith,5729,2,22,9,5,68,32,36,75
Alloa,5729,3,17,9,10,56,43,13,60
Arbroath,5729,4,17,8,11,71,50,21,59
Stranraer,5729,5,15,5,16,56,67,-11,50
East Fife,5729,6,14,3,19,50,65,-15,45
Airdrieon,5729,7,10,12,14,46,59,-13,42
Forfar,5729,8,10,6,20,39,65,-26,36
Queen's Park,5729,9,7,10,19,41,73,-32,31
Albion,5729,10,8,6,22,59,83,-24,30
Ayr,5730,1,24,4,8,92,43,49,76
Raith,5730,2,22,9,5,69,33,36,75
Arbroath,5730,3,18,8,10,73,49,24,62
Alloa,5730,4,17,9,10,57,44,13,60
Stranraer,5730,5,15,5,16,56,66,-10,50
East Fife,5730,6,14,3,19,49,65,-16,45
Airdrieon,5730,7,11,11,14,46,58,-12,44
Forfar,5730,8,10,5,21,38,65,-27,35
Albion,5730,9,8,6,22,58,80,-22,30
Queen's Park,5730,10,6,10,20,40,75,-35,28
Raith,5731,1,23,8,5,72,33,39,77
Ayr,5731,2,24,4,8,96,44,52,76
Arbroath,5731,3,17,9,10,72,50,22,60
Alloa,5731,4,17,8,11,57,47,10,59
Stranraer,5731,5,15,5,16,55,66,-11,50
East Fife,5731,6,14,3,19,49,64,-15,45
Airdrieon,5731,7,10,12,14,46,59,-13,42
Forfar,5731,8,10,6,20,39,65,-26,36
Albion,5731,9,8,6,22,59,84,-25,30
Queen's Park,5731,10,6,11,19,41,74,-33,29
Ayr,5732,1,24,4,8,94,44,50,76
Raith,5732,2,22,9,5,69,33,36,75
Alloa,5732,3,17,9,10,57,44,13,60
Arbroath,5732,4,17,8,11,70,50,20,59
Stranraer,5732,5,15,5,16,57,67,-10,50
East Fife,5732,6,14,3,19,50,66,-16,45
Airdrieon,5732,7,11,11,14,48,58,-10,44
Forfar,5732,8,10,5,21,38,67,-29,35
Queen's Park,5732,9,7,10,19,41,72,-31,31
Albion,5732,10,8,6,22,59,82,-23,30
Raith,5733,1,23,8,5,71,34,37,77
Ayr,5733,2,24,4,8,94,44,50,76
Arbroath,5733,3,18,8,10,73,49,24,62
Alloa,5733,4,17,8,11,58,46,12,59
Stranraer,5733,5,16,5,15,58,65,-7,53
East Fife,5733,6,13,3,20,48,67,-19,42
Airdrieon,5733,7,10,11,15,46,60,-14,41
Forfar,5733,8,11,5,20,40,65,-25,38
Albion,5733,9,8,6,22,59,82,-23,30
Queen's Park,5733,10,6,10,20,40,75,-35,28
Ayr,5734,1,24,4,8,95,44,51,76
Raith,5734,2,22,9,5,69,33,36,75
Alloa,5734,3,17,9,10,57,44,13,60
Arbroath,5734,4,17,8,11,71,50,21,59
Stranraer,5734,5,16,5,15,57,65,-8,53
East Fife,5734,6,13,3,20,48,66,-18,42
Airdrieon,5734,7,10,11,15,45,60,-15,41
Forfar,5734,8,11,5,20,40,64,-24,38
Queen's Park,5734,9,7,10,19,41,73,-32,31
Albion,5734,10,8,6,22,59,83,-24,30
Raith,5735,1,23,8,5,70,32,38,77
Ayr,5735,2,24,4,8,92,43,49,76
Arbroath,5735,3,17,9,10,72,50,22,60
Alloa,5735,4,17,8,11,56,45,11,59
Stranraer,5735,5,15,5,16,57,69,-12,50
East Fife,5735,6,14,3,19,52,66,-14,45
Airdrieon,5735,7,11,11,14,49,58,-9,44
Forfar,5735,8,10,5,21,38,68,-30,35
Albion,5735,9,8,6,22,58,80,-22,30
Queen's Park,5735,10,6,11,19,41,74,-33,29
Raith,5736,1,23,8,5,69,32,37,77
Ayr,5736,2,24,4,8,97,42,55,76
Arbroath,5736,3,18,8,10,73,49,24,62
Alloa,5736,4,17,8,11,56,44,12,59
Stranraer,5736,5,16,5,15,58,66,-8,53
Airdrieon,5736,6,11,11,14,48,59,-11,44
East Fife,5736,7,13,3,20,49,67,-18,42
Forfar,5736,8,10,5,21,39,67,-28,35
Albion,5736,9,8,6,22,57,85,-28,30
Queen's Park,5736,10,6,10,20,40,75,-35,28
Raith,5737,1,23,8,5,69,32,37,77
Ayr,5737,2,24,4,8,92,42,50,76
Arbroath,5737,3,18,8,10,72,49,23,62
Alloa,5737,4,17,8,11,56,44,12,59
Stranraer,5737,5,16,5,15,58,64,-6,53
East Fife,5737,6,13,3,20,47,67,-20,42
Airdrieon,5737,7,10,11,15,45,60,-15,41
Forfar,5737,8,11,5,20,40,64,-24,38
Albion,5737,9,8,6,22,57,80,-23,30
Queen's Park,5737,10,6,10,20,40,74,-34,28
Ayr,5738,1,24,4,8,92,43,49,76
Raith,5738,2,22,8,6,69,34,35,74
Arbroath,5738,3,18,8,10,73,50,23,62
Alloa,5738,4,18,8,10,58,44,14,62
Stranraer,5738,5,15,5,16,55,65,-10,50
East Fife,5738,6,14,3,19,48,64,-16,45
Airdrieon,5738,7,10,12,14,45,58,-13,42
Forfar,5738,8,10,6,20,38,64,-26,36
Albion,5738,9,8,6,22,58,80,-22,30
Queen's Park,5738,10,6,10,20,41,75,-34,28
Ayr,5739,1,24,4,8,93,44,49,76
Raith,5739,2,22,9,5,70,34,36,75
Arbroath,5739,3,18,8,10,72,48,24,62
Alloa,5739,4,17,9,10,58,45,13,60
Stranraer,5739,5,15,5,16,56,66,-10,50
East Fife,5739,6,14,3,19,49,65,-16,45
Airdrieon,5739,7,11,11,14,46,58,-12,44
Forfar,5739,8,10,5,21,38,65,-27,35
Albion,5739,9,8,6,22,59,81,-22,30
Queen's Park,5739,10,6,10,20,39,74,-35,28
Ayr,5740,1,24,4,8,92,42,50,76
Raith,5740,2,22,8,6,68,33,35,74
Alloa,5740,3,18,8,10,57,43,14,62
Arbroath,5740,4,17,8,11,70,49,21,59
Stranraer,5740,5,16,5,15,58,65,-7,53
Airdrieon,5740,6,11,11,14,47,58,-11,44
East Fife,5740,7,13,3,20,48,67,-19,42
Forfar,5740,8,10,5,21,38,66,-28,35
Queen's Park,5740,9,7,10,19,40,72,-32,31
Albion,5740,10,8,6,22,57,80,-23,30
Raith,5741,1,23,8,5,69,32,37,77
Ayr,5741,2,24,4,8,95,44,51,76
Arbroath,5741,3,18,8,10,72,49,23,62
Alloa,5741,4,17,8,11,56,44,12,59
Stranraer,5741,5,15,6,15,55,64,-9,51
East Fife,5741,6,13,4,19,47,64,-17,43
Airdrieon,5741,7,10,12,14,45,58,-13,42
Forfar,5741,8,10,6,20,38,64,-26,36
Albion,5741,9,8,6,22,59,83,-24,30
Queen's Park,5741,10,6,10,20,40,74,-34,28
Raith,5742,1,23,8,5,70,32,38,77
Ayr,5742,2,24,4,8,94,44,50,76
Arbroath,5742,3,17,9,10,72,50,22,60
Alloa,5742,4,17,8,11,56,45,11,59
Stranraer,5742,5,16,5,15,60,67,-7,53
East Fife,5742,6,13,3,20,50,69,-19,42
Airdrieon,5742,7,10,11,15,46,62,-16,41
Forfar,5742,8,11,5,20,42,65,-23,38
Albion,5742,9,8,6,22,59,82,-23,30
Queen's Park,5742,10,6,11,19,41,74,-33,29
Ayr,5743,1,24,4,8,91,42,49,76
Raith,5743,2,22,9,5,69,33,36,75
Alloa,5743,3,17,9,10,57,44,13,60
Arbroath,5743,4,17,8,11,70,49,21,59
Stranraer,5743,5,16,5,15,58,65,-7,53
Airdrieon,5743,6,10,12,14,47,60,-13,42
East Fife,5743,7,13,3,20,48,67,-19,42
Forfar,5743,8,10,6,20,40,66,-26,36
Queen's Park,5743,9,7,10,19,40,72,-32,31
Albion,5743,10,8,6,22,57,79,-22,30
Raith,5744,1,23,8,5,69,32,37,77
Ayr,5744,2,24,4,8,96,45,51,76
Arbroath,5744,3,17,8,11,72,51,21,59
Alloa,5744,4,17,8,11,56,44,12,59
Stranraer,5744,5,16,5,15,58,64,-6,53
Airdrieon,5744,6,10,12,14,47,60,-13,42
East Fife,5744,7,13,3,20,47,67,-20,42
Forfar,5744,8,10,6,20,40,66,-26,36
Queen's Park,5744,9,7,10,19,42,74,-32,31
Albion,5744,10,8,6,22,60,84,-24,30
Ayr,5745,1,24,4,8,93,42,51,76
Raith,5745,2,22,8,6,68,33,35,74
Arbroath,5745,3,18,8,10,74,50,24,62
Alloa,5745,4,18,8,10,57,43,14,62
Stranraer,5745,5,15,6,15,55,64,-9,51
Airdrieon,5745,6,11,11,14,48,59,-11,44
East Fife,5745,7,13,4,19,47,64,-17,43
Forfar,5745,8,10,5,21,39,67,-28,35
Albion,5745,9,8,6,22,57,81,-24,30
Queen's Park,5745,10,6,10,20,41,76,-35,28
Ayr,5746,1,24,4,8,93,42,51,76
Raith,5746,2,22,9,5,68,32,36,75
Arbroath,5746,3,17,9,10,72,50,22,60
Alloa,5746,4,17,9,10,56,43,13,60
Stranraer,5746,5,16,5,15,57,65,-8,53
Airdrieon,5746,6,11,11,14,46,58,-12,44
East Fife,5746,7,13,3,20,48,66,-18,42
Forfar,5746,8,10,5,21,38,65,-27,35
Albion,5746,9,8,6,22,57,81,-24,30
Queen's Park,5746,10,6,11,19,41,74,-33,29
Raith,5747,1,23,8,5,69,32,37,77
Ayr,5747,2,24,4,8,93,43,50,76
Arbroath,5747,3,17,9,10,70,48,22,60
Alloa,5747,4,17,8,11,56,44,12,59
Stranraer,5747,5,15,5,16,57,68,-11,50
East Fife,5747,6,14,3,19,51,66,-15,45
Airdrieon,5747,7,10,12,14,47,60,-13,42
Forfar,5747,8,10,6,20,40,66,-26,36
Albion,5747,9,8,6,22,58,81,-23,30
Queen's Park,5747,10,6,11,19,39,72,-33,29
Raith,5748,1,23,8,5,70,33,37,77
Ayr,5748,2,24,4,8,95,43,52,76
Arbroath,5748,3,18,8,10,72,48,24,62
Alloa,5748,4,17,8,11,57,45,12,59
Stranraer,5748,5,15,5,16,56,67,-11,50
East Fife,5748,6,14,3,19,50,65,-15,45
Airdrieon,5748,7,11,11,14,48,59,-11,44
Forfar,5748,8,10,5,21,39,67,-28,35
Albion,5748,9,8,6,22,58,83,-25,30
Queen's Park,5748,10,6,10,20,39,74,-35,28
Raith,5749,1,23,8,5,71,32,39,77
Ayr,5749,2,23,5,8,90,42,48,74
Arbroath,5749,3,17,8,11,71,51,20,59
Alloa,5749,4,17,8,11,56,46,10,59
Stranraer,5749,5,16,5,15,57,64,-7,53
East Fife,5749,6,13,3,20,47,66,-19,42
Airdrieon,5749,7,10,11,15,46,62,-16,41
Forfar,5749,8,11,5,20,42,65,-23,38
Albion,5749,9,8,7,21,57,78,-21,31
Queen's Park,5749,10,7,10,19,42,73,-31,31
Raith,5750,1,23,8,5,71,33,38,77
Ayr,5750,2,23,4,9,91,46,45,73
Arbroath,5750,3,18,8,10,72,48,24,62
Alloa,5750,4,17,8,11,57,46,11,59
Stranraer,5750,5,16,5,15,56,64,-8,53
Airdrieon,5750,6,11,11,14,48,58,-10,44
East Fife,5750,7,13,3,20,47,65,-18,42
Forfar,5750,8,10,5,21,38,67,-29,35
Albion,5750,9,9,6,21,61,79,-18,33
Queen's Park,5750,10,6,10,20,39,74,-35,28
Raith,5751,1,23,8,5,70,32,38,77
Ayr,5751,2,24,4,8,94,44,50,76
Arbroath,5751,3,17,9,10,71,49,22,60
Alloa,5751,4,17,8,11,56,45,11,59
Stranraer,5751,5,15,5,16,57,68,-11,50
East Fife,5751,6,14,3,19,51,66,-15,45
Airdrieon,5751,7,11,11,14,47,58,-11,44
Forfar,5751,8,10,5,21,38,66,-28,35
Albion,5751,9,8,6,22,59,82,-23,30
Queen's Park,5751,10,6,11,19,40,73,-33,29
Raith,5752,1,23,8,5,71,32,39,77
Ayr,5752,2,24,4,8,98,44,54,76
Arbroath,5752,3,17,8,11,71,50,21,59
Alloa,5752,4,17,8,11,56,46,10,59
Stranraer,5752,5,15,5,16,55,66,-11,50
East Fife,5752,6,14,3,19,49,64,-15,45
Airdrieon,5752,7,11,11,14,47,59,-12,44
Forfar,5752,8,10,5,21,39,66,-27,35
Queen's Park,5752,9,7,10,19,41,73,-32,31
Albion,5752,10,8,6,22,59,86,-27,30
Raith,5753,1,23,8,5,72,32,40,77
Ayr,5753,2,24,4,8,96,42,54,76
Arbroath,5753,3,18,8,10,73,49,24,62
Alloa,5753,4,17,8,11,56,47,9,59
Stranraer,5753,5,15,5,16,56,67,-11,50
East Fife,5753,6,14,3,19,50,65,-15,45
Airdrieon,5753,7,11,11,14,50,60,-10,44
Forfar,5753,8,10,5,21,40,69,-29,35
Albion,5753,9,8,6,22,57,84,-27,30
Queen's Park,5753,10,6,10,20,40,75,-35,28
Raith,5754,1,22,8,6,68,33,35,74
Ayr,5754,2,23,4,9,90,44,46,73
Alloa,5754,3,18,8,10,57,43,14,62
Arbroath,5754,4,17,8,11,71,51,20,59
Stranraer,5754,5,15,6,15,57,66,-9,51
East Fife,5754,6,13,4,19,49,66,-17,43
Airdrieon,5754,7,10,11,15,45,59,-14,41
Forfar,5754,8,11,5,20,39,64,-25,38
Albion,5754,9,9,6,21,59,78,-19,33
Queen's Park,5754,10,7,10,19,42,73,-31,31
Ayr,5755,1,24,4,8,94,44,50,76
Raith,5755,2,22,9,5,68,32,36,75
Alloa,5755,3,17,9,10,56,43,13,60
Arbroath,5755,4,17,8,11,70,49,21,59
Stranraer,5755,5,16,5,15,57,65,-8,53
Airdrieon,5755,6,11,11,14,50,58,-8,44
East Fife,5755,7,13,3,20,48,66,-18,42
Forfar,5755,8,10,5,21,38,69,-31,35
Queen's Park,5755,9,7,10,19,40,72,-32,31
Albion,5755,10,8,6,22,59,82,-23,30
Ayr,5756,1,24,4,8,93,43,50,76
Raith,5756,2,22,9,5,70,34,36,75
Alloa,5756,3,17,9,10,58,45,13,60
Arbroath,5756,4,17,8,11,70,49,21,59
Stranraer,5756,5,16,5,15,57,65,-8,53
Airdrieon,5756,6,11,11,14,48,60,-12,44
East Fife,5756,7,13,3,20,48,66,-18,42
Forfar,5756,8,10,5,21,40,67,-27,35
Queen's Park,5756,9,7,10,19,40,72,-32,31
Albion,5756,10,8,6,22,58,81,-23,30
Raith,5757,1,23,8,5,71,33,38,77
Ayr,5757,2,23,5,8,91,43,48,74
Arbroath,5757,3,18,8,10,71,48,23,62
Alloa,5757,4,17,8,11,57,46,11,59
Stranraer,5757,5,15,5,16,55,67,-12,50
East Fife,5757,6,14,3,19,50,64,-14,45
Airdrieon,5757,7,11,11,14,47,59,-12,44
Forfar,5757,8,10,5,21,39,66,-27,35
Albion,5757,9,8,7,21,58,79,-21,31
Queen's Park,5757,10,6,10,20,39,73,-34,28
Raith,5758,1,23,8,5,71,32,39,77
Ayr,5758,2,24,4,8,94,44,50,76
Arbroath,5758,3,18,8,10,72,49,23,62
Alloa,5758,4,17,8,11,56,46,10,59
Stranraer,5758,5,15,5,16,56,67,-11,50
East Fife,5758,6,14,3,19,50,65,-15,45
Airdrieon,5758,7,11,11,14,48,60,-12,44
Forfar,5758,8,10,5,21,40,67,-27,35
Albion,5758,9,8,6,22,59,82,-23,30
Queen's Park,5758,10,6,10,20,40,74,-34,28
Raith,5759,1,23,8,5,70,32,38,77
Ayr,5759,2,24,4,8,94,43,51,76
Arbroath,5759,3,17,8,11,71,50,21,59
Alloa,5759,4,17,8,11,56,45,11,59
Stranraer,5759,5,16,5,15,60,67,-7,53
Airdrieon,5759,6,11,11,14,47,59,-12,44
East Fife,5759,7,13,3,20,50,69,-19,42
Forfar,5759,8,10,5,21,39,66,-27,35
Queen's Park,5759,9,7,10,19,41,73,-32,31
Albion,5759,10,8,6,22,58,82,-24,30
Ayr,5760,1,24,4,8,95,44,51,76
Raith,5760,2,22,8,6,68,33,35,74
Alloa,5760,3,18,8,10,57,43,14,62
Arbroath,5760,4,17,8,11,71,50,21,59
Stranraer,5760,5,15,5,16,56,66,-10,50
East Fife,5760,6,14,3,19,49,65,-16,45
Airdrieon,5760,7,10,12,14,45,58,-13,42
Forfar,5760,8,10,6,20,38,64,-26,36
Queen's Park,5760,9,7,10,19,41,73,-32,31
Albion,5760,10,8,6,22,59,83,-24,30
Raith,5761,1,23,8,5,70,32,38,77
Ayr,5761,2,23,4,9,92,45,47,73
Arbroath,5761,3,18,8,10,73,48,25,62
Alloa,5761,4,17,8,11,56,45,11,59
Stranraer,5761,5,15,5,16,56,68,-12,50
East Fife,5761,6,14,3,19,51,65,-14,45
Airdrieon,5761,7,11,11,14,46,58,-12,44
Forfar,5761,8,10,5,21,38,65,-27,35
Albion,5761,9,9,6,21,60,80,-20,33
Queen's Park,5761,10,6,10,20,39,75,-36,28
Raith,5762,1,23,8,5,71,34,37,77
Ayr,5762,2,24,4,8,95,42,53,76
Arbroath,5762,3,17,8,11,71,50,21,59
Alloa,5762,4,17,8,11,58,46,12,59
Stranraer,5762,5,16,5,15,58,65,-7,53
Airdrieon,5762,6,11,11,14,46,58,-12,44
East Fife,5762,7,13,3,20,48,67,-19,42
Forfar,5762,8,10,5,21,38,65,-27,35
Queen's Park,5762,9,7,10,19,41,73,-32,31
Albion,5762,10,8,6,22,57,83,-26,30
Raith,5763,1,22,9,5,68,32,36,75
Ayr,5763,2,23,4,9,92,45,47,73
Alloa,5763,3,17,9,10,56,43,13,60
Arbroath,5763,4,17,8,11,72,51,21,59
Stranraer,5763,5,15,5,16,56,66,-10,50
East Fife,5763,6,14,3,19,49,65,-16,45
Airdrieon,5763,7,11,11,14,47,58,-11,44
Forfar,5763,8,10,5,21,38,66,-28,35
Albion,5763,9,9,6,21,60,80,-20,33
Queen's Park,5763,10,7,10,19,42,74,-32,31
Ayr,5764,1,23,5,8,91,43,48,74
Raith,5764,2,22,8,6,69,34,35,74
Alloa,5764,3,18,8,10,58,44,14,62
Arbroath,5764,4,17,9,10,72,50,22,60
Stranraer,5764,5,16,5,15,57,65,-8,53
Airdrieon,5764,6,11,11,14,49,60,-11,44
East Fife,5764,7,13,3,20,48,66,-18,42
Forfar,5764,8,10,5,21,40,68,-28,35
Albion,5764,9,8,7,21,58,79,-21,31
Queen's Park,5764,10,6,11,19,41,74,-33,29
Raith,5765,1,23,8,5,70,32,38,77
Ayr,5765,2,24,4,8,93,42,51,76
Arbroath,5765,3,17,8,11,71,50,21,59
Alloa,5765,4,17,8,11,56,45,11,59
Stranraer,5765,5,15,6,15,56,65,-9,51
Airdrieon,5765,6,11,11,14,49,58,-9,44
East Fife,5765,7,13,4,19,48,65,-17,43
Forfar,5765,8,10,5,21,38,68,-30,35
Queen's Park,5765,9,7,10,19,41,73,-32,31
Albion,5765,10,8,6,22,57,81,-24,30
Ayr,5766,1,24,4,8,94,45,49,76
Raith,5766,2,22,9,5,69,33,36,75
Arbroath,5766,3,18,8,10,74,49,25,62
Alloa,5766,4,17,9,10,57,44,13,60
Stranraer,5766,5,16,5,15,57,64,-7,53
Airdrieon,5766,6,10,12,14,48,61,-13,42
East Fife,5766,7,13,3,20,47,66,-19,42
Forfar,5766,8,10,6,20,41,67,-26,36
Albion,5766,9,8,6,22,60,82,-22,30
Queen's Park,5766,10,6,10,20,40,76,-36,28
Ayr,5767,1,23,5,8,91,43,48,74
Raith,5767,2,22,8,6,68,34,34,74
Alloa,5767,3,18,8,10,58,43,15,62
Arbroath,5767,4,17,8,11,70,50,20,59
Stranraer,5767,5,15,5,16,55,65,-10,50
East Fife,5767,6,14,3,19,48,64,-16,45
Airdrieon,5767,7,11,11,14,47,59,-12,44
Forfar,5767,8,10,5,21,39,66,-27,35
Albion,5767,9,8,7,21,58,79,-21,31
Queen's Park,5767,10,7,10,19,41,72,-31,31
Raith,5768,1,23,8,5,70,33,37,77
Ayr,5768,2,24,4,8,94,43,51,76
Arbroath,5768,3,18,8,10,71,48,23,62
Alloa,5768,4,17,8,11,57,45,12,59
Stranraer,5768,5,16,5,15,58,65,-7,53
East Fife,5768,6,13,3,20,48,67,-19,42
Airdrieon,5768,7,10,11,15,46,60,-14,41
Forfar,5768,8,11,5,20,40,65,-25,38
Albion,5768,9,8,6,22,58,82,-24,30
Queen's Park,5768,10,6,10,20,39,73,-34,28
Ayr,5769,1,24,4,8,93,43,50,76
Raith,5769,2,22,8,6,69,34,35,74
Alloa,5769,3,18,8,10,58,44,14,62
Arbroath,5769,4,17,9,10,72,50,22,60
Stranraer,5769,5,16,5,15,57,65,-8,53
Airdrieon,5769,6,11,11,14,46,58,-12,44
East Fife,5769,7,13,3,20,48,66,-18,42
Forfar,5769,8,10,5,21,38,65,-27,35
Albion,5769,9,8,6,22,58,81,-23,30
Queen's Park,5769,10,6,11,19,41,74,-33,29
Raith,5770,1,23,8,5,72,32,40,77
Ayr,5770,2,24,4,8,96,44,52,76
Arbroath,5770,3,18,8,10,76,48,28,62
Alloa,5770,4,17,8,11,56,47,9,59
Stranraer,5770,5,16,5,15,57,64,-7,53
Airdrieon,5770,6,11,11,14,47,58,-11,44
East Fife,5770,7,13,3,20,47,66,-19,42
Forfar,5770,8,10,5,21,38,66,-28,35
Albion,5770,9,8,6,22,59,84,-25,30
Queen's Park,5770,10,6,10,20,39,78,-39,28
Ayr,5771,1,24,4,8,93,42,51,76
Raith,5771,2,22,9,5,70,34,36,75
Arbroath,5771,3,17,9,10,72,50,22,60
Alloa,5771,4,17,9,10,58,45,13,60
Stranraer,5771,5,15,6,15,56,65,-9,51
Airdrieon,5771,6,11,11,14,47,58,-11,44
East Fife,5771,7,13,4,19,48,65,-17,43
Forfar,5771,8,10,5,21,38,66,-28,35
Albion,5771,9,8,6,22,57,81,-24,30
Queen's Park,5771,10,6,11,19,41,74,-33,29
Raith,5772,1,23,8,5,69,32,37,77
Ayr,5772,2,23,4,9,91,45,46,73
Arbroath,5772,3,17,8,11,72,51,21,59
Alloa,5772,4,17,8,11,56,44,12,59
Stranraer,5772,5,15,6,15,55,64,-9,51
Airdrieon,5772,6,11,11,14,47,58,-11,44
East Fife,5772,7,13,4,19,47,64,-17,43
Forfar,5772,8,10,5,21,38,66,-28,35
Albion,5772,9,9,6,21,60,79,-19,33
Queen's Park,5772,10,7,10,19,42,74,-32,31
Ayr,5773,1,23,5,8,93,45,48,74
Raith,5773,2,22,8,6,68,33,35,74
Alloa,5773,3,18,8,10,57,43,14,62
Arbroath,5773,4,17,9,10,71,49,22,60
Stranraer,5773,5,15,6,15,56,65,-9,51
Airdrieon,5773,6,11,11,14,48,59,-11,44
East Fife,5773,7,13,4,19,48,65,-17,43
Forfar,5773,8,10,5,21,39,67,-28,35
Albion,5773,9,8,7,21,60,81,-21,31
Queen's Park,5773,10,6,11,19,40,73,-33,29
Raith,5774,1,23,8,5,72,33,39,77
Ayr,5774,2,24,4,8,95,42,53,76
Arbroath,5774,3,17,9,10,71,49,22,60
Alloa,5774,4,17,8,11,57,47,10,59
Stranraer,5774,5,15,5,16,55,65,-10,50
East Fife,5774,6,14,3,19,48,64,-16,45
Airdrieon,5774,7,10,11,15,46,60,-14,41
Forfar,5774,8,11,5,20,40,65,-25,38
Albion,5774,9,8,6,22,57,83,-26,30
Queen's Park,5774,10,6,11,19,40,73,-33,29
Ayr,5775,1,24,4,8,94,43,51,76
Raith,5775,2,22,8,6,68,33,35,74
Alloa,5775,3,18,8,10,57,43,14,62
Arbroath,5775,4,17,8,11,71,50,21,59
Stranraer,5775,5,15,5,16,57,67,-10,50
East Fife,5775,6,14,3,19,50,66,-16,45
Airdrieon,5775,7,11,11,14,48,58,-10,44
Forfar,5775,8,10,5,21,38,67,-29,35
Queen's Park,5775,9,7,10,19,41,73,-32,31
Albion,5775,10,8,6,22,58,82,-24,30
Ayr,5776,1,24,4,8,96,43,53,76
Raith,5776,2,22,8,6,68,34,34,74
Arbroath,5776,3,18,8,10,76,50,26,62
Alloa,5776,4,18,8,10,58,43,15,62
Stranraer,5776,5,16,5,15,56,64,-8,53
Airdrieon,5776,6,11,11,14,48,60,-12,44
East Fife,5776,7,13,3,20,47,65,-18,42
Forfar,5776,8,10,5,21,40,67,-27,35
Albion,5776,9,8,6,22,58,84,-26,30
Queen's Park,5776,10,6,10,20,41,78,-37,28
Raith,5777,1,23,8,5,69,32,37,77
Ayr,5777,2,24,4,8,93,43,50,76
Arbroath,5777,3,18,8,10,74,48,26,62
Alloa,5777,4,17,8,11,56,44,12,59
Stranraer,5777,5,16,5,15,57,65,-8,53
Airdrieon,5777,6,11,11,14,51,58,-7,44
East Fife,5777,7,13,3,20,48,66,-18,42
Forfar,5777,8,10,5,21,38,70,-32,35
Albion,5777,9,8,6,22,58,81,-23,30
Queen's Park,5777,10,6,10,20,39,76,-37,28
Raith,5778,1,23,8,5,71,34,37,77
Ayr,5778,2,24,4,8,92,43,49,76
Arbroath,5778,3,17,9,10,71,49,22,60
Alloa,5778,4,17,8,11,58,46,12,59
Stranraer,5778,5,16,5,15,57,65,-8,53
Airdrieon,5778,6,11,11,14,48,58,-10,44
East Fife,5778,7,13,3,20,48,66,-18,42
Forfar,5778,8,10,5,21,38,67,-29,35
Albion,5778,9,8,6,22,58,80,-22,30
Queen's Park,5778,10,6,11,19,40,73,-33,29
Raith,5779,1,23,8,5,71,33,38,77
Ayr,5779,2,24,4,8,93,43,50,76
Arbroath,5779,3,17,9,10,71,49,22,60
Alloa,5779,4,17,8,11,57,46,11,59
Stranraer,5779,5,15,5,16,55,66,-11,50
East Fife,5779,6,14,3,19,49,64,-15,45
Airdrieon,5779,7,11,11,14,46,58,-12,44
Forfar,5779,8,10,5,21,38,65,-27,35
Albion,5779,9,8,6,22,58,81,-23,30
Queen's Park,5779,10,6,11,19,40,73,-33,29
Raith,5780,1,23,8,5,70,33,37,77
Ayr,5780,2,24,4,8,96,44,52,76
Arbroath,5780,3,17,9,10,70,48,22,60
Alloa,5780,4,17,8,11,57,45,12,59
Stranraer,5780,5,15,5,16,56,66,-10,50
East Fife,5780,6,14,3,19,49,65,-16,45
Airdrieon,5780,7,10,11,15,47,61,-14,41
Forfar,5780,8,11,5,20,41,66,-25,38
Albion,5780,9,8,6,22,59,84,-25,30
Queen's Park,5780,10,6,11,19,39,72,-33,29
Raith,5781,1,23,8,5,69,32,37,77
Ayr,5781,2,24,4,8,94,43,51,76
Arbroath,5781,3,17,8,11,70,50,20,59
Alloa,5781,4,17,8,11,56,44,12,59
Stranraer,5781,5,15,5,16,56,66,-10,50
East Fife,5781,6,14,3,19,49,65,-16,45
Airdrieon,5781,7,10,11,15,45,59,-14,41
Forfar,5781,8,11,5,20,39,64,-25,38
Queen's Park,5781,9,7,10,19,41,72,-31,31
Albion,5781,10,8,6,22,58,82,-24,30
Raith,5782,1,23,8,5,71,32,39,77
Ayr,5782,2,23,4,9,92,45,47,73
Arbroath,5782,3,17,9,10,71,49,22,60
Alloa,5782,4,17,8,11,56,46,10,59
Stranraer,5782,5,16,5,15,57,65,-8,53
Airdrieon,5782,6,11,11,14,48,59,-11,44
East Fife,5782,7,13,3,20,48,66,-18,42
Forfar,5782,8,10,5,21,39,67,-28,35
Albion,5782,9,9,6,21,60,80,-20,33
Queen's Park,5782,10,6,11,19,40,73,-33,29
Raith,5783,1,23,8,5,71,33,38,77
Ayr,5783,2,23,4,9,91,44,47,73
Arbroath,5783,3,18,8,10,72,48,24,62
Alloa,5783,4,17,8,11,57,46,11,59
Stranraer,5783,5,15,5,16,55,67,-12,50
East Fife,5783,6,14,3,19,50,64,-14,45
Airdrieon,5783,7,11,11,14,51,59,-8,44
Forfar,5783,8,10,5,21,39,70,-31,35
Albion,5783,9,9,6,21,59,79,-20,33
Queen's Park,5783,10,6,10,20,39,74,-35,28
Ayr,5784,1,24,4,8,91,42,49,76
Raith,5784,2,22,9,5,68,32,36,75
Arbroath,5784,3,18,8,10,72,48,24,62
Alloa,5784,4,17,9,10,56,43,13,60
Stranraer,5784,5,15,5,16,58,68,-10,50
East Fife,5784,6,14,3,19,51,67,-16,45
Airdrieon,5784,7,10,11,15,46,60,-14,41
Forfar,5784,8,11,5,20,40,65,-25,38
Albion,5784,9,8,6,22,57,79,-22,30
Queen's Park,5784,10,6,10,20,39,74,-35,28
Raith,5785,1,22,9,5,70,34,36,75
Ayr,5785,2,23,4,9,93,49,44,73
Arbroath,5785,3,18,8,10,74,48,26,62
Alloa,5785,4,17,9,10,58,45,13,60
Stranraer,5785,5,16,5,15,56,64,-8,53
East Fife,5785,6,13,3,20,47,65,-18,42
Airdrieon,5785,7,10,11,15,45,59,-14,41
Forfar,5785,8,11,5,20,39,64,-25,38
Albion,5785,9,9,6,21,64,81,-17,33
Queen's Park,5785,10,6,10,20,39,76,-37,28
Raith,5786,1,22,9,5,69,33,36,75
Ayr,5786,2,23,5,8,92,44,48,74
Arbroath,5786,3,18,8,10,73,50,23,62
Alloa,5786,4,17,9,10,57,44,13,60
Stranraer,5786,5,16,5,15,58,64,-6,53
Airdrieon,5786,6,11,11,14,46,58,-12,44
East Fife,5786,7,13,3,20,47,67,-20,42
Forfar,5786,8,10,5,21,38,65,-27,35
Albion,5786,9,8,7,21,59,80,-21,31
Queen's Park,5786,10,6,10,20,41,75,-34,28
Raith,5787,1,23,8,5,70,33,37,77
Ayr,5787,2,23,4,9,90,46,44,73
Arbroath,5787,3,17,9,10,71,49,22,60
Alloa,5787,4,17,8,11,57,45,12,59
Stranraer,5787,5,16,5,15,57,65,-8,53
East Fife,5787,6,13,3,20,48,66,-18,42
Airdrieon,5787,7,10,11,15,46,61,-15,41
Forfar,5787,8,11,5,20,41,65,-24,38
Albion,5787,9,9,6,21,61,78,-17,33
Queen's Park,5787,10,6,11,19,40,73,-33,29
Raith,5788,1,23,8,5,69,32,37,77
Ayr,5788,2,24,4,8,95,43,52,76
Arbroath,5788,3,18,8,10,71,48,23,62
Alloa,5788,4,17,8,11,56,44,12,59
Stranraer,5788,5,15,5,16,55,66,-11,50
East Fife,5788,6,14,3,19,49,64,-15,45
Airdrieon,5788,7,10,11,15,45,59,-14,41
Forfar,5788,8,11,5,20,39,64,-25,38
Albion,5788,9,8,6,22,58,83,-25,30
Queen's Park,5788,10,6,10,20,39,73,-34,28
Raith,5789,1,23,8,5,72,32,40,77
Ayr,5789,2,24,4,8,94,42,52,76
Arbroath,5789,3,18,8,10,71,48,23,62
Alloa,5789,4,17,8,11,56,47,9,59
Stranraer,5789,5,16,5,15,56,64,-8,53
Airdrieon,5789,6,11,11,14,47,58,-11,44
East Fife,5789,7,13,3,20,47,65,-18,42
Forfar,5789,8,10,5,21,38,66,-28,35
Albion,5789,9,8,6,22,57,82,-25,30
Queen's Park,5789,10,6,10,20,39,73,-34,28
Raith,5790,1,22,9,5,69,33,36,75
Ayr,5790,2,23,4,9,93,47,46,73
Arbroath,5790,3,18,8,10,75,49,26,62
Alloa,5790,4,17,9,10,57,44,13,60
Stranraer,5790,5,16,5,15,57,65,-8,53
Airdrieon,5790,6,11,11,14,47,59,-12,44
East Fife,5790,7,13,3,20,48,66,-18,42
Forfar,5790,8,10,5,21,39,66,-27,35
Albion,5790,9,9,6,21,62,81,-19,33
Queen's Park,5790,10,6,10,20,40,77,-37,28
Raith,5791,1,23,8,5,70,33,37,77
Ayr,5791,2,24,4,8,95,42,53,76
Arbroath,5791,3,17,9,10,71,49,22,60
Alloa,5791,4,17,8,11,57,45,12,59
Stranraer,5791,5,15,6,15,57,66,-9,51
East Fife,5791,6,13,4,19,49,66,-17,43
Airdrieon,5791,7,10,11,15,45,59,-14,41
Forfar,5791,8,11,5,20,39,64,-25,38
Albion,5791,9,8,6,22,57,83,-26,30
Queen's Park,5791,10,6,11,19,40,73,-33,29
Raith,5792,1,23,8,5,69,32,37,77
Ayr,5792,2,24,4,8,93,43,50,76
Arbroath,5792,3,17,9,10,72,50,22,60
Alloa,5792,4,17,8,11,56,44,12,59
Stranraer,5792,5,15,5,16,56,69,-13,50
East Fife,5792,6,14,3,19,52,65,-13,45
Airdrieon,5792,7,11,11,14,47,58,-11,44
Forfar,5792,8,10,5,21,38,66,-28,35
Albion,5792,9,8,6,22,58,81,-23,30
Queen's Park,5792,10,6,11,19,41,74,-33,29
Raith,5793,1,23,8,5,71,32,39,77
Ayr,5793,2,23,4,9,92,46,46,73
Arbroath,5793,3,17,9,10,72,50,22,60
Alloa,5793,4,17,8,11,56,46,10,59
Stranraer,5793,5,16,5,15,58,66,-8,53
Airdrieon,5793,6,10,12,14,46,59,-13,42
East Fife,5793,7,13,3,20,49,67,-18,42
Forfar,5793,8,10,6,20,39,65,-26,36
Albion,5793,9,9,6,21,61,80,-19,33
Queen's Park,5793,10,6,11,19,41,74,-33,29
Raith,5794,1,23,8,5,70,33,37,77
Ayr,5794,2,24,4,8,92,43,49,76
Arbroath,5794,3,18,8,10,74,50,24,62
Alloa,5794,4,17,8,11,57,45,12,59
Stranraer,5794,5,15,5,16,55,66,-11,50
East Fife,5794,6,14,3,19,49,64,-15,45
Airdrieon,5794,7,10,11,15,45,59,-14,41
Forfar,5794,8,11,5,20,39,64,-25,38
Albion,5794,9,8,6,22,58,80,-22,30
Queen's Park,5794,10,6,10,20,41,76,-35,28
Raith,5795,1,23,8,5,70,32,38,77
Ayr,5795,2,24,4,8,93,43,50,76
Arbroath,5795,3,18,8,10,76,49,27,62
Alloa,5795,4,17,8,11,56,45,11,59
Stranraer,5795,5,15,6,15,55,64,-9,51
Airdrieon,5795,6,11,11,14,48,58,-10,44
East Fife,5795,7,13,4,19,47,64,-17,43
Forfar,5795,8,10,5,21,38,67,-29,35
Albion,5795,9,8,6,22,58,81,-23,30
Queen's Park,5795,10,6,10,20,40,78,-38,28
Ayr,5796,1,23,5,8,92,44,48,74
Raith,5796,2,22,8,6,68,34,34,74
Alloa,5796,3,18,8,10,58,43,15,62
Arbroath,5796,4,17,9,10,71,49,22,60
Stranraer,5796,5,15,6,15,56,65,-9,51
Airdrieon,5796,6,11,11,14,47,59,-12,44
East Fife,5796,7,13,4,19,48,65,-17,43
Forfar,5796,8,10,5,21,39,66,-27,35
Albion,5796,9,8,7,21,59,80,-21,31
Queen's Park,5796,10,6,11,19,40,73,-33,29
Raith,5797,1,22,8,6,70,35,35,74
Ayr,5797,2,23,4,9,91,44,47,73
Arbroath,5797,3,18,8,10,74,49,25,62
Alloa,5797,4,18,8,10,59,45,14,62
Stranraer,5797,5,15,5,16,55,65,-10,50
East Fife,5797,6,14,3,19,48,64,-16,45
Airdrieon,5797,7,11,11,14,48,58,-10,44
Forfar,5797,8,10,5,21,38,67,-29,35
Albion,5797,9,9,6,21,59,79,-20,33
Queen's Park,5797,10,6,10,20,40,76,-36,28
Ayr,5798,1,24,4,8,95,45,50,76
Raith,5798,2,22,8,6,68,33,35,74
Arbroath,5798,3,18,8,10,72,48,24,62
Alloa,5798,4,18,8,10,57,43,14,62
Stranraer,5798,5,15,6,15,57,66,-9,51
East Fife,5798,6,13,4,19,49,66,-17,43
Airdrieon,5798,7,10,11,15,45,59,-14,41
Forfar,5798,8,11,5,20,39,64,-25,38
Albion,5798,9,8,6,22,60,83,-23,30
Queen's Park,5798,10,6,10,20,39,74,-35,28
Raith,5799,1,23,8,5,72,32,40,77
Ayr,5799,2,24,4,8,95,43,52,76
Arbroath,5799,3,17,8,11,72,52,20,59
Alloa,5799,4,17,8,11,56,47,9,59
Stranraer,5799,5,16,5,15,57,65,-8,53
Airdrieon,5799,6,11,11,14,49,58,-9,44
East Fife,5799,7,13,3,20,48,66,-18,42
Forfar,5799,8,10,5,21,38,68,-30,35
Queen's Park,5799,9,7,10,19,43,74,-31,31
Albion,5799,10,8,6,22,58,83,-25,30
Raith,5800,1,23,8,5,69,32,37,77
Ayr,5800,2,23,4,9,92,45,47,73
Arbroath,5800,3,17,8,11,70,49,21,59
Alloa,5800,4,17,8,11,56,44,12,59
Stranraer,5800,5,16,5,15,58,64,-6,53
Airdrieon,5800,6,11,11,14,49,61,-12,44
East Fife,5800,7,13,3,20,47,67,-20,42
Forfar,5800,8,10,5,21,41,68,-27,35
Albion,5800,9,9,6,21,60,80,-20,33
Queen's Park,5800,10,7,10,19,40,72,-32,31
Raith,5801,1,23,8,5,72,33,39,77
Ayr,5801,2,24,4,8,93,43,50,76
Arbroath,5801,3,18,8,10,73,49,24,62
Alloa,5801,4,17,8,11,57,47,10,59
Stranraer,5801,5,16,5,15,57,65,-8,53
Airdrieon,5801,6,10,12,14,46,59,-13,42
East Fife,5801,7,13,3,20,48,66,-18,42
Forfar,5801,8,10,6,20,39,65,-26,36
Albion,5801,9,8,6,22,58,81,-23,30
Queen's Park,5801,10,6,10,20,40,75,-35,28
Ayr,5802,1,24,4,8,95,43,52,76
Raith,5802,2,22,9,5,69,33,36,75
Arbroath,5802,3,18,8,10,75,49,26,62
Alloa,5802,4,17,9,10,57,44,13,60
Stranraer,5802,5,15,6,15,56,65,-9,51
East Fife,5802,6,13,4,19,48,65,-17,43
Airdrieon,5802,7,10,12,14,47,60,-13,42
Forfar,5802,8,10,6,20,40,66,-26,36
Albion,5802,9,8,6,22,58,83,-25,30
Queen's Park,5802,10,6,10,20,40,77,-37,28
Raith,5803,1,23,8,5,69,32,37,77
Ayr,5803,2,24,4,8,92,43,49,76
Arbroath,5803,3,17,8,11,70,49,21,59
Alloa,5803,4,17,8,11,56,44,12,59
Stranraer,5803,5,16,5,15,57,65,-8,53
Airdrieon,5803,6,10,12,14,47,60,-13,42
East Fife,5803,7,13,3,20,48,66,-18,42
Forfar,5803,8,10,6,20,40,66,-26,36
Queen's Park,5803,9,7,10,19,40,72,-32,31
Albion,5803,10,8,6,22,58,80,-22,30
Raith,5804,1,23,8,5,71,33,38,77
Ayr,5804,2,24,4,8,97,42,55,76
Arbroath,5804,3,17,8,11,70,50,20,59
Alloa,5804,4,17,8,11,57,46,11,59
Stranraer,5804,5,15,5,16,56,67,-11,50
East Fife,5804,6,14,3,19,50,65,-15,45
Airdrieon,5804,7,10,12,14,46,59,-13,42
Forfar,5804,8,10,6,20,39,65,-26,36
Queen's Park,5804,9,7,10,19,41,72,-31,31
Albion,5804,10,8,6,22,57,85,-28,30
Raith,5805,1,23,8,5,69,32,37,77
Ayr,5805,2,24,4,8,93,43,50,76
Arbroath,5805,3,18,8,10,73,50,23,62
Alloa,5805,4,17,8,11,56,44,12,59
Stranraer,5805,5,16,5,15,58,65,-7,53
Airdrieon,5805,6,10,12,14,46,59,-13,42
East Fife,5805,7,13,3,20,48,67,-19,42
Forfar,5805,8,10,6,20,39,65,-26,36
Albion,5805,9,8,6,22,58,81,-23,30
Queen's Park,5805,10,6,10,20,41,75,-34,28
Raith,5806,1,23,8,5,71,33,38,77
Ayr,5806,2,24,4,8,95,42,53,76
Arbroath,5806,3,18,8,10,72,49,23,62
Alloa,5806,4,17,8,11,57,46,11,59
Stranraer,5806,5,15,5,16,55,67,-12,50
East Fife,5806,6,14,3,19,50,64,-14,45
Airdrieon,5806,7,10,11,15,45,60,-15,41
Forfar,5806,8,11,5,20,40,64,-24,38
Albion,5806,9,8,6,22,57,83,-26,30
Queen's Park,5806,10,6,10,20,40,74,-34,28
Raith,5807,1,23,8,5,71,34,37,77
Ayr,5807,2,23,5,8,91,43,48,74
Arbroath,5807,3,17,8,11,70,49,21,59
Alloa,5807,4,17,8,11,58,46,12,59
Stranraer,5807,5,16,5,15,57,64,-7,53
Airdrieon,5807,6,10,12,14,45,58,-13,42
East Fife,5807,7,13,3,20,47,66,-19,42
Forfar,5807,8,10,6,20,38,64,-26,36
Albion,5807,9,8,7,21,58,79,-21,31
Queen's Park,5807,10,7,10,19,40,72,-32,31
Raith,5808,1,23,8,5,69,32,37,77
Ayr,5808,2,24,4,8,92,42,50,76
Arbroath,5808,3,17,8,11,70,49,21,59
Alloa,5808,4,17,8,11,56,44,12,59
Stranraer,5808,5,16,5,15,59,64,-5,53
Airdrieon,5808,6,10,12,14,45,58,-13,42
East Fife,5808,7,13,3,20,47,68,-21,42
Forfar,5808,8,10,6,20,38,64,-26,36
Queen's Park,5808,9,7,10,19,40,72,-32,31
Albion,5808,10,8,6,22,57,80,-23,30
Raith,5809,1,23,8,5,72,33,39,77
Ayr,5809,2,24,4,8,98,42,56,76
Arbroath,5809,3,18,8,10,71,48,23,62
Alloa,5809,4,17,8,11,57,47,10,59
Stranraer,5809,5,15,6,15,57,66,-9,51
Airdrieon,5809,6,11,11,14,47,59,-12,44
East Fife,5809,7,13,4,19,49,66,-17,43
Forfar,5809,8,10,5,21,39,66,-27,35
Albion,5809,9,8,6,22,57,86,-29,30
Queen's Park,5809,10,6,10,20,39,73,-34,28
Ayr,5810,1,24,4,8,93,44,49,76
Raith,5810,2,22,8,6,68,33,35,74
Alloa,5810,3,18,8,10,57,43,14,62
Arbroath,5810,4,17,9,10,72,50,22,60
Stranraer,5810,5,15,5,16,55,66,-11,50
East Fife,5810,6,14,3,19,49,64,-15,45
Airdrieon,5810,7,10,12,14,45,58,-13,42
Forfar,5810,8,10,6,20,38,64,-26,36
Albion,5810,9,8,6,22,59,81,-22,30
Queen's Park,5810,10,6,11,19,41,74,-33,29
Ayr,5811,1,23,5,8,92,44,48,74
Raith,5811,2,22,8,6,70,36,34,74
Alloa,5811,3,18,8,10,60,45,15,62
Arbroath,5811,4,17,9,10,70,48,22,60
Stranraer,5811,5,15,5,16,55,66,-11,50
East Fife,5811,6,14,3,19,49,64,-15,45
Airdrieon,5811,7,11,11,14,46,58,-12,44
Forfar,5811,8,10,5,21,38,65,-27,35
Albion,5811,9,8,7,21,59,80,-21,31
Queen's Park,5811,10,6,11,19,39,72,-33,29
Raith,5812,1,23,8,5,72,34,38,77
Ayr,5812,2,23,5,8,95,47,48,74
Arbroath,5812,3,18,8,10,72,48,24,62
Alloa,5812,4,17,8,11,58,47,11,59
Stranraer,5812,5,15,5,16,56,66,-10,50
East Fife,5812,6,14,3,19,49,65,-16,45
Airdrieon,5812,7,10,12,14,45,58,-13,42
Forfar,5812,8,10,6,20,38,64,-26,36
Albion,5812,9,8,7,21,62,83,-21,31
Queen's Park,5812,10,6,10,20,39,74,-35,28
Raith,5813,1,23,8,5,70,33,37,77
Ayr,5813,2,23,4,9,92,45,47,73
Arbroath,5813,3,17,9,10,73,51,22,60
Alloa,5813,4,17,8,11,57,45,12,59
Stranraer,5813,5,15,5,16,56,66,-10,50
East Fife,5813,6,14,3,19,49,65,-16,45
Airdrieon,5813,7,10,11,15,45,59,-14,41
Forfar,5813,8,11,5,20,39,64,-25,38
Albion,5813,9,9,6,21,60,80,-20,33
Queen's Park,5813,10,6,11,19,42,75,-33,29
Raith,5814,1,23,8,5,69,32,37,77
Ayr,5814,2,23,4,9,92,45,47,73
Arbroath,5814,3,17,8,11,70,50,20,59
Alloa,5814,4,17,8,11,56,44,12,59
Stranraer,5814,5,16,5,15,59,65,-6,53
Airdrieon,5814,6,11,11,14,47,59,-12,44
East Fife,5814,7,13,3,20,48,68,-20,42
Forfar,5814,8,10,5,21,39,66,-27,35
Albion,5814,9,9,6,21,60,80,-20,33
Queen's Park,5814,10,7,10,19,41,72,-31,31
Raith,5815,1,23,8,5,70,32,38,77
Ayr,5815,2,23,4,9,91,44,47,73
Arbroath,5815,3,18,8,10,74,48,26,62
Alloa,5815,4,17,8,11,56,45,11,59
Stranraer,5815,5,15,5,16,55,66,-11,50
East Fife,5815,6,14,3,19,49,64,-15,45
Airdrieon,5815,7,10,11,15,45,59,-14,41
Forfar,5815,8,11,5,20,39,64,-25,38
Albion,5815,9,9,6,21,59,79,-20,33
Queen's Park,5815,10,6,10,20,39,76,-37,28
Ayr,5816,1,23,5,8,91,43,48,74
Raith,5816,2,22,8,6,69,34,35,74
Arbroath,5816,3,18,8,10,72,48,24,62
Alloa,5816,4,18,8,10,58,44,14,62
Stranraer,5816,5,15,5,16,55,65,-10,50
East Fife,5816,6,14,3,19,48,64,-16,45
Airdrieon,5816,7,11,11,14,47,59,-12,44
Forfar,5816,8,10,5,21,39,66,-27,35
Albion,5816,9,8,7,21,58,79,-21,31
Queen's Park,5816,10,6,10,20,39,74,-35,28
Raith,5817,1,23,8,5,70,33,37,77
Ayr,5817,2,23,5,8,91,43,48,74
Arbroath,5817,3,18,8,10,72,49,23,62
Alloa,5817,4,17,8,11,57,45,12,59
Stranraer,5817,5,15,5,16,55,66,-11,50
East Fife,5817,6,14,3,19,49,64,-15,45
Airdrieon,5817,7,11,11,14,46,58,-12,44
Forfar,5817,8,10,5,21,38,65,-27,35
Albion,5817,9,8,7,21,58,79,-21,31
Queen's Park,5817,10,6,10,20,40,74,-34,28
Raith,5818,1,23,8,5,71,32,39,77
Ayr,5818,2,24,4,8,94,42,52,76
Arbroath,5818,3,18,8,10,73,49,24,62
Alloa,5818,4,17,8,11,56,46,10,59
Stranraer,5818,5,15,5,16,55,65,-10,50
East Fife,5818,6,14,3,19,48,64,-16,45
Airdrieon,5818,7,11,11,14,48,59,-11,44
Forfar,5818,8,10,5,21,39,67,-28,35
Albion,5818,9,8,6,22,57,82,-25,30
Queen's Park,5818,10,6,10,20,40,75,-35,28
Ayr,5819,1,24,4,8,94,42,52,76
Raith,5819,2,22,8,6,68,34,34,74
Arbroath,5819,3,18,8,10,75,50,25,62
Alloa,5819,4,18,8,10,58,43,15,62
Stranraer,5819,5,15,6,15,56,65,-9,51
East Fife,5819,6,13,4,19,48,65,-17,43
Airdrieon,5819,7,10,11,15,46,60,-14,41
Forfar,5819,8,11,5,20,40,65,-25,38
Albion,5819,9,8,6,22,57,82,-25,30
Queen's Park,5819,10,6,10,20,41,77,-36,28
Ayr,5820,1,24,4,8,92,42,50,76
Raith,5820,2,22,9,5,69,33,36,75
Alloa,5820,3,17,9,10,57,44,13,60
Arbroath,5820,4,17,8,11,70,51,19,59
Stranraer,5820,5,15,6,15,55,64,-9,51
Airdrieon,5820,6,11,11,14,48,58,-10,44
East Fife,5820,7,13,4,19,47,64,-17,43
Forfar,5820,8,10,5,21,38,67,-29,35
Queen's Park,5820,9,7,10,19,42,72,-30,31
Albion,5820,10,8,6,22,57,80,-23,30
Raith,5821,1,23,8,5,69,32,37,77
Ayr,5821,2,24,4,8,93,42,51,76
Arbroath,5821,3,18,8,10,72,49,23,62
Alloa,5821,4,17,8,11,56,44,12,59
Stranraer,5821,5,15,5,16,57,67,-10,50
East Fife,5821,6,14,3,19,50,66,-16,45
Airdrieon,5821,7,11,11,14,48,58,-10,44
Forfar,5821,8,10,5,21,38,67,-29,35
Albion,5821,9,8,6,22,57,81,-24,30
Queen's Park,5821,10,6,10,20,40,74,-34,28
Ayr,5822,1,24,4,8,93,43,50,76
Raith,5822,2,22,8,6,69,35,34,74
Alloa,5822,3,18,8,10,59,44,15,62
Arbroath,5822,4,17,9,10,70,48,22,60
Stranraer,5822,5,15,6,15,56,65,-9,51
Airdrieon,5822,6,11,11,14,48,59,-11,44
East Fife,5822,7,13,4,19,48,65,-17,43
Forfar,5822,8,10,5,21,39,67,-28,35
Albion,5822,9,8,6,22,58,81,-23,30
Queen's Park,5822,10,6,11,19,39,72,-33,29
Ayr,5823,1,24,4,8,97,44,53,76
Raith,5823,2,22,9,5,68,32,36,75
Arbroath,5823,3,17,9,10,71,49,22,60
Alloa,5823,4,17,9,10,56,43,13,60
Stranraer,5823,5,16,5,15,57,65,-8,53
East Fife,5823,6,13,3,20,48,66,-18,42
Airdrieon,5823,7,10,11,15,45,59,-14,41
Forfar,5823,8,11,5,20,39,64,-25,38
Albion,5823,9,8,6,22,59,85,-26,30
Queen's Park,5823,10,6,11,19,40,73,-33,29
Raith,5824,1,23,8,5,70,33,37,77
Ayr,5824,2,24,4,8,93,42,51,76
Arbroath,5824,3,18,8,10,72,49,23,62
Alloa,5824,4,17,8,11,57,45,12,59
Stranraer,5824,5,15,6,15,55,64,-9,51
Airdrieon,5824,6,11,11,14,48,58,-10,44
East Fife,5824,7,13,4,19,47,64,-17,43
Forfar,5824,8,10,5,21,38,67,-29,35
Albion,5824,9,8,6,22,57,81,-24,30
Queen's Park,5824,10,6,10,20,40,74,-34,28
Raith,5825,1,23,8,5,72,32,40,77
Ayr,5825,2,24,4,8,92,43,49,76
Arbroath,5825,3,18,8,10,73,48,25,62
Alloa,5825,4,17,8,11,56,47,9,59
Stranraer,5825,5,15,5,16,55,67,-12,50
East Fife,5825,6,14,3,19,50,64,-14,45
Airdrieon,5825,7,11,11,14,47,59,-12,44
Forfar,5825,8,10,5,21,39,66,-27,35
Albion,5825,9,8,6,22,58,80,-22,30
Queen's Park,5825,10,6,10,20,39,75,-36,28
Ayr,5826,1,24,4,8,93,42,51,76
Raith,5826,2,22,9,5,68,32,36,75
Alloa,5826,3,17,9,10,56,43,13,60
Arbroath,5826,4,17,8,11,71,50,21,59
Stranraer,5826,5,16,5,15,57,65,-8,53
Airdrieon,5826,6,10,12,14,46,59,-13,42
East Fife,5826,7,13,3,20,48,66,-18,42
Forfar,5826,8,10,6,20,39,65,-26,36
Queen's Park,5826,9,7,10,19,41,73,-32,31
Albion,5826,10,8,6,22,57,81,-24,30
Raith,5827,1,23,8,5,69,32,37,77
Ayr,5827,2,24,4,8,92,42,50,76
Arbroath,5827,3,18,8,10,73,48,25,62
Alloa,5827,4,17,8,11,56,44,12,59
Stranraer,5827,5,15,5,16,57,67,-10,50
East Fife,5827,6,14,3,19,50,66,-16,45
Airdrieon,5827,7,10,12,14,47,60,-13,42
Forfar,5827,8,10,6,20,40,66,-26,36
Albion,5827,9,8,6,22,57,80,-23,30
Queen's Park,5827,10,6,10,20,39,75,-36,28
Ayr,5828,1,24,4,8,99,42,57,76
Raith,5828,2,22,8,6,69,34,35,74
Alloa,5828,3,18,8,10,58,44,14,62
Arbroath,5828,4,17,9,10,72,50,22,60
Stranraer,5828,5,15,6,15,55,64,-9,51
Airdrieon,5828,6,11,11,14,47,59,-12,44
East Fife,5828,7,13,4,19,47,64,-17,43
Forfar,5828,8,10,5,21,39,66,-27,35
Albion,5828,9,8,6,22,57,87,-30,30
Queen's Park,5828,10,6,11,19,41,74,-33,29
Raith,5829,1,23,8,5,71,33,38,77
Ayr,5829,2,23,5,8,90,42,48,74
Arbroath,5829,3,18,8,10,72,48,24,62
Alloa,5829,4,17,8,11,57,46,11,59
Stranraer,5829,5,15,6,15,55,64,-9,51
Airdrieon,5829,6,11,11,14,47,59,-12,44
East Fife,5829,7,13,4,19,47,64,-17,43
Forfar,5829,8,10,5,21,39,66,-27,35
Albion,5829,9,8,7,21,57,78,-21,31
Queen's Park,5829,10,6,10,20,39,74,-35,28
Ayr,5830,1,24,4,8,93,43,50,76
Raith,5830,2,22,8,6,68,33,35,74
Arbroath,5830,3,18,8,10,72,49,23,62
Alloa,5830,4,18,8,10,57,43,14,62
Stranraer,5830,5,16,5,15,57,65,-8,53
Airdrieon,5830,6,11,11,14,48,59,-11,44
East Fife,5830,7,13,3,20,48,66,-18,42
Forfar,5830,8,10,5,21,39,67,-28,35
Albion,5830,9,8,6,22,58,81,-23,30
Queen's Park,5830,10,6,10,20,40,74,-34,28
Raith,5831,1,22,9,5,68,32,36,75
Ayr,5831,2,23,4,9,92,45,47,73
Alloa,5831,3,17,9,10,56,43,13,60
Arbroath,5831,4,17,8,11,70,51,19,59
Stranraer,5831,5,16,5,15,57,64,-7,53
East Fife,5831,6,13,3,20,47,66,-19,42
Airdrieon,5831,7,10,11,15,45,59,-14,41
Forfar,5831,8,11,5,20,39,64,-25,38
Albion,5831,9,9,6,21,60,80,-20,33
Queen's Park,5831,10,7,10,19,42,72,-30,31
Raith,5832,1,23,8,5,70,32,38,77
Ayr,5832,2,24,4,8,94,43,51,76
Arbroath,5832,3,18,8,10,72,48,24,62
Alloa,5832,4,17,8,11,56,45,11,59
Stranraer,5832,5,16,5,15,58,66,-8,53
Airdrieon,5832,6,11,11,14,48,58,-10,44
East Fife,5832,7,13,3,20,49,67,-18,42
Forfar,5832,8,10,5,21,38,67,-29,35
Albion,5832,9,8,6,22,58,82,-24,30
Queen's Park,5832,10,6,10,20,39,74,-35,28
Raith,5833,1,23,8,5,71,32,39,77
Ayr,5833,2,24,4,8,96,42,54,76
Arbroath,5833,3,18,8,10,72,49,23,62
Alloa,5833,4,17,8,11,56,46,10,59
Stranraer,5833,5,15,5,16,55,67,-12,50
East Fife,5833,6,14,3,19,50,64,-14,45
Airdrieon,5833,7,11,11,14,47,58,-11,44
Forfar,5833,8,10,5,21,38,66,-28,35
Albion,5833,9,8,6,22,57,84,-27,30
Queen's Park,5833,10,6,10,20,40,74,-34,28
Raith,5834,1,22,9,5,70,34,36,75
Ayr,5834,2,23,5,8,92,44,48,74
Alloa,5834,3,17,9,10,58,45,13,60
Arbroath,5834,4,17,8,11,70,55,15,59
Stranraer,5834,5,15,5,16,55,66,-11,50
East Fife,5834,6,14,3,19,49,64,-15,45
Airdrieon,5834,7,10,11,15,45,60,-15,41
Forfar,5834,8,11,5,20,40,64,-24,38
Albion,5834,9,8,7,21,59,80,-21,31
Queen's Park,5834,10,7,10,19,46,72,-26,31
Raith,5835,1,23,8,5,74,34,40,77
Ayr,5835,2,24,4,8,92,43,49,76
Arbroath,5835,3,17,9,10,73,51,22,60
Alloa,5835,4,17,8,11,58,49,9,59
Stranraer,5835,5,15,5,16,57,67,-10,50
East Fife,5835,6,14,3,19,50,66,-16,45
Airdrieon,5835,7,11,11,14,47,58,-11,44
Forfar,5835,8,10,5,21,38,66,-28,35
Albion,5835,9,8,6,22,58,80,-22,30
Queen's Park,5835,10,6,11,19,42,75,-33,29
Raith,5836,1,23,8,5,70,33,37,77
Ayr,5836,2,24,4,8,94,42,52,76
Arbroath,5836,3,18,8,10,71,48,23,62
Alloa,5836,4,17,8,11,57,45,12,59
Stranraer,5836,5,16,5,15,59,66,-7,53
East Fife,5836,6,13,3,20,49,68,-19,42
Airdrieon,5836,7,10,11,15,45,59,-14,41
Forfar,5836,8,11,5,20,39,64,-25,38
Albion,5836,9,8,6,22,57,82,-25,30
Queen's Park,5836,10,6,10,20,39,73,-34,28
Raith,5837,1,23,8,5,72,34,38,77
Ayr,5837,2,24,4,8,95,44,51,76
Arbroath,5837,3,18,8,10,71,48,23,62
Alloa,5837,4,17,8,11,58,47,11,59
Stranraer,5837,5,16,5,15,60,64,-4,53
Airdrieon,5837,6,11,11,14,47,58,-11,44
East Fife,5837,7,13,3,20,47,69,-22,42
Forfar,5837,8,10,5,21,38,66,-28,35
Albion,5837,9,8,6,22,59,83,-24,30
Queen's Park,5837,10,6,10,20,39,73,-34,28
Ayr,5838,1,24,4,8,94,43,51,76
Raith,5838,2,22,9,5,69,33,36,75
Arbroath,5838,3,18,8,10,71,48,23,62
Alloa,5838,4,17,9,10,57,44,13,60
Stranraer,5838,5,15,5,16,55,67,-12,50
East Fife,5838,6,14,3,19,50,64,-14,45
Airdrieon,5838,7,10,11,15,45,59,-14,41
Forfar,5838,8,11,5,20,39,64,-25,38
Albion,5838,9,8,6,22,58,82,-24,30
Queen's Park,5838,10,6,10,20,39,73,-34,28
Ayr,5839,1,24,4,8,94,42,52,76
Raith,5839,2,22,9,5,69,33,36,75
Arbroath,5839,3,18,8,10,71,48,23,62
Alloa,5839,4,17,9,10,57,44,13,60
Stranraer,5839,5,16,5,15,56,64,-8,53
Airdrieon,5839,6,11,11,14,49,58,-9,44
East Fife,5839,7,13,3,20,47,65,-18,42
Forfar,5839,8,10,5,21,38,68,-30,35
Albion,5839,9,8,6,22,57,82,-25,30
Queen's Park,5839,10,6,10,20,39,73,-34,28
Raith,5840,1,23,8,5,71,34,37,77
Ayr,5840,2,23,4,9,91,45,46,73
Arbroath,5840,3,17,8,11,71,51,20,59
Alloa,5840,4,17,8,11,58,46,12,59
Stranraer,5840,5,15,5,16,55,65,-10,50
East Fife,5840,6,14,3,19,48,64,-16,45
Airdrieon,5840,7,10,11,15,46,60,-14,41
Forfar,5840,8,11,5,20,40,65,-25,38
Albion,5840,9,9,6,21,60,79,-19,33
Queen's Park,5840,10,7,10,19,42,73,-31,31
Ayr,5841,1,24,4,8,91,42,49,76
Raith,5841,2,22,8,6,69,34,35,74
Arbroath,5841,3,18,8,10,75,49,26,62
Alloa,5841,4,18,8,10,58,44,14,62
Stranraer,5841,5,16,5,15,59,64,-5,53
Airdrieon,5841,6,11,11,14,48,59,-11,44
East Fife,5841,7,13,3,20,47,68,-21,42
Forfar,5841,8,10,5,21,39,67,-28,35
Albion,5841,9,8,6,22,57,79,-22,30
Queen's Park,5841,10,6,10,20,40,77,-37,28
Ayr,5842,1,24,4,8,93,42,51,76
Raith,5842,2,22,8,6,68,34,34,74
Arbroath,5842,3,18,8,10,72,48,24,62
Alloa,5842,4,18,8,10,58,43,15,62
Stranraer,5842,5,16,5,15,58,64,-6,53
East Fife,5842,6,13,3,20,47,67,-20,42
Airdrieon,5842,7,10,11,15,46,60,-14,41
Forfar,5842,8,11,5,20,40,65,-25,38
Albion,5842,9,8,6,22,57,81,-24,30
Queen's Park,5842,10,6,10,20,39,74,-35,28
Raith,5843,1,23,8,5,70,32,38,77
Ayr,5843,2,24,4,8,97,45,52,76
Arbroath,5843,3,18,8,10,73,48,25,62
Alloa,5843,4,17,8,11,56,45,11,59
Stranraer,5843,5,15,6,15,55,64,-9,51
Airdrieon,5843,6,11,11,14,49,58,-9,44
East Fife,5843,7,13,4,19,47,64,-17,43
Forfar,5843,8,10,5,21,38,68,-30,35
Albion,5843,9,8,6,22,60,85,-25,30
Queen's Park,5843,10,6,10,20,39,75,-36,28
Ayr,5844,1,24,4,8,94,42,52,76
Raith,5844,2,22,8,6,68,34,34,74
Alloa,5844,3,18,8,10,58,43,15,62
Arbroath,5844,4,17,9,10,72,50,22,60
Stranraer,5844,5,16,5,15,58,65,-7,53
Airdrieon,5844,6,11,11,14,48,60,-12,44
East Fife,5844,7,13,3,20,48,67,-19,42
Forfar,5844,8,10,5,21,40,67,-27,35
Albion,5844,9,8,6,22,57,82,-25,30
Queen's Park,5844,10,6,11,19,41,74,-33,29
Raith,5845,1,23,8,5,70,33,37,77
Ayr,5845,2,24,4,8,93,42,51,76
Arbroath,5845,3,18,8,10,75,49,26,62
Alloa,5845,4,17,8,11,57,45,12,59
Stranraer,5845,5,15,5,16,55,66,-11,50
East Fife,5845,6,14,3,19,49,64,-15,45
Airdrieon,5845,7,11,11,14,48,60,-12,44
Forfar,5845,8,10,5,21,40,67,-27,35
Albion,5845,9,8,6,22,57,81,-24,30
Queen's Park,5845,10,6,10,20,40,77,-37,28
Raith,5846,1,23,8,5,71,33,38,77
Ayr,5846,2,24,4,8,93,42,51,76
Arbroath,5846,3,18,8,10,73,48,25,62
Alloa,5846,4,17,8,11,57,46,11,59
Stranraer,5846,5,15,5,16,57,67,-10,50
East Fife,5846,6,14,3,19,50,66,-16,45
Airdrieon,5846,7,10,12,14,46,59,-13,42
Forfar,5846,8,10,6,20,39,65,-26,36
Albion,5846,9,8,6,22,57,81,-24,30
Queen's Park,5846,10,6,10,20,39,75,-36,28
Raith,5847,1,22,9,5,70,34,36,75
Ayr,5847,2,23,5,8,91,43,48,74
Arbroath,5847,3,18,8,10,72,48,24,62
Alloa,5847,4,17,9,10,58,45,13,60
Stranraer,5847,5,15,6,15,55,64,-9,51
Airdrieon,5847,6,11,11,14,47,59,-12,44
East Fife,5847,7,13,4,19,47,64,-17,43
Forfar,5847,8,10,5,21,39,66,-27,35
Albion,5847,9,8,7,21,58,79,-21,31
Queen's Park,5847,10,6,10,20,39,74,-35,28
Ayr,5848,1,24,4,8,95,43,52,76
Raith,5848,2,22,8,6,68,33,35,74
Arbroath,5848,3,18,8,10,72,48,24,62
Alloa,5848,4,18,8,10,57,43,14,62
Stranraer,5848,5,15,5,16,55,65,-10,50
East Fife,5848,6,14,3,19,48,64,-16,45
Airdrieon,5848,7,10,12,14,46,59,-13,42
Forfar,5848,8,10,6,20,39,65,-26,36
Albion,5848,9,8,6,22,58,83,-25,30
Queen's Park,5848,10,6,10,20,39,74,-35,28
Raith,5849,1,22,8,6,70,35,35,74
Ayr,5849,2,23,4,9,91,45,46,73
Arbroath,5849,3,18,8,10,73,48,25,62
Alloa,5849,4,18,8,10,59,45,14,62
Stranraer,5849,5,15,6,15,56,65,-9,51
East Fife,5849,6,13,4,19,48,65,-17,43
Airdrieon,5849,7,10,11,15,46,61,-15,41
Forfar,5849,8,11,5,20,41,65,-24,38
Albion,5849,9,9,6,21,60,79,-19,33
Queen's Park,5849,10,6,10,20,39,75,-36,28
Raith,5850,1,23,8,5,70,32,38,77
Ayr,5850,2,24,4,8,91,42,49,76
Arbroath,5850,3,18,8,10,73,48,25,62
Alloa,5850,4,17,8,11,56,45,11,59
Stranraer,5850,5,16,5,15,57,65,-8,53
Airdrieon,5850,6,10,12,14,45,58,-13,42
East Fife,5850,7,13,3,20,48,66,-18,42
Forfar,5850,8,10,6,20,38,64,-26,36
Albion,5850,9,8,6,22,57,79,-22,30
Queen's Park,5850,10,6,10,20,39,75,-36,28
Ayr,5851,1,24,4,8,93,42,51,76
Raith,5851,2,22,9,5,69,33,36,75
Arbroath,5851,3,18,8,10,72,49,23,62
Alloa,5851,4,17,9,10,57,44,13,60
Stranraer,5851,5,15,5,16,55,65,-10,50
East Fife,5851,6,14,3,19,48,64,-16,45
Airdrieon,5851,7,11,11,14,46,58,-12,44
Forfar,5851,8,10,5,21,38,65,-27,35
Albion,5851,9,8,6,22,57,81,-24,30
Queen's Park,5851,10,6,10,20,40,74,-34,28
Raith,5852,1,23,8,5,69,32,37,77
Ayr,5852,2,24,4,8,94,44,50,76
Arbroath,5852,3,18,8,10,74,48,26,62
Alloa,5852,4,17,8,11,56,44,12,59
Stranraer,5852,5,15,6,15,59,68,-9,51
East Fife,5852,6,13,4,19,51,68,-17,43
Airdrieon,5852,7,10,12,14,46,59,-13,42
Forfar,5852,8,10,6,20,39,65,-26,36
Albion,5852,9,8,6,22,59,82,-23,30
Queen's Park,5852,10,6,10,20,39,76,-37,28
Ayr,5853,1,24,4,8,93,42,51,76
Raith,5853,2,22,8,6,68,33,35,74
Arbroath,5853,3,18,8,10,72,49,23,62
Alloa,5853,4,18,8,10,57,43,14,62
Stranraer,5853,5,15,6,15,56,65,-9,51
Airdrieon,5853,6,11,11,14,48,60,-12,44
East Fife,5853,7,13,4,19,48,65,-17,43
Forfar,5853,8,10,5,21,40,67,-27,35
Albion,5853,9,8,6,22,57,81,-24,30
Queen's Park,5853,10,6,10,20,40,74,-34,28
Raith,5854,1,23,8,5,71,32,39,77
Ayr,5854,2,24,4,8,96,43,53,76
Arbroath,5854,3,17,8,11,71,50,21,59
Alloa,5854,4,17,8,11,56,46,10,59
Stranraer,5854,5,15,5,16,56,68,-12,50
East Fife,5854,6,14,3,19,51,65,-14,45
Airdrieon,5854,7,10,11,15,47,61,-14,41
Forfar,5854,8,11,5,20,41,66,-25,38
Queen's Park,5854,9,7,10,19,41,73,-32,31
Albion,5854,10,8,6,22,58,84,-26,30
Raith,5855,1,23,8,5,70,33,37,77
Ayr,5855,2,23,4,9,92,46,46,73
Arbroath,5855,3,17,8,11,70,49,21,59
Alloa,5855,4,17,8,11,57,45,12,59
Stranraer,5855,5,15,5,16,55,66,-11,50
East Fife,5855,6,14,3,19,49,64,-15,45
Airdrieon,5855,7,11,11,14,46,58,-12,44
Forfar,5855,8,10,5,21,38,65,-27,35
Albion,5855,9,9,6,21,61,80,-19,33
Queen's Park,5855,10,7,10,19,40,72,-32,31
Raith,5856,1,23,8,5,71,33,38,77
Ayr,5856,2,23,5,8,90,42,48,74
Arbroath,5856,3,17,8,11,70,50,20,59
Alloa,5856,4,17,8,11,57,46,11,59
Stranraer,5856,5,15,5,16,55,65,-10,50
East Fife,5856,6,14,3,19,48,64,-16,45
Airdrieon,5856,7,11,11,14,46,58,-12,44
Forfar,5856,8,10,5,21,38,65,-27,35
Albion,5856,9,8,7,21,57,78,-21,31
Queen's Park,5856,10,7,10,19,41,72,-31,31
Ayr,5857,1,24,4,8,96,44,52,76
Raith,5857,2,22,8,6,68,34,34,74
Alloa,5857,3,18,8,10,58,43,15,62
Arbroath,5857,4,17,8,11,72,51,21,59
Stranraer,5857,5,15,6,15,55,64,-9,51
East Fife,5857,6,13,4,19,47,64,-17,43
Airdrieon,5857,7,10,12,14,47,60,-13,42
Forfar,5857,8,10,6,20,40,66,-26,36
Queen's Park,5857,9,7,10,19,42,74,-32,31
Albion,5857,10,8,6,22,59,84,-25,30
Raith,5858,1,23,8,5,70,33,37,77
Ayr,5858,2,24,4,8,93,43,50,76
Arbroath,5858,3,18,8,10,74,49,25,62
Alloa,5858,4,17,8,11,57,45,12,59
Stranraer,5858,5,16,5,15,58,66,-8,53
East Fife,5858,6,13,3,20,49,67,-18,42
Airdrieon,5858,7,10,11,15,45,60,-15,41
Forfar,5858,8,11,5,20,40,64,-24,38
Albion,5858,9,8,6,22,58,81,-23,30
Queen's Park,5858,10,6,10,20,40,76,-36,28
Raith,5859,1,22,9,5,68,32,36,75
Ayr,5859,2,23,5,8,92,44,48,74
Arbroath,5859,3,18,8,10,72,48,24,62
Alloa,5859,4,17,9,10,56,43,13,60
Stranraer,5859,5,15,5,16,56,67,-11,50
East Fife,5859,6,14,3,19,50,65,-15,45
Airdrieon,5859,7,11,11,14,48,59,-11,44
Forfar,5859,8,10,5,21,39,67,-28,35
Albion,5859,9,8,7,21,59,80,-21,31
Queen's Park,5859,10,6,10,20,39,74,-35,28
Ayr,5860,1,24,4,8,95,44,51,76
Raith,5860,2,22,8,6,68,34,34,74
Alloa,5860,3,18,8,10,58,43,15,62
Arbroath,5860,4,17,9,10,70,48,22,60
Stranraer,5860,5,16,5,15,57,65,-8,53
Airdrieon,5860,6,10,12,14,46,59,-13,42
East Fife,5860,7,13,3,20,48,66,-18,42
Forfar,5860,8,10,6,20,39,65,-26,36
Albion,5860,9,8,6,22,59,83,-24,30
Queen's Park,5860,10,6,11,19,39,72,-33,29
Raith,5861,1,23,8,5,71,32,39,77
Ayr,5861,2,24,4,8,94,43,51,76
Arbroath,5861,3,17,9,10,71,49,22,60
Alloa,5861,4,17,8,11,56,46,10,59
Stranraer,5861,5,15,5,16,56,67,-11,50
East Fife,5861,6,14,3,19,50,65,-15,45
Airdrieon,5861,7,11,11,14,48,59,-11,44
Forfar,5861,8,10,5,21,39,67,-28,35
Albion,5861,9,8,6,22,58,82,-24,30
Queen's Park,5861,10,6,11,19,40,73,-33,29
Raith,5862,1,22,8,6,69,36,33,74
Ayr,5862,2,23,4,9,92,45,47,73
Arbroath,5862,3,18,8,10,71,48,23,62
Alloa,5862,4,18,8,10,60,44,16,62
Stranraer,5862,5,16,5,15,57,64,-7,53
Airdrieon,5862,6,11,11,14,47,58,-11,44
East Fife,5862,7,13,3,20,47,66,-19,42
Forfar,5862,8,10,5,21,38,66,-28,35
Albion,5862,9,9,6,21,60,80,-20,33
Queen's Park,5862,10,6,10,20,39,73,-34,28
Ayr,5863,1,24,4,8,94,43,51,76
Raith,5863,2,22,9,5,68,32,36,75
Arbroath,5863,3,18,8,10,72,48,24,62
Alloa,5863,4,17,9,10,56,43,13,60
Stranraer,5863,5,16,5,15,57,64,-7,53
East Fife,5863,6,13,3,20,47,66,-19,42
Airdrieon,5863,7,10,11,15,45,62,-17,41
Forfar,5863,8,11,5,20,42,64,-22,38
Albion,5863,9,8,6,22,58,82,-24,30
Queen's Park,5863,10,6,10,20,39,74,-35,28
Ayr,5864,1,24,4,8,95,43,52,76
Raith,5864,2,22,8,6,70,35,35,74
Arbroath,5864,3,18,8,10,75,48,27,62
Alloa,5864,4,18,8,10,59,45,14,62
Stranraer,5864,5,16,5,15,58,65,-7,53
Airdrieon,5864,6,11,11,14,46,58,-12,44
East Fife,5864,7,13,3,20,48,67,-19,42
Forfar,5864,8,10,5,21,38,65,-27,35
Albion,5864,9,8,6,22,58,83,-25,30
Queen's Park,5864,10,6,10,20,39,77,-38,28
Ayr,5865,1,24,4,8,95,43,52,76
Raith,5865,2,22,9,5,68,32,36,75
Alloa,5865,3,17,9,10,56,43,13,60
Arbroath,5865,4,17,8,11,70,50,20,59
Stranraer,5865,5,16,5,15,57,65,-8,53
Airdrieon,5865,6,11,11,14,46,58,-12,44
East Fife,5865,7,13,3,20,48,66,-18,42
Forfar,5865,8,10,5,21,38,65,-27,35
Queen's Park,5865,9,7,10,19,41,72,-31,31
Albion,5865,10,8,6,22,58,83,-25,30
Raith,5866,1,23,8,5,74,33,41,77
Ayr,5866,2,24,4,8,93,44,49,76
Arbroath,5866,3,17,8,11,71,50,21,59
Alloa,5866,4,17,8,11,57,49,8,59
Stranraer,5866,5,16,5,15,56,64,-8,53
Airdrieon,5866,6,11,11,14,47,58,-11,44
East Fife,5866,7,13,3,20,47,65,-18,42
Forfar,5866,8,10,5,21,38,66,-28,35
Queen's Park,5866,9,7,10,19,41,73,-32,31
Albion,5866,10,8,6,22,59,81,-22,30
Raith,5867,1,23,8,5,74,32,42,77
Ayr,5867,2,23,5,8,91,43,48,74
Arbroath,5867,3,17,8,11,71,50,21,59
Alloa,5867,4,17,8,11,56,49,7,59
Stranraer,5867,5,16,5,15,56,64,-8,53
East Fife,5867,6,13,3,20,47,65,-18,42
Airdrieon,5867,7,10,11,15,46,60,-14,41
Forfar,5867,8,11,5,20,40,65,-25,38
Albion,5867,9,8,7,21,58,79,-21,31
Queen's Park,5867,10,7,10,19,41,73,-32,31
Ayr,5868,1,24,4,8,93,42,51,76
Raith,5868,2,22,8,6,69,35,34,74
Alloa,5868,3,18,8,10,59,44,15,62
Arbroath,5868,4,17,8,11,70,51,19,59
Stranraer,5868,5,15,5,16,56,66,-10,50
East Fife,5868,6,14,3,19,49,65,-16,45
Airdrieon,5868,7,10,11,15,45,60,-15,41
Forfar,5868,8,11,5,20,40,64,-24,38
Queen's Park,5868,9,7,10,19,42,72,-30,31
Albion,5868,10,8,6,22,57,81,-24,30
Raith,5869,1,23,8,5,70,32,38,77
Ayr,5869,2,23,4,9,90,43,47,73
Arbroath,5869,3,17,8,11,70,49,21,59
Alloa,5869,4,17,8,11,56,45,11,59
Stranraer,5869,5,15,6,15,57,66,-9,51
Airdrieon,5869,6,11,11,14,48,59,-11,44
East Fife,5869,7,13,4,19,49,66,-17,43
Forfar,5869,8,10,5,21,39,67,-28,35
Albion,5869,9,9,6,21,58,78,-20,33
Queen's Park,5869,10,7,10,19,40,72,-32,31
Raith,5870,1,23,8,5,72,34,38,77
Ayr,5870,2,24,4,8,95,44,51,76
Arbroath,5870,3,17,9,10,73,51,22,60
Alloa,5870,4,17,8,11,58,47,11,59
Stranraer,5870,5,15,6,15,55,64,-9,51
Airdrieon,5870,6,11,11,14,47,59,-12,44
East Fife,5870,7,13,4,19,47,64,-17,43
Forfar,5870,8,10,5,21,39,66,-27,35
Albion,5870,9,8,6,22,59,83,-24,30
Queen's Park,5870,10,6,11,19,42,75,-33,29
Raith,5871,1,23,8,5,70,32,38,77
Ayr,5871,2,24,4,8,93,43,50,76
Arbroath,5871,3,17,8,11,74,53,21,59
Alloa,5871,4,17,8,11,56,45,11,59
Stranraer,5871,5,16,5,15,57,65,-8,53
East Fife,5871,6,13,3,20,48,66,-18,42
Airdrieon,5871,7,10,11,15,46,60,-14,41
Forfar,5871,8,11,5,20,40,65,-25,38
Queen's Park,5871,9,7,10,19,44,76,-32,31
Albion,5871,10,8,6,22,58,81,-23,30
Ayr,5872,1,24,4,8,95,43,52,76
Raith,5872,2,22,8,6,68,33,35,74
Arbroath,5872,3,18,8,10,76,48,28,62
Alloa,5872,4,18,8,10,57,43,14,62
Stranraer,5872,5,15,6,15,56,65,-9,51
East Fife,5872,6,13,4,19,48,65,-17,43
Airdrieon,5872,7,10,12,14,46,59,-13,42
Forfar,5872,8,10,6,20,39,65,-26,36
Albion,5872,9,8,6,22,58,83,-25,30
Queen's Park,5872,10,6,10,20,39,78,-39,28
Raith,5873,1,23,8,5,69,32,37,77
Ayr,5873,2,24,4,8,94,42,52,76
Arbroath,5873,3,17,8,11,71,50,21,59
Alloa,5873,4,17,8,11,56,44,12,59
Stranraer,5873,5,16,5,15,58,66,-8,53
Airdrieon,5873,6,11,11,14,49,60,-11,44
East Fife,5873,7,13,3,20,49,67,-18,42
Forfar,5873,8,10,5,21,40,68,-28,35
Queen's Park,5873,9,7,10,19,41,73,-32,31
Albion,5873,10,8,6,22,57,82,-25,30
Ayr,5874,1,24,4,8,94,43,51,76
Raith,5874,2,22,9,5,69,33,36,75
Alloa,5874,3,17,9,10,57,44,13,60
Arbroath,5874,4,17,8,11,71,53,18,59
Stranraer,5874,5,15,6,15,56,65,-9,51
Airdrieon,5874,6,11,11,14,50,58,-8,44
East Fife,5874,7,13,4,19,48,65,-17,43
Forfar,5874,8,10,5,21,38,69,-31,35
Queen's Park,5874,9,7,10,19,44,73,-29,31
Albion,5874,10,8,6,22,58,82,-24,30
Raith,5875,1,23,8,5,71,34,37,77
Ayr,5875,2,24,4,8,91,42,49,76
Arbroath,5875,3,18,8,10,75,48,27,62
Alloa,5875,4,17,8,11,58,46,12,59
Stranraer,5875,5,16,5,15,57,64,-7,53
Airdrieon,5875,6,11,11,14,48,58,-10,44
East Fife,5875,7,13,3,20,47,66,-19,42
Forfar,5875,8,10,5,21,38,67,-29,35
Albion,5875,9,8,6,22,57,79,-22,30
Queen's Park,5875,10,6,10,20,39,77,-38,28
Raith,5876,1,23,8,5,70,33,37,77
Ayr,5876,2,24,4,8,96,44,52,76
Arbroath,5876,3,17,8,11,72,51,21,59
Alloa,5876,4,17,8,11,57,45,12,59
Stranraer,5876,5,16,5,15,57,65,-8,53
Airdrieon,5876,6,11,11,14,47,58,-11,44
East Fife,5876,7,13,3,20,48,66,-18,42
Forfar,5876,8,10,5,21,38,66,-28,35
Queen's Park,5876,9,7,10,19,42,74,-32,31
Albion,5876,10,8,6,22,59,84,-25,30
Raith,5877,1,23,8,5,71,33,38,77
Ayr,5877,2,24,4,8,94,44,50,76
Arbroath,5877,3,17,9,10,71,49,22,60
Alloa,5877,4,17,8,11,57,46,11,59
Stranraer,5877,5,15,5,16,57,68,-11,50
East Fife,5877,6,14,3,19,51,66,-15,45
Airdrieon,5877,7,11,11,14,47,59,-12,44
Forfar,5877,8,10,5,21,39,66,-27,35
Albion,5877,9,8,6,22,59,82,-23,30
Queen's Park,5877,10,6,11,19,40,73,-33,29
Raith,5878,1,23,8,5,69,32,37,77
Ayr,5878,2,24,4,8,93,42,51,76
Arbroath,5878,3,17,8,11,71,51,20,59
Alloa,5878,4,17,8,11,56,44,12,59
Stranraer,5878,5,16,5,15,58,65,-7,53
Airdrieon,5878,6,11,11,14,47,59,-12,44
East Fife,5878,7,13,3,20,48,67,-19,42
Forfar,5878,8,10,5,21,39,66,-27,35
Queen's Park,5878,9,7,10,19,42,73,-31,31
Albion,5878,10,8,6,22,57,81,-24,30
Ayr,5879,1,24,4,8,96,43,53,76
Raith,5879,2,22,8,6,69,35,34,74
Arbroath,5879,3,18,8,10,73,50,23,62
Alloa,5879,4,18,8,10,59,44,15,62
Stranraer,5879,5,16,5,15,57,65,-8,53
East Fife,5879,6,13,3,20,48,66,-18,42
Airdrieon,5879,7,10,11,15,46,60,-14,41
Forfar,5879,8,11,5,20,40,65,-25,38
Albion,5879,9,8,6,22,58,84,-26,30
Queen's Park,5879,10,6,10,20,41,75,-34,28
Raith,5880,1,23,8,5,69,32,37,77
Ayr,5880,2,23,5,8,90,42,48,74
Arbroath,5880,3,18,8,10,75,51,24,62
Alloa,5880,4,17,8,11,56,44,12,59
Stranraer,5880,5,15,5,16,57,67,-10,50
East Fife,5880,6,14,3,19,50,66,-16,45
Airdrieon,5880,7,10,12,14,45,58,-13,42
Forfar,5880,8,10,6,20,38,64,-26,36
Albion,5880,9,8,7,21,57,78,-21,31
Queen's Park,5880,10,6,10,20,42,77,-35,28
Ayr,5881,1,24,4,8,92,43,49,76
Raith,5881,2,22,8,6,68,33,35,74
Arbroath,5881,3,18,8,10,72,49,23,62
Alloa,5881,4,18,8,10,57,43,14,62
Stranraer,5881,5,15,6,15,56,65,-9,51
East Fife,5881,6,13,4,19,48,65,-17,43
Airdrieon,5881,7,10,11,15,46,60,-14,41
Forfar,5881,8,11,5,20,40,65,-25,38
Albion,5881,9,8,6,22,58,80,-22,30
Queen's Park,5881,10,6,10,20,40,74,-34,28
Raith,5882,1,23,8,5,72,35,37,77
Ayr,5882,2,24,4,8,92,42,50,76
Arbroath,5882,3,18,8,10,71,48,23,62
Alloa,5882,4,17,8,11,59,47,12,59
Stranraer,5882,5,15,5,16,55,66,-11,50
East Fife,5882,6,14,3,19,49,64,-15,45
Airdrieon,5882,7,10,11,15,45,60,-15,41
Forfar,5882,8,11,5,20,40,64,-24,38
Albion,5882,9,8,6,22,57,80,-23,30
Queen's Park,5882,10,6,10,20,39,73,-34,28
Raith,5883,1,23,8,5,69,32,37,77
Ayr,5883,2,23,5,8,92,44,48,74
Arbroath,5883,3,18,8,10,72,48,24,62
Alloa,5883,4,17,8,11,56,44,12,59
Stranraer,5883,5,15,6,15,56,65,-9,51
East Fife,5883,6,13,4,19,48,65,-17,43
Airdrieon,5883,7,10,11,15,46,60,-14,41
Forfar,5883,8,11,5,20,40,65,-25,38
Albion,5883,9,8,7,21,59,80,-21,31
Queen's Park,5883,10,6,10,20,39,74,-35,28
Ayr,5884,1,24,4,8,93,43,50,76
Raith,5884,2,22,9,5,68,32,36,75
Arbroath,5884,3,18,8,10,71,48,23,62
Alloa,5884,4,17,9,10,56,43,13,60
Stranraer,5884,5,15,5,16,56,67,-11,50
East Fife,5884,6,14,3,19,50,65,-15,45
Airdrieon,5884,7,10,12,14,45,58,-13,42
Forfar,5884,8,10,6,20,38,64,-26,36
Albion,5884,9,8,6,22,58,81,-23,30
Queen's Park,5884,10,6,10,20,39,73,-34,28
Raith,5885,1,23,8,5,70,32,38,77
Ayr,5885,2,23,5,8,92,44,48,74
Arbroath,5885,3,18,8,10,75,50,25,62
Alloa,5885,4,17,8,11,56,45,11,59
Stranraer,5885,5,15,6,15,57,66,-9,51
Airdrieon,5885,6,11,11,14,49,59,-10,44
East Fife,5885,7,13,4,19,49,66,-17,43
Forfar,5885,8,10,5,21,39,68,-29,35
Albion,5885,9,8,7,21,59,80,-21,31
Queen's Park,5885,10,6,10,20,41,77,-36,28
Raith,5886,1,23,8,5,69,32,37,77
Ayr,5886,2,24,4,8,93,42,51,76
Arbroath,5886,3,17,9,10,72,50,22,60
Alloa,5886,4,17,8,11,56,44,12,59
Stranraer,5886,5,15,5,16,56,66,-10,50
East Fife,5886,6,14,3,19,49,65,-16,45
Airdrieon,5886,7,10,12,14,47,60,-13,42
Forfar,5886,8,10,6,20,40,66,-26,36
Albion,5886,9,8,6,22,57,81,-24,30
Queen's Park,5886,10,6,11,19,41,74,-33,29
Raith,5887,1,23,8,5,75,33,42,77
Ayr,5887,2,24,4,8,93,42,51,76
Arbroath,5887,3,17,9,10,70,48,22,60
Alloa,5887,4,17,8,11,57,50,7,59
Stranraer,5887,5,15,6,15,55,64,-9,51
East Fife,5887,6,13,4,19,47,64,-17,43
Airdrieon,5887,7,10,12,14,46,59,-13,42
Forfar,5887,8,10,6,20,39,65,-26,36
Albion,5887,9,8,6,22,57,81,-24,30
Queen's Park,5887,10,6,11,19,39,72,-33,29
Ayr,5888,1,24,4,8,93,43,50,76
Raith,5888,2,22,8,6,68,35,33,74
Alloa,5888,3,18,8,10,59,43,16,62
Arbroath,5888,4,17,8,11,70,49,21,59
Stranraer,5888,5,15,6,15,57,66,-9,51
East Fife,5888,6,13,4,19,49,66,-17,43
Airdrieon,5888,7,10,11,15,45,59,-14,41
Forfar,5888,8,11,5,20,39,64,-25,38
Queen's Park,5888,9,7,10,19,40,72,-32,31
Albion,5888,10,8,6,22,58,81,-23,30
Raith,5889,1,23,8,5,71,33,38,77
Ayr,5889,2,23,5,8,92,44,48,74
Arbroath,5889,3,17,8,11,70,49,21,59
Alloa,5889,4,17,8,11,57,46,11,59
Stranraer,5889,5,15,6,15,57,66,-9,51
Airdrieon,5889,6,11,11,14,48,58,-10,44
East Fife,5889,7,13,4,19,49,66,-17,43
Forfar,5889,8,10,5,21,38,67,-29,35
Albion,5889,9,8,7,21,59,80,-21,31
Queen's Park,5889,10,7,10,19,40,72,-32,31
Raith,5890,1,23,8,5,69,32,37,77
Ayr,5890,2,24,4,8,93,44,49,76
Arbroath,5890,3,18,8,10,73,50,23,62
Alloa,5890,4,17,8,11,56,44,12,59
Stranraer,5890,5,15,5,16,56,66,-10,50
East Fife,5890,6,14,3,19,49,65,-16,45
Airdrieon,5890,7,10,12,14,46,59,-13,42
Forfar,5890,8,10,6,20,39,65,-26,36
Albion,5890,9,8,6,22,59,81,-22,30
Queen's Park,5890,10,6,10,20,41,75,-34,28
Ayr,5891,1,24,4,8,97,43,54,76
Raith,5891,2,22,8,6,70,35,35,74
Alloa,5891,3,18,8,10,59,45,14,62
Arbroath,5891,4,17,8,11,73,52,21,59
Stranraer,5891,5,16,5,15,59,65,-6,53
East Fife,5891,6,13,3,20,48,68,-20,42
Airdrieon,5891,7,10,11,15,45,59,-14,41
Forfar,5891,8,11,5,20,39,64,-25,38
Queen's Park,5891,9,7,10,19,43,75,-32,31
Albion,5891,10,8,6,22,58,85,-27,30
Ayr,5892,1,23,5,8,91,43,48,74
Raith,5892,2,22,8,6,68,34,34,74
Alloa,5892,3,18,8,10,58,43,15,62
Arbroath,5892,4,17,8,11,71,51,20,59
Stranraer,5892,5,16,5,15,56,64,-8,53
Airdrieon,5892,6,10,12,14,45,58,-13,42
East Fife,5892,7,13,3,20,47,65,-18,42
Forfar,5892,8,10,6,20,38,64,-26,36
Albion,5892,9,8,7,21,58,79,-21,31
Queen's Park,5892,10,7,10,19,42,73,-31,31
Raith,5893,1,23,8,5,69,32,37,77
Ayr,5893,2,24,4,8,96,43,53,76
Arbroath,5893,3,17,9,10,70,48,22,60
Alloa,5893,4,17,8,11,56,44,12,59
Stranraer,5893,5,16,5,15,56,64,-8,53
Airdrieon,5893,6,11,11,14,46,58,-12,44
East Fife,5893,7,13,3,20,47,65,-18,42
Forfar,5893,8,10,5,21,38,65,-27,35
Albion,5893,9,8,6,22,58,84,-26,30
Queen's Park,5893,10,6,11,19,39,72,-33,29
Ayr,5894,1,24,4,8,95,44,51,76
Raith,5894,2,22,9,5,70,34,36,75
Arbroath,5894,3,18,8,10,74,48,26,62
Alloa,5894,4,17,9,10,58,45,13,60
Stranraer,5894,5,15,5,16,56,66,-10,50
East Fife,5894,6,14,3,19,49,65,-16,45
Airdrieon,5894,7,10,11,15,45,59,-14,41
Forfar,5894,8,11,5,20,39,64,-25,38
Albion,5894,9,8,6,22,59,83,-24,30
Queen's Park,5894,10,6,10,20,39,76,-37,28
Ayr,5895,1,23,5,8,91,43,48,74
Raith,5895,2,22,8,6,68,33,35,74
Alloa,5895,3,18,8,10,57,43,14,62
Arbroath,5895,4,17,8,11,72,51,21,59
Stranraer,5895,5,16,5,15,57,64,-7,53
Airdrieon,5895,6,11,11,14,46,58,-12,44
East Fife,5895,7,13,3,20,47,66,-19,42
Forfar,5895,8,10,5,21,38,65,-27,35
Albion,5895,9,8,7,21,58,79,-21,31
Queen's Park,5895,10,7,10,19,42,74,-32,31
Raith,5896,1,23,8,5,69,32,37,77
Ayr,5896,2,24,4,8,95,43,52,76
Arbroath,5896,3,18,8,10,71,48,23,62
Alloa,5896,4,17,8,11,56,44,12,59
Stranraer,5896,5,15,5,16,57,67,-10,50
East Fife,5896,6,14,3,19,50,66,-16,45
Airdrieon,5896,7,11,11,14,48,60,-12,44
Forfar,5896,8,10,5,21,40,67,-27,35
Albion,5896,9,8,6,22,58,83,-25,30
Queen's Park,5896,10,6,10,20,39,73,-34,28
Ayr,5897,1,24,4,8,96,43,53,76
Raith,5897,2,22,9,5,69,33,36,75
Alloa,5897,3,17,9,10,57,44,13,60
Arbroath,5897,4,17,8,11,71,50,21,59
Stranraer,5897,5,15,6,15,58,67,-9,51
East Fife,5897,6,13,4,19,50,67,-17,43
Airdrieon,5897,7,10,11,15,45,60,-15,41
Forfar,5897,8,11,5,20,40,64,-24,38
Queen's Park,5897,9,7,10,19,41,73,-32,31
Albion,5897,10,8,6,22,58,84,-26,30
Raith,5898,1,23,8,5,71,32,39,77
Ayr,5898,2,24,4,8,95,42,53,76
Arbroath,5898,3,18,8,10,73,49,24,62
Alloa,5898,4,17,8,11,56,46,10,59
Stranraer,5898,5,15,6,15,56,65,-9,51
East Fife,5898,6,13,4,19,48,65,-17,43
Airdrieon,5898,7,10,11,15,45,59,-14,41
Forfar,5898,8,11,5,20,39,64,-25,38
Albion,5898,9,8,6,22,57,83,-26,30
Queen's Park,5898,10,6,10,20,40,75,-35,28
Raith,5899,1,23,8,5,70,33,37,77
Ayr,5899,2,24,4,8,92,43,49,76
Arbroath,5899,3,18,8,10,71,48,23,62
Alloa,5899,4,17,8,11,57,45,12,59
Stranraer,5899,5,16,5,15,59,67,-8,53
East Fife,5899,6,13,3,20,50,68,-18,42
Airdrieon,5899,7,10,11,15,45,60,-15,41
Forfar,5899,8,11,5,20,40,64,-24,38
Albion,5899,9,8,6,22,58,80,-22,30
Queen's Park,5899,10,6,10,20,39,73,-34,28
Ayr,5900,1,24,4,8,93,42,51,76
Raith,5900,2,22,8,6,68,34,34,74
Alloa,5900,3,18,8,10,58,43,15,62
Arbroath,5900,4,17,8,11,71,50,21,59
Stranraer,5900,5,15,6,15,55,64,-9,51
East Fife,5900,6,13,4,19,47,64,-17,43
Airdrieon,5900,7,10,11,15,47,61,-14,41
Forfar,5900,8,11,5,20,41,66,-25,38
Queen's Park,5900,9,7,10,19,41,73,-32,31
Albion,5900,10,8,6,22,57,81,-24,30
Raith,5901,1,23,8,5,70,33,37,77
Ayr,5901,2,23,5,8,91,43,48,74
Arbroath,5901,3,18,8,10,74,49,25,62
Alloa,5901,4,17,8,11,57,45,12,59
Stranraer,5901,5,15,6,15,58,67,-9,51
East Fife,5901,6,13,4,19,50,67,-17,43
Airdrieon,5901,7,10,12,14,45,58,-13,42
Forfar,5901,8,10,6,20,38,64,-26,36
Albion,5901,9,8,7,21,58,79,-21,31
Queen's Park,5901,10,6,10,20,40,76,-36,28
Raith,5902,1,23,8,5,72,33,39,77
Ayr,5902,2,24,4,8,93,44,49,76
Arbroath,5902,3,17,8,11,71,51,20,59
Alloa,5902,4,17,8,11,57,47,10,59
Stranraer,5902,5,15,5,16,56,67,-11,50
East Fife,5902,6,14,3,19,50,65,-15,45
Airdrieon,5902,7,10,12,14,46,59,-13,42
Forfar,5902,8,10,6,20,39,65,-26,36
Queen's Park,5902,9,7,10,19,42,73,-31,31
Albion,5902,10,8,6,22,59,81,-22,30
Ayr,5903,1,24,4,8,94,44,50,76
Raith,5903,2,22,8,6,68,34,34,74
Alloa,5903,3,18,8,10,58,43,15,62
Arbroath,5903,4,17,8,11,72,52,20,59
Stranraer,5903,5,15,5,16,55,66,-11,50
East Fife,5903,6,14,3,19,49,64,-15,45
Airdrieon,5903,7,10,12,14,45,58,-13,42
Forfar,5903,8,10,6,20,38,64,-26,36
Queen's Park,5903,9,7,10,19,43,74,-31,31
Albion,5903,10,8,6,22,59,82,-23,30
Raith,5904,1,23,8,5,71,33,38,77
Ayr,5904,2,24,4,8,95,43,52,76
Arbroath,5904,3,18,8,10,73,50,23,62
Alloa,5904,4,17,8,11,57,46,11,59
Stranraer,5904,5,16,5,15,57,65,-8,53
Airdrieon,5904,6,10,12,14,46,59,-13,42
East Fife,5904,7,13,3,20,48,66,-18,42
Forfar,5904,8,10,6,20,39,65,-26,36
Albion,5904,9,8,6,22,58,83,-25,30
Queen's Park,5904,10,6,10,20,41,75,-34,28
Raith,5905,1,23,8,5,70,33,37,77
Ayr,5905,2,24,4,8,93,43,50,76
Arbroath,5905,3,18,8,10,73,49,24,62
Alloa,5905,4,17,8,11,57,45,12,59
Stranraer,5905,5,15,5,16,55,66,-11,50
East Fife,5905,6,14,3,19,49,64,-15,45
Airdrieon,5905,7,10,12,14,45,58,-13,42
Forfar,5905,8,10,6,20,38,64,-26,36
Albion,5905,9,8,6,22,58,81,-23,30
Queen's Park,5905,10,6,10,20,40,75,-35,28
Raith,5906,1,23,8,5,70,32,38,77
Ayr,5906,2,24,4,8,94,44,50,76
Arbroath,5906,3,18,8,10,73,48,25,62
Alloa,5906,4,17,8,11,56,45,11,59
Stranraer,5906,5,16,5,15,57,65,-8,53
Airdrieon,5906,6,11,11,14,48,59,-11,44
East Fife,5906,7,13,3,20,48,66,-18,42
Forfar,5906,8,10,5,21,39,67,-28,35
Albion,5906,9,8,6,22,59,82,-23,30
Queen's Park,5906,10,6,10,20,39,75,-36,28
Raith,5907,1,23,8,5,70,33,37,77
Ayr,5907,2,24,4,8,94,42,52,76
Arbroath,5907,3,18,8,10,74,48,26,62
Alloa,5907,4,17,8,11,57,45,12,59
Stranraer,5907,5,15,5,16,55,66,-11,50
East Fife,5907,6,14,3,19,49,64,-15,45
Airdrieon,5907,7,11,11,14,48,60,-12,44
Forfar,5907,8,10,5,21,40,67,-27,35
Albion,5907,9,8,6,22,57,82,-25,30
Queen's Park,5907,10,6,10,20,39,76,-37,28
Ayr,5908,1,24,4,8,93,44,49,76
Raith,5908,2,22,9,5,70,34,36,75
Arbroath,5908,3,18,8,10,72,48,24,62
Alloa,5908,4,17,9,10,58,45,13,60
Stranraer,5908,5,15,5,16,57,68,-11,50
East Fife,5908,6,14,3,19,51,66,-15,45
Airdrieon,5908,7,10,11,15,47,62,-15,41
Forfar,5908,8,11,5,20,42,66,-24,38
Albion,5908,9,8,6,22,59,81,-22,30
Queen's Park,5908,10,6,10,20,39,74,-35,28
Ayr,5909,1,24,4,8,93,44,49,76
Raith,5909,2,22,9,5,69,33,36,75
Alloa,5909,3,17,9,10,57,44,13,60
Arbroath,5909,4,17,8,11,70,49,21,59
Stranraer,5909,5,15,5,16,56,67,-11,50
East Fife,5909,6,14,3,19,50,65,-15,45
Airdrieon,5909,7,11,11,14,47,59,-12,44
Forfar,5909,8,10,5,21,39,66,-27,35
Queen's Park,5909,9,7,10,19,40,72,-32,31
Albion,5909,10,8,6,22,59,81,-22,30
Ayr,5910,1,24,4,8,93,44,49,76
Raith,5910,2,22,9,5,68,32,36,75
Alloa,5910,3,17,9,10,56,43,13,60
Arbroath,5910,4,17,8,11,70,49,21,59
Stranraer,5910,5,15,5,16,55,65,-10,50
East Fife,5910,6,14,3,19,48,64,-16,45
Airdrieon,5910,7,10,12,14,45,58,-13,42
Forfar,5910,8,10,6,20,38,64,-26,36
Queen's Park,5910,9,7,10,19,40,72,-32,31
Albion,5910,10,8,6,22,59,81,-22,30
Ayr,5911,1,24,4,8,92,42,50,76
Raith,5911,2,22,9,5,69,33,36,75
Arbroath,5911,3,18,8,10,73,49,24,62
Alloa,5911,4,17,9,10,57,44,13,60
Stranraer,5911,5,16,5,15,61,66,-5,53
East Fife,5911,6,13,3,20,49,70,-21,42
Airdrieon,5911,7,10,11,15,46,60,-14,41
Forfar,5911,8,11,5,20,40,65,-25,38
Albion,5911,9,8,6,22,57,80,-23,30
Queen's Park,5911,10,6,10,20,40,75,-35,28
Ayr,5912,1,24,4,8,93,42,51,76
Raith,5912,2,22,9,5,68,32,36,75
Arbroath,5912,3,18,8,10,72,49,23,62
Alloa,5912,4,17,9,10,56,43,13,60
Stranraer,5912,5,16,5,15,57,65,-8,53
Airdrieon,5912,6,11,11,14,46,58,-12,44
East Fife,5912,7,13,3,20,48,66,-18,42
Forfar,5912,8,10,5,21,38,65,-27,35
Albion,5912,9,8,6,22,57,81,-24,30
Queen's Park,5912,10,6,10,20,40,74,-34,28
Ayr,5913,1,24,4,8,92,42,50,76
Raith,5913,2,22,8,6,68,33,35,74
Arbroath,5913,3,18,8,10,74,49,25,62
Alloa,5913,4,18,8,10,57,43,14,62
Stranraer,5913,5,16,5,15,56,64,-8,53
Airdrieon,5913,6,11,11,14,49,59,-10,44
East Fife,5913,7,13,3,20,47,65,-18,42
Forfar,5913,8,10,5,21,39,68,-29,35
Albion,5913,9,8,6,22,57,80,-23,30
Queen's Park,5913,10,6,10,20,40,76,-36,28
Ayr,5914,1,24,4,8,91,42,49,76
Raith,5914,2,22,8,6,68,33,35,74
Arbroath,5914,3,18,8,10,72,49,23,62
Alloa,5914,4,18,8,10,57,43,14,62
Stranraer,5914,5,16,5,15,60,67,-7,53
Airdrieon,5914,6,11,11,14,48,60,-12,44
East Fife,5914,7,13,3,20,50,69,-19,42
Forfar,5914,8,10,5,21,40,67,-27,35
Albion,5914,9,8,6,22,57,79,-22,30
Queen's Park,5914,10,6,10,20,40,74,-34,28
Raith,5915,1,23,8,5,72,33,39,77
Ayr,5915,2,23,4,9,94,47,47,73
Arbroath,5915,3,17,8,11,71,51,20,59
Alloa,5915,4,17,8,11,57,47,10,59
Stranraer,5915,5,16,5,15,58,65,-7,53
Airdrieon,5915,6,10,12,14,47,60,-13,42
East Fife,5915,7,13,3,20,48,67,-19,42
Forfar,5915,8,10,6,20,40,66,-26,36
Albion,5915,9,9,6,21,62,82,-20,33
Queen's Park,5915,10,7,10,19,42,73,-31,31
Ayr,5916,1,24,4,8,97,43,54,76
Raith,5916,2,22,8,6,68,33,35,74
Alloa,5916,3,18,8,10,57,43,14,62
Arbroath,5916,4,17,9,10,73,51,22,60
Stranraer,5916,5,15,5,16,55,65,-10,50
East Fife,5916,6,14,3,19,48,64,-16,45
Airdrieon,5916,7,10,11,15,46,61,-15,41
Forfar,5916,8,11,5,20,41,65,-24,38
Albion,5916,9,8,6,22,58,85,-27,30
Queen's Park,5916,10,6,11,19,42,75,-33,29
Raith,5917,1,23,8,5,70,33,37,77
Ayr,5917,2,24,4,8,92,42,50,76
Arbroath,5917,3,17,9,10,72,50,22,60
Alloa,5917,4,17,8,11,57,45,12,59
Stranraer,5917,5,15,5,16,57,67,-10,50
East Fife,5917,6,14,3,19,50,66,-16,45
Airdrieon,5917,7,10,12,14,48,61,-13,42
Forfar,5917,8,10,6,20,41,67,-26,36
Albion,5917,9,8,6,22,57,80,-23,30
Queen's Park,5917,10,6,11,19,41,74,-33,29
Raith,5918,1,23,8,5,70,32,38,77
Ayr,5918,2,23,5,8,92,44,48,74
Arbroath,5918,3,17,9,10,72,50,22,60
Alloa,5918,4,17,8,11,56,45,11,59
Stranraer,5918,5,15,5,16,55,66,-11,50
East Fife,5918,6,14,3,19,49,64,-15,45
Airdrieon,5918,7,11,11,14,48,58,-10,44
Forfar,5918,8,10,5,21,38,67,-29,35
Albion,5918,9,8,7,21,59,80,-21,31
Queen's Park,5918,10,6,11,19,41,74,-33,29
Raith,5919,1,23,8,5,70,33,37,77
Ayr,5919,2,23,5,8,92,44,48,74
Arbroath,5919,3,17,9,10,71,49,22,60
Alloa,5919,4,17,8,11,57,45,12,59
Stranraer,5919,5,16,5,15,59,66,-7,53
Airdrieon,5919,6,11,11,14,49,58,-9,44
East Fife,5919,7,13,3,20,49,68,-19,42
Forfar,5919,8,10,5,21,38,68,-30,35
Albion,5919,9,8,7,21,59,80,-21,31
Queen's Park,5919,10,6,11,19,40,73,-33,29
Ayr,5920,1,24,4,8,93,42,51,76
Raith,5920,2,22,9,5,69,33,36,75
Arbroath,5920,3,18,8,10,73,50,23,62
Alloa,5920,4,17,9,10,57,44,13,60
Stranraer,5920,5,15,5,16,55,67,-12,50
East Fife,5920,6,14,3,19,50,64,-14,45
Airdrieon,5920,7,10,11,15,46,61,-15,41
Forfar,5920,8,11,5,20,41,65,-24,38
Albion,5920,9,8,6,22,57,81,-24,30
Queen's Park,5920,10,6,10,20,41,75,-34,28
Raith,5921,1,22,8,6,69,34,35,74
Ayr,5921,2,23,4,9,91,46,45,73
Alloa,5921,3,18,8,10,58,44,14,62
Arbroath,5921,4,17,9,10,71,49,22,60
Stranraer,5921,5,15,5,16,55,66,-11,50
East Fife,5921,6,14,3,19,49,64,-15,45
Airdrieon,5921,7,10,11,15,48,62,-14,41
Forfar,5921,8,11,5,20,42,67,-25,38
Albion,5921,9,9,6,21,61,79,-18,33
Queen's Park,5921,10,6,11,19,40,73,-33,29
Ayr,5922,1,24,4,8,92,43,49,76
Raith,5922,2,22,9,5,69,33,36,75
Arbroath,5922,3,17,9,10,73,51,22,60
Alloa,5922,4,17,9,10,57,44,13,60
Stranraer,5922,5,16,5,15,58,64,-6,53
Airdrieon,5922,6,11,11,14,47,58,-11,44
East Fife,5922,7,13,3,20,47,67,-20,42
Forfar,5922,8,10,5,21,38,66,-28,35
Albion,5922,9,8,6,22,58,80,-22,30
Queen's Park,5922,10,6,11,19,42,75,-33,29
Raith,5923,1,23,8,5,69,32,37,77
Ayr,5923,2,24,4,8,96,45,51,76
Arbroath,5923,3,18,8,10,73,50,23,62
Alloa,5923,4,17,8,11,56,44,12,59
Stranraer,5923,5,15,5,16,55,67,-12,50
East Fife,5923,6,14,3,19,50,64,-14,45
Airdrieon,5923,7,10,12,14,46,59,-13,42
Forfar,5923,8,10,6,20,39,65,-26,36
Albion,5923,9,8,6,22,60,84,-24,30
Queen's Park,5923,10,6,10,20,41,75,-34,28
Ayr,5924,1,24,4,8,93,43,50,76
Raith,5924,2,22,8,6,68,34,34,74
Arbroath,5924,3,18,8,10,72,48,24,62
Alloa,5924,4,18,8,10,58,43,15,62
Stranraer,5924,5,15,5,16,56,66,-10,50
East Fife,5924,6,14,3,19,49,65,-16,45
Airdrieon,5924,7,10,11,15,47,61,-14,41
Forfar,5924,8,11,5,20,41,66,-25,38
Albion,5924,9,8,6,22,58,81,-23,30
Queen's Park,5924,10,6,10,20,39,74,-35,28
Raith,5925,1,23,8,5,70,32,38,77
Ayr,5925,2,24,4,8,95,44,51,76
Arbroath,5925,3,17,9,10,71,49,22,60
Alloa,5925,4,17,8,11,56,45,11,59
Stranraer,5925,5,16,5,15,57,64,-7,53
East Fife,5925,6,13,3,20,47,66,-19,42
Airdrieon,5925,7,10,11,15,45,59,-14,41
Forfar,5925,8,11,5,20,39,64,-25,38
Albion,5925,9,8,6,22,59,83,-24,30
Queen's Park,5925,10,6,11,19,40,73,-33,29
Ayr,5926,1,24,4,8,94,43,51,76
Raith,5926,2,22,9,5,69,33,36,75
Alloa,5926,3,17,9,10,57,44,13,60
Arbroath,5926,4,17,8,11,72,51,21,59
Stranraer,5926,5,16,5,15,58,65,-7,53
Airdrieon,5926,6,11,11,14,47,59,-12,44
East Fife,5926,7,13,3,20,48,67,-19,42
Forfar,5926,8,10,5,21,39,66,-27,35
Queen's Park,5926,9,7,10,19,42,74,-32,31
Albion,5926,10,8,6,22,58,82,-24,30
Ayr,5927,1,24,4,8,94,43,51,76
Raith,5927,2,22,9,5,70,34,36,75
Arbroath,5927,3,18,8,10,71,48,23,62
Alloa,5927,4,17,9,10,58,45,13,60
Stranraer,5927,5,15,5,16,56,66,-10,50
East Fife,5927,6,14,3,19,49,65,-16,45
Airdrieon,5927,7,10,12,14,47,60,-13,42
Forfar,5927,8,10,6,20,40,66,-26,36
Albion,5927,9,8,6,22,58,82,-24,30
Queen's Park,5927,10,6,10,20,39,73,-34,28
Raith,5928,1,23,8,5,69,32,37,77
Ayr,5928,2,24,4,8,91,42,49,76
Arbroath,5928,3,17,8,11,70,50,20,59
Alloa,5928,4,17,8,11,56,44,12,59
Stranraer,5928,5,15,6,15,57,66,-9,51
Airdrieon,5928,6,11,11,14,48,59,-11,44
East Fife,5928,7,13,4,19,49,66,-17,43
Forfar,5928,8,10,5,21,39,67,-28,35
Queen's Park,5928,9,7,10,19,41,72,-31,31
Albion,5928,10,8,6,22,57,79,-22,30
Ayr,5929,1,24,4,8,95,42,53,76
Raith,5929,2,22,9,5,70,34,36,75
Arbroath,5929,3,18,8,10,73,48,25,62
Alloa,5929,4,17,9,10,58,45,13,60
Stranraer,5929,5,16,5,15,61,64,-3,53
Airdrieon,5929,6,10,12,14,47,60,-13,42
East Fife,5929,7,13,3,20,47,70,-23,42
Forfar,5929,8,10,6,20,40,66,-26,36
Albion,5929,9,8,6,22,57,83,-26,30
Queen's Park,5929,10,6,10,20,39,75,-36,28
Raith,5930,1,23,8,5,73,32,41,77
Ayr,5930,2,24,4,8,96,44,52,76
Arbroath,5930,3,18,8,10,72,49,23,62
Alloa,5930,4,17,8,11,56,48,8,59
Stranraer,5930,5,15,6,15,57,66,-9,51
East Fife,5930,6,13,4,19,49,66,-17,43
Airdrieon,5930,7,10,11,15,46,60,-14,41
Forfar,5930,8,11,5,20,40,65,-25,38
Albion,5930,9,8,6,22,59,84,-25,30
Queen's Park,5930,10,6,10,20,40,74,-34,28
Ayr,5931,1,24,4,8,95,44,51,76
Raith,5931,2,22,9,5,69,33,36,75
Arbroath,5931,3,18,8,10,72,48,24,62
Alloa,5931,4,17,9,10,57,44,13,60
Stranraer,5931,5,15,5,16,56,68,-12,50
East Fife,5931,6,14,3,19,51,65,-14,45
Airdrieon,5931,7,10,12,14,47,60,-13,42
Forfar,5931,8,10,6,20,40,66,-26,36
Albion,5931,9,8,6,22,59,83,-24,30
Queen's Park,5931,10,6,10,20,39,74,-35,28
Raith,5932,1,23,8,5,70,33,37,77
Ayr,5932,2,24,4,8,94,42,52,76
Arbroath,5932,3,17,8,11,70,49,21,59
Alloa,5932,4,17,8,11,57,45,12,59
Stranraer,5932,5,15,5,16,55,67,-12,50
East Fife,5932,6,14,3,19,50,64,-14,45
Airdrieon,5932,7,11,11,14,47,59,-12,44
Forfar,5932,8,10,5,21,39,66,-27,35
Queen's Park,5932,9,7,10,19,40,72,-32,31
Albion,5932,10,8,6,22,57,82,-25,30
Raith,5933,1,23,8,5,70,33,37,77
Ayr,5933,2,24,4,8,92,42,50,76
Arbroath,5933,3,18,8,10,72,48,24,62
Alloa,5933,4,17,8,11,57,45,12,59
Stranraer,5933,5,15,5,16,56,68,-12,50
East Fife,5933,6,14,3,19,51,65,-14,45
Airdrieon,5933,7,10,11,15,46,61,-15,41
Forfar,5933,8,11,5,20,41,65,-24,38
Albion,5933,9,8,6,22,57,80,-23,30
Queen's Park,5933,10,6,10,20,39,74,-35,28
Ayr,5934,1,24,4,8,94,42,52,76
Raith,5934,2,22,9,5,69,33,36,75
Alloa,5934,3,17,9,10,57,44,13,60
Arbroath,5934,4,17,8,11,72,52,20,59
Stranraer,5934,5,15,6,15,56,65,-9,51
Airdrieon,5934,6,11,11,14,48,59,-11,44
East Fife,5934,7,13,4,19,48,65,-17,43
Forfar,5934,8,10,5,21,39,67,-28,35
Queen's Park,5934,9,7,10,19,43,74,-31,31
Albion,5934,10,8,6,22,57,82,-25,30
Raith,5935,1,23,8,5,69,32,37,77
Ayr,5935,2,24,4,8,92,43,49,76
Arbroath,5935,3,18,8,10,72,49,23,62
Alloa,5935,4,17,8,11,56,44,12,59
Stranraer,5935,5,15,5,16,57,67,-10,50
East Fife,5935,6,14,3,19,50,66,-16,45
Airdrieon,5935,7,11,11,14,48,60,-12,44
Forfar,5935,8,10,5,21,40,67,-27,35
Albion,5935,9,8,6,22,58,80,-22,30
Queen's Park,5935,10,6,10,20,40,74,-34,28
Ayr,5936,1,24,4,8,92,42,50,76
Raith,5936,2,22,8,6,68,33,35,74
Alloa,5936,3,18,8,10,57,43,14,62
Arbroath,5936,4,17,9,10,71,49,22,60
Stranraer,5936,5,16,5,15,57,65,-8,53
Airdrieon,5936,6,11,11,14,48,58,-10,44
East Fife,5936,7,13,3,20,48,66,-18,42
Forfar,5936,8,10,5,21,38,67,-29,35
Albion,5936,9,8,6,22,57,80,-23,30
Queen's Park,5936,10,6,11,19,40,73,-33,29
Raith,5937,1,23,8,5,70,32,38,77
Ayr,5937,2,24,4,8,94,45,49,76
Arbroath,5937,3,17,8,11,71,51,20,59
Alloa,5937,4,17,8,11,56,45,11,59
Stranraer,5937,5,15,6,15,58,67,-9,51
East Fife,5937,6,13,4,19,50,67,-17,43
Airdrieon,5937,7,10,12,14,46,59,-13,42
Forfar,5937,8,10,6,20,39,65,-26,36
Queen's Park,5937,9,7,10,19,42,73,-31,31
Albion,5937,10,8,6,22,60,82,-22,30
Ayr,5938,1,23,5,8,93,45,48,74
Raith,5938,2,22,8,6,69,36,33,74
Alloa,5938,3,18,8,10,60,44,16,62
Arbroath,5938,4,17,9,10,72,50,22,60
Stranraer,5938,5,15,5,16,57,67,-10,50
East Fife,5938,6,14,3,19,50,66,-16,45
Airdrieon,5938,7,11,11,14,47,59,-12,44
Forfar,5938,8,10,5,21,39,66,-27,35
Albion,5938,9,8,7,21,60,81,-21,31
Queen's Park,5938,10,6,11,19,41,74,-33,29
Ayr,5939,1,24,4,8,100,43,57,76
Raith,5939,2,22,9,5,69,33,36,75
Arbroath,5939,3,18,8,10,73,48,25,62
Alloa,5939,4,17,9,10,57,44,13,60
Stranraer,5939,5,16,5,15,58,64,-6,53
Airdrieon,5939,6,10,12,14,47,60,-13,42
East Fife,5939,7,13,3,20,47,67,-20,42
Forfar,5939,8,10,6,20,40,66,-26,36
Albion,5939,9,8,6,22,58,88,-30,30
Queen's Park,5939,10,6,10,20,39,75,-36,28
Raith,5940,1,23,8,5,70,32,38,77
Ayr,5940,2,24,4,8,95,42,53,76
Arbroath,5940,3,17,9,10,71,49,22,60
Alloa,5940,4,17,8,11,56,45,11,59
Stranraer,5940,5,16,5,15,61,66,-5,53
Airdrieon,5940,6,11,11,14,47,58,-11,44
East Fife,5940,7,13,3,20,49,70,-21,42
Forfar,5940,8,10,5,21,38,66,-28,35
Albion,5940,9,8,6,22,57,83,-26,30
Queen's Park,5940,10,6,11,19,40,73,-33,29
Ayr,5941,1,24,4,8,93,44,49,76
Raith,5941,2,22,9,5,71,35,36,75
Arbroath,5941,3,18,8,10,73,48,25,62
Alloa,5941,4,17,9,10,59,46,13,60
Stranraer,5941,5,15,5,16,55,68,-13,50
East Fife,5941,6,14,3,19,51,64,-13,45
Airdrieon,5941,7,10,12,14,48,61,-13,42
Forfar,5941,8,10,6,20,41,67,-26,36
Albion,5941,9,8,6,22,59,81,-22,30
Queen's Park,5941,10,6,10,20,39,75,-36,28
Raith,5942,1,23,8,5,70,32,38,77
Ayr,5942,2,24,4,8,92,43,49,76
Arbroath,5942,3,17,9,10,71,49,22,60
Alloa,5942,4,17,8,11,56,45,11,59
Stranraer,5942,5,16,5,15,57,65,-8,53
Airdrieon,5942,6,11,11,14,46,58,-12,44
East Fife,5942,7,13,3,20,48,66,-18,42
Forfar,5942,8,10,5,21,38,65,-27,35
Albion,5942,9,8,6,22,58,80,-22,30
Queen's Park,5942,10,6,11,19,40,73,-33,29
Raith,5943,1,23,8,5,71,32,39,77
Ayr,5943,2,24,4,8,95,43,52,76
Arbroath,5943,3,17,8,11,71,52,19,59
Alloa,5943,4,17,8,11,56,46,10,59
Stranraer,5943,5,16,5,15,58,65,-7,53
Airdrieon,5943,6,11,11,14,46,58,-12,44
East Fife,5943,7,13,3,20,48,67,-19,42
Forfar,5943,8,10,5,21,38,65,-27,35
Queen's Park,5943,9,7,10,19,43,73,-30,31
Albion,5943,10,8,6,22,58,83,-25,30
Raith,5944,1,23,8,5,69,32,37,77
Ayr,5944,2,23,5,8,91,43,48,74
Arbroath,5944,3,17,8,11,70,49,21,59
Alloa,5944,4,17,8,11,56,44,12,59
Stranraer,5944,5,15,5,16,57,67,-10,50
East Fife,5944,6,14,3,19,50,66,-16,45
Airdrieon,5944,7,10,12,14,46,59,-13,42
Forfar,5944,8,10,6,20,39,65,-26,36
Albion,5944,9,8,7,21,58,79,-21,31
Queen's Park,5944,10,7,10,19,40,72,-32,31
Raith,5945,1,23,8,5,71,32,39,77
Ayr,5945,2,24,4,8,93,44,49,76
Arbroath,5945,3,17,8,11,72,52,20,59
Alloa,5945,4,17,8,11,56,46,10,59
Stranraer,5945,5,15,5,16,55,68,-13,50
East Fife,5945,6,14,3,19,51,64,-13,45
Airdrieon,5945,7,10,11,15,45,59,-14,41
Forfar,5945,8,11,5,20,39,64,-25,38
Queen's Park,5945,9,7,10,19,43,74,-31,31
Albion,5945,10,8,6,22,59,81,-22,30
Ayr,5946,1,24,4,8,93,43,50,76
Raith,5946,2,22,8,6,69,34,35,74
Alloa,5946,3,18,8,10,58,44,14,62
Arbroath,5946,4,17,8,11,71,51,20,59
Stranraer,5946,5,15,5,16,56,66,-10,50
East Fife,5946,6,14,3,19,49,65,-16,45
Airdrieon,5946,7,10,11,15,46,60,-14,41
Forfar,5946,8,11,5,20,40,65,-25,38
Queen's Park,5946,9,7,10,19,42,73,-31,31
Albion,5946,10,8,6,22,58,81,-23,30
Raith,5947,1,22,9,5,71,35,36,75
Ayr,5947,2,23,5,8,93,45,48,74
Alloa,5947,3,17,9,10,59,46,13,60
Arbroath,5947,4,17,8,11,70,49,21,59
Stranraer,5947,5,15,5,16,57,67,-10,50
East Fife,5947,6,14,3,19,50,66,-16,45
Airdrieon,5947,7,11,11,14,47,59,-12,44
Forfar,5947,8,10,5,21,39,66,-27,35
Albion,5947,9,8,7,21,60,81,-21,31
Queen's Park,5947,10,7,10,19,40,72,-32,31
Raith,5948,1,23,8,5,71,32,39,77
Ayr,5948,2,24,4,8,93,43,50,76
Arbroath,5948,3,17,9,10,72,50,22,60
Alloa,5948,4,17,8,11,56,46,10,59
Stranraer,5948,5,15,5,16,55,65,-10,50
East Fife,5948,6,14,3,19,48,64,-16,45
Airdrieon,5948,7,11,11,14,49,59,-10,44
Forfar,5948,8,10,5,21,39,68,-29,35
Albion,5948,9,8,6,22,58,81,-23,30
Queen's Park,5948,10,6,11,19,41,74,-33,29
Raith,5949,1,23,8,5,71,33,38,77
Ayr,5949,2,24,4,8,96,46,50,76
Arbroath,5949,3,17,8,11,72,52,20,59
Alloa,5949,4,17,8,11,57,46,11,59
Stranraer,5949,5,15,5,16,55,65,-10,50
East Fife,5949,6,14,3,19,48,64,-16,45
Airdrieon,5949,7,10,12,14,47,60,-13,42
Forfar,5949,8,10,6,20,40,66,-26,36
Queen's Park,5949,9,7,10,19,43,74,-31,31
Albion,5949,10,8,6,22,61,84,-23,30
Raith,5950,1,23,8,5,70,32,38,77
Ayr,5950,2,24,4,8,93,43,50,76
Arbroath,5950,3,18,8,10,73,48,25,62
Alloa,5950,4,17,8,11,56,45,11,59
Stranraer,5950,5,15,5,16,55,66,-11,50
East Fife,5950,6,14,3,19,49,64,-15,45
Airdrieon,5950,7,10,12,14,46,59,-13,42
Forfar,5950,8,10,6,20,39,65,-26,36
Albion,5950,9,8,6,22,58,81,-23,30
Queen's Park,5950,10,6,10,20,39,75,-36,28
Raith,5951,1,23,8,5,71,33,38,77
Ayr,5951,2,24,4,8,94,43,51,76
Arbroath,5951,3,17,9,10,72,50,22,60
Alloa,5951,4,17,8,11,57,46,11,59
Stranraer,5951,5,15,6,15,55,64,-9,51
Airdrieon,5951,6,11,11,14,46,58,-12,44
East Fife,5951,7,13,4,19,47,64,-17,43
Forfar,5951,8,10,5,21,38,65,-27,35
Albion,5951,9,8,6,22,58,82,-24,30
Queen's Park,5951,10,6,11,19,41,74,-33,29
Ayr,5952,1,24,4,8,93,43,50,76
Raith,5952,2,22,9,5,69,33,36,75
Arbroath,5952,3,18,8,10,73,48,25,62
Alloa,5952,4,17,9,10,57,44,13,60
Stranraer,5952,5,16,5,15,56,64,-8,53
Airdrieon,5952,6,11,11,14,49,59,-10,44
East Fife,5952,7,13,3,20,47,65,-18,42
Forfar,5952,8,10,5,21,39,68,-29,35
Albion,5952,9,8,6,22,58,81,-23,30
Queen's Park,5952,10,6,10,20,39,75,-36,28
Ayr,5953,1,24,4,8,97,44,53,76
Raith,5953,2,22,9,5,70,34,36,75
Alloa,5953,3,17,9,10,58,45,13,60
Arbroath,5953,4,17,8,11,70,49,21,59
Stranraer,5953,5,15,6,15,57,66,-9,51
Airdrieon,5953,6,11,11,14,51,58,-7,44
East Fife,5953,7,13,4,19,49,66,-17,43
Forfar,5953,8,10,5,21,38,70,-32,35
Queen's Park,5953,9,7,10,19,40,72,-32,31
Albion,5953,10,8,6,22,59,85,-26,30
Raith,5954,1,23,8,5,71,34,37,77
Ayr,5954,2,24,4,8,93,42,51,76
Arbroath,5954,3,18,8,10,72,48,24,62
Alloa,5954,4,17,8,11,58,46,12,59
Stranraer,5954,5,16,5,15,57,64,-7,53
Airdrieon,5954,6,11,11,14,46,58,-12,44
East Fife,5954,7,13,3,20,47,66,-19,42
Forfar,5954,8,10,5,21,38,65,-27,35
Albion,5954,9,8,6,22,57,81,-24,30
Queen's Park,5954,10,6,10,20,39,74,-35,28
Raith,5955,1,22,9,5,69,33,36,75
Ayr,5955,2,23,4,9,92,45,47,73
Arbroath,5955,3,18,8,10,73,50,23,62
Alloa,5955,4,17,9,10,57,44,13,60
Stranraer,5955,5,16,5,15,56,64,-8,53
Airdrieon,5955,6,11,11,14,48,60,-12,44
East Fife,5955,7,13,3,20,47,65,-18,42
Forfar,5955,8,10,5,21,40,67,-27,35
Albion,5955,9,9,6,21,60,80,-20,33
Queen's Park,5955,10,6,10,20,41,75,-34,28
Raith,5956,1,23,8,5,70,32,38,77
Ayr,5956,2,24,4,8,94,43,51,76
Arbroath,5956,3,18,8,10,72,49,23,62
Alloa,5956,4,17,8,11,56,45,11,59
Stranraer,5956,5,15,6,15,56,65,-9,51
Airdrieon,5956,6,11,11,14,47,58,-11,44
East Fife,5956,7,13,4,19,48,65,-17,43
Forfar,5956,8,10,5,21,38,66,-28,35
Albion,5956,9,8,6,22,58,82,-24,30
Queen's Park,5956,10,6,10,20,40,74,-34,28
Ayr,5957,1,23,5,8,91,43,48,74
Raith,5957,2,22,8,6,69,35,34,74
Alloa,5957,3,18,8,10,59,44,15,62
Arbroath,5957,4,17,8,11,71,50,21,59
Stranraer,5957,5,16,5,15,57,64,-7,53
Airdrieon,5957,6,10,12,14,46,59,-13,42
East Fife,5957,7,13,3,20,47,66,-19,42
Forfar,5957,8,10,6,20,39,65,-26,36
Albion,5957,9,8,7,21,58,79,-21,31
Queen's Park,5957,10,7,10,19,41,73,-32,31
Raith,5958,1,23,8,5,71,32,39,77
Ayr,5958,2,23,5,8,90,42,48,74
Arbroath,5958,3,18,8,10,72,48,24,62
Alloa,5958,4,17,8,11,56,46,10,59
Stranraer,5958,5,16,5,15,58,66,-8,53
Airdrieon,5958,6,10,12,14,46,59,-13,42
East Fife,5958,7,13,3,20,49,67,-18,42
Forfar,5958,8,10,6,20,39,65,-26,36
Albion,5958,9,8,7,21,57,78,-21,31
Queen's Park,5958,10,6,10,20,39,74,-35,28
Ayr,5959,1,24,4,8,93,42,51,76
Raith,5959,2,22,9,5,69,33,36,75
Arbroath,5959,3,18,8,10,73,48,25,62
Alloa,5959,4,17,9,10,57,44,13,60
Stranraer,5959,5,15,5,16,55,67,-12,50
East Fife,5959,6,14,3,19,50,64,-14,45
Airdrieon,5959,7,11,11,14,46,58,-12,44
Forfar,5959,8,10,5,21,38,65,-27,35
Albion,5959,9,8,6,22,57,81,-24,30
Queen's Park,5959,10,6,10,20,39,75,-36,28
Raith,5960,1,23,8,5,71,32,39,77
Ayr,5960,2,23,4,9,91,44,47,73
Arbroath,5960,3,18,8,10,72,48,24,62
Alloa,5960,4,17,8,11,56,46,10,59
Stranraer,5960,5,15,5,16,56,66,-10,50
East Fife,5960,6,14,3,19,49,65,-16,45
Airdrieon,5960,7,10,11,15,46,60,-14,41
Forfar,5960,8,11,5,20,40,65,-25,38
Albion,5960,9,9,6,21,59,79,-20,33
Queen's Park,5960,10,6,10,20,39,74,-35,28
Ayr,5961,1,24,4,8,93,42,51,76
Raith,5961,2,22,8,6,68,33,35,74
Alloa,5961,3,18,8,10,57,43,14,62
Arbroath,5961,4,17,9,10,73,51,22,60
Stranraer,5961,5,16,5,15,56,64,-8,53
East Fife,5961,6,13,3,20,47,65,-18,42
Airdrieon,5961,7,10,11,15,45,59,-14,41
Forfar,5961,8,11,5,20,39,64,-25,38
Albion,5961,9,8,6,22,57,81,-24,30
Queen's Park,5961,10,6,11,19,42,75,-33,29
Raith,5962,1,23,8,5,71,34,37,77
Ayr,5962,2,24,4,8,96,42,54,76
Arbroath,5962,3,17,9,10,73,51,22,60
Alloa,5962,4,17,8,11,58,46,12,59
Stranraer,5962,5,16,5,15,58,65,-7,53
Airdrieon,5962,6,11,11,14,46,58,-12,44
East Fife,5962,7,13,3,20,48,67,-19,42
Forfar,5962,8,10,5,21,38,65,-27,35
Albion,5962,9,8,6,22,57,84,-27,30
Queen's Park,5962,10,6,11,19,42,75,-33,29
Ayr,5963,1,24,4,8,96,44,52,76
Raith,5963,2,22,8,6,69,35,34,74
Arbroath,5963,3,18,8,10,76,48,28,62
Alloa,5963,4,18,8,10,59,44,15,62
Stranraer,5963,5,15,5,16,56,67,-11,50
East Fife,5963,6,14,3,19,50,65,-15,45
Airdrieon,5963,7,10,12,14,47,60,-13,42
Forfar,5963,8,10,6,20,40,66,-26,36
Albion,5963,9,8,6,22,59,84,-25,30
Queen's Park,5963,10,6,10,20,39,78,-39,28
Ayr,5964,1,24,4,8,96,44,52,76
Raith,5964,2,22,9,5,69,33,36,75
Alloa,5964,3,17,9,10,57,44,13,60
Arbroath,5964,4,17,8,11,72,51,21,59
Stranraer,5964,5,15,5,16,56,67,-11,50
East Fife,5964,6,14,3,19,50,65,-15,45
Airdrieon,5964,7,10,11,15,45,59,-14,41
Forfar,5964,8,11,5,20,39,64,-25,38
Queen's Park,5964,9,7,10,19,42,74,-32,31
Albion,5964,10,8,6,22,59,84,-25,30
Raith,5965,1,23,8,5,72,32,40,77
Ayr,5965,2,24,4,8,95,42,53,76
Arbroath,5965,3,18,8,10,72,49,23,62
Alloa,5965,4,17,8,11,56,47,9,59
Stranraer,5965,5,15,6,15,56,65,-9,51
East Fife,5965,6,13,4,19,48,65,-17,43
Airdrieon,5965,7,10,12,14,46,59,-13,42
Forfar,5965,8,10,6,20,39,65,-26,36
Albion,5965,9,8,6,22,57,83,-26,30
Queen's Park,5965,10,6,10,20,40,74,-34,28
Raith,5966,1,23,8,5,72,33,39,77
Ayr,5966,2,23,4,9,90,44,46,73
Arbroath,5966,3,17,8,11,70,50,20,59
Alloa,5966,4,17,8,11,57,47,10,59
Stranraer,5966,5,16,5,15,57,64,-7,53
Airdrieon,5966,6,11,11,14,47,58,-11,44
East Fife,5966,7,13,3,20,47,66,-19,42
Forfar,5966,8,10,5,21,38,66,-28,35
Albion,5966,9,9,6,21,59,78,-19,33
Queen's Park,5966,10,7,10,19,41,72,-31,31
Raith,5967,1,23,8,5,70,33,37,77
Ayr,5967,2,24,4,8,93,44,49,76
Arbroath,5967,3,17,9,10,73,51,22,60
Alloa,5967,4,17,8,11,57,45,12,59
Stranraer,5967,5,15,6,15,56,65,-9,51
East Fife,5967,6,13,4,19,48,65,-17,43
Airdrieon,5967,7,10,12,14,46,59,-13,42
Forfar,5967,8,10,6,20,39,65,-26,36
Albion,5967,9,8,6,22,59,81,-22,30
Queen's Park,5967,10,6,11,19,42,75,-33,29
Raith,5968,1,23,8,5,72,35,37,77
Ayr,5968,2,24,4,8,91,42,49,76
Arbroath,5968,3,17,8,11,70,50,20,59
Alloa,5968,4,17,8,11,59,47,12,59
Stranraer,5968,5,15,5,16,56,67,-11,50
East Fife,5968,6,14,3,19,50,65,-15,45
Airdrieon,5968,7,11,11,14,48,58,-10,44
Forfar,5968,8,10,5,21,38,67,-29,35
Queen's Park,5968,9,7,10,19,41,72,-31,31
Albion,5968,10,8,6,22,57,79,-22,30
Ayr,5969,1,24,4,8,95,44,51,76
Raith,5969,2,22,8,6,70,37,33,74
Arbroath,5969,3,18,8,10,72,49,23,62
Alloa,5969,4,18,8,10,61,45,16,62
Stranraer,5969,5,15,5,16,55,65,-10,50
East Fife,5969,6,14,3,19,48,64,-16,45
Airdrieon,5969,7,10,12,14,46,59,-13,42
Forfar,5969,8,10,6,20,39,65,-26,36
Albion,5969,9,8,6,22,59,83,-24,30
Queen's Park,5969,10,6,10,20,40,74,-34,28
Ayr,5970,1,24,4,8,94,45,49,76
Raith,5970,2,22,9,5,71,35,36,75
Arbroath,5970,3,17,9,10,73,51,22,60
Alloa,5970,4,17,9,10,59,46,13,60
Stranraer,5970,5,15,6,15,55,64,-9,51
East Fife,5970,6,13,4,19,47,64,-17,43
Airdrieon,5970,7,10,12,14,45,58,-13,42
Forfar,5970,8,10,6,20,38,64,-26,36
Albion,5970,9,8,6,22,60,82,-22,30
Queen's Park,5970,10,6,11,19,42,75,-33,29
Ayr,5971,1,24,4,8,95,42,53,76
Raith,5971,2,22,8,6,69,34,35,74
Arbroath,5971,3,18,8,10,75,50,25,62
Alloa,5971,4,18,8,10,58,44,14,62
Stranraer,5971,5,15,5,16,55,66,-11,50
East Fife,5971,6,14,3,19,49,64,-15,45
Airdrieon,5971,7,10,12,14,48,61,-13,42
Forfar,5971,8,10,6,20,41,67,-26,36
Albion,5971,9,8,6,22,57,83,-26,30
Queen's Park,5971,10,6,10,20,41,77,-36,28
Raith,5972,1,23,8,5,74,33,41,77
Ayr,5972,2,24,4,8,94,44,50,76
Arbroath,5972,3,18,8,10,73,49,24,62
Alloa,5972,4,17,8,11,57,49,8,59
Stranraer,5972,5,15,5,16,57,67,-10,50
East Fife,5972,6,14,3,19,50,66,-16,45
Airdrieon,5972,7,11,11,14,47,58,-11,44
Forfar,5972,8,10,5,21,38,66,-28,35
Albion,5972,9,8,6,22,59,82,-23,30
Queen's Park,5972,10,6,10,20,40,75,-35,28
Ayr,5973,1,23,5,8,92,44,48,74
Raith,5973,2,22,8,6,68,33,35,74
Arbroath,5973,3,18,8,10,74,49,25,62
Alloa,5973,4,18,8,10,57,43,14,62
Stranraer,5973,5,16,5,15,56,64,-8,53
East Fife,5973,6,13,3,20,47,65,-18,42
Airdrieon,5973,7,10,11,15,49,63,-14,41
Forfar,5973,8,11,5,20,43,68,-25,38
Albion,5973,9,8,7,21,59,80,-21,31
Queen's Park,5973,10,6,10,20,40,76,-36,28
Raith,5974,1,23,8,5,70,32,38,77
Ayr,5974,2,23,4,9,91,44,47,73
Arbroath,5974,3,17,9,10,71,49,22,60
Alloa,5974,4,17,8,11,56,45,11,59
Stranraer,5974,5,15,5,16,55,65,-10,50
East Fife,5974,6,14,3,19,48,64,-16,45
Airdrieon,5974,7,11,11,14,47,59,-12,44
Forfar,5974,8,10,5,21,39,66,-27,35
Albion,5974,9,9,6,21,59,79,-20,33
Queen's Park,5974,10,6,11,19,40,73,-33,29
Raith,5975,1,23,8,5,69,32,37,77
Ayr,5975,2,24,4,8,94,42,52,76
Arbroath,5975,3,18,8,10,72,49,23,62
Alloa,5975,4,17,8,11,56,44,12,59
Stranraer,5975,5,15,5,16,56,69,-13,50
East Fife,5975,6,14,3,19,52,65,-13,45
Airdrieon,5975,7,10,11,15,46,61,-15,41
Forfar,5975,8,11,5,20,41,65,-24,38
Albion,5975,9,8,6,22,57,82,-25,30
Queen's Park,5975,10,6,10,20,40,74,-34,28
Ayr,5976,1,24,4,8,93,42,51,76
Raith,5976,2,22,8,6,69,36,33,74
Arbroath,5976,3,18,8,10,73,50,23,62
Alloa,5976,4,18,8,10,60,44,16,62
Stranraer,5976,5,16,5,15,57,65,-8,53
Airdrieon,5976,6,11,11,14,48,59,-11,44
East Fife,5976,7,13,3,20,48,66,-18,42
Forfar,5976,8,10,5,21,39,67,-28,35
Albion,5976,9,8,6,22,57,81,-24,30
Queen's Park,5976,10,6,10,20,41,75,-34,28
Ayr,5977,1,24,4,8,93,43,50,76
Raith,5977,2,22,8,6,68,33,35,74
Alloa,5977,3,18,8,10,57,43,14,62
Arbroath,5977,4,17,8,11,74,54,20,59
Stranraer,5977,5,16,5,15,60,64,-4,53
Airdrieon,5977,6,11,11,14,48,58,-10,44
East Fife,5977,7,13,3,20,47,69,-22,42
Forfar,5977,8,10,5,21,38,67,-29,35
Queen's Park,5977,9,7,10,19,45,76,-31,31
Albion,5977,10,8,6,22,58,81,-23,30
Raith,5978,1,23,8,5,69,32,37,77
Ayr,5978,2,23,5,8,92,44,48,74
Arbroath,5978,3,18,8,10,73,49,24,62
Alloa,5978,4,17,8,11,56,44,12,59
Stranraer,5978,5,15,6,15,58,67,-9,51
Airdrieon,5978,6,11,11,14,46,58,-12,44
East Fife,5978,7,13,4,19,50,67,-17,43
Forfar,5978,8,10,5,21,38,65,-27,35
Albion,5978,9,8,7,21,59,80,-21,31
Queen's Park,5978,10,6,10,20,40,75,-35,28
Raith,5979,1,23,8,5,72,32,40,77
Ayr,5979,2,24,4,8,94,45,49,76
Arbroath,5979,3,17,9,10,73,51,22,60
Alloa,5979,4,17,8,11,56,47,9,59
Stranraer,5979,5,16,5,15,58,65,-7,53
Airdrieon,5979,6,11,11,14,47,59,-12,44
East Fife,5979,7,13,3,20,48,67,-19,42
Forfar,5979,8,10,5,21,39,66,-27,35
Albion,5979,9,8,6,22,60,82,-22,30
Queen's Park,5979,10,6,11,19,42,75,-33,29
Ayr,5980,1,24,4,8,98,46,52,76
Raith,5980,2,22,8,6,68,33,35,74
Alloa,5980,3,18,8,10,57,43,14,62
Arbroath,5980,4,17,9,10,72,50,22,60
Stranraer,5980,5,16,5,15,59,64,-5,53
East Fife,5980,6,13,3,20,47,68,-21,42
Airdrieon,5980,7,10,11,15,45,59,-14,41
Forfar,5980,8,11,5,20,39,64,-25,38
Albion,5980,9,8,6,22,61,86,-25,30
Queen's Park,5980,10,6,11,19,41,74,-33,29
Raith,5981,1,23,8,5,69,32,37,77
Ayr,5981,2,23,4,9,91,45,46,73
Arbroath,5981,3,17,8,11,70,50,20,59
Alloa,5981,4,17,8,11,56,44,12,59
Stranraer,5981,5,15,6,15,58,67,-9,51
Airdrieon,5981,6,11,11,14,48,60,-12,44
East Fife,5981,7,13,4,19,50,67,-17,43
Forfar,5981,8,10,5,21,40,67,-27,35
Albion,5981,9,9,6,21,60,79,-19,33
Queen's Park,5981,10,7,10,19,41,72,-31,31
Raith,5982,1,23,8,5,69,32,37,77
Ayr,5982,2,24,4,8,91,42,49,76
Arbroath,5982,3,18,8,10,72,48,24,62
Alloa,5982,4,17,8,11,56,44,12,59
Stranraer,5982,5,15,5,16,57,67,-10,50
East Fife,5982,6,14,3,19,50,66,-16,45
Airdrieon,5982,7,10,12,14,46,59,-13,42
Forfar,5982,8,10,6,20,39,65,-26,36
Albion,5982,9,8,6,22,57,79,-22,30
Queen's Park,5982,10,6,10,20,39,74,-35,28
Raith,5983,1,23,8,5,69,32,37,77
Ayr,5983,2,24,4,8,94,44,50,76
Arbroath,5983,3,18,8,10,73,49,24,62
Alloa,5983,4,17,8,11,56,44,12,59
Stranraer,5983,5,15,5,16,57,67,-10,50
East Fife,5983,6,14,3,19,50,66,-16,45
Airdrieon,5983,7,11,11,14,48,60,-12,44
Forfar,5983,8,10,5,21,40,67,-27,35
Albion,5983,9,8,6,22,59,82,-23,30
Queen's Park,5983,10,6,10,20,40,75,-35,28
Ayr,5984,1,24,4,8,96,42,54,76
Raith,5984,2,22,9,5,69,33,36,75
Arbroath,5984,3,18,8,10,72,49,23,62
Alloa,5984,4,17,9,10,57,44,13,60
Stranraer,5984,5,16,5,15,58,66,-8,53
Airdrieon,5984,6,10,12,14,46,59,-13,42
East Fife,5984,7,13,3,20,49,67,-18,42
Forfar,5984,8,10,6,20,39,65,-26,36
Albion,5984,9,8,6,22,57,84,-27,30
Queen's Park,5984,10,6,10,20,40,74,-34,28
Raith,5985,1,23,8,5,70,32,38,77
Ayr,5985,2,24,4,8,93,43,50,76
Arbroath,5985,3,17,8,11,70,51,19,59
Alloa,5985,4,17,8,11,56,45,11,59
Stranraer,5985,5,15,5,16,55,66,-11,50
East Fife,5985,6,14,3,19,49,64,-15,45
Airdrieon,5985,7,11,11,14,49,59,-10,44
Forfar,5985,8,10,5,21,39,68,-29,35
Queen's Park,5985,9,7,10,19,42,72,-30,31
Albion,5985,10,8,6,22,58,81,-23,30
Ayr,5986,1,24,4,8,94,44,50,76
Raith,5986,2,22,9,5,68,32,36,75
Arbroath,5986,3,17,9,10,71,49,22,60
Alloa,5986,4,17,9,10,56,43,13,60
Stranraer,5986,5,16,5,15,58,65,-7,53
East Fife,5986,6,13,3,20,48,67,-19,42
Airdrieon,5986,7,10,11,15,46,60,-14,41
Forfar,5986,8,11,5,20,40,65,-25,38
Albion,5986,9,8,6,22,59,82,-23,30
Queen's Park,5986,10,6,11,19,40,73,-33,29
Raith,5987,1,23,8,5,72,32,40,77
Ayr,5987,2,24,4,8,95,42,53,76
Arbroath,5987,3,18,8,10,73,49,24,62
Alloa,5987,4,17,8,11,56,47,9,59
Stranraer,5987,5,15,6,15,58,67,-9,51
Airdrieon,5987,6,11,11,14,48,60,-12,44
East Fife,5987,7,13,4,19,50,67,-17,43
Forfar,5987,8,10,5,21,40,67,-27,35
Albion,5987,9,8,6,22,57,83,-26,30
Queen's Park,5987,10,6,10,20,40,75,-35,28
Ayr,5988,1,24,4,8,93,42,51,76
Raith,5988,2,22,8,6,69,34,35,74
Arbroath,5988,3,18,8,10,72,49,23,62
Alloa,5988,4,18,8,10,58,44,14,62
Stranraer,5988,5,15,5,16,56,67,-11,50
East Fife,5988,6,14,3,19,50,65,-15,45
Airdrieon,5988,7,10,11,15,46,61,-15,41
Forfar,5988,8,11,5,20,41,65,-24,38
Albion,5988,9,8,6,22,57,81,-24,30
Queen's Park,5988,10,6,10,20,40,74,-34,28
Raith,5989,1,23,8,5,70,33,37,77
Ayr,5989,2,23,5,8,92,44,48,74
Arbroath,5989,3,17,9,10,72,50,22,60
Alloa,5989,4,17,8,11,57,45,12,59
Stranraer,5989,5,16,5,15,57,64,-7,53
Airdrieon,5989,6,11,11,14,47,59,-12,44
East Fife,5989,7,13,3,20,47,66,-19,42
Forfar,5989,8,10,5,21,39,66,-27,35
Albion,5989,9,8,7,21,59,80,-21,31
Queen's Park,5989,10,6,11,19,41,74,-33,29
Raith,5990,1,23,8,5,70,33,37,77
Ayr,5990,2,24,4,8,95,43,52,76
Arbroath,5990,3,17,9,10,71,49,22,60
Alloa,5990,4,17,8,11,57,45,12,59
Stranraer,5990,5,16,5,15,59,65,-6,53
East Fife,5990,6,13,3,20,48,68,-20,42
Airdrieon,5990,7,10,11,15,47,61,-14,41
Forfar,5990,8,11,5,20,41,66,-25,38
Albion,5990,9,8,6,22,58,83,-25,30
Queen's Park,5990,10,6,11,19,40,73,-33,29
Raith,5991,1,23,8,5,71,33,38,77
Ayr,5991,2,24,4,8,94,43,51,76
Arbroath,5991,3,18,8,10,73,50,23,62
Alloa,5991,4,17,8,11,57,46,11,59
Stranraer,5991,5,15,6,15,55,64,-9,51
East Fife,5991,6,13,4,19,47,64,-17,43
Airdrieon,5991,7,10,11,15,45,59,-14,41
Forfar,5991,8,11,5,20,39,64,-25,38
Albion,5991,9,8,6,22,58,82,-24,30
Queen's Park,5991,10,6,10,20,41,75,-34,28
Ayr,5992,1,24,4,8,91,42,49,76
Raith,5992,2,22,8,6,68,33,35,74
Alloa,5992,3,18,8,10,57,43,14,62
Arbroath,5992,4,17,9,10,71,49,22,60
Stranraer,5992,5,15,5,16,55,65,-10,50
East Fife,5992,6,14,3,19,48,64,-16,45
Airdrieon,5992,7,11,11,14,49,60,-11,44
Forfar,5992,8,10,5,21,40,68,-28,35
Albion,5992,9,8,6,22,57,79,-22,30
Queen's Park,5992,10,6,11,19,40,73,-33,29
Ayr,5993,1,24,4,8,96,43,53,76
Raith,5993,2,22,9,5,69,33,36,75
Arbroath,5993,3,18,8,10,76,48,28,62
Alloa,5993,4,17,9,10,57,44,13,60
Stranraer,5993,5,15,5,16,55,66,-11,50
East Fife,5993,6,14,3,19,49,64,-15,45
Airdrieon,5993,7,11,11,14,46,58,-12,44
Forfar,5993,8,10,5,21,38,65,-27,35
Albion,5993,9,8,6,22,58,84,-26,30
Queen's Park,5993,10,6,10,20,39,78,-39,28
Raith,5994,1,23,8,5,69,32,37,77
Ayr,5994,2,24,4,8,95,44,51,76
Arbroath,5994,3,17,9,10,72,50,22,60
Alloa,5994,4,17,8,11,56,44,12,59
Stranraer,5994,5,15,5,16,55,66,-11,50
East Fife,5994,6,14,3,19,49,64,-15,45
Airdrieon,5994,7,11,11,14,50,62,-12,44
Forfar,5994,8,10,5,21,42,69,-27,35
Albion,5994,9,8,6,22,59,83,-24,30
Queen's Park,5994,10,6,11,19,41,74,-33,29
Ayr,5995,1,23,5,8,92,44,48,74
Raith,5995,2,22,8,6,69,34,35,74
Alloa,5995,3,18,8,10,58,44,14,62
Arbroath,5995,4,17,8,11,70,49,21,59
Stranraer,5995,5,15,5,16,56,66,-10,50
East Fife,5995,6,14,3,19,49,65,-16,45
Airdrieon,5995,7,10,11,15,45,60,-15,41
Forfar,5995,8,11,5,20,40,64,-24,38
Albion,5995,9,8,7,21,59,80,-21,31
Queen's Park,5995,10,7,10,19,40,72,-32,31
Raith,5996,1,23,8,5,71,33,38,77
Ayr,5996,2,24,4,8,94,43,51,76
Arbroath,5996,3,18,8,10,73,49,24,62
Alloa,5996,4,17,8,11,57,46,11,59
Stranraer,5996,5,15,5,16,56,66,-10,50
East Fife,5996,6,14,3,19,49,65,-16,45
Airdrieon,5996,7,11,11,14,48,58,-10,44
Forfar,5996,8,10,5,21,38,67,-29,35
Albion,5996,9,8,6,22,58,82,-24,30
Queen's Park,5996,10,6,10,20,40,75,-35,28
Ayr,5997,1,24,4,8,95,44,51,76
Raith,5997,2,22,8,6,68,33,35,74
Alloa,5997,3,18,8,10,57,43,14,62
Arbroath,5997,4,17,8,11,72,51,21,59
Stranraer,5997,5,16,5,15,57,64,-7,53
East Fife,5997,6,13,3,20,47,66,-19,42
Airdrieon,5997,7,10,11,15,48,62,-14,41
Forfar,5997,8,11,5,20,42,67,-25,38
Queen's Park,5997,9,7,10,19,42,74,-32,31
Albion,5997,10,8,6,22,59,83,-24,30
Ayr,5998,1,24,4,8,92,43,49,76
Raith,5998,2,22,8,6,69,35,34,74
Arbroath,5998,3,18,8,10,73,49,24,62
Alloa,5998,4,18,8,10,59,44,15,62
Stranraer,5998,5,15,5,16,56,66,-10,50
East Fife,5998,6,14,3,19,49,65,-16,45
Airdrieon,5998,7,10,12,14,45,58,-13,42
Forfar,5998,8,10,6,20,38,64,-26,36
Albion,5998,9,8,6,22,58,80,-22,30
Queen's Park,5998,10,6,10,20,40,75,-35,28
Raith,5999,1,23,8,5,69,32,37,77
Ayr,5999,2,24,4,8,92,42,50,76
Arbroath,5999,3,18,8,10,72,48,24,62
Alloa,5999,4,17,8,11,56,44,12,59
Stranraer,5999,5,16,5,15,56,64,-8,53
Airdrieon,5999,6,11,11,14,46,58,-12,44
East Fife,5999,7,13,3,20,47,65,-18,42
Forfar,5999,8,10,5,21,38,65,-27,35
Albion,5999,9,8,6,22,57,80,-23,30
Queen's Park,5999,10,6,10,20,39,74,-35,28
Ayr,6000,1,24,4,8,96,43,53,76
Raith,6000,2,22,8,6,69,34,35,74
Arbroath,6000,3,18,8,10,73,48,25,62
Alloa,6000,4,18,8,10,58,44,14,62
Stranraer,6000,5,15,5,16,56,66,-10,50
East Fife,6000,6,14,3,19,49,65,-16,45
Airdrieon,6000,7,11,11,14,46,58,-12,44
Forfar,6000,8,10,5,21,38,65,-27,35
Albion,6000,9,8,6,22,58,84,-26,30
Queen's Park,6000,10,6,10,20,39,75,-36,28
Raith,6001,1,23,8,5,71,34,37,77
Ayr,6001,2,24,4,8,94,42,52,76
Arbroath,6001,3,17,8,11,70,49,21,59
Alloa,6001,4,17,8,11,58,46,12,59
Stranraer,6001,5,15,6,15,57,66,-9,51
Airdrieon,6001,6,11,11,14,46,58,-12,44
East Fife,6001,7,13,4,19,49,66,-17,43
Forfar,6001,8,10,5,21,38,65,-27,35
Queen's Park,6001,9,7,10,19,40,72,-32,31
Albion,6001,10,8,6,22,57,82,-25,30
Raith,6002,1,23,8,5,74,33,41,77
Ayr,6002,2,24,4,8,92,43,49,76
Arbroath,6002,3,18,8,10,73,50,23,62
Alloa,6002,4,17,8,11,57,49,8,59
Stranraer,6002,5,15,5,16,55,65,-10,50
East Fife,6002,6,14,3,19,48,64,-16,45
Airdrieon,6002,7,10,12,14,45,58,-13,42
Forfar,6002,8,10,6,20,38,64,-26,36
Albion,6002,9,8,6,22,58,80,-22,30
Queen's Park,6002,10,6,10,20,41,75,-34,28
Raith,6003,1,22,9,5,69,33,36,75
Ayr,6003,2,23,4,9,93,46,47,73
Arbroath,6003,3,17,9,10,72,50,22,60
Alloa,6003,4,17,9,10,57,44,13,60
Stranraer,6003,5,16,5,15,57,64,-7,53
Airdrieon,6003,6,10,12,14,47,60,-13,42
East Fife,6003,7,13,3,20,47,66,-19,42
Forfar,6003,8,10,6,20,40,66,-26,36
Albion,6003,9,9,6,21,61,81,-20,33
Queen's Park,6003,10,6,11,19,41,74,-33,29
Ayr,6004,1,23,5,8,92,44,48,74
Raith,6004,2,22,8,6,70,35,35,74
Arbroath,6004,3,18,8,10,72,49,23,62
Alloa,6004,4,18,8,10,59,45,14,62
Stranraer,6004,5,16,5,15,58,66,-8,53
Airdrieon,6004,6,11,11,14,48,59,-11,44
East Fife,6004,7,13,3,20,49,67,-18,42
Forfar,6004,8,10,5,21,39,67,-28,35
Albion,6004,9,8,7,21,59,80,-21,31
Queen's Park,6004,10,6,10,20,40,74,-34,28
Raith,6005,1,23,8,5,70,32,38,77
Ayr,6005,2,24,4,8,93,42,51,76
Arbroath,6005,3,18,8,10,75,49,26,62
Alloa,6005,4,17,8,11,56,45,11,59
Stranraer,6005,5,16,5,15,57,64,-7,53
East Fife,6005,6,13,3,20,47,66,-19,42
Airdrieon,6005,7,10,11,15,46,60,-14,41
Forfar,6005,8,11,5,20,40,65,-25,38
Albion,6005,9,8,6,22,57,81,-24,30
Queen's Park,6005,10,6,10,20,40,77,-37,28
Ayr,6006,1,24,4,8,93,42,51,76
Raith,6006,2,22,9,5,69,33,36,75
Arbroath,6006,3,18,8,10,72,49,23,62
Alloa,6006,4,17,9,10,57,44,13,60
Stranraer,6006,5,16,5,15,56,64,-8,53
East Fife,6006,6,13,3,20,47,65,-18,42
Airdrieon,6006,7,10,11,15,45,59,-14,41
Forfar,6006,8,11,5,20,39,64,-25,38
Albion,6006,9,8,6,22,57,81,-24,30
Queen's Park,6006,10,6,10,20,40,74,-34,28
Ayr,6007,1,24,4,8,95,42,53,76
Raith,6007,2,22,8,6,68,33,35,74
Alloa,6007,3,18,8,10,57,43,14,62
Arbroath,6007,4,17,8,11,70,50,20,59
Stranraer,6007,5,15,5,16,56,66,-10,50
East Fife,6007,6,14,3,19,49,65,-16,45
Airdrieon,6007,7,11,11,14,46,58,-12,44
Forfar,6007,8,10,5,21,38,65,-27,35
Queen's Park,6007,9,7,10,19,41,72,-31,31
Albion,6007,10,8,6,22,57,83,-26,30
Ayr,6008,1,24,4,8,95,43,52,76
Raith,6008,2,22,8,6,68,34,34,74
Alloa,6008,3,18,8,10,58,43,15,62
Arbroath,6008,4,17,9,10,71,49,22,60
Stranraer,6008,5,16,5,15,56,64,-8,53
Airdrieon,6008,6,10,12,14,45,58,-13,42
East Fife,6008,7,13,3,20,47,65,-18,42
Forfar,6008,8,10,6,20,38,64,-26,36
Albion,6008,9,8,6,22,58,83,-25,30
Queen's Park,6008,10,6,11,19,40,73,-33,29
Ayr,6009,1,24,4,8,95,43,52,76
Raith,6009,2,22,9,5,68,32,36,75
Alloa,6009,3,17,9,10,56,43,13,60
Arbroath,6009,4,17,8,11,70,51,19,59
Stranraer,6009,5,16,5,15,58,65,-7,53
Airdrieon,6009,6,10,12,14,45,58,-13,42
East Fife,6009,7,13,3,20,48,67,-19,42
Forfar,6009,8,10,6,20,38,64,-26,36
Queen's Park,6009,9,7,10,19,42,72,-30,31
Albion,6009,10,8,6,22,58,83,-25,30
Raith,6010,1,23,8,5,69,32,37,77
Ayr,6010,2,24,4,8,95,42,53,76
Arbroath,6010,3,17,8,11,70,49,21,59
Alloa,6010,4,17,8,11,56,44,12,59
Stranraer,6010,5,15,6,15,56,65,-9,51
Airdrieon,6010,6,11,11,14,47,58,-11,44
East Fife,6010,7,13,4,19,48,65,-17,43
Forfar,6010,8,10,5,21,38,66,-28,35
Queen's Park,6010,9,7,10,19,40,72,-32,31
Albion,6010,10,8,6,22,57,83,-26,30
Raith,6011,1,23,8,5,70,32,38,77
Ayr,6011,2,24,4,8,98,42,56,76
Arbroath,6011,3,18,8,10,72,49,23,62
Alloa,6011,4,17,8,11,56,45,11,59
Stranraer,6011,5,15,5,16,56,67,-11,50
East Fife,6011,6,14,3,19,50,65,-15,45
Airdrieon,6011,7,11,11,14,46,58,-12,44
Forfar,6011,8,10,5,21,38,65,-27,35
Albion,6011,9,8,6,22,57,86,-29,30
Queen's Park,6011,10,6,10,20,40,74,-34,28
Raith,6012,1,23,8,5,70,33,37,77
Ayr,6012,2,23,4,9,91,45,46,73
Arbroath,6012,3,17,8,11,71,50,21,59
Alloa,6012,4,17,8,11,57,45,12,59
Stranraer,6012,5,15,6,15,56,65,-9,51
East Fife,6012,6,13,4,19,48,65,-17,43
Airdrieon,6012,7,10,11,15,46,62,-16,41
Forfar,6012,8,11,5,20,42,65,-23,38
Albion,6012,9,9,6,21,60,79,-19,33
Queen's Park,6012,10,7,10,19,41,73,-32,31
Ayr,6013,1,24,4,8,94,42,52,76
Raith,6013,2,22,8,6,68,33,35,74
Arbroath,6013,3,18,8,10,72,49,23,62
Alloa,6013,4,18,8,10,57,43,14,62
Stranraer,6013,5,15,5,16,57,67,-10,50
East Fife,6013,6,14,3,19,50,66,-16,45
Airdrieon,6013,7,11,11,14,48,59,-11,44
Forfar,6013,8,10,5,21,39,67,-28,35
Albion,6013,9,8,6,22,57,82,-25,30
Queen's Park,6013,10,6,10,20,40,74,-34,28
Ayr,6014,1,23,5,8,92,44,48,74
Raith,6014,2,22,8,6,69,34,35,74
Alloa,6014,3,18,8,10,58,44,14,62
Arbroath,6014,4,17,9,10,70,48,22,60
Stranraer,6014,5,15,5,16,55,65,-10,50
East Fife,6014,6,14,3,19,48,64,-16,45
Airdrieon,6014,7,11,11,14,49,58,-9,44
Forfar,6014,8,10,5,21,38,68,-30,35
Albion,6014,9,8,7,21,59,80,-21,31
Queen's Park,6014,10,6,11,19,39,72,-33,29
Ayr,6015,1,24,4,8,96,43,53,76
Raith,6015,2,22,8,6,69,34,35,74
Arbroath,6015,3,18,8,10,73,48,25,62
Alloa,6015,4,18,8,10,58,44,14,62
Stranraer,6015,5,16,5,15,57,65,-8,53
Airdrieon,6015,6,11,11,14,48,59,-11,44
East Fife,6015,7,13,3,20,48,66,-18,42
Forfar,6015,8,10,5,21,39,67,-28,35
Albion,6015,9,8,6,22,58,84,-26,30
Queen's Park,6015,10,6,10,20,39,75,-36,28
Raith,6016,1,23,8,5,70,32,38,77
Ayr,6016,2,24,4,8,93,43,50,76
Arbroath,6016,3,18,8,10,73,50,23,62
Alloa,6016,4,17,8,11,56,45,11,59
Stranraer,6016,5,16,5,15,57,65,-8,53
Airdrieon,6016,6,10,12,14,46,59,-13,42
East Fife,6016,7,13,3,20,48,66,-18,42
Forfar,6016,8,10,6,20,39,65,-26,36
Albion,6016,9,8,6,22,58,81,-23,30
Queen's Park,6016,10,6,10,20,41,75,-34,28
Raith,6017,1,23,8,5,70,32,38,77
Ayr,6017,2,23,5,8,92,44,48,74
Arbroath,6017,3,18,8,10,74,49,25,62
Alloa,6017,4,17,8,11,56,45,11,59
Stranraer,6017,5,15,5,16,55,65,-10,50
East Fife,6017,6,14,3,19,48,64,-16,45
Airdrieon,6017,7,10,12,14,47,60,-13,42
Forfar,6017,8,10,6,20,40,66,-26,36
Albion,6017,9,8,7,21,59,80,-21,31
Queen's Park,6017,10,6,10,20,40,76,-36,28
Raith,6018,1,23,8,5,75,36,39,77
Ayr,6018,2,23,5,8,91,43,48,74
Arbroath,6018,3,18,8,10,72,49,23,62
Alloa,6018,4,17,8,11,60,50,10,59
Stranraer,6018,5,15,6,15,57,66,-9,51
East Fife,6018,6,13,4,19,49,66,-17,43
Airdrieon,6018,7,10,11,15,45,59,-14,41
Forfar,6018,8,11,5,20,39,64,-25,38
Albion,6018,9,8,7,21,58,79,-21,31
Queen's Park,6018,10,6,10,20,40,74,-34,28
Ayr,6019,1,24,4,8,94,45,49,76
Raith,6019,2,22,8,6,68,33,35,74
Alloa,6019,3,18,8,10,57,43,14,62
Arbroath,6019,4,17,8,11,71,51,20,59
Stranraer,6019,5,15,5,16,55,65,-10,50
East Fife,6019,6,14,3,19,48,64,-16,45
Airdrieon,6019,7,11,11,14,48,58,-10,44
Forfar,6019,8,10,5,21,38,67,-29,35
Queen's Park,6019,9,7,10,19,42,73,-31,31
Albion,6019,10,8,6,22,60,82,-22,30
Ayr,6020,1,24,4,8,93,43,50,76
Raith,6020,2,22,8,6,69,34,35,74
Alloa,6020,3,18,8,10,58,44,14,62
Arbroath,6020,4,17,8,11,70,49,21,59
Stranraer,6020,5,16,5,15,58,65,-7,53
Airdrieon,6020,6,11,11,14,46,58,-12,44
East Fife,6020,7,13,3,20,48,67,-19,42
Forfar,6020,8,10,5,21,38,65,-27,35
Queen's Park,6020,9,7,10,19,40,72,-32,31
Albion,6020,10,8,6,22,58,81,-23,30
Raith,6021,1,23,8,5,70,33,37,77
Ayr,6021,2,24,4,8,91,42,49,76
Arbroath,6021,3,18,8,10,74,51,23,62
Alloa,6021,4,17,8,11,57,45,12,59
Stranraer,6021,5,15,5,16,57,68,-11,50
East Fife,6021,6,14,3,19,51,66,-15,45
Airdrieon,6021,7,10,11,15,45,59,-14,41
Forfar,6021,8,11,5,20,39,64,-25,38
Albion,6021,9,8,6,22,57,79,-22,30
Queen's Park,6021,10,6,10,20,42,76,-34,28
Ayr,6022,1,24,4,8,96,43,53,76
Raith,6022,2,22,9,5,70,34,36,75
Arbroath,6022,3,18,8,10,72,48,24,62
Alloa,6022,4,17,9,10,58,45,13,60
Stranraer,6022,5,15,6,15,56,65,-9,51
Airdrieon,6022,6,11,11,14,46,58,-12,44
East Fife,6022,7,13,4,19,48,65,-17,43
Forfar,6022,8,10,5,21,38,65,-27,35
Albion,6022,9,8,6,22,58,84,-26,30
Queen's Park,6022,10,6,10,20,39,74,-35,28
Ayr,6023,1,24,4,8,95,44,51,76
Raith,6023,2,22,9,5,69,33,36,75
Arbroath,6023,3,17,9,10,72,50,22,60
Alloa,6023,4,17,9,10,57,44,13,60
Stranraer,6023,5,15,5,16,55,66,-11,50
East Fife,6023,6,14,3,19,49,64,-15,45
Airdrieon,6023,7,10,11,15,46,60,-14,41
Forfar,6023,8,11,5,20,40,65,-25,38
Albion,6023,9,8,6,22,59,83,-24,30
Queen's Park,6023,10,6,11,19,41,74,-33,29
Ayr,6024,1,24,4,8,96,42,54,76
Raith,6024,2,22,9,5,70,34,36,75
Arbroath,6024,3,18,8,10,73,49,24,62
Alloa,6024,4,17,9,10,58,45,13,60
Stranraer,6024,5,16,5,15,57,65,-8,53
East Fife,6024,6,13,3,20,48,66,-18,42
Airdrieon,6024,7,10,11,15,45,60,-15,41
Forfar,6024,8,11,5,20,40,64,-24,38
Albion,6024,9,8,6,22,57,84,-27,30
Queen's Park,6024,10,6,10,20,40,75,-35,28
Raith,6025,1,23,8,5,71,33,38,77
Ayr,6025,2,23,5,8,91,43,48,74
Arbroath,6025,3,18,8,10,74,48,26,62
Alloa,6025,4,17,8,11,57,46,11,59
Stranraer,6025,5,15,5,16,55,65,-10,50
East Fife,6025,6,14,3,19,48,64,-16,45
Airdrieon,6025,7,11,11,14,46,58,-12,44
Forfar,6025,8,10,5,21,38,65,-27,35
Albion,6025,9,8,7,21,58,79,-21,31
Queen's Park,6025,10,6,10,20,39,76,-37,28
Raith,6026,1,23,8,5,70,33,37,77
Ayr,6026,2,24,4,8,95,43,52,76
Arbroath,6026,3,17,9,10,72,50,22,60
Alloa,6026,4,17,8,11,57,45,12,59
Stranraer,6026,5,15,5,16,55,65,-10,50
East Fife,6026,6,14,3,19,48,64,-16,45
Airdrieon,6026,7,11,11,14,47,59,-12,44
Forfar,6026,8,10,5,21,39,66,-27,35
Albion,6026,9,8,6,22,58,83,-25,30
Queen's Park,6026,10,6,11,19,41,74,-33,29
Ayr,6027,1,24,4,8,92,43,49,76
Raith,6027,2,22,9,5,68,32,36,75
Arbroath,6027,3,18,8,10,72,49,23,62
Alloa,6027,4,17,9,10,56,43,13,60
Stranraer,6027,5,15,5,16,56,66,-10,50
East Fife,6027,6,14,3,19,49,65,-16,45
Airdrieon,6027,7,11,11,14,46,58,-12,44
Forfar,6027,8,10,5,21,38,65,-27,35
Albion,6027,9,8,6,22,58,80,-22,30
Queen's Park,6027,10,6,10,20,40,74,-34,28
Ayr,6028,1,23,5,8,93,45,48,74
Raith,6028,2,22,8,6,68,33,35,74
Arbroath,6028,3,18,8,10,72,48,24,62
Alloa,6028,4,18,8,10,57,43,14,62
Stranraer,6028,5,15,6,15,56,65,-9,51
Airdrieon,6028,6,11,11,14,52,58,-6,44
East Fife,6028,7,13,4,19,48,65,-17,43
Forfar,6028,8,10,5,21,38,71,-33,35
Albion,6028,9,8,7,21,60,81,-21,31
Queen's Park,6028,10,6,10,20,39,74,-35,28
Raith,6029,1,23,8,5,70,33,37,77
Ayr,6029,2,24,4,8,95,42,53,76
Arbroath,6029,3,18,8,10,75,50,25,62
Alloa,6029,4,17,8,11,57,45,12,59
Stranraer,6029,5,15,5,16,55,67,-12,50
East Fife,6029,6,14,3,19,50,64,-14,45
Airdrieon,6029,7,10,12,14,45,58,-13,42
Forfar,6029,8,10,6,20,38,64,-26,36
Albion,6029,9,8,6,22,57,83,-26,30
Queen's Park,6029,10,6,10,20,41,77,-36,28
Raith,6030,1,23,8,5,70,33,37,77
Ayr,6030,2,24,4,8,95,42,53,76
Arbroath,6030,3,17,8,11,72,51,21,59
Alloa,6030,4,17,8,11,57,45,12,59
Stranraer,6030,5,15,6,15,56,65,-9,51
East Fife,6030,6,13,4,19,48,65,-17,43
Airdrieon,6030,7,10,12,14,48,61,-13,42
Forfar,6030,8,10,6,20,41,67,-26,36
Queen's Park,6030,9,7,10,19,42,74,-32,31
Albion,6030,10,8,6,22,57,83,-26,30
Ayr,6031,1,24,4,8,95,42,53,76
Raith,6031,2,22,8,6,68,33,35,74
Arbroath,6031,3,18,8,10,72,48,24,62
Alloa,6031,4,18,8,10,57,43,14,62
Stranraer,6031,5,15,6,15,56,65,-9,51
East Fife,6031,6,13,4,19,48,65,-17,43
Airdrieon,6031,7,10,12,14,47,60,-13,42
Forfar,6031,8,10,6,20,40,66,-26,36
Albion,6031,9,8,6,22,57,83,-26,30
Queen's Park,6031,10,6,10,20,39,74,-35,28
Raith,6032,1,23,8,5,71,32,39,77
Ayr,6032,2,24,4,8,98,44,54,76
Arbroath,6032,3,17,9,10,70,48,22,60
Alloa,6032,4,17,8,11,56,46,10,59
Stranraer,6032,5,15,5,16,57,67,-10,50
East Fife,6032,6,14,3,19,50,66,-16,45
Airdrieon,6032,7,10,11,15,45,60,-15,41
Forfar,6032,8,11,5,20,40,64,-24,38
Albion,6032,9,8,6,22,59,86,-27,30
Queen's Park,6032,10,6,11,19,39,72,-33,29
Ayr,6033,1,24,4,8,93,42,51,76
Raith,6033,2,22,8,6,69,34,35,74
Alloa,6033,3,18,8,10,58,44,14,62
Arbroath,6033,4,17,9,10,70,48,22,60
Stranraer,6033,5,15,6,15,57,66,-9,51
Airdrieon,6033,6,11,11,14,47,58,-11,44
East Fife,6033,7,13,4,19,49,66,-17,43
Forfar,6033,8,10,5,21,38,66,-28,35
Albion,6033,9,8,6,22,57,81,-24,30
Queen's Park,6033,10,6,11,19,39,72,-33,29
Raith,6034,1,23,8,5,70,33,37,77
Ayr,6034,2,24,4,8,92,43,49,76
Arbroath,6034,3,17,8,11,72,51,21,59
Alloa,6034,4,17,8,11,57,45,12,59
Stranraer,6034,5,15,6,15,57,66,-9,51
Airdrieon,6034,6,11,11,14,48,59,-11,44
East Fife,6034,7,13,4,19,49,66,-17,43
Forfar,6034,8,10,5,21,39,67,-28,35
Queen's Park,6034,9,7,10,19,42,74,-32,31
Albion,6034,10,8,6,22,58,80,-22,30
Ayr,6035,1,24,4,8,93,42,51,76
Raith,6035,2,22,9,5,69,33,36,75
Alloa,6035,3,17,9,10,57,44,13,60
Arbroath,6035,4,17,8,11,71,52,19,59
Stranraer,6035,5,15,6,15,58,67,-9,51
Airdrieon,6035,6,11,11,14,47,59,-12,44
East Fife,6035,7,13,4,19,50,67,-17,43
Forfar,6035,8,10,5,21,39,66,-27,35
Queen's Park,6035,9,7,10,19,43,73,-30,31
Albion,6035,10,8,6,22,57,81,-24,30
Ayr,6036,1,24,4,8,97,44,53,76
Raith,6036,2,22,8,6,68,33,35,74
Arbroath,6036,3,18,8,10,71,48,23,62
Alloa,6036,4,18,8,10,57,43,14,62
Stranraer,6036,5,15,5,16,59,69,-10,50
East Fife,6036,6,14,3,19,52,68,-16,45
Airdrieon,6036,7,11,11,14,47,58,-11,44
Forfar,6036,8,10,5,21,38,66,-28,35
Albion,6036,9,8,6,22,59,85,-26,30
Queen's Park,6036,10,6,10,20,39,73,-34,28
Raith,6037,1,23,8,5,69,32,37,77
Ayr,6037,2,24,4,8,93,44,49,76
Arbroath,6037,3,17,9,10,72,50,22,60
Alloa,6037,4,17,8,11,56,44,12,59
Stranraer,6037,5,15,5,16,57,67,-10,50
East Fife,6037,6,14,3,19,50,66,-16,45
Airdrieon,6037,7,11,11,14,47,59,-12,44
Forfar,6037,8,10,5,21,39,66,-27,35
Albion,6037,9,8,6,22,59,81,-22,30
Queen's Park,6037,10,6,11,19,41,74,-33,29
Ayr,6038,1,24,4,8,92,43,49,76
Raith,6038,2,22,9,5,71,35,36,75
Arbroath,6038,3,18,8,10,72,49,23,62
Alloa,6038,4,17,9,10,59,46,13,60
Stranraer,6038,5,15,6,15,55,64,-9,51
Airdrieon,6038,6,11,11,14,47,58,-11,44
East Fife,6038,7,13,4,19,47,64,-17,43
Forfar,6038,8,10,5,21,38,66,-28,35
Albion,6038,9,8,6,22,58,80,-22,30
Queen's Park,6038,10,6,10,20,40,74,-34,28
Ayr,6039,1,24,4,8,92,42,50,76
Raith,6039,2,22,9,5,71,35,36,75
Arbroath,6039,3,18,8,10,73,50,23,62
Alloa,6039,4,17,9,10,59,46,13,60
Stranraer,6039,5,15,5,16,56,66,-10,50
East Fife,6039,6,14,3,19,49,65,-16,45
Airdrieon,6039,7,10,11,15,45,60,-15,41
Forfar,6039,8,11,5,20,40,64,-24,38
Albion,6039,9,8,6,22,57,80,-23,30
Queen's Park,6039,10,6,10,20,41,75,-34,28
Raith,6040,1,23,8,5,71,32,39,77
Ayr,6040,2,24,4,8,93,42,51,76
Arbroath,6040,3,18,8,10,72,48,24,62
Alloa,6040,4,17,8,11,56,46,10,59
Stranraer,6040,5,16,5,15,58,66,-8,53
Airdrieon,6040,6,11,11,14,48,59,-11,44
East Fife,6040,7,13,3,20,49,67,-18,42
Forfar,6040,8,10,5,21,39,67,-28,35
Albion,6040,9,8,6,22,57,81,-24,30
Queen's Park,6040,10,6,10,20,39,74,-35,28
Raith,6041,1,23,8,5,72,33,39,77
Ayr,6041,2,24,4,8,95,45,50,76
Arbroath,6041,3,17,8,11,70,51,19,59
Alloa,6041,4,17,8,11,57,47,10,59
Stranraer,6041,5,16,5,15,57,64,-7,53
Airdrieon,6041,6,10,12,14,47,60,-13,42
East Fife,6041,7,13,3,20,47,66,-19,42
Forfar,6041,8,10,6,20,40,66,-26,36
Queen's Park,6041,9,7,10,19,42,72,-30,31
Albion,6041,10,8,6,22,60,83,-23,30
Raith,6042,1,22,9,5,68,32,36,75
Ayr,6042,2,23,5,8,93,45,48,74
Arbroath,6042,3,18,8,10,73,49,24,62
Alloa,6042,4,17,9,10,56,43,13,60
Stranraer,6042,5,15,6,15,57,66,-9,51
East Fife,6042,6,13,4,19,49,66,-17,43
Airdrieon,6042,7,10,12,14,47,60,-13,42
Forfar,6042,8,10,6,20,40,66,-26,36
Albion,6042,9,8,7,21,60,81,-21,31
Queen's Park,6042,10,6,10,20,40,75,-35,28
Ayr,6043,1,24,4,8,97,42,55,76
Raith,6043,2,22,9,5,69,33,36,75
Alloa,6043,3,17,9,10,57,44,13,60
Arbroath,6043,4,17,8,11,71,50,21,59
Stranraer,6043,5,16,5,15,56,64,-8,53
East Fife,6043,6,13,3,20,47,65,-18,42
Airdrieon,6043,7,10,11,15,46,61,-15,41
Forfar,6043,8,11,5,20,41,65,-24,38
Queen's Park,6043,9,7,10,19,41,73,-32,31
Albion,6043,10,8,6,22,57,85,-28,30
Ayr,6044,1,24,4,8,93,42,51,76
Raith,6044,2,22,9,5,70,34,36,75
Arbroath,6044,3,17,9,10,72,50,22,60
Alloa,6044,4,17,9,10,58,45,13,60
Stranraer,6044,5,16,5,15,57,64,-7,53
Airdrieon,6044,6,11,11,14,48,59,-11,44
East Fife,6044,7,13,3,20,47,66,-19,42
Forfar,6044,8,10,5,21,39,67,-28,35
Albion,6044,9,8,6,22,57,81,-24,30
Queen's Park,6044,10,6,11,19,41,74,-33,29
Ayr,6045,1,24,4,8,94,44,50,76
Raith,6045,2,22,8,6,68,35,33,74
Alloa,6045,3,18,8,10,59,43,16,62
Arbroath,6045,4,17,9,10,70,48,22,60
Stranraer,6045,5,16,5,15,59,67,-8,53
Airdrieon,6045,6,11,11,14,46,58,-12,44
East Fife,6045,7,13,3,20,50,68,-18,42
Forfar,6045,8,10,5,21,38,65,-27,35
Albion,6045,9,8,6,22,59,82,-23,30
Queen's Park,6045,10,6,11,19,39,72,-33,29
Raith,6046,1,23,8,5,70,33,37,77
Ayr,6046,2,24,4,8,91,42,49,76
Arbroath,6046,3,18,8,10,72,48,24,62
Alloa,6046,4,17,8,11,57,45,12,59
Stranraer,6046,5,15,5,16,55,67,-12,50
East Fife,6046,6,14,3,19,50,64,-14,45
Airdrieon,6046,7,10,12,14,47,60,-13,42
Forfar,6046,8,10,6,20,40,66,-26,36
Albion,6046,9,8,6,22,57,79,-22,30
Queen's Park,6046,10,6,10,20,39,74,-35,28
Raith,6047,1,22,8,6,69,35,34,74
Ayr,6047,2,23,4,9,92,47,45,73
Alloa,6047,3,18,8,10,59,44,15,62
Arbroath,6047,4,17,9,10,71,49,22,60
Stranraer,6047,5,15,5,16,55,67,-12,50
East Fife,6047,6,14,3,19,50,64,-14,45
Airdrieon,6047,7,10,11,15,45,61,-16,41
Forfar,6047,8,11,5,20,41,64,-23,38
Albion,6047,9,9,6,21,62,80,-18,33
Queen's Park,6047,10,6,11,19,40,73,-33,29
Ayr,6048,1,24,4,8,94,44,50,76
Raith,6048,2,22,9,5,70,34,36,75
Arbroath,6048,3,17,9,10,71,49,22,60
Alloa,6048,4,17,9,10,58,45,13,60
Stranraer,6048,5,15,5,16,56,66,-10,50
East Fife,6048,6,14,3,19,49,65,-16,45
Airdrieon,6048,7,10,11,15,45,59,-14,41
Forfar,6048,8,11,5,20,39,64,-25,38
Albion,6048,9,8,6,22,59,82,-23,30
Queen's Park,6048,10,6,11,19,40,73,-33,29
Raith,6049,1,23,8,5,70,32,38,77
Ayr,6049,2,24,4,8,92,43,49,76
Arbroath,6049,3,18,8,10,72,49,23,62
Alloa,6049,4,17,8,11,56,45,11,59
Stranraer,6049,5,16,5,15,56,64,-8,53
Airdrieon,6049,6,11,11,14,47,58,-11,44
East Fife,6049,7,13,3,20,47,65,-18,42
Forfar,6049,8,10,5,21,38,66,-28,35
Albion,6049,9,8,6,22,58,80,-22,30
Queen's Park,6049,10,6,10,20,40,74,-34,28
Ayr,6050,1,23,5,8,92,44,48,74
Raith,6050,2,22,8,6,68,34,34,74
Arbroath,6050,3,18,8,10,74,48,26,62
Alloa,6050,4,18,8,10,58,43,15,62
Stranraer,6050,5,15,6,15,57,66,-9,51
East Fife,6050,6,13,4,19,49,66,-17,43
Airdrieon,6050,7,10,12,14,46,59,-13,42
Forfar,6050,8,10,6,20,39,65,-26,36
Albion,6050,9,8,7,21,59,80,-21,31
Queen's Park,6050,10,6,10,20,39,76,-37,28
Ayr,6051,1,24,4,8,94,42,52,76
Raith,6051,2,22,8,6,68,33,35,74
Arbroath,6051,3,18,8,10,74,50,24,62
Alloa,6051,4,18,8,10,57,43,14,62
Stranraer,6051,5,15,5,16,57,67,-10,50
East Fife,6051,6,14,3,19,50,66,-16,45
Airdrieon,6051,7,10,11,15,45,59,-14,41
Forfar,6051,8,11,5,20,39,64,-25,38
Albion,6051,9,8,6,22,57,82,-25,30
Queen's Park,6051,10,6,10,20,41,76,-35,28
Ayr,6052,1,23,5,8,93,45,48,74
Raith,6052,2,22,8,6,69,34,35,74
Arbroath,6052,3,18,8,10,75,50,25,62
Alloa,6052,4,18,8,10,58,44,14,62
Stranraer,6052,5,15,6,15,57,66,-9,51
Airdrieon,6052,6,11,11,14,48,59,-11,44
East Fife,6052,7,13,4,19,49,66,-17,43
Forfar,6052,8,10,5,21,39,67,-28,35
Albion,6052,9,8,7,21,60,81,-21,31
Queen's Park,6052,10,6,10,20,41,77,-36,28
Raith,6053,1,23,8,5,69,32,37,77
Ayr,6053,2,24,4,8,94,43,51,76
Arbroath,6053,3,18,8,10,74,50,24,62
Alloa,6053,4,17,8,11,56,44,12,59
Stranraer,6053,5,15,5,16,57,67,-10,50
East Fife,6053,6,14,3,19,50,66,-16,45
Airdrieon,6053,7,10,12,14,46,59,-13,42
Forfar,6053,8,10,6,20,39,65,-26,36
Albion,6053,9,8,6,22,58,82,-24,30
Queen's Park,6053,10,6,10,20,41,76,-35,28
Raith,6054,1,23,8,5,70,32,38,77
Ayr,6054,2,23,5,8,92,44,48,74
Arbroath,6054,3,18,8,10,72,49,23,62
Alloa,6054,4,17,8,11,56,45,11,59
Stranraer,6054,5,15,5,16,55,65,-10,50
East Fife,6054,6,14,3,19,48,64,-16,45
Airdrieon,6054,7,10,12,14,46,59,-13,42
Forfar,6054,8,10,6,20,39,65,-26,36
Albion,6054,9,8,7,21,59,80,-21,31
Queen's Park,6054,10,6,10,20,40,74,-34,28
Raith,6055,1,22,9,5,70,34,36,75
Ayr,6055,2,23,5,8,91,43,48,74
Arbroath,6055,3,17,9,10,72,50,22,60
Alloa,6055,4,17,9,10,58,45,13,60
Stranraer,6055,5,16,5,15,59,64,-5,53
Airdrieon,6055,6,11,11,14,48,59,-11,44
East Fife,6055,7,13,3,20,47,68,-21,42
Forfar,6055,8,10,5,21,39,67,-28,35
Albion,6055,9,8,7,21,58,79,-21,31
Queen's Park,6055,10,6,11,19,41,74,-33,29
Ayr,6056,1,24,4,8,95,43,52,76
Raith,6056,2,22,9,5,69,33,36,75
Alloa,6056,3,17,9,10,57,44,13,60
Arbroath,6056,4,17,8,11,72,51,21,59
Stranraer,6056,5,15,5,16,56,67,-11,50
East Fife,6056,6,14,3,19,50,65,-15,45
Airdrieon,6056,7,11,11,14,49,61,-12,44
Forfar,6056,8,10,5,21,41,68,-27,35
Queen's Park,6056,9,7,10,19,42,74,-32,31
Albion,6056,10,8,6,22,58,83,-25,30
Ayr,6057,1,24,4,8,95,43,52,76
Raith,6057,2,22,9,5,69,33,36,75
Arbroath,6057,3,18,8,10,71,48,23,62
Alloa,6057,4,17,9,10,57,44,13,60
Stranraer,6057,5,16,5,15,56,64,-8,53
Airdrieon,6057,6,10,12,14,46,59,-13,42
East Fife,6057,7,13,3,20,47,65,-18,42
Forfar,6057,8,10,6,20,39,65,-26,36
Albion,6057,9,8,6,22,58,83,-25,30
Queen's Park,6057,10,6,10,20,39,73,-34,28
Ayr,6058,1,24,4,8,93,43,50,76
Raith,6058,2,22,9,5,70,34,36,75
Alloa,6058,3,17,9,10,58,45,13,60
Arbroath,6058,4,17,8,11,71,50,21,59
Stranraer,6058,5,15,5,16,56,67,-11,50
East Fife,6058,6,14,3,19,50,65,-15,45
Airdrieon,6058,7,11,11,14,48,58,-10,44
Forfar,6058,8,10,5,21,38,67,-29,35
Queen's Park,6058,9,7,10,19,41,73,-32,31
Albion,6058,10,8,6,22,58,81,-23,30
Raith,6059,1,23,8,5,71,33,38,77
Ayr,6059,2,23,4,9,90,44,46,73
Arbroath,6059,3,17,8,11,71,50,21,59
Alloa,6059,4,17,8,11,57,46,11,59
Stranraer,6059,5,15,5,16,55,68,-13,50
East Fife,6059,6,14,3,19,51,64,-13,45
Airdrieon,6059,7,10,12,14,46,59,-13,42
Forfar,6059,8,10,6,20,39,65,-26,36
Albion,6059,9,9,6,21,59,78,-19,33
Queen's Park,6059,10,7,10,19,41,73,-32,31
Raith,6060,1,23,8,5,71,32,39,77
Ayr,6060,2,24,4,8,92,43,49,76
Arbroath,6060,3,17,9,10,71,49,22,60
Alloa,6060,4,17,8,11,56,46,10,59
Stranraer,6060,5,15,6,15,57,66,-9,51
East Fife,6060,6,13,4,19,49,66,-17,43
Airdrieon,6060,7,10,12,14,47,60,-13,42
Forfar,6060,8,10,6,20,40,66,-26,36
Albion,6060,9,8,6,22,58,80,-22,30
Queen's Park,6060,10,6,11,19,40,73,-33,29
Ayr,6061,1,24,4,8,94,42,52,76
Raith,6061,2,22,8,6,69,34,35,74
Arbroath,6061,3,18,8,10,72,48,24,62
Alloa,6061,4,18,8,10,58,44,14,62
Stranraer,6061,5,15,5,16,55,68,-13,50
East Fife,6061,6,14,3,19,51,64,-13,45
Airdrieon,6061,7,11,11,14,47,58,-11,44
Forfar,6061,8,10,5,21,38,66,-28,35
Albion,6061,9,8,6,22,57,82,-25,30
Queen's Park,6061,10,6,10,20,39,74,-35,28
Raith,6062,1,23,8,5,71,34,37,77
Ayr,6062,2,24,4,8,95,43,52,76
Arbroath,6062,3,17,9,10,70,48,22,60
Alloa,6062,4,17,8,11,58,46,12,59
Stranraer,6062,5,15,5,16,56,67,-11,50
East Fife,6062,6,14,3,19,50,65,-15,45
Airdrieon,6062,7,11,11,14,47,58,-11,44
Forfar,6062,8,10,5,21,38,66,-28,35
Albion,6062,9,8,6,22,58,83,-25,30
Queen's Park,6062,10,6,11,19,39,72,-33,29
Raith,6063,1,23,8,5,70,33,37,77
Ayr,6063,2,23,4,9,91,44,47,73
Arbroath,6063,3,18,8,10,74,48,26,62
Alloa,6063,4,17,8,11,57,45,12,59
Stranraer,6063,5,15,6,15,57,66,-9,51
East Fife,6063,6,13,4,19,49,66,-17,43
Airdrieon,6063,7,10,12,14,47,60,-13,42
Forfar,6063,8,10,6,20,40,66,-26,36
Albion,6063,9,9,6,21,59,79,-20,33
Queen's Park,6063,10,6,10,20,39,76,-37,28
Ayr,6064,1,24,4,8,93,43,50,76
Raith,6064,2,22,9,5,69,33,36,75
Arbroath,6064,3,18,8,10,74,49,25,62
Alloa,6064,4,17,9,10,57,44,13,60
Stranraer,6064,5,16,5,15,57,64,-7,53
Airdrieon,6064,6,11,11,14,48,59,-11,44
East Fife,6064,7,13,3,20,47,66,-19,42
Forfar,6064,8,10,5,21,39,67,-28,35
Albion,6064,9,8,6,22,58,81,-23,30
Queen's Park,6064,10,6,10,20,40,76,-36,28
Ayr,6065,1,24,4,8,95,43,52,76
Raith,6065,2,22,9,5,69,33,36,75
Arbroath,6065,3,18,8,10,74,49,25,62
Alloa,6065,4,17,9,10,57,44,13,60
Stranraer,6065,5,16,5,15,56,64,-8,53
East Fife,6065,6,13,3,20,47,65,-18,42
Airdrieon,6065,7,10,11,15,45,60,-15,41
Forfar,6065,8,11,5,20,40,64,-24,38
Albion,6065,9,8,6,22,58,83,-25,30
Queen's Park,6065,10,6,10,20,40,76,-36,28
Raith,6066,1,23,8,5,74,35,39,77
Ayr,6066,2,24,4,8,92,43,49,76
Arbroath,6066,3,17,8,11,71,50,21,59
Alloa,6066,4,17,8,11,59,49,10,59
Stranraer,6066,5,15,5,16,55,65,-10,50
East Fife,6066,6,14,3,19,48,64,-16,45
Airdrieon,6066,7,11,11,14,48,58,-10,44
Forfar,6066,8,10,5,21,38,67,-29,35
Queen's Park,6066,9,7,10,19,41,73,-32,31
Albion,6066,10,8,6,22,58,80,-22,30
Raith,6067,1,23,8,5,70,33,37,77
Ayr,6067,2,24,4,8,92,43,49,76
Arbroath,6067,3,18,8,10,72,49,23,62
Alloa,6067,4,17,8,11,57,45,12,59
Stranraer,6067,5,16,5,15,57,65,-8,53
Airdrieon,6067,6,11,11,14,47,59,-12,44
East Fife,6067,7,13,3,20,48,66,-18,42
Forfar,6067,8,10,5,21,39,66,-27,35
Albion,6067,9,8,6,22,58,80,-22,30
Queen's Park,6067,10,6,10,20,40,74,-34,28
Raith,6068,1,23,8,5,69,32,37,77
Ayr,6068,2,24,4,8,95,44,51,76
Arbroath,6068,3,18,8,10,73,49,24,62
Alloa,6068,4,17,8,11,56,44,12,59
Stranraer,6068,5,15,5,16,55,65,-10,50
East Fife,6068,6,14,3,19,48,64,-16,45
Airdrieon,6068,7,10,11,15,45,59,-14,41
Forfar,6068,8,11,5,20,39,64,-25,38
Albion,6068,9,8,6,22,59,83,-24,30
Queen's Park,6068,10,6,10,20,40,75,-35,28
Raith,6069,1,23,8,5,69,32,37,77
Ayr,6069,2,24,4,8,91,42,49,76
Arbroath,6069,3,18,8,10,73,50,23,62
Alloa,6069,4,17,8,11,56,44,12,59
Stranraer,6069,5,15,6,15,57,66,-9,51
Airdrieon,6069,6,11,11,14,47,59,-12,44
East Fife,6069,7,13,4,19,49,66,-17,43
Forfar,6069,8,10,5,21,39,66,-27,35
Albion,6069,9,8,6,22,57,79,-22,30
Queen's Park,6069,10,6,10,20,41,75,-34,28
Ayr,6070,1,24,4,8,94,43,51,76
Raith,6070,2,22,8,6,68,33,35,74
Arbroath,6070,3,18,8,10,74,48,26,62
Alloa,6070,4,18,8,10,57,43,14,62
Stranraer,6070,5,15,5,16,55,65,-10,50
East Fife,6070,6,14,3,19,48,64,-16,45
Airdrieon,6070,7,10,12,14,46,59,-13,42
Forfar,6070,8,10,6,20,39,65,-26,36
Albion,6070,9,8,6,22,58,82,-24,30
Queen's Park,6070,10,6,10,20,39,76,-37,28
Raith,6071,1,23,8,5,71,33,38,77
Ayr,6071,2,24,4,8,96,43,53,76
Arbroath,6071,3,18,8,10,72,49,23,62
Alloa,6071,4,17,8,11,57,46,11,59
Stranraer,6071,5,15,5,16,56,67,-11,50
East Fife,6071,6,14,3,19,50,65,-15,45
Airdrieon,6071,7,10,12,14,46,59,-13,42
Forfar,6071,8,10,6,20,39,65,-26,36
Albion,6071,9,8,6,22,58,84,-26,30
Queen's Park,6071,10,6,10,20,40,74,-34,28
Raith,6072,1,23,8,5,71,32,39,77
Ayr,6072,2,23,5,8,93,45,48,74
Arbroath,6072,3,17,9,10,70,48,22,60
Alloa,6072,4,17,8,11,56,46,10,59
Stranraer,6072,5,15,6,15,56,65,-9,51
East Fife,6072,6,13,4,19,48,65,-17,43
Airdrieon,6072,7,10,12,14,46,59,-13,42
Forfar,6072,8,10,6,20,39,65,-26,36
Albion,6072,9,8,7,21,60,81,-21,31
Queen's Park,6072,10,6,11,19,39,72,-33,29
Ayr,6073,1,23,5,8,92,44,48,74
Raith,6073,2,22,8,6,68,33,35,74
Alloa,6073,3,18,8,10,57,43,14,62
Arbroath,6073,4,17,9,10,73,51,22,60
Stranraer,6073,5,16,5,15,59,66,-7,53
Airdrieon,6073,6,11,11,14,47,59,-12,44
East Fife,6073,7,13,3,20,49,68,-19,42
Forfar,6073,8,10,5,21,39,66,-27,35
Albion,6073,9,8,7,21,59,80,-21,31
Queen's Park,6073,10,6,11,19,42,75,-33,29
Raith,6074,1,23,8,5,70,33,37,77
Ayr,6074,2,24,4,8,94,43,51,76
Arbroath,6074,3,18,8,10,72,49,23,62
Alloa,6074,4,17,8,11,57,45,12,59
Stranraer,6074,5,15,5,16,56,66,-10,50
East Fife,6074,6,14,3,19,49,65,-16,45
Airdrieon,6074,7,11,11,14,47,58,-11,44
Forfar,6074,8,10,5,21,38,66,-28,35
Albion,6074,9,8,6,22,58,82,-24,30
Queen's Park,6074,10,6,10,20,40,74,-34,28
Raith,6075,1,23,8,5,70,32,38,77
Ayr,6075,2,24,4,8,92,42,50,76
Arbroath,6075,3,17,9,10,72,50,22,60
Alloa,6075,4,17,8,11,56,45,11,59
Stranraer,6075,5,15,6,15,56,65,-9,51
Airdrieon,6075,6,11,11,14,48,60,-12,44
East Fife,6075,7,13,4,19,48,65,-17,43
Forfar,6075,8,10,5,21,40,67,-27,35
Albion,6075,9,8,6,22,57,80,-23,30
Queen's Park,6075,10,6,11,19,41,74,-33,29
Raith,6076,1,22,9,5,68,32,36,75
Ayr,6076,2,23,4,9,91,45,46,73
Arbroath,6076,3,18,8,10,74,50,24,62
Alloa,6076,4,17,9,10,56,43,13,60
Stranraer,6076,5,15,6,15,57,66,-9,51
East Fife,6076,6,13,4,19,49,66,-17,43
Airdrieon,6076,7,10,11,15,45,60,-15,41
Forfar,6076,8,11,5,20,40,64,-24,38
Albion,6076,9,9,6,21,60,79,-19,33
Queen's Park,6076,10,6,10,20,41,76,-35,28
Raith,6077,1,23,8,5,71,32,39,77
Ayr,6077,2,23,5,8,90,42,48,74
Arbroath,6077,3,17,9,10,72,50,22,60
Alloa,6077,4,17,8,11,56,46,10,59
Stranraer,6077,5,15,6,15,56,65,-9,51
Airdrieon,6077,6,11,11,14,48,59,-11,44
East Fife,6077,7,13,4,19,48,65,-17,43
Forfar,6077,8,10,5,21,39,67,-28,35
Albion,6077,9,8,7,21,57,78,-21,31
Queen's Park,6077,10,6,11,19,41,74,-33,29
Raith,6078,1,22,9,5,70,34,36,75
Ayr,6078,2,23,5,8,92,44,48,74
Alloa,6078,3,17,9,10,58,45,13,60
Arbroath,6078,4,17,8,11,71,50,21,59
Stranraer,6078,5,16,5,15,58,65,-7,53
East Fife,6078,6,13,3,20,48,67,-19,42
Airdrieon,6078,7,10,11,15,46,60,-14,41
Forfar,6078,8,11,5,20,40,65,-25,38
Albion,6078,9,8,7,21,59,80,-21,31
Queen's Park,6078,10,7,10,19,41,73,-32,31
Raith,6079,1,23,8,5,70,32,38,77
Ayr,6079,2,24,4,8,97,42,55,76
Arbroath,6079,3,18,8,10,71,48,23,62
Alloa,6079,4,17,8,11,56,45,11,59
Stranraer,6079,5,15,5,16,56,66,-10,50
East Fife,6079,6,14,3,19,49,65,-16,45
Airdrieon,6079,7,11,11,14,47,59,-12,44
Forfar,6079,8,10,5,21,39,66,-27,35
Albion,6079,9,8,6,22,57,85,-28,30
Queen's Park,6079,10,6,10,20,39,73,-34,28
Raith,6080,1,23,8,5,71,34,37,77
Ayr,6080,2,24,4,8,95,43,52,76
Arbroath,6080,3,17,8,11,70,52,18,59
Alloa,6080,4,17,8,11,58,46,12,59
Stranraer,6080,5,15,5,16,55,66,-11,50
East Fife,6080,6,14,3,19,49,64,-15,45
Airdrieon,6080,7,11,11,14,48,58,-10,44
Forfar,6080,8,10,5,21,38,67,-29,35
Queen's Park,6080,9,7,10,19,43,72,-29,31
Albion,6080,10,8,6,22,58,83,-25,30
Raith,6081,1,23,8,5,71,33,38,77
Ayr,6081,2,24,4,8,91,42,49,76
Arbroath,6081,3,18,8,10,72,49,23,62
Alloa,6081,4,17,8,11,57,46,11,59
Stranraer,6081,5,16,5,15,58,65,-7,53
Airdrieon,6081,6,11,11,14,47,59,-12,44
East Fife,6081,7,13,3,20,48,67,-19,42
Forfar,6081,8,10,5,21,39,66,-27,35
Albion,6081,9,8,6,22,57,79,-22,30
Queen's Park,6081,10,6,10,20,40,74,-34,28
Raith,6082,1,23,8,5,73,32,41,77
Ayr,6082,2,23,4,9,91,44,47,73
Arbroath,6082,3,18,8,10,72,49,23,62
Alloa,6082,4,17,8,11,56,48,8,59
Stranraer,6082,5,15,6,15,57,66,-9,51
Airdrieon,6082,6,11,11,14,48,58,-10,44
East Fife,6082,7,13,4,19,49,66,-17,43
Forfar,6082,8,10,5,21,38,67,-29,35
Albion,6082,9,9,6,21,59,79,-20,33
Queen's Park,6082,10,6,10,20,40,74,-34,28
Raith,6083,1,23,8,5,71,33,38,77
Ayr,6083,2,24,4,8,92,42,50,76
Arbroath,6083,3,18,8,10,73,48,25,62
Alloa,6083,4,17,8,11,57,46,11,59
Stranraer,6083,5,15,5,16,56,67,-11,50
East Fife,6083,6,14,3,19,50,65,-15,45
Airdrieon,6083,7,10,11,15,45,60,-15,41
Forfar,6083,8,11,5,20,40,64,-24,38
Albion,6083,9,8,6,22,57,80,-23,30
Queen's Park,6083,10,6,10,20,39,75,-36,28
Ayr,6084,1,24,4,8,94,43,51,76
Raith,6084,2,22,9,5,70,34,36,75
Arbroath,6084,3,17,9,10,71,49,22,60
Alloa,6084,4,17,9,10,58,45,13,60
Stranraer,6084,5,16,5,15,56,64,-8,53
East Fife,6084,6,13,3,20,47,65,-18,42
Airdrieon,6084,7,10,11,15,46,61,-15,41
Forfar,6084,8,11,5,20,41,65,-24,38
Albion,6084,9,8,6,22,58,82,-24,30
Queen's Park,6084,10,6,11,19,40,73,-33,29
Ayr,6085,1,24,4,8,94,42,52,76
Raith,6085,2,22,9,5,69,33,36,75
Alloa,6085,3,17,9,10,57,44,13,60
Arbroath,6085,4,17,8,11,71,53,18,59
Stranraer,6085,5,15,5,16,56,66,-10,50
East Fife,6085,6,14,3,19,49,65,-16,45
Airdrieon,6085,7,11,11,14,47,58,-11,44
Forfar,6085,8,10,5,21,38,66,-28,35
Queen's Park,6085,9,7,10,19,44,73,-29,31
Albion,6085,10,8,6,22,57,82,-25,30
Ayr,6086,1,24,4,8,100,42,58,76
Raith,6086,2,22,8,6,68,33,35,74
Arbroath,6086,3,18,8,10,73,50,23,62
Alloa,6086,4,18,8,10,57,43,14,62
Stranraer,6086,5,15,6,15,56,65,-9,51
East Fife,6086,6,13,4,19,48,65,-17,43
Airdrieon,6086,7,10,12,14,45,58,-13,42
Forfar,6086,8,10,6,20,38,64,-26,36
Albion,6086,9,8,6,22,57,88,-31,30
Queen's Park,6086,10,6,10,20,41,75,-34,28
Raith,6087,1,23,8,5,71,32,39,77
Ayr,6087,2,23,4,9,91,46,45,73
Arbroath,6087,3,17,9,10,71,49,22,60
Alloa,6087,4,17,8,11,56,46,10,59
Stranraer,6087,5,15,6,15,56,65,-9,51
East Fife,6087,6,13,4,19,48,65,-17,43
Airdrieon,6087,7,10,12,14,46,59,-13,42
Forfar,6087,8,10,6,20,39,65,-26,36
Albion,6087,9,9,6,21,61,79,-18,33
Queen's Park,6087,10,6,11,19,40,73,-33,29
Raith,6088,1,23,8,5,70,33,37,77
Ayr,6088,2,24,4,8,93,43,50,76
Arbroath,6088,3,17,9,10,73,51,22,60
Alloa,6088,4,17,8,11,57,45,12,59
Stranraer,6088,5,16,5,15,59,64,-5,53
East Fife,6088,6,13,3,20,47,68,-21,42
Airdrieon,6088,7,10,11,15,45,59,-14,41
Forfar,6088,8,11,5,20,39,64,-25,38
Albion,6088,9,8,6,22,58,81,-23,30
Queen's Park,6088,10,6,11,19,42,75,-33,29
Raith,6089,1,23,8,5,71,32,39,77
Ayr,6089,2,24,4,8,92,43,49,76
Arbroath,6089,3,18,8,10,75,51,24,62
Alloa,6089,4,17,8,11,56,46,10,59
Stranraer,6089,5,15,5,16,56,67,-11,50
East Fife,6089,6,14,3,19,50,65,-15,45
Airdrieon,6089,7,10,11,15,46,60,-14,41
Forfar,6089,8,11,5,20,40,65,-25,38
Albion,6089,9,8,6,22,58,80,-22,30
Queen's Park,6089,10,6,10,20,42,77,-35,28
Ayr,6090,1,24,4,8,96,44,52,76
Raith,6090,2,22,8,6,69,34,35,74
Arbroath,6090,3,18,8,10,73,49,24,62
Alloa,6090,4,18,8,10,58,44,14,62
Stranraer,6090,5,15,5,16,55,67,-12,50
East Fife,6090,6,14,3,19,50,64,-14,45
Airdrieon,6090,7,11,11,14,47,58,-11,44
Forfar,6090,8,10,5,21,38,66,-28,35
Albion,6090,9,8,6,22,59,84,-25,30
Queen's Park,6090,10,6,10,20,40,75,-35,28
Raith,6091,1,23,8,5,70,32,38,77
Ayr,6091,2,24,4,8,96,44,52,76
Arbroath,6091,3,17,9,10,70,48,22,60
Alloa,6091,4,17,8,11,56,45,11,59
Stranraer,6091,5,16,5,15,57,65,-8,53
Airdrieon,6091,6,11,11,14,48,58,-10,44
East Fife,6091,7,13,3,20,48,66,-18,42
Forfar,6091,8,10,5,21,38,67,-29,35
Albion,6091,9,8,6,22,59,84,-25,30
Queen's Park,6091,10,6,11,19,39,72,-33,29
Raith,6092,1,23,8,5,69,32,37,77
Ayr,6092,2,23,5,8,92,44,48,74
Arbroath,6092,3,18,8,10,72,49,23,62
Alloa,6092,4,17,8,11,56,44,12,59
Stranraer,6092,5,16,5,15,58,65,-7,53
Airdrieon,6092,6,11,11,14,46,58,-12,44
East Fife,6092,7,13,3,20,48,67,-19,42
Forfar,6092,8,10,5,21,38,65,-27,35
Albion,6092,9,8,7,21,59,80,-21,31
Queen's Park,6092,10,6,10,20,40,74,-34,28
Raith,6093,1,23,8,5,72,32,40,77
Ayr,6093,2,24,4,8,93,42,51,76
Arbroath,6093,3,17,9,10,71,49,22,60
Alloa,6093,4,17,8,11,56,47,9,59
Stranraer,6093,5,15,6,15,57,66,-9,51
East Fife,6093,6,13,4,19,49,66,-17,43
Airdrieon,6093,7,10,12,14,45,58,-13,42
Forfar,6093,8,10,6,20,38,64,-26,36
Albion,6093,9,8,6,22,57,81,-24,30
Queen's Park,6093,10,6,11,19,40,73,-33,29
Ayr,6094,1,24,4,8,93,43,50,76
Raith,6094,2,22,9,5,69,33,36,75
Arbroath,6094,3,18,8,10,75,49,26,62
Alloa,6094,4,17,9,10,57,44,13,60
Stranraer,6094,5,15,6,15,57,66,-9,51
Airdrieon,6094,6,11,11,14,46,58,-12,44
East Fife,6094,7,13,4,19,49,66,-17,43
Forfar,6094,8,10,5,21,38,65,-27,35
Albion,6094,9,8,6,22,58,81,-23,30
Queen's Park,6094,10,6,10,20,40,77,-37,28
Raith,6095,1,23,8,5,70,32,38,77
Ayr,6095,2,24,4,8,93,44,49,76
Arbroath,6095,3,17,8,11,70,50,20,59
Alloa,6095,4,17,8,11,56,45,11,59
Stranraer,6095,5,15,5,16,56,66,-10,50
East Fife,6095,6,14,3,19,49,65,-16,45
Airdrieon,6095,7,11,11,14,46,58,-12,44
Forfar,6095,8,10,5,21,38,65,-27,35
Queen's Park,6095,9,7,10,19,41,72,-31,31
Albion,6095,10,8,6,22,59,81,-22,30
Raith,6096,1,23,8,5,70,32,38,77
Ayr,6096,2,24,4,8,93,42,51,76
Arbroath,6096,3,17,9,10,71,49,22,60
Alloa,6096,4,17,8,11,56,45,11,59
Stranraer,6096,5,15,6,15,55,64,-9,51
East Fife,6096,6,13,4,19,47,64,-17,43
Airdrieon,6096,7,10,11,15,45,61,-16,41
Forfar,6096,8,11,5,20,41,64,-23,38
Albion,6096,9,8,6,22,57,81,-24,30
Queen's Park,6096,10,6,11,19,40,73,-33,29
Ayr,6097,1,24,4,8,95,45,50,76
Raith,6097,2,22,8,6,68,33,35,74
Alloa,6097,3,18,8,10,57,43,14,62
Arbroath,6097,4,17,9,10,73,51,22,60
Stranraer,6097,5,15,5,16,55,66,-11,50
East Fife,6097,6,14,3,19,49,64,-15,45
Airdrieon,6097,7,10,12,14,46,59,-13,42
Forfar,6097,8,10,6,20,39,65,-26,36
Albion,6097,9,8,6,22,60,83,-23,30
Queen's Park,6097,10,6,11,19,42,75,-33,29
Raith,6098,1,23,8,5,71,32,39,77
Ayr,6098,2,24,4,8,93,44,49,76
Arbroath,6098,3,17,9,10,73,51,22,60
Alloa,6098,4,17,8,11,56,46,10,59
Stranraer,6098,5,15,5,16,56,69,-13,50
East Fife,6098,6,14,3,19,52,65,-13,45
Airdrieon,6098,7,11,11,14,46,58,-12,44
Forfar,6098,8,10,5,21,38,65,-27,35
Albion,6098,9,8,6,22,59,81,-22,30
Queen's Park,6098,10,6,11,19,42,75,-33,29
Raith,6099,1,23,8,5,74,33,41,77
Ayr,6099,2,24,4,8,96,45,51,76
Arbroath,6099,3,17,8,11,71,50,21,59
Alloa,6099,4,17,8,11,57,49,8,59
Stranraer,6099,5,16,5,15,56,64,-8,53
Airdrieon,6099,6,11,11,14,48,58,-10,44
East Fife,6099,7,13,3,20,47,65,-18,42
Forfar,6099,8,10,5,21,38,67,-29,35
Queen's Park,6099,9,7,10,19,41,73,-32,31
Albion,6099,10,8,6,22,60,84,-24,30
Raith,6100,1,23,8,5,70,32,38,77
Ayr,6100,2,24,4,8,92,42,50,76
Arbroath,6100,3,17,9,10,71,49,22,60
Alloa,6100,4,17,8,11,56,45,11,59
Stranraer,6100,5,15,6,15,56,65,-9,51
Airdrieon,6100,6,11,11,14,47,59,-12,44
East Fife,6100,7,13,4,19,48,65,-17,43
Forfar,6100,8,10,5,21,39,66,-27,35
Albion,6100,9,8,6,22,57,80,-23,30
Queen's Park,6100,10,6,11,19,40,73,-33,29
Ayr,6101,1,24,4,8,92,43,49,76
Raith,6101,2,22,9,5,68,32,36,75
Alloa,6101,3,17,9,10,56,43,13,60
Arbroath,6101,4,17,8,11,70,50,20,59
Stranraer,6101,5,15,6,15,57,66,-9,51
East Fife,6101,6,13,4,19,49,66,-17,43
Airdrieon,6101,7,10,11,15,46,62,-16,41
Forfar,6101,8,11,5,20,42,65,-23,38
Queen's Park,6101,9,7,10,19,41,72,-31,31
Albion,6101,10,8,6,22,58,80,-22,30
Raith,6102,1,23,8,5,70,33,37,77
Ayr,6102,2,24,4,8,94,43,51,76
Arbroath,6102,3,18,8,10,74,51,23,62
Alloa,6102,4,17,8,11,57,45,12,59
Stranraer,6102,5,16,5,15,58,64,-6,53
Airdrieon,6102,6,11,11,14,49,58,-9,44
East Fife,6102,7,13,3,20,47,67,-20,42
Forfar,6102,8,10,5,21,38,68,-30,35
Albion,6102,9,8,6,22,58,82,-24,30
Queen's Park,6102,10,6,10,20,42,76,-34,28
Raith,6103,1,23,8,5,71,32,39,77
Ayr,6103,2,24,4,8,94,42,52,76
Arbroath,6103,3,17,9,10,70,48,22,60
Alloa,6103,4,17,8,11,56,46,10,59
Stranraer,6103,5,15,5,16,56,66,-10,50
East Fife,6103,6,14,3,19,49,65,-16,45
Airdrieon,6103,7,11,11,14,47,59,-12,44
Forfar,6103,8,10,5,21,39,66,-27,35
Albion,6103,9,8,6,22,57,82,-25,30
Queen's Park,6103,10,6,11,19,39,72,-33,29
Raith,6104,1,23,8,5,71,32,39,77
Ayr,6104,2,23,4,9,93,46,47,73
Arbroath,6104,3,17,8,11,71,51,20,59
Alloa,6104,4,17,8,11,56,46,10,59
Stranraer,6104,5,15,5,16,55,65,-10,50
East Fife,6104,6,14,3,19,48,64,-16,45
Airdrieon,6104,7,10,11,15,45,60,-15,41
Forfar,6104,8,11,5,20,40,64,-24,38
Albion,6104,9,9,6,21,61,81,-20,33
Queen's Park,6104,10,7,10,19,42,73,-31,31
Raith,6105,1,23,8,5,71,33,38,77
Ayr,6105,2,24,4,8,97,43,54,76
Arbroath,6105,3,17,8,11,71,51,20,59
Alloa,6105,4,17,8,11,57,46,11,59
Stranraer,6105,5,16,5,15,57,65,-8,53
East Fife,6105,6,13,3,20,48,66,-18,42
Airdrieon,6105,7,10,11,15,45,61,-16,41
Forfar,6105,8,11,5,20,41,64,-23,38
Queen's Park,6105,9,7,10,19,42,73,-31,31
Albion,6105,10,8,6,22,58,85,-27,30
Ayr,6106,1,24,4,8,94,45,49,76
Raith,6106,2,22,9,5,69,33,36,75
Arbroath,6106,3,17,9,10,71,49,22,60
Alloa,6106,4,17,9,10,57,44,13,60
Stranraer,6106,5,16,5,15,56,64,-8,53
Airdrieon,6106,6,10,12,14,46,59,-13,42
East Fife,6106,7,13,3,20,47,65,-18,42
Forfar,6106,8,10,6,20,39,65,-26,36
Albion,6106,9,8,6,22,60,82,-22,30
Queen's Park,6106,10,6,11,19,40,73,-33,29
Ayr,6107,1,23,5,8,92,44,48,74
Raith,6107,2,22,8,6,69,34,35,74
Arbroath,6107,3,18,8,10,72,49,23,62
Alloa,6107,4,18,8,10,58,44,14,62
Stranraer,6107,5,15,5,16,56,68,-12,50
East Fife,6107,6,14,3,19,51,65,-14,45
Airdrieon,6107,7,11,11,14,47,58,-11,44
Forfar,6107,8,10,5,21,38,66,-28,35
Albion,6107,9,8,7,21,59,80,-21,31
Queen's Park,6107,10,6,10,20,40,74,-34,28
Raith,6108,1,23,8,5,69,32,37,77
Ayr,6108,2,24,4,8,96,44,52,76
Arbroath,6108,3,17,8,11,71,50,21,59
Alloa,6108,4,17,8,11,56,44,12,59
Stranraer,6108,5,16,5,15,57,65,-8,53
Airdrieon,6108,6,10,12,14,46,59,-13,42
East Fife,6108,7,13,3,20,48,66,-18,42
Forfar,6108,8,10,6,20,39,65,-26,36
Queen's Park,6108,9,7,10,19,41,73,-32,31
Albion,6108,10,8,6,22,59,84,-25,30
Ayr,6109,1,24,4,8,97,43,54,76
Raith,6109,2,22,9,5,68,32,36,75
Arbroath,6109,3,18,8,10,72,48,24,62
Alloa,6109,4,17,9,10,56,43,13,60
Stranraer,6109,5,15,6,15,56,65,-9,51
Airdrieon,6109,6,11,11,14,46,58,-12,44
East Fife,6109,7,13,4,19,48,65,-17,43
Forfar,6109,8,10,5,21,38,65,-27,35
Albion,6109,9,8,6,22,58,85,-27,30
Queen's Park,6109,10,6,10,20,39,74,-35,28
Ayr,6110,1,24,4,8,93,44,49,76
Raith,6110,2,22,8,6,69,35,34,74
Arbroath,6110,3,18,8,10,73,49,24,62
Alloa,6110,4,18,8,10,59,44,15,62
Stranraer,6110,5,16,5,15,57,65,-8,53
Airdrieon,6110,6,11,11,14,50,59,-9,44
East Fife,6110,7,13,3,20,48,66,-18,42
Forfar,6110,8,10,5,21,39,69,-30,35
Albion,6110,9,8,6,22,59,81,-22,30
Queen's Park,6110,10,6,10,20,40,75,-35,28
Raith,6111,1,23,8,5,71,33,38,77
Ayr,6111,2,24,4,8,94,43,51,76
Arbroath,6111,3,18,8,10,74,50,24,62
Alloa,6111,4,17,8,11,57,46,11,59
Stranraer,6111,5,15,5,16,56,66,-10,50
East Fife,6111,6,14,3,19,49,65,-16,45
Airdrieon,6111,7,10,11,15,45,59,-14,41
Forfar,6111,8,11,5,20,39,64,-25,38
Albion,6111,9,8,6,22,58,82,-24,30
Queen's Park,6111,10,6,10,20,41,76,-35,28
Raith,6112,1,23,8,5,69,32,37,77
Ayr,6112,2,24,4,8,93,42,51,76
Arbroath,6112,3,18,8,10,71,48,23,62
Alloa,6112,4,17,8,11,56,44,12,59
Stranraer,6112,5,15,5,16,56,66,-10,50
East Fife,6112,6,14,3,19,49,65,-16,45
Airdrieon,6112,7,11,11,14,47,58,-11,44
Forfar,6112,8,10,5,21,38,66,-28,35
Albion,6112,9,8,6,22,57,81,-24,30
Queen's Park,6112,10,6,10,20,39,73,-34,28
Raith,6113,1,23,8,5,72,32,40,77
Ayr,6113,2,24,4,8,92,43,49,76
Arbroath,6113,3,17,8,11,70,50,20,59
Alloa,6113,4,17,8,11,56,47,9,59
Stranraer,6113,5,15,5,16,56,66,-10,50
East Fife,6113,6,14,3,19,49,65,-16,45
Airdrieon,6113,7,10,11,15,45,59,-14,41
Forfar,6113,8,11,5,20,39,64,-25,38
Queen's Park,6113,9,7,10,19,41,72,-31,31
Albion,6113,10,8,6,22,58,80,-22,30
Raith,6114,1,23,8,5,71,33,38,77
Ayr,6114,2,23,5,8,93,45,48,74
Arbroath,6114,3,17,8,11,71,50,21,59
Alloa,6114,4,17,8,11,57,46,11,59
Stranraer,6114,5,15,5,16,55,65,-10,50
East Fife,6114,6,14,3,19,48,64,-16,45
Airdrieon,6114,7,10,12,14,47,60,-13,42
Forfar,6114,8,10,6,20,40,66,-26,36
Albion,6114,9,8,7,21,60,81,-21,31
Queen's Park,6114,10,7,10,19,41,73,-32,31
Ayr,6115,1,24,4,8,94,43,51,76
Raith,6115,2,22,8,6,68,33,35,74
Arbroath,6115,3,18,8,10,75,49,26,62
Alloa,6115,4,18,8,10,57,43,14,62
Stranraer,6115,5,16,5,15,57,64,-7,53
Airdrieon,6115,6,11,11,14,49,59,-10,44
East Fife,6115,7,13,3,20,47,66,-19,42
Forfar,6115,8,10,5,21,39,68,-29,35
Albion,6115,9,8,6,22,58,82,-24,30
Queen's Park,6115,10,6,10,20,40,77,-37,28
Ayr,6116,1,24,4,8,92,42,50,76
Raith,6116,2,22,8,6,69,34,35,74
Arbroath,6116,3,18,8,10,74,50,24,62
Alloa,6116,4,18,8,10,58,44,14,62
Stranraer,6116,5,15,5,16,56,67,-11,50
East Fife,6116,6,14,3,19,50,65,-15,45
Airdrieon,6116,7,10,12,14,46,59,-13,42
Forfar,6116,8,10,6,20,39,65,-26,36
Albion,6116,9,8,6,22,57,80,-23,30
Queen's Park,6116,10,6,10,20,41,76,-35,28
Ayr,6117,1,24,4,8,93,43,50,76
Raith,6117,2,22,9,5,68,32,36,75
Alloa,6117,3,17,9,10,56,43,13,60
Arbroath,6117,4,17,8,11,70,51,19,59
Stranraer,6117,5,16,5,15,56,64,-8,53
Airdrieon,6117,6,11,11,14,48,58,-10,44
East Fife,6117,7,13,3,20,47,65,-18,42
Forfar,6117,8,10,5,21,38,67,-29,35
Queen's Park,6117,9,7,10,19,42,72,-30,31
Albion,6117,10,8,6,22,58,81,-23,30
Raith,6118,1,23,8,5,70,33,37,77
Ayr,6118,2,24,4,8,92,42,50,76
Arbroath,6118,3,17,8,11,70,50,20,59
Alloa,6118,4,17,8,11,57,45,12,59
Stranraer,6118,5,16,5,15,56,64,-8,53
East Fife,6118,6,13,3,20,47,65,-18,42
Airdrieon,6118,7,10,11,15,45,60,-15,41
Forfar,6118,8,11,5,20,40,64,-24,38
Queen's Park,6118,9,7,10,19,41,72,-31,31
Albion,6118,10,8,6,22,57,80,-23,30
Raith,6119,1,23,8,5,69,32,37,77
Ayr,6119,2,24,4,8,95,42,53,76
Arbroath,6119,3,17,9,10,71,49,22,60
Alloa,6119,4,17,8,11,56,44,12,59
Stranraer,6119,5,15,5,16,55,68,-13,50
East Fife,6119,6,14,3,19,51,64,-13,45
Airdrieon,6119,7,10,12,14,46,59,-13,42
Forfar,6119,8,10,6,20,39,65,-26,36
Albion,6119,9,8,6,22,57,83,-26,30
Queen's Park,6119,10,6,11,19,40,73,-33,29
Raith,6120,1,23,8,5,69,32,37,77
Ayr,6120,2,23,4,9,90,43,47,73
Arbroath,6120,3,17,9,10,70,48,22,60
Alloa,6120,4,17,8,11,56,44,12,59
Stranraer,6120,5,15,5,16,56,68,-12,50
East Fife,6120,6,14,3,19,51,65,-14,45
Airdrieon,6120,7,10,11,15,45,60,-15,41
Forfar,6120,8,11,5,20,40,64,-24,38
Albion,6120,9,9,6,21,58,78,-20,33
Queen's Park,6120,10,6,11,19,39,72,-33,29
Raith,6121,1,23,8,5,69,32,37,77
Ayr,6121,2,24,4,8,93,43,50,76
Arbroath,6121,3,17,9,10,72,50,22,60
Alloa,6121,4,17,8,11,56,44,12,59
Stranraer,6121,5,15,6,15,57,66,-9,51
Airdrieon,6121,6,11,11,14,49,61,-12,44
East Fife,6121,7,13,4,19,49,66,-17,43
Forfar,6121,8,10,5,21,41,68,-27,35
Albion,6121,9,8,6,22,58,81,-23,30
Queen's Park,6121,10,6,11,19,41,74,-33,29
Ayr,6122,1,24,4,8,93,42,51,76
Raith,6122,2,22,9,5,68,32,36,75
Arbroath,6122,3,18,8,10,71,48,23,62
Alloa,6122,4,17,9,10,56,43,13,60
Stranraer,6122,5,15,5,16,57,67,-10,50
East Fife,6122,6,14,3,19,50,66,-16,45
Airdrieon,6122,7,11,11,14,47,59,-12,44
Forfar,6122,8,10,5,21,39,66,-27,35
Albion,6122,9,8,6,22,57,81,-24,30
Queen's Park,6122,10,6,10,20,39,73,-34,28
Ayr,6123,1,24,4,8,94,44,50,76
Raith,6123,2,22,8,6,68,33,35,74
Arbroath,6123,3,18,8,10,74,50,24,62
Alloa,6123,4,18,8,10,57,43,14,62
Stranraer,6123,5,15,5,16,55,68,-13,50
East Fife,6123,6,14,3,19,51,64,-13,45
Airdrieon,6123,7,10,12,14,47,60,-13,42
Forfar,6123,8,10,6,20,40,66,-26,36
Albion,6123,9,8,6,22,59,82,-23,30
Queen's Park,6123,10,6,10,20,41,76,-35,28
Raith,6124,1,22,8,6,68,33,35,74
Ayr,6124,2,23,4,9,92,46,46,73
Alloa,6124,3,18,8,10,57,43,14,62
Arbroath,6124,4,17,9,10,70,48,22,60
Stranraer,6124,5,15,6,15,56,65,-9,51
Airdrieon,6124,6,11,11,14,48,59,-11,44
East Fife,6124,7,13,4,19,48,65,-17,43
Forfar,6124,8,10,5,21,39,67,-28,35
Albion,6124,9,9,6,21,61,80,-19,33
Queen's Park,6124,10,6,11,19,39,72,-33,29
Raith,6125,1,23,8,5,70,32,38,77
Ayr,6125,2,24,4,8,94,44,50,76
Arbroath,6125,3,18,8,10,75,50,25,62
Alloa,6125,4,17,8,11,56,45,11,59
Stranraer,6125,5,16,5,15,59,66,-7,53
Airdrieon,6125,6,11,11,14,47,58,-11,44
East Fife,6125,7,13,3,20,49,68,-19,42
Forfar,6125,8,10,5,21,38,66,-28,35
Albion,6125,9,8,6,22,59,82,-23,30
Queen's Park,6125,10,6,10,20,41,77,-36,28
Raith,6126,1,23,8,5,70,33,37,77
Ayr,6126,2,23,5,8,92,44,48,74
Arbroath,6126,3,17,9,10,72,50,22,60
Alloa,6126,4,17,8,11,57,45,12,59
Stranraer,6126,5,16,5,15,57,65,-8,53
East Fife,6126,6,13,3,20,48,66,-18,42
Airdrieon,6126,7,10,11,15,46,61,-15,41
Forfar,6126,8,11,5,20,41,65,-24,38
Albion,6126,9,8,7,21,59,80,-21,31
Queen's Park,6126,10,6,11,19,41,74,-33,29
Ayr,6127,1,24,4,8,95,44,51,76
Raith,6127,2,22,8,6,68,34,34,74
Alloa,6127,3,18,8,10,58,43,15,62
Arbroath,6127,4,17,8,11,71,50,21,59
Stranraer,6127,5,15,6,15,56,65,-9,51
East Fife,6127,6,13,4,19,48,65,-17,43
Airdrieon,6127,7,10,12,14,46,59,-13,42
Forfar,6127,8,10,6,20,39,65,-26,36
Queen's Park,6127,9,7,10,19,41,73,-32,31
Albion,6127,10,8,6,22,59,83,-24,30
Ayr,6128,1,24,4,8,96,43,53,76
Raith,6128,2,22,8,6,69,34,35,74
Alloa,6128,3,18,8,10,58,44,14,62
Arbroath,6128,4,17,8,11,71,50,21,59
Stranraer,6128,5,16,5,15,58,65,-7,53
Airdrieon,6128,6,11,11,14,47,58,-11,44
East Fife,6128,7,13,3,20,48,67,-19,42
Forfar,6128,8,10,5,21,38,66,-28,35
Queen's Park,6128,9,7,10,19,41,73,-32,31
Albion,6128,10,8,6,22,58,84,-26,30
Raith,6129,1,23,8,5,71,32,39,77
Ayr,6129,2,24,4,8,92,43,49,76
Arbroath,6129,3,18,8,10,71,48,23,62
Alloa,6129,4,17,8,11,56,46,10,59
Stranraer,6129,5,15,5,16,57,69,-12,50
East Fife,6129,6,14,3,19,52,66,-14,45
Airdrieon,6129,7,11,11,14,48,59,-11,44
Forfar,6129,8,10,5,21,39,67,-28,35
Albion,6129,9,8,6,22,58,80,-22,30
Queen's Park,6129,10,6,10,20,39,73,-34,28
Raith,6130,1,23,8,5,71,32,39,77
Ayr,6130,2,24,4,8,94,42,52,76
Arbroath,6130,3,18,8,10,73,48,25,62
Alloa,6130,4,17,8,11,56,46,10,59
Stranraer,6130,5,16,5,15,57,65,-8,53
Airdrieon,6130,6,10,12,14,45,58,-13,42
East Fife,6130,7,13,3,20,48,66,-18,42
Forfar,6130,8,10,6,20,38,64,-26,36
Albion,6130,9,8,6,22,57,82,-25,30
Queen's Park,6130,10,6,10,20,39,75,-36,28
Ayr,6131,1,24,4,8,97,45,52,76
Raith,6131,2,22,9,5,68,32,36,75
Arbroath,6131,3,18,8,10,72,48,24,62
Alloa,6131,4,17,9,10,56,43,13,60
Stranraer,6131,5,16,5,15,56,64,-8,53
Airdrieon,6131,6,11,11,14,47,59,-12,44
East Fife,6131,7,13,3,20,47,65,-18,42
Forfar,6131,8,10,5,21,39,66,-27,35
Albion,6131,9,8,6,22,60,85,-25,30
Queen's Park,6131,10,6,10,20,39,74,-35,28
Raith,6132,1,23,8,5,73,33,40,77
Ayr,6132,2,24,4,8,91,42,49,76
Arbroath,6132,3,17,8,11,70,49,21,59
Alloa,6132,4,17,8,11,57,48,9,59
Stranraer,6132,5,15,6,15,57,66,-9,51
Airdrieon,6132,6,11,11,14,46,58,-12,44
East Fife,6132,7,13,4,19,49,66,-17,43
Forfar,6132,8,10,5,21,38,65,-27,35
Queen's Park,6132,9,7,10,19,40,72,-32,31
Albion,6132,10,8,6,22,57,79,-22,30
Ayr,6133,1,24,4,8,92,43,49,76
Raith,6133,2,22,8,6,69,34,35,74
Alloa,6133,3,18,8,10,58,44,14,62
Arbroath,6133,4,17,9,10,71,49,22,60
Stranraer,6133,5,15,5,16,55,67,-12,50
East Fife,6133,6,14,3,19,50,64,-14,45
Airdrieon,6133,7,11,11,14,50,59,-9,44
Forfar,6133,8,10,5,21,39,69,-30,35
Albion,6133,9,8,6,22,58,80,-22,30
Queen's Park,6133,10,6,11,19,40,73,-33,29
Raith,6134,1,23,8,5,71,34,37,77
Ayr,6134,2,23,5,8,91,43,48,74
Arbroath,6134,3,17,9,10,71,49,22,60
Alloa,6134,4,17,8,11,58,46,12,59
Stranraer,6134,5,16,5,15,57,64,-7,53
Airdrieon,6134,6,11,11,14,47,58,-11,44
East Fife,6134,7,13,3,20,47,66,-19,42
Forfar,6134,8,10,5,21,38,66,-28,35
Albion,6134,9,8,7,21,58,79,-21,31
Queen's Park,6134,10,6,11,19,40,73,-33,29
Raith,6135,1,23,8,5,70,32,38,77
Ayr,6135,2,23,4,9,91,44,47,73
Arbroath,6135,3,17,8,11,72,51,21,59
Alloa,6135,4,17,8,11,56,45,11,59
Stranraer,6135,5,16,5,15,57,65,-8,53
Airdrieon,6135,6,11,11,14,49,59,-10,44
East Fife,6135,7,13,3,20,48,66,-18,42
Forfar,6135,8,10,5,21,39,68,-29,35
Albion,6135,9,9,6,21,59,79,-20,33
Queen's Park,6135,10,7,10,19,42,74,-32,31
Ayr,6136,1,24,4,8,94,42,52,76
Raith,6136,2,22,8,6,69,34,35,74
Arbroath,6136,3,18,8,10,73,50,23,62
Alloa,6136,4,18,8,10,58,44,14,62
Stranraer,6136,5,16,5,15,57,65,-8,53
Airdrieon,6136,6,11,11,14,49,59,-10,44
East Fife,6136,7,13,3,20,48,66,-18,42
Forfar,6136,8,10,5,21,39,68,-29,35
Albion,6136,9,8,6,22,57,82,-25,30
Queen's Park,6136,10,6,10,20,41,75,-34,28
Raith,6137,1,23,8,5,72,34,38,77
Ayr,6137,2,24,4,8,96,44,52,76
Arbroath,6137,3,17,9,10,73,51,22,60
Alloa,6137,4,17,8,11,58,47,11,59
Stranraer,6137,5,15,5,16,55,65,-10,50
East Fife,6137,6,14,3,19,48,64,-16,45
Airdrieon,6137,7,11,11,14,49,58,-9,44
Forfar,6137,8,10,5,21,38,68,-30,35
Albion,6137,9,8,6,22,59,84,-25,30
Queen's Park,6137,10,6,11,19,42,75,-33,29
Raith,6138,1,23,8,5,72,33,39,77
Ayr,6138,2,24,4,8,94,44,50,76
Arbroath,6138,3,17,9,10,72,50,22,60
Alloa,6138,4,17,8,11,57,47,10,59
Stranraer,6138,5,16,5,15,58,66,-8,53
Airdrieon,6138,6,11,11,14,47,59,-12,44
East Fife,6138,7,13,3,20,49,67,-18,42
Forfar,6138,8,10,5,21,39,66,-27,35
Albion,6138,9,8,6,22,59,82,-23,30
Queen's Park,6138,10,6,11,19,41,74,-33,29
Raith,6139,1,23,8,5,69,32,37,77
Ayr,6139,2,23,4,9,92,46,46,73
Arbroath,6139,3,17,9,10,72,50,22,60
Alloa,6139,4,17,8,11,56,44,12,59
Stranraer,6139,5,15,5,16,56,66,-10,50
East Fife,6139,6,14,3,19,49,65,-16,45
Airdrieon,6139,7,10,11,15,46,61,-15,41
Forfar,6139,8,11,5,20,41,65,-24,38
Albion,6139,9,9,6,21,61,80,-19,33
Queen's Park,6139,10,6,11,19,41,74,-33,29
Ayr,6140,1,24,4,8,94,43,51,76
Raith,6140,2,22,8,6,70,36,34,74
Alloa,6140,3,18,8,10,60,45,15,62
Arbroath,6140,4,17,8,11,70,49,21,59
Stranraer,6140,5,15,5,16,56,67,-11,50
East Fife,6140,6,14,3,19,50,65,-15,45
Airdrieon,6140,7,11,11,14,51,59,-8,44
Forfar,6140,8,10,5,21,39,70,-31,35
Queen's Park,6140,9,7,10,19,40,72,-32,31
Albion,6140,10,8,6,22,58,82,-24,30
Ayr,6141,1,24,4,8,94,44,50,76
Raith,6141,2,22,9,5,70,34,36,75
Alloa,6141,3,17,9,10,58,45,13,60
Arbroath,6141,4,17,8,11,71,50,21,59
Stranraer,6141,5,16,5,15,58,66,-8,53
Airdrieon,6141,6,10,12,14,46,59,-13,42
East Fife,6141,7,13,3,20,49,67,-18,42
Forfar,6141,8,10,6,20,39,65,-26,36
Queen's Park,6141,9,7,10,19,41,73,-32,31
Albion,6141,10,8,6,22,59,82,-23,30
Ayr,6142,1,24,4,8,93,42,51,76
Raith,6142,2,22,9,5,69,33,36,75
Arbroath,6142,3,18,8,10,75,50,25,62
Alloa,6142,4,17,9,10,57,44,13,60
Stranraer,6142,5,15,6,15,55,64,-9,51
East Fife,6142,6,13,4,19,47,64,-17,43
Airdrieon,6142,7,10,12,14,46,59,-13,42
Forfar,6142,8,10,6,20,39,65,-26,36
Albion,6142,9,8,6,22,57,81,-24,30
Queen's Park,6142,10,6,10,20,41,77,-36,28
Ayr,6143,1,24,4,8,93,42,51,76
Raith,6143,2,22,9,5,69,33,36,75
Arbroath,6143,3,17,9,10,71,49,22,60
Alloa,6143,4,17,9,10,57,44,13,60
Stranraer,6143,5,15,5,16,56,66,-10,50
East Fife,6143,6,14,3,19,49,65,-16,45
Airdrieon,6143,7,10,12,14,46,59,-13,42
Forfar,6143,8,10,6,20,39,65,-26,36
Albion,6143,9,8,6,22,57,81,-24,30
Queen's Park,6143,10,6,11,19,40,73,-33,29
Raith,6144,1,23,8,5,69,32,37,77
Ayr,6144,2,24,4,8,92,42,50,76
Arbroath,6144,3,18,8,10,73,49,24,62
Alloa,6144,4,17,8,11,56,44,12,59
Stranraer,6144,5,15,5,16,55,67,-12,50
East Fife,6144,6,14,3,19,50,64,-14,45
Airdrieon,6144,7,10,12,14,45,58,-13,42
Forfar,6144,8,10,6,20,38,64,-26,36
Albion,6144,9,8,6,22,57,80,-23,30
Queen's Park,6144,10,6,10,20,40,75,-35,28
Raith,6145,1,23,8,5,70,33,37,77
Ayr,6145,2,23,5,8,93,45,48,74
Arbroath,6145,3,18,8,10,72,49,23,62
Alloa,6145,4,17,8,11,57,45,12,59
Stranraer,6145,5,15,5,16,55,65,-10,50
East Fife,6145,6,14,3,19,48,64,-16,45
Airdrieon,6145,7,10,12,14,47,60,-13,42
Forfar,6145,8,10,6,20,40,66,-26,36
Albion,6145,9,8,7,21,60,81,-21,31
Queen's Park,6145,10,6,10,20,40,74,-34,28
Raith,6146,1,23,8,5,71,32,39,77
Ayr,6146,2,24,4,8,94,43,51,76
Arbroath,6146,3,18,8,10,72,48,24,62
Alloa,6146,4,17,8,11,56,46,10,59
Stranraer,6146,5,15,5,16,56,67,-11,50
East Fife,6146,6,14,3,19,50,65,-15,45
Airdrieon,6146,7,10,12,14,46,59,-13,42
Forfar,6146,8,10,6,20,39,65,-26,36
Albion,6146,9,8,6,22,58,82,-24,30
Queen's Park,6146,10,6,10,20,39,74,-35,28
Ayr,6147,1,24,4,8,92,42,50,76
Raith,6147,2,22,9,5,71,35,36,75
Arbroath,6147,3,17,9,10,72,50,22,60
Alloa,6147,4,17,9,10,59,46,13,60
Stranraer,6147,5,15,6,15,58,67,-9,51
East Fife,6147,6,13,4,19,50,67,-17,43
Airdrieon,6147,7,10,11,15,46,60,-14,41
Forfar,6147,8,11,5,20,40,65,-25,38
Albion,6147,9,8,6,22,57,80,-23,30
Queen's Park,6147,10,6,11,19,41,74,-33,29
Raith,6148,1,23,8,5,70,33,37,77
Ayr,6148,2,24,4,8,99,44,55,76
Arbroath,6148,3,17,9,10,72,50,22,60
Alloa,6148,4,17,8,11,57,45,12,59
Stranraer,6148,5,15,6,15,57,66,-9,51
Airdrieon,6148,6,11,11,14,47,59,-12,44
East Fife,6148,7,13,4,19,49,66,-17,43
Forfar,6148,8,10,5,21,39,66,-27,35
Albion,6148,9,8,6,22,59,87,-28,30
Queen's Park,6148,10,6,11,19,41,74,-33,29
Ayr,6149,1,24,4,8,95,42,53,76
Raith,6149,2,22,8,6,68,34,34,74
Arbroath,6149,3,18,8,10,75,48,27,62
Alloa,6149,4,18,8,10,58,43,15,62
Stranraer,6149,5,15,5,16,55,66,-11,50
East Fife,6149,6,14,3,19,49,64,-15,45
Airdrieon,6149,7,11,11,14,46,58,-12,44
Forfar,6149,8,10,5,21,38,65,-27,35
Albion,6149,9,8,6,22,57,83,-26,30
Queen's Park,6149,10,6,10,20,39,77,-38,28
Raith,6150,1,23,8,5,70,32,38,77
Ayr,6150,2,23,5,8,91,43,48,74
Arbroath,6150,3,18,8,10,72,48,24,62
Alloa,6150,4,17,8,11,56,45,11,59
Stranraer,6150,5,15,5,16,55,67,-12,50
East Fife,6150,6,14,3,19,50,64,-14,45
Airdrieon,6150,7,10,12,14,45,58,-13,42
Forfar,6150,8,10,6,20,38,64,-26,36
Albion,6150,9,8,7,21,58,79,-21,31
Queen's Park,6150,10,6,10,20,39,74,-35,28
Ayr,6151,1,24,4,8,93,44,49,76
Raith,6151,2,22,9,5,68,32,36,75
Arbroath,6151,3,18,8,10,72,48,24,62
Alloa,6151,4,17,9,10,56,43,13,60
Stranraer,6151,5,15,6,15,58,67,-9,51
Airdrieon,6151,6,11,11,14,48,60,-12,44
East Fife,6151,7,13,4,19,50,67,-17,43
Forfar,6151,8,10,5,21,40,67,-27,35
Albion,6151,9,8,6,22,59,81,-22,30
Queen's Park,6151,10,6,10,20,39,74,-35,28
Raith,6152,1,23,8,5,70,33,37,77
Ayr,6152,2,24,4,8,93,43,50,76
Arbroath,6152,3,17,8,11,72,51,21,59
Alloa,6152,4,17,8,11,57,45,12,59
Stranraer,6152,5,15,5,16,55,66,-11,50
East Fife,6152,6,14,3,19,49,64,-15,45
Airdrieon,6152,7,10,11,15,45,59,-14,41
Forfar,6152,8,11,5,20,39,64,-25,38
Queen's Park,6152,9,7,10,19,42,74,-32,31
Albion,6152,10,8,6,22,58,81,-23,30
Ayr,6153,1,24,4,8,92,43,49,76
Raith,6153,2,22,8,6,69,38,31,74
Arbroath,6153,3,18,8,10,74,49,25,62
Alloa,6153,4,18,8,10,62,44,18,62
Stranraer,6153,5,15,5,16,57,67,-10,50
East Fife,6153,6,14,3,19,50,66,-16,45
Airdrieon,6153,7,11,11,14,47,59,-12,44
Forfar,6153,8,10,5,21,39,66,-27,35
Albion,6153,9,8,6,22,58,80,-22,30
Queen's Park,6153,10,6,10,20,40,76,-36,28
Raith,6154,1,23,8,5,70,32,38,77
Ayr,6154,2,24,4,8,94,44,50,76
Arbroath,6154,3,17,8,11,71,50,21,59
Alloa,6154,4,17,8,11,56,45,11,59
Stranraer,6154,5,15,6,15,57,66,-9,51
East Fife,6154,6,13,4,19,49,66,-17,43
Airdrieon,6154,7,10,11,15,46,60,-14,41
Forfar,6154,8,11,5,20,40,65,-25,38
Queen's Park,6154,9,7,10,19,41,73,-32,31
Albion,6154,10,8,6,22,59,82,-23,30
Raith,6155,1,23,8,5,71,33,38,77
Ayr,6155,2,24,4,8,92,43,49,76
Arbroath,6155,3,18,8,10,72,49,23,62
Alloa,6155,4,17,8,11,57,46,11,59
Stranraer,6155,5,15,5,16,56,66,-10,50
East Fife,6155,6,14,3,19,49,65,-16,45
Airdrieon,6155,7,10,11,15,46,60,-14,41
Forfar,6155,8,11,5,20,40,65,-25,38
Albion,6155,9,8,6,22,58,80,-22,30
Queen's Park,6155,10,6,10,20,40,74,-34,28
Raith,6156,1,23,8,5,71,32,39,77
Ayr,6156,2,24,4,8,91,42,49,76
Arbroath,6156,3,18,8,10,75,49,26,62
Alloa,6156,4,17,8,11,56,46,10,59
Stranraer,6156,5,16,5,15,57,65,-8,53
Airdrieon,6156,6,10,12,14,45,58,-13,42
East Fife,6156,7,13,3,20,48,66,-18,42
Forfar,6156,8,10,6,20,38,64,-26,36
Albion,6156,9,8,6,22,57,79,-22,30
Queen's Park,6156,10,6,10,20,40,77,-37,28
Raith,6157,1,23,8,5,71,33,38,77
Ayr,6157,2,23,4,9,90,43,47,73
Arbroath,6157,3,18,8,10,74,50,24,62
Alloa,6157,4,17,8,11,57,46,11,59
Stranraer,6157,5,15,5,16,55,67,-12,50
East Fife,6157,6,14,3,19,50,64,-14,45
Airdrieon,6157,7,11,11,14,47,59,-12,44
Forfar,6157,8,10,5,21,39,66,-27,35
Albion,6157,9,9,6,21,58,78,-20,33
Queen's Park,6157,10,6,10,20,41,76,-35,28
Raith,6158,1,23,8,5,71,32,39,77
Ayr,6158,2,24,4,8,94,43,51,76
Arbroath,6158,3,17,9,10,72,50,22,60
Alloa,6158,4,17,8,11,56,46,10,59
Stranraer,6158,5,16,5,15,57,65,-8,53
East Fife,6158,6,13,3,20,48,66,-18,42
Airdrieon,6158,7,10,11,15,45,59,-14,41
Forfar,6158,8,11,5,20,39,64,-25,38
Albion,6158,9,8,6,22,58,82,-24,30
Queen's Park,6158,10,6,11,19,41,74,-33,29
Raith,6159,1,23,8,5,70,33,37,77
Ayr,6159,2,24,4,8,96,42,54,76
Arbroath,6159,3,18,8,10,71,48,23,62
Alloa,6159,4,17,8,11,57,45,12,59
Stranraer,6159,5,15,5,16,56,66,-10,50
East Fife,6159,6,14,3,19,49,65,-16,45
Airdrieon,6159,7,11,11,14,46,58,-12,44
Forfar,6159,8,10,5,21,38,65,-27,35
Albion,6159,9,8,6,22,57,84,-27,30
Queen's Park,6159,10,6,10,20,39,73,-34,28
Raith,6160,1,23,8,5,71,33,38,77
Ayr,6160,2,24,4,8,94,42,52,76
Arbroath,6160,3,17,9,10,73,51,22,60
Alloa,6160,4,17,8,11,57,46,11,59
Stranraer,6160,5,16,5,15,60,64,-4,53
East Fife,6160,6,13,3,20,47,69,-22,42
Airdrieon,6160,7,10,11,15,46,60,-14,41
Forfar,6160,8,11,5,20,40,65,-25,38
Albion,6160,9,8,6,22,57,82,-25,30
Queen's Park,6160,10,6,11,19,42,75,-33,29
Raith,6161,1,23,8,5,70,33,37,77
Ayr,6161,2,24,4,8,94,44,50,76
Arbroath,6161,3,18,8,10,73,50,23,62
Alloa,6161,4,17,8,11,57,45,12,59
Stranraer,6161,5,16,5,15,56,64,-8,53
Airdrieon,6161,6,11,11,14,48,58,-10,44
East Fife,6161,7,13,3,20,47,65,-18,42
Forfar,6161,8,10,5,21,38,67,-29,35
Albion,6161,9,8,6,22,59,82,-23,30
Queen's Park,6161,10,6,10,20,41,75,-34,28
Raith,6162,1,23,8,5,70,32,38,77
Ayr,6162,2,24,4,8,97,42,55,76
Arbroath,6162,3,18,8,10,74,49,25,62
Alloa,6162,4,17,8,11,56,45,11,59
Stranraer,6162,5,16,5,15,56,64,-8,53
East Fife,6162,6,13,3,20,47,65,-18,42
Airdrieon,6162,7,10,11,15,46,60,-14,41
Forfar,6162,8,11,5,20,40,65,-25,38
Albion,6162,9,8,6,22,57,85,-28,30
Queen's Park,6162,10,6,10,20,40,76,-36,28
Raith,6163,1,23,8,5,74,33,41,77
Ayr,6163,2,24,4,8,92,43,49,76
Arbroath,6163,3,17,9,10,72,50,22,60
Alloa,6163,4,17,8,11,57,49,8,59
Stranraer,6163,5,16,5,15,58,64,-6,53
Airdrieon,6163,6,10,12,14,46,59,-13,42
East Fife,6163,7,13,3,20,47,67,-20,42
Forfar,6163,8,10,6,20,39,65,-26,36
Albion,6163,9,8,6,22,58,80,-22,30
Queen's Park,6163,10,6,11,19,41,74,-33,29
Raith,6164,1,23,8,5,70,33,37,77
Ayr,6164,2,23,4,9,91,44,47,73
Arbroath,6164,3,17,9,10,70,48,22,60
Alloa,6164,4,17,8,11,57,45,12,59
Stranraer,6164,5,16,5,15,57,65,-8,53
East Fife,6164,6,13,3,20,48,66,-18,42
Airdrieon,6164,7,10,11,15,45,59,-14,41
Forfar,6164,8,11,5,20,39,64,-25,38
Albion,6164,9,9,6,21,59,79,-20,33
Queen's Park,6164,10,6,11,19,39,72,-33,29
Raith,6165,1,23,8,5,73,32,41,77
Ayr,6165,2,24,4,8,93,42,51,76
Arbroath,6165,3,17,9,10,71,49,22,60
Alloa,6165,4,17,8,11,56,48,8,59
Stranraer,6165,5,16,5,15,56,64,-8,53
Airdrieon,6165,6,10,12,14,46,59,-13,42
East Fife,6165,7,13,3,20,47,65,-18,42
Forfar,6165,8,10,6,20,39,65,-26,36
Albion,6165,9,8,6,22,57,81,-24,30
Queen's Park,6165,10,6,11,19,40,73,-33,29
Ayr,6166,1,24,4,8,95,43,52,76
Raith,6166,2,22,8,6,69,36,33,74
Alloa,6166,3,18,8,10,60,44,16,62
Arbroath,6166,4,17,8,11,71,52,19,59
Stranraer,6166,5,15,6,15,59,68,-9,51
East Fife,6166,6,13,4,19,51,68,-17,43
Airdrieon,6166,7,10,11,15,46,60,-14,41
Forfar,6166,8,11,5,20,40,65,-25,38
Queen's Park,6166,9,7,10,19,43,73,-30,31
Albion,6166,10,8,6,22,58,83,-25,30
Raith,6167,1,23,8,5,70,32,38,77
Ayr,6167,2,23,5,8,91,43,48,74
Arbroath,6167,3,18,8,10,72,49,23,62
Alloa,6167,4,17,8,11,56,45,11,59
Stranraer,6167,5,15,5,16,57,67,-10,50
East Fife,6167,6,14,3,19,50,66,-16,45
Airdrieon,6167,7,10,11,15,47,61,-14,41
Forfar,6167,8,11,5,20,41,66,-25,38
Albion,6167,9,8,7,21,58,79,-21,31
Queen's Park,6167,10,6,10,20,40,74,-34,28
Ayr,6168,1,24,4,8,94,44,50,76
Raith,6168,2,22,8,6,68,34,34,74
Arbroath,6168,3,18,8,10,72,49,23,62
Alloa,6168,4,18,8,10,58,43,15,62
Stranraer,6168,5,16,5,15,56,64,-8,53
Airdrieon,6168,6,11,11,14,48,58,-10,44
East Fife,6168,7,13,3,20,47,65,-18,42
Forfar,6168,8,10,5,21,38,67,-29,35
Albion,6168,9,8,6,22,59,82,-23,30
Queen's Park,6168,10,6,10,20,40,74,-34,28
Raith,6169,1,23,8,5,70,32,38,77
Ayr,6169,2,24,4,8,93,43,50,76
Arbroath,6169,3,17,8,11,70,49,21,59
Alloa,6169,4,17,8,11,56,45,11,59
Stranraer,6169,5,15,6,15,57,66,-9,51
East Fife,6169,6,13,4,19,49,66,-17,43
Airdrieon,6169,7,10,11,15,46,60,-14,41
Forfar,6169,8,11,5,20,40,65,-25,38
Queen's Park,6169,9,7,10,19,40,72,-32,31
Albion,6169,10,8,6,22,58,81,-23,30
Ayr,6170,1,24,4,8,94,45,49,76
Raith,6170,2,22,8,6,69,36,33,74
Alloa,6170,3,18,8,10,60,44,16,62
Arbroath,6170,4,17,8,11,71,54,17,59
Stranraer,6170,5,16,5,15,56,64,-8,53
Airdrieon,6170,6,11,11,14,47,59,-12,44
East Fife,6170,7,13,3,20,47,65,-18,42
Forfar,6170,8,10,5,21,39,66,-27,35
Queen's Park,6170,9,7,10,19,45,73,-28,31
Albion,6170,10,8,6,22,60,82,-22,30
Ayr,6171,1,24,4,8,93,44,49,76
Raith,6171,2,22,9,5,69,33,36,75
Alloa,6171,3,17,9,10,57,44,13,60
Arbroath,6171,4,17,8,11,71,52,19,59
Stranraer,6171,5,16,5,15,56,64,-8,53
Airdrieon,6171,6,10,12,14,46,59,-13,42
East Fife,6171,7,13,3,20,47,65,-18,42
Forfar,6171,8,10,6,20,39,65,-26,36
Queen's Park,6171,9,7,10,19,43,73,-30,31
Albion,6171,10,8,6,22,59,81,-22,30
Raith,6172,1,23,8,5,72,34,38,77
Ayr,6172,2,23,4,9,91,44,47,73
Arbroath,6172,3,17,9,10,71,49,22,60
Alloa,6172,4,17,8,11,58,47,11,59
Stranraer,6172,5,15,5,16,56,66,-10,50
East Fife,6172,6,14,3,19,49,65,-16,45
Airdrieon,6172,7,10,12,14,46,59,-13,42
Forfar,6172,8,10,6,20,39,65,-26,36
Albion,6172,9,9,6,21,59,79,-20,33
Queen's Park,6172,10,6,11,19,40,73,-33,29
Ayr,6173,1,24,4,8,94,44,50,76
Raith,6173,2,22,8,6,69,34,35,74
Alloa,6173,3,18,8,10,58,44,14,62
Arbroath,6173,4,17,8,11,70,49,21,59
Stranraer,6173,5,15,5,16,56,67,-11,50
East Fife,6173,6,14,3,19,50,65,-15,45
Airdrieon,6173,7,11,11,14,47,59,-12,44
Forfar,6173,8,10,5,21,39,66,-27,35
Queen's Park,6173,9,7,10,19,40,72,-32,31
Albion,6173,10,8,6,22,59,82,-23,30
Raith,6174,1,23,8,5,69,32,37,77
Ayr,6174,2,24,4,8,93,43,50,76
Arbroath,6174,3,18,8,10,73,49,24,62
Alloa,6174,4,17,8,11,56,44,12,59
Stranraer,6174,5,16,5,15,57,65,-8,53
Airdrieon,6174,6,11,11,14,47,59,-12,44
East Fife,6174,7,13,3,20,48,66,-18,42
Forfar,6174,8,10,5,21,39,66,-27,35
Albion,6174,9,8,6,22,58,81,-23,30
Queen's Park,6174,10,6,10,20,40,75,-35,28
Raith,6175,1,23,8,5,70,32,38,77
Ayr,6175,2,24,4,8,92,43,49,76
Arbroath,6175,3,18,8,10,72,49,23,62
Alloa,6175,4,17,8,11,56,45,11,59
Stranraer,6175,5,15,5,16,57,67,-10,50
East Fife,6175,6,14,3,19,50,66,-16,45
Airdrieon,6175,7,10,11,15,46,60,-14,41
Forfar,6175,8,11,5,20,40,65,-25,38
Albion,6175,9,8,6,22,58,80,-22,30
Queen's Park,6175,10,6,10,20,40,74,-34,28
Ayr,6176,1,24,4,8,95,44,51,76
Raith,6176,2,22,9,5,69,33,36,75
Alloa,6176,3,17,9,10,57,44,13,60
Arbroath,6176,4,17,8,11,71,50,21,59
Stranraer,6176,5,15,5,16,55,66,-11,50
East Fife,6176,6,14,3,19,49,64,-15,45
Airdrieon,6176,7,10,11,15,47,62,-15,41
Forfar,6176,8,11,5,20,42,66,-24,38
Queen's Park,6176,9,7,10,19,41,73,-32,31
Albion,6176,10,8,6,22,59,83,-24,30
Raith,6177,1,23,8,5,71,32,39,77
Ayr,6177,2,23,5,8,93,45,48,74
Arbroath,6177,3,17,8,11,71,50,21,59
Alloa,6177,4,17,8,11,56,46,10,59
Stranraer,6177,5,15,5,16,55,70,-15,50
East Fife,6177,6,14,3,19,53,64,-11,45
Airdrieon,6177,7,10,11,15,46,62,-16,41
Forfar,6177,8,11,5,20,42,65,-23,38
Albion,6177,9,8,7,21,60,81,-21,31
Queen's Park,6177,10,7,10,19,41,73,-32,31
Raith,6178,1,23,8,5,71,32,39,77
Ayr,6178,2,24,4,8,96,43,53,76
Arbroath,6178,3,17,9,10,71,49,22,60
Alloa,6178,4,17,8,11,56,46,10,59
Stranraer,6178,5,16,5,15,57,65,-8,53
Airdrieon,6178,6,11,11,14,50,59,-9,44
East Fife,6178,7,13,3,20,48,66,-18,42
Forfar,6178,8,10,5,21,39,69,-30,35
Albion,6178,9,8,6,22,58,84,-26,30
Queen's Park,6178,10,6,11,19,40,73,-33,29
Raith,6179,1,23,8,5,70,32,38,77
Ayr,6179,2,24,4,8,92,43,49,76
Arbroath,6179,3,18,8,10,71,48,23,62
Alloa,6179,4,17,8,11,56,45,11,59
Stranraer,6179,5,16,5,15,58,65,-7,53
Airdrieon,6179,6,11,11,14,46,58,-12,44
East Fife,6179,7,13,3,20,48,67,-19,42
Forfar,6179,8,10,5,21,38,65,-27,35
Albion,6179,9,8,6,22,58,80,-22,30
Queen's Park,6179,10,6,10,20,39,73,-34,28
Raith,6180,1,23,8,5,70,32,38,77
Ayr,6180,2,24,4,8,94,42,52,76
Arbroath,6180,3,17,9,10,71,49,22,60
Alloa,6180,4,17,8,11,56,45,11,59
Stranraer,6180,5,15,6,15,56,65,-9,51
East Fife,6180,6,13,4,19,48,65,-17,43
Airdrieon,6180,7,10,12,14,46,59,-13,42
Forfar,6180,8,10,6,20,39,65,-26,36
Albion,6180,9,8,6,22,57,82,-25,30
Queen's Park,6180,10,6,11,19,40,73,-33,29
Ayr,6181,1,24,4,8,95,43,52,76
Raith,6181,2,22,9,5,68,32,36,75
Arbroath,6181,3,18,8,10,75,50,25,62
Alloa,6181,4,17,9,10,56,43,13,60
Stranraer,6181,5,15,6,15,55,64,-9,51
East Fife,6181,6,13,4,19,47,64,-17,43
Airdrieon,6181,7,10,11,15,47,61,-14,41
Forfar,6181,8,11,5,20,41,66,-25,38
Albion,6181,9,8,6,22,58,83,-25,30
Queen's Park,6181,10,6,10,20,41,77,-36,28
Ayr,6182,1,24,4,8,97,43,54,76
Raith,6182,2,22,8,6,68,33,35,74
Alloa,6182,3,18,8,10,57,43,14,62
Arbroath,6182,4,17,9,10,70,48,22,60
Stranraer,6182,5,15,5,16,56,67,-11,50
East Fife,6182,6,14,3,19,50,65,-15,45
Airdrieon,6182,7,11,11,14,48,59,-11,44
Forfar,6182,8,10,5,21,39,67,-28,35
Albion,6182,9,8,6,22,58,85,-27,30
Queen's Park,6182,10,6,11,19,39,72,-33,29
Raith,6183,1,23,8,5,72,34,38,77
Ayr,6183,2,24,4,8,94,42,52,76
Arbroath,6183,3,18,8,10,71,48,23,62
Alloa,6183,4,17,8,11,58,47,11,59
Stranraer,6183,5,15,5,16,57,67,-10,50
East Fife,6183,6,14,3,19,50,66,-16,45
Airdrieon,6183,7,11,11,14,47,58,-11,44
Forfar,6183,8,10,5,21,38,66,-28,35
Albion,6183,9,8,6,22,57,82,-25,30
Queen's Park,6183,10,6,10,20,39,73,-34,28
Raith,6184,1,23,8,5,69,32,37,77
Ayr,6184,2,24,4,8,93,43,50,76
Arbroath,6184,3,18,8,10,74,50,24,62
Alloa,6184,4,17,8,11,56,44,12,59
Stranraer,6184,5,16,5,15,59,64,-5,53
Airdrieon,6184,6,11,11,14,46,58,-12,44
East Fife,6184,7,13,3,20,47,68,-21,42
Forfar,6184,8,10,5,21,38,65,-27,35
Albion,6184,9,8,6,22,58,81,-23,30
Queen's Park,6184,10,6,10,20,41,76,-35,28
Raith,6185,1,23,8,5,69,32,37,77
Ayr,6185,2,24,4,8,92,42,50,76
Arbroath,6185,3,17,8,11,70,54,16,59
Alloa,6185,4,17,8,11,56,44,12,59
Stranraer,6185,5,15,6,15,55,64,-9,51
East Fife,6185,6,13,4,19,47,64,-17,43
Airdrieon,6185,7,10,12,14,45,58,-13,42
Forfar,6185,8,10,6,20,38,64,-26,36
Queen's Park,6185,9,7,10,19,45,72,-27,31
Albion,6185,10,8,6,22,57,80,-23,30
Raith,6186,1,23,8,5,69,32,37,77
Ayr,6186,2,24,4,8,94,44,50,76
Arbroath,6186,3,18,8,10,72,48,24,62
Alloa,6186,4,17,8,11,56,44,12,59
Stranraer,6186,5,15,5,16,55,65,-10,50
East Fife,6186,6,14,3,19,48,64,-16,45
Airdrieon,6186,7,10,11,15,46,60,-14,41
Forfar,6186,8,11,5,20,40,65,-25,38
Albion,6186,9,8,6,22,59,82,-23,30
Queen's Park,6186,10,6,10,20,39,74,-35,28
Ayr,6187,1,24,4,8,96,42,54,76
Raith,6187,2,22,9,5,70,34,36,75
Arbroath,6187,3,18,8,10,73,50,23,62
Alloa,6187,4,17,9,10,58,45,13,60
Stranraer,6187,5,15,5,16,55,65,-10,50
East Fife,6187,6,14,3,19,48,64,-16,45
Airdrieon,6187,7,10,11,15,45,60,-15,41
Forfar,6187,8,11,5,20,40,64,-24,38
Albion,6187,9,8,6,22,57,84,-27,30
Queen's Park,6187,10,6,10,20,41,75,-34,28
Raith,6188,1,23,8,5,71,33,38,77
Ayr,6188,2,24,4,8,97,42,55,76
Arbroath,6188,3,17,8,11,71,50,21,59
Alloa,6188,4,17,8,11,57,46,11,59
Stranraer,6188,5,16,5,15,59,65,-6,53
East Fife,6188,6,13,3,20,48,68,-20,42
Airdrieon,6188,7,10,11,15,46,60,-14,41
Forfar,6188,8,11,5,20,40,65,-25,38
Queen's Park,6188,9,7,10,19,41,73,-32,31
Albion,6188,10,8,6,22,57,85,-28,30
Raith,6189,1,23,8,5,70,32,38,77
Ayr,6189,2,24,4,8,93,43,50,76
Arbroath,6189,3,17,8,11,71,50,21,59
Alloa,6189,4,17,8,11,56,45,11,59
Stranraer,6189,5,15,5,16,56,67,-11,50
East Fife,6189,6,14,3,19,50,65,-15,45
Airdrieon,6189,7,10,12,14,45,58,-13,42
Forfar,6189,8,10,6,20,38,64,-26,36
Queen's Park,6189,9,7,10,19,41,73,-32,31
Albion,6189,10,8,6,22,58,81,-23,30
Ayr,6190,1,24,4,8,94,42,52,76
Raith,6190,2,22,9,5,69,33,36,75
Arbroath,6190,3,18,8,10,73,49,24,62
Alloa,6190,4,17,9,10,57,44,13,60
Stranraer,6190,5,16,5,15,58,64,-6,53
Airdrieon,6190,6,11,11,14,46,58,-12,44
East Fife,6190,7,13,3,20,47,67,-20,42
Forfar,6190,8,10,5,21,38,65,-27,35
Albion,6190,9,8,6,22,57,82,-25,30
Queen's Park,6190,10,6,10,20,40,75,-35,28
Ayr,6191,1,24,4,8,96,42,54,76
Raith,6191,2,22,8,6,69,34,35,74
Alloa,6191,3,18,8,10,58,44,14,62
Arbroath,6191,4,17,9,10,71,49,22,60
Stranraer,6191,5,16,5,15,58,66,-8,53
East Fife,6191,6,13,3,20,49,67,-18,42
Airdrieon,6191,7,10,11,15,45,60,-15,41
Forfar,6191,8,11,5,20,40,64,-24,38
Albion,6191,9,8,6,22,57,84,-27,30
Queen's Park,6191,10,6,11,19,40,73,-33,29
Ayr,6192,1,24,4,8,95,43,52,76
Raith,6192,2,22,8,6,69,35,34,74
Alloa,6192,3,18,8,10,59,44,15,62
Arbroath,6192,4,17,8,11,71,50,21,59
Stranraer,6192,5,15,5,16,56,66,-10,50
East Fife,6192,6,14,3,19,49,65,-16,45
Airdrieon,6192,7,10,12,14,47,60,-13,42
Forfar,6192,8,10,6,20,40,66,-26,36
Queen's Park,6192,9,7,10,19,41,73,-32,31
Albion,6192,10,8,6,22,58,83,-25,30
Ayr,6193,1,24,4,8,95,43,52,76
Raith,6193,2,22,8,6,70,35,35,74
Arbroath,6193,3,18,8,10,72,49,23,62
Alloa,6193,4,18,8,10,59,45,14,62
Stranraer,6193,5,15,6,15,56,65,-9,51
East Fife,6193,6,13,4,19,48,65,-17,43
Airdrieon,6193,7,10,11,15,45,59,-14,41
Forfar,6193,8,11,5,20,39,64,-25,38
Albion,6193,9,8,6,22,58,83,-25,30
Queen's Park,6193,10,6,10,20,40,74,-34,28
Ayr,6194,1,24,4,8,94,45,49,76
Raith,6194,2,22,8,6,71,36,35,74
Alloa,6194,3,18,8,10,60,46,14,62
Arbroath,6194,4,17,8,11,70,52,18,59
Stranraer,6194,5,16,5,15,57,64,-7,53
Airdrieon,6194,6,11,11,14,52,58,-6,44
East Fife,6194,7,13,3,20,47,66,-19,42
Forfar,6194,8,10,5,21,38,71,-33,35
Queen's Park,6194,9,7,10,19,43,72,-29,31
Albion,6194,10,8,6,22,60,82,-22,30
Ayr,6195,1,24,4,8,96,44,52,76
Raith,6195,2,22,9,5,69,33,36,75
Arbroath,6195,3,18,8,10,73,49,24,62
Alloa,6195,4,17,9,10,57,44,13,60
Stranraer,6195,5,16,5,15,57,64,-7,53
Airdrieon,6195,6,11,11,14,46,58,-12,44
East Fife,6195,7,13,3,20,47,66,-19,42
Forfar,6195,8,10,5,21,38,65,-27,35
Albion,6195,9,8,6,22,59,84,-25,30
Queen's Park,6195,10,6,10,20,40,75,-35,28
Raith,6196,1,23,8,5,71,34,37,77
Ayr,6196,2,24,4,8,95,43,52,76
Arbroath,6196,3,18,8,10,75,48,27,62
Alloa,6196,4,17,8,11,58,46,12,59
Stranraer,6196,5,15,5,16,55,66,-11,50
East Fife,6196,6,14,3,19,49,64,-15,45
Airdrieon,6196,7,11,11,14,46,58,-12,44
Forfar,6196,8,10,5,21,38,65,-27,35
Albion,6196,9,8,6,22,58,83,-25,30
Queen's Park,6196,10,6,10,20,39,77,-38,28
Raith,6197,1,23,8,5,69,32,37,77
Ayr,6197,2,24,4,8,92,43,49,76
Arbroath,6197,3,17,8,11,71,51,20,59
Alloa,6197,4,17,8,11,56,44,12,59
Stranraer,6197,5,15,6,15,56,65,-9,51
East Fife,6197,6,13,4,19,48,65,-17,43
Airdrieon,6197,7,10,11,15,46,60,-14,41
Forfar,6197,8,11,5,20,40,65,-25,38
Queen's Park,6197,9,7,10,19,42,73,-31,31
Albion,6197,10,8,6,22,58,80,-22,30
Ayr,6198,1,24,4,8,95,43,52,76
Raith,6198,2,22,9,5,69,33,36,75
Alloa,6198,3,17,9,10,57,44,13,60
Arbroath,6198,4,17,8,11,70,49,21,59
Stranraer,6198,5,15,5,16,55,67,-12,50
East Fife,6198,6,14,3,19,50,64,-14,45
Airdrieon,6198,7,11,11,14,47,59,-12,44
Forfar,6198,8,10,5,21,39,66,-27,35
Queen's Park,6198,9,7,10,19,40,72,-32,31
Albion,6198,10,8,6,22,58,83,-25,30
Ayr,6199,1,24,4,8,98,43,55,76
Raith,6199,2,22,8,6,69,34,35,74
Alloa,6199,3,18,8,10,58,44,14,62
Arbroath,6199,4,17,9,10,72,50,22,60
Stranraer,6199,5,15,5,16,57,68,-11,50
East Fife,6199,6,14,3,19,51,66,-15,45
Airdrieon,6199,7,11,11,14,47,58,-11,44
Forfar,6199,8,10,5,21,38,66,-28,35
Albion,6199,9,8,6,22,58,86,-28,30
Queen's Park,6199,10,6,11,19,41,74,-33,29
Raith,6200,1,23,8,5,69,32,37,77
Ayr,6200,2,24,4,8,94,42,52,76
Arbroath,6200,3,18,8,10,72,49,23,62
Alloa,6200,4,17,8,11,56,44,12,59
Stranraer,6200,5,15,5,16,55,69,-14,50
East Fife,6200,6,14,3,19,52,64,-12,45
Airdrieon,6200,7,10,11,15,45,59,-14,41
Forfar,6200,8,11,5,20,39,64,-25,38
Albion,6200,9,8,6,22,57,82,-25,30
Queen's Park,6200,10,6,10,20,40,74,-34,28
Raith,6201,1,23,8,5,69,32,37,77
Ayr,6201,2,24,4,8,94,43,51,76
Arbroath,6201,3,18,8,10,71,48,23,62
Alloa,6201,4,17,8,11,56,44,12,59
Stranraer,6201,5,15,5,16,56,66,-10,50
East Fife,6201,6,14,3,19,49,65,-16,45
Airdrieon,6201,7,11,11,14,48,59,-11,44
Forfar,6201,8,10,5,21,39,67,-28,35
Albion,6201,9,8,6,22,58,82,-24,30
Queen's Park,6201,10,6,10,20,39,73,-34,28
Ayr,6202,1,24,4,8,94,42,52,76
Raith,6202,2,22,9,5,70,34,36,75
Alloa,6202,3,17,9,10,58,45,13,60
Arbroath,6202,4,17,8,11,71,50,21,59
Stranraer,6202,5,16,5,15,57,65,-8,53
Airdrieon,6202,6,11,11,14,47,59,-12,44
East Fife,6202,7,13,3,20,48,66,-18,42
Forfar,6202,8,10,5,21,39,66,-27,35
Queen's Park,6202,9,7,10,19,41,73,-32,31
Albion,6202,10,8,6,22,57,82,-25,30
Raith,6203,1,23,8,5,69,32,37,77
Ayr,6203,2,23,4,9,93,46,47,73
Arbroath,6203,3,18,8,10,73,50,23,62
Alloa,6203,4,17,8,11,56,44,12,59
Stranraer,6203,5,15,5,16,57,67,-10,50
East Fife,6203,6,14,3,19,50,66,-16,45
Airdrieon,6203,7,11,11,14,46,58,-12,44
Forfar,6203,8,10,5,21,38,65,-27,35
Albion,6203,9,9,6,21,61,81,-20,33
Queen's Park,6203,10,6,10,20,41,75,-34,28
Raith,6204,1,23,8,5,70,33,37,77
Ayr,6204,2,24,4,8,92,43,49,76
Arbroath,6204,3,18,8,10,74,48,26,62
Alloa,6204,4,17,8,11,57,45,12,59
Stranraer,6204,5,15,6,15,57,66,-9,51
Airdrieon,6204,6,11,11,14,46,58,-12,44
East Fife,6204,7,13,4,19,49,66,-17,43
Forfar,6204,8,10,5,21,38,65,-27,35
Albion,6204,9,8,6,22,58,80,-22,30
Queen's Park,6204,10,6,10,20,39,76,-37,28
Raith,6205,1,22,9,5,68,32,36,75
Ayr,6205,2,23,5,8,90,42,48,74
Arbroath,6205,3,17,9,10,70,48,22,60
Alloa,6205,4,17,9,10,56,43,13,60
Stranraer,6205,5,15,5,16,56,66,-10,50
East Fife,6205,6,14,3,19,49,65,-16,45
Airdrieon,6205,7,11,11,14,47,59,-12,44
Forfar,6205,8,10,5,21,39,66,-27,35
Albion,6205,9,8,7,21,57,78,-21,31
Queen's Park,6205,10,6,11,19,39,72,-33,29
Raith,6206,1,23,8,5,69,32,37,77
Ayr,6206,2,24,4,8,92,42,50,76
Arbroath,6206,3,18,8,10,73,49,24,62
Alloa,6206,4,17,8,11,56,44,12,59
Stranraer,6206,5,16,5,15,58,66,-8,53
Airdrieon,6206,6,11,11,14,46,58,-12,44
East Fife,6206,7,13,3,20,49,67,-18,42
Forfar,6206,8,10,5,21,38,65,-27,35
Albion,6206,9,8,6,22,57,80,-23,30
Queen's Park,6206,10,6,10,20,40,75,-35,28
Ayr,6207,1,24,4,8,95,44,51,76
Raith,6207,2,22,8,6,68,33,35,74
Alloa,6207,3,18,8,10,57,43,14,62
Arbroath,6207,4,17,8,11,71,51,20,59
Stranraer,6207,5,15,5,16,55,65,-10,50
East Fife,6207,6,14,3,19,48,64,-16,45
Airdrieon,6207,7,11,11,14,47,59,-12,44
Forfar,6207,8,10,5,21,39,66,-27,35
Queen's Park,6207,9,7,10,19,42,73,-31,31
Albion,6207,10,8,6,22,59,83,-24,30
Raith,6208,1,23,8,5,70,32,38,77
Ayr,6208,2,24,4,8,95,44,51,76
Arbroath,6208,3,18,8,10,72,49,23,62
Alloa,6208,4,17,8,11,56,45,11,59
Stranraer,6208,5,15,5,16,56,69,-13,50
East Fife,6208,6,14,3,19,52,65,-13,45
Airdrieon,6208,7,10,11,15,45,60,-15,41
Forfar,6208,8,11,5,20,40,64,-24,38
Albion,6208,9,8,6,22,59,83,-24,30
Queen's Park,6208,10,6,10,20,40,74,-34,28
Raith,6209,1,23,8,5,71,32,39,77
Ayr,6209,2,24,4,8,93,43,50,76
Arbroath,6209,3,17,9,10,71,49,22,60
Alloa,6209,4,17,8,11,56,46,10,59
Stranraer,6209,5,16,5,15,56,64,-8,53
Airdrieon,6209,6,11,11,14,46,58,-12,44
East Fife,6209,7,13,3,20,47,65,-18,42
Forfar,6209,8,10,5,21,38,65,-27,35
Albion,6209,9,8,6,22,58,81,-23,30
Queen's Park,6209,10,6,11,19,40,73,-33,29
Raith,6210,1,23,8,5,70,32,38,77
Ayr,6210,2,24,4,8,92,43,49,76
Arbroath,6210,3,18,8,10,72,49,23,62
Alloa,6210,4,17,8,11,56,45,11,59
Stranraer,6210,5,16,5,15,57,65,-8,53
Airdrieon,6210,6,11,11,14,46,58,-12,44
East Fife,6210,7,13,3,20,48,66,-18,42
Forfar,6210,8,10,5,21,38,65,-27,35
Albion,6210,9,8,6,22,58,80,-22,30
Queen's Park,6210,10,6,10,20,40,74,-34,28
Raith,6211,1,23,8,5,72,32,40,77
Ayr,6211,2,24,4,8,92,43,49,76
Arbroath,6211,3,17,8,11,70,51,19,59
Alloa,6211,4,17,8,11,56,47,9,59
Stranraer,6211,5,15,6,15,56,65,-9,51
East Fife,6211,6,13,4,19,48,65,-17,43
Airdrieon,6211,7,10,11,15,45,60,-15,41
Forfar,6211,8,11,5,20,40,64,-24,38
Queen's Park,6211,9,7,10,19,42,72,-30,31
Albion,6211,10,8,6,22,58,80,-22,30
Ayr,6212,1,23,5,8,94,46,48,74
Raith,6212,2,22,8,6,70,35,35,74
Arbroath,6212,3,18,8,10,72,48,24,62
Alloa,6212,4,18,8,10,59,45,14,62
Stranraer,6212,5,15,5,16,55,66,-11,50
East Fife,6212,6,14,3,19,49,64,-15,45
Airdrieon,6212,7,10,12,14,47,60,-13,42
Forfar,6212,8,10,6,20,40,66,-26,36
Albion,6212,9,8,7,21,61,82,-21,31
Queen's Park,6212,10,6,10,20,39,74,-35,28
Raith,6213,1,23,8,5,72,35,37,77
Ayr,6213,2,24,4,8,94,42,52,76
Arbroath,6213,3,18,8,10,75,50,25,62
Alloa,6213,4,17,8,11,59,47,12,59
Stranraer,6213,5,15,6,15,56,65,-9,51
Airdrieon,6213,6,11,11,14,47,59,-12,44
East Fife,6213,7,13,4,19,48,65,-17,43
Forfar,6213,8,10,5,21,39,66,-27,35
Albion,6213,9,8,6,22,57,82,-25,30
Queen's Park,6213,10,6,10,20,41,77,-36,28
Ayr,6214,1,24,4,8,92,43,49,76
Raith,6214,2,22,9,5,68,32,36,75
Arbroath,6214,3,18,8,10,72,48,24,62
Alloa,6214,4,17,9,10,56,43,13,60
Stranraer,6214,5,15,5,16,58,68,-10,50
East Fife,6214,6,14,3,19,51,67,-16,45
Airdrieon,6214,7,11,11,14,47,58,-11,44
Forfar,6214,8,10,5,21,38,66,-28,35
Albion,6214,9,8,6,22,58,80,-22,30
Queen's Park,6214,10,6,10,20,39,74,-35,28
Raith,6215,1,23,8,5,71,34,37,77
Ayr,6215,2,24,4,8,95,42,53,76
Arbroath,6215,3,18,8,10,72,49,23,62
Alloa,6215,4,17,8,11,58,46,12,59
Stranraer,6215,5,15,6,15,55,64,-9,51
Airdrieon,6215,6,11,11,14,47,59,-12,44
East Fife,6215,7,13,4,19,47,64,-17,43
Forfar,6215,8,10,5,21,39,66,-27,35
Albion,6215,9,8,6,22,57,83,-26,30
Queen's Park,6215,10,6,10,20,40,74,-34,28
Raith,6216,1,22,9,5,69,33,36,75
Ayr,6216,2,23,4,9,91,45,46,73
Arbroath,6216,3,17,9,10,73,51,22,60
Alloa,6216,4,17,9,10,57,44,13,60
Stranraer,6216,5,15,5,16,58,68,-10,50
East Fife,6216,6,14,3,19,51,67,-16,45
Airdrieon,6216,7,11,11,14,47,59,-12,44
Forfar,6216,8,10,5,21,39,66,-27,35
Albion,6216,9,9,6,21,60,79,-19,33
Queen's Park,6216,10,6,11,19,42,75,-33,29
Ayr,6217,1,24,4,8,93,43,50,76
Raith,6217,2,22,9,5,68,32,36,75
Arbroath,6217,3,17,9,10,71,49,22,60
Alloa,6217,4,17,9,10,56,43,13,60
Stranraer,6217,5,15,6,15,57,66,-9,51
Airdrieon,6217,6,11,11,14,47,59,-12,44
East Fife,6217,7,13,4,19,49,66,-17,43
Forfar,6217,8,10,5,21,39,66,-27,35
Albion,6217,9,8,6,22,58,81,-23,30
Queen's Park,6217,10,6,11,19,40,73,-33,29
Raith,6218,1,23,8,5,71,34,37,77
Ayr,6218,2,23,5,8,91,43,48,74
Arbroath,6218,3,17,8,11,70,49,21,59
Alloa,6218,4,17,8,11,58,46,12,59
Stranraer,6218,5,15,6,15,57,66,-9,51
East Fife,6218,6,13,4,19,49,66,-17,43
Airdrieon,6218,7,10,11,15,45,61,-16,41
Forfar,6218,8,11,5,20,41,64,-23,38
Albion,6218,9,8,7,21,58,79,-21,31
Queen's Park,6218,10,7,10,19,40,72,-32,31
Raith,6219,1,23,8,5,71,33,38,77
Ayr,6219,2,24,4,8,93,44,49,76
Arbroath,6219,3,18,8,10,73,49,24,62
Alloa,6219,4,17,8,11,57,46,11,59
Stranraer,6219,5,15,5,16,55,65,-10,50
East Fife,6219,6,14,3,19,48,64,-16,45
Airdrieon,6219,7,11,11,14,49,60,-11,44
Forfar,6219,8,10,5,21,40,68,-28,35
Albion,6219,9,8,6,22,59,81,-22,30
Queen's Park,6219,10,6,10,20,40,75,-35,28
Raith,6220,1,23,8,5,70,32,38,77
Ayr,6220,2,24,4,8,96,43,53,76
Arbroath,6220,3,18,8,10,74,50,24,62
Alloa,6220,4,17,8,11,56,45,11,59
Stranraer,6220,5,15,6,15,55,64,-9,51
Airdrieon,6220,6,11,11,14,48,59,-11,44
East Fife,6220,7,13,4,19,47,64,-17,43
Forfar,6220,8,10,5,21,39,67,-28,35
Albion,6220,9,8,6,22,58,84,-26,30
Queen's Park,6220,10,6,10,20,41,76,-35,28
Ayr,6221,1,24,4,8,94,43,51,76
Raith,6221,2,22,8,6,68,34,34,74
Arbroath,6221,3,18,8,10,73,50,23,62
Alloa,6221,4,18,8,10,58,43,15,62
Stranraer,6221,5,16,5,15,59,65,-6,53
Airdrieon,6221,6,11,11,14,50,61,-11,44
East Fife,6221,7,13,3,20,48,68,-20,42
Forfar,6221,8,10,5,21,41,69,-28,35
Albion,6221,9,8,6,22,58,82,-24,30
Queen's Park,6221,10,6,10,20,41,75,-34,28
Ayr,6222,1,24,4,8,94,44,50,76
Raith,6222,2,22,9,5,69,33,36,75
Arbroath,6222,3,18,8,10,74,48,26,62
Alloa,6222,4,17,9,10,57,44,13,60
Stranraer,6222,5,16,5,15,59,66,-7,53
East Fife,6222,6,13,3,20,49,68,-19,42
Airdrieon,6222,7,10,11,15,45,61,-16,41
Forfar,6222,8,11,5,20,41,64,-23,38
Albion,6222,9,8,6,22,59,82,-23,30
Queen's Park,6222,10,6,10,20,39,76,-37,28
Raith,6223,1,23,8,5,70,32,38,77
Ayr,6223,2,24,4,8,93,43,50,76
Arbroath,6223,3,18,8,10,72,48,24,62
Alloa,6223,4,17,8,11,56,45,11,59
Stranraer,6223,5,15,5,16,55,66,-11,50
East Fife,6223,6,14,3,19,49,64,-15,45
Airdrieon,6223,7,11,11,14,46,58,-12,44
Forfar,6223,8,10,5,21,38,65,-27,35
Albion,6223,9,8,6,22,58,81,-23,30
Queen's Park,6223,10,6,10,20,39,74,-35,28
Ayr,6224,1,24,4,8,95,44,51,76
Raith,6224,2,22,8,6,70,35,35,74
Alloa,6224,3,18,8,10,59,45,14,62
Arbroath,6224,4,17,8,11,72,52,20,59
Stranraer,6224,5,15,5,16,55,70,-15,50
East Fife,6224,6,14,3,19,53,64,-11,45
Airdrieon,6224,7,10,12,14,46,59,-13,42
Forfar,6224,8,10,6,20,39,65,-26,36
Queen's Park,6224,9,7,10,19,43,74,-31,31
Albion,6224,10,8,6,22,59,83,-24,30
Raith,6225,1,23,8,5,71,33,38,77
Ayr,6225,2,23,4,9,91,45,46,73
Arbroath,6225,3,18,8,10,71,48,23,62
Alloa,6225,4,17,8,11,57,46,11,59
Stranraer,6225,5,15,6,15,55,64,-9,51
Airdrieon,6225,6,11,11,14,49,58,-9,44
East Fife,6225,7,13,4,19,47,64,-17,43
Forfar,6225,8,10,5,21,38,68,-30,35
Albion,6225,9,9,6,21,60,79,-19,33
Queen's Park,6225,10,6,10,20,39,73,-34,28
Raith,6226,1,23,8,5,70,33,37,77
Ayr,6226,2,24,4,8,92,42,50,76
Arbroath,6226,3,18,8,10,74,49,25,62
Alloa,6226,4,17,8,11,57,45,12,59
Stranraer,6226,5,15,5,16,55,65,-10,50
East Fife,6226,6,14,3,19,48,64,-16,45
Airdrieon,6226,7,11,11,14,48,58,-10,44
Forfar,6226,8,10,5,21,38,67,-29,35
Albion,6226,9,8,6,22,57,80,-23,30
Queen's Park,6226,10,6,10,20,40,76,-36,28
Ayr,6227,1,24,4,8,95,43,52,76
Raith,6227,2,22,9,5,70,34,36,75
Arbroath,6227,3,18,8,10,73,49,24,62
Alloa,6227,4,17,9,10,58,45,13,60
Stranraer,6227,5,15,5,16,56,68,-12,50
East Fife,6227,6,14,3,19,51,65,-14,45
Airdrieon,6227,7,10,11,15,45,61,-16,41
Forfar,6227,8,11,5,20,41,64,-23,38
Albion,6227,9,8,6,22,58,83,-25,30
Queen's Park,6227,10,6,10,20,40,75,-35,28
Ayr,6228,1,24,4,8,96,43,53,76
Raith,6228,2,22,8,6,68,33,35,74
Alloa,6228,3,18,8,10,57,43,14,62
Arbroath,6228,4,17,8,11,70,50,20,59
Stranraer,6228,5,16,5,15,58,65,-7,53
Airdrieon,6228,6,11,11,14,50,59,-9,44
East Fife,6228,7,13,3,20,48,67,-19,42
Forfar,6228,8,10,5,21,39,69,-30,35
Queen's Park,6228,9,7,10,19,41,72,-31,31
Albion,6228,10,8,6,22,58,84,-26,30
Ayr,6229,1,24,4,8,92,42,50,76
Raith,6229,2,22,9,5,69,33,36,75
Arbroath,6229,3,18,8,10,73,48,25,62
Alloa,6229,4,17,9,10,57,44,13,60
Stranraer,6229,5,15,5,16,56,67,-11,50
East Fife,6229,6,14,3,19,50,65,-15,45
Airdrieon,6229,7,10,11,15,45,60,-15,41
Forfar,6229,8,11,5,20,40,64,-24,38
Albion,6229,9,8,6,22,57,80,-23,30
Queen's Park,6229,10,6,10,20,39,75,-36,28
Raith,6230,1,23,8,5,74,32,42,77
Ayr,6230,2,24,4,8,96,44,52,76
Arbroath,6230,3,18,8,10,73,49,24,62
Alloa,6230,4,17,8,11,56,49,7,59
Stranraer,6230,5,15,6,15,57,66,-9,51
East Fife,6230,6,13,4,19,49,66,-17,43
Airdrieon,6230,7,10,11,15,45,59,-14,41
Forfar,6230,8,11,5,20,39,64,-25,38
Albion,6230,9,8,6,22,59,84,-25,30
Queen's Park,6230,10,6,10,20,40,75,-35,28
Ayr,6231,1,24,4,8,94,43,51,76
Raith,6231,2,22,8,6,68,33,35,74
Arbroath,6231,3,18,8,10,72,48,24,62
Alloa,6231,4,18,8,10,57,43,14,62
Stranraer,6231,5,15,5,16,56,66,-10,50
East Fife,6231,6,14,3,19,49,65,-16,45
Airdrieon,6231,7,10,11,15,47,61,-14,41
Forfar,6231,8,11,5,20,41,66,-25,38
Albion,6231,9,8,6,22,58,82,-24,30
Queen's Park,6231,10,6,10,20,39,74,-35,28
Raith,6232,1,23,8,5,70,32,38,77
Ayr,6232,2,24,4,8,93,44,49,76
Arbroath,6232,3,18,8,10,73,48,25,62
Alloa,6232,4,17,8,11,56,45,11,59
Stranraer,6232,5,15,5,16,56,67,-11,50
East Fife,6232,6,14,3,19,50,65,-15,45
Airdrieon,6232,7,11,11,14,48,59,-11,44
Forfar,6232,8,10,5,21,39,67,-28,35
Albion,6232,9,8,6,22,59,81,-22,30
Queen's Park,6232,10,6,10,20,39,75,-36,28
Ayr,6233,1,24,4,8,96,42,54,76
Raith,6233,2,22,9,5,69,33,36,75
Arbroath,6233,3,18,8,10,74,50,24,62
Alloa,6233,4,17,9,10,57,44,13,60
Stranraer,6233,5,15,5,16,57,67,-10,50
East Fife,6233,6,14,3,19,50,66,-16,45
Airdrieon,6233,7,11,11,14,48,60,-12,44
Forfar,6233,8,10,5,21,40,67,-27,35
Albion,6233,9,8,6,22,57,84,-27,30
Queen's Park,6233,10,6,10,20,41,76,-35,28
Raith,6234,1,22,9,5,69,33,36,75
Ayr,6234,2,23,4,9,91,44,47,73
Arbroath,6234,3,18,8,10,72,48,24,62
Alloa,6234,4,17,9,10,57,44,13,60
Stranraer,6234,5,16,5,15,57,64,-7,53
Airdrieon,6234,6,10,12,14,45,58,-13,42
East Fife,6234,7,13,3,20,47,66,-19,42
Forfar,6234,8,10,6,20,38,64,-26,36
Albion,6234,9,9,6,21,59,79,-20,33
Queen's Park,6234,10,6,10,20,39,74,-35,28
Raith,6235,1,22,9,5,69,33,36,75
Ayr,6235,2,23,5,8,91,43,48,74
Arbroath,6235,3,18,8,10,71,48,23,62
Alloa,6235,4,17,9,10,57,44,13,60
Stranraer,6235,5,16,5,15,58,65,-7,53
Airdrieon,6235,6,10,12,14,48,61,-13,42
East Fife,6235,7,13,3,20,48,67,-19,42
Forfar,6235,8,10,6,20,41,67,-26,36
Albion,6235,9,8,7,21,58,79,-21,31
Queen's Park,6235,10,6,10,20,39,73,-34,28
Raith,6236,1,23,8,5,69,32,37,77
Ayr,6236,2,24,4,8,94,42,52,76
Arbroath,6236,3,17,8,11,70,50,20,59
Alloa,6236,4,17,8,11,56,44,12,59
Stranraer,6236,5,15,5,16,56,66,-10,50
East Fife,6236,6,14,3,19,49,65,-16,45
Airdrieon,6236,7,10,11,15,46,60,-14,41
Forfar,6236,8,11,5,20,40,65,-25,38
Queen's Park,6236,9,7,10,19,41,72,-31,31
Albion,6236,10,8,6,22,57,82,-25,30
Ayr,6237,1,24,4,8,96,44,52,76
Raith,6237,2,22,8,6,69,34,35,74
Alloa,6237,3,18,8,10,58,44,14,62
Arbroath,6237,4,17,9,10,72,50,22,60
Stranraer,6237,5,16,5,15,56,64,-8,53
Airdrieon,6237,6,11,11,14,48,58,-10,44
East Fife,6237,7,13,3,20,47,65,-18,42
Forfar,6237,8,10,5,21,38,67,-29,35
Albion,6237,9,8,6,22,59,84,-25,30
Queen's Park,6237,10,6,11,19,41,74,-33,29
Raith,6238,1,23,8,5,71,34,37,77
Ayr,6238,2,24,4,8,92,43,49,76
Arbroath,6238,3,17,9,10,71,49,22,60
Alloa,6238,4,17,8,11,58,46,12,59
Stranraer,6238,5,15,6,15,56,65,-9,51
Airdrieon,6238,6,11,11,14,47,59,-12,44
East Fife,6238,7,13,4,19,48,65,-17,43
Forfar,6238,8,10,5,21,39,66,-27,35
Albion,6238,9,8,6,22,58,80,-22,30
Queen's Park,6238,10,6,11,19,40,73,-33,29
Raith,6239,1,23,8,5,69,32,37,77
Ayr,6239,2,24,4,8,95,44,51,76
Arbroath,6239,3,18,8,10,74,48,26,62
Alloa,6239,4,17,8,11,56,44,12,59
Stranraer,6239,5,15,6,15,57,66,-9,51
Airdrieon,6239,6,11,11,14,46,58,-12,44
East Fife,6239,7,13,4,19,49,66,-17,43
Forfar,6239,8,10,5,21,38,65,-27,35
Albion,6239,9,8,6,22,59,83,-24,30
Queen's Park,6239,10,6,10,20,39,76,-37,28
Raith,6240,1,23,8,5,69,32,37,77
Ayr,6240,2,24,4,8,93,43,50,76
Arbroath,6240,3,18,8,10,72,48,24,62
Alloa,6240,4,17,8,11,56,44,12,59
Stranraer,6240,5,15,6,15,56,65,-9,51
East Fife,6240,6,13,4,19,48,65,-17,43
Airdrieon,6240,7,10,11,15,46,61,-15,41
Forfar,6240,8,11,5,20,41,65,-24,38
Albion,6240,9,8,6,22,58,81,-23,30
Queen's Park,6240,10,6,10,20,39,74,-35,28
Ayr,6241,1,24,4,8,91,42,49,76
Raith,6241,2,22,8,6,68,34,34,74
Arbroath,6241,3,18,8,10,72,48,24,62
Alloa,6241,4,18,8,10,58,43,15,62
Stranraer,6241,5,15,6,15,55,64,-9,51
East Fife,6241,6,13,4,19,47,64,-17,43
Airdrieon,6241,7,10,12,14,46,59,-13,42
Forfar,6241,8,10,6,20,39,65,-26,36
Albion,6241,9,8,6,22,57,79,-22,30
Queen's Park,6241,10,6,10,20,39,74,-35,28
Raith,6242,1,23,8,5,69,32,37,77
Ayr,6242,2,24,4,8,94,42,52,76
Arbroath,6242,3,17,9,10,72,50,22,60
Alloa,6242,4,17,8,11,56,44,12,59
Stranraer,6242,5,15,5,16,56,66,-10,50
East Fife,6242,6,14,3,19,49,65,-16,45
Airdrieon,6242,7,11,11,14,46,58,-12,44
Forfar,6242,8,10,5,21,38,65,-27,35
Albion,6242,9,8,6,22,57,82,-25,30
Queen's Park,6242,10,6,11,19,41,74,-33,29
Ayr,6243,1,24,4,8,93,42,51,76
Raith,6243,2,22,9,5,68,32,36,75
Arbroath,6243,3,18,8,10,72,49,23,62
Alloa,6243,4,17,9,10,56,43,13,60
Stranraer,6243,5,16,5,15,58,66,-8,53
East Fife,6243,6,13,3,20,49,67,-18,42
Airdrieon,6243,7,10,11,15,45,59,-14,41
Forfar,6243,8,11,5,20,39,64,-25,38
Albion,6243,9,8,6,22,57,81,-24,30
Queen's Park,6243,10,6,10,20,40,74,-34,28
Ayr,6244,1,24,4,8,95,44,51,76
Raith,6244,2,22,8,6,70,36,34,74
Alloa,6244,3,18,8,10,60,45,15,62
Arbroath,6244,4,17,8,11,71,50,21,59
Stranraer,6244,5,16,5,15,58,66,-8,53
Airdrieon,6244,6,11,11,14,46,58,-12,44
East Fife,6244,7,13,3,20,49,67,-18,42
Forfar,6244,8,10,5,21,38,65,-27,35
Queen's Park,6244,9,7,10,19,41,73,-32,31
Albion,6244,10,8,6,22,59,83,-24,30
Raith,6245,1,23,8,5,72,32,40,77
Ayr,6245,2,24,4,8,92,43,49,76
Arbroath,6245,3,17,9,10,71,49,22,60
Alloa,6245,4,17,8,11,56,47,9,59
Stranraer,6245,5,15,5,16,55,66,-11,50
East Fife,6245,6,14,3,19,49,64,-15,45
Airdrieon,6245,7,11,11,14,46,58,-12,44
Forfar,6245,8,10,5,21,38,65,-27,35
Albion,6245,9,8,6,22,58,80,-22,30
Queen's Park,6245,10,6,11,19,40,73,-33,29
Raith,6246,1,23,8,5,71,34,37,77
Ayr,6246,2,23,5,8,92,44,48,74
Arbroath,6246,3,17,8,11,70,50,20,59
Alloa,6246,4,17,8,11,58,46,12,59
Stranraer,6246,5,15,5,16,55,66,-11,50
East Fife,6246,6,14,3,19,49,64,-15,45
Airdrieon,6246,7,10,11,15,46,60,-14,41
Forfar,6246,8,11,5,20,40,65,-25,38
Albion,6246,9,8,7,21,59,80,-21,31
Queen's Park,6246,10,7,10,19,41,72,-31,31
Raith,6247,1,23,8,5,70,33,37,77
Ayr,6247,2,24,4,8,95,45,50,76
Arbroath,6247,3,18,8,10,74,50,24,62
Alloa,6247,4,17,8,11,57,45,12,59
Stranraer,6247,5,15,5,16,55,65,-10,50
East Fife,6247,6,14,3,19,48,64,-16,45
Airdrieon,6247,7,11,11,14,49,59,-10,44
Forfar,6247,8,10,5,21,39,68,-29,35
Albion,6247,9,8,6,22,60,83,-23,30
Queen's Park,6247,10,6,10,20,41,76,-35,28
Raith,6248,1,23,8,5,70,33,37,77
Ayr,6248,2,24,4,8,96,42,54,76
Arbroath,6248,3,17,9,10,72,50,22,60
Alloa,6248,4,17,8,11,57,45,12,59
Stranraer,6248,5,15,5,16,56,66,-10,50
East Fife,6248,6,14,3,19,49,65,-16,45
Airdrieon,6248,7,11,11,14,47,58,-11,44
Forfar,6248,8,10,5,21,38,66,-28,35
Albion,6248,9,8,6,22,57,84,-27,30
Queen's Park,6248,10,6,11,19,41,74,-33,29
Raith,6249,1,23,8,5,70,32,38,77
Ayr,6249,2,23,4,9,92,45,47,73
Arbroath,6249,3,18,8,10,71,48,23,62
Alloa,6249,4,17,8,11,56,45,11,59
Stranraer,6249,5,16,5,15,56,64,-8,53
East Fife,6249,6,13,3,20,47,65,-18,42
Airdrieon,6249,7,10,11,15,45,59,-14,41
Forfar,6249,8,11,5,20,39,64,-25,38
Albion,6249,9,9,6,21,60,80,-20,33
Queen's Park,6249,10,6,10,20,39,73,-34,28
Raith,6250,1,23,8,5,70,33,37,77
Ayr,6250,2,24,4,8,92,42,50,76
Arbroath,6250,3,18,8,10,72,48,24,62
Alloa,6250,4,17,8,11,57,45,12,59
Stranraer,6250,5,15,6,15,57,66,-9,51
East Fife,6250,6,13,4,19,49,66,-17,43
Airdrieon,6250,7,10,12,14,46,59,-13,42
Forfar,6250,8,10,6,20,39,65,-26,36
Albion,6250,9,8,6,22,57,80,-23,30
Queen's Park,6250,10,6,10,20,39,74,-35,28
Ayr,6251,1,24,4,8,95,42,53,76
Raith,6251,2,22,9,5,69,33,36,75
Alloa,6251,3,17,9,10,57,44,13,60
Arbroath,6251,4,17,8,11,70,50,20,59
Stranraer,6251,5,16,5,15,57,64,-7,53
Airdrieon,6251,6,10,12,14,47,60,-13,42
East Fife,6251,7,13,3,20,47,66,-19,42
Forfar,6251,8,10,6,20,40,66,-26,36
Queen's Park,6251,9,7,10,19,41,72,-31,31
Albion,6251,10,8,6,22,57,83,-26,30
Ayr,6252,1,24,4,8,95,43,52,76
Raith,6252,2,22,9,5,70,34,36,75
Alloa,6252,3,17,9,10,58,45,13,60
Arbroath,6252,4,17,8,11,70,49,21,59
Stranraer,6252,5,16,5,15,58,66,-8,53
East Fife,6252,6,13,3,20,49,67,-18,42
Airdrieon,6252,7,10,11,15,46,60,-14,41
Forfar,6252,8,11,5,20,40,65,-25,38
Queen's Park,6252,9,7,10,19,40,72,-32,31
Albion,6252,10,8,6,22,58,83,-25,30
Ayr,6253,1,24,4,8,91,42,49,76
Raith,6253,2,22,8,6,68,33,35,74
Alloa,6253,3,18,8,10,57,43,14,62
Arbroath,6253,4,17,9,10,71,49,22,60
Stranraer,6253,5,15,5,16,56,66,-10,50
East Fife,6253,6,14,3,19,49,65,-16,45
Airdrieon,6253,7,11,11,14,46,58,-12,44
Forfar,6253,8,10,5,21,38,65,-27,35
Albion,6253,9,8,6,22,57,79,-22,30
Queen's Park,6253,10,6,11,19,40,73,-33,29
Raith,6254,1,23,8,5,74,33,41,77
Ayr,6254,2,24,4,8,95,42,53,76
Arbroath,6254,3,18,8,10,72,48,24,62
Alloa,6254,4,17,8,11,57,49,8,59
Stranraer,6254,5,15,5,16,56,69,-13,50
East Fife,6254,6,14,3,19,52,65,-13,45
Airdrieon,6254,7,10,11,15,46,60,-14,41
Forfar,6254,8,11,5,20,40,65,-25,38
Albion,6254,9,8,6,22,57,83,-26,30
Queen's Park,6254,10,6,10,20,39,74,-35,28
Raith,6255,1,23,8,5,69,32,37,77
Ayr,6255,2,24,4,8,91,42,49,76
Arbroath,6255,3,17,8,11,70,50,20,59
Alloa,6255,4,17,8,11,56,44,12,59
Stranraer,6255,5,15,5,16,55,67,-12,50
East Fife,6255,6,14,3,19,50,64,-14,45
Airdrieon,6255,7,11,11,14,47,58,-11,44
Forfar,6255,8,10,5,21,38,66,-28,35
Queen's Park,6255,9,7,10,19,41,72,-31,31
Albion,6255,10,8,6,22,57,79,-22,30
Raith,6256,1,22,9,5,69,33,36,75
Ayr,6256,2,23,5,8,94,46,48,74
Arbroath,6256,3,18,8,10,74,49,25,62
Alloa,6256,4,17,9,10,57,44,13,60
Stranraer,6256,5,15,5,16,56,67,-11,50
East Fife,6256,6,14,3,19,50,65,-15,45
Airdrieon,6256,7,11,11,14,50,58,-8,44
Forfar,6256,8,10,5,21,38,69,-31,35
Albion,6256,9,8,7,21,61,82,-21,31
Queen's Park,6256,10,6,10,20,40,76,-36,28
Raith,6257,1,23,8,5,69,32,37,77
Ayr,6257,2,24,4,8,94,42,52,76
Arbroath,6257,3,17,8,11,72,51,21,59
Alloa,6257,4,17,8,11,56,44,12,59
Stranraer,6257,5,16,5,15,56,64,-8,53
East Fife,6257,6,13,3,20,47,65,-18,42
Airdrieon,6257,7,10,11,15,45,59,-14,41
Forfar,6257,8,11,5,20,39,64,-25,38
Queen's Park,6257,9,7,10,19,42,74,-32,31
Albion,6257,10,8,6,22,57,82,-25,30
Raith,6258,1,23,8,5,70,33,37,77
Ayr,6258,2,24,4,8,95,42,53,76
Arbroath,6258,3,17,8,11,70,50,20,59
Alloa,6258,4,17,8,11,57,45,12,59
Stranraer,6258,5,15,5,16,55,67,-12,50
East Fife,6258,6,14,3,19,50,64,-14,45
Airdrieon,6258,7,10,12,14,45,58,-13,42
Forfar,6258,8,10,6,20,38,64,-26,36
Queen's Park,6258,9,7,10,19,41,72,-31,31
Albion,6258,10,8,6,22,57,83,-26,30
Raith,6259,1,23,8,5,71,34,37,77
Ayr,6259,2,24,4,8,95,42,53,76
Arbroath,6259,3,18,8,10,71,48,23,62
Alloa,6259,4,17,8,11,58,46,12,59
Stranraer,6259,5,15,6,15,55,64,-9,51
Airdrieon,6259,6,11,11,14,48,59,-11,44
East Fife,6259,7,13,4,19,47,64,-17,43
Forfar,6259,8,10,5,21,39,67,-28,35
Albion,6259,9,8,6,22,57,83,-26,30
Queen's Park,6259,10,6,10,20,39,73,-34,28
Raith,6260,1,23,8,5,71,33,38,77
Ayr,6260,2,24,4,8,92,43,49,76
Arbroath,6260,3,17,8,11,70,52,18,59
Alloa,6260,4,17,8,11,57,46,11,59
Stranraer,6260,5,15,5,16,56,66,-10,50
East Fife,6260,6,14,3,19,49,65,-16,45
Airdrieon,6260,7,11,11,14,46,58,-12,44
Forfar,6260,8,10,5,21,38,65,-27,35
Queen's Park,6260,9,7,10,19,43,72,-29,31
Albion,6260,10,8,6,22,58,80,-22,30
Ayr,6261,1,24,4,8,95,43,52,76
Raith,6261,2,22,8,6,69,35,34,74
Alloa,6261,3,18,8,10,59,44,15,62
Arbroath,6261,4,17,8,11,70,51,19,59
Stranraer,6261,5,15,5,16,56,66,-10,50
East Fife,6261,6,14,3,19,49,65,-16,45
Airdrieon,6261,7,10,12,14,46,59,-13,42
Forfar,6261,8,10,6,20,39,65,-26,36
Queen's Park,6261,9,7,10,19,42,72,-30,31
Albion,6261,10,8,6,22,58,83,-25,30
Raith,6262,1,23,8,5,70,32,38,77
Ayr,6262,2,24,4,8,97,44,53,76
Arbroath,6262,3,17,9,10,71,49,22,60
Alloa,6262,4,17,8,11,56,45,11,59
Stranraer,6262,5,16,5,15,59,67,-8,53
Airdrieon,6262,6,11,11,14,47,59,-12,44
East Fife,6262,7,13,3,20,50,68,-18,42
Forfar,6262,8,10,5,21,39,66,-27,35
Albion,6262,9,8,6,22,59,85,-26,30
Queen's Park,6262,10,6,11,19,40,73,-33,29
Raith,6263,1,23,8,5,70,33,37,77
Ayr,6263,2,24,4,8,91,42,49,76
Arbroath,6263,3,17,8,11,70,53,17,59
Alloa,6263,4,17,8,11,57,45,12,59
Stranraer,6263,5,15,5,16,55,67,-12,50
East Fife,6263,6,14,3,19,50,64,-14,45
Airdrieon,6263,7,10,12,14,46,59,-13,42
Forfar,6263,8,10,6,20,39,65,-26,36
Queen's Park,6263,9,7,10,19,44,72,-28,31
Albion,6263,10,8,6,22,57,79,-22,30
Ayr,6264,1,23,5,8,92,44,48,74
Raith,6264,2,22,8,6,68,33,35,74
Arbroath,6264,3,18,8,10,72,49,23,62
Alloa,6264,4,18,8,10,57,43,14,62
Stranraer,6264,5,15,5,16,55,65,-10,50
East Fife,6264,6,14,3,19,48,64,-16,45
Airdrieon,6264,7,11,11,14,48,58,-10,44
Forfar,6264,8,10,5,21,38,67,-29,35
Albion,6264,9,8,7,21,59,80,-21,31
Queen's Park,6264,10,6,10,20,40,74,-34,28
Raith,6265,1,23,8,5,69,32,37,77
Ayr,6265,2,23,5,8,91,43,48,74
Arbroath,6265,3,18,8,10,73,49,24,62
Alloa,6265,4,17,8,11,56,44,12,59
Stranraer,6265,5,15,5,16,56,68,-12,50
East Fife,6265,6,14,3,19,51,65,-14,45
Airdrieon,6265,7,10,11,15,45,59,-14,41
Forfar,6265,8,11,5,20,39,64,-25,38
Albion,6265,9,8,7,21,58,79,-21,31
Queen's Park,6265,10,6,10,20,40,75,-35,28
Raith,6266,1,23,8,5,70,33,37,77
Ayr,6266,2,24,4,8,92,42,50,76
Arbroath,6266,3,18,8,10,72,49,23,62
Alloa,6266,4,17,8,11,57,45,12,59
Stranraer,6266,5,15,5,16,55,66,-11,50
East Fife,6266,6,14,3,19,49,64,-15,45
Airdrieon,6266,7,10,12,14,46,59,-13,42
Forfar,6266,8,10,6,20,39,65,-26,36
Albion,6266,9,8,6,22,57,80,-23,30
Queen's Park,6266,10,6,10,20,40,74,-34,28
Ayr,6267,1,24,4,8,96,43,53,76
Raith,6267,2,22,9,5,69,33,36,75
Arbroath,6267,3,17,9,10,73,51,22,60
Alloa,6267,4,17,9,10,57,44,13,60
Stranraer,6267,5,16,5,15,59,65,-6,53
Airdrieon,6267,6,11,11,14,47,59,-12,44
East Fife,6267,7,13,3,20,48,68,-20,42
Forfar,6267,8,10,5,21,39,66,-27,35
Albion,6267,9,8,6,22,58,84,-26,30
Queen's Park,6267,10,6,11,19,42,75,-33,29
Raith,6268,1,23,8,5,71,34,37,77
Ayr,6268,2,24,4,8,92,43,49,76
Arbroath,6268,3,18,8,10,72,49,23,62
Alloa,6268,4,17,8,11,58,46,12,59
Stranraer,6268,5,15,6,15,55,64,-9,51
East Fife,6268,6,13,4,19,47,64,-17,43
Airdrieon,6268,7,10,12,14,46,59,-13,42
Forfar,6268,8,10,6,20,39,65,-26,36
Albion,6268,9,8,6,22,58,80,-22,30
Queen's Park,6268,10,6,10,20,40,74,-34,28
Raith,6269,1,23,8,5,72,34,38,77
Ayr,6269,2,24,4,8,94,42,52,76
Arbroath,6269,3,18,8,10,72,49,23,62
Alloa,6269,4,17,8,11,58,47,11,59
Stranraer,6269,5,15,5,16,57,67,-10,50
East Fife,6269,6,14,3,19,50,66,-16,45
Airdrieon,6269,7,11,11,14,47,58,-11,44
Forfar,6269,8,10,5,21,38,66,-28,35
Albion,6269,9,8,6,22,57,82,-25,30
Queen's Park,6269,10,6,10,20,40,74,-34,28
Raith,6270,1,23,8,5,70,33,37,77
Ayr,6270,2,24,4,8,92,42,50,76
Arbroath,6270,3,18,8,10,72,48,24,62
Alloa,6270,4,17,8,11,57,45,12,59
Stranraer,6270,5,15,5,16,55,66,-11,50
East Fife,6270,6,14,3,19,49,64,-15,45
Airdrieon,6270,7,10,11,15,45,59,-14,41
Forfar,6270,8,11,5,20,39,64,-25,38
Albion,6270,9,8,6,22,57,80,-23,30
Queen's Park,6270,10,6,10,20,39,74,-35,28
Raith,6271,1,23,8,5,69,32,37,77
Ayr,6271,2,23,4,9,93,46,47,73
Arbroath,6271,3,17,8,11,71,50,21,59
Alloa,6271,4,17,8,11,56,44,12,59
Stranraer,6271,5,15,6,15,56,65,-9,51
Airdrieon,6271,6,11,11,14,48,58,-10,44
East Fife,6271,7,13,4,19,48,65,-17,43
Forfar,6271,8,10,5,21,38,67,-29,35
Albion,6271,9,9,6,21,61,81,-20,33
Queen's Park,6271,10,7,10,19,41,73,-32,31
Raith,6272,1,23,8,5,71,33,38,77
Ayr,6272,2,24,4,8,93,43,50,76
Arbroath,6272,3,18,8,10,75,50,25,62
Alloa,6272,4,17,8,11,57,46,11,59
Stranraer,6272,5,15,5,16,56,66,-10,50
East Fife,6272,6,14,3,19,49,65,-16,45
Airdrieon,6272,7,11,11,14,47,59,-12,44
Forfar,6272,8,10,5,21,39,66,-27,35
Albion,6272,9,8,6,22,58,81,-23,30
Queen's Park,6272,10,6,10,20,41,77,-36,28
Raith,6273,1,23,8,5,71,34,37,77
Ayr,6273,2,24,4,8,93,42,51,76
Arbroath,6273,3,17,8,11,71,50,21,59
Alloa,6273,4,17,8,11,58,46,12,59
Stranraer,6273,5,16,5,15,58,66,-8,53
Airdrieon,6273,6,11,11,14,47,59,-12,44
East Fife,6273,7,13,3,20,49,67,-18,42
Forfar,6273,8,10,5,21,39,66,-27,35
Queen's Park,6273,9,7,10,19,41,73,-32,31
Albion,6273,10,8,6,22,57,81,-24,30
Ayr,6274,1,24,4,8,92,43,49,76
Raith,6274,2,22,9,5,70,34,36,75
Arbroath,6274,3,18,8,10,74,50,24,62
Alloa,6274,4,17,9,10,58,45,13,60
Stranraer,6274,5,15,6,15,55,64,-9,51
East Fife,6274,6,13,4,19,47,64,-17,43
Airdrieon,6274,7,10,11,15,45,60,-15,41
Forfar,6274,8,11,5,20,40,64,-24,38
Albion,6274,9,8,6,22,58,80,-22,30
Queen's Park,6274,10,6,10,20,41,76,-35,28
Ayr,6275,1,24,4,8,91,42,49,76
Raith,6275,2,22,8,6,68,33,35,74
Arbroath,6275,3,18,8,10,74,48,26,62
Alloa,6275,4,18,8,10,57,43,14,62
Stranraer,6275,5,16,5,15,57,65,-8,53
Airdrieon,6275,6,10,12,14,45,58,-13,42
East Fife,6275,7,13,3,20,48,66,-18,42
Forfar,6275,8,10,6,20,38,64,-26,36
Albion,6275,9,8,6,22,57,79,-22,30
Queen's Park,6275,10,6,10,20,39,76,-37,28
Raith,6276,1,23,8,5,70,33,37,77
Ayr,6276,2,24,4,8,95,44,51,76
Arbroath,6276,3,17,8,11,71,50,21,59
Alloa,6276,4,17,8,11,57,45,12,59
Stranraer,6276,5,15,6,15,55,64,-9,51
Airdrieon,6276,6,11,11,14,48,59,-11,44
East Fife,6276,7,13,4,19,47,64,-17,43
Forfar,6276,8,10,5,21,39,67,-28,35
Queen's Park,6276,9,7,10,19,41,73,-32,31
Albion,6276,10,8,6,22,59,83,-24,30
Raith,6277,1,23,8,5,72,32,40,77
Ayr,6277,2,24,4,8,94,42,52,76
Arbroath,6277,3,17,8,11,71,50,21,59
Alloa,6277,4,17,8,11,56,47,9,59
Stranraer,6277,5,15,6,15,56,65,-9,51
Airdrieon,6277,6,11,11,14,47,59,-12,44
East Fife,6277,7,13,4,19,48,65,-17,43
Forfar,6277,8,10,5,21,39,66,-27,35
Queen's Park,6277,9,7,10,19,41,73,-32,31
Albion,6277,10,8,6,22,57,82,-25,30
Raith,6278,1,23,8,5,69,32,37,77
Ayr,6278,2,24,4,8,95,43,52,76
Arbroath,6278,3,17,8,11,71,50,21,59
Alloa,6278,4,17,8,11,56,44,12,59
Stranraer,6278,5,16,5,15,56,64,-8,53
East Fife,6278,6,13,3,20,47,65,-18,42
Airdrieon,6278,7,10,11,15,46,61,-15,41
Forfar,6278,8,11,5,20,41,65,-24,38
Queen's Park,6278,9,7,10,19,41,73,-32,31
Albion,6278,10,8,6,22,58,83,-25,30
Ayr,6279,1,24,4,8,101,42,59,76
Raith,6279,2,22,9,5,68,32,36,75
Arbroath,6279,3,18,8,10,74,49,25,62
Alloa,6279,4,17,9,10,56,43,13,60
Stranraer,6279,5,15,5,16,55,65,-10,50
East Fife,6279,6,14,3,19,48,64,-16,45
Airdrieon,6279,7,10,12,14,46,59,-13,42
Forfar,6279,8,10,6,20,39,65,-26,36
Albion,6279,9,8,6,22,57,89,-32,30
Queen's Park,6279,10,6,10,20,40,76,-36,28
Raith,6280,1,23,8,5,69,32,37,77
Ayr,6280,2,23,4,9,92,45,47,73
Arbroath,6280,3,17,8,11,71,53,18,59
Alloa,6280,4,17,8,11,56,44,12,59
Stranraer,6280,5,15,5,16,56,66,-10,50
East Fife,6280,6,14,3,19,49,65,-16,45
Airdrieon,6280,7,10,12,14,46,59,-13,42
Forfar,6280,8,10,6,20,39,65,-26,36
Albion,6280,9,9,6,21,60,80,-20,33
Queen's Park,6280,10,7,10,19,44,73,-29,31
Raith,6281,1,23,8,5,70,32,38,77
Ayr,6281,2,24,4,8,93,42,51,76
Arbroath,6281,3,18,8,10,73,49,24,62
Alloa,6281,4,17,8,11,56,45,11,59
Stranraer,6281,5,15,6,15,55,64,-9,51
Airdrieon,6281,6,11,11,14,49,58,-9,44
East Fife,6281,7,13,4,19,47,64,-17,43
Forfar,6281,8,10,5,21,38,68,-30,35
Albion,6281,9,8,6,22,57,81,-24,30
Queen's Park,6281,10,6,10,20,40,75,-35,28
Ayr,6282,1,24,4,8,93,42,51,76
Raith,6282,2,22,9,5,69,33,36,75
Arbroath,6282,3,17,9,10,72,50,22,60
Alloa,6282,4,17,9,10,57,44,13,60
Stranraer,6282,5,15,5,16,55,70,-15,50
East Fife,6282,6,14,3,19,53,64,-11,45
Airdrieon,6282,7,10,12,14,46,59,-13,42
Forfar,6282,8,10,6,20,39,65,-26,36
Albion,6282,9,8,6,22,57,81,-24,30
Queen's Park,6282,10,6,11,19,41,74,-33,29
Raith,6283,1,23,8,5,72,32,40,77
Ayr,6283,2,24,4,8,95,43,52,76
Arbroath,6283,3,18,8,10,73,50,23,62
Alloa,6283,4,17,8,11,56,47,9,59
Stranraer,6283,5,15,5,16,56,67,-11,50
East Fife,6283,6,14,3,19,50,65,-15,45
Airdrieon,6283,7,11,11,14,47,59,-12,44
Forfar,6283,8,10,5,21,39,66,-27,35
Albion,6283,9,8,6,22,58,83,-25,30
Queen's Park,6283,10,6,10,20,41,75,-34,28
Ayr,6284,1,24,4,8,93,43,50,76
Raith,6284,2,22,9,5,69,33,36,75
Alloa,6284,3,17,9,10,57,44,13,60
Arbroath,6284,4,17,8,11,72,52,20,59
Stranraer,6284,5,16,5,15,58,66,-8,53
East Fife,6284,6,13,3,20,49,67,-18,42
Airdrieon,6284,7,10,11,15,47,61,-14,41
Forfar,6284,8,11,5,20,41,66,-25,38
Queen's Park,6284,9,7,10,19,43,74,-31,31
Albion,6284,10,8,6,22,58,81,-23,30
Ayr,6285,1,24,4,8,96,45,51,76
Raith,6285,2,22,8,6,68,33,35,74
Alloa,6285,3,18,8,10,57,43,14,62
Arbroath,6285,4,17,8,11,70,51,19,59
Stranraer,6285,5,15,6,15,57,66,-9,51
East Fife,6285,6,13,4,19,49,66,-17,43
Airdrieon,6285,7,10,11,15,45,59,-14,41
Forfar,6285,8,11,5,20,39,64,-25,38
Queen's Park,6285,9,7,10,19,42,72,-30,31
Albion,6285,10,8,6,22,60,84,-24,30
Raith,6286,1,23,8,5,72,33,39,77
Ayr,6286,2,23,4,9,90,45,45,73
Arbroath,6286,3,17,9,10,71,49,22,60
Alloa,6286,4,17,8,11,57,47,10,59
Stranraer,6286,5,15,5,16,55,66,-11,50
East Fife,6286,6,14,3,19,49,64,-15,45
Airdrieon,6286,7,10,12,14,45,58,-13,42
Forfar,6286,8,10,6,20,38,64,-26,36
Albion,6286,9,9,6,21,60,78,-18,33
Queen's Park,6286,10,6,11,19,40,73,-33,29
Raith,6287,1,23,8,5,71,34,37,77
Ayr,6287,2,24,4,8,93,43,50,76
Arbroath,6287,3,17,8,11,70,50,20,59
Alloa,6287,4,17,8,11,58,46,12,59
Stranraer,6287,5,16,5,15,57,64,-7,53
Airdrieon,6287,6,11,11,14,48,58,-10,44
East Fife,6287,7,13,3,20,47,66,-19,42
Forfar,6287,8,10,5,21,38,67,-29,35
Queen's Park,6287,9,7,10,19,41,72,-31,31
Albion,6287,10,8,6,22,58,81,-23,30
Raith,6288,1,22,9,5,70,34,36,75
Ayr,6288,2,23,5,8,92,44,48,74
Arbroath,6288,3,17,9,10,71,49,22,60
Alloa,6288,4,17,9,10,58,45,13,60
Stranraer,6288,5,15,6,15,55,64,-9,51
Airdrieon,6288,6,11,11,14,46,58,-12,44
East Fife,6288,7,13,4,19,47,64,-17,43
Forfar,6288,8,10,5,21,38,65,-27,35
Albion,6288,9,8,7,21,59,80,-21,31
Queen's Park,6288,10,6,11,19,40,73,-33,29
Ayr,6289,1,24,4,8,95,42,53,76
Raith,6289,2,22,8,6,69,34,35,74
Arbroath,6289,3,18,8,10,73,48,25,62
Alloa,6289,4,18,8,10,58,44,14,62
Stranraer,6289,5,16,5,15,57,65,-8,53
Airdrieon,6289,6,11,11,14,46,58,-12,44
East Fife,6289,7,13,3,20,48,66,-18,42
Forfar,6289,8,10,5,21,38,65,-27,35
Albion,6289,9,8,6,22,57,83,-26,30
Queen's Park,6289,10,6,10,20,39,75,-36,28
Raith,6290,1,23,8,5,71,32,39,77
Ayr,6290,2,24,4,8,94,44,50,76
Arbroath,6290,3,18,8,10,71,48,23,62
Alloa,6290,4,17,8,11,56,46,10,59
Stranraer,6290,5,15,6,15,57,66,-9,51
East Fife,6290,6,13,4,19,49,66,-17,43
Airdrieon,6290,7,10,12,14,45,58,-13,42
Forfar,6290,8,10,6,20,38,64,-26,36
Albion,6290,9,8,6,22,59,82,-23,30
Queen's Park,6290,10,6,10,20,39,73,-34,28
Ayr,6291,1,24,4,8,95,45,50,76
Raith,6291,2,22,9,5,68,32,36,75
Arbroath,6291,3,18,8,10,72,48,24,62
Alloa,6291,4,17,9,10,56,43,13,60
Stranraer,6291,5,15,5,16,56,69,-13,50
East Fife,6291,6,14,3,19,52,65,-13,45
Airdrieon,6291,7,10,12,14,47,60,-13,42
Forfar,6291,8,10,6,20,40,66,-26,36
Albion,6291,9,8,6,22,60,83,-23,30
Queen's Park,6291,10,6,10,20,39,74,-35,28
Ayr,6292,1,24,4,8,93,43,50,76
Raith,6292,2,22,8,6,68,33,35,74
Arbroath,6292,3,18,8,10,73,48,25,62
Alloa,6292,4,18,8,10,57,43,14,62
Stranraer,6292,5,15,5,16,57,67,-10,50
East Fife,6292,6,14,3,19,50,66,-16,45
Airdrieon,6292,7,10,11,15,45,59,-14,41
Forfar,6292,8,11,5,20,39,64,-25,38
Albion,6292,9,8,6,22,58,81,-23,30
Queen's Park,6292,10,6,10,20,39,75,-36,28
Raith,6293,1,23,8,5,71,33,38,77
Ayr,6293,2,24,4,8,95,43,52,76
Arbroath,6293,3,17,8,11,72,52,20,59
Alloa,6293,4,17,8,11,57,46,11,59
Stranraer,6293,5,15,5,16,56,67,-11,50
East Fife,6293,6,14,3,19,50,65,-15,45
Airdrieon,6293,7,11,11,14,48,58,-10,44
Forfar,6293,8,10,5,21,38,67,-29,35
Queen's Park,6293,9,7,10,19,43,74,-31,31
Albion,6293,10,8,6,22,58,83,-25,30
Ayr,6294,1,24,4,8,94,44,50,76
Raith,6294,2,22,8,6,68,33,35,74
Alloa,6294,3,18,8,10,57,43,14,62
Arbroath,6294,4,17,8,11,71,51,20,59
Stranraer,6294,5,15,6,15,55,64,-9,51
Airdrieon,6294,6,11,11,14,47,59,-12,44
East Fife,6294,7,13,4,19,47,64,-17,43
Forfar,6294,8,10,5,21,39,66,-27,35
Queen's Park,6294,9,7,10,19,42,73,-31,31
Albion,6294,10,8,6,22,59,82,-23,30
Raith,6295,1,23,8,5,71,32,39,77
Ayr,6295,2,24,4,8,97,42,55,76
Arbroath,6295,3,18,8,10,72,49,23,62
Alloa,6295,4,17,8,11,56,46,10,59
Stranraer,6295,5,15,6,15,56,65,-9,51
Airdrieon,6295,6,11,11,14,46,58,-12,44
East Fife,6295,7,13,4,19,48,65,-17,43
Forfar,6295,8,10,5,21,38,65,-27,35
Albion,6295,9,8,6,22,57,85,-28,30
Queen's Park,6295,10,6,10,20,40,74,-34,28
Raith,6296,1,23,8,5,70,33,37,77
Ayr,6296,2,24,4,8,92,43,49,76
Arbroath,6296,3,17,8,11,70,51,19,59
Alloa,6296,4,17,8,11,57,45,12,59
Stranraer,6296,5,15,6,15,57,66,-9,51
East Fife,6296,6,13,4,19,49,66,-17,43
Airdrieon,6296,7,10,12,14,47,60,-13,42
Forfar,6296,8,10,6,20,40,66,-26,36
Queen's Park,6296,9,7,10,19,42,72,-30,31
Albion,6296,10,8,6,22,58,80,-22,30
Ayr,6297,1,24,4,8,95,43,52,76
Raith,6297,2,22,8,6,69,35,34,74
Arbroath,6297,3,18,8,10,73,49,24,62
Alloa,6297,4,18,8,10,59,44,15,62
Stranraer,6297,5,16,5,15,62,68,-6,53
Airdrieon,6297,6,11,11,14,49,59,-10,44
East Fife,6297,7,13,3,20,51,71,-20,42
Forfar,6297,8,10,5,21,39,68,-29,35
Albion,6297,9,8,6,22,58,83,-25,30
Queen's Park,6297,10,6,10,20,40,75,-35,28
Ayr,6298,1,24,4,8,97,45,52,76
Raith,6298,2,22,9,5,69,33,36,75
Arbroath,6298,3,18,8,10,72,48,24,62
Alloa,6298,4,17,9,10,57,44,13,60
Stranraer,6298,5,15,5,16,56,69,-13,50
East Fife,6298,6,14,3,19,52,65,-13,45
Airdrieon,6298,7,10,11,15,46,60,-14,41
Forfar,6298,8,11,5,20,40,65,-25,38
Albion,6298,9,8,6,22,60,85,-25,30
Queen's Park,6298,10,6,10,20,39,74,-35,28
Ayr,6299,1,23,5,8,92,44,48,74
Raith,6299,2,22,8,6,68,34,34,74
Arbroath,6299,3,18,8,10,74,48,26,62
Alloa,6299,4,18,8,10,58,43,15,62
Stranraer,6299,5,15,5,16,56,66,-10,50
East Fife,6299,6,14,3,19,49,65,-16,45
Airdrieon,6299,7,10,12,14,47,60,-13,42
Forfar,6299,8,10,6,20,40,66,-26,36
Albion,6299,9,8,7,21,59,80,-21,31
Queen's Park,6299,10,6,10,20,39,76,-37,28
Raith,6300,1,23,8,5,69,32,37,77
Ayr,6300,2,24,4,8,94,43,51,76
Arbroath,6300,3,18,8,10,71,48,23,62
Alloa,6300,4,17,8,11,56,44,12,59
Stranraer,6300,5,16,5,15,57,65,-8,53
Airdrieon,6300,6,10,12,14,45,58,-13,42
East Fife,6300,7,13,3,20,48,66,-18,42
Forfar,6300,8,10,6,20,38,64,-26,36
Albion,6300,9,8,6,22,58,82,-24,30
Queen's Park,6300,10,6,10,20,39,73,-34,28
Raith,6301,1,23,8,5,71,32,39,77
Ayr,6301,2,24,4,8,99,42,57,76
Arbroath,6301,3,18,8,10,72,49,23,62
Alloa,6301,4,17,8,11,56,46,10,59
Stranraer,6301,5,15,5,16,56,67,-11,50
East Fife,6301,6,14,3,19,50,65,-15,45
Airdrieon,6301,7,10,11,15,46,60,-14,41
Forfar,6301,8,11,5,20,40,65,-25,38
Albion,6301,9,8,6,22,57,87,-30,30
Queen's Park,6301,10,6,10,20,40,74,-34,28
Raith,6302,1,23,8,5,71,33,38,77
Ayr,6302,2,24,4,8,94,43,51,76
Arbroath,6302,3,18,8,10,73,50,23,62
Alloa,6302,4,17,8,11,57,46,11,59
Stranraer,6302,5,15,5,16,56,66,-10,50
East Fife,6302,6,14,3,19,49,65,-16,45
Airdrieon,6302,7,10,11,15,45,59,-14,41
Forfar,6302,8,11,5,20,39,64,-25,38
Albion,6302,9,8,6,22,58,82,-24,30
Queen's Park,6302,10,6,10,20,41,75,-34,28
Raith,6303,1,22,8,6,68,33,35,74
Ayr,6303,2,23,4,9,90,43,47,73
Arbroath,6303,3,18,8,10,71,48,23,62
Alloa,6303,4,18,8,10,57,43,14,62
Stranraer,6303,5,15,6,15,56,65,-9,51
East Fife,6303,6,13,4,19,48,65,-17,43
Airdrieon,6303,7,10,11,15,46,60,-14,41
Forfar,6303,8,11,5,20,40,65,-25,38
Albion,6303,9,9,6,21,58,78,-20,33
Queen's Park,6303,10,6,10,20,39,73,-34,28
Raith,6304,1,23,8,5,71,32,39,77
Ayr,6304,2,24,4,8,92,43,49,76
Arbroath,6304,3,18,8,10,74,50,24,62
Alloa,6304,4,17,8,11,56,46,10,59
Stranraer,6304,5,15,6,15,57,66,-9,51
Airdrieon,6304,6,11,11,14,47,58,-11,44
East Fife,6304,7,13,4,19,49,66,-17,43
Forfar,6304,8,10,5,21,38,66,-28,35
Albion,6304,9,8,6,22,58,80,-22,30
Queen's Park,6304,10,6,10,20,41,76,-35,28
Ayr,6305,1,24,4,8,95,43,52,76
Raith,6305,2,22,8,6,69,34,35,74
Arbroath,6305,3,18,8,10,72,49,23,62
Alloa,6305,4,18,8,10,58,44,14,62
Stranraer,6305,5,15,5,16,55,65,-10,50
East Fife,6305,6,14,3,19,48,64,-16,45
Airdrieon,6305,7,11,11,14,46,58,-12,44
Forfar,6305,8,10,5,21,38,65,-27,35
Albion,6305,9,8,6,22,58,83,-25,30
Queen's Park,6305,10,6,10,20,40,74,-34,28
Ayr,6306,1,24,4,8,93,44,49,76
Raith,6306,2,22,9,5,70,34,36,75
Arbroath,6306,3,17,9,10,70,48,22,60
Alloa,6306,4,17,9,10,58,45,13,60
Stranraer,6306,5,15,5,16,56,66,-10,50
East Fife,6306,6,14,3,19,49,65,-16,45
Airdrieon,6306,7,10,12,14,47,60,-13,42
Forfar,6306,8,10,6,20,40,66,-26,36
Albion,6306,9,8,6,22,59,81,-22,30
Queen's Park,6306,10,6,11,19,39,72,-33,29
Ayr,6307,1,24,4,8,95,44,51,76
Raith,6307,2,22,9,5,68,32,36,75
Arbroath,6307,3,18,8,10,72,49,23,62
Alloa,6307,4,17,9,10,56,43,13,60
Stranraer,6307,5,15,5,16,56,68,-12,50
East Fife,6307,6,14,3,19,51,65,-14,45
Airdrieon,6307,7,10,11,15,46,60,-14,41
Forfar,6307,8,11,5,20,40,65,-25,38
Albion,6307,9,8,6,22,59,83,-24,30
Queen's Park,6307,10,6,10,20,40,74,-34,28
Raith,6308,1,23,8,5,69,32,37,77
Ayr,6308,2,24,4,8,92,42,50,76
Arbroath,6308,3,17,8,11,71,52,19,59
Alloa,6308,4,17,8,11,56,44,12,59
Stranraer,6308,5,16,5,15,59,64,-5,53
Airdrieon,6308,6,10,12,14,47,60,-13,42
East Fife,6308,7,13,3,20,47,68,-21,42
Forfar,6308,8,10,6,20,40,66,-26,36
Queen's Park,6308,9,7,10,19,43,73,-30,31
Albion,6308,10,8,6,22,57,80,-23,30
Ayr,6309,1,24,4,8,94,43,51,76
Raith,6309,2,22,9,5,72,36,36,75
Arbroath,6309,3,18,8,10,72,48,24,62
Alloa,6309,4,17,9,10,60,47,13,60
Stranraer,6309,5,15,6,15,55,64,-9,51
East Fife,6309,6,13,4,19,47,64,-17,43
Airdrieon,6309,7,10,12,14,46,59,-13,42
Forfar,6309,8,10,6,20,39,65,-26,36
Albion,6309,9,8,6,22,58,82,-24,30
Queen's Park,6309,10,6,10,20,39,74,-35,28
Raith,6310,1,23,8,5,70,33,37,77
Ayr,6310,2,24,4,8,95,42,53,76
Arbroath,6310,3,18,8,10,76,49,27,62
Alloa,6310,4,17,8,11,57,45,12,59
Stranraer,6310,5,16,5,15,58,64,-6,53
Airdrieon,6310,6,11,11,14,47,58,-11,44
East Fife,6310,7,13,3,20,47,67,-20,42
Forfar,6310,8,10,5,21,38,66,-28,35
Albion,6310,9,8,6,22,57,83,-26,30
Queen's Park,6310,10,6,10,20,40,78,-38,28
Raith,6311,1,23,8,5,71,32,39,77
Ayr,6311,2,24,4,8,93,43,50,76
Arbroath,6311,3,17,8,11,72,51,21,59
Alloa,6311,4,17,8,11,56,46,10,59
Stranraer,6311,5,15,5,16,56,67,-11,50
East Fife,6311,6,14,3,19,50,65,-15,45
Airdrieon,6311,7,11,11,14,48,60,-12,44
Forfar,6311,8,10,5,21,40,67,-27,35
Queen's Park,6311,9,7,10,19,42,74,-32,31
Albion,6311,10,8,6,22,58,81,-23,30
Raith,6312,1,23,8,5,70,32,38,77
Ayr,6312,2,24,4,8,92,43,49,76
Arbroath,6312,3,17,8,11,73,53,20,59
Alloa,6312,4,17,8,11,56,45,11,59
Stranraer,6312,5,16,5,15,57,64,-7,53
Airdrieon,6312,6,10,12,14,47,60,-13,42
East Fife,6312,7,13,3,20,47,66,-19,42
Forfar,6312,8,10,6,20,40,66,-26,36
Queen's Park,6312,9,7,10,19,44,75,-31,31
Albion,6312,10,8,6,22,58,80,-22,30
Raith,6313,1,23,8,5,69,32,37,77
Ayr,6313,2,24,4,8,94,44,50,76
Arbroath,6313,3,18,8,10,72,49,23,62
Alloa,6313,4,17,8,11,56,44,12,59
Stranraer,6313,5,15,5,16,56,67,-11,50
East Fife,6313,6,14,3,19,50,65,-15,45
Airdrieon,6313,7,11,11,14,47,59,-12,44
Forfar,6313,8,10,5,21,39,66,-27,35
Albion,6313,9,8,6,22,59,82,-23,30
Queen's Park,6313,10,6,10,20,40,74,-34,28
Ayr,6314,1,24,4,8,94,42,52,76
Raith,6314,2,22,8,6,68,33,35,74
Alloa,6314,3,18,8,10,57,43,14,62
Arbroath,6314,4,17,8,11,70,49,21,59
Stranraer,6314,5,16,5,15,56,64,-8,53
East Fife,6314,6,13,3,20,47,65,-18,42
Airdrieon,6314,7,10,11,15,47,61,-14,41
Forfar,6314,8,11,5,20,41,66,-25,38
Queen's Park,6314,9,7,10,19,40,72,-32,31
Albion,6314,10,8,6,22,57,82,-25,30
Ayr,6315,1,24,4,8,92,43,49,76
Raith,6315,2,22,9,5,69,33,36,75
Arbroath,6315,3,18,8,10,72,48,24,62
Alloa,6315,4,17,9,10,57,44,13,60
Stranraer,6315,5,16,5,15,57,64,-7,53
Airdrieon,6315,6,10,12,14,46,59,-13,42
East Fife,6315,7,13,3,20,47,66,-19,42
Forfar,6315,8,10,6,20,39,65,-26,36
Albion,6315,9,8,6,22,58,80,-22,30
Queen's Park,6315,10,6,10,20,39,74,-35,28
Ayr,6316,1,24,4,8,93,42,51,76
Raith,6316,2,22,9,5,69,33,36,75
Arbroath,6316,3,18,8,10,74,48,26,62
Alloa,6316,4,17,9,10,57,44,13,60
Stranraer,6316,5,15,6,15,58,67,-9,51
Airdrieon,6316,6,11,11,14,47,58,-11,44
East Fife,6316,7,13,4,19,50,67,-17,43
Forfar,6316,8,10,5,21,38,66,-28,35
Albion,6316,9,8,6,22,57,81,-24,30
Queen's Park,6316,10,6,10,20,39,76,-37,28
Raith,6317,1,23,8,5,71,32,39,77
Ayr,6317,2,23,5,8,92,44,48,74
Arbroath,6317,3,17,9,10,72,50,22,60
Alloa,6317,4,17,8,11,56,46,10,59
Stranraer,6317,5,15,5,16,55,65,-10,50
East Fife,6317,6,14,3,19,48,64,-16,45
Airdrieon,6317,7,11,11,14,48,58,-10,44
Forfar,6317,8,10,5,21,38,67,-29,35
Albion,6317,9,8,7,21,59,80,-21,31
Queen's Park,6317,10,6,11,19,41,74,-33,29
Ayr,6318,1,24,4,8,97,43,54,76
Raith,6318,2,22,9,5,70,34,36,75
Alloa,6318,3,17,9,10,58,45,13,60
Arbroath,6318,4,17,8,11,72,51,21,59
Stranraer,6318,5,15,6,15,56,65,-9,51
East Fife,6318,6,13,4,19,48,65,-17,43
Airdrieon,6318,7,10,11,15,45,59,-14,41
Forfar,6318,8,11,5,20,39,64,-25,38
Queen's Park,6318,9,7,10,19,42,74,-32,31
Albion,6318,10,8,6,22,58,85,-27,30
Raith,6319,1,23,8,5,72,35,37,77
Ayr,6319,2,24,4,8,97,45,52,76
Arbroath,6319,3,17,8,11,71,50,21,59
Alloa,6319,4,17,8,11,59,47,12,59
Stranraer,6319,5,16,5,15,58,66,-8,53
Airdrieon,6319,6,10,12,14,45,58,-13,42
East Fife,6319,7,13,3,20,49,67,-18,42
Forfar,6319,8,10,6,20,38,64,-26,36
Queen's Park,6319,9,7,10,19,41,73,-32,31
Albion,6319,10,8,6,22,60,85,-25,30
Raith,6320,1,23,8,5,71,32,39,77
Ayr,6320,2,24,4,8,95,42,53,76
Arbroath,6320,3,17,9,10,71,49,22,60
Alloa,6320,4,17,8,11,56,46,10,59
Stranraer,6320,5,16,5,15,58,65,-7,53
Airdrieon,6320,6,11,11,14,47,59,-12,44
East Fife,6320,7,13,3,20,48,67,-19,42
Forfar,6320,8,10,5,21,39,66,-27,35
Albion,6320,9,8,6,22,57,83,-26,30
Queen's Park,6320,10,6,11,19,40,73,-33,29
Raith,6321,1,23,8,5,70,32,38,77
Ayr,6321,2,24,4,8,95,43,52,76
Arbroath,6321,3,18,8,10,71,48,23,62
Alloa,6321,4,17,8,11,56,45,11,59
Stranraer,6321,5,15,5,16,56,67,-11,50
East Fife,6321,6,14,3,19,50,65,-15,45
Airdrieon,6321,7,11,11,14,47,59,-12,44
Forfar,6321,8,10,5,21,39,66,-27,35
Albion,6321,9,8,6,22,58,83,-25,30
Queen's Park,6321,10,6,10,20,39,73,-34,28
Raith,6322,1,23,8,5,70,32,38,77
Ayr,6322,2,24,4,8,94,43,51,76
Arbroath,6322,3,17,9,10,70,48,22,60
Alloa,6322,4,17,8,11,56,45,11,59
Stranraer,6322,5,16,5,15,58,65,-7,53
Airdrieon,6322,6,11,11,14,47,58,-11,44
East Fife,6322,7,13,3,20,48,67,-19,42
Forfar,6322,8,10,5,21,38,66,-28,35
Albion,6322,9,8,6,22,58,82,-24,30
Queen's Park,6322,10,6,11,19,39,72,-33,29
Raith,6323,1,23,8,5,73,33,40,77
Ayr,6323,2,24,4,8,94,43,51,76
Arbroath,6323,3,17,8,11,70,50,20,59
Alloa,6323,4,17,8,11,57,48,9,59
Stranraer,6323,5,15,5,16,55,66,-11,50
East Fife,6323,6,14,3,19,49,64,-15,45
Airdrieon,6323,7,10,12,14,45,58,-13,42
Forfar,6323,8,10,6,20,38,64,-26,36
Queen's Park,6323,9,7,10,19,41,72,-31,31
Albion,6323,10,8,6,22,58,82,-24,30
Ayr,6324,1,24,4,8,93,43,50,76
Raith,6324,2,22,9,5,68,32,36,75
Arbroath,6324,3,18,8,10,73,48,25,62
Alloa,6324,4,17,9,10,56,43,13,60
Stranraer,6324,5,15,5,16,56,67,-11,50
East Fife,6324,6,14,3,19,50,65,-15,45
Airdrieon,6324,7,11,11,14,47,59,-12,44
Forfar,6324,8,10,5,21,39,66,-27,35
Albion,6324,9,8,6,22,58,81,-23,30
Queen's Park,6324,10,6,10,20,39,75,-36,28
Ayr,6325,1,24,4,8,92,42,50,76
Raith,6325,2,22,8,6,68,33,35,74
Alloa,6325,3,18,8,10,57,43,14,62
Arbroath,6325,4,17,9,10,72,50,22,60
Stranraer,6325,5,15,5,16,56,67,-11,50
East Fife,6325,6,14,3,19,50,65,-15,45
Airdrieon,6325,7,11,11,14,47,58,-11,44
Forfar,6325,8,10,5,21,38,66,-28,35
Albion,6325,9,8,6,22,57,80,-23,30
Queen's Park,6325,10,6,11,19,41,74,-33,29
Raith,6326,1,23,8,5,70,33,37,77
Ayr,6326,2,24,4,8,95,42,53,76
Arbroath,6326,3,17,9,10,70,48,22,60
Alloa,6326,4,17,8,11,57,45,12,59
Stranraer,6326,5,16,5,15,57,65,-8,53
Airdrieon,6326,6,11,11,14,46,58,-12,44
East Fife,6326,7,13,3,20,48,66,-18,42
Forfar,6326,8,10,5,21,38,65,-27,35
Albion,6326,9,8,6,22,57,83,-26,30
Queen's Park,6326,10,6,11,19,39,72,-33,29
Ayr,6327,1,24,4,8,93,44,49,76
Raith,6327,2,22,8,6,68,33,35,74
Arbroath,6327,3,18,8,10,73,49,24,62
Alloa,6327,4,18,8,10,57,43,14,62
Stranraer,6327,5,15,5,16,56,67,-11,50
East Fife,6327,6,14,3,19,50,65,-15,45
Airdrieon,6327,7,10,11,15,45,60,-15,41
Forfar,6327,8,11,5,20,40,64,-24,38
Albion,6327,9,8,6,22,59,81,-22,30
Queen's Park,6327,10,6,10,20,40,75,-35,28
Raith,6328,1,23,8,5,70,32,38,77
Ayr,6328,2,24,4,8,93,42,51,76
Arbroath,6328,3,18,8,10,72,49,23,62
Alloa,6328,4,17,8,11,56,45,11,59
Stranraer,6328,5,15,6,15,56,65,-9,51
East Fife,6328,6,13,4,19,48,65,-17,43
Airdrieon,6328,7,10,12,14,47,60,-13,42
Forfar,6328,8,10,6,20,40,66,-26,36
Albion,6328,9,8,6,22,57,81,-24,30
Queen's Park,6328,10,6,10,20,40,74,-34,28
Raith,6329,1,23,8,5,71,33,38,77
Ayr,6329,2,23,4,9,90,44,46,73
Arbroath,6329,3,17,8,11,71,51,20,59
Alloa,6329,4,17,8,11,57,46,11,59
Stranraer,6329,5,15,6,15,56,65,-9,51
Airdrieon,6329,6,11,11,14,48,59,-11,44
East Fife,6329,7,13,4,19,48,65,-17,43
Forfar,6329,8,10,5,21,39,67,-28,35
Albion,6329,9,9,6,21,59,78,-19,33
Queen's Park,6329,10,7,10,19,42,73,-31,31
Raith,6330,1,23,8,5,70,33,37,77
Ayr,6330,2,24,4,8,91,42,49,76
Arbroath,6330,3,17,9,10,71,49,22,60
Alloa,6330,4,17,8,11,57,45,12,59
Stranraer,6330,5,15,5,16,55,65,-10,50
East Fife,6330,6,14,3,19,48,64,-16,45
Airdrieon,6330,7,11,11,14,46,58,-12,44
Forfar,6330,8,10,5,21,38,65,-27,35
Albion,6330,9,8,6,22,57,79,-22,30
Queen's Park,6330,10,6,11,19,40,73,-33,29
Raith,6331,1,23,8,5,70,33,37,77
Ayr,6331,2,24,4,8,93,43,50,76
Arbroath,6331,3,18,8,10,73,50,23,62
Alloa,6331,4,17,8,11,57,45,12,59
Stranraer,6331,5,16,5,15,57,65,-8,53
Airdrieon,6331,6,11,11,14,46,58,-12,44
East Fife,6331,7,13,3,20,48,66,-18,42
Forfar,6331,8,10,5,21,38,65,-27,35
Albion,6331,9,8,6,22,58,81,-23,30
Queen's Park,6331,10,6,10,20,41,75,-34,28
Ayr,6332,1,24,4,8,95,43,52,76
Raith,6332,2,22,8,6,69,34,35,74
Alloa,6332,3,18,8,10,58,44,14,62
Arbroath,6332,4,17,8,11,71,50,21,59
Stranraer,6332,5,15,5,16,56,67,-11,50
East Fife,6332,6,14,3,19,50,65,-15,45
Airdrieon,6332,7,11,11,14,48,58,-10,44
Forfar,6332,8,10,5,21,38,67,-29,35
Queen's Park,6332,9,7,10,19,41,73,-32,31
Albion,6332,10,8,6,22,58,83,-25,30
Raith,6333,1,23,8,5,70,32,38,77
Ayr,6333,2,23,4,9,90,43,47,73
Arbroath,6333,3,18,8,10,72,48,24,62
Alloa,6333,4,17,8,11,56,45,11,59
Stranraer,6333,5,16,5,15,58,66,-8,53
Airdrieon,6333,6,11,11,14,48,59,-11,44
East Fife,6333,7,13,3,20,49,67,-18,42
Forfar,6333,8,10,5,21,39,67,-28,35
Albion,6333,9,9,6,21,58,78,-20,33
Queen's Park,6333,10,6,10,20,39,74,-35,28
Raith,6334,1,23,8,5,73,32,41,77
Ayr,6334,2,24,4,8,91,42,49,76
Arbroath,6334,3,18,8,10,73,49,24,62
Alloa,6334,4,17,8,11,56,48,8,59
Stranraer,6334,5,15,5,16,55,65,-10,50
East Fife,6334,6,14,3,19,48,64,-16,45
Airdrieon,6334,7,11,11,14,48,60,-12,44
Forfar,6334,8,10,5,21,40,67,-27,35
Albion,6334,9,8,6,22,57,79,-22,30
Queen's Park,6334,10,6,10,20,40,75,-35,28
Raith,6335,1,22,9,5,71,35,36,75
Ayr,6335,2,23,5,8,93,45,48,74
Arbroath,6335,3,17,9,10,71,49,22,60
Alloa,6335,4,17,9,10,59,46,13,60
Stranraer,6335,5,15,5,16,56,67,-11,50
East Fife,6335,6,14,3,19,50,65,-15,45
Airdrieon,6335,7,10,12,14,47,60,-13,42
Forfar,6335,8,10,6,20,40,66,-26,36
Albion,6335,9,8,7,21,60,81,-21,31
Queen's Park,6335,10,6,11,19,40,73,-33,29
Ayr,6336,1,24,4,8,97,43,54,76
Raith,6336,2,22,8,6,69,34,35,74
Arbroath,6336,3,18,8,10,72,49,23,62
Alloa,6336,4,18,8,10,58,44,14,62
Stranraer,6336,5,16,5,15,59,67,-8,53
Airdrieon,6336,6,10,12,14,47,60,-13,42
East Fife,6336,7,13,3,20,50,68,-18,42
Forfar,6336,8,10,6,20,40,66,-26,36
Albion,6336,9,8,6,22,58,85,-27,30
Queen's Park,6336,10,6,10,20,40,74,-34,28
Raith,6337,1,23,8,5,70,32,38,77
Ayr,6337,2,24,4,8,96,43,53,76
Arbroath,6337,3,17,9,10,71,49,22,60
Alloa,6337,4,17,8,11,56,45,11,59
Stranraer,6337,5,15,5,16,55,66,-11,50
East Fife,6337,6,14,3,19,49,64,-15,45
Airdrieon,6337,7,10,11,15,45,61,-16,41
Forfar,6337,8,11,5,20,41,64,-23,38
Albion,6337,9,8,6,22,58,84,-26,30
Queen's Park,6337,10,6,11,19,40,73,-33,29
Raith,6338,1,23,8,5,72,32,40,77
Ayr,6338,2,24,4,8,92,42,50,76
Arbroath,6338,3,17,9,10,71,49,22,60
Alloa,6338,4,17,8,11,56,47,9,59
Stranraer,6338,5,15,5,16,58,69,-11,50
East Fife,6338,6,14,3,19,52,67,-15,45
Airdrieon,6338,7,11,11,14,46,58,-12,44
Forfar,6338,8,10,5,21,38,65,-27,35
Albion,6338,9,8,6,22,57,80,-23,30
Queen's Park,6338,10,6,11,19,40,73,-33,29
Raith,6339,1,23,8,5,69,32,37,77
Ayr,6339,2,24,4,8,94,42,52,76
Arbroath,6339,3,18,8,10,74,49,25,62
Alloa,6339,4,17,8,11,56,44,12,59
Stranraer,6339,5,15,5,16,55,65,-10,50
East Fife,6339,6,14,3,19,48,64,-16,45
Airdrieon,6339,7,11,11,14,47,58,-11,44
Forfar,6339,8,10,5,21,38,66,-28,35
Albion,6339,9,8,6,22,57,82,-25,30
Queen's Park,6339,10,6,10,20,40,76,-36,28
Raith,6340,1,23,8,5,69,32,37,77
Ayr,6340,2,23,4,9,91,44,47,73
Arbroath,6340,3,17,8,11,70,51,19,59
Alloa,6340,4,17,8,11,56,44,12,59
Stranraer,6340,5,15,6,15,58,67,-9,51
Airdrieon,6340,6,11,11,14,47,59,-12,44
East Fife,6340,7,13,4,19,50,67,-17,43
Forfar,6340,8,10,5,21,39,66,-27,35
Albion,6340,9,9,6,21,59,79,-20,33
Queen's Park,6340,10,7,10,19,42,72,-30,31
Raith,6341,1,23,8,5,73,35,38,77
Ayr,6341,2,24,4,8,92,42,50,76
Arbroath,6341,3,18,8,10,74,49,25,62
Alloa,6341,4,17,8,11,59,48,11,59
Stranraer,6341,5,15,5,16,55,68,-13,50
East Fife,6341,6,14,3,19,51,64,-13,45
Airdrieon,6341,7,11,11,14,47,59,-12,44
Forfar,6341,8,10,5,21,39,66,-27,35
Albion,6341,9,8,6,22,57,80,-23,30
Queen's Park,6341,10,6,10,20,40,76,-36,28
Ayr,6342,1,24,4,8,97,44,53,76
Raith,6342,2,22,9,5,68,32,36,75
Arbroath,6342,3,18,8,10,78,50,28,62
Alloa,6342,4,17,9,10,56,43,13,60
Stranraer,6342,5,15,5,16,57,68,-11,50
East Fife,6342,6,14,3,19,51,66,-15,45
Airdrieon,6342,7,11,11,14,47,58,-11,44
Forfar,6342,8,10,5,21,38,66,-28,35
Albion,6342,9,8,6,22,59,85,-26,30
Queen's Park,6342,10,6,10,20,41,80,-39,28
Ayr,6343,1,24,4,8,97,43,54,76
Raith,6343,2,22,9,5,69,33,36,75
Alloa,6343,3,17,9,10,57,44,13,60
Arbroath,6343,4,17,8,11,73,52,21,59
Stranraer,6343,5,15,6,15,55,64,-9,51
Airdrieon,6343,6,11,11,14,48,60,-12,44
East Fife,6343,7,13,4,19,47,64,-17,43
Forfar,6343,8,10,5,21,40,67,-27,35
Queen's Park,6343,9,7,10,19,43,75,-32,31
Albion,6343,10,8,6,22,58,85,-27,30
Ayr,6344,1,24,4,8,96,43,53,76
Raith,6344,2,22,8,6,68,33,35,74
Arbroath,6344,3,18,8,10,76,51,25,62
Alloa,6344,4,18,8,10,57,43,14,62
Stranraer,6344,5,16,5,15,58,64,-6,53
Airdrieon,6344,6,10,12,14,45,58,-13,42
East Fife,6344,7,13,3,20,47,67,-20,42
Forfar,6344,8,10,6,20,38,64,-26,36
Albion,6344,9,8,6,22,58,84,-26,30
Queen's Park,6344,10,6,10,20,42,78,-36,28
Raith,6345,1,23,8,5,69,32,37,77
Ayr,6345,2,24,4,8,94,43,51,76
Arbroath,6345,3,17,8,11,72,51,21,59
Alloa,6345,4,17,8,11,56,44,12,59
Stranraer,6345,5,15,6,15,57,66,-9,51
East Fife,6345,6,13,4,19,49,66,-17,43
Airdrieon,6345,7,10,11,15,45,59,-14,41
Forfar,6345,8,11,5,20,39,64,-25,38
Queen's Park,6345,9,7,10,19,42,74,-32,31
Albion,6345,10,8,6,22,58,82,-24,30
Raith,6346,1,23,8,5,70,33,37,77
Ayr,6346,2,24,4,8,95,43,52,76
Arbroath,6346,3,18,8,10,72,49,23,62
Alloa,6346,4,17,8,11,57,45,12,59
Stranraer,6346,5,15,5,16,56,67,-11,50
East Fife,6346,6,14,3,19,50,65,-15,45
Airdrieon,6346,7,10,11,15,46,60,-14,41
Forfar,6346,8,11,5,20,40,65,-25,38
Albion,6346,9,8,6,22,58,83,-25,30
Queen's Park,6346,10,6,10,20,40,74,-34,28
Raith,6347,1,23,8,5,72,33,39,77
Ayr,6347,2,24,4,8,93,43,50,76
Arbroath,6347,3,18,8,10,73,48,25,62
Alloa,6347,4,17,8,11,57,47,10,59
Stranraer,6347,5,15,5,16,55,66,-11,50
East Fife,6347,6,14,3,19,49,64,-15,45
Airdrieon,6347,7,11,11,14,48,59,-11,44
Forfar,6347,8,10,5,21,39,67,-28,35
Albion,6347,9,8,6,22,58,81,-23,30
Queen's Park,6347,10,6,10,20,39,75,-36,28
Ayr,6348,1,24,4,8,95,43,52,76
Raith,6348,2,22,8,6,68,33,35,74
Alloa,6348,3,18,8,10,57,43,14,62
Arbroath,6348,4,17,9,10,72,50,22,60
Stranraer,6348,5,15,6,15,57,66,-9,51
Airdrieon,6348,6,11,11,14,47,58,-11,44
East Fife,6348,7,13,4,19,49,66,-17,43
Forfar,6348,8,10,5,21,38,66,-28,35
Albion,6348,9,8,6,22,58,83,-25,30
Queen's Park,6348,10,6,11,19,41,74,-33,29
Raith,6349,1,23,8,5,71,33,38,77
Ayr,6349,2,24,4,8,91,42,49,76
Arbroath,6349,3,18,8,10,72,48,24,62
Alloa,6349,4,17,8,11,57,46,11,59
Stranraer,6349,5,15,5,16,57,67,-10,50
East Fife,6349,6,14,3,19,50,66,-16,45
Airdrieon,6349,7,11,11,14,47,58,-11,44
Forfar,6349,8,10,5,21,38,66,-28,35
Albion,6349,9,8,6,22,57,79,-22,30
Queen's Park,6349,10,6,10,20,39,74,-35,28
Raith,6350,1,23,8,5,69,32,37,77
Ayr,6350,2,23,5,8,91,43,48,74
Arbroath,6350,3,17,8,11,71,50,21,59
Alloa,6350,4,17,8,11,56,44,12,59
Stranraer,6350,5,16,5,15,57,65,-8,53
Airdrieon,6350,6,10,12,14,45,58,-13,42
East Fife,6350,7,13,3,20,48,66,-18,42
Forfar,6350,8,10,6,20,38,64,-26,36
Albion,6350,9,8,7,21,58,79,-21,31
Queen's Park,6350,10,7,10,19,41,73,-32,31
Raith,6351,1,23,8,5,71,32,39,77
Ayr,6351,2,24,4,8,93,43,50,76
Arbroath,6351,3,18,8,10,74,51,23,62
Alloa,6351,4,17,8,11,56,46,10,59
Stranraer,6351,5,15,5,16,56,68,-12,50
East Fife,6351,6,14,3,19,51,65,-14,45
Airdrieon,6351,7,11,11,14,46,58,-12,44
Forfar,6351,8,10,5,21,38,65,-27,35
Albion,6351,9,8,6,22,58,81,-23,30
Queen's Park,6351,10,6,10,20,42,76,-34,28
Ayr,6352,1,24,4,8,94,42,52,76
Raith,6352,2,22,8,6,69,34,35,74
Arbroath,6352,3,18,8,10,74,49,25,62
Alloa,6352,4,18,8,10,58,44,14,62
Stranraer,6352,5,15,6,15,56,65,-9,51
East Fife,6352,6,13,4,19,48,65,-17,43
Airdrieon,6352,7,10,12,14,45,58,-13,42
Forfar,6352,8,10,6,20,38,64,-26,36
Albion,6352,9,8,6,22,57,82,-25,30
Queen's Park,6352,10,6,10,20,40,76,-36,28
Raith,6353,1,23,8,5,70,32,38,77
Ayr,6353,2,24,4,8,94,44,50,76
Arbroath,6353,3,18,8,10,75,49,26,62
Alloa,6353,4,17,8,11,56,45,11,59
Stranraer,6353,5,16,5,15,58,65,-7,53
Airdrieon,6353,6,11,11,14,48,59,-11,44
East Fife,6353,7,13,3,20,48,67,-19,42
Forfar,6353,8,10,5,21,39,67,-28,35
Albion,6353,9,8,6,22,59,82,-23,30
Queen's Park,6353,10,6,10,20,40,77,-37,28
Raith,6354,1,23,8,5,69,32,37,77
Ayr,6354,2,24,4,8,95,43,52,76
Arbroath,6354,3,17,9,10,71,49,22,60
Alloa,6354,4,17,8,11,56,44,12,59
Stranraer,6354,5,15,5,16,55,65,-10,50
East Fife,6354,6,14,3,19,48,64,-16,45
Airdrieon,6354,7,10,12,14,45,58,-13,42
Forfar,6354,8,10,6,20,38,64,-26,36
Albion,6354,9,8,6,22,58,83,-25,30
Queen's Park,6354,10,6,11,19,40,73,-33,29
Raith,6355,1,23,8,5,69,32,37,77
Ayr,6355,2,24,4,8,93,44,49,76
Arbroath,6355,3,17,8,11,71,51,20,59
Alloa,6355,4,17,8,11,56,44,12,59
Stranraer,6355,5,15,5,16,55,66,-11,50
East Fife,6355,6,14,3,19,49,64,-15,45
Airdrieon,6355,7,10,12,14,46,59,-13,42
Forfar,6355,8,10,6,20,39,65,-26,36
Queen's Park,6355,9,7,10,19,42,73,-31,31
Albion,6355,10,8,6,22,59,81,-22,30
Raith,6356,1,23,8,5,69,32,37,77
Ayr,6356,2,24,4,8,92,43,49,76
Arbroath,6356,3,17,9,10,71,49,22,60
Alloa,6356,4,17,8,11,56,44,12,59
Stranraer,6356,5,16,5,15,57,65,-8,53
Airdrieon,6356,6,11,11,14,47,59,-12,44
East Fife,6356,7,13,3,20,48,66,-18,42
Forfar,6356,8,10,5,21,39,66,-27,35
Albion,6356,9,8,6,22,58,80,-22,30
Queen's Park,6356,10,6,11,19,40,73,-33,29
Raith,6357,1,23,8,5,69,32,37,77
Ayr,6357,2,24,4,8,95,45,50,76
Arbroath,6357,3,17,9,10,72,50,22,60
Alloa,6357,4,17,8,11,56,44,12,59
Stranraer,6357,5,15,5,16,58,68,-10,50
East Fife,6357,6,14,3,19,51,67,-16,45
Airdrieon,6357,7,10,12,14,47,60,-13,42
Forfar,6357,8,10,6,20,40,66,-26,36
Albion,6357,9,8,6,22,60,83,-23,30
Queen's Park,6357,10,6,11,19,41,74,-33,29
Raith,6358,1,23,8,5,69,32,37,77
Ayr,6358,2,23,4,9,91,44,47,73
Arbroath,6358,3,17,9,10,70,48,22,60
Alloa,6358,4,17,8,11,56,44,12,59
Stranraer,6358,5,15,5,16,56,66,-10,50
East Fife,6358,6,14,3,19,49,65,-16,45
Airdrieon,6358,7,11,11,14,48,58,-10,44
Forfar,6358,8,10,5,21,38,67,-29,35
Albion,6358,9,9,6,21,59,79,-20,33
Queen's Park,6358,10,6,11,19,39,72,-33,29
Ayr,6359,1,24,4,8,96,43,53,76
Raith,6359,2,22,9,5,69,33,36,75
Arbroath,6359,3,18,8,10,73,50,23,62
Alloa,6359,4,17,9,10,57,44,13,60
Stranraer,6359,5,15,5,16,56,68,-12,50
East Fife,6359,6,14,3,19,51,65,-14,45
Airdrieon,6359,7,10,12,14,47,60,-13,42
Forfar,6359,8,10,6,20,40,66,-26,36
Albion,6359,9,8,6,22,58,84,-26,30
Queen's Park,6359,10,6,10,20,41,75,-34,28
Raith,6360,1,23,8,5,69,32,37,77
Ayr,6360,2,23,4,9,90,43,47,73
Arbroath,6360,3,17,9,10,70,48,22,60
Alloa,6360,4,17,8,11,56,44,12,59
Stranraer,6360,5,15,5,16,55,67,-12,50
East Fife,6360,6,14,3,19,50,64,-14,45
Airdrieon,6360,7,10,12,14,46,59,-13,42
Forfar,6360,8,10,6,20,39,65,-26,36
Albion,6360,9,9,6,21,58,78,-20,33
Queen's Park,6360,10,6,11,19,39,72,-33,29
Ayr,6361,1,24,4,8,95,46,49,76
Raith,6361,2,22,9,5,68,32,36,75
Arbroath,6361,3,17,9,10,71,49,22,60
Alloa,6361,4,17,9,10,56,43,13,60
Stranraer,6361,5,15,5,16,57,67,-10,50
East Fife,6361,6,14,3,19,50,66,-16,45
Airdrieon,6361,7,10,11,15,46,60,-14,41
Forfar,6361,8,11,5,20,40,65,-25,38
Albion,6361,9,8,6,22,61,83,-22,30
Queen's Park,6361,10,6,11,19,40,73,-33,29
Raith,6362,1,22,9,5,69,33,36,75
Ayr,6362,2,23,4,9,91,44,47,73
Arbroath,6362,3,17,9,10,71,49,22,60
Alloa,6362,4,17,9,10,57,44,13,60
Stranraer,6362,5,15,5,16,55,68,-13,50
East Fife,6362,6,14,3,19,51,64,-13,45
Airdrieon,6362,7,11,11,14,46,58,-12,44
Forfar,6362,8,10,5,21,38,65,-27,35
Albion,6362,9,9,6,21,59,79,-20,33
Queen's Park,6362,10,6,11,19,40,73,-33,29
Raith,6363,1,23,8,5,70,33,37,77
Ayr,6363,2,24,4,8,92,42,50,76
Arbroath,6363,3,18,8,10,73,49,24,62
Alloa,6363,4,17,8,11,57,45,12,59
Stranraer,6363,5,15,5,16,56,66,-10,50
East Fife,6363,6,14,3,19,49,65,-16,45
Airdrieon,6363,7,11,11,14,47,59,-12,44
Forfar,6363,8,10,5,21,39,66,-27,35
Albion,6363,9,8,6,22,57,80,-23,30
Queen's Park,6363,10,6,10,20,40,75,-35,28
Ayr,6364,1,23,5,8,91,43,48,74
Raith,6364,2,22,8,6,69,35,34,74
Arbroath,6364,3,18,8,10,73,48,25,62
Alloa,6364,4,18,8,10,59,44,15,62
Stranraer,6364,5,15,6,15,57,66,-9,51
Airdrieon,6364,6,11,11,14,48,60,-12,44
East Fife,6364,7,13,4,19,49,66,-17,43
Forfar,6364,8,10,5,21,40,67,-27,35
Albion,6364,9,8,7,21,58,79,-21,31
Queen's Park,6364,10,6,10,20,39,75,-36,28
Ayr,6365,1,24,4,8,92,43,49,76
Raith,6365,2,22,8,6,68,33,35,74
Alloa,6365,3,18,8,10,57,43,14,62
Arbroath,6365,4,17,9,10,70,48,22,60
Stranraer,6365,5,16,5,15,56,64,-8,53
Airdrieon,6365,6,11,11,14,47,59,-12,44
East Fife,6365,7,13,3,20,47,65,-18,42
Forfar,6365,8,10,5,21,39,66,-27,35
Albion,6365,9,8,6,22,58,80,-22,30
Queen's Park,6365,10,6,11,19,39,72,-33,29
Raith,6366,1,23,8,5,71,33,38,77
Ayr,6366,2,24,4,8,96,43,53,76
Arbroath,6366,3,17,8,11,70,50,20,59
Alloa,6366,4,17,8,11,57,46,11,59
Stranraer,6366,5,15,6,15,59,68,-9,51
East Fife,6366,6,13,4,19,51,68,-17,43
Airdrieon,6366,7,10,12,14,46,59,-13,42
Forfar,6366,8,10,6,20,39,65,-26,36
Queen's Park,6366,9,7,10,19,41,72,-31,31
Albion,6366,10,8,6,22,58,84,-26,30
Raith,6367,1,23,8,5,71,33,38,77
Ayr,6367,2,24,4,8,92,42,50,76
Arbroath,6367,3,17,9,10,71,49,22,60
Alloa,6367,4,17,8,11,57,46,11,59
Stranraer,6367,5,15,5,16,55,66,-11,50
East Fife,6367,6,14,3,19,49,64,-15,45
Airdrieon,6367,7,11,11,14,46,58,-12,44
Forfar,6367,8,10,5,21,38,65,-27,35
Albion,6367,9,8,6,22,57,80,-23,30
Queen's Park,6367,10,6,11,19,40,73,-33,29
Ayr,6368,1,24,4,8,93,44,49,76
Raith,6368,2,22,8,6,68,34,34,74
Arbroath,6368,3,18,8,10,74,48,26,62
Alloa,6368,4,18,8,10,58,43,15,62
Stranraer,6368,5,16,5,15,57,65,-8,53
Airdrieon,6368,6,10,12,14,46,59,-13,42
East Fife,6368,7,13,3,20,48,66,-18,42
Forfar,6368,8,10,6,20,39,65,-26,36
Albion,6368,9,8,6,22,59,81,-22,30
Queen's Park,6368,10,6,10,20,39,76,-37,28
Raith,6369,1,22,8,6,68,33,35,74
Ayr,6369,2,23,4,9,90,43,47,73
Arbroath,6369,3,18,8,10,73,50,23,62
Alloa,6369,4,18,8,10,57,43,14,62
Stranraer,6369,5,16,5,15,58,65,-7,53
Airdrieon,6369,6,11,11,14,47,59,-12,44
East Fife,6369,7,13,3,20,48,67,-19,42
Forfar,6369,8,10,5,21,39,66,-27,35
Albion,6369,9,9,6,21,58,78,-20,33
Queen's Park,6369,10,6,10,20,41,75,-34,28
Raith,6370,1,23,8,5,70,33,37,77
Ayr,6370,2,24,4,8,95,43,52,76
Arbroath,6370,3,18,8,10,73,50,23,62
Alloa,6370,4,17,8,11,57,45,12,59
Stranraer,6370,5,15,5,16,55,66,-11,50
East Fife,6370,6,14,3,19,49,64,-15,45
Airdrieon,6370,7,10,12,14,49,62,-13,42
Forfar,6370,8,10,6,20,42,68,-26,36
Albion,6370,9,8,6,22,58,83,-25,30
Queen's Park,6370,10,6,10,20,41,75,-34,28
Raith,6371,1,22,8,6,68,35,33,74
Ayr,6371,2,23,4,9,92,45,47,73
Arbroath,6371,3,18,8,10,76,49,27,62
Alloa,6371,4,18,8,10,59,43,16,62
Stranraer,6371,5,15,5,16,57,68,-11,50
East Fife,6371,6,14,3,19,51,66,-15,45
Airdrieon,6371,7,11,11,14,53,58,-5,44
Forfar,6371,8,10,5,21,38,72,-34,35
Albion,6371,9,9,6,21,60,80,-20,33
Queen's Park,6371,10,6,10,20,40,78,-38,28
Raith,6372,1,23,8,5,71,33,38,77
Ayr,6372,2,24,4,8,94,42,52,76
Arbroath,6372,3,18,8,10,74,48,26,62
Alloa,6372,4,17,8,11,57,46,11,59
Stranraer,6372,5,15,5,16,56,66,-10,50
East Fife,6372,6,14,3,19,49,65,-16,45
Airdrieon,6372,7,10,11,15,45,59,-14,41
Forfar,6372,8,11,5,20,39,64,-25,38
Albion,6372,9,8,6,22,57,82,-25,30
Queen's Park,6372,10,6,10,20,39,76,-37,28
Ayr,6373,1,24,4,8,93,42,51,76
Raith,6373,2,22,8,6,68,33,35,74
Alloa,6373,3,18,8,10,57,43,14,62
Arbroath,6373,4,17,8,11,71,50,21,59
Stranraer,6373,5,16,5,15,59,66,-7,53
East Fife,6373,6,13,3,20,49,68,-19,42
Airdrieon,6373,7,10,11,15,45,59,-14,41
Forfar,6373,8,11,5,20,39,64,-25,38
Queen's Park,6373,9,7,10,19,41,73,-32,31
Albion,6373,10,8,6,22,57,81,-24,30
Raith,6374,1,23,8,5,70,32,38,77
Ayr,6374,2,24,4,8,92,43,49,76
Arbroath,6374,3,17,8,11,71,50,21,59
Alloa,6374,4,17,8,11,56,45,11,59
Stranraer,6374,5,15,5,16,55,67,-12,50
East Fife,6374,6,14,3,19,50,64,-14,45
Airdrieon,6374,7,10,11,15,46,61,-15,41
Forfar,6374,8,11,5,20,41,65,-24,38
Queen's Park,6374,9,7,10,19,41,73,-32,31
Albion,6374,10,8,6,22,58,80,-22,30
Raith,6375,1,23,8,5,74,32,42,77
Ayr,6375,2,24,4,8,94,45,49,76
Arbroath,6375,3,17,8,11,72,52,20,59
Alloa,6375,4,17,8,11,56,49,7,59
Stranraer,6375,5,16,5,15,59,65,-6,53
Airdrieon,6375,6,11,11,14,47,58,-11,44
East Fife,6375,7,13,3,20,48,68,-20,42
Forfar,6375,8,10,5,21,38,66,-28,35
Queen's Park,6375,9,7,10,19,43,74,-31,31
Albion,6375,10,8,6,22,60,82,-22,30
Ayr,6376,1,24,4,8,94,45,49,76
Raith,6376,2,22,9,5,70,34,36,75
Arbroath,6376,3,17,9,10,71,49,22,60
Alloa,6376,4,17,9,10,58,45,13,60
Stranraer,6376,5,15,5,16,56,66,-10,50
East Fife,6376,6,14,3,19,49,65,-16,45
Airdrieon,6376,7,11,11,14,49,58,-9,44
Forfar,6376,8,10,5,21,38,68,-30,35
Albion,6376,9,8,6,22,60,82,-22,30
Queen's Park,6376,10,6,11,19,40,73,-33,29
Ayr,6377,1,24,4,8,92,42,50,76
Raith,6377,2,22,9,5,70,34,36,75
Arbroath,6377,3,17,9,10,70,48,22,60
Alloa,6377,4,17,9,10,58,45,13,60
Stranraer,6377,5,16,5,15,56,64,-8,53
Airdrieon,6377,6,11,11,14,48,60,-12,44
East Fife,6377,7,13,3,20,47,65,-18,42
Forfar,6377,8,10,5,21,40,67,-27,35
Albion,6377,9,8,6,22,57,80,-23,30
Queen's Park,6377,10,6,11,19,39,72,-33,29
Raith,6378,1,22,9,5,70,34,36,75
Ayr,6378,2,23,5,8,91,43,48,74
Arbroath,6378,3,18,8,10,73,50,23,62
Alloa,6378,4,17,9,10,58,45,13,60
Stranraer,6378,5,15,5,16,55,67,-12,50
East Fife,6378,6,14,3,19,50,64,-14,45
Airdrieon,6378,7,11,11,14,46,58,-12,44
Forfar,6378,8,10,5,21,38,65,-27,35
Albion,6378,9,8,7,21,58,79,-21,31
Queen's Park,6378,10,6,10,20,41,75,-34,28
Ayr,6379,1,24,4,8,91,42,49,76
Raith,6379,2,22,9,5,69,33,36,75
Alloa,6379,3,17,9,10,57,44,13,60
Arbroath,6379,4,17,8,11,71,50,21,59
Stranraer,6379,5,16,5,15,59,66,-7,53
East Fife,6379,6,13,3,20,49,68,-19,42
Airdrieon,6379,7,10,11,15,45,59,-14,41
Forfar,6379,8,11,5,20,39,64,-25,38
Queen's Park,6379,9,7,10,19,41,73,-32,31
Albion,6379,10,8,6,22,57,79,-22,30
Ayr,6380,1,24,4,8,95,43,52,76
Raith,6380,2,22,8,6,68,33,35,74
Arbroath,6380,3,18,8,10,71,48,23,62
Alloa,6380,4,18,8,10,57,43,14,62
Stranraer,6380,5,16,5,15,58,64,-6,53
East Fife,6380,6,13,3,20,47,67,-20,42
Airdrieon,6380,7,10,11,15,47,61,-14,41
Forfar,6380,8,11,5,20,41,66,-25,38
Albion,6380,9,8,6,22,58,83,-25,30
Queen's Park,6380,10,6,10,20,39,73,-34,28
Raith,6381,1,23,8,5,70,33,37,77
Ayr,6381,2,23,4,9,91,44,47,73
Arbroath,6381,3,18,8,10,71,48,23,62
Alloa,6381,4,17,8,11,57,45,12,59
Stranraer,6381,5,15,5,16,58,69,-11,50
East Fife,6381,6,14,3,19,52,67,-15,45
Airdrieon,6381,7,11,11,14,49,60,-11,44
Forfar,6381,8,10,5,21,40,68,-28,35
Albion,6381,9,9,6,21,59,79,-20,33
Queen's Park,6381,10,6,10,20,39,73,-34,28
Raith,6382,1,23,8,5,72,33,39,77
Ayr,6382,2,24,4,8,95,43,52,76
Arbroath,6382,3,17,8,11,71,51,20,59
Alloa,6382,4,17,8,11,57,47,10,59
Stranraer,6382,5,16,5,15,56,64,-8,53
Airdrieon,6382,6,11,11,14,46,58,-12,44
East Fife,6382,7,13,3,20,47,65,-18,42
Forfar,6382,8,10,5,21,38,65,-27,35
Queen's Park,6382,9,7,10,19,42,73,-31,31
Albion,6382,10,8,6,22,58,83,-25,30
Ayr,6383,1,24,4,8,96,43,53,76
Raith,6383,2,22,9,5,69,33,36,75
Arbroath,6383,3,17,9,10,71,49,22,60
Alloa,6383,4,17,9,10,57,44,13,60
Stranraer,6383,5,16,5,15,57,65,-8,53
Airdrieon,6383,6,10,12,14,46,59,-13,42
East Fife,6383,7,13,3,20,48,66,-18,42
Forfar,6383,8,10,6,20,39,65,-26,36
Albion,6383,9,8,6,22,58,84,-26,30
Queen's Park,6383,10,6,11,19,40,73,-33,29
Raith,6384,1,23,8,5,69,32,37,77
Ayr,6384,2,24,4,8,91,42,49,76
Arbroath,6384,3,18,8,10,73,48,25,62
Alloa,6384,4,17,8,11,56,44,12,59
Stranraer,6384,5,15,6,15,55,64,-9,51
Airdrieon,6384,6,11,11,14,47,59,-12,44
East Fife,6384,7,13,4,19,47,64,-17,43
Forfar,6384,8,10,5,21,39,66,-27,35
Albion,6384,9,8,6,22,57,79,-22,30
Queen's Park,6384,10,6,10,20,39,75,-36,28
Raith,6385,1,23,8,5,71,34,37,77
Ayr,6385,2,23,5,8,92,44,48,74
Arbroath,6385,3,17,9,10,71,49,22,60
Alloa,6385,4,17,8,11,58,46,12,59
Stranraer,6385,5,15,6,15,56,65,-9,51
Airdrieon,6385,6,11,11,14,48,60,-12,44
East Fife,6385,7,13,4,19,48,65,-17,43
Forfar,6385,8,10,5,21,40,67,-27,35
Albion,6385,9,8,7,21,59,80,-21,31
Queen's Park,6385,10,6,11,19,40,73,-33,29
Ayr,6386,1,24,4,8,93,44,49,76
Raith,6386,2,22,9,5,70,34,36,75
Arbroath,6386,3,18,8,10,71,48,23,62
Alloa,6386,4,17,9,10,58,45,13,60
Stranraer,6386,5,15,6,15,58,67,-9,51
Airdrieon,6386,6,11,11,14,50,58,-8,44
East Fife,6386,7,13,4,19,50,67,-17,43
Forfar,6386,8,10,5,21,38,69,-31,35
Albion,6386,9,8,6,22,59,81,-22,30
Queen's Park,6386,10,6,10,20,39,73,-34,28
Raith,6387,1,23,8,5,72,33,39,77
Ayr,6387,2,24,4,8,97,44,53,76
Arbroath,6387,3,17,8,11,70,49,21,59
Alloa,6387,4,17,8,11,57,47,10,59
Stranraer,6387,5,15,5,16,58,68,-10,50
East Fife,6387,6,14,3,19,51,67,-16,45
Airdrieon,6387,7,11,11,14,47,59,-12,44
Forfar,6387,8,10,5,21,39,66,-27,35
Queen's Park,6387,9,7,10,19,40,72,-32,31
Albion,6387,10,8,6,22,59,85,-26,30
Raith,6388,1,23,8,5,71,33,38,77
Ayr,6388,2,24,4,8,95,44,51,76
Arbroath,6388,3,17,8,11,71,50,21,59
Alloa,6388,4,17,8,11,57,46,11,59
Stranraer,6388,5,16,5,15,58,65,-7,53
Airdrieon,6388,6,11,11,14,46,58,-12,44
East Fife,6388,7,13,3,20,48,67,-19,42
Forfar,6388,8,10,5,21,38,65,-27,35
Queen's Park,6388,9,7,10,19,41,73,-32,31
Albion,6388,10,8,6,22,59,83,-24,30
Ayr,6389,1,24,4,8,92,43,49,76
Raith,6389,2,22,8,6,68,33,35,74
Alloa,6389,3,18,8,10,57,43,14,62
Arbroath,6389,4,17,8,11,70,51,19,59
Stranraer,6389,5,15,5,16,55,66,-11,50
East Fife,6389,6,14,3,19,49,64,-15,45
Airdrieon,6389,7,10,12,14,46,59,-13,42
Forfar,6389,8,10,6,20,39,65,-26,36
Queen's Park,6389,9,7,10,19,42,72,-30,31
Albion,6389,10,8,6,22,58,80,-22,30
Raith,6390,1,23,8,5,70,33,37,77
Ayr,6390,2,24,4,8,93,43,50,76
Arbroath,6390,3,17,9,10,72,50,22,60
Alloa,6390,4,17,8,11,57,45,12,59
Stranraer,6390,5,16,5,15,56,64,-8,53
Airdrieon,6390,6,11,11,14,47,59,-12,44
East Fife,6390,7,13,3,20,47,65,-18,42
Forfar,6390,8,10,5,21,39,66,-27,35
Albion,6390,9,8,6,22,58,81,-23,30
Queen's Park,6390,10,6,11,19,41,74,-33,29
Raith,6391,1,23,8,5,70,33,37,77
Ayr,6391,2,24,4,8,93,44,49,76
Arbroath,6391,3,18,8,10,72,48,24,62
Alloa,6391,4,17,8,11,57,45,12,59
Stranraer,6391,5,15,5,16,55,66,-11,50
East Fife,6391,6,14,3,19,49,64,-15,45
Airdrieon,6391,7,10,11,15,46,60,-14,41
Forfar,6391,8,11,5,20,40,65,-25,38
Albion,6391,9,8,6,22,59,81,-22,30
Queen's Park,6391,10,6,10,20,39,74,-35,28
Raith,6392,1,23,8,5,70,33,37,77
Ayr,6392,2,23,4,9,92,46,46,73
Arbroath,6392,3,18,8,10,74,51,23,62
Alloa,6392,4,17,8,11,57,45,12,59
Stranraer,6392,5,16,5,15,57,64,-7,53
Airdrieon,6392,6,10,12,14,45,58,-13,42
East Fife,6392,7,13,3,20,47,66,-19,42
Forfar,6392,8,10,6,20,38,64,-26,36
Albion,6392,9,9,6,21,61,80,-19,33
Queen's Park,6392,10,6,10,20,42,76,-34,28
Raith,6393,1,23,8,5,70,32,38,77
Ayr,6393,2,24,4,8,97,43,54,76
Arbroath,6393,3,18,8,10,76,48,28,62
Alloa,6393,4,17,8,11,56,45,11,59
Stranraer,6393,5,15,5,16,56,66,-10,50
East Fife,6393,6,14,3,19,49,65,-16,45
Airdrieon,6393,7,11,11,14,47,58,-11,44
Forfar,6393,8,10,5,21,38,66,-28,35
Albion,6393,9,8,6,22,58,85,-27,30
Queen's Park,6393,10,6,10,20,39,78,-39,28
Raith,6394,1,23,8,5,70,33,37,77
Ayr,6394,2,24,4,8,97,44,53,76
Arbroath,6394,3,17,8,11,70,49,21,59
Alloa,6394,4,17,8,11,57,45,12,59
Stranraer,6394,5,15,5,16,56,67,-11,50
East Fife,6394,6,14,3,19,50,65,-15,45
Airdrieon,6394,7,11,11,14,47,58,-11,44
Forfar,6394,8,10,5,21,38,66,-28,35
Queen's Park,6394,9,7,10,19,40,72,-32,31
Albion,6394,10,8,6,22,59,85,-26,30
Ayr,6395,1,24,4,8,95,42,53,76
Raith,6395,2,22,8,6,68,34,34,74
Alloa,6395,3,18,8,10,58,43,15,62
Arbroath,6395,4,17,8,11,71,51,20,59
Stranraer,6395,5,15,6,15,58,67,-9,51
East Fife,6395,6,13,4,19,50,67,-17,43
Airdrieon,6395,7,10,11,15,46,60,-14,41
Forfar,6395,8,11,5,20,40,65,-25,38
Queen's Park,6395,9,7,10,19,42,73,-31,31
Albion,6395,10,8,6,22,57,83,-26,30
Raith,6396,1,23,8,5,70,33,37,77
Ayr,6396,2,24,4,8,94,42,52,76
Arbroath,6396,3,17,9,10,71,49,22,60
Alloa,6396,4,17,8,11,57,45,12,59
Stranraer,6396,5,15,6,15,56,65,-9,51
Airdrieon,6396,6,11,11,14,47,59,-12,44
East Fife,6396,7,13,4,19,48,65,-17,43
Forfar,6396,8,10,5,21,39,66,-27,35
Albion,6396,9,8,6,22,57,82,-25,30
Queen's Park,6396,10,6,11,19,40,73,-33,29
Raith,6397,1,22,8,6,69,34,35,74
Ayr,6397,2,23,4,9,90,43,47,73
Alloa,6397,3,18,8,10,58,44,14,62
Arbroath,6397,4,17,8,11,71,51,20,59
Stranraer,6397,5,16,5,15,57,65,-8,53
Airdrieon,6397,6,10,12,14,45,58,-13,42
East Fife,6397,7,13,3,20,48,66,-18,42
Forfar,6397,8,10,6,20,38,64,-26,36
Albion,6397,9,9,6,21,58,78,-20,33
Queen's Park,6397,10,7,10,19,42,73,-31,31
Raith,6398,1,23,8,5,70,33,37,77
Ayr,6398,2,24,4,8,96,44,52,76
Arbroath,6398,3,18,8,10,75,48,27,62
Alloa,6398,4,17,8,11,57,45,12,59
Stranraer,6398,5,15,6,15,57,66,-9,51
Airdrieon,6398,6,11,11,14,46,58,-12,44
East Fife,6398,7,13,4,19,49,66,-17,43
Forfar,6398,8,10,5,21,38,65,-27,35
Albion,6398,9,8,6,22,59,84,-25,30
Queen's Park,6398,10,6,10,20,39,77,-38,28
Raith,6399,1,23,8,5,70,32,38,77
Ayr,6399,2,24,4,8,92,43,49,76
Arbroath,6399,3,17,8,11,70,49,21,59
Alloa,6399,4,17,8,11,56,45,11,59
Stranraer,6399,5,15,6,15,57,66,-9,51
East Fife,6399,6,13,4,19,49,66,-17,43
Airdrieon,6399,7,10,12,14,46,59,-13,42
Forfar,6399,8,10,6,20,39,65,-26,36
Queen's Park,6399,9,7,10,19,40,72,-32,31
Albion,6399,10,8,6,22,58,80,-22,30
Raith,6400,1,23,8,5,70,32,38,77
Ayr,6400,2,23,5,8,93,45,48,74
Arbroath,6400,3,17,8,11,72,52,20,59
Alloa,6400,4,17,8,11,56,45,11,59
Stranraer,6400,5,15,6,15,56,65,-9,51
East Fife,6400,6,13,4,19,48,65,-17,43
Airdrieon,6400,7,10,12,14,46,59,-13,42
Forfar,6400,8,10,6,20,39,65,-26,36
Albion,6400,9,8,7,21,60,81,-21,31
Queen's Park,6400,10,7,10,19,43,74,-31,31
Raith,6401,1,23,8,5,71,32,39,77
Ayr,6401,2,24,4,8,93,42,51,76
Arbroath,6401,3,18,8,10,71,48,23,62
Alloa,6401,4,17,8,11,56,46,10,59
Stranraer,6401,5,15,5,16,55,66,-11,50
East Fife,6401,6,14,3,19,49,64,-15,45
Airdrieon,6401,7,11,11,14,48,58,-10,44
Forfar,6401,8,10,5,21,38,67,-29,35
Albion,6401,9,8,6,22,57,81,-24,30
Queen's Park,6401,10,6,10,20,39,73,-34,28
Raith,6402,1,23,8,5,72,32,40,77
Ayr,6402,2,23,5,8,92,44,48,74
Arbroath,6402,3,17,8,11,71,50,21,59
Alloa,6402,4,17,8,11,56,47,9,59
Stranraer,6402,5,15,5,16,55,65,-10,50
East Fife,6402,6,14,3,19,48,64,-16,45
Airdrieon,6402,7,11,11,14,47,59,-12,44
Forfar,6402,8,10,5,21,39,66,-27,35
Albion,6402,9,8,7,21,59,80,-21,31
Queen's Park,6402,10,7,10,19,41,73,-32,31
Raith,6403,1,23,8,5,70,32,38,77
Ayr,6403,2,24,4,8,95,44,51,76
Arbroath,6403,3,17,8,11,72,52,20,59
Alloa,6403,4,17,8,11,56,45,11,59
Stranraer,6403,5,15,6,15,56,65,-9,51
East Fife,6403,6,13,4,19,48,65,-17,43
Airdrieon,6403,7,10,11,15,45,60,-15,41
Forfar,6403,8,11,5,20,40,64,-24,38
Queen's Park,6403,9,7,10,19,43,74,-31,31
Albion,6403,10,8,6,22,59,83,-24,30
Raith,6404,1,23,8,5,70,33,37,77
Ayr,6404,2,24,4,8,92,43,49,76
Arbroath,6404,3,17,9,10,71,49,22,60
Alloa,6404,4,17,8,11,57,45,12,59
Stranraer,6404,5,15,5,16,55,65,-10,50
East Fife,6404,6,14,3,19,48,64,-16,45
Airdrieon,6404,7,11,11,14,49,60,-11,44
Forfar,6404,8,10,5,21,40,68,-28,35
Albion,6404,9,8,6,22,58,80,-22,30
Queen's Park,6404,10,6,11,19,40,73,-33,29
Ayr,6405,1,24,4,8,95,44,51,76
Raith,6405,2,22,8,6,69,34,35,74
Alloa,6405,3,18,8,10,58,44,14,62
Arbroath,6405,4,17,8,11,70,49,21,59
Stranraer,6405,5,15,6,15,56,65,-9,51
East Fife,6405,6,13,4,19,48,65,-17,43
Airdrieon,6405,7,10,11,15,45,59,-14,41
Forfar,6405,8,11,5,20,39,64,-25,38
Queen's Park,6405,9,7,10,19,40,72,-32,31
Albion,6405,10,8,6,22,59,83,-24,30
Ayr,6406,1,24,4,8,94,42,52,76
Raith,6406,2,22,9,5,69,33,36,75
Alloa,6406,3,17,9,10,57,44,13,60
Arbroath,6406,4,17,8,11,70,49,21,59
Stranraer,6406,5,15,6,15,57,66,-9,51
Airdrieon,6406,6,11,11,14,47,58,-11,44
East Fife,6406,7,13,4,19,49,66,-17,43
Forfar,6406,8,10,5,21,38,66,-28,35
Queen's Park,6406,9,7,10,19,40,72,-32,31
Albion,6406,10,8,6,22,57,82,-25,30
Raith,6407,1,23,8,5,73,32,41,77
Ayr,6407,2,24,4,8,94,43,51,76
Arbroath,6407,3,18,8,10,72,48,24,62
Alloa,6407,4,17,8,11,56,48,8,59
Stranraer,6407,5,15,5,16,56,66,-10,50
East Fife,6407,6,14,3,19,49,65,-16,45
Airdrieon,6407,7,11,11,14,46,58,-12,44
Forfar,6407,8,10,5,21,38,65,-27,35
Albion,6407,9,8,6,22,58,82,-24,30
Queen's Park,6407,10,6,10,20,39,74,-35,28
Raith,6408,1,23,8,5,70,32,38,77
Ayr,6408,2,24,4,8,92,43,49,76
Arbroath,6408,3,18,8,10,73,48,25,62
Alloa,6408,4,17,8,11,56,45,11,59
Stranraer,6408,5,15,5,16,56,66,-10,50
East Fife,6408,6,14,3,19,49,65,-16,45
Airdrieon,6408,7,11,11,14,47,58,-11,44
Forfar,6408,8,10,5,21,38,66,-28,35
Albion,6408,9,8,6,22,58,80,-22,30
Queen's Park,6408,10,6,10,20,39,75,-36,28
Raith,6409,1,23,8,5,69,32,37,77
Ayr,6409,2,23,5,8,91,43,48,74
Arbroath,6409,3,17,8,11,70,52,18,59
Alloa,6409,4,17,8,11,56,44,12,59
Stranraer,6409,5,15,5,16,56,66,-10,50
East Fife,6409,6,14,3,19,49,65,-16,45
Airdrieon,6409,7,10,12,14,46,59,-13,42
Forfar,6409,8,10,6,20,39,65,-26,36
Albion,6409,9,8,7,21,58,79,-21,31
Queen's Park,6409,10,7,10,19,43,72,-29,31
Raith,6410,1,23,8,5,71,33,38,77
Ayr,6410,2,24,4,8,94,44,50,76
Arbroath,6410,3,18,8,10,74,48,26,62
Alloa,6410,4,17,8,11,57,46,11,59
Stranraer,6410,5,16,5,15,56,64,-8,53
East Fife,6410,6,13,3,20,47,65,-18,42
Airdrieon,6410,7,10,11,15,45,59,-14,41
Forfar,6410,8,11,5,20,39,64,-25,38
Albion,6410,9,8,6,22,59,82,-23,30
Queen's Park,6410,10,6,10,20,39,76,-37,28
Raith,6411,1,23,8,5,70,33,37,77
Ayr,6411,2,24,4,8,93,43,50,76
Arbroath,6411,3,18,8,10,73,50,23,62
Alloa,6411,4,17,8,11,57,45,12,59
Stranraer,6411,5,15,5,16,55,66,-11,50
East Fife,6411,6,14,3,19,49,64,-15,45
Airdrieon,6411,7,10,11,15,46,60,-14,41
Forfar,6411,8,11,5,20,40,65,-25,38
Albion,6411,9,8,6,22,58,81,-23,30
Queen's Park,6411,10,6,10,20,41,75,-34,28
Raith,6412,1,23,8,5,70,32,38,77
Ayr,6412,2,23,5,8,94,46,48,74
Arbroath,6412,3,18,8,10,73,50,23,62
Alloa,6412,4,17,8,11,56,45,11,59
Stranraer,6412,5,15,5,16,55,67,-12,50
East Fife,6412,6,14,3,19,50,64,-14,45
Airdrieon,6412,7,10,12,14,45,58,-13,42
Forfar,6412,8,10,6,20,38,64,-26,36
Albion,6412,9,8,7,21,61,82,-21,31
Queen's Park,6412,10,6,10,20,41,75,-34,28
Ayr,6413,1,24,4,8,92,43,49,76
Raith,6413,2,22,9,5,68,32,36,75
Alloa,6413,3,17,9,10,56,43,13,60
Arbroath,6413,4,17,8,11,71,50,21,59
Stranraer,6413,5,16,5,15,57,65,-8,53
Airdrieon,6413,6,11,11,14,47,59,-12,44
East Fife,6413,7,13,3,20,48,66,-18,42
Forfar,6413,8,10,5,21,39,66,-27,35
Queen's Park,6413,9,7,10,19,41,73,-32,31
Albion,6413,10,8,6,22,58,80,-22,30
Raith,6414,1,23,8,5,71,33,38,77
Ayr,6414,2,23,4,9,92,45,47,73
Arbroath,6414,3,17,8,11,71,50,21,59
Alloa,6414,4,17,8,11,57,46,11,59
Stranraer,6414,5,15,5,16,55,66,-11,50
East Fife,6414,6,14,3,19,49,64,-15,45
Airdrieon,6414,7,11,11,14,51,59,-8,44
Forfar,6414,8,10,5,21,39,70,-31,35
Albion,6414,9,9,6,21,60,80,-20,33
Queen's Park,6414,10,7,10,19,41,73,-32,31
Raith,6415,1,23,8,5,71,32,39,77
Ayr,6415,2,24,4,8,93,42,51,76
Arbroath,6415,3,17,8,11,70,51,19,59
Alloa,6415,4,17,8,11,56,46,10,59
Stranraer,6415,5,15,5,16,55,65,-10,50
East Fife,6415,6,14,3,19,48,64,-16,45
Airdrieon,6415,7,11,11,14,48,58,-10,44
Forfar,6415,8,10,5,21,38,67,-29,35
Queen's Park,6415,9,7,10,19,42,72,-30,31
Albion,6415,10,8,6,22,57,81,-24,30
Raith,6416,1,23,8,5,71,33,38,77
Ayr,6416,2,24,4,8,92,42,50,76
Arbroath,6416,3,18,8,10,74,49,25,62
Alloa,6416,4,17,8,11,57,46,11,59
Stranraer,6416,5,15,5,16,56,66,-10,50
East Fife,6416,6,14,3,19,49,65,-16,45
Airdrieon,6416,7,10,11,15,45,60,-15,41
Forfar,6416,8,11,5,20,40,64,-24,38
Albion,6416,9,8,6,22,57,80,-23,30
Queen's Park,6416,10,6,10,20,40,76,-36,28
Raith,6417,1,23,8,5,70,32,38,77
Ayr,6417,2,23,5,8,90,42,48,74
Arbroath,6417,3,17,8,11,73,52,21,59
Alloa,6417,4,17,8,11,56,45,11,59
Stranraer,6417,5,16,5,15,59,65,-6,53
Airdrieon,6417,6,11,11,14,48,58,-10,44
East Fife,6417,7,13,3,20,48,68,-20,42
Forfar,6417,8,10,5,21,38,67,-29,35
Albion,6417,9,8,7,21,57,78,-21,31
Queen's Park,6417,10,7,10,19,43,75,-32,31
Ayr,6418,1,23,5,8,92,44,48,74
Raith,6418,2,22,8,6,68,34,34,74
Arbroath,6418,3,18,8,10,73,50,23,62
Alloa,6418,4,18,8,10,58,43,15,62
Stranraer,6418,5,15,5,16,55,65,-10,50
East Fife,6418,6,14,3,19,48,64,-16,45
Airdrieon,6418,7,11,11,14,49,58,-9,44
Forfar,6418,8,10,5,21,38,68,-30,35
Albion,6418,9,8,7,21,59,80,-21,31
Queen's Park,6418,10,6,10,20,41,75,-34,28
Ayr,6419,1,24,4,8,92,43,49,76
Raith,6419,2,22,9,5,69,33,36,75
Arbroath,6419,3,17,9,10,72,50,22,60
Alloa,6419,4,17,9,10,57,44,13,60
Stranraer,6419,5,15,6,15,56,65,-9,51
East Fife,6419,6,13,4,19,48,65,-17,43
Airdrieon,6419,7,10,12,14,46,59,-13,42
Forfar,6419,8,10,6,20,39,65,-26,36
Albion,6419,9,8,6,22,58,80,-22,30
Queen's Park,6419,10,6,11,19,41,74,-33,29
Raith,6420,1,23,8,5,69,32,37,77
Ayr,6420,2,24,4,8,93,43,50,76
Arbroath,6420,3,17,8,11,71,50,21,59
Alloa,6420,4,17,8,11,56,44,12,59
Stranraer,6420,5,15,6,15,57,66,-9,51
Airdrieon,6420,6,11,11,14,47,59,-12,44
East Fife,6420,7,13,4,19,49,66,-17,43
Forfar,6420,8,10,5,21,39,66,-27,35
Queen's Park,6420,9,7,10,19,41,73,-32,31
Albion,6420,10,8,6,22,58,81,-23,30
Ayr,6421,1,24,4,8,98,42,56,76
Raith,6421,2,22,8,6,68,33,35,74
Alloa,6421,3,18,8,10,57,43,14,62
Arbroath,6421,4,17,9,10,72,50,22,60
Stranraer,6421,5,15,5,16,56,68,-12,50
East Fife,6421,6,14,3,19,51,65,-14,45
Airdrieon,6421,7,11,11,14,48,59,-11,44
Forfar,6421,8,10,5,21,39,67,-28,35
Albion,6421,9,8,6,22,57,86,-29,30
Queen's Park,6421,10,6,11,19,41,74,-33,29
Raith,6422,1,23,8,5,71,34,37,77
Ayr,6422,2,23,5,8,91,43,48,74
Arbroath,6422,3,17,9,10,72,50,22,60
Alloa,6422,4,17,8,11,58,46,12,59
Stranraer,6422,5,16,5,15,58,66,-8,53
Airdrieon,6422,6,10,12,14,45,58,-13,42
East Fife,6422,7,13,3,20,49,67,-18,42
Forfar,6422,8,10,6,20,38,64,-26,36
Albion,6422,9,8,7,21,58,79,-21,31
Queen's Park,6422,10,6,11,19,41,74,-33,29
Raith,6423,1,23,8,5,70,32,38,77
Ayr,6423,2,24,4,8,94,43,51,76
Arbroath,6423,3,17,8,11,72,51,21,59
Alloa,6423,4,17,8,11,56,45,11,59
Stranraer,6423,5,15,5,16,57,67,-10,50
East Fife,6423,6,14,3,19,50,66,-16,45
Airdrieon,6423,7,10,12,14,46,59,-13,42
Forfar,6423,8,10,6,20,39,65,-26,36
Queen's Park,6423,9,7,10,19,42,74,-32,31
Albion,6423,10,8,6,22,58,82,-24,30
Raith,6424,1,23,8,5,73,33,40,77
Ayr,6424,2,24,4,8,92,42,50,76
Arbroath,6424,3,17,8,11,72,52,20,59
Alloa,6424,4,17,8,11,57,48,9,59
Stranraer,6424,5,16,5,15,57,64,-7,53
Airdrieon,6424,6,11,11,14,47,58,-11,44
East Fife,6424,7,13,3,20,47,66,-19,42
Forfar,6424,8,10,5,21,38,66,-28,35
Queen's Park,6424,9,7,10,19,43,74,-31,31
Albion,6424,10,8,6,22,57,80,-23,30
Ayr,6425,1,24,4,8,93,43,50,76
Raith,6425,2,22,9,5,68,32,36,75
Arbroath,6425,3,18,8,10,72,49,23,62
Alloa,6425,4,17,9,10,56,43,13,60
Stranraer,6425,5,16,5,15,58,66,-8,53
Airdrieon,6425,6,11,11,14,49,59,-10,44
East Fife,6425,7,13,3,20,49,67,-18,42
Forfar,6425,8,10,5,21,39,68,-29,35
Albion,6425,9,8,6,22,58,81,-23,30
Queen's Park,6425,10,6,10,20,40,74,-34,28
Ayr,6426,1,24,4,8,95,44,51,76
Raith,6426,2,22,8,6,68,33,35,74
Alloa,6426,3,18,8,10,57,43,14,62
Arbroath,6426,4,17,8,11,72,51,21,59
Stranraer,6426,5,16,5,15,57,65,-8,53
Airdrieon,6426,6,11,11,14,47,59,-12,44
East Fife,6426,7,13,3,20,48,66,-18,42
Forfar,6426,8,10,5,21,39,66,-27,35
Queen's Park,6426,9,7,10,19,42,74,-32,31
Albion,6426,10,8,6,22,59,83,-24,30
Ayr,6427,1,24,4,8,92,43,49,76
Raith,6427,2,22,8,6,68,34,34,74
Alloa,6427,3,18,8,10,58,43,15,62
Arbroath,6427,4,17,9,10,71,49,22,60
Stranraer,6427,5,16,5,15,57,65,-8,53
Airdrieon,6427,6,10,12,14,46,59,-13,42
East Fife,6427,7,13,3,20,48,66,-18,42
Forfar,6427,8,10,6,20,39,65,-26,36
Albion,6427,9,8,6,22,58,80,-22,30
Queen's Park,6427,10,6,11,19,40,73,-33,29
Ayr,6428,1,24,4,8,98,43,55,76
Raith,6428,2,22,8,6,68,33,35,74
Arbroath,6428,3,18,8,10,72,49,23,62
Alloa,6428,4,18,8,10,57,43,14,62
Stranraer,6428,5,15,6,15,56,65,-9,51
East Fife,6428,6,13,4,19,48,65,-17,43
Airdrieon,6428,7,10,11,15,45,60,-15,41
Forfar,6428,8,11,5,20,40,64,-24,38
Albion,6428,9,8,6,22,58,86,-28,30
Queen's Park,6428,10,6,10,20,40,74,-34,28
Raith,6429,1,23,8,5,70,32,38,77
Ayr,6429,2,24,4,8,93,43,50,76
Arbroath,6429,3,18,8,10,74,49,25,62
Alloa,6429,4,17,8,11,56,45,11,59
Stranraer,6429,5,16,5,15,56,64,-8,53
East Fife,6429,6,13,3,20,47,65,-18,42
Airdrieon,6429,7,10,11,15,46,60,-14,41
Forfar,6429,8,11,5,20,40,65,-25,38
Albion,6429,9,8,6,22,58,81,-23,30
Queen's Park,6429,10,6,10,20,40,76,-36,28
Raith,6430,1,23,8,5,72,32,40,77
Ayr,6430,2,24,4,8,94,44,50,76
Arbroath,6430,3,17,8,11,71,50,21,59
Alloa,6430,4,17,8,11,56,47,9,59
Stranraer,6430,5,15,6,15,55,64,-9,51
East Fife,6430,6,13,4,19,47,64,-17,43
Airdrieon,6430,7,10,12,14,46,59,-13,42
Forfar,6430,8,10,6,20,39,65,-26,36
Queen's Park,6430,9,7,10,19,41,73,-32,31
Albion,6430,10,8,6,22,59,82,-23,30
Raith,6431,1,23,8,5,72,32,40,77
Ayr,6431,2,23,4,9,94,48,46,73
Arbroath,6431,3,18,8,10,72,48,24,62
Alloa,6431,4,17,8,11,56,47,9,59
Stranraer,6431,5,15,5,16,58,70,-12,50
East Fife,6431,6,14,3,19,53,67,-14,45
Airdrieon,6431,7,11,11,14,46,58,-12,44
Forfar,6431,8,10,5,21,38,65,-27,35
Albion,6431,9,9,6,21,63,82,-19,33
Queen's Park,6431,10,6,10,20,39,74,-35,28
Raith,6432,1,22,9,5,68,32,36,75
Ayr,6432,2,23,5,8,91,43,48,74
Arbroath,6432,3,17,9,10,73,51,22,60
Alloa,6432,4,17,9,10,56,43,13,60
Stranraer,6432,5,15,5,16,56,68,-12,50
East Fife,6432,6,14,3,19,51,65,-14,45
Airdrieon,6432,7,10,11,15,46,61,-15,41
Forfar,6432,8,11,5,20,41,65,-24,38
Albion,6432,9,8,7,21,58,79,-21,31
Queen's Park,6432,10,6,11,19,42,75,-33,29
Raith,6433,1,22,9,5,69,33,36,75
Ayr,6433,2,23,4,9,90,43,47,73
Arbroath,6433,3,18,8,10,74,48,26,62
Alloa,6433,4,17,9,10,57,44,13,60
Stranraer,6433,5,15,6,15,56,65,-9,51
East Fife,6433,6,13,4,19,48,65,-17,43
Airdrieon,6433,7,10,12,14,46,59,-13,42
Forfar,6433,8,10,6,20,39,65,-26,36
Albion,6433,9,9,6,21,58,78,-20,33
Queen's Park,6433,10,6,10,20,39,76,-37,28
Raith,6434,1,23,8,5,72,33,39,77
Ayr,6434,2,24,4,8,95,43,52,76
Arbroath,6434,3,17,8,11,70,49,21,59
Alloa,6434,4,17,8,11,57,47,10,59
Stranraer,6434,5,16,5,15,56,64,-8,53
Airdrieon,6434,6,11,11,14,46,58,-12,44
East Fife,6434,7,13,3,20,47,65,-18,42
Forfar,6434,8,10,5,21,38,65,-27,35
Queen's Park,6434,9,7,10,19,40,72,-32,31
Albion,6434,10,8,6,22,58,83,-25,30
Raith,6435,1,23,8,5,70,32,38,77
Ayr,6435,2,23,5,8,91,43,48,74
Arbroath,6435,3,18,8,10,76,50,26,62
Alloa,6435,4,17,8,11,56,45,11,59
Stranraer,6435,5,16,5,15,59,65,-6,53
East Fife,6435,6,13,3,20,48,68,-20,42
Airdrieon,6435,7,10,11,15,45,60,-15,41
Forfar,6435,8,11,5,20,40,64,-24,38
Albion,6435,9,8,7,21,58,79,-21,31
Queen's Park,6435,10,6,10,20,41,78,-37,28
Raith,6436,1,23,8,5,69,32,37,77
Ayr,6436,2,23,4,9,93,46,47,73
Arbroath,6436,3,18,8,10,72,49,23,62
Alloa,6436,4,17,8,11,56,44,12,59
Stranraer,6436,5,15,5,16,57,69,-12,50
East Fife,6436,6,14,3,19,52,66,-14,45
Airdrieon,6436,7,11,11,14,46,58,-12,44
Forfar,6436,8,10,5,21,38,65,-27,35
Albion,6436,9,9,6,21,61,81,-20,33
Queen's Park,6436,10,6,10,20,40,74,-34,28
Raith,6437,1,23,8,5,71,32,39,77
Ayr,6437,2,24,4,8,96,43,53,76
Arbroath,6437,3,18,8,10,73,49,24,62
Alloa,6437,4,17,8,11,56,46,10,59
Stranraer,6437,5,15,5,16,55,67,-12,50
East Fife,6437,6,14,3,19,50,64,-14,45
Airdrieon,6437,7,11,11,14,48,59,-11,44
Forfar,6437,8,10,5,21,39,67,-28,35
Albion,6437,9,8,6,22,58,84,-26,30
Queen's Park,6437,10,6,10,20,40,75,-35,28
Raith,6438,1,23,8,5,70,33,37,77
Ayr,6438,2,24,4,8,94,44,50,76
Arbroath,6438,3,18,8,10,73,49,24,62
Alloa,6438,4,17,8,11,57,45,12,59
Stranraer,6438,5,15,6,15,55,64,-9,51
East Fife,6438,6,13,4,19,47,64,-17,43
Airdrieon,6438,7,10,12,14,46,59,-13,42
Forfar,6438,8,10,6,20,39,65,-26,36
Albion,6438,9,8,6,22,59,82,-23,30
Queen's Park,6438,10,6,10,20,40,75,-35,28
Raith,6439,1,23,8,5,72,34,38,77
Ayr,6439,2,24,4,8,95,45,50,76
Arbroath,6439,3,17,9,10,74,52,22,60
Alloa,6439,4,17,8,11,58,47,11,59
Stranraer,6439,5,16,5,15,59,64,-5,53
East Fife,6439,6,13,3,20,47,68,-21,42
Airdrieon,6439,7,10,11,15,45,59,-14,41
Forfar,6439,8,11,5,20,39,64,-25,38
Albion,6439,9,8,6,22,60,83,-23,30
Queen's Park,6439,10,6,11,19,43,76,-33,29
Ayr,6440,1,24,4,8,92,42,50,76
Raith,6440,2,22,9,5,69,33,36,75
Alloa,6440,3,17,9,10,57,44,13,60
Arbroath,6440,4,17,8,11,71,51,20,59
Stranraer,6440,5,15,5,16,56,66,-10,50
East Fife,6440,6,14,3,19,49,65,-16,45
Airdrieon,6440,7,10,12,14,46,59,-13,42
Forfar,6440,8,10,6,20,39,65,-26,36
Queen's Park,6440,9,7,10,19,42,73,-31,31
Albion,6440,10,8,6,22,57,80,-23,30
Raith,6441,1,23,8,5,70,32,38,77
Ayr,6441,2,23,4,9,90,43,47,73
Arbroath,6441,3,18,8,10,73,49,24,62
Alloa,6441,4,17,8,11,56,45,11,59
Stranraer,6441,5,15,5,16,57,70,-13,50
East Fife,6441,6,14,3,19,53,66,-13,45
Airdrieon,6441,7,11,11,14,50,62,-12,44
Forfar,6441,8,10,5,21,42,69,-27,35
Albion,6441,9,9,6,21,58,78,-20,33
Queen's Park,6441,10,6,10,20,40,75,-35,28
Ayr,6442,1,23,5,8,92,44,48,74
Raith,6442,2,22,8,6,68,34,34,74
Alloa,6442,3,18,8,10,58,43,15,62
Arbroath,6442,4,17,8,11,71,50,21,59
Stranraer,6442,5,15,5,16,57,68,-11,50
East Fife,6442,6,14,3,19,51,66,-15,45
Airdrieon,6442,7,10,12,14,46,59,-13,42
Forfar,6442,8,10,6,20,39,65,-26,36
Albion,6442,9,8,7,21,59,80,-21,31
Queen's Park,6442,10,7,10,19,41,73,-32,31
Raith,6443,1,23,8,5,71,33,38,77
Ayr,6443,2,24,4,8,94,42,52,76
Arbroath,6443,3,18,8,10,74,50,24,62
Alloa,6443,4,17,8,11,57,46,11,59
Stranraer,6443,5,15,5,16,56,70,-14,50
East Fife,6443,6,14,3,19,53,65,-12,45
Airdrieon,6443,7,11,11,14,47,58,-11,44
Forfar,6443,8,10,5,21,38,66,-28,35
Albion,6443,9,8,6,22,57,82,-25,30
Queen's Park,6443,10,6,10,20,41,76,-35,28
Raith,6444,1,23,8,5,69,32,37,77
Ayr,6444,2,24,4,8,97,43,54,76
Arbroath,6444,3,17,8,11,71,53,18,59
Alloa,6444,4,17,8,11,56,44,12,59
Stranraer,6444,5,15,5,16,57,67,-10,50
East Fife,6444,6,14,3,19,50,66,-16,45
Airdrieon,6444,7,11,11,14,48,59,-11,44
Forfar,6444,8,10,5,21,39,67,-28,35
Queen's Park,6444,9,7,10,19,44,73,-29,31
Albion,6444,10,8,6,22,58,85,-27,30
Raith,6445,1,23,8,5,71,33,38,77
Ayr,6445,2,24,4,8,96,43,53,76
Arbroath,6445,3,17,8,11,70,49,21,59
Alloa,6445,4,17,8,11,57,46,11,59
Stranraer,6445,5,16,5,15,57,65,-8,53
Airdrieon,6445,6,10,12,14,47,60,-13,42
East Fife,6445,7,13,3,20,48,66,-18,42
Forfar,6445,8,10,6,20,40,66,-26,36
Queen's Park,6445,9,7,10,19,40,72,-32,31
Albion,6445,10,8,6,22,58,84,-26,30
Ayr,6446,1,24,4,8,93,42,51,76
Raith,6446,2,22,8,6,68,34,34,74
Alloa,6446,3,18,8,10,58,43,15,62
Arbroath,6446,4,17,8,11,70,49,21,59
Stranraer,6446,5,16,5,15,58,66,-8,53
Airdrieon,6446,6,11,11,14,48,58,-10,44
East Fife,6446,7,13,3,20,49,67,-18,42
Forfar,6446,8,10,5,21,38,67,-29,35
Queen's Park,6446,9,7,10,19,40,72,-32,31
Albion,6446,10,8,6,22,57,81,-24,30
Ayr,6447,1,24,4,8,92,43,49,76
Raith,6447,2,22,8,6,68,33,35,74
Alloa,6447,3,18,8,10,57,43,14,62
Arbroath,6447,4,17,8,11,72,51,21,59
Stranraer,6447,5,16,5,15,59,67,-8,53
Airdrieon,6447,6,11,11,14,46,58,-12,44
East Fife,6447,7,13,3,20,50,68,-18,42
Forfar,6447,8,10,5,21,38,65,-27,35
Queen's Park,6447,9,7,10,19,42,74,-32,31
Albion,6447,10,8,6,22,58,80,-22,30
Ayr,6448,1,24,4,8,92,43,49,76
Raith,6448,2,22,9,5,69,33,36,75
Alloa,6448,3,17,9,10,57,44,13,60
Arbroath,6448,4,17,8,11,70,49,21,59
Stranraer,6448,5,15,6,15,56,65,-9,51
East Fife,6448,6,13,4,19,48,65,-17,43
Airdrieon,6448,7,10,11,15,46,60,-14,41
Forfar,6448,8,11,5,20,40,65,-25,38
Queen's Park,6448,9,7,10,19,40,72,-32,31
Albion,6448,10,8,6,22,58,80,-22,30
Raith,6449,1,22,9,5,68,32,36,75
Ayr,6449,2,23,5,8,92,44,48,74
Alloa,6449,3,17,9,10,56,43,13,60
Arbroath,6449,4,17,8,11,71,50,21,59
Stranraer,6449,5,15,5,16,55,65,-10,50
East Fife,6449,6,14,3,19,48,64,-16,45
Airdrieon,6449,7,10,12,14,47,60,-13,42
Forfar,6449,8,10,6,20,40,66,-26,36
Albion,6449,9,8,7,21,59,80,-21,31
Queen's Park,6449,10,7,10,19,41,73,-32,31
Ayr,6450,1,24,4,8,96,44,52,76
Raith,6450,2,22,8,6,69,34,35,74
Arbroath,6450,3,18,8,10,73,49,24,62
Alloa,6450,4,18,8,10,58,44,14,62
Stranraer,6450,5,15,5,16,55,70,-15,50
East Fife,6450,6,14,3,19,53,64,-11,45
Airdrieon,6450,7,10,11,15,45,60,-15,41
Forfar,6450,8,11,5,20,40,64,-24,38
Albion,6450,9,8,6,22,59,84,-25,30
Queen's Park,6450,10,6,10,20,40,75,-35,28
Ayr,6451,1,24,4,8,94,45,49,76
Raith,6451,2,22,8,6,70,35,35,74
Arbroath,6451,3,18,8,10,75,49,26,62
Alloa,6451,4,18,8,10,59,45,14,62
Stranraer,6451,5,15,6,15,57,66,-9,51
Airdrieon,6451,6,11,11,14,47,58,-11,44
East Fife,6451,7,13,4,19,49,66,-17,43
Forfar,6451,8,10,5,21,38,66,-28,35
Albion,6451,9,8,6,22,60,82,-22,30
Queen's Park,6451,10,6,10,20,40,77,-37,28
Raith,6452,1,23,8,5,70,33,37,77
Ayr,6452,2,24,4,8,94,44,50,76
Arbroath,6452,3,17,8,11,70,50,20,59
Alloa,6452,4,17,8,11,57,45,12,59
Stranraer,6452,5,16,5,15,58,64,-6,53
Airdrieon,6452,6,11,11,14,47,58,-11,44
East Fife,6452,7,13,3,20,47,67,-20,42
Forfar,6452,8,10,5,21,38,66,-28,35
Queen's Park,6452,9,7,10,19,41,72,-31,31
Albion,6452,10,8,6,22,59,82,-23,30
Raith,6453,1,23,8,5,70,32,38,77
Ayr,6453,2,23,5,8,91,43,48,74
Arbroath,6453,3,17,8,11,71,51,20,59
Alloa,6453,4,17,8,11,56,45,11,59
Stranraer,6453,5,15,5,16,57,68,-11,50
East Fife,6453,6,14,3,19,51,66,-15,45
Airdrieon,6453,7,11,11,14,49,60,-11,44
Forfar,6453,8,10,5,21,40,68,-28,35
Albion,6453,9,8,7,21,58,79,-21,31
Queen's Park,6453,10,7,10,19,42,73,-31,31
Raith,6454,1,23,8,5,69,32,37,77
Ayr,6454,2,24,4,8,95,43,52,76
Arbroath,6454,3,18,8,10,73,50,23,62
Alloa,6454,4,17,8,11,56,44,12,59
Stranraer,6454,5,15,6,15,55,64,-9,51
Airdrieon,6454,6,11,11,14,48,58,-10,44
East Fife,6454,7,13,4,19,47,64,-17,43
Forfar,6454,8,10,5,21,38,67,-29,35
Albion,6454,9,8,6,22,58,83,-25,30
Queen's Park,6454,10,6,10,20,41,75,-34,28
Ayr,6455,1,24,4,8,96,44,52,76
Raith,6455,2,22,9,5,68,32,36,75
Alloa,6455,3,17,9,10,56,43,13,60
Arbroath,6455,4,17,8,11,71,50,21,59
Stranraer,6455,5,16,5,15,60,66,-6,53
East Fife,6455,6,13,3,20,49,69,-20,42
Airdrieon,6455,7,10,11,15,46,60,-14,41
Forfar,6455,8,11,5,20,40,65,-25,38
Queen's Park,6455,9,7,10,19,41,73,-32,31
Albion,6455,10,8,6,22,59,84,-25,30
Raith,6456,1,23,8,5,70,33,37,77
Ayr,6456,2,24,4,8,93,44,49,76
Arbroath,6456,3,17,9,10,71,49,22,60
Alloa,6456,4,17,8,11,57,45,12,59
Stranraer,6456,5,15,6,15,57,66,-9,51
Airdrieon,6456,6,11,11,14,49,61,-12,44
East Fife,6456,7,13,4,19,49,66,-17,43
Forfar,6456,8,10,5,21,41,68,-27,35
Albion,6456,9,8,6,22,59,81,-22,30
Queen's Park,6456,10,6,11,19,40,73,-33,29
Raith,6457,1,23,8,5,72,34,38,77
Ayr,6457,2,23,5,8,92,44,48,74
Arbroath,6457,3,17,8,11,71,50,21,59
Alloa,6457,4,17,8,11,58,47,11,59
Stranraer,6457,5,15,5,16,55,65,-10,50
East Fife,6457,6,14,3,19,48,64,-16,45
Airdrieon,6457,7,11,11,14,50,59,-9,44
Forfar,6457,8,10,5,21,39,69,-30,35
Albion,6457,9,8,7,21,59,80,-21,31
Queen's Park,6457,10,7,10,19,41,73,-32,31
Ayr,6458,1,24,4,8,93,43,50,76
Raith,6458,2,22,8,6,68,34,34,74
Arbroath,6458,3,18,8,10,74,48,26,62
Alloa,6458,4,18,8,10,58,43,15,62
Stranraer,6458,5,16,5,15,56,64,-8,53
Airdrieon,6458,6,10,12,14,45,58,-13,42
East Fife,6458,7,13,3,20,47,65,-18,42
Forfar,6458,8,10,6,20,38,64,-26,36
Albion,6458,9,8,6,22,58,81,-23,30
Queen's Park,6458,10,6,10,20,39,76,-37,28
Raith,6459,1,23,8,5,71,32,39,77
Ayr,6459,2,24,4,8,93,42,51,76
Arbroath,6459,3,17,8,11,72,51,21,59
Alloa,6459,4,17,8,11,56,46,10,59
Stranraer,6459,5,15,5,16,57,68,-11,50
East Fife,6459,6,14,3,19,51,66,-15,45
Airdrieon,6459,7,11,11,14,47,58,-11,44
Forfar,6459,8,10,5,21,38,66,-28,35
Queen's Park,6459,9,7,10,19,42,74,-32,31
Albion,6459,10,8,6,22,57,81,-24,30
Raith,6460,1,23,8,5,73,34,39,77
Ayr,6460,2,23,4,9,92,45,47,73
Arbroath,6460,3,17,8,11,70,51,19,59
Alloa,6460,4,17,8,11,58,48,10,59
Stranraer,6460,5,16,5,15,56,64,-8,53
Airdrieon,6460,6,11,11,14,48,60,-12,44
East Fife,6460,7,13,3,20,47,65,-18,42
Forfar,6460,8,10,5,21,40,67,-27,35
Albion,6460,9,9,6,21,60,80,-20,33
Queen's Park,6460,10,7,10,19,42,72,-30,31
Raith,6461,1,23,8,5,71,33,38,77
Ayr,6461,2,23,5,8,91,43,48,74
Arbroath,6461,3,18,8,10,74,48,26,62
Alloa,6461,4,17,8,11,57,46,11,59
Stranraer,6461,5,16,5,15,56,64,-8,53
Airdrieon,6461,6,11,11,14,47,59,-12,44
East Fife,6461,7,13,3,20,47,65,-18,42
Forfar,6461,8,10,5,21,39,66,-27,35
Albion,6461,9,8,7,21,58,79,-21,31
Queen's Park,6461,10,6,10,20,39,76,-37,28
Raith,6462,1,23,8,5,69,32,37,77
Ayr,6462,2,23,5,8,92,44,48,74
Arbroath,6462,3,17,9,10,73,51,22,60
Alloa,6462,4,17,8,11,56,44,12,59
Stranraer,6462,5,16,5,15,58,66,-8,53
Airdrieon,6462,6,11,11,14,46,58,-12,44
East Fife,6462,7,13,3,20,49,67,-18,42
Forfar,6462,8,10,5,21,38,65,-27,35
Albion,6462,9,8,7,21,59,80,-21,31
Queen's Park,6462,10,6,11,19,42,75,-33,29
Raith,6463,1,23,8,5,71,34,37,77
Ayr,6463,2,24,4,8,93,44,49,76
Arbroath,6463,3,18,8,10,73,50,23,62
Alloa,6463,4,17,8,11,58,46,12,59
Stranraer,6463,5,15,5,16,56,66,-10,50
East Fife,6463,6,14,3,19,49,65,-16,45
Airdrieon,6463,7,11,11,14,48,58,-10,44
Forfar,6463,8,10,5,21,38,67,-29,35
Albion,6463,9,8,6,22,59,81,-22,30
Queen's Park,6463,10,6,10,20,41,75,-34,28
Raith,6464,1,23,8,5,71,32,39,77
Ayr,6464,2,24,4,8,93,44,49,76
Arbroath,6464,3,18,8,10,71,48,23,62
Alloa,6464,4,17,8,11,56,46,10,59
Stranraer,6464,5,15,5,16,56,68,-12,50
East Fife,6464,6,14,3,19,51,65,-14,45
Airdrieon,6464,7,10,11,15,45,59,-14,41
Forfar,6464,8,11,5,20,39,64,-25,38
Albion,6464,9,8,6,22,59,81,-22,30
Queen's Park,6464,10,6,10,20,39,73,-34,28
Raith,6465,1,22,8,6,68,33,35,74
Ayr,6465,2,23,4,9,90,43,47,73
Alloa,6465,3,18,8,10,57,43,14,62
Arbroath,6465,4,17,9,10,70,48,22,60
Stranraer,6465,5,15,6,15,57,66,-9,51
East Fife,6465,6,13,4,19,49,66,-17,43
Airdrieon,6465,7,10,11,15,45,59,-14,41
Forfar,6465,8,11,5,20,39,64,-25,38
Albion,6465,9,9,6,21,58,78,-20,33
Queen's Park,6465,10,6,11,19,39,72,-33,29
Raith,6466,1,23,8,5,70,33,37,77
Ayr,6466,2,24,4,8,93,44,49,76
Arbroath,6466,3,17,8,11,73,52,21,59
Alloa,6466,4,17,8,11,57,45,12,59
Stranraer,6466,5,15,6,15,56,65,-9,51
East Fife,6466,6,13,4,19,48,65,-17,43
Airdrieon,6466,7,10,12,14,46,59,-13,42
Forfar,6466,8,10,6,20,39,65,-26,36
Queen's Park,6466,9,7,10,19,43,75,-32,31
Albion,6466,10,8,6,22,59,81,-22,30
Raith,6467,1,23,8,5,69,32,37,77
Ayr,6467,2,24,4,8,94,45,49,76
Arbroath,6467,3,17,9,10,71,49,22,60
Alloa,6467,4,17,8,11,56,44,12,59
Stranraer,6467,5,15,6,15,58,67,-9,51
Airdrieon,6467,6,11,11,14,48,58,-10,44
East Fife,6467,7,13,4,19,50,67,-17,43
Forfar,6467,8,10,5,21,38,67,-29,35
Albion,6467,9,8,6,22,60,82,-22,30
Queen's Park,6467,10,6,11,19,40,73,-33,29
Ayr,6468,1,24,4,8,93,43,50,76
Raith,6468,2,22,9,5,68,32,36,75
Arbroath,6468,3,18,8,10,74,51,23,62
Alloa,6468,4,17,9,10,56,43,13,60
Stranraer,6468,5,15,6,15,56,65,-9,51
East Fife,6468,6,13,4,19,48,65,-17,43
Airdrieon,6468,7,10,11,15,45,59,-14,41
Forfar,6468,8,11,5,20,39,64,-25,38
Albion,6468,9,8,6,22,58,81,-23,30
Queen's Park,6468,10,6,10,20,42,76,-34,28
Ayr,6469,1,24,4,8,94,43,51,76
Raith,6469,2,22,9,5,69,33,36,75
Arbroath,6469,3,17,9,10,71,49,22,60
Alloa,6469,4,17,9,10,57,44,13,60
Stranraer,6469,5,15,6,15,56,65,-9,51
Airdrieon,6469,6,11,11,14,46,58,-12,44
East Fife,6469,7,13,4,19,48,65,-17,43
Forfar,6469,8,10,5,21,38,65,-27,35
Albion,6469,9,8,6,22,58,82,-24,30
Queen's Park,6469,10,6,11,19,40,73,-33,29
Raith,6470,1,23,8,5,69,32,37,77
Ayr,6470,2,24,4,8,94,42,52,76
Arbroath,6470,3,17,9,10,71,49,22,60
Alloa,6470,4,17,8,11,56,44,12,59
Stranraer,6470,5,15,5,16,56,66,-10,50
East Fife,6470,6,14,3,19,49,65,-16,45
Airdrieon,6470,7,10,12,14,45,58,-13,42
Forfar,6470,8,10,6,20,38,64,-26,36
Albion,6470,9,8,6,22,57,82,-25,30
Queen's Park,6470,10,6,11,19,40,73,-33,29
Raith,6471,1,23,8,5,71,32,39,77
Ayr,6471,2,23,4,9,92,45,47,73
Arbroath,6471,3,18,8,10,74,49,25,62
Alloa,6471,4,17,8,11,56,46,10,59
Stranraer,6471,5,15,5,16,55,67,-12,50
East Fife,6471,6,14,3,19,50,64,-14,45
Airdrieon,6471,7,10,11,15,46,60,-14,41
Forfar,6471,8,11,5,20,40,65,-25,38
Albion,6471,9,9,6,21,60,80,-20,33
Queen's Park,6471,10,6,10,20,40,76,-36,28
Ayr,6472,1,24,4,8,93,42,51,76
Raith,6472,2,22,8,6,69,34,35,74
Arbroath,6472,3,18,8,10,73,48,25,62
Alloa,6472,4,18,8,10,58,44,14,62
Stranraer,6472,5,15,5,16,55,65,-10,50
East Fife,6472,6,14,3,19,48,64,-16,45
Airdrieon,6472,7,11,11,14,48,58,-10,44
Forfar,6472,8,10,5,21,38,67,-29,35
Albion,6472,9,8,6,22,57,81,-24,30
Queen's Park,6472,10,6,10,20,39,75,-36,28
Ayr,6473,1,24,4,8,97,42,55,76
Raith,6473,2,22,9,5,71,35,36,75
Alloa,6473,3,17,9,10,59,46,13,60
Arbroath,6473,4,17,8,11,70,49,21,59
Stranraer,6473,5,15,5,16,55,65,-10,50
East Fife,6473,6,14,3,19,48,64,-16,45
Airdrieon,6473,7,10,12,14,46,59,-13,42
Forfar,6473,8,10,6,20,39,65,-26,36
Queen's Park,6473,9,7,10,19,40,72,-32,31
Albion,6473,10,8,6,22,57,85,-28,30
Ayr,6474,1,24,4,8,96,44,52,76
Raith,6474,2,22,8,6,68,33,35,74
Alloa,6474,3,18,8,10,57,43,14,62
Arbroath,6474,4,17,9,10,72,50,22,60
Stranraer,6474,5,15,6,15,58,67,-9,51
East Fife,6474,6,13,4,19,50,67,-17,43
Airdrieon,6474,7,10,11,15,46,60,-14,41
Forfar,6474,8,11,5,20,40,65,-25,38
Albion,6474,9,8,6,22,59,84,-25,30
Queen's Park,6474,10,6,11,19,41,74,-33,29
Ayr,6475,1,24,4,8,94,43,51,76
Raith,6475,2,22,9,5,69,33,36,75
Alloa,6475,3,17,9,10,57,44,13,60
Arbroath,6475,4,17,8,11,73,53,20,59
Stranraer,6475,5,15,5,16,56,67,-11,50
East Fife,6475,6,14,3,19,50,65,-15,45
Airdrieon,6475,7,10,12,14,46,59,-13,42
Forfar,6475,8,10,6,20,39,65,-26,36
Queen's Park,6475,9,7,10,19,44,75,-31,31
Albion,6475,10,8,6,22,58,82,-24,30
Raith,6476,1,23,8,5,70,33,37,77
Ayr,6476,2,24,4,8,96,43,53,76
Arbroath,6476,3,17,8,11,71,50,21,59
Alloa,6476,4,17,8,11,57,45,12,59
Stranraer,6476,5,16,5,15,57,64,-7,53
Airdrieon,6476,6,10,12,14,45,58,-13,42
East Fife,6476,7,13,3,20,47,66,-19,42
Forfar,6476,8,10,6,20,38,64,-26,36
Queen's Park,6476,9,7,10,19,41,73,-32,31
Albion,6476,10,8,6,22,58,84,-26,30
Raith,6477,1,23,8,5,70,33,37,77
Ayr,6477,2,24,4,8,93,42,51,76
Arbroath,6477,3,17,8,11,71,50,21,59
Alloa,6477,4,17,8,11,57,45,12,59
Stranraer,6477,5,15,6,15,57,66,-9,51
East Fife,6477,6,13,4,19,49,66,-17,43
Airdrieon,6477,7,10,11,15,45,59,-14,41
Forfar,6477,8,11,5,20,39,64,-25,38
Queen's Park,6477,9,7,10,19,41,73,-32,31
Albion,6477,10,8,6,22,57,81,-24,30
Raith,6478,1,23,8,5,71,33,38,77
Ayr,6478,2,24,4,8,93,43,50,76
Arbroath,6478,3,18,8,10,73,49,24,62
Alloa,6478,4,17,8,11,57,46,11,59
Stranraer,6478,5,15,5,16,55,66,-11,50
East Fife,6478,6,14,3,19,49,64,-15,45
Airdrieon,6478,7,11,11,14,51,60,-9,44
Forfar,6478,8,10,5,21,40,70,-30,35
Albion,6478,9,8,6,22,58,81,-23,30
Queen's Park,6478,10,6,10,20,40,75,-35,28
Ayr,6479,1,24,4,8,94,42,52,76
Raith,6479,2,22,9,5,70,34,36,75
Alloa,6479,3,17,9,10,58,45,13,60
Arbroath,6479,4,17,8,11,70,49,21,59
Stranraer,6479,5,15,5,16,56,67,-11,50
East Fife,6479,6,14,3,19,50,65,-15,45
Airdrieon,6479,7,10,12,14,46,59,-13,42
Forfar,6479,8,10,6,20,39,65,-26,36
Queen's Park,6479,9,7,10,19,40,72,-32,31
Albion,6479,10,8,6,22,57,82,-25,30
Raith,6480,1,23,8,5,71,32,39,77
Ayr,6480,2,24,4,8,93,43,50,76
Arbroath,6480,3,18,8,10,71,48,23,62
Alloa,6480,4,17,8,11,56,46,10,59
Stranraer,6480,5,15,5,16,57,68,-11,50
East Fife,6480,6,14,3,19,51,66,-15,45
Airdrieon,6480,7,10,11,15,47,62,-15,41
Forfar,6480,8,11,5,20,42,66,-24,38
Albion,6480,9,8,6,22,58,81,-23,30
Queen's Park,6480,10,6,10,20,39,73,-34,28
Raith,6481,1,23,8,5,70,33,37,77
Ayr,6481,2,24,4,8,94,42,52,76
Arbroath,6481,3,17,8,11,71,50,21,59
Alloa,6481,4,17,8,11,57,45,12,59
Stranraer,6481,5,15,5,16,55,66,-11,50
East Fife,6481,6,14,3,19,49,64,-15,45
Airdrieon,6481,7,10,12,14,46,59,-13,42
Forfar,6481,8,10,6,20,39,65,-26,36
Queen's Park,6481,9,7,10,19,41,73,-32,31
Albion,6481,10,8,6,22,57,82,-25,30
Raith,6482,1,23,8,5,69,32,37,77
Ayr,6482,2,24,4,8,94,44,50,76
Arbroath,6482,3,18,8,10,74,49,25,62
Alloa,6482,4,17,8,11,56,44,12,59
Stranraer,6482,5,15,5,16,55,66,-11,50
East Fife,6482,6,14,3,19,49,64,-15,45
Airdrieon,6482,7,10,11,15,46,60,-14,41
Forfar,6482,8,11,5,20,40,65,-25,38
Albion,6482,9,8,6,22,59,82,-23,30
Queen's Park,6482,10,6,10,20,40,76,-36,28
Raith,6483,1,23,8,5,70,32,38,77
Ayr,6483,2,24,4,8,91,42,49,76
Arbroath,6483,3,18,8,10,75,51,24,62
Alloa,6483,4,17,8,11,56,45,11,59
Stranraer,6483,5,16,5,15,58,64,-6,53
East Fife,6483,6,13,3,20,47,67,-20,42
Airdrieon,6483,7,10,11,15,45,59,-14,41
Forfar,6483,8,11,5,20,39,64,-25,38
Albion,6483,9,8,6,22,57,79,-22,30
Queen's Park,6483,10,6,10,20,42,77,-35,28
Ayr,6484,1,24,4,8,97,43,54,76
Raith,6484,2,22,8,6,69,34,35,74
Alloa,6484,3,18,8,10,58,44,14,62
Arbroath,6484,4,17,8,11,71,53,18,59
Stranraer,6484,5,16,5,15,57,65,-8,53
East Fife,6484,6,13,3,20,48,66,-18,42
Airdrieon,6484,7,10,11,15,45,59,-14,41
Forfar,6484,8,11,5,20,39,64,-25,38
Queen's Park,6484,9,7,10,19,44,73,-29,31
Albion,6484,10,8,6,22,58,85,-27,30
Raith,6485,1,22,8,6,68,34,34,74
Ayr,6485,2,23,4,9,91,45,46,73
Arbroath,6485,3,18,8,10,74,51,23,62
Alloa,6485,4,18,8,10,58,43,15,62
Stranraer,6485,5,15,5,16,57,68,-11,50
East Fife,6485,6,14,3,19,51,66,-15,45
Airdrieon,6485,7,10,12,14,46,59,-13,42
Forfar,6485,8,10,6,20,39,65,-26,36
Albion,6485,9,9,6,21,60,79,-19,33
Queen's Park,6485,10,6,10,20,42,76,-34,28
Ayr,6486,1,24,4,8,92,43,49,76
Raith,6486,2,22,9,5,69,33,36,75
Arbroath,6486,3,18,8,10,73,50,23,62
Alloa,6486,4,17,9,10,57,44,13,60
Stranraer,6486,5,15,5,16,56,66,-10,50
East Fife,6486,6,14,3,19,49,65,-16,45
Airdrieon,6486,7,11,11,14,47,58,-11,44
Forfar,6486,8,10,5,21,38,66,-28,35
Albion,6486,9,8,6,22,58,80,-22,30
Queen's Park,6486,10,6,10,20,41,75,-34,28
Raith,6487,1,23,8,5,69,32,37,77
Ayr,6487,2,24,4,8,95,44,51,76
Arbroath,6487,3,18,8,10,73,49,24,62
Alloa,6487,4,17,8,11,56,44,12,59
Stranraer,6487,5,15,5,16,55,66,-11,50
East Fife,6487,6,14,3,19,49,64,-15,45
Airdrieon,6487,7,11,11,14,49,59,-10,44
Forfar,6487,8,10,5,21,39,68,-29,35
Albion,6487,9,8,6,22,59,83,-24,30
Queen's Park,6487,10,6,10,20,40,75,-35,28
Raith,6488,1,23,8,5,69,32,37,77
Ayr,6488,2,24,4,8,94,43,51,76
Arbroath,6488,3,17,8,11,72,53,19,59
Alloa,6488,4,17,8,11,56,44,12,59
Stranraer,6488,5,15,5,16,55,65,-10,50
East Fife,6488,6,14,3,19,48,64,-16,45
Airdrieon,6488,7,11,11,14,48,60,-12,44
Forfar,6488,8,10,5,21,40,67,-27,35
Queen's Park,6488,9,7,10,19,44,74,-30,31
Albion,6488,10,8,6,22,58,82,-24,30
Ayr,6489,1,24,4,8,93,44,49,76
Raith,6489,2,22,9,5,71,35,36,75
Arbroath,6489,3,17,9,10,72,50,22,60
Alloa,6489,4,17,9,10,59,46,13,60
Stranraer,6489,5,15,5,16,58,68,-10,50
East Fife,6489,6,14,3,19,51,67,-16,45
Airdrieon,6489,7,11,11,14,46,58,-12,44
Forfar,6489,8,10,5,21,38,65,-27,35
Albion,6489,9,8,6,22,59,81,-22,30
Queen's Park,6489,10,6,11,19,41,74,-33,29
Ayr,6490,1,24,4,8,92,42,50,76
Raith,6490,2,22,9,5,68,32,36,75
Alloa,6490,3,17,9,10,56,43,13,60
Arbroath,6490,4,17,8,11,72,51,21,59
Stranraer,6490,5,15,5,16,55,65,-10,50
East Fife,6490,6,14,3,19,48,64,-16,45
Airdrieon,6490,7,11,11,14,47,58,-11,44
Forfar,6490,8,10,5,21,38,66,-28,35
Queen's Park,6490,9,7,10,19,42,74,-32,31
Albion,6490,10,8,6,22,57,80,-23,30
Raith,6491,1,23,8,5,70,32,38,77
Ayr,6491,2,24,4,8,95,43,52,76
Arbroath,6491,3,18,8,10,73,49,24,62
Alloa,6491,4,17,8,11,56,45,11,59
Stranraer,6491,5,15,5,16,55,65,-10,50
East Fife,6491,6,14,3,19,48,64,-16,45
Airdrieon,6491,7,11,11,14,46,58,-12,44
Forfar,6491,8,10,5,21,38,65,-27,35
Albion,6491,9,8,6,22,58,83,-25,30
Queen's Park,6491,10,6,10,20,40,75,-35,28
Raith,6492,1,23,8,5,70,33,37,77
Ayr,6492,2,24,4,8,93,43,50,76
Arbroath,6492,3,17,8,11,70,49,21,59
Alloa,6492,4,17,8,11,57,45,12,59
Stranraer,6492,5,15,5,16,56,66,-10,50
East Fife,6492,6,14,3,19,49,65,-16,45
Airdrieon,6492,7,11,11,14,48,58,-10,44
Forfar,6492,8,10,5,21,38,67,-29,35
Queen's Park,6492,9,7,10,19,40,72,-32,31
Albion,6492,10,8,6,22,58,81,-23,30
Raith,6493,1,23,8,5,70,33,37,77
Ayr,6493,2,24,4,8,94,43,51,76
Arbroath,6493,3,18,8,10,71,48,23,62
Alloa,6493,4,17,8,11,57,45,12,59
Stranraer,6493,5,16,5,15,57,65,-8,53
Airdrieon,6493,6,10,12,14,47,60,-13,42
East Fife,6493,7,13,3,20,48,66,-18,42
Forfar,6493,8,10,6,20,40,66,-26,36
Albion,6493,9,8,6,22,58,82,-24,30
Queen's Park,6493,10,6,10,20,39,73,-34,28
Raith,6494,1,23,8,5,70,32,38,77
Ayr,6494,2,24,4,8,96,42,54,76
Arbroath,6494,3,18,8,10,71,48,23,62
Alloa,6494,4,17,8,11,56,45,11,59
Stranraer,6494,5,15,5,16,55,65,-10,50
East Fife,6494,6,14,3,19,48,64,-16,45
Airdrieon,6494,7,10,11,15,46,60,-14,41
Forfar,6494,8,11,5,20,40,65,-25,38
Albion,6494,9,8,6,22,57,84,-27,30
Queen's Park,6494,10,6,10,20,39,73,-34,28
Raith,6495,1,23,8,5,71,32,39,77
Ayr,6495,2,23,5,8,91,43,48,74
Arbroath,6495,3,17,8,11,71,52,19,59
Alloa,6495,4,17,8,11,56,46,10,59
Stranraer,6495,5,15,5,16,56,66,-10,50
East Fife,6495,6,14,3,19,49,65,-16,45
Airdrieon,6495,7,10,11,15,46,60,-14,41
Forfar,6495,8,11,5,20,40,65,-25,38
Albion,6495,9,8,7,21,58,79,-21,31
Queen's Park,6495,10,7,10,19,43,73,-30,31
Ayr,6496,1,24,4,8,93,43,50,76
Raith,6496,2,22,9,5,68,32,36,75
Arbroath,6496,3,18,8,10,75,51,24,62
Alloa,6496,4,17,9,10,56,43,13,60
Stranraer,6496,5,16,5,15,58,65,-7,53
Airdrieon,6496,6,10,12,14,46,59,-13,42
East Fife,6496,7,13,3,20,48,67,-19,42
Forfar,6496,8,10,6,20,39,65,-26,36
Albion,6496,9,8,6,22,58,81,-23,30
Queen's Park,6496,10,6,10,20,42,77,-35,28
Ayr,6497,1,24,4,8,92,42,50,76
Raith,6497,2,22,8,6,69,34,35,74
Arbroath,6497,3,18,8,10,72,49,23,62
Alloa,6497,4,18,8,10,58,44,14,62
Stranraer,6497,5,15,6,15,56,65,-9,51
Airdrieon,6497,6,11,11,14,50,61,-11,44
East Fife,6497,7,13,4,19,48,65,-17,43
Forfar,6497,8,10,5,21,41,69,-28,35
Albion,6497,9,8,6,22,57,80,-23,30
Queen's Park,6497,10,6,10,20,40,74,-34,28
Raith,6498,1,23,8,5,72,33,39,77
Ayr,6498,2,23,4,9,91,45,46,73
Arbroath,6498,3,17,8,11,72,52,20,59
Alloa,6498,4,17,8,11,57,47,10,59
Stranraer,6498,5,15,6,15,56,65,-9,51
Airdrieon,6498,6,11,11,14,47,58,-11,44
East Fife,6498,7,13,4,19,48,65,-17,43
Forfar,6498,8,10,5,21,38,66,-28,35
Albion,6498,9,9,6,21,60,79,-19,33
Queen's Park,6498,10,7,10,19,43,74,-31,31
Raith,6499,1,22,9,5,68,32,36,75
Ayr,6499,2,23,5,8,92,44,48,74
Alloa,6499,3,17,9,10,56,43,13,60
Arbroath,6499,4,17,8,11,71,50,21,59
Stranraer,6499,5,15,6,15,56,65,-9,51
Airdrieon,6499,6,11,11,14,49,60,-11,44
East Fife,6499,7,13,4,19,48,65,-17,43
Forfar,6499,8,10,5,21,40,68,-28,35
Albion,6499,9,8,7,21,59,80,-21,31
Queen's Park,6499,10,7,10,19,41,73,-32,31
Ayr,6500,1,23,5,8,92,44,48,74
Raith,6500,2,22,8,6,68,33,35,74
Arbroath,6500,3,18,8,10,71,48,23,62
Alloa,6500,4,18,8,10,57,43,14,62
Stranraer,6500,5,15,5,16,56,66,-10,50
East Fife,6500,6,14,3,19,49,65,-16,45
Airdrieon,6500,7,11,11,14,47,59,-12,44
Forfar,6500,8,10,5,21,39,66,-27,35
Albion,6500,9,8,7,21,59,80,-21,31
Queen's Park,6500,10,6,10,20,39,73,-34,28
Ayr,6501,1,24,4,8,94,43,51,76
Raith,6501,2,22,9,5,68,32,36,75
Arbroath,6501,3,18,8,10,73,49,24,62
Alloa,6501,4,17,9,10,56,43,13,60
Stranraer,6501,5,15,6,15,56,65,-9,51
East Fife,6501,6,13,4,19,48,65,-17,43
Airdrieon,6501,7,10,11,15,46,60,-14,41
Forfar,6501,8,11,5,20,40,65,-25,38
Albion,6501,9,8,6,22,58,82,-24,30
Queen's Park,6501,10,6,10,20,40,75,-35,28
Raith,6502,1,23,8,5,71,32,39,77
Ayr,6502,2,24,4,8,95,45,50,76
Arbroath,6502,3,17,9,10,71,49,22,60
Alloa,6502,4,17,8,11,56,46,10,59
Stranraer,6502,5,16,5,15,57,65,-8,53
Airdrieon,6502,6,11,11,14,46,58,-12,44
East Fife,6502,7,13,3,20,48,66,-18,42
Forfar,6502,8,10,5,21,38,65,-27,35
Albion,6502,9,8,6,22,60,83,-23,30
Queen's Park,6502,10,6,11,19,40,73,-33,29
Ayr,6503,1,24,4,8,95,42,53,76
Raith,6503,2,22,9,5,71,35,36,75
Alloa,6503,3,17,9,10,59,46,13,60
Arbroath,6503,4,17,8,11,70,49,21,59
Stranraer,6503,5,16,5,15,57,65,-8,53
Airdrieon,6503,6,11,11,14,47,58,-11,44
East Fife,6503,7,13,3,20,48,66,-18,42
Forfar,6503,8,10,5,21,38,66,-28,35
Queen's Park,6503,9,7,10,19,40,72,-32,31
Albion,6503,10,8,6,22,57,83,-26,30
Raith,6504,1,23,8,5,70,33,37,77
Ayr,6504,2,24,4,8,92,42,50,76
Arbroath,6504,3,17,8,11,71,50,21,59
Alloa,6504,4,17,8,11,57,45,12,59
Stranraer,6504,5,15,5,16,56,66,-10,50
East Fife,6504,6,14,3,19,49,65,-16,45
Airdrieon,6504,7,10,12,14,46,59,-13,42
Forfar,6504,8,10,6,20,39,65,-26,36
Queen's Park,6504,9,7,10,19,41,73,-32,31
Albion,6504,10,8,6,22,57,80,-23,30
Ayr,6505,1,24,4,8,95,43,52,76
Raith,6505,2,22,8,6,69,34,35,74
Arbroath,6505,3,18,8,10,72,49,23,62
Alloa,6505,4,18,8,10,58,44,14,62
Stranraer,6505,5,16,5,15,57,65,-8,53
Airdrieon,6505,6,11,11,14,46,58,-12,44
East Fife,6505,7,13,3,20,48,66,-18,42
Forfar,6505,8,10,5,21,38,65,-27,35
Albion,6505,9,8,6,22,58,83,-25,30
Queen's Park,6505,10,6,10,20,40,74,-34,28
Raith,6506,1,23,8,5,70,33,37,77
Ayr,6506,2,24,4,8,95,44,51,76
Arbroath,6506,3,17,8,11,71,50,21,59
Alloa,6506,4,17,8,11,57,45,12,59
Stranraer,6506,5,15,6,15,56,65,-9,51
East Fife,6506,6,13,4,19,48,65,-17,43
Airdrieon,6506,7,10,11,15,45,59,-14,41
Forfar,6506,8,11,5,20,39,64,-25,38
Queen's Park,6506,9,7,10,19,41,73,-32,31
Albion,6506,10,8,6,22,59,83,-24,30
Raith,6507,1,23,8,5,70,32,38,77
Ayr,6507,2,24,4,8,91,42,49,76
Arbroath,6507,3,17,9,10,71,49,22,60
Alloa,6507,4,17,8,11,56,45,11,59
Stranraer,6507,5,15,6,15,58,67,-9,51
Airdrieon,6507,6,11,11,14,46,58,-12,44
East Fife,6507,7,13,4,19,50,67,-17,43
Forfar,6507,8,10,5,21,38,65,-27,35
Albion,6507,9,8,6,22,57,79,-22,30
Queen's Park,6507,10,6,11,19,40,73,-33,29
Ayr,6508,1,24,4,8,96,42,54,76
Raith,6508,2,22,9,5,70,34,36,75
Arbroath,6508,3,17,9,10,71,49,22,60
Alloa,6508,4,17,9,10,58,45,13,60
Stranraer,6508,5,16,5,15,56,64,-8,53
East Fife,6508,6,13,3,20,47,65,-18,42
Airdrieon,6508,7,10,11,15,47,63,-16,41
Forfar,6508,8,11,5,20,43,66,-23,38
Albion,6508,9,8,6,22,57,84,-27,30
Queen's Park,6508,10,6,11,19,40,73,-33,29
Raith,6509,1,23,8,5,69,32,37,77
Ayr,6509,2,24,4,8,95,43,52,76
Arbroath,6509,3,18,8,10,76,50,26,62
Alloa,6509,4,17,8,11,56,44,12,59
Stranraer,6509,5,15,6,15,55,64,-9,51
East Fife,6509,6,13,4,19,47,64,-17,43
Airdrieon,6509,7,10,12,14,46,59,-13,42
Forfar,6509,8,10,6,20,39,65,-26,36
Albion,6509,9,8,6,22,58,83,-25,30
Queen's Park,6509,10,6,10,20,41,78,-37,28
Ayr,6510,1,24,4,8,93,42,51,76
Raith,6510,2,22,8,6,68,33,35,74
Alloa,6510,3,18,8,10,57,43,14,62
Arbroath,6510,4,17,8,11,70,49,21,59
Stranraer,6510,5,15,5,16,55,65,-10,50
East Fife,6510,6,14,3,19,48,64,-16,45
Airdrieon,6510,7,10,11,15,45,61,-16,41
Forfar,6510,8,11,5,20,41,64,-23,38
Queen's Park,6510,9,7,10,19,40,72,-32,31
Albion,6510,10,8,6,22,57,81,-24,30
Raith,6511,1,23,8,5,69,32,37,77
Ayr,6511,2,24,4,8,100,43,57,76
Arbroath,6511,3,18,8,10,72,48,24,62
Alloa,6511,4,17,8,11,56,44,12,59
Stranraer,6511,5,15,6,15,56,65,-9,51
Airdrieon,6511,6,11,11,14,47,58,-11,44
East Fife,6511,7,13,4,19,48,65,-17,43
Forfar,6511,8,10,5,21,38,66,-28,35
Albion,6511,9,8,6,22,58,88,-30,30
Queen's Park,6511,10,6,10,20,39,74,-35,28
Ayr,6512,1,23,5,8,92,44,48,74
Raith,6512,2,22,8,6,68,33,35,74
Alloa,6512,3,18,8,10,57,43,14,62
Arbroath,6512,4,17,9,10,70,48,22,60
Stranraer,6512,5,15,6,15,55,64,-9,51
East Fife,6512,6,13,4,19,47,64,-17,43
Airdrieon,6512,7,10,12,14,45,58,-13,42
Forfar,6512,8,10,6,20,38,64,-26,36
Albion,6512,9,8,7,21,59,80,-21,31
Queen's Park,6512,10,6,11,19,39,72,-33,29
Ayr,6513,1,24,4,8,94,44,50,76
Raith,6513,2,22,8,6,68,33,35,74
Alloa,6513,3,18,8,10,57,43,14,62
Arbroath,6513,4,17,8,11,71,50,21,59
Stranraer,6513,5,15,5,16,55,66,-11,50
East Fife,6513,6,14,3,19,49,64,-15,45
Airdrieon,6513,7,11,11,14,47,58,-11,44
Forfar,6513,8,10,5,21,38,66,-28,35
Queen's Park,6513,9,7,10,19,41,73,-32,31
Albion,6513,10,8,6,22,59,82,-23,30
Ayr,6514,1,24,4,8,91,42,49,76
Raith,6514,2,22,9,5,70,34,36,75
Arbroath,6514,3,18,8,10,73,49,24,62
Alloa,6514,4,17,9,10,58,45,13,60
Stranraer,6514,5,15,5,16,55,67,-12,50
East Fife,6514,6,14,3,19,50,64,-14,45
Airdrieon,6514,7,11,11,14,47,58,-11,44
Forfar,6514,8,10,5,21,38,66,-28,35
Albion,6514,9,8,6,22,57,79,-22,30
Queen's Park,6514,10,6,10,20,40,75,-35,28
Raith,6515,1,23,8,5,71,34,37,77
Ayr,6515,2,23,5,8,91,43,48,74
Arbroath,6515,3,18,8,10,72,48,24,62
Alloa,6515,4,17,8,11,58,46,12,59
Stranraer,6515,5,15,6,15,57,66,-9,51
East Fife,6515,6,13,4,19,49,66,-17,43
Airdrieon,6515,7,10,12,14,46,59,-13,42
Forfar,6515,8,10,6,20,39,65,-26,36
Albion,6515,9,8,7,21,58,79,-21,31
Queen's Park,6515,10,6,10,20,39,74,-35,28
Raith,6516,1,23,8,5,72,32,40,77
Ayr,6516,2,24,4,8,95,43,52,76
Arbroath,6516,3,17,8,11,72,51,21,59
Alloa,6516,4,17,8,11,56,47,9,59
Stranraer,6516,5,16,5,15,56,64,-8,53
Airdrieon,6516,6,11,11,14,47,59,-12,44
East Fife,6516,7,13,3,20,47,65,-18,42
Forfar,6516,8,10,5,21,39,66,-27,35
Queen's Park,6516,9,7,10,19,42,74,-32,31
Albion,6516,10,8,6,22,58,83,-25,30
Raith,6517,1,23,8,5,70,32,38,77
Ayr,6517,2,24,4,8,92,43,49,76
Arbroath,6517,3,17,9,10,71,49,22,60
Alloa,6517,4,17,8,11,56,45,11,59
Stranraer,6517,5,15,5,16,56,67,-11,50
East Fife,6517,6,14,3,19,50,65,-15,45
Airdrieon,6517,7,10,12,14,46,59,-13,42
Forfar,6517,8,10,6,20,39,65,-26,36
Albion,6517,9,8,6,22,58,80,-22,30
Queen's Park,6517,10,6,11,19,40,73,-33,29
Raith,6518,1,22,9,5,68,32,36,75
Ayr,6518,2,23,5,8,91,43,48,74
Alloa,6518,3,17,9,10,56,43,13,60
Arbroath,6518,4,17,8,11,71,50,21,59
Stranraer,6518,5,15,6,15,55,64,-9,51
East Fife,6518,6,13,4,19,47,64,-17,43
Airdrieon,6518,7,10,11,15,45,61,-16,41
Forfar,6518,8,11,5,20,41,64,-23,38
Albion,6518,9,8,7,21,58,79,-21,31
Queen's Park,6518,10,7,10,19,41,73,-32,31
Ayr,6519,1,24,4,8,94,44,50,76
Raith,6519,2,22,9,5,69,33,36,75
Arbroath,6519,3,17,9,10,71,49,22,60
Alloa,6519,4,17,9,10,57,44,13,60
Stranraer,6519,5,15,6,15,58,67,-9,51
Airdrieon,6519,6,11,11,14,47,59,-12,44
East Fife,6519,7,13,4,19,50,67,-17,43
Forfar,6519,8,10,5,21,39,66,-27,35
Albion,6519,9,8,6,22,59,82,-23,30
Queen's Park,6519,10,6,11,19,40,73,-33,29
Raith,6520,1,23,8,5,72,32,40,77
Ayr,6520,2,24,4,8,92,42,50,76
Arbroath,6520,3,18,8,10,74,48,26,62
Alloa,6520,4,17,8,11,56,47,9,59
Stranraer,6520,5,15,5,16,56,66,-10,50
East Fife,6520,6,14,3,19,49,65,-16,45
Airdrieon,6520,7,11,11,14,47,58,-11,44
Forfar,6520,8,10,5,21,38,66,-28,35
Albion,6520,9,8,6,22,57,80,-23,30
Queen's Park,6520,10,6,10,20,39,76,-37,28
Raith,6521,1,23,8,5,70,32,38,77
Ayr,6521,2,24,4,8,93,43,50,76
Arbroath,6521,3,18,8,10,72,49,23,62
Alloa,6521,4,17,8,11,56,45,11,59
Stranraer,6521,5,15,5,16,55,66,-11,50
East Fife,6521,6,14,3,19,49,64,-15,45
Airdrieon,6521,7,10,12,14,46,59,-13,42
Forfar,6521,8,10,6,20,39,65,-26,36
Albion,6521,9,8,6,22,58,81,-23,30
Queen's Park,6521,10,6,10,20,40,74,-34,28
Raith,6522,1,23,8,5,70,33,37,77
Ayr,6522,2,23,4,9,91,44,47,73
Arbroath,6522,3,17,8,11,71,53,18,59
Alloa,6522,4,17,8,11,57,45,12,59
Stranraer,6522,5,16,5,15,57,64,-7,53
Airdrieon,6522,6,11,11,14,48,60,-12,44
East Fife,6522,7,13,3,20,47,66,-19,42
Forfar,6522,8,10,5,21,40,67,-27,35
Albion,6522,9,9,6,21,59,79,-20,33
Queen's Park,6522,10,7,10,19,44,73,-29,31
Raith,6523,1,23,8,5,70,32,38,77
Ayr,6523,2,24,4,8,96,45,51,76
Arbroath,6523,3,17,8,11,70,49,21,59
Alloa,6523,4,17,8,11,56,45,11,59
Stranraer,6523,5,16,5,15,57,64,-7,53
Airdrieon,6523,6,11,11,14,47,59,-12,44
East Fife,6523,7,13,3,20,47,66,-19,42
Forfar,6523,8,10,5,21,39,66,-27,35
Queen's Park,6523,9,7,10,19,40,72,-32,31
Albion,6523,10,8,6,22,60,84,-24,30
Ayr,6524,1,24,4,8,92,43,49,76
Raith,6524,2,22,8,6,69,34,35,74
Arbroath,6524,3,18,8,10,73,48,25,62
Alloa,6524,4,18,8,10,58,44,14,62
Stranraer,6524,5,15,5,16,58,69,-11,50
East Fife,6524,6,14,3,19,52,67,-15,45
Airdrieon,6524,7,10,11,15,46,60,-14,41
Forfar,6524,8,11,5,20,40,65,-25,38
Albion,6524,9,8,6,22,58,80,-22,30
Queen's Park,6524,10,6,10,20,39,75,-36,28
Raith,6525,1,23,8,5,70,33,37,77
Ayr,6525,2,24,4,8,93,43,50,76
Arbroath,6525,3,17,8,11,71,50,21,59
Alloa,6525,4,17,8,11,57,45,12,59
Stranraer,6525,5,15,6,15,55,64,-9,51
East Fife,6525,6,13,4,19,47,64,-17,43
Airdrieon,6525,7,10,11,15,46,60,-14,41
Forfar,6525,8,11,5,20,40,65,-25,38
Queen's Park,6525,9,7,10,19,41,73,-32,31
Albion,6525,10,8,6,22,58,81,-23,30
Raith,6526,1,23,8,5,70,33,37,77
Ayr,6526,2,24,4,8,93,43,50,76
Arbroath,6526,3,17,8,11,71,50,21,59
Alloa,6526,4,17,8,11,57,45,12,59
Stranraer,6526,5,16,5,15,57,64,-7,53
Airdrieon,6526,6,11,11,14,48,59,-11,44
East Fife,6526,7,13,3,20,47,66,-19,42
Forfar,6526,8,10,5,21,39,67,-28,35
Queen's Park,6526,9,7,10,19,41,73,-32,31
Albion,6526,10,8,6,22,58,81,-23,30
Raith,6527,1,23,8,5,69,32,37,77
Ayr,6527,2,24,4,8,95,42,53,76
Arbroath,6527,3,17,9,10,74,52,22,60
Alloa,6527,4,17,8,11,56,44,12,59
Stranraer,6527,5,15,5,16,55,65,-10,50
East Fife,6527,6,14,3,19,48,64,-16,45
Airdrieon,6527,7,10,11,15,46,60,-14,41
Forfar,6527,8,11,5,20,40,65,-25,38
Albion,6527,9,8,6,22,57,83,-26,30
Queen's Park,6527,10,6,11,19,43,76,-33,29
Raith,6528,1,23,8,5,70,32,38,77
Ayr,6528,2,23,5,8,92,44,48,74
Arbroath,6528,3,17,8,11,73,52,21,59
Alloa,6528,4,17,8,11,56,45,11,59
Stranraer,6528,5,15,5,16,56,69,-13,50
East Fife,6528,6,14,3,19,52,65,-13,45
Airdrieon,6528,7,11,11,14,48,59,-11,44
Forfar,6528,8,10,5,21,39,67,-28,35
Albion,6528,9,8,7,21,59,80,-21,31
Queen's Park,6528,10,7,10,19,43,75,-32,31
Raith,6529,1,23,8,5,69,32,37,77
Ayr,6529,2,23,5,8,92,44,48,74
Arbroath,6529,3,18,8,10,71,48,23,62
Alloa,6529,4,17,8,11,56,44,12,59
Stranraer,6529,5,16,5,15,57,65,-8,53
East Fife,6529,6,13,3,20,48,66,-18,42
Airdrieon,6529,7,10,11,15,46,60,-14,41
Forfar,6529,8,11,5,20,40,65,-25,38
Albion,6529,9,8,7,21,59,80,-21,31
Queen's Park,6529,10,6,10,20,39,73,-34,28
Raith,6530,1,23,8,5,71,33,38,77
Ayr,6530,2,24,4,8,93,42,51,76
Arbroath,6530,3,17,8,11,72,51,21,59
Alloa,6530,4,17,8,11,57,46,11,59
Stranraer,6530,5,16,5,15,58,64,-6,53
Airdrieon,6530,6,11,11,14,49,59,-10,44
East Fife,6530,7,13,3,20,47,67,-20,42
Forfar,6530,8,10,5,21,39,68,-29,35
Queen's Park,6530,9,7,10,19,42,74,-32,31
Albion,6530,10,8,6,22,57,81,-24,30
Raith,6531,1,23,8,5,73,35,38,77
Ayr,6531,2,24,4,8,93,44,49,76
Arbroath,6531,3,18,8,10,75,48,27,62
Alloa,6531,4,17,8,11,59,48,11,59
Stranraer,6531,5,15,5,16,55,67,-12,50
East Fife,6531,6,14,3,19,50,64,-14,45
Airdrieon,6531,7,10,11,15,45,61,-16,41
Forfar,6531,8,11,5,20,41,64,-23,38
Albion,6531,9,8,6,22,59,81,-22,30
Queen's Park,6531,10,6,10,20,39,77,-38,28
Ayr,6532,1,24,4,8,92,42,50,76
Raith,6532,2,22,8,6,69,34,35,74
Alloa,6532,3,18,8,10,58,44,14,62
Arbroath,6532,4,17,8,11,71,50,21,59
Stranraer,6532,5,15,6,15,56,65,-9,51
Airdrieon,6532,6,11,11,14,48,59,-11,44
East Fife,6532,7,13,4,19,48,65,-17,43
Forfar,6532,8,10,5,21,39,67,-28,35
Queen's Park,6532,9,7,10,19,41,73,-32,31
Albion,6532,10,8,6,22,57,80,-23,30
Raith,6533,1,23,8,5,69,32,37,77
Ayr,6533,2,24,4,8,93,42,51,76
Arbroath,6533,3,18,8,10,71,48,23,62
Alloa,6533,4,17,8,11,56,44,12,59
Stranraer,6533,5,16,5,15,57,65,-8,53
Airdrieon,6533,6,11,11,14,47,58,-11,44
East Fife,6533,7,13,3,20,48,66,-18,42
Forfar,6533,8,10,5,21,38,66,-28,35
Albion,6533,9,8,6,22,57,81,-24,30
Queen's Park,6533,10,6,10,20,39,73,-34,28
Raith,6534,1,23,8,5,69,32,37,77
Ayr,6534,2,23,4,9,90,43,47,73
Arbroath,6534,3,17,8,11,70,49,21,59
Alloa,6534,4,17,8,11,56,44,12,59
Stranraer,6534,5,16,5,15,57,65,-8,53
Airdrieon,6534,6,11,11,14,48,60,-12,44
East Fife,6534,7,13,3,20,48,66,-18,42
Forfar,6534,8,10,5,21,40,67,-27,35
Albion,6534,9,9,6,21,58,78,-20,33
Queen's Park,6534,10,7,10,19,40,72,-32,31
Raith,6535,1,23,8,5,71,32,39,77
Ayr,6535,2,24,4,8,94,44,50,76
Arbroath,6535,3,18,8,10,72,48,24,62
Alloa,6535,4,17,8,11,56,46,10,59
Stranraer,6535,5,16,5,15,59,65,-6,53
Airdrieon,6535,6,10,12,14,46,59,-13,42
East Fife,6535,7,13,3,20,48,68,-20,42
Forfar,6535,8,10,6,20,39,65,-26,36
Albion,6535,9,8,6,22,59,82,-23,30
Queen's Park,6535,10,6,10,20,39,74,-35,28
Raith,6536,1,23,8,5,71,34,37,77
Ayr,6536,2,23,5,8,93,45,48,74
Arbroath,6536,3,18,8,10,73,49,24,62
Alloa,6536,4,17,8,11,58,46,12,59
Stranraer,6536,5,16,5,15,57,65,-8,53
Airdrieon,6536,6,11,11,14,47,58,-11,44
East Fife,6536,7,13,3,20,48,66,-18,42
Forfar,6536,8,10,5,21,38,66,-28,35
Albion,6536,9,8,7,21,60,81,-21,31
Queen's Park,6536,10,6,10,20,40,75,-35,28
Ayr,6537,1,24,4,8,92,43,49,76
Raith,6537,2,22,8,6,68,33,35,74
Alloa,6537,3,18,8,10,57,43,14,62
Arbroath,6537,4,17,9,10,72,50,22,60
Stranraer,6537,5,16,5,15,59,65,-6,53
Airdrieon,6537,6,11,11,14,48,58,-10,44
East Fife,6537,7,13,3,20,48,68,-20,42
Forfar,6537,8,10,5,21,38,67,-29,35
Albion,6537,9,8,6,22,58,80,-22,30
Queen's Park,6537,10,6,11,19,41,74,-33,29
Raith,6538,1,23,8,5,72,34,38,77
Ayr,6538,2,24,4,8,102,42,60,76
Arbroath,6538,3,18,8,10,73,49,24,62
Alloa,6538,4,17,8,11,58,47,11,59
Stranraer,6538,5,15,5,16,55,67,-12,50
East Fife,6538,6,14,3,19,50,64,-14,45
Airdrieon,6538,7,11,11,14,47,59,-12,44
Forfar,6538,8,10,5,21,39,66,-27,35
Albion,6538,9,8,6,22,57,90,-33,30
Queen's Park,6538,10,6,10,20,40,75,-35,28
Raith,6539,1,23,8,5,70,32,38,77
Ayr,6539,2,24,4,8,92,42,50,76
Arbroath,6539,3,17,9,10,71,49,22,60
Alloa,6539,4,17,8,11,56,45,11,59
Stranraer,6539,5,15,6,15,57,66,-9,51
Airdrieon,6539,6,11,11,14,48,58,-10,44
East Fife,6539,7,13,4,19,49,66,-17,43
Forfar,6539,8,10,5,21,38,67,-29,35
Albion,6539,9,8,6,22,57,80,-23,30
Queen's Park,6539,10,6,11,19,40,73,-33,29
Ayr,6540,1,24,4,8,95,43,52,76
Raith,6540,2,22,8,6,69,34,35,74
Arbroath,6540,3,18,8,10,72,48,24,62
Alloa,6540,4,18,8,10,58,44,14,62
Stranraer,6540,5,15,6,15,55,64,-9,51
Airdrieon,6540,6,11,11,14,48,59,-11,44
East Fife,6540,7,13,4,19,47,64,-17,43
Forfar,6540,8,10,5,21,39,67,-28,35
Albion,6540,9,8,6,22,58,83,-25,30
Queen's Park,6540,10,6,10,20,39,74,-35,28
Ayr,6541,1,24,4,8,95,43,52,76
Raith,6541,2,22,9,5,71,35,36,75
Arbroath,6541,3,18,8,10,73,50,23,62
Alloa,6541,4,17,9,10,59,46,13,60
Stranraer,6541,5,15,6,15,55,64,-9,51
Airdrieon,6541,6,11,11,14,51,58,-7,44
East Fife,6541,7,13,4,19,47,64,-17,43
Forfar,6541,8,10,5,21,38,70,-32,35
Albion,6541,9,8,6,22,58,83,-25,30
Queen's Park,6541,10,6,10,20,41,75,-34,28
Raith,6542,1,23,8,5,72,32,40,77
Ayr,6542,2,24,4,8,93,42,51,76
Arbroath,6542,3,17,8,11,70,49,21,59
Alloa,6542,4,17,8,11,56,47,9,59
Stranraer,6542,5,15,5,16,55,65,-10,50
East Fife,6542,6,14,3,19,48,64,-16,45
Airdrieon,6542,7,11,11,14,49,58,-9,44
Forfar,6542,8,10,5,21,38,68,-30,35
Queen's Park,6542,9,7,10,19,40,72,-32,31
Albion,6542,10,8,6,22,57,81,-24,30
Raith,6543,1,23,8,5,70,33,37,77
Ayr,6543,2,24,4,8,91,42,49,76
Arbroath,6543,3,17,8,11,71,51,20,59
Alloa,6543,4,17,8,11,57,45,12,59
Stranraer,6543,5,15,5,16,56,67,-11,50
East Fife,6543,6,14,3,19,50,65,-15,45
Airdrieon,6543,7,11,11,14,46,58,-12,44
Forfar,6543,8,10,5,21,38,65,-27,35
Queen's Park,6543,9,7,10,19,42,73,-31,31
Albion,6543,10,8,6,22,57,79,-22,30
Ayr,6544,1,24,4,8,94,44,50,76
Raith,6544,2,22,8,6,68,34,34,74
Alloa,6544,3,18,8,10,58,43,15,62
Arbroath,6544,4,17,8,11,70,51,19,59
Stranraer,6544,5,16,5,15,56,64,-8,53
Airdrieon,6544,6,11,11,14,47,59,-12,44
East Fife,6544,7,13,3,20,47,65,-18,42
Forfar,6544,8,10,5,21,39,66,-27,35
Queen's Park,6544,9,7,10,19,42,72,-30,31
Albion,6544,10,8,6,22,59,82,-23,30
Raith,6545,1,23,8,5,71,32,39,77
Ayr,6545,2,24,4,8,94,43,51,76
Arbroath,6545,3,17,9,10,71,49,22,60
Alloa,6545,4,17,8,11,56,46,10,59
Stranraer,6545,5,16,5,15,59,64,-5,53
Airdrieon,6545,6,11,11,14,47,58,-11,44
East Fife,6545,7,13,3,20,47,68,-21,42
Forfar,6545,8,10,5,21,38,66,-28,35
Albion,6545,9,8,6,22,58,82,-24,30
Queen's Park,6545,10,6,11,19,40,73,-33,29
Ayr,6546,1,24,4,8,94,42,52,76
Raith,6546,2,22,9,5,71,35,36,75
Alloa,6546,3,17,9,10,59,46,13,60
Arbroath,6546,4,17,8,11,70,53,17,59
Stranraer,6546,5,15,5,16,58,68,-10,50
East Fife,6546,6,14,3,19,51,67,-16,45
Airdrieon,6546,7,10,12,14,46,59,-13,42
Forfar,6546,8,10,6,20,39,65,-26,36
Queen's Park,6546,9,7,10,19,44,72,-28,31
Albion,6546,10,8,6,22,57,82,-25,30
Raith,6547,1,23,8,5,71,33,38,77
Ayr,6547,2,24,4,8,95,43,52,76
Arbroath,6547,3,17,9,10,72,50,22,60
Alloa,6547,4,17,8,11,57,46,11,59
Stranraer,6547,5,16,5,15,58,64,-6,53
Airdrieon,6547,6,11,11,14,47,58,-11,44
East Fife,6547,7,13,3,20,47,67,-20,42
Forfar,6547,8,10,5,21,38,66,-28,35
Albion,6547,9,8,6,22,58,83,-25,30
Queen's Park,6547,10,6,11,19,41,74,-33,29
Ayr,6548,1,23,5,8,90,42,48,74
Raith,6548,2,22,8,6,68,35,33,74
Arbroath,6548,3,18,8,10,72,48,24,62
Alloa,6548,4,18,8,10,59,43,16,62
Stranraer,6548,5,15,6,15,55,64,-9,51
East Fife,6548,6,13,4,19,47,64,-17,43
Airdrieon,6548,7,10,11,15,46,60,-14,41
Forfar,6548,8,11,5,20,40,65,-25,38
Albion,6548,9,8,7,21,57,78,-21,31
Queen's Park,6548,10,6,10,20,39,74,-35,28
Raith,6549,1,23,8,5,70,33,37,77
Ayr,6549,2,24,4,8,94,43,51,76
Arbroath,6549,3,18,8,10,73,50,23,62
Alloa,6549,4,17,8,11,57,45,12,59
Stranraer,6549,5,15,6,15,56,65,-9,51
Airdrieon,6549,6,11,11,14,50,60,-10,44
East Fife,6549,7,13,4,19,48,65,-17,43
Forfar,6549,8,10,5,21,40,69,-29,35
Albion,6549,9,8,6,22,58,82,-24,30
Queen's Park,6549,10,6,10,20,41,75,-34,28
Ayr,6550,1,24,4,8,92,43,49,76
Raith,6550,2,22,9,5,69,33,36,75
Arbroath,6550,3,18,8,10,72,49,23,62
Alloa,6550,4,17,9,10,57,44,13,60
Stranraer,6550,5,15,5,16,56,68,-12,50
East Fife,6550,6,14,3,19,51,65,-14,45
Airdrieon,6550,7,10,11,15,46,60,-14,41
Forfar,6550,8,11,5,20,40,65,-25,38
Albion,6550,9,8,6,22,58,80,-22,30
Queen's Park,6550,10,6,10,20,40,74,-34,28
Ayr,6551,1,24,4,8,92,43,49,76
Raith,6551,2,22,8,6,70,35,35,74
Alloa,6551,3,18,8,10,59,45,14,62
Arbroath,6551,4,17,9,10,72,50,22,60
Stranraer,6551,5,16,5,15,57,64,-7,53
East Fife,6551,6,13,3,20,47,66,-19,42
Airdrieon,6551,7,10,11,15,45,60,-15,41
Forfar,6551,8,11,5,20,40,64,-24,38
Albion,6551,9,8,6,22,58,80,-22,30
Queen's Park,6551,10,6,11,19,41,74,-33,29
Ayr,6552,1,24,4,8,96,42,54,76
Raith,6552,2,22,9,5,69,33,36,75
Arbroath,6552,3,17,9,10,71,49,22,60
Alloa,6552,4,17,9,10,57,44,13,60
Stranraer,6552,5,15,5,16,55,67,-12,50
East Fife,6552,6,14,3,19,50,64,-14,45
Airdrieon,6552,7,10,11,15,46,61,-15,41
Forfar,6552,8,11,5,20,41,65,-24,38
Albion,6552,9,8,6,22,57,84,-27,30
Queen's Park,6552,10,6,11,19,40,73,-33,29
Ayr,6553,1,24,4,8,92,42,50,76
Raith,6553,2,22,9,5,70,34,36,75
Arbroath,6553,3,18,8,10,75,49,26,62
Alloa,6553,4,17,9,10,58,45,13,60
Stranraer,6553,5,16,5,15,58,64,-6,53
Airdrieon,6553,6,10,12,14,45,58,-13,42
East Fife,6553,7,13,3,20,47,67,-20,42
Forfar,6553,8,10,6,20,38,64,-26,36
Albion,6553,9,8,6,22,57,80,-23,30
Queen's Park,6553,10,6,10,20,40,77,-37,28
Ayr,6554,1,24,4,8,93,42,51,76
Raith,6554,2,22,9,5,69,33,36,75
Arbroath,6554,3,18,8,10,73,48,25,62
Alloa,6554,4,17,9,10,57,44,13,60
Stranraer,6554,5,15,6,15,56,65,-9,51
Airdrieon,6554,6,11,11,14,46,58,-12,44
East Fife,6554,7,13,4,19,48,65,-17,43
Forfar,6554,8,10,5,21,38,65,-27,35
Albion,6554,9,8,6,22,57,81,-24,30
Queen's Park,6554,10,6,10,20,39,75,-36,28
Raith,6555,1,23,8,5,71,33,38,77
Ayr,6555,2,24,4,8,92,43,49,76
Arbroath,6555,3,17,9,10,71,49,22,60
Alloa,6555,4,17,8,11,57,46,11,59
Stranraer,6555,5,15,6,15,57,66,-9,51
Airdrieon,6555,6,11,11,14,47,59,-12,44
East Fife,6555,7,13,4,19,49,66,-17,43
Forfar,6555,8,10,5,21,39,66,-27,35
Albion,6555,9,8,6,22,58,80,-22,30
Queen's Park,6555,10,6,11,19,40,73,-33,29
Ayr,6556,1,24,4,8,93,43,50,76
Raith,6556,2,22,9,5,68,32,36,75
Arbroath,6556,3,17,9,10,72,50,22,60
Alloa,6556,4,17,9,10,56,43,13,60
Stranraer,6556,5,15,5,16,56,68,-12,50
East Fife,6556,6,14,3,19,51,65,-14,45
Airdrieon,6556,7,10,12,14,46,59,-13,42
Forfar,6556,8,10,6,20,39,65,-26,36
Albion,6556,9,8,6,22,58,81,-23,30
Queen's Park,6556,10,6,11,19,41,74,-33,29
Ayr,6557,1,24,4,8,92,42,50,76
Raith,6557,2,22,9,5,71,35,36,75
Alloa,6557,3,17,9,10,59,46,13,60
Arbroath,6557,4,17,8,11,71,52,19,59
Stranraer,6557,5,15,5,16,55,69,-14,50
East Fife,6557,6,14,3,19,52,64,-12,45
Airdrieon,6557,7,11,11,14,46,58,-12,44
Forfar,6557,8,10,5,21,38,65,-27,35
Queen's Park,6557,9,7,10,19,43,73,-30,31
Albion,6557,10,8,6,22,57,80,-23,30
Raith,6558,1,23,8,5,70,32,38,77
Ayr,6558,2,24,4,8,93,43,50,76
Arbroath,6558,3,17,8,11,73,53,20,59
Alloa,6558,4,17,8,11,56,45,11,59
Stranraer,6558,5,16,5,15,56,64,-8,53
Airdrieon,6558,6,11,11,14,46,58,-12,44
East Fife,6558,7,13,3,20,47,65,-18,42
Forfar,6558,8,10,5,21,38,65,-27,35
Queen's Park,6558,9,7,10,19,44,75,-31,31
Albion,6558,10,8,6,22,58,81,-23,30
Ayr,6559,1,24,4,8,93,42,51,76
Raith,6559,2,22,9,5,68,32,36,75
Arbroath,6559,3,17,9,10,72,50,22,60
Alloa,6559,4,17,9,10,56,43,13,60
Stranraer,6559,5,16,5,15,61,65,-4,53
Airdrieon,6559,6,10,12,14,45,58,-13,42
East Fife,6559,7,13,3,20,48,70,-22,42
Forfar,6559,8,10,6,20,38,64,-26,36
Albion,6559,9,8,6,22,57,81,-24,30
Queen's Park,6559,10,6,11,19,41,74,-33,29
Ayr,6560,1,24,4,8,95,43,52,76
Raith,6560,2,22,9,5,68,32,36,75
Arbroath,6560,3,17,9,10,70,48,22,60
Alloa,6560,4,17,9,10,56,43,13,60
Stranraer,6560,5,15,5,16,56,70,-14,50
East Fife,6560,6,14,3,19,53,65,-12,45
Airdrieon,6560,7,11,11,14,47,59,-12,44
Forfar,6560,8,10,5,21,39,66,-27,35
Albion,6560,9,8,6,22,58,83,-25,30
Queen's Park,6560,10,6,11,19,39,72,-33,29
Ayr,6561,1,23,5,8,91,43,48,74
Raith,6561,2,22,8,6,68,34,34,74
Arbroath,6561,3,18,8,10,74,50,24,62
Alloa,6561,4,18,8,10,58,43,15,62
Stranraer,6561,5,15,5,16,57,67,-10,50
East Fife,6561,6,14,3,19,50,66,-16,45
Airdrieon,6561,7,11,11,14,48,59,-11,44
Forfar,6561,8,10,5,21,39,67,-28,35
Albion,6561,9,8,7,21,58,79,-21,31
Queen's Park,6561,10,6,10,20,41,76,-35,28
Raith,6562,1,22,9,5,68,32,36,75
Ayr,6562,2,23,4,9,92,45,47,73
Arbroath,6562,3,18,8,10,73,50,23,62
Alloa,6562,4,17,9,10,56,43,13,60
Stranraer,6562,5,16,5,15,58,66,-8,53
Airdrieon,6562,6,11,11,14,48,59,-11,44
East Fife,6562,7,13,3,20,49,67,-18,42
Forfar,6562,8,10,5,21,39,67,-28,35
Albion,6562,9,9,6,21,60,80,-20,33
Queen's Park,6562,10,6,10,20,41,75,-34,28
Ayr,6563,1,24,4,8,93,42,51,76
Raith,6563,2,22,8,6,69,36,33,74
Alloa,6563,3,18,8,10,60,44,16,62
Arbroath,6563,4,17,8,11,71,51,20,59
Stranraer,6563,5,15,5,16,55,66,-11,50
East Fife,6563,6,14,3,19,49,64,-15,45
Airdrieon,6563,7,11,11,14,49,60,-11,44
Forfar,6563,8,10,5,21,40,68,-28,35
Queen's Park,6563,9,7,10,19,42,73,-31,31
Albion,6563,10,8,6,22,57,81,-24,30
Raith,6564,1,23,8,5,70,33,37,77
Ayr,6564,2,24,4,8,93,42,51,76
Arbroath,6564,3,18,8,10,75,49,26,62
Alloa,6564,4,17,8,11,57,45,12,59
Stranraer,6564,5,15,6,15,57,66,-9,51
East Fife,6564,6,13,4,19,49,66,-17,43
Airdrieon,6564,7,10,12,14,45,58,-13,42
Forfar,6564,8,10,6,20,38,64,-26,36
Albion,6564,9,8,6,22,57,81,-24,30
Queen's Park,6564,10,6,10,20,40,77,-37,28
Raith,6565,1,23,8,5,70,33,37,77
Ayr,6565,2,24,4,8,92,42,50,76
Arbroath,6565,3,18,8,10,71,48,23,62
Alloa,6565,4,17,8,11,57,45,12,59
Stranraer,6565,5,15,5,16,56,67,-11,50
East Fife,6565,6,14,3,19,50,65,-15,45
Airdrieon,6565,7,11,11,14,48,59,-11,44
Forfar,6565,8,10,5,21,39,67,-28,35
Albion,6565,9,8,6,22,57,80,-23,30
Queen's Park,6565,10,6,10,20,39,73,-34,28
Raith,6566,1,23,8,5,72,34,38,77
Ayr,6566,2,24,4,8,94,43,51,76
Arbroath,6566,3,17,9,10,71,49,22,60
Alloa,6566,4,17,8,11,58,47,11,59
Stranraer,6566,5,15,5,16,55,66,-11,50
East Fife,6566,6,14,3,19,49,64,-15,45
Airdrieon,6566,7,11,11,14,49,59,-10,44
Forfar,6566,8,10,5,21,39,68,-29,35
Albion,6566,9,8,6,22,58,82,-24,30
Queen's Park,6566,10,6,11,19,40,73,-33,29
Raith,6567,1,23,8,5,70,32,38,77
Ayr,6567,2,23,5,8,91,43,48,74
Arbroath,6567,3,17,8,11,71,55,16,59
Alloa,6567,4,17,8,11,56,45,11,59
Stranraer,6567,5,15,5,16,58,68,-10,50
East Fife,6567,6,14,3,19,51,67,-16,45
Airdrieon,6567,7,10,11,15,45,62,-17,41
Forfar,6567,8,11,5,20,42,64,-22,38
Albion,6567,9,8,7,21,58,79,-21,31
Queen's Park,6567,10,7,10,19,46,73,-27,31
Ayr,6568,1,24,4,8,94,43,51,76
Raith,6568,2,22,8,6,69,37,32,74
Alloa,6568,3,18,8,10,61,44,17,62
Arbroath,6568,4,17,9,10,71,49,22,60
Stranraer,6568,5,16,5,15,59,65,-6,53
Airdrieon,6568,6,11,11,14,47,58,-11,44
East Fife,6568,7,13,3,20,48,68,-20,42
Forfar,6568,8,10,5,21,38,66,-28,35
Albion,6568,9,8,6,22,58,82,-24,30
Queen's Park,6568,10,6,11,19,40,73,-33,29
Ayr,6569,1,24,4,8,93,44,49,76
Raith,6569,2,22,8,6,68,33,35,74
Alloa,6569,3,18,8,10,57,43,14,62
Arbroath,6569,4,17,9,10,72,50,22,60
Stranraer,6569,5,16,5,15,58,64,-6,53
East Fife,6569,6,13,3,20,47,67,-20,42
Airdrieon,6569,7,10,11,15,47,61,-14,41
Forfar,6569,8,11,5,20,41,66,-25,38
Albion,6569,9,8,6,22,59,81,-22,30
Queen's Park,6569,10,6,11,19,41,74,-33,29
Ayr,6570,1,24,4,8,94,42,52,76
Raith,6570,2,22,9,5,70,34,36,75
Arbroath,6570,3,18,8,10,73,48,25,62
Alloa,6570,4,17,9,10,58,45,13,60
Stranraer,6570,5,15,5,16,55,67,-12,50
East Fife,6570,6,14,3,19,50,64,-14,45
Airdrieon,6570,7,10,11,15,45,59,-14,41
Forfar,6570,8,11,5,20,39,64,-25,38
Albion,6570,9,8,6,22,57,82,-25,30
Queen's Park,6570,10,6,10,20,39,75,-36,28
Raith,6571,1,23,8,5,70,33,37,77
Ayr,6571,2,24,4,8,95,43,52,76
Arbroath,6571,3,18,8,10,73,50,23,62
Alloa,6571,4,17,8,11,57,45,12,59
Stranraer,6571,5,15,5,16,55,65,-10,50
East Fife,6571,6,14,3,19,48,64,-16,45
Airdrieon,6571,7,11,11,14,46,58,-12,44
Forfar,6571,8,10,5,21,38,65,-27,35
Albion,6571,9,8,6,22,58,83,-25,30
Queen's Park,6571,10,6,10,20,41,75,-34,28
Raith,6572,1,23,8,5,71,33,38,77
Ayr,6572,2,24,4,8,93,42,51,76
Arbroath,6572,3,18,8,10,74,49,25,62
Alloa,6572,4,17,8,11,57,46,11,59
Stranraer,6572,5,16,5,15,58,66,-8,53
Airdrieon,6572,6,11,11,14,47,59,-12,44
East Fife,6572,7,13,3,20,49,67,-18,42
Forfar,6572,8,10,5,21,39,66,-27,35
Albion,6572,9,8,6,22,57,81,-24,30
Queen's Park,6572,10,6,10,20,40,76,-36,28
Raith,6573,1,23,8,5,71,33,38,77
Ayr,6573,2,24,4,8,96,44,52,76
Arbroath,6573,3,17,9,10,70,48,22,60
Alloa,6573,4,17,8,11,57,46,11,59
Stranraer,6573,5,15,5,16,55,66,-11,50
East Fife,6573,6,14,3,19,49,64,-15,45
Airdrieon,6573,7,11,11,14,47,58,-11,44
Forfar,6573,8,10,5,21,38,66,-28,35
Albion,6573,9,8,6,22,59,84,-25,30
Queen's Park,6573,10,6,11,19,39,72,-33,29
Ayr,6574,1,24,4,8,92,42,50,76
Raith,6574,2,22,8,6,68,33,35,74
Arbroath,6574,3,18,8,10,74,50,24,62
Alloa,6574,4,18,8,10,57,43,14,62
Stranraer,6574,5,15,5,16,56,66,-10,50
East Fife,6574,6,14,3,19,49,65,-16,45
Airdrieon,6574,7,10,11,15,45,59,-14,41
Forfar,6574,8,11,5,20,39,64,-25,38
Albion,6574,9,8,6,22,57,80,-23,30
Queen's Park,6574,10,6,10,20,41,76,-35,28
Ayr,6575,1,24,4,8,92,42,50,76
Raith,6575,2,22,8,6,68,34,34,74
Arbroath,6575,3,18,8,10,72,48,24,62
Alloa,6575,4,18,8,10,58,43,15,62
Stranraer,6575,5,16,5,15,58,65,-7,53
Airdrieon,6575,6,10,12,14,46,59,-13,42
East Fife,6575,7,13,3,20,48,67,-19,42
Forfar,6575,8,10,6,20,39,65,-26,36
Albion,6575,9,8,6,22,57,80,-23,30
Queen's Park,6575,10,6,10,20,39,74,-35,28
Ayr,6576,1,24,4,8,93,42,51,76
Raith,6576,2,22,8,6,68,33,35,74
Alloa,6576,3,18,8,10,57,43,14,62
Arbroath,6576,4,17,8,11,71,51,20,59
Stranraer,6576,5,15,6,15,55,64,-9,51
Airdrieon,6576,6,11,11,14,47,58,-11,44
East Fife,6576,7,13,4,19,47,64,-17,43
Forfar,6576,8,10,5,21,38,66,-28,35
Queen's Park,6576,9,7,10,19,42,73,-31,31
Albion,6576,10,8,6,22,57,81,-24,30
Ayr,6577,1,24,4,8,93,42,51,76
Raith,6577,2,22,8,6,68,33,35,74
Alloa,6577,3,18,8,10,57,43,14,62
Arbroath,6577,4,17,9,10,71,49,22,60
Stranraer,6577,5,15,5,16,55,66,-11,50
East Fife,6577,6,14,3,19,49,64,-15,45
Airdrieon,6577,7,11,11,14,47,58,-11,44
Forfar,6577,8,10,5,21,38,66,-28,35
Albion,6577,9,8,6,22,57,81,-24,30
Queen's Park,6577,10,6,11,19,40,73,-33,29
Raith,6578,1,22,9,5,69,33,36,75
Ayr,6578,2,23,5,8,92,44,48,74
Arbroath,6578,3,18,8,10,74,50,24,62
Alloa,6578,4,17,9,10,57,44,13,60
Stranraer,6578,5,16,5,15,58,65,-7,53
Airdrieon,6578,6,11,11,14,47,58,-11,44
East Fife,6578,7,13,3,20,48,67,-19,42
Forfar,6578,8,10,5,21,38,66,-28,35
Albion,6578,9,8,7,21,59,80,-21,31
Queen's Park,6578,10,6,10,20,41,76,-35,28
Raith,6579,1,23,8,5,71,34,37,77
Ayr,6579,2,24,4,8,94,45,49,76
Arbroath,6579,3,18,8,10,73,48,25,62
Alloa,6579,4,17,8,11,58,46,12,59
Stranraer,6579,5,15,5,16,56,67,-11,50
East Fife,6579,6,14,3,19,50,65,-15,45
Airdrieon,6579,7,10,12,14,45,58,-13,42
Forfar,6579,8,10,6,20,38,64,-26,36
Albion,6579,9,8,6,22,60,82,-22,30
Queen's Park,6579,10,6,10,20,39,75,-36,28
Raith,6580,1,23,8,5,73,32,41,77
Ayr,6580,2,24,4,8,93,43,50,76
Arbroath,6580,3,17,8,11,70,50,20,59
Alloa,6580,4,17,8,11,56,48,8,59
Stranraer,6580,5,15,5,16,56,66,-10,50
East Fife,6580,6,14,3,19,49,65,-16,45
Airdrieon,6580,7,10,11,15,46,61,-15,41
Forfar,6580,8,11,5,20,41,65,-24,38
Queen's Park,6580,9,7,10,19,41,72,-31,31
Albion,6580,10,8,6,22,58,81,-23,30
Raith,6581,1,22,9,5,69,33,36,75
Ayr,6581,2,23,5,8,93,45,48,74
Arbroath,6581,3,17,9,10,72,50,22,60
Alloa,6581,4,17,9,10,57,44,13,60
Stranraer,6581,5,15,5,16,55,66,-11,50
East Fife,6581,6,14,3,19,49,64,-15,45
Airdrieon,6581,7,11,11,14,47,58,-11,44
Forfar,6581,8,10,5,21,38,66,-28,35
Albion,6581,9,8,7,21,60,81,-21,31
Queen's Park,6581,10,6,11,19,41,74,-33,29
Raith,6582,1,23,8,5,70,32,38,77
Ayr,6582,2,23,4,9,90,44,46,73
Arbroath,6582,3,17,9,10,71,49,22,60
Alloa,6582,4,17,8,11,56,45,11,59
Stranraer,6582,5,15,5,16,55,67,-12,50
East Fife,6582,6,14,3,19,50,64,-14,45
Airdrieon,6582,7,10,12,14,46,59,-13,42
Forfar,6582,8,10,6,20,39,65,-26,36
Albion,6582,9,9,6,21,59,78,-19,33
Queen's Park,6582,10,6,11,19,40,73,-33,29
Raith,6583,1,23,8,5,70,32,38,77
Ayr,6583,2,24,4,8,97,45,52,76
Arbroath,6583,3,17,8,11,71,50,21,59
Alloa,6583,4,17,8,11,56,45,11,59
Stranraer,6583,5,15,6,15,55,64,-9,51
Airdrieon,6583,6,11,11,14,47,59,-12,44
East Fife,6583,7,13,4,19,47,64,-17,43
Forfar,6583,8,10,5,21,39,66,-27,35
Queen's Park,6583,9,7,10,19,41,73,-32,31
Albion,6583,10,8,6,22,60,85,-25,30
Raith,6584,1,23,8,5,70,33,37,77
Ayr,6584,2,24,4,8,93,43,50,76
Arbroath,6584,3,17,9,10,71,49,22,60
Alloa,6584,4,17,8,11,57,45,12,59
Stranraer,6584,5,15,5,16,55,66,-11,50
East Fife,6584,6,14,3,19,49,64,-15,45
Airdrieon,6584,7,11,11,14,49,59,-10,44
Forfar,6584,8,10,5,21,39,68,-29,35
Albion,6584,9,8,6,22,58,81,-23,30
Queen's Park,6584,10,6,11,19,40,73,-33,29
Raith,6585,1,23,8,5,69,32,37,77
Ayr,6585,2,24,4,8,97,43,54,76
Arbroath,6585,3,17,8,11,70,50,20,59
Alloa,6585,4,17,8,11,56,44,12,59
Stranraer,6585,5,15,5,16,55,65,-10,50
East Fife,6585,6,14,3,19,48,64,-16,45
Airdrieon,6585,7,11,11,14,47,58,-11,44
Forfar,6585,8,10,5,21,38,66,-28,35
Queen's Park,6585,9,7,10,19,41,72,-31,31
Albion,6585,10,8,6,22,58,85,-27,30
Raith,6586,1,23,8,5,70,32,38,77
Ayr,6586,2,23,5,8,93,45,48,74
Arbroath,6586,3,18,8,10,73,48,25,62
Alloa,6586,4,17,8,11,56,45,11,59
Stranraer,6586,5,15,6,15,56,65,-9,51
Airdrieon,6586,6,11,11,14,50,59,-9,44
East Fife,6586,7,13,4,19,48,65,-17,43
Forfar,6586,8,10,5,21,39,69,-30,35
Albion,6586,9,8,7,21,60,81,-21,31
Queen's Park,6586,10,6,10,20,39,75,-36,28
Ayr,6587,1,24,4,8,95,43,52,76
Raith,6587,2,22,9,5,68,32,36,75
Arbroath,6587,3,18,8,10,73,49,24,62
Alloa,6587,4,17,9,10,56,43,13,60
Stranraer,6587,5,15,6,15,57,66,-9,51
Airdrieon,6587,6,11,11,14,46,58,-12,44
East Fife,6587,7,13,4,19,49,66,-17,43
Forfar,6587,8,10,5,21,38,65,-27,35
Albion,6587,9,8,6,22,58,83,-25,30
Queen's Park,6587,10,6,10,20,40,75,-35,28
Ayr,6588,1,24,4,8,95,44,51,76
Raith,6588,2,22,9,5,69,33,36,75
Arbroath,6588,3,17,9,10,73,51,22,60
Alloa,6588,4,17,9,10,57,44,13,60
Stranraer,6588,5,15,6,15,56,65,-9,51
East Fife,6588,6,13,4,19,48,65,-17,43
Airdrieon,6588,7,10,12,14,46,59,-13,42
Forfar,6588,8,10,6,20,39,65,-26,36
Albion,6588,9,8,6,22,59,83,-24,30
Queen's Park,6588,10,6,11,19,42,75,-33,29
Raith,6589,1,23,8,5,69,32,37,77
Ayr,6589,2,24,4,8,93,44,49,76
Arbroath,6589,3,17,8,11,70,49,21,59
Alloa,6589,4,17,8,11,56,44,12,59
Stranraer,6589,5,15,5,16,58,69,-11,50
East Fife,6589,6,14,3,19,52,67,-15,45
Airdrieon,6589,7,10,12,14,46,59,-13,42
Forfar,6589,8,10,6,20,39,65,-26,36
Queen's Park,6589,9,7,10,19,40,72,-32,31
Albion,6589,10,8,6,22,59,81,-22,30
Raith,6590,1,22,8,6,69,34,35,74
Ayr,6590,2,23,4,9,92,46,46,73
Alloa,6590,3,18,8,10,58,44,14,62
Arbroath,6590,4,17,9,10,72,50,22,60
Stranraer,6590,5,15,5,16,56,67,-11,50
East Fife,6590,6,14,3,19,50,65,-15,45
Airdrieon,6590,7,10,11,15,46,60,-14,41
Forfar,6590,8,11,5,20,40,65,-25,38
Albion,6590,9,9,6,21,61,80,-19,33
Queen's Park,6590,10,6,11,19,41,74,-33,29
Ayr,6591,1,24,4,8,92,43,49,76
Raith,6591,2,22,8,6,68,33,35,74
Alloa,6591,3,18,8,10,57,43,14,62
Arbroath,6591,4,17,8,11,70,50,20,59
Stranraer,6591,5,15,5,16,56,66,-10,50
East Fife,6591,6,14,3,19,49,65,-16,45
Airdrieon,6591,7,11,11,14,46,58,-12,44
Forfar,6591,8,10,5,21,38,65,-27,35
Queen's Park,6591,9,7,10,19,41,72,-31,31
Albion,6591,10,8,6,22,58,80,-22,30
Ayr,6592,1,24,4,8,94,43,51,76
Raith,6592,2,22,9,5,69,33,36,75
Arbroath,6592,3,18,8,10,72,49,23,62
Alloa,6592,4,17,9,10,57,44,13,60
Stranraer,6592,5,15,5,16,56,66,-10,50
East Fife,6592,6,14,3,19,49,65,-16,45
Airdrieon,6592,7,10,11,15,46,63,-17,41
Forfar,6592,8,11,5,20,43,65,-22,38
Albion,6592,9,8,6,22,58,82,-24,30
Queen's Park,6592,10,6,10,20,40,74,-34,28
Raith,6593,1,23,8,5,69,32,37,77
Ayr,6593,2,23,5,8,92,44,48,74
Arbroath,6593,3,17,8,11,71,50,21,59
Alloa,6593,4,17,8,11,56,44,12,59
Stranraer,6593,5,15,5,16,55,65,-10,50
East Fife,6593,6,14,3,19,48,64,-16,45
Airdrieon,6593,7,11,11,14,48,59,-11,44
Forfar,6593,8,10,5,21,39,67,-28,35
Albion,6593,9,8,7,21,59,80,-21,31
Queen's Park,6593,10,7,10,19,41,73,-32,31
Raith,6594,1,23,8,5,70,33,37,77
Ayr,6594,2,24,4,8,94,43,51,76
Arbroath,6594,3,18,8,10,73,48,25,62
Alloa,6594,4,17,8,11,57,45,12,59
Stranraer,6594,5,15,5,16,56,68,-12,50
East Fife,6594,6,14,3,19,51,65,-14,45
Airdrieon,6594,7,10,11,15,47,61,-14,41
Forfar,6594,8,11,5,20,41,66,-25,38
Albion,6594,9,8,6,22,58,82,-24,30
Queen's Park,6594,10,6,10,20,39,75,-36,28
Raith,6595,1,23,8,5,69,32,37,77
Ayr,6595,2,23,5,8,92,44,48,74
Arbroath,6595,3,17,9,10,71,49,22,60
Alloa,6595,4,17,8,11,56,44,12,59
Stranraer,6595,5,16,5,15,58,65,-7,53
Airdrieon,6595,6,10,12,14,46,59,-13,42
East Fife,6595,7,13,3,20,48,67,-19,42
Forfar,6595,8,10,6,20,39,65,-26,36
Albion,6595,9,8,7,21,59,80,-21,31
Queen's Park,6595,10,6,11,19,40,73,-33,29
Ayr,6596,1,24,4,8,94,43,51,76
Raith,6596,2,22,9,5,70,34,36,75
Arbroath,6596,3,18,8,10,74,49,25,62
Alloa,6596,4,17,9,10,58,45,13,60
Stranraer,6596,5,15,5,16,55,67,-12,50
East Fife,6596,6,14,3,19,50,64,-14,45
Airdrieon,6596,7,11,11,14,49,58,-9,44
Forfar,6596,8,10,5,21,38,68,-30,35
Albion,6596,9,8,6,22,58,82,-24,30
Queen's Park,6596,10,6,10,20,40,76,-36,28
Raith,6597,1,23,8,5,70,32,38,77
Ayr,6597,2,23,5,8,93,45,48,74
Arbroath,6597,3,17,8,11,71,50,21,59
Alloa,6597,4,17,8,11,56,45,11,59
Stranraer,6597,5,15,6,15,56,65,-9,51
Airdrieon,6597,6,11,11,14,47,59,-12,44
East Fife,6597,7,13,4,19,48,65,-17,43
Forfar,6597,8,10,5,21,39,66,-27,35
Albion,6597,9,8,7,21,60,81,-21,31
Queen's Park,6597,10,7,10,19,41,73,-32,31
Ayr,6598,1,24,4,8,95,44,51,76
Raith,6598,2,22,8,6,68,33,35,74
Alloa,6598,3,18,8,10,57,43,14,62
Arbroath,6598,4,17,8,11,71,51,20,59
Stranraer,6598,5,16,5,15,57,65,-8,53
Airdrieon,6598,6,11,11,14,47,59,-12,44
East Fife,6598,7,13,3,20,48,66,-18,42
Forfar,6598,8,10,5,21,39,66,-27,35
Queen's Park,6598,9,7,10,19,42,73,-31,31
Albion,6598,10,8,6,22,59,83,-24,30
Raith,6599,1,22,9,5,68,32,36,75
Ayr,6599,2,23,4,9,91,45,46,73
Arbroath,6599,3,17,9,10,71,49,22,60
Alloa,6599,4,17,9,10,56,43,13,60
Stranraer,6599,5,16,5,15,57,65,-8,53
East Fife,6599,6,13,3,20,48,66,-18,42
Airdrieon,6599,7,10,11,15,45,61,-16,41
Forfar,6599,8,11,5,20,41,64,-23,38
Albion,6599,9,9,6,21,60,79,-19,33
Queen's Park,6599,10,6,11,19,40,73,-33,29
Ayr,6600,1,24,4,8,93,44,49,76
Raith,6600,2,22,9,5,70,34,36,75
Arbroath,6600,3,18,8,10,72,49,23,62
Alloa,6600,4,17,9,10,58,45,13,60
Stranraer,6600,5,15,5,16,55,68,-13,50
East Fife,6600,6,14,3,19,51,64,-13,45
Airdrieon,6600,7,10,12,14,46,59,-13,42
Forfar,6600,8,10,6,20,39,65,-26,36
Albion,6600,9,8,6,22,59,81,-22,30
Queen's Park,6600,10,6,10,20,40,74,-34,28
Raith,6601,1,23,8,5,70,33,37,77
Ayr,6601,2,24,4,8,92,43,49,76
Arbroath,6601,3,18,8,10,73,49,24,62
Alloa,6601,4,17,8,11,57,45,12,59
Stranraer,6601,5,16,5,15,59,65,-6,53
Airdrieon,6601,6,11,11,14,49,61,-12,44
East Fife,6601,7,13,3,20,48,68,-20,42
Forfar,6601,8,10,5,21,41,68,-27,35
Albion,6601,9,8,6,22,58,80,-22,30
Queen's Park,6601,10,6,10,20,40,75,-35,28
Raith,6602,1,23,8,5,70,33,37,77
Ayr,6602,2,23,5,8,91,43,48,74
Arbroath,6602,3,18,8,10,73,48,25,62
Alloa,6602,4,17,8,11,57,45,12,59
Stranraer,6602,5,15,5,16,55,66,-11,50
East Fife,6602,6,14,3,19,49,64,-15,45
Airdrieon,6602,7,10,11,15,46,60,-14,41
Forfar,6602,8,11,5,20,40,65,-25,38
Albion,6602,9,8,7,21,58,79,-21,31
Queen's Park,6602,10,6,10,20,39,75,-36,28
Ayr,6603,1,24,4,8,91,42,49,76
Raith,6603,2,22,9,5,68,32,36,75
Alloa,6603,3,17,9,10,56,43,13,60
Arbroath,6603,4,17,8,11,70,50,20,59
Stranraer,6603,5,15,6,15,56,65,-9,51
East Fife,6603,6,13,4,19,48,65,-17,43
Airdrieon,6603,7,10,11,15,46,60,-14,41
Forfar,6603,8,11,5,20,40,65,-25,38
Queen's Park,6603,9,7,10,19,41,72,-31,31
Albion,6603,10,8,6,22,57,79,-22,30
Raith,6604,1,22,8,6,68,35,33,74
Ayr,6604,2,23,4,9,91,47,44,73
Arbroath,6604,3,18,8,10,73,49,24,62
Alloa,6604,4,18,8,10,59,43,16,62
Stranraer,6604,5,15,5,16,57,67,-10,50
East Fife,6604,6,14,3,19,50,66,-16,45
Airdrieon,6604,7,11,11,14,48,58,-10,44
Forfar,6604,8,10,5,21,38,67,-29,35
Albion,6604,9,9,6,21,62,79,-17,33
Queen's Park,6604,10,6,10,20,40,75,-35,28
Raith,6605,1,23,8,5,72,34,38,77
Ayr,6605,2,23,4,9,90,45,45,73
Arbroath,6605,3,17,9,10,71,49,22,60
Alloa,6605,4,17,8,11,58,47,11,59
Stranraer,6605,5,15,6,15,55,64,-9,51
East Fife,6605,6,13,4,19,47,64,-17,43
Airdrieon,6605,7,10,11,15,45,60,-15,41
Forfar,6605,8,11,5,20,40,64,-24,38
Albion,6605,9,9,6,21,60,78,-18,33
Queen's Park,6605,10,6,11,19,40,73,-33,29
Raith,6606,1,23,8,5,70,32,38,77
Ayr,6606,2,24,4,8,94,43,51,76
Arbroath,6606,3,18,8,10,73,48,25,62
Alloa,6606,4,17,8,11,56,45,11,59
Stranraer,6606,5,15,5,16,57,67,-10,50
East Fife,6606,6,14,3,19,50,66,-16,45
Airdrieon,6606,7,11,11,14,48,59,-11,44
Forfar,6606,8,10,5,21,39,67,-28,35
Albion,6606,9,8,6,22,58,82,-24,30
Queen's Park,6606,10,6,10,20,39,75,-36,28
Ayr,6607,1,24,4,8,93,42,51,76
Raith,6607,2,22,9,5,69,33,36,75
Arbroath,6607,3,18,8,10,73,50,23,62
Alloa,6607,4,17,9,10,57,44,13,60
Stranraer,6607,5,15,5,16,57,67,-10,50
East Fife,6607,6,14,3,19,50,66,-16,45
Airdrieon,6607,7,10,12,14,45,58,-13,42
Forfar,6607,8,10,6,20,38,64,-26,36
Albion,6607,9,8,6,22,57,81,-24,30
Queen's Park,6607,10,6,10,20,41,75,-34,28
Raith,6608,1,23,8,5,70,33,37,77
Ayr,6608,2,24,4,8,94,43,51,76
Arbroath,6608,3,17,9,10,71,49,22,60
Alloa,6608,4,17,8,11,57,45,12,59
Stranraer,6608,5,15,5,16,56,66,-10,50
East Fife,6608,6,14,3,19,49,65,-16,45
Airdrieon,6608,7,10,11,15,46,60,-14,41
Forfar,6608,8,11,5,20,40,65,-25,38
Albion,6608,9,8,6,22,58,82,-24,30
Queen's Park,6608,10,6,11,19,40,73,-33,29
Ayr,6609,1,24,4,8,95,42,53,76
Raith,6609,2,22,9,5,68,32,36,75
Arbroath,6609,3,18,8,10,73,50,23,62
Alloa,6609,4,17,9,10,56,43,13,60
Stranraer,6609,5,15,6,15,57,66,-9,51
East Fife,6609,6,13,4,19,49,66,-17,43
Airdrieon,6609,7,10,12,14,45,58,-13,42
Forfar,6609,8,10,6,20,38,64,-26,36
Albion,6609,9,8,6,22,57,83,-26,30
Queen's Park,6609,10,6,10,20,41,75,-34,28
Raith,6610,1,23,8,5,71,33,38,77
Ayr,6610,2,23,5,8,91,43,48,74
Arbroath,6610,3,18,8,10,72,49,23,62
Alloa,6610,4,17,8,11,57,46,11,59
Stranraer,6610,5,15,5,16,55,67,-12,50
East Fife,6610,6,14,3,19,50,64,-14,45
Airdrieon,6610,7,10,11,15,46,61,-15,41
Forfar,6610,8,11,5,20,41,65,-24,38
Albion,6610,9,8,7,21,58,79,-21,31
Queen's Park,6610,10,6,10,20,40,74,-34,28
Raith,6611,1,23,8,5,69,32,37,77
Ayr,6611,2,23,4,9,92,45,47,73
Arbroath,6611,3,17,8,11,70,50,20,59
Alloa,6611,4,17,8,11,56,44,12,59
Stranraer,6611,5,15,5,16,57,67,-10,50
East Fife,6611,6,14,3,19,50,66,-16,45
Airdrieon,6611,7,11,11,14,49,58,-9,44
Forfar,6611,8,10,5,21,38,68,-30,35
Albion,6611,9,9,6,21,60,80,-20,33
Queen's Park,6611,10,7,10,19,41,72,-31,31
Raith,6612,1,23,8,5,69,32,37,77
Ayr,6612,2,23,4,9,91,45,46,73
Arbroath,6612,3,17,9,10,71,49,22,60
Alloa,6612,4,17,8,11,56,44,12,59
Stranraer,6612,5,15,6,15,57,66,-9,51
Airdrieon,6612,6,11,11,14,47,59,-12,44
East Fife,6612,7,13,4,19,49,66,-17,43
Forfar,6612,8,10,5,21,39,66,-27,35
Albion,6612,9,9,6,21,60,79,-19,33
Queen's Park,6612,10,6,11,19,40,73,-33,29
Raith,6613,1,23,8,5,70,32,38,77
Ayr,6613,2,24,4,8,96,44,52,76
Arbroath,6613,3,18,8,10,75,50,25,62
Alloa,6613,4,17,8,11,56,45,11,59
Stranraer,6613,5,15,5,16,55,67,-12,50
East Fife,6613,6,14,3,19,50,64,-14,45
Airdrieon,6613,7,11,11,14,47,58,-11,44
Forfar,6613,8,10,5,21,38,66,-28,35
Albion,6613,9,8,6,22,59,84,-25,30
Queen's Park,6613,10,6,10,20,41,77,-36,28
Ayr,6614,1,24,4,8,92,43,49,76
Raith,6614,2,22,8,6,69,35,34,74
Alloa,6614,3,18,8,10,59,44,15,62
Arbroath,6614,4,17,8,11,70,50,20,59
Stranraer,6614,5,15,5,16,55,68,-13,50
East Fife,6614,6,14,3,19,51,64,-13,45
Airdrieon,6614,7,10,11,15,46,60,-14,41
Forfar,6614,8,11,5,20,40,65,-25,38
Queen's Park,6614,9,7,10,19,41,72,-31,31
Albion,6614,10,8,6,22,58,80,-22,30
Raith,6615,1,23,8,5,69,32,37,77
Ayr,6615,2,24,4,8,95,42,53,76
Arbroath,6615,3,17,8,11,70,49,21,59
Alloa,6615,4,17,8,11,56,44,12,59
Stranraer,6615,5,15,6,15,57,66,-9,51
Airdrieon,6615,6,11,11,14,49,61,-12,44
East Fife,6615,7,13,4,19,49,66,-17,43
Forfar,6615,8,10,5,21,41,68,-27,35
Queen's Park,6615,9,7,10,19,40,72,-32,31
Albion,6615,10,8,6,22,57,83,-26,30
Ayr,6616,1,24,4,8,92,42,50,76
Raith,6616,2,22,9,5,68,32,36,75
Arbroath,6616,3,18,8,10,74,51,23,62
Alloa,6616,4,17,9,10,56,43,13,60
Stranraer,6616,5,15,5,16,55,66,-11,50
East Fife,6616,6,14,3,19,49,64,-15,45
Airdrieon,6616,7,11,11,14,51,59,-8,44
Forfar,6616,8,10,5,21,39,70,-31,35
Albion,6616,9,8,6,22,57,80,-23,30
Queen's Park,6616,10,6,10,20,42,76,-34,28
Raith,6617,1,23,8,5,69,32,37,77
Ayr,6617,2,24,4,8,92,42,50,76
Arbroath,6617,3,17,9,10,71,49,22,60
Alloa,6617,4,17,8,11,56,44,12,59
Stranraer,6617,5,15,5,16,57,67,-10,50
East Fife,6617,6,14,3,19,50,66,-16,45
Airdrieon,6617,7,10,12,14,46,59,-13,42
Forfar,6617,8,10,6,20,39,65,-26,36
Albion,6617,9,8,6,22,57,80,-23,30
Queen's Park,6617,10,6,11,19,40,73,-33,29
Raith,6618,1,23,8,5,71,32,39,77
Ayr,6618,2,24,4,8,98,43,55,76
Arbroath,6618,3,17,9,10,71,49,22,60
Alloa,6618,4,17,8,11,56,46,10,59
Stranraer,6618,5,15,5,16,56,66,-10,50
East Fife,6618,6,14,3,19,49,65,-16,45
Airdrieon,6618,7,11,11,14,47,59,-12,44
Forfar,6618,8,10,5,21,39,66,-27,35
Albion,6618,9,8,6,22,58,86,-28,30
Queen's Park,6618,10,6,11,19,40,73,-33,29
Raith,6619,1,23,8,5,70,33,37,77
Ayr,6619,2,24,4,8,92,43,49,76
Arbroath,6619,3,17,8,11,70,50,20,59
Alloa,6619,4,17,8,11,57,45,12,59
Stranraer,6619,5,15,6,15,55,64,-9,51
East Fife,6619,6,13,4,19,47,64,-17,43
Airdrieon,6619,7,10,11,15,45,61,-16,41
Forfar,6619,8,11,5,20,41,64,-23,38
Queen's Park,6619,9,7,10,19,41,72,-31,31
Albion,6619,10,8,6,22,58,80,-22,30
Raith,6620,1,23,8,5,70,32,38,77
Ayr,6620,2,24,4,8,92,42,50,76
Arbroath,6620,3,18,8,10,73,50,23,62
Alloa,6620,4,17,8,11,56,45,11,59
Stranraer,6620,5,15,5,16,55,70,-15,50
East Fife,6620,6,14,3,19,53,64,-11,45
Airdrieon,6620,7,11,11,14,46,58,-12,44
Forfar,6620,8,10,5,21,38,65,-27,35
Albion,6620,9,8,6,22,57,80,-23,30
Queen's Park,6620,10,6,10,20,41,75,-34,28
Ayr,6621,1,24,4,8,93,43,50,76
Raith,6621,2,22,9,5,69,33,36,75
Arbroath,6621,3,17,9,10,70,48,22,60
Alloa,6621,4,17,9,10,57,44,13,60
Stranraer,6621,5,16,5,15,59,66,-7,53
Airdrieon,6621,6,11,11,14,48,59,-11,44
East Fife,6621,7,13,3,20,49,68,-19,42
Forfar,6621,8,10,5,21,39,67,-28,35
Albion,6621,9,8,6,22,58,81,-23,30
Queen's Park,6621,10,6,11,19,39,72,-33,29
Raith,6622,1,23,8,5,69,32,37,77
Ayr,6622,2,23,4,9,92,45,47,73
Arbroath,6622,3,18,8,10,73,48,25,62
Alloa,6622,4,17,8,11,56,44,12,59
Stranraer,6622,5,15,5,16,55,68,-13,50
East Fife,6622,6,14,3,19,51,64,-13,45
Airdrieon,6622,7,11,11,14,46,58,-12,44
Forfar,6622,8,10,5,21,38,65,-27,35
Albion,6622,9,9,6,21,60,80,-20,33
Queen's Park,6622,10,6,10,20,39,75,-36,28
Raith,6623,1,23,8,5,69,32,37,77
Ayr,6623,2,24,4,8,93,42,51,76
Arbroath,6623,3,18,8,10,72,49,23,62
Alloa,6623,4,17,8,11,56,44,12,59
Stranraer,6623,5,15,6,15,55,64,-9,51
Airdrieon,6623,6,11,11,14,48,58,-10,44
East Fife,6623,7,13,4,19,47,64,-17,43
Forfar,6623,8,10,5,21,38,67,-29,35
Albion,6623,9,8,6,22,57,81,-24,30
Queen's Park,6623,10,6,10,20,40,74,-34,28
Raith,6624,1,23,8,5,69,32,37,77
Ayr,6624,2,23,4,9,91,44,47,73
Arbroath,6624,3,18,8,10,72,49,23,62
Alloa,6624,4,17,8,11,56,44,12,59
Stranraer,6624,5,15,6,15,57,66,-9,51
Airdrieon,6624,6,11,11,14,47,59,-12,44
East Fife,6624,7,13,4,19,49,66,-17,43
Forfar,6624,8,10,5,21,39,66,-27,35
Albion,6624,9,9,6,21,59,79,-20,33
Queen's Park,6624,10,6,10,20,40,74,-34,28
Ayr,6625,1,24,4,8,93,43,50,76
Raith,6625,2,22,9,5,69,33,36,75
Arbroath,6625,3,17,9,10,71,49,22,60
Alloa,6625,4,17,9,10,57,44,13,60
Stranraer,6625,5,16,5,15,56,64,-8,53
Airdrieon,6625,6,11,11,14,48,59,-11,44
East Fife,6625,7,13,3,20,47,65,-18,42
Forfar,6625,8,10,5,21,39,67,-28,35
Albion,6625,9,8,6,22,58,81,-23,30
Queen's Park,6625,10,6,11,19,40,73,-33,29
Ayr,6626,1,24,4,8,95,43,52,76
Raith,6626,2,22,8,6,71,36,35,74
Arbroath,6626,3,18,8,10,73,48,25,62
Alloa,6626,4,18,8,10,60,46,14,62
Stranraer,6626,5,16,5,15,56,64,-8,53
Airdrieon,6626,6,11,11,14,48,59,-11,44
East Fife,6626,7,13,3,20,47,65,-18,42
Forfar,6626,8,10,5,21,39,67,-28,35
Albion,6626,9,8,6,22,58,83,-25,30
Queen's Park,6626,10,6,10,20,39,75,-36,28
Raith,6627,1,23,8,5,71,34,37,77
Ayr,6627,2,24,4,8,96,44,52,76
Arbroath,6627,3,17,9,10,72,50,22,60
Alloa,6627,4,17,8,11,58,46,12,59
Stranraer,6627,5,15,6,15,56,65,-9,51
East Fife,6627,6,13,4,19,48,65,-17,43
Airdrieon,6627,7,10,12,14,45,58,-13,42
Forfar,6627,8,10,6,20,38,64,-26,36
Albion,6627,9,8,6,22,59,84,-25,30
Queen's Park,6627,10,6,11,19,41,74,-33,29
Raith,6628,1,23,8,5,70,33,37,77
Ayr,6628,2,24,4,8,94,43,51,76
Arbroath,6628,3,17,8,11,71,51,20,59
Alloa,6628,4,17,8,11,57,45,12,59
Stranraer,6628,5,15,5,16,55,66,-11,50
East Fife,6628,6,14,3,19,49,64,-15,45
Airdrieon,6628,7,10,11,15,45,59,-14,41
Forfar,6628,8,11,5,20,39,64,-25,38
Queen's Park,6628,9,7,10,19,42,73,-31,31
Albion,6628,10,8,6,22,58,82,-24,30
Raith,6629,1,23,8,5,70,33,37,77
Ayr,6629,2,24,4,8,93,42,51,76
Arbroath,6629,3,17,9,10,74,52,22,60
Alloa,6629,4,17,8,11,57,45,12,59
Stranraer,6629,5,16,5,15,57,65,-8,53
Airdrieon,6629,6,11,11,14,48,58,-10,44
East Fife,6629,7,13,3,20,48,66,-18,42
Forfar,6629,8,10,5,21,38,67,-29,35
Albion,6629,9,8,6,22,57,81,-24,30
Queen's Park,6629,10,6,11,19,43,76,-33,29
Ayr,6630,1,24,4,8,95,45,50,76
Raith,6630,2,22,9,5,71,35,36,75
Arbroath,6630,3,18,8,10,73,49,24,62
Alloa,6630,4,17,9,10,59,46,13,60
Stranraer,6630,5,15,5,16,56,66,-10,50
East Fife,6630,6,14,3,19,49,65,-16,45
Airdrieon,6630,7,10,11,15,45,59,-14,41
Forfar,6630,8,11,5,20,39,64,-25,38
Albion,6630,9,8,6,22,60,83,-23,30
Queen's Park,6630,10,6,10,20,40,75,-35,28
Ayr,6631,1,24,4,8,94,45,49,76
Raith,6631,2,22,8,6,69,34,35,74
Arbroath,6631,3,18,8,10,73,50,23,62
Alloa,6631,4,18,8,10,58,44,14,62
Stranraer,6631,5,16,5,15,57,64,-7,53
Airdrieon,6631,6,11,11,14,47,59,-12,44
East Fife,6631,7,13,3,20,47,66,-19,42
Forfar,6631,8,10,5,21,39,66,-27,35
Albion,6631,9,8,6,22,60,82,-22,30
Queen's Park,6631,10,6,10,20,41,75,-34,28
Ayr,6632,1,24,4,8,91,42,49,76
Raith,6632,2,22,9,5,70,34,36,75
Alloa,6632,3,17,9,10,58,45,13,60
Arbroath,6632,4,17,8,11,71,53,18,59
Stranraer,6632,5,16,5,15,58,65,-7,53
Airdrieon,6632,6,11,11,14,48,58,-10,44
East Fife,6632,7,13,3,20,48,67,-19,42
Forfar,6632,8,10,5,21,38,67,-29,35
Queen's Park,6632,9,7,10,19,44,73,-29,31
Albion,6632,10,8,6,22,57,79,-22,30
Ayr,6633,1,24,4,8,92,43,49,76
Raith,6633,2,22,9,5,69,33,36,75
Arbroath,6633,3,18,8,10,74,49,25,62
Alloa,6633,4,17,9,10,57,44,13,60
Stranraer,6633,5,15,5,16,55,67,-12,50
East Fife,6633,6,14,3,19,50,64,-14,45
Airdrieon,6633,7,11,11,14,48,60,-12,44
Forfar,6633,8,10,5,21,40,67,-27,35
Albion,6633,9,8,6,22,58,80,-22,30
Queen's Park,6633,10,6,10,20,40,76,-36,28
Raith,6634,1,23,8,5,69,32,37,77
Ayr,6634,2,24,4,8,92,42,50,76
Arbroath,6634,3,18,8,10,73,49,24,62
Alloa,6634,4,17,8,11,56,44,12,59
Stranraer,6634,5,15,5,16,56,66,-10,50
East Fife,6634,6,14,3,19,49,65,-16,45
Airdrieon,6634,7,10,12,14,45,58,-13,42
Forfar,6634,8,10,6,20,38,64,-26,36
Albion,6634,9,8,6,22,57,80,-23,30
Queen's Park,6634,10,6,10,20,40,75,-35,28
Raith,6635,1,23,8,5,70,32,38,77
Ayr,6635,2,24,4,8,92,42,50,76
Arbroath,6635,3,17,8,11,70,50,20,59
Alloa,6635,4,17,8,11,56,45,11,59
Stranraer,6635,5,16,5,15,58,66,-8,53
Airdrieon,6635,6,11,11,14,47,58,-11,44
East Fife,6635,7,13,3,20,49,67,-18,42
Forfar,6635,8,10,5,21,38,66,-28,35
Queen's Park,6635,9,7,10,19,41,72,-31,31
Albion,6635,10,8,6,22,57,80,-23,30
Raith,6636,1,23,8,5,71,32,39,77
Ayr,6636,2,24,4,8,94,43,51,76
Arbroath,6636,3,18,8,10,73,49,24,62
Alloa,6636,4,17,8,11,56,46,10,59
Stranraer,6636,5,15,5,16,57,67,-10,50
East Fife,6636,6,14,3,19,50,66,-16,45
Airdrieon,6636,7,10,11,15,46,63,-17,41
Forfar,6636,8,11,5,20,43,65,-22,38
Albion,6636,9,8,6,22,58,82,-24,30
Queen's Park,6636,10,6,10,20,40,75,-35,28
Raith,6637,1,23,8,5,70,32,38,77
Ayr,6637,2,24,4,8,94,43,51,76
Arbroath,6637,3,17,8,11,70,49,21,59
Alloa,6637,4,17,8,11,56,45,11,59
Stranraer,6637,5,15,5,16,57,68,-11,50
East Fife,6637,6,14,3,19,51,66,-15,45
Airdrieon,6637,7,10,11,15,45,60,-15,41
Forfar,6637,8,11,5,20,40,64,-24,38
Queen's Park,6637,9,7,10,19,40,72,-32,31
Albion,6637,10,8,6,22,58,82,-24,30
Ayr,6638,1,24,4,8,94,42,52,76
Raith,6638,2,22,9,5,69,33,36,75
Alloa,6638,3,17,9,10,57,44,13,60
Arbroath,6638,4,17,8,11,70,50,20,59
Stranraer,6638,5,15,5,16,55,66,-11,50
East Fife,6638,6,14,3,19,49,64,-15,45
Airdrieon,6638,7,10,11,15,46,60,-14,41
Forfar,6638,8,11,5,20,40,65,-25,38
Queen's Park,6638,9,7,10,19,41,72,-31,31
Albion,6638,10,8,6,22,57,82,-25,30
Ayr,6639,1,24,4,8,94,42,52,76
Raith,6639,2,22,9,5,68,32,36,75
Arbroath,6639,3,18,8,10,71,48,23,62
Alloa,6639,4,17,9,10,56,43,13,60
Stranraer,6639,5,16,5,15,58,65,-7,53
Airdrieon,6639,6,11,11,14,49,60,-11,44
East Fife,6639,7,13,3,20,48,67,-19,42
Forfar,6639,8,10,5,21,40,68,-28,35
Albion,6639,9,8,6,22,57,82,-25,30
Queen's Park,6639,10,6,10,20,39,73,-34,28
Raith,6640,1,23,8,5,73,32,41,77
Ayr,6640,2,23,5,8,93,45,48,74
Arbroath,6640,3,17,9,10,70,48,22,60
Alloa,6640,4,17,8,11,56,48,8,59
Stranraer,6640,5,16,5,15,56,64,-8,53
Airdrieon,6640,6,11,11,14,47,59,-12,44
East Fife,6640,7,13,3,20,47,65,-18,42
Forfar,6640,8,10,5,21,39,66,-27,35
Albion,6640,9,8,7,21,60,81,-21,31
Queen's Park,6640,10,6,11,19,39,72,-33,29
Raith,6641,1,23,8,5,71,32,39,77
Ayr,6641,2,23,5,8,91,43,48,74
Arbroath,6641,3,17,8,11,70,51,19,59
Alloa,6641,4,17,8,11,56,46,10,59
Stranraer,6641,5,16,5,15,58,65,-7,53
Airdrieon,6641,6,10,12,14,47,60,-13,42
East Fife,6641,7,13,3,20,48,67,-19,42
Forfar,6641,8,10,6,20,40,66,-26,36
Albion,6641,9,8,7,21,58,79,-21,31
Queen's Park,6641,10,7,10,19,42,72,-30,31
Raith,6642,1,23,8,5,72,34,38,77
Ayr,6642,2,24,4,8,96,43,53,76
Arbroath,6642,3,17,8,11,71,51,20,59
Alloa,6642,4,17,8,11,58,47,11,59
Stranraer,6642,5,15,5,16,55,65,-10,50
East Fife,6642,6,14,3,19,48,64,-16,45
Airdrieon,6642,7,11,11,14,48,58,-10,44
Forfar,6642,8,10,5,21,38,67,-29,35
Queen's Park,6642,9,7,10,19,42,73,-31,31
Albion,6642,10,8,6,22,58,84,-26,30
Raith,6643,1,23,8,5,71,34,37,77
Ayr,6643,2,23,5,8,92,44,48,74
Arbroath,6643,3,17,8,11,70,49,21,59
Alloa,6643,4,17,8,11,58,46,12,59
Stranraer,6643,5,16,5,15,56,64,-8,53
Airdrieon,6643,6,11,11,14,48,59,-11,44
East Fife,6643,7,13,3,20,47,65,-18,42
Forfar,6643,8,10,5,21,39,67,-28,35
Albion,6643,9,8,7,21,59,80,-21,31
Queen's Park,6643,10,7,10,19,40,72,-32,31
Ayr,6644,1,24,4,8,94,44,50,76
Raith,6644,2,22,8,6,69,34,35,74
Alloa,6644,3,18,8,10,58,44,14,62
Arbroath,6644,4,17,9,10,72,50,22,60
Stranraer,6644,5,15,5,16,56,67,-11,50
East Fife,6644,6,14,3,19,50,65,-15,45
Airdrieon,6644,7,11,11,14,48,58,-10,44
Forfar,6644,8,10,5,21,38,67,-29,35
Albion,6644,9,8,6,22,59,82,-23,30
Queen's Park,6644,10,6,11,19,41,74,-33,29
Ayr,6645,1,24,4,8,94,43,51,76
Raith,6645,2,22,8,6,68,34,34,74
Alloa,6645,3,18,8,10,58,43,15,62
Arbroath,6645,4,17,9,10,71,49,22,60
Stranraer,6645,5,15,5,16,56,66,-10,50
East Fife,6645,6,14,3,19,49,65,-16,45
Airdrieon,6645,7,11,11,14,47,58,-11,44
Forfar,6645,8,10,5,21,38,66,-28,35
Albion,6645,9,8,6,22,58,82,-24,30
Queen's Park,6645,10,6,11,19,40,73,-33,29
Raith,6646,1,23,8,5,70,33,37,77
Ayr,6646,2,24,4,8,96,42,54,76
Arbroath,6646,3,18,8,10,72,48,24,62
Alloa,6646,4,17,8,11,57,45,12,59
Stranraer,6646,5,15,6,15,56,65,-9,51
Airdrieon,6646,6,11,11,14,47,58,-11,44
East Fife,6646,7,13,4,19,48,65,-17,43
Forfar,6646,8,10,5,21,38,66,-28,35
Albion,6646,9,8,6,22,57,84,-27,30
Queen's Park,6646,10,6,10,20,39,74,-35,28
Raith,6647,1,23,8,5,70,32,38,77
Ayr,6647,2,24,4,8,94,44,50,76
Arbroath,6647,3,18,8,10,74,49,25,62
Alloa,6647,4,17,8,11,56,45,11,59
Stranraer,6647,5,15,5,16,55,67,-12,50
East Fife,6647,6,14,3,19,50,64,-14,45
Airdrieon,6647,7,11,11,14,48,58,-10,44
Forfar,6647,8,10,5,21,38,67,-29,35
Albion,6647,9,8,6,22,59,82,-23,30
Queen's Park,6647,10,6,10,20,40,76,-36,28
Ayr,6648,1,24,4,8,97,42,55,76
Raith,6648,2,22,9,5,68,32,36,75
Arbroath,6648,3,18,8,10,71,48,23,62
Alloa,6648,4,17,9,10,56,43,13,60
Stranraer,6648,5,16,5,15,59,64,-5,53
Airdrieon,6648,6,11,11,14,47,59,-12,44
East Fife,6648,7,13,3,20,47,68,-21,42
Forfar,6648,8,10,5,21,39,66,-27,35
Albion,6648,9,8,6,22,57,85,-28,30
Queen's Park,6648,10,6,10,20,39,73,-34,28
Ayr,6649,1,24,4,8,94,44,50,76
Raith,6649,2,22,8,6,68,33,35,74
Arbroath,6649,3,18,8,10,72,48,24,62
Alloa,6649,4,18,8,10,57,43,14,62
Stranraer,6649,5,15,5,16,56,66,-10,50
East Fife,6649,6,14,3,19,49,65,-16,45
Airdrieon,6649,7,10,12,14,46,59,-13,42
Forfar,6649,8,10,6,20,39,65,-26,36
Albion,6649,9,8,6,22,59,82,-23,30
Queen's Park,6649,10,6,10,20,39,74,-35,28
Ayr,6650,1,24,4,8,94,43,51,76
Raith,6650,2,22,8,6,70,35,35,74
Arbroath,6650,3,18,8,10,72,48,24,62
Alloa,6650,4,18,8,10,59,45,14,62
Stranraer,6650,5,15,6,15,55,64,-9,51
Airdrieon,6650,6,11,11,14,46,58,-12,44
East Fife,6650,7,13,4,19,47,64,-17,43
Forfar,6650,8,10,5,21,38,65,-27,35
Albion,6650,9,8,6,22,58,82,-24,30
Queen's Park,6650,10,6,10,20,39,74,-35,28
Raith,6651,1,23,8,5,70,33,37,77
Ayr,6651,2,24,4,8,97,44,53,76
Arbroath,6651,3,17,8,11,71,50,21,59
Alloa,6651,4,17,8,11,57,45,12,59
Stranraer,6651,5,16,5,15,58,64,-6,53
Airdrieon,6651,6,10,12,14,45,58,-13,42
East Fife,6651,7,13,3,20,47,67,-20,42
Forfar,6651,8,10,6,20,38,64,-26,36
Queen's Park,6651,9,7,10,19,41,73,-32,31
Albion,6651,10,8,6,22,59,85,-26,30
Raith,6652,1,23,8,5,71,32,39,77
Ayr,6652,2,24,4,8,94,44,50,76
Arbroath,6652,3,18,8,10,73,49,24,62
Alloa,6652,4,17,8,11,56,46,10,59
Stranraer,6652,5,16,5,15,57,64,-7,53
Airdrieon,6652,6,11,11,14,46,58,-12,44
East Fife,6652,7,13,3,20,47,66,-19,42
Forfar,6652,8,10,5,21,38,65,-27,35
Albion,6652,9,8,6,22,59,82,-23,30
Queen's Park,6652,10,6,10,20,40,75,-35,28
Raith,6653,1,23,8,5,72,33,39,77
Ayr,6653,2,24,4,8,94,45,49,76
Arbroath,6653,3,18,8,10,71,48,23,62
Alloa,6653,4,17,8,11,57,47,10,59
Stranraer,6653,5,16,5,15,58,66,-8,53
Airdrieon,6653,6,11,11,14,47,58,-11,44
East Fife,6653,7,13,3,20,49,67,-18,42
Forfar,6653,8,10,5,21,38,66,-28,35
Albion,6653,9,8,6,22,60,82,-22,30
Queen's Park,6653,10,6,10,20,39,73,-34,28
Ayr,6654,1,24,4,8,96,43,53,76
Raith,6654,2,22,9,5,69,33,36,75
Arbroath,6654,3,18,8,10,75,51,24,62
Alloa,6654,4,17,9,10,57,44,13,60
Stranraer,6654,5,15,6,15,56,65,-9,51
Airdrieon,6654,6,11,11,14,47,58,-11,44
East Fife,6654,7,13,4,19,48,65,-17,43
Forfar,6654,8,10,5,21,38,66,-28,35
Albion,6654,9,8,6,22,58,84,-26,30
Queen's Park,6654,10,6,10,20,42,77,-35,28
Raith,6655,1,23,8,5,71,34,37,77
Ayr,6655,2,24,4,8,96,42,54,76
Arbroath,6655,3,18,8,10,72,48,24,62
Alloa,6655,4,17,8,11,58,46,12,59
Stranraer,6655,5,15,5,16,56,67,-11,50
East Fife,6655,6,14,3,19,50,65,-15,45
Airdrieon,6655,7,11,11,14,47,58,-11,44
Forfar,6655,8,10,5,21,38,66,-28,35
Albion,6655,9,8,6,22,57,84,-27,30
Queen's Park,6655,10,6,10,20,39,74,-35,28
Raith,6656,1,23,8,5,71,34,37,77
Ayr,6656,2,24,4,8,93,44,49,76
Arbroath,6656,3,17,9,10,72,50,22,60
Alloa,6656,4,17,8,11,58,46,12,59
Stranraer,6656,5,15,6,15,55,64,-9,51
Airdrieon,6656,6,11,11,14,47,58,-11,44
East Fife,6656,7,13,4,19,47,64,-17,43
Forfar,6656,8,10,5,21,38,66,-28,35
Albion,6656,9,8,6,22,59,81,-22,30
Queen's Park,6656,10,6,11,19,41,74,-33,29
Ayr,6657,1,24,4,8,94,44,50,76
Raith,6657,2,22,9,5,69,33,36,75
Arbroath,6657,3,18,8,10,75,50,25,62
Alloa,6657,4,17,9,10,57,44,13,60
Stranraer,6657,5,15,5,16,56,68,-12,50
East Fife,6657,6,14,3,19,51,65,-14,45
Airdrieon,6657,7,11,11,14,52,58,-6,44
Forfar,6657,8,10,5,21,38,71,-33,35
Albion,6657,9,8,6,22,59,82,-23,30
Queen's Park,6657,10,6,10,20,41,77,-36,28
Raith,6658,1,23,8,5,70,32,38,77
Ayr,6658,2,24,4,8,93,44,49,76
Arbroath,6658,3,18,8,10,72,49,23,62
Alloa,6658,4,17,8,11,56,45,11,59
Stranraer,6658,5,15,5,16,55,67,-12,50
East Fife,6658,6,14,3,19,50,64,-14,45
Airdrieon,6658,7,10,12,14,47,60,-13,42
Forfar,6658,8,10,6,20,40,66,-26,36
Albion,6658,9,8,6,22,59,81,-22,30
Queen's Park,6658,10,6,10,20,40,74,-34,28
Raith,6659,1,23,8,5,72,33,39,77
Ayr,6659,2,23,4,9,91,44,47,73
Arbroath,6659,3,18,8,10,72,48,24,62
Alloa,6659,4,17,8,11,57,47,10,59
Stranraer,6659,5,15,5,16,56,67,-11,50
East Fife,6659,6,14,3,19,50,65,-15,45
Airdrieon,6659,7,10,12,14,46,59,-13,42
Forfar,6659,8,10,6,20,39,65,-26,36
Albion,6659,9,9,6,21,59,79,-20,33
Queen's Park,6659,10,6,10,20,39,74,-35,28
Raith,6660,1,23,8,5,71,34,37,77
Ayr,6660,2,24,4,8,95,42,53,76
Arbroath,6660,3,18,8,10,74,49,25,62
Alloa,6660,4,17,8,11,58,46,12,59
Stranraer,6660,5,16,5,15,56,64,-8,53
Airdrieon,6660,6,11,11,14,49,58,-9,44
East Fife,6660,7,13,3,20,47,65,-18,42
Forfar,6660,8,10,5,21,38,68,-30,35
Albion,6660,9,8,6,22,57,83,-26,30
Queen's Park,6660,10,6,10,20,40,76,-36,28
Ayr,6661,1,24,4,8,95,44,51,76
Raith,6661,2,22,8,6,68,36,32,74
Arbroath,6661,3,18,8,10,72,49,23,62
Alloa,6661,4,18,8,10,60,43,17,62
Stranraer,6661,5,15,6,15,56,65,-9,51
Airdrieon,6661,6,11,11,14,47,59,-12,44
East Fife,6661,7,13,4,19,48,65,-17,43
Forfar,6661,8,10,5,21,39,66,-27,35
Albion,6661,9,8,6,22,59,83,-24,30
Queen's Park,6661,10,6,10,20,40,74,-34,28
Raith,6662,1,23,8,5,69,32,37,77
Ayr,6662,2,24,4,8,94,43,51,76
Arbroath,6662,3,17,9,10,71,49,22,60
Alloa,6662,4,17,8,11,56,44,12,59
Stranraer,6662,5,16,5,15,56,64,-8,53
Airdrieon,6662,6,11,11,14,47,59,-12,44
East Fife,6662,7,13,3,20,47,65,-18,42
Forfar,6662,8,10,5,21,39,66,-27,35
Albion,6662,9,8,6,22,58,82,-24,30
Queen's Park,6662,10,6,11,19,40,73,-33,29
Raith,6663,1,23,8,5,69,32,37,77
Ayr,6663,2,24,4,8,95,42,53,76
Arbroath,6663,3,18,8,10,71,48,23,62
Alloa,6663,4,17,8,11,56,44,12,59
Stranraer,6663,5,16,5,15,57,64,-7,53
Airdrieon,6663,6,10,12,14,46,59,-13,42
East Fife,6663,7,13,3,20,47,66,-19,42
Forfar,6663,8,10,6,20,39,65,-26,36
Albion,6663,9,8,6,22,57,83,-26,30
Queen's Park,6663,10,6,10,20,39,73,-34,28
Ayr,6664,1,24,4,8,95,42,53,76
Raith,6664,2,22,9,5,70,34,36,75
Arbroath,6664,3,17,9,10,70,48,22,60
Alloa,6664,4,17,9,10,58,45,13,60
Stranraer,6664,5,16,5,15,57,65,-8,53
Airdrieon,6664,6,11,11,14,47,59,-12,44
East Fife,6664,7,13,3,20,48,66,-18,42
Forfar,6664,8,10,5,21,39,66,-27,35
Albion,6664,9,8,6,22,57,83,-26,30
Queen's Park,6664,10,6,11,19,39,72,-33,29
Raith,6665,1,23,8,5,73,33,40,77
Ayr,6665,2,24,4,8,96,42,54,76
Arbroath,6665,3,18,8,10,72,49,23,62
Alloa,6665,4,17,8,11,57,48,9,59
Stranraer,6665,5,15,5,16,56,66,-10,50
East Fife,6665,6,14,3,19,49,65,-16,45
Airdrieon,6665,7,10,11,15,45,60,-15,41
Forfar,6665,8,11,5,20,40,64,-24,38
Albion,6665,9,8,6,22,57,84,-27,30
Queen's Park,6665,10,6,10,20,40,74,-34,28
Raith,6666,1,23,8,5,70,32,38,77
Ayr,6666,2,24,4,8,95,44,51,76
Arbroath,6666,3,18,8,10,74,49,25,62
Alloa,6666,4,17,8,11,56,45,11,59
Stranraer,6666,5,15,5,16,55,69,-14,50
East Fife,6666,6,14,3,19,52,64,-12,45
Airdrieon,6666,7,10,11,15,46,60,-14,41
Forfar,6666,8,11,5,20,40,65,-25,38
Albion,6666,9,8,6,22,59,83,-24,30
Queen's Park,6666,10,6,10,20,40,76,-36,28
Raith,6667,1,23,8,5,70,33,37,77
Ayr,6667,2,24,4,8,96,44,52,76
Arbroath,6667,3,18,8,10,72,49,23,62
Alloa,6667,4,17,8,11,57,45,12,59
Stranraer,6667,5,15,5,16,56,66,-10,50
East Fife,6667,6,14,3,19,49,65,-16,45
Airdrieon,6667,7,11,11,14,47,59,-12,44
Forfar,6667,8,10,5,21,39,66,-27,35
Albion,6667,9,8,6,22,59,84,-25,30
Queen's Park,6667,10,6,10,20,40,74,-34,28
Raith,6668,1,23,8,5,70,32,38,77
Ayr,6668,2,24,4,8,95,43,52,76
Arbroath,6668,3,17,9,10,70,48,22,60
Alloa,6668,4,17,8,11,56,45,11,59
Stranraer,6668,5,15,5,16,56,67,-11,50
East Fife,6668,6,14,3,19,50,65,-15,45
Airdrieon,6668,7,11,11,14,51,59,-8,44
Forfar,6668,8,10,5,21,39,70,-31,35
Albion,6668,9,8,6,22,58,83,-25,30
Queen's Park,6668,10,6,11,19,39,72,-33,29
Raith,6669,1,23,8,5,71,33,38,77
Ayr,6669,2,24,4,8,92,42,50,76
Arbroath,6669,3,18,8,10,73,49,24,62
Alloa,6669,4,17,8,11,57,46,11,59
Stranraer,6669,5,15,5,16,55,65,-10,50
East Fife,6669,6,14,3,19,48,64,-16,45
Airdrieon,6669,7,10,12,14,45,58,-13,42
Forfar,6669,8,10,6,20,38,64,-26,36
Albion,6669,9,8,6,22,57,80,-23,30
Queen's Park,6669,10,6,10,20,40,75,-35,28
Raith,6670,1,23,8,5,70,33,37,77
Ayr,6670,2,24,4,8,95,42,53,76
Arbroath,6670,3,18,8,10,72,48,24,62
Alloa,6670,4,17,8,11,57,45,12,59
Stranraer,6670,5,15,5,16,55,65,-10,50
East Fife,6670,6,14,3,19,48,64,-16,45
Airdrieon,6670,7,10,12,14,46,59,-13,42
Forfar,6670,8,10,6,20,39,65,-26,36
Albion,6670,9,8,6,22,57,83,-26,30
Queen's Park,6670,10,6,10,20,39,74,-35,28
Ayr,6671,1,24,4,8,96,44,52,76
Raith,6671,2,22,8,6,69,34,35,74
Arbroath,6671,3,18,8,10,71,48,23,62
Alloa,6671,4,18,8,10,58,44,14,62
Stranraer,6671,5,15,6,15,56,65,-9,51
East Fife,6671,6,13,4,19,48,65,-17,43
Airdrieon,6671,7,10,12,14,46,59,-13,42
Forfar,6671,8,10,6,20,39,65,-26,36
Albion,6671,9,8,6,22,59,84,-25,30
Queen's Park,6671,10,6,10,20,39,73,-34,28
Ayr,6672,1,24,4,8,91,42,49,76
Raith,6672,2,22,8,6,68,34,34,74
Alloa,6672,3,18,8,10,58,43,15,62
Arbroath,6672,4,17,9,10,71,49,22,60
Stranraer,6672,5,15,5,16,56,68,-12,50
East Fife,6672,6,14,3,19,51,65,-14,45
Airdrieon,6672,7,11,11,14,47,59,-12,44
Forfar,6672,8,10,5,21,39,66,-27,35
Albion,6672,9,8,6,22,57,79,-22,30
Queen's Park,6672,10,6,11,19,40,73,-33,29
Raith,6673,1,23,8,5,70,33,37,77
Ayr,6673,2,24,4,8,92,43,49,76
Arbroath,6673,3,18,8,10,72,49,23,62
Alloa,6673,4,17,8,11,57,45,12,59
Stranraer,6673,5,16,5,15,57,64,-7,53
Airdrieon,6673,6,10,12,14,47,60,-13,42
East Fife,6673,7,13,3,20,47,66,-19,42
Forfar,6673,8,10,6,20,40,66,-26,36
Albion,6673,9,8,6,22,58,80,-22,30
Queen's Park,6673,10,6,10,20,40,74,-34,28
Raith,6674,1,23,8,5,70,33,37,77
Ayr,6674,2,23,5,8,91,43,48,74
Arbroath,6674,3,18,8,10,73,49,24,62
Alloa,6674,4,17,8,11,57,45,12,59
Stranraer,6674,5,15,6,15,57,66,-9,51
Airdrieon,6674,6,11,11,14,48,58,-10,44
East Fife,6674,7,13,4,19,49,66,-17,43
Forfar,6674,8,10,5,21,38,67,-29,35
Albion,6674,9,8,7,21,58,79,-21,31
Queen's Park,6674,10,6,10,20,40,75,-35,28
Ayr,6675,1,24,4,8,92,42,50,76
Raith,6675,2,22,8,6,68,35,33,74
Alloa,6675,3,18,8,10,59,43,16,62
Arbroath,6675,4,17,9,10,73,51,22,60
Stranraer,6675,5,15,6,15,56,65,-9,51
East Fife,6675,6,13,4,19,48,65,-17,43
Airdrieon,6675,7,10,12,14,46,59,-13,42
Forfar,6675,8,10,6,20,39,65,-26,36
Albion,6675,9,8,6,22,57,80,-23,30
Queen's Park,6675,10,6,11,19,42,75,-33,29
Raith,6676,1,23,8,5,69,32,37,77
Ayr,6676,2,24,4,8,91,42,49,76
Arbroath,6676,3,17,8,11,72,51,21,59
Alloa,6676,4,17,8,11,56,44,12,59
Stranraer,6676,5,15,6,15,56,65,-9,51
East Fife,6676,6,13,4,19,48,65,-17,43
Airdrieon,6676,7,10,11,15,46,60,-14,41
Forfar,6676,8,11,5,20,40,65,-25,38
Queen's Park,6676,9,7,10,19,42,74,-32,31
Albion,6676,10,8,6,22,57,79,-22,30
Raith,6677,1,23,8,5,71,32,39,77
Ayr,6677,2,24,4,8,93,43,50,76
Arbroath,6677,3,18,8,10,72,49,23,62
Alloa,6677,4,17,8,11,56,46,10,59
Stranraer,6677,5,15,5,16,56,66,-10,50
East Fife,6677,6,14,3,19,49,65,-16,45
Airdrieon,6677,7,10,11,15,45,59,-14,41
Forfar,6677,8,11,5,20,39,64,-25,38
Albion,6677,9,8,6,22,58,81,-23,30
Queen's Park,6677,10,6,10,20,40,74,-34,28
Raith,6678,1,23,8,5,74,32,42,77
Ayr,6678,2,23,5,8,92,44,48,74
Arbroath,6678,3,17,8,11,71,51,20,59
Alloa,6678,4,17,8,11,56,49,7,59
Stranraer,6678,5,15,5,16,56,68,-12,50
East Fife,6678,6,14,3,19,51,65,-14,45
Airdrieon,6678,7,10,12,14,45,58,-13,42
Forfar,6678,8,10,6,20,38,64,-26,36
Albion,6678,9,8,7,21,59,80,-21,31
Queen's Park,6678,10,7,10,19,42,73,-31,31
Ayr,6679,1,24,4,8,94,42,52,76
Raith,6679,2,22,9,5,70,34,36,75
Arbroath,6679,3,17,9,10,73,51,22,60
Alloa,6679,4,17,9,10,58,45,13,60
Stranraer,6679,5,15,6,15,55,64,-9,51
East Fife,6679,6,13,4,19,47,64,-17,43
Airdrieon,6679,7,10,11,15,46,60,-14,41
Forfar,6679,8,11,5,20,40,65,-25,38
Albion,6679,9,8,6,22,57,82,-25,30
Queen's Park,6679,10,6,11,19,42,75,-33,29
Raith,6680,1,23,8,5,71,32,39,77
Ayr,6680,2,24,4,8,97,42,55,76
Arbroath,6680,3,17,8,11,72,51,21,59
Alloa,6680,4,17,8,11,56,46,10,59
Stranraer,6680,5,16,5,15,57,65,-8,53
East Fife,6680,6,13,3,20,48,66,-18,42
Airdrieon,6680,7,10,11,15,45,59,-14,41
Forfar,6680,8,11,5,20,39,64,-25,38
Queen's Park,6680,9,7,10,19,42,74,-32,31
Albion,6680,10,8,6,22,57,85,-28,30
Ayr,6681,1,23,5,8,91,43,48,74
Raith,6681,2,22,8,6,68,33,35,74
Alloa,6681,3,18,8,10,57,43,14,62
Arbroath,6681,4,17,8,11,70,51,19,59
Stranraer,6681,5,15,6,15,55,64,-9,51
Airdrieon,6681,6,11,11,14,46,58,-12,44
East Fife,6681,7,13,4,19,47,64,-17,43
Forfar,6681,8,10,5,21,38,65,-27,35
Albion,6681,9,8,7,21,58,79,-21,31
Queen's Park,6681,10,7,10,19,42,72,-30,31
Raith,6682,1,23,8,5,69,32,37,77
Ayr,6682,2,24,4,8,92,42,50,76
Arbroath,6682,3,17,8,11,71,50,21,59
Alloa,6682,4,17,8,11,56,44,12,59
Stranraer,6682,5,16,5,15,58,65,-7,53
East Fife,6682,6,13,3,20,48,67,-19,42
Airdrieon,6682,7,10,11,15,47,61,-14,41
Forfar,6682,8,11,5,20,41,66,-25,38
Queen's Park,6682,9,7,10,19,41,73,-32,31
Albion,6682,10,8,6,22,57,80,-23,30
Ayr,6683,1,24,4,8,92,42,50,76
Raith,6683,2,22,9,5,70,34,36,75
Arbroath,6683,3,17,9,10,72,50,22,60
Alloa,6683,4,17,9,10,58,45,13,60
Stranraer,6683,5,16,5,15,59,64,-5,53
Airdrieon,6683,6,10,12,14,45,58,-13,42
East Fife,6683,7,13,3,20,47,68,-21,42
Forfar,6683,8,10,6,20,38,64,-26,36
Albion,6683,9,8,6,22,57,80,-23,30
Queen's Park,6683,10,6,11,19,41,74,-33,29
Raith,6684,1,23,8,5,70,32,38,77
Ayr,6684,2,24,4,8,94,42,52,76
Arbroath,6684,3,18,8,10,73,50,23,62
Alloa,6684,4,17,8,11,56,45,11,59
Stranraer,6684,5,15,6,15,57,66,-9,51
Airdrieon,6684,6,11,11,14,50,59,-9,44
East Fife,6684,7,13,4,19,49,66,-17,43
Forfar,6684,8,10,5,21,39,69,-30,35
Albion,6684,9,8,6,22,57,82,-25,30
Queen's Park,6684,10,6,10,20,41,75,-34,28
Raith,6685,1,23,8,5,70,33,37,77
Ayr,6685,2,24,4,8,94,43,51,76
Arbroath,6685,3,17,8,11,71,50,21,59
Alloa,6685,4,17,8,11,57,45,12,59
Stranraer,6685,5,15,6,15,55,64,-9,51
Airdrieon,6685,6,11,11,14,47,58,-11,44
East Fife,6685,7,13,4,19,47,64,-17,43
Forfar,6685,8,10,5,21,38,66,-28,35
Queen's Park,6685,9,7,10,19,41,73,-32,31
Albion,6685,10,8,6,22,58,82,-24,30
Raith,6686,1,23,8,5,71,33,38,77
Ayr,6686,2,24,4,8,95,43,52,76
Arbroath,6686,3,17,9,10,70,48,22,60
Alloa,6686,4,17,8,11,57,46,11,59
Stranraer,6686,5,16,5,15,59,65,-6,53
East Fife,6686,6,13,3,20,48,68,-20,42
Airdrieon,6686,7,10,11,15,45,59,-14,41
Forfar,6686,8,11,5,20,39,64,-25,38
Albion,6686,9,8,6,22,58,83,-25,30
Queen's Park,6686,10,6,11,19,39,72,-33,29
Raith,6687,1,23,8,5,71,33,38,77
Ayr,6687,2,23,4,9,90,43,47,73
Arbroath,6687,3,18,8,10,73,48,25,62
Alloa,6687,4,17,8,11,57,46,11,59
Stranraer,6687,5,15,6,15,57,66,-9,51
Airdrieon,6687,6,11,11,14,48,60,-12,44
East Fife,6687,7,13,4,19,49,66,-17,43
Forfar,6687,8,10,5,21,40,67,-27,35
Albion,6687,9,9,6,21,58,78,-20,33
Queen's Park,6687,10,6,10,20,39,75,-36,28
Raith,6688,1,23,8,5,71,33,38,77
Ayr,6688,2,24,4,8,92,42,50,76
Arbroath,6688,3,17,8,11,72,51,21,59
Alloa,6688,4,17,8,11,57,46,11,59
Stranraer,6688,5,16,5,15,61,66,-5,53
East Fife,6688,6,13,3,20,49,70,-21,42
Airdrieon,6688,7,10,11,15,46,61,-15,41
Forfar,6688,8,11,5,20,41,65,-24,38
Queen's Park,6688,9,7,10,19,42,74,-32,31
Albion,6688,10,8,6,22,57,80,-23,30
Ayr,6689,1,24,4,8,92,43,49,76
Raith,6689,2,22,9,5,68,32,36,75
Arbroath,6689,3,18,8,10,72,49,23,62
Alloa,6689,4,17,9,10,56,43,13,60
Stranraer,6689,5,15,6,15,57,66,-9,51
Airdrieon,6689,6,11,11,14,48,59,-11,44
East Fife,6689,7,13,4,19,49,66,-17,43
Forfar,6689,8,10,5,21,39,67,-28,35
Albion,6689,9,8,6,22,58,80,-22,30
Queen's Park,6689,10,6,10,20,40,74,-34,28
Ayr,6690,1,24,4,8,93,43,50,76
Raith,6690,2,22,8,6,69,35,34,74
Arbroath,6690,3,18,8,10,73,48,25,62
Alloa,6690,4,18,8,10,59,44,15,62
Stranraer,6690,5,15,5,16,56,67,-11,50
East Fife,6690,6,14,3,19,50,65,-15,45
Airdrieon,6690,7,11,11,14,47,58,-11,44
Forfar,6690,8,10,5,21,38,66,-28,35
Albion,6690,9,8,6,22,58,81,-23,30
Queen's Park,6690,10,6,10,20,39,75,-36,28
Ayr,6691,1,24,4,8,95,43,52,76
Raith,6691,2,22,9,5,69,33,36,75
Arbroath,6691,3,18,8,10,74,50,24,62
Alloa,6691,4,17,9,10,57,44,13,60
Stranraer,6691,5,15,5,16,56,69,-13,50
East Fife,6691,6,14,3,19,52,65,-13,45
Airdrieon,6691,7,11,11,14,47,58,-11,44
Forfar,6691,8,10,5,21,38,66,-28,35
Albion,6691,9,8,6,22,58,83,-25,30
Queen's Park,6691,10,6,10,20,41,76,-35,28
Raith,6692,1,23,8,5,70,33,37,77
Ayr,6692,2,24,4,8,93,44,49,76
Arbroath,6692,3,17,8,11,71,50,21,59
Alloa,6692,4,17,8,11,57,45,12,59
Stranraer,6692,5,16,5,15,57,65,-8,53
Airdrieon,6692,6,11,11,14,47,59,-12,44
East Fife,6692,7,13,3,20,48,66,-18,42
Forfar,6692,8,10,5,21,39,66,-27,35
Queen's Park,6692,9,7,10,19,41,73,-32,31
Albion,6692,10,8,6,22,59,81,-22,30
Ayr,6693,1,24,4,8,92,42,50,76
Raith,6693,2,22,9,5,68,32,36,75
Arbroath,6693,3,18,8,10,73,49,24,62
Alloa,6693,4,17,9,10,56,43,13,60
Stranraer,6693,5,15,5,16,55,68,-13,50
East Fife,6693,6,14,3,19,51,64,-13,45
Airdrieon,6693,7,10,11,15,45,60,-15,41
Forfar,6693,8,11,5,20,40,64,-24,38
Albion,6693,9,8,6,22,57,80,-23,30
Queen's Park,6693,10,6,10,20,40,75,-35,28
Raith,6694,1,23,8,5,71,33,38,77
Ayr,6694,2,24,4,8,92,42,50,76
Arbroath,6694,3,18,8,10,72,49,23,62
Alloa,6694,4,17,8,11,57,46,11,59
Stranraer,6694,5,15,5,16,55,65,-10,50
East Fife,6694,6,14,3,19,48,64,-16,45
Airdrieon,6694,7,11,11,14,48,58,-10,44
Forfar,6694,8,10,5,21,38,67,-29,35
Albion,6694,9,8,6,22,57,80,-23,30
Queen's Park,6694,10,6,10,20,40,74,-34,28
Raith,6695,1,23,8,5,71,32,39,77
Ayr,6695,2,24,4,8,96,44,52,76
Arbroath,6695,3,18,8,10,73,49,24,62
Alloa,6695,4,17,8,11,56,46,10,59
Stranraer,6695,5,15,6,15,56,65,-9,51
Airdrieon,6695,6,11,11,14,46,58,-12,44
East Fife,6695,7,13,4,19,48,65,-17,43
Forfar,6695,8,10,5,21,38,65,-27,35
Albion,6695,9,8,6,22,59,84,-25,30
Queen's Park,6695,10,6,10,20,40,75,-35,28
Ayr,6696,1,24,4,8,91,42,49,76
Raith,6696,2,22,9,5,69,33,36,75
Arbroath,6696,3,18,8,10,72,48,24,62
Alloa,6696,4,17,9,10,57,44,13,60
Stranraer,6696,5,15,6,15,56,65,-9,51
Airdrieon,6696,6,11,11,14,49,59,-10,44
East Fife,6696,7,13,4,19,48,65,-17,43
Forfar,6696,8,10,5,21,39,68,-29,35
Albion,6696,9,8,6,22,57,79,-22,30
Queen's Park,6696,10,6,10,20,39,74,-35,28
Raith,6697,1,23,8,5,70,32,38,77
Ayr,6697,2,23,5,8,91,43,48,74
Arbroath,6697,3,18,8,10,73,50,23,62
Alloa,6697,4,17,8,11,56,45,11,59
Stranraer,6697,5,15,5,16,55,65,-10,50
East Fife,6697,6,14,3,19,48,64,-16,45
Airdrieon,6697,7,11,11,14,47,58,-11,44
Forfar,6697,8,10,5,21,38,66,-28,35
Albion,6697,9,8,7,21,58,79,-21,31
Queen's Park,6697,10,6,10,20,41,75,-34,28
Raith,6698,1,23,8,5,70,33,37,77
Ayr,6698,2,24,4,8,95,42,53,76
Arbroath,6698,3,17,9,10,70,48,22,60
Alloa,6698,4,17,8,11,57,45,12,59
Stranraer,6698,5,16,5,15,57,65,-8,53
Airdrieon,6698,6,11,11,14,48,60,-12,44
East Fife,6698,7,13,3,20,48,66,-18,42
Forfar,6698,8,10,5,21,40,67,-27,35
Albion,6698,9,8,6,22,57,83,-26,30
Queen's Park,6698,10,6,11,19,39,72,-33,29
Raith,6699,1,23,8,5,69,32,37,77
Ayr,6699,2,23,5,8,91,43,48,74
Arbroath,6699,3,17,8,11,70,49,21,59
Alloa,6699,4,17,8,11,56,44,12,59
Stranraer,6699,5,15,5,16,57,68,-11,50
East Fife,6699,6,14,3,19,51,66,-15,45
Airdrieon,6699,7,11,11,14,48,59,-11,44
Forfar,6699,8,10,5,21,39,67,-28,35
Albion,6699,9,8,7,21,58,79,-21,31
Queen's Park,6699,10,7,10,19,40,72,-32,31
Raith,6700,1,23,8,5,71,32,39,77
Ayr,6700,2,24,4,8,94,42,52,76
Arbroath,6700,3,17,8,11,71,51,20,59
Alloa,6700,4,17,8,11,56,46,10,59
Stranraer,6700,5,16,5,15,58,66,-8,53
Airdrieon,6700,6,10,12,14,45,58,-13,42
East Fife,6700,7,13,3,20,49,67,-18,42
Forfar,6700,8,10,6,20,38,64,-26,36
Queen's Park,6700,9,7,10,19,42,73,-31,31
Albion,6700,10,8,6,22,57,82,-25,30
Raith,6701,1,23,8,5,71,33,38,77
Ayr,6701,2,24,4,8,93,43,50,76
Arbroath,6701,3,17,9,10,71,49,22,60
Alloa,6701,4,17,8,11,57,46,11,59
Stranraer,6701,5,15,5,16,56,67,-11,50
East Fife,6701,6,14,3,19,50,65,-15,45
Airdrieon,6701,7,10,12,14,48,61,-13,42
Forfar,6701,8,10,6,20,41,67,-26,36
Albion,6701,9,8,6,22,58,81,-23,30
Queen's Park,6701,10,6,11,19,40,73,-33,29
Ayr,6702,1,23,5,8,90,42,48,74
Raith,6702,2,22,8,6,68,33,35,74
Arbroath,6702,3,18,8,10,75,50,25,62
Alloa,6702,4,18,8,10,57,43,14,62
Stranraer,6702,5,16,5,15,56,64,-8,53
East Fife,6702,6,13,3,20,47,65,-18,42
Airdrieon,6702,7,10,11,15,45,59,-14,41
Forfar,6702,8,11,5,20,39,64,-25,38
Albion,6702,9,8,7,21,57,78,-21,31
Queen's Park,6702,10,6,10,20,41,77,-36,28
Raith,6703,1,22,8,6,68,33,35,74
Ayr,6703,2,23,4,9,93,46,47,73
Alloa,6703,3,18,8,10,57,43,14,62
Arbroath,6703,4,17,8,11,70,50,20,59
Stranraer,6703,5,15,6,15,57,66,-9,51
Airdrieon,6703,6,11,11,14,48,59,-11,44
East Fife,6703,7,13,4,19,49,66,-17,43
Forfar,6703,8,10,5,21,39,67,-28,35
Albion,6703,9,9,6,21,61,81,-20,33
Queen's Park,6703,10,7,10,19,41,72,-31,31
Raith,6704,1,23,8,5,70,33,37,77
Ayr,6704,2,23,4,9,91,44,47,73
Arbroath,6704,3,17,8,11,73,52,21,59
Alloa,6704,4,17,8,11,57,45,12,59
Stranraer,6704,5,15,6,15,56,65,-9,51
Airdrieon,6704,6,11,11,14,48,58,-10,44
East Fife,6704,7,13,4,19,48,65,-17,43
Forfar,6704,8,10,5,21,38,67,-29,35
Albion,6704,9,9,6,21,59,79,-20,33
Queen's Park,6704,10,7,10,19,43,75,-32,31
Raith,6705,1,23,8,5,69,32,37,77
Ayr,6705,2,24,4,8,97,42,55,76
Arbroath,6705,3,17,8,11,70,51,19,59
Alloa,6705,4,17,8,11,56,44,12,59
Stranraer,6705,5,16,5,15,56,64,-8,53
Airdrieon,6705,6,11,11,14,47,58,-11,44
East Fife,6705,7,13,3,20,47,65,-18,42
Forfar,6705,8,10,5,21,38,66,-28,35
Queen's Park,6705,9,7,10,19,42,72,-30,31
Albion,6705,10,8,6,22,57,85,-28,30
Raith,6706,1,22,9,5,69,33,36,75
Ayr,6706,2,23,4,9,93,46,47,73
Alloa,6706,3,17,9,10,57,44,13,60
Arbroath,6706,4,17,8,11,71,50,21,59
Stranraer,6706,5,15,5,16,56,67,-11,50
East Fife,6706,6,14,3,19,50,65,-15,45
Airdrieon,6706,7,11,11,14,47,59,-12,44
Forfar,6706,8,10,5,21,39,66,-27,35
Albion,6706,9,9,6,21,61,81,-20,33
Queen's Park,6706,10,7,10,19,41,73,-32,31
Ayr,6707,1,24,4,8,94,44,50,76
Raith,6707,2,22,8,6,68,33,35,74
Arbroath,6707,3,18,8,10,71,48,23,62
Alloa,6707,4,18,8,10,57,43,14,62
Stranraer,6707,5,15,5,16,55,65,-10,50
East Fife,6707,6,14,3,19,48,64,-16,45
Airdrieon,6707,7,11,11,14,50,59,-9,44
Forfar,6707,8,10,5,21,39,69,-30,35
Albion,6707,9,8,6,22,59,82,-23,30
Queen's Park,6707,10,6,10,20,39,73,-34,28
Raith,6708,1,23,8,5,70,32,38,77
Ayr,6708,2,23,4,9,90,44,46,73
Arbroath,6708,3,17,9,10,72,50,22,60
Alloa,6708,4,17,8,11,56,45,11,59
Stranraer,6708,5,16,5,15,58,65,-7,53
Airdrieon,6708,6,10,12,14,48,61,-13,42
East Fife,6708,7,13,3,20,48,67,-19,42
Forfar,6708,8,10,6,20,41,67,-26,36
Albion,6708,9,9,6,21,59,78,-19,33
Queen's Park,6708,10,6,11,19,41,74,-33,29
Ayr,6709,1,24,4,8,92,42,50,76
Raith,6709,2,22,9,5,69,33,36,75
Alloa,6709,3,17,9,10,57,44,13,60
Arbroath,6709,4,17,8,11,70,49,21,59
Stranraer,6709,5,15,5,16,56,67,-11,50
East Fife,6709,6,14,3,19,50,65,-15,45
Airdrieon,6709,7,11,11,14,48,58,-10,44
Forfar,6709,8,10,5,21,38,67,-29,35
Queen's Park,6709,9,7,10,19,40,72,-32,31
Albion,6709,10,8,6,22,57,80,-23,30
Raith,6710,1,23,8,5,70,32,38,77
Ayr,6710,2,24,4,8,93,43,50,76
Arbroath,6710,3,17,9,10,70,48,22,60
Alloa,6710,4,17,8,11,56,45,11,59
Stranraer,6710,5,15,6,15,56,65,-9,51
Airdrieon,6710,6,11,11,14,47,59,-12,44
East Fife,6710,7,13,4,19,48,65,-17,43
Forfar,6710,8,10,5,21,39,66,-27,35
Albion,6710,9,8,6,22,58,81,-23,30
Queen's Park,6710,10,6,11,19,39,72,-33,29
Raith,6711,1,23,8,5,70,32,38,77
Ayr,6711,2,24,4,8,92,42,50,76
Arbroath,6711,3,17,8,11,71,50,21,59
Alloa,6711,4,17,8,11,56,45,11,59
Stranraer,6711,5,15,5,16,55,67,-12,50
East Fife,6711,6,14,3,19,50,64,-14,45
Airdrieon,6711,7,11,11,14,48,59,-11,44
Forfar,6711,8,10,5,21,39,67,-28,35
Queen's Park,6711,9,7,10,19,41,73,-32,31
Albion,6711,10,8,6,22,57,80,-23,30
Ayr,6712,1,24,4,8,93,43,50,76
Raith,6712,2,22,9,5,68,32,36,75
Arbroath,6712,3,18,8,10,74,50,24,62
Alloa,6712,4,17,9,10,56,43,13,60
Stranraer,6712,5,15,5,16,55,68,-13,50
East Fife,6712,6,14,3,19,51,64,-13,45
Airdrieon,6712,7,11,11,14,50,58,-8,44
Forfar,6712,8,10,5,21,38,69,-31,35
Albion,6712,9,8,6,22,58,81,-23,30
Queen's Park,6712,10,6,10,20,41,76,-35,28
Ayr,6713,1,23,5,8,92,44,48,74
Raith,6713,2,22,8,6,68,34,34,74
Alloa,6713,3,18,8,10,58,43,15,62
Arbroath,6713,4,17,9,10,71,49,22,60
Stranraer,6713,5,16,5,15,56,64,-8,53
Airdrieon,6713,6,10,12,14,46,59,-13,42
East Fife,6713,7,13,3,20,47,65,-18,42
Forfar,6713,8,10,6,20,39,65,-26,36
Albion,6713,9,8,7,21,59,80,-21,31
Queen's Park,6713,10,6,11,19,40,73,-33,29
Ayr,6714,1,23,5,8,91,43,48,74
Raith,6714,2,22,8,6,69,34,35,74
Alloa,6714,3,18,8,10,58,44,14,62
Arbroath,6714,4,17,9,10,72,50,22,60
Stranraer,6714,5,15,5,16,55,65,-10,50
East Fife,6714,6,14,3,19,48,64,-16,45
Airdrieon,6714,7,10,11,15,46,61,-15,41
Forfar,6714,8,11,5,20,41,65,-24,38
Albion,6714,9,8,7,21,58,79,-21,31
Queen's Park,6714,10,6,11,19,41,74,-33,29
Raith,6715,1,23,8,5,69,32,37,77
Ayr,6715,2,23,4,9,90,43,47,73
Arbroath,6715,3,17,9,10,70,48,22,60
Alloa,6715,4,17,8,11,56,44,12,59
Stranraer,6715,5,15,5,16,55,65,-10,50
East Fife,6715,6,14,3,19,48,64,-16,45
Airdrieon,6715,7,10,12,14,47,60,-13,42
Forfar,6715,8,10,6,20,40,66,-26,36
Albion,6715,9,9,6,21,58,78,-20,33
Queen's Park,6715,10,6,11,19,39,72,-33,29
Ayr,6716,1,24,4,8,94,43,51,76
Raith,6716,2,22,9,5,69,33,36,75
Alloa,6716,3,17,9,10,57,44,13,60
Arbroath,6716,4,17,8,11,70,49,21,59
Stranraer,6716,5,15,6,15,55,64,-9,51
Airdrieon,6716,6,11,11,14,46,58,-12,44
East Fife,6716,7,13,4,19,47,64,-17,43
Forfar,6716,8,10,5,21,38,65,-27,35
Queen's Park,6716,9,7,10,19,40,72,-32,31
Albion,6716,10,8,6,22,58,82,-24,30
Raith,6717,1,23,8,5,71,33,38,77
Ayr,6717,2,24,4,8,94,43,51,76
Arbroath,6717,3,18,8,10,72,48,24,62
Alloa,6717,4,17,8,11,57,46,11,59
Stranraer,6717,5,15,5,16,56,68,-12,50
East Fife,6717,6,14,3,19,51,65,-14,45
Airdrieon,6717,7,11,11,14,47,59,-12,44
Forfar,6717,8,10,5,21,39,66,-27,35
Albion,6717,9,8,6,22,58,82,-24,30
Queen's Park,6717,10,6,10,20,39,74,-35,28
Raith,6718,1,23,8,5,72,32,40,77
Ayr,6718,2,24,4,8,96,42,54,76
Arbroath,6718,3,17,8,11,70,49,21,59
Alloa,6718,4,17,8,11,56,47,9,59
Stranraer,6718,5,15,5,16,55,65,-10,50
East Fife,6718,6,14,3,19,48,64,-16,45
Airdrieon,6718,7,10,12,14,46,59,-13,42
Forfar,6718,8,10,6,20,39,65,-26,36
Queen's Park,6718,9,7,10,19,40,72,-32,31
Albion,6718,10,8,6,22,57,84,-27,30
Ayr,6719,1,23,5,8,93,45,48,74
Raith,6719,2,22,8,6,69,34,35,74
Arbroath,6719,3,18,8,10,73,50,23,62
Alloa,6719,4,18,8,10,58,44,14,62
Stranraer,6719,5,15,5,16,55,65,-10,50
East Fife,6719,6,14,3,19,48,64,-16,45
Airdrieon,6719,7,11,11,14,48,58,-10,44
Forfar,6719,8,10,5,21,38,67,-29,35
Albion,6719,9,8,7,21,60,81,-21,31
Queen's Park,6719,10,6,10,20,41,75,-34,28
Ayr,6720,1,24,4,8,94,42,52,76
Raith,6720,2,22,8,6,68,33,35,74
Alloa,6720,3,18,8,10,57,43,14,62
Arbroath,6720,4,17,9,10,72,50,22,60
Stranraer,6720,5,15,5,16,56,66,-10,50
East Fife,6720,6,14,3,19,49,65,-16,45
Airdrieon,6720,7,10,12,14,46,59,-13,42
Forfar,6720,8,10,6,20,39,65,-26,36
Albion,6720,9,8,6,22,57,82,-25,30
Queen's Park,6720,10,6,11,19,41,74,-33,29
Raith,6721,1,23,8,5,73,32,41,77
Ayr,6721,2,24,4,8,94,43,51,76
Arbroath,6721,3,17,9,10,71,49,22,60
Alloa,6721,4,17,8,11,56,48,8,59
Stranraer,6721,5,15,6,15,57,66,-9,51
East Fife,6721,6,13,4,19,49,66,-17,43
Airdrieon,6721,7,10,12,14,46,59,-13,42
Forfar,6721,8,10,6,20,39,65,-26,36
Albion,6721,9,8,6,22,58,82,-24,30
Queen's Park,6721,10,6,11,19,40,73,-33,29
Ayr,6722,1,24,4,8,92,42,50,76
Raith,6722,2,22,9,5,68,32,36,75
Arbroath,6722,3,18,8,10,71,48,23,62
Alloa,6722,4,17,9,10,56,43,13,60
Stranraer,6722,5,15,5,16,56,66,-10,50
East Fife,6722,6,14,3,19,49,65,-16,45
Airdrieon,6722,7,11,11,14,48,59,-11,44
Forfar,6722,8,10,5,21,39,67,-28,35
Albion,6722,9,8,6,22,57,80,-23,30
Queen's Park,6722,10,6,10,20,39,73,-34,28
Raith,6723,1,23,8,5,69,32,37,77
Ayr,6723,2,24,4,8,93,43,50,76
Arbroath,6723,3,18,8,10,72,49,23,62
Alloa,6723,4,17,8,11,56,44,12,59
Stranraer,6723,5,16,5,15,56,64,-8,53
East Fife,6723,6,13,3,20,47,65,-18,42
Airdrieon,6723,7,10,11,15,46,61,-15,41
Forfar,6723,8,11,5,20,41,65,-24,38
Albion,6723,9,8,6,22,58,81,-23,30
Queen's Park,6723,10,6,10,20,40,74,-34,28
Ayr,6724,1,24,4,8,93,42,51,76
Raith,6724,2,22,8,6,70,35,35,74
Arbroath,6724,3,18,8,10,73,48,25,62
Alloa,6724,4,18,8,10,59,45,14,62
Stranraer,6724,5,16,5,15,58,64,-6,53
Airdrieon,6724,6,11,11,14,46,58,-12,44
East Fife,6724,7,13,3,20,47,67,-20,42
Forfar,6724,8,10,5,21,38,65,-27,35
Albion,6724,9,8,6,22,57,81,-24,30
Queen's Park,6724,10,6,10,20,39,75,-36,28
Raith,6725,1,23,8,5,71,32,39,77
Ayr,6725,2,24,4,8,95,44,51,76
Arbroath,6725,3,17,9,10,71,49,22,60
Alloa,6725,4,17,8,11,56,46,10,59
Stranraer,6725,5,15,6,15,56,65,-9,51
Airdrieon,6725,6,11,11,14,49,60,-11,44
East Fife,6725,7,13,4,19,48,65,-17,43
Forfar,6725,8,10,5,21,40,68,-28,35
Albion,6725,9,8,6,22,59,83,-24,30
Queen's Park,6725,10,6,11,19,40,73,-33,29
Raith,6726,1,23,8,5,70,33,37,77
Ayr,6726,2,24,4,8,96,45,51,76
Arbroath,6726,3,17,8,11,70,50,20,59
Alloa,6726,4,17,8,11,57,45,12,59
Stranraer,6726,5,16,5,15,59,64,-5,53
Airdrieon,6726,6,10,12,14,46,59,-13,42
East Fife,6726,7,13,3,20,47,68,-21,42
Forfar,6726,8,10,6,20,39,65,-26,36
Queen's Park,6726,9,7,10,19,41,72,-31,31
Albion,6726,10,8,6,22,60,84,-24,30
Ayr,6727,1,23,5,8,91,43,48,74
Raith,6727,2,22,8,6,68,33,35,74
Alloa,6727,3,18,8,10,57,43,14,62
Arbroath,6727,4,17,8,11,71,52,19,59
Stranraer,6727,5,15,5,16,55,66,-11,50
East Fife,6727,6,14,3,19,49,64,-15,45
Airdrieon,6727,7,10,12,14,46,59,-13,42
Forfar,6727,8,10,6,20,39,65,-26,36
Albion,6727,9,8,7,21,58,79,-21,31
Queen's Park,6727,10,7,10,19,43,73,-30,31
Raith,6728,1,22,9,5,70,34,36,75
Ayr,6728,2,23,5,8,93,45,48,74
Arbroath,6728,3,18,8,10,74,51,23,62
Alloa,6728,4,17,9,10,58,45,13,60
Stranraer,6728,5,16,5,15,58,65,-7,53
Airdrieon,6728,6,10,12,14,46,59,-13,42
East Fife,6728,7,13,3,20,48,67,-19,42
Forfar,6728,8,10,6,20,39,65,-26,36
Albion,6728,9,8,7,21,60,81,-21,31
Queen's Park,6728,10,6,10,20,42,76,-34,28
Raith,6729,1,23,8,5,71,33,38,77
Ayr,6729,2,24,4,8,94,44,50,76
Arbroath,6729,3,17,9,10,72,50,22,60
Alloa,6729,4,17,8,11,57,46,11,59
Stranraer,6729,5,15,5,16,56,67,-11,50
East Fife,6729,6,14,3,19,50,65,-15,45
Airdrieon,6729,7,10,12,14,45,58,-13,42
Forfar,6729,8,10,6,20,38,64,-26,36
Albion,6729,9,8,6,22,59,82,-23,30
Queen's Park,6729,10,6,11,19,41,74,-33,29
Raith,6730,1,23,8,5,72,32,40,77
Ayr,6730,2,24,4,8,94,44,50,76
Arbroath,6730,3,17,8,11,70,49,21,59
Alloa,6730,4,17,8,11,56,47,9,59
Stranraer,6730,5,15,5,16,55,66,-11,50
East Fife,6730,6,14,3,19,49,64,-15,45
Airdrieon,6730,7,11,11,14,49,58,-9,44
Forfar,6730,8,10,5,21,38,68,-30,35
Queen's Park,6730,9,7,10,19,40,72,-32,31
Albion,6730,10,8,6,22,59,82,-23,30
Ayr,6731,1,24,4,8,94,45,49,76
Raith,6731,2,22,8,6,68,33,35,74
Arbroath,6731,3,18,8,10,72,48,24,62
Alloa,6731,4,18,8,10,57,43,14,62
Stranraer,6731,5,15,6,15,58,67,-9,51
Airdrieon,6731,6,11,11,14,48,58,-10,44
East Fife,6731,7,13,4,19,50,67,-17,43
Forfar,6731,8,10,5,21,38,67,-29,35
Albion,6731,9,8,6,22,60,82,-22,30
Queen's Park,6731,10,6,10,20,39,74,-35,28
Ayr,6732,1,24,4,8,96,42,54,76
Raith,6732,2,22,9,5,69,33,36,75
Arbroath,6732,3,18,8,10,72,49,23,62
Alloa,6732,4,17,9,10,57,44,13,60
Stranraer,6732,5,15,6,15,58,67,-9,51
Airdrieon,6732,6,11,11,14,46,58,-12,44
East Fife,6732,7,13,4,19,50,67,-17,43
Forfar,6732,8,10,5,21,38,65,-27,35
Albion,6732,9,8,6,22,57,84,-27,30
Queen's Park,6732,10,6,10,20,40,74,-34,28
Raith,6733,1,23,8,5,70,33,37,77
Ayr,6733,2,24,4,8,93,42,51,76
Arbroath,6733,3,17,9,10,71,49,22,60
Alloa,6733,4,17,8,11,57,45,12,59
Stranraer,6733,5,15,6,15,57,66,-9,51
East Fife,6733,6,13,4,19,49,66,-17,43
Airdrieon,6733,7,10,12,14,46,59,-13,42
Forfar,6733,8,10,6,20,39,65,-26,36
Albion,6733,9,8,6,22,57,81,-24,30
Queen's Park,6733,10,6,11,19,40,73,-33,29
Raith,6734,1,23,8,5,73,33,40,77
Ayr,6734,2,24,4,8,94,44,50,76
Arbroath,6734,3,18,8,10,71,48,23,62
Alloa,6734,4,17,8,11,57,48,9,59
Stranraer,6734,5,15,6,15,56,65,-9,51
East Fife,6734,6,13,4,19,48,65,-17,43
Airdrieon,6734,7,10,11,15,46,60,-14,41
Forfar,6734,8,11,5,20,40,65,-25,38
Albion,6734,9,8,6,22,59,82,-23,30
Queen's Park,6734,10,6,10,20,39,73,-34,28
Ayr,6735,1,24,4,8,96,46,50,76
Raith,6735,2,22,9,5,71,35,36,75
Arbroath,6735,3,18,8,10,75,49,26,62
Alloa,6735,4,17,9,10,59,46,13,60
Stranraer,6735,5,16,5,15,59,64,-5,53
Airdrieon,6735,6,10,12,14,45,58,-13,42
East Fife,6735,7,13,3,20,47,68,-21,42
Forfar,6735,8,10,6,20,38,64,-26,36
Albion,6735,9,8,6,22,61,84,-23,30
Queen's Park,6735,10,6,10,20,40,77,-37,28
Raith,6736,1,23,8,5,74,35,39,77
Ayr,6736,2,24,4,8,91,42,49,76
Arbroath,6736,3,17,8,11,70,50,20,59
Alloa,6736,4,17,8,11,59,49,10,59
Stranraer,6736,5,15,5,16,55,65,-10,50
East Fife,6736,6,14,3,19,48,64,-16,45
Airdrieon,6736,7,10,12,14,47,60,-13,42
Forfar,6736,8,10,6,20,40,66,-26,36
Queen's Park,6736,9,7,10,19,41,72,-31,31
Albion,6736,10,8,6,22,57,79,-22,30
Raith,6737,1,23,8,5,70,32,38,77
Ayr,6737,2,24,4,8,95,42,53,76
Arbroath,6737,3,17,9,10,73,51,22,60
Alloa,6737,4,17,8,11,56,45,11,59
Stranraer,6737,5,15,5,16,56,67,-11,50
East Fife,6737,6,14,3,19,50,65,-15,45
Airdrieon,6737,7,10,11,15,47,62,-15,41
Forfar,6737,8,11,5,20,42,66,-24,38
Albion,6737,9,8,6,22,57,83,-26,30
Queen's Park,6737,10,6,11,19,42,75,-33,29
Raith,6738,1,23,8,5,71,32,39,77
Ayr,6738,2,24,4,8,94,43,51,76
Arbroath,6738,3,18,8,10,72,48,24,62
Alloa,6738,4,17,8,11,56,46,10,59
Stranraer,6738,5,15,6,15,56,65,-9,51
East Fife,6738,6,13,4,19,48,65,-17,43
Airdrieon,6738,7,10,12,14,46,59,-13,42
Forfar,6738,8,10,6,20,39,65,-26,36
Albion,6738,9,8,6,22,58,82,-24,30
Queen's Park,6738,10,6,10,20,39,74,-35,28
Raith,6739,1,23,8,5,69,32,37,77
Ayr,6739,2,24,4,8,96,42,54,76
Arbroath,6739,3,17,9,10,72,50,22,60
Alloa,6739,4,17,8,11,56,44,12,59
Stranraer,6739,5,16,5,15,57,64,-7,53
East Fife,6739,6,13,3,20,47,66,-19,42
Airdrieon,6739,7,10,11,15,45,60,-15,41
Forfar,6739,8,11,5,20,40,64,-24,38
Albion,6739,9,8,6,22,57,84,-27,30
Queen's Park,6739,10,6,11,19,41,74,-33,29
Raith,6740,1,23,8,5,70,32,38,77
Ayr,6740,2,24,4,8,92,43,49,76
Arbroath,6740,3,18,8,10,74,50,24,62
Alloa,6740,4,17,8,11,56,45,11,59
Stranraer,6740,5,15,6,15,56,65,-9,51
Airdrieon,6740,6,11,11,14,47,58,-11,44
East Fife,6740,7,13,4,19,48,65,-17,43
Forfar,6740,8,10,5,21,38,66,-28,35
Albion,6740,9,8,6,22,58,80,-22,30
Queen's Park,6740,10,6,10,20,41,76,-35,28
Raith,6741,1,23,8,5,70,32,38,77
Ayr,6741,2,24,4,8,95,44,51,76
Arbroath,6741,3,18,8,10,73,49,24,62
Alloa,6741,4,17,8,11,56,45,11,59
Stranraer,6741,5,15,5,16,57,69,-12,50
East Fife,6741,6,14,3,19,52,66,-14,45
Airdrieon,6741,7,11,11,14,50,58,-8,44
Forfar,6741,8,10,5,21,38,69,-31,35
Albion,6741,9,8,6,22,59,83,-24,30
Queen's Park,6741,10,6,10,20,40,75,-35,28
Ayr,6742,1,24,4,8,93,42,51,76
Raith,6742,2,22,8,6,69,34,35,74
Arbroath,6742,3,18,8,10,74,48,26,62
Alloa,6742,4,18,8,10,58,44,14,62
Stranraer,6742,5,16,5,15,56,64,-8,53
Airdrieon,6742,6,11,11,14,48,58,-10,44
East Fife,6742,7,13,3,20,47,65,-18,42
Forfar,6742,8,10,5,21,38,67,-29,35
Albion,6742,9,8,6,22,57,81,-24,30
Queen's Park,6742,10,6,10,20,39,76,-37,28
Ayr,6743,1,24,4,8,98,44,54,76
Raith,6743,2,22,9,5,69,33,36,75
Arbroath,6743,3,18,8,10,74,49,25,62
Alloa,6743,4,17,9,10,57,44,13,60
Stranraer,6743,5,15,6,15,56,65,-9,51
Airdrieon,6743,6,11,11,14,47,59,-12,44
East Fife,6743,7,13,4,19,48,65,-17,43
Forfar,6743,8,10,5,21,39,66,-27,35
Albion,6743,9,8,6,22,59,86,-27,30
Queen's Park,6743,10,6,10,20,40,76,-36,28
Raith,6744,1,23,8,5,69,32,37,77
Ayr,6744,2,24,4,8,92,42,50,76
Arbroath,6744,3,18,8,10,71,48,23,62
Alloa,6744,4,17,8,11,56,44,12,59
Stranraer,6744,5,15,6,15,56,65,-9,51
East Fife,6744,6,13,4,19,48,65,-17,43
Airdrieon,6744,7,10,12,14,46,59,-13,42
Forfar,6744,8,10,6,20,39,65,-26,36
Albion,6744,9,8,6,22,57,80,-23,30
Queen's Park,6744,10,6,10,20,39,73,-34,28
Ayr,6745,1,24,4,8,94,43,51,76
Raith,6745,2,22,9,5,69,33,36,75
Arbroath,6745,3,18,8,10,72,49,23,62
Alloa,6745,4,17,9,10,57,44,13,60
Stranraer,6745,5,15,6,15,57,66,-9,51
East Fife,6745,6,13,4,19,49,66,-17,43
Airdrieon,6745,7,10,11,15,46,60,-14,41
Forfar,6745,8,11,5,20,40,65,-25,38
Albion,6745,9,8,6,22,58,82,-24,30
Queen's Park,6745,10,6,10,20,40,74,-34,28
Raith,6746,1,23,8,5,70,33,37,77
Ayr,6746,2,23,5,8,92,44,48,74
Arbroath,6746,3,18,8,10,71,48,23,62
Alloa,6746,4,17,8,11,57,45,12,59
Stranraer,6746,5,15,6,15,57,66,-9,51
Airdrieon,6746,6,11,11,14,48,59,-11,44
East Fife,6746,7,13,4,19,49,66,-17,43
Forfar,6746,8,10,5,21,39,67,-28,35
Albion,6746,9,8,7,21,59,80,-21,31
Queen's Park,6746,10,6,10,20,39,73,-34,28
Ayr,6747,1,24,4,8,97,44,53,76
Raith,6747,2,22,8,6,69,34,35,74
Arbroath,6747,3,18,8,10,73,49,24,62
Alloa,6747,4,18,8,10,58,44,14,62
Stranraer,6747,5,16,5,15,57,65,-8,53
East Fife,6747,6,13,3,20,48,66,-18,42
Airdrieon,6747,7,10,11,15,46,60,-14,41
Forfar,6747,8,11,5,20,40,65,-25,38
Albion,6747,9,8,6,22,59,85,-26,30
Queen's Park,6747,10,6,10,20,40,75,-35,28
Raith,6748,1,23,8,5,69,32,37,77
Ayr,6748,2,24,4,8,93,44,49,76
Arbroath,6748,3,18,8,10,73,49,24,62
Alloa,6748,4,17,8,11,56,44,12,59
Stranraer,6748,5,15,6,15,57,66,-9,51
Airdrieon,6748,6,11,11,14,49,58,-9,44
East Fife,6748,7,13,4,19,49,66,-17,43
Forfar,6748,8,10,5,21,38,68,-30,35
Albion,6748,9,8,6,22,59,81,-22,30
Queen's Park,6748,10,6,10,20,40,75,-35,28
Raith,6749,1,23,8,5,69,32,37,77
Ayr,6749,2,24,4,8,94,43,51,76
Arbroath,6749,3,17,8,11,70,51,19,59
Alloa,6749,4,17,8,11,56,44,12,59
Stranraer,6749,5,15,5,16,55,65,-10,50
East Fife,6749,6,14,3,19,48,64,-16,45
Airdrieon,6749,7,10,11,15,46,60,-14,41
Forfar,6749,8,11,5,20,40,65,-25,38
Queen's Park,6749,9,7,10,19,42,72,-30,31
Albion,6749,10,8,6,22,58,82,-24,30
Ayr,6750,1,24,4,8,95,42,53,76
Raith,6750,2,22,9,5,68,32,36,75
Arbroath,6750,3,18,8,10,73,49,24,62
Alloa,6750,4,17,9,10,56,43,13,60
Stranraer,6750,5,16,5,15,57,64,-7,53
Airdrieon,6750,6,11,11,14,47,59,-12,44
East Fife,6750,7,13,3,20,47,66,-19,42
Forfar,6750,8,10,5,21,39,66,-27,35
Albion,6750,9,8,6,22,57,83,-26,30
Queen's Park,6750,10,6,10,20,40,75,-35,28
Raith,6751,1,23,8,5,70,32,38,77
Ayr,6751,2,24,4,8,92,42,50,76
Arbroath,6751,3,17,8,11,71,50,21,59
Alloa,6751,4,17,8,11,56,45,11,59
Stranraer,6751,5,16,5,15,58,64,-6,53
Airdrieon,6751,6,10,12,14,46,59,-13,42
East Fife,6751,7,13,3,20,47,67,-20,42
Forfar,6751,8,10,6,20,39,65,-26,36
Queen's Park,6751,9,7,10,19,41,73,-32,31
Albion,6751,10,8,6,22,57,80,-23,30
Raith,6752,1,23,8,5,71,33,38,77
Ayr,6752,2,23,4,9,92,45,47,73
Arbroath,6752,3,18,8,10,73,50,23,62
Alloa,6752,4,17,8,11,57,46,11,59
Stranraer,6752,5,15,5,16,58,68,-10,50
East Fife,6752,6,14,3,19,51,67,-16,45
Airdrieon,6752,7,11,11,14,46,58,-12,44
Forfar,6752,8,10,5,21,38,65,-27,35
Albion,6752,9,9,6,21,60,80,-20,33
Queen's Park,6752,10,6,10,20,41,75,-34,28
Ayr,6753,1,24,4,8,94,42,52,76
Raith,6753,2,22,9,5,68,32,36,75
Arbroath,6753,3,18,8,10,71,48,23,62
Alloa,6753,4,17,9,10,56,43,13,60
Stranraer,6753,5,15,6,15,58,67,-9,51
Airdrieon,6753,6,11,11,14,46,58,-12,44
East Fife,6753,7,13,4,19,50,67,-17,43
Forfar,6753,8,10,5,21,38,65,-27,35
Albion,6753,9,8,6,22,57,82,-25,30
Queen's Park,6753,10,6,10,20,39,73,-34,28
Ayr,6754,1,23,5,8,91,43,48,74
Raith,6754,2,22,8,6,69,35,34,74
Arbroath,6754,3,18,8,10,74,51,23,62
Alloa,6754,4,18,8,10,59,44,15,62
Stranraer,6754,5,15,5,16,55,65,-10,50
East Fife,6754,6,14,3,19,48,64,-16,45
Airdrieon,6754,7,11,11,14,48,58,-10,44
Forfar,6754,8,10,5,21,38,67,-29,35
Albion,6754,9,8,7,21,58,79,-21,31
Queen's Park,6754,10,6,10,20,42,76,-34,28
Ayr,6755,1,24,4,8,92,42,50,76
Raith,6755,2,22,8,6,70,35,35,74
Arbroath,6755,3,18,8,10,72,49,23,62
Alloa,6755,4,18,8,10,59,45,14,62
Stranraer,6755,5,15,6,15,56,65,-9,51
Airdrieon,6755,6,11,11,14,47,59,-12,44
East Fife,6755,7,13,4,19,48,65,-17,43
Forfar,6755,8,10,5,21,39,66,-27,35
Albion,6755,9,8,6,22,57,80,-23,30
Queen's Park,6755,10,6,10,20,40,74,-34,28
Ayr,6756,1,24,4,8,94,44,50,76
Raith,6756,2,22,9,5,68,32,36,75
Arbroath,6756,3,17,9,10,71,49,22,60
Alloa,6756,4,17,9,10,56,43,13,60
Stranraer,6756,5,15,5,16,55,66,-11,50
East Fife,6756,6,14,3,19,49,64,-15,45
Airdrieon,6756,7,11,11,14,48,60,-12,44
Forfar,6756,8,10,5,21,40,67,-27,35
Albion,6756,9,8,6,22,59,82,-23,30
Queen's Park,6756,10,6,11,19,40,73,-33,29
Ayr,6757,1,23,5,8,91,43,48,74
Raith,6757,2,22,8,6,69,35,34,74
Arbroath,6757,3,18,8,10,74,48,26,62
Alloa,6757,4,18,8,10,59,44,15,62
Stranraer,6757,5,16,5,15,58,64,-6,53
Airdrieon,6757,6,11,11,14,47,59,-12,44
East Fife,6757,7,13,3,20,47,67,-20,42
Forfar,6757,8,10,5,21,39,66,-27,35
Albion,6757,9,8,7,21,58,79,-21,31
Queen's Park,6757,10,6,10,20,39,76,-37,28
Raith,6758,1,22,8,6,69,34,35,74
Ayr,6758,2,23,4,9,91,44,47,73
Alloa,6758,3,18,8,10,58,44,14,62
Arbroath,6758,4,17,9,10,72,50,22,60
Stranraer,6758,5,15,5,16,56,66,-10,50
East Fife,6758,6,14,3,19,49,65,-16,45
Airdrieon,6758,7,11,11,14,47,58,-11,44
Forfar,6758,8,10,5,21,38,66,-28,35
Albion,6758,9,9,6,21,59,79,-20,33
Queen's Park,6758,10,6,11,19,41,74,-33,29
Raith,6759,1,23,8,5,70,32,38,77
Ayr,6759,2,23,4,9,90,44,46,73
Arbroath,6759,3,17,8,11,70,51,19,59
Alloa,6759,4,17,8,11,56,45,11,59
Stranraer,6759,5,15,5,16,57,67,-10,50
East Fife,6759,6,14,3,19,50,66,-16,45
Airdrieon,6759,7,11,11,14,47,59,-12,44
Forfar,6759,8,10,5,21,39,66,-27,35
Albion,6759,9,9,6,21,59,78,-19,33
Queen's Park,6759,10,7,10,19,42,72,-30,31
Raith,6760,1,23,8,5,71,33,38,77
Ayr,6760,2,24,4,8,93,43,50,76
Arbroath,6760,3,18,8,10,71,48,23,62
Alloa,6760,4,17,8,11,57,46,11,59
Stranraer,6760,5,15,5,16,56,66,-10,50
East Fife,6760,6,14,3,19,49,65,-16,45
Airdrieon,6760,7,11,11,14,47,58,-11,44
Forfar,6760,8,10,5,21,38,66,-28,35
Albion,6760,9,8,6,22,58,81,-23,30
Queen's Park,6760,10,6,10,20,39,73,-34,28
Raith,6761,1,23,8,5,71,34,37,77
Ayr,6761,2,24,4,8,97,42,55,76
Arbroath,6761,3,18,8,10,74,50,24,62
Alloa,6761,4,17,8,11,58,46,12,59
Stranraer,6761,5,16,5,15,59,66,-7,53
Airdrieon,6761,6,11,11,14,47,58,-11,44
East Fife,6761,7,13,3,20,49,68,-19,42
Forfar,6761,8,10,5,21,38,66,-28,35
Albion,6761,9,8,6,22,57,85,-28,30
Queen's Park,6761,10,6,10,20,41,76,-35,28
Raith,6762,1,23,8,5,70,32,38,77
Ayr,6762,2,24,4,8,94,43,51,76
Arbroath,6762,3,18,8,10,73,49,24,62
Alloa,6762,4,17,8,11,56,45,11,59
Stranraer,6762,5,15,5,16,55,65,-10,50
East Fife,6762,6,14,3,19,48,64,-16,45
Airdrieon,6762,7,10,11,15,46,60,-14,41
Forfar,6762,8,11,5,20,40,65,-25,38
Albion,6762,9,8,6,22,58,82,-24,30
Queen's Park,6762,10,6,10,20,40,75,-35,28
Ayr,6763,1,24,4,8,91,42,49,76
Raith,6763,2,22,8,6,69,34,35,74
Arbroath,6763,3,18,8,10,76,50,26,62
Alloa,6763,4,18,8,10,58,44,14,62
Stranraer,6763,5,16,5,15,58,65,-7,53
Airdrieon,6763,6,11,11,14,47,59,-12,44
East Fife,6763,7,13,3,20,48,67,-19,42
Forfar,6763,8,10,5,21,39,66,-27,35
Albion,6763,9,8,6,22,57,79,-22,30
Queen's Park,6763,10,6,10,20,41,78,-37,28
Raith,6764,1,23,8,5,70,33,37,77
Ayr,6764,2,24,4,8,95,44,51,76
Arbroath,6764,3,17,8,11,71,51,20,59
Alloa,6764,4,17,8,11,57,45,12,59
Stranraer,6764,5,15,5,16,57,67,-10,50
East Fife,6764,6,14,3,19,50,66,-16,45
Airdrieon,6764,7,10,12,14,48,61,-13,42
Forfar,6764,8,10,6,20,41,67,-26,36
Queen's Park,6764,9,7,10,19,42,73,-31,31
Albion,6764,10,8,6,22,59,83,-24,30
Raith,6765,1,23,8,5,71,32,39,77
Ayr,6765,2,24,4,8,95,45,50,76
Arbroath,6765,3,17,8,11,71,50,21,59
Alloa,6765,4,17,8,11,56,46,10,59
Stranraer,6765,5,16,5,15,57,64,-7,53
Airdrieon,6765,6,11,11,14,49,61,-12,44
East Fife,6765,7,13,3,20,47,66,-19,42
Forfar,6765,8,10,5,21,41,68,-27,35
Queen's Park,6765,9,7,10,19,41,73,-32,31
Albion,6765,10,8,6,22,60,83,-23,30
Ayr,6766,1,24,4,8,92,42,50,76
Raith,6766,2,22,9,5,69,33,36,75
Arbroath,6766,3,17,9,10,73,51,22,60
Alloa,6766,4,17,9,10,57,44,13,60
Stranraer,6766,5,15,5,16,56,66,-10,50
East Fife,6766,6,14,3,19,49,65,-16,45
Airdrieon,6766,7,11,11,14,46,58,-12,44
Forfar,6766,8,10,5,21,38,65,-27,35
Albion,6766,9,8,6,22,57,80,-23,30
Queen's Park,6766,10,6,11,19,42,75,-33,29
Ayr,6767,1,24,4,8,91,42,49,76
Raith,6767,2,22,9,5,69,33,36,75
Arbroath,6767,3,18,8,10,73,49,24,62
Alloa,6767,4,17,9,10,57,44,13,60
Stranraer,6767,5,15,5,16,55,65,-10,50
East Fife,6767,6,14,3,19,48,64,-16,45
Airdrieon,6767,7,10,11,15,46,60,-14,41
Forfar,6767,8,11,5,20,40,65,-25,38
Albion,6767,9,8,6,22,57,79,-22,30
Queen's Park,6767,10,6,10,20,40,75,-35,28
Ayr,6768,1,24,4,8,94,43,51,76
Raith,6768,2,22,9,5,68,32,36,75
Alloa,6768,3,17,9,10,56,43,13,60
Arbroath,6768,4,17,8,11,72,51,21,59
Stranraer,6768,5,16,5,15,57,65,-8,53
East Fife,6768,6,13,3,20,48,66,-18,42
Airdrieon,6768,7,10,11,15,45,59,-14,41
Forfar,6768,8,11,5,20,39,64,-25,38
Queen's Park,6768,9,7,10,19,42,74,-32,31
Albion,6768,10,8,6,22,58,82,-24,30
Ayr,6769,1,24,4,8,93,42,51,76
Raith,6769,2,22,9,5,69,33,36,75
Arbroath,6769,3,18,8,10,71,48,23,62
Alloa,6769,4,17,9,10,57,44,13,60
Stranraer,6769,5,15,5,16,56,67,-11,50
East Fife,6769,6,14,3,19,50,65,-15,45
Airdrieon,6769,7,10,12,14,46,59,-13,42
Forfar,6769,8,10,6,20,39,65,-26,36
Albion,6769,9,8,6,22,57,81,-24,30
Queen's Park,6769,10,6,10,20,39,73,-34,28
Raith,6770,1,23,8,5,70,32,38,77
Ayr,6770,2,24,4,8,95,45,50,76
Arbroath,6770,3,17,8,11,72,51,21,59
Alloa,6770,4,17,8,11,56,45,11,59
Stranraer,6770,5,15,5,16,57,68,-11,50
East Fife,6770,6,14,3,19,51,66,-15,45
Airdrieon,6770,7,11,11,14,47,58,-11,44
Forfar,6770,8,10,5,21,38,66,-28,35
Queen's Park,6770,9,7,10,19,42,74,-32,31
Albion,6770,10,8,6,22,60,83,-23,30
Raith,6771,1,23,8,5,72,32,40,77
Ayr,6771,2,23,5,8,92,44,48,74
Arbroath,6771,3,17,9,10,71,49,22,60
Alloa,6771,4,17,8,11,56,47,9,59
Stranraer,6771,5,16,5,15,57,65,-8,53
Airdrieon,6771,6,11,11,14,48,59,-11,44
East Fife,6771,7,13,3,20,48,66,-18,42
Forfar,6771,8,10,5,21,39,67,-28,35
Albion,6771,9,8,7,21,59,80,-21,31
Queen's Park,6771,10,6,11,19,40,73,-33,29
Ayr,6772,1,24,4,8,94,42,52,76
Raith,6772,2,22,9,5,68,32,36,75
Alloa,6772,3,17,9,10,56,43,13,60
Arbroath,6772,4,17,8,11,70,51,19,59
Stranraer,6772,5,15,5,16,56,66,-10,50
East Fife,6772,6,14,3,19,49,65,-16,45
Airdrieon,6772,7,10,11,15,46,61,-15,41
Forfar,6772,8,11,5,20,41,65,-24,38
Queen's Park,6772,9,7,10,19,42,72,-30,31
Albion,6772,10,8,6,22,57,82,-25,30
Raith,6773,1,23,8,5,69,32,37,77
Ayr,6773,2,24,4,8,97,45,52,76
Arbroath,6773,3,17,9,10,71,49,22,60
Alloa,6773,4,17,8,11,56,44,12,59
Stranraer,6773,5,15,6,15,57,66,-9,51
Airdrieon,6773,6,11,11,14,48,60,-12,44
East Fife,6773,7,13,4,19,49,66,-17,43
Forfar,6773,8,10,5,21,40,67,-27,35
Albion,6773,9,8,6,22,60,85,-25,30
Queen's Park,6773,10,6,11,19,40,73,-33,29
Raith,6774,1,23,8,5,72,33,39,77
Ayr,6774,2,24,4,8,94,42,52,76
Arbroath,6774,3,17,8,11,70,50,20,59
Alloa,6774,4,17,8,11,57,47,10,59
Stranraer,6774,5,15,6,15,56,65,-9,51
Airdrieon,6774,6,11,11,14,48,59,-11,44
East Fife,6774,7,13,4,19,48,65,-17,43
Forfar,6774,8,10,5,21,39,67,-28,35
Queen's Park,6774,9,7,10,19,41,72,-31,31
Albion,6774,10,8,6,22,57,82,-25,30
Raith,6775,1,23,8,5,71,33,38,77
Ayr,6775,2,24,4,8,93,44,49,76
Arbroath,6775,3,17,8,11,70,51,19,59
Alloa,6775,4,17,8,11,57,46,11,59
Stranraer,6775,5,15,6,15,58,67,-9,51
Airdrieon,6775,6,11,11,14,46,58,-12,44
East Fife,6775,7,13,4,19,50,67,-17,43
Forfar,6775,8,10,5,21,38,65,-27,35
Queen's Park,6775,9,7,10,19,42,72,-30,31
Albion,6775,10,8,6,22,59,81,-22,30
Raith,6776,1,23,8,5,69,32,37,77
Ayr,6776,2,24,4,8,96,43,53,76
Arbroath,6776,3,18,8,10,72,49,23,62
Alloa,6776,4,17,8,11,56,44,12,59
Stranraer,6776,5,16,5,15,57,64,-7,53
Airdrieon,6776,6,10,12,14,46,59,-13,42
East Fife,6776,7,13,3,20,47,66,-19,42
Forfar,6776,8,10,6,20,39,65,-26,36
Albion,6776,9,8,6,22,58,84,-26,30
Queen's Park,6776,10,6,10,20,40,74,-34,28
Raith,6777,1,23,8,5,70,33,37,77
Ayr,6777,2,23,5,8,92,44,48,74
Arbroath,6777,3,17,9,10,71,49,22,60
Alloa,6777,4,17,8,11,57,45,12,59
Stranraer,6777,5,15,5,16,55,65,-10,50
East Fife,6777,6,14,3,19,48,64,-16,45
Airdrieon,6777,7,10,12,14,45,58,-13,42
Forfar,6777,8,10,6,20,38,64,-26,36
Albion,6777,9,8,7,21,59,80,-21,31
Queen's Park,6777,10,6,11,19,40,73,-33,29
Raith,6778,1,23,8,5,72,32,40,77
Ayr,6778,2,24,4,8,93,43,50,76
Arbroath,6778,3,18,8,10,72,49,23,62
Alloa,6778,4,17,8,11,56,47,9,59
Stranraer,6778,5,16,5,15,59,65,-6,53
Airdrieon,6778,6,11,11,14,46,58,-12,44
East Fife,6778,7,13,3,20,48,68,-20,42
Forfar,6778,8,10,5,21,38,65,-27,35
Albion,6778,9,8,6,22,58,81,-23,30
Queen's Park,6778,10,6,10,20,40,74,-34,28
Raith,6779,1,23,8,5,71,34,37,77
Ayr,6779,2,23,4,9,92,45,47,73
Arbroath,6779,3,18,8,10,73,49,24,62
Alloa,6779,4,17,8,11,58,46,12,59
Stranraer,6779,5,15,5,16,56,67,-11,50
East Fife,6779,6,14,3,19,50,65,-15,45
Airdrieon,6779,7,10,11,15,45,59,-14,41
Forfar,6779,8,11,5,20,39,64,-25,38
Albion,6779,9,9,6,21,60,80,-20,33
Queen's Park,6779,10,6,10,20,40,75,-35,28
Raith,6780,1,22,9,5,68,32,36,75
Ayr,6780,2,23,4,9,92,45,47,73
Alloa,6780,3,17,9,10,56,43,13,60
Arbroath,6780,4,17,8,11,71,51,20,59
Stranraer,6780,5,16,5,15,57,65,-8,53
Airdrieon,6780,6,10,12,14,46,59,-13,42
East Fife,6780,7,13,3,20,48,66,-18,42
Forfar,6780,8,10,6,20,39,65,-26,36
Albion,6780,9,9,6,21,60,80,-20,33
Queen's Park,6780,10,7,10,19,42,73,-31,31
Raith,6781,1,23,8,5,70,33,37,77
Ayr,6781,2,24,4,8,91,42,49,76
Arbroath,6781,3,18,8,10,71,48,23,62
Alloa,6781,4,17,8,11,57,45,12,59
Stranraer,6781,5,15,5,16,55,65,-10,50
East Fife,6781,6,14,3,19,48,64,-16,45
Airdrieon,6781,7,11,11,14,46,58,-12,44
Forfar,6781,8,10,5,21,38,65,-27,35
Albion,6781,9,8,6,22,57,79,-22,30
Queen's Park,6781,10,6,10,20,39,73,-34,28
Ayr,6782,1,24,4,8,98,43,55,76
Raith,6782,2,22,9,5,69,33,36,75
Alloa,6782,3,17,9,10,57,44,13,60
Arbroath,6782,4,17,8,11,71,50,21,59
Stranraer,6782,5,15,5,16,55,67,-12,50
East Fife,6782,6,14,3,19,50,64,-14,45
Airdrieon,6782,7,11,11,14,46,58,-12,44
Forfar,6782,8,10,5,21,38,65,-27,35
Queen's Park,6782,9,7,10,19,41,73,-32,31
Albion,6782,10,8,6,22,58,86,-28,30
Raith,6783,1,23,8,5,69,32,37,77
Ayr,6783,2,24,4,8,92,43,49,76
Arbroath,6783,3,18,8,10,72,49,23,62
Alloa,6783,4,17,8,11,56,44,12,59
Stranraer,6783,5,15,6,15,55,64,-9,51
Airdrieon,6783,6,11,11,14,47,58,-11,44
East Fife,6783,7,13,4,19,47,64,-17,43
Forfar,6783,8,10,5,21,38,66,-28,35
Albion,6783,9,8,6,22,58,80,-22,30
Queen's Park,6783,10,6,10,20,40,74,-34,28
Raith,6784,1,23,8,5,69,32,37,77
Ayr,6784,2,23,5,8,92,44,48,74
Arbroath,6784,3,18,8,10,71,48,23,62
Alloa,6784,4,17,8,11,56,44,12,59
Stranraer,6784,5,15,6,15,55,64,-9,51
Airdrieon,6784,6,11,11,14,47,58,-11,44
East Fife,6784,7,13,4,19,47,64,-17,43
Forfar,6784,8,10,5,21,38,66,-28,35
Albion,6784,9,8,7,21,59,80,-21,31
Queen's Park,6784,10,6,10,20,39,73,-34,28
Raith,6785,1,22,9,5,70,34,36,75
Ayr,6785,2,23,4,9,92,45,47,73
Alloa,6785,3,17,9,10,58,45,13,60
Arbroath,6785,4,17,8,11,70,51,19,59
Stranraer,6785,5,16,5,15,59,64,-5,53
East Fife,6785,6,13,3,20,47,68,-21,42
Airdrieon,6785,7,10,11,15,45,60,-15,41
Forfar,6785,8,11,5,20,40,64,-24,38
Albion,6785,9,9,6,21,60,80,-20,33
Queen's Park,6785,10,7,10,19,42,72,-30,31
Raith,6786,1,23,8,5,70,32,38,77
Ayr,6786,2,23,5,8,92,44,48,74
Arbroath,6786,3,17,8,11,71,52,19,59
Alloa,6786,4,17,8,11,56,45,11,59
Stranraer,6786,5,16,5,15,59,67,-8,53
Airdrieon,6786,6,11,11,14,47,58,-11,44
East Fife,6786,7,13,3,20,50,68,-18,42
Forfar,6786,8,10,5,21,38,66,-28,35
Albion,6786,9,8,7,21,59,80,-21,31
Queen's Park,6786,10,7,10,19,43,73,-30,31
Ayr,6787,1,24,4,8,93,43,50,76
Raith,6787,2,22,8,6,68,33,35,74
Arbroath,6787,3,18,8,10,76,50,26,62
Alloa,6787,4,18,8,10,57,43,14,62
Stranraer,6787,5,15,6,15,56,65,-9,51
Airdrieon,6787,6,11,11,14,47,58,-11,44
East Fife,6787,7,13,4,19,48,65,-17,43
Forfar,6787,8,10,5,21,38,66,-28,35
Albion,6787,9,8,6,22,58,81,-23,30
Queen's Park,6787,10,6,10,20,41,78,-37,28
Raith,6788,1,23,8,5,70,33,37,77
Ayr,6788,2,24,4,8,93,43,50,76
Arbroath,6788,3,17,9,10,71,49,22,60
Alloa,6788,4,17,8,11,57,45,12,59
Stranraer,6788,5,16,5,15,56,64,-8,53
East Fife,6788,6,13,3,20,47,65,-18,42
Airdrieon,6788,7,10,11,15,46,60,-14,41
Forfar,6788,8,11,5,20,40,65,-25,38
Albion,6788,9,8,6,22,58,81,-23,30
Queen's Park,6788,10,6,11,19,40,73,-33,29
Raith,6789,1,22,9,5,70,34,36,75
Ayr,6789,2,23,5,8,91,43,48,74
Arbroath,6789,3,18,8,10,72,48,24,62
Alloa,6789,4,17,9,10,58,45,13,60
Stranraer,6789,5,15,5,16,55,66,-11,50
East Fife,6789,6,14,3,19,49,64,-15,45
Airdrieon,6789,7,11,11,14,48,59,-11,44
Forfar,6789,8,10,5,21,39,67,-28,35
Albion,6789,9,8,7,21,58,79,-21,31
Queen's Park,6789,10,6,10,20,39,74,-35,28
Ayr,6790,1,24,4,8,95,44,51,76
Raith,6790,2,22,9,5,68,32,36,75
Arbroath,6790,3,18,8,10,72,48,24,62
Alloa,6790,4,17,9,10,56,43,13,60
Stranraer,6790,5,15,6,15,56,65,-9,51
Airdrieon,6790,6,11,11,14,49,58,-9,44
East Fife,6790,7,13,4,19,48,65,-17,43
Forfar,6790,8,10,5,21,38,68,-30,35
Albion,6790,9,8,6,22,59,83,-24,30
Queen's Park,6790,10,6,10,20,39,74,-35,28
Ayr,6791,1,24,4,8,92,43,49,76
Raith,6791,2,22,8,6,68,34,34,74
Alloa,6791,3,18,8,10,58,43,15,62
Arbroath,6791,4,17,9,10,71,49,22,60
Stranraer,6791,5,15,6,15,56,65,-9,51
Airdrieon,6791,6,11,11,14,47,59,-12,44
East Fife,6791,7,13,4,19,48,65,-17,43
Forfar,6791,8,10,5,21,39,66,-27,35
Albion,6791,9,8,6,22,58,80,-22,30
Queen's Park,6791,10,6,11,19,40,73,-33,29
Ayr,6792,1,24,4,8,95,43,52,76
Raith,6792,2,22,8,6,68,33,35,74
Arbroath,6792,3,18,8,10,73,48,25,62
Alloa,6792,4,18,8,10,57,43,14,62
Stranraer,6792,5,15,5,16,57,67,-10,50
East Fife,6792,6,14,3,19,50,66,-16,45
Airdrieon,6792,7,11,11,14,49,58,-9,44
Forfar,6792,8,10,5,21,38,68,-30,35
Albion,6792,9,8,6,22,58,83,-25,30
Queen's Park,6792,10,6,10,20,39,75,-36,28
Ayr,6793,1,24,4,8,93,44,49,76
Raith,6793,2,22,9,5,68,32,36,75
Arbroath,6793,3,17,9,10,71,49,22,60
Alloa,6793,4,17,9,10,56,43,13,60
Stranraer,6793,5,15,5,16,57,67,-10,50
East Fife,6793,6,14,3,19,50,66,-16,45
Airdrieon,6793,7,10,11,15,46,60,-14,41
Forfar,6793,8,11,5,20,40,65,-25,38
Albion,6793,9,8,6,22,59,81,-22,30
Queen's Park,6793,10,6,11,19,40,73,-33,29
Ayr,6794,1,24,4,8,94,43,51,76
Raith,6794,2,22,8,6,69,34,35,74
Alloa,6794,3,18,8,10,58,44,14,62
Arbroath,6794,4,17,8,11,70,49,21,59
Stranraer,6794,5,15,5,16,55,69,-14,50
East Fife,6794,6,14,3,19,52,64,-12,45
Airdrieon,6794,7,11,11,14,48,60,-12,44
Forfar,6794,8,10,5,21,40,67,-27,35
Queen's Park,6794,9,7,10,19,40,72,-32,31
Albion,6794,10,8,6,22,58,82,-24,30
Raith,6795,1,23,8,5,70,32,38,77
Ayr,6795,2,23,5,8,91,43,48,74
Arbroath,6795,3,18,8,10,73,50,23,62
Alloa,6795,4,17,8,11,56,45,11,59
Stranraer,6795,5,15,5,16,57,67,-10,50
East Fife,6795,6,14,3,19,50,66,-16,45
Airdrieon,6795,7,11,11,14,48,59,-11,44
Forfar,6795,8,10,5,21,39,67,-28,35
Albion,6795,9,8,7,21,58,79,-21,31
Queen's Park,6795,10,6,10,20,41,75,-34,28
Raith,6796,1,23,8,5,69,32,37,77
Ayr,6796,2,24,4,8,93,44,49,76
Arbroath,6796,3,18,8,10,74,49,25,62
Alloa,6796,4,17,8,11,56,44,12,59
Stranraer,6796,5,16,5,15,58,66,-8,53
Airdrieon,6796,6,11,11,14,48,58,-10,44
East Fife,6796,7,13,3,20,49,67,-18,42
Forfar,6796,8,10,5,21,38,67,-29,35
Albion,6796,9,8,6,22,59,81,-22,30
Queen's Park,6796,10,6,10,20,40,76,-36,28
Raith,6797,1,23,8,5,69,32,37,77
Ayr,6797,2,24,4,8,93,43,50,76
Arbroath,6797,3,17,9,10,72,50,22,60
Alloa,6797,4,17,8,11,56,44,12,59
Stranraer,6797,5,16,5,15,57,65,-8,53
Airdrieon,6797,6,11,11,14,46,58,-12,44
East Fife,6797,7,13,3,20,48,66,-18,42
Forfar,6797,8,10,5,21,38,65,-27,35
Albion,6797,9,8,6,22,58,81,-23,30
Queen's Park,6797,10,6,11,19,41,74,-33,29
Raith,6798,1,23,8,5,69,32,37,77
Ayr,6798,2,23,4,9,91,46,45,73
Arbroath,6798,3,17,8,11,70,49,21,59
Alloa,6798,4,17,8,11,56,44,12,59
Stranraer,6798,5,15,6,15,57,66,-9,51
Airdrieon,6798,6,11,11,14,47,59,-12,44
East Fife,6798,7,13,4,19,49,66,-17,43
Forfar,6798,8,10,5,21,39,66,-27,35
Albion,6798,9,9,6,21,61,79,-18,33
Queen's Park,6798,10,7,10,19,40,72,-32,31
Raith,6799,1,23,8,5,71,34,37,77
Ayr,6799,2,24,4,8,95,42,53,76
Arbroath,6799,3,18,8,10,72,49,23,62
Alloa,6799,4,17,8,11,58,46,12,59
Stranraer,6799,5,15,5,16,57,69,-12,50
East Fife,6799,6,14,3,19,52,66,-14,45
Airdrieon,6799,7,11,11,14,48,60,-12,44
Forfar,6799,8,10,5,21,40,67,-27,35
Albion,6799,9,8,6,22,57,83,-26,30
Queen's Park,6799,10,6,10,20,40,74,-34,28
Ayr,6800,1,24,4,8,92,43,49,76
Raith,6800,2,22,8,6,68,33,35,74
Alloa,6800,3,18,8,10,57,43,14,62
Arbroath,6800,4,17,8,11,71,50,21,59
Stranraer,6800,5,15,5,16,56,66,-10,50
East Fife,6800,6,14,3,19,49,65,-16,45
Airdrieon,6800,7,10,12,14,46,59,-13,42
Forfar,6800,8,10,6,20,39,65,-26,36
Queen's Park,6800,9,7,10,19,41,73,-32,31
Albion,6800,10,8,6,22,58,80,-22,30
Raith,6801,1,23,8,5,70,32,38,77
Ayr,6801,2,24,4,8,93,43,50,76
Arbroath,6801,3,17,9,10,70,48,22,60
Alloa,6801,4,17,8,11,56,45,11,59
Stranraer,6801,5,16,5,15,58,66,-8,53
Airdrieon,6801,6,11,11,14,47,59,-12,44
East Fife,6801,7,13,3,20,49,67,-18,42
Forfar,6801,8,10,5,21,39,66,-27,35
Albion,6801,9,8,6,22,58,81,-23,30
Queen's Park,6801,10,6,11,19,39,72,-33,29
Raith,6802,1,23,8,5,69,32,37,77
Ayr,6802,2,24,4,8,95,44,51,76
Arbroath,6802,3,18,8,10,73,48,25,62
Alloa,6802,4,17,8,11,56,44,12,59
Stranraer,6802,5,16,5,15,59,64,-5,53
Airdrieon,6802,6,11,11,14,47,59,-12,44
East Fife,6802,7,13,3,20,47,68,-21,42
Forfar,6802,8,10,5,21,39,66,-27,35
Albion,6802,9,8,6,22,59,83,-24,30
Queen's Park,6802,10,6,10,20,39,75,-36,28
Raith,6803,1,23,8,5,70,32,38,77
Ayr,6803,2,23,5,8,92,44,48,74
Arbroath,6803,3,17,9,10,72,50,22,60
Alloa,6803,4,17,8,11,56,45,11,59
Stranraer,6803,5,15,5,16,57,68,-11,50
East Fife,6803,6,14,3,19,51,66,-15,45
Airdrieon,6803,7,10,12,14,47,60,-13,42
Forfar,6803,8,10,6,20,40,66,-26,36
Albion,6803,9,8,7,21,59,80,-21,31
Queen's Park,6803,10,6,11,19,41,74,-33,29
Raith,6804,1,23,8,5,74,34,40,77
Ayr,6804,2,24,4,8,95,43,52,76
Arbroath,6804,3,17,8,11,71,52,19,59
Alloa,6804,4,17,8,11,58,49,9,59
Stranraer,6804,5,16,5,15,56,64,-8,53
Airdrieon,6804,6,10,12,14,47,60,-13,42
East Fife,6804,7,13,3,20,47,65,-18,42
Forfar,6804,8,10,6,20,40,66,-26,36
Queen's Park,6804,9,7,10,19,43,73,-30,31
Albion,6804,10,8,6,22,58,83,-25,30
Ayr,6805,1,24,4,8,92,43,49,76
Raith,6805,2,22,8,6,68,34,34,74
Arbroath,6805,3,18,8,10,76,49,27,62
Alloa,6805,4,18,8,10,58,43,15,62
Stranraer,6805,5,16,5,15,58,65,-7,53
Airdrieon,6805,6,11,11,14,47,58,-11,44
East Fife,6805,7,13,3,20,48,67,-19,42
Forfar,6805,8,10,5,21,38,66,-28,35
Albion,6805,9,8,6,22,58,80,-22,30
Queen's Park,6805,10,6,10,20,40,78,-38,28
Raith,6806,1,23,8,5,70,32,38,77
Ayr,6806,2,24,4,8,93,44,49,76
Arbroath,6806,3,18,8,10,72,48,24,62
Alloa,6806,4,17,8,11,56,45,11,59
Stranraer,6806,5,16,5,15,58,64,-6,53
Airdrieon,6806,6,11,11,14,48,58,-10,44
East Fife,6806,7,13,3,20,47,67,-20,42
Forfar,6806,8,10,5,21,38,67,-29,35
Albion,6806,9,8,6,22,59,81,-22,30
Queen's Park,6806,10,6,10,20,39,74,-35,28
Ayr,6807,1,24,4,8,93,42,51,76
Raith,6807,2,22,9,5,69,33,36,75
Alloa,6807,3,17,9,10,57,44,13,60
Arbroath,6807,4,17,8,11,71,50,21,59
Stranraer,6807,5,16,5,15,59,64,-5,53
Airdrieon,6807,6,11,11,14,47,58,-11,44
East Fife,6807,7,13,3,20,47,68,-21,42
Forfar,6807,8,10,5,21,38,66,-28,35
Queen's Park,6807,9,7,10,19,41,73,-32,31
Albion,6807,10,8,6,22,57,81,-24,30
Ayr,6808,1,24,4,8,95,44,51,76
Raith,6808,2,22,9,5,69,33,36,75
Alloa,6808,3,17,9,10,57,44,13,60
Arbroath,6808,4,17,8,11,70,50,20,59
Stranraer,6808,5,15,5,16,55,66,-11,50
East Fife,6808,6,14,3,19,49,64,-15,45
Airdrieon,6808,7,10,11,15,45,59,-14,41
Forfar,6808,8,11,5,20,39,64,-25,38
Queen's Park,6808,9,7,10,19,41,72,-31,31
Albion,6808,10,8,6,22,59,83,-24,30
Ayr,6809,1,24,4,8,92,42,50,76
Raith,6809,2,22,8,6,69,34,35,74
Alloa,6809,3,18,8,10,58,44,14,62
Arbroath,6809,4,17,8,11,72,51,21,59
Stranraer,6809,5,15,5,16,56,67,-11,50
East Fife,6809,6,14,3,19,50,65,-15,45
Airdrieon,6809,7,11,11,14,50,59,-9,44
Forfar,6809,8,10,5,21,39,69,-30,35
Queen's Park,6809,9,7,10,19,42,74,-32,31
Albion,6809,10,8,6,22,57,80,-23,30
Ayr,6810,1,24,4,8,94,43,51,76
Raith,6810,2,22,9,5,69,33,36,75
Arbroath,6810,3,18,8,10,72,49,23,62
Alloa,6810,4,17,9,10,57,44,13,60
Stranraer,6810,5,16,5,15,57,65,-8,53
East Fife,6810,6,13,3,20,48,66,-18,42
Airdrieon,6810,7,10,11,15,46,60,-14,41
Forfar,6810,8,11,5,20,40,65,-25,38
Albion,6810,9,8,6,22,58,82,-24,30
Queen's Park,6810,10,6,10,20,40,74,-34,28
Ayr,6811,1,24,4,8,96,43,53,76
Raith,6811,2,22,9,5,69,33,36,75
Alloa,6811,3,17,9,10,57,44,13,60
Arbroath,6811,4,17,8,11,70,50,20,59
Stranraer,6811,5,15,6,15,56,65,-9,51
East Fife,6811,6,13,4,19,48,65,-17,43
Airdrieon,6811,7,10,12,14,45,58,-13,42
Forfar,6811,8,10,6,20,38,64,-26,36
Queen's Park,6811,9,7,10,19,41,72,-31,31
Albion,6811,10,8,6,22,58,84,-26,30
Raith,6812,1,23,8,5,69,32,37,77
Ayr,6812,2,24,4,8,95,44,51,76
Arbroath,6812,3,18,8,10,73,50,23,62
Alloa,6812,4,17,8,11,56,44,12,59
Stranraer,6812,5,16,5,15,56,64,-8,53
Airdrieon,6812,6,11,11,14,47,58,-11,44
East Fife,6812,7,13,3,20,47,65,-18,42
Forfar,6812,8,10,5,21,38,66,-28,35
Albion,6812,9,8,6,22,59,83,-24,30
Queen's Park,6812,10,6,10,20,41,75,-34,28
Ayr,6813,1,24,4,8,93,42,51,76
Raith,6813,2,22,8,6,68,33,35,74
Alloa,6813,3,18,8,10,57,43,14,62
Arbroath,6813,4,17,8,11,70,49,21,59
Stranraer,6813,5,15,5,16,57,67,-10,50
East Fife,6813,6,14,3,19,50,66,-16,45
Airdrieon,6813,7,11,11,14,46,58,-12,44
Forfar,6813,8,10,5,21,38,65,-27,35
Queen's Park,6813,9,7,10,19,40,72,-32,31
Albion,6813,10,8,6,22,57,81,-24,30
Ayr,6814,1,24,4,8,94,42,52,76
Raith,6814,2,22,9,5,69,33,36,75
Alloa,6814,3,17,9,10,57,44,13,60
Arbroath,6814,4,17,8,11,71,51,20,59
Stranraer,6814,5,15,5,16,56,67,-11,50
East Fife,6814,6,14,3,19,50,65,-15,45
Airdrieon,6814,7,10,11,15,45,59,-14,41
Forfar,6814,8,11,5,20,39,64,-25,38
Queen's Park,6814,9,7,10,19,42,73,-31,31
Albion,6814,10,8,6,22,57,82,-25,30
Raith,6815,1,23,8,5,70,33,37,77
Ayr,6815,2,23,5,8,92,44,48,74
Arbroath,6815,3,18,8,10,72,48,24,62
Alloa,6815,4,17,8,11,57,45,12,59
Stranraer,6815,5,15,5,16,56,67,-11,50
East Fife,6815,6,14,3,19,50,65,-15,45
Airdrieon,6815,7,11,11,14,47,59,-12,44
Forfar,6815,8,10,5,21,39,66,-27,35
Albion,6815,9,8,7,21,59,80,-21,31
Queen's Park,6815,10,6,10,20,39,74,-35,28
Ayr,6816,1,24,4,8,95,43,52,76
Raith,6816,2,22,9,5,68,32,36,75
Alloa,6816,3,17,9,10,56,43,13,60
Arbroath,6816,4,17,8,11,71,50,21,59
Stranraer,6816,5,16,5,15,59,64,-5,53
East Fife,6816,6,13,3,20,47,68,-21,42
Airdrieon,6816,7,10,11,15,45,59,-14,41
Forfar,6816,8,11,5,20,39,64,-25,38
Queen's Park,6816,9,7,10,19,41,73,-32,31
Albion,6816,10,8,6,22,58,83,-25,30
Ayr,6817,1,24,4,8,98,45,53,76
Raith,6817,2,22,8,6,69,34,35,74
Arbroath,6817,3,18,8,10,72,49,23,62
Alloa,6817,4,18,8,10,58,44,14,62
Stranraer,6817,5,15,5,16,56,68,-12,50
East Fife,6817,6,14,3,19,51,65,-14,45
Airdrieon,6817,7,11,11,14,48,58,-10,44
Forfar,6817,8,10,5,21,38,67,-29,35
Albion,6817,9,8,6,22,60,86,-26,30
Queen's Park,6817,10,6,10,20,40,74,-34,28
Raith,6818,1,23,8,5,69,32,37,77
Ayr,6818,2,24,4,8,93,42,51,76
Arbroath,6818,3,18,8,10,72,49,23,62
Alloa,6818,4,17,8,11,56,44,12,59
Stranraer,6818,5,15,5,16,55,66,-11,50
East Fife,6818,6,14,3,19,49,64,-15,45
Airdrieon,6818,7,11,11,14,46,58,-12,44
Forfar,6818,8,10,5,21,38,65,-27,35
Albion,6818,9,8,6,22,57,81,-24,30
Queen's Park,6818,10,6,10,20,40,74,-34,28
Raith,6819,1,23,8,5,71,32,39,77
Ayr,6819,2,24,4,8,95,43,52,76
Arbroath,6819,3,17,9,10,71,49,22,60
Alloa,6819,4,17,8,11,56,46,10,59
Stranraer,6819,5,16,5,15,57,65,-8,53
Airdrieon,6819,6,10,12,14,45,58,-13,42
East Fife,6819,7,13,3,20,48,66,-18,42
Forfar,6819,8,10,6,20,38,64,-26,36
Albion,6819,9,8,6,22,58,83,-25,30
Queen's Park,6819,10,6,11,19,40,73,-33,29
Raith,6820,1,23,8,5,74,33,41,77
Ayr,6820,2,23,4,9,92,45,47,73
Arbroath,6820,3,17,8,11,71,50,21,59
Alloa,6820,4,17,8,11,57,49,8,59
Stranraer,6820,5,15,5,16,57,69,-12,50
East Fife,6820,6,14,3,19,52,66,-14,45
Airdrieon,6820,7,11,11,14,48,59,-11,44
Forfar,6820,8,10,5,21,39,67,-28,35
Albion,6820,9,9,6,21,60,80,-20,33
Queen's Park,6820,10,7,10,19,41,73,-32,31
Raith,6821,1,23,8,5,71,32,39,77
Ayr,6821,2,24,4,8,95,44,51,76
Arbroath,6821,3,17,8,11,70,50,20,59
Alloa,6821,4,17,8,11,56,46,10,59
Stranraer,6821,5,16,5,15,59,64,-5,53
Airdrieon,6821,6,10,12,14,46,59,-13,42
East Fife,6821,7,13,3,20,47,68,-21,42
Forfar,6821,8,10,6,20,39,65,-26,36
Queen's Park,6821,9,7,10,19,41,72,-31,31
Albion,6821,10,8,6,22,59,83,-24,30
Raith,6822,1,23,8,5,72,32,40,77
Ayr,6822,2,24,4,8,94,44,50,76
Arbroath,6822,3,17,8,11,72,51,21,59
Alloa,6822,4,17,8,11,56,47,9,59
Stranraer,6822,5,16,5,15,59,66,-7,53
Airdrieon,6822,6,11,11,14,48,59,-11,44
East Fife,6822,7,13,3,20,49,68,-19,42
Forfar,6822,8,10,5,21,39,67,-28,35
Queen's Park,6822,9,7,10,19,42,74,-32,31
Albion,6822,10,8,6,22,59,82,-23,30
Raith,6823,1,22,9,5,68,32,36,75
Ayr,6823,2,23,4,9,91,44,47,73
Arbroath,6823,3,18,8,10,73,49,24,62
Alloa,6823,4,17,9,10,56,43,13,60
Stranraer,6823,5,15,5,16,57,67,-10,50
East Fife,6823,6,14,3,19,50,66,-16,45
Airdrieon,6823,7,11,11,14,48,59,-11,44
Forfar,6823,8,10,5,21,39,67,-28,35
Albion,6823,9,9,6,21,59,79,-20,33
Queen's Park,6823,10,6,10,20,40,75,-35,28
Raith,6824,1,23,8,5,71,32,39,77
Ayr,6824,2,24,4,8,92,42,50,76
Arbroath,6824,3,18,8,10,74,50,24,62
Alloa,6824,4,17,8,11,56,46,10,59
Stranraer,6824,5,16,5,15,58,66,-8,53
Airdrieon,6824,6,11,11,14,47,59,-12,44
East Fife,6824,7,13,3,20,49,67,-18,42
Forfar,6824,8,10,5,21,39,66,-27,35
Albion,6824,9,8,6,22,57,80,-23,30
Queen's Park,6824,10,6,10,20,41,76,-35,28
Raith,6825,1,22,8,6,68,34,34,74
Ayr,6825,2,23,4,9,90,43,47,73
Alloa,6825,3,18,8,10,58,43,15,62
Arbroath,6825,4,17,9,10,72,50,22,60
Stranraer,6825,5,15,5,16,56,66,-10,50
East Fife,6825,6,14,3,19,49,65,-16,45
Airdrieon,6825,7,11,11,14,47,58,-11,44
Forfar,6825,8,10,5,21,38,66,-28,35
Albion,6825,9,9,6,21,58,78,-20,33
Queen's Park,6825,10,6,11,19,41,74,-33,29
Ayr,6826,1,23,5,8,90,42,48,74
Raith,6826,2,22,8,6,68,33,35,74
Alloa,6826,3,18,8,10,57,43,14,62
Arbroath,6826,4,17,9,10,70,48,22,60
Stranraer,6826,5,15,6,15,56,65,-9,51
Airdrieon,6826,6,11,11,14,48,59,-11,44
East Fife,6826,7,13,4,19,48,65,-17,43
Forfar,6826,8,10,5,21,39,67,-28,35
Albion,6826,9,8,7,21,57,78,-21,31
Queen's Park,6826,10,6,11,19,39,72,-33,29
Ayr,6827,1,24,4,8,93,44,49,76
Raith,6827,2,22,8,6,68,33,35,74
Arbroath,6827,3,18,8,10,74,48,26,62
Alloa,6827,4,18,8,10,57,43,14,62
Stranraer,6827,5,15,5,16,56,67,-11,50
East Fife,6827,6,14,3,19,50,65,-15,45
Airdrieon,6827,7,11,11,14,47,59,-12,44
Forfar,6827,8,10,5,21,39,66,-27,35
Albion,6827,9,8,6,22,59,81,-22,30
Queen's Park,6827,10,6,10,20,39,76,-37,28
Raith,6828,1,23,8,5,69,32,37,77
Ayr,6828,2,24,4,8,92,42,50,76
Arbroath,6828,3,18,8,10,74,50,24,62
Alloa,6828,4,17,8,11,56,44,12,59
Stranraer,6828,5,16,5,15,56,64,-8,53
Airdrieon,6828,6,10,12,14,45,58,-13,42
East Fife,6828,7,13,3,20,47,65,-18,42
Forfar,6828,8,10,6,20,38,64,-26,36
Albion,6828,9,8,6,22,57,80,-23,30
Queen's Park,6828,10,6,10,20,41,76,-35,28
Raith,6829,1,23,8,5,70,32,38,77
Ayr,6829,2,23,4,9,92,46,46,73
Arbroath,6829,3,17,8,11,70,49,21,59
Alloa,6829,4,17,8,11,56,45,11,59
Stranraer,6829,5,16,5,15,57,65,-8,53
Airdrieon,6829,6,11,11,14,48,58,-10,44
East Fife,6829,7,13,3,20,48,66,-18,42
Forfar,6829,8,10,5,21,38,67,-29,35
Albion,6829,9,9,6,21,61,80,-19,33
Queen's Park,6829,10,7,10,19,40,72,-32,31
Raith,6830,1,23,8,5,69,32,37,77
Ayr,6830,2,24,4,8,93,44,49,76
Arbroath,6830,3,17,8,11,70,50,20,59
Alloa,6830,4,17,8,11,56,44,12,59
Stranraer,6830,5,16,5,15,56,64,-8,53
Airdrieon,6830,6,11,11,14,49,58,-9,44
East Fife,6830,7,13,3,20,47,65,-18,42
Forfar,6830,8,10,5,21,38,68,-30,35
Queen's Park,6830,9,7,10,19,41,72,-31,31
Albion,6830,10,8,6,22,59,81,-22,30
Ayr,6831,1,24,4,8,94,43,51,76
Raith,6831,2,22,8,6,69,34,35,74
Arbroath,6831,3,18,8,10,74,49,25,62
Alloa,6831,4,18,8,10,58,44,14,62
Stranraer,6831,5,15,5,16,55,67,-12,50
East Fife,6831,6,14,3,19,50,64,-14,45
Airdrieon,6831,7,10,11,15,45,60,-15,41
Forfar,6831,8,11,5,20,40,64,-24,38
Albion,6831,9,8,6,22,58,82,-24,30
Queen's Park,6831,10,6,10,20,40,76,-36,28
Raith,6832,1,22,9,5,68,32,36,75
Ayr,6832,2,23,4,9,93,46,47,73
Arbroath,6832,3,18,8,10,74,51,23,62
Alloa,6832,4,17,9,10,56,43,13,60
Stranraer,6832,5,15,6,15,57,66,-9,51
East Fife,6832,6,13,4,19,49,66,-17,43
Airdrieon,6832,7,10,11,15,46,60,-14,41
Forfar,6832,8,11,5,20,40,65,-25,38
Albion,6832,9,9,6,21,61,81,-20,33
Queen's Park,6832,10,6,10,20,42,76,-34,28
Ayr,6833,1,24,4,8,95,43,52,76
Raith,6833,2,22,8,6,69,34,35,74
Arbroath,6833,3,18,8,10,71,48,23,62
Alloa,6833,4,18,8,10,58,44,14,62
Stranraer,6833,5,15,6,15,55,64,-9,51
Airdrieon,6833,6,11,11,14,47,58,-11,44
East Fife,6833,7,13,4,19,47,64,-17,43
Forfar,6833,8,10,5,21,38,66,-28,35
Albion,6833,9,8,6,22,58,83,-25,30
Queen's Park,6833,10,6,10,20,39,73,-34,28
Ayr,6834,1,24,4,8,94,43,51,76
Raith,6834,2,22,8,6,68,33,35,74
Alloa,6834,3,18,8,10,57,43,14,62
Arbroath,6834,4,17,8,11,73,52,21,59
Stranraer,6834,5,15,5,16,57,67,-10,50
East Fife,6834,6,14,3,19,50,66,-16,45
Airdrieon,6834,7,11,11,14,49,59,-10,44
Forfar,6834,8,10,5,21,39,68,-29,35
Queen's Park,6834,9,7,10,19,43,75,-32,31
Albion,6834,10,8,6,22,58,82,-24,30
Ayr,6835,1,24,4,8,91,42,49,76
Raith,6835,2,22,8,6,68,33,35,74
Alloa,6835,3,18,8,10,57,43,14,62
Arbroath,6835,4,17,9,10,70,48,22,60
Stranraer,6835,5,15,5,16,57,68,-11,50
East Fife,6835,6,14,3,19,51,66,-15,45
Airdrieon,6835,7,10,11,15,46,61,-15,41
Forfar,6835,8,11,5,20,41,65,-24,38
Albion,6835,9,8,6,22,57,79,-22,30
Queen's Park,6835,10,6,11,19,39,72,-33,29
Ayr,6836,1,24,4,8,94,45,49,76
Raith,6836,2,22,8,6,69,34,35,74
Alloa,6836,3,18,8,10,58,44,14,62
Arbroath,6836,4,17,8,11,72,51,21,59
Stranraer,6836,5,15,5,16,55,66,-11,50
East Fife,6836,6,14,3,19,49,64,-15,45
Airdrieon,6836,7,11,11,14,47,58,-11,44
Forfar,6836,8,10,5,21,38,66,-28,35
Queen's Park,6836,9,7,10,19,42,74,-32,31
Albion,6836,10,8,6,22,60,82,-22,30
Ayr,6837,1,24,4,8,94,42,52,76
Raith,6837,2,22,8,6,69,34,35,74
Alloa,6837,3,18,8,10,58,44,14,62
Arbroath,6837,4,17,8,11,72,51,21,59
Stranraer,6837,5,15,5,16,58,68,-10,50
East Fife,6837,6,14,3,19,51,67,-16,45
Airdrieon,6837,7,11,11,14,47,58,-11,44
Forfar,6837,8,10,5,21,38,66,-28,35
Queen's Park,6837,9,7,10,19,42,74,-32,31
Albion,6837,10,8,6,22,57,82,-25,30
Raith,6838,1,23,8,5,71,32,39,77
Ayr,6838,2,24,4,8,93,42,51,76
Arbroath,6838,3,17,8,11,70,51,19,59
Alloa,6838,4,17,8,11,56,46,10,59
Stranraer,6838,5,16,5,15,57,65,-8,53
Airdrieon,6838,6,11,11,14,48,60,-12,44
East Fife,6838,7,13,3,20,48,66,-18,42
Forfar,6838,8,10,5,21,40,67,-27,35
Queen's Park,6838,9,7,10,19,42,72,-30,31
Albion,6838,10,8,6,22,57,81,-24,30
Ayr,6839,1,24,4,8,93,42,51,76
Raith,6839,2,22,9,5,69,33,36,75
Arbroath,6839,3,18,8,10,72,49,23,62
Alloa,6839,4,17,9,10,57,44,13,60
Stranraer,6839,5,16,5,15,58,65,-7,53
East Fife,6839,6,13,3,20,48,67,-19,42
Airdrieon,6839,7,10,11,15,45,60,-15,41
Forfar,6839,8,11,5,20,40,64,-24,38
Albion,6839,9,8,6,22,57,81,-24,30
Queen's Park,6839,10,6,10,20,40,74,-34,28
Raith,6840,1,23,8,5,70,33,37,77
Ayr,6840,2,24,4,8,92,42,50,76
Arbroath,6840,3,17,8,11,71,52,19,59
Alloa,6840,4,17,8,11,57,45,12,59
Stranraer,6840,5,15,5,16,56,66,-10,50
East Fife,6840,6,14,3,19,49,65,-16,45
Airdrieon,6840,7,11,11,14,47,59,-12,44
Forfar,6840,8,10,5,21,39,66,-27,35
Queen's Park,6840,9,7,10,19,43,73,-30,31
Albion,6840,10,8,6,22,57,80,-23,30
Raith,6841,1,23,8,5,69,32,37,77
Ayr,6841,2,23,5,8,91,43,48,74
Arbroath,6841,3,17,9,10,70,48,22,60
Alloa,6841,4,17,8,11,56,44,12,59
Stranraer,6841,5,15,5,16,55,66,-11,50
East Fife,6841,6,14,3,19,49,64,-15,45
Airdrieon,6841,7,10,11,15,45,59,-14,41
Forfar,6841,8,11,5,20,39,64,-25,38
Albion,6841,9,8,7,21,58,79,-21,31
Queen's Park,6841,10,6,11,19,39,72,-33,29
Raith,6842,1,23,8,5,73,35,38,77
Ayr,6842,2,24,4,8,93,42,51,76
Arbroath,6842,3,18,8,10,75,49,26,62
Alloa,6842,4,17,8,11,59,48,11,59
Stranraer,6842,5,15,5,16,58,68,-10,50
East Fife,6842,6,14,3,19,51,67,-16,45
Airdrieon,6842,7,11,11,14,48,59,-11,44
Forfar,6842,8,10,5,21,39,67,-28,35
Albion,6842,9,8,6,22,57,81,-24,30
Queen's Park,6842,10,6,10,20,40,77,-37,28
Raith,6843,1,23,8,5,70,33,37,77
Ayr,6843,2,24,4,8,94,42,52,76
Arbroath,6843,3,18,8,10,73,48,25,62
Alloa,6843,4,17,8,11,57,45,12,59
Stranraer,6843,5,16,5,15,57,65,-8,53
Airdrieon,6843,6,11,11,14,47,59,-12,44
East Fife,6843,7,13,3,20,48,66,-18,42
Forfar,6843,8,10,5,21,39,66,-27,35
Albion,6843,9,8,6,22,57,82,-25,30
Queen's Park,6843,10,6,10,20,39,75,-36,28
Raith,6844,1,23,8,5,70,33,37,77
Ayr,6844,2,24,4,8,94,44,50,76
Arbroath,6844,3,17,8,11,70,51,19,59
Alloa,6844,4,17,8,11,57,45,12,59
Stranraer,6844,5,16,5,15,57,65,-8,53
Airdrieon,6844,6,11,11,14,46,58,-12,44
East Fife,6844,7,13,3,20,48,66,-18,42
Forfar,6844,8,10,5,21,38,65,-27,35
Queen's Park,6844,9,7,10,19,42,72,-30,31
Albion,6844,10,8,6,22,59,82,-23,30
Ayr,6845,1,24,4,8,93,42,51,76
Raith,6845,2,22,9,5,70,34,36,75
Arbroath,6845,3,17,9,10,71,49,22,60
Alloa,6845,4,17,9,10,58,45,13,60
Stranraer,6845,5,16,5,15,57,65,-8,53
Airdrieon,6845,6,11,11,14,46,58,-12,44
East Fife,6845,7,13,3,20,48,66,-18,42
Forfar,6845,8,10,5,21,38,65,-27,35
Albion,6845,9,8,6,22,57,81,-24,30
Queen's Park,6845,10,6,11,19,40,73,-33,29
Ayr,6846,1,24,4,8,91,42,49,76
Raith,6846,2,22,8,6,68,34,34,74
Alloa,6846,3,18,8,10,58,43,15,62
Arbroath,6846,4,17,9,10,72,50,22,60
Stranraer,6846,5,16,5,15,57,65,-8,53
Airdrieon,6846,6,11,11,14,49,61,-12,44
East Fife,6846,7,13,3,20,48,66,-18,42
Forfar,6846,8,10,5,21,41,68,-27,35
Albion,6846,9,8,6,22,57,79,-22,30
Queen's Park,6846,10,6,11,19,41,74,-33,29
Raith,6847,1,23,8,5,69,32,37,77
Ayr,6847,2,24,4,8,95,44,51,76
Arbroath,6847,3,17,9,10,72,50,22,60
Alloa,6847,4,17,8,11,56,44,12,59
Stranraer,6847,5,15,6,15,55,64,-9,51
East Fife,6847,6,13,4,19,47,64,-17,43
Airdrieon,6847,7,10,12,14,45,58,-13,42
Forfar,6847,8,10,6,20,38,64,-26,36
Albion,6847,9,8,6,22,59,83,-24,30
Queen's Park,6847,10,6,11,19,41,74,-33,29
Raith,6848,1,23,8,5,71,32,39,77
Ayr,6848,2,24,4,8,93,44,49,76
Arbroath,6848,3,18,8,10,73,48,25,62
Alloa,6848,4,17,8,11,56,46,10,59
Stranraer,6848,5,15,5,16,55,67,-12,50
East Fife,6848,6,14,3,19,50,64,-14,45
Airdrieon,6848,7,11,11,14,47,59,-12,44
Forfar,6848,8,10,5,21,39,66,-27,35
Albion,6848,9,8,6,22,59,81,-22,30
Queen's Park,6848,10,6,10,20,39,75,-36,28
Raith,6849,1,23,8,5,69,32,37,77
Ayr,6849,2,24,4,8,94,43,51,76
Arbroath,6849,3,17,8,11,71,51,20,59
Alloa,6849,4,17,8,11,56,44,12,59
Stranraer,6849,5,15,5,16,57,68,-11,50
East Fife,6849,6,14,3,19,51,66,-15,45
Airdrieon,6849,7,11,11,14,47,58,-11,44
Forfar,6849,8,10,5,21,38,66,-28,35
Queen's Park,6849,9,7,10,19,42,73,-31,31
Albion,6849,10,8,6,22,58,82,-24,30
Ayr,6850,1,24,4,8,93,42,51,76
Raith,6850,2,22,8,6,69,34,35,74
Alloa,6850,3,18,8,10,58,44,14,62
Arbroath,6850,4,17,8,11,71,51,20,59
Stranraer,6850,5,16,5,15,59,65,-6,53
Airdrieon,6850,6,11,11,14,47,59,-12,44
East Fife,6850,7,13,3,20,48,68,-20,42
Forfar,6850,8,10,5,21,39,66,-27,35
Queen's Park,6850,9,7,10,19,42,73,-31,31
Albion,6850,10,8,6,22,57,81,-24,30
Ayr,6851,1,24,4,8,95,42,53,76
Raith,6851,2,22,8,6,69,35,34,74
Alloa,6851,3,18,8,10,59,44,15,62
Arbroath,6851,4,17,8,11,70,49,21,59
Stranraer,6851,5,15,5,16,56,66,-10,50
East Fife,6851,6,14,3,19,49,65,-16,45
Airdrieon,6851,7,10,12,14,46,59,-13,42
Forfar,6851,8,10,6,20,39,65,-26,36
Queen's Park,6851,9,7,10,19,40,72,-32,31
Albion,6851,10,8,6,22,57,83,-26,30
Ayr,6852,1,24,4,8,93,43,50,76
Raith,6852,2,22,9,5,69,33,36,75
Arbroath,6852,3,18,8,10,71,48,23,62
Alloa,6852,4,17,9,10,57,44,13,60
Stranraer,6852,5,15,5,16,55,66,-11,50
East Fife,6852,6,14,3,19,49,64,-15,45
Airdrieon,6852,7,10,11,15,45,59,-14,41
Forfar,6852,8,11,5,20,39,64,-25,38
Albion,6852,9,8,6,22,58,81,-23,30
Queen's Park,6852,10,6,10,20,39,73,-34,28
Raith,6853,1,22,9,5,68,32,36,75
Ayr,6853,2,23,5,8,92,44,48,74
Arbroath,6853,3,18,8,10,74,49,25,62
Alloa,6853,4,17,9,10,56,43,13,60
Stranraer,6853,5,15,6,15,56,65,-9,51
East Fife,6853,6,13,4,19,48,65,-17,43
Airdrieon,6853,7,10,11,15,45,61,-16,41
Forfar,6853,8,11,5,20,41,64,-23,38
Albion,6853,9,8,7,21,59,80,-21,31
Queen's Park,6853,10,6,10,20,40,76,-36,28
Ayr,6854,1,24,4,8,93,43,50,76
Raith,6854,2,22,9,5,69,33,36,75
Arbroath,6854,3,17,9,10,72,50,22,60
Alloa,6854,4,17,9,10,57,44,13,60
Stranraer,6854,5,15,5,16,55,67,-12,50
East Fife,6854,6,14,3,19,50,64,-14,45
Airdrieon,6854,7,10,12,14,46,59,-13,42
Forfar,6854,8,10,6,20,39,65,-26,36
Albion,6854,9,8,6,22,58,81,-23,30
Queen's Park,6854,10,6,11,19,41,74,-33,29
Ayr,6855,1,24,4,8,97,44,53,76
Raith,6855,2,22,8,6,69,34,35,74
Alloa,6855,3,18,8,10,58,44,14,62
Arbroath,6855,4,17,9,10,73,51,22,60
Stranraer,6855,5,15,6,15,56,65,-9,51
East Fife,6855,6,13,4,19,48,65,-17,43
Airdrieon,6855,7,10,12,14,46,59,-13,42
Forfar,6855,8,10,6,20,39,65,-26,36
Albion,6855,9,8,6,22,59,85,-26,30
Queen's Park,6855,10,6,11,19,42,75,-33,29
Ayr,6856,1,24,4,8,95,42,53,76
Raith,6856,2,22,9,5,68,32,36,75
Alloa,6856,3,17,9,10,56,43,13,60
Arbroath,6856,4,17,8,11,72,52,20,59
Stranraer,6856,5,16,5,15,57,64,-7,53
Airdrieon,6856,6,11,11,14,47,58,-11,44
East Fife,6856,7,13,3,20,47,66,-19,42
Forfar,6856,8,10,5,21,38,66,-28,35
Queen's Park,6856,9,7,10,19,43,74,-31,31
Albion,6856,10,8,6,22,57,83,-26,30
Ayr,6857,1,24,4,8,93,43,50,76
Raith,6857,2,22,9,5,68,32,36,75
Alloa,6857,3,17,9,10,56,43,13,60
Arbroath,6857,4,17,8,11,70,49,21,59
Stranraer,6857,5,15,5,16,55,65,-10,50
East Fife,6857,6,14,3,19,48,64,-16,45
Airdrieon,6857,7,10,12,14,46,59,-13,42
Forfar,6857,8,10,6,20,39,65,-26,36
Queen's Park,6857,9,7,10,19,40,72,-32,31
Albion,6857,10,8,6,22,58,81,-23,30
Raith,6858,1,23,8,5,71,34,37,77
Ayr,6858,2,24,4,8,94,44,50,76
Arbroath,6858,3,17,8,11,72,51,21,59
Alloa,6858,4,17,8,11,58,46,12,59
Stranraer,6858,5,15,5,16,55,66,-11,50
East Fife,6858,6,14,3,19,49,64,-15,45
Airdrieon,6858,7,10,11,15,46,60,-14,41
Forfar,6858,8,11,5,20,40,65,-25,38
Queen's Park,6858,9,7,10,19,42,74,-32,31
Albion,6858,10,8,6,22,59,82,-23,30
Raith,6859,1,23,8,5,71,32,39,77
Ayr,6859,2,24,4,8,95,44,51,76
Arbroath,6859,3,17,8,11,70,50,20,59
Alloa,6859,4,17,8,11,56,46,10,59
Stranraer,6859,5,16,5,15,56,64,-8,53
Airdrieon,6859,6,11,11,14,50,59,-9,44
East Fife,6859,7,13,3,20,47,65,-18,42
Forfar,6859,8,10,5,21,39,69,-30,35
Queen's Park,6859,9,7,10,19,41,72,-31,31
Albion,6859,10,8,6,22,59,83,-24,30
Ayr,6860,1,24,4,8,94,45,49,76
Raith,6860,2,22,9,5,70,34,36,75
Arbroath,6860,3,18,8,10,75,49,26,62
Alloa,6860,4,17,9,10,58,45,13,60
Stranraer,6860,5,15,6,15,55,64,-9,51
East Fife,6860,6,13,4,19,47,64,-17,43
Airdrieon,6860,7,10,11,15,45,59,-14,41
Forfar,6860,8,11,5,20,39,64,-25,38
Albion,6860,9,8,6,22,60,82,-22,30
Queen's Park,6860,10,6,10,20,40,77,-37,28
Ayr,6861,1,24,4,8,94,43,51,76
Raith,6861,2,22,9,5,69,33,36,75
Alloa,6861,3,17,9,10,57,44,13,60
Arbroath,6861,4,17,8,11,70,49,21,59
Stranraer,6861,5,15,5,16,57,68,-11,50
East Fife,6861,6,14,3,19,51,66,-15,45
Airdrieon,6861,7,11,11,14,47,58,-11,44
Forfar,6861,8,10,5,21,38,66,-28,35
Queen's Park,6861,9,7,10,19,40,72,-32,31
Albion,6861,10,8,6,22,58,82,-24,30
Raith,6862,1,23,8,5,70,33,37,77
Ayr,6862,2,24,4,8,94,42,52,76
Arbroath,6862,3,18,8,10,72,48,24,62
Alloa,6862,4,17,8,11,57,45,12,59
Stranraer,6862,5,15,5,16,56,67,-11,50
East Fife,6862,6,14,3,19,50,65,-15,45
Airdrieon,6862,7,10,12,14,46,59,-13,42
Forfar,6862,8,10,6,20,39,65,-26,36
Albion,6862,9,8,6,22,57,82,-25,30
Queen's Park,6862,10,6,10,20,39,74,-35,28
Raith,6863,1,23,8,5,69,32,37,77
Ayr,6863,2,24,4,8,93,43,50,76
Arbroath,6863,3,18,8,10,74,50,24,62
Alloa,6863,4,17,8,11,56,44,12,59
Stranraer,6863,5,15,5,16,55,66,-11,50
East Fife,6863,6,14,3,19,49,64,-15,45
Airdrieon,6863,7,11,11,14,48,59,-11,44
Forfar,6863,8,10,5,21,39,67,-28,35
Albion,6863,9,8,6,22,58,81,-23,30
Queen's Park,6863,10,6,10,20,41,76,-35,28
Raith,6864,1,22,8,6,68,33,35,74
Ayr,6864,2,23,4,9,94,47,47,73
Alloa,6864,3,18,8,10,57,43,14,62
Arbroath,6864,4,17,8,11,73,53,20,59
Stranraer,6864,5,15,5,16,55,67,-12,50
East Fife,6864,6,14,3,19,50,64,-14,45
Airdrieon,6864,7,10,11,15,45,59,-14,41
Forfar,6864,8,11,5,20,39,64,-25,38
Albion,6864,9,9,6,21,62,82,-20,33
Queen's Park,6864,10,7,10,19,44,75,-31,31
Raith,6865,1,23,8,5,70,33,37,77
Ayr,6865,2,23,4,9,91,44,47,73
Arbroath,6865,3,18,8,10,72,49,23,62
Alloa,6865,4,17,8,11,57,45,12,59
Stranraer,6865,5,16,5,15,56,64,-8,53
Airdrieon,6865,6,10,12,14,47,60,-13,42
East Fife,6865,7,13,3,20,47,65,-18,42
Forfar,6865,8,10,6,20,40,66,-26,36
Albion,6865,9,9,6,21,59,79,-20,33
Queen's Park,6865,10,6,10,20,40,74,-34,28
Raith,6866,1,23,8,5,71,34,37,77
Ayr,6866,2,23,5,8,92,44,48,74
Arbroath,6866,3,18,8,10,73,49,24,62
Alloa,6866,4,17,8,11,58,46,12,59
Stranraer,6866,5,15,5,16,55,68,-13,50
East Fife,6866,6,14,3,19,51,64,-13,45
Airdrieon,6866,7,11,11,14,46,58,-12,44
Forfar,6866,8,10,5,21,38,65,-27,35
Albion,6866,9,8,7,21,59,80,-21,31
Queen's Park,6866,10,6,10,20,40,75,-35,28
Raith,6867,1,23,8,5,69,32,37,77
Ayr,6867,2,23,5,8,92,44,48,74
Arbroath,6867,3,18,8,10,72,48,24,62
Alloa,6867,4,17,8,11,56,44,12,59
Stranraer,6867,5,16,5,15,59,66,-7,53
Airdrieon,6867,6,11,11,14,48,59,-11,44
East Fife,6867,7,13,3,20,49,68,-19,42
Forfar,6867,8,10,5,21,39,67,-28,35
Albion,6867,9,8,7,21,59,80,-21,31
Queen's Park,6867,10,6,10,20,39,74,-35,28
Ayr,6868,1,24,4,8,93,43,50,76
Raith,6868,2,22,9,5,69,33,36,75
Alloa,6868,3,17,9,10,57,44,13,60
Arbroath,6868,4,17,8,11,72,51,21,59
Stranraer,6868,5,16,5,15,56,64,-8,53
East Fife,6868,6,13,3,20,47,65,-18,42
Airdrieon,6868,7,10,11,15,46,60,-14,41
Forfar,6868,8,11,5,20,40,65,-25,38
Queen's Park,6868,9,7,10,19,42,74,-32,31
Albion,6868,10,8,6,22,58,81,-23,30
Raith,6869,1,23,8,5,70,33,37,77
Ayr,6869,2,23,5,8,92,44,48,74
Arbroath,6869,3,17,9,10,73,51,22,60
Alloa,6869,4,17,8,11,57,45,12,59
Stranraer,6869,5,15,5,16,55,65,-10,50
East Fife,6869,6,14,3,19,48,64,-16,45
Airdrieon,6869,7,10,11,15,45,60,-15,41
Forfar,6869,8,11,5,20,40,64,-24,38
Albion,6869,9,8,7,21,59,80,-21,31
Queen's Park,6869,10,6,11,19,42,75,-33,29
Raith,6870,1,23,8,5,71,32,39,77
Ayr,6870,2,23,5,8,94,46,48,74
Arbroath,6870,3,18,8,10,72,48,24,62
Alloa,6870,4,17,8,11,56,46,10,59
Stranraer,6870,5,15,6,15,57,66,-9,51
Airdrieon,6870,6,11,11,14,48,59,-11,44
East Fife,6870,7,13,4,19,49,66,-17,43
Forfar,6870,8,10,5,21,39,67,-28,35
Albion,6870,9,8,7,21,61,82,-21,31
Queen's Park,6870,10,6,10,20,39,74,-35,28
Ayr,6871,1,24,4,8,94,42,52,76
Raith,6871,2,22,9,5,68,32,36,75
Alloa,6871,3,17,9,10,56,43,13,60
Arbroath,6871,4,17,8,11,72,51,21,59
Stranraer,6871,5,15,5,16,56,67,-11,50
East Fife,6871,6,14,3,19,50,65,-15,45
Airdrieon,6871,7,11,11,14,46,58,-12,44
Forfar,6871,8,10,5,21,38,65,-27,35
Queen's Park,6871,9,7,10,19,42,74,-32,31
Albion,6871,10,8,6,22,57,82,-25,30
Raith,6872,1,23,8,5,69,32,37,77
Ayr,6872,2,24,4,8,95,44,51,76
Arbroath,6872,3,17,8,11,70,50,20,59
Alloa,6872,4,17,8,11,56,44,12,59
Stranraer,6872,5,15,5,16,56,68,-12,50
East Fife,6872,6,14,3,19,51,65,-14,45
Airdrieon,6872,7,11,11,14,46,58,-12,44
Forfar,6872,8,10,5,21,38,65,-27,35
Queen's Park,6872,9,7,10,19,41,72,-31,31
Albion,6872,10,8,6,22,59,83,-24,30
Ayr,6873,1,24,4,8,93,44,49,76
Raith,6873,2,22,9,5,68,32,36,75
Arbroath,6873,3,18,8,10,72,48,24,62
Alloa,6873,4,17,9,10,56,43,13,60
Stranraer,6873,5,15,5,16,55,66,-11,50
East Fife,6873,6,14,3,19,49,64,-15,45
Airdrieon,6873,7,11,11,14,46,58,-12,44
Forfar,6873,8,10,5,21,38,65,-27,35
Albion,6873,9,8,6,22,59,81,-22,30
Queen's Park,6873,10,6,10,20,39,74,-35,28
Raith,6874,1,23,8,5,69,32,37,77
Ayr,6874,2,24,4,8,94,43,51,76
Arbroath,6874,3,17,8,11,70,49,21,59
Alloa,6874,4,17,8,11,56,44,12,59
Stranraer,6874,5,15,6,15,58,67,-9,51
Airdrieon,6874,6,11,11,14,46,58,-12,44
East Fife,6874,7,13,4,19,50,67,-17,43
Forfar,6874,8,10,5,21,38,65,-27,35
Queen's Park,6874,9,7,10,19,40,72,-32,31
Albion,6874,10,8,6,22,58,82,-24,30
Raith,6875,1,23,8,5,70,32,38,77
Ayr,6875,2,23,4,9,91,45,46,73
Arbroath,6875,3,18,8,10,74,49,25,62
Alloa,6875,4,17,8,11,56,45,11,59
Stranraer,6875,5,15,5,16,56,70,-14,50
East Fife,6875,6,14,3,19,53,65,-12,45
Airdrieon,6875,7,10,11,15,46,60,-14,41
Forfar,6875,8,11,5,20,40,65,-25,38
Albion,6875,9,9,6,21,60,79,-19,33
Queen's Park,6875,10,6,10,20,40,76,-36,28
Raith,6876,1,23,8,5,69,32,37,77
Ayr,6876,2,23,5,8,92,44,48,74
Arbroath,6876,3,17,8,11,70,50,20,59
Alloa,6876,4,17,8,11,56,44,12,59
Stranraer,6876,5,15,5,16,56,67,-11,50
East Fife,6876,6,14,3,19,50,65,-15,45
Airdrieon,6876,7,10,11,15,46,61,-15,41
Forfar,6876,8,11,5,20,41,65,-24,38
Albion,6876,9,8,7,21,59,80,-21,31
Queen's Park,6876,10,7,10,19,41,72,-31,31
Raith,6877,1,23,8,5,72,34,38,77
Ayr,6877,2,24,4,8,92,43,49,76
Arbroath,6877,3,18,8,10,72,48,24,62
Alloa,6877,4,17,8,11,58,47,11,59
Stranraer,6877,5,15,6,15,57,66,-9,51
East Fife,6877,6,13,4,19,49,66,-17,43
Airdrieon,6877,7,10,12,14,46,59,-13,42
Forfar,6877,8,10,6,20,39,65,-26,36
Albion,6877,9,8,6,22,58,80,-22,30
Queen's Park,6877,10,6,10,20,39,74,-35,28
Raith,6878,1,23,8,5,71,32,39,77
Ayr,6878,2,24,4,8,92,43,49,76
Arbroath,6878,3,18,8,10,73,48,25,62
Alloa,6878,4,17,8,11,56,46,10,59
Stranraer,6878,5,15,5,16,55,65,-10,50
East Fife,6878,6,14,3,19,48,64,-16,45
Airdrieon,6878,7,11,11,14,48,59,-11,44
Forfar,6878,8,10,5,21,39,67,-28,35
Albion,6878,9,8,6,22,58,80,-22,30
Queen's Park,6878,10,6,10,20,39,75,-36,28
Ayr,6879,1,24,4,8,96,44,52,76
Raith,6879,2,22,9,5,69,33,36,75
Arbroath,6879,3,17,9,10,71,49,22,60
Alloa,6879,4,17,9,10,57,44,13,60
Stranraer,6879,5,16,5,15,57,64,-7,53
Airdrieon,6879,6,11,11,14,47,59,-12,44
East Fife,6879,7,13,3,20,47,66,-19,42
Forfar,6879,8,10,5,21,39,66,-27,35
Albion,6879,9,8,6,22,59,84,-25,30
Queen's Park,6879,10,6,11,19,40,73,-33,29
Ayr,6880,1,24,4,8,93,43,50,76
Raith,6880,2,22,9,5,69,33,36,75
Arbroath,6880,3,18,8,10,72,48,24,62
Alloa,6880,4,17,9,10,57,44,13,60
Stranraer,6880,5,15,5,16,55,66,-11,50
East Fife,6880,6,14,3,19,49,64,-15,45
Airdrieon,6880,7,11,11,14,48,60,-12,44
Forfar,6880,8,10,5,21,40,67,-27,35
Albion,6880,9,8,6,22,58,81,-23,30
Queen's Park,6880,10,6,10,20,39,74,-35,28
Raith,6881,1,23,8,5,73,34,39,77
Ayr,6881,2,24,4,8,94,43,51,76
Arbroath,6881,3,18,8,10,73,49,24,62
Alloa,6881,4,17,8,11,58,48,10,59
Stranraer,6881,5,16,5,15,58,64,-6,53
Airdrieon,6881,6,11,11,14,47,59,-12,44
East Fife,6881,7,13,3,20,47,67,-20,42
Forfar,6881,8,10,5,21,39,66,-27,35
Albion,6881,9,8,6,22,58,82,-24,30
Queen's Park,6881,10,6,10,20,40,75,-35,28
Ayr,6882,1,24,4,8,94,44,50,76
Raith,6882,2,22,9,5,68,32,36,75
Arbroath,6882,3,18,8,10,72,49,23,62
Alloa,6882,4,17,9,10,56,43,13,60
Stranraer,6882,5,15,6,15,55,64,-9,51
East Fife,6882,6,13,4,19,47,64,-17,43
Airdrieon,6882,7,10,12,14,46,59,-13,42
Forfar,6882,8,10,6,20,39,65,-26,36
Albion,6882,9,8,6,22,59,82,-23,30
Queen's Park,6882,10,6,10,20,40,74,-34,28
Ayr,6883,1,24,4,8,93,43,50,76
Raith,6883,2,22,8,6,68,33,35,74
Alloa,6883,3,18,8,10,57,43,14,62
Arbroath,6883,4,17,8,11,70,51,19,59
Stranraer,6883,5,15,5,16,56,66,-10,50
East Fife,6883,6,14,3,19,49,65,-16,45
Airdrieon,6883,7,10,12,14,45,58,-13,42
Forfar,6883,8,10,6,20,38,64,-26,36
Queen's Park,6883,9,7,10,19,42,72,-30,31
Albion,6883,10,8,6,22,58,81,-23,30
Raith,6884,1,23,8,5,69,32,37,77
Ayr,6884,2,24,4,8,94,44,50,76
Arbroath,6884,3,17,8,11,70,52,18,59
Alloa,6884,4,17,8,11,56,44,12,59
Stranraer,6884,5,16,5,15,56,64,-8,53
Airdrieon,6884,6,10,12,14,45,58,-13,42
East Fife,6884,7,13,3,20,47,65,-18,42
Forfar,6884,8,10,6,20,38,64,-26,36
Queen's Park,6884,9,7,10,19,43,72,-29,31
Albion,6884,10,8,6,22,59,82,-23,30
Ayr,6885,1,24,4,8,93,44,49,76
Raith,6885,2,22,9,5,69,33,36,75
Alloa,6885,3,17,9,10,57,44,13,60
Arbroath,6885,4,17,8,11,70,53,17,59
Stranraer,6885,5,16,5,15,56,64,-8,53
East Fife,6885,6,13,3,20,47,65,-18,42
Airdrieon,6885,7,10,11,15,46,61,-15,41
Forfar,6885,8,11,5,20,41,65,-24,38
Queen's Park,6885,9,7,10,19,44,72,-28,31
Albion,6885,10,8,6,22,59,81,-22,30
Ayr,6886,1,24,4,8,93,42,51,76
Raith,6886,2,22,9,5,69,33,36,75
Arbroath,6886,3,18,8,10,71,48,23,62
Alloa,6886,4,17,9,10,57,44,13,60
Stranraer,6886,5,15,5,16,55,65,-10,50
East Fife,6886,6,14,3,19,48,64,-16,45
Airdrieon,6886,7,10,11,15,46,60,-14,41
Forfar,6886,8,11,5,20,40,65,-25,38
Albion,6886,9,8,6,22,57,81,-24,30
Queen's Park,6886,10,6,10,20,39,73,-34,28
Ayr,6887,1,24,4,8,93,44,49,76
Raith,6887,2,22,8,6,68,33,35,74
Arbroath,6887,3,18,8,10,75,49,26,62
Alloa,6887,4,18,8,10,57,43,14,62
Stranraer,6887,5,16,5,15,57,64,-7,53
Airdrieon,6887,6,10,12,14,47,60,-13,42
East Fife,6887,7,13,3,20,47,66,-19,42
Forfar,6887,8,10,6,20,40,66,-26,36
Albion,6887,9,8,6,22,59,81,-22,30
Queen's Park,6887,10,6,10,20,40,77,-37,28
Raith,6888,1,22,8,6,69,35,34,74
Ayr,6888,2,23,4,9,90,44,46,73
Arbroath,6888,3,18,8,10,75,49,26,62
Alloa,6888,4,18,8,10,59,44,15,62
Stranraer,6888,5,16,5,15,57,65,-8,53
Airdrieon,6888,6,11,11,14,48,59,-11,44
East Fife,6888,7,13,3,20,48,66,-18,42
Forfar,6888,8,10,5,21,39,67,-28,35
Albion,6888,9,9,6,21,59,78,-19,33
Queen's Park,6888,10,6,10,20,40,77,-37,28
Raith,6889,1,23,8,5,73,33,40,77
Ayr,6889,2,24,4,8,95,44,51,76
Arbroath,6889,3,18,8,10,73,48,25,62
Alloa,6889,4,17,8,11,57,48,9,59
Stranraer,6889,5,16,5,15,58,65,-7,53
Airdrieon,6889,6,10,12,14,46,59,-13,42
East Fife,6889,7,13,3,20,48,67,-19,42
Forfar,6889,8,10,6,20,39,65,-26,36
Albion,6889,9,8,6,22,59,83,-24,30
Queen's Park,6889,10,6,10,20,39,75,-36,28
Ayr,6890,1,24,4,8,93,44,49,76
Raith,6890,2,22,9,5,69,33,36,75
Arbroath,6890,3,18,8,10,71,48,23,62
Alloa,6890,4,17,9,10,57,44,13,60
Stranraer,6890,5,16,5,15,58,64,-6,53
Airdrieon,6890,6,11,11,14,47,59,-12,44
East Fife,6890,7,13,3,20,47,67,-20,42
Forfar,6890,8,10,5,21,39,66,-27,35
Albion,6890,9,8,6,22,59,81,-22,30
Queen's Park,6890,10,6,10,20,39,73,-34,28
Raith,6891,1,23,8,5,70,33,37,77
Ayr,6891,2,24,4,8,93,43,50,76
Arbroath,6891,3,18,8,10,72,48,24,62
Alloa,6891,4,17,8,11,57,45,12,59
Stranraer,6891,5,15,5,16,55,66,-11,50
East Fife,6891,6,14,3,19,49,64,-15,45
Airdrieon,6891,7,11,11,14,48,58,-10,44
Forfar,6891,8,10,5,21,38,67,-29,35
Albion,6891,9,8,6,22,58,81,-23,30
Queen's Park,6891,10,6,10,20,39,74,-35,28
Raith,6892,1,22,9,5,68,32,36,75
Ayr,6892,2,23,4,9,91,44,47,73
Arbroath,6892,3,18,8,10,75,49,26,62
Alloa,6892,4,17,9,10,56,43,13,60
Stranraer,6892,5,15,5,16,55,65,-10,50
East Fife,6892,6,14,3,19,48,64,-16,45
Airdrieon,6892,7,10,12,14,48,61,-13,42
Forfar,6892,8,10,6,20,41,67,-26,36
Albion,6892,9,9,6,21,59,79,-20,33
Queen's Park,6892,10,6,10,20,40,77,-37,28
Ayr,6893,1,23,5,8,91,43,48,74
Raith,6893,2,22,8,6,69,34,35,74
Alloa,6893,3,18,8,10,58,44,14,62
Arbroath,6893,4,17,9,10,71,49,22,60
Stranraer,6893,5,15,5,16,56,67,-11,50
East Fife,6893,6,14,3,19,50,65,-15,45
Airdrieon,6893,7,10,12,14,46,59,-13,42
Forfar,6893,8,10,6,20,39,65,-26,36
Albion,6893,9,8,7,21,58,79,-21,31
Queen's Park,6893,10,6,11,19,40,73,-33,29
Raith,6894,1,23,8,5,71,33,38,77
Ayr,6894,2,24,4,8,95,42,53,76
Arbroath,6894,3,18,8,10,74,48,26,62
Alloa,6894,4,17,8,11,57,46,11,59
Stranraer,6894,5,15,5,16,55,67,-12,50
East Fife,6894,6,14,3,19,50,64,-14,45
Airdrieon,6894,7,10,12,14,47,60,-13,42
Forfar,6894,8,10,6,20,40,66,-26,36
Albion,6894,9,8,6,22,57,83,-26,30
Queen's Park,6894,10,6,10,20,39,76,-37,28
Raith,6895,1,23,8,5,70,32,38,77
Ayr,6895,2,24,4,8,92,43,49,76
Arbroath,6895,3,17,8,11,70,49,21,59
Alloa,6895,4,17,8,11,56,45,11,59
Stranraer,6895,5,15,6,15,56,65,-9,51
East Fife,6895,6,13,4,19,48,65,-17,43
Airdrieon,6895,7,10,11,15,45,60,-15,41
Forfar,6895,8,11,5,20,40,64,-24,38
Queen's Park,6895,9,7,10,19,40,72,-32,31
Albion,6895,10,8,6,22,58,80,-22,30
Ayr,6896,1,24,4,8,95,45,50,76
Raith,6896,2,22,9,5,69,33,36,75
Arbroath,6896,3,18,8,10,72,48,24,62
Alloa,6896,4,17,9,10,57,44,13,60
Stranraer,6896,5,15,6,15,55,64,-9,51
East Fife,6896,6,13,4,19,47,64,-17,43
Airdrieon,6896,7,10,11,15,46,60,-14,41
Forfar,6896,8,11,5,20,40,65,-25,38
Albion,6896,9,8,6,22,60,83,-23,30
Queen's Park,6896,10,6,10,20,39,74,-35,28
Raith,6897,1,23,8,5,69,32,37,77
Ayr,6897,2,24,4,8,94,42,52,76
Arbroath,6897,3,17,8,11,72,51,21,59
Alloa,6897,4,17,8,11,56,44,12,59
Stranraer,6897,5,15,5,16,56,68,-12,50
East Fife,6897,6,14,3,19,51,65,-14,45
Airdrieon,6897,7,11,11,14,47,59,-12,44
Forfar,6897,8,10,5,21,39,66,-27,35
Queen's Park,6897,9,7,10,19,42,74,-32,31
Albion,6897,10,8,6,22,57,82,-25,30
Raith,6898,1,23,8,5,69,32,37,77
Ayr,6898,2,24,4,8,94,42,52,76
Arbroath,6898,3,18,8,10,73,49,24,62
Alloa,6898,4,17,8,11,56,44,12,59
Stranraer,6898,5,16,5,15,58,64,-6,53
East Fife,6898,6,13,3,20,47,67,-20,42
Airdrieon,6898,7,10,11,15,47,61,-14,41
Forfar,6898,8,11,5,20,41,66,-25,38
Albion,6898,9,8,6,22,57,82,-25,30
Queen's Park,6898,10,6,10,20,40,75,-35,28
Ayr,6899,1,24,4,8,94,42,52,76
Raith,6899,2,22,9,5,70,34,36,75
Arbroath,6899,3,18,8,10,73,49,24,62
Alloa,6899,4,17,9,10,58,45,13,60
Stranraer,6899,5,15,6,15,57,66,-9,51
East Fife,6899,6,13,4,19,49,66,-17,43
Airdrieon,6899,7,10,12,14,46,59,-13,42
Forfar,6899,8,10,6,20,39,65,-26,36
Albion,6899,9,8,6,22,57,82,-25,30
Queen's Park,6899,10,6,10,20,40,75,-35,28
Raith,6900,1,23,8,5,70,32,38,77
Ayr,6900,2,24,4,8,93,42,51,76
Arbroath,6900,3,17,8,11,70,49,21,59
Alloa,6900,4,17,8,11,56,45,11,59
Stranraer,6900,5,15,5,16,56,66,-10,50
East Fife,6900,6,14,3,19,49,65,-16,45
Airdrieon,6900,7,10,11,15,45,59,-14,41
Forfar,6900,8,11,5,20,39,64,-25,38
Queen's Park,6900,9,7,10,19,40,72,-32,31
Albion,6900,10,8,6,22,57,81,-24,30
Ayr,6901,1,24,4,8,92,43,49,76
Raith,6901,2,22,8,6,68,34,34,74
Alloa,6901,3,18,8,10,58,43,15,62
Arbroath,6901,4,17,8,11,70,50,20,59
Stranraer,6901,5,15,5,16,55,65,-10,50
East Fife,6901,6,14,3,19,48,64,-16,45
Airdrieon,6901,7,11,11,14,49,60,-11,44
Forfar,6901,8,10,5,21,40,68,-28,35
Queen's Park,6901,9,7,10,19,41,72,-31,31
Albion,6901,10,8,6,22,58,80,-22,30
Raith,6902,1,23,8,5,73,33,40,77
Ayr,6902,2,24,4,8,95,43,52,76
Arbroath,6902,3,17,8,11,71,51,20,59
Alloa,6902,4,17,8,11,57,48,9,59
Stranraer,6902,5,16,5,15,57,64,-7,53
Airdrieon,6902,6,10,12,14,47,60,-13,42
East Fife,6902,7,13,3,20,47,66,-19,42
Forfar,6902,8,10,6,20,40,66,-26,36
Queen's Park,6902,9,7,10,19,42,73,-31,31
Albion,6902,10,8,6,22,58,83,-25,30
Ayr,6903,1,24,4,8,94,43,51,76
Raith,6903,2,22,9,5,69,33,36,75
Arbroath,6903,3,18,8,10,72,48,24,62
Alloa,6903,4,17,9,10,57,44,13,60
Stranraer,6903,5,15,5,16,55,65,-10,50
East Fife,6903,6,14,3,19,48,64,-16,45
Airdrieon,6903,7,11,11,14,48,60,-12,44
Forfar,6903,8,10,5,21,40,67,-27,35
Albion,6903,9,8,6,22,58,82,-24,30
Queen's Park,6903,10,6,10,20,39,74,-35,28
Ayr,6904,1,24,4,8,94,44,50,76
Raith,6904,2,22,9,5,71,35,36,75
Alloa,6904,3,17,9,10,59,46,13,60
Arbroath,6904,4,17,8,11,70,49,21,59
Stranraer,6904,5,15,5,16,55,68,-13,50
East Fife,6904,6,14,3,19,51,64,-13,45
Airdrieon,6904,7,10,11,15,45,60,-15,41
Forfar,6904,8,11,5,20,40,64,-24,38
Queen's Park,6904,9,7,10,19,40,72,-32,31
Albion,6904,10,8,6,22,59,82,-23,30
Ayr,6905,1,23,5,8,91,43,48,74
Raith,6905,2,22,8,6,68,34,34,74
Arbroath,6905,3,18,8,10,72,49,23,62
Alloa,6905,4,18,8,10,58,43,15,62
Stranraer,6905,5,15,6,15,57,66,-9,51
Airdrieon,6905,6,11,11,14,46,58,-12,44
East Fife,6905,7,13,4,19,49,66,-17,43
Forfar,6905,8,10,5,21,38,65,-27,35
Albion,6905,9,8,7,21,58,79,-21,31
Queen's Park,6905,10,6,10,20,40,74,-34,28
Raith,6906,1,23,8,5,71,34,37,77
Ayr,6906,2,24,4,8,91,42,49,76
Arbroath,6906,3,17,9,10,70,48,22,60
Alloa,6906,4,17,8,11,58,46,12,59
Stranraer,6906,5,16,5,15,57,65,-8,53
Airdrieon,6906,6,11,11,14,47,59,-12,44
East Fife,6906,7,13,3,20,48,66,-18,42
Forfar,6906,8,10,5,21,39,66,-27,35
Albion,6906,9,8,6,22,57,79,-22,30
Queen's Park,6906,10,6,11,19,39,72,-33,29
Raith,6907,1,23,8,5,71,32,39,77
Ayr,6907,2,24,4,8,91,42,49,76
Arbroath,6907,3,18,8,10,73,50,23,62
Alloa,6907,4,17,8,11,56,46,10,59
Stranraer,6907,5,16,5,15,58,65,-7,53
Airdrieon,6907,6,11,11,14,48,59,-11,44
East Fife,6907,7,13,3,20,48,67,-19,42
Forfar,6907,8,10,5,21,39,67,-28,35
Albion,6907,9,8,6,22,57,79,-22,30
Queen's Park,6907,10,6,10,20,41,75,-34,28
Raith,6908,1,23,8,5,69,32,37,77
Ayr,6908,2,24,4,8,94,43,51,76
Arbroath,6908,3,17,9,10,72,50,22,60
Alloa,6908,4,17,8,11,56,44,12,59
Stranraer,6908,5,16,5,15,57,65,-8,53
Airdrieon,6908,6,11,11,14,47,59,-12,44
East Fife,6908,7,13,3,20,48,66,-18,42
Forfar,6908,8,10,5,21,39,66,-27,35
Albion,6908,9,8,6,22,58,82,-24,30
Queen's Park,6908,10,6,11,19,41,74,-33,29
Raith,6909,1,23,8,5,70,33,37,77
Ayr,6909,2,24,4,8,92,43,49,76
Arbroath,6909,3,18,8,10,72,49,23,62
Alloa,6909,4,17,8,11,57,45,12,59
Stranraer,6909,5,15,5,16,56,67,-11,50
East Fife,6909,6,14,3,19,50,65,-15,45
Airdrieon,6909,7,10,11,15,45,59,-14,41
Forfar,6909,8,11,5,20,39,64,-25,38
Albion,6909,9,8,6,22,58,80,-22,30
Queen's Park,6909,10,6,10,20,40,74,-34,28
Ayr,6910,1,24,4,8,95,43,52,76
Raith,6910,2,22,9,5,68,32,36,75
Arbroath,6910,3,18,8,10,72,49,23,62
Alloa,6910,4,17,9,10,56,43,13,60
Stranraer,6910,5,15,5,16,56,67,-11,50
East Fife,6910,6,14,3,19,50,65,-15,45
Airdrieon,6910,7,11,11,14,48,59,-11,44
Forfar,6910,8,10,5,21,39,67,-28,35
Albion,6910,9,8,6,22,58,83,-25,30
Queen's Park,6910,10,6,10,20,40,74,-34,28
Raith,6911,1,22,8,6,68,34,34,74
Ayr,6911,2,23,4,9,93,46,47,73
Arbroath,6911,3,18,8,10,71,48,23,62
Alloa,6911,4,18,8,10,58,43,15,62
Stranraer,6911,5,16,5,15,58,65,-7,53
Airdrieon,6911,6,11,11,14,48,58,-10,44
East Fife,6911,7,13,3,20,48,67,-19,42
Forfar,6911,8,10,5,21,38,67,-29,35
Albion,6911,9,9,6,21,61,81,-20,33
Queen's Park,6911,10,6,10,20,39,73,-34,28
Ayr,6912,1,24,4,8,95,43,52,76
Raith,6912,2,22,8,6,69,35,34,74
Alloa,6912,3,18,8,10,59,44,15,62
Arbroath,6912,4,17,9,10,72,50,22,60
Stranraer,6912,5,16,5,15,56,64,-8,53
Airdrieon,6912,6,10,12,14,47,60,-13,42
East Fife,6912,7,13,3,20,47,65,-18,42
Forfar,6912,8,10,6,20,40,66,-26,36
Albion,6912,9,8,6,22,58,83,-25,30
Queen's Park,6912,10,6,11,19,41,74,-33,29
Raith,6913,1,22,9,5,69,33,36,75
Ayr,6913,2,23,4,9,92,45,47,73
Arbroath,6913,3,18,8,10,72,49,23,62
Alloa,6913,4,17,9,10,57,44,13,60
Stranraer,6913,5,16,5,15,59,67,-8,53
Airdrieon,6913,6,11,11,14,47,59,-12,44
East Fife,6913,7,13,3,20,50,68,-18,42
Forfar,6913,8,10,5,21,39,66,-27,35
Albion,6913,9,9,6,21,60,80,-20,33
Queen's Park,6913,10,6,10,20,40,74,-34,28
Ayr,6914,1,24,4,8,92,43,49,76
Raith,6914,2,22,9,5,68,32,36,75
Arbroath,6914,3,18,8,10,73,49,24,62
Alloa,6914,4,17,9,10,56,43,13,60
Stranraer,6914,5,16,5,15,56,64,-8,53
Airdrieon,6914,6,11,11,14,48,58,-10,44
East Fife,6914,7,13,3,20,47,65,-18,42
Forfar,6914,8,10,5,21,38,67,-29,35
Albion,6914,9,8,6,22,58,80,-22,30
Queen's Park,6914,10,6,10,20,40,75,-35,28
Raith,6915,1,23,8,5,72,32,40,77
Ayr,6915,2,24,4,8,94,43,51,76
Arbroath,6915,3,18,8,10,72,49,23,62
Alloa,6915,4,17,8,11,56,47,9,59
Stranraer,6915,5,15,5,16,56,66,-10,50
East Fife,6915,6,14,3,19,49,65,-16,45
Airdrieon,6915,7,11,11,14,47,58,-11,44
Forfar,6915,8,10,5,21,38,66,-28,35
Albion,6915,9,8,6,22,58,82,-24,30
Queen's Park,6915,10,6,10,20,40,74,-34,28
Raith,6916,1,23,8,5,71,32,39,77
Ayr,6916,2,24,4,8,94,43,51,76
Arbroath,6916,3,18,8,10,73,50,23,62
Alloa,6916,4,17,8,11,56,46,10,59
Stranraer,6916,5,15,5,16,57,67,-10,50
East Fife,6916,6,14,3,19,50,66,-16,45
Airdrieon,6916,7,11,11,14,48,59,-11,44
Forfar,6916,8,10,5,21,39,67,-28,35
Albion,6916,9,8,6,22,58,82,-24,30
Queen's Park,6916,10,6,10,20,41,75,-34,28
Ayr,6917,1,24,4,8,93,42,51,76
Raith,6917,2,22,8,6,68,34,34,74
Alloa,6917,3,18,8,10,58,43,15,62
Arbroath,6917,4,17,8,11,72,53,19,59
Stranraer,6917,5,15,5,16,56,67,-11,50
East Fife,6917,6,14,3,19,50,65,-15,45
Airdrieon,6917,7,11,11,14,48,58,-10,44
Forfar,6917,8,10,5,21,38,67,-29,35
Queen's Park,6917,9,7,10,19,44,74,-30,31
Albion,6917,10,8,6,22,57,81,-24,30
Raith,6918,1,22,9,5,69,33,36,75
Ayr,6918,2,23,5,8,92,44,48,74
Arbroath,6918,3,17,9,10,73,51,22,60
Alloa,6918,4,17,9,10,57,44,13,60
Stranraer,6918,5,15,6,15,56,65,-9,51
Airdrieon,6918,6,11,11,14,48,58,-10,44
East Fife,6918,7,13,4,19,48,65,-17,43
Forfar,6918,8,10,5,21,38,67,-29,35
Albion,6918,9,8,7,21,59,80,-21,31
Queen's Park,6918,10,6,11,19,42,75,-33,29
Ayr,6919,1,23,5,8,91,43,48,74
Raith,6919,2,22,8,6,69,34,35,74
Alloa,6919,3,18,8,10,58,44,14,62
Arbroath,6919,4,17,9,10,74,52,22,60
Stranraer,6919,5,15,5,16,55,67,-12,50
East Fife,6919,6,14,3,19,50,64,-14,45
Airdrieon,6919,7,11,11,14,47,59,-12,44
Forfar,6919,8,10,5,21,39,66,-27,35
Albion,6919,9,8,7,21,58,79,-21,31
Queen's Park,6919,10,6,11,19,43,76,-33,29
Ayr,6920,1,24,4,8,93,44,49,76
Raith,6920,2,22,8,6,68,34,34,74
Alloa,6920,3,18,8,10,58,43,15,62
Arbroath,6920,4,17,8,11,74,53,21,59
Stranraer,6920,5,16,5,15,56,64,-8,53
Airdrieon,6920,6,11,11,14,47,59,-12,44
East Fife,6920,7,13,3,20,47,65,-18,42
Forfar,6920,8,10,5,21,39,66,-27,35
Queen's Park,6920,9,7,10,19,44,76,-32,31
Albion,6920,10,8,6,22,59,81,-22,30
Raith,6921,1,23,8,5,70,33,37,77
Ayr,6921,2,24,4,8,100,42,58,76
Arbroath,6921,3,18,8,10,74,50,24,62
Alloa,6921,4,17,8,11,57,45,12,59
Stranraer,6921,5,15,6,15,56,65,-9,51
East Fife,6921,6,13,4,19,48,65,-17,43
Airdrieon,6921,7,10,11,15,45,60,-15,41
Forfar,6921,8,11,5,20,40,64,-24,38
Albion,6921,9,8,6,22,57,88,-31,30
Queen's Park,6921,10,6,10,20,41,76,-35,28
Raith,6922,1,23,8,5,69,32,37,77
Ayr,6922,2,24,4,8,95,42,53,76
Arbroath,6922,3,18,8,10,75,51,24,62
Alloa,6922,4,17,8,11,56,44,12,59
Stranraer,6922,5,15,5,16,57,68,-11,50
East Fife,6922,6,14,3,19,51,66,-15,45
Airdrieon,6922,7,11,11,14,47,58,-11,44
Forfar,6922,8,10,5,21,38,66,-28,35
Albion,6922,9,8,6,22,57,83,-26,30
Queen's Park,6922,10,6,10,20,42,77,-35,28
Ayr,6923,1,24,4,8,95,43,52,76
Raith,6923,2,22,8,6,69,34,35,74
Arbroath,6923,3,18,8,10,71,48,23,62
Alloa,6923,4,18,8,10,58,44,14,62
Stranraer,6923,5,16,5,15,58,64,-6,53
East Fife,6923,6,13,3,20,47,67,-20,42
Airdrieon,6923,7,10,11,15,45,59,-14,41
Forfar,6923,8,11,5,20,39,64,-25,38
Albion,6923,9,8,6,22,58,83,-25,30
Queen's Park,6923,10,6,10,20,39,73,-34,28
Raith,6924,1,23,8,5,71,34,37,77
Ayr,6924,2,24,4,8,93,43,50,76
Arbroath,6924,3,17,9,10,71,49,22,60
Alloa,6924,4,17,8,11,58,46,12,59
Stranraer,6924,5,16,5,15,57,65,-8,53
Airdrieon,6924,6,10,12,14,48,61,-13,42
East Fife,6924,7,13,3,20,48,66,-18,42
Forfar,6924,8,10,6,20,41,67,-26,36
Albion,6924,9,8,6,22,58,81,-23,30
Queen's Park,6924,10,6,11,19,40,73,-33,29
Ayr,6925,1,23,5,8,93,45,48,74
Raith,6925,2,22,8,6,69,34,35,74
Alloa,6925,3,18,8,10,58,44,14,62
Arbroath,6925,4,17,8,11,71,50,21,59
Stranraer,6925,5,15,5,16,55,65,-10,50
East Fife,6925,6,14,3,19,48,64,-16,45
Airdrieon,6925,7,10,12,14,46,59,-13,42
Forfar,6925,8,10,6,20,39,65,-26,36
Albion,6925,9,8,7,21,60,81,-21,31
Queen's Park,6925,10,7,10,19,41,73,-32,31
Raith,6926,1,23,8,5,70,33,37,77
Ayr,6926,2,24,4,8,95,44,51,76
Arbroath,6926,3,17,9,10,73,51,22,60
Alloa,6926,4,17,8,11,57,45,12,59
Stranraer,6926,5,15,6,15,57,66,-9,51
East Fife,6926,6,13,4,19,49,66,-17,43
Airdrieon,6926,7,10,12,14,46,59,-13,42
Forfar,6926,8,10,6,20,39,65,-26,36
Albion,6926,9,8,6,22,59,83,-24,30
Queen's Park,6926,10,6,11,19,42,75,-33,29
Ayr,6927,1,24,4,8,92,42,50,76
Raith,6927,2,22,9,5,68,32,36,75
Arbroath,6927,3,18,8,10,71,48,23,62
Alloa,6927,4,17,9,10,56,43,13,60
Stranraer,6927,5,15,5,16,55,65,-10,50
East Fife,6927,6,14,3,19,48,64,-16,45
Airdrieon,6927,7,10,11,15,45,59,-14,41
Forfar,6927,8,11,5,20,39,64,-25,38
Albion,6927,9,8,6,22,57,80,-23,30
Queen's Park,6927,10,6,10,20,39,73,-34,28
Ayr,6928,1,23,5,8,91,43,48,74
Raith,6928,2,22,8,6,68,34,34,74
Alloa,6928,3,18,8,10,58,43,15,62
Arbroath,6928,4,17,9,10,71,49,22,60
Stranraer,6928,5,15,5,16,55,68,-13,50
East Fife,6928,6,14,3,19,51,64,-13,45
Airdrieon,6928,7,11,11,14,48,58,-10,44
Forfar,6928,8,10,5,21,38,67,-29,35
Albion,6928,9,8,7,21,58,79,-21,31
Queen's Park,6928,10,6,11,19,40,73,-33,29
Ayr,6929,1,24,4,8,91,42,49,76
Raith,6929,2,22,9,5,69,33,36,75
Arbroath,6929,3,18,8,10,74,50,24,62
Alloa,6929,4,17,9,10,57,44,13,60
Stranraer,6929,5,15,5,16,56,66,-10,50
East Fife,6929,6,14,3,19,49,65,-16,45
Airdrieon,6929,7,11,11,14,47,59,-12,44
Forfar,6929,8,10,5,21,39,66,-27,35
Albion,6929,9,8,6,22,57,79,-22,30
Queen's Park,6929,10,6,10,20,41,76,-35,28
Raith,6930,1,23,8,5,73,34,39,77
Ayr,6930,2,24,4,8,92,42,50,76
Arbroath,6930,3,18,8,10,75,51,24,62
Alloa,6930,4,17,8,11,58,48,10,59
Stranraer,6930,5,15,5,16,55,66,-11,50
East Fife,6930,6,14,3,19,49,64,-15,45
Airdrieon,6930,7,11,11,14,47,58,-11,44
Forfar,6930,8,10,5,21,38,66,-28,35
Albion,6930,9,8,6,22,57,80,-23,30
Queen's Park,6930,10,6,10,20,42,77,-35,28
Raith,6931,1,23,8,5,69,32,37,77
Ayr,6931,2,24,4,8,92,42,50,76
Arbroath,6931,3,18,8,10,74,49,25,62
Alloa,6931,4,17,8,11,56,44,12,59
Stranraer,6931,5,16,5,15,57,64,-7,53
Airdrieon,6931,6,10,12,14,47,60,-13,42
East Fife,6931,7,13,3,20,47,66,-19,42
Forfar,6931,8,10,6,20,40,66,-26,36
Albion,6931,9,8,6,22,57,80,-23,30
Queen's Park,6931,10,6,10,20,40,76,-36,28
Raith,6932,1,23,8,5,72,33,39,77
Ayr,6932,2,24,4,8,92,42,50,76
Arbroath,6932,3,18,8,10,71,48,23,62
Alloa,6932,4,17,8,11,57,47,10,59
Stranraer,6932,5,15,5,16,55,66,-11,50
East Fife,6932,6,14,3,19,49,64,-15,45
Airdrieon,6932,7,10,11,15,45,61,-16,41
Forfar,6932,8,11,5,20,41,64,-23,38
Albion,6932,9,8,6,22,57,80,-23,30
Queen's Park,6932,10,6,10,20,39,73,-34,28
Ayr,6933,1,24,4,8,92,42,50,76
Raith,6933,2,22,8,6,69,34,35,74
Alloa,6933,3,18,8,10,58,44,14,62
Arbroath,6933,4,17,8,11,70,50,20,59
Stranraer,6933,5,16,5,15,59,64,-5,53
Airdrieon,6933,6,11,11,14,48,60,-12,44
East Fife,6933,7,13,3,20,47,68,-21,42
Forfar,6933,8,10,5,21,40,67,-27,35
Queen's Park,6933,9,7,10,19,41,72,-31,31
Albion,6933,10,8,6,22,57,80,-23,30
Raith,6934,1,23,8,5,70,32,38,77
Ayr,6934,2,24,4,8,95,44,51,76
Arbroath,6934,3,17,8,11,71,50,21,59
Alloa,6934,4,17,8,11,56,45,11,59
Stranraer,6934,5,16,5,15,56,64,-8,53
East Fife,6934,6,13,3,20,47,65,-18,42
Airdrieon,6934,7,10,11,15,45,60,-15,41
Forfar,6934,8,11,5,20,40,64,-24,38
Queen's Park,6934,9,7,10,19,41,73,-32,31
Albion,6934,10,8,6,22,59,83,-24,30
Ayr,6935,1,24,4,8,94,43,51,76
Raith,6935,2,22,9,5,68,32,36,75
Arbroath,6935,3,18,8,10,74,49,25,62
Alloa,6935,4,17,9,10,56,43,13,60
Stranraer,6935,5,16,5,15,58,64,-6,53
Airdrieon,6935,6,11,11,14,47,58,-11,44
East Fife,6935,7,13,3,20,47,67,-20,42
Forfar,6935,8,10,5,21,38,66,-28,35
Albion,6935,9,8,6,22,58,82,-24,30
Queen's Park,6935,10,6,10,20,40,76,-36,28
Raith,6936,1,23,8,5,71,33,38,77
Ayr,6936,2,24,4,8,97,42,55,76
Arbroath,6936,3,18,8,10,72,49,23,62
Alloa,6936,4,17,8,11,57,46,11,59
Stranraer,6936,5,15,5,16,56,66,-10,50
East Fife,6936,6,14,3,19,49,65,-16,45
Airdrieon,6936,7,11,11,14,47,59,-12,44
Forfar,6936,8,10,5,21,39,66,-27,35
Albion,6936,9,8,6,22,57,85,-28,30
Queen's Park,6936,10,6,10,20,40,74,-34,28
Ayr,6937,1,24,4,8,94,44,50,76
Raith,6937,2,22,8,6,69,34,35,74
Arbroath,6937,3,18,8,10,71,48,23,62
Alloa,6937,4,18,8,10,58,44,14,62
Stranraer,6937,5,15,5,16,57,67,-10,50
East Fife,6937,6,14,3,19,50,66,-16,45
Airdrieon,6937,7,10,11,15,46,60,-14,41
Forfar,6937,8,11,5,20,40,65,-25,38
Albion,6937,9,8,6,22,59,82,-23,30
Queen's Park,6937,10,6,10,20,39,73,-34,28
Raith,6938,1,23,8,5,72,34,38,77
Ayr,6938,2,24,4,8,93,43,50,76
Arbroath,6938,3,18,8,10,72,49,23,62
Alloa,6938,4,17,8,11,58,47,11,59
Stranraer,6938,5,15,5,16,56,66,-10,50
East Fife,6938,6,14,3,19,49,65,-16,45
Airdrieon,6938,7,11,11,14,46,58,-12,44
Forfar,6938,8,10,5,21,38,65,-27,35
Albion,6938,9,8,6,22,58,81,-23,30
Queen's Park,6938,10,6,10,20,40,74,-34,28
Ayr,6939,1,24,4,8,92,43,49,76
Raith,6939,2,22,9,5,69,33,36,75
Arbroath,6939,3,18,8,10,72,49,23,62
Alloa,6939,4,17,9,10,57,44,13,60
Stranraer,6939,5,15,5,16,55,67,-12,50
East Fife,6939,6,14,3,19,50,64,-14,45
Airdrieon,6939,7,10,12,14,46,59,-13,42
Forfar,6939,8,10,6,20,39,65,-26,36
Albion,6939,9,8,6,22,58,80,-22,30
Queen's Park,6939,10,6,10,20,40,74,-34,28
Raith,6940,1,23,8,5,69,32,37,77
Ayr,6940,2,24,4,8,97,44,53,76
Arbroath,6940,3,18,8,10,71,48,23,62
Alloa,6940,4,17,8,11,56,44,12,59
Stranraer,6940,5,15,5,16,56,66,-10,50
East Fife,6940,6,14,3,19,49,65,-16,45
Airdrieon,6940,7,11,11,14,47,59,-12,44
Forfar,6940,8,10,5,21,39,66,-27,35
Albion,6940,9,8,6,22,59,85,-26,30
Queen's Park,6940,10,6,10,20,39,73,-34,28
Raith,6941,1,23,8,5,69,32,37,77
Ayr,6941,2,24,4,8,93,44,49,76
Arbroath,6941,3,17,9,10,73,51,22,60
Alloa,6941,4,17,8,11,56,44,12,59
Stranraer,6941,5,15,6,15,56,65,-9,51
East Fife,6941,6,13,4,19,48,65,-17,43
Airdrieon,6941,7,10,11,15,45,61,-16,41
Forfar,6941,8,11,5,20,41,64,-23,38
Albion,6941,9,8,6,22,59,81,-22,30
Queen's Park,6941,10,6,11,19,42,75,-33,29
Raith,6942,1,23,8,5,70,33,37,77
Ayr,6942,2,24,4,8,91,42,49,76
Arbroath,6942,3,17,8,11,73,52,21,59
Alloa,6942,4,17,8,11,57,45,12,59
Stranraer,6942,5,16,5,15,56,64,-8,53
East Fife,6942,6,13,3,20,47,65,-18,42
Airdrieon,6942,7,10,11,15,46,60,-14,41
Forfar,6942,8,11,5,20,40,65,-25,38
Queen's Park,6942,9,7,10,19,43,75,-32,31
Albion,6942,10,8,6,22,57,79,-22,30
Ayr,6943,1,24,4,8,92,42,50,76
Raith,6943,2,22,9,5,68,32,36,75
Alloa,6943,3,17,9,10,56,43,13,60
Arbroath,6943,4,17,8,11,70,49,21,59
Stranraer,6943,5,15,5,16,56,67,-11,50
East Fife,6943,6,14,3,19,50,65,-15,45
Airdrieon,6943,7,11,11,14,47,58,-11,44
Forfar,6943,8,10,5,21,38,66,-28,35
Queen's Park,6943,9,7,10,19,40,72,-32,31
Albion,6943,10,8,6,22,57,80,-23,30
Raith,6944,1,23,8,5,70,33,37,77
Ayr,6944,2,24,4,8,92,42,50,76
Arbroath,6944,3,17,9,10,71,49,22,60
Alloa,6944,4,17,8,11,57,45,12,59
Stranraer,6944,5,15,6,15,56,65,-9,51
Airdrieon,6944,6,11,11,14,47,58,-11,44
East Fife,6944,7,13,4,19,48,65,-17,43
Forfar,6944,8,10,5,21,38,66,-28,35
Albion,6944,9,8,6,22,57,80,-23,30
Queen's Park,6944,10,6,11,19,40,73,-33,29
Raith,6945,1,23,8,5,71,32,39,77
Ayr,6945,2,24,4,8,95,42,53,76
Arbroath,6945,3,18,8,10,73,50,23,62
Alloa,6945,4,17,8,11,56,46,10,59
Stranraer,6945,5,15,5,16,55,65,-10,50
East Fife,6945,6,14,3,19,48,64,-16,45
Airdrieon,6945,7,11,11,14,46,58,-12,44
Forfar,6945,8,10,5,21,38,65,-27,35
Albion,6945,9,8,6,22,57,83,-26,30
Queen's Park,6945,10,6,10,20,41,75,-34,28
Raith,6946,1,23,8,5,69,32,37,77
Ayr,6946,2,23,4,9,91,47,44,73
Arbroath,6946,3,17,8,11,70,49,21,59
Alloa,6946,4,17,8,11,56,44,12,59
Stranraer,6946,5,15,5,16,56,66,-10,50
East Fife,6946,6,14,3,19,49,65,-16,45
Airdrieon,6946,7,11,11,14,47,59,-12,44
Forfar,6946,8,10,5,21,39,66,-27,35
Albion,6946,9,9,6,21,62,79,-17,33
Queen's Park,6946,10,7,10,19,40,72,-32,31
Ayr,6947,1,24,4,8,95,44,51,76
Raith,6947,2,22,8,6,68,34,34,74
Alloa,6947,3,18,8,10,58,43,15,62
Arbroath,6947,4,17,8,11,70,49,21,59
Stranraer,6947,5,16,5,15,56,64,-8,53
Airdrieon,6947,6,11,11,14,53,58,-5,44
East Fife,6947,7,13,3,20,47,65,-18,42
Forfar,6947,8,10,5,21,38,72,-34,35
Queen's Park,6947,9,7,10,19,40,72,-32,31
Albion,6947,10,8,6,22,59,83,-24,30
Raith,6948,1,23,8,5,72,33,39,77
Ayr,6948,2,24,4,8,92,43,49,76
Arbroath,6948,3,17,9,10,70,48,22,60
Alloa,6948,4,17,8,11,57,47,10,59
Stranraer,6948,5,15,5,16,55,65,-10,50
East Fife,6948,6,14,3,19,48,64,-16,45
Airdrieon,6948,7,10,11,15,46,60,-14,41
Forfar,6948,8,11,5,20,40,65,-25,38
Albion,6948,9,8,6,22,58,80,-22,30
Queen's Park,6948,10,6,11,19,39,72,-33,29
Raith,6949,1,23,8,5,72,34,38,77
Ayr,6949,2,23,5,8,91,43,48,74
Arbroath,6949,3,18,8,10,72,49,23,62
Alloa,6949,4,17,8,11,58,47,11,59
Stranraer,6949,5,15,5,16,56,66,-10,50
East Fife,6949,6,14,3,19,49,65,-16,45
Airdrieon,6949,7,10,12,14,45,58,-13,42
Forfar,6949,8,10,6,20,38,64,-26,36
Albion,6949,9,8,7,21,58,79,-21,31
Queen's Park,6949,10,6,10,20,40,74,-34,28
Raith,6950,1,23,8,5,70,33,37,77
Ayr,6950,2,23,5,8,91,43,48,74
Arbroath,6950,3,18,8,10,72,48,24,62
Alloa,6950,4,17,8,11,57,45,12,59
Stranraer,6950,5,15,5,16,55,66,-11,50
East Fife,6950,6,14,3,19,49,64,-15,45
Airdrieon,6950,7,10,12,14,48,61,-13,42
Forfar,6950,8,10,6,20,41,67,-26,36
Albion,6950,9,8,7,21,58,79,-21,31
Queen's Park,6950,10,6,10,20,39,74,-35,28
Raith,6951,1,23,8,5,71,33,38,77
Ayr,6951,2,24,4,8,93,44,49,76
Arbroath,6951,3,18,8,10,72,49,23,62
Alloa,6951,4,17,8,11,57,46,11,59
Stranraer,6951,5,16,5,15,57,64,-7,53
Airdrieon,6951,6,11,11,14,48,60,-12,44
East Fife,6951,7,13,3,20,47,66,-19,42
Forfar,6951,8,10,5,21,40,67,-27,35
Albion,6951,9,8,6,22,59,81,-22,30
Queen's Park,6951,10,6,10,20,40,74,-34,28
Raith,6952,1,23,8,5,70,32,38,77
Ayr,6952,2,24,4,8,94,42,52,76
Arbroath,6952,3,17,9,10,71,49,22,60
Alloa,6952,4,17,8,11,56,45,11,59
Stranraer,6952,5,15,5,16,55,65,-10,50
East Fife,6952,6,14,3,19,48,64,-16,45
Airdrieon,6952,7,11,11,14,47,59,-12,44
Forfar,6952,8,10,5,21,39,66,-27,35
Albion,6952,9,8,6,22,57,82,-25,30
Queen's Park,6952,10,6,11,19,40,73,-33,29
Raith,6953,1,23,8,5,73,34,39,77
Ayr,6953,2,24,4,8,93,44,49,76
Arbroath,6953,3,17,8,11,71,50,21,59
Alloa,6953,4,17,8,11,58,48,10,59
Stranraer,6953,5,15,6,15,57,66,-9,51
East Fife,6953,6,13,4,19,49,66,-17,43
Airdrieon,6953,7,10,11,15,45,59,-14,41
Forfar,6953,8,11,5,20,39,64,-25,38
Queen's Park,6953,9,7,10,19,41,73,-32,31
Albion,6953,10,8,6,22,59,81,-22,30
Raith,6954,1,23,8,5,72,32,40,77
Ayr,6954,2,23,4,9,90,43,47,73
Arbroath,6954,3,17,8,11,71,50,21,59
Alloa,6954,4,17,8,11,56,47,9,59
Stranraer,6954,5,16,5,15,57,64,-7,53
Airdrieon,6954,6,10,12,14,46,59,-13,42
East Fife,6954,7,13,3,20,47,66,-19,42
Forfar,6954,8,10,6,20,39,65,-26,36
Albion,6954,9,9,6,21,58,78,-20,33
Queen's Park,6954,10,7,10,19,41,73,-32,31
Ayr,6955,1,24,4,8,94,44,50,76
Raith,6955,2,22,9,5,70,34,36,75
Arbroath,6955,3,18,8,10,73,48,25,62
Alloa,6955,4,17,9,10,58,45,13,60
Stranraer,6955,5,15,5,16,56,66,-10,50
East Fife,6955,6,14,3,19,49,65,-16,45
Airdrieon,6955,7,10,12,14,47,60,-13,42
Forfar,6955,8,10,6,20,40,66,-26,36
Albion,6955,9,8,6,22,59,82,-23,30
Queen's Park,6955,10,6,10,20,39,75,-36,28
Raith,6956,1,23,8,5,69,32,37,77
Ayr,6956,2,24,4,8,91,42,49,76
Arbroath,6956,3,18,8,10,71,48,23,62
Alloa,6956,4,17,8,11,56,44,12,59
Stranraer,6956,5,15,5,16,57,67,-10,50
East Fife,6956,6,14,3,19,50,66,-16,45
Airdrieon,6956,7,11,11,14,47,59,-12,44
Forfar,6956,8,10,5,21,39,66,-27,35
Albion,6956,9,8,6,22,57,79,-22,30
Queen's Park,6956,10,6,10,20,39,73,-34,28
Ayr,6957,1,24,4,8,92,43,49,76
Raith,6957,2,22,8,6,69,34,35,74
Arbroath,6957,3,18,8,10,73,48,25,62
Alloa,6957,4,18,8,10,58,44,14,62
Stranraer,6957,5,16,5,15,58,65,-7,53
Airdrieon,6957,6,11,11,14,48,59,-11,44
East Fife,6957,7,13,3,20,48,67,-19,42
Forfar,6957,8,10,5,21,39,67,-28,35
Albion,6957,9,8,6,22,58,80,-22,30
Queen's Park,6957,10,6,10,20,39,75,-36,28
Ayr,6958,1,24,4,8,94,43,51,76
Raith,6958,2,22,9,5,69,33,36,75
Arbroath,6958,3,17,9,10,71,49,22,60
Alloa,6958,4,17,9,10,57,44,13,60
Stranraer,6958,5,16,5,15,56,64,-8,53
East Fife,6958,6,13,3,20,47,65,-18,42
Airdrieon,6958,7,10,11,15,45,59,-14,41
Forfar,6958,8,11,5,20,39,64,-25,38
Albion,6958,9,8,6,22,58,82,-24,30
Queen's Park,6958,10,6,11,19,40,73,-33,29
Raith,6959,1,23,8,5,73,34,39,77
Ayr,6959,2,24,4,8,92,43,49,76
Arbroath,6959,3,17,9,10,71,49,22,60
Alloa,6959,4,17,8,11,58,48,10,59
Stranraer,6959,5,16,5,15,58,64,-6,53
Airdrieon,6959,6,11,11,14,47,59,-12,44
East Fife,6959,7,13,3,20,47,67,-20,42
Forfar,6959,8,10,5,21,39,66,-27,35
Albion,6959,9,8,6,22,58,80,-22,30
Queen's Park,6959,10,6,11,19,40,73,-33,29
Ayr,6960,1,24,4,8,93,43,50,76
Raith,6960,2,22,9,5,68,32,36,75
Alloa,6960,3,17,9,10,56,43,13,60
Arbroath,6960,4,17,8,11,70,50,20,59
Stranraer,6960,5,16,5,15,59,65,-6,53
East Fife,6960,6,13,3,20,48,68,-20,42
Airdrieon,6960,7,10,11,15,45,60,-15,41
Forfar,6960,8,11,5,20,40,64,-24,38
Queen's Park,6960,9,7,10,19,41,72,-31,31
Albion,6960,10,8,6,22,58,81,-23,30
Raith,6961,1,23,8,5,70,32,38,77
Ayr,6961,2,23,5,8,91,43,48,74
Arbroath,6961,3,18,8,10,72,48,24,62
Alloa,6961,4,17,8,11,56,45,11,59
Stranraer,6961,5,16,5,15,58,65,-7,53
Airdrieon,6961,6,10,12,14,47,60,-13,42
East Fife,6961,7,13,3,20,48,67,-19,42
Forfar,6961,8,10,6,20,40,66,-26,36
Albion,6961,9,8,7,21,58,79,-21,31
Queen's Park,6961,10,6,10,20,39,74,-35,28
Ayr,6962,1,24,4,8,95,43,52,76
Raith,6962,2,22,9,5,70,34,36,75
Alloa,6962,3,17,9,10,58,45,13,60
Arbroath,6962,4,17,8,11,71,51,20,59
Stranraer,6962,5,15,5,16,55,66,-11,50
East Fife,6962,6,14,3,19,49,64,-15,45
Airdrieon,6962,7,10,11,15,45,59,-14,41
Forfar,6962,8,11,5,20,39,64,-25,38
Queen's Park,6962,9,7,10,19,42,73,-31,31
Albion,6962,10,8,6,22,58,83,-25,30
Ayr,6963,1,24,4,8,93,42,51,76
Raith,6963,2,22,9,5,68,32,36,75
Arbroath,6963,3,18,8,10,78,49,29,62
Alloa,6963,4,17,9,10,56,43,13,60
Stranraer,6963,5,16,5,15,57,65,-8,53
Airdrieon,6963,6,10,12,14,46,59,-13,42
East Fife,6963,7,13,3,20,48,66,-18,42
Forfar,6963,8,10,6,20,39,65,-26,36
Albion,6963,9,8,6,22,57,81,-24,30
Queen's Park,6963,10,6,10,20,40,80,-40,28
Raith,6964,1,23,8,5,70,33,37,77
Ayr,6964,2,23,5,8,91,43,48,74
Arbroath,6964,3,17,8,11,72,51,21,59
Alloa,6964,4,17,8,11,57,45,12,59
Stranraer,6964,5,15,5,16,55,68,-13,50
East Fife,6964,6,14,3,19,51,64,-13,45
Airdrieon,6964,7,11,11,14,46,58,-12,44
Forfar,6964,8,10,5,21,38,65,-27,35
Albion,6964,9,8,7,21,58,79,-21,31
Queen's Park,6964,10,7,10,19,42,74,-32,31
Raith,6965,1,23,8,5,71,33,38,77
Ayr,6965,2,24,4,8,93,44,49,76
Arbroath,6965,3,18,8,10,72,48,24,62
Alloa,6965,4,17,8,11,57,46,11,59
Stranraer,6965,5,15,5,16,55,65,-10,50
East Fife,6965,6,14,3,19,48,64,-16,45
Airdrieon,6965,7,10,12,14,46,59,-13,42
Forfar,6965,8,10,6,20,39,65,-26,36
Albion,6965,9,8,6,22,59,81,-22,30
Queen's Park,6965,10,6,10,20,39,74,-35,28
Ayr,6966,1,24,4,8,93,43,50,76
Raith,6966,2,22,9,5,69,33,36,75
Arbroath,6966,3,18,8,10,73,48,25,62
Alloa,6966,4,17,9,10,57,44,13,60
Stranraer,6966,5,16,5,15,58,66,-8,53
Airdrieon,6966,6,11,11,14,48,59,-11,44
East Fife,6966,7,13,3,20,49,67,-18,42
Forfar,6966,8,10,5,21,39,67,-28,35
Albion,6966,9,8,6,22,58,81,-23,30
Queen's Park,6966,10,6,10,20,39,75,-36,28
Raith,6967,1,22,9,5,70,34,36,75
Ayr,6967,2,23,5,8,94,46,48,74
Arbroath,6967,3,18,8,10,71,48,23,62
Alloa,6967,4,17,9,10,58,45,13,60
Stranraer,6967,5,15,6,15,55,64,-9,51
Airdrieon,6967,6,11,11,14,48,58,-10,44
East Fife,6967,7,13,4,19,47,64,-17,43
Forfar,6967,8,10,5,21,38,67,-29,35
Albion,6967,9,8,7,21,61,82,-21,31
Queen's Park,6967,10,6,10,20,39,73,-34,28
Raith,6968,1,23,8,5,70,32,38,77
Ayr,6968,2,24,4,8,94,45,49,76
Arbroath,6968,3,17,8,11,71,51,20,59
Alloa,6968,4,17,8,11,56,45,11,59
Stranraer,6968,5,15,5,16,55,68,-13,50
East Fife,6968,6,14,3,19,51,64,-13,45
Airdrieon,6968,7,11,11,14,47,59,-12,44
Forfar,6968,8,10,5,21,39,66,-27,35
Queen's Park,6968,9,7,10,19,42,73,-31,31
Albion,6968,10,8,6,22,60,82,-22,30
Raith,6969,1,23,8,5,72,34,38,77
Ayr,6969,2,23,5,8,94,46,48,74
Arbroath,6969,3,18,8,10,74,50,24,62
Alloa,6969,4,17,8,11,58,47,11,59
Stranraer,6969,5,15,6,15,57,66,-9,51
Airdrieon,6969,6,11,11,14,47,58,-11,44
East Fife,6969,7,13,4,19,49,66,-17,43
Forfar,6969,8,10,5,21,38,66,-28,35
Albion,6969,9,8,7,21,61,82,-21,31
Queen's Park,6969,10,6,10,20,41,76,-35,28
Ayr,6970,1,24,4,8,95,42,53,76
Raith,6970,2,22,8,6,68,35,33,74
Arbroath,6970,3,18,8,10,74,50,24,62
Alloa,6970,4,18,8,10,59,43,16,62
Stranraer,6970,5,15,6,15,58,67,-9,51
Airdrieon,6970,6,11,11,14,48,59,-11,44
East Fife,6970,7,13,4,19,50,67,-17,43
Forfar,6970,8,10,5,21,39,67,-28,35
Albion,6970,9,8,6,22,57,83,-26,30
Queen's Park,6970,10,6,10,20,41,76,-35,28
Ayr,6971,1,24,4,8,93,43,50,76
Raith,6971,2,22,9,5,69,33,36,75
Alloa,6971,3,17,9,10,57,44,13,60
Arbroath,6971,4,17,8,11,71,50,21,59
Stranraer,6971,5,15,5,16,56,66,-10,50
East Fife,6971,6,14,3,19,49,65,-16,45
Airdrieon,6971,7,11,11,14,48,60,-12,44
Forfar,6971,8,10,5,21,40,67,-27,35
Queen's Park,6971,9,7,10,19,41,73,-32,31
Albion,6971,10,8,6,22,58,81,-23,30
Raith,6972,1,23,8,5,72,32,40,77
Ayr,6972,2,24,4,8,93,42,51,76
Arbroath,6972,3,17,8,11,71,51,20,59
Alloa,6972,4,17,8,11,56,47,9,59
Stranraer,6972,5,16,5,15,59,67,-8,53
East Fife,6972,6,13,3,20,50,68,-18,42
Airdrieon,6972,7,10,11,15,45,59,-14,41
Forfar,6972,8,11,5,20,39,64,-25,38
Queen's Park,6972,9,7,10,19,42,73,-31,31
Albion,6972,10,8,6,22,57,81,-24,30
Raith,6973,1,22,9,5,69,33,36,75
Ayr,6973,2,23,5,8,93,45,48,74
Arbroath,6973,3,17,9,10,70,48,22,60
Alloa,6973,4,17,9,10,57,44,13,60
Stranraer,6973,5,15,5,16,55,65,-10,50
East Fife,6973,6,14,3,19,48,64,-16,45
Airdrieon,6973,7,10,11,15,47,62,-15,41
Forfar,6973,8,11,5,20,42,66,-24,38
Albion,6973,9,8,7,21,60,81,-21,31
Queen's Park,6973,10,6,11,19,39,72,-33,29
Raith,6974,1,23,8,5,69,32,37,77
Ayr,6974,2,24,4,8,94,43,51,76
Arbroath,6974,3,18,8,10,71,48,23,62
Alloa,6974,4,17,8,11,56,44,12,59
Stranraer,6974,5,16,5,15,60,64,-4,53
East Fife,6974,6,13,3,20,47,69,-22,42
Airdrieon,6974,7,10,11,15,45,60,-15,41
Forfar,6974,8,11,5,20,40,64,-24,38
Albion,6974,9,8,6,22,58,82,-24,30
Queen's Park,6974,10,6,10,20,39,73,-34,28
Ayr,6975,1,24,4,8,92,43,49,76
Raith,6975,2,22,9,5,68,32,36,75
Arbroath,6975,3,18,8,10,73,49,24,62
Alloa,6975,4,17,9,10,56,43,13,60
Stranraer,6975,5,15,5,16,56,66,-10,50
East Fife,6975,6,14,3,19,49,65,-16,45
Airdrieon,6975,7,11,11,14,47,58,-11,44
Forfar,6975,8,10,5,21,38,66,-28,35
Albion,6975,9,8,6,22,58,80,-22,30
Queen's Park,6975,10,6,10,20,40,75,-35,28
Ayr,6976,1,24,4,8,95,45,50,76
Raith,6976,2,22,9,5,68,32,36,75
Arbroath,6976,3,18,8,10,74,50,24,62
Alloa,6976,4,17,9,10,56,43,13,60
Stranraer,6976,5,16,5,15,59,66,-7,53
Airdrieon,6976,6,11,11,14,49,58,-9,44
East Fife,6976,7,13,3,20,49,68,-19,42
Forfar,6976,8,10,5,21,38,68,-30,35
Albion,6976,9,8,6,22,60,83,-23,30
Queen's Park,6976,10,6,10,20,41,76,-35,28
Raith,6977,1,23,8,5,71,34,37,77
Ayr,6977,2,24,4,8,95,44,51,76
Arbroath,6977,3,17,9,10,71,49,22,60
Alloa,6977,4,17,8,11,58,46,12,59
Stranraer,6977,5,16,5,15,58,64,-6,53
Airdrieon,6977,6,10,12,14,46,59,-13,42
East Fife,6977,7,13,3,20,47,67,-20,42
Forfar,6977,8,10,6,20,39,65,-26,36
Albion,6977,9,8,6,22,59,83,-24,30
Queen's Park,6977,10,6,11,19,40,73,-33,29
Ayr,6978,1,24,4,8,95,42,53,76
Raith,6978,2,22,8,6,68,33,35,74
Alloa,6978,3,18,8,10,57,43,14,62
Arbroath,6978,4,17,9,10,72,50,22,60
Stranraer,6978,5,15,5,16,57,67,-10,50
East Fife,6978,6,14,3,19,50,66,-16,45
Airdrieon,6978,7,11,11,14,46,58,-12,44
Forfar,6978,8,10,5,21,38,65,-27,35
Albion,6978,9,8,6,22,57,83,-26,30
Queen's Park,6978,10,6,11,19,41,74,-33,29
Raith,6979,1,23,8,5,69,32,37,77
Ayr,6979,2,24,4,8,93,43,50,76
Arbroath,6979,3,18,8,10,74,51,23,62
Alloa,6979,4,17,8,11,56,44,12,59
Stranraer,6979,5,16,5,15,56,64,-8,53
Airdrieon,6979,6,11,11,14,48,58,-10,44
East Fife,6979,7,13,3,20,47,65,-18,42
Forfar,6979,8,10,5,21,38,67,-29,35
Albion,6979,9,8,6,22,58,81,-23,30
Queen's Park,6979,10,6,10,20,42,76,-34,28
Raith,6980,1,22,8,6,68,34,34,74
Ayr,6980,2,23,4,9,90,45,45,73
Arbroath,6980,3,18,8,10,74,49,25,62
Alloa,6980,4,18,8,10,58,43,15,62
Stranraer,6980,5,16,5,15,56,64,-8,53
Airdrieon,6980,6,10,12,14,47,60,-13,42
East Fife,6980,7,13,3,20,47,65,-18,42
Forfar,6980,8,10,6,20,40,66,-26,36
Albion,6980,9,9,6,21,60,78,-18,33
Queen's Park,6980,10,6,10,20,40,76,-36,28
Ayr,6981,1,24,4,8,94,43,51,76
Raith,6981,2,22,9,5,70,34,36,75
Arbroath,6981,3,18,8,10,72,49,23,62
Alloa,6981,4,17,9,10,58,45,13,60
Stranraer,6981,5,16,5,15,57,65,-8,53
Airdrieon,6981,6,11,11,14,46,58,-12,44
East Fife,6981,7,13,3,20,48,66,-18,42
Forfar,6981,8,10,5,21,38,65,-27,35
Albion,6981,9,8,6,22,58,82,-24,30
Queen's Park,6981,10,6,10,20,40,74,-34,28
Ayr,6982,1,24,4,8,97,46,51,76
Raith,6982,2,22,9,5,69,33,36,75
Alloa,6982,3,17,9,10,57,44,13,60
Arbroath,6982,4,17,8,11,71,50,21,59
Stranraer,6982,5,15,5,16,56,68,-12,50
East Fife,6982,6,14,3,19,51,65,-14,45
Airdrieon,6982,7,11,11,14,48,59,-11,44
Forfar,6982,8,10,5,21,39,67,-28,35
Queen's Park,6982,9,7,10,19,41,73,-32,31
Albion,6982,10,8,6,22,61,85,-24,30
Raith,6983,1,23,8,5,71,34,37,77
Ayr,6983,2,24,4,8,94,43,51,76
Arbroath,6983,3,18,8,10,73,48,25,62
Alloa,6983,4,17,8,11,58,46,12,59
Stranraer,6983,5,15,5,16,56,66,-10,50
East Fife,6983,6,14,3,19,49,65,-16,45
Airdrieon,6983,7,10,11,15,46,60,-14,41
Forfar,6983,8,11,5,20,40,65,-25,38
Albion,6983,9,8,6,22,58,82,-24,30
Queen's Park,6983,10,6,10,20,39,75,-36,28
Raith,6984,1,23,8,5,69,32,37,77
Ayr,6984,2,24,4,8,94,44,50,76
Arbroath,6984,3,18,8,10,72,48,24,62
Alloa,6984,4,17,8,11,56,44,12,59
Stranraer,6984,5,15,6,15,55,64,-9,51
Airdrieon,6984,6,11,11,14,48,59,-11,44
East Fife,6984,7,13,4,19,47,64,-17,43
Forfar,6984,8,10,5,21,39,67,-28,35
Albion,6984,9,8,6,22,59,82,-23,30
Queen's Park,6984,10,6,10,20,39,74,-35,28
Raith,6985,1,23,8,5,72,33,39,77
Ayr,6985,2,24,4,8,95,45,50,76
Arbroath,6985,3,17,9,10,72,50,22,60
Alloa,6985,4,17,8,11,57,47,10,59
Stranraer,6985,5,16,5,15,60,66,-6,53
Airdrieon,6985,6,10,12,14,46,59,-13,42
East Fife,6985,7,13,3,20,49,69,-20,42
Forfar,6985,8,10,6,20,39,65,-26,36
Albion,6985,9,8,6,22,60,83,-23,30
Queen's Park,6985,10,6,11,19,41,74,-33,29
Ayr,6986,1,24,4,8,93,42,51,76
Raith,6986,2,22,9,5,70,34,36,75
Alloa,6986,3,17,9,10,58,45,13,60
Arbroath,6986,4,17,8,11,71,50,21,59
Stranraer,6986,5,15,5,16,56,67,-11,50
East Fife,6986,6,14,3,19,50,65,-15,45
Airdrieon,6986,7,11,11,14,46,58,-12,44
Forfar,6986,8,10,5,21,38,65,-27,35
Queen's Park,6986,9,7,10,19,41,73,-32,31
Albion,6986,10,8,6,22,57,81,-24,30
Raith,6987,1,23,8,5,69,32,37,77
Ayr,6987,2,24,4,8,92,43,49,76
Arbroath,6987,3,18,8,10,72,48,24,62
Alloa,6987,4,17,8,11,56,44,12,59
Stranraer,6987,5,16,5,15,58,64,-6,53
Airdrieon,6987,6,11,11,14,49,58,-9,44
East Fife,6987,7,13,3,20,47,67,-20,42
Forfar,6987,8,10,5,21,38,68,-30,35
Albion,6987,9,8,6,22,58,80,-22,30
Queen's Park,6987,10,6,10,20,39,74,-35,28
Ayr,6988,1,24,4,8,98,45,53,76
Raith,6988,2,22,9,5,68,32,36,75
Arbroath,6988,3,18,8,10,72,48,24,62
Alloa,6988,4,17,9,10,56,43,13,60
Stranraer,6988,5,16,5,15,58,66,-8,53
East Fife,6988,6,13,3,20,49,67,-18,42
Airdrieon,6988,7,10,11,15,45,59,-14,41
Forfar,6988,8,11,5,20,39,64,-25,38
Albion,6988,9,8,6,22,60,86,-26,30
Queen's Park,6988,10,6,10,20,39,74,-35,28
Raith,6989,1,23,8,5,71,34,37,77
Ayr,6989,2,23,5,8,91,43,48,74
Arbroath,6989,3,17,9,10,71,49,22,60
Alloa,6989,4,17,8,11,58,46,12,59
Stranraer,6989,5,15,6,15,56,65,-9,51
East Fife,6989,6,13,4,19,48,65,-17,43
Airdrieon,6989,7,10,11,15,45,59,-14,41
Forfar,6989,8,11,5,20,39,64,-25,38
Albion,6989,9,8,7,21,58,79,-21,31
Queen's Park,6989,10,6,11,19,40,73,-33,29
Ayr,6990,1,24,4,8,92,43,49,76
Raith,6990,2,22,8,6,68,34,34,74
Alloa,6990,3,18,8,10,58,43,15,62
Arbroath,6990,4,17,9,10,71,49,22,60
Stranraer,6990,5,15,6,15,57,66,-9,51
Airdrieon,6990,6,11,11,14,48,59,-11,44
East Fife,6990,7,13,4,19,49,66,-17,43
Forfar,6990,8,10,5,21,39,67,-28,35
Albion,6990,9,8,6,22,58,80,-22,30
Queen's Park,6990,10,6,11,19,40,73,-33,29
Raith,6991,1,23,8,5,71,32,39,77
Ayr,6991,2,24,4,8,95,42,53,76
Arbroath,6991,3,18,8,10,73,50,23,62
Alloa,6991,4,17,8,11,56,46,10,59
Stranraer,6991,5,15,5,16,56,66,-10,50
East Fife,6991,6,14,3,19,49,65,-16,45
Airdrieon,6991,7,11,11,14,46,58,-12,44
Forfar,6991,8,10,5,21,38,65,-27,35
Albion,6991,9,8,6,22,57,83,-26,30
Queen's Park,6991,10,6,10,20,41,75,-34,28
Raith,6992,1,23,8,5,70,32,38,77
Ayr,6992,2,24,4,8,95,43,52,76
Arbroath,6992,3,17,8,11,71,53,18,59
Alloa,6992,4,17,8,11,56,45,11,59
Stranraer,6992,5,16,5,15,58,64,-6,53
Airdrieon,6992,6,11,11,14,46,58,-12,44
East Fife,6992,7,13,3,20,47,67,-20,42
Forfar,6992,8,10,5,21,38,65,-27,35
Queen's Park,6992,9,7,10,19,44,73,-29,31
Albion,6992,10,8,6,22,58,83,-25,30
Ayr,6993,1,24,4,8,95,46,49,76
Raith,6993,2,22,9,5,69,33,36,75
Arbroath,6993,3,17,9,10,71,49,22,60
Alloa,6993,4,17,9,10,57,44,13,60
Stranraer,6993,5,15,6,15,57,66,-9,51
East Fife,6993,6,13,4,19,49,66,-17,43
Airdrieon,6993,7,10,11,15,47,61,-14,41
Forfar,6993,8,11,5,20,41,66,-25,38
Albion,6993,9,8,6,22,61,83,-22,30
Queen's Park,6993,10,6,11,19,40,73,-33,29
Raith,6994,1,23,8,5,70,33,37,77
Ayr,6994,2,24,4,8,97,42,55,76
Arbroath,6994,3,18,8,10,74,50,24,62
Alloa,6994,4,17,8,11,57,45,12,59
Stranraer,6994,5,15,6,15,55,64,-9,51
Airdrieon,6994,6,11,11,14,47,58,-11,44
East Fife,6994,7,13,4,19,47,64,-17,43
Forfar,6994,8,10,5,21,38,66,-28,35
Albion,6994,9,8,6,22,57,85,-28,30
Queen's Park,6994,10,6,10,20,41,76,-35,28
Raith,6995,1,23,8,5,70,33,37,77
Ayr,6995,2,24,4,8,95,44,51,76
Arbroath,6995,3,17,8,11,72,51,21,59
Alloa,6995,4,17,8,11,57,45,12,59
Stranraer,6995,5,15,6,15,56,65,-9,51
Airdrieon,6995,6,11,11,14,49,59,-10,44
East Fife,6995,7,13,4,19,48,65,-17,43
Forfar,6995,8,10,5,21,39,68,-29,35
Queen's Park,6995,9,7,10,19,42,74,-32,31
Albion,6995,10,8,6,22,59,83,-24,30
Raith,6996,1,23,8,5,71,34,37,77
Ayr,6996,2,24,4,8,92,43,49,76
Arbroath,6996,3,17,8,11,71,50,21,59
Alloa,6996,4,17,8,11,58,46,12,59
Stranraer,6996,5,15,5,16,55,66,-11,50
East Fife,6996,6,14,3,19,49,64,-15,45
Airdrieon,6996,7,11,11,14,48,58,-10,44
Forfar,6996,8,10,5,21,38,67,-29,35
Queen's Park,6996,9,7,10,19,41,73,-32,31
Albion,6996,10,8,6,22,58,80,-22,30
Ayr,6997,1,24,4,8,94,43,51,76
Raith,6997,2,22,8,6,68,33,35,74
Arbroath,6997,3,18,8,10,73,49,24,62
Alloa,6997,4,18,8,10,57,43,14,62
Stranraer,6997,5,15,6,15,56,65,-9,51
East Fife,6997,6,13,4,19,48,65,-17,43
Airdrieon,6997,7,10,12,14,46,59,-13,42
Forfar,6997,8,10,6,20,39,65,-26,36
Albion,6997,9,8,6,22,58,82,-24,30
Queen's Park,6997,10,6,10,20,40,75,-35,28
Raith,6998,1,23,8,5,70,33,37,77
Ayr,6998,2,24,4,8,95,43,52,76
Arbroath,6998,3,18,8,10,71,48,23,62
Alloa,6998,4,17,8,11,57,45,12,59
Stranraer,6998,5,15,6,15,57,66,-9,51
East Fife,6998,6,13,4,19,49,66,-17,43
Airdrieon,6998,7,10,12,14,47,60,-13,42
Forfar,6998,8,10,6,20,40,66,-26,36
Albion,6998,9,8,6,22,58,83,-25,30
Queen's Park,6998,10,6,10,20,39,73,-34,28
Raith,6999,1,23,8,5,72,33,39,77
Ayr,6999,2,24,4,8,95,43,52,76
Arbroath,6999,3,18,8,10,73,49,24,62
Alloa,6999,4,17,8,11,57,47,10,59
Stranraer,6999,5,15,5,16,56,66,-10,50
East Fife,6999,6,14,3,19,49,65,-16,45
Airdrieon,6999,7,10,11,15,45,59,-14,41
Forfar,6999,8,11,5,20,39,64,-25,38
Albion,6999,9,8,6,22,58,83,-25,30
Queen's Park,6999,10,6,10,20,40,75,-35,28
Raith,7000,1,23,8,5,70,32,38,77
Ayr,7000,2,23,5,8,92,44,48,74
Arbroath,7000,3,18,8,10,74,48,26,62
Alloa,7000,4,17,8,11,56,45,11,59
Stranraer,7000,5,16,5,15,57,65,-8,53
Airdrieon,7000,6,11,11,14,48,59,-11,44
East Fife,7000,7,13,3,20,48,66,-18,42
Forfar,7000,8,10,5,21,39,67,-28,35
Albion,7000,9,8,7,21,59,80,-21,31
Queen's Park,7000,10,6,10,20,39,76,-37,28
Raith,7001,1,23,8,5,71,33,38,77
Ayr,7001,2,24,4,8,94,42,52,76
Arbroath,7001,3,18,8,10,74,48,26,62
Alloa,7001,4,17,8,11,57,46,11,59
Stranraer,7001,5,16,5,15,58,66,-8,53
Airdrieon,7001,6,11,11,14,47,58,-11,44
East Fife,7001,7,13,3,20,49,67,-18,42
Forfar,7001,8,10,5,21,38,66,-28,35
Albion,7001,9,8,6,22,57,82,-25,30
Queen's Park,7001,10,6,10,20,39,76,-37,28
Raith,7002,1,22,9,5,69,33,36,75
Ayr,7002,2,23,4,9,92,45,47,73
Arbroath,7002,3,18,8,10,73,50,23,62
Alloa,7002,4,17,9,10,57,44,13,60
Stranraer,7002,5,16,5,15,58,66,-8,53
Airdrieon,7002,6,10,12,14,46,59,-13,42
East Fife,7002,7,13,3,20,49,67,-18,42
Forfar,7002,8,10,6,20,39,65,-26,36
Albion,7002,9,9,6,21,60,80,-20,33
Queen's Park,7002,10,6,10,20,41,75,-34,28
Raith,7003,1,23,8,5,69,32,37,77
Ayr,7003,2,24,4,8,94,43,51,76
Arbroath,7003,3,17,9,10,71,49,22,60
Alloa,7003,4,17,8,11,56,44,12,59
Stranraer,7003,5,15,5,16,55,65,-10,50
East Fife,7003,6,14,3,19,48,64,-16,45
Airdrieon,7003,7,10,12,14,45,58,-13,42
Forfar,7003,8,10,6,20,38,64,-26,36
Albion,7003,9,8,6,22,58,82,-24,30
Queen's Park,7003,10,6,11,19,40,73,-33,29
Raith,7004,1,23,8,5,69,32,37,77
Ayr,7004,2,24,4,8,92,42,50,76
Arbroath,7004,3,18,8,10,71,48,23,62
Alloa,7004,4,17,8,11,56,44,12,59
Stranraer,7004,5,15,6,15,59,68,-9,51
East Fife,7004,6,13,4,19,51,68,-17,43
Airdrieon,7004,7,10,11,15,46,61,-15,41
Forfar,7004,8,11,5,20,41,65,-24,38
Albion,7004,9,8,6,22,57,80,-23,30
Queen's Park,7004,10,6,10,20,39,73,-34,28
Raith,7005,1,23,8,5,71,33,38,77
Ayr,7005,2,24,4,8,94,42,52,76
Arbroath,7005,3,18,8,10,74,51,23,62
Alloa,7005,4,17,8,11,57,46,11,59
Stranraer,7005,5,15,5,16,56,67,-11,50
East Fife,7005,6,14,3,19,50,65,-15,45
Airdrieon,7005,7,11,11,14,49,58,-9,44
Forfar,7005,8,10,5,21,38,68,-30,35
Albion,7005,9,8,6,22,57,82,-25,30
Queen's Park,7005,10,6,10,20,42,76,-34,28
Raith,7006,1,23,8,5,70,33,37,77
Ayr,7006,2,23,5,8,92,44,48,74
Arbroath,7006,3,18,8,10,72,49,23,62
Alloa,7006,4,17,8,11,57,45,12,59
Stranraer,7006,5,15,6,15,56,65,-9,51
East Fife,7006,6,13,4,19,48,65,-17,43
Airdrieon,7006,7,10,11,15,45,59,-14,41
Forfar,7006,8,11,5,20,39,64,-25,38
Albion,7006,9,8,7,21,59,80,-21,31
Queen's Park,7006,10,6,10,20,40,74,-34,28
Ayr,7007,1,24,4,8,93,43,50,76
Raith,7007,2,22,8,6,68,34,34,74
Alloa,7007,3,18,8,10,58,43,15,62
Arbroath,7007,4,17,9,10,71,49,22,60
Stranraer,7007,5,15,5,16,55,66,-11,50
East Fife,7007,6,14,3,19,49,64,-15,45
Airdrieon,7007,7,11,11,14,47,58,-11,44
Forfar,7007,8,10,5,21,38,66,-28,35
Albion,7007,9,8,6,22,58,81,-23,30
Queen's Park,7007,10,6,11,19,40,73,-33,29
Ayr,7008,1,24,4,8,94,43,51,76
Raith,7008,2,22,9,5,69,33,36,75
Alloa,7008,3,17,9,10,57,44,13,60
Arbroath,7008,4,17,8,11,71,51,20,59
Stranraer,7008,5,15,5,16,58,68,-10,50
East Fife,7008,6,14,3,19,51,67,-16,45
Airdrieon,7008,7,11,11,14,47,58,-11,44
Forfar,7008,8,10,5,21,38,66,-28,35
Queen's Park,7008,9,7,10,19,42,73,-31,31
Albion,7008,10,8,6,22,58,82,-24,30
Raith,7009,1,23,8,5,69,32,37,77
Ayr,7009,2,23,5,8,93,45,48,74
Arbroath,7009,3,17,9,10,72,50,22,60
Alloa,7009,4,17,8,11,56,44,12,59
Stranraer,7009,5,15,6,15,58,67,-9,51
Airdrieon,7009,6,11,11,14,46,58,-12,44
East Fife,7009,7,13,4,19,50,67,-17,43
Forfar,7009,8,10,5,21,38,65,-27,35
Albion,7009,9,8,7,21,60,81,-21,31
Queen's Park,7009,10,6,11,19,41,74,-33,29
Ayr,7010,1,24,4,8,95,43,52,76
Raith,7010,2,22,9,5,70,34,36,75
Alloa,7010,3,17,9,10,58,45,13,60
Arbroath,7010,4,17,8,11,71,51,20,59
Stranraer,7010,5,16,5,15,58,66,-8,53
Airdrieon,7010,6,11,11,14,47,58,-11,44
East Fife,7010,7,13,3,20,49,67,-18,42
Forfar,7010,8,10,5,21,38,66,-28,35
Queen's Park,7010,9,7,10,19,42,73,-31,31
Albion,7010,10,8,6,22,58,83,-25,30
Ayr,7011,1,24,4,8,94,44,50,76
Raith,7011,2,22,9,5,69,33,36,75
Arbroath,7011,3,17,9,10,70,48,22,60
Alloa,7011,4,17,9,10,57,44,13,60
Stranraer,7011,5,15,6,15,57,66,-9,51
Airdrieon,7011,6,11,11,14,48,60,-12,44
East Fife,7011,7,13,4,19,49,66,-17,43
Forfar,7011,8,10,5,21,40,67,-27,35
Albion,7011,9,8,6,22,59,82,-23,30
Queen's Park,7011,10,6,11,19,39,72,-33,29
Raith,7012,1,22,8,6,69,35,34,74
Ayr,7012,2,23,4,9,92,46,46,73
Arbroath,7012,3,18,8,10,72,48,24,62
Alloa,7012,4,18,8,10,59,44,15,62
Stranraer,7012,5,15,5,16,55,65,-10,50
East Fife,7012,6,14,3,19,48,64,-16,45
Airdrieon,7012,7,10,11,15,46,60,-14,41
Forfar,7012,8,11,5,20,40,65,-25,38
Albion,7012,9,9,6,21,61,80,-19,33
Queen's Park,7012,10,6,10,20,39,74,-35,28
Raith,7013,1,23,8,5,70,33,37,77
Ayr,7013,2,24,4,8,93,43,50,76
Arbroath,7013,3,18,8,10,74,50,24,62
Alloa,7013,4,17,8,11,57,45,12,59
Stranraer,7013,5,15,5,16,55,65,-10,50
East Fife,7013,6,14,3,19,48,64,-16,45
Airdrieon,7013,7,11,11,14,48,60,-12,44
Forfar,7013,8,10,5,21,40,67,-27,35
Albion,7013,9,8,6,22,58,81,-23,30
Queen's Park,7013,10,6,10,20,41,76,-35,28
Raith,7014,1,23,8,5,71,33,38,77
Ayr,7014,2,24,4,8,93,44,49,76
Arbroath,7014,3,17,8,11,71,51,20,59
Alloa,7014,4,17,8,11,57,46,11,59
Stranraer,7014,5,16,5,15,56,64,-8,53
Airdrieon,7014,6,10,12,14,45,58,-13,42
East Fife,7014,7,13,3,20,47,65,-18,42
Forfar,7014,8,10,6,20,38,64,-26,36
Queen's Park,7014,9,7,10,19,42,73,-31,31
Albion,7014,10,8,6,22,59,81,-22,30
Ayr,7015,1,24,4,8,95,43,52,76
Raith,7015,2,22,8,6,70,35,35,74
Arbroath,7015,3,18,8,10,72,48,24,62
Alloa,7015,4,18,8,10,59,45,14,62
Stranraer,7015,5,16,5,15,58,66,-8,53
East Fife,7015,6,13,3,20,49,67,-18,42
Airdrieon,7015,7,10,11,15,45,59,-14,41
Forfar,7015,8,11,5,20,39,64,-25,38
Albion,7015,9,8,6,22,58,83,-25,30
Queen's Park,7015,10,6,10,20,39,74,-35,28
Raith,7016,1,22,8,6,68,33,35,74
Ayr,7016,2,23,4,9,90,43,47,73
Arbroath,7016,3,18,8,10,74,48,26,62
Alloa,7016,4,18,8,10,57,43,14,62
Stranraer,7016,5,15,5,16,55,65,-10,50
East Fife,7016,6,14,3,19,48,64,-16,45
Airdrieon,7016,7,11,11,14,47,58,-11,44
Forfar,7016,8,10,5,21,38,66,-28,35
Albion,7016,9,9,6,21,58,78,-20,33
Queen's Park,7016,10,6,10,20,39,76,-37,28
Ayr,7017,1,24,4,8,98,42,56,76
Raith,7017,2,22,8,6,68,34,34,74
Alloa,7017,3,18,8,10,58,43,15,62
Arbroath,7017,4,17,8,11,71,52,19,59
Stranraer,7017,5,16,5,15,57,65,-8,53
Airdrieon,7017,6,11,11,14,47,59,-12,44
East Fife,7017,7,13,3,20,48,66,-18,42
Forfar,7017,8,10,5,21,39,66,-27,35
Queen's Park,7017,9,7,10,19,43,73,-30,31
Albion,7017,10,8,6,22,57,86,-29,30
Ayr,7018,1,24,4,8,93,44,49,76
Raith,7018,2,22,8,6,68,33,35,74
Alloa,7018,3,18,8,10,57,43,14,62
Arbroath,7018,4,17,8,11,72,51,21,59
Stranraer,7018,5,15,5,16,55,65,-10,50
East Fife,7018,6,14,3,19,48,64,-16,45
Airdrieon,7018,7,11,11,14,48,58,-10,44
Forfar,7018,8,10,5,21,38,67,-29,35
Queen's Park,7018,9,7,10,19,42,74,-32,31
Albion,7018,10,8,6,22,59,81,-22,30
Raith,7019,1,23,8,5,70,33,37,77
Ayr,7019,2,24,4,8,94,43,51,76
Arbroath,7019,3,17,9,10,73,51,22,60
Alloa,7019,4,17,8,11,57,45,12,59
Stranraer,7019,5,16,5,15,59,64,-5,53
Airdrieon,7019,6,10,12,14,45,58,-13,42
East Fife,7019,7,13,3,20,47,68,-21,42
Forfar,7019,8,10,6,20,38,64,-26,36
Albion,7019,9,8,6,22,58,82,-24,30
Queen's Park,7019,10,6,11,19,42,75,-33,29
Ayr,7020,1,24,4,8,95,43,52,76
Raith,7020,2,22,9,5,69,33,36,75
Arbroath,7020,3,18,8,10,76,48,28,62
Alloa,7020,4,17,9,10,57,44,13,60
Stranraer,7020,5,16,5,15,57,64,-7,53
East Fife,7020,6,13,3,20,47,66,-19,42
Airdrieon,7020,7,10,11,15,45,60,-15,41
Forfar,7020,8,11,5,20,40,64,-24,38
Albion,7020,9,8,6,22,58,83,-25,30
Queen's Park,7020,10,6,10,20,39,78,-39,28
Raith,7021,1,23,8,5,69,32,37,77
Ayr,7021,2,23,5,8,92,44,48,74
Arbroath,7021,3,18,8,10,74,48,26,62
Alloa,7021,4,17,8,11,56,44,12,59
Stranraer,7021,5,15,5,16,55,69,-14,50
East Fife,7021,6,14,3,19,52,64,-12,45
Airdrieon,7021,7,10,11,15,46,60,-14,41
Forfar,7021,8,11,5,20,40,65,-25,38
Albion,7021,9,8,7,21,59,80,-21,31
Queen's Park,7021,10,6,10,20,39,76,-37,28
Raith,7022,1,22,9,5,69,33,36,75
Ayr,7022,2,23,4,9,91,45,46,73
Arbroath,7022,3,17,9,10,70,48,22,60
Alloa,7022,4,17,9,10,57,44,13,60
Stranraer,7022,5,15,5,16,55,68,-13,50
East Fife,7022,6,14,3,19,51,64,-13,45
Airdrieon,7022,7,10,12,14,47,60,-13,42
Forfar,7022,8,10,6,20,40,66,-26,36
Albion,7022,9,9,6,21,60,79,-19,33
Queen's Park,7022,10,6,11,19,39,72,-33,29
Ayr,7023,1,24,4,8,92,42,50,76
Raith,7023,2,22,9,5,69,33,36,75
Arbroath,7023,3,17,9,10,71,49,22,60
Alloa,7023,4,17,9,10,57,44,13,60
Stranraer,7023,5,15,6,15,57,66,-9,51
East Fife,7023,6,13,4,19,49,66,-17,43
Airdrieon,7023,7,10,11,15,45,60,-15,41
Forfar,7023,8,11,5,20,40,64,-24,38
Albion,7023,9,8,6,22,57,80,-23,30
Queen's Park,7023,10,6,11,19,40,73,-33,29
Raith,7024,1,23,8,5,70,33,37,77
Ayr,7024,2,23,5,8,92,44,48,74
Arbroath,7024,3,18,8,10,73,50,23,62
Alloa,7024,4,17,8,11,57,45,12,59
Stranraer,7024,5,15,5,16,55,66,-11,50
East Fife,7024,6,14,3,19,49,64,-15,45
Airdrieon,7024,7,11,11,14,50,59,-9,44
Forfar,7024,8,10,5,21,39,69,-30,35
Albion,7024,9,8,7,21,59,80,-21,31
Queen's Park,7024,10,6,10,20,41,75,-34,28
Raith,7025,1,22,8,6,69,34,35,74
Ayr,7025,2,23,4,9,90,44,46,73
Alloa,7025,3,18,8,10,58,44,14,62
Arbroath,7025,4,17,8,11,71,50,21,59
Stranraer,7025,5,15,5,16,55,67,-12,50
East Fife,7025,6,14,3,19,50,64,-14,45
Airdrieon,7025,7,11,11,14,46,58,-12,44
Forfar,7025,8,10,5,21,38,65,-27,35
Albion,7025,9,9,6,21,59,78,-19,33
Queen's Park,7025,10,7,10,19,41,73,-32,31
Raith,7026,1,22,8,6,68,33,35,74
Ayr,7026,2,23,4,9,91,45,46,73
Alloa,7026,3,18,8,10,57,43,14,62
Arbroath,7026,4,17,9,10,71,49,22,60
Stranraer,7026,5,15,5,16,55,67,-12,50
East Fife,7026,6,14,3,19,50,64,-14,45
Airdrieon,7026,7,11,11,14,48,59,-11,44
Forfar,7026,8,10,5,21,39,67,-28,35
Albion,7026,9,9,6,21,60,79,-19,33
Queen's Park,7026,10,6,11,19,40,73,-33,29
Ayr,7027,1,24,4,8,94,44,50,76
Raith,7027,2,22,9,5,68,32,36,75
Arbroath,7027,3,18,8,10,73,50,23,62
Alloa,7027,4,17,9,10,56,43,13,60
Stranraer,7027,5,15,6,15,56,65,-9,51
Airdrieon,7027,6,11,11,14,48,58,-10,44
East Fife,7027,7,13,4,19,48,65,-17,43
Forfar,7027,8,10,5,21,38,67,-29,35
Albion,7027,9,8,6,22,59,82,-23,30
Queen's Park,7027,10,6,10,20,41,75,-34,28
Raith,7028,1,23,8,5,71,32,39,77
Ayr,7028,2,24,4,8,94,42,52,76
Arbroath,7028,3,17,8,11,70,49,21,59
Alloa,7028,4,17,8,11,56,46,10,59
Stranraer,7028,5,15,5,16,56,66,-10,50
East Fife,7028,6,14,3,19,49,65,-16,45
Airdrieon,7028,7,11,11,14,47,58,-11,44
Forfar,7028,8,10,5,21,38,66,-28,35
Queen's Park,7028,9,7,10,19,40,72,-32,31
Albion,7028,10,8,6,22,57,82,-25,30
Raith,7029,1,23,8,5,69,32,37,77
Ayr,7029,2,24,4,8,93,42,51,76
Arbroath,7029,3,17,9,10,71,49,22,60
Alloa,7029,4,17,8,11,56,44,12,59
Stranraer,7029,5,16,5,15,56,64,-8,53
Airdrieon,7029,6,11,11,14,47,58,-11,44
East Fife,7029,7,13,3,20,47,65,-18,42
Forfar,7029,8,10,5,21,38,66,-28,35
Albion,7029,9,8,6,22,57,81,-24,30
Queen's Park,7029,10,6,11,19,40,73,-33,29
Raith,7030,1,23,8,5,69,32,37,77
Ayr,7030,2,23,5,8,92,44,48,74
Arbroath,7030,3,18,8,10,71,48,23,62
Alloa,7030,4,17,8,11,56,44,12,59
Stranraer,7030,5,16,5,15,57,65,-8,53
Airdrieon,7030,6,11,11,14,48,60,-12,44
East Fife,7030,7,13,3,20,48,66,-18,42
Forfar,7030,8,10,5,21,40,67,-27,35
Albion,7030,9,8,7,21,59,80,-21,31
Queen's Park,7030,10,6,10,20,39,73,-34,28
Raith,7031,1,23,8,5,71,33,38,77
Ayr,7031,2,24,4,8,94,44,50,76
Arbroath,7031,3,18,8,10,71,48,23,62
Alloa,7031,4,17,8,11,57,46,11,59
Stranraer,7031,5,16,5,15,56,64,-8,53
Airdrieon,7031,6,10,12,14,45,58,-13,42
East Fife,7031,7,13,3,20,47,65,-18,42
Forfar,7031,8,10,6,20,38,64,-26,36
Albion,7031,9,8,6,22,59,82,-23,30
Queen's Park,7031,10,6,10,20,39,73,-34,28
Raith,7032,1,23,8,5,70,32,38,77
Ayr,7032,2,24,4,8,93,44,49,76
Arbroath,7032,3,17,8,11,73,53,20,59
Alloa,7032,4,17,8,11,56,45,11,59
Stranraer,7032,5,15,5,16,55,66,-11,50
East Fife,7032,6,14,3,19,49,64,-15,45
Airdrieon,7032,7,11,11,14,46,58,-12,44
Forfar,7032,8,10,5,21,38,65,-27,35
Queen's Park,7032,9,7,10,19,44,75,-31,31
Albion,7032,10,8,6,22,59,81,-22,30
Raith,7033,1,23,8,5,72,33,39,77
Ayr,7033,2,23,4,9,92,45,47,73
Arbroath,7033,3,17,8,11,72,52,20,59
Alloa,7033,4,17,8,11,57,47,10,59
Stranraer,7033,5,15,5,16,56,66,-10,50
East Fife,7033,6,14,3,19,49,65,-16,45
Airdrieon,7033,7,11,11,14,48,58,-10,44
Forfar,7033,8,10,5,21,38,67,-29,35
Albion,7033,9,9,6,21,60,80,-20,33
Queen's Park,7033,10,7,10,19,43,74,-31,31
Raith,7034,1,23,8,5,70,33,37,77
Ayr,7034,2,24,4,8,94,42,52,76
Arbroath,7034,3,18,8,10,72,49,23,62
Alloa,7034,4,17,8,11,57,45,12,59
Stranraer,7034,5,16,5,15,57,65,-8,53
Airdrieon,7034,6,11,11,14,46,58,-12,44
East Fife,7034,7,13,3,20,48,66,-18,42
Forfar,7034,8,10,5,21,38,65,-27,35
Albion,7034,9,8,6,22,57,82,-25,30
Queen's Park,7034,10,6,10,20,40,74,-34,28
Raith,7035,1,23,8,5,72,33,39,77
Ayr,7035,2,24,4,8,96,45,51,76
Arbroath,7035,3,17,8,11,71,50,21,59
Alloa,7035,4,17,8,11,57,47,10,59
Stranraer,7035,5,15,5,16,55,67,-12,50
East Fife,7035,6,14,3,19,50,64,-14,45
Airdrieon,7035,7,11,11,14,47,59,-12,44
Forfar,7035,8,10,5,21,39,66,-27,35
Queen's Park,7035,9,7,10,19,41,73,-32,31
Albion,7035,10,8,6,22,60,84,-24,30
Raith,7036,1,23,8,5,71,33,38,77
Ayr,7036,2,24,4,8,92,42,50,76
Arbroath,7036,3,17,8,11,70,50,20,59
Alloa,7036,4,17,8,11,57,46,11,59
Stranraer,7036,5,16,5,15,57,64,-7,53
Airdrieon,7036,6,11,11,14,46,58,-12,44
East Fife,7036,7,13,3,20,47,66,-19,42
Forfar,7036,8,10,5,21,38,65,-27,35
Queen's Park,7036,9,7,10,19,41,72,-31,31
Albion,7036,10,8,6,22,57,80,-23,30
Raith,7037,1,23,8,5,70,32,38,77
Ayr,7037,2,24,4,8,95,43,52,76
Arbroath,7037,3,18,8,10,71,48,23,62
Alloa,7037,4,17,8,11,56,45,11,59
Stranraer,7037,5,15,5,16,55,65,-10,50
East Fife,7037,6,14,3,19,48,64,-16,45
Airdrieon,7037,7,11,11,14,47,58,-11,44
Forfar,7037,8,10,5,21,38,66,-28,35
Albion,7037,9,8,6,22,58,83,-25,30
Queen's Park,7037,10,6,10,20,39,73,-34,28
Ayr,7038,1,24,4,8,97,42,55,76
Raith,7038,2,22,9,5,69,33,36,75
Arbroath,7038,3,17,9,10,73,51,22,60
Alloa,7038,4,17,9,10,57,44,13,60
Stranraer,7038,5,16,5,15,59,67,-8,53
East Fife,7038,6,13,3,20,50,68,-18,42
Airdrieon,7038,7,10,11,15,45,60,-15,41
Forfar,7038,8,11,5,20,40,64,-24,38
Albion,7038,9,8,6,22,57,85,-28,30
Queen's Park,7038,10,6,11,19,42,75,-33,29
Raith,7039,1,23,8,5,69,32,37,77
Ayr,7039,2,24,4,8,93,44,49,76
Arbroath,7039,3,17,9,10,73,51,22,60
Alloa,7039,4,17,8,11,56,44,12,59
Stranraer,7039,5,15,5,16,56,68,-12,50
East Fife,7039,6,14,3,19,51,65,-14,45
Airdrieon,7039,7,11,11,14,50,60,-10,44
Forfar,7039,8,10,5,21,40,69,-29,35
Albion,7039,9,8,6,22,59,81,-22,30
Queen's Park,7039,10,6,11,19,42,75,-33,29
Raith,7040,1,23,8,5,70,33,37,77
Ayr,7040,2,24,4,8,94,43,51,76
Arbroath,7040,3,17,8,11,72,51,21,59
Alloa,7040,4,17,8,11,57,45,12,59
Stranraer,7040,5,16,5,15,56,64,-8,53
Airdrieon,7040,6,11,11,14,48,59,-11,44
East Fife,7040,7,13,3,20,47,65,-18,42
Forfar,7040,8,10,5,21,39,67,-28,35
Queen's Park,7040,9,7,10,19,42,74,-32,31
Albion,7040,10,8,6,22,58,82,-24,30
Ayr,7041,1,24,4,8,95,42,53,76
Raith,7041,2,22,8,6,68,33,35,74
Arbroath,7041,3,18,8,10,72,49,23,62
Alloa,7041,4,18,8,10,57,43,14,62
Stranraer,7041,5,15,5,16,55,65,-10,50
East Fife,7041,6,14,3,19,48,64,-16,45
Airdrieon,7041,7,10,12,14,47,60,-13,42
Forfar,7041,8,10,6,20,40,66,-26,36
Albion,7041,9,8,6,22,57,83,-26,30
Queen's Park,7041,10,6,10,20,40,74,-34,28
Ayr,7042,1,24,4,8,97,43,54,76
Raith,7042,2,22,9,5,69,33,36,75
Arbroath,7042,3,18,8,10,73,49,24,62
Alloa,7042,4,17,9,10,57,44,13,60
Stranraer,7042,5,15,6,15,58,67,-9,51
Airdrieon,7042,6,11,11,14,48,59,-11,44
East Fife,7042,7,13,4,19,50,67,-17,43
Forfar,7042,8,10,5,21,39,67,-28,35
Albion,7042,9,8,6,22,58,85,-27,30
Queen's Park,7042,10,6,10,20,40,75,-35,28
Ayr,7043,1,24,4,8,92,43,49,76
Raith,7043,2,22,9,5,69,33,36,75
Alloa,7043,3,17,9,10,57,44,13,60
Arbroath,7043,4,17,8,11,70,50,20,59
Stranraer,7043,5,16,5,15,57,64,-7,53
Airdrieon,7043,6,11,11,14,47,59,-12,44
East Fife,7043,7,13,3,20,47,66,-19,42
Forfar,7043,8,10,5,21,39,66,-27,35
Queen's Park,7043,9,7,10,19,41,72,-31,31
Albion,7043,10,8,6,22,58,80,-22,30
Raith,7044,1,23,8,5,70,33,37,77
Ayr,7044,2,24,4,8,93,42,51,76
Arbroath,7044,3,17,9,10,72,50,22,60
Alloa,7044,4,17,8,11,57,45,12,59
Stranraer,7044,5,15,5,16,57,67,-10,50
East Fife,7044,6,14,3,19,50,66,-16,45
Airdrieon,7044,7,11,11,14,46,58,-12,44
Forfar,7044,8,10,5,21,38,65,-27,35
Albion,7044,9,8,6,22,57,81,-24,30
Queen's Park,7044,10,6,11,19,41,74,-33,29
Ayr,7045,1,24,4,8,93,42,51,76
Raith,7045,2,22,9,5,69,33,36,75
Alloa,7045,3,17,9,10,57,44,13,60
Arbroath,7045,4,17,8,11,71,51,20,59
Stranraer,7045,5,16,5,15,56,64,-8,53
East Fife,7045,6,13,3,20,47,65,-18,42
Airdrieon,7045,7,10,11,15,46,61,-15,41
Forfar,7045,8,11,5,20,41,65,-24,38
Queen's Park,7045,9,7,10,19,42,73,-31,31
Albion,7045,10,8,6,22,57,81,-24,30
Raith,7046,1,23,8,5,69,32,37,77
Ayr,7046,2,24,4,8,94,42,52,76
Arbroath,7046,3,17,9,10,71,49,22,60
Alloa,7046,4,17,8,11,56,44,12,59
Stranraer,7046,5,16,5,15,57,64,-7,53
Airdrieon,7046,6,11,11,14,46,58,-12,44
East Fife,7046,7,13,3,20,47,66,-19,42
Forfar,7046,8,10,5,21,38,65,-27,35
Albion,7046,9,8,6,22,57,82,-25,30
Queen's Park,7046,10,6,11,19,40,73,-33,29
Raith,7047,1,23,8,5,70,33,37,77
Ayr,7047,2,23,5,8,91,43,48,74
Arbroath,7047,3,17,8,11,71,51,20,59
Alloa,7047,4,17,8,11,57,45,12,59
Stranraer,7047,5,16,5,15,60,68,-8,53
Airdrieon,7047,6,11,11,14,49,59,-10,44
East Fife,7047,7,13,3,20,51,69,-18,42
Forfar,7047,8,10,5,21,39,68,-29,35
Albion,7047,9,8,7,21,58,79,-21,31
Queen's Park,7047,10,7,10,19,42,73,-31,31
Raith,7048,1,23,8,5,71,33,38,77
Ayr,7048,2,24,4,8,93,42,51,76
Arbroath,7048,3,18,8,10,72,48,24,62
Alloa,7048,4,17,8,11,57,46,11,59
Stranraer,7048,5,15,6,15,57,66,-9,51
East Fife,7048,6,13,4,19,49,66,-17,43
Airdrieon,7048,7,10,12,14,46,59,-13,42
Forfar,7048,8,10,6,20,39,65,-26,36
Albion,7048,9,8,6,22,57,81,-24,30
Queen's Park,7048,10,6,10,20,39,74,-35,28
Raith,7049,1,23,8,5,71,32,39,77
Ayr,7049,2,24,4,8,92,43,49,76
Arbroath,7049,3,17,9,10,71,49,22,60
Alloa,7049,4,17,8,11,56,46,10,59
Stranraer,7049,5,15,6,15,58,67,-9,51
Airdrieon,7049,6,11,11,14,47,58,-11,44
East Fife,7049,7,13,4,19,50,67,-17,43
Forfar,7049,8,10,5,21,38,66,-28,35
Albion,7049,9,8,6,22,58,80,-22,30
Queen's Park,7049,10,6,11,19,40,73,-33,29
Raith,7050,1,23,8,5,70,33,37,77
Ayr,7050,2,24,4,8,97,43,54,76
Arbroath,7050,3,18,8,10,72,49,23,62
Alloa,7050,4,17,8,11,57,45,12,59
Stranraer,7050,5,16,5,15,57,64,-7,53
Airdrieon,7050,6,11,11,14,47,59,-12,44
East Fife,7050,7,13,3,20,47,66,-19,42
Forfar,7050,8,10,5,21,39,66,-27,35
Albion,7050,9,8,6,22,58,85,-27,30
Queen's Park,7050,10,6,10,20,40,74,-34,28
Raith,7051,1,23,8,5,72,34,38,77
Ayr,7051,2,24,4,8,93,43,50,76
Arbroath,7051,3,17,8,11,70,49,21,59
Alloa,7051,4,17,8,11,58,47,11,59
Stranraer,7051,5,16,5,15,58,66,-8,53
Airdrieon,7051,6,11,11,14,47,59,-12,44
East Fife,7051,7,13,3,20,49,67,-18,42
Forfar,7051,8,10,5,21,39,66,-27,35
Queen's Park,7051,9,7,10,19,40,72,-32,31
Albion,7051,10,8,6,22,58,81,-23,30
Raith,7052,1,23,8,5,69,32,37,77
Ayr,7052,2,23,5,8,91,43,48,74
Arbroath,7052,3,17,9,10,71,49,22,60
Alloa,7052,4,17,8,11,56,44,12,59
Stranraer,7052,5,16,5,15,56,64,-8,53
Airdrieon,7052,6,11,11,14,47,59,-12,44
East Fife,7052,7,13,3,20,47,65,-18,42
Forfar,7052,8,10,5,21,39,66,-27,35
Albion,7052,9,8,7,21,58,79,-21,31
Queen's Park,7052,10,6,11,19,40,73,-33,29
Raith,7053,1,23,8,5,69,32,37,77
Ayr,7053,2,24,4,8,93,43,50,76
Arbroath,7053,3,18,8,10,74,51,23,62
Alloa,7053,4,17,8,11,56,44,12,59
Stranraer,7053,5,15,5,16,55,67,-12,50
East Fife,7053,6,14,3,19,50,64,-14,45
Airdrieon,7053,7,10,12,14,45,58,-13,42
Forfar,7053,8,10,6,20,38,64,-26,36
Albion,7053,9,8,6,22,58,81,-23,30
Queen's Park,7053,10,6,10,20,42,76,-34,28
Raith,7054,1,23,8,5,70,33,37,77
Ayr,7054,2,24,4,8,93,43,50,76
Arbroath,7054,3,18,8,10,72,48,24,62
Alloa,7054,4,17,8,11,57,45,12,59
Stranraer,7054,5,15,6,15,57,66,-9,51
Airdrieon,7054,6,11,11,14,47,59,-12,44
East Fife,7054,7,13,4,19,49,66,-17,43
Forfar,7054,8,10,5,21,39,66,-27,35
Albion,7054,9,8,6,22,58,81,-23,30
Queen's Park,7054,10,6,10,20,39,74,-35,28
Raith,7055,1,23,8,5,73,33,40,77
Ayr,7055,2,24,4,8,92,42,50,76
Arbroath,7055,3,18,8,10,72,49,23,62
Alloa,7055,4,17,8,11,57,48,9,59
Stranraer,7055,5,15,5,16,55,65,-10,50
East Fife,7055,6,14,3,19,48,64,-16,45
Airdrieon,7055,7,11,11,14,47,59,-12,44
Forfar,7055,8,10,5,21,39,66,-27,35
Albion,7055,9,8,6,22,57,80,-23,30
Queen's Park,7055,10,6,10,20,40,74,-34,28
Raith,7056,1,23,8,5,70,32,38,77
Ayr,7056,2,24,4,8,95,44,51,76
Arbroath,7056,3,17,8,11,71,50,21,59
Alloa,7056,4,17,8,11,56,45,11,59
Stranraer,7056,5,15,5,16,55,66,-11,50
East Fife,7056,6,14,3,19,49,64,-15,45
Airdrieon,7056,7,11,11,14,48,59,-11,44
Forfar,7056,8,10,5,21,39,67,-28,35
Queen's Park,7056,9,7,10,19,41,73,-32,31
Albion,7056,10,8,6,22,59,83,-24,30
Ayr,7057,1,24,4,8,95,43,52,76
Raith,7057,2,22,9,5,69,33,36,75
Arbroath,7057,3,18,8,10,72,49,23,62
Alloa,7057,4,17,9,10,57,44,13,60
Stranraer,7057,5,15,5,16,55,65,-10,50
East Fife,7057,6,14,3,19,48,64,-16,45
Airdrieon,7057,7,10,11,15,45,59,-14,41
Forfar,7057,8,11,5,20,39,64,-25,38
Albion,7057,9,8,6,22,58,83,-25,30
Queen's Park,7057,10,6,10,20,40,74,-34,28
Raith,7058,1,22,9,5,69,33,36,75
Ayr,7058,2,23,4,9,90,43,47,73
Arbroath,7058,3,18,8,10,72,49,23,62
Alloa,7058,4,17,9,10,57,44,13,60
Stranraer,7058,5,15,5,16,56,66,-10,50
East Fife,7058,6,14,3,19,49,65,-16,45
Airdrieon,7058,7,10,12,14,45,58,-13,42
Forfar,7058,8,10,6,20,38,64,-26,36
Albion,7058,9,9,6,21,58,78,-20,33
Queen's Park,7058,10,6,10,20,40,74,-34,28
Raith,7059,1,22,9,5,70,34,36,75
Ayr,7059,2,23,4,9,90,44,46,73
Arbroath,7059,3,18,8,10,72,49,23,62
Alloa,7059,4,17,9,10,58,45,13,60
Stranraer,7059,5,15,5,16,56,66,-10,50
East Fife,7059,6,14,3,19,49,65,-16,45
Airdrieon,7059,7,10,11,15,47,61,-14,41
Forfar,7059,8,11,5,20,41,66,-25,38
Albion,7059,9,9,6,21,59,78,-19,33
Queen's Park,7059,10,6,10,20,40,74,-34,28
Ayr,7060,1,24,4,8,94,43,51,76
Raith,7060,2,22,8,6,68,33,35,74
Arbroath,7060,3,18,8,10,74,49,25,62
Alloa,7060,4,18,8,10,57,43,14,62
Stranraer,7060,5,15,6,15,57,66,-9,51
East Fife,7060,6,13,4,19,49,66,-17,43
Airdrieon,7060,7,10,12,14,48,61,-13,42
Forfar,7060,8,10,6,20,41,67,-26,36
Albion,7060,9,8,6,22,58,82,-24,30
Queen's Park,7060,10,6,10,20,40,76,-36,28
Raith,7061,1,22,8,6,68,35,33,74
Ayr,7061,2,23,4,9,91,44,47,73
Arbroath,7061,3,18,8,10,73,49,24,62
Alloa,7061,4,18,8,10,59,43,16,62
Stranraer,7061,5,15,5,16,55,67,-12,50
East Fife,7061,6,14,3,19,50,64,-14,45
Airdrieon,7061,7,11,11,14,46,58,-12,44
Forfar,7061,8,10,5,21,38,65,-27,35
Albion,7061,9,9,6,21,59,79,-20,33
Queen's Park,7061,10,6,10,20,40,75,-35,28
Raith,7062,1,23,8,5,69,32,37,77
Ayr,7062,2,24,4,8,94,43,51,76
Arbroath,7062,3,18,8,10,75,48,27,62
Alloa,7062,4,17,8,11,56,44,12,59
Stranraer,7062,5,16,5,15,56,64,-8,53
East Fife,7062,6,13,3,20,47,65,-18,42
Airdrieon,7062,7,10,11,15,45,60,-15,41
Forfar,7062,8,11,5,20,40,64,-24,38
Albion,7062,9,8,6,22,58,82,-24,30
Queen's Park,7062,10,6,10,20,39,77,-38,28
Raith,7063,1,23,8,5,72,33,39,77
Ayr,7063,2,24,4,8,91,42,49,76
Arbroath,7063,3,18,8,10,74,48,26,62
Alloa,7063,4,17,8,11,57,47,10,59
Stranraer,7063,5,16,5,15,58,65,-7,53
Airdrieon,7063,6,11,11,14,46,58,-12,44
East Fife,7063,7,13,3,20,48,67,-19,42
Forfar,7063,8,10,5,21,38,65,-27,35
Albion,7063,9,8,6,22,57,79,-22,30
Queen's Park,7063,10,6,10,20,39,76,-37,28
Ayr,7064,1,24,4,8,98,42,56,76
Raith,7064,2,22,8,6,69,36,33,74
Alloa,7064,3,18,8,10,60,44,16,62
Arbroath,7064,4,17,8,11,71,50,21,59
Stranraer,7064,5,15,6,15,56,65,-9,51
East Fife,7064,6,13,4,19,48,65,-17,43
Airdrieon,7064,7,10,11,15,45,60,-15,41
Forfar,7064,8,11,5,20,40,64,-24,38
Queen's Park,7064,9,7,10,19,41,73,-32,31
Albion,7064,10,8,6,22,57,86,-29,30
Ayr,7065,1,24,4,8,95,42,53,76
Raith,7065,2,22,9,5,68,32,36,75
Arbroath,7065,3,17,9,10,70,48,22,60
Alloa,7065,4,17,9,10,56,43,13,60
Stranraer,7065,5,15,5,16,56,67,-11,50
East Fife,7065,6,14,3,19,50,65,-15,45
Airdrieon,7065,7,11,11,14,48,58,-10,44
Forfar,7065,8,10,5,21,38,67,-29,35
Albion,7065,9,8,6,22,57,83,-26,30
Queen's Park,7065,10,6,11,19,39,72,-33,29
Raith,7066,1,23,8,5,71,34,37,77
Ayr,7066,2,24,4,8,95,43,52,76
Arbroath,7066,3,17,8,11,71,50,21,59
Alloa,7066,4,17,8,11,58,46,12,59
Stranraer,7066,5,15,6,15,56,65,-9,51
East Fife,7066,6,13,4,19,48,65,-17,43
Airdrieon,7066,7,10,11,15,45,60,-15,41
Forfar,7066,8,11,5,20,40,64,-24,38
Queen's Park,7066,9,7,10,19,41,73,-32,31
Albion,7066,10,8,6,22,58,83,-25,30
Raith,7067,1,23,8,5,70,33,37,77
Ayr,7067,2,24,4,8,97,43,54,76
Arbroath,7067,3,18,8,10,72,49,23,62
Alloa,7067,4,17,8,11,57,45,12,59
Stranraer,7067,5,15,5,16,55,66,-11,50
East Fife,7067,6,14,3,19,49,64,-15,45
Airdrieon,7067,7,11,11,14,48,58,-10,44
Forfar,7067,8,10,5,21,38,67,-29,35
Albion,7067,9,8,6,22,58,85,-27,30
Queen's Park,7067,10,6,10,20,40,74,-34,28
Raith,7068,1,23,8,5,72,32,40,77
Ayr,7068,2,24,4,8,94,45,49,76
Arbroath,7068,3,17,8,11,71,51,20,59
Alloa,7068,4,17,8,11,56,47,9,59
Stranraer,7068,5,15,5,16,56,66,-10,50
East Fife,7068,6,14,3,19,49,65,-16,45
Airdrieon,7068,7,10,12,14,46,59,-13,42
Forfar,7068,8,10,6,20,39,65,-26,36
Queen's Park,7068,9,7,10,19,42,73,-31,31
Albion,7068,10,8,6,22,60,82,-22,30
Raith,7069,1,22,9,5,68,32,36,75
Ayr,7069,2,23,5,8,90,42,48,74
Arbroath,7069,3,17,9,10,71,49,22,60
Alloa,7069,4,17,9,10,56,43,13,60
Stranraer,7069,5,16,5,15,58,66,-8,53
Airdrieon,7069,6,10,12,14,47,60,-13,42
East Fife,7069,7,13,3,20,49,67,-18,42
Forfar,7069,8,10,6,20,40,66,-26,36
Albion,7069,9,8,7,21,57,78,-21,31
Queen's Park,7069,10,6,11,19,40,73,-33,29
Ayr,7070,1,24,4,8,94,44,50,76
Raith,7070,2,22,8,6,69,36,33,74
Alloa,7070,3,18,8,10,60,44,16,62
Arbroath,7070,4,17,9,10,71,49,22,60
Stranraer,7070,5,16,5,15,60,66,-6,53
Airdrieon,7070,6,11,11,14,48,58,-10,44
East Fife,7070,7,13,3,20,49,69,-20,42
Forfar,7070,8,10,5,21,38,67,-29,35
Albion,7070,9,8,6,22,59,82,-23,30
Queen's Park,7070,10,6,11,19,40,73,-33,29
Ayr,7071,1,24,4,8,92,43,49,76
Raith,7071,2,22,8,6,70,35,35,74
Arbroath,7071,3,18,8,10,73,48,25,62
Alloa,7071,4,18,8,10,59,45,14,62
Stranraer,7071,5,16,5,15,57,65,-8,53
Airdrieon,7071,6,11,11,14,47,58,-11,44
East Fife,7071,7,13,3,20,48,66,-18,42
Forfar,7071,8,10,5,21,38,66,-28,35
Albion,7071,9,8,6,22,58,80,-22,30
Queen's Park,7071,10,6,10,20,39,75,-36,28
Raith,7072,1,23,8,5,72,34,38,77
Ayr,7072,2,24,4,8,92,43,49,76
Arbroath,7072,3,17,8,11,71,50,21,59
Alloa,7072,4,17,8,11,58,47,11,59
Stranraer,7072,5,15,5,16,57,67,-10,50
East Fife,7072,6,14,3,19,50,66,-16,45
Airdrieon,7072,7,10,11,15,46,60,-14,41
Forfar,7072,8,11,5,20,40,65,-25,38
Queen's Park,7072,9,7,10,19,41,73,-32,31
Albion,7072,10,8,6,22,58,80,-22,30
Raith,7073,1,23,8,5,72,34,38,77
Ayr,7073,2,24,4,8,96,43,53,76
Arbroath,7073,3,18,8,10,75,49,26,62
Alloa,7073,4,17,8,11,58,47,11,59
Stranraer,7073,5,15,5,16,55,66,-11,50
East Fife,7073,6,14,3,19,49,64,-15,45
Airdrieon,7073,7,11,11,14,47,58,-11,44
Forfar,7073,8,10,5,21,38,66,-28,35
Albion,7073,9,8,6,22,58,84,-26,30
Queen's Park,7073,10,6,10,20,40,77,-37,28
Raith,7074,1,23,8,5,71,33,38,77
Ayr,7074,2,24,4,8,94,44,50,76
Arbroath,7074,3,17,9,10,70,48,22,60
Alloa,7074,4,17,8,11,57,46,11,59
Stranraer,7074,5,16,5,15,56,64,-8,53
Airdrieon,7074,6,10,12,14,45,58,-13,42
East Fife,7074,7,13,3,20,47,65,-18,42
Forfar,7074,8,10,6,20,38,64,-26,36
Albion,7074,9,8,6,22,59,82,-23,30
Queen's Park,7074,10,6,11,19,39,72,-33,29
Raith,7075,1,23,8,5,70,32,38,77
Ayr,7075,2,24,4,8,93,42,51,76
Arbroath,7075,3,18,8,10,71,48,23,62
Alloa,7075,4,17,8,11,56,45,11,59
Stranraer,7075,5,15,5,16,56,66,-10,50
East Fife,7075,6,14,3,19,49,65,-16,45
Airdrieon,7075,7,10,12,14,46,59,-13,42
Forfar,7075,8,10,6,20,39,65,-26,36
Albion,7075,9,8,6,22,57,81,-24,30
Queen's Park,7075,10,6,10,20,39,73,-34,28
Raith,7076,1,23,8,5,69,32,37,77
Ayr,7076,2,24,4,8,93,44,49,76
Arbroath,7076,3,18,8,10,73,49,24,62
Alloa,7076,4,17,8,11,56,44,12,59
Stranraer,7076,5,15,6,15,57,66,-9,51
Airdrieon,7076,6,11,11,14,47,59,-12,44
East Fife,7076,7,13,4,19,49,66,-17,43
Forfar,7076,8,10,5,21,39,66,-27,35
Albion,7076,9,8,6,22,59,81,-22,30
Queen's Park,7076,10,6,10,20,40,75,-35,28
Raith,7077,1,23,8,5,69,32,37,77
Ayr,7077,2,24,4,8,91,42,49,76
Arbroath,7077,3,17,9,10,71,49,22,60
Alloa,7077,4,17,8,11,56,44,12,59
Stranraer,7077,5,15,6,15,56,65,-9,51
Airdrieon,7077,6,11,11,14,49,58,-9,44
East Fife,7077,7,13,4,19,48,65,-17,43
Forfar,7077,8,10,5,21,38,68,-30,35
Albion,7077,9,8,6,22,57,79,-22,30
Queen's Park,7077,10,6,11,19,40,73,-33,29
Ayr,7078,1,24,4,8,93,43,50,76
Raith,7078,2,22,8,6,68,34,34,74
Arbroath,7078,3,18,8,10,74,48,26,62
Alloa,7078,4,18,8,10,58,43,15,62
Stranraer,7078,5,15,5,16,56,66,-10,50
East Fife,7078,6,14,3,19,49,65,-16,45
Airdrieon,7078,7,11,11,14,47,58,-11,44
Forfar,7078,8,10,5,21,38,66,-28,35
Albion,7078,9,8,6,22,58,81,-23,30
Queen's Park,7078,10,6,10,20,39,76,-37,28
Ayr,7079,1,24,4,8,95,45,50,76
Raith,7079,2,22,9,5,70,34,36,75
Arbroath,7079,3,18,8,10,71,48,23,62
Alloa,7079,4,17,9,10,58,45,13,60
Stranraer,7079,5,15,5,16,55,69,-14,50
East Fife,7079,6,14,3,19,52,64,-12,45
Airdrieon,7079,7,10,12,14,46,59,-13,42
Forfar,7079,8,10,6,20,39,65,-26,36
Albion,7079,9,8,6,22,60,83,-23,30
Queen's Park,7079,10,6,10,20,39,73,-34,28
Raith,7080,1,23,8,5,72,33,39,77
Ayr,7080,2,24,4,8,95,43,52,76
Arbroath,7080,3,17,8,11,70,52,18,59
Alloa,7080,4,17,8,11,57,47,10,59
Stranraer,7080,5,15,5,16,55,65,-10,50
East Fife,7080,6,14,3,19,48,64,-16,45
Airdrieon,7080,7,11,11,14,49,59,-10,44
Forfar,7080,8,10,5,21,39,68,-29,35
Queen's Park,7080,9,7,10,19,43,72,-29,31
Albion,7080,10,8,6,22,58,83,-25,30
Raith,7081,1,23,8,5,71,34,37,77
Ayr,7081,2,24,4,8,93,42,51,76
Arbroath,7081,3,17,8,11,71,50,21,59
Alloa,7081,4,17,8,11,58,46,12,59
Stranraer,7081,5,15,5,16,56,67,-11,50
East Fife,7081,6,14,3,19,50,65,-15,45
Airdrieon,7081,7,11,11,14,46,58,-12,44
Forfar,7081,8,10,5,21,38,65,-27,35
Queen's Park,7081,9,7,10,19,41,73,-32,31
Albion,7081,10,8,6,22,57,81,-24,30
Raith,7082,1,23,8,5,70,33,37,77
Ayr,7082,2,24,4,8,93,42,51,76
Arbroath,7082,3,18,8,10,71,48,23,62
Alloa,7082,4,17,8,11,57,45,12,59
Stranraer,7082,5,15,5,16,55,65,-10,50
East Fife,7082,6,14,3,19,48,64,-16,45
Airdrieon,7082,7,10,11,15,45,59,-14,41
Forfar,7082,8,11,5,20,39,64,-25,38
Albion,7082,9,8,6,22,57,81,-24,30
Queen's Park,7082,10,6,10,20,39,73,-34,28
Raith,7083,1,23,8,5,70,33,37,77
Ayr,7083,2,24,4,8,94,44,50,76
Arbroath,7083,3,17,8,11,71,50,21,59
Alloa,7083,4,17,8,11,57,45,12,59
Stranraer,7083,5,15,5,16,56,66,-10,50
East Fife,7083,6,14,3,19,49,65,-16,45
Airdrieon,7083,7,11,11,14,47,58,-11,44
Forfar,7083,8,10,5,21,38,66,-28,35
Queen's Park,7083,9,7,10,19,41,73,-32,31
Albion,7083,10,8,6,22,59,82,-23,30
Raith,7084,1,23,8,5,71,34,37,77
Ayr,7084,2,23,5,8,91,43,48,74
Arbroath,7084,3,18,8,10,72,49,23,62
Alloa,7084,4,17,8,11,58,46,12,59
Stranraer,7084,5,15,6,15,57,66,-9,51
East Fife,7084,6,13,4,19,49,66,-17,43
Airdrieon,7084,7,10,12,14,46,59,-13,42
Forfar,7084,8,10,6,20,39,65,-26,36
Albion,7084,9,8,7,21,58,79,-21,31
Queen's Park,7084,10,6,10,20,40,74,-34,28
Raith,7085,1,23,8,5,71,32,39,77
Ayr,7085,2,24,4,8,98,42,56,76
Arbroath,7085,3,17,9,10,71,49,22,60
Alloa,7085,4,17,8,11,56,46,10,59
Stranraer,7085,5,16,5,15,58,66,-8,53
Airdrieon,7085,6,10,12,14,45,58,-13,42
East Fife,7085,7,13,3,20,49,67,-18,42
Forfar,7085,8,10,6,20,38,64,-26,36
Albion,7085,9,8,6,22,57,86,-29,30
Queen's Park,7085,10,6,11,19,40,73,-33,29
Ayr,7086,1,24,4,8,97,44,53,76
Raith,7086,2,22,9,5,70,34,36,75
Arbroath,7086,3,17,9,10,71,49,22,60
Alloa,7086,4,17,9,10,58,45,13,60
Stranraer,7086,5,15,5,16,55,68,-13,50
East Fife,7086,6,14,3,19,51,64,-13,45
Airdrieon,7086,7,11,11,14,49,58,-9,44
Forfar,7086,8,10,5,21,38,68,-30,35
Albion,7086,9,8,6,22,59,85,-26,30
Queen's Park,7086,10,6,11,19,40,73,-33,29
Raith,7087,1,23,8,5,69,32,37,77
Ayr,7087,2,24,4,8,92,43,49,76
Arbroath,7087,3,17,8,11,71,50,21,59
Alloa,7087,4,17,8,11,56,44,12,59
Stranraer,7087,5,15,5,16,56,67,-11,50
East Fife,7087,6,14,3,19,50,65,-15,45
Airdrieon,7087,7,11,11,14,46,58,-12,44
Forfar,7087,8,10,5,21,38,65,-27,35
Queen's Park,7087,9,7,10,19,41,73,-32,31
Albion,7087,10,8,6,22,58,80,-22,30
Ayr,7088,1,24,4,8,95,43,52,76
Raith,7088,2,22,8,6,68,34,34,74
Alloa,7088,3,18,8,10,58,43,15,62
Arbroath,7088,4,17,9,10,71,49,22,60
Stranraer,7088,5,15,6,15,57,66,-9,51
Airdrieon,7088,6,11,11,14,49,58,-9,44
East Fife,7088,7,13,4,19,49,66,-17,43
Forfar,7088,8,10,5,21,38,68,-30,35
Albion,7088,9,8,6,22,58,83,-25,30
Queen's Park,7088,10,6,11,19,40,73,-33,29
Ayr,7089,1,24,4,8,94,44,50,76
Raith,7089,2,22,9,5,69,33,36,75
Alloa,7089,3,17,9,10,57,44,13,60
Arbroath,7089,4,17,8,11,71,53,18,59
Stranraer,7089,5,15,6,15,55,64,-9,51
East Fife,7089,6,13,4,19,47,64,-17,43
Airdrieon,7089,7,10,11,15,46,60,-14,41
Forfar,7089,8,11,5,20,40,65,-25,38
Queen's Park,7089,9,7,10,19,44,73,-29,31
Albion,7089,10,8,6,22,59,82,-23,30
Raith,7090,1,23,8,5,70,32,38,77
Ayr,7090,2,23,5,8,91,43,48,74
Arbroath,7090,3,18,8,10,74,49,25,62
Alloa,7090,4,17,8,11,56,45,11,59
Stranraer,7090,5,15,6,15,56,65,-9,51
East Fife,7090,6,13,4,19,48,65,-17,43
Airdrieon,7090,7,10,12,14,46,59,-13,42
Forfar,7090,8,10,6,20,39,65,-26,36
Albion,7090,9,8,7,21,58,79,-21,31
Queen's Park,7090,10,6,10,20,40,76,-36,28
Raith,7091,1,23,8,5,71,33,38,77
Ayr,7091,2,24,4,8,91,42,49,76
Arbroath,7091,3,17,8,11,72,52,20,59
Alloa,7091,4,17,8,11,57,46,11,59
Stranraer,7091,5,16,5,15,58,65,-7,53
East Fife,7091,6,13,3,20,48,67,-19,42
Airdrieon,7091,7,10,11,15,45,59,-14,41
Forfar,7091,8,11,5,20,39,64,-25,38
Queen's Park,7091,9,7,10,19,43,74,-31,31
Albion,7091,10,8,6,22,57,79,-22,30
Ayr,7092,1,24,4,8,96,46,50,76
Raith,7092,2,22,8,6,68,33,35,74
Arbroath,7092,3,18,8,10,72,49,23,62
Alloa,7092,4,18,8,10,57,43,14,62
Stranraer,7092,5,16,5,15,58,66,-8,53
East Fife,7092,6,13,3,20,49,67,-18,42
Airdrieon,7092,7,10,11,15,45,60,-15,41
Forfar,7092,8,11,5,20,40,64,-24,38
Albion,7092,9,8,6,22,61,84,-23,30
Queen's Park,7092,10,6,10,20,40,74,-34,28
Raith,7093,1,23,8,5,72,32,40,77
Ayr,7093,2,24,4,8,93,43,50,76
Arbroath,7093,3,18,8,10,73,48,25,62
Alloa,7093,4,17,8,11,56,47,9,59
Stranraer,7093,5,15,5,16,57,72,-15,50
East Fife,7093,6,14,3,19,55,66,-11,45
Airdrieon,7093,7,10,12,14,45,58,-13,42
Forfar,7093,8,10,6,20,38,64,-26,36
Albion,7093,9,8,6,22,58,81,-23,30
Queen's Park,7093,10,6,10,20,39,75,-36,28
Raith,7094,1,23,8,5,69,32,37,77
Ayr,7094,2,24,4,8,92,42,50,76
Arbroath,7094,3,17,8,11,71,51,20,59
Alloa,7094,4,17,8,11,56,44,12,59
Stranraer,7094,5,15,6,15,55,64,-9,51
Airdrieon,7094,6,11,11,14,48,59,-11,44
East Fife,7094,7,13,4,19,47,64,-17,43
Forfar,7094,8,10,5,21,39,67,-28,35
Queen's Park,7094,9,7,10,19,42,73,-31,31
Albion,7094,10,8,6,22,57,80,-23,30
Raith,7095,1,22,9,5,68,32,36,75
Ayr,7095,2,23,5,8,93,45,48,74
Arbroath,7095,3,18,8,10,72,49,23,62
Alloa,7095,4,17,9,10,56,43,13,60
Stranraer,7095,5,15,5,16,55,65,-10,50
East Fife,7095,6,14,3,19,48,64,-16,45
Airdrieon,7095,7,10,11,15,45,60,-15,41
Forfar,7095,8,11,5,20,40,64,-24,38
Albion,7095,9,8,7,21,60,81,-21,31
Queen's Park,7095,10,6,10,20,40,74,-34,28
Ayr,7096,1,24,4,8,92,42,50,76
Raith,7096,2,22,8,6,68,34,34,74
Alloa,7096,3,18,8,10,58,43,15,62
Arbroath,7096,4,17,8,11,72,51,21,59
Stranraer,7096,5,15,5,16,56,66,-10,50
East Fife,7096,6,14,3,19,49,65,-16,45
Airdrieon,7096,7,10,11,15,45,60,-15,41
Forfar,7096,8,11,5,20,40,64,-24,38
Queen's Park,7096,9,7,10,19,42,74,-32,31
Albion,7096,10,8,6,22,57,80,-23,30
Raith,7097,1,23,8,5,70,32,38,77
Ayr,7097,2,23,4,9,90,44,46,73
Arbroath,7097,3,17,9,10,71,49,22,60
Alloa,7097,4,17,8,11,56,45,11,59
Stranraer,7097,5,15,5,16,56,66,-10,50
East Fife,7097,6,14,3,19,49,65,-16,45
Airdrieon,7097,7,10,12,14,46,59,-13,42
Forfar,7097,8,10,6,20,39,65,-26,36
Albion,7097,9,9,6,21,59,78,-19,33
Queen's Park,7097,10,6,11,19,40,73,-33,29
Raith,7098,1,22,9,5,69,33,36,75
Ayr,7098,2,23,5,8,92,44,48,74
Arbroath,7098,3,18,8,10,72,49,23,62
Alloa,7098,4,17,9,10,57,44,13,60
Stranraer,7098,5,15,6,15,56,65,-9,51
Airdrieon,7098,6,11,11,14,46,58,-12,44
East Fife,7098,7,13,4,19,48,65,-17,43
Forfar,7098,8,10,5,21,38,65,-27,35
Albion,7098,9,8,7,21,59,80,-21,31
Queen's Park,7098,10,6,10,20,40,74,-34,28
Raith,7099,1,23,8,5,69,32,37,77
Ayr,7099,2,24,4,8,91,42,49,76
Arbroath,7099,3,18,8,10,72,49,23,62
Alloa,7099,4,17,8,11,56,44,12,59
Stranraer,7099,5,15,6,15,57,66,-9,51
Airdrieon,7099,6,11,11,14,46,58,-12,44
East Fife,7099,7,13,4,19,49,66,-17,43
Forfar,7099,8,10,5,21,38,65,-27,35
Albion,7099,9,8,6,22,57,79,-22,30
Queen's Park,7099,10,6,10,20,40,74,-34,28
Raith,7100,1,22,9,5,69,33,36,75
Ayr,7100,2,23,4,9,93,46,47,73
Arbroath,7100,3,18,8,10,73,48,25,62
Alloa,7100,4,17,9,10,57,44,13,60
Stranraer,7100,5,15,5,16,56,68,-12,50
East Fife,7100,6,14,3,19,51,65,-14,45
Airdrieon,7100,7,11,11,14,48,58,-10,44
Forfar,7100,8,10,5,21,38,67,-29,35
Albion,7100,9,9,6,21,61,81,-20,33
Queen's Park,7100,10,6,10,20,39,75,-36,28
Ayr,7101,1,24,4,8,93,43,50,76
Raith,7101,2,22,9,5,68,32,36,75
Arbroath,7101,3,18,8,10,73,50,23,62
Alloa,7101,4,17,9,10,56,43,13,60
Stranraer,7101,5,15,6,15,56,65,-9,51
East Fife,7101,6,13,4,19,48,65,-17,43
Airdrieon,7101,7,10,11,15,46,61,-15,41
Forfar,7101,8,11,5,20,41,65,-24,38
Albion,7101,9,8,6,22,58,81,-23,30
Queen's Park,7101,10,6,10,20,41,75,-34,28
Raith,7102,1,23,8,5,72,33,39,77
Ayr,7102,2,23,5,8,94,46,48,74
Arbroath,7102,3,17,8,11,72,51,21,59
Alloa,7102,4,17,8,11,57,47,10,59
Stranraer,7102,5,15,5,16,58,68,-10,50
East Fife,7102,6,14,3,19,51,67,-16,45
Airdrieon,7102,7,11,11,14,48,58,-10,44
Forfar,7102,8,10,5,21,38,67,-29,35
Albion,7102,9,8,7,21,61,82,-21,31
Queen's Park,7102,10,7,10,19,42,74,-32,31
Ayr,7103,1,24,4,8,92,43,49,76
Raith,7103,2,22,8,6,68,34,34,74
Arbroath,7103,3,18,8,10,72,49,23,62
Alloa,7103,4,18,8,10,58,43,15,62
Stranraer,7103,5,16,5,15,58,65,-7,53
Airdrieon,7103,6,11,11,14,50,59,-9,44
East Fife,7103,7,13,3,20,48,67,-19,42
Forfar,7103,8,10,5,21,39,69,-30,35
Albion,7103,9,8,6,22,58,80,-22,30
Queen's Park,7103,10,6,10,20,40,74,-34,28
Ayr,7104,1,24,4,8,94,43,51,76
Raith,7104,2,22,9,5,69,33,36,75
Arbroath,7104,3,17,9,10,73,51,22,60
Alloa,7104,4,17,9,10,57,44,13,60
Stranraer,7104,5,15,5,16,56,66,-10,50
East Fife,7104,6,14,3,19,49,65,-16,45
Airdrieon,7104,7,11,11,14,48,59,-11,44
Forfar,7104,8,10,5,21,39,67,-28,35
Albion,7104,9,8,6,22,58,82,-24,30
Queen's Park,7104,10,6,11,19,42,75,-33,29
Raith,7105,1,22,9,5,69,33,36,75
Ayr,7105,2,23,4,9,93,46,47,73
Arbroath,7105,3,17,9,10,71,49,22,60
Alloa,7105,4,17,9,10,57,44,13,60
Stranraer,7105,5,15,5,16,55,65,-10,50
East Fife,7105,6,14,3,19,48,64,-16,45
Airdrieon,7105,7,11,11,14,48,60,-12,44
Forfar,7105,8,10,5,21,40,67,-27,35
Albion,7105,9,9,6,21,61,81,-20,33
Queen's Park,7105,10,6,11,19,40,73,-33,29
Ayr,7106,1,24,4,8,93,44,49,76
Raith,7106,2,22,9,5,69,33,36,75
Arbroath,7106,3,18,8,10,74,50,24,62
Alloa,7106,4,17,9,10,57,44,13,60
Stranraer,7106,5,15,5,16,56,67,-11,50
East Fife,7106,6,14,3,19,50,65,-15,45
Airdrieon,7106,7,10,12,14,46,59,-13,42
Forfar,7106,8,10,6,20,39,65,-26,36
Albion,7106,9,8,6,22,59,81,-22,30
Queen's Park,7106,10,6,10,20,41,76,-35,28
Raith,7107,1,23,8,5,72,32,40,77
Ayr,7107,2,24,4,8,97,46,51,76
Arbroath,7107,3,17,9,10,70,48,22,60
Alloa,7107,4,17,8,11,56,47,9,59
Stranraer,7107,5,16,5,15,57,65,-8,53
Airdrieon,7107,6,11,11,14,46,58,-12,44
East Fife,7107,7,13,3,20,48,66,-18,42
Forfar,7107,8,10,5,21,38,65,-27,35
Albion,7107,9,8,6,22,61,85,-24,30
Queen's Park,7107,10,6,11,19,39,72,-33,29
Raith,7108,1,23,8,5,70,32,38,77
Ayr,7108,2,24,4,8,94,42,52,76
Arbroath,7108,3,18,8,10,73,49,24,62
Alloa,7108,4,17,8,11,56,45,11,59
Stranraer,7108,5,15,5,16,56,67,-11,50
East Fife,7108,6,14,3,19,50,65,-15,45
Airdrieon,7108,7,10,12,14,47,60,-13,42
Forfar,7108,8,10,6,20,40,66,-26,36
Albion,7108,9,8,6,22,57,82,-25,30
Queen's Park,7108,10,6,10,20,40,75,-35,28
Ayr,7109,1,24,4,8,93,42,51,76
Raith,7109,2,22,9,5,68,32,36,75
Arbroath,7109,3,17,9,10,72,50,22,60
Alloa,7109,4,17,9,10,56,43,13,60
Stranraer,7109,5,15,6,15,56,65,-9,51
East Fife,7109,6,13,4,19,48,65,-17,43
Airdrieon,7109,7,10,12,14,45,58,-13,42
Forfar,7109,8,10,6,20,38,64,-26,36
Albion,7109,9,8,6,22,57,81,-24,30
Queen's Park,7109,10,6,11,19,41,74,-33,29
Raith,7110,1,23,8,5,71,34,37,77
Ayr,7110,2,24,4,8,94,44,50,76
Arbroath,7110,3,17,8,11,70,49,21,59
Alloa,7110,4,17,8,11,58,46,12,59
Stranraer,7110,5,15,5,16,56,66,-10,50
East Fife,7110,6,14,3,19,49,65,-16,45
Airdrieon,7110,7,10,12,14,45,58,-13,42
Forfar,7110,8,10,6,20,38,64,-26,36
Queen's Park,7110,9,7,10,19,40,72,-32,31
Albion,7110,10,8,6,22,59,82,-23,30
Ayr,7111,1,24,4,8,91,42,49,76
Raith,7111,2,22,9,5,69,33,36,75
Alloa,7111,3,17,9,10,57,44,13,60
Arbroath,7111,4,17,8,11,73,52,21,59
Stranraer,7111,5,15,5,16,56,67,-11,50
East Fife,7111,6,14,3,19,50,65,-15,45
Airdrieon,7111,7,11,11,14,47,59,-12,44
Forfar,7111,8,10,5,21,39,66,-27,35
Queen's Park,7111,9,7,10,19,43,75,-32,31
Albion,7111,10,8,6,22,57,79,-22,30
Ayr,7112,1,24,4,8,95,45,50,76
Raith,7112,2,22,8,6,69,34,35,74
Alloa,7112,3,18,8,10,58,44,14,62
Arbroath,7112,4,17,9,10,72,50,22,60
Stranraer,7112,5,15,6,15,55,64,-9,51
Airdrieon,7112,6,11,11,14,48,58,-10,44
East Fife,7112,7,13,4,19,47,64,-17,43
Forfar,7112,8,10,5,21,38,67,-29,35
Albion,7112,9,8,6,22,60,83,-23,30
Queen's Park,7112,10,6,11,19,41,74,-33,29
Raith,7113,1,23,8,5,69,32,37,77
Ayr,7113,2,23,4,9,91,44,47,73
Arbroath,7113,3,18,8,10,71,48,23,62
Alloa,7113,4,17,8,11,56,44,12,59
Stranraer,7113,5,16,5,15,56,64,-8,53
Airdrieon,7113,6,11,11,14,47,59,-12,44
East Fife,7113,7,13,3,20,47,65,-18,42
Forfar,7113,8,10,5,21,39,66,-27,35
Albion,7113,9,9,6,21,59,79,-20,33
Queen's Park,7113,10,6,10,20,39,73,-34,28
Ayr,7114,1,24,4,8,93,44,49,76
Raith,7114,2,22,8,6,68,34,34,74
Alloa,7114,3,18,8,10,58,43,15,62
Arbroath,7114,4,17,8,11,71,50,21,59
Stranraer,7114,5,15,6,15,55,64,-9,51
Airdrieon,7114,6,11,11,14,47,58,-11,44
East Fife,7114,7,13,4,19,47,64,-17,43
Forfar,7114,8,10,5,21,38,66,-28,35
Queen's Park,7114,9,7,10,19,41,73,-32,31
Albion,7114,10,8,6,22,59,81,-22,30
Raith,7115,1,23,8,5,71,33,38,77
Ayr,7115,2,24,4,8,91,42,49,76
Arbroath,7115,3,17,9,10,70,48,22,60
Alloa,7115,4,17,8,11,57,46,11,59
Stranraer,7115,5,15,5,16,55,67,-12,50
East Fife,7115,6,14,3,19,50,64,-14,45
Airdrieon,7115,7,10,11,15,45,59,-14,41
Forfar,7115,8,11,5,20,39,64,-25,38
Albion,7115,9,8,6,22,57,79,-22,30
Queen's Park,7115,10,6,11,19,39,72,-33,29
Raith,7116,1,23,8,5,72,34,38,77
Ayr,7116,2,24,4,8,92,42,50,76
Arbroath,7116,3,18,8,10,76,48,28,62
Alloa,7116,4,17,8,11,58,47,11,59
Stranraer,7116,5,15,6,15,58,67,-9,51
Airdrieon,7116,6,11,11,14,47,58,-11,44
East Fife,7116,7,13,4,19,50,67,-17,43
Forfar,7116,8,10,5,21,38,66,-28,35
Albion,7116,9,8,6,22,57,80,-23,30
Queen's Park,7116,10,6,10,20,39,78,-39,28
Raith,7117,1,23,8,5,69,32,37,77
Ayr,7117,2,24,4,8,96,43,53,76
Arbroath,7117,3,17,9,10,71,49,22,60
Alloa,7117,4,17,8,11,56,44,12,59
Stranraer,7117,5,16,5,15,57,64,-7,53
Airdrieon,7117,6,10,12,14,46,59,-13,42
East Fife,7117,7,13,3,20,47,66,-19,42
Forfar,7117,8,10,6,20,39,65,-26,36
Albion,7117,9,8,6,22,58,84,-26,30
Queen's Park,7117,10,6,11,19,40,73,-33,29
Raith,7118,1,22,9,5,69,33,36,75
Ayr,7118,2,23,4,9,90,43,47,73
Arbroath,7118,3,17,9,10,71,49,22,60
Alloa,7118,4,17,9,10,57,44,13,60
Stranraer,7118,5,16,5,15,58,64,-6,53
Airdrieon,7118,6,10,12,14,46,59,-13,42
East Fife,7118,7,13,3,20,47,67,-20,42
Forfar,7118,8,10,6,20,39,65,-26,36
Albion,7118,9,9,6,21,58,78,-20,33
Queen's Park,7118,10,6,11,19,40,73,-33,29
Ayr,7119,1,24,4,8,96,42,54,76
Raith,7119,2,22,9,5,70,34,36,75
Arbroath,7119,3,18,8,10,74,51,23,62
Alloa,7119,4,17,9,10,58,45,13,60
Stranraer,7119,5,15,5,16,55,65,-10,50
East Fife,7119,6,14,3,19,48,64,-16,45
Airdrieon,7119,7,10,12,14,45,58,-13,42
Forfar,7119,8,10,6,20,38,64,-26,36
Albion,7119,9,8,6,22,57,84,-27,30
Queen's Park,7119,10,6,10,20,42,76,-34,28
Raith,7120,1,23,8,5,72,33,39,77
Ayr,7120,2,24,4,8,94,43,51,76
Arbroath,7120,3,17,8,11,72,51,21,59
Alloa,7120,4,17,8,11,57,47,10,59
Stranraer,7120,5,16,5,15,57,65,-8,53
East Fife,7120,6,13,3,20,48,66,-18,42
Airdrieon,7120,7,10,11,15,45,60,-15,41
Forfar,7120,8,11,5,20,40,64,-24,38
Queen's Park,7120,9,7,10,19,42,74,-32,31
Albion,7120,10,8,6,22,58,82,-24,30
Raith,7121,1,23,8,5,71,32,39,77
Ayr,7121,2,24,4,8,96,42,54,76
Arbroath,7121,3,17,8,11,71,51,20,59
Alloa,7121,4,17,8,11,56,46,10,59
Stranraer,7121,5,15,6,15,55,64,-9,51
East Fife,7121,6,13,4,19,47,64,-17,43
Airdrieon,7121,7,10,12,14,45,58,-13,42
Forfar,7121,8,10,6,20,38,64,-26,36
Queen's Park,7121,9,7,10,19,42,73,-31,31
Albion,7121,10,8,6,22,57,84,-27,30
Ayr,7122,1,24,4,8,95,43,52,76
Raith,7122,2,22,9,5,68,32,36,75
Arbroath,7122,3,17,9,10,70,48,22,60
Alloa,7122,4,17,9,10,56,43,13,60
Stranraer,7122,5,15,5,16,56,68,-12,50
East Fife,7122,6,14,3,19,51,65,-14,45
Airdrieon,7122,7,10,11,15,46,60,-14,41
Forfar,7122,8,11,5,20,40,65,-25,38
Albion,7122,9,8,6,22,58,83,-25,30
Queen's Park,7122,10,6,11,19,39,72,-33,29
Raith,7123,1,23,8,5,74,34,40,77
Ayr,7123,2,24,4,8,94,44,50,76
Arbroath,7123,3,17,9,10,71,49,22,60
Alloa,7123,4,17,8,11,58,49,9,59
Stranraer,7123,5,15,5,16,55,67,-12,50
East Fife,7123,6,14,3,19,50,64,-14,45
Airdrieon,7123,7,10,12,14,46,59,-13,42
Forfar,7123,8,10,6,20,39,65,-26,36
Albion,7123,9,8,6,22,59,82,-23,30
Queen's Park,7123,10,6,11,19,40,73,-33,29
Ayr,7124,1,24,4,8,95,43,52,76
Raith,7124,2,22,9,5,70,34,36,75
Arbroath,7124,3,18,8,10,74,51,23,62
Alloa,7124,4,17,9,10,58,45,13,60
Stranraer,7124,5,15,5,16,55,66,-11,50
East Fife,7124,6,14,3,19,49,64,-15,45
Airdrieon,7124,7,11,11,14,48,60,-12,44
Forfar,7124,8,10,5,21,40,67,-27,35
Albion,7124,9,8,6,22,58,83,-25,30
Queen's Park,7124,10,6,10,20,42,76,-34,28
Raith,7125,1,23,8,5,72,33,39,77
Ayr,7125,2,24,4,8,93,42,51,76
Arbroath,7125,3,18,8,10,73,48,25,62
Alloa,7125,4,17,8,11,57,47,10,59
Stranraer,7125,5,15,6,15,55,64,-9,51
East Fife,7125,6,13,4,19,47,64,-17,43
Airdrieon,7125,7,10,11,15,47,61,-14,41
Forfar,7125,8,11,5,20,41,66,-25,38
Albion,7125,9,8,6,22,57,81,-24,30
Queen's Park,7125,10,6,10,20,39,75,-36,28
Raith,7126,1,23,8,5,69,32,37,77
Ayr,7126,2,23,4,9,92,45,47,73
Arbroath,7126,3,18,8,10,72,48,24,62
Alloa,7126,4,17,8,11,56,44,12,59
Stranraer,7126,5,16,5,15,58,64,-6,53
Airdrieon,7126,6,10,12,14,46,59,-13,42
East Fife,7126,7,13,3,20,47,67,-20,42
Forfar,7126,8,10,6,20,39,65,-26,36
Albion,7126,9,9,6,21,60,80,-20,33
Queen's Park,7126,10,6,10,20,39,74,-35,28
Ayr,7127,1,24,4,8,94,44,50,76
Raith,7127,2,22,9,5,68,32,36,75
Arbroath,7127,3,18,8,10,74,51,23,62
Alloa,7127,4,17,9,10,56,43,13,60
Stranraer,7127,5,15,5,16,55,67,-12,50
East Fife,7127,6,14,3,19,50,64,-14,45
Airdrieon,7127,7,11,11,14,46,58,-12,44
Forfar,7127,8,10,5,21,38,65,-27,35
Albion,7127,9,8,6,22,59,82,-23,30
Queen's Park,7127,10,6,10,20,42,76,-34,28
Raith,7128,1,23,8,5,69,32,37,77
Ayr,7128,2,24,4,8,92,43,49,76
Arbroath,7128,3,18,8,10,72,49,23,62
Alloa,7128,4,17,8,11,56,44,12,59
Stranraer,7128,5,15,5,16,55,65,-10,50
East Fife,7128,6,14,3,19,48,64,-16,45
Airdrieon,7128,7,11,11,14,50,59,-9,44
Forfar,7128,8,10,5,21,39,69,-30,35
Albion,7128,9,8,6,22,58,80,-22,30
Queen's Park,7128,10,6,10,20,40,74,-34,28
Ayr,7129,1,24,4,8,94,44,50,76
Raith,7129,2,22,9,5,70,34,36,75
Arbroath,7129,3,18,8,10,71,48,23,62
Alloa,7129,4,17,9,10,58,45,13,60
Stranraer,7129,5,15,5,16,56,67,-11,50
East Fife,7129,6,14,3,19,50,65,-15,45
Airdrieon,7129,7,10,12,14,49,62,-13,42
Forfar,7129,8,10,6,20,42,68,-26,36
Albion,7129,9,8,6,22,59,82,-23,30
Queen's Park,7129,10,6,10,20,39,73,-34,28
Raith,7130,1,23,8,5,71,32,39,77
Ayr,7130,2,24,4,8,92,42,50,76
Arbroath,7130,3,18,8,10,73,50,23,62
Alloa,7130,4,17,8,11,56,46,10,59
Stranraer,7130,5,16,5,15,56,64,-8,53
Airdrieon,7130,6,11,11,14,48,60,-12,44
East Fife,7130,7,13,3,20,47,65,-18,42
Forfar,7130,8,10,5,21,40,67,-27,35
Albion,7130,9,8,6,22,57,80,-23,30
Queen's Park,7130,10,6,10,20,41,75,-34,28
Raith,7131,1,23,8,5,69,32,37,77
Ayr,7131,2,24,4,8,93,44,49,76
Arbroath,7131,3,18,8,10,72,48,24,62
Alloa,7131,4,17,8,11,56,44,12,59
Stranraer,7131,5,15,5,16,55,65,-10,50
East Fife,7131,6,14,3,19,48,64,-16,45
Airdrieon,7131,7,11,11,14,49,58,-9,44
Forfar,7131,8,10,5,21,38,68,-30,35
Albion,7131,9,8,6,22,59,81,-22,30
Queen's Park,7131,10,6,10,20,39,74,-35,28
Raith,7132,1,23,8,5,72,33,39,77
Ayr,7132,2,24,4,8,94,43,51,76
Arbroath,7132,3,17,9,10,71,49,22,60
Alloa,7132,4,17,8,11,57,47,10,59
Stranraer,7132,5,15,5,16,55,65,-10,50
East Fife,7132,6,14,3,19,48,64,-16,45
Airdrieon,7132,7,10,12,14,45,58,-13,42
Forfar,7132,8,10,6,20,38,64,-26,36
Albion,7132,9,8,6,22,58,82,-24,30
Queen's Park,7132,10,6,11,19,40,73,-33,29
Raith,7133,1,23,8,5,69,32,37,77
Ayr,7133,2,24,4,8,93,43,50,76
Arbroath,7133,3,17,8,11,71,50,21,59
Alloa,7133,4,17,8,11,56,44,12,59
Stranraer,7133,5,15,5,16,57,68,-11,50
East Fife,7133,6,14,3,19,51,66,-15,45
Airdrieon,7133,7,11,11,14,50,59,-9,44
Forfar,7133,8,10,5,21,39,69,-30,35
Queen's Park,7133,9,7,10,19,41,73,-32,31
Albion,7133,10,8,6,22,58,81,-23,30
Ayr,7134,1,24,4,8,94,43,51,76
Raith,7134,2,22,9,5,68,32,36,75
Arbroath,7134,3,17,9,10,72,50,22,60
Alloa,7134,4,17,9,10,56,43,13,60
Stranraer,7134,5,16,5,15,57,65,-8,53
Airdrieon,7134,6,11,11,14,49,58,-9,44
East Fife,7134,7,13,3,20,48,66,-18,42
Forfar,7134,8,10,5,21,38,68,-30,35
Albion,7134,9,8,6,22,58,82,-24,30
Queen's Park,7134,10,6,11,19,41,74,-33,29
Raith,7135,1,23,8,5,70,32,38,77
Ayr,7135,2,23,4,9,90,43,47,73
Arbroath,7135,3,17,8,11,70,53,17,59
Alloa,7135,4,17,8,11,56,45,11,59
Stranraer,7135,5,15,6,15,58,67,-9,51
Airdrieon,7135,6,11,11,14,47,59,-12,44
East Fife,7135,7,13,4,19,50,67,-17,43
Forfar,7135,8,10,5,21,39,66,-27,35
Albion,7135,9,9,6,21,58,78,-20,33
Queen's Park,7135,10,7,10,19,44,72,-28,31
Ayr,7136,1,24,4,8,98,44,54,76
Raith,7136,2,22,9,5,69,33,36,75
Arbroath,7136,3,18,8,10,72,49,23,62
Alloa,7136,4,17,9,10,57,44,13,60
Stranraer,7136,5,15,5,16,55,67,-12,50
East Fife,7136,6,14,3,19,50,64,-14,45
Airdrieon,7136,7,11,11,14,47,58,-11,44
Forfar,7136,8,10,5,21,38,66,-28,35
Albion,7136,9,8,6,22,59,86,-27,30
Queen's Park,7136,10,6,10,20,40,74,-34,28
Raith,7137,1,23,8,5,69,32,37,77
Ayr,7137,2,23,5,8,91,43,48,74
Arbroath,7137,3,18,8,10,71,48,23,62
Alloa,7137,4,17,8,11,56,44,12,59
Stranraer,7137,5,15,5,16,56,66,-10,50
East Fife,7137,6,14,3,19,49,65,-16,45
Airdrieon,7137,7,11,11,14,47,59,-12,44
Forfar,7137,8,10,5,21,39,66,-27,35
Albion,7137,9,8,7,21,58,79,-21,31
Queen's Park,7137,10,6,10,20,39,73,-34,28
Raith,7138,1,23,8,5,72,34,38,77
Ayr,7138,2,23,5,8,94,46,48,74
Arbroath,7138,3,18,8,10,72,49,23,62
Alloa,7138,4,17,8,11,58,47,11,59
Stranraer,7138,5,15,5,16,56,66,-10,50
East Fife,7138,6,14,3,19,49,65,-16,45
Airdrieon,7138,7,11,11,14,46,58,-12,44
Forfar,7138,8,10,5,21,38,65,-27,35
Albion,7138,9,8,7,21,61,82,-21,31
Queen's Park,7138,10,6,10,20,40,74,-34,28
Ayr,7139,1,24,4,8,92,43,49,76
Raith,7139,2,22,9,5,70,34,36,75
Arbroath,7139,3,18,8,10,74,49,25,62
Alloa,7139,4,17,9,10,58,45,13,60
Stranraer,7139,5,15,5,16,55,66,-11,50
East Fife,7139,6,14,3,19,49,64,-15,45
Airdrieon,7139,7,10,12,14,45,58,-13,42
Forfar,7139,8,10,6,20,38,64,-26,36
Albion,7139,9,8,6,22,58,80,-22,30
Queen's Park,7139,10,6,10,20,40,76,-36,28
Raith,7140,1,23,8,5,71,34,37,77
Ayr,7140,2,24,4,8,92,42,50,76
Arbroath,7140,3,18,8,10,71,48,23,62
Alloa,7140,4,17,8,11,58,46,12,59
Stranraer,7140,5,16,5,15,56,64,-8,53
East Fife,7140,6,13,3,20,47,65,-18,42
Airdrieon,7140,7,10,11,15,46,61,-15,41
Forfar,7140,8,11,5,20,41,65,-24,38
Albion,7140,9,8,6,22,57,80,-23,30
Queen's Park,7140,10,6,10,20,39,73,-34,28
Raith,7141,1,23,8,5,72,34,38,77
Ayr,7141,2,24,4,8,94,43,51,76
Arbroath,7141,3,17,9,10,71,49,22,60
Alloa,7141,4,17,8,11,58,47,11,59
Stranraer,7141,5,16,5,15,57,65,-8,53
Airdrieon,7141,6,11,11,14,48,58,-10,44
East Fife,7141,7,13,3,20,48,66,-18,42
Forfar,7141,8,10,5,21,38,67,-29,35
Albion,7141,9,8,6,22,58,82,-24,30
Queen's Park,7141,10,6,11,19,40,73,-33,29
Raith,7142,1,23,8,5,70,32,38,77
Ayr,7142,2,24,4,8,95,43,52,76
Arbroath,7142,3,17,8,11,70,50,20,59
Alloa,7142,4,17,8,11,56,45,11,59
Stranraer,7142,5,15,5,16,55,65,-10,50
East Fife,7142,6,14,3,19,48,64,-16,45
Airdrieon,7142,7,10,11,15,45,59,-14,41
Forfar,7142,8,11,5,20,39,64,-25,38
Queen's Park,7142,9,7,10,19,41,72,-31,31
Albion,7142,10,8,6,22,58,83,-25,30
Raith,7143,1,23,8,5,70,33,37,77
Ayr,7143,2,24,4,8,92,43,49,76
Arbroath,7143,3,18,8,10,72,48,24,62
Alloa,7143,4,17,8,11,57,45,12,59
Stranraer,7143,5,15,6,15,55,64,-9,51
East Fife,7143,6,13,4,19,47,64,-17,43
Airdrieon,7143,7,10,11,15,45,59,-14,41
Forfar,7143,8,11,5,20,39,64,-25,38
Albion,7143,9,8,6,22,58,80,-22,30
Queen's Park,7143,10,6,10,20,39,74,-35,28
Raith,7144,1,23,8,5,72,34,38,77
Ayr,7144,2,24,4,8,96,43,53,76
Arbroath,7144,3,18,8,10,74,50,24,62
Alloa,7144,4,17,8,11,58,47,11,59
Stranraer,7144,5,15,5,16,55,66,-11,50
East Fife,7144,6,14,3,19,49,64,-15,45
Airdrieon,7144,7,10,12,14,45,58,-13,42
Forfar,7144,8,10,6,20,38,64,-26,36
Albion,7144,9,8,6,22,58,84,-26,30
Queen's Park,7144,10,6,10,20,41,76,-35,28
Raith,7145,1,23,8,5,69,32,37,77
Ayr,7145,2,24,4,8,97,45,52,76
Arbroath,7145,3,18,8,10,73,50,23,62
Alloa,7145,4,17,8,11,56,44,12,59
Stranraer,7145,5,15,5,16,56,66,-10,50
East Fife,7145,6,14,3,19,49,65,-16,45
Airdrieon,7145,7,11,11,14,47,58,-11,44
Forfar,7145,8,10,5,21,38,66,-28,35
Albion,7145,9,8,6,22,60,85,-25,30
Queen's Park,7145,10,6,10,20,41,75,-34,28
Ayr,7146,1,24,4,8,92,43,49,76
Raith,7146,2,22,8,6,69,34,35,74
Arbroath,7146,3,18,8,10,73,49,24,62
Alloa,7146,4,18,8,10,58,44,14,62
Stranraer,7146,5,16,5,15,60,65,-5,53
Airdrieon,7146,6,11,11,14,47,59,-12,44
East Fife,7146,7,13,3,20,48,69,-21,42
Forfar,7146,8,10,5,21,39,66,-27,35
Albion,7146,9,8,6,22,58,80,-22,30
Queen's Park,7146,10,6,10,20,40,75,-35,28
Raith,7147,1,23,8,5,69,32,37,77
Ayr,7147,2,23,5,8,91,43,48,74
Arbroath,7147,3,17,8,11,70,50,20,59
Alloa,7147,4,17,8,11,56,44,12,59
Stranraer,7147,5,15,6,15,57,66,-9,51
East Fife,7147,6,13,4,19,49,66,-17,43
Airdrieon,7147,7,10,12,14,45,58,-13,42
Forfar,7147,8,10,6,20,38,64,-26,36
Albion,7147,9,8,7,21,58,79,-21,31
Queen's Park,7147,10,7,10,19,41,72,-31,31
Raith,7148,1,23,8,5,71,33,38,77
Ayr,7148,2,24,4,8,95,43,52,76
Arbroath,7148,3,17,8,11,71,50,21,59
Alloa,7148,4,17,8,11,57,46,11,59
Stranraer,7148,5,15,5,16,55,68,-13,50
East Fife,7148,6,14,3,19,51,64,-13,45
Airdrieon,7148,7,11,11,14,47,58,-11,44
Forfar,7148,8,10,5,21,38,66,-28,35
Queen's Park,7148,9,7,10,19,41,73,-32,31
Albion,7148,10,8,6,22,58,83,-25,30
Raith,7149,1,23,8,5,70,32,38,77
Ayr,7149,2,24,4,8,96,42,54,76
Arbroath,7149,3,17,9,10,71,49,22,60
Alloa,7149,4,17,8,11,56,45,11,59
Stranraer,7149,5,16,5,15,57,65,-8,53
Airdrieon,7149,6,10,12,14,46,59,-13,42
East Fife,7149,7,13,3,20,48,66,-18,42
Forfar,7149,8,10,6,20,39,65,-26,36
Albion,7149,9,8,6,22,57,84,-27,30
Queen's Park,7149,10,6,11,19,40,73,-33,29
Ayr,7150,1,24,4,8,93,43,50,76
Raith,7150,2,22,9,5,68,32,36,75
Arbroath,7150,3,18,8,10,74,48,26,62
Alloa,7150,4,17,9,10,56,43,13,60
Stranraer,7150,5,16,5,15,57,65,-8,53
Airdrieon,7150,6,10,12,14,46,59,-13,42
East Fife,7150,7,13,3,20,48,66,-18,42
Forfar,7150,8,10,6,20,39,65,-26,36
Albion,7150,9,8,6,22,58,81,-23,30
Queen's Park,7150,10,6,10,20,39,76,-37,28
Raith,7151,1,23,8,5,73,33,40,77
Ayr,7151,2,23,5,8,92,44,48,74
Arbroath,7151,3,18,8,10,71,48,23,62
Alloa,7151,4,17,8,11,57,48,9,59
Stranraer,7151,5,15,5,16,56,66,-10,50
East Fife,7151,6,14,3,19,49,65,-16,45
Airdrieon,7151,7,10,12,14,45,58,-13,42
Forfar,7151,8,10,6,20,38,64,-26,36
Albion,7151,9,8,7,21,59,80,-21,31
Queen's Park,7151,10,6,10,20,39,73,-34,28
Ayr,7152,1,24,4,8,93,43,50,76
Raith,7152,2,22,9,5,69,33,36,75
Arbroath,7152,3,17,9,10,71,49,22,60
Alloa,7152,4,17,9,10,57,44,13,60
Stranraer,7152,5,16,5,15,58,64,-6,53
Airdrieon,7152,6,11,11,14,47,58,-11,44
East Fife,7152,7,13,3,20,47,67,-20,42
Forfar,7152,8,10,5,21,38,66,-28,35
Albion,7152,9,8,6,22,58,81,-23,30
Queen's Park,7152,10,6,11,19,40,73,-33,29
Raith,7153,1,23,8,5,71,32,39,77
Ayr,7153,2,24,4,8,91,42,49,76
Arbroath,7153,3,18,8,10,73,48,25,62
Alloa,7153,4,17,8,11,56,46,10,59
Stranraer,7153,5,15,6,15,55,64,-9,51
East Fife,7153,6,13,4,19,47,64,-17,43
Airdrieon,7153,7,10,12,14,46,59,-13,42
Forfar,7153,8,10,6,20,39,65,-26,36
Albion,7153,9,8,6,22,57,79,-22,30
Queen's Park,7153,10,6,10,20,39,75,-36,28
Raith,7154,1,22,9,5,69,33,36,75
Ayr,7154,2,23,5,8,93,45,48,74
Alloa,7154,3,17,9,10,57,44,13,60
Arbroath,7154,4,17,8,11,71,52,19,59
Stranraer,7154,5,15,5,16,55,66,-11,50
East Fife,7154,6,14,3,19,49,64,-15,45
Airdrieon,7154,7,10,11,15,45,59,-14,41
Forfar,7154,8,11,5,20,39,64,-25,38
Albion,7154,9,8,7,21,60,81,-21,31
Queen's Park,7154,10,7,10,19,43,73,-30,31
Ayr,7155,1,24,4,8,93,43,50,76
Raith,7155,2,22,9,5,70,34,36,75
Alloa,7155,3,17,9,10,58,45,13,60
Arbroath,7155,4,17,8,11,71,51,20,59
Stranraer,7155,5,15,5,16,55,65,-10,50
East Fife,7155,6,14,3,19,48,64,-16,45
Airdrieon,7155,7,11,11,14,46,58,-12,44
Forfar,7155,8,10,5,21,38,65,-27,35
Queen's Park,7155,9,7,10,19,42,73,-31,31
Albion,7155,10,8,6,22,58,81,-23,30
Raith,7156,1,23,8,5,69,32,37,77
Ayr,7156,2,23,4,9,90,43,47,73
Arbroath,7156,3,17,8,11,72,52,20,59
Alloa,7156,4,17,8,11,56,44,12,59
Stranraer,7156,5,15,5,16,55,67,-12,50
East Fife,7156,6,14,3,19,50,64,-14,45
Airdrieon,7156,7,10,11,15,45,61,-16,41
Forfar,7156,8,11,5,20,41,64,-23,38
Albion,7156,9,9,6,21,58,78,-20,33
Queen's Park,7156,10,7,10,19,43,74,-31,31
Raith,7157,1,22,8,6,70,35,35,74
Ayr,7157,2,23,4,9,94,47,47,73
Alloa,7157,3,18,8,10,59,45,14,62
Arbroath,7157,4,17,8,11,72,51,21,59
Stranraer,7157,5,15,6,15,56,65,-9,51
Airdrieon,7157,6,11,11,14,46,58,-12,44
East Fife,7157,7,13,4,19,48,65,-17,43
Forfar,7157,8,10,5,21,38,65,-27,35
Albion,7157,9,9,6,21,62,82,-20,33
Queen's Park,7157,10,7,10,19,42,74,-32,31
Raith,7158,1,23,8,5,72,32,40,77
Ayr,7158,2,24,4,8,93,43,50,76
Arbroath,7158,3,17,8,11,71,50,21,59
Alloa,7158,4,17,8,11,56,47,9,59
Stranraer,7158,5,15,6,15,56,65,-9,51
East Fife,7158,6,13,4,19,48,65,-17,43
Airdrieon,7158,7,10,12,14,48,61,-13,42
Forfar,7158,8,10,6,20,41,67,-26,36
Queen's Park,7158,9,7,10,19,41,73,-32,31
Albion,7158,10,8,6,22,58,81,-23,30
Raith,7159,1,22,8,6,68,33,35,74
Ayr,7159,2,23,4,9,91,44,47,73
Arbroath,7159,3,18,8,10,72,49,23,62
Alloa,7159,4,18,8,10,57,43,14,62
Stranraer,7159,5,15,6,15,56,65,-9,51
East Fife,7159,6,13,4,19,48,65,-17,43
Airdrieon,7159,7,10,12,14,45,58,-13,42
Forfar,7159,8,10,6,20,38,64,-26,36
Albion,7159,9,9,6,21,59,79,-20,33
Queen's Park,7159,10,6,10,20,40,74,-34,28
Raith,7160,1,23,8,5,73,33,40,77
Ayr,7160,2,24,4,8,95,44,51,76
Arbroath,7160,3,18,8,10,73,49,24,62
Alloa,7160,4,17,8,11,57,48,9,59
Stranraer,7160,5,15,5,16,56,66,-10,50
East Fife,7160,6,14,3,19,49,65,-16,45
Airdrieon,7160,7,10,12,14,47,60,-13,42
Forfar,7160,8,10,6,20,40,66,-26,36
Albion,7160,9,8,6,22,59,83,-24,30
Queen's Park,7160,10,6,10,20,40,75,-35,28
Ayr,7161,1,23,5,8,94,46,48,74
Raith,7161,2,22,8,6,68,33,35,74
Arbroath,7161,3,18,8,10,72,48,24,62
Alloa,7161,4,18,8,10,57,43,14,62
Stranraer,7161,5,16,5,15,57,64,-7,53
Airdrieon,7161,6,11,11,14,46,58,-12,44
East Fife,7161,7,13,3,20,47,66,-19,42
Forfar,7161,8,10,5,21,38,65,-27,35
Albion,7161,9,8,7,21,61,82,-21,31
Queen's Park,7161,10,6,10,20,39,74,-35,28
Raith,7162,1,23,8,5,72,32,40,77
Ayr,7162,2,24,4,8,96,43,53,76
Arbroath,7162,3,17,9,10,70,48,22,60
Alloa,7162,4,17,8,11,56,47,9,59
Stranraer,7162,5,15,5,16,55,66,-11,50
East Fife,7162,6,14,3,19,49,64,-15,45
Airdrieon,7162,7,11,11,14,48,58,-10,44
Forfar,7162,8,10,5,21,38,67,-29,35
Albion,7162,9,8,6,22,58,84,-26,30
Queen's Park,7162,10,6,11,19,39,72,-33,29
Ayr,7163,1,24,4,8,91,42,49,76
Raith,7163,2,22,9,5,69,33,36,75
Arbroath,7163,3,18,8,10,73,48,25,62
Alloa,7163,4,17,9,10,57,44,13,60
Stranraer,7163,5,16,5,15,56,64,-8,53
Airdrieon,7163,6,11,11,14,50,58,-8,44
East Fife,7163,7,13,3,20,47,65,-18,42
Forfar,7163,8,10,5,21,38,69,-31,35
Albion,7163,9,8,6,22,57,79,-22,30
Queen's Park,7163,10,6,10,20,39,75,-36,28
Ayr,7164,1,24,4,8,96,42,54,76
Raith,7164,2,22,8,6,68,33,35,74
Alloa,7164,3,18,8,10,57,43,14,62
Arbroath,7164,4,17,9,10,71,49,22,60
Stranraer,7164,5,16,5,15,57,64,-7,53
East Fife,7164,6,13,3,20,47,66,-19,42
Airdrieon,7164,7,10,11,15,45,60,-15,41
Forfar,7164,8,11,5,20,40,64,-24,38
Albion,7164,9,8,6,22,57,84,-27,30
Queen's Park,7164,10,6,11,19,40,73,-33,29
Raith,7165,1,23,8,5,72,32,40,77
Ayr,7165,2,23,4,9,92,45,47,73
Arbroath,7165,3,17,9,10,70,48,22,60
Alloa,7165,4,17,8,11,56,47,9,59
Stranraer,7165,5,16,5,15,57,65,-8,53
East Fife,7165,6,13,3,20,48,66,-18,42
Airdrieon,7165,7,10,11,15,45,59,-14,41
Forfar,7165,8,11,5,20,39,64,-25,38
Albion,7165,9,9,6,21,60,80,-20,33
Queen's Park,7165,10,6,11,19,39,72,-33,29
Raith,7166,1,23,8,5,69,32,37,77
Ayr,7166,2,24,4,8,95,44,51,76
Arbroath,7166,3,17,9,10,72,50,22,60
Alloa,7166,4,17,8,11,56,44,12,59
Stranraer,7166,5,16,5,15,56,64,-8,53
East Fife,7166,6,13,3,20,47,65,-18,42
Airdrieon,7166,7,10,11,15,47,62,-15,41
Forfar,7166,8,11,5,20,42,66,-24,38
Albion,7166,9,8,6,22,59,83,-24,30
Queen's Park,7166,10,6,11,19,41,74,-33,29
Raith,7167,1,23,8,5,70,33,37,77
Ayr,7167,2,23,5,8,93,45,48,74
Arbroath,7167,3,18,8,10,72,48,24,62
Alloa,7167,4,17,8,11,57,45,12,59
Stranraer,7167,5,15,5,16,56,66,-10,50
East Fife,7167,6,14,3,19,49,65,-16,45
Airdrieon,7167,7,11,11,14,47,58,-11,44
Forfar,7167,8,10,5,21,38,66,-28,35
Albion,7167,9,8,7,21,60,81,-21,31
Queen's Park,7167,10,6,10,20,39,74,-35,28
Raith,7168,1,23,8,5,72,32,40,77
Ayr,7168,2,23,4,9,91,44,47,73
Arbroath,7168,3,18,8,10,71,48,23,62
Alloa,7168,4,17,8,11,56,47,9,59
Stranraer,7168,5,16,5,15,57,65,-8,53
Airdrieon,7168,6,11,11,14,47,58,-11,44
East Fife,7168,7,13,3,20,48,66,-18,42
Forfar,7168,8,10,5,21,38,66,-28,35
Albion,7168,9,9,6,21,59,79,-20,33
Queen's Park,7168,10,6,10,20,39,73,-34,28
Ayr,7169,1,23,5,8,93,45,48,74
Raith,7169,2,22,8,6,68,33,35,74
Alloa,7169,3,18,8,10,57,43,14,62
Arbroath,7169,4,17,8,11,72,51,21,59
Stranraer,7169,5,15,6,15,56,65,-9,51
East Fife,7169,6,13,4,19,48,65,-17,43
Airdrieon,7169,7,10,11,15,45,60,-15,41
Forfar,7169,8,11,5,20,40,64,-24,38
Albion,7169,9,8,7,21,60,81,-21,31
Queen's Park,7169,10,7,10,19,42,74,-32,31
Raith,7170,1,23,8,5,70,33,37,77
Ayr,7170,2,24,4,8,94,43,51,76
Arbroath,7170,3,17,9,10,72,50,22,60
Alloa,7170,4,17,8,11,57,45,12,59
Stranraer,7170,5,16,5,15,57,65,-8,53
Airdrieon,7170,6,11,11,14,47,59,-12,44
East Fife,7170,7,13,3,20,48,66,-18,42
Forfar,7170,8,10,5,21,39,66,-27,35
Albion,7170,9,8,6,22,58,82,-24,30
Queen's Park,7170,10,6,11,19,41,74,-33,29
Ayr,7171,1,24,4,8,95,43,52,76
Raith,7171,2,22,9,5,69,33,36,75
Arbroath,7171,3,18,8,10,74,49,25,62
Alloa,7171,4,17,9,10,57,44,13,60
Stranraer,7171,5,15,5,16,55,66,-11,50
East Fife,7171,6,14,3,19,49,64,-15,45
Airdrieon,7171,7,11,11,14,47,58,-11,44
Forfar,7171,8,10,5,21,38,66,-28,35
Albion,7171,9,8,6,22,58,83,-25,30
Queen's Park,7171,10,6,10,20,40,76,-36,28
Ayr,7172,1,24,4,8,96,42,54,76
Raith,7172,2,22,8,6,68,33,35,74
Arbroath,7172,3,18,8,10,73,50,23,62
Alloa,7172,4,18,8,10,57,43,14,62
Stranraer,7172,5,15,6,15,55,64,-9,51
Airdrieon,7172,6,11,11,14,47,59,-12,44
East Fife,7172,7,13,4,19,47,64,-17,43
Forfar,7172,8,10,5,21,39,66,-27,35
Albion,7172,9,8,6,22,57,84,-27,30
Queen's Park,7172,10,6,10,20,41,75,-34,28
Raith,7173,1,23,8,5,72,32,40,77
Ayr,7173,2,24,4,8,92,42,50,76
Arbroath,7173,3,18,8,10,73,48,25,62
Alloa,7173,4,17,8,11,56,47,9,59
Stranraer,7173,5,15,5,16,55,66,-11,50
East Fife,7173,6,14,3,19,49,64,-15,45
Airdrieon,7173,7,11,11,14,49,58,-9,44
Forfar,7173,8,10,5,21,38,68,-30,35
Albion,7173,9,8,6,22,57,80,-23,30
Queen's Park,7173,10,6,10,20,39,75,-36,28
Ayr,7174,1,24,4,8,95,44,51,76
Raith,7174,2,22,8,6,68,33,35,74
Alloa,7174,3,18,8,10,57,43,14,62
Arbroath,7174,4,17,8,11,71,51,20,59
Stranraer,7174,5,15,6,15,56,65,-9,51
Airdrieon,7174,6,11,11,14,47,58,-11,44
East Fife,7174,7,13,4,19,48,65,-17,43
Forfar,7174,8,10,5,21,38,66,-28,35
Queen's Park,7174,9,7,10,19,42,73,-31,31
Albion,7174,10,8,6,22,59,83,-24,30
Ayr,7175,1,24,4,8,97,45,52,76
Raith,7175,2,22,9,5,69,33,36,75
Arbroath,7175,3,17,9,10,70,48,22,60
Alloa,7175,4,17,9,10,57,44,13,60
Stranraer,7175,5,15,5,16,56,66,-10,50
East Fife,7175,6,14,3,19,49,65,-16,45
Airdrieon,7175,7,10,12,14,47,60,-13,42
Forfar,7175,8,10,6,20,40,66,-26,36
Albion,7175,9,8,6,22,60,85,-25,30
Queen's Park,7175,10,6,11,19,39,72,-33,29
Ayr,7176,1,24,4,8,93,43,50,76
Raith,7176,2,22,8,6,69,34,35,74
Alloa,7176,3,18,8,10,58,44,14,62
Arbroath,7176,4,17,8,11,72,51,21,59
Stranraer,7176,5,15,5,16,57,67,-10,50
East Fife,7176,6,14,3,19,50,66,-16,45
Airdrieon,7176,7,11,11,14,47,59,-12,44
Forfar,7176,8,10,5,21,39,66,-27,35
Queen's Park,7176,9,7,10,19,42,74,-32,31
Albion,7176,10,8,6,22,58,81,-23,30
Raith,7177,1,23,8,5,70,33,37,77
Ayr,7177,2,24,4,8,95,44,51,76
Arbroath,7177,3,17,8,11,71,50,21,59
Alloa,7177,4,17,8,11,57,45,12,59
Stranraer,7177,5,15,6,15,57,66,-9,51
Airdrieon,7177,6,11,11,14,47,59,-12,44
East Fife,7177,7,13,4,19,49,66,-17,43
Forfar,7177,8,10,5,21,39,66,-27,35
Queen's Park,7177,9,7,10,19,41,73,-32,31
Albion,7177,10,8,6,22,59,83,-24,30
Raith,7178,1,23,8,5,70,32,38,77
Ayr,7178,2,24,4,8,93,42,51,76
Arbroath,7178,3,17,8,11,70,49,21,59
Alloa,7178,4,17,8,11,56,45,11,59
Stranraer,7178,5,15,6,15,59,68,-9,51
Airdrieon,7178,6,11,11,14,46,58,-12,44
East Fife,7178,7,13,4,19,51,68,-17,43
Forfar,7178,8,10,5,21,38,65,-27,35
Queen's Park,7178,9,7,10,19,40,72,-32,31
Albion,7178,10,8,6,22,57,81,-24,30
Raith,7179,1,23,8,5,71,33,38,77
Ayr,7179,2,24,4,8,94,44,50,76
Arbroath,7179,3,17,8,11,71,51,20,59
Alloa,7179,4,17,8,11,57,46,11,59
Stranraer,7179,5,15,5,16,55,66,-11,50
East Fife,7179,6,14,3,19,49,64,-15,45
Airdrieon,7179,7,10,11,15,45,59,-14,41
Forfar,7179,8,11,5,20,39,64,-25,38
Queen's Park,7179,9,7,10,19,42,73,-31,31
Albion,7179,10,8,6,22,59,82,-23,30
Ayr,7180,1,24,4,8,94,42,52,76
Raith,7180,2,22,9,5,68,32,36,75
Alloa,7180,3,17,9,10,56,43,13,60
Arbroath,7180,4,17,8,11,70,49,21,59
Stranraer,7180,5,15,5,16,56,67,-11,50
East Fife,7180,6,14,3,19,50,65,-15,45
Airdrieon,7180,7,10,11,15,45,59,-14,41
Forfar,7180,8,11,5,20,39,64,-25,38
Queen's Park,7180,9,7,10,19,40,72,-32,31
Albion,7180,10,8,6,22,57,82,-25,30
Raith,7181,1,23,8,5,70,33,37,77
Ayr,7181,2,24,4,8,92,43,49,76
Arbroath,7181,3,17,9,10,72,50,22,60
Alloa,7181,4,17,8,11,57,45,12,59
Stranraer,7181,5,15,6,15,57,66,-9,51
Airdrieon,7181,6,11,11,14,46,58,-12,44
East Fife,7181,7,13,4,19,49,66,-17,43
Forfar,7181,8,10,5,21,38,65,-27,35
Albion,7181,9,8,6,22,58,80,-22,30
Queen's Park,7181,10,6,11,19,41,74,-33,29
Raith,7182,1,23,8,5,72,33,39,77
Ayr,7182,2,24,4,8,92,43,49,76
Arbroath,7182,3,17,8,11,71,51,20,59
Alloa,7182,4,17,8,11,57,47,10,59
Stranraer,7182,5,15,5,16,56,67,-11,50
East Fife,7182,6,14,3,19,50,65,-15,45
Airdrieon,7182,7,10,12,14,45,58,-13,42
Forfar,7182,8,10,6,20,38,64,-26,36
Queen's Park,7182,9,7,10,19,42,73,-31,31
Albion,7182,10,8,6,22,58,80,-22,30
Ayr,7183,1,24,4,8,95,44,51,76
Raith,7183,2,22,9,5,68,32,36,75
Alloa,7183,3,17,9,10,56,43,13,60
Arbroath,7183,4,17,8,11,70,51,19,59
Stranraer,7183,5,16,5,15,60,67,-7,53
Airdrieon,7183,6,11,11,14,49,59,-10,44
East Fife,7183,7,13,3,20,50,69,-19,42
Forfar,7183,8,10,5,21,39,68,-29,35
Queen's Park,7183,9,7,10,19,42,72,-30,31
Albion,7183,10,8,6,22,59,83,-24,30
Ayr,7184,1,24,4,8,93,43,50,76
Raith,7184,2,22,9,5,70,34,36,75
Arbroath,7184,3,18,8,10,73,48,25,62
Alloa,7184,4,17,9,10,58,45,13,60
Stranraer,7184,5,16,5,15,59,66,-7,53
Airdrieon,7184,6,11,11,14,47,58,-11,44
East Fife,7184,7,13,3,20,49,68,-19,42
Forfar,7184,8,10,5,21,38,66,-28,35
Albion,7184,9,8,6,22,58,81,-23,30
Queen's Park,7184,10,6,10,20,39,75,-36,28
Raith,7185,1,23,8,5,70,32,38,77
Ayr,7185,2,24,4,8,95,43,52,76
Arbroath,7185,3,17,8,11,71,51,20,59
Alloa,7185,4,17,8,11,56,45,11,59
Stranraer,7185,5,16,5,15,59,65,-6,53
East Fife,7185,6,13,3,20,48,68,-20,42
Airdrieon,7185,7,10,11,15,45,61,-16,41
Forfar,7185,8,11,5,20,41,64,-23,38
Queen's Park,7185,9,7,10,19,42,73,-31,31
Albion,7185,10,8,6,22,58,83,-25,30
Raith,7186,1,23,8,5,71,33,38,77
Ayr,7186,2,24,4,8,95,42,53,76
Arbroath,7186,3,18,8,10,71,48,23,62
Alloa,7186,4,17,8,11,57,46,11,59
Stranraer,7186,5,16,5,15,58,66,-8,53
Airdrieon,7186,6,10,12,14,47,60,-13,42
East Fife,7186,7,13,3,20,49,67,-18,42
Forfar,7186,8,10,6,20,40,66,-26,36
Albion,7186,9,8,6,22,57,83,-26,30
Queen's Park,7186,10,6,10,20,39,73,-34,28
Raith,7187,1,23,8,5,71,34,37,77
Ayr,7187,2,24,4,8,93,43,50,76
Arbroath,7187,3,18,8,10,74,48,26,62
Alloa,7187,4,17,8,11,58,46,12,59
Stranraer,7187,5,15,6,15,55,64,-9,51
Airdrieon,7187,6,11,11,14,47,59,-12,44
East Fife,7187,7,13,4,19,47,64,-17,43
Forfar,7187,8,10,5,21,39,66,-27,35
Albion,7187,9,8,6,22,58,81,-23,30
Queen's Park,7187,10,6,10,20,39,76,-37,28
Raith,7188,1,23,8,5,69,32,37,77
Ayr,7188,2,24,4,8,92,42,50,76
Arbroath,7188,3,18,8,10,74,51,23,62
Alloa,7188,4,17,8,11,56,44,12,59
Stranraer,7188,5,16,5,15,58,65,-7,53
Airdrieon,7188,6,11,11,14,48,59,-11,44
East Fife,7188,7,13,3,20,48,67,-19,42
Forfar,7188,8,10,5,21,39,67,-28,35
Albion,7188,9,8,6,22,57,80,-23,30
Queen's Park,7188,10,6,10,20,42,76,-34,28
Raith,7189,1,23,8,5,70,32,38,77
Ayr,7189,2,24,4,8,93,43,50,76
Arbroath,7189,3,17,9,10,71,49,22,60
Alloa,7189,4,17,8,11,56,45,11,59
Stranraer,7189,5,15,6,15,57,66,-9,51
Airdrieon,7189,6,11,11,14,48,58,-10,44
East Fife,7189,7,13,4,19,49,66,-17,43
Forfar,7189,8,10,5,21,38,67,-29,35
Albion,7189,9,8,6,22,58,81,-23,30
Queen's Park,7189,10,6,11,19,40,73,-33,29
Raith,7190,1,23,8,5,70,33,37,77
Ayr,7190,2,23,5,8,93,45,48,74
Arbroath,7190,3,18,8,10,74,48,26,62
Alloa,7190,4,17,8,11,57,45,12,59
Stranraer,7190,5,16,5,15,57,64,-7,53
Airdrieon,7190,6,10,12,14,45,58,-13,42
East Fife,7190,7,13,3,20,47,66,-19,42
Forfar,7190,8,10,6,20,38,64,-26,36
Albion,7190,9,8,7,21,60,81,-21,31
Queen's Park,7190,10,6,10,20,39,76,-37,28
Raith,7191,1,23,8,5,69,32,37,77
Ayr,7191,2,23,5,8,91,43,48,74
Arbroath,7191,3,17,9,10,72,50,22,60
Alloa,7191,4,17,8,11,56,44,12,59
Stranraer,7191,5,15,5,16,57,68,-11,50
East Fife,7191,6,14,3,19,51,66,-15,45
Airdrieon,7191,7,10,12,14,46,59,-13,42
Forfar,7191,8,10,6,20,39,65,-26,36
Albion,7191,9,8,7,21,58,79,-21,31
Queen's Park,7191,10,6,11,19,41,74,-33,29
Raith,7192,1,23,8,5,69,32,37,77
Ayr,7192,2,24,4,8,95,43,52,76
Arbroath,7192,3,18,8,10,72,49,23,62
Alloa,7192,4,17,8,11,56,44,12,59
Stranraer,7192,5,15,6,15,58,67,-9,51
Airdrieon,7192,6,11,11,14,50,60,-10,44
East Fife,7192,7,13,4,19,50,67,-17,43
Forfar,7192,8,10,5,21,40,69,-29,35
Albion,7192,9,8,6,22,58,83,-25,30
Queen's Park,7192,10,6,10,20,40,74,-34,28
Raith,7193,1,22,8,6,68,33,35,74
Ayr,7193,2,23,4,9,91,44,47,73
Arbroath,7193,3,18,8,10,74,48,26,62
Alloa,7193,4,18,8,10,57,43,14,62
Stranraer,7193,5,16,5,15,56,64,-8,53
East Fife,7193,6,13,3,20,47,65,-18,42
Airdrieon,7193,7,10,11,15,46,60,-14,41
Forfar,7193,8,11,5,20,40,65,-25,38
Albion,7193,9,9,6,21,59,79,-20,33
Queen's Park,7193,10,6,10,20,39,76,-37,28
Ayr,7194,1,24,4,8,93,43,50,76
Raith,7194,2,22,8,6,70,38,32,74
Alloa,7194,3,18,8,10,62,45,17,62
Arbroath,7194,4,17,9,10,72,50,22,60
Stranraer,7194,5,15,5,16,57,67,-10,50
East Fife,7194,6,14,3,19,50,66,-16,45
Airdrieon,7194,7,11,11,14,48,58,-10,44
Forfar,7194,8,10,5,21,38,67,-29,35
Albion,7194,9,8,6,22,58,81,-23,30
Queen's Park,7194,10,6,11,19,41,74,-33,29
Ayr,7195,1,24,4,8,92,42,50,76
Raith,7195,2,22,8,6,69,34,35,74
Arbroath,7195,3,18,8,10,71,48,23,62
Alloa,7195,4,18,8,10,58,44,14,62
Stranraer,7195,5,15,5,16,56,67,-11,50
East Fife,7195,6,14,3,19,50,65,-15,45
Airdrieon,7195,7,11,11,14,47,58,-11,44
Forfar,7195,8,10,5,21,38,66,-28,35
Albion,7195,9,8,6,22,57,80,-23,30
Queen's Park,7195,10,6,10,20,39,73,-34,28
Raith,7196,1,23,8,5,70,32,38,77
Ayr,7196,2,24,4,8,94,42,52,76
Arbroath,7196,3,18,8,10,72,48,24,62
Alloa,7196,4,17,8,11,56,45,11,59
Stranraer,7196,5,15,5,16,55,67,-12,50
East Fife,7196,6,14,3,19,50,64,-14,45
Airdrieon,7196,7,10,12,14,46,59,-13,42
Forfar,7196,8,10,6,20,39,65,-26,36
Albion,7196,9,8,6,22,57,82,-25,30
Queen's Park,7196,10,6,10,20,39,74,-35,28
Raith,7197,1,23,8,5,70,33,37,77
Ayr,7197,2,24,4,8,96,43,53,76
Arbroath,7197,3,18,8,10,72,48,24,62
Alloa,7197,4,17,8,11,57,45,12,59
Stranraer,7197,5,15,5,16,55,65,-10,50
East Fife,7197,6,14,3,19,48,64,-16,45
Airdrieon,7197,7,10,12,14,46,59,-13,42
Forfar,7197,8,10,6,20,39,65,-26,36
Albion,7197,9,8,6,22,58,84,-26,30
Queen's Park,7197,10,6,10,20,39,74,-35,28
Raith,7198,1,22,9,5,69,33,36,75
Ayr,7198,2,23,5,8,90,42,48,74
Arbroath,7198,3,18,8,10,73,49,24,62
Alloa,7198,4,17,9,10,57,44,13,60
Stranraer,7198,5,15,5,16,56,66,-10,50
East Fife,7198,6,14,3,19,49,65,-16,45
Airdrieon,7198,7,11,11,14,48,60,-12,44
Forfar,7198,8,10,5,21,40,67,-27,35
Albion,7198,9,8,7,21,57,78,-21,31
Queen's Park,7198,10,6,10,20,40,75,-35,28
Ayr,7199,1,24,4,8,94,43,51,76
Raith,7199,2,22,8,6,69,34,35,74
Alloa,7199,3,18,8,10,58,44,14,62
Arbroath,7199,4,17,9,10,71,49,22,60
Stranraer,7199,5,16,5,15,59,65,-6,53
Airdrieon,7199,6,11,11,14,46,58,-12,44
East Fife,7199,7,13,3,20,48,68,-20,42
Forfar,7199,8,10,5,21,38,65,-27,35
Albion,7199,9,8,6,22,58,82,-24,30
Queen's Park,7199,10,6,11,19,40,73,-33,29
Raith,7200,1,22,8,6,68,33,35,74
Ayr,7200,2,23,4,9,91,44,47,73
Alloa,7200,3,18,8,10,57,43,14,62
Arbroath,7200,4,17,9,10,70,48,22,60
Stranraer,7200,5,15,5,16,56,66,-10,50
East Fife,7200,6,14,3,19,49,65,-16,45
Airdrieon,7200,7,11,11,14,46,58,-12,44
Forfar,7200,8,10,5,21,38,65,-27,35
Albion,7200,9,9,6,21,59,79,-20,33
Queen's Park,7200,10,6,11,19,39,72,-33,29
Raith,7201,1,23,8,5,70,33,37,77
Ayr,7201,2,23,5,8,92,44,48,74
Arbroath,7201,3,17,8,11,70,50,20,59
Alloa,7201,4,17,8,11,57,45,12,59
Stranraer,7201,5,16,5,15,56,64,-8,53
Airdrieon,7201,6,11,11,14,47,59,-12,44
East Fife,7201,7,13,3,20,47,65,-18,42
Forfar,7201,8,10,5,21,39,66,-27,35
Albion,7201,9,8,7,21,59,80,-21,31
Queen's Park,7201,10,7,10,19,41,72,-31,31
Ayr,7202,1,24,4,8,92,42,50,76
Raith,7202,2,22,9,5,70,34,36,75
Arbroath,7202,3,18,8,10,71,48,23,62
Alloa,7202,4,17,9,10,58,45,13,60
Stranraer,7202,5,15,5,16,56,66,-10,50
East Fife,7202,6,14,3,19,49,65,-16,45
Airdrieon,7202,7,11,11,14,47,58,-11,44
Forfar,7202,8,10,5,21,38,66,-28,35
Albion,7202,9,8,6,22,57,80,-23,30
Queen's Park,7202,10,6,10,20,39,73,-34,28
Ayr,7203,1,24,4,8,92,43,49,76
Raith,7203,2,22,8,6,69,34,35,74
Alloa,7203,3,18,8,10,58,44,14,62
Arbroath,7203,4,17,8,11,70,50,20,59
Stranraer,7203,5,16,5,15,56,64,-8,53
Airdrieon,7203,6,10,12,14,45,58,-13,42
East Fife,7203,7,13,3,20,47,65,-18,42
Forfar,7203,8,10,6,20,38,64,-26,36
Queen's Park,7203,9,7,10,19,41,72,-31,31
Albion,7203,10,8,6,22,58,80,-22,30
Raith,7204,1,23,8,5,71,32,39,77
Ayr,7204,2,24,4,8,93,42,51,76
Arbroath,7204,3,17,8,11,72,51,21,59
Alloa,7204,4,17,8,11,56,46,10,59
Stranraer,7204,5,16,5,15,58,66,-8,53
Airdrieon,7204,6,11,11,14,46,58,-12,44
East Fife,7204,7,13,3,20,49,67,-18,42
Forfar,7204,8,10,5,21,38,65,-27,35
Queen's Park,7204,9,7,10,19,42,74,-32,31
Albion,7204,10,8,6,22,57,81,-24,30
Ayr,7205,1,24,4,8,96,43,53,76
Raith,7205,2,22,8,6,68,33,35,74
Alloa,7205,3,18,8,10,57,43,14,62
Arbroath,7205,4,17,9,10,72,50,22,60
Stranraer,7205,5,16,5,15,57,65,-8,53
Airdrieon,7205,6,10,12,14,46,59,-13,42
East Fife,7205,7,13,3,20,48,66,-18,42
Forfar,7205,8,10,6,20,39,65,-26,36
Albion,7205,9,8,6,22,58,84,-26,30
Queen's Park,7205,10,6,11,19,41,74,-33,29
Ayr,7206,1,24,4,8,99,46,53,76
Raith,7206,2,22,9,5,68,32,36,75
Alloa,7206,3,17,9,10,56,43,13,60
Arbroath,7206,4,17,8,11,71,50,21,59
Stranraer,7206,5,15,5,16,55,68,-13,50
East Fife,7206,6,14,3,19,51,64,-13,45
Airdrieon,7206,7,10,12,14,46,59,-13,42
Forfar,7206,8,10,6,20,39,65,-26,36
Queen's Park,7206,9,7,10,19,41,73,-32,31
Albion,7206,10,8,6,22,61,87,-26,30
Raith,7207,1,23,8,5,71,32,39,77
Ayr,7207,2,24,4,8,94,42,52,76
Arbroath,7207,3,18,8,10,72,48,24,62
Alloa,7207,4,17,8,11,56,46,10,59
Stranraer,7207,5,15,5,16,55,68,-13,50
East Fife,7207,6,14,3,19,51,64,-13,45
Airdrieon,7207,7,11,11,14,47,59,-12,44
Forfar,7207,8,10,5,21,39,66,-27,35
Albion,7207,9,8,6,22,57,82,-25,30
Queen's Park,7207,10,6,10,20,39,74,-35,28
Raith,7208,1,23,8,5,69,32,37,77
Ayr,7208,2,24,4,8,96,45,51,76
Arbroath,7208,3,18,8,10,76,49,27,62
Alloa,7208,4,17,8,11,56,44,12,59
Stranraer,7208,5,15,5,16,56,68,-12,50
East Fife,7208,6,14,3,19,51,65,-14,45
Airdrieon,7208,7,10,11,15,46,60,-14,41
Forfar,7208,8,11,5,20,40,65,-25,38
Albion,7208,9,8,6,22,60,84,-24,30
Queen's Park,7208,10,6,10,20,40,78,-38,28
Raith,7209,1,23,8,5,69,32,37,77
Ayr,7209,2,24,4,8,93,42,51,76
Arbroath,7209,3,17,8,11,71,50,21,59
Alloa,7209,4,17,8,11,56,44,12,59
Stranraer,7209,5,15,6,15,56,65,-9,51
Airdrieon,7209,6,11,11,14,48,58,-10,44
East Fife,7209,7,13,4,19,48,65,-17,43
Forfar,7209,8,10,5,21,38,67,-29,35
Queen's Park,7209,9,7,10,19,41,73,-32,31
Albion,7209,10,8,6,22,57,81,-24,30
Raith,7210,1,22,9,5,69,33,36,75
Ayr,7210,2,23,5,8,91,43,48,74
Arbroath,7210,3,17,9,10,71,49,22,60
Alloa,7210,4,17,9,10,57,44,13,60
Stranraer,7210,5,16,5,15,57,64,-7,53
Airdrieon,7210,6,11,11,14,46,58,-12,44
East Fife,7210,7,13,3,20,47,66,-19,42
Forfar,7210,8,10,5,21,38,65,-27,35
Albion,7210,9,8,7,21,58,79,-21,31
Queen's Park,7210,10,6,11,19,40,73,-33,29
Raith,7211,1,22,9,5,68,32,36,75
Ayr,7211,2,23,4,9,92,45,47,73
Alloa,7211,3,17,9,10,56,43,13,60
Arbroath,7211,4,17,8,11,70,50,20,59
Stranraer,7211,5,15,6,15,57,66,-9,51
Airdrieon,7211,6,11,11,14,48,59,-11,44
East Fife,7211,7,13,4,19,49,66,-17,43
Forfar,7211,8,10,5,21,39,67,-28,35
Albion,7211,9,9,6,21,60,80,-20,33
Queen's Park,7211,10,7,10,19,41,72,-31,31
Raith,7212,1,23,8,5,72,34,38,77
Ayr,7212,2,24,4,8,91,42,49,76
Arbroath,7212,3,17,9,10,72,50,22,60
Alloa,7212,4,17,8,11,58,47,11,59
Stranraer,7212,5,15,5,16,55,70,-15,50
East Fife,7212,6,14,3,19,53,64,-11,45
Airdrieon,7212,7,10,12,14,45,58,-13,42
Forfar,7212,8,10,6,20,38,64,-26,36
Albion,7212,9,8,6,22,57,79,-22,30
Queen's Park,7212,10,6,11,19,41,74,-33,29
Raith,7213,1,23,8,5,70,33,37,77
Ayr,7213,2,24,4,8,94,43,51,76
Arbroath,7213,3,18,8,10,71,48,23,62
Alloa,7213,4,17,8,11,57,45,12,59
Stranraer,7213,5,15,6,15,57,66,-9,51
Airdrieon,7213,6,11,11,14,48,60,-12,44
East Fife,7213,7,13,4,19,49,66,-17,43
Forfar,7213,8,10,5,21,40,67,-27,35
Albion,7213,9,8,6,22,58,82,-24,30
Queen's Park,7213,10,6,10,20,39,73,-34,28
Raith,7214,1,23,8,5,69,32,37,77
Ayr,7214,2,24,4,8,93,43,50,76
Arbroath,7214,3,17,8,11,72,53,19,59
Alloa,7214,4,17,8,11,56,44,12,59
Stranraer,7214,5,15,5,16,55,67,-12,50
East Fife,7214,6,14,3,19,50,64,-14,45
Airdrieon,7214,7,11,11,14,49,59,-10,44
Forfar,7214,8,10,5,21,39,68,-29,35
Queen's Park,7214,9,7,10,19,44,74,-30,31
Albion,7214,10,8,6,22,58,81,-23,30
Raith,7215,1,23,8,5,70,33,37,77
Ayr,7215,2,24,4,8,93,42,51,76
Arbroath,7215,3,17,8,11,71,50,21,59
Alloa,7215,4,17,8,11,57,45,12,59
Stranraer,7215,5,15,5,16,56,66,-10,50
East Fife,7215,6,14,3,19,49,65,-16,45
Airdrieon,7215,7,11,11,14,50,59,-9,44
Forfar,7215,8,10,5,21,39,69,-30,35
Queen's Park,7215,9,7,10,19,41,73,-32,31
Albion,7215,10,8,6,22,57,81,-24,30
Raith,7216,1,23,8,5,71,33,38,77
Ayr,7216,2,23,4,9,91,44,47,73
Arbroath,7216,3,18,8,10,73,50,23,62
Alloa,7216,4,17,8,11,57,46,11,59
Stranraer,7216,5,15,5,16,55,66,-11,50
East Fife,7216,6,14,3,19,49,64,-15,45
Airdrieon,7216,7,10,11,15,47,61,-14,41
Forfar,7216,8,11,5,20,41,66,-25,38
Albion,7216,9,9,6,21,59,79,-20,33
Queen's Park,7216,10,6,10,20,41,75,-34,28
Raith,7217,1,23,8,5,70,33,37,77
Ayr,7217,2,24,4,8,92,43,49,76
Arbroath,7217,3,18,8,10,72,49,23,62
Alloa,7217,4,17,8,11,57,45,12,59
Stranraer,7217,5,15,5,16,55,67,-12,50
East Fife,7217,6,14,3,19,50,64,-14,45
Airdrieon,7217,7,11,11,14,46,58,-12,44
Forfar,7217,8,10,5,21,38,65,-27,35
Albion,7217,9,8,6,22,58,80,-22,30
Queen's Park,7217,10,6,10,20,40,74,-34,28
Ayr,7218,1,24,4,8,93,44,49,76
Raith,7218,2,22,9,5,69,33,36,75
Arbroath,7218,3,17,9,10,71,49,22,60
Alloa,7218,4,17,9,10,57,44,13,60
Stranraer,7218,5,15,5,16,55,69,-14,50
East Fife,7218,6,14,3,19,52,64,-12,45
Airdrieon,7218,7,10,12,14,47,60,-13,42
Forfar,7218,8,10,6,20,40,66,-26,36
Albion,7218,9,8,6,22,59,81,-22,30
Queen's Park,7218,10,6,11,19,40,73,-33,29
Raith,7219,1,23,8,5,71,34,37,77
Ayr,7219,2,23,5,8,93,45,48,74
Arbroath,7219,3,17,9,10,71,49,22,60
Alloa,7219,4,17,8,11,58,46,12,59
Stranraer,7219,5,15,5,16,55,66,-11,50
East Fife,7219,6,14,3,19,49,64,-15,45
Airdrieon,7219,7,10,11,15,47,61,-14,41
Forfar,7219,8,11,5,20,41,66,-25,38
Albion,7219,9,8,7,21,60,81,-21,31
Queen's Park,7219,10,6,11,19,40,73,-33,29
Raith,7220,1,23,8,5,72,32,40,77
Ayr,7220,2,24,4,8,93,42,51,76
Arbroath,7220,3,18,8,10,74,49,25,62
Alloa,7220,4,17,8,11,56,47,9,59
Stranraer,7220,5,15,5,16,56,67,-11,50
East Fife,7220,6,14,3,19,50,65,-15,45
Airdrieon,7220,7,10,11,15,45,59,-14,41
Forfar,7220,8,11,5,20,39,64,-25,38
Albion,7220,9,8,6,22,57,81,-24,30
Queen's Park,7220,10,6,10,20,40,76,-36,28
Ayr,7221,1,24,4,8,92,43,49,76
Raith,7221,2,22,9,5,68,32,36,75
Alloa,7221,3,17,9,10,56,43,13,60
Arbroath,7221,4,17,8,11,71,51,20,59
Stranraer,7221,5,16,5,15,57,65,-8,53
East Fife,7221,6,13,3,20,48,66,-18,42
Airdrieon,7221,7,10,11,15,45,60,-15,41
Forfar,7221,8,11,5,20,40,64,-24,38
Queen's Park,7221,9,7,10,19,42,73,-31,31
Albion,7221,10,8,6,22,58,80,-22,30
Raith,7222,1,23,8,5,70,32,38,77
Ayr,7222,2,24,4,8,92,42,50,76
Arbroath,7222,3,17,8,11,70,49,21,59
Alloa,7222,4,17,8,11,56,45,11,59
Stranraer,7222,5,16,5,15,59,65,-6,53
Airdrieon,7222,6,11,11,14,48,58,-10,44
East Fife,7222,7,13,3,20,48,68,-20,42
Forfar,7222,8,10,5,21,38,67,-29,35
Queen's Park,7222,9,7,10,19,40,72,-32,31
Albion,7222,10,8,6,22,57,80,-23,30
Ayr,7223,1,24,4,8,94,44,50,76
Raith,7223,2,22,9,5,68,32,36,75
Arbroath,7223,3,18,8,10,74,49,25,62
Alloa,7223,4,17,9,10,56,43,13,60
Stranraer,7223,5,15,5,16,58,68,-10,50
East Fife,7223,6,14,3,19,51,67,-16,45
Airdrieon,7223,7,11,11,14,48,59,-11,44
Forfar,7223,8,10,5,21,39,67,-28,35
Albion,7223,9,8,6,22,59,82,-23,30
Queen's Park,7223,10,6,10,20,40,76,-36,28
Ayr,7224,1,24,4,8,93,43,50,76
Raith,7224,2,22,8,6,68,33,35,74
Alloa,7224,3,18,8,10,57,43,14,62
Arbroath,7224,4,17,8,11,71,50,21,59
Stranraer,7224,5,15,6,15,56,65,-9,51
East Fife,7224,6,13,4,19,48,65,-17,43
Airdrieon,7224,7,10,11,15,45,60,-15,41
Forfar,7224,8,11,5,20,40,64,-24,38
Queen's Park,7224,9,7,10,19,41,73,-32,31
Albion,7224,10,8,6,22,58,81,-23,30
Ayr,7225,1,24,4,8,95,45,50,76
Raith,7225,2,22,8,6,69,35,34,74
Alloa,7225,3,18,8,10,59,44,15,62
Arbroath,7225,4,17,8,11,72,51,21,59
Stranraer,7225,5,15,5,16,56,67,-11,50
East Fife,7225,6,14,3,19,50,65,-15,45
Airdrieon,7225,7,11,11,14,49,59,-10,44
Forfar,7225,8,10,5,21,39,68,-29,35
Queen's Park,7225,9,7,10,19,42,74,-32,31
Albion,7225,10,8,6,22,60,83,-23,30
Raith,7226,1,23,8,5,70,33,37,77
Ayr,7226,2,23,4,9,91,44,47,73
Arbroath,7226,3,18,8,10,72,48,24,62
Alloa,7226,4,17,8,11,57,45,12,59
Stranraer,7226,5,16,5,15,57,65,-8,53
Airdrieon,7226,6,11,11,14,48,59,-11,44
East Fife,7226,7,13,3,20,48,66,-18,42
Forfar,7226,8,10,5,21,39,67,-28,35
Albion,7226,9,9,6,21,59,79,-20,33
Queen's Park,7226,10,6,10,20,39,74,-35,28
Ayr,7227,1,24,4,8,94,45,49,76
Raith,7227,2,22,9,5,69,33,36,75
Arbroath,7227,3,18,8,10,73,49,24,62
Alloa,7227,4,17,9,10,57,44,13,60
Stranraer,7227,5,16,5,15,56,64,-8,53
Airdrieon,7227,6,11,11,14,46,58,-12,44
East Fife,7227,7,13,3,20,47,65,-18,42
Forfar,7227,8,10,5,21,38,65,-27,35
Albion,7227,9,8,6,22,60,82,-22,30
Queen's Park,7227,10,6,10,20,40,75,-35,28
Raith,7228,1,23,8,5,70,32,38,77
Ayr,7228,2,23,5,8,92,44,48,74
Arbroath,7228,3,18,8,10,73,48,25,62
Alloa,7228,4,17,8,11,56,45,11,59
Stranraer,7228,5,16,5,15,58,64,-6,53
Airdrieon,7228,6,10,12,14,45,58,-13,42
East Fife,7228,7,13,3,20,47,67,-20,42
Forfar,7228,8,10,6,20,38,64,-26,36
Albion,7228,9,8,7,21,59,80,-21,31
Queen's Park,7228,10,6,10,20,39,75,-36,28
Ayr,7229,1,24,4,8,96,43,53,76
Raith,7229,2,22,8,6,68,33,35,74
Alloa,7229,3,18,8,10,57,43,14,62
Arbroath,7229,4,17,9,10,72,50,22,60
Stranraer,7229,5,15,6,15,56,65,-9,51
Airdrieon,7229,6,11,11,14,47,59,-12,44
East Fife,7229,7,13,4,19,48,65,-17,43
Forfar,7229,8,10,5,21,39,66,-27,35
Albion,7229,9,8,6,22,58,84,-26,30
Queen's Park,7229,10,6,11,19,41,74,-33,29
Ayr,7230,1,24,4,8,95,43,52,76
Raith,7230,2,22,8,6,68,33,35,74
Arbroath,7230,3,18,8,10,73,48,25,62
Alloa,7230,4,18,8,10,57,43,14,62
Stranraer,7230,5,15,6,15,57,66,-9,51
Airdrieon,7230,6,11,11,14,48,59,-11,44
East Fife,7230,7,13,4,19,49,66,-17,43
Forfar,7230,8,10,5,21,39,67,-28,35
Albion,7230,9,8,6,22,58,83,-25,30
Queen's Park,7230,10,6,10,20,39,75,-36,28
Raith,7231,1,23,8,5,72,33,39,77
Ayr,7231,2,24,4,8,93,44,49,76
Arbroath,7231,3,17,9,10,71,49,22,60
Alloa,7231,4,17,8,11,57,47,10,59
Stranraer,7231,5,16,5,15,57,65,-8,53
Airdrieon,7231,6,10,12,14,45,58,-13,42
East Fife,7231,7,13,3,20,48,66,-18,42
Forfar,7231,8,10,6,20,38,64,-26,36
Albion,7231,9,8,6,22,59,81,-22,30
Queen's Park,7231,10,6,11,19,40,73,-33,29
Ayr,7232,1,24,4,8,96,45,51,76
Raith,7232,2,22,8,6,70,35,35,74
Alloa,7232,3,18,8,10,59,45,14,62
Arbroath,7232,4,17,8,11,72,53,19,59
Stranraer,7232,5,15,6,15,56,65,-9,51
Airdrieon,7232,6,11,11,14,47,58,-11,44
East Fife,7232,7,13,4,19,48,65,-17,43
Forfar,7232,8,10,5,21,38,66,-28,35
Queen's Park,7232,9,7,10,19,44,74,-30,31
Albion,7232,10,8,6,22,60,84,-24,30
Raith,7233,1,23,8,5,69,32,37,77
Ayr,7233,2,23,4,9,90,43,47,73
Arbroath,7233,3,17,9,10,71,49,22,60
Alloa,7233,4,17,8,11,56,44,12,59
Stranraer,7233,5,16,5,15,57,65,-8,53
Airdrieon,7233,6,11,11,14,48,59,-11,44
East Fife,7233,7,13,3,20,48,66,-18,42
Forfar,7233,8,10,5,21,39,67,-28,35
Albion,7233,9,9,6,21,58,78,-20,33
Queen's Park,7233,10,6,11,19,40,73,-33,29
Ayr,7234,1,24,4,8,93,43,50,76
Raith,7234,2,22,9,5,69,33,36,75
Arbroath,7234,3,18,8,10,75,51,24,62
Alloa,7234,4,17,9,10,57,44,13,60
Stranraer,7234,5,15,6,15,57,66,-9,51
Airdrieon,7234,6,11,11,14,47,58,-11,44
East Fife,7234,7,13,4,19,49,66,-17,43
Forfar,7234,8,10,5,21,38,66,-28,35
Albion,7234,9,8,6,22,58,81,-23,30
Queen's Park,7234,10,6,10,20,42,77,-35,28
Ayr,7235,1,24,4,8,93,42,51,76
Raith,7235,2,22,9,5,68,32,36,75
Arbroath,7235,3,18,8,10,71,48,23,62
Alloa,7235,4,17,9,10,56,43,13,60
Stranraer,7235,5,16,5,15,59,66,-7,53
Airdrieon,7235,6,11,11,14,49,58,-9,44
East Fife,7235,7,13,3,20,49,68,-19,42
Forfar,7235,8,10,5,21,38,68,-30,35
Albion,7235,9,8,6,22,57,81,-24,30
Queen's Park,7235,10,6,10,20,39,73,-34,28
Ayr,7236,1,24,4,8,92,43,49,76
Raith,7236,2,22,9,5,68,32,36,75
Arbroath,7236,3,17,9,10,73,51,22,60
Alloa,7236,4,17,9,10,56,43,13,60
Stranraer,7236,5,16,5,15,60,66,-6,53
Airdrieon,7236,6,11,11,14,48,59,-11,44
East Fife,7236,7,13,3,20,49,69,-20,42
Forfar,7236,8,10,5,21,39,67,-28,35
Albion,7236,9,8,6,22,58,80,-22,30
Queen's Park,7236,10,6,11,19,42,75,-33,29
Raith,7237,1,22,9,5,68,32,36,75
Ayr,7237,2,23,4,9,92,45,47,73
Arbroath,7237,3,18,8,10,74,48,26,62
Alloa,7237,4,17,9,10,56,43,13,60
Stranraer,7237,5,16,5,15,58,66,-8,53
Airdrieon,7237,6,10,12,14,46,59,-13,42
East Fife,7237,7,13,3,20,49,67,-18,42
Forfar,7237,8,10,6,20,39,65,-26,36
Albion,7237,9,9,6,21,60,80,-20,33
Queen's Park,7237,10,6,10,20,39,76,-37,28
Raith,7238,1,23,8,5,72,32,40,77
Ayr,7238,2,23,5,8,93,45,48,74
Arbroath,7238,3,17,9,10,72,50,22,60
Alloa,7238,4,17,8,11,56,47,9,59
Stranraer,7238,5,15,5,16,56,69,-13,50
East Fife,7238,6,14,3,19,52,65,-13,45
Airdrieon,7238,7,10,12,14,46,59,-13,42
Forfar,7238,8,10,6,20,39,65,-26,36
Albion,7238,9,8,7,21,60,81,-21,31
Queen's Park,7238,10,6,11,19,41,74,-33,29
Ayr,7239,1,24,4,8,92,42,50,76
Raith,7239,2,22,8,6,69,35,34,74
Arbroath,7239,3,18,8,10,73,49,24,62
Alloa,7239,4,18,8,10,59,44,15,62
Stranraer,7239,5,15,5,16,56,66,-10,50
East Fife,7239,6,14,3,19,49,65,-16,45
Airdrieon,7239,7,10,11,15,46,61,-15,41
Forfar,7239,8,11,5,20,41,65,-24,38
Albion,7239,9,8,6,22,57,80,-23,30
Queen's Park,7239,10,6,10,20,40,75,-35,28
Raith,7240,1,23,8,5,71,32,39,77
Ayr,7240,2,24,4,8,92,42,50,76
Arbroath,7240,3,17,8,11,72,51,21,59
Alloa,7240,4,17,8,11,56,46,10,59
Stranraer,7240,5,16,5,15,59,64,-5,53
Airdrieon,7240,6,11,11,14,49,58,-9,44
East Fife,7240,7,13,3,20,47,68,-21,42
Forfar,7240,8,10,5,21,38,68,-30,35
Queen's Park,7240,9,7,10,19,42,74,-32,31
Albion,7240,10,8,6,22,57,80,-23,30
Ayr,7241,1,24,4,8,98,43,55,76
Raith,7241,2,22,9,5,69,33,36,75
Alloa,7241,3,17,9,10,57,44,13,60
Arbroath,7241,4,17,8,11,74,53,21,59
Stranraer,7241,5,16,5,15,56,64,-8,53
Airdrieon,7241,6,11,11,14,47,59,-12,44
East Fife,7241,7,13,3,20,47,65,-18,42
Forfar,7241,8,10,5,21,39,66,-27,35
Queen's Park,7241,9,7,10,19,44,76,-32,31
Albion,7241,10,8,6,22,58,86,-28,30
Raith,7242,1,23,8,5,71,32,39,77
Ayr,7242,2,23,4,9,90,44,46,73
Arbroath,7242,3,18,8,10,71,48,23,62
Alloa,7242,4,17,8,11,56,46,10,59
Stranraer,7242,5,15,5,16,57,67,-10,50
East Fife,7242,6,14,3,19,50,66,-16,45
Airdrieon,7242,7,10,11,15,46,60,-14,41
Forfar,7242,8,11,5,20,40,65,-25,38
Albion,7242,9,9,6,21,59,78,-19,33
Queen's Park,7242,10,6,10,20,39,73,-34,28
Raith,7243,1,23,8,5,75,34,41,77
Ayr,7243,2,24,4,8,95,43,52,76
Arbroath,7243,3,17,9,10,70,48,22,60
Alloa,7243,4,17,8,11,58,50,8,59
Stranraer,7243,5,16,5,15,58,66,-8,53
East Fife,7243,6,13,3,20,49,67,-18,42
Airdrieon,7243,7,10,11,15,45,59,-14,41
Forfar,7243,8,11,5,20,39,64,-25,38
Albion,7243,9,8,6,22,58,83,-25,30
Queen's Park,7243,10,6,11,19,39,72,-33,29
Raith,7244,1,23,8,5,70,33,37,77
Ayr,7244,2,24,4,8,94,43,51,76
Arbroath,7244,3,17,8,11,71,50,21,59
Alloa,7244,4,17,8,11,57,45,12,59
Stranraer,7244,5,15,5,16,56,66,-10,50
East Fife,7244,6,14,3,19,49,65,-16,45
Airdrieon,7244,7,11,11,14,47,59,-12,44
Forfar,7244,8,10,5,21,39,66,-27,35
Queen's Park,7244,9,7,10,19,41,73,-32,31
Albion,7244,10,8,6,22,58,82,-24,30
Ayr,7245,1,23,5,8,91,43,48,74
Raith,7245,2,22,8,6,69,35,34,74
Arbroath,7245,3,18,8,10,71,48,23,62
Alloa,7245,4,18,8,10,59,44,15,62
Stranraer,7245,5,15,5,16,56,67,-11,50
East Fife,7245,6,14,3,19,50,65,-15,45
Airdrieon,7245,7,11,11,14,50,59,-9,44
Forfar,7245,8,10,5,21,39,69,-30,35
Albion,7245,9,8,7,21,58,79,-21,31
Queen's Park,7245,10,6,10,20,39,73,-34,28
Raith,7246,1,23,8,5,72,33,39,77
Ayr,7246,2,24,4,8,94,43,51,76
Arbroath,7246,3,17,9,10,71,49,22,60
Alloa,7246,4,17,8,11,57,47,10,59
Stranraer,7246,5,15,5,16,56,69,-13,50
East Fife,7246,6,14,3,19,52,65,-13,45
Airdrieon,7246,7,10,11,15,46,60,-14,41
Forfar,7246,8,11,5,20,40,65,-25,38
Albion,7246,9,8,6,22,58,82,-24,30
Queen's Park,7246,10,6,11,19,40,73,-33,29
Raith,7247,1,23,8,5,70,32,38,77
Ayr,7247,2,23,4,9,92,45,47,73
Arbroath,7247,3,18,8,10,73,49,24,62
Alloa,7247,4,17,8,11,56,45,11,59
Stranraer,7247,5,15,5,16,55,65,-10,50
East Fife,7247,6,14,3,19,48,64,-16,45
Airdrieon,7247,7,11,11,14,46,58,-12,44
Forfar,7247,8,10,5,21,38,65,-27,35
Albion,7247,9,9,6,21,60,80,-20,33
Queen's Park,7247,10,6,10,20,40,75,-35,28
Raith,7248,1,23,8,5,71,32,39,77
Ayr,7248,2,23,5,8,91,43,48,74
Arbroath,7248,3,17,9,10,73,51,22,60
Alloa,7248,4,17,8,11,56,46,10,59
Stranraer,7248,5,15,5,16,57,67,-10,50
East Fife,7248,6,14,3,19,50,66,-16,45
Airdrieon,7248,7,10,12,14,46,59,-13,42
Forfar,7248,8,10,6,20,39,65,-26,36
Albion,7248,9,8,7,21,58,79,-21,31
Queen's Park,7248,10,6,11,19,42,75,-33,29
Raith,7249,1,23,8,5,70,32,38,77
Ayr,7249,2,23,5,8,92,44,48,74
Arbroath,7249,3,18,8,10,72,49,23,62
Alloa,7249,4,17,8,11,56,45,11,59
Stranraer,7249,5,16,5,15,60,66,-6,53
East Fife,7249,6,13,3,20,49,69,-20,42
Airdrieon,7249,7,10,11,15,45,59,-14,41
Forfar,7249,8,11,5,20,39,64,-25,38
Albion,7249,9,8,7,21,59,80,-21,31
Queen's Park,7249,10,6,10,20,40,74,-34,28
Ayr,7250,1,24,4,8,93,42,51,76
Raith,7250,2,22,8,6,68,33,35,74
Alloa,7250,3,18,8,10,57,43,14,62
Arbroath,7250,4,17,8,11,72,51,21,59
Stranraer,7250,5,15,5,16,56,66,-10,50
East Fife,7250,6,14,3,19,49,65,-16,45
Airdrieon,7250,7,11,11,14,48,59,-11,44
Forfar,7250,8,10,5,21,39,67,-28,35
Queen's Park,7250,9,7,10,19,42,74,-32,31
Albion,7250,10,8,6,22,57,81,-24,30
Raith,7251,1,23,8,5,69,32,37,77
Ayr,7251,2,24,4,8,95,42,53,76
Arbroath,7251,3,17,8,11,70,50,20,59
Alloa,7251,4,17,8,11,56,44,12,59
Stranraer,7251,5,15,5,16,57,67,-10,50
East Fife,7251,6,14,3,19,50,66,-16,45
Airdrieon,7251,7,10,11,15,46,60,-14,41
Forfar,7251,8,11,5,20,40,65,-25,38
Queen's Park,7251,9,7,10,19,41,72,-31,31
Albion,7251,10,8,6,22,57,83,-26,30
Ayr,7252,1,24,4,8,92,42,50,76
Raith,7252,2,22,9,5,69,33,36,75
Arbroath,7252,3,18,8,10,74,48,26,62
Alloa,7252,4,17,9,10,57,44,13,60
Stranraer,7252,5,15,6,15,55,64,-9,51
East Fife,7252,6,13,4,19,47,64,-17,43
Airdrieon,7252,7,10,11,15,45,59,-14,41
Forfar,7252,8,11,5,20,39,64,-25,38
Albion,7252,9,8,6,22,57,80,-23,30
Queen's Park,7252,10,6,10,20,39,76,-37,28
Raith,7253,1,23,8,5,70,32,38,77
Ayr,7253,2,24,4,8,93,42,51,76
Arbroath,7253,3,18,8,10,74,49,25,62
Alloa,7253,4,17,8,11,56,45,11,59
Stranraer,7253,5,15,5,16,56,66,-10,50
East Fife,7253,6,14,3,19,49,65,-16,45
Airdrieon,7253,7,11,11,14,49,61,-12,44
Forfar,7253,8,10,5,21,41,68,-27,35
Albion,7253,9,8,6,22,57,81,-24,30
Queen's Park,7253,10,6,10,20,40,76,-36,28
Ayr,7254,1,24,4,8,94,42,52,76
Raith,7254,2,22,9,5,69,33,36,75
Arbroath,7254,3,17,9,10,72,50,22,60
Alloa,7254,4,17,9,10,57,44,13,60
Stranraer,7254,5,15,6,15,56,65,-9,51
Airdrieon,7254,6,11,11,14,47,58,-11,44
East Fife,7254,7,13,4,19,48,65,-17,43
Forfar,7254,8,10,5,21,38,66,-28,35
Albion,7254,9,8,6,22,57,82,-25,30
Queen's Park,7254,10,6,11,19,41,74,-33,29
Ayr,7255,1,23,5,8,90,42,48,74
Raith,7255,2,22,8,6,69,35,34,74
Arbroath,7255,3,18,8,10,75,49,26,62
Alloa,7255,4,18,8,10,59,44,15,62
Stranraer,7255,5,15,5,16,56,66,-10,50
East Fife,7255,6,14,3,19,49,65,-16,45
Airdrieon,7255,7,11,11,14,46,58,-12,44
Forfar,7255,8,10,5,21,38,65,-27,35
Albion,7255,9,8,7,21,57,78,-21,31
Queen's Park,7255,10,6,10,20,40,77,-37,28
Raith,7256,1,23,8,5,71,32,39,77
Ayr,7256,2,24,4,8,95,43,52,76
Arbroath,7256,3,17,8,11,70,50,20,59
Alloa,7256,4,17,8,11,56,46,10,59
Stranraer,7256,5,15,6,15,56,65,-9,51
Airdrieon,7256,6,11,11,14,46,58,-12,44
East Fife,7256,7,13,4,19,48,65,-17,43
Forfar,7256,8,10,5,21,38,65,-27,35
Queen's Park,7256,9,7,10,19,41,72,-31,31
Albion,7256,10,8,6,22,58,83,-25,30
Ayr,7257,1,24,4,8,98,45,53,76
Raith,7257,2,22,8,6,69,34,35,74
Arbroath,7257,3,18,8,10,72,49,23,62
Alloa,7257,4,18,8,10,58,44,14,62
Stranraer,7257,5,16,5,15,57,65,-8,53
Airdrieon,7257,6,10,12,14,46,59,-13,42
East Fife,7257,7,13,3,20,48,66,-18,42
Forfar,7257,8,10,6,20,39,65,-26,36
Albion,7257,9,8,6,22,60,86,-26,30
Queen's Park,7257,10,6,10,20,40,74,-34,28
Ayr,7258,1,24,4,8,94,44,50,76
Raith,7258,2,22,8,6,68,33,35,74
Alloa,7258,3,18,8,10,57,43,14,62
Arbroath,7258,4,17,8,11,70,49,21,59
Stranraer,7258,5,16,5,15,58,65,-7,53
Airdrieon,7258,6,10,12,14,47,60,-13,42
East Fife,7258,7,13,3,20,48,67,-19,42
Forfar,7258,8,10,6,20,40,66,-26,36
Queen's Park,7258,9,7,10,19,40,72,-32,31
Albion,7258,10,8,6,22,59,82,-23,30
Raith,7259,1,23,8,5,70,33,37,77
Ayr,7259,2,24,4,8,94,42,52,76
Arbroath,7259,3,17,9,10,72,50,22,60
Alloa,7259,4,17,8,11,57,45,12,59
Stranraer,7259,5,15,5,16,57,67,-10,50
East Fife,7259,6,14,3,19,50,66,-16,45
Airdrieon,7259,7,11,11,14,49,60,-11,44
Forfar,7259,8,10,5,21,40,68,-28,35
Albion,7259,9,8,6,22,57,82,-25,30
Queen's Park,7259,10,6,11,19,41,74,-33,29
Ayr,7260,1,24,4,8,94,45,49,76
Raith,7260,2,22,8,6,68,33,35,74
Arbroath,7260,3,18,8,10,71,48,23,62
Alloa,7260,4,18,8,10,57,43,14,62
Stranraer,7260,5,16,5,15,57,65,-8,53
East Fife,7260,6,13,3,20,48,66,-18,42
Airdrieon,7260,7,10,11,15,48,63,-15,41
Forfar,7260,8,11,5,20,43,67,-24,38
Albion,7260,9,8,6,22,60,82,-22,30
Queen's Park,7260,10,6,10,20,39,73,-34,28
Raith,7261,1,23,8,5,71,32,39,77
Ayr,7261,2,24,4,8,94,45,49,76
Arbroath,7261,3,17,9,10,71,49,22,60
Alloa,7261,4,17,8,11,56,46,10,59
Stranraer,7261,5,15,5,16,55,65,-10,50
East Fife,7261,6,14,3,19,48,64,-16,45
Airdrieon,7261,7,11,11,14,48,59,-11,44
Forfar,7261,8,10,5,21,39,67,-28,35
Albion,7261,9,8,6,22,60,82,-22,30
Queen's Park,7261,10,6,11,19,40,73,-33,29
Raith,7262,1,23,8,5,69,32,37,77
Ayr,7262,2,24,4,8,93,43,50,76
Arbroath,7262,3,17,8,11,70,49,21,59
Alloa,7262,4,17,8,11,56,44,12,59
Stranraer,7262,5,16,5,15,58,66,-8,53
Airdrieon,7262,6,11,11,14,48,59,-11,44
East Fife,7262,7,13,3,20,49,67,-18,42
Forfar,7262,8,10,5,21,39,67,-28,35
Queen's Park,7262,9,7,10,19,40,72,-32,31
Albion,7262,10,8,6,22,58,81,-23,30
Ayr,7263,1,24,4,8,93,44,49,76
Raith,7263,2,22,9,5,69,33,36,75
Alloa,7263,3,17,9,10,57,44,13,60
Arbroath,7263,4,17,8,11,71,50,21,59
Stranraer,7263,5,15,6,15,57,66,-9,51
Airdrieon,7263,6,11,11,14,46,58,-12,44
East Fife,7263,7,13,4,19,49,66,-17,43
Forfar,7263,8,10,5,21,38,65,-27,35
Queen's Park,7263,9,7,10,19,41,73,-32,31
Albion,7263,10,8,6,22,59,81,-22,30
Ayr,7264,1,24,4,8,96,42,54,76
Raith,7264,2,22,8,6,68,33,35,74
Alloa,7264,3,18,8,10,57,43,14,62
Arbroath,7264,4,17,8,11,71,52,19,59
Stranraer,7264,5,15,5,16,56,67,-11,50
East Fife,7264,6,14,3,19,50,65,-15,45
Airdrieon,7264,7,11,11,14,47,59,-12,44
Forfar,7264,8,10,5,21,39,66,-27,35
Queen's Park,7264,9,7,10,19,43,73,-30,31
Albion,7264,10,8,6,22,57,84,-27,30
Raith,7265,1,23,8,5,70,33,37,77
Ayr,7265,2,23,4,9,91,46,45,73
Arbroath,7265,3,18,8,10,73,49,24,62
Alloa,7265,4,17,8,11,57,45,12,59
Stranraer,7265,5,16,5,15,57,65,-8,53
Airdrieon,7265,6,11,11,14,49,58,-9,44
East Fife,7265,7,13,3,20,48,66,-18,42
Forfar,7265,8,10,5,21,38,68,-30,35
Albion,7265,9,9,6,21,61,79,-18,33
Queen's Park,7265,10,6,10,20,40,75,-35,28
Raith,7266,1,23,8,5,71,32,39,77
Ayr,7266,2,24,4,8,92,42,50,76
Arbroath,7266,3,18,8,10,73,49,24,62
Alloa,7266,4,17,8,11,56,46,10,59
Stranraer,7266,5,15,5,16,57,67,-10,50
East Fife,7266,6,14,3,19,50,66,-16,45
Airdrieon,7266,7,11,11,14,47,58,-11,44
Forfar,7266,8,10,5,21,38,66,-28,35
Albion,7266,9,8,6,22,57,80,-23,30
Queen's Park,7266,10,6,10,20,40,75,-35,28
Raith,7267,1,23,8,5,69,32,37,77
Ayr,7267,2,24,4,8,93,42,51,76
Arbroath,7267,3,18,8,10,73,49,24,62
Alloa,7267,4,17,8,11,56,44,12,59
Stranraer,7267,5,15,5,16,56,68,-12,50
East Fife,7267,6,14,3,19,51,65,-14,45
Airdrieon,7267,7,11,11,14,47,59,-12,44
Forfar,7267,8,10,5,21,39,66,-27,35
Albion,7267,9,8,6,22,57,81,-24,30
Queen's Park,7267,10,6,10,20,40,75,-35,28
Raith,7268,1,23,8,5,70,33,37,77
Ayr,7268,2,24,4,8,98,43,55,76
Arbroath,7268,3,17,9,10,73,51,22,60
Alloa,7268,4,17,8,11,57,45,12,59
Stranraer,7268,5,15,6,15,55,64,-9,51
East Fife,7268,6,13,4,19,47,64,-17,43
Airdrieon,7268,7,10,11,15,45,60,-15,41
Forfar,7268,8,11,5,20,40,64,-24,38
Albion,7268,9,8,6,22,58,86,-28,30
Queen's Park,7268,10,6,11,19,42,75,-33,29
Ayr,7269,1,23,5,8,91,43,48,74
Raith,7269,2,22,8,6,69,34,35,74
Alloa,7269,3,18,8,10,58,44,14,62
Arbroath,7269,4,17,8,11,71,50,21,59
Stranraer,7269,5,16,5,15,57,65,-8,53
Airdrieon,7269,6,10,12,14,46,59,-13,42
East Fife,7269,7,13,3,20,48,66,-18,42
Forfar,7269,8,10,6,20,39,65,-26,36
Albion,7269,9,8,7,21,58,79,-21,31
Queen's Park,7269,10,7,10,19,41,73,-32,31
Raith,7270,1,22,9,5,70,34,36,75
Ayr,7270,2,23,5,8,92,44,48,74
Arbroath,7270,3,17,9,10,70,48,22,60
Alloa,7270,4,17,9,10,58,45,13,60
Stranraer,7270,5,15,5,16,55,66,-11,50
East Fife,7270,6,14,3,19,49,64,-15,45
Airdrieon,7270,7,10,12,14,46,59,-13,42
Forfar,7270,8,10,6,20,39,65,-26,36
Albion,7270,9,8,7,21,59,80,-21,31
Queen's Park,7270,10,6,11,19,39,72,-33,29
Ayr,7271,1,24,4,8,97,44,53,76
Raith,7271,2,22,9,5,69,33,36,75
Arbroath,7271,3,17,9,10,71,49,22,60
Alloa,7271,4,17,9,10,57,44,13,60
Stranraer,7271,5,16,5,15,57,65,-8,53
Airdrieon,7271,6,11,11,14,47,59,-12,44
East Fife,7271,7,13,3,20,48,66,-18,42
Forfar,7271,8,10,5,21,39,66,-27,35
Albion,7271,9,8,6,22,59,85,-26,30
Queen's Park,7271,10,6,11,19,40,73,-33,29
Raith,7272,1,23,8,5,69,32,37,77
Ayr,7272,2,23,4,9,91,45,46,73
Arbroath,7272,3,17,9,10,73,51,22,60
Alloa,7272,4,17,8,11,56,44,12,59
Stranraer,7272,5,15,5,16,56,66,-10,50
East Fife,7272,6,14,3,19,49,65,-16,45
Airdrieon,7272,7,11,11,14,48,59,-11,44
Forfar,7272,8,10,5,21,39,67,-28,35
Albion,7272,9,9,6,21,60,79,-19,33
Queen's Park,7272,10,6,11,19,42,75,-33,29
Raith,7273,1,23,8,5,70,32,38,77
Ayr,7273,2,24,4,8,94,44,50,76
Arbroath,7273,3,17,9,10,71,49,22,60
Alloa,7273,4,17,8,11,56,45,11,59
Stranraer,7273,5,15,5,16,55,66,-11,50
East Fife,7273,6,14,3,19,49,64,-15,45
Airdrieon,7273,7,11,11,14,46,58,-12,44
Forfar,7273,8,10,5,21,38,65,-27,35
Albion,7273,9,8,6,22,59,82,-23,30
Queen's Park,7273,10,6,11,19,40,73,-33,29
Raith,7274,1,23,8,5,71,33,38,77
Ayr,7274,2,24,4,8,93,42,51,76
Arbroath,7274,3,18,8,10,72,48,24,62
Alloa,7274,4,17,8,11,57,46,11,59
Stranraer,7274,5,15,5,16,57,67,-10,50
East Fife,7274,6,14,3,19,50,66,-16,45
Airdrieon,7274,7,10,11,15,46,60,-14,41
Forfar,7274,8,11,5,20,40,65,-25,38
Albion,7274,9,8,6,22,57,81,-24,30
Queen's Park,7274,10,6,10,20,39,74,-35,28
Raith,7275,1,23,8,5,70,32,38,77
Ayr,7275,2,23,5,8,92,44,48,74
Arbroath,7275,3,17,9,10,71,49,22,60
Alloa,7275,4,17,8,11,56,45,11,59
Stranraer,7275,5,15,5,16,55,65,-10,50
East Fife,7275,6,14,3,19,48,64,-16,45
Airdrieon,7275,7,11,11,14,47,59,-12,44
Forfar,7275,8,10,5,21,39,66,-27,35
Albion,7275,9,8,7,21,59,80,-21,31
Queen's Park,7275,10,6,11,19,40,73,-33,29
Raith,7276,1,23,8,5,72,33,39,77
Ayr,7276,2,24,4,8,93,43,50,76
Arbroath,7276,3,17,9,10,71,49,22,60
Alloa,7276,4,17,8,11,57,47,10,59
Stranraer,7276,5,16,5,15,59,64,-5,53
East Fife,7276,6,13,3,20,47,68,-21,42
Airdrieon,7276,7,10,11,15,45,60,-15,41
Forfar,7276,8,11,5,20,40,64,-24,38
Albion,7276,9,8,6,22,58,81,-23,30
Queen's Park,7276,10,6,11,19,40,73,-33,29
Ayr,7277,1,24,4,8,93,43,50,76
Raith,7277,2,22,8,6,68,34,34,74
Arbroath,7277,3,18,8,10,73,49,24,62
Alloa,7277,4,18,8,10,58,43,15,62
Stranraer,7277,5,16,5,15,57,64,-7,53
Airdrieon,7277,6,11,11,14,47,59,-12,44
East Fife,7277,7,13,3,20,47,66,-19,42
Forfar,7277,8,10,5,21,39,66,-27,35
Albion,7277,9,8,6,22,58,81,-23,30
Queen's Park,7277,10,6,10,20,40,75,-35,28
Raith,7278,1,23,8,5,70,33,37,77
Ayr,7278,2,24,4,8,93,42,51,76
Arbroath,7278,3,18,8,10,72,48,24,62
Alloa,7278,4,17,8,11,57,45,12,59
Stranraer,7278,5,16,5,15,56,64,-8,53
Airdrieon,7278,6,10,12,14,46,59,-13,42
East Fife,7278,7,13,3,20,47,65,-18,42
Forfar,7278,8,10,6,20,39,65,-26,36
Albion,7278,9,8,6,22,57,81,-24,30
Queen's Park,7278,10,6,10,20,39,74,-35,28
Raith,7279,1,23,8,5,73,32,41,77
Ayr,7279,2,24,4,8,93,43,50,76
Arbroath,7279,3,18,8,10,74,49,25,62
Alloa,7279,4,17,8,11,56,48,8,59
Stranraer,7279,5,15,5,16,56,67,-11,50
East Fife,7279,6,14,3,19,50,65,-15,45
Airdrieon,7279,7,10,12,14,47,60,-13,42
Forfar,7279,8,10,6,20,40,66,-26,36
Albion,7279,9,8,6,22,58,81,-23,30
Queen's Park,7279,10,6,10,20,40,76,-36,28
Ayr,7280,1,24,4,8,97,43,54,76
Raith,7280,2,22,8,6,68,35,33,74
Arbroath,7280,3,18,8,10,74,48,26,62
Alloa,7280,4,18,8,10,59,43,16,62
Stranraer,7280,5,16,5,15,57,65,-8,53
Airdrieon,7280,6,10,12,14,47,60,-13,42
East Fife,7280,7,13,3,20,48,66,-18,42
Forfar,7280,8,10,6,20,40,66,-26,36
Albion,7280,9,8,6,22,58,85,-27,30
Queen's Park,7280,10,6,10,20,39,76,-37,28
Ayr,7281,1,24,4,8,95,42,53,76
Raith,7281,2,22,9,5,70,34,36,75
Alloa,7281,3,17,9,10,58,45,13,60
Arbroath,7281,4,17,8,11,70,49,21,59
Stranraer,7281,5,15,6,15,56,65,-9,51
East Fife,7281,6,13,4,19,48,65,-17,43
Airdrieon,7281,7,10,11,15,45,59,-14,41
Forfar,7281,8,11,5,20,39,64,-25,38
Queen's Park,7281,9,7,10,19,40,72,-32,31
Albion,7281,10,8,6,22,57,83,-26,30
Raith,7282,1,23,8,5,71,34,37,77
Ayr,7282,2,24,4,8,92,43,49,76
Arbroath,7282,3,17,9,10,72,50,22,60
Alloa,7282,4,17,8,11,58,46,12,59
Stranraer,7282,5,16,5,15,57,64,-7,53
East Fife,7282,6,13,3,20,47,66,-19,42
Airdrieon,7282,7,10,11,15,46,61,-15,41
Forfar,7282,8,11,5,20,41,65,-24,38
Albion,7282,9,8,6,22,58,80,-22,30
Queen's Park,7282,10,6,11,19,41,74,-33,29
Raith,7283,1,23,8,5,71,34,37,77
Ayr,7283,2,24,4,8,91,42,49,76
Arbroath,7283,3,17,9,10,72,50,22,60
Alloa,7283,4,17,8,11,58,46,12,59
Stranraer,7283,5,16,5,15,57,65,-8,53
Airdrieon,7283,6,10,12,14,46,59,-13,42
East Fife,7283,7,13,3,20,48,66,-18,42
Forfar,7283,8,10,6,20,39,65,-26,36
Albion,7283,9,8,6,22,57,79,-22,30
Queen's Park,7283,10,6,11,19,41,74,-33,29
Raith,7284,1,23,8,5,69,32,37,77
Ayr,7284,2,24,4,8,94,43,51,76
Arbroath,7284,3,17,8,11,70,51,19,59
Alloa,7284,4,17,8,11,56,44,12,59
Stranraer,7284,5,16,5,15,57,65,-8,53
Airdrieon,7284,6,11,11,14,46,58,-12,44
East Fife,7284,7,13,3,20,48,66,-18,42
Forfar,7284,8,10,5,21,38,65,-27,35
Queen's Park,7284,9,7,10,19,42,72,-30,31
Albion,7284,10,8,6,22,58,82,-24,30
Raith,7285,1,22,9,5,69,33,36,75
Ayr,7285,2,23,5,8,90,42,48,74
Arbroath,7285,3,18,8,10,72,48,24,62
Alloa,7285,4,17,9,10,57,44,13,60
Stranraer,7285,5,15,5,16,57,67,-10,50
East Fife,7285,6,14,3,19,50,66,-16,45
Airdrieon,7285,7,10,11,15,46,60,-14,41
Forfar,7285,8,11,5,20,40,65,-25,38
Albion,7285,9,8,7,21,57,78,-21,31
Queen's Park,7285,10,6,10,20,39,74,-35,28
Raith,7286,1,22,8,6,68,33,35,74
Ayr,7286,2,23,4,9,91,44,47,73
Alloa,7286,3,18,8,10,57,43,14,62
Arbroath,7286,4,17,8,11,70,49,21,59
Stranraer,7286,5,16,5,15,57,65,-8,53
East Fife,7286,6,13,3,20,48,66,-18,42
Airdrieon,7286,7,10,11,15,46,61,-15,41
Forfar,7286,8,11,5,20,41,65,-24,38
Albion,7286,9,9,6,21,59,79,-20,33
Queen's Park,7286,10,7,10,19,40,72,-32,31
Ayr,7287,1,24,4,8,94,42,52,76
Raith,7287,2,22,8,6,69,34,35,74
Alloa,7287,3,18,8,10,58,44,14,62
Arbroath,7287,4,17,8,11,71,50,21,59
Stranraer,7287,5,16,5,15,57,65,-8,53
Airdrieon,7287,6,11,11,14,48,58,-10,44
East Fife,7287,7,13,3,20,48,66,-18,42
Forfar,7287,8,10,5,21,38,67,-29,35
Queen's Park,7287,9,7,10,19,41,73,-32,31
Albion,7287,10,8,6,22,57,82,-25,30
Raith,7288,1,23,8,5,72,32,40,77
Ayr,7288,2,23,5,8,90,42,48,74
Arbroath,7288,3,17,9,10,72,50,22,60
Alloa,7288,4,17,8,11,56,47,9,59
Stranraer,7288,5,16,5,15,58,64,-6,53
Airdrieon,7288,6,11,11,14,49,58,-9,44
East Fife,7288,7,13,3,20,47,67,-20,42
Forfar,7288,8,10,5,21,38,68,-30,35
Albion,7288,9,8,7,21,57,78,-21,31
Queen's Park,7288,10,6,11,19,41,74,-33,29
Ayr,7289,1,24,4,8,93,42,51,76
Raith,7289,2,22,9,5,70,34,36,75
Arbroath,7289,3,18,8,10,72,48,24,62
Alloa,7289,4,17,9,10,58,45,13,60
Stranraer,7289,5,15,5,16,55,66,-11,50
East Fife,7289,6,14,3,19,49,64,-15,45
Airdrieon,7289,7,11,11,14,49,60,-11,44
Forfar,7289,8,10,5,21,40,68,-28,35
Albion,7289,9,8,6,22,57,81,-24,30
Queen's Park,7289,10,6,10,20,39,74,-35,28
Raith,7290,1,23,8,5,70,32,38,77
Ayr,7290,2,23,4,9,92,45,47,73
Arbroath,7290,3,17,9,10,72,50,22,60
Alloa,7290,4,17,8,11,56,45,11,59
Stranraer,7290,5,16,5,15,57,65,-8,53
Airdrieon,7290,6,10,12,14,47,60,-13,42
East Fife,7290,7,13,3,20,48,66,-18,42
Forfar,7290,8,10,6,20,40,66,-26,36
Albion,7290,9,9,6,21,60,80,-20,33
Queen's Park,7290,10,6,11,19,41,74,-33,29
Raith,7291,1,23,8,5,71,32,39,77
Ayr,7291,2,24,4,8,92,42,50,76
Arbroath,7291,3,17,8,11,71,50,21,59
Alloa,7291,4,17,8,11,56,46,10,59
Stranraer,7291,5,15,5,16,55,66,-11,50
East Fife,7291,6,14,3,19,49,64,-15,45
Airdrieon,7291,7,11,11,14,46,58,-12,44
Forfar,7291,8,10,5,21,38,65,-27,35
Queen's Park,7291,9,7,10,19,41,73,-32,31
Albion,7291,10,8,6,22,57,80,-23,30
Raith,7292,1,23,8,5,72,32,40,77
Ayr,7292,2,24,4,8,91,42,49,76
Arbroath,7292,3,17,8,11,70,49,21,59
Alloa,7292,4,17,8,11,56,47,9,59
Stranraer,7292,5,15,5,16,57,68,-11,50
East Fife,7292,6,14,3,19,51,66,-15,45
Airdrieon,7292,7,11,11,14,47,59,-12,44
Forfar,7292,8,10,5,21,39,66,-27,35
Queen's Park,7292,9,7,10,19,40,72,-32,31
Albion,7292,10,8,6,22,57,79,-22,30
Raith,7293,1,23,8,5,72,35,37,77
Ayr,7293,2,24,4,8,97,43,54,76
Arbroath,7293,3,18,8,10,74,48,26,62
Alloa,7293,4,17,8,11,59,47,12,59
Stranraer,7293,5,15,6,15,55,64,-9,51
East Fife,7293,6,13,4,19,47,64,-17,43
Airdrieon,7293,7,10,11,15,46,60,-14,41
Forfar,7293,8,11,5,20,40,65,-25,38
Albion,7293,9,8,6,22,58,85,-27,30
Queen's Park,7293,10,6,10,20,39,76,-37,28
Ayr,7294,1,24,4,8,96,45,51,76
Raith,7294,2,22,8,6,68,34,34,74
Alloa,7294,3,18,8,10,58,43,15,62
Arbroath,7294,4,17,9,10,71,49,22,60
Stranraer,7294,5,15,5,16,56,66,-10,50
East Fife,7294,6,14,3,19,49,65,-16,45
Airdrieon,7294,7,10,12,14,46,59,-13,42
Forfar,7294,8,10,6,20,39,65,-26,36
Albion,7294,9,8,6,22,60,84,-24,30
Queen's Park,7294,10,6,11,19,40,73,-33,29
Raith,7295,1,23,8,5,71,33,38,77
Ayr,7295,2,24,4,8,96,44,52,76
Arbroath,7295,3,17,8,11,71,51,20,59
Alloa,7295,4,17,8,11,57,46,11,59
Stranraer,7295,5,15,5,16,57,67,-10,50
East Fife,7295,6,14,3,19,50,66,-16,45
Airdrieon,7295,7,11,11,14,46,58,-12,44
Forfar,7295,8,10,5,21,38,65,-27,35
Queen's Park,7295,9,7,10,19,42,73,-31,31
Albion,7295,10,8,6,22,59,84,-25,30
Ayr,7296,1,24,4,8,96,44,52,76
Raith,7296,2,22,9,5,69,33,36,75
Alloa,7296,3,17,9,10,57,44,13,60
Arbroath,7296,4,17,8,11,72,51,21,59
Stranraer,7296,5,16,5,15,57,65,-8,53
Airdrieon,7296,6,10,12,14,47,60,-13,42
East Fife,7296,7,13,3,20,48,66,-18,42
Forfar,7296,8,10,6,20,40,66,-26,36
Queen's Park,7296,9,7,10,19,42,74,-32,31
Albion,7296,10,8,6,22,59,84,-25,30
Ayr,7297,1,23,5,8,90,42,48,74
Raith,7297,2,22,8,6,69,34,35,74
Alloa,7297,3,18,8,10,58,44,14,62
Arbroath,7297,4,17,8,11,70,49,21,59
Stranraer,7297,5,15,5,16,56,67,-11,50
East Fife,7297,6,14,3,19,50,65,-15,45
Airdrieon,7297,7,10,12,14,46,59,-13,42
Forfar,7297,8,10,6,20,39,65,-26,36
Albion,7297,9,8,7,21,57,78,-21,31
Queen's Park,7297,10,7,10,19,40,72,-32,31
Ayr,7298,1,24,4,8,93,43,50,76
Raith,7298,2,22,9,5,69,33,36,75
Arbroath,7298,3,17,9,10,70,48,22,60
Alloa,7298,4,17,9,10,57,44,13,60
Stranraer,7298,5,15,6,15,55,64,-9,51
East Fife,7298,6,13,4,19,47,64,-17,43
Airdrieon,7298,7,10,11,15,45,59,-14,41
Forfar,7298,8,11,5,20,39,64,-25,38
Albion,7298,9,8,6,22,58,81,-23,30
Queen's Park,7298,10,6,11,19,39,72,-33,29
Ayr,7299,1,24,4,8,94,43,51,76
Raith,7299,2,22,9,5,69,33,36,75
Alloa,7299,3,17,9,10,57,44,13,60
Arbroath,7299,4,17,8,11,70,50,20,59
Stranraer,7299,5,15,6,15,56,65,-9,51
Airdrieon,7299,6,11,11,14,48,58,-10,44
East Fife,7299,7,13,4,19,48,65,-17,43
Forfar,7299,8,10,5,21,38,67,-29,35
Queen's Park,7299,9,7,10,19,41,72,-31,31
Albion,7299,10,8,6,22,58,82,-24,30
Raith,7300,1,23,8,5,69,32,37,77
Ayr,7300,2,24,4,8,92,42,50,76
Arbroath,7300,3,17,9,10,73,51,22,60
Alloa,7300,4,17,8,11,56,44,12,59
Stranraer,7300,5,15,5,16,56,66,-10,50
East Fife,7300,6,14,3,19,49,65,-16,45
Airdrieon,7300,7,10,12,14,47,60,-13,42
Forfar,7300,8,10,6,20,40,66,-26,36
Albion,7300,9,8,6,22,57,80,-23,30
Queen's Park,7300,10,6,11,19,42,75,-33,29
Raith,7301,1,22,9,5,68,32,36,75
Ayr,7301,2,23,4,9,91,44,47,73
Alloa,7301,3,17,9,10,56,43,13,60
Arbroath,7301,4,17,8,11,70,49,21,59
Stranraer,7301,5,15,5,16,58,69,-11,50
East Fife,7301,6,14,3,19,52,67,-15,45
Airdrieon,7301,7,11,11,14,46,58,-12,44
Forfar,7301,8,10,5,21,38,65,-27,35
Albion,7301,9,9,6,21,59,79,-20,33
Queen's Park,7301,10,7,10,19,40,72,-32,31
Raith,7302,1,22,8,6,68,34,34,74
Ayr,7302,2,23,4,9,93,46,47,73
Arbroath,7302,3,18,8,10,72,49,23,62
Alloa,7302,4,18,8,10,58,43,15,62
Stranraer,7302,5,16,5,15,56,64,-8,53
East Fife,7302,6,13,3,20,47,65,-18,42
Airdrieon,7302,7,10,11,15,46,62,-16,41
Forfar,7302,8,11,5,20,42,65,-23,38
Albion,7302,9,9,6,21,61,81,-20,33
Queen's Park,7302,10,6,10,20,40,74,-34,28
Raith,7303,1,23,8,5,69,32,37,77
Ayr,7303,2,24,4,8,94,43,51,76
Arbroath,7303,3,18,8,10,75,50,25,62
Alloa,7303,4,17,8,11,56,44,12,59
Stranraer,7303,5,16,5,15,58,64,-6,53
East Fife,7303,6,13,3,20,47,67,-20,42
Airdrieon,7303,7,10,11,15,46,60,-14,41
Forfar,7303,8,11,5,20,40,65,-25,38
Albion,7303,9,8,6,22,58,82,-24,30
Queen's Park,7303,10,6,10,20,41,77,-36,28
Raith,7304,1,23,8,5,70,33,37,77
Ayr,7304,2,24,4,8,94,43,51,76
Arbroath,7304,3,18,8,10,71,48,23,62
Alloa,7304,4,17,8,11,57,45,12,59
Stranraer,7304,5,16,5,15,56,64,-8,53
Airdrieon,7304,6,11,11,14,46,58,-12,44
East Fife,7304,7,13,3,20,47,65,-18,42
Forfar,7304,8,10,5,21,38,65,-27,35
Albion,7304,9,8,6,22,58,82,-24,30
Queen's Park,7304,10,6,10,20,39,73,-34,28
Raith,7305,1,23,8,5,71,33,38,77
Ayr,7305,2,24,4,8,94,44,50,76
Arbroath,7305,3,18,8,10,73,49,24,62
Alloa,7305,4,17,8,11,57,46,11,59
Stranraer,7305,5,15,5,16,57,68,-11,50
East Fife,7305,6,14,3,19,51,66,-15,45
Airdrieon,7305,7,11,11,14,50,58,-8,44
Forfar,7305,8,10,5,21,38,69,-31,35
Albion,7305,9,8,6,22,59,82,-23,30
Queen's Park,7305,10,6,10,20,40,75,-35,28
Raith,7306,1,23,8,5,69,32,37,77
Ayr,7306,2,24,4,8,92,42,50,76
Arbroath,7306,3,17,8,11,71,51,20,59
Alloa,7306,4,17,8,11,56,44,12,59
Stranraer,7306,5,16,5,15,57,65,-8,53
East Fife,7306,6,13,3,20,48,66,-18,42
Airdrieon,7306,7,10,11,15,45,59,-14,41
Forfar,7306,8,11,5,20,39,64,-25,38
Queen's Park,7306,9,7,10,19,42,73,-31,31
Albion,7306,10,8,6,22,57,80,-23,30
Raith,7307,1,23,8,5,72,34,38,77
Ayr,7307,2,24,4,8,96,44,52,76
Arbroath,7307,3,17,9,10,70,48,22,60
Alloa,7307,4,17,8,11,58,47,11,59
Stranraer,7307,5,15,5,16,57,67,-10,50
East Fife,7307,6,14,3,19,50,66,-16,45
Airdrieon,7307,7,10,12,14,45,58,-13,42
Forfar,7307,8,10,6,20,38,64,-26,36
Albion,7307,9,8,6,22,59,84,-25,30
Queen's Park,7307,10,6,11,19,39,72,-33,29
Raith,7308,1,23,8,5,73,32,41,77
Ayr,7308,2,24,4,8,94,45,49,76
Arbroath,7308,3,18,8,10,72,49,23,62
Alloa,7308,4,17,8,11,56,48,8,59
Stranraer,7308,5,15,5,16,55,66,-11,50
East Fife,7308,6,14,3,19,49,64,-15,45
Airdrieon,7308,7,10,12,14,46,59,-13,42
Forfar,7308,8,10,6,20,39,65,-26,36
Albion,7308,9,8,6,22,60,82,-22,30
Queen's Park,7308,10,6,10,20,40,74,-34,28
Raith,7309,1,23,8,5,72,32,40,77
Ayr,7309,2,24,4,8,92,42,50,76
Arbroath,7309,3,18,8,10,73,49,24,62
Alloa,7309,4,17,8,11,56,47,9,59
Stranraer,7309,5,15,5,16,58,68,-10,50
East Fife,7309,6,14,3,19,51,67,-16,45
Airdrieon,7309,7,10,12,14,46,59,-13,42
Forfar,7309,8,10,6,20,39,65,-26,36
Albion,7309,9,8,6,22,57,80,-23,30
Queen's Park,7309,10,6,10,20,40,75,-35,28
Raith,7310,1,23,8,5,71,32,39,77
Ayr,7310,2,23,5,8,92,44,48,74
Arbroath,7310,3,18,8,10,73,48,25,62
Alloa,7310,4,17,8,11,56,46,10,59
Stranraer,7310,5,15,5,16,56,66,-10,50
East Fife,7310,6,14,3,19,49,65,-16,45
Airdrieon,7310,7,11,11,14,47,58,-11,44
Forfar,7310,8,10,5,21,38,66,-28,35
Albion,7310,9,8,7,21,59,80,-21,31
Queen's Park,7310,10,6,10,20,39,75,-36,28
Raith,7311,1,23,8,5,70,33,37,77
Ayr,7311,2,24,4,8,93,43,50,76
Arbroath,7311,3,17,8,11,70,49,21,59
Alloa,7311,4,17,8,11,57,45,12,59
Stranraer,7311,5,15,6,15,57,66,-9,51
East Fife,7311,6,13,4,19,49,66,-17,43
Airdrieon,7311,7,10,11,15,46,60,-14,41
Forfar,7311,8,11,5,20,40,65,-25,38
Queen's Park,7311,9,7,10,19,40,72,-32,31
Albion,7311,10,8,6,22,58,81,-23,30
Raith,7312,1,22,8,6,69,34,35,74
Ayr,7312,2,23,4,9,91,44,47,73
Alloa,7312,3,18,8,10,58,44,14,62
Arbroath,7312,4,17,9,10,72,50,22,60
Stranraer,7312,5,15,5,16,55,65,-10,50
East Fife,7312,6,14,3,19,48,64,-16,45
Airdrieon,7312,7,10,12,14,45,58,-13,42
Forfar,7312,8,10,6,20,38,64,-26,36
Albion,7312,9,9,6,21,59,79,-20,33
Queen's Park,7312,10,6,11,19,41,74,-33,29
Raith,7313,1,23,8,5,71,34,37,77
Ayr,7313,2,24,4,8,92,42,50,76
Arbroath,7313,3,18,8,10,75,49,26,62
Alloa,7313,4,17,8,11,58,46,12,59
Stranraer,7313,5,15,5,16,56,66,-10,50
East Fife,7313,6,14,3,19,49,65,-16,45
Airdrieon,7313,7,10,12,14,46,59,-13,42
Forfar,7313,8,10,6,20,39,65,-26,36
Albion,7313,9,8,6,22,57,80,-23,30
Queen's Park,7313,10,6,10,20,40,77,-37,28
Raith,7314,1,23,8,5,72,32,40,77
Ayr,7314,2,24,4,8,96,43,53,76
Arbroath,7314,3,18,8,10,72,49,23,62
Alloa,7314,4,17,8,11,56,47,9,59
Stranraer,7314,5,15,6,15,57,66,-9,51
East Fife,7314,6,13,4,19,49,66,-17,43
Airdrieon,7314,7,10,12,14,46,59,-13,42
Forfar,7314,8,10,6,20,39,65,-26,36
Albion,7314,9,8,6,22,58,84,-26,30
Queen's Park,7314,10,6,10,20,40,74,-34,28
Raith,7315,1,23,8,5,70,33,37,77
Ayr,7315,2,23,4,9,90,44,46,73
Arbroath,7315,3,18,8,10,73,49,24,62
Alloa,7315,4,17,8,11,57,45,12,59
Stranraer,7315,5,15,5,16,55,66,-11,50
East Fife,7315,6,14,3,19,49,64,-15,45
Airdrieon,7315,7,10,11,15,45,60,-15,41
Forfar,7315,8,11,5,20,40,64,-24,38
Albion,7315,9,9,6,21,59,78,-19,33
Queen's Park,7315,10,6,10,20,40,75,-35,28
Ayr,7316,1,24,4,8,93,42,51,76
Raith,7316,2,22,9,5,70,34,36,75
Arbroath,7316,3,18,8,10,72,49,23,62
Alloa,7316,4,17,9,10,58,45,13,60
Stranraer,7316,5,15,5,16,57,68,-11,50
East Fife,7316,6,14,3,19,51,66,-15,45
Airdrieon,7316,7,11,11,14,48,58,-10,44
Forfar,7316,8,10,5,21,38,67,-29,35
Albion,7316,9,8,6,22,57,81,-24,30
Queen's Park,7316,10,6,10,20,40,74,-34,28
Ayr,7317,1,24,4,8,93,44,49,76
Raith,7317,2,22,9,5,69,33,36,75
Arbroath,7317,3,18,8,10,72,49,23,62
Alloa,7317,4,17,9,10,57,44,13,60
Stranraer,7317,5,16,5,15,58,66,-8,53
Airdrieon,7317,6,11,11,14,48,60,-12,44
East Fife,7317,7,13,3,20,49,67,-18,42
Forfar,7317,8,10,5,21,40,67,-27,35
Albion,7317,9,8,6,22,59,81,-22,30
Queen's Park,7317,10,6,10,20,40,74,-34,28
Ayr,7318,1,24,4,8,94,42,52,76
Raith,7318,2,22,9,5,69,33,36,75
Alloa,7318,3,17,9,10,57,44,13,60
Arbroath,7318,4,17,8,11,71,52,19,59
Stranraer,7318,5,15,5,16,56,68,-12,50
East Fife,7318,6,14,3,19,51,65,-14,45
Airdrieon,7318,7,11,11,14,46,58,-12,44
Forfar,7318,8,10,5,21,38,65,-27,35
Queen's Park,7318,9,7,10,19,43,73,-30,31
Albion,7318,10,8,6,22,57,82,-25,30
Raith,7319,1,23,8,5,70,32,38,77
Ayr,7319,2,23,5,8,90,42,48,74
Arbroath,7319,3,17,9,10,71,49,22,60
Alloa,7319,4,17,8,11,56,45,11,59
Stranraer,7319,5,15,5,16,57,71,-14,50
East Fife,7319,6,14,3,19,54,66,-12,45
Airdrieon,7319,7,11,11,14,48,58,-10,44
Forfar,7319,8,10,5,21,38,67,-29,35
Albion,7319,9,8,7,21,57,78,-21,31
Queen's Park,7319,10,6,11,19,40,73,-33,29
Raith,7320,1,23,8,5,71,33,38,77
Ayr,7320,2,24,4,8,93,42,51,76
Arbroath,7320,3,17,9,10,71,49,22,60
Alloa,7320,4,17,8,11,57,46,11,59
Stranraer,7320,5,15,5,16,57,67,-10,50
East Fife,7320,6,14,3,19,50,66,-16,45
Airdrieon,7320,7,11,11,14,49,60,-11,44
Forfar,7320,8,10,5,21,40,68,-28,35
Albion,7320,9,8,6,22,57,81,-24,30
Queen's Park,7320,10,6,11,19,40,73,-33,29
Ayr,7321,1,24,4,8,91,42,49,76
Raith,7321,2,22,8,6,68,33,35,74
Arbroath,7321,3,18,8,10,72,48,24,62
Alloa,7321,4,18,8,10,57,43,14,62
Stranraer,7321,5,15,5,16,56,66,-10,50
East Fife,7321,6,14,3,19,49,65,-16,45
Airdrieon,7321,7,11,11,14,47,59,-12,44
Forfar,7321,8,10,5,21,39,66,-27,35
Albion,7321,9,8,6,22,57,79,-22,30
Queen's Park,7321,10,6,10,20,39,74,-35,28
Raith,7322,1,23,8,5,72,33,39,77
Ayr,7322,2,24,4,8,93,42,51,76
Arbroath,7322,3,18,8,10,72,49,23,62
Alloa,7322,4,17,8,11,57,47,10,59
Stranraer,7322,5,15,6,15,55,64,-9,51
East Fife,7322,6,13,4,19,47,64,-17,43
Airdrieon,7322,7,10,12,14,46,59,-13,42
Forfar,7322,8,10,6,20,39,65,-26,36
Albion,7322,9,8,6,22,57,81,-24,30
Queen's Park,7322,10,6,10,20,40,74,-34,28
Ayr,7323,1,24,4,8,92,43,49,76
Raith,7323,2,22,9,5,68,32,36,75
Arbroath,7323,3,18,8,10,72,49,23,62
Alloa,7323,4,17,9,10,56,43,13,60
Stranraer,7323,5,15,5,16,55,67,-12,50
East Fife,7323,6,14,3,19,50,64,-14,45
Airdrieon,7323,7,11,11,14,48,58,-10,44
Forfar,7323,8,10,5,21,38,67,-29,35
Albion,7323,9,8,6,22,58,80,-22,30
Queen's Park,7323,10,6,10,20,40,74,-34,28
Ayr,7324,1,24,4,8,94,44,50,76
Raith,7324,2,22,9,5,69,33,36,75
Arbroath,7324,3,18,8,10,71,48,23,62
Alloa,7324,4,17,9,10,57,44,13,60
Stranraer,7324,5,15,6,15,57,66,-9,51
East Fife,7324,6,13,4,19,49,66,-17,43
Airdrieon,7324,7,10,11,15,46,60,-14,41
Forfar,7324,8,11,5,20,40,65,-25,38
Albion,7324,9,8,6,22,59,82,-23,30
Queen's Park,7324,10,6,10,20,39,73,-34,28
Raith,7325,1,22,9,5,68,32,36,75
Ayr,7325,2,23,5,8,91,43,48,74
Alloa,7325,3,17,9,10,56,43,13,60
Arbroath,7325,4,17,8,11,72,52,20,59
Stranraer,7325,5,15,5,16,56,68,-12,50
East Fife,7325,6,14,3,19,51,65,-14,45
Airdrieon,7325,7,10,12,14,46,59,-13,42
Forfar,7325,8,10,6,20,39,65,-26,36
Albion,7325,9,8,7,21,58,79,-21,31
Queen's Park,7325,10,7,10,19,43,74,-31,31
Raith,7326,1,22,9,5,68,32,36,75
Ayr,7326,2,23,5,8,92,44,48,74
Alloa,7326,3,17,9,10,56,43,13,60
Arbroath,7326,4,17,8,11,71,51,20,59
Stranraer,7326,5,15,5,16,56,66,-10,50
East Fife,7326,6,14,3,19,49,65,-16,45
Airdrieon,7326,7,10,12,14,45,58,-13,42
Forfar,7326,8,10,6,20,38,64,-26,36
Albion,7326,9,8,7,21,59,80,-21,31
Queen's Park,7326,10,7,10,19,42,73,-31,31
Raith,7327,1,23,8,5,72,33,39,77
Ayr,7327,2,24,4,8,92,43,49,76
Arbroath,7327,3,18,8,10,75,51,24,62
Alloa,7327,4,17,8,11,57,47,10,59
Stranraer,7327,5,16,5,15,57,64,-7,53
Airdrieon,7327,6,10,12,14,46,59,-13,42
East Fife,7327,7,13,3,20,47,66,-19,42
Forfar,7327,8,10,6,20,39,65,-26,36
Albion,7327,9,8,6,22,58,80,-22,30
Queen's Park,7327,10,6,10,20,42,77,-35,28
Raith,7328,1,23,8,5,72,33,39,77
Ayr,7328,2,24,4,8,93,43,50,76
Arbroath,7328,3,18,8,10,72,48,24,62
Alloa,7328,4,17,8,11,57,47,10,59
Stranraer,7328,5,15,5,16,55,67,-12,50
East Fife,7328,6,14,3,19,50,64,-14,45
Airdrieon,7328,7,11,11,14,48,58,-10,44
Forfar,7328,8,10,5,21,38,67,-29,35
Albion,7328,9,8,6,22,58,81,-23,30
Queen's Park,7328,10,6,10,20,39,74,-35,28
Ayr,7329,1,24,4,8,97,42,55,76
Raith,7329,2,22,9,5,68,32,36,75
Arbroath,7329,3,18,8,10,73,48,25,62
Alloa,7329,4,17,9,10,56,43,13,60
Stranraer,7329,5,15,5,16,55,67,-12,50
East Fife,7329,6,14,3,19,50,64,-14,45
Airdrieon,7329,7,10,11,15,47,62,-15,41
Forfar,7329,8,11,5,20,42,66,-24,38
Albion,7329,9,8,6,22,57,85,-28,30
Queen's Park,7329,10,6,10,20,39,75,-36,28
Raith,7330,1,23,8,5,70,32,38,77
Ayr,7330,2,24,4,8,95,45,50,76
Arbroath,7330,3,18,8,10,76,48,28,62
Alloa,7330,4,17,8,11,56,45,11,59
Stranraer,7330,5,15,5,16,56,66,-10,50
East Fife,7330,6,14,3,19,49,65,-16,45
Airdrieon,7330,7,11,11,14,47,59,-12,44
Forfar,7330,8,10,5,21,39,66,-27,35
Albion,7330,9,8,6,22,60,83,-23,30
Queen's Park,7330,10,6,10,20,39,78,-39,28
Raith,7331,1,23,8,5,71,32,39,77
Ayr,7331,2,24,4,8,95,44,51,76
Arbroath,7331,3,17,8,11,72,51,21,59
Alloa,7331,4,17,8,11,56,46,10,59
Stranraer,7331,5,16,5,15,58,65,-7,53
Airdrieon,7331,6,11,11,14,48,59,-11,44
East Fife,7331,7,13,3,20,48,67,-19,42
Forfar,7331,8,10,5,21,39,67,-28,35
Queen's Park,7331,9,7,10,19,42,74,-32,31
Albion,7331,10,8,6,22,59,83,-24,30
Raith,7332,1,23,8,5,73,34,39,77
Ayr,7332,2,24,4,8,93,43,50,76
Arbroath,7332,3,18,8,10,71,48,23,62
Alloa,7332,4,17,8,11,58,48,10,59
Stranraer,7332,5,15,5,16,55,67,-12,50
East Fife,7332,6,14,3,19,50,64,-14,45
Airdrieon,7332,7,11,11,14,48,58,-10,44
Forfar,7332,8,10,5,21,38,67,-29,35
Albion,7332,9,8,6,22,58,81,-23,30
Queen's Park,7332,10,6,10,20,39,73,-34,28
Ayr,7333,1,24,4,8,95,43,52,76
Raith,7333,2,22,8,6,68,34,34,74
Arbroath,7333,3,18,8,10,74,49,25,62
Alloa,7333,4,18,8,10,58,43,15,62
Stranraer,7333,5,16,5,15,58,65,-7,53
Airdrieon,7333,6,10,12,14,48,61,-13,42
East Fife,7333,7,13,3,20,48,67,-19,42
Forfar,7333,8,10,6,20,41,67,-26,36
Albion,7333,9,8,6,22,58,83,-25,30
Queen's Park,7333,10,6,10,20,40,76,-36,28
Raith,7334,1,23,8,5,70,33,37,77
Ayr,7334,2,24,4,8,93,44,49,76
Arbroath,7334,3,18,8,10,74,50,24,62
Alloa,7334,4,17,8,11,57,45,12,59
Stranraer,7334,5,16,5,15,57,64,-7,53
Airdrieon,7334,6,11,11,14,46,58,-12,44
East Fife,7334,7,13,3,20,47,66,-19,42
Forfar,7334,8,10,5,21,38,65,-27,35
Albion,7334,9,8,6,22,59,81,-22,30
Queen's Park,7334,10,6,10,20,41,76,-35,28
Raith,7335,1,23,8,5,70,32,38,77
Ayr,7335,2,24,4,8,97,44,53,76
Arbroath,7335,3,17,8,11,70,49,21,59
Alloa,7335,4,17,8,11,56,45,11,59
Stranraer,7335,5,16,5,15,56,64,-8,53
Airdrieon,7335,6,10,12,14,46,59,-13,42
East Fife,7335,7,13,3,20,47,65,-18,42
Forfar,7335,8,10,6,20,39,65,-26,36
Queen's Park,7335,9,7,10,19,40,72,-32,31
Albion,7335,10,8,6,22,59,85,-26,30
Ayr,7336,1,24,4,8,91,42,49,76
Raith,7336,2,22,8,6,69,35,34,74
Alloa,7336,3,18,8,10,59,44,15,62
Arbroath,7336,4,17,8,11,71,51,20,59
Stranraer,7336,5,15,5,16,57,67,-10,50
East Fife,7336,6,14,3,19,50,66,-16,45
Airdrieon,7336,7,10,12,14,45,58,-13,42
Forfar,7336,8,10,6,20,38,64,-26,36
Queen's Park,7336,9,7,10,19,42,73,-31,31
Albion,7336,10,8,6,22,57,79,-22,30
Ayr,7337,1,24,4,8,93,43,50,76
Raith,7337,2,22,9,5,68,32,36,75
Arbroath,7337,3,18,8,10,72,48,24,62
Alloa,7337,4,17,9,10,56,43,13,60
Stranraer,7337,5,15,6,15,55,64,-9,51
Airdrieon,7337,6,11,11,14,47,59,-12,44
East Fife,7337,7,13,4,19,47,64,-17,43
Forfar,7337,8,10,5,21,39,66,-27,35
Albion,7337,9,8,6,22,58,81,-23,30
Queen's Park,7337,10,6,10,20,39,74,-35,28
Ayr,7338,1,24,4,8,91,42,49,76
Raith,7338,2,22,9,5,68,32,36,75
Arbroath,7338,3,18,8,10,72,48,24,62
Alloa,7338,4,17,9,10,56,43,13,60
Stranraer,7338,5,15,6,15,57,66,-9,51
East Fife,7338,6,13,4,19,49,66,-17,43
Airdrieon,7338,7,10,12,14,46,59,-13,42
Forfar,7338,8,10,6,20,39,65,-26,36
Albion,7338,9,8,6,22,57,79,-22,30
Queen's Park,7338,10,6,10,20,39,74,-35,28
Raith,7339,1,23,8,5,75,33,42,77
Ayr,7339,2,24,4,8,94,45,49,76
Arbroath,7339,3,18,8,10,73,48,25,62
Alloa,7339,4,17,8,11,57,50,7,59
Stranraer,7339,5,16,5,15,56,64,-8,53
Airdrieon,7339,6,11,11,14,48,58,-10,44
East Fife,7339,7,13,3,20,47,65,-18,42
Forfar,7339,8,10,5,21,38,67,-29,35
Albion,7339,9,8,6,22,60,82,-22,30
Queen's Park,7339,10,6,10,20,39,75,-36,28
Ayr,7340,1,24,4,8,97,42,55,76
Raith,7340,2,22,8,6,68,33,35,74
Alloa,7340,3,18,8,10,57,43,14,62
Arbroath,7340,4,17,8,11,71,51,20,59
Stranraer,7340,5,15,5,16,56,67,-11,50
East Fife,7340,6,14,3,19,50,65,-15,45
Airdrieon,7340,7,10,12,14,45,58,-13,42
Forfar,7340,8,10,6,20,38,64,-26,36
Queen's Park,7340,9,7,10,19,42,73,-31,31
Albion,7340,10,8,6,22,57,85,-28,30
Ayr,7341,1,24,4,8,93,42,51,76
Raith,7341,2,22,9,5,68,32,36,75
Arbroath,7341,3,18,8,10,75,48,27,62
Alloa,7341,4,17,9,10,56,43,13,60
Stranraer,7341,5,15,6,15,57,66,-9,51
East Fife,7341,6,13,4,19,49,66,-17,43
Airdrieon,7341,7,10,12,14,45,58,-13,42
Forfar,7341,8,10,6,20,38,64,-26,36
Albion,7341,9,8,6,22,57,81,-24,30
Queen's Park,7341,10,6,10,20,39,77,-38,28
Ayr,7342,1,24,4,8,93,43,50,76
Raith,7342,2,22,9,5,69,33,36,75
Arbroath,7342,3,17,9,10,73,51,22,60
Alloa,7342,4,17,9,10,57,44,13,60
Stranraer,7342,5,15,5,16,55,65,-10,50
East Fife,7342,6,14,3,19,48,64,-16,45
Airdrieon,7342,7,11,11,14,48,59,-11,44
Forfar,7342,8,10,5,21,39,67,-28,35
Albion,7342,9,8,6,22,58,81,-23,30
Queen's Park,7342,10,6,11,19,42,75,-33,29
Ayr,7343,1,23,5,8,92,44,48,74
Raith,7343,2,22,8,6,68,34,34,74
Alloa,7343,3,18,8,10,58,43,15,62
Arbroath,7343,4,17,8,11,70,49,21,59
Stranraer,7343,5,15,5,16,57,67,-10,50
East Fife,7343,6,14,3,19,50,66,-16,45
Airdrieon,7343,7,10,11,15,45,59,-14,41
Forfar,7343,8,11,5,20,39,64,-25,38
Albion,7343,9,8,7,21,59,80,-21,31
Queen's Park,7343,10,7,10,19,40,72,-32,31
Raith,7344,1,23,8,5,72,32,40,77
Ayr,7344,2,24,4,8,92,43,49,76
Arbroath,7344,3,18,8,10,72,49,23,62
Alloa,7344,4,17,8,11,56,47,9,59
Stranraer,7344,5,15,5,16,56,67,-11,50
East Fife,7344,6,14,3,19,50,65,-15,45
Airdrieon,7344,7,10,11,15,46,62,-16,41
Forfar,7344,8,11,5,20,42,65,-23,38
Albion,7344,9,8,6,22,58,80,-22,30
Queen's Park,7344,10,6,10,20,40,74,-34,28
Ayr,7345,1,24,4,8,94,45,49,76
Raith,7345,2,22,9,5,69,33,36,75
Arbroath,7345,3,17,9,10,71,49,22,60
Alloa,7345,4,17,9,10,57,44,13,60
Stranraer,7345,5,15,5,16,56,67,-11,50
East Fife,7345,6,14,3,19,50,65,-15,45
Airdrieon,7345,7,10,11,15,45,59,-14,41
Forfar,7345,8,11,5,20,39,64,-25,38
Albion,7345,9,8,6,22,60,82,-22,30
Queen's Park,7345,10,6,11,19,40,73,-33,29
Ayr,7346,1,24,4,8,94,42,52,76
Raith,7346,2,22,9,5,69,33,36,75
Arbroath,7346,3,17,9,10,71,49,22,60
Alloa,7346,4,17,9,10,57,44,13,60
Stranraer,7346,5,15,5,16,56,66,-10,50
East Fife,7346,6,14,3,19,49,65,-16,45
Airdrieon,7346,7,11,11,14,47,58,-11,44
Forfar,7346,8,10,5,21,38,66,-28,35
Albion,7346,9,8,6,22,57,82,-25,30
Queen's Park,7346,10,6,11,19,40,73,-33,29
Raith,7347,1,22,9,5,68,32,36,75
Ayr,7347,2,23,5,8,93,45,48,74
Alloa,7347,3,17,9,10,56,43,13,60
Arbroath,7347,4,17,8,11,70,50,20,59
Stranraer,7347,5,16,5,15,59,67,-8,53
Airdrieon,7347,6,11,11,14,47,59,-12,44
East Fife,7347,7,13,3,20,50,68,-18,42
Forfar,7347,8,10,5,21,39,66,-27,35
Albion,7347,9,8,7,21,60,81,-21,31
Queen's Park,7347,10,7,10,19,41,72,-31,31
Raith,7348,1,23,8,5,70,32,38,77
Ayr,7348,2,24,4,8,93,42,51,76
Arbroath,7348,3,18,8,10,73,50,23,62
Alloa,7348,4,17,8,11,56,45,11,59
Stranraer,7348,5,15,6,15,56,65,-9,51
Airdrieon,7348,6,11,11,14,47,58,-11,44
East Fife,7348,7,13,4,19,48,65,-17,43
Forfar,7348,8,10,5,21,38,66,-28,35
Albion,7348,9,8,6,22,57,81,-24,30
Queen's Park,7348,10,6,10,20,41,75,-34,28
Ayr,7349,1,24,4,8,93,43,50,76
Raith,7349,2,22,9,5,71,35,36,75
Alloa,7349,3,17,9,10,59,46,13,60
Arbroath,7349,4,17,8,11,70,50,20,59
Stranraer,7349,5,15,5,16,56,66,-10,50
East Fife,7349,6,14,3,19,49,65,-16,45
Airdrieon,7349,7,10,11,15,45,59,-14,41
Forfar,7349,8,11,5,20,39,64,-25,38
Queen's Park,7349,9,7,10,19,41,72,-31,31
Albion,7349,10,8,6,22,58,81,-23,30
Raith,7350,1,23,8,5,70,33,37,77
Ayr,7350,2,24,4,8,92,43,49,76
Arbroath,7350,3,18,8,10,72,49,23,62
Alloa,7350,4,17,8,11,57,45,12,59
Stranraer,7350,5,15,5,16,55,65,-10,50
East Fife,7350,6,14,3,19,48,64,-16,45
Airdrieon,7350,7,10,12,14,46,59,-13,42
Forfar,7350,8,10,6,20,39,65,-26,36
Albion,7350,9,8,6,22,58,80,-22,30
Queen's Park,7350,10,6,10,20,40,74,-34,28
Raith,7351,1,23,8,5,70,32,38,77
Ayr,7351,2,24,4,8,98,43,55,76
Arbroath,7351,3,17,9,10,71,49,22,60
Alloa,7351,4,17,8,11,56,45,11,59
Stranraer,7351,5,16,5,15,57,65,-8,53
Airdrieon,7351,6,11,11,14,48,59,-11,44
East Fife,7351,7,13,3,20,48,66,-18,42
Forfar,7351,8,10,5,21,39,67,-28,35
Albion,7351,9,8,6,22,58,86,-28,30
Queen's Park,7351,10,6,11,19,40,73,-33,29
Ayr,7352,1,24,4,8,92,42,50,76
Raith,7352,2,22,9,5,68,32,36,75
Alloa,7352,3,17,9,10,56,43,13,60
Arbroath,7352,4,17,8,11,71,50,21,59
Stranraer,7352,5,15,5,16,56,67,-11,50
East Fife,7352,6,14,3,19,50,65,-15,45
Airdrieon,7352,7,10,12,14,45,58,-13,42
Forfar,7352,8,10,6,20,38,64,-26,36
Queen's Park,7352,9,7,10,19,41,73,-32,31
Albion,7352,10,8,6,22,57,80,-23,30
Ayr,7353,1,24,4,8,93,42,51,76
Raith,7353,2,22,9,5,70,34,36,75
Alloa,7353,3,17,9,10,58,45,13,60
Arbroath,7353,4,17,8,11,70,53,17,59
Stranraer,7353,5,15,5,16,57,68,-11,50
East Fife,7353,6,14,3,19,51,66,-15,45
Airdrieon,7353,7,10,12,14,46,59,-13,42
Forfar,7353,8,10,6,20,39,65,-26,36
Queen's Park,7353,9,7,10,19,44,72,-28,31
Albion,7353,10,8,6,22,57,81,-24,30
Ayr,7354,1,24,4,8,92,43,49,76
Raith,7354,2,22,8,6,68,34,34,74
Arbroath,7354,3,18,8,10,75,49,26,62
Alloa,7354,4,18,8,10,58,43,15,62
Stranraer,7354,5,16,5,15,57,64,-7,53
East Fife,7354,6,13,3,20,47,66,-19,42
Airdrieon,7354,7,10,11,15,46,60,-14,41
Forfar,7354,8,11,5,20,40,65,-25,38
Albion,7354,9,8,6,22,58,80,-22,30
Queen's Park,7354,10,6,10,20,40,77,-37,28
Raith,7355,1,23,8,5,70,33,37,77
Ayr,7355,2,24,4,8,95,42,53,76
Arbroath,7355,3,17,8,11,70,49,21,59
Alloa,7355,4,17,8,11,57,45,12,59
Stranraer,7355,5,16,5,15,56,64,-8,53
Airdrieon,7355,6,11,11,14,49,59,-10,44
East Fife,7355,7,13,3,20,47,65,-18,42
Forfar,7355,8,10,5,21,39,68,-29,35
Queen's Park,7355,9,7,10,19,40,72,-32,31
Albion,7355,10,8,6,22,57,83,-26,30
Raith,7356,1,23,8,5,71,34,37,77
Ayr,7356,2,24,4,8,95,43,52,76
Arbroath,7356,3,18,8,10,73,50,23,62
Alloa,7356,4,17,8,11,58,46,12,59
Stranraer,7356,5,15,5,16,56,66,-10,50
East Fife,7356,6,14,3,19,49,65,-16,45
Airdrieon,7356,7,10,12,14,47,60,-13,42
Forfar,7356,8,10,6,20,40,66,-26,36
Albion,7356,9,8,6,22,58,83,-25,30
Queen's Park,7356,10,6,10,20,41,75,-34,28
Ayr,7357,1,24,4,8,93,42,51,76
Raith,7357,2,22,8,6,69,34,35,74
Alloa,7357,3,18,8,10,58,44,14,62
Arbroath,7357,4,17,8,11,70,50,20,59
Stranraer,7357,5,16,5,15,56,64,-8,53
Airdrieon,7357,6,10,12,14,46,59,-13,42
East Fife,7357,7,13,3,20,47,65,-18,42
Forfar,7357,8,10,6,20,39,65,-26,36
Queen's Park,7357,9,7,10,19,41,72,-31,31
Albion,7357,10,8,6,22,57,81,-24,30
Ayr,7358,1,24,4,8,93,43,50,76
Raith,7358,2,22,8,6,69,35,34,74
Alloa,7358,3,18,8,10,59,44,15,62
Arbroath,7358,4,17,8,11,71,50,21,59
Stranraer,7358,5,15,5,16,56,67,-11,50
East Fife,7358,6,14,3,19,50,65,-15,45
Airdrieon,7358,7,10,12,14,45,58,-13,42
Forfar,7358,8,10,6,20,38,64,-26,36
Queen's Park,7358,9,7,10,19,41,73,-32,31
Albion,7358,10,8,6,22,58,81,-23,30
Ayr,7359,1,24,4,8,92,43,49,76
Raith,7359,2,22,8,6,68,34,34,74
Alloa,7359,3,18,8,10,58,43,15,62
Arbroath,7359,4,17,8,11,72,52,20,59
Stranraer,7359,5,15,5,16,57,67,-10,50
East Fife,7359,6,14,3,19,50,66,-16,45
Airdrieon,7359,7,11,11,14,48,58,-10,44
Forfar,7359,8,10,5,21,38,67,-29,35
Queen's Park,7359,9,7,10,19,43,74,-31,31
Albion,7359,10,8,6,22,58,80,-22,30
Raith,7360,1,23,8,5,69,32,37,77
Ayr,7360,2,23,4,9,90,44,46,73
Arbroath,7360,3,18,8,10,72,49,23,62
Alloa,7360,4,17,8,11,56,44,12,59
Stranraer,7360,5,15,6,15,56,65,-9,51
East Fife,7360,6,13,4,19,48,65,-17,43
Airdrieon,7360,7,10,11,15,45,59,-14,41
Forfar,7360,8,11,5,20,39,64,-25,38
Albion,7360,9,9,6,21,59,78,-19,33
Queen's Park,7360,10,6,10,20,40,74,-34,28
Raith,7361,1,23,8,5,70,33,37,77
Ayr,7361,2,23,5,8,92,44,48,74
Arbroath,7361,3,18,8,10,73,49,24,62
Alloa,7361,4,17,8,11,57,45,12,59
Stranraer,7361,5,16,5,15,59,66,-7,53
Airdrieon,7361,6,11,11,14,48,59,-11,44
East Fife,7361,7,13,3,20,49,68,-19,42
Forfar,7361,8,10,5,21,39,67,-28,35
Albion,7361,9,8,7,21,59,80,-21,31
Queen's Park,7361,10,6,10,20,40,75,-35,28
Ayr,7362,1,24,4,8,97,43,54,76
Raith,7362,2,22,9,5,68,32,36,75
Arbroath,7362,3,17,9,10,72,50,22,60
Alloa,7362,4,17,9,10,56,43,13,60
Stranraer,7362,5,16,5,15,57,64,-7,53
Airdrieon,7362,6,11,11,14,48,59,-11,44
East Fife,7362,7,13,3,20,47,66,-19,42
Forfar,7362,8,10,5,21,39,67,-28,35
Albion,7362,9,8,6,22,58,85,-27,30
Queen's Park,7362,10,6,11,19,41,74,-33,29
Raith,7363,1,23,8,5,71,34,37,77
Ayr,7363,2,24,4,8,98,43,55,76
Arbroath,7363,3,18,8,10,72,48,24,62
Alloa,7363,4,17,8,11,58,46,12,59
Stranraer,7363,5,16,5,15,59,64,-5,53
Airdrieon,7363,6,11,11,14,51,59,-8,44
East Fife,7363,7,13,3,20,47,68,-21,42
Forfar,7363,8,10,5,21,39,70,-31,35
Albion,7363,9,8,6,22,58,86,-28,30
Queen's Park,7363,10,6,10,20,39,74,-35,28
Ayr,7364,1,24,4,8,94,44,50,76
Raith,7364,2,22,8,6,69,34,35,74
Arbroath,7364,3,18,8,10,71,48,23,62
Alloa,7364,4,18,8,10,58,44,14,62
Stranraer,7364,5,16,5,15,57,65,-8,53
East Fife,7364,6,13,3,20,48,66,-18,42
Airdrieon,7364,7,10,11,15,45,59,-14,41
Forfar,7364,8,11,5,20,39,64,-25,38
Albion,7364,9,8,6,22,59,82,-23,30
Queen's Park,7364,10,6,10,20,39,73,-34,28
Raith,7365,1,23,8,5,69,32,37,77
Ayr,7365,2,23,4,9,92,45,47,73
Arbroath,7365,3,17,9,10,71,49,22,60
Alloa,7365,4,17,8,11,56,44,12,59
Stranraer,7365,5,15,5,16,57,67,-10,50
East Fife,7365,6,14,3,19,50,66,-16,45
Airdrieon,7365,7,11,11,14,46,58,-12,44
Forfar,7365,8,10,5,21,38,65,-27,35
Albion,7365,9,9,6,21,60,80,-20,33
Queen's Park,7365,10,6,11,19,40,73,-33,29
Raith,7366,1,23,8,5,69,32,37,77
Ayr,7366,2,23,5,8,92,44,48,74
Arbroath,7366,3,17,9,10,71,49,22,60
Alloa,7366,4,17,8,11,56,44,12,59
Stranraer,7366,5,15,5,16,55,67,-12,50
East Fife,7366,6,14,3,19,50,64,-14,45
Airdrieon,7366,7,10,11,15,47,61,-14,41
Forfar,7366,8,11,5,20,41,66,-25,38
Albion,7366,9,8,7,21,59,80,-21,31
Queen's Park,7366,10,6,11,19,40,73,-33,29
Ayr,7367,1,24,4,8,94,42,52,76
Raith,7367,2,22,8,6,69,35,34,74
Arbroath,7367,3,18,8,10,72,48,24,62
Alloa,7367,4,18,8,10,59,44,15,62
Stranraer,7367,5,15,6,15,56,65,-9,51
East Fife,7367,6,13,4,19,48,65,-17,43
Airdrieon,7367,7,10,12,14,47,60,-13,42
Forfar,7367,8,10,6,20,40,66,-26,36
Albion,7367,9,8,6,22,57,82,-25,30
Queen's Park,7367,10,6,10,20,39,74,-35,28
Ayr,7368,1,24,4,8,92,43,49,76
Raith,7368,2,22,8,6,68,34,34,74
Arbroath,7368,3,18,8,10,72,48,24,62
Alloa,7368,4,18,8,10,58,43,15,62
Stranraer,7368,5,15,6,15,57,66,-9,51
East Fife,7368,6,13,4,19,49,66,-17,43
Airdrieon,7368,7,10,12,14,45,58,-13,42
Forfar,7368,8,10,6,20,38,64,-26,36
Albion,7368,9,8,6,22,58,80,-22,30
Queen's Park,7368,10,6,10,20,39,74,-35,28
Ayr,7369,1,24,4,8,95,42,53,76
Raith,7369,2,22,9,5,68,32,36,75
Arbroath,7369,3,18,8,10,73,48,25,62
Alloa,7369,4,17,9,10,56,43,13,60
Stranraer,7369,5,16,5,15,56,64,-8,53
East Fife,7369,6,13,3,20,47,65,-18,42
Airdrieon,7369,7,10,11,15,46,60,-14,41
Forfar,7369,8,11,5,20,40,65,-25,38
Albion,7369,9,8,6,22,57,83,-26,30
Queen's Park,7369,10,6,10,20,39,75,-36,28
Ayr,7370,1,24,4,8,93,42,51,76
Raith,7370,2,22,9,5,69,33,36,75
Arbroath,7370,3,18,8,10,73,49,24,62
Alloa,7370,4,17,9,10,57,44,13,60
Stranraer,7370,5,15,6,15,57,66,-9,51
East Fife,7370,6,13,4,19,49,66,-17,43
Airdrieon,7370,7,10,11,15,47,61,-14,41
Forfar,7370,8,11,5,20,41,66,-25,38
Albion,7370,9,8,6,22,57,81,-24,30
Queen's Park,7370,10,6,10,20,40,75,-35,28
Ayr,7371,1,24,4,8,92,43,49,76
Raith,7371,2,22,8,6,68,34,34,74
Arbroath,7371,3,18,8,10,73,49,24,62
Alloa,7371,4,18,8,10,58,43,15,62
Stranraer,7371,5,16,5,15,57,65,-8,53
Airdrieon,7371,6,11,11,14,48,60,-12,44
East Fife,7371,7,13,3,20,48,66,-18,42
Forfar,7371,8,10,5,21,40,67,-27,35
Albion,7371,9,8,6,22,58,80,-22,30
Queen's Park,7371,10,6,10,20,40,75,-35,28
Raith,7372,1,23,8,5,69,32,37,77
Ayr,7372,2,24,4,8,94,43,51,76
Arbroath,7372,3,17,9,10,71,49,22,60
Alloa,7372,4,17,8,11,56,44,12,59
Stranraer,7372,5,15,6,15,57,66,-9,51
Airdrieon,7372,6,11,11,14,48,59,-11,44
East Fife,7372,7,13,4,19,49,66,-17,43
Forfar,7372,8,10,5,21,39,67,-28,35
Albion,7372,9,8,6,22,58,82,-24,30
Queen's Park,7372,10,6,11,19,40,73,-33,29
Raith,7373,1,23,8,5,71,32,39,77
Ayr,7373,2,24,4,8,93,42,51,76
Arbroath,7373,3,18,8,10,73,49,24,62
Alloa,7373,4,17,8,11,56,46,10,59
Stranraer,7373,5,15,5,16,55,65,-10,50
East Fife,7373,6,14,3,19,48,64,-16,45
Airdrieon,7373,7,11,11,14,46,58,-12,44
Forfar,7373,8,10,5,21,38,65,-27,35
Albion,7373,9,8,6,22,57,81,-24,30
Queen's Park,7373,10,6,10,20,40,75,-35,28
Ayr,7374,1,24,4,8,93,43,50,76
Raith,7374,2,22,9,5,69,33,36,75
Arbroath,7374,3,17,9,10,71,49,22,60
Alloa,7374,4,17,9,10,57,44,13,60
Stranraer,7374,5,16,5,15,58,65,-7,53
Airdrieon,7374,6,11,11,14,47,58,-11,44
East Fife,7374,7,13,3,20,48,67,-19,42
Forfar,7374,8,10,5,21,38,66,-28,35
Albion,7374,9,8,6,22,58,81,-23,30
Queen's Park,7374,10,6,11,19,40,73,-33,29
Raith,7375,1,23,8,5,70,32,38,77
Ayr,7375,2,24,4,8,92,43,49,76
Arbroath,7375,3,17,8,11,70,51,19,59
Alloa,7375,4,17,8,11,56,45,11,59
Stranraer,7375,5,15,6,15,55,64,-9,51
Airdrieon,7375,6,11,11,14,47,59,-12,44
East Fife,7375,7,13,4,19,47,64,-17,43
Forfar,7375,8,10,5,21,39,66,-27,35
Queen's Park,7375,9,7,10,19,42,72,-30,31
Albion,7375,10,8,6,22,58,80,-22,30
Ayr,7376,1,24,4,8,96,44,52,76
Raith,7376,2,22,9,5,70,34,36,75
Arbroath,7376,3,18,8,10,73,49,24,62
Alloa,7376,4,17,9,10,58,45,13,60
Stranraer,7376,5,15,5,16,57,67,-10,50
East Fife,7376,6,14,3,19,50,66,-16,45
Airdrieon,7376,7,11,11,14,47,59,-12,44
Forfar,7376,8,10,5,21,39,66,-27,35
Albion,7376,9,8,6,22,59,84,-25,30
Queen's Park,7376,10,6,10,20,40,75,-35,28
Raith,7377,1,23,8,5,71,33,38,77
Ayr,7377,2,24,4,8,95,43,52,76
Arbroath,7377,3,17,8,11,71,50,21,59
Alloa,7377,4,17,8,11,57,46,11,59
Stranraer,7377,5,15,5,16,55,66,-11,50
East Fife,7377,6,14,3,19,49,64,-15,45
Airdrieon,7377,7,10,11,15,46,60,-14,41
Forfar,7377,8,11,5,20,40,65,-25,38
Queen's Park,7377,9,7,10,19,41,73,-32,31
Albion,7377,10,8,6,22,58,83,-25,30
Raith,7378,1,23,8,5,70,33,37,77
Ayr,7378,2,24,4,8,93,42,51,76
Arbroath,7378,3,17,9,10,71,49,22,60
Alloa,7378,4,17,8,11,57,45,12,59
Stranraer,7378,5,15,6,15,57,66,-9,51
Airdrieon,7378,6,11,11,14,49,60,-11,44
East Fife,7378,7,13,4,19,49,66,-17,43
Forfar,7378,8,10,5,21,40,68,-28,35
Albion,7378,9,8,6,22,57,81,-24,30
Queen's Park,7378,10,6,11,19,40,73,-33,29
Ayr,7379,1,24,4,8,92,43,49,76
Raith,7379,2,22,9,5,70,34,36,75
Arbroath,7379,3,17,9,10,71,49,22,60
Alloa,7379,4,17,9,10,58,45,13,60
Stranraer,7379,5,15,5,16,55,65,-10,50
East Fife,7379,6,14,3,19,48,64,-16,45
Airdrieon,7379,7,10,12,14,47,60,-13,42
Forfar,7379,8,10,6,20,40,66,-26,36
Albion,7379,9,8,6,22,58,80,-22,30
Queen's Park,7379,10,6,11,19,40,73,-33,29
Ayr,7380,1,24,4,8,95,42,53,76
Raith,7380,2,22,8,6,69,34,35,74
Alloa,7380,3,18,8,10,58,44,14,62
Arbroath,7380,4,17,9,10,70,48,22,60
Stranraer,7380,5,15,6,15,57,66,-9,51
East Fife,7380,6,13,4,19,49,66,-17,43
Airdrieon,7380,7,10,12,14,46,59,-13,42
Forfar,7380,8,10,6,20,39,65,-26,36
Albion,7380,9,8,6,22,57,83,-26,30
Queen's Park,7380,10,6,11,19,39,72,-33,29
Raith,7381,1,23,8,5,69,32,37,77
Ayr,7381,2,24,4,8,92,42,50,76
Arbroath,7381,3,17,9,10,71,49,22,60
Alloa,7381,4,17,8,11,56,44,12,59
Stranraer,7381,5,15,5,16,57,68,-11,50
East Fife,7381,6,14,3,19,51,66,-15,45
Airdrieon,7381,7,10,11,15,45,61,-16,41
Forfar,7381,8,11,5,20,41,64,-23,38
Albion,7381,9,8,6,22,57,80,-23,30
Queen's Park,7381,10,6,11,19,40,73,-33,29
Ayr,7382,1,24,4,8,92,42,50,76
Raith,7382,2,22,9,5,68,32,36,75
Arbroath,7382,3,17,9,10,71,49,22,60
Alloa,7382,4,17,9,10,56,43,13,60
Stranraer,7382,5,16,5,15,58,66,-8,53
Airdrieon,7382,6,10,12,14,46,59,-13,42
East Fife,7382,7,13,3,20,49,67,-18,42
Forfar,7382,8,10,6,20,39,65,-26,36
Albion,7382,9,8,6,22,57,80,-23,30
Queen's Park,7382,10,6,11,19,40,73,-33,29
Ayr,7383,1,24,4,8,91,42,49,76
Raith,7383,2,22,9,5,68,32,36,75
Arbroath,7383,3,18,8,10,74,49,25,62
Alloa,7383,4,17,9,10,56,43,13,60
Stranraer,7383,5,15,5,16,56,66,-10,50
East Fife,7383,6,14,3,19,49,65,-16,45
Airdrieon,7383,7,10,11,15,46,60,-14,41
Forfar,7383,8,11,5,20,40,65,-25,38
Albion,7383,9,8,6,22,57,79,-22,30
Queen's Park,7383,10,6,10,20,40,76,-36,28
Raith,7384,1,23,8,5,70,32,38,77
Ayr,7384,2,24,4,8,93,43,50,76
Arbroath,7384,3,18,8,10,73,48,25,62
Alloa,7384,4,17,8,11,56,45,11,59
Stranraer,7384,5,16,5,15,57,64,-7,53
East Fife,7384,6,13,3,20,47,66,-19,42
Airdrieon,7384,7,10,11,15,45,64,-19,41
Forfar,7384,8,11,5,20,44,64,-20,38
Albion,7384,9,8,6,22,58,81,-23,30
Queen's Park,7384,10,6,10,20,39,75,-36,28
Raith,7385,1,23,8,5,71,34,37,77
Ayr,7385,2,24,4,8,94,43,51,76
Arbroath,7385,3,17,8,11,71,50,21,59
Alloa,7385,4,17,8,11,58,46,12,59
Stranraer,7385,5,16,5,15,57,65,-8,53
Airdrieon,7385,6,11,11,14,47,58,-11,44
East Fife,7385,7,13,3,20,48,66,-18,42
Forfar,7385,8,10,5,21,38,66,-28,35
Queen's Park,7385,9,7,10,19,41,73,-32,31
Albion,7385,10,8,6,22,58,82,-24,30
Raith,7386,1,23,8,5,71,32,39,77
Ayr,7386,2,24,4,8,93,44,49,76
Arbroath,7386,3,17,9,10,71,49,22,60
Alloa,7386,4,17,8,11,56,46,10,59
Stranraer,7386,5,15,5,16,55,66,-11,50
East Fife,7386,6,14,3,19,49,64,-15,45
Airdrieon,7386,7,11,11,14,47,58,-11,44
Forfar,7386,8,10,5,21,38,66,-28,35
Albion,7386,9,8,6,22,59,81,-22,30
Queen's Park,7386,10,6,11,19,40,73,-33,29
Raith,7387,1,23,8,5,69,32,37,77
Ayr,7387,2,23,5,8,92,44,48,74
Arbroath,7387,3,17,8,11,71,51,20,59
Alloa,7387,4,17,8,11,56,44,12,59
Stranraer,7387,5,16,5,15,59,66,-7,53
Airdrieon,7387,6,10,12,14,46,59,-13,42
East Fife,7387,7,13,3,20,49,68,-19,42
Forfar,7387,8,10,6,20,39,65,-26,36
Albion,7387,9,8,7,21,59,80,-21,31
Queen's Park,7387,10,7,10,19,42,73,-31,31
Raith,7388,1,23,8,5,72,34,38,77
Ayr,7388,2,23,4,9,91,44,47,73
Arbroath,7388,3,17,8,11,70,52,18,59
Alloa,7388,4,17,8,11,58,47,11,59
Stranraer,7388,5,15,6,15,56,65,-9,51
Airdrieon,7388,6,11,11,14,48,59,-11,44
East Fife,7388,7,13,4,19,48,65,-17,43
Forfar,7388,8,10,5,21,39,67,-28,35
Albion,7388,9,9,6,21,59,79,-20,33
Queen's Park,7388,10,7,10,19,43,72,-29,31
Raith,7389,1,23,8,5,72,33,39,77
Ayr,7389,2,24,4,8,95,42,53,76
Arbroath,7389,3,18,8,10,73,50,23,62
Alloa,7389,4,17,8,11,57,47,10,59
Stranraer,7389,5,16,5,15,57,65,-8,53
Airdrieon,7389,6,11,11,14,46,58,-12,44
East Fife,7389,7,13,3,20,48,66,-18,42
Forfar,7389,8,10,5,21,38,65,-27,35
Albion,7389,9,8,6,22,57,83,-26,30
Queen's Park,7389,10,6,10,20,41,75,-34,28
Raith,7390,1,23,8,5,70,32,38,77
Ayr,7390,2,24,4,8,92,43,49,76
Arbroath,7390,3,17,8,11,71,51,20,59
Alloa,7390,4,17,8,11,56,45,11,59
Stranraer,7390,5,16,5,15,58,66,-8,53
Airdrieon,7390,6,10,12,14,46,59,-13,42
East Fife,7390,7,13,3,20,49,67,-18,42
Forfar,7390,8,10,6,20,39,65,-26,36
Queen's Park,7390,9,7,10,19,42,73,-31,31
Albion,7390,10,8,6,22,58,80,-22,30
Ayr,7391,1,24,4,8,95,42,53,76
Raith,7391,2,22,8,6,70,35,35,74
Alloa,7391,3,18,8,10,59,45,14,62
Arbroath,7391,4,17,9,10,71,49,22,60
Stranraer,7391,5,15,6,15,56,65,-9,51
Airdrieon,7391,6,11,11,14,47,58,-11,44
East Fife,7391,7,13,4,19,48,65,-17,43
Forfar,7391,8,10,5,21,38,66,-28,35
Albion,7391,9,8,6,22,57,83,-26,30
Queen's Park,7391,10,6,11,19,40,73,-33,29
Ayr,7392,1,23,5,8,91,43,48,74
Raith,7392,2,22,8,6,70,35,35,74
Alloa,7392,3,18,8,10,59,45,14,62
Arbroath,7392,4,17,9,10,71,49,22,60
Stranraer,7392,5,16,5,15,59,65,-6,53
Airdrieon,7392,6,10,12,14,47,60,-13,42
East Fife,7392,7,13,3,20,48,68,-20,42
Forfar,7392,8,10,6,20,40,66,-26,36
Albion,7392,9,8,7,21,58,79,-21,31
Queen's Park,7392,10,6,11,19,40,73,-33,29
Raith,7393,1,23,8,5,70,32,38,77
Ayr,7393,2,24,4,8,96,44,52,76
Arbroath,7393,3,17,8,11,70,49,21,59
Alloa,7393,4,17,8,11,56,45,11,59
Stranraer,7393,5,16,5,15,57,65,-8,53
East Fife,7393,6,13,3,20,48,66,-18,42
Airdrieon,7393,7,10,11,15,46,61,-15,41
Forfar,7393,8,11,5,20,41,65,-24,38
Queen's Park,7393,9,7,10,19,40,72,-32,31
Albion,7393,10,8,6,22,59,84,-25,30
Raith,7394,1,23,8,5,70,33,37,77
Ayr,7394,2,23,5,8,92,44,48,74
Arbroath,7394,3,18,8,10,74,49,25,62
Alloa,7394,4,17,8,11,57,45,12,59
Stranraer,7394,5,15,5,16,56,67,-11,50
East Fife,7394,6,14,3,19,50,65,-15,45
Airdrieon,7394,7,10,11,15,45,60,-15,41
Forfar,7394,8,11,5,20,40,64,-24,38
Albion,7394,9,8,7,21,59,80,-21,31
Queen's Park,7394,10,6,10,20,40,76,-36,28
Ayr,7395,1,24,4,8,94,43,51,76
Raith,7395,2,22,9,5,70,34,36,75
Arbroath,7395,3,18,8,10,72,49,23,62
Alloa,7395,4,17,9,10,58,45,13,60
Stranraer,7395,5,15,5,16,56,66,-10,50
East Fife,7395,6,14,3,19,49,65,-16,45
Airdrieon,7395,7,11,11,14,47,58,-11,44
Forfar,7395,8,10,5,21,38,66,-28,35
Albion,7395,9,8,6,22,58,82,-24,30
Queen's Park,7395,10,6,10,20,40,74,-34,28
Ayr,7396,1,24,4,8,95,43,52,76
Raith,7396,2,22,9,5,69,33,36,75
Alloa,7396,3,17,9,10,57,44,13,60
Arbroath,7396,4,17,8,11,71,50,21,59
Stranraer,7396,5,16,5,15,58,66,-8,53
Airdrieon,7396,6,11,11,14,46,58,-12,44
East Fife,7396,7,13,3,20,49,67,-18,42
Forfar,7396,8,10,5,21,38,65,-27,35
Queen's Park,7396,9,7,10,19,41,73,-32,31
Albion,7396,10,8,6,22,58,83,-25,30
Raith,7397,1,23,8,5,69,32,37,77
Ayr,7397,2,23,4,9,92,47,45,73
Arbroath,7397,3,17,9,10,71,49,22,60
Alloa,7397,4,17,8,11,56,44,12,59
Stranraer,7397,5,15,5,16,55,65,-10,50
East Fife,7397,6,14,3,19,48,64,-16,45
Airdrieon,7397,7,11,11,14,48,58,-10,44
Forfar,7397,8,10,5,21,38,67,-29,35
Albion,7397,9,9,6,21,62,80,-18,33
Queen's Park,7397,10,6,11,19,40,73,-33,29
Raith,7398,1,23,8,5,70,33,37,77
Ayr,7398,2,24,4,8,98,42,56,76
Arbroath,7398,3,18,8,10,71,48,23,62
Alloa,7398,4,17,8,11,57,45,12,59
Stranraer,7398,5,16,5,15,56,64,-8,53
East Fife,7398,6,13,3,20,47,65,-18,42
Airdrieon,7398,7,10,11,15,45,59,-14,41
Forfar,7398,8,11,5,20,39,64,-25,38
Albion,7398,9,8,6,22,57,86,-29,30
Queen's Park,7398,10,6,10,20,39,73,-34,28
Raith,7399,1,23,8,5,70,33,37,77
Ayr,7399,2,24,4,8,94,43,51,76
Arbroath,7399,3,18,8,10,73,50,23,62
Alloa,7399,4,17,8,11,57,45,12,59
Stranraer,7399,5,15,5,16,55,69,-14,50
East Fife,7399,6,14,3,19,52,64,-12,45
Airdrieon,7399,7,11,11,14,48,59,-11,44
Forfar,7399,8,10,5,21,39,67,-28,35
Albion,7399,9,8,6,22,58,82,-24,30
Queen's Park,7399,10,6,10,20,41,75,-34,28
Raith,7400,1,23,8,5,69,32,37,77
Ayr,7400,2,23,5,8,92,44,48,74
Arbroath,7400,3,18,8,10,73,49,24,62
Alloa,7400,4,17,8,11,56,44,12,59
Stranraer,7400,5,15,5,16,55,65,-10,50
East Fife,7400,6,14,3,19,48,64,-16,45
Airdrieon,7400,7,11,11,14,46,58,-12,44
Forfar,7400,8,10,5,21,38,65,-27,35
Albion,7400,9,8,7,21,59,80,-21,31
Queen's Park,7400,10,6,10,20,40,75,-35,28
Ayr,7401,1,24,4,8,93,42,51,76
Raith,7401,2,22,8,6,68,33,35,74
Alloa,7401,3,18,8,10,57,43,14,62
Arbroath,7401,4,17,9,10,71,49,22,60
Stranraer,7401,5,15,5,16,57,69,-12,50
East Fife,7401,6,14,3,19,52,66,-14,45
Airdrieon,7401,7,10,11,15,47,61,-14,41
Forfar,7401,8,11,5,20,41,66,-25,38
Albion,7401,9,8,6,22,57,81,-24,30
Queen's Park,7401,10,6,11,19,40,73,-33,29
Raith,7402,1,23,8,5,70,33,37,77
Ayr,7402,2,24,4,8,93,43,50,76
Arbroath,7402,3,18,8,10,71,48,23,62
Alloa,7402,4,17,8,11,57,45,12,59
Stranraer,7402,5,15,5,16,56,66,-10,50
East Fife,7402,6,14,3,19,49,65,-16,45
Airdrieon,7402,7,10,12,14,45,58,-13,42
Forfar,7402,8,10,6,20,38,64,-26,36
Albion,7402,9,8,6,22,58,81,-23,30
Queen's Park,7402,10,6,10,20,39,73,-34,28
Raith,7403,1,23,8,5,71,32,39,77
Ayr,7403,2,24,4,8,94,44,50,76
Arbroath,7403,3,17,8,11,71,51,20,59
Alloa,7403,4,17,8,11,56,46,10,59
Stranraer,7403,5,15,5,16,55,65,-10,50
East Fife,7403,6,14,3,19,48,64,-16,45
Airdrieon,7403,7,10,11,15,45,59,-14,41
Forfar,7403,8,11,5,20,39,64,-25,38
Queen's Park,7403,9,7,10,19,42,73,-31,31
Albion,7403,10,8,6,22,59,82,-23,30
Raith,7404,1,23,8,5,69,32,37,77
Ayr,7404,2,24,4,8,92,43,49,76
Arbroath,7404,3,17,8,11,71,51,20,59
Alloa,7404,4,17,8,11,56,44,12,59
Stranraer,7404,5,16,5,15,56,64,-8,53
East Fife,7404,6,13,3,20,47,65,-18,42
Airdrieon,7404,7,10,11,15,45,59,-14,41
Forfar,7404,8,11,5,20,39,64,-25,38
Queen's Park,7404,9,7,10,19,42,73,-31,31
Albion,7404,10,8,6,22,58,80,-22,30
Raith,7405,1,23,8,5,71,32,39,77
Ayr,7405,2,24,4,8,95,42,53,76
Arbroath,7405,3,18,8,10,74,49,25,62
Alloa,7405,4,17,8,11,56,46,10,59
Stranraer,7405,5,15,5,16,57,67,-10,50
East Fife,7405,6,14,3,19,50,66,-16,45
Airdrieon,7405,7,11,11,14,46,58,-12,44
Forfar,7405,8,10,5,21,38,65,-27,35
Albion,7405,9,8,6,22,57,83,-26,30
Queen's Park,7405,10,6,10,20,40,76,-36,28
Ayr,7406,1,24,4,8,93,43,50,76
Raith,7406,2,22,8,6,68,33,35,74
Alloa,7406,3,18,8,10,57,43,14,62
Arbroath,7406,4,17,9,10,70,48,22,60
Stranraer,7406,5,15,5,16,56,66,-10,50
East Fife,7406,6,14,3,19,49,65,-16,45
Airdrieon,7406,7,10,11,15,45,60,-15,41
Forfar,7406,8,11,5,20,40,64,-24,38
Albion,7406,9,8,6,22,58,81,-23,30
Queen's Park,7406,10,6,11,19,39,72,-33,29
Ayr,7407,1,24,4,8,97,45,52,76
Raith,7407,2,22,9,5,68,32,36,75
Arbroath,7407,3,17,9,10,70,48,22,60
Alloa,7407,4,17,9,10,56,43,13,60
Stranraer,7407,5,15,5,16,55,65,-10,50
East Fife,7407,6,14,3,19,48,64,-16,45
Airdrieon,7407,7,10,11,15,46,61,-15,41
Forfar,7407,8,11,5,20,41,65,-24,38
Albion,7407,9,8,6,22,60,85,-25,30
Queen's Park,7407,10,6,11,19,39,72,-33,29
Ayr,7408,1,24,4,8,95,43,52,76
Raith,7408,2,22,9,5,71,35,36,75
Arbroath,7408,3,18,8,10,71,48,23,62
Alloa,7408,4,17,9,10,59,46,13,60
Stranraer,7408,5,16,5,15,57,65,-8,53
Airdrieon,7408,6,10,12,14,47,60,-13,42
East Fife,7408,7,13,3,20,48,66,-18,42
Forfar,7408,8,10,6,20,40,66,-26,36
Albion,7408,9,8,6,22,58,83,-25,30
Queen's Park,7408,10,6,10,20,39,73,-34,28
Raith,7409,1,23,8,5,71,32,39,77
Ayr,7409,2,24,4,8,94,44,50,76
Arbroath,7409,3,17,8,11,71,50,21,59
Alloa,7409,4,17,8,11,56,46,10,59
Stranraer,7409,5,16,5,15,57,64,-7,53
Airdrieon,7409,6,10,12,14,46,59,-13,42
East Fife,7409,7,13,3,20,47,66,-19,42
Forfar,7409,8,10,6,20,39,65,-26,36
Queen's Park,7409,9,7,10,19,41,73,-32,31
Albion,7409,10,8,6,22,59,82,-23,30
Raith,7410,1,23,8,5,69,32,37,77
Ayr,7410,2,24,4,8,91,42,49,76
Arbroath,7410,3,17,9,10,71,49,22,60
Alloa,7410,4,17,8,11,56,44,12,59
Stranraer,7410,5,15,6,15,56,65,-9,51
East Fife,7410,6,13,4,19,48,65,-17,43
Airdrieon,7410,7,10,12,14,45,58,-13,42
Forfar,7410,8,10,6,20,38,64,-26,36
Albion,7410,9,8,6,22,57,79,-22,30
Queen's Park,7410,10,6,11,19,40,73,-33,29
Ayr,7411,1,24,4,8,94,43,51,76
Raith,7411,2,22,9,5,70,34,36,75
Alloa,7411,3,17,9,10,58,45,13,60
Arbroath,7411,4,17,8,11,70,50,20,59
Stranraer,7411,5,15,5,16,56,66,-10,50
East Fife,7411,6,14,3,19,49,65,-16,45
Airdrieon,7411,7,11,11,14,47,59,-12,44
Forfar,7411,8,10,5,21,39,66,-27,35
Queen's Park,7411,9,7,10,19,41,72,-31,31
Albion,7411,10,8,6,22,58,82,-24,30
Raith,7412,1,23,8,5,70,32,38,77
Ayr,7412,2,24,4,8,94,44,50,76
Arbroath,7412,3,18,8,10,71,48,23,62
Alloa,7412,4,17,8,11,56,45,11,59
Stranraer,7412,5,16,5,15,57,64,-7,53
Airdrieon,7412,6,11,11,14,47,59,-12,44
East Fife,7412,7,13,3,20,47,66,-19,42
Forfar,7412,8,10,5,21,39,66,-27,35
Albion,7412,9,8,6,22,59,82,-23,30
Queen's Park,7412,10,6,10,20,39,73,-34,28
Ayr,7413,1,24,4,8,94,43,51,76
Raith,7413,2,22,9,5,69,33,36,75
Alloa,7413,3,17,9,10,57,44,13,60
Arbroath,7413,4,17,8,11,71,50,21,59
Stranraer,7413,5,15,5,16,55,66,-11,50
East Fife,7413,6,14,3,19,49,64,-15,45
Airdrieon,7413,7,10,12,14,47,60,-13,42
Forfar,7413,8,10,6,20,40,66,-26,36
Queen's Park,7413,9,7,10,19,41,73,-32,31
Albion,7413,10,8,6,22,58,82,-24,30
Raith,7414,1,22,9,5,69,33,36,75
Ayr,7414,2,23,4,9,93,47,46,73
Arbroath,7414,3,18,8,10,71,48,23,62
Alloa,7414,4,17,9,10,57,44,13,60
Stranraer,7414,5,15,5,16,55,66,-11,50
East Fife,7414,6,14,3,19,49,64,-15,45
Airdrieon,7414,7,10,11,15,48,63,-15,41
Forfar,7414,8,11,5,20,43,67,-24,38
Albion,7414,9,9,6,21,62,81,-19,33
Queen's Park,7414,10,6,10,20,39,73,-34,28
Raith,7415,1,23,8,5,70,32,38,77
Ayr,7415,2,23,4,9,91,44,47,73
Arbroath,7415,3,17,8,11,71,52,19,59
Alloa,7415,4,17,8,11,56,45,11,59
Stranraer,7415,5,15,6,15,56,65,-9,51
Airdrieon,7415,6,11,11,14,46,58,-12,44
East Fife,7415,7,13,4,19,48,65,-17,43
Forfar,7415,8,10,5,21,38,65,-27,35
Albion,7415,9,9,6,21,59,79,-20,33
Queen's Park,7415,10,7,10,19,43,73,-30,31
Ayr,7416,1,24,4,8,97,43,54,76
Raith,7416,2,22,8,6,68,33,35,74
Arbroath,7416,3,18,8,10,73,49,24,62
Alloa,7416,4,18,8,10,57,43,14,62
Stranraer,7416,5,15,6,15,57,66,-9,51
East Fife,7416,6,13,4,19,49,66,-17,43
Airdrieon,7416,7,10,12,14,45,58,-13,42
Forfar,7416,8,10,6,20,38,64,-26,36
Albion,7416,9,8,6,22,58,85,-27,30
Queen's Park,7416,10,6,10,20,40,75,-35,28
Ayr,7417,1,24,4,8,93,42,51,76
Raith,7417,2,22,8,6,69,34,35,74
Arbroath,7417,3,18,8,10,74,51,23,62
Alloa,7417,4,18,8,10,58,44,14,62
Stranraer,7417,5,15,6,15,56,65,-9,51
East Fife,7417,6,13,4,19,48,65,-17,43
Airdrieon,7417,7,10,12,14,45,58,-13,42
Forfar,7417,8,10,6,20,38,64,-26,36
Albion,7417,9,8,6,22,57,81,-24,30
Queen's Park,7417,10,6,10,20,42,76,-34,28
Raith,7418,1,23,8,5,71,32,39,77
Ayr,7418,2,24,4,8,95,44,51,76
Arbroath,7418,3,17,8,11,71,52,19,59
Alloa,7418,4,17,8,11,56,46,10,59
Stranraer,7418,5,16,5,15,57,64,-7,53
Airdrieon,7418,6,11,11,14,48,58,-10,44
East Fife,7418,7,13,3,20,47,66,-19,42
Forfar,7418,8,10,5,21,38,67,-29,35
Queen's Park,7418,9,7,10,19,43,73,-30,31
Albion,7418,10,8,6,22,59,83,-24,30
Raith,7419,1,23,8,5,73,32,41,77
Ayr,7419,2,24,4,8,92,43,49,76
Arbroath,7419,3,18,8,10,74,49,25,62
Alloa,7419,4,17,8,11,56,48,8,59
Stranraer,7419,5,15,5,16,55,65,-10,50
East Fife,7419,6,14,3,19,48,64,-16,45
Airdrieon,7419,7,10,12,14,45,58,-13,42
Forfar,7419,8,10,6,20,38,64,-26,36
Albion,7419,9,8,6,22,58,80,-22,30
Queen's Park,7419,10,6,10,20,40,76,-36,28
Raith,7420,1,23,8,5,69,32,37,77
Ayr,7420,2,24,4,8,96,42,54,76
Arbroath,7420,3,18,8,10,73,49,24,62
Alloa,7420,4,17,8,11,56,44,12,59
Stranraer,7420,5,15,5,16,56,67,-11,50
East Fife,7420,6,14,3,19,50,65,-15,45
Airdrieon,7420,7,10,11,15,45,60,-15,41
Forfar,7420,8,11,5,20,40,64,-24,38
Albion,7420,9,8,6,22,57,84,-27,30
Queen's Park,7420,10,6,10,20,40,75,-35,28
Raith,7421,1,23,8,5,69,32,37,77
Ayr,7421,2,24,4,8,95,42,53,76
Arbroath,7421,3,17,8,11,72,51,21,59
Alloa,7421,4,17,8,11,56,44,12,59
Stranraer,7421,5,16,5,15,59,66,-7,53
Airdrieon,7421,6,11,11,14,47,59,-12,44
East Fife,7421,7,13,3,20,49,68,-19,42
Forfar,7421,8,10,5,21,39,66,-27,35
Queen's Park,7421,9,7,10,19,42,74,-32,31
Albion,7421,10,8,6,22,57,83,-26,30
Raith,7422,1,23,8,5,69,32,37,77
Ayr,7422,2,24,4,8,100,44,56,76
Arbroath,7422,3,18,8,10,73,50,23,62
Alloa,7422,4,17,8,11,56,44,12,59
Stranraer,7422,5,15,5,16,57,67,-10,50
East Fife,7422,6,14,3,19,50,66,-16,45
Airdrieon,7422,7,10,12,14,45,58,-13,42
Forfar,7422,8,10,6,20,38,64,-26,36
Albion,7422,9,8,6,22,59,88,-29,30
Queen's Park,7422,10,6,10,20,41,75,-34,28
Raith,7423,1,23,8,5,70,32,38,77
Ayr,7423,2,23,4,9,92,45,47,73
Arbroath,7423,3,17,9,10,72,50,22,60
Alloa,7423,4,17,8,11,56,45,11,59
Stranraer,7423,5,16,5,15,56,64,-8,53
Airdrieon,7423,6,10,12,14,46,59,-13,42
East Fife,7423,7,13,3,20,47,65,-18,42
Forfar,7423,8,10,6,20,39,65,-26,36
Albion,7423,9,9,6,21,60,80,-20,33
Queen's Park,7423,10,6,11,19,41,74,-33,29
Raith,7424,1,23,8,5,71,33,38,77
Ayr,7424,2,24,4,8,92,42,50,76
Arbroath,7424,3,17,8,11,71,51,20,59
Alloa,7424,4,17,8,11,57,46,11,59
Stranraer,7424,5,16,5,15,60,66,-6,53
Airdrieon,7424,6,11,11,14,46,58,-12,44
East Fife,7424,7,13,3,20,49,69,-20,42
Forfar,7424,8,10,5,21,38,65,-27,35
Queen's Park,7424,9,7,10,19,42,73,-31,31
Albion,7424,10,8,6,22,57,80,-23,30
Ayr,7425,1,24,4,8,92,42,50,76
Raith,7425,2,22,8,6,69,35,34,74
Arbroath,7425,3,18,8,10,71,48,23,62
Alloa,7425,4,18,8,10,59,44,15,62
Stranraer,7425,5,15,5,16,56,69,-13,50
East Fife,7425,6,14,3,19,52,65,-13,45
Airdrieon,7425,7,11,11,14,49,60,-11,44
Forfar,7425,8,10,5,21,40,68,-28,35
Albion,7425,9,8,6,22,57,80,-23,30
Queen's Park,7425,10,6,10,20,39,73,-34,28
Raith,7426,1,23,8,5,70,32,38,77
Ayr,7426,2,23,5,8,91,43,48,74
Arbroath,7426,3,17,8,11,70,50,20,59
Alloa,7426,4,17,8,11,56,45,11,59
Stranraer,7426,5,15,5,16,55,67,-12,50
East Fife,7426,6,14,3,19,50,64,-14,45
Airdrieon,7426,7,11,11,14,47,58,-11,44
Forfar,7426,8,10,5,21,38,66,-28,35
Albion,7426,9,8,7,21,58,79,-21,31
Queen's Park,7426,10,7,10,19,41,72,-31,31
Raith,7427,1,23,8,5,70,33,37,77
Ayr,7427,2,24,4,8,94,42,52,76
Arbroath,7427,3,18,8,10,71,48,23,62
Alloa,7427,4,17,8,11,57,45,12,59
Stranraer,7427,5,15,5,16,56,67,-11,50
East Fife,7427,6,14,3,19,50,65,-15,45
Airdrieon,7427,7,10,12,14,46,59,-13,42
Forfar,7427,8,10,6,20,39,65,-26,36
Albion,7427,9,8,6,22,57,82,-25,30
Queen's Park,7427,10,6,10,20,39,73,-34,28
Raith,7428,1,23,8,5,73,33,40,77
Ayr,7428,2,24,4,8,93,43,50,76
Arbroath,7428,3,17,8,11,71,50,21,59
Alloa,7428,4,17,8,11,57,48,9,59
Stranraer,7428,5,15,5,16,55,65,-10,50
East Fife,7428,6,14,3,19,48,64,-16,45
Airdrieon,7428,7,11,11,14,47,59,-12,44
Forfar,7428,8,10,5,21,39,66,-27,35
Queen's Park,7428,9,7,10,19,41,73,-32,31
Albion,7428,10,8,6,22,58,81,-23,30
Ayr,7429,1,24,4,8,95,43,52,76
Raith,7429,2,22,8,6,68,36,32,74
Alloa,7429,3,18,8,10,60,43,17,62
Arbroath,7429,4,17,8,11,71,50,21,59
Stranraer,7429,5,15,5,16,55,67,-12,50
East Fife,7429,6,14,3,19,50,64,-14,45
Airdrieon,7429,7,10,12,14,46,59,-13,42
Forfar,7429,8,10,6,20,39,65,-26,36
Queen's Park,7429,9,7,10,19,41,73,-32,31
Albion,7429,10,8,6,22,58,83,-25,30
Raith,7430,1,23,8,5,71,32,39,77
Ayr,7430,2,24,4,8,95,45,50,76
Arbroath,7430,3,17,8,11,70,50,20,59
Alloa,7430,4,17,8,11,56,46,10,59
Stranraer,7430,5,15,6,15,56,65,-9,51
Airdrieon,7430,6,11,11,14,47,58,-11,44
East Fife,7430,7,13,4,19,48,65,-17,43
Forfar,7430,8,10,5,21,38,66,-28,35
Queen's Park,7430,9,7,10,19,41,72,-31,31
Albion,7430,10,8,6,22,60,83,-23,30
Ayr,7431,1,24,4,8,92,42,50,76
Raith,7431,2,22,8,6,69,34,35,74
Arbroath,7431,3,18,8,10,73,50,23,62
Alloa,7431,4,18,8,10,58,44,14,62
Stranraer,7431,5,16,5,15,58,65,-7,53
Airdrieon,7431,6,11,11,14,47,59,-12,44
East Fife,7431,7,13,3,20,48,67,-19,42
Forfar,7431,8,10,5,21,39,66,-27,35
Albion,7431,9,8,6,22,57,80,-23,30
Queen's Park,7431,10,6,10,20,41,75,-34,28
Ayr,7432,1,24,4,8,93,44,49,76
Raith,7432,2,22,8,6,68,34,34,74
Arbroath,7432,3,18,8,10,71,48,23,62
Alloa,7432,4,18,8,10,58,43,15,62
Stranraer,7432,5,16,5,15,58,66,-8,53
Airdrieon,7432,6,10,12,14,46,59,-13,42
East Fife,7432,7,13,3,20,49,67,-18,42
Forfar,7432,8,10,6,20,39,65,-26,36
Albion,7432,9,8,6,22,59,81,-22,30
Queen's Park,7432,10,6,10,20,39,73,-34,28
Ayr,7433,1,24,4,8,92,42,50,76
Raith,7433,2,22,8,6,69,34,35,74
Arbroath,7433,3,18,8,10,75,49,26,62
Alloa,7433,4,18,8,10,58,44,14,62
Stranraer,7433,5,16,5,15,57,65,-8,53
Airdrieon,7433,6,11,11,14,48,58,-10,44
East Fife,7433,7,13,3,20,48,66,-18,42
Forfar,7433,8,10,5,21,38,67,-29,35
Albion,7433,9,8,6,22,57,80,-23,30
Queen's Park,7433,10,6,10,20,40,77,-37,28
Raith,7434,1,23,8,5,71,33,38,77
Ayr,7434,2,24,4,8,93,44,49,76
Arbroath,7434,3,17,9,10,72,50,22,60
Alloa,7434,4,17,8,11,57,46,11,59
Stranraer,7434,5,15,6,15,55,64,-9,51
East Fife,7434,6,13,4,19,47,64,-17,43
Airdrieon,7434,7,10,11,15,46,60,-14,41
Forfar,7434,8,11,5,20,40,65,-25,38
Albion,7434,9,8,6,22,59,81,-22,30
Queen's Park,7434,10,6,11,19,41,74,-33,29
Raith,7435,1,23,8,5,71,32,39,77
Ayr,7435,2,24,4,8,93,43,50,76
Arbroath,7435,3,17,8,11,70,49,21,59
Alloa,7435,4,17,8,11,56,46,10,59
Stranraer,7435,5,15,6,15,55,64,-9,51
Airdrieon,7435,6,11,11,14,48,59,-11,44
East Fife,7435,7,13,4,19,47,64,-17,43
Forfar,7435,8,10,5,21,39,67,-28,35
Queen's Park,7435,9,7,10,19,40,72,-32,31
Albion,7435,10,8,6,22,58,81,-23,30
Ayr,7436,1,23,5,8,91,43,48,74
Raith,7436,2,22,8,6,69,34,35,74
Arbroath,7436,3,18,8,10,74,49,25,62
Alloa,7436,4,18,8,10,58,44,14,62
Stranraer,7436,5,15,5,16,56,68,-12,50
East Fife,7436,6,14,3,19,51,65,-14,45
Airdrieon,7436,7,11,11,14,47,59,-12,44
Forfar,7436,8,10,5,21,39,66,-27,35
Albion,7436,9,8,7,21,58,79,-21,31
Queen's Park,7436,10,6,10,20,40,76,-36,28
Raith,7437,1,23,8,5,72,34,38,77
Ayr,7437,2,24,4,8,94,43,51,76
Arbroath,7437,3,18,8,10,73,49,24,62
Alloa,7437,4,17,8,11,58,47,11,59
Stranraer,7437,5,15,5,16,55,65,-10,50
East Fife,7437,6,14,3,19,48,64,-16,45
Airdrieon,7437,7,11,11,14,49,60,-11,44
Forfar,7437,8,10,5,21,40,68,-28,35
Albion,7437,9,8,6,22,58,82,-24,30
Queen's Park,7437,10,6,10,20,40,75,-35,28
Ayr,7438,1,24,4,8,91,42,49,76
Raith,7438,2,22,9,5,68,32,36,75
Arbroath,7438,3,18,8,10,72,48,24,62
Alloa,7438,4,17,9,10,56,43,13,60
Stranraer,7438,5,15,5,16,56,66,-10,50
East Fife,7438,6,14,3,19,49,65,-16,45
Airdrieon,7438,7,11,11,14,47,58,-11,44
Forfar,7438,8,10,5,21,38,66,-28,35
Albion,7438,9,8,6,22,57,79,-22,30
Queen's Park,7438,10,6,10,20,39,74,-35,28
Raith,7439,1,22,9,5,68,32,36,75
Ayr,7439,2,23,5,8,91,43,48,74
Arbroath,7439,3,18,8,10,72,48,24,62
Alloa,7439,4,17,9,10,56,43,13,60
Stranraer,7439,5,16,5,15,58,66,-8,53
Airdrieon,7439,6,11,11,14,48,59,-11,44
East Fife,7439,7,13,3,20,49,67,-18,42
Forfar,7439,8,10,5,21,39,67,-28,35
Albion,7439,9,8,7,21,58,79,-21,31
Queen's Park,7439,10,6,10,20,39,74,-35,28
Ayr,7440,1,24,4,8,96,42,54,76
Raith,7440,2,22,9,5,68,32,36,75
Arbroath,7440,3,17,9,10,71,49,22,60
Alloa,7440,4,17,9,10,56,43,13,60
Stranraer,7440,5,15,5,16,57,67,-10,50
East Fife,7440,6,14,3,19,50,66,-16,45
Airdrieon,7440,7,11,11,14,49,59,-10,44
Forfar,7440,8,10,5,21,39,68,-29,35
Albion,7440,9,8,6,22,57,84,-27,30
Queen's Park,7440,10,6,11,19,40,73,-33,29
Raith,7441,1,22,9,5,69,33,36,75
Ayr,7441,2,23,4,9,91,45,46,73
Alloa,7441,3,17,9,10,57,44,13,60
Arbroath,7441,4,17,8,11,72,51,21,59
Stranraer,7441,5,16,5,15,58,65,-7,53
Airdrieon,7441,6,10,12,14,47,60,-13,42
East Fife,7441,7,13,3,20,48,67,-19,42
Forfar,7441,8,10,6,20,40,66,-26,36
Albion,7441,9,9,6,21,60,79,-19,33
Queen's Park,7441,10,7,10,19,42,74,-32,31
Raith,7442,1,23,8,5,72,33,39,77
Ayr,7442,2,24,4,8,94,43,51,76
Arbroath,7442,3,18,8,10,73,49,24,62
Alloa,7442,4,17,8,11,57,47,10,59
Stranraer,7442,5,15,5,16,55,65,-10,50
East Fife,7442,6,14,3,19,48,64,-16,45
Airdrieon,7442,7,11,11,14,47,58,-11,44
Forfar,7442,8,10,5,21,38,66,-28,35
Albion,7442,9,8,6,22,58,82,-24,30
Queen's Park,7442,10,6,10,20,40,75,-35,28
Ayr,7443,1,24,4,8,92,43,49,76
Raith,7443,2,22,9,5,68,32,36,75
Arbroath,7443,3,18,8,10,71,48,23,62
Alloa,7443,4,17,9,10,56,43,13,60
Stranraer,7443,5,15,5,16,56,66,-10,50
East Fife,7443,6,14,3,19,49,65,-16,45
Airdrieon,7443,7,11,11,14,47,59,-12,44
Forfar,7443,8,10,5,21,39,66,-27,35
Albion,7443,9,8,6,22,58,80,-22,30
Queen's Park,7443,10,6,10,20,39,73,-34,28
Ayr,7444,1,24,4,8,94,44,50,76
Raith,7444,2,22,9,5,68,32,36,75
Arbroath,7444,3,18,8,10,71,48,23,62
Alloa,7444,4,17,9,10,56,43,13,60
Stranraer,7444,5,16,5,15,59,65,-6,53
Airdrieon,7444,6,11,11,14,47,58,-11,44
East Fife,7444,7,13,3,20,48,68,-20,42
Forfar,7444,8,10,5,21,38,66,-28,35
Albion,7444,9,8,6,22,59,82,-23,30
Queen's Park,7444,10,6,10,20,39,73,-34,28
Raith,7445,1,23,8,5,71,33,38,77
Ayr,7445,2,24,4,8,92,43,49,76
Arbroath,7445,3,17,8,11,71,51,20,59
Alloa,7445,4,17,8,11,57,46,11,59
Stranraer,7445,5,15,5,16,55,65,-10,50
East Fife,7445,6,14,3,19,48,64,-16,45
Airdrieon,7445,7,10,12,14,47,60,-13,42
Forfar,7445,8,10,6,20,40,66,-26,36
Queen's Park,7445,9,7,10,19,42,73,-31,31
Albion,7445,10,8,6,22,58,80,-22,30
Ayr,7446,1,24,4,8,92,43,49,76
Raith,7446,2,22,8,6,68,33,35,74
Alloa,7446,3,18,8,10,57,43,14,62
Arbroath,7446,4,17,8,11,70,50,20,59
Stranraer,7446,5,16,5,15,56,64,-8,53
Airdrieon,7446,6,11,11,14,46,58,-12,44
East Fife,7446,7,13,3,20,47,65,-18,42
Forfar,7446,8,10,5,21,38,65,-27,35
Queen's Park,7446,9,7,10,19,41,72,-31,31
Albion,7446,10,8,6,22,58,80,-22,30
Raith,7447,1,23,8,5,70,32,38,77
Ayr,7447,2,24,4,8,95,43,52,76
Arbroath,7447,3,17,9,10,73,51,22,60
Alloa,7447,4,17,8,11,56,45,11,59
Stranraer,7447,5,15,5,16,56,68,-12,50
East Fife,7447,6,14,3,19,51,65,-14,45
Airdrieon,7447,7,10,12,14,46,59,-13,42
Forfar,7447,8,10,6,20,39,65,-26,36
Albion,7447,9,8,6,22,58,83,-25,30
Queen's Park,7447,10,6,11,19,42,75,-33,29
Ayr,7448,1,24,4,8,94,44,50,76
Raith,7448,2,22,9,5,68,32,36,75
Alloa,7448,3,17,9,10,56,43,13,60
Arbroath,7448,4,17,8,11,70,50,20,59
Stranraer,7448,5,15,5,16,57,68,-11,50
East Fife,7448,6,14,3,19,51,66,-15,45
Airdrieon,7448,7,10,11,15,45,59,-14,41
Forfar,7448,8,11,5,20,39,64,-25,38
Queen's Park,7448,9,7,10,19,41,72,-31,31
Albion,7448,10,8,6,22,59,82,-23,30
Raith,7449,1,23,8,5,70,33,37,77
Ayr,7449,2,24,4,8,93,42,51,76
Arbroath,7449,3,17,9,10,70,48,22,60
Alloa,7449,4,17,8,11,57,45,12,59
Stranraer,7449,5,15,5,16,56,66,-10,50
East Fife,7449,6,14,3,19,49,65,-16,45
Airdrieon,7449,7,10,12,14,46,59,-13,42
Forfar,7449,8,10,6,20,39,65,-26,36
Albion,7449,9,8,6,22,57,81,-24,30
Queen's Park,7449,10,6,11,19,39,72,-33,29
Ayr,7450,1,24,4,8,94,43,51,76
Raith,7450,2,22,8,6,68,33,35,74
Arbroath,7450,3,18,8,10,72,49,23,62
Alloa,7450,4,18,8,10,57,43,14,62
Stranraer,7450,5,15,6,15,58,67,-9,51
Airdrieon,7450,6,11,11,14,47,59,-12,44
East Fife,7450,7,13,4,19,50,67,-17,43
Forfar,7450,8,10,5,21,39,66,-27,35
Albion,7450,9,8,6,22,58,82,-24,30
Queen's Park,7450,10,6,10,20,40,74,-34,28
Raith,7451,1,23,8,5,72,32,40,77
Ayr,7451,2,23,5,8,92,44,48,74
Arbroath,7451,3,18,8,10,73,49,24,62
Alloa,7451,4,17,8,11,56,47,9,59
Stranraer,7451,5,15,5,16,55,65,-10,50
East Fife,7451,6,14,3,19,48,64,-16,45
Airdrieon,7451,7,10,12,14,47,60,-13,42
Forfar,7451,8,10,6,20,40,66,-26,36
Albion,7451,9,8,7,21,59,80,-21,31
Queen's Park,7451,10,6,10,20,40,75,-35,28
Raith,7452,1,23,8,5,69,32,37,77
Ayr,7452,2,24,4,8,95,43,52,76
Arbroath,7452,3,17,9,10,72,50,22,60
Alloa,7452,4,17,8,11,56,44,12,59
Stranraer,7452,5,15,6,15,57,66,-9,51
Airdrieon,7452,6,11,11,14,49,59,-10,44
East Fife,7452,7,13,4,19,49,66,-17,43
Forfar,7452,8,10,5,21,39,68,-29,35
Albion,7452,9,8,6,22,58,83,-25,30
Queen's Park,7452,10,6,11,19,41,74,-33,29
Raith,7453,1,22,9,5,70,34,36,75
Ayr,7453,2,23,5,8,93,45,48,74
Alloa,7453,3,17,9,10,58,45,13,60
Arbroath,7453,4,17,8,11,72,52,20,59
Stranraer,7453,5,15,5,16,55,66,-11,50
East Fife,7453,6,14,3,19,49,64,-15,45
Airdrieon,7453,7,11,11,14,47,58,-11,44
Forfar,7453,8,10,5,21,38,66,-28,35
Albion,7453,9,8,7,21,60,81,-21,31
Queen's Park,7453,10,7,10,19,43,74,-31,31
Ayr,7454,1,24,4,8,93,44,49,76
Raith,7454,2,22,8,6,69,34,35,74
Arbroath,7454,3,18,8,10,76,48,28,62
Alloa,7454,4,18,8,10,58,44,14,62
Stranraer,7454,5,15,6,15,55,64,-9,51
East Fife,7454,6,13,4,19,47,64,-17,43
Airdrieon,7454,7,10,11,15,45,63,-18,41
Forfar,7454,8,11,5,20,43,64,-21,38
Albion,7454,9,8,6,22,59,81,-22,30
Queen's Park,7454,10,6,10,20,39,78,-39,28
Ayr,7455,1,24,4,8,98,44,54,76
Raith,7455,2,22,9,5,70,34,36,75
Arbroath,7455,3,18,8,10,73,49,24,62
Alloa,7455,4,17,9,10,58,45,13,60
Stranraer,7455,5,15,5,16,56,66,-10,50
East Fife,7455,6,14,3,19,49,65,-16,45
Airdrieon,7455,7,10,12,14,46,59,-13,42
Forfar,7455,8,10,6,20,39,65,-26,36
Albion,7455,9,8,6,22,59,86,-27,30
Queen's Park,7455,10,6,10,20,40,75,-35,28
Raith,7456,1,23,8,5,73,33,40,77
Ayr,7456,2,24,4,8,94,43,51,76
Arbroath,7456,3,17,8,11,73,53,20,59
Alloa,7456,4,17,8,11,57,48,9,59
Stranraer,7456,5,16,5,15,57,65,-8,53
Airdrieon,7456,6,11,11,14,46,58,-12,44
East Fife,7456,7,13,3,20,48,66,-18,42
Forfar,7456,8,10,5,21,38,65,-27,35
Queen's Park,7456,9,7,10,19,44,75,-31,31
Albion,7456,10,8,6,22,58,82,-24,30
Raith,7457,1,22,9,5,69,33,36,75
Ayr,7457,2,23,5,8,92,44,48,74
Arbroath,7457,3,17,9,10,73,51,22,60
Alloa,7457,4,17,9,10,57,44,13,60
Stranraer,7457,5,15,5,16,56,67,-11,50
East Fife,7457,6,14,3,19,50,65,-15,45
Airdrieon,7457,7,11,11,14,48,60,-12,44
Forfar,7457,8,10,5,21,40,67,-27,35
Albion,7457,9,8,7,21,59,80,-21,31
Queen's Park,7457,10,6,11,19,42,75,-33,29
Raith,7458,1,23,8,5,70,33,37,77
Ayr,7458,2,24,4,8,96,42,54,76
Arbroath,7458,3,18,8,10,73,49,24,62
Alloa,7458,4,17,8,11,57,45,12,59
Stranraer,7458,5,15,5,16,56,68,-12,50
East Fife,7458,6,14,3,19,51,65,-14,45
Airdrieon,7458,7,10,11,15,46,61,-15,41
Forfar,7458,8,11,5,20,41,65,-24,38
Albion,7458,9,8,6,22,57,84,-27,30
Queen's Park,7458,10,6,10,20,40,75,-35,28
Raith,7459,1,23,8,5,70,32,38,77
Ayr,7459,2,24,4,8,95,43,52,76
Arbroath,7459,3,18,8,10,73,48,25,62
Alloa,7459,4,17,8,11,56,45,11,59
Stranraer,7459,5,15,6,15,56,65,-9,51
Airdrieon,7459,6,11,11,14,47,58,-11,44
East Fife,7459,7,13,4,19,48,65,-17,43
Forfar,7459,8,10,5,21,38,66,-28,35
Albion,7459,9,8,6,22,58,83,-25,30
Queen's Park,7459,10,6,10,20,39,75,-36,28
Raith,7460,1,23,8,5,69,32,37,77
Ayr,7460,2,24,4,8,93,43,50,76
Arbroath,7460,3,17,8,11,71,52,19,59
Alloa,7460,4,17,8,11,56,44,12,59
Stranraer,7460,5,15,5,16,56,66,-10,50
East Fife,7460,6,14,3,19,49,65,-16,45
Airdrieon,7460,7,10,11,15,46,60,-14,41
Forfar,7460,8,11,5,20,40,65,-25,38
Queen's Park,7460,9,7,10,19,43,73,-30,31
Albion,7460,10,8,6,22,58,81,-23,30
Ayr,7461,1,24,4,8,93,42,51,76
Raith,7461,2,22,8,6,69,35,34,74
Arbroath,7461,3,18,8,10,72,49,23,62
Alloa,7461,4,18,8,10,59,44,15,62
Stranraer,7461,5,16,5,15,57,64,-7,53
Airdrieon,7461,6,11,11,14,46,58,-12,44
East Fife,7461,7,13,3,20,47,66,-19,42
Forfar,7461,8,10,5,21,38,65,-27,35
Albion,7461,9,8,6,22,57,81,-24,30
Queen's Park,7461,10,6,10,20,40,74,-34,28
Raith,7462,1,23,8,5,70,33,37,77
Ayr,7462,2,23,5,8,91,43,48,74
Arbroath,7462,3,17,9,10,72,50,22,60
Alloa,7462,4,17,8,11,57,45,12,59
Stranraer,7462,5,15,5,16,56,66,-10,50
East Fife,7462,6,14,3,19,49,65,-16,45
Airdrieon,7462,7,11,11,14,48,60,-12,44
Forfar,7462,8,10,5,21,40,67,-27,35
Albion,7462,9,8,7,21,58,79,-21,31
Queen's Park,7462,10,6,11,19,41,74,-33,29
Ayr,7463,1,24,4,8,91,42,49,76
Raith,7463,2,22,8,6,70,35,35,74
Arbroath,7463,3,18,8,10,75,50,25,62
Alloa,7463,4,18,8,10,59,45,14,62
Stranraer,7463,5,15,5,16,55,69,-14,50
East Fife,7463,6,14,3,19,52,64,-12,45
Airdrieon,7463,7,10,12,14,46,59,-13,42
Forfar,7463,8,10,6,20,39,65,-26,36
Albion,7463,9,8,6,22,57,79,-22,30
Queen's Park,7463,10,6,10,20,41,77,-36,28
Ayr,7464,1,24,4,8,91,42,49,76
Raith,7464,2,22,8,6,68,33,35,74
Arbroath,7464,3,18,8,10,72,48,24,62
Alloa,7464,4,18,8,10,57,43,14,62
Stranraer,7464,5,15,5,16,56,66,-10,50
East Fife,7464,6,14,3,19,49,65,-16,45
Airdrieon,7464,7,11,11,14,46,58,-12,44
Forfar,7464,8,10,5,21,38,65,-27,35
Albion,7464,9,8,6,22,57,79,-22,30
Queen's Park,7464,10,6,10,20,39,74,-35,28
Raith,7465,1,23,8,5,73,33,40,77
Ayr,7465,2,24,4,8,94,45,49,76
Arbroath,7465,3,18,8,10,74,51,23,62
Alloa,7465,4,17,8,11,57,48,9,59
Stranraer,7465,5,15,5,16,55,67,-12,50
East Fife,7465,6,14,3,19,50,64,-14,45
Airdrieon,7465,7,10,12,14,45,58,-13,42
Forfar,7465,8,10,6,20,38,64,-26,36
Albion,7465,9,8,6,22,60,82,-22,30
Queen's Park,7465,10,6,10,20,42,76,-34,28
Ayr,7466,1,24,4,8,94,42,52,76
Raith,7466,2,22,8,6,69,34,35,74
Alloa,7466,3,18,8,10,58,44,14,62
Arbroath,7466,4,17,8,11,71,50,21,59
Stranraer,7466,5,15,5,16,56,68,-12,50
East Fife,7466,6,14,3,19,51,65,-14,45
Airdrieon,7466,7,11,11,14,46,58,-12,44
Forfar,7466,8,10,5,21,38,65,-27,35
Queen's Park,7466,9,7,10,19,41,73,-32,31
Albion,7466,10,8,6,22,57,82,-25,30
Raith,7467,1,23,8,5,69,32,37,77
Ayr,7467,2,24,4,8,93,43,50,76
Arbroath,7467,3,17,8,11,70,49,21,59
Alloa,7467,4,17,8,11,56,44,12,59
Stranraer,7467,5,16,5,15,57,65,-8,53
Airdrieon,7467,6,11,11,14,47,58,-11,44
East Fife,7467,7,13,3,20,48,66,-18,42
Forfar,7467,8,10,5,21,38,66,-28,35
Queen's Park,7467,9,7,10,19,40,72,-32,31
Albion,7467,10,8,6,22,58,81,-23,30
Ayr,7468,1,24,4,8,93,43,50,76
Raith,7468,2,22,9,5,68,32,36,75
Alloa,7468,3,17,9,10,56,43,13,60
Arbroath,7468,4,17,8,11,71,50,21,59
Stranraer,7468,5,15,5,16,55,65,-10,50
East Fife,7468,6,14,3,19,48,64,-16,45
Airdrieon,7468,7,11,11,14,48,59,-11,44
Forfar,7468,8,10,5,21,39,67,-28,35
Queen's Park,7468,9,7,10,19,41,73,-32,31
Albion,7468,10,8,6,22,58,81,-23,30
Raith,7469,1,23,8,5,70,32,38,77
Ayr,7469,2,24,4,8,95,44,51,76
Arbroath,7469,3,18,8,10,72,49,23,62
Alloa,7469,4,17,8,11,56,45,11,59
Stranraer,7469,5,15,6,15,56,65,-9,51
Airdrieon,7469,6,11,11,14,49,58,-9,44
East Fife,7469,7,13,4,19,48,65,-17,43
Forfar,7469,8,10,5,21,38,68,-30,35
Albion,7469,9,8,6,22,59,83,-24,30
Queen's Park,7469,10,6,10,20,40,74,-34,28
Ayr,7470,1,24,4,8,93,43,50,76
Raith,7470,2,22,9,5,69,33,36,75
Alloa,7470,3,17,9,10,57,44,13,60
Arbroath,7470,4,17,8,11,70,49,21,59
Stranraer,7470,5,15,6,15,58,67,-9,51
East Fife,7470,6,13,4,19,50,67,-17,43
Airdrieon,7470,7,10,11,15,45,60,-15,41
Forfar,7470,8,11,5,20,40,64,-24,38
Queen's Park,7470,9,7,10,19,40,72,-32,31
Albion,7470,10,8,6,22,58,81,-23,30
Raith,7471,1,23,8,5,70,32,38,77
Ayr,7471,2,24,4,8,94,42,52,76
Arbroath,7471,3,18,8,10,73,48,25,62
Alloa,7471,4,17,8,11,56,45,11,59
Stranraer,7471,5,16,5,15,57,64,-7,53
Airdrieon,7471,6,11,11,14,47,59,-12,44
East Fife,7471,7,13,3,20,47,66,-19,42
Forfar,7471,8,10,5,21,39,66,-27,35
Albion,7471,9,8,6,22,57,82,-25,30
Queen's Park,7471,10,6,10,20,39,75,-36,28
Raith,7472,1,23,8,5,71,33,38,77
Ayr,7472,2,24,4,8,93,43,50,76
Arbroath,7472,3,17,9,10,74,52,22,60
Alloa,7472,4,17,8,11,57,46,11,59
Stranraer,7472,5,15,5,16,55,65,-10,50
East Fife,7472,6,14,3,19,48,64,-16,45
Airdrieon,7472,7,10,12,14,45,58,-13,42
Forfar,7472,8,10,6,20,38,64,-26,36
Albion,7472,9,8,6,22,58,81,-23,30
Queen's Park,7472,10,6,11,19,43,76,-33,29
Raith,7473,1,23,8,5,70,32,38,77
Ayr,7473,2,23,5,8,90,42,48,74
Arbroath,7473,3,17,9,10,71,49,22,60
Alloa,7473,4,17,8,11,56,45,11,59
Stranraer,7473,5,16,5,15,56,64,-8,53
East Fife,7473,6,13,3,20,47,65,-18,42
Airdrieon,7473,7,10,11,15,46,60,-14,41
Forfar,7473,8,11,5,20,40,65,-25,38
Albion,7473,9,8,7,21,57,78,-21,31
Queen's Park,7473,10,6,11,19,40,73,-33,29
Raith,7474,1,23,8,5,71,34,37,77
Ayr,7474,2,23,5,8,92,44,48,74
Arbroath,7474,3,17,9,10,71,49,22,60
Alloa,7474,4,17,8,11,58,46,12,59
Stranraer,7474,5,16,5,15,58,65,-7,53
Airdrieon,7474,6,11,11,14,47,58,-11,44
East Fife,7474,7,13,3,20,48,67,-19,42
Forfar,7474,8,10,5,21,38,66,-28,35
Albion,7474,9,8,7,21,59,80,-21,31
Queen's Park,7474,10,6,11,19,40,73,-33,29
Ayr,7475,1,23,5,8,91,43,48,74
Raith,7475,2,22,8,6,68,34,34,74
Arbroath,7475,3,18,8,10,73,49,24,62
Alloa,7475,4,18,8,10,58,43,15,62
Stranraer,7475,5,15,5,16,56,67,-11,50
East Fife,7475,6,14,3,19,50,65,-15,45
Airdrieon,7475,7,10,11,15,45,61,-16,41
Forfar,7475,8,11,5,20,41,64,-23,38
Albion,7475,9,8,7,21,58,79,-21,31
Queen's Park,7475,10,6,10,20,40,75,-35,28
Raith,7476,1,23,8,5,73,32,41,77
Ayr,7476,2,24,4,8,93,44,49,76
Arbroath,7476,3,18,8,10,73,50,23,62
Alloa,7476,4,17,8,11,56,48,8,59
Stranraer,7476,5,15,5,16,55,65,-10,50
East Fife,7476,6,14,3,19,48,64,-16,45
Airdrieon,7476,7,11,11,14,47,58,-11,44
Forfar,7476,8,10,5,21,38,66,-28,35
Albion,7476,9,8,6,22,59,81,-22,30
Queen's Park,7476,10,6,10,20,41,75,-34,28
Raith,7477,1,22,9,5,69,33,36,75
Ayr,7477,2,23,5,8,93,45,48,74
Alloa,7477,3,17,9,10,57,44,13,60
Arbroath,7477,4,17,8,11,70,49,21,59
Stranraer,7477,5,16,5,15,57,65,-8,53
Airdrieon,7477,6,11,11,14,46,58,-12,44
East Fife,7477,7,13,3,20,48,66,-18,42
Forfar,7477,8,10,5,21,38,65,-27,35
Albion,7477,9,8,7,21,60,81,-21,31
Queen's Park,7477,10,7,10,19,40,72,-32,31
Ayr,7478,1,24,4,8,96,44,52,76
Raith,7478,2,22,8,6,68,34,34,74
Arbroath,7478,3,18,8,10,73,50,23,62
Alloa,7478,4,18,8,10,58,43,15,62
Stranraer,7478,5,16,5,15,61,65,-4,53
Airdrieon,7478,6,10,12,14,45,58,-13,42
East Fife,7478,7,13,3,20,48,70,-22,42
Forfar,7478,8,10,6,20,38,64,-26,36
Albion,7478,9,8,6,22,59,84,-25,30
Queen's Park,7478,10,6,10,20,41,75,-34,28
Raith,7479,1,23,8,5,71,33,38,77
Ayr,7479,2,24,4,8,94,42,52,76
Arbroath,7479,3,17,8,11,72,53,19,59
Alloa,7479,4,17,8,11,57,46,11,59
Stranraer,7479,5,15,5,16,56,67,-11,50
East Fife,7479,6,14,3,19,50,65,-15,45
Airdrieon,7479,7,11,11,14,47,59,-12,44
Forfar,7479,8,10,5,21,39,66,-27,35
Queen's Park,7479,9,7,10,19,44,74,-30,31
Albion,7479,10,8,6,22,57,82,-25,30
Ayr,7480,1,24,4,8,93,44,49,76
Raith,7480,2,22,9,5,69,33,36,75
Arbroath,7480,3,18,8,10,72,49,23,62
Alloa,7480,4,17,9,10,57,44,13,60
Stranraer,7480,5,15,5,16,55,66,-11,50
East Fife,7480,6,14,3,19,49,64,-15,45
Airdrieon,7480,7,11,11,14,47,58,-11,44
Forfar,7480,8,10,5,21,38,66,-28,35
Albion,7480,9,8,6,22,59,81,-22,30
Queen's Park,7480,10,6,10,20,40,74,-34,28
Ayr,7481,1,24,4,8,97,46,51,76
Raith,7481,2,22,8,6,71,36,35,74
Arbroath,7481,3,18,8,10,73,49,24,62
Alloa,7481,4,18,8,10,60,46,14,62
Stranraer,7481,5,16,5,15,56,64,-8,53
Airdrieon,7481,6,11,11,14,47,59,-12,44
East Fife,7481,7,13,3,20,47,65,-18,42
Forfar,7481,8,10,5,21,39,66,-27,35
Albion,7481,9,8,6,22,61,85,-24,30
Queen's Park,7481,10,6,10,20,40,75,-35,28
Raith,7482,1,22,9,5,69,33,36,75
Ayr,7482,2,23,5,8,90,42,48,74
Alloa,7482,3,17,9,10,57,44,13,60
Arbroath,7482,4,17,8,11,71,50,21,59
Stranraer,7482,5,15,5,16,55,66,-11,50
East Fife,7482,6,14,3,19,49,64,-15,45
Airdrieon,7482,7,10,11,15,46,61,-15,41
Forfar,7482,8,11,5,20,41,65,-24,38
Albion,7482,9,8,7,21,57,78,-21,31
Queen's Park,7482,10,7,10,19,41,73,-32,31
Ayr,7483,1,24,4,8,96,42,54,76
Raith,7483,2,22,9,5,68,32,36,75
Arbroath,7483,3,18,8,10,72,49,23,62
Alloa,7483,4,17,9,10,56,43,13,60
Stranraer,7483,5,16,5,15,59,66,-7,53
East Fife,7483,6,13,3,20,49,68,-19,42
Airdrieon,7483,7,10,11,15,46,60,-14,41
Forfar,7483,8,11,5,20,40,65,-25,38
Albion,7483,9,8,6,22,57,84,-27,30
Queen's Park,7483,10,6,10,20,40,74,-34,28
Ayr,7484,1,24,4,8,91,42,49,76
Raith,7484,2,22,9,5,69,33,36,75
Alloa,7484,3,17,9,10,57,44,13,60
Arbroath,7484,4,17,8,11,70,49,21,59
Stranraer,7484,5,16,5,15,57,64,-7,53
East Fife,7484,6,13,3,20,47,66,-19,42
Airdrieon,7484,7,10,11,15,46,60,-14,41
Forfar,7484,8,11,5,20,40,65,-25,38
Queen's Park,7484,9,7,10,19,40,72,-32,31
Albion,7484,10,8,6,22,57,79,-22,30
Raith,7485,1,22,8,6,69,35,34,74
Ayr,7485,2,23,4,9,90,43,47,73
Arbroath,7485,3,18,8,10,73,49,24,62
Alloa,7485,4,18,8,10,59,44,15,62
Stranraer,7485,5,15,6,15,56,65,-9,51
Airdrieon,7485,6,11,11,14,48,58,-10,44
East Fife,7485,7,13,4,19,48,65,-17,43
Forfar,7485,8,10,5,21,38,67,-29,35
Albion,7485,9,9,6,21,58,78,-20,33
Queen's Park,7485,10,6,10,20,40,75,-35,28
Raith,7486,1,23,8,5,71,33,38,77
Ayr,7486,2,24,4,8,96,45,51,76
Arbroath,7486,3,17,8,11,70,49,21,59
Alloa,7486,4,17,8,11,57,46,11,59
Stranraer,7486,5,15,5,16,55,68,-13,50
East Fife,7486,6,14,3,19,51,64,-13,45
Airdrieon,7486,7,10,11,15,45,59,-14,41
Forfar,7486,8,11,5,20,39,64,-25,38
Queen's Park,7486,9,7,10,19,40,72,-32,31
Albion,7486,10,8,6,22,60,84,-24,30
Raith,7487,1,22,8,6,69,36,33,74
Ayr,7487,2,23,4,9,90,43,47,73
Alloa,7487,3,18,8,10,60,44,16,62
Arbroath,7487,4,17,8,11,71,51,20,59
Stranraer,7487,5,15,5,16,56,67,-11,50
East Fife,7487,6,14,3,19,50,65,-15,45
Airdrieon,7487,7,11,11,14,46,58,-12,44
Forfar,7487,8,10,5,21,38,65,-27,35
Albion,7487,9,9,6,21,58,78,-20,33
Queen's Park,7487,10,7,10,19,42,73,-31,31
Ayr,7488,1,24,4,8,98,43,55,76
Raith,7488,2,22,8,6,68,33,35,74
Arbroath,7488,3,18,8,10,73,49,24,62
Alloa,7488,4,18,8,10,57,43,14,62
Stranraer,7488,5,15,6,15,55,64,-9,51
East Fife,7488,6,13,4,19,47,64,-17,43
Airdrieon,7488,7,10,11,15,46,60,-14,41
Forfar,7488,8,11,5,20,40,65,-25,38
Albion,7488,9,8,6,22,58,86,-28,30
Queen's Park,7488,10,6,10,20,40,75,-35,28
Ayr,7489,1,23,5,8,91,43,48,74
Raith,7489,2,22,8,6,68,34,34,74
Arbroath,7489,3,18,8,10,73,49,24,62
Alloa,7489,4,18,8,10,58,43,15,62
Stranraer,7489,5,15,5,16,57,67,-10,50
East Fife,7489,6,14,3,19,50,66,-16,45
Airdrieon,7489,7,10,12,14,46,59,-13,42
Forfar,7489,8,10,6,20,39,65,-26,36
Albion,7489,9,8,7,21,58,79,-21,31
Queen's Park,7489,10,6,10,20,40,75,-35,28
Ayr,7490,1,24,4,8,94,43,51,76
Raith,7490,2,22,8,6,68,34,34,74
Alloa,7490,3,18,8,10,58,43,15,62
Arbroath,7490,4,17,8,11,72,51,21,59
Stranraer,7490,5,15,5,16,58,69,-11,50
East Fife,7490,6,14,3,19,52,67,-15,45
Airdrieon,7490,7,10,12,14,46,59,-13,42
Forfar,7490,8,10,6,20,39,65,-26,36
Queen's Park,7490,9,7,10,19,42,74,-32,31
Albion,7490,10,8,6,22,58,82,-24,30
Raith,7491,1,23,8,5,69,32,37,77
Ayr,7491,2,24,4,8,93,43,50,76
Arbroath,7491,3,17,9,10,73,51,22,60
Alloa,7491,4,17,8,11,56,44,12,59
Stranraer,7491,5,16,5,15,57,65,-8,53
Airdrieon,7491,6,10,12,14,48,61,-13,42
East Fife,7491,7,13,3,20,48,66,-18,42
Forfar,7491,8,10,6,20,41,67,-26,36
Albion,7491,9,8,6,22,58,81,-23,30
Queen's Park,7491,10,6,11,19,42,75,-33,29
Ayr,7492,1,24,4,8,94,45,49,76
Raith,7492,2,22,9,5,69,33,36,75
Arbroath,7492,3,18,8,10,72,48,24,62
Alloa,7492,4,17,9,10,57,44,13,60
Stranraer,7492,5,15,5,16,55,66,-11,50
East Fife,7492,6,14,3,19,49,64,-15,45
Airdrieon,7492,7,11,11,14,48,58,-10,44
Forfar,7492,8,10,5,21,38,67,-29,35
Albion,7492,9,8,6,22,60,82,-22,30
Queen's Park,7492,10,6,10,20,39,74,-35,28
Ayr,7493,1,24,4,8,97,42,55,76
Raith,7493,2,22,9,5,69,33,36,75
Arbroath,7493,3,18,8,10,72,49,23,62
Alloa,7493,4,17,9,10,57,44,13,60
Stranraer,7493,5,15,6,15,57,66,-9,51
East Fife,7493,6,13,4,19,49,66,-17,43
Airdrieon,7493,7,10,11,15,46,60,-14,41
Forfar,7493,8,11,5,20,40,65,-25,38
Albion,7493,9,8,6,22,57,85,-28,30
Queen's Park,7493,10,6,10,20,40,74,-34,28
Ayr,7494,1,24,4,8,96,44,52,76
Raith,7494,2,22,8,6,70,35,35,74
Arbroath,7494,3,18,8,10,72,48,24,62
Alloa,7494,4,18,8,10,59,45,14,62
Stranraer,7494,5,15,5,16,56,67,-11,50
East Fife,7494,6,14,3,19,50,65,-15,45
Airdrieon,7494,7,11,11,14,46,58,-12,44
Forfar,7494,8,10,5,21,38,65,-27,35
Albion,7494,9,8,6,22,59,84,-25,30
Queen's Park,7494,10,6,10,20,39,74,-35,28
Ayr,7495,1,24,4,8,96,44,52,76
Raith,7495,2,22,8,6,69,35,34,74
Arbroath,7495,3,18,8,10,74,49,25,62
Alloa,7495,4,18,8,10,59,44,15,62
Stranraer,7495,5,15,5,16,56,66,-10,50
East Fife,7495,6,14,3,19,49,65,-16,45
Airdrieon,7495,7,11,11,14,47,58,-11,44
Forfar,7495,8,10,5,21,38,66,-28,35
Albion,7495,9,8,6,22,59,84,-25,30
Queen's Park,7495,10,6,10,20,40,76,-36,28
Raith,7496,1,23,8,5,69,32,37,77
Ayr,7496,2,23,4,9,90,43,47,73
Arbroath,7496,3,17,8,11,72,51,21,59
Alloa,7496,4,17,8,11,56,44,12,59
Stranraer,7496,5,15,5,16,56,66,-10,50
East Fife,7496,6,14,3,19,49,65,-16,45
Airdrieon,7496,7,11,11,14,49,59,-10,44
Forfar,7496,8,10,5,21,39,68,-29,35
Albion,7496,9,9,6,21,58,78,-20,33
Queen's Park,7496,10,7,10,19,42,74,-32,31
Raith,7497,1,23,8,5,70,33,37,77
Ayr,7497,2,24,4,8,97,43,54,76
Arbroath,7497,3,18,8,10,75,50,25,62
Alloa,7497,4,17,8,11,57,45,12,59
Stranraer,7497,5,15,6,15,55,64,-9,51
Airdrieon,7497,6,11,11,14,47,59,-12,44
East Fife,7497,7,13,4,19,47,64,-17,43
Forfar,7497,8,10,5,21,39,66,-27,35
Albion,7497,9,8,6,22,58,85,-27,30
Queen's Park,7497,10,6,10,20,41,77,-36,28
Ayr,7498,1,24,4,8,95,42,53,76
Raith,7498,2,22,8,6,69,37,32,74
Arbroath,7498,3,18,8,10,74,48,26,62
Alloa,7498,4,18,8,10,61,44,17,62
Stranraer,7498,5,15,5,16,55,65,-10,50
East Fife,7498,6,14,3,19,48,64,-16,45
Airdrieon,7498,7,11,11,14,49,58,-9,44
Forfar,7498,8,10,5,21,38,68,-30,35
Albion,7498,9,8,6,22,57,83,-26,30
Queen's Park,7498,10,6,10,20,39,76,-37,28
Raith,7499,1,23,8,5,70,33,37,77
Ayr,7499,2,23,4,9,90,43,47,73
Arbroath,7499,3,18,8,10,73,49,24,62
Alloa,7499,4,17,8,11,57,45,12,59
Stranraer,7499,5,16,5,15,57,64,-7,53
Airdrieon,7499,6,10,12,14,46,59,-13,42
East Fife,7499,7,13,3,20,47,66,-19,42
Forfar,7499,8,10,6,20,39,65,-26,36
Albion,7499,9,9,6,21,58,78,-20,33
Queen's Park,7499,10,6,10,20,40,75,-35,28
Raith,7500,1,23,8,5,72,33,39,77
Ayr,7500,2,24,4,8,92,42,50,76
Arbroath,7500,3,18,8,10,72,49,23,62
Alloa,7500,4,17,8,11,57,47,10,59
Stranraer,7500,5,15,6,15,56,65,-9,51
Airdrieon,7500,6,11,11,14,47,58,-11,44
East Fife,7500,7,13,4,19,48,65,-17,43
Forfar,7500,8,10,5,21,38,66,-28,35
Albion,7500,9,8,6,22,57,80,-23,30
Queen's Park,7500,10,6,10,20,40,74,-34,28
Ayr,7501,1,24,4,8,94,44,50,76
Raith,7501,2,22,8,6,68,34,34,74
Arbroath,7501,3,18,8,10,72,48,24,62
Alloa,7501,4,18,8,10,58,43,15,62
Stranraer,7501,5,15,5,16,55,65,-10,50
East Fife,7501,6,14,3,19,48,64,-16,45
Airdrieon,7501,7,11,11,14,48,59,-11,44
Forfar,7501,8,10,5,21,39,67,-28,35
Albion,7501,9,8,6,22,59,82,-23,30
Queen's Park,7501,10,6,10,20,39,74,-35,28
Raith,7502,1,23,8,5,70,33,37,77
Ayr,7502,2,24,4,8,93,43,50,76
Arbroath,7502,3,18,8,10,73,49,24,62
Alloa,7502,4,17,8,11,57,45,12,59
Stranraer,7502,5,15,5,16,56,66,-10,50
East Fife,7502,6,14,3,19,49,65,-16,45
Airdrieon,7502,7,11,11,14,47,59,-12,44
Forfar,7502,8,10,5,21,39,66,-27,35
Albion,7502,9,8,6,22,58,81,-23,30
Queen's Park,7502,10,6,10,20,40,75,-35,28
Raith,7503,1,23,8,5,72,33,39,77
Ayr,7503,2,23,5,8,92,44,48,74
Arbroath,7503,3,17,9,10,71,49,22,60
Alloa,7503,4,17,8,11,57,47,10,59
Stranraer,7503,5,15,5,16,57,67,-10,50
East Fife,7503,6,14,3,19,50,66,-16,45
Airdrieon,7503,7,11,11,14,47,58,-11,44
Forfar,7503,8,10,5,21,38,66,-28,35
Albion,7503,9,8,7,21,59,80,-21,31
Queen's Park,7503,10,6,11,19,40,73,-33,29
Ayr,7504,1,24,4,8,92,43,49,76
Raith,7504,2,22,8,6,69,34,35,74
Arbroath,7504,3,18,8,10,72,48,24,62
Alloa,7504,4,18,8,10,58,44,14,62
Stranraer,7504,5,16,5,15,58,65,-7,53
Airdrieon,7504,6,11,11,14,48,58,-10,44
East Fife,7504,7,13,3,20,48,67,-19,42
Forfar,7504,8,10,5,21,38,67,-29,35
Albion,7504,9,8,6,22,58,80,-22,30
Queen's Park,7504,10,6,10,20,39,74,-35,28
Raith,7505,1,23,8,5,70,32,38,77
Ayr,7505,2,23,5,8,93,45,48,74
Arbroath,7505,3,17,8,11,71,50,21,59
Alloa,7505,4,17,8,11,56,45,11,59
Stranraer,7505,5,15,5,16,56,68,-12,50
East Fife,7505,6,14,3,19,51,65,-14,45
Airdrieon,7505,7,11,11,14,48,59,-11,44
Forfar,7505,8,10,5,21,39,67,-28,35
Albion,7505,9,8,7,21,60,81,-21,31
Queen's Park,7505,10,7,10,19,41,73,-32,31
Raith,7506,1,23,8,5,71,33,38,77
Ayr,7506,2,24,4,8,94,42,52,76
Arbroath,7506,3,17,9,10,71,49,22,60
Alloa,7506,4,17,8,11,57,46,11,59
Stranraer,7506,5,15,5,16,57,68,-11,50
East Fife,7506,6,14,3,19,51,66,-15,45
Airdrieon,7506,7,10,11,15,45,59,-14,41
Forfar,7506,8,11,5,20,39,64,-25,38
Albion,7506,9,8,6,22,57,82,-25,30
Queen's Park,7506,10,6,11,19,40,73,-33,29
Raith,7507,1,23,8,5,70,32,38,77
Ayr,7507,2,24,4,8,94,44,50,76
Arbroath,7507,3,18,8,10,71,48,23,62
Alloa,7507,4,17,8,11,56,45,11,59
Stranraer,7507,5,15,6,15,57,66,-9,51
Airdrieon,7507,6,11,11,14,48,58,-10,44
East Fife,7507,7,13,4,19,49,66,-17,43
Forfar,7507,8,10,5,21,38,67,-29,35
Albion,7507,9,8,6,22,59,82,-23,30
Queen's Park,7507,10,6,10,20,39,73,-34,28
Raith,7508,1,23,8,5,71,32,39,77
Ayr,7508,2,24,4,8,92,43,49,76
Arbroath,7508,3,17,8,11,70,50,20,59
Alloa,7508,4,17,8,11,56,46,10,59
Stranraer,7508,5,16,5,15,58,64,-6,53
Airdrieon,7508,6,11,11,14,47,58,-11,44
East Fife,7508,7,13,3,20,47,67,-20,42
Forfar,7508,8,10,5,21,38,66,-28,35
Queen's Park,7508,9,7,10,19,41,72,-31,31
Albion,7508,10,8,6,22,58,80,-22,30
Raith,7509,1,23,8,5,72,33,39,77
Ayr,7509,2,24,4,8,91,42,49,76
Arbroath,7509,3,18,8,10,72,49,23,62
Alloa,7509,4,17,8,11,57,47,10,59
Stranraer,7509,5,16,5,15,58,66,-8,53
Airdrieon,7509,6,11,11,14,50,59,-9,44
East Fife,7509,7,13,3,20,49,67,-18,42
Forfar,7509,8,10,5,21,39,69,-30,35
Albion,7509,9,8,6,22,57,79,-22,30
Queen's Park,7509,10,6,10,20,40,74,-34,28
Raith,7510,1,23,8,5,70,32,38,77
Ayr,7510,2,24,4,8,92,42,50,76
Arbroath,7510,3,18,8,10,74,48,26,62
Alloa,7510,4,17,8,11,56,45,11,59
Stranraer,7510,5,15,6,15,57,66,-9,51
Airdrieon,7510,6,11,11,14,46,58,-12,44
East Fife,7510,7,13,4,19,49,66,-17,43
Forfar,7510,8,10,5,21,38,65,-27,35
Albion,7510,9,8,6,22,57,80,-23,30
Queen's Park,7510,10,6,10,20,39,76,-37,28
Raith,7511,1,23,8,5,70,32,38,77
Ayr,7511,2,24,4,8,95,45,50,76
Arbroath,7511,3,17,9,10,70,48,22,60
Alloa,7511,4,17,8,11,56,45,11,59
Stranraer,7511,5,15,6,15,57,66,-9,51
East Fife,7511,6,13,4,19,49,66,-17,43
Airdrieon,7511,7,10,11,15,46,60,-14,41
Forfar,7511,8,11,5,20,40,65,-25,38
Albion,7511,9,8,6,22,60,83,-23,30
Queen's Park,7511,10,6,11,19,39,72,-33,29
Raith,7512,1,22,9,5,69,33,36,75
Ayr,7512,2,23,5,8,92,44,48,74
Arbroath,7512,3,17,9,10,71,49,22,60
Alloa,7512,4,17,9,10,57,44,13,60
Stranraer,7512,5,15,5,16,56,66,-10,50
East Fife,7512,6,14,3,19,49,65,-16,45
Airdrieon,7512,7,11,11,14,50,58,-8,44
Forfar,7512,8,10,5,21,38,69,-31,35
Albion,7512,9,8,7,21,59,80,-21,31
Queen's Park,7512,10,6,11,19,40,73,-33,29
Raith,7513,1,23,8,5,71,33,38,77
Ayr,7513,2,24,4,8,95,44,51,76
Arbroath,7513,3,18,8,10,72,48,24,62
Alloa,7513,4,17,8,11,57,46,11,59
Stranraer,7513,5,15,5,16,55,65,-10,50
East Fife,7513,6,14,3,19,48,64,-16,45
Airdrieon,7513,7,11,11,14,48,58,-10,44
Forfar,7513,8,10,5,21,38,67,-29,35
Albion,7513,9,8,6,22,59,83,-24,30
Queen's Park,7513,10,6,10,20,39,74,-35,28
Raith,7514,1,23,8,5,72,32,40,77
Ayr,7514,2,24,4,8,93,43,50,76
Arbroath,7514,3,17,9,10,71,49,22,60
Alloa,7514,4,17,8,11,56,47,9,59
Stranraer,7514,5,15,6,15,57,66,-9,51
East Fife,7514,6,13,4,19,49,66,-17,43
Airdrieon,7514,7,10,12,14,47,60,-13,42
Forfar,7514,8,10,6,20,40,66,-26,36
Albion,7514,9,8,6,22,58,81,-23,30
Queen's Park,7514,10,6,11,19,40,73,-33,29
Raith,7515,1,23,8,5,69,32,37,77
Ayr,7515,2,24,4,8,93,42,51,76
Arbroath,7515,3,18,8,10,74,49,25,62
Alloa,7515,4,17,8,11,56,44,12,59
Stranraer,7515,5,16,5,15,60,66,-6,53
Airdrieon,7515,6,11,11,14,50,58,-8,44
East Fife,7515,7,13,3,20,49,69,-20,42
Forfar,7515,8,10,5,21,38,69,-31,35
Albion,7515,9,8,6,22,57,81,-24,30
Queen's Park,7515,10,6,10,20,40,76,-36,28
Raith,7516,1,23,8,5,71,32,39,77
Ayr,7516,2,24,4,8,96,43,53,76
Arbroath,7516,3,18,8,10,72,49,23,62
Alloa,7516,4,17,8,11,56,46,10,59
Stranraer,7516,5,15,6,15,57,66,-9,51
Airdrieon,7516,6,11,11,14,47,58,-11,44
East Fife,7516,7,13,4,19,49,66,-17,43
Forfar,7516,8,10,5,21,38,66,-28,35
Albion,7516,9,8,6,22,58,84,-26,30
Queen's Park,7516,10,6,10,20,40,74,-34,28
Raith,7517,1,23,8,5,70,33,37,77
Ayr,7517,2,24,4,8,97,43,54,76
Arbroath,7517,3,18,8,10,72,49,23,62
Alloa,7517,4,17,8,11,57,45,12,59
Stranraer,7517,5,16,5,15,57,65,-8,53
Airdrieon,7517,6,11,11,14,48,58,-10,44
East Fife,7517,7,13,3,20,48,66,-18,42
Forfar,7517,8,10,5,21,38,67,-29,35
Albion,7517,9,8,6,22,58,85,-27,30
Queen's Park,7517,10,6,10,20,40,74,-34,28
Raith,7518,1,23,8,5,74,34,40,77
Ayr,7518,2,24,4,8,94,43,51,76
Arbroath,7518,3,18,8,10,73,49,24,62
Alloa,7518,4,17,8,11,58,49,9,59
Stranraer,7518,5,15,6,15,56,65,-9,51
East Fife,7518,6,13,4,19,48,65,-17,43
Airdrieon,7518,7,10,11,15,45,62,-17,41
Forfar,7518,8,11,5,20,42,64,-22,38
Albion,7518,9,8,6,22,58,82,-24,30
Queen's Park,7518,10,6,10,20,40,75,-35,28
Raith,7519,1,23,8,5,71,34,37,77
Ayr,7519,2,24,4,8,95,42,53,76
Arbroath,7519,3,18,8,10,72,49,23,62
Alloa,7519,4,17,8,11,58,46,12,59
Stranraer,7519,5,16,5,15,58,65,-7,53
Airdrieon,7519,6,11,11,14,49,59,-10,44
East Fife,7519,7,13,3,20,48,67,-19,42
Forfar,7519,8,10,5,21,39,68,-29,35
Albion,7519,9,8,6,22,57,83,-26,30
Queen's Park,7519,10,6,10,20,40,74,-34,28
Ayr,7520,1,24,4,8,94,42,52,76
Raith,7520,2,22,8,6,70,36,34,74
Alloa,7520,3,18,8,10,60,45,15,62
Arbroath,7520,4,17,9,10,72,50,22,60
Stranraer,7520,5,15,5,16,55,68,-13,50
East Fife,7520,6,14,3,19,51,64,-13,45
Airdrieon,7520,7,10,11,15,45,59,-14,41
Forfar,7520,8,11,5,20,39,64,-25,38
Albion,7520,9,8,6,22,57,82,-25,30
Queen's Park,7520,10,6,11,19,41,74,-33,29
Raith,7521,1,23,8,5,72,33,39,77
Ayr,7521,2,24,4,8,95,42,53,76
Arbroath,7521,3,18,8,10,74,49,25,62
Alloa,7521,4,17,8,11,57,47,10,59
Stranraer,7521,5,16,5,15,56,64,-8,53
East Fife,7521,6,13,3,20,47,65,-18,42
Airdrieon,7521,7,10,11,15,45,59,-14,41
Forfar,7521,8,11,5,20,39,64,-25,38
Albion,7521,9,8,6,22,57,83,-26,30
Queen's Park,7521,10,6,10,20,40,76,-36,28
Ayr,7522,1,24,4,8,94,43,51,76
Raith,7522,2,22,9,5,70,34,36,75
Arbroath,7522,3,18,8,10,75,51,24,62
Alloa,7522,4,17,9,10,58,45,13,60
Stranraer,7522,5,16,5,15,58,64,-6,53
Airdrieon,7522,6,11,11,14,47,59,-12,44
East Fife,7522,7,13,3,20,47,67,-20,42
Forfar,7522,8,10,5,21,39,66,-27,35
Albion,7522,9,8,6,22,58,82,-24,30
Queen's Park,7522,10,6,10,20,42,77,-35,28
Ayr,7523,1,24,4,8,94,42,52,76
Raith,7523,2,22,9,5,68,32,36,75
Arbroath,7523,3,17,9,10,70,48,22,60
Alloa,7523,4,17,9,10,56,43,13,60
Stranraer,7523,5,15,5,16,55,65,-10,50
East Fife,7523,6,14,3,19,48,64,-16,45
Airdrieon,7523,7,11,11,14,46,58,-12,44
Forfar,7523,8,10,5,21,38,65,-27,35
Albion,7523,9,8,6,22,57,82,-25,30
Queen's Park,7523,10,6,11,19,39,72,-33,29
Ayr,7524,1,24,4,8,91,42,49,76
Raith,7524,2,22,8,6,69,36,33,74
Arbroath,7524,3,18,8,10,72,48,24,62
Alloa,7524,4,18,8,10,60,44,16,62
Stranraer,7524,5,15,5,16,55,65,-10,50
East Fife,7524,6,14,3,19,48,64,-16,45
Airdrieon,7524,7,10,12,14,47,60,-13,42
Forfar,7524,8,10,6,20,40,66,-26,36
Albion,7524,9,8,6,22,57,79,-22,30
Queen's Park,7524,10,6,10,20,39,74,-35,28
Ayr,7525,1,24,4,8,94,45,49,76
Raith,7525,2,22,9,5,69,33,36,75
Arbroath,7525,3,17,9,10,72,50,22,60
Alloa,7525,4,17,9,10,57,44,13,60
Stranraer,7525,5,16,5,15,60,65,-5,53
Airdrieon,7525,6,11,11,14,48,59,-11,44
East Fife,7525,7,13,3,20,48,69,-21,42
Forfar,7525,8,10,5,21,39,67,-28,35
Albion,7525,9,8,6,22,60,82,-22,30
Queen's Park,7525,10,6,11,19,41,74,-33,29
Ayr,7526,1,24,4,8,93,44,49,76
Raith,7526,2,22,9,5,68,32,36,75
Arbroath,7526,3,18,8,10,73,49,24,62
Alloa,7526,4,17,9,10,56,43,13,60
Stranraer,7526,5,15,5,16,56,66,-10,50
East Fife,7526,6,14,3,19,49,65,-16,45
Airdrieon,7526,7,11,11,14,48,58,-10,44
Forfar,7526,8,10,5,21,38,67,-29,35
Albion,7526,9,8,6,22,59,81,-22,30
Queen's Park,7526,10,6,10,20,40,75,-35,28
Ayr,7527,1,24,4,8,94,43,51,76
Raith,7527,2,22,9,5,70,34,36,75
Alloa,7527,3,17,9,10,58,45,13,60
Arbroath,7527,4,17,8,11,71,51,20,59
Stranraer,7527,5,16,5,15,57,65,-8,53
East Fife,7527,6,13,3,20,48,66,-18,42
Airdrieon,7527,7,10,11,15,46,60,-14,41
Forfar,7527,8,11,5,20,40,65,-25,38
Queen's Park,7527,9,7,10,19,42,73,-31,31
Albion,7527,10,8,6,22,58,82,-24,30
Raith,7528,1,23,8,5,69,32,37,77
Ayr,7528,2,23,5,8,92,44,48,74
Arbroath,7528,3,18,8,10,75,52,23,62
Alloa,7528,4,17,8,11,56,44,12,59
Stranraer,7528,5,16,5,15,58,64,-6,53
Airdrieon,7528,6,10,12,14,45,58,-13,42
East Fife,7528,7,13,3,20,47,67,-20,42
Forfar,7528,8,10,6,20,38,64,-26,36
Albion,7528,9,8,7,21,59,80,-21,31
Queen's Park,7528,10,6,10,20,43,77,-34,28
Raith,7529,1,22,9,5,68,32,36,75
Ayr,7529,2,23,5,8,92,44,48,74
Alloa,7529,3,17,9,10,56,43,13,60
Arbroath,7529,4,17,8,11,72,51,21,59
Stranraer,7529,5,16,5,15,57,64,-7,53
East Fife,7529,6,13,3,20,47,66,-19,42
Airdrieon,7529,7,10,11,15,47,61,-14,41
Forfar,7529,8,11,5,20,41,66,-25,38
Albion,7529,9,8,7,21,59,80,-21,31
Queen's Park,7529,10,7,10,19,42,74,-32,31
Ayr,7530,1,24,4,8,93,44,49,76
Raith,7530,2,22,9,5,69,33,36,75
Arbroath,7530,3,18,8,10,73,48,25,62
Alloa,7530,4,17,9,10,57,44,13,60
Stranraer,7530,5,15,5,16,58,68,-10,50
East Fife,7530,6,14,3,19,51,67,-16,45
Airdrieon,7530,7,11,11,14,49,59,-10,44
Forfar,7530,8,10,5,21,39,68,-29,35
Albion,7530,9,8,6,22,59,81,-22,30
Queen's Park,7530,10,6,10,20,39,75,-36,28
Raith,7531,1,23,8,5,71,32,39,77
Ayr,7531,2,24,4,8,96,43,53,76
Arbroath,7531,3,17,9,10,72,50,22,60
Alloa,7531,4,17,8,11,56,46,10,59
Stranraer,7531,5,15,5,16,56,66,-10,50
East Fife,7531,6,14,3,19,49,65,-16,45
Airdrieon,7531,7,10,11,15,45,60,-15,41
Forfar,7531,8,11,5,20,40,64,-24,38
Albion,7531,9,8,6,22,58,84,-26,30
Queen's Park,7531,10,6,11,19,41,74,-33,29
Ayr,7532,1,24,4,8,99,45,54,76
Raith,7532,2,22,9,5,69,33,36,75
Alloa,7532,3,17,9,10,57,44,13,60
Arbroath,7532,4,17,8,11,71,50,21,59
Stranraer,7532,5,15,6,15,56,65,-9,51
Airdrieon,7532,6,11,11,14,47,59,-12,44
East Fife,7532,7,13,4,19,48,65,-17,43
Forfar,7532,8,10,5,21,39,66,-27,35
Queen's Park,7532,9,7,10,19,41,73,-32,31
Albion,7532,10,8,6,22,60,87,-27,30
Ayr,7533,1,24,4,8,92,43,49,76
Raith,7533,2,22,8,6,69,34,35,74
Arbroath,7533,3,18,8,10,72,49,23,62
Alloa,7533,4,18,8,10,58,44,14,62
Stranraer,7533,5,15,5,16,55,65,-10,50
East Fife,7533,6,14,3,19,48,64,-16,45
Airdrieon,7533,7,11,11,14,48,58,-10,44
Forfar,7533,8,10,5,21,38,67,-29,35
Albion,7533,9,8,6,22,58,80,-22,30
Queen's Park,7533,10,6,10,20,40,74,-34,28
Raith,7534,1,23,8,5,71,32,39,77
Ayr,7534,2,23,5,8,94,46,48,74
Arbroath,7534,3,17,8,11,71,52,19,59
Alloa,7534,4,17,8,11,56,46,10,59
Stranraer,7534,5,15,5,16,56,68,-12,50
East Fife,7534,6,14,3,19,51,65,-14,45
Airdrieon,7534,7,10,11,15,47,61,-14,41
Forfar,7534,8,11,5,20,41,66,-25,38
Albion,7534,9,8,7,21,61,82,-21,31
Queen's Park,7534,10,7,10,19,43,73,-30,31
Raith,7535,1,23,8,5,72,33,39,77
Ayr,7535,2,24,4,8,96,44,52,76
Arbroath,7535,3,17,8,11,71,51,20,59
Alloa,7535,4,17,8,11,57,47,10,59
Stranraer,7535,5,15,6,15,57,66,-9,51
East Fife,7535,6,13,4,19,49,66,-17,43
Airdrieon,7535,7,10,11,15,45,59,-14,41
Forfar,7535,8,11,5,20,39,64,-25,38
Queen's Park,7535,9,7,10,19,42,73,-31,31
Albion,7535,10,8,6,22,59,84,-25,30
Raith,7536,1,23,8,5,70,33,37,77
Ayr,7536,2,24,4,8,93,42,51,76
Arbroath,7536,3,17,9,10,72,50,22,60
Alloa,7536,4,17,8,11,57,45,12,59
Stranraer,7536,5,16,5,15,57,65,-8,53
Airdrieon,7536,6,11,11,14,46,58,-12,44
East Fife,7536,7,13,3,20,48,66,-18,42
Forfar,7536,8,10,5,21,38,65,-27,35
Albion,7536,9,8,6,22,57,81,-24,30
Queen's Park,7536,10,6,11,19,41,74,-33,29
Raith,7537,1,23,8,5,69,32,37,77
Ayr,7537,2,24,4,8,93,44,49,76
Arbroath,7537,3,17,8,11,72,51,21,59
Alloa,7537,4,17,8,11,56,44,12,59
Stranraer,7537,5,16,5,15,58,66,-8,53
Airdrieon,7537,6,11,11,14,46,58,-12,44
East Fife,7537,7,13,3,20,49,67,-18,42
Forfar,7537,8,10,5,21,38,65,-27,35
Queen's Park,7537,9,7,10,19,42,74,-32,31
Albion,7537,10,8,6,22,59,81,-22,30
Raith,7538,1,23,8,5,70,33,37,77
Ayr,7538,2,23,4,9,91,44,47,73
Arbroath,7538,3,17,8,11,70,49,21,59
Alloa,7538,4,17,8,11,57,45,12,59
Stranraer,7538,5,15,5,16,55,66,-11,50
East Fife,7538,6,14,3,19,49,64,-15,45
Airdrieon,7538,7,11,11,14,50,59,-9,44
Forfar,7538,8,10,5,21,39,69,-30,35
Albion,7538,9,9,6,21,59,79,-20,33
Queen's Park,7538,10,7,10,19,40,72,-32,31
Ayr,7539,1,24,4,8,95,44,51,76
Raith,7539,2,22,8,6,70,35,35,74
Alloa,7539,3,18,8,10,59,45,14,62
Arbroath,7539,4,17,9,10,71,49,22,60
Stranraer,7539,5,16,5,15,56,64,-8,53
Airdrieon,7539,6,11,11,14,48,59,-11,44
East Fife,7539,7,13,3,20,47,65,-18,42
Forfar,7539,8,10,5,21,39,67,-28,35
Albion,7539,9,8,6,22,59,83,-24,30
Queen's Park,7539,10,6,11,19,40,73,-33,29
Raith,7540,1,23,8,5,70,32,38,77
Ayr,7540,2,24,4,8,94,45,49,76
Arbroath,7540,3,18,8,10,72,48,24,62
Alloa,7540,4,17,8,11,56,45,11,59
Stranraer,7540,5,15,6,15,57,66,-9,51
Airdrieon,7540,6,11,11,14,46,58,-12,44
East Fife,7540,7,13,4,19,49,66,-17,43
Forfar,7540,8,10,5,21,38,65,-27,35
Albion,7540,9,8,6,22,60,82,-22,30
Queen's Park,7540,10,6,10,20,39,74,-35,28
Raith,7541,1,23,8,5,71,32,39,77
Ayr,7541,2,24,4,8,96,42,54,76
Arbroath,7541,3,17,8,11,71,50,21,59
Alloa,7541,4,17,8,11,56,46,10,59
Stranraer,7541,5,15,5,16,56,68,-12,50
East Fife,7541,6,14,3,19,51,65,-14,45
Airdrieon,7541,7,11,11,14,48,58,-10,44
Forfar,7541,8,10,5,21,38,67,-29,35
Queen's Park,7541,9,7,10,19,41,73,-32,31
Albion,7541,10,8,6,22,57,84,-27,30
Ayr,7542,1,24,4,8,97,44,53,76
Raith,7542,2,22,9,5,69,33,36,75
Arbroath,7542,3,18,8,10,74,49,25,62
Alloa,7542,4,17,9,10,57,44,13,60
Stranraer,7542,5,15,6,15,56,65,-9,51
Airdrieon,7542,6,11,11,14,49,59,-10,44
East Fife,7542,7,13,4,19,48,65,-17,43
Forfar,7542,8,10,5,21,39,68,-29,35
Albion,7542,9,8,6,22,59,85,-26,30
Queen's Park,7542,10,6,10,20,40,76,-36,28
Raith,7543,1,23,8,5,70,33,37,77
Ayr,7543,2,23,5,8,92,44,48,74
Arbroath,7543,3,18,8,10,73,48,25,62
Alloa,7543,4,17,8,11,57,45,12,59
Stranraer,7543,5,15,5,16,55,65,-10,50
East Fife,7543,6,14,3,19,48,64,-16,45
Airdrieon,7543,7,11,11,14,47,58,-11,44
Forfar,7543,8,10,5,21,38,66,-28,35
Albion,7543,9,8,7,21,59,80,-21,31
Queen's Park,7543,10,6,10,20,39,75,-36,28
Ayr,7544,1,24,4,8,95,42,53,76
Raith,7544,2,22,8,6,68,33,35,74
Alloa,7544,3,18,8,10,57,43,14,62
Arbroath,7544,4,17,9,10,70,48,22,60
Stranraer,7544,5,15,5,16,55,67,-12,50
East Fife,7544,6,14,3,19,50,64,-14,45
Airdrieon,7544,7,10,12,14,46,59,-13,42
Forfar,7544,8,10,6,20,39,65,-26,36
Albion,7544,9,8,6,22,57,83,-26,30
Queen's Park,7544,10,6,11,19,39,72,-33,29
Raith,7545,1,23,8,5,70,32,38,77
Ayr,7545,2,23,4,9,90,43,47,73
Arbroath,7545,3,18,8,10,72,49,23,62
Alloa,7545,4,17,8,11,56,45,11,59
Stranraer,7545,5,15,5,16,56,69,-13,50
East Fife,7545,6,14,3,19,52,65,-13,45
Airdrieon,7545,7,11,11,14,48,60,-12,44
Forfar,7545,8,10,5,21,40,67,-27,35
Albion,7545,9,9,6,21,58,78,-20,33
Queen's Park,7545,10,6,10,20,40,74,-34,28
Raith,7546,1,23,8,5,71,32,39,77
Ayr,7546,2,24,4,8,95,43,52,76
Arbroath,7546,3,17,9,10,70,48,22,60
Alloa,7546,4,17,8,11,56,46,10,59
Stranraer,7546,5,15,5,16,55,66,-11,50
East Fife,7546,6,14,3,19,49,64,-15,45
Airdrieon,7546,7,10,11,15,45,59,-14,41
Forfar,7546,8,11,5,20,39,64,-25,38
Albion,7546,9,8,6,22,58,83,-25,30
Queen's Park,7546,10,6,11,19,39,72,-33,29
Ayr,7547,1,24,4,8,93,43,50,76
Raith,7547,2,22,8,6,68,33,35,74
Arbroath,7547,3,18,8,10,72,49,23,62
Alloa,7547,4,18,8,10,57,43,14,62
Stranraer,7547,5,16,5,15,56,64,-8,53
East Fife,7547,6,13,3,20,47,65,-18,42
Airdrieon,7547,7,10,11,15,46,60,-14,41
Forfar,7547,8,11,5,20,40,65,-25,38
Albion,7547,9,8,6,22,58,81,-23,30
Queen's Park,7547,10,6,10,20,40,74,-34,28
Raith,7548,1,23,8,5,71,32,39,77
Ayr,7548,2,24,4,8,92,43,49,76
Arbroath,7548,3,17,9,10,72,50,22,60
Alloa,7548,4,17,8,11,56,46,10,59
Stranraer,7548,5,16,5,15,56,64,-8,53
Airdrieon,7548,6,10,12,14,47,60,-13,42
East Fife,7548,7,13,3,20,47,65,-18,42
Forfar,7548,8,10,6,20,40,66,-26,36
Albion,7548,9,8,6,22,58,80,-22,30
Queen's Park,7548,10,6,11,19,41,74,-33,29
Raith,7549,1,22,8,6,68,33,35,74
Ayr,7549,2,23,4,9,91,44,47,73
Arbroath,7549,3,18,8,10,73,48,25,62
Alloa,7549,4,18,8,10,57,43,14,62
Stranraer,7549,5,16,5,15,58,64,-6,53
East Fife,7549,6,13,3,20,47,67,-20,42
Airdrieon,7549,7,10,11,15,45,60,-15,41
Forfar,7549,8,11,5,20,40,64,-24,38
Albion,7549,9,9,6,21,59,79,-20,33
Queen's Park,7549,10,6,10,20,39,75,-36,28
Raith,7550,1,23,8,5,69,32,37,77
Ayr,7550,2,24,4,8,93,42,51,76
Arbroath,7550,3,18,8,10,72,49,23,62
Alloa,7550,4,17,8,11,56,44,12,59
Stranraer,7550,5,15,5,16,57,67,-10,50
East Fife,7550,6,14,3,19,50,66,-16,45
Airdrieon,7550,7,10,12,14,46,59,-13,42
Forfar,7550,8,10,6,20,39,65,-26,36
Albion,7550,9,8,6,22,57,81,-24,30
Queen's Park,7550,10,6,10,20,40,74,-34,28
Raith,7551,1,23,8,5,71,33,38,77
Ayr,7551,2,23,4,9,90,43,47,73
Arbroath,7551,3,18,8,10,73,49,24,62
Alloa,7551,4,17,8,11,57,46,11,59
Stranraer,7551,5,16,5,15,59,65,-6,53
Airdrieon,7551,6,11,11,14,47,59,-12,44
East Fife,7551,7,13,3,20,48,68,-20,42
Forfar,7551,8,10,5,21,39,66,-27,35
Albion,7551,9,9,6,21,58,78,-20,33
Queen's Park,7551,10,6,10,20,40,75,-35,28
Raith,7552,1,23,8,5,70,32,38,77
Ayr,7552,2,23,5,8,92,44,48,74
Arbroath,7552,3,17,8,11,71,50,21,59
Alloa,7552,4,17,8,11,56,45,11,59
Stranraer,7552,5,16,5,15,58,65,-7,53
Airdrieon,7552,6,10,12,14,46,59,-13,42
East Fife,7552,7,13,3,20,48,67,-19,42
Forfar,7552,8,10,6,20,39,65,-26,36
Albion,7552,9,8,7,21,59,80,-21,31
Queen's Park,7552,10,7,10,19,41,73,-32,31
Ayr,7553,1,24,4,8,97,42,55,76
Raith,7553,2,22,9,5,69,33,36,75
Arbroath,7553,3,18,8,10,72,49,23,62
Alloa,7553,4,17,9,10,57,44,13,60
Stranraer,7553,5,15,5,16,55,65,-10,50
East Fife,7553,6,14,3,19,48,64,-16,45
Airdrieon,7553,7,11,11,14,46,58,-12,44
Forfar,7553,8,10,5,21,38,65,-27,35
Albion,7553,9,8,6,22,57,85,-28,30
Queen's Park,7553,10,6,10,20,40,74,-34,28
Ayr,7554,1,24,4,8,93,43,50,76
Raith,7554,2,22,9,5,68,32,36,75
Arbroath,7554,3,18,8,10,74,48,26,62
Alloa,7554,4,17,9,10,56,43,13,60
Stranraer,7554,5,15,5,16,56,69,-13,50
East Fife,7554,6,14,3,19,52,65,-13,45
Airdrieon,7554,7,11,11,14,48,60,-12,44
Forfar,7554,8,10,5,21,40,67,-27,35
Albion,7554,9,8,6,22,58,81,-23,30
Queen's Park,7554,10,6,10,20,39,76,-37,28
Ayr,7555,1,24,4,8,93,42,51,76
Raith,7555,2,22,9,5,69,33,36,75
Alloa,7555,3,17,9,10,57,44,13,60
Arbroath,7555,4,17,8,11,71,50,21,59
Stranraer,7555,5,15,5,16,56,67,-11,50
East Fife,7555,6,14,3,19,50,65,-15,45
Airdrieon,7555,7,11,11,14,47,58,-11,44
Forfar,7555,8,10,5,21,38,66,-28,35
Queen's Park,7555,9,7,10,19,41,73,-32,31
Albion,7555,10,8,6,22,57,81,-24,30
Ayr,7556,1,24,4,8,94,43,51,76
Raith,7556,2,22,9,5,69,33,36,75
Alloa,7556,3,17,9,10,57,44,13,60
Arbroath,7556,4,17,8,11,70,49,21,59
Stranraer,7556,5,15,5,16,56,66,-10,50
East Fife,7556,6,14,3,19,49,65,-16,45
Airdrieon,7556,7,11,11,14,46,58,-12,44
Forfar,7556,8,10,5,21,38,65,-27,35
Queen's Park,7556,9,7,10,19,40,72,-32,31
Albion,7556,10,8,6,22,58,82,-24,30
Raith,7557,1,23,8,5,71,34,37,77
Ayr,7557,2,24,4,8,92,42,50,76
Arbroath,7557,3,17,8,11,70,49,21,59
Alloa,7557,4,17,8,11,58,46,12,59
Stranraer,7557,5,15,5,16,55,65,-10,50
East Fife,7557,6,14,3,19,48,64,-16,45
Airdrieon,7557,7,11,11,14,48,58,-10,44
Forfar,7557,8,10,5,21,38,67,-29,35
Queen's Park,7557,9,7,10,19,40,72,-32,31
Albion,7557,10,8,6,22,57,80,-23,30
Raith,7558,1,23,8,5,70,32,38,77
Ayr,7558,2,24,4,8,91,42,49,76
Arbroath,7558,3,18,8,10,75,50,25,62
Alloa,7558,4,17,8,11,56,45,11,59
Stranraer,7558,5,16,5,15,58,66,-8,53
Airdrieon,7558,6,11,11,14,47,59,-12,44
East Fife,7558,7,13,3,20,49,67,-18,42
Forfar,7558,8,10,5,21,39,66,-27,35
Albion,7558,9,8,6,22,57,79,-22,30
Queen's Park,7558,10,6,10,20,41,77,-36,28
Raith,7559,1,23,8,5,70,33,37,77
Ayr,7559,2,23,5,8,91,43,48,74
Arbroath,7559,3,17,8,11,71,50,21,59
Alloa,7559,4,17,8,11,57,45,12,59
Stranraer,7559,5,16,5,15,59,64,-5,53
East Fife,7559,6,13,3,20,47,68,-21,42
Airdrieon,7559,7,10,11,15,45,59,-14,41
Forfar,7559,8,11,5,20,39,64,-25,38
Albion,7559,9,8,7,21,58,79,-21,31
Queen's Park,7559,10,7,10,19,41,73,-32,31
Ayr,7560,1,24,4,8,95,43,52,76
Raith,7560,2,22,8,6,68,33,35,74
Arbroath,7560,3,18,8,10,72,48,24,62
Alloa,7560,4,18,8,10,57,43,14,62
Stranraer,7560,5,16,5,15,59,66,-7,53
Airdrieon,7560,6,11,11,14,49,61,-12,44
East Fife,7560,7,13,3,20,49,68,-19,42
Forfar,7560,8,10,5,21,41,68,-27,35
Albion,7560,9,8,6,22,58,83,-25,30
Queen's Park,7560,10,6,10,20,39,74,-35,28
Raith,7561,1,23,8,5,73,33,40,77
Ayr,7561,2,24,4,8,92,42,50,76
Arbroath,7561,3,18,8,10,74,48,26,62
Alloa,7561,4,17,8,11,57,48,9,59
Stranraer,7561,5,15,5,16,55,67,-12,50
East Fife,7561,6,14,3,19,50,64,-14,45
Airdrieon,7561,7,10,12,14,46,59,-13,42
Forfar,7561,8,10,6,20,39,65,-26,36
Albion,7561,9,8,6,22,57,80,-23,30
Queen's Park,7561,10,6,10,20,39,76,-37,28
Ayr,7562,1,24,4,8,93,44,49,76
Raith,7562,2,22,8,6,68,34,34,74
Alloa,7562,3,18,8,10,58,43,15,62
Arbroath,7562,4,17,8,11,70,49,21,59
Stranraer,7562,5,15,5,16,56,68,-12,50
East Fife,7562,6,14,3,19,51,65,-14,45
Airdrieon,7562,7,11,11,14,47,59,-12,44
Forfar,7562,8,10,5,21,39,66,-27,35
Queen's Park,7562,9,7,10,19,40,72,-32,31
Albion,7562,10,8,6,22,59,81,-22,30
Raith,7563,1,23,8,5,70,32,38,77
Ayr,7563,2,24,4,8,95,43,52,76
Arbroath,7563,3,18,8,10,74,50,24,62
Alloa,7563,4,17,8,11,56,45,11,59
Stranraer,7563,5,16,5,15,56,64,-8,53
Airdrieon,7563,6,10,12,14,46,59,-13,42
East Fife,7563,7,13,3,20,47,65,-18,42
Forfar,7563,8,10,6,20,39,65,-26,36
Albion,7563,9,8,6,22,58,83,-25,30
Queen's Park,7563,10,6,10,20,41,76,-35,28
Ayr,7564,1,24,4,8,94,43,51,76
Raith,7564,2,22,8,6,69,34,35,74
Arbroath,7564,3,18,8,10,74,49,25,62
Alloa,7564,4,18,8,10,58,44,14,62
Stranraer,7564,5,16,5,15,57,65,-8,53
Airdrieon,7564,6,11,11,14,49,58,-9,44
East Fife,7564,7,13,3,20,48,66,-18,42
Forfar,7564,8,10,5,21,38,68,-30,35
Albion,7564,9,8,6,22,58,82,-24,30
Queen's Park,7564,10,6,10,20,40,76,-36,28
Raith,7565,1,23,8,5,71,33,38,77
Ayr,7565,2,23,4,9,92,46,46,73
Arbroath,7565,3,17,8,11,70,50,20,59
Alloa,7565,4,17,8,11,57,46,11,59
Stranraer,7565,5,16,5,15,57,64,-7,53
Airdrieon,7565,6,11,11,14,47,58,-11,44
East Fife,7565,7,13,3,20,47,66,-19,42
Forfar,7565,8,10,5,21,38,66,-28,35
Albion,7565,9,9,6,21,61,80,-19,33
Queen's Park,7565,10,7,10,19,41,72,-31,31
Raith,7566,1,23,8,5,70,33,37,77
Ayr,7566,2,24,4,8,93,42,51,76
Arbroath,7566,3,17,9,10,71,49,22,60
Alloa,7566,4,17,8,11,57,45,12,59
Stranraer,7566,5,15,5,16,55,66,-11,50
East Fife,7566,6,14,3,19,49,64,-15,45
Airdrieon,7566,7,10,12,14,45,58,-13,42
Forfar,7566,8,10,6,20,38,64,-26,36
Albion,7566,9,8,6,22,57,81,-24,30
Queen's Park,7566,10,6,11,19,40,73,-33,29
Raith,7567,1,23,8,5,70,32,38,77
Ayr,7567,2,24,4,8,94,44,50,76
Arbroath,7567,3,17,9,10,71,49,22,60
Alloa,7567,4,17,8,11,56,45,11,59
Stranraer,7567,5,15,5,16,55,66,-11,50
East Fife,7567,6,14,3,19,49,64,-15,45
Airdrieon,7567,7,11,11,14,49,60,-11,44
Forfar,7567,8,10,5,21,40,68,-28,35
Albion,7567,9,8,6,22,59,82,-23,30
Queen's Park,7567,10,6,11,19,40,73,-33,29
Ayr,7568,1,24,4,8,93,43,50,76
Raith,7568,2,22,9,5,71,35,36,75
Alloa,7568,3,17,9,10,59,46,13,60
Arbroath,7568,4,17,8,11,71,51,20,59
Stranraer,7568,5,16,5,15,58,64,-6,53
East Fife,7568,6,13,3,20,47,67,-20,42
Airdrieon,7568,7,10,11,15,46,63,-17,41
Forfar,7568,8,11,5,20,43,65,-22,38
Queen's Park,7568,9,7,10,19,42,73,-31,31
Albion,7568,10,8,6,22,58,81,-23,30
Ayr,7569,1,24,4,8,92,42,50,76
Raith,7569,2,22,8,6,68,33,35,74
Arbroath,7569,3,18,8,10,72,48,24,62
Alloa,7569,4,18,8,10,57,43,14,62
Stranraer,7569,5,16,5,15,58,65,-7,53
East Fife,7569,6,13,3,20,48,67,-19,42
Airdrieon,7569,7,10,11,15,47,62,-15,41
Forfar,7569,8,11,5,20,42,66,-24,38
Albion,7569,9,8,6,22,57,80,-23,30
Queen's Park,7569,10,6,10,20,39,74,-35,28
Ayr,7570,1,24,4,8,96,43,53,76
Raith,7570,2,22,9,5,69,33,36,75
Arbroath,7570,3,17,9,10,71,49,22,60
Alloa,7570,4,17,9,10,57,44,13,60
Stranraer,7570,5,15,6,15,56,65,-9,51
Airdrieon,7570,6,11,11,14,47,59,-12,44
East Fife,7570,7,13,4,19,48,65,-17,43
Forfar,7570,8,10,5,21,39,66,-27,35
Albion,7570,9,8,6,22,58,84,-26,30
Queen's Park,7570,10,6,11,19,40,73,-33,29
Ayr,7571,1,24,4,8,93,42,51,76
Raith,7571,2,22,9,5,69,33,36,75
Alloa,7571,3,17,9,10,57,44,13,60
Arbroath,7571,4,17,8,11,70,50,20,59
Stranraer,7571,5,15,5,16,55,66,-11,50
East Fife,7571,6,14,3,19,49,64,-15,45
Airdrieon,7571,7,10,12,14,46,59,-13,42
Forfar,7571,8,10,6,20,39,65,-26,36
Queen's Park,7571,9,7,10,19,41,72,-31,31
Albion,7571,10,8,6,22,57,81,-24,30
Raith,7572,1,23,8,5,69,32,37,77
Ayr,7572,2,24,4,8,93,44,49,76
Arbroath,7572,3,17,9,10,71,49,22,60
Alloa,7572,4,17,8,11,56,44,12,59
Stranraer,7572,5,15,6,15,55,64,-9,51
Airdrieon,7572,6,11,11,14,48,60,-12,44
East Fife,7572,7,13,4,19,47,64,-17,43
Forfar,7572,8,10,5,21,40,67,-27,35
Albion,7572,9,8,6,22,59,81,-22,30
Queen's Park,7572,10,6,11,19,40,73,-33,29
Raith,7573,1,23,8,5,69,32,37,77
Ayr,7573,2,24,4,8,94,43,51,76
Arbroath,7573,3,18,8,10,74,49,25,62
Alloa,7573,4,17,8,11,56,44,12,59
Stranraer,7573,5,15,5,16,55,67,-12,50
East Fife,7573,6,14,3,19,50,64,-14,45
Airdrieon,7573,7,11,11,14,48,58,-10,44
Forfar,7573,8,10,5,21,38,67,-29,35
Albion,7573,9,8,6,22,58,82,-24,30
Queen's Park,7573,10,6,10,20,40,76,-36,28
Raith,7574,1,23,8,5,70,33,37,77
Ayr,7574,2,24,4,8,92,43,49,76
Arbroath,7574,3,17,8,11,70,51,19,59
Alloa,7574,4,17,8,11,57,45,12,59
Stranraer,7574,5,15,5,16,55,65,-10,50
East Fife,7574,6,14,3,19,48,64,-16,45
Airdrieon,7574,7,10,11,15,45,59,-14,41
Forfar,7574,8,11,5,20,39,64,-25,38
Queen's Park,7574,9,7,10,19,42,72,-30,31
Albion,7574,10,8,6,22,58,80,-22,30
Raith,7575,1,23,8,5,70,33,37,77
Ayr,7575,2,24,4,8,94,45,49,76
Arbroath,7575,3,17,8,11,70,49,21,59
Alloa,7575,4,17,8,11,57,45,12,59
Stranraer,7575,5,15,5,16,55,65,-10,50
East Fife,7575,6,14,3,19,48,64,-16,45
Airdrieon,7575,7,11,11,14,46,58,-12,44
Forfar,7575,8,10,5,21,38,65,-27,35
Queen's Park,7575,9,7,10,19,40,72,-32,31
Albion,7575,10,8,6,22,60,82,-22,30
Ayr,7576,1,24,4,8,96,43,53,76
Raith,7576,2,22,9,5,70,34,36,75
Arbroath,7576,3,17,9,10,70,48,22,60
Alloa,7576,4,17,9,10,58,45,13,60
Stranraer,7576,5,16,5,15,56,64,-8,53
Airdrieon,7576,6,11,11,14,49,58,-9,44
East Fife,7576,7,13,3,20,47,65,-18,42
Forfar,7576,8,10,5,21,38,68,-30,35
Albion,7576,9,8,6,22,58,84,-26,30
Queen's Park,7576,10,6,11,19,39,72,-33,29
Ayr,7577,1,23,5,8,91,43,48,74
Raith,7577,2,22,8,6,69,36,33,74
Arbroath,7577,3,18,8,10,75,50,25,62
Alloa,7577,4,18,8,10,60,44,16,62
Stranraer,7577,5,15,6,15,57,66,-9,51
East Fife,7577,6,13,4,19,49,66,-17,43
Airdrieon,7577,7,10,12,14,45,58,-13,42
Forfar,7577,8,10,6,20,38,64,-26,36
Albion,7577,9,8,7,21,58,79,-21,31
Queen's Park,7577,10,6,10,20,41,77,-36,28
Raith,7578,1,23,8,5,71,33,38,77
Ayr,7578,2,23,5,8,92,44,48,74
Arbroath,7578,3,17,9,10,70,48,22,60
Alloa,7578,4,17,8,11,57,46,11,59
Stranraer,7578,5,15,5,16,56,66,-10,50
East Fife,7578,6,14,3,19,49,65,-16,45
Airdrieon,7578,7,11,11,14,48,59,-11,44
Forfar,7578,8,10,5,21,39,67,-28,35
Albion,7578,9,8,7,21,59,80,-21,31
Queen's Park,7578,10,6,11,19,39,72,-33,29
Raith,7579,1,23,8,5,74,33,41,77
Ayr,7579,2,24,4,8,96,43,53,76
Arbroath,7579,3,17,9,10,71,49,22,60
Alloa,7579,4,17,8,11,57,49,8,59
Stranraer,7579,5,15,5,16,57,67,-10,50
East Fife,7579,6,14,3,19,50,66,-16,45
Airdrieon,7579,7,11,11,14,48,59,-11,44
Forfar,7579,8,10,5,21,39,67,-28,35
Albion,7579,9,8,6,22,58,84,-26,30
Queen's Park,7579,10,6,11,19,40,73,-33,29
Ayr,7580,1,24,4,8,95,42,53,76
Raith,7580,2,22,9,5,70,34,36,75
Alloa,7580,3,17,9,10,58,45,13,60
Arbroath,7580,4,17,8,11,70,51,19,59
Stranraer,7580,5,16,5,15,56,64,-8,53
Airdrieon,7580,6,10,12,14,47,60,-13,42
East Fife,7580,7,13,3,20,47,65,-18,42
Forfar,7580,8,10,6,20,40,66,-26,36
Queen's Park,7580,9,7,10,19,42,72,-30,31
Albion,7580,10,8,6,22,57,83,-26,30
Ayr,7581,1,24,4,8,93,42,51,76
Raith,7581,2,22,8,6,69,35,34,74
Alloa,7581,3,18,8,10,59,44,15,62
Arbroath,7581,4,17,8,11,72,51,21,59
Stranraer,7581,5,15,5,16,55,67,-12,50
East Fife,7581,6,14,3,19,50,64,-14,45
Airdrieon,7581,7,10,12,14,46,59,-13,42
Forfar,7581,8,10,6,20,39,65,-26,36
Queen's Park,7581,9,7,10,19,42,74,-32,31
Albion,7581,10,8,6,22,57,81,-24,30
Ayr,7582,1,24,4,8,93,43,50,76
Raith,7582,2,22,9,5,68,32,36,75
Arbroath,7582,3,18,8,10,73,48,25,62
Alloa,7582,4,17,9,10,56,43,13,60
Stranraer,7582,5,16,5,15,57,65,-8,53
East Fife,7582,6,13,3,20,48,66,-18,42
Airdrieon,7582,7,10,11,15,47,61,-14,41
Forfar,7582,8,11,5,20,41,66,-25,38
Albion,7582,9,8,6,22,58,81,-23,30
Queen's Park,7582,10,6,10,20,39,75,-36,28
Ayr,7583,1,23,5,8,91,43,48,74
Raith,7583,2,22,8,6,68,34,34,74
Arbroath,7583,3,18,8,10,72,48,24,62
Alloa,7583,4,18,8,10,58,43,15,62
Stranraer,7583,5,16,5,15,56,64,-8,53
Airdrieon,7583,6,11,11,14,48,59,-11,44
East Fife,7583,7,13,3,20,47,65,-18,42
Forfar,7583,8,10,5,21,39,67,-28,35
Albion,7583,9,8,7,21,58,79,-21,31
Queen's Park,7583,10,6,10,20,39,74,-35,28
Ayr,7584,1,24,4,8,93,42,51,76
Raith,7584,2,22,8,6,70,35,35,74
Arbroath,7584,3,18,8,10,73,48,25,62
Alloa,7584,4,18,8,10,59,45,14,62
Stranraer,7584,5,16,5,15,57,65,-8,53
Airdrieon,7584,6,10,12,14,46,59,-13,42
East Fife,7584,7,13,3,20,48,66,-18,42
Forfar,7584,8,10,6,20,39,65,-26,36
Albion,7584,9,8,6,22,57,81,-24,30
Queen's Park,7584,10,6,10,20,39,75,-36,28
Raith,7585,1,23,8,5,70,32,38,77
Ayr,7585,2,23,5,8,93,45,48,74
Arbroath,7585,3,17,9,10,71,49,22,60
Alloa,7585,4,17,8,11,56,45,11,59
Stranraer,7585,5,15,5,16,55,69,-14,50
East Fife,7585,6,14,3,19,52,64,-12,45
Airdrieon,7585,7,11,11,14,47,59,-12,44
Forfar,7585,8,10,5,21,39,66,-27,35
Albion,7585,9,8,7,21,60,81,-21,31
Queen's Park,7585,10,6,11,19,40,73,-33,29
Raith,7586,1,23,8,5,71,34,37,77
Ayr,7586,2,24,4,8,93,43,50,76
Arbroath,7586,3,18,8,10,74,51,23,62
Alloa,7586,4,17,8,11,58,46,12,59
Stranraer,7586,5,16,5,15,58,65,-7,53
Airdrieon,7586,6,11,11,14,47,58,-11,44
East Fife,7586,7,13,3,20,48,67,-19,42
Forfar,7586,8,10,5,21,38,66,-28,35
Albion,7586,9,8,6,22,58,81,-23,30
Queen's Park,7586,10,6,10,20,42,76,-34,28
Raith,7587,1,23,8,5,70,33,37,77
Ayr,7587,2,23,5,8,92,44,48,74
Arbroath,7587,3,18,8,10,73,48,25,62
Alloa,7587,4,17,8,11,57,45,12,59
Stranraer,7587,5,16,5,15,59,64,-5,53
Airdrieon,7587,6,10,12,14,46,59,-13,42
East Fife,7587,7,13,3,20,47,68,-21,42
Forfar,7587,8,10,6,20,39,65,-26,36
Albion,7587,9,8,7,21,59,80,-21,31
Queen's Park,7587,10,6,10,20,39,75,-36,28
Raith,7588,1,23,8,5,70,32,38,77
Ayr,7588,2,24,4,8,95,44,51,76
Arbroath,7588,3,17,8,11,70,49,21,59
Alloa,7588,4,17,8,11,56,45,11,59
Stranraer,7588,5,16,5,15,57,65,-8,53
East Fife,7588,6,13,3,20,48,66,-18,42
Airdrieon,7588,7,10,11,15,45,60,-15,41
Forfar,7588,8,11,5,20,40,64,-24,38
Queen's Park,7588,9,7,10,19,40,72,-32,31
Albion,7588,10,8,6,22,59,83,-24,30
Ayr,7589,1,24,4,8,91,42,49,76
Raith,7589,2,22,9,5,69,33,36,75
Alloa,7589,3,17,9,10,57,44,13,60
Arbroath,7589,4,17,8,11,71,50,21,59
Stranraer,7589,5,15,5,16,58,68,-10,50
East Fife,7589,6,14,3,19,51,67,-16,45
Airdrieon,7589,7,10,11,15,46,60,-14,41
Forfar,7589,8,11,5,20,40,65,-25,38
Queen's Park,7589,9,7,10,19,41,73,-32,31
Albion,7589,10,8,6,22,57,79,-22,30
Raith,7590,1,22,8,6,69,34,35,74
Ayr,7590,2,23,4,9,91,46,45,73
Alloa,7590,3,18,8,10,58,44,14,62
Arbroath,7590,4,17,8,11,71,50,21,59
Stranraer,7590,5,15,5,16,57,67,-10,50
East Fife,7590,6,14,3,19,50,66,-16,45
Airdrieon,7590,7,11,11,14,49,59,-10,44
Forfar,7590,8,10,5,21,39,68,-29,35
Albion,7590,9,9,6,21,61,79,-18,33
Queen's Park,7590,10,7,10,19,41,73,-32,31
Raith,7591,1,23,8,5,71,34,37,77
Ayr,7591,2,24,4,8,95,42,53,76
Arbroath,7591,3,18,8,10,72,49,23,62
Alloa,7591,4,17,8,11,58,46,12,59
Stranraer,7591,5,15,6,15,57,66,-9,51
East Fife,7591,6,13,4,19,49,66,-17,43
Airdrieon,7591,7,10,12,14,46,59,-13,42
Forfar,7591,8,10,6,20,39,65,-26,36
Albion,7591,9,8,6,22,57,83,-26,30
Queen's Park,7591,10,6,10,20,40,74,-34,28
Ayr,7592,1,24,4,8,94,42,52,76
Raith,7592,2,22,9,5,69,33,36,75
Arbroath,7592,3,18,8,10,74,50,24,62
Alloa,7592,4,17,9,10,57,44,13,60
Stranraer,7592,5,15,5,16,56,66,-10,50
East Fife,7592,6,14,3,19,49,65,-16,45
Airdrieon,7592,7,10,12,14,45,58,-13,42
Forfar,7592,8,10,6,20,38,64,-26,36
Albion,7592,9,8,6,22,57,82,-25,30
Queen's Park,7592,10,6,10,20,41,76,-35,28
Ayr,7593,1,24,4,8,95,46,49,76
Raith,7593,2,22,9,5,69,33,36,75
Arbroath,7593,3,17,9,10,71,49,22,60
Alloa,7593,4,17,9,10,57,44,13,60
Stranraer,7593,5,15,5,16,58,68,-10,50
East Fife,7593,6,14,3,19,51,67,-16,45
Airdrieon,7593,7,10,12,14,46,59,-13,42
Forfar,7593,8,10,6,20,39,65,-26,36
Albion,7593,9,8,6,22,61,83,-22,30
Queen's Park,7593,10,6,11,19,40,73,-33,29
Raith,7594,1,23,8,5,71,33,38,77
Ayr,7594,2,24,4,8,93,43,50,76
Arbroath,7594,3,18,8,10,73,48,25,62
Alloa,7594,4,17,8,11,57,46,11,59
Stranraer,7594,5,16,5,15,56,64,-8,53
East Fife,7594,6,13,3,20,47,65,-18,42
Airdrieon,7594,7,10,11,15,46,60,-14,41
Forfar,7594,8,11,5,20,40,65,-25,38
Albion,7594,9,8,6,22,58,81,-23,30
Queen's Park,7594,10,6,10,20,39,75,-36,28
Raith,7595,1,23,8,5,70,33,37,77
Ayr,7595,2,23,4,9,92,45,47,73
Arbroath,7595,3,17,8,11,72,52,20,59
Alloa,7595,4,17,8,11,57,45,12,59
Stranraer,7595,5,16,5,15,56,64,-8,53
East Fife,7595,6,13,3,20,47,65,-18,42
Airdrieon,7595,7,10,11,15,46,60,-14,41
Forfar,7595,8,11,5,20,40,65,-25,38
Albion,7595,9,9,6,21,60,80,-20,33
Queen's Park,7595,10,7,10,19,43,74,-31,31
Ayr,7596,1,24,4,8,94,44,50,76
Raith,7596,2,22,9,5,70,34,36,75
Arbroath,7596,3,18,8,10,75,49,26,62
Alloa,7596,4,17,9,10,58,45,13,60
Stranraer,7596,5,15,5,16,55,65,-10,50
East Fife,7596,6,14,3,19,48,64,-16,45
Airdrieon,7596,7,11,11,14,46,58,-12,44
Forfar,7596,8,10,5,21,38,65,-27,35
Albion,7596,9,8,6,22,59,82,-23,30
Queen's Park,7596,10,6,10,20,40,77,-37,28
Raith,7597,1,23,8,5,70,32,38,77
Ayr,7597,2,23,4,9,93,46,47,73
Arbroath,7597,3,18,8,10,73,49,24,62
Alloa,7597,4,17,8,11,56,45,11,59
Stranraer,7597,5,16,5,15,58,64,-6,53
Airdrieon,7597,6,11,11,14,46,58,-12,44
East Fife,7597,7,13,3,20,47,67,-20,42
Forfar,7597,8,10,5,21,38,65,-27,35
Albion,7597,9,9,6,21,61,81,-20,33
Queen's Park,7597,10,6,10,20,40,75,-35,28
Ayr,7598,1,24,4,8,93,43,50,76
Raith,7598,2,22,9,5,70,34,36,75
Arbroath,7598,3,17,9,10,71,49,22,60
Alloa,7598,4,17,9,10,58,45,13,60
Stranraer,7598,5,16,5,15,57,64,-7,53
Airdrieon,7598,6,11,11,14,49,58,-9,44
East Fife,7598,7,13,3,20,47,66,-19,42
Forfar,7598,8,10,5,21,38,68,-30,35
Albion,7598,9,8,6,22,58,81,-23,30
Queen's Park,7598,10,6,11,19,40,73,-33,29
Raith,7599,1,23,8,5,71,32,39,77
Ayr,7599,2,24,4,8,91,42,49,76
Arbroath,7599,3,18,8,10,72,48,24,62
Alloa,7599,4,17,8,11,56,46,10,59
Stranraer,7599,5,15,5,16,56,66,-10,50
East Fife,7599,6,14,3,19,49,65,-16,45
Airdrieon,7599,7,11,11,14,48,59,-11,44
Forfar,7599,8,10,5,21,39,67,-28,35
Albion,7599,9,8,6,22,57,79,-22,30
Queen's Park,7599,10,6,10,20,39,74,-35,28
Ayr,7600,1,24,4,8,92,42,50,76
Raith,7600,2,22,8,6,68,34,34,74
Alloa,7600,3,18,8,10,58,43,15,62
Arbroath,7600,4,17,8,11,71,52,19,59
Stranraer,7600,5,15,5,16,56,66,-10,50
East Fife,7600,6,14,3,19,49,65,-16,45
Airdrieon,7600,7,11,11,14,47,58,-11,44
Forfar,7600,8,10,5,21,38,66,-28,35
Queen's Park,7600,9,7,10,19,43,73,-30,31
Albion,7600,10,8,6,22,57,80,-23,30
Raith,7601,1,23,8,5,72,32,40,77
Ayr,7601,2,24,4,8,94,43,51,76
Arbroath,7601,3,17,8,11,71,51,20,59
Alloa,7601,4,17,8,11,56,47,9,59
Stranraer,7601,5,15,6,15,56,65,-9,51
East Fife,7601,6,13,4,19,48,65,-17,43
Airdrieon,7601,7,10,11,15,45,59,-14,41
Forfar,7601,8,11,5,20,39,64,-25,38
Queen's Park,7601,9,7,10,19,42,73,-31,31
Albion,7601,10,8,6,22,58,82,-24,30
Raith,7602,1,23,8,5,72,32,40,77
Ayr,7602,2,23,4,9,93,46,47,73
Arbroath,7602,3,18,8,10,71,48,23,62
Alloa,7602,4,17,8,11,56,47,9,59
Stranraer,7602,5,15,6,15,57,66,-9,51
East Fife,7602,6,13,4,19,49,66,-17,43
Airdrieon,7602,7,10,11,15,45,59,-14,41
Forfar,7602,8,11,5,20,39,64,-25,38
Albion,7602,9,9,6,21,61,81,-20,33
Queen's Park,7602,10,6,10,20,39,73,-34,28
Ayr,7603,1,24,4,8,97,42,55,76
Raith,7603,2,22,9,5,69,33,36,75
Alloa,7603,3,17,9,10,57,44,13,60
Arbroath,7603,4,17,8,11,70,49,21,59
Stranraer,7603,5,15,5,16,57,68,-11,50
East Fife,7603,6,14,3,19,51,66,-15,45
Airdrieon,7603,7,10,11,15,47,61,-14,41
Forfar,7603,8,11,5,20,41,66,-25,38
Queen's Park,7603,9,7,10,19,40,72,-32,31
Albion,7603,10,8,6,22,57,85,-28,30
Raith,7604,1,22,9,5,70,34,36,75
Ayr,7604,2,23,5,8,93,45,48,74
Arbroath,7604,3,18,8,10,74,48,26,62
Alloa,7604,4,17,9,10,58,45,13,60
Stranraer,7604,5,15,5,16,56,66,-10,50
East Fife,7604,6,14,3,19,49,65,-16,45
Airdrieon,7604,7,11,11,14,47,58,-11,44
Forfar,7604,8,10,5,21,38,66,-28,35
Albion,7604,9,8,7,21,60,81,-21,31
Queen's Park,7604,10,6,10,20,39,76,-37,28
Raith,7605,1,23,8,5,71,32,39,77
Ayr,7605,2,24,4,8,93,43,50,76
Arbroath,7605,3,17,8,11,70,50,20,59
Alloa,7605,4,17,8,11,56,46,10,59
Stranraer,7605,5,15,5,16,55,65,-10,50
East Fife,7605,6,14,3,19,48,64,-16,45
Airdrieon,7605,7,11,11,14,48,58,-10,44
Forfar,7605,8,10,5,21,38,67,-29,35
Queen's Park,7605,9,7,10,19,41,72,-31,31
Albion,7605,10,8,6,22,58,81,-23,30
Raith,7606,1,23,8,5,72,32,40,77
Ayr,7606,2,24,4,8,91,42,49,76
Arbroath,7606,3,18,8,10,73,48,25,62
Alloa,7606,4,17,8,11,56,47,9,59
Stranraer,7606,5,16,5,15,57,65,-8,53
Airdrieon,7606,6,10,12,14,46,59,-13,42
East Fife,7606,7,13,3,20,48,66,-18,42
Forfar,7606,8,10,6,20,39,65,-26,36
Albion,7606,9,8,6,22,57,79,-22,30
Queen's Park,7606,10,6,10,20,39,75,-36,28
Ayr,7607,1,24,4,8,97,45,52,76
Raith,7607,2,22,9,5,70,34,36,75
Arbroath,7607,3,17,9,10,74,52,22,60
Alloa,7607,4,17,9,10,58,45,13,60
Stranraer,7607,5,16,5,15,58,65,-7,53
Airdrieon,7607,6,10,12,14,46,59,-13,42
East Fife,7607,7,13,3,20,48,67,-19,42
Forfar,7607,8,10,6,20,39,65,-26,36
Albion,7607,9,8,6,22,60,85,-25,30
Queen's Park,7607,10,6,11,19,43,76,-33,29
Raith,7608,1,22,8,6,68,33,35,74
Ayr,7608,2,23,4,9,90,43,47,73
Alloa,7608,3,18,8,10,57,43,14,62
Arbroath,7608,4,17,9,10,70,48,22,60
Stranraer,7608,5,15,6,15,56,65,-9,51
Airdrieon,7608,6,11,11,14,48,59,-11,44
East Fife,7608,7,13,4,19,48,65,-17,43
Forfar,7608,8,10,5,21,39,67,-28,35
Albion,7608,9,9,6,21,58,78,-20,33
Queen's Park,7608,10,6,11,19,39,72,-33,29
Raith,7609,1,23,8,5,71,33,38,77
Ayr,7609,2,24,4,8,92,43,49,76
Arbroath,7609,3,17,8,11,70,52,18,59
Alloa,7609,4,17,8,11,57,46,11,59
Stranraer,7609,5,15,6,15,55,64,-9,51
Airdrieon,7609,6,11,11,14,47,59,-12,44
East Fife,7609,7,13,4,19,47,64,-17,43
Forfar,7609,8,10,5,21,39,66,-27,35
Queen's Park,7609,9,7,10,19,43,72,-29,31
Albion,7609,10,8,6,22,58,80,-22,30
Raith,7610,1,23,8,5,71,34,37,77
Ayr,7610,2,24,4,8,94,43,51,76
Arbroath,7610,3,17,9,10,70,48,22,60
Alloa,7610,4,17,8,11,58,46,12,59
Stranraer,7610,5,15,6,15,56,65,-9,51
East Fife,7610,6,13,4,19,48,65,-17,43
Airdrieon,7610,7,10,12,14,46,59,-13,42
Forfar,7610,8,10,6,20,39,65,-26,36
Albion,7610,9,8,6,22,58,82,-24,30
Queen's Park,7610,10,6,11,19,39,72,-33,29
Raith,7611,1,22,9,5,68,32,36,75
Ayr,7611,2,23,4,9,90,43,47,73
Arbroath,7611,3,18,8,10,74,49,25,62
Alloa,7611,4,17,9,10,56,43,13,60
Stranraer,7611,5,15,5,16,57,67,-10,50
East Fife,7611,6,14,3,19,50,66,-16,45
Airdrieon,7611,7,10,12,14,46,59,-13,42
Forfar,7611,8,10,6,20,39,65,-26,36
Albion,7611,9,9,6,21,58,78,-20,33
Queen's Park,7611,10,6,10,20,40,76,-36,28
Raith,7612,1,22,8,6,69,34,35,74
Ayr,7612,2,23,4,9,94,47,47,73
Alloa,7612,3,18,8,10,58,44,14,62
Arbroath,7612,4,17,9,10,72,50,22,60
Stranraer,7612,5,15,5,16,56,67,-11,50
East Fife,7612,6,14,3,19,50,65,-15,45
Airdrieon,7612,7,11,11,14,47,59,-12,44
Forfar,7612,8,10,5,21,39,66,-27,35
Albion,7612,9,9,6,21,62,82,-20,33
Queen's Park,7612,10,6,11,19,41,74,-33,29
Raith,7613,1,23,8,5,70,33,37,77
Ayr,7613,2,24,4,8,94,43,51,76
Arbroath,7613,3,18,8,10,72,48,24,62
Alloa,7613,4,17,8,11,57,45,12,59
Stranraer,7613,5,15,5,16,55,65,-10,50
East Fife,7613,6,14,3,19,48,64,-16,45
Airdrieon,7613,7,10,12,14,46,59,-13,42
Forfar,7613,8,10,6,20,39,65,-26,36
Albion,7613,9,8,6,22,58,82,-24,30
Queen's Park,7613,10,6,10,20,39,74,-35,28
Ayr,7614,1,24,4,8,94,43,51,76
Raith,7614,2,22,8,6,68,33,35,74
Arbroath,7614,3,18,8,10,72,49,23,62
Alloa,7614,4,18,8,10,57,43,14,62
Stranraer,7614,5,15,6,15,55,64,-9,51
East Fife,7614,6,13,4,19,47,64,-17,43
Airdrieon,7614,7,10,12,14,46,59,-13,42
Forfar,7614,8,10,6,20,39,65,-26,36
Albion,7614,9,8,6,22,58,82,-24,30
Queen's Park,7614,10,6,10,20,40,74,-34,28
Raith,7615,1,23,8,5,69,32,37,77
Ayr,7615,2,24,4,8,94,44,50,76
Arbroath,7615,3,18,8,10,72,48,24,62
Alloa,7615,4,17,8,11,56,44,12,59
Stranraer,7615,5,16,5,15,58,64,-6,53
East Fife,7615,6,13,3,20,47,67,-20,42
Airdrieon,7615,7,10,11,15,46,60,-14,41
Forfar,7615,8,11,5,20,40,65,-25,38
Albion,7615,9,8,6,22,59,82,-23,30
Queen's Park,7615,10,6,10,20,39,74,-35,28
Ayr,7616,1,23,5,8,92,44,48,74
Raith,7616,2,22,8,6,68,33,35,74
Alloa,7616,3,18,8,10,57,43,14,62
Arbroath,7616,4,17,8,11,70,49,21,59
Stranraer,7616,5,15,6,15,55,64,-9,51
East Fife,7616,6,13,4,19,47,64,-17,43
Airdrieon,7616,7,10,11,15,45,59,-14,41
Forfar,7616,8,11,5,20,39,64,-25,38
Albion,7616,9,8,7,21,59,80,-21,31
Queen's Park,7616,10,7,10,19,40,72,-32,31
Raith,7617,1,23,8,5,71,32,39,77
Ayr,7617,2,24,4,8,92,42,50,76
Arbroath,7617,3,18,8,10,73,50,23,62
Alloa,7617,4,17,8,11,56,46,10,59
Stranraer,7617,5,16,5,15,56,64,-8,53
East Fife,7617,6,13,3,20,47,65,-18,42
Airdrieon,7617,7,10,11,15,46,60,-14,41
Forfar,7617,8,11,5,20,40,65,-25,38
Albion,7617,9,8,6,22,57,80,-23,30
Queen's Park,7617,10,6,10,20,41,75,-34,28
Raith,7618,1,23,8,5,71,32,39,77
Ayr,7618,2,24,4,8,96,43,53,76
Arbroath,7618,3,18,8,10,74,49,25,62
Alloa,7618,4,17,8,11,56,46,10,59
Stranraer,7618,5,16,5,15,58,65,-7,53
Airdrieon,7618,6,11,11,14,49,58,-9,44
East Fife,7618,7,13,3,20,48,67,-19,42
Forfar,7618,8,10,5,21,38,68,-30,35
Albion,7618,9,8,6,22,58,84,-26,30
Queen's Park,7618,10,6,10,20,40,76,-36,28
Raith,7619,1,23,8,5,70,32,38,77
Ayr,7619,2,24,4,8,94,42,52,76
Arbroath,7619,3,17,8,11,73,52,21,59
Alloa,7619,4,17,8,11,56,45,11,59
Stranraer,7619,5,16,5,15,57,65,-8,53
Airdrieon,7619,6,11,11,14,49,58,-9,44
East Fife,7619,7,13,3,20,48,66,-18,42
Forfar,7619,8,10,5,21,38,68,-30,35
Queen's Park,7619,9,7,10,19,43,75,-32,31
Albion,7619,10,8,6,22,57,82,-25,30
Raith,7620,1,23,8,5,71,33,38,77
Ayr,7620,2,24,4,8,91,42,49,76
Arbroath,7620,3,17,8,11,71,51,20,59
Alloa,7620,4,17,8,11,57,46,11,59
Stranraer,7620,5,15,5,16,56,66,-10,50
East Fife,7620,6,14,3,19,49,65,-16,45
Airdrieon,7620,7,11,11,14,47,59,-12,44
Forfar,7620,8,10,5,21,39,66,-27,35
Queen's Park,7620,9,7,10,19,42,73,-31,31
Albion,7620,10,8,6,22,57,79,-22,30
Raith,7621,1,23,8,5,70,33,37,77
Ayr,7621,2,24,4,8,95,43,52,76
Arbroath,7621,3,17,8,11,70,49,21,59
Alloa,7621,4,17,8,11,57,45,12,59
Stranraer,7621,5,15,6,15,57,66,-9,51
East Fife,7621,6,13,4,19,49,66,-17,43
Airdrieon,7621,7,10,11,15,45,59,-14,41
Forfar,7621,8,11,5,20,39,64,-25,38
Queen's Park,7621,9,7,10,19,40,72,-32,31
Albion,7621,10,8,6,22,58,83,-25,30
Raith,7622,1,22,8,6,69,35,34,74
Ayr,7622,2,23,4,9,91,44,47,73
Alloa,7622,3,18,8,10,59,44,15,62
Arbroath,7622,4,17,9,10,71,49,22,60
Stranraer,7622,5,16,5,15,56,64,-8,53
East Fife,7622,6,13,3,20,47,65,-18,42
Airdrieon,7622,7,10,11,15,47,61,-14,41
Forfar,7622,8,11,5,20,41,66,-25,38
Albion,7622,9,9,6,21,59,79,-20,33
Queen's Park,7622,10,6,11,19,40,73,-33,29
Raith,7623,1,23,8,5,70,33,37,77
Ayr,7623,2,24,4,8,93,44,49,76
Arbroath,7623,3,18,8,10,73,48,25,62
Alloa,7623,4,17,8,11,57,45,12,59
Stranraer,7623,5,16,5,15,57,65,-8,53
Airdrieon,7623,6,11,11,14,47,58,-11,44
East Fife,7623,7,13,3,20,48,66,-18,42
Forfar,7623,8,10,5,21,38,66,-28,35
Albion,7623,9,8,6,22,59,81,-22,30
Queen's Park,7623,10,6,10,20,39,75,-36,28
Raith,7624,1,23,8,5,70,33,37,77
Ayr,7624,2,24,4,8,93,44,49,76
Arbroath,7624,3,18,8,10,72,48,24,62
Alloa,7624,4,17,8,11,57,45,12,59
Stranraer,7624,5,16,5,15,56,64,-8,53
Airdrieon,7624,6,10,12,14,45,58,-13,42
East Fife,7624,7,13,3,20,47,65,-18,42
Forfar,7624,8,10,6,20,38,64,-26,36
Albion,7624,9,8,6,22,59,81,-22,30
Queen's Park,7624,10,6,10,20,39,74,-35,28
Ayr,7625,1,24,4,8,95,43,52,76
Raith,7625,2,22,9,5,68,32,36,75
Alloa,7625,3,17,9,10,56,43,13,60
Arbroath,7625,4,17,8,11,71,51,20,59
Stranraer,7625,5,16,5,15,60,67,-7,53
East Fife,7625,6,13,3,20,50,69,-19,42
Airdrieon,7625,7,10,11,15,46,63,-17,41
Forfar,7625,8,11,5,20,43,65,-22,38
Queen's Park,7625,9,7,10,19,42,73,-31,31
Albion,7625,10,8,6,22,58,83,-25,30
Ayr,7626,1,24,4,8,93,42,51,76
Raith,7626,2,22,8,6,68,33,35,74
Arbroath,7626,3,18,8,10,71,48,23,62
Alloa,7626,4,18,8,10,57,43,14,62
Stranraer,7626,5,15,5,16,57,67,-10,50
East Fife,7626,6,14,3,19,50,66,-16,45
Airdrieon,7626,7,10,12,14,47,60,-13,42
Forfar,7626,8,10,6,20,40,66,-26,36
Albion,7626,9,8,6,22,57,81,-24,30
Queen's Park,7626,10,6,10,20,39,73,-34,28
Ayr,7627,1,24,4,8,95,44,51,76
Raith,7627,2,22,8,6,68,33,35,74
Arbroath,7627,3,18,8,10,73,49,24,62
Alloa,7627,4,18,8,10,57,43,14,62
Stranraer,7627,5,15,5,16,56,67,-11,50
East Fife,7627,6,14,3,19,50,65,-15,45
Airdrieon,7627,7,10,11,15,46,61,-15,41
Forfar,7627,8,11,5,20,41,65,-24,38
Albion,7627,9,8,6,22,59,83,-24,30
Queen's Park,7627,10,6,10,20,40,75,-35,28
Ayr,7628,1,24,4,8,97,44,53,76
Raith,7628,2,22,9,5,71,35,36,75
Arbroath,7628,3,18,8,10,75,51,24,62
Alloa,7628,4,17,9,10,59,46,13,60
Stranraer,7628,5,15,5,16,57,67,-10,50
East Fife,7628,6,14,3,19,50,66,-16,45
Airdrieon,7628,7,10,12,14,46,59,-13,42
Forfar,7628,8,10,6,20,39,65,-26,36
Albion,7628,9,8,6,22,59,85,-26,30
Queen's Park,7628,10,6,10,20,42,77,-35,28
Raith,7629,1,23,8,5,71,32,39,77
Ayr,7629,2,23,4,9,91,46,45,73
Arbroath,7629,3,18,8,10,76,49,27,62
Alloa,7629,4,17,8,11,56,46,10,59
Stranraer,7629,5,15,5,16,55,65,-10,50
East Fife,7629,6,14,3,19,48,64,-16,45
Airdrieon,7629,7,11,11,14,48,58,-10,44
Forfar,7629,8,10,5,21,38,67,-29,35
Albion,7629,9,9,6,21,61,79,-18,33
Queen's Park,7629,10,6,10,20,40,78,-38,28
Ayr,7630,1,24,4,8,96,42,54,76
Raith,7630,2,22,8,6,68,33,35,74
Arbroath,7630,3,18,8,10,72,48,24,62
Alloa,7630,4,18,8,10,57,43,14,62
Stranraer,7630,5,15,5,16,55,65,-10,50
East Fife,7630,6,14,3,19,48,64,-16,45
Airdrieon,7630,7,10,11,15,45,59,-14,41
Forfar,7630,8,11,5,20,39,64,-25,38
Albion,7630,9,8,6,22,57,84,-27,30
Queen's Park,7630,10,6,10,20,39,74,-35,28
Raith,7631,1,23,8,5,70,32,38,77
Ayr,7631,2,24,4,8,97,44,53,76
Arbroath,7631,3,17,8,11,72,51,21,59
Alloa,7631,4,17,8,11,56,45,11,59
Stranraer,7631,5,16,5,15,58,65,-7,53
Airdrieon,7631,6,11,11,14,48,60,-12,44
East Fife,7631,7,13,3,20,48,67,-19,42
Forfar,7631,8,10,5,21,40,67,-27,35
Queen's Park,7631,9,7,10,19,42,74,-32,31
Albion,7631,10,8,6,22,59,85,-26,30
Ayr,7632,1,24,4,8,94,42,52,76
Raith,7632,2,22,9,5,69,33,36,75
Arbroath,7632,3,18,8,10,74,50,24,62
Alloa,7632,4,17,9,10,57,44,13,60
Stranraer,7632,5,16,5,15,59,67,-8,53
Airdrieon,7632,6,11,11,14,48,59,-11,44
East Fife,7632,7,13,3,20,50,68,-18,42
Forfar,7632,8,10,5,21,39,67,-28,35
Albion,7632,9,8,6,22,57,82,-25,30
Queen's Park,7632,10,6,10,20,41,76,-35,28
Raith,7633,1,23,8,5,70,33,37,77
Ayr,7633,2,24,4,8,96,43,53,76
Arbroath,7633,3,17,8,11,72,51,21,59
Alloa,7633,4,17,8,11,57,45,12,59
Stranraer,7633,5,15,5,16,56,68,-12,50
East Fife,7633,6,14,3,19,51,65,-14,45
Airdrieon,7633,7,11,11,14,47,59,-12,44
Forfar,7633,8,10,5,21,39,66,-27,35
Queen's Park,7633,9,7,10,19,42,74,-32,31
Albion,7633,10,8,6,22,58,84,-26,30
Raith,7634,1,23,8,5,71,32,39,77
Ayr,7634,2,24,4,8,95,44,51,76
Arbroath,7634,3,18,8,10,72,49,23,62
Alloa,7634,4,17,8,11,56,46,10,59
Stranraer,7634,5,16,5,15,58,64,-6,53
East Fife,7634,6,13,3,20,47,67,-20,42
Airdrieon,7634,7,10,11,15,46,60,-14,41
Forfar,7634,8,11,5,20,40,65,-25,38
Albion,7634,9,8,6,22,59,83,-24,30
Queen's Park,7634,10,6,10,20,40,74,-34,28
Raith,7635,1,23,8,5,70,32,38,77
Ayr,7635,2,24,4,8,94,42,52,76
Arbroath,7635,3,18,8,10,73,48,25,62
Alloa,7635,4,17,8,11,56,45,11,59
Stranraer,7635,5,16,5,15,57,64,-7,53
East Fife,7635,6,13,3,20,47,66,-19,42
Airdrieon,7635,7,10,11,15,45,60,-15,41
Forfar,7635,8,11,5,20,40,64,-24,38
Albion,7635,9,8,6,22,57,82,-25,30
Queen's Park,7635,10,6,10,20,39,75,-36,28
Raith,7636,1,23,8,5,72,32,40,77
Ayr,7636,2,24,4,8,93,43,50,76
Arbroath,7636,3,17,8,11,70,49,21,59
Alloa,7636,4,17,8,11,56,47,9,59
Stranraer,7636,5,15,5,16,56,66,-10,50
East Fife,7636,6,14,3,19,49,65,-16,45
Airdrieon,7636,7,10,11,15,46,61,-15,41
Forfar,7636,8,11,5,20,41,65,-24,38
Queen's Park,7636,9,7,10,19,40,72,-32,31
Albion,7636,10,8,6,22,58,81,-23,30
Raith,7637,1,23,8,5,70,33,37,77
Ayr,7637,2,24,4,8,93,43,50,76
Arbroath,7637,3,17,9,10,72,50,22,60
Alloa,7637,4,17,8,11,57,45,12,59
Stranraer,7637,5,16,5,15,56,64,-8,53
Airdrieon,7637,6,11,11,14,48,58,-10,44
East Fife,7637,7,13,3,20,47,65,-18,42
Forfar,7637,8,10,5,21,38,67,-29,35
Albion,7637,9,8,6,22,58,81,-23,30
Queen's Park,7637,10,6,11,19,41,74,-33,29
Ayr,7638,1,23,5,8,93,45,48,74
Raith,7638,2,22,8,6,69,34,35,74
Arbroath,7638,3,18,8,10,73,50,23,62
Alloa,7638,4,18,8,10,58,44,14,62
Stranraer,7638,5,15,5,16,55,67,-12,50
East Fife,7638,6,14,3,19,50,64,-14,45
Airdrieon,7638,7,10,11,15,47,61,-14,41
Forfar,7638,8,11,5,20,41,66,-25,38
Albion,7638,9,8,7,21,60,81,-21,31
Queen's Park,7638,10,6,10,20,41,75,-34,28
Ayr,7639,1,24,4,8,96,42,54,76
Raith,7639,2,22,8,6,68,33,35,74
Arbroath,7639,3,18,8,10,72,48,24,62
Alloa,7639,4,18,8,10,57,43,14,62
Stranraer,7639,5,16,5,15,59,65,-6,53
Airdrieon,7639,6,11,11,14,47,58,-11,44
East Fife,7639,7,13,3,20,48,68,-20,42
Forfar,7639,8,10,5,21,38,66,-28,35
Albion,7639,9,8,6,22,57,84,-27,30
Queen's Park,7639,10,6,10,20,39,74,-35,28
Ayr,7640,1,24,4,8,93,44,49,76
Raith,7640,2,22,8,6,68,34,34,74
Arbroath,7640,3,18,8,10,71,48,23,62
Alloa,7640,4,18,8,10,58,43,15,62
Stranraer,7640,5,15,6,15,56,65,-9,51
Airdrieon,7640,6,11,11,14,50,58,-8,44
East Fife,7640,7,13,4,19,48,65,-17,43
Forfar,7640,8,10,5,21,38,69,-31,35
Albion,7640,9,8,6,22,59,81,-22,30
Queen's Park,7640,10,6,10,20,39,73,-34,28
Ayr,7641,1,24,4,8,93,43,50,76
Raith,7641,2,22,9,5,68,32,36,75
Arbroath,7641,3,18,8,10,73,49,24,62
Alloa,7641,4,17,9,10,56,43,13,60
Stranraer,7641,5,15,5,16,55,67,-12,50
East Fife,7641,6,14,3,19,50,64,-14,45
Airdrieon,7641,7,10,11,15,45,59,-14,41
Forfar,7641,8,11,5,20,39,64,-25,38
Albion,7641,9,8,6,22,58,81,-23,30
Queen's Park,7641,10,6,10,20,40,75,-35,28
Ayr,7642,1,23,5,8,92,44,48,74
Raith,7642,2,22,8,6,69,34,35,74
Arbroath,7642,3,18,8,10,72,49,23,62
Alloa,7642,4,18,8,10,58,44,14,62
Stranraer,7642,5,15,6,15,56,65,-9,51
East Fife,7642,6,13,4,19,48,65,-17,43
Airdrieon,7642,7,10,12,14,46,59,-13,42
Forfar,7642,8,10,6,20,39,65,-26,36
Albion,7642,9,8,7,21,59,80,-21,31
Queen's Park,7642,10,6,10,20,40,74,-34,28
Raith,7643,1,22,9,5,69,33,36,75
Ayr,7643,2,23,5,8,92,44,48,74
Alloa,7643,3,17,9,10,57,44,13,60
Arbroath,7643,4,17,8,11,70,49,21,59
Stranraer,7643,5,15,6,15,56,65,-9,51
Airdrieon,7643,6,11,11,14,49,60,-11,44
East Fife,7643,7,13,4,19,48,65,-17,43
Forfar,7643,8,10,5,21,40,68,-28,35
Albion,7643,9,8,7,21,59,80,-21,31
Queen's Park,7643,10,7,10,19,40,72,-32,31
Raith,7644,1,23,8,5,70,32,38,77
Ayr,7644,2,24,4,8,93,44,49,76
Arbroath,7644,3,17,8,11,70,49,21,59
Alloa,7644,4,17,8,11,56,45,11,59
Stranraer,7644,5,15,6,15,56,65,-9,51
Airdrieon,7644,6,11,11,14,48,60,-12,44
East Fife,7644,7,13,4,19,48,65,-17,43
Forfar,7644,8,10,5,21,40,67,-27,35
Queen's Park,7644,9,7,10,19,40,72,-32,31
Albion,7644,10,8,6,22,59,81,-22,30
Ayr,7645,1,24,4,8,94,43,51,76
Raith,7645,2,22,9,5,69,33,36,75
Arbroath,7645,3,17,9,10,71,49,22,60
Alloa,7645,4,17,9,10,57,44,13,60
Stranraer,7645,5,15,5,16,55,65,-10,50
East Fife,7645,6,14,3,19,48,64,-16,45
Airdrieon,7645,7,10,12,14,45,58,-13,42
Forfar,7645,8,10,6,20,38,64,-26,36
Albion,7645,9,8,6,22,58,82,-24,30
Queen's Park,7645,10,6,11,19,40,73,-33,29
Ayr,7646,1,24,4,8,95,44,51,76
Raith,7646,2,22,8,6,68,33,35,74
Alloa,7646,3,18,8,10,57,43,14,62
Arbroath,7646,4,17,9,10,71,49,22,60
Stranraer,7646,5,16,5,15,58,66,-8,53
Airdrieon,7646,6,11,11,14,46,58,-12,44
East Fife,7646,7,13,3,20,49,67,-18,42
Forfar,7646,8,10,5,21,38,65,-27,35
Albion,7646,9,8,6,22,59,83,-24,30
Queen's Park,7646,10,6,11,19,40,73,-33,29
Raith,7647,1,23,8,5,70,33,37,77
Ayr,7647,2,23,5,8,91,43,48,74
Arbroath,7647,3,18,8,10,75,50,25,62
Alloa,7647,4,17,8,11,57,45,12,59
Stranraer,7647,5,16,5,15,58,66,-8,53
Airdrieon,7647,6,11,11,14,51,60,-9,44
East Fife,7647,7,13,3,20,49,67,-18,42
Forfar,7647,8,10,5,21,40,70,-30,35
Albion,7647,9,8,7,21,58,79,-21,31
Queen's Park,7647,10,6,10,20,41,77,-36,28
Raith,7648,1,23,8,5,69,32,37,77
Ayr,7648,2,24,4,8,96,46,50,76
Arbroath,7648,3,18,8,10,73,48,25,62
Alloa,7648,4,17,8,11,56,44,12,59
Stranraer,7648,5,15,5,16,56,67,-11,50
East Fife,7648,6,14,3,19,50,65,-15,45
Airdrieon,7648,7,11,11,14,48,58,-10,44
Forfar,7648,8,10,5,21,38,67,-29,35
Albion,7648,9,8,6,22,61,84,-23,30
Queen's Park,7648,10,6,10,20,39,75,-36,28
Raith,7649,1,23,8,5,69,32,37,77
Ayr,7649,2,24,4,8,93,44,49,76
Arbroath,7649,3,17,8,11,72,51,21,59
Alloa,7649,4,17,8,11,56,44,12,59
Stranraer,7649,5,16,5,15,57,64,-7,53
Airdrieon,7649,6,11,11,14,48,59,-11,44
East Fife,7649,7,13,3,20,47,66,-19,42
Forfar,7649,8,10,5,21,39,67,-28,35
Queen's Park,7649,9,7,10,19,42,74,-32,31
Albion,7649,10,8,6,22,59,81,-22,30
Raith,7650,1,23,8,5,70,32,38,77
Ayr,7650,2,24,4,8,95,43,52,76
Arbroath,7650,3,18,8,10,72,48,24,62
Alloa,7650,4,17,8,11,56,45,11,59
Stranraer,7650,5,15,6,15,57,66,-9,51
Airdrieon,7650,6,11,11,14,46,58,-12,44
East Fife,7650,7,13,4,19,49,66,-17,43
Forfar,7650,8,10,5,21,38,65,-27,35
Albion,7650,9,8,6,22,58,83,-25,30
Queen's Park,7650,10,6,10,20,39,74,-35,28
Ayr,7651,1,24,4,8,94,44,50,76
Raith,7651,2,22,8,6,69,34,35,74
Alloa,7651,3,18,8,10,58,44,14,62
Arbroath,7651,4,17,9,10,71,49,22,60
Stranraer,7651,5,16,5,15,57,65,-8,53
East Fife,7651,6,13,3,20,48,66,-18,42
Airdrieon,7651,7,10,11,15,46,61,-15,41
Forfar,7651,8,11,5,20,41,65,-24,38
Albion,7651,9,8,6,22,59,82,-23,30
Queen's Park,7651,10,6,11,19,40,73,-33,29
Ayr,7652,1,24,4,8,93,44,49,76
Raith,7652,2,22,8,6,68,34,34,74
Alloa,7652,3,18,8,10,58,43,15,62
Arbroath,7652,4,17,9,10,70,48,22,60
Stranraer,7652,5,15,6,15,56,65,-9,51
East Fife,7652,6,13,4,19,48,65,-17,43
Airdrieon,7652,7,10,12,14,45,58,-13,42
Forfar,7652,8,10,6,20,38,64,-26,36
Albion,7652,9,8,6,22,59,81,-22,30
Queen's Park,7652,10,6,11,19,39,72,-33,29
Raith,7653,1,23,8,5,72,34,38,77
Ayr,7653,2,24,4,8,97,45,52,76
Arbroath,7653,3,17,8,11,71,50,21,59
Alloa,7653,4,17,8,11,58,47,11,59
Stranraer,7653,5,15,6,15,56,65,-9,51
Airdrieon,7653,6,11,11,14,47,58,-11,44
East Fife,7653,7,13,4,19,48,65,-17,43
Forfar,7653,8,10,5,21,38,66,-28,35
Queen's Park,7653,9,7,10,19,41,73,-32,31
Albion,7653,10,8,6,22,60,85,-25,30
Raith,7654,1,23,8,5,71,33,38,77
Ayr,7654,2,24,4,8,97,42,55,76
Arbroath,7654,3,17,9,10,71,49,22,60
Alloa,7654,4,17,8,11,57,46,11,59
Stranraer,7654,5,16,5,15,57,64,-7,53
East Fife,7654,6,13,3,20,47,66,-19,42
Airdrieon,7654,7,10,11,15,46,61,-15,41
Forfar,7654,8,11,5,20,41,65,-24,38
Albion,7654,9,8,6,22,57,85,-28,30
Queen's Park,7654,10,6,11,19,40,73,-33,29
Raith,7655,1,23,8,5,70,32,38,77
Ayr,7655,2,24,4,8,93,42,51,76
Arbroath,7655,3,17,8,11,71,50,21,59
Alloa,7655,4,17,8,11,56,45,11,59
Stranraer,7655,5,15,6,15,55,64,-9,51
East Fife,7655,6,13,4,19,47,64,-17,43
Airdrieon,7655,7,10,12,14,47,60,-13,42
Forfar,7655,8,10,6,20,40,66,-26,36
Queen's Park,7655,9,7,10,19,41,73,-32,31
Albion,7655,10,8,6,22,57,81,-24,30
Raith,7656,1,23,8,5,72,33,39,77
Ayr,7656,2,24,4,8,95,44,51,76
Arbroath,7656,3,17,9,10,72,50,22,60
Alloa,7656,4,17,8,11,57,47,10,59
Stranraer,7656,5,15,5,16,56,67,-11,50
East Fife,7656,6,14,3,19,50,65,-15,45
Airdrieon,7656,7,11,11,14,48,58,-10,44
Forfar,7656,8,10,5,21,38,67,-29,35
Albion,7656,9,8,6,22,59,83,-24,30
Queen's Park,7656,10,6,11,19,41,74,-33,29
Raith,7657,1,23,8,5,70,33,37,77
Ayr,7657,2,24,4,8,94,43,51,76
Arbroath,7657,3,18,8,10,73,48,25,62
Alloa,7657,4,17,8,11,57,45,12,59
Stranraer,7657,5,15,5,16,55,66,-11,50
East Fife,7657,6,14,3,19,49,64,-15,45
Airdrieon,7657,7,10,12,14,46,59,-13,42
Forfar,7657,8,10,6,20,39,65,-26,36
Albion,7657,9,8,6,22,58,82,-24,30
Queen's Park,7657,10,6,10,20,39,75,-36,28
Raith,7658,1,22,9,5,68,32,36,75
Ayr,7658,2,23,4,9,91,44,47,73
Arbroath,7658,3,17,9,10,72,50,22,60
Alloa,7658,4,17,9,10,56,43,13,60
Stranraer,7658,5,15,6,15,56,65,-9,51
Airdrieon,7658,6,11,11,14,49,58,-9,44
East Fife,7658,7,13,4,19,48,65,-17,43
Forfar,7658,8,10,5,21,38,68,-30,35
Albion,7658,9,9,6,21,59,79,-20,33
Queen's Park,7658,10,6,11,19,41,74,-33,29
Raith,7659,1,23,8,5,71,32,39,77
Ayr,7659,2,24,4,8,93,43,50,76
Arbroath,7659,3,17,9,10,70,48,22,60
Alloa,7659,4,17,8,11,56,46,10,59
Stranraer,7659,5,16,5,15,56,64,-8,53
Airdrieon,7659,6,11,11,14,47,58,-11,44
East Fife,7659,7,13,3,20,47,65,-18,42
Forfar,7659,8,10,5,21,38,66,-28,35
Albion,7659,9,8,6,22,58,81,-23,30
Queen's Park,7659,10,6,11,19,39,72,-33,29
Ayr,7660,1,24,4,8,93,44,49,76
Raith,7660,2,22,8,6,69,35,34,74
Alloa,7660,3,18,8,10,59,44,15,62
Arbroath,7660,4,17,8,11,70,49,21,59
Stranraer,7660,5,16,5,15,56,64,-8,53
East Fife,7660,6,13,3,20,47,65,-18,42
Airdrieon,7660,7,10,11,15,45,61,-16,41
Forfar,7660,8,11,5,20,41,64,-23,38
Queen's Park,7660,9,7,10,19,40,72,-32,31
Albion,7660,10,8,6,22,59,81,-22,30
Ayr,7661,1,24,4,8,94,43,51,76
Raith,7661,2,22,8,6,68,35,33,74
Arbroath,7661,3,18,8,10,73,49,24,62
Alloa,7661,4,18,8,10,59,43,16,62
Stranraer,7661,5,15,5,16,56,66,-10,50
East Fife,7661,6,14,3,19,49,65,-16,45
Airdrieon,7661,7,10,12,14,46,59,-13,42
Forfar,7661,8,10,6,20,39,65,-26,36
Albion,7661,9,8,6,22,58,82,-24,30
Queen's Park,7661,10,6,10,20,40,75,-35,28
Raith,7662,1,23,8,5,70,33,37,77
Ayr,7662,2,24,4,8,94,43,51,76
Arbroath,7662,3,17,8,11,70,51,19,59
Alloa,7662,4,17,8,11,57,45,12,59
Stranraer,7662,5,15,5,16,56,66,-10,50
East Fife,7662,6,14,3,19,49,65,-16,45
Airdrieon,7662,7,10,12,14,45,58,-13,42
Forfar,7662,8,10,6,20,38,64,-26,36
Queen's Park,7662,9,7,10,19,42,72,-30,31
Albion,7662,10,8,6,22,58,82,-24,30
Ayr,7663,1,24,4,8,96,42,54,76
Raith,7663,2,22,9,5,69,33,36,75
Arbroath,7663,3,18,8,10,74,49,25,62
Alloa,7663,4,17,9,10,57,44,13,60
Stranraer,7663,5,16,5,15,58,66,-8,53
Airdrieon,7663,6,11,11,14,46,58,-12,44
East Fife,7663,7,13,3,20,49,67,-18,42
Forfar,7663,8,10,5,21,38,65,-27,35
Albion,7663,9,8,6,22,57,84,-27,30
Queen's Park,7663,10,6,10,20,40,76,-36,28
Raith,7664,1,23,8,5,70,33,37,77
Ayr,7664,2,24,4,8,95,43,52,76
Arbroath,7664,3,18,8,10,73,49,24,62
Alloa,7664,4,17,8,11,57,45,12,59
Stranraer,7664,5,15,5,16,55,65,-10,50
East Fife,7664,6,14,3,19,48,64,-16,45
Airdrieon,7664,7,10,12,14,46,59,-13,42
Forfar,7664,8,10,6,20,39,65,-26,36
Albion,7664,9,8,6,22,58,83,-25,30
Queen's Park,7664,10,6,10,20,40,75,-35,28
Ayr,7665,1,24,4,8,98,44,54,76
Raith,7665,2,22,8,6,68,34,34,74
Arbroath,7665,3,18,8,10,72,49,23,62
Alloa,7665,4,18,8,10,58,43,15,62
Stranraer,7665,5,15,5,16,57,67,-10,50
East Fife,7665,6,14,3,19,50,66,-16,45
Airdrieon,7665,7,10,11,15,45,59,-14,41
Forfar,7665,8,11,5,20,39,64,-25,38
Albion,7665,9,8,6,22,59,86,-27,30
Queen's Park,7665,10,6,10,20,40,74,-34,28
Raith,7666,1,23,8,5,73,34,39,77
Ayr,7666,2,24,4,8,95,42,53,76
Arbroath,7666,3,18,8,10,72,49,23,62
Alloa,7666,4,17,8,11,58,48,10,59
Stranraer,7666,5,15,5,16,57,68,-11,50
East Fife,7666,6,14,3,19,51,66,-15,45
Airdrieon,7666,7,10,11,15,45,61,-16,41
Forfar,7666,8,11,5,20,41,64,-23,38
Albion,7666,9,8,6,22,57,83,-26,30
Queen's Park,7666,10,6,10,20,40,74,-34,28
Raith,7667,1,23,8,5,71,33,38,77
Ayr,7667,2,23,5,8,94,46,48,74
Arbroath,7667,3,18,8,10,74,50,24,62
Alloa,7667,4,17,8,11,57,46,11,59
Stranraer,7667,5,15,5,16,56,67,-11,50
East Fife,7667,6,14,3,19,50,65,-15,45
Airdrieon,7667,7,11,11,14,47,59,-12,44
Forfar,7667,8,10,5,21,39,66,-27,35
Albion,7667,9,8,7,21,61,82,-21,31
Queen's Park,7667,10,6,10,20,41,76,-35,28
Ayr,7668,1,24,4,8,96,44,52,76
Raith,7668,2,22,9,5,69,33,36,75
Arbroath,7668,3,18,8,10,76,49,27,62
Alloa,7668,4,17,9,10,57,44,13,60
Stranraer,7668,5,15,5,16,55,66,-11,50
East Fife,7668,6,14,3,19,49,64,-15,45
Airdrieon,7668,7,11,11,14,48,60,-12,44
Forfar,7668,8,10,5,21,40,67,-27,35
Albion,7668,9,8,6,22,59,84,-25,30
Queen's Park,7668,10,6,10,20,40,78,-38,28
Raith,7669,1,22,9,5,69,33,36,75
Ayr,7669,2,23,5,8,91,43,48,74
Arbroath,7669,3,18,8,10,72,49,23,62
Alloa,7669,4,17,9,10,57,44,13,60
Stranraer,7669,5,15,5,16,56,67,-11,50
East Fife,7669,6,14,3,19,50,65,-15,45
Airdrieon,7669,7,10,12,14,46,59,-13,42
Forfar,7669,8,10,6,20,39,65,-26,36
Albion,7669,9,8,7,21,58,79,-21,31
Queen's Park,7669,10,6,10,20,40,74,-34,28
Ayr,7670,1,24,4,8,94,42,52,76
Raith,7670,2,22,8,6,70,35,35,74
Arbroath,7670,3,18,8,10,73,49,24,62
Alloa,7670,4,18,8,10,59,45,14,62
Stranraer,7670,5,16,5,15,57,65,-8,53
East Fife,7670,6,13,3,20,48,66,-18,42
Airdrieon,7670,7,10,11,15,45,61,-16,41
Forfar,7670,8,11,5,20,41,64,-23,38
Albion,7670,9,8,6,22,57,82,-25,30
Queen's Park,7670,10,6,10,20,40,75,-35,28
Ayr,7671,1,24,4,8,93,42,51,76
Raith,7671,2,22,8,6,70,35,35,74
Alloa,7671,3,18,8,10,59,45,14,62
Arbroath,7671,4,17,9,10,71,49,22,60
Stranraer,7671,5,15,6,15,57,66,-9,51
East Fife,7671,6,13,4,19,49,66,-17,43
Airdrieon,7671,7,10,11,15,45,60,-15,41
Forfar,7671,8,11,5,20,40,64,-24,38
Albion,7671,9,8,6,22,57,81,-24,30
Queen's Park,7671,10,6,11,19,40,73,-33,29
Raith,7672,1,23,8,5,71,33,38,77
Ayr,7672,2,24,4,8,94,42,52,76
Arbroath,7672,3,18,8,10,73,48,25,62
Alloa,7672,4,17,8,11,57,46,11,59
Stranraer,7672,5,15,5,16,56,66,-10,50
East Fife,7672,6,14,3,19,49,65,-16,45
Airdrieon,7672,7,10,12,14,45,58,-13,42
Forfar,7672,8,10,6,20,38,64,-26,36
Albion,7672,9,8,6,22,57,82,-25,30
Queen's Park,7672,10,6,10,20,39,75,-36,28
Raith,7673,1,23,8,5,70,32,38,77
Ayr,7673,2,24,4,8,95,43,52,76
Arbroath,7673,3,17,8,11,71,50,21,59
Alloa,7673,4,17,8,11,56,45,11,59
Stranraer,7673,5,15,6,15,57,66,-9,51
East Fife,7673,6,13,4,19,49,66,-17,43
Airdrieon,7673,7,10,12,14,46,59,-13,42
Forfar,7673,8,10,6,20,39,65,-26,36
Queen's Park,7673,9,7,10,19,41,73,-32,31
Albion,7673,10,8,6,22,58,83,-25,30
Raith,7674,1,23,8,5,69,32,37,77
Ayr,7674,2,23,4,9,90,44,46,73
Arbroath,7674,3,17,8,11,72,51,21,59
Alloa,7674,4,17,8,11,56,44,12,59
Stranraer,7674,5,16,5,15,57,65,-8,53
Airdrieon,7674,6,10,12,14,48,61,-13,42
East Fife,7674,7,13,3,20,48,66,-18,42
Forfar,7674,8,10,6,20,41,67,-26,36
Albion,7674,9,9,6,21,59,78,-19,33
Queen's Park,7674,10,7,10,19,42,74,-32,31
Raith,7675,1,23,8,5,70,32,38,77
Ayr,7675,2,24,4,8,94,44,50,76
Arbroath,7675,3,18,8,10,71,48,23,62
Alloa,7675,4,17,8,11,56,45,11,59
Stranraer,7675,5,16,5,15,57,64,-7,53
Airdrieon,7675,6,11,11,14,47,59,-12,44
East Fife,7675,7,13,3,20,47,66,-19,42
Forfar,7675,8,10,5,21,39,66,-27,35
Albion,7675,9,8,6,22,59,82,-23,30
Queen's Park,7675,10,6,10,20,39,73,-34,28
Ayr,7676,1,24,4,8,93,43,50,76
Raith,7676,2,22,9,5,68,32,36,75
Alloa,7676,3,17,9,10,56,43,13,60
Arbroath,7676,4,17,8,11,71,50,21,59
Stranraer,7676,5,15,5,16,56,67,-11,50
East Fife,7676,6,14,3,19,50,65,-15,45
Airdrieon,7676,7,11,11,14,47,58,-11,44
Forfar,7676,8,10,5,21,38,66,-28,35
Queen's Park,7676,9,7,10,19,41,73,-32,31
Albion,7676,10,8,6,22,58,81,-23,30
Raith,7677,1,22,9,5,71,35,36,75
Ayr,7677,2,23,5,8,92,44,48,74
Alloa,7677,3,17,9,10,59,46,13,60
Arbroath,7677,4,17,8,11,71,50,21,59
Stranraer,7677,5,16,5,15,59,65,-6,53
Airdrieon,7677,6,11,11,14,49,58,-9,44
East Fife,7677,7,13,3,20,48,68,-20,42
Forfar,7677,8,10,5,21,38,68,-30,35
Albion,7677,9,8,7,21,59,80,-21,31
Queen's Park,7677,10,7,10,19,41,73,-32,31
Raith,7678,1,23,8,5,70,32,38,77
Ayr,7678,2,24,4,8,95,43,52,76
Arbroath,7678,3,17,9,10,71,49,22,60
Alloa,7678,4,17,8,11,56,45,11,59
Stranraer,7678,5,16,5,15,56,64,-8,53
East Fife,7678,6,13,3,20,47,65,-18,42
Airdrieon,7678,7,10,11,15,45,60,-15,41
Forfar,7678,8,11,5,20,40,64,-24,38
Albion,7678,9,8,6,22,58,83,-25,30
Queen's Park,7678,10,6,11,19,40,73,-33,29
Raith,7679,1,23,8,5,69,32,37,77
Ayr,7679,2,23,5,8,91,43,48,74
Arbroath,7679,3,17,8,11,72,52,20,59
Alloa,7679,4,17,8,11,56,44,12,59
Stranraer,7679,5,16,5,15,56,64,-8,53
Airdrieon,7679,6,11,11,14,49,59,-10,44
East Fife,7679,7,13,3,20,47,65,-18,42
Forfar,7679,8,10,5,21,39,68,-29,35
Albion,7679,9,8,7,21,58,79,-21,31
Queen's Park,7679,10,7,10,19,43,74,-31,31
Ayr,7680,1,24,4,8,94,42,52,76
Raith,7680,2,22,8,6,68,33,35,74
Alloa,7680,3,18,8,10,57,43,14,62
Arbroath,7680,4,17,9,10,71,49,22,60
Stranraer,7680,5,16,5,15,60,65,-5,53
Airdrieon,7680,6,11,11,14,46,58,-12,44
East Fife,7680,7,13,3,20,48,69,-21,42
Forfar,7680,8,10,5,21,38,65,-27,35
Albion,7680,9,8,6,22,57,82,-25,30
Queen's Park,7680,10,6,11,19,40,73,-33,29
Ayr,7681,1,24,4,8,93,43,50,76
Raith,7681,2,22,8,6,69,34,35,74
Alloa,7681,3,18,8,10,58,44,14,62
Arbroath,7681,4,17,9,10,70,48,22,60
Stranraer,7681,5,15,6,15,57,66,-9,51
Airdrieon,7681,6,11,11,14,47,58,-11,44
East Fife,7681,7,13,4,19,49,66,-17,43
Forfar,7681,8,10,5,21,38,66,-28,35
Albion,7681,9,8,6,22,58,81,-23,30
Queen's Park,7681,10,6,11,19,39,72,-33,29
Raith,7682,1,23,8,5,71,32,39,77
Ayr,7682,2,23,4,9,94,47,47,73
Arbroath,7682,3,17,8,11,70,49,21,59
Alloa,7682,4,17,8,11,56,46,10,59
Stranraer,7682,5,15,5,16,58,69,-11,50
East Fife,7682,6,14,3,19,52,67,-15,45
Airdrieon,7682,7,11,11,14,47,58,-11,44
Forfar,7682,8,10,5,21,38,66,-28,35
Albion,7682,9,9,6,21,62,82,-20,33
Queen's Park,7682,10,7,10,19,40,72,-32,31
Raith,7683,1,23,8,5,74,34,40,77
Ayr,7683,2,24,4,8,95,42,53,76
Arbroath,7683,3,18,8,10,71,48,23,62
Alloa,7683,4,17,8,11,58,49,9,59
Stranraer,7683,5,16,5,15,56,64,-8,53
Airdrieon,7683,6,10,12,14,46,59,-13,42
East Fife,7683,7,13,3,20,47,65,-18,42
Forfar,7683,8,10,6,20,39,65,-26,36
Albion,7683,9,8,6,22,57,83,-26,30
Queen's Park,7683,10,6,10,20,39,73,-34,28
Ayr,7684,1,24,4,8,92,42,50,76
Raith,7684,2,22,8,6,69,34,35,74
Alloa,7684,3,18,8,10,58,44,14,62
Arbroath,7684,4,17,9,10,73,51,22,60
Stranraer,7684,5,15,5,16,55,66,-11,50
East Fife,7684,6,14,3,19,49,64,-15,45
Airdrieon,7684,7,10,12,14,46,59,-13,42
Forfar,7684,8,10,6,20,39,65,-26,36
Albion,7684,9,8,6,22,57,80,-23,30
Queen's Park,7684,10,6,11,19,42,75,-33,29
Ayr,7685,1,24,4,8,97,43,54,76
Raith,7685,2,22,9,5,68,32,36,75
Arbroath,7685,3,18,8,10,72,48,24,62
Alloa,7685,4,17,9,10,56,43,13,60
Stranraer,7685,5,15,5,16,57,67,-10,50
East Fife,7685,6,14,3,19,50,66,-16,45
Airdrieon,7685,7,10,12,14,45,58,-13,42
Forfar,7685,8,10,6,20,38,64,-26,36
Albion,7685,9,8,6,22,58,85,-27,30
Queen's Park,7685,10,6,10,20,39,74,-35,28
Raith,7686,1,23,8,5,72,32,40,77
Ayr,7686,2,24,4,8,94,43,51,76
Arbroath,7686,3,17,8,11,71,50,21,59
Alloa,7686,4,17,8,11,56,47,9,59
Stranraer,7686,5,15,6,15,56,65,-9,51
Airdrieon,7686,6,11,11,14,49,60,-11,44
East Fife,7686,7,13,4,19,48,65,-17,43
Forfar,7686,8,10,5,21,40,68,-28,35
Queen's Park,7686,9,7,10,19,41,73,-32,31
Albion,7686,10,8,6,22,58,82,-24,30
Raith,7687,1,23,8,5,72,32,40,77
Ayr,7687,2,24,4,8,92,43,49,76
Arbroath,7687,3,18,8,10,72,48,24,62
Alloa,7687,4,17,8,11,56,47,9,59
Stranraer,7687,5,16,5,15,57,65,-8,53
East Fife,7687,6,13,3,20,48,66,-18,42
Airdrieon,7687,7,10,11,15,45,60,-15,41
Forfar,7687,8,11,5,20,40,64,-24,38
Albion,7687,9,8,6,22,58,80,-22,30
Queen's Park,7687,10,6,10,20,39,74,-35,28
Ayr,7688,1,24,4,8,97,45,52,76
Raith,7688,2,22,8,6,68,34,34,74
Arbroath,7688,3,18,8,10,74,49,25,62
Alloa,7688,4,18,8,10,58,43,15,62
Stranraer,7688,5,16,5,15,57,65,-8,53
Airdrieon,7688,6,11,11,14,47,59,-12,44
East Fife,7688,7,13,3,20,48,66,-18,42
Forfar,7688,8,10,5,21,39,66,-27,35
Albion,7688,9,8,6,22,60,85,-25,30
Queen's Park,7688,10,6,10,20,40,76,-36,28
Ayr,7689,1,24,4,8,96,44,52,76
Raith,7689,2,22,9,5,68,32,36,75
Arbroath,7689,3,18,8,10,75,49,26,62
Alloa,7689,4,17,9,10,56,43,13,60
Stranraer,7689,5,15,5,16,57,69,-12,50
East Fife,7689,6,14,3,19,52,66,-14,45
Airdrieon,7689,7,10,11,15,47,62,-15,41
Forfar,7689,8,11,5,20,42,66,-24,38
Albion,7689,9,8,6,22,59,84,-25,30
Queen's Park,7689,10,6,10,20,40,77,-37,28
Ayr,7690,1,24,4,8,92,43,49,76
Raith,7690,2,22,8,6,68,33,35,74
Arbroath,7690,3,18,8,10,74,50,24,62
Alloa,7690,4,18,8,10,57,43,14,62
Stranraer,7690,5,16,5,15,58,66,-8,53
Airdrieon,7690,6,11,11,14,46,58,-12,44
East Fife,7690,7,13,3,20,49,67,-18,42
Forfar,7690,8,10,5,21,38,65,-27,35
Albion,7690,9,8,6,22,58,80,-22,30
Queen's Park,7690,10,6,10,20,41,76,-35,28
Raith,7691,1,23,8,5,70,33,37,77
Ayr,7691,2,24,4,8,92,43,49,76
Arbroath,7691,3,18,8,10,73,50,23,62
Alloa,7691,4,17,8,11,57,45,12,59
Stranraer,7691,5,16,5,15,56,64,-8,53
Airdrieon,7691,6,10,12,14,47,60,-13,42
East Fife,7691,7,13,3,20,47,65,-18,42
Forfar,7691,8,10,6,20,40,66,-26,36
Albion,7691,9,8,6,22,58,80,-22,30
Queen's Park,7691,10,6,10,20,41,75,-34,28
Ayr,7692,1,24,4,8,97,42,55,76
Raith,7692,2,22,8,6,69,34,35,74
Alloa,7692,3,18,8,10,58,44,14,62
Arbroath,7692,4,17,9,10,72,50,22,60
Stranraer,7692,5,16,5,15,57,65,-8,53
Airdrieon,7692,6,11,11,14,47,58,-11,44
East Fife,7692,7,13,3,20,48,66,-18,42
Forfar,7692,8,10,5,21,38,66,-28,35
Albion,7692,9,8,6,22,57,85,-28,30
Queen's Park,7692,10,6,11,19,41,74,-33,29
Raith,7693,1,23,8,5,71,33,38,77
Ayr,7693,2,24,4,8,93,42,51,76
Arbroath,7693,3,18,8,10,71,48,23,62
Alloa,7693,4,17,8,11,57,46,11,59
Stranraer,7693,5,16,5,15,56,64,-8,53
Airdrieon,7693,6,10,12,14,46,59,-13,42
East Fife,7693,7,13,3,20,47,65,-18,42
Forfar,7693,8,10,6,20,39,65,-26,36
Albion,7693,9,8,6,22,57,81,-24,30
Queen's Park,7693,10,6,10,20,39,73,-34,28
Ayr,7694,1,24,4,8,91,42,49,76
Raith,7694,2,22,9,5,69,33,36,75
Arbroath,7694,3,17,9,10,70,48,22,60
Alloa,7694,4,17,9,10,57,44,13,60
Stranraer,7694,5,15,5,16,55,66,-11,50
East Fife,7694,6,14,3,19,49,64,-15,45
Airdrieon,7694,7,10,12,14,46,59,-13,42
Forfar,7694,8,10,6,20,39,65,-26,36
Albion,7694,9,8,6,22,57,79,-22,30
Queen's Park,7694,10,6,11,19,39,72,-33,29
Raith,7695,1,23,8,5,70,32,38,77
Ayr,7695,2,23,5,8,91,43,48,74
Arbroath,7695,3,17,8,11,71,50,21,59
Alloa,7695,4,17,8,11,56,45,11,59
Stranraer,7695,5,16,5,15,59,66,-7,53
Airdrieon,7695,6,11,11,14,49,60,-11,44
East Fife,7695,7,13,3,20,49,68,-19,42
Forfar,7695,8,10,5,21,40,68,-28,35
Albion,7695,9,8,7,21,58,79,-21,31
Queen's Park,7695,10,7,10,19,41,73,-32,31
Ayr,7696,1,24,4,8,94,43,51,76
Raith,7696,2,22,8,6,68,33,35,74
Alloa,7696,3,18,8,10,57,43,14,62
Arbroath,7696,4,17,8,11,70,49,21,59
Stranraer,7696,5,15,5,16,55,65,-10,50
East Fife,7696,6,14,3,19,48,64,-16,45
Airdrieon,7696,7,11,11,14,48,59,-11,44
Forfar,7696,8,10,5,21,39,67,-28,35
Queen's Park,7696,9,7,10,19,40,72,-32,31
Albion,7696,10,8,6,22,58,82,-24,30
Ayr,7697,1,24,4,8,92,42,50,76
Raith,7697,2,22,8,6,68,34,34,74
Arbroath,7697,3,18,8,10,71,48,23,62
Alloa,7697,4,18,8,10,58,43,15,62
Stranraer,7697,5,15,5,16,57,68,-11,50
East Fife,7697,6,14,3,19,51,66,-15,45
Airdrieon,7697,7,11,11,14,47,58,-11,44
Forfar,7697,8,10,5,21,38,66,-28,35
Albion,7697,9,8,6,22,57,80,-23,30
Queen's Park,7697,10,6,10,20,39,73,-34,28
Ayr,7698,1,24,4,8,96,43,53,76
Raith,7698,2,22,9,5,69,33,36,75
Arbroath,7698,3,18,8,10,74,48,26,62
Alloa,7698,4,17,9,10,57,44,13,60
Stranraer,7698,5,15,6,15,55,64,-9,51
East Fife,7698,6,13,4,19,47,64,-17,43
Airdrieon,7698,7,10,12,14,47,60,-13,42
Forfar,7698,8,10,6,20,40,66,-26,36
Albion,7698,9,8,6,22,58,84,-26,30
Queen's Park,7698,10,6,10,20,39,76,-37,28
Ayr,7699,1,24,4,8,92,43,49,76
Raith,7699,2,22,9,5,68,32,36,75
Alloa,7699,3,17,9,10,56,43,13,60
Arbroath,7699,4,17,8,11,72,52,20,59
Stranraer,7699,5,15,5,16,56,66,-10,50
East Fife,7699,6,14,3,19,49,65,-16,45
Airdrieon,7699,7,10,12,14,47,60,-13,42
Forfar,7699,8,10,6,20,40,66,-26,36
Queen's Park,7699,9,7,10,19,43,74,-31,31
Albion,7699,10,8,6,22,58,80,-22,30
Raith,7700,1,23,8,5,72,32,40,77
Ayr,7700,2,24,4,8,95,44,51,76
Arbroath,7700,3,17,8,11,71,51,20,59
Alloa,7700,4,17,8,11,56,47,9,59
Stranraer,7700,5,15,5,16,56,67,-11,50
East Fife,7700,6,14,3,19,50,65,-15,45
Airdrieon,7700,7,10,11,15,45,59,-14,41
Forfar,7700,8,11,5,20,39,64,-25,38
Queen's Park,7700,9,7,10,19,42,73,-31,31
Albion,7700,10,8,6,22,59,83,-24,30
Ayr,7701,1,24,4,8,96,44,52,76
Raith,7701,2,22,9,5,69,33,36,75
Arbroath,7701,3,17,9,10,72,50,22,60
Alloa,7701,4,17,9,10,57,44,13,60
Stranraer,7701,5,15,5,16,57,68,-11,50
East Fife,7701,6,14,3,19,51,66,-15,45
Airdrieon,7701,7,10,12,14,46,59,-13,42
Forfar,7701,8,10,6,20,39,65,-26,36
Albion,7701,9,8,6,22,59,84,-25,30
Queen's Park,7701,10,6,11,19,41,74,-33,29
Raith,7702,1,22,8,6,69,35,34,74
Ayr,7702,2,23,4,9,93,46,47,73
Alloa,7702,3,18,8,10,59,44,15,62
Arbroath,7702,4,17,8,11,71,50,21,59
Stranraer,7702,5,15,5,16,56,66,-10,50
East Fife,7702,6,14,3,19,49,65,-16,45
Airdrieon,7702,7,11,11,14,50,58,-8,44
Forfar,7702,8,10,5,21,38,69,-31,35
Albion,7702,9,9,6,21,61,81,-20,33
Queen's Park,7702,10,7,10,19,41,73,-32,31
Ayr,7703,1,24,4,8,92,42,50,76
Raith,7703,2,22,9,5,70,34,36,75
Alloa,7703,3,17,9,10,58,45,13,60
Arbroath,7703,4,17,8,11,70,50,20,59
Stranraer,7703,5,16,5,15,57,65,-8,53
East Fife,7703,6,13,3,20,48,66,-18,42
Airdrieon,7703,7,10,11,15,46,60,-14,41
Forfar,7703,8,11,5,20,40,65,-25,38
Queen's Park,7703,9,7,10,19,41,72,-31,31
Albion,7703,10,8,6,22,57,80,-23,30
Raith,7704,1,23,8,5,69,32,37,77
Ayr,7704,2,24,4,8,97,44,53,76
Arbroath,7704,3,17,8,11,72,51,21,59
Alloa,7704,4,17,8,11,56,44,12,59
Stranraer,7704,5,15,6,15,56,65,-9,51
East Fife,7704,6,13,4,19,48,65,-17,43
Airdrieon,7704,7,10,11,15,47,62,-15,41
Forfar,7704,8,11,5,20,42,66,-24,38
Queen's Park,7704,9,7,10,19,42,74,-32,31
Albion,7704,10,8,6,22,59,85,-26,30
Raith,7705,1,23,8,5,69,32,37,77
Ayr,7705,2,23,4,9,90,44,46,73
Arbroath,7705,3,17,8,11,70,51,19,59
Alloa,7705,4,17,8,11,56,44,12,59
Stranraer,7705,5,15,5,16,57,67,-10,50
East Fife,7705,6,14,3,19,50,66,-16,45
Airdrieon,7705,7,10,12,14,46,59,-13,42
Forfar,7705,8,10,6,20,39,65,-26,36
Albion,7705,9,9,6,21,59,78,-19,33
Queen's Park,7705,10,7,10,19,42,72,-30,31
Raith,7706,1,23,8,5,70,33,37,77
Ayr,7706,2,24,4,8,93,43,50,76
Arbroath,7706,3,17,8,11,70,49,21,59
Alloa,7706,4,17,8,11,57,45,12,59
Stranraer,7706,5,16,5,15,56,64,-8,53
Airdrieon,7706,6,11,11,14,47,59,-12,44
East Fife,7706,7,13,3,20,47,65,-18,42
Forfar,7706,8,10,5,21,39,66,-27,35
Queen's Park,7706,9,7,10,19,40,72,-32,31
Albion,7706,10,8,6,22,58,81,-23,30
Raith,7707,1,23,8,5,69,32,37,77
Ayr,7707,2,24,4,8,93,43,50,76
Arbroath,7707,3,18,8,10,73,49,24,62
Alloa,7707,4,17,8,11,56,44,12,59
Stranraer,7707,5,15,6,15,56,65,-9,51
Airdrieon,7707,6,11,11,14,48,59,-11,44
East Fife,7707,7,13,4,19,48,65,-17,43
Forfar,7707,8,10,5,21,39,67,-28,35
Albion,7707,9,8,6,22,58,81,-23,30
Queen's Park,7707,10,6,10,20,40,75,-35,28
Ayr,7708,1,24,4,8,98,42,56,76
Raith,7708,2,22,8,6,69,34,35,74
Arbroath,7708,3,18,8,10,74,51,23,62
Alloa,7708,4,18,8,10,58,44,14,62
Stranraer,7708,5,15,6,15,55,64,-9,51
Airdrieon,7708,6,11,11,14,46,58,-12,44
East Fife,7708,7,13,4,19,47,64,-17,43
Forfar,7708,8,10,5,21,38,65,-27,35
Albion,7708,9,8,6,22,57,86,-29,30
Queen's Park,7708,10,6,10,20,42,76,-34,28
Ayr,7709,1,24,4,8,93,43,50,76
Raith,7709,2,22,9,5,68,32,36,75
Alloa,7709,3,17,9,10,56,43,13,60
Arbroath,7709,4,17,8,11,71,51,20,59
Stranraer,7709,5,15,6,15,55,64,-9,51
East Fife,7709,6,13,4,19,47,64,-17,43
Airdrieon,7709,7,10,11,15,46,60,-14,41
Forfar,7709,8,11,5,20,40,65,-25,38
Queen's Park,7709,9,7,10,19,42,73,-31,31
Albion,7709,10,8,6,22,58,81,-23,30
Ayr,7710,1,24,4,8,92,43,49,76
Raith,7710,2,22,9,5,69,33,36,75
Arbroath,7710,3,17,9,10,70,48,22,60
Alloa,7710,4,17,9,10,57,44,13,60
Stranraer,7710,5,16,5,15,57,65,-8,53
Airdrieon,7710,6,10,12,14,47,60,-13,42
East Fife,7710,7,13,3,20,48,66,-18,42
Forfar,7710,8,10,6,20,40,66,-26,36
Albion,7710,9,8,6,22,58,80,-22,30
Queen's Park,7710,10,6,11,19,39,72,-33,29
Raith,7711,1,23,8,5,71,33,38,77
Ayr,7711,2,24,4,8,94,43,51,76
Arbroath,7711,3,17,9,10,72,50,22,60
Alloa,7711,4,17,8,11,57,46,11,59
Stranraer,7711,5,15,6,15,56,65,-9,51
Airdrieon,7711,6,11,11,14,49,59,-10,44
East Fife,7711,7,13,4,19,48,65,-17,43
Forfar,7711,8,10,5,21,39,68,-29,35
Albion,7711,9,8,6,22,58,82,-24,30
Queen's Park,7711,10,6,11,19,41,74,-33,29
Raith,7712,1,23,8,5,69,32,37,77
Ayr,7712,2,24,4,8,91,42,49,76
Arbroath,7712,3,17,8,11,71,50,21,59
Alloa,7712,4,17,8,11,56,44,12,59
Stranraer,7712,5,15,5,16,55,67,-12,50
East Fife,7712,6,14,3,19,50,64,-14,45
Airdrieon,7712,7,10,12,14,47,60,-13,42
Forfar,7712,8,10,6,20,40,66,-26,36
Queen's Park,7712,9,7,10,19,41,73,-32,31
Albion,7712,10,8,6,22,57,79,-22,30
Raith,7713,1,23,8,5,70,33,37,77
Ayr,7713,2,24,4,8,95,43,52,76
Arbroath,7713,3,18,8,10,71,48,23,62
Alloa,7713,4,17,8,11,57,45,12,59
Stranraer,7713,5,15,6,15,56,65,-9,51
Airdrieon,7713,6,11,11,14,48,60,-12,44
East Fife,7713,7,13,4,19,48,65,-17,43
Forfar,7713,8,10,5,21,40,67,-27,35
Albion,7713,9,8,6,22,58,83,-25,30
Queen's Park,7713,10,6,10,20,39,73,-34,28
Raith,7714,1,23,8,5,71,33,38,77
Ayr,7714,2,24,4,8,93,42,51,76
Arbroath,7714,3,18,8,10,72,48,24,62
Alloa,7714,4,17,8,11,57,46,11,59
Stranraer,7714,5,16,5,15,57,64,-7,53
Airdrieon,7714,6,10,12,14,46,59,-13,42
East Fife,7714,7,13,3,20,47,66,-19,42
Forfar,7714,8,10,6,20,39,65,-26,36
Albion,7714,9,8,6,22,57,81,-24,30
Queen's Park,7714,10,6,10,20,39,74,-35,28
Ayr,7715,1,24,4,8,92,42,50,76
Raith,7715,2,22,8,6,68,35,33,74
Arbroath,7715,3,18,8,10,73,50,23,62
Alloa,7715,4,18,8,10,59,43,16,62
Stranraer,7715,5,16,5,15,58,65,-7,53
Airdrieon,7715,6,10,12,14,46,59,-13,42
East Fife,7715,7,13,3,20,48,67,-19,42
Forfar,7715,8,10,6,20,39,65,-26,36
Albion,7715,9,8,6,22,57,80,-23,30
Queen's Park,7715,10,6,10,20,41,75,-34,28
Raith,7716,1,23,8,5,70,32,38,77
Ayr,7716,2,24,4,8,95,45,50,76
Arbroath,7716,3,18,8,10,71,48,23,62
Alloa,7716,4,17,8,11,56,45,11,59
Stranraer,7716,5,15,5,16,55,66,-11,50
East Fife,7716,6,14,3,19,49,64,-15,45
Airdrieon,7716,7,11,11,14,47,58,-11,44
Forfar,7716,8,10,5,21,38,66,-28,35
Albion,7716,9,8,6,22,60,83,-23,30
Queen's Park,7716,10,6,10,20,39,73,-34,28
Raith,7717,1,23,8,5,70,33,37,77
Ayr,7717,2,24,4,8,93,42,51,76
Arbroath,7717,3,17,8,11,71,50,21,59
Alloa,7717,4,17,8,11,57,45,12,59
Stranraer,7717,5,15,5,16,56,70,-14,50
East Fife,7717,6,14,3,19,53,65,-12,45
Airdrieon,7717,7,10,11,15,45,59,-14,41
Forfar,7717,8,11,5,20,39,64,-25,38
Queen's Park,7717,9,7,10,19,41,73,-32,31
Albion,7717,10,8,6,22,57,81,-24,30
Raith,7718,1,23,8,5,72,32,40,77
Ayr,7718,2,24,4,8,94,45,49,76
Arbroath,7718,3,18,8,10,72,48,24,62
Alloa,7718,4,17,8,11,56,47,9,59
Stranraer,7718,5,15,5,16,55,67,-12,50
East Fife,7718,6,14,3,19,50,64,-14,45
Airdrieon,7718,7,10,11,15,45,61,-16,41
Forfar,7718,8,11,5,20,41,64,-23,38
Albion,7718,9,8,6,22,60,82,-22,30
Queen's Park,7718,10,6,10,20,39,74,-35,28
Raith,7719,1,23,8,5,69,32,37,77
Ayr,7719,2,24,4,8,91,42,49,76
Arbroath,7719,3,17,8,11,72,51,21,59
Alloa,7719,4,17,8,11,56,44,12,59
Stranraer,7719,5,15,6,15,57,66,-9,51
East Fife,7719,6,13,4,19,49,66,-17,43
Airdrieon,7719,7,10,11,15,45,59,-14,41
Forfar,7719,8,11,5,20,39,64,-25,38
Queen's Park,7719,9,7,10,19,42,74,-32,31
Albion,7719,10,8,6,22,57,79,-22,30
Raith,7720,1,23,8,5,71,33,38,77
Ayr,7720,2,24,4,8,91,42,49,76
Arbroath,7720,3,17,8,11,71,51,20,59
Alloa,7720,4,17,8,11,57,46,11,59
Stranraer,7720,5,16,5,15,57,65,-8,53
Airdrieon,7720,6,10,12,14,46,59,-13,42
East Fife,7720,7,13,3,20,48,66,-18,42
Forfar,7720,8,10,6,20,39,65,-26,36
Queen's Park,7720,9,7,10,19,42,73,-31,31
Albion,7720,10,8,6,22,57,79,-22,30
Ayr,7721,1,24,4,8,94,44,50,76
Raith,7721,2,22,8,6,69,34,35,74
Alloa,7721,3,18,8,10,58,44,14,62
Arbroath,7721,4,17,8,11,71,50,21,59
Stranraer,7721,5,15,5,16,57,67,-10,50
East Fife,7721,6,14,3,19,50,66,-16,45
Airdrieon,7721,7,11,11,14,47,59,-12,44
Forfar,7721,8,10,5,21,39,66,-27,35
Queen's Park,7721,9,7,10,19,41,73,-32,31
Albion,7721,10,8,6,22,59,82,-23,30
Raith,7722,1,23,8,5,70,32,38,77
Ayr,7722,2,24,4,8,94,45,49,76
Arbroath,7722,3,17,8,11,70,50,20,59
Alloa,7722,4,17,8,11,56,45,11,59
Stranraer,7722,5,16,5,15,57,65,-8,53
Airdrieon,7722,6,10,12,14,45,58,-13,42
East Fife,7722,7,13,3,20,48,66,-18,42
Forfar,7722,8,10,6,20,38,64,-26,36
Queen's Park,7722,9,7,10,19,41,72,-31,31
Albion,7722,10,8,6,22,60,82,-22,30
Raith,7723,1,23,8,5,70,33,37,77
Ayr,7723,2,24,4,8,96,42,54,76
Arbroath,7723,3,17,8,11,71,50,21,59
Alloa,7723,4,17,8,11,57,45,12,59
Stranraer,7723,5,15,5,16,55,65,-10,50
East Fife,7723,6,14,3,19,48,64,-16,45
Airdrieon,7723,7,10,11,15,45,60,-15,41
Forfar,7723,8,11,5,20,40,64,-24,38
Queen's Park,7723,9,7,10,19,41,73,-32,31
Albion,7723,10,8,6,22,57,84,-27,30
Raith,7724,1,23,8,5,70,32,38,77
Ayr,7724,2,24,4,8,93,43,50,76
Arbroath,7724,3,18,8,10,75,48,27,62
Alloa,7724,4,17,8,11,56,45,11,59
Stranraer,7724,5,15,5,16,55,67,-12,50
East Fife,7724,6,14,3,19,50,64,-14,45
Airdrieon,7724,7,10,11,15,46,60,-14,41
Forfar,7724,8,11,5,20,40,65,-25,38
Albion,7724,9,8,6,22,58,81,-23,30
Queen's Park,7724,10,6,10,20,39,77,-38,28
Raith,7725,1,23,8,5,70,32,38,77
Ayr,7725,2,24,4,8,92,43,49,76
Arbroath,7725,3,18,8,10,72,48,24,62
Alloa,7725,4,17,8,11,56,45,11,59
Stranraer,7725,5,15,5,16,56,67,-11,50
East Fife,7725,6,14,3,19,50,65,-15,45
Airdrieon,7725,7,11,11,14,51,59,-8,44
Forfar,7725,8,10,5,21,39,70,-31,35
Albion,7725,9,8,6,22,58,80,-22,30
Queen's Park,7725,10,6,10,20,39,74,-35,28
Raith,7726,1,23,8,5,69,32,37,77
Ayr,7726,2,24,4,8,92,43,49,76
Arbroath,7726,3,17,9,10,71,49,22,60
Alloa,7726,4,17,8,11,56,44,12,59
Stranraer,7726,5,15,6,15,56,65,-9,51
Airdrieon,7726,6,11,11,14,46,58,-12,44
East Fife,7726,7,13,4,19,48,65,-17,43
Forfar,7726,8,10,5,21,38,65,-27,35
Albion,7726,9,8,6,22,58,80,-22,30
Queen's Park,7726,10,6,11,19,40,73,-33,29
Raith,7727,1,23,8,5,72,33,39,77
Ayr,7727,2,24,4,8,94,45,49,76
Arbroath,7727,3,17,8,11,74,53,21,59
Alloa,7727,4,17,8,11,57,47,10,59
Stranraer,7727,5,15,6,15,56,65,-9,51
East Fife,7727,6,13,4,19,48,65,-17,43
Airdrieon,7727,7,10,11,15,46,60,-14,41
Forfar,7727,8,11,5,20,40,65,-25,38
Queen's Park,7727,9,7,10,19,44,76,-32,31
Albion,7727,10,8,6,22,60,82,-22,30
Raith,7728,1,23,8,5,69,32,37,77
Ayr,7728,2,24,4,8,93,42,51,76
Arbroath,7728,3,17,9,10,73,51,22,60
Alloa,7728,4,17,8,11,56,44,12,59
Stranraer,7728,5,15,6,15,56,65,-9,51
Airdrieon,7728,6,11,11,14,49,59,-10,44
East Fife,7728,7,13,4,19,48,65,-17,43
Forfar,7728,8,10,5,21,39,68,-29,35
Albion,7728,9,8,6,22,57,81,-24,30
Queen's Park,7728,10,6,11,19,42,75,-33,29
Ayr,7729,1,24,4,8,93,43,50,76
Raith,7729,2,22,8,6,68,33,35,74
Alloa,7729,3,18,8,10,57,43,14,62
Arbroath,7729,4,17,8,11,71,50,21,59
Stranraer,7729,5,15,5,16,56,70,-14,50
East Fife,7729,6,14,3,19,53,65,-12,45
Airdrieon,7729,7,11,11,14,50,59,-9,44
Forfar,7729,8,10,5,21,39,69,-30,35
Queen's Park,7729,9,7,10,19,41,73,-32,31
Albion,7729,10,8,6,22,58,81,-23,30
Raith,7730,1,23,8,5,69,32,37,77
Ayr,7730,2,23,5,8,92,44,48,74
Arbroath,7730,3,17,9,10,71,49,22,60
Alloa,7730,4,17,8,11,56,44,12,59
Stranraer,7730,5,15,6,15,56,65,-9,51
Airdrieon,7730,6,11,11,14,49,58,-9,44
East Fife,7730,7,13,4,19,48,65,-17,43
Forfar,7730,8,10,5,21,38,68,-30,35
Albion,7730,9,8,7,21,59,80,-21,31
Queen's Park,7730,10,6,11,19,40,73,-33,29
Raith,7731,1,23,8,5,70,33,37,77
Ayr,7731,2,24,4,8,93,42,51,76
Arbroath,7731,3,18,8,10,75,48,27,62
Alloa,7731,4,17,8,11,57,45,12,59
Stranraer,7731,5,15,5,16,56,67,-11,50
East Fife,7731,6,14,3,19,50,65,-15,45
Airdrieon,7731,7,10,12,14,46,59,-13,42
Forfar,7731,8,10,6,20,39,65,-26,36
Albion,7731,9,8,6,22,57,81,-24,30
Queen's Park,7731,10,6,10,20,39,77,-38,28
Raith,7732,1,23,8,5,71,33,38,77
Ayr,7732,2,24,4,8,96,44,52,76
Arbroath,7732,3,18,8,10,71,48,23,62
Alloa,7732,4,17,8,11,57,46,11,59
Stranraer,7732,5,16,5,15,57,65,-8,53
Airdrieon,7732,6,11,11,14,47,59,-12,44
East Fife,7732,7,13,3,20,48,66,-18,42
Forfar,7732,8,10,5,21,39,66,-27,35
Albion,7732,9,8,6,22,59,84,-25,30
Queen's Park,7732,10,6,10,20,39,73,-34,28
Raith,7733,1,23,8,5,70,32,38,77
Ayr,7733,2,23,5,8,93,45,48,74
Arbroath,7733,3,17,9,10,71,49,22,60
Alloa,7733,4,17,8,11,56,45,11,59
Stranraer,7733,5,15,5,16,55,67,-12,50
East Fife,7733,6,14,3,19,50,64,-14,45
Airdrieon,7733,7,10,12,14,48,61,-13,42
Forfar,7733,8,10,6,20,41,67,-26,36
Albion,7733,9,8,7,21,60,81,-21,31
Queen's Park,7733,10,6,11,19,40,73,-33,29
Raith,7734,1,23,8,5,72,33,39,77
Ayr,7734,2,24,4,8,93,42,51,76
Arbroath,7734,3,18,8,10,73,49,24,62
Alloa,7734,4,17,8,11,57,47,10,59
Stranraer,7734,5,15,5,16,56,66,-10,50
East Fife,7734,6,14,3,19,49,65,-16,45
Airdrieon,7734,7,11,11,14,48,60,-12,44
Forfar,7734,8,10,5,21,40,67,-27,35
Albion,7734,9,8,6,22,57,81,-24,30
Queen's Park,7734,10,6,10,20,40,75,-35,28
Raith,7735,1,22,9,5,69,33,36,75
Ayr,7735,2,23,5,8,92,44,48,74
Alloa,7735,3,17,9,10,57,44,13,60
Arbroath,7735,4,17,8,11,72,51,21,59
Stranraer,7735,5,15,5,16,56,66,-10,50
East Fife,7735,6,14,3,19,49,65,-16,45
Airdrieon,7735,7,10,12,14,46,59,-13,42
Forfar,7735,8,10,6,20,39,65,-26,36
Albion,7735,9,8,7,21,59,80,-21,31
Queen's Park,7735,10,7,10,19,42,74,-32,31
Ayr,7736,1,24,4,8,94,44,50,76
Raith,7736,2,22,9,5,68,32,36,75
Arbroath,7736,3,18,8,10,72,48,24,62
Alloa,7736,4,17,9,10,56,43,13,60
Stranraer,7736,5,15,5,16,55,66,-11,50
East Fife,7736,6,14,3,19,49,64,-15,45
Airdrieon,7736,7,11,11,14,47,58,-11,44
Forfar,7736,8,10,5,21,38,66,-28,35
Albion,7736,9,8,6,22,59,82,-23,30
Queen's Park,7736,10,6,10,20,39,74,-35,28
Raith,7737,1,23,8,5,69,32,37,77
Ayr,7737,2,24,4,8,93,43,50,76
Arbroath,7737,3,18,8,10,71,48,23,62
Alloa,7737,4,17,8,11,56,44,12,59
Stranraer,7737,5,15,5,16,55,66,-11,50
East Fife,7737,6,14,3,19,49,64,-15,45
Airdrieon,7737,7,10,12,14,46,59,-13,42
Forfar,7737,8,10,6,20,39,65,-26,36
Albion,7737,9,8,6,22,58,81,-23,30
Queen's Park,7737,10,6,10,20,39,73,-34,28
Ayr,7738,1,24,4,8,94,44,50,76
Raith,7738,2,22,8,6,69,34,35,74
Alloa,7738,3,18,8,10,58,44,14,62
Arbroath,7738,4,17,9,10,71,49,22,60
Stranraer,7738,5,15,5,16,56,69,-13,50
East Fife,7738,6,14,3,19,52,65,-13,45
Airdrieon,7738,7,10,11,15,45,59,-14,41
Forfar,7738,8,11,5,20,39,64,-25,38
Albion,7738,9,8,6,22,59,82,-23,30
Queen's Park,7738,10,6,11,19,40,73,-33,29
Raith,7739,1,23,8,5,73,32,41,77
Ayr,7739,2,23,4,9,91,44,47,73
Arbroath,7739,3,17,8,11,71,50,21,59
Alloa,7739,4,17,8,11,56,48,8,59
Stranraer,7739,5,16,5,15,58,65,-7,53
East Fife,7739,6,13,3,20,48,67,-19,42
Airdrieon,7739,7,10,11,15,47,61,-14,41
Forfar,7739,8,11,5,20,41,66,-25,38
Albion,7739,9,9,6,21,59,79,-20,33
Queen's Park,7739,10,7,10,19,41,73,-32,31
Ayr,7740,1,24,4,8,94,43,51,76
Raith,7740,2,22,9,5,70,34,36,75
Alloa,7740,3,17,9,10,58,45,13,60
Arbroath,7740,4,17,8,11,71,50,21,59
Stranraer,7740,5,15,5,16,57,67,-10,50
East Fife,7740,6,14,3,19,50,66,-16,45
Airdrieon,7740,7,11,11,14,48,59,-11,44
Forfar,7740,8,10,5,21,39,67,-28,35
Queen's Park,7740,9,7,10,19,41,73,-32,31
Albion,7740,10,8,6,22,58,82,-24,30
Raith,7741,1,23,8,5,70,32,38,77
Ayr,7741,2,24,4,8,96,43,53,76
Arbroath,7741,3,18,8,10,72,49,23,62
Alloa,7741,4,17,8,11,56,45,11,59
Stranraer,7741,5,16,5,15,58,66,-8,53
Airdrieon,7741,6,11,11,14,49,58,-9,44
East Fife,7741,7,13,3,20,49,67,-18,42
Forfar,7741,8,10,5,21,38,68,-30,35
Albion,7741,9,8,6,22,58,84,-26,30
Queen's Park,7741,10,6,10,20,40,74,-34,28
Raith,7742,1,23,8,5,71,32,39,77
Ayr,7742,2,24,4,8,96,42,54,76
Arbroath,7742,3,17,9,10,71,49,22,60
Alloa,7742,4,17,8,11,56,46,10,59
Stranraer,7742,5,15,5,16,55,69,-14,50
East Fife,7742,6,14,3,19,52,64,-12,45
Airdrieon,7742,7,11,11,14,47,58,-11,44
Forfar,7742,8,10,5,21,38,66,-28,35
Albion,7742,9,8,6,22,57,84,-27,30
Queen's Park,7742,10,6,11,19,40,73,-33,29
Ayr,7743,1,24,4,8,95,45,50,76
Raith,7743,2,22,9,5,68,32,36,75
Arbroath,7743,3,18,8,10,73,49,24,62
Alloa,7743,4,17,9,10,56,43,13,60
Stranraer,7743,5,15,6,15,58,67,-9,51
East Fife,7743,6,13,4,19,50,67,-17,43
Airdrieon,7743,7,10,12,14,46,59,-13,42
Forfar,7743,8,10,6,20,39,65,-26,36
Albion,7743,9,8,6,22,60,83,-23,30
Queen's Park,7743,10,6,10,20,40,75,-35,28
Raith,7744,1,23,8,5,70,33,37,77
Ayr,7744,2,24,4,8,96,43,53,76
Arbroath,7744,3,18,8,10,72,49,23,62
Alloa,7744,4,17,8,11,57,45,12,59
Stranraer,7744,5,15,6,15,56,65,-9,51
East Fife,7744,6,13,4,19,48,65,-17,43
Airdrieon,7744,7,10,12,14,47,60,-13,42
Forfar,7744,8,10,6,20,40,66,-26,36
Albion,7744,9,8,6,22,58,84,-26,30
Queen's Park,7744,10,6,10,20,40,74,-34,28
Ayr,7745,1,24,4,8,96,43,53,76
Raith,7745,2,22,9,5,69,33,36,75
Arbroath,7745,3,17,9,10,72,50,22,60
Alloa,7745,4,17,9,10,57,44,13,60
Stranraer,7745,5,15,6,15,56,65,-9,51
East Fife,7745,6,13,4,19,48,65,-17,43
Airdrieon,7745,7,10,11,15,46,61,-15,41
Forfar,7745,8,11,5,20,41,65,-24,38
Albion,7745,9,8,6,22,58,84,-26,30
Queen's Park,7745,10,6,11,19,41,74,-33,29
Raith,7746,1,23,8,5,71,34,37,77
Ayr,7746,2,24,4,8,96,43,53,76
Arbroath,7746,3,18,8,10,74,50,24,62
Alloa,7746,4,17,8,11,58,46,12,59
Stranraer,7746,5,15,6,15,56,65,-9,51
East Fife,7746,6,13,4,19,48,65,-17,43
Airdrieon,7746,7,10,12,14,47,60,-13,42
Forfar,7746,8,10,6,20,40,66,-26,36
Albion,7746,9,8,6,22,58,84,-26,30
Queen's Park,7746,10,6,10,20,41,76,-35,28
Ayr,7747,1,24,4,8,91,42,49,76
Raith,7747,2,22,8,6,68,35,33,74
Alloa,7747,3,18,8,10,59,43,16,62
Arbroath,7747,4,17,9,10,71,49,22,60
Stranraer,7747,5,15,5,16,55,65,-10,50
East Fife,7747,6,14,3,19,48,64,-16,45
Airdrieon,7747,7,11,11,14,46,58,-12,44
Forfar,7747,8,10,5,21,38,65,-27,35
Albion,7747,9,8,6,22,57,79,-22,30
Queen's Park,7747,10,6,11,19,40,73,-33,29
Raith,7748,1,23,8,5,71,32,39,77
Ayr,7748,2,24,4,8,93,44,49,76
Arbroath,7748,3,18,8,10,71,48,23,62
Alloa,7748,4,17,8,11,56,46,10,59
Stranraer,7748,5,16,5,15,56,64,-8,53
Airdrieon,7748,6,11,11,14,47,59,-12,44
East Fife,7748,7,13,3,20,47,65,-18,42
Forfar,7748,8,10,5,21,39,66,-27,35
Albion,7748,9,8,6,22,59,81,-22,30
Queen's Park,7748,10,6,10,20,39,73,-34,28
Raith,7749,1,23,8,5,71,33,38,77
Ayr,7749,2,23,5,8,92,44,48,74
Arbroath,7749,3,17,9,10,73,51,22,60
Alloa,7749,4,17,8,11,57,46,11,59
Stranraer,7749,5,16,5,15,57,65,-8,53
Airdrieon,7749,6,11,11,14,46,58,-12,44
East Fife,7749,7,13,3,20,48,66,-18,42
Forfar,7749,8,10,5,21,38,65,-27,35
Albion,7749,9,8,7,21,59,80,-21,31
Queen's Park,7749,10,6,11,19,42,75,-33,29
Raith,7750,1,23,8,5,69,32,37,77
Ayr,7750,2,24,4,8,97,42,55,76
Arbroath,7750,3,17,8,11,72,51,21,59
Alloa,7750,4,17,8,11,56,44,12,59
Stranraer,7750,5,16,5,15,58,65,-7,53
East Fife,7750,6,13,3,20,48,67,-19,42
Airdrieon,7750,7,10,11,15,46,60,-14,41
Forfar,7750,8,11,5,20,40,65,-25,38
Queen's Park,7750,9,7,10,19,42,74,-32,31
Albion,7750,10,8,6,22,57,85,-28,30
Raith,7751,1,23,8,5,70,32,38,77
Ayr,7751,2,24,4,8,94,42,52,76
Arbroath,7751,3,17,9,10,72,50,22,60
Alloa,7751,4,17,8,11,56,45,11,59
Stranraer,7751,5,15,5,16,56,67,-11,50
East Fife,7751,6,14,3,19,50,65,-15,45
Airdrieon,7751,7,11,11,14,46,58,-12,44
Forfar,7751,8,10,5,21,38,65,-27,35
Albion,7751,9,8,6,22,57,82,-25,30
Queen's Park,7751,10,6,11,19,41,74,-33,29
Ayr,7752,1,24,4,8,93,43,50,76
Raith,7752,2,22,9,5,69,33,36,75
Alloa,7752,3,17,9,10,57,44,13,60
Arbroath,7752,4,17,8,11,73,52,21,59
Stranraer,7752,5,15,6,15,58,67,-9,51
East Fife,7752,6,13,4,19,50,67,-17,43
Airdrieon,7752,7,10,12,14,46,59,-13,42
Forfar,7752,8,10,6,20,39,65,-26,36
Queen's Park,7752,9,7,10,19,43,75,-32,31
Albion,7752,10,8,6,22,58,81,-23,30
Raith,7753,1,23,8,5,73,32,41,77
Ayr,7753,2,24,4,8,94,43,51,76
Arbroath,7753,3,18,8,10,73,49,24,62
Alloa,7753,4,17,8,11,56,48,8,59
Stranraer,7753,5,15,6,15,57,66,-9,51
Airdrieon,7753,6,11,11,14,48,58,-10,44
East Fife,7753,7,13,4,19,49,66,-17,43
Forfar,7753,8,10,5,21,38,67,-29,35
Albion,7753,9,8,6,22,58,82,-24,30
Queen's Park,7753,10,6,10,20,40,75,-35,28
Raith,7754,1,23,8,5,70,32,38,77
Ayr,7754,2,24,4,8,99,43,56,76
Arbroath,7754,3,18,8,10,71,48,23,62
Alloa,7754,4,17,8,11,56,45,11,59
Stranraer,7754,5,15,5,16,56,66,-10,50
East Fife,7754,6,14,3,19,49,65,-16,45
Airdrieon,7754,7,11,11,14,48,59,-11,44
Forfar,7754,8,10,5,21,39,67,-28,35
Albion,7754,9,8,6,22,58,87,-29,30
Queen's Park,7754,10,6,10,20,39,73,-34,28
Ayr,7755,1,24,4,8,93,43,50,76
Raith,7755,2,22,8,6,68,33,35,74
Alloa,7755,3,18,8,10,57,43,14,62
Arbroath,7755,4,17,9,10,70,48,22,60
Stranraer,7755,5,16,5,15,56,64,-8,53
Airdrieon,7755,6,11,11,14,47,59,-12,44
East Fife,7755,7,13,3,20,47,65,-18,42
Forfar,7755,8,10,5,21,39,66,-27,35
Albion,7755,9,8,6,22,58,81,-23,30
Queen's Park,7755,10,6,11,19,39,72,-33,29
Ayr,7756,1,24,4,8,97,42,55,76
Raith,7756,2,22,8,6,68,34,34,74
Alloa,7756,3,18,8,10,58,43,15,62
Arbroath,7756,4,17,9,10,70,48,22,60
Stranraer,7756,5,16,5,15,57,65,-8,53
East Fife,7756,6,13,3,20,48,66,-18,42
Airdrieon,7756,7,10,11,15,47,62,-15,41
Forfar,7756,8,11,5,20,42,66,-24,38
Albion,7756,9,8,6,22,57,85,-28,30
Queen's Park,7756,10,6,11,19,39,72,-33,29
Ayr,7757,1,24,4,8,94,43,51,76
Raith,7757,2,22,8,6,70,35,35,74
Alloa,7757,3,18,8,10,59,45,14,62
Arbroath,7757,4,17,8,11,71,51,20,59
Stranraer,7757,5,15,5,16,57,70,-13,50
East Fife,7757,6,14,3,19,53,66,-13,45
Airdrieon,7757,7,10,12,14,45,58,-13,42
Forfar,7757,8,10,6,20,38,64,-26,36
Queen's Park,7757,9,7,10,19,42,73,-31,31
Albion,7757,10,8,6,22,58,82,-24,30
Ayr,7758,1,24,4,8,93,42,51,76
Raith,7758,2,22,9,5,69,33,36,75
Arbroath,7758,3,18,8,10,74,48,26,62
Alloa,7758,4,17,9,10,57,44,13,60
Stranraer,7758,5,15,5,16,55,65,-10,50
East Fife,7758,6,14,3,19,48,64,-16,45
Airdrieon,7758,7,10,11,15,45,59,-14,41
Forfar,7758,8,11,5,20,39,64,-25,38
Albion,7758,9,8,6,22,57,81,-24,30
Queen's Park,7758,10,6,10,20,39,76,-37,28
Raith,7759,1,23,8,5,71,33,38,77
Ayr,7759,2,23,4,9,91,44,47,73
Arbroath,7759,3,17,8,11,72,51,21,59
Alloa,7759,4,17,8,11,57,46,11,59
Stranraer,7759,5,15,5,16,55,66,-11,50
East Fife,7759,6,14,3,19,49,64,-15,45
Airdrieon,7759,7,10,12,14,48,61,-13,42
Forfar,7759,8,10,6,20,41,67,-26,36
Albion,7759,9,9,6,21,59,79,-20,33
Queen's Park,7759,10,7,10,19,42,74,-32,31
Ayr,7760,1,24,4,8,93,44,49,76
Raith,7760,2,22,8,6,69,34,35,74
Alloa,7760,3,18,8,10,58,44,14,62
Arbroath,7760,4,17,8,11,70,51,19,59
Stranraer,7760,5,15,5,16,57,67,-10,50
East Fife,7760,6,14,3,19,50,66,-16,45
Airdrieon,7760,7,11,11,14,48,59,-11,44
Forfar,7760,8,10,5,21,39,67,-28,35
Queen's Park,7760,9,7,10,19,42,72,-30,31
Albion,7760,10,8,6,22,59,81,-22,30
Ayr,7761,1,24,4,8,97,43,54,76
Raith,7761,2,22,9,5,69,33,36,75
Arbroath,7761,3,18,8,10,77,49,28,62
Alloa,7761,4,17,9,10,57,44,13,60
Stranraer,7761,5,15,5,16,55,65,-10,50
East Fife,7761,6,14,3,19,48,64,-16,45
Airdrieon,7761,7,10,12,14,47,60,-13,42
Forfar,7761,8,10,6,20,40,66,-26,36
Albion,7761,9,8,6,22,58,85,-27,30
Queen's Park,7761,10,6,10,20,40,79,-39,28
Raith,7762,1,23,8,5,69,32,37,77
Ayr,7762,2,24,4,8,93,44,49,76
Arbroath,7762,3,18,8,10,73,48,25,62
Alloa,7762,4,17,8,11,56,44,12,59
Stranraer,7762,5,15,5,16,56,66,-10,50
East Fife,7762,6,14,3,19,49,65,-16,45
Airdrieon,7762,7,11,11,14,48,60,-12,44
Forfar,7762,8,10,5,21,40,67,-27,35
Albion,7762,9,8,6,22,59,81,-22,30
Queen's Park,7762,10,6,10,20,39,75,-36,28
Ayr,7763,1,24,4,8,96,42,54,76
Raith,7763,2,22,8,6,69,34,35,74
Alloa,7763,3,18,8,10,58,44,14,62
Arbroath,7763,4,17,9,10,71,49,22,60
Stranraer,7763,5,16,5,15,58,66,-8,53
Airdrieon,7763,6,11,11,14,49,59,-10,44
East Fife,7763,7,13,3,20,49,67,-18,42
Forfar,7763,8,10,5,21,39,68,-29,35
Albion,7763,9,8,6,22,57,84,-27,30
Queen's Park,7763,10,6,11,19,40,73,-33,29
Ayr,7764,1,24,4,8,92,42,50,76
Raith,7764,2,22,8,6,69,35,34,74
Alloa,7764,3,18,8,10,59,44,15,62
Arbroath,7764,4,17,8,11,71,51,20,59
Stranraer,7764,5,16,5,15,58,65,-7,53
East Fife,7764,6,13,3,20,48,67,-19,42
Airdrieon,7764,7,10,11,15,45,59,-14,41
Forfar,7764,8,11,5,20,39,64,-25,38
Queen's Park,7764,9,7,10,19,42,73,-31,31
Albion,7764,10,8,6,22,57,80,-23,30
Raith,7765,1,23,8,5,72,32,40,77
Ayr,7765,2,24,4,8,93,42,51,76
Arbroath,7765,3,17,9,10,70,48,22,60
Alloa,7765,4,17,8,11,56,47,9,59
Stranraer,7765,5,16,5,15,58,64,-6,53
East Fife,7765,6,13,3,20,47,67,-20,42
Airdrieon,7765,7,10,11,15,46,60,-14,41
Forfar,7765,8,11,5,20,40,65,-25,38
Albion,7765,9,8,6,22,57,81,-24,30
Queen's Park,7765,10,6,11,19,39,72,-33,29
Raith,7766,1,23,8,5,71,32,39,77
Ayr,7766,2,24,4,8,92,42,50,76
Arbroath,7766,3,17,8,11,71,50,21,59
Alloa,7766,4,17,8,11,56,46,10,59
Stranraer,7766,5,16,5,15,57,65,-8,53
Airdrieon,7766,6,11,11,14,47,59,-12,44
East Fife,7766,7,13,3,20,48,66,-18,42
Forfar,7766,8,10,5,21,39,66,-27,35
Queen's Park,7766,9,7,10,19,41,73,-32,31
Albion,7766,10,8,6,22,57,80,-23,30
Raith,7767,1,23,8,5,74,34,40,77
Ayr,7767,2,24,4,8,93,43,50,76
Arbroath,7767,3,18,8,10,72,49,23,62
Alloa,7767,4,17,8,11,58,49,9,59
Stranraer,7767,5,15,5,16,56,66,-10,50
East Fife,7767,6,14,3,19,49,65,-16,45
Airdrieon,7767,7,10,11,15,46,62,-16,41
Forfar,7767,8,11,5,20,42,65,-23,38
Albion,7767,9,8,6,22,58,81,-23,30
Queen's Park,7767,10,6,10,20,40,74,-34,28
Ayr,7768,1,24,4,8,92,43,49,76
Raith,7768,2,22,8,6,70,35,35,74
Alloa,7768,3,18,8,10,59,45,14,62
Arbroath,7768,4,17,9,10,72,50,22,60
Stranraer,7768,5,15,5,16,55,66,-11,50
East Fife,7768,6,14,3,19,49,64,-15,45
Airdrieon,7768,7,10,11,15,45,59,-14,41
Forfar,7768,8,11,5,20,39,64,-25,38
Albion,7768,9,8,6,22,58,80,-22,30
Queen's Park,7768,10,6,11,19,41,74,-33,29
Ayr,7769,1,24,4,8,95,43,52,76
Raith,7769,2,22,9,5,69,33,36,75
Alloa,7769,3,17,9,10,57,44,13,60
Arbroath,7769,4,17,8,11,70,49,21,59
Stranraer,7769,5,15,6,15,56,65,-9,51
Airdrieon,7769,6,11,11,14,48,59,-11,44
East Fife,7769,7,13,4,19,48,65,-17,43
Forfar,7769,8,10,5,21,39,67,-28,35
Queen's Park,7769,9,7,10,19,40,72,-32,31
Albion,7769,10,8,6,22,58,83,-25,30
Raith,7770,1,23,8,5,70,32,38,77
Ayr,7770,2,23,5,8,91,43,48,74
Arbroath,7770,3,17,8,11,70,49,21,59
Alloa,7770,4,17,8,11,56,45,11,59
Stranraer,7770,5,15,5,16,55,65,-10,50
East Fife,7770,6,14,3,19,48,64,-16,45
Airdrieon,7770,7,11,11,14,46,58,-12,44
Forfar,7770,8,10,5,21,38,65,-27,35
Albion,7770,9,8,7,21,58,79,-21,31
Queen's Park,7770,10,7,10,19,40,72,-32,31
Ayr,7771,1,24,4,8,94,43,51,76
Raith,7771,2,22,9,5,68,32,36,75
Arbroath,7771,3,18,8,10,74,48,26,62
Alloa,7771,4,17,9,10,56,43,13,60
Stranraer,7771,5,16,5,15,56,64,-8,53
East Fife,7771,6,13,3,20,47,65,-18,42
Airdrieon,7771,7,10,11,15,45,59,-14,41
Forfar,7771,8,11,5,20,39,64,-25,38
Albion,7771,9,8,6,22,58,82,-24,30
Queen's Park,7771,10,6,10,20,39,76,-37,28
Raith,7772,1,23,8,5,70,33,37,77
Ayr,7772,2,23,4,9,90,44,46,73
Arbroath,7772,3,18,8,10,73,50,23,62
Alloa,7772,4,17,8,11,57,45,12,59
Stranraer,7772,5,15,6,15,56,65,-9,51
Airdrieon,7772,6,11,11,14,49,59,-10,44
East Fife,7772,7,13,4,19,48,65,-17,43
Forfar,7772,8,10,5,21,39,68,-29,35
Albion,7772,9,9,6,21,59,78,-19,33
Queen's Park,7772,10,6,10,20,41,75,-34,28
Ayr,7773,1,24,4,8,94,44,50,76
Raith,7773,2,22,8,6,68,34,34,74
Arbroath,7773,3,18,8,10,75,50,25,62
Alloa,7773,4,18,8,10,58,43,15,62
Stranraer,7773,5,16,5,15,57,65,-8,53
Airdrieon,7773,6,10,12,14,46,59,-13,42
East Fife,7773,7,13,3,20,48,66,-18,42
Forfar,7773,8,10,6,20,39,65,-26,36
Albion,7773,9,8,6,22,59,82,-23,30
Queen's Park,7773,10,6,10,20,41,77,-36,28
Raith,7774,1,23,8,5,73,33,40,77
Ayr,7774,2,24,4,8,92,43,49,76
Arbroath,7774,3,18,8,10,73,50,23,62
Alloa,7774,4,17,8,11,57,48,9,59
Stranraer,7774,5,15,6,15,56,65,-9,51
Airdrieon,7774,6,11,11,14,49,58,-9,44
East Fife,7774,7,13,4,19,48,65,-17,43
Forfar,7774,8,10,5,21,38,68,-30,35
Albion,7774,9,8,6,22,58,80,-22,30
Queen's Park,7774,10,6,10,20,41,75,-34,28
Ayr,7775,1,24,4,8,92,42,50,76
Raith,7775,2,22,8,6,68,34,34,74
Alloa,7775,3,18,8,10,58,43,15,62
Arbroath,7775,4,17,8,11,70,49,21,59
Stranraer,7775,5,15,5,16,56,70,-14,50
East Fife,7775,6,14,3,19,53,65,-12,45
Airdrieon,7775,7,10,11,15,46,60,-14,41
Forfar,7775,8,11,5,20,40,65,-25,38
Queen's Park,7775,9,7,10,19,40,72,-32,31
Albion,7775,10,8,6,22,57,80,-23,30
Raith,7776,1,23,8,5,71,32,39,77
Ayr,7776,2,24,4,8,93,43,50,76
Arbroath,7776,3,18,8,10,71,48,23,62
Alloa,7776,4,17,8,11,56,46,10,59
Stranraer,7776,5,15,5,16,55,65,-10,50
East Fife,7776,6,14,3,19,48,64,-16,45
Airdrieon,7776,7,10,12,14,46,59,-13,42
Forfar,7776,8,10,6,20,39,65,-26,36
Albion,7776,9,8,6,22,58,81,-23,30
Queen's Park,7776,10,6,10,20,39,73,-34,28
Ayr,7777,1,24,4,8,95,44,51,76
Raith,7777,2,22,9,5,69,33,36,75
Arbroath,7777,3,18,8,10,73,49,24,62
Alloa,7777,4,17,9,10,57,44,13,60
Stranraer,7777,5,15,5,16,55,65,-10,50
East Fife,7777,6,14,3,19,48,64,-16,45
Airdrieon,7777,7,11,11,14,48,60,-12,44
Forfar,7777,8,10,5,21,40,67,-27,35
Albion,7777,9,8,6,22,59,83,-24,30
Queen's Park,7777,10,6,10,20,40,75,-35,28
Ayr,7778,1,24,4,8,92,42,50,76
Raith,7778,2,22,8,6,68,34,34,74
Arbroath,7778,3,18,8,10,74,49,25,62
Alloa,7778,4,18,8,10,58,43,15,62
Stranraer,7778,5,15,5,16,55,66,-11,50
East Fife,7778,6,14,3,19,49,64,-15,45
Airdrieon,7778,7,10,11,15,46,60,-14,41
Forfar,7778,8,11,5,20,40,65,-25,38
Albion,7778,9,8,6,22,57,80,-23,30
Queen's Park,7778,10,6,10,20,40,76,-36,28
Raith,7779,1,23,8,5,70,32,38,77
Ayr,7779,2,24,4,8,96,44,52,76
Arbroath,7779,3,18,8,10,76,50,26,62
Alloa,7779,4,17,8,11,56,45,11,59
Stranraer,7779,5,16,5,15,57,65,-8,53
Airdrieon,7779,6,10,12,14,45,58,-13,42
East Fife,7779,7,13,3,20,48,66,-18,42
Forfar,7779,8,10,6,20,38,64,-26,36
Albion,7779,9,8,6,22,59,84,-25,30
Queen's Park,7779,10,6,10,20,41,78,-37,28
Raith,7780,1,23,8,5,70,32,38,77
Ayr,7780,2,23,5,8,90,42,48,74
Arbroath,7780,3,18,8,10,71,48,23,62
Alloa,7780,4,17,8,11,56,45,11,59
Stranraer,7780,5,16,5,15,56,64,-8,53
Airdrieon,7780,6,11,11,14,48,58,-10,44
East Fife,7780,7,13,3,20,47,65,-18,42
Forfar,7780,8,10,5,21,38,67,-29,35
Albion,7780,9,8,7,21,57,78,-21,31
Queen's Park,7780,10,6,10,20,39,73,-34,28
Ayr,7781,1,23,5,8,91,43,48,74
Raith,7781,2,22,8,6,68,33,35,74
Arbroath,7781,3,18,8,10,75,49,26,62
Alloa,7781,4,18,8,10,57,43,14,62
Stranraer,7781,5,15,6,15,56,65,-9,51
Airdrieon,7781,6,11,11,14,48,59,-11,44
East Fife,7781,7,13,4,19,48,65,-17,43
Forfar,7781,8,10,5,21,39,67,-28,35
Albion,7781,9,8,7,21,58,79,-21,31
Queen's Park,7781,10,6,10,20,40,77,-37,28
Ayr,7782,1,24,4,8,94,42,52,76
Raith,7782,2,22,8,6,68,34,34,74
Arbroath,7782,3,18,8,10,71,48,23,62
Alloa,7782,4,18,8,10,58,43,15,62
Stranraer,7782,5,15,5,16,56,68,-12,50
East Fife,7782,6,14,3,19,51,65,-14,45
Airdrieon,7782,7,11,11,14,47,59,-12,44
Forfar,7782,8,10,5,21,39,66,-27,35
Albion,7782,9,8,6,22,57,82,-25,30
Queen's Park,7782,10,6,10,20,39,73,-34,28
Ayr,7783,1,24,4,8,92,43,49,76
Raith,7783,2,22,8,6,69,34,35,74
Arbroath,7783,3,18,8,10,72,49,23,62
Alloa,7783,4,18,8,10,58,44,14,62
Stranraer,7783,5,16,5,15,57,64,-7,53
East Fife,7783,6,13,3,20,47,66,-19,42
Airdrieon,7783,7,10,11,15,46,60,-14,41
Forfar,7783,8,11,5,20,40,65,-25,38
Albion,7783,9,8,6,22,58,80,-22,30
Queen's Park,7783,10,6,10,20,40,74,-34,28
Ayr,7784,1,24,4,8,93,42,51,76
Raith,7784,2,22,8,6,68,34,34,74
Alloa,7784,3,18,8,10,58,43,15,62
Arbroath,7784,4,17,9,10,71,49,22,60
Stranraer,7784,5,15,6,15,57,66,-9,51
Airdrieon,7784,6,11,11,14,47,58,-11,44
East Fife,7784,7,13,4,19,49,66,-17,43
Forfar,7784,8,10,5,21,38,66,-28,35
Albion,7784,9,8,6,22,57,81,-24,30
Queen's Park,7784,10,6,11,19,40,73,-33,29
Raith,7785,1,23,8,5,70,33,37,77
Ayr,7785,2,24,4,8,94,43,51,76
Arbroath,7785,3,17,9,10,71,49,22,60
Alloa,7785,4,17,8,11,57,45,12,59
Stranraer,7785,5,16,5,15,57,64,-7,53
Airdrieon,7785,6,10,12,14,46,59,-13,42
East Fife,7785,7,13,3,20,47,66,-19,42
Forfar,7785,8,10,6,20,39,65,-26,36
Albion,7785,9,8,6,22,58,82,-24,30
Queen's Park,7785,10,6,11,19,40,73,-33,29
Raith,7786,1,23,8,5,70,32,38,77
Ayr,7786,2,24,4,8,94,43,51,76
Arbroath,7786,3,18,8,10,72,48,24,62
Alloa,7786,4,17,8,11,56,45,11,59
Stranraer,7786,5,16,5,15,56,64,-8,53
Airdrieon,7786,6,10,12,14,45,58,-13,42
East Fife,7786,7,13,3,20,47,65,-18,42
Forfar,7786,8,10,6,20,38,64,-26,36
Albion,7786,9,8,6,22,58,82,-24,30
Queen's Park,7786,10,6,10,20,39,74,-35,28
Raith,7787,1,23,8,5,71,32,39,77
Ayr,7787,2,24,4,8,93,43,50,76
Arbroath,7787,3,18,8,10,73,50,23,62
Alloa,7787,4,17,8,11,56,46,10,59
Stranraer,7787,5,15,5,16,56,66,-10,50
East Fife,7787,6,14,3,19,49,65,-16,45
Airdrieon,7787,7,11,11,14,47,59,-12,44
Forfar,7787,8,10,5,21,39,66,-27,35
Albion,7787,9,8,6,22,58,81,-23,30
Queen's Park,7787,10,6,10,20,41,75,-34,28
Raith,7788,1,23,8,5,71,34,37,77
Ayr,7788,2,23,4,9,91,44,47,73
Arbroath,7788,3,17,8,11,70,50,20,59
Alloa,7788,4,17,8,11,58,46,12,59
Stranraer,7788,5,15,5,16,55,70,-15,50
East Fife,7788,6,14,3,19,53,64,-11,45
Airdrieon,7788,7,10,11,15,45,59,-14,41
Forfar,7788,8,11,5,20,39,64,-25,38
Albion,7788,9,9,6,21,59,79,-20,33
Queen's Park,7788,10,7,10,19,41,72,-31,31
Raith,7789,1,23,8,5,70,33,37,77
Ayr,7789,2,24,4,8,95,43,52,76
Arbroath,7789,3,18,8,10,74,51,23,62
Alloa,7789,4,17,8,11,57,45,12,59
Stranraer,7789,5,15,5,16,56,67,-11,50
East Fife,7789,6,14,3,19,50,65,-15,45
Airdrieon,7789,7,10,12,14,46,59,-13,42
Forfar,7789,8,10,6,20,39,65,-26,36
Albion,7789,9,8,6,22,58,83,-25,30
Queen's Park,7789,10,6,10,20,42,76,-34,28
Ayr,7790,1,24,4,8,94,44,50,76
Raith,7790,2,22,9,5,71,35,36,75
Arbroath,7790,3,17,9,10,72,50,22,60
Alloa,7790,4,17,9,10,59,46,13,60
Stranraer,7790,5,15,5,16,55,65,-10,50
East Fife,7790,6,14,3,19,48,64,-16,45
Airdrieon,7790,7,10,11,15,46,60,-14,41
Forfar,7790,8,11,5,20,40,65,-25,38
Albion,7790,9,8,6,22,59,82,-23,30
Queen's Park,7790,10,6,11,19,41,74,-33,29
Raith,7791,1,23,8,5,72,32,40,77
Ayr,7791,2,24,4,8,93,44,49,76
Arbroath,7791,3,18,8,10,74,49,25,62
Alloa,7791,4,17,8,11,56,47,9,59
Stranraer,7791,5,16,5,15,57,65,-8,53
Airdrieon,7791,6,10,12,14,46,59,-13,42
East Fife,7791,7,13,3,20,48,66,-18,42
Forfar,7791,8,10,6,20,39,65,-26,36
Albion,7791,9,8,6,22,59,81,-22,30
Queen's Park,7791,10,6,10,20,40,76,-36,28
Raith,7792,1,23,8,5,71,33,38,77
Ayr,7792,2,24,4,8,97,44,53,76
Arbroath,7792,3,17,9,10,71,49,22,60
Alloa,7792,4,17,8,11,57,46,11,59
Stranraer,7792,5,15,6,15,57,66,-9,51
East Fife,7792,6,13,4,19,49,66,-17,43
Airdrieon,7792,7,10,12,14,47,60,-13,42
Forfar,7792,8,10,6,20,40,66,-26,36
Albion,7792,9,8,6,22,59,85,-26,30
Queen's Park,7792,10,6,11,19,40,73,-33,29
Raith,7793,1,23,8,5,71,32,39,77
Ayr,7793,2,23,5,8,92,44,48,74
Arbroath,7793,3,17,9,10,73,51,22,60
Alloa,7793,4,17,8,11,56,46,10,59
Stranraer,7793,5,15,5,16,56,68,-12,50
East Fife,7793,6,14,3,19,51,65,-14,45
Airdrieon,7793,7,11,11,14,46,58,-12,44
Forfar,7793,8,10,5,21,38,65,-27,35
Albion,7793,9,8,7,21,59,80,-21,31
Queen's Park,7793,10,6,11,19,42,75,-33,29
Raith,7794,1,23,8,5,72,34,38,77
Ayr,7794,2,23,4,9,92,45,47,73
Arbroath,7794,3,18,8,10,71,48,23,62
Alloa,7794,4,17,8,11,58,47,11,59
Stranraer,7794,5,16,5,15,59,66,-7,53
Airdrieon,7794,6,10,12,14,46,59,-13,42
East Fife,7794,7,13,3,20,49,68,-19,42
Forfar,7794,8,10,6,20,39,65,-26,36
Albion,7794,9,9,6,21,60,80,-20,33
Queen's Park,7794,10,6,10,20,39,73,-34,28
Raith,7795,1,22,9,5,68,32,36,75
Ayr,7795,2,23,4,9,90,45,45,73
Arbroath,7795,3,18,8,10,73,49,24,62
Alloa,7795,4,17,9,10,56,43,13,60
Stranraer,7795,5,15,5,16,55,66,-11,50
East Fife,7795,6,14,3,19,49,64,-15,45
Airdrieon,7795,7,10,11,15,46,60,-14,41
Forfar,7795,8,11,5,20,40,65,-25,38
Albion,7795,9,9,6,21,60,78,-18,33
Queen's Park,7795,10,6,10,20,40,75,-35,28
Raith,7796,1,23,8,5,70,33,37,77
Ayr,7796,2,24,4,8,94,42,52,76
Arbroath,7796,3,17,9,10,71,49,22,60
Alloa,7796,4,17,8,11,57,45,12,59
Stranraer,7796,5,15,5,16,55,65,-10,50
East Fife,7796,6,14,3,19,48,64,-16,45
Airdrieon,7796,7,10,12,14,46,59,-13,42
Forfar,7796,8,10,6,20,39,65,-26,36
Albion,7796,9,8,6,22,57,82,-25,30
Queen's Park,7796,10,6,11,19,40,73,-33,29
Ayr,7797,1,24,4,8,92,43,49,76
Raith,7797,2,22,9,5,69,33,36,75
Arbroath,7797,3,18,8,10,72,48,24,62
Alloa,7797,4,17,9,10,57,44,13,60
Stranraer,7797,5,15,6,15,56,65,-9,51
Airdrieon,7797,6,11,11,14,46,58,-12,44
East Fife,7797,7,13,4,19,48,65,-17,43
Forfar,7797,8,10,5,21,38,65,-27,35
Albion,7797,9,8,6,22,58,80,-22,30
Queen's Park,7797,10,6,10,20,39,74,-35,28
Raith,7798,1,23,8,5,69,32,37,77
Ayr,7798,2,23,5,8,93,45,48,74
Arbroath,7798,3,17,8,11,73,52,21,59
Alloa,7798,4,17,8,11,56,44,12,59
Stranraer,7798,5,15,6,15,56,65,-9,51
East Fife,7798,6,13,4,19,48,65,-17,43
Airdrieon,7798,7,10,12,14,45,58,-13,42
Forfar,7798,8,10,6,20,38,64,-26,36
Albion,7798,9,8,7,21,60,81,-21,31
Queen's Park,7798,10,7,10,19,43,75,-32,31
Raith,7799,1,23,8,5,69,32,37,77
Ayr,7799,2,24,4,8,93,43,50,76
Arbroath,7799,3,17,8,11,70,49,21,59
Alloa,7799,4,17,8,11,56,44,12,59
Stranraer,7799,5,15,6,15,57,66,-9,51
Airdrieon,7799,6,11,11,14,48,58,-10,44
East Fife,7799,7,13,4,19,49,66,-17,43
Forfar,7799,8,10,5,21,38,67,-29,35
Queen's Park,7799,9,7,10,19,40,72,-32,31
Albion,7799,10,8,6,22,58,81,-23,30
Raith,7800,1,22,9,5,70,34,36,75
Ayr,7800,2,23,5,8,94,46,48,74
Arbroath,7800,3,18,8,10,71,48,23,62
Alloa,7800,4,17,9,10,58,45,13,60
Stranraer,7800,5,16,5,15,56,64,-8,53
Airdrieon,7800,6,11,11,14,49,60,-11,44
East Fife,7800,7,13,3,20,47,65,-18,42
Forfar,7800,8,10,5,21,40,68,-28,35
Albion,7800,9,8,7,21,61,82,-21,31
Queen's Park,7800,10,6,10,20,39,73,-34,28
Raith,7801,1,23,8,5,69,32,37,77
Ayr,7801,2,24,4,8,95,44,51,76
Arbroath,7801,3,18,8,10,72,48,24,62
Alloa,7801,4,17,8,11,56,44,12,59
Stranraer,7801,5,16,5,15,56,64,-8,53
East Fife,7801,6,13,3,20,47,65,-18,42
Airdrieon,7801,7,10,11,15,45,59,-14,41
Forfar,7801,8,11,5,20,39,64,-25,38
Albion,7801,9,8,6,22,59,83,-24,30
Queen's Park,7801,10,6,10,20,39,74,-35,28
Ayr,7802,1,24,4,8,92,42,50,76
Raith,7802,2,22,8,6,69,34,35,74
Arbroath,7802,3,18,8,10,72,49,23,62
Alloa,7802,4,18,8,10,58,44,14,62
Stranraer,7802,5,15,6,15,56,65,-9,51
Airdrieon,7802,6,11,11,14,47,59,-12,44
East Fife,7802,7,13,4,19,48,65,-17,43
Forfar,7802,8,10,5,21,39,66,-27,35
Albion,7802,9,8,6,22,57,80,-23,30
Queen's Park,7802,10,6,10,20,40,74,-34,28
Raith,7803,1,23,8,5,70,32,38,77
Ayr,7803,2,24,4,8,94,44,50,76
Arbroath,7803,3,17,8,11,70,50,20,59
Alloa,7803,4,17,8,11,56,45,11,59
Stranraer,7803,5,15,6,15,58,67,-9,51
East Fife,7803,6,13,4,19,50,67,-17,43
Airdrieon,7803,7,10,12,14,46,59,-13,42
Forfar,7803,8,10,6,20,39,65,-26,36
Queen's Park,7803,9,7,10,19,41,72,-31,31
Albion,7803,10,8,6,22,59,82,-23,30
Raith,7804,1,23,8,5,71,33,38,77
Ayr,7804,2,24,4,8,93,43,50,76
Arbroath,7804,3,17,8,11,70,50,20,59
Alloa,7804,4,17,8,11,57,46,11,59
Stranraer,7804,5,15,5,16,55,66,-11,50
East Fife,7804,6,14,3,19,49,64,-15,45
Airdrieon,7804,7,10,12,14,46,59,-13,42
Forfar,7804,8,10,6,20,39,65,-26,36
Queen's Park,7804,9,7,10,19,41,72,-31,31
Albion,7804,10,8,6,22,58,81,-23,30
Ayr,7805,1,24,4,8,95,42,53,76
Raith,7805,2,22,8,6,69,34,35,74
Arbroath,7805,3,18,8,10,72,49,23,62
Alloa,7805,4,18,8,10,58,44,14,62
Stranraer,7805,5,15,6,15,56,65,-9,51
Airdrieon,7805,6,11,11,14,47,59,-12,44
East Fife,7805,7,13,4,19,48,65,-17,43
Forfar,7805,8,10,5,21,39,66,-27,35
Albion,7805,9,8,6,22,57,83,-26,30
Queen's Park,7805,10,6,10,20,40,74,-34,28
Raith,7806,1,23,8,5,70,32,38,77
Ayr,7806,2,24,4,8,91,42,49,76
Arbroath,7806,3,18,8,10,76,48,28,62
Alloa,7806,4,17,8,11,56,45,11,59
Stranraer,7806,5,15,5,16,55,66,-11,50
East Fife,7806,6,14,3,19,49,64,-15,45
Airdrieon,7806,7,10,12,14,46,59,-13,42
Forfar,7806,8,10,6,20,39,65,-26,36
Albion,7806,9,8,6,22,57,79,-22,30
Queen's Park,7806,10,6,10,20,39,78,-39,28
Raith,7807,1,23,8,5,70,33,37,77
Ayr,7807,2,23,4,9,92,46,46,73
Arbroath,7807,3,18,8,10,72,49,23,62
Alloa,7807,4,17,8,11,57,45,12,59
Stranraer,7807,5,15,5,16,55,67,-12,50
East Fife,7807,6,14,3,19,50,64,-14,45
Airdrieon,7807,7,10,12,14,46,59,-13,42
Forfar,7807,8,10,6,20,39,65,-26,36
Albion,7807,9,9,6,21,61,80,-19,33
Queen's Park,7807,10,6,10,20,40,74,-34,28
Ayr,7808,1,24,4,8,92,43,49,76
Raith,7808,2,22,8,6,68,33,35,74
Alloa,7808,3,18,8,10,57,43,14,62
Arbroath,7808,4,17,9,10,71,49,22,60
Stranraer,7808,5,15,5,16,55,67,-12,50
East Fife,7808,6,14,3,19,50,64,-14,45
Airdrieon,7808,7,10,12,14,48,61,-13,42
Forfar,7808,8,10,6,20,41,67,-26,36
Albion,7808,9,8,6,22,58,80,-22,30
Queen's Park,7808,10,6,11,19,40,73,-33,29
Raith,7809,1,23,8,5,70,33,37,77
Ayr,7809,2,24,4,8,94,42,52,76
Arbroath,7809,3,17,9,10,71,49,22,60
Alloa,7809,4,17,8,11,57,45,12,59
Stranraer,7809,5,15,5,16,56,66,-10,50
East Fife,7809,6,14,3,19,49,65,-16,45
Airdrieon,7809,7,10,12,14,45,58,-13,42
Forfar,7809,8,10,6,20,38,64,-26,36
Albion,7809,9,8,6,22,57,82,-25,30
Queen's Park,7809,10,6,11,19,40,73,-33,29
Raith,7810,1,23,8,5,70,32,38,77
Ayr,7810,2,24,4,8,97,43,54,76
Arbroath,7810,3,17,8,11,70,49,21,59
Alloa,7810,4,17,8,11,56,45,11,59
Stranraer,7810,5,15,5,16,55,66,-11,50
East Fife,7810,6,14,3,19,49,64,-15,45
Airdrieon,7810,7,10,11,15,45,59,-14,41
Forfar,7810,8,11,5,20,39,64,-25,38
Queen's Park,7810,9,7,10,19,40,72,-32,31
Albion,7810,10,8,6,22,58,85,-27,30
Raith,7811,1,23,8,5,71,34,37,77
Ayr,7811,2,24,4,8,97,42,55,76
Arbroath,7811,3,17,8,11,71,50,21,59
Alloa,7811,4,17,8,11,58,46,12,59
Stranraer,7811,5,16,5,15,57,65,-8,53
Airdrieon,7811,6,11,11,14,47,59,-12,44
East Fife,7811,7,13,3,20,48,66,-18,42
Forfar,7811,8,10,5,21,39,66,-27,35
Queen's Park,7811,9,7,10,19,41,73,-32,31
Albion,7811,10,8,6,22,57,85,-28,30
Ayr,7812,1,24,4,8,98,46,52,76
Raith,7812,2,22,9,5,69,33,36,75
Alloa,7812,3,17,9,10,57,44,13,60
Arbroath,7812,4,17,8,11,71,50,21,59
Stranraer,7812,5,15,6,15,55,64,-9,51
East Fife,7812,6,13,4,19,47,64,-17,43
Airdrieon,7812,7,10,12,14,46,59,-13,42
Forfar,7812,8,10,6,20,39,65,-26,36
Queen's Park,7812,9,7,10,19,41,73,-32,31
Albion,7812,10,8,6,22,61,86,-25,30
Ayr,7813,1,24,4,8,93,43,50,76
Raith,7813,2,22,9,5,68,32,36,75
Arbroath,7813,3,17,9,10,71,49,22,60
Alloa,7813,4,17,9,10,56,43,13,60
Stranraer,7813,5,15,5,16,56,66,-10,50
East Fife,7813,6,14,3,19,49,65,-16,45
Airdrieon,7813,7,11,11,14,47,58,-11,44
Forfar,7813,8,10,5,21,38,66,-28,35
Albion,7813,9,8,6,22,58,81,-23,30
Queen's Park,7813,10,6,11,19,40,73,-33,29
Raith,7814,1,22,9,5,69,33,36,75
Ayr,7814,2,23,4,9,90,45,45,73
Alloa,7814,3,17,9,10,57,44,13,60
Arbroath,7814,4,17,8,11,71,50,21,59
Stranraer,7814,5,16,5,15,57,65,-8,53
Airdrieon,7814,6,11,11,14,49,59,-10,44
East Fife,7814,7,13,3,20,48,66,-18,42
Forfar,7814,8,10,5,21,39,68,-29,35
Albion,7814,9,9,6,21,60,78,-18,33
Queen's Park,7814,10,7,10,19,41,73,-32,31
Ayr,7815,1,24,4,8,95,44,51,76
Raith,7815,2,22,9,5,70,34,36,75
Arbroath,7815,3,18,8,10,72,48,24,62
Alloa,7815,4,17,9,10,58,45,13,60
Stranraer,7815,5,15,6,15,58,67,-9,51
Airdrieon,7815,6,11,11,14,48,59,-11,44
East Fife,7815,7,13,4,19,50,67,-17,43
Forfar,7815,8,10,5,21,39,67,-28,35
Albion,7815,9,8,6,22,59,83,-24,30
Queen's Park,7815,10,6,10,20,39,74,-35,28
Raith,7816,1,23,8,5,70,32,38,77
Ayr,7816,2,24,4,8,94,43,51,76
Arbroath,7816,3,17,8,11,71,51,20,59
Alloa,7816,4,17,8,11,56,45,11,59
Stranraer,7816,5,15,6,15,55,64,-9,51
Airdrieon,7816,6,11,11,14,46,58,-12,44
East Fife,7816,7,13,4,19,47,64,-17,43
Forfar,7816,8,10,5,21,38,65,-27,35
Queen's Park,7816,9,7,10,19,42,73,-31,31
Albion,7816,10,8,6,22,58,82,-24,30
Raith,7817,1,23,8,5,72,32,40,77
Ayr,7817,2,24,4,8,98,42,56,76
Arbroath,7817,3,17,9,10,71,49,22,60
Alloa,7817,4,17,8,11,56,47,9,59
Stranraer,7817,5,15,6,15,57,66,-9,51
Airdrieon,7817,6,11,11,14,46,58,-12,44
East Fife,7817,7,13,4,19,49,66,-17,43
Forfar,7817,8,10,5,21,38,65,-27,35
Albion,7817,9,8,6,22,57,86,-29,30
Queen's Park,7817,10,6,11,19,40,73,-33,29
Ayr,7818,1,24,4,8,95,42,53,76
Raith,7818,2,22,9,5,71,35,36,75
Arbroath,7818,3,17,9,10,71,49,22,60
Alloa,7818,4,17,9,10,59,46,13,60
Stranraer,7818,5,16,5,15,57,65,-8,53
Airdrieon,7818,6,11,11,14,47,59,-12,44
East Fife,7818,7,13,3,20,48,66,-18,42
Forfar,7818,8,10,5,21,39,66,-27,35
Albion,7818,9,8,6,22,57,83,-26,30
Queen's Park,7818,10,6,11,19,40,73,-33,29
Raith,7819,1,22,9,5,69,33,36,75
Ayr,7819,2,23,5,8,91,43,48,74
Alloa,7819,3,17,9,10,57,44,13,60
Arbroath,7819,4,17,8,11,72,51,21,59
Stranraer,7819,5,16,5,15,56,64,-8,53
Airdrieon,7819,6,11,11,14,49,59,-10,44
East Fife,7819,7,13,3,20,47,65,-18,42
Forfar,7819,8,10,5,21,39,68,-29,35
Albion,7819,9,8,7,21,58,79,-21,31
Queen's Park,7819,10,7,10,19,42,74,-32,31
Ayr,7820,1,24,4,8,93,44,49,76
Raith,7820,2,22,8,6,69,34,35,74
Alloa,7820,3,18,8,10,58,44,14,62
Arbroath,7820,4,17,9,10,70,48,22,60
Stranraer,7820,5,15,5,16,56,66,-10,50
East Fife,7820,6,14,3,19,49,65,-16,45
Airdrieon,7820,7,11,11,14,47,58,-11,44
Forfar,7820,8,10,5,21,38,66,-28,35
Albion,7820,9,8,6,22,59,81,-22,30
Queen's Park,7820,10,6,11,19,39,72,-33,29
Ayr,7821,1,24,4,8,95,42,53,76
Raith,7821,2,22,9,5,69,33,36,75
Arbroath,7821,3,18,8,10,73,50,23,62
Alloa,7821,4,17,9,10,57,44,13,60
Stranraer,7821,5,16,5,15,57,64,-7,53
East Fife,7821,6,13,3,20,47,66,-19,42
Airdrieon,7821,7,10,11,15,45,59,-14,41
Forfar,7821,8,11,5,20,39,64,-25,38
Albion,7821,9,8,6,22,57,83,-26,30
Queen's Park,7821,10,6,10,20,41,75,-34,28
Raith,7822,1,23,8,5,72,32,40,77
Ayr,7822,2,24,4,8,93,44,49,76
Arbroath,7822,3,17,8,11,70,49,21,59
Alloa,7822,4,17,8,11,56,47,9,59
Stranraer,7822,5,15,5,16,57,67,-10,50
East Fife,7822,6,14,3,19,50,66,-16,45
Airdrieon,7822,7,11,11,14,48,60,-12,44
Forfar,7822,8,10,5,21,40,67,-27,35
Queen's Park,7822,9,7,10,19,40,72,-32,31
Albion,7822,10,8,6,22,59,81,-22,30
Raith,7823,1,23,8,5,71,34,37,77
Ayr,7823,2,24,4,8,94,43,51,76
Arbroath,7823,3,18,8,10,72,49,23,62
Alloa,7823,4,17,8,11,58,46,12,59
Stranraer,7823,5,15,5,16,55,66,-11,50
East Fife,7823,6,14,3,19,49,64,-15,45
Airdrieon,7823,7,10,12,14,48,61,-13,42
Forfar,7823,8,10,6,20,41,67,-26,36
Albion,7823,9,8,6,22,58,82,-24,30
Queen's Park,7823,10,6,10,20,40,74,-34,28
Ayr,7824,1,24,4,8,93,44,49,76
Raith,7824,2,22,9,5,69,33,36,75
Arbroath,7824,3,18,8,10,75,48,27,62
Alloa,7824,4,17,9,10,57,44,13,60
Stranraer,7824,5,16,5,15,57,65,-8,53
East Fife,7824,6,13,3,20,48,66,-18,42
Airdrieon,7824,7,10,11,15,46,60,-14,41
Forfar,7824,8,11,5,20,40,65,-25,38
Albion,7824,9,8,6,22,59,81,-22,30
Queen's Park,7824,10,6,10,20,39,77,-38,28
Raith,7825,1,23,8,5,70,32,38,77
Ayr,7825,2,23,4,9,92,45,47,73
Arbroath,7825,3,18,8,10,74,48,26,62
Alloa,7825,4,17,8,11,56,45,11,59
Stranraer,7825,5,15,6,15,57,66,-9,51
Airdrieon,7825,6,11,11,14,48,59,-11,44
East Fife,7825,7,13,4,19,49,66,-17,43
Forfar,7825,8,10,5,21,39,67,-28,35
Albion,7825,9,9,6,21,60,80,-20,33
Queen's Park,7825,10,6,10,20,39,76,-37,28
Raith,7826,1,22,8,6,68,33,35,74
Ayr,7826,2,23,4,9,90,43,47,73
Alloa,7826,3,18,8,10,57,43,14,62
Arbroath,7826,4,17,8,11,71,50,21,59
Stranraer,7826,5,16,5,15,57,64,-7,53
East Fife,7826,6,13,3,20,47,66,-19,42
Airdrieon,7826,7,10,11,15,45,60,-15,41
Forfar,7826,8,11,5,20,40,64,-24,38
Albion,7826,9,9,6,21,58,78,-20,33
Queen's Park,7826,10,7,10,19,41,73,-32,31
Ayr,7827,1,24,4,8,94,43,51,76
Raith,7827,2,22,9,5,68,32,36,75
Alloa,7827,3,17,9,10,56,43,13,60
Arbroath,7827,4,17,8,11,70,50,20,59
Stranraer,7827,5,16,5,15,56,64,-8,53
Airdrieon,7827,6,10,12,14,45,58,-13,42
East Fife,7827,7,13,3,20,47,65,-18,42
Forfar,7827,8,10,6,20,38,64,-26,36
Queen's Park,7827,9,7,10,19,41,72,-31,31
Albion,7827,10,8,6,22,58,82,-24,30
Ayr,7828,1,24,4,8,92,43,49,76
Raith,7828,2,22,9,5,69,33,36,75
Alloa,7828,3,17,9,10,57,44,13,60
Arbroath,7828,4,17,8,11,71,50,21,59
Stranraer,7828,5,15,5,16,55,68,-13,50
East Fife,7828,6,14,3,19,51,64,-13,45
Airdrieon,7828,7,10,12,14,46,59,-13,42
Forfar,7828,8,10,6,20,39,65,-26,36
Queen's Park,7828,9,7,10,19,41,73,-32,31
Albion,7828,10,8,6,22,58,80,-22,30
Raith,7829,1,22,9,5,69,33,36,75
Ayr,7829,2,23,4,9,92,45,47,73
Arbroath,7829,3,18,8,10,72,48,24,62
Alloa,7829,4,17,9,10,57,44,13,60
Stranraer,7829,5,15,5,16,55,68,-13,50
East Fife,7829,6,14,3,19,51,64,-13,45
Airdrieon,7829,7,11,11,14,47,58,-11,44
Forfar,7829,8,10,5,21,38,66,-28,35
Albion,7829,9,9,6,21,60,80,-20,33
Queen's Park,7829,10,6,10,20,39,74,-35,28
Ayr,7830,1,24,4,8,94,44,50,76
Raith,7830,2,22,8,6,68,34,34,74
Alloa,7830,3,18,8,10,58,43,15,62
Arbroath,7830,4,17,8,11,73,52,21,59
Stranraer,7830,5,15,6,15,56,65,-9,51
Airdrieon,7830,6,11,11,14,49,60,-11,44
East Fife,7830,7,13,4,19,48,65,-17,43
Forfar,7830,8,10,5,21,40,68,-28,35
Queen's Park,7830,9,7,10,19,43,75,-32,31
Albion,7830,10,8,6,22,59,82,-23,30
Raith,7831,1,23,8,5,71,32,39,77
Ayr,7831,2,24,4,8,96,43,53,76
Arbroath,7831,3,18,8,10,76,49,27,62
Alloa,7831,4,17,8,11,56,46,10,59
Stranraer,7831,5,15,6,15,55,64,-9,51
Airdrieon,7831,6,11,11,14,48,60,-12,44
East Fife,7831,7,13,4,19,47,64,-17,43
Forfar,7831,8,10,5,21,40,67,-27,35
Albion,7831,9,8,6,22,58,84,-26,30
Queen's Park,7831,10,6,10,20,40,78,-38,28
Raith,7832,1,23,8,5,69,32,37,77
Ayr,7832,2,23,5,8,94,46,48,74
Arbroath,7832,3,18,8,10,71,48,23,62
Alloa,7832,4,17,8,11,56,44,12,59
Stranraer,7832,5,15,6,15,57,66,-9,51
Airdrieon,7832,6,11,11,14,47,59,-12,44
East Fife,7832,7,13,4,19,49,66,-17,43
Forfar,7832,8,10,5,21,39,66,-27,35
Albion,7832,9,8,7,21,61,82,-21,31
Queen's Park,7832,10,6,10,20,39,73,-34,28
Raith,7833,1,23,8,5,71,33,38,77
Ayr,7833,2,24,4,8,94,42,52,76
Arbroath,7833,3,18,8,10,74,49,25,62
Alloa,7833,4,17,8,11,57,46,11,59
Stranraer,7833,5,16,5,15,57,65,-8,53
Airdrieon,7833,6,11,11,14,48,60,-12,44
East Fife,7833,7,13,3,20,48,66,-18,42
Forfar,7833,8,10,5,21,40,67,-27,35
Albion,7833,9,8,6,22,57,82,-25,30
Queen's Park,7833,10,6,10,20,40,76,-36,28
Ayr,7834,1,24,4,8,96,44,52,76
Raith,7834,2,22,8,6,68,33,35,74
Alloa,7834,3,18,8,10,57,43,14,62
Arbroath,7834,4,17,9,10,70,48,22,60
Stranraer,7834,5,15,5,16,56,67,-11,50
East Fife,7834,6,14,3,19,50,65,-15,45
Airdrieon,7834,7,10,12,14,45,58,-13,42
Forfar,7834,8,10,6,20,38,64,-26,36
Albion,7834,9,8,6,22,59,84,-25,30
Queen's Park,7834,10,6,11,19,39,72,-33,29
Ayr,7835,1,23,5,8,91,43,48,74
Raith,7835,2,22,8,6,69,34,35,74
Arbroath,7835,3,18,8,10,72,48,24,62
Alloa,7835,4,18,8,10,58,44,14,62
Stranraer,7835,5,15,5,16,55,65,-10,50
East Fife,7835,6,14,3,19,48,64,-16,45
Airdrieon,7835,7,10,12,14,46,59,-13,42
Forfar,7835,8,10,6,20,39,65,-26,36
Albion,7835,9,8,7,21,58,79,-21,31
Queen's Park,7835,10,6,10,20,39,74,-35,28
Raith,7836,1,23,8,5,69,32,37,77
Ayr,7836,2,23,4,9,93,46,47,73
Arbroath,7836,3,18,8,10,74,51,23,62
Alloa,7836,4,17,8,11,56,44,12,59
Stranraer,7836,5,15,5,16,58,68,-10,50
East Fife,7836,6,14,3,19,51,67,-16,45
Airdrieon,7836,7,11,11,14,47,59,-12,44
Forfar,7836,8,10,5,21,39,66,-27,35
Albion,7836,9,9,6,21,61,81,-20,33
Queen's Park,7836,10,6,10,20,42,76,-34,28
Raith,7837,1,23,8,5,70,33,37,77
Ayr,7837,2,24,4,8,97,43,54,76
Arbroath,7837,3,18,8,10,73,50,23,62
Alloa,7837,4,17,8,11,57,45,12,59
Stranraer,7837,5,16,5,15,58,65,-7,53
Airdrieon,7837,6,11,11,14,48,59,-11,44
East Fife,7837,7,13,3,20,48,67,-19,42
Forfar,7837,8,10,5,21,39,67,-28,35
Albion,7837,9,8,6,22,58,85,-27,30
Queen's Park,7837,10,6,10,20,41,75,-34,28
Raith,7838,1,23,8,5,70,33,37,77
Ayr,7838,2,24,4,8,96,45,51,76
Arbroath,7838,3,18,8,10,73,48,25,62
Alloa,7838,4,17,8,11,57,45,12,59
Stranraer,7838,5,15,6,15,56,65,-9,51
Airdrieon,7838,6,11,11,14,48,58,-10,44
East Fife,7838,7,13,4,19,48,65,-17,43
Forfar,7838,8,10,5,21,38,67,-29,35
Albion,7838,9,8,6,22,60,84,-24,30
Queen's Park,7838,10,6,10,20,39,75,-36,28
Raith,7839,1,23,8,5,71,32,39,77
Ayr,7839,2,24,4,8,93,43,50,76
Arbroath,7839,3,17,9,10,72,50,22,60
Alloa,7839,4,17,8,11,56,46,10,59
Stranraer,7839,5,16,5,15,58,66,-8,53
East Fife,7839,6,13,3,20,49,67,-18,42
Airdrieon,7839,7,10,11,15,45,61,-16,41
Forfar,7839,8,11,5,20,41,64,-23,38
Albion,7839,9,8,6,22,58,81,-23,30
Queen's Park,7839,10,6,11,19,41,74,-33,29
Raith,7840,1,23,8,5,73,32,41,77
Ayr,7840,2,24,4,8,92,43,49,76
Arbroath,7840,3,18,8,10,72,49,23,62
Alloa,7840,4,17,8,11,56,48,8,59
Stranraer,7840,5,15,6,15,57,66,-9,51
Airdrieon,7840,6,11,11,14,47,59,-12,44
East Fife,7840,7,13,4,19,49,66,-17,43
Forfar,7840,8,10,5,21,39,66,-27,35
Albion,7840,9,8,6,22,58,80,-22,30
Queen's Park,7840,10,6,10,20,40,74,-34,28
Ayr,7841,1,23,5,8,92,44,48,74
Raith,7841,2,22,8,6,69,36,33,74
Arbroath,7841,3,18,8,10,73,50,23,62
Alloa,7841,4,18,8,10,60,44,16,62
Stranraer,7841,5,16,5,15,59,65,-6,53
Airdrieon,7841,6,11,11,14,48,59,-11,44
East Fife,7841,7,13,3,20,48,68,-20,42
Forfar,7841,8,10,5,21,39,67,-28,35
Albion,7841,9,8,7,21,59,80,-21,31
Queen's Park,7841,10,6,10,20,41,75,-34,28
Raith,7842,1,23,8,5,70,33,37,77
Ayr,7842,2,24,4,8,95,44,51,76
Arbroath,7842,3,17,9,10,71,49,22,60
Alloa,7842,4,17,8,11,57,45,12,59
Stranraer,7842,5,15,6,15,56,65,-9,51
Airdrieon,7842,6,11,11,14,48,58,-10,44
East Fife,7842,7,13,4,19,48,65,-17,43
Forfar,7842,8,10,5,21,38,67,-29,35
Albion,7842,9,8,6,22,59,83,-24,30
Queen's Park,7842,10,6,11,19,40,73,-33,29
Raith,7843,1,22,9,5,68,32,36,75
Ayr,7843,2,23,5,8,93,45,48,74
Arbroath,7843,3,18,8,10,73,49,24,62
Alloa,7843,4,17,9,10,56,43,13,60
Stranraer,7843,5,15,5,16,55,67,-12,50
East Fife,7843,6,14,3,19,50,64,-14,45
Airdrieon,7843,7,10,12,14,46,59,-13,42
Forfar,7843,8,10,6,20,39,65,-26,36
Albion,7843,9,8,7,21,60,81,-21,31
Queen's Park,7843,10,6,10,20,40,75,-35,28
Ayr,7844,1,24,4,8,94,42,52,76
Raith,7844,2,22,8,6,68,34,34,74
Alloa,7844,3,18,8,10,58,43,15,62
Arbroath,7844,4,17,8,11,70,49,21,59
Stranraer,7844,5,16,5,15,58,66,-8,53
Airdrieon,7844,6,11,11,14,46,58,-12,44
East Fife,7844,7,13,3,20,49,67,-18,42
Forfar,7844,8,10,5,21,38,65,-27,35
Queen's Park,7844,9,7,10,19,40,72,-32,31
Albion,7844,10,8,6,22,57,82,-25,30
Raith,7845,1,22,8,6,68,33,35,74
Ayr,7845,2,23,4,9,90,43,47,73
Arbroath,7845,3,18,8,10,72,49,23,62
Alloa,7845,4,18,8,10,57,43,14,62
Stranraer,7845,5,16,5,15,56,64,-8,53
East Fife,7845,6,13,3,20,47,65,-18,42
Airdrieon,7845,7,10,11,15,47,61,-14,41
Forfar,7845,8,11,5,20,41,66,-25,38
Albion,7845,9,9,6,21,58,78,-20,33
Queen's Park,7845,10,6,10,20,40,74,-34,28
Ayr,7846,1,24,4,8,94,42,52,76
Raith,7846,2,22,9,5,70,34,36,75
Arbroath,7846,3,18,8,10,71,48,23,62
Alloa,7846,4,17,9,10,58,45,13,60
Stranraer,7846,5,15,6,15,56,65,-9,51
East Fife,7846,6,13,4,19,48,65,-17,43
Airdrieon,7846,7,10,12,14,46,59,-13,42
Forfar,7846,8,10,6,20,39,65,-26,36
Albion,7846,9,8,6,22,57,82,-25,30
Queen's Park,7846,10,6,10,20,39,73,-34,28
Raith,7847,1,23,8,5,70,33,37,77
Ayr,7847,2,23,5,8,93,45,48,74
Arbroath,7847,3,18,8,10,76,50,26,62
Alloa,7847,4,17,8,11,57,45,12,59
Stranraer,7847,5,15,6,15,57,66,-9,51
East Fife,7847,6,13,4,19,49,66,-17,43
Airdrieon,7847,7,10,12,14,45,58,-13,42
Forfar,7847,8,10,6,20,38,64,-26,36
Albion,7847,9,8,7,21,60,81,-21,31
Queen's Park,7847,10,6,10,20,41,78,-37,28
Raith,7848,1,23,8,5,69,32,37,77
Ayr,7848,2,24,4,8,93,43,50,76
Arbroath,7848,3,18,8,10,73,49,24,62
Alloa,7848,4,17,8,11,56,44,12,59
Stranraer,7848,5,15,6,15,56,65,-9,51
East Fife,7848,6,13,4,19,48,65,-17,43
Airdrieon,7848,7,10,11,15,45,59,-14,41
Forfar,7848,8,11,5,20,39,64,-25,38
Albion,7848,9,8,6,22,58,81,-23,30
Queen's Park,7848,10,6,10,20,40,75,-35,28
Raith,7849,1,22,8,6,69,34,35,74
Ayr,7849,2,23,4,9,91,44,47,73
Arbroath,7849,3,18,8,10,71,48,23,62
Alloa,7849,4,18,8,10,58,44,14,62
Stranraer,7849,5,15,5,16,55,68,-13,50
East Fife,7849,6,14,3,19,51,64,-13,45
Airdrieon,7849,7,11,11,14,49,59,-10,44
Forfar,7849,8,10,5,21,39,68,-29,35
Albion,7849,9,9,6,21,59,79,-20,33
Queen's Park,7849,10,6,10,20,39,73,-34,28
Raith,7850,1,23,8,5,71,34,37,77
Ayr,7850,2,24,4,8,93,44,49,76
Arbroath,7850,3,17,8,11,70,49,21,59
Alloa,7850,4,17,8,11,58,46,12,59
Stranraer,7850,5,16,5,15,58,66,-8,53
East Fife,7850,6,13,3,20,49,67,-18,42
Airdrieon,7850,7,10,11,15,45,59,-14,41
Forfar,7850,8,11,5,20,39,64,-25,38
Queen's Park,7850,9,7,10,19,40,72,-32,31
Albion,7850,10,8,6,22,59,81,-22,30
Raith,7851,1,23,8,5,72,32,40,77
Ayr,7851,2,23,4,9,91,44,47,73
Arbroath,7851,3,18,8,10,72,48,24,62
Alloa,7851,4,17,8,11,56,47,9,59
Stranraer,7851,5,15,5,16,58,68,-10,50
East Fife,7851,6,14,3,19,51,67,-16,45
Airdrieon,7851,7,11,11,14,50,58,-8,44
Forfar,7851,8,10,5,21,38,69,-31,35
Albion,7851,9,9,6,21,59,79,-20,33
Queen's Park,7851,10,6,10,20,39,74,-35,28
Raith,7852,1,22,9,5,68,32,36,75
Ayr,7852,2,23,5,8,93,45,48,74
Arbroath,7852,3,18,8,10,74,51,23,62
Alloa,7852,4,17,9,10,56,43,13,60
Stranraer,7852,5,15,6,15,56,65,-9,51
East Fife,7852,6,13,4,19,48,65,-17,43
Airdrieon,7852,7,10,11,15,46,60,-14,41
Forfar,7852,8,11,5,20,40,65,-25,38
Albion,7852,9,8,7,21,60,81,-21,31
Queen's Park,7852,10,6,10,20,42,76,-34,28
Ayr,7853,1,24,4,8,95,43,52,76
Raith,7853,2,22,8,6,68,33,35,74
Arbroath,7853,3,18,8,10,73,48,25,62
Alloa,7853,4,18,8,10,57,43,14,62
Stranraer,7853,5,15,5,16,56,66,-10,50
East Fife,7853,6,14,3,19,49,65,-16,45
Airdrieon,7853,7,10,12,14,47,60,-13,42
Forfar,7853,8,10,6,20,40,66,-26,36
Albion,7853,9,8,6,22,58,83,-25,30
Queen's Park,7853,10,6,10,20,39,75,-36,28
Raith,7854,1,23,8,5,73,34,39,77
Ayr,7854,2,23,5,8,94,46,48,74
Arbroath,7854,3,18,8,10,73,49,24,62
Alloa,7854,4,17,8,11,58,48,10,59
Stranraer,7854,5,15,6,15,56,65,-9,51
East Fife,7854,6,13,4,19,48,65,-17,43
Airdrieon,7854,7,10,12,14,45,58,-13,42
Forfar,7854,8,10,6,20,38,64,-26,36
Albion,7854,9,8,7,21,61,82,-21,31
Queen's Park,7854,10,6,10,20,40,75,-35,28
Ayr,7855,1,24,4,8,92,43,49,76
Raith,7855,2,22,9,5,69,33,36,75
Arbroath,7855,3,18,8,10,72,49,23,62
Alloa,7855,4,17,9,10,57,44,13,60
Stranraer,7855,5,15,5,16,55,65,-10,50
East Fife,7855,6,14,3,19,48,64,-16,45
Airdrieon,7855,7,10,12,14,45,58,-13,42
Forfar,7855,8,10,6,20,38,64,-26,36
Albion,7855,9,8,6,22,58,80,-22,30
Queen's Park,7855,10,6,10,20,40,74,-34,28
Raith,7856,1,22,9,5,69,33,36,75
Ayr,7856,2,23,5,8,92,44,48,74
Arbroath,7856,3,17,9,10,71,49,22,60
Alloa,7856,4,17,9,10,57,44,13,60
Stranraer,7856,5,15,5,16,57,67,-10,50
East Fife,7856,6,14,3,19,50,66,-16,45
Airdrieon,7856,7,10,12,14,46,59,-13,42
Forfar,7856,8,10,6,20,39,65,-26,36
Albion,7856,9,8,7,21,59,80,-21,31
Queen's Park,7856,10,6,11,19,40,73,-33,29
Ayr,7857,1,24,4,8,95,45,50,76
Raith,7857,2,22,8,6,68,34,34,74
Arbroath,7857,3,18,8,10,72,48,24,62
Alloa,7857,4,18,8,10,58,43,15,62
Stranraer,7857,5,15,5,16,56,66,-10,50
East Fife,7857,6,14,3,19,49,65,-16,45
Airdrieon,7857,7,11,11,14,46,58,-12,44
Forfar,7857,8,10,5,21,38,65,-27,35
Albion,7857,9,8,6,22,60,83,-23,30
Queen's Park,7857,10,6,10,20,39,74,-35,28
Raith,7858,1,23,8,5,69,32,37,77
Ayr,7858,2,24,4,8,93,42,51,76
Arbroath,7858,3,17,8,11,70,50,20,59
Alloa,7858,4,17,8,11,56,44,12,59
Stranraer,7858,5,15,5,16,55,65,-10,50
East Fife,7858,6,14,3,19,48,64,-16,45
Airdrieon,7858,7,10,11,15,45,59,-14,41
Forfar,7858,8,11,5,20,39,64,-25,38
Queen's Park,7858,9,7,10,19,41,72,-31,31
Albion,7858,10,8,6,22,57,81,-24,30
Raith,7859,1,23,8,5,70,32,38,77
Ayr,7859,2,24,4,8,92,43,49,76
Arbroath,7859,3,17,8,11,71,51,20,59
Alloa,7859,4,17,8,11,56,45,11,59
Stranraer,7859,5,15,5,16,55,65,-10,50
East Fife,7859,6,14,3,19,48,64,-16,45
Airdrieon,7859,7,10,12,14,48,61,-13,42
Forfar,7859,8,10,6,20,41,67,-26,36
Queen's Park,7859,9,7,10,19,42,73,-31,31
Albion,7859,10,8,6,22,58,80,-22,30
Ayr,7860,1,24,4,8,96,42,54,76
Raith,7860,2,22,9,5,70,34,36,75
Arbroath,7860,3,18,8,10,72,48,24,62
Alloa,7860,4,17,9,10,58,45,13,60
Stranraer,7860,5,15,5,16,56,66,-10,50
East Fife,7860,6,14,3,19,49,65,-16,45
Airdrieon,7860,7,10,12,14,48,61,-13,42
Forfar,7860,8,10,6,20,41,67,-26,36
Albion,7860,9,8,6,22,57,84,-27,30
Queen's Park,7860,10,6,10,20,39,74,-35,28
Ayr,7861,1,24,4,8,96,43,53,76
Raith,7861,2,22,8,6,69,34,35,74
Alloa,7861,3,18,8,10,58,44,14,62
Arbroath,7861,4,17,9,10,72,50,22,60
Stranraer,7861,5,15,5,16,56,67,-11,50
East Fife,7861,6,14,3,19,50,65,-15,45
Airdrieon,7861,7,10,11,15,45,59,-14,41
Forfar,7861,8,11,5,20,39,64,-25,38
Albion,7861,9,8,6,22,58,84,-26,30
Queen's Park,7861,10,6,11,19,41,74,-33,29
Ayr,7862,1,24,4,8,93,43,50,76
Raith,7862,2,22,9,5,70,34,36,75
Arbroath,7862,3,17,9,10,70,48,22,60
Alloa,7862,4,17,9,10,58,45,13,60
Stranraer,7862,5,16,5,15,56,64,-8,53
East Fife,7862,6,13,3,20,47,65,-18,42
Airdrieon,7862,7,10,11,15,45,60,-15,41
Forfar,7862,8,11,5,20,40,64,-24,38
Albion,7862,9,8,6,22,58,81,-23,30
Queen's Park,7862,10,6,11,19,39,72,-33,29
Raith,7863,1,23,8,5,69,32,37,77
Ayr,7863,2,24,4,8,94,43,51,76
Arbroath,7863,3,18,8,10,72,49,23,62
Alloa,7863,4,17,8,11,56,44,12,59
Stranraer,7863,5,16,5,15,58,65,-7,53
Airdrieon,7863,6,11,11,14,46,58,-12,44
East Fife,7863,7,13,3,20,48,67,-19,42
Forfar,7863,8,10,5,21,38,65,-27,35
Albion,7863,9,8,6,22,58,82,-24,30
Queen's Park,7863,10,6,10,20,40,74,-34,28
Ayr,7864,1,24,4,8,94,42,52,76
Raith,7864,2,22,9,5,69,33,36,75
Arbroath,7864,3,18,8,10,72,49,23,62
Alloa,7864,4,17,9,10,57,44,13,60
Stranraer,7864,5,15,6,15,55,64,-9,51
Airdrieon,7864,6,11,11,14,48,59,-11,44
East Fife,7864,7,13,4,19,47,64,-17,43
Forfar,7864,8,10,5,21,39,67,-28,35
Albion,7864,9,8,6,22,57,82,-25,30
Queen's Park,7864,10,6,10,20,40,74,-34,28
Raith,7865,1,23,8,5,69,32,37,77
Ayr,7865,2,24,4,8,92,43,49,76
Arbroath,7865,3,18,8,10,72,48,24,62
Alloa,7865,4,17,8,11,56,44,12,59
Stranraer,7865,5,15,5,16,55,67,-12,50
East Fife,7865,6,14,3,19,50,64,-14,45
Airdrieon,7865,7,11,11,14,49,59,-10,44
Forfar,7865,8,10,5,21,39,68,-29,35
Albion,7865,9,8,6,22,58,80,-22,30
Queen's Park,7865,10,6,10,20,39,74,-35,28
Raith,7866,1,23,8,5,71,32,39,77
Ayr,7866,2,24,4,8,92,43,49,76
Arbroath,7866,3,17,9,10,71,49,22,60
Alloa,7866,4,17,8,11,56,46,10,59
Stranraer,7866,5,15,6,15,57,66,-9,51
Airdrieon,7866,6,11,11,14,47,59,-12,44
East Fife,7866,7,13,4,19,49,66,-17,43
Forfar,7866,8,10,5,21,39,66,-27,35
Albion,7866,9,8,6,22,58,80,-22,30
Queen's Park,7866,10,6,11,19,40,73,-33,29
Raith,7867,1,23,8,5,71,33,38,77
Ayr,7867,2,24,4,8,92,42,50,76
Arbroath,7867,3,17,9,10,71,49,22,60
Alloa,7867,4,17,8,11,57,46,11,59
Stranraer,7867,5,16,5,15,58,65,-7,53
East Fife,7867,6,13,3,20,48,67,-19,42
Airdrieon,7867,7,10,11,15,45,59,-14,41
Forfar,7867,8,11,5,20,39,64,-25,38
Albion,7867,9,8,6,22,57,80,-23,30
Queen's Park,7867,10,6,11,19,40,73,-33,29
Raith,7868,1,23,8,5,69,32,37,77
Ayr,7868,2,24,4,8,98,43,55,76
Arbroath,7868,3,17,9,10,72,50,22,60
Alloa,7868,4,17,8,11,56,44,12,59
Stranraer,7868,5,16,5,15,56,64,-8,53
East Fife,7868,6,13,3,20,47,65,-18,42
Airdrieon,7868,7,10,11,15,45,59,-14,41
Forfar,7868,8,11,5,20,39,64,-25,38
Albion,7868,9,8,6,22,58,86,-28,30
Queen's Park,7868,10,6,11,19,41,74,-33,29
Raith,7869,1,23,8,5,72,34,38,77
Ayr,7869,2,24,4,8,94,45,49,76
Arbroath,7869,3,17,8,11,71,50,21,59
Alloa,7869,4,17,8,11,58,47,11,59
Stranraer,7869,5,15,5,16,56,67,-11,50
East Fife,7869,6,14,3,19,50,65,-15,45
Airdrieon,7869,7,10,12,14,46,59,-13,42
Forfar,7869,8,10,6,20,39,65,-26,36
Queen's Park,7869,9,7,10,19,41,73,-32,31
Albion,7869,10,8,6,22,60,82,-22,30
Raith,7870,1,23,8,5,70,32,38,77
Ayr,7870,2,24,4,8,91,42,49,76
Arbroath,7870,3,18,8,10,74,51,23,62
Alloa,7870,4,17,8,11,56,45,11,59
Stranraer,7870,5,16,5,15,56,64,-8,53
Airdrieon,7870,6,10,12,14,45,58,-13,42
East Fife,7870,7,13,3,20,47,65,-18,42
Forfar,7870,8,10,6,20,38,64,-26,36
Albion,7870,9,8,6,22,57,79,-22,30
Queen's Park,7870,10,6,10,20,42,76,-34,28
Ayr,7871,1,24,4,8,95,42,53,76
Raith,7871,2,22,8,6,68,33,35,74
Arbroath,7871,3,18,8,10,75,49,26,62
Alloa,7871,4,18,8,10,57,43,14,62
Stranraer,7871,5,16,5,15,58,66,-8,53
East Fife,7871,6,13,3,20,49,67,-18,42
Airdrieon,7871,7,10,11,15,49,63,-14,41
Forfar,7871,8,11,5,20,43,68,-25,38
Albion,7871,9,8,6,22,57,83,-26,30
Queen's Park,7871,10,6,10,20,40,77,-37,28
Raith,7872,1,23,8,5,70,32,38,77
Ayr,7872,2,24,4,8,95,43,52,76
Arbroath,7872,3,17,8,11,70,50,20,59
Alloa,7872,4,17,8,11,56,45,11,59
Stranraer,7872,5,15,6,15,55,64,-9,51
Airdrieon,7872,6,11,11,14,46,58,-12,44
East Fife,7872,7,13,4,19,47,64,-17,43
Forfar,7872,8,10,5,21,38,65,-27,35
Queen's Park,7872,9,7,10,19,41,72,-31,31
Albion,7872,10,8,6,22,58,83,-25,30
Ayr,7873,1,24,4,8,93,43,50,76
Raith,7873,2,22,8,6,68,33,35,74
Alloa,7873,3,18,8,10,57,43,14,62
Arbroath,7873,4,17,8,11,72,51,21,59
Stranraer,7873,5,16,5,15,61,64,-3,53
Airdrieon,7873,6,10,12,14,46,59,-13,42
East Fife,7873,7,13,3,20,47,70,-23,42
Forfar,7873,8,10,6,20,39,65,-26,36
Queen's Park,7873,9,7,10,19,42,74,-32,31
Albion,7873,10,8,6,22,58,81,-23,30
Raith,7874,1,23,8,5,69,32,37,77
Ayr,7874,2,23,5,8,91,43,48,74
Arbroath,7874,3,18,8,10,72,49,23,62
Alloa,7874,4,17,8,11,56,44,12,59
Stranraer,7874,5,15,6,15,57,66,-9,51
Airdrieon,7874,6,11,11,14,48,58,-10,44
East Fife,7874,7,13,4,19,49,66,-17,43
Forfar,7874,8,10,5,21,38,67,-29,35
Albion,7874,9,8,7,21,58,79,-21,31
Queen's Park,7874,10,6,10,20,40,74,-34,28
Raith,7875,1,23,8,5,70,32,38,77
Ayr,7875,2,23,4,9,91,44,47,73
Arbroath,7875,3,17,8,11,71,50,21,59
Alloa,7875,4,17,8,11,56,45,11,59
Stranraer,7875,5,15,5,16,55,67,-12,50
East Fife,7875,6,14,3,19,50,64,-14,45
Airdrieon,7875,7,10,12,14,46,59,-13,42
Forfar,7875,8,10,6,20,39,65,-26,36
Albion,7875,9,9,6,21,59,79,-20,33
Queen's Park,7875,10,7,10,19,41,73,-32,31
Raith,7876,1,23,8,5,71,32,39,77
Ayr,7876,2,24,4,8,94,42,52,76
Arbroath,7876,3,18,8,10,71,48,23,62
Alloa,7876,4,17,8,11,56,46,10,59
Stranraer,7876,5,15,5,16,55,65,-10,50
East Fife,7876,6,14,3,19,48,64,-16,45
Airdrieon,7876,7,10,11,15,46,60,-14,41
Forfar,7876,8,11,5,20,40,65,-25,38
Albion,7876,9,8,6,22,57,82,-25,30
Queen's Park,7876,10,6,10,20,39,73,-34,28
Raith,7877,1,22,9,5,68,32,36,75
Ayr,7877,2,23,4,9,92,45,47,73
Arbroath,7877,3,18,8,10,73,48,25,62
Alloa,7877,4,17,9,10,56,43,13,60
Stranraer,7877,5,15,6,15,58,67,-9,51
Airdrieon,7877,6,11,11,14,49,58,-9,44
East Fife,7877,7,13,4,19,50,67,-17,43
Forfar,7877,8,10,5,21,38,68,-30,35
Albion,7877,9,9,6,21,60,80,-20,33
Queen's Park,7877,10,6,10,20,39,75,-36,28
Raith,7878,1,22,8,6,68,33,35,74
Ayr,7878,2,23,4,9,91,44,47,73
Alloa,7878,3,18,8,10,57,43,14,62
Arbroath,7878,4,17,8,11,70,49,21,59
Stranraer,7878,5,15,6,15,56,65,-9,51
Airdrieon,7878,6,11,11,14,48,58,-10,44
East Fife,7878,7,13,4,19,48,65,-17,43
Forfar,7878,8,10,5,21,38,67,-29,35
Albion,7878,9,9,6,21,59,79,-20,33
Queen's Park,7878,10,7,10,19,40,72,-32,31
Raith,7879,1,23,8,5,73,34,39,77
Ayr,7879,2,24,4,8,93,43,50,76
Arbroath,7879,3,17,8,11,70,51,19,59
Alloa,7879,4,17,8,11,58,48,10,59
Stranraer,7879,5,15,5,16,55,68,-13,50
East Fife,7879,6,14,3,19,51,64,-13,45
Airdrieon,7879,7,11,11,14,49,58,-9,44
Forfar,7879,8,10,5,21,38,68,-30,35
Queen's Park,7879,9,7,10,19,42,72,-30,31
Albion,7879,10,8,6,22,58,81,-23,30
Raith,7880,1,23,8,5,69,32,37,77
Ayr,7880,2,24,4,8,92,43,49,76
Arbroath,7880,3,17,8,11,70,52,18,59
Alloa,7880,4,17,8,11,56,44,12,59
Stranraer,7880,5,16,5,15,57,64,-7,53
Airdrieon,7880,6,11,11,14,47,58,-11,44
East Fife,7880,7,13,3,20,47,66,-19,42
Forfar,7880,8,10,5,21,38,66,-28,35
Queen's Park,7880,9,7,10,19,43,72,-29,31
Albion,7880,10,8,6,22,58,80,-22,30
Ayr,7881,1,24,4,8,94,42,52,76
Raith,7881,2,22,9,5,69,33,36,75
Arbroath,7881,3,17,9,10,71,49,22,60
Alloa,7881,4,17,9,10,57,44,13,60
Stranraer,7881,5,15,6,15,56,65,-9,51
East Fife,7881,6,13,4,19,48,65,-17,43
Airdrieon,7881,7,10,12,14,46,59,-13,42
Forfar,7881,8,10,6,20,39,65,-26,36
Albion,7881,9,8,6,22,57,82,-25,30
Queen's Park,7881,10,6,11,19,40,73,-33,29
Raith,7882,1,23,8,5,69,32,37,77
Ayr,7882,2,24,4,8,92,42,50,76
Arbroath,7882,3,18,8,10,73,50,23,62
Alloa,7882,4,17,8,11,56,44,12,59
Stranraer,7882,5,16,5,15,57,65,-8,53
Airdrieon,7882,6,11,11,14,49,58,-9,44
East Fife,7882,7,13,3,20,48,66,-18,42
Forfar,7882,8,10,5,21,38,68,-30,35
Albion,7882,9,8,6,22,57,80,-23,30
Queen's Park,7882,10,6,10,20,41,75,-34,28
Ayr,7883,1,24,4,8,92,43,49,76
Raith,7883,2,22,8,6,68,33,35,74
Arbroath,7883,3,18,8,10,72,48,24,62
Alloa,7883,4,18,8,10,57,43,14,62
Stranraer,7883,5,15,5,16,55,68,-13,50
East Fife,7883,6,14,3,19,51,64,-13,45
Airdrieon,7883,7,11,11,14,46,58,-12,44
Forfar,7883,8,10,5,21,38,65,-27,35
Albion,7883,9,8,6,22,58,80,-22,30
Queen's Park,7883,10,6,10,20,39,74,-35,28
Raith,7884,1,22,9,5,68,32,36,75
Ayr,7884,2,23,5,8,91,43,48,74
Alloa,7884,3,17,9,10,56,43,13,60
Arbroath,7884,4,17,8,11,72,52,20,59
Stranraer,7884,5,15,6,15,56,65,-9,51
East Fife,7884,6,13,4,19,48,65,-17,43
Airdrieon,7884,7,10,12,14,46,59,-13,42
Forfar,7884,8,10,6,20,39,65,-26,36
Albion,7884,9,8,7,21,58,79,-21,31
Queen's Park,7884,10,7,10,19,43,74,-31,31
Raith,7885,1,23,8,5,72,34,38,77
Ayr,7885,2,24,4,8,93,43,50,76
Arbroath,7885,3,18,8,10,74,50,24,62
Alloa,7885,4,17,8,11,58,47,11,59
Stranraer,7885,5,15,6,15,58,67,-9,51
Airdrieon,7885,6,11,11,14,48,58,-10,44
East Fife,7885,7,13,4,19,50,67,-17,43
Forfar,7885,8,10,5,21,38,67,-29,35
Albion,7885,9,8,6,22,58,81,-23,30
Queen's Park,7885,10,6,10,20,41,76,-35,28
Ayr,7886,1,24,4,8,95,44,51,76
Raith,7886,2,22,9,5,70,34,36,75
Alloa,7886,3,17,9,10,58,45,13,60
Arbroath,7886,4,17,8,11,70,49,21,59
Stranraer,7886,5,15,5,16,55,67,-12,50
East Fife,7886,6,14,3,19,50,64,-14,45
Airdrieon,7886,7,10,12,14,46,59,-13,42
Forfar,7886,8,10,6,20,39,65,-26,36
Queen's Park,7886,9,7,10,19,40,72,-32,31
Albion,7886,10,8,6,22,59,83,-24,30
Raith,7887,1,22,9,5,69,33,36,75
Ayr,7887,2,23,5,8,91,43,48,74
Arbroath,7887,3,17,9,10,71,49,22,60
Alloa,7887,4,17,9,10,57,44,13,60
Stranraer,7887,5,15,5,16,57,69,-12,50
East Fife,7887,6,14,3,19,52,66,-14,45
Airdrieon,7887,7,10,11,15,46,60,-14,41
Forfar,7887,8,11,5,20,40,65,-25,38
Albion,7887,9,8,7,21,58,79,-21,31
Queen's Park,7887,10,6,11,19,40,73,-33,29
Raith,7888,1,23,8,5,69,32,37,77
Ayr,7888,2,24,4,8,94,42,52,76
Arbroath,7888,3,18,8,10,73,49,24,62
Alloa,7888,4,17,8,11,56,44,12,59
Stranraer,7888,5,16,5,15,57,64,-7,53
Airdrieon,7888,6,11,11,14,47,58,-11,44
East Fife,7888,7,13,3,20,47,66,-19,42
Forfar,7888,8,10,5,21,38,66,-28,35
Albion,7888,9,8,6,22,57,82,-25,30
Queen's Park,7888,10,6,10,20,40,75,-35,28
Ayr,7889,1,24,4,8,92,43,49,76
Raith,7889,2,22,8,6,68,33,35,74
Alloa,7889,3,18,8,10,57,43,14,62
Arbroath,7889,4,17,9,10,71,49,22,60
Stranraer,7889,5,16,5,15,56,64,-8,53
Airdrieon,7889,6,10,12,14,46,59,-13,42
East Fife,7889,7,13,3,20,47,65,-18,42
Forfar,7889,8,10,6,20,39,65,-26,36
Albion,7889,9,8,6,22,58,80,-22,30
Queen's Park,7889,10,6,11,19,40,73,-33,29
Ayr,7890,1,24,4,8,94,43,51,76
Raith,7890,2,22,9,5,69,33,36,75
Alloa,7890,3,17,9,10,57,44,13,60
Arbroath,7890,4,17,8,11,72,51,21,59
Stranraer,7890,5,15,5,16,55,65,-10,50
East Fife,7890,6,14,3,19,48,64,-16,45
Airdrieon,7890,7,11,11,14,49,60,-11,44
Forfar,7890,8,10,5,21,40,68,-28,35
Queen's Park,7890,9,7,10,19,42,74,-32,31
Albion,7890,10,8,6,22,58,82,-24,30
Ayr,7891,1,24,4,8,96,44,52,76
Raith,7891,2,22,9,5,70,34,36,75
Arbroath,7891,3,18,8,10,74,50,24,62
Alloa,7891,4,17,9,10,58,45,13,60
Stranraer,7891,5,15,6,15,55,64,-9,51
East Fife,7891,6,13,4,19,47,64,-17,43
Airdrieon,7891,7,10,12,14,47,60,-13,42
Forfar,7891,8,10,6,20,40,66,-26,36
Albion,7891,9,8,6,22,59,84,-25,30
Queen's Park,7891,10,6,10,20,41,76,-35,28
Ayr,7892,1,24,4,8,98,45,53,76
Raith,7892,2,22,8,6,69,36,33,74
Alloa,7892,3,18,8,10,60,44,16,62
Arbroath,7892,4,17,9,10,71,49,22,60
Stranraer,7892,5,16,5,15,57,64,-7,53
East Fife,7892,6,13,3,20,47,66,-19,42
Airdrieon,7892,7,10,11,15,47,61,-14,41
Forfar,7892,8,11,5,20,41,66,-25,38
Albion,7892,9,8,6,22,60,86,-26,30
Queen's Park,7892,10,6,11,19,40,73,-33,29
Raith,7893,1,23,8,5,69,32,37,77
Ayr,7893,2,24,4,8,94,43,51,76
Arbroath,7893,3,18,8,10,72,49,23,62
Alloa,7893,4,17,8,11,56,44,12,59
Stranraer,7893,5,15,5,16,56,66,-10,50
East Fife,7893,6,14,3,19,49,65,-16,45
Airdrieon,7893,7,10,12,14,46,59,-13,42
Forfar,7893,8,10,6,20,39,65,-26,36
Albion,7893,9,8,6,22,58,82,-24,30
Queen's Park,7893,10,6,10,20,40,74,-34,28
Raith,7894,1,23,8,5,72,33,39,77
Ayr,7894,2,24,4,8,95,43,52,76
Arbroath,7894,3,17,8,11,71,51,20,59
Alloa,7894,4,17,8,11,57,47,10,59
Stranraer,7894,5,16,5,15,61,65,-4,53
East Fife,7894,6,13,3,20,48,70,-22,42
Airdrieon,7894,7,10,11,15,46,61,-15,41
Forfar,7894,8,11,5,20,41,65,-24,38
Queen's Park,7894,9,7,10,19,42,73,-31,31
Albion,7894,10,8,6,22,58,83,-25,30
Raith,7895,1,22,8,6,69,34,35,74
Ayr,7895,2,23,4,9,90,44,46,73
Alloa,7895,3,18,8,10,58,44,14,62
Arbroath,7895,4,17,8,11,71,50,21,59
Stranraer,7895,5,15,5,16,55,67,-12,50
East Fife,7895,6,14,3,19,50,64,-14,45
Airdrieon,7895,7,10,11,15,45,59,-14,41
Forfar,7895,8,11,5,20,39,64,-25,38
Albion,7895,9,9,6,21,59,78,-19,33
Queen's Park,7895,10,7,10,19,41,73,-32,31
Raith,7896,1,23,8,5,71,32,39,77
Ayr,7896,2,24,4,8,93,44,49,76
Arbroath,7896,3,17,9,10,70,48,22,60
Alloa,7896,4,17,8,11,56,46,10,59
Stranraer,7896,5,15,6,15,56,65,-9,51
East Fife,7896,6,13,4,19,48,65,-17,43
Airdrieon,7896,7,10,11,15,45,62,-17,41
Forfar,7896,8,11,5,20,42,64,-22,38
Albion,7896,9,8,6,22,59,81,-22,30
Queen's Park,7896,10,6,11,19,39,72,-33,29
Raith,7897,1,22,8,6,68,33,35,74
Ayr,7897,2,23,4,9,91,46,45,73
Arbroath,7897,3,18,8,10,73,50,23,62
Alloa,7897,4,18,8,10,57,43,14,62
Stranraer,7897,5,15,5,16,55,65,-10,50
East Fife,7897,6,14,3,19,48,64,-16,45
Airdrieon,7897,7,10,12,14,48,61,-13,42
Forfar,7897,8,10,6,20,41,67,-26,36
Albion,7897,9,9,6,21,61,79,-18,33
Queen's Park,7897,10,6,10,20,41,75,-34,28
Raith,7898,1,23,8,5,71,33,38,77
Ayr,7898,2,23,5,8,91,43,48,74
Arbroath,7898,3,17,9,10,71,49,22,60
Alloa,7898,4,17,8,11,57,46,11,59
Stranraer,7898,5,15,5,16,56,67,-11,50
East Fife,7898,6,14,3,19,50,65,-15,45
Airdrieon,7898,7,10,12,14,48,61,-13,42
Forfar,7898,8,10,6,20,41,67,-26,36
Albion,7898,9,8,7,21,58,79,-21,31
Queen's Park,7898,10,6,11,19,40,73,-33,29
Ayr,7899,1,24,4,8,95,46,49,76
Raith,7899,2,22,9,5,69,33,36,75
Arbroath,7899,3,17,9,10,70,48,22,60
Alloa,7899,4,17,9,10,57,44,13,60
Stranraer,7899,5,15,5,16,55,66,-11,50
East Fife,7899,6,14,3,19,49,64,-15,45
Airdrieon,7899,7,11,11,14,47,59,-12,44
Forfar,7899,8,10,5,21,39,66,-27,35
Albion,7899,9,8,6,22,61,83,-22,30
Queen's Park,7899,10,6,11,19,39,72,-33,29
Ayr,7900,1,24,4,8,95,43,52,76
Raith,7900,2,22,9,5,68,32,36,75
Arbroath,7900,3,18,8,10,72,49,23,62
Alloa,7900,4,17,9,10,56,43,13,60
Stranraer,7900,5,15,5,16,56,68,-12,50
East Fife,7900,6,14,3,19,51,65,-14,45
Airdrieon,7900,7,11,11,14,47,58,-11,44
Forfar,7900,8,10,5,21,38,66,-28,35
Albion,7900,9,8,6,22,58,83,-25,30
Queen's Park,7900,10,6,10,20,40,74,-34,28
Ayr,7901,1,23,5,8,92,44,48,74
Raith,7901,2,22,8,6,69,34,35,74
Alloa,7901,3,18,8,10,58,44,14,62
Arbroath,7901,4,17,9,10,71,49,22,60
Stranraer,7901,5,16,5,15,59,64,-5,53
East Fife,7901,6,13,3,20,47,68,-21,42
Airdrieon,7901,7,10,11,15,47,61,-14,41
Forfar,7901,8,11,5,20,41,66,-25,38
Albion,7901,9,8,7,21,59,80,-21,31
Queen's Park,7901,10,6,11,19,40,73,-33,29
Ayr,7902,1,24,4,8,93,42,51,76
Raith,7902,2,22,8,6,70,35,35,74
Alloa,7902,3,18,8,10,59,45,14,62
Arbroath,7902,4,17,8,11,71,50,21,59
Stranraer,7902,5,15,5,16,55,65,-10,50
East Fife,7902,6,14,3,19,48,64,-16,45
Airdrieon,7902,7,11,11,14,48,58,-10,44
Forfar,7902,8,10,5,21,38,67,-29,35
Queen's Park,7902,9,7,10,19,41,73,-32,31
Albion,7902,10,8,6,22,57,81,-24,30
Ayr,7903,1,24,4,8,95,43,52,76
Raith,7903,2,22,9,5,69,33,36,75
Arbroath,7903,3,17,9,10,72,50,22,60
Alloa,7903,4,17,9,10,57,44,13,60
Stranraer,7903,5,15,5,16,55,66,-11,50
East Fife,7903,6,14,3,19,49,64,-15,45
Airdrieon,7903,7,10,11,15,45,59,-14,41
Forfar,7903,8,11,5,20,39,64,-25,38
Albion,7903,9,8,6,22,58,83,-25,30
Queen's Park,7903,10,6,11,19,41,74,-33,29
Raith,7904,1,23,8,5,69,32,37,77
Ayr,7904,2,24,4,8,94,45,49,76
Arbroath,7904,3,17,8,11,70,49,21,59
Alloa,7904,4,17,8,11,56,44,12,59
Stranraer,7904,5,15,5,16,55,66,-11,50
East Fife,7904,6,14,3,19,49,64,-15,45
Airdrieon,7904,7,11,11,14,49,60,-11,44
Forfar,7904,8,10,5,21,40,68,-28,35
Queen's Park,7904,9,7,10,19,40,72,-32,31
Albion,7904,10,8,6,22,60,82,-22,30
Ayr,7905,1,24,4,8,93,44,49,76
Raith,7905,2,22,9,5,69,33,36,75
Alloa,7905,3,17,9,10,57,44,13,60
Arbroath,7905,4,17,8,11,71,50,21,59
Stranraer,7905,5,16,5,15,59,64,-5,53
Airdrieon,7905,6,11,11,14,49,59,-10,44
East Fife,7905,7,13,3,20,47,68,-21,42
Forfar,7905,8,10,5,21,39,68,-29,35
Queen's Park,7905,9,7,10,19,41,73,-32,31
Albion,7905,10,8,6,22,59,81,-22,30
Raith,7906,1,23,8,5,71,33,38,77
Ayr,7906,2,24,4,8,93,42,51,76
Arbroath,7906,3,17,8,11,71,50,21,59
Alloa,7906,4,17,8,11,57,46,11,59
Stranraer,7906,5,15,5,16,55,66,-11,50
East Fife,7906,6,14,3,19,49,64,-15,45
Airdrieon,7906,7,11,11,14,48,58,-10,44
Forfar,7906,8,10,5,21,38,67,-29,35
Queen's Park,7906,9,7,10,19,41,73,-32,31
Albion,7906,10,8,6,22,57,81,-24,30
Ayr,7907,1,24,4,8,93,42,51,76
Raith,7907,2,22,9,5,68,32,36,75
Arbroath,7907,3,18,8,10,74,50,24,62
Alloa,7907,4,17,9,10,56,43,13,60
Stranraer,7907,5,15,5,16,55,68,-13,50
East Fife,7907,6,14,3,19,51,64,-13,45
Airdrieon,7907,7,10,11,15,46,61,-15,41
Forfar,7907,8,11,5,20,41,65,-24,38
Albion,7907,9,8,6,22,57,81,-24,30
Queen's Park,7907,10,6,10,20,41,76,-35,28
Raith,7908,1,23,8,5,70,33,37,77
Ayr,7908,2,24,4,8,97,44,53,76
Arbroath,7908,3,18,8,10,73,49,24,62
Alloa,7908,4,17,8,11,57,45,12,59
Stranraer,7908,5,15,5,16,55,66,-11,50
East Fife,7908,6,14,3,19,49,64,-15,45
Airdrieon,7908,7,10,11,15,45,59,-14,41
Forfar,7908,8,11,5,20,39,64,-25,38
Albion,7908,9,8,6,22,59,85,-26,30
Queen's Park,7908,10,6,10,20,40,75,-35,28
Ayr,7909,1,24,4,8,93,42,51,76
Raith,7909,2,22,8,6,69,35,34,74
Arbroath,7909,3,18,8,10,73,50,23,62
Alloa,7909,4,18,8,10,59,44,15,62
Stranraer,7909,5,15,5,16,55,66,-11,50
East Fife,7909,6,14,3,19,49,64,-15,45
Airdrieon,7909,7,11,11,14,46,58,-12,44
Forfar,7909,8,10,5,21,38,65,-27,35
Albion,7909,9,8,6,22,57,81,-24,30
Queen's Park,7909,10,6,10,20,41,75,-34,28
Ayr,7910,1,24,4,8,93,43,50,76
Raith,7910,2,22,9,5,70,34,36,75
Arbroath,7910,3,17,9,10,71,49,22,60
Alloa,7910,4,17,9,10,58,45,13,60
Stranraer,7910,5,15,5,16,56,69,-13,50
East Fife,7910,6,14,3,19,52,65,-13,45
Airdrieon,7910,7,11,11,14,46,58,-12,44
Forfar,7910,8,10,5,21,38,65,-27,35
Albion,7910,9,8,6,22,58,81,-23,30
Queen's Park,7910,10,6,11,19,40,73,-33,29
Ayr,7911,1,24,4,8,92,43,49,76
Raith,7911,2,22,9,5,68,32,36,75
Alloa,7911,3,17,9,10,56,43,13,60
Arbroath,7911,4,17,8,11,71,52,19,59
Stranraer,7911,5,16,5,15,56,64,-8,53
East Fife,7911,6,13,3,20,47,65,-18,42
Airdrieon,7911,7,10,11,15,45,59,-14,41
Forfar,7911,8,11,5,20,39,64,-25,38
Queen's Park,7911,9,7,10,19,43,73,-30,31
Albion,7911,10,8,6,22,58,80,-22,30
Ayr,7912,1,24,4,8,95,44,51,76
Raith,7912,2,22,8,6,68,33,35,74
Arbroath,7912,3,18,8,10,72,49,23,62
Alloa,7912,4,18,8,10,57,43,14,62
Stranraer,7912,5,16,5,15,57,65,-8,53
Airdrieon,7912,6,11,11,14,48,60,-12,44
East Fife,7912,7,13,3,20,48,66,-18,42
Forfar,7912,8,10,5,21,40,67,-27,35
Albion,7912,9,8,6,22,59,83,-24,30
Queen's Park,7912,10,6,10,20,40,74,-34,28
Ayr,7913,1,24,4,8,94,43,51,76
Raith,7913,2,22,9,5,69,33,36,75
Arbroath,7913,3,18,8,10,72,49,23,62
Alloa,7913,4,17,9,10,57,44,13,60
Stranraer,7913,5,15,5,16,56,66,-10,50
East Fife,7913,6,14,3,19,49,65,-16,45
Airdrieon,7913,7,11,11,14,46,58,-12,44
Forfar,7913,8,10,5,21,38,65,-27,35
Albion,7913,9,8,6,22,58,82,-24,30
Queen's Park,7913,10,6,10,20,40,74,-34,28
Raith,7914,1,23,8,5,70,33,37,77
Ayr,7914,2,24,4,8,93,43,50,76
Arbroath,7914,3,17,9,10,71,49,22,60
Alloa,7914,4,17,8,11,57,45,12,59
Stranraer,7914,5,15,6,15,55,64,-9,51
Airdrieon,7914,6,11,11,14,48,60,-12,44
East Fife,7914,7,13,4,19,47,64,-17,43
Forfar,7914,8,10,5,21,40,67,-27,35
Albion,7914,9,8,6,22,58,81,-23,30
Queen's Park,7914,10,6,11,19,40,73,-33,29
Raith,7915,1,23,8,5,69,32,37,77
Ayr,7915,2,23,5,8,91,43,48,74
Arbroath,7915,3,18,8,10,73,48,25,62
Alloa,7915,4,17,8,11,56,44,12,59
Stranraer,7915,5,16,5,15,56,64,-8,53
East Fife,7915,6,13,3,20,47,65,-18,42
Airdrieon,7915,7,10,11,15,46,61,-15,41
Forfar,7915,8,11,5,20,41,65,-24,38
Albion,7915,9,8,7,21,58,79,-21,31
Queen's Park,7915,10,6,10,20,39,75,-36,28
Ayr,7916,1,23,5,8,92,44,48,74
Raith,7916,2,22,8,6,68,34,34,74
Arbroath,7916,3,18,8,10,74,49,25,62
Alloa,7916,4,18,8,10,58,43,15,62
Stranraer,7916,5,16,5,15,58,65,-7,53
East Fife,7916,6,13,3,20,48,67,-19,42
Airdrieon,7916,7,10,11,15,45,59,-14,41
Forfar,7916,8,11,5,20,39,64,-25,38
Albion,7916,9,8,7,21,59,80,-21,31
Queen's Park,7916,10,6,10,20,40,76,-36,28
Raith,7917,1,23,8,5,69,32,37,77
Ayr,7917,2,24,4,8,100,44,56,76
Arbroath,7917,3,17,9,10,72,50,22,60
Alloa,7917,4,17,8,11,56,44,12,59
Stranraer,7917,5,15,5,16,57,70,-13,50
East Fife,7917,6,14,3,19,53,66,-13,45
Airdrieon,7917,7,11,11,14,47,59,-12,44
Forfar,7917,8,10,5,21,39,66,-27,35
Albion,7917,9,8,6,22,59,88,-29,30
Queen's Park,7917,10,6,11,19,41,74,-33,29
Ayr,7918,1,24,4,8,94,43,51,76
Raith,7918,2,22,8,6,68,33,35,74
Alloa,7918,3,18,8,10,57,43,14,62
Arbroath,7918,4,17,8,11,70,49,21,59
Stranraer,7918,5,15,5,16,57,67,-10,50
East Fife,7918,6,14,3,19,50,66,-16,45
Airdrieon,7918,7,11,11,14,46,58,-12,44
Forfar,7918,8,10,5,21,38,65,-27,35
Queen's Park,7918,9,7,10,19,40,72,-32,31
Albion,7918,10,8,6,22,58,82,-24,30
Raith,7919,1,23,8,5,70,32,38,77
Ayr,7919,2,24,4,8,91,42,49,76
Arbroath,7919,3,18,8,10,73,48,25,62
Alloa,7919,4,17,8,11,56,45,11,59
Stranraer,7919,5,15,5,16,55,66,-11,50
East Fife,7919,6,14,3,19,49,64,-15,45
Airdrieon,7919,7,11,11,14,47,58,-11,44
Forfar,7919,8,10,5,21,38,66,-28,35
Albion,7919,9,8,6,22,57,79,-22,30
Queen's Park,7919,10,6,10,20,39,75,-36,28
Ayr,7920,1,24,4,8,95,42,53,76
Raith,7920,2,22,9,5,68,32,36,75
Alloa,7920,3,17,9,10,56,43,13,60
Arbroath,7920,4,17,8,11,70,51,19,59
Stranraer,7920,5,15,5,16,56,67,-11,50
East Fife,7920,6,14,3,19,50,65,-15,45
Airdrieon,7920,7,10,11,15,45,59,-14,41
Forfar,7920,8,11,5,20,39,64,-25,38
Queen's Park,7920,9,7,10,19,42,72,-30,31
Albion,7920,10,8,6,22,57,83,-26,30
Raith,7921,1,23,8,5,70,32,38,77
Ayr,7921,2,24,4,8,95,45,50,76
Arbroath,7921,3,18,8,10,74,49,25,62
Alloa,7921,4,17,8,11,56,45,11,59
Stranraer,7921,5,15,5,16,58,70,-12,50
East Fife,7921,6,14,3,19,53,67,-14,45
Airdrieon,7921,7,11,11,14,47,59,-12,44
Forfar,7921,8,10,5,21,39,66,-27,35
Albion,7921,9,8,6,22,60,83,-23,30
Queen's Park,7921,10,6,10,20,40,76,-36,28
Ayr,7922,1,23,5,8,94,46,48,74
Raith,7922,2,22,8,6,68,33,35,74
Arbroath,7922,3,18,8,10,73,48,25,62
Alloa,7922,4,18,8,10,57,43,14,62
Stranraer,7922,5,16,5,15,59,66,-7,53
Airdrieon,7922,6,11,11,14,48,58,-10,44
East Fife,7922,7,13,3,20,49,68,-19,42
Forfar,7922,8,10,5,21,38,67,-29,35
Albion,7922,9,8,7,21,61,82,-21,31
Queen's Park,7922,10,6,10,20,39,75,-36,28
Raith,7923,1,23,8,5,72,32,40,77
Ayr,7923,2,24,4,8,95,43,52,76
Arbroath,7923,3,18,8,10,72,48,24,62
Alloa,7923,4,17,8,11,56,47,9,59
Stranraer,7923,5,15,5,16,55,65,-10,50
East Fife,7923,6,14,3,19,48,64,-16,45
Airdrieon,7923,7,11,11,14,46,58,-12,44
Forfar,7923,8,10,5,21,38,65,-27,35
Albion,7923,9,8,6,22,58,83,-25,30
Queen's Park,7923,10,6,10,20,39,74,-35,28
Raith,7924,1,23,8,5,69,32,37,77
Ayr,7924,2,24,4,8,96,43,53,76
Arbroath,7924,3,17,9,10,72,50,22,60
Alloa,7924,4,17,8,11,56,44,12,59
Stranraer,7924,5,16,5,15,58,66,-8,53
Airdrieon,7924,6,10,12,14,46,59,-13,42
East Fife,7924,7,13,3,20,49,67,-18,42
Forfar,7924,8,10,6,20,39,65,-26,36
Albion,7924,9,8,6,22,58,84,-26,30
Queen's Park,7924,10,6,11,19,41,74,-33,29
Raith,7925,1,23,8,5,70,32,38,77
Ayr,7925,2,24,4,8,94,44,50,76
Arbroath,7925,3,17,9,10,71,49,22,60
Alloa,7925,4,17,8,11,56,45,11,59
Stranraer,7925,5,15,5,16,56,66,-10,50
East Fife,7925,6,14,3,19,49,65,-16,45
Airdrieon,7925,7,10,12,14,46,59,-13,42
Forfar,7925,8,10,6,20,39,65,-26,36
Albion,7925,9,8,6,22,59,82,-23,30
Queen's Park,7925,10,6,11,19,40,73,-33,29
Ayr,7926,1,24,4,8,95,43,52,76
Raith,7926,2,22,9,5,69,33,36,75
Arbroath,7926,3,17,9,10,72,50,22,60
Alloa,7926,4,17,9,10,57,44,13,60
Stranraer,7926,5,15,5,16,56,67,-11,50
East Fife,7926,6,14,3,19,50,65,-15,45
Airdrieon,7926,7,11,11,14,46,58,-12,44
Forfar,7926,8,10,5,21,38,65,-27,35
Albion,7926,9,8,6,22,58,83,-25,30
Queen's Park,7926,10,6,11,19,41,74,-33,29
Raith,7927,1,23,8,5,72,33,39,77
Ayr,7927,2,24,4,8,93,43,50,76
Arbroath,7927,3,18,8,10,73,48,25,62
Alloa,7927,4,17,8,11,57,47,10,59
Stranraer,7927,5,15,5,16,56,66,-10,50
East Fife,7927,6,14,3,19,49,65,-16,45
Airdrieon,7927,7,10,12,14,46,59,-13,42
Forfar,7927,8,10,6,20,39,65,-26,36
Albion,7927,9,8,6,22,58,81,-23,30
Queen's Park,7927,10,6,10,20,39,75,-36,28
Raith,7928,1,23,8,5,69,32,37,77
Ayr,7928,2,24,4,8,93,43,50,76
Arbroath,7928,3,18,8,10,73,49,24,62
Alloa,7928,4,17,8,11,56,44,12,59
Stranraer,7928,5,16,5,15,57,64,-7,53
East Fife,7928,6,13,3,20,47,66,-19,42
Airdrieon,7928,7,10,11,15,46,61,-15,41
Forfar,7928,8,11,5,20,41,65,-24,38
Albion,7928,9,8,6,22,58,81,-23,30
Queen's Park,7928,10,6,10,20,40,75,-35,28
Raith,7929,1,23,8,5,72,32,40,77
Ayr,7929,2,24,4,8,97,43,54,76
Arbroath,7929,3,17,9,10,71,49,22,60
Alloa,7929,4,17,8,11,56,47,9,59
Stranraer,7929,5,15,6,15,57,66,-9,51
Airdrieon,7929,6,11,11,14,48,58,-10,44
East Fife,7929,7,13,4,19,49,66,-17,43
Forfar,7929,8,10,5,21,38,67,-29,35
Albion,7929,9,8,6,22,58,85,-27,30
Queen's Park,7929,10,6,11,19,40,73,-33,29
Ayr,7930,1,24,4,8,97,45,52,76
Raith,7930,2,22,8,6,69,34,35,74
Arbroath,7930,3,18,8,10,73,49,24,62
Alloa,7930,4,18,8,10,58,44,14,62
Stranraer,7930,5,15,5,16,58,68,-10,50
East Fife,7930,6,14,3,19,51,67,-16,45
Airdrieon,7930,7,10,12,14,45,58,-13,42
Forfar,7930,8,10,6,20,38,64,-26,36
Albion,7930,9,8,6,22,60,85,-25,30
Queen's Park,7930,10,6,10,20,40,75,-35,28
Ayr,7931,1,24,4,8,96,42,54,76
Raith,7931,2,22,9,5,70,34,36,75
Arbroath,7931,3,17,9,10,71,49,22,60
Alloa,7931,4,17,9,10,58,45,13,60
Stranraer,7931,5,16,5,15,57,65,-8,53
Airdrieon,7931,6,11,11,14,47,59,-12,44
East Fife,7931,7,13,3,20,48,66,-18,42
Forfar,7931,8,10,5,21,39,66,-27,35
Albion,7931,9,8,6,22,57,84,-27,30
Queen's Park,7931,10,6,11,19,40,73,-33,29
Raith,7932,1,23,8,5,70,32,38,77
Ayr,7932,2,24,4,8,93,43,50,76
Arbroath,7932,3,17,9,10,71,49,22,60
Alloa,7932,4,17,8,11,56,45,11,59
Stranraer,7932,5,15,6,15,55,64,-9,51
East Fife,7932,6,13,4,19,47,64,-17,43
Airdrieon,7932,7,10,12,14,46,59,-13,42
Forfar,7932,8,10,6,20,39,65,-26,36
Albion,7932,9,8,6,22,58,81,-23,30
Queen's Park,7932,10,6,11,19,40,73,-33,29
Ayr,7933,1,24,4,8,93,42,51,76
Raith,7933,2,22,8,6,70,36,34,74
Alloa,7933,3,18,8,10,60,45,15,62
Arbroath,7933,4,17,8,11,70,51,19,59
Stranraer,7933,5,15,5,16,55,65,-10,50
East Fife,7933,6,14,3,19,48,64,-16,45
Airdrieon,7933,7,11,11,14,48,60,-12,44
Forfar,7933,8,10,5,21,40,67,-27,35
Queen's Park,7933,9,7,10,19,42,72,-30,31
Albion,7933,10,8,6,22,57,81,-24,30
Raith,7934,1,23,8,5,71,33,38,77
Ayr,7934,2,23,5,8,93,45,48,74
Arbroath,7934,3,18,8,10,73,49,24,62
Alloa,7934,4,17,8,11,57,46,11,59
Stranraer,7934,5,15,6,15,56,65,-9,51
Airdrieon,7934,6,11,11,14,47,58,-11,44
East Fife,7934,7,13,4,19,48,65,-17,43
Forfar,7934,8,10,5,21,38,66,-28,35
Albion,7934,9,8,7,21,60,81,-21,31
Queen's Park,7934,10,6,10,20,40,75,-35,28
Ayr,7935,1,24,4,8,93,43,50,76
Raith,7935,2,22,8,6,68,36,32,74
Alloa,7935,3,18,8,10,60,43,17,62
Arbroath,7935,4,17,8,11,71,51,20,59
Stranraer,7935,5,15,6,15,55,64,-9,51
Airdrieon,7935,6,11,11,14,47,58,-11,44
East Fife,7935,7,13,4,19,47,64,-17,43
Forfar,7935,8,10,5,21,38,66,-28,35
Queen's Park,7935,9,7,10,19,42,73,-31,31
Albion,7935,10,8,6,22,58,81,-23,30
Raith,7936,1,23,8,5,70,32,38,77
Ayr,7936,2,24,4,8,93,43,50,76
Arbroath,7936,3,17,8,11,70,49,21,59
Alloa,7936,4,17,8,11,56,45,11,59
Stranraer,7936,5,15,5,16,55,65,-10,50
East Fife,7936,6,14,3,19,48,64,-16,45
Airdrieon,7936,7,11,11,14,46,58,-12,44
Forfar,7936,8,10,5,21,38,65,-27,35
Queen's Park,7936,9,7,10,19,40,72,-32,31
Albion,7936,10,8,6,22,58,81,-23,30
Ayr,7937,1,24,4,8,91,42,49,76
Raith,7937,2,22,9,5,70,34,36,75
Alloa,7937,3,17,9,10,58,45,13,60
Arbroath,7937,4,17,8,11,70,49,21,59
Stranraer,7937,5,15,5,16,57,67,-10,50
East Fife,7937,6,14,3,19,50,66,-16,45
Airdrieon,7937,7,10,12,14,46,59,-13,42
Forfar,7937,8,10,6,20,39,65,-26,36
Queen's Park,7937,9,7,10,19,40,72,-32,31
Albion,7937,10,8,6,22,57,79,-22,30
Raith,7938,1,23,8,5,71,34,37,77
Ayr,7938,2,24,4,8,93,44,49,76
Arbroath,7938,3,18,8,10,71,48,23,62
Alloa,7938,4,17,8,11,58,46,12,59
Stranraer,7938,5,16,5,15,60,65,-5,53
Airdrieon,7938,6,10,12,14,46,59,-13,42
East Fife,7938,7,13,3,20,48,69,-21,42
Forfar,7938,8,10,6,20,39,65,-26,36
Albion,7938,9,8,6,22,59,81,-22,30
Queen's Park,7938,10,6,10,20,39,73,-34,28
Raith,7939,1,23,8,5,70,33,37,77
Ayr,7939,2,24,4,8,94,42,52,76
Arbroath,7939,3,18,8,10,74,48,26,62
Alloa,7939,4,17,8,11,57,45,12,59
Stranraer,7939,5,16,5,15,57,64,-7,53
Airdrieon,7939,6,10,12,14,47,60,-13,42
East Fife,7939,7,13,3,20,47,66,-19,42
Forfar,7939,8,10,6,20,40,66,-26,36
Albion,7939,9,8,6,22,57,82,-25,30
Queen's Park,7939,10,6,10,20,39,76,-37,28
Ayr,7940,1,24,4,8,96,43,53,76
Raith,7940,2,22,9,5,68,32,36,75
Arbroath,7940,3,18,8,10,72,49,23,62
Alloa,7940,4,17,9,10,56,43,13,60
Stranraer,7940,5,16,5,15,58,65,-7,53
East Fife,7940,6,13,3,20,48,67,-19,42
Airdrieon,7940,7,10,11,15,48,62,-14,41
Forfar,7940,8,11,5,20,42,67,-25,38
Albion,7940,9,8,6,22,58,84,-26,30
Queen's Park,7940,10,6,10,20,40,74,-34,28
Ayr,7941,1,24,4,8,96,43,53,76
Raith,7941,2,22,9,5,69,33,36,75
Arbroath,7941,3,18,8,10,73,49,24,62
Alloa,7941,4,17,9,10,57,44,13,60
Stranraer,7941,5,15,5,16,56,66,-10,50
East Fife,7941,6,14,3,19,49,65,-16,45
Airdrieon,7941,7,11,11,14,49,61,-12,44
Forfar,7941,8,10,5,21,41,68,-27,35
Albion,7941,9,8,6,22,58,84,-26,30
Queen's Park,7941,10,6,10,20,40,75,-35,28
Raith,7942,1,23,8,5,70,32,38,77
Ayr,7942,2,24,4,8,93,42,51,76
Arbroath,7942,3,17,8,11,71,50,21,59
Alloa,7942,4,17,8,11,56,45,11,59
Stranraer,7942,5,16,5,15,58,65,-7,53
Airdrieon,7942,6,10,12,14,45,58,-13,42
East Fife,7942,7,13,3,20,48,67,-19,42
Forfar,7942,8,10,6,20,38,64,-26,36
Queen's Park,7942,9,7,10,19,41,73,-32,31
Albion,7942,10,8,6,22,57,81,-24,30
Ayr,7943,1,24,4,8,93,43,50,76
Raith,7943,2,22,8,6,68,33,35,74
Alloa,7943,3,18,8,10,57,43,14,62
Arbroath,7943,4,17,9,10,70,48,22,60
Stranraer,7943,5,15,6,15,57,66,-9,51
East Fife,7943,6,13,4,19,49,66,-17,43
Airdrieon,7943,7,10,12,14,46,59,-13,42
Forfar,7943,8,10,6,20,39,65,-26,36
Albion,7943,9,8,6,22,58,81,-23,30
Queen's Park,7943,10,6,11,19,39,72,-33,29
Ayr,7944,1,23,5,8,93,45,48,74
Raith,7944,2,22,8,6,68,33,35,74
Arbroath,7944,3,18,8,10,72,48,24,62
Alloa,7944,4,18,8,10,57,43,14,62
Stranraer,7944,5,16,5,15,56,64,-8,53
Airdrieon,7944,6,10,12,14,46,59,-13,42
East Fife,7944,7,13,3,20,47,65,-18,42
Forfar,7944,8,10,6,20,39,65,-26,36
Albion,7944,9,8,7,21,60,81,-21,31
Queen's Park,7944,10,6,10,20,39,74,-35,28
Ayr,7945,1,24,4,8,95,44,51,76
Raith,7945,2,22,8,6,68,33,35,74
Arbroath,7945,3,18,8,10,72,49,23,62
Alloa,7945,4,18,8,10,57,43,14,62
Stranraer,7945,5,15,5,16,56,66,-10,50
East Fife,7945,6,14,3,19,49,65,-16,45
Airdrieon,7945,7,11,11,14,46,58,-12,44
Forfar,7945,8,10,5,21,38,65,-27,35
Albion,7945,9,8,6,22,59,83,-24,30
Queen's Park,7945,10,6,10,20,40,74,-34,28
Raith,7946,1,23,8,5,71,32,39,77
Ayr,7946,2,24,4,8,96,43,53,76
Arbroath,7946,3,17,8,11,70,50,20,59
Alloa,7946,4,17,8,11,56,46,10,59
Stranraer,7946,5,15,5,16,57,68,-11,50
East Fife,7946,6,14,3,19,51,66,-15,45
Airdrieon,7946,7,10,11,15,46,60,-14,41
Forfar,7946,8,11,5,20,40,65,-25,38
Queen's Park,7946,9,7,10,19,41,72,-31,31
Albion,7946,10,8,6,22,58,84,-26,30
Raith,7947,1,23,8,5,71,33,38,77
Ayr,7947,2,24,4,8,91,42,49,76
Arbroath,7947,3,17,9,10,71,49,22,60
Alloa,7947,4,17,8,11,57,46,11,59
Stranraer,7947,5,15,6,15,55,64,-9,51
East Fife,7947,6,13,4,19,47,64,-17,43
Airdrieon,7947,7,10,11,15,46,61,-15,41
Forfar,7947,8,11,5,20,41,65,-24,38
Albion,7947,9,8,6,22,57,79,-22,30
Queen's Park,7947,10,6,11,19,40,73,-33,29
Raith,7948,1,23,8,5,72,33,39,77
Ayr,7948,2,24,4,8,94,43,51,76
Arbroath,7948,3,17,9,10,71,49,22,60
Alloa,7948,4,17,8,11,57,47,10,59
Stranraer,7948,5,16,5,15,58,66,-8,53
Airdrieon,7948,6,11,11,14,46,58,-12,44
East Fife,7948,7,13,3,20,49,67,-18,42
Forfar,7948,8,10,5,21,38,65,-27,35
Albion,7948,9,8,6,22,58,82,-24,30
Queen's Park,7948,10,6,11,19,40,73,-33,29
Ayr,7949,1,24,4,8,93,43,50,76
Raith,7949,2,22,9,5,70,34,36,75
Arbroath,7949,3,18,8,10,74,50,24,62
Alloa,7949,4,17,9,10,58,45,13,60
Stranraer,7949,5,16,5,15,57,65,-8,53
Airdrieon,7949,6,11,11,14,46,58,-12,44
East Fife,7949,7,13,3,20,48,66,-18,42
Forfar,7949,8,10,5,21,38,65,-27,35
Albion,7949,9,8,6,22,58,81,-23,30
Queen's Park,7949,10,6,10,20,41,76,-35,28
Ayr,7950,1,24,4,8,95,43,52,76
Raith,7950,2,22,8,6,69,34,35,74
Arbroath,7950,3,18,8,10,72,49,23,62
Alloa,7950,4,18,8,10,58,44,14,62
Stranraer,7950,5,16,5,15,56,64,-8,53
East Fife,7950,6,13,3,20,47,65,-18,42
Airdrieon,7950,7,10,11,15,45,59,-14,41
Forfar,7950,8,11,5,20,39,64,-25,38
Albion,7950,9,8,6,22,58,83,-25,30
Queen's Park,7950,10,6,10,20,40,74,-34,28
Raith,7951,1,23,8,5,70,32,38,77
Ayr,7951,2,24,4,8,92,42,50,76
Arbroath,7951,3,17,8,11,71,50,21,59
Alloa,7951,4,17,8,11,56,45,11,59
Stranraer,7951,5,15,6,15,56,65,-9,51
Airdrieon,7951,6,11,11,14,47,59,-12,44
East Fife,7951,7,13,4,19,48,65,-17,43
Forfar,7951,8,10,5,21,39,66,-27,35
Queen's Park,7951,9,7,10,19,41,73,-32,31
Albion,7951,10,8,6,22,57,80,-23,30
Ayr,7952,1,24,4,8,93,42,51,76
Raith,7952,2,22,8,6,69,34,35,74
Alloa,7952,3,18,8,10,58,44,14,62
Arbroath,7952,4,17,8,11,71,50,21,59
Stranraer,7952,5,15,6,15,58,67,-9,51
Airdrieon,7952,6,11,11,14,47,59,-12,44
East Fife,7952,7,13,4,19,50,67,-17,43
Forfar,7952,8,10,5,21,39,66,-27,35
Queen's Park,7952,9,7,10,19,41,73,-32,31
Albion,7952,10,8,6,22,57,81,-24,30
Ayr,7953,1,24,4,8,94,44,50,76
Raith,7953,2,22,9,5,70,34,36,75
Arbroath,7953,3,18,8,10,71,48,23,62
Alloa,7953,4,17,9,10,58,45,13,60
Stranraer,7953,5,15,6,15,56,65,-9,51
East Fife,7953,6,13,4,19,48,65,-17,43
Airdrieon,7953,7,10,11,15,45,60,-15,41
Forfar,7953,8,11,5,20,40,64,-24,38
Albion,7953,9,8,6,22,59,82,-23,30
Queen's Park,7953,10,6,10,20,39,73,-34,28
Ayr,7954,1,24,4,8,94,43,51,76
Raith,7954,2,22,9,5,68,32,36,75
Alloa,7954,3,17,9,10,56,43,13,60
Arbroath,7954,4,17,8,11,73,52,21,59
Stranraer,7954,5,15,5,16,55,66,-11,50
East Fife,7954,6,14,3,19,49,64,-15,45
Airdrieon,7954,7,10,11,15,45,59,-14,41
Forfar,7954,8,11,5,20,39,64,-25,38
Queen's Park,7954,9,7,10,19,43,75,-32,31
Albion,7954,10,8,6,22,58,82,-24,30
Raith,7955,1,23,8,5,72,34,38,77
Ayr,7955,2,24,4,8,95,42,53,76
Arbroath,7955,3,17,9,10,70,48,22,60
Alloa,7955,4,17,8,11,58,47,11,59
Stranraer,7955,5,15,5,16,55,65,-10,50
East Fife,7955,6,14,3,19,48,64,-16,45
Airdrieon,7955,7,11,11,14,49,59,-10,44
Forfar,7955,8,10,5,21,39,68,-29,35
Albion,7955,9,8,6,22,57,83,-26,30
Queen's Park,7955,10,6,11,19,39,72,-33,29
Raith,7956,1,23,8,5,69,32,37,77
Ayr,7956,2,24,4,8,95,43,52,76
Arbroath,7956,3,17,8,11,71,50,21,59
Alloa,7956,4,17,8,11,56,44,12,59
Stranraer,7956,5,16,5,15,58,65,-7,53
Airdrieon,7956,6,11,11,14,47,58,-11,44
East Fife,7956,7,13,3,20,48,67,-19,42
Forfar,7956,8,10,5,21,38,66,-28,35
Queen's Park,7956,9,7,10,19,41,73,-32,31
Albion,7956,10,8,6,22,58,83,-25,30
Raith,7957,1,23,8,5,71,32,39,77
Ayr,7957,2,24,4,8,94,42,52,76
Arbroath,7957,3,17,8,11,70,49,21,59
Alloa,7957,4,17,8,11,56,46,10,59
Stranraer,7957,5,15,5,16,56,66,-10,50
East Fife,7957,6,14,3,19,49,65,-16,45
Airdrieon,7957,7,11,11,14,49,58,-9,44
Forfar,7957,8,10,5,21,38,68,-30,35
Queen's Park,7957,9,7,10,19,40,72,-32,31
Albion,7957,10,8,6,22,57,82,-25,30
Ayr,7958,1,24,4,8,96,43,53,76
Raith,7958,2,22,9,5,69,33,36,75
Arbroath,7958,3,18,8,10,72,48,24,62
Alloa,7958,4,17,9,10,57,44,13,60
Stranraer,7958,5,15,5,16,55,65,-10,50
East Fife,7958,6,14,3,19,48,64,-16,45
Airdrieon,7958,7,11,11,14,49,58,-9,44
Forfar,7958,8,10,5,21,38,68,-30,35
Albion,7958,9,8,6,22,58,84,-26,30
Queen's Park,7958,10,6,10,20,39,74,-35,28
Raith,7959,1,23,8,5,70,32,38,77
Ayr,7959,2,24,4,8,96,43,53,76
Arbroath,7959,3,17,9,10,70,48,22,60
Alloa,7959,4,17,8,11,56,45,11,59
Stranraer,7959,5,16,5,15,58,66,-8,53
Airdrieon,7959,6,11,11,14,48,60,-12,44
East Fife,7959,7,13,3,20,49,67,-18,42
Forfar,7959,8,10,5,21,40,67,-27,35
Albion,7959,9,8,6,22,58,84,-26,30
Queen's Park,7959,10,6,11,19,39,72,-33,29
Raith,7960,1,23,8,5,71,32,39,77
Ayr,7960,2,24,4,8,91,42,49,76
Arbroath,7960,3,18,8,10,72,48,24,62
Alloa,7960,4,17,8,11,56,46,10,59
Stranraer,7960,5,15,5,16,56,66,-10,50
East Fife,7960,6,14,3,19,49,65,-16,45
Airdrieon,7960,7,10,11,15,45,59,-14,41
Forfar,7960,8,11,5,20,39,64,-25,38
Albion,7960,9,8,6,22,57,79,-22,30
Queen's Park,7960,10,6,10,20,39,74,-35,28
Raith,7961,1,23,8,5,70,33,37,77
Ayr,7961,2,24,4,8,92,43,49,76
Arbroath,7961,3,17,9,10,72,50,22,60
Alloa,7961,4,17,8,11,57,45,12,59
Stranraer,7961,5,16,5,15,57,64,-7,53
Airdrieon,7961,6,10,12,14,46,59,-13,42
East Fife,7961,7,13,3,20,47,66,-19,42
Forfar,7961,8,10,6,20,39,65,-26,36
Albion,7961,9,8,6,22,58,80,-22,30
Queen's Park,7961,10,6,11,19,41,74,-33,29
Ayr,7962,1,23,5,8,92,44,48,74
Raith,7962,2,22,8,6,69,35,34,74
Alloa,7962,3,18,8,10,59,44,15,62
Arbroath,7962,4,17,9,10,70,48,22,60
Stranraer,7962,5,15,6,15,56,65,-9,51
Airdrieon,7962,6,11,11,14,49,59,-10,44
East Fife,7962,7,13,4,19,48,65,-17,43
Forfar,7962,8,10,5,21,39,68,-29,35
Albion,7962,9,8,7,21,59,80,-21,31
Queen's Park,7962,10,6,11,19,39,72,-33,29
Raith,7963,1,23,8,5,70,32,38,77
Ayr,7963,2,24,4,8,98,44,54,76
Arbroath,7963,3,18,8,10,75,48,27,62
Alloa,7963,4,17,8,11,56,45,11,59
Stranraer,7963,5,16,5,15,59,65,-6,53
Airdrieon,7963,6,11,11,14,49,58,-9,44
East Fife,7963,7,13,3,20,48,68,-20,42
Forfar,7963,8,10,5,21,38,68,-30,35
Albion,7963,9,8,6,22,59,86,-27,30
Queen's Park,7963,10,6,10,20,39,77,-38,28
Raith,7964,1,23,8,5,70,32,38,77
Ayr,7964,2,24,4,8,93,42,51,76
Arbroath,7964,3,18,8,10,74,50,24,62
Alloa,7964,4,17,8,11,56,45,11,59
Stranraer,7964,5,15,5,16,56,66,-10,50
East Fife,7964,6,14,3,19,49,65,-16,45
Airdrieon,7964,7,11,11,14,47,58,-11,44
Forfar,7964,8,10,5,21,38,66,-28,35
Albion,7964,9,8,6,22,57,81,-24,30
Queen's Park,7964,10,6,10,20,41,76,-35,28
Raith,7965,1,23,8,5,70,32,38,77
Ayr,7965,2,24,4,8,96,43,53,76
Arbroath,7965,3,18,8,10,75,48,27,62
Alloa,7965,4,17,8,11,56,45,11,59
Stranraer,7965,5,16,5,15,59,65,-6,53
East Fife,7965,6,13,3,20,48,68,-20,42
Airdrieon,7965,7,10,11,15,45,59,-14,41
Forfar,7965,8,11,5,20,39,64,-25,38
Albion,7965,9,8,6,22,58,84,-26,30
Queen's Park,7965,10,6,10,20,39,77,-38,28
Ayr,7966,1,24,4,8,95,42,53,76
Raith,7966,2,22,8,6,68,33,35,74
Arbroath,7966,3,18,8,10,71,48,23,62
Alloa,7966,4,18,8,10,57,43,14,62
Stranraer,7966,5,15,5,16,56,67,-11,50
East Fife,7966,6,14,3,19,50,65,-15,45
Airdrieon,7966,7,10,12,14,47,60,-13,42
Forfar,7966,8,10,6,20,40,66,-26,36
Albion,7966,9,8,6,22,57,83,-26,30
Queen's Park,7966,10,6,10,20,39,73,-34,28
Raith,7967,1,23,8,5,69,32,37,77
Ayr,7967,2,24,4,8,94,43,51,76
Arbroath,7967,3,17,8,11,71,50,21,59
Alloa,7967,4,17,8,11,56,44,12,59
Stranraer,7967,5,15,5,16,57,67,-10,50
East Fife,7967,6,14,3,19,50,66,-16,45
Airdrieon,7967,7,10,11,15,46,61,-15,41
Forfar,7967,8,11,5,20,41,65,-24,38
Queen's Park,7967,9,7,10,19,41,73,-32,31
Albion,7967,10,8,6,22,58,82,-24,30
Ayr,7968,1,24,4,8,93,44,49,76
Raith,7968,2,22,9,5,68,32,36,75
Arbroath,7968,3,18,8,10,72,49,23,62
Alloa,7968,4,17,9,10,56,43,13,60
Stranraer,7968,5,15,5,16,56,67,-11,50
East Fife,7968,6,14,3,19,50,65,-15,45
Airdrieon,7968,7,11,11,14,48,59,-11,44
Forfar,7968,8,10,5,21,39,67,-28,35
Albion,7968,9,8,6,22,59,81,-22,30
Queen's Park,7968,10,6,10,20,40,74,-34,28
Raith,7969,1,22,9,5,69,33,36,75
Ayr,7969,2,23,4,9,90,44,46,73
Arbroath,7969,3,18,8,10,73,50,23,62
Alloa,7969,4,17,9,10,57,44,13,60
Stranraer,7969,5,15,6,15,56,65,-9,51
Airdrieon,7969,6,11,11,14,47,58,-11,44
East Fife,7969,7,13,4,19,48,65,-17,43
Forfar,7969,8,10,5,21,38,66,-28,35
Albion,7969,9,9,6,21,59,78,-19,33
Queen's Park,7969,10,6,10,20,41,75,-34,28
Ayr,7970,1,24,4,8,94,44,50,76
Raith,7970,2,22,9,5,69,33,36,75
Arbroath,7970,3,18,8,10,71,48,23,62
Alloa,7970,4,17,9,10,57,44,13,60
Stranraer,7970,5,15,5,16,56,66,-10,50
East Fife,7970,6,14,3,19,49,65,-16,45
Airdrieon,7970,7,10,12,14,47,60,-13,42
Forfar,7970,8,10,6,20,40,66,-26,36
Albion,7970,9,8,6,22,59,82,-23,30
Queen's Park,7970,10,6,10,20,39,73,-34,28
Ayr,7971,1,24,4,8,91,42,49,76
Raith,7971,2,22,8,6,69,34,35,74
Arbroath,7971,3,18,8,10,73,48,25,62
Alloa,7971,4,18,8,10,58,44,14,62
Stranraer,7971,5,15,5,16,55,66,-11,50
East Fife,7971,6,14,3,19,49,64,-15,45
Airdrieon,7971,7,11,11,14,48,59,-11,44
Forfar,7971,8,10,5,21,39,67,-28,35
Albion,7971,9,8,6,22,57,79,-22,30
Queen's Park,7971,10,6,10,20,39,75,-36,28
Raith,7972,1,23,8,5,70,33,37,77
Ayr,7972,2,24,4,8,93,44,49,76
Arbroath,7972,3,17,8,11,70,51,19,59
Alloa,7972,4,17,8,11,57,45,12,59
Stranraer,7972,5,15,6,15,55,64,-9,51
Airdrieon,7972,6,11,11,14,47,59,-12,44
East Fife,7972,7,13,4,19,47,64,-17,43
Forfar,7972,8,10,5,21,39,66,-27,35
Queen's Park,7972,9,7,10,19,42,72,-30,31
Albion,7972,10,8,6,22,59,81,-22,30
Ayr,7973,1,24,4,8,93,44,49,76
Raith,7973,2,22,9,5,70,34,36,75
Arbroath,7973,3,18,8,10,72,48,24,62
Alloa,7973,4,17,9,10,58,45,13,60
Stranraer,7973,5,15,6,15,55,64,-9,51
East Fife,7973,6,13,4,19,47,64,-17,43
Airdrieon,7973,7,10,11,15,45,59,-14,41
Forfar,7973,8,11,5,20,39,64,-25,38
Albion,7973,9,8,6,22,59,81,-22,30
Queen's Park,7973,10,6,10,20,39,74,-35,28
Ayr,7974,1,24,4,8,93,44,49,76
Raith,7974,2,22,8,6,69,34,35,74
Alloa,7974,3,18,8,10,58,44,14,62
Arbroath,7974,4,17,8,11,70,49,21,59
Stranraer,7974,5,16,5,15,57,64,-7,53
Airdrieon,7974,6,11,11,14,47,58,-11,44
East Fife,7974,7,13,3,20,47,66,-19,42
Forfar,7974,8,10,5,21,38,66,-28,35
Queen's Park,7974,9,7,10,19,40,72,-32,31
Albion,7974,10,8,6,22,59,81,-22,30
Raith,7975,1,23,8,5,71,34,37,77
Ayr,7975,2,24,4,8,93,43,50,76
Arbroath,7975,3,17,8,11,70,50,20,59
Alloa,7975,4,17,8,11,58,46,12,59
Stranraer,7975,5,15,5,16,56,69,-13,50
East Fife,7975,6,14,3,19,52,65,-13,45
Airdrieon,7975,7,10,11,15,45,59,-14,41
Forfar,7975,8,11,5,20,39,64,-25,38
Queen's Park,7975,9,7,10,19,41,72,-31,31
Albion,7975,10,8,6,22,58,81,-23,30
Raith,7976,1,22,9,5,69,33,36,75
Ayr,7976,2,23,4,9,91,44,47,73
Arbroath,7976,3,18,8,10,71,48,23,62
Alloa,7976,4,17,9,10,57,44,13,60
Stranraer,7976,5,16,5,15,56,64,-8,53
Airdrieon,7976,6,10,12,14,46,59,-13,42
East Fife,7976,7,13,3,20,47,65,-18,42
Forfar,7976,8,10,6,20,39,65,-26,36
Albion,7976,9,9,6,21,59,79,-20,33
Queen's Park,7976,10,6,10,20,39,73,-34,28
Raith,7977,1,23,8,5,71,32,39,77
Ayr,7977,2,24,4,8,94,44,50,76
Arbroath,7977,3,17,9,10,71,49,22,60
Alloa,7977,4,17,8,11,56,46,10,59
Stranraer,7977,5,15,5,16,55,65,-10,50
East Fife,7977,6,14,3,19,48,64,-16,45
Airdrieon,7977,7,10,12,14,46,59,-13,42
Forfar,7977,8,10,6,20,39,65,-26,36
Albion,7977,9,8,6,22,59,82,-23,30
Queen's Park,7977,10,6,11,19,40,73,-33,29
Ayr,7978,1,24,4,8,95,42,53,76
Raith,7978,2,22,9,5,69,33,36,75
Arbroath,7978,3,17,9,10,72,50,22,60
Alloa,7978,4,17,9,10,57,44,13,60
Stranraer,7978,5,15,6,15,55,64,-9,51
Airdrieon,7978,6,11,11,14,47,58,-11,44
East Fife,7978,7,13,4,19,47,64,-17,43
Forfar,7978,8,10,5,21,38,66,-28,35
Albion,7978,9,8,6,22,57,83,-26,30
Queen's Park,7978,10,6,11,19,41,74,-33,29
Ayr,7979,1,24,4,8,94,43,51,76
Raith,7979,2,22,9,5,69,33,36,75
Alloa,7979,3,17,9,10,57,44,13,60
Arbroath,7979,4,17,8,11,71,50,21,59
Stranraer,7979,5,15,5,16,56,68,-12,50
East Fife,7979,6,14,3,19,51,65,-14,45
Airdrieon,7979,7,11,11,14,46,58,-12,44
Forfar,7979,8,10,5,21,38,65,-27,35
Queen's Park,7979,9,7,10,19,41,73,-32,31
Albion,7979,10,8,6,22,58,82,-24,30
Raith,7980,1,23,8,5,69,32,37,77
Ayr,7980,2,24,4,8,94,44,50,76
Arbroath,7980,3,17,8,11,71,51,20,59
Alloa,7980,4,17,8,11,56,44,12,59
Stranraer,7980,5,15,5,16,55,66,-11,50
East Fife,7980,6,14,3,19,49,64,-15,45
Airdrieon,7980,7,10,12,14,46,59,-13,42
Forfar,7980,8,10,6,20,39,65,-26,36
Queen's Park,7980,9,7,10,19,42,73,-31,31
Albion,7980,10,8,6,22,59,82,-23,30
Raith,7981,1,23,8,5,71,33,38,77
Ayr,7981,2,23,5,8,91,43,48,74
Arbroath,7981,3,17,8,11,70,50,20,59
Alloa,7981,4,17,8,11,57,46,11,59
Stranraer,7981,5,15,5,16,55,65,-10,50
East Fife,7981,6,14,3,19,48,64,-16,45
Airdrieon,7981,7,10,11,15,47,61,-14,41
Forfar,7981,8,11,5,20,41,66,-25,38
Albion,7981,9,8,7,21,58,79,-21,31
Queen's Park,7981,10,7,10,19,41,72,-31,31
Ayr,7982,1,24,4,8,96,46,50,76
Raith,7982,2,22,9,5,69,33,36,75
Arbroath,7982,3,18,8,10,73,48,25,62
Alloa,7982,4,17,9,10,57,44,13,60
Stranraer,7982,5,15,6,15,57,66,-9,51
Airdrieon,7982,6,11,11,14,47,59,-12,44
East Fife,7982,7,13,4,19,49,66,-17,43
Forfar,7982,8,10,5,21,39,66,-27,35
Albion,7982,9,8,6,22,61,84,-23,30
Queen's Park,7982,10,6,10,20,39,75,-36,28
Raith,7983,1,23,8,5,70,32,38,77
Ayr,7983,2,24,4,8,94,44,50,76
Arbroath,7983,3,18,8,10,74,49,25,62
Alloa,7983,4,17,8,11,56,45,11,59
Stranraer,7983,5,16,5,15,58,65,-7,53
East Fife,7983,6,13,3,20,48,67,-19,42
Airdrieon,7983,7,10,11,15,45,60,-15,41
Forfar,7983,8,11,5,20,40,64,-24,38
Albion,7983,9,8,6,22,59,82,-23,30
Queen's Park,7983,10,6,10,20,40,76,-36,28
Raith,7984,1,23,8,5,69,32,37,77
Ayr,7984,2,24,4,8,93,43,50,76
Arbroath,7984,3,17,8,11,72,52,20,59
Alloa,7984,4,17,8,11,56,44,12,59
Stranraer,7984,5,16,5,15,57,65,-8,53
East Fife,7984,6,13,3,20,48,66,-18,42
Airdrieon,7984,7,10,11,15,45,59,-14,41
Forfar,7984,8,11,5,20,39,64,-25,38
Queen's Park,7984,9,7,10,19,43,74,-31,31
Albion,7984,10,8,6,22,58,81,-23,30
Ayr,7985,1,23,5,8,93,45,48,74
Raith,7985,2,22,8,6,68,33,35,74
Alloa,7985,3,18,8,10,57,43,14,62
Arbroath,7985,4,17,8,11,70,50,20,59
Stranraer,7985,5,15,6,15,56,65,-9,51
East Fife,7985,6,13,4,19,48,65,-17,43
Airdrieon,7985,7,10,11,15,46,60,-14,41
Forfar,7985,8,11,5,20,40,65,-25,38
Albion,7985,9,8,7,21,60,81,-21,31
Queen's Park,7985,10,7,10,19,41,72,-31,31
Ayr,7986,1,24,4,8,94,43,51,76
Raith,7986,2,22,9,5,69,33,36,75
Arbroath,7986,3,18,8,10,73,48,25,62
Alloa,7986,4,17,9,10,57,44,13,60
Stranraer,7986,5,15,5,16,56,69,-13,50
East Fife,7986,6,14,3,19,52,65,-13,45
Airdrieon,7986,7,11,11,14,48,60,-12,44
Forfar,7986,8,10,5,21,40,67,-27,35
Albion,7986,9,8,6,22,58,82,-24,30
Queen's Park,7986,10,6,10,20,39,75,-36,28
Ayr,7987,1,24,4,8,92,43,49,76
Raith,7987,2,22,9,5,69,33,36,75
Arbroath,7987,3,17,9,10,70,48,22,60
Alloa,7987,4,17,9,10,57,44,13,60
Stranraer,7987,5,15,5,16,57,67,-10,50
East Fife,7987,6,14,3,19,50,66,-16,45
Airdrieon,7987,7,11,11,14,47,58,-11,44
Forfar,7987,8,10,5,21,38,66,-28,35
Albion,7987,9,8,6,22,58,80,-22,30
Queen's Park,7987,10,6,11,19,39,72,-33,29
Ayr,7988,1,24,4,8,95,45,50,76
Raith,7988,2,22,9,5,69,33,36,75
Arbroath,7988,3,17,9,10,71,49,22,60
Alloa,7988,4,17,9,10,57,44,13,60
Stranraer,7988,5,15,5,16,56,67,-11,50
East Fife,7988,6,14,3,19,50,65,-15,45
Airdrieon,7988,7,11,11,14,46,58,-12,44
Forfar,7988,8,10,5,21,38,65,-27,35
Albion,7988,9,8,6,22,60,83,-23,30
Queen's Park,7988,10,6,11,19,40,73,-33,29
Raith,7989,1,23,8,5,71,32,39,77
Ayr,7989,2,24,4,8,93,44,49,76
Arbroath,7989,3,17,8,11,70,50,20,59
Alloa,7989,4,17,8,11,56,46,10,59
Stranraer,7989,5,16,5,15,58,64,-6,53
East Fife,7989,6,13,3,20,47,67,-20,42
Airdrieon,7989,7,10,11,15,46,60,-14,41
Forfar,7989,8,11,5,20,40,65,-25,38
Queen's Park,7989,9,7,10,19,41,72,-31,31
Albion,7989,10,8,6,22,59,81,-22,30
Ayr,7990,1,24,4,8,92,43,49,76
Raith,7990,2,22,8,6,68,33,35,74
Arbroath,7990,3,18,8,10,72,49,23,62
Alloa,7990,4,18,8,10,57,43,14,62
Stranraer,7990,5,15,5,16,55,65,-10,50
East Fife,7990,6,14,3,19,48,64,-16,45
Airdrieon,7990,7,11,11,14,49,59,-10,44
Forfar,7990,8,10,5,21,39,68,-29,35
Albion,7990,9,8,6,22,58,80,-22,30
Queen's Park,7990,10,6,10,20,40,74,-34,28
Raith,7991,1,23,8,5,69,32,37,77
Ayr,7991,2,24,4,8,93,44,49,76
Arbroath,7991,3,18,8,10,72,49,23,62
Alloa,7991,4,17,8,11,56,44,12,59
Stranraer,7991,5,15,5,16,55,65,-10,50
East Fife,7991,6,14,3,19,48,64,-16,45
Airdrieon,7991,7,11,11,14,49,60,-11,44
Forfar,7991,8,10,5,21,40,68,-28,35
Albion,7991,9,8,6,22,59,81,-22,30
Queen's Park,7991,10,6,10,20,40,74,-34,28
Raith,7992,1,23,8,5,69,32,37,77
Ayr,7992,2,23,4,9,91,44,47,73
Arbroath,7992,3,17,9,10,71,49,22,60
Alloa,7992,4,17,8,11,56,44,12,59
Stranraer,7992,5,15,5,16,56,67,-11,50
East Fife,7992,6,14,3,19,50,65,-15,45
Airdrieon,7992,7,10,11,15,45,59,-14,41
Forfar,7992,8,11,5,20,39,64,-25,38
Albion,7992,9,9,6,21,59,79,-20,33
Queen's Park,7992,10,6,11,19,40,73,-33,29
Ayr,7993,1,24,4,8,93,44,49,76
Raith,7993,2,22,9,5,68,32,36,75
Arbroath,7993,3,18,8,10,74,49,25,62
Alloa,7993,4,17,9,10,56,43,13,60
Stranraer,7993,5,15,5,16,56,66,-10,50
East Fife,7993,6,14,3,19,49,65,-16,45
Airdrieon,7993,7,10,11,15,45,59,-14,41
Forfar,7993,8,11,5,20,39,64,-25,38
Albion,7993,9,8,6,22,59,81,-22,30
Queen's Park,7993,10,6,10,20,40,76,-36,28
Raith,7994,1,23,8,5,71,32,39,77
Ayr,7994,2,23,5,8,92,44,48,74
Arbroath,7994,3,17,9,10,71,49,22,60
Alloa,7994,4,17,8,11,56,46,10,59
Stranraer,7994,5,15,5,16,55,66,-11,50
East Fife,7994,6,14,3,19,49,64,-15,45
Airdrieon,7994,7,10,12,14,47,60,-13,42
Forfar,7994,8,10,6,20,40,66,-26,36
Albion,7994,9,8,7,21,59,80,-21,31
Queen's Park,7994,10,6,11,19,40,73,-33,29
Ayr,7995,1,24,4,8,92,43,49,76
Raith,7995,2,22,9,5,68,32,36,75
Arbroath,7995,3,18,8,10,72,49,23,62
Alloa,7995,4,17,9,10,56,43,13,60
Stranraer,7995,5,16,5,15,57,64,-7,53
East Fife,7995,6,13,3,20,47,66,-19,42
Airdrieon,7995,7,10,11,15,45,60,-15,41
Forfar,7995,8,11,5,20,40,64,-24,38
Albion,7995,9,8,6,22,58,80,-22,30
Queen's Park,7995,10,6,10,20,40,74,-34,28
Raith,7996,1,22,9,5,69,33,36,75
Ayr,7996,2,23,4,9,90,43,47,73
Alloa,7996,3,17,9,10,57,44,13,60
Arbroath,7996,4,17,8,11,70,49,21,59
Stranraer,7996,5,16,5,15,59,67,-8,53
East Fife,7996,6,13,3,20,50,68,-18,42
Airdrieon,7996,7,10,11,15,45,59,-14,41
Forfar,7996,8,11,5,20,39,64,-25,38
Albion,7996,9,9,6,21,58,78,-20,33
Queen's Park,7996,10,7,10,19,40,72,-32,31
Ayr,7997,1,24,4,8,92,43,49,76
Raith,7997,2,22,8,6,68,33,35,74
Arbroath,7997,3,18,8,10,72,49,23,62
Alloa,7997,4,18,8,10,57,43,14,62
Stranraer,7997,5,15,5,16,56,66,-10,50
East Fife,7997,6,14,3,19,49,65,-16,45
Airdrieon,7997,7,10,12,14,47,60,-13,42
Forfar,7997,8,10,6,20,40,66,-26,36
Albion,7997,9,8,6,22,58,80,-22,30
Queen's Park,7997,10,6,10,20,40,74,-34,28
Raith,7998,1,22,9,5,69,33,36,75
Ayr,7998,2,23,4,9,90,43,47,73
Alloa,7998,3,17,9,10,57,44,13,60
Arbroath,7998,4,17,8,11,72,51,21,59
Stranraer,7998,5,15,5,16,56,67,-11,50
East Fife,7998,6,14,3,19,50,65,-15,45
Airdrieon,7998,7,10,12,14,46,59,-13,42
Forfar,7998,8,10,6,20,39,65,-26,36
Albion,7998,9,9,6,21,58,78,-20,33
Queen's Park,7998,10,7,10,19,42,74,-32,31
Raith,7999,1,22,9,5,69,33,36,75
Ayr,7999,2,23,5,8,91,43,48,74
Alloa,7999,3,17,9,10,57,44,13,60
Arbroath,7999,4,17,8,11,71,50,21,59
Stranraer,7999,5,15,5,16,56,66,-10,50
East Fife,7999,6,14,3,19,49,65,-16,45
Airdrieon,7999,7,11,11,14,46,58,-12,44
Forfar,7999,8,10,5,21,38,65,-27,35
Albion,7999,9,8,7,21,58,79,-21,31
Queen's Park,7999,10,7,10,19,41,73,-32,31
Ayr,8000,1,24,4,8,94,43,51,76
Raith,8000,2,22,9,5,70,34,36,75
Arbroath,8000,3,18,8,10,77,48,29,62
Alloa,8000,4,17,9,10,58,45,13,60
Stranraer,8000,5,15,5,16,56,66,-10,50
East Fife,8000,6,14,3,19,49,65,-16,45
Airdrieon,8000,7,10,12,14,47,60,-13,42
Forfar,8000,8,10,6,20,40,66,-26,36
Albion,8000,9,8,6,22,58,82,-24,30
Queen's Park,8000,10,6,10,20,39,79,-40,28
Ayr,8001,1,24,4,8,94,45,49,76
Raith,8001,2,22,9,5,69,33,36,75
Alloa,8001,3,17,9,10,57,44,13,60
Arbroath,8001,4,17,8,11,70,52,18,59
Stranraer,8001,5,16,5,15,56,64,-8,53
Airdrieon,8001,6,11,11,14,47,59,-12,44
East Fife,8001,7,13,3,20,47,65,-18,42
Forfar,8001,8,10,5,21,39,66,-27,35
Queen's Park,8001,9,7,10,19,43,72,-29,31
Albion,8001,10,8,6,22,60,82,-22,30
Raith,8002,1,23,8,5,70,32,38,77
Ayr,8002,2,23,5,8,90,42,48,74
Arbroath,8002,3,17,8,11,70,49,21,59
Alloa,8002,4,17,8,11,56,45,11,59
Stranraer,8002,5,15,5,16,55,67,-12,50
East Fife,8002,6,14,3,19,50,64,-14,45
Airdrieon,8002,7,10,11,15,49,63,-14,41
Forfar,8002,8,11,5,20,43,68,-25,38
Albion,8002,9,8,7,21,57,78,-21,31
Queen's Park,8002,10,7,10,19,40,72,-32,31
Raith,8003,1,23,8,5,70,32,38,77
Ayr,8003,2,23,5,8,93,45,48,74
Arbroath,8003,3,17,9,10,71,49,22,60
Alloa,8003,4,17,8,11,56,45,11,59
Stranraer,8003,5,15,5,16,55,65,-10,50
East Fife,8003,6,14,3,19,48,64,-16,45
Airdrieon,8003,7,10,11,15,46,60,-14,41
Forfar,8003,8,11,5,20,40,65,-25,38
Albion,8003,9,8,7,21,60,81,-21,31
Queen's Park,8003,10,6,11,19,40,73,-33,29
Ayr,8004,1,24,4,8,92,43,49,76
Raith,8004,2,22,9,5,68,32,36,75
Arbroath,8004,3,17,9,10,72,50,22,60
Alloa,8004,4,17,9,10,56,43,13,60
Stranraer,8004,5,15,6,15,56,65,-9,51
Airdrieon,8004,6,11,11,14,48,59,-11,44
East Fife,8004,7,13,4,19,48,65,-17,43
Forfar,8004,8,10,5,21,39,67,-28,35
Albion,8004,9,8,6,22,58,80,-22,30
Queen's Park,8004,10,6,11,19,41,74,-33,29
Ayr,8005,1,24,4,8,97,44,53,76
Raith,8005,2,22,9,5,71,35,36,75
Alloa,8005,3,17,9,10,59,46,13,60
Arbroath,8005,4,17,8,11,70,50,20,59
Stranraer,8005,5,15,5,16,57,67,-10,50
East Fife,8005,6,14,3,19,50,66,-16,45
Airdrieon,8005,7,11,11,14,47,59,-12,44
Forfar,8005,8,10,5,21,39,66,-27,35
Queen's Park,8005,9,7,10,19,41,72,-31,31
Albion,8005,10,8,6,22,59,85,-26,30
Raith,8006,1,23,8,5,69,32,37,77
Ayr,8006,2,23,4,9,91,44,47,73
Arbroath,8006,3,18,8,10,72,48,24,62
Alloa,8006,4,17,8,11,56,44,12,59
Stranraer,8006,5,15,5,16,55,65,-10,50
East Fife,8006,6,14,3,19,48,64,-16,45
Airdrieon,8006,7,10,11,15,46,61,-15,41
Forfar,8006,8,11,5,20,41,65,-24,38
Albion,8006,9,9,6,21,59,79,-20,33
Queen's Park,8006,10,6,10,20,39,74,-35,28
Ayr,8007,1,24,4,8,94,43,51,76
Raith,8007,2,22,8,6,69,34,35,74
Alloa,8007,3,18,8,10,58,44,14,62
Arbroath,8007,4,17,8,11,71,52,19,59
Stranraer,8007,5,15,6,15,58,67,-9,51
Airdrieon,8007,6,11,11,14,47,59,-12,44
East Fife,8007,7,13,4,19,50,67,-17,43
Forfar,8007,8,10,5,21,39,66,-27,35
Queen's Park,8007,9,7,10,19,43,73,-30,31
Albion,8007,10,8,6,22,58,82,-24,30
Raith,8008,1,23,8,5,73,33,40,77
Ayr,8008,2,24,4,8,94,44,50,76
Arbroath,8008,3,18,8,10,72,48,24,62
Alloa,8008,4,17,8,11,57,48,9,59
Stranraer,8008,5,16,5,15,57,65,-8,53
Airdrieon,8008,6,11,11,14,48,59,-11,44
East Fife,8008,7,13,3,20,48,66,-18,42
Forfar,8008,8,10,5,21,39,67,-28,35
Albion,8008,9,8,6,22,59,82,-23,30
Queen's Park,8008,10,6,10,20,39,74,-35,28
Raith,8009,1,23,8,5,70,33,37,77
Ayr,8009,2,23,5,8,94,46,48,74
Arbroath,8009,3,17,8,11,71,50,21,59
Alloa,8009,4,17,8,11,57,45,12,59
Stranraer,8009,5,16,5,15,59,65,-6,53
Airdrieon,8009,6,10,12,14,47,60,-13,42
East Fife,8009,7,13,3,20,48,68,-20,42
Forfar,8009,8,10,6,20,40,66,-26,36
Albion,8009,9,8,7,21,61,82,-21,31
Queen's Park,8009,10,7,10,19,41,73,-32,31
Raith,8010,1,23,8,5,71,33,38,77
Ayr,8010,2,23,4,9,91,45,46,73
Arbroath,8010,3,17,8,11,70,49,21,59
Alloa,8010,4,17,8,11,57,46,11,59
Stranraer,8010,5,15,5,16,56,66,-10,50
East Fife,8010,6,14,3,19,49,65,-16,45
Airdrieon,8010,7,10,12,14,45,58,-13,42
Forfar,8010,8,10,6,20,38,64,-26,36
Albion,8010,9,9,6,21,60,79,-19,33
Queen's Park,8010,10,7,10,19,40,72,-32,31
Raith,8011,1,23,8,5,70,32,38,77
Ayr,8011,2,23,4,9,92,46,46,73
Arbroath,8011,3,17,8,11,72,51,21,59
Alloa,8011,4,17,8,11,56,45,11,59
Stranraer,8011,5,16,5,15,57,65,-8,53
Airdrieon,8011,6,11,11,14,46,58,-12,44
East Fife,8011,7,13,3,20,48,66,-18,42
Forfar,8011,8,10,5,21,38,65,-27,35
Albion,8011,9,9,6,21,61,80,-19,33
Queen's Park,8011,10,7,10,19,42,74,-32,31
Ayr,8012,1,24,4,8,94,43,51,76
Raith,8012,2,22,8,6,68,33,35,74
Alloa,8012,3,18,8,10,57,43,14,62
Arbroath,8012,4,17,8,11,71,51,20,59
Stranraer,8012,5,16,5,15,56,64,-8,53
Airdrieon,8012,6,11,11,14,48,59,-11,44
East Fife,8012,7,13,3,20,47,65,-18,42
Forfar,8012,8,10,5,21,39,67,-28,35
Queen's Park,8012,9,7,10,19,42,73,-31,31
Albion,8012,10,8,6,22,58,82,-24,30
Ayr,8013,1,24,4,8,93,42,51,76
Raith,8013,2,22,8,6,69,34,35,74
Alloa,8013,3,18,8,10,58,44,14,62
Arbroath,8013,4,17,9,10,71,49,22,60
Stranraer,8013,5,15,5,16,55,66,-11,50
East Fife,8013,6,14,3,19,49,64,-15,45
Airdrieon,8013,7,10,12,14,46,59,-13,42
Forfar,8013,8,10,6,20,39,65,-26,36
Albion,8013,9,8,6,22,57,81,-24,30
Queen's Park,8013,10,6,11,19,40,73,-33,29
Raith,8014,1,22,8,6,68,35,33,74
Ayr,8014,2,23,4,9,90,43,47,73
Alloa,8014,3,18,8,10,59,43,16,62
Arbroath,8014,4,17,9,10,71,49,22,60
Stranraer,8014,5,16,5,15,56,64,-8,53
Airdrieon,8014,6,11,11,14,47,58,-11,44
East Fife,8014,7,13,3,20,47,65,-18,42
Forfar,8014,8,10,5,21,38,66,-28,35
Albion,8014,9,9,6,21,58,78,-20,33
Queen's Park,8014,10,6,11,19,40,73,-33,29
Raith,8015,1,22,9,5,68,32,36,75
Ayr,8015,2,23,5,8,91,43,48,74
Alloa,8015,3,17,9,10,56,43,13,60
Arbroath,8015,4,17,8,11,71,50,21,59
Stranraer,8015,5,15,5,16,56,67,-11,50
East Fife,8015,6,14,3,19,50,65,-15,45
Airdrieon,8015,7,11,11,14,47,59,-12,44
Forfar,8015,8,10,5,21,39,66,-27,35
Albion,8015,9,8,7,21,58,79,-21,31
Queen's Park,8015,10,7,10,19,41,73,-32,31
Ayr,8016,1,24,4,8,93,44,49,76
Raith,8016,2,22,8,6,68,34,34,74
Arbroath,8016,3,18,8,10,74,48,26,62
Alloa,8016,4,18,8,10,58,43,15,62
Stranraer,8016,5,15,5,16,56,67,-11,50
East Fife,8016,6,14,3,19,50,65,-15,45
Airdrieon,8016,7,10,11,15,46,61,-15,41
Forfar,8016,8,11,5,20,41,65,-24,38
Albion,8016,9,8,6,22,59,81,-22,30
Queen's Park,8016,10,6,10,20,39,76,-37,28
Raith,8017,1,23,8,5,71,33,38,77
Ayr,8017,2,24,4,8,91,42,49,76
Arbroath,8017,3,18,8,10,73,48,25,62
Alloa,8017,4,17,8,11,57,46,11,59
Stranraer,8017,5,15,6,15,56,65,-9,51
East Fife,8017,6,13,4,19,48,65,-17,43
Airdrieon,8017,7,10,12,14,45,58,-13,42
Forfar,8017,8,10,6,20,38,64,-26,36
Albion,8017,9,8,6,22,57,79,-22,30
Queen's Park,8017,10,6,10,20,39,75,-36,28
Raith,8018,1,23,8,5,71,32,39,77
Ayr,8018,2,24,4,8,93,42,51,76
Arbroath,8018,3,18,8,10,72,48,24,62
Alloa,8018,4,17,8,11,56,46,10,59
Stranraer,8018,5,16,5,15,58,66,-8,53
East Fife,8018,6,13,3,20,49,67,-18,42
Airdrieon,8018,7,10,11,15,45,59,-14,41
Forfar,8018,8,11,5,20,39,64,-25,38
Albion,8018,9,8,6,22,57,81,-24,30
Queen's Park,8018,10,6,10,20,39,74,-35,28
Ayr,8019,1,23,5,8,92,44,48,74
Raith,8019,2,22,8,6,68,33,35,74
Alloa,8019,3,18,8,10,57,43,14,62
Arbroath,8019,4,17,8,11,71,50,21,59
Stranraer,8019,5,15,5,16,56,66,-10,50
East Fife,8019,6,14,3,19,49,65,-16,45
Airdrieon,8019,7,10,11,15,45,59,-14,41
Forfar,8019,8,11,5,20,39,64,-25,38
Albion,8019,9,8,7,21,59,80,-21,31
Queen's Park,8019,10,7,10,19,41,73,-32,31
Ayr,8020,1,23,5,8,91,43,48,74
Raith,8020,2,22,8,6,68,33,35,74
Arbroath,8020,3,18,8,10,74,49,25,62
Alloa,8020,4,18,8,10,57,43,14,62
Stranraer,8020,5,15,5,16,55,66,-11,50
East Fife,8020,6,14,3,19,49,64,-15,45
Airdrieon,8020,7,10,11,15,48,62,-14,41
Forfar,8020,8,11,5,20,42,67,-25,38
Albion,8020,9,8,7,21,58,79,-21,31
Queen's Park,8020,10,6,10,20,40,76,-36,28
Ayr,8021,1,24,4,8,93,43,50,76
Raith,8021,2,22,9,5,68,32,36,75
Arbroath,8021,3,17,9,10,71,49,22,60
Alloa,8021,4,17,9,10,56,43,13,60
Stranraer,8021,5,15,5,16,57,72,-15,50
East Fife,8021,6,14,3,19,55,66,-11,45
Airdrieon,8021,7,10,11,15,45,60,-15,41
Forfar,8021,8,11,5,20,40,64,-24,38
Albion,8021,9,8,6,22,58,81,-23,30
Queen's Park,8021,10,6,11,19,40,73,-33,29
Ayr,8022,1,24,4,8,97,43,54,76
Raith,8022,2,22,9,5,69,33,36,75
Arbroath,8022,3,18,8,10,73,48,25,62
Alloa,8022,4,17,9,10,57,44,13,60
Stranraer,8022,5,15,5,16,55,66,-11,50
East Fife,8022,6,14,3,19,49,64,-15,45
Airdrieon,8022,7,10,12,14,46,59,-13,42
Forfar,8022,8,10,6,20,39,65,-26,36
Albion,8022,9,8,6,22,58,85,-27,30
Queen's Park,8022,10,6,10,20,39,75,-36,28
Ayr,8023,1,24,4,8,96,44,52,76
Raith,8023,2,22,9,5,69,33,36,75
Alloa,8023,3,17,9,10,57,44,13,60
Arbroath,8023,4,17,8,11,70,50,20,59
Stranraer,8023,5,15,5,16,56,67,-11,50
East Fife,8023,6,14,3,19,50,65,-15,45
Airdrieon,8023,7,11,11,14,46,58,-12,44
Forfar,8023,8,10,5,21,38,65,-27,35
Queen's Park,8023,9,7,10,19,41,72,-31,31
Albion,8023,10,8,6,22,59,84,-25,30
Ayr,8024,1,24,4,8,94,45,49,76
Raith,8024,2,22,9,5,68,32,36,75
Arbroath,8024,3,18,8,10,73,48,25,62
Alloa,8024,4,17,9,10,56,43,13,60
Stranraer,8024,5,16,5,15,57,65,-8,53
East Fife,8024,6,13,3,20,48,66,-18,42
Airdrieon,8024,7,10,11,15,45,60,-15,41
Forfar,8024,8,11,5,20,40,64,-24,38
Albion,8024,9,8,6,22,60,82,-22,30
Queen's Park,8024,10,6,10,20,39,75,-36,28
Raith,8025,1,23,8,5,72,34,38,77
Ayr,8025,2,24,4,8,93,43,50,76
Arbroath,8025,3,17,8,11,70,49,21,59
Alloa,8025,4,17,8,11,58,47,11,59
Stranraer,8025,5,16,5,15,56,64,-8,53
Airdrieon,8025,6,10,12,14,47,60,-13,42
East Fife,8025,7,13,3,20,47,65,-18,42
Forfar,8025,8,10,6,20,40,66,-26,36
Queen's Park,8025,9,7,10,19,40,72,-32,31
Albion,8025,10,8,6,22,58,81,-23,30
Raith,8026,1,23,8,5,69,32,37,77
Ayr,8026,2,24,4,8,94,45,49,76
Arbroath,8026,3,18,8,10,73,49,24,62
Alloa,8026,4,17,8,11,56,44,12,59
Stranraer,8026,5,15,5,16,56,66,-10,50
East Fife,8026,6,14,3,19,49,65,-16,45
Airdrieon,8026,7,11,11,14,47,58,-11,44
Forfar,8026,8,10,5,21,38,66,-28,35
Albion,8026,9,8,6,22,60,82,-22,30
Queen's Park,8026,10,6,10,20,40,75,-35,28
Raith,8027,1,23,8,5,70,33,37,77
Ayr,8027,2,24,4,8,93,44,49,76
Arbroath,8027,3,17,9,10,71,49,22,60
Alloa,8027,4,17,8,11,57,45,12,59
Stranraer,8027,5,15,5,16,56,66,-10,50
East Fife,8027,6,14,3,19,49,65,-16,45
Airdrieon,8027,7,10,11,15,46,60,-14,41
Forfar,8027,8,11,5,20,40,65,-25,38
Albion,8027,9,8,6,22,59,81,-22,30
Queen's Park,8027,10,6,11,19,40,73,-33,29
Raith,8028,1,23,8,5,70,33,37,77
Ayr,8028,2,24,4,8,92,42,50,76
Arbroath,8028,3,18,8,10,72,49,23,62
Alloa,8028,4,17,8,11,57,45,12,59
Stranraer,8028,5,15,6,15,57,66,-9,51
East Fife,8028,6,13,4,19,49,66,-17,43
Airdrieon,8028,7,10,12,14,45,58,-13,42
Forfar,8028,8,10,6,20,38,64,-26,36
Albion,8028,9,8,6,22,57,80,-23,30
Queen's Park,8028,10,6,10,20,40,74,-34,28
Raith,8029,1,23,8,5,70,33,37,77
Ayr,8029,2,23,4,9,93,46,47,73
Arbroath,8029,3,18,8,10,73,49,24,62
Alloa,8029,4,17,8,11,57,45,12,59
Stranraer,8029,5,16,5,15,61,67,-6,53
Airdrieon,8029,6,10,12,14,46,59,-13,42
East Fife,8029,7,13,3,20,50,70,-20,42
Forfar,8029,8,10,6,20,39,65,-26,36
Albion,8029,9,9,6,21,61,81,-20,33
Queen's Park,8029,10,6,10,20,40,75,-35,28
Ayr,8030,1,24,4,8,94,44,50,76
Raith,8030,2,22,9,5,68,32,36,75
Alloa,8030,3,17,9,10,56,43,13,60
Arbroath,8030,4,17,8,11,70,50,20,59
Stranraer,8030,5,15,5,16,56,68,-12,50
East Fife,8030,6,14,3,19,51,65,-14,45
Airdrieon,8030,7,10,11,15,45,60,-15,41
Forfar,8030,8,11,5,20,40,64,-24,38
Queen's Park,8030,9,7,10,19,41,72,-31,31
Albion,8030,10,8,6,22,59,82,-23,30
Ayr,8031,1,24,4,8,94,43,51,76
Raith,8031,2,22,9,5,70,34,36,75
Arbroath,8031,3,18,8,10,72,48,24,62
Alloa,8031,4,17,9,10,58,45,13,60
Stranraer,8031,5,15,6,15,59,68,-9,51
East Fife,8031,6,13,4,19,51,68,-17,43
Airdrieon,8031,7,10,11,15,45,59,-14,41
Forfar,8031,8,11,5,20,39,64,-25,38
Albion,8031,9,8,6,22,58,82,-24,30
Queen's Park,8031,10,6,10,20,39,74,-35,28
Raith,8032,1,23,8,5,70,33,37,77
Ayr,8032,2,24,4,8,94,43,51,76
Arbroath,8032,3,17,8,11,70,51,19,59
Alloa,8032,4,17,8,11,57,45,12,59
Stranraer,8032,5,15,6,15,55,64,-9,51
East Fife,8032,6,13,4,19,47,64,-17,43
Airdrieon,8032,7,10,12,14,46,59,-13,42
Forfar,8032,8,10,6,20,39,65,-26,36
Queen's Park,8032,9,7,10,19,42,72,-30,31
Albion,8032,10,8,6,22,58,82,-24,30
Ayr,8033,1,24,4,8,96,43,53,76
Raith,8033,2,22,9,5,69,33,36,75
Alloa,8033,3,17,9,10,57,44,13,60
Arbroath,8033,4,17,8,11,71,50,21,59
Stranraer,8033,5,16,5,15,59,67,-8,53
Airdrieon,8033,6,11,11,14,46,58,-12,44
East Fife,8033,7,13,3,20,50,68,-18,42
Forfar,8033,8,10,5,21,38,65,-27,35
Queen's Park,8033,9,7,10,19,41,73,-32,31
Albion,8033,10,8,6,22,58,84,-26,30
Raith,8034,1,23,8,5,70,33,37,77
Ayr,8034,2,24,4,8,94,44,50,76
Arbroath,8034,3,18,8,10,72,48,24,62
Alloa,8034,4,17,8,11,57,45,12,59
Stranraer,8034,5,16,5,15,56,64,-8,53
Airdrieon,8034,6,11,11,14,50,58,-8,44
East Fife,8034,7,13,3,20,47,65,-18,42
Forfar,8034,8,10,5,21,38,69,-31,35
Albion,8034,9,8,6,22,59,82,-23,30
Queen's Park,8034,10,6,10,20,39,74,-35,28
Raith,8035,1,22,9,5,70,34,36,75
Ayr,8035,2,23,5,8,93,45,48,74
Arbroath,8035,3,18,8,10,78,51,27,62
Alloa,8035,4,17,9,10,58,45,13,60
Stranraer,8035,5,15,5,16,55,66,-11,50
East Fife,8035,6,14,3,19,49,64,-15,45
Airdrieon,8035,7,10,12,14,46,59,-13,42
Forfar,8035,8,10,6,20,39,65,-26,36
Albion,8035,9,8,7,21,60,81,-21,31
Queen's Park,8035,10,6,10,20,42,80,-38,28
Raith,8036,1,23,8,5,69,32,37,77
Ayr,8036,2,23,5,8,91,43,48,74
Arbroath,8036,3,18,8,10,72,49,23,62
Alloa,8036,4,17,8,11,56,44,12,59
Stranraer,8036,5,15,5,16,55,65,-10,50
East Fife,8036,6,14,3,19,48,64,-16,45
Airdrieon,8036,7,10,11,15,45,59,-14,41
Forfar,8036,8,11,5,20,39,64,-25,38
Albion,8036,9,8,7,21,58,79,-21,31
Queen's Park,8036,10,6,10,20,40,74,-34,28
Ayr,8037,1,23,5,8,95,47,48,74
Raith,8037,2,22,8,6,68,34,34,74
Alloa,8037,3,18,8,10,58,43,15,62
Arbroath,8037,4,17,8,11,72,52,20,59
Stranraer,8037,5,16,5,15,59,64,-5,53
Airdrieon,8037,6,11,11,14,46,58,-12,44
East Fife,8037,7,13,3,20,47,68,-21,42
Forfar,8037,8,10,5,21,38,65,-27,35
Albion,8037,9,8,7,21,62,83,-21,31
Queen's Park,8037,10,7,10,19,43,74,-31,31
Raith,8038,1,23,8,5,70,33,37,77
Ayr,8038,2,24,4,8,92,43,49,76
Arbroath,8038,3,18,8,10,73,49,24,62
Alloa,8038,4,17,8,11,57,45,12,59
Stranraer,8038,5,15,5,16,57,68,-11,50
East Fife,8038,6,14,3,19,51,66,-15,45
Airdrieon,8038,7,10,12,14,46,59,-13,42
Forfar,8038,8,10,6,20,39,65,-26,36
Albion,8038,9,8,6,22,58,80,-22,30
Queen's Park,8038,10,6,10,20,40,75,-35,28
Raith,8039,1,23,8,5,71,32,39,77
Ayr,8039,2,24,4,8,92,43,49,76
Arbroath,8039,3,18,8,10,72,49,23,62
Alloa,8039,4,17,8,11,56,46,10,59
Stranraer,8039,5,15,5,16,55,65,-10,50
East Fife,8039,6,14,3,19,48,64,-16,45
Airdrieon,8039,7,11,11,14,47,59,-12,44
Forfar,8039,8,10,5,21,39,66,-27,35
Albion,8039,9,8,6,22,58,80,-22,30
Queen's Park,8039,10,6,10,20,40,74,-34,28
Ayr,8040,1,24,4,8,96,42,54,76
Raith,8040,2,22,8,6,69,34,35,74
Alloa,8040,3,18,8,10,58,44,14,62
Arbroath,8040,4,17,9,10,72,50,22,60
Stranraer,8040,5,15,5,16,57,68,-11,50
East Fife,8040,6,14,3,19,51,66,-15,45
Airdrieon,8040,7,11,11,14,50,61,-11,44
Forfar,8040,8,10,5,21,41,69,-28,35
Albion,8040,9,8,6,22,57,84,-27,30
Queen's Park,8040,10,6,11,19,41,74,-33,29
Raith,8041,1,23,8,5,70,32,38,77
Ayr,8041,2,24,4,8,92,42,50,76
Arbroath,8041,3,18,8,10,73,50,23,62
Alloa,8041,4,17,8,11,56,45,11,59
Stranraer,8041,5,15,6,15,57,66,-9,51
East Fife,8041,6,13,4,19,49,66,-17,43
Airdrieon,8041,7,10,12,14,46,59,-13,42
Forfar,8041,8,10,6,20,39,65,-26,36
Albion,8041,9,8,6,22,57,80,-23,30
Queen's Park,8041,10,6,10,20,41,75,-34,28
Raith,8042,1,23,8,5,70,32,38,77
Ayr,8042,2,23,5,8,94,46,48,74
Arbroath,8042,3,17,8,11,71,51,20,59
Alloa,8042,4,17,8,11,56,45,11,59
Stranraer,8042,5,15,5,16,57,67,-10,50
East Fife,8042,6,14,3,19,50,66,-16,45
Airdrieon,8042,7,10,12,14,46,59,-13,42
Forfar,8042,8,10,6,20,39,65,-26,36
Albion,8042,9,8,7,21,61,82,-21,31
Queen's Park,8042,10,7,10,19,42,73,-31,31
Raith,8043,1,23,8,5,70,32,38,77
Ayr,8043,2,24,4,8,94,42,52,76
Arbroath,8043,3,18,8,10,72,49,23,62
Alloa,8043,4,17,8,11,56,45,11,59
Stranraer,8043,5,16,5,15,59,64,-5,53
Airdrieon,8043,6,10,12,14,46,59,-13,42
East Fife,8043,7,13,3,20,47,68,-21,42
Forfar,8043,8,10,6,20,39,65,-26,36
Albion,8043,9,8,6,22,57,82,-25,30
Queen's Park,8043,10,6,10,20,40,74,-34,28
Ayr,8044,1,24,4,8,92,43,49,76
Raith,8044,2,22,8,6,69,36,33,74
Arbroath,8044,3,18,8,10,72,49,23,62
Alloa,8044,4,18,8,10,60,44,16,62
Stranraer,8044,5,15,6,15,58,67,-9,51
Airdrieon,8044,6,11,11,14,48,59,-11,44
East Fife,8044,7,13,4,19,50,67,-17,43
Forfar,8044,8,10,5,21,39,67,-28,35
Albion,8044,9,8,6,22,58,80,-22,30
Queen's Park,8044,10,6,10,20,40,74,-34,28
Ayr,8045,1,24,4,8,95,44,51,76
Raith,8045,2,22,9,5,70,34,36,75
Arbroath,8045,3,18,8,10,72,49,23,62
Alloa,8045,4,17,9,10,58,45,13,60
Stranraer,8045,5,15,5,16,56,67,-11,50
East Fife,8045,6,14,3,19,50,65,-15,45
Airdrieon,8045,7,11,11,14,47,59,-12,44
Forfar,8045,8,10,5,21,39,66,-27,35
Albion,8045,9,8,6,22,59,83,-24,30
Queen's Park,8045,10,6,10,20,40,74,-34,28
Ayr,8046,1,24,4,8,92,43,49,76
Raith,8046,2,22,9,5,69,33,36,75
Arbroath,8046,3,18,8,10,72,49,23,62
Alloa,8046,4,17,9,10,57,44,13,60
Stranraer,8046,5,15,6,15,55,64,-9,51
Airdrieon,8046,6,11,11,14,47,58,-11,44
East Fife,8046,7,13,4,19,47,64,-17,43
Forfar,8046,8,10,5,21,38,66,-28,35
Albion,8046,9,8,6,22,58,80,-22,30
Queen's Park,8046,10,6,10,20,40,74,-34,28
Ayr,8047,1,24,4,8,93,44,49,76
Raith,8047,2,22,9,5,68,32,36,75
Arbroath,8047,3,18,8,10,71,48,23,62
Alloa,8047,4,17,9,10,56,43,13,60
Stranraer,8047,5,16,5,15,56,64,-8,53
East Fife,8047,6,13,3,20,47,65,-18,42
Airdrieon,8047,7,10,11,15,45,59,-14,41
Forfar,8047,8,11,5,20,39,64,-25,38
Albion,8047,9,8,6,22,59,81,-22,30
Queen's Park,8047,10,6,10,20,39,73,-34,28
Raith,8048,1,23,8,5,70,33,37,77
Ayr,8048,2,24,4,8,95,43,52,76
Arbroath,8048,3,17,9,10,71,49,22,60
Alloa,8048,4,17,8,11,57,45,12,59
Stranraer,8048,5,15,6,15,56,65,-9,51
Airdrieon,8048,6,11,11,14,48,59,-11,44
East Fife,8048,7,13,4,19,48,65,-17,43
Forfar,8048,8,10,5,21,39,67,-28,35
Albion,8048,9,8,6,22,58,83,-25,30
Queen's Park,8048,10,6,11,19,40,73,-33,29
Raith,8049,1,23,8,5,71,32,39,77
Ayr,8049,2,24,4,8,94,42,52,76
Arbroath,8049,3,18,8,10,73,48,25,62
Alloa,8049,4,17,8,11,56,46,10,59
Stranraer,8049,5,16,5,15,59,64,-5,53
Airdrieon,8049,6,10,12,14,47,60,-13,42
East Fife,8049,7,13,3,20,47,68,-21,42
Forfar,8049,8,10,6,20,40,66,-26,36
Albion,8049,9,8,6,22,57,82,-25,30
Queen's Park,8049,10,6,10,20,39,75,-36,28
Raith,8050,1,23,8,5,71,32,39,77
Ayr,8050,2,23,4,9,92,45,47,73
Arbroath,8050,3,17,8,11,71,50,21,59
Alloa,8050,4,17,8,11,56,46,10,59
Stranraer,8050,5,15,5,16,56,66,-10,50
East Fife,8050,6,14,3,19,49,65,-16,45
Airdrieon,8050,7,11,11,14,46,58,-12,44
Forfar,8050,8,10,5,21,38,65,-27,35
Albion,8050,9,9,6,21,60,80,-20,33
Queen's Park,8050,10,7,10,19,41,73,-32,31
Ayr,8051,1,24,4,8,94,42,52,76
Raith,8051,2,22,9,5,69,33,36,75
Alloa,8051,3,17,9,10,57,44,13,60
Arbroath,8051,4,17,8,11,70,51,19,59
Stranraer,8051,5,15,5,16,56,67,-11,50
East Fife,8051,6,14,3,19,50,65,-15,45
Airdrieon,8051,7,10,11,15,45,60,-15,41
Forfar,8051,8,11,5,20,40,64,-24,38
Queen's Park,8051,9,7,10,19,42,72,-30,31
Albion,8051,10,8,6,22,57,82,-25,30
Ayr,8052,1,24,4,8,93,44,49,76
Raith,8052,2,22,8,6,68,35,33,74
Arbroath,8052,3,18,8,10,72,48,24,62
Alloa,8052,4,18,8,10,59,43,16,62
Stranraer,8052,5,15,5,16,55,65,-10,50
East Fife,8052,6,14,3,19,48,64,-16,45
Airdrieon,8052,7,10,12,14,46,59,-13,42
Forfar,8052,8,10,6,20,39,65,-26,36
Albion,8052,9,8,6,22,59,81,-22,30
Queen's Park,8052,10,6,10,20,39,74,-35,28
Raith,8053,1,23,8,5,72,33,39,77
Ayr,8053,2,23,4,9,92,45,47,73
Arbroath,8053,3,17,8,11,70,49,21,59
Alloa,8053,4,17,8,11,57,47,10,59
Stranraer,8053,5,15,5,16,55,67,-12,50
East Fife,8053,6,14,3,19,50,64,-14,45
Airdrieon,8053,7,10,12,14,46,59,-13,42
Forfar,8053,8,10,6,20,39,65,-26,36
Albion,8053,9,9,6,21,60,80,-20,33
Queen's Park,8053,10,7,10,19,40,72,-32,31
Raith,8054,1,23,8,5,70,33,37,77
Ayr,8054,2,24,4,8,92,42,50,76
Arbroath,8054,3,18,8,10,72,49,23,62
Alloa,8054,4,17,8,11,57,45,12,59
Stranraer,8054,5,16,5,15,57,65,-8,53
Airdrieon,8054,6,11,11,14,48,59,-11,44
East Fife,8054,7,13,3,20,48,66,-18,42
Forfar,8054,8,10,5,21,39,67,-28,35
Albion,8054,9,8,6,22,57,80,-23,30
Queen's Park,8054,10,6,10,20,40,74,-34,28
Raith,8055,1,23,8,5,73,33,40,77
Ayr,8055,2,24,4,8,95,43,52,76
Arbroath,8055,3,18,8,10,73,48,25,62
Alloa,8055,4,17,8,11,57,48,9,59
Stranraer,8055,5,15,5,16,56,66,-10,50
East Fife,8055,6,14,3,19,49,65,-16,45
Airdrieon,8055,7,10,11,15,45,59,-14,41
Forfar,8055,8,11,5,20,39,64,-25,38
Albion,8055,9,8,6,22,58,83,-25,30
Queen's Park,8055,10,6,10,20,39,75,-36,28
Raith,8056,1,23,8,5,70,33,37,77
Ayr,8056,2,24,4,8,95,44,51,76
Arbroath,8056,3,18,8,10,72,48,24,62
Alloa,8056,4,17,8,11,57,45,12,59
Stranraer,8056,5,16,5,15,58,65,-7,53
East Fife,8056,6,13,3,20,48,67,-19,42
Airdrieon,8056,7,10,11,15,46,60,-14,41
Forfar,8056,8,11,5,20,40,65,-25,38
Albion,8056,9,8,6,22,59,83,-24,30
Queen's Park,8056,10,6,10,20,39,74,-35,28
Raith,8057,1,23,8,5,72,32,40,77
Ayr,8057,2,24,4,8,93,44,49,76
Arbroath,8057,3,18,8,10,72,48,24,62
Alloa,8057,4,17,8,11,56,47,9,59
Stranraer,8057,5,15,6,15,57,66,-9,51
East Fife,8057,6,13,4,19,49,66,-17,43
Airdrieon,8057,7,10,12,14,47,60,-13,42
Forfar,8057,8,10,6,20,40,66,-26,36
Albion,8057,9,8,6,22,59,81,-22,30
Queen's Park,8057,10,6,10,20,39,74,-35,28
Raith,8058,1,23,8,5,70,33,37,77
Ayr,8058,2,24,4,8,92,43,49,76
Arbroath,8058,3,17,8,11,70,49,21,59
Alloa,8058,4,17,8,11,57,45,12,59
Stranraer,8058,5,15,6,15,56,65,-9,51
Airdrieon,8058,6,11,11,14,49,59,-10,44
East Fife,8058,7,13,4,19,48,65,-17,43
Forfar,8058,8,10,5,21,39,68,-29,35
Queen's Park,8058,9,7,10,19,40,72,-32,31
Albion,8058,10,8,6,22,58,80,-22,30
Ayr,8059,1,24,4,8,94,45,49,76
Raith,8059,2,22,9,5,68,32,36,75
Alloa,8059,3,17,9,10,56,43,13,60
Arbroath,8059,4,17,8,11,71,50,21,59
Stranraer,8059,5,15,5,16,56,66,-10,50
East Fife,8059,6,14,3,19,49,65,-16,45
Airdrieon,8059,7,11,11,14,46,58,-12,44
Forfar,8059,8,10,5,21,38,65,-27,35
Queen's Park,8059,9,7,10,19,41,73,-32,31
Albion,8059,10,8,6,22,60,82,-22,30
Ayr,8060,1,24,4,8,92,43,49,76
Raith,8060,2,22,9,5,69,33,36,75
Alloa,8060,3,17,9,10,57,44,13,60
Arbroath,8060,4,17,8,11,71,51,20,59
Stranraer,8060,5,16,5,15,57,64,-7,53
Airdrieon,8060,6,10,12,14,45,58,-13,42
East Fife,8060,7,13,3,20,47,66,-19,42
Forfar,8060,8,10,6,20,38,64,-26,36
Queen's Park,8060,9,7,10,19,42,73,-31,31
Albion,8060,10,8,6,22,58,80,-22,30
Raith,8061,1,22,8,6,68,33,35,74
Ayr,8061,2,23,4,9,92,45,47,73
Arbroath,8061,3,18,8,10,72,48,24,62
Alloa,8061,4,18,8,10,57,43,14,62
Stranraer,8061,5,15,6,15,57,66,-9,51
Airdrieon,8061,6,11,11,14,47,59,-12,44
East Fife,8061,7,13,4,19,49,66,-17,43
Forfar,8061,8,10,5,21,39,66,-27,35
Albion,8061,9,9,6,21,60,80,-20,33
Queen's Park,8061,10,6,10,20,39,74,-35,28
Ayr,8062,1,24,4,8,94,43,51,76
Raith,8062,2,22,8,6,68,35,33,74
Arbroath,8062,3,18,8,10,72,49,23,62
Alloa,8062,4,18,8,10,59,43,16,62
Stranraer,8062,5,15,5,16,55,65,-10,50
East Fife,8062,6,14,3,19,48,64,-16,45
Airdrieon,8062,7,11,11,14,46,58,-12,44
Forfar,8062,8,10,5,21,38,65,-27,35
Albion,8062,9,8,6,22,58,82,-24,30
Queen's Park,8062,10,6,10,20,40,74,-34,28
Ayr,8063,1,24,4,8,95,43,52,76
Raith,8063,2,22,8,6,69,34,35,74
Alloa,8063,3,18,8,10,58,44,14,62
Arbroath,8063,4,17,8,11,72,51,21,59
Stranraer,8063,5,15,6,15,56,65,-9,51
East Fife,8063,6,13,4,19,48,65,-17,43
Airdrieon,8063,7,10,11,15,46,62,-16,41
Forfar,8063,8,11,5,20,42,65,-23,38
Queen's Park,8063,9,7,10,19,42,74,-32,31
Albion,8063,10,8,6,22,58,83,-25,30
Ayr,8064,1,24,4,8,92,42,50,76
Raith,8064,2,22,9,5,68,32,36,75
Alloa,8064,3,17,9,10,56,43,13,60
Arbroath,8064,4,17,8,11,71,52,19,59
Stranraer,8064,5,15,6,15,56,65,-9,51
Airdrieon,8064,6,11,11,14,47,58,-11,44
East Fife,8064,7,13,4,19,48,65,-17,43
Forfar,8064,8,10,5,21,38,66,-28,35
Queen's Park,8064,9,7,10,19,43,73,-30,31
Albion,8064,10,8,6,22,57,80,-23,30
Ayr,8065,1,23,5,8,93,45,48,74
Raith,8065,2,22,8,6,68,35,33,74
Alloa,8065,3,18,8,10,59,43,16,62
Arbroath,8065,4,17,9,10,70,48,22,60
Stranraer,8065,5,15,6,15,57,66,-9,51
Airdrieon,8065,6,11,11,14,46,58,-12,44
East Fife,8065,7,13,4,19,49,66,-17,43
Forfar,8065,8,10,5,21,38,65,-27,35
Albion,8065,9,8,7,21,60,81,-21,31
Queen's Park,8065,10,6,11,19,39,72,-33,29
Raith,8066,1,22,9,5,68,32,36,75
Ayr,8066,2,23,4,9,92,46,46,73
Arbroath,8066,3,18,8,10,71,48,23,62
Alloa,8066,4,17,9,10,56,43,13,60
Stranraer,8066,5,15,6,15,57,66,-9,51
East Fife,8066,6,13,4,19,49,66,-17,43
Airdrieon,8066,7,10,11,15,46,60,-14,41
Forfar,8066,8,11,5,20,40,65,-25,38
Albion,8066,9,9,6,21,61,80,-19,33
Queen's Park,8066,10,6,10,20,39,73,-34,28
Raith,8067,1,23,8,5,70,32,38,77
Ayr,8067,2,23,5,8,91,43,48,74
Arbroath,8067,3,17,9,10,72,50,22,60
Alloa,8067,4,17,8,11,56,45,11,59
Stranraer,8067,5,16,5,15,59,64,-5,53
East Fife,8067,6,13,3,20,47,68,-21,42
Airdrieon,8067,7,10,11,15,46,60,-14,41
Forfar,8067,8,11,5,20,40,65,-25,38
Albion,8067,9,8,7,21,58,79,-21,31
Queen's Park,8067,10,6,11,19,41,74,-33,29
Raith,8068,1,23,8,5,72,32,40,77
Ayr,8068,2,23,5,8,91,43,48,74
Arbroath,8068,3,17,9,10,71,49,22,60
Alloa,8068,4,17,8,11,56,47,9,59
Stranraer,8068,5,15,6,15,56,65,-9,51
Airdrieon,8068,6,11,11,14,47,59,-12,44
East Fife,8068,7,13,4,19,48,65,-17,43
Forfar,8068,8,10,5,21,39,66,-27,35
Albion,8068,9,8,7,21,58,79,-21,31
Queen's Park,8068,10,6,11,19,40,73,-33,29
Ayr,8069,1,24,4,8,96,42,54,76
Raith,8069,2,22,9,5,70,34,36,75
Alloa,8069,3,17,9,10,58,45,13,60
Arbroath,8069,4,17,8,11,74,53,21,59
Stranraer,8069,5,15,5,16,56,67,-11,50
East Fife,8069,6,14,3,19,50,65,-15,45
Airdrieon,8069,7,11,11,14,48,60,-12,44
Forfar,8069,8,10,5,21,40,67,-27,35
Queen's Park,8069,9,7,10,19,44,76,-32,31
Albion,8069,10,8,6,22,57,84,-27,30
Raith,8070,1,23,8,5,70,33,37,77
Ayr,8070,2,24,4,8,93,43,50,76
Arbroath,8070,3,17,9,10,71,49,22,60
Alloa,8070,4,17,8,11,57,45,12,59
Stranraer,8070,5,16,5,15,57,64,-7,53
Airdrieon,8070,6,11,11,14,47,59,-12,44
East Fife,8070,7,13,3,20,47,66,-19,42
Forfar,8070,8,10,5,21,39,66,-27,35
Albion,8070,9,8,6,22,58,81,-23,30
Queen's Park,8070,10,6,11,19,40,73,-33,29
Raith,8071,1,23,8,5,70,32,38,77
Ayr,8071,2,23,5,8,94,46,48,74
Arbroath,8071,3,18,8,10,72,49,23,62
Alloa,8071,4,17,8,11,56,45,11,59
Stranraer,8071,5,16,5,15,57,65,-8,53
Airdrieon,8071,6,10,12,14,47,60,-13,42
East Fife,8071,7,13,3,20,48,66,-18,42
Forfar,8071,8,10,6,20,40,66,-26,36
Albion,8071,9,8,7,21,61,82,-21,31
Queen's Park,8071,10,6,10,20,40,74,-34,28
Ayr,8072,1,24,4,8,93,43,50,76
Raith,8072,2,22,9,5,69,33,36,75
Arbroath,8072,3,18,8,10,75,48,27,62
Alloa,8072,4,17,9,10,57,44,13,60
Stranraer,8072,5,15,5,16,56,66,-10,50
East Fife,8072,6,14,3,19,49,65,-16,45
Airdrieon,8072,7,10,12,14,47,60,-13,42
Forfar,8072,8,10,6,20,40,66,-26,36
Albion,8072,9,8,6,22,58,81,-23,30
Queen's Park,8072,10,6,10,20,39,77,-38,28
Raith,8073,1,23,8,5,71,33,38,77
Ayr,8073,2,24,4,8,95,45,50,76
Arbroath,8073,3,17,9,10,72,50,22,60
Alloa,8073,4,17,8,11,57,46,11,59
Stranraer,8073,5,15,6,15,59,68,-9,51
Airdrieon,8073,6,11,11,14,46,58,-12,44
East Fife,8073,7,13,4,19,51,68,-17,43
Forfar,8073,8,10,5,21,38,65,-27,35
Albion,8073,9,8,6,22,60,83,-23,30
Queen's Park,8073,10,6,11,19,41,74,-33,29
Raith,8074,1,23,8,5,72,32,40,77
Ayr,8074,2,24,4,8,92,42,50,76
Arbroath,8074,3,17,8,11,70,50,20,59
Alloa,8074,4,17,8,11,56,47,9,59
Stranraer,8074,5,16,5,15,57,65,-8,53
Airdrieon,8074,6,10,12,14,46,59,-13,42
East Fife,8074,7,13,3,20,48,66,-18,42
Forfar,8074,8,10,6,20,39,65,-26,36
Queen's Park,8074,9,7,10,19,41,72,-31,31
Albion,8074,10,8,6,22,57,80,-23,30
Raith,8075,1,23,8,5,70,33,37,77
Ayr,8075,2,24,4,8,92,42,50,76
Arbroath,8075,3,18,8,10,74,49,25,62
Alloa,8075,4,17,8,11,57,45,12,59
Stranraer,8075,5,16,5,15,56,64,-8,53
Airdrieon,8075,6,10,12,14,45,58,-13,42
East Fife,8075,7,13,3,20,47,65,-18,42
Forfar,8075,8,10,6,20,38,64,-26,36
Albion,8075,9,8,6,22,57,80,-23,30
Queen's Park,8075,10,6,10,20,40,76,-36,28
Ayr,8076,1,23,5,8,93,45,48,74
Raith,8076,2,22,8,6,71,36,35,74
Arbroath,8076,3,18,8,10,72,49,23,62
Alloa,8076,4,18,8,10,60,46,14,62
Stranraer,8076,5,15,6,15,56,65,-9,51
Airdrieon,8076,6,11,11,14,47,59,-12,44
East Fife,8076,7,13,4,19,48,65,-17,43
Forfar,8076,8,10,5,21,39,66,-27,35
Albion,8076,9,8,7,21,60,81,-21,31
Queen's Park,8076,10,6,10,20,40,74,-34,28
Ayr,8077,1,24,4,8,93,43,50,76
Raith,8077,2,22,8,6,68,33,35,74
Alloa,8077,3,18,8,10,57,43,14,62
Arbroath,8077,4,17,8,11,71,51,20,59
Stranraer,8077,5,15,5,16,55,65,-10,50
East Fife,8077,6,14,3,19,48,64,-16,45
Airdrieon,8077,7,11,11,14,47,59,-12,44
Forfar,8077,8,10,5,21,39,66,-27,35
Queen's Park,8077,9,7,10,19,42,73,-31,31
Albion,8077,10,8,6,22,58,81,-23,30
Raith,8078,1,23,8,5,69,32,37,77
Ayr,8078,2,24,4,8,94,43,51,76
Arbroath,8078,3,17,9,10,71,49,22,60
Alloa,8078,4,17,8,11,56,44,12,59
Stranraer,8078,5,16,5,15,57,64,-7,53
Airdrieon,8078,6,11,11,14,51,58,-7,44
East Fife,8078,7,13,3,20,47,66,-19,42
Forfar,8078,8,10,5,21,38,70,-32,35
Albion,8078,9,8,6,22,58,82,-24,30
Queen's Park,8078,10,6,11,19,40,73,-33,29
Raith,8079,1,23,8,5,70,33,37,77
Ayr,8079,2,23,5,8,91,43,48,74
Arbroath,8079,3,18,8,10,72,48,24,62
Alloa,8079,4,17,8,11,57,45,12,59
Stranraer,8079,5,15,5,16,56,66,-10,50
East Fife,8079,6,14,3,19,49,65,-16,45
Airdrieon,8079,7,11,11,14,47,58,-11,44
Forfar,8079,8,10,5,21,38,66,-28,35
Albion,8079,9,8,7,21,58,79,-21,31
Queen's Park,8079,10,6,10,20,39,74,-35,28
Raith,8080,1,22,9,5,70,34,36,75
Ayr,8080,2,23,4,9,91,44,47,73
Arbroath,8080,3,17,9,10,72,50,22,60
Alloa,8080,4,17,9,10,58,45,13,60
Stranraer,8080,5,15,5,16,56,66,-10,50
East Fife,8080,6,14,3,19,49,65,-16,45
Airdrieon,8080,7,11,11,14,47,58,-11,44
Forfar,8080,8,10,5,21,38,66,-28,35
Albion,8080,9,9,6,21,59,79,-20,33
Queen's Park,8080,10,6,11,19,41,74,-33,29
Raith,8081,1,23,8,5,71,33,38,77
Ayr,8081,2,24,4,8,94,44,50,76
Arbroath,8081,3,17,8,11,72,52,20,59
Alloa,8081,4,17,8,11,57,46,11,59
Stranraer,8081,5,16,5,15,58,65,-7,53
Airdrieon,8081,6,10,12,14,45,58,-13,42
East Fife,8081,7,13,3,20,48,67,-19,42
Forfar,8081,8,10,6,20,38,64,-26,36
Queen's Park,8081,9,7,10,19,43,74,-31,31
Albion,8081,10,8,6,22,59,82,-23,30
Ayr,8082,1,24,4,8,92,43,49,76
Raith,8082,2,22,8,6,68,34,34,74
Alloa,8082,3,18,8,10,58,43,15,62
Arbroath,8082,4,17,9,10,71,49,22,60
Stranraer,8082,5,15,5,16,56,66,-10,50
East Fife,8082,6,14,3,19,49,65,-16,45
Airdrieon,8082,7,11,11,14,46,58,-12,44
Forfar,8082,8,10,5,21,38,65,-27,35
Albion,8082,9,8,6,22,58,80,-22,30
Queen's Park,8082,10,6,11,19,40,73,-33,29
Raith,8083,1,23,8,5,71,34,37,77
Ayr,8083,2,24,4,8,94,42,52,76
Arbroath,8083,3,17,9,10,70,48,22,60
Alloa,8083,4,17,8,11,58,46,12,59
Stranraer,8083,5,15,5,16,56,66,-10,50
East Fife,8083,6,14,3,19,49,65,-16,45
Airdrieon,8083,7,10,11,15,46,60,-14,41
Forfar,8083,8,11,5,20,40,65,-25,38
Albion,8083,9,8,6,22,57,82,-25,30
Queen's Park,8083,10,6,11,19,39,72,-33,29
Raith,8084,1,23,8,5,71,34,37,77
Ayr,8084,2,24,4,8,97,42,55,76
Arbroath,8084,3,18,8,10,72,48,24,62
Alloa,8084,4,17,8,11,58,46,12,59
Stranraer,8084,5,15,5,16,56,68,-12,50
East Fife,8084,6,14,3,19,51,65,-14,45
Airdrieon,8084,7,10,11,15,45,60,-15,41
Forfar,8084,8,11,5,20,40,64,-24,38
Albion,8084,9,8,6,22,57,85,-28,30
Queen's Park,8084,10,6,10,20,39,74,-35,28
Ayr,8085,1,24,4,8,93,43,50,76
Raith,8085,2,22,8,6,69,34,35,74
Arbroath,8085,3,18,8,10,76,49,27,62
Alloa,8085,4,18,8,10,58,44,14,62
Stranraer,8085,5,15,5,16,56,66,-10,50
East Fife,8085,6,14,3,19,49,65,-16,45
Airdrieon,8085,7,11,11,14,47,59,-12,44
Forfar,8085,8,10,5,21,39,66,-27,35
Albion,8085,9,8,6,22,58,81,-23,30
Queen's Park,8085,10,6,10,20,40,78,-38,28
Raith,8086,1,23,8,5,70,32,38,77
Ayr,8086,2,24,4,8,95,42,53,76
Arbroath,8086,3,18,8,10,72,49,23,62
Alloa,8086,4,17,8,11,56,45,11,59
Stranraer,8086,5,15,5,16,55,65,-10,50
East Fife,8086,6,14,3,19,48,64,-16,45
Airdrieon,8086,7,11,11,14,49,58,-9,44
Forfar,8086,8,10,5,21,38,68,-30,35
Albion,8086,9,8,6,22,57,83,-26,30
Queen's Park,8086,10,6,10,20,40,74,-34,28
Ayr,8087,1,24,4,8,93,43,50,76
Raith,8087,2,22,8,6,68,35,33,74
Arbroath,8087,3,18,8,10,73,49,24,62
Alloa,8087,4,18,8,10,59,43,16,62
Stranraer,8087,5,15,6,15,58,67,-9,51
Airdrieon,8087,6,11,11,14,49,59,-10,44
East Fife,8087,7,13,4,19,50,67,-17,43
Forfar,8087,8,10,5,21,39,68,-29,35
Albion,8087,9,8,6,22,58,81,-23,30
Queen's Park,8087,10,6,10,20,40,75,-35,28
Ayr,8088,1,24,4,8,94,44,50,76
Raith,8088,2,22,8,6,68,34,34,74
Alloa,8088,3,18,8,10,58,43,15,62
Arbroath,8088,4,17,9,10,72,50,22,60
Stranraer,8088,5,15,5,16,56,67,-11,50
East Fife,8088,6,14,3,19,50,65,-15,45
Airdrieon,8088,7,11,11,14,46,58,-12,44
Forfar,8088,8,10,5,21,38,65,-27,35
Albion,8088,9,8,6,22,59,82,-23,30
Queen's Park,8088,10,6,11,19,41,74,-33,29
Raith,8089,1,23,8,5,69,32,37,77
Ayr,8089,2,24,4,8,95,43,52,76
Arbroath,8089,3,17,8,11,70,49,21,59
Alloa,8089,4,17,8,11,56,44,12,59
Stranraer,8089,5,15,5,16,56,66,-10,50
East Fife,8089,6,14,3,19,49,65,-16,45
Airdrieon,8089,7,11,11,14,50,59,-9,44
Forfar,8089,8,10,5,21,39,69,-30,35
Queen's Park,8089,9,7,10,19,40,72,-32,31
Albion,8089,10,8,6,22,58,83,-25,30
Raith,8090,1,23,8,5,70,32,38,77
Ayr,8090,2,24,4,8,96,43,53,76
Arbroath,8090,3,18,8,10,73,49,24,62
Alloa,8090,4,17,8,11,56,45,11,59
Stranraer,8090,5,16,5,15,56,64,-8,53
Airdrieon,8090,6,11,11,14,48,59,-11,44
East Fife,8090,7,13,3,20,47,65,-18,42
Forfar,8090,8,10,5,21,39,67,-28,35
Albion,8090,9,8,6,22,58,84,-26,30
Queen's Park,8090,10,6,10,20,40,75,-35,28
Raith,8091,1,23,8,5,70,32,38,77
Ayr,8091,2,24,4,8,95,42,53,76
Arbroath,8091,3,17,8,11,71,51,20,59
Alloa,8091,4,17,8,11,56,45,11,59
Stranraer,8091,5,16,5,15,59,65,-6,53
East Fife,8091,6,13,3,20,48,68,-20,42
Airdrieon,8091,7,10,11,15,45,61,-16,41
Forfar,8091,8,11,5,20,41,64,-23,38
Queen's Park,8091,9,7,10,19,42,73,-31,31
Albion,8091,10,8,6,22,57,83,-26,30
Ayr,8092,1,24,4,8,93,44,49,76
Raith,8092,2,22,9,5,68,32,36,75
Alloa,8092,3,17,9,10,56,43,13,60
Arbroath,8092,4,17,8,11,73,52,21,59
Stranraer,8092,5,16,5,15,59,65,-6,53
Airdrieon,8092,6,11,11,14,47,58,-11,44
East Fife,8092,7,13,3,20,48,68,-20,42
Forfar,8092,8,10,5,21,38,66,-28,35
Queen's Park,8092,9,7,10,19,43,75,-32,31
Albion,8092,10,8,6,22,59,81,-22,30
Ayr,8093,1,23,5,8,92,44,48,74
Raith,8093,2,22,8,6,68,33,35,74
Alloa,8093,3,18,8,10,57,43,14,62
Arbroath,8093,4,17,8,11,70,50,20,59
Stranraer,8093,5,15,5,16,56,67,-11,50
East Fife,8093,6,14,3,19,50,65,-15,45
Airdrieon,8093,7,10,11,15,45,60,-15,41
Forfar,8093,8,11,5,20,40,64,-24,38
Albion,8093,9,8,7,21,59,80,-21,31
Queen's Park,8093,10,7,10,19,41,72,-31,31
Ayr,8094,1,24,4,8,93,43,50,76
Raith,8094,2,22,8,6,69,34,35,74
Alloa,8094,3,18,8,10,58,44,14,62
Arbroath,8094,4,17,8,11,72,51,21,59
Stranraer,8094,5,15,6,15,56,65,-9,51
Airdrieon,8094,6,11,11,14,48,60,-12,44
East Fife,8094,7,13,4,19,48,65,-17,43
Forfar,8094,8,10,5,21,40,67,-27,35
Queen's Park,8094,9,7,10,19,42,74,-32,31
Albion,8094,10,8,6,22,58,81,-23,30
Ayr,8095,1,24,4,8,96,44,52,76
Raith,8095,2,22,9,5,69,33,36,75
Arbroath,8095,3,18,8,10,71,48,23,62
Alloa,8095,4,17,9,10,57,44,13,60
Stranraer,8095,5,16,5,15,57,65,-8,53
Airdrieon,8095,6,11,11,14,48,58,-10,44
East Fife,8095,7,13,3,20,48,66,-18,42
Forfar,8095,8,10,5,21,38,67,-29,35
Albion,8095,9,8,6,22,59,84,-25,30
Queen's Park,8095,10,6,10,20,39,73,-34,28
Raith,8096,1,23,8,5,70,32,38,77
Ayr,8096,2,24,4,8,97,43,54,76
Arbroath,8096,3,18,8,10,75,48,27,62
Alloa,8096,4,17,8,11,56,45,11,59
Stranraer,8096,5,15,5,16,56,66,-10,50
East Fife,8096,6,14,3,19,49,65,-16,45
Airdrieon,8096,7,10,12,14,45,58,-13,42
Forfar,8096,8,10,6,20,38,64,-26,36
Albion,8096,9,8,6,22,58,85,-27,30
Queen's Park,8096,10,6,10,20,39,77,-38,28
Raith,8097,1,23,8,5,70,32,38,77
Ayr,8097,2,24,4,8,98,45,53,76
Arbroath,8097,3,17,8,11,71,50,21,59
Alloa,8097,4,17,8,11,56,45,11,59
Stranraer,8097,5,15,6,15,55,64,-9,51
Airdrieon,8097,6,11,11,14,48,58,-10,44
East Fife,8097,7,13,4,19,47,64,-17,43
Forfar,8097,8,10,5,21,38,67,-29,35
Queen's Park,8097,9,7,10,19,41,73,-32,31
Albion,8097,10,8,6,22,60,86,-26,30
Ayr,8098,1,24,4,8,93,44,49,76
Raith,8098,2,22,9,5,69,33,36,75
Arbroath,8098,3,18,8,10,72,48,24,62
Alloa,8098,4,17,9,10,57,44,13,60
Stranraer,8098,5,15,5,16,56,66,-10,50
East Fife,8098,6,14,3,19,49,65,-16,45
Airdrieon,8098,7,10,11,15,46,61,-15,41
Forfar,8098,8,11,5,20,41,65,-24,38
Albion,8098,9,8,6,22,59,81,-22,30
Queen's Park,8098,10,6,10,20,39,74,-35,28
Raith,8099,1,23,8,5,71,32,39,77
Ayr,8099,2,24,4,8,95,43,52,76
Arbroath,8099,3,18,8,10,73,49,24,62
Alloa,8099,4,17,8,11,56,46,10,59
Stranraer,8099,5,15,6,15,58,67,-9,51
Airdrieon,8099,6,11,11,14,47,59,-12,44
East Fife,8099,7,13,4,19,50,67,-17,43
Forfar,8099,8,10,5,21,39,66,-27,35
Albion,8099,9,8,6,22,58,83,-25,30
Queen's Park,8099,10,6,10,20,40,75,-35,28
Raith,8100,1,23,8,5,70,32,38,77
Ayr,8100,2,24,4,8,92,43,49,76
Arbroath,8100,3,17,8,11,70,49,21,59
Alloa,8100,4,17,8,11,56,45,11,59
Stranraer,8100,5,15,5,16,55,65,-10,50
East Fife,8100,6,14,3,19,48,64,-16,45
Airdrieon,8100,7,11,11,14,47,58,-11,44
Forfar,8100,8,10,5,21,38,66,-28,35
Queen's Park,8100,9,7,10,19,40,72,-32,31
Albion,8100,10,8,6,22,58,80,-22,30
Ayr,8101,1,24,4,8,93,44,49,76
Raith,8101,2,22,8,6,68,33,35,74
Arbroath,8101,3,18,8,10,73,49,24,62
Alloa,8101,4,18,8,10,57,43,14,62
Stranraer,8101,5,16,5,15,57,64,-7,53
East Fife,8101,6,13,3,20,47,66,-19,42
Airdrieon,8101,7,10,11,15,45,59,-14,41
Forfar,8101,8,11,5,20,39,64,-25,38
Albion,8101,9,8,6,22,59,81,-22,30
Queen's Park,8101,10,6,10,20,40,75,-35,28
Ayr,8102,1,24,4,8,95,44,51,76
Raith,8102,2,22,8,6,68,33,35,74
Alloa,8102,3,18,8,10,57,43,14,62
Arbroath,8102,4,17,8,11,70,49,21,59
Stranraer,8102,5,15,5,16,55,67,-12,50
East Fife,8102,6,14,3,19,50,64,-14,45
Airdrieon,8102,7,10,11,15,45,60,-15,41
Forfar,8102,8,11,5,20,40,64,-24,38
Queen's Park,8102,9,7,10,19,40,72,-32,31
Albion,8102,10,8,6,22,59,83,-24,30
Ayr,8103,1,24,4,8,97,44,53,76
Raith,8103,2,22,8,6,69,34,35,74
Arbroath,8103,3,18,8,10,72,49,23,62
Alloa,8103,4,18,8,10,58,44,14,62
Stranraer,8103,5,15,5,16,55,65,-10,50
East Fife,8103,6,14,3,19,48,64,-16,45
Airdrieon,8103,7,11,11,14,46,58,-12,44
Forfar,8103,8,10,5,21,38,65,-27,35
Albion,8103,9,8,6,22,59,85,-26,30
Queen's Park,8103,10,6,10,20,40,74,-34,28
Raith,8104,1,23,8,5,69,32,37,77
Ayr,8104,2,23,5,8,93,45,48,74
Arbroath,8104,3,18,8,10,73,50,23,62
Alloa,8104,4,17,8,11,56,44,12,59
Stranraer,8104,5,15,6,15,55,64,-9,51
East Fife,8104,6,13,4,19,47,64,-17,43
Airdrieon,8104,7,10,12,14,47,60,-13,42
Forfar,8104,8,10,6,20,40,66,-26,36
Albion,8104,9,8,7,21,60,81,-21,31
Queen's Park,8104,10,6,10,20,41,75,-34,28
Raith,8105,1,23,8,5,70,32,38,77
Ayr,8105,2,24,4,8,96,44,52,76
Arbroath,8105,3,17,8,11,72,51,21,59
Alloa,8105,4,17,8,11,56,45,11,59
Stranraer,8105,5,16,5,15,58,65,-7,53
Airdrieon,8105,6,11,11,14,48,58,-10,44
East Fife,8105,7,13,3,20,48,67,-19,42
Forfar,8105,8,10,5,21,38,67,-29,35
Queen's Park,8105,9,7,10,19,42,74,-32,31
Albion,8105,10,8,6,22,59,84,-25,30
Raith,8106,1,23,8,5,70,32,38,77
Ayr,8106,2,24,4,8,92,42,50,76
Arbroath,8106,3,17,8,11,71,50,21,59
Alloa,8106,4,17,8,11,56,45,11,59
Stranraer,8106,5,15,5,16,55,67,-12,50
East Fife,8106,6,14,3,19,50,64,-14,45
Airdrieon,8106,7,11,11,14,46,58,-12,44
Forfar,8106,8,10,5,21,38,65,-27,35
Queen's Park,8106,9,7,10,19,41,73,-32,31
Albion,8106,10,8,6,22,57,80,-23,30
Ayr,8107,1,24,4,8,95,43,52,76
Raith,8107,2,22,9,5,68,32,36,75
Arbroath,8107,3,18,8,10,74,49,25,62
Alloa,8107,4,17,9,10,56,43,13,60
Stranraer,8107,5,15,6,15,58,67,-9,51
Airdrieon,8107,6,11,11,14,47,58,-11,44
East Fife,8107,7,13,4,19,50,67,-17,43
Forfar,8107,8,10,5,21,38,66,-28,35
Albion,8107,9,8,6,22,58,83,-25,30
Queen's Park,8107,10,6,10,20,40,76,-36,28
Raith,8108,1,23,8,5,70,32,38,77
Ayr,8108,2,24,4,8,95,42,53,76
Arbroath,8108,3,17,8,11,70,49,21,59
Alloa,8108,4,17,8,11,56,45,11,59
Stranraer,8108,5,15,6,15,56,65,-9,51
Airdrieon,8108,6,11,11,14,47,59,-12,44
East Fife,8108,7,13,4,19,48,65,-17,43
Forfar,8108,8,10,5,21,39,66,-27,35
Queen's Park,8108,9,7,10,19,40,72,-32,31
Albion,8108,10,8,6,22,57,83,-26,30
Ayr,8109,1,24,4,8,91,42,49,76
Raith,8109,2,22,8,6,68,33,35,74
Alloa,8109,3,18,8,10,57,43,14,62
Arbroath,8109,4,17,9,10,71,49,22,60
Stranraer,8109,5,16,5,15,60,64,-4,53
Airdrieon,8109,6,11,11,14,50,61,-11,44
East Fife,8109,7,13,3,20,47,69,-22,42
Forfar,8109,8,10,5,21,41,69,-28,35
Albion,8109,9,8,6,22,57,79,-22,30
Queen's Park,8109,10,6,11,19,40,73,-33,29
Raith,8110,1,23,8,5,70,33,37,77
Ayr,8110,2,23,4,9,92,46,46,73
Arbroath,8110,3,17,8,11,71,50,21,59
Alloa,8110,4,17,8,11,57,45,12,59
Stranraer,8110,5,15,6,15,57,66,-9,51
Airdrieon,8110,6,11,11,14,46,58,-12,44
East Fife,8110,7,13,4,19,49,66,-17,43
Forfar,8110,8,10,5,21,38,65,-27,35
Albion,8110,9,9,6,21,61,80,-19,33
Queen's Park,8110,10,7,10,19,41,73,-32,31
Raith,8111,1,23,8,5,71,32,39,77
Ayr,8111,2,24,4,8,97,43,54,76
Arbroath,8111,3,18,8,10,72,48,24,62
Alloa,8111,4,17,8,11,56,46,10,59
Stranraer,8111,5,15,5,16,55,66,-11,50
East Fife,8111,6,14,3,19,49,64,-15,45
Airdrieon,8111,7,10,12,14,46,59,-13,42
Forfar,8111,8,10,6,20,39,65,-26,36
Albion,8111,9,8,6,22,58,85,-27,30
Queen's Park,8111,10,6,10,20,39,74,-35,28
Raith,8112,1,23,8,5,72,32,40,77
Ayr,8112,2,24,4,8,92,43,49,76
Arbroath,8112,3,18,8,10,75,50,25,62
Alloa,8112,4,17,8,11,56,47,9,59
Stranraer,8112,5,15,5,16,55,66,-11,50
East Fife,8112,6,14,3,19,49,64,-15,45
Airdrieon,8112,7,11,11,14,47,59,-12,44
Forfar,8112,8,10,5,21,39,66,-27,35
Albion,8112,9,8,6,22,58,80,-22,30
Queen's Park,8112,10,6,10,20,41,77,-36,28
Raith,8113,1,23,8,5,69,32,37,77
Ayr,8113,2,24,4,8,91,42,49,76
Arbroath,8113,3,17,8,11,71,50,21,59
Alloa,8113,4,17,8,11,56,44,12,59
Stranraer,8113,5,16,5,15,57,65,-8,53
Airdrieon,8113,6,10,12,14,46,59,-13,42
East Fife,8113,7,13,3,20,48,66,-18,42
Forfar,8113,8,10,6,20,39,65,-26,36
Queen's Park,8113,9,7,10,19,41,73,-32,31
Albion,8113,10,8,6,22,57,79,-22,30
Ayr,8114,1,24,4,8,92,43,49,76
Raith,8114,2,22,8,6,69,34,35,74
Alloa,8114,3,18,8,10,58,44,14,62
Arbroath,8114,4,17,8,11,73,52,21,59
Stranraer,8114,5,15,5,16,55,65,-10,50
East Fife,8114,6,14,3,19,48,64,-16,45
Airdrieon,8114,7,11,11,14,49,59,-10,44
Forfar,8114,8,10,5,21,39,68,-29,35
Queen's Park,8114,9,7,10,19,43,75,-32,31
Albion,8114,10,8,6,22,58,80,-22,30
Raith,8115,1,23,8,5,72,32,40,77
Ayr,8115,2,24,4,8,94,42,52,76
Arbroath,8115,3,18,8,10,75,49,26,62
Alloa,8115,4,17,8,11,56,47,9,59
Stranraer,8115,5,15,5,16,55,65,-10,50
East Fife,8115,6,14,3,19,48,64,-16,45
Airdrieon,8115,7,10,11,15,46,60,-14,41
Forfar,8115,8,11,5,20,40,65,-25,38
Albion,8115,9,8,6,22,57,82,-25,30
Queen's Park,8115,10,6,10,20,40,77,-37,28
Raith,8116,1,23,8,5,69,32,37,77
Ayr,8116,2,24,4,8,94,42,52,76
Arbroath,8116,3,18,8,10,73,48,25,62
Alloa,8116,4,17,8,11,56,44,12,59
Stranraer,8116,5,15,6,15,56,65,-9,51
East Fife,8116,6,13,4,19,48,65,-17,43
Airdrieon,8116,7,10,12,14,47,60,-13,42
Forfar,8116,8,10,6,20,40,66,-26,36
Albion,8116,9,8,6,22,57,82,-25,30
Queen's Park,8116,10,6,10,20,39,75,-36,28
Ayr,8117,1,24,4,8,98,44,54,76
Raith,8117,2,22,9,5,70,34,36,75
Arbroath,8117,3,18,8,10,72,48,24,62
Alloa,8117,4,17,9,10,58,45,13,60
Stranraer,8117,5,15,5,16,55,65,-10,50
East Fife,8117,6,14,3,19,48,64,-16,45
Airdrieon,8117,7,10,12,14,46,59,-13,42
Forfar,8117,8,10,6,20,39,65,-26,36
Albion,8117,9,8,6,22,59,86,-27,30
Queen's Park,8117,10,6,10,20,39,74,-35,28
Raith,8118,1,23,8,5,69,32,37,77
Ayr,8118,2,24,4,8,93,43,50,76
Arbroath,8118,3,18,8,10,73,49,24,62
Alloa,8118,4,17,8,11,56,44,12,59
Stranraer,8118,5,15,5,16,55,66,-11,50
East Fife,8118,6,14,3,19,49,64,-15,45
Airdrieon,8118,7,10,11,15,45,59,-14,41
Forfar,8118,8,11,5,20,39,64,-25,38
Albion,8118,9,8,6,22,58,81,-23,30
Queen's Park,8118,10,6,10,20,40,75,-35,28
Ayr,8119,1,24,4,8,96,42,54,76
Raith,8119,2,22,8,6,68,33,35,74
Arbroath,8119,3,18,8,10,72,48,24,62
Alloa,8119,4,18,8,10,57,43,14,62
Stranraer,8119,5,16,5,15,59,66,-7,53
Airdrieon,8119,6,11,11,14,46,58,-12,44
East Fife,8119,7,13,3,20,49,68,-19,42
Forfar,8119,8,10,5,21,38,65,-27,35
Albion,8119,9,8,6,22,57,84,-27,30
Queen's Park,8119,10,6,10,20,39,74,-35,28
Ayr,8120,1,24,4,8,92,43,49,76
Raith,8120,2,22,8,6,70,35,35,74
Alloa,8120,3,18,8,10,59,45,14,62
Arbroath,8120,4,17,8,11,70,50,20,59
Stranraer,8120,5,15,5,16,55,67,-12,50
East Fife,8120,6,14,3,19,50,64,-14,45
Airdrieon,8120,7,10,12,14,46,59,-13,42
Forfar,8120,8,10,6,20,39,65,-26,36
Queen's Park,8120,9,7,10,19,41,72,-31,31
Albion,8120,10,8,6,22,58,80,-22,30
Raith,8121,1,23,8,5,71,34,37,77
Ayr,8121,2,24,4,8,95,45,50,76
Arbroath,8121,3,18,8,10,73,49,24,62
Alloa,8121,4,17,8,11,58,46,12,59
Stranraer,8121,5,16,5,15,59,65,-6,53
Airdrieon,8121,6,11,11,14,49,59,-10,44
East Fife,8121,7,13,3,20,48,68,-20,42
Forfar,8121,8,10,5,21,39,68,-29,35
Albion,8121,9,8,6,22,60,83,-23,30
Queen's Park,8121,10,6,10,20,40,75,-35,28
Raith,8122,1,23,8,5,69,32,37,77
Ayr,8122,2,24,4,8,94,44,50,76
Arbroath,8122,3,17,8,11,70,50,20,59
Alloa,8122,4,17,8,11,56,44,12,59
Stranraer,8122,5,15,6,15,57,66,-9,51
Airdrieon,8122,6,11,11,14,47,58,-11,44
East Fife,8122,7,13,4,19,49,66,-17,43
Forfar,8122,8,10,5,21,38,66,-28,35
Queen's Park,8122,9,7,10,19,41,72,-31,31
Albion,8122,10,8,6,22,59,82,-23,30
Raith,8123,1,23,8,5,70,32,38,77
Ayr,8123,2,24,4,8,94,43,51,76
Arbroath,8123,3,17,9,10,71,49,22,60
Alloa,8123,4,17,8,11,56,45,11,59
Stranraer,8123,5,15,6,15,56,65,-9,51
Airdrieon,8123,6,11,11,14,49,58,-9,44
East Fife,8123,7,13,4,19,48,65,-17,43
Forfar,8123,8,10,5,21,38,68,-30,35
Albion,8123,9,8,6,22,58,82,-24,30
Queen's Park,8123,10,6,11,19,40,73,-33,29
Raith,8124,1,23,8,5,70,33,37,77
Ayr,8124,2,24,4,8,91,42,49,76
Arbroath,8124,3,17,9,10,71,49,22,60
Alloa,8124,4,17,8,11,57,45,12,59
Stranraer,8124,5,15,6,15,55,64,-9,51
Airdrieon,8124,6,11,11,14,47,59,-12,44
East Fife,8124,7,13,4,19,47,64,-17,43
Forfar,8124,8,10,5,21,39,66,-27,35
Albion,8124,9,8,6,22,57,79,-22,30
Queen's Park,8124,10,6,11,19,40,73,-33,29
Raith,8125,1,23,8,5,71,32,39,77
Ayr,8125,2,24,4,8,93,42,51,76
Arbroath,8125,3,18,8,10,72,49,23,62
Alloa,8125,4,17,8,11,56,46,10,59
Stranraer,8125,5,15,5,16,55,66,-11,50
East Fife,8125,6,14,3,19,49,64,-15,45
Airdrieon,8125,7,10,11,15,46,60,-14,41
Forfar,8125,8,11,5,20,40,65,-25,38
Albion,8125,9,8,6,22,57,81,-24,30
Queen's Park,8125,10,6,10,20,40,74,-34,28
Raith,8126,1,23,8,5,69,32,37,77
Ayr,8126,2,24,4,8,95,42,53,76
Arbroath,8126,3,18,8,10,71,48,23,62
Alloa,8126,4,17,8,11,56,44,12,59
Stranraer,8126,5,15,5,16,56,66,-10,50
East Fife,8126,6,14,3,19,49,65,-16,45
Airdrieon,8126,7,11,11,14,49,59,-10,44
Forfar,8126,8,10,5,21,39,68,-29,35
Albion,8126,9,8,6,22,57,83,-26,30
Queen's Park,8126,10,6,10,20,39,73,-34,28
Ayr,8127,1,24,4,8,92,42,50,76
Raith,8127,2,22,9,5,70,34,36,75
Arbroath,8127,3,17,9,10,72,50,22,60
Alloa,8127,4,17,9,10,58,45,13,60
Stranraer,8127,5,16,5,15,57,65,-8,53
Airdrieon,8127,6,10,12,14,45,58,-13,42
East Fife,8127,7,13,3,20,48,66,-18,42
Forfar,8127,8,10,6,20,38,64,-26,36
Albion,8127,9,8,6,22,57,80,-23,30
Queen's Park,8127,10,6,11,19,41,74,-33,29
Raith,8128,1,23,8,5,70,32,38,77
Ayr,8128,2,24,4,8,94,43,51,76
Arbroath,8128,3,17,9,10,71,49,22,60
Alloa,8128,4,17,8,11,56,45,11,59
Stranraer,8128,5,16,5,15,57,64,-7,53
Airdrieon,8128,6,10,12,14,48,61,-13,42
East Fife,8128,7,13,3,20,47,66,-19,42
Forfar,8128,8,10,6,20,41,67,-26,36
Albion,8128,9,8,6,22,58,82,-24,30
Queen's Park,8128,10,6,11,19,40,73,-33,29
Raith,8129,1,23,8,5,70,32,38,77
Ayr,8129,2,24,4,8,93,43,50,76
Arbroath,8129,3,18,8,10,72,49,23,62
Alloa,8129,4,17,8,11,56,45,11,59
Stranraer,8129,5,15,5,16,56,67,-11,50
East Fife,8129,6,14,3,19,50,65,-15,45
Airdrieon,8129,7,11,11,14,47,58,-11,44
Forfar,8129,8,10,5,21,38,66,-28,35
Albion,8129,9,8,6,22,58,81,-23,30
Queen's Park,8129,10,6,10,20,40,74,-34,28
Raith,8130,1,22,9,5,70,34,36,75
Ayr,8130,2,23,5,8,93,45,48,74
Arbroath,8130,3,17,9,10,72,50,22,60
Alloa,8130,4,17,9,10,58,45,13,60
Stranraer,8130,5,15,5,16,55,65,-10,50
East Fife,8130,6,14,3,19,48,64,-16,45
Airdrieon,8130,7,10,11,15,45,61,-16,41
Forfar,8130,8,11,5,20,41,64,-23,38
Albion,8130,9,8,7,21,60,81,-21,31
Queen's Park,8130,10,6,11,19,41,74,-33,29
Raith,8131,1,23,8,5,74,33,41,77
Ayr,8131,2,24,4,8,92,43,49,76
Arbroath,8131,3,18,8,10,72,49,23,62
Alloa,8131,4,17,8,11,57,49,8,59
Stranraer,8131,5,15,6,15,59,68,-9,51
East Fife,8131,6,13,4,19,51,68,-17,43
Airdrieon,8131,7,10,12,14,46,59,-13,42
Forfar,8131,8,10,6,20,39,65,-26,36
Albion,8131,9,8,6,22,58,80,-22,30
Queen's Park,8131,10,6,10,20,40,74,-34,28
Ayr,8132,1,24,4,8,93,43,50,76
Raith,8132,2,22,9,5,68,32,36,75
Alloa,8132,3,17,9,10,56,43,13,60
Arbroath,8132,4,17,8,11,70,51,19,59
Stranraer,8132,5,16,5,15,59,64,-5,53
Airdrieon,8132,6,10,12,14,46,59,-13,42
East Fife,8132,7,13,3,20,47,68,-21,42
Forfar,8132,8,10,6,20,39,65,-26,36
Queen's Park,8132,9,7,10,19,42,72,-30,31
Albion,8132,10,8,6,22,58,81,-23,30
Ayr,8133,1,24,4,8,92,43,49,76
Raith,8133,2,22,9,5,68,32,36,75
Arbroath,8133,3,18,8,10,72,48,24,62
Alloa,8133,4,17,9,10,56,43,13,60
Stranraer,8133,5,16,5,15,57,65,-8,53
Airdrieon,8133,6,10,12,14,46,59,-13,42
East Fife,8133,7,13,3,20,48,66,-18,42
Forfar,8133,8,10,6,20,39,65,-26,36
Albion,8133,9,8,6,22,58,80,-22,30
Queen's Park,8133,10,6,10,20,39,74,-35,28
Ayr,8134,1,24,4,8,96,43,53,76
Raith,8134,2,22,8,6,68,33,35,74
Alloa,8134,3,18,8,10,57,43,14,62
Arbroath,8134,4,17,9,10,70,48,22,60
Stranraer,8134,5,16,5,15,60,67,-7,53
Airdrieon,8134,6,11,11,14,47,59,-12,44
East Fife,8134,7,13,3,20,50,69,-19,42
Forfar,8134,8,10,5,21,39,66,-27,35
Albion,8134,9,8,6,22,58,84,-26,30
Queen's Park,8134,10,6,11,19,39,72,-33,29
Raith,8135,1,23,8,5,69,32,37,77
Ayr,8135,2,24,4,8,94,43,51,76
Arbroath,8135,3,18,8,10,72,49,23,62
Alloa,8135,4,17,8,11,56,44,12,59
Stranraer,8135,5,16,5,15,57,64,-7,53
Airdrieon,8135,6,11,11,14,47,59,-12,44
East Fife,8135,7,13,3,20,47,66,-19,42
Forfar,8135,8,10,5,21,39,66,-27,35
Albion,8135,9,8,6,22,58,82,-24,30
Queen's Park,8135,10,6,10,20,40,74,-34,28
Raith,8136,1,22,9,5,69,33,36,75
Ayr,8136,2,23,4,9,92,46,46,73
Arbroath,8136,3,18,8,10,73,49,24,62
Alloa,8136,4,17,9,10,57,44,13,60
Stranraer,8136,5,15,6,15,57,66,-9,51
East Fife,8136,6,13,4,19,49,66,-17,43
Airdrieon,8136,7,10,12,14,47,60,-13,42
Forfar,8136,8,10,6,20,40,66,-26,36
Albion,8136,9,9,6,21,61,80,-19,33
Queen's Park,8136,10,6,10,20,40,75,-35,28
Raith,8137,1,22,8,6,68,33,35,74
Ayr,8137,2,23,4,9,92,46,46,73
Arbroath,8137,3,18,8,10,72,49,23,62
Alloa,8137,4,18,8,10,57,43,14,62
Stranraer,8137,5,15,5,16,57,68,-11,50
East Fife,8137,6,14,3,19,51,66,-15,45
Airdrieon,8137,7,10,11,15,45,61,-16,41
Forfar,8137,8,11,5,20,41,64,-23,38
Albion,8137,9,9,6,21,61,80,-19,33
Queen's Park,8137,10,6,10,20,40,74,-34,28
Raith,8138,1,23,8,5,70,32,38,77
Ayr,8138,2,24,4,8,97,42,55,76
Arbroath,8138,3,18,8,10,73,48,25,62
Alloa,8138,4,17,8,11,56,45,11,59
Stranraer,8138,5,15,5,16,56,66,-10,50
East Fife,8138,6,14,3,19,49,65,-16,45
Airdrieon,8138,7,11,11,14,48,58,-10,44
Forfar,8138,8,10,5,21,38,67,-29,35
Albion,8138,9,8,6,22,57,85,-28,30
Queen's Park,8138,10,6,10,20,39,75,-36,28
Raith,8139,1,23,8,5,70,33,37,77
Ayr,8139,2,24,4,8,93,44,49,76
Arbroath,8139,3,17,8,11,70,49,21,59
Alloa,8139,4,17,8,11,57,45,12,59
Stranraer,8139,5,15,5,16,55,67,-12,50
East Fife,8139,6,14,3,19,50,64,-14,45
Airdrieon,8139,7,10,11,15,45,59,-14,41
Forfar,8139,8,11,5,20,39,64,-25,38
Queen's Park,8139,9,7,10,19,40,72,-32,31
Albion,8139,10,8,6,22,59,81,-22,30
Ayr,8140,1,24,4,8,93,43,50,76
Raith,8140,2,22,8,6,69,35,34,74
Alloa,8140,3,18,8,10,59,44,15,62
Arbroath,8140,4,17,8,11,73,52,21,59
Stranraer,8140,5,15,5,16,55,65,-10,50
East Fife,8140,6,14,3,19,48,64,-16,45
Airdrieon,8140,7,10,11,15,46,60,-14,41
Forfar,8140,8,11,5,20,40,65,-25,38
Queen's Park,8140,9,7,10,19,43,75,-32,31
Albion,8140,10,8,6,22,58,81,-23,30
Raith,8141,1,22,8,6,68,33,35,74
Ayr,8141,2,23,4,9,90,44,46,73
Alloa,8141,3,18,8,10,57,43,14,62
Arbroath,8141,4,17,9,10,71,49,22,60
Stranraer,8141,5,15,5,16,55,65,-10,50
East Fife,8141,6,14,3,19,48,64,-16,45
Airdrieon,8141,7,11,11,14,48,58,-10,44
Forfar,8141,8,10,5,21,38,67,-29,35
Albion,8141,9,9,6,21,59,78,-19,33
Queen's Park,8141,10,6,11,19,40,73,-33,29
Raith,8142,1,23,8,5,70,33,37,77
Ayr,8142,2,23,4,9,90,43,47,73
Arbroath,8142,3,18,8,10,72,48,24,62
Alloa,8142,4,17,8,11,57,45,12,59
Stranraer,8142,5,15,6,15,56,65,-9,51
Airdrieon,8142,6,11,11,14,47,58,-11,44
East Fife,8142,7,13,4,19,48,65,-17,43
Forfar,8142,8,10,5,21,38,66,-28,35
Albion,8142,9,9,6,21,58,78,-20,33
Queen's Park,8142,10,6,10,20,39,74,-35,28
Ayr,8143,1,24,4,8,93,43,50,76
Raith,8143,2,22,8,6,68,33,35,74
Arbroath,8143,3,18,8,10,73,49,24,62
Alloa,8143,4,18,8,10,57,43,14,62
Stranraer,8143,5,15,6,15,56,65,-9,51
East Fife,8143,6,13,4,19,48,65,-17,43
Airdrieon,8143,7,10,12,14,45,58,-13,42
Forfar,8143,8,10,6,20,38,64,-26,36
Albion,8143,9,8,6,22,58,81,-23,30
Queen's Park,8143,10,6,10,20,40,75,-35,28
Ayr,8144,1,24,4,8,92,42,50,76
Raith,8144,2,22,9,5,69,33,36,75
Alloa,8144,3,17,9,10,57,44,13,60
Arbroath,8144,4,17,8,11,71,51,20,59
Stranraer,8144,5,15,6,15,56,65,-9,51
Airdrieon,8144,6,11,11,14,50,60,-10,44
East Fife,8144,7,13,4,19,48,65,-17,43
Forfar,8144,8,10,5,21,40,69,-29,35
Queen's Park,8144,9,7,10,19,42,73,-31,31
Albion,8144,10,8,6,22,57,80,-23,30
Raith,8145,1,23,8,5,69,32,37,77
Ayr,8145,2,24,4,8,91,42,49,76
Arbroath,8145,3,17,9,10,71,49,22,60
Alloa,8145,4,17,8,11,56,44,12,59
Stranraer,8145,5,15,5,16,57,68,-11,50
East Fife,8145,6,14,3,19,51,66,-15,45
Airdrieon,8145,7,10,12,14,48,61,-13,42
Forfar,8145,8,10,6,20,41,67,-26,36
Albion,8145,9,8,6,22,57,79,-22,30
Queen's Park,8145,10,6,11,19,40,73,-33,29
Ayr,8146,1,24,4,8,93,42,51,76
Raith,8146,2,22,9,5,69,33,36,75
Arbroath,8146,3,18,8,10,74,50,24,62
Alloa,8146,4,17,9,10,57,44,13,60
Stranraer,8146,5,15,6,15,55,64,-9,51
East Fife,8146,6,13,4,19,47,64,-17,43
Airdrieon,8146,7,10,11,15,46,60,-14,41
Forfar,8146,8,11,5,20,40,65,-25,38
Albion,8146,9,8,6,22,57,81,-24,30
Queen's Park,8146,10,6,10,20,41,76,-35,28
Ayr,8147,1,24,4,8,95,46,49,76
Raith,8147,2,22,8,6,70,35,35,74
Arbroath,8147,3,18,8,10,72,48,24,62
Alloa,8147,4,18,8,10,59,45,14,62
Stranraer,8147,5,16,5,15,58,66,-8,53
Airdrieon,8147,6,10,12,14,48,61,-13,42
East Fife,8147,7,13,3,20,49,67,-18,42
Forfar,8147,8,10,6,20,41,67,-26,36
Albion,8147,9,8,6,22,61,83,-22,30
Queen's Park,8147,10,6,10,20,39,74,-35,28
Raith,8148,1,23,8,5,70,33,37,77
Ayr,8148,2,24,4,8,91,42,49,76
Arbroath,8148,3,17,8,11,70,52,18,59
Alloa,8148,4,17,8,11,57,45,12,59
Stranraer,8148,5,16,5,15,59,65,-6,53
East Fife,8148,6,13,3,20,48,68,-20,42
Airdrieon,8148,7,10,11,15,45,60,-15,41
Forfar,8148,8,11,5,20,40,64,-24,38
Queen's Park,8148,9,7,10,19,43,72,-29,31
Albion,8148,10,8,6,22,57,79,-22,30
Raith,8149,1,23,8,5,71,32,39,77
Ayr,8149,2,23,4,9,92,45,47,73
Arbroath,8149,3,17,8,11,72,52,20,59
Alloa,8149,4,17,8,11,56,46,10,59
Stranraer,8149,5,15,5,16,56,68,-12,50
East Fife,8149,6,14,3,19,51,65,-14,45
Airdrieon,8149,7,11,11,14,46,58,-12,44
Forfar,8149,8,10,5,21,38,65,-27,35
Albion,8149,9,9,6,21,60,80,-20,33
Queen's Park,8149,10,7,10,19,43,74,-31,31
Raith,8150,1,23,8,5,70,33,37,77
Ayr,8150,2,24,4,8,97,42,55,76
Arbroath,8150,3,18,8,10,74,48,26,62
Alloa,8150,4,17,8,11,57,45,12,59
Stranraer,8150,5,15,6,15,57,66,-9,51
East Fife,8150,6,13,4,19,49,66,-17,43
Airdrieon,8150,7,10,12,14,45,58,-13,42
Forfar,8150,8,10,6,20,38,64,-26,36
Albion,8150,9,8,6,22,57,85,-28,30
Queen's Park,8150,10,6,10,20,39,76,-37,28
Raith,8151,1,23,8,5,72,33,39,77
Ayr,8151,2,24,4,8,97,43,54,76
Arbroath,8151,3,17,9,10,72,50,22,60
Alloa,8151,4,17,8,11,57,47,10,59
Stranraer,8151,5,15,5,16,56,67,-11,50
East Fife,8151,6,14,3,19,50,65,-15,45
Airdrieon,8151,7,10,12,14,47,60,-13,42
Forfar,8151,8,10,6,20,40,66,-26,36
Albion,8151,9,8,6,22,58,85,-27,30
Queen's Park,8151,10,6,11,19,41,74,-33,29
Raith,8152,1,23,8,5,70,32,38,77
Ayr,8152,2,24,4,8,95,43,52,76
Arbroath,8152,3,17,9,10,70,48,22,60
Alloa,8152,4,17,8,11,56,45,11,59
Stranraer,8152,5,15,5,16,56,67,-11,50
East Fife,8152,6,14,3,19,50,65,-15,45
Airdrieon,8152,7,10,11,15,45,59,-14,41
Forfar,8152,8,11,5,20,39,64,-25,38
Albion,8152,9,8,6,22,58,83,-25,30
Queen's Park,8152,10,6,11,19,39,72,-33,29
Ayr,8153,1,24,4,8,93,43,50,76
Raith,8153,2,22,8,6,69,36,33,74
Alloa,8153,3,18,8,10,60,44,16,62
Arbroath,8153,4,17,8,11,71,51,20,59
Stranraer,8153,5,16,5,15,56,64,-8,53
East Fife,8153,6,13,3,20,47,65,-18,42
Airdrieon,8153,7,10,11,15,45,59,-14,41
Forfar,8153,8,11,5,20,39,64,-25,38
Queen's Park,8153,9,7,10,19,42,73,-31,31
Albion,8153,10,8,6,22,58,81,-23,30
Raith,8154,1,23,8,5,71,33,38,77
Ayr,8154,2,24,4,8,92,42,50,76
Arbroath,8154,3,18,8,10,71,48,23,62
Alloa,8154,4,17,8,11,57,46,11,59
Stranraer,8154,5,16,5,15,56,64,-8,53
Airdrieon,8154,6,11,11,14,47,58,-11,44
East Fife,8154,7,13,3,20,47,65,-18,42
Forfar,8154,8,10,5,21,38,66,-28,35
Albion,8154,9,8,6,22,57,80,-23,30
Queen's Park,8154,10,6,10,20,39,73,-34,28
Ayr,8155,1,24,4,8,96,44,52,76
Raith,8155,2,22,9,5,69,33,36,75
Arbroath,8155,3,18,8,10,75,49,26,62
Alloa,8155,4,17,9,10,57,44,13,60
Stranraer,8155,5,15,6,15,57,66,-9,51
Airdrieon,8155,6,11,11,14,48,59,-11,44
East Fife,8155,7,13,4,19,49,66,-17,43
Forfar,8155,8,10,5,21,39,67,-28,35
Albion,8155,9,8,6,22,59,84,-25,30
Queen's Park,8155,10,6,10,20,40,77,-37,28
Ayr,8156,1,24,4,8,93,42,51,76
Raith,8156,2,22,9,5,69,33,36,75
Alloa,8156,3,17,9,10,57,44,13,60
Arbroath,8156,4,17,8,11,71,51,20,59
Stranraer,8156,5,16,5,15,58,66,-8,53
Airdrieon,8156,6,11,11,14,50,58,-8,44
East Fife,8156,7,13,3,20,49,67,-18,42
Forfar,8156,8,10,5,21,38,69,-31,35
Queen's Park,8156,9,7,10,19,42,73,-31,31
Albion,8156,10,8,6,22,57,81,-24,30
Ayr,8157,1,24,4,8,94,44,50,76
Raith,8157,2,22,9,5,70,34,36,75
Alloa,8157,3,17,9,10,58,45,13,60
Arbroath,8157,4,17,8,11,70,50,20,59
Stranraer,8157,5,16,5,15,57,65,-8,53
Airdrieon,8157,6,10,12,14,46,59,-13,42
East Fife,8157,7,13,3,20,48,66,-18,42
Forfar,8157,8,10,6,20,39,65,-26,36
Queen's Park,8157,9,7,10,19,41,72,-31,31
Albion,8157,10,8,6,22,59,82,-23,30
Ayr,8158,1,24,4,8,93,43,50,76
Raith,8158,2,22,9,5,70,34,36,75
Alloa,8158,3,17,9,10,58,45,13,60
Arbroath,8158,4,17,8,11,70,49,21,59
Stranraer,8158,5,16,5,15,57,65,-8,53
East Fife,8158,6,13,3,20,48,66,-18,42
Airdrieon,8158,7,10,11,15,45,61,-16,41
Forfar,8158,8,11,5,20,41,64,-23,38
Queen's Park,8158,9,7,10,19,40,72,-32,31
Albion,8158,10,8,6,22,58,81,-23,30
Raith,8159,1,22,8,6,68,33,35,74
Ayr,8159,2,23,4,9,91,46,45,73
Arbroath,8159,3,18,8,10,73,49,24,62
Alloa,8159,4,18,8,10,57,43,14,62
Stranraer,8159,5,15,5,16,55,68,-13,50
East Fife,8159,6,14,3,19,51,64,-13,45
Airdrieon,8159,7,10,12,14,46,59,-13,42
Forfar,8159,8,10,6,20,39,65,-26,36
Albion,8159,9,9,6,21,61,79,-18,33
Queen's Park,8159,10,6,10,20,40,75,-35,28
Raith,8160,1,23,8,5,71,33,38,77
Ayr,8160,2,24,4,8,94,44,50,76
Arbroath,8160,3,17,9,10,71,49,22,60
Alloa,8160,4,17,8,11,57,46,11,59
Stranraer,8160,5,15,5,16,56,67,-11,50
East Fife,8160,6,14,3,19,50,65,-15,45
Airdrieon,8160,7,11,11,14,46,58,-12,44
Forfar,8160,8,10,5,21,38,65,-27,35
Albion,8160,9,8,6,22,59,82,-23,30
Queen's Park,8160,10,6,11,19,40,73,-33,29
Raith,8161,1,23,8,5,71,33,38,77
Ayr,8161,2,24,4,8,97,43,54,76
Arbroath,8161,3,17,9,10,72,50,22,60
Alloa,8161,4,17,8,11,57,46,11,59
Stranraer,8161,5,15,5,16,55,65,-10,50
East Fife,8161,6,14,3,19,48,64,-16,45
Airdrieon,8161,7,11,11,14,47,58,-11,44
Forfar,8161,8,10,5,21,38,66,-28,35
Albion,8161,9,8,6,22,58,85,-27,30
Queen's Park,8161,10,6,11,19,41,74,-33,29
Raith,8162,1,23,8,5,69,32,37,77
Ayr,8162,2,24,4,8,92,42,50,76
Arbroath,8162,3,17,8,11,70,50,20,59
Alloa,8162,4,17,8,11,56,44,12,59
Stranraer,8162,5,15,5,16,55,66,-11,50
East Fife,8162,6,14,3,19,49,64,-15,45
Airdrieon,8162,7,10,11,15,47,61,-14,41
Forfar,8162,8,11,5,20,41,66,-25,38
Queen's Park,8162,9,7,10,19,41,72,-31,31
Albion,8162,10,8,6,22,57,80,-23,30
Ayr,8163,1,24,4,8,93,43,50,76
Raith,8163,2,22,8,6,68,33,35,74
Alloa,8163,3,18,8,10,57,43,14,62
Arbroath,8163,4,17,8,11,71,51,20,59
Stranraer,8163,5,16,5,15,58,66,-8,53
East Fife,8163,6,13,3,20,49,67,-18,42
Airdrieon,8163,7,10,11,15,46,61,-15,41
Forfar,8163,8,11,5,20,41,65,-24,38
Queen's Park,8163,9,7,10,19,42,73,-31,31
Albion,8163,10,8,6,22,58,81,-23,30
Raith,8164,1,23,8,5,70,33,37,77
Ayr,8164,2,24,4,8,95,42,53,76
Arbroath,8164,3,17,8,11,70,51,19,59
Alloa,8164,4,17,8,11,57,45,12,59
Stranraer,8164,5,15,5,16,56,66,-10,50
East Fife,8164,6,14,3,19,49,65,-16,45
Airdrieon,8164,7,11,11,14,46,58,-12,44
Forfar,8164,8,10,5,21,38,65,-27,35
Queen's Park,8164,9,7,10,19,42,72,-30,31
Albion,8164,10,8,6,22,57,83,-26,30
Ayr,8165,1,24,4,8,94,45,49,76
Raith,8165,2,22,9,5,69,33,36,75
Alloa,8165,3,17,9,10,57,44,13,60
Arbroath,8165,4,17,8,11,71,51,20,59
Stranraer,8165,5,15,6,15,55,64,-9,51
Airdrieon,8165,6,11,11,14,49,60,-11,44
East Fife,8165,7,13,4,19,47,64,-17,43
Forfar,8165,8,10,5,21,40,68,-28,35
Queen's Park,8165,9,7,10,19,42,73,-31,31
Albion,8165,10,8,6,22,60,82,-22,30
Raith,8166,1,23,8,5,71,32,39,77
Ayr,8166,2,24,4,8,94,44,50,76
Arbroath,8166,3,18,8,10,72,49,23,62
Alloa,8166,4,17,8,11,56,46,10,59
Stranraer,8166,5,15,5,16,57,67,-10,50
East Fife,8166,6,14,3,19,50,66,-16,45
Airdrieon,8166,7,11,11,14,46,58,-12,44
Forfar,8166,8,10,5,21,38,65,-27,35
Albion,8166,9,8,6,22,59,82,-23,30
Queen's Park,8166,10,6,10,20,40,74,-34,28
Ayr,8167,1,24,4,8,93,43,50,76
Raith,8167,2,22,9,5,69,33,36,75
Arbroath,8167,3,17,9,10,70,48,22,60
Alloa,8167,4,17,9,10,57,44,13,60
Stranraer,8167,5,15,5,16,56,66,-10,50
East Fife,8167,6,14,3,19,49,65,-16,45
Airdrieon,8167,7,11,11,14,47,58,-11,44
Forfar,8167,8,10,5,21,38,66,-28,35
Albion,8167,9,8,6,22,58,81,-23,30
Queen's Park,8167,10,6,11,19,39,72,-33,29
Raith,8168,1,23,8,5,69,32,37,77
Ayr,8168,2,23,4,9,91,44,47,73
Arbroath,8168,3,18,8,10,73,50,23,62
Alloa,8168,4,17,8,11,56,44,12,59
Stranraer,8168,5,15,6,15,55,64,-9,51
East Fife,8168,6,13,4,19,47,64,-17,43
Airdrieon,8168,7,10,12,14,47,60,-13,42
Forfar,8168,8,10,6,20,40,66,-26,36
Albion,8168,9,9,6,21,59,79,-20,33
Queen's Park,8168,10,6,10,20,41,75,-34,28
Raith,8169,1,23,8,5,70,33,37,77
Ayr,8169,2,24,4,8,96,43,53,76
Arbroath,8169,3,18,8,10,72,48,24,62
Alloa,8169,4,17,8,11,57,45,12,59
Stranraer,8169,5,16,5,15,56,64,-8,53
Airdrieon,8169,6,11,11,14,48,58,-10,44
East Fife,8169,7,13,3,20,47,65,-18,42
Forfar,8169,8,10,5,21,38,67,-29,35
Albion,8169,9,8,6,22,58,84,-26,30
Queen's Park,8169,10,6,10,20,39,74,-35,28
Ayr,8170,1,24,4,8,94,42,52,76
Raith,8170,2,22,8,6,68,34,34,74
Alloa,8170,3,18,8,10,58,43,15,62
Arbroath,8170,4,17,9,10,72,50,22,60
Stranraer,8170,5,15,5,16,55,67,-12,50
East Fife,8170,6,14,3,19,50,64,-14,45
Airdrieon,8170,7,11,11,14,48,58,-10,44
Forfar,8170,8,10,5,21,38,67,-29,35
Albion,8170,9,8,6,22,57,82,-25,30
Queen's Park,8170,10,6,11,19,41,74,-33,29
Ayr,8171,1,24,4,8,92,42,50,76
Raith,8171,2,22,9,5,68,32,36,75
Arbroath,8171,3,18,8,10,72,49,23,62
Alloa,8171,4,17,9,10,56,43,13,60
Stranraer,8171,5,15,5,16,56,66,-10,50
East Fife,8171,6,14,3,19,49,65,-16,45
Airdrieon,8171,7,11,11,14,47,59,-12,44
Forfar,8171,8,10,5,21,39,66,-27,35
Albion,8171,9,8,6,22,57,80,-23,30
Queen's Park,8171,10,6,10,20,40,74,-34,28
Raith,8172,1,23,8,5,71,32,39,77
Ayr,8172,2,24,4,8,93,44,49,76
Arbroath,8172,3,17,8,11,72,51,21,59
Alloa,8172,4,17,8,11,56,46,10,59
Stranraer,8172,5,15,6,15,56,65,-9,51
Airdrieon,8172,6,11,11,14,47,58,-11,44
East Fife,8172,7,13,4,19,48,65,-17,43
Forfar,8172,8,10,5,21,38,66,-28,35
Queen's Park,8172,9,7,10,19,42,74,-32,31
Albion,8172,10,8,6,22,59,81,-22,30
Ayr,8173,1,24,4,8,95,43,52,76
Raith,8173,2,22,8,6,69,34,35,74
Alloa,8173,3,18,8,10,58,44,14,62
Arbroath,8173,4,17,8,11,72,51,21,59
Stranraer,8173,5,16,5,15,60,68,-8,53
East Fife,8173,6,13,3,20,51,69,-18,42
Airdrieon,8173,7,10,11,15,46,61,-15,41
Forfar,8173,8,11,5,20,41,65,-24,38
Queen's Park,8173,9,7,10,19,42,74,-32,31
Albion,8173,10,8,6,22,58,83,-25,30
Raith,8174,1,23,8,5,70,33,37,77
Ayr,8174,2,24,4,8,92,42,50,76
Arbroath,8174,3,17,9,10,72,50,22,60
Alloa,8174,4,17,8,11,57,45,12,59
Stranraer,8174,5,15,5,16,56,66,-10,50
East Fife,8174,6,14,3,19,49,65,-16,45
Airdrieon,8174,7,11,11,14,48,58,-10,44
Forfar,8174,8,10,5,21,38,67,-29,35
Albion,8174,9,8,6,22,57,80,-23,30
Queen's Park,8174,10,6,11,19,41,74,-33,29
Ayr,8175,1,24,4,8,94,44,50,76
Raith,8175,2,22,9,5,70,34,36,75
Arbroath,8175,3,17,9,10,71,49,22,60
Alloa,8175,4,17,9,10,58,45,13,60
Stranraer,8175,5,16,5,15,59,65,-6,53
Airdrieon,8175,6,10,12,14,47,60,-13,42
East Fife,8175,7,13,3,20,48,68,-20,42
Forfar,8175,8,10,6,20,40,66,-26,36
Albion,8175,9,8,6,22,59,82,-23,30
Queen's Park,8175,10,6,11,19,40,73,-33,29
Raith,8176,1,23,8,5,70,33,37,77
Ayr,8176,2,24,4,8,95,43,52,76
Arbroath,8176,3,17,8,11,70,50,20,59
Alloa,8176,4,17,8,11,57,45,12,59
Stranraer,8176,5,15,5,16,57,69,-12,50
East Fife,8176,6,14,3,19,52,66,-14,45
Airdrieon,8176,7,10,12,14,45,58,-13,42
Forfar,8176,8,10,6,20,38,64,-26,36
Queen's Park,8176,9,7,10,19,41,72,-31,31
Albion,8176,10,8,6,22,58,83,-25,30
Raith,8177,1,23,8,5,70,32,38,77
Ayr,8177,2,24,4,8,94,42,52,76
Arbroath,8177,3,18,8,10,72,48,24,62
Alloa,8177,4,17,8,11,56,45,11,59
Stranraer,8177,5,15,5,16,58,68,-10,50
East Fife,8177,6,14,3,19,51,67,-16,45
Airdrieon,8177,7,11,11,14,47,59,-12,44
Forfar,8177,8,10,5,21,39,66,-27,35
Albion,8177,9,8,6,22,57,82,-25,30
Queen's Park,8177,10,6,10,20,39,74,-35,28
Raith,8178,1,23,8,5,69,32,37,77
Ayr,8178,2,23,5,8,93,45,48,74
Arbroath,8178,3,18,8,10,74,49,25,62
Alloa,8178,4,17,8,11,56,44,12,59
Stranraer,8178,5,15,5,16,56,66,-10,50
East Fife,8178,6,14,3,19,49,65,-16,45
Airdrieon,8178,7,10,12,14,45,58,-13,42
Forfar,8178,8,10,6,20,38,64,-26,36
Albion,8178,9,8,7,21,60,81,-21,31
Queen's Park,8178,10,6,10,20,40,76,-36,28
Raith,8179,1,22,9,5,70,34,36,75
Ayr,8179,2,23,5,8,90,42,48,74
Arbroath,8179,3,18,8,10,73,48,25,62
Alloa,8179,4,17,9,10,58,45,13,60
Stranraer,8179,5,16,5,15,56,64,-8,53
Airdrieon,8179,6,11,11,14,47,59,-12,44
East Fife,8179,7,13,3,20,47,65,-18,42
Forfar,8179,8,10,5,21,39,66,-27,35
Albion,8179,9,8,7,21,57,78,-21,31
Queen's Park,8179,10,6,10,20,39,75,-36,28
Raith,8180,1,23,8,5,70,32,38,77
Ayr,8180,2,23,5,8,90,42,48,74
Arbroath,8180,3,17,9,10,71,49,22,60
Alloa,8180,4,17,8,11,56,45,11,59
Stranraer,8180,5,15,5,16,55,65,-10,50
East Fife,8180,6,14,3,19,48,64,-16,45
Airdrieon,8180,7,11,11,14,46,58,-12,44
Forfar,8180,8,10,5,21,38,65,-27,35
Albion,8180,9,8,7,21,57,78,-21,31
Queen's Park,8180,10,6,11,19,40,73,-33,29
Ayr,8181,1,24,4,8,93,43,50,76
Raith,8181,2,22,9,5,68,32,36,75
Arbroath,8181,3,17,9,10,71,49,22,60
Alloa,8181,4,17,9,10,56,43,13,60
Stranraer,8181,5,15,5,16,56,67,-11,50
East Fife,8181,6,14,3,19,50,65,-15,45
Airdrieon,8181,7,11,11,14,47,58,-11,44
Forfar,8181,8,10,5,21,38,66,-28,35
Albion,8181,9,8,6,22,58,81,-23,30
Queen's Park,8181,10,6,11,19,40,73,-33,29
Ayr,8182,1,24,4,8,95,43,52,76
Raith,8182,2,22,8,6,68,33,35,74
Alloa,8182,3,18,8,10,57,43,14,62
Arbroath,8182,4,17,8,11,71,50,21,59
Stranraer,8182,5,16,5,15,59,64,-5,53
East Fife,8182,6,13,3,20,47,68,-21,42
Airdrieon,8182,7,10,11,15,47,61,-14,41
Forfar,8182,8,11,5,20,41,66,-25,38
Queen's Park,8182,9,7,10,19,41,73,-32,31
Albion,8182,10,8,6,22,58,83,-25,30
Ayr,8183,1,24,4,8,93,43,50,76
Raith,8183,2,22,9,5,70,34,36,75
Arbroath,8183,3,18,8,10,71,48,23,62
Alloa,8183,4,17,9,10,58,45,13,60
Stranraer,8183,5,16,5,15,57,65,-8,53
Airdrieon,8183,6,10,12,14,45,58,-13,42
East Fife,8183,7,13,3,20,48,66,-18,42
Forfar,8183,8,10,6,20,38,64,-26,36
Albion,8183,9,8,6,22,58,81,-23,30
Queen's Park,8183,10,6,10,20,39,73,-34,28
Raith,8184,1,23,8,5,71,33,38,77
Ayr,8184,2,23,5,8,93,45,48,74
Arbroath,8184,3,18,8,10,73,48,25,62
Alloa,8184,4,17,8,11,57,46,11,59
Stranraer,8184,5,16,5,15,59,64,-5,53
Airdrieon,8184,6,11,11,14,50,61,-11,44
East Fife,8184,7,13,3,20,47,68,-21,42
Forfar,8184,8,10,5,21,41,69,-28,35
Albion,8184,9,8,7,21,60,81,-21,31
Queen's Park,8184,10,6,10,20,39,75,-36,28
Ayr,8185,1,24,4,8,96,44,52,76
Raith,8185,2,22,9,5,69,33,36,75
Arbroath,8185,3,18,8,10,74,50,24,62
Alloa,8185,4,17,9,10,57,44,13,60
Stranraer,8185,5,16,5,15,58,66,-8,53
East Fife,8185,6,13,3,20,49,67,-18,42
Airdrieon,8185,7,10,11,15,46,60,-14,41
Forfar,8185,8,11,5,20,40,65,-25,38
Albion,8185,9,8,6,22,59,84,-25,30
Queen's Park,8185,10,6,10,20,41,76,-35,28
Raith,8186,1,23,8,5,70,33,37,77
Ayr,8186,2,24,4,8,93,42,51,76
Arbroath,8186,3,17,8,11,70,49,21,59
Alloa,8186,4,17,8,11,57,45,12,59
Stranraer,8186,5,16,5,15,57,65,-8,53
Airdrieon,8186,6,11,11,14,48,59,-11,44
East Fife,8186,7,13,3,20,48,66,-18,42
Forfar,8186,8,10,5,21,39,67,-28,35
Queen's Park,8186,9,7,10,19,40,72,-32,31
Albion,8186,10,8,6,22,57,81,-24,30
Ayr,8187,1,24,4,8,93,43,50,76
Raith,8187,2,22,9,5,70,34,36,75
Arbroath,8187,3,18,8,10,73,48,25,62
Alloa,8187,4,17,9,10,58,45,13,60
Stranraer,8187,5,15,6,15,57,66,-9,51
East Fife,8187,6,13,4,19,49,66,-17,43
Airdrieon,8187,7,10,11,15,45,63,-18,41
Forfar,8187,8,11,5,20,43,64,-21,38
Albion,8187,9,8,6,22,58,81,-23,30
Queen's Park,8187,10,6,10,20,39,75,-36,28
Ayr,8188,1,24,4,8,93,44,49,76
Raith,8188,2,22,9,5,69,33,36,75
Arbroath,8188,3,17,9,10,70,48,22,60
Alloa,8188,4,17,9,10,57,44,13,60
Stranraer,8188,5,15,5,16,55,65,-10,50
East Fife,8188,6,14,3,19,48,64,-16,45
Airdrieon,8188,7,11,11,14,47,58,-11,44
Forfar,8188,8,10,5,21,38,66,-28,35
Albion,8188,9,8,6,22,59,81,-22,30
Queen's Park,8188,10,6,11,19,39,72,-33,29
Raith,8189,1,23,8,5,71,32,39,77
Ayr,8189,2,24,4,8,94,43,51,76
Arbroath,8189,3,17,9,10,72,50,22,60
Alloa,8189,4,17,8,11,56,46,10,59
Stranraer,8189,5,15,5,16,55,69,-14,50
East Fife,8189,6,14,3,19,52,64,-12,45
Airdrieon,8189,7,10,12,14,48,61,-13,42
Forfar,8189,8,10,6,20,41,67,-26,36
Albion,8189,9,8,6,22,58,82,-24,30
Queen's Park,8189,10,6,11,19,41,74,-33,29
Ayr,8190,1,24,4,8,93,42,51,76
Raith,8190,2,22,8,6,68,33,35,74
Arbroath,8190,3,18,8,10,71,48,23,62
Alloa,8190,4,18,8,10,57,43,14,62
Stranraer,8190,5,16,5,15,56,64,-8,53
East Fife,8190,6,13,3,20,47,65,-18,42
Airdrieon,8190,7,10,11,15,46,60,-14,41
Forfar,8190,8,11,5,20,40,65,-25,38
Albion,8190,9,8,6,22,57,81,-24,30
Queen's Park,8190,10,6,10,20,39,73,-34,28
Raith,8191,1,22,9,5,68,32,36,75
Ayr,8191,2,23,5,8,92,44,48,74
Arbroath,8191,3,18,8,10,72,49,23,62
Alloa,8191,4,17,9,10,56,43,13,60
Stranraer,8191,5,15,5,16,55,65,-10,50
East Fife,8191,6,14,3,19,48,64,-16,45
Airdrieon,8191,7,10,11,15,46,60,-14,41
Forfar,8191,8,11,5,20,40,65,-25,38
Albion,8191,9,8,7,21,59,80,-21,31
Queen's Park,8191,10,6,10,20,40,74,-34,28
Ayr,8192,1,24,4,8,94,43,51,76
Raith,8192,2,22,9,5,68,32,36,75
Arbroath,8192,3,18,8,10,72,49,23,62
Alloa,8192,4,17,9,10,56,43,13,60
Stranraer,8192,5,15,6,15,55,64,-9,51
Airdrieon,8192,6,11,11,14,47,59,-12,44
East Fife,8192,7,13,4,19,47,64,-17,43
Forfar,8192,8,10,5,21,39,66,-27,35
Albion,8192,9,8,6,22,58,82,-24,30
Queen's Park,8192,10,6,10,20,40,74,-34,28
Raith,8193,1,23,8,5,69,32,37,77
Ayr,8193,2,24,4,8,92,43,49,76
Arbroath,8193,3,18,8,10,73,50,23,62
Alloa,8193,4,17,8,11,56,44,12,59
Stranraer,8193,5,15,6,15,56,65,-9,51
Airdrieon,8193,6,11,11,14,47,58,-11,44
East Fife,8193,7,13,4,19,48,65,-17,43
Forfar,8193,8,10,5,21,38,66,-28,35
Albion,8193,9,8,6,22,58,80,-22,30
Queen's Park,8193,10,6,10,20,41,75,-34,28
Raith,8194,1,23,8,5,71,33,38,77
Ayr,8194,2,24,4,8,91,42,49,76
Arbroath,8194,3,18,8,10,76,50,26,62
Alloa,8194,4,17,8,11,57,46,11,59
Stranraer,8194,5,16,5,15,56,64,-8,53
Airdrieon,8194,6,10,12,14,45,58,-13,42
East Fife,8194,7,13,3,20,47,65,-18,42
Forfar,8194,8,10,6,20,38,64,-26,36
Albion,8194,9,8,6,22,57,79,-22,30
Queen's Park,8194,10,6,10,20,41,78,-37,28
Ayr,8195,1,24,4,8,98,44,54,76
Raith,8195,2,22,8,6,68,35,33,74
Arbroath,8195,3,18,8,10,74,49,25,62
Alloa,8195,4,18,8,10,59,43,16,62
Stranraer,8195,5,15,5,16,55,65,-10,50
East Fife,8195,6,14,3,19,48,64,-16,45
Airdrieon,8195,7,10,11,15,47,61,-14,41
Forfar,8195,8,11,5,20,41,66,-25,38
Albion,8195,9,8,6,22,59,86,-27,30
Queen's Park,8195,10,6,10,20,40,76,-36,28
Raith,8196,1,23,8,5,72,32,40,77
Ayr,8196,2,23,5,8,92,44,48,74
Arbroath,8196,3,17,8,11,70,51,19,59
Alloa,8196,4,17,8,11,56,47,9,59
Stranraer,8196,5,15,6,15,55,64,-9,51
East Fife,8196,6,13,4,19,47,64,-17,43
Airdrieon,8196,7,10,11,15,46,61,-15,41
Forfar,8196,8,11,5,20,41,65,-24,38
Albion,8196,9,8,7,21,59,80,-21,31
Queen's Park,8196,10,7,10,19,42,72,-30,31
Ayr,8197,1,24,4,8,92,42,50,76
Raith,8197,2,22,8,6,68,34,34,74
Alloa,8197,3,18,8,10,58,43,15,62
Arbroath,8197,4,17,9,10,72,50,22,60
Stranraer,8197,5,15,6,15,55,64,-9,51
East Fife,8197,6,13,4,19,47,64,-17,43
Airdrieon,8197,7,10,12,14,46,59,-13,42
Forfar,8197,8,10,6,20,39,65,-26,36
Albion,8197,9,8,6,22,57,80,-23,30
Queen's Park,8197,10,6,11,19,41,74,-33,29
Raith,8198,1,23,8,5,70,33,37,77
Ayr,8198,2,23,5,8,94,46,48,74
Arbroath,8198,3,17,9,10,73,51,22,60
Alloa,8198,4,17,8,11,57,45,12,59
Stranraer,8198,5,16,5,15,57,64,-7,53
Airdrieon,8198,6,11,11,14,47,59,-12,44
East Fife,8198,7,13,3,20,47,66,-19,42
Forfar,8198,8,10,5,21,39,66,-27,35
Albion,8198,9,8,7,21,61,82,-21,31
Queen's Park,8198,10,6,11,19,42,75,-33,29
Raith,8199,1,23,8,5,71,34,37,77
Ayr,8199,2,24,4,8,96,44,52,76
Arbroath,8199,3,18,8,10,75,50,25,62
Alloa,8199,4,17,8,11,58,46,12,59
Stranraer,8199,5,15,5,16,55,66,-11,50
East Fife,8199,6,14,3,19,49,64,-15,45
Airdrieon,8199,7,11,11,14,49,60,-11,44
Forfar,8199,8,10,5,21,40,68,-28,35
Albion,8199,9,8,6,22,59,84,-25,30
Queen's Park,8199,10,6,10,20,41,77,-36,28
Ayr,8200,1,24,4,8,96,43,53,76
Raith,8200,2,22,9,5,69,33,36,75
Arbroath,8200,3,18,8,10,74,49,25,62
Alloa,8200,4,17,9,10,57,44,13,60
Stranraer,8200,5,16,5,15,57,65,-8,53
East Fife,8200,6,13,3,20,48,66,-18,42
Airdrieon,8200,7,10,11,15,45,59,-14,41
Forfar,8200,8,11,5,20,39,64,-25,38
Albion,8200,9,8,6,22,58,84,-26,30
Queen's Park,8200,10,6,10,20,40,76,-36,28
Raith,8201,1,23,8,5,69,32,37,77
Ayr,8201,2,24,4,8,92,42,50,76
Arbroath,8201,3,17,8,11,71,52,19,59
Alloa,8201,4,17,8,11,56,44,12,59
Stranraer,8201,5,15,5,16,55,67,-12,50
East Fife,8201,6,14,3,19,50,64,-14,45
Airdrieon,8201,7,11,11,14,47,59,-12,44
Forfar,8201,8,10,5,21,39,66,-27,35
Queen's Park,8201,9,7,10,19,43,73,-30,31
Albion,8201,10,8,6,22,57,80,-23,30
Ayr,8202,1,24,4,8,93,43,50,76
Raith,8202,2,22,9,5,69,33,36,75
Alloa,8202,3,17,9,10,57,44,13,60
Arbroath,8202,4,17,8,11,70,49,21,59
Stranraer,8202,5,16,5,15,57,65,-8,53
Airdrieon,8202,6,10,12,14,45,58,-13,42
East Fife,8202,7,13,3,20,48,66,-18,42
Forfar,8202,8,10,6,20,38,64,-26,36
Queen's Park,8202,9,7,10,19,40,72,-32,31
Albion,8202,10,8,6,22,58,81,-23,30
Raith,8203,1,23,8,5,69,32,37,77
Ayr,8203,2,23,4,9,91,44,47,73
Arbroath,8203,3,18,8,10,73,50,23,62
Alloa,8203,4,17,8,11,56,44,12,59
Stranraer,8203,5,15,5,16,55,68,-13,50
East Fife,8203,6,14,3,19,51,64,-13,45
Airdrieon,8203,7,10,11,15,45,60,-15,41
Forfar,8203,8,11,5,20,40,64,-24,38
Albion,8203,9,9,6,21,59,79,-20,33
Queen's Park,8203,10,6,10,20,41,75,-34,28
Raith,8204,1,23,8,5,70,32,38,77
Ayr,8204,2,24,4,8,93,43,50,76
Arbroath,8204,3,18,8,10,73,49,24,62
Alloa,8204,4,17,8,11,56,45,11,59
Stranraer,8204,5,15,6,15,56,65,-9,51
East Fife,8204,6,13,4,19,48,65,-17,43
Airdrieon,8204,7,10,12,14,45,58,-13,42
Forfar,8204,8,10,6,20,38,64,-26,36
Albion,8204,9,8,6,22,58,81,-23,30
Queen's Park,8204,10,6,10,20,40,75,-35,28
Ayr,8205,1,24,4,8,95,44,51,76
Raith,8205,2,22,8,6,68,34,34,74
Arbroath,8205,3,18,8,10,73,49,24,62
Alloa,8205,4,18,8,10,58,43,15,62
Stranraer,8205,5,15,5,16,55,65,-10,50
East Fife,8205,6,14,3,19,48,64,-16,45
Airdrieon,8205,7,10,11,15,46,61,-15,41
Forfar,8205,8,11,5,20,41,65,-24,38
Albion,8205,9,8,6,22,59,83,-24,30
Queen's Park,8205,10,6,10,20,40,75,-35,28
Raith,8206,1,23,8,5,71,34,37,77
Ayr,8206,2,24,4,8,94,42,52,76
Arbroath,8206,3,18,8,10,71,48,23,62
Alloa,8206,4,17,8,11,58,46,12,59
Stranraer,8206,5,15,5,16,57,67,-10,50
East Fife,8206,6,14,3,19,50,66,-16,45
Airdrieon,8206,7,10,12,14,47,60,-13,42
Forfar,8206,8,10,6,20,40,66,-26,36
Albion,8206,9,8,6,22,57,82,-25,30
Queen's Park,8206,10,6,10,20,39,73,-34,28
Raith,8207,1,23,8,5,69,32,37,77
Ayr,8207,2,24,4,8,94,43,51,76
Arbroath,8207,3,17,9,10,71,49,22,60
Alloa,8207,4,17,8,11,56,44,12,59
Stranraer,8207,5,15,5,16,55,66,-11,50
East Fife,8207,6,14,3,19,49,64,-15,45
Airdrieon,8207,7,10,11,15,47,61,-14,41
Forfar,8207,8,11,5,20,41,66,-25,38
Albion,8207,9,8,6,22,58,82,-24,30
Queen's Park,8207,10,6,11,19,40,73,-33,29
Raith,8208,1,23,8,5,69,32,37,77
Ayr,8208,2,23,5,8,92,44,48,74
Arbroath,8208,3,17,9,10,71,49,22,60
Alloa,8208,4,17,8,11,56,44,12,59
Stranraer,8208,5,15,5,16,57,67,-10,50
East Fife,8208,6,14,3,19,50,66,-16,45
Airdrieon,8208,7,11,11,14,47,59,-12,44
Forfar,8208,8,10,5,21,39,66,-27,35
Albion,8208,9,8,7,21,59,80,-21,31
Queen's Park,8208,10,6,11,19,40,73,-33,29
Raith,8209,1,23,8,5,69,32,37,77
Ayr,8209,2,24,4,8,94,44,50,76
Arbroath,8209,3,18,8,10,73,48,25,62
Alloa,8209,4,17,8,11,56,44,12,59
Stranraer,8209,5,15,5,16,56,67,-11,50
East Fife,8209,6,14,3,19,50,65,-15,45
Airdrieon,8209,7,10,11,15,46,60,-14,41
Forfar,8209,8,11,5,20,40,65,-25,38
Albion,8209,9,8,6,22,59,82,-23,30
Queen's Park,8209,10,6,10,20,39,75,-36,28
Raith,8210,1,23,8,5,71,32,39,77
Ayr,8210,2,23,5,8,91,43,48,74
Arbroath,8210,3,17,9,10,72,50,22,60
Alloa,8210,4,17,8,11,56,46,10,59
Stranraer,8210,5,15,5,16,55,68,-13,50
East Fife,8210,6,14,3,19,51,64,-13,45
Airdrieon,8210,7,11,11,14,48,59,-11,44
Forfar,8210,8,10,5,21,39,67,-28,35
Albion,8210,9,8,7,21,58,79,-21,31
Queen's Park,8210,10,6,11,19,41,74,-33,29
Ayr,8211,1,24,4,8,93,43,50,76
Raith,8211,2,22,8,6,69,34,35,74
Alloa,8211,3,18,8,10,58,44,14,62
Arbroath,8211,4,17,9,10,70,48,22,60
Stranraer,8211,5,15,5,16,56,67,-11,50
East Fife,8211,6,14,3,19,50,65,-15,45
Airdrieon,8211,7,10,11,15,47,61,-14,41
Forfar,8211,8,11,5,20,41,66,-25,38
Albion,8211,9,8,6,22,58,81,-23,30
Queen's Park,8211,10,6,11,19,39,72,-33,29
Raith,8212,1,23,8,5,71,33,38,77
Ayr,8212,2,24,4,8,93,42,51,76
Arbroath,8212,3,17,8,11,70,51,19,59
Alloa,8212,4,17,8,11,57,46,11,59
Stranraer,8212,5,15,5,16,56,66,-10,50
East Fife,8212,6,14,3,19,49,65,-16,45
Airdrieon,8212,7,10,12,14,47,60,-13,42
Forfar,8212,8,10,6,20,40,66,-26,36
Queen's Park,8212,9,7,10,19,42,72,-30,31
Albion,8212,10,8,6,22,57,81,-24,30
Ayr,8213,1,24,4,8,94,44,50,76
Raith,8213,2,22,8,6,70,35,35,74
Alloa,8213,3,18,8,10,59,45,14,62
Arbroath,8213,4,17,9,10,71,49,22,60
Stranraer,8213,5,15,5,16,55,66,-11,50
East Fife,8213,6,14,3,19,49,64,-15,45
Airdrieon,8213,7,10,12,14,46,59,-13,42
Forfar,8213,8,10,6,20,39,65,-26,36
Albion,8213,9,8,6,22,59,82,-23,30
Queen's Park,8213,10,6,11,19,40,73,-33,29
Ayr,8214,1,24,4,8,94,44,50,76
Raith,8214,2,22,8,6,68,34,34,74
Alloa,8214,3,18,8,10,58,43,15,62
Arbroath,8214,4,17,8,11,72,52,20,59
Stranraer,8214,5,16,5,15,59,66,-7,53
Airdrieon,8214,6,10,12,14,46,59,-13,42
East Fife,8214,7,13,3,20,49,68,-19,42
Forfar,8214,8,10,6,20,39,65,-26,36
Queen's Park,8214,9,7,10,19,43,74,-31,31
Albion,8214,10,8,6,22,59,82,-23,30
Raith,8215,1,23,8,5,70,32,38,77
Ayr,8215,2,24,4,8,95,44,51,76
Arbroath,8215,3,18,8,10,71,48,23,62
Alloa,8215,4,17,8,11,56,45,11,59
Stranraer,8215,5,16,5,15,57,65,-8,53
East Fife,8215,6,13,3,20,48,66,-18,42
Airdrieon,8215,7,10,11,15,45,59,-14,41
Forfar,8215,8,11,5,20,39,64,-25,38
Albion,8215,9,8,6,22,59,83,-24,30
Queen's Park,8215,10,6,10,20,39,73,-34,28
Ayr,8216,1,24,4,8,95,45,50,76
Raith,8216,2,22,8,6,70,35,35,74
Alloa,8216,3,18,8,10,59,45,14,62
Arbroath,8216,4,17,9,10,72,50,22,60
Stranraer,8216,5,16,5,15,58,66,-8,53
Airdrieon,8216,6,11,11,14,47,58,-11,44
East Fife,8216,7,13,3,20,49,67,-18,42
Forfar,8216,8,10,5,21,38,66,-28,35
Albion,8216,9,8,6,22,60,83,-23,30
Queen's Park,8216,10,6,11,19,41,74,-33,29
Ayr,8217,1,23,5,8,93,45,48,74
Raith,8217,2,22,8,6,68,33,35,74
Alloa,8217,3,18,8,10,57,43,14,62
Arbroath,8217,4,17,9,10,71,49,22,60
Stranraer,8217,5,15,5,16,55,65,-10,50
East Fife,8217,6,14,3,19,48,64,-16,45
Airdrieon,8217,7,11,11,14,47,59,-12,44
Forfar,8217,8,10,5,21,39,66,-27,35
Albion,8217,9,8,7,21,60,81,-21,31
Queen's Park,8217,10,6,11,19,40,73,-33,29
Raith,8218,1,22,9,5,70,34,36,75
Ayr,8218,2,23,4,9,91,44,47,73
Arbroath,8218,3,18,8,10,71,48,23,62
Alloa,8218,4,17,9,10,58,45,13,60
Stranraer,8218,5,15,6,15,56,65,-9,51
East Fife,8218,6,13,4,19,48,65,-17,43
Airdrieon,8218,7,10,11,15,45,60,-15,41
Forfar,8218,8,11,5,20,40,64,-24,38
Albion,8218,9,9,6,21,59,79,-20,33
Queen's Park,8218,10,6,10,20,39,73,-34,28
Raith,8219,1,23,8,5,70,32,38,77
Ayr,8219,2,23,5,8,91,43,48,74
Arbroath,8219,3,17,8,11,71,51,20,59
Alloa,8219,4,17,8,11,56,45,11,59
Stranraer,8219,5,15,5,16,56,66,-10,50
East Fife,8219,6,14,3,19,49,65,-16,45
Airdrieon,8219,7,11,11,14,48,58,-10,44
Forfar,8219,8,10,5,21,38,67,-29,35
Albion,8219,9,8,7,21,58,79,-21,31
Queen's Park,8219,10,7,10,19,42,73,-31,31
Raith,8220,1,23,8,5,71,33,38,77
Ayr,8220,2,24,4,8,92,42,50,76
Arbroath,8220,3,18,8,10,75,50,25,62
Alloa,8220,4,17,8,11,57,46,11,59
Stranraer,8220,5,16,5,15,57,65,-8,53
Airdrieon,8220,6,11,11,14,47,59,-12,44
East Fife,8220,7,13,3,20,48,66,-18,42
Forfar,8220,8,10,5,21,39,66,-27,35
Albion,8220,9,8,6,22,57,80,-23,30
Queen's Park,8220,10,6,10,20,41,77,-36,28
Raith,8221,1,23,8,5,70,33,37,77
Ayr,8221,2,24,4,8,95,43,52,76
Arbroath,8221,3,18,8,10,73,48,25,62
Alloa,8221,4,17,8,11,57,45,12,59
Stranraer,8221,5,15,5,16,55,65,-10,50
East Fife,8221,6,14,3,19,48,64,-16,45
Airdrieon,8221,7,10,12,14,47,60,-13,42
Forfar,8221,8,10,6,20,40,66,-26,36
Albion,8221,9,8,6,22,58,83,-25,30
Queen's Park,8221,10,6,10,20,39,75,-36,28
Raith,8222,1,23,8,5,71,32,39,77
Ayr,8222,2,24,4,8,93,42,51,76
Arbroath,8222,3,17,8,11,71,53,18,59
Alloa,8222,4,17,8,11,56,46,10,59
Stranraer,8222,5,16,5,15,57,64,-7,53
Airdrieon,8222,6,11,11,14,49,60,-11,44
East Fife,8222,7,13,3,20,47,66,-19,42
Forfar,8222,8,10,5,21,40,68,-28,35
Queen's Park,8222,9,7,10,19,44,73,-29,31
Albion,8222,10,8,6,22,57,81,-24,30
Raith,8223,1,23,8,5,72,33,39,77
Ayr,8223,2,24,4,8,93,42,51,76
Arbroath,8223,3,17,8,11,71,51,20,59
Alloa,8223,4,17,8,11,57,47,10,59
Stranraer,8223,5,15,6,15,57,66,-9,51
Airdrieon,8223,6,11,11,14,50,61,-11,44
East Fife,8223,7,13,4,19,49,66,-17,43
Forfar,8223,8,10,5,21,41,69,-28,35
Queen's Park,8223,9,7,10,19,42,73,-31,31
Albion,8223,10,8,6,22,57,81,-24,30
Ayr,8224,1,24,4,8,91,42,49,76
Raith,8224,2,22,9,5,69,33,36,75
Arbroath,8224,3,18,8,10,73,49,24,62
Alloa,8224,4,17,9,10,57,44,13,60
Stranraer,8224,5,16,5,15,57,64,-7,53
Airdrieon,8224,6,11,11,14,48,60,-12,44
East Fife,8224,7,13,3,20,47,66,-19,42
Forfar,8224,8,10,5,21,40,67,-27,35
Albion,8224,9,8,6,22,57,79,-22,30
Queen's Park,8224,10,6,10,20,40,75,-35,28
Raith,8225,1,23,8,5,70,33,37,77
Ayr,8225,2,24,4,8,95,43,52,76
Arbroath,8225,3,17,8,11,70,49,21,59
Alloa,8225,4,17,8,11,57,45,12,59
Stranraer,8225,5,16,5,15,57,64,-7,53
East Fife,8225,6,13,3,20,47,66,-19,42
Airdrieon,8225,7,10,11,15,46,61,-15,41
Forfar,8225,8,11,5,20,41,65,-24,38
Queen's Park,8225,9,7,10,19,40,72,-32,31
Albion,8225,10,8,6,22,58,83,-25,30
Ayr,8226,1,24,4,8,94,43,51,76
Raith,8226,2,22,8,6,69,34,35,74
Alloa,8226,3,18,8,10,58,44,14,62
Arbroath,8226,4,17,8,11,70,51,19,59
Stranraer,8226,5,15,6,15,55,64,-9,51
Airdrieon,8226,6,11,11,14,46,58,-12,44
East Fife,8226,7,13,4,19,47,64,-17,43
Forfar,8226,8,10,5,21,38,65,-27,35
Queen's Park,8226,9,7,10,19,42,72,-30,31
Albion,8226,10,8,6,22,58,82,-24,30
Ayr,8227,1,24,4,8,95,42,53,76
Raith,8227,2,22,8,6,68,33,35,74
Alloa,8227,3,18,8,10,57,43,14,62
Arbroath,8227,4,17,8,11,70,49,21,59
Stranraer,8227,5,15,5,16,55,67,-12,50
East Fife,8227,6,14,3,19,50,64,-14,45
Airdrieon,8227,7,11,11,14,48,60,-12,44
Forfar,8227,8,10,5,21,40,67,-27,35
Queen's Park,8227,9,7,10,19,40,72,-32,31
Albion,8227,10,8,6,22,57,83,-26,30
Ayr,8228,1,24,4,8,94,43,51,76
Raith,8228,2,22,9,5,68,32,36,75
Arbroath,8228,3,18,8,10,76,51,25,62
Alloa,8228,4,17,9,10,56,43,13,60
Stranraer,8228,5,15,5,16,56,67,-11,50
East Fife,8228,6,14,3,19,50,65,-15,45
Airdrieon,8228,7,11,11,14,48,60,-12,44
Forfar,8228,8,10,5,21,40,67,-27,35
Albion,8228,9,8,6,22,58,82,-24,30
Queen's Park,8228,10,6,10,20,42,78,-36,28
Raith,8229,1,23,8,5,69,32,37,77
Ayr,8229,2,23,5,8,91,43,48,74
Arbroath,8229,3,18,8,10,75,50,25,62
Alloa,8229,4,17,8,11,56,44,12,59
Stranraer,8229,5,15,5,16,56,66,-10,50
East Fife,8229,6,14,3,19,49,65,-16,45
Airdrieon,8229,7,10,11,15,45,59,-14,41
Forfar,8229,8,11,5,20,39,64,-25,38
Albion,8229,9,8,7,21,58,79,-21,31
Queen's Park,8229,10,6,10,20,41,77,-36,28
Raith,8230,1,23,8,5,70,32,38,77
Ayr,8230,2,23,4,9,90,44,46,73
Arbroath,8230,3,18,8,10,72,48,24,62
Alloa,8230,4,17,8,11,56,45,11,59
Stranraer,8230,5,15,5,16,57,67,-10,50
East Fife,8230,6,14,3,19,50,66,-16,45
Airdrieon,8230,7,10,12,14,46,59,-13,42
Forfar,8230,8,10,6,20,39,65,-26,36
Albion,8230,9,9,6,21,59,78,-19,33
Queen's Park,8230,10,6,10,20,39,74,-35,28
Raith,8231,1,23,8,5,70,33,37,77
Ayr,8231,2,24,4,8,94,42,52,76
Arbroath,8231,3,17,8,11,70,50,20,59
Alloa,8231,4,17,8,11,57,45,12,59
Stranraer,8231,5,15,6,15,56,65,-9,51
Airdrieon,8231,6,11,11,14,50,59,-9,44
East Fife,8231,7,13,4,19,48,65,-17,43
Forfar,8231,8,10,5,21,39,69,-30,35
Queen's Park,8231,9,7,10,19,41,72,-31,31
Albion,8231,10,8,6,22,57,82,-25,30
Raith,8232,1,22,8,6,68,34,34,74
Ayr,8232,2,23,4,9,91,44,47,73
Arbroath,8232,3,18,8,10,74,48,26,62
Alloa,8232,4,18,8,10,58,43,15,62
Stranraer,8232,5,15,5,16,56,66,-10,50
East Fife,8232,6,14,3,19,49,65,-16,45
Airdrieon,8232,7,11,11,14,47,59,-12,44
Forfar,8232,8,10,5,21,39,66,-27,35
Albion,8232,9,9,6,21,59,79,-20,33
Queen's Park,8232,10,6,10,20,39,76,-37,28
Raith,8233,1,23,8,5,71,34,37,77
Ayr,8233,2,24,4,8,95,43,52,76
Arbroath,8233,3,17,8,11,70,50,20,59
Alloa,8233,4,17,8,11,58,46,12,59
Stranraer,8233,5,16,5,15,57,65,-8,53
East Fife,8233,6,13,3,20,48,66,-18,42
Airdrieon,8233,7,10,11,15,45,59,-14,41
Forfar,8233,8,11,5,20,39,64,-25,38
Queen's Park,8233,9,7,10,19,41,72,-31,31
Albion,8233,10,8,6,22,58,83,-25,30
Raith,8234,1,23,8,5,70,32,38,77
Ayr,8234,2,23,5,8,91,43,48,74
Arbroath,8234,3,17,8,11,70,49,21,59
Alloa,8234,4,17,8,11,56,45,11,59
Stranraer,8234,5,15,6,15,56,65,-9,51
East Fife,8234,6,13,4,19,48,65,-17,43
Airdrieon,8234,7,10,12,14,45,58,-13,42
Forfar,8234,8,10,6,20,38,64,-26,36
Albion,8234,9,8,7,21,58,79,-21,31
Queen's Park,8234,10,7,10,19,40,72,-32,31
Ayr,8235,1,24,4,8,95,42,53,76
Raith,8235,2,22,9,5,69,33,36,75
Alloa,8235,3,17,9,10,57,44,13,60
Arbroath,8235,4,17,8,11,70,51,19,59
Stranraer,8235,5,16,5,15,56,64,-8,53
East Fife,8235,6,13,3,20,47,65,-18,42
Airdrieon,8235,7,10,11,15,46,60,-14,41
Forfar,8235,8,11,5,20,40,65,-25,38
Queen's Park,8235,9,7,10,19,42,72,-30,31
Albion,8235,10,8,6,22,57,83,-26,30
Raith,8236,1,23,8,5,70,32,38,77
Ayr,8236,2,24,4,8,91,42,49,76
Arbroath,8236,3,17,8,11,71,50,21,59
Alloa,8236,4,17,8,11,56,45,11,59
Stranraer,8236,5,15,6,15,57,66,-9,51
East Fife,8236,6,13,4,19,49,66,-17,43
Airdrieon,8236,7,10,12,14,47,60,-13,42
Forfar,8236,8,10,6,20,40,66,-26,36
Queen's Park,8236,9,7,10,19,41,73,-32,31
Albion,8236,10,8,6,22,57,79,-22,30
Raith,8237,1,23,8,5,70,33,37,77
Ayr,8237,2,23,5,8,91,43,48,74
Arbroath,8237,3,18,8,10,72,48,24,62
Alloa,8237,4,17,8,11,57,45,12,59
Stranraer,8237,5,15,5,16,55,65,-10,50
East Fife,8237,6,14,3,19,48,64,-16,45
Airdrieon,8237,7,11,11,14,48,59,-11,44
Forfar,8237,8,10,5,21,39,67,-28,35
Albion,8237,9,8,7,21,58,79,-21,31
Queen's Park,8237,10,6,10,20,39,74,-35,28
Raith,8238,1,23,8,5,72,32,40,77
Ayr,8238,2,24,4,8,94,43,51,76
Arbroath,8238,3,17,9,10,72,50,22,60
Alloa,8238,4,17,8,11,56,47,9,59
Stranraer,8238,5,15,6,15,56,65,-9,51
Airdrieon,8238,6,11,11,14,49,60,-11,44
East Fife,8238,7,13,4,19,48,65,-17,43
Forfar,8238,8,10,5,21,40,68,-28,35
Albion,8238,9,8,6,22,58,82,-24,30
Queen's Park,8238,10,6,11,19,41,74,-33,29
Ayr,8239,1,24,4,8,93,43,50,76
Raith,8239,2,22,9,5,69,33,36,75
Alloa,8239,3,17,9,10,57,44,13,60
Arbroath,8239,4,17,8,11,72,52,20,59
Stranraer,8239,5,15,6,15,56,65,-9,51
East Fife,8239,6,13,4,19,48,65,-17,43
Airdrieon,8239,7,10,12,14,47,60,-13,42
Forfar,8239,8,10,6,20,40,66,-26,36
Queen's Park,8239,9,7,10,19,43,74,-31,31
Albion,8239,10,8,6,22,58,81,-23,30
Raith,8240,1,23,8,5,70,32,38,77
Ayr,8240,2,24,4,8,92,42,50,76
Arbroath,8240,3,17,8,11,71,51,20,59
Alloa,8240,4,17,8,11,56,45,11,59
Stranraer,8240,5,16,5,15,59,64,-5,53
Airdrieon,8240,6,11,11,14,47,59,-12,44
East Fife,8240,7,13,3,20,47,68,-21,42
Forfar,8240,8,10,5,21,39,66,-27,35
Queen's Park,8240,9,7,10,19,42,73,-31,31
Albion,8240,10,8,6,22,57,80,-23,30
Raith,8241,1,23,8,5,69,32,37,77
Ayr,8241,2,23,5,8,92,44,48,74
Arbroath,8241,3,18,8,10,73,49,24,62
Alloa,8241,4,17,8,11,56,44,12,59
Stranraer,8241,5,16,5,15,57,64,-7,53
Airdrieon,8241,6,11,11,14,48,59,-11,44
East Fife,8241,7,13,3,20,47,66,-19,42
Forfar,8241,8,10,5,21,39,67,-28,35
Albion,8241,9,8,7,21,59,80,-21,31
Queen's Park,8241,10,6,10,20,40,75,-35,28
Raith,8242,1,23,8,5,71,34,37,77
Ayr,8242,2,24,4,8,95,43,52,76
Arbroath,8242,3,17,9,10,70,48,22,60
Alloa,8242,4,17,8,11,58,46,12,59
Stranraer,8242,5,16,5,15,57,65,-8,53
Airdrieon,8242,6,11,11,14,49,59,-10,44
East Fife,8242,7,13,3,20,48,66,-18,42
Forfar,8242,8,10,5,21,39,68,-29,35
Albion,8242,9,8,6,22,58,83,-25,30
Queen's Park,8242,10,6,11,19,39,72,-33,29
Raith,8243,1,23,8,5,71,33,38,77
Ayr,8243,2,24,4,8,93,44,49,76
Arbroath,8243,3,17,9,10,72,50,22,60
Alloa,8243,4,17,8,11,57,46,11,59
Stranraer,8243,5,16,5,15,56,64,-8,53
East Fife,8243,6,13,3,20,47,65,-18,42
Airdrieon,8243,7,10,11,15,45,61,-16,41
Forfar,8243,8,11,5,20,41,64,-23,38
Albion,8243,9,8,6,22,59,81,-22,30
Queen's Park,8243,10,6,11,19,41,74,-33,29
Raith,8244,1,23,8,5,70,33,37,77
Ayr,8244,2,24,4,8,91,42,49,76
Arbroath,8244,3,18,8,10,72,48,24,62
Alloa,8244,4,17,8,11,57,45,12,59
Stranraer,8244,5,15,6,15,57,66,-9,51
Airdrieon,8244,6,11,11,14,47,59,-12,44
East Fife,8244,7,13,4,19,49,66,-17,43
Forfar,8244,8,10,5,21,39,66,-27,35
Albion,8244,9,8,6,22,57,79,-22,30
Queen's Park,8244,10,6,10,20,39,74,-35,28
Raith,8245,1,23,8,5,74,33,41,77
Ayr,8245,2,23,5,8,95,47,48,74
Arbroath,8245,3,17,9,10,72,50,22,60
Alloa,8245,4,17,8,11,57,49,8,59
Stranraer,8245,5,16,5,15,57,65,-8,53
Airdrieon,8245,6,11,11,14,47,58,-11,44
East Fife,8245,7,13,3,20,48,66,-18,42
Forfar,8245,8,10,5,21,38,66,-28,35
Albion,8245,9,8,7,21,62,83,-21,31
Queen's Park,8245,10,6,11,19,41,74,-33,29
Ayr,8246,1,24,4,8,95,42,53,76
Raith,8246,2,22,8,6,69,34,35,74
Arbroath,8246,3,18,8,10,74,49,25,62
Alloa,8246,4,18,8,10,58,44,14,62
Stranraer,8246,5,15,6,15,56,65,-9,51
East Fife,8246,6,13,4,19,48,65,-17,43
Airdrieon,8246,7,10,12,14,45,58,-13,42
Forfar,8246,8,10,6,20,38,64,-26,36
Albion,8246,9,8,6,22,57,83,-26,30
Queen's Park,8246,10,6,10,20,40,76,-36,28
Raith,8247,1,23,8,5,71,32,39,77
Ayr,8247,2,23,4,9,92,45,47,73
Arbroath,8247,3,18,8,10,74,50,24,62
Alloa,8247,4,17,8,11,56,46,10,59
Stranraer,8247,5,15,6,15,56,65,-9,51
East Fife,8247,6,13,4,19,48,65,-17,43
Airdrieon,8247,7,10,11,15,45,59,-14,41
Forfar,8247,8,11,5,20,39,64,-25,38
Albion,8247,9,9,6,21,60,80,-20,33
Queen's Park,8247,10,6,10,20,41,76,-35,28
Ayr,8248,1,23,5,8,91,43,48,74
Raith,8248,2,22,8,6,68,36,32,74
Arbroath,8248,3,18,8,10,73,50,23,62
Alloa,8248,4,18,8,10,60,43,17,62
Stranraer,8248,5,15,5,16,55,66,-11,50
East Fife,8248,6,14,3,19,49,64,-15,45
Airdrieon,8248,7,11,11,14,48,59,-11,44
Forfar,8248,8,10,5,21,39,67,-28,35
Albion,8248,9,8,7,21,58,79,-21,31
Queen's Park,8248,10,6,10,20,41,75,-34,28
Raith,8249,1,22,9,5,69,33,36,75
Ayr,8249,2,23,5,8,91,43,48,74
Arbroath,8249,3,17,9,10,73,51,22,60
Alloa,8249,4,17,9,10,57,44,13,60
Stranraer,8249,5,15,5,16,58,68,-10,50
East Fife,8249,6,14,3,19,51,67,-16,45
Airdrieon,8249,7,10,12,14,46,59,-13,42
Forfar,8249,8,10,6,20,39,65,-26,36
Albion,8249,9,8,7,21,58,79,-21,31
Queen's Park,8249,10,6,11,19,42,75,-33,29
Ayr,8250,1,24,4,8,97,42,55,76
Raith,8250,2,22,8,6,68,33,35,74
Alloa,8250,3,18,8,10,57,43,14,62
Arbroath,8250,4,17,8,11,70,49,21,59
Stranraer,8250,5,15,5,16,56,68,-12,50
East Fife,8250,6,14,3,19,51,65,-14,45
Airdrieon,8250,7,10,12,14,47,60,-13,42
Forfar,8250,8,10,6,20,40,66,-26,36
Queen's Park,8250,9,7,10,19,40,72,-32,31
Albion,8250,10,8,6,22,57,85,-28,30
Ayr,8251,1,24,4,8,93,43,50,76
Raith,8251,2,22,9,5,68,32,36,75
Arbroath,8251,3,18,8,10,74,48,26,62
Alloa,8251,4,17,9,10,56,43,13,60
Stranraer,8251,5,15,5,16,56,66,-10,50
East Fife,8251,6,14,3,19,49,65,-16,45
Airdrieon,8251,7,11,11,14,49,60,-11,44
Forfar,8251,8,10,5,21,40,68,-28,35
Albion,8251,9,8,6,22,58,81,-23,30
Queen's Park,8251,10,6,10,20,39,76,-37,28
Ayr,8252,1,23,5,8,92,44,48,74
Raith,8252,2,22,8,6,68,33,35,74
Arbroath,8252,3,18,8,10,72,49,23,62
Alloa,8252,4,18,8,10,57,43,14,62
Stranraer,8252,5,16,5,15,59,64,-5,53
East Fife,8252,6,13,3,20,47,68,-21,42
Airdrieon,8252,7,10,11,15,46,60,-14,41
Forfar,8252,8,11,5,20,40,65,-25,38
Albion,8252,9,8,7,21,59,80,-21,31
Queen's Park,8252,10,6,10,20,40,74,-34,28
Ayr,8253,1,24,4,8,91,42,49,76
Raith,8253,2,22,9,5,71,35,36,75
Arbroath,8253,3,17,9,10,71,49,22,60
Alloa,8253,4,17,9,10,59,46,13,60
Stranraer,8253,5,15,5,16,55,65,-10,50
East Fife,8253,6,14,3,19,48,64,-16,45
Airdrieon,8253,7,11,11,14,50,59,-9,44
Forfar,8253,8,10,5,21,39,69,-30,35
Albion,8253,9,8,6,22,57,79,-22,30
Queen's Park,8253,10,6,11,19,40,73,-33,29
Raith,8254,1,23,8,5,71,33,38,77
Ayr,8254,2,23,4,9,91,44,47,73
Arbroath,8254,3,18,8,10,71,48,23,62
Alloa,8254,4,17,8,11,57,46,11,59
Stranraer,8254,5,15,5,16,56,66,-10,50
East Fife,8254,6,14,3,19,49,65,-16,45
Airdrieon,8254,7,11,11,14,46,58,-12,44
Forfar,8254,8,10,5,21,38,65,-27,35
Albion,8254,9,9,6,21,59,79,-20,33
Queen's Park,8254,10,6,10,20,39,73,-34,28
Ayr,8255,1,24,4,8,93,44,49,76
Raith,8255,2,22,9,5,68,32,36,75
Arbroath,8255,3,18,8,10,73,50,23,62
Alloa,8255,4,17,9,10,56,43,13,60
Stranraer,8255,5,15,5,16,55,68,-13,50
East Fife,8255,6,14,3,19,51,64,-13,45
Airdrieon,8255,7,10,11,15,45,59,-14,41
Forfar,8255,8,11,5,20,39,64,-25,38
Albion,8255,9,8,6,22,59,81,-22,30
Queen's Park,8255,10,6,10,20,41,75,-34,28
Ayr,8256,1,24,4,8,94,42,52,76
Raith,8256,2,22,8,6,68,33,35,74
Arbroath,8256,3,18,8,10,72,49,23,62
Alloa,8256,4,18,8,10,57,43,14,62
Stranraer,8256,5,16,5,15,58,65,-7,53
East Fife,8256,6,13,3,20,48,67,-19,42
Airdrieon,8256,7,10,11,15,46,60,-14,41
Forfar,8256,8,11,5,20,40,65,-25,38
Albion,8256,9,8,6,22,57,82,-25,30
Queen's Park,8256,10,6,10,20,40,74,-34,28
Raith,8257,1,23,8,5,71,33,38,77
Ayr,8257,2,23,4,9,91,44,47,73
Arbroath,8257,3,18,8,10,75,49,26,62
Alloa,8257,4,17,8,11,57,46,11,59
Stranraer,8257,5,15,5,16,56,67,-11,50
East Fife,8257,6,14,3,19,50,65,-15,45
Airdrieon,8257,7,11,11,14,47,59,-12,44
Forfar,8257,8,10,5,21,39,66,-27,35
Albion,8257,9,9,6,21,59,79,-20,33
Queen's Park,8257,10,6,10,20,40,77,-37,28
Ayr,8258,1,24,4,8,92,43,49,76
Raith,8258,2,22,9,5,69,33,36,75
Arbroath,8258,3,17,9,10,71,49,22,60
Alloa,8258,4,17,9,10,57,44,13,60
Stranraer,8258,5,15,5,16,55,65,-10,50
East Fife,8258,6,14,3,19,48,64,-16,45
Airdrieon,8258,7,11,11,14,48,59,-11,44
Forfar,8258,8,10,5,21,39,67,-28,35
Albion,8258,9,8,6,22,58,80,-22,30
Queen's Park,8258,10,6,11,19,40,73,-33,29
Ayr,8259,1,24,4,8,94,42,52,76
Raith,8259,2,22,9,5,68,32,36,75
Arbroath,8259,3,18,8,10,72,49,23,62
Alloa,8259,4,17,9,10,56,43,13,60
Stranraer,8259,5,15,5,16,55,65,-10,50
East Fife,8259,6,14,3,19,48,64,-16,45
Airdrieon,8259,7,10,11,15,46,60,-14,41
Forfar,8259,8,11,5,20,40,65,-25,38
Albion,8259,9,8,6,22,57,82,-25,30
Queen's Park,8259,10,6,10,20,40,74,-34,28
Ayr,8260,1,24,4,8,94,42,52,76
Raith,8260,2,22,9,5,69,33,36,75
Alloa,8260,3,17,9,10,57,44,13,60
Arbroath,8260,4,17,8,11,70,49,21,59
Stranraer,8260,5,16,5,15,58,65,-7,53
Airdrieon,8260,6,11,11,14,46,58,-12,44
East Fife,8260,7,13,3,20,48,67,-19,42
Forfar,8260,8,10,5,21,38,65,-27,35
Queen's Park,8260,9,7,10,19,40,72,-32,31
Albion,8260,10,8,6,22,57,82,-25,30
Raith,8261,1,23,8,5,71,32,39,77
Ayr,8261,2,24,4,8,94,44,50,76
Arbroath,8261,3,17,8,11,71,50,21,59
Alloa,8261,4,17,8,11,56,46,10,59
Stranraer,8261,5,15,5,16,56,67,-11,50
East Fife,8261,6,14,3,19,50,65,-15,45
Airdrieon,8261,7,10,12,14,47,60,-13,42
Forfar,8261,8,10,6,20,40,66,-26,36
Queen's Park,8261,9,7,10,19,41,73,-32,31
Albion,8261,10,8,6,22,59,82,-23,30
Ayr,8262,1,24,4,8,96,44,52,76
Raith,8262,2,22,9,5,69,33,36,75
Arbroath,8262,3,18,8,10,73,49,24,62
Alloa,8262,4,17,9,10,57,44,13,60
Stranraer,8262,5,15,5,16,56,66,-10,50
East Fife,8262,6,14,3,19,49,65,-16,45
Airdrieon,8262,7,10,11,15,45,60,-15,41
Forfar,8262,8,11,5,20,40,64,-24,38
Albion,8262,9,8,6,22,59,84,-25,30
Queen's Park,8262,10,6,10,20,40,75,-35,28
Ayr,8263,1,24,4,8,94,43,51,76
Raith,8263,2,22,9,5,70,34,36,75
Arbroath,8263,3,18,8,10,73,48,25,62
Alloa,8263,4,17,9,10,58,45,13,60
Stranraer,8263,5,15,6,15,56,65,-9,51
Airdrieon,8263,6,11,11,14,48,58,-10,44
East Fife,8263,7,13,4,19,48,65,-17,43
Forfar,8263,8,10,5,21,38,67,-29,35
Albion,8263,9,8,6,22,58,82,-24,30
Queen's Park,8263,10,6,10,20,39,75,-36,28
Ayr,8264,1,24,4,8,93,44,49,76
Raith,8264,2,22,8,6,70,36,34,74
Arbroath,8264,3,18,8,10,72,48,24,62
Alloa,8264,4,18,8,10,60,45,15,62
Stranraer,8264,5,15,5,16,55,67,-12,50
East Fife,8264,6,14,3,19,50,64,-14,45
Airdrieon,8264,7,11,11,14,48,60,-12,44
Forfar,8264,8,10,5,21,40,67,-27,35
Albion,8264,9,8,6,22,59,81,-22,30
Queen's Park,8264,10,6,10,20,39,74,-35,28
Ayr,8265,1,24,4,8,95,44,51,76
Raith,8265,2,22,9,5,69,33,36,75
Alloa,8265,3,17,9,10,57,44,13,60
Arbroath,8265,4,17,8,11,71,50,21,59
Stranraer,8265,5,15,5,16,56,66,-10,50
East Fife,8265,6,14,3,19,49,65,-16,45
Airdrieon,8265,7,10,11,15,45,61,-16,41
Forfar,8265,8,11,5,20,41,64,-23,38
Queen's Park,8265,9,7,10,19,41,73,-32,31
Albion,8265,10,8,6,22,59,83,-24,30
Raith,8266,1,23,8,5,70,32,38,77
Ayr,8266,2,24,4,8,95,43,52,76
Arbroath,8266,3,18,8,10,73,49,24,62
Alloa,8266,4,17,8,11,56,45,11,59
Stranraer,8266,5,15,6,15,55,64,-9,51
East Fife,8266,6,13,4,19,47,64,-17,43
Airdrieon,8266,7,10,11,15,46,60,-14,41
Forfar,8266,8,11,5,20,40,65,-25,38
Albion,8266,9,8,6,22,58,83,-25,30
Queen's Park,8266,10,6,10,20,40,75,-35,28
Raith,8267,1,23,8,5,71,32,39,77
Ayr,8267,2,24,4,8,91,42,49,76
Arbroath,8267,3,17,8,11,70,49,21,59
Alloa,8267,4,17,8,11,56,46,10,59
Stranraer,8267,5,15,6,15,56,65,-9,51
Airdrieon,8267,6,11,11,14,50,58,-8,44
East Fife,8267,7,13,4,19,48,65,-17,43
Forfar,8267,8,10,5,21,38,69,-31,35
Queen's Park,8267,9,7,10,19,40,72,-32,31
Albion,8267,10,8,6,22,57,79,-22,30
Ayr,8268,1,24,4,8,92,42,50,76
Raith,8268,2,22,8,6,69,34,35,74
Arbroath,8268,3,18,8,10,73,50,23,62
Alloa,8268,4,18,8,10,58,44,14,62
Stranraer,8268,5,15,6,15,56,65,-9,51
Airdrieon,8268,6,11,11,14,47,59,-12,44
East Fife,8268,7,13,4,19,48,65,-17,43
Forfar,8268,8,10,5,21,39,66,-27,35
Albion,8268,9,8,6,22,57,80,-23,30
Queen's Park,8268,10,6,10,20,41,75,-34,28
Raith,8269,1,23,8,5,69,32,37,77
Ayr,8269,2,24,4,8,93,44,49,76
Arbroath,8269,3,18,8,10,72,49,23,62
Alloa,8269,4,17,8,11,56,44,12,59
Stranraer,8269,5,15,5,16,56,66,-10,50
East Fife,8269,6,14,3,19,49,65,-16,45
Airdrieon,8269,7,10,12,14,46,59,-13,42
Forfar,8269,8,10,6,20,39,65,-26,36
Albion,8269,9,8,6,22,59,81,-22,30
Queen's Park,8269,10,6,10,20,40,74,-34,28
Raith,8270,1,23,8,5,70,33,37,77
Ayr,8270,2,24,4,8,95,44,51,76
Arbroath,8270,3,18,8,10,72,49,23,62
Alloa,8270,4,17,8,11,57,45,12,59
Stranraer,8270,5,16,5,15,59,65,-6,53
Airdrieon,8270,6,10,12,14,46,59,-13,42
East Fife,8270,7,13,3,20,48,68,-20,42
Forfar,8270,8,10,6,20,39,65,-26,36
Albion,8270,9,8,6,22,59,83,-24,30
Queen's Park,8270,10,6,10,20,40,74,-34,28
Ayr,8271,1,24,4,8,93,43,50,76
Raith,8271,2,22,8,6,68,34,34,74
Arbroath,8271,3,18,8,10,71,48,23,62
Alloa,8271,4,18,8,10,58,43,15,62
Stranraer,8271,5,15,5,16,55,65,-10,50
East Fife,8271,6,14,3,19,48,64,-16,45
Airdrieon,8271,7,11,11,14,47,58,-11,44
Forfar,8271,8,10,5,21,38,66,-28,35
Albion,8271,9,8,6,22,58,81,-23,30
Queen's Park,8271,10,6,10,20,39,73,-34,28
Ayr,8272,1,24,4,8,95,42,53,76
Raith,8272,2,22,9,5,69,33,36,75
Arbroath,8272,3,18,8,10,74,48,26,62
Alloa,8272,4,17,9,10,57,44,13,60
Stranraer,8272,5,15,5,16,56,68,-12,50
East Fife,8272,6,14,3,19,51,65,-14,45
Airdrieon,8272,7,11,11,14,47,58,-11,44
Forfar,8272,8,10,5,21,38,66,-28,35
Albion,8272,9,8,6,22,57,83,-26,30
Queen's Park,8272,10,6,10,20,39,76,-37,28
Raith,8273,1,23,8,5,71,33,38,77
Ayr,8273,2,23,4,9,90,43,47,73
Arbroath,8273,3,18,8,10,71,48,23,62
Alloa,8273,4,17,8,11,57,46,11,59
Stranraer,8273,5,15,5,16,56,68,-12,50
East Fife,8273,6,14,3,19,51,65,-14,45
Airdrieon,8273,7,11,11,14,48,59,-11,44
Forfar,8273,8,10,5,21,39,67,-28,35
Albion,8273,9,9,6,21,58,78,-20,33
Queen's Park,8273,10,6,10,20,39,73,-34,28
Ayr,8274,1,24,4,8,92,42,50,76
Raith,8274,2,22,8,6,69,36,33,74
Arbroath,8274,3,18,8,10,74,48,26,62
Alloa,8274,4,18,8,10,60,44,16,62
Stranraer,8274,5,15,6,15,57,66,-9,51
East Fife,8274,6,13,4,19,49,66,-17,43
Airdrieon,8274,7,10,12,14,47,60,-13,42
Forfar,8274,8,10,6,20,40,66,-26,36
Albion,8274,9,8,6,22,57,80,-23,30
Queen's Park,8274,10,6,10,20,39,76,-37,28
Ayr,8275,1,24,4,8,92,42,50,76
Raith,8275,2,22,8,6,68,33,35,74
Alloa,8275,3,18,8,10,57,43,14,62
Arbroath,8275,4,17,9,10,72,50,22,60
Stranraer,8275,5,15,6,15,56,65,-9,51
East Fife,8275,6,13,4,19,48,65,-17,43
Airdrieon,8275,7,10,11,15,45,59,-14,41
Forfar,8275,8,11,5,20,39,64,-25,38
Albion,8275,9,8,6,22,57,80,-23,30
Queen's Park,8275,10,6,11,19,41,74,-33,29
Raith,8276,1,22,8,6,68,33,35,74
Ayr,8276,2,23,4,9,91,44,47,73
Arbroath,8276,3,18,8,10,72,48,24,62
Alloa,8276,4,18,8,10,57,43,14,62
Stranraer,8276,5,15,6,15,56,65,-9,51
East Fife,8276,6,13,4,19,48,65,-17,43
Airdrieon,8276,7,10,11,15,46,60,-14,41
Forfar,8276,8,11,5,20,40,65,-25,38
Albion,8276,9,9,6,21,59,79,-20,33
Queen's Park,8276,10,6,10,20,39,74,-35,28
Raith,8277,1,23,8,5,71,33,38,77
Ayr,8277,2,24,4,8,92,42,50,76
Arbroath,8277,3,17,9,10,70,48,22,60
Alloa,8277,4,17,8,11,57,46,11,59
Stranraer,8277,5,15,5,16,55,65,-10,50
East Fife,8277,6,14,3,19,48,64,-16,45
Airdrieon,8277,7,10,12,14,46,59,-13,42
Forfar,8277,8,10,6,20,39,65,-26,36
Albion,8277,9,8,6,22,57,80,-23,30
Queen's Park,8277,10,6,11,19,39,72,-33,29
Raith,8278,1,23,8,5,69,32,37,77
Ayr,8278,2,24,4,8,94,44,50,76
Arbroath,8278,3,17,9,10,70,48,22,60
Alloa,8278,4,17,8,11,56,44,12,59
Stranraer,8278,5,16,5,15,57,64,-7,53
Airdrieon,8278,6,10,12,14,46,59,-13,42
East Fife,8278,7,13,3,20,47,66,-19,42
Forfar,8278,8,10,6,20,39,65,-26,36
Albion,8278,9,8,6,22,59,82,-23,30
Queen's Park,8278,10,6,11,19,39,72,-33,29
Raith,8279,1,23,8,5,72,32,40,77
Ayr,8279,2,23,5,8,92,44,48,74
Arbroath,8279,3,18,8,10,72,48,24,62
Alloa,8279,4,17,8,11,56,47,9,59
Stranraer,8279,5,15,5,16,55,65,-10,50
East Fife,8279,6,14,3,19,48,64,-16,45
Airdrieon,8279,7,11,11,14,49,59,-10,44
Forfar,8279,8,10,5,21,39,68,-29,35
Albion,8279,9,8,7,21,59,80,-21,31
Queen's Park,8279,10,6,10,20,39,74,-35,28
Ayr,8280,1,24,4,8,94,42,52,76
Raith,8280,2,22,9,5,68,32,36,75
Arbroath,8280,3,18,8,10,77,49,28,62
Alloa,8280,4,17,9,10,56,43,13,60
Stranraer,8280,5,15,5,16,55,65,-10,50
East Fife,8280,6,14,3,19,48,64,-16,45
Airdrieon,8280,7,10,12,14,46,59,-13,42
Forfar,8280,8,10,6,20,39,65,-26,36
Albion,8280,9,8,6,22,57,82,-25,30
Queen's Park,8280,10,6,10,20,40,79,-39,28
Raith,8281,1,23,8,5,72,32,40,77
Ayr,8281,2,24,4,8,93,44,49,76
Arbroath,8281,3,17,9,10,71,49,22,60
Alloa,8281,4,17,8,11,56,47,9,59
Stranraer,8281,5,15,6,15,57,66,-9,51
Airdrieon,8281,6,11,11,14,48,59,-11,44
East Fife,8281,7,13,4,19,49,66,-17,43
Forfar,8281,8,10,5,21,39,67,-28,35
Albion,8281,9,8,6,22,59,81,-22,30
Queen's Park,8281,10,6,11,19,40,73,-33,29
Raith,8282,1,23,8,5,72,33,39,77
Ayr,8282,2,24,4,8,95,44,51,76
Arbroath,8282,3,18,8,10,71,48,23,62
Alloa,8282,4,17,8,11,57,47,10,59
Stranraer,8282,5,15,5,16,56,67,-11,50
East Fife,8282,6,14,3,19,50,65,-15,45
Airdrieon,8282,7,11,11,14,46,58,-12,44
Forfar,8282,8,10,5,21,38,65,-27,35
Albion,8282,9,8,6,22,59,83,-24,30
Queen's Park,8282,10,6,10,20,39,73,-34,28
Ayr,8283,1,24,4,8,97,42,55,76
Raith,8283,2,22,9,5,68,32,36,75
Arbroath,8283,3,18,8,10,72,48,24,62
Alloa,8283,4,17,9,10,56,43,13,60
Stranraer,8283,5,16,5,15,59,64,-5,53
Airdrieon,8283,6,11,11,14,46,58,-12,44
East Fife,8283,7,13,3,20,47,68,-21,42
Forfar,8283,8,10,5,21,38,65,-27,35
Albion,8283,9,8,6,22,57,85,-28,30
Queen's Park,8283,10,6,10,20,39,74,-35,28
Ayr,8284,1,24,4,8,95,43,52,76
Raith,8284,2,22,8,6,68,33,35,74
Alloa,8284,3,18,8,10,57,43,14,62
Arbroath,8284,4,17,8,11,70,50,20,59
Stranraer,8284,5,16,5,15,58,66,-8,53
Airdrieon,8284,6,10,12,14,46,59,-13,42
East Fife,8284,7,13,3,20,49,67,-18,42
Forfar,8284,8,10,6,20,39,65,-26,36
Queen's Park,8284,9,7,10,19,41,72,-31,31
Albion,8284,10,8,6,22,58,83,-25,30
Ayr,8285,1,24,4,8,94,44,50,76
Raith,8285,2,22,9,5,69,33,36,75
Arbroath,8285,3,17,9,10,72,50,22,60
Alloa,8285,4,17,9,10,57,44,13,60
Stranraer,8285,5,16,5,15,57,64,-7,53
East Fife,8285,6,13,3,20,47,66,-19,42
Airdrieon,8285,7,10,11,15,46,60,-14,41
Forfar,8285,8,11,5,20,40,65,-25,38
Albion,8285,9,8,6,22,59,82,-23,30
Queen's Park,8285,10,6,11,19,41,74,-33,29
Raith,8286,1,23,8,5,70,32,38,77
Ayr,8286,2,23,5,8,94,46,48,74
Arbroath,8286,3,17,9,10,71,49,22,60
Alloa,8286,4,17,8,11,56,45,11,59
Stranraer,8286,5,16,5,15,58,65,-7,53
East Fife,8286,6,13,3,20,48,67,-19,42
Airdrieon,8286,7,10,11,15,46,63,-17,41
Forfar,8286,8,11,5,20,43,65,-22,38
Albion,8286,9,8,7,21,61,82,-21,31
Queen's Park,8286,10,6,11,19,40,73,-33,29
Raith,8287,1,23,8,5,72,32,40,77
Ayr,8287,2,24,4,8,92,42,50,76
Arbroath,8287,3,18,8,10,72,48,24,62
Alloa,8287,4,17,8,11,56,47,9,59
Stranraer,8287,5,15,6,15,57,66,-9,51
Airdrieon,8287,6,11,11,14,47,58,-11,44
East Fife,8287,7,13,4,19,49,66,-17,43
Forfar,8287,8,10,5,21,38,66,-28,35
Albion,8287,9,8,6,22,57,80,-23,30
Queen's Park,8287,10,6,10,20,39,74,-35,28
Ayr,8288,1,24,4,8,95,44,51,76
Raith,8288,2,22,9,5,69,33,36,75
Arbroath,8288,3,18,8,10,72,48,24,62
Alloa,8288,4,17,9,10,57,44,13,60
Stranraer,8288,5,15,6,15,55,64,-9,51
East Fife,8288,6,13,4,19,47,64,-17,43
Airdrieon,8288,7,10,11,15,45,59,-14,41
Forfar,8288,8,11,5,20,39,64,-25,38
Albion,8288,9,8,6,22,59,83,-24,30
Queen's Park,8288,10,6,10,20,39,74,-35,28
Raith,8289,1,23,8,5,70,32,38,77
Ayr,8289,2,24,4,8,95,42,53,76
Arbroath,8289,3,17,9,10,70,48,22,60
Alloa,8289,4,17,8,11,56,45,11,59
Stranraer,8289,5,16,5,15,57,65,-8,53
East Fife,8289,6,13,3,20,48,66,-18,42
Airdrieon,8289,7,10,11,15,45,60,-15,41
Forfar,8289,8,11,5,20,40,64,-24,38
Albion,8289,9,8,6,22,57,83,-26,30
Queen's Park,8289,10,6,11,19,39,72,-33,29
Raith,8290,1,23,8,5,71,32,39,77
Ayr,8290,2,24,4,8,94,42,52,76
Arbroath,8290,3,18,8,10,72,48,24,62
Alloa,8290,4,17,8,11,56,46,10,59
Stranraer,8290,5,15,5,16,56,71,-15,50
East Fife,8290,6,14,3,19,54,65,-11,45
Airdrieon,8290,7,11,11,14,46,58,-12,44
Forfar,8290,8,10,5,21,38,65,-27,35
Albion,8290,9,8,6,22,57,82,-25,30
Queen's Park,8290,10,6,10,20,39,74,-35,28
Raith,8291,1,23,8,5,71,32,39,77
Ayr,8291,2,24,4,8,93,44,49,76
Arbroath,8291,3,17,8,11,71,50,21,59
Alloa,8291,4,17,8,11,56,46,10,59
Stranraer,8291,5,16,5,15,56,64,-8,53
Airdrieon,8291,6,11,11,14,48,59,-11,44
East Fife,8291,7,13,3,20,47,65,-18,42
Forfar,8291,8,10,5,21,39,67,-28,35
Queen's Park,8291,9,7,10,19,41,73,-32,31
Albion,8291,10,8,6,22,59,81,-22,30
Ayr,8292,1,23,5,8,91,43,48,74
Raith,8292,2,22,8,6,68,33,35,74
Arbroath,8292,3,18,8,10,74,49,25,62
Alloa,8292,4,18,8,10,57,43,14,62
Stranraer,8292,5,16,5,15,58,64,-6,53
Airdrieon,8292,6,11,11,14,46,58,-12,44
East Fife,8292,7,13,3,20,47,67,-20,42
Forfar,8292,8,10,5,21,38,65,-27,35
Albion,8292,9,8,7,21,58,79,-21,31
Queen's Park,8292,10,6,10,20,40,76,-36,28
Raith,8293,1,23,8,5,71,32,39,77
Ayr,8293,2,24,4,8,93,42,51,76
Arbroath,8293,3,18,8,10,71,48,23,62
Alloa,8293,4,17,8,11,56,46,10,59
Stranraer,8293,5,15,5,16,57,67,-10,50
East Fife,8293,6,14,3,19,50,66,-16,45
Airdrieon,8293,7,11,11,14,47,58,-11,44
Forfar,8293,8,10,5,21,38,66,-28,35
Albion,8293,9,8,6,22,57,81,-24,30
Queen's Park,8293,10,6,10,20,39,73,-34,28
Raith,8294,1,23,8,5,71,32,39,77
Ayr,8294,2,24,4,8,94,42,52,76
Arbroath,8294,3,17,8,11,70,51,19,59
Alloa,8294,4,17,8,11,56,46,10,59
Stranraer,8294,5,15,5,16,55,66,-11,50
East Fife,8294,6,14,3,19,49,64,-15,45
Airdrieon,8294,7,11,11,14,47,58,-11,44
Forfar,8294,8,10,5,21,38,66,-28,35
Queen's Park,8294,9,7,10,19,42,72,-30,31
Albion,8294,10,8,6,22,57,82,-25,30
Raith,8295,1,23,8,5,70,33,37,77
Ayr,8295,2,24,4,8,98,44,54,76
Arbroath,8295,3,17,9,10,71,49,22,60
Alloa,8295,4,17,8,11,57,45,12,59
Stranraer,8295,5,16,5,15,58,66,-8,53
Airdrieon,8295,6,10,12,14,45,58,-13,42
East Fife,8295,7,13,3,20,49,67,-18,42
Forfar,8295,8,10,6,20,38,64,-26,36
Albion,8295,9,8,6,22,59,86,-27,30
Queen's Park,8295,10,6,11,19,40,73,-33,29
Ayr,8296,1,24,4,8,93,43,50,76
Raith,8296,2,22,9,5,68,32,36,75
Arbroath,8296,3,18,8,10,71,48,23,62
Alloa,8296,4,17,9,10,56,43,13,60
Stranraer,8296,5,16,5,15,57,65,-8,53
East Fife,8296,6,13,3,20,48,66,-18,42
Airdrieon,8296,7,10,11,15,46,61,-15,41
Forfar,8296,8,11,5,20,41,65,-24,38
Albion,8296,9,8,6,22,58,81,-23,30
Queen's Park,8296,10,6,10,20,39,73,-34,28
Raith,8297,1,23,8,5,69,32,37,77
Ayr,8297,2,24,4,8,93,42,51,76
Arbroath,8297,3,17,8,11,71,50,21,59
Alloa,8297,4,17,8,11,56,44,12,59
Stranraer,8297,5,15,5,16,55,66,-11,50
East Fife,8297,6,14,3,19,49,64,-15,45
Airdrieon,8297,7,10,12,14,46,59,-13,42
Forfar,8297,8,10,6,20,39,65,-26,36
Queen's Park,8297,9,7,10,19,41,73,-32,31
Albion,8297,10,8,6,22,57,81,-24,30
Ayr,8298,1,24,4,8,93,42,51,76
Raith,8298,2,22,8,6,70,35,35,74
Arbroath,8298,3,18,8,10,73,49,24,62
Alloa,8298,4,18,8,10,59,45,14,62
Stranraer,8298,5,15,5,16,55,67,-12,50
East Fife,8298,6,14,3,19,50,64,-14,45
Airdrieon,8298,7,11,11,14,48,59,-11,44
Forfar,8298,8,10,5,21,39,67,-28,35
Albion,8298,9,8,6,22,57,81,-24,30
Queen's Park,8298,10,6,10,20,40,75,-35,28
Raith,8299,1,23,8,5,71,32,39,77
Ayr,8299,2,24,4,8,92,43,49,76
Arbroath,8299,3,18,8,10,71,48,23,62
Alloa,8299,4,17,8,11,56,46,10,59
Stranraer,8299,5,16,5,15,57,64,-7,53
Airdrieon,8299,6,10,12,14,45,58,-13,42
East Fife,8299,7,13,3,20,47,66,-19,42
Forfar,8299,8,10,6,20,38,64,-26,36
Albion,8299,9,8,6,22,58,80,-22,30
Queen's Park,8299,10,6,10,20,39,73,-34,28
Raith,8300,1,22,9,5,70,34,36,75
Ayr,8300,2,23,4,9,91,44,47,73
Arbroath,8300,3,18,8,10,74,49,25,62
Alloa,8300,4,17,9,10,58,45,13,60
Stranraer,8300,5,15,5,16,56,67,-11,50
East Fife,8300,6,14,3,19,50,65,-15,45
Airdrieon,8300,7,10,11,15,45,63,-18,41
Forfar,8300,8,11,5,20,43,64,-21,38
Albion,8300,9,9,6,21,59,79,-20,33
Queen's Park,8300,10,6,10,20,40,76,-36,28
Ayr,8301,1,24,4,8,91,42,49,76
Raith,8301,2,22,9,5,70,34,36,75
Alloa,8301,3,17,9,10,58,45,13,60
Arbroath,8301,4,17,8,11,70,49,21,59
Stranraer,8301,5,15,6,15,56,65,-9,51
East Fife,8301,6,13,4,19,48,65,-17,43
Airdrieon,8301,7,10,11,15,46,60,-14,41
Forfar,8301,8,11,5,20,40,65,-25,38
Queen's Park,8301,9,7,10,19,40,72,-32,31
Albion,8301,10,8,6,22,57,79,-22,30
Raith,8302,1,23,8,5,71,33,38,77
Ayr,8302,2,24,4,8,92,43,49,76
Arbroath,8302,3,17,8,11,70,50,20,59
Alloa,8302,4,17,8,11,57,46,11,59
Stranraer,8302,5,16,5,15,57,64,-7,53
Airdrieon,8302,6,11,11,14,48,58,-10,44
East Fife,8302,7,13,3,20,47,66,-19,42
Forfar,8302,8,10,5,21,38,67,-29,35
Queen's Park,8302,9,7,10,19,41,72,-31,31
Albion,8302,10,8,6,22,58,80,-22,30
Ayr,8303,1,23,5,8,94,46,48,74
Raith,8303,2,22,8,6,69,34,35,74
Alloa,8303,3,18,8,10,58,44,14,62
Arbroath,8303,4,17,9,10,71,49,22,60
Stranraer,8303,5,16,5,15,58,65,-7,53
East Fife,8303,6,13,3,20,48,67,-19,42
Airdrieon,8303,7,10,11,15,46,60,-14,41
Forfar,8303,8,11,5,20,40,65,-25,38
Albion,8303,9,8,7,21,61,82,-21,31
Queen's Park,8303,10,6,11,19,40,73,-33,29
Ayr,8304,1,24,4,8,93,44,49,76
Raith,8304,2,22,9,5,69,33,36,75
Arbroath,8304,3,17,9,10,71,49,22,60
Alloa,8304,4,17,9,10,57,44,13,60
Stranraer,8304,5,15,5,16,55,65,-10,50
East Fife,8304,6,14,3,19,48,64,-16,45
Airdrieon,8304,7,10,11,15,46,60,-14,41
Forfar,8304,8,11,5,20,40,65,-25,38
Albion,8304,9,8,6,22,59,81,-22,30
Queen's Park,8304,10,6,11,19,40,73,-33,29
Ayr,8305,1,24,4,8,93,42,51,76
Raith,8305,2,22,8,6,69,34,35,74
Arbroath,8305,3,18,8,10,75,49,26,62
Alloa,8305,4,18,8,10,58,44,14,62
Stranraer,8305,5,16,5,15,57,65,-8,53
Airdrieon,8305,6,11,11,14,46,58,-12,44
East Fife,8305,7,13,3,20,48,66,-18,42
Forfar,8305,8,10,5,21,38,65,-27,35
Albion,8305,9,8,6,22,57,81,-24,30
Queen's Park,8305,10,6,10,20,40,77,-37,28
Ayr,8306,1,24,4,8,95,42,53,76
Raith,8306,2,22,9,5,68,32,36,75
Arbroath,8306,3,17,9,10,72,50,22,60
Alloa,8306,4,17,9,10,56,43,13,60
Stranraer,8306,5,15,5,16,56,66,-10,50
East Fife,8306,6,14,3,19,49,65,-16,45
Airdrieon,8306,7,10,12,14,46,59,-13,42
Forfar,8306,8,10,6,20,39,65,-26,36
Albion,8306,9,8,6,22,57,83,-26,30
Queen's Park,8306,10,6,11,19,41,74,-33,29
Raith,8307,1,22,9,5,70,34,36,75
Ayr,8307,2,23,5,8,90,42,48,74
Arbroath,8307,3,18,8,10,73,49,24,62
Alloa,8307,4,17,9,10,58,45,13,60
Stranraer,8307,5,15,5,16,55,65,-10,50
East Fife,8307,6,14,3,19,48,64,-16,45
Airdrieon,8307,7,10,12,14,46,59,-13,42
Forfar,8307,8,10,6,20,39,65,-26,36
Albion,8307,9,8,7,21,57,78,-21,31
Queen's Park,8307,10,6,10,20,40,75,-35,28
Raith,8308,1,23,8,5,72,34,38,77
Ayr,8308,2,24,4,8,95,42,53,76
Arbroath,8308,3,17,9,10,72,50,22,60
Alloa,8308,4,17,8,11,58,47,11,59
Stranraer,8308,5,16,5,15,58,65,-7,53
Airdrieon,8308,6,10,12,14,45,58,-13,42
East Fife,8308,7,13,3,20,48,67,-19,42
Forfar,8308,8,10,6,20,38,64,-26,36
Albion,8308,9,8,6,22,57,83,-26,30
Queen's Park,8308,10,6,11,19,41,74,-33,29
Ayr,8309,1,24,4,8,94,42,52,76
Raith,8309,2,22,8,6,69,34,35,74
Arbroath,8309,3,18,8,10,73,49,24,62
Alloa,8309,4,18,8,10,58,44,14,62
Stranraer,8309,5,15,5,16,56,66,-10,50
East Fife,8309,6,14,3,19,49,65,-16,45
Airdrieon,8309,7,11,11,14,46,58,-12,44
Forfar,8309,8,10,5,21,38,65,-27,35
Albion,8309,9,8,6,22,57,82,-25,30
Queen's Park,8309,10,6,10,20,40,75,-35,28
Raith,8310,1,22,9,5,68,32,36,75
Ayr,8310,2,23,4,9,91,44,47,73
Arbroath,8310,3,18,8,10,75,49,26,62
Alloa,8310,4,17,9,10,56,43,13,60
Stranraer,8310,5,15,5,16,56,67,-11,50
East Fife,8310,6,14,3,19,50,65,-15,45
Airdrieon,8310,7,11,11,14,47,59,-12,44
Forfar,8310,8,10,5,21,39,66,-27,35
Albion,8310,9,9,6,21,59,79,-20,33
Queen's Park,8310,10,6,10,20,40,77,-37,28
Raith,8311,1,23,8,5,70,33,37,77
Ayr,8311,2,24,4,8,92,43,49,76
Arbroath,8311,3,17,8,11,71,50,21,59
Alloa,8311,4,17,8,11,57,45,12,59
Stranraer,8311,5,15,5,16,56,66,-10,50
East Fife,8311,6,14,3,19,49,65,-16,45
Airdrieon,8311,7,10,11,15,47,63,-16,41
Forfar,8311,8,11,5,20,43,66,-23,38
Queen's Park,8311,9,7,10,19,41,73,-32,31
Albion,8311,10,8,6,22,58,80,-22,30
Ayr,8312,1,24,4,8,95,45,50,76
Raith,8312,2,22,9,5,71,35,36,75
Alloa,8312,3,17,9,10,59,46,13,60
Arbroath,8312,4,17,8,11,71,50,21,59
Stranraer,8312,5,15,6,15,56,65,-9,51
Airdrieon,8312,6,11,11,14,47,59,-12,44
East Fife,8312,7,13,4,19,48,65,-17,43
Forfar,8312,8,10,5,21,39,66,-27,35
Queen's Park,8312,9,7,10,19,41,73,-32,31
Albion,8312,10,8,6,22,60,83,-23,30
Raith,8313,1,23,8,5,70,33,37,77
Ayr,8313,2,24,4,8,93,44,49,76
Arbroath,8313,3,17,9,10,72,50,22,60
Alloa,8313,4,17,8,11,57,45,12,59
Stranraer,8313,5,15,6,15,56,65,-9,51
East Fife,8313,6,13,4,19,48,65,-17,43
Airdrieon,8313,7,10,11,15,45,59,-14,41
Forfar,8313,8,11,5,20,39,64,-25,38
Albion,8313,9,8,6,22,59,81,-22,30
Queen's Park,8313,10,6,11,19,41,74,-33,29
Ayr,8314,1,24,4,8,96,43,53,76
Raith,8314,2,22,8,6,69,34,35,74
Alloa,8314,3,18,8,10,58,44,14,62
Arbroath,8314,4,17,8,11,70,50,20,59
Stranraer,8314,5,15,5,16,55,66,-11,50
East Fife,8314,6,14,3,19,49,64,-15,45
Airdrieon,8314,7,10,11,15,45,60,-15,41
Forfar,8314,8,11,5,20,40,64,-24,38
Queen's Park,8314,9,7,10,19,41,72,-31,31
Albion,8314,10,8,6,22,58,84,-26,30
Ayr,8315,1,24,4,8,96,42,54,76
Raith,8315,2,22,9,5,69,33,36,75
Arbroath,8315,3,18,8,10,72,48,24,62
Alloa,8315,4,17,9,10,57,44,13,60
Stranraer,8315,5,15,5,16,56,67,-11,50
East Fife,8315,6,14,3,19,50,65,-15,45
Airdrieon,8315,7,11,11,14,50,59,-9,44
Forfar,8315,8,10,5,21,39,69,-30,35
Albion,8315,9,8,6,22,57,84,-27,30
Queen's Park,8315,10,6,10,20,39,74,-35,28
Raith,8316,1,23,8,5,71,32,39,77
Ayr,8316,2,23,5,8,93,45,48,74
Arbroath,8316,3,17,8,11,70,50,20,59
Alloa,8316,4,17,8,11,56,46,10,59
Stranraer,8316,5,16,5,15,59,64,-5,53
Airdrieon,8316,6,10,12,14,46,59,-13,42
East Fife,8316,7,13,3,20,47,68,-21,42
Forfar,8316,8,10,6,20,39,65,-26,36
Albion,8316,9,8,7,21,60,81,-21,31
Queen's Park,8316,10,7,10,19,41,72,-31,31
Raith,8317,1,23,8,5,73,32,41,77
Ayr,8317,2,24,4,8,91,42,49,76
Arbroath,8317,3,18,8,10,73,50,23,62
Alloa,8317,4,17,8,11,56,48,8,59
Stranraer,8317,5,15,6,15,56,65,-9,51
East Fife,8317,6,13,4,19,48,65,-17,43
Airdrieon,8317,7,10,12,14,46,59,-13,42
Forfar,8317,8,10,6,20,39,65,-26,36
Albion,8317,9,8,6,22,57,79,-22,30
Queen's Park,8317,10,6,10,20,41,75,-34,28
Raith,8318,1,23,8,5,71,33,38,77
Ayr,8318,2,24,4,8,94,43,51,76
Arbroath,8318,3,17,8,11,70,49,21,59
Alloa,8318,4,17,8,11,57,46,11,59
Stranraer,8318,5,15,5,16,56,67,-11,50
East Fife,8318,6,14,3,19,50,65,-15,45
Airdrieon,8318,7,10,12,14,46,59,-13,42
Forfar,8318,8,10,6,20,39,65,-26,36
Queen's Park,8318,9,7,10,19,40,72,-32,31
Albion,8318,10,8,6,22,58,82,-24,30
Raith,8319,1,23,8,5,71,32,39,77
Ayr,8319,2,23,5,8,92,44,48,74
Arbroath,8319,3,18,8,10,71,48,23,62
Alloa,8319,4,17,8,11,56,46,10,59
Stranraer,8319,5,16,5,15,57,65,-8,53
Airdrieon,8319,6,11,11,14,49,58,-9,44
East Fife,8319,7,13,3,20,48,66,-18,42
Forfar,8319,8,10,5,21,38,68,-30,35
Albion,8319,9,8,7,21,59,80,-21,31
Queen's Park,8319,10,6,10,20,39,73,-34,28
Ayr,8320,1,24,4,8,94,42,52,76
Raith,8320,2,22,9,5,69,33,36,75
Arbroath,8320,3,18,8,10,76,50,26,62
Alloa,8320,4,17,9,10,57,44,13,60
Stranraer,8320,5,15,5,16,57,68,-11,50
East Fife,8320,6,14,3,19,51,66,-15,45
Airdrieon,8320,7,11,11,14,46,58,-12,44
Forfar,8320,8,10,5,21,38,65,-27,35
Albion,8320,9,8,6,22,57,82,-25,30
Queen's Park,8320,10,6,10,20,41,78,-37,28
Ayr,8321,1,24,4,8,95,43,52,76
Raith,8321,2,22,9,5,71,35,36,75
Alloa,8321,3,17,9,10,59,46,13,60
Arbroath,8321,4,17,8,11,70,50,20,59
Stranraer,8321,5,15,5,16,55,67,-12,50
East Fife,8321,6,14,3,19,50,64,-14,45
Airdrieon,8321,7,10,11,15,45,59,-14,41
Forfar,8321,8,11,5,20,39,64,-25,38
Queen's Park,8321,9,7,10,19,41,72,-31,31
Albion,8321,10,8,6,22,58,83,-25,30
Ayr,8322,1,24,4,8,95,42,53,76
Raith,8322,2,22,9,5,69,33,36,75
Arbroath,8322,3,18,8,10,71,48,23,62
Alloa,8322,4,17,9,10,57,44,13,60
Stranraer,8322,5,15,5,16,56,66,-10,50
East Fife,8322,6,14,3,19,49,65,-16,45
Airdrieon,8322,7,11,11,14,49,60,-11,44
Forfar,8322,8,10,5,21,40,68,-28,35
Albion,8322,9,8,6,22,57,83,-26,30
Queen's Park,8322,10,6,10,20,39,73,-34,28
Raith,8323,1,23,8,5,70,32,38,77
Ayr,8323,2,24,4,8,92,43,49,76
Arbroath,8323,3,17,8,11,70,49,21,59
Alloa,8323,4,17,8,11,56,45,11,59
Stranraer,8323,5,16,5,15,57,65,-8,53
Airdrieon,8323,6,11,11,14,48,59,-11,44
East Fife,8323,7,13,3,20,48,66,-18,42
Forfar,8323,8,10,5,21,39,67,-28,35
Queen's Park,8323,9,7,10,19,40,72,-32,31
Albion,8323,10,8,6,22,58,80,-22,30
Ayr,8324,1,24,4,8,94,44,50,76
Raith,8324,2,22,8,6,68,34,34,74
Alloa,8324,3,18,8,10,58,43,15,62
Arbroath,8324,4,17,9,10,70,48,22,60
Stranraer,8324,5,16,5,15,60,66,-6,53
Airdrieon,8324,6,11,11,14,49,58,-9,44
East Fife,8324,7,13,3,20,49,69,-20,42
Forfar,8324,8,10,5,21,38,68,-30,35
Albion,8324,9,8,6,22,59,82,-23,30
Queen's Park,8324,10,6,11,19,39,72,-33,29
Ayr,8325,1,24,4,8,94,43,51,76
Raith,8325,2,22,8,6,69,35,34,74
Arbroath,8325,3,18,8,10,72,48,24,62
Alloa,8325,4,18,8,10,59,44,15,62
Stranraer,8325,5,15,5,16,56,67,-11,50
East Fife,8325,6,14,3,19,50,65,-15,45
Airdrieon,8325,7,10,12,14,46,59,-13,42
Forfar,8325,8,10,6,20,39,65,-26,36
Albion,8325,9,8,6,22,58,82,-24,30
Queen's Park,8325,10,6,10,20,39,74,-35,28
Ayr,8326,1,24,4,8,92,43,49,76
Raith,8326,2,22,8,6,68,34,34,74
Arbroath,8326,3,18,8,10,73,50,23,62
Alloa,8326,4,18,8,10,58,43,15,62
Stranraer,8326,5,16,5,15,58,64,-6,53
Airdrieon,8326,6,11,11,14,48,58,-10,44
East Fife,8326,7,13,3,20,47,67,-20,42
Forfar,8326,8,10,5,21,38,67,-29,35
Albion,8326,9,8,6,22,58,80,-22,30
Queen's Park,8326,10,6,10,20,41,75,-34,28
Raith,8327,1,23,8,5,70,32,38,77
Ayr,8327,2,24,4,8,95,44,51,76
Arbroath,8327,3,18,8,10,72,48,24,62
Alloa,8327,4,17,8,11,56,45,11,59
Stranraer,8327,5,15,5,16,55,66,-11,50
East Fife,8327,6,14,3,19,49,64,-15,45
Airdrieon,8327,7,10,12,14,46,59,-13,42
Forfar,8327,8,10,6,20,39,65,-26,36
Albion,8327,9,8,6,22,59,83,-24,30
Queen's Park,8327,10,6,10,20,39,74,-35,28
Ayr,8328,1,24,4,8,94,42,52,76
Raith,8328,2,22,8,6,68,34,34,74
Alloa,8328,3,18,8,10,58,43,15,62
Arbroath,8328,4,17,9,10,73,51,22,60
Stranraer,8328,5,15,6,15,57,66,-9,51
East Fife,8328,6,13,4,19,49,66,-17,43
Airdrieon,8328,7,10,11,15,45,59,-14,41
Forfar,8328,8,11,5,20,39,64,-25,38
Albion,8328,9,8,6,22,57,82,-25,30
Queen's Park,8328,10,6,11,19,42,75,-33,29
Ayr,8329,1,24,4,8,93,42,51,76
Raith,8329,2,22,8,6,68,33,35,74
Arbroath,8329,3,18,8,10,73,50,23,62
Alloa,8329,4,18,8,10,57,43,14,62
Stranraer,8329,5,15,6,15,56,65,-9,51
East Fife,8329,6,13,4,19,48,65,-17,43
Airdrieon,8329,7,10,11,15,47,61,-14,41
Forfar,8329,8,11,5,20,41,66,-25,38
Albion,8329,9,8,6,22,57,81,-24,30
Queen's Park,8329,10,6,10,20,41,75,-34,28
Ayr,8330,1,24,4,8,92,42,50,76
Raith,8330,2,22,9,5,69,33,36,75
Arbroath,8330,3,17,9,10,71,49,22,60
Alloa,8330,4,17,9,10,57,44,13,60
Stranraer,8330,5,15,5,16,56,68,-12,50
East Fife,8330,6,14,3,19,51,65,-14,45
Airdrieon,8330,7,11,11,14,47,59,-12,44
Forfar,8330,8,10,5,21,39,66,-27,35
Albion,8330,9,8,6,22,57,80,-23,30
Queen's Park,8330,10,6,11,19,40,73,-33,29
Ayr,8331,1,24,4,8,93,44,49,76
Raith,8331,2,22,9,5,68,32,36,75
Arbroath,8331,3,18,8,10,73,50,23,62
Alloa,8331,4,17,9,10,56,43,13,60
Stranraer,8331,5,16,5,15,57,65,-8,53
Airdrieon,8331,6,11,11,14,47,59,-12,44
East Fife,8331,7,13,3,20,48,66,-18,42
Forfar,8331,8,10,5,21,39,66,-27,35
Albion,8331,9,8,6,22,59,81,-22,30
Queen's Park,8331,10,6,10,20,41,75,-34,28
Ayr,8332,1,24,4,8,95,43,52,76
Raith,8332,2,22,9,5,69,33,36,75
Alloa,8332,3,17,9,10,57,44,13,60
Arbroath,8332,4,17,8,11,70,49,21,59
Stranraer,8332,5,15,5,16,56,67,-11,50
East Fife,8332,6,14,3,19,50,65,-15,45
Airdrieon,8332,7,10,11,15,45,60,-15,41
Forfar,8332,8,11,5,20,40,64,-24,38
Queen's Park,8332,9,7,10,19,40,72,-32,31
Albion,8332,10,8,6,22,58,83,-25,30
Ayr,8333,1,24,4,8,93,44,49,76
Raith,8333,2,22,9,5,69,33,36,75
Alloa,8333,3,17,9,10,57,44,13,60
Arbroath,8333,4,17,8,11,70,49,21,59
Stranraer,8333,5,16,5,15,57,65,-8,53
Airdrieon,8333,6,10,12,14,47,60,-13,42
East Fife,8333,7,13,3,20,48,66,-18,42
Forfar,8333,8,10,6,20,40,66,-26,36
Queen's Park,8333,9,7,10,19,40,72,-32,31
Albion,8333,10,8,6,22,59,81,-22,30
Ayr,8334,1,24,4,8,94,43,51,76
Raith,8334,2,22,9,5,69,33,36,75
Arbroath,8334,3,18,8,10,72,49,23,62
Alloa,8334,4,17,9,10,57,44,13,60
Stranraer,8334,5,15,6,15,56,65,-9,51
Airdrieon,8334,6,11,11,14,48,59,-11,44
East Fife,8334,7,13,4,19,48,65,-17,43
Forfar,8334,8,10,5,21,39,67,-28,35
Albion,8334,9,8,6,22,58,82,-24,30
Queen's Park,8334,10,6,10,20,40,74,-34,28
Ayr,8335,1,24,4,8,92,43,49,76
Raith,8335,2,22,9,5,68,32,36,75
Arbroath,8335,3,17,9,10,72,50,22,60
Alloa,8335,4,17,9,10,56,43,13,60
Stranraer,8335,5,16,5,15,56,64,-8,53
Airdrieon,8335,6,11,11,14,47,59,-12,44
East Fife,8335,7,13,3,20,47,65,-18,42
Forfar,8335,8,10,5,21,39,66,-27,35
Albion,8335,9,8,6,22,58,80,-22,30
Queen's Park,8335,10,6,11,19,41,74,-33,29
Ayr,8336,1,24,4,8,96,43,53,76
Raith,8336,2,22,9,5,69,33,36,75
Arbroath,8336,3,18,8,10,72,48,24,62
Alloa,8336,4,17,9,10,57,44,13,60
Stranraer,8336,5,15,6,15,55,64,-9,51
East Fife,8336,6,13,4,19,47,64,-17,43
Airdrieon,8336,7,10,12,14,46,59,-13,42
Forfar,8336,8,10,6,20,39,65,-26,36
Albion,8336,9,8,6,22,58,84,-26,30
Queen's Park,8336,10,6,10,20,39,74,-35,28
Raith,8337,1,23,8,5,70,32,38,77
Ayr,8337,2,24,4,8,93,44,49,76
Arbroath,8337,3,17,8,11,70,49,21,59
Alloa,8337,4,17,8,11,56,45,11,59
Stranraer,8337,5,16,5,15,58,66,-8,53
East Fife,8337,6,13,3,20,49,67,-18,42
Airdrieon,8337,7,10,11,15,46,60,-14,41
Forfar,8337,8,11,5,20,40,65,-25,38
Queen's Park,8337,9,7,10,19,40,72,-32,31
Albion,8337,10,8,6,22,59,81,-22,30
Ayr,8338,1,24,4,8,94,43,51,76
Raith,8338,2,22,9,5,70,34,36,75
Alloa,8338,3,17,9,10,58,45,13,60
Arbroath,8338,4,17,8,11,72,52,20,59
Stranraer,8338,5,15,5,16,57,68,-11,50
East Fife,8338,6,14,3,19,51,66,-15,45
Airdrieon,8338,7,11,11,14,46,58,-12,44
Forfar,8338,8,10,5,21,38,65,-27,35
Queen's Park,8338,9,7,10,19,43,74,-31,31
Albion,8338,10,8,6,22,58,82,-24,30
Raith,8339,1,23,8,5,72,33,39,77
Ayr,8339,2,24,4,8,95,43,52,76
Arbroath,8339,3,17,8,11,70,51,19,59
Alloa,8339,4,17,8,11,57,47,10,59
Stranraer,8339,5,15,5,16,55,67,-12,50
East Fife,8339,6,14,3,19,50,64,-14,45
Airdrieon,8339,7,11,11,14,47,59,-12,44
Forfar,8339,8,10,5,21,39,66,-27,35
Queen's Park,8339,9,7,10,19,42,72,-30,31
Albion,8339,10,8,6,22,58,83,-25,30
Ayr,8340,1,24,4,8,99,43,56,76
Raith,8340,2,22,8,6,68,33,35,74
Alloa,8340,3,18,8,10,57,43,14,62
Arbroath,8340,4,17,8,11,71,51,20,59
Stranraer,8340,5,15,6,15,56,65,-9,51
Airdrieon,8340,6,11,11,14,48,60,-12,44
East Fife,8340,7,13,4,19,48,65,-17,43
Forfar,8340,8,10,5,21,40,67,-27,35
Queen's Park,8340,9,7,10,19,42,73,-31,31
Albion,8340,10,8,6,22,58,87,-29,30
Raith,8341,1,23,8,5,70,33,37,77
Ayr,8341,2,24,4,8,92,42,50,76
Arbroath,8341,3,17,8,11,70,50,20,59
Alloa,8341,4,17,8,11,57,45,12,59
Stranraer,8341,5,15,5,16,56,66,-10,50
East Fife,8341,6,14,3,19,49,65,-16,45
Airdrieon,8341,7,11,11,14,47,58,-11,44
Forfar,8341,8,10,5,21,38,66,-28,35
Queen's Park,8341,9,7,10,19,41,72,-31,31
Albion,8341,10,8,6,22,57,80,-23,30
Ayr,8342,1,24,4,8,92,42,50,76
Raith,8342,2,22,9,5,69,33,36,75
Arbroath,8342,3,18,8,10,73,48,25,62
Alloa,8342,4,17,9,10,57,44,13,60
Stranraer,8342,5,15,6,15,57,66,-9,51
East Fife,8342,6,13,4,19,49,66,-17,43
Airdrieon,8342,7,10,12,14,47,60,-13,42
Forfar,8342,8,10,6,20,40,66,-26,36
Albion,8342,9,8,6,22,57,80,-23,30
Queen's Park,8342,10,6,10,20,39,75,-36,28
Raith,8343,1,23,8,5,69,32,37,77
Ayr,8343,2,24,4,8,98,43,55,76
Arbroath,8343,3,17,9,10,72,50,22,60
Alloa,8343,4,17,8,11,56,44,12,59
Stranraer,8343,5,16,5,15,59,67,-8,53
Airdrieon,8343,6,11,11,14,47,59,-12,44
East Fife,8343,7,13,3,20,50,68,-18,42
Forfar,8343,8,10,5,21,39,66,-27,35
Albion,8343,9,8,6,22,58,86,-28,30
Queen's Park,8343,10,6,11,19,41,74,-33,29
Raith,8344,1,23,8,5,69,32,37,77
Ayr,8344,2,24,4,8,95,43,52,76
Arbroath,8344,3,17,8,11,71,50,21,59
Alloa,8344,4,17,8,11,56,44,12,59
Stranraer,8344,5,15,6,15,58,67,-9,51
East Fife,8344,6,13,4,19,50,67,-17,43
Airdrieon,8344,7,10,12,14,47,60,-13,42
Forfar,8344,8,10,6,20,40,66,-26,36
Queen's Park,8344,9,7,10,19,41,73,-32,31
Albion,8344,10,8,6,22,58,83,-25,30
Ayr,8345,1,24,4,8,93,42,51,76
Raith,8345,2,22,9,5,68,32,36,75
Alloa,8345,3,17,9,10,56,43,13,60
Arbroath,8345,4,17,8,11,72,52,20,59
Stranraer,8345,5,16,5,15,57,65,-8,53
Airdrieon,8345,6,11,11,14,46,58,-12,44
East Fife,8345,7,13,3,20,48,66,-18,42
Forfar,8345,8,10,5,21,38,65,-27,35
Queen's Park,8345,9,7,10,19,43,74,-31,31
Albion,8345,10,8,6,22,57,81,-24,30
Raith,8346,1,22,9,5,69,33,36,75
Ayr,8346,2,23,5,8,91,43,48,74
Arbroath,8346,3,18,8,10,74,49,25,62
Alloa,8346,4,17,9,10,57,44,13,60
Stranraer,8346,5,15,6,15,58,67,-9,51
East Fife,8346,6,13,4,19,50,67,-17,43
Airdrieon,8346,7,10,11,15,45,59,-14,41
Forfar,8346,8,11,5,20,39,64,-25,38
Albion,8346,9,8,7,21,58,79,-21,31
Queen's Park,8346,10,6,10,20,40,76,-36,28
Raith,8347,1,22,9,5,70,34,36,75
Ayr,8347,2,23,4,9,91,44,47,73
Arbroath,8347,3,17,9,10,71,49,22,60
Alloa,8347,4,17,9,10,58,45,13,60
Stranraer,8347,5,15,5,16,55,67,-12,50
East Fife,8347,6,14,3,19,50,64,-14,45
Airdrieon,8347,7,11,11,14,47,59,-12,44
Forfar,8347,8,10,5,21,39,66,-27,35
Albion,8347,9,9,6,21,59,79,-20,33
Queen's Park,8347,10,6,11,19,40,73,-33,29
Raith,8348,1,23,8,5,69,32,37,77
Ayr,8348,2,23,4,9,92,45,47,73
Arbroath,8348,3,17,8,11,71,51,20,59
Alloa,8348,4,17,8,11,56,44,12,59
Stranraer,8348,5,15,6,15,55,64,-9,51
East Fife,8348,6,13,4,19,47,64,-17,43
Airdrieon,8348,7,10,11,15,45,59,-14,41
Forfar,8348,8,11,5,20,39,64,-25,38
Albion,8348,9,9,6,21,60,80,-20,33
Queen's Park,8348,10,7,10,19,42,73,-31,31
Ayr,8349,1,24,4,8,93,44,49,76
Raith,8349,2,22,9,5,68,32,36,75
Arbroath,8349,3,17,9,10,72,50,22,60
Alloa,8349,4,17,9,10,56,43,13,60
Stranraer,8349,5,16,5,15,57,65,-8,53
Airdrieon,8349,6,11,11,14,47,59,-12,44
East Fife,8349,7,13,3,20,48,66,-18,42
Forfar,8349,8,10,5,21,39,66,-27,35
Albion,8349,9,8,6,22,59,81,-22,30
Queen's Park,8349,10,6,11,19,41,74,-33,29
Raith,8350,1,23,8,5,70,33,37,77
Ayr,8350,2,24,4,8,93,44,49,76
Arbroath,8350,3,18,8,10,71,48,23,62
Alloa,8350,4,17,8,11,57,45,12,59
Stranraer,8350,5,15,6,15,55,64,-9,51
Airdrieon,8350,6,11,11,14,47,58,-11,44
East Fife,8350,7,13,4,19,47,64,-17,43
Forfar,8350,8,10,5,21,38,66,-28,35
Albion,8350,9,8,6,22,59,81,-22,30
Queen's Park,8350,10,6,10,20,39,73,-34,28
Ayr,8351,1,24,4,8,93,43,50,76
Raith,8351,2,22,9,5,68,32,36,75
Arbroath,8351,3,18,8,10,72,49,23,62
Alloa,8351,4,17,9,10,56,43,13,60
Stranraer,8351,5,16,5,15,56,64,-8,53
East Fife,8351,6,13,3,20,47,65,-18,42
Airdrieon,8351,7,10,11,15,46,60,-14,41
Forfar,8351,8,11,5,20,40,65,-25,38
Albion,8351,9,8,6,22,58,81,-23,30
Queen's Park,8351,10,6,10,20,40,74,-34,28
Ayr,8352,1,24,4,8,93,44,49,76
Raith,8352,2,22,8,6,69,35,34,74
Alloa,8352,3,18,8,10,59,44,15,62
Arbroath,8352,4,17,9,10,72,50,22,60
Stranraer,8352,5,15,6,15,55,64,-9,51
Airdrieon,8352,6,11,11,14,47,59,-12,44
East Fife,8352,7,13,4,19,47,64,-17,43
Forfar,8352,8,10,5,21,39,66,-27,35
Albion,8352,9,8,6,22,59,81,-22,30
Queen's Park,8352,10,6,11,19,41,74,-33,29
Ayr,8353,1,24,4,8,94,43,51,76
Raith,8353,2,22,9,5,68,32,36,75
Alloa,8353,3,17,9,10,56,43,13,60
Arbroath,8353,4,17,8,11,72,52,20,59
Stranraer,8353,5,15,5,16,56,67,-11,50
East Fife,8353,6,14,3,19,50,65,-15,45
Airdrieon,8353,7,11,11,14,48,60,-12,44
Forfar,8353,8,10,5,21,40,67,-27,35
Queen's Park,8353,9,7,10,19,43,74,-31,31
Albion,8353,10,8,6,22,58,82,-24,30
Ayr,8354,1,24,4,8,93,42,51,76
Raith,8354,2,22,8,6,69,34,35,74
Arbroath,8354,3,18,8,10,73,49,24,62
Alloa,8354,4,18,8,10,58,44,14,62
Stranraer,8354,5,15,6,15,56,65,-9,51
Airdrieon,8354,6,11,11,14,46,58,-12,44
East Fife,8354,7,13,4,19,48,65,-17,43
Forfar,8354,8,10,5,21,38,65,-27,35
Albion,8354,9,8,6,22,57,81,-24,30
Queen's Park,8354,10,6,10,20,40,75,-35,28
Ayr,8355,1,24,4,8,92,43,49,76
Raith,8355,2,22,9,5,70,34,36,75
Arbroath,8355,3,18,8,10,72,49,23,62
Alloa,8355,4,17,9,10,58,45,13,60
Stranraer,8355,5,15,5,16,55,65,-10,50
East Fife,8355,6,14,3,19,48,64,-16,45
Airdrieon,8355,7,11,11,14,46,58,-12,44
Forfar,8355,8,10,5,21,38,65,-27,35
Albion,8355,9,8,6,22,58,80,-22,30
Queen's Park,8355,10,6,10,20,40,74,-34,28
Raith,8356,1,23,8,5,70,32,38,77
Ayr,8356,2,24,4,8,94,44,50,76
Arbroath,8356,3,17,9,10,72,50,22,60
Alloa,8356,4,17,8,11,56,45,11,59
Stranraer,8356,5,15,6,15,57,66,-9,51
Airdrieon,8356,6,11,11,14,49,59,-10,44
East Fife,8356,7,13,4,19,49,66,-17,43
Forfar,8356,8,10,5,21,39,68,-29,35
Albion,8356,9,8,6,22,59,82,-23,30
Queen's Park,8356,10,6,11,19,41,74,-33,29
Raith,8357,1,23,8,5,71,34,37,77
Ayr,8357,2,24,4,8,98,42,56,76
Arbroath,8357,3,17,8,11,71,50,21,59
Alloa,8357,4,17,8,11,58,46,12,59
Stranraer,8357,5,16,5,15,57,64,-7,53
Airdrieon,8357,6,11,11,14,47,58,-11,44
East Fife,8357,7,13,3,20,47,66,-19,42
Forfar,8357,8,10,5,21,38,66,-28,35
Queen's Park,8357,9,7,10,19,41,73,-32,31
Albion,8357,10,8,6,22,57,86,-29,30
Raith,8358,1,23,8,5,71,33,38,77
Ayr,8358,2,24,4,8,93,43,50,76
Arbroath,8358,3,18,8,10,72,49,23,62
Alloa,8358,4,17,8,11,57,46,11,59
Stranraer,8358,5,15,5,16,55,69,-14,50
East Fife,8358,6,14,3,19,52,64,-12,45
Airdrieon,8358,7,11,11,14,52,59,-7,44
Forfar,8358,8,10,5,21,39,71,-32,35
Albion,8358,9,8,6,22,58,81,-23,30
Queen's Park,8358,10,6,10,20,40,74,-34,28
Ayr,8359,1,24,4,8,92,42,50,76
Raith,8359,2,22,9,5,69,33,36,75
Arbroath,8359,3,17,9,10,72,50,22,60
Alloa,8359,4,17,9,10,57,44,13,60
Stranraer,8359,5,15,5,16,56,66,-10,50
East Fife,8359,6,14,3,19,49,65,-16,45
Airdrieon,8359,7,10,11,15,45,59,-14,41
Forfar,8359,8,11,5,20,39,64,-25,38
Albion,8359,9,8,6,22,57,80,-23,30
Queen's Park,8359,10,6,11,19,41,74,-33,29
Raith,8360,1,23,8,5,69,32,37,77
Ayr,8360,2,24,4,8,94,43,51,76
Arbroath,8360,3,17,8,11,70,50,20,59
Alloa,8360,4,17,8,11,56,44,12,59
Stranraer,8360,5,15,6,15,57,66,-9,51
Airdrieon,8360,6,11,11,14,49,60,-11,44
East Fife,8360,7,13,4,19,49,66,-17,43
Forfar,8360,8,10,5,21,40,68,-28,35
Queen's Park,8360,9,7,10,19,41,72,-31,31
Albion,8360,10,8,6,22,58,82,-24,30
Raith,8361,1,23,8,5,69,32,37,77
Ayr,8361,2,23,4,9,90,43,47,73
Arbroath,8361,3,17,8,11,71,50,21,59
Alloa,8361,4,17,8,11,56,44,12,59
Stranraer,8361,5,15,5,16,55,66,-11,50
East Fife,8361,6,14,3,19,49,64,-15,45
Airdrieon,8361,7,10,11,15,46,61,-15,41
Forfar,8361,8,11,5,20,41,65,-24,38
Albion,8361,9,9,6,21,58,78,-20,33
Queen's Park,8361,10,7,10,19,41,73,-32,31
Raith,8362,1,23,8,5,70,32,38,77
Ayr,8362,2,24,4,8,94,42,52,76
Arbroath,8362,3,18,8,10,72,48,24,62
Alloa,8362,4,17,8,11,56,45,11,59
Stranraer,8362,5,16,5,15,56,64,-8,53
Airdrieon,8362,6,11,11,14,50,58,-8,44
East Fife,8362,7,13,3,20,47,65,-18,42
Forfar,8362,8,10,5,21,38,69,-31,35
Albion,8362,9,8,6,22,57,82,-25,30
Queen's Park,8362,10,6,10,20,39,74,-35,28
Ayr,8363,1,24,4,8,96,42,54,76
Raith,8363,2,22,8,6,68,33,35,74
Alloa,8363,3,18,8,10,57,43,14,62
Arbroath,8363,4,17,8,11,72,51,21,59
Stranraer,8363,5,16,5,15,58,66,-8,53
Airdrieon,8363,6,11,11,14,47,59,-12,44
East Fife,8363,7,13,3,20,49,67,-18,42
Forfar,8363,8,10,5,21,39,66,-27,35
Queen's Park,8363,9,7,10,19,42,74,-32,31
Albion,8363,10,8,6,22,57,84,-27,30
Raith,8364,1,23,8,5,73,35,38,77
Ayr,8364,2,24,4,8,93,42,51,76
Arbroath,8364,3,17,8,11,71,50,21,59
Alloa,8364,4,17,8,11,59,48,11,59
Stranraer,8364,5,15,5,16,55,67,-12,50
East Fife,8364,6,14,3,19,50,64,-14,45
Airdrieon,8364,7,10,11,15,47,61,-14,41
Forfar,8364,8,11,5,20,41,66,-25,38
Queen's Park,8364,9,7,10,19,41,73,-32,31
Albion,8364,10,8,6,22,57,81,-24,30
Raith,8365,1,23,8,5,69,32,37,77
Ayr,8365,2,23,4,9,90,43,47,73
Arbroath,8365,3,17,8,11,70,50,20,59
Alloa,8365,4,17,8,11,56,44,12,59
Stranraer,8365,5,15,5,16,56,66,-10,50
East Fife,8365,6,14,3,19,49,65,-16,45
Airdrieon,8365,7,11,11,14,47,59,-12,44
Forfar,8365,8,10,5,21,39,66,-27,35
Albion,8365,9,9,6,21,58,78,-20,33
Queen's Park,8365,10,7,10,19,41,72,-31,31
Raith,8366,1,23,8,5,69,32,37,77
Ayr,8366,2,24,4,8,96,42,54,76
Arbroath,8366,3,17,9,10,71,49,22,60
Alloa,8366,4,17,8,11,56,44,12,59
Stranraer,8366,5,15,5,16,55,66,-11,50
East Fife,8366,6,14,3,19,49,64,-15,45
Airdrieon,8366,7,10,11,15,45,59,-14,41
Forfar,8366,8,11,5,20,39,64,-25,38
Albion,8366,9,8,6,22,57,84,-27,30
Queen's Park,8366,10,6,11,19,40,73,-33,29
Ayr,8367,1,24,4,8,94,43,51,76
Raith,8367,2,22,9,5,69,33,36,75
Arbroath,8367,3,18,8,10,74,50,24,62
Alloa,8367,4,17,9,10,57,44,13,60
Stranraer,8367,5,15,6,15,56,65,-9,51
East Fife,8367,6,13,4,19,48,65,-17,43
Airdrieon,8367,7,10,12,14,45,58,-13,42
Forfar,8367,8,10,6,20,38,64,-26,36
Albion,8367,9,8,6,22,58,82,-24,30
Queen's Park,8367,10,6,10,20,41,76,-35,28
Raith,8368,1,23,8,5,69,32,37,77
Ayr,8368,2,23,5,8,93,45,48,74
Arbroath,8368,3,17,9,10,70,48,22,60
Alloa,8368,4,17,8,11,56,44,12,59
Stranraer,8368,5,15,5,16,55,67,-12,50
East Fife,8368,6,14,3,19,50,64,-14,45
Airdrieon,8368,7,11,11,14,48,58,-10,44
Forfar,8368,8,10,5,21,38,67,-29,35
Albion,8368,9,8,7,21,60,81,-21,31
Queen's Park,8368,10,6,11,19,39,72,-33,29
Raith,8369,1,23,8,5,70,32,38,77
Ayr,8369,2,24,4,8,93,44,49,76
Arbroath,8369,3,17,8,11,71,52,19,59
Alloa,8369,4,17,8,11,56,45,11,59
Stranraer,8369,5,16,5,15,60,66,-6,53
Airdrieon,8369,6,11,11,14,48,58,-10,44
East Fife,8369,7,13,3,20,49,69,-20,42
Forfar,8369,8,10,5,21,38,67,-29,35
Queen's Park,8369,9,7,10,19,43,73,-30,31
Albion,8369,10,8,6,22,59,81,-22,30
Ayr,8370,1,24,4,8,95,44,51,76
Raith,8370,2,22,8,6,68,34,34,74
Arbroath,8370,3,18,8,10,71,48,23,62
Alloa,8370,4,18,8,10,58,43,15,62
Stranraer,8370,5,16,5,15,56,64,-8,53
Airdrieon,8370,6,11,11,14,47,58,-11,44
East Fife,8370,7,13,3,20,47,65,-18,42
Forfar,8370,8,10,5,21,38,66,-28,35
Albion,8370,9,8,6,22,59,83,-24,30
Queen's Park,8370,10,6,10,20,39,73,-34,28
Raith,8371,1,23,8,5,71,32,39,77
Ayr,8371,2,24,4,8,96,42,54,76
Arbroath,8371,3,17,8,11,70,50,20,59
Alloa,8371,4,17,8,11,56,46,10,59
Stranraer,8371,5,15,6,15,56,65,-9,51
East Fife,8371,6,13,4,19,48,65,-17,43
Airdrieon,8371,7,10,11,15,45,59,-14,41
Forfar,8371,8,11,5,20,39,64,-25,38
Queen's Park,8371,9,7,10,19,41,72,-31,31
Albion,8371,10,8,6,22,57,84,-27,30
Raith,8372,1,23,8,5,69,32,37,77
Ayr,8372,2,24,4,8,96,42,54,76
Arbroath,8372,3,18,8,10,71,48,23,62
Alloa,8372,4,17,8,11,56,44,12,59
Stranraer,8372,5,16,5,15,58,66,-8,53
East Fife,8372,6,13,3,20,49,67,-18,42
Airdrieon,8372,7,10,11,15,45,59,-14,41
Forfar,8372,8,11,5,20,39,64,-25,38
Albion,8372,9,8,6,22,57,84,-27,30
Queen's Park,8372,10,6,10,20,39,73,-34,28
Ayr,8373,1,24,4,8,95,43,52,76
Raith,8373,2,22,8,6,70,35,35,74
Arbroath,8373,3,18,8,10,71,48,23,62
Alloa,8373,4,18,8,10,59,45,14,62
Stranraer,8373,5,15,5,16,55,65,-10,50
East Fife,8373,6,14,3,19,48,64,-16,45
Airdrieon,8373,7,11,11,14,48,58,-10,44
Forfar,8373,8,10,5,21,38,67,-29,35
Albion,8373,9,8,6,22,58,83,-25,30
Queen's Park,8373,10,6,10,20,39,73,-34,28
Raith,8374,1,23,8,5,71,33,38,77
Ayr,8374,2,24,4,8,95,42,53,76
Arbroath,8374,3,17,8,11,70,50,20,59
Alloa,8374,4,17,8,11,57,46,11,59
Stranraer,8374,5,15,6,15,56,65,-9,51
East Fife,8374,6,13,4,19,48,65,-17,43
Airdrieon,8374,7,10,12,14,48,61,-13,42
Forfar,8374,8,10,6,20,41,67,-26,36
Queen's Park,8374,9,7,10,19,41,72,-31,31
Albion,8374,10,8,6,22,57,83,-26,30
Raith,8375,1,23,8,5,70,33,37,77
Ayr,8375,2,23,5,8,92,44,48,74
Arbroath,8375,3,17,8,11,71,50,21,59
Alloa,8375,4,17,8,11,57,45,12,59
Stranraer,8375,5,15,6,15,55,64,-9,51
East Fife,8375,6,13,4,19,47,64,-17,43
Airdrieon,8375,7,10,12,14,45,58,-13,42
Forfar,8375,8,10,6,20,38,64,-26,36
Albion,8375,9,8,7,21,59,80,-21,31
Queen's Park,8375,10,7,10,19,41,73,-32,31
Raith,8376,1,23,8,5,73,33,40,77
Ayr,8376,2,24,4,8,98,43,55,76
Arbroath,8376,3,17,9,10,72,50,22,60
Alloa,8376,4,17,8,11,57,48,9,59
Stranraer,8376,5,15,6,15,57,66,-9,51
Airdrieon,8376,6,11,11,14,47,58,-11,44
East Fife,8376,7,13,4,19,49,66,-17,43
Forfar,8376,8,10,5,21,38,66,-28,35
Albion,8376,9,8,6,22,58,86,-28,30
Queen's Park,8376,10,6,11,19,41,74,-33,29
Raith,8377,1,23,8,5,69,32,37,77
Ayr,8377,2,24,4,8,94,43,51,76
Arbroath,8377,3,17,8,11,70,51,19,59
Alloa,8377,4,17,8,11,56,44,12,59
Stranraer,8377,5,15,5,16,57,67,-10,50
East Fife,8377,6,14,3,19,50,66,-16,45
Airdrieon,8377,7,11,11,14,50,59,-9,44
Forfar,8377,8,10,5,21,39,69,-30,35
Queen's Park,8377,9,7,10,19,42,72,-30,31
Albion,8377,10,8,6,22,58,82,-24,30
Raith,8378,1,23,8,5,69,32,37,77
Ayr,8378,2,24,4,8,92,43,49,76
Arbroath,8378,3,18,8,10,74,49,25,62
Alloa,8378,4,17,8,11,56,44,12,59
Stranraer,8378,5,15,5,16,56,66,-10,50
East Fife,8378,6,14,3,19,49,65,-16,45
Airdrieon,8378,7,11,11,14,47,59,-12,44
Forfar,8378,8,10,5,21,39,66,-27,35
Albion,8378,9,8,6,22,58,80,-22,30
Queen's Park,8378,10,6,10,20,40,76,-36,28
Raith,8379,1,23,8,5,72,32,40,77
Ayr,8379,2,24,4,8,93,42,51,76
Arbroath,8379,3,17,8,11,70,49,21,59
Alloa,8379,4,17,8,11,56,47,9,59
Stranraer,8379,5,15,6,15,56,65,-9,51
East Fife,8379,6,13,4,19,48,65,-17,43
Airdrieon,8379,7,10,11,15,45,59,-14,41
Forfar,8379,8,11,5,20,39,64,-25,38
Queen's Park,8379,9,7,10,19,40,72,-32,31
Albion,8379,10,8,6,22,57,81,-24,30
Raith,8380,1,23,8,5,69,32,37,77
Ayr,8380,2,24,4,8,97,43,54,76
Arbroath,8380,3,18,8,10,73,49,24,62
Alloa,8380,4,17,8,11,56,44,12,59
Stranraer,8380,5,15,6,15,55,64,-9,51
Airdrieon,8380,6,11,11,14,47,59,-12,44
East Fife,8380,7,13,4,19,47,64,-17,43
Forfar,8380,8,10,5,21,39,66,-27,35
Albion,8380,9,8,6,22,58,85,-27,30
Queen's Park,8380,10,6,10,20,40,75,-35,28
Ayr,8381,1,24,4,8,92,43,49,76
Raith,8381,2,22,8,6,69,34,35,74
Arbroath,8381,3,18,8,10,74,48,26,62
Alloa,8381,4,18,8,10,58,44,14,62
Stranraer,8381,5,15,5,16,56,66,-10,50
East Fife,8381,6,14,3,19,49,65,-16,45
Airdrieon,8381,7,10,11,15,45,61,-16,41
Forfar,8381,8,11,5,20,41,64,-23,38
Albion,8381,9,8,6,22,58,80,-22,30
Queen's Park,8381,10,6,10,20,39,76,-37,28
Raith,8382,1,23,8,5,71,32,39,77
Ayr,8382,2,24,4,8,92,42,50,76
Arbroath,8382,3,18,8,10,73,49,24,62
Alloa,8382,4,17,8,11,56,46,10,59
Stranraer,8382,5,16,5,15,59,64,-5,53
East Fife,8382,6,13,3,20,47,68,-21,42
Airdrieon,8382,7,10,11,15,46,60,-14,41
Forfar,8382,8,11,5,20,40,65,-25,38
Albion,8382,9,8,6,22,57,80,-23,30
Queen's Park,8382,10,6,10,20,40,75,-35,28
Ayr,8383,1,24,4,8,94,42,52,76
Raith,8383,2,22,9,5,70,34,36,75
Arbroath,8383,3,17,9,10,72,50,22,60
Alloa,8383,4,17,9,10,58,45,13,60
Stranraer,8383,5,16,5,15,57,65,-8,53
Airdrieon,8383,6,11,11,14,50,59,-9,44
East Fife,8383,7,13,3,20,48,66,-18,42
Forfar,8383,8,10,5,21,39,69,-30,35
Albion,8383,9,8,6,22,57,82,-25,30
Queen's Park,8383,10,6,11,19,41,74,-33,29
Raith,8384,1,22,9,5,68,32,36,75
Ayr,8384,2,23,4,9,93,47,46,73
Arbroath,8384,3,18,8,10,74,51,23,62
Alloa,8384,4,17,9,10,56,43,13,60
Stranraer,8384,5,15,5,16,55,66,-11,50
East Fife,8384,6,14,3,19,49,64,-15,45
Airdrieon,8384,7,11,11,14,46,58,-12,44
Forfar,8384,8,10,5,21,38,65,-27,35
Albion,8384,9,9,6,21,62,81,-19,33
Queen's Park,8384,10,6,10,20,42,76,-34,28
Raith,8385,1,23,8,5,70,32,38,77
Ayr,8385,2,24,4,8,96,44,52,76
Arbroath,8385,3,18,8,10,71,48,23,62
Alloa,8385,4,17,8,11,56,45,11,59
Stranraer,8385,5,15,5,16,55,65,-10,50
East Fife,8385,6,14,3,19,48,64,-16,45
Airdrieon,8385,7,10,11,15,47,61,-14,41
Forfar,8385,8,11,5,20,41,66,-25,38
Albion,8385,9,8,6,22,59,84,-25,30
Queen's Park,8385,10,6,10,20,39,73,-34,28
Ayr,8386,1,24,4,8,94,42,52,76
Raith,8386,2,22,8,6,69,34,35,74
Arbroath,8386,3,18,8,10,74,48,26,62
Alloa,8386,4,18,8,10,58,44,14,62
Stranraer,8386,5,15,6,15,56,65,-9,51
Airdrieon,8386,6,11,11,14,49,59,-10,44
East Fife,8386,7,13,4,19,48,65,-17,43
Forfar,8386,8,10,5,21,39,68,-29,35
Albion,8386,9,8,6,22,57,82,-25,30
Queen's Park,8386,10,6,10,20,39,76,-37,28
Ayr,8387,1,24,4,8,93,42,51,76
Raith,8387,2,22,9,5,70,34,36,75
Arbroath,8387,3,17,9,10,70,48,22,60
Alloa,8387,4,17,9,10,58,45,13,60
Stranraer,8387,5,15,5,16,56,66,-10,50
East Fife,8387,6,14,3,19,49,65,-16,45
Airdrieon,8387,7,11,11,14,47,59,-12,44
Forfar,8387,8,10,5,21,39,66,-27,35
Albion,8387,9,8,6,22,57,81,-24,30
Queen's Park,8387,10,6,11,19,39,72,-33,29
Raith,8388,1,23,8,5,70,32,38,77
Ayr,8388,2,24,4,8,95,43,52,76
Arbroath,8388,3,17,9,10,72,50,22,60
Alloa,8388,4,17,8,11,56,45,11,59
Stranraer,8388,5,15,5,16,55,68,-13,50
East Fife,8388,6,14,3,19,51,64,-13,45
Airdrieon,8388,7,10,11,15,45,59,-14,41
Forfar,8388,8,11,5,20,39,64,-25,38
Albion,8388,9,8,6,22,58,83,-25,30
Queen's Park,8388,10,6,11,19,41,74,-33,29
Raith,8389,1,23,8,5,70,32,38,77
Ayr,8389,2,23,4,9,92,45,47,73
Arbroath,8389,3,18,8,10,73,48,25,62
Alloa,8389,4,17,8,11,56,45,11,59
Stranraer,8389,5,16,5,15,57,65,-8,53
Airdrieon,8389,6,10,12,14,45,58,-13,42
East Fife,8389,7,13,3,20,48,66,-18,42
Forfar,8389,8,10,6,20,38,64,-26,36
Albion,8389,9,9,6,21,60,80,-20,33
Queen's Park,8389,10,6,10,20,39,75,-36,28
Ayr,8390,1,24,4,8,96,42,54,76
Raith,8390,2,22,8,6,69,34,35,74
Arbroath,8390,3,18,8,10,72,48,24,62
Alloa,8390,4,18,8,10,58,44,14,62
Stranraer,8390,5,15,5,16,55,67,-12,50
East Fife,8390,6,14,3,19,50,64,-14,45
Airdrieon,8390,7,10,11,15,45,60,-15,41
Forfar,8390,8,11,5,20,40,64,-24,38
Albion,8390,9,8,6,22,57,84,-27,30
Queen's Park,8390,10,6,10,20,39,74,-35,28
Ayr,8391,1,24,4,8,93,43,50,76
Raith,8391,2,22,8,6,69,36,33,74
Alloa,8391,3,18,8,10,60,44,16,62
Arbroath,8391,4,17,9,10,70,48,22,60
Stranraer,8391,5,16,5,15,58,66,-8,53
Airdrieon,8391,6,11,11,14,48,58,-10,44
East Fife,8391,7,13,3,20,49,67,-18,42
Forfar,8391,8,10,5,21,38,67,-29,35
Albion,8391,9,8,6,22,58,81,-23,30
Queen's Park,8391,10,6,11,19,39,72,-33,29
Ayr,8392,1,24,4,8,93,43,50,76
Raith,8392,2,22,9,5,69,33,36,75
Arbroath,8392,3,17,9,10,72,50,22,60
Alloa,8392,4,17,9,10,57,44,13,60
Stranraer,8392,5,15,5,16,58,68,-10,50
East Fife,8392,6,14,3,19,51,67,-16,45
Airdrieon,8392,7,10,11,15,46,61,-15,41
Forfar,8392,8,11,5,20,41,65,-24,38
Albion,8392,9,8,6,22,58,81,-23,30
Queen's Park,8392,10,6,11,19,41,74,-33,29
Ayr,8393,1,24,4,8,95,45,50,76
Raith,8393,2,22,9,5,69,33,36,75
Arbroath,8393,3,18,8,10,73,48,25,62
Alloa,8393,4,17,9,10,57,44,13,60
Stranraer,8393,5,15,6,15,57,66,-9,51
Airdrieon,8393,6,11,11,14,48,59,-11,44
East Fife,8393,7,13,4,19,49,66,-17,43
Forfar,8393,8,10,5,21,39,67,-28,35
Albion,8393,9,8,6,22,60,83,-23,30
Queen's Park,8393,10,6,10,20,39,75,-36,28
Raith,8394,1,22,9,5,69,33,36,75
Ayr,8394,2,23,5,8,92,44,48,74
Arbroath,8394,3,18,8,10,72,49,23,62
Alloa,8394,4,17,9,10,57,44,13,60
Stranraer,8394,5,15,6,15,57,66,-9,51
East Fife,8394,6,13,4,19,49,66,-17,43
Airdrieon,8394,7,10,11,15,45,60,-15,41
Forfar,8394,8,11,5,20,40,64,-24,38
Albion,8394,9,8,7,21,59,80,-21,31
Queen's Park,8394,10,6,10,20,40,74,-34,28
Raith,8395,1,23,8,5,71,34,37,77
Ayr,8395,2,24,4,8,94,42,52,76
Arbroath,8395,3,17,8,11,73,52,21,59
Alloa,8395,4,17,8,11,58,46,12,59
Stranraer,8395,5,15,5,16,56,68,-12,50
East Fife,8395,6,14,3,19,51,65,-14,45
Airdrieon,8395,7,10,12,14,45,58,-13,42
Forfar,8395,8,10,6,20,38,64,-26,36
Queen's Park,8395,9,7,10,19,43,75,-32,31
Albion,8395,10,8,6,22,57,82,-25,30
Raith,8396,1,23,8,5,70,33,37,77
Ayr,8396,2,24,4,8,93,42,51,76
Arbroath,8396,3,17,8,11,70,50,20,59
Alloa,8396,4,17,8,11,57,45,12,59
Stranraer,8396,5,16,5,15,57,65,-8,53
East Fife,8396,6,13,3,20,48,66,-18,42
Airdrieon,8396,7,10,11,15,46,60,-14,41
Forfar,8396,8,11,5,20,40,65,-25,38
Queen's Park,8396,9,7,10,19,41,72,-31,31
Albion,8396,10,8,6,22,57,81,-24,30
Raith,8397,1,23,8,5,70,33,37,77
Ayr,8397,2,24,4,8,96,42,54,76
Arbroath,8397,3,18,8,10,72,48,24,62
Alloa,8397,4,17,8,11,57,45,12,59
Stranraer,8397,5,15,5,16,57,67,-10,50
East Fife,8397,6,14,3,19,50,66,-16,45
Airdrieon,8397,7,10,12,14,46,59,-13,42
Forfar,8397,8,10,6,20,39,65,-26,36
Albion,8397,9,8,6,22,57,84,-27,30
Queen's Park,8397,10,6,10,20,39,74,-35,28
Ayr,8398,1,23,5,8,92,44,48,74
Raith,8398,2,22,8,6,69,34,35,74
Arbroath,8398,3,18,8,10,71,48,23,62
Alloa,8398,4,18,8,10,58,44,14,62
Stranraer,8398,5,15,6,15,57,66,-9,51
Airdrieon,8398,6,11,11,14,46,58,-12,44
East Fife,8398,7,13,4,19,49,66,-17,43
Forfar,8398,8,10,5,21,38,65,-27,35
Albion,8398,9,8,7,21,59,80,-21,31
Queen's Park,8398,10,6,10,20,39,73,-34,28
Raith,8399,1,23,8,5,71,33,38,77
Ayr,8399,2,24,4,8,93,42,51,76
Arbroath,8399,3,17,8,11,71,51,20,59
Alloa,8399,4,17,8,11,57,46,11,59
Stranraer,8399,5,15,5,16,56,67,-11,50
East Fife,8399,6,14,3,19,50,65,-15,45
Airdrieon,8399,7,11,11,14,48,59,-11,44
Forfar,8399,8,10,5,21,39,67,-28,35
Queen's Park,8399,9,7,10,19,42,73,-31,31
Albion,8399,10,8,6,22,57,81,-24,30
Raith,8400,1,23,8,5,71,34,37,77
Ayr,8400,2,23,4,9,90,43,47,73
Arbroath,8400,3,18,8,10,72,49,23,62
Alloa,8400,4,17,8,11,58,46,12,59
Stranraer,8400,5,15,5,16,56,67,-11,50
East Fife,8400,6,14,3,19,50,65,-15,45
Airdrieon,8400,7,11,11,14,47,59,-12,44
Forfar,8400,8,10,5,21,39,66,-27,35
Albion,8400,9,9,6,21,58,78,-20,33
Queen's Park,8400,10,6,10,20,40,74,-34,28
Raith,8401,1,23,8,5,69,32,37,77
Ayr,8401,2,24,4,8,94,43,51,76
Arbroath,8401,3,17,8,11,71,50,21,59
Alloa,8401,4,17,8,11,56,44,12,59
Stranraer,8401,5,15,5,16,56,67,-11,50
East Fife,8401,6,14,3,19,50,65,-15,45
Airdrieon,8401,7,10,12,14,45,58,-13,42
Forfar,8401,8,10,6,20,38,64,-26,36
Queen's Park,8401,9,7,10,19,41,73,-32,31
Albion,8401,10,8,6,22,58,82,-24,30
Raith,8402,1,23,8,5,72,32,40,77
Ayr,8402,2,24,4,8,92,43,49,76
Arbroath,8402,3,18,8,10,72,48,24,62
Alloa,8402,4,17,8,11,56,47,9,59
Stranraer,8402,5,15,6,15,57,66,-9,51
Airdrieon,8402,6,11,11,14,48,58,-10,44
East Fife,8402,7,13,4,19,49,66,-17,43
Forfar,8402,8,10,5,21,38,67,-29,35
Albion,8402,9,8,6,22,58,80,-22,30
Queen's Park,8402,10,6,10,20,39,74,-35,28
Ayr,8403,1,24,4,8,95,43,52,76
Raith,8403,2,22,8,6,68,33,35,74
Alloa,8403,3,18,8,10,57,43,14,62
Arbroath,8403,4,17,8,11,72,52,20,59
Stranraer,8403,5,15,5,16,55,65,-10,50
East Fife,8403,6,14,3,19,48,64,-16,45
Airdrieon,8403,7,11,11,14,48,58,-10,44
Forfar,8403,8,10,5,21,38,67,-29,35
Queen's Park,8403,9,7,10,19,43,74,-31,31
Albion,8403,10,8,6,22,58,83,-25,30
Raith,8404,1,23,8,5,70,32,38,77
Ayr,8404,2,24,4,8,93,44,49,76
Arbroath,8404,3,17,8,11,73,52,21,59
Alloa,8404,4,17,8,11,56,45,11,59
Stranraer,8404,5,16,5,15,58,65,-7,53
East Fife,8404,6,13,3,20,48,67,-19,42
Airdrieon,8404,7,10,11,15,45,61,-16,41
Forfar,8404,8,11,5,20,41,64,-23,38
Queen's Park,8404,9,7,10,19,43,75,-32,31
Albion,8404,10,8,6,22,59,81,-22,30
Raith,8405,1,23,8,5,71,33,38,77
Ayr,8405,2,23,5,8,92,44,48,74
Arbroath,8405,3,18,8,10,74,49,25,62
Alloa,8405,4,17,8,11,57,46,11,59
Stranraer,8405,5,16,5,15,60,66,-6,53
East Fife,8405,6,13,3,20,49,69,-20,42
Airdrieon,8405,7,10,11,15,45,59,-14,41
Forfar,8405,8,11,5,20,39,64,-25,38
Albion,8405,9,8,7,21,59,80,-21,31
Queen's Park,8405,10,6,10,20,40,76,-36,28
Ayr,8406,1,24,4,8,95,43,52,76
Raith,8406,2,22,9,5,69,33,36,75
Arbroath,8406,3,17,9,10,72,50,22,60
Alloa,8406,4,17,9,10,57,44,13,60
Stranraer,8406,5,15,5,16,57,67,-10,50
East Fife,8406,6,14,3,19,50,66,-16,45
Airdrieon,8406,7,11,11,14,46,58,-12,44
Forfar,8406,8,10,5,21,38,65,-27,35
Albion,8406,9,8,6,22,58,83,-25,30
Queen's Park,8406,10,6,11,19,41,74,-33,29
Ayr,8407,1,24,4,8,93,43,50,76
Raith,8407,2,22,8,6,70,35,35,74
Arbroath,8407,3,18,8,10,72,49,23,62
Alloa,8407,4,18,8,10,59,45,14,62
Stranraer,8407,5,15,5,16,56,67,-11,50
East Fife,8407,6,14,3,19,50,65,-15,45
Airdrieon,8407,7,10,12,14,47,60,-13,42
Forfar,8407,8,10,6,20,40,66,-26,36
Albion,8407,9,8,6,22,58,81,-23,30
Queen's Park,8407,10,6,10,20,40,74,-34,28
Ayr,8408,1,24,4,8,93,44,49,76
Raith,8408,2,22,9,5,68,32,36,75
Arbroath,8408,3,17,9,10,72,50,22,60
Alloa,8408,4,17,9,10,56,43,13,60
Stranraer,8408,5,16,5,15,57,65,-8,53
Airdrieon,8408,6,11,11,14,47,59,-12,44
East Fife,8408,7,13,3,20,48,66,-18,42
Forfar,8408,8,10,5,21,39,66,-27,35
Albion,8408,9,8,6,22,59,81,-22,30
Queen's Park,8408,10,6,11,19,41,74,-33,29
Raith,8409,1,23,8,5,70,33,37,77
Ayr,8409,2,24,4,8,95,42,53,76
Arbroath,8409,3,17,8,11,71,50,21,59
Alloa,8409,4,17,8,11,57,45,12,59
Stranraer,8409,5,15,5,16,56,69,-13,50
East Fife,8409,6,14,3,19,52,65,-13,45
Airdrieon,8409,7,11,11,14,48,58,-10,44
Forfar,8409,8,10,5,21,38,67,-29,35
Queen's Park,8409,9,7,10,19,41,73,-32,31
Albion,8409,10,8,6,22,57,83,-26,30
Ayr,8410,1,24,4,8,92,43,49,76
Raith,8410,2,22,8,6,69,34,35,74
Arbroath,8410,3,18,8,10,72,48,24,62
Alloa,8410,4,18,8,10,58,44,14,62
Stranraer,8410,5,16,5,15,56,64,-8,53
Airdrieon,8410,6,11,11,14,47,59,-12,44
East Fife,8410,7,13,3,20,47,65,-18,42
Forfar,8410,8,10,5,21,39,66,-27,35
Albion,8410,9,8,6,22,58,80,-22,30
Queen's Park,8410,10,6,10,20,39,74,-35,28
Raith,8411,1,23,8,5,69,32,37,77
Ayr,8411,2,24,4,8,94,44,50,76
Arbroath,8411,3,17,9,10,71,49,22,60
Alloa,8411,4,17,8,11,56,44,12,59
Stranraer,8411,5,15,5,16,56,67,-11,50
East Fife,8411,6,14,3,19,50,65,-15,45
Airdrieon,8411,7,10,11,15,46,60,-14,41
Forfar,8411,8,11,5,20,40,65,-25,38
Albion,8411,9,8,6,22,59,82,-23,30
Queen's Park,8411,10,6,11,19,40,73,-33,29
Raith,8412,1,23,8,5,72,33,39,77
Ayr,8412,2,24,4,8,93,44,49,76
Arbroath,8412,3,18,8,10,73,48,25,62
Alloa,8412,4,17,8,11,57,47,10,59
Stranraer,8412,5,16,5,15,58,65,-7,53
Airdrieon,8412,6,10,12,14,47,60,-13,42
East Fife,8412,7,13,3,20,48,67,-19,42
Forfar,8412,8,10,6,20,40,66,-26,36
Albion,8412,9,8,6,22,59,81,-22,30
Queen's Park,8412,10,6,10,20,39,75,-36,28
Raith,8413,1,23,8,5,70,33,37,77
Ayr,8413,2,24,4,8,94,43,51,76
Arbroath,8413,3,18,8,10,74,50,24,62
Alloa,8413,4,17,8,11,57,45,12,59
Stranraer,8413,5,15,6,15,58,67,-9,51
Airdrieon,8413,6,11,11,14,47,58,-11,44
East Fife,8413,7,13,4,19,50,67,-17,43
Forfar,8413,8,10,5,21,38,66,-28,35
Albion,8413,9,8,6,22,58,82,-24,30
Queen's Park,8413,10,6,10,20,41,76,-35,28
Ayr,8414,1,24,4,8,92,42,50,76
Raith,8414,2,22,9,5,70,34,36,75
Alloa,8414,3,17,9,10,58,45,13,60
Arbroath,8414,4,17,8,11,73,52,21,59
Stranraer,8414,5,15,5,16,56,67,-11,50
East Fife,8414,6,14,3,19,50,65,-15,45
Airdrieon,8414,7,11,11,14,50,58,-8,44
Forfar,8414,8,10,5,21,38,69,-31,35
Queen's Park,8414,9,7,10,19,43,75,-32,31
Albion,8414,10,8,6,22,57,80,-23,30
Raith,8415,1,22,9,5,68,32,36,75
Ayr,8415,2,23,5,8,91,43,48,74
Arbroath,8415,3,18,8,10,71,48,23,62
Alloa,8415,4,17,9,10,56,43,13,60
Stranraer,8415,5,16,5,15,58,66,-8,53
Airdrieon,8415,6,11,11,14,48,59,-11,44
East Fife,8415,7,13,3,20,49,67,-18,42
Forfar,8415,8,10,5,21,39,67,-28,35
Albion,8415,9,8,7,21,58,79,-21,31
Queen's Park,8415,10,6,10,20,39,73,-34,28
Raith,8416,1,23,8,5,70,33,37,77
Ayr,8416,2,24,4,8,93,44,49,76
Arbroath,8416,3,17,8,11,71,52,19,59
Alloa,8416,4,17,8,11,57,45,12,59
Stranraer,8416,5,16,5,15,58,66,-8,53
Airdrieon,8416,6,10,12,14,46,59,-13,42
East Fife,8416,7,13,3,20,49,67,-18,42
Forfar,8416,8,10,6,20,39,65,-26,36
Queen's Park,8416,9,7,10,19,43,73,-30,31
Albion,8416,10,8,6,22,59,81,-22,30
Ayr,8417,1,24,4,8,97,44,53,76
Raith,8417,2,22,9,5,68,32,36,75
Arbroath,8417,3,18,8,10,71,48,23,62
Alloa,8417,4,17,9,10,56,43,13,60
Stranraer,8417,5,15,6,15,57,66,-9,51
East Fife,8417,6,13,4,19,49,66,-17,43
Airdrieon,8417,7,10,12,14,46,59,-13,42
Forfar,8417,8,10,6,20,39,65,-26,36
Albion,8417,9,8,6,22,59,85,-26,30
Queen's Park,8417,10,6,10,20,39,73,-34,28
Raith,8418,1,23,8,5,70,32,38,77
Ayr,8418,2,23,5,8,91,43,48,74
Arbroath,8418,3,18,8,10,72,49,23,62
Alloa,8418,4,17,8,11,56,45,11,59
Stranraer,8418,5,15,5,16,56,66,-10,50
East Fife,8418,6,14,3,19,49,65,-16,45
Airdrieon,8418,7,10,12,14,46,59,-13,42
Forfar,8418,8,10,6,20,39,65,-26,36
Albion,8418,9,8,7,21,58,79,-21,31
Queen's Park,8418,10,6,10,20,40,74,-34,28
Ayr,8419,1,24,4,8,94,44,50,76
Raith,8419,2,22,9,5,69,33,36,75
Arbroath,8419,3,18,8,10,73,50,23,62
Alloa,8419,4,17,9,10,57,44,13,60
Stranraer,8419,5,15,5,16,56,67,-11,50
East Fife,8419,6,14,3,19,50,65,-15,45
Airdrieon,8419,7,11,11,14,47,58,-11,44
Forfar,8419,8,10,5,21,38,66,-28,35
Albion,8419,9,8,6,22,59,82,-23,30
Queen's Park,8419,10,6,10,20,41,75,-34,28
Raith,8420,1,23,8,5,71,33,38,77
Ayr,8420,2,24,4,8,92,43,49,76
Arbroath,8420,3,17,9,10,70,48,22,60
Alloa,8420,4,17,8,11,57,46,11,59
Stranraer,8420,5,16,5,15,56,64,-8,53
Airdrieon,8420,6,11,11,14,47,58,-11,44
East Fife,8420,7,13,3,20,47,65,-18,42
Forfar,8420,8,10,5,21,38,66,-28,35
Albion,8420,9,8,6,22,58,80,-22,30
Queen's Park,8420,10,6,11,19,39,72,-33,29
Raith,8421,1,23,8,5,69,32,37,77
Ayr,8421,2,24,4,8,94,43,51,76
Arbroath,8421,3,17,8,11,70,50,20,59
Alloa,8421,4,17,8,11,56,44,12,59
Stranraer,8421,5,15,6,15,57,66,-9,51
Airdrieon,8421,6,11,11,14,48,60,-12,44
East Fife,8421,7,13,4,19,49,66,-17,43
Forfar,8421,8,10,5,21,40,67,-27,35
Queen's Park,8421,9,7,10,19,41,72,-31,31
Albion,8421,10,8,6,22,58,82,-24,30
Raith,8422,1,23,8,5,71,33,38,77
Ayr,8422,2,24,4,8,95,44,51,76
Arbroath,8422,3,17,9,10,70,48,22,60
Alloa,8422,4,17,8,11,57,46,11,59
Stranraer,8422,5,15,5,16,55,65,-10,50
East Fife,8422,6,14,3,19,48,64,-16,45
Airdrieon,8422,7,11,11,14,46,58,-12,44
Forfar,8422,8,10,5,21,38,65,-27,35
Albion,8422,9,8,6,22,59,83,-24,30
Queen's Park,8422,10,6,11,19,39,72,-33,29
Raith,8423,1,23,8,5,73,32,41,77
Ayr,8423,2,23,5,8,93,45,48,74
Arbroath,8423,3,18,8,10,75,50,25,62
Alloa,8423,4,17,8,11,56,48,8,59
Stranraer,8423,5,15,5,16,55,65,-10,50
East Fife,8423,6,14,3,19,48,64,-16,45
Airdrieon,8423,7,11,11,14,46,58,-12,44
Forfar,8423,8,10,5,21,38,65,-27,35
Albion,8423,9,8,7,21,60,81,-21,31
Queen's Park,8423,10,6,10,20,41,77,-36,28
Raith,8424,1,23,8,5,70,32,38,77
Ayr,8424,2,24,4,8,96,42,54,76
Arbroath,8424,3,18,8,10,73,49,24,62
Alloa,8424,4,17,8,11,56,45,11,59
Stranraer,8424,5,16,5,15,56,64,-8,53
Airdrieon,8424,6,11,11,14,49,59,-10,44
East Fife,8424,7,13,3,20,47,65,-18,42
Forfar,8424,8,10,5,21,39,68,-29,35
Albion,8424,9,8,6,22,57,84,-27,30
Queen's Park,8424,10,6,10,20,40,75,-35,28
Raith,8425,1,23,8,5,72,32,40,77
Ayr,8425,2,24,4,8,95,43,52,76
Arbroath,8425,3,18,8,10,71,48,23,62
Alloa,8425,4,17,8,11,56,47,9,59
Stranraer,8425,5,16,5,15,56,64,-8,53
Airdrieon,8425,6,11,11,14,48,58,-10,44
East Fife,8425,7,13,3,20,47,65,-18,42
Forfar,8425,8,10,5,21,38,67,-29,35
Albion,8425,9,8,6,22,58,83,-25,30
Queen's Park,8425,10,6,10,20,39,73,-34,28
Ayr,8426,1,24,4,8,93,44,49,76
Raith,8426,2,22,8,6,68,33,35,74
Alloa,8426,3,18,8,10,57,43,14,62
Arbroath,8426,4,17,8,11,70,51,19,59
Stranraer,8426,5,16,5,15,58,64,-6,53
East Fife,8426,6,13,3,20,47,67,-20,42
Airdrieon,8426,7,10,11,15,46,62,-16,41
Forfar,8426,8,11,5,20,42,65,-23,38
Queen's Park,8426,9,7,10,19,42,72,-30,31
Albion,8426,10,8,6,22,59,81,-22,30
Raith,8427,1,22,9,5,69,33,36,75
Ayr,8427,2,23,5,8,92,44,48,74
Arbroath,8427,3,18,8,10,74,50,24,62
Alloa,8427,4,17,9,10,57,44,13,60
Stranraer,8427,5,15,6,15,55,64,-9,51
Airdrieon,8427,6,11,11,14,46,58,-12,44
East Fife,8427,7,13,4,19,47,64,-17,43
Forfar,8427,8,10,5,21,38,65,-27,35
Albion,8427,9,8,7,21,59,80,-21,31
Queen's Park,8427,10,6,10,20,41,76,-35,28
Ayr,8428,1,24,4,8,91,42,49,76
Raith,8428,2,22,9,5,68,32,36,75
Arbroath,8428,3,17,9,10,73,51,22,60
Alloa,8428,4,17,9,10,56,43,13,60
Stranraer,8428,5,16,5,15,58,65,-7,53
Airdrieon,8428,6,11,11,14,47,58,-11,44
East Fife,8428,7,13,3,20,48,67,-19,42
Forfar,8428,8,10,5,21,38,66,-28,35
Albion,8428,9,8,6,22,57,79,-22,30
Queen's Park,8428,10,6,11,19,42,75,-33,29
Ayr,8429,1,24,4,8,95,42,53,76
Raith,8429,2,22,9,5,69,33,36,75
Alloa,8429,3,17,9,10,57,44,13,60
Arbroath,8429,4,17,8,11,71,51,20,59
Stranraer,8429,5,15,6,15,56,65,-9,51
East Fife,8429,6,13,4,19,48,65,-17,43
Airdrieon,8429,7,10,11,15,45,60,-15,41
Forfar,8429,8,11,5,20,40,64,-24,38
Queen's Park,8429,9,7,10,19,42,73,-31,31
Albion,8429,10,8,6,22,57,83,-26,30
Ayr,8430,1,24,4,8,93,43,50,76
Raith,8430,2,22,9,5,68,32,36,75
Arbroath,8430,3,18,8,10,74,48,26,62
Alloa,8430,4,17,9,10,56,43,13,60
Stranraer,8430,5,16,5,15,57,65,-8,53
Airdrieon,8430,6,10,12,14,48,61,-13,42
East Fife,8430,7,13,3,20,48,66,-18,42
Forfar,8430,8,10,6,20,41,67,-26,36
Albion,8430,9,8,6,22,58,81,-23,30
Queen's Park,8430,10,6,10,20,39,76,-37,28
Raith,8431,1,23,8,5,70,33,37,77
Ayr,8431,2,24,4,8,97,42,55,76
Arbroath,8431,3,17,9,10,72,50,22,60
Alloa,8431,4,17,8,11,57,45,12,59
Stranraer,8431,5,16,5,15,57,64,-7,53
Airdrieon,8431,6,11,11,14,49,60,-11,44
East Fife,8431,7,13,3,20,47,66,-19,42
Forfar,8431,8,10,5,21,40,68,-28,35
Albion,8431,9,8,6,22,57,85,-28,30
Queen's Park,8431,10,6,11,19,41,74,-33,29
Raith,8432,1,23,8,5,70,32,38,77
Ayr,8432,2,23,5,8,91,43,48,74
Arbroath,8432,3,18,8,10,75,50,25,62
Alloa,8432,4,17,8,11,56,45,11,59
Stranraer,8432,5,16,5,15,60,66,-6,53
Airdrieon,8432,6,11,11,14,49,59,-10,44
East Fife,8432,7,13,3,20,49,69,-20,42
Forfar,8432,8,10,5,21,39,68,-29,35
Albion,8432,9,8,7,21,58,79,-21,31
Queen's Park,8432,10,6,10,20,41,77,-36,28
Ayr,8433,1,24,4,8,92,43,49,76
Raith,8433,2,22,9,5,70,34,36,75
Arbroath,8433,3,18,8,10,71,48,23,62
Alloa,8433,4,17,9,10,58,45,13,60
Stranraer,8433,5,16,5,15,61,64,-3,53
East Fife,8433,6,13,3,20,47,70,-23,42
Airdrieon,8433,7,10,11,15,47,61,-14,41
Forfar,8433,8,11,5,20,41,66,-25,38
Albion,8433,9,8,6,22,58,80,-22,30
Queen's Park,8433,10,6,10,20,39,73,-34,28
Raith,8434,1,23,8,5,70,33,37,77
Ayr,8434,2,24,4,8,96,44,52,76
Arbroath,8434,3,18,8,10,73,49,24,62
Alloa,8434,4,17,8,11,57,45,12,59
Stranraer,8434,5,16,5,15,56,64,-8,53
Airdrieon,8434,6,11,11,14,48,60,-12,44
East Fife,8434,7,13,3,20,47,65,-18,42
Forfar,8434,8,10,5,21,40,67,-27,35
Albion,8434,9,8,6,22,59,84,-25,30
Queen's Park,8434,10,6,10,20,40,75,-35,28
Raith,8435,1,23,8,5,70,33,37,77
Ayr,8435,2,23,4,9,91,44,47,73
Arbroath,8435,3,17,9,10,71,49,22,60
Alloa,8435,4,17,8,11,57,45,12,59
Stranraer,8435,5,16,5,15,58,64,-6,53
East Fife,8435,6,13,3,20,47,67,-20,42
Airdrieon,8435,7,10,11,15,45,59,-14,41
Forfar,8435,8,11,5,20,39,64,-25,38
Albion,8435,9,9,6,21,59,79,-20,33
Queen's Park,8435,10,6,11,19,40,73,-33,29
Ayr,8436,1,24,4,8,96,42,54,76
Raith,8436,2,22,8,6,69,34,35,74
Arbroath,8436,3,18,8,10,72,48,24,62
Alloa,8436,4,18,8,10,58,44,14,62
Stranraer,8436,5,16,5,15,60,66,-6,53
Airdrieon,8436,6,11,11,14,48,58,-10,44
East Fife,8436,7,13,3,20,49,69,-20,42
Forfar,8436,8,10,5,21,38,67,-29,35
Albion,8436,9,8,6,22,57,84,-27,30
Queen's Park,8436,10,6,10,20,39,74,-35,28
Raith,8437,1,23,8,5,70,33,37,77
Ayr,8437,2,24,4,8,94,44,50,76
Arbroath,8437,3,18,8,10,73,49,24,62
Alloa,8437,4,17,8,11,57,45,12,59
Stranraer,8437,5,16,5,15,57,64,-7,53
Airdrieon,8437,6,11,11,14,47,58,-11,44
East Fife,8437,7,13,3,20,47,66,-19,42
Forfar,8437,8,10,5,21,38,66,-28,35
Albion,8437,9,8,6,22,59,82,-23,30
Queen's Park,8437,10,6,10,20,40,75,-35,28
Ayr,8438,1,24,4,8,97,43,54,76
Raith,8438,2,22,9,5,70,34,36,75
Arbroath,8438,3,18,8,10,72,48,24,62
Alloa,8438,4,17,9,10,58,45,13,60
Stranraer,8438,5,15,5,16,55,65,-10,50
East Fife,8438,6,14,3,19,48,64,-16,45
Airdrieon,8438,7,11,11,14,50,58,-8,44
Forfar,8438,8,10,5,21,38,69,-31,35
Albion,8438,9,8,6,22,58,85,-27,30
Queen's Park,8438,10,6,10,20,39,74,-35,28
Raith,8439,1,23,8,5,70,33,37,77
Ayr,8439,2,24,4,8,93,44,49,76
Arbroath,8439,3,18,8,10,73,48,25,62
Alloa,8439,4,17,8,11,57,45,12,59
Stranraer,8439,5,16,5,15,59,65,-6,53
East Fife,8439,6,13,3,20,48,68,-20,42
Airdrieon,8439,7,10,11,15,45,61,-16,41
Forfar,8439,8,11,5,20,41,64,-23,38
Albion,8439,9,8,6,22,59,81,-22,30
Queen's Park,8439,10,6,10,20,39,75,-36,28
Raith,8440,1,23,8,5,72,34,38,77
Ayr,8440,2,23,5,8,92,44,48,74
Arbroath,8440,3,18,8,10,75,51,24,62
Alloa,8440,4,17,8,11,58,47,11,59
Stranraer,8440,5,16,5,15,58,65,-7,53
Airdrieon,8440,6,10,12,14,46,59,-13,42
East Fife,8440,7,13,3,20,48,67,-19,42
Forfar,8440,8,10,6,20,39,65,-26,36
Albion,8440,9,8,7,21,59,80,-21,31
Queen's Park,8440,10,6,10,20,42,77,-35,28
Ayr,8441,1,24,4,8,93,42,51,76
Raith,8441,2,22,8,6,69,36,33,74
Arbroath,8441,3,18,8,10,77,48,29,62
Alloa,8441,4,18,8,10,60,44,16,62
Stranraer,8441,5,15,5,16,56,67,-11,50
East Fife,8441,6,14,3,19,50,65,-15,45
Airdrieon,8441,7,10,12,14,46,59,-13,42
Forfar,8441,8,10,6,20,39,65,-26,36
Albion,8441,9,8,6,22,57,81,-24,30
Queen's Park,8441,10,6,10,20,39,79,-40,28
Ayr,8442,1,24,4,8,94,43,51,76
Raith,8442,2,22,9,5,70,34,36,75
Arbroath,8442,3,17,9,10,70,48,22,60
Alloa,8442,4,17,9,10,58,45,13,60
Stranraer,8442,5,15,5,16,55,65,-10,50
East Fife,8442,6,14,3,19,48,64,-16,45
Airdrieon,8442,7,10,12,14,46,59,-13,42
Forfar,8442,8,10,6,20,39,65,-26,36
Albion,8442,9,8,6,22,58,82,-24,30
Queen's Park,8442,10,6,11,19,39,72,-33,29
Raith,8443,1,23,8,5,71,32,39,77
Ayr,8443,2,24,4,8,95,42,53,76
Arbroath,8443,3,18,8,10,72,48,24,62
Alloa,8443,4,17,8,11,56,46,10,59
Stranraer,8443,5,15,5,16,56,68,-12,50
East Fife,8443,6,14,3,19,51,65,-14,45
Airdrieon,8443,7,10,11,15,45,61,-16,41
Forfar,8443,8,11,5,20,41,64,-23,38
Albion,8443,9,8,6,22,57,83,-26,30
Queen's Park,8443,10,6,10,20,39,74,-35,28
Raith,8444,1,23,8,5,70,33,37,77
Ayr,8444,2,24,4,8,91,42,49,76
Arbroath,8444,3,18,8,10,72,49,23,62
Alloa,8444,4,17,8,11,57,45,12,59
Stranraer,8444,5,16,5,15,56,64,-8,53
Airdrieon,8444,6,10,12,14,46,59,-13,42
East Fife,8444,7,13,3,20,47,65,-18,42
Forfar,8444,8,10,6,20,39,65,-26,36
Albion,8444,9,8,6,22,57,79,-22,30
Queen's Park,8444,10,6,10,20,40,74,-34,28
Ayr,8445,1,24,4,8,92,43,49,76
Raith,8445,2,22,8,6,69,34,35,74
Arbroath,8445,3,18,8,10,74,49,25,62
Alloa,8445,4,18,8,10,58,44,14,62
Stranraer,8445,5,16,5,15,59,65,-6,53
Airdrieon,8445,6,11,11,14,48,59,-11,44
East Fife,8445,7,13,3,20,48,68,-20,42
Forfar,8445,8,10,5,21,39,67,-28,35
Albion,8445,9,8,6,22,58,80,-22,30
Queen's Park,8445,10,6,10,20,40,76,-36,28
Raith,8446,1,23,8,5,71,32,39,77
Ayr,8446,2,24,4,8,96,42,54,76
Arbroath,8446,3,18,8,10,72,49,23,62
Alloa,8446,4,17,8,11,56,46,10,59
Stranraer,8446,5,15,5,16,55,65,-10,50
East Fife,8446,6,14,3,19,48,64,-16,45
Airdrieon,8446,7,10,11,15,46,60,-14,41
Forfar,8446,8,11,5,20,40,65,-25,38
Albion,8446,9,8,6,22,57,84,-27,30
Queen's Park,8446,10,6,10,20,40,74,-34,28
Raith,8447,1,23,8,5,72,34,38,77
Ayr,8447,2,24,4,8,95,44,51,76
Arbroath,8447,3,17,8,11,70,50,20,59
Alloa,8447,4,17,8,11,58,47,11,59
Stranraer,8447,5,15,5,16,57,67,-10,50
East Fife,8447,6,14,3,19,50,66,-16,45
Airdrieon,8447,7,11,11,14,48,58,-10,44
Forfar,8447,8,10,5,21,38,67,-29,35
Queen's Park,8447,9,7,10,19,41,72,-31,31
Albion,8447,10,8,6,22,59,83,-24,30
Raith,8448,1,23,8,5,71,33,38,77
Ayr,8448,2,23,5,8,92,44,48,74
Arbroath,8448,3,18,8,10,73,50,23,62
Alloa,8448,4,17,8,11,57,46,11,59
Stranraer,8448,5,15,6,15,57,66,-9,51
East Fife,8448,6,13,4,19,49,66,-17,43
Airdrieon,8448,7,10,12,14,45,58,-13,42
Forfar,8448,8,10,6,20,38,64,-26,36
Albion,8448,9,8,7,21,59,80,-21,31
Queen's Park,8448,10,6,10,20,41,75,-34,28
Raith,8449,1,23,8,5,70,32,38,77
Ayr,8449,2,24,4,8,95,43,52,76
Arbroath,8449,3,18,8,10,72,48,24,62
Alloa,8449,4,17,8,11,56,45,11,59
Stranraer,8449,5,16,5,15,58,65,-7,53
East Fife,8449,6,13,3,20,48,67,-19,42
Airdrieon,8449,7,10,11,15,45,59,-14,41
Forfar,8449,8,11,5,20,39,64,-25,38
Albion,8449,9,8,6,22,58,83,-25,30
Queen's Park,8449,10,6,10,20,39,74,-35,28
Raith,8450,1,23,8,5,72,32,40,77
Ayr,8450,2,24,4,8,94,44,50,76
Arbroath,8450,3,18,8,10,73,49,24,62
Alloa,8450,4,17,8,11,56,47,9,59
Stranraer,8450,5,15,5,16,55,68,-13,50
East Fife,8450,6,14,3,19,51,64,-13,45
Airdrieon,8450,7,11,11,14,48,60,-12,44
Forfar,8450,8,10,5,21,40,67,-27,35
Albion,8450,9,8,6,22,59,82,-23,30
Queen's Park,8450,10,6,10,20,40,75,-35,28
Raith,8451,1,22,8,6,68,34,34,74
Ayr,8451,2,23,4,9,92,45,47,73
Alloa,8451,3,18,8,10,58,43,15,62
Arbroath,8451,4,17,9,10,71,49,22,60
Stranraer,8451,5,15,5,16,56,67,-11,50
East Fife,8451,6,14,3,19,50,65,-15,45
Airdrieon,8451,7,10,12,14,46,59,-13,42
Forfar,8451,8,10,6,20,39,65,-26,36
Albion,8451,9,9,6,21,60,80,-20,33
Queen's Park,8451,10,6,11,19,40,73,-33,29
Ayr,8452,1,24,4,8,92,43,49,76
Raith,8452,2,22,8,6,68,34,34,74
Arbroath,8452,3,18,8,10,72,49,23,62
Alloa,8452,4,18,8,10,58,43,15,62
Stranraer,8452,5,16,5,15,59,65,-6,53
East Fife,8452,6,13,3,20,48,68,-20,42
Airdrieon,8452,7,10,11,15,45,59,-14,41
Forfar,8452,8,11,5,20,39,64,-25,38
Albion,8452,9,8,6,22,58,80,-22,30
Queen's Park,8452,10,6,10,20,40,74,-34,28
Ayr,8453,1,24,4,8,94,42,52,76
Raith,8453,2,22,9,5,69,33,36,75
Alloa,8453,3,17,9,10,57,44,13,60
Arbroath,8453,4,17,8,11,70,49,21,59
Stranraer,8453,5,15,5,16,56,68,-12,50
East Fife,8453,6,14,3,19,51,65,-14,45
Airdrieon,8453,7,10,11,15,46,60,-14,41
Forfar,8453,8,11,5,20,40,65,-25,38
Queen's Park,8453,9,7,10,19,40,72,-32,31
Albion,8453,10,8,6,22,57,82,-25,30
Ayr,8454,1,24,4,8,92,43,49,76
Raith,8454,2,22,8,6,69,35,34,74
Arbroath,8454,3,18,8,10,72,49,23,62
Alloa,8454,4,18,8,10,59,44,15,62
Stranraer,8454,5,15,5,16,57,67,-10,50
East Fife,8454,6,14,3,19,50,66,-16,45
Airdrieon,8454,7,10,11,15,46,61,-15,41
Forfar,8454,8,11,5,20,41,65,-24,38
Albion,8454,9,8,6,22,58,80,-22,30
Queen's Park,8454,10,6,10,20,40,74,-34,28
Ayr,8455,1,24,4,8,94,43,51,76
Raith,8455,2,22,8,6,68,35,33,74
Alloa,8455,3,18,8,10,59,43,16,62
Arbroath,8455,4,17,9,10,72,50,22,60
Stranraer,8455,5,15,5,16,55,65,-10,50
East Fife,8455,6,14,3,19,48,64,-16,45
Airdrieon,8455,7,11,11,14,47,59,-12,44
Forfar,8455,8,10,5,21,39,66,-27,35
Albion,8455,9,8,6,22,58,82,-24,30
Queen's Park,8455,10,6,11,19,41,74,-33,29
Ayr,8456,1,24,4,8,94,42,52,76
Raith,8456,2,22,9,5,68,32,36,75
Alloa,8456,3,17,9,10,56,43,13,60
Arbroath,8456,4,17,8,11,71,50,21,59
Stranraer,8456,5,16,5,15,57,65,-8,53
Airdrieon,8456,6,11,11,14,47,59,-12,44
East Fife,8456,7,13,3,20,48,66,-18,42
Forfar,8456,8,10,5,21,39,66,-27,35
Queen's Park,8456,9,7,10,19,41,73,-32,31
Albion,8456,10,8,6,22,57,82,-25,30
Raith,8457,1,23,8,5,69,32,37,77
Ayr,8457,2,24,4,8,100,43,57,76
Arbroath,8457,3,18,8,10,71,48,23,62
Alloa,8457,4,17,8,11,56,44,12,59
Stranraer,8457,5,16,5,15,56,64,-8,53
Airdrieon,8457,6,11,11,14,46,58,-12,44
East Fife,8457,7,13,3,20,47,65,-18,42
Forfar,8457,8,10,5,21,38,65,-27,35
Albion,8457,9,8,6,22,58,88,-30,30
Queen's Park,8457,10,6,10,20,39,73,-34,28
Ayr,8458,1,24,4,8,96,42,54,76
Raith,8458,2,22,9,5,71,35,36,75
Arbroath,8458,3,17,9,10,70,48,22,60
Alloa,8458,4,17,9,10,59,46,13,60
Stranraer,8458,5,15,6,15,56,65,-9,51
Airdrieon,8458,6,11,11,14,47,58,-11,44
East Fife,8458,7,13,4,19,48,65,-17,43
Forfar,8458,8,10,5,21,38,66,-28,35
Albion,8458,9,8,6,22,57,84,-27,30
Queen's Park,8458,10,6,11,19,39,72,-33,29
Raith,8459,1,23,8,5,69,32,37,77
Ayr,8459,2,24,4,8,95,44,51,76
Arbroath,8459,3,18,8,10,72,49,23,62
Alloa,8459,4,17,8,11,56,44,12,59
Stranraer,8459,5,15,5,16,55,69,-14,50
East Fife,8459,6,14,3,19,52,64,-12,45
Airdrieon,8459,7,10,11,15,45,59,-14,41
Forfar,8459,8,11,5,20,39,64,-25,38
Albion,8459,9,8,6,22,59,83,-24,30
Queen's Park,8459,10,6,10,20,40,74,-34,28
Raith,8460,1,23,8,5,69,32,37,77
Ayr,8460,2,24,4,8,95,44,51,76
Arbroath,8460,3,18,8,10,72,48,24,62
Alloa,8460,4,17,8,11,56,44,12,59
Stranraer,8460,5,15,5,16,55,66,-11,50
East Fife,8460,6,14,3,19,49,64,-15,45
Airdrieon,8460,7,10,12,14,46,59,-13,42
Forfar,8460,8,10,6,20,39,65,-26,36
Albion,8460,9,8,6,22,59,83,-24,30
Queen's Park,8460,10,6,10,20,39,74,-35,28
Ayr,8461,1,24,4,8,94,43,51,76
Raith,8461,2,22,8,6,68,33,35,74
Arbroath,8461,3,18,8,10,73,48,25,62
Alloa,8461,4,18,8,10,57,43,14,62
Stranraer,8461,5,15,6,15,58,67,-9,51
Airdrieon,8461,6,11,11,14,48,59,-11,44
East Fife,8461,7,13,4,19,50,67,-17,43
Forfar,8461,8,10,5,21,39,67,-28,35
Albion,8461,9,8,6,22,58,82,-24,30
Queen's Park,8461,10,6,10,20,39,75,-36,28
Raith,8462,1,23,8,5,70,33,37,77
Ayr,8462,2,23,5,8,91,43,48,74
Arbroath,8462,3,17,8,11,70,49,21,59
Alloa,8462,4,17,8,11,57,45,12,59
Stranraer,8462,5,16,5,15,58,66,-8,53
Airdrieon,8462,6,11,11,14,46,58,-12,44
East Fife,8462,7,13,3,20,49,67,-18,42
Forfar,8462,8,10,5,21,38,65,-27,35
Albion,8462,9,8,7,21,58,79,-21,31
Queen's Park,8462,10,7,10,19,40,72,-32,31
Ayr,8463,1,24,4,8,94,43,51,76
Raith,8463,2,22,8,6,70,35,35,74
Alloa,8463,3,18,8,10,59,45,14,62
Arbroath,8463,4,17,8,11,70,49,21,59
Stranraer,8463,5,16,5,15,56,64,-8,53
Airdrieon,8463,6,11,11,14,47,59,-12,44
East Fife,8463,7,13,3,20,47,65,-18,42
Forfar,8463,8,10,5,21,39,66,-27,35
Queen's Park,8463,9,7,10,19,40,72,-32,31
Albion,8463,10,8,6,22,58,82,-24,30
Raith,8464,1,23,8,5,72,34,38,77
Ayr,8464,2,24,4,8,93,43,50,76
Arbroath,8464,3,17,9,10,71,49,22,60
Alloa,8464,4,17,8,11,58,47,11,59
Stranraer,8464,5,15,5,16,55,66,-11,50
East Fife,8464,6,14,3,19,49,64,-15,45
Airdrieon,8464,7,10,11,15,46,60,-14,41
Forfar,8464,8,11,5,20,40,65,-25,38
Albion,8464,9,8,6,22,58,81,-23,30
Queen's Park,8464,10,6,11,19,40,73,-33,29
Ayr,8465,1,24,4,8,95,44,51,76
Raith,8465,2,22,8,6,69,35,34,74
Arbroath,8465,3,18,8,10,77,49,28,62
Alloa,8465,4,18,8,10,59,44,15,62
Stranraer,8465,5,15,5,16,55,66,-11,50
East Fife,8465,6,14,3,19,49,64,-15,45
Airdrieon,8465,7,11,11,14,47,58,-11,44
Forfar,8465,8,10,5,21,38,66,-28,35
Albion,8465,9,8,6,22,59,83,-24,30
Queen's Park,8465,10,6,10,20,40,79,-39,28
Raith,8466,1,23,8,5,70,33,37,77
Ayr,8466,2,24,4,8,95,46,49,76
Arbroath,8466,3,17,9,10,70,48,22,60
Alloa,8466,4,17,8,11,57,45,12,59
Stranraer,8466,5,16,5,15,57,65,-8,53
East Fife,8466,6,13,3,20,48,66,-18,42
Airdrieon,8466,7,10,11,15,46,60,-14,41
Forfar,8466,8,11,5,20,40,65,-25,38
Albion,8466,9,8,6,22,61,83,-22,30
Queen's Park,8466,10,6,11,19,39,72,-33,29
Raith,8467,1,23,8,5,71,32,39,77
Ayr,8467,2,24,4,8,97,43,54,76
Arbroath,8467,3,17,9,10,72,50,22,60
Alloa,8467,4,17,8,11,56,46,10,59
Stranraer,8467,5,15,5,16,55,66,-11,50
East Fife,8467,6,14,3,19,49,64,-15,45
Airdrieon,8467,7,11,11,14,48,58,-10,44
Forfar,8467,8,10,5,21,38,67,-29,35
Albion,8467,9,8,6,22,58,85,-27,30
Queen's Park,8467,10,6,11,19,41,74,-33,29
Raith,8468,1,23,8,5,72,34,38,77
Ayr,8468,2,24,4,8,96,42,54,76
Arbroath,8468,3,17,8,11,71,51,20,59
Alloa,8468,4,17,8,11,58,47,11,59
Stranraer,8468,5,16,5,15,56,64,-8,53
Airdrieon,8468,6,11,11,14,46,58,-12,44
East Fife,8468,7,13,3,20,47,65,-18,42
Forfar,8468,8,10,5,21,38,65,-27,35
Queen's Park,8468,9,7,10,19,42,73,-31,31
Albion,8468,10,8,6,22,57,84,-27,30
Raith,8469,1,23,8,5,70,32,38,77
Ayr,8469,2,23,5,8,91,43,48,74
Arbroath,8469,3,17,9,10,71,49,22,60
Alloa,8469,4,17,8,11,56,45,11,59
Stranraer,8469,5,16,5,15,57,65,-8,53
Airdrieon,8469,6,10,12,14,46,59,-13,42
East Fife,8469,7,13,3,20,48,66,-18,42
Forfar,8469,8,10,6,20,39,65,-26,36
Albion,8469,9,8,7,21,58,79,-21,31
Queen's Park,8469,10,6,11,19,40,73,-33,29
Raith,8470,1,23,8,5,72,33,39,77
Ayr,8470,2,24,4,8,95,43,52,76
Arbroath,8470,3,18,8,10,72,49,23,62
Alloa,8470,4,17,8,11,57,47,10,59
Stranraer,8470,5,15,5,16,57,67,-10,50
East Fife,8470,6,14,3,19,50,66,-16,45
Airdrieon,8470,7,10,12,14,48,61,-13,42
Forfar,8470,8,10,6,20,41,67,-26,36
Albion,8470,9,8,6,22,58,83,-25,30
Queen's Park,8470,10,6,10,20,40,74,-34,28
Ayr,8471,1,24,4,8,94,45,49,76
Raith,8471,2,22,9,5,69,33,36,75
Arbroath,8471,3,18,8,10,73,50,23,62
Alloa,8471,4,17,9,10,57,44,13,60
Stranraer,8471,5,16,5,15,56,64,-8,53
Airdrieon,8471,6,11,11,14,46,58,-12,44
East Fife,8471,7,13,3,20,47,65,-18,42
Forfar,8471,8,10,5,21,38,65,-27,35
Albion,8471,9,8,6,22,60,82,-22,30
Queen's Park,8471,10,6,10,20,41,75,-34,28
Raith,8472,1,23,8,5,70,33,37,77
Ayr,8472,2,24,4,8,93,43,50,76
Arbroath,8472,3,18,8,10,73,50,23,62
Alloa,8472,4,17,8,11,57,45,12,59
Stranraer,8472,5,15,5,16,58,68,-10,50
East Fife,8472,6,14,3,19,51,67,-16,45
Airdrieon,8472,7,11,11,14,46,58,-12,44
Forfar,8472,8,10,5,21,38,65,-27,35
Albion,8472,9,8,6,22,58,81,-23,30
Queen's Park,8472,10,6,10,20,41,75,-34,28
Raith,8473,1,23,8,5,70,33,37,77
Ayr,8473,2,24,4,8,92,42,50,76
Arbroath,8473,3,17,8,11,71,50,21,59
Alloa,8473,4,17,8,11,57,45,12,59
Stranraer,8473,5,15,5,16,55,69,-14,50
East Fife,8473,6,14,3,19,52,64,-12,45
Airdrieon,8473,7,10,11,15,46,62,-16,41
Forfar,8473,8,11,5,20,42,65,-23,38
Queen's Park,8473,9,7,10,19,41,73,-32,31
Albion,8473,10,8,6,22,57,80,-23,30
Raith,8474,1,23,8,5,72,34,38,77
Ayr,8474,2,24,4,8,93,44,49,76
Arbroath,8474,3,17,9,10,73,51,22,60
Alloa,8474,4,17,8,11,58,47,11,59
Stranraer,8474,5,15,5,16,55,66,-11,50
East Fife,8474,6,14,3,19,49,64,-15,45
Airdrieon,8474,7,10,12,14,45,58,-13,42
Forfar,8474,8,10,6,20,38,64,-26,36
Albion,8474,9,8,6,22,59,81,-22,30
Queen's Park,8474,10,6,11,19,42,75,-33,29
Ayr,8475,1,24,4,8,92,42,50,76
Raith,8475,2,22,9,5,69,33,36,75
Arbroath,8475,3,17,9,10,72,50,22,60
Alloa,8475,4,17,9,10,57,44,13,60
Stranraer,8475,5,15,5,16,56,67,-11,50
East Fife,8475,6,14,3,19,50,65,-15,45
Airdrieon,8475,7,10,11,15,45,59,-14,41
Forfar,8475,8,11,5,20,39,64,-25,38
Albion,8475,9,8,6,22,57,80,-23,30
Queen's Park,8475,10,6,11,19,41,74,-33,29
Ayr,8476,1,23,5,8,93,45,48,74
Raith,8476,2,22,8,6,68,34,34,74
Arbroath,8476,3,18,8,10,72,49,23,62
Alloa,8476,4,18,8,10,58,43,15,62
Stranraer,8476,5,15,6,15,55,64,-9,51
Airdrieon,8476,6,11,11,14,47,58,-11,44
East Fife,8476,7,13,4,19,47,64,-17,43
Forfar,8476,8,10,5,21,38,66,-28,35
Albion,8476,9,8,7,21,60,81,-21,31
Queen's Park,8476,10,6,10,20,40,74,-34,28
Ayr,8477,1,24,4,8,92,43,49,76
Raith,8477,2,22,9,5,69,33,36,75
Arbroath,8477,3,18,8,10,72,49,23,62
Alloa,8477,4,17,9,10,57,44,13,60
Stranraer,8477,5,15,5,16,56,66,-10,50
East Fife,8477,6,14,3,19,49,65,-16,45
Airdrieon,8477,7,10,12,14,46,59,-13,42
Forfar,8477,8,10,6,20,39,65,-26,36
Albion,8477,9,8,6,22,58,80,-22,30
Queen's Park,8477,10,6,10,20,40,74,-34,28
Ayr,8478,1,24,4,8,92,43,49,76
Raith,8478,2,22,8,6,68,33,35,74
Alloa,8478,3,18,8,10,57,43,14,62
Arbroath,8478,4,17,9,10,71,49,22,60
Stranraer,8478,5,16,5,15,58,66,-8,53
Airdrieon,8478,6,11,11,14,46,58,-12,44
East Fife,8478,7,13,3,20,49,67,-18,42
Forfar,8478,8,10,5,21,38,65,-27,35
Albion,8478,9,8,6,22,58,80,-22,30
Queen's Park,8478,10,6,11,19,40,73,-33,29
Raith,8479,1,23,8,5,70,33,37,77
Ayr,8479,2,24,4,8,91,42,49,76
Arbroath,8479,3,18,8,10,71,48,23,62
Alloa,8479,4,17,8,11,57,45,12,59
Stranraer,8479,5,15,6,15,56,65,-9,51
Airdrieon,8479,6,11,11,14,50,58,-8,44
East Fife,8479,7,13,4,19,48,65,-17,43
Forfar,8479,8,10,5,21,38,69,-31,35
Albion,8479,9,8,6,22,57,79,-22,30
Queen's Park,8479,10,6,10,20,39,73,-34,28
Raith,8480,1,23,8,5,71,34,37,77
Ayr,8480,2,23,5,8,94,46,48,74
Arbroath,8480,3,17,9,10,71,49,22,60
Alloa,8480,4,17,8,11,58,46,12,59
Stranraer,8480,5,15,5,16,55,65,-10,50
East Fife,8480,6,14,3,19,48,64,-16,45
Airdrieon,8480,7,10,12,14,45,58,-13,42
Forfar,8480,8,10,6,20,38,64,-26,36
Albion,8480,9,8,7,21,61,82,-21,31
Queen's Park,8480,10,6,11,19,40,73,-33,29
Raith,8481,1,23,8,5,69,32,37,77
Ayr,8481,2,24,4,8,93,43,50,76
Arbroath,8481,3,18,8,10,74,50,24,62
Alloa,8481,4,17,8,11,56,44,12,59
Stranraer,8481,5,16,5,15,58,66,-8,53
Airdrieon,8481,6,10,12,14,46,59,-13,42
East Fife,8481,7,13,3,20,49,67,-18,42
Forfar,8481,8,10,6,20,39,65,-26,36
Albion,8481,9,8,6,22,58,81,-23,30
Queen's Park,8481,10,6,10,20,41,76,-35,28
Ayr,8482,1,24,4,8,93,42,51,76
Raith,8482,2,22,9,5,69,33,36,75
Arbroath,8482,3,17,9,10,70,48,22,60
Alloa,8482,4,17,9,10,57,44,13,60
Stranraer,8482,5,15,5,16,55,66,-11,50
East Fife,8482,6,14,3,19,49,64,-15,45
Airdrieon,8482,7,10,11,15,45,59,-14,41
Forfar,8482,8,11,5,20,39,64,-25,38
Albion,8482,9,8,6,22,57,81,-24,30
Queen's Park,8482,10,6,11,19,39,72,-33,29
Raith,8483,1,23,8,5,71,32,39,77
Ayr,8483,2,24,4,8,93,43,50,76
Arbroath,8483,3,17,8,11,71,51,20,59
Alloa,8483,4,17,8,11,56,46,10,59
Stranraer,8483,5,16,5,15,57,65,-8,53
Airdrieon,8483,6,11,11,14,49,59,-10,44
East Fife,8483,7,13,3,20,48,66,-18,42
Forfar,8483,8,10,5,21,39,68,-29,35
Queen's Park,8483,9,7,10,19,42,73,-31,31
Albion,8483,10,8,6,22,58,81,-23,30
Raith,8484,1,23,8,5,71,33,38,77
Ayr,8484,2,24,4,8,94,43,51,76
Arbroath,8484,3,17,8,11,75,54,21,59
Alloa,8484,4,17,8,11,57,46,11,59
Stranraer,8484,5,16,5,15,58,64,-6,53
Airdrieon,8484,6,11,11,14,49,60,-11,44
East Fife,8484,7,13,3,20,47,67,-20,42
Forfar,8484,8,10,5,21,40,68,-28,35
Queen's Park,8484,9,7,10,19,45,77,-32,31
Albion,8484,10,8,6,22,58,82,-24,30
Raith,8485,1,23,8,5,69,32,37,77
Ayr,8485,2,23,5,8,93,45,48,74
Arbroath,8485,3,17,9,10,70,48,22,60
Alloa,8485,4,17,8,11,56,44,12,59
Stranraer,8485,5,16,5,15,59,67,-8,53
Airdrieon,8485,6,10,12,14,47,60,-13,42
East Fife,8485,7,13,3,20,50,68,-18,42
Forfar,8485,8,10,6,20,40,66,-26,36
Albion,8485,9,8,7,21,60,81,-21,31
Queen's Park,8485,10,6,11,19,39,72,-33,29
Raith,8486,1,23,8,5,72,32,40,77
Ayr,8486,2,24,4,8,93,42,51,76
Arbroath,8486,3,17,9,10,71,49,22,60
Alloa,8486,4,17,8,11,56,47,9,59
Stranraer,8486,5,15,5,16,55,69,-14,50
East Fife,8486,6,14,3,19,52,64,-12,45
Airdrieon,8486,7,10,11,15,47,61,-14,41
Forfar,8486,8,11,5,20,41,66,-25,38
Albion,8486,9,8,6,22,57,81,-24,30
Queen's Park,8486,10,6,11,19,40,73,-33,29
Raith,8487,1,22,9,5,69,33,36,75
Ayr,8487,2,23,5,8,90,42,48,74
Arbroath,8487,3,18,8,10,74,50,24,62
Alloa,8487,4,17,9,10,57,44,13,60
Stranraer,8487,5,16,5,15,56,64,-8,53
East Fife,8487,6,13,3,20,47,65,-18,42
Airdrieon,8487,7,10,11,15,49,63,-14,41
Forfar,8487,8,11,5,20,43,68,-25,38
Albion,8487,9,8,7,21,57,78,-21,31
Queen's Park,8487,10,6,10,20,41,76,-35,28
Raith,8488,1,23,8,5,70,33,37,77
Ayr,8488,2,24,4,8,93,44,49,76
Arbroath,8488,3,17,9,10,71,49,22,60
Alloa,8488,4,17,8,11,57,45,12,59
Stranraer,8488,5,15,6,15,56,65,-9,51
Airdrieon,8488,6,11,11,14,47,58,-11,44
East Fife,8488,7,13,4,19,48,65,-17,43
Forfar,8488,8,10,5,21,38,66,-28,35
Albion,8488,9,8,6,22,59,81,-22,30
Queen's Park,8488,10,6,11,19,40,73,-33,29
Raith,8489,1,23,8,5,69,32,37,77
Ayr,8489,2,24,4,8,93,43,50,76
Arbroath,8489,3,17,8,11,71,50,21,59
Alloa,8489,4,17,8,11,56,44,12,59
Stranraer,8489,5,15,5,16,56,67,-11,50
East Fife,8489,6,14,3,19,50,65,-15,45
Airdrieon,8489,7,11,11,14,50,59,-9,44
Forfar,8489,8,10,5,21,39,69,-30,35
Queen's Park,8489,9,7,10,19,41,73,-32,31
Albion,8489,10,8,6,22,58,81,-23,30
Raith,8490,1,23,8,5,70,32,38,77
Ayr,8490,2,24,4,8,95,43,52,76
Arbroath,8490,3,17,8,11,70,50,20,59
Alloa,8490,4,17,8,11,56,45,11,59
Stranraer,8490,5,15,6,15,56,65,-9,51
East Fife,8490,6,13,4,19,48,65,-17,43
Airdrieon,8490,7,10,12,14,45,58,-13,42
Forfar,8490,8,10,6,20,38,64,-26,36
Queen's Park,8490,9,7,10,19,41,72,-31,31
Albion,8490,10,8,6,22,58,83,-25,30
Raith,8491,1,23,8,5,71,32,39,77
Ayr,8491,2,24,4,8,94,42,52,76
Arbroath,8491,3,18,8,10,74,50,24,62
Alloa,8491,4,17,8,11,56,46,10,59
Stranraer,8491,5,15,6,15,56,65,-9,51
Airdrieon,8491,6,11,11,14,49,59,-10,44
East Fife,8491,7,13,4,19,48,65,-17,43
Forfar,8491,8,10,5,21,39,68,-29,35
Albion,8491,9,8,6,22,57,82,-25,30
Queen's Park,8491,10,6,10,20,41,76,-35,28
Ayr,8492,1,23,5,8,92,44,48,74
Raith,8492,2,22,8,6,68,34,34,74
Arbroath,8492,3,18,8,10,73,48,25,62
Alloa,8492,4,18,8,10,58,43,15,62
Stranraer,8492,5,15,5,16,55,65,-10,50
East Fife,8492,6,14,3,19,48,64,-16,45
Airdrieon,8492,7,11,11,14,48,58,-10,44
Forfar,8492,8,10,5,21,38,67,-29,35
Albion,8492,9,8,7,21,59,80,-21,31
Queen's Park,8492,10,6,10,20,39,75,-36,28
Raith,8493,1,23,8,5,70,33,37,77
Ayr,8493,2,24,4,8,93,43,50,76
Arbroath,8493,3,17,8,11,70,51,19,59
Alloa,8493,4,17,8,11,57,45,12,59
Stranraer,8493,5,15,5,16,55,65,-10,50
East Fife,8493,6,14,3,19,48,64,-16,45
Airdrieon,8493,7,10,11,15,47,61,-14,41
Forfar,8493,8,11,5,20,41,66,-25,38
Queen's Park,8493,9,7,10,19,42,72,-30,31
Albion,8493,10,8,6,22,58,81,-23,30
Ayr,8494,1,24,4,8,93,42,51,76
Raith,8494,2,22,9,5,69,33,36,75
Alloa,8494,3,17,9,10,57,44,13,60
Arbroath,8494,4,17,8,11,71,50,21,59
Stranraer,8494,5,15,5,16,56,66,-10,50
East Fife,8494,6,14,3,19,49,65,-16,45
Airdrieon,8494,7,11,11,14,48,59,-11,44
Forfar,8494,8,10,5,21,39,67,-28,35
Queen's Park,8494,9,7,10,19,41,73,-32,31
Albion,8494,10,8,6,22,57,81,-24,30
Raith,8495,1,23,8,5,69,32,37,77
Ayr,8495,2,23,5,8,91,43,48,74
Arbroath,8495,3,17,9,10,72,50,22,60
Alloa,8495,4,17,8,11,56,44,12,59
Stranraer,8495,5,16,5,15,58,64,-6,53
East Fife,8495,6,13,3,20,47,67,-20,42
Airdrieon,8495,7,10,11,15,45,61,-16,41
Forfar,8495,8,11,5,20,41,64,-23,38
Albion,8495,9,8,7,21,58,79,-21,31
Queen's Park,8495,10,6,11,19,41,74,-33,29
Ayr,8496,1,24,4,8,94,43,51,76
Raith,8496,2,22,9,5,69,33,36,75
Arbroath,8496,3,18,8,10,72,48,24,62
Alloa,8496,4,17,9,10,57,44,13,60
Stranraer,8496,5,16,5,15,58,66,-8,53
Airdrieon,8496,6,10,12,14,46,59,-13,42
East Fife,8496,7,13,3,20,49,67,-18,42
Forfar,8496,8,10,6,20,39,65,-26,36
Albion,8496,9,8,6,22,58,82,-24,30
Queen's Park,8496,10,6,10,20,39,74,-35,28
Raith,8497,1,23,8,5,69,32,37,77
Ayr,8497,2,24,4,8,94,43,51,76
Arbroath,8497,3,18,8,10,72,49,23,62
Alloa,8497,4,17,8,11,56,44,12,59
Stranraer,8497,5,16,5,15,57,64,-7,53
East Fife,8497,6,13,3,20,47,66,-19,42
Airdrieon,8497,7,10,11,15,45,59,-14,41
Forfar,8497,8,11,5,20,39,64,-25,38
Albion,8497,9,8,6,22,58,82,-24,30
Queen's Park,8497,10,6,10,20,40,74,-34,28
Ayr,8498,1,24,4,8,97,42,55,76
Raith,8498,2,22,8,6,69,34,35,74
Arbroath,8498,3,18,8,10,74,50,24,62
Alloa,8498,4,18,8,10,58,44,14,62
Stranraer,8498,5,15,6,15,57,66,-9,51
East Fife,8498,6,13,4,19,49,66,-17,43
Airdrieon,8498,7,10,12,14,46,59,-13,42
Forfar,8498,8,10,6,20,39,65,-26,36
Albion,8498,9,8,6,22,57,85,-28,30
Queen's Park,8498,10,6,10,20,41,76,-35,28
Raith,8499,1,23,8,5,72,32,40,77
Ayr,8499,2,24,4,8,92,42,50,76
Arbroath,8499,3,17,8,11,70,50,20,59
Alloa,8499,4,17,8,11,56,47,9,59
Stranraer,8499,5,15,6,15,55,64,-9,51
East Fife,8499,6,13,4,19,47,64,-17,43
Airdrieon,8499,7,10,11,15,47,61,-14,41
Forfar,8499,8,11,5,20,41,66,-25,38
Queen's Park,8499,9,7,10,19,41,72,-31,31
Albion,8499,10,8,6,22,57,80,-23,30
Raith,8500,1,23,8,5,72,32,40,77
Ayr,8500,2,24,4,8,93,43,50,76
Arbroath,8500,3,18,8,10,71,48,23,62
Alloa,8500,4,17,8,11,56,47,9,59
Stranraer,8500,5,15,5,16,56,66,-10,50
East Fife,8500,6,14,3,19,49,65,-16,45
Airdrieon,8500,7,11,11,14,47,59,-12,44
Forfar,8500,8,10,5,21,39,66,-27,35
Albion,8500,9,8,6,22,58,81,-23,30
Queen's Park,8500,10,6,10,20,39,73,-34,28
Raith,8501,1,23,8,5,70,32,38,77
Ayr,8501,2,24,4,8,95,44,51,76
Arbroath,8501,3,18,8,10,73,48,25,62
Alloa,8501,4,17,8,11,56,45,11,59
Stranraer,8501,5,15,5,16,55,65,-10,50
East Fife,8501,6,14,3,19,48,64,-16,45
Airdrieon,8501,7,11,11,14,48,58,-10,44
Forfar,8501,8,10,5,21,38,67,-29,35
Albion,8501,9,8,6,22,59,83,-24,30
Queen's Park,8501,10,6,10,20,39,75,-36,28
Ayr,8502,1,24,4,8,93,42,51,76
Raith,8502,2,22,9,5,69,33,36,75
Arbroath,8502,3,17,9,10,72,50,22,60
Alloa,8502,4,17,9,10,57,44,13,60
Stranraer,8502,5,15,5,16,56,66,-10,50
East Fife,8502,6,14,3,19,49,65,-16,45
Airdrieon,8502,7,10,11,15,46,60,-14,41
Forfar,8502,8,11,5,20,40,65,-25,38
Albion,8502,9,8,6,22,57,81,-24,30
Queen's Park,8502,10,6,11,19,41,74,-33,29
Raith,8503,1,22,9,5,70,34,36,75
Ayr,8503,2,23,5,8,91,43,48,74
Arbroath,8503,3,17,9,10,70,48,22,60
Alloa,8503,4,17,9,10,58,45,13,60
Stranraer,8503,5,15,5,16,56,66,-10,50
East Fife,8503,6,14,3,19,49,65,-16,45
Airdrieon,8503,7,11,11,14,47,59,-12,44
Forfar,8503,8,10,5,21,39,66,-27,35
Albion,8503,9,8,7,21,58,79,-21,31
Queen's Park,8503,10,6,11,19,39,72,-33,29
Raith,8504,1,23,8,5,70,33,37,77
Ayr,8504,2,24,4,8,93,43,50,76
Arbroath,8504,3,18,8,10,74,50,24,62
Alloa,8504,4,17,8,11,57,45,12,59
Stranraer,8504,5,16,5,15,58,66,-8,53
Airdrieon,8504,6,11,11,14,49,59,-10,44
East Fife,8504,7,13,3,20,49,67,-18,42
Forfar,8504,8,10,5,21,39,68,-29,35
Albion,8504,9,8,6,22,58,81,-23,30
Queen's Park,8504,10,6,10,20,41,76,-35,28
Ayr,8505,1,24,4,8,92,42,50,76
Raith,8505,2,22,8,6,69,34,35,74
Arbroath,8505,3,18,8,10,73,49,24,62
Alloa,8505,4,18,8,10,58,44,14,62
Stranraer,8505,5,15,5,16,55,65,-10,50
East Fife,8505,6,14,3,19,48,64,-16,45
Airdrieon,8505,7,10,12,14,48,61,-13,42
Forfar,8505,8,10,6,20,41,67,-26,36
Albion,8505,9,8,6,22,57,80,-23,30
Queen's Park,8505,10,6,10,20,40,75,-35,28
Ayr,8506,1,24,4,8,96,44,52,76
Raith,8506,2,22,9,5,68,32,36,75
Arbroath,8506,3,18,8,10,72,49,23,62
Alloa,8506,4,17,9,10,56,43,13,60
Stranraer,8506,5,15,5,16,56,66,-10,50
East Fife,8506,6,14,3,19,49,65,-16,45
Airdrieon,8506,7,11,11,14,48,58,-10,44
Forfar,8506,8,10,5,21,38,67,-29,35
Albion,8506,9,8,6,22,59,84,-25,30
Queen's Park,8506,10,6,10,20,40,74,-34,28
Raith,8507,1,23,8,5,70,33,37,77
Ayr,8507,2,24,4,8,92,43,49,76
Arbroath,8507,3,18,8,10,72,48,24,62
Alloa,8507,4,17,8,11,57,45,12,59
Stranraer,8507,5,15,6,15,56,65,-9,51
Airdrieon,8507,6,11,11,14,47,58,-11,44
East Fife,8507,7,13,4,19,48,65,-17,43
Forfar,8507,8,10,5,21,38,66,-28,35
Albion,8507,9,8,6,22,58,80,-22,30
Queen's Park,8507,10,6,10,20,39,74,-35,28
Raith,8508,1,23,8,5,70,33,37,77
Ayr,8508,2,24,4,8,94,43,51,76
Arbroath,8508,3,18,8,10,72,48,24,62
Alloa,8508,4,17,8,11,57,45,12,59
Stranraer,8508,5,16,5,15,57,65,-8,53
Airdrieon,8508,6,11,11,14,47,58,-11,44
East Fife,8508,7,13,3,20,48,66,-18,42
Forfar,8508,8,10,5,21,38,66,-28,35
Albion,8508,9,8,6,22,58,82,-24,30
Queen's Park,8508,10,6,10,20,39,74,-35,28
Raith,8509,1,22,8,6,68,34,34,74
Ayr,8509,2,23,4,9,90,43,47,73
Arbroath,8509,3,18,8,10,73,50,23,62
Alloa,8509,4,18,8,10,58,43,15,62
Stranraer,8509,5,15,6,15,56,65,-9,51
East Fife,8509,6,13,4,19,48,65,-17,43
Airdrieon,8509,7,10,12,14,45,58,-13,42
Forfar,8509,8,10,6,20,38,64,-26,36
Albion,8509,9,9,6,21,58,78,-20,33
Queen's Park,8509,10,6,10,20,41,75,-34,28
Raith,8510,1,23,8,5,70,33,37,77
Ayr,8510,2,24,4,8,93,44,49,76
Arbroath,8510,3,18,8,10,72,49,23,62
Alloa,8510,4,17,8,11,57,45,12,59
Stranraer,8510,5,16,5,15,59,67,-8,53
Airdrieon,8510,6,11,11,14,46,58,-12,44
East Fife,8510,7,13,3,20,50,68,-18,42
Forfar,8510,8,10,5,21,38,65,-27,35
Albion,8510,9,8,6,22,59,81,-22,30
Queen's Park,8510,10,6,10,20,40,74,-34,28
Raith,8511,1,23,8,5,71,33,38,77
Ayr,8511,2,24,4,8,92,42,50,76
Arbroath,8511,3,18,8,10,72,49,23,62
Alloa,8511,4,17,8,11,57,46,11,59
Stranraer,8511,5,15,5,16,55,65,-10,50
East Fife,8511,6,14,3,19,48,64,-16,45
Airdrieon,8511,7,10,12,14,47,60,-13,42
Forfar,8511,8,10,6,20,40,66,-26,36
Albion,8511,9,8,6,22,57,80,-23,30
Queen's Park,8511,10,6,10,20,40,74,-34,28
Raith,8512,1,23,8,5,71,33,38,77
Ayr,8512,2,24,4,8,93,44,49,76
Arbroath,8512,3,17,9,10,72,50,22,60
Alloa,8512,4,17,8,11,57,46,11,59
Stranraer,8512,5,15,5,16,56,66,-10,50
East Fife,8512,6,14,3,19,49,65,-16,45
Airdrieon,8512,7,11,11,14,48,59,-11,44
Forfar,8512,8,10,5,21,39,67,-28,35
Albion,8512,9,8,6,22,59,81,-22,30
Queen's Park,8512,10,6,11,19,41,74,-33,29
Ayr,8513,1,24,4,8,96,42,54,76
Raith,8513,2,22,9,5,69,33,36,75
Arbroath,8513,3,17,9,10,71,49,22,60
Alloa,8513,4,17,9,10,57,44,13,60
Stranraer,8513,5,16,5,15,60,66,-6,53
Airdrieon,8513,6,10,12,14,47,60,-13,42
East Fife,8513,7,13,3,20,49,69,-20,42
Forfar,8513,8,10,6,20,40,66,-26,36
Albion,8513,9,8,6,22,57,84,-27,30
Queen's Park,8513,10,6,11,19,40,73,-33,29
Raith,8514,1,23,8,5,69,32,37,77
Ayr,8514,2,24,4,8,95,44,51,76
Arbroath,8514,3,18,8,10,72,49,23,62
Alloa,8514,4,17,8,11,56,44,12,59
Stranraer,8514,5,15,5,16,57,67,-10,50
East Fife,8514,6,14,3,19,50,66,-16,45
Airdrieon,8514,7,10,11,15,46,60,-14,41
Forfar,8514,8,11,5,20,40,65,-25,38
Albion,8514,9,8,6,22,59,83,-24,30
Queen's Park,8514,10,6,10,20,40,74,-34,28
Ayr,8515,1,24,4,8,93,44,49,76
Raith,8515,2,22,9,5,69,33,36,75
Arbroath,8515,3,17,9,10,71,49,22,60
Alloa,8515,4,17,9,10,57,44,13,60
Stranraer,8515,5,15,5,16,57,68,-11,50
East Fife,8515,6,14,3,19,51,66,-15,45
Airdrieon,8515,7,10,11,15,47,61,-14,41
Forfar,8515,8,11,5,20,41,66,-25,38
Albion,8515,9,8,6,22,59,81,-22,30
Queen's Park,8515,10,6,11,19,40,73,-33,29
Ayr,8516,1,24,4,8,93,43,50,76
Raith,8516,2,22,9,5,69,33,36,75
Alloa,8516,3,17,9,10,57,44,13,60
Arbroath,8516,4,17,8,11,71,50,21,59
Stranraer,8516,5,16,5,15,59,64,-5,53
Airdrieon,8516,6,11,11,14,46,58,-12,44
East Fife,8516,7,13,3,20,47,68,-21,42
Forfar,8516,8,10,5,21,38,65,-27,35
Queen's Park,8516,9,7,10,19,41,73,-32,31
Albion,8516,10,8,6,22,58,81,-23,30
Raith,8517,1,22,8,6,69,34,35,74
Ayr,8517,2,23,4,9,90,43,47,73
Arbroath,8517,3,18,8,10,72,49,23,62
Alloa,8517,4,18,8,10,58,44,14,62
Stranraer,8517,5,16,5,15,58,66,-8,53
Airdrieon,8517,6,10,12,14,46,59,-13,42
East Fife,8517,7,13,3,20,49,67,-18,42
Forfar,8517,8,10,6,20,39,65,-26,36
Albion,8517,9,9,6,21,58,78,-20,33
Queen's Park,8517,10,6,10,20,40,74,-34,28
Raith,8518,1,23,8,5,71,33,38,77
Ayr,8518,2,23,5,8,93,45,48,74
Arbroath,8518,3,17,8,11,71,52,19,59
Alloa,8518,4,17,8,11,57,46,11,59
Stranraer,8518,5,15,5,16,57,67,-10,50
East Fife,8518,6,14,3,19,50,66,-16,45
Airdrieon,8518,7,10,11,15,45,61,-16,41
Forfar,8518,8,11,5,20,41,64,-23,38
Albion,8518,9,8,7,21,60,81,-21,31
Queen's Park,8518,10,7,10,19,43,73,-30,31
Raith,8519,1,23,8,5,72,32,40,77
Ayr,8519,2,24,4,8,93,43,50,76
Arbroath,8519,3,17,8,11,70,50,20,59
Alloa,8519,4,17,8,11,56,47,9,59
Stranraer,8519,5,16,5,15,58,66,-8,53
Airdrieon,8519,6,11,11,14,48,58,-10,44
East Fife,8519,7,13,3,20,49,67,-18,42
Forfar,8519,8,10,5,21,38,67,-29,35
Queen's Park,8519,9,7,10,19,41,72,-31,31
Albion,8519,10,8,6,22,58,81,-23,30
Raith,8520,1,23,8,5,70,32,38,77
Ayr,8520,2,24,4,8,95,44,51,76
Arbroath,8520,3,17,8,11,70,49,21,59
Alloa,8520,4,17,8,11,56,45,11,59
Stranraer,8520,5,15,6,15,57,66,-9,51
East Fife,8520,6,13,4,19,49,66,-17,43
Airdrieon,8520,7,10,12,14,46,59,-13,42
Forfar,8520,8,10,6,20,39,65,-26,36
Queen's Park,8520,9,7,10,19,40,72,-32,31
Albion,8520,10,8,6,22,59,83,-24,30
Raith,8521,1,23,8,5,74,32,42,77
Ayr,8521,2,24,4,8,92,43,49,76
Arbroath,8521,3,18,8,10,73,49,24,62
Alloa,8521,4,17,8,11,56,49,7,59
Stranraer,8521,5,15,5,16,55,65,-10,50
East Fife,8521,6,14,3,19,48,64,-16,45
Airdrieon,8521,7,11,11,14,46,58,-12,44
Forfar,8521,8,10,5,21,38,65,-27,35
Albion,8521,9,8,6,22,58,80,-22,30
Queen's Park,8521,10,6,10,20,40,75,-35,28
Ayr,8522,1,24,4,8,95,44,51,76
Raith,8522,2,22,9,5,68,32,36,75
Arbroath,8522,3,18,8,10,73,49,24,62
Alloa,8522,4,17,9,10,56,43,13,60
Stranraer,8522,5,15,5,16,55,66,-11,50
East Fife,8522,6,14,3,19,49,64,-15,45
Airdrieon,8522,7,10,12,14,47,60,-13,42
Forfar,8522,8,10,6,20,40,66,-26,36
Albion,8522,9,8,6,22,59,83,-24,30
Queen's Park,8522,10,6,10,20,40,75,-35,28
Raith,8523,1,23,8,5,72,32,40,77
Ayr,8523,2,24,4,8,93,42,51,76
Arbroath,8523,3,17,9,10,73,51,22,60
Alloa,8523,4,17,8,11,56,47,9,59
Stranraer,8523,5,15,6,15,58,67,-9,51
East Fife,8523,6,13,4,19,50,67,-17,43
Airdrieon,8523,7,10,11,15,45,59,-14,41
Forfar,8523,8,11,5,20,39,64,-25,38
Albion,8523,9,8,6,22,57,81,-24,30
Queen's Park,8523,10,6,11,19,42,75,-33,29
Raith,8524,1,23,8,5,70,32,38,77
Ayr,8524,2,24,4,8,94,43,51,76
Arbroath,8524,3,17,9,10,73,51,22,60
Alloa,8524,4,17,8,11,56,45,11,59
Stranraer,8524,5,15,6,15,56,65,-9,51
Airdrieon,8524,6,11,11,14,47,58,-11,44
East Fife,8524,7,13,4,19,48,65,-17,43
Forfar,8524,8,10,5,21,38,66,-28,35
Albion,8524,9,8,6,22,58,82,-24,30
Queen's Park,8524,10,6,11,19,42,75,-33,29
Raith,8525,1,23,8,5,73,33,40,77
Ayr,8525,2,24,4,8,95,44,51,76
Arbroath,8525,3,17,8,11,71,50,21,59
Alloa,8525,4,17,8,11,57,48,9,59
Stranraer,8525,5,16,5,15,61,65,-4,53
East Fife,8525,6,13,3,20,48,70,-22,42
Airdrieon,8525,7,10,11,15,46,62,-16,41
Forfar,8525,8,11,5,20,42,65,-23,38
Queen's Park,8525,9,7,10,19,41,73,-32,31
Albion,8525,10,8,6,22,59,83,-24,30
Ayr,8526,1,24,4,8,95,45,50,76
Raith,8526,2,22,8,6,69,35,34,74
Arbroath,8526,3,18,8,10,72,48,24,62
Alloa,8526,4,18,8,10,59,44,15,62
Stranraer,8526,5,15,5,16,56,67,-11,50
East Fife,8526,6,14,3,19,50,65,-15,45
Airdrieon,8526,7,11,11,14,48,58,-10,44
Forfar,8526,8,10,5,21,38,67,-29,35
Albion,8526,9,8,6,22,60,83,-23,30
Queen's Park,8526,10,6,10,20,39,74,-35,28
Raith,8527,1,23,8,5,70,32,38,77
Ayr,8527,2,24,4,8,94,44,50,76
Arbroath,8527,3,17,9,10,71,49,22,60
Alloa,8527,4,17,8,11,56,45,11,59
Stranraer,8527,5,15,5,16,56,66,-10,50
East Fife,8527,6,14,3,19,49,65,-16,45
Airdrieon,8527,7,10,11,15,46,60,-14,41
Forfar,8527,8,11,5,20,40,65,-25,38
Albion,8527,9,8,6,22,59,82,-23,30
Queen's Park,8527,10,6,11,19,40,73,-33,29
Raith,8528,1,23,8,5,71,34,37,77
Ayr,8528,2,23,4,9,92,45,47,73
Arbroath,8528,3,17,9,10,72,50,22,60
Alloa,8528,4,17,8,11,58,46,12,59
Stranraer,8528,5,15,5,16,58,69,-11,50
East Fife,8528,6,14,3,19,52,67,-15,45
Airdrieon,8528,7,10,11,15,45,59,-14,41
Forfar,8528,8,11,5,20,39,64,-25,38
Albion,8528,9,9,6,21,60,80,-20,33
Queen's Park,8528,10,6,11,19,41,74,-33,29
Raith,8529,1,23,8,5,69,32,37,77
Ayr,8529,2,23,4,9,90,45,45,73
Arbroath,8529,3,17,9,10,71,49,22,60
Alloa,8529,4,17,8,11,56,44,12,59
Stranraer,8529,5,16,5,15,56,64,-8,53
Airdrieon,8529,6,11,11,14,48,58,-10,44
East Fife,8529,7,13,3,20,47,65,-18,42
Forfar,8529,8,10,5,21,38,67,-29,35
Albion,8529,9,9,6,21,60,78,-18,33
Queen's Park,8529,10,6,11,19,40,73,-33,29
Ayr,8530,1,24,4,8,94,42,52,76
Raith,8530,2,22,8,6,70,35,35,74
Alloa,8530,3,18,8,10,59,45,14,62
Arbroath,8530,4,17,9,10,72,50,22,60
Stranraer,8530,5,15,6,15,56,65,-9,51
East Fife,8530,6,13,4,19,48,65,-17,43
Airdrieon,8530,7,10,11,15,45,59,-14,41
Forfar,8530,8,11,5,20,39,64,-25,38
Albion,8530,9,8,6,22,57,82,-25,30
Queen's Park,8530,10,6,11,19,41,74,-33,29
Raith,8531,1,23,8,5,72,33,39,77
Ayr,8531,2,24,4,8,95,43,52,76
Arbroath,8531,3,18,8,10,73,49,24,62
Alloa,8531,4,17,8,11,57,47,10,59
Stranraer,8531,5,15,5,16,56,66,-10,50
East Fife,8531,6,14,3,19,49,65,-16,45
Airdrieon,8531,7,11,11,14,47,58,-11,44
Forfar,8531,8,10,5,21,38,66,-28,35
Albion,8531,9,8,6,22,58,83,-25,30
Queen's Park,8531,10,6,10,20,40,75,-35,28
Raith,8532,1,23,8,5,71,33,38,77
Ayr,8532,2,24,4,8,94,43,51,76
Arbroath,8532,3,17,9,10,71,49,22,60
Alloa,8532,4,17,8,11,57,46,11,59
Stranraer,8532,5,15,6,15,56,65,-9,51
East Fife,8532,6,13,4,19,48,65,-17,43
Airdrieon,8532,7,10,11,15,47,62,-15,41
Forfar,8532,8,11,5,20,42,66,-24,38
Albion,8532,9,8,6,22,58,82,-24,30
Queen's Park,8532,10,6,11,19,40,73,-33,29
Raith,8533,1,22,8,6,69,34,35,74
Ayr,8533,2,23,4,9,91,44,47,73
Arbroath,8533,3,18,8,10,73,49,24,62
Alloa,8533,4,18,8,10,58,44,14,62
Stranraer,8533,5,15,5,16,55,65,-10,50
East Fife,8533,6,14,3,19,48,64,-16,45
Airdrieon,8533,7,11,11,14,47,59,-12,44
Forfar,8533,8,10,5,21,39,66,-27,35
Albion,8533,9,9,6,21,59,79,-20,33
Queen's Park,8533,10,6,10,20,40,75,-35,28
Raith,8534,1,23,8,5,69,32,37,77
Ayr,8534,2,24,4,8,94,44,50,76
Arbroath,8534,3,17,9,10,73,51,22,60
Alloa,8534,4,17,8,11,56,44,12,59
Stranraer,8534,5,15,5,16,55,67,-12,50
East Fife,8534,6,14,3,19,50,64,-14,45
Airdrieon,8534,7,10,11,15,45,60,-15,41
Forfar,8534,8,11,5,20,40,64,-24,38
Albion,8534,9,8,6,22,59,82,-23,30
Queen's Park,8534,10,6,11,19,42,75,-33,29
Raith,8535,1,23,8,5,70,32,38,77
Ayr,8535,2,24,4,8,96,43,53,76
Arbroath,8535,3,18,8,10,71,48,23,62
Alloa,8535,4,17,8,11,56,45,11,59
Stranraer,8535,5,15,5,16,56,66,-10,50
East Fife,8535,6,14,3,19,49,65,-16,45
Airdrieon,8535,7,11,11,14,51,61,-10,44
Forfar,8535,8,10,5,21,41,70,-29,35
Albion,8535,9,8,6,22,58,84,-26,30
Queen's Park,8535,10,6,10,20,39,73,-34,28
Raith,8536,1,23,8,5,69,32,37,77
Ayr,8536,2,24,4,8,94,42,52,76
Arbroath,8536,3,18,8,10,73,49,24,62
Alloa,8536,4,17,8,11,56,44,12,59
Stranraer,8536,5,15,6,15,56,65,-9,51
East Fife,8536,6,13,4,19,48,65,-17,43
Airdrieon,8536,7,10,12,14,46,59,-13,42
Forfar,8536,8,10,6,20,39,65,-26,36
Albion,8536,9,8,6,22,57,82,-25,30
Queen's Park,8536,10,6,10,20,40,75,-35,28
Raith,8537,1,22,9,5,68,32,36,75
Ayr,8537,2,23,5,8,91,43,48,74
Alloa,8537,3,17,9,10,56,43,13,60
Arbroath,8537,4,17,8,11,71,51,20,59
Stranraer,8537,5,16,5,15,56,64,-8,53
Airdrieon,8537,6,10,12,14,45,58,-13,42
East Fife,8537,7,13,3,20,47,65,-18,42
Forfar,8537,8,10,6,20,38,64,-26,36
Albion,8537,9,8,7,21,58,79,-21,31
Queen's Park,8537,10,7,10,19,42,73,-31,31
Raith,8538,1,23,8,5,72,32,40,77
Ayr,8538,2,24,4,8,92,42,50,76
Arbroath,8538,3,18,8,10,71,48,23,62
Alloa,8538,4,17,8,11,56,47,9,59
Stranraer,8538,5,15,5,16,56,67,-11,50
East Fife,8538,6,14,3,19,50,65,-15,45
Airdrieon,8538,7,10,12,14,46,59,-13,42
Forfar,8538,8,10,6,20,39,65,-26,36
Albion,8538,9,8,6,22,57,80,-23,30
Queen's Park,8538,10,6,10,20,39,73,-34,28
Ayr,8539,1,24,4,8,93,44,49,76
Raith,8539,2,22,9,5,69,33,36,75
Alloa,8539,3,17,9,10,57,44,13,60
Arbroath,8539,4,17,8,11,71,50,21,59
Stranraer,8539,5,15,6,15,56,65,-9,51
Airdrieon,8539,6,11,11,14,49,58,-9,44
East Fife,8539,7,13,4,19,48,65,-17,43
Forfar,8539,8,10,5,21,38,68,-30,35
Queen's Park,8539,9,7,10,19,41,73,-32,31
Albion,8539,10,8,6,22,59,81,-22,30
Raith,8540,1,23,8,5,70,32,38,77
Ayr,8540,2,24,4,8,92,42,50,76
Arbroath,8540,3,18,8,10,75,49,26,62
Alloa,8540,4,17,8,11,56,45,11,59
Stranraer,8540,5,16,5,15,57,64,-7,53
Airdrieon,8540,6,11,11,14,47,59,-12,44
East Fife,8540,7,13,3,20,47,66,-19,42
Forfar,8540,8,10,5,21,39,66,-27,35
Albion,8540,9,8,6,22,57,80,-23,30
Queen's Park,8540,10,6,10,20,40,77,-37,28
Ayr,8541,1,24,4,8,95,44,51,76
Raith,8541,2,22,8,6,68,34,34,74
Alloa,8541,3,18,8,10,58,43,15,62
Arbroath,8541,4,17,8,11,70,50,20,59
Stranraer,8541,5,16,5,15,56,64,-8,53
East Fife,8541,6,13,3,20,47,65,-18,42
Airdrieon,8541,7,10,11,15,46,60,-14,41
Forfar,8541,8,11,5,20,40,65,-25,38
Queen's Park,8541,9,7,10,19,41,72,-31,31
Albion,8541,10,8,6,22,59,83,-24,30
Raith,8542,1,23,8,5,70,32,38,77
Ayr,8542,2,24,4,8,95,44,51,76
Arbroath,8542,3,17,9,10,73,51,22,60
Alloa,8542,4,17,8,11,56,45,11,59
Stranraer,8542,5,16,5,15,57,65,-8,53
East Fife,8542,6,13,3,20,48,66,-18,42
Airdrieon,8542,7,10,11,15,45,59,-14,41
Forfar,8542,8,11,5,20,39,64,-25,38
Albion,8542,9,8,6,22,59,83,-24,30
Queen's Park,8542,10,6,11,19,42,75,-33,29
Raith,8543,1,23,8,5,72,33,39,77
Ayr,8543,2,23,4,9,90,44,46,73
Arbroath,8543,3,18,8,10,74,48,26,62
Alloa,8543,4,17,8,11,57,47,10,59
Stranraer,8543,5,15,5,16,55,66,-11,50
East Fife,8543,6,14,3,19,49,64,-15,45
Airdrieon,8543,7,11,11,14,49,59,-10,44
Forfar,8543,8,10,5,21,39,68,-29,35
Albion,8543,9,9,6,21,59,78,-19,33
Queen's Park,8543,10,6,10,20,39,76,-37,28
Raith,8544,1,23,8,5,69,32,37,77
Ayr,8544,2,24,4,8,92,43,49,76
Arbroath,8544,3,17,8,11,70,49,21,59
Alloa,8544,4,17,8,11,56,44,12,59
Stranraer,8544,5,15,5,16,57,68,-11,50
East Fife,8544,6,14,3,19,51,66,-15,45
Airdrieon,8544,7,11,11,14,47,58,-11,44
Forfar,8544,8,10,5,21,38,66,-28,35
Queen's Park,8544,9,7,10,19,40,72,-32,31
Albion,8544,10,8,6,22,58,80,-22,30
Raith,8545,1,23,8,5,73,33,40,77
Ayr,8545,2,24,4,8,93,42,51,76
Arbroath,8545,3,17,9,10,72,50,22,60
Alloa,8545,4,17,8,11,57,48,9,59
Stranraer,8545,5,15,5,16,55,65,-10,50
East Fife,8545,6,14,3,19,48,64,-16,45
Airdrieon,8545,7,10,12,14,45,58,-13,42
Forfar,8545,8,10,6,20,38,64,-26,36
Albion,8545,9,8,6,22,57,81,-24,30
Queen's Park,8545,10,6,11,19,41,74,-33,29
Raith,8546,1,23,8,5,70,33,37,77
Ayr,8546,2,24,4,8,93,43,50,76
Arbroath,8546,3,17,8,11,71,50,21,59
Alloa,8546,4,17,8,11,57,45,12,59
Stranraer,8546,5,15,6,15,57,66,-9,51
East Fife,8546,6,13,4,19,49,66,-17,43
Airdrieon,8546,7,10,11,15,47,61,-14,41
Forfar,8546,8,11,5,20,41,66,-25,38
Queen's Park,8546,9,7,10,19,41,73,-32,31
Albion,8546,10,8,6,22,58,81,-23,30
Raith,8547,1,23,8,5,71,32,39,77
Ayr,8547,2,24,4,8,97,43,54,76
Arbroath,8547,3,18,8,10,71,48,23,62
Alloa,8547,4,17,8,11,56,46,10,59
Stranraer,8547,5,16,5,15,57,65,-8,53
Airdrieon,8547,6,10,12,14,45,58,-13,42
East Fife,8547,7,13,3,20,48,66,-18,42
Forfar,8547,8,10,6,20,38,64,-26,36
Albion,8547,9,8,6,22,58,85,-27,30
Queen's Park,8547,10,6,10,20,39,73,-34,28
Raith,8548,1,23,8,5,70,33,37,77
Ayr,8548,2,24,4,8,92,42,50,76
Arbroath,8548,3,18,8,10,73,49,24,62
Alloa,8548,4,17,8,11,57,45,12,59
Stranraer,8548,5,15,5,16,55,65,-10,50
East Fife,8548,6,14,3,19,48,64,-16,45
Airdrieon,8548,7,11,11,14,49,59,-10,44
Forfar,8548,8,10,5,21,39,68,-29,35
Albion,8548,9,8,6,22,57,80,-23,30
Queen's Park,8548,10,6,10,20,40,75,-35,28
Raith,8549,1,23,8,5,74,33,41,77
Ayr,8549,2,24,4,8,92,42,50,76
Arbroath,8549,3,17,8,11,70,52,18,59
Alloa,8549,4,17,8,11,57,49,8,59
Stranraer,8549,5,15,5,16,55,65,-10,50
East Fife,8549,6,14,3,19,48,64,-16,45
Airdrieon,8549,7,10,11,15,45,59,-14,41
Forfar,8549,8,11,5,20,39,64,-25,38
Queen's Park,8549,9,7,10,19,43,72,-29,31
Albion,8549,10,8,6,22,57,80,-23,30
Raith,8550,1,22,8,6,69,34,35,74
Ayr,8550,2,23,4,9,91,46,45,73
Alloa,8550,3,18,8,10,58,44,14,62
Arbroath,8550,4,17,9,10,70,48,22,60
Stranraer,8550,5,15,5,16,55,65,-10,50
East Fife,8550,6,14,3,19,48,64,-16,45
Airdrieon,8550,7,11,11,14,48,58,-10,44
Forfar,8550,8,10,5,21,38,67,-29,35
Albion,8550,9,9,6,21,61,79,-18,33
Queen's Park,8550,10,6,11,19,39,72,-33,29
Raith,8551,1,22,9,5,69,33,36,75
Ayr,8551,2,23,4,9,91,44,47,73
Arbroath,8551,3,17,9,10,71,49,22,60
Alloa,8551,4,17,9,10,57,44,13,60
Stranraer,8551,5,15,5,16,56,66,-10,50
East Fife,8551,6,14,3,19,49,65,-16,45
Airdrieon,8551,7,11,11,14,46,58,-12,44
Forfar,8551,8,10,5,21,38,65,-27,35
Albion,8551,9,9,6,21,59,79,-20,33
Queen's Park,8551,10,6,11,19,40,73,-33,29
Raith,8552,1,23,8,5,70,32,38,77
Ayr,8552,2,24,4,8,94,43,51,76
Arbroath,8552,3,17,8,11,70,49,21,59
Alloa,8552,4,17,8,11,56,45,11,59
Stranraer,8552,5,15,6,15,57,66,-9,51
East Fife,8552,6,13,4,19,49,66,-17,43
Airdrieon,8552,7,10,12,14,48,61,-13,42
Forfar,8552,8,10,6,20,41,67,-26,36
Queen's Park,8552,9,7,10,19,40,72,-32,31
Albion,8552,10,8,6,22,58,82,-24,30
Raith,8553,1,23,8,5,71,33,38,77
Ayr,8553,2,24,4,8,93,42,51,76
Arbroath,8553,3,18,8,10,73,49,24,62
Alloa,8553,4,17,8,11,57,46,11,59
Stranraer,8553,5,15,5,16,55,69,-14,50
East Fife,8553,6,14,3,19,52,64,-12,45
Airdrieon,8553,7,11,11,14,46,58,-12,44
Forfar,8553,8,10,5,21,38,65,-27,35
Albion,8553,9,8,6,22,57,81,-24,30
Queen's Park,8553,10,6,10,20,40,75,-35,28
Ayr,8554,1,24,4,8,93,43,50,76
Raith,8554,2,22,8,6,68,33,35,74
Arbroath,8554,3,18,8,10,72,49,23,62
Alloa,8554,4,18,8,10,57,43,14,62
Stranraer,8554,5,15,5,16,55,65,-10,50
East Fife,8554,6,14,3,19,48,64,-16,45
Airdrieon,8554,7,11,11,14,47,59,-12,44
Forfar,8554,8,10,5,21,39,66,-27,35
Albion,8554,9,8,6,22,58,81,-23,30
Queen's Park,8554,10,6,10,20,40,74,-34,28
Raith,8555,1,23,8,5,72,34,38,77
Ayr,8555,2,24,4,8,92,43,49,76
Arbroath,8555,3,17,9,10,71,49,22,60
Alloa,8555,4,17,8,11,58,47,11,59
Stranraer,8555,5,15,6,15,56,65,-9,51
Airdrieon,8555,6,11,11,14,49,59,-10,44
East Fife,8555,7,13,4,19,48,65,-17,43
Forfar,8555,8,10,5,21,39,68,-29,35
Albion,8555,9,8,6,22,58,80,-22,30
Queen's Park,8555,10,6,11,19,40,73,-33,29
Raith,8556,1,23,8,5,70,32,38,77
Ayr,8556,2,24,4,8,96,43,53,76
Arbroath,8556,3,18,8,10,73,48,25,62
Alloa,8556,4,17,8,11,56,45,11,59
Stranraer,8556,5,15,5,16,56,67,-11,50
East Fife,8556,6,14,3,19,50,65,-15,45
Airdrieon,8556,7,10,12,14,48,61,-13,42
Forfar,8556,8,10,6,20,41,67,-26,36
Albion,8556,9,8,6,22,58,84,-26,30
Queen's Park,8556,10,6,10,20,39,75,-36,28
Ayr,8557,1,24,4,8,95,43,52,76
Raith,8557,2,22,9,5,69,33,36,75
Alloa,8557,3,17,9,10,57,44,13,60
Arbroath,8557,4,17,8,11,73,54,19,59
Stranraer,8557,5,15,5,16,55,65,-10,50
East Fife,8557,6,14,3,19,48,64,-16,45
Airdrieon,8557,7,10,11,15,46,60,-14,41
Forfar,8557,8,11,5,20,40,65,-25,38
Queen's Park,8557,9,7,10,19,45,75,-30,31
Albion,8557,10,8,6,22,58,83,-25,30
Raith,8558,1,23,8,5,73,33,40,77
Ayr,8558,2,24,4,8,95,43,52,76
Arbroath,8558,3,18,8,10,71,48,23,62
Alloa,8558,4,17,8,11,57,48,9,59
Stranraer,8558,5,16,5,15,57,65,-8,53
East Fife,8558,6,13,3,20,48,66,-18,42
Airdrieon,8558,7,10,11,15,45,60,-15,41
Forfar,8558,8,11,5,20,40,64,-24,38
Albion,8558,9,8,6,22,58,83,-25,30
Queen's Park,8558,10,6,10,20,39,73,-34,28
Ayr,8559,1,24,4,8,92,42,50,76
Raith,8559,2,22,9,5,69,33,36,75
Alloa,8559,3,17,9,10,57,44,13,60
Arbroath,8559,4,17,8,11,70,51,19,59
Stranraer,8559,5,15,5,16,56,66,-10,50
East Fife,8559,6,14,3,19,49,65,-16,45
Airdrieon,8559,7,11,11,14,47,59,-12,44
Forfar,8559,8,10,5,21,39,66,-27,35
Queen's Park,8559,9,7,10,19,42,72,-30,31
Albion,8559,10,8,6,22,57,80,-23,30
Ayr,8560,1,24,4,8,94,42,52,76
Raith,8560,2,22,8,6,69,34,35,74
Alloa,8560,3,18,8,10,58,44,14,62
Arbroath,8560,4,17,9,10,72,50,22,60
Stranraer,8560,5,15,6,15,56,65,-9,51
East Fife,8560,6,13,4,19,48,65,-17,43
Airdrieon,8560,7,10,12,14,47,60,-13,42
Forfar,8560,8,10,6,20,40,66,-26,36
Albion,8560,9,8,6,22,57,82,-25,30
Queen's Park,8560,10,6,11,19,41,74,-33,29
Raith,8561,1,23,8,5,69,32,37,77
Ayr,8561,2,24,4,8,95,44,51,76
Arbroath,8561,3,18,8,10,73,50,23,62
Alloa,8561,4,17,8,11,56,44,12,59
Stranraer,8561,5,15,6,15,56,65,-9,51
Airdrieon,8561,6,11,11,14,47,58,-11,44
East Fife,8561,7,13,4,19,48,65,-17,43
Forfar,8561,8,10,5,21,38,66,-28,35
Albion,8561,9,8,6,22,59,83,-24,30
Queen's Park,8561,10,6,10,20,41,75,-34,28
Raith,8562,1,23,8,5,69,32,37,77
Ayr,8562,2,23,4,9,91,46,45,73
Arbroath,8562,3,17,9,10,71,49,22,60
Alloa,8562,4,17,8,11,56,44,12,59
Stranraer,8562,5,16,5,15,56,64,-8,53
Airdrieon,8562,6,11,11,14,47,59,-12,44
East Fife,8562,7,13,3,20,47,65,-18,42
Forfar,8562,8,10,5,21,39,66,-27,35
Albion,8562,9,9,6,21,61,79,-18,33
Queen's Park,8562,10,6,11,19,40,73,-33,29
Ayr,8563,1,24,4,8,96,43,53,76
Raith,8563,2,22,9,5,68,32,36,75
Arbroath,8563,3,17,9,10,73,51,22,60
Alloa,8563,4,17,9,10,56,43,13,60
Stranraer,8563,5,15,5,16,58,68,-10,50
East Fife,8563,6,14,3,19,51,67,-16,45
Airdrieon,8563,7,10,12,14,46,59,-13,42
Forfar,8563,8,10,6,20,39,65,-26,36
Albion,8563,9,8,6,22,58,84,-26,30
Queen's Park,8563,10,6,11,19,42,75,-33,29
Raith,8564,1,22,9,5,69,33,36,75
Ayr,8564,2,23,5,8,91,43,48,74
Alloa,8564,3,17,9,10,57,44,13,60
Arbroath,8564,4,17,8,11,70,50,20,59
Stranraer,8564,5,16,5,15,56,64,-8,53
East Fife,8564,6,13,3,20,47,65,-18,42
Airdrieon,8564,7,10,11,15,47,61,-14,41
Forfar,8564,8,11,5,20,41,66,-25,38
Albion,8564,9,8,7,21,58,79,-21,31
Queen's Park,8564,10,7,10,19,41,72,-31,31
Raith,8565,1,23,8,5,69,32,37,77
Ayr,8565,2,24,4,8,94,43,51,76
Arbroath,8565,3,17,8,11,71,50,21,59
Alloa,8565,4,17,8,11,56,44,12,59
Stranraer,8565,5,15,5,16,56,66,-10,50
East Fife,8565,6,14,3,19,49,65,-16,45
Airdrieon,8565,7,10,12,14,47,60,-13,42
Forfar,8565,8,10,6,20,40,66,-26,36
Queen's Park,8565,9,7,10,19,41,73,-32,31
Albion,8565,10,8,6,22,58,82,-24,30
Raith,8566,1,23,8,5,72,32,40,77
Ayr,8566,2,24,4,8,93,42,51,76
Arbroath,8566,3,18,8,10,73,48,25,62
Alloa,8566,4,17,8,11,56,47,9,59
Stranraer,8566,5,15,5,16,56,68,-12,50
East Fife,8566,6,14,3,19,51,65,-14,45
Airdrieon,8566,7,11,11,14,47,58,-11,44
Forfar,8566,8,10,5,21,38,66,-28,35
Albion,8566,9,8,6,22,57,81,-24,30
Queen's Park,8566,10,6,10,20,39,75,-36,28
Raith,8567,1,23,8,5,69,32,37,77
Ayr,8567,2,24,4,8,96,43,53,76
Arbroath,8567,3,18,8,10,72,49,23,62
Alloa,8567,4,17,8,11,56,44,12,59
Stranraer,8567,5,15,6,15,56,65,-9,51
Airdrieon,8567,6,11,11,14,46,58,-12,44
East Fife,8567,7,13,4,19,48,65,-17,43
Forfar,8567,8,10,5,21,38,65,-27,35
Albion,8567,9,8,6,22,58,84,-26,30
Queen's Park,8567,10,6,10,20,40,74,-34,28
Ayr,8568,1,24,4,8,94,43,51,76
Raith,8568,2,22,8,6,68,34,34,74
Arbroath,8568,3,18,8,10,74,48,26,62
Alloa,8568,4,18,8,10,58,43,15,62
Stranraer,8568,5,16,5,15,57,65,-8,53
Airdrieon,8568,6,11,11,14,48,59,-11,44
East Fife,8568,7,13,3,20,48,66,-18,42
Forfar,8568,8,10,5,21,39,67,-28,35
Albion,8568,9,8,6,22,58,82,-24,30
Queen's Park,8568,10,6,10,20,39,76,-37,28
Ayr,8569,1,24,4,8,93,42,51,76
Raith,8569,2,22,9,5,69,33,36,75
Arbroath,8569,3,18,8,10,73,48,25,62
Alloa,8569,4,17,9,10,57,44,13,60
Stranraer,8569,5,15,5,16,56,66,-10,50
East Fife,8569,6,14,3,19,49,65,-16,45
Airdrieon,8569,7,11,11,14,48,58,-10,44
Forfar,8569,8,10,5,21,38,67,-29,35
Albion,8569,9,8,6,22,57,81,-24,30
Queen's Park,8569,10,6,10,20,39,75,-36,28
Raith,8570,1,23,8,5,70,33,37,77
Ayr,8570,2,24,4,8,94,43,51,76
Arbroath,8570,3,18,8,10,72,48,24,62
Alloa,8570,4,17,8,11,57,45,12,59
Stranraer,8570,5,15,6,15,56,65,-9,51
East Fife,8570,6,13,4,19,48,65,-17,43
Airdrieon,8570,7,10,11,15,45,59,-14,41
Forfar,8570,8,11,5,20,39,64,-25,38
Albion,8570,9,8,6,22,58,82,-24,30
Queen's Park,8570,10,6,10,20,39,74,-35,28
Raith,8571,1,22,9,5,68,32,36,75
Ayr,8571,2,23,4,9,91,44,47,73
Arbroath,8571,3,18,8,10,72,48,24,62
Alloa,8571,4,17,9,10,56,43,13,60
Stranraer,8571,5,16,5,15,58,65,-7,53
Airdrieon,8571,6,11,11,14,46,58,-12,44
East Fife,8571,7,13,3,20,48,67,-19,42
Forfar,8571,8,10,5,21,38,65,-27,35
Albion,8571,9,9,6,21,59,79,-20,33
Queen's Park,8571,10,6,10,20,39,74,-35,28
Ayr,8572,1,24,4,8,95,44,51,76
Raith,8572,2,22,8,6,68,34,34,74
Arbroath,8572,3,18,8,10,72,49,23,62
Alloa,8572,4,18,8,10,58,43,15,62
Stranraer,8572,5,16,5,15,58,64,-6,53
Airdrieon,8572,6,11,11,14,47,59,-12,44
East Fife,8572,7,13,3,20,47,67,-20,42
Forfar,8572,8,10,5,21,39,66,-27,35
Albion,8572,9,8,6,22,59,83,-24,30
Queen's Park,8572,10,6,10,20,40,74,-34,28
Ayr,8573,1,24,4,8,94,45,49,76
Raith,8573,2,22,8,6,69,35,34,74
Arbroath,8573,3,18,8,10,72,48,24,62
Alloa,8573,4,18,8,10,59,44,15,62
Stranraer,8573,5,15,5,16,56,66,-10,50
East Fife,8573,6,14,3,19,49,65,-16,45
Airdrieon,8573,7,11,11,14,46,58,-12,44
Forfar,8573,8,10,5,21,38,65,-27,35
Albion,8573,9,8,6,22,60,82,-22,30
Queen's Park,8573,10,6,10,20,39,74,-35,28
Raith,8574,1,23,8,5,72,32,40,77
Ayr,8574,2,24,4,8,97,43,54,76
Arbroath,8574,3,18,8,10,75,50,25,62
Alloa,8574,4,17,8,11,56,47,9,59
Stranraer,8574,5,15,6,15,56,65,-9,51
East Fife,8574,6,13,4,19,48,65,-17,43
Airdrieon,8574,7,10,12,14,46,59,-13,42
Forfar,8574,8,10,6,20,39,65,-26,36
Albion,8574,9,8,6,22,58,85,-27,30
Queen's Park,8574,10,6,10,20,41,77,-36,28
Raith,8575,1,23,8,5,71,33,38,77
Ayr,8575,2,23,4,9,90,43,47,73
Arbroath,8575,3,17,9,10,71,49,22,60
Alloa,8575,4,17,8,11,57,46,11,59
Stranraer,8575,5,15,6,15,57,66,-9,51
Airdrieon,8575,6,11,11,14,47,58,-11,44
East Fife,8575,7,13,4,19,49,66,-17,43
Forfar,8575,8,10,5,21,38,66,-28,35
Albion,8575,9,9,6,21,58,78,-20,33
Queen's Park,8575,10,6,11,19,40,73,-33,29
Raith,8576,1,23,8,5,70,33,37,77
Ayr,8576,2,23,5,8,91,43,48,74
Arbroath,8576,3,17,9,10,71,49,22,60
Alloa,8576,4,17,8,11,57,45,12,59
Stranraer,8576,5,16,5,15,56,64,-8,53
East Fife,8576,6,13,3,20,47,65,-18,42
Airdrieon,8576,7,10,11,15,46,60,-14,41
Forfar,8576,8,11,5,20,40,65,-25,38
Albion,8576,9,8,7,21,58,79,-21,31
Queen's Park,8576,10,6,11,19,40,73,-33,29
Raith,8577,1,22,9,5,70,34,36,75
Ayr,8577,2,23,5,8,92,44,48,74
Arbroath,8577,3,18,8,10,74,49,25,62
Alloa,8577,4,17,9,10,58,45,13,60
Stranraer,8577,5,15,6,15,57,66,-9,51
East Fife,8577,6,13,4,19,49,66,-17,43
Airdrieon,8577,7,10,12,14,45,58,-13,42
Forfar,8577,8,10,6,20,38,64,-26,36
Albion,8577,9,8,7,21,59,80,-21,31
Queen's Park,8577,10,6,10,20,40,76,-36,28
Ayr,8578,1,24,4,8,93,43,50,76
Raith,8578,2,22,8,6,68,33,35,74
Alloa,8578,3,18,8,10,57,43,14,62
Arbroath,8578,4,17,9,10,71,49,22,60
Stranraer,8578,5,15,6,15,57,66,-9,51
Airdrieon,8578,6,11,11,14,47,58,-11,44
East Fife,8578,7,13,4,19,49,66,-17,43
Forfar,8578,8,10,5,21,38,66,-28,35
Albion,8578,9,8,6,22,58,81,-23,30
Queen's Park,8578,10,6,11,19,40,73,-33,29
Ayr,8579,1,24,4,8,93,44,49,76
Raith,8579,2,22,9,5,68,32,36,75
Arbroath,8579,3,17,9,10,71,49,22,60
Alloa,8579,4,17,9,10,56,43,13,60
Stranraer,8579,5,15,6,15,56,65,-9,51
East Fife,8579,6,13,4,19,48,65,-17,43
Airdrieon,8579,7,10,11,15,46,60,-14,41
Forfar,8579,8,11,5,20,40,65,-25,38
Albion,8579,9,8,6,22,59,81,-22,30
Queen's Park,8579,10,6,11,19,40,73,-33,29
Raith,8580,1,23,8,5,70,32,38,77
Ayr,8580,2,24,4,8,93,42,51,76
Arbroath,8580,3,18,8,10,72,49,23,62
Alloa,8580,4,17,8,11,56,45,11,59
Stranraer,8580,5,15,6,15,55,64,-9,51
Airdrieon,8580,6,11,11,14,48,59,-11,44
East Fife,8580,7,13,4,19,47,64,-17,43
Forfar,8580,8,10,5,21,39,67,-28,35
Albion,8580,9,8,6,22,57,81,-24,30
Queen's Park,8580,10,6,10,20,40,74,-34,28
Raith,8581,1,22,9,5,68,32,36,75
Ayr,8581,2,23,4,9,91,44,47,73
Arbroath,8581,3,18,8,10,71,48,23,62
Alloa,8581,4,17,9,10,56,43,13,60
Stranraer,8581,5,15,6,15,56,65,-9,51
East Fife,8581,6,13,4,19,48,65,-17,43
Airdrieon,8581,7,10,11,15,45,59,-14,41
Forfar,8581,8,11,5,20,39,64,-25,38
Albion,8581,9,9,6,21,59,79,-20,33
Queen's Park,8581,10,6,10,20,39,73,-34,28
Ayr,8582,1,24,4,8,96,43,53,76
Raith,8582,2,22,8,6,68,33,35,74
Arbroath,8582,3,18,8,10,71,48,23,62
Alloa,8582,4,18,8,10,57,43,14,62
Stranraer,8582,5,15,5,16,56,66,-10,50
East Fife,8582,6,14,3,19,49,65,-16,45
Airdrieon,8582,7,11,11,14,47,59,-12,44
Forfar,8582,8,10,5,21,39,66,-27,35
Albion,8582,9,8,6,22,58,84,-26,30
Queen's Park,8582,10,6,10,20,39,73,-34,28
Ayr,8583,1,24,4,8,95,43,52,76
Raith,8583,2,22,9,5,69,33,36,75
Arbroath,8583,3,18,8,10,72,49,23,62
Alloa,8583,4,17,9,10,57,44,13,60
Stranraer,8583,5,16,5,15,58,66,-8,53
Airdrieon,8583,6,11,11,14,47,58,-11,44
East Fife,8583,7,13,3,20,49,67,-18,42
Forfar,8583,8,10,5,21,38,66,-28,35
Albion,8583,9,8,6,22,58,83,-25,30
Queen's Park,8583,10,6,10,20,40,74,-34,28
Raith,8584,1,23,8,5,71,34,37,77
Ayr,8584,2,23,4,9,91,44,47,73
Arbroath,8584,3,17,8,11,72,51,21,59
Alloa,8584,4,17,8,11,58,46,12,59
Stranraer,8584,5,16,5,15,57,64,-7,53
Airdrieon,8584,6,11,11,14,49,60,-11,44
East Fife,8584,7,13,3,20,47,66,-19,42
Forfar,8584,8,10,5,21,40,68,-28,35
Albion,8584,9,9,6,21,59,79,-20,33
Queen's Park,8584,10,7,10,19,42,74,-32,31
Raith,8585,1,23,8,5,69,32,37,77
Ayr,8585,2,24,4,8,96,45,51,76
Arbroath,8585,3,17,9,10,71,49,22,60
Alloa,8585,4,17,8,11,56,44,12,59
Stranraer,8585,5,15,5,16,55,67,-12,50
East Fife,8585,6,14,3,19,50,64,-14,45
Airdrieon,8585,7,10,11,15,46,60,-14,41
Forfar,8585,8,11,5,20,40,65,-25,38
Albion,8585,9,8,6,22,60,84,-24,30
Queen's Park,8585,10,6,11,19,40,73,-33,29
Raith,8586,1,23,8,5,71,32,39,77
Ayr,8586,2,23,4,9,93,46,47,73
Arbroath,8586,3,17,9,10,73,51,22,60
Alloa,8586,4,17,8,11,56,46,10,59
Stranraer,8586,5,15,6,15,56,65,-9,51
Airdrieon,8586,6,11,11,14,47,59,-12,44
East Fife,8586,7,13,4,19,48,65,-17,43
Forfar,8586,8,10,5,21,39,66,-27,35
Albion,8586,9,9,6,21,61,81,-20,33
Queen's Park,8586,10,6,11,19,42,75,-33,29
Raith,8587,1,23,8,5,70,32,38,77
Ayr,8587,2,24,4,8,92,42,50,76
Arbroath,8587,3,18,8,10,73,50,23,62
Alloa,8587,4,17,8,11,56,45,11,59
Stranraer,8587,5,15,5,16,56,66,-10,50
East Fife,8587,6,14,3,19,49,65,-16,45
Airdrieon,8587,7,10,11,15,47,64,-17,41
Forfar,8587,8,11,5,20,44,66,-22,38
Albion,8587,9,8,6,22,57,80,-23,30
Queen's Park,8587,10,6,10,20,41,75,-34,28
Raith,8588,1,23,8,5,70,32,38,77
Ayr,8588,2,24,4,8,97,43,54,76
Arbroath,8588,3,17,9,10,72,50,22,60
Alloa,8588,4,17,8,11,56,45,11,59
Stranraer,8588,5,15,5,16,55,67,-12,50
East Fife,8588,6,14,3,19,50,64,-14,45
Airdrieon,8588,7,11,11,14,46,58,-12,44
Forfar,8588,8,10,5,21,38,65,-27,35
Albion,8588,9,8,6,22,58,85,-27,30
Queen's Park,8588,10,6,11,19,41,74,-33,29
Ayr,8589,1,24,4,8,93,43,50,76
Raith,8589,2,22,9,5,69,33,36,75
Alloa,8589,3,17,9,10,57,44,13,60
Arbroath,8589,4,17,8,11,71,51,20,59
Stranraer,8589,5,15,5,16,55,65,-10,50
East Fife,8589,6,14,3,19,48,64,-16,45
Airdrieon,8589,7,10,11,15,45,60,-15,41
Forfar,8589,8,11,5,20,40,64,-24,38
Queen's Park,8589,9,7,10,19,42,73,-31,31
Albion,8589,10,8,6,22,58,81,-23,30
Ayr,8590,1,24,4,8,93,44,49,76
Raith,8590,2,22,8,6,70,35,35,74
Alloa,8590,3,18,8,10,59,45,14,62
Arbroath,8590,4,17,9,10,71,49,22,60
Stranraer,8590,5,15,5,16,55,66,-11,50
East Fife,8590,6,14,3,19,49,64,-15,45
Airdrieon,8590,7,11,11,14,46,58,-12,44
Forfar,8590,8,10,5,21,38,65,-27,35
Albion,8590,9,8,6,22,59,81,-22,30
Queen's Park,8590,10,6,11,19,40,73,-33,29
Raith,8591,1,23,8,5,70,33,37,77
Ayr,8591,2,23,5,8,92,44,48,74
Arbroath,8591,3,18,8,10,71,48,23,62
Alloa,8591,4,17,8,11,57,45,12,59
Stranraer,8591,5,16,5,15,59,67,-8,53
East Fife,8591,6,13,3,20,50,68,-18,42
Airdrieon,8591,7,10,11,15,45,59,-14,41
Forfar,8591,8,11,5,20,39,64,-25,38
Albion,8591,9,8,7,21,59,80,-21,31
Queen's Park,8591,10,6,10,20,39,73,-34,28
Ayr,8592,1,24,4,8,92,42,50,76
Raith,8592,2,22,9,5,68,32,36,75
Alloa,8592,3,17,9,10,56,43,13,60
Arbroath,8592,4,17,8,11,70,50,20,59
Stranraer,8592,5,16,5,15,58,64,-6,53
Airdrieon,8592,6,11,11,14,48,58,-10,44
East Fife,8592,7,13,3,20,47,67,-20,42
Forfar,8592,8,10,5,21,38,67,-29,35
Queen's Park,8592,9,7,10,19,41,72,-31,31
Albion,8592,10,8,6,22,57,80,-23,30
Ayr,8593,1,24,4,8,92,42,50,76
Raith,8593,2,22,8,6,68,34,34,74
Alloa,8593,3,18,8,10,58,43,15,62
Arbroath,8593,4,17,9,10,71,49,22,60
Stranraer,8593,5,15,6,15,55,64,-9,51
Airdrieon,8593,6,11,11,14,48,59,-11,44
East Fife,8593,7,13,4,19,47,64,-17,43
Forfar,8593,8,10,5,21,39,67,-28,35
Albion,8593,9,8,6,22,57,80,-23,30
Queen's Park,8593,10,6,11,19,40,73,-33,29
Ayr,8594,1,24,4,8,95,42,53,76
Raith,8594,2,22,8,6,69,34,35,74
Alloa,8594,3,18,8,10,58,44,14,62
Arbroath,8594,4,17,8,11,70,50,20,59
Stranraer,8594,5,15,5,16,55,67,-12,50
East Fife,8594,6,14,3,19,50,64,-14,45
Airdrieon,8594,7,11,11,14,47,58,-11,44
Forfar,8594,8,10,5,21,38,66,-28,35
Queen's Park,8594,9,7,10,19,41,72,-31,31
Albion,8594,10,8,6,22,57,83,-26,30
Raith,8595,1,23,8,5,71,32,39,77
Ayr,8595,2,24,4,8,97,44,53,76
Arbroath,8595,3,18,8,10,74,48,26,62
Alloa,8595,4,17,8,11,56,46,10,59
Stranraer,8595,5,15,6,15,56,65,-9,51
East Fife,8595,6,13,4,19,48,65,-17,43
Airdrieon,8595,7,10,12,14,46,59,-13,42
Forfar,8595,8,10,6,20,39,65,-26,36
Albion,8595,9,8,6,22,59,85,-26,30
Queen's Park,8595,10,6,10,20,39,76,-37,28
Raith,8596,1,23,8,5,72,32,40,77
Ayr,8596,2,24,4,8,94,44,50,76
Arbroath,8596,3,18,8,10,72,48,24,62
Alloa,8596,4,17,8,11,56,47,9,59
Stranraer,8596,5,15,5,16,56,66,-10,50
East Fife,8596,6,14,3,19,49,65,-16,45
Airdrieon,8596,7,11,11,14,48,58,-10,44
Forfar,8596,8,10,5,21,38,67,-29,35
Albion,8596,9,8,6,22,59,82,-23,30
Queen's Park,8596,10,6,10,20,39,74,-35,28
Ayr,8597,1,24,4,8,92,43,49,76
Raith,8597,2,22,9,5,69,33,36,75
Arbroath,8597,3,17,9,10,71,49,22,60
Alloa,8597,4,17,9,10,57,44,13,60
Stranraer,8597,5,15,5,16,56,66,-10,50
East Fife,8597,6,14,3,19,49,65,-16,45
Airdrieon,8597,7,11,11,14,49,60,-11,44
Forfar,8597,8,10,5,21,40,68,-28,35
Albion,8597,9,8,6,22,58,80,-22,30
Queen's Park,8597,10,6,11,19,40,73,-33,29
Raith,8598,1,23,8,5,72,32,40,77
Ayr,8598,2,24,4,8,94,42,52,76
Arbroath,8598,3,18,8,10,71,48,23,62
Alloa,8598,4,17,8,11,56,47,9,59
Stranraer,8598,5,15,5,16,57,67,-10,50
East Fife,8598,6,14,3,19,50,66,-16,45
Airdrieon,8598,7,11,11,14,47,58,-11,44
Forfar,8598,8,10,5,21,38,66,-28,35
Albion,8598,9,8,6,22,57,82,-25,30
Queen's Park,8598,10,6,10,20,39,73,-34,28
Ayr,8599,1,24,4,8,92,43,49,76
Raith,8599,2,22,9,5,69,33,36,75
Arbroath,8599,3,17,9,10,71,49,22,60
Alloa,8599,4,17,9,10,57,44,13,60
Stranraer,8599,5,15,5,16,56,66,-10,50
East Fife,8599,6,14,3,19,49,65,-16,45
Airdrieon,8599,7,11,11,14,46,58,-12,44
Forfar,8599,8,10,5,21,38,65,-27,35
Albion,8599,9,8,6,22,58,80,-22,30
Queen's Park,8599,10,6,11,19,40,73,-33,29
Raith,8600,1,23,8,5,70,33,37,77
Ayr,8600,2,24,4,8,97,44,53,76
Arbroath,8600,3,17,8,11,70,50,20,59
Alloa,8600,4,17,8,11,57,45,12,59
Stranraer,8600,5,16,5,15,57,65,-8,53
Airdrieon,8600,6,10,12,14,46,59,-13,42
East Fife,8600,7,13,3,20,48,66,-18,42
Forfar,8600,8,10,6,20,39,65,-26,36
Queen's Park,8600,9,7,10,19,41,72,-31,31
Albion,8600,10,8,6,22,59,85,-26,30
Raith,8601,1,22,8,6,69,34,35,74
Ayr,8601,2,23,4,9,91,44,47,73
Alloa,8601,3,18,8,10,58,44,14,62
Arbroath,8601,4,17,8,11,71,50,21,59
Stranraer,8601,5,15,5,16,55,66,-11,50
East Fife,8601,6,14,3,19,49,64,-15,45
Airdrieon,8601,7,11,11,14,48,59,-11,44
Forfar,8601,8,10,5,21,39,67,-28,35
Albion,8601,9,9,6,21,59,79,-20,33
Queen's Park,8601,10,7,10,19,41,73,-32,31
Ayr,8602,1,24,4,8,93,44,49,76
Raith,8602,2,22,9,5,69,33,36,75
Arbroath,8602,3,18,8,10,72,48,24,62
Alloa,8602,4,17,9,10,57,44,13,60
Stranraer,8602,5,16,5,15,56,64,-8,53
East Fife,8602,6,13,3,20,47,65,-18,42
Airdrieon,8602,7,10,11,15,45,59,-14,41
Forfar,8602,8,11,5,20,39,64,-25,38
Albion,8602,9,8,6,22,59,81,-22,30
Queen's Park,8602,10,6,10,20,39,74,-35,28
Raith,8603,1,23,8,5,70,33,37,77
Ayr,8603,2,24,4,8,95,44,51,76
Arbroath,8603,3,18,8,10,74,50,24,62
Alloa,8603,4,17,8,11,57,45,12,59
Stranraer,8603,5,15,5,16,56,67,-11,50
East Fife,8603,6,14,3,19,50,65,-15,45
Airdrieon,8603,7,11,11,14,48,60,-12,44
Forfar,8603,8,10,5,21,40,67,-27,35
Albion,8603,9,8,6,22,59,83,-24,30
Queen's Park,8603,10,6,10,20,41,76,-35,28
Ayr,8604,1,24,4,8,96,43,53,76
Raith,8604,2,22,9,5,69,33,36,75
Arbroath,8604,3,18,8,10,71,48,23,62
Alloa,8604,4,17,9,10,57,44,13,60
Stranraer,8604,5,15,5,16,56,66,-10,50
East Fife,8604,6,14,3,19,49,65,-16,45
Airdrieon,8604,7,11,11,14,49,59,-10,44
Forfar,8604,8,10,5,21,39,68,-29,35
Albion,8604,9,8,6,22,58,84,-26,30
Queen's Park,8604,10,6,10,20,39,73,-34,28
Raith,8605,1,23,8,5,70,32,38,77
Ayr,8605,2,24,4,8,98,42,56,76
Arbroath,8605,3,17,8,11,70,49,21,59
Alloa,8605,4,17,8,11,56,45,11,59
Stranraer,8605,5,15,5,16,56,67,-11,50
East Fife,8605,6,14,3,19,50,65,-15,45
Airdrieon,8605,7,10,11,15,46,60,-14,41
Forfar,8605,8,11,5,20,40,65,-25,38
Queen's Park,8605,9,7,10,19,40,72,-32,31
Albion,8605,10,8,6,22,57,86,-29,30
Ayr,8606,1,24,4,8,94,42,52,76
Raith,8606,2,22,8,6,69,35,34,74
Alloa,8606,3,18,8,10,59,44,15,62
Arbroath,8606,4,17,9,10,72,50,22,60
Stranraer,8606,5,16,5,15,58,65,-7,53
Airdrieon,8606,6,10,12,14,46,59,-13,42
East Fife,8606,7,13,3,20,48,67,-19,42
Forfar,8606,8,10,6,20,39,65,-26,36
Albion,8606,9,8,6,22,57,82,-25,30
Queen's Park,8606,10,6,11,19,41,74,-33,29
Ayr,8607,1,24,4,8,94,44,50,76
Raith,8607,2,22,8,6,69,34,35,74
Arbroath,8607,3,18,8,10,73,50,23,62
Alloa,8607,4,18,8,10,58,44,14,62
Stranraer,8607,5,15,5,16,55,65,-10,50
East Fife,8607,6,14,3,19,48,64,-16,45
Airdrieon,8607,7,10,12,14,45,58,-13,42
Forfar,8607,8,10,6,20,38,64,-26,36
Albion,8607,9,8,6,22,59,82,-23,30
Queen's Park,8607,10,6,10,20,41,75,-34,28
Raith,8608,1,23,8,5,70,32,38,77
Ayr,8608,2,23,5,8,91,43,48,74
Arbroath,8608,3,17,8,11,73,53,20,59
Alloa,8608,4,17,8,11,56,45,11,59
Stranraer,8608,5,16,5,15,56,64,-8,53
Airdrieon,8608,6,11,11,14,48,58,-10,44
East Fife,8608,7,13,3,20,47,65,-18,42
Forfar,8608,8,10,5,21,38,67,-29,35
Albion,8608,9,8,7,21,58,79,-21,31
Queen's Park,8608,10,7,10,19,44,75,-31,31
Raith,8609,1,23,8,5,70,32,38,77
Ayr,8609,2,23,4,9,92,45,47,73
Arbroath,8609,3,18,8,10,73,49,24,62
Alloa,8609,4,17,8,11,56,45,11,59
Stranraer,8609,5,15,5,16,57,68,-11,50
East Fife,8609,6,14,3,19,51,66,-15,45
Airdrieon,8609,7,11,11,14,46,58,-12,44
Forfar,8609,8,10,5,21,38,65,-27,35
Albion,8609,9,9,6,21,60,80,-20,33
Queen's Park,8609,10,6,10,20,40,75,-35,28
Raith,8610,1,23,8,5,69,32,37,77
Ayr,8610,2,24,4,8,92,42,50,76
Arbroath,8610,3,17,8,11,71,50,21,59
Alloa,8610,4,17,8,11,56,44,12,59
Stranraer,8610,5,15,6,15,56,65,-9,51
East Fife,8610,6,13,4,19,48,65,-17,43
Airdrieon,8610,7,10,12,14,46,59,-13,42
Forfar,8610,8,10,6,20,39,65,-26,36
Queen's Park,8610,9,7,10,19,41,73,-32,31
Albion,8610,10,8,6,22,57,80,-23,30
Raith,8611,1,22,9,5,68,32,36,75
Ayr,8611,2,23,4,9,91,44,47,73
Alloa,8611,3,17,9,10,56,43,13,60
Arbroath,8611,4,17,8,11,70,50,20,59
Stranraer,8611,5,16,5,15,58,64,-6,53
Airdrieon,8611,6,10,12,14,45,58,-13,42
East Fife,8611,7,13,3,20,47,67,-20,42
Forfar,8611,8,10,6,20,38,64,-26,36
Albion,8611,9,9,6,21,59,79,-20,33
Queen's Park,8611,10,7,10,19,41,72,-31,31
Raith,8612,1,23,8,5,69,32,37,77
Ayr,8612,2,24,4,8,92,42,50,76
Arbroath,8612,3,17,8,11,70,49,21,59
Alloa,8612,4,17,8,11,56,44,12,59
Stranraer,8612,5,15,5,16,56,67,-11,50
East Fife,8612,6,14,3,19,50,65,-15,45
Airdrieon,8612,7,11,11,14,50,58,-8,44
Forfar,8612,8,10,5,21,38,69,-31,35
Queen's Park,8612,9,7,10,19,40,72,-32,31
Albion,8612,10,8,6,22,57,80,-23,30
Ayr,8613,1,24,4,8,93,42,51,76
Raith,8613,2,22,8,6,68,33,35,74
Arbroath,8613,3,18,8,10,72,48,24,62
Alloa,8613,4,18,8,10,57,43,14,62
Stranraer,8613,5,16,5,15,57,64,-7,53
East Fife,8613,6,13,3,20,47,66,-19,42
Airdrieon,8613,7,10,11,15,45,60,-15,41
Forfar,8613,8,11,5,20,40,64,-24,38
Albion,8613,9,8,6,22,57,81,-24,30
Queen's Park,8613,10,6,10,20,39,74,-35,28
Ayr,8614,1,24,4,8,94,42,52,76
Raith,8614,2,22,8,6,68,33,35,74
Alloa,8614,3,18,8,10,57,43,14,62
Arbroath,8614,4,17,9,10,72,50,22,60
Stranraer,8614,5,16,5,15,58,66,-8,53
East Fife,8614,6,13,3,20,49,67,-18,42
Airdrieon,8614,7,10,11,15,45,60,-15,41
Forfar,8614,8,11,5,20,40,64,-24,38
Albion,8614,9,8,6,22,57,82,-25,30
Queen's Park,8614,10,6,11,19,41,74,-33,29
Raith,8615,1,23,8,5,69,32,37,77
Ayr,8615,2,24,4,8,94,42,52,76
Arbroath,8615,3,17,8,11,70,49,21,59
Alloa,8615,4,17,8,11,56,44,12,59
Stranraer,8615,5,15,5,16,56,68,-12,50
East Fife,8615,6,14,3,19,51,65,-14,45
Airdrieon,8615,7,10,12,14,46,59,-13,42
Forfar,8615,8,10,6,20,39,65,-26,36
Queen's Park,8615,9,7,10,19,40,72,-32,31
Albion,8615,10,8,6,22,57,82,-25,30
Raith,8616,1,23,8,5,71,32,39,77
Ayr,8616,2,23,5,8,91,43,48,74
Arbroath,8616,3,18,8,10,74,50,24,62
Alloa,8616,4,17,8,11,56,46,10,59
Stranraer,8616,5,15,5,16,56,66,-10,50
East Fife,8616,6,14,3,19,49,65,-16,45
Airdrieon,8616,7,11,11,14,48,59,-11,44
Forfar,8616,8,10,5,21,39,67,-28,35
Albion,8616,9,8,7,21,58,79,-21,31
Queen's Park,8616,10,6,10,20,41,76,-35,28
Ayr,8617,1,24,4,8,91,42,49,76
Raith,8617,2,22,9,5,69,33,36,75
Arbroath,8617,3,18,8,10,71,48,23,62
Alloa,8617,4,17,9,10,57,44,13,60
Stranraer,8617,5,15,5,16,56,66,-10,50
East Fife,8617,6,14,3,19,49,65,-16,45
Airdrieon,8617,7,10,11,15,47,61,-14,41
Forfar,8617,8,11,5,20,41,66,-25,38
Albion,8617,9,8,6,22,57,79,-22,30
Queen's Park,8617,10,6,10,20,39,73,-34,28
Raith,8618,1,23,8,5,71,33,38,77
Ayr,8618,2,24,4,8,92,42,50,76
Arbroath,8618,3,18,8,10,71,48,23,62
Alloa,8618,4,17,8,11,57,46,11,59
Stranraer,8618,5,15,6,15,56,65,-9,51
East Fife,8618,6,13,4,19,48,65,-17,43
Airdrieon,8618,7,10,11,15,45,59,-14,41
Forfar,8618,8,11,5,20,39,64,-25,38
Albion,8618,9,8,6,22,57,80,-23,30
Queen's Park,8618,10,6,10,20,39,73,-34,28
Raith,8619,1,23,8,5,69,32,37,77
Ayr,8619,2,23,5,8,91,43,48,74
Arbroath,8619,3,18,8,10,72,48,24,62
Alloa,8619,4,17,8,11,56,44,12,59
Stranraer,8619,5,16,5,15,58,66,-8,53
Airdrieon,8619,6,10,12,14,46,59,-13,42
East Fife,8619,7,13,3,20,49,67,-18,42
Forfar,8619,8,10,6,20,39,65,-26,36
Albion,8619,9,8,7,21,58,79,-21,31
Queen's Park,8619,10,6,10,20,39,74,-35,28
Raith,8620,1,23,8,5,70,33,37,77
Ayr,8620,2,23,4,9,91,44,47,73
Arbroath,8620,3,17,8,11,72,51,21,59
Alloa,8620,4,17,8,11,57,45,12,59
Stranraer,8620,5,15,5,16,56,67,-11,50
East Fife,8620,6,14,3,19,50,65,-15,45
Airdrieon,8620,7,11,11,14,49,58,-9,44
Forfar,8620,8,10,5,21,38,68,-30,35
Albion,8620,9,9,6,21,59,79,-20,33
Queen's Park,8620,10,7,10,19,42,74,-32,31
Raith,8621,1,23,8,5,71,32,39,77
Ayr,8621,2,23,5,8,91,43,48,74
Arbroath,8621,3,17,9,10,73,51,22,60
Alloa,8621,4,17,8,11,56,46,10,59
Stranraer,8621,5,15,6,15,57,66,-9,51
Airdrieon,8621,6,11,11,14,48,59,-11,44
East Fife,8621,7,13,4,19,49,66,-17,43
Forfar,8621,8,10,5,21,39,67,-28,35
Albion,8621,9,8,7,21,58,79,-21,31
Queen's Park,8621,10,6,11,19,42,75,-33,29
Raith,8622,1,23,8,5,69,32,37,77
Ayr,8622,2,24,4,8,95,42,53,76
Arbroath,8622,3,17,9,10,70,48,22,60
Alloa,8622,4,17,8,11,56,44,12,59
Stranraer,8622,5,16,5,15,56,64,-8,53
Airdrieon,8622,6,11,11,14,48,60,-12,44
East Fife,8622,7,13,3,20,47,65,-18,42
Forfar,8622,8,10,5,21,40,67,-27,35
Albion,8622,9,8,6,22,57,83,-26,30
Queen's Park,8622,10,6,11,19,39,72,-33,29
Ayr,8623,1,24,4,8,96,44,52,76
Raith,8623,2,22,9,5,70,34,36,75
Arbroath,8623,3,17,9,10,72,50,22,60
Alloa,8623,4,17,9,10,58,45,13,60
Stranraer,8623,5,15,5,16,55,69,-14,50
East Fife,8623,6,14,3,19,52,64,-12,45
Airdrieon,8623,7,10,11,15,45,59,-14,41
Forfar,8623,8,11,5,20,39,64,-25,38
Albion,8623,9,8,6,22,59,84,-25,30
Queen's Park,8623,10,6,11,19,41,74,-33,29
Raith,8624,1,23,8,5,71,32,39,77
Ayr,8624,2,24,4,8,94,43,51,76
Arbroath,8624,3,17,9,10,72,50,22,60
Alloa,8624,4,17,8,11,56,46,10,59
Stranraer,8624,5,15,5,16,57,67,-10,50
East Fife,8624,6,14,3,19,50,66,-16,45
Airdrieon,8624,7,10,11,15,45,60,-15,41
Forfar,8624,8,11,5,20,40,64,-24,38
Albion,8624,9,8,6,22,58,82,-24,30
Queen's Park,8624,10,6,11,19,41,74,-33,29
Raith,8625,1,23,8,5,69,32,37,77
Ayr,8625,2,23,4,9,92,46,46,73
Arbroath,8625,3,17,9,10,72,50,22,60
Alloa,8625,4,17,8,11,56,44,12,59
Stranraer,8625,5,15,5,16,56,68,-12,50
East Fife,8625,6,14,3,19,51,65,-14,45
Airdrieon,8625,7,11,11,14,46,58,-12,44
Forfar,8625,8,10,5,21,38,65,-27,35
Albion,8625,9,9,6,21,61,80,-19,33
Queen's Park,8625,10,6,11,19,41,74,-33,29
Raith,8626,1,23,8,5,70,32,38,77
Ayr,8626,2,24,4,8,100,43,57,76
Arbroath,8626,3,17,9,10,70,48,22,60
Alloa,8626,4,17,8,11,56,45,11,59
Stranraer,8626,5,15,5,16,57,68,-11,50
East Fife,8626,6,14,3,19,51,66,-15,45
Airdrieon,8626,7,11,11,14,48,59,-11,44
Forfar,8626,8,10,5,21,39,67,-28,35
Albion,8626,9,8,6,22,58,88,-30,30
Queen's Park,8626,10,6,11,19,39,72,-33,29
Raith,8627,1,23,8,5,69,32,37,77
Ayr,8627,2,24,4,8,93,43,50,76
Arbroath,8627,3,17,8,11,71,50,21,59
Alloa,8627,4,17,8,11,56,44,12,59
Stranraer,8627,5,16,5,15,58,66,-8,53
East Fife,8627,6,13,3,20,49,67,-18,42
Airdrieon,8627,7,10,11,15,46,60,-14,41
Forfar,8627,8,11,5,20,40,65,-25,38
Queen's Park,8627,9,7,10,19,41,73,-32,31
Albion,8627,10,8,6,22,58,81,-23,30
Raith,8628,1,23,8,5,70,33,37,77
Ayr,8628,2,23,4,9,91,44,47,73
Arbroath,8628,3,18,8,10,73,49,24,62
Alloa,8628,4,17,8,11,57,45,12,59
Stranraer,8628,5,15,5,16,56,67,-11,50
East Fife,8628,6,14,3,19,50,65,-15,45
Airdrieon,8628,7,10,12,14,46,59,-13,42
Forfar,8628,8,10,6,20,39,65,-26,36
Albion,8628,9,9,6,21,59,79,-20,33
Queen's Park,8628,10,6,10,20,40,75,-35,28
Ayr,8629,1,24,4,8,92,43,49,76
Raith,8629,2,22,8,6,69,35,34,74
Arbroath,8629,3,18,8,10,72,48,24,62
Alloa,8629,4,18,8,10,59,44,15,62
Stranraer,8629,5,15,6,15,55,64,-9,51
East Fife,8629,6,13,4,19,47,64,-17,43
Airdrieon,8629,7,10,12,14,46,59,-13,42
Forfar,8629,8,10,6,20,39,65,-26,36
Albion,8629,9,8,6,22,58,80,-22,30
Queen's Park,8629,10,6,10,20,39,74,-35,28
Raith,8630,1,23,8,5,72,32,40,77
Ayr,8630,2,24,4,8,94,45,49,76
Arbroath,8630,3,17,9,10,70,48,22,60
Alloa,8630,4,17,8,11,56,47,9,59
Stranraer,8630,5,16,5,15,58,64,-6,53
East Fife,8630,6,13,3,20,47,67,-20,42
Airdrieon,8630,7,10,11,15,46,60,-14,41
Forfar,8630,8,11,5,20,40,65,-25,38
Albion,8630,9,8,6,22,60,82,-22,30
Queen's Park,8630,10,6,11,19,39,72,-33,29
Raith,8631,1,23,8,5,72,32,40,77
Ayr,8631,2,24,4,8,95,43,52,76
Arbroath,8631,3,18,8,10,76,50,26,62
Alloa,8631,4,17,8,11,56,47,9,59
Stranraer,8631,5,15,5,16,56,66,-10,50
East Fife,8631,6,14,3,19,49,65,-16,45
Airdrieon,8631,7,11,11,14,50,58,-8,44
Forfar,8631,8,10,5,21,38,69,-31,35
Albion,8631,9,8,6,22,58,83,-25,30
Queen's Park,8631,10,6,10,20,41,78,-37,28
Raith,8632,1,23,8,5,70,33,37,77
Ayr,8632,2,23,4,9,91,45,46,73
Arbroath,8632,3,17,8,11,72,51,21,59
Alloa,8632,4,17,8,11,57,45,12,59
Stranraer,8632,5,16,5,15,57,65,-8,53
Airdrieon,8632,6,11,11,14,49,58,-9,44
East Fife,8632,7,13,3,20,48,66,-18,42
Forfar,8632,8,10,5,21,38,68,-30,35
Albion,8632,9,9,6,21,60,79,-19,33
Queen's Park,8632,10,7,10,19,42,74,-32,31
Ayr,8633,1,24,4,8,92,43,49,76
Raith,8633,2,22,8,6,69,34,35,74
Arbroath,8633,3,18,8,10,71,48,23,62
Alloa,8633,4,18,8,10,58,44,14,62
Stranraer,8633,5,15,5,16,55,67,-12,50
East Fife,8633,6,14,3,19,50,64,-14,45
Airdrieon,8633,7,11,11,14,46,58,-12,44
Forfar,8633,8,10,5,21,38,65,-27,35
Albion,8633,9,8,6,22,58,80,-22,30
Queen's Park,8633,10,6,10,20,39,73,-34,28
Raith,8634,1,23,8,5,72,34,38,77
Ayr,8634,2,24,4,8,92,42,50,76
Arbroath,8634,3,18,8,10,72,49,23,62
Alloa,8634,4,17,8,11,58,47,11,59
Stranraer,8634,5,15,5,16,55,65,-10,50
East Fife,8634,6,14,3,19,48,64,-16,45
Airdrieon,8634,7,10,12,14,46,59,-13,42
Forfar,8634,8,10,6,20,39,65,-26,36
Albion,8634,9,8,6,22,57,80,-23,30
Queen's Park,8634,10,6,10,20,40,74,-34,28
Raith,8635,1,23,8,5,69,32,37,77
Ayr,8635,2,23,5,8,91,43,48,74
Arbroath,8635,3,17,8,11,71,50,21,59
Alloa,8635,4,17,8,11,56,44,12,59
Stranraer,8635,5,15,6,15,56,65,-9,51
East Fife,8635,6,13,4,19,48,65,-17,43
Airdrieon,8635,7,10,11,15,45,60,-15,41
Forfar,8635,8,11,5,20,40,64,-24,38
Albion,8635,9,8,7,21,58,79,-21,31
Queen's Park,8635,10,7,10,19,41,73,-32,31
Raith,8636,1,23,8,5,69,32,37,77
Ayr,8636,2,24,4,8,93,42,51,76
Arbroath,8636,3,18,8,10,73,50,23,62
Alloa,8636,4,17,8,11,56,44,12,59
Stranraer,8636,5,15,5,16,56,68,-12,50
East Fife,8636,6,14,3,19,51,65,-14,45
Airdrieon,8636,7,10,11,15,46,61,-15,41
Forfar,8636,8,11,5,20,41,65,-24,38
Albion,8636,9,8,6,22,57,81,-24,30
Queen's Park,8636,10,6,10,20,41,75,-34,28
Raith,8637,1,23,8,5,70,32,38,77
Ayr,8637,2,23,4,9,92,45,47,73
Arbroath,8637,3,18,8,10,73,48,25,62
Alloa,8637,4,17,8,11,56,45,11,59
Stranraer,8637,5,16,5,15,58,65,-7,53
Airdrieon,8637,6,11,11,14,49,60,-11,44
East Fife,8637,7,13,3,20,48,67,-19,42
Forfar,8637,8,10,5,21,40,68,-28,35
Albion,8637,9,9,6,21,60,80,-20,33
Queen's Park,8637,10,6,10,20,39,75,-36,28
Raith,8638,1,23,8,5,70,33,37,77
Ayr,8638,2,24,4,8,95,42,53,76
Arbroath,8638,3,18,8,10,71,48,23,62
Alloa,8638,4,17,8,11,57,45,12,59
Stranraer,8638,5,16,5,15,57,64,-7,53
Airdrieon,8638,6,10,12,14,47,60,-13,42
East Fife,8638,7,13,3,20,47,66,-19,42
Forfar,8638,8,10,6,20,40,66,-26,36
Albion,8638,9,8,6,22,57,83,-26,30
Queen's Park,8638,10,6,10,20,39,73,-34,28
Raith,8639,1,23,8,5,72,32,40,77
Ayr,8639,2,24,4,8,92,42,50,76
Arbroath,8639,3,18,8,10,72,49,23,62
Alloa,8639,4,17,8,11,56,47,9,59
Stranraer,8639,5,15,6,15,56,65,-9,51
Airdrieon,8639,6,11,11,14,48,59,-11,44
East Fife,8639,7,13,4,19,48,65,-17,43
Forfar,8639,8,10,5,21,39,67,-28,35
Albion,8639,9,8,6,22,57,80,-23,30
Queen's Park,8639,10,6,10,20,40,74,-34,28
Raith,8640,1,23,8,5,72,33,39,77
Ayr,8640,2,24,4,8,93,44,49,76
Arbroath,8640,3,17,8,11,71,50,21,59
Alloa,8640,4,17,8,11,57,47,10,59
Stranraer,8640,5,16,5,15,57,65,-8,53
East Fife,8640,6,13,3,20,48,66,-18,42
Airdrieon,8640,7,10,11,15,45,59,-14,41
Forfar,8640,8,11,5,20,39,64,-25,38
Queen's Park,8640,9,7,10,19,41,73,-32,31
Albion,8640,10,8,6,22,59,81,-22,30
Raith,8641,1,23,8,5,72,33,39,77
Ayr,8641,2,23,5,8,93,45,48,74
Arbroath,8641,3,17,9,10,71,49,22,60
Alloa,8641,4,17,8,11,57,47,10,59
Stranraer,8641,5,15,6,15,56,65,-9,51
East Fife,8641,6,13,4,19,48,65,-17,43
Airdrieon,8641,7,10,11,15,45,59,-14,41
Forfar,8641,8,11,5,20,39,64,-25,38
Albion,8641,9,8,7,21,60,81,-21,31
Queen's Park,8641,10,6,11,19,40,73,-33,29
Raith,8642,1,23,8,5,70,32,38,77
Ayr,8642,2,23,4,9,90,43,47,73
Arbroath,8642,3,17,9,10,71,49,22,60
Alloa,8642,4,17,8,11,56,45,11,59
Stranraer,8642,5,15,6,15,57,66,-9,51
Airdrieon,8642,6,11,11,14,51,58,-7,44
East Fife,8642,7,13,4,19,49,66,-17,43
Forfar,8642,8,10,5,21,38,70,-32,35
Albion,8642,9,9,6,21,58,78,-20,33
Queen's Park,8642,10,6,11,19,40,73,-33,29
Ayr,8643,1,24,4,8,96,45,51,76
Raith,8643,2,22,8,6,68,34,34,74
Arbroath,8643,3,18,8,10,72,49,23,62
Alloa,8643,4,18,8,10,58,43,15,62
Stranraer,8643,5,16,5,15,56,64,-8,53
Airdrieon,8643,6,11,11,14,47,58,-11,44
East Fife,8643,7,13,3,20,47,65,-18,42
Forfar,8643,8,10,5,21,38,66,-28,35
Albion,8643,9,8,6,22,60,84,-24,30
Queen's Park,8643,10,6,10,20,40,74,-34,28
Ayr,8644,1,24,4,8,95,42,53,76
Raith,8644,2,22,9,5,69,33,36,75
Arbroath,8644,3,18,8,10,73,48,25,62
Alloa,8644,4,17,9,10,57,44,13,60
Stranraer,8644,5,15,5,16,56,68,-12,50
East Fife,8644,6,14,3,19,51,65,-14,45
Airdrieon,8644,7,11,11,14,49,58,-9,44
Forfar,8644,8,10,5,21,38,68,-30,35
Albion,8644,9,8,6,22,57,83,-26,30
Queen's Park,8644,10,6,10,20,39,75,-36,28
Raith,8645,1,23,8,5,71,34,37,77
Ayr,8645,2,24,4,8,100,44,56,76
Arbroath,8645,3,18,8,10,72,49,23,62
Alloa,8645,4,17,8,11,58,46,12,59
Stranraer,8645,5,15,5,16,56,67,-11,50
East Fife,8645,6,14,3,19,50,65,-15,45
Airdrieon,8645,7,10,12,14,46,59,-13,42
Forfar,8645,8,10,6,20,39,65,-26,36
Albion,8645,9,8,6,22,59,88,-29,30
Queen's Park,8645,10,6,10,20,40,74,-34,28
Raith,8646,1,22,9,5,69,33,36,75
Ayr,8646,2,23,4,9,91,45,46,73
Arbroath,8646,3,18,8,10,72,49,23,62
Alloa,8646,4,17,9,10,57,44,13,60
Stranraer,8646,5,15,5,16,56,66,-10,50
East Fife,8646,6,14,3,19,49,65,-16,45
Airdrieon,8646,7,10,12,14,46,59,-13,42
Forfar,8646,8,10,6,20,39,65,-26,36
Albion,8646,9,9,6,21,60,79,-19,33
Queen's Park,8646,10,6,10,20,40,74,-34,28
Raith,8647,1,22,8,6,69,35,34,74
Ayr,8647,2,23,4,9,91,44,47,73
Alloa,8647,3,18,8,10,59,44,15,62
Arbroath,8647,4,17,9,10,70,48,22,60
Stranraer,8647,5,15,5,16,55,67,-12,50
East Fife,8647,6,14,3,19,50,64,-14,45
Airdrieon,8647,7,10,11,15,45,60,-15,41
Forfar,8647,8,11,5,20,40,64,-24,38
Albion,8647,9,9,6,21,59,79,-20,33
Queen's Park,8647,10,6,11,19,39,72,-33,29
Raith,8648,1,22,8,6,68,34,34,74
Ayr,8648,2,23,4,9,92,45,47,73
Arbroath,8648,3,18,8,10,72,48,24,62
Alloa,8648,4,18,8,10,58,43,15,62
Stranraer,8648,5,16,5,15,56,64,-8,53
East Fife,8648,6,13,3,20,47,65,-18,42
Airdrieon,8648,7,10,11,15,46,60,-14,41
Forfar,8648,8,11,5,20,40,65,-25,38
Albion,8648,9,9,6,21,60,80,-20,33
Queen's Park,8648,10,6,10,20,39,74,-35,28
Raith,8649,1,23,8,5,69,32,37,77
Ayr,8649,2,24,4,8,91,42,49,76
Arbroath,8649,3,18,8,10,73,49,24,62
Alloa,8649,4,17,8,11,56,44,12,59
Stranraer,8649,5,15,6,15,56,65,-9,51
Airdrieon,8649,6,11,11,14,48,58,-10,44
East Fife,8649,7,13,4,19,48,65,-17,43
Forfar,8649,8,10,5,21,38,67,-29,35
Albion,8649,9,8,6,22,57,79,-22,30
Queen's Park,8649,10,6,10,20,40,75,-35,28
Raith,8650,1,23,8,5,69,32,37,77
Ayr,8650,2,23,5,8,92,44,48,74
Arbroath,8650,3,17,8,11,72,52,20,59
Alloa,8650,4,17,8,11,56,44,12,59
Stranraer,8650,5,15,5,16,55,68,-13,50
East Fife,8650,6,14,3,19,51,64,-13,45
Airdrieon,8650,7,11,11,14,46,58,-12,44
Forfar,8650,8,10,5,21,38,65,-27,35
Albion,8650,9,8,7,21,59,80,-21,31
Queen's Park,8650,10,7,10,19,43,74,-31,31
Raith,8651,1,23,8,5,70,33,37,77
Ayr,8651,2,24,4,8,91,42,49,76
Arbroath,8651,3,17,8,11,72,53,19,59
Alloa,8651,4,17,8,11,57,45,12,59
Stranraer,8651,5,16,5,15,58,64,-6,53
Airdrieon,8651,6,11,11,14,48,59,-11,44
East Fife,8651,7,13,3,20,47,67,-20,42
Forfar,8651,8,10,5,21,39,67,-28,35
Queen's Park,8651,9,7,10,19,44,74,-30,31
Albion,8651,10,8,6,22,57,79,-22,30
Raith,8652,1,23,8,5,71,32,39,77
Ayr,8652,2,24,4,8,96,43,53,76
Arbroath,8652,3,17,9,10,73,51,22,60
Alloa,8652,4,17,8,11,56,46,10,59
Stranraer,8652,5,16,5,15,57,65,-8,53
Airdrieon,8652,6,10,12,14,48,61,-13,42
East Fife,8652,7,13,3,20,48,66,-18,42
Forfar,8652,8,10,6,20,41,67,-26,36
Albion,8652,9,8,6,22,58,84,-26,30
Queen's Park,8652,10,6,11,19,42,75,-33,29
Raith,8653,1,23,8,5,69,32,37,77
Ayr,8653,2,24,4,8,92,43,49,76
Arbroath,8653,3,18,8,10,72,49,23,62
Alloa,8653,4,17,8,11,56,44,12,59
Stranraer,8653,5,16,5,15,60,65,-5,53
Airdrieon,8653,6,10,12,14,45,58,-13,42
East Fife,8653,7,13,3,20,48,69,-21,42
Forfar,8653,8,10,6,20,38,64,-26,36
Albion,8653,9,8,6,22,58,80,-22,30
Queen's Park,8653,10,6,10,20,40,74,-34,28
Raith,8654,1,23,8,5,71,32,39,77
Ayr,8654,2,23,5,8,92,44,48,74
Arbroath,8654,3,17,9,10,70,48,22,60
Alloa,8654,4,17,8,11,56,46,10,59
Stranraer,8654,5,15,5,16,56,67,-11,50
East Fife,8654,6,14,3,19,50,65,-15,45
Airdrieon,8654,7,11,11,14,47,58,-11,44
Forfar,8654,8,10,5,21,38,66,-28,35
Albion,8654,9,8,7,21,59,80,-21,31
Queen's Park,8654,10,6,11,19,39,72,-33,29
Raith,8655,1,23,8,5,69,32,37,77
Ayr,8655,2,24,4,8,96,43,53,76
Arbroath,8655,3,18,8,10,73,49,24,62
Alloa,8655,4,17,8,11,56,44,12,59
Stranraer,8655,5,15,5,16,56,66,-10,50
East Fife,8655,6,14,3,19,49,65,-16,45
Airdrieon,8655,7,10,12,14,45,58,-13,42
Forfar,8655,8,10,6,20,38,64,-26,36
Albion,8655,9,8,6,22,58,84,-26,30
Queen's Park,8655,10,6,10,20,40,75,-35,28
Ayr,8656,1,24,4,8,93,42,51,76
Raith,8656,2,22,9,5,69,33,36,75
Alloa,8656,3,17,9,10,57,44,13,60
Arbroath,8656,4,17,8,11,70,50,20,59
Stranraer,8656,5,16,5,15,57,64,-7,53
East Fife,8656,6,13,3,20,47,66,-19,42
Airdrieon,8656,7,10,11,15,47,61,-14,41
Forfar,8656,8,11,5,20,41,66,-25,38
Queen's Park,8656,9,7,10,19,41,72,-31,31
Albion,8656,10,8,6,22,57,81,-24,30
Raith,8657,1,23,8,5,72,32,40,77
Ayr,8657,2,23,4,9,92,45,47,73
Arbroath,8657,3,17,9,10,73,51,22,60
Alloa,8657,4,17,8,11,56,47,9,59
Stranraer,8657,5,16,5,15,57,65,-8,53
Airdrieon,8657,6,11,11,14,47,58,-11,44
East Fife,8657,7,13,3,20,48,66,-18,42
Forfar,8657,8,10,5,21,38,66,-28,35
Albion,8657,9,9,6,21,60,80,-20,33
Queen's Park,8657,10,6,11,19,42,75,-33,29
Raith,8658,1,23,8,5,71,33,38,77
Ayr,8658,2,24,4,8,94,42,52,76
Arbroath,8658,3,18,8,10,74,51,23,62
Alloa,8658,4,17,8,11,57,46,11,59
Stranraer,8658,5,15,5,16,56,67,-11,50
East Fife,8658,6,14,3,19,50,65,-15,45
Airdrieon,8658,7,11,11,14,48,59,-11,44
Forfar,8658,8,10,5,21,39,67,-28,35
Albion,8658,9,8,6,22,57,82,-25,30
Queen's Park,8658,10,6,10,20,42,76,-34,28
Ayr,8659,1,24,4,8,93,42,51,76
Raith,8659,2,22,8,6,70,35,35,74
Arbroath,8659,3,18,8,10,73,49,24,62
Alloa,8659,4,18,8,10,59,45,14,62
Stranraer,8659,5,16,5,15,58,64,-6,53
Airdrieon,8659,6,10,12,14,46,59,-13,42
East Fife,8659,7,13,3,20,47,67,-20,42
Forfar,8659,8,10,6,20,39,65,-26,36
Albion,8659,9,8,6,22,57,81,-24,30
Queen's Park,8659,10,6,10,20,40,75,-35,28
Ayr,8660,1,24,4,8,95,45,50,76
Raith,8660,2,22,8,6,68,34,34,74
Alloa,8660,3,18,8,10,58,43,15,62
Arbroath,8660,4,17,8,11,71,50,21,59
Stranraer,8660,5,16,5,15,57,65,-8,53
Airdrieon,8660,6,10,12,14,46,59,-13,42
East Fife,8660,7,13,3,20,48,66,-18,42
Forfar,8660,8,10,6,20,39,65,-26,36
Queen's Park,8660,9,7,10,19,41,73,-32,31
Albion,8660,10,8,6,22,60,83,-23,30
Raith,8661,1,22,9,5,70,34,36,75
Ayr,8661,2,23,5,8,91,43,48,74
Alloa,8661,3,17,9,10,58,45,13,60
Arbroath,8661,4,17,8,11,71,50,21,59
Stranraer,8661,5,15,6,15,56,65,-9,51
East Fife,8661,6,13,4,19,48,65,-17,43
Airdrieon,8661,7,10,12,14,47,60,-13,42
Forfar,8661,8,10,6,20,40,66,-26,36
Albion,8661,9,8,7,21,58,79,-21,31
Queen's Park,8661,10,7,10,19,41,73,-32,31
Raith,8662,1,23,8,5,71,33,38,77
Ayr,8662,2,23,4,9,92,45,47,73
Arbroath,8662,3,18,8,10,74,48,26,62
Alloa,8662,4,17,8,11,57,46,11,59
Stranraer,8662,5,15,5,16,55,68,-13,50
East Fife,8662,6,14,3,19,51,64,-13,45
Airdrieon,8662,7,10,12,14,46,59,-13,42
Forfar,8662,8,10,6,20,39,65,-26,36
Albion,8662,9,9,6,21,60,80,-20,33
Queen's Park,8662,10,6,10,20,39,76,-37,28
Raith,8663,1,23,8,5,74,33,41,77
Ayr,8663,2,24,4,8,96,42,54,76
Arbroath,8663,3,18,8,10,72,49,23,62
Alloa,8663,4,17,8,11,57,49,8,59
Stranraer,8663,5,15,5,16,55,66,-11,50
East Fife,8663,6,14,3,19,49,64,-15,45
Airdrieon,8663,7,10,11,15,45,61,-16,41
Forfar,8663,8,11,5,20,41,64,-23,38
Albion,8663,9,8,6,22,57,84,-27,30
Queen's Park,8663,10,6,10,20,40,74,-34,28
Ayr,8664,1,24,4,8,96,42,54,76
Raith,8664,2,22,8,6,68,36,32,74
Alloa,8664,3,18,8,10,60,43,17,62
Arbroath,8664,4,17,9,10,72,50,22,60
Stranraer,8664,5,15,5,16,55,65,-10,50
East Fife,8664,6,14,3,19,48,64,-16,45
Airdrieon,8664,7,11,11,14,48,58,-10,44
Forfar,8664,8,10,5,21,38,67,-29,35
Albion,8664,9,8,6,22,57,84,-27,30
Queen's Park,8664,10,6,11,19,41,74,-33,29
Ayr,8665,1,24,4,8,98,44,54,76
Raith,8665,2,22,8,6,68,33,35,74
Alloa,8665,3,18,8,10,57,43,14,62
Arbroath,8665,4,17,9,10,71,49,22,60
Stranraer,8665,5,15,5,16,55,66,-11,50
East Fife,8665,6,14,3,19,49,64,-15,45
Airdrieon,8665,7,10,11,15,45,59,-14,41
Forfar,8665,8,11,5,20,39,64,-25,38
Albion,8665,9,8,6,22,59,86,-27,30
Queen's Park,8665,10,6,11,19,40,73,-33,29
Raith,8666,1,22,8,6,69,34,35,74
Ayr,8666,2,23,4,9,91,44,47,73
Alloa,8666,3,18,8,10,58,44,14,62
Arbroath,8666,4,17,8,11,71,50,21,59
Stranraer,8666,5,15,6,15,56,65,-9,51
East Fife,8666,6,13,4,19,48,65,-17,43
Airdrieon,8666,7,10,11,15,45,60,-15,41
Forfar,8666,8,11,5,20,40,64,-24,38
Albion,8666,9,9,6,21,59,79,-20,33
Queen's Park,8666,10,7,10,19,41,73,-32,31
Raith,8667,1,23,8,5,70,33,37,77
Ayr,8667,2,24,4,8,94,43,51,76
Arbroath,8667,3,18,8,10,72,48,24,62
Alloa,8667,4,17,8,11,57,45,12,59
Stranraer,8667,5,16,5,15,56,64,-8,53
Airdrieon,8667,6,11,11,14,46,58,-12,44
East Fife,8667,7,13,3,20,47,65,-18,42
Forfar,8667,8,10,5,21,38,65,-27,35
Albion,8667,9,8,6,22,58,82,-24,30
Queen's Park,8667,10,6,10,20,39,74,-35,28
Ayr,8668,1,24,4,8,94,43,51,76
Raith,8668,2,22,8,6,69,34,35,74
Arbroath,8668,3,18,8,10,72,49,23,62
Alloa,8668,4,18,8,10,58,44,14,62
Stranraer,8668,5,16,5,15,58,65,-7,53
Airdrieon,8668,6,11,11,14,47,59,-12,44
East Fife,8668,7,13,3,20,48,67,-19,42
Forfar,8668,8,10,5,21,39,66,-27,35
Albion,8668,9,8,6,22,58,82,-24,30
Queen's Park,8668,10,6,10,20,40,74,-34,28
Ayr,8669,1,24,4,8,96,44,52,76
Raith,8669,2,22,8,6,68,34,34,74
Alloa,8669,3,18,8,10,58,43,15,62
Arbroath,8669,4,17,9,10,70,48,22,60
Stranraer,8669,5,15,6,15,56,65,-9,51
East Fife,8669,6,13,4,19,48,65,-17,43
Airdrieon,8669,7,10,12,14,47,60,-13,42
Forfar,8669,8,10,6,20,40,66,-26,36
Albion,8669,9,8,6,22,59,84,-25,30
Queen's Park,8669,10,6,11,19,39,72,-33,29
Raith,8670,1,23,8,5,69,32,37,77
Ayr,8670,2,24,4,8,94,43,51,76
Arbroath,8670,3,18,8,10,76,48,28,62
Alloa,8670,4,17,8,11,56,44,12,59
Stranraer,8670,5,15,6,15,57,66,-9,51
Airdrieon,8670,6,11,11,14,47,59,-12,44
East Fife,8670,7,13,4,19,49,66,-17,43
Forfar,8670,8,10,5,21,39,66,-27,35
Albion,8670,9,8,6,22,58,82,-24,30
Queen's Park,8670,10,6,10,20,39,78,-39,28
Raith,8671,1,23,8,5,70,32,38,77
Ayr,8671,2,23,4,9,92,45,47,73
Arbroath,8671,3,18,8,10,75,50,25,62
Alloa,8671,4,17,8,11,56,45,11,59
Stranraer,8671,5,15,5,16,55,66,-11,50
East Fife,8671,6,14,3,19,49,64,-15,45
Airdrieon,8671,7,10,12,14,46,59,-13,42
Forfar,8671,8,10,6,20,39,65,-26,36
Albion,8671,9,9,6,21,60,80,-20,33
Queen's Park,8671,10,6,10,20,41,77,-36,28
Ayr,8672,1,24,4,8,95,42,53,76
Raith,8672,2,22,8,6,69,35,34,74
Arbroath,8672,3,18,8,10,73,50,23,62
Alloa,8672,4,18,8,10,59,44,15,62
Stranraer,8672,5,15,5,16,57,67,-10,50
East Fife,8672,6,14,3,19,50,66,-16,45
Airdrieon,8672,7,10,12,14,46,59,-13,42
Forfar,8672,8,10,6,20,39,65,-26,36
Albion,8672,9,8,6,22,57,83,-26,30
Queen's Park,8672,10,6,10,20,41,75,-34,28
Ayr,8673,1,24,4,8,94,42,52,76
Raith,8673,2,22,8,6,70,35,35,74
Alloa,8673,3,18,8,10,59,45,14,62
Arbroath,8673,4,17,8,11,71,51,20,59
Stranraer,8673,5,15,5,16,55,68,-13,50
East Fife,8673,6,14,3,19,51,64,-13,45
Airdrieon,8673,7,11,11,14,46,58,-12,44
Forfar,8673,8,10,5,21,38,65,-27,35
Queen's Park,8673,9,7,10,19,42,73,-31,31
Albion,8673,10,8,6,22,57,82,-25,30
Ayr,8674,1,24,4,8,94,43,51,76
Raith,8674,2,22,9,5,70,34,36,75
Alloa,8674,3,17,9,10,58,45,13,60
Arbroath,8674,4,17,8,11,71,50,21,59
Stranraer,8674,5,15,6,15,57,66,-9,51
Airdrieon,8674,6,11,11,14,47,59,-12,44
East Fife,8674,7,13,4,19,49,66,-17,43
Forfar,8674,8,10,5,21,39,66,-27,35
Queen's Park,8674,9,7,10,19,41,73,-32,31
Albion,8674,10,8,6,22,58,82,-24,30
Ayr,8675,1,24,4,8,92,43,49,76
Raith,8675,2,22,8,6,68,33,35,74
Alloa,8675,3,18,8,10,57,43,14,62
Arbroath,8675,4,17,8,11,73,52,21,59
Stranraer,8675,5,16,5,15,57,64,-7,53
East Fife,8675,6,13,3,20,47,66,-19,42
Airdrieon,8675,7,10,11,15,45,59,-14,41
Forfar,8675,8,11,5,20,39,64,-25,38
Queen's Park,8675,9,7,10,19,43,75,-32,31
Albion,8675,10,8,6,22,58,80,-22,30
Raith,8676,1,23,8,5,69,32,37,77
Ayr,8676,2,24,4,8,93,44,49,76
Arbroath,8676,3,18,8,10,72,49,23,62
Alloa,8676,4,17,8,11,56,44,12,59
Stranraer,8676,5,15,5,16,55,67,-12,50
East Fife,8676,6,14,3,19,50,64,-14,45
Airdrieon,8676,7,11,11,14,48,60,-12,44
Forfar,8676,8,10,5,21,40,67,-27,35
Albion,8676,9,8,6,22,59,81,-22,30
Queen's Park,8676,10,6,10,20,40,74,-34,28
Raith,8677,1,23,8,5,69,32,37,77
Ayr,8677,2,24,4,8,98,44,54,76
Arbroath,8677,3,18,8,10,76,49,27,62
Alloa,8677,4,17,8,11,56,44,12,59
Stranraer,8677,5,15,6,15,56,65,-9,51
East Fife,8677,6,13,4,19,48,65,-17,43
Airdrieon,8677,7,10,12,14,47,60,-13,42
Forfar,8677,8,10,6,20,40,66,-26,36
Albion,8677,9,8,6,22,59,86,-27,30
Queen's Park,8677,10,6,10,20,40,78,-38,28
Ayr,8678,1,24,4,8,93,44,49,76
Raith,8678,2,22,8,6,68,33,35,74
Arbroath,8678,3,18,8,10,72,49,23,62
Alloa,8678,4,18,8,10,57,43,14,62
Stranraer,8678,5,16,5,15,58,66,-8,53
East Fife,8678,6,13,3,20,49,67,-18,42
Airdrieon,8678,7,10,11,15,45,60,-15,41
Forfar,8678,8,11,5,20,40,64,-24,38
Albion,8678,9,8,6,22,59,81,-22,30
Queen's Park,8678,10,6,10,20,40,74,-34,28
Raith,8679,1,23,8,5,70,32,38,77
Ayr,8679,2,24,4,8,95,42,53,76
Arbroath,8679,3,17,9,10,71,49,22,60
Alloa,8679,4,17,8,11,56,45,11,59
Stranraer,8679,5,16,5,15,56,64,-8,53
Airdrieon,8679,6,10,12,14,46,59,-13,42
East Fife,8679,7,13,3,20,47,65,-18,42
Forfar,8679,8,10,6,20,39,65,-26,36
Albion,8679,9,8,6,22,57,83,-26,30
Queen's Park,8679,10,6,11,19,40,73,-33,29
Ayr,8680,1,24,4,8,93,43,50,76
Raith,8680,2,22,8,6,68,33,35,74
Alloa,8680,3,18,8,10,57,43,14,62
Arbroath,8680,4,17,9,10,71,49,22,60
Stranraer,8680,5,15,5,16,55,65,-10,50
East Fife,8680,6,14,3,19,48,64,-16,45
Airdrieon,8680,7,10,12,14,46,59,-13,42
Forfar,8680,8,10,6,20,39,65,-26,36
Albion,8680,9,8,6,22,58,81,-23,30
Queen's Park,8680,10,6,11,19,40,73,-33,29
Raith,8681,1,23,8,5,70,33,37,77
Ayr,8681,2,24,4,8,94,45,49,76
Arbroath,8681,3,18,8,10,72,48,24,62
Alloa,8681,4,17,8,11,57,45,12,59
Stranraer,8681,5,16,5,15,59,65,-6,53
Airdrieon,8681,6,10,12,14,46,59,-13,42
East Fife,8681,7,13,3,20,48,68,-20,42
Forfar,8681,8,10,6,20,39,65,-26,36
Albion,8681,9,8,6,22,60,82,-22,30
Queen's Park,8681,10,6,10,20,39,74,-35,28
Ayr,8682,1,24,4,8,91,42,49,76
Raith,8682,2,22,9,5,69,33,36,75
Arbroath,8682,3,18,8,10,75,48,27,62
Alloa,8682,4,17,9,10,57,44,13,60
Stranraer,8682,5,15,5,16,56,66,-10,50
East Fife,8682,6,14,3,19,49,65,-16,45
Airdrieon,8682,7,10,11,15,46,60,-14,41
Forfar,8682,8,11,5,20,40,65,-25,38
Albion,8682,9,8,6,22,57,79,-22,30
Queen's Park,8682,10,6,10,20,39,77,-38,28
Raith,8683,1,23,8,5,69,32,37,77
Ayr,8683,2,23,5,8,91,43,48,74
Arbroath,8683,3,17,8,11,70,50,20,59
Alloa,8683,4,17,8,11,56,44,12,59
Stranraer,8683,5,16,5,15,57,65,-8,53
Airdrieon,8683,6,11,11,14,48,59,-11,44
East Fife,8683,7,13,3,20,48,66,-18,42
Forfar,8683,8,10,5,21,39,67,-28,35
Albion,8683,9,8,7,21,58,79,-21,31
Queen's Park,8683,10,7,10,19,41,72,-31,31
Ayr,8684,1,24,4,8,95,43,52,76
Raith,8684,2,22,9,5,69,33,36,75
Arbroath,8684,3,18,8,10,73,48,25,62
Alloa,8684,4,17,9,10,57,44,13,60
Stranraer,8684,5,15,6,15,56,65,-9,51
Airdrieon,8684,6,11,11,14,47,58,-11,44
East Fife,8684,7,13,4,19,48,65,-17,43
Forfar,8684,8,10,5,21,38,66,-28,35
Albion,8684,9,8,6,22,58,83,-25,30
Queen's Park,8684,10,6,10,20,39,75,-36,28
Raith,8685,1,23,8,5,70,33,37,77
Ayr,8685,2,24,4,8,93,43,50,76
Arbroath,8685,3,17,8,11,70,49,21,59
Alloa,8685,4,17,8,11,57,45,12,59
Stranraer,8685,5,15,6,15,58,67,-9,51
East Fife,8685,6,13,4,19,50,67,-17,43
Airdrieon,8685,7,10,12,14,46,59,-13,42
Forfar,8685,8,10,6,20,39,65,-26,36
Queen's Park,8685,9,7,10,19,40,72,-32,31
Albion,8685,10,8,6,22,58,81,-23,30
Ayr,8686,1,24,4,8,93,43,50,76
Raith,8686,2,22,8,6,68,34,34,74
Arbroath,8686,3,18,8,10,72,48,24,62
Alloa,8686,4,18,8,10,58,43,15,62
Stranraer,8686,5,15,5,16,55,65,-10,50
East Fife,8686,6,14,3,19,48,64,-16,45
Airdrieon,8686,7,11,11,14,48,58,-10,44
Forfar,8686,8,10,5,21,38,67,-29,35
Albion,8686,9,8,6,22,58,81,-23,30
Queen's Park,8686,10,6,10,20,39,74,-35,28
Raith,8687,1,23,8,5,71,33,38,77
Ayr,8687,2,24,4,8,96,43,53,76
Arbroath,8687,3,18,8,10,73,49,24,62
Alloa,8687,4,17,8,11,57,46,11,59
Stranraer,8687,5,16,5,15,57,64,-7,53
East Fife,8687,6,13,3,20,47,66,-19,42
Airdrieon,8687,7,10,11,15,46,60,-14,41
Forfar,8687,8,11,5,20,40,65,-25,38
Albion,8687,9,8,6,22,58,84,-26,30
Queen's Park,8687,10,6,10,20,40,75,-35,28
Raith,8688,1,23,8,5,70,32,38,77
Ayr,8688,2,24,4,8,97,45,52,76
Arbroath,8688,3,17,8,11,70,50,20,59
Alloa,8688,4,17,8,11,56,45,11,59
Stranraer,8688,5,16,5,15,57,65,-8,53
Airdrieon,8688,6,11,11,14,47,59,-12,44
East Fife,8688,7,13,3,20,48,66,-18,42
Forfar,8688,8,10,5,21,39,66,-27,35
Queen's Park,8688,9,7,10,19,41,72,-31,31
Albion,8688,10,8,6,22,60,85,-25,30
Raith,8689,1,23,8,5,71,32,39,77
Ayr,8689,2,24,4,8,94,43,51,76
Arbroath,8689,3,17,9,10,70,48,22,60
Alloa,8689,4,17,8,11,56,46,10,59
Stranraer,8689,5,15,5,16,57,68,-11,50
East Fife,8689,6,14,3,19,51,66,-15,45
Airdrieon,8689,7,11,11,14,47,59,-12,44
Forfar,8689,8,10,5,21,39,66,-27,35
Albion,8689,9,8,6,22,58,82,-24,30
Queen's Park,8689,10,6,11,19,39,72,-33,29
Raith,8690,1,23,8,5,69,32,37,77
Ayr,8690,2,24,4,8,97,43,54,76
Arbroath,8690,3,17,8,11,70,49,21,59
Alloa,8690,4,17,8,11,56,44,12,59
Stranraer,8690,5,15,5,16,56,66,-10,50
East Fife,8690,6,14,3,19,49,65,-16,45
Airdrieon,8690,7,10,12,14,46,59,-13,42
Forfar,8690,8,10,6,20,39,65,-26,36
Queen's Park,8690,9,7,10,19,40,72,-32,31
Albion,8690,10,8,6,22,58,85,-27,30
Raith,8691,1,23,8,5,70,32,38,77
Ayr,8691,2,24,4,8,96,42,54,76
Arbroath,8691,3,17,9,10,72,50,22,60
Alloa,8691,4,17,8,11,56,45,11,59
Stranraer,8691,5,16,5,15,58,66,-8,53
Airdrieon,8691,6,10,12,14,45,58,-13,42
East Fife,8691,7,13,3,20,49,67,-18,42
Forfar,8691,8,10,6,20,38,64,-26,36
Albion,8691,9,8,6,22,57,84,-27,30
Queen's Park,8691,10,6,11,19,41,74,-33,29
Raith,8692,1,23,8,5,73,32,41,77
Ayr,8692,2,24,4,8,94,43,51,76
Arbroath,8692,3,17,8,11,71,50,21,59
Alloa,8692,4,17,8,11,56,48,8,59
Stranraer,8692,5,15,5,16,55,66,-11,50
East Fife,8692,6,14,3,19,49,64,-15,45
Airdrieon,8692,7,10,11,15,45,60,-15,41
Forfar,8692,8,11,5,20,40,64,-24,38
Queen's Park,8692,9,7,10,19,41,73,-32,31
Albion,8692,10,8,6,22,58,82,-24,30
Ayr,8693,1,24,4,8,94,43,51,76
Raith,8693,2,22,8,6,69,34,35,74
Alloa,8693,3,18,8,10,58,44,14,62
Arbroath,8693,4,17,8,11,71,50,21,59
Stranraer,8693,5,15,5,16,57,68,-11,50
East Fife,8693,6,14,3,19,51,66,-15,45
Airdrieon,8693,7,11,11,14,46,58,-12,44
Forfar,8693,8,10,5,21,38,65,-27,35
Queen's Park,8693,9,7,10,19,41,73,-32,31
Albion,8693,10,8,6,22,58,82,-24,30
Raith,8694,1,23,8,5,73,33,40,77
Ayr,8694,2,24,4,8,97,44,53,76
Arbroath,8694,3,17,8,11,70,49,21,59
Alloa,8694,4,17,8,11,57,48,9,59
Stranraer,8694,5,15,6,15,57,66,-9,51
East Fife,8694,6,13,4,19,49,66,-17,43
Airdrieon,8694,7,10,12,14,46,59,-13,42
Forfar,8694,8,10,6,20,39,65,-26,36
Queen's Park,8694,9,7,10,19,40,72,-32,31
Albion,8694,10,8,6,22,59,85,-26,30
Ayr,8695,1,24,4,8,95,45,50,76
Raith,8695,2,22,9,5,68,32,36,75
Arbroath,8695,3,18,8,10,72,48,24,62
Alloa,8695,4,17,9,10,56,43,13,60
Stranraer,8695,5,16,5,15,57,64,-7,53
Airdrieon,8695,6,11,11,14,48,60,-12,44
East Fife,8695,7,13,3,20,47,66,-19,42
Forfar,8695,8,10,5,21,40,67,-27,35
Albion,8695,9,8,6,22,60,83,-23,30
Queen's Park,8695,10,6,10,20,39,74,-35,28
Raith,8696,1,23,8,5,70,33,37,77
Ayr,8696,2,24,4,8,95,45,50,76
Arbroath,8696,3,18,8,10,73,48,25,62
Alloa,8696,4,17,8,11,57,45,12,59
Stranraer,8696,5,16,5,15,57,64,-7,53
Airdrieon,8696,6,11,11,14,48,58,-10,44
East Fife,8696,7,13,3,20,47,66,-19,42
Forfar,8696,8,10,5,21,38,67,-29,35
Albion,8696,9,8,6,22,60,83,-23,30
Queen's Park,8696,10,6,10,20,39,75,-36,28
Raith,8697,1,23,8,5,73,32,41,77
Ayr,8697,2,24,4,8,92,43,49,76
Arbroath,8697,3,17,9,10,71,49,22,60
Alloa,8697,4,17,8,11,56,48,8,59
Stranraer,8697,5,15,5,16,55,66,-11,50
East Fife,8697,6,14,3,19,49,64,-15,45
Airdrieon,8697,7,10,11,15,46,60,-14,41
Forfar,8697,8,11,5,20,40,65,-25,38
Albion,8697,9,8,6,22,58,80,-22,30
Queen's Park,8697,10,6,11,19,40,73,-33,29
Raith,8698,1,23,8,5,69,32,37,77
Ayr,8698,2,24,4,8,93,43,50,76
Arbroath,8698,3,17,8,11,72,51,21,59
Alloa,8698,4,17,8,11,56,44,12,59
Stranraer,8698,5,16,5,15,58,66,-8,53
Airdrieon,8698,6,11,11,14,47,59,-12,44
East Fife,8698,7,13,3,20,49,67,-18,42
Forfar,8698,8,10,5,21,39,66,-27,35
Queen's Park,8698,9,7,10,19,42,74,-32,31
Albion,8698,10,8,6,22,58,81,-23,30
Raith,8699,1,23,8,5,69,32,37,77
Ayr,8699,2,24,4,8,94,43,51,76
Arbroath,8699,3,18,8,10,72,49,23,62
Alloa,8699,4,17,8,11,56,44,12,59
Stranraer,8699,5,16,5,15,59,66,-7,53
Airdrieon,8699,6,11,11,14,47,58,-11,44
East Fife,8699,7,13,3,20,49,68,-19,42
Forfar,8699,8,10,5,21,38,66,-28,35
Albion,8699,9,8,6,22,58,82,-24,30
Queen's Park,8699,10,6,10,20,40,74,-34,28
Ayr,8700,1,24,4,8,92,42,50,76
Raith,8700,2,22,8,6,68,33,35,74
Alloa,8700,3,18,8,10,57,43,14,62
Arbroath,8700,4,17,9,10,72,50,22,60
Stranraer,8700,5,15,5,16,55,65,-10,50
East Fife,8700,6,14,3,19,48,64,-16,45
Airdrieon,8700,7,10,12,14,45,58,-13,42
Forfar,8700,8,10,6,20,38,64,-26,36
Albion,8700,9,8,6,22,57,80,-23,30
Queen's Park,8700,10,6,11,19,41,74,-33,29
Ayr,8701,1,24,4,8,98,42,56,76
Raith,8701,2,22,9,5,68,32,36,75
Alloa,8701,3,17,9,10,56,43,13,60
Arbroath,8701,4,17,8,11,71,50,21,59
Stranraer,8701,5,16,5,15,56,64,-8,53
Airdrieon,8701,6,10,12,14,48,61,-13,42
East Fife,8701,7,13,3,20,47,65,-18,42
Forfar,8701,8,10,6,20,41,67,-26,36
Queen's Park,8701,9,7,10,19,41,73,-32,31
Albion,8701,10,8,6,22,57,86,-29,30
Ayr,8702,1,24,4,8,93,44,49,76
Raith,8702,2,22,8,6,69,34,35,74
Arbroath,8702,3,18,8,10,73,49,24,62
Alloa,8702,4,18,8,10,58,44,14,62
Stranraer,8702,5,15,5,16,55,65,-10,50
East Fife,8702,6,14,3,19,48,64,-16,45
Airdrieon,8702,7,10,12,14,46,59,-13,42
Forfar,8702,8,10,6,20,39,65,-26,36
Albion,8702,9,8,6,22,59,81,-22,30
Queen's Park,8702,10,6,10,20,40,75,-35,28
Raith,8703,1,23,8,5,70,33,37,77
Ayr,8703,2,23,5,8,91,43,48,74
Arbroath,8703,3,17,9,10,71,49,22,60
Alloa,8703,4,17,8,11,57,45,12,59
Stranraer,8703,5,16,5,15,59,67,-8,53
Airdrieon,8703,6,11,11,14,46,58,-12,44
East Fife,8703,7,13,3,20,50,68,-18,42
Forfar,8703,8,10,5,21,38,65,-27,35
Albion,8703,9,8,7,21,58,79,-21,31
Queen's Park,8703,10,6,11,19,40,73,-33,29
Ayr,8704,1,24,4,8,97,42,55,76
Raith,8704,2,22,8,6,70,35,35,74
Arbroath,8704,3,18,8,10,71,48,23,62
Alloa,8704,4,18,8,10,59,45,14,62
Stranraer,8704,5,15,5,16,56,66,-10,50
East Fife,8704,6,14,3,19,49,65,-16,45
Airdrieon,8704,7,10,11,15,45,60,-15,41
Forfar,8704,8,11,5,20,40,64,-24,38
Albion,8704,9,8,6,22,57,85,-28,30
Queen's Park,8704,10,6,10,20,39,73,-34,28
Ayr,8705,1,24,4,8,93,42,51,76
Raith,8705,2,22,9,5,69,33,36,75
Arbroath,8705,3,18,8,10,72,48,24,62
Alloa,8705,4,17,9,10,57,44,13,60
Stranraer,8705,5,15,6,15,56,65,-9,51
East Fife,8705,6,13,4,19,48,65,-17,43
Airdrieon,8705,7,10,12,14,46,59,-13,42
Forfar,8705,8,10,6,20,39,65,-26,36
Albion,8705,9,8,6,22,57,81,-24,30
Queen's Park,8705,10,6,10,20,39,74,-35,28
Ayr,8706,1,24,4,8,91,42,49,76
Raith,8706,2,22,8,6,69,34,35,74
Arbroath,8706,3,18,8,10,74,49,25,62
Alloa,8706,4,18,8,10,58,44,14,62
Stranraer,8706,5,15,5,16,55,68,-13,50
East Fife,8706,6,14,3,19,51,64,-13,45
Airdrieon,8706,7,11,11,14,48,58,-10,44
Forfar,8706,8,10,5,21,38,67,-29,35
Albion,8706,9,8,6,22,57,79,-22,30
Queen's Park,8706,10,6,10,20,40,76,-36,28
Raith,8707,1,23,8,5,71,32,39,77
Ayr,8707,2,24,4,8,95,42,53,76
Arbroath,8707,3,18,8,10,72,49,23,62
Alloa,8707,4,17,8,11,56,46,10,59
Stranraer,8707,5,15,6,15,59,68,-9,51
East Fife,8707,6,13,4,19,51,68,-17,43
Airdrieon,8707,7,10,12,14,47,60,-13,42
Forfar,8707,8,10,6,20,40,66,-26,36
Albion,8707,9,8,6,22,57,83,-26,30
Queen's Park,8707,10,6,10,20,40,74,-34,28
Raith,8708,1,23,8,5,72,33,39,77
Ayr,8708,2,24,4,8,98,42,56,76
Arbroath,8708,3,17,9,10,71,49,22,60
Alloa,8708,4,17,8,11,57,47,10,59
Stranraer,8708,5,15,6,15,55,64,-9,51
Airdrieon,8708,6,11,11,14,48,59,-11,44
East Fife,8708,7,13,4,19,47,64,-17,43
Forfar,8708,8,10,5,21,39,67,-28,35
Albion,8708,9,8,6,22,57,86,-29,30
Queen's Park,8708,10,6,11,19,40,73,-33,29
Raith,8709,1,23,8,5,72,34,38,77
Ayr,8709,2,24,4,8,95,43,52,76
Arbroath,8709,3,17,8,11,71,51,20,59
Alloa,8709,4,17,8,11,58,47,11,59
Stranraer,8709,5,15,6,15,55,64,-9,51
East Fife,8709,6,13,4,19,47,64,-17,43
Airdrieon,8709,7,10,11,15,45,60,-15,41
Forfar,8709,8,11,5,20,40,64,-24,38
Queen's Park,8709,9,7,10,19,42,73,-31,31
Albion,8709,10,8,6,22,58,83,-25,30
Ayr,8710,1,24,4,8,94,43,51,76
Raith,8710,2,22,8,6,69,35,34,74
Arbroath,8710,3,18,8,10,74,48,26,62
Alloa,8710,4,18,8,10,59,44,15,62
Stranraer,8710,5,15,6,15,56,65,-9,51
East Fife,8710,6,13,4,19,48,65,-17,43
Airdrieon,8710,7,10,11,15,47,61,-14,41
Forfar,8710,8,11,5,20,41,66,-25,38
Albion,8710,9,8,6,22,58,82,-24,30
Queen's Park,8710,10,6,10,20,39,76,-37,28
Raith,8711,1,23,8,5,71,33,38,77
Ayr,8711,2,23,4,9,92,45,47,73
Arbroath,8711,3,18,8,10,73,49,24,62
Alloa,8711,4,17,8,11,57,46,11,59
Stranraer,8711,5,15,5,16,59,69,-10,50
East Fife,8711,6,14,3,19,52,68,-16,45
Airdrieon,8711,7,10,11,15,45,59,-14,41
Forfar,8711,8,11,5,20,39,64,-25,38
Albion,8711,9,9,6,21,60,80,-20,33
Queen's Park,8711,10,6,10,20,40,75,-35,28
Raith,8712,1,23,8,5,71,33,38,77
Ayr,8712,2,24,4,8,94,44,50,76
Arbroath,8712,3,17,8,11,71,50,21,59
Alloa,8712,4,17,8,11,57,46,11,59
Stranraer,8712,5,15,5,16,55,65,-10,50
East Fife,8712,6,14,3,19,48,64,-16,45
Airdrieon,8712,7,11,11,14,46,58,-12,44
Forfar,8712,8,10,5,21,38,65,-27,35
Queen's Park,8712,9,7,10,19,41,73,-32,31
Albion,8712,10,8,6,22,59,82,-23,30
Raith,8713,1,23,8,5,72,32,40,77
Ayr,8713,2,24,4,8,94,43,51,76
Arbroath,8713,3,17,8,11,70,49,21,59
Alloa,8713,4,17,8,11,56,47,9,59
Stranraer,8713,5,16,5,15,57,64,-7,53
Airdrieon,8713,6,11,11,14,48,59,-11,44
East Fife,8713,7,13,3,20,47,66,-19,42
Forfar,8713,8,10,5,21,39,67,-28,35
Queen's Park,8713,9,7,10,19,40,72,-32,31
Albion,8713,10,8,6,22,58,82,-24,30
Raith,8714,1,23,8,5,69,32,37,77
Ayr,8714,2,23,4,9,91,45,46,73
Arbroath,8714,3,17,9,10,70,48,22,60
Alloa,8714,4,17,8,11,56,44,12,59
Stranraer,8714,5,16,5,15,57,64,-7,53
Airdrieon,8714,6,11,11,14,48,58,-10,44
East Fife,8714,7,13,3,20,47,66,-19,42
Forfar,8714,8,10,5,21,38,67,-29,35
Albion,8714,9,9,6,21,60,79,-19,33
Queen's Park,8714,10,6,11,19,39,72,-33,29
Raith,8715,1,23,8,5,70,33,37,77
Ayr,8715,2,23,5,8,92,44,48,74
Arbroath,8715,3,18,8,10,73,48,25,62
Alloa,8715,4,17,8,11,57,45,12,59
Stranraer,8715,5,15,5,16,56,67,-11,50
East Fife,8715,6,14,3,19,50,65,-15,45
Airdrieon,8715,7,10,11,15,46,60,-14,41
Forfar,8715,8,11,5,20,40,65,-25,38
Albion,8715,9,8,7,21,59,80,-21,31
Queen's Park,8715,10,6,10,20,39,75,-36,28
Raith,8716,1,23,8,5,75,33,42,77
Ayr,8716,2,24,4,8,93,43,50,76
Arbroath,8716,3,17,8,11,71,50,21,59
Alloa,8716,4,17,8,11,57,50,7,59
Stranraer,8716,5,15,5,16,55,67,-12,50
East Fife,8716,6,14,3,19,50,64,-14,45
Airdrieon,8716,7,11,11,14,46,58,-12,44
Forfar,8716,8,10,5,21,38,65,-27,35
Queen's Park,8716,9,7,10,19,41,73,-32,31
Albion,8716,10,8,6,22,58,81,-23,30
Raith,8717,1,23,8,5,69,32,37,77
Ayr,8717,2,24,4,8,92,43,49,76
Arbroath,8717,3,17,9,10,75,53,22,60
Alloa,8717,4,17,8,11,56,44,12,59
Stranraer,8717,5,15,5,16,56,66,-10,50
East Fife,8717,6,14,3,19,49,65,-16,45
Airdrieon,8717,7,10,12,14,46,59,-13,42
Forfar,8717,8,10,6,20,39,65,-26,36
Albion,8717,9,8,6,22,58,80,-22,30
Queen's Park,8717,10,6,11,19,44,77,-33,29
Raith,8718,1,23,8,5,69,32,37,77
Ayr,8718,2,24,4,8,94,43,51,76
Arbroath,8718,3,18,8,10,73,48,25,62
Alloa,8718,4,17,8,11,56,44,12,59
Stranraer,8718,5,16,5,15,57,64,-7,53
Airdrieon,8718,6,11,11,14,49,58,-9,44
East Fife,8718,7,13,3,20,47,66,-19,42
Forfar,8718,8,10,5,21,38,68,-30,35
Albion,8718,9,8,6,22,58,82,-24,30
Queen's Park,8718,10,6,10,20,39,75,-36,28
Ayr,8719,1,24,4,8,96,43,53,76
Raith,8719,2,22,9,5,70,34,36,75
Arbroath,8719,3,17,9,10,71,49,22,60
Alloa,8719,4,17,9,10,58,45,13,60
Stranraer,8719,5,15,5,16,55,65,-10,50
East Fife,8719,6,14,3,19,48,64,-16,45
Airdrieon,8719,7,11,11,14,48,60,-12,44
Forfar,8719,8,10,5,21,40,67,-27,35
Albion,8719,9,8,6,22,58,84,-26,30
Queen's Park,8719,10,6,11,19,40,73,-33,29
Ayr,8720,1,24,4,8,93,44,49,76
Raith,8720,2,22,8,6,69,34,35,74
Alloa,8720,3,18,8,10,58,44,14,62
Arbroath,8720,4,17,8,11,71,50,21,59
Stranraer,8720,5,15,6,15,57,66,-9,51
East Fife,8720,6,13,4,19,49,66,-17,43
Airdrieon,8720,7,10,12,14,45,58,-13,42
Forfar,8720,8,10,6,20,38,64,-26,36
Queen's Park,8720,9,7,10,19,41,73,-32,31
Albion,8720,10,8,6,22,59,81,-22,30
Ayr,8721,1,24,4,8,94,43,51,76
Raith,8721,2,22,9,5,69,33,36,75
Alloa,8721,3,17,9,10,57,44,13,60
Arbroath,8721,4,17,8,11,71,51,20,59
Stranraer,8721,5,15,6,15,58,67,-9,51
Airdrieon,8721,6,11,11,14,47,59,-12,44
East Fife,8721,7,13,4,19,50,67,-17,43
Forfar,8721,8,10,5,21,39,66,-27,35
Queen's Park,8721,9,7,10,19,42,73,-31,31
Albion,8721,10,8,6,22,58,82,-24,30
Raith,8722,1,23,8,5,69,32,37,77
Ayr,8722,2,23,5,8,91,43,48,74
Arbroath,8722,3,18,8,10,71,48,23,62
Alloa,8722,4,17,8,11,56,44,12,59
Stranraer,8722,5,15,5,16,57,67,-10,50
East Fife,8722,6,14,3,19,50,66,-16,45
Airdrieon,8722,7,11,11,14,49,61,-12,44
Forfar,8722,8,10,5,21,41,68,-27,35
Albion,8722,9,8,7,21,58,79,-21,31
Queen's Park,8722,10,6,10,20,39,73,-34,28
Ayr,8723,1,24,4,8,92,42,50,76
Raith,8723,2,22,8,6,70,35,35,74
Alloa,8723,3,18,8,10,59,45,14,62
Arbroath,8723,4,17,8,11,71,51,20,59
Stranraer,8723,5,15,5,16,55,67,-12,50
East Fife,8723,6,14,3,19,50,64,-14,45
Airdrieon,8723,7,10,11,15,45,60,-15,41
Forfar,8723,8,11,5,20,40,64,-24,38
Queen's Park,8723,9,7,10,19,42,73,-31,31
Albion,8723,10,8,6,22,57,80,-23,30
Raith,8724,1,22,9,5,69,33,36,75
Ayr,8724,2,23,5,8,93,45,48,74
Arbroath,8724,3,18,8,10,75,50,25,62
Alloa,8724,4,17,9,10,57,44,13,60
Stranraer,8724,5,15,5,16,55,65,-10,50
East Fife,8724,6,14,3,19,48,64,-16,45
Airdrieon,8724,7,11,11,14,47,59,-12,44
Forfar,8724,8,10,5,21,39,66,-27,35
Albion,8724,9,8,7,21,60,81,-21,31
Queen's Park,8724,10,6,10,20,41,77,-36,28
Ayr,8725,1,24,4,8,94,44,50,76
Raith,8725,2,22,9,5,69,33,36,75
Arbroath,8725,3,17,9,10,71,49,22,60
Alloa,8725,4,17,9,10,57,44,13,60
Stranraer,8725,5,15,5,16,55,66,-11,50
East Fife,8725,6,14,3,19,49,64,-15,45
Airdrieon,8725,7,11,11,14,46,58,-12,44
Forfar,8725,8,10,5,21,38,65,-27,35
Albion,8725,9,8,6,22,59,82,-23,30
Queen's Park,8725,10,6,11,19,40,73,-33,29
Ayr,8726,1,24,4,8,96,44,52,76
Raith,8726,2,22,9,5,69,33,36,75
Arbroath,8726,3,18,8,10,74,49,25,62
Alloa,8726,4,17,9,10,57,44,13,60
Stranraer,8726,5,15,5,16,56,67,-11,50
East Fife,8726,6,14,3,19,50,65,-15,45
Airdrieon,8726,7,10,12,14,47,60,-13,42
Forfar,8726,8,10,6,20,40,66,-26,36
Albion,8726,9,8,6,22,59,84,-25,30
Queen's Park,8726,10,6,10,20,40,76,-36,28
Raith,8727,1,22,8,6,68,33,35,74
Ayr,8727,2,23,4,9,92,45,47,73
Arbroath,8727,3,18,8,10,73,49,24,62
Alloa,8727,4,18,8,10,57,43,14,62
Stranraer,8727,5,15,5,16,55,66,-11,50
East Fife,8727,6,14,3,19,49,64,-15,45
Airdrieon,8727,7,10,11,15,45,59,-14,41
Forfar,8727,8,11,5,20,39,64,-25,38
Albion,8727,9,9,6,21,60,80,-20,33
Queen's Park,8727,10,6,10,20,40,75,-35,28
Raith,8728,1,22,9,5,69,33,36,75
Ayr,8728,2,23,4,9,91,45,46,73
Arbroath,8728,3,18,8,10,73,48,25,62
Alloa,8728,4,17,9,10,57,44,13,60
Stranraer,8728,5,15,6,15,56,65,-9,51
East Fife,8728,6,13,4,19,48,65,-17,43
Airdrieon,8728,7,10,12,14,47,60,-13,42
Forfar,8728,8,10,6,20,40,66,-26,36
Albion,8728,9,9,6,21,60,79,-19,33
Queen's Park,8728,10,6,10,20,39,75,-36,28
Ayr,8729,1,24,4,8,95,43,52,76
Raith,8729,2,22,8,6,68,33,35,74
Alloa,8729,3,18,8,10,57,43,14,62
Arbroath,8729,4,17,8,11,71,51,20,59
Stranraer,8729,5,15,5,16,55,69,-14,50
East Fife,8729,6,14,3,19,52,64,-12,45
Airdrieon,8729,7,10,12,14,46,59,-13,42
Forfar,8729,8,10,6,20,39,65,-26,36
Queen's Park,8729,9,7,10,19,42,73,-31,31
Albion,8729,10,8,6,22,58,83,-25,30
Raith,8730,1,22,9,5,70,34,36,75
Ayr,8730,2,23,5,8,92,44,48,74
Alloa,8730,3,17,9,10,58,45,13,60
Arbroath,8730,4,17,8,11,71,50,21,59
Stranraer,8730,5,15,6,15,57,66,-9,51
Airdrieon,8730,6,11,11,14,48,59,-11,44
East Fife,8730,7,13,4,19,49,66,-17,43
Forfar,8730,8,10,5,21,39,67,-28,35
Albion,8730,9,8,7,21,59,80,-21,31
Queen's Park,8730,10,7,10,19,41,73,-32,31
Raith,8731,1,23,8,5,70,33,37,77
Ayr,8731,2,24,4,8,94,42,52,76
Arbroath,8731,3,17,8,11,70,51,19,59
Alloa,8731,4,17,8,11,57,45,12,59
Stranraer,8731,5,16,5,15,56,64,-8,53
Airdrieon,8731,6,10,12,14,46,59,-13,42
East Fife,8731,7,13,3,20,47,65,-18,42
Forfar,8731,8,10,6,20,39,65,-26,36
Queen's Park,8731,9,7,10,19,42,72,-30,31
Albion,8731,10,8,6,22,57,82,-25,30
Raith,8732,1,23,8,5,71,32,39,77
Ayr,8732,2,24,4,8,93,42,51,76
Arbroath,8732,3,18,8,10,73,49,24,62
Alloa,8732,4,17,8,11,56,46,10,59
Stranraer,8732,5,15,6,15,58,67,-9,51
Airdrieon,8732,6,11,11,14,49,58,-9,44
East Fife,8732,7,13,4,19,50,67,-17,43
Forfar,8732,8,10,5,21,38,68,-30,35
Albion,8732,9,8,6,22,57,81,-24,30
Queen's Park,8732,10,6,10,20,40,75,-35,28
Raith,8733,1,23,8,5,69,32,37,77
Ayr,8733,2,24,4,8,93,44,49,76
Arbroath,8733,3,17,9,10,72,50,22,60
Alloa,8733,4,17,8,11,56,44,12,59
Stranraer,8733,5,15,6,15,56,65,-9,51
East Fife,8733,6,13,4,19,48,65,-17,43
Airdrieon,8733,7,10,12,14,46,59,-13,42
Forfar,8733,8,10,6,20,39,65,-26,36
Albion,8733,9,8,6,22,59,81,-22,30
Queen's Park,8733,10,6,11,19,41,74,-33,29
Raith,8734,1,23,8,5,69,32,37,77
Ayr,8734,2,24,4,8,92,42,50,76
Arbroath,8734,3,18,8,10,72,49,23,62
Alloa,8734,4,17,8,11,56,44,12,59
Stranraer,8734,5,15,6,15,56,65,-9,51
Airdrieon,8734,6,11,11,14,47,58,-11,44
East Fife,8734,7,13,4,19,48,65,-17,43
Forfar,8734,8,10,5,21,38,66,-28,35
Albion,8734,9,8,6,22,57,80,-23,30
Queen's Park,8734,10,6,10,20,40,74,-34,28
Raith,8735,1,23,8,5,69,32,37,77
Ayr,8735,2,23,4,9,90,44,46,73
Arbroath,8735,3,17,9,10,72,50,22,60
Alloa,8735,4,17,8,11,56,44,12,59
Stranraer,8735,5,15,5,16,55,66,-11,50
East Fife,8735,6,14,3,19,49,64,-15,45
Airdrieon,8735,7,11,11,14,46,58,-12,44
Forfar,8735,8,10,5,21,38,65,-27,35
Albion,8735,9,9,6,21,59,78,-19,33
Queen's Park,8735,10,6,11,19,41,74,-33,29
Raith,8736,1,23,8,5,69,32,37,77
Ayr,8736,2,24,4,8,92,43,49,76
Arbroath,8736,3,18,8,10,73,50,23,62
Alloa,8736,4,17,8,11,56,44,12,59
Stranraer,8736,5,15,6,15,56,65,-9,51
East Fife,8736,6,13,4,19,48,65,-17,43
Airdrieon,8736,7,10,12,14,45,58,-13,42
Forfar,8736,8,10,6,20,38,64,-26,36
Albion,8736,9,8,6,22,58,80,-22,30
Queen's Park,8736,10,6,10,20,41,75,-34,28
Ayr,8737,1,23,5,8,91,43,48,74
Raith,8737,2,22,8,6,69,36,33,74
Alloa,8737,3,18,8,10,60,44,16,62
Arbroath,8737,4,17,9,10,71,49,22,60
Stranraer,8737,5,15,5,16,56,66,-10,50
East Fife,8737,6,14,3,19,49,65,-16,45
Airdrieon,8737,7,11,11,14,46,58,-12,44
Forfar,8737,8,10,5,21,38,65,-27,35
Albion,8737,9,8,7,21,58,79,-21,31
Queen's Park,8737,10,6,11,19,40,73,-33,29
Raith,8738,1,23,8,5,70,33,37,77
Ayr,8738,2,24,4,8,94,43,51,76
Arbroath,8738,3,17,9,10,71,49,22,60
Alloa,8738,4,17,8,11,57,45,12,59
Stranraer,8738,5,16,5,15,57,65,-8,53
Airdrieon,8738,6,10,12,14,45,58,-13,42
East Fife,8738,7,13,3,20,48,66,-18,42
Forfar,8738,8,10,6,20,38,64,-26,36
Albion,8738,9,8,6,22,58,82,-24,30
Queen's Park,8738,10,6,11,19,40,73,-33,29
Raith,8739,1,22,9,5,71,35,36,75
Ayr,8739,2,23,4,9,91,44,47,73
Arbroath,8739,3,17,9,10,70,48,22,60
Alloa,8739,4,17,9,10,59,46,13,60
Stranraer,8739,5,15,5,16,55,65,-10,50
East Fife,8739,6,14,3,19,48,64,-16,45
Airdrieon,8739,7,11,11,14,46,58,-12,44
Forfar,8739,8,10,5,21,38,65,-27,35
Albion,8739,9,9,6,21,59,79,-20,33
Queen's Park,8739,10,6,11,19,39,72,-33,29
Ayr,8740,1,24,4,8,93,42,51,76
Raith,8740,2,22,8,6,69,35,34,74
Alloa,8740,3,18,8,10,59,44,15,62
Arbroath,8740,4,17,9,10,70,48,22,60
Stranraer,8740,5,15,5,16,56,66,-10,50
East Fife,8740,6,14,3,19,49,65,-16,45
Airdrieon,8740,7,11,11,14,48,58,-10,44
Forfar,8740,8,10,5,21,38,67,-29,35
Albion,8740,9,8,6,22,57,81,-24,30
Queen's Park,8740,10,6,11,19,39,72,-33,29
Ayr,8741,1,24,4,8,97,42,55,76
Raith,8741,2,22,9,5,70,34,36,75
Arbroath,8741,3,18,8,10,72,48,24,62
Alloa,8741,4,17,9,10,58,45,13,60
Stranraer,8741,5,15,5,16,55,66,-11,50
East Fife,8741,6,14,3,19,49,64,-15,45
Airdrieon,8741,7,10,11,15,45,59,-14,41
Forfar,8741,8,11,5,20,39,64,-25,38
Albion,8741,9,8,6,22,57,85,-28,30
Queen's Park,8741,10,6,10,20,39,74,-35,28
Ayr,8742,1,24,4,8,93,44,49,76
Raith,8742,2,22,8,6,70,35,35,74
Alloa,8742,3,18,8,10,59,45,14,62
Arbroath,8742,4,17,8,11,71,51,20,59
Stranraer,8742,5,15,5,16,56,66,-10,50
East Fife,8742,6,14,3,19,49,65,-16,45
Airdrieon,8742,7,11,11,14,48,58,-10,44
Forfar,8742,8,10,5,21,38,67,-29,35
Queen's Park,8742,9,7,10,19,42,73,-31,31
Albion,8742,10,8,6,22,59,81,-22,30
Ayr,8743,1,24,4,8,94,43,51,76
Raith,8743,2,22,8,6,69,34,35,74
Alloa,8743,3,18,8,10,58,44,14,62
Arbroath,8743,4,17,9,10,71,49,22,60
Stranraer,8743,5,15,5,16,55,69,-14,50
East Fife,8743,6,14,3,19,52,64,-12,45
Airdrieon,8743,7,10,12,14,45,58,-13,42
Forfar,8743,8,10,6,20,38,64,-26,36
Albion,8743,9,8,6,22,58,82,-24,30
Queen's Park,8743,10,6,11,19,40,73,-33,29
Ayr,8744,1,23,5,8,90,42,48,74
Raith,8744,2,22,8,6,68,33,35,74
Arbroath,8744,3,18,8,10,73,48,25,62
Alloa,8744,4,18,8,10,57,43,14,62
Stranraer,8744,5,15,6,15,56,65,-9,51
Airdrieon,8744,6,11,11,14,47,59,-12,44
East Fife,8744,7,13,4,19,48,65,-17,43
Forfar,8744,8,10,5,21,39,66,-27,35
Albion,8744,9,8,7,21,57,78,-21,31
Queen's Park,8744,10,6,10,20,39,75,-36,28
Ayr,8745,1,23,5,8,92,44,48,74
Raith,8745,2,22,8,6,68,33,35,74
Arbroath,8745,3,18,8,10,72,49,23,62
Alloa,8745,4,18,8,10,57,43,14,62
Stranraer,8745,5,15,5,16,55,65,-10,50
East Fife,8745,6,14,3,19,48,64,-16,45
Airdrieon,8745,7,10,12,14,46,59,-13,42
Forfar,8745,8,10,6,20,39,65,-26,36
Albion,8745,9,8,7,21,59,80,-21,31
Queen's Park,8745,10,6,10,20,40,74,-34,28
Raith,8746,1,22,8,6,68,33,35,74
Ayr,8746,2,23,4,9,92,45,47,73
Alloa,8746,3,18,8,10,57,43,14,62
Arbroath,8746,4,17,9,10,70,48,22,60
Stranraer,8746,5,15,5,16,56,66,-10,50
East Fife,8746,6,14,3,19,49,65,-16,45
Airdrieon,8746,7,10,12,14,45,58,-13,42
Forfar,8746,8,10,6,20,38,64,-26,36
Albion,8746,9,9,6,21,60,80,-20,33
Queen's Park,8746,10,6,11,19,39,72,-33,29
Raith,8747,1,23,8,5,70,33,37,77
Ayr,8747,2,24,4,8,93,43,50,76
Arbroath,8747,3,18,8,10,72,49,23,62
Alloa,8747,4,17,8,11,57,45,12,59
Stranraer,8747,5,15,5,16,55,66,-11,50
East Fife,8747,6,14,3,19,49,64,-15,45
Airdrieon,8747,7,11,11,14,47,59,-12,44
Forfar,8747,8,10,5,21,39,66,-27,35
Albion,8747,9,8,6,22,58,81,-23,30
Queen's Park,8747,10,6,10,20,40,74,-34,28
Ayr,8748,1,24,4,8,96,44,52,76
Raith,8748,2,22,8,6,69,34,35,74
Alloa,8748,3,18,8,10,58,44,14,62
Arbroath,8748,4,17,9,10,71,49,22,60
Stranraer,8748,5,16,5,15,57,64,-7,53
Airdrieon,8748,6,11,11,14,46,58,-12,44
East Fife,8748,7,13,3,20,47,66,-19,42
Forfar,8748,8,10,5,21,38,65,-27,35
Albion,8748,9,8,6,22,59,84,-25,30
Queen's Park,8748,10,6,11,19,40,73,-33,29
Raith,8749,1,23,8,5,69,32,37,77
Ayr,8749,2,23,5,8,93,45,48,74
Arbroath,8749,3,17,8,11,70,49,21,59
Alloa,8749,4,17,8,11,56,44,12,59
Stranraer,8749,5,15,5,16,55,67,-12,50
East Fife,8749,6,14,3,19,50,64,-14,45
Airdrieon,8749,7,11,11,14,48,59,-11,44
Forfar,8749,8,10,5,21,39,67,-28,35
Albion,8749,9,8,7,21,60,81,-21,31
Queen's Park,8749,10,7,10,19,40,72,-32,31
Raith,8750,1,23,8,5,69,32,37,77
Ayr,8750,2,24,4,8,92,43,49,76
Arbroath,8750,3,18,8,10,73,49,24,62
Alloa,8750,4,17,8,11,56,44,12,59
Stranraer,8750,5,15,6,15,55,64,-9,51
Airdrieon,8750,6,11,11,14,47,59,-12,44
East Fife,8750,7,13,4,19,47,64,-17,43
Forfar,8750,8,10,5,21,39,66,-27,35
Albion,8750,9,8,6,22,58,80,-22,30
Queen's Park,8750,10,6,10,20,40,75,-35,28
Ayr,8751,1,24,4,8,98,43,55,76
Raith,8751,2,22,9,5,69,33,36,75
Arbroath,8751,3,18,8,10,76,51,25,62
Alloa,8751,4,17,9,10,57,44,13,60
Stranraer,8751,5,15,5,16,56,67,-11,50
East Fife,8751,6,14,3,19,50,65,-15,45
Airdrieon,8751,7,11,11,14,48,58,-10,44
Forfar,8751,8,10,5,21,38,67,-29,35
Albion,8751,9,8,6,22,58,86,-28,30
Queen's Park,8751,10,6,10,20,42,78,-36,28
Raith,8752,1,23,8,5,70,32,38,77
Ayr,8752,2,23,5,8,92,44,48,74
Arbroath,8752,3,17,9,10,71,49,22,60
Alloa,8752,4,17,8,11,56,45,11,59
Stranraer,8752,5,15,6,15,57,66,-9,51
Airdrieon,8752,6,11,11,14,47,59,-12,44
East Fife,8752,7,13,4,19,49,66,-17,43
Forfar,8752,8,10,5,21,39,66,-27,35
Albion,8752,9,8,7,21,59,80,-21,31
Queen's Park,8752,10,6,11,19,40,73,-33,29
Raith,8753,1,23,8,5,70,33,37,77
Ayr,8753,2,24,4,8,97,43,54,76
Arbroath,8753,3,17,8,11,70,51,19,59
Alloa,8753,4,17,8,11,57,45,12,59
Stranraer,8753,5,15,6,15,57,66,-9,51
Airdrieon,8753,6,11,11,14,47,58,-11,44
East Fife,8753,7,13,4,19,49,66,-17,43
Forfar,8753,8,10,5,21,38,66,-28,35
Queen's Park,8753,9,7,10,19,42,72,-30,31
Albion,8753,10,8,6,22,58,85,-27,30
Raith,8754,1,23,8,5,69,32,37,77
Ayr,8754,2,24,4,8,94,45,49,76
Arbroath,8754,3,17,9,10,72,50,22,60
Alloa,8754,4,17,8,11,56,44,12,59
Stranraer,8754,5,15,5,16,55,66,-11,50
East Fife,8754,6,14,3,19,49,64,-15,45
Airdrieon,8754,7,10,12,14,46,59,-13,42
Forfar,8754,8,10,6,20,39,65,-26,36
Albion,8754,9,8,6,22,60,82,-22,30
Queen's Park,8754,10,6,11,19,41,74,-33,29
Raith,8755,1,22,8,6,69,35,34,74
Ayr,8755,2,23,4,9,91,44,47,73
Alloa,8755,3,18,8,10,59,44,15,62
Arbroath,8755,4,17,8,11,71,52,19,59
Stranraer,8755,5,16,5,15,58,66,-8,53
Airdrieon,8755,6,11,11,14,46,58,-12,44
East Fife,8755,7,13,3,20,49,67,-18,42
Forfar,8755,8,10,5,21,38,65,-27,35
Albion,8755,9,9,6,21,59,79,-20,33
Queen's Park,8755,10,7,10,19,43,73,-30,31
Ayr,8756,1,24,4,8,93,43,50,76
Raith,8756,2,22,8,6,68,33,35,74
Arbroath,8756,3,18,8,10,73,49,24,62
Alloa,8756,4,18,8,10,57,43,14,62
Stranraer,8756,5,16,5,15,61,65,-4,53
Airdrieon,8756,6,11,11,14,47,58,-11,44
East Fife,8756,7,13,3,20,48,70,-22,42
Forfar,8756,8,10,5,21,38,66,-28,35
Albion,8756,9,8,6,22,58,81,-23,30
Queen's Park,8756,10,6,10,20,40,75,-35,28
Ayr,8757,1,24,4,8,96,43,53,76
Raith,8757,2,22,8,6,69,34,35,74
Arbroath,8757,3,18,8,10,74,48,26,62
Alloa,8757,4,18,8,10,58,44,14,62
Stranraer,8757,5,15,5,16,57,67,-10,50
East Fife,8757,6,14,3,19,50,66,-16,45
Airdrieon,8757,7,10,11,15,47,61,-14,41
Forfar,8757,8,11,5,20,41,66,-25,38
Albion,8757,9,8,6,22,58,84,-26,30
Queen's Park,8757,10,6,10,20,39,76,-37,28
Raith,8758,1,23,8,5,72,32,40,77
Ayr,8758,2,24,4,8,95,43,52,76
Arbroath,8758,3,18,8,10,73,50,23,62
Alloa,8758,4,17,8,11,56,47,9,59
Stranraer,8758,5,15,5,16,55,67,-12,50
East Fife,8758,6,14,3,19,50,64,-14,45
Airdrieon,8758,7,10,11,15,45,60,-15,41
Forfar,8758,8,11,5,20,40,64,-24,38
Albion,8758,9,8,6,22,58,83,-25,30
Queen's Park,8758,10,6,10,20,41,75,-34,28
Ayr,8759,1,24,4,8,92,43,49,76
Raith,8759,2,22,8,6,69,34,35,74
Alloa,8759,3,18,8,10,58,44,14,62
Arbroath,8759,4,17,8,11,72,51,21,59
Stranraer,8759,5,16,5,15,56,64,-8,53
East Fife,8759,6,13,3,20,47,65,-18,42
Airdrieon,8759,7,10,11,15,46,60,-14,41
Forfar,8759,8,11,5,20,40,65,-25,38
Queen's Park,8759,9,7,10,19,42,74,-32,31
Albion,8759,10,8,6,22,58,80,-22,30
Raith,8760,1,23,8,5,70,33,37,77
Ayr,8760,2,24,4,8,92,42,50,76
Arbroath,8760,3,18,8,10,71,48,23,62
Alloa,8760,4,17,8,11,57,45,12,59
Stranraer,8760,5,15,5,16,55,65,-10,50
East Fife,8760,6,14,3,19,48,64,-16,45
Airdrieon,8760,7,11,11,14,49,60,-11,44
Forfar,8760,8,10,5,21,40,68,-28,35
Albion,8760,9,8,6,22,57,80,-23,30
Queen's Park,8760,10,6,10,20,39,73,-34,28
Ayr,8761,1,24,4,8,92,42,50,76
Raith,8761,2,22,8,6,68,33,35,74
Alloa,8761,3,18,8,10,57,43,14,62
Arbroath,8761,4,17,9,10,71,49,22,60
Stranraer,8761,5,16,5,15,59,65,-6,53
Airdrieon,8761,6,10,12,14,46,59,-13,42
East Fife,8761,7,13,3,20,48,68,-20,42
Forfar,8761,8,10,6,20,39,65,-26,36
Albion,8761,9,8,6,22,57,80,-23,30
Queen's Park,8761,10,6,11,19,40,73,-33,29
Ayr,8762,1,24,4,8,97,42,55,76
Raith,8762,2,22,8,6,68,35,33,74
Alloa,8762,3,18,8,10,59,43,16,62
Arbroath,8762,4,17,8,11,71,50,21,59
Stranraer,8762,5,15,6,15,58,67,-9,51
Airdrieon,8762,6,11,11,14,48,60,-12,44
East Fife,8762,7,13,4,19,50,67,-17,43
Forfar,8762,8,10,5,21,40,67,-27,35
Queen's Park,8762,9,7,10,19,41,73,-32,31
Albion,8762,10,8,6,22,57,85,-28,30
Raith,8763,1,22,8,6,68,35,33,74
Ayr,8763,2,23,4,9,92,45,47,73
Alloa,8763,3,18,8,10,59,43,16,62
Arbroath,8763,4,17,9,10,71,49,22,60
Stranraer,8763,5,15,5,16,56,66,-10,50
East Fife,8763,6,14,3,19,49,65,-16,45
Airdrieon,8763,7,11,11,14,48,59,-11,44
Forfar,8763,8,10,5,21,39,67,-28,35
Albion,8763,9,9,6,21,60,80,-20,33
Queen's Park,8763,10,6,11,19,40,73,-33,29
Raith,8764,1,23,8,5,71,32,39,77
Ayr,8764,2,24,4,8,93,42,51,76
Arbroath,8764,3,17,8,11,71,52,19,59
Alloa,8764,4,17,8,11,56,46,10,59
Stranraer,8764,5,15,5,16,56,66,-10,50
East Fife,8764,6,14,3,19,49,65,-16,45
Airdrieon,8764,7,11,11,14,48,58,-10,44
Forfar,8764,8,10,5,21,38,67,-29,35
Queen's Park,8764,9,7,10,19,43,73,-30,31
Albion,8764,10,8,6,22,57,81,-24,30
Raith,8765,1,23,8,5,70,33,37,77
Ayr,8765,2,24,4,8,94,42,52,76
Arbroath,8765,3,18,8,10,73,50,23,62
Alloa,8765,4,17,8,11,57,45,12,59
Stranraer,8765,5,16,5,15,58,66,-8,53
Airdrieon,8765,6,10,12,14,45,58,-13,42
East Fife,8765,7,13,3,20,49,67,-18,42
Forfar,8765,8,10,6,20,38,64,-26,36
Albion,8765,9,8,6,22,57,82,-25,30
Queen's Park,8765,10,6,10,20,41,75,-34,28
Ayr,8766,1,24,4,8,94,42,52,76
Raith,8766,2,22,9,5,68,32,36,75
Arbroath,8766,3,18,8,10,73,49,24,62
Alloa,8766,4,17,9,10,56,43,13,60
Stranraer,8766,5,15,5,16,56,66,-10,50
East Fife,8766,6,14,3,19,49,65,-16,45
Airdrieon,8766,7,11,11,14,47,59,-12,44
Forfar,8766,8,10,5,21,39,66,-27,35
Albion,8766,9,8,6,22,57,82,-25,30
Queen's Park,8766,10,6,10,20,40,75,-35,28
Raith,8767,1,23,8,5,71,32,39,77
Ayr,8767,2,24,4,8,94,43,51,76
Arbroath,8767,3,18,8,10,73,50,23,62
Alloa,8767,4,17,8,11,56,46,10,59
Stranraer,8767,5,15,6,15,56,65,-9,51
East Fife,8767,6,13,4,19,48,65,-17,43
Airdrieon,8767,7,10,12,14,45,58,-13,42
Forfar,8767,8,10,6,20,38,64,-26,36
Albion,8767,9,8,6,22,58,82,-24,30
Queen's Park,8767,10,6,10,20,41,75,-34,28
Raith,8768,1,23,8,5,70,32,38,77
Ayr,8768,2,23,4,9,90,44,46,73
Arbroath,8768,3,18,8,10,73,49,24,62
Alloa,8768,4,17,8,11,56,45,11,59
Stranraer,8768,5,15,5,16,56,68,-12,50
East Fife,8768,6,14,3,19,51,65,-14,45
Airdrieon,8768,7,11,11,14,48,58,-10,44
Forfar,8768,8,10,5,21,38,67,-29,35
Albion,8768,9,9,6,21,59,78,-19,33
Queen's Park,8768,10,6,10,20,40,75,-35,28
Raith,8769,1,23,8,5,72,33,39,77
Ayr,8769,2,24,4,8,94,43,51,76
Arbroath,8769,3,17,8,11,72,51,21,59
Alloa,8769,4,17,8,11,57,47,10,59
Stranraer,8769,5,15,6,15,57,66,-9,51
East Fife,8769,6,13,4,19,49,66,-17,43
Airdrieon,8769,7,10,11,15,45,60,-15,41
Forfar,8769,8,11,5,20,40,64,-24,38
Queen's Park,8769,9,7,10,19,42,74,-32,31
Albion,8769,10,8,6,22,58,82,-24,30
Raith,8770,1,23,8,5,69,32,37,77
Ayr,8770,2,23,4,9,90,43,47,73
Arbroath,8770,3,18,8,10,72,49,23,62
Alloa,8770,4,17,8,11,56,44,12,59
Stranraer,8770,5,15,5,16,55,69,-14,50
East Fife,8770,6,14,3,19,52,64,-12,45
Airdrieon,8770,7,10,12,14,46,59,-13,42
Forfar,8770,8,10,6,20,39,65,-26,36
Albion,8770,9,9,6,21,58,78,-20,33
Queen's Park,8770,10,6,10,20,40,74,-34,28
Ayr,8771,1,24,4,8,93,43,50,76
Raith,8771,2,22,8,6,68,36,32,74
Arbroath,8771,3,18,8,10,74,49,25,62
Alloa,8771,4,18,8,10,60,43,17,62
Stranraer,8771,5,15,5,16,56,66,-10,50
East Fife,8771,6,14,3,19,49,65,-16,45
Airdrieon,8771,7,10,12,14,47,60,-13,42
Forfar,8771,8,10,6,20,40,66,-26,36
Albion,8771,9,8,6,22,58,81,-23,30
Queen's Park,8771,10,6,10,20,40,76,-36,28
Ayr,8772,1,23,5,8,92,44,48,74
Raith,8772,2,22,8,6,69,34,35,74
Alloa,8772,3,18,8,10,58,44,14,62
Arbroath,8772,4,17,8,11,72,51,21,59
Stranraer,8772,5,15,6,15,58,67,-9,51
East Fife,8772,6,13,4,19,50,67,-17,43
Airdrieon,8772,7,10,12,14,46,59,-13,42
Forfar,8772,8,10,6,20,39,65,-26,36
Albion,8772,9,8,7,21,59,80,-21,31
Queen's Park,8772,10,7,10,19,42,74,-32,31
Raith,8773,1,23,8,5,71,32,39,77
Ayr,8773,2,23,4,9,91,44,47,73
Arbroath,8773,3,17,9,10,71,49,22,60
Alloa,8773,4,17,8,11,56,46,10,59
Stranraer,8773,5,15,5,16,55,66,-11,50
East Fife,8773,6,14,3,19,49,64,-15,45
Airdrieon,8773,7,11,11,14,48,58,-10,44
Forfar,8773,8,10,5,21,38,67,-29,35
Albion,8773,9,9,6,21,59,79,-20,33
Queen's Park,8773,10,6,11,19,40,73,-33,29
Raith,8774,1,23,8,5,71,33,38,77
Ayr,8774,2,24,4,8,94,44,50,76
Arbroath,8774,3,17,8,11,70,51,19,59
Alloa,8774,4,17,8,11,57,46,11,59
Stranraer,8774,5,15,5,16,55,65,-10,50
East Fife,8774,6,14,3,19,48,64,-16,45
Airdrieon,8774,7,11,11,14,46,58,-12,44
Forfar,8774,8,10,5,21,38,65,-27,35
Queen's Park,8774,9,7,10,19,42,72,-30,31
Albion,8774,10,8,6,22,59,82,-23,30
Raith,8775,1,23,8,5,72,33,39,77
Ayr,8775,2,24,4,8,93,42,51,76
Arbroath,8775,3,18,8,10,74,49,25,62
Alloa,8775,4,17,8,11,57,47,10,59
Stranraer,8775,5,16,5,15,56,64,-8,53
East Fife,8775,6,13,3,20,47,65,-18,42
Airdrieon,8775,7,10,11,15,45,59,-14,41
Forfar,8775,8,11,5,20,39,64,-25,38
Albion,8775,9,8,6,22,57,81,-24,30
Queen's Park,8775,10,6,10,20,40,76,-36,28
Raith,8776,1,23,8,5,71,33,38,77
Ayr,8776,2,23,4,9,91,44,47,73
Arbroath,8776,3,17,9,10,72,50,22,60
Alloa,8776,4,17,8,11,57,46,11,59
Stranraer,8776,5,16,5,15,57,64,-7,53
Airdrieon,8776,6,11,11,14,48,59,-11,44
East Fife,8776,7,13,3,20,47,66,-19,42
Forfar,8776,8,10,5,21,39,67,-28,35
Albion,8776,9,9,6,21,59,79,-20,33
Queen's Park,8776,10,6,11,19,41,74,-33,29
Raith,8777,1,23,8,5,69,32,37,77
Ayr,8777,2,24,4,8,93,43,50,76
Arbroath,8777,3,17,9,10,71,49,22,60
Alloa,8777,4,17,8,11,56,44,12,59
Stranraer,8777,5,15,5,16,55,66,-11,50
East Fife,8777,6,14,3,19,49,64,-15,45
Airdrieon,8777,7,11,11,14,46,58,-12,44
Forfar,8777,8,10,5,21,38,65,-27,35
Albion,8777,9,8,6,22,58,81,-23,30
Queen's Park,8777,10,6,11,19,40,73,-33,29
Raith,8778,1,23,8,5,70,33,37,77
Ayr,8778,2,24,4,8,94,43,51,76
Arbroath,8778,3,18,8,10,72,48,24,62
Alloa,8778,4,17,8,11,57,45,12,59
Stranraer,8778,5,15,5,16,55,66,-11,50
East Fife,8778,6,14,3,19,49,64,-15,45
Airdrieon,8778,7,11,11,14,49,58,-9,44
Forfar,8778,8,10,5,21,38,68,-30,35
Albion,8778,9,8,6,22,58,82,-24,30
Queen's Park,8778,10,6,10,20,39,74,-35,28
Raith,8779,1,23,8,5,70,33,37,77
Ayr,8779,2,23,4,9,90,45,45,73
Arbroath,8779,3,18,8,10,71,48,23,62
Alloa,8779,4,17,8,11,57,45,12,59
Stranraer,8779,5,15,6,15,57,66,-9,51
Airdrieon,8779,6,11,11,14,47,58,-11,44
East Fife,8779,7,13,4,19,49,66,-17,43
Forfar,8779,8,10,5,21,38,66,-28,35
Albion,8779,9,9,6,21,60,78,-18,33
Queen's Park,8779,10,6,10,20,39,73,-34,28
Raith,8780,1,22,9,5,69,33,36,75
Ayr,8780,2,23,5,8,90,42,48,74
Arbroath,8780,3,17,9,10,70,48,22,60
Alloa,8780,4,17,9,10,57,44,13,60
Stranraer,8780,5,15,5,16,55,66,-11,50
East Fife,8780,6,14,3,19,49,64,-15,45
Airdrieon,8780,7,10,11,15,45,62,-17,41
Forfar,8780,8,11,5,20,42,64,-22,38
Albion,8780,9,8,7,21,57,78,-21,31
Queen's Park,8780,10,6,11,19,39,72,-33,29
Raith,8781,1,23,8,5,69,32,37,77
Ayr,8781,2,24,4,8,92,43,49,76
Arbroath,8781,3,17,8,11,71,52,19,59
Alloa,8781,4,17,8,11,56,44,12,59
Stranraer,8781,5,15,5,16,56,66,-10,50
East Fife,8781,6,14,3,19,49,65,-16,45
Airdrieon,8781,7,10,11,15,46,60,-14,41
Forfar,8781,8,11,5,20,40,65,-25,38
Queen's Park,8781,9,7,10,19,43,73,-30,31
Albion,8781,10,8,6,22,58,80,-22,30
Raith,8782,1,23,8,5,71,34,37,77
Ayr,8782,2,24,4,8,96,43,53,76
Arbroath,8782,3,18,8,10,74,48,26,62
Alloa,8782,4,17,8,11,58,46,12,59
Stranraer,8782,5,16,5,15,58,65,-7,53
East Fife,8782,6,13,3,20,48,67,-19,42
Airdrieon,8782,7,10,11,15,47,61,-14,41
Forfar,8782,8,11,5,20,41,66,-25,38
Albion,8782,9,8,6,22,58,84,-26,30
Queen's Park,8782,10,6,10,20,39,76,-37,28
Raith,8783,1,22,9,5,68,32,36,75
Ayr,8783,2,23,5,8,92,44,48,74
Arbroath,8783,3,18,8,10,72,48,24,62
Alloa,8783,4,17,9,10,56,43,13,60
Stranraer,8783,5,16,5,15,57,65,-8,53
Airdrieon,8783,6,11,11,14,46,58,-12,44
East Fife,8783,7,13,3,20,48,66,-18,42
Forfar,8783,8,10,5,21,38,65,-27,35
Albion,8783,9,8,7,21,59,80,-21,31
Queen's Park,8783,10,6,10,20,39,74,-35,28
Ayr,8784,1,24,4,8,97,44,53,76
Raith,8784,2,22,9,5,69,33,36,75
Arbroath,8784,3,18,8,10,73,48,25,62
Alloa,8784,4,17,9,10,57,44,13,60
Stranraer,8784,5,15,5,16,56,67,-11,50
East Fife,8784,6,14,3,19,50,65,-15,45
Airdrieon,8784,7,10,11,15,45,59,-14,41
Forfar,8784,8,11,5,20,39,64,-25,38
Albion,8784,9,8,6,22,59,85,-26,30
Queen's Park,8784,10,6,10,20,39,75,-36,28
Ayr,8785,1,24,4,8,94,43,51,76
Raith,8785,2,22,8,6,68,33,35,74
Alloa,8785,3,18,8,10,57,43,14,62
Arbroath,8785,4,17,8,11,70,50,20,59
Stranraer,8785,5,16,5,15,56,64,-8,53
East Fife,8785,6,13,3,20,47,65,-18,42
Airdrieon,8785,7,10,11,15,45,60,-15,41
Forfar,8785,8,11,5,20,40,64,-24,38
Queen's Park,8785,9,7,10,19,41,72,-31,31
Albion,8785,10,8,6,22,58,82,-24,30
Ayr,8786,1,24,4,8,96,43,53,76
Raith,8786,2,22,8,6,68,33,35,74
Arbroath,8786,3,18,8,10,71,48,23,62
Alloa,8786,4,18,8,10,57,43,14,62
Stranraer,8786,5,16,5,15,58,65,-7,53
Airdrieon,8786,6,11,11,14,47,59,-12,44
East Fife,8786,7,13,3,20,48,67,-19,42
Forfar,8786,8,10,5,21,39,66,-27,35
Albion,8786,9,8,6,22,58,84,-26,30
Queen's Park,8786,10,6,10,20,39,73,-34,28
Raith,8787,1,23,8,5,71,32,39,77
Ayr,8787,2,24,4,8,95,43,52,76
Arbroath,8787,3,17,8,11,71,52,19,59
Alloa,8787,4,17,8,11,56,46,10,59
Stranraer,8787,5,15,6,15,57,66,-9,51
East Fife,8787,6,13,4,19,49,66,-17,43
Airdrieon,8787,7,10,11,15,45,59,-14,41
Forfar,8787,8,11,5,20,39,64,-25,38
Queen's Park,8787,9,7,10,19,43,73,-30,31
Albion,8787,10,8,6,22,58,83,-25,30
Raith,8788,1,23,8,5,69,32,37,77
Ayr,8788,2,24,4,8,98,43,55,76
Arbroath,8788,3,17,8,11,70,49,21,59
Alloa,8788,4,17,8,11,56,44,12,59
Stranraer,8788,5,15,6,15,56,65,-9,51
Airdrieon,8788,6,11,11,14,46,58,-12,44
East Fife,8788,7,13,4,19,48,65,-17,43
Forfar,8788,8,10,5,21,38,65,-27,35
Queen's Park,8788,9,7,10,19,40,72,-32,31
Albion,8788,10,8,6,22,58,86,-28,30
Raith,8789,1,23,8,5,73,33,40,77
Ayr,8789,2,24,4,8,95,43,52,76
Arbroath,8789,3,17,8,11,71,50,21,59
Alloa,8789,4,17,8,11,57,48,9,59
Stranraer,8789,5,15,5,16,56,68,-12,50
East Fife,8789,6,14,3,19,51,65,-14,45
Airdrieon,8789,7,10,12,14,45,58,-13,42
Forfar,8789,8,10,6,20,38,64,-26,36
Queen's Park,8789,9,7,10,19,41,73,-32,31
Albion,8789,10,8,6,22,58,83,-25,30
Raith,8790,1,23,8,5,70,33,37,77
Ayr,8790,2,24,4,8,95,42,53,76
Arbroath,8790,3,17,8,11,71,51,20,59
Alloa,8790,4,17,8,11,57,45,12,59
Stranraer,8790,5,15,5,16,56,67,-11,50
East Fife,8790,6,14,3,19,50,65,-15,45
Airdrieon,8790,7,11,11,14,50,58,-8,44
Forfar,8790,8,10,5,21,38,69,-31,35
Queen's Park,8790,9,7,10,19,42,73,-31,31
Albion,8790,10,8,6,22,57,83,-26,30
Ayr,8791,1,24,4,8,96,42,54,76
Raith,8791,2,22,9,5,68,32,36,75
Arbroath,8791,3,17,9,10,72,50,22,60
Alloa,8791,4,17,9,10,56,43,13,60
Stranraer,8791,5,15,5,16,56,66,-10,50
East Fife,8791,6,14,3,19,49,65,-16,45
Airdrieon,8791,7,10,11,15,46,60,-14,41
Forfar,8791,8,11,5,20,40,65,-25,38
Albion,8791,9,8,6,22,57,84,-27,30
Queen's Park,8791,10,6,11,19,41,74,-33,29
Raith,8792,1,23,8,5,71,32,39,77
Ayr,8792,2,24,4,8,93,43,50,76
Arbroath,8792,3,17,9,10,73,51,22,60
Alloa,8792,4,17,8,11,56,46,10,59
Stranraer,8792,5,15,5,16,55,70,-15,50
East Fife,8792,6,14,3,19,53,64,-11,45
Airdrieon,8792,7,11,11,14,48,58,-10,44
Forfar,8792,8,10,5,21,38,67,-29,35
Albion,8792,9,8,6,22,58,81,-23,30
Queen's Park,8792,10,6,11,19,42,75,-33,29
Ayr,8793,1,24,4,8,93,42,51,76
Raith,8793,2,22,9,5,69,33,36,75
Arbroath,8793,3,17,9,10,70,48,22,60
Alloa,8793,4,17,9,10,57,44,13,60
Stranraer,8793,5,16,5,15,58,64,-6,53
Airdrieon,8793,6,10,12,14,45,58,-13,42
East Fife,8793,7,13,3,20,47,67,-20,42
Forfar,8793,8,10,6,20,38,64,-26,36
Albion,8793,9,8,6,22,57,81,-24,30
Queen's Park,8793,10,6,11,19,39,72,-33,29
Raith,8794,1,23,8,5,72,32,40,77
Ayr,8794,2,24,4,8,93,43,50,76
Arbroath,8794,3,18,8,10,73,48,25,62
Alloa,8794,4,17,8,11,56,47,9,59
Stranraer,8794,5,15,5,16,55,68,-13,50
East Fife,8794,6,14,3,19,51,64,-13,45
Airdrieon,8794,7,10,12,14,46,59,-13,42
Forfar,8794,8,10,6,20,39,65,-26,36
Albion,8794,9,8,6,22,58,81,-23,30
Queen's Park,8794,10,6,10,20,39,75,-36,28
Raith,8795,1,23,8,5,70,33,37,77
Ayr,8795,2,24,4,8,91,42,49,76
Arbroath,8795,3,17,9,10,71,49,22,60
Alloa,8795,4,17,8,11,57,45,12,59
Stranraer,8795,5,15,6,15,56,65,-9,51
Airdrieon,8795,6,11,11,14,47,58,-11,44
East Fife,8795,7,13,4,19,48,65,-17,43
Forfar,8795,8,10,5,21,38,66,-28,35
Albion,8795,9,8,6,22,57,79,-22,30
Queen's Park,8795,10,6,11,19,40,73,-33,29
Raith,8796,1,23,8,5,70,32,38,77
Ayr,8796,2,24,4,8,95,42,53,76
Arbroath,8796,3,18,8,10,72,49,23,62
Alloa,8796,4,17,8,11,56,45,11,59
Stranraer,8796,5,15,5,16,56,67,-11,50
East Fife,8796,6,14,3,19,50,65,-15,45
Airdrieon,8796,7,10,12,14,48,61,-13,42
Forfar,8796,8,10,6,20,41,67,-26,36
Albion,8796,9,8,6,22,57,83,-26,30
Queen's Park,8796,10,6,10,20,40,74,-34,28
Ayr,8797,1,24,4,8,92,42,50,76
Raith,8797,2,22,9,5,70,34,36,75
Arbroath,8797,3,18,8,10,71,48,23,62
Alloa,8797,4,17,9,10,58,45,13,60
Stranraer,8797,5,15,6,15,57,66,-9,51
East Fife,8797,6,13,4,19,49,66,-17,43
Airdrieon,8797,7,10,12,14,47,60,-13,42
Forfar,8797,8,10,6,20,40,66,-26,36
Albion,8797,9,8,6,22,57,80,-23,30
Queen's Park,8797,10,6,10,20,39,73,-34,28
Raith,8798,1,23,8,5,70,33,37,77
Ayr,8798,2,24,4,8,93,42,51,76
Arbroath,8798,3,17,9,10,71,49,22,60
Alloa,8798,4,17,8,11,57,45,12,59
Stranraer,8798,5,15,5,16,55,67,-12,50
East Fife,8798,6,14,3,19,50,64,-14,45
Airdrieon,8798,7,11,11,14,48,59,-11,44
Forfar,8798,8,10,5,21,39,67,-28,35
Albion,8798,9,8,6,22,57,81,-24,30
Queen's Park,8798,10,6,11,19,40,73,-33,29
Raith,8799,1,23,8,5,71,33,38,77
Ayr,8799,2,24,4,8,92,42,50,76
Arbroath,8799,3,17,8,11,71,50,21,59
Alloa,8799,4,17,8,11,57,46,11,59
Stranraer,8799,5,15,5,16,56,67,-11,50
East Fife,8799,6,14,3,19,50,65,-15,45
Airdrieon,8799,7,11,11,14,50,59,-9,44
Forfar,8799,8,10,5,21,39,69,-30,35
Queen's Park,8799,9,7,10,19,41,73,-32,31
Albion,8799,10,8,6,22,57,80,-23,30
Raith,8800,1,23,8,5,72,33,39,77
Ayr,8800,2,24,4,8,96,44,52,76
Arbroath,8800,3,17,9,10,71,49,22,60
Alloa,8800,4,17,8,11,57,47,10,59
Stranraer,8800,5,15,6,15,56,65,-9,51
Airdrieon,8800,6,11,11,14,47,59,-12,44
East Fife,8800,7,13,4,19,48,65,-17,43
Forfar,8800,8,10,5,21,39,66,-27,35
Albion,8800,9,8,6,22,59,84,-25,30
Queen's Park,8800,10,6,11,19,40,73,-33,29
Ayr,8801,1,24,4,8,96,43,53,76
Raith,8801,2,22,8,6,69,35,34,74
Alloa,8801,3,18,8,10,59,44,15,62
Arbroath,8801,4,17,9,10,70,48,22,60
Stranraer,8801,5,15,6,15,56,65,-9,51
East Fife,8801,6,13,4,19,48,65,-17,43
Airdrieon,8801,7,10,12,14,46,59,-13,42
Forfar,8801,8,10,6,20,39,65,-26,36
Albion,8801,9,8,6,22,58,84,-26,30
Queen's Park,8801,10,6,11,19,39,72,-33,29
Raith,8802,1,23,8,5,73,35,38,77
Ayr,8802,2,23,4,9,93,46,47,73
Arbroath,8802,3,18,8,10,73,49,24,62
Alloa,8802,4,17,8,11,59,48,11,59
Stranraer,8802,5,16,5,15,57,65,-8,53
Airdrieon,8802,6,11,11,14,50,60,-10,44
East Fife,8802,7,13,3,20,48,66,-18,42
Forfar,8802,8,10,5,21,40,69,-29,35
Albion,8802,9,9,6,21,61,81,-20,33
Queen's Park,8802,10,6,10,20,40,75,-35,28
Ayr,8803,1,24,4,8,95,43,52,76
Raith,8803,2,22,9,5,69,33,36,75
Arbroath,8803,3,18,8,10,72,48,24,62
Alloa,8803,4,17,9,10,57,44,13,60
Stranraer,8803,5,16,5,15,57,65,-8,53
Airdrieon,8803,6,11,11,14,46,58,-12,44
East Fife,8803,7,13,3,20,48,66,-18,42
Forfar,8803,8,10,5,21,38,65,-27,35
Albion,8803,9,8,6,22,58,83,-25,30
Queen's Park,8803,10,6,10,20,39,74,-35,28
Raith,8804,1,23,8,5,70,32,38,77
Ayr,8804,2,23,5,8,92,44,48,74
Arbroath,8804,3,18,8,10,73,48,25,62
Alloa,8804,4,17,8,11,56,45,11,59
Stranraer,8804,5,15,5,16,56,67,-11,50
East Fife,8804,6,14,3,19,50,65,-15,45
Airdrieon,8804,7,11,11,14,48,58,-10,44
Forfar,8804,8,10,5,21,38,67,-29,35
Albion,8804,9,8,7,21,59,80,-21,31
Queen's Park,8804,10,6,10,20,39,75,-36,28
Raith,8805,1,23,8,5,73,33,40,77
Ayr,8805,2,23,4,9,90,43,47,73
Arbroath,8805,3,17,8,11,71,50,21,59
Alloa,8805,4,17,8,11,57,48,9,59
Stranraer,8805,5,16,5,15,59,65,-6,53
Airdrieon,8805,6,11,11,14,46,58,-12,44
East Fife,8805,7,13,3,20,48,68,-20,42
Forfar,8805,8,10,5,21,38,65,-27,35
Albion,8805,9,9,6,21,58,78,-20,33
Queen's Park,8805,10,7,10,19,41,73,-32,31
Raith,8806,1,23,8,5,70,33,37,77
Ayr,8806,2,23,5,8,90,42,48,74
Arbroath,8806,3,18,8,10,72,49,23,62
Alloa,8806,4,17,8,11,57,45,12,59
Stranraer,8806,5,15,5,16,55,67,-12,50
East Fife,8806,6,14,3,19,50,64,-14,45
Airdrieon,8806,7,11,11,14,46,58,-12,44
Forfar,8806,8,10,5,21,38,65,-27,35
Albion,8806,9,8,7,21,57,78,-21,31
Queen's Park,8806,10,6,10,20,40,74,-34,28
Ayr,8807,1,24,4,8,93,43,50,76
Raith,8807,2,22,9,5,69,33,36,75
Alloa,8807,3,17,9,10,57,44,13,60
Arbroath,8807,4,17,8,11,72,51,21,59
Stranraer,8807,5,15,6,15,56,65,-9,51
East Fife,8807,6,13,4,19,48,65,-17,43
Airdrieon,8807,7,10,11,15,47,61,-14,41
Forfar,8807,8,11,5,20,41,66,-25,38
Queen's Park,8807,9,7,10,19,42,74,-32,31
Albion,8807,10,8,6,22,58,81,-23,30
Ayr,8808,1,24,4,8,92,42,50,76
Raith,8808,2,22,8,6,68,34,34,74
Arbroath,8808,3,18,8,10,72,49,23,62
Alloa,8808,4,18,8,10,58,43,15,62
Stranraer,8808,5,15,5,16,55,65,-10,50
East Fife,8808,6,14,3,19,48,64,-16,45
Airdrieon,8808,7,10,11,15,46,60,-14,41
Forfar,8808,8,11,5,20,40,65,-25,38
Albion,8808,9,8,6,22,57,80,-23,30
Queen's Park,8808,10,6,10,20,40,74,-34,28
Raith,8809,1,23,8,5,70,32,38,77
Ayr,8809,2,24,4,8,94,43,51,76
Arbroath,8809,3,17,8,11,70,51,19,59
Alloa,8809,4,17,8,11,56,45,11,59
Stranraer,8809,5,15,5,16,55,65,-10,50
East Fife,8809,6,14,3,19,48,64,-16,45
Airdrieon,8809,7,11,11,14,47,59,-12,44
Forfar,8809,8,10,5,21,39,66,-27,35
Queen's Park,8809,9,7,10,19,42,72,-30,31
Albion,8809,10,8,6,22,58,82,-24,30
Ayr,8810,1,24,4,8,92,43,49,76
Raith,8810,2,22,8,6,68,33,35,74
Alloa,8810,3,18,8,10,57,43,14,62
Arbroath,8810,4,17,8,11,70,50,20,59
Stranraer,8810,5,15,5,16,55,66,-11,50
East Fife,8810,6,14,3,19,49,64,-15,45
Airdrieon,8810,7,10,12,14,45,58,-13,42
Forfar,8810,8,10,6,20,38,64,-26,36
Queen's Park,8810,9,7,10,19,41,72,-31,31
Albion,8810,10,8,6,22,58,80,-22,30
Ayr,8811,1,24,4,8,91,42,49,76
Raith,8811,2,22,9,5,68,32,36,75
Alloa,8811,3,17,9,10,56,43,13,60
Arbroath,8811,4,17,8,11,71,50,21,59
Stranraer,8811,5,15,5,16,56,67,-11,50
East Fife,8811,6,14,3,19,50,65,-15,45
Airdrieon,8811,7,11,11,14,47,59,-12,44
Forfar,8811,8,10,5,21,39,66,-27,35
Queen's Park,8811,9,7,10,19,41,73,-32,31
Albion,8811,10,8,6,22,57,79,-22,30
Raith,8812,1,23,8,5,70,33,37,77
Ayr,8812,2,23,4,9,91,44,47,73
Arbroath,8812,3,18,8,10,73,49,24,62
Alloa,8812,4,17,8,11,57,45,12,59
Stranraer,8812,5,15,5,16,55,66,-11,50
East Fife,8812,6,14,3,19,49,64,-15,45
Airdrieon,8812,7,11,11,14,48,59,-11,44
Forfar,8812,8,10,5,21,39,67,-28,35
Albion,8812,9,9,6,21,59,79,-20,33
Queen's Park,8812,10,6,10,20,40,75,-35,28
Raith,8813,1,23,8,5,70,32,38,77
Ayr,8813,2,24,4,8,95,46,49,76
Arbroath,8813,3,18,8,10,72,49,23,62
Alloa,8813,4,17,8,11,56,45,11,59
Stranraer,8813,5,15,6,15,55,64,-9,51
Airdrieon,8813,6,11,11,14,51,58,-7,44
East Fife,8813,7,13,4,19,47,64,-17,43
Forfar,8813,8,10,5,21,38,70,-32,35
Albion,8813,9,8,6,22,61,83,-22,30
Queen's Park,8813,10,6,10,20,40,74,-34,28
Raith,8814,1,23,8,5,71,34,37,77
Ayr,8814,2,24,4,8,94,43,51,76
Arbroath,8814,3,17,8,11,70,49,21,59
Alloa,8814,4,17,8,11,58,46,12,59
Stranraer,8814,5,15,5,16,57,68,-11,50
East Fife,8814,6,14,3,19,51,66,-15,45
Airdrieon,8814,7,10,12,14,45,58,-13,42
Forfar,8814,8,10,6,20,38,64,-26,36
Queen's Park,8814,9,7,10,19,40,72,-32,31
Albion,8814,10,8,6,22,58,82,-24,30
Ayr,8815,1,24,4,8,94,42,52,76
Raith,8815,2,22,9,5,70,34,36,75
Arbroath,8815,3,18,8,10,74,49,25,62
Alloa,8815,4,17,9,10,58,45,13,60
Stranraer,8815,5,15,5,16,55,66,-11,50
East Fife,8815,6,14,3,19,49,64,-15,45
Airdrieon,8815,7,10,11,15,45,60,-15,41
Forfar,8815,8,11,5,20,40,64,-24,38
Albion,8815,9,8,6,22,57,82,-25,30
Queen's Park,8815,10,6,10,20,40,76,-36,28
Raith,8816,1,22,8,6,68,33,35,74
Ayr,8816,2,23,4,9,90,43,47,73
Alloa,8816,3,18,8,10,57,43,14,62
Arbroath,8816,4,17,8,11,71,51,20,59
Stranraer,8816,5,16,5,15,57,64,-7,53
East Fife,8816,6,13,3,20,47,66,-19,42
Airdrieon,8816,7,10,11,15,45,60,-15,41
Forfar,8816,8,11,5,20,40,64,-24,38
Albion,8816,9,9,6,21,58,78,-20,33
Queen's Park,8816,10,7,10,19,42,73,-31,31
Raith,8817,1,23,8,5,73,35,38,77
Ayr,8817,2,24,4,8,92,43,49,76
Arbroath,8817,3,17,8,11,70,49,21,59
Alloa,8817,4,17,8,11,59,48,11,59
Stranraer,8817,5,16,5,15,57,64,-7,53
Airdrieon,8817,6,11,11,14,48,59,-11,44
East Fife,8817,7,13,3,20,47,66,-19,42
Forfar,8817,8,10,5,21,39,67,-28,35
Queen's Park,8817,9,7,10,19,40,72,-32,31
Albion,8817,10,8,6,22,58,80,-22,30
Raith,8818,1,23,8,5,69,32,37,77
Ayr,8818,2,24,4,8,92,43,49,76
Arbroath,8818,3,18,8,10,74,48,26,62
Alloa,8818,4,17,8,11,56,44,12,59
Stranraer,8818,5,15,5,16,55,70,-15,50
East Fife,8818,6,14,3,19,53,64,-11,45
Airdrieon,8818,7,11,11,14,47,59,-12,44
Forfar,8818,8,10,5,21,39,66,-27,35
Albion,8818,9,8,6,22,58,80,-22,30
Queen's Park,8818,10,6,10,20,39,76,-37,28
Raith,8819,1,22,9,5,69,33,36,75
Ayr,8819,2,23,4,9,91,45,46,73
Arbroath,8819,3,18,8,10,73,50,23,62
Alloa,8819,4,17,9,10,57,44,13,60
Stranraer,8819,5,15,5,16,55,68,-13,50
East Fife,8819,6,14,3,19,51,64,-13,45
Airdrieon,8819,7,10,11,15,45,59,-14,41
Forfar,8819,8,11,5,20,39,64,-25,38
Albion,8819,9,9,6,21,60,79,-19,33
Queen's Park,8819,10,6,10,20,41,75,-34,28
Raith,8820,1,23,8,5,71,33,38,77
Ayr,8820,2,24,4,8,93,43,50,76
Arbroath,8820,3,17,8,11,72,51,21,59
Alloa,8820,4,17,8,11,57,46,11,59
Stranraer,8820,5,15,5,16,55,67,-12,50
East Fife,8820,6,14,3,19,50,64,-14,45
Airdrieon,8820,7,11,11,14,46,58,-12,44
Forfar,8820,8,10,5,21,38,65,-27,35
Queen's Park,8820,9,7,10,19,42,74,-32,31
Albion,8820,10,8,6,22,58,81,-23,30
Ayr,8821,1,24,4,8,95,42,53,76
Raith,8821,2,22,8,6,69,35,34,74
Arbroath,8821,3,18,8,10,72,48,24,62
Alloa,8821,4,18,8,10,59,44,15,62
Stranraer,8821,5,15,5,16,56,66,-10,50
East Fife,8821,6,14,3,19,49,65,-16,45
Airdrieon,8821,7,11,11,14,47,58,-11,44
Forfar,8821,8,10,5,21,38,66,-28,35
Albion,8821,9,8,6,22,57,83,-26,30
Queen's Park,8821,10,6,10,20,39,74,-35,28
Ayr,8822,1,24,4,8,93,42,51,76
Raith,8822,2,22,9,5,68,32,36,75
Arbroath,8822,3,17,9,10,73,51,22,60
Alloa,8822,4,17,9,10,56,43,13,60
Stranraer,8822,5,16,5,15,58,65,-7,53
East Fife,8822,6,13,3,20,48,67,-19,42
Airdrieon,8822,7,10,11,15,45,59,-14,41
Forfar,8822,8,11,5,20,39,64,-25,38
Albion,8822,9,8,6,22,57,81,-24,30
Queen's Park,8822,10,6,11,19,42,75,-33,29
Raith,8823,1,23,8,5,70,32,38,77
Ayr,8823,2,24,4,8,93,44,49,76
Arbroath,8823,3,18,8,10,72,48,24,62
Alloa,8823,4,17,8,11,56,45,11,59
Stranraer,8823,5,15,5,16,56,66,-10,50
East Fife,8823,6,14,3,19,49,65,-16,45
Airdrieon,8823,7,11,11,14,46,58,-12,44
Forfar,8823,8,10,5,21,38,65,-27,35
Albion,8823,9,8,6,22,59,81,-22,30
Queen's Park,8823,10,6,10,20,39,74,-35,28
Ayr,8824,1,24,4,8,92,43,49,76
Raith,8824,2,22,9,5,70,34,36,75
Alloa,8824,3,17,9,10,58,45,13,60
Arbroath,8824,4,17,8,11,73,52,21,59
Stranraer,8824,5,16,5,15,57,65,-8,53
East Fife,8824,6,13,3,20,48,66,-18,42
Airdrieon,8824,7,10,11,15,45,60,-15,41
Forfar,8824,8,11,5,20,40,64,-24,38
Queen's Park,8824,9,7,10,19,43,75,-32,31
Albion,8824,10,8,6,22,58,80,-22,30
Ayr,8825,1,23,5,8,91,43,48,74
Raith,8825,2,22,8,6,69,34,35,74
Alloa,8825,3,18,8,10,58,44,14,62
Arbroath,8825,4,17,9,10,71,49,22,60
Stranraer,8825,5,15,6,15,57,66,-9,51
East Fife,8825,6,13,4,19,49,66,-17,43
Airdrieon,8825,7,10,11,15,45,59,-14,41
Forfar,8825,8,11,5,20,39,64,-25,38
Albion,8825,9,8,7,21,58,79,-21,31
Queen's Park,8825,10,6,11,19,40,73,-33,29
Raith,8826,1,23,8,5,71,32,39,77
Ayr,8826,2,24,4,8,96,44,52,76
Arbroath,8826,3,18,8,10,73,48,25,62
Alloa,8826,4,17,8,11,56,46,10,59
Stranraer,8826,5,15,5,16,56,66,-10,50
East Fife,8826,6,14,3,19,49,65,-16,45
Airdrieon,8826,7,11,11,14,48,60,-12,44
Forfar,8826,8,10,5,21,40,67,-27,35
Albion,8826,9,8,6,22,59,84,-25,30
Queen's Park,8826,10,6,10,20,39,75,-36,28
Raith,8827,1,22,9,5,70,34,36,75
Ayr,8827,2,23,5,8,90,42,48,74
Alloa,8827,3,17,9,10,58,45,13,60
Arbroath,8827,4,17,8,11,71,50,21,59
Stranraer,8827,5,16,5,15,58,65,-7,53
East Fife,8827,6,13,3,20,48,67,-19,42
Airdrieon,8827,7,10,11,15,45,59,-14,41
Forfar,8827,8,11,5,20,39,64,-25,38
Albion,8827,9,8,7,21,57,78,-21,31
Queen's Park,8827,10,7,10,19,41,73,-32,31
Ayr,8828,1,24,4,8,91,42,49,76
Raith,8828,2,22,8,6,68,35,33,74
Arbroath,8828,3,18,8,10,72,49,23,62
Alloa,8828,4,18,8,10,59,43,16,62
Stranraer,8828,5,15,6,15,55,64,-9,51
East Fife,8828,6,13,4,19,47,64,-17,43
Airdrieon,8828,7,10,11,15,45,59,-14,41
Forfar,8828,8,11,5,20,39,64,-25,38
Albion,8828,9,8,6,22,57,79,-22,30
Queen's Park,8828,10,6,10,20,40,74,-34,28
Raith,8829,1,23,8,5,70,33,37,77
Ayr,8829,2,24,4,8,93,44,49,76
Arbroath,8829,3,17,8,11,71,50,21,59
Alloa,8829,4,17,8,11,57,45,12,59
Stranraer,8829,5,15,5,16,56,66,-10,50
East Fife,8829,6,14,3,19,49,65,-16,45
Airdrieon,8829,7,10,11,15,47,61,-14,41
Forfar,8829,8,11,5,20,41,66,-25,38
Queen's Park,8829,9,7,10,19,41,73,-32,31
Albion,8829,10,8,6,22,59,81,-22,30
Raith,8830,1,23,8,5,70,32,38,77
Ayr,8830,2,24,4,8,96,42,54,76
Arbroath,8830,3,17,8,11,71,50,21,59
Alloa,8830,4,17,8,11,56,45,11,59
Stranraer,8830,5,15,5,16,55,67,-12,50
East Fife,8830,6,14,3,19,50,64,-14,45
Airdrieon,8830,7,11,11,14,46,58,-12,44
Forfar,8830,8,10,5,21,38,65,-27,35
Queen's Park,8830,9,7,10,19,41,73,-32,31
Albion,8830,10,8,6,22,57,84,-27,30
Raith,8831,1,23,8,5,71,34,37,77
Ayr,8831,2,24,4,8,94,43,51,76
Arbroath,8831,3,18,8,10,72,49,23,62
Alloa,8831,4,17,8,11,58,46,12,59
Stranraer,8831,5,16,5,15,56,64,-8,53
East Fife,8831,6,13,3,20,47,65,-18,42
Airdrieon,8831,7,10,11,15,45,59,-14,41
Forfar,8831,8,11,5,20,39,64,-25,38
Albion,8831,9,8,6,22,58,82,-24,30
Queen's Park,8831,10,6,10,20,40,74,-34,28
Raith,8832,1,23,8,5,73,32,41,77
Ayr,8832,2,24,4,8,95,42,53,76
Arbroath,8832,3,18,8,10,72,49,23,62
Alloa,8832,4,17,8,11,56,48,8,59
Stranraer,8832,5,16,5,15,59,67,-8,53
Airdrieon,8832,6,11,11,14,48,58,-10,44
East Fife,8832,7,13,3,20,50,68,-18,42
Forfar,8832,8,10,5,21,38,67,-29,35
Albion,8832,9,8,6,22,57,83,-26,30
Queen's Park,8832,10,6,10,20,40,74,-34,28
Raith,8833,1,22,9,5,69,33,36,75
Ayr,8833,2,23,4,9,92,46,46,73
Arbroath,8833,3,17,9,10,70,48,22,60
Alloa,8833,4,17,9,10,57,44,13,60
Stranraer,8833,5,15,5,16,56,66,-10,50
East Fife,8833,6,14,3,19,49,65,-16,45
Airdrieon,8833,7,10,11,15,46,60,-14,41
Forfar,8833,8,11,5,20,40,65,-25,38
Albion,8833,9,9,6,21,61,80,-19,33
Queen's Park,8833,10,6,11,19,39,72,-33,29
Ayr,8834,1,24,4,8,93,43,50,76
Raith,8834,2,22,8,6,70,35,35,74
Alloa,8834,3,18,8,10,59,45,14,62
Arbroath,8834,4,17,8,11,71,50,21,59
Stranraer,8834,5,15,6,15,55,64,-9,51
East Fife,8834,6,13,4,19,47,64,-17,43
Airdrieon,8834,7,10,12,14,45,58,-13,42
Forfar,8834,8,10,6,20,38,64,-26,36
Queen's Park,8834,9,7,10,19,41,73,-32,31
Albion,8834,10,8,6,22,58,81,-23,30
Ayr,8835,1,24,4,8,93,44,49,76
Raith,8835,2,22,9,5,70,34,36,75
Alloa,8835,3,17,9,10,58,45,13,60
Arbroath,8835,4,17,8,11,71,50,21,59
Stranraer,8835,5,16,5,15,57,65,-8,53
Airdrieon,8835,6,10,12,14,46,59,-13,42
East Fife,8835,7,13,3,20,48,66,-18,42
Forfar,8835,8,10,6,20,39,65,-26,36
Queen's Park,8835,9,7,10,19,41,73,-32,31
Albion,8835,10,8,6,22,59,81,-22,30
Raith,8836,1,23,8,5,70,32,38,77
Ayr,8836,2,24,4,8,93,43,50,76
Arbroath,8836,3,17,8,11,70,50,20,59
Alloa,8836,4,17,8,11,56,45,11,59
Stranraer,8836,5,15,6,15,55,64,-9,51
Airdrieon,8836,6,11,11,14,48,58,-10,44
East Fife,8836,7,13,4,19,47,64,-17,43
Forfar,8836,8,10,5,21,38,67,-29,35
Queen's Park,8836,9,7,10,19,41,72,-31,31
Albion,8836,10,8,6,22,58,81,-23,30
Raith,8837,1,23,8,5,70,33,37,77
Ayr,8837,2,24,4,8,94,43,51,76
Arbroath,8837,3,18,8,10,74,48,26,62
Alloa,8837,4,17,8,11,57,45,12,59
Stranraer,8837,5,15,5,16,55,67,-12,50
East Fife,8837,6,14,3,19,50,64,-14,45
Airdrieon,8837,7,10,11,15,48,62,-14,41
Forfar,8837,8,11,5,20,42,67,-25,38
Albion,8837,9,8,6,22,58,82,-24,30
Queen's Park,8837,10,6,10,20,39,76,-37,28
Raith,8838,1,23,8,5,69,32,37,77
Ayr,8838,2,23,5,8,90,42,48,74
Arbroath,8838,3,18,8,10,73,50,23,62
Alloa,8838,4,17,8,11,56,44,12,59
Stranraer,8838,5,15,5,16,55,66,-11,50
East Fife,8838,6,14,3,19,49,64,-15,45
Airdrieon,8838,7,11,11,14,47,58,-11,44
Forfar,8838,8,10,5,21,38,66,-28,35
Albion,8838,9,8,7,21,57,78,-21,31
Queen's Park,8838,10,6,10,20,41,75,-34,28
Ayr,8839,1,23,5,8,90,42,48,74
Raith,8839,2,22,8,6,68,33,35,74
Alloa,8839,3,18,8,10,57,43,14,62
Arbroath,8839,4,17,8,11,72,51,21,59
Stranraer,8839,5,15,6,15,55,64,-9,51
Airdrieon,8839,6,11,11,14,47,59,-12,44
East Fife,8839,7,13,4,19,47,64,-17,43
Forfar,8839,8,10,5,21,39,66,-27,35
Albion,8839,9,8,7,21,57,78,-21,31
Queen's Park,8839,10,7,10,19,42,74,-32,31
Ayr,8840,1,24,4,8,92,42,50,76
Raith,8840,2,22,9,5,70,34,36,75
Arbroath,8840,3,18,8,10,73,50,23,62
Alloa,8840,4,17,9,10,58,45,13,60
Stranraer,8840,5,15,6,15,57,66,-9,51
Airdrieon,8840,6,11,11,14,47,58,-11,44
East Fife,8840,7,13,4,19,49,66,-17,43
Forfar,8840,8,10,5,21,38,66,-28,35
Albion,8840,9,8,6,22,57,80,-23,30
Queen's Park,8840,10,6,10,20,41,75,-34,28
Ayr,8841,1,24,4,8,94,44,50,76
Raith,8841,2,22,9,5,70,34,36,75
Arbroath,8841,3,18,8,10,72,49,23,62
Alloa,8841,4,17,9,10,58,45,13,60
Stranraer,8841,5,15,6,15,56,65,-9,51
Airdrieon,8841,6,11,11,14,46,58,-12,44
East Fife,8841,7,13,4,19,48,65,-17,43
Forfar,8841,8,10,5,21,38,65,-27,35
Albion,8841,9,8,6,22,59,82,-23,30
Queen's Park,8841,10,6,10,20,40,74,-34,28
Ayr,8842,1,24,4,8,93,42,51,76
Raith,8842,2,22,8,6,69,34,35,74
Arbroath,8842,3,18,8,10,71,48,23,62
Alloa,8842,4,18,8,10,58,44,14,62
Stranraer,8842,5,15,5,16,56,66,-10,50
East Fife,8842,6,14,3,19,49,65,-16,45
Airdrieon,8842,7,10,11,15,46,62,-16,41
Forfar,8842,8,11,5,20,42,65,-23,38
Albion,8842,9,8,6,22,57,81,-24,30
Queen's Park,8842,10,6,10,20,39,73,-34,28
Ayr,8843,1,24,4,8,94,43,51,76
Raith,8843,2,22,8,6,68,34,34,74
Arbroath,8843,3,18,8,10,73,48,25,62
Alloa,8843,4,18,8,10,58,43,15,62
Stranraer,8843,5,15,5,16,55,67,-12,50
East Fife,8843,6,14,3,19,50,64,-14,45
Airdrieon,8843,7,11,11,14,49,60,-11,44
Forfar,8843,8,10,5,21,40,68,-28,35
Albion,8843,9,8,6,22,58,82,-24,30
Queen's Park,8843,10,6,10,20,39,75,-36,28
Raith,8844,1,22,9,5,69,33,36,75
Ayr,8844,2,23,5,8,91,43,48,74
Arbroath,8844,3,18,8,10,72,49,23,62
Alloa,8844,4,17,9,10,57,44,13,60
Stranraer,8844,5,15,5,16,55,66,-11,50
East Fife,8844,6,14,3,19,49,64,-15,45
Airdrieon,8844,7,11,11,14,47,58,-11,44
Forfar,8844,8,10,5,21,38,66,-28,35
Albion,8844,9,8,7,21,58,79,-21,31
Queen's Park,8844,10,6,10,20,40,74,-34,28
Ayr,8845,1,24,4,8,94,43,51,76
Raith,8845,2,22,8,6,69,34,35,74
Arbroath,8845,3,18,8,10,72,48,24,62
Alloa,8845,4,18,8,10,58,44,14,62
Stranraer,8845,5,15,5,16,55,65,-10,50
East Fife,8845,6,14,3,19,48,64,-16,45
Airdrieon,8845,7,11,11,14,47,58,-11,44
Forfar,8845,8,10,5,21,38,66,-28,35
Albion,8845,9,8,6,22,58,82,-24,30
Queen's Park,8845,10,6,10,20,39,74,-35,28
Raith,8846,1,23,8,5,70,32,38,77
Ayr,8846,2,24,4,8,93,42,51,76
Arbroath,8846,3,17,8,11,71,50,21,59
Alloa,8846,4,17,8,11,56,45,11,59
Stranraer,8846,5,15,5,16,56,67,-11,50
East Fife,8846,6,14,3,19,50,65,-15,45
Airdrieon,8846,7,10,12,14,45,58,-13,42
Forfar,8846,8,10,6,20,38,64,-26,36
Queen's Park,8846,9,7,10,19,41,73,-32,31
Albion,8846,10,8,6,22,57,81,-24,30
Raith,8847,1,23,8,5,69,32,37,77
Ayr,8847,2,24,4,8,95,44,51,76
Arbroath,8847,3,18,8,10,72,49,23,62
Alloa,8847,4,17,8,11,56,44,12,59
Stranraer,8847,5,15,5,16,56,68,-12,50
East Fife,8847,6,14,3,19,51,65,-14,45
Airdrieon,8847,7,10,11,15,45,60,-15,41
Forfar,8847,8,11,5,20,40,64,-24,38
Albion,8847,9,8,6,22,59,83,-24,30
Queen's Park,8847,10,6,10,20,40,74,-34,28
Raith,8848,1,23,8,5,71,34,37,77
Ayr,8848,2,23,5,8,91,43,48,74
Arbroath,8848,3,17,8,11,72,51,21,59
Alloa,8848,4,17,8,11,58,46,12,59
Stranraer,8848,5,15,5,16,55,65,-10,50
East Fife,8848,6,14,3,19,48,64,-16,45
Airdrieon,8848,7,10,12,14,48,61,-13,42
Forfar,8848,8,10,6,20,41,67,-26,36
Albion,8848,9,8,7,21,58,79,-21,31
Queen's Park,8848,10,7,10,19,42,74,-32,31
Ayr,8849,1,24,4,8,92,43,49,76
Raith,8849,2,22,9,5,68,32,36,75
Arbroath,8849,3,17,9,10,72,50,22,60
Alloa,8849,4,17,9,10,56,43,13,60
Stranraer,8849,5,15,5,16,57,67,-10,50
East Fife,8849,6,14,3,19,50,66,-16,45
Airdrieon,8849,7,10,12,14,48,61,-13,42
Forfar,8849,8,10,6,20,41,67,-26,36
Albion,8849,9,8,6,22,58,80,-22,30
Queen's Park,8849,10,6,11,19,41,74,-33,29
Ayr,8850,1,24,4,8,93,42,51,76
Raith,8850,2,22,9,5,68,32,36,75
Arbroath,8850,3,18,8,10,73,49,24,62
Alloa,8850,4,17,9,10,56,43,13,60
Stranraer,8850,5,16,5,15,57,65,-8,53
Airdrieon,8850,6,11,11,14,46,58,-12,44
East Fife,8850,7,13,3,20,48,66,-18,42
Forfar,8850,8,10,5,21,38,65,-27,35
Albion,8850,9,8,6,22,57,81,-24,30
Queen's Park,8850,10,6,10,20,40,75,-35,28
Raith,8851,1,23,8,5,71,32,39,77
Ayr,8851,2,24,4,8,95,43,52,76
Arbroath,8851,3,17,9,10,73,51,22,60
Alloa,8851,4,17,8,11,56,46,10,59
Stranraer,8851,5,15,6,15,57,66,-9,51
Airdrieon,8851,6,11,11,14,48,60,-12,44
East Fife,8851,7,13,4,19,49,66,-17,43
Forfar,8851,8,10,5,21,40,67,-27,35
Albion,8851,9,8,6,22,58,83,-25,30
Queen's Park,8851,10,6,11,19,42,75,-33,29
Ayr,8852,1,24,4,8,92,42,50,76
Raith,8852,2,22,8,6,69,34,35,74
Alloa,8852,3,18,8,10,58,44,14,62
Arbroath,8852,4,17,8,11,70,49,21,59
Stranraer,8852,5,15,6,15,56,65,-9,51
East Fife,8852,6,13,4,19,48,65,-17,43
Airdrieon,8852,7,10,11,15,45,60,-15,41
Forfar,8852,8,11,5,20,40,64,-24,38
Queen's Park,8852,9,7,10,19,40,72,-32,31
Albion,8852,10,8,6,22,57,80,-23,30
Ayr,8853,1,24,4,8,92,43,49,76
Raith,8853,2,22,9,5,69,33,36,75
Arbroath,8853,3,18,8,10,72,49,23,62
Alloa,8853,4,17,9,10,57,44,13,60
Stranraer,8853,5,16,5,15,60,65,-5,53
East Fife,8853,6,13,3,20,48,69,-21,42
Airdrieon,8853,7,10,11,15,46,60,-14,41
Forfar,8853,8,11,5,20,40,65,-25,38
Albion,8853,9,8,6,22,58,80,-22,30
Queen's Park,8853,10,6,10,20,40,74,-34,28
Ayr,8854,1,24,4,8,91,42,49,76
Raith,8854,2,22,8,6,68,34,34,74
Arbroath,8854,3,18,8,10,73,49,24,62
Alloa,8854,4,18,8,10,58,43,15,62
Stranraer,8854,5,15,6,15,56,65,-9,51
East Fife,8854,6,13,4,19,48,65,-17,43
Airdrieon,8854,7,10,12,14,46,59,-13,42
Forfar,8854,8,10,6,20,39,65,-26,36
Albion,8854,9,8,6,22,57,79,-22,30
Queen's Park,8854,10,6,10,20,40,75,-35,28
Raith,8855,1,23,8,5,70,32,38,77
Ayr,8855,2,24,4,8,93,43,50,76
Arbroath,8855,3,17,8,11,71,52,19,59
Alloa,8855,4,17,8,11,56,45,11,59
Stranraer,8855,5,15,5,16,58,68,-10,50
East Fife,8855,6,14,3,19,51,67,-16,45
Airdrieon,8855,7,10,12,14,48,61,-13,42
Forfar,8855,8,10,6,20,41,67,-26,36
Queen's Park,8855,9,7,10,19,43,73,-30,31
Albion,8855,10,8,6,22,58,81,-23,30
Raith,8856,1,23,8,5,71,32,39,77
Ayr,8856,2,24,4,8,91,42,49,76
Arbroath,8856,3,17,9,10,71,49,22,60
Alloa,8856,4,17,8,11,56,46,10,59
Stranraer,8856,5,16,5,15,57,64,-7,53
East Fife,8856,6,13,3,20,47,66,-19,42
Airdrieon,8856,7,10,11,15,46,61,-15,41
Forfar,8856,8,11,5,20,41,65,-24,38
Albion,8856,9,8,6,22,57,79,-22,30
Queen's Park,8856,10,6,11,19,40,73,-33,29
Ayr,8857,1,23,5,8,93,45,48,74
Raith,8857,2,22,8,6,69,34,35,74
Arbroath,8857,3,18,8,10,72,48,24,62
Alloa,8857,4,18,8,10,58,44,14,62
Stranraer,8857,5,15,5,16,55,67,-12,50
East Fife,8857,6,14,3,19,50,64,-14,45
Airdrieon,8857,7,10,12,14,47,60,-13,42
Forfar,8857,8,10,6,20,40,66,-26,36
Albion,8857,9,8,7,21,60,81,-21,31
Queen's Park,8857,10,6,10,20,39,74,-35,28
Raith,8858,1,23,8,5,71,33,38,77
Ayr,8858,2,24,4,8,94,42,52,76
Arbroath,8858,3,17,9,10,71,49,22,60
Alloa,8858,4,17,8,11,57,46,11,59
Stranraer,8858,5,15,5,16,55,67,-12,50
East Fife,8858,6,14,3,19,50,64,-14,45
Airdrieon,8858,7,10,12,14,45,58,-13,42
Forfar,8858,8,10,6,20,38,64,-26,36
Albion,8858,9,8,6,22,57,82,-25,30
Queen's Park,8858,10,6,11,19,40,73,-33,29
Raith,8859,1,23,8,5,69,32,37,77
Ayr,8859,2,24,4,8,93,43,50,76
Arbroath,8859,3,18,8,10,73,48,25,62
Alloa,8859,4,17,8,11,56,44,12,59
Stranraer,8859,5,16,5,15,58,65,-7,53
East Fife,8859,6,13,3,20,48,67,-19,42
Airdrieon,8859,7,10,11,15,45,59,-14,41
Forfar,8859,8,11,5,20,39,64,-25,38
Albion,8859,9,8,6,22,58,81,-23,30
Queen's Park,8859,10,6,10,20,39,75,-36,28
Raith,8860,1,23,8,5,70,33,37,77
Ayr,8860,2,24,4,8,93,44,49,76
Arbroath,8860,3,18,8,10,73,48,25,62
Alloa,8860,4,17,8,11,57,45,12,59
Stranraer,8860,5,16,5,15,56,64,-8,53
Airdrieon,8860,6,11,11,14,47,58,-11,44
East Fife,8860,7,13,3,20,47,65,-18,42
Forfar,8860,8,10,5,21,38,66,-28,35
Albion,8860,9,8,6,22,59,81,-22,30
Queen's Park,8860,10,6,10,20,39,75,-36,28
Ayr,8861,1,24,4,8,93,44,49,76
Raith,8861,2,22,9,5,69,33,36,75
Arbroath,8861,3,18,8,10,74,50,24,62
Alloa,8861,4,17,9,10,57,44,13,60
Stranraer,8861,5,15,6,15,57,66,-9,51
East Fife,8861,6,13,4,19,49,66,-17,43
Airdrieon,8861,7,10,12,14,46,59,-13,42
Forfar,8861,8,10,6,20,39,65,-26,36
Albion,8861,9,8,6,22,59,81,-22,30
Queen's Park,8861,10,6,10,20,41,76,-35,28
Raith,8862,1,23,8,5,71,33,38,77
Ayr,8862,2,24,4,8,95,43,52,76
Arbroath,8862,3,18,8,10,75,48,27,62
Alloa,8862,4,17,8,11,57,46,11,59
Stranraer,8862,5,16,5,15,57,65,-8,53
East Fife,8862,6,13,3,20,48,66,-18,42
Airdrieon,8862,7,10,11,15,46,60,-14,41
Forfar,8862,8,11,5,20,40,65,-25,38
Albion,8862,9,8,6,22,58,83,-25,30
Queen's Park,8862,10,6,10,20,39,77,-38,28
Ayr,8863,1,23,5,8,92,44,48,74
Raith,8863,2,22,8,6,69,34,35,74
Alloa,8863,3,18,8,10,58,44,14,62
Arbroath,8863,4,17,9,10,72,50,22,60
Stranraer,8863,5,16,5,15,56,64,-8,53
East Fife,8863,6,13,3,20,47,65,-18,42
Airdrieon,8863,7,10,11,15,45,60,-15,41
Forfar,8863,8,11,5,20,40,64,-24,38
Albion,8863,9,8,7,21,59,80,-21,31
Queen's Park,8863,10,6,11,19,41,74,-33,29
Raith,8864,1,23,8,5,71,32,39,77
Ayr,8864,2,24,4,8,96,44,52,76
Arbroath,8864,3,17,9,10,71,49,22,60
Alloa,8864,4,17,8,11,56,46,10,59
Stranraer,8864,5,15,6,15,57,66,-9,51
East Fife,8864,6,13,4,19,49,66,-17,43
Airdrieon,8864,7,10,12,14,45,58,-13,42
Forfar,8864,8,10,6,20,38,64,-26,36
Albion,8864,9,8,6,22,59,84,-25,30
Queen's Park,8864,10,6,11,19,40,73,-33,29
Raith,8865,1,23,8,5,69,32,37,77
Ayr,8865,2,24,4,8,92,42,50,76
Arbroath,8865,3,18,8,10,72,49,23,62
Alloa,8865,4,17,8,11,56,44,12,59
Stranraer,8865,5,15,5,16,57,72,-15,50
East Fife,8865,6,14,3,19,55,66,-11,45
Airdrieon,8865,7,10,11,15,47,61,-14,41
Forfar,8865,8,11,5,20,41,66,-25,38
Albion,8865,9,8,6,22,57,80,-23,30
Queen's Park,8865,10,6,10,20,40,74,-34,28
Raith,8866,1,23,8,5,71,32,39,77
Ayr,8866,2,24,4,8,93,42,51,76
Arbroath,8866,3,17,8,11,71,50,21,59
Alloa,8866,4,17,8,11,56,46,10,59
Stranraer,8866,5,16,5,15,58,65,-7,53
Airdrieon,8866,6,11,11,14,46,58,-12,44
East Fife,8866,7,13,3,20,48,67,-19,42
Forfar,8866,8,10,5,21,38,65,-27,35
Queen's Park,8866,9,7,10,19,41,73,-32,31
Albion,8866,10,8,6,22,57,81,-24,30
Ayr,8867,1,24,4,8,93,43,50,76
Raith,8867,2,22,9,5,68,32,36,75
Alloa,8867,3,17,9,10,56,43,13,60
Arbroath,8867,4,17,8,11,71,51,20,59
Stranraer,8867,5,15,6,15,58,67,-9,51
Airdrieon,8867,6,11,11,14,46,58,-12,44
East Fife,8867,7,13,4,19,50,67,-17,43
Forfar,8867,8,10,5,21,38,65,-27,35
Queen's Park,8867,9,7,10,19,42,73,-31,31
Albion,8867,10,8,6,22,58,81,-23,30
Raith,8868,1,23,8,5,69,32,37,77
Ayr,8868,2,23,4,9,91,45,46,73
Arbroath,8868,3,17,8,11,70,50,20,59
Alloa,8868,4,17,8,11,56,44,12,59
Stranraer,8868,5,16,5,15,57,65,-8,53
Airdrieon,8868,6,11,11,14,47,59,-12,44
East Fife,8868,7,13,3,20,48,66,-18,42
Forfar,8868,8,10,5,21,39,66,-27,35
Albion,8868,9,9,6,21,60,79,-19,33
Queen's Park,8868,10,7,10,19,41,72,-31,31
Ayr,8869,1,24,4,8,95,44,51,76
Raith,8869,2,22,8,6,68,33,35,74
Alloa,8869,3,18,8,10,57,43,14,62
Arbroath,8869,4,17,9,10,70,48,22,60
Stranraer,8869,5,15,5,16,55,65,-10,50
East Fife,8869,6,14,3,19,48,64,-16,45
Airdrieon,8869,7,10,12,14,46,59,-13,42
Forfar,8869,8,10,6,20,39,65,-26,36
Albion,8869,9,8,6,22,59,83,-24,30
Queen's Park,8869,10,6,11,19,39,72,-33,29
Ayr,8870,1,24,4,8,93,44,49,76
Raith,8870,2,22,9,5,69,33,36,75
Arbroath,8870,3,17,9,10,71,49,22,60
Alloa,8870,4,17,9,10,57,44,13,60
Stranraer,8870,5,16,5,15,58,65,-7,53
East Fife,8870,6,13,3,20,48,67,-19,42
Airdrieon,8870,7,10,11,15,46,60,-14,41
Forfar,8870,8,11,5,20,40,65,-25,38
Albion,8870,9,8,6,22,59,81,-22,30
Queen's Park,8870,10,6,11,19,40,73,-33,29
Ayr,8871,1,24,4,8,94,44,50,76
Raith,8871,2,22,9,5,69,33,36,75
Alloa,8871,3,17,9,10,57,44,13,60
Arbroath,8871,4,17,8,11,72,51,21,59
Stranraer,8871,5,15,5,16,55,68,-13,50
East Fife,8871,6,14,3,19,51,64,-13,45
Airdrieon,8871,7,11,11,14,47,58,-11,44
Forfar,8871,8,10,5,21,38,66,-28,35
Queen's Park,8871,9,7,10,19,42,74,-32,31
Albion,8871,10,8,6,22,59,82,-23,30
Raith,8872,1,23,8,5,74,32,42,77
Ayr,8872,2,24,4,8,93,44,49,76
Arbroath,8872,3,18,8,10,72,48,24,62
Alloa,8872,4,17,8,11,56,49,7,59
Stranraer,8872,5,15,6,15,56,65,-9,51
Airdrieon,8872,6,11,11,14,47,59,-12,44
East Fife,8872,7,13,4,19,48,65,-17,43
Forfar,8872,8,10,5,21,39,66,-27,35
Albion,8872,9,8,6,22,59,81,-22,30
Queen's Park,8872,10,6,10,20,39,74,-35,28
Ayr,8873,1,24,4,8,96,43,53,76
Raith,8873,2,22,8,6,68,33,35,74
Alloa,8873,3,18,8,10,57,43,14,62
Arbroath,8873,4,17,8,11,70,50,20,59
Stranraer,8873,5,15,5,16,55,65,-10,50
East Fife,8873,6,14,3,19,48,64,-16,45
Airdrieon,8873,7,11,11,14,47,58,-11,44
Forfar,8873,8,10,5,21,38,66,-28,35
Queen's Park,8873,9,7,10,19,41,72,-31,31
Albion,8873,10,8,6,22,58,84,-26,30
Raith,8874,1,23,8,5,71,32,39,77
Ayr,8874,2,24,4,8,94,44,50,76
Arbroath,8874,3,17,9,10,72,50,22,60
Alloa,8874,4,17,8,11,56,46,10,59
Stranraer,8874,5,16,5,15,56,64,-8,53
Airdrieon,8874,6,10,12,14,47,60,-13,42
East Fife,8874,7,13,3,20,47,65,-18,42
Forfar,8874,8,10,6,20,40,66,-26,36
Albion,8874,9,8,6,22,59,82,-23,30
Queen's Park,8874,10,6,11,19,41,74,-33,29
Ayr,8875,1,24,4,8,94,43,51,76
Raith,8875,2,22,9,5,69,33,36,75
Alloa,8875,3,17,9,10,57,44,13,60
Arbroath,8875,4,17,8,11,70,49,21,59
Stranraer,8875,5,15,5,16,55,65,-10,50
East Fife,8875,6,14,3,19,48,64,-16,45
Airdrieon,8875,7,11,11,14,49,59,-10,44
Forfar,8875,8,10,5,21,39,68,-29,35
Queen's Park,8875,9,7,10,19,40,72,-32,31
Albion,8875,10,8,6,22,58,82,-24,30
Ayr,8876,1,24,4,8,92,42,50,76
Raith,8876,2,22,9,5,68,32,36,75
Arbroath,8876,3,18,8,10,72,48,24,62
Alloa,8876,4,17,9,10,56,43,13,60
Stranraer,8876,5,15,5,16,55,65,-10,50
East Fife,8876,6,14,3,19,48,64,-16,45
Airdrieon,8876,7,10,12,14,47,60,-13,42
Forfar,8876,8,10,6,20,40,66,-26,36
Albion,8876,9,8,6,22,57,80,-23,30
Queen's Park,8876,10,6,10,20,39,74,-35,28
Ayr,8877,1,24,4,8,94,43,51,76
Raith,8877,2,22,9,5,68,32,36,75
Alloa,8877,3,17,9,10,56,43,13,60
Arbroath,8877,4,17,8,11,71,50,21,59
Stranraer,8877,5,15,6,15,56,65,-9,51
East Fife,8877,6,13,4,19,48,65,-17,43
Airdrieon,8877,7,10,12,14,45,58,-13,42
Forfar,8877,8,10,6,20,38,64,-26,36
Queen's Park,8877,9,7,10,19,41,73,-32,31
Albion,8877,10,8,6,22,58,82,-24,30
Raith,8878,1,23,8,5,71,32,39,77
Ayr,8878,2,24,4,8,91,42,49,76
Arbroath,8878,3,17,8,11,72,52,20,59
Alloa,8878,4,17,8,11,56,46,10,59
Stranraer,8878,5,16,5,15,57,65,-8,53
Airdrieon,8878,6,11,11,14,46,58,-12,44
East Fife,8878,7,13,3,20,48,66,-18,42
Forfar,8878,8,10,5,21,38,65,-27,35
Queen's Park,8878,9,7,10,19,43,74,-31,31
Albion,8878,10,8,6,22,57,79,-22,30
Raith,8879,1,22,9,5,69,33,36,75
Ayr,8879,2,23,4,9,93,46,47,73
Arbroath,8879,3,17,9,10,71,49,22,60
Alloa,8879,4,17,9,10,57,44,13,60
Stranraer,8879,5,16,5,15,59,65,-6,53
Airdrieon,8879,6,10,12,14,45,58,-13,42
East Fife,8879,7,13,3,20,48,68,-20,42
Forfar,8879,8,10,6,20,38,64,-26,36
Albion,8879,9,9,6,21,61,81,-20,33
Queen's Park,8879,10,6,11,19,40,73,-33,29
Raith,8880,1,23,8,5,69,32,37,77
Ayr,8880,2,24,4,8,94,44,50,76
Arbroath,8880,3,17,8,11,72,54,18,59
Alloa,8880,4,17,8,11,56,44,12,59
Stranraer,8880,5,15,6,15,57,66,-9,51
Airdrieon,8880,6,11,11,14,47,59,-12,44
East Fife,8880,7,13,4,19,49,66,-17,43
Forfar,8880,8,10,5,21,39,66,-27,35
Queen's Park,8880,9,7,10,19,45,74,-29,31
Albion,8880,10,8,6,22,59,82,-23,30
Ayr,8881,1,24,4,8,93,43,50,76
Raith,8881,2,22,9,5,68,32,36,75
Arbroath,8881,3,18,8,10,71,48,23,62
Alloa,8881,4,17,9,10,56,43,13,60
Stranraer,8881,5,16,5,15,59,66,-7,53
Airdrieon,8881,6,11,11,14,48,59,-11,44
East Fife,8881,7,13,3,20,49,68,-19,42
Forfar,8881,8,10,5,21,39,67,-28,35
Albion,8881,9,8,6,22,58,81,-23,30
Queen's Park,8881,10,6,10,20,39,73,-34,28
Ayr,8882,1,24,4,8,96,47,49,76
Raith,8882,2,22,8,6,68,33,35,74
Alloa,8882,3,18,8,10,57,43,14,62
Arbroath,8882,4,17,8,11,70,50,20,59
Stranraer,8882,5,15,5,16,56,66,-10,50
East Fife,8882,6,14,3,19,49,65,-16,45
Airdrieon,8882,7,10,12,14,46,59,-13,42
Forfar,8882,8,10,6,20,39,65,-26,36
Queen's Park,8882,9,7,10,19,41,72,-31,31
Albion,8882,10,8,6,22,62,84,-22,30
Raith,8883,1,23,8,5,72,32,40,77
Ayr,8883,2,24,4,8,92,43,49,76
Arbroath,8883,3,17,8,11,71,50,21,59
Alloa,8883,4,17,8,11,56,47,9,59
Stranraer,8883,5,16,5,15,56,64,-8,53
Airdrieon,8883,6,10,12,14,46,59,-13,42
East Fife,8883,7,13,3,20,47,65,-18,42
Forfar,8883,8,10,6,20,39,65,-26,36
Queen's Park,8883,9,7,10,19,41,73,-32,31
Albion,8883,10,8,6,22,58,80,-22,30
Raith,8884,1,23,8,5,70,32,38,77
Ayr,8884,2,24,4,8,95,44,51,76
Arbroath,8884,3,18,8,10,73,50,23,62
Alloa,8884,4,17,8,11,56,45,11,59
Stranraer,8884,5,15,5,16,57,67,-10,50
East Fife,8884,6,14,3,19,50,66,-16,45
Airdrieon,8884,7,10,11,15,45,59,-14,41
Forfar,8884,8,11,5,20,39,64,-25,38
Albion,8884,9,8,6,22,59,83,-24,30
Queen's Park,8884,10,6,10,20,41,75,-34,28
Raith,8885,1,23,8,5,71,34,37,77
Ayr,8885,2,24,4,8,96,43,53,76
Arbroath,8885,3,17,9,10,71,49,22,60
Alloa,8885,4,17,8,11,58,46,12,59
Stranraer,8885,5,15,5,16,57,67,-10,50
East Fife,8885,6,14,3,19,50,66,-16,45
Airdrieon,8885,7,11,11,14,46,58,-12,44
Forfar,8885,8,10,5,21,38,65,-27,35
Albion,8885,9,8,6,22,58,84,-26,30
Queen's Park,8885,10,6,11,19,40,73,-33,29
Raith,8886,1,23,8,5,69,32,37,77
Ayr,8886,2,24,4,8,94,44,50,76
Arbroath,8886,3,17,8,11,70,50,20,59
Alloa,8886,4,17,8,11,56,44,12,59
Stranraer,8886,5,15,5,16,55,67,-12,50
East Fife,8886,6,14,3,19,50,64,-14,45
Airdrieon,8886,7,10,11,15,45,59,-14,41
Forfar,8886,8,11,5,20,39,64,-25,38
Queen's Park,8886,9,7,10,19,41,72,-31,31
Albion,8886,10,8,6,22,59,82,-23,30
Raith,8887,1,23,8,5,70,32,38,77
Ayr,8887,2,23,4,9,93,46,47,73
Arbroath,8887,3,18,8,10,75,49,26,62
Alloa,8887,4,17,8,11,56,45,11,59
Stranraer,8887,5,16,5,15,57,64,-7,53
East Fife,8887,6,13,3,20,47,66,-19,42
Airdrieon,8887,7,10,11,15,47,61,-14,41
Forfar,8887,8,11,5,20,41,66,-25,38
Albion,8887,9,9,6,21,61,81,-20,33
Queen's Park,8887,10,6,10,20,40,77,-37,28
Ayr,8888,1,24,4,8,94,42,52,76
Raith,8888,2,22,9,5,70,34,36,75
Arbroath,8888,3,18,8,10,71,48,23,62
Alloa,8888,4,17,9,10,58,45,13,60
Stranraer,8888,5,15,5,16,55,67,-12,50
East Fife,8888,6,14,3,19,50,64,-14,45
Airdrieon,8888,7,10,11,15,45,60,-15,41
Forfar,8888,8,11,5,20,40,64,-24,38
Albion,8888,9,8,6,22,57,82,-25,30
Queen's Park,8888,10,6,10,20,39,73,-34,28
Raith,8889,1,23,8,5,69,32,37,77
Ayr,8889,2,23,5,8,92,44,48,74
Arbroath,8889,3,17,8,11,71,50,21,59
Alloa,8889,4,17,8,11,56,44,12,59
Stranraer,8889,5,15,5,16,55,66,-11,50
East Fife,8889,6,14,3,19,49,64,-15,45
Airdrieon,8889,7,10,12,14,45,58,-13,42
Forfar,8889,8,10,6,20,38,64,-26,36
Albion,8889,9,8,7,21,59,80,-21,31
Queen's Park,8889,10,7,10,19,41,73,-32,31
Ayr,8890,1,24,4,8,93,43,50,76
Raith,8890,2,22,9,5,70,34,36,75
Arbroath,8890,3,18,8,10,72,49,23,62
Alloa,8890,4,17,9,10,58,45,13,60
Stranraer,8890,5,16,5,15,56,64,-8,53
Airdrieon,8890,6,11,11,14,48,58,-10,44
East Fife,8890,7,13,3,20,47,65,-18,42
Forfar,8890,8,10,5,21,38,67,-29,35
Albion,8890,9,8,6,22,58,81,-23,30
Queen's Park,8890,10,6,10,20,40,74,-34,28
Ayr,8891,1,24,4,8,93,43,50,76
Raith,8891,2,22,9,5,70,34,36,75
Arbroath,8891,3,18,8,10,73,49,24,62
Alloa,8891,4,17,9,10,58,45,13,60
Stranraer,8891,5,16,5,15,57,65,-8,53
Airdrieon,8891,6,11,11,14,48,59,-11,44
East Fife,8891,7,13,3,20,48,66,-18,42
Forfar,8891,8,10,5,21,39,67,-28,35
Albion,8891,9,8,6,22,58,81,-23,30
Queen's Park,8891,10,6,10,20,40,75,-35,28
Raith,8892,1,23,8,5,69,32,37,77
Ayr,8892,2,24,4,8,96,42,54,76
Arbroath,8892,3,17,9,10,70,48,22,60
Alloa,8892,4,17,8,11,56,44,12,59
Stranraer,8892,5,15,5,16,57,69,-12,50
East Fife,8892,6,14,3,19,52,66,-14,45
Airdrieon,8892,7,11,11,14,47,58,-11,44
Forfar,8892,8,10,5,21,38,66,-28,35
Albion,8892,9,8,6,22,57,84,-27,30
Queen's Park,8892,10,6,11,19,39,72,-33,29
Ayr,8893,1,24,4,8,93,44,49,76
Raith,8893,2,22,9,5,69,33,36,75
Alloa,8893,3,17,9,10,57,44,13,60
Arbroath,8893,4,17,8,11,72,51,21,59
Stranraer,8893,5,15,5,16,56,66,-10,50
East Fife,8893,6,14,3,19,49,65,-16,45
Airdrieon,8893,7,10,12,14,46,59,-13,42
Forfar,8893,8,10,6,20,39,65,-26,36
Queen's Park,8893,9,7,10,19,42,74,-32,31
Albion,8893,10,8,6,22,59,81,-22,30
Raith,8894,1,23,8,5,70,33,37,77
Ayr,8894,2,24,4,8,91,42,49,76
Arbroath,8894,3,18,8,10,72,49,23,62
Alloa,8894,4,17,8,11,57,45,12,59
Stranraer,8894,5,15,5,16,56,66,-10,50
East Fife,8894,6,14,3,19,49,65,-16,45
Airdrieon,8894,7,10,11,15,47,62,-15,41
Forfar,8894,8,11,5,20,42,66,-24,38
Albion,8894,9,8,6,22,57,79,-22,30
Queen's Park,8894,10,6,10,20,40,74,-34,28
Raith,8895,1,23,8,5,69,32,37,77
Ayr,8895,2,24,4,8,92,42,50,76
Arbroath,8895,3,18,8,10,73,49,24,62
Alloa,8895,4,17,8,11,56,44,12,59
Stranraer,8895,5,16,5,15,56,64,-8,53
Airdrieon,8895,6,11,11,14,47,58,-11,44
East Fife,8895,7,13,3,20,47,65,-18,42
Forfar,8895,8,10,5,21,38,66,-28,35
Albion,8895,9,8,6,22,57,80,-23,30
Queen's Park,8895,10,6,10,20,40,75,-35,28
Raith,8896,1,23,8,5,69,32,37,77
Ayr,8896,2,23,5,8,92,44,48,74
Arbroath,8896,3,18,8,10,73,48,25,62
Alloa,8896,4,17,8,11,56,44,12,59
Stranraer,8896,5,16,5,15,58,65,-7,53
East Fife,8896,6,13,3,20,48,67,-19,42
Airdrieon,8896,7,10,11,15,45,59,-14,41
Forfar,8896,8,11,5,20,39,64,-25,38
Albion,8896,9,8,7,21,59,80,-21,31
Queen's Park,8896,10,6,10,20,39,75,-36,28
Raith,8897,1,23,8,5,72,32,40,77
Ayr,8897,2,24,4,8,94,43,51,76
Arbroath,8897,3,18,8,10,74,50,24,62
Alloa,8897,4,17,8,11,56,47,9,59
Stranraer,8897,5,15,5,16,55,66,-11,50
East Fife,8897,6,14,3,19,49,64,-15,45
Airdrieon,8897,7,11,11,14,48,59,-11,44
Forfar,8897,8,10,5,21,39,67,-28,35
Albion,8897,9,8,6,22,58,82,-24,30
Queen's Park,8897,10,6,10,20,41,76,-35,28
Raith,8898,1,23,8,5,72,32,40,77
Ayr,8898,2,24,4,8,95,43,52,76
Arbroath,8898,3,17,8,11,70,49,21,59
Alloa,8898,4,17,8,11,56,47,9,59
Stranraer,8898,5,15,5,16,56,67,-11,50
East Fife,8898,6,14,3,19,50,65,-15,45
Airdrieon,8898,7,11,11,14,49,58,-9,44
Forfar,8898,8,10,5,21,38,68,-30,35
Queen's Park,8898,9,7,10,19,40,72,-32,31
Albion,8898,10,8,6,22,58,83,-25,30
Raith,8899,1,23,8,5,71,33,38,77
Ayr,8899,2,24,4,8,93,42,51,76
Arbroath,8899,3,17,8,11,71,51,20,59
Alloa,8899,4,17,8,11,57,46,11,59
Stranraer,8899,5,15,6,15,56,65,-9,51
Airdrieon,8899,6,11,11,14,46,58,-12,44
East Fife,8899,7,13,4,19,48,65,-17,43
Forfar,8899,8,10,5,21,38,65,-27,35
Queen's Park,8899,9,7,10,19,42,73,-31,31
Albion,8899,10,8,6,22,57,81,-24,30
Ayr,8900,1,24,4,8,92,43,49,76
Raith,8900,2,22,8,6,69,34,35,74
Alloa,8900,3,18,8,10,58,44,14,62
Arbroath,8900,4,17,9,10,71,49,22,60
Stranraer,8900,5,15,5,16,56,66,-10,50
East Fife,8900,6,14,3,19,49,65,-16,45
Airdrieon,8900,7,11,11,14,47,58,-11,44
Forfar,8900,8,10,5,21,38,66,-28,35
Albion,8900,9,8,6,22,58,80,-22,30
Queen's Park,8900,10,6,11,19,40,73,-33,29
Raith,8901,1,23,8,5,70,33,37,77
Ayr,8901,2,24,4,8,93,42,51,76
Arbroath,8901,3,17,8,11,70,49,21,59
Alloa,8901,4,17,8,11,57,45,12,59
Stranraer,8901,5,16,5,15,57,65,-8,53
Airdrieon,8901,6,10,12,14,46,59,-13,42
East Fife,8901,7,13,3,20,48,66,-18,42
Forfar,8901,8,10,6,20,39,65,-26,36
Queen's Park,8901,9,7,10,19,40,72,-32,31
Albion,8901,10,8,6,22,57,81,-24,30
Ayr,8902,1,24,4,8,93,44,49,76
Raith,8902,2,22,8,6,69,34,35,74
Alloa,8902,3,18,8,10,58,44,14,62
Arbroath,8902,4,17,9,10,70,48,22,60
Stranraer,8902,5,15,6,15,56,65,-9,51
East Fife,8902,6,13,4,19,48,65,-17,43
Airdrieon,8902,7,10,11,15,45,60,-15,41
Forfar,8902,8,11,5,20,40,64,-24,38
Albion,8902,9,8,6,22,59,81,-22,30
Queen's Park,8902,10,6,11,19,39,72,-33,29
Raith,8903,1,23,8,5,71,33,38,77
Ayr,8903,2,24,4,8,97,45,52,76
Arbroath,8903,3,17,9,10,70,48,22,60
Alloa,8903,4,17,8,11,57,46,11,59
Stranraer,8903,5,16,5,15,57,64,-7,53
Airdrieon,8903,6,11,11,14,48,58,-10,44
East Fife,8903,7,13,3,20,47,66,-19,42
Forfar,8903,8,10,5,21,38,67,-29,35
Albion,8903,9,8,6,22,60,85,-25,30
Queen's Park,8903,10,6,11,19,39,72,-33,29
Raith,8904,1,23,8,5,70,32,38,77
Ayr,8904,2,24,4,8,95,42,53,76
Arbroath,8904,3,18,8,10,75,48,27,62
Alloa,8904,4,17,8,11,56,45,11,59
Stranraer,8904,5,15,5,16,56,67,-11,50
East Fife,8904,6,14,3,19,50,65,-15,45
Airdrieon,8904,7,11,11,14,49,58,-9,44
Forfar,8904,8,10,5,21,38,68,-30,35
Albion,8904,9,8,6,22,57,83,-26,30
Queen's Park,8904,10,6,10,20,39,77,-38,28
Raith,8905,1,23,8,5,70,33,37,77
Ayr,8905,2,24,4,8,91,42,49,76
Arbroath,8905,3,17,9,10,70,48,22,60
Alloa,8905,4,17,8,11,57,45,12,59
Stranraer,8905,5,15,6,15,56,65,-9,51
Airdrieon,8905,6,11,11,14,48,58,-10,44
East Fife,8905,7,13,4,19,48,65,-17,43
Forfar,8905,8,10,5,21,38,67,-29,35
Albion,8905,9,8,6,22,57,79,-22,30
Queen's Park,8905,10,6,11,19,39,72,-33,29
Raith,8906,1,22,9,5,69,33,36,75
Ayr,8906,2,23,5,8,91,43,48,74
Arbroath,8906,3,18,8,10,73,48,25,62
Alloa,8906,4,17,9,10,57,44,13,60
Stranraer,8906,5,15,5,16,56,66,-10,50
East Fife,8906,6,14,3,19,49,65,-16,45
Airdrieon,8906,7,11,11,14,46,58,-12,44
Forfar,8906,8,10,5,21,38,65,-27,35
Albion,8906,9,8,7,21,58,79,-21,31
Queen's Park,8906,10,6,10,20,39,75,-36,28
Raith,8907,1,23,8,5,70,32,38,77
Ayr,8907,2,24,4,8,94,43,51,76
Arbroath,8907,3,18,8,10,74,48,26,62
Alloa,8907,4,17,8,11,56,45,11,59
Stranraer,8907,5,16,5,15,58,65,-7,53
Airdrieon,8907,6,10,12,14,46,59,-13,42
East Fife,8907,7,13,3,20,48,67,-19,42
Forfar,8907,8,10,6,20,39,65,-26,36
Albion,8907,9,8,6,22,58,82,-24,30
Queen's Park,8907,10,6,10,20,39,76,-37,28
Ayr,8908,1,24,4,8,93,42,51,76
Raith,8908,2,22,8,6,69,35,34,74
Alloa,8908,3,18,8,10,59,44,15,62
Arbroath,8908,4,17,9,10,73,51,22,60
Stranraer,8908,5,15,5,16,56,66,-10,50
East Fife,8908,6,14,3,19,49,65,-16,45
Airdrieon,8908,7,10,12,14,45,58,-13,42
Forfar,8908,8,10,6,20,38,64,-26,36
Albion,8908,9,8,6,22,57,81,-24,30
Queen's Park,8908,10,6,11,19,42,75,-33,29
Raith,8909,1,23,8,5,70,32,38,77
Ayr,8909,2,24,4,8,94,44,50,76
Arbroath,8909,3,18,8,10,73,49,24,62
Alloa,8909,4,17,8,11,56,45,11,59
Stranraer,8909,5,16,5,15,58,65,-7,53
Airdrieon,8909,6,10,12,14,46,59,-13,42
East Fife,8909,7,13,3,20,48,67,-19,42
Forfar,8909,8,10,6,20,39,65,-26,36
Albion,8909,9,8,6,22,59,82,-23,30
Queen's Park,8909,10,6,10,20,40,75,-35,28
Raith,8910,1,23,8,5,69,32,37,77
Ayr,8910,2,24,4,8,93,43,50,76
Arbroath,8910,3,18,8,10,73,49,24,62
Alloa,8910,4,17,8,11,56,44,12,59
Stranraer,8910,5,16,5,15,59,65,-6,53
Airdrieon,8910,6,10,12,14,46,59,-13,42
East Fife,8910,7,13,3,20,48,68,-20,42
Forfar,8910,8,10,6,20,39,65,-26,36
Albion,8910,9,8,6,22,58,81,-23,30
Queen's Park,8910,10,6,10,20,40,75,-35,28
Raith,8911,1,23,8,5,70,33,37,77
Ayr,8911,2,24,4,8,94,43,51,76
Arbroath,8911,3,18,8,10,75,50,25,62
Alloa,8911,4,17,8,11,57,45,12,59
Stranraer,8911,5,15,5,16,55,65,-10,50
East Fife,8911,6,14,3,19,48,64,-16,45
Airdrieon,8911,7,10,11,15,46,60,-14,41
Forfar,8911,8,11,5,20,40,65,-25,38
Albion,8911,9,8,6,22,58,82,-24,30
Queen's Park,8911,10,6,10,20,41,77,-36,28
Raith,8912,1,23,8,5,70,33,37,77
Ayr,8912,2,24,4,8,95,42,53,76
Arbroath,8912,3,18,8,10,73,49,24,62
Alloa,8912,4,17,8,11,57,45,12,59
Stranraer,8912,5,16,5,15,56,64,-8,53
Airdrieon,8912,6,11,11,14,46,58,-12,44
East Fife,8912,7,13,3,20,47,65,-18,42
Forfar,8912,8,10,5,21,38,65,-27,35
Albion,8912,9,8,6,22,57,83,-26,30
Queen's Park,8912,10,6,10,20,40,75,-35,28
Raith,8913,1,23,8,5,69,32,37,77
Ayr,8913,2,23,4,9,93,46,47,73
Arbroath,8913,3,17,9,10,72,50,22,60
Alloa,8913,4,17,8,11,56,44,12,59
Stranraer,8913,5,16,5,15,56,64,-8,53
Airdrieon,8913,6,10,12,14,45,58,-13,42
East Fife,8913,7,13,3,20,47,65,-18,42
Forfar,8913,8,10,6,20,38,64,-26,36
Albion,8913,9,9,6,21,61,81,-20,33
Queen's Park,8913,10,6,11,19,41,74,-33,29
Raith,8914,1,23,8,5,72,35,37,77
Ayr,8914,2,23,4,9,91,44,47,73
Arbroath,8914,3,18,8,10,72,48,24,62
Alloa,8914,4,17,8,11,59,47,12,59
Stranraer,8914,5,15,6,15,58,67,-9,51
East Fife,8914,6,13,4,19,50,67,-17,43
Airdrieon,8914,7,10,12,14,46,59,-13,42
Forfar,8914,8,10,6,20,39,65,-26,36
Albion,8914,9,9,6,21,59,79,-20,33
Queen's Park,8914,10,6,10,20,39,74,-35,28
Raith,8915,1,23,8,5,72,32,40,77
Ayr,8915,2,24,4,8,93,43,50,76
Arbroath,8915,3,17,8,11,71,50,21,59
Alloa,8915,4,17,8,11,56,47,9,59
Stranraer,8915,5,16,5,15,57,64,-7,53
Airdrieon,8915,6,11,11,14,48,59,-11,44
East Fife,8915,7,13,3,20,47,66,-19,42
Forfar,8915,8,10,5,21,39,67,-28,35
Queen's Park,8915,9,7,10,19,41,73,-32,31
Albion,8915,10,8,6,22,58,81,-23,30
Raith,8916,1,23,8,5,69,32,37,77
Ayr,8916,2,24,4,8,95,46,49,76
Arbroath,8916,3,17,9,10,72,50,22,60
Alloa,8916,4,17,8,11,56,44,12,59
Stranraer,8916,5,15,5,16,57,71,-14,50
East Fife,8916,6,14,3,19,54,66,-12,45
Airdrieon,8916,7,11,11,14,47,59,-12,44
Forfar,8916,8,10,5,21,39,66,-27,35
Albion,8916,9,8,6,22,61,83,-22,30
Queen's Park,8916,10,6,11,19,41,74,-33,29
Raith,8917,1,23,8,5,69,32,37,77
Ayr,8917,2,24,4,8,96,42,54,76
Arbroath,8917,3,18,8,10,72,48,24,62
Alloa,8917,4,17,8,11,56,44,12,59
Stranraer,8917,5,16,5,15,58,64,-6,53
East Fife,8917,6,13,3,20,47,67,-20,42
Airdrieon,8917,7,10,11,15,46,60,-14,41
Forfar,8917,8,11,5,20,40,65,-25,38
Albion,8917,9,8,6,22,57,84,-27,30
Queen's Park,8917,10,6,10,20,39,74,-35,28
Ayr,8918,1,24,4,8,92,43,49,76
Raith,8918,2,22,9,5,68,32,36,75
Arbroath,8918,3,18,8,10,72,49,23,62
Alloa,8918,4,17,9,10,56,43,13,60
Stranraer,8918,5,15,5,16,55,66,-11,50
East Fife,8918,6,14,3,19,49,64,-15,45
Airdrieon,8918,7,10,12,14,45,58,-13,42
Forfar,8918,8,10,6,20,38,64,-26,36
Albion,8918,9,8,6,22,58,80,-22,30
Queen's Park,8918,10,6,10,20,40,74,-34,28
Ayr,8919,1,24,4,8,95,43,52,76
Raith,8919,2,22,9,5,70,34,36,75
Arbroath,8919,3,18,8,10,72,48,24,62
Alloa,8919,4,17,9,10,58,45,13,60
Stranraer,8919,5,15,6,15,57,66,-9,51
Airdrieon,8919,6,11,11,14,48,59,-11,44
East Fife,8919,7,13,4,19,49,66,-17,43
Forfar,8919,8,10,5,21,39,67,-28,35
Albion,8919,9,8,6,22,58,83,-25,30
Queen's Park,8919,10,6,10,20,39,74,-35,28
Raith,8920,1,23,8,5,69,32,37,77
Ayr,8920,2,24,4,8,93,44,49,76
Arbroath,8920,3,18,8,10,73,49,24,62
Alloa,8920,4,17,8,11,56,44,12,59
Stranraer,8920,5,16,5,15,57,65,-8,53
East Fife,8920,6,13,3,20,48,66,-18,42
Airdrieon,8920,7,10,11,15,45,59,-14,41
Forfar,8920,8,11,5,20,39,64,-25,38
Albion,8920,9,8,6,22,59,81,-22,30
Queen's Park,8920,10,6,10,20,40,75,-35,28
Raith,8921,1,23,8,5,70,32,38,77
Ayr,8921,2,24,4,8,100,43,57,76
Arbroath,8921,3,18,8,10,72,48,24,62
Alloa,8921,4,17,8,11,56,45,11,59
Stranraer,8921,5,15,6,15,56,65,-9,51
Airdrieon,8921,6,11,11,14,46,58,-12,44
East Fife,8921,7,13,4,19,48,65,-17,43
Forfar,8921,8,10,5,21,38,65,-27,35
Albion,8921,9,8,6,22,58,88,-30,30
Queen's Park,8921,10,6,10,20,39,74,-35,28
Raith,8922,1,23,8,5,69,32,37,77
Ayr,8922,2,23,4,9,93,47,46,73
Arbroath,8922,3,18,8,10,73,49,24,62
Alloa,8922,4,17,8,11,56,44,12,59
Stranraer,8922,5,15,6,15,55,64,-9,51
Airdrieon,8922,6,11,11,14,47,58,-11,44
East Fife,8922,7,13,4,19,47,64,-17,43
Forfar,8922,8,10,5,21,38,66,-28,35
Albion,8922,9,9,6,21,62,81,-19,33
Queen's Park,8922,10,6,10,20,40,75,-35,28
Raith,8923,1,22,9,5,68,32,36,75
Ayr,8923,2,23,5,8,91,43,48,74
Arbroath,8923,3,18,8,10,71,48,23,62
Alloa,8923,4,17,9,10,56,43,13,60
Stranraer,8923,5,15,5,16,56,67,-11,50
East Fife,8923,6,14,3,19,50,65,-15,45
Airdrieon,8923,7,10,11,15,47,61,-14,41
Forfar,8923,8,11,5,20,41,66,-25,38
Albion,8923,9,8,7,21,58,79,-21,31
Queen's Park,8923,10,6,10,20,39,73,-34,28
Raith,8924,1,23,8,5,70,32,38,77
Ayr,8924,2,24,4,8,94,43,51,76
Arbroath,8924,3,17,9,10,73,51,22,60
Alloa,8924,4,17,8,11,56,45,11,59
Stranraer,8924,5,15,6,15,58,67,-9,51
Airdrieon,8924,6,11,11,14,47,58,-11,44
East Fife,8924,7,13,4,19,50,67,-17,43
Forfar,8924,8,10,5,21,38,66,-28,35
Albion,8924,9,8,6,22,58,82,-24,30
Queen's Park,8924,10,6,11,19,42,75,-33,29
Raith,8925,1,23,8,5,69,32,37,77
Ayr,8925,2,24,4,8,93,43,50,76
Arbroath,8925,3,18,8,10,75,50,25,62
Alloa,8925,4,17,8,11,56,44,12,59
Stranraer,8925,5,15,6,15,57,66,-9,51
East Fife,8925,6,13,4,19,49,66,-17,43
Airdrieon,8925,7,10,12,14,46,59,-13,42
Forfar,8925,8,10,6,20,39,65,-26,36
Albion,8925,9,8,6,22,58,81,-23,30
Queen's Park,8925,10,6,10,20,41,77,-36,28
Ayr,8926,1,24,4,8,94,44,50,76
Raith,8926,2,22,9,5,69,33,36,75
Alloa,8926,3,17,9,10,57,44,13,60
Arbroath,8926,4,17,8,11,71,51,20,59
Stranraer,8926,5,15,6,15,58,67,-9,51
Airdrieon,8926,6,11,11,14,49,59,-10,44
East Fife,8926,7,13,4,19,50,67,-17,43
Forfar,8926,8,10,5,21,39,68,-29,35
Queen's Park,8926,9,7,10,19,42,73,-31,31
Albion,8926,10,8,6,22,59,82,-23,30
Raith,8927,1,23,8,5,73,33,40,77
Ayr,8927,2,24,4,8,93,43,50,76
Arbroath,8927,3,17,9,10,72,50,22,60
Alloa,8927,4,17,8,11,57,48,9,59
Stranraer,8927,5,16,5,15,57,64,-7,53
Airdrieon,8927,6,11,11,14,48,59,-11,44
East Fife,8927,7,13,3,20,47,66,-19,42
Forfar,8927,8,10,5,21,39,67,-28,35
Albion,8927,9,8,6,22,58,81,-23,30
Queen's Park,8927,10,6,11,19,41,74,-33,29
Raith,8928,1,23,8,5,74,33,41,77
Ayr,8928,2,24,4,8,92,43,49,76
Arbroath,8928,3,17,9,10,73,51,22,60
Alloa,8928,4,17,8,11,57,49,8,59
Stranraer,8928,5,15,5,16,56,67,-11,50
East Fife,8928,6,14,3,19,50,65,-15,45
Airdrieon,8928,7,11,11,14,47,58,-11,44
Forfar,8928,8,10,5,21,38,66,-28,35
Albion,8928,9,8,6,22,58,80,-22,30
Queen's Park,8928,10,6,11,19,42,75,-33,29
Raith,8929,1,22,8,6,68,34,34,74
Ayr,8929,2,23,4,9,93,47,46,73
Alloa,8929,3,18,8,10,58,43,15,62
Arbroath,8929,4,17,8,11,72,51,21,59
Stranraer,8929,5,15,5,16,55,67,-12,50
East Fife,8929,6,14,3,19,50,64,-14,45
Airdrieon,8929,7,11,11,14,47,59,-12,44
Forfar,8929,8,10,5,21,39,66,-27,35
Albion,8929,9,9,6,21,62,81,-19,33
Queen's Park,8929,10,7,10,19,42,74,-32,31
Raith,8930,1,23,8,5,71,32,39,77
Ayr,8930,2,24,4,8,94,43,51,76
Arbroath,8930,3,18,8,10,73,48,25,62
Alloa,8930,4,17,8,11,56,46,10,59
Stranraer,8930,5,15,6,15,56,65,-9,51
Airdrieon,8930,6,11,11,14,46,58,-12,44
East Fife,8930,7,13,4,19,48,65,-17,43
Forfar,8930,8,10,5,21,38,65,-27,35
Albion,8930,9,8,6,22,58,82,-24,30
Queen's Park,8930,10,6,10,20,39,75,-36,28
Ayr,8931,1,24,4,8,94,44,50,76
Raith,8931,2,22,8,6,69,34,35,74
Arbroath,8931,3,18,8,10,71,48,23,62
Alloa,8931,4,18,8,10,58,44,14,62
Stranraer,8931,5,15,6,15,57,66,-9,51
Airdrieon,8931,6,11,11,14,47,58,-11,44
East Fife,8931,7,13,4,19,49,66,-17,43
Forfar,8931,8,10,5,21,38,66,-28,35
Albion,8931,9,8,6,22,59,82,-23,30
Queen's Park,8931,10,6,10,20,39,73,-34,28
Ayr,8932,1,24,4,8,93,42,51,76
Raith,8932,2,22,9,5,68,32,36,75
Alloa,8932,3,17,9,10,56,43,13,60
Arbroath,8932,4,17,8,11,70,50,20,59
Stranraer,8932,5,15,5,16,56,66,-10,50
East Fife,8932,6,14,3,19,49,65,-16,45
Airdrieon,8932,7,10,12,14,45,58,-13,42
Forfar,8932,8,10,6,20,38,64,-26,36
Queen's Park,8932,9,7,10,19,41,72,-31,31
Albion,8932,10,8,6,22,57,81,-24,30
Raith,8933,1,23,8,5,70,32,38,77
Ayr,8933,2,23,5,8,92,44,48,74
Arbroath,8933,3,17,8,11,71,50,21,59
Alloa,8933,4,17,8,11,56,45,11,59
Stranraer,8933,5,15,5,16,55,65,-10,50
East Fife,8933,6,14,3,19,48,64,-16,45
Airdrieon,8933,7,10,11,15,45,59,-14,41
Forfar,8933,8,11,5,20,39,64,-25,38
Albion,8933,9,8,7,21,59,80,-21,31
Queen's Park,8933,10,7,10,19,41,73,-32,31
Raith,8934,1,23,8,5,72,34,38,77
Ayr,8934,2,24,4,8,93,44,49,76
Arbroath,8934,3,18,8,10,73,49,24,62
Alloa,8934,4,17,8,11,58,47,11,59
Stranraer,8934,5,15,5,16,55,66,-11,50
East Fife,8934,6,14,3,19,49,64,-15,45
Airdrieon,8934,7,11,11,14,46,58,-12,44
Forfar,8934,8,10,5,21,38,65,-27,35
Albion,8934,9,8,6,22,59,81,-22,30
Queen's Park,8934,10,6,10,20,40,75,-35,28
Raith,8935,1,23,8,5,69,32,37,77
Ayr,8935,2,24,4,8,92,43,49,76
Arbroath,8935,3,18,8,10,75,48,27,62
Alloa,8935,4,17,8,11,56,44,12,59
Stranraer,8935,5,15,5,16,56,66,-10,50
East Fife,8935,6,14,3,19,49,65,-16,45
Airdrieon,8935,7,10,12,14,46,59,-13,42
Forfar,8935,8,10,6,20,39,65,-26,36
Albion,8935,9,8,6,22,58,80,-22,30
Queen's Park,8935,10,6,10,20,39,77,-38,28
Ayr,8936,1,24,4,8,92,43,49,76
Raith,8936,2,22,9,5,69,33,36,75
Alloa,8936,3,17,9,10,57,44,13,60
Arbroath,8936,4,17,8,11,73,53,20,59
Stranraer,8936,5,15,5,16,55,66,-11,50
East Fife,8936,6,14,3,19,49,64,-15,45
Airdrieon,8936,7,11,11,14,47,59,-12,44
Forfar,8936,8,10,5,21,39,66,-27,35
Queen's Park,8936,9,7,10,19,44,75,-31,31
Albion,8936,10,8,6,22,58,80,-22,30
Raith,8937,1,23,8,5,70,33,37,77
Ayr,8937,2,23,5,8,93,45,48,74
Arbroath,8937,3,18,8,10,73,50,23,62
Alloa,8937,4,17,8,11,57,45,12,59
Stranraer,8937,5,15,5,16,55,68,-13,50
East Fife,8937,6,14,3,19,51,64,-13,45
Airdrieon,8937,7,10,12,14,45,58,-13,42
Forfar,8937,8,10,6,20,38,64,-26,36
Albion,8937,9,8,7,21,60,81,-21,31
Queen's Park,8937,10,6,10,20,41,75,-34,28
Ayr,8938,1,23,5,8,92,44,48,74
Raith,8938,2,22,8,6,70,35,35,74
Alloa,8938,3,18,8,10,59,45,14,62
Arbroath,8938,4,17,9,10,71,49,22,60
Stranraer,8938,5,16,5,15,58,65,-7,53
East Fife,8938,6,13,3,20,48,67,-19,42
Airdrieon,8938,7,10,11,15,46,60,-14,41
Forfar,8938,8,11,5,20,40,65,-25,38
Albion,8938,9,8,7,21,59,80,-21,31
Queen's Park,8938,10,6,11,19,40,73,-33,29
Ayr,8939,1,24,4,8,93,43,50,76
Raith,8939,2,22,9,5,70,34,36,75
Arbroath,8939,3,17,9,10,71,49,22,60
Alloa,8939,4,17,9,10,58,45,13,60
Stranraer,8939,5,15,5,16,55,66,-11,50
East Fife,8939,6,14,3,19,49,64,-15,45
Airdrieon,8939,7,11,11,14,48,58,-10,44
Forfar,8939,8,10,5,21,38,67,-29,35
Albion,8939,9,8,6,22,58,81,-23,30
Queen's Park,8939,10,6,11,19,40,73,-33,29
Raith,8940,1,23,8,5,69,32,37,77
Ayr,8940,2,24,4,8,97,42,55,76
Arbroath,8940,3,18,8,10,73,48,25,62
Alloa,8940,4,17,8,11,56,44,12,59
Stranraer,8940,5,16,5,15,59,65,-6,53
East Fife,8940,6,13,3,20,48,68,-20,42
Airdrieon,8940,7,10,11,15,45,60,-15,41
Forfar,8940,8,11,5,20,40,64,-24,38
Albion,8940,9,8,6,22,57,85,-28,30
Queen's Park,8940,10,6,10,20,39,75,-36,28
Raith,8941,1,23,8,5,71,33,38,77
Ayr,8941,2,24,4,8,95,45,50,76
Arbroath,8941,3,18,8,10,72,48,24,62
Alloa,8941,4,17,8,11,57,46,11,59
Stranraer,8941,5,15,5,16,57,68,-11,50
East Fife,8941,6,14,3,19,51,66,-15,45
Airdrieon,8941,7,11,11,14,51,59,-8,44
Forfar,8941,8,10,5,21,39,70,-31,35
Albion,8941,9,8,6,22,60,83,-23,30
Queen's Park,8941,10,6,10,20,39,74,-35,28
Ayr,8942,1,24,4,8,95,44,51,76
Raith,8942,2,22,9,5,69,33,36,75
Arbroath,8942,3,17,9,10,71,49,22,60
Alloa,8942,4,17,9,10,57,44,13,60
Stranraer,8942,5,16,5,15,59,65,-6,53
Airdrieon,8942,6,11,11,14,48,58,-10,44
East Fife,8942,7,13,3,20,48,68,-20,42
Forfar,8942,8,10,5,21,38,67,-29,35
Albion,8942,9,8,6,22,59,83,-24,30
Queen's Park,8942,10,6,11,19,40,73,-33,29
Raith,8943,1,23,8,5,73,35,38,77
Ayr,8943,2,24,4,8,93,43,50,76
Arbroath,8943,3,18,8,10,71,48,23,62
Alloa,8943,4,17,8,11,59,48,11,59
Stranraer,8943,5,15,5,16,56,66,-10,50
East Fife,8943,6,14,3,19,49,65,-16,45
Airdrieon,8943,7,11,11,14,49,58,-9,44
Forfar,8943,8,10,5,21,38,68,-30,35
Albion,8943,9,8,6,22,58,81,-23,30
Queen's Park,8943,10,6,10,20,39,73,-34,28
Raith,8944,1,23,8,5,70,33,37,77
Ayr,8944,2,24,4,8,95,43,52,76
Arbroath,8944,3,18,8,10,72,49,23,62
Alloa,8944,4,17,8,11,57,45,12,59
Stranraer,8944,5,16,5,15,58,66,-8,53
East Fife,8944,6,13,3,20,49,67,-18,42
Airdrieon,8944,7,10,11,15,46,60,-14,41
Forfar,8944,8,11,5,20,40,65,-25,38
Albion,8944,9,8,6,22,58,83,-25,30
Queen's Park,8944,10,6,10,20,40,74,-34,28
Raith,8945,1,23,8,5,72,33,39,77
Ayr,8945,2,24,4,8,94,43,51,76
Arbroath,8945,3,18,8,10,72,49,23,62
Alloa,8945,4,17,8,11,57,47,10,59
Stranraer,8945,5,15,5,16,57,68,-11,50
East Fife,8945,6,14,3,19,51,66,-15,45
Airdrieon,8945,7,11,11,14,47,59,-12,44
Forfar,8945,8,10,5,21,39,66,-27,35
Albion,8945,9,8,6,22,58,82,-24,30
Queen's Park,8945,10,6,10,20,40,74,-34,28
Ayr,8946,1,24,4,8,94,45,49,76
Raith,8946,2,22,8,6,70,35,35,74
Alloa,8946,3,18,8,10,59,45,14,62
Arbroath,8946,4,17,8,11,72,52,20,59
Stranraer,8946,5,15,6,15,56,65,-9,51
Airdrieon,8946,6,11,11,14,47,58,-11,44
East Fife,8946,7,13,4,19,48,65,-17,43
Forfar,8946,8,10,5,21,38,66,-28,35
Queen's Park,8946,9,7,10,19,43,74,-31,31
Albion,8946,10,8,6,22,60,82,-22,30
Ayr,8947,1,24,4,8,93,42,51,76
Raith,8947,2,22,8,6,69,34,35,74
Arbroath,8947,3,18,8,10,72,49,23,62
Alloa,8947,4,18,8,10,58,44,14,62
Stranraer,8947,5,15,6,15,56,65,-9,51
Airdrieon,8947,6,11,11,14,49,59,-10,44
East Fife,8947,7,13,4,19,48,65,-17,43
Forfar,8947,8,10,5,21,39,68,-29,35
Albion,8947,9,8,6,22,57,81,-24,30
Queen's Park,8947,10,6,10,20,40,74,-34,28
Raith,8948,1,23,8,5,71,34,37,77
Ayr,8948,2,24,4,8,92,43,49,76
Arbroath,8948,3,17,9,10,71,49,22,60
Alloa,8948,4,17,8,11,58,46,12,59
Stranraer,8948,5,16,5,15,57,65,-8,53
Airdrieon,8948,6,11,11,14,46,58,-12,44
East Fife,8948,7,13,3,20,48,66,-18,42
Forfar,8948,8,10,5,21,38,65,-27,35
Albion,8948,9,8,6,22,58,80,-22,30
Queen's Park,8948,10,6,11,19,40,73,-33,29
Raith,8949,1,23,8,5,70,32,38,77
Ayr,8949,2,23,5,8,92,44,48,74
Arbroath,8949,3,17,9,10,72,50,22,60
Alloa,8949,4,17,8,11,56,45,11,59
Stranraer,8949,5,15,5,16,55,65,-10,50
East Fife,8949,6,14,3,19,48,64,-16,45
Airdrieon,8949,7,11,11,14,46,58,-12,44
Forfar,8949,8,10,5,21,38,65,-27,35
Albion,8949,9,8,7,21,59,80,-21,31
Queen's Park,8949,10,6,11,19,41,74,-33,29
Ayr,8950,1,24,4,8,95,43,52,76
Raith,8950,2,22,8,6,69,36,33,74
Alloa,8950,3,18,8,10,60,44,16,62
Arbroath,8950,4,17,8,11,70,49,21,59
Stranraer,8950,5,16,5,15,57,64,-7,53
Airdrieon,8950,6,11,11,14,46,58,-12,44
East Fife,8950,7,13,3,20,47,66,-19,42
Forfar,8950,8,10,5,21,38,65,-27,35
Queen's Park,8950,9,7,10,19,40,72,-32,31
Albion,8950,10,8,6,22,58,83,-25,30
Raith,8951,1,23,8,5,70,32,38,77
Ayr,8951,2,24,4,8,93,42,51,76
Arbroath,8951,3,18,8,10,72,48,24,62
Alloa,8951,4,17,8,11,56,45,11,59
Stranraer,8951,5,15,5,16,57,67,-10,50
East Fife,8951,6,14,3,19,50,66,-16,45
Airdrieon,8951,7,10,11,15,45,60,-15,41
Forfar,8951,8,11,5,20,40,64,-24,38
Albion,8951,9,8,6,22,57,81,-24,30
Queen's Park,8951,10,6,10,20,39,74,-35,28
Ayr,8952,1,23,5,8,92,44,48,74
Raith,8952,2,22,8,6,68,34,34,74
Alloa,8952,3,18,8,10,58,43,15,62
Arbroath,8952,4,17,8,11,71,51,20,59
Stranraer,8952,5,15,6,15,56,65,-9,51
Airdrieon,8952,6,11,11,14,47,59,-12,44
East Fife,8952,7,13,4,19,48,65,-17,43
Forfar,8952,8,10,5,21,39,66,-27,35
Albion,8952,9,8,7,21,59,80,-21,31
Queen's Park,8952,10,7,10,19,42,73,-31,31
Raith,8953,1,23,8,5,70,32,38,77
Ayr,8953,2,24,4,8,95,45,50,76
Arbroath,8953,3,17,9,10,72,50,22,60
Alloa,8953,4,17,8,11,56,45,11,59
Stranraer,8953,5,16,5,15,56,64,-8,53
Airdrieon,8953,6,11,11,14,47,58,-11,44
East Fife,8953,7,13,3,20,47,65,-18,42
Forfar,8953,8,10,5,21,38,66,-28,35
Albion,8953,9,8,6,22,60,83,-23,30
Queen's Park,8953,10,6,11,19,41,74,-33,29
Raith,8954,1,23,8,5,70,33,37,77
Ayr,8954,2,24,4,8,93,42,51,76
Arbroath,8954,3,17,8,11,71,51,20,59
Alloa,8954,4,17,8,11,57,45,12,59
Stranraer,8954,5,16,5,15,58,64,-6,53
Airdrieon,8954,6,11,11,14,47,58,-11,44
East Fife,8954,7,13,3,20,47,67,-20,42
Forfar,8954,8,10,5,21,38,66,-28,35
Queen's Park,8954,9,7,10,19,42,73,-31,31
Albion,8954,10,8,6,22,57,81,-24,30
Ayr,8955,1,24,4,8,93,43,50,76
Raith,8955,2,22,9,5,71,35,36,75
Alloa,8955,3,17,9,10,59,46,13,60
Arbroath,8955,4,17,8,11,71,50,21,59
Stranraer,8955,5,16,5,15,58,65,-7,53
Airdrieon,8955,6,11,11,14,49,60,-11,44
East Fife,8955,7,13,3,20,48,67,-19,42
Forfar,8955,8,10,5,21,40,68,-28,35
Queen's Park,8955,9,7,10,19,41,73,-32,31
Albion,8955,10,8,6,22,58,81,-23,30
Raith,8956,1,23,8,5,74,32,42,77
Ayr,8956,2,24,4,8,94,43,51,76
Arbroath,8956,3,17,8,11,70,50,20,59
Alloa,8956,4,17,8,11,56,49,7,59
Stranraer,8956,5,15,5,16,55,67,-12,50
East Fife,8956,6,14,3,19,50,64,-14,45
Airdrieon,8956,7,11,11,14,48,59,-11,44
Forfar,8956,8,10,5,21,39,67,-28,35
Queen's Park,8956,9,7,10,19,41,72,-31,31
Albion,8956,10,8,6,22,58,82,-24,30
Ayr,8957,1,24,4,8,94,42,52,76
Raith,8957,2,22,9,5,68,32,36,75
Arbroath,8957,3,17,9,10,70,48,22,60
Alloa,8957,4,17,9,10,56,43,13,60
Stranraer,8957,5,16,5,15,59,64,-5,53
Airdrieon,8957,6,11,11,14,49,59,-10,44
East Fife,8957,7,13,3,20,47,68,-21,42
Forfar,8957,8,10,5,21,39,68,-29,35
Albion,8957,9,8,6,22,57,82,-25,30
Queen's Park,8957,10,6,11,19,39,72,-33,29
Raith,8958,1,23,8,5,69,32,37,77
Ayr,8958,2,23,4,9,91,44,47,73
Arbroath,8958,3,18,8,10,74,48,26,62
Alloa,8958,4,17,8,11,56,44,12,59
Stranraer,8958,5,15,5,16,55,66,-11,50
East Fife,8958,6,14,3,19,49,64,-15,45
Airdrieon,8958,7,10,12,14,45,58,-13,42
Forfar,8958,8,10,6,20,38,64,-26,36
Albion,8958,9,9,6,21,59,79,-20,33
Queen's Park,8958,10,6,10,20,39,76,-37,28
Ayr,8959,1,24,4,8,94,43,51,76
Raith,8959,2,22,9,5,69,33,36,75
Arbroath,8959,3,18,8,10,73,49,24,62
Alloa,8959,4,17,9,10,57,44,13,60
Stranraer,8959,5,15,5,16,55,65,-10,50
East Fife,8959,6,14,3,19,48,64,-16,45
Airdrieon,8959,7,10,11,15,45,60,-15,41
Forfar,8959,8,11,5,20,40,64,-24,38
Albion,8959,9,8,6,22,58,82,-24,30
Queen's Park,8959,10,6,10,20,40,75,-35,28
Raith,8960,1,23,8,5,72,32,40,77
Ayr,8960,2,24,4,8,93,43,50,76
Arbroath,8960,3,17,9,10,71,49,22,60
Alloa,8960,4,17,8,11,56,47,9,59
Stranraer,8960,5,16,5,15,58,65,-7,53
Airdrieon,8960,6,10,12,14,46,59,-13,42
East Fife,8960,7,13,3,20,48,67,-19,42
Forfar,8960,8,10,6,20,39,65,-26,36
Albion,8960,9,8,6,22,58,81,-23,30
Queen's Park,8960,10,6,11,19,40,73,-33,29
Raith,8961,1,23,8,5,72,34,38,77
Ayr,8961,2,24,4,8,91,42,49,76
Arbroath,8961,3,18,8,10,73,49,24,62
Alloa,8961,4,17,8,11,58,47,11,59
Stranraer,8961,5,15,5,16,57,67,-10,50
East Fife,8961,6,14,3,19,50,66,-16,45
Airdrieon,8961,7,10,11,15,45,60,-15,41
Forfar,8961,8,11,5,20,40,64,-24,38
Albion,8961,9,8,6,22,57,79,-22,30
Queen's Park,8961,10,6,10,20,40,75,-35,28
Raith,8962,1,23,8,5,69,32,37,77
Ayr,8962,2,24,4,8,92,42,50,76
Arbroath,8962,3,18,8,10,72,49,23,62
Alloa,8962,4,17,8,11,56,44,12,59
Stranraer,8962,5,16,5,15,57,65,-8,53
Airdrieon,8962,6,10,12,14,46,59,-13,42
East Fife,8962,7,13,3,20,48,66,-18,42
Forfar,8962,8,10,6,20,39,65,-26,36
Albion,8962,9,8,6,22,57,80,-23,30
Queen's Park,8962,10,6,10,20,40,74,-34,28
Raith,8963,1,23,8,5,70,33,37,77
Ayr,8963,2,24,4,8,94,45,49,76
Arbroath,8963,3,18,8,10,73,48,25,62
Alloa,8963,4,17,8,11,57,45,12,59
Stranraer,8963,5,15,5,16,55,66,-11,50
East Fife,8963,6,14,3,19,49,64,-15,45
Airdrieon,8963,7,10,11,15,47,61,-14,41
Forfar,8963,8,11,5,20,41,66,-25,38
Albion,8963,9,8,6,22,60,82,-22,30
Queen's Park,8963,10,6,10,20,39,75,-36,28
Raith,8964,1,23,8,5,72,32,40,77
Ayr,8964,2,24,4,8,98,46,52,76
Arbroath,8964,3,18,8,10,73,49,24,62
Alloa,8964,4,17,8,11,56,47,9,59
Stranraer,8964,5,16,5,15,59,64,-5,53
East Fife,8964,6,13,3,20,47,68,-21,42
Airdrieon,8964,7,10,11,15,45,60,-15,41
Forfar,8964,8,11,5,20,40,64,-24,38
Albion,8964,9,8,6,22,61,86,-25,30
Queen's Park,8964,10,6,10,20,40,75,-35,28
Raith,8965,1,22,9,5,69,33,36,75
Ayr,8965,2,23,4,9,91,44,47,73
Arbroath,8965,3,18,8,10,71,48,23,62
Alloa,8965,4,17,9,10,57,44,13,60
Stranraer,8965,5,15,6,15,57,66,-9,51
Airdrieon,8965,6,11,11,14,47,59,-12,44
East Fife,8965,7,13,4,19,49,66,-17,43
Forfar,8965,8,10,5,21,39,66,-27,35
Albion,8965,9,9,6,21,59,79,-20,33
Queen's Park,8965,10,6,10,20,39,73,-34,28
Raith,8966,1,23,8,5,72,32,40,77
Ayr,8966,2,23,4,9,91,44,47,73
Arbroath,8966,3,17,9,10,71,49,22,60
Alloa,8966,4,17,8,11,56,47,9,59
Stranraer,8966,5,16,5,15,56,64,-8,53
East Fife,8966,6,13,3,20,47,65,-18,42
Airdrieon,8966,7,10,11,15,48,63,-15,41
Forfar,8966,8,11,5,20,43,67,-24,38
Albion,8966,9,9,6,21,59,79,-20,33
Queen's Park,8966,10,6,11,19,40,73,-33,29
Raith,8967,1,23,8,5,72,32,40,77
Ayr,8967,2,24,4,8,96,43,53,76
Arbroath,8967,3,18,8,10,74,48,26,62
Alloa,8967,4,17,8,11,56,47,9,59
Stranraer,8967,5,15,5,16,55,65,-10,50
East Fife,8967,6,14,3,19,48,64,-16,45
Airdrieon,8967,7,10,12,14,46,59,-13,42
Forfar,8967,8,10,6,20,39,65,-26,36
Albion,8967,9,8,6,22,58,84,-26,30
Queen's Park,8967,10,6,10,20,39,76,-37,28
Ayr,8968,1,24,4,8,94,43,51,76
Raith,8968,2,22,9,5,70,34,36,75
Arbroath,8968,3,18,8,10,74,49,25,62
Alloa,8968,4,17,9,10,58,45,13,60
Stranraer,8968,5,16,5,15,59,65,-6,53
Airdrieon,8968,6,10,12,14,47,60,-13,42
East Fife,8968,7,13,3,20,48,68,-20,42
Forfar,8968,8,10,6,20,40,66,-26,36
Albion,8968,9,8,6,22,58,82,-24,30
Queen's Park,8968,10,6,10,20,40,76,-36,28
Raith,8969,1,23,8,5,69,32,37,77
Ayr,8969,2,24,4,8,97,42,55,76
Arbroath,8969,3,18,8,10,73,49,24,62
Alloa,8969,4,17,8,11,56,44,12,59
Stranraer,8969,5,15,5,16,55,66,-11,50
East Fife,8969,6,14,3,19,49,64,-15,45
Airdrieon,8969,7,10,12,14,46,59,-13,42
Forfar,8969,8,10,6,20,39,65,-26,36
Albion,8969,9,8,6,22,57,85,-28,30
Queen's Park,8969,10,6,10,20,40,75,-35,28
Ayr,8970,1,24,4,8,95,43,52,76
Raith,8970,2,22,8,6,68,34,34,74
Alloa,8970,3,18,8,10,58,43,15,62
Arbroath,8970,4,17,8,11,70,49,21,59
Stranraer,8970,5,15,6,15,56,65,-9,51
East Fife,8970,6,13,4,19,48,65,-17,43
Airdrieon,8970,7,10,12,14,45,58,-13,42
Forfar,8970,8,10,6,20,38,64,-26,36
Queen's Park,8970,9,7,10,19,40,72,-32,31
Albion,8970,10,8,6,22,58,83,-25,30
Ayr,8971,1,24,4,8,92,42,50,76
Raith,8971,2,22,9,5,70,34,36,75
Arbroath,8971,3,17,9,10,71,49,22,60
Alloa,8971,4,17,9,10,58,45,13,60
Stranraer,8971,5,15,5,16,55,66,-11,50
East Fife,8971,6,14,3,19,49,64,-15,45
Airdrieon,8971,7,10,11,15,45,61,-16,41
Forfar,8971,8,11,5,20,41,64,-23,38
Albion,8971,9,8,6,22,57,80,-23,30
Queen's Park,8971,10,6,11,19,40,73,-33,29
Ayr,8972,1,24,4,8,95,44,51,76
Raith,8972,2,22,9,5,71,35,36,75
Arbroath,8972,3,17,9,10,72,50,22,60
Alloa,8972,4,17,9,10,59,46,13,60
Stranraer,8972,5,16,5,15,56,64,-8,53
Airdrieon,8972,6,11,11,14,48,58,-10,44
East Fife,8972,7,13,3,20,47,65,-18,42
Forfar,8972,8,10,5,21,38,67,-29,35
Albion,8972,9,8,6,22,59,83,-24,30
Queen's Park,8972,10,6,11,19,41,74,-33,29
Raith,8973,1,23,8,5,71,32,39,77
Ayr,8973,2,24,4,8,93,42,51,76
Arbroath,8973,3,18,8,10,71,48,23,62
Alloa,8973,4,17,8,11,56,46,10,59
Stranraer,8973,5,15,6,15,57,66,-9,51
Airdrieon,8973,6,11,11,14,48,58,-10,44
East Fife,8973,7,13,4,19,49,66,-17,43
Forfar,8973,8,10,5,21,38,67,-29,35
Albion,8973,9,8,6,22,57,81,-24,30
Queen's Park,8973,10,6,10,20,39,73,-34,28
Ayr,8974,1,24,4,8,93,43,50,76
Raith,8974,2,22,9,5,69,33,36,75
Alloa,8974,3,17,9,10,57,44,13,60
Arbroath,8974,4,17,8,11,70,51,19,59
Stranraer,8974,5,16,5,15,57,64,-7,53
East Fife,8974,6,13,3,20,47,66,-19,42
Airdrieon,8974,7,10,11,15,45,60,-15,41
Forfar,8974,8,11,5,20,40,64,-24,38
Queen's Park,8974,9,7,10,19,42,72,-30,31
Albion,8974,10,8,6,22,58,81,-23,30
Raith,8975,1,23,8,5,69,32,37,77
Ayr,8975,2,24,4,8,93,43,50,76
Arbroath,8975,3,17,8,11,72,52,20,59
Alloa,8975,4,17,8,11,56,44,12,59
Stranraer,8975,5,15,6,15,56,65,-9,51
Airdrieon,8975,6,11,11,14,47,58,-11,44
East Fife,8975,7,13,4,19,48,65,-17,43
Forfar,8975,8,10,5,21,38,66,-28,35
Queen's Park,8975,9,7,10,19,43,74,-31,31
Albion,8975,10,8,6,22,58,81,-23,30
Raith,8976,1,23,8,5,69,32,37,77
Ayr,8976,2,24,4,8,96,42,54,76
Arbroath,8976,3,18,8,10,71,48,23,62
Alloa,8976,4,17,8,11,56,44,12,59
Stranraer,8976,5,16,5,15,59,66,-7,53
East Fife,8976,6,13,3,20,49,68,-19,42
Airdrieon,8976,7,10,11,15,46,60,-14,41
Forfar,8976,8,11,5,20,40,65,-25,38
Albion,8976,9,8,6,22,57,84,-27,30
Queen's Park,8976,10,6,10,20,39,73,-34,28
Raith,8977,1,23,8,5,70,32,38,77
Ayr,8977,2,23,5,8,92,44,48,74
Arbroath,8977,3,18,8,10,74,48,26,62
Alloa,8977,4,17,8,11,56,45,11,59
Stranraer,8977,5,15,6,15,56,65,-9,51
East Fife,8977,6,13,4,19,48,65,-17,43
Airdrieon,8977,7,10,12,14,47,60,-13,42
Forfar,8977,8,10,6,20,40,66,-26,36
Albion,8977,9,8,7,21,59,80,-21,31
Queen's Park,8977,10,6,10,20,39,76,-37,28
Raith,8978,1,23,8,5,71,33,38,77
Ayr,8978,2,23,5,8,92,44,48,74
Arbroath,8978,3,17,9,10,71,49,22,60
Alloa,8978,4,17,8,11,57,46,11,59
Stranraer,8978,5,15,5,16,55,66,-11,50
East Fife,8978,6,14,3,19,49,64,-15,45
Airdrieon,8978,7,10,12,14,46,59,-13,42
Forfar,8978,8,10,6,20,39,65,-26,36
Albion,8978,9,8,7,21,59,80,-21,31
Queen's Park,8978,10,6,11,19,40,73,-33,29
Raith,8979,1,23,8,5,69,32,37,77
Ayr,8979,2,24,4,8,95,43,52,76
Arbroath,8979,3,18,8,10,71,48,23,62
Alloa,8979,4,17,8,11,56,44,12,59
Stranraer,8979,5,16,5,15,59,66,-7,53
Airdrieon,8979,6,11,11,14,46,58,-12,44
East Fife,8979,7,13,3,20,49,68,-19,42
Forfar,8979,8,10,5,21,38,65,-27,35
Albion,8979,9,8,6,22,58,83,-25,30
Queen's Park,8979,10,6,10,20,39,73,-34,28
Raith,8980,1,23,8,5,71,34,37,77
Ayr,8980,2,24,4,8,94,43,51,76
Arbroath,8980,3,17,8,11,70,49,21,59
Alloa,8980,4,17,8,11,58,46,12,59
Stranraer,8980,5,15,6,15,57,66,-9,51
East Fife,8980,6,13,4,19,49,66,-17,43
Airdrieon,8980,7,10,12,14,46,59,-13,42
Forfar,8980,8,10,6,20,39,65,-26,36
Queen's Park,8980,9,7,10,19,40,72,-32,31
Albion,8980,10,8,6,22,58,82,-24,30
Raith,8981,1,23,8,5,69,32,37,77
Ayr,8981,2,24,4,8,93,43,50,76
Arbroath,8981,3,18,8,10,73,50,23,62
Alloa,8981,4,17,8,11,56,44,12,59
Stranraer,8981,5,16,5,15,59,67,-8,53
East Fife,8981,6,13,3,20,50,68,-18,42
Airdrieon,8981,7,10,11,15,45,60,-15,41
Forfar,8981,8,11,5,20,40,64,-24,38
Albion,8981,9,8,6,22,58,81,-23,30
Queen's Park,8981,10,6,10,20,41,75,-34,28
Raith,8982,1,23,8,5,69,32,37,77
Ayr,8982,2,24,4,8,91,42,49,76
Arbroath,8982,3,18,8,10,72,48,24,62
Alloa,8982,4,17,8,11,56,44,12,59
Stranraer,8982,5,15,5,16,55,67,-12,50
East Fife,8982,6,14,3,19,50,64,-14,45
Airdrieon,8982,7,11,11,14,48,58,-10,44
Forfar,8982,8,10,5,21,38,67,-29,35
Albion,8982,9,8,6,22,57,79,-22,30
Queen's Park,8982,10,6,10,20,39,74,-35,28
Raith,8983,1,23,8,5,70,32,38,77
Ayr,8983,2,24,4,8,95,42,53,76
Arbroath,8983,3,17,9,10,73,51,22,60
Alloa,8983,4,17,8,11,56,45,11,59
Stranraer,8983,5,15,6,15,56,65,-9,51
East Fife,8983,6,13,4,19,48,65,-17,43
Airdrieon,8983,7,10,12,14,46,59,-13,42
Forfar,8983,8,10,6,20,39,65,-26,36
Albion,8983,9,8,6,22,57,83,-26,30
Queen's Park,8983,10,6,11,19,42,75,-33,29
Raith,8984,1,23,8,5,70,33,37,77
Ayr,8984,2,24,4,8,92,43,49,76
Arbroath,8984,3,17,8,11,70,49,21,59
Alloa,8984,4,17,8,11,57,45,12,59
Stranraer,8984,5,16,5,15,56,64,-8,53
East Fife,8984,6,13,3,20,47,65,-18,42
Airdrieon,8984,7,10,11,15,46,61,-15,41
Forfar,8984,8,11,5,20,41,65,-24,38
Queen's Park,8984,9,7,10,19,40,72,-32,31
Albion,8984,10,8,6,22,58,80,-22,30
Ayr,8985,1,24,4,8,92,43,49,76
Raith,8985,2,22,8,6,68,33,35,74
Alloa,8985,3,18,8,10,57,43,14,62
Arbroath,8985,4,17,8,11,71,50,21,59
Stranraer,8985,5,16,5,15,58,66,-8,53
Airdrieon,8985,6,11,11,14,49,59,-10,44
East Fife,8985,7,13,3,20,49,67,-18,42
Forfar,8985,8,10,5,21,39,68,-29,35
Queen's Park,8985,9,7,10,19,41,73,-32,31
Albion,8985,10,8,6,22,58,80,-22,30
Raith,8986,1,23,8,5,70,32,38,77
Ayr,8986,2,23,4,9,90,44,46,73
Arbroath,8986,3,18,8,10,75,50,25,62
Alloa,8986,4,17,8,11,56,45,11,59
Stranraer,8986,5,16,5,15,58,65,-7,53
Airdrieon,8986,6,10,12,14,47,60,-13,42
East Fife,8986,7,13,3,20,48,67,-19,42
Forfar,8986,8,10,6,20,40,66,-26,36
Albion,8986,9,9,6,21,59,78,-19,33
Queen's Park,8986,10,6,10,20,41,77,-36,28
Raith,8987,1,23,8,5,72,34,38,77
Ayr,8987,2,23,4,9,95,48,47,73
Arbroath,8987,3,18,8,10,73,49,24,62
Alloa,8987,4,17,8,11,58,47,11,59
Stranraer,8987,5,15,5,16,55,66,-11,50
East Fife,8987,6,14,3,19,49,64,-15,45
Airdrieon,8987,7,10,11,15,46,60,-14,41
Forfar,8987,8,11,5,20,40,65,-25,38
Albion,8987,9,9,6,21,63,83,-20,33
Queen's Park,8987,10,6,10,20,40,75,-35,28
Raith,8988,1,22,9,5,70,34,36,75
Ayr,8988,2,23,5,8,92,44,48,74
Arbroath,8988,3,18,8,10,71,48,23,62
Alloa,8988,4,17,9,10,58,45,13,60
Stranraer,8988,5,15,5,16,56,66,-10,50
East Fife,8988,6,14,3,19,49,65,-16,45
Airdrieon,8988,7,11,11,14,47,59,-12,44
Forfar,8988,8,10,5,21,39,66,-27,35
Albion,8988,9,8,7,21,59,80,-21,31
Queen's Park,8988,10,6,10,20,39,73,-34,28
Raith,8989,1,23,8,5,70,32,38,77
Ayr,8989,2,24,4,8,91,42,49,76
Arbroath,8989,3,17,9,10,72,50,22,60
Alloa,8989,4,17,8,11,56,45,11,59
Stranraer,8989,5,15,6,15,55,64,-9,51
Airdrieon,8989,6,11,11,14,47,58,-11,44
East Fife,8989,7,13,4,19,47,64,-17,43
Forfar,8989,8,10,5,21,38,66,-28,35
Albion,8989,9,8,6,22,57,79,-22,30
Queen's Park,8989,10,6,11,19,41,74,-33,29
Ayr,8990,1,24,4,8,97,44,53,76
Raith,8990,2,22,8,6,68,33,35,74
Alloa,8990,3,18,8,10,57,43,14,62
Arbroath,8990,4,17,9,10,71,49,22,60
Stranraer,8990,5,16,5,15,56,64,-8,53
Airdrieon,8990,6,11,11,14,49,58,-9,44
East Fife,8990,7,13,3,20,47,65,-18,42
Forfar,8990,8,10,5,21,38,68,-30,35
Albion,8990,9,8,6,22,59,85,-26,30
Queen's Park,8990,10,6,11,19,40,73,-33,29
Ayr,8991,1,24,4,8,94,43,51,76
Raith,8991,2,22,9,5,70,34,36,75
Alloa,8991,3,17,9,10,58,45,13,60
Arbroath,8991,4,17,8,11,72,52,20,59
Stranraer,8991,5,15,5,16,55,66,-11,50
East Fife,8991,6,14,3,19,49,64,-15,45
Airdrieon,8991,7,11,11,14,47,59,-12,44
Forfar,8991,8,10,5,21,39,66,-27,35
Queen's Park,8991,9,7,10,19,43,74,-31,31
Albion,8991,10,8,6,22,58,82,-24,30
Raith,8992,1,23,8,5,69,32,37,77
Ayr,8992,2,23,4,9,90,45,45,73
Arbroath,8992,3,18,8,10,71,48,23,62
Alloa,8992,4,17,8,11,56,44,12,59
Stranraer,8992,5,15,5,16,56,66,-10,50
East Fife,8992,6,14,3,19,49,65,-16,45
Airdrieon,8992,7,10,12,14,48,61,-13,42
Forfar,8992,8,10,6,20,41,67,-26,36
Albion,8992,9,9,6,21,60,78,-18,33
Queen's Park,8992,10,6,10,20,39,73,-34,28
Raith,8993,1,23,8,5,70,33,37,77
Ayr,8993,2,24,4,8,94,43,51,76
Arbroath,8993,3,18,8,10,73,50,23,62
Alloa,8993,4,17,8,11,57,45,12,59
Stranraer,8993,5,15,5,16,55,68,-13,50
East Fife,8993,6,14,3,19,51,64,-13,45
Airdrieon,8993,7,10,11,15,45,59,-14,41
Forfar,8993,8,11,5,20,39,64,-25,38
Albion,8993,9,8,6,22,58,82,-24,30
Queen's Park,8993,10,6,10,20,41,75,-34,28
Raith,8994,1,23,8,5,71,32,39,77
Ayr,8994,2,24,4,8,91,42,49,76
Arbroath,8994,3,18,8,10,73,50,23,62
Alloa,8994,4,17,8,11,56,46,10,59
Stranraer,8994,5,15,6,15,56,65,-9,51
Airdrieon,8994,6,11,11,14,46,58,-12,44
East Fife,8994,7,13,4,19,48,65,-17,43
Forfar,8994,8,10,5,21,38,65,-27,35
Albion,8994,9,8,6,22,57,79,-22,30
Queen's Park,8994,10,6,10,20,41,75,-34,28
Raith,8995,1,22,8,6,71,36,35,74
Ayr,8995,2,23,4,9,91,46,45,73
Arbroath,8995,3,18,8,10,73,49,24,62
Alloa,8995,4,18,8,10,60,46,14,62
Stranraer,8995,5,15,5,16,56,66,-10,50
East Fife,8995,6,14,3,19,49,65,-16,45
Airdrieon,8995,7,10,11,15,46,60,-14,41
Forfar,8995,8,11,5,20,40,65,-25,38
Albion,8995,9,9,6,21,61,79,-18,33
Queen's Park,8995,10,6,10,20,40,75,-35,28
Ayr,8996,1,24,4,8,96,42,54,76
Raith,8996,2,22,9,5,70,34,36,75
Arbroath,8996,3,17,9,10,71,49,22,60
Alloa,8996,4,17,9,10,58,45,13,60
Stranraer,8996,5,16,5,15,56,64,-8,53
Airdrieon,8996,6,10,12,14,45,58,-13,42
East Fife,8996,7,13,3,20,47,65,-18,42
Forfar,8996,8,10,6,20,38,64,-26,36
Albion,8996,9,8,6,22,57,84,-27,30
Queen's Park,8996,10,6,11,19,40,73,-33,29
Raith,8997,1,23,8,5,69,32,37,77
Ayr,8997,2,24,4,8,96,44,52,76
Arbroath,8997,3,17,9,10,71,49,22,60
Alloa,8997,4,17,8,11,56,44,12,59
Stranraer,8997,5,15,6,15,56,65,-9,51
East Fife,8997,6,13,4,19,48,65,-17,43
Airdrieon,8997,7,10,12,14,47,60,-13,42
Forfar,8997,8,10,6,20,40,66,-26,36
Albion,8997,9,8,6,22,59,84,-25,30
Queen's Park,8997,10,6,11,19,40,73,-33,29
Ayr,8998,1,24,4,8,96,44,52,76
Raith,8998,2,22,9,5,68,32,36,75
Alloa,8998,3,17,9,10,56,43,13,60
Arbroath,8998,4,17,8,11,70,50,20,59
Stranraer,8998,5,15,5,16,56,66,-10,50
East Fife,8998,6,14,3,19,49,65,-16,45
Airdrieon,8998,7,10,12,14,46,59,-13,42
Forfar,8998,8,10,6,20,39,65,-26,36
Queen's Park,8998,9,7,10,19,41,72,-31,31
Albion,8998,10,8,6,22,59,84,-25,30
Raith,8999,1,23,8,5,70,33,37,77
Ayr,8999,2,24,4,8,96,42,54,76
Arbroath,8999,3,17,9,10,72,50,22,60
Alloa,8999,4,17,8,11,57,45,12,59
Stranraer,8999,5,15,5,16,56,67,-11,50
East Fife,8999,6,14,3,19,50,65,-15,45
Airdrieon,8999,7,10,11,15,45,60,-15,41
Forfar,8999,8,11,5,20,40,64,-24,38
Albion,8999,9,8,6,22,57,84,-27,30
Queen's Park,8999,10,6,11,19,41,74,-33,29
Raith,9000,1,22,9,5,69,33,36,75
Ayr,9000,2,23,4,9,90,44,46,73
Alloa,9000,3,17,9,10,57,44,13,60
Arbroath,9000,4,17,8,11,73,52,21,59
Stranraer,9000,5,15,5,16,58,68,-10,50
East Fife,9000,6,14,3,19,51,67,-16,45
Airdrieon,9000,7,11,11,14,47,59,-12,44
Forfar,9000,8,10,5,21,39,66,-27,35
Albion,9000,9,9,6,21,59,78,-19,33
Queen's Park,9000,10,7,10,19,43,75,-32,31
Ayr,9001,1,24,4,8,95,44,51,76
Raith,9001,2,22,8,6,70,35,35,74
Alloa,9001,3,18,8,10,59,45,14,62
Arbroath,9001,4,17,8,11,72,52,20,59
Stranraer,9001,5,15,5,16,58,68,-10,50
East Fife,9001,6,14,3,19,51,67,-16,45
Airdrieon,9001,7,11,11,14,50,60,-10,44
Forfar,9001,8,10,5,21,40,69,-29,35
Queen's Park,9001,9,7,10,19,43,74,-31,31
Albion,9001,10,8,6,22,59,83,-24,30
Raith,9002,1,23,8,5,69,32,37,77
Ayr,9002,2,24,4,8,93,44,49,76
Arbroath,9002,3,17,8,11,70,49,21,59
Alloa,9002,4,17,8,11,56,44,12,59
Stranraer,9002,5,15,5,16,56,66,-10,50
East Fife,9002,6,14,3,19,49,65,-16,45
Airdrieon,9002,7,10,11,15,48,62,-14,41
Forfar,9002,8,11,5,20,42,67,-25,38
Queen's Park,9002,9,7,10,19,40,72,-32,31
Albion,9002,10,8,6,22,59,81,-22,30
Raith,9003,1,22,9,5,69,33,36,75
Ayr,9003,2,23,4,9,92,45,47,73
Alloa,9003,3,17,9,10,57,44,13,60
Arbroath,9003,4,17,8,11,71,50,21,59
Stranraer,9003,5,16,5,15,58,65,-7,53
Airdrieon,9003,6,10,12,14,45,58,-13,42
East Fife,9003,7,13,3,20,48,67,-19,42
Forfar,9003,8,10,6,20,38,64,-26,36
Albion,9003,9,9,6,21,60,80,-20,33
Queen's Park,9003,10,7,10,19,41,73,-32,31
Raith,9004,1,23,8,5,71,32,39,77
Ayr,9004,2,24,4,8,93,42,51,76
Arbroath,9004,3,17,8,11,70,49,21,59
Alloa,9004,4,17,8,11,56,46,10,59
Stranraer,9004,5,15,6,15,56,65,-9,51
East Fife,9004,6,13,4,19,48,65,-17,43
Airdrieon,9004,7,10,11,15,45,60,-15,41
Forfar,9004,8,11,5,20,40,64,-24,38
Queen's Park,9004,9,7,10,19,40,72,-32,31
Albion,9004,10,8,6,22,57,81,-24,30
Raith,9005,1,23,8,5,69,32,37,77
Ayr,9005,2,23,5,8,90,42,48,74
Arbroath,9005,3,17,9,10,71,49,22,60
Alloa,9005,4,17,8,11,56,44,12,59
Stranraer,9005,5,15,5,16,55,65,-10,50
East Fife,9005,6,14,3,19,48,64,-16,45
Airdrieon,9005,7,11,11,14,47,59,-12,44
Forfar,9005,8,10,5,21,39,66,-27,35
Albion,9005,9,8,7,21,57,78,-21,31
Queen's Park,9005,10,6,11,19,40,73,-33,29
Ayr,9006,1,24,4,8,94,43,51,76
Raith,9006,2,22,8,6,68,33,35,74
Arbroath,9006,3,18,8,10,71,48,23,62
Alloa,9006,4,18,8,10,57,43,14,62
Stranraer,9006,5,15,6,15,57,66,-9,51
East Fife,9006,6,13,4,19,49,66,-17,43
Airdrieon,9006,7,10,11,15,47,61,-14,41
Forfar,9006,8,11,5,20,41,66,-25,38
Albion,9006,9,8,6,22,58,82,-24,30
Queen's Park,9006,10,6,10,20,39,73,-34,28
Raith,9007,1,23,8,5,73,32,41,77
Ayr,9007,2,23,5,8,92,44,48,74
Arbroath,9007,3,18,8,10,72,49,23,62
Alloa,9007,4,17,8,11,56,48,8,59
Stranraer,9007,5,15,5,16,55,66,-11,50
East Fife,9007,6,14,3,19,49,64,-15,45
Airdrieon,9007,7,10,12,14,45,58,-13,42
Forfar,9007,8,10,6,20,38,64,-26,36
Albion,9007,9,8,7,21,59,80,-21,31
Queen's Park,9007,10,6,10,20,40,74,-34,28
Ayr,9008,1,23,5,8,92,44,48,74
Raith,9008,2,22,8,6,69,34,35,74
Arbroath,9008,3,18,8,10,72,49,23,62
Alloa,9008,4,18,8,10,58,44,14,62
Stranraer,9008,5,15,5,16,56,67,-11,50
East Fife,9008,6,14,3,19,50,65,-15,45
Airdrieon,9008,7,11,11,14,48,60,-12,44
Forfar,9008,8,10,5,21,40,67,-27,35
Albion,9008,9,8,7,21,59,80,-21,31
Queen's Park,9008,10,6,10,20,40,74,-34,28
Ayr,9009,1,24,4,8,95,43,52,76
Raith,9009,2,22,8,6,69,34,35,74
Alloa,9009,3,18,8,10,58,44,14,62
Arbroath,9009,4,17,9,10,72,50,22,60
Stranraer,9009,5,15,5,16,55,66,-11,50
East Fife,9009,6,14,3,19,49,64,-15,45
Airdrieon,9009,7,10,12,14,46,59,-13,42
Forfar,9009,8,10,6,20,39,65,-26,36
Albion,9009,9,8,6,22,58,83,-25,30
Queen's Park,9009,10,6,11,19,41,74,-33,29
Raith,9010,1,23,8,5,72,32,40,77
Ayr,9010,2,24,4,8,99,44,55,76
Arbroath,9010,3,18,8,10,72,48,24,62
Alloa,9010,4,17,8,11,56,47,9,59
Stranraer,9010,5,15,6,15,55,64,-9,51
East Fife,9010,6,13,4,19,47,64,-17,43
Airdrieon,9010,7,10,12,14,47,60,-13,42
Forfar,9010,8,10,6,20,40,66,-26,36
Albion,9010,9,8,6,22,59,87,-28,30
Queen's Park,9010,10,6,10,20,39,74,-35,28
Raith,9011,1,23,8,5,70,33,37,77
Ayr,9011,2,24,4,8,93,43,50,76
Arbroath,9011,3,18,8,10,73,48,25,62
Alloa,9011,4,17,8,11,57,45,12,59
Stranraer,9011,5,16,5,15,58,66,-8,53
East Fife,9011,6,13,3,20,49,67,-18,42
Airdrieon,9011,7,10,11,15,45,59,-14,41
Forfar,9011,8,11,5,20,39,64,-25,38
Albion,9011,9,8,6,22,58,81,-23,30
Queen's Park,9011,10,6,10,20,39,75,-36,28
Raith,9012,1,23,8,5,71,33,38,77
Ayr,9012,2,24,4,8,96,43,53,76
Arbroath,9012,3,18,8,10,74,50,24,62
Alloa,9012,4,17,8,11,57,46,11,59
Stranraer,9012,5,15,5,16,56,69,-13,50
East Fife,9012,6,14,3,19,52,65,-13,45
Airdrieon,9012,7,11,11,14,49,59,-10,44
Forfar,9012,8,10,5,21,39,68,-29,35
Albion,9012,9,8,6,22,58,84,-26,30
Queen's Park,9012,10,6,10,20,41,76,-35,28
Raith,9013,1,23,8,5,69,32,37,77
Ayr,9013,2,24,4,8,95,43,52,76
Arbroath,9013,3,17,9,10,72,50,22,60
Alloa,9013,4,17,8,11,56,44,12,59
Stranraer,9013,5,15,5,16,56,68,-12,50
East Fife,9013,6,14,3,19,51,65,-14,45
Airdrieon,9013,7,11,11,14,47,59,-12,44
Forfar,9013,8,10,5,21,39,66,-27,35
Albion,9013,9,8,6,22,58,83,-25,30
Queen's Park,9013,10,6,11,19,41,74,-33,29
Raith,9014,1,23,8,5,73,33,40,77
Ayr,9014,2,24,4,8,94,42,52,76
Arbroath,9014,3,18,8,10,74,48,26,62
Alloa,9014,4,17,8,11,57,48,9,59
Stranraer,9014,5,16,5,15,57,65,-8,53
East Fife,9014,6,13,3,20,48,66,-18,42
Airdrieon,9014,7,10,11,15,45,59,-14,41
Forfar,9014,8,11,5,20,39,64,-25,38
Albion,9014,9,8,6,22,57,82,-25,30
Queen's Park,9014,10,6,10,20,39,76,-37,28
Raith,9015,1,23,8,5,71,33,38,77
Ayr,9015,2,23,4,9,92,45,47,73
Arbroath,9015,3,17,9,10,71,49,22,60
Alloa,9015,4,17,8,11,57,46,11,59
Stranraer,9015,5,15,6,15,58,67,-9,51
Airdrieon,9015,6,11,11,14,47,59,-12,44
East Fife,9015,7,13,4,19,50,67,-17,43
Forfar,9015,8,10,5,21,39,66,-27,35
Albion,9015,9,9,6,21,60,80,-20,33
Queen's Park,9015,10,6,11,19,40,73,-33,29
Ayr,9016,1,24,4,8,95,44,51,76
Raith,9016,2,22,8,6,68,33,35,74
Alloa,9016,3,18,8,10,57,43,14,62
Arbroath,9016,4,17,8,11,71,50,21,59
Stranraer,9016,5,16,5,15,57,65,-8,53
East Fife,9016,6,13,3,20,48,66,-18,42
Airdrieon,9016,7,10,11,15,45,61,-16,41
Forfar,9016,8,11,5,20,41,64,-23,38
Queen's Park,9016,9,7,10,19,41,73,-32,31
Albion,9016,10,8,6,22,59,83,-24,30
Raith,9017,1,23,8,5,69,32,37,77
Ayr,9017,2,23,4,9,91,44,47,73
Arbroath,9017,3,17,9,10,72,50,22,60
Alloa,9017,4,17,8,11,56,44,12,59
Stranraer,9017,5,16,5,15,58,66,-8,53
Airdrieon,9017,6,11,11,14,47,59,-12,44
East Fife,9017,7,13,3,20,49,67,-18,42
Forfar,9017,8,10,5,21,39,66,-27,35
Albion,9017,9,9,6,21,59,79,-20,33
Queen's Park,9017,10,6,11,19,41,74,-33,29
Raith,9018,1,23,8,5,70,32,38,77
Ayr,9018,2,24,4,8,95,42,53,76
Arbroath,9018,3,18,8,10,71,48,23,62
Alloa,9018,4,17,8,11,56,45,11,59
Stranraer,9018,5,15,5,16,56,66,-10,50
East Fife,9018,6,14,3,19,49,65,-16,45
Airdrieon,9018,7,11,11,14,49,58,-9,44
Forfar,9018,8,10,5,21,38,68,-30,35
Albion,9018,9,8,6,22,57,83,-26,30
Queen's Park,9018,10,6,10,20,39,73,-34,28
Raith,9019,1,23,8,5,72,34,38,77
Ayr,9019,2,23,4,9,91,46,45,73
Arbroath,9019,3,17,9,10,72,50,22,60
Alloa,9019,4,17,8,11,58,47,11,59
Stranraer,9019,5,16,5,15,58,65,-7,53
Airdrieon,9019,6,11,11,14,48,60,-12,44
East Fife,9019,7,13,3,20,48,67,-19,42
Forfar,9019,8,10,5,21,40,67,-27,35
Albion,9019,9,9,6,21,61,79,-18,33
Queen's Park,9019,10,6,11,19,41,74,-33,29
Raith,9020,1,23,8,5,69,32,37,77
Ayr,9020,2,24,4,8,92,43,49,76
Arbroath,9020,3,18,8,10,71,48,23,62
Alloa,9020,4,17,8,11,56,44,12,59
Stranraer,9020,5,16,5,15,57,65,-8,53
East Fife,9020,6,13,3,20,48,66,-18,42
Airdrieon,9020,7,10,11,15,46,60,-14,41
Forfar,9020,8,11,5,20,40,65,-25,38
Albion,9020,9,8,6,22,58,80,-22,30
Queen's Park,9020,10,6,10,20,39,73,-34,28
Raith,9021,1,23,8,5,70,33,37,77
Ayr,9021,2,24,4,8,95,44,51,76
Arbroath,9021,3,17,8,11,70,49,21,59
Alloa,9021,4,17,8,11,57,45,12,59
Stranraer,9021,5,15,5,16,56,66,-10,50
East Fife,9021,6,14,3,19,49,65,-16,45
Airdrieon,9021,7,10,11,15,46,60,-14,41
Forfar,9021,8,11,5,20,40,65,-25,38
Queen's Park,9021,9,7,10,19,40,72,-32,31
Albion,9021,10,8,6,22,59,83,-24,30
Raith,9022,1,23,8,5,70,33,37,77
Ayr,9022,2,24,4,8,95,45,50,76
Arbroath,9022,3,18,8,10,73,49,24,62
Alloa,9022,4,17,8,11,57,45,12,59
Stranraer,9022,5,16,5,15,57,64,-7,53
East Fife,9022,6,13,3,20,47,66,-19,42
Airdrieon,9022,7,10,11,15,46,60,-14,41
Forfar,9022,8,11,5,20,40,65,-25,38
Albion,9022,9,8,6,22,60,83,-23,30
Queen's Park,9022,10,6,10,20,40,75,-35,28
Raith,9023,1,23,8,5,72,32,40,77
Ayr,9023,2,24,4,8,94,43,51,76
Arbroath,9023,3,17,8,11,70,54,16,59
Alloa,9023,4,17,8,11,56,47,9,59
Stranraer,9023,5,15,6,15,56,65,-9,51
Airdrieon,9023,6,11,11,14,46,58,-12,44
East Fife,9023,7,13,4,19,48,65,-17,43
Forfar,9023,8,10,5,21,38,65,-27,35
Queen's Park,9023,9,7,10,19,45,72,-27,31
Albion,9023,10,8,6,22,58,82,-24,30
Ayr,9024,1,24,4,8,92,42,50,76
Raith,9024,2,22,9,5,69,33,36,75
Arbroath,9024,3,18,8,10,73,49,24,62
Alloa,9024,4,17,9,10,57,44,13,60
Stranraer,9024,5,15,5,16,56,67,-11,50
East Fife,9024,6,14,3,19,50,65,-15,45
Airdrieon,9024,7,10,11,15,45,60,-15,41
Forfar,9024,8,11,5,20,40,64,-24,38
Albion,9024,9,8,6,22,57,80,-23,30
Queen's Park,9024,10,6,10,20,40,75,-35,28
Raith,9025,1,23,8,5,71,32,39,77
Ayr,9025,2,23,5,8,91,43,48,74
Arbroath,9025,3,18,8,10,72,48,24,62
Alloa,9025,4,17,8,11,56,46,10,59
Stranraer,9025,5,15,6,15,56,65,-9,51
East Fife,9025,6,13,4,19,48,65,-17,43
Airdrieon,9025,7,10,12,14,46,59,-13,42
Forfar,9025,8,10,6,20,39,65,-26,36
Albion,9025,9,8,7,21,58,79,-21,31
Queen's Park,9025,10,6,10,20,39,74,-35,28
Raith,9026,1,23,8,5,69,32,37,77
Ayr,9026,2,24,4,8,92,42,50,76
Arbroath,9026,3,18,8,10,72,48,24,62
Alloa,9026,4,17,8,11,56,44,12,59
Stranraer,9026,5,16,5,15,58,66,-8,53
Airdrieon,9026,6,11,11,14,48,59,-11,44
East Fife,9026,7,13,3,20,49,67,-18,42
Forfar,9026,8,10,5,21,39,67,-28,35
Albion,9026,9,8,6,22,57,80,-23,30
Queen's Park,9026,10,6,10,20,39,74,-35,28
Ayr,9027,1,24,4,8,93,44,49,76
Raith,9027,2,22,9,5,68,32,36,75
Arbroath,9027,3,18,8,10,73,48,25,62
Alloa,9027,4,17,9,10,56,43,13,60
Stranraer,9027,5,16,5,15,57,64,-7,53
Airdrieon,9027,6,10,12,14,45,58,-13,42
East Fife,9027,7,13,3,20,47,66,-19,42
Forfar,9027,8,10,6,20,38,64,-26,36
Albion,9027,9,8,6,22,59,81,-22,30
Queen's Park,9027,10,6,10,20,39,75,-36,28
Raith,9028,1,23,8,5,71,33,38,77
Ayr,9028,2,23,5,8,93,45,48,74
Arbroath,9028,3,18,8,10,74,48,26,62
Alloa,9028,4,17,8,11,57,46,11,59
Stranraer,9028,5,16,5,15,56,64,-8,53
Airdrieon,9028,6,11,11,14,50,59,-9,44
East Fife,9028,7,13,3,20,47,65,-18,42
Forfar,9028,8,10,5,21,39,69,-30,35
Albion,9028,9,8,7,21,60,81,-21,31
Queen's Park,9028,10,6,10,20,39,76,-37,28
Ayr,9029,1,24,4,8,94,43,51,76
Raith,9029,2,22,9,5,69,33,36,75
Arbroath,9029,3,17,9,10,71,49,22,60
Alloa,9029,4,17,9,10,57,44,13,60
Stranraer,9029,5,15,5,16,55,67,-12,50
East Fife,9029,6,14,3,19,50,64,-14,45
Airdrieon,9029,7,10,12,14,45,58,-13,42
Forfar,9029,8,10,6,20,38,64,-26,36
Albion,9029,9,8,6,22,58,82,-24,30
Queen's Park,9029,10,6,11,19,40,73,-33,29
Ayr,9030,1,24,4,8,94,43,51,76
Raith,9030,2,22,8,6,68,33,35,74
Arbroath,9030,3,18,8,10,73,49,24,62
Alloa,9030,4,18,8,10,57,43,14,62
Stranraer,9030,5,15,6,15,57,66,-9,51
Airdrieon,9030,6,11,11,14,48,59,-11,44
East Fife,9030,7,13,4,19,49,66,-17,43
Forfar,9030,8,10,5,21,39,67,-28,35
Albion,9030,9,8,6,22,58,82,-24,30
Queen's Park,9030,10,6,10,20,40,75,-35,28
Ayr,9031,1,24,4,8,95,42,53,76
Raith,9031,2,22,9,5,69,33,36,75
Arbroath,9031,3,18,8,10,73,50,23,62
Alloa,9031,4,17,9,10,57,44,13,60
Stranraer,9031,5,15,5,16,55,65,-10,50
East Fife,9031,6,14,3,19,48,64,-16,45
Airdrieon,9031,7,10,11,15,47,62,-15,41
Forfar,9031,8,11,5,20,42,66,-24,38
Albion,9031,9,8,6,22,57,83,-26,30
Queen's Park,9031,10,6,10,20,41,75,-34,28
Raith,9032,1,23,8,5,71,34,37,77
Ayr,9032,2,24,4,8,96,42,54,76
Arbroath,9032,3,17,9,10,71,49,22,60
Alloa,9032,4,17,8,11,58,46,12,59
Stranraer,9032,5,16,5,15,57,64,-7,53
Airdrieon,9032,6,11,11,14,48,58,-10,44
East Fife,9032,7,13,3,20,47,66,-19,42
Forfar,9032,8,10,5,21,38,67,-29,35
Albion,9032,9,8,6,22,57,84,-27,30
Queen's Park,9032,10,6,11,19,40,73,-33,29
Ayr,9033,1,24,4,8,96,43,53,76
Raith,9033,2,22,8,6,68,37,31,74
Alloa,9033,3,18,8,10,61,43,18,62
Arbroath,9033,4,17,8,11,70,49,21,59
Stranraer,9033,5,16,5,15,58,66,-8,53
Airdrieon,9033,6,11,11,14,47,59,-12,44
East Fife,9033,7,13,3,20,49,67,-18,42
Forfar,9033,8,10,5,21,39,66,-27,35
Queen's Park,9033,9,7,10,19,40,72,-32,31
Albion,9033,10,8,6,22,58,84,-26,30
Raith,9034,1,23,8,5,70,32,38,77
Ayr,9034,2,23,5,8,93,45,48,74
Arbroath,9034,3,17,9,10,71,49,22,60
Alloa,9034,4,17,8,11,56,45,11,59
Stranraer,9034,5,16,5,15,56,64,-8,53
Airdrieon,9034,6,10,12,14,45,58,-13,42
East Fife,9034,7,13,3,20,47,65,-18,42
Forfar,9034,8,10,6,20,38,64,-26,36
Albion,9034,9,8,7,21,60,81,-21,31
Queen's Park,9034,10,6,11,19,40,73,-33,29
Raith,9035,1,23,8,5,70,33,37,77
Ayr,9035,2,24,4,8,97,42,55,76
Arbroath,9035,3,17,9,10,72,50,22,60
Alloa,9035,4,17,8,11,57,45,12,59
Stranraer,9035,5,16,5,15,58,65,-7,53
Airdrieon,9035,6,10,12,14,46,59,-13,42
East Fife,9035,7,13,3,20,48,67,-19,42
Forfar,9035,8,10,6,20,39,65,-26,36
Albion,9035,9,8,6,22,57,85,-28,30
Queen's Park,9035,10,6,11,19,41,74,-33,29
Raith,9036,1,23,8,5,72,32,40,77
Ayr,9036,2,24,4,8,92,43,49,76
Arbroath,9036,3,18,8,10,73,48,25,62
Alloa,9036,4,17,8,11,56,47,9,59
Stranraer,9036,5,16,5,15,58,65,-7,53
Airdrieon,9036,6,11,11,14,47,58,-11,44
East Fife,9036,7,13,3,20,48,67,-19,42
Forfar,9036,8,10,5,21,38,66,-28,35
Albion,9036,9,8,6,22,58,80,-22,30
Queen's Park,9036,10,6,10,20,39,75,-36,28
Raith,9037,1,23,8,5,71,34,37,77
Ayr,9037,2,24,4,8,94,42,52,76
Arbroath,9037,3,18,8,10,73,48,25,62
Alloa,9037,4,17,8,11,58,46,12,59
Stranraer,9037,5,15,6,15,57,66,-9,51
Airdrieon,9037,6,11,11,14,46,58,-12,44
East Fife,9037,7,13,4,19,49,66,-17,43
Forfar,9037,8,10,5,21,38,65,-27,35
Albion,9037,9,8,6,22,57,82,-25,30
Queen's Park,9037,10,6,10,20,39,75,-36,28
Raith,9038,1,22,9,5,69,33,36,75
Ayr,9038,2,23,5,8,93,45,48,74
Arbroath,9038,3,18,8,10,74,48,26,62
Alloa,9038,4,17,9,10,57,44,13,60
Stranraer,9038,5,15,5,16,56,67,-11,50
East Fife,9038,6,14,3,19,50,65,-15,45
Airdrieon,9038,7,10,11,15,46,62,-16,41
Forfar,9038,8,11,5,20,42,65,-23,38
Albion,9038,9,8,7,21,60,81,-21,31
Queen's Park,9038,10,6,10,20,39,76,-37,28
Raith,9039,1,23,8,5,71,34,37,77
Ayr,9039,2,23,5,8,90,42,48,74
Arbroath,9039,3,17,9,10,73,51,22,60
Alloa,9039,4,17,8,11,58,46,12,59
Stranraer,9039,5,15,6,15,57,66,-9,51
Airdrieon,9039,6,11,11,14,49,61,-12,44
East Fife,9039,7,13,4,19,49,66,-17,43
Forfar,9039,8,10,5,21,41,68,-27,35
Albion,9039,9,8,7,21,57,78,-21,31
Queen's Park,9039,10,6,11,19,42,75,-33,29
Raith,9040,1,22,9,5,70,34,36,75
Ayr,9040,2,23,5,8,93,45,48,74
Arbroath,9040,3,18,8,10,74,49,25,62
Alloa,9040,4,17,9,10,58,45,13,60
Stranraer,9040,5,15,6,15,56,65,-9,51
Airdrieon,9040,6,11,11,14,46,58,-12,44
East Fife,9040,7,13,4,19,48,65,-17,43
Forfar,9040,8,10,5,21,38,65,-27,35
Albion,9040,9,8,7,21,60,81,-21,31
Queen's Park,9040,10,6,10,20,40,76,-36,28
Raith,9041,1,23,8,5,70,32,38,77
Ayr,9041,2,24,4,8,92,43,49,76
Arbroath,9041,3,17,8,11,71,50,21,59
Alloa,9041,4,17,8,11,56,45,11,59
Stranraer,9041,5,15,6,15,56,65,-9,51
Airdrieon,9041,6,11,11,14,48,60,-12,44
East Fife,9041,7,13,4,19,48,65,-17,43
Forfar,9041,8,10,5,21,40,67,-27,35
Queen's Park,9041,9,7,10,19,41,73,-32,31
Albion,9041,10,8,6,22,58,80,-22,30
Ayr,9042,1,24,4,8,95,42,53,76
Raith,9042,2,22,9,5,68,32,36,75
Arbroath,9042,3,17,9,10,73,51,22,60
Alloa,9042,4,17,9,10,56,43,13,60
Stranraer,9042,5,15,6,15,56,65,-9,51
East Fife,9042,6,13,4,19,48,65,-17,43
Airdrieon,9042,7,10,11,15,46,60,-14,41
Forfar,9042,8,11,5,20,40,65,-25,38
Albion,9042,9,8,6,22,57,83,-26,30
Queen's Park,9042,10,6,11,19,42,75,-33,29
Ayr,9043,1,24,4,8,95,43,52,76
Raith,9043,2,22,9,5,68,32,36,75
Arbroath,9043,3,17,9,10,71,49,22,60
Alloa,9043,4,17,9,10,56,43,13,60
Stranraer,9043,5,15,5,16,55,68,-13,50
East Fife,9043,6,14,3,19,51,64,-13,45
Airdrieon,9043,7,10,11,15,48,62,-14,41
Forfar,9043,8,11,5,20,42,67,-25,38
Albion,9043,9,8,6,22,58,83,-25,30
Queen's Park,9043,10,6,11,19,40,73,-33,29
Ayr,9044,1,24,4,8,92,42,50,76
Raith,9044,2,22,9,5,70,34,36,75
Arbroath,9044,3,18,8,10,72,49,23,62
Alloa,9044,4,17,9,10,58,45,13,60
Stranraer,9044,5,15,6,15,55,64,-9,51
East Fife,9044,6,13,4,19,47,64,-17,43
Airdrieon,9044,7,10,12,14,46,59,-13,42
Forfar,9044,8,10,6,20,39,65,-26,36
Albion,9044,9,8,6,22,57,80,-23,30
Queen's Park,9044,10,6,10,20,40,74,-34,28
Ayr,9045,1,24,4,8,97,44,53,76
Raith,9045,2,22,9,5,69,33,36,75
Arbroath,9045,3,18,8,10,71,48,23,62
Alloa,9045,4,17,9,10,57,44,13,60
Stranraer,9045,5,15,6,15,56,65,-9,51
Airdrieon,9045,6,11,11,14,48,58,-10,44
East Fife,9045,7,13,4,19,48,65,-17,43
Forfar,9045,8,10,5,21,38,67,-29,35
Albion,9045,9,8,6,22,59,85,-26,30
Queen's Park,9045,10,6,10,20,39,73,-34,28
Raith,9046,1,23,8,5,69,32,37,77
Ayr,9046,2,24,4,8,93,42,51,76
Arbroath,9046,3,18,8,10,72,49,23,62
Alloa,9046,4,17,8,11,56,44,12,59
Stranraer,9046,5,15,5,16,56,66,-10,50
East Fife,9046,6,14,3,19,49,65,-16,45
Airdrieon,9046,7,10,11,15,46,60,-14,41
Forfar,9046,8,11,5,20,40,65,-25,38
Albion,9046,9,8,6,22,57,81,-24,30
Queen's Park,9046,10,6,10,20,40,74,-34,28
Raith,9047,1,23,8,5,70,33,37,77
Ayr,9047,2,24,4,8,93,42,51,76
Arbroath,9047,3,17,8,11,72,51,21,59
Alloa,9047,4,17,8,11,57,45,12,59
Stranraer,9047,5,16,5,15,56,64,-8,53
East Fife,9047,6,13,3,20,47,65,-18,42
Airdrieon,9047,7,10,11,15,45,60,-15,41
Forfar,9047,8,11,5,20,40,64,-24,38
Queen's Park,9047,9,7,10,19,42,74,-32,31
Albion,9047,10,8,6,22,57,81,-24,30
Raith,9048,1,23,8,5,70,33,37,77
Ayr,9048,2,24,4,8,97,44,53,76
Arbroath,9048,3,18,8,10,72,49,23,62
Alloa,9048,4,17,8,11,57,45,12,59
Stranraer,9048,5,15,5,16,56,66,-10,50
East Fife,9048,6,14,3,19,49,65,-16,45
Airdrieon,9048,7,11,11,14,46,58,-12,44
Forfar,9048,8,10,5,21,38,65,-27,35
Albion,9048,9,8,6,22,59,85,-26,30
Queen's Park,9048,10,6,10,20,40,74,-34,28
Raith,9049,1,23,8,5,71,32,39,77
Ayr,9049,2,23,4,9,90,44,46,73
Arbroath,9049,3,17,8,11,71,50,21,59
Alloa,9049,4,17,8,11,56,46,10,59
Stranraer,9049,5,16,5,15,57,64,-7,53
Airdrieon,9049,6,11,11,14,47,59,-12,44
East Fife,9049,7,13,3,20,47,66,-19,42
Forfar,9049,8,10,5,21,39,66,-27,35
Albion,9049,9,9,6,21,59,78,-19,33
Queen's Park,9049,10,7,10,19,41,73,-32,31
Raith,9050,1,23,8,5,71,32,39,77
Ayr,9050,2,24,4,8,93,43,50,76
Arbroath,9050,3,17,8,11,70,51,19,59
Alloa,9050,4,17,8,11,56,46,10,59
Stranraer,9050,5,16,5,15,56,64,-8,53
East Fife,9050,6,13,3,20,47,65,-18,42
Airdrieon,9050,7,10,11,15,46,60,-14,41
Forfar,9050,8,11,5,20,40,65,-25,38
Queen's Park,9050,9,7,10,19,42,72,-30,31
Albion,9050,10,8,6,22,58,81,-23,30
Ayr,9051,1,24,4,8,94,43,51,76
Raith,9051,2,22,9,5,68,32,36,75
Arbroath,9051,3,18,8,10,72,49,23,62
Alloa,9051,4,17,9,10,56,43,13,60
Stranraer,9051,5,15,5,16,55,68,-13,50
East Fife,9051,6,14,3,19,51,64,-13,45
Airdrieon,9051,7,11,11,14,50,59,-9,44
Forfar,9051,8,10,5,21,39,69,-30,35
Albion,9051,9,8,6,22,58,82,-24,30
Queen's Park,9051,10,6,10,20,40,74,-34,28
Ayr,9052,1,24,4,8,96,42,54,76
Raith,9052,2,22,9,5,69,33,36,75
Alloa,9052,3,17,9,10,57,44,13,60
Arbroath,9052,4,17,8,11,73,52,21,59
Stranraer,9052,5,15,5,16,56,66,-10,50
East Fife,9052,6,14,3,19,49,65,-16,45
Airdrieon,9052,7,11,11,14,47,58,-11,44
Forfar,9052,8,10,5,21,38,66,-28,35
Queen's Park,9052,9,7,10,19,43,75,-32,31
Albion,9052,10,8,6,22,57,84,-27,30
Raith,9053,1,22,8,6,68,34,34,74
Ayr,9053,2,23,4,9,91,44,47,73
Alloa,9053,3,18,8,10,58,43,15,62
Arbroath,9053,4,17,8,11,73,52,21,59
Stranraer,9053,5,15,5,16,55,65,-10,50
East Fife,9053,6,14,3,19,48,64,-16,45
Airdrieon,9053,7,11,11,14,48,58,-10,44
Forfar,9053,8,10,5,21,38,67,-29,35
Albion,9053,9,9,6,21,59,79,-20,33
Queen's Park,9053,10,7,10,19,43,75,-32,31
Raith,9054,1,23,8,5,70,32,38,77
Ayr,9054,2,23,4,9,90,44,46,73
Arbroath,9054,3,18,8,10,72,48,24,62
Alloa,9054,4,17,8,11,56,45,11,59
Stranraer,9054,5,15,6,15,56,65,-9,51
East Fife,9054,6,13,4,19,48,65,-17,43
Airdrieon,9054,7,10,11,15,47,61,-14,41
Forfar,9054,8,11,5,20,41,66,-25,38
Albion,9054,9,9,6,21,59,78,-19,33
Queen's Park,9054,10,6,10,20,39,74,-35,28
Raith,9055,1,23,8,5,70,33,37,77
Ayr,9055,2,24,4,8,94,43,51,76
Arbroath,9055,3,18,8,10,72,49,23,62
Alloa,9055,4,17,8,11,57,45,12,59
Stranraer,9055,5,15,6,15,57,66,-9,51
Airdrieon,9055,6,11,11,14,47,59,-12,44
East Fife,9055,7,13,4,19,49,66,-17,43
Forfar,9055,8,10,5,21,39,66,-27,35
Albion,9055,9,8,6,22,58,82,-24,30
Queen's Park,9055,10,6,10,20,40,74,-34,28
Raith,9056,1,23,8,5,71,33,38,77
Ayr,9056,2,24,4,8,92,42,50,76
Arbroath,9056,3,17,9,10,72,50,22,60
Alloa,9056,4,17,8,11,57,46,11,59
Stranraer,9056,5,15,6,15,57,66,-9,51
Airdrieon,9056,6,11,11,14,47,58,-11,44
East Fife,9056,7,13,4,19,49,66,-17,43
Forfar,9056,8,10,5,21,38,66,-28,35
Albion,9056,9,8,6,22,57,80,-23,30
Queen's Park,9056,10,6,11,19,41,74,-33,29
Raith,9057,1,23,8,5,69,32,37,77
Ayr,9057,2,24,4,8,92,42,50,76
Arbroath,9057,3,18,8,10,73,49,24,62
Alloa,9057,4,17,8,11,56,44,12,59
Stranraer,9057,5,16,5,15,59,66,-7,53
Airdrieon,9057,6,10,12,14,45,58,-13,42
East Fife,9057,7,13,3,20,49,68,-19,42
Forfar,9057,8,10,6,20,38,64,-26,36
Albion,9057,9,8,6,22,57,80,-23,30
Queen's Park,9057,10,6,10,20,40,75,-35,28
Raith,9058,1,23,8,5,71,33,38,77
Ayr,9058,2,24,4,8,94,42,52,76
Arbroath,9058,3,17,8,11,71,52,19,59
Alloa,9058,4,17,8,11,57,46,11,59
Stranraer,9058,5,15,6,15,56,65,-9,51
East Fife,9058,6,13,4,19,48,65,-17,43
Airdrieon,9058,7,10,11,15,46,61,-15,41
Forfar,9058,8,11,5,20,41,65,-24,38
Queen's Park,9058,9,7,10,19,43,73,-30,31
Albion,9058,10,8,6,22,57,82,-25,30
Ayr,9059,1,24,4,8,94,43,51,76
Raith,9059,2,22,8,6,68,33,35,74
Alloa,9059,3,18,8,10,57,43,14,62
Arbroath,9059,4,17,8,11,70,49,21,59
Stranraer,9059,5,15,5,16,56,66,-10,50
East Fife,9059,6,14,3,19,49,65,-16,45
Airdrieon,9059,7,10,11,15,45,59,-14,41
Forfar,9059,8,11,5,20,39,64,-25,38
Queen's Park,9059,9,7,10,19,40,72,-32,31
Albion,9059,10,8,6,22,58,82,-24,30
Raith,9060,1,23,8,5,70,32,38,77
Ayr,9060,2,24,4,8,93,43,50,76
Arbroath,9060,3,17,8,11,72,51,21,59
Alloa,9060,4,17,8,11,56,45,11,59
Stranraer,9060,5,15,6,15,56,65,-9,51
East Fife,9060,6,13,4,19,48,65,-17,43
Airdrieon,9060,7,10,12,14,46,59,-13,42
Forfar,9060,8,10,6,20,39,65,-26,36
Queen's Park,9060,9,7,10,19,42,74,-32,31
Albion,9060,10,8,6,22,58,81,-23,30
Ayr,9061,1,24,4,8,95,43,52,76
Raith,9061,2,22,8,6,70,35,35,74
Arbroath,9061,3,18,8,10,71,48,23,62
Alloa,9061,4,18,8,10,59,45,14,62
Stranraer,9061,5,16,5,15,58,65,-7,53
East Fife,9061,6,13,3,20,48,67,-19,42
Airdrieon,9061,7,10,11,15,45,59,-14,41
Forfar,9061,8,11,5,20,39,64,-25,38
Albion,9061,9,8,6,22,58,83,-25,30
Queen's Park,9061,10,6,10,20,39,73,-34,28
Raith,9062,1,23,8,5,70,33,37,77
Ayr,9062,2,23,4,9,92,45,47,73
Arbroath,9062,3,18,8,10,73,50,23,62
Alloa,9062,4,17,8,11,57,45,12,59
Stranraer,9062,5,16,5,15,58,64,-6,53
Airdrieon,9062,6,11,11,14,47,59,-12,44
East Fife,9062,7,13,3,20,47,67,-20,42
Forfar,9062,8,10,5,21,39,66,-27,35
Albion,9062,9,9,6,21,60,80,-20,33
Queen's Park,9062,10,6,10,20,41,75,-34,28
Ayr,9063,1,24,4,8,94,44,50,76
Raith,9063,2,22,8,6,68,35,33,74
Arbroath,9063,3,18,8,10,72,49,23,62
Alloa,9063,4,18,8,10,59,43,16,62
Stranraer,9063,5,15,6,15,57,66,-9,51
Airdrieon,9063,6,11,11,14,47,58,-11,44
East Fife,9063,7,13,4,19,49,66,-17,43
Forfar,9063,8,10,5,21,38,66,-28,35
Albion,9063,9,8,6,22,59,82,-23,30
Queen's Park,9063,10,6,10,20,40,74,-34,28
Raith,9064,1,23,8,5,70,32,38,77
Ayr,9064,2,24,4,8,94,42,52,76
Arbroath,9064,3,17,9,10,70,48,22,60
Alloa,9064,4,17,8,11,56,45,11,59
Stranraer,9064,5,15,6,15,56,65,-9,51
East Fife,9064,6,13,4,19,48,65,-17,43
Airdrieon,9064,7,10,12,14,45,58,-13,42
Forfar,9064,8,10,6,20,38,64,-26,36
Albion,9064,9,8,6,22,57,82,-25,30
Queen's Park,9064,10,6,11,19,39,72,-33,29
Raith,9065,1,23,8,5,70,33,37,77
Ayr,9065,2,24,4,8,93,42,51,76
Arbroath,9065,3,17,8,11,70,49,21,59
Alloa,9065,4,17,8,11,57,45,12,59
Stranraer,9065,5,15,6,15,59,68,-9,51
Airdrieon,9065,6,11,11,14,48,58,-10,44
East Fife,9065,7,13,4,19,51,68,-17,43
Forfar,9065,8,10,5,21,38,67,-29,35
Queen's Park,9065,9,7,10,19,40,72,-32,31
Albion,9065,10,8,6,22,57,81,-24,30
Raith,9066,1,23,8,5,70,32,38,77
Ayr,9066,2,24,4,8,94,44,50,76
Arbroath,9066,3,18,8,10,71,48,23,62
Alloa,9066,4,17,8,11,56,45,11,59
Stranraer,9066,5,15,5,16,55,69,-14,50
East Fife,9066,6,14,3,19,52,64,-12,45
Airdrieon,9066,7,11,11,14,47,59,-12,44
Forfar,9066,8,10,5,21,39,66,-27,35
Albion,9066,9,8,6,22,59,82,-23,30
Queen's Park,9066,10,6,10,20,39,73,-34,28
Raith,9067,1,23,8,5,71,33,38,77
Ayr,9067,2,24,4,8,93,42,51,76
Arbroath,9067,3,18,8,10,74,49,25,62
Alloa,9067,4,17,8,11,57,46,11,59
Stranraer,9067,5,16,5,15,58,64,-6,53
East Fife,9067,6,13,3,20,47,67,-20,42
Airdrieon,9067,7,10,11,15,45,60,-15,41
Forfar,9067,8,11,5,20,40,64,-24,38
Albion,9067,9,8,6,22,57,81,-24,30
Queen's Park,9067,10,6,10,20,40,76,-36,28
Ayr,9068,1,23,5,8,92,44,48,74
Raith,9068,2,22,8,6,68,36,32,74
Arbroath,9068,3,18,8,10,73,48,25,62
Alloa,9068,4,18,8,10,60,43,17,62
Stranraer,9068,5,16,5,15,58,65,-7,53
East Fife,9068,6,13,3,20,48,67,-19,42
Airdrieon,9068,7,10,11,15,45,60,-15,41
Forfar,9068,8,11,5,20,40,64,-24,38
Albion,9068,9,8,7,21,59,80,-21,31
Queen's Park,9068,10,6,10,20,39,75,-36,28
Ayr,9069,1,24,4,8,92,42,50,76
Raith,9069,2,22,8,6,69,34,35,74
Alloa,9069,3,18,8,10,58,44,14,62
Arbroath,9069,4,17,8,11,71,51,20,59
Stranraer,9069,5,15,5,16,55,65,-10,50
East Fife,9069,6,14,3,19,48,64,-16,45
Airdrieon,9069,7,11,11,14,49,58,-9,44
Forfar,9069,8,10,5,21,38,68,-30,35
Queen's Park,9069,9,7,10,19,42,73,-31,31
Albion,9069,10,8,6,22,57,80,-23,30
Ayr,9070,1,24,4,8,92,43,49,76
Raith,9070,2,22,8,6,68,33,35,74
Arbroath,9070,3,18,8,10,73,50,23,62
Alloa,9070,4,18,8,10,57,43,14,62
Stranraer,9070,5,15,5,16,57,68,-11,50
East Fife,9070,6,14,3,19,51,66,-15,45
Airdrieon,9070,7,10,11,15,49,63,-14,41
Forfar,9070,8,11,5,20,43,68,-25,38
Albion,9070,9,8,6,22,58,80,-22,30
Queen's Park,9070,10,6,10,20,41,75,-34,28
Ayr,9071,1,23,5,8,92,44,48,74
Raith,9071,2,22,8,6,68,33,35,74
Alloa,9071,3,18,8,10,57,43,14,62
Arbroath,9071,4,17,9,10,72,50,22,60
Stranraer,9071,5,15,6,15,57,66,-9,51
Airdrieon,9071,6,11,11,14,47,59,-12,44
East Fife,9071,7,13,4,19,49,66,-17,43
Forfar,9071,8,10,5,21,39,66,-27,35
Albion,9071,9,8,7,21,59,80,-21,31
Queen's Park,9071,10,6,11,19,41,74,-33,29
Raith,9072,1,23,8,5,69,32,37,77
Ayr,9072,2,24,4,8,93,42,51,76
Arbroath,9072,3,17,8,11,70,50,20,59
Alloa,9072,4,17,8,11,56,44,12,59
Stranraer,9072,5,16,5,15,58,66,-8,53
Airdrieon,9072,6,11,11,14,47,59,-12,44
East Fife,9072,7,13,3,20,49,67,-18,42
Forfar,9072,8,10,5,21,39,66,-27,35
Queen's Park,9072,9,7,10,19,41,72,-31,31
Albion,9072,10,8,6,22,57,81,-24,30
Raith,9073,1,23,8,5,71,33,38,77
Ayr,9073,2,24,4,8,94,43,51,76
Arbroath,9073,3,17,8,11,71,52,19,59
Alloa,9073,4,17,8,11,57,46,11,59
Stranraer,9073,5,16,5,15,56,64,-8,53
Airdrieon,9073,6,11,11,14,47,58,-11,44
East Fife,9073,7,13,3,20,47,65,-18,42
Forfar,9073,8,10,5,21,38,66,-28,35
Queen's Park,9073,9,7,10,19,43,73,-30,31
Albion,9073,10,8,6,22,58,82,-24,30
Ayr,9074,1,24,4,8,93,43,50,76
Raith,9074,2,22,8,6,68,33,35,74
Arbroath,9074,3,18,8,10,73,50,23,62
Alloa,9074,4,18,8,10,57,43,14,62
Stranraer,9074,5,15,5,16,55,65,-10,50
East Fife,9074,6,14,3,19,48,64,-16,45
Airdrieon,9074,7,11,11,14,47,59,-12,44
Forfar,9074,8,10,5,21,39,66,-27,35
Albion,9074,9,8,6,22,58,81,-23,30
Queen's Park,9074,10,6,10,20,41,75,-34,28
Ayr,9075,1,23,5,8,91,43,48,74
Raith,9075,2,22,8,6,68,35,33,74
Alloa,9075,3,18,8,10,59,43,16,62
Arbroath,9075,4,17,8,11,72,51,21,59
Stranraer,9075,5,15,5,16,55,65,-10,50
East Fife,9075,6,14,3,19,48,64,-16,45
Airdrieon,9075,7,10,11,15,45,60,-15,41
Forfar,9075,8,11,5,20,40,64,-24,38
Albion,9075,9,8,7,21,58,79,-21,31
Queen's Park,9075,10,7,10,19,42,74,-32,31
Raith,9076,1,23,8,5,74,32,42,77
Ayr,9076,2,24,4,8,96,42,54,76
Arbroath,9076,3,18,8,10,76,49,27,62
Alloa,9076,4,17,8,11,56,49,7,59
Stranraer,9076,5,15,5,16,57,67,-10,50
East Fife,9076,6,14,3,19,50,66,-16,45
Airdrieon,9076,7,11,11,14,46,58,-12,44
Forfar,9076,8,10,5,21,38,65,-27,35
Albion,9076,9,8,6,22,57,84,-27,30
Queen's Park,9076,10,6,10,20,40,78,-38,28
Ayr,9077,1,24,4,8,96,43,53,76
Raith,9077,2,22,8,6,69,35,34,74
Arbroath,9077,3,18,8,10,71,48,23,62
Alloa,9077,4,18,8,10,59,44,15,62
Stranraer,9077,5,16,5,15,57,65,-8,53
Airdrieon,9077,6,10,12,14,46,59,-13,42
East Fife,9077,7,13,3,20,48,66,-18,42
Forfar,9077,8,10,6,20,39,65,-26,36
Albion,9077,9,8,6,22,58,84,-26,30
Queen's Park,9077,10,6,10,20,39,73,-34,28
Raith,9078,1,23,8,5,71,34,37,77
Ayr,9078,2,24,4,8,95,43,52,76
Arbroath,9078,3,17,8,11,72,51,21,59
Alloa,9078,4,17,8,11,58,46,12,59
Stranraer,9078,5,16,5,15,57,65,-8,53
Airdrieon,9078,6,11,11,14,48,59,-11,44
East Fife,9078,7,13,3,20,48,66,-18,42
Forfar,9078,8,10,5,21,39,67,-28,35
Queen's Park,9078,9,7,10,19,42,74,-32,31
Albion,9078,10,8,6,22,58,83,-25,30
Raith,9079,1,23,8,5,71,32,39,77
Ayr,9079,2,23,4,9,90,44,46,73
Arbroath,9079,3,18,8,10,73,48,25,62
Alloa,9079,4,17,8,11,56,46,10,59
Stranraer,9079,5,15,5,16,55,65,-10,50
East Fife,9079,6,14,3,19,48,64,-16,45
Airdrieon,9079,7,11,11,14,48,59,-11,44
Forfar,9079,8,10,5,21,39,67,-28,35
Albion,9079,9,9,6,21,59,78,-19,33
Queen's Park,9079,10,6,10,20,39,75,-36,28
Ayr,9080,1,24,4,8,91,42,49,76
Raith,9080,2,22,8,6,69,34,35,74
Alloa,9080,3,18,8,10,58,44,14,62
Arbroath,9080,4,17,8,11,70,51,19,59
Stranraer,9080,5,16,5,15,57,65,-8,53
Airdrieon,9080,6,11,11,14,48,59,-11,44
East Fife,9080,7,13,3,20,48,66,-18,42
Forfar,9080,8,10,5,21,39,67,-28,35
Queen's Park,9080,9,7,10,19,42,72,-30,31
Albion,9080,10,8,6,22,57,79,-22,30
Raith,9081,1,23,8,5,70,33,37,77
Ayr,9081,2,24,4,8,93,42,51,76
Arbroath,9081,3,18,8,10,72,48,24,62
Alloa,9081,4,17,8,11,57,45,12,59
Stranraer,9081,5,15,5,16,55,67,-12,50
East Fife,9081,6,14,3,19,50,64,-14,45
Airdrieon,9081,7,11,11,14,47,58,-11,44
Forfar,9081,8,10,5,21,38,66,-28,35
Albion,9081,9,8,6,22,57,81,-24,30
Queen's Park,9081,10,6,10,20,39,74,-35,28
Ayr,9082,1,24,4,8,93,42,51,76
Raith,9082,2,22,8,6,69,34,35,74
Alloa,9082,3,18,8,10,58,44,14,62
Arbroath,9082,4,17,8,11,70,51,19,59
Stranraer,9082,5,15,5,16,55,65,-10,50
East Fife,9082,6,14,3,19,48,64,-16,45
Airdrieon,9082,7,10,11,15,45,59,-14,41
Forfar,9082,8,11,5,20,39,64,-25,38
Queen's Park,9082,9,7,10,19,42,72,-30,31
Albion,9082,10,8,6,22,57,81,-24,30
Ayr,9083,1,24,4,8,95,43,52,76
Raith,9083,2,22,9,5,68,32,36,75
Arbroath,9083,3,17,9,10,72,50,22,60
Alloa,9083,4,17,9,10,56,43,13,60
Stranraer,9083,5,15,5,16,57,68,-11,50
East Fife,9083,6,14,3,19,51,66,-15,45
Airdrieon,9083,7,11,11,14,48,60,-12,44
Forfar,9083,8,10,5,21,40,67,-27,35
Albion,9083,9,8,6,22,58,83,-25,30
Queen's Park,9083,10,6,11,19,41,74,-33,29
Ayr,9084,1,24,4,8,93,43,50,76
Raith,9084,2,22,8,6,69,34,35,74
Alloa,9084,3,18,8,10,58,44,14,62
Arbroath,9084,4,17,9,10,71,49,22,60
Stranraer,9084,5,15,5,16,56,69,-13,50
East Fife,9084,6,14,3,19,52,65,-13,45
Airdrieon,9084,7,10,12,14,46,59,-13,42
Forfar,9084,8,10,6,20,39,65,-26,36
Albion,9084,9,8,6,22,58,81,-23,30
Queen's Park,9084,10,6,11,19,40,73,-33,29
Raith,9085,1,23,8,5,70,33,37,77
Ayr,9085,2,24,4,8,93,43,50,76
Arbroath,9085,3,18,8,10,73,48,25,62
Alloa,9085,4,17,8,11,57,45,12,59
Stranraer,9085,5,16,5,15,57,65,-8,53
East Fife,9085,6,13,3,20,48,66,-18,42
Airdrieon,9085,7,10,11,15,45,59,-14,41
Forfar,9085,8,11,5,20,39,64,-25,38
Albion,9085,9,8,6,22,58,81,-23,30
Queen's Park,9085,10,6,10,20,39,75,-36,28
Ayr,9086,1,24,4,8,94,43,51,76
Raith,9086,2,22,9,5,70,34,36,75
Arbroath,9086,3,17,9,10,71,49,22,60
Alloa,9086,4,17,9,10,58,45,13,60
Stranraer,9086,5,15,6,15,58,67,-9,51
Airdrieon,9086,6,11,11,14,49,58,-9,44
East Fife,9086,7,13,4,19,50,67,-17,43
Forfar,9086,8,10,5,21,38,68,-30,35
Albion,9086,9,8,6,22,58,82,-24,30
Queen's Park,9086,10,6,11,19,40,73,-33,29
Raith,9087,1,23,8,5,69,32,37,77
Ayr,9087,2,24,4,8,94,42,52,76
Arbroath,9087,3,18,8,10,74,48,26,62
Alloa,9087,4,17,8,11,56,44,12,59
Stranraer,9087,5,15,5,16,57,67,-10,50
East Fife,9087,6,14,3,19,50,66,-16,45
Airdrieon,9087,7,10,12,14,46,59,-13,42
Forfar,9087,8,10,6,20,39,65,-26,36
Albion,9087,9,8,6,22,57,82,-25,30
Queen's Park,9087,10,6,10,20,39,76,-37,28
Ayr,9088,1,24,4,8,93,42,51,76
Raith,9088,2,22,9,5,68,32,36,75
Arbroath,9088,3,17,9,10,71,49,22,60
Alloa,9088,4,17,9,10,56,43,13,60
Stranraer,9088,5,15,6,15,58,67,-9,51
East Fife,9088,6,13,4,19,50,67,-17,43
Airdrieon,9088,7,10,12,14,45,58,-13,42
Forfar,9088,8,10,6,20,38,64,-26,36
Albion,9088,9,8,6,22,57,81,-24,30
Queen's Park,9088,10,6,11,19,40,73,-33,29
Raith,9089,1,23,8,5,70,33,37,77
Ayr,9089,2,24,4,8,96,45,51,76
Arbroath,9089,3,18,8,10,75,48,27,62
Alloa,9089,4,17,8,11,57,45,12,59
Stranraer,9089,5,15,5,16,56,67,-11,50
East Fife,9089,6,14,3,19,50,65,-15,45
Airdrieon,9089,7,11,11,14,49,58,-9,44
Forfar,9089,8,10,5,21,38,68,-30,35
Albion,9089,9,8,6,22,60,84,-24,30
Queen's Park,9089,10,6,10,20,39,77,-38,28
Raith,9090,1,23,8,5,71,33,38,77
Ayr,9090,2,24,4,8,97,44,53,76
Arbroath,9090,3,18,8,10,75,48,27,62
Alloa,9090,4,17,8,11,57,46,11,59
Stranraer,9090,5,16,5,15,58,65,-7,53
Airdrieon,9090,6,10,12,14,45,58,-13,42
East Fife,9090,7,13,3,20,48,67,-19,42
Forfar,9090,8,10,6,20,38,64,-26,36
Albion,9090,9,8,6,22,59,85,-26,30
Queen's Park,9090,10,6,10,20,39,77,-38,28
Raith,9091,1,22,9,5,69,33,36,75
Ayr,9091,2,23,5,8,91,43,48,74
Arbroath,9091,3,18,8,10,74,48,26,62
Alloa,9091,4,17,9,10,57,44,13,60
Stranraer,9091,5,16,5,15,56,64,-8,53
East Fife,9091,6,13,3,20,47,65,-18,42
Airdrieon,9091,7,10,11,15,45,61,-16,41
Forfar,9091,8,11,5,20,41,64,-23,38
Albion,9091,9,8,7,21,58,79,-21,31
Queen's Park,9091,10,6,10,20,39,76,-37,28
Raith,9092,1,23,8,5,70,32,38,77
Ayr,9092,2,24,4,8,93,42,51,76
Arbroath,9092,3,17,8,11,72,52,20,59
Alloa,9092,4,17,8,11,56,45,11,59
Stranraer,9092,5,15,5,16,56,67,-11,50
East Fife,9092,6,14,3,19,50,65,-15,45
Airdrieon,9092,7,10,12,14,46,59,-13,42
Forfar,9092,8,10,6,20,39,65,-26,36
Queen's Park,9092,9,7,10,19,43,74,-31,31
Albion,9092,10,8,6,22,57,81,-24,30
Raith,9093,1,23,8,5,70,32,38,77
Ayr,9093,2,24,4,8,93,42,51,76
Arbroath,9093,3,17,9,10,70,48,22,60
Alloa,9093,4,17,8,11,56,45,11,59
Stranraer,9093,5,15,6,15,56,65,-9,51
East Fife,9093,6,13,4,19,48,65,-17,43
Airdrieon,9093,7,10,12,14,46,59,-13,42
Forfar,9093,8,10,6,20,39,65,-26,36
Albion,9093,9,8,6,22,57,81,-24,30
Queen's Park,9093,10,6,11,19,39,72,-33,29
Ayr,9094,1,23,5,8,92,44,48,74
Raith,9094,2,22,8,6,68,33,35,74
Arbroath,9094,3,18,8,10,72,49,23,62
Alloa,9094,4,18,8,10,57,43,14,62
Stranraer,9094,5,15,5,16,55,66,-11,50
East Fife,9094,6,14,3,19,49,64,-15,45
Airdrieon,9094,7,10,12,14,46,59,-13,42
Forfar,9094,8,10,6,20,39,65,-26,36
Albion,9094,9,8,7,21,59,80,-21,31
Queen's Park,9094,10,6,10,20,40,74,-34,28
Raith,9095,1,23,8,5,72,32,40,77
Ayr,9095,2,24,4,8,93,43,50,76
Arbroath,9095,3,18,8,10,72,49,23,62
Alloa,9095,4,17,8,11,56,47,9,59
Stranraer,9095,5,15,5,16,55,65,-10,50
East Fife,9095,6,14,3,19,48,64,-16,45
Airdrieon,9095,7,10,12,14,47,60,-13,42
Forfar,9095,8,10,6,20,40,66,-26,36
Albion,9095,9,8,6,22,58,81,-23,30
Queen's Park,9095,10,6,10,20,40,74,-34,28
Raith,9096,1,23,8,5,71,32,39,77
Ayr,9096,2,23,4,9,92,45,47,73
Arbroath,9096,3,18,8,10,72,49,23,62
Alloa,9096,4,17,8,11,56,46,10,59
Stranraer,9096,5,15,5,16,56,66,-10,50
East Fife,9096,6,14,3,19,49,65,-16,45
Airdrieon,9096,7,10,11,15,45,59,-14,41
Forfar,9096,8,11,5,20,39,64,-25,38
Albion,9096,9,9,6,21,60,80,-20,33
Queen's Park,9096,10,6,10,20,40,74,-34,28
Raith,9097,1,22,8,6,69,35,34,74
Ayr,9097,2,23,4,9,92,45,47,73
Alloa,9097,3,18,8,10,59,44,15,62
Arbroath,9097,4,17,8,11,71,50,21,59
Stranraer,9097,5,16,5,15,58,64,-6,53
Airdrieon,9097,6,10,12,14,45,58,-13,42
East Fife,9097,7,13,3,20,47,67,-20,42
Forfar,9097,8,10,6,20,38,64,-26,36
Albion,9097,9,9,6,21,60,80,-20,33
Queen's Park,9097,10,7,10,19,41,73,-32,31
Raith,9098,1,23,8,5,69,32,37,77
Ayr,9098,2,23,5,8,91,43,48,74
Arbroath,9098,3,17,8,11,70,49,21,59
Alloa,9098,4,17,8,11,56,44,12,59
Stranraer,9098,5,15,5,16,56,66,-10,50
East Fife,9098,6,14,3,19,49,65,-16,45
Airdrieon,9098,7,11,11,14,47,59,-12,44
Forfar,9098,8,10,5,21,39,66,-27,35
Albion,9098,9,8,7,21,58,79,-21,31
Queen's Park,9098,10,7,10,19,40,72,-32,31
Raith,9099,1,23,8,5,72,32,40,77
Ayr,9099,2,24,4,8,97,45,52,76
Arbroath,9099,3,17,9,10,73,51,22,60
Alloa,9099,4,17,8,11,56,47,9,59
Stranraer,9099,5,15,5,16,56,66,-10,50
East Fife,9099,6,14,3,19,49,65,-16,45
Airdrieon,9099,7,11,11,14,48,60,-12,44
Forfar,9099,8,10,5,21,40,67,-27,35
Albion,9099,9,8,6,22,60,85,-25,30
Queen's Park,9099,10,6,11,19,42,75,-33,29
Ayr,9100,1,23,5,8,93,45,48,74
Raith,9100,2,22,8,6,70,36,34,74
Alloa,9100,3,18,8,10,60,45,15,62
Arbroath,9100,4,17,8,11,72,51,21,59
Stranraer,9100,5,16,5,15,58,66,-8,53
Airdrieon,9100,6,11,11,14,48,58,-10,44
East Fife,9100,7,13,3,20,49,67,-18,42
Forfar,9100,8,10,5,21,38,67,-29,35
Albion,9100,9,8,7,21,60,81,-21,31
Queen's Park,9100,10,7,10,19,42,74,-32,31
Ayr,9101,1,24,4,8,94,42,52,76
Raith,9101,2,22,8,6,68,33,35,74
Arbroath,9101,3,18,8,10,72,49,23,62
Alloa,9101,4,18,8,10,57,43,14,62
Stranraer,9101,5,15,6,15,59,68,-9,51
Airdrieon,9101,6,11,11,14,48,59,-11,44
East Fife,9101,7,13,4,19,51,68,-17,43
Forfar,9101,8,10,5,21,39,67,-28,35
Albion,9101,9,8,6,22,57,82,-25,30
Queen's Park,9101,10,6,10,20,40,74,-34,28
Raith,9102,1,23,8,5,69,32,37,77
Ayr,9102,2,23,5,8,92,44,48,74
Arbroath,9102,3,17,8,11,70,49,21,59
Alloa,9102,4,17,8,11,56,44,12,59
Stranraer,9102,5,15,5,16,56,67,-11,50
East Fife,9102,6,14,3,19,50,65,-15,45
Airdrieon,9102,7,10,11,15,45,59,-14,41
Forfar,9102,8,11,5,20,39,64,-25,38
Albion,9102,9,8,7,21,59,80,-21,31
Queen's Park,9102,10,7,10,19,40,72,-32,31
Ayr,9103,1,24,4,8,92,42,50,76
Raith,9103,2,22,8,6,70,35,35,74
Alloa,9103,3,18,8,10,59,45,14,62
Arbroath,9103,4,17,8,11,71,51,20,59
Stranraer,9103,5,16,5,15,57,64,-7,53
East Fife,9103,6,13,3,20,47,66,-19,42
Airdrieon,9103,7,10,11,15,45,60,-15,41
Forfar,9103,8,11,5,20,40,64,-24,38
Queen's Park,9103,9,7,10,19,42,73,-31,31
Albion,9103,10,8,6,22,57,80,-23,30
Ayr,9104,1,23,5,8,92,44,48,74
Raith,9104,2,22,8,6,68,33,35,74
Alloa,9104,3,18,8,10,57,43,14,62
Arbroath,9104,4,17,8,11,71,50,21,59
Stranraer,9104,5,15,5,16,55,65,-10,50
East Fife,9104,6,14,3,19,48,64,-16,45
Airdrieon,9104,7,10,12,14,46,59,-13,42
Forfar,9104,8,10,6,20,39,65,-26,36
Albion,9104,9,8,7,21,59,80,-21,31
Queen's Park,9104,10,7,10,19,41,73,-32,31
Raith,9105,1,23,8,5,69,32,37,77
Ayr,9105,2,23,5,8,91,43,48,74
Arbroath,9105,3,17,9,10,70,48,22,60
Alloa,9105,4,17,8,11,56,44,12,59
Stranraer,9105,5,15,5,16,55,65,-10,50
East Fife,9105,6,14,3,19,48,64,-16,45
Airdrieon,9105,7,10,11,15,45,60,-15,41
Forfar,9105,8,11,5,20,40,64,-24,38
Albion,9105,9,8,7,21,58,79,-21,31
Queen's Park,9105,10,6,11,19,39,72,-33,29
Ayr,9106,1,24,4,8,93,43,50,76
Raith,9106,2,22,8,6,71,36,35,74
Alloa,9106,3,18,8,10,60,46,14,62
Arbroath,9106,4,17,9,10,72,50,22,60
Stranraer,9106,5,15,5,16,56,66,-10,50
East Fife,9106,6,14,3,19,49,65,-16,45
Airdrieon,9106,7,10,11,15,46,61,-15,41
Forfar,9106,8,11,5,20,41,65,-24,38
Albion,9106,9,8,6,22,58,81,-23,30
Queen's Park,9106,10,6,11,19,41,74,-33,29
Raith,9107,1,23,8,5,71,33,38,77
Ayr,9107,2,23,4,9,90,44,46,73
Arbroath,9107,3,18,8,10,71,48,23,62
Alloa,9107,4,17,8,11,57,46,11,59
Stranraer,9107,5,15,6,15,56,65,-9,51
East Fife,9107,6,13,4,19,48,65,-17,43
Airdrieon,9107,7,10,11,15,45,59,-14,41
Forfar,9107,8,11,5,20,39,64,-25,38
Albion,9107,9,9,6,21,59,78,-19,33
Queen's Park,9107,10,6,10,20,39,73,-34,28
Ayr,9108,1,24,4,8,93,42,51,76
Raith,9108,2,22,9,5,69,33,36,75
Alloa,9108,3,17,9,10,57,44,13,60
Arbroath,9108,4,17,8,11,70,49,21,59
Stranraer,9108,5,15,5,16,56,66,-10,50
East Fife,9108,6,14,3,19,49,65,-16,45
Airdrieon,9108,7,11,11,14,47,59,-12,44
Forfar,9108,8,10,5,21,39,66,-27,35
Queen's Park,9108,9,7,10,19,40,72,-32,31
Albion,9108,10,8,6,22,57,81,-24,30
Raith,9109,1,23,8,5,69,32,37,77
Ayr,9109,2,24,4,8,91,42,49,76
Arbroath,9109,3,17,8,11,71,51,20,59
Alloa,9109,4,17,8,11,56,44,12,59
Stranraer,9109,5,15,6,15,58,67,-9,51
Airdrieon,9109,6,11,11,14,46,58,-12,44
East Fife,9109,7,13,4,19,50,67,-17,43
Forfar,9109,8,10,5,21,38,65,-27,35
Queen's Park,9109,9,7,10,19,42,73,-31,31
Albion,9109,10,8,6,22,57,79,-22,30
Raith,9110,1,23,8,5,70,32,38,77
Ayr,9110,2,23,5,8,93,45,48,74
Arbroath,9110,3,17,8,11,70,51,19,59
Alloa,9110,4,17,8,11,56,45,11,59
Stranraer,9110,5,15,5,16,57,68,-11,50
East Fife,9110,6,14,3,19,51,66,-15,45
Airdrieon,9110,7,10,11,15,47,61,-14,41
Forfar,9110,8,11,5,20,41,66,-25,38
Albion,9110,9,8,7,21,60,81,-21,31
Queen's Park,9110,10,7,10,19,42,72,-30,31
Raith,9111,1,23,8,5,71,34,37,77
Ayr,9111,2,24,4,8,92,43,49,76
Arbroath,9111,3,18,8,10,71,48,23,62
Alloa,9111,4,17,8,11,58,46,12,59
Stranraer,9111,5,16,5,15,56,64,-8,53
Airdrieon,9111,6,11,11,14,47,59,-12,44
East Fife,9111,7,13,3,20,47,65,-18,42
Forfar,9111,8,10,5,21,39,66,-27,35
Albion,9111,9,8,6,22,58,80,-22,30
Queen's Park,9111,10,6,10,20,39,73,-34,28
Ayr,9112,1,24,4,8,95,43,52,76
Raith,9112,2,22,9,5,68,32,36,75
Arbroath,9112,3,18,8,10,71,48,23,62
Alloa,9112,4,17,9,10,56,43,13,60
Stranraer,9112,5,16,5,15,57,65,-8,53
East Fife,9112,6,13,3,20,48,66,-18,42
Airdrieon,9112,7,10,11,15,47,61,-14,41
Forfar,9112,8,11,5,20,41,66,-25,38
Albion,9112,9,8,6,22,58,83,-25,30
Queen's Park,9112,10,6,10,20,39,73,-34,28
Ayr,9113,1,24,4,8,95,42,53,76
Raith,9113,2,22,9,5,69,33,36,75
Arbroath,9113,3,18,8,10,73,48,25,62
Alloa,9113,4,17,9,10,57,44,13,60
Stranraer,9113,5,15,5,16,55,66,-11,50
East Fife,9113,6,14,3,19,49,64,-15,45
Airdrieon,9113,7,10,11,15,45,60,-15,41
Forfar,9113,8,11,5,20,40,64,-24,38
Albion,9113,9,8,6,22,57,83,-26,30
Queen's Park,9113,10,6,10,20,39,75,-36,28
Ayr,9114,1,24,4,8,94,43,51,76
Raith,9114,2,22,9,5,69,33,36,75
Arbroath,9114,3,18,8,10,73,48,25,62
Alloa,9114,4,17,9,10,57,44,13,60
Stranraer,9114,5,16,5,15,58,64,-6,53
Airdrieon,9114,6,11,11,14,50,59,-9,44
East Fife,9114,7,13,3,20,47,67,-20,42
Forfar,9114,8,10,5,21,39,69,-30,35
Albion,9114,9,8,6,22,58,82,-24,30
Queen's Park,9114,10,6,10,20,39,75,-36,28
Ayr,9115,1,24,4,8,94,42,52,76
Raith,9115,2,22,8,6,69,34,35,74
Arbroath,9115,3,18,8,10,71,48,23,62
Alloa,9115,4,18,8,10,58,44,14,62
Stranraer,9115,5,15,6,15,56,65,-9,51
Airdrieon,9115,6,11,11,14,47,58,-11,44
East Fife,9115,7,13,4,19,48,65,-17,43
Forfar,9115,8,10,5,21,38,66,-28,35
Albion,9115,9,8,6,22,57,82,-25,30
Queen's Park,9115,10,6,10,20,39,73,-34,28
Ayr,9116,1,23,5,8,95,47,48,74
Raith,9116,2,22,8,6,68,34,34,74
Arbroath,9116,3,18,8,10,72,49,23,62
Alloa,9116,4,18,8,10,58,43,15,62
Stranraer,9116,5,16,5,15,57,65,-8,53
Airdrieon,9116,6,11,11,14,46,58,-12,44
East Fife,9116,7,13,3,20,48,66,-18,42
Forfar,9116,8,10,5,21,38,65,-27,35
Albion,9116,9,8,7,21,62,83,-21,31
Queen's Park,9116,10,6,10,20,40,74,-34,28
Raith,9117,1,23,8,5,69,32,37,77
Ayr,9117,2,24,4,8,97,43,54,76
Arbroath,9117,3,18,8,10,72,48,24,62
Alloa,9117,4,17,8,11,56,44,12,59
Stranraer,9117,5,15,6,15,56,65,-9,51
East Fife,9117,6,13,4,19,48,65,-17,43
Airdrieon,9117,7,10,12,14,47,60,-13,42
Forfar,9117,8,10,6,20,40,66,-26,36
Albion,9117,9,8,6,22,58,85,-27,30
Queen's Park,9117,10,6,10,20,39,74,-35,28
Raith,9118,1,23,8,5,73,33,40,77
Ayr,9118,2,24,4,8,94,43,51,76
Arbroath,9118,3,17,8,11,71,50,21,59
Alloa,9118,4,17,8,11,57,48,9,59
Stranraer,9118,5,16,5,15,56,64,-8,53
East Fife,9118,6,13,3,20,47,65,-18,42
Airdrieon,9118,7,10,11,15,45,59,-14,41
Forfar,9118,8,11,5,20,39,64,-25,38
Queen's Park,9118,9,7,10,19,41,73,-32,31
Albion,9118,10,8,6,22,58,82,-24,30
Raith,9119,1,23,8,5,70,32,38,77
Ayr,9119,2,24,4,8,95,42,53,76
Arbroath,9119,3,17,9,10,72,50,22,60
Alloa,9119,4,17,8,11,56,45,11,59
Stranraer,9119,5,16,5,15,56,64,-8,53
Airdrieon,9119,6,11,11,14,49,58,-9,44
East Fife,9119,7,13,3,20,47,65,-18,42
Forfar,9119,8,10,5,21,38,68,-30,35
Albion,9119,9,8,6,22,57,83,-26,30
Queen's Park,9119,10,6,11,19,41,74,-33,29
Ayr,9120,1,24,4,8,94,44,50,76
Raith,9120,2,22,8,6,69,34,35,74
Arbroath,9120,3,18,8,10,71,48,23,62
Alloa,9120,4,18,8,10,58,44,14,62
Stranraer,9120,5,15,5,16,55,68,-13,50
East Fife,9120,6,14,3,19,51,64,-13,45
Airdrieon,9120,7,10,11,15,46,60,-14,41
Forfar,9120,8,11,5,20,40,65,-25,38
Albion,9120,9,8,6,22,59,82,-23,30
Queen's Park,9120,10,6,10,20,39,73,-34,28
Ayr,9121,1,24,4,8,95,44,51,76
Raith,9121,2,22,8,6,68,33,35,74
Alloa,9121,3,18,8,10,57,43,14,62
Arbroath,9121,4,17,9,10,72,50,22,60
Stranraer,9121,5,15,6,15,55,64,-9,51
East Fife,9121,6,13,4,19,47,64,-17,43
Airdrieon,9121,7,10,11,15,45,59,-14,41
Forfar,9121,8,11,5,20,39,64,-25,38
Albion,9121,9,8,6,22,59,83,-24,30
Queen's Park,9121,10,6,11,19,41,74,-33,29
Ayr,9122,1,24,4,8,95,42,53,76
Raith,9122,2,22,9,5,70,34,36,75
Arbroath,9122,3,18,8,10,75,48,27,62
Alloa,9122,4,17,9,10,58,45,13,60
Stranraer,9122,5,15,5,16,56,66,-10,50
East Fife,9122,6,14,3,19,49,65,-16,45
Airdrieon,9122,7,11,11,14,48,59,-11,44
Forfar,9122,8,10,5,21,39,67,-28,35
Albion,9122,9,8,6,22,57,83,-26,30
Queen's Park,9122,10,6,10,20,39,77,-38,28
Ayr,9123,1,24,4,8,94,42,52,76
Raith,9123,2,22,8,6,70,35,35,74
Alloa,9123,3,18,8,10,59,45,14,62
Arbroath,9123,4,17,9,10,71,49,22,60
Stranraer,9123,5,15,5,16,56,66,-10,50
East Fife,9123,6,14,3,19,49,65,-16,45
Airdrieon,9123,7,10,11,15,45,59,-14,41
Forfar,9123,8,11,5,20,39,64,-25,38
Albion,9123,9,8,6,22,57,82,-25,30
Queen's Park,9123,10,6,11,19,40,73,-33,29
Raith,9124,1,22,9,5,68,32,36,75
Ayr,9124,2,23,5,8,93,45,48,74
Arbroath,9124,3,17,9,10,70,48,22,60
Alloa,9124,4,17,9,10,56,43,13,60
Stranraer,9124,5,15,6,15,57,66,-9,51
Airdrieon,9124,6,11,11,14,46,58,-12,44
East Fife,9124,7,13,4,19,49,66,-17,43
Forfar,9124,8,10,5,21,38,65,-27,35
Albion,9124,9,8,7,21,60,81,-21,31
Queen's Park,9124,10,6,11,19,39,72,-33,29
Raith,9125,1,23,8,5,70,33,37,77
Ayr,9125,2,23,4,9,92,45,47,73
Arbroath,9125,3,18,8,10,72,49,23,62
Alloa,9125,4,17,8,11,57,45,12,59
Stranraer,9125,5,16,5,15,56,64,-8,53
Airdrieon,9125,6,11,11,14,47,58,-11,44
East Fife,9125,7,13,3,20,47,65,-18,42
Forfar,9125,8,10,5,21,38,66,-28,35
Albion,9125,9,9,6,21,60,80,-20,33
Queen's Park,9125,10,6,10,20,40,74,-34,28
Ayr,9126,1,24,4,8,92,43,49,76
Raith,9126,2,22,8,6,69,34,35,74
Alloa,9126,3,18,8,10,58,44,14,62
Arbroath,9126,4,17,9,10,72,50,22,60
Stranraer,9126,5,16,5,15,57,64,-7,53
Airdrieon,9126,6,11,11,14,47,58,-11,44
East Fife,9126,7,13,3,20,47,66,-19,42
Forfar,9126,8,10,5,21,38,66,-28,35
Albion,9126,9,8,6,22,58,80,-22,30
Queen's Park,9126,10,6,11,19,41,74,-33,29
Ayr,9127,1,24,4,8,93,44,49,76
Raith,9127,2,22,8,6,69,34,35,74
Arbroath,9127,3,18,8,10,72,48,24,62
Alloa,9127,4,18,8,10,58,44,14,62
Stranraer,9127,5,16,5,15,59,65,-6,53
Airdrieon,9127,6,10,12,14,45,58,-13,42
East Fife,9127,7,13,3,20,48,68,-20,42
Forfar,9127,8,10,6,20,38,64,-26,36
Albion,9127,9,8,6,22,59,81,-22,30
Queen's Park,9127,10,6,10,20,39,74,-35,28
Raith,9128,1,23,8,5,71,32,39,77
Ayr,9128,2,23,4,9,90,44,46,73
Arbroath,9128,3,17,8,11,70,49,21,59
Alloa,9128,4,17,8,11,56,46,10,59
Stranraer,9128,5,16,5,15,57,64,-7,53
East Fife,9128,6,13,3,20,47,66,-19,42
Airdrieon,9128,7,10,11,15,45,61,-16,41
Forfar,9128,8,11,5,20,41,64,-23,38
Albion,9128,9,9,6,21,59,78,-19,33
Queen's Park,9128,10,7,10,19,40,72,-32,31
Raith,9129,1,23,8,5,70,33,37,77
Ayr,9129,2,24,4,8,91,42,49,76
Arbroath,9129,3,17,8,11,71,51,20,59
Alloa,9129,4,17,8,11,57,45,12,59
Stranraer,9129,5,15,5,16,56,70,-14,50
East Fife,9129,6,14,3,19,53,65,-12,45
Airdrieon,9129,7,10,12,14,47,60,-13,42
Forfar,9129,8,10,6,20,40,66,-26,36
Queen's Park,9129,9,7,10,19,42,73,-31,31
Albion,9129,10,8,6,22,57,79,-22,30
Raith,9130,1,23,8,5,69,32,37,77
Ayr,9130,2,23,4,9,91,44,47,73
Arbroath,9130,3,17,8,11,71,52,19,59
Alloa,9130,4,17,8,11,56,44,12,59
Stranraer,9130,5,15,5,16,56,68,-12,50
East Fife,9130,6,14,3,19,51,65,-14,45
Airdrieon,9130,7,10,11,15,46,60,-14,41
Forfar,9130,8,11,5,20,40,65,-25,38
Albion,9130,9,9,6,21,59,79,-20,33
Queen's Park,9130,10,7,10,19,43,73,-30,31
Raith,9131,1,23,8,5,70,32,38,77
Ayr,9131,2,24,4,8,95,45,50,76
Arbroath,9131,3,17,9,10,71,49,22,60
Alloa,9131,4,17,8,11,56,45,11,59
Stranraer,9131,5,15,6,15,57,66,-9,51
East Fife,9131,6,13,4,19,49,66,-17,43
Airdrieon,9131,7,10,12,14,45,58,-13,42
Forfar,9131,8,10,6,20,38,64,-26,36
Albion,9131,9,8,6,22,60,83,-23,30
Queen's Park,9131,10,6,11,19,40,73,-33,29
Raith,9132,1,23,8,5,69,32,37,77
Ayr,9132,2,24,4,8,95,43,52,76
Arbroath,9132,3,18,8,10,71,48,23,62
Alloa,9132,4,17,8,11,56,44,12,59
Stranraer,9132,5,16,5,15,56,64,-8,53
Airdrieon,9132,6,11,11,14,49,58,-9,44
East Fife,9132,7,13,3,20,47,65,-18,42
Forfar,9132,8,10,5,21,38,68,-30,35
Albion,9132,9,8,6,22,58,83,-25,30
Queen's Park,9132,10,6,10,20,39,73,-34,28
Raith,9133,1,23,8,5,71,34,37,77
Ayr,9133,2,24,4,8,92,42,50,76
Arbroath,9133,3,18,8,10,72,49,23,62
Alloa,9133,4,17,8,11,58,46,12,59
Stranraer,9133,5,15,6,15,57,66,-9,51
East Fife,9133,6,13,4,19,49,66,-17,43
Airdrieon,9133,7,10,11,15,45,59,-14,41
Forfar,9133,8,11,5,20,39,64,-25,38
Albion,9133,9,8,6,22,57,80,-23,30
Queen's Park,9133,10,6,10,20,40,74,-34,28
Raith,9134,1,23,8,5,69,32,37,77
Ayr,9134,2,24,4,8,92,43,49,76
Arbroath,9134,3,18,8,10,71,48,23,62
Alloa,9134,4,17,8,11,56,44,12,59
Stranraer,9134,5,16,5,15,58,64,-6,53
Airdrieon,9134,6,11,11,14,46,58,-12,44
East Fife,9134,7,13,3,20,47,67,-20,42
Forfar,9134,8,10,5,21,38,65,-27,35
Albion,9134,9,8,6,22,58,80,-22,30
Queen's Park,9134,10,6,10,20,39,73,-34,28
Ayr,9135,1,24,4,8,92,42,50,76
Raith,9135,2,22,9,5,68,32,36,75
Arbroath,9135,3,18,8,10,74,48,26,62
Alloa,9135,4,17,9,10,56,43,13,60
Stranraer,9135,5,16,5,15,58,65,-7,53
East Fife,9135,6,13,3,20,48,67,-19,42
Airdrieon,9135,7,10,11,15,45,60,-15,41
Forfar,9135,8,11,5,20,40,64,-24,38
Albion,9135,9,8,6,22,57,80,-23,30
Queen's Park,9135,10,6,10,20,39,76,-37,28
Raith,9136,1,23,8,5,72,32,40,77
Ayr,9136,2,23,5,8,92,44,48,74
Arbroath,9136,3,17,8,11,71,50,21,59
Alloa,9136,4,17,8,11,56,47,9,59
Stranraer,9136,5,15,5,16,55,66,-11,50
East Fife,9136,6,14,3,19,49,64,-15,45
Airdrieon,9136,7,11,11,14,50,60,-10,44
Forfar,9136,8,10,5,21,40,69,-29,35
Albion,9136,9,8,7,21,59,80,-21,31
Queen's Park,9136,10,7,10,19,41,73,-32,31
Raith,9137,1,23,8,5,73,32,41,77
Ayr,9137,2,24,4,8,94,44,50,76
Arbroath,9137,3,17,8,11,72,51,21,59
Alloa,9137,4,17,8,11,56,48,8,59
Stranraer,9137,5,15,6,15,55,64,-9,51
East Fife,9137,6,13,4,19,47,64,-17,43
Airdrieon,9137,7,10,11,15,45,60,-15,41
Forfar,9137,8,11,5,20,40,64,-24,38
Queen's Park,9137,9,7,10,19,42,74,-32,31
Albion,9137,10,8,6,22,59,82,-23,30
Ayr,9138,1,24,4,8,97,42,55,76
Raith,9138,2,22,8,6,68,33,35,74
Arbroath,9138,3,18,8,10,74,49,25,62
Alloa,9138,4,18,8,10,57,43,14,62
Stranraer,9138,5,15,5,16,56,66,-10,50
East Fife,9138,6,14,3,19,49,65,-16,45
Airdrieon,9138,7,10,11,15,46,61,-15,41
Forfar,9138,8,11,5,20,41,65,-24,38
Albion,9138,9,8,6,22,57,85,-28,30
Queen's Park,9138,10,6,10,20,40,76,-36,28
Ayr,9139,1,24,4,8,95,43,52,76
Raith,9139,2,22,8,6,70,36,34,74
Arbroath,9139,3,18,8,10,74,50,24,62
Alloa,9139,4,18,8,10,60,45,15,62
Stranraer,9139,5,16,5,15,57,65,-8,53
East Fife,9139,6,13,3,20,48,66,-18,42
Airdrieon,9139,7,10,11,15,46,60,-14,41
Forfar,9139,8,11,5,20,40,65,-25,38
Albion,9139,9,8,6,22,58,83,-25,30
Queen's Park,9139,10,6,10,20,41,76,-35,28
Ayr,9140,1,24,4,8,92,43,49,76
Raith,9140,2,22,8,6,68,33,35,74
Arbroath,9140,3,18,8,10,71,48,23,62
Alloa,9140,4,18,8,10,57,43,14,62
Stranraer,9140,5,16,5,15,58,64,-6,53
Airdrieon,9140,6,10,12,14,46,59,-13,42
East Fife,9140,7,13,3,20,47,67,-20,42
Forfar,9140,8,10,6,20,39,65,-26,36
Albion,9140,9,8,6,22,58,80,-22,30
Queen's Park,9140,10,6,10,20,39,73,-34,28
Ayr,9141,1,24,4,8,96,44,52,76
Raith,9141,2,22,9,5,69,33,36,75
Arbroath,9141,3,18,8,10,73,48,25,62
Alloa,9141,4,17,9,10,57,44,13,60
Stranraer,9141,5,15,6,15,56,65,-9,51
Airdrieon,9141,6,11,11,14,46,58,-12,44
East Fife,9141,7,13,4,19,48,65,-17,43
Forfar,9141,8,10,5,21,38,65,-27,35
Albion,9141,9,8,6,22,59,84,-25,30
Queen's Park,9141,10,6,10,20,39,75,-36,28
Ayr,9142,1,24,4,8,94,43,51,76
Raith,9142,2,22,9,5,69,33,36,75
Arbroath,9142,3,18,8,10,72,48,24,62
Alloa,9142,4,17,9,10,57,44,13,60
Stranraer,9142,5,16,5,15,61,65,-4,53
Airdrieon,9142,6,11,11,14,47,59,-12,44
East Fife,9142,7,13,3,20,48,70,-22,42
Forfar,9142,8,10,5,21,39,66,-27,35
Albion,9142,9,8,6,22,58,82,-24,30
Queen's Park,9142,10,6,10,20,39,74,-35,28
Raith,9143,1,23,8,5,70,32,38,77
Ayr,9143,2,24,4,8,92,42,50,76
Arbroath,9143,3,18,8,10,76,49,27,62
Alloa,9143,4,17,8,11,56,45,11,59
Stranraer,9143,5,15,5,16,55,65,-10,50
East Fife,9143,6,14,3,19,48,64,-16,45
Airdrieon,9143,7,11,11,14,47,59,-12,44
Forfar,9143,8,10,5,21,39,66,-27,35
Albion,9143,9,8,6,22,57,80,-23,30
Queen's Park,9143,10,6,10,20,40,78,-38,28
Raith,9144,1,22,8,6,69,34,35,74
Ayr,9144,2,23,4,9,93,48,45,73
Alloa,9144,3,18,8,10,58,44,14,62
Arbroath,9144,4,17,8,11,73,52,21,59
Stranraer,9144,5,15,5,16,56,68,-12,50
East Fife,9144,6,14,3,19,51,65,-14,45
Airdrieon,9144,7,11,11,14,48,60,-12,44
Forfar,9144,8,10,5,21,40,67,-27,35
Albion,9144,9,9,6,21,63,81,-18,33
Queen's Park,9144,10,7,10,19,43,75,-32,31
Raith,9145,1,22,9,5,69,33,36,75
Ayr,9145,2,23,5,8,91,43,48,74
Arbroath,9145,3,18,8,10,73,49,24,62
Alloa,9145,4,17,9,10,57,44,13,60
Stranraer,9145,5,15,5,16,55,65,-10,50
East Fife,9145,6,14,3,19,48,64,-16,45
Airdrieon,9145,7,10,11,15,45,60,-15,41
Forfar,9145,8,11,5,20,40,64,-24,38
Albion,9145,9,8,7,21,58,79,-21,31
Queen's Park,9145,10,6,10,20,40,75,-35,28
Raith,9146,1,23,8,5,70,33,37,77
Ayr,9146,2,24,4,8,93,43,50,76
Arbroath,9146,3,17,9,10,71,49,22,60
Alloa,9146,4,17,8,11,57,45,12,59
Stranraer,9146,5,16,5,15,56,64,-8,53
East Fife,9146,6,13,3,20,47,65,-18,42
Airdrieon,9146,7,10,11,15,46,60,-14,41
Forfar,9146,8,11,5,20,40,65,-25,38
Albion,9146,9,8,6,22,58,81,-23,30
Queen's Park,9146,10,6,11,19,40,73,-33,29
Ayr,9147,1,24,4,8,92,43,49,76
Raith,9147,2,22,8,6,69,34,35,74
Arbroath,9147,3,18,8,10,73,49,24,62
Alloa,9147,4,18,8,10,58,44,14,62
Stranraer,9147,5,16,5,15,56,64,-8,53
Airdrieon,9147,6,10,12,14,48,61,-13,42
East Fife,9147,7,13,3,20,47,65,-18,42
Forfar,9147,8,10,6,20,41,67,-26,36
Albion,9147,9,8,6,22,58,80,-22,30
Queen's Park,9147,10,6,10,20,40,75,-35,28
Raith,9148,1,23,8,5,70,32,38,77
Ayr,9148,2,23,5,8,92,44,48,74
Arbroath,9148,3,18,8,10,72,48,24,62
Alloa,9148,4,17,8,11,56,45,11,59
Stranraer,9148,5,15,6,15,56,65,-9,51
Airdrieon,9148,6,11,11,14,48,58,-10,44
East Fife,9148,7,13,4,19,48,65,-17,43
Forfar,9148,8,10,5,21,38,67,-29,35
Albion,9148,9,8,7,21,59,80,-21,31
Queen's Park,9148,10,6,10,20,39,74,-35,28
Raith,9149,1,23,8,5,69,32,37,77
Ayr,9149,2,24,4,8,93,43,50,76
Arbroath,9149,3,17,8,11,71,50,21,59
Alloa,9149,4,17,8,11,56,44,12,59
Stranraer,9149,5,15,6,15,56,65,-9,51
East Fife,9149,6,13,4,19,48,65,-17,43
Airdrieon,9149,7,10,11,15,45,59,-14,41
Forfar,9149,8,11,5,20,39,64,-25,38
Queen's Park,9149,9,7,10,19,41,73,-32,31
Albion,9149,10,8,6,22,58,81,-23,30
Raith,9150,1,23,8,5,69,32,37,77
Ayr,9150,2,23,4,9,92,45,47,73
Arbroath,9150,3,18,8,10,72,48,24,62
Alloa,9150,4,17,8,11,56,44,12,59
Stranraer,9150,5,16,5,15,58,65,-7,53
Airdrieon,9150,6,11,11,14,48,58,-10,44
East Fife,9150,7,13,3,20,48,67,-19,42
Forfar,9150,8,10,5,21,38,67,-29,35
Albion,9150,9,9,6,21,60,80,-20,33
Queen's Park,9150,10,6,10,20,39,74,-35,28
Raith,9151,1,23,8,5,70,33,37,77
Ayr,9151,2,24,4,8,96,44,52,76
Arbroath,9151,3,17,9,10,72,50,22,60
Alloa,9151,4,17,8,11,57,45,12,59
Stranraer,9151,5,15,5,16,56,67,-11,50
East Fife,9151,6,14,3,19,50,65,-15,45
Airdrieon,9151,7,10,12,14,45,58,-13,42
Forfar,9151,8,10,6,20,38,64,-26,36
Albion,9151,9,8,6,22,59,84,-25,30
Queen's Park,9151,10,6,11,19,41,74,-33,29
Ayr,9152,1,24,4,8,96,42,54,76
Raith,9152,2,22,8,6,69,34,35,74
Alloa,9152,3,18,8,10,58,44,14,62
Arbroath,9152,4,17,9,10,72,50,22,60
Stranraer,9152,5,15,6,15,56,65,-9,51
East Fife,9152,6,13,4,19,48,65,-17,43
Airdrieon,9152,7,10,11,15,46,62,-16,41
Forfar,9152,8,11,5,20,42,65,-23,38
Albion,9152,9,8,6,22,57,84,-27,30
Queen's Park,9152,10,6,11,19,41,74,-33,29
Raith,9153,1,23,8,5,70,32,38,77
Ayr,9153,2,23,5,8,93,45,48,74
Arbroath,9153,3,18,8,10,73,50,23,62
Alloa,9153,4,17,8,11,56,45,11,59
Stranraer,9153,5,15,5,16,56,66,-10,50
East Fife,9153,6,14,3,19,49,65,-16,45
Airdrieon,9153,7,10,11,15,46,61,-15,41
Forfar,9153,8,11,5,20,41,65,-24,38
Albion,9153,9,8,7,21,60,81,-21,31
Queen's Park,9153,10,6,10,20,41,75,-34,28
Ayr,9154,1,24,4,8,93,44,49,76
Raith,9154,2,22,8,6,68,33,35,74
Arbroath,9154,3,18,8,10,72,49,23,62
Alloa,9154,4,18,8,10,57,43,14,62
Stranraer,9154,5,16,5,15,58,65,-7,53
Airdrieon,9154,6,11,11,14,48,59,-11,44
East Fife,9154,7,13,3,20,48,67,-19,42
Forfar,9154,8,10,5,21,39,67,-28,35
Albion,9154,9,8,6,22,59,81,-22,30
Queen's Park,9154,10,6,10,20,40,74,-34,28
Raith,9155,1,23,8,5,71,32,39,77
Ayr,9155,2,24,4,8,93,43,50,76
Arbroath,9155,3,17,8,11,70,49,21,59
Alloa,9155,4,17,8,11,56,46,10,59
Stranraer,9155,5,15,6,15,56,65,-9,51
Airdrieon,9155,6,11,11,14,48,59,-11,44
East Fife,9155,7,13,4,19,48,65,-17,43
Forfar,9155,8,10,5,21,39,67,-28,35
Queen's Park,9155,9,7,10,19,40,72,-32,31
Albion,9155,10,8,6,22,58,81,-23,30
Raith,9156,1,23,8,5,75,32,43,77
Ayr,9156,2,23,5,8,92,44,48,74
Arbroath,9156,3,17,9,10,70,48,22,60
Alloa,9156,4,17,8,11,56,50,6,59
Stranraer,9156,5,16,5,15,59,65,-6,53
Airdrieon,9156,6,11,11,14,46,58,-12,44
East Fife,9156,7,13,3,20,48,68,-20,42
Forfar,9156,8,10,5,21,38,65,-27,35
Albion,9156,9,8,7,21,59,80,-21,31
Queen's Park,9156,10,6,11,19,39,72,-33,29
Ayr,9157,1,24,4,8,96,42,54,76
Raith,9157,2,22,8,6,69,35,34,74
Alloa,9157,3,18,8,10,59,44,15,62
Arbroath,9157,4,17,9,10,70,48,22,60
Stranraer,9157,5,16,5,15,58,66,-8,53
East Fife,9157,6,13,3,20,49,67,-18,42
Airdrieon,9157,7,10,11,15,46,60,-14,41
Forfar,9157,8,11,5,20,40,65,-25,38
Albion,9157,9,8,6,22,57,84,-27,30
Queen's Park,9157,10,6,11,19,39,72,-33,29
Raith,9158,1,23,8,5,71,32,39,77
Ayr,9158,2,24,4,8,93,43,50,76
Arbroath,9158,3,17,8,11,70,49,21,59
Alloa,9158,4,17,8,11,56,46,10,59
Stranraer,9158,5,16,5,15,59,66,-7,53
Airdrieon,9158,6,11,11,14,47,59,-12,44
East Fife,9158,7,13,3,20,49,68,-19,42
Forfar,9158,8,10,5,21,39,66,-27,35
Queen's Park,9158,9,7,10,19,40,72,-32,31
Albion,9158,10,8,6,22,58,81,-23,30
Ayr,9159,1,24,4,8,93,44,49,76
Raith,9159,2,22,8,6,69,34,35,74
Alloa,9159,3,18,8,10,58,44,14,62
Arbroath,9159,4,17,8,11,70,49,21,59
Stranraer,9159,5,16,5,15,60,65,-5,53
Airdrieon,9159,6,11,11,14,48,58,-10,44
East Fife,9159,7,13,3,20,48,69,-21,42
Forfar,9159,8,10,5,21,38,67,-29,35
Queen's Park,9159,9,7,10,19,40,72,-32,31
Albion,9159,10,8,6,22,59,81,-22,30
Raith,9160,1,23,8,5,71,32,39,77
Ayr,9160,2,23,5,8,91,43,48,74
Arbroath,9160,3,18,8,10,71,48,23,62
Alloa,9160,4,17,8,11,56,46,10,59
Stranraer,9160,5,15,6,15,56,65,-9,51
Airdrieon,9160,6,11,11,14,48,58,-10,44
East Fife,9160,7,13,4,19,48,65,-17,43
Forfar,9160,8,10,5,21,38,67,-29,35
Albion,9160,9,8,7,21,58,79,-21,31
Queen's Park,9160,10,6,10,20,39,73,-34,28
Ayr,9161,1,24,4,8,94,45,49,76
Raith,9161,2,22,8,6,68,33,35,74
Alloa,9161,3,18,8,10,57,43,14,62
Arbroath,9161,4,17,8,11,71,50,21,59
Stranraer,9161,5,16,5,15,57,65,-8,53
East Fife,9161,6,13,3,20,48,66,-18,42
Airdrieon,9161,7,10,11,15,45,61,-16,41
Forfar,9161,8,11,5,20,41,64,-23,38
Queen's Park,9161,9,7,10,19,41,73,-32,31
Albion,9161,10,8,6,22,60,82,-22,30
Ayr,9162,1,24,4,8,94,42,52,76
Raith,9162,2,22,8,6,68,33,35,74
Arbroath,9162,3,18,8,10,72,48,24,62
Alloa,9162,4,18,8,10,57,43,14,62
Stranraer,9162,5,15,6,15,56,65,-9,51
Airdrieon,9162,6,11,11,14,47,58,-11,44
East Fife,9162,7,13,4,19,48,65,-17,43
Forfar,9162,8,10,5,21,38,66,-28,35
Albion,9162,9,8,6,22,57,82,-25,30
Queen's Park,9162,10,6,10,20,39,74,-35,28
Ayr,9163,1,24,4,8,93,43,50,76
Raith,9163,2,22,9,5,68,32,36,75
Arbroath,9163,3,18,8,10,71,48,23,62
Alloa,9163,4,17,9,10,56,43,13,60
Stranraer,9163,5,15,5,16,56,68,-12,50
East Fife,9163,6,14,3,19,51,65,-14,45
Airdrieon,9163,7,11,11,14,48,59,-11,44
Forfar,9163,8,10,5,21,39,67,-28,35
Albion,9163,9,8,6,22,58,81,-23,30
Queen's Park,9163,10,6,10,20,39,73,-34,28
Ayr,9164,1,24,4,8,94,43,51,76
Raith,9164,2,22,9,5,68,32,36,75
Arbroath,9164,3,18,8,10,73,49,24,62
Alloa,9164,4,17,9,10,56,43,13,60
Stranraer,9164,5,15,5,16,56,66,-10,50
East Fife,9164,6,14,3,19,49,65,-16,45
Airdrieon,9164,7,11,11,14,46,58,-12,44
Forfar,9164,8,10,5,21,38,65,-27,35
Albion,9164,9,8,6,22,58,82,-24,30
Queen's Park,9164,10,6,10,20,40,75,-35,28
Raith,9165,1,23,8,5,69,32,37,77
Ayr,9165,2,24,4,8,97,42,55,76
Arbroath,9165,3,17,9,10,71,49,22,60
Alloa,9165,4,17,8,11,56,44,12,59
Stranraer,9165,5,15,6,15,58,67,-9,51
Airdrieon,9165,6,11,11,14,47,59,-12,44
East Fife,9165,7,13,4,19,50,67,-17,43
Forfar,9165,8,10,5,21,39,66,-27,35
Albion,9165,9,8,6,22,57,85,-28,30
Queen's Park,9165,10,6,11,19,40,73,-33,29
Ayr,9166,1,24,4,8,95,44,51,76
Raith,9166,2,22,9,5,69,33,36,75
Arbroath,9166,3,18,8,10,74,49,25,62
Alloa,9166,4,17,9,10,57,44,13,60
Stranraer,9166,5,16,5,15,59,67,-8,53
Airdrieon,9166,6,11,11,14,46,58,-12,44
East Fife,9166,7,13,3,20,50,68,-18,42
Forfar,9166,8,10,5,21,38,65,-27,35
Albion,9166,9,8,6,22,59,83,-24,30
Queen's Park,9166,10,6,10,20,40,76,-36,28
Ayr,9167,1,24,4,8,92,42,50,76
Raith,9167,2,22,9,5,70,34,36,75
Arbroath,9167,3,18,8,10,73,50,23,62
Alloa,9167,4,17,9,10,58,45,13,60
Stranraer,9167,5,15,6,15,56,65,-9,51
Airdrieon,9167,6,11,11,14,46,58,-12,44
East Fife,9167,7,13,4,19,48,65,-17,43
Forfar,9167,8,10,5,21,38,65,-27,35
Albion,9167,9,8,6,22,57,80,-23,30
Queen's Park,9167,10,6,10,20,41,75,-34,28
Ayr,9168,1,24,4,8,92,42,50,76
Raith,9168,2,22,9,5,69,33,36,75
Arbroath,9168,3,18,8,10,75,49,26,62
Alloa,9168,4,17,9,10,57,44,13,60
Stranraer,9168,5,16,5,15,59,65,-6,53
East Fife,9168,6,13,3,20,48,68,-20,42
Airdrieon,9168,7,10,11,15,47,61,-14,41
Forfar,9168,8,11,5,20,41,66,-25,38
Albion,9168,9,8,6,22,57,80,-23,30
Queen's Park,9168,10,6,10,20,40,77,-37,28
Raith,9169,1,23,8,5,69,32,37,77
Ayr,9169,2,24,4,8,92,42,50,76
Arbroath,9169,3,18,8,10,74,49,25,62
Alloa,9169,4,17,8,11,56,44,12,59
Stranraer,9169,5,16,5,15,58,64,-6,53
Airdrieon,9169,6,10,12,14,48,61,-13,42
East Fife,9169,7,13,3,20,47,67,-20,42
Forfar,9169,8,10,6,20,41,67,-26,36
Albion,9169,9,8,6,22,57,80,-23,30
Queen's Park,9169,10,6,10,20,40,76,-36,28
Raith,9170,1,22,9,5,68,32,36,75
Ayr,9170,2,23,4,9,92,45,47,73
Arbroath,9170,3,18,8,10,71,48,23,62
Alloa,9170,4,17,9,10,56,43,13,60
Stranraer,9170,5,15,5,16,55,67,-12,50
East Fife,9170,6,14,3,19,50,64,-14,45
Airdrieon,9170,7,10,12,14,45,58,-13,42
Forfar,9170,8,10,6,20,38,64,-26,36
Albion,9170,9,9,6,21,60,80,-20,33
Queen's Park,9170,10,6,10,20,39,73,-34,28
Raith,9171,1,23,8,5,71,33,38,77
Ayr,9171,2,24,4,8,93,43,50,76
Arbroath,9171,3,17,9,10,72,50,22,60
Alloa,9171,4,17,8,11,57,46,11,59
Stranraer,9171,5,15,6,15,55,64,-9,51
Airdrieon,9171,6,11,11,14,48,58,-10,44
East Fife,9171,7,13,4,19,47,64,-17,43
Forfar,9171,8,10,5,21,38,67,-29,35
Albion,9171,9,8,6,22,58,81,-23,30
Queen's Park,9171,10,6,11,19,41,74,-33,29
Raith,9172,1,22,9,5,68,32,36,75
Ayr,9172,2,23,4,9,94,47,47,73
Arbroath,9172,3,17,9,10,72,50,22,60
Alloa,9172,4,17,9,10,56,43,13,60
Stranraer,9172,5,15,6,15,57,66,-9,51
East Fife,9172,6,13,4,19,49,66,-17,43
Airdrieon,9172,7,10,12,14,45,58,-13,42
Forfar,9172,8,10,6,20,38,64,-26,36
Albion,9172,9,9,6,21,62,82,-20,33
Queen's Park,9172,10,6,11,19,41,74,-33,29
Raith,9173,1,23,8,5,70,33,37,77
Ayr,9173,2,24,4,8,94,42,52,76
Arbroath,9173,3,18,8,10,73,48,25,62
Alloa,9173,4,17,8,11,57,45,12,59
Stranraer,9173,5,15,5,16,56,66,-10,50
East Fife,9173,6,14,3,19,49,65,-16,45
Airdrieon,9173,7,10,12,14,46,59,-13,42
Forfar,9173,8,10,6,20,39,65,-26,36
Albion,9173,9,8,6,22,57,82,-25,30
Queen's Park,9173,10,6,10,20,39,75,-36,28
Ayr,9174,1,23,5,8,91,43,48,74
Raith,9174,2,22,8,6,68,33,35,74
Arbroath,9174,3,18,8,10,73,50,23,62
Alloa,9174,4,18,8,10,57,43,14,62
Stranraer,9174,5,15,6,15,56,65,-9,51
East Fife,9174,6,13,4,19,48,65,-17,43
Airdrieon,9174,7,10,11,15,45,61,-16,41
Forfar,9174,8,11,5,20,41,64,-23,38
Albion,9174,9,8,7,21,58,79,-21,31
Queen's Park,9174,10,6,10,20,41,75,-34,28
Raith,9175,1,23,8,5,71,34,37,77
Ayr,9175,2,24,4,8,94,44,50,76
Arbroath,9175,3,17,9,10,73,51,22,60
Alloa,9175,4,17,8,11,58,46,12,59
Stranraer,9175,5,15,5,16,57,68,-11,50
East Fife,9175,6,14,3,19,51,66,-15,45
Airdrieon,9175,7,10,12,14,45,58,-13,42
Forfar,9175,8,10,6,20,38,64,-26,36
Albion,9175,9,8,6,22,59,82,-23,30
Queen's Park,9175,10,6,11,19,42,75,-33,29
Ayr,9176,1,24,4,8,94,43,51,76
Raith,9176,2,22,9,5,69,33,36,75
Alloa,9176,3,17,9,10,57,44,13,60
Arbroath,9176,4,17,8,11,72,51,21,59
Stranraer,9176,5,16,5,15,57,65,-8,53
East Fife,9176,6,13,3,20,48,66,-18,42
Airdrieon,9176,7,10,11,15,45,59,-14,41
Forfar,9176,8,11,5,20,39,64,-25,38
Queen's Park,9176,9,7,10,19,42,74,-32,31
Albion,9176,10,8,6,22,58,82,-24,30
Raith,9177,1,23,8,5,71,34,37,77
Ayr,9177,2,24,4,8,93,44,49,76
Arbroath,9177,3,18,8,10,77,49,28,62
Alloa,9177,4,17,8,11,58,46,12,59
Stranraer,9177,5,15,6,15,56,65,-9,51
Airdrieon,9177,6,11,11,14,48,60,-12,44
East Fife,9177,7,13,4,19,48,65,-17,43
Forfar,9177,8,10,5,21,40,67,-27,35
Albion,9177,9,8,6,22,59,81,-22,30
Queen's Park,9177,10,6,10,20,40,79,-39,28
Raith,9178,1,22,9,5,69,33,36,75
Ayr,9178,2,23,5,8,91,43,48,74
Arbroath,9178,3,18,8,10,74,48,26,62
Alloa,9178,4,17,9,10,57,44,13,60
Stranraer,9178,5,16,5,15,58,65,-7,53
Airdrieon,9178,6,11,11,14,47,58,-11,44
East Fife,9178,7,13,3,20,48,67,-19,42
Forfar,9178,8,10,5,21,38,66,-28,35
Albion,9178,9,8,7,21,58,79,-21,31
Queen's Park,9178,10,6,10,20,39,76,-37,28
Ayr,9179,1,24,4,8,95,43,52,76
Raith,9179,2,22,9,5,69,33,36,75
Arbroath,9179,3,18,8,10,74,48,26,62
Alloa,9179,4,17,9,10,57,44,13,60
Stranraer,9179,5,16,5,15,58,64,-6,53
Airdrieon,9179,6,10,12,14,46,59,-13,42
East Fife,9179,7,13,3,20,47,67,-20,42
Forfar,9179,8,10,6,20,39,65,-26,36
Albion,9179,9,8,6,22,58,83,-25,30
Queen's Park,9179,10,6,10,20,39,76,-37,28
Raith,9180,1,22,8,6,68,33,35,74
Ayr,9180,2,23,4,9,90,44,46,73
Alloa,9180,3,18,8,10,57,43,14,62
Arbroath,9180,4,17,8,11,71,53,18,59
Stranraer,9180,5,15,5,16,56,66,-10,50
East Fife,9180,6,14,3,19,49,65,-16,45
Airdrieon,9180,7,11,11,14,49,59,-10,44
Forfar,9180,8,10,5,21,39,68,-29,35
Albion,9180,9,9,6,21,59,78,-19,33
Queen's Park,9180,10,7,10,19,44,73,-29,31
Ayr,9181,1,24,4,8,93,44,49,76
Raith,9181,2,22,9,5,69,33,36,75
Alloa,9181,3,17,9,10,57,44,13,60
Arbroath,9181,4,17,8,11,72,51,21,59
Stranraer,9181,5,15,5,16,55,65,-10,50
East Fife,9181,6,14,3,19,48,64,-16,45
Airdrieon,9181,7,11,11,14,46,58,-12,44
Forfar,9181,8,10,5,21,38,65,-27,35
Queen's Park,9181,9,7,10,19,42,74,-32,31
Albion,9181,10,8,6,22,59,81,-22,30
Raith,9182,1,23,8,5,71,33,38,77
Ayr,9182,2,24,4,8,94,42,52,76
Arbroath,9182,3,18,8,10,73,50,23,62
Alloa,9182,4,17,8,11,57,46,11,59
Stranraer,9182,5,15,5,16,56,66,-10,50
East Fife,9182,6,14,3,19,49,65,-16,45
Airdrieon,9182,7,11,11,14,47,58,-11,44
Forfar,9182,8,10,5,21,38,66,-28,35
Albion,9182,9,8,6,22,57,82,-25,30
Queen's Park,9182,10,6,10,20,41,75,-34,28
Raith,9183,1,23,8,5,72,35,37,77
Ayr,9183,2,24,4,8,92,42,50,76
Arbroath,9183,3,18,8,10,73,49,24,62
Alloa,9183,4,17,8,11,59,47,12,59
Stranraer,9183,5,15,5,16,57,68,-11,50
East Fife,9183,6,14,3,19,51,66,-15,45
Airdrieon,9183,7,10,12,14,46,59,-13,42
Forfar,9183,8,10,6,20,39,65,-26,36
Albion,9183,9,8,6,22,57,80,-23,30
Queen's Park,9183,10,6,10,20,40,75,-35,28
Raith,9184,1,23,8,5,70,33,37,77
Ayr,9184,2,24,4,8,94,43,51,76
Arbroath,9184,3,18,8,10,72,48,24,62
Alloa,9184,4,17,8,11,57,45,12,59
Stranraer,9184,5,15,5,16,56,67,-11,50
East Fife,9184,6,14,3,19,50,65,-15,45
Airdrieon,9184,7,11,11,14,47,59,-12,44
Forfar,9184,8,10,5,21,39,66,-27,35
Albion,9184,9,8,6,22,58,82,-24,30
Queen's Park,9184,10,6,10,20,39,74,-35,28
Ayr,9185,1,24,4,8,93,44,49,76
Raith,9185,2,22,9,5,69,33,36,75
Arbroath,9185,3,17,9,10,71,49,22,60
Alloa,9185,4,17,9,10,57,44,13,60
Stranraer,9185,5,15,5,16,55,65,-10,50
East Fife,9185,6,14,3,19,48,64,-16,45
Airdrieon,9185,7,10,12,14,46,59,-13,42
Forfar,9185,8,10,6,20,39,65,-26,36
Albion,9185,9,8,6,22,59,81,-22,30
Queen's Park,9185,10,6,11,19,40,73,-33,29
Ayr,9186,1,24,4,8,92,43,49,76
Raith,9186,2,22,8,6,68,33,35,74
Arbroath,9186,3,18,8,10,75,50,25,62
Alloa,9186,4,18,8,10,57,43,14,62
Stranraer,9186,5,15,6,15,58,67,-9,51
East Fife,9186,6,13,4,19,50,67,-17,43
Airdrieon,9186,7,10,12,14,46,59,-13,42
Forfar,9186,8,10,6,20,39,65,-26,36
Albion,9186,9,8,6,22,58,80,-22,30
Queen's Park,9186,10,6,10,20,41,77,-36,28
Raith,9187,1,23,8,5,70,33,37,77
Ayr,9187,2,24,4,8,94,42,52,76
Arbroath,9187,3,17,8,11,70,49,21,59
Alloa,9187,4,17,8,11,57,45,12,59
Stranraer,9187,5,15,5,16,56,66,-10,50
East Fife,9187,6,14,3,19,49,65,-16,45
Airdrieon,9187,7,11,11,14,47,58,-11,44
Forfar,9187,8,10,5,21,38,66,-28,35
Queen's Park,9187,9,7,10,19,40,72,-32,31
Albion,9187,10,8,6,22,57,82,-25,30
Ayr,9188,1,24,4,8,95,44,51,76
Raith,9188,2,22,8,6,69,34,35,74
Alloa,9188,3,18,8,10,58,44,14,62
Arbroath,9188,4,17,9,10,71,49,22,60
Stranraer,9188,5,16,5,15,58,65,-7,53
Airdrieon,9188,6,10,12,14,46,59,-13,42
East Fife,9188,7,13,3,20,48,67,-19,42
Forfar,9188,8,10,6,20,39,65,-26,36
Albion,9188,9,8,6,22,59,83,-24,30
Queen's Park,9188,10,6,11,19,40,73,-33,29
Raith,9189,1,23,8,5,69,32,37,77
Ayr,9189,2,24,4,8,94,43,51,76
Arbroath,9189,3,18,8,10,71,48,23,62
Alloa,9189,4,17,8,11,56,44,12,59
Stranraer,9189,5,16,5,15,57,64,-7,53
Airdrieon,9189,6,10,12,14,45,58,-13,42
East Fife,9189,7,13,3,20,47,66,-19,42
Forfar,9189,8,10,6,20,38,64,-26,36
Albion,9189,9,8,6,22,58,82,-24,30
Queen's Park,9189,10,6,10,20,39,73,-34,28
Ayr,9190,1,24,4,8,97,43,54,76
Raith,9190,2,22,8,6,68,33,35,74
Arbroath,9190,3,18,8,10,73,50,23,62
Alloa,9190,4,18,8,10,57,43,14,62
Stranraer,9190,5,16,5,15,58,64,-6,53
Airdrieon,9190,6,11,11,14,47,58,-11,44
East Fife,9190,7,13,3,20,47,67,-20,42
Forfar,9190,8,10,5,21,38,66,-28,35
Albion,9190,9,8,6,22,58,85,-27,30
Queen's Park,9190,10,6,10,20,41,75,-34,28
Raith,9191,1,23,8,5,69,32,37,77
Ayr,9191,2,24,4,8,93,43,50,76
Arbroath,9191,3,18,8,10,71,48,23,62
Alloa,9191,4,17,8,11,56,44,12,59
Stranraer,9191,5,15,5,16,56,66,-10,50
East Fife,9191,6,14,3,19,49,65,-16,45
Airdrieon,9191,7,11,11,14,47,59,-12,44
Forfar,9191,8,10,5,21,39,66,-27,35
Albion,9191,9,8,6,22,58,81,-23,30
Queen's Park,9191,10,6,10,20,39,73,-34,28
Raith,9192,1,23,8,5,71,34,37,77
Ayr,9192,2,24,4,8,94,44,50,76
Arbroath,9192,3,17,9,10,71,49,22,60
Alloa,9192,4,17,8,11,58,46,12,59
Stranraer,9192,5,16,5,15,59,67,-8,53
East Fife,9192,6,13,3,20,50,68,-18,42
Airdrieon,9192,7,10,11,15,46,60,-14,41
Forfar,9192,8,11,5,20,40,65,-25,38
Albion,9192,9,8,6,22,59,82,-23,30
Queen's Park,9192,10,6,11,19,40,73,-33,29
Raith,9193,1,23,8,5,71,33,38,77
Ayr,9193,2,23,5,8,92,44,48,74
Arbroath,9193,3,17,8,11,70,49,21,59
Alloa,9193,4,17,8,11,57,46,11,59
Stranraer,9193,5,16,5,15,56,64,-8,53
Airdrieon,9193,6,10,12,14,48,61,-13,42
East Fife,9193,7,13,3,20,47,65,-18,42
Forfar,9193,8,10,6,20,41,67,-26,36
Albion,9193,9,8,7,21,59,80,-21,31
Queen's Park,9193,10,7,10,19,40,72,-32,31
Raith,9194,1,22,9,5,70,34,36,75
Ayr,9194,2,23,4,9,90,43,47,73
Alloa,9194,3,17,9,10,58,45,13,60
Arbroath,9194,4,17,8,11,73,52,21,59
Stranraer,9194,5,15,5,16,55,67,-12,50
East Fife,9194,6,14,3,19,50,64,-14,45
Airdrieon,9194,7,11,11,14,49,59,-10,44
Forfar,9194,8,10,5,21,39,68,-29,35
Albion,9194,9,9,6,21,58,78,-20,33
Queen's Park,9194,10,7,10,19,43,75,-32,31
Ayr,9195,1,24,4,8,96,44,52,76
Raith,9195,2,22,9,5,70,34,36,75
Alloa,9195,3,17,9,10,58,45,13,60
Arbroath,9195,4,17,8,11,71,52,19,59
Stranraer,9195,5,15,5,16,56,67,-11,50
East Fife,9195,6,14,3,19,50,65,-15,45
Airdrieon,9195,7,11,11,14,46,58,-12,44
Forfar,9195,8,10,5,21,38,65,-27,35
Queen's Park,9195,9,7,10,19,43,73,-30,31
Albion,9195,10,8,6,22,59,84,-25,30
Raith,9196,1,23,8,5,71,33,38,77
Ayr,9196,2,24,4,8,92,43,49,76
Arbroath,9196,3,17,8,11,71,51,20,59
Alloa,9196,4,17,8,11,57,46,11,59
Stranraer,9196,5,16,5,15,56,64,-8,53
Airdrieon,9196,6,11,11,14,48,58,-10,44
East Fife,9196,7,13,3,20,47,65,-18,42
Forfar,9196,8,10,5,21,38,67,-29,35
Queen's Park,9196,9,7,10,19,42,73,-31,31
Albion,9196,10,8,6,22,58,80,-22,30
Raith,9197,1,23,8,5,69,32,37,77
Ayr,9197,2,24,4,8,94,45,49,76
Arbroath,9197,3,18,8,10,72,48,24,62
Alloa,9197,4,17,8,11,56,44,12,59
Stranraer,9197,5,15,5,16,55,68,-13,50
East Fife,9197,6,14,3,19,51,64,-13,45
Airdrieon,9197,7,10,12,14,45,58,-13,42
Forfar,9197,8,10,6,20,38,64,-26,36
Albion,9197,9,8,6,22,60,82,-22,30
Queen's Park,9197,10,6,10,20,39,74,-35,28
Raith,9198,1,22,9,5,69,33,36,75
Ayr,9198,2,23,5,8,93,45,48,74
Alloa,9198,3,17,9,10,57,44,13,60
Arbroath,9198,4,17,8,11,71,50,21,59
Stranraer,9198,5,15,6,15,57,66,-9,51
Airdrieon,9198,6,11,11,14,47,58,-11,44
East Fife,9198,7,13,4,19,49,66,-17,43
Forfar,9198,8,10,5,21,38,66,-28,35
Albion,9198,9,8,7,21,60,81,-21,31
Queen's Park,9198,10,7,10,19,41,73,-32,31
Ayr,9199,1,24,4,8,94,43,51,76
Raith,9199,2,22,9,5,70,34,36,75
Arbroath,9199,3,18,8,10,72,48,24,62
Alloa,9199,4,17,9,10,58,45,13,60
Stranraer,9199,5,15,5,16,55,67,-12,50
East Fife,9199,6,14,3,19,50,64,-14,45
Airdrieon,9199,7,11,11,14,48,58,-10,44
Forfar,9199,8,10,5,21,38,67,-29,35
Albion,9199,9,8,6,22,58,82,-24,30
Queen's Park,9199,10,6,10,20,39,74,-35,28
Raith,9200,1,23,8,5,69,32,37,77
Ayr,9200,2,23,5,8,93,45,48,74
Arbroath,9200,3,17,8,11,71,50,21,59
Alloa,9200,4,17,8,11,56,44,12,59
Stranraer,9200,5,15,5,16,56,66,-10,50
East Fife,9200,6,14,3,19,49,65,-16,45
Airdrieon,9200,7,10,12,14,47,60,-13,42
Forfar,9200,8,10,6,20,40,66,-26,36
Albion,9200,9,8,7,21,60,81,-21,31
Queen's Park,9200,10,7,10,19,41,73,-32,31
Ayr,9201,1,24,4,8,97,42,55,76
Raith,9201,2,22,8,6,69,35,34,74
Arbroath,9201,3,18,8,10,72,48,24,62
Alloa,9201,4,18,8,10,59,44,15,62
Stranraer,9201,5,15,5,16,57,68,-11,50
East Fife,9201,6,14,3,19,51,66,-15,45
Airdrieon,9201,7,10,12,14,46,59,-13,42
Forfar,9201,8,10,6,20,39,65,-26,36
Albion,9201,9,8,6,22,57,85,-28,30
Queen's Park,9201,10,6,10,20,39,74,-35,28
Raith,9202,1,23,8,5,70,32,38,77
Ayr,9202,2,24,4,8,95,43,52,76
Arbroath,9202,3,18,8,10,72,49,23,62
Alloa,9202,4,17,8,11,56,45,11,59
Stranraer,9202,5,15,6,15,56,65,-9,51
Airdrieon,9202,6,11,11,14,47,58,-11,44
East Fife,9202,7,13,4,19,48,65,-17,43
Forfar,9202,8,10,5,21,38,66,-28,35
Albion,9202,9,8,6,22,58,83,-25,30
Queen's Park,9202,10,6,10,20,40,74,-34,28
Raith,9203,1,23,8,5,71,34,37,77
Ayr,9203,2,24,4,8,92,43,49,76
Arbroath,9203,3,18,8,10,73,48,25,62
Alloa,9203,4,17,8,11,58,46,12,59
Stranraer,9203,5,15,6,15,57,66,-9,51
Airdrieon,9203,6,11,11,14,46,58,-12,44
East Fife,9203,7,13,4,19,49,66,-17,43
Forfar,9203,8,10,5,21,38,65,-27,35
Albion,9203,9,8,6,22,58,80,-22,30
Queen's Park,9203,10,6,10,20,39,75,-36,28
Raith,9204,1,23,8,5,70,33,37,77
Ayr,9204,2,24,4,8,93,44,49,76
Arbroath,9204,3,17,9,10,70,48,22,60
Alloa,9204,4,17,8,11,57,45,12,59
Stranraer,9204,5,15,5,16,55,67,-12,50
East Fife,9204,6,14,3,19,50,64,-14,45
Airdrieon,9204,7,11,11,14,47,59,-12,44
Forfar,9204,8,10,5,21,39,66,-27,35
Albion,9204,9,8,6,22,59,81,-22,30
Queen's Park,9204,10,6,11,19,39,72,-33,29
Ayr,9205,1,24,4,8,94,43,51,76
Raith,9205,2,22,9,5,68,32,36,75
Arbroath,9205,3,18,8,10,73,49,24,62
Alloa,9205,4,17,9,10,56,43,13,60
Stranraer,9205,5,16,5,15,57,65,-8,53
East Fife,9205,6,13,3,20,48,66,-18,42
Airdrieon,9205,7,10,11,15,46,60,-14,41
Forfar,9205,8,11,5,20,40,65,-25,38
Albion,9205,9,8,6,22,58,82,-24,30
Queen's Park,9205,10,6,10,20,40,75,-35,28
Raith,9206,1,22,9,5,69,33,36,75
Ayr,9206,2,23,4,9,93,46,47,73
Alloa,9206,3,17,9,10,57,44,13,60
Arbroath,9206,4,17,8,11,70,49,21,59
Stranraer,9206,5,15,6,15,58,67,-9,51
East Fife,9206,6,13,4,19,50,67,-17,43
Airdrieon,9206,7,10,11,15,45,59,-14,41
Forfar,9206,8,11,5,20,39,64,-25,38
Albion,9206,9,9,6,21,61,81,-20,33
Queen's Park,9206,10,7,10,19,40,72,-32,31
Raith,9207,1,23,8,5,70,33,37,77
Ayr,9207,2,24,4,8,95,42,53,76
Arbroath,9207,3,17,8,11,72,53,19,59
Alloa,9207,4,17,8,11,57,45,12,59
Stranraer,9207,5,16,5,15,59,66,-7,53
East Fife,9207,6,13,3,20,49,68,-19,42
Airdrieon,9207,7,10,11,15,47,62,-15,41
Forfar,9207,8,11,5,20,42,66,-24,38
Queen's Park,9207,9,7,10,19,44,74,-30,31
Albion,9207,10,8,6,22,57,83,-26,30
Ayr,9208,1,24,4,8,96,42,54,76
Raith,9208,2,22,8,6,68,33,35,74
Alloa,9208,3,18,8,10,57,43,14,62
Arbroath,9208,4,17,9,10,72,50,22,60
Stranraer,9208,5,15,5,16,55,65,-10,50
East Fife,9208,6,14,3,19,48,64,-16,45
Airdrieon,9208,7,10,11,15,47,61,-14,41
Forfar,9208,8,11,5,20,41,66,-25,38
Albion,9208,9,8,6,22,57,84,-27,30
Queen's Park,9208,10,6,11,19,41,74,-33,29
Raith,9209,1,23,8,5,71,33,38,77
Ayr,9209,2,23,4,9,90,45,45,73
Arbroath,9209,3,17,8,11,71,50,21,59
Alloa,9209,4,17,8,11,57,46,11,59
Stranraer,9209,5,15,6,15,57,66,-9,51
East Fife,9209,6,13,4,19,49,66,-17,43
Airdrieon,9209,7,10,12,14,46,59,-13,42
Forfar,9209,8,10,6,20,39,65,-26,36
Albion,9209,9,9,6,21,60,78,-18,33
Queen's Park,9209,10,7,10,19,41,73,-32,31
Ayr,9210,1,24,4,8,93,42,51,76
Raith,9210,2,22,9,5,70,34,36,75
Arbroath,9210,3,17,9,10,70,48,22,60
Alloa,9210,4,17,9,10,58,45,13,60
Stranraer,9210,5,15,5,16,55,66,-11,50
East Fife,9210,6,14,3,19,49,64,-15,45
Airdrieon,9210,7,10,12,14,46,59,-13,42
Forfar,9210,8,10,6,20,39,65,-26,36
Albion,9210,9,8,6,22,57,81,-24,30
Queen's Park,9210,10,6,11,19,39,72,-33,29
Ayr,9211,1,24,4,8,94,45,49,76
Raith,9211,2,22,8,6,69,34,35,74
Alloa,9211,3,18,8,10,58,44,14,62
Arbroath,9211,4,17,8,11,71,50,21,59
Stranraer,9211,5,16,5,15,59,65,-6,53
East Fife,9211,6,13,3,20,48,68,-20,42
Airdrieon,9211,7,10,11,15,46,62,-16,41
Forfar,9211,8,11,5,20,42,65,-23,38
Queen's Park,9211,9,7,10,19,41,73,-32,31
Albion,9211,10,8,6,22,60,82,-22,30
Raith,9212,1,23,8,5,70,33,37,77
Ayr,9212,2,24,4,8,93,42,51,76
Arbroath,9212,3,17,8,11,72,52,20,59
Alloa,9212,4,17,8,11,57,45,12,59
Stranraer,9212,5,16,5,15,59,66,-7,53
Airdrieon,9212,6,11,11,14,49,59,-10,44
East Fife,9212,7,13,3,20,49,68,-19,42
Forfar,9212,8,10,5,21,39,68,-29,35
Queen's Park,9212,9,7,10,19,43,74,-31,31
Albion,9212,10,8,6,22,57,81,-24,30
Raith,9213,1,23,8,5,69,32,37,77
Ayr,9213,2,24,4,8,93,43,50,76
Arbroath,9213,3,18,8,10,73,49,24,62
Alloa,9213,4,17,8,11,56,44,12,59
Stranraer,9213,5,15,5,16,56,67,-11,50
East Fife,9213,6,14,3,19,50,65,-15,45
Airdrieon,9213,7,11,11,14,48,58,-10,44
Forfar,9213,8,10,5,21,38,67,-29,35
Albion,9213,9,8,6,22,58,81,-23,30
Queen's Park,9213,10,6,10,20,40,75,-35,28
Raith,9214,1,23,8,5,70,32,38,77
Ayr,9214,2,24,4,8,94,42,52,76
Arbroath,9214,3,18,8,10,73,48,25,62
Alloa,9214,4,17,8,11,56,45,11,59
Stranraer,9214,5,15,5,16,55,65,-10,50
East Fife,9214,6,14,3,19,48,64,-16,45
Airdrieon,9214,7,11,11,14,47,58,-11,44
Forfar,9214,8,10,5,21,38,66,-28,35
Albion,9214,9,8,6,22,57,82,-25,30
Queen's Park,9214,10,6,10,20,39,75,-36,28
Raith,9215,1,23,8,5,70,32,38,77
Ayr,9215,2,24,4,8,94,44,50,76
Arbroath,9215,3,17,8,11,71,50,21,59
Alloa,9215,4,17,8,11,56,45,11,59
Stranraer,9215,5,15,6,15,56,65,-9,51
Airdrieon,9215,6,11,11,14,48,59,-11,44
East Fife,9215,7,13,4,19,48,65,-17,43
Forfar,9215,8,10,5,21,39,67,-28,35
Queen's Park,9215,9,7,10,19,41,73,-32,31
Albion,9215,10,8,6,22,59,82,-23,30
Ayr,9216,1,24,4,8,93,42,51,76
Raith,9216,2,22,9,5,70,34,36,75
Alloa,9216,3,17,9,10,58,45,13,60
Arbroath,9216,4,17,8,11,70,50,20,59
Stranraer,9216,5,15,6,15,57,66,-9,51
East Fife,9216,6,13,4,19,49,66,-17,43
Airdrieon,9216,7,10,12,14,46,59,-13,42
Forfar,9216,8,10,6,20,39,65,-26,36
Queen's Park,9216,9,7,10,19,41,72,-31,31
Albion,9216,10,8,6,22,57,81,-24,30
Raith,9217,1,23,8,5,71,33,38,77
Ayr,9217,2,23,5,8,92,44,48,74
Arbroath,9217,3,17,9,10,74,52,22,60
Alloa,9217,4,17,8,11,57,46,11,59
Stranraer,9217,5,16,5,15,59,66,-7,53
Airdrieon,9217,6,10,12,14,46,59,-13,42
East Fife,9217,7,13,3,20,49,68,-19,42
Forfar,9217,8,10,6,20,39,65,-26,36
Albion,9217,9,8,7,21,59,80,-21,31
Queen's Park,9217,10,6,11,19,43,76,-33,29
Ayr,9218,1,24,4,8,94,42,52,76
Raith,9218,2,22,9,5,70,34,36,75
Alloa,9218,3,17,9,10,58,45,13,60
Arbroath,9218,4,17,8,11,71,51,20,59
Stranraer,9218,5,15,6,15,56,65,-9,51
East Fife,9218,6,13,4,19,48,65,-17,43
Airdrieon,9218,7,10,11,15,47,61,-14,41
Forfar,9218,8,11,5,20,41,66,-25,38
Queen's Park,9218,9,7,10,19,42,73,-31,31
Albion,9218,10,8,6,22,57,82,-25,30
Ayr,9219,1,24,4,8,93,43,50,76
Raith,9219,2,22,9,5,68,32,36,75
Arbroath,9219,3,17,9,10,70,48,22,60
Alloa,9219,4,17,9,10,56,43,13,60
Stranraer,9219,5,15,5,16,56,67,-11,50
East Fife,9219,6,14,3,19,50,65,-15,45
Airdrieon,9219,7,11,11,14,47,59,-12,44
Forfar,9219,8,10,5,21,39,66,-27,35
Albion,9219,9,8,6,22,58,81,-23,30
Queen's Park,9219,10,6,11,19,39,72,-33,29
Ayr,9220,1,24,4,8,95,42,53,76
Raith,9220,2,22,8,6,69,34,35,74
Alloa,9220,3,18,8,10,58,44,14,62
Arbroath,9220,4,17,9,10,71,49,22,60
Stranraer,9220,5,15,5,16,57,68,-11,50
East Fife,9220,6,14,3,19,51,66,-15,45
Airdrieon,9220,7,11,11,14,46,58,-12,44
Forfar,9220,8,10,5,21,38,65,-27,35
Albion,9220,9,8,6,22,57,83,-26,30
Queen's Park,9220,10,6,11,19,40,73,-33,29
Ayr,9221,1,24,4,8,93,43,50,76
Raith,9221,2,22,8,6,70,35,35,74
Arbroath,9221,3,18,8,10,73,50,23,62
Alloa,9221,4,18,8,10,59,45,14,62
Stranraer,9221,5,15,5,16,55,66,-11,50
East Fife,9221,6,14,3,19,49,64,-15,45
Airdrieon,9221,7,11,11,14,48,59,-11,44
Forfar,9221,8,10,5,21,39,67,-28,35
Albion,9221,9,8,6,22,58,81,-23,30
Queen's Park,9221,10,6,10,20,41,75,-34,28
Raith,9222,1,23,8,5,69,32,37,77
Ayr,9222,2,24,4,8,92,42,50,76
Arbroath,9222,3,17,9,10,70,48,22,60
Alloa,9222,4,17,8,11,56,44,12,59
Stranraer,9222,5,16,5,15,56,64,-8,53
East Fife,9222,6,13,3,20,47,65,-18,42
Airdrieon,9222,7,10,11,15,45,59,-14,41
Forfar,9222,8,11,5,20,39,64,-25,38
Albion,9222,9,8,6,22,57,80,-23,30
Queen's Park,9222,10,6,11,19,39,72,-33,29
Raith,9223,1,23,8,5,70,33,37,77
Ayr,9223,2,24,4,8,95,42,53,76
Arbroath,9223,3,18,8,10,75,48,27,62
Alloa,9223,4,17,8,11,57,45,12,59
Stranraer,9223,5,16,5,15,57,65,-8,53
East Fife,9223,6,13,3,20,48,66,-18,42
Airdrieon,9223,7,10,11,15,47,61,-14,41
Forfar,9223,8,11,5,20,41,66,-25,38
Albion,9223,9,8,6,22,57,83,-26,30
Queen's Park,9223,10,6,10,20,39,77,-38,28
Ayr,9224,1,24,4,8,95,44,51,76
Raith,9224,2,22,9,5,69,33,36,75
Arbroath,9224,3,18,8,10,71,48,23,62
Alloa,9224,4,17,9,10,57,44,13,60
Stranraer,9224,5,16,5,15,57,65,-8,53
Airdrieon,9224,6,11,11,14,47,58,-11,44
East Fife,9224,7,13,3,20,48,66,-18,42
Forfar,9224,8,10,5,21,38,66,-28,35
Albion,9224,9,8,6,22,59,83,-24,30
Queen's Park,9224,10,6,10,20,39,73,-34,28
Raith,9225,1,23,8,5,69,32,37,77
Ayr,9225,2,24,4,8,92,43,49,76
Arbroath,9225,3,18,8,10,71,48,23,62
Alloa,9225,4,17,8,11,56,44,12,59
Stranraer,9225,5,15,6,15,56,65,-9,51
Airdrieon,9225,6,11,11,14,46,58,-12,44
East Fife,9225,7,13,4,19,48,65,-17,43
Forfar,9225,8,10,5,21,38,65,-27,35
Albion,9225,9,8,6,22,58,80,-22,30
Queen's Park,9225,10,6,10,20,39,73,-34,28
Raith,9226,1,23,8,5,70,32,38,77
Ayr,9226,2,24,4,8,92,43,49,76
Arbroath,9226,3,18,8,10,72,49,23,62
Alloa,9226,4,17,8,11,56,45,11,59
Stranraer,9226,5,16,5,15,57,65,-8,53
Airdrieon,9226,6,10,12,14,46,59,-13,42
East Fife,9226,7,13,3,20,48,66,-18,42
Forfar,9226,8,10,6,20,39,65,-26,36
Albion,9226,9,8,6,22,58,80,-22,30
Queen's Park,9226,10,6,10,20,40,74,-34,28
Ayr,9227,1,24,4,8,91,42,49,76
Raith,9227,2,22,9,5,69,33,36,75
Arbroath,9227,3,18,8,10,74,51,23,62
Alloa,9227,4,17,9,10,57,44,13,60
Stranraer,9227,5,15,5,16,56,66,-10,50
East Fife,9227,6,14,3,19,49,65,-16,45
Airdrieon,9227,7,11,11,14,46,58,-12,44
Forfar,9227,8,10,5,21,38,65,-27,35
Albion,9227,9,8,6,22,57,79,-22,30
Queen's Park,9227,10,6,10,20,42,76,-34,28
Raith,9228,1,22,8,6,69,36,33,74
Ayr,9228,2,23,4,9,90,43,47,73
Arbroath,9228,3,18,8,10,71,48,23,62
Alloa,9228,4,18,8,10,60,44,16,62
Stranraer,9228,5,15,5,16,57,69,-12,50
East Fife,9228,6,14,3,19,52,66,-14,45
Airdrieon,9228,7,10,12,14,46,59,-13,42
Forfar,9228,8,10,6,20,39,65,-26,36
Albion,9228,9,9,6,21,58,78,-20,33
Queen's Park,9228,10,6,10,20,39,73,-34,28
Ayr,9229,1,24,4,8,93,42,51,76
Raith,9229,2,22,8,6,68,33,35,74
Arbroath,9229,3,18,8,10,72,49,23,62
Alloa,9229,4,18,8,10,57,43,14,62
Stranraer,9229,5,15,5,16,55,70,-15,50
East Fife,9229,6,14,3,19,53,64,-11,45
Airdrieon,9229,7,10,12,14,47,60,-13,42
Forfar,9229,8,10,6,20,40,66,-26,36
Albion,9229,9,8,6,22,57,81,-24,30
Queen's Park,9229,10,6,10,20,40,74,-34,28
Raith,9230,1,23,8,5,69,32,37,77
Ayr,9230,2,24,4,8,95,43,52,76
Arbroath,9230,3,18,8,10,76,50,26,62
Alloa,9230,4,17,8,11,56,44,12,59
Stranraer,9230,5,15,5,16,57,67,-10,50
East Fife,9230,6,14,3,19,50,66,-16,45
Airdrieon,9230,7,10,12,14,45,58,-13,42
Forfar,9230,8,10,6,20,38,64,-26,36
Albion,9230,9,8,6,22,58,83,-25,30
Queen's Park,9230,10,6,10,20,41,78,-37,28
Raith,9231,1,23,8,5,71,33,38,77
Ayr,9231,2,24,4,8,94,43,51,76
Arbroath,9231,3,17,8,11,70,49,21,59
Alloa,9231,4,17,8,11,57,46,11,59
Stranraer,9231,5,16,5,15,57,65,-8,53
Airdrieon,9231,6,11,11,14,47,58,-11,44
East Fife,9231,7,13,3,20,48,66,-18,42
Forfar,9231,8,10,5,21,38,66,-28,35
Queen's Park,9231,9,7,10,19,40,72,-32,31
Albion,9231,10,8,6,22,58,82,-24,30
Raith,9232,1,23,8,5,71,32,39,77
Ayr,9232,2,24,4,8,95,43,52,76
Arbroath,9232,3,18,8,10,73,49,24,62
Alloa,9232,4,17,8,11,56,46,10,59
Stranraer,9232,5,15,5,16,55,65,-10,50
East Fife,9232,6,14,3,19,48,64,-16,45
Airdrieon,9232,7,11,11,14,47,58,-11,44
Forfar,9232,8,10,5,21,38,66,-28,35
Albion,9232,9,8,6,22,58,83,-25,30
Queen's Park,9232,10,6,10,20,40,75,-35,28
Ayr,9233,1,24,4,8,94,43,51,76
Raith,9233,2,22,8,6,69,34,35,74
Arbroath,9233,3,18,8,10,71,48,23,62
Alloa,9233,4,18,8,10,58,44,14,62
Stranraer,9233,5,16,5,15,56,64,-8,53
Airdrieon,9233,6,11,11,14,46,58,-12,44
East Fife,9233,7,13,3,20,47,65,-18,42
Forfar,9233,8,10,5,21,38,65,-27,35
Albion,9233,9,8,6,22,58,82,-24,30
Queen's Park,9233,10,6,10,20,39,73,-34,28
Raith,9234,1,22,9,5,71,35,36,75
Ayr,9234,2,23,5,8,91,43,48,74
Arbroath,9234,3,18,8,10,73,49,24,62
Alloa,9234,4,17,9,10,59,46,13,60
Stranraer,9234,5,15,5,16,58,69,-11,50
East Fife,9234,6,14,3,19,52,67,-15,45
Airdrieon,9234,7,11,11,14,46,58,-12,44
Forfar,9234,8,10,5,21,38,65,-27,35
Albion,9234,9,8,7,21,58,79,-21,31
Queen's Park,9234,10,6,10,20,40,75,-35,28
Raith,9235,1,23,8,5,71,32,39,77
Ayr,9235,2,23,4,9,90,43,47,73
Arbroath,9235,3,17,8,11,72,52,20,59
Alloa,9235,4,17,8,11,56,46,10,59
Stranraer,9235,5,15,6,15,56,65,-9,51
East Fife,9235,6,13,4,19,48,65,-17,43
Airdrieon,9235,7,10,12,14,45,58,-13,42
Forfar,9235,8,10,6,20,38,64,-26,36
Albion,9235,9,9,6,21,58,78,-20,33
Queen's Park,9235,10,7,10,19,43,74,-31,31
Ayr,9236,1,24,4,8,92,43,49,76
Raith,9236,2,22,8,6,69,34,35,74
Alloa,9236,3,18,8,10,58,44,14,62
Arbroath,9236,4,17,8,11,70,50,20,59
Stranraer,9236,5,15,5,16,57,67,-10,50
East Fife,9236,6,14,3,19,50,66,-16,45
Airdrieon,9236,7,10,12,14,48,61,-13,42
Forfar,9236,8,10,6,20,41,67,-26,36
Queen's Park,9236,9,7,10,19,41,72,-31,31
Albion,9236,10,8,6,22,58,80,-22,30
Raith,9237,1,23,8,5,70,33,37,77
Ayr,9237,2,24,4,8,92,43,49,76
Arbroath,9237,3,18,8,10,72,48,24,62
Alloa,9237,4,17,8,11,57,45,12,59
Stranraer,9237,5,15,5,16,56,66,-10,50
East Fife,9237,6,14,3,19,49,65,-16,45
Airdrieon,9237,7,10,11,15,46,60,-14,41
Forfar,9237,8,11,5,20,40,65,-25,38
Albion,9237,9,8,6,22,58,80,-22,30
Queen's Park,9237,10,6,10,20,39,74,-35,28
Ayr,9238,1,24,4,8,95,43,52,76
Raith,9238,2,22,8,6,69,36,33,74
Alloa,9238,3,18,8,10,60,44,16,62
Arbroath,9238,4,17,9,10,72,50,22,60
Stranraer,9238,5,15,5,16,56,66,-10,50
East Fife,9238,6,14,3,19,49,65,-16,45
Airdrieon,9238,7,10,11,15,45,60,-15,41
Forfar,9238,8,11,5,20,40,64,-24,38
Albion,9238,9,8,6,22,58,83,-25,30
Queen's Park,9238,10,6,11,19,41,74,-33,29
Ayr,9239,1,24,4,8,96,42,54,76
Raith,9239,2,22,9,5,69,33,36,75
Arbroath,9239,3,17,9,10,71,49,22,60
Alloa,9239,4,17,9,10,57,44,13,60
Stranraer,9239,5,15,5,16,58,68,-10,50
East Fife,9239,6,14,3,19,51,67,-16,45
Airdrieon,9239,7,11,11,14,49,60,-11,44
Forfar,9239,8,10,5,21,40,68,-28,35
Albion,9239,9,8,6,22,57,84,-27,30
Queen's Park,9239,10,6,11,19,40,73,-33,29
Raith,9240,1,23,8,5,69,32,37,77
Ayr,9240,2,24,4,8,96,42,54,76
Arbroath,9240,3,17,9,10,70,48,22,60
Alloa,9240,4,17,8,11,56,44,12,59
Stranraer,9240,5,15,5,16,56,67,-11,50
East Fife,9240,6,14,3,19,50,65,-15,45
Airdrieon,9240,7,10,11,15,45,59,-14,41
Forfar,9240,8,11,5,20,39,64,-25,38
Albion,9240,9,8,6,22,57,84,-27,30
Queen's Park,9240,10,6,11,19,39,72,-33,29
Raith,9241,1,23,8,5,71,32,39,77
Ayr,9241,2,24,4,8,94,43,51,76
Arbroath,9241,3,18,8,10,72,49,23,62
Alloa,9241,4,17,8,11,56,46,10,59
Stranraer,9241,5,15,5,16,55,66,-11,50
East Fife,9241,6,14,3,19,49,64,-15,45
Airdrieon,9241,7,10,12,14,45,58,-13,42
Forfar,9241,8,10,6,20,38,64,-26,36
Albion,9241,9,8,6,22,58,82,-24,30
Queen's Park,9241,10,6,10,20,40,74,-34,28
Ayr,9242,1,24,4,8,92,42,50,76
Raith,9242,2,22,9,5,70,34,36,75
Alloa,9242,3,17,9,10,58,45,13,60
Arbroath,9242,4,17,8,11,71,50,21,59
Stranraer,9242,5,15,6,15,56,65,-9,51
Airdrieon,9242,6,11,11,14,46,58,-12,44
East Fife,9242,7,13,4,19,48,65,-17,43
Forfar,9242,8,10,5,21,38,65,-27,35
Queen's Park,9242,9,7,10,19,41,73,-32,31
Albion,9242,10,8,6,22,57,80,-23,30
Ayr,9243,1,24,4,8,92,42,50,76
Raith,9243,2,22,9,5,69,33,36,75
Arbroath,9243,3,18,8,10,72,49,23,62
Alloa,9243,4,17,9,10,57,44,13,60
Stranraer,9243,5,15,6,15,56,65,-9,51
Airdrieon,9243,6,11,11,14,48,59,-11,44
East Fife,9243,7,13,4,19,48,65,-17,43
Forfar,9243,8,10,5,21,39,67,-28,35
Albion,9243,9,8,6,22,57,80,-23,30
Queen's Park,9243,10,6,10,20,40,74,-34,28
Raith,9244,1,23,8,5,73,34,39,77
Ayr,9244,2,24,4,8,94,43,51,76
Arbroath,9244,3,18,8,10,74,48,26,62
Alloa,9244,4,17,8,11,58,48,10,59
Stranraer,9244,5,15,5,16,56,68,-12,50
East Fife,9244,6,14,3,19,51,65,-14,45
Airdrieon,9244,7,11,11,14,50,59,-9,44
Forfar,9244,8,10,5,21,39,69,-30,35
Albion,9244,9,8,6,22,58,82,-24,30
Queen's Park,9244,10,6,10,20,39,76,-37,28
Raith,9245,1,23,8,5,70,32,38,77
Ayr,9245,2,24,4,8,94,42,52,76
Arbroath,9245,3,17,9,10,70,48,22,60
Alloa,9245,4,17,8,11,56,45,11,59
Stranraer,9245,5,15,5,16,55,65,-10,50
East Fife,9245,6,14,3,19,48,64,-16,45
Airdrieon,9245,7,11,11,14,46,58,-12,44
Forfar,9245,8,10,5,21,38,65,-27,35
Albion,9245,9,8,6,22,57,82,-25,30
Queen's Park,9245,10,6,11,19,39,72,-33,29
Ayr,9246,1,24,4,8,95,42,53,76
Raith,9246,2,22,8,6,69,34,35,74
Alloa,9246,3,18,8,10,58,44,14,62
Arbroath,9246,4,17,8,11,71,50,21,59
Stranraer,9246,5,15,6,15,57,66,-9,51
East Fife,9246,6,13,4,19,49,66,-17,43
Airdrieon,9246,7,10,11,15,45,61,-16,41
Forfar,9246,8,11,5,20,41,64,-23,38
Queen's Park,9246,9,7,10,19,41,73,-32,31
Albion,9246,10,8,6,22,57,83,-26,30
Raith,9247,1,22,8,6,70,35,35,74
Ayr,9247,2,23,4,9,91,44,47,73
Alloa,9247,3,18,8,10,59,45,14,62
Arbroath,9247,4,17,8,11,71,50,21,59
Stranraer,9247,5,15,6,15,56,65,-9,51
Airdrieon,9247,6,11,11,14,47,58,-11,44
East Fife,9247,7,13,4,19,48,65,-17,43
Forfar,9247,8,10,5,21,38,66,-28,35
Albion,9247,9,9,6,21,59,79,-20,33
Queen's Park,9247,10,7,10,19,41,73,-32,31
Raith,9248,1,22,9,5,69,33,36,75
Ayr,9248,2,23,4,9,90,44,46,73
Alloa,9248,3,17,9,10,57,44,13,60
Arbroath,9248,4,17,8,11,71,51,20,59
Stranraer,9248,5,16,5,15,57,64,-7,53
Airdrieon,9248,6,11,11,14,49,58,-9,44
East Fife,9248,7,13,3,20,47,66,-19,42
Forfar,9248,8,10,5,21,38,68,-30,35
Albion,9248,9,9,6,21,59,78,-19,33
Queen's Park,9248,10,7,10,19,42,73,-31,31
Ayr,9249,1,24,4,8,97,44,53,76
Raith,9249,2,22,9,5,69,33,36,75
Arbroath,9249,3,18,8,10,72,49,23,62
Alloa,9249,4,17,9,10,57,44,13,60
Stranraer,9249,5,16,5,15,56,64,-8,53
Airdrieon,9249,6,11,11,14,48,58,-10,44
East Fife,9249,7,13,3,20,47,65,-18,42
Forfar,9249,8,10,5,21,38,67,-29,35
Albion,9249,9,8,6,22,59,85,-26,30
Queen's Park,9249,10,6,10,20,40,74,-34,28
Ayr,9250,1,23,5,8,93,45,48,74
Raith,9250,2,22,8,6,69,34,35,74
Arbroath,9250,3,18,8,10,73,49,24,62
Alloa,9250,4,18,8,10,58,44,14,62
Stranraer,9250,5,15,5,16,56,67,-11,50
East Fife,9250,6,14,3,19,50,65,-15,45
Airdrieon,9250,7,11,11,14,47,59,-12,44
Forfar,9250,8,10,5,21,39,66,-27,35
Albion,9250,9,8,7,21,60,81,-21,31
Queen's Park,9250,10,6,10,20,40,75,-35,28
Raith,9251,1,23,8,5,70,33,37,77
Ayr,9251,2,24,4,8,93,43,50,76
Arbroath,9251,3,17,8,11,70,50,20,59
Alloa,9251,4,17,8,11,57,45,12,59
Stranraer,9251,5,15,6,15,56,65,-9,51
Airdrieon,9251,6,11,11,14,47,58,-11,44
East Fife,9251,7,13,4,19,48,65,-17,43
Forfar,9251,8,10,5,21,38,66,-28,35
Queen's Park,9251,9,7,10,19,41,72,-31,31
Albion,9251,10,8,6,22,58,81,-23,30
Ayr,9252,1,24,4,8,92,43,49,76
Raith,9252,2,22,8,6,69,35,34,74
Alloa,9252,3,18,8,10,59,44,15,62
Arbroath,9252,4,17,8,11,70,49,21,59
Stranraer,9252,5,15,5,16,55,67,-12,50
East Fife,9252,6,14,3,19,50,64,-14,45
Airdrieon,9252,7,10,12,14,46,59,-13,42
Forfar,9252,8,10,6,20,39,65,-26,36
Queen's Park,9252,9,7,10,19,40,72,-32,31
Albion,9252,10,8,6,22,58,80,-22,30
Raith,9253,1,23,8,5,70,33,37,77
Ayr,9253,2,24,4,8,96,42,54,76
Arbroath,9253,3,17,8,11,71,50,21,59
Alloa,9253,4,17,8,11,57,45,12,59
Stranraer,9253,5,16,5,15,57,64,-7,53
Airdrieon,9253,6,10,12,14,46,59,-13,42
East Fife,9253,7,13,3,20,47,66,-19,42
Forfar,9253,8,10,6,20,39,65,-26,36
Queen's Park,9253,9,7,10,19,41,73,-32,31
Albion,9253,10,8,6,22,57,84,-27,30
Ayr,9254,1,24,4,8,96,42,54,76
Raith,9254,2,22,8,6,68,34,34,74
Alloa,9254,3,18,8,10,58,43,15,62
Arbroath,9254,4,17,8,11,71,52,19,59
Stranraer,9254,5,15,5,16,55,65,-10,50
East Fife,9254,6,14,3,19,48,64,-16,45
Airdrieon,9254,7,11,11,14,48,60,-12,44
Forfar,9254,8,10,5,21,40,67,-27,35
Queen's Park,9254,9,7,10,19,43,73,-30,31
Albion,9254,10,8,6,22,57,84,-27,30
Ayr,9255,1,24,4,8,94,42,52,76
Raith,9255,2,22,8,6,69,34,35,74
Arbroath,9255,3,18,8,10,72,49,23,62
Alloa,9255,4,18,8,10,58,44,14,62
Stranraer,9255,5,16,5,15,56,64,-8,53
Airdrieon,9255,6,11,11,14,47,59,-12,44
East Fife,9255,7,13,3,20,47,65,-18,42
Forfar,9255,8,10,5,21,39,66,-27,35
Albion,9255,9,8,6,22,57,82,-25,30
Queen's Park,9255,10,6,10,20,40,74,-34,28
Ayr,9256,1,24,4,8,95,43,52,76
Raith,9256,2,22,9,5,69,33,36,75
Arbroath,9256,3,17,9,10,71,49,22,60
Alloa,9256,4,17,9,10,57,44,13,60
Stranraer,9256,5,15,6,15,55,64,-9,51
East Fife,9256,6,13,4,19,47,64,-17,43
Airdrieon,9256,7,10,11,15,45,60,-15,41
Forfar,9256,8,11,5,20,40,64,-24,38
Albion,9256,9,8,6,22,58,83,-25,30
Queen's Park,9256,10,6,11,19,40,73,-33,29
Ayr,9257,1,24,4,8,94,43,51,76
Raith,9257,2,22,8,6,68,33,35,74
Arbroath,9257,3,18,8,10,72,49,23,62
Alloa,9257,4,18,8,10,57,43,14,62
Stranraer,9257,5,15,5,16,55,69,-14,50
East Fife,9257,6,14,3,19,52,64,-12,45
Airdrieon,9257,7,11,11,14,47,58,-11,44
Forfar,9257,8,10,5,21,38,66,-28,35
Albion,9257,9,8,6,22,58,82,-24,30
Queen's Park,9257,10,6,10,20,40,74,-34,28
Ayr,9258,1,24,4,8,95,42,53,76
Raith,9258,2,22,8,6,69,34,35,74
Alloa,9258,3,18,8,10,58,44,14,62
Arbroath,9258,4,17,9,10,71,49,22,60
Stranraer,9258,5,16,5,15,58,64,-6,53
Airdrieon,9258,6,11,11,14,46,58,-12,44
East Fife,9258,7,13,3,20,47,67,-20,42
Forfar,9258,8,10,5,21,38,65,-27,35
Albion,9258,9,8,6,22,57,83,-26,30
Queen's Park,9258,10,6,11,19,40,73,-33,29
Raith,9259,1,23,8,5,70,32,38,77
Ayr,9259,2,24,4,8,94,42,52,76
Arbroath,9259,3,17,9,10,72,50,22,60
Alloa,9259,4,17,8,11,56,45,11,59
Stranraer,9259,5,15,5,16,56,68,-12,50
East Fife,9259,6,14,3,19,51,65,-14,45
Airdrieon,9259,7,10,12,14,47,60,-13,42
Forfar,9259,8,10,6,20,40,66,-26,36
Albion,9259,9,8,6,22,57,82,-25,30
Queen's Park,9259,10,6,11,19,41,74,-33,29
Raith,9260,1,23,8,5,70,33,37,77
Ayr,9260,2,24,4,8,96,44,52,76
Arbroath,9260,3,18,8,10,75,48,27,62
Alloa,9260,4,17,8,11,57,45,12,59
Stranraer,9260,5,16,5,15,58,64,-6,53
Airdrieon,9260,6,10,12,14,47,60,-13,42
East Fife,9260,7,13,3,20,47,67,-20,42
Forfar,9260,8,10,6,20,40,66,-26,36
Albion,9260,9,8,6,22,59,84,-25,30
Queen's Park,9260,10,6,10,20,39,77,-38,28
Raith,9261,1,23,8,5,69,32,37,77
Ayr,9261,2,24,4,8,95,43,52,76
Arbroath,9261,3,18,8,10,72,48,24,62
Alloa,9261,4,17,8,11,56,44,12,59
Stranraer,9261,5,15,5,16,57,67,-10,50
East Fife,9261,6,14,3,19,50,66,-16,45
Airdrieon,9261,7,10,12,14,46,59,-13,42
Forfar,9261,8,10,6,20,39,65,-26,36
Albion,9261,9,8,6,22,58,83,-25,30
Queen's Park,9261,10,6,10,20,39,74,-35,28
Raith,9262,1,23,8,5,71,34,37,77
Ayr,9262,2,23,4,9,93,46,47,73
Arbroath,9262,3,18,8,10,71,48,23,62
Alloa,9262,4,17,8,11,58,46,12,59
Stranraer,9262,5,15,5,16,56,68,-12,50
East Fife,9262,6,14,3,19,51,65,-14,45
Airdrieon,9262,7,10,12,14,46,59,-13,42
Forfar,9262,8,10,6,20,39,65,-26,36
Albion,9262,9,9,6,21,61,81,-20,33
Queen's Park,9262,10,6,10,20,39,73,-34,28
Raith,9263,1,23,8,5,69,32,37,77
Ayr,9263,2,24,4,8,94,42,52,76
Arbroath,9263,3,17,8,11,71,50,21,59
Alloa,9263,4,17,8,11,56,44,12,59
Stranraer,9263,5,15,6,15,56,65,-9,51
Airdrieon,9263,6,11,11,14,46,58,-12,44
East Fife,9263,7,13,4,19,48,65,-17,43
Forfar,9263,8,10,5,21,38,65,-27,35
Queen's Park,9263,9,7,10,19,41,73,-32,31
Albion,9263,10,8,6,22,57,82,-25,30
Ayr,9264,1,24,4,8,96,43,53,76
Raith,9264,2,22,9,5,70,34,36,75
Arbroath,9264,3,17,9,10,71,49,22,60
Alloa,9264,4,17,9,10,58,45,13,60
Stranraer,9264,5,15,5,16,57,67,-10,50
East Fife,9264,6,14,3,19,50,66,-16,45
Airdrieon,9264,7,11,11,14,47,59,-12,44
Forfar,9264,8,10,5,21,39,66,-27,35
Albion,9264,9,8,6,22,58,84,-26,30
Queen's Park,9264,10,6,11,19,40,73,-33,29
Raith,9265,1,23,8,5,70,33,37,77
Ayr,9265,2,24,4,8,92,43,49,76
Arbroath,9265,3,18,8,10,72,49,23,62
Alloa,9265,4,17,8,11,57,45,12,59
Stranraer,9265,5,15,5,16,55,67,-12,50
East Fife,9265,6,14,3,19,50,64,-14,45
Airdrieon,9265,7,11,11,14,47,59,-12,44
Forfar,9265,8,10,5,21,39,66,-27,35
Albion,9265,9,8,6,22,58,80,-22,30
Queen's Park,9265,10,6,10,20,40,74,-34,28
Raith,9266,1,23,8,5,69,32,37,77
Ayr,9266,2,24,4,8,93,42,51,76
Arbroath,9266,3,18,8,10,72,49,23,62
Alloa,9266,4,17,8,11,56,44,12,59
Stranraer,9266,5,16,5,15,57,65,-8,53
Airdrieon,9266,6,10,12,14,46,59,-13,42
East Fife,9266,7,13,3,20,48,66,-18,42
Forfar,9266,8,10,6,20,39,65,-26,36
Albion,9266,9,8,6,22,57,81,-24,30
Queen's Park,9266,10,6,10,20,40,74,-34,28
Raith,9267,1,23,8,5,70,32,38,77
Ayr,9267,2,23,4,9,90,45,45,73
Arbroath,9267,3,18,8,10,73,49,24,62
Alloa,9267,4,17,8,11,56,45,11,59
Stranraer,9267,5,15,6,15,57,66,-9,51
East Fife,9267,6,13,4,19,49,66,-17,43
Airdrieon,9267,7,10,11,15,45,60,-15,41
Forfar,9267,8,11,5,20,40,64,-24,38
Albion,9267,9,9,6,21,60,78,-18,33
Queen's Park,9267,10,6,10,20,40,75,-35,28
Ayr,9268,1,24,4,8,94,42,52,76
Raith,9268,2,22,8,6,69,35,34,74
Alloa,9268,3,18,8,10,59,44,15,62
Arbroath,9268,4,17,9,10,72,50,22,60
Stranraer,9268,5,15,5,16,55,65,-10,50
East Fife,9268,6,14,3,19,48,64,-16,45
Airdrieon,9268,7,11,11,14,46,58,-12,44
Forfar,9268,8,10,5,21,38,65,-27,35
Albion,9268,9,8,6,22,57,82,-25,30
Queen's Park,9268,10,6,11,19,41,74,-33,29
Raith,9269,1,23,8,5,74,32,42,77
Ayr,9269,2,24,4,8,93,44,49,76
Arbroath,9269,3,17,8,11,72,51,21,59
Alloa,9269,4,17,8,11,56,49,7,59
Stranraer,9269,5,15,6,15,56,65,-9,51
Airdrieon,9269,6,11,11,14,46,58,-12,44
East Fife,9269,7,13,4,19,48,65,-17,43
Forfar,9269,8,10,5,21,38,65,-27,35
Queen's Park,9269,9,7,10,19,42,74,-32,31
Albion,9269,10,8,6,22,59,81,-22,30
Raith,9270,1,23,8,5,70,32,38,77
Ayr,9270,2,23,5,8,92,44,48,74
Arbroath,9270,3,18,8,10,72,49,23,62
Alloa,9270,4,17,8,11,56,45,11,59
Stranraer,9270,5,16,5,15,57,65,-8,53
Airdrieon,9270,6,11,11,14,46,58,-12,44
East Fife,9270,7,13,3,20,48,66,-18,42
Forfar,9270,8,10,5,21,38,65,-27,35
Albion,9270,9,8,7,21,59,80,-21,31
Queen's Park,9270,10,6,10,20,40,74,-34,28
Raith,9271,1,22,9,5,69,33,36,75
Ayr,9271,2,23,4,9,91,44,47,73
Alloa,9271,3,17,9,10,57,44,13,60
Arbroath,9271,4,17,8,11,72,51,21,59
Stranraer,9271,5,16,5,15,58,65,-7,53
Airdrieon,9271,6,11,11,14,47,59,-12,44
East Fife,9271,7,13,3,20,48,67,-19,42
Forfar,9271,8,10,5,21,39,66,-27,35
Albion,9271,9,9,6,21,59,79,-20,33
Queen's Park,9271,10,7,10,19,42,74,-32,31
Raith,9272,1,22,9,5,69,33,36,75
Ayr,9272,2,23,5,8,91,43,48,74
Arbroath,9272,3,18,8,10,72,49,23,62
Alloa,9272,4,17,9,10,57,44,13,60
Stranraer,9272,5,16,5,15,57,65,-8,53
East Fife,9272,6,13,3,20,48,66,-18,42
Airdrieon,9272,7,10,11,15,45,59,-14,41
Forfar,9272,8,11,5,20,39,64,-25,38
Albion,9272,9,8,7,21,58,79,-21,31
Queen's Park,9272,10,6,10,20,40,74,-34,28
Raith,9273,1,23,8,5,72,32,40,77
Ayr,9273,2,24,4,8,95,44,51,76
Arbroath,9273,3,18,8,10,73,50,23,62
Alloa,9273,4,17,8,11,56,47,9,59
Stranraer,9273,5,15,5,16,55,65,-10,50
East Fife,9273,6,14,3,19,48,64,-16,45
Airdrieon,9273,7,10,11,15,46,61,-15,41
Forfar,9273,8,11,5,20,41,65,-24,38
Albion,9273,9,8,6,22,59,83,-24,30
Queen's Park,9273,10,6,10,20,41,75,-34,28
Raith,9274,1,23,8,5,70,33,37,77
Ayr,9274,2,24,4,8,95,43,52,76
Arbroath,9274,3,17,8,11,70,49,21,59
Alloa,9274,4,17,8,11,57,45,12,59
Stranraer,9274,5,15,5,16,55,65,-10,50
East Fife,9274,6,14,3,19,48,64,-16,45
Airdrieon,9274,7,11,11,14,48,60,-12,44
Forfar,9274,8,10,5,21,40,67,-27,35
Queen's Park,9274,9,7,10,19,40,72,-32,31
Albion,9274,10,8,6,22,58,83,-25,30
Ayr,9275,1,24,4,8,93,43,50,76
Raith,9275,2,22,8,6,68,34,34,74
Alloa,9275,3,18,8,10,58,43,15,62
Arbroath,9275,4,17,8,11,71,50,21,59
Stranraer,9275,5,15,6,15,56,65,-9,51
East Fife,9275,6,13,4,19,48,65,-17,43
Airdrieon,9275,7,10,11,15,45,60,-15,41
Forfar,9275,8,11,5,20,40,64,-24,38
Queen's Park,9275,9,7,10,19,41,73,-32,31
Albion,9275,10,8,6,22,58,81,-23,30
Raith,9276,1,23,8,5,69,32,37,77
Ayr,9276,2,24,4,8,93,43,50,76
Arbroath,9276,3,18,8,10,72,48,24,62
Alloa,9276,4,17,8,11,56,44,12,59
Stranraer,9276,5,15,5,16,57,67,-10,50
East Fife,9276,6,14,3,19,50,66,-16,45
Airdrieon,9276,7,11,11,14,47,58,-11,44
Forfar,9276,8,10,5,21,38,66,-28,35
Albion,9276,9,8,6,22,58,81,-23,30
Queen's Park,9276,10,6,10,20,39,74,-35,28
Ayr,9277,1,24,4,8,93,43,50,76
Raith,9277,2,22,9,5,70,34,36,75
Arbroath,9277,3,18,8,10,72,48,24,62
Alloa,9277,4,17,9,10,58,45,13,60
Stranraer,9277,5,16,5,15,59,67,-8,53
Airdrieon,9277,6,10,12,14,46,59,-13,42
East Fife,9277,7,13,3,20,50,68,-18,42
Forfar,9277,8,10,6,20,39,65,-26,36
Albion,9277,9,8,6,22,58,81,-23,30
Queen's Park,9277,10,6,10,20,39,74,-35,28
Raith,9278,1,22,9,5,68,32,36,75
Ayr,9278,2,23,4,9,91,45,46,73
Alloa,9278,3,17,9,10,56,43,13,60
Arbroath,9278,4,17,8,11,70,51,19,59
Stranraer,9278,5,15,5,16,56,67,-11,50
East Fife,9278,6,14,3,19,50,65,-15,45
Airdrieon,9278,7,11,11,14,48,58,-10,44
Forfar,9278,8,10,5,21,38,67,-29,35
Albion,9278,9,9,6,21,60,79,-19,33
Queen's Park,9278,10,7,10,19,42,72,-30,31
Raith,9279,1,23,8,5,69,32,37,77
Ayr,9279,2,24,4,8,95,44,51,76
Arbroath,9279,3,17,9,10,70,48,22,60
Alloa,9279,4,17,8,11,56,44,12,59
Stranraer,9279,5,15,6,15,58,67,-9,51
East Fife,9279,6,13,4,19,50,67,-17,43
Airdrieon,9279,7,10,11,15,46,60,-14,41
Forfar,9279,8,11,5,20,40,65,-25,38
Albion,9279,9,8,6,22,59,83,-24,30
Queen's Park,9279,10,6,11,19,39,72,-33,29
Raith,9280,1,23,8,5,72,34,38,77
Ayr,9280,2,24,4,8,94,42,52,76
Arbroath,9280,3,18,8,10,71,48,23,62
Alloa,9280,4,17,8,11,58,47,11,59
Stranraer,9280,5,16,5,15,61,65,-4,53
Airdrieon,9280,6,11,11,14,47,59,-12,44
East Fife,9280,7,13,3,20,48,70,-22,42
Forfar,9280,8,10,5,21,39,66,-27,35
Albion,9280,9,8,6,22,57,82,-25,30
Queen's Park,9280,10,6,10,20,39,73,-34,28
Raith,9281,1,23,8,5,70,33,37,77
Ayr,9281,2,24,4,8,95,45,50,76
Arbroath,9281,3,17,8,11,71,50,21,59
Alloa,9281,4,17,8,11,57,45,12,59
Stranraer,9281,5,15,5,16,57,69,-12,50
East Fife,9281,6,14,3,19,52,66,-14,45
Airdrieon,9281,7,10,12,14,45,58,-13,42
Forfar,9281,8,10,6,20,38,64,-26,36
Queen's Park,9281,9,7,10,19,41,73,-32,31
Albion,9281,10,8,6,22,60,83,-23,30
Raith,9282,1,22,8,6,68,33,35,74
Ayr,9282,2,23,4,9,91,45,46,73
Arbroath,9282,3,18,8,10,73,49,24,62
Alloa,9282,4,18,8,10,57,43,14,62
Stranraer,9282,5,16,5,15,56,64,-8,53
East Fife,9282,6,13,3,20,47,65,-18,42
Airdrieon,9282,7,10,11,15,46,60,-14,41
Forfar,9282,8,11,5,20,40,65,-25,38
Albion,9282,9,9,6,21,60,79,-19,33
Queen's Park,9282,10,6,10,20,40,75,-35,28
Ayr,9283,1,24,4,8,93,44,49,76
Raith,9283,2,22,8,6,69,34,35,74
Arbroath,9283,3,18,8,10,71,48,23,62
Alloa,9283,4,18,8,10,58,44,14,62
Stranraer,9283,5,16,5,15,57,65,-8,53
Airdrieon,9283,6,11,11,14,48,58,-10,44
East Fife,9283,7,13,3,20,48,66,-18,42
Forfar,9283,8,10,5,21,38,67,-29,35
Albion,9283,9,8,6,22,59,81,-22,30
Queen's Park,9283,10,6,10,20,39,73,-34,28
Ayr,9284,1,24,4,8,93,42,51,76
Raith,9284,2,22,8,6,69,34,35,74
Arbroath,9284,3,18,8,10,73,48,25,62
Alloa,9284,4,18,8,10,58,44,14,62
Stranraer,9284,5,15,5,16,55,65,-10,50
East Fife,9284,6,14,3,19,48,64,-16,45
Airdrieon,9284,7,11,11,14,48,58,-10,44
Forfar,9284,8,10,5,21,38,67,-29,35
Albion,9284,9,8,6,22,57,81,-24,30
Queen's Park,9284,10,6,10,20,39,75,-36,28
Raith,9285,1,22,9,5,69,33,36,75
Ayr,9285,2,23,5,8,92,44,48,74
Alloa,9285,3,17,9,10,57,44,13,60
Arbroath,9285,4,17,8,11,71,50,21,59
Stranraer,9285,5,16,5,15,57,65,-8,53
Airdrieon,9285,6,10,12,14,45,58,-13,42
East Fife,9285,7,13,3,20,48,66,-18,42
Forfar,9285,8,10,6,20,38,64,-26,36
Albion,9285,9,8,7,21,59,80,-21,31
Queen's Park,9285,10,7,10,19,41,73,-32,31
Raith,9286,1,23,8,5,71,33,38,77
Ayr,9286,2,24,4,8,92,43,49,76
Arbroath,9286,3,18,8,10,71,48,23,62
Alloa,9286,4,17,8,11,57,46,11,59
Stranraer,9286,5,15,5,16,55,67,-12,50
East Fife,9286,6,14,3,19,50,64,-14,45
Airdrieon,9286,7,11,11,14,48,59,-11,44
Forfar,9286,8,10,5,21,39,67,-28,35
Albion,9286,9,8,6,22,58,80,-22,30
Queen's Park,9286,10,6,10,20,39,73,-34,28
Raith,9287,1,22,9,5,69,33,36,75
Ayr,9287,2,23,5,8,92,44,48,74
Alloa,9287,3,17,9,10,57,44,13,60
Arbroath,9287,4,17,8,11,71,50,21,59
Stranraer,9287,5,15,5,16,55,70,-15,50
East Fife,9287,6,14,3,19,53,64,-11,45
Airdrieon,9287,7,11,11,14,47,58,-11,44
Forfar,9287,8,10,5,21,38,66,-28,35
Albion,9287,9,8,7,21,59,80,-21,31
Queen's Park,9287,10,7,10,19,41,73,-32,31
Raith,9288,1,23,8,5,72,33,39,77
Ayr,9288,2,24,4,8,94,45,49,76
Arbroath,9288,3,17,8,11,70,49,21,59
Alloa,9288,4,17,8,11,57,47,10,59
Stranraer,9288,5,15,5,16,56,66,-10,50
East Fife,9288,6,14,3,19,49,65,-16,45
Airdrieon,9288,7,11,11,14,49,58,-9,44
Forfar,9288,8,10,5,21,38,68,-30,35
Queen's Park,9288,9,7,10,19,40,72,-32,31
Albion,9288,10,8,6,22,60,82,-22,30
Raith,9289,1,23,8,5,70,32,38,77
Ayr,9289,2,23,5,8,92,44,48,74
Arbroath,9289,3,17,8,11,71,50,21,59
Alloa,9289,4,17,8,11,56,45,11,59
Stranraer,9289,5,16,5,15,59,66,-7,53
East Fife,9289,6,13,3,20,49,68,-19,42
Airdrieon,9289,7,10,11,15,46,62,-16,41
Forfar,9289,8,11,5,20,42,65,-23,38
Albion,9289,9,8,7,21,59,80,-21,31
Queen's Park,9289,10,7,10,19,41,73,-32,31
Raith,9290,1,23,8,5,70,32,38,77
Ayr,9290,2,24,4,8,94,44,50,76
Arbroath,9290,3,18,8,10,73,49,24,62
Alloa,9290,4,17,8,11,56,45,11,59
Stranraer,9290,5,15,5,16,55,65,-10,50
East Fife,9290,6,14,3,19,48,64,-16,45
Airdrieon,9290,7,10,11,15,45,60,-15,41
Forfar,9290,8,11,5,20,40,64,-24,38
Albion,9290,9,8,6,22,59,82,-23,30
Queen's Park,9290,10,6,10,20,40,75,-35,28
Ayr,9291,1,24,4,8,93,44,49,76
Raith,9291,2,22,9,5,69,33,36,75
Arbroath,9291,3,17,9,10,71,49,22,60
Alloa,9291,4,17,9,10,57,44,13,60
Stranraer,9291,5,15,6,15,56,65,-9,51
Airdrieon,9291,6,11,11,14,47,58,-11,44
East Fife,9291,7,13,4,19,48,65,-17,43
Forfar,9291,8,10,5,21,38,66,-28,35
Albion,9291,9,8,6,22,59,81,-22,30
Queen's Park,9291,10,6,11,19,40,73,-33,29
Raith,9292,1,22,8,6,69,34,35,74
Ayr,9292,2,23,4,9,92,45,47,73
Alloa,9292,3,18,8,10,58,44,14,62
Arbroath,9292,4,17,9,10,70,48,22,60
Stranraer,9292,5,15,6,15,55,64,-9,51
Airdrieon,9292,6,11,11,14,48,58,-10,44
East Fife,9292,7,13,4,19,47,64,-17,43
Forfar,9292,8,10,5,21,38,67,-29,35
Albion,9292,9,9,6,21,60,80,-20,33
Queen's Park,9292,10,6,11,19,39,72,-33,29
Ayr,9293,1,24,4,8,92,42,50,76
Raith,9293,2,22,9,5,69,33,36,75
Arbroath,9293,3,18,8,10,71,48,23,62
Alloa,9293,4,17,9,10,57,44,13,60
Stranraer,9293,5,15,5,16,56,66,-10,50
East Fife,9293,6,14,3,19,49,65,-16,45
Airdrieon,9293,7,11,11,14,48,59,-11,44
Forfar,9293,8,10,5,21,39,67,-28,35
Albion,9293,9,8,6,22,57,80,-23,30
Queen's Park,9293,10,6,10,20,39,73,-34,28
Ayr,9294,1,24,4,8,93,42,51,76
Raith,9294,2,22,8,6,68,33,35,74
Arbroath,9294,3,18,8,10,73,49,24,62
Alloa,9294,4,18,8,10,57,43,14,62
Stranraer,9294,5,15,5,16,55,68,-13,50
East Fife,9294,6,14,3,19,51,64,-13,45
Airdrieon,9294,7,11,11,14,46,58,-12,44
Forfar,9294,8,10,5,21,38,65,-27,35
Albion,9294,9,8,6,22,57,81,-24,30
Queen's Park,9294,10,6,10,20,40,75,-35,28
Raith,9295,1,23,8,5,72,33,39,77
Ayr,9295,2,23,5,8,92,44,48,74
Arbroath,9295,3,17,8,11,70,49,21,59
Alloa,9295,4,17,8,11,57,47,10,59
Stranraer,9295,5,16,5,15,56,64,-8,53
East Fife,9295,6,13,3,20,47,65,-18,42
Airdrieon,9295,7,10,11,15,45,60,-15,41
Forfar,9295,8,11,5,20,40,64,-24,38
Albion,9295,9,8,7,21,59,80,-21,31
Queen's Park,9295,10,7,10,19,40,72,-32,31
Ayr,9296,1,24,4,8,96,42,54,76
Raith,9296,2,22,8,6,68,33,35,74
Arbroath,9296,3,18,8,10,75,48,27,62
Alloa,9296,4,18,8,10,57,43,14,62
Stranraer,9296,5,16,5,15,58,66,-8,53
Airdrieon,9296,6,11,11,14,50,59,-9,44
East Fife,9296,7,13,3,20,49,67,-18,42
Forfar,9296,8,10,5,21,39,69,-30,35
Albion,9296,9,8,6,22,57,84,-27,30
Queen's Park,9296,10,6,10,20,39,77,-38,28
Raith,9297,1,23,8,5,70,33,37,77
Ayr,9297,2,24,4,8,93,44,49,76
Arbroath,9297,3,18,8,10,71,48,23,62
Alloa,9297,4,17,8,11,57,45,12,59
Stranraer,9297,5,15,5,16,56,66,-10,50
East Fife,9297,6,14,3,19,49,65,-16,45
Airdrieon,9297,7,11,11,14,47,59,-12,44
Forfar,9297,8,10,5,21,39,66,-27,35
Albion,9297,9,8,6,22,59,81,-22,30
Queen's Park,9297,10,6,10,20,39,73,-34,28
Ayr,9298,1,24,4,8,92,43,49,76
Raith,9298,2,22,8,6,68,34,34,74
Arbroath,9298,3,18,8,10,73,50,23,62
Alloa,9298,4,18,8,10,58,43,15,62
Stranraer,9298,5,15,6,15,55,64,-9,51
Airdrieon,9298,6,11,11,14,47,58,-11,44
East Fife,9298,7,13,4,19,47,64,-17,43
Forfar,9298,8,10,5,21,38,66,-28,35
Albion,9298,9,8,6,22,58,80,-22,30
Queen's Park,9298,10,6,10,20,41,75,-34,28
Raith,9299,1,23,8,5,70,33,37,77
Ayr,9299,2,24,4,8,93,43,50,76
Arbroath,9299,3,18,8,10,73,49,24,62
Alloa,9299,4,17,8,11,57,45,12,59
Stranraer,9299,5,15,6,15,57,66,-9,51
East Fife,9299,6,13,4,19,49,66,-17,43
Airdrieon,9299,7,10,12,14,46,59,-13,42
Forfar,9299,8,10,6,20,39,65,-26,36
Albion,9299,9,8,6,22,58,81,-23,30
Queen's Park,9299,10,6,10,20,40,75,-35,28
Ayr,9300,1,24,4,8,93,44,49,76
Raith,9300,2,22,9,5,68,32,36,75
Arbroath,9300,3,18,8,10,72,49,23,62
Alloa,9300,4,17,9,10,56,43,13,60
Stranraer,9300,5,15,6,15,56,65,-9,51
Airdrieon,9300,6,11,11,14,47,59,-12,44
East Fife,9300,7,13,4,19,48,65,-17,43
Forfar,9300,8,10,5,21,39,66,-27,35
Albion,9300,9,8,6,22,59,81,-22,30
Queen's Park,9300,10,6,10,20,40,74,-34,28
Raith,9301,1,23,8,5,72,32,40,77
Ayr,9301,2,24,4,8,94,42,52,76
Arbroath,9301,3,17,9,10,70,48,22,60
Alloa,9301,4,17,8,11,56,47,9,59
Stranraer,9301,5,15,5,16,55,65,-10,50
East Fife,9301,6,14,3,19,48,64,-16,45
Airdrieon,9301,7,10,11,15,46,60,-14,41
Forfar,9301,8,11,5,20,40,65,-25,38
Albion,9301,9,8,6,22,57,82,-25,30
Queen's Park,9301,10,6,11,19,39,72,-33,29
Ayr,9302,1,24,4,8,95,43,52,76
Raith,9302,2,22,8,6,69,35,34,74
Arbroath,9302,3,18,8,10,72,48,24,62
Alloa,9302,4,18,8,10,59,44,15,62
Stranraer,9302,5,16,5,15,56,64,-8,53
Airdrieon,9302,6,11,11,14,49,59,-10,44
East Fife,9302,7,13,3,20,47,65,-18,42
Forfar,9302,8,10,5,21,39,68,-29,35
Albion,9302,9,8,6,22,58,83,-25,30
Queen's Park,9302,10,6,10,20,39,74,-35,28
Ayr,9303,1,24,4,8,96,43,53,76
Raith,9303,2,22,9,5,69,33,36,75
Alloa,9303,3,17,9,10,57,44,13,60
Arbroath,9303,4,17,8,11,71,50,21,59
Stranraer,9303,5,16,5,15,56,64,-8,53
Airdrieon,9303,6,11,11,14,48,58,-10,44
East Fife,9303,7,13,3,20,47,65,-18,42
Forfar,9303,8,10,5,21,38,67,-29,35
Queen's Park,9303,9,7,10,19,41,73,-32,31
Albion,9303,10,8,6,22,58,84,-26,30
Raith,9304,1,23,8,5,70,32,38,77
Ayr,9304,2,24,4,8,96,44,52,76
Arbroath,9304,3,18,8,10,73,48,25,62
Alloa,9304,4,17,8,11,56,45,11,59
Stranraer,9304,5,16,5,15,57,65,-8,53
Airdrieon,9304,6,11,11,14,47,59,-12,44
East Fife,9304,7,13,3,20,48,66,-18,42
Forfar,9304,8,10,5,21,39,66,-27,35
Albion,9304,9,8,6,22,59,84,-25,30
Queen's Park,9304,10,6,10,20,39,75,-36,28
Ayr,9305,1,24,4,8,95,45,50,76
Raith,9305,2,22,9,5,68,32,36,75
Alloa,9305,3,17,9,10,56,43,13,60
Arbroath,9305,4,17,8,11,71,51,20,59
Stranraer,9305,5,15,5,16,56,67,-11,50
East Fife,9305,6,14,3,19,50,65,-15,45
Airdrieon,9305,7,11,11,14,47,59,-12,44
Forfar,9305,8,10,5,21,39,66,-27,35
Queen's Park,9305,9,7,10,19,42,73,-31,31
Albion,9305,10,8,6,22,60,83,-23,30
Raith,9306,1,23,8,5,70,32,38,77
Ayr,9306,2,23,5,8,92,44,48,74
Arbroath,9306,3,17,8,11,71,50,21,59
Alloa,9306,4,17,8,11,56,45,11,59
Stranraer,9306,5,15,5,16,56,66,-10,50
East Fife,9306,6,14,3,19,49,65,-16,45
Airdrieon,9306,7,11,11,14,47,59,-12,44
Forfar,9306,8,10,5,21,39,66,-27,35
Albion,9306,9,8,7,21,59,80,-21,31
Queen's Park,9306,10,7,10,19,41,73,-32,31
Raith,9307,1,23,8,5,69,32,37,77
Ayr,9307,2,24,4,8,97,44,53,76
Arbroath,9307,3,17,8,11,71,51,20,59
Alloa,9307,4,17,8,11,56,44,12,59
Stranraer,9307,5,15,5,16,55,65,-10,50
East Fife,9307,6,14,3,19,48,64,-16,45
Airdrieon,9307,7,11,11,14,47,58,-11,44
Forfar,9307,8,10,5,21,38,66,-28,35
Queen's Park,9307,9,7,10,19,42,73,-31,31
Albion,9307,10,8,6,22,59,85,-26,30
Ayr,9308,1,24,4,8,93,42,51,76
Raith,9308,2,22,8,6,68,33,35,74
Arbroath,9308,3,18,8,10,73,50,23,62
Alloa,9308,4,18,8,10,57,43,14,62
Stranraer,9308,5,16,5,15,57,65,-8,53
East Fife,9308,6,13,3,20,48,66,-18,42
Airdrieon,9308,7,10,11,15,45,59,-14,41
Forfar,9308,8,11,5,20,39,64,-25,38
Albion,9308,9,8,6,22,57,81,-24,30
Queen's Park,9308,10,6,10,20,41,75,-34,28
Raith,9309,1,23,8,5,71,33,38,77
Ayr,9309,2,24,4,8,93,44,49,76
Arbroath,9309,3,17,9,10,72,50,22,60
Alloa,9309,4,17,8,11,57,46,11,59
Stranraer,9309,5,15,5,16,55,66,-11,50
East Fife,9309,6,14,3,19,49,64,-15,45
Airdrieon,9309,7,10,11,15,45,59,-14,41
Forfar,9309,8,11,5,20,39,64,-25,38
Albion,9309,9,8,6,22,59,81,-22,30
Queen's Park,9309,10,6,11,19,41,74,-33,29
Raith,9310,1,23,8,5,70,33,37,77
Ayr,9310,2,24,4,8,94,44,50,76
Arbroath,9310,3,18,8,10,73,49,24,62
Alloa,9310,4,17,8,11,57,45,12,59
Stranraer,9310,5,15,6,15,58,67,-9,51
East Fife,9310,6,13,4,19,50,67,-17,43
Airdrieon,9310,7,10,11,15,46,60,-14,41
Forfar,9310,8,11,5,20,40,65,-25,38
Albion,9310,9,8,6,22,59,82,-23,30
Queen's Park,9310,10,6,10,20,40,75,-35,28
Ayr,9311,1,24,4,8,94,43,51,76
Raith,9311,2,22,8,6,68,33,35,74
Alloa,9311,3,18,8,10,57,43,14,62
Arbroath,9311,4,17,9,10,73,51,22,60
Stranraer,9311,5,16,5,15,56,64,-8,53
Airdrieon,9311,6,11,11,14,47,59,-12,44
East Fife,9311,7,13,3,20,47,65,-18,42
Forfar,9311,8,10,5,21,39,66,-27,35
Albion,9311,9,8,6,22,58,82,-24,30
Queen's Park,9311,10,6,11,19,42,75,-33,29
Raith,9312,1,23,8,5,69,32,37,77
Ayr,9312,2,23,5,8,92,44,48,74
Arbroath,9312,3,17,9,10,72,50,22,60
Alloa,9312,4,17,8,11,56,44,12,59
Stranraer,9312,5,15,5,16,56,66,-10,50
East Fife,9312,6,14,3,19,49,65,-16,45
Airdrieon,9312,7,10,11,15,46,60,-14,41
Forfar,9312,8,11,5,20,40,65,-25,38
Albion,9312,9,8,7,21,59,80,-21,31
Queen's Park,9312,10,6,11,19,41,74,-33,29
Ayr,9313,1,24,4,8,94,43,51,76
Raith,9313,2,22,9,5,68,32,36,75
Alloa,9313,3,17,9,10,56,43,13,60
Arbroath,9313,4,17,8,11,70,51,19,59
Stranraer,9313,5,16,5,15,59,64,-5,53
Airdrieon,9313,6,10,12,14,46,59,-13,42
East Fife,9313,7,13,3,20,47,68,-21,42
Forfar,9313,8,10,6,20,39,65,-26,36
Queen's Park,9313,9,7,10,19,42,72,-30,31
Albion,9313,10,8,6,22,58,82,-24,30
Ayr,9314,1,24,4,8,94,43,51,76
Raith,9314,2,22,9,5,68,32,36,75
Arbroath,9314,3,17,9,10,70,48,22,60
Alloa,9314,4,17,9,10,56,43,13,60
Stranraer,9314,5,16,5,15,58,66,-8,53
Airdrieon,9314,6,11,11,14,48,59,-11,44
East Fife,9314,7,13,3,20,49,67,-18,42
Forfar,9314,8,10,5,21,39,67,-28,35
Albion,9314,9,8,6,22,58,82,-24,30
Queen's Park,9314,10,6,11,19,39,72,-33,29
Ayr,9315,1,24,4,8,94,45,49,76
Raith,9315,2,22,8,6,69,34,35,74
Alloa,9315,3,18,8,10,58,44,14,62
Arbroath,9315,4,17,9,10,71,49,22,60
Stranraer,9315,5,15,5,16,55,65,-10,50
East Fife,9315,6,14,3,19,48,64,-16,45
Airdrieon,9315,7,10,12,14,46,59,-13,42
Forfar,9315,8,10,6,20,39,65,-26,36
Albion,9315,9,8,6,22,60,82,-22,30
Queen's Park,9315,10,6,11,19,40,73,-33,29
Ayr,9316,1,24,4,8,93,43,50,76
Raith,9316,2,22,8,6,68,33,35,74
Arbroath,9316,3,18,8,10,72,49,23,62
Alloa,9316,4,18,8,10,57,43,14,62
Stranraer,9316,5,16,5,15,57,65,-8,53
East Fife,9316,6,13,3,20,48,66,-18,42
Airdrieon,9316,7,10,11,15,46,60,-14,41
Forfar,9316,8,11,5,20,40,65,-25,38
Albion,9316,9,8,6,22,58,81,-23,30
Queen's Park,9316,10,6,10,20,40,74,-34,28
Raith,9317,1,23,8,5,69,32,37,77
Ayr,9317,2,24,4,8,94,43,51,76
Arbroath,9317,3,18,8,10,73,49,24,62
Alloa,9317,4,17,8,11,56,44,12,59
Stranraer,9317,5,15,5,16,55,67,-12,50
East Fife,9317,6,14,3,19,50,64,-14,45
Airdrieon,9317,7,10,12,14,46,59,-13,42
Forfar,9317,8,10,6,20,39,65,-26,36
Albion,9317,9,8,6,22,58,82,-24,30
Queen's Park,9317,10,6,10,20,40,75,-35,28
Ayr,9318,1,24,4,8,94,44,50,76
Raith,9318,2,22,9,5,68,32,36,75
Alloa,9318,3,17,9,10,56,43,13,60
Arbroath,9318,4,17,8,11,72,51,21,59
Stranraer,9318,5,16,5,15,58,64,-6,53
East Fife,9318,6,13,3,20,47,67,-20,42
Airdrieon,9318,7,10,11,15,45,59,-14,41
Forfar,9318,8,11,5,20,39,64,-25,38
Queen's Park,9318,9,7,10,19,42,74,-32,31
Albion,9318,10,8,6,22,59,82,-23,30
Raith,9319,1,23,8,5,72,34,38,77
Ayr,9319,2,24,4,8,93,43,50,76
Arbroath,9319,3,17,8,11,70,50,20,59
Alloa,9319,4,17,8,11,58,47,11,59
Stranraer,9319,5,15,5,16,56,68,-12,50
East Fife,9319,6,14,3,19,51,65,-14,45
Airdrieon,9319,7,10,12,14,46,59,-13,42
Forfar,9319,8,10,6,20,39,65,-26,36
Queen's Park,9319,9,7,10,19,41,72,-31,31
Albion,9319,10,8,6,22,58,81,-23,30
Ayr,9320,1,24,4,8,93,42,51,76
Raith,9320,2,22,9,5,68,32,36,75
Arbroath,9320,3,18,8,10,72,49,23,62
Alloa,9320,4,17,9,10,56,43,13,60
Stranraer,9320,5,15,5,16,56,67,-11,50
East Fife,9320,6,14,3,19,50,65,-15,45
Airdrieon,9320,7,10,12,14,46,59,-13,42
Forfar,9320,8,10,6,20,39,65,-26,36
Albion,9320,9,8,6,22,57,81,-24,30
Queen's Park,9320,10,6,10,20,40,74,-34,28
Ayr,9321,1,24,4,8,92,42,50,76
Raith,9321,2,22,8,6,69,34,35,74
Alloa,9321,3,18,8,10,58,44,14,62
Arbroath,9321,4,17,9,10,73,51,22,60
Stranraer,9321,5,16,5,15,58,65,-7,53
Airdrieon,9321,6,11,11,14,48,59,-11,44
East Fife,9321,7,13,3,20,48,67,-19,42
Forfar,9321,8,10,5,21,39,67,-28,35
Albion,9321,9,8,6,22,57,80,-23,30
Queen's Park,9321,10,6,11,19,42,75,-33,29
Raith,9322,1,23,8,5,69,32,37,77
Ayr,9322,2,23,4,9,91,44,47,73
Arbroath,9322,3,18,8,10,73,49,24,62
Alloa,9322,4,17,8,11,56,44,12,59
Stranraer,9322,5,15,5,16,56,68,-12,50
East Fife,9322,6,14,3,19,51,65,-14,45
Airdrieon,9322,7,11,11,14,48,58,-10,44
Forfar,9322,8,10,5,21,38,67,-29,35
Albion,9322,9,9,6,21,59,79,-20,33
Queen's Park,9322,10,6,10,20,40,75,-35,28
Ayr,9323,1,24,4,8,95,44,51,76
Raith,9323,2,22,8,6,69,34,35,74
Arbroath,9323,3,18,8,10,72,49,23,62
Alloa,9323,4,18,8,10,58,44,14,62
Stranraer,9323,5,16,5,15,57,65,-8,53
East Fife,9323,6,13,3,20,48,66,-18,42
Airdrieon,9323,7,10,11,15,45,59,-14,41
Forfar,9323,8,11,5,20,39,64,-25,38
Albion,9323,9,8,6,22,59,83,-24,30
Queen's Park,9323,10,6,10,20,40,74,-34,28
Raith,9324,1,23,8,5,70,32,38,77
Ayr,9324,2,23,5,8,92,44,48,74
Arbroath,9324,3,17,9,10,71,49,22,60
Alloa,9324,4,17,8,11,56,45,11,59
Stranraer,9324,5,15,5,16,56,66,-10,50
East Fife,9324,6,14,3,19,49,65,-16,45
Airdrieon,9324,7,10,12,14,47,60,-13,42
Forfar,9324,8,10,6,20,40,66,-26,36
Albion,9324,9,8,7,21,59,80,-21,31
Queen's Park,9324,10,6,11,19,40,73,-33,29
Ayr,9325,1,24,4,8,92,42,50,76
Raith,9325,2,22,9,5,68,32,36,75
Arbroath,9325,3,18,8,10,73,48,25,62
Alloa,9325,4,17,9,10,56,43,13,60
Stranraer,9325,5,16,5,15,56,64,-8,53
Airdrieon,9325,6,11,11,14,49,59,-10,44
East Fife,9325,7,13,3,20,47,65,-18,42
Forfar,9325,8,10,5,21,39,68,-29,35
Albion,9325,9,8,6,22,57,80,-23,30
Queen's Park,9325,10,6,10,20,39,75,-36,28
Raith,9326,1,22,9,5,69,33,36,75
Ayr,9326,2,23,4,9,92,45,47,73
Alloa,9326,3,17,9,10,57,44,13,60
Arbroath,9326,4,17,8,11,71,51,20,59
Stranraer,9326,5,15,5,16,55,66,-11,50
East Fife,9326,6,14,3,19,49,64,-15,45
Airdrieon,9326,7,11,11,14,46,58,-12,44
Forfar,9326,8,10,5,21,38,65,-27,35
Albion,9326,9,9,6,21,60,80,-20,33
Queen's Park,9326,10,7,10,19,42,73,-31,31
Raith,9327,1,23,8,5,74,34,40,77
Ayr,9327,2,24,4,8,93,42,51,76
Arbroath,9327,3,17,9,10,72,50,22,60
Alloa,9327,4,17,8,11,58,49,9,59
Stranraer,9327,5,15,6,15,58,67,-9,51
Airdrieon,9327,6,11,11,14,49,58,-9,44
East Fife,9327,7,13,4,19,50,67,-17,43
Forfar,9327,8,10,5,21,38,68,-30,35
Albion,9327,9,8,6,22,57,81,-24,30
Queen's Park,9327,10,6,11,19,41,74,-33,29
Ayr,9328,1,24,4,8,92,43,49,76
Raith,9328,2,22,9,5,69,33,36,75
Arbroath,9328,3,17,9,10,70,48,22,60
Alloa,9328,4,17,9,10,57,44,13,60
Stranraer,9328,5,15,5,16,56,67,-11,50
East Fife,9328,6,14,3,19,50,65,-15,45
Airdrieon,9328,7,10,11,15,45,60,-15,41
Forfar,9328,8,11,5,20,40,64,-24,38
Albion,9328,9,8,6,22,58,80,-22,30
Queen's Park,9328,10,6,11,19,39,72,-33,29
Raith,9329,1,22,9,5,69,33,36,75
Ayr,9329,2,23,5,8,92,44,48,74
Arbroath,9329,3,17,9,10,72,50,22,60
Alloa,9329,4,17,9,10,57,44,13,60
Stranraer,9329,5,16,5,15,57,64,-7,53
Airdrieon,9329,6,11,11,14,49,59,-10,44
East Fife,9329,7,13,3,20,47,66,-19,42
Forfar,9329,8,10,5,21,39,68,-29,35
Albion,9329,9,8,7,21,59,80,-21,31
Queen's Park,9329,10,6,11,19,41,74,-33,29
Ayr,9330,1,24,4,8,91,42,49,76
Raith,9330,2,22,8,6,68,33,35,74
Arbroath,9330,3,18,8,10,72,49,23,62
Alloa,9330,4,18,8,10,57,43,14,62
Stranraer,9330,5,16,5,15,56,64,-8,53
Airdrieon,9330,6,10,12,14,46,59,-13,42
East Fife,9330,7,13,3,20,47,65,-18,42
Forfar,9330,8,10,6,20,39,65,-26,36
Albion,9330,9,8,6,22,57,79,-22,30
Queen's Park,9330,10,6,10,20,40,74,-34,28
Raith,9331,1,23,8,5,72,33,39,77
Ayr,9331,2,24,4,8,95,42,53,76
Arbroath,9331,3,18,8,10,72,48,24,62
Alloa,9331,4,17,8,11,57,47,10,59
Stranraer,9331,5,15,6,15,58,67,-9,51
Airdrieon,9331,6,11,11,14,47,59,-12,44
East Fife,9331,7,13,4,19,50,67,-17,43
Forfar,9331,8,10,5,21,39,66,-27,35
Albion,9331,9,8,6,22,57,83,-26,30
Queen's Park,9331,10,6,10,20,39,74,-35,28
Ayr,9332,1,24,4,8,93,43,50,76
Raith,9332,2,22,9,5,68,32,36,75
Arbroath,9332,3,18,8,10,75,51,24,62
Alloa,9332,4,17,9,10,56,43,13,60
Stranraer,9332,5,15,5,16,56,67,-11,50
East Fife,9332,6,14,3,19,50,65,-15,45
Airdrieon,9332,7,11,11,14,47,59,-12,44
Forfar,9332,8,10,5,21,39,66,-27,35
Albion,9332,9,8,6,22,58,81,-23,30
Queen's Park,9332,10,6,10,20,42,77,-35,28
Ayr,9333,1,24,4,8,95,42,53,76
Raith,9333,2,22,8,6,68,36,32,74
Alloa,9333,3,18,8,10,60,43,17,62
Arbroath,9333,4,17,9,10,71,49,22,60
Stranraer,9333,5,16,5,15,57,64,-7,53
Airdrieon,9333,6,11,11,14,48,60,-12,44
East Fife,9333,7,13,3,20,47,66,-19,42
Forfar,9333,8,10,5,21,40,67,-27,35
Albion,9333,9,8,6,22,57,83,-26,30
Queen's Park,9333,10,6,11,19,40,73,-33,29
Raith,9334,1,22,9,5,69,33,36,75
Ayr,9334,2,23,5,8,93,45,48,74
Arbroath,9334,3,18,8,10,74,50,24,62
Alloa,9334,4,17,9,10,57,44,13,60
Stranraer,9334,5,15,6,15,58,67,-9,51
East Fife,9334,6,13,4,19,50,67,-17,43
Airdrieon,9334,7,10,12,14,47,60,-13,42
Forfar,9334,8,10,6,20,40,66,-26,36
Albion,9334,9,8,7,21,60,81,-21,31
Queen's Park,9334,10,6,10,20,41,76,-35,28
Raith,9335,1,23,8,5,70,32,38,77
Ayr,9335,2,24,4,8,95,45,50,76
Arbroath,9335,3,18,8,10,73,48,25,62
Alloa,9335,4,17,8,11,56,45,11,59
Stranraer,9335,5,16,5,15,57,65,-8,53
Airdrieon,9335,6,11,11,14,47,58,-11,44
East Fife,9335,7,13,3,20,48,66,-18,42
Forfar,9335,8,10,5,21,38,66,-28,35
Albion,9335,9,8,6,22,60,83,-23,30
Queen's Park,9335,10,6,10,20,39,75,-36,28
Raith,9336,1,23,8,5,71,33,38,77
Ayr,9336,2,24,4,8,94,42,52,76
Arbroath,9336,3,17,9,10,71,49,22,60
Alloa,9336,4,17,8,11,57,46,11,59
Stranraer,9336,5,15,6,15,58,67,-9,51
Airdrieon,9336,6,11,11,14,46,58,-12,44
East Fife,9336,7,13,4,19,50,67,-17,43
Forfar,9336,8,10,5,21,38,65,-27,35
Albion,9336,9,8,6,22,57,82,-25,30
Queen's Park,9336,10,6,11,19,40,73,-33,29
Raith,9337,1,23,8,5,70,33,37,77
Ayr,9337,2,24,4,8,94,42,52,76
Arbroath,9337,3,18,8,10,74,50,24,62
Alloa,9337,4,17,8,11,57,45,12,59
Stranraer,9337,5,15,6,15,56,65,-9,51
East Fife,9337,6,13,4,19,48,65,-17,43
Airdrieon,9337,7,10,12,14,46,59,-13,42
Forfar,9337,8,10,6,20,39,65,-26,36
Albion,9337,9,8,6,22,57,82,-25,30
Queen's Park,9337,10,6,10,20,41,76,-35,28
Raith,9338,1,23,8,5,69,32,37,77
Ayr,9338,2,23,4,9,92,45,47,73
Arbroath,9338,3,18,8,10,73,50,23,62
Alloa,9338,4,17,8,11,56,44,12,59
Stranraer,9338,5,15,6,15,57,66,-9,51
East Fife,9338,6,13,4,19,49,66,-17,43
Airdrieon,9338,7,10,12,14,48,61,-13,42
Forfar,9338,8,10,6,20,41,67,-26,36
Albion,9338,9,9,6,21,60,80,-20,33
Queen's Park,9338,10,6,10,20,41,75,-34,28
Ayr,9339,1,24,4,8,96,46,50,76
Raith,9339,2,22,9,5,68,32,36,75
Arbroath,9339,3,18,8,10,73,49,24,62
Alloa,9339,4,17,9,10,56,43,13,60
Stranraer,9339,5,15,5,16,56,67,-11,50
East Fife,9339,6,14,3,19,50,65,-15,45
Airdrieon,9339,7,10,12,14,46,59,-13,42
Forfar,9339,8,10,6,20,39,65,-26,36
Albion,9339,9,8,6,22,61,84,-23,30
Queen's Park,9339,10,6,10,20,40,75,-35,28
Raith,9340,1,23,8,5,69,32,37,77
Ayr,9340,2,24,4,8,95,43,52,76
Arbroath,9340,3,17,9,10,72,50,22,60
Alloa,9340,4,17,8,11,56,44,12,59
Stranraer,9340,5,15,5,16,55,65,-10,50
East Fife,9340,6,14,3,19,48,64,-16,45
Airdrieon,9340,7,10,11,15,45,59,-14,41
Forfar,9340,8,11,5,20,39,64,-25,38
Albion,9340,9,8,6,22,58,83,-25,30
Queen's Park,9340,10,6,11,19,41,74,-33,29
Ayr,9341,1,24,4,8,94,44,50,76
Raith,9341,2,22,8,6,68,33,35,74
Alloa,9341,3,18,8,10,57,43,14,62
Arbroath,9341,4,17,9,10,71,49,22,60
Stranraer,9341,5,15,5,16,56,66,-10,50
East Fife,9341,6,14,3,19,49,65,-16,45
Airdrieon,9341,7,10,12,14,46,59,-13,42
Forfar,9341,8,10,6,20,39,65,-26,36
Albion,9341,9,8,6,22,59,82,-23,30
Queen's Park,9341,10,6,11,19,40,73,-33,29
Ayr,9342,1,24,4,8,94,43,51,76
Raith,9342,2,22,8,6,70,35,35,74
Alloa,9342,3,18,8,10,59,45,14,62
Arbroath,9342,4,17,8,11,72,51,21,59
Stranraer,9342,5,15,5,16,57,68,-11,50
East Fife,9342,6,14,3,19,51,66,-15,45
Airdrieon,9342,7,11,11,14,47,58,-11,44
Forfar,9342,8,10,5,21,38,66,-28,35
Queen's Park,9342,9,7,10,19,42,74,-32,31
Albion,9342,10,8,6,22,58,82,-24,30
Ayr,9343,1,24,4,8,94,42,52,76
Raith,9343,2,22,9,5,68,32,36,75
Alloa,9343,3,17,9,10,56,43,13,60
Arbroath,9343,4,17,8,11,72,51,21,59
Stranraer,9343,5,15,5,16,55,65,-10,50
East Fife,9343,6,14,3,19,48,64,-16,45
Airdrieon,9343,7,10,12,14,45,58,-13,42
Forfar,9343,8,10,6,20,38,64,-26,36
Queen's Park,9343,9,7,10,19,42,74,-32,31
Albion,9343,10,8,6,22,57,82,-25,30
Ayr,9344,1,24,4,8,93,42,51,76
Raith,9344,2,22,8,6,68,33,35,74
Arbroath,9344,3,18,8,10,74,49,25,62
Alloa,9344,4,18,8,10,57,43,14,62
Stranraer,9344,5,15,6,15,56,65,-9,51
Airdrieon,9344,6,11,11,14,48,59,-11,44
East Fife,9344,7,13,4,19,48,65,-17,43
Forfar,9344,8,10,5,21,39,67,-28,35
Albion,9344,9,8,6,22,57,81,-24,30
Queen's Park,9344,10,6,10,20,40,76,-36,28
Ayr,9345,1,24,4,8,92,42,50,76
Raith,9345,2,22,8,6,69,35,34,74
Alloa,9345,3,18,8,10,59,44,15,62
Arbroath,9345,4,17,8,11,70,49,21,59
Stranraer,9345,5,15,6,15,56,65,-9,51
Airdrieon,9345,6,11,11,14,46,58,-12,44
East Fife,9345,7,13,4,19,48,65,-17,43
Forfar,9345,8,10,5,21,38,65,-27,35
Queen's Park,9345,9,7,10,19,40,72,-32,31
Albion,9345,10,8,6,22,57,80,-23,30
Ayr,9346,1,24,4,8,93,44,49,76
Raith,9346,2,22,9,5,70,34,36,75
Arbroath,9346,3,18,8,10,72,49,23,62
Alloa,9346,4,17,9,10,58,45,13,60
Stranraer,9346,5,15,5,16,56,66,-10,50
East Fife,9346,6,14,3,19,49,65,-16,45
Airdrieon,9346,7,11,11,14,50,58,-8,44
Forfar,9346,8,10,5,21,38,69,-31,35
Albion,9346,9,8,6,22,59,81,-22,30
Queen's Park,9346,10,6,10,20,40,74,-34,28
Raith,9347,1,23,8,5,71,33,38,77
Ayr,9347,2,23,4,9,91,46,45,73
Arbroath,9347,3,18,8,10,75,48,27,62
Alloa,9347,4,17,8,11,57,46,11,59
Stranraer,9347,5,15,6,15,55,64,-9,51
Airdrieon,9347,6,11,11,14,47,59,-12,44
East Fife,9347,7,13,4,19,47,64,-17,43
Forfar,9347,8,10,5,21,39,66,-27,35
Albion,9347,9,9,6,21,61,79,-18,33
Queen's Park,9347,10,6,10,20,39,77,-38,28
Ayr,9348,1,24,4,8,95,42,53,76
Raith,9348,2,22,9,5,69,33,36,75
Alloa,9348,3,17,9,10,57,44,13,60
Arbroath,9348,4,17,8,11,70,49,21,59
Stranraer,9348,5,15,5,16,57,67,-10,50
East Fife,9348,6,14,3,19,50,66,-16,45
Airdrieon,9348,7,11,11,14,46,58,-12,44
Forfar,9348,8,10,5,21,38,65,-27,35
Queen's Park,9348,9,7,10,19,40,72,-32,31
Albion,9348,10,8,6,22,57,83,-26,30
Raith,9349,1,23,8,5,70,32,38,77
Ayr,9349,2,24,4,8,93,43,50,76
Arbroath,9349,3,17,9,10,71,49,22,60
Alloa,9349,4,17,8,11,56,45,11,59
Stranraer,9349,5,16,5,15,56,64,-8,53
Airdrieon,9349,6,10,12,14,45,58,-13,42
East Fife,9349,7,13,3,20,47,65,-18,42
Forfar,9349,8,10,6,20,38,64,-26,36
Albion,9349,9,8,6,22,58,81,-23,30
Queen's Park,9349,10,6,11,19,40,73,-33,29
Ayr,9350,1,24,4,8,96,42,54,76
Raith,9350,2,22,8,6,68,33,35,74
Arbroath,9350,3,18,8,10,71,48,23,62
Alloa,9350,4,18,8,10,57,43,14,62
Stranraer,9350,5,16,5,15,57,64,-7,53
East Fife,9350,6,13,3,20,47,66,-19,42
Airdrieon,9350,7,10,11,15,45,60,-15,41
Forfar,9350,8,11,5,20,40,64,-24,38
Albion,9350,9,8,6,22,57,84,-27,30
Queen's Park,9350,10,6,10,20,39,73,-34,28
Raith,9351,1,23,8,5,72,33,39,77
Ayr,9351,2,23,5,8,92,44,48,74
Arbroath,9351,3,17,8,11,71,50,21,59
Alloa,9351,4,17,8,11,57,47,10,59
Stranraer,9351,5,15,5,16,56,66,-10,50
East Fife,9351,6,14,3,19,49,65,-16,45
Airdrieon,9351,7,11,11,14,49,60,-11,44
Forfar,9351,8,10,5,21,40,68,-28,35
Albion,9351,9,8,7,21,59,80,-21,31
Queen's Park,9351,10,7,10,19,41,73,-32,31
Ayr,9352,1,24,4,8,93,42,51,76
Raith,9352,2,22,8,6,68,34,34,74
Alloa,9352,3,18,8,10,58,43,15,62
Arbroath,9352,4,17,9,10,72,50,22,60
Stranraer,9352,5,16,5,15,56,64,-8,53
Airdrieon,9352,6,10,12,14,45,58,-13,42
East Fife,9352,7,13,3,20,47,65,-18,42
Forfar,9352,8,10,6,20,38,64,-26,36
Albion,9352,9,8,6,22,57,81,-24,30
Queen's Park,9352,10,6,11,19,41,74,-33,29
Raith,9353,1,23,8,5,70,32,38,77
Ayr,9353,2,24,4,8,96,42,54,76
Arbroath,9353,3,17,9,10,71,49,22,60
Alloa,9353,4,17,8,11,56,45,11,59
Stranraer,9353,5,15,5,16,55,66,-11,50
East Fife,9353,6,14,3,19,49,64,-15,45
Airdrieon,9353,7,10,11,15,46,60,-14,41
Forfar,9353,8,11,5,20,40,65,-25,38
Albion,9353,9,8,6,22,57,84,-27,30
Queen's Park,9353,10,6,11,19,40,73,-33,29
Raith,9354,1,23,8,5,71,34,37,77
Ayr,9354,2,24,4,8,94,42,52,76
Arbroath,9354,3,17,8,11,70,51,19,59
Alloa,9354,4,17,8,11,58,46,12,59
Stranraer,9354,5,15,5,16,58,69,-11,50
East Fife,9354,6,14,3,19,52,67,-15,45
Airdrieon,9354,7,11,11,14,48,59,-11,44
Forfar,9354,8,10,5,21,39,67,-28,35
Queen's Park,9354,9,7,10,19,42,72,-30,31
Albion,9354,10,8,6,22,57,82,-25,30
Raith,9355,1,23,8,5,72,32,40,77
Ayr,9355,2,24,4,8,97,42,55,76
Arbroath,9355,3,18,8,10,73,48,25,62
Alloa,9355,4,17,8,11,56,47,9,59
Stranraer,9355,5,16,5,15,57,65,-8,53
East Fife,9355,6,13,3,20,48,66,-18,42
Airdrieon,9355,7,10,11,15,47,62,-15,41
Forfar,9355,8,11,5,20,42,66,-24,38
Albion,9355,9,8,6,22,57,85,-28,30
Queen's Park,9355,10,6,10,20,39,75,-36,28
Ayr,9356,1,24,4,8,94,42,52,76
Raith,9356,2,22,9,5,69,33,36,75
Arbroath,9356,3,18,8,10,73,49,24,62
Alloa,9356,4,17,9,10,57,44,13,60
Stranraer,9356,5,15,6,15,56,65,-9,51
Airdrieon,9356,6,11,11,14,48,59,-11,44
East Fife,9356,7,13,4,19,48,65,-17,43
Forfar,9356,8,10,5,21,39,67,-28,35
Albion,9356,9,8,6,22,57,82,-25,30
Queen's Park,9356,10,6,10,20,40,75,-35,28
Raith,9357,1,23,8,5,69,32,37,77
Ayr,9357,2,24,4,8,94,42,52,76
Arbroath,9357,3,17,9,10,72,50,22,60
Alloa,9357,4,17,8,11,56,44,12,59
Stranraer,9357,5,15,6,15,56,65,-9,51
East Fife,9357,6,13,4,19,48,65,-17,43
Airdrieon,9357,7,10,12,14,45,58,-13,42
Forfar,9357,8,10,6,20,38,64,-26,36
Albion,9357,9,8,6,22,57,82,-25,30
Queen's Park,9357,10,6,11,19,41,74,-33,29
Ayr,9358,1,24,4,8,92,42,50,76
Raith,9358,2,22,9,5,70,34,36,75
Arbroath,9358,3,18,8,10,72,49,23,62
Alloa,9358,4,17,9,10,58,45,13,60
Stranraer,9358,5,15,5,16,56,67,-11,50
East Fife,9358,6,14,3,19,50,65,-15,45
Airdrieon,9358,7,10,12,14,46,59,-13,42
Forfar,9358,8,10,6,20,39,65,-26,36
Albion,9358,9,8,6,22,57,80,-23,30
Queen's Park,9358,10,6,10,20,40,74,-34,28
Raith,9359,1,23,8,5,70,32,38,77
Ayr,9359,2,24,4,8,93,44,49,76
Arbroath,9359,3,17,8,11,70,50,20,59
Alloa,9359,4,17,8,11,56,45,11,59
Stranraer,9359,5,16,5,15,58,65,-7,53
Airdrieon,9359,6,10,12,14,46,59,-13,42
East Fife,9359,7,13,3,20,48,67,-19,42
Forfar,9359,8,10,6,20,39,65,-26,36
Queen's Park,9359,9,7,10,19,41,72,-31,31
Albion,9359,10,8,6,22,59,81,-22,30
Raith,9360,1,23,8,5,70,33,37,77
Ayr,9360,2,24,4,8,93,42,51,76
Arbroath,9360,3,18,8,10,72,49,23,62
Alloa,9360,4,17,8,11,57,45,12,59
Stranraer,9360,5,15,5,16,56,66,-10,50
East Fife,9360,6,14,3,19,49,65,-16,45
Airdrieon,9360,7,10,12,14,46,59,-13,42
Forfar,9360,8,10,6,20,39,65,-26,36
Albion,9360,9,8,6,22,57,81,-24,30
Queen's Park,9360,10,6,10,20,40,74,-34,28
Raith,9361,1,23,8,5,69,32,37,77
Ayr,9361,2,24,4,8,97,44,53,76
Arbroath,9361,3,18,8,10,74,48,26,62
Alloa,9361,4,17,8,11,56,44,12,59
Stranraer,9361,5,16,5,15,58,65,-7,53
Airdrieon,9361,6,11,11,14,49,60,-11,44
East Fife,9361,7,13,3,20,48,67,-19,42
Forfar,9361,8,10,5,21,40,68,-28,35
Albion,9361,9,8,6,22,59,85,-26,30
Queen's Park,9361,10,6,10,20,39,76,-37,28
Raith,9362,1,23,8,5,70,33,37,77
Ayr,9362,2,24,4,8,98,43,55,76
Arbroath,9362,3,17,9,10,70,48,22,60
Alloa,9362,4,17,8,11,57,45,12,59
Stranraer,9362,5,16,5,15,60,65,-5,53
Airdrieon,9362,6,11,11,14,47,58,-11,44
East Fife,9362,7,13,3,20,48,69,-21,42
Forfar,9362,8,10,5,21,38,66,-28,35
Albion,9362,9,8,6,22,58,86,-28,30
Queen's Park,9362,10,6,11,19,39,72,-33,29
Ayr,9363,1,24,4,8,92,43,49,76
Raith,9363,2,22,9,5,70,34,36,75
Arbroath,9363,3,18,8,10,71,48,23,62
Alloa,9363,4,17,9,10,58,45,13,60
Stranraer,9363,5,15,5,16,55,65,-10,50
East Fife,9363,6,14,3,19,48,64,-16,45
Airdrieon,9363,7,11,11,14,48,59,-11,44
Forfar,9363,8,10,5,21,39,67,-28,35
Albion,9363,9,8,6,22,58,80,-22,30
Queen's Park,9363,10,6,10,20,39,73,-34,28
Raith,9364,1,23,8,5,70,32,38,77
Ayr,9364,2,24,4,8,91,42,49,76
Arbroath,9364,3,18,8,10,73,50,23,62
Alloa,9364,4,17,8,11,56,45,11,59
Stranraer,9364,5,15,5,16,56,68,-12,50
East Fife,9364,6,14,3,19,51,65,-14,45
Airdrieon,9364,7,11,11,14,47,59,-12,44
Forfar,9364,8,10,5,21,39,66,-27,35
Albion,9364,9,8,6,22,57,79,-22,30
Queen's Park,9364,10,6,10,20,41,75,-34,28
Ayr,9365,1,24,4,8,97,42,55,76
Raith,9365,2,22,9,5,69,33,36,75
Alloa,9365,3,17,9,10,57,44,13,60
Arbroath,9365,4,17,8,11,70,52,18,59
Stranraer,9365,5,15,5,16,55,66,-11,50
East Fife,9365,6,14,3,19,49,64,-15,45
Airdrieon,9365,7,10,12,14,46,59,-13,42
Forfar,9365,8,10,6,20,39,65,-26,36
Queen's Park,9365,9,7,10,19,43,72,-29,31
Albion,9365,10,8,6,22,57,85,-28,30
Raith,9366,1,23,8,5,71,33,38,77
Ayr,9366,2,24,4,8,92,43,49,76
Arbroath,9366,3,18,8,10,72,48,24,62
Alloa,9366,4,17,8,11,57,46,11,59
Stranraer,9366,5,16,5,15,56,64,-8,53
Airdrieon,9366,6,11,11,14,46,58,-12,44
East Fife,9366,7,13,3,20,47,65,-18,42
Forfar,9366,8,10,5,21,38,65,-27,35
Albion,9366,9,8,6,22,58,80,-22,30
Queen's Park,9366,10,6,10,20,39,74,-35,28
Ayr,9367,1,24,4,8,94,43,51,76
Raith,9367,2,22,9,5,69,33,36,75
Arbroath,9367,3,18,8,10,72,49,23,62
Alloa,9367,4,17,9,10,57,44,13,60
Stranraer,9367,5,15,5,16,55,66,-11,50
East Fife,9367,6,14,3,19,49,64,-15,45
Airdrieon,9367,7,11,11,14,48,58,-10,44
Forfar,9367,8,10,5,21,38,67,-29,35
Albion,9367,9,8,6,22,58,82,-24,30
Queen's Park,9367,10,6,10,20,40,74,-34,28
Raith,9368,1,22,9,5,69,33,36,75
Ayr,9368,2,23,4,9,90,44,46,73
Arbroath,9368,3,17,9,10,72,50,22,60
Alloa,9368,4,17,9,10,57,44,13,60
Stranraer,9368,5,16,5,15,56,64,-8,53
Airdrieon,9368,6,11,11,14,48,58,-10,44
East Fife,9368,7,13,3,20,47,65,-18,42
Forfar,9368,8,10,5,21,38,67,-29,35
Albion,9368,9,9,6,21,59,78,-19,33
Queen's Park,9368,10,6,11,19,41,74,-33,29
Raith,9369,1,23,8,5,69,32,37,77
Ayr,9369,2,24,4,8,95,42,53,76
Arbroath,9369,3,18,8,10,73,49,24,62
Alloa,9369,4,17,8,11,56,44,12,59
Stranraer,9369,5,15,5,16,57,67,-10,50
East Fife,9369,6,14,3,19,50,66,-16,45
Airdrieon,9369,7,11,11,14,50,60,-10,44
Forfar,9369,8,10,5,21,40,69,-29,35
Albion,9369,9,8,6,22,57,83,-26,30
Queen's Park,9369,10,6,10,20,40,75,-35,28
Ayr,9370,1,24,4,8,94,42,52,76
Raith,9370,2,22,9,5,68,32,36,75
Arbroath,9370,3,18,8,10,72,48,24,62
Alloa,9370,4,17,9,10,56,43,13,60
Stranraer,9370,5,15,5,16,56,66,-10,50
East Fife,9370,6,14,3,19,49,65,-16,45
Airdrieon,9370,7,11,11,14,46,58,-12,44
Forfar,9370,8,10,5,21,38,65,-27,35
Albion,9370,9,8,6,22,57,82,-25,30
Queen's Park,9370,10,6,10,20,39,74,-35,28
Ayr,9371,1,24,4,8,93,44,49,76
Raith,9371,2,22,8,6,70,35,35,74
Alloa,9371,3,18,8,10,59,45,14,62
Arbroath,9371,4,17,9,10,72,50,22,60
Stranraer,9371,5,16,5,15,56,64,-8,53
Airdrieon,9371,6,11,11,14,46,58,-12,44
East Fife,9371,7,13,3,20,47,65,-18,42
Forfar,9371,8,10,5,21,38,65,-27,35
Albion,9371,9,8,6,22,59,81,-22,30
Queen's Park,9371,10,6,11,19,41,74,-33,29
Ayr,9372,1,24,4,8,94,42,52,76
Raith,9372,2,22,8,6,69,34,35,74
Alloa,9372,3,18,8,10,58,44,14,62
Arbroath,9372,4,17,9,10,71,49,22,60
Stranraer,9372,5,15,5,16,55,65,-10,50
East Fife,9372,6,14,3,19,48,64,-16,45
Airdrieon,9372,7,10,12,14,45,58,-13,42
Forfar,9372,8,10,6,20,38,64,-26,36
Albion,9372,9,8,6,22,57,82,-25,30
Queen's Park,9372,10,6,11,19,40,73,-33,29
Ayr,9373,1,24,4,8,92,42,50,76
Raith,9373,2,22,8,6,68,33,35,74
Alloa,9373,3,18,8,10,57,43,14,62
Arbroath,9373,4,17,9,10,71,49,22,60
Stranraer,9373,5,15,5,16,56,69,-13,50
East Fife,9373,6,14,3,19,52,65,-13,45
Airdrieon,9373,7,10,12,14,47,60,-13,42
Forfar,9373,8,10,6,20,40,66,-26,36
Albion,9373,9,8,6,22,57,80,-23,30
Queen's Park,9373,10,6,11,19,40,73,-33,29
Raith,9374,1,23,8,5,69,32,37,77
Ayr,9374,2,24,4,8,94,42,52,76
Arbroath,9374,3,18,8,10,72,49,23,62
Alloa,9374,4,17,8,11,56,44,12,59
Stranraer,9374,5,15,5,16,55,65,-10,50
East Fife,9374,6,14,3,19,48,64,-16,45
Airdrieon,9374,7,10,12,14,47,60,-13,42
Forfar,9374,8,10,6,20,40,66,-26,36
Albion,9374,9,8,6,22,57,82,-25,30
Queen's Park,9374,10,6,10,20,40,74,-34,28
Raith,9375,1,23,8,5,69,32,37,77
Ayr,9375,2,24,4,8,94,43,51,76
Arbroath,9375,3,17,8,11,71,50,21,59
Alloa,9375,4,17,8,11,56,44,12,59
Stranraer,9375,5,15,6,15,57,66,-9,51
Airdrieon,9375,6,11,11,14,47,58,-11,44
East Fife,9375,7,13,4,19,49,66,-17,43
Forfar,9375,8,10,5,21,38,66,-28,35
Queen's Park,9375,9,7,10,19,41,73,-32,31
Albion,9375,10,8,6,22,58,82,-24,30
Ayr,9376,1,24,4,8,92,42,50,76
Raith,9376,2,22,9,5,69,33,36,75
Alloa,9376,3,17,9,10,57,44,13,60
Arbroath,9376,4,17,8,11,70,50,20,59
Stranraer,9376,5,15,6,15,56,65,-9,51
Airdrieon,9376,6,11,11,14,49,58,-9,44
East Fife,9376,7,13,4,19,48,65,-17,43
Forfar,9376,8,10,5,21,38,68,-30,35
Queen's Park,9376,9,7,10,19,41,72,-31,31
Albion,9376,10,8,6,22,57,80,-23,30
Ayr,9377,1,24,4,8,93,42,51,76
Raith,9377,2,22,8,6,68,34,34,74
Arbroath,9377,3,18,8,10,72,49,23,62
Alloa,9377,4,18,8,10,58,43,15,62
Stranraer,9377,5,16,5,15,56,64,-8,53
Airdrieon,9377,6,11,11,14,47,58,-11,44
East Fife,9377,7,13,3,20,47,65,-18,42
Forfar,9377,8,10,5,21,38,66,-28,35
Albion,9377,9,8,6,22,57,81,-24,30
Queen's Park,9377,10,6,10,20,40,74,-34,28
Ayr,9378,1,24,4,8,92,43,49,76
Raith,9378,2,22,9,5,68,32,36,75
Arbroath,9378,3,18,8,10,73,50,23,62
Alloa,9378,4,17,9,10,56,43,13,60
Stranraer,9378,5,15,5,16,55,65,-10,50
East Fife,9378,6,14,3,19,48,64,-16,45
Airdrieon,9378,7,10,11,15,45,60,-15,41
Forfar,9378,8,11,5,20,40,64,-24,38
Albion,9378,9,8,6,22,58,80,-22,30
Queen's Park,9378,10,6,10,20,41,75,-34,28
Ayr,9379,1,24,4,8,92,42,50,76
Raith,9379,2,22,8,6,69,34,35,74
Arbroath,9379,3,18,8,10,71,48,23,62
Alloa,9379,4,18,8,10,58,44,14,62
Stranraer,9379,5,15,6,15,57,66,-9,51
Airdrieon,9379,6,11,11,14,50,59,-9,44
East Fife,9379,7,13,4,19,49,66,-17,43
Forfar,9379,8,10,5,21,39,69,-30,35
Albion,9379,9,8,6,22,57,80,-23,30
Queen's Park,9379,10,6,10,20,39,73,-34,28
Raith,9380,1,22,9,5,68,32,36,75
Ayr,9380,2,23,5,8,93,45,48,74
Arbroath,9380,3,17,9,10,73,51,22,60
Alloa,9380,4,17,9,10,56,43,13,60
Stranraer,9380,5,16,5,15,59,66,-7,53
East Fife,9380,6,13,3,20,49,68,-19,42
Airdrieon,9380,7,10,11,15,45,59,-14,41
Forfar,9380,8,11,5,20,39,64,-25,38
Albion,9380,9,8,7,21,60,81,-21,31
Queen's Park,9380,10,6,11,19,42,75,-33,29
Raith,9381,1,23,8,5,72,35,37,77
Ayr,9381,2,24,4,8,95,42,53,76
Arbroath,9381,3,17,8,11,71,52,19,59
Alloa,9381,4,17,8,11,59,47,12,59
Stranraer,9381,5,15,5,16,57,67,-10,50
East Fife,9381,6,14,3,19,50,66,-16,45
Airdrieon,9381,7,11,11,14,47,59,-12,44
Forfar,9381,8,10,5,21,39,66,-27,35
Queen's Park,9381,9,7,10,19,43,73,-30,31
Albion,9381,10,8,6,22,57,83,-26,30
Ayr,9382,1,24,4,8,96,42,54,76
Raith,9382,2,22,8,6,69,34,35,74
Alloa,9382,3,18,8,10,58,44,14,62
Arbroath,9382,4,17,8,11,70,49,21,59
Stranraer,9382,5,15,6,15,55,64,-9,51
Airdrieon,9382,6,11,11,14,47,58,-11,44
East Fife,9382,7,13,4,19,47,64,-17,43
Forfar,9382,8,10,5,21,38,66,-28,35
Queen's Park,9382,9,7,10,19,40,72,-32,31
Albion,9382,10,8,6,22,57,84,-27,30
Ayr,9383,1,24,4,8,95,43,52,76
Raith,9383,2,22,9,5,68,32,36,75
Arbroath,9383,3,18,8,10,72,49,23,62
Alloa,9383,4,17,9,10,56,43,13,60
Stranraer,9383,5,15,5,16,57,67,-10,50
East Fife,9383,6,14,3,19,50,66,-16,45
Airdrieon,9383,7,10,11,15,45,59,-14,41
Forfar,9383,8,11,5,20,39,64,-25,38
Albion,9383,9,8,6,22,58,83,-25,30
Queen's Park,9383,10,6,10,20,40,74,-34,28
Raith,9384,1,23,8,5,70,32,38,77
Ayr,9384,2,23,5,8,92,44,48,74
Arbroath,9384,3,18,8,10,72,49,23,62
Alloa,9384,4,17,8,11,56,45,11,59
Stranraer,9384,5,15,5,16,56,66,-10,50
East Fife,9384,6,14,3,19,49,65,-16,45
Airdrieon,9384,7,10,11,15,46,61,-15,41
Forfar,9384,8,11,5,20,41,65,-24,38
Albion,9384,9,8,7,21,59,80,-21,31
Queen's Park,9384,10,6,10,20,40,74,-34,28
Raith,9385,1,23,8,5,70,32,38,77
Ayr,9385,2,24,4,8,93,43,50,76
Arbroath,9385,3,18,8,10,74,49,25,62
Alloa,9385,4,17,8,11,56,45,11,59
Stranraer,9385,5,15,5,16,56,67,-11,50
East Fife,9385,6,14,3,19,50,65,-15,45
Airdrieon,9385,7,10,12,14,45,58,-13,42
Forfar,9385,8,10,6,20,38,64,-26,36
Albion,9385,9,8,6,22,58,81,-23,30
Queen's Park,9385,10,6,10,20,40,76,-36,28
Raith,9386,1,23,8,5,70,32,38,77
Ayr,9386,2,24,4,8,98,43,55,76
Arbroath,9386,3,17,9,10,72,50,22,60
Alloa,9386,4,17,8,11,56,45,11,59
Stranraer,9386,5,15,5,16,55,68,-13,50
East Fife,9386,6,14,3,19,51,64,-13,45
Airdrieon,9386,7,10,12,14,47,60,-13,42
Forfar,9386,8,10,6,20,40,66,-26,36
Albion,9386,9,8,6,22,58,86,-28,30
Queen's Park,9386,10,6,11,19,41,74,-33,29
Ayr,9387,1,24,4,8,97,44,53,76
Raith,9387,2,22,8,6,70,36,34,74
Arbroath,9387,3,18,8,10,74,50,24,62
Alloa,9387,4,18,8,10,60,45,15,62
Stranraer,9387,5,16,5,15,57,65,-8,53
Airdrieon,9387,6,11,11,14,46,58,-12,44
East Fife,9387,7,13,3,20,48,66,-18,42
Forfar,9387,8,10,5,21,38,65,-27,35
Albion,9387,9,8,6,22,59,85,-26,30
Queen's Park,9387,10,6,10,20,41,76,-35,28
Raith,9388,1,23,8,5,70,33,37,77
Ayr,9388,2,24,4,8,93,43,50,76
Arbroath,9388,3,18,8,10,75,50,25,62
Alloa,9388,4,17,8,11,57,45,12,59
Stranraer,9388,5,15,5,16,56,66,-10,50
East Fife,9388,6,14,3,19,49,65,-16,45
Airdrieon,9388,7,11,11,14,48,60,-12,44
Forfar,9388,8,10,5,21,40,67,-27,35
Albion,9388,9,8,6,22,58,81,-23,30
Queen's Park,9388,10,6,10,20,41,77,-36,28
Raith,9389,1,23,8,5,70,33,37,77
Ayr,9389,2,24,4,8,92,43,49,76
Arbroath,9389,3,18,8,10,72,48,24,62
Alloa,9389,4,17,8,11,57,45,12,59
Stranraer,9389,5,15,5,16,56,66,-10,50
East Fife,9389,6,14,3,19,49,65,-16,45
Airdrieon,9389,7,10,11,15,46,60,-14,41
Forfar,9389,8,11,5,20,40,65,-25,38
Albion,9389,9,8,6,22,58,80,-22,30
Queen's Park,9389,10,6,10,20,39,74,-35,28
Raith,9390,1,23,8,5,73,32,41,77
Ayr,9390,2,24,4,8,92,43,49,76
Arbroath,9390,3,17,8,11,70,51,19,59
Alloa,9390,4,17,8,11,56,48,8,59
Stranraer,9390,5,15,5,16,55,65,-10,50
East Fife,9390,6,14,3,19,48,64,-16,45
Airdrieon,9390,7,10,11,15,46,61,-15,41
Forfar,9390,8,11,5,20,41,65,-24,38
Queen's Park,9390,9,7,10,19,42,72,-30,31
Albion,9390,10,8,6,22,58,80,-22,30
Raith,9391,1,22,9,5,69,33,36,75
Ayr,9391,2,23,5,8,93,45,48,74
Arbroath,9391,3,17,9,10,70,48,22,60
Alloa,9391,4,17,9,10,57,44,13,60
Stranraer,9391,5,15,5,16,56,68,-12,50
East Fife,9391,6,14,3,19,51,65,-14,45
Airdrieon,9391,7,11,11,14,48,58,-10,44
Forfar,9391,8,10,5,21,38,67,-29,35
Albion,9391,9,8,7,21,60,81,-21,31
Queen's Park,9391,10,6,11,19,39,72,-33,29
Ayr,9392,1,24,4,8,95,44,51,76
Raith,9392,2,22,8,6,68,35,33,74
Arbroath,9392,3,18,8,10,72,49,23,62
Alloa,9392,4,18,8,10,59,43,16,62
Stranraer,9392,5,16,5,15,58,66,-8,53
East Fife,9392,6,13,3,20,49,67,-18,42
Airdrieon,9392,7,10,11,15,45,59,-14,41
Forfar,9392,8,11,5,20,39,64,-25,38
Albion,9392,9,8,6,22,59,83,-24,30
Queen's Park,9392,10,6,10,20,40,74,-34,28
Ayr,9393,1,24,4,8,94,43,51,76
Raith,9393,2,22,9,5,69,33,36,75
Alloa,9393,3,17,9,10,57,44,13,60
Arbroath,9393,4,17,8,11,70,52,18,59
Stranraer,9393,5,15,5,16,56,68,-12,50
East Fife,9393,6,14,3,19,51,65,-14,45
Airdrieon,9393,7,10,11,15,45,59,-14,41
Forfar,9393,8,11,5,20,39,64,-25,38
Queen's Park,9393,9,7,10,19,43,72,-29,31
Albion,9393,10,8,6,22,58,82,-24,30
Ayr,9394,1,24,4,8,92,43,49,76
Raith,9394,2,22,8,6,68,35,33,74
Arbroath,9394,3,18,8,10,72,48,24,62
Alloa,9394,4,18,8,10,59,43,16,62
Stranraer,9394,5,15,6,15,56,65,-9,51
East Fife,9394,6,13,4,19,48,65,-17,43
Airdrieon,9394,7,10,11,15,45,61,-16,41
Forfar,9394,8,11,5,20,41,64,-23,38
Albion,9394,9,8,6,22,58,80,-22,30
Queen's Park,9394,10,6,10,20,39,74,-35,28
Raith,9395,1,23,8,5,71,33,38,77
Ayr,9395,2,24,4,8,92,42,50,76
Arbroath,9395,3,18,8,10,73,48,25,62
Alloa,9395,4,17,8,11,57,46,11,59
Stranraer,9395,5,15,5,16,55,65,-10,50
East Fife,9395,6,14,3,19,48,64,-16,45
Airdrieon,9395,7,10,12,14,49,62,-13,42
Forfar,9395,8,10,6,20,42,68,-26,36
Albion,9395,9,8,6,22,57,80,-23,30
Queen's Park,9395,10,6,10,20,39,75,-36,28
Raith,9396,1,23,8,5,70,33,37,77
Ayr,9396,2,23,5,8,90,42,48,74
Arbroath,9396,3,18,8,10,73,48,25,62
Alloa,9396,4,17,8,11,57,45,12,59
Stranraer,9396,5,15,5,16,56,68,-12,50
East Fife,9396,6,14,3,19,51,65,-14,45
Airdrieon,9396,7,10,12,14,46,59,-13,42
Forfar,9396,8,10,6,20,39,65,-26,36
Albion,9396,9,8,7,21,57,78,-21,31
Queen's Park,9396,10,6,10,20,39,75,-36,28
Ayr,9397,1,24,4,8,93,42,51,76
Raith,9397,2,22,9,5,68,32,36,75
Arbroath,9397,3,18,8,10,74,51,23,62
Alloa,9397,4,17,9,10,56,43,13,60
Stranraer,9397,5,16,5,15,57,64,-7,53
Airdrieon,9397,6,10,12,14,48,61,-13,42
East Fife,9397,7,13,3,20,47,66,-19,42
Forfar,9397,8,10,6,20,41,67,-26,36
Albion,9397,9,8,6,22,57,81,-24,30
Queen's Park,9397,10,6,10,20,42,76,-34,28
Ayr,9398,1,24,4,8,93,43,50,76
Raith,9398,2,22,9,5,70,34,36,75
Arbroath,9398,3,18,8,10,72,48,24,62
Alloa,9398,4,17,9,10,58,45,13,60
Stranraer,9398,5,15,5,16,55,67,-12,50
East Fife,9398,6,14,3,19,50,64,-14,45
Airdrieon,9398,7,10,12,14,46,59,-13,42
Forfar,9398,8,10,6,20,39,65,-26,36
Albion,9398,9,8,6,22,58,81,-23,30
Queen's Park,9398,10,6,10,20,39,74,-35,28
Raith,9399,1,23,8,5,70,32,38,77
Ayr,9399,2,24,4,8,92,42,50,76
Arbroath,9399,3,18,8,10,72,48,24,62
Alloa,9399,4,17,8,11,56,45,11,59
Stranraer,9399,5,16,5,15,58,65,-7,53
Airdrieon,9399,6,10,12,14,46,59,-13,42
East Fife,9399,7,13,3,20,48,67,-19,42
Forfar,9399,8,10,6,20,39,65,-26,36
Albion,9399,9,8,6,22,57,80,-23,30
Queen's Park,9399,10,6,10,20,39,74,-35,28
Raith,9400,1,23,8,5,72,34,38,77
Ayr,9400,2,24,4,8,96,43,53,76
Arbroath,9400,3,18,8,10,72,49,23,62
Alloa,9400,4,17,8,11,58,47,11,59
Stranraer,9400,5,16,5,15,58,65,-7,53
Airdrieon,9400,6,11,11,14,46,58,-12,44
East Fife,9400,7,13,3,20,48,67,-19,42
Forfar,9400,8,10,5,21,38,65,-27,35
Albion,9400,9,8,6,22,58,84,-26,30
Queen's Park,9400,10,6,10,20,40,74,-34,28
Raith,9401,1,23,8,5,70,32,38,77
Ayr,9401,2,24,4,8,96,44,52,76
Arbroath,9401,3,17,8,11,72,51,21,59
Alloa,9401,4,17,8,11,56,45,11,59
Stranraer,9401,5,16,5,15,57,64,-7,53
Airdrieon,9401,6,11,11,14,47,58,-11,44
East Fife,9401,7,13,3,20,47,66,-19,42
Forfar,9401,8,10,5,21,38,66,-28,35
Queen's Park,9401,9,7,10,19,42,74,-32,31
Albion,9401,10,8,6,22,59,84,-25,30
Ayr,9402,1,24,4,8,93,43,50,76
Raith,9402,2,22,8,6,69,34,35,74
Alloa,9402,3,18,8,10,58,44,14,62
Arbroath,9402,4,17,8,11,71,50,21,59
Stranraer,9402,5,15,5,16,56,66,-10,50
East Fife,9402,6,14,3,19,49,65,-16,45
Airdrieon,9402,7,11,11,14,51,59,-8,44
Forfar,9402,8,10,5,21,39,70,-31,35
Queen's Park,9402,9,7,10,19,41,73,-32,31
Albion,9402,10,8,6,22,58,81,-23,30
Raith,9403,1,23,8,5,71,32,39,77
Ayr,9403,2,24,4,8,94,43,51,76
Arbroath,9403,3,18,8,10,72,49,23,62
Alloa,9403,4,17,8,11,56,46,10,59
Stranraer,9403,5,15,5,16,57,68,-11,50
East Fife,9403,6,14,3,19,51,66,-15,45
Airdrieon,9403,7,11,11,14,46,58,-12,44
Forfar,9403,8,10,5,21,38,65,-27,35
Albion,9403,9,8,6,22,58,82,-24,30
Queen's Park,9403,10,6,10,20,40,74,-34,28
Ayr,9404,1,24,4,8,93,42,51,76
Raith,9404,2,22,9,5,68,32,36,75
Arbroath,9404,3,18,8,10,75,49,26,62
Alloa,9404,4,17,9,10,56,43,13,60
Stranraer,9404,5,15,5,16,56,68,-12,50
East Fife,9404,6,14,3,19,51,65,-14,45
Airdrieon,9404,7,11,11,14,46,58,-12,44
Forfar,9404,8,10,5,21,38,65,-27,35
Albion,9404,9,8,6,22,57,81,-24,30
Queen's Park,9404,10,6,10,20,40,77,-37,28
Ayr,9405,1,24,4,8,94,42,52,76
Raith,9405,2,22,8,6,68,33,35,74
Alloa,9405,3,18,8,10,57,43,14,62
Arbroath,9405,4,17,8,11,70,54,16,59
Stranraer,9405,5,16,5,15,59,66,-7,53
Airdrieon,9405,6,10,12,14,46,59,-13,42
East Fife,9405,7,13,3,20,49,68,-19,42
Forfar,9405,8,10,6,20,39,65,-26,36
Queen's Park,9405,9,7,10,19,45,72,-27,31
Albion,9405,10,8,6,22,57,82,-25,30
Raith,9406,1,23,8,5,71,33,38,77
Ayr,9406,2,24,4,8,94,44,50,76
Arbroath,9406,3,18,8,10,73,49,24,62
Alloa,9406,4,17,8,11,57,46,11,59
Stranraer,9406,5,15,5,16,56,66,-10,50
East Fife,9406,6,14,3,19,49,65,-16,45
Airdrieon,9406,7,10,12,14,46,59,-13,42
Forfar,9406,8,10,6,20,39,65,-26,36
Albion,9406,9,8,6,22,59,82,-23,30
Queen's Park,9406,10,6,10,20,40,75,-35,28
Ayr,9407,1,24,4,8,92,43,49,76
Raith,9407,2,22,9,5,68,32,36,75
Arbroath,9407,3,18,8,10,72,49,23,62
Alloa,9407,4,17,9,10,56,43,13,60
Stranraer,9407,5,15,6,15,57,66,-9,51
East Fife,9407,6,13,4,19,49,66,-17,43
Airdrieon,9407,7,10,12,14,48,61,-13,42
Forfar,9407,8,10,6,20,41,67,-26,36
Albion,9407,9,8,6,22,58,80,-22,30
Queen's Park,9407,10,6,10,20,40,74,-34,28
Ayr,9408,1,24,4,8,93,43,50,76
Raith,9408,2,22,8,6,70,36,34,74
Arbroath,9408,3,18,8,10,74,49,25,62
Alloa,9408,4,18,8,10,60,45,15,62
Stranraer,9408,5,15,6,15,55,64,-9,51
East Fife,9408,6,13,4,19,47,64,-17,43
Airdrieon,9408,7,10,11,15,45,59,-14,41
Forfar,9408,8,11,5,20,39,64,-25,38
Albion,9408,9,8,6,22,58,81,-23,30
Queen's Park,9408,10,6,10,20,40,76,-36,28
Raith,9409,1,23,8,5,72,32,40,77
Ayr,9409,2,24,4,8,93,43,50,76
Arbroath,9409,3,17,9,10,71,49,22,60
Alloa,9409,4,17,8,11,56,47,9,59
Stranraer,9409,5,15,6,15,56,65,-9,51
Airdrieon,9409,6,11,11,14,47,58,-11,44
East Fife,9409,7,13,4,19,48,65,-17,43
Forfar,9409,8,10,5,21,38,66,-28,35
Albion,9409,9,8,6,22,58,81,-23,30
Queen's Park,9409,10,6,11,19,40,73,-33,29
Raith,9410,1,23,8,5,71,33,38,77
Ayr,9410,2,24,4,8,91,42,49,76
Arbroath,9410,3,18,8,10,72,48,24,62
Alloa,9410,4,17,8,11,57,46,11,59
Stranraer,9410,5,16,5,15,58,64,-6,53
Airdrieon,9410,6,11,11,14,48,58,-10,44
East Fife,9410,7,13,3,20,47,67,-20,42
Forfar,9410,8,10,5,21,38,67,-29,35
Albion,9410,9,8,6,22,57,79,-22,30
Queen's Park,9410,10,6,10,20,39,74,-35,28
Raith,9411,1,23,8,5,69,32,37,77
Ayr,9411,2,24,4,8,95,46,49,76
Arbroath,9411,3,18,8,10,73,49,24,62
Alloa,9411,4,17,8,11,56,44,12,59
Stranraer,9411,5,16,5,15,57,64,-7,53
Airdrieon,9411,6,10,12,14,47,60,-13,42
East Fife,9411,7,13,3,20,47,66,-19,42
Forfar,9411,8,10,6,20,40,66,-26,36
Albion,9411,9,8,6,22,61,83,-22,30
Queen's Park,9411,10,6,10,20,40,75,-35,28
Raith,9412,1,23,8,5,72,32,40,77
Ayr,9412,2,24,4,8,94,43,51,76
Arbroath,9412,3,18,8,10,73,49,24,62
Alloa,9412,4,17,8,11,56,47,9,59
Stranraer,9412,5,15,5,16,55,65,-10,50
East Fife,9412,6,14,3,19,48,64,-16,45
Airdrieon,9412,7,10,12,14,46,59,-13,42
Forfar,9412,8,10,6,20,39,65,-26,36
Albion,9412,9,8,6,22,58,82,-24,30
Queen's Park,9412,10,6,10,20,40,75,-35,28
Raith,9413,1,23,8,5,70,33,37,77
Ayr,9413,2,24,4,8,92,42,50,76
Arbroath,9413,3,17,9,10,72,50,22,60
Alloa,9413,4,17,8,11,57,45,12,59
Stranraer,9413,5,15,5,16,55,65,-10,50
East Fife,9413,6,14,3,19,48,64,-16,45
Airdrieon,9413,7,10,11,15,46,60,-14,41
Forfar,9413,8,11,5,20,40,65,-25,38
Albion,9413,9,8,6,22,57,80,-23,30
Queen's Park,9413,10,6,11,19,41,74,-33,29
Raith,9414,1,23,8,5,72,33,39,77
Ayr,9414,2,24,4,8,95,42,53,76
Arbroath,9414,3,17,8,11,71,50,21,59
Alloa,9414,4,17,8,11,57,47,10,59
Stranraer,9414,5,15,5,16,55,65,-10,50
East Fife,9414,6,14,3,19,48,64,-16,45
Airdrieon,9414,7,10,12,14,46,59,-13,42
Forfar,9414,8,10,6,20,39,65,-26,36
Queen's Park,9414,9,7,10,19,41,73,-32,31
Albion,9414,10,8,6,22,57,83,-26,30
Ayr,9415,1,24,4,8,98,42,56,76
Raith,9415,2,22,9,5,68,32,36,75
Arbroath,9415,3,18,8,10,71,48,23,62
Alloa,9415,4,17,9,10,56,43,13,60
Stranraer,9415,5,15,5,16,56,68,-12,50
East Fife,9415,6,14,3,19,51,65,-14,45
Airdrieon,9415,7,10,11,15,47,61,-14,41
Forfar,9415,8,11,5,20,41,66,-25,38
Albion,9415,9,8,6,22,57,86,-29,30
Queen's Park,9415,10,6,10,20,39,73,-34,28
Raith,9416,1,23,8,5,71,33,38,77
Ayr,9416,2,24,4,8,92,42,50,76
Arbroath,9416,3,18,8,10,71,48,23,62
Alloa,9416,4,17,8,11,57,46,11,59
Stranraer,9416,5,15,5,16,55,69,-14,50
East Fife,9416,6,14,3,19,52,64,-12,45
Airdrieon,9416,7,11,11,14,46,58,-12,44
Forfar,9416,8,10,5,21,38,65,-27,35
Albion,9416,9,8,6,22,57,80,-23,30
Queen's Park,9416,10,6,10,20,39,73,-34,28
Raith,9417,1,23,8,5,70,33,37,77
Ayr,9417,2,24,4,8,97,42,55,76
Arbroath,9417,3,18,8,10,72,49,23,62
Alloa,9417,4,17,8,11,57,45,12,59
Stranraer,9417,5,15,5,16,56,68,-12,50
East Fife,9417,6,14,3,19,51,65,-14,45
Airdrieon,9417,7,10,12,14,46,59,-13,42
Forfar,9417,8,10,6,20,39,65,-26,36
Albion,9417,9,8,6,22,57,85,-28,30
Queen's Park,9417,10,6,10,20,40,74,-34,28
Ayr,9418,1,24,4,8,95,42,53,76
Raith,9418,2,22,9,5,68,32,36,75
Arbroath,9418,3,17,9,10,72,50,22,60
Alloa,9418,4,17,9,10,56,43,13,60
Stranraer,9418,5,16,5,15,59,65,-6,53
Airdrieon,9418,6,11,11,14,47,59,-12,44
East Fife,9418,7,13,3,20,48,68,-20,42
Forfar,9418,8,10,5,21,39,66,-27,35
Albion,9418,9,8,6,22,57,83,-26,30
Queen's Park,9418,10,6,11,19,41,74,-33,29
Ayr,9419,1,24,4,8,94,44,50,76
Raith,9419,2,22,8,6,68,33,35,74
Arbroath,9419,3,18,8,10,71,48,23,62
Alloa,9419,4,18,8,10,57,43,14,62
Stranraer,9419,5,15,5,16,56,67,-11,50
East Fife,9419,6,14,3,19,50,65,-15,45
Airdrieon,9419,7,11,11,14,48,59,-11,44
Forfar,9419,8,10,5,21,39,67,-28,35
Albion,9419,9,8,6,22,59,82,-23,30
Queen's Park,9419,10,6,10,20,39,73,-34,28
Raith,9420,1,23,8,5,70,33,37,77
Ayr,9420,2,24,4,8,94,43,51,76
Arbroath,9420,3,18,8,10,72,48,24,62
Alloa,9420,4,17,8,11,57,45,12,59
Stranraer,9420,5,15,5,16,56,66,-10,50
East Fife,9420,6,14,3,19,49,65,-16,45
Airdrieon,9420,7,11,11,14,46,58,-12,44
Forfar,9420,8,10,5,21,38,65,-27,35
Albion,9420,9,8,6,22,58,82,-24,30
Queen's Park,9420,10,6,10,20,39,74,-35,28
Raith,9421,1,23,8,5,69,32,37,77
Ayr,9421,2,23,4,9,91,44,47,73
Arbroath,9421,3,17,9,10,70,48,22,60
Alloa,9421,4,17,8,11,56,44,12,59
Stranraer,9421,5,15,5,16,56,67,-11,50
East Fife,9421,6,14,3,19,50,65,-15,45
Airdrieon,9421,7,10,12,14,47,60,-13,42
Forfar,9421,8,10,6,20,40,66,-26,36
Albion,9421,9,9,6,21,59,79,-20,33
Queen's Park,9421,10,6,11,19,39,72,-33,29
Raith,9422,1,23,8,5,69,32,37,77
Ayr,9422,2,24,4,8,93,44,49,76
Arbroath,9422,3,17,8,11,70,49,21,59
Alloa,9422,4,17,8,11,56,44,12,59
Stranraer,9422,5,16,5,15,59,66,-7,53
Airdrieon,9422,6,11,11,14,48,59,-11,44
East Fife,9422,7,13,3,20,49,68,-19,42
Forfar,9422,8,10,5,21,39,67,-28,35
Queen's Park,9422,9,7,10,19,40,72,-32,31
Albion,9422,10,8,6,22,59,81,-22,30
Ayr,9423,1,24,4,8,93,42,51,76
Raith,9423,2,22,8,6,68,33,35,74
Alloa,9423,3,18,8,10,57,43,14,62
Arbroath,9423,4,17,8,11,70,49,21,59
Stranraer,9423,5,16,5,15,60,65,-5,53
Airdrieon,9423,6,11,11,14,46,58,-12,44
East Fife,9423,7,13,3,20,48,69,-21,42
Forfar,9423,8,10,5,21,38,65,-27,35
Queen's Park,9423,9,7,10,19,40,72,-32,31
Albion,9423,10,8,6,22,57,81,-24,30
Raith,9424,1,23,8,5,70,33,37,77
Ayr,9424,2,24,4,8,92,43,49,76
Arbroath,9424,3,17,8,11,72,51,21,59
Alloa,9424,4,17,8,11,57,45,12,59
Stranraer,9424,5,15,5,16,55,65,-10,50
East Fife,9424,6,14,3,19,48,64,-16,45
Airdrieon,9424,7,10,12,14,46,59,-13,42
Forfar,9424,8,10,6,20,39,65,-26,36
Queen's Park,9424,9,7,10,19,42,74,-32,31
Albion,9424,10,8,6,22,58,80,-22,30
Ayr,9425,1,24,4,8,93,42,51,76
Raith,9425,2,22,9,5,68,32,36,75
Arbroath,9425,3,18,8,10,75,51,24,62
Alloa,9425,4,17,9,10,56,43,13,60
Stranraer,9425,5,16,5,15,57,65,-8,53
Airdrieon,9425,6,11,11,14,48,59,-11,44
East Fife,9425,7,13,3,20,48,66,-18,42
Forfar,9425,8,10,5,21,39,67,-28,35
Albion,9425,9,8,6,22,57,81,-24,30
Queen's Park,9425,10,6,10,20,42,77,-35,28
Ayr,9426,1,24,4,8,95,44,51,76
Raith,9426,2,22,9,5,69,33,36,75
Arbroath,9426,3,18,8,10,72,48,24,62
Alloa,9426,4,17,9,10,57,44,13,60
Stranraer,9426,5,16,5,15,56,64,-8,53
Airdrieon,9426,6,10,12,14,45,58,-13,42
East Fife,9426,7,13,3,20,47,65,-18,42
Forfar,9426,8,10,6,20,38,64,-26,36
Albion,9426,9,8,6,22,59,83,-24,30
Queen's Park,9426,10,6,10,20,39,74,-35,28
Ayr,9427,1,24,4,8,94,42,52,76
Raith,9427,2,22,8,6,69,34,35,74
Alloa,9427,3,18,8,10,58,44,14,62
Arbroath,9427,4,17,8,11,72,52,20,59
Stranraer,9427,5,16,5,15,57,65,-8,53
Airdrieon,9427,6,11,11,14,49,61,-12,44
East Fife,9427,7,13,3,20,48,66,-18,42
Forfar,9427,8,10,5,21,41,68,-27,35
Queen's Park,9427,9,7,10,19,43,74,-31,31
Albion,9427,10,8,6,22,57,82,-25,30
Ayr,9428,1,24,4,8,97,45,52,76
Raith,9428,2,22,8,6,69,34,35,74
Arbroath,9428,3,18,8,10,74,48,26,62
Alloa,9428,4,18,8,10,58,44,14,62
Stranraer,9428,5,16,5,15,59,65,-6,53
Airdrieon,9428,6,11,11,14,47,59,-12,44
East Fife,9428,7,13,3,20,48,68,-20,42
Forfar,9428,8,10,5,21,39,66,-27,35
Albion,9428,9,8,6,22,60,85,-25,30
Queen's Park,9428,10,6,10,20,39,76,-37,28
Raith,9429,1,23,8,5,75,33,42,77
Ayr,9429,2,24,4,8,95,44,51,76
Arbroath,9429,3,17,9,10,71,49,22,60
Alloa,9429,4,17,8,11,57,50,7,59
Stranraer,9429,5,15,5,16,55,67,-12,50
East Fife,9429,6,14,3,19,50,64,-14,45
Airdrieon,9429,7,11,11,14,46,58,-12,44
Forfar,9429,8,10,5,21,38,65,-27,35
Albion,9429,9,8,6,22,59,83,-24,30
Queen's Park,9429,10,6,11,19,40,73,-33,29
Ayr,9430,1,24,4,8,95,43,52,76
Raith,9430,2,22,8,6,68,33,35,74
Alloa,9430,3,18,8,10,57,43,14,62
Arbroath,9430,4,17,9,10,72,50,22,60
Stranraer,9430,5,16,5,15,58,66,-8,53
Airdrieon,9430,6,11,11,14,46,58,-12,44
East Fife,9430,7,13,3,20,49,67,-18,42
Forfar,9430,8,10,5,21,38,65,-27,35
Albion,9430,9,8,6,22,58,83,-25,30
Queen's Park,9430,10,6,11,19,41,74,-33,29
Raith,9431,1,22,8,6,68,33,35,74
Ayr,9431,2,23,4,9,92,45,47,73
Arbroath,9431,3,18,8,10,71,48,23,62
Alloa,9431,4,18,8,10,57,43,14,62
Stranraer,9431,5,15,5,16,55,66,-11,50
East Fife,9431,6,14,3,19,49,64,-15,45
Airdrieon,9431,7,11,11,14,46,58,-12,44
Forfar,9431,8,10,5,21,38,65,-27,35
Albion,9431,9,9,6,21,60,80,-20,33
Queen's Park,9431,10,6,10,20,39,73,-34,28
Ayr,9432,1,24,4,8,94,43,51,76
Raith,9432,2,22,9,5,70,34,36,75
Alloa,9432,3,17,9,10,58,45,13,60
Arbroath,9432,4,17,8,11,71,50,21,59
Stranraer,9432,5,16,5,15,57,65,-8,53
Airdrieon,9432,6,11,11,14,47,58,-11,44
East Fife,9432,7,13,3,20,48,66,-18,42
Forfar,9432,8,10,5,21,38,66,-28,35
Queen's Park,9432,9,7,10,19,41,73,-32,31
Albion,9432,10,8,6,22,58,82,-24,30
Raith,9433,1,23,8,5,71,34,37,77
Ayr,9433,2,24,4,8,94,43,51,76
Arbroath,9433,3,18,8,10,73,49,24,62
Alloa,9433,4,17,8,11,58,46,12,59
Stranraer,9433,5,16,5,15,57,65,-8,53
Airdrieon,9433,6,11,11,14,48,59,-11,44
East Fife,9433,7,13,3,20,48,66,-18,42
Forfar,9433,8,10,5,21,39,67,-28,35
Albion,9433,9,8,6,22,58,82,-24,30
Queen's Park,9433,10,6,10,20,40,75,-35,28
Raith,9434,1,23,8,5,69,32,37,77
Ayr,9434,2,24,4,8,92,42,50,76
Arbroath,9434,3,17,9,10,72,50,22,60
Alloa,9434,4,17,8,11,56,44,12,59
Stranraer,9434,5,15,5,16,56,66,-10,50
East Fife,9434,6,14,3,19,49,65,-16,45
Airdrieon,9434,7,11,11,14,46,58,-12,44
Forfar,9434,8,10,5,21,38,65,-27,35
Albion,9434,9,8,6,22,57,80,-23,30
Queen's Park,9434,10,6,11,19,41,74,-33,29
Raith,9435,1,23,8,5,69,32,37,77
Ayr,9435,2,24,4,8,94,43,51,76
Arbroath,9435,3,18,8,10,72,48,24,62
Alloa,9435,4,17,8,11,56,44,12,59
Stranraer,9435,5,15,6,15,56,65,-9,51
East Fife,9435,6,13,4,19,48,65,-17,43
Airdrieon,9435,7,10,11,15,46,60,-14,41
Forfar,9435,8,11,5,20,40,65,-25,38
Albion,9435,9,8,6,22,58,82,-24,30
Queen's Park,9435,10,6,10,20,39,74,-35,28
Ayr,9436,1,23,5,8,91,43,48,74
Raith,9436,2,22,8,6,69,36,33,74
Alloa,9436,3,18,8,10,60,44,16,62
Arbroath,9436,4,17,9,10,70,48,22,60
Stranraer,9436,5,15,5,16,56,66,-10,50
East Fife,9436,6,14,3,19,49,65,-16,45
Airdrieon,9436,7,11,11,14,47,59,-12,44
Forfar,9436,8,10,5,21,39,66,-27,35
Albion,9436,9,8,7,21,58,79,-21,31
Queen's Park,9436,10,6,11,19,39,72,-33,29
Ayr,9437,1,24,4,8,93,44,49,76
Raith,9437,2,22,9,5,69,33,36,75
Arbroath,9437,3,18,8,10,72,49,23,62
Alloa,9437,4,17,9,10,57,44,13,60
Stranraer,9437,5,16,5,15,58,66,-8,53
Airdrieon,9437,6,11,11,14,50,61,-11,44
East Fife,9437,7,13,3,20,49,67,-18,42
Forfar,9437,8,10,5,21,41,69,-28,35
Albion,9437,9,8,6,22,59,81,-22,30
Queen's Park,9437,10,6,10,20,40,74,-34,28
Raith,9438,1,23,8,5,69,32,37,77
Ayr,9438,2,23,5,8,92,44,48,74
Arbroath,9438,3,18,8,10,73,48,25,62
Alloa,9438,4,17,8,11,56,44,12,59
Stranraer,9438,5,15,6,15,56,65,-9,51
East Fife,9438,6,13,4,19,48,65,-17,43
Airdrieon,9438,7,10,11,15,46,60,-14,41
Forfar,9438,8,11,5,20,40,65,-25,38
Albion,9438,9,8,7,21,59,80,-21,31
Queen's Park,9438,10,6,10,20,39,75,-36,28
Raith,9439,1,23,8,5,71,33,38,77
Ayr,9439,2,24,4,8,93,43,50,76
Arbroath,9439,3,18,8,10,72,49,23,62
Alloa,9439,4,17,8,11,57,46,11,59
Stranraer,9439,5,16,5,15,57,65,-8,53
Airdrieon,9439,6,11,11,14,48,59,-11,44
East Fife,9439,7,13,3,20,48,66,-18,42
Forfar,9439,8,10,5,21,39,67,-28,35
Albion,9439,9,8,6,22,58,81,-23,30
Queen's Park,9439,10,6,10,20,40,74,-34,28
Raith,9440,1,23,8,5,69,32,37,77
Ayr,9440,2,24,4,8,93,44,49,76
Arbroath,9440,3,18,8,10,74,49,25,62
Alloa,9440,4,17,8,11,56,44,12,59
Stranraer,9440,5,16,5,15,57,65,-8,53
Airdrieon,9440,6,10,12,14,45,58,-13,42
East Fife,9440,7,13,3,20,48,66,-18,42
Forfar,9440,8,10,6,20,38,64,-26,36
Albion,9440,9,8,6,22,59,81,-22,30
Queen's Park,9440,10,6,10,20,40,76,-36,28
Raith,9441,1,22,9,5,68,32,36,75
Ayr,9441,2,23,5,8,92,44,48,74
Arbroath,9441,3,18,8,10,73,49,24,62
Alloa,9441,4,17,9,10,56,43,13,60
Stranraer,9441,5,15,5,16,55,67,-12,50
East Fife,9441,6,14,3,19,50,64,-14,45
Airdrieon,9441,7,11,11,14,48,58,-10,44
Forfar,9441,8,10,5,21,38,67,-29,35
Albion,9441,9,8,7,21,59,80,-21,31
Queen's Park,9441,10,6,10,20,40,75,-35,28
Raith,9442,1,23,8,5,70,32,38,77
Ayr,9442,2,24,4,8,93,42,51,76
Arbroath,9442,3,18,8,10,72,49,23,62
Alloa,9442,4,17,8,11,56,45,11,59
Stranraer,9442,5,15,6,15,56,65,-9,51
Airdrieon,9442,6,11,11,14,46,58,-12,44
East Fife,9442,7,13,4,19,48,65,-17,43
Forfar,9442,8,10,5,21,38,65,-27,35
Albion,9442,9,8,6,22,57,81,-24,30
Queen's Park,9442,10,6,10,20,40,74,-34,28
Raith,9443,1,23,8,5,70,33,37,77
Ayr,9443,2,23,5,8,91,43,48,74
Arbroath,9443,3,18,8,10,71,48,23,62
Alloa,9443,4,17,8,11,57,45,12,59
Stranraer,9443,5,15,6,15,57,66,-9,51
East Fife,9443,6,13,4,19,49,66,-17,43
Airdrieon,9443,7,10,11,15,45,59,-14,41
Forfar,9443,8,11,5,20,39,64,-25,38
Albion,9443,9,8,7,21,58,79,-21,31
Queen's Park,9443,10,6,10,20,39,73,-34,28
Raith,9444,1,23,8,5,71,33,38,77
Ayr,9444,2,23,5,8,92,44,48,74
Arbroath,9444,3,17,8,11,71,50,21,59
Alloa,9444,4,17,8,11,57,46,11,59
Stranraer,9444,5,16,5,15,62,65,-3,53
Airdrieon,9444,6,11,11,14,48,59,-11,44
East Fife,9444,7,13,3,20,48,71,-23,42
Forfar,9444,8,10,5,21,39,67,-28,35
Albion,9444,9,8,7,21,59,80,-21,31
Queen's Park,9444,10,7,10,19,41,73,-32,31
Ayr,9445,1,24,4,8,93,43,50,76
Raith,9445,2,22,8,6,68,34,34,74
Alloa,9445,3,18,8,10,58,43,15,62
Arbroath,9445,4,17,9,10,72,50,22,60
Stranraer,9445,5,15,5,16,56,67,-11,50
East Fife,9445,6,14,3,19,50,65,-15,45
Airdrieon,9445,7,10,12,14,46,59,-13,42
Forfar,9445,8,10,6,20,39,65,-26,36
Albion,9445,9,8,6,22,58,81,-23,30
Queen's Park,9445,10,6,11,19,41,74,-33,29
Ayr,9446,1,24,4,8,96,44,52,76
Raith,9446,2,22,8,6,71,36,35,74
Alloa,9446,3,18,8,10,60,46,14,62
Arbroath,9446,4,17,9,10,70,48,22,60
Stranraer,9446,5,15,6,15,56,65,-9,51
East Fife,9446,6,13,4,19,48,65,-17,43
Airdrieon,9446,7,10,11,15,47,61,-14,41
Forfar,9446,8,11,5,20,41,66,-25,38
Albion,9446,9,8,6,22,59,84,-25,30
Queen's Park,9446,10,6,11,19,39,72,-33,29
Ayr,9447,1,24,4,8,93,44,49,76
Raith,9447,2,22,8,6,68,34,34,74
Arbroath,9447,3,18,8,10,73,49,24,62
Alloa,9447,4,18,8,10,58,43,15,62
Stranraer,9447,5,15,6,15,58,67,-9,51
Airdrieon,9447,6,11,11,14,48,58,-10,44
East Fife,9447,7,13,4,19,50,67,-17,43
Forfar,9447,8,10,5,21,38,67,-29,35
Albion,9447,9,8,6,22,59,81,-22,30
Queen's Park,9447,10,6,10,20,40,75,-35,28
Raith,9448,1,23,8,5,69,32,37,77
Ayr,9448,2,24,4,8,94,43,51,76
Arbroath,9448,3,18,8,10,72,49,23,62
Alloa,9448,4,17,8,11,56,44,12,59
Stranraer,9448,5,15,5,16,56,66,-10,50
East Fife,9448,6,14,3,19,49,65,-16,45
Airdrieon,9448,7,10,12,14,45,58,-13,42
Forfar,9448,8,10,6,20,38,64,-26,36
Albion,9448,9,8,6,22,58,82,-24,30
Queen's Park,9448,10,6,10,20,40,74,-34,28
Raith,9449,1,23,8,5,70,32,38,77
Ayr,9449,2,24,4,8,93,44,49,76
Arbroath,9449,3,17,9,10,70,48,22,60
Alloa,9449,4,17,8,11,56,45,11,59
Stranraer,9449,5,15,5,16,56,66,-10,50
East Fife,9449,6,14,3,19,49,65,-16,45
Airdrieon,9449,7,10,12,14,48,61,-13,42
Forfar,9449,8,10,6,20,41,67,-26,36
Albion,9449,9,8,6,22,59,81,-22,30
Queen's Park,9449,10,6,11,19,39,72,-33,29
Ayr,9450,1,24,4,8,93,43,50,76
Raith,9450,2,22,9,5,69,33,36,75
Arbroath,9450,3,18,8,10,74,50,24,62
Alloa,9450,4,17,9,10,57,44,13,60
Stranraer,9450,5,15,5,16,55,66,-11,50
East Fife,9450,6,14,3,19,49,64,-15,45
Airdrieon,9450,7,10,11,15,46,60,-14,41
Forfar,9450,8,11,5,20,40,65,-25,38
Albion,9450,9,8,6,22,58,81,-23,30
Queen's Park,9450,10,6,10,20,41,76,-35,28
Raith,9451,1,23,8,5,71,33,38,77
Ayr,9451,2,23,5,8,92,44,48,74
Arbroath,9451,3,17,8,11,71,50,21,59
Alloa,9451,4,17,8,11,57,46,11,59
Stranraer,9451,5,15,5,16,55,65,-10,50
East Fife,9451,6,14,3,19,48,64,-16,45
Airdrieon,9451,7,11,11,14,49,59,-10,44
Forfar,9451,8,10,5,21,39,68,-29,35
Albion,9451,9,8,7,21,59,80,-21,31
Queen's Park,9451,10,7,10,19,41,73,-32,31
Ayr,9452,1,24,4,8,94,42,52,76
Raith,9452,2,22,9,5,69,33,36,75
Alloa,9452,3,17,9,10,57,44,13,60
Arbroath,9452,4,17,8,11,70,49,21,59
Stranraer,9452,5,15,6,15,57,66,-9,51
Airdrieon,9452,6,11,11,14,47,59,-12,44
East Fife,9452,7,13,4,19,49,66,-17,43
Forfar,9452,8,10,5,21,39,66,-27,35
Queen's Park,9452,9,7,10,19,40,72,-32,31
Albion,9452,10,8,6,22,57,82,-25,30
Raith,9453,1,23,8,5,70,32,38,77
Ayr,9453,2,24,4,8,93,44,49,76
Arbroath,9453,3,17,9,10,71,49,22,60
Alloa,9453,4,17,8,11,56,45,11,59
Stranraer,9453,5,16,5,15,57,65,-8,53
Airdrieon,9453,6,11,11,14,47,58,-11,44
East Fife,9453,7,13,3,20,48,66,-18,42
Forfar,9453,8,10,5,21,38,66,-28,35
Albion,9453,9,8,6,22,59,81,-22,30
Queen's Park,9453,10,6,11,19,40,73,-33,29
Ayr,9454,1,24,4,8,91,42,49,76
Raith,9454,2,22,9,5,69,33,36,75
Arbroath,9454,3,17,9,10,71,49,22,60
Alloa,9454,4,17,9,10,57,44,13,60
Stranraer,9454,5,16,5,15,59,66,-7,53
East Fife,9454,6,13,3,20,49,68,-19,42
Airdrieon,9454,7,10,11,15,47,62,-15,41
Forfar,9454,8,11,5,20,42,66,-24,38
Albion,9454,9,8,6,22,57,79,-22,30
Queen's Park,9454,10,6,11,19,40,73,-33,29
Ayr,9455,1,24,4,8,95,42,53,76
Raith,9455,2,22,9,5,69,33,36,75
Arbroath,9455,3,18,8,10,72,48,24,62
Alloa,9455,4,17,9,10,57,44,13,60
Stranraer,9455,5,16,5,15,58,66,-8,53
Airdrieon,9455,6,11,11,14,48,59,-11,44
East Fife,9455,7,13,3,20,49,67,-18,42
Forfar,9455,8,10,5,21,39,67,-28,35
Albion,9455,9,8,6,22,57,83,-26,30
Queen's Park,9455,10,6,10,20,39,74,-35,28
Ayr,9456,1,24,4,8,93,42,51,76
Raith,9456,2,22,9,5,70,34,36,75
Arbroath,9456,3,18,8,10,73,48,25,62
Alloa,9456,4,17,9,10,58,45,13,60
Stranraer,9456,5,15,6,15,56,65,-9,51
East Fife,9456,6,13,4,19,48,65,-17,43
Airdrieon,9456,7,10,12,14,46,59,-13,42
Forfar,9456,8,10,6,20,39,65,-26,36
Albion,9456,9,8,6,22,57,81,-24,30
Queen's Park,9456,10,6,10,20,39,75,-36,28
Raith,9457,1,23,8,5,71,33,38,77
Ayr,9457,2,23,5,8,93,45,48,74
Arbroath,9457,3,18,8,10,73,48,25,62
Alloa,9457,4,17,8,11,57,46,11,59
Stranraer,9457,5,16,5,15,57,65,-8,53
Airdrieon,9457,6,11,11,14,49,59,-10,44
East Fife,9457,7,13,3,20,48,66,-18,42
Forfar,9457,8,10,5,21,39,68,-29,35
Albion,9457,9,8,7,21,60,81,-21,31
Queen's Park,9457,10,6,10,20,39,75,-36,28
Ayr,9458,1,24,4,8,92,43,49,76
Raith,9458,2,22,9,5,69,33,36,75
Arbroath,9458,3,18,8,10,72,48,24,62
Alloa,9458,4,17,9,10,57,44,13,60
Stranraer,9458,5,15,5,16,56,67,-11,50
East Fife,9458,6,14,3,19,50,65,-15,45
Airdrieon,9458,7,11,11,14,47,59,-12,44
Forfar,9458,8,10,5,21,39,66,-27,35
Albion,9458,9,8,6,22,58,80,-22,30
Queen's Park,9458,10,6,10,20,39,74,-35,28
Raith,9459,1,23,8,5,70,32,38,77
Ayr,9459,2,24,4,8,93,43,50,76
Arbroath,9459,3,18,8,10,71,48,23,62
Alloa,9459,4,17,8,11,56,45,11,59
Stranraer,9459,5,15,5,16,56,67,-11,50
East Fife,9459,6,14,3,19,50,65,-15,45
Airdrieon,9459,7,11,11,14,46,58,-12,44
Forfar,9459,8,10,5,21,38,65,-27,35
Albion,9459,9,8,6,22,58,81,-23,30
Queen's Park,9459,10,6,10,20,39,73,-34,28
Ayr,9460,1,24,4,8,94,43,51,76
Raith,9460,2,22,8,6,68,34,34,74
Alloa,9460,3,18,8,10,58,43,15,62
Arbroath,9460,4,17,9,10,72,50,22,60
Stranraer,9460,5,15,5,16,56,67,-11,50
East Fife,9460,6,14,3,19,50,65,-15,45
Airdrieon,9460,7,11,11,14,50,58,-8,44
Forfar,9460,8,10,5,21,38,69,-31,35
Albion,9460,9,8,6,22,58,82,-24,30
Queen's Park,9460,10,6,11,19,41,74,-33,29
Ayr,9461,1,24,4,8,91,42,49,76
Raith,9461,2,22,8,6,69,34,35,74
Arbroath,9461,3,18,8,10,73,49,24,62
Alloa,9461,4,18,8,10,58,44,14,62
Stranraer,9461,5,15,5,16,57,68,-11,50
East Fife,9461,6,14,3,19,51,66,-15,45
Airdrieon,9461,7,10,11,15,45,60,-15,41
Forfar,9461,8,11,5,20,40,64,-24,38
Albion,9461,9,8,6,22,57,79,-22,30
Queen's Park,9461,10,6,10,20,40,75,-35,28
Raith,9462,1,23,8,5,69,32,37,77
Ayr,9462,2,23,5,8,91,43,48,74
Arbroath,9462,3,18,8,10,71,48,23,62
Alloa,9462,4,17,8,11,56,44,12,59
Stranraer,9462,5,15,6,15,57,66,-9,51
Airdrieon,9462,6,11,11,14,47,59,-12,44
East Fife,9462,7,13,4,19,49,66,-17,43
Forfar,9462,8,10,5,21,39,66,-27,35
Albion,9462,9,8,7,21,58,79,-21,31
Queen's Park,9462,10,6,10,20,39,73,-34,28
Raith,9463,1,23,8,5,70,32,38,77
Ayr,9463,2,23,5,8,91,43,48,74
Arbroath,9463,3,18,8,10,72,49,23,62
Alloa,9463,4,17,8,11,56,45,11,59
Stranraer,9463,5,15,5,16,56,66,-10,50
East Fife,9463,6,14,3,19,49,65,-16,45
Airdrieon,9463,7,11,11,14,51,60,-9,44
Forfar,9463,8,10,5,21,40,70,-30,35
Albion,9463,9,8,7,21,58,79,-21,31
Queen's Park,9463,10,6,10,20,40,74,-34,28
Ayr,9464,1,24,4,8,96,44,52,76
Raith,9464,2,22,8,6,71,37,34,74
Alloa,9464,3,18,8,10,61,46,15,62
Arbroath,9464,4,17,8,11,70,50,20,59
Stranraer,9464,5,15,5,16,56,69,-13,50
East Fife,9464,6,14,3,19,52,65,-13,45
Airdrieon,9464,7,10,11,15,46,61,-15,41
Forfar,9464,8,11,5,20,41,65,-24,38
Queen's Park,9464,9,7,10,19,41,72,-31,31
Albion,9464,10,8,6,22,59,84,-25,30
Raith,9465,1,23,8,5,69,32,37,77
Ayr,9465,2,24,4,8,95,42,53,76
Arbroath,9465,3,18,8,10,73,49,24,62
Alloa,9465,4,17,8,11,56,44,12,59
Stranraer,9465,5,15,6,15,56,65,-9,51
Airdrieon,9465,6,11,11,14,49,58,-9,44
East Fife,9465,7,13,4,19,48,65,-17,43
Forfar,9465,8,10,5,21,38,68,-30,35
Albion,9465,9,8,6,22,57,83,-26,30
Queen's Park,9465,10,6,10,20,40,75,-35,28
Raith,9466,1,23,8,5,70,33,37,77
Ayr,9466,2,23,5,8,92,44,48,74
Arbroath,9466,3,17,9,10,70,48,22,60
Alloa,9466,4,17,8,11,57,45,12,59
Stranraer,9466,5,15,5,16,58,69,-11,50
East Fife,9466,6,14,3,19,52,67,-15,45
Airdrieon,9466,7,10,11,15,45,59,-14,41
Forfar,9466,8,11,5,20,39,64,-25,38
Albion,9466,9,8,7,21,59,80,-21,31
Queen's Park,9466,10,6,11,19,39,72,-33,29
Raith,9467,1,23,8,5,71,34,37,77
Ayr,9467,2,23,5,8,98,50,48,74
Arbroath,9467,3,17,8,11,71,51,20,59
Alloa,9467,4,17,8,11,58,46,12,59
Stranraer,9467,5,15,5,16,55,67,-12,50
East Fife,9467,6,14,3,19,50,64,-14,45
Airdrieon,9467,7,10,12,14,45,58,-13,42
Forfar,9467,8,10,6,20,38,64,-26,36
Albion,9467,9,8,7,21,65,86,-21,31
Queen's Park,9467,10,7,10,19,42,73,-31,31
Ayr,9468,1,24,4,8,96,44,52,76
Raith,9468,2,22,8,6,68,33,35,74
Arbroath,9468,3,18,8,10,71,48,23,62
Alloa,9468,4,18,8,10,57,43,14,62
Stranraer,9468,5,15,5,16,55,65,-10,50
East Fife,9468,6,14,3,19,48,64,-16,45
Airdrieon,9468,7,11,11,14,49,58,-9,44
Forfar,9468,8,10,5,21,38,68,-30,35
Albion,9468,9,8,6,22,59,84,-25,30
Queen's Park,9468,10,6,10,20,39,73,-34,28
Ayr,9469,1,24,4,8,95,42,53,76
Raith,9469,2,22,9,5,70,34,36,75
Arbroath,9469,3,17,9,10,72,50,22,60
Alloa,9469,4,17,9,10,58,45,13,60
Stranraer,9469,5,16,5,15,59,67,-8,53
Airdrieon,9469,6,11,11,14,48,60,-12,44
East Fife,9469,7,13,3,20,50,68,-18,42
Forfar,9469,8,10,5,21,40,67,-27,35
Albion,9469,9,8,6,22,57,83,-26,30
Queen's Park,9469,10,6,11,19,41,74,-33,29
Raith,9470,1,23,8,5,71,32,39,77
Ayr,9470,2,24,4,8,94,42,52,76
Arbroath,9470,3,18,8,10,75,50,25,62
Alloa,9470,4,17,8,11,56,46,10,59
Stranraer,9470,5,15,5,16,58,70,-12,50
East Fife,9470,6,14,3,19,53,67,-14,45
Airdrieon,9470,7,10,12,14,47,60,-13,42
Forfar,9470,8,10,6,20,40,66,-26,36
Albion,9470,9,8,6,22,57,82,-25,30
Queen's Park,9470,10,6,10,20,41,77,-36,28
Raith,9471,1,23,8,5,70,32,38,77
Ayr,9471,2,24,4,8,95,42,53,76
Arbroath,9471,3,18,8,10,72,49,23,62
Alloa,9471,4,17,8,11,56,45,11,59
Stranraer,9471,5,15,5,16,57,67,-10,50
East Fife,9471,6,14,3,19,50,66,-16,45
Airdrieon,9471,7,11,11,14,48,58,-10,44
Forfar,9471,8,10,5,21,38,67,-29,35
Albion,9471,9,8,6,22,57,83,-26,30
Queen's Park,9471,10,6,10,20,40,74,-34,28
Raith,9472,1,23,8,5,72,32,40,77
Ayr,9472,2,23,4,9,91,45,46,73
Arbroath,9472,3,18,8,10,74,48,26,62
Alloa,9472,4,17,8,11,56,47,9,59
Stranraer,9472,5,16,5,15,56,64,-8,53
Airdrieon,9472,6,11,11,14,49,60,-11,44
East Fife,9472,7,13,3,20,47,65,-18,42
Forfar,9472,8,10,5,21,40,68,-28,35
Albion,9472,9,9,6,21,60,79,-19,33
Queen's Park,9472,10,6,10,20,39,76,-37,28
Raith,9473,1,23,8,5,71,33,38,77
Ayr,9473,2,23,5,8,91,43,48,74
Arbroath,9473,3,18,8,10,73,48,25,62
Alloa,9473,4,17,8,11,57,46,11,59
Stranraer,9473,5,16,5,15,56,64,-8,53
Airdrieon,9473,6,11,11,14,47,59,-12,44
East Fife,9473,7,13,3,20,47,65,-18,42
Forfar,9473,8,10,5,21,39,66,-27,35
Albion,9473,9,8,7,21,58,79,-21,31
Queen's Park,9473,10,6,10,20,39,75,-36,28
Ayr,9474,1,24,4,8,95,42,53,76
Raith,9474,2,22,9,5,68,32,36,75
Arbroath,9474,3,18,8,10,71,48,23,62
Alloa,9474,4,17,9,10,56,43,13,60
Stranraer,9474,5,16,5,15,59,67,-8,53
Airdrieon,9474,6,11,11,14,46,58,-12,44
East Fife,9474,7,13,3,20,50,68,-18,42
Forfar,9474,8,10,5,21,38,65,-27,35
Albion,9474,9,8,6,22,57,83,-26,30
Queen's Park,9474,10,6,10,20,39,73,-34,28
Raith,9475,1,23,8,5,69,32,37,77
Ayr,9475,2,23,4,9,91,44,47,73
Arbroath,9475,3,17,8,11,72,51,21,59
Alloa,9475,4,17,8,11,56,44,12,59
Stranraer,9475,5,15,5,16,55,65,-10,50
East Fife,9475,6,14,3,19,48,64,-16,45
Airdrieon,9475,7,11,11,14,49,59,-10,44
Forfar,9475,8,10,5,21,39,68,-29,35
Albion,9475,9,9,6,21,59,79,-20,33
Queen's Park,9475,10,7,10,19,42,74,-32,31
Raith,9476,1,23,8,5,71,33,38,77
Ayr,9476,2,24,4,8,92,42,50,76
Arbroath,9476,3,18,8,10,72,49,23,62
Alloa,9476,4,17,8,11,57,46,11,59
Stranraer,9476,5,16,5,15,57,65,-8,53
Airdrieon,9476,6,10,12,14,46,59,-13,42
East Fife,9476,7,13,3,20,48,66,-18,42
Forfar,9476,8,10,6,20,39,65,-26,36
Albion,9476,9,8,6,22,57,80,-23,30
Queen's Park,9476,10,6,10,20,40,74,-34,28
Raith,9477,1,23,8,5,70,32,38,77
Ayr,9477,2,24,4,8,93,44,49,76
Arbroath,9477,3,18,8,10,73,48,25,62
Alloa,9477,4,17,8,11,56,45,11,59
Stranraer,9477,5,16,5,15,56,64,-8,53
East Fife,9477,6,13,3,20,47,65,-18,42
Airdrieon,9477,7,10,11,15,45,59,-14,41
Forfar,9477,8,11,5,20,39,64,-25,38
Albion,9477,9,8,6,22,59,81,-22,30
Queen's Park,9477,10,6,10,20,39,75,-36,28
Ayr,9478,1,24,4,8,94,44,50,76
Raith,9478,2,22,8,6,70,35,35,74
Alloa,9478,3,18,8,10,59,45,14,62
Arbroath,9478,4,17,8,11,71,52,19,59
Stranraer,9478,5,15,6,15,55,64,-9,51
East Fife,9478,6,13,4,19,47,64,-17,43
Airdrieon,9478,7,10,11,15,45,59,-14,41
Forfar,9478,8,11,5,20,39,64,-25,38
Queen's Park,9478,9,7,10,19,43,73,-30,31
Albion,9478,10,8,6,22,59,82,-23,30
Ayr,9479,1,24,4,8,95,43,52,76
Raith,9479,2,22,8,6,68,34,34,74
Alloa,9479,3,18,8,10,58,43,15,62
Arbroath,9479,4,17,8,11,71,52,19,59
Stranraer,9479,5,16,5,15,56,64,-8,53
Airdrieon,9479,6,11,11,14,48,58,-10,44
East Fife,9479,7,13,3,20,47,65,-18,42
Forfar,9479,8,10,5,21,38,67,-29,35
Queen's Park,9479,9,7,10,19,43,73,-30,31
Albion,9479,10,8,6,22,58,83,-25,30
Ayr,9480,1,24,4,8,95,43,52,76
Raith,9480,2,22,9,5,68,32,36,75
Arbroath,9480,3,18,8,10,73,49,24,62
Alloa,9480,4,17,9,10,56,43,13,60
Stranraer,9480,5,15,5,16,56,67,-11,50
East Fife,9480,6,14,3,19,50,65,-15,45
Airdrieon,9480,7,11,11,14,47,59,-12,44
Forfar,9480,8,10,5,21,39,66,-27,35
Albion,9480,9,8,6,22,58,83,-25,30
Queen's Park,9480,10,6,10,20,40,75,-35,28
Raith,9481,1,23,8,5,71,32,39,77
Ayr,9481,2,24,4,8,94,43,51,76
Arbroath,9481,3,18,8,10,73,50,23,62
Alloa,9481,4,17,8,11,56,46,10,59
Stranraer,9481,5,16,5,15,57,65,-8,53
Airdrieon,9481,6,11,11,14,46,58,-12,44
East Fife,9481,7,13,3,20,48,66,-18,42
Forfar,9481,8,10,5,21,38,65,-27,35
Albion,9481,9,8,6,22,58,82,-24,30
Queen's Park,9481,10,6,10,20,41,75,-34,28
Ayr,9482,1,24,4,8,92,43,49,76
Raith,9482,2,22,8,6,69,35,34,74
Alloa,9482,3,18,8,10,59,44,15,62
Arbroath,9482,4,17,9,10,71,49,22,60
Stranraer,9482,5,15,6,15,57,66,-9,51
Airdrieon,9482,6,11,11,14,48,59,-11,44
East Fife,9482,7,13,4,19,49,66,-17,43
Forfar,9482,8,10,5,21,39,67,-28,35
Albion,9482,9,8,6,22,58,80,-22,30
Queen's Park,9482,10,6,11,19,40,73,-33,29
Raith,9483,1,23,8,5,71,34,37,77
Ayr,9483,2,23,5,8,91,43,48,74
Arbroath,9483,3,17,8,11,70,49,21,59
Alloa,9483,4,17,8,11,58,46,12,59
Stranraer,9483,5,16,5,15,57,65,-8,53
East Fife,9483,6,13,3,20,48,66,-18,42
Airdrieon,9483,7,10,11,15,45,59,-14,41
Forfar,9483,8,11,5,20,39,64,-25,38
Albion,9483,9,8,7,21,58,79,-21,31
Queen's Park,9483,10,7,10,19,40,72,-32,31
Raith,9484,1,22,8,6,68,33,35,74
Ayr,9484,2,23,4,9,90,43,47,73
Arbroath,9484,3,18,8,10,73,50,23,62
Alloa,9484,4,18,8,10,57,43,14,62
Stranraer,9484,5,15,5,16,56,66,-10,50
East Fife,9484,6,14,3,19,49,65,-16,45
Airdrieon,9484,7,10,11,15,45,60,-15,41
Forfar,9484,8,11,5,20,40,64,-24,38
Albion,9484,9,9,6,21,58,78,-20,33
Queen's Park,9484,10,6,10,20,41,75,-34,28
Raith,9485,1,23,8,5,70,32,38,77
Ayr,9485,2,24,4,8,96,42,54,76
Arbroath,9485,3,17,8,11,70,51,19,59
Alloa,9485,4,17,8,11,56,45,11,59
Stranraer,9485,5,16,5,15,59,64,-5,53
Airdrieon,9485,6,11,11,14,48,60,-12,44
East Fife,9485,7,13,3,20,47,68,-21,42
Forfar,9485,8,10,5,21,40,67,-27,35
Queen's Park,9485,9,7,10,19,42,72,-30,31
Albion,9485,10,8,6,22,57,84,-27,30
Raith,9486,1,23,8,5,69,32,37,77
Ayr,9486,2,24,4,8,94,44,50,76
Arbroath,9486,3,17,9,10,72,50,22,60
Alloa,9486,4,17,8,11,56,44,12,59
Stranraer,9486,5,15,5,16,55,66,-11,50
East Fife,9486,6,14,3,19,49,64,-15,45
Airdrieon,9486,7,10,12,14,45,58,-13,42
Forfar,9486,8,10,6,20,38,64,-26,36
Albion,9486,9,8,6,22,59,82,-23,30
Queen's Park,9486,10,6,11,19,41,74,-33,29
Raith,9487,1,23,8,5,71,33,38,77
Ayr,9487,2,24,4,8,95,43,52,76
Arbroath,9487,3,17,9,10,73,51,22,60
Alloa,9487,4,17,8,11,57,46,11,59
Stranraer,9487,5,16,5,15,58,65,-7,53
Airdrieon,9487,6,10,12,14,45,58,-13,42
East Fife,9487,7,13,3,20,48,67,-19,42
Forfar,9487,8,10,6,20,38,64,-26,36
Albion,9487,9,8,6,22,58,83,-25,30
Queen's Park,9487,10,6,11,19,42,75,-33,29
Ayr,9488,1,24,4,8,94,43,51,76
Raith,9488,2,22,9,5,69,33,36,75
Arbroath,9488,3,18,8,10,73,48,25,62
Alloa,9488,4,17,9,10,57,44,13,60
Stranraer,9488,5,15,5,16,55,66,-11,50
East Fife,9488,6,14,3,19,49,64,-15,45
Airdrieon,9488,7,11,11,14,47,58,-11,44
Forfar,9488,8,10,5,21,38,66,-28,35
Albion,9488,9,8,6,22,58,82,-24,30
Queen's Park,9488,10,6,10,20,39,75,-36,28
Ayr,9489,1,24,4,8,94,43,51,76
Raith,9489,2,22,9,5,69,33,36,75
Arbroath,9489,3,18,8,10,73,50,23,62
Alloa,9489,4,17,9,10,57,44,13,60
Stranraer,9489,5,16,5,15,56,64,-8,53
Airdrieon,9489,6,10,12,14,45,58,-13,42
East Fife,9489,7,13,3,20,47,65,-18,42
Forfar,9489,8,10,6,20,38,64,-26,36
Albion,9489,9,8,6,22,58,82,-24,30
Queen's Park,9489,10,6,10,20,41,75,-34,28
Ayr,9490,1,24,4,8,94,42,52,76
Raith,9490,2,22,9,5,68,32,36,75
Arbroath,9490,3,18,8,10,74,50,24,62
Alloa,9490,4,17,9,10,56,43,13,60
Stranraer,9490,5,15,6,15,58,67,-9,51
East Fife,9490,6,13,4,19,50,67,-17,43
Airdrieon,9490,7,10,11,15,45,60,-15,41
Forfar,9490,8,11,5,20,40,64,-24,38
Albion,9490,9,8,6,22,57,82,-25,30
Queen's Park,9490,10,6,10,20,41,76,-35,28
Raith,9491,1,23,8,5,71,32,39,77
Ayr,9491,2,24,4,8,91,42,49,76
Arbroath,9491,3,17,9,10,71,49,22,60
Alloa,9491,4,17,8,11,56,46,10,59
Stranraer,9491,5,15,5,16,56,66,-10,50
East Fife,9491,6,14,3,19,49,65,-16,45
Airdrieon,9491,7,10,11,15,45,59,-14,41
Forfar,9491,8,11,5,20,39,64,-25,38
Albion,9491,9,8,6,22,57,79,-22,30
Queen's Park,9491,10,6,11,19,40,73,-33,29
Raith,9492,1,22,8,6,68,33,35,74
Ayr,9492,2,23,4,9,90,44,46,73
Alloa,9492,3,18,8,10,57,43,14,62
Arbroath,9492,4,17,8,11,71,51,20,59
Stranraer,9492,5,15,5,16,55,69,-14,50
East Fife,9492,6,14,3,19,52,64,-12,45
Airdrieon,9492,7,11,11,14,48,59,-11,44
Forfar,9492,8,10,5,21,39,67,-28,35
Albion,9492,9,9,6,21,59,78,-19,33
Queen's Park,9492,10,7,10,19,42,73,-31,31
Ayr,9493,1,24,4,8,93,43,50,76
Raith,9493,2,22,9,5,68,32,36,75
Arbroath,9493,3,17,9,10,70,48,22,60
Alloa,9493,4,17,9,10,56,43,13,60
Stranraer,9493,5,16,5,15,57,65,-8,53
East Fife,9493,6,13,3,20,48,66,-18,42
Airdrieon,9493,7,10,11,15,45,59,-14,41
Forfar,9493,8,11,5,20,39,64,-25,38
Albion,9493,9,8,6,22,58,81,-23,30
Queen's Park,9493,10,6,11,19,39,72,-33,29
Raith,9494,1,23,8,5,73,33,40,77
Ayr,9494,2,23,4,9,91,46,45,73
Arbroath,9494,3,18,8,10,73,50,23,62
Alloa,9494,4,17,8,11,57,48,9,59
Stranraer,9494,5,15,5,16,56,69,-13,50
East Fife,9494,6,14,3,19,52,65,-13,45
Airdrieon,9494,7,11,11,14,46,58,-12,44
Forfar,9494,8,10,5,21,38,65,-27,35
Albion,9494,9,9,6,21,61,79,-18,33
Queen's Park,9494,10,6,10,20,41,75,-34,28
Ayr,9495,1,24,4,8,93,43,50,76
Raith,9495,2,22,8,6,69,34,35,74
Arbroath,9495,3,18,8,10,72,48,24,62
Alloa,9495,4,18,8,10,58,44,14,62
Stranraer,9495,5,15,6,15,58,67,-9,51
Airdrieon,9495,6,11,11,14,48,60,-12,44
East Fife,9495,7,13,4,19,50,67,-17,43
Forfar,9495,8,10,5,21,40,67,-27,35
Albion,9495,9,8,6,22,58,81,-23,30
Queen's Park,9495,10,6,10,20,39,74,-35,28
Raith,9496,1,23,8,5,71,33,38,77
Ayr,9496,2,24,4,8,91,42,49,76
Arbroath,9496,3,17,9,10,71,49,22,60
Alloa,9496,4,17,8,11,57,46,11,59
Stranraer,9496,5,15,5,16,56,66,-10,50
East Fife,9496,6,14,3,19,49,65,-16,45
Airdrieon,9496,7,10,12,14,46,59,-13,42
Forfar,9496,8,10,6,20,39,65,-26,36
Albion,9496,9,8,6,22,57,79,-22,30
Queen's Park,9496,10,6,11,19,40,73,-33,29
Raith,9497,1,23,8,5,70,32,38,77
Ayr,9497,2,24,4,8,93,43,50,76
Arbroath,9497,3,18,8,10,71,48,23,62
Alloa,9497,4,17,8,11,56,45,11,59
Stranraer,9497,5,16,5,15,58,64,-6,53
East Fife,9497,6,13,3,20,47,67,-20,42
Airdrieon,9497,7,10,11,15,46,60,-14,41
Forfar,9497,8,11,5,20,40,65,-25,38
Albion,9497,9,8,6,22,58,81,-23,30
Queen's Park,9497,10,6,10,20,39,73,-34,28
Ayr,9498,1,24,4,8,94,43,51,76
Raith,9498,2,22,9,5,69,33,36,75
Alloa,9498,3,17,9,10,57,44,13,60
Arbroath,9498,4,17,8,11,72,51,21,59
Stranraer,9498,5,15,5,16,55,67,-12,50
East Fife,9498,6,14,3,19,50,64,-14,45
Airdrieon,9498,7,10,12,14,46,59,-13,42
Forfar,9498,8,10,6,20,39,65,-26,36
Queen's Park,9498,9,7,10,19,42,74,-32,31
Albion,9498,10,8,6,22,58,82,-24,30
Ayr,9499,1,24,4,8,95,43,52,76
Raith,9499,2,22,8,6,68,34,34,74
Arbroath,9499,3,18,8,10,74,48,26,62
Alloa,9499,4,18,8,10,58,43,15,62
Stranraer,9499,5,16,5,15,58,64,-6,53
East Fife,9499,6,13,3,20,47,67,-20,42
Airdrieon,9499,7,10,11,15,45,59,-14,41
Forfar,9499,8,11,5,20,39,64,-25,38
Albion,9499,9,8,6,22,58,83,-25,30
Queen's Park,9499,10,6,10,20,39,76,-37,28
Raith,9500,1,23,8,5,70,32,38,77
Ayr,9500,2,24,4,8,92,42,50,76
Arbroath,9500,3,17,9,10,72,50,22,60
Alloa,9500,4,17,8,11,56,45,11,59
Stranraer,9500,5,16,5,15,57,64,-7,53
East Fife,9500,6,13,3,20,47,66,-19,42
Airdrieon,9500,7,10,11,15,45,59,-14,41
Forfar,9500,8,11,5,20,39,64,-25,38
Albion,9500,9,8,6,22,57,80,-23,30
Queen's Park,9500,10,6,11,19,41,74,-33,29
Raith,9501,1,23,8,5,70,33,37,77
Ayr,9501,2,24,4,8,95,42,53,76
Arbroath,9501,3,17,9,10,71,49,22,60
Alloa,9501,4,17,8,11,57,45,12,59
Stranraer,9501,5,15,5,16,57,68,-11,50
East Fife,9501,6,14,3,19,51,66,-15,45
Airdrieon,9501,7,11,11,14,47,59,-12,44
Forfar,9501,8,10,5,21,39,66,-27,35
Albion,9501,9,8,6,22,57,83,-26,30
Queen's Park,9501,10,6,11,19,40,73,-33,29
Ayr,9502,1,24,4,8,95,42,53,76
Raith,9502,2,22,9,5,69,33,36,75
Arbroath,9502,3,17,9,10,72,50,22,60
Alloa,9502,4,17,9,10,57,44,13,60
Stranraer,9502,5,15,5,16,55,66,-11,50
East Fife,9502,6,14,3,19,49,64,-15,45
Airdrieon,9502,7,10,12,14,47,60,-13,42
Forfar,9502,8,10,6,20,40,66,-26,36
Albion,9502,9,8,6,22,57,83,-26,30
Queen's Park,9502,10,6,11,19,41,74,-33,29
Raith,9503,1,23,8,5,71,32,39,77
Ayr,9503,2,24,4,8,94,43,51,76
Arbroath,9503,3,18,8,10,72,48,24,62
Alloa,9503,4,17,8,11,56,46,10,59
Stranraer,9503,5,16,5,15,57,64,-7,53
East Fife,9503,6,13,3,20,47,66,-19,42
Airdrieon,9503,7,10,11,15,46,61,-15,41
Forfar,9503,8,11,5,20,41,65,-24,38
Albion,9503,9,8,6,22,58,82,-24,30
Queen's Park,9503,10,6,10,20,39,74,-35,28
Ayr,9504,1,24,4,8,94,43,51,76
Raith,9504,2,22,8,6,70,35,35,74
Alloa,9504,3,18,8,10,59,45,14,62
Arbroath,9504,4,17,8,11,70,50,20,59
Stranraer,9504,5,16,5,15,58,65,-7,53
Airdrieon,9504,6,10,12,14,46,59,-13,42
East Fife,9504,7,13,3,20,48,67,-19,42
Forfar,9504,8,10,6,20,39,65,-26,36
Queen's Park,9504,9,7,10,19,41,72,-31,31
Albion,9504,10,8,6,22,58,82,-24,30
Raith,9505,1,23,8,5,72,33,39,77
Ayr,9505,2,23,5,8,92,44,48,74
Arbroath,9505,3,17,9,10,72,50,22,60
Alloa,9505,4,17,8,11,57,47,10,59
Stranraer,9505,5,15,5,16,56,67,-11,50
East Fife,9505,6,14,3,19,50,65,-15,45
Airdrieon,9505,7,10,12,14,45,58,-13,42
Forfar,9505,8,10,6,20,38,64,-26,36
Albion,9505,9,8,7,21,59,80,-21,31
Queen's Park,9505,10,6,11,19,41,74,-33,29
Raith,9506,1,23,8,5,69,32,37,77
Ayr,9506,2,24,4,8,96,42,54,76
Arbroath,9506,3,18,8,10,71,48,23,62
Alloa,9506,4,17,8,11,56,44,12,59
Stranraer,9506,5,15,5,16,57,69,-12,50
East Fife,9506,6,14,3,19,52,66,-14,45
Airdrieon,9506,7,11,11,14,47,58,-11,44
Forfar,9506,8,10,5,21,38,66,-28,35
Albion,9506,9,8,6,22,57,84,-27,30
Queen's Park,9506,10,6,10,20,39,73,-34,28
Ayr,9507,1,24,4,8,98,47,51,76
Raith,9507,2,22,8,6,69,36,33,74
Alloa,9507,3,18,8,10,60,44,16,62
Arbroath,9507,4,17,8,11,70,50,20,59
Stranraer,9507,5,15,5,16,56,66,-10,50
East Fife,9507,6,14,3,19,49,65,-16,45
Airdrieon,9507,7,11,11,14,47,59,-12,44
Forfar,9507,8,10,5,21,39,66,-27,35
Queen's Park,9507,9,7,10,19,41,72,-31,31
Albion,9507,10,8,6,22,62,86,-24,30
Raith,9508,1,23,8,5,69,32,37,77
Ayr,9508,2,24,4,8,93,42,51,76
Arbroath,9508,3,17,8,11,70,50,20,59
Alloa,9508,4,17,8,11,56,44,12,59
Stranraer,9508,5,16,5,15,57,64,-7,53
Airdrieon,9508,6,10,12,14,45,58,-13,42
East Fife,9508,7,13,3,20,47,66,-19,42
Forfar,9508,8,10,6,20,38,64,-26,36
Queen's Park,9508,9,7,10,19,41,72,-31,31
Albion,9508,10,8,6,22,57,81,-24,30
Ayr,9509,1,23,5,8,92,44,48,74
Raith,9509,2,22,8,6,68,33,35,74
Alloa,9509,3,18,8,10,57,43,14,62
Arbroath,9509,4,17,8,11,70,51,19,59
Stranraer,9509,5,16,5,15,59,67,-8,53
Airdrieon,9509,6,11,11,14,47,59,-12,44
East Fife,9509,7,13,3,20,50,68,-18,42
Forfar,9509,8,10,5,21,39,66,-27,35
Albion,9509,9,8,7,21,59,80,-21,31
Queen's Park,9509,10,7,10,19,42,72,-30,31
Raith,9510,1,23,8,5,70,32,38,77
Ayr,9510,2,24,4,8,94,43,51,76
Arbroath,9510,3,17,8,11,71,50,21,59
Alloa,9510,4,17,8,11,56,45,11,59
Stranraer,9510,5,16,5,15,56,64,-8,53
Airdrieon,9510,6,11,11,14,48,59,-11,44
East Fife,9510,7,13,3,20,47,65,-18,42
Forfar,9510,8,10,5,21,39,67,-28,35
Queen's Park,9510,9,7,10,19,41,73,-32,31
Albion,9510,10,8,6,22,58,82,-24,30
Ayr,9511,1,24,4,8,98,42,56,76
Raith,9511,2,22,9,5,68,32,36,75
Alloa,9511,3,17,9,10,56,43,13,60
Arbroath,9511,4,17,8,11,70,53,17,59
Stranraer,9511,5,15,6,15,56,65,-9,51
East Fife,9511,6,13,4,19,48,65,-17,43
Airdrieon,9511,7,10,12,14,47,60,-13,42
Forfar,9511,8,10,6,20,40,66,-26,36
Queen's Park,9511,9,7,10,19,44,72,-28,31
Albion,9511,10,8,6,22,57,86,-29,30
Ayr,9512,1,24,4,8,92,43,49,76
Raith,9512,2,22,8,6,70,35,35,74
Arbroath,9512,3,18,8,10,75,49,26,62
Alloa,9512,4,18,8,10,59,45,14,62
Stranraer,9512,5,15,5,16,55,67,-12,50
East Fife,9512,6,14,3,19,50,64,-14,45
Airdrieon,9512,7,10,11,15,46,60,-14,41
Forfar,9512,8,11,5,20,40,65,-25,38
Albion,9512,9,8,6,22,58,80,-22,30
Queen's Park,9512,10,6,10,20,40,77,-37,28
Raith,9513,1,22,8,6,69,34,35,74
Ayr,9513,2,23,4,9,91,44,47,73
Alloa,9513,3,18,8,10,58,44,14,62
Arbroath,9513,4,17,8,11,71,50,21,59
Stranraer,9513,5,15,5,16,55,66,-11,50
East Fife,9513,6,14,3,19,49,64,-15,45
Airdrieon,9513,7,11,11,14,47,58,-11,44
Forfar,9513,8,10,5,21,38,66,-28,35
Albion,9513,9,9,6,21,59,79,-20,33
Queen's Park,9513,10,7,10,19,41,73,-32,31
Ayr,9514,1,24,4,8,92,42,50,76
Raith,9514,2,22,8,6,68,35,33,74
Arbroath,9514,3,18,8,10,71,48,23,62
Alloa,9514,4,18,8,10,59,43,16,62
Stranraer,9514,5,15,6,15,57,66,-9,51
East Fife,9514,6,13,4,19,49,66,-17,43
Airdrieon,9514,7,10,11,15,45,60,-15,41
Forfar,9514,8,11,5,20,40,64,-24,38
Albion,9514,9,8,6,22,57,80,-23,30
Queen's Park,9514,10,6,10,20,39,73,-34,28
Ayr,9515,1,24,4,8,93,43,50,76
Raith,9515,2,22,9,5,70,34,36,75
Arbroath,9515,3,18,8,10,73,48,25,62
Alloa,9515,4,17,9,10,58,45,13,60
Stranraer,9515,5,16,5,15,57,64,-7,53
Airdrieon,9515,6,11,11,14,47,58,-11,44
East Fife,9515,7,13,3,20,47,66,-19,42
Forfar,9515,8,10,5,21,38,66,-28,35
Albion,9515,9,8,6,22,58,81,-23,30
Queen's Park,9515,10,6,10,20,39,75,-36,28
Raith,9516,1,23,8,5,69,32,37,77
Ayr,9516,2,24,4,8,95,43,52,76
Arbroath,9516,3,17,9,10,71,49,22,60
Alloa,9516,4,17,8,11,56,44,12,59
Stranraer,9516,5,15,5,16,56,68,-12,50
East Fife,9516,6,14,3,19,51,65,-14,45
Airdrieon,9516,7,10,11,15,46,61,-15,41
Forfar,9516,8,11,5,20,41,65,-24,38
Albion,9516,9,8,6,22,58,83,-25,30
Queen's Park,9516,10,6,11,19,40,73,-33,29
Ayr,9517,1,24,4,8,97,42,55,76
Raith,9517,2,22,8,6,69,34,35,74
Arbroath,9517,3,18,8,10,71,48,23,62
Alloa,9517,4,18,8,10,58,44,14,62
Stranraer,9517,5,15,5,16,58,69,-11,50
East Fife,9517,6,14,3,19,52,67,-15,45
Airdrieon,9517,7,11,11,14,48,60,-12,44
Forfar,9517,8,10,5,21,40,67,-27,35
Albion,9517,9,8,6,22,57,85,-28,30
Queen's Park,9517,10,6,10,20,39,73,-34,28
Raith,9518,1,23,8,5,71,32,39,77
Ayr,9518,2,24,4,8,95,44,51,76
Arbroath,9518,3,17,8,11,72,51,21,59
Alloa,9518,4,17,8,11,56,46,10,59
Stranraer,9518,5,15,5,16,56,66,-10,50
East Fife,9518,6,14,3,19,49,65,-16,45
Airdrieon,9518,7,11,11,14,46,58,-12,44
Forfar,9518,8,10,5,21,38,65,-27,35
Queen's Park,9518,9,7,10,19,42,74,-32,31
Albion,9518,10,8,6,22,59,83,-24,30
Raith,9519,1,23,8,5,70,32,38,77
Ayr,9519,2,23,5,8,93,45,48,74
Arbroath,9519,3,18,8,10,75,48,27,62
Alloa,9519,4,17,8,11,56,45,11,59
Stranraer,9519,5,15,5,16,55,67,-12,50
East Fife,9519,6,14,3,19,50,64,-14,45
Airdrieon,9519,7,10,12,14,46,59,-13,42
Forfar,9519,8,10,6,20,39,65,-26,36
Albion,9519,9,8,7,21,60,81,-21,31
Queen's Park,9519,10,6,10,20,39,77,-38,28
Raith,9520,1,23,8,5,71,32,39,77
Ayr,9520,2,24,4,8,95,44,51,76
Arbroath,9520,3,17,8,11,72,51,21,59
Alloa,9520,4,17,8,11,56,46,10,59
Stranraer,9520,5,15,5,16,56,67,-11,50
East Fife,9520,6,14,3,19,50,65,-15,45
Airdrieon,9520,7,11,11,14,48,59,-11,44
Forfar,9520,8,10,5,21,39,67,-28,35
Queen's Park,9520,9,7,10,19,42,74,-32,31
Albion,9520,10,8,6,22,59,83,-24,30
Raith,9521,1,23,8,5,73,33,40,77
Ayr,9521,2,24,4,8,93,43,50,76
Arbroath,9521,3,18,8,10,71,48,23,62
Alloa,9521,4,17,8,11,57,48,9,59
Stranraer,9521,5,15,5,16,57,70,-13,50
East Fife,9521,6,14,3,19,53,66,-13,45
Airdrieon,9521,7,11,11,14,48,59,-11,44
Forfar,9521,8,10,5,21,39,67,-28,35
Albion,9521,9,8,6,22,58,81,-23,30
Queen's Park,9521,10,6,10,20,39,73,-34,28
Ayr,9522,1,24,4,8,97,46,51,76
Raith,9522,2,22,9,5,69,33,36,75
Arbroath,9522,3,18,8,10,72,48,24,62
Alloa,9522,4,17,9,10,57,44,13,60
Stranraer,9522,5,15,5,16,56,66,-10,50
East Fife,9522,6,14,3,19,49,65,-16,45
Airdrieon,9522,7,11,11,14,47,59,-12,44
Forfar,9522,8,10,5,21,39,66,-27,35
Albion,9522,9,8,6,22,61,85,-24,30
Queen's Park,9522,10,6,10,20,39,74,-35,28
Raith,9523,1,23,8,5,70,32,38,77
Ayr,9523,2,23,5,8,92,44,48,74
Arbroath,9523,3,17,9,10,73,51,22,60
Alloa,9523,4,17,8,11,56,45,11,59
Stranraer,9523,5,16,5,15,59,66,-7,53
East Fife,9523,6,13,3,20,49,68,-19,42
Airdrieon,9523,7,10,11,15,46,61,-15,41
Forfar,9523,8,11,5,20,41,65,-24,38
Albion,9523,9,8,7,21,59,80,-21,31
Queen's Park,9523,10,6,11,19,42,75,-33,29
Raith,9524,1,23,8,5,72,32,40,77
Ayr,9524,2,24,4,8,95,43,52,76
Arbroath,9524,3,18,8,10,74,48,26,62
Alloa,9524,4,17,8,11,56,47,9,59
Stranraer,9524,5,15,5,16,55,68,-13,50
East Fife,9524,6,14,3,19,51,64,-13,45
Airdrieon,9524,7,11,11,14,48,59,-11,44
Forfar,9524,8,10,5,21,39,67,-28,35
Albion,9524,9,8,6,22,58,83,-25,30
Queen's Park,9524,10,6,10,20,39,76,-37,28
Raith,9525,1,23,8,5,69,32,37,77
Ayr,9525,2,24,4,8,97,43,54,76
Arbroath,9525,3,18,8,10,72,48,24,62
Alloa,9525,4,17,8,11,56,44,12,59
Stranraer,9525,5,15,5,16,55,66,-11,50
East Fife,9525,6,14,3,19,49,64,-15,45
Airdrieon,9525,7,11,11,14,49,59,-10,44
Forfar,9525,8,10,5,21,39,68,-29,35
Albion,9525,9,8,6,22,58,85,-27,30
Queen's Park,9525,10,6,10,20,39,74,-35,28
Ayr,9526,1,24,4,8,96,44,52,76
Raith,9526,2,22,9,5,68,32,36,75
Arbroath,9526,3,17,9,10,72,50,22,60
Alloa,9526,4,17,9,10,56,43,13,60
Stranraer,9526,5,15,6,15,56,65,-9,51
East Fife,9526,6,13,4,19,48,65,-17,43
Airdrieon,9526,7,10,12,14,46,59,-13,42
Forfar,9526,8,10,6,20,39,65,-26,36
Albion,9526,9,8,6,22,59,84,-25,30
Queen's Park,9526,10,6,11,19,41,74,-33,29
Raith,9527,1,23,8,5,72,32,40,77
Ayr,9527,2,24,4,8,93,42,51,76
Arbroath,9527,3,18,8,10,73,49,24,62
Alloa,9527,4,17,8,11,56,47,9,59
Stranraer,9527,5,15,5,16,56,67,-11,50
East Fife,9527,6,14,3,19,50,65,-15,45
Airdrieon,9527,7,11,11,14,49,58,-9,44
Forfar,9527,8,10,5,21,38,68,-30,35
Albion,9527,9,8,6,22,57,81,-24,30
Queen's Park,9527,10,6,10,20,40,75,-35,28
Raith,9528,1,23,8,5,69,32,37,77
Ayr,9528,2,24,4,8,95,43,52,76
Arbroath,9528,3,18,8,10,73,48,25,62
Alloa,9528,4,17,8,11,56,44,12,59
Stranraer,9528,5,15,5,16,56,66,-10,50
East Fife,9528,6,14,3,19,49,65,-16,45
Airdrieon,9528,7,10,12,14,45,58,-13,42
Forfar,9528,8,10,6,20,38,64,-26,36
Albion,9528,9,8,6,22,58,83,-25,30
Queen's Park,9528,10,6,10,20,39,75,-36,28
Raith,9529,1,23,8,5,69,32,37,77
Ayr,9529,2,24,4,8,92,42,50,76
Arbroath,9529,3,18,8,10,73,48,25,62
Alloa,9529,4,17,8,11,56,44,12,59
Stranraer,9529,5,15,5,16,55,66,-11,50
East Fife,9529,6,14,3,19,49,64,-15,45
Airdrieon,9529,7,11,11,14,48,60,-12,44
Forfar,9529,8,10,5,21,40,67,-27,35
Albion,9529,9,8,6,22,57,80,-23,30
Queen's Park,9529,10,6,10,20,39,75,-36,28
Raith,9530,1,23,8,5,71,33,38,77
Ayr,9530,2,24,4,8,93,43,50,76
Arbroath,9530,3,17,8,11,70,50,20,59
Alloa,9530,4,17,8,11,57,46,11,59
Stranraer,9530,5,15,6,15,56,65,-9,51
Airdrieon,9530,6,11,11,14,48,59,-11,44
East Fife,9530,7,13,4,19,48,65,-17,43
Forfar,9530,8,10,5,21,39,67,-28,35
Queen's Park,9530,9,7,10,19,41,72,-31,31
Albion,9530,10,8,6,22,58,81,-23,30
Raith,9531,1,23,8,5,69,32,37,77
Ayr,9531,2,24,4,8,91,42,49,76
Arbroath,9531,3,18,8,10,73,49,24,62
Alloa,9531,4,17,8,11,56,44,12,59
Stranraer,9531,5,16,5,15,59,66,-7,53
East Fife,9531,6,13,3,20,49,68,-19,42
Airdrieon,9531,7,10,11,15,45,59,-14,41
Forfar,9531,8,11,5,20,39,64,-25,38
Albion,9531,9,8,6,22,57,79,-22,30
Queen's Park,9531,10,6,10,20,40,75,-35,28
Ayr,9532,1,24,4,8,93,43,50,76
Raith,9532,2,22,9,5,69,33,36,75
Alloa,9532,3,17,9,10,57,44,13,60
Arbroath,9532,4,17,8,11,70,51,19,59
Stranraer,9532,5,15,6,15,57,66,-9,51
Airdrieon,9532,6,11,11,14,48,59,-11,44
East Fife,9532,7,13,4,19,49,66,-17,43
Forfar,9532,8,10,5,21,39,67,-28,35
Queen's Park,9532,9,7,10,19,42,72,-30,31
Albion,9532,10,8,6,22,58,81,-23,30
Ayr,9533,1,23,5,8,92,44,48,74
Raith,9533,2,22,8,6,70,35,35,74
Arbroath,9533,3,18,8,10,73,49,24,62
Alloa,9533,4,18,8,10,59,45,14,62
Stranraer,9533,5,15,6,15,56,65,-9,51
Airdrieon,9533,6,11,11,14,49,60,-11,44
East Fife,9533,7,13,4,19,48,65,-17,43
Forfar,9533,8,10,5,21,40,68,-28,35
Albion,9533,9,8,7,21,59,80,-21,31
Queen's Park,9533,10,6,10,20,40,75,-35,28
Raith,9534,1,22,8,6,69,37,32,74
Ayr,9534,2,23,4,9,91,45,46,73
Alloa,9534,3,18,8,10,61,44,17,62
Arbroath,9534,4,17,8,11,71,51,20,59
Stranraer,9534,5,16,5,15,58,64,-6,53
Airdrieon,9534,6,11,11,14,48,59,-11,44
East Fife,9534,7,13,3,20,47,67,-20,42
Forfar,9534,8,10,5,21,39,67,-28,35
Albion,9534,9,9,6,21,60,79,-19,33
Queen's Park,9534,10,7,10,19,42,73,-31,31
Raith,9535,1,23,8,5,69,32,37,77
Ayr,9535,2,24,4,8,94,43,51,76
Arbroath,9535,3,17,8,11,71,51,20,59
Alloa,9535,4,17,8,11,56,44,12,59
Stranraer,9535,5,16,5,15,60,64,-4,53
East Fife,9535,6,13,3,20,47,69,-22,42
Airdrieon,9535,7,10,11,15,46,60,-14,41
Forfar,9535,8,11,5,20,40,65,-25,38
Queen's Park,9535,9,7,10,19,42,73,-31,31
Albion,9535,10,8,6,22,58,82,-24,30
Raith,9536,1,23,8,5,71,32,39,77
Ayr,9536,2,23,5,8,93,45,48,74
Arbroath,9536,3,18,8,10,72,49,23,62
Alloa,9536,4,17,8,11,56,46,10,59
Stranraer,9536,5,15,6,15,57,66,-9,51
Airdrieon,9536,6,11,11,14,47,58,-11,44
East Fife,9536,7,13,4,19,49,66,-17,43
Forfar,9536,8,10,5,21,38,66,-28,35
Albion,9536,9,8,7,21,60,81,-21,31
Queen's Park,9536,10,6,10,20,40,74,-34,28
Raith,9537,1,23,8,5,70,32,38,77
Ayr,9537,2,24,4,8,93,42,51,76
Arbroath,9537,3,18,8,10,72,49,23,62
Alloa,9537,4,17,8,11,56,45,11,59
Stranraer,9537,5,16,5,15,57,65,-8,53
Airdrieon,9537,6,10,12,14,45,58,-13,42
East Fife,9537,7,13,3,20,48,66,-18,42
Forfar,9537,8,10,6,20,38,64,-26,36
Albion,9537,9,8,6,22,57,81,-24,30
Queen's Park,9537,10,6,10,20,40,74,-34,28
Ayr,9538,1,24,4,8,94,42,52,76
Raith,9538,2,22,9,5,68,32,36,75
Alloa,9538,3,17,9,10,56,43,13,60
Arbroath,9538,4,17,8,11,73,52,21,59
Stranraer,9538,5,15,6,15,56,65,-9,51
Airdrieon,9538,6,11,11,14,49,59,-10,44
East Fife,9538,7,13,4,19,48,65,-17,43
Forfar,9538,8,10,5,21,39,68,-29,35
Queen's Park,9538,9,7,10,19,43,75,-32,31
Albion,9538,10,8,6,22,57,82,-25,30
Ayr,9539,1,24,4,8,92,42,50,76
Raith,9539,2,22,9,5,68,32,36,75
Alloa,9539,3,17,9,10,56,43,13,60
Arbroath,9539,4,17,8,11,71,50,21,59
Stranraer,9539,5,15,5,16,55,65,-10,50
East Fife,9539,6,14,3,19,48,64,-16,45
Airdrieon,9539,7,10,11,15,46,60,-14,41
Forfar,9539,8,11,5,20,40,65,-25,38
Queen's Park,9539,9,7,10,19,41,73,-32,31
Albion,9539,10,8,6,22,57,80,-23,30
Raith,9540,1,23,8,5,72,33,39,77
Ayr,9540,2,24,4,8,91,42,49,76
Arbroath,9540,3,17,9,10,70,48,22,60
Alloa,9540,4,17,8,11,57,47,10,59
Stranraer,9540,5,15,6,15,57,66,-9,51
East Fife,9540,6,13,4,19,49,66,-17,43
Airdrieon,9540,7,10,11,15,46,60,-14,41
Forfar,9540,8,11,5,20,40,65,-25,38
Albion,9540,9,8,6,22,57,79,-22,30
Queen's Park,9540,10,6,11,19,39,72,-33,29
Raith,9541,1,23,8,5,70,33,37,77
Ayr,9541,2,24,4,8,93,43,50,76
Arbroath,9541,3,18,8,10,72,49,23,62
Alloa,9541,4,17,8,11,57,45,12,59
Stranraer,9541,5,15,6,15,57,66,-9,51
Airdrieon,9541,6,11,11,14,48,58,-10,44
East Fife,9541,7,13,4,19,49,66,-17,43
Forfar,9541,8,10,5,21,38,67,-29,35
Albion,9541,9,8,6,22,58,81,-23,30
Queen's Park,9541,10,6,10,20,40,74,-34,28
Raith,9542,1,23,8,5,69,32,37,77
Ayr,9542,2,24,4,8,95,43,52,76
Arbroath,9542,3,17,8,11,70,50,20,59
Alloa,9542,4,17,8,11,56,44,12,59
Stranraer,9542,5,15,5,16,56,67,-11,50
East Fife,9542,6,14,3,19,50,65,-15,45
Airdrieon,9542,7,10,12,14,46,59,-13,42
Forfar,9542,8,10,6,20,39,65,-26,36
Queen's Park,9542,9,7,10,19,41,72,-31,31
Albion,9542,10,8,6,22,58,83,-25,30
Raith,9543,1,23,8,5,71,32,39,77
Ayr,9543,2,24,4,8,94,43,51,76
Arbroath,9543,3,18,8,10,73,50,23,62
Alloa,9543,4,17,8,11,56,46,10,59
Stranraer,9543,5,15,5,16,55,65,-10,50
East Fife,9543,6,14,3,19,48,64,-16,45
Airdrieon,9543,7,11,11,14,48,59,-11,44
Forfar,9543,8,10,5,21,39,67,-28,35
Albion,9543,9,8,6,22,58,82,-24,30
Queen's Park,9543,10,6,10,20,41,75,-34,28
Raith,9544,1,23,8,5,69,32,37,77
Ayr,9544,2,24,4,8,93,42,51,76
Arbroath,9544,3,18,8,10,72,49,23,62
Alloa,9544,4,17,8,11,56,44,12,59
Stranraer,9544,5,15,6,15,55,64,-9,51
Airdrieon,9544,6,11,11,14,48,60,-12,44
East Fife,9544,7,13,4,19,47,64,-17,43
Forfar,9544,8,10,5,21,40,67,-27,35
Albion,9544,9,8,6,22,57,81,-24,30
Queen's Park,9544,10,6,10,20,40,74,-34,28
Ayr,9545,1,24,4,8,94,43,51,76
Raith,9545,2,22,9,5,68,32,36,75
Alloa,9545,3,17,9,10,56,43,13,60
Arbroath,9545,4,17,8,11,72,51,21,59
Stranraer,9545,5,15,5,16,56,66,-10,50
East Fife,9545,6,14,3,19,49,65,-16,45
Airdrieon,9545,7,11,11,14,47,59,-12,44
Forfar,9545,8,10,5,21,39,66,-27,35
Queen's Park,9545,9,7,10,19,42,74,-32,31
Albion,9545,10,8,6,22,58,82,-24,30
Raith,9546,1,23,8,5,71,32,39,77
Ayr,9546,2,24,4,8,91,42,49,76
Arbroath,9546,3,17,9,10,71,49,22,60
Alloa,9546,4,17,8,11,56,46,10,59
Stranraer,9546,5,16,5,15,59,64,-5,53
East Fife,9546,6,13,3,20,47,68,-21,42
Airdrieon,9546,7,10,11,15,47,62,-15,41
Forfar,9546,8,11,5,20,42,66,-24,38
Albion,9546,9,8,6,22,57,79,-22,30
Queen's Park,9546,10,6,11,19,40,73,-33,29
Raith,9547,1,23,8,5,69,32,37,77
Ayr,9547,2,24,4,8,95,42,53,76
Arbroath,9547,3,18,8,10,74,49,25,62
Alloa,9547,4,17,8,11,56,44,12,59
Stranraer,9547,5,15,5,16,56,71,-15,50
East Fife,9547,6,14,3,19,54,65,-11,45
Airdrieon,9547,7,11,11,14,47,58,-11,44
Forfar,9547,8,10,5,21,38,66,-28,35
Albion,9547,9,8,6,22,57,83,-26,30
Queen's Park,9547,10,6,10,20,40,76,-36,28
Raith,9548,1,23,8,5,69,32,37,77
Ayr,9548,2,24,4,8,93,43,50,76
Arbroath,9548,3,18,8,10,72,49,23,62
Alloa,9548,4,17,8,11,56,44,12,59
Stranraer,9548,5,15,5,16,55,66,-11,50
East Fife,9548,6,14,3,19,49,64,-15,45
Airdrieon,9548,7,11,11,14,46,58,-12,44
Forfar,9548,8,10,5,21,38,65,-27,35
Albion,9548,9,8,6,22,58,81,-23,30
Queen's Park,9548,10,6,10,20,40,74,-34,28
Raith,9549,1,23,8,5,71,34,37,77
Ayr,9549,2,24,4,8,93,43,50,76
Arbroath,9549,3,18,8,10,73,48,25,62
Alloa,9549,4,17,8,11,58,46,12,59
Stranraer,9549,5,15,5,16,57,67,-10,50
East Fife,9549,6,14,3,19,50,66,-16,45
Airdrieon,9549,7,10,11,15,45,59,-14,41
Forfar,9549,8,11,5,20,39,64,-25,38
Albion,9549,9,8,6,22,58,81,-23,30
Queen's Park,9549,10,6,10,20,39,75,-36,28
Ayr,9550,1,24,4,8,93,43,50,76
Raith,9550,2,22,8,6,69,34,35,74
Alloa,9550,3,18,8,10,58,44,14,62
Arbroath,9550,4,17,8,11,71,50,21,59
Stranraer,9550,5,15,6,15,56,65,-9,51
East Fife,9550,6,13,4,19,48,65,-17,43
Airdrieon,9550,7,10,11,15,46,61,-15,41
Forfar,9550,8,11,5,20,41,65,-24,38
Queen's Park,9550,9,7,10,19,41,73,-32,31
Albion,9550,10,8,6,22,58,81,-23,30
Raith,9551,1,23,8,5,70,32,38,77
Ayr,9551,2,24,4,8,95,44,51,76
Arbroath,9551,3,18,8,10,72,49,23,62
Alloa,9551,4,17,8,11,56,45,11,59
Stranraer,9551,5,16,5,15,58,66,-8,53
Airdrieon,9551,6,11,11,14,47,58,-11,44
East Fife,9551,7,13,3,20,49,67,-18,42
Forfar,9551,8,10,5,21,38,66,-28,35
Albion,9551,9,8,6,22,59,83,-24,30
Queen's Park,9551,10,6,10,20,40,74,-34,28
Ayr,9552,1,24,4,8,96,45,51,76
Raith,9552,2,22,8,6,68,33,35,74
Arbroath,9552,3,18,8,10,72,49,23,62
Alloa,9552,4,18,8,10,57,43,14,62
Stranraer,9552,5,15,6,15,56,65,-9,51
Airdrieon,9552,6,11,11,14,46,58,-12,44
East Fife,9552,7,13,4,19,48,65,-17,43
Forfar,9552,8,10,5,21,38,65,-27,35
Albion,9552,9,8,6,22,60,84,-24,30
Queen's Park,9552,10,6,10,20,40,74,-34,28
Ayr,9553,1,24,4,8,95,43,52,76
Raith,9553,2,22,8,6,70,35,35,74
Alloa,9553,3,18,8,10,59,45,14,62
Arbroath,9553,4,17,9,10,73,51,22,60
Stranraer,9553,5,16,5,15,57,65,-8,53
Airdrieon,9553,6,11,11,14,47,58,-11,44
East Fife,9553,7,13,3,20,48,66,-18,42
Forfar,9553,8,10,5,21,38,66,-28,35
Albion,9553,9,8,6,22,58,83,-25,30
Queen's Park,9553,10,6,11,19,42,75,-33,29
Raith,9554,1,23,8,5,70,33,37,77
Ayr,9554,2,24,4,8,93,43,50,76
Arbroath,9554,3,17,8,11,72,53,19,59
Alloa,9554,4,17,8,11,57,45,12,59
Stranraer,9554,5,15,5,16,56,69,-13,50
East Fife,9554,6,14,3,19,52,65,-13,45
Airdrieon,9554,7,11,11,14,48,59,-11,44
Forfar,9554,8,10,5,21,39,67,-28,35
Queen's Park,9554,9,7,10,19,44,74,-30,31
Albion,9554,10,8,6,22,58,81,-23,30
Raith,9555,1,22,9,5,68,32,36,75
Ayr,9555,2,23,4,9,92,45,47,73
Alloa,9555,3,17,9,10,56,43,13,60
Arbroath,9555,4,17,8,11,72,51,21,59
Stranraer,9555,5,15,5,16,55,68,-13,50
East Fife,9555,6,14,3,19,51,64,-13,45
Airdrieon,9555,7,10,12,14,46,59,-13,42
Forfar,9555,8,10,6,20,39,65,-26,36
Albion,9555,9,9,6,21,60,80,-20,33
Queen's Park,9555,10,7,10,19,42,74,-32,31
Raith,9556,1,23,8,5,70,33,37,77
Ayr,9556,2,24,4,8,93,43,50,76
Arbroath,9556,3,17,9,10,72,50,22,60
Alloa,9556,4,17,8,11,57,45,12,59
Stranraer,9556,5,15,5,16,56,69,-13,50
East Fife,9556,6,14,3,19,52,65,-13,45
Airdrieon,9556,7,11,11,14,47,59,-12,44
Forfar,9556,8,10,5,21,39,66,-27,35
Albion,9556,9,8,6,22,58,81,-23,30
Queen's Park,9556,10,6,11,19,41,74,-33,29
Ayr,9557,1,24,4,8,92,42,50,76
Raith,9557,2,22,8,6,68,36,32,74
Arbroath,9557,3,18,8,10,71,48,23,62
Alloa,9557,4,18,8,10,60,43,17,62
Stranraer,9557,5,16,5,15,57,65,-8,53
Airdrieon,9557,6,11,11,14,47,58,-11,44
East Fife,9557,7,13,3,20,48,66,-18,42
Forfar,9557,8,10,5,21,38,66,-28,35
Albion,9557,9,8,6,22,57,80,-23,30
Queen's Park,9557,10,6,10,20,39,73,-34,28
Ayr,9558,1,24,4,8,93,42,51,76
Raith,9558,2,22,9,5,70,34,36,75
Arbroath,9558,3,17,9,10,72,50,22,60
Alloa,9558,4,17,9,10,58,45,13,60
Stranraer,9558,5,15,6,15,57,66,-9,51
Airdrieon,9558,6,11,11,14,47,58,-11,44
East Fife,9558,7,13,4,19,49,66,-17,43
Forfar,9558,8,10,5,21,38,66,-28,35
Albion,9558,9,8,6,22,57,81,-24,30
Queen's Park,9558,10,6,11,19,41,74,-33,29
Ayr,9559,1,24,4,8,93,42,51,76
Raith,9559,2,22,9,5,69,33,36,75
Arbroath,9559,3,18,8,10,71,48,23,62
Alloa,9559,4,17,9,10,57,44,13,60
Stranraer,9559,5,15,5,16,57,68,-11,50
East Fife,9559,6,14,3,19,51,66,-15,45
Airdrieon,9559,7,11,11,14,48,59,-11,44
Forfar,9559,8,10,5,21,39,67,-28,35
Albion,9559,9,8,6,22,57,81,-24,30
Queen's Park,9559,10,6,10,20,39,73,-34,28
Raith,9560,1,23,8,5,70,33,37,77
Ayr,9560,2,24,4,8,94,42,52,76
Arbroath,9560,3,18,8,10,72,49,23,62
Alloa,9560,4,17,8,11,57,45,12,59
Stranraer,9560,5,16,5,15,56,64,-8,53
East Fife,9560,6,13,3,20,47,65,-18,42
Airdrieon,9560,7,10,11,15,46,61,-15,41
Forfar,9560,8,11,5,20,41,65,-24,38
Albion,9560,9,8,6,22,57,82,-25,30
Queen's Park,9560,10,6,10,20,40,74,-34,28
Ayr,9561,1,24,4,8,92,42,50,76
Raith,9561,2,22,8,6,70,35,35,74
Arbroath,9561,3,18,8,10,72,48,24,62
Alloa,9561,4,18,8,10,59,45,14,62
Stranraer,9561,5,15,5,16,56,67,-11,50
East Fife,9561,6,14,3,19,50,65,-15,45
Airdrieon,9561,7,11,11,14,46,58,-12,44
Forfar,9561,8,10,5,21,38,65,-27,35
Albion,9561,9,8,6,22,57,80,-23,30
Queen's Park,9561,10,6,10,20,39,74,-35,28
Raith,9562,1,23,8,5,69,32,37,77
Ayr,9562,2,24,4,8,94,42,52,76
Arbroath,9562,3,17,9,10,73,51,22,60
Alloa,9562,4,17,8,11,56,44,12,59
Stranraer,9562,5,15,5,16,56,67,-11,50
East Fife,9562,6,14,3,19,50,65,-15,45
Airdrieon,9562,7,11,11,14,48,59,-11,44
Forfar,9562,8,10,5,21,39,67,-28,35
Albion,9562,9,8,6,22,57,82,-25,30
Queen's Park,9562,10,6,11,19,42,75,-33,29
Raith,9563,1,23,8,5,70,32,38,77
Ayr,9563,2,23,4,9,91,46,45,73
Arbroath,9563,3,18,8,10,71,48,23,62
Alloa,9563,4,17,8,11,56,45,11,59
Stranraer,9563,5,15,5,16,55,65,-10,50
East Fife,9563,6,14,3,19,48,64,-16,45
Airdrieon,9563,7,11,11,14,47,58,-11,44
Forfar,9563,8,10,5,21,38,66,-28,35
Albion,9563,9,9,6,21,61,79,-18,33
Queen's Park,9563,10,6,10,20,39,73,-34,28
Raith,9564,1,23,8,5,71,32,39,77
Ayr,9564,2,23,5,8,91,43,48,74
Arbroath,9564,3,18,8,10,73,48,25,62
Alloa,9564,4,17,8,11,56,46,10,59
Stranraer,9564,5,15,5,16,56,66,-10,50
East Fife,9564,6,14,3,19,49,65,-16,45
Airdrieon,9564,7,10,11,15,45,59,-14,41
Forfar,9564,8,11,5,20,39,64,-25,38
Albion,9564,9,8,7,21,58,79,-21,31
Queen's Park,9564,10,6,10,20,39,75,-36,28
Raith,9565,1,23,8,5,70,33,37,77
Ayr,9565,2,24,4,8,92,43,49,76
Arbroath,9565,3,17,9,10,71,49,22,60
Alloa,9565,4,17,8,11,57,45,12,59
Stranraer,9565,5,15,5,16,57,68,-11,50
East Fife,9565,6,14,3,19,51,66,-15,45
Airdrieon,9565,7,11,11,14,48,58,-10,44
Forfar,9565,8,10,5,21,38,67,-29,35
Albion,9565,9,8,6,22,58,80,-22,30
Queen's Park,9565,10,6,11,19,40,73,-33,29
Ayr,9566,1,24,4,8,100,43,57,76
Raith,9566,2,22,9,5,69,33,36,75
Arbroath,9566,3,18,8,10,73,48,25,62
Alloa,9566,4,17,9,10,57,44,13,60
Stranraer,9566,5,15,5,16,55,65,-10,50
East Fife,9566,6,14,3,19,48,64,-16,45
Airdrieon,9566,7,11,11,14,49,59,-10,44
Forfar,9566,8,10,5,21,39,68,-29,35
Albion,9566,9,8,6,22,58,88,-30,30
Queen's Park,9566,10,6,10,20,39,75,-36,28
Ayr,9567,1,24,4,8,92,42,50,76
Raith,9567,2,22,9,5,68,32,36,75
Arbroath,9567,3,18,8,10,72,49,23,62
Alloa,9567,4,17,9,10,56,43,13,60
Stranraer,9567,5,15,6,15,56,65,-9,51
Airdrieon,9567,6,11,11,14,50,60,-10,44
East Fife,9567,7,13,4,19,48,65,-17,43
Forfar,9567,8,10,5,21,40,69,-29,35
Albion,9567,9,8,6,22,57,80,-23,30
Queen's Park,9567,10,6,10,20,40,74,-34,28
Raith,9568,1,23,8,5,69,32,37,77
Ayr,9568,2,24,4,8,93,43,50,76
Arbroath,9568,3,18,8,10,73,50,23,62
Alloa,9568,4,17,8,11,56,44,12,59
Stranraer,9568,5,16,5,15,58,64,-6,53
Airdrieon,9568,6,10,12,14,46,59,-13,42
East Fife,9568,7,13,3,20,47,67,-20,42
Forfar,9568,8,10,6,20,39,65,-26,36
Albion,9568,9,8,6,22,58,81,-23,30
Queen's Park,9568,10,6,10,20,41,75,-34,28
Raith,9569,1,23,8,5,69,32,37,77
Ayr,9569,2,24,4,8,94,42,52,76
Arbroath,9569,3,17,9,10,70,48,22,60
Alloa,9569,4,17,8,11,56,44,12,59
Stranraer,9569,5,15,6,15,57,66,-9,51
East Fife,9569,6,13,4,19,49,66,-17,43
Airdrieon,9569,7,10,12,14,45,58,-13,42
Forfar,9569,8,10,6,20,38,64,-26,36
Albion,9569,9,8,6,22,57,82,-25,30
Queen's Park,9569,10,6,11,19,39,72,-33,29
Ayr,9570,1,24,4,8,95,44,51,76
Raith,9570,2,22,9,5,71,35,36,75
Arbroath,9570,3,18,8,10,74,50,24,62
Alloa,9570,4,17,9,10,59,46,13,60
Stranraer,9570,5,16,5,15,57,65,-8,53
Airdrieon,9570,6,10,12,14,45,58,-13,42
East Fife,9570,7,13,3,20,48,66,-18,42
Forfar,9570,8,10,6,20,38,64,-26,36
Albion,9570,9,8,6,22,59,83,-24,30
Queen's Park,9570,10,6,10,20,41,76,-35,28
Raith,9571,1,23,8,5,71,33,38,77
Ayr,9571,2,24,4,8,95,42,53,76
Arbroath,9571,3,18,8,10,72,49,23,62
Alloa,9571,4,17,8,11,57,46,11,59
Stranraer,9571,5,16,5,15,57,64,-7,53
Airdrieon,9571,6,10,12,14,45,58,-13,42
East Fife,9571,7,13,3,20,47,66,-19,42
Forfar,9571,8,10,6,20,38,64,-26,36
Albion,9571,9,8,6,22,57,83,-26,30
Queen's Park,9571,10,6,10,20,40,74,-34,28
Ayr,9572,1,24,4,8,95,42,53,76
Raith,9572,2,22,9,5,69,33,36,75
Arbroath,9572,3,17,9,10,71,49,22,60
Alloa,9572,4,17,9,10,57,44,13,60
Stranraer,9572,5,15,5,16,56,67,-11,50
East Fife,9572,6,14,3,19,50,65,-15,45
Airdrieon,9572,7,11,11,14,46,58,-12,44
Forfar,9572,8,10,5,21,38,65,-27,35
Albion,9572,9,8,6,22,57,83,-26,30
Queen's Park,9572,10,6,11,19,40,73,-33,29
Ayr,9573,1,24,4,8,96,43,53,76
Raith,9573,2,22,8,6,70,35,35,74
Alloa,9573,3,18,8,10,59,45,14,62
Arbroath,9573,4,17,9,10,70,48,22,60
Stranraer,9573,5,15,6,15,55,64,-9,51
Airdrieon,9573,6,11,11,14,47,59,-12,44
East Fife,9573,7,13,4,19,47,64,-17,43
Forfar,9573,8,10,5,21,39,66,-27,35
Albion,9573,9,8,6,22,58,84,-26,30
Queen's Park,9573,10,6,11,19,39,72,-33,29
Raith,9574,1,22,9,5,68,32,36,75
Ayr,9574,2,23,4,9,90,43,47,73
Alloa,9574,3,17,9,10,56,43,13,60
Arbroath,9574,4,17,8,11,71,50,21,59
Stranraer,9574,5,15,5,16,57,67,-10,50
East Fife,9574,6,14,3,19,50,66,-16,45
Airdrieon,9574,7,10,12,14,47,60,-13,42
Forfar,9574,8,10,6,20,40,66,-26,36
Albion,9574,9,9,6,21,58,78,-20,33
Queen's Park,9574,10,7,10,19,41,73,-32,31
Raith,9575,1,23,8,5,71,32,39,77
Ayr,9575,2,23,5,8,91,43,48,74
Arbroath,9575,3,18,8,10,73,48,25,62
Alloa,9575,4,17,8,11,56,46,10,59
Stranraer,9575,5,16,5,15,57,65,-8,53
Airdrieon,9575,6,10,12,14,46,59,-13,42
East Fife,9575,7,13,3,20,48,66,-18,42
Forfar,9575,8,10,6,20,39,65,-26,36
Albion,9575,9,8,7,21,58,79,-21,31
Queen's Park,9575,10,6,10,20,39,75,-36,28
Raith,9576,1,23,8,5,71,34,37,77
Ayr,9576,2,24,4,8,93,43,50,76
Arbroath,9576,3,18,8,10,73,48,25,62
Alloa,9576,4,17,8,11,58,46,12,59
Stranraer,9576,5,15,5,16,55,67,-12,50
East Fife,9576,6,14,3,19,50,64,-14,45
Airdrieon,9576,7,11,11,14,48,58,-10,44
Forfar,9576,8,10,5,21,38,67,-29,35
Albion,9576,9,8,6,22,58,81,-23,30
Queen's Park,9576,10,6,10,20,39,75,-36,28
Ayr,9577,1,24,4,8,92,43,49,76
Raith,9577,2,22,9,5,68,32,36,75
Arbroath,9577,3,17,9,10,73,51,22,60
Alloa,9577,4,17,9,10,56,43,13,60
Stranraer,9577,5,16,5,15,56,64,-8,53
Airdrieon,9577,6,10,12,14,46,59,-13,42
East Fife,9577,7,13,3,20,47,65,-18,42
Forfar,9577,8,10,6,20,39,65,-26,36
Albion,9577,9,8,6,22,58,80,-22,30
Queen's Park,9577,10,6,11,19,42,75,-33,29
Raith,9578,1,23,8,5,72,35,37,77
Ayr,9578,2,24,4,8,93,44,49,76
Arbroath,9578,3,17,8,11,71,51,20,59
Alloa,9578,4,17,8,11,59,47,12,59
Stranraer,9578,5,15,5,16,55,65,-10,50
East Fife,9578,6,14,3,19,48,64,-16,45
Airdrieon,9578,7,11,11,14,48,59,-11,44
Forfar,9578,8,10,5,21,39,67,-28,35
Queen's Park,9578,9,7,10,19,42,73,-31,31
Albion,9578,10,8,6,22,59,81,-22,30
Ayr,9579,1,24,4,8,96,42,54,76
Raith,9579,2,22,9,5,69,33,36,75
Arbroath,9579,3,18,8,10,71,48,23,62
Alloa,9579,4,17,9,10,57,44,13,60
Stranraer,9579,5,16,5,15,58,64,-6,53
East Fife,9579,6,13,3,20,47,67,-20,42
Airdrieon,9579,7,10,11,15,46,60,-14,41
Forfar,9579,8,11,5,20,40,65,-25,38
Albion,9579,9,8,6,22,57,84,-27,30
Queen's Park,9579,10,6,10,20,39,73,-34,28
Ayr,9580,1,24,4,8,94,42,52,76
Raith,9580,2,22,9,5,69,33,36,75
Arbroath,9580,3,17,9,10,70,48,22,60
Alloa,9580,4,17,9,10,57,44,13,60
Stranraer,9580,5,15,6,15,57,66,-9,51
Airdrieon,9580,6,11,11,14,46,58,-12,44
East Fife,9580,7,13,4,19,49,66,-17,43
Forfar,9580,8,10,5,21,38,65,-27,35
Albion,9580,9,8,6,22,57,82,-25,30
Queen's Park,9580,10,6,11,19,39,72,-33,29
Raith,9581,1,23,8,5,69,32,37,77
Ayr,9581,2,23,4,9,90,43,47,73
Arbroath,9581,3,18,8,10,72,48,24,62
Alloa,9581,4,17,8,11,56,44,12,59
Stranraer,9581,5,15,5,16,55,66,-11,50
East Fife,9581,6,14,3,19,49,64,-15,45
Airdrieon,9581,7,11,11,14,48,59,-11,44
Forfar,9581,8,10,5,21,39,67,-28,35
Albion,9581,9,9,6,21,58,78,-20,33
Queen's Park,9581,10,6,10,20,39,74,-35,28
Ayr,9582,1,24,4,8,96,47,49,76
Raith,9582,2,22,8,6,68,33,35,74
Alloa,9582,3,18,8,10,57,43,14,62
Arbroath,9582,4,17,9,10,70,48,22,60
Stranraer,9582,5,15,6,15,57,66,-9,51
Airdrieon,9582,6,11,11,14,49,58,-9,44
East Fife,9582,7,13,4,19,49,66,-17,43
Forfar,9582,8,10,5,21,38,68,-30,35
Albion,9582,9,8,6,22,62,84,-22,30
Queen's Park,9582,10,6,11,19,39,72,-33,29
Raith,9583,1,23,8,5,70,32,38,77
Ayr,9583,2,24,4,8,98,43,55,76
Arbroath,9583,3,17,8,11,71,50,21,59
Alloa,9583,4,17,8,11,56,45,11,59
Stranraer,9583,5,15,5,16,57,67,-10,50
East Fife,9583,6,14,3,19,50,66,-16,45
Airdrieon,9583,7,11,11,14,47,58,-11,44
Forfar,9583,8,10,5,21,38,66,-28,35
Queen's Park,9583,9,7,10,19,41,73,-32,31
Albion,9583,10,8,6,22,58,86,-28,30
Raith,9584,1,23,8,5,70,33,37,77
Ayr,9584,2,24,4,8,93,42,51,76
Arbroath,9584,3,17,9,10,71,49,22,60
Alloa,9584,4,17,8,11,57,45,12,59
Stranraer,9584,5,15,6,15,55,64,-9,51
East Fife,9584,6,13,4,19,47,64,-17,43
Airdrieon,9584,7,10,11,15,46,60,-14,41
Forfar,9584,8,11,5,20,40,65,-25,38
Albion,9584,9,8,6,22,57,81,-24,30
Queen's Park,9584,10,6,11,19,40,73,-33,29
Raith,9585,1,23,8,5,69,32,37,77
Ayr,9585,2,23,4,9,91,44,47,73
Arbroath,9585,3,18,8,10,72,49,23,62
Alloa,9585,4,17,8,11,56,44,12,59
Stranraer,9585,5,16,5,15,60,66,-6,53
Airdrieon,9585,6,11,11,14,46,58,-12,44
East Fife,9585,7,13,3,20,49,69,-20,42
Forfar,9585,8,10,5,21,38,65,-27,35
Albion,9585,9,9,6,21,59,79,-20,33
Queen's Park,9585,10,6,10,20,40,74,-34,28
Raith,9586,1,23,8,5,69,32,37,77
Ayr,9586,2,24,4,8,92,43,49,76
Arbroath,9586,3,18,8,10,73,48,25,62
Alloa,9586,4,17,8,11,56,44,12,59
Stranraer,9586,5,16,5,15,57,65,-8,53
Airdrieon,9586,6,10,12,14,46,59,-13,42
East Fife,9586,7,13,3,20,48,66,-18,42
Forfar,9586,8,10,6,20,39,65,-26,36
Albion,9586,9,8,6,22,58,80,-22,30
Queen's Park,9586,10,6,10,20,39,75,-36,28
Ayr,9587,1,24,4,8,93,44,49,76
Raith,9587,2,22,9,5,69,33,36,75
Arbroath,9587,3,17,9,10,71,49,22,60
Alloa,9587,4,17,9,10,57,44,13,60
Stranraer,9587,5,15,5,16,55,66,-11,50
East Fife,9587,6,14,3,19,49,64,-15,45
Airdrieon,9587,7,11,11,14,48,59,-11,44
Forfar,9587,8,10,5,21,39,67,-28,35
Albion,9587,9,8,6,22,59,81,-22,30
Queen's Park,9587,10,6,11,19,40,73,-33,29
Raith,9588,1,23,8,5,71,33,38,77
Ayr,9588,2,23,5,8,91,43,48,74
Arbroath,9588,3,17,9,10,70,48,22,60
Alloa,9588,4,17,8,11,57,46,11,59
Stranraer,9588,5,15,6,15,56,65,-9,51
Airdrieon,9588,6,11,11,14,47,58,-11,44
East Fife,9588,7,13,4,19,48,65,-17,43
Forfar,9588,8,10,5,21,38,66,-28,35
Albion,9588,9,8,7,21,58,79,-21,31
Queen's Park,9588,10,6,11,19,39,72,-33,29
Ayr,9589,1,24,4,8,94,45,49,76
Raith,9589,2,22,9,5,68,32,36,75
Alloa,9589,3,17,9,10,56,43,13,60
Arbroath,9589,4,17,8,11,72,52,20,59
Stranraer,9589,5,15,6,15,55,64,-9,51
Airdrieon,9589,6,11,11,14,48,58,-10,44
East Fife,9589,7,13,4,19,47,64,-17,43
Forfar,9589,8,10,5,21,38,67,-29,35
Queen's Park,9589,9,7,10,19,43,74,-31,31
Albion,9589,10,8,6,22,60,82,-22,30
Raith,9590,1,23,8,5,71,32,39,77
Ayr,9590,2,24,4,8,94,42,52,76
Arbroath,9590,3,18,8,10,73,48,25,62
Alloa,9590,4,17,8,11,56,46,10,59
Stranraer,9590,5,15,5,16,55,66,-11,50
East Fife,9590,6,14,3,19,49,64,-15,45
Airdrieon,9590,7,11,11,14,49,58,-9,44
Forfar,9590,8,10,5,21,38,68,-30,35
Albion,9590,9,8,6,22,57,82,-25,30
Queen's Park,9590,10,6,10,20,39,75,-36,28
Ayr,9591,1,23,5,8,92,44,48,74
Raith,9591,2,22,8,6,68,33,35,74
Arbroath,9591,3,18,8,10,73,49,24,62
Alloa,9591,4,18,8,10,57,43,14,62
Stranraer,9591,5,15,6,15,55,64,-9,51
East Fife,9591,6,13,4,19,47,64,-17,43
Airdrieon,9591,7,10,11,15,45,59,-14,41
Forfar,9591,8,11,5,20,39,64,-25,38
Albion,9591,9,8,7,21,59,80,-21,31
Queen's Park,9591,10,6,10,20,40,75,-35,28
Raith,9592,1,23,8,5,69,32,37,77
Ayr,9592,2,24,4,8,93,43,50,76
Arbroath,9592,3,17,9,10,72,50,22,60
Alloa,9592,4,17,8,11,56,44,12,59
Stranraer,9592,5,15,6,15,55,64,-9,51
East Fife,9592,6,13,4,19,47,64,-17,43
Airdrieon,9592,7,10,11,15,47,62,-15,41
Forfar,9592,8,11,5,20,42,66,-24,38
Albion,9592,9,8,6,22,58,81,-23,30
Queen's Park,9592,10,6,11,19,41,74,-33,29
Ayr,9593,1,24,4,8,94,44,50,76
Raith,9593,2,22,8,6,68,33,35,74
Arbroath,9593,3,18,8,10,71,48,23,62
Alloa,9593,4,18,8,10,57,43,14,62
Stranraer,9593,5,16,5,15,58,65,-7,53
East Fife,9593,6,13,3,20,48,67,-19,42
Airdrieon,9593,7,10,11,15,46,60,-14,41
Forfar,9593,8,11,5,20,40,65,-25,38
Albion,9593,9,8,6,22,59,82,-23,30
Queen's Park,9593,10,6,10,20,39,73,-34,28
Raith,9594,1,23,8,5,69,32,37,77
Ayr,9594,2,24,4,8,92,43,49,76
Arbroath,9594,3,17,9,10,72,50,22,60
Alloa,9594,4,17,8,11,56,44,12,59
Stranraer,9594,5,15,6,15,56,65,-9,51
Airdrieon,9594,6,11,11,14,46,58,-12,44
East Fife,9594,7,13,4,19,48,65,-17,43
Forfar,9594,8,10,5,21,38,65,-27,35
Albion,9594,9,8,6,22,58,80,-22,30
Queen's Park,9594,10,6,11,19,41,74,-33,29
Ayr,9595,1,24,4,8,92,43,49,76
Raith,9595,2,22,9,5,68,32,36,75
Alloa,9595,3,17,9,10,56,43,13,60
Arbroath,9595,4,17,8,11,70,49,21,59
Stranraer,9595,5,15,5,16,56,67,-11,50
East Fife,9595,6,14,3,19,50,65,-15,45
Airdrieon,9595,7,11,11,14,47,59,-12,44
Forfar,9595,8,10,5,21,39,66,-27,35
Queen's Park,9595,9,7,10,19,40,72,-32,31
Albion,9595,10,8,6,22,58,80,-22,30
Raith,9596,1,23,8,5,69,32,37,77
Ayr,9596,2,23,5,8,92,44,48,74
Arbroath,9596,3,18,8,10,72,48,24,62
Alloa,9596,4,17,8,11,56,44,12,59
Stranraer,9596,5,16,5,15,57,65,-8,53
East Fife,9596,6,13,3,20,48,66,-18,42
Airdrieon,9596,7,10,11,15,45,60,-15,41
Forfar,9596,8,11,5,20,40,64,-24,38
Albion,9596,9,8,7,21,59,80,-21,31
Queen's Park,9596,10,6,10,20,39,74,-35,28
Ayr,9597,1,24,4,8,94,45,49,76
Raith,9597,2,22,8,6,69,35,34,74
Alloa,9597,3,18,8,10,59,44,15,62
Arbroath,9597,4,17,8,11,71,50,21,59
Stranraer,9597,5,15,6,15,55,64,-9,51
Airdrieon,9597,6,11,11,14,47,59,-12,44
East Fife,9597,7,13,4,19,47,64,-17,43
Forfar,9597,8,10,5,21,39,66,-27,35
Queen's Park,9597,9,7,10,19,41,73,-32,31
Albion,9597,10,8,6,22,60,82,-22,30
Raith,9598,1,23,8,5,72,33,39,77
Ayr,9598,2,24,4,8,93,42,51,76
Arbroath,9598,3,17,9,10,72,50,22,60
Alloa,9598,4,17,8,11,57,47,10,59
Stranraer,9598,5,15,5,16,56,66,-10,50
East Fife,9598,6,14,3,19,49,65,-16,45
Airdrieon,9598,7,11,11,14,49,59,-10,44
Forfar,9598,8,10,5,21,39,68,-29,35
Albion,9598,9,8,6,22,57,81,-24,30
Queen's Park,9598,10,6,11,19,41,74,-33,29
Raith,9599,1,23,8,5,69,32,37,77
Ayr,9599,2,24,4,8,93,43,50,76
Arbroath,9599,3,18,8,10,73,50,23,62
Alloa,9599,4,17,8,11,56,44,12,59
Stranraer,9599,5,15,5,16,55,65,-10,50
East Fife,9599,6,14,3,19,48,64,-16,45
Airdrieon,9599,7,11,11,14,48,59,-11,44
Forfar,9599,8,10,5,21,39,67,-28,35
Albion,9599,9,8,6,22,58,81,-23,30
Queen's Park,9599,10,6,10,20,41,75,-34,28
Ayr,9600,1,24,4,8,93,43,50,76
Raith,9600,2,22,9,5,69,33,36,75
Alloa,9600,3,17,9,10,57,44,13,60
Arbroath,9600,4,17,8,11,70,49,21,59
Stranraer,9600,5,15,5,16,56,66,-10,50
East Fife,9600,6,14,3,19,49,65,-16,45
Airdrieon,9600,7,11,11,14,49,58,-9,44
Forfar,9600,8,10,5,21,38,68,-30,35
Queen's Park,9600,9,7,10,19,40,72,-32,31
Albion,9600,10,8,6,22,58,81,-23,30
Raith,9601,1,23,8,5,70,33,37,77
Ayr,9601,2,23,4,9,90,43,47,73
Arbroath,9601,3,18,8,10,72,48,24,62
Alloa,9601,4,17,8,11,57,45,12,59
Stranraer,9601,5,16,5,15,57,65,-8,53
Airdrieon,9601,6,10,12,14,46,59,-13,42
East Fife,9601,7,13,3,20,48,66,-18,42
Forfar,9601,8,10,6,20,39,65,-26,36
Albion,9601,9,9,6,21,58,78,-20,33
Queen's Park,9601,10,6,10,20,39,74,-35,28
Ayr,9602,1,24,4,8,93,42,51,76
Raith,9602,2,22,9,5,70,34,36,75
Alloa,9602,3,17,9,10,58,45,13,60
Arbroath,9602,4,17,8,11,70,50,20,59
Stranraer,9602,5,16,5,15,56,64,-8,53
Airdrieon,9602,6,11,11,14,47,59,-12,44
East Fife,9602,7,13,3,20,47,65,-18,42
Forfar,9602,8,10,5,21,39,66,-27,35
Queen's Park,9602,9,7,10,19,41,72,-31,31
Albion,9602,10,8,6,22,57,81,-24,30
Raith,9603,1,23,8,5,70,33,37,77
Ayr,9603,2,24,4,8,93,42,51,76
Arbroath,9603,3,17,8,11,70,49,21,59
Alloa,9603,4,17,8,11,57,45,12,59
Stranraer,9603,5,15,6,15,56,65,-9,51
Airdrieon,9603,6,11,11,14,46,58,-12,44
East Fife,9603,7,13,4,19,48,65,-17,43
Forfar,9603,8,10,5,21,38,65,-27,35
Queen's Park,9603,9,7,10,19,40,72,-32,31
Albion,9603,10,8,6,22,57,81,-24,30
Raith,9604,1,23,8,5,73,34,39,77
Ayr,9604,2,24,4,8,94,44,50,76
Arbroath,9604,3,17,8,11,72,51,21,59
Alloa,9604,4,17,8,11,58,48,10,59
Stranraer,9604,5,15,5,16,56,67,-11,50
East Fife,9604,6,14,3,19,50,65,-15,45
Airdrieon,9604,7,11,11,14,46,58,-12,44
Forfar,9604,8,10,5,21,38,65,-27,35
Queen's Park,9604,9,7,10,19,42,74,-32,31
Albion,9604,10,8,6,22,59,82,-23,30
Raith,9605,1,23,8,5,72,32,40,77
Ayr,9605,2,24,4,8,94,44,50,76
Arbroath,9605,3,18,8,10,74,48,26,62
Alloa,9605,4,17,8,11,56,47,9,59
Stranraer,9605,5,15,5,16,55,65,-10,50
East Fife,9605,6,14,3,19,48,64,-16,45
Airdrieon,9605,7,10,12,14,46,59,-13,42
Forfar,9605,8,10,6,20,39,65,-26,36
Albion,9605,9,8,6,22,59,82,-23,30
Queen's Park,9605,10,6,10,20,39,76,-37,28
Raith,9606,1,23,8,5,69,32,37,77
Ayr,9606,2,24,4,8,95,44,51,76
Arbroath,9606,3,18,8,10,76,49,27,62
Alloa,9606,4,17,8,11,56,44,12,59
Stranraer,9606,5,15,5,16,56,66,-10,50
East Fife,9606,6,14,3,19,49,65,-16,45
Airdrieon,9606,7,10,12,14,47,60,-13,42
Forfar,9606,8,10,6,20,40,66,-26,36
Albion,9606,9,8,6,22,59,83,-24,30
Queen's Park,9606,10,6,10,20,40,78,-38,28
Raith,9607,1,23,8,5,69,32,37,77
Ayr,9607,2,24,4,8,94,45,49,76
Arbroath,9607,3,17,8,11,71,50,21,59
Alloa,9607,4,17,8,11,56,44,12,59
Stranraer,9607,5,15,6,15,56,65,-9,51
Airdrieon,9607,6,11,11,14,46,58,-12,44
East Fife,9607,7,13,4,19,48,65,-17,43
Forfar,9607,8,10,5,21,38,65,-27,35
Queen's Park,9607,9,7,10,19,41,73,-32,31
Albion,9607,10,8,6,22,60,82,-22,30
Ayr,9608,1,24,4,8,93,44,49,76
Raith,9608,2,22,9,5,69,33,36,75
Arbroath,9608,3,18,8,10,73,48,25,62
Alloa,9608,4,17,9,10,57,44,13,60
Stranraer,9608,5,15,6,15,55,64,-9,51
Airdrieon,9608,6,11,11,14,46,58,-12,44
East Fife,9608,7,13,4,19,47,64,-17,43
Forfar,9608,8,10,5,21,38,65,-27,35
Albion,9608,9,8,6,22,59,81,-22,30
Queen's Park,9608,10,6,10,20,39,75,-36,28
Ayr,9609,1,24,4,8,94,43,51,76
Raith,9609,2,22,9,5,69,33,36,75
Alloa,9609,3,17,9,10,57,44,13,60
Arbroath,9609,4,17,8,11,70,49,21,59
Stranraer,9609,5,15,5,16,56,66,-10,50
East Fife,9609,6,14,3,19,49,65,-16,45
Airdrieon,9609,7,11,11,14,47,58,-11,44
Forfar,9609,8,10,5,21,38,66,-28,35
Queen's Park,9609,9,7,10,19,40,72,-32,31
Albion,9609,10,8,6,22,58,82,-24,30
Ayr,9610,1,24,4,8,94,42,52,76
Raith,9610,2,22,8,6,68,35,33,74
Alloa,9610,3,18,8,10,59,43,16,62
Arbroath,9610,4,17,8,11,71,53,18,59
Stranraer,9610,5,15,5,16,57,67,-10,50
East Fife,9610,6,14,3,19,50,66,-16,45
Airdrieon,9610,7,10,11,15,46,60,-14,41
Forfar,9610,8,11,5,20,40,65,-25,38
Queen's Park,9610,9,7,10,19,44,73,-29,31
Albion,9610,10,8,6,22,57,82,-25,30
Raith,9611,1,23,8,5,70,33,37,77
Ayr,9611,2,24,4,8,95,42,53,76
Arbroath,9611,3,17,9,10,72,50,22,60
Alloa,9611,4,17,8,11,57,45,12,59
Stranraer,9611,5,15,6,15,55,64,-9,51
East Fife,9611,6,13,4,19,47,64,-17,43
Airdrieon,9611,7,10,11,15,45,59,-14,41
Forfar,9611,8,11,5,20,39,64,-25,38
Albion,9611,9,8,6,22,57,83,-26,30
Queen's Park,9611,10,6,11,19,41,74,-33,29
Ayr,9612,1,24,4,8,94,45,49,76
Raith,9612,2,22,9,5,69,33,36,75
Arbroath,9612,3,18,8,10,73,50,23,62
Alloa,9612,4,17,9,10,57,44,13,60
Stranraer,9612,5,16,5,15,58,65,-7,53
Airdrieon,9612,6,11,11,14,47,58,-11,44
East Fife,9612,7,13,3,20,48,67,-19,42
Forfar,9612,8,10,5,21,38,66,-28,35
Albion,9612,9,8,6,22,60,82,-22,30
Queen's Park,9612,10,6,10,20,41,75,-34,28
Raith,9613,1,23,8,5,71,33,38,77
Ayr,9613,2,24,4,8,93,43,50,76
Arbroath,9613,3,18,8,10,71,48,23,62
Alloa,9613,4,17,8,11,57,46,11,59
Stranraer,9613,5,16,5,15,58,64,-6,53
Airdrieon,9613,6,11,11,14,47,58,-11,44
East Fife,9613,7,13,3,20,47,67,-20,42
Forfar,9613,8,10,5,21,38,66,-28,35
Albion,9613,9,8,6,22,58,81,-23,30
Queen's Park,9613,10,6,10,20,39,73,-34,28
Raith,9614,1,23,8,5,71,32,39,77
Ayr,9614,2,24,4,8,95,44,51,76
Arbroath,9614,3,18,8,10,73,49,24,62
Alloa,9614,4,17,8,11,56,46,10,59
Stranraer,9614,5,15,5,16,55,69,-14,50
East Fife,9614,6,14,3,19,52,64,-12,45
Airdrieon,9614,7,10,12,14,46,59,-13,42
Forfar,9614,8,10,6,20,39,65,-26,36
Albion,9614,9,8,6,22,59,83,-24,30
Queen's Park,9614,10,6,10,20,40,75,-35,28
Ayr,9615,1,24,4,8,94,43,51,76
Raith,9615,2,22,9,5,70,34,36,75
Alloa,9615,3,17,9,10,58,45,13,60
Arbroath,9615,4,17,8,11,70,50,20,59
Stranraer,9615,5,15,5,16,56,66,-10,50
East Fife,9615,6,14,3,19,49,65,-16,45
Airdrieon,9615,7,11,11,14,46,58,-12,44
Forfar,9615,8,10,5,21,38,65,-27,35
Queen's Park,9615,9,7,10,19,41,72,-31,31
Albion,9615,10,8,6,22,58,82,-24,30
Raith,9616,1,23,8,5,70,33,37,77
Ayr,9616,2,24,4,8,94,45,49,76
Arbroath,9616,3,17,9,10,71,49,22,60
Alloa,9616,4,17,8,11,57,45,12,59
Stranraer,9616,5,16,5,15,57,64,-7,53
Airdrieon,9616,6,11,11,14,48,59,-11,44
East Fife,9616,7,13,3,20,47,66,-19,42
Forfar,9616,8,10,5,21,39,67,-28,35
Albion,9616,9,8,6,22,60,82,-22,30
Queen's Park,9616,10,6,11,19,40,73,-33,29
Raith,9617,1,23,8,5,70,33,37,77
Ayr,9617,2,24,4,8,95,42,53,76
Arbroath,9617,3,18,8,10,72,48,24,62
Alloa,9617,4,17,8,11,57,45,12,59
Stranraer,9617,5,15,5,16,56,66,-10,50
East Fife,9617,6,14,3,19,49,65,-16,45
Airdrieon,9617,7,10,11,15,47,62,-15,41
Forfar,9617,8,11,5,20,42,66,-24,38
Albion,9617,9,8,6,22,57,83,-26,30
Queen's Park,9617,10,6,10,20,39,74,-35,28
Ayr,9618,1,24,4,8,94,42,52,76
Raith,9618,2,22,9,5,68,32,36,75
Arbroath,9618,3,18,8,10,72,48,24,62
Alloa,9618,4,17,9,10,56,43,13,60
Stranraer,9618,5,16,5,15,56,64,-8,53
Airdrieon,9618,6,10,12,14,45,58,-13,42
East Fife,9618,7,13,3,20,47,65,-18,42
Forfar,9618,8,10,6,20,38,64,-26,36
Albion,9618,9,8,6,22,57,82,-25,30
Queen's Park,9618,10,6,10,20,39,74,-35,28
Raith,9619,1,23,8,5,71,32,39,77
Ayr,9619,2,24,4,8,97,45,52,76
Arbroath,9619,3,18,8,10,73,48,25,62
Alloa,9619,4,17,8,11,56,46,10,59
Stranraer,9619,5,15,5,16,55,65,-10,50
East Fife,9619,6,14,3,19,48,64,-16,45
Airdrieon,9619,7,10,11,15,45,60,-15,41
Forfar,9619,8,11,5,20,40,64,-24,38
Albion,9619,9,8,6,22,60,85,-25,30
Queen's Park,9619,10,6,10,20,39,75,-36,28
Raith,9620,1,23,8,5,69,32,37,77
Ayr,9620,2,23,4,9,91,44,47,73
Arbroath,9620,3,18,8,10,73,50,23,62
Alloa,9620,4,17,8,11,56,44,12,59
Stranraer,9620,5,16,5,15,58,66,-8,53
Airdrieon,9620,6,11,11,14,47,59,-12,44
East Fife,9620,7,13,3,20,49,67,-18,42
Forfar,9620,8,10,5,21,39,66,-27,35
Albion,9620,9,9,6,21,59,79,-20,33
Queen's Park,9620,10,6,10,20,41,75,-34,28
Raith,9621,1,23,8,5,73,34,39,77
Ayr,9621,2,24,4,8,94,44,50,76
Arbroath,9621,3,18,8,10,71,48,23,62
Alloa,9621,4,17,8,11,58,48,10,59
Stranraer,9621,5,15,5,16,55,66,-11,50
East Fife,9621,6,14,3,19,49,64,-15,45
Airdrieon,9621,7,11,11,14,46,58,-12,44
Forfar,9621,8,10,5,21,38,65,-27,35
Albion,9621,9,8,6,22,59,82,-23,30
Queen's Park,9621,10,6,10,20,39,73,-34,28
Raith,9622,1,22,9,5,69,33,36,75
Ayr,9622,2,23,5,8,92,44,48,74
Arbroath,9622,3,17,9,10,71,49,22,60
Alloa,9622,4,17,9,10,57,44,13,60
Stranraer,9622,5,15,6,15,57,66,-9,51
East Fife,9622,6,13,4,19,49,66,-17,43
Airdrieon,9622,7,10,11,15,45,59,-14,41
Forfar,9622,8,11,5,20,39,64,-25,38
Albion,9622,9,8,7,21,59,80,-21,31
Queen's Park,9622,10,6,11,19,40,73,-33,29
Raith,9623,1,23,8,5,69,32,37,77
Ayr,9623,2,24,4,8,93,42,51,76
Arbroath,9623,3,18,8,10,74,51,23,62
Alloa,9623,4,17,8,11,56,44,12,59
Stranraer,9623,5,16,5,15,56,64,-8,53
East Fife,9623,6,13,3,20,47,65,-18,42
Airdrieon,9623,7,10,11,15,48,62,-14,41
Forfar,9623,8,11,5,20,42,67,-25,38
Albion,9623,9,8,6,22,57,81,-24,30
Queen's Park,9623,10,6,10,20,42,76,-34,28
Ayr,9624,1,24,4,8,92,43,49,76
Raith,9624,2,22,9,5,69,33,36,75
Arbroath,9624,3,18,8,10,73,49,24,62
Alloa,9624,4,17,9,10,57,44,13,60
Stranraer,9624,5,15,5,16,55,66,-11,50
East Fife,9624,6,14,3,19,49,64,-15,45
Airdrieon,9624,7,10,11,15,47,61,-14,41
Forfar,9624,8,11,5,20,41,66,-25,38
Albion,9624,9,8,6,22,58,80,-22,30
Queen's Park,9624,10,6,10,20,40,75,-35,28
Raith,9625,1,22,9,5,69,33,36,75
Ayr,9625,2,23,4,9,91,45,46,73
Arbroath,9625,3,18,8,10,72,49,23,62
Alloa,9625,4,17,9,10,57,44,13,60
Stranraer,9625,5,15,5,16,56,66,-10,50
East Fife,9625,6,14,3,19,49,65,-16,45
Airdrieon,9625,7,11,11,14,48,59,-11,44
Forfar,9625,8,10,5,21,39,67,-28,35
Albion,9625,9,9,6,21,60,79,-19,33
Queen's Park,9625,10,6,10,20,40,74,-34,28
Raith,9626,1,23,8,5,72,35,37,77
Ayr,9626,2,23,5,8,95,47,48,74
Arbroath,9626,3,18,8,10,74,49,25,62
Alloa,9626,4,17,8,11,59,47,12,59
Stranraer,9626,5,16,5,15,58,65,-7,53
Airdrieon,9626,6,10,12,14,46,59,-13,42
East Fife,9626,7,13,3,20,48,67,-19,42
Forfar,9626,8,10,6,20,39,65,-26,36
Albion,9626,9,8,7,21,62,83,-21,31
Queen's Park,9626,10,6,10,20,40,76,-36,28
Raith,9627,1,23,8,5,71,34,37,77
Ayr,9627,2,24,4,8,95,45,50,76
Arbroath,9627,3,18,8,10,72,48,24,62
Alloa,9627,4,17,8,11,58,46,12,59
Stranraer,9627,5,15,5,16,55,65,-10,50
East Fife,9627,6,14,3,19,48,64,-16,45
Airdrieon,9627,7,11,11,14,48,58,-10,44
Forfar,9627,8,10,5,21,38,67,-29,35
Albion,9627,9,8,6,22,60,83,-23,30
Queen's Park,9627,10,6,10,20,39,74,-35,28
Ayr,9628,1,24,4,8,96,44,52,76
Raith,9628,2,22,9,5,68,32,36,75
Alloa,9628,3,17,9,10,56,43,13,60
Arbroath,9628,4,17,8,11,71,52,19,59
Stranraer,9628,5,15,5,16,55,66,-11,50
East Fife,9628,6,14,3,19,49,64,-15,45
Airdrieon,9628,7,11,11,14,47,58,-11,44
Forfar,9628,8,10,5,21,38,66,-28,35
Queen's Park,9628,9,7,10,19,43,73,-30,31
Albion,9628,10,8,6,22,59,84,-25,30
Raith,9629,1,22,9,5,69,33,36,75
Ayr,9629,2,23,5,8,91,43,48,74
Arbroath,9629,3,18,8,10,72,49,23,62
Alloa,9629,4,17,9,10,57,44,13,60
Stranraer,9629,5,15,5,16,55,65,-10,50
East Fife,9629,6,14,3,19,48,64,-16,45
Airdrieon,9629,7,11,11,14,48,59,-11,44
Forfar,9629,8,10,5,21,39,67,-28,35
Albion,9629,9,8,7,21,58,79,-21,31
Queen's Park,9629,10,6,10,20,40,74,-34,28
Raith,9630,1,22,9,5,71,35,36,75
Ayr,9630,2,23,4,9,92,46,46,73
Arbroath,9630,3,18,8,10,71,48,23,62
Alloa,9630,4,17,9,10,59,46,13,60
Stranraer,9630,5,15,6,15,55,64,-9,51
East Fife,9630,6,13,4,19,47,64,-17,43
Airdrieon,9630,7,10,12,14,46,59,-13,42
Forfar,9630,8,10,6,20,39,65,-26,36
Albion,9630,9,9,6,21,61,80,-19,33
Queen's Park,9630,10,6,10,20,39,73,-34,28
Raith,9631,1,22,9,5,68,32,36,75
Ayr,9631,2,23,5,8,91,43,48,74
Alloa,9631,3,17,9,10,56,43,13,60
Arbroath,9631,4,17,8,11,72,52,20,59
Stranraer,9631,5,16,5,15,57,65,-8,53
Airdrieon,9631,6,10,12,14,46,59,-13,42
East Fife,9631,7,13,3,20,48,66,-18,42
Forfar,9631,8,10,6,20,39,65,-26,36
Albion,9631,9,8,7,21,58,79,-21,31
Queen's Park,9631,10,7,10,19,43,74,-31,31
Raith,9632,1,23,8,5,73,32,41,77
Ayr,9632,2,24,4,8,94,42,52,76
Arbroath,9632,3,17,8,11,70,52,18,59
Alloa,9632,4,17,8,11,56,48,8,59
Stranraer,9632,5,15,5,16,56,67,-11,50
East Fife,9632,6,14,3,19,50,65,-15,45
Airdrieon,9632,7,11,11,14,48,58,-10,44
Forfar,9632,8,10,5,21,38,67,-29,35
Queen's Park,9632,9,7,10,19,43,72,-29,31
Albion,9632,10,8,6,22,57,82,-25,30
Ayr,9633,1,24,4,8,94,43,51,76
Raith,9633,2,22,8,6,68,35,33,74
Arbroath,9633,3,18,8,10,72,49,23,62
Alloa,9633,4,18,8,10,59,43,16,62
Stranraer,9633,5,15,5,16,55,65,-10,50
East Fife,9633,6,14,3,19,48,64,-16,45
Airdrieon,9633,7,11,11,14,47,59,-12,44
Forfar,9633,8,10,5,21,39,66,-27,35
Albion,9633,9,8,6,22,58,82,-24,30
Queen's Park,9633,10,6,10,20,40,74,-34,28
Ayr,9634,1,23,5,8,94,46,48,74
Raith,9634,2,22,8,6,68,33,35,74
Arbroath,9634,3,18,8,10,72,49,23,62
Alloa,9634,4,18,8,10,57,43,14,62
Stranraer,9634,5,15,6,15,58,67,-9,51
Airdrieon,9634,6,11,11,14,48,60,-12,44
East Fife,9634,7,13,4,19,50,67,-17,43
Forfar,9634,8,10,5,21,40,67,-27,35
Albion,9634,9,8,7,21,61,82,-21,31
Queen's Park,9634,10,6,10,20,40,74,-34,28
Raith,9635,1,23,8,5,72,32,40,77
Ayr,9635,2,24,4,8,95,43,52,76
Arbroath,9635,3,17,9,10,71,49,22,60
Alloa,9635,4,17,8,11,56,47,9,59
Stranraer,9635,5,16,5,15,58,65,-7,53
Airdrieon,9635,6,11,11,14,50,58,-8,44
East Fife,9635,7,13,3,20,48,67,-19,42
Forfar,9635,8,10,5,21,38,69,-31,35
Albion,9635,9,8,6,22,58,83,-25,30
Queen's Park,9635,10,6,11,19,40,73,-33,29
Raith,9636,1,22,9,5,69,33,36,75
Ayr,9636,2,23,5,8,90,42,48,74
Arbroath,9636,3,18,8,10,75,52,23,62
Alloa,9636,4,17,9,10,57,44,13,60
Stranraer,9636,5,15,6,15,57,66,-9,51
East Fife,9636,6,13,4,19,49,66,-17,43
Airdrieon,9636,7,10,12,14,47,60,-13,42
Forfar,9636,8,10,6,20,40,66,-26,36
Albion,9636,9,8,7,21,57,78,-21,31
Queen's Park,9636,10,6,10,20,43,77,-34,28
Ayr,9637,1,24,4,8,94,44,50,76
Raith,9637,2,22,9,5,69,33,36,75
Alloa,9637,3,17,9,10,57,44,13,60
Arbroath,9637,4,17,8,11,73,52,21,59
Stranraer,9637,5,15,5,16,55,65,-10,50
East Fife,9637,6,14,3,19,48,64,-16,45
Airdrieon,9637,7,11,11,14,48,60,-12,44
Forfar,9637,8,10,5,21,40,67,-27,35
Queen's Park,9637,9,7,10,19,43,75,-32,31
Albion,9637,10,8,6,22,59,82,-23,30
Raith,9638,1,23,8,5,71,33,38,77
Ayr,9638,2,23,4,9,92,46,46,73
Arbroath,9638,3,17,8,11,70,49,21,59
Alloa,9638,4,17,8,11,57,46,11,59
Stranraer,9638,5,15,6,15,56,65,-9,51
East Fife,9638,6,13,4,19,48,65,-17,43
Airdrieon,9638,7,10,11,15,46,60,-14,41
Forfar,9638,8,11,5,20,40,65,-25,38
Albion,9638,9,9,6,21,61,80,-19,33
Queen's Park,9638,10,7,10,19,40,72,-32,31
Ayr,9639,1,24,4,8,92,43,49,76
Raith,9639,2,22,9,5,68,32,36,75
Arbroath,9639,3,18,8,10,74,48,26,62
Alloa,9639,4,17,9,10,56,43,13,60
Stranraer,9639,5,15,6,15,55,64,-9,51
East Fife,9639,6,13,4,19,47,64,-17,43
Airdrieon,9639,7,10,12,14,45,58,-13,42
Forfar,9639,8,10,6,20,38,64,-26,36
Albion,9639,9,8,6,22,58,80,-22,30
Queen's Park,9639,10,6,10,20,39,76,-37,28
Ayr,9640,1,24,4,8,96,42,54,76
Raith,9640,2,22,8,6,69,34,35,74
Arbroath,9640,3,18,8,10,71,48,23,62
Alloa,9640,4,18,8,10,58,44,14,62
Stranraer,9640,5,16,5,15,57,65,-8,53
Airdrieon,9640,6,11,11,14,48,59,-11,44
East Fife,9640,7,13,3,20,48,66,-18,42
Forfar,9640,8,10,5,21,39,67,-28,35
Albion,9640,9,8,6,22,57,84,-27,30
Queen's Park,9640,10,6,10,20,39,73,-34,28
Ayr,9641,1,24,4,8,95,43,52,76
Raith,9641,2,22,8,6,69,35,34,74
Alloa,9641,3,18,8,10,59,44,15,62
Arbroath,9641,4,17,8,11,71,51,20,59
Stranraer,9641,5,15,5,16,57,67,-10,50
East Fife,9641,6,14,3,19,50,66,-16,45
Airdrieon,9641,7,10,11,15,45,59,-14,41
Forfar,9641,8,11,5,20,39,64,-25,38
Queen's Park,9641,9,7,10,19,42,73,-31,31
Albion,9641,10,8,6,22,58,83,-25,30
Raith,9642,1,23,8,5,71,33,38,77
Ayr,9642,2,24,4,8,94,42,52,76
Arbroath,9642,3,18,8,10,72,49,23,62
Alloa,9642,4,17,8,11,57,46,11,59
Stranraer,9642,5,15,6,15,56,65,-9,51
Airdrieon,9642,6,11,11,14,46,58,-12,44
East Fife,9642,7,13,4,19,48,65,-17,43
Forfar,9642,8,10,5,21,38,65,-27,35
Albion,9642,9,8,6,22,57,82,-25,30
Queen's Park,9642,10,6,10,20,40,74,-34,28
Raith,9643,1,23,8,5,73,33,40,77
Ayr,9643,2,24,4,8,94,42,52,76
Arbroath,9643,3,17,8,11,70,49,21,59
Alloa,9643,4,17,8,11,57,48,9,59
Stranraer,9643,5,15,5,16,55,65,-10,50
East Fife,9643,6,14,3,19,48,64,-16,45
Airdrieon,9643,7,10,11,15,46,60,-14,41
Forfar,9643,8,11,5,20,40,65,-25,38
Queen's Park,9643,9,7,10,19,40,72,-32,31
Albion,9643,10,8,6,22,57,82,-25,30
Raith,9644,1,23,8,5,71,34,37,77
Ayr,9644,2,24,4,8,97,42,55,76
Arbroath,9644,3,18,8,10,74,51,23,62
Alloa,9644,4,17,8,11,58,46,12,59
Stranraer,9644,5,15,6,15,59,68,-9,51
East Fife,9644,6,13,4,19,51,68,-17,43
Airdrieon,9644,7,10,12,14,46,59,-13,42
Forfar,9644,8,10,6,20,39,65,-26,36
Albion,9644,9,8,6,22,57,85,-28,30
Queen's Park,9644,10,6,10,20,42,76,-34,28
Raith,9645,1,23,8,5,69,32,37,77
Ayr,9645,2,24,4,8,93,44,49,76
Arbroath,9645,3,18,8,10,74,49,25,62
Alloa,9645,4,17,8,11,56,44,12,59
Stranraer,9645,5,15,6,15,58,67,-9,51
Airdrieon,9645,6,11,11,14,47,59,-12,44
East Fife,9645,7,13,4,19,50,67,-17,43
Forfar,9645,8,10,5,21,39,66,-27,35
Albion,9645,9,8,6,22,59,81,-22,30
Queen's Park,9645,10,6,10,20,40,76,-36,28
Ayr,9646,1,23,5,8,92,44,48,74
Raith,9646,2,22,8,6,68,33,35,74
Alloa,9646,3,18,8,10,57,43,14,62
Arbroath,9646,4,17,8,11,72,51,21,59
Stranraer,9646,5,15,6,15,55,64,-9,51
Airdrieon,9646,6,11,11,14,47,59,-12,44
East Fife,9646,7,13,4,19,47,64,-17,43
Forfar,9646,8,10,5,21,39,66,-27,35
Albion,9646,9,8,7,21,59,80,-21,31
Queen's Park,9646,10,7,10,19,42,74,-32,31
Raith,9647,1,23,8,5,73,33,40,77
Ayr,9647,2,24,4,8,94,44,50,76
Arbroath,9647,3,17,9,10,71,49,22,60
Alloa,9647,4,17,8,11,57,48,9,59
Stranraer,9647,5,16,5,15,57,64,-7,53
East Fife,9647,6,13,3,20,47,66,-19,42
Airdrieon,9647,7,10,11,15,46,60,-14,41
Forfar,9647,8,11,5,20,40,65,-25,38
Albion,9647,9,8,6,22,59,82,-23,30
Queen's Park,9647,10,6,11,19,40,73,-33,29
Raith,9648,1,23,8,5,71,32,39,77
Ayr,9648,2,24,4,8,95,42,53,76
Arbroath,9648,3,17,8,11,71,51,20,59
Alloa,9648,4,17,8,11,56,46,10,59
Stranraer,9648,5,15,5,16,57,67,-10,50
East Fife,9648,6,14,3,19,50,66,-16,45
Airdrieon,9648,7,11,11,14,46,58,-12,44
Forfar,9648,8,10,5,21,38,65,-27,35
Queen's Park,9648,9,7,10,19,42,73,-31,31
Albion,9648,10,8,6,22,57,83,-26,30
Ayr,9649,1,24,4,8,94,43,51,76
Raith,9649,2,22,9,5,69,33,36,75
Alloa,9649,3,17,9,10,57,44,13,60
Arbroath,9649,4,17,8,11,72,51,21,59
Stranraer,9649,5,15,6,15,55,64,-9,51
East Fife,9649,6,13,4,19,47,64,-17,43
Airdrieon,9649,7,10,12,14,46,59,-13,42
Forfar,9649,8,10,6,20,39,65,-26,36
Queen's Park,9649,9,7,10,19,42,74,-32,31
Albion,9649,10,8,6,22,58,82,-24,30
Raith,9650,1,23,8,5,70,32,38,77
Ayr,9650,2,24,4,8,98,43,55,76
Arbroath,9650,3,18,8,10,74,50,24,62
Alloa,9650,4,17,8,11,56,45,11,59
Stranraer,9650,5,16,5,15,57,65,-8,53
Airdrieon,9650,6,10,12,14,47,60,-13,42
East Fife,9650,7,13,3,20,48,66,-18,42
Forfar,9650,8,10,6,20,40,66,-26,36
Albion,9650,9,8,6,22,58,86,-28,30
Queen's Park,9650,10,6,10,20,41,76,-35,28
Ayr,9651,1,23,5,8,91,43,48,74
Raith,9651,2,22,8,6,69,34,35,74
Alloa,9651,3,18,8,10,58,44,14,62
Arbroath,9651,4,17,9,10,73,51,22,60
Stranraer,9651,5,15,5,16,55,65,-10,50
East Fife,9651,6,14,3,19,48,64,-16,45
Airdrieon,9651,7,11,11,14,46,58,-12,44
Forfar,9651,8,10,5,21,38,65,-27,35
Albion,9651,9,8,7,21,58,79,-21,31
Queen's Park,9651,10,6,11,19,42,75,-33,29
Raith,9652,1,22,9,5,70,34,36,75
Ayr,9652,2,23,5,8,93,45,48,74
Arbroath,9652,3,18,8,10,72,49,23,62
Alloa,9652,4,17,9,10,58,45,13,60
Stranraer,9652,5,15,5,16,57,69,-12,50
East Fife,9652,6,14,3,19,52,66,-14,45
Airdrieon,9652,7,10,11,15,46,60,-14,41
Forfar,9652,8,11,5,20,40,65,-25,38
Albion,9652,9,8,7,21,60,81,-21,31
Queen's Park,9652,10,6,10,20,40,74,-34,28
Raith,9653,1,23,8,5,71,34,37,77
Ayr,9653,2,24,4,8,95,42,53,76
Arbroath,9653,3,18,8,10,73,49,24,62
Alloa,9653,4,17,8,11,58,46,12,59
Stranraer,9653,5,15,6,15,57,66,-9,51
Airdrieon,9653,6,11,11,14,48,58,-10,44
East Fife,9653,7,13,4,19,49,66,-17,43
Forfar,9653,8,10,5,21,38,67,-29,35
Albion,9653,9,8,6,22,57,83,-26,30
Queen's Park,9653,10,6,10,20,40,75,-35,28
Raith,9654,1,23,8,5,69,32,37,77
Ayr,9654,2,24,4,8,93,43,50,76
Arbroath,9654,3,18,8,10,75,50,25,62
Alloa,9654,4,17,8,11,56,44,12,59
Stranraer,9654,5,16,5,15,57,65,-8,53
Airdrieon,9654,6,11,11,14,47,59,-12,44
East Fife,9654,7,13,3,20,48,66,-18,42
Forfar,9654,8,10,5,21,39,66,-27,35
Albion,9654,9,8,6,22,58,81,-23,30
Queen's Park,9654,10,6,10,20,41,77,-36,28
Raith,9655,1,23,8,5,73,35,38,77
Ayr,9655,2,24,4,8,97,45,52,76
Arbroath,9655,3,18,8,10,73,50,23,62
Alloa,9655,4,17,8,11,59,48,11,59
Stranraer,9655,5,15,6,15,56,65,-9,51
East Fife,9655,6,13,4,19,48,65,-17,43
Airdrieon,9655,7,10,11,15,45,59,-14,41
Forfar,9655,8,11,5,20,39,64,-25,38
Albion,9655,9,8,6,22,60,85,-25,30
Queen's Park,9655,10,6,10,20,41,75,-34,28
Raith,9656,1,23,8,5,69,32,37,77
Ayr,9656,2,24,4,8,94,44,50,76
Arbroath,9656,3,18,8,10,73,50,23,62
Alloa,9656,4,17,8,11,56,44,12,59
Stranraer,9656,5,15,6,15,57,66,-9,51
Airdrieon,9656,6,11,11,14,47,59,-12,44
East Fife,9656,7,13,4,19,49,66,-17,43
Forfar,9656,8,10,5,21,39,66,-27,35
Albion,9656,9,8,6,22,59,82,-23,30
Queen's Park,9656,10,6,10,20,41,75,-34,28
Ayr,9657,1,24,4,8,94,45,49,76
Raith,9657,2,22,9,5,70,34,36,75
Arbroath,9657,3,18,8,10,73,48,25,62
Alloa,9657,4,17,9,10,58,45,13,60
Stranraer,9657,5,16,5,15,56,64,-8,53
Airdrieon,9657,6,10,12,14,48,61,-13,42
East Fife,9657,7,13,3,20,47,65,-18,42
Forfar,9657,8,10,6,20,41,67,-26,36
Albion,9657,9,8,6,22,60,82,-22,30
Queen's Park,9657,10,6,10,20,39,75,-36,28
Raith,9658,1,23,8,5,70,33,37,77
Ayr,9658,2,24,4,8,94,44,50,76
Arbroath,9658,3,18,8,10,72,49,23,62
Alloa,9658,4,17,8,11,57,45,12,59
Stranraer,9658,5,15,5,16,57,67,-10,50
East Fife,9658,6,14,3,19,50,66,-16,45
Airdrieon,9658,7,11,11,14,50,58,-8,44
Forfar,9658,8,10,5,21,38,69,-31,35
Albion,9658,9,8,6,22,59,82,-23,30
Queen's Park,9658,10,6,10,20,40,74,-34,28
Raith,9659,1,23,8,5,71,32,39,77
Ayr,9659,2,24,4,8,96,43,53,76
Arbroath,9659,3,18,8,10,75,49,26,62
Alloa,9659,4,17,8,11,56,46,10,59
Stranraer,9659,5,16,5,15,59,67,-8,53
Airdrieon,9659,6,11,11,14,46,58,-12,44
East Fife,9659,7,13,3,20,50,68,-18,42
Forfar,9659,8,10,5,21,38,65,-27,35
Albion,9659,9,8,6,22,58,84,-26,30
Queen's Park,9659,10,6,10,20,40,77,-37,28
Raith,9660,1,23,8,5,70,33,37,77
Ayr,9660,2,24,4,8,94,44,50,76
Arbroath,9660,3,18,8,10,74,49,25,62
Alloa,9660,4,17,8,11,57,45,12,59
Stranraer,9660,5,16,5,15,58,66,-8,53
Airdrieon,9660,6,11,11,14,48,60,-12,44
East Fife,9660,7,13,3,20,49,67,-18,42
Forfar,9660,8,10,5,21,40,67,-27,35
Albion,9660,9,8,6,22,59,82,-23,30
Queen's Park,9660,10,6,10,20,40,76,-36,28
Raith,9661,1,22,9,5,69,33,36,75
Ayr,9661,2,23,4,9,92,46,46,73
Arbroath,9661,3,18,8,10,73,49,24,62
Alloa,9661,4,17,9,10,57,44,13,60
Stranraer,9661,5,15,5,16,56,68,-12,50
East Fife,9661,6,14,3,19,51,65,-14,45
Airdrieon,9661,7,11,11,14,47,58,-11,44
Forfar,9661,8,10,5,21,38,66,-28,35
Albion,9661,9,9,6,21,61,80,-19,33
Queen's Park,9661,10,6,10,20,40,75,-35,28
Ayr,9662,1,24,4,8,92,42,50,76
Raith,9662,2,22,9,5,69,33,36,75
Arbroath,9662,3,17,9,10,71,49,22,60
Alloa,9662,4,17,9,10,57,44,13,60
Stranraer,9662,5,15,6,15,55,64,-9,51
East Fife,9662,6,13,4,19,47,64,-17,43
Airdrieon,9662,7,10,12,14,46,59,-13,42
Forfar,9662,8,10,6,20,39,65,-26,36
Albion,9662,9,8,6,22,57,80,-23,30
Queen's Park,9662,10,6,11,19,40,73,-33,29
Raith,9663,1,23,8,5,69,32,37,77
Ayr,9663,2,24,4,8,92,43,49,76
Arbroath,9663,3,18,8,10,73,50,23,62
Alloa,9663,4,17,8,11,56,44,12,59
Stranraer,9663,5,15,5,16,57,67,-10,50
East Fife,9663,6,14,3,19,50,66,-16,45
Airdrieon,9663,7,10,11,15,45,59,-14,41
Forfar,9663,8,11,5,20,39,64,-25,38
Albion,9663,9,8,6,22,58,80,-22,30
Queen's Park,9663,10,6,10,20,41,75,-34,28
Raith,9664,1,23,8,5,71,33,38,77
Ayr,9664,2,24,4,8,92,42,50,76
Arbroath,9664,3,18,8,10,73,48,25,62
Alloa,9664,4,17,8,11,57,46,11,59
Stranraer,9664,5,15,5,16,55,66,-11,50
East Fife,9664,6,14,3,19,49,64,-15,45
Airdrieon,9664,7,10,11,15,46,60,-14,41
Forfar,9664,8,11,5,20,40,65,-25,38
Albion,9664,9,8,6,22,57,80,-23,30
Queen's Park,9664,10,6,10,20,39,75,-36,28
Raith,9665,1,23,8,5,69,32,37,77
Ayr,9665,2,24,4,8,94,45,49,76
Arbroath,9665,3,17,9,10,72,50,22,60
Alloa,9665,4,17,8,11,56,44,12,59
Stranraer,9665,5,15,5,16,58,69,-11,50
East Fife,9665,6,14,3,19,52,67,-15,45
Airdrieon,9665,7,11,11,14,46,58,-12,44
Forfar,9665,8,10,5,21,38,65,-27,35
Albion,9665,9,8,6,22,60,82,-22,30
Queen's Park,9665,10,6,11,19,41,74,-33,29
Ayr,9666,1,24,4,8,97,42,55,76
Raith,9666,2,22,9,5,68,32,36,75
Alloa,9666,3,17,9,10,56,43,13,60
Arbroath,9666,4,17,8,11,71,52,19,59
Stranraer,9666,5,16,5,15,58,65,-7,53
Airdrieon,9666,6,11,11,14,48,60,-12,44
East Fife,9666,7,13,3,20,48,67,-19,42
Forfar,9666,8,10,5,21,40,67,-27,35
Queen's Park,9666,9,7,10,19,43,73,-30,31
Albion,9666,10,8,6,22,57,85,-28,30
Raith,9667,1,23,8,5,71,33,38,77
Ayr,9667,2,24,4,8,96,43,53,76
Arbroath,9667,3,18,8,10,72,48,24,62
Alloa,9667,4,17,8,11,57,46,11,59
Stranraer,9667,5,16,5,15,56,64,-8,53
Airdrieon,9667,6,11,11,14,48,59,-11,44
East Fife,9667,7,13,3,20,47,65,-18,42
Forfar,9667,8,10,5,21,39,67,-28,35
Albion,9667,9,8,6,22,58,84,-26,30
Queen's Park,9667,10,6,10,20,39,74,-35,28
Ayr,9668,1,24,4,8,93,43,50,76
Raith,9668,2,22,8,6,68,33,35,74
Alloa,9668,3,18,8,10,57,43,14,62
Arbroath,9668,4,17,9,10,71,49,22,60
Stranraer,9668,5,15,5,16,55,70,-15,50
East Fife,9668,6,14,3,19,53,64,-11,45
Airdrieon,9668,7,11,11,14,48,59,-11,44
Forfar,9668,8,10,5,21,39,67,-28,35
Albion,9668,9,8,6,22,58,81,-23,30
Queen's Park,9668,10,6,11,19,40,73,-33,29
Raith,9669,1,23,8,5,70,32,38,77
Ayr,9669,2,24,4,8,93,44,49,76
Arbroath,9669,3,17,9,10,72,50,22,60
Alloa,9669,4,17,8,11,56,45,11,59
Stranraer,9669,5,15,5,16,57,68,-11,50
East Fife,9669,6,14,3,19,51,66,-15,45
Airdrieon,9669,7,11,11,14,48,58,-10,44
Forfar,9669,8,10,5,21,38,67,-29,35
Albion,9669,9,8,6,22,59,81,-22,30
Queen's Park,9669,10,6,11,19,41,74,-33,29
Ayr,9670,1,24,4,8,93,42,51,76
Raith,9670,2,22,8,6,68,35,33,74
Alloa,9670,3,18,8,10,59,43,16,62
Arbroath,9670,4,17,8,11,72,52,20,59
Stranraer,9670,5,15,6,15,58,67,-9,51
Airdrieon,9670,6,11,11,14,47,58,-11,44
East Fife,9670,7,13,4,19,50,67,-17,43
Forfar,9670,8,10,5,21,38,66,-28,35
Queen's Park,9670,9,7,10,19,43,74,-31,31
Albion,9670,10,8,6,22,57,81,-24,30
Raith,9671,1,23,8,5,72,33,39,77
Ayr,9671,2,24,4,8,92,42,50,76
Arbroath,9671,3,17,8,11,71,50,21,59
Alloa,9671,4,17,8,11,57,47,10,59
Stranraer,9671,5,15,5,16,55,66,-11,50
East Fife,9671,6,14,3,19,49,64,-15,45
Airdrieon,9671,7,10,11,15,47,61,-14,41
Forfar,9671,8,11,5,20,41,66,-25,38
Queen's Park,9671,9,7,10,19,41,73,-32,31
Albion,9671,10,8,6,22,57,80,-23,30
Ayr,9672,1,24,4,8,94,43,51,76
Raith,9672,2,22,9,5,69,33,36,75
Arbroath,9672,3,17,9,10,71,49,22,60
Alloa,9672,4,17,9,10,57,44,13,60
Stranraer,9672,5,15,6,15,56,65,-9,51
Airdrieon,9672,6,11,11,14,48,60,-12,44
East Fife,9672,7,13,4,19,48,65,-17,43
Forfar,9672,8,10,5,21,40,67,-27,35
Albion,9672,9,8,6,22,58,82,-24,30
Queen's Park,9672,10,6,11,19,40,73,-33,29
Raith,9673,1,23,8,5,70,33,37,77
Ayr,9673,2,23,5,8,93,45,48,74
Arbroath,9673,3,18,8,10,73,48,25,62
Alloa,9673,4,17,8,11,57,45,12,59
Stranraer,9673,5,15,5,16,55,67,-12,50
East Fife,9673,6,14,3,19,50,64,-14,45
Airdrieon,9673,7,11,11,14,46,58,-12,44
Forfar,9673,8,10,5,21,38,65,-27,35
Albion,9673,9,8,7,21,60,81,-21,31
Queen's Park,9673,10,6,10,20,39,75,-36,28
Raith,9674,1,23,8,5,74,32,42,77
Ayr,9674,2,24,4,8,93,44,49,76
Arbroath,9674,3,17,8,11,70,49,21,59
Alloa,9674,4,17,8,11,56,49,7,59
Stranraer,9674,5,15,5,16,56,67,-11,50
East Fife,9674,6,14,3,19,50,65,-15,45
Airdrieon,9674,7,10,11,15,47,61,-14,41
Forfar,9674,8,11,5,20,41,66,-25,38
Queen's Park,9674,9,7,10,19,40,72,-32,31
Albion,9674,10,8,6,22,59,81,-22,30
Raith,9675,1,23,8,5,69,32,37,77
Ayr,9675,2,24,4,8,97,43,54,76
Arbroath,9675,3,17,9,10,70,48,22,60
Alloa,9675,4,17,8,11,56,44,12,59
Stranraer,9675,5,15,5,16,56,66,-10,50
East Fife,9675,6,14,3,19,49,65,-16,45
Airdrieon,9675,7,10,12,14,45,58,-13,42
Forfar,9675,8,10,6,20,38,64,-26,36
Albion,9675,9,8,6,22,58,85,-27,30
Queen's Park,9675,10,6,11,19,39,72,-33,29
Raith,9676,1,23,8,5,69,32,37,77
Ayr,9676,2,24,4,8,94,44,50,76
Arbroath,9676,3,18,8,10,71,48,23,62
Alloa,9676,4,17,8,11,56,44,12,59
Stranraer,9676,5,15,5,16,56,66,-10,50
East Fife,9676,6,14,3,19,49,65,-16,45
Airdrieon,9676,7,10,12,14,46,59,-13,42
Forfar,9676,8,10,6,20,39,65,-26,36
Albion,9676,9,8,6,22,59,82,-23,30
Queen's Park,9676,10,6,10,20,39,73,-34,28
Raith,9677,1,23,8,5,71,34,37,77
Ayr,9677,2,24,4,8,92,43,49,76
Arbroath,9677,3,18,8,10,72,49,23,62
Alloa,9677,4,17,8,11,58,46,12,59
Stranraer,9677,5,16,5,15,58,65,-7,53
Airdrieon,9677,6,11,11,14,47,58,-11,44
East Fife,9677,7,13,3,20,48,67,-19,42
Forfar,9677,8,10,5,21,38,66,-28,35
Albion,9677,9,8,6,22,58,80,-22,30
Queen's Park,9677,10,6,10,20,40,74,-34,28
Ayr,9678,1,24,4,8,99,44,55,76
Raith,9678,2,22,9,5,68,32,36,75
Arbroath,9678,3,17,9,10,71,49,22,60
Alloa,9678,4,17,9,10,56,43,13,60
Stranraer,9678,5,16,5,15,58,66,-8,53
Airdrieon,9678,6,11,11,14,47,59,-12,44
East Fife,9678,7,13,3,20,49,67,-18,42
Forfar,9678,8,10,5,21,39,66,-27,35
Albion,9678,9,8,6,22,59,87,-28,30
Queen's Park,9678,10,6,11,19,40,73,-33,29
Ayr,9679,1,24,4,8,96,44,52,76
Raith,9679,2,22,8,6,68,34,34,74
Alloa,9679,3,18,8,10,58,43,15,62
Arbroath,9679,4,17,8,11,71,51,20,59
Stranraer,9679,5,15,5,16,57,68,-11,50
East Fife,9679,6,14,3,19,51,66,-15,45
Airdrieon,9679,7,11,11,14,48,59,-11,44
Forfar,9679,8,10,5,21,39,67,-28,35
Queen's Park,9679,9,7,10,19,42,73,-31,31
Albion,9679,10,8,6,22,59,84,-25,30
Raith,9680,1,23,8,5,73,32,41,77
Ayr,9680,2,24,4,8,95,42,53,76
Arbroath,9680,3,17,8,11,71,50,21,59
Alloa,9680,4,17,8,11,56,48,8,59
Stranraer,9680,5,16,5,15,56,64,-8,53
Airdrieon,9680,6,11,11,14,48,60,-12,44
East Fife,9680,7,13,3,20,47,65,-18,42
Forfar,9680,8,10,5,21,40,67,-27,35
Queen's Park,9680,9,7,10,19,41,73,-32,31
Albion,9680,10,8,6,22,57,83,-26,30
Ayr,9681,1,23,5,8,93,45,48,74
Raith,9681,2,22,8,6,69,34,35,74
Alloa,9681,3,18,8,10,58,44,14,62
Arbroath,9681,4,17,8,11,71,50,21,59
Stranraer,9681,5,16,5,15,58,66,-8,53
East Fife,9681,6,13,3,20,49,67,-18,42
Airdrieon,9681,7,10,11,15,45,59,-14,41
Forfar,9681,8,11,5,20,39,64,-25,38
Albion,9681,9,8,7,21,60,81,-21,31
Queen's Park,9681,10,7,10,19,41,73,-32,31
Raith,9682,1,23,8,5,71,32,39,77
Ayr,9682,2,24,4,8,95,43,52,76
Arbroath,9682,3,17,8,11,72,51,21,59
Alloa,9682,4,17,8,11,56,46,10,59
Stranraer,9682,5,15,5,16,56,66,-10,50
East Fife,9682,6,14,3,19,49,65,-16,45
Airdrieon,9682,7,11,11,14,48,60,-12,44
Forfar,9682,8,10,5,21,40,67,-27,35
Queen's Park,9682,9,7,10,19,42,74,-32,31
Albion,9682,10,8,6,22,58,83,-25,30
Ayr,9683,1,24,4,8,93,42,51,76
Raith,9683,2,22,9,5,68,32,36,75
Arbroath,9683,3,17,9,10,73,51,22,60
Alloa,9683,4,17,9,10,56,43,13,60
Stranraer,9683,5,15,5,16,57,68,-11,50
East Fife,9683,6,14,3,19,51,66,-15,45
Airdrieon,9683,7,10,12,14,46,59,-13,42
Forfar,9683,8,10,6,20,39,65,-26,36
Albion,9683,9,8,6,22,57,81,-24,30
Queen's Park,9683,10,6,11,19,42,75,-33,29
Ayr,9684,1,24,4,8,92,42,50,76
Raith,9684,2,22,8,6,69,34,35,74
Arbroath,9684,3,18,8,10,72,49,23,62
Alloa,9684,4,18,8,10,58,44,14,62
Stranraer,9684,5,16,5,15,58,65,-7,53
East Fife,9684,6,13,3,20,48,67,-19,42
Airdrieon,9684,7,10,11,15,45,59,-14,41
Forfar,9684,8,11,5,20,39,64,-25,38
Albion,9684,9,8,6,22,57,80,-23,30
Queen's Park,9684,10,6,10,20,40,74,-34,28
Raith,9685,1,23,8,5,72,32,40,77
Ayr,9685,2,24,4,8,93,43,50,76
Arbroath,9685,3,18,8,10,72,49,23,62
Alloa,9685,4,17,8,11,56,47,9,59
Stranraer,9685,5,15,5,16,56,67,-11,50
East Fife,9685,6,14,3,19,50,65,-15,45
Airdrieon,9685,7,10,12,14,47,60,-13,42
Forfar,9685,8,10,6,20,40,66,-26,36
Albion,9685,9,8,6,22,58,81,-23,30
Queen's Park,9685,10,6,10,20,40,74,-34,28
Raith,9686,1,23,8,5,71,33,38,77
Ayr,9686,2,24,4,8,94,43,51,76
Arbroath,9686,3,18,8,10,72,49,23,62
Alloa,9686,4,17,8,11,57,46,11,59
Stranraer,9686,5,16,5,15,57,65,-8,53
Airdrieon,9686,6,11,11,14,46,58,-12,44
East Fife,9686,7,13,3,20,48,66,-18,42
Forfar,9686,8,10,5,21,38,65,-27,35
Albion,9686,9,8,6,22,58,82,-24,30
Queen's Park,9686,10,6,10,20,40,74,-34,28
Raith,9687,1,23,8,5,70,33,37,77
Ayr,9687,2,24,4,8,96,43,53,76
Arbroath,9687,3,17,9,10,71,49,22,60
Alloa,9687,4,17,8,11,57,45,12,59
Stranraer,9687,5,15,6,15,57,66,-9,51
Airdrieon,9687,6,11,11,14,47,59,-12,44
East Fife,9687,7,13,4,19,49,66,-17,43
Forfar,9687,8,10,5,21,39,66,-27,35
Albion,9687,9,8,6,22,58,84,-26,30
Queen's Park,9687,10,6,11,19,40,73,-33,29
Raith,9688,1,23,8,5,71,33,38,77
Ayr,9688,2,24,4,8,92,42,50,76
Arbroath,9688,3,18,8,10,72,48,24,62
Alloa,9688,4,17,8,11,57,46,11,59
Stranraer,9688,5,15,5,16,57,68,-11,50
East Fife,9688,6,14,3,19,51,66,-15,45
Airdrieon,9688,7,10,11,15,45,61,-16,41
Forfar,9688,8,11,5,20,41,64,-23,38
Albion,9688,9,8,6,22,57,80,-23,30
Queen's Park,9688,10,6,10,20,39,74,-35,28
Raith,9689,1,23,8,5,69,32,37,77
Ayr,9689,2,23,5,8,91,43,48,74
Arbroath,9689,3,18,8,10,72,48,24,62
Alloa,9689,4,17,8,11,56,44,12,59
Stranraer,9689,5,15,6,15,57,66,-9,51
Airdrieon,9689,6,11,11,14,46,58,-12,44
East Fife,9689,7,13,4,19,49,66,-17,43
Forfar,9689,8,10,5,21,38,65,-27,35
Albion,9689,9,8,7,21,58,79,-21,31
Queen's Park,9689,10,6,10,20,39,74,-35,28
Ayr,9690,1,24,4,8,93,44,49,76
Raith,9690,2,22,9,5,68,32,36,75
Arbroath,9690,3,17,9,10,70,48,22,60
Alloa,9690,4,17,9,10,56,43,13,60
Stranraer,9690,5,15,5,16,56,66,-10,50
East Fife,9690,6,14,3,19,49,65,-16,45
Airdrieon,9690,7,11,11,14,48,60,-12,44
Forfar,9690,8,10,5,21,40,67,-27,35
Albion,9690,9,8,6,22,59,81,-22,30
Queen's Park,9690,10,6,11,19,39,72,-33,29
Raith,9691,1,23,8,5,72,32,40,77
Ayr,9691,2,24,4,8,94,43,51,76
Arbroath,9691,3,17,9,10,70,48,22,60
Alloa,9691,4,17,8,11,56,47,9,59
Stranraer,9691,5,16,5,15,58,66,-8,53
East Fife,9691,6,13,3,20,49,67,-18,42
Airdrieon,9691,7,10,11,15,46,60,-14,41
Forfar,9691,8,11,5,20,40,65,-25,38
Albion,9691,9,8,6,22,58,82,-24,30
Queen's Park,9691,10,6,11,19,39,72,-33,29
Ayr,9692,1,24,4,8,93,42,51,76
Raith,9692,2,22,9,5,69,33,36,75
Alloa,9692,3,17,9,10,57,44,13,60
Arbroath,9692,4,17,8,11,70,52,18,59
Stranraer,9692,5,15,5,16,56,66,-10,50
East Fife,9692,6,14,3,19,49,65,-16,45
Airdrieon,9692,7,11,11,14,47,58,-11,44
Forfar,9692,8,10,5,21,38,66,-28,35
Queen's Park,9692,9,7,10,19,43,72,-29,31
Albion,9692,10,8,6,22,57,81,-24,30
Raith,9693,1,23,8,5,69,32,37,77
Ayr,9693,2,24,4,8,91,42,49,76
Arbroath,9693,3,17,9,10,71,49,22,60
Alloa,9693,4,17,8,11,56,44,12,59
Stranraer,9693,5,15,5,16,56,66,-10,50
East Fife,9693,6,14,3,19,49,65,-16,45
Airdrieon,9693,7,11,11,14,48,59,-11,44
Forfar,9693,8,10,5,21,39,67,-28,35
Albion,9693,9,8,6,22,57,79,-22,30
Queen's Park,9693,10,6,11,19,40,73,-33,29
Raith,9694,1,23,8,5,71,32,39,77
Ayr,9694,2,24,4,8,93,42,51,76
Arbroath,9694,3,18,8,10,73,49,24,62
Alloa,9694,4,17,8,11,56,46,10,59
Stranraer,9694,5,15,5,16,56,67,-11,50
East Fife,9694,6,14,3,19,50,65,-15,45
Airdrieon,9694,7,10,11,15,47,61,-14,41
Forfar,9694,8,11,5,20,41,66,-25,38
Albion,9694,9,8,6,22,57,81,-24,30
Queen's Park,9694,10,6,10,20,40,75,-35,28
Ayr,9695,1,23,5,8,92,44,48,74
Raith,9695,2,22,8,6,68,33,35,74
Alloa,9695,3,18,8,10,57,43,14,62
Arbroath,9695,4,17,8,11,71,50,21,59
Stranraer,9695,5,16,5,15,57,65,-8,53
Airdrieon,9695,6,11,11,14,49,59,-10,44
East Fife,9695,7,13,3,20,48,66,-18,42
Forfar,9695,8,10,5,21,39,68,-29,35
Albion,9695,9,8,7,21,59,80,-21,31
Queen's Park,9695,10,7,10,19,41,73,-32,31
Ayr,9696,1,23,5,8,93,45,48,74
Raith,9696,2,22,8,6,68,33,35,74
Arbroath,9696,3,18,8,10,72,49,23,62
Alloa,9696,4,18,8,10,57,43,14,62
Stranraer,9696,5,15,5,16,58,68,-10,50
East Fife,9696,6,14,3,19,51,67,-16,45
Airdrieon,9696,7,10,12,14,46,59,-13,42
Forfar,9696,8,10,6,20,39,65,-26,36
Albion,9696,9,8,7,21,60,81,-21,31
Queen's Park,9696,10,6,10,20,40,74,-34,28
Ayr,9697,1,24,4,8,94,44,50,76
Raith,9697,2,22,8,6,69,35,34,74
Arbroath,9697,3,18,8,10,74,50,24,62
Alloa,9697,4,18,8,10,59,44,15,62
Stranraer,9697,5,15,5,16,55,67,-12,50
East Fife,9697,6,14,3,19,50,64,-14,45
Airdrieon,9697,7,10,11,15,46,60,-14,41
Forfar,9697,8,11,5,20,40,65,-25,38
Albion,9697,9,8,6,22,59,82,-23,30
Queen's Park,9697,10,6,10,20,41,76,-35,28
Raith,9698,1,23,8,5,69,32,37,77
Ayr,9698,2,24,4,8,95,43,52,76
Arbroath,9698,3,17,9,10,73,51,22,60
Alloa,9698,4,17,8,11,56,44,12,59
Stranraer,9698,5,15,5,16,56,67,-11,50
East Fife,9698,6,14,3,19,50,65,-15,45
Airdrieon,9698,7,10,12,14,46,59,-13,42
Forfar,9698,8,10,6,20,39,65,-26,36
Albion,9698,9,8,6,22,58,83,-25,30
Queen's Park,9698,10,6,11,19,42,75,-33,29
Raith,9699,1,23,8,5,69,32,37,77
Ayr,9699,2,23,5,8,93,45,48,74
Arbroath,9699,3,17,8,11,71,50,21,59
Alloa,9699,4,17,8,11,56,44,12,59
Stranraer,9699,5,16,5,15,56,64,-8,53
Airdrieon,9699,6,10,12,14,46,59,-13,42
East Fife,9699,7,13,3,20,47,65,-18,42
Forfar,9699,8,10,6,20,39,65,-26,36
Albion,9699,9,8,7,21,60,81,-21,31
Queen's Park,9699,10,7,10,19,41,73,-32,31
Ayr,9700,1,24,4,8,91,42,49,76
Raith,9700,2,22,8,6,68,33,35,74
Alloa,9700,3,18,8,10,57,43,14,62
Arbroath,9700,4,17,8,11,71,50,21,59
Stranraer,9700,5,15,5,16,55,65,-10,50
East Fife,9700,6,14,3,19,48,64,-16,45
Airdrieon,9700,7,10,11,15,46,61,-15,41
Forfar,9700,8,11,5,20,41,65,-24,38
Queen's Park,9700,9,7,10,19,41,73,-32,31
Albion,9700,10,8,6,22,57,79,-22,30
Raith,9701,1,23,8,5,69,32,37,77
Ayr,9701,2,24,4,8,91,42,49,76
Arbroath,9701,3,17,8,11,71,50,21,59
Alloa,9701,4,17,8,11,56,44,12,59
Stranraer,9701,5,15,6,15,56,65,-9,51
Airdrieon,9701,6,11,11,14,49,58,-9,44
East Fife,9701,7,13,4,19,48,65,-17,43
Forfar,9701,8,10,5,21,38,68,-30,35
Queen's Park,9701,9,7,10,19,41,73,-32,31
Albion,9701,10,8,6,22,57,79,-22,30
Raith,9702,1,23,8,5,72,32,40,77
Ayr,9702,2,24,4,8,98,43,55,76
Arbroath,9702,3,17,8,11,70,50,20,59
Alloa,9702,4,17,8,11,56,47,9,59
Stranraer,9702,5,15,5,16,55,66,-11,50
East Fife,9702,6,14,3,19,49,64,-15,45
Airdrieon,9702,7,10,11,15,45,61,-16,41
Forfar,9702,8,11,5,20,41,64,-23,38
Queen's Park,9702,9,7,10,19,41,72,-31,31
Albion,9702,10,8,6,22,58,86,-28,30
Ayr,9703,1,24,4,8,96,42,54,76
Raith,9703,2,22,9,5,68,32,36,75
Arbroath,9703,3,17,9,10,71,49,22,60
Alloa,9703,4,17,9,10,56,43,13,60
Stranraer,9703,5,15,5,16,55,65,-10,50
East Fife,9703,6,14,3,19,48,64,-16,45
Airdrieon,9703,7,10,12,14,45,58,-13,42
Forfar,9703,8,10,6,20,38,64,-26,36
Albion,9703,9,8,6,22,57,84,-27,30
Queen's Park,9703,10,6,11,19,40,73,-33,29
Raith,9704,1,23,8,5,71,32,39,77
Ayr,9704,2,24,4,8,97,42,55,76
Arbroath,9704,3,17,8,11,70,49,21,59
Alloa,9704,4,17,8,11,56,46,10,59
Stranraer,9704,5,16,5,15,58,66,-8,53
East Fife,9704,6,13,3,20,49,67,-18,42
Airdrieon,9704,7,10,11,15,46,64,-18,41
Forfar,9704,8,11,5,20,44,65,-21,38
Queen's Park,9704,9,7,10,19,40,72,-32,31
Albion,9704,10,8,6,22,57,85,-28,30
Raith,9705,1,23,8,5,70,32,38,77
Ayr,9705,2,24,4,8,93,44,49,76
Arbroath,9705,3,18,8,10,74,49,25,62
Alloa,9705,4,17,8,11,56,45,11,59
Stranraer,9705,5,15,5,16,55,66,-11,50
East Fife,9705,6,14,3,19,49,64,-15,45
Airdrieon,9705,7,10,11,15,45,61,-16,41
Forfar,9705,8,11,5,20,41,64,-23,38
Albion,9705,9,8,6,22,59,81,-22,30
Queen's Park,9705,10,6,10,20,40,76,-36,28
Raith,9706,1,23,8,5,70,32,38,77
Ayr,9706,2,24,4,8,94,43,51,76
Arbroath,9706,3,17,9,10,70,48,22,60
Alloa,9706,4,17,8,11,56,45,11,59
Stranraer,9706,5,16,5,15,58,65,-7,53
Airdrieon,9706,6,10,12,14,45,58,-13,42
East Fife,9706,7,13,3,20,48,67,-19,42
Forfar,9706,8,10,6,20,38,64,-26,36
Albion,9706,9,8,6,22,58,82,-24,30
Queen's Park,9706,10,6,11,19,39,72,-33,29
Raith,9707,1,23,8,5,70,33,37,77
Ayr,9707,2,24,4,8,92,43,49,76
Arbroath,9707,3,18,8,10,73,49,24,62
Alloa,9707,4,17,8,11,57,45,12,59
Stranraer,9707,5,15,5,16,56,66,-10,50
East Fife,9707,6,14,3,19,49,65,-16,45
Airdrieon,9707,7,11,11,14,46,58,-12,44
Forfar,9707,8,10,5,21,38,65,-27,35
Albion,9707,9,8,6,22,58,80,-22,30
Queen's Park,9707,10,6,10,20,40,75,-35,28
Raith,9708,1,23,8,5,72,32,40,77
Ayr,9708,2,24,4,8,91,42,49,76
Arbroath,9708,3,18,8,10,72,49,23,62
Alloa,9708,4,17,8,11,56,47,9,59
Stranraer,9708,5,15,5,16,55,65,-10,50
East Fife,9708,6,14,3,19,48,64,-16,45
Airdrieon,9708,7,11,11,14,48,60,-12,44
Forfar,9708,8,10,5,21,40,67,-27,35
Albion,9708,9,8,6,22,57,79,-22,30
Queen's Park,9708,10,6,10,20,40,74,-34,28
Raith,9709,1,22,9,5,69,33,36,75
Ayr,9709,2,23,5,8,91,43,48,74
Arbroath,9709,3,17,9,10,70,48,22,60
Alloa,9709,4,17,9,10,57,44,13,60
Stranraer,9709,5,15,6,15,57,66,-9,51
East Fife,9709,6,13,4,19,49,66,-17,43
Airdrieon,9709,7,10,11,15,45,60,-15,41
Forfar,9709,8,11,5,20,40,64,-24,38
Albion,9709,9,8,7,21,58,79,-21,31
Queen's Park,9709,10,6,11,19,39,72,-33,29
Ayr,9710,1,24,4,8,94,44,50,76
Raith,9710,2,22,9,5,68,32,36,75
Alloa,9710,3,17,9,10,56,43,13,60
Arbroath,9710,4,17,8,11,72,52,20,59
Stranraer,9710,5,15,5,16,55,65,-10,50
East Fife,9710,6,14,3,19,48,64,-16,45
Airdrieon,9710,7,11,11,14,46,58,-12,44
Forfar,9710,8,10,5,21,38,65,-27,35
Queen's Park,9710,9,7,10,19,43,74,-31,31
Albion,9710,10,8,6,22,59,82,-23,30
Raith,9711,1,23,8,5,69,32,37,77
Ayr,9711,2,24,4,8,94,43,51,76
Arbroath,9711,3,18,8,10,72,48,24,62
Alloa,9711,4,17,8,11,56,44,12,59
Stranraer,9711,5,16,5,15,58,66,-8,53
Airdrieon,9711,6,11,11,14,46,58,-12,44
East Fife,9711,7,13,3,20,49,67,-18,42
Forfar,9711,8,10,5,21,38,65,-27,35
Albion,9711,9,8,6,22,58,82,-24,30
Queen's Park,9711,10,6,10,20,39,74,-35,28
Raith,9712,1,22,8,6,68,33,35,74
Ayr,9712,2,23,4,9,91,47,44,73
Arbroath,9712,3,18,8,10,73,49,24,62
Alloa,9712,4,18,8,10,57,43,14,62
Stranraer,9712,5,15,6,15,58,67,-9,51
East Fife,9712,6,13,4,19,50,67,-17,43
Airdrieon,9712,7,10,11,15,46,61,-15,41
Forfar,9712,8,11,5,20,41,65,-24,38
Albion,9712,9,9,6,21,62,79,-17,33
Queen's Park,9712,10,6,10,20,40,75,-35,28
Raith,9713,1,23,8,5,71,32,39,77
Ayr,9713,2,24,4,8,93,42,51,76
Arbroath,9713,3,17,8,11,71,50,21,59
Alloa,9713,4,17,8,11,56,46,10,59
Stranraer,9713,5,16,5,15,57,65,-8,53
Airdrieon,9713,6,11,11,14,48,59,-11,44
East Fife,9713,7,13,3,20,48,66,-18,42
Forfar,9713,8,10,5,21,39,67,-28,35
Queen's Park,9713,9,7,10,19,41,73,-32,31
Albion,9713,10,8,6,22,57,81,-24,30
Raith,9714,1,23,8,5,70,32,38,77
Ayr,9714,2,24,4,8,92,42,50,76
Arbroath,9714,3,18,8,10,73,49,24,62
Alloa,9714,4,17,8,11,56,45,11,59
Stranraer,9714,5,16,5,15,57,65,-8,53
Airdrieon,9714,6,11,11,14,46,58,-12,44
East Fife,9714,7,13,3,20,48,66,-18,42
Forfar,9714,8,10,5,21,38,65,-27,35
Albion,9714,9,8,6,22,57,80,-23,30
Queen's Park,9714,10,6,10,20,40,75,-35,28
Raith,9715,1,22,8,6,68,34,34,74
Ayr,9715,2,23,4,9,91,44,47,73
Arbroath,9715,3,18,8,10,72,49,23,62
Alloa,9715,4,18,8,10,58,43,15,62
Stranraer,9715,5,15,5,16,55,67,-12,50
East Fife,9715,6,14,3,19,50,64,-14,45
Airdrieon,9715,7,10,12,14,46,59,-13,42
Forfar,9715,8,10,6,20,39,65,-26,36
Albion,9715,9,9,6,21,59,79,-20,33
Queen's Park,9715,10,6,10,20,40,74,-34,28
Ayr,9716,1,24,4,8,92,43,49,76
Raith,9716,2,22,8,6,69,34,35,74
Arbroath,9716,3,18,8,10,72,48,24,62
Alloa,9716,4,18,8,10,58,44,14,62
Stranraer,9716,5,15,5,16,55,66,-11,50
East Fife,9716,6,14,3,19,49,64,-15,45
Airdrieon,9716,7,10,12,14,45,58,-13,42
Forfar,9716,8,10,6,20,38,64,-26,36
Albion,9716,9,8,6,22,58,80,-22,30
Queen's Park,9716,10,6,10,20,39,74,-35,28
Raith,9717,1,23,8,5,70,33,37,77
Ayr,9717,2,24,4,8,94,42,52,76
Arbroath,9717,3,18,8,10,72,49,23,62
Alloa,9717,4,17,8,11,57,45,12,59
Stranraer,9717,5,15,6,15,57,66,-9,51
East Fife,9717,6,13,4,19,49,66,-17,43
Airdrieon,9717,7,10,12,14,46,59,-13,42
Forfar,9717,8,10,6,20,39,65,-26,36
Albion,9717,9,8,6,22,57,82,-25,30
Queen's Park,9717,10,6,10,20,40,74,-34,28
Ayr,9718,1,24,4,8,95,43,52,76
Raith,9718,2,22,9,5,71,35,36,75
Arbroath,9718,3,18,8,10,77,49,28,62
Alloa,9718,4,17,9,10,59,46,13,60
Stranraer,9718,5,16,5,15,57,65,-8,53
Airdrieon,9718,6,10,12,14,46,59,-13,42
East Fife,9718,7,13,3,20,48,66,-18,42
Forfar,9718,8,10,6,20,39,65,-26,36
Albion,9718,9,8,6,22,58,83,-25,30
Queen's Park,9718,10,6,10,20,40,79,-39,28
Raith,9719,1,23,8,5,70,32,38,77
Ayr,9719,2,23,5,8,91,43,48,74
Arbroath,9719,3,17,9,10,72,50,22,60
Alloa,9719,4,17,8,11,56,45,11,59
Stranraer,9719,5,15,5,16,55,65,-10,50
East Fife,9719,6,14,3,19,48,64,-16,45
Airdrieon,9719,7,11,11,14,47,59,-12,44
Forfar,9719,8,10,5,21,39,66,-27,35
Albion,9719,9,8,7,21,58,79,-21,31
Queen's Park,9719,10,6,11,19,41,74,-33,29
Raith,9720,1,23,8,5,70,32,38,77
Ayr,9720,2,24,4,8,96,42,54,76
Arbroath,9720,3,17,8,11,70,49,21,59
Alloa,9720,4,17,8,11,56,45,11,59
Stranraer,9720,5,15,6,15,56,65,-9,51
Airdrieon,9720,6,11,11,14,47,59,-12,44
East Fife,9720,7,13,4,19,48,65,-17,43
Forfar,9720,8,10,5,21,39,66,-27,35
Queen's Park,9720,9,7,10,19,40,72,-32,31
Albion,9720,10,8,6,22,57,84,-27,30
Raith,9721,1,23,8,5,72,33,39,77
Ayr,9721,2,24,4,8,94,42,52,76
Arbroath,9721,3,17,8,11,72,51,21,59
Alloa,9721,4,17,8,11,57,47,10,59
Stranraer,9721,5,15,5,16,55,66,-11,50
East Fife,9721,6,14,3,19,49,64,-15,45
Airdrieon,9721,7,11,11,14,48,59,-11,44
Forfar,9721,8,10,5,21,39,67,-28,35
Queen's Park,9721,9,7,10,19,42,74,-32,31
Albion,9721,10,8,6,22,57,82,-25,30
Raith,9722,1,23,8,5,69,32,37,77
Ayr,9722,2,24,4,8,93,43,50,76
Arbroath,9722,3,18,8,10,72,48,24,62
Alloa,9722,4,17,8,11,56,44,12,59
Stranraer,9722,5,15,5,16,56,66,-10,50
East Fife,9722,6,14,3,19,49,65,-16,45
Airdrieon,9722,7,10,11,15,46,60,-14,41
Forfar,9722,8,11,5,20,40,65,-25,38
Albion,9722,9,8,6,22,58,81,-23,30
Queen's Park,9722,10,6,10,20,39,74,-35,28
Raith,9723,1,23,8,5,70,33,37,77
Ayr,9723,2,24,4,8,93,44,49,76
Arbroath,9723,3,18,8,10,71,48,23,62
Alloa,9723,4,17,8,11,57,45,12,59
Stranraer,9723,5,15,5,16,56,67,-11,50
East Fife,9723,6,14,3,19,50,65,-15,45
Airdrieon,9723,7,11,11,14,47,59,-12,44
Forfar,9723,8,10,5,21,39,66,-27,35
Albion,9723,9,8,6,22,59,81,-22,30
Queen's Park,9723,10,6,10,20,39,73,-34,28
Raith,9724,1,23,8,5,71,33,38,77
Ayr,9724,2,23,5,8,92,44,48,74
Arbroath,9724,3,17,8,11,71,50,21,59
Alloa,9724,4,17,8,11,57,46,11,59
Stranraer,9724,5,15,5,16,56,67,-11,50
East Fife,9724,6,14,3,19,50,65,-15,45
Airdrieon,9724,7,11,11,14,47,59,-12,44
Forfar,9724,8,10,5,21,39,66,-27,35
Albion,9724,9,8,7,21,59,80,-21,31
Queen's Park,9724,10,7,10,19,41,73,-32,31
Ayr,9725,1,24,4,8,97,42,55,76
Raith,9725,2,22,9,5,69,33,36,75
Alloa,9725,3,17,9,10,57,44,13,60
Arbroath,9725,4,17,8,11,70,51,19,59
Stranraer,9725,5,16,5,15,56,64,-8,53
East Fife,9725,6,13,3,20,47,65,-18,42
Airdrieon,9725,7,10,11,15,45,59,-14,41
Forfar,9725,8,11,5,20,39,64,-25,38
Queen's Park,9725,9,7,10,19,42,72,-30,31
Albion,9725,10,8,6,22,57,85,-28,30
Raith,9726,1,23,8,5,73,33,40,77
Ayr,9726,2,24,4,8,93,42,51,76
Arbroath,9726,3,17,8,11,70,49,21,59
Alloa,9726,4,17,8,11,57,48,9,59
Stranraer,9726,5,15,6,15,56,65,-9,51
Airdrieon,9726,6,11,11,14,47,58,-11,44
East Fife,9726,7,13,4,19,48,65,-17,43
Forfar,9726,8,10,5,21,38,66,-28,35
Queen's Park,9726,9,7,10,19,40,72,-32,31
Albion,9726,10,8,6,22,57,81,-24,30
Raith,9727,1,23,8,5,71,32,39,77
Ayr,9727,2,24,4,8,93,42,51,76
Arbroath,9727,3,17,9,10,72,50,22,60
Alloa,9727,4,17,8,11,56,46,10,59
Stranraer,9727,5,15,6,15,57,66,-9,51
East Fife,9727,6,13,4,19,49,66,-17,43
Airdrieon,9727,7,10,12,14,47,60,-13,42
Forfar,9727,8,10,6,20,40,66,-26,36
Albion,9727,9,8,6,22,57,81,-24,30
Queen's Park,9727,10,6,11,19,41,74,-33,29
Ayr,9728,1,23,5,8,92,44,48,74
Raith,9728,2,22,8,6,69,35,34,74
Arbroath,9728,3,18,8,10,73,50,23,62
Alloa,9728,4,18,8,10,59,44,15,62
Stranraer,9728,5,15,5,16,56,66,-10,50
East Fife,9728,6,14,3,19,49,65,-16,45
Airdrieon,9728,7,10,11,15,46,60,-14,41
Forfar,9728,8,11,5,20,40,65,-25,38
Albion,9728,9,8,7,21,59,80,-21,31
Queen's Park,9728,10,6,10,20,41,75,-34,28
Raith,9729,1,23,8,5,70,32,38,77
Ayr,9729,2,24,4,8,96,44,52,76
Arbroath,9729,3,18,8,10,75,48,27,62
Alloa,9729,4,17,8,11,56,45,11,59
Stranraer,9729,5,16,5,15,56,64,-8,53
Airdrieon,9729,6,11,11,14,46,58,-12,44
East Fife,9729,7,13,3,20,47,65,-18,42
Forfar,9729,8,10,5,21,38,65,-27,35
Albion,9729,9,8,6,22,59,84,-25,30
Queen's Park,9729,10,6,10,20,39,77,-38,28
Ayr,9730,1,24,4,8,92,42,50,76
Raith,9730,2,22,9,5,69,33,36,75
Arbroath,9730,3,18,8,10,73,49,24,62
Alloa,9730,4,17,9,10,57,44,13,60
Stranraer,9730,5,15,6,15,58,67,-9,51
East Fife,9730,6,13,4,19,50,67,-17,43
Airdrieon,9730,7,10,11,15,46,60,-14,41
Forfar,9730,8,11,5,20,40,65,-25,38
Albion,9730,9,8,6,22,57,80,-23,30
Queen's Park,9730,10,6,10,20,40,75,-35,28
Ayr,9731,1,24,4,8,92,43,49,76
Raith,9731,2,22,8,6,68,34,34,74
Alloa,9731,3,18,8,10,58,43,15,62
Arbroath,9731,4,17,9,10,74,52,22,60
Stranraer,9731,5,15,6,15,58,67,-9,51
East Fife,9731,6,13,4,19,50,67,-17,43
Airdrieon,9731,7,10,11,15,48,62,-14,41
Forfar,9731,8,11,5,20,42,67,-25,38
Albion,9731,9,8,6,22,58,80,-22,30
Queen's Park,9731,10,6,11,19,43,76,-33,29
Raith,9732,1,23,8,5,70,32,38,77
Ayr,9732,2,24,4,8,95,44,51,76
Arbroath,9732,3,17,8,11,70,52,18,59
Alloa,9732,4,17,8,11,56,45,11,59
Stranraer,9732,5,15,5,16,57,70,-13,50
East Fife,9732,6,14,3,19,53,66,-13,45
Airdrieon,9732,7,11,11,14,48,60,-12,44
Forfar,9732,8,10,5,21,40,67,-27,35
Queen's Park,9732,9,7,10,19,43,72,-29,31
Albion,9732,10,8,6,22,59,83,-24,30
Raith,9733,1,23,8,5,70,32,38,77
Ayr,9733,2,24,4,8,94,44,50,76
Arbroath,9733,3,17,9,10,71,49,22,60
Alloa,9733,4,17,8,11,56,45,11,59
Stranraer,9733,5,15,5,16,57,67,-10,50
East Fife,9733,6,14,3,19,50,66,-16,45
Airdrieon,9733,7,11,11,14,48,59,-11,44
Forfar,9733,8,10,5,21,39,67,-28,35
Albion,9733,9,8,6,22,59,82,-23,30
Queen's Park,9733,10,6,11,19,40,73,-33,29
Raith,9734,1,23,8,5,71,32,39,77
Ayr,9734,2,24,4,8,94,44,50,76
Arbroath,9734,3,17,9,10,72,50,22,60
Alloa,9734,4,17,8,11,56,46,10,59
Stranraer,9734,5,15,5,16,55,65,-10,50
East Fife,9734,6,14,3,19,48,64,-16,45
Airdrieon,9734,7,11,11,14,47,58,-11,44
Forfar,9734,8,10,5,21,38,66,-28,35
Albion,9734,9,8,6,22,59,82,-23,30
Queen's Park,9734,10,6,11,19,41,74,-33,29
Raith,9735,1,23,8,5,70,33,37,77
Ayr,9735,2,23,5,8,92,44,48,74
Arbroath,9735,3,18,8,10,73,49,24,62
Alloa,9735,4,17,8,11,57,45,12,59
Stranraer,9735,5,16,5,15,58,64,-6,53
East Fife,9735,6,13,3,20,47,67,-20,42
Airdrieon,9735,7,10,11,15,46,60,-14,41
Forfar,9735,8,11,5,20,40,65,-25,38
Albion,9735,9,8,7,21,59,80,-21,31
Queen's Park,9735,10,6,10,20,40,75,-35,28
Raith,9736,1,23,8,5,70,32,38,77
Ayr,9736,2,24,4,8,94,44,50,76
Arbroath,9736,3,17,8,11,71,50,21,59
Alloa,9736,4,17,8,11,56,45,11,59
Stranraer,9736,5,15,5,16,56,66,-10,50
East Fife,9736,6,14,3,19,49,65,-16,45
Airdrieon,9736,7,11,11,14,47,59,-12,44
Forfar,9736,8,10,5,21,39,66,-27,35
Queen's Park,9736,9,7,10,19,41,73,-32,31
Albion,9736,10,8,6,22,59,82,-23,30
Raith,9737,1,23,8,5,70,32,38,77
Ayr,9737,2,24,4,8,94,42,52,76
Arbroath,9737,3,17,8,11,71,51,20,59
Alloa,9737,4,17,8,11,56,45,11,59
Stranraer,9737,5,15,5,16,56,68,-12,50
East Fife,9737,6,14,3,19,51,65,-14,45
Airdrieon,9737,7,11,11,14,47,58,-11,44
Forfar,9737,8,10,5,21,38,66,-28,35
Queen's Park,9737,9,7,10,19,42,73,-31,31
Albion,9737,10,8,6,22,57,82,-25,30
Ayr,9738,1,24,4,8,93,43,50,76
Raith,9738,2,22,8,6,70,35,35,74
Alloa,9738,3,18,8,10,59,45,14,62
Arbroath,9738,4,17,8,11,71,50,21,59
Stranraer,9738,5,16,5,15,57,64,-7,53
Airdrieon,9738,6,10,12,14,46,59,-13,42
East Fife,9738,7,13,3,20,47,66,-19,42
Forfar,9738,8,10,6,20,39,65,-26,36
Queen's Park,9738,9,7,10,19,41,73,-32,31
Albion,9738,10,8,6,22,58,81,-23,30
Ayr,9739,1,23,5,8,91,43,48,74
Raith,9739,2,22,8,6,68,33,35,74
Arbroath,9739,3,18,8,10,73,48,25,62
Alloa,9739,4,18,8,10,57,43,14,62
Stranraer,9739,5,15,5,16,55,67,-12,50
East Fife,9739,6,14,3,19,50,64,-14,45
Airdrieon,9739,7,10,12,14,45,58,-13,42
Forfar,9739,8,10,6,20,38,64,-26,36
Albion,9739,9,8,7,21,58,79,-21,31
Queen's Park,9739,10,6,10,20,39,75,-36,28
Ayr,9740,1,24,4,8,92,43,49,76
Raith,9740,2,22,9,5,68,32,36,75
Arbroath,9740,3,17,9,10,71,49,22,60
Alloa,9740,4,17,9,10,56,43,13,60
Stranraer,9740,5,15,5,16,55,65,-10,50
East Fife,9740,6,14,3,19,48,64,-16,45
Airdrieon,9740,7,10,12,14,46,59,-13,42
Forfar,9740,8,10,6,20,39,65,-26,36
Albion,9740,9,8,6,22,58,80,-22,30
Queen's Park,9740,10,6,11,19,40,73,-33,29
Ayr,9741,1,24,4,8,93,43,50,76
Raith,9741,2,22,9,5,69,33,36,75
Arbroath,9741,3,18,8,10,73,48,25,62
Alloa,9741,4,17,9,10,57,44,13,60
Stranraer,9741,5,15,5,16,57,67,-10,50
East Fife,9741,6,14,3,19,50,66,-16,45
Airdrieon,9741,7,11,11,14,46,58,-12,44
Forfar,9741,8,10,5,21,38,65,-27,35
Albion,9741,9,8,6,22,58,81,-23,30
Queen's Park,9741,10,6,10,20,39,75,-36,28
Ayr,9742,1,23,5,8,91,43,48,74
Raith,9742,2,22,8,6,69,34,35,74
Alloa,9742,3,18,8,10,58,44,14,62
Arbroath,9742,4,17,9,10,72,50,22,60
Stranraer,9742,5,15,6,15,56,65,-9,51
East Fife,9742,6,13,4,19,48,65,-17,43
Airdrieon,9742,7,10,12,14,45,58,-13,42
Forfar,9742,8,10,6,20,38,64,-26,36
Albion,9742,9,8,7,21,58,79,-21,31
Queen's Park,9742,10,6,11,19,41,74,-33,29
Raith,9743,1,23,8,5,71,34,37,77
Ayr,9743,2,24,4,8,96,42,54,76
Arbroath,9743,3,17,9,10,70,48,22,60
Alloa,9743,4,17,8,11,58,46,12,59
Stranraer,9743,5,15,5,16,57,67,-10,50
East Fife,9743,6,14,3,19,50,66,-16,45
Airdrieon,9743,7,10,12,14,48,61,-13,42
Forfar,9743,8,10,6,20,41,67,-26,36
Albion,9743,9,8,6,22,57,84,-27,30
Queen's Park,9743,10,6,11,19,39,72,-33,29
Ayr,9744,1,24,4,8,94,42,52,76
Raith,9744,2,22,9,5,70,34,36,75
Arbroath,9744,3,18,8,10,71,48,23,62
Alloa,9744,4,17,9,10,58,45,13,60
Stranraer,9744,5,15,5,16,56,66,-10,50
East Fife,9744,6,14,3,19,49,65,-16,45
Airdrieon,9744,7,11,11,14,48,60,-12,44
Forfar,9744,8,10,5,21,40,67,-27,35
Albion,9744,9,8,6,22,57,82,-25,30
Queen's Park,9744,10,6,10,20,39,73,-34,28
Raith,9745,1,23,8,5,71,34,37,77
Ayr,9745,2,24,4,8,96,44,52,76
Arbroath,9745,3,17,8,11,72,52,20,59
Alloa,9745,4,17,8,11,58,46,12,59
Stranraer,9745,5,15,6,15,57,66,-9,51
East Fife,9745,6,13,4,19,49,66,-17,43
Airdrieon,9745,7,10,11,15,46,61,-15,41
Forfar,9745,8,11,5,20,41,65,-24,38
Queen's Park,9745,9,7,10,19,43,74,-31,31
Albion,9745,10,8,6,22,59,84,-25,30
Ayr,9746,1,24,4,8,94,42,52,76
Raith,9746,2,22,8,6,68,35,33,74
Arbroath,9746,3,18,8,10,72,49,23,62
Alloa,9746,4,18,8,10,59,43,16,62
Stranraer,9746,5,15,6,15,56,65,-9,51
Airdrieon,9746,6,11,11,14,46,58,-12,44
East Fife,9746,7,13,4,19,48,65,-17,43
Forfar,9746,8,10,5,21,38,65,-27,35
Albion,9746,9,8,6,22,57,82,-25,30
Queen's Park,9746,10,6,10,20,40,74,-34,28
Ayr,9747,1,24,4,8,95,45,50,76
Raith,9747,2,22,9,5,69,33,36,75
Alloa,9747,3,17,9,10,57,44,13,60
Arbroath,9747,4,17,8,11,71,50,21,59
Stranraer,9747,5,16,5,15,57,65,-8,53
Airdrieon,9747,6,11,11,14,47,59,-12,44
East Fife,9747,7,13,3,20,48,66,-18,42
Forfar,9747,8,10,5,21,39,66,-27,35
Queen's Park,9747,9,7,10,19,41,73,-32,31
Albion,9747,10,8,6,22,60,83,-23,30
Raith,9748,1,23,8,5,69,32,37,77
Ayr,9748,2,24,4,8,93,43,50,76
Arbroath,9748,3,17,8,11,70,52,18,59
Alloa,9748,4,17,8,11,56,44,12,59
Stranraer,9748,5,16,5,15,56,64,-8,53
Airdrieon,9748,6,11,11,14,47,58,-11,44
East Fife,9748,7,13,3,20,47,65,-18,42
Forfar,9748,8,10,5,21,38,66,-28,35
Queen's Park,9748,9,7,10,19,43,72,-29,31
Albion,9748,10,8,6,22,58,81,-23,30
Ayr,9749,1,24,4,8,95,42,53,76
Raith,9749,2,22,9,5,68,32,36,75
Alloa,9749,3,17,9,10,56,43,13,60
Arbroath,9749,4,17,8,11,71,53,18,59
Stranraer,9749,5,16,5,15,56,64,-8,53
Airdrieon,9749,6,11,11,14,46,58,-12,44
East Fife,9749,7,13,3,20,47,65,-18,42
Forfar,9749,8,10,5,21,38,65,-27,35
Queen's Park,9749,9,7,10,19,44,73,-29,31
Albion,9749,10,8,6,22,57,83,-26,30
Ayr,9750,1,24,4,8,95,42,53,76
Raith,9750,2,22,8,6,69,34,35,74
Arbroath,9750,3,18,8,10,75,48,27,62
Alloa,9750,4,18,8,10,58,44,14,62
Stranraer,9750,5,15,5,16,56,69,-13,50
East Fife,9750,6,14,3,19,52,65,-13,45
Airdrieon,9750,7,11,11,14,48,59,-11,44
Forfar,9750,8,10,5,21,39,67,-28,35
Albion,9750,9,8,6,22,57,83,-26,30
Queen's Park,9750,10,6,10,20,39,77,-38,28
Raith,9751,1,23,8,5,72,32,40,77
Ayr,9751,2,24,4,8,93,43,50,76
Arbroath,9751,3,17,9,10,71,49,22,60
Alloa,9751,4,17,8,11,56,47,9,59
Stranraer,9751,5,15,5,16,55,65,-10,50
East Fife,9751,6,14,3,19,48,64,-16,45
Airdrieon,9751,7,10,11,15,45,62,-17,41
Forfar,9751,8,11,5,20,42,64,-22,38
Albion,9751,9,8,6,22,58,81,-23,30
Queen's Park,9751,10,6,11,19,40,73,-33,29
Raith,9752,1,23,8,5,71,32,39,77
Ayr,9752,2,24,4,8,93,42,51,76
Arbroath,9752,3,17,8,11,70,49,21,59
Alloa,9752,4,17,8,11,56,46,10,59
Stranraer,9752,5,15,5,16,55,66,-11,50
East Fife,9752,6,14,3,19,49,64,-15,45
Airdrieon,9752,7,11,11,14,49,59,-10,44
Forfar,9752,8,10,5,21,39,68,-29,35
Queen's Park,9752,9,7,10,19,40,72,-32,31
Albion,9752,10,8,6,22,57,81,-24,30
Raith,9753,1,22,8,6,68,34,34,74
Ayr,9753,2,23,4,9,92,47,45,73
Arbroath,9753,3,18,8,10,73,49,24,62
Alloa,9753,4,18,8,10,58,43,15,62
Stranraer,9753,5,15,5,16,55,70,-15,50
East Fife,9753,6,14,3,19,53,64,-11,45
Airdrieon,9753,7,11,11,14,50,58,-8,44
Forfar,9753,8,10,5,21,38,69,-31,35
Albion,9753,9,9,6,21,62,80,-18,33
Queen's Park,9753,10,6,10,20,40,75,-35,28
Raith,9754,1,22,9,5,70,34,36,75
Ayr,9754,2,23,5,8,92,44,48,74
Alloa,9754,3,17,9,10,58,45,13,60
Arbroath,9754,4,17,8,11,72,51,21,59
Stranraer,9754,5,15,5,16,55,66,-11,50
East Fife,9754,6,14,3,19,49,64,-15,45
Airdrieon,9754,7,11,11,14,47,59,-12,44
Forfar,9754,8,10,5,21,39,66,-27,35
Albion,9754,9,8,7,21,59,80,-21,31
Queen's Park,9754,10,7,10,19,42,74,-32,31
Raith,9755,1,23,8,5,71,32,39,77
Ayr,9755,2,23,5,8,92,44,48,74
Arbroath,9755,3,17,9,10,70,48,22,60
Alloa,9755,4,17,8,11,56,46,10,59
Stranraer,9755,5,15,5,16,55,65,-10,50
East Fife,9755,6,14,3,19,48,64,-16,45
Airdrieon,9755,7,11,11,14,48,59,-11,44
Forfar,9755,8,10,5,21,39,67,-28,35
Albion,9755,9,8,7,21,59,80,-21,31
Queen's Park,9755,10,6,11,19,39,72,-33,29
Raith,9756,1,23,8,5,69,32,37,77
Ayr,9756,2,23,5,8,92,44,48,74
Arbroath,9756,3,17,8,11,72,51,21,59
Alloa,9756,4,17,8,11,56,44,12,59
Stranraer,9756,5,16,5,15,59,66,-7,53
Airdrieon,9756,6,11,11,14,48,60,-12,44
East Fife,9756,7,13,3,20,49,68,-19,42
Forfar,9756,8,10,5,21,40,67,-27,35
Albion,9756,9,8,7,21,59,80,-21,31
Queen's Park,9756,10,7,10,19,42,74,-32,31
Ayr,9757,1,23,5,8,91,43,48,74
Raith,9757,2,22,8,6,68,35,33,74
Arbroath,9757,3,18,8,10,73,50,23,62
Alloa,9757,4,18,8,10,59,43,16,62
Stranraer,9757,5,15,6,15,57,66,-9,51
Airdrieon,9757,6,11,11,14,47,59,-12,44
East Fife,9757,7,13,4,19,49,66,-17,43
Forfar,9757,8,10,5,21,39,66,-27,35
Albion,9757,9,8,7,21,58,79,-21,31
Queen's Park,9757,10,6,10,20,41,75,-34,28
Ayr,9758,1,24,4,8,93,44,49,76
Raith,9758,2,22,9,5,70,34,36,75
Alloa,9758,3,17,9,10,58,45,13,60
Arbroath,9758,4,17,8,11,71,50,21,59
Stranraer,9758,5,16,5,15,58,64,-6,53
Airdrieon,9758,6,11,11,14,47,58,-11,44
East Fife,9758,7,13,3,20,47,67,-20,42
Forfar,9758,8,10,5,21,38,66,-28,35
Queen's Park,9758,9,7,10,19,41,73,-32,31
Albion,9758,10,8,6,22,59,81,-22,30
Raith,9759,1,22,9,5,69,33,36,75
Ayr,9759,2,23,5,8,92,44,48,74
Alloa,9759,3,17,9,10,57,44,13,60
Arbroath,9759,4,17,8,11,72,51,21,59
Stranraer,9759,5,15,5,16,56,67,-11,50
East Fife,9759,6,14,3,19,50,65,-15,45
Airdrieon,9759,7,10,12,14,48,61,-13,42
Forfar,9759,8,10,6,20,41,67,-26,36
Albion,9759,9,8,7,21,59,80,-21,31
Queen's Park,9759,10,7,10,19,42,74,-32,31
Ayr,9760,1,24,4,8,97,43,54,76
Raith,9760,2,22,8,6,68,33,35,74
Arbroath,9760,3,18,8,10,71,48,23,62
Alloa,9760,4,18,8,10,57,43,14,62
Stranraer,9760,5,15,6,15,55,64,-9,51
Airdrieon,9760,6,11,11,14,48,60,-12,44
East Fife,9760,7,13,4,19,47,64,-17,43
Forfar,9760,8,10,5,21,40,67,-27,35
Albion,9760,9,8,6,22,58,85,-27,30
Queen's Park,9760,10,6,10,20,39,73,-34,28
Raith,9761,1,23,8,5,73,34,39,77
Ayr,9761,2,24,4,8,95,42,53,76
Arbroath,9761,3,17,9,10,71,49,22,60
Alloa,9761,4,17,8,11,58,48,10,59
Stranraer,9761,5,16,5,15,57,64,-7,53
Airdrieon,9761,6,11,11,14,47,58,-11,44
East Fife,9761,7,13,3,20,47,66,-19,42
Forfar,9761,8,10,5,21,38,66,-28,35
Albion,9761,9,8,6,22,57,83,-26,30
Queen's Park,9761,10,6,11,19,40,73,-33,29
Raith,9762,1,23,8,5,69,32,37,77
Ayr,9762,2,23,4,9,90,44,46,73
Arbroath,9762,3,17,8,11,72,52,20,59
Alloa,9762,4,17,8,11,56,44,12,59
Stranraer,9762,5,15,5,16,55,65,-10,50
East Fife,9762,6,14,3,19,48,64,-16,45
Airdrieon,9762,7,11,11,14,49,61,-12,44
Forfar,9762,8,10,5,21,41,68,-27,35
Albion,9762,9,9,6,21,59,78,-19,33
Queen's Park,9762,10,7,10,19,43,74,-31,31
Ayr,9763,1,24,4,8,93,42,51,76
Raith,9763,2,22,9,5,70,34,36,75
Alloa,9763,3,17,9,10,58,45,13,60
Arbroath,9763,4,17,8,11,71,50,21,59
Stranraer,9763,5,15,5,16,55,66,-11,50
East Fife,9763,6,14,3,19,49,64,-15,45
Airdrieon,9763,7,10,12,14,47,60,-13,42
Forfar,9763,8,10,6,20,40,66,-26,36
Queen's Park,9763,9,7,10,19,41,73,-32,31
Albion,9763,10,8,6,22,57,81,-24,30
Raith,9764,1,23,8,5,70,33,37,77
Ayr,9764,2,24,4,8,92,43,49,76
Arbroath,9764,3,18,8,10,75,48,27,62
Alloa,9764,4,17,8,11,57,45,12,59
Stranraer,9764,5,15,5,16,57,68,-11,50
East Fife,9764,6,14,3,19,51,66,-15,45
Airdrieon,9764,7,11,11,14,46,58,-12,44
Forfar,9764,8,10,5,21,38,65,-27,35
Albion,9764,9,8,6,22,58,80,-22,30
Queen's Park,9764,10,6,10,20,39,77,-38,28
Raith,9765,1,23,8,5,69,32,37,77
Ayr,9765,2,24,4,8,92,42,50,76
Arbroath,9765,3,17,8,11,70,51,19,59
Alloa,9765,4,17,8,11,56,44,12,59
Stranraer,9765,5,15,5,16,55,66,-11,50
East Fife,9765,6,14,3,19,49,64,-15,45
Airdrieon,9765,7,11,11,14,51,59,-8,44
Forfar,9765,8,10,5,21,39,70,-31,35
Queen's Park,9765,9,7,10,19,42,72,-30,31
Albion,9765,10,8,6,22,57,80,-23,30
Ayr,9766,1,24,4,8,92,42,50,76
Raith,9766,2,22,9,5,69,33,36,75
Arbroath,9766,3,17,9,10,71,49,22,60
Alloa,9766,4,17,9,10,57,44,13,60
Stranraer,9766,5,15,6,15,56,65,-9,51
East Fife,9766,6,13,4,19,48,65,-17,43
Airdrieon,9766,7,10,12,14,46,59,-13,42
Forfar,9766,8,10,6,20,39,65,-26,36
Albion,9766,9,8,6,22,57,80,-23,30
Queen's Park,9766,10,6,11,19,40,73,-33,29
Ayr,9767,1,24,4,8,93,42,51,76
Raith,9767,2,22,8,6,69,34,35,74
Arbroath,9767,3,18,8,10,71,48,23,62
Alloa,9767,4,18,8,10,58,44,14,62
Stranraer,9767,5,16,5,15,57,64,-7,53
Airdrieon,9767,6,11,11,14,46,58,-12,44
East Fife,9767,7,13,3,20,47,66,-19,42
Forfar,9767,8,10,5,21,38,65,-27,35
Albion,9767,9,8,6,22,57,81,-24,30
Queen's Park,9767,10,6,10,20,39,73,-34,28
Ayr,9768,1,24,4,8,95,42,53,76
Raith,9768,2,22,8,6,69,34,35,74
Alloa,9768,3,18,8,10,58,44,14,62
Arbroath,9768,4,17,8,11,70,49,21,59
Stranraer,9768,5,15,6,15,57,66,-9,51
Airdrieon,9768,6,11,11,14,49,59,-10,44
East Fife,9768,7,13,4,19,49,66,-17,43
Forfar,9768,8,10,5,21,39,68,-29,35
Queen's Park,9768,9,7,10,19,40,72,-32,31
Albion,9768,10,8,6,22,57,83,-26,30
Raith,9769,1,23,8,5,72,33,39,77
Ayr,9769,2,23,4,9,91,46,45,73
Arbroath,9769,3,18,8,10,71,48,23,62
Alloa,9769,4,17,8,11,57,47,10,59
Stranraer,9769,5,15,5,16,57,67,-10,50
East Fife,9769,6,14,3,19,50,66,-16,45
Airdrieon,9769,7,11,11,14,48,58,-10,44
Forfar,9769,8,10,5,21,38,67,-29,35
Albion,9769,9,9,6,21,61,79,-18,33
Queen's Park,9769,10,6,10,20,39,73,-34,28
Ayr,9770,1,24,4,8,95,43,52,76
Raith,9770,2,22,9,5,71,35,36,75
Arbroath,9770,3,18,8,10,72,49,23,62
Alloa,9770,4,17,9,10,59,46,13,60
Stranraer,9770,5,15,5,16,56,68,-12,50
East Fife,9770,6,14,3,19,51,65,-14,45
Airdrieon,9770,7,10,11,15,46,60,-14,41
Forfar,9770,8,11,5,20,40,65,-25,38
Albion,9770,9,8,6,22,58,83,-25,30
Queen's Park,9770,10,6,10,20,40,74,-34,28
Raith,9771,1,23,8,5,70,33,37,77
Ayr,9771,2,24,4,8,92,43,49,76
Arbroath,9771,3,17,8,11,70,49,21,59
Alloa,9771,4,17,8,11,57,45,12,59
Stranraer,9771,5,15,6,15,56,65,-9,51
Airdrieon,9771,6,11,11,14,46,58,-12,44
East Fife,9771,7,13,4,19,48,65,-17,43
Forfar,9771,8,10,5,21,38,65,-27,35
Queen's Park,9771,9,7,10,19,40,72,-32,31
Albion,9771,10,8,6,22,58,80,-22,30
Ayr,9772,1,24,4,8,92,43,49,76
Raith,9772,2,22,9,5,68,32,36,75
Arbroath,9772,3,18,8,10,73,48,25,62
Alloa,9772,4,17,9,10,56,43,13,60
Stranraer,9772,5,15,5,16,56,66,-10,50
East Fife,9772,6,14,3,19,49,65,-16,45
Airdrieon,9772,7,11,11,14,48,60,-12,44
Forfar,9772,8,10,5,21,40,67,-27,35
Albion,9772,9,8,6,22,58,80,-22,30
Queen's Park,9772,10,6,10,20,39,75,-36,28
Raith,9773,1,23,8,5,70,33,37,77
Ayr,9773,2,24,4,8,95,43,52,76
Arbroath,9773,3,18,8,10,71,48,23,62
Alloa,9773,4,17,8,11,57,45,12,59
Stranraer,9773,5,16,5,15,57,64,-7,53
East Fife,9773,6,13,3,20,47,66,-19,42
Airdrieon,9773,7,10,11,15,46,60,-14,41
Forfar,9773,8,11,5,20,40,65,-25,38
Albion,9773,9,8,6,22,58,83,-25,30
Queen's Park,9773,10,6,10,20,39,73,-34,28
Ayr,9774,1,24,4,8,95,44,51,76
Raith,9774,2,22,8,6,68,33,35,74
Arbroath,9774,3,18,8,10,72,48,24,62
Alloa,9774,4,18,8,10,57,43,14,62
Stranraer,9774,5,15,5,16,55,65,-10,50
East Fife,9774,6,14,3,19,48,64,-16,45
Airdrieon,9774,7,11,11,14,46,58,-12,44
Forfar,9774,8,10,5,21,38,65,-27,35
Albion,9774,9,8,6,22,59,83,-24,30
Queen's Park,9774,10,6,10,20,39,74,-35,28
Ayr,9775,1,24,4,8,95,44,51,76
Raith,9775,2,22,9,5,70,34,36,75
Arbroath,9775,3,18,8,10,73,50,23,62
Alloa,9775,4,17,9,10,58,45,13,60
Stranraer,9775,5,15,6,15,56,65,-9,51
East Fife,9775,6,13,4,19,48,65,-17,43
Airdrieon,9775,7,10,11,15,45,59,-14,41
Forfar,9775,8,11,5,20,39,64,-25,38
Albion,9775,9,8,6,22,59,83,-24,30
Queen's Park,9775,10,6,10,20,41,75,-34,28
Raith,9776,1,23,8,5,70,32,38,77
Ayr,9776,2,24,4,8,96,42,54,76
Arbroath,9776,3,18,8,10,72,49,23,62
Alloa,9776,4,17,8,11,56,45,11,59
Stranraer,9776,5,15,6,15,56,65,-9,51
East Fife,9776,6,13,4,19,48,65,-17,43
Airdrieon,9776,7,10,11,15,45,60,-15,41
Forfar,9776,8,11,5,20,40,64,-24,38
Albion,9776,9,8,6,22,57,84,-27,30
Queen's Park,9776,10,6,10,20,40,74,-34,28
Ayr,9777,1,24,4,8,94,43,51,76
Raith,9777,2,22,8,6,69,34,35,74
Arbroath,9777,3,18,8,10,74,50,24,62
Alloa,9777,4,18,8,10,58,44,14,62
Stranraer,9777,5,15,5,16,55,66,-11,50
East Fife,9777,6,14,3,19,49,64,-15,45
Airdrieon,9777,7,11,11,14,47,58,-11,44
Forfar,9777,8,10,5,21,38,66,-28,35
Albion,9777,9,8,6,22,58,82,-24,30
Queen's Park,9777,10,6,10,20,41,76,-35,28
Ayr,9778,1,24,4,8,92,42,50,76
Raith,9778,2,22,9,5,69,33,36,75
Alloa,9778,3,17,9,10,57,44,13,60
Arbroath,9778,4,17,8,11,71,51,20,59
Stranraer,9778,5,15,6,15,56,65,-9,51
Airdrieon,9778,6,11,11,14,48,59,-11,44
East Fife,9778,7,13,4,19,48,65,-17,43
Forfar,9778,8,10,5,21,39,67,-28,35
Queen's Park,9778,9,7,10,19,42,73,-31,31
Albion,9778,10,8,6,22,57,80,-23,30
Ayr,9779,1,24,4,8,96,42,54,76
Raith,9779,2,22,9,5,68,32,36,75
Arbroath,9779,3,18,8,10,74,49,25,62
Alloa,9779,4,17,9,10,56,43,13,60
Stranraer,9779,5,15,6,15,56,65,-9,51
Airdrieon,9779,6,11,11,14,46,58,-12,44
East Fife,9779,7,13,4,19,48,65,-17,43
Forfar,9779,8,10,5,21,38,65,-27,35
Albion,9779,9,8,6,22,57,84,-27,30
Queen's Park,9779,10,6,10,20,40,76,-36,28
Ayr,9780,1,24,4,8,95,42,53,76
Raith,9780,2,22,8,6,69,34,35,74
Arbroath,9780,3,18,8,10,73,50,23,62
Alloa,9780,4,18,8,10,58,44,14,62
Stranraer,9780,5,15,6,15,56,65,-9,51
East Fife,9780,6,13,4,19,48,65,-17,43
Airdrieon,9780,7,10,11,15,46,60,-14,41
Forfar,9780,8,11,5,20,40,65,-25,38
Albion,9780,9,8,6,22,57,83,-26,30
Queen's Park,9780,10,6,10,20,41,75,-34,28
Ayr,9781,1,24,4,8,94,44,50,76
Raith,9781,2,22,9,5,69,33,36,75
Arbroath,9781,3,18,8,10,72,48,24,62
Alloa,9781,4,17,9,10,57,44,13,60
Stranraer,9781,5,16,5,15,59,66,-7,53
East Fife,9781,6,13,3,20,49,68,-19,42
Airdrieon,9781,7,10,11,15,45,59,-14,41
Forfar,9781,8,11,5,20,39,64,-25,38
Albion,9781,9,8,6,22,59,82,-23,30
Queen's Park,9781,10,6,10,20,39,74,-35,28
Ayr,9782,1,24,4,8,94,45,49,76
Raith,9782,2,22,8,6,69,35,34,74
Arbroath,9782,3,18,8,10,73,49,24,62
Alloa,9782,4,18,8,10,59,44,15,62
Stranraer,9782,5,15,6,15,55,64,-9,51
Airdrieon,9782,6,11,11,14,48,60,-12,44
East Fife,9782,7,13,4,19,47,64,-17,43
Forfar,9782,8,10,5,21,40,67,-27,35
Albion,9782,9,8,6,22,60,82,-22,30
Queen's Park,9782,10,6,10,20,40,75,-35,28
Raith,9783,1,22,9,5,69,33,36,75
Ayr,9783,2,23,4,9,91,44,47,73
Alloa,9783,3,17,9,10,57,44,13,60
Arbroath,9783,4,17,8,11,70,50,20,59
Stranraer,9783,5,15,5,16,57,67,-10,50
East Fife,9783,6,14,3,19,50,66,-16,45
Airdrieon,9783,7,10,12,14,46,59,-13,42
Forfar,9783,8,10,6,20,39,65,-26,36
Albion,9783,9,9,6,21,59,79,-20,33
Queen's Park,9783,10,7,10,19,41,72,-31,31
Ayr,9784,1,24,4,8,95,44,51,76
Raith,9784,2,22,9,5,70,34,36,75
Alloa,9784,3,17,9,10,58,45,13,60
Arbroath,9784,4,17,8,11,71,50,21,59
Stranraer,9784,5,15,6,15,56,65,-9,51
Airdrieon,9784,6,11,11,14,47,59,-12,44
East Fife,9784,7,13,4,19,48,65,-17,43
Forfar,9784,8,10,5,21,39,66,-27,35
Queen's Park,9784,9,7,10,19,41,73,-32,31
Albion,9784,10,8,6,22,59,83,-24,30
Ayr,9785,1,24,4,8,91,42,49,76
Raith,9785,2,22,8,6,69,35,34,74
Arbroath,9785,3,18,8,10,71,48,23,62
Alloa,9785,4,18,8,10,59,44,15,62
Stranraer,9785,5,16,5,15,57,65,-8,53
East Fife,9785,6,13,3,20,48,66,-18,42
Airdrieon,9785,7,10,11,15,45,59,-14,41
Forfar,9785,8,11,5,20,39,64,-25,38
Albion,9785,9,8,6,22,57,79,-22,30
Queen's Park,9785,10,6,10,20,39,73,-34,28
Raith,9786,1,23,8,5,72,32,40,77
Ayr,9786,2,24,4,8,94,42,52,76
Arbroath,9786,3,17,9,10,72,50,22,60
Alloa,9786,4,17,8,11,56,47,9,59
Stranraer,9786,5,15,5,16,57,68,-11,50
East Fife,9786,6,14,3,19,51,66,-15,45
Airdrieon,9786,7,11,11,14,48,59,-11,44
Forfar,9786,8,10,5,21,39,67,-28,35
Albion,9786,9,8,6,22,57,82,-25,30
Queen's Park,9786,10,6,11,19,41,74,-33,29
Raith,9787,1,23,8,5,71,32,39,77
Ayr,9787,2,24,4,8,93,43,50,76
Arbroath,9787,3,18,8,10,74,50,24,62
Alloa,9787,4,17,8,11,56,46,10,59
Stranraer,9787,5,16,5,15,56,64,-8,53
Airdrieon,9787,6,11,11,14,47,59,-12,44
East Fife,9787,7,13,3,20,47,65,-18,42
Forfar,9787,8,10,5,21,39,66,-27,35
Albion,9787,9,8,6,22,58,81,-23,30
Queen's Park,9787,10,6,10,20,41,76,-35,28
Ayr,9788,1,24,4,8,95,42,53,76
Raith,9788,2,22,9,5,69,33,36,75
Arbroath,9788,3,17,9,10,73,51,22,60
Alloa,9788,4,17,9,10,57,44,13,60
Stranraer,9788,5,16,5,15,56,64,-8,53
Airdrieon,9788,6,11,11,14,48,58,-10,44
East Fife,9788,7,13,3,20,47,65,-18,42
Forfar,9788,8,10,5,21,38,67,-29,35
Albion,9788,9,8,6,22,57,83,-26,30
Queen's Park,9788,10,6,11,19,42,75,-33,29
Raith,9789,1,23,8,5,69,32,37,77
Ayr,9789,2,24,4,8,93,42,51,76
Arbroath,9789,3,17,8,11,70,50,20,59
Alloa,9789,4,17,8,11,56,44,12,59
Stranraer,9789,5,16,5,15,58,64,-6,53
Airdrieon,9789,6,11,11,14,49,58,-9,44
East Fife,9789,7,13,3,20,47,67,-20,42
Forfar,9789,8,10,5,21,38,68,-30,35
Queen's Park,9789,9,7,10,19,41,72,-31,31
Albion,9789,10,8,6,22,57,81,-24,30
Raith,9790,1,23,8,5,70,33,37,77
Ayr,9790,2,23,5,8,91,43,48,74
Arbroath,9790,3,18,8,10,71,48,23,62
Alloa,9790,4,17,8,11,57,45,12,59
Stranraer,9790,5,15,6,15,56,65,-9,51
East Fife,9790,6,13,4,19,48,65,-17,43
Airdrieon,9790,7,10,11,15,46,60,-14,41
Forfar,9790,8,11,5,20,40,65,-25,38
Albion,9790,9,8,7,21,58,79,-21,31
Queen's Park,9790,10,6,10,20,39,73,-34,28
Raith,9791,1,23,8,5,69,32,37,77
Ayr,9791,2,24,4,8,94,44,50,76
Arbroath,9791,3,17,8,11,71,50,21,59
Alloa,9791,4,17,8,11,56,44,12,59
Stranraer,9791,5,16,5,15,59,65,-6,53
Airdrieon,9791,6,11,11,14,48,59,-11,44
East Fife,9791,7,13,3,20,48,68,-20,42
Forfar,9791,8,10,5,21,39,67,-28,35
Queen's Park,9791,9,7,10,19,41,73,-32,31
Albion,9791,10,8,6,22,59,82,-23,30
Raith,9792,1,23,8,5,71,33,38,77
Ayr,9792,2,24,4,8,94,42,52,76
Arbroath,9792,3,18,8,10,75,48,27,62
Alloa,9792,4,17,8,11,57,46,11,59
Stranraer,9792,5,15,6,15,57,66,-9,51
East Fife,9792,6,13,4,19,49,66,-17,43
Airdrieon,9792,7,10,11,15,45,59,-14,41
Forfar,9792,8,11,5,20,39,64,-25,38
Albion,9792,9,8,6,22,57,82,-25,30
Queen's Park,9792,10,6,10,20,39,77,-38,28
Ayr,9793,1,24,4,8,92,43,49,76
Raith,9793,2,22,8,6,69,34,35,74
Alloa,9793,3,18,8,10,58,44,14,62
Arbroath,9793,4,17,8,11,70,51,19,59
Stranraer,9793,5,16,5,15,58,66,-8,53
East Fife,9793,6,13,3,20,49,67,-18,42
Airdrieon,9793,7,10,11,15,46,61,-15,41
Forfar,9793,8,11,5,20,41,65,-24,38
Queen's Park,9793,9,7,10,19,42,72,-30,31
Albion,9793,10,8,6,22,58,80,-22,30
Ayr,9794,1,23,5,8,92,44,48,74
Raith,9794,2,22,8,6,69,35,34,74
Alloa,9794,3,18,8,10,59,44,15,62
Arbroath,9794,4,17,8,11,70,51,19,59
Stranraer,9794,5,15,6,15,56,65,-9,51
Airdrieon,9794,6,11,11,14,50,59,-9,44
East Fife,9794,7,13,4,19,48,65,-17,43
Forfar,9794,8,10,5,21,39,69,-30,35
Albion,9794,9,8,7,21,59,80,-21,31
Queen's Park,9794,10,7,10,19,42,72,-30,31
Ayr,9795,1,24,4,8,93,44,49,76
Raith,9795,2,22,9,5,69,33,36,75
Alloa,9795,3,17,9,10,57,44,13,60
Arbroath,9795,4,17,8,11,70,50,20,59
Stranraer,9795,5,15,6,15,57,66,-9,51
Airdrieon,9795,6,11,11,14,48,59,-11,44
East Fife,9795,7,13,4,19,49,66,-17,43
Forfar,9795,8,10,5,21,39,67,-28,35
Queen's Park,9795,9,7,10,19,41,72,-31,31
Albion,9795,10,8,6,22,59,81,-22,30
Raith,9796,1,23,8,5,70,33,37,77
Ayr,9796,2,24,4,8,93,43,50,76
Arbroath,9796,3,17,9,10,71,49,22,60
Alloa,9796,4,17,8,11,57,45,12,59
Stranraer,9796,5,15,5,16,55,67,-12,50
East Fife,9796,6,14,3,19,50,64,-14,45
Airdrieon,9796,7,11,11,14,49,58,-9,44
Forfar,9796,8,10,5,21,38,68,-30,35
Albion,9796,9,8,6,22,58,81,-23,30
Queen's Park,9796,10,6,11,19,40,73,-33,29
Raith,9797,1,23,8,5,69,32,37,77
Ayr,9797,2,24,4,8,93,43,50,76
Arbroath,9797,3,17,8,11,70,51,19,59
Alloa,9797,4,17,8,11,56,44,12,59
Stranraer,9797,5,16,5,15,58,64,-6,53
Airdrieon,9797,6,11,11,14,47,59,-12,44
East Fife,9797,7,13,3,20,47,67,-20,42
Forfar,9797,8,10,5,21,39,66,-27,35
Queen's Park,9797,9,7,10,19,42,72,-30,31
Albion,9797,10,8,6,22,58,81,-23,30
Ayr,9798,1,24,4,8,94,43,51,76
Raith,9798,2,22,8,6,70,35,35,74
Alloa,9798,3,18,8,10,59,45,14,62
Arbroath,9798,4,17,8,11,71,51,20,59
Stranraer,9798,5,16,5,15,56,64,-8,53
Airdrieon,9798,6,10,12,14,47,60,-13,42
East Fife,9798,7,13,3,20,47,65,-18,42
Forfar,9798,8,10,6,20,40,66,-26,36
Queen's Park,9798,9,7,10,19,42,73,-31,31
Albion,9798,10,8,6,22,58,82,-24,30
Ayr,9799,1,24,4,8,95,45,50,76
Raith,9799,2,22,8,6,68,33,35,74
Arbroath,9799,3,18,8,10,73,50,23,62
Alloa,9799,4,18,8,10,57,43,14,62
Stranraer,9799,5,15,5,16,55,66,-11,50
East Fife,9799,6,14,3,19,49,64,-15,45
Airdrieon,9799,7,11,11,14,50,60,-10,44
Forfar,9799,8,10,5,21,40,69,-29,35
Albion,9799,9,8,6,22,60,83,-23,30
Queen's Park,9799,10,6,10,20,41,75,-34,28
Ayr,9800,1,24,4,8,93,44,49,76
Raith,9800,2,22,8,6,68,34,34,74
Arbroath,9800,3,18,8,10,72,49,23,62
Alloa,9800,4,18,8,10,58,43,15,62
Stranraer,9800,5,15,6,15,59,68,-9,51
Airdrieon,9800,6,11,11,14,47,58,-11,44
East Fife,9800,7,13,4,19,51,68,-17,43
Forfar,9800,8,10,5,21,38,66,-28,35
Albion,9800,9,8,6,22,59,81,-22,30
Queen's Park,9800,10,6,10,20,40,74,-34,28
Ayr,9801,1,24,4,8,91,42,49,76
Raith,9801,2,22,9,5,69,33,36,75
Arbroath,9801,3,17,9,10,73,51,22,60
Alloa,9801,4,17,9,10,57,44,13,60
Stranraer,9801,5,16,5,15,58,66,-8,53
Airdrieon,9801,6,11,11,14,46,58,-12,44
East Fife,9801,7,13,3,20,49,67,-18,42
Forfar,9801,8,10,5,21,38,65,-27,35
Albion,9801,9,8,6,22,57,79,-22,30
Queen's Park,9801,10,6,11,19,42,75,-33,29
Raith,9802,1,23,8,5,70,32,38,77
Ayr,9802,2,24,4,8,93,44,49,76
Arbroath,9802,3,17,9,10,73,51,22,60
Alloa,9802,4,17,8,11,56,45,11,59
Stranraer,9802,5,15,5,16,55,65,-10,50
East Fife,9802,6,14,3,19,48,64,-16,45
Airdrieon,9802,7,11,11,14,48,58,-10,44
Forfar,9802,8,10,5,21,38,67,-29,35
Albion,9802,9,8,6,22,59,81,-22,30
Queen's Park,9802,10,6,11,19,42,75,-33,29
Raith,9803,1,23,8,5,70,32,38,77
Ayr,9803,2,24,4,8,93,43,50,76
Arbroath,9803,3,17,9,10,72,50,22,60
Alloa,9803,4,17,8,11,56,45,11,59
Stranraer,9803,5,15,6,15,56,65,-9,51
East Fife,9803,6,13,4,19,48,65,-17,43
Airdrieon,9803,7,10,12,14,46,59,-13,42
Forfar,9803,8,10,6,20,39,65,-26,36
Albion,9803,9,8,6,22,58,81,-23,30
Queen's Park,9803,10,6,11,19,41,74,-33,29
Ayr,9804,1,24,4,8,92,43,49,76
Raith,9804,2,22,9,5,70,34,36,75
Alloa,9804,3,17,9,10,58,45,13,60
Arbroath,9804,4,17,8,11,72,51,21,59
Stranraer,9804,5,15,5,16,56,66,-10,50
East Fife,9804,6,14,3,19,49,65,-16,45
Airdrieon,9804,7,11,11,14,46,58,-12,44
Forfar,9804,8,10,5,21,38,65,-27,35
Queen's Park,9804,9,7,10,19,42,74,-32,31
Albion,9804,10,8,6,22,58,80,-22,30
Raith,9805,1,22,9,5,69,33,36,75
Ayr,9805,2,23,4,9,92,45,47,73
Arbroath,9805,3,18,8,10,73,48,25,62
Alloa,9805,4,17,9,10,57,44,13,60
Stranraer,9805,5,15,5,16,56,67,-11,50
East Fife,9805,6,14,3,19,50,65,-15,45
Airdrieon,9805,7,11,11,14,46,58,-12,44
Forfar,9805,8,10,5,21,38,65,-27,35
Albion,9805,9,9,6,21,60,80,-20,33
Queen's Park,9805,10,6,10,20,39,75,-36,28
Raith,9806,1,23,8,5,70,32,38,77
Ayr,9806,2,24,4,8,95,44,51,76
Arbroath,9806,3,17,8,11,71,50,21,59
Alloa,9806,4,17,8,11,56,45,11,59
Stranraer,9806,5,15,5,16,55,66,-11,50
East Fife,9806,6,14,3,19,49,64,-15,45
Airdrieon,9806,7,10,12,14,46,59,-13,42
Forfar,9806,8,10,6,20,39,65,-26,36
Queen's Park,9806,9,7,10,19,41,73,-32,31
Albion,9806,10,8,6,22,59,83,-24,30
Raith,9807,1,22,9,5,71,35,36,75
Ayr,9807,2,23,4,9,90,44,46,73
Arbroath,9807,3,18,8,10,72,48,24,62
Alloa,9807,4,17,9,10,59,46,13,60
Stranraer,9807,5,15,5,16,56,67,-11,50
East Fife,9807,6,14,3,19,50,65,-15,45
Airdrieon,9807,7,11,11,14,46,58,-12,44
Forfar,9807,8,10,5,21,38,65,-27,35
Albion,9807,9,9,6,21,59,78,-19,33
Queen's Park,9807,10,6,10,20,39,74,-35,28
Raith,9808,1,23,8,5,71,32,39,77
Ayr,9808,2,24,4,8,91,42,49,76
Arbroath,9808,3,18,8,10,71,48,23,62
Alloa,9808,4,17,8,11,56,46,10,59
Stranraer,9808,5,15,5,16,57,67,-10,50
East Fife,9808,6,14,3,19,50,66,-16,45
Airdrieon,9808,7,11,11,14,48,58,-10,44
Forfar,9808,8,10,5,21,38,67,-29,35
Albion,9808,9,8,6,22,57,79,-22,30
Queen's Park,9808,10,6,10,20,39,73,-34,28
Raith,9809,1,23,8,5,71,32,39,77
Ayr,9809,2,24,4,8,94,44,50,76
Arbroath,9809,3,18,8,10,72,49,23,62
Alloa,9809,4,17,8,11,56,46,10,59
Stranraer,9809,5,16,5,15,61,65,-4,53
East Fife,9809,6,13,3,20,48,70,-22,42
Airdrieon,9809,7,10,11,15,46,61,-15,41
Forfar,9809,8,11,5,20,41,65,-24,38
Albion,9809,9,8,6,22,59,82,-23,30
Queen's Park,9809,10,6,10,20,40,74,-34,28
Raith,9810,1,23,8,5,69,32,37,77
Ayr,9810,2,24,4,8,93,43,50,76
Arbroath,9810,3,17,8,11,71,50,21,59
Alloa,9810,4,17,8,11,56,44,12,59
Stranraer,9810,5,15,6,15,55,64,-9,51
Airdrieon,9810,6,11,11,14,47,59,-12,44
East Fife,9810,7,13,4,19,47,64,-17,43
Forfar,9810,8,10,5,21,39,66,-27,35
Queen's Park,9810,9,7,10,19,41,73,-32,31
Albion,9810,10,8,6,22,58,81,-23,30
Raith,9811,1,23,8,5,69,32,37,77
Ayr,9811,2,23,4,9,90,44,46,73
Arbroath,9811,3,18,8,10,73,49,24,62
Alloa,9811,4,17,8,11,56,44,12,59
Stranraer,9811,5,16,5,15,56,64,-8,53
Airdrieon,9811,6,11,11,14,47,59,-12,44
East Fife,9811,7,13,3,20,47,65,-18,42
Forfar,9811,8,10,5,21,39,66,-27,35
Albion,9811,9,9,6,21,59,78,-19,33
Queen's Park,9811,10,6,10,20,40,75,-35,28
Ayr,9812,1,24,4,8,93,43,50,76
Raith,9812,2,22,9,5,69,33,36,75
Alloa,9812,3,17,9,10,57,44,13,60
Arbroath,9812,4,17,8,11,71,51,20,59
Stranraer,9812,5,15,5,16,55,67,-12,50
East Fife,9812,6,14,3,19,50,64,-14,45
Airdrieon,9812,7,11,11,14,47,58,-11,44
Forfar,9812,8,10,5,21,38,66,-28,35
Queen's Park,9812,9,7,10,19,42,73,-31,31
Albion,9812,10,8,6,22,58,81,-23,30
Ayr,9813,1,23,5,8,92,44,48,74
Raith,9813,2,22,8,6,68,33,35,74
Arbroath,9813,3,18,8,10,72,48,24,62
Alloa,9813,4,18,8,10,57,43,14,62
Stranraer,9813,5,15,6,15,55,64,-9,51
Airdrieon,9813,6,11,11,14,47,59,-12,44
East Fife,9813,7,13,4,19,47,64,-17,43
Forfar,9813,8,10,5,21,39,66,-27,35
Albion,9813,9,8,7,21,59,80,-21,31
Queen's Park,9813,10,6,10,20,39,74,-35,28
Ayr,9814,1,24,4,8,93,43,50,76
Raith,9814,2,22,8,6,68,33,35,74
Alloa,9814,3,18,8,10,57,43,14,62
Arbroath,9814,4,17,8,11,70,50,20,59
Stranraer,9814,5,16,5,15,59,66,-7,53
Airdrieon,9814,6,10,12,14,45,58,-13,42
East Fife,9814,7,13,3,20,49,68,-19,42
Forfar,9814,8,10,6,20,38,64,-26,36
Queen's Park,9814,9,7,10,19,41,72,-31,31
Albion,9814,10,8,6,22,58,81,-23,30
Raith,9815,1,23,8,5,71,32,39,77
Ayr,9815,2,24,4,8,97,44,53,76
Arbroath,9815,3,18,8,10,75,49,26,62
Alloa,9815,4,17,8,11,56,46,10,59
Stranraer,9815,5,15,6,15,56,65,-9,51
East Fife,9815,6,13,4,19,48,65,-17,43
Airdrieon,9815,7,10,11,15,46,61,-15,41
Forfar,9815,8,11,5,20,41,65,-24,38
Albion,9815,9,8,6,22,59,85,-26,30
Queen's Park,9815,10,6,10,20,40,77,-37,28
Raith,9816,1,23,8,5,70,32,38,77
Ayr,9816,2,24,4,8,94,42,52,76
Arbroath,9816,3,17,9,10,71,49,22,60
Alloa,9816,4,17,8,11,56,45,11,59
Stranraer,9816,5,16,5,15,58,66,-8,53
Airdrieon,9816,6,10,12,14,45,58,-13,42
East Fife,9816,7,13,3,20,49,67,-18,42
Forfar,9816,8,10,6,20,38,64,-26,36
Albion,9816,9,8,6,22,57,82,-25,30
Queen's Park,9816,10,6,11,19,40,73,-33,29
Raith,9817,1,22,8,6,68,33,35,74
Ayr,9817,2,23,4,9,93,46,47,73
Arbroath,9817,3,18,8,10,75,48,27,62
Alloa,9817,4,18,8,10,57,43,14,62
Stranraer,9817,5,15,5,16,56,66,-10,50
East Fife,9817,6,14,3,19,49,65,-16,45
Airdrieon,9817,7,10,12,14,46,59,-13,42
Forfar,9817,8,10,6,20,39,65,-26,36
Albion,9817,9,9,6,21,61,81,-20,33
Queen's Park,9817,10,6,10,20,39,77,-38,28
Raith,9818,1,23,8,5,72,33,39,77
Ayr,9818,2,24,4,8,94,42,52,76
Arbroath,9818,3,17,8,11,70,50,20,59
Alloa,9818,4,17,8,11,57,47,10,59
Stranraer,9818,5,15,5,16,56,70,-14,50
East Fife,9818,6,14,3,19,53,65,-12,45
Airdrieon,9818,7,10,11,15,45,61,-16,41
Forfar,9818,8,11,5,20,41,64,-23,38
Queen's Park,9818,9,7,10,19,41,72,-31,31
Albion,9818,10,8,6,22,57,82,-25,30
Ayr,9819,1,24,4,8,93,42,51,76
Raith,9819,2,22,9,5,68,32,36,75
Alloa,9819,3,17,9,10,56,43,13,60
Arbroath,9819,4,17,8,11,70,49,21,59
Stranraer,9819,5,16,5,15,57,65,-8,53
Airdrieon,9819,6,10,12,14,47,60,-13,42
East Fife,9819,7,13,3,20,48,66,-18,42
Forfar,9819,8,10,6,20,40,66,-26,36
Queen's Park,9819,9,7,10,19,40,72,-32,31
Albion,9819,10,8,6,22,57,81,-24,30
Raith,9820,1,23,8,5,74,33,41,77
Ayr,9820,2,24,4,8,95,44,51,76
Arbroath,9820,3,17,8,11,72,53,19,59
Alloa,9820,4,17,8,11,57,49,8,59
Stranraer,9820,5,15,5,16,55,65,-10,50
East Fife,9820,6,14,3,19,48,64,-16,45
Airdrieon,9820,7,10,12,14,47,60,-13,42
Forfar,9820,8,10,6,20,40,66,-26,36
Queen's Park,9820,9,7,10,19,44,74,-30,31
Albion,9820,10,8,6,22,59,83,-24,30
Ayr,9821,1,24,4,8,95,44,51,76
Raith,9821,2,22,9,5,69,33,36,75
Alloa,9821,3,17,9,10,57,44,13,60
Arbroath,9821,4,17,8,11,71,51,20,59
Stranraer,9821,5,15,5,16,56,66,-10,50
East Fife,9821,6,14,3,19,49,65,-16,45
Airdrieon,9821,7,11,11,14,47,59,-12,44
Forfar,9821,8,10,5,21,39,66,-27,35
Queen's Park,9821,9,7,10,19,42,73,-31,31
Albion,9821,10,8,6,22,59,83,-24,30
Raith,9822,1,23,8,5,70,32,38,77
Ayr,9822,2,24,4,8,92,43,49,76
Arbroath,9822,3,18,8,10,74,50,24,62
Alloa,9822,4,17,8,11,56,45,11,59
Stranraer,9822,5,16,5,15,56,64,-8,53
Airdrieon,9822,6,11,11,14,46,58,-12,44
East Fife,9822,7,13,3,20,47,65,-18,42
Forfar,9822,8,10,5,21,38,65,-27,35
Albion,9822,9,8,6,22,58,80,-22,30
Queen's Park,9822,10,6,10,20,41,76,-35,28
Raith,9823,1,23,8,5,69,32,37,77
Ayr,9823,2,24,4,8,96,44,52,76
Arbroath,9823,3,18,8,10,74,48,26,62
Alloa,9823,4,17,8,11,56,44,12,59
Stranraer,9823,5,15,6,15,56,65,-9,51
Airdrieon,9823,6,11,11,14,47,58,-11,44
East Fife,9823,7,13,4,19,48,65,-17,43
Forfar,9823,8,10,5,21,38,66,-28,35
Albion,9823,9,8,6,22,59,84,-25,30
Queen's Park,9823,10,6,10,20,39,76,-37,28
Raith,9824,1,22,9,5,68,32,36,75
Ayr,9824,2,23,5,8,90,42,48,74
Arbroath,9824,3,18,8,10,72,48,24,62
Alloa,9824,4,17,9,10,56,43,13,60
Stranraer,9824,5,15,5,16,58,68,-10,50
East Fife,9824,6,14,3,19,51,67,-16,45
Airdrieon,9824,7,11,11,14,48,59,-11,44
Forfar,9824,8,10,5,21,39,67,-28,35
Albion,9824,9,8,7,21,57,78,-21,31
Queen's Park,9824,10,6,10,20,39,74,-35,28
Raith,9825,1,23,8,5,71,33,38,77
Ayr,9825,2,24,4,8,94,44,50,76
Arbroath,9825,3,17,8,11,71,50,21,59
Alloa,9825,4,17,8,11,57,46,11,59
Stranraer,9825,5,16,5,15,56,64,-8,53
Airdrieon,9825,6,11,11,14,49,58,-9,44
East Fife,9825,7,13,3,20,47,65,-18,42
Forfar,9825,8,10,5,21,38,68,-30,35
Queen's Park,9825,9,7,10,19,41,73,-32,31
Albion,9825,10,8,6,22,59,82,-23,30
Raith,9826,1,23,8,5,71,33,38,77
Ayr,9826,2,24,4,8,91,42,49,76
Arbroath,9826,3,18,8,10,73,49,24,62
Alloa,9826,4,17,8,11,57,46,11,59
Stranraer,9826,5,15,6,15,55,64,-9,51
Airdrieon,9826,6,11,11,14,46,58,-12,44
East Fife,9826,7,13,4,19,47,64,-17,43
Forfar,9826,8,10,5,21,38,65,-27,35
Albion,9826,9,8,6,22,57,79,-22,30
Queen's Park,9826,10,6,10,20,40,75,-35,28
Ayr,9827,1,24,4,8,94,44,50,76
Raith,9827,2,22,9,5,69,33,36,75
Alloa,9827,3,17,9,10,57,44,13,60
Arbroath,9827,4,17,8,11,70,50,20,59
Stranraer,9827,5,15,5,16,56,66,-10,50
East Fife,9827,6,14,3,19,49,65,-16,45
Airdrieon,9827,7,10,11,15,45,60,-15,41
Forfar,9827,8,11,5,20,40,64,-24,38
Queen's Park,9827,9,7,10,19,41,72,-31,31
Albion,9827,10,8,6,22,59,82,-23,30
Raith,9828,1,23,8,5,71,34,37,77
Ayr,9828,2,24,4,8,94,45,49,76
Arbroath,9828,3,17,8,11,72,51,21,59
Alloa,9828,4,17,8,11,58,46,12,59
Stranraer,9828,5,15,6,15,57,66,-9,51
East Fife,9828,6,13,4,19,49,66,-17,43
Airdrieon,9828,7,10,12,14,46,59,-13,42
Forfar,9828,8,10,6,20,39,65,-26,36
Queen's Park,9828,9,7,10,19,42,74,-32,31
Albion,9828,10,8,6,22,60,82,-22,30
Raith,9829,1,23,8,5,70,32,38,77
Ayr,9829,2,24,4,8,93,42,51,76
Arbroath,9829,3,18,8,10,72,49,23,62
Alloa,9829,4,17,8,11,56,45,11,59
Stranraer,9829,5,15,5,16,55,66,-11,50
East Fife,9829,6,14,3,19,49,64,-15,45
Airdrieon,9829,7,10,11,15,45,59,-14,41
Forfar,9829,8,11,5,20,39,64,-25,38
Albion,9829,9,8,6,22,57,81,-24,30
Queen's Park,9829,10,6,10,20,40,74,-34,28
Ayr,9830,1,24,4,8,92,43,49,76
Raith,9830,2,22,8,6,68,33,35,74
Arbroath,9830,3,18,8,10,74,48,26,62
Alloa,9830,4,18,8,10,57,43,14,62
Stranraer,9830,5,15,6,15,56,65,-9,51
Airdrieon,9830,6,11,11,14,49,58,-9,44
East Fife,9830,7,13,4,19,48,65,-17,43
Forfar,9830,8,10,5,21,38,68,-30,35
Albion,9830,9,8,6,22,58,80,-22,30
Queen's Park,9830,10,6,10,20,39,76,-37,28
Ayr,9831,1,24,4,8,96,42,54,76
Raith,9831,2,22,8,6,68,35,33,74
Arbroath,9831,3,18,8,10,74,49,25,62
Alloa,9831,4,18,8,10,59,43,16,62
Stranraer,9831,5,15,6,15,56,65,-9,51
Airdrieon,9831,6,11,11,14,46,58,-12,44
East Fife,9831,7,13,4,19,48,65,-17,43
Forfar,9831,8,10,5,21,38,65,-27,35
Albion,9831,9,8,6,22,57,84,-27,30
Queen's Park,9831,10,6,10,20,40,76,-36,28
Ayr,9832,1,24,4,8,93,43,50,76
Raith,9832,2,22,8,6,69,36,33,74
Arbroath,9832,3,18,8,10,73,50,23,62
Alloa,9832,4,18,8,10,60,44,16,62
Stranraer,9832,5,15,5,16,57,69,-12,50
East Fife,9832,6,14,3,19,52,66,-14,45
Airdrieon,9832,7,11,11,14,47,58,-11,44
Forfar,9832,8,10,5,21,38,66,-28,35
Albion,9832,9,8,6,22,58,81,-23,30
Queen's Park,9832,10,6,10,20,41,75,-34,28
Raith,9833,1,23,8,5,69,32,37,77
Ayr,9833,2,23,5,8,92,44,48,74
Arbroath,9833,3,18,8,10,73,49,24,62
Alloa,9833,4,17,8,11,56,44,12,59
Stranraer,9833,5,15,5,16,56,67,-11,50
East Fife,9833,6,14,3,19,50,65,-15,45
Airdrieon,9833,7,11,11,14,48,58,-10,44
Forfar,9833,8,10,5,21,38,67,-29,35
Albion,9833,9,8,7,21,59,80,-21,31
Queen's Park,9833,10,6,10,20,40,75,-35,28
Raith,9834,1,23,8,5,69,32,37,77
Ayr,9834,2,23,4,9,91,46,45,73
Arbroath,9834,3,18,8,10,73,50,23,62
Alloa,9834,4,17,8,11,56,44,12,59
Stranraer,9834,5,15,5,16,58,69,-11,50
East Fife,9834,6,14,3,19,52,67,-15,45
Airdrieon,9834,7,10,11,15,45,59,-14,41
Forfar,9834,8,11,5,20,39,64,-25,38
Albion,9834,9,9,6,21,61,79,-18,33
Queen's Park,9834,10,6,10,20,41,75,-34,28
Raith,9835,1,23,8,5,75,34,41,77
Ayr,9835,2,24,4,8,92,43,49,76
Arbroath,9835,3,18,8,10,74,49,25,62
Alloa,9835,4,17,8,11,58,50,8,59
Stranraer,9835,5,16,5,15,57,65,-8,53
Airdrieon,9835,6,11,11,14,48,58,-10,44
East Fife,9835,7,13,3,20,48,66,-18,42
Forfar,9835,8,10,5,21,38,67,-29,35
Albion,9835,9,8,6,22,58,80,-22,30
Queen's Park,9835,10,6,10,20,40,76,-36,28
Raith,9836,1,23,8,5,72,35,37,77
Ayr,9836,2,23,4,9,93,48,45,73
Arbroath,9836,3,17,8,11,71,50,21,59
Alloa,9836,4,17,8,11,59,47,12,59
Stranraer,9836,5,15,6,15,58,67,-9,51
East Fife,9836,6,13,4,19,50,67,-17,43
Airdrieon,9836,7,10,11,15,45,60,-15,41
Forfar,9836,8,11,5,20,40,64,-24,38
Albion,9836,9,9,6,21,63,81,-18,33
Queen's Park,9836,10,7,10,19,41,73,-32,31
Ayr,9837,1,24,4,8,93,43,50,76
Raith,9837,2,22,9,5,68,32,36,75
Arbroath,9837,3,18,8,10,74,48,26,62
Alloa,9837,4,17,9,10,56,43,13,60
Stranraer,9837,5,15,6,15,56,65,-9,51
East Fife,9837,6,13,4,19,48,65,-17,43
Airdrieon,9837,7,10,11,15,46,60,-14,41
Forfar,9837,8,11,5,20,40,65,-25,38
Albion,9837,9,8,6,22,58,81,-23,30
Queen's Park,9837,10,6,10,20,39,76,-37,28
Raith,9838,1,22,9,5,68,32,36,75
Ayr,9838,2,23,5,8,91,43,48,74
Arbroath,9838,3,17,9,10,71,49,22,60
Alloa,9838,4,17,9,10,56,43,13,60
Stranraer,9838,5,16,5,15,59,67,-8,53
East Fife,9838,6,13,3,20,50,68,-18,42
Airdrieon,9838,7,10,11,15,46,60,-14,41
Forfar,9838,8,11,5,20,40,65,-25,38
Albion,9838,9,8,7,21,58,79,-21,31
Queen's Park,9838,10,6,11,19,40,73,-33,29
Ayr,9839,1,23,5,8,94,46,48,74
Raith,9839,2,22,8,6,68,34,34,74
Alloa,9839,3,18,8,10,58,43,15,62
Arbroath,9839,4,17,8,11,70,49,21,59
Stranraer,9839,5,15,5,16,55,65,-10,50
East Fife,9839,6,14,3,19,48,64,-16,45
Airdrieon,9839,7,10,12,14,46,59,-13,42
Forfar,9839,8,10,6,20,39,65,-26,36
Albion,9839,9,8,7,21,61,82,-21,31
Queen's Park,9839,10,7,10,19,40,72,-32,31
Ayr,9840,1,24,4,8,92,43,49,76
Raith,9840,2,22,8,6,68,33,35,74
Arbroath,9840,3,18,8,10,72,48,24,62
Alloa,9840,4,18,8,10,57,43,14,62
Stranraer,9840,5,15,6,15,55,64,-9,51
East Fife,9840,6,13,4,19,47,64,-17,43
Airdrieon,9840,7,10,12,14,46,59,-13,42
Forfar,9840,8,10,6,20,39,65,-26,36
Albion,9840,9,8,6,22,58,80,-22,30
Queen's Park,9840,10,6,10,20,39,74,-35,28
Raith,9841,1,23,8,5,70,32,38,77
Ayr,9841,2,24,4,8,93,42,51,76
Arbroath,9841,3,17,9,10,71,49,22,60
Alloa,9841,4,17,8,11,56,45,11,59
Stranraer,9841,5,15,5,16,55,67,-12,50
East Fife,9841,6,14,3,19,50,64,-14,45
Airdrieon,9841,7,10,12,14,45,58,-13,42
Forfar,9841,8,10,6,20,38,64,-26,36
Albion,9841,9,8,6,22,57,81,-24,30
Queen's Park,9841,10,6,11,19,40,73,-33,29
Raith,9842,1,23,8,5,70,33,37,77
Ayr,9842,2,24,4,8,94,42,52,76
Arbroath,9842,3,17,9,10,72,50,22,60
Alloa,9842,4,17,8,11,57,45,12,59
Stranraer,9842,5,16,5,15,59,66,-7,53
Airdrieon,9842,6,11,11,14,49,59,-10,44
East Fife,9842,7,13,3,20,49,68,-19,42
Forfar,9842,8,10,5,21,39,68,-29,35
Albion,9842,9,8,6,22,57,82,-25,30
Queen's Park,9842,10,6,11,19,41,74,-33,29
Raith,9843,1,23,8,5,71,33,38,77
Ayr,9843,2,24,4,8,94,44,50,76
Arbroath,9843,3,17,9,10,71,49,22,60
Alloa,9843,4,17,8,11,57,46,11,59
Stranraer,9843,5,15,5,16,57,67,-10,50
East Fife,9843,6,14,3,19,50,66,-16,45
Airdrieon,9843,7,11,11,14,49,58,-9,44
Forfar,9843,8,10,5,21,38,68,-30,35
Albion,9843,9,8,6,22,59,82,-23,30
Queen's Park,9843,10,6,11,19,40,73,-33,29
Ayr,9844,1,24,4,8,96,43,53,76
Raith,9844,2,22,8,6,68,33,35,74
Arbroath,9844,3,18,8,10,72,48,24,62
Alloa,9844,4,18,8,10,57,43,14,62
Stranraer,9844,5,16,5,15,59,66,-7,53
Airdrieon,9844,6,10,12,14,46,59,-13,42
East Fife,9844,7,13,3,20,49,68,-19,42
Forfar,9844,8,10,6,20,39,65,-26,36
Albion,9844,9,8,6,22,58,84,-26,30
Queen's Park,9844,10,6,10,20,39,74,-35,28
Ayr,9845,1,24,4,8,94,42,52,76
Raith,9845,2,22,9,5,70,34,36,75
Arbroath,9845,3,18,8,10,73,50,23,62
Alloa,9845,4,17,9,10,58,45,13,60
Stranraer,9845,5,16,5,15,57,65,-8,53
East Fife,9845,6,13,3,20,48,66,-18,42
Airdrieon,9845,7,10,11,15,46,61,-15,41
Forfar,9845,8,11,5,20,41,65,-24,38
Albion,9845,9,8,6,22,57,82,-25,30
Queen's Park,9845,10,6,10,20,41,75,-34,28
Raith,9846,1,23,8,5,71,34,37,77
Ayr,9846,2,24,4,8,93,42,51,76
Arbroath,9846,3,18,8,10,73,49,24,62
Alloa,9846,4,17,8,11,58,46,12,59
Stranraer,9846,5,15,5,16,55,67,-12,50
East Fife,9846,6,14,3,19,50,64,-14,45
Airdrieon,9846,7,10,11,15,45,60,-15,41
Forfar,9846,8,11,5,20,40,64,-24,38
Albion,9846,9,8,6,22,57,81,-24,30
Queen's Park,9846,10,6,10,20,40,75,-35,28
Ayr,9847,1,24,4,8,93,43,50,76
Raith,9847,2,22,8,6,69,35,34,74
Alloa,9847,3,18,8,10,59,44,15,62
Arbroath,9847,4,17,8,11,70,51,19,59
Stranraer,9847,5,16,5,15,59,65,-6,53
Airdrieon,9847,6,10,12,14,45,58,-13,42
East Fife,9847,7,13,3,20,48,68,-20,42
Forfar,9847,8,10,6,20,38,64,-26,36
Queen's Park,9847,9,7,10,19,42,72,-30,31
Albion,9847,10,8,6,22,58,81,-23,30
Ayr,9848,1,24,4,8,96,43,53,76
Raith,9848,2,22,9,5,68,32,36,75
Arbroath,9848,3,17,9,10,72,50,22,60
Alloa,9848,4,17,9,10,56,43,13,60
Stranraer,9848,5,15,5,16,56,66,-10,50
East Fife,9848,6,14,3,19,49,65,-16,45
Airdrieon,9848,7,10,12,14,47,60,-13,42
Forfar,9848,8,10,6,20,40,66,-26,36
Albion,9848,9,8,6,22,58,84,-26,30
Queen's Park,9848,10,6,11,19,41,74,-33,29
Ayr,9849,1,24,4,8,92,42,50,76
Raith,9849,2,22,9,5,69,33,36,75
Arbroath,9849,3,17,9,10,70,48,22,60
Alloa,9849,4,17,9,10,57,44,13,60
Stranraer,9849,5,16,5,15,57,65,-8,53
East Fife,9849,6,13,3,20,48,66,-18,42
Airdrieon,9849,7,10,11,15,46,61,-15,41
Forfar,9849,8,11,5,20,41,65,-24,38
Albion,9849,9,8,6,22,57,80,-23,30
Queen's Park,9849,10,6,11,19,39,72,-33,29
Raith,9850,1,23,8,5,70,33,37,77
Ayr,9850,2,24,4,8,95,44,51,76
Arbroath,9850,3,17,8,11,71,50,21,59
Alloa,9850,4,17,8,11,57,45,12,59
Stranraer,9850,5,16,5,15,58,66,-8,53
East Fife,9850,6,13,3,20,49,67,-18,42
Airdrieon,9850,7,10,11,15,45,60,-15,41
Forfar,9850,8,11,5,20,40,64,-24,38
Queen's Park,9850,9,7,10,19,41,73,-32,31
Albion,9850,10,8,6,22,59,83,-24,30
Ayr,9851,1,24,4,8,96,44,52,76
Raith,9851,2,22,8,6,68,33,35,74
Alloa,9851,3,18,8,10,57,43,14,62
Arbroath,9851,4,17,9,10,70,48,22,60
Stranraer,9851,5,15,6,15,56,65,-9,51
Airdrieon,9851,6,11,11,14,47,58,-11,44
East Fife,9851,7,13,4,19,48,65,-17,43
Forfar,9851,8,10,5,21,38,66,-28,35
Albion,9851,9,8,6,22,59,84,-25,30
Queen's Park,9851,10,6,11,19,39,72,-33,29
Ayr,9852,1,24,4,8,91,42,49,76
Raith,9852,2,22,9,5,69,33,36,75
Arbroath,9852,3,17,9,10,70,48,22,60
Alloa,9852,4,17,9,10,57,44,13,60
Stranraer,9852,5,15,6,15,55,64,-9,51
East Fife,9852,6,13,4,19,47,64,-17,43
Airdrieon,9852,7,10,11,15,46,61,-15,41
Forfar,9852,8,11,5,20,41,65,-24,38
Albion,9852,9,8,6,22,57,79,-22,30
Queen's Park,9852,10,6,11,19,39,72,-33,29
Ayr,9853,1,24,4,8,94,42,52,76
Raith,9853,2,22,9,5,69,33,36,75
Alloa,9853,3,17,9,10,57,44,13,60
Arbroath,9853,4,17,8,11,70,50,20,59
Stranraer,9853,5,15,5,16,57,67,-10,50
East Fife,9853,6,14,3,19,50,66,-16,45
Airdrieon,9853,7,10,11,15,46,61,-15,41
Forfar,9853,8,11,5,20,41,65,-24,38
Queen's Park,9853,9,7,10,19,41,72,-31,31
Albion,9853,10,8,6,22,57,82,-25,30
Raith,9854,1,23,8,5,70,32,38,77
Ayr,9854,2,23,5,8,92,44,48,74
Arbroath,9854,3,18,8,10,74,48,26,62
Alloa,9854,4,17,8,11,56,45,11,59
Stranraer,9854,5,15,6,15,56,65,-9,51
East Fife,9854,6,13,4,19,48,65,-17,43
Airdrieon,9854,7,10,11,15,47,61,-14,41
Forfar,9854,8,11,5,20,41,66,-25,38
Albion,9854,9,8,7,21,59,80,-21,31
Queen's Park,9854,10,6,10,20,39,76,-37,28
Raith,9855,1,23,8,5,71,32,39,77
Ayr,9855,2,24,4,8,93,43,50,76
Arbroath,9855,3,17,8,11,71,52,19,59
Alloa,9855,4,17,8,11,56,46,10,59
Stranraer,9855,5,15,6,15,57,66,-9,51
East Fife,9855,6,13,4,19,49,66,-17,43
Airdrieon,9855,7,10,12,14,46,59,-13,42
Forfar,9855,8,10,6,20,39,65,-26,36
Queen's Park,9855,9,7,10,19,43,73,-30,31
Albion,9855,10,8,6,22,58,81,-23,30
Raith,9856,1,23,8,5,72,32,40,77
Ayr,9856,2,24,4,8,93,42,51,76
Arbroath,9856,3,18,8,10,72,49,23,62
Alloa,9856,4,17,8,11,56,47,9,59
Stranraer,9856,5,15,5,16,58,68,-10,50
East Fife,9856,6,14,3,19,51,67,-16,45
Airdrieon,9856,7,10,11,15,46,60,-14,41
Forfar,9856,8,11,5,20,40,65,-25,38
Albion,9856,9,8,6,22,57,81,-24,30
Queen's Park,9856,10,6,10,20,40,74,-34,28
Ayr,9857,1,24,4,8,93,42,51,76
Raith,9857,2,22,9,5,69,33,36,75
Arbroath,9857,3,18,8,10,72,48,24,62
Alloa,9857,4,17,9,10,57,44,13,60
Stranraer,9857,5,15,5,16,55,70,-15,50
East Fife,9857,6,14,3,19,53,64,-11,45
Airdrieon,9857,7,11,11,14,50,60,-10,44
Forfar,9857,8,10,5,21,40,69,-29,35
Albion,9857,9,8,6,22,57,81,-24,30
Queen's Park,9857,10,6,10,20,39,74,-35,28
Raith,9858,1,23,8,5,70,33,37,77
Ayr,9858,2,24,4,8,92,43,49,76
Arbroath,9858,3,17,9,10,70,48,22,60
Alloa,9858,4,17,8,11,57,45,12,59
Stranraer,9858,5,15,6,15,57,66,-9,51
East Fife,9858,6,13,4,19,49,66,-17,43
Airdrieon,9858,7,10,12,14,45,58,-13,42
Forfar,9858,8,10,6,20,38,64,-26,36
Albion,9858,9,8,6,22,58,80,-22,30
Queen's Park,9858,10,6,11,19,39,72,-33,29
Raith,9859,1,23,8,5,71,32,39,77
Ayr,9859,2,24,4,8,92,43,49,76
Arbroath,9859,3,17,8,11,71,50,21,59
Alloa,9859,4,17,8,11,56,46,10,59
Stranraer,9859,5,15,5,16,55,67,-12,50
East Fife,9859,6,14,3,19,50,64,-14,45
Airdrieon,9859,7,10,11,15,47,61,-14,41
Forfar,9859,8,11,5,20,41,66,-25,38
Queen's Park,9859,9,7,10,19,41,73,-32,31
Albion,9859,10,8,6,22,58,80,-22,30
Raith,9860,1,23,8,5,72,32,40,77
Ayr,9860,2,24,4,8,98,43,55,76
Arbroath,9860,3,18,8,10,75,49,26,62
Alloa,9860,4,17,8,11,56,47,9,59
Stranraer,9860,5,16,5,15,58,66,-8,53
Airdrieon,9860,6,10,12,14,46,59,-13,42
East Fife,9860,7,13,3,20,49,67,-18,42
Forfar,9860,8,10,6,20,39,65,-26,36
Albion,9860,9,8,6,22,58,86,-28,30
Queen's Park,9860,10,6,10,20,40,77,-37,28
Ayr,9861,1,24,4,8,96,42,54,76
Raith,9861,2,22,9,5,70,34,36,75
Alloa,9861,3,17,9,10,58,45,13,60
Arbroath,9861,4,17,8,11,70,51,19,59
Stranraer,9861,5,15,6,15,56,65,-9,51
Airdrieon,9861,6,11,11,14,47,59,-12,44
East Fife,9861,7,13,4,19,48,65,-17,43
Forfar,9861,8,10,5,21,39,66,-27,35
Queen's Park,9861,9,7,10,19,42,72,-30,31
Albion,9861,10,8,6,22,57,84,-27,30
Raith,9862,1,23,8,5,71,33,38,77
Ayr,9862,2,23,4,9,91,44,47,73
Arbroath,9862,3,18,8,10,74,49,25,62
Alloa,9862,4,17,8,11,57,46,11,59
Stranraer,9862,5,16,5,15,57,65,-8,53
East Fife,9862,6,13,3,20,48,66,-18,42
Airdrieon,9862,7,10,11,15,46,60,-14,41
Forfar,9862,8,11,5,20,40,65,-25,38
Albion,9862,9,9,6,21,59,79,-20,33
Queen's Park,9862,10,6,10,20,40,76,-36,28
Raith,9863,1,23,8,5,70,32,38,77
Ayr,9863,2,24,4,8,92,43,49,76
Arbroath,9863,3,18,8,10,73,50,23,62
Alloa,9863,4,17,8,11,56,45,11,59
Stranraer,9863,5,15,5,16,56,67,-11,50
East Fife,9863,6,14,3,19,50,65,-15,45
Airdrieon,9863,7,10,12,14,47,60,-13,42
Forfar,9863,8,10,6,20,40,66,-26,36
Albion,9863,9,8,6,22,58,80,-22,30
Queen's Park,9863,10,6,10,20,41,75,-34,28
Raith,9864,1,23,8,5,69,32,37,77
Ayr,9864,2,23,4,9,92,46,46,73
Arbroath,9864,3,17,8,11,72,51,21,59
Alloa,9864,4,17,8,11,56,44,12,59
Stranraer,9864,5,16,5,15,58,66,-8,53
East Fife,9864,6,13,3,20,49,67,-18,42
Airdrieon,9864,7,10,11,15,45,60,-15,41
Forfar,9864,8,11,5,20,40,64,-24,38
Albion,9864,9,9,6,21,61,80,-19,33
Queen's Park,9864,10,7,10,19,42,74,-32,31
Ayr,9865,1,24,4,8,97,43,54,76
Raith,9865,2,22,8,6,69,34,35,74
Alloa,9865,3,18,8,10,58,44,14,62
Arbroath,9865,4,17,9,10,71,49,22,60
Stranraer,9865,5,15,6,15,56,65,-9,51
Airdrieon,9865,6,11,11,14,48,58,-10,44
East Fife,9865,7,13,4,19,48,65,-17,43
Forfar,9865,8,10,5,21,38,67,-29,35
Albion,9865,9,8,6,22,58,85,-27,30
Queen's Park,9865,10,6,11,19,40,73,-33,29
Raith,9866,1,23,8,5,69,32,37,77
Ayr,9866,2,24,4,8,94,44,50,76
Arbroath,9866,3,17,9,10,71,49,22,60
Alloa,9866,4,17,8,11,56,44,12,59
Stranraer,9866,5,16,5,15,57,65,-8,53
Airdrieon,9866,6,10,12,14,46,59,-13,42
East Fife,9866,7,13,3,20,48,66,-18,42
Forfar,9866,8,10,6,20,39,65,-26,36
Albion,9866,9,8,6,22,59,82,-23,30
Queen's Park,9866,10,6,11,19,40,73,-33,29
Ayr,9867,1,24,4,8,94,42,52,76
Raith,9867,2,22,8,6,68,33,35,74
Arbroath,9867,3,18,8,10,72,49,23,62
Alloa,9867,4,18,8,10,57,43,14,62
Stranraer,9867,5,15,5,16,56,67,-11,50
East Fife,9867,6,14,3,19,50,65,-15,45
Airdrieon,9867,7,11,11,14,48,58,-10,44
Forfar,9867,8,10,5,21,38,67,-29,35
Albion,9867,9,8,6,22,57,82,-25,30
Queen's Park,9867,10,6,10,20,40,74,-34,28
Raith,9868,1,23,8,5,69,32,37,77
Ayr,9868,2,24,4,8,93,44,49,76
Arbroath,9868,3,18,8,10,74,50,24,62
Alloa,9868,4,17,8,11,56,44,12,59
Stranraer,9868,5,16,5,15,57,65,-8,53
East Fife,9868,6,13,3,20,48,66,-18,42
Airdrieon,9868,7,10,11,15,45,60,-15,41
Forfar,9868,8,11,5,20,40,64,-24,38
Albion,9868,9,8,6,22,59,81,-22,30
Queen's Park,9868,10,6,10,20,41,76,-35,28
Raith,9869,1,23,8,5,70,33,37,77
Ayr,9869,2,24,4,8,94,42,52,76
Arbroath,9869,3,18,8,10,75,50,25,62
Alloa,9869,4,17,8,11,57,45,12,59
Stranraer,9869,5,16,5,15,57,64,-7,53
Airdrieon,9869,6,10,12,14,46,59,-13,42
East Fife,9869,7,13,3,20,47,66,-19,42
Forfar,9869,8,10,6,20,39,65,-26,36
Albion,9869,9,8,6,22,57,82,-25,30
Queen's Park,9869,10,6,10,20,41,77,-36,28
Ayr,9870,1,24,4,8,92,43,49,76
Raith,9870,2,22,9,5,69,33,36,75
Arbroath,9870,3,18,8,10,74,49,25,62
Alloa,9870,4,17,9,10,57,44,13,60
Stranraer,9870,5,15,5,16,55,66,-11,50
East Fife,9870,6,14,3,19,49,64,-15,45
Airdrieon,9870,7,11,11,14,46,58,-12,44
Forfar,9870,8,10,5,21,38,65,-27,35
Albion,9870,9,8,6,22,58,80,-22,30
Queen's Park,9870,10,6,10,20,40,76,-36,28
Ayr,9871,1,24,4,8,95,43,52,76
Raith,9871,2,22,9,5,68,32,36,75
Arbroath,9871,3,17,9,10,71,49,22,60
Alloa,9871,4,17,9,10,56,43,13,60
Stranraer,9871,5,16,5,15,57,65,-8,53
East Fife,9871,6,13,3,20,48,66,-18,42
Airdrieon,9871,7,10,11,15,46,60,-14,41
Forfar,9871,8,11,5,20,40,65,-25,38
Albion,9871,9,8,6,22,58,83,-25,30
Queen's Park,9871,10,6,11,19,40,73,-33,29
Ayr,9872,1,24,4,8,95,43,52,76
Raith,9872,2,22,9,5,70,34,36,75
Arbroath,9872,3,17,9,10,71,49,22,60
Alloa,9872,4,17,9,10,58,45,13,60
Stranraer,9872,5,15,6,15,55,64,-9,51
East Fife,9872,6,13,4,19,47,64,-17,43
Airdrieon,9872,7,10,12,14,46,59,-13,42
Forfar,9872,8,10,6,20,39,65,-26,36
Albion,9872,9,8,6,22,58,83,-25,30
Queen's Park,9872,10,6,11,19,40,73,-33,29
Raith,9873,1,23,8,5,71,34,37,77
Ayr,9873,2,24,4,8,94,44,50,76
Arbroath,9873,3,18,8,10,73,49,24,62
Alloa,9873,4,17,8,11,58,46,12,59
Stranraer,9873,5,16,5,15,58,65,-7,53
Airdrieon,9873,6,10,12,14,45,58,-13,42
East Fife,9873,7,13,3,20,48,67,-19,42
Forfar,9873,8,10,6,20,38,64,-26,36
Albion,9873,9,8,6,22,59,82,-23,30
Queen's Park,9873,10,6,10,20,40,75,-35,28
Raith,9874,1,23,8,5,69,32,37,77
Ayr,9874,2,24,4,8,96,44,52,76
Arbroath,9874,3,18,8,10,73,49,24,62
Alloa,9874,4,17,8,11,56,44,12,59
Stranraer,9874,5,15,5,16,56,66,-10,50
East Fife,9874,6,14,3,19,49,65,-16,45
Airdrieon,9874,7,10,11,15,46,60,-14,41
Forfar,9874,8,11,5,20,40,65,-25,38
Albion,9874,9,8,6,22,59,84,-25,30
Queen's Park,9874,10,6,10,20,40,75,-35,28
Raith,9875,1,23,8,5,69,32,37,77
Ayr,9875,2,23,5,8,91,43,48,74
Arbroath,9875,3,17,9,10,72,50,22,60
Alloa,9875,4,17,8,11,56,44,12,59
Stranraer,9875,5,15,5,16,57,68,-11,50
East Fife,9875,6,14,3,19,51,66,-15,45
Airdrieon,9875,7,11,11,14,49,58,-9,44
Forfar,9875,8,10,5,21,38,68,-30,35
Albion,9875,9,8,7,21,58,79,-21,31
Queen's Park,9875,10,6,11,19,41,74,-33,29
Ayr,9876,1,24,4,8,92,42,50,76
Raith,9876,2,22,8,6,68,33,35,74
Alloa,9876,3,18,8,10,57,43,14,62
Arbroath,9876,4,17,8,11,71,50,21,59
Stranraer,9876,5,15,5,16,55,66,-11,50
East Fife,9876,6,14,3,19,49,64,-15,45
Airdrieon,9876,7,10,11,15,45,60,-15,41
Forfar,9876,8,11,5,20,40,64,-24,38
Queen's Park,9876,9,7,10,19,41,73,-32,31
Albion,9876,10,8,6,22,57,80,-23,30
Ayr,9877,1,24,4,8,96,45,51,76
Raith,9877,2,22,9,5,68,32,36,75
Arbroath,9877,3,18,8,10,72,49,23,62
Alloa,9877,4,17,9,10,56,43,13,60
Stranraer,9877,5,15,5,16,55,66,-11,50
East Fife,9877,6,14,3,19,49,64,-15,45
Airdrieon,9877,7,11,11,14,47,58,-11,44
Forfar,9877,8,10,5,21,38,66,-28,35
Albion,9877,9,8,6,22,60,84,-24,30
Queen's Park,9877,10,6,10,20,40,74,-34,28
Raith,9878,1,23,8,5,70,32,38,77
Ayr,9878,2,24,4,8,93,42,51,76
Arbroath,9878,3,18,8,10,73,50,23,62
Alloa,9878,4,17,8,11,56,45,11,59
Stranraer,9878,5,16,5,15,58,65,-7,53
Airdrieon,9878,6,10,12,14,46,59,-13,42
East Fife,9878,7,13,3,20,48,67,-19,42
Forfar,9878,8,10,6,20,39,65,-26,36
Albion,9878,9,8,6,22,57,81,-24,30
Queen's Park,9878,10,6,10,20,41,75,-34,28
Ayr,9879,1,24,4,8,92,43,49,76
Raith,9879,2,22,9,5,69,33,36,75
Alloa,9879,3,17,9,10,57,44,13,60
Arbroath,9879,4,17,8,11,71,50,21,59
Stranraer,9879,5,16,5,15,57,64,-7,53
Airdrieon,9879,6,11,11,14,47,58,-11,44
East Fife,9879,7,13,3,20,47,66,-19,42
Forfar,9879,8,10,5,21,38,66,-28,35
Queen's Park,9879,9,7,10,19,41,73,-32,31
Albion,9879,10,8,6,22,58,80,-22,30
Raith,9880,1,22,9,5,68,32,36,75
Ayr,9880,2,23,5,8,91,43,48,74
Arbroath,9880,3,17,9,10,71,49,22,60
Alloa,9880,4,17,9,10,56,43,13,60
Stranraer,9880,5,16,5,15,57,65,-8,53
East Fife,9880,6,13,3,20,48,66,-18,42
Airdrieon,9880,7,10,11,15,45,60,-15,41
Forfar,9880,8,11,5,20,40,64,-24,38
Albion,9880,9,8,7,21,58,79,-21,31
Queen's Park,9880,10,6,11,19,40,73,-33,29
Raith,9881,1,23,8,5,72,32,40,77
Ayr,9881,2,24,4,8,97,45,52,76
Arbroath,9881,3,18,8,10,74,50,24,62
Alloa,9881,4,17,8,11,56,47,9,59
Stranraer,9881,5,15,5,16,55,66,-11,50
East Fife,9881,6,14,3,19,49,64,-15,45
Airdrieon,9881,7,11,11,14,47,59,-12,44
Forfar,9881,8,10,5,21,39,66,-27,35
Albion,9881,9,8,6,22,60,85,-25,30
Queen's Park,9881,10,6,10,20,41,76,-35,28
Ayr,9882,1,24,4,8,96,43,53,76
Raith,9882,2,22,8,6,68,33,35,74
Arbroath,9882,3,18,8,10,73,49,24,62
Alloa,9882,4,18,8,10,57,43,14,62
Stranraer,9882,5,15,5,16,56,68,-12,50
East Fife,9882,6,14,3,19,51,65,-14,45
Airdrieon,9882,7,10,11,15,45,59,-14,41
Forfar,9882,8,11,5,20,39,64,-25,38
Albion,9882,9,8,6,22,58,84,-26,30
Queen's Park,9882,10,6,10,20,40,75,-35,28
Ayr,9883,1,24,4,8,96,42,54,76
Raith,9883,2,22,9,5,69,33,36,75
Alloa,9883,3,17,9,10,57,44,13,60
Arbroath,9883,4,17,8,11,70,50,20,59
Stranraer,9883,5,16,5,15,56,64,-8,53
Airdrieon,9883,6,11,11,14,47,58,-11,44
East Fife,9883,7,13,3,20,47,65,-18,42
Forfar,9883,8,10,5,21,38,66,-28,35
Queen's Park,9883,9,7,10,19,41,72,-31,31
Albion,9883,10,8,6,22,57,84,-27,30
Raith,9884,1,23,8,5,70,32,38,77
Ayr,9884,2,24,4,8,92,42,50,76
Arbroath,9884,3,17,9,10,71,49,22,60
Alloa,9884,4,17,8,11,56,45,11,59
Stranraer,9884,5,16,5,15,57,64,-7,53
East Fife,9884,6,13,3,20,47,66,-19,42
Airdrieon,9884,7,10,11,15,46,60,-14,41
Forfar,9884,8,11,5,20,40,65,-25,38
Albion,9884,9,8,6,22,57,80,-23,30
Queen's Park,9884,10,6,11,19,40,73,-33,29
Raith,9885,1,23,8,5,70,33,37,77
Ayr,9885,2,24,4,8,95,45,50,76
Arbroath,9885,3,18,8,10,72,48,24,62
Alloa,9885,4,17,8,11,57,45,12,59
Stranraer,9885,5,15,5,16,56,66,-10,50
East Fife,9885,6,14,3,19,49,65,-16,45
Airdrieon,9885,7,11,11,14,49,60,-11,44
Forfar,9885,8,10,5,21,40,68,-28,35
Albion,9885,9,8,6,22,60,83,-23,30
Queen's Park,9885,10,6,10,20,39,74,-35,28
Raith,9886,1,23,8,5,72,34,38,77
Ayr,9886,2,24,4,8,93,43,50,76
Arbroath,9886,3,18,8,10,72,48,24,62
Alloa,9886,4,17,8,11,58,47,11,59
Stranraer,9886,5,16,5,15,57,64,-7,53
Airdrieon,9886,6,10,12,14,49,62,-13,42
East Fife,9886,7,13,3,20,47,66,-19,42
Forfar,9886,8,10,6,20,42,68,-26,36
Albion,9886,9,8,6,22,58,81,-23,30
Queen's Park,9886,10,6,10,20,39,74,-35,28
Raith,9887,1,23,8,5,70,33,37,77
Ayr,9887,2,24,4,8,94,42,52,76
Arbroath,9887,3,18,8,10,72,49,23,62
Alloa,9887,4,17,8,11,57,45,12,59
Stranraer,9887,5,15,5,16,55,66,-11,50
East Fife,9887,6,14,3,19,49,64,-15,45
Airdrieon,9887,7,11,11,14,47,59,-12,44
Forfar,9887,8,10,5,21,39,66,-27,35
Albion,9887,9,8,6,22,57,82,-25,30
Queen's Park,9887,10,6,10,20,40,74,-34,28
Ayr,9888,1,24,4,8,93,43,50,76
Raith,9888,2,22,8,6,68,33,35,74
Alloa,9888,3,18,8,10,57,43,14,62
Arbroath,9888,4,17,8,11,72,53,19,59
Stranraer,9888,5,16,5,15,57,64,-7,53
Airdrieon,9888,6,11,11,14,47,59,-12,44
East Fife,9888,7,13,3,20,47,66,-19,42
Forfar,9888,8,10,5,21,39,66,-27,35
Queen's Park,9888,9,7,10,19,44,74,-30,31
Albion,9888,10,8,6,22,58,81,-23,30
Ayr,9889,1,24,4,8,96,44,52,76
Raith,9889,2,22,8,6,68,33,35,74
Arbroath,9889,3,18,8,10,73,50,23,62
Alloa,9889,4,18,8,10,57,43,14,62
Stranraer,9889,5,15,6,15,55,64,-9,51
East Fife,9889,6,13,4,19,47,64,-17,43
Airdrieon,9889,7,10,11,15,45,60,-15,41
Forfar,9889,8,11,5,20,40,64,-24,38
Albion,9889,9,8,6,22,59,84,-25,30
Queen's Park,9889,10,6,10,20,41,75,-34,28
Raith,9890,1,23,8,5,69,32,37,77
Ayr,9890,2,23,4,9,91,44,47,73
Arbroath,9890,3,17,8,11,70,52,18,59
Alloa,9890,4,17,8,11,56,44,12,59
Stranraer,9890,5,15,6,15,56,65,-9,51
Airdrieon,9890,6,11,11,14,49,60,-11,44
East Fife,9890,7,13,4,19,48,65,-17,43
Forfar,9890,8,10,5,21,40,68,-28,35
Albion,9890,9,9,6,21,59,79,-20,33
Queen's Park,9890,10,7,10,19,43,72,-29,31
Ayr,9891,1,24,4,8,95,43,52,76
Raith,9891,2,22,9,5,69,33,36,75
Arbroath,9891,3,17,9,10,72,50,22,60
Alloa,9891,4,17,9,10,57,44,13,60
Stranraer,9891,5,15,5,16,56,66,-10,50
East Fife,9891,6,14,3,19,49,65,-16,45
Airdrieon,9891,7,10,12,14,47,60,-13,42
Forfar,9891,8,10,6,20,40,66,-26,36
Albion,9891,9,8,6,22,58,83,-25,30
Queen's Park,9891,10,6,11,19,41,74,-33,29
Ayr,9892,1,24,4,8,94,42,52,76
Raith,9892,2,22,9,5,69,33,36,75
Alloa,9892,3,17,9,10,57,44,13,60
Arbroath,9892,4,17,8,11,70,49,21,59
Stranraer,9892,5,15,5,16,55,66,-11,50
East Fife,9892,6,14,3,19,49,64,-15,45
Airdrieon,9892,7,11,11,14,47,59,-12,44
Forfar,9892,8,10,5,21,39,66,-27,35
Queen's Park,9892,9,7,10,19,40,72,-32,31
Albion,9892,10,8,6,22,57,82,-25,30
Raith,9893,1,23,8,5,72,32,40,77
Ayr,9893,2,24,4,8,92,42,50,76
Arbroath,9893,3,17,9,10,71,49,22,60
Alloa,9893,4,17,8,11,56,47,9,59
Stranraer,9893,5,15,6,15,56,65,-9,51
East Fife,9893,6,13,4,19,48,65,-17,43
Airdrieon,9893,7,10,12,14,46,59,-13,42
Forfar,9893,8,10,6,20,39,65,-26,36
Albion,9893,9,8,6,22,57,80,-23,30
Queen's Park,9893,10,6,11,19,40,73,-33,29
Raith,9894,1,23,8,5,71,33,38,77
Ayr,9894,2,23,5,8,92,44,48,74
Arbroath,9894,3,17,8,11,70,49,21,59
Alloa,9894,4,17,8,11,57,46,11,59
Stranraer,9894,5,16,5,15,58,65,-7,53
East Fife,9894,6,13,3,20,48,67,-19,42
Airdrieon,9894,7,10,11,15,46,60,-14,41
Forfar,9894,8,11,5,20,40,65,-25,38
Albion,9894,9,8,7,21,59,80,-21,31
Queen's Park,9894,10,7,10,19,40,72,-32,31
Ayr,9895,1,24,4,8,92,42,50,76
Raith,9895,2,22,8,6,69,36,33,74
Alloa,9895,3,18,8,10,60,44,16,62
Arbroath,9895,4,17,8,11,70,49,21,59
Stranraer,9895,5,15,5,16,56,66,-10,50
East Fife,9895,6,14,3,19,49,65,-16,45
Airdrieon,9895,7,10,11,15,45,60,-15,41
Forfar,9895,8,11,5,20,40,64,-24,38
Queen's Park,9895,9,7,10,19,40,72,-32,31
Albion,9895,10,8,6,22,57,80,-23,30
Raith,9896,1,23,8,5,72,33,39,77
Ayr,9896,2,23,4,9,93,46,47,73
Arbroath,9896,3,17,8,11,70,51,19,59
Alloa,9896,4,17,8,11,57,47,10,59
Stranraer,9896,5,15,5,16,57,67,-10,50
East Fife,9896,6,14,3,19,50,66,-16,45
Airdrieon,9896,7,11,11,14,46,58,-12,44
Forfar,9896,8,10,5,21,38,65,-27,35
Albion,9896,9,9,6,21,61,81,-20,33
Queen's Park,9896,10,7,10,19,42,72,-30,31
Raith,9897,1,23,8,5,70,33,37,77
Ayr,9897,2,24,4,8,93,42,51,76
Arbroath,9897,3,18,8,10,71,48,23,62
Alloa,9897,4,17,8,11,57,45,12,59
Stranraer,9897,5,16,5,15,59,67,-8,53
Airdrieon,9897,6,10,12,14,45,58,-13,42
East Fife,9897,7,13,3,20,50,68,-18,42
Forfar,9897,8,10,6,20,38,64,-26,36
Albion,9897,9,8,6,22,57,81,-24,30
Queen's Park,9897,10,6,10,20,39,73,-34,28
Ayr,9898,1,24,4,8,94,44,50,76
Raith,9898,2,22,9,5,70,34,36,75
Arbroath,9898,3,17,9,10,70,48,22,60
Alloa,9898,4,17,9,10,58,45,13,60
Stranraer,9898,5,15,5,16,57,68,-11,50
East Fife,9898,6,14,3,19,51,66,-15,45
Airdrieon,9898,7,10,12,14,45,58,-13,42
Forfar,9898,8,10,6,20,38,64,-26,36
Albion,9898,9,8,6,22,59,82,-23,30
Queen's Park,9898,10,6,11,19,39,72,-33,29
Raith,9899,1,23,8,5,72,33,39,77
Ayr,9899,2,24,4,8,94,42,52,76
Arbroath,9899,3,17,8,11,70,52,18,59
Alloa,9899,4,17,8,11,57,47,10,59
Stranraer,9899,5,16,5,15,56,64,-8,53
Airdrieon,9899,6,11,11,14,46,58,-12,44
East Fife,9899,7,13,3,20,47,65,-18,42
Forfar,9899,8,10,5,21,38,65,-27,35
Queen's Park,9899,9,7,10,19,43,72,-29,31
Albion,9899,10,8,6,22,57,82,-25,30
Raith,9900,1,23,8,5,70,33,37,77
Ayr,9900,2,24,4,8,93,44,49,76
Arbroath,9900,3,18,8,10,71,48,23,62
Alloa,9900,4,17,8,11,57,45,12,59
Stranraer,9900,5,15,6,15,56,65,-9,51
East Fife,9900,6,13,4,19,48,65,-17,43
Airdrieon,9900,7,10,12,14,46,59,-13,42
Forfar,9900,8,10,6,20,39,65,-26,36
Albion,9900,9,8,6,22,59,81,-22,30
Queen's Park,9900,10,6,10,20,39,73,-34,28
Raith,9901,1,23,8,5,69,32,37,77
Ayr,9901,2,24,4,8,92,42,50,76
Arbroath,9901,3,17,8,11,70,53,17,59
Alloa,9901,4,17,8,11,56,44,12,59
Stranraer,9901,5,15,5,16,57,67,-10,50
East Fife,9901,6,14,3,19,50,66,-16,45
Airdrieon,9901,7,10,12,14,47,60,-13,42
Forfar,9901,8,10,6,20,40,66,-26,36
Queen's Park,9901,9,7,10,19,44,72,-28,31
Albion,9901,10,8,6,22,57,80,-23,30
Raith,9902,1,23,8,5,72,32,40,77
Ayr,9902,2,23,5,8,91,43,48,74
Arbroath,9902,3,17,8,11,71,50,21,59
Alloa,9902,4,17,8,11,56,47,9,59
Stranraer,9902,5,15,6,15,55,64,-9,51
East Fife,9902,6,13,4,19,47,64,-17,43
Airdrieon,9902,7,10,11,15,45,59,-14,41
Forfar,9902,8,11,5,20,39,64,-25,38
Albion,9902,9,8,7,21,58,79,-21,31
Queen's Park,9902,10,7,10,19,41,73,-32,31
Raith,9903,1,23,8,5,70,33,37,77
Ayr,9903,2,24,4,8,93,44,49,76
Arbroath,9903,3,17,8,11,71,50,21,59
Alloa,9903,4,17,8,11,57,45,12,59
Stranraer,9903,5,16,5,15,56,64,-8,53
Airdrieon,9903,6,11,11,14,49,61,-12,44
East Fife,9903,7,13,3,20,47,65,-18,42
Forfar,9903,8,10,5,21,41,68,-27,35
Queen's Park,9903,9,7,10,19,41,73,-32,31
Albion,9903,10,8,6,22,59,81,-22,30
Ayr,9904,1,24,4,8,91,42,49,76
Raith,9904,2,22,9,5,69,33,36,75
Arbroath,9904,3,18,8,10,73,50,23,62
Alloa,9904,4,17,9,10,57,44,13,60
Stranraer,9904,5,16,5,15,57,64,-7,53
Airdrieon,9904,6,11,11,14,49,58,-9,44
East Fife,9904,7,13,3,20,47,66,-19,42
Forfar,9904,8,10,5,21,38,68,-30,35
Albion,9904,9,8,6,22,57,79,-22,30
Queen's Park,9904,10,6,10,20,41,75,-34,28
Ayr,9905,1,24,4,8,91,42,49,76
Raith,9905,2,22,8,6,69,35,34,74
Alloa,9905,3,18,8,10,59,44,15,62
Arbroath,9905,4,17,8,11,71,52,19,59
Stranraer,9905,5,15,5,16,55,66,-11,50
East Fife,9905,6,14,3,19,49,64,-15,45
Airdrieon,9905,7,11,11,14,47,59,-12,44
Forfar,9905,8,10,5,21,39,66,-27,35
Queen's Park,9905,9,7,10,19,43,73,-30,31
Albion,9905,10,8,6,22,57,79,-22,30
Raith,9906,1,23,8,5,69,32,37,77
Ayr,9906,2,24,4,8,94,44,50,76
Arbroath,9906,3,18,8,10,71,48,23,62
Alloa,9906,4,17,8,11,56,44,12,59
Stranraer,9906,5,16,5,15,56,64,-8,53
Airdrieon,9906,6,11,11,14,47,58,-11,44
East Fife,9906,7,13,3,20,47,65,-18,42
Forfar,9906,8,10,5,21,38,66,-28,35
Albion,9906,9,8,6,22,59,82,-23,30
Queen's Park,9906,10,6,10,20,39,73,-34,28
Raith,9907,1,22,9,5,69,33,36,75
Ayr,9907,2,23,5,8,91,43,48,74
Arbroath,9907,3,17,9,10,71,49,22,60
Alloa,9907,4,17,9,10,57,44,13,60
Stranraer,9907,5,15,5,16,55,68,-13,50
East Fife,9907,6,14,3,19,51,64,-13,45
Airdrieon,9907,7,10,11,15,45,59,-14,41
Forfar,9907,8,11,5,20,39,64,-25,38
Albion,9907,9,8,7,21,58,79,-21,31
Queen's Park,9907,10,6,11,19,40,73,-33,29
Raith,9908,1,23,8,5,69,32,37,77
Ayr,9908,2,24,4,8,94,43,51,76
Arbroath,9908,3,17,8,11,71,51,20,59
Alloa,9908,4,17,8,11,56,44,12,59
Stranraer,9908,5,15,6,15,56,65,-9,51
East Fife,9908,6,13,4,19,48,65,-17,43
Airdrieon,9908,7,10,12,14,45,58,-13,42
Forfar,9908,8,10,6,20,38,64,-26,36
Queen's Park,9908,9,7,10,19,42,73,-31,31
Albion,9908,10,8,6,22,58,82,-24,30
Raith,9909,1,23,8,5,72,32,40,77
Ayr,9909,2,24,4,8,93,42,51,76
Arbroath,9909,3,17,9,10,71,49,22,60
Alloa,9909,4,17,8,11,56,47,9,59
Stranraer,9909,5,16,5,15,58,66,-8,53
Airdrieon,9909,6,11,11,14,47,59,-12,44
East Fife,9909,7,13,3,20,49,67,-18,42
Forfar,9909,8,10,5,21,39,66,-27,35
Albion,9909,9,8,6,22,57,81,-24,30
Queen's Park,9909,10,6,11,19,40,73,-33,29
Raith,9910,1,23,8,5,71,34,37,77
Ayr,9910,2,23,5,8,91,43,48,74
Arbroath,9910,3,18,8,10,76,49,27,62
Alloa,9910,4,17,8,11,58,46,12,59
Stranraer,9910,5,16,5,15,57,65,-8,53
Airdrieon,9910,6,11,11,14,49,58,-9,44
East Fife,9910,7,13,3,20,48,66,-18,42
Forfar,9910,8,10,5,21,38,68,-30,35
Albion,9910,9,8,7,21,58,79,-21,31
Queen's Park,9910,10,6,10,20,40,78,-38,28
Raith,9911,1,23,8,5,70,32,38,77
Ayr,9911,2,24,4,8,95,43,52,76
Arbroath,9911,3,17,8,11,72,52,20,59
Alloa,9911,4,17,8,11,56,45,11,59
Stranraer,9911,5,15,5,16,55,66,-11,50
East Fife,9911,6,14,3,19,49,64,-15,45
Airdrieon,9911,7,11,11,14,46,58,-12,44
Forfar,9911,8,10,5,21,38,65,-27,35
Queen's Park,9911,9,7,10,19,43,74,-31,31
Albion,9911,10,8,6,22,58,83,-25,30
Raith,9912,1,23,8,5,70,33,37,77
Ayr,9912,2,23,4,9,90,45,45,73
Arbroath,9912,3,17,8,11,71,50,21,59
Alloa,9912,4,17,8,11,57,45,12,59
Stranraer,9912,5,15,5,16,57,67,-10,50
East Fife,9912,6,14,3,19,50,66,-16,45
Airdrieon,9912,7,11,11,14,49,60,-11,44
Forfar,9912,8,10,5,21,40,68,-28,35
Albion,9912,9,9,6,21,60,78,-18,33
Queen's Park,9912,10,7,10,19,41,73,-32,31
Ayr,9913,1,24,4,8,96,45,51,76
Raith,9913,2,22,9,5,68,32,36,75
Arbroath,9913,3,17,9,10,71,49,22,60
Alloa,9913,4,17,9,10,56,43,13,60
Stranraer,9913,5,15,5,16,55,66,-11,50
East Fife,9913,6,14,3,19,49,64,-15,45
Airdrieon,9913,7,11,11,14,50,59,-9,44
Forfar,9913,8,10,5,21,39,69,-30,35
Albion,9913,9,8,6,22,60,84,-24,30
Queen's Park,9913,10,6,11,19,40,73,-33,29
Raith,9914,1,23,8,5,71,33,38,77
Ayr,9914,2,24,4,8,92,42,50,76
Arbroath,9914,3,17,8,11,70,51,19,59
Alloa,9914,4,17,8,11,57,46,11,59
Stranraer,9914,5,15,6,15,57,66,-9,51
East Fife,9914,6,13,4,19,49,66,-17,43
Airdrieon,9914,7,10,11,15,45,61,-16,41
Forfar,9914,8,11,5,20,41,64,-23,38
Queen's Park,9914,9,7,10,19,42,72,-30,31
Albion,9914,10,8,6,22,57,80,-23,30
Raith,9915,1,23,8,5,71,34,37,77
Ayr,9915,2,24,4,8,94,45,49,76
Arbroath,9915,3,18,8,10,73,48,25,62
Alloa,9915,4,17,8,11,58,46,12,59
Stranraer,9915,5,16,5,15,57,64,-7,53
Airdrieon,9915,6,11,11,14,50,58,-8,44
East Fife,9915,7,13,3,20,47,66,-19,42
Forfar,9915,8,10,5,21,38,69,-31,35
Albion,9915,9,8,6,22,60,82,-22,30
Queen's Park,9915,10,6,10,20,39,75,-36,28
Ayr,9916,1,24,4,8,94,42,52,76
Raith,9916,2,22,8,6,69,35,34,74
Alloa,9916,3,18,8,10,59,44,15,62
Arbroath,9916,4,17,9,10,71,49,22,60
Stranraer,9916,5,16,5,15,58,65,-7,53
Airdrieon,9916,6,11,11,14,48,60,-12,44
East Fife,9916,7,13,3,20,48,67,-19,42
Forfar,9916,8,10,5,21,40,67,-27,35
Albion,9916,9,8,6,22,57,82,-25,30
Queen's Park,9916,10,6,11,19,40,73,-33,29
Ayr,9917,1,24,4,8,93,43,50,76
Raith,9917,2,22,9,5,69,33,36,75
Arbroath,9917,3,18,8,10,75,48,27,62
Alloa,9917,4,17,9,10,57,44,13,60
Stranraer,9917,5,16,5,15,57,65,-8,53
Airdrieon,9917,6,11,11,14,46,58,-12,44
East Fife,9917,7,13,3,20,48,66,-18,42
Forfar,9917,8,10,5,21,38,65,-27,35
Albion,9917,9,8,6,22,58,81,-23,30
Queen's Park,9917,10,6,10,20,39,77,-38,28
Raith,9918,1,23,8,5,70,32,38,77
Ayr,9918,2,24,4,8,93,44,49,76
Arbroath,9918,3,18,8,10,72,49,23,62
Alloa,9918,4,17,8,11,56,45,11,59
Stranraer,9918,5,15,6,15,55,64,-9,51
East Fife,9918,6,13,4,19,47,64,-17,43
Airdrieon,9918,7,10,12,14,45,58,-13,42
Forfar,9918,8,10,6,20,38,64,-26,36
Albion,9918,9,8,6,22,59,81,-22,30
Queen's Park,9918,10,6,10,20,40,74,-34,28
Ayr,9919,1,24,4,8,94,44,50,76
Raith,9919,2,22,9,5,69,33,36,75
Arbroath,9919,3,18,8,10,72,49,23,62
Alloa,9919,4,17,9,10,57,44,13,60
Stranraer,9919,5,15,5,16,55,68,-13,50
East Fife,9919,6,14,3,19,51,64,-13,45
Airdrieon,9919,7,11,11,14,50,58,-8,44
Forfar,9919,8,10,5,21,38,69,-31,35
Albion,9919,9,8,6,22,59,82,-23,30
Queen's Park,9919,10,6,10,20,40,74,-34,28
Ayr,9920,1,24,4,8,94,43,51,76
Raith,9920,2,22,8,6,70,37,33,74
Arbroath,9920,3,18,8,10,75,51,24,62
Alloa,9920,4,18,8,10,61,45,16,62
Stranraer,9920,5,15,5,16,55,65,-10,50
East Fife,9920,6,14,3,19,48,64,-16,45
Airdrieon,9920,7,11,11,14,49,58,-9,44
Forfar,9920,8,10,5,21,38,68,-30,35
Albion,9920,9,8,6,22,58,82,-24,30
Queen's Park,9920,10,6,10,20,42,77,-35,28
Raith,9921,1,23,8,5,71,32,39,77
Ayr,9921,2,23,5,8,92,44,48,74
Arbroath,9921,3,17,9,10,71,49,22,60
Alloa,9921,4,17,8,11,56,46,10,59
Stranraer,9921,5,16,5,15,58,64,-6,53
Airdrieon,9921,6,11,11,14,49,59,-10,44
East Fife,9921,7,13,3,20,47,67,-20,42
Forfar,9921,8,10,5,21,39,68,-29,35
Albion,9921,9,8,7,21,59,80,-21,31
Queen's Park,9921,10,6,11,19,40,73,-33,29
Raith,9922,1,23,8,5,70,33,37,77
Ayr,9922,2,23,5,8,93,45,48,74
Arbroath,9922,3,18,8,10,71,48,23,62
Alloa,9922,4,17,8,11,57,45,12,59
Stranraer,9922,5,15,5,16,56,67,-11,50
East Fife,9922,6,14,3,19,50,65,-15,45
Airdrieon,9922,7,10,12,14,46,59,-13,42
Forfar,9922,8,10,6,20,39,65,-26,36
Albion,9922,9,8,7,21,60,81,-21,31
Queen's Park,9922,10,6,10,20,39,73,-34,28
Raith,9923,1,23,8,5,69,32,37,77
Ayr,9923,2,23,4,9,91,44,47,73
Arbroath,9923,3,18,8,10,71,48,23,62
Alloa,9923,4,17,8,11,56,44,12,59
Stranraer,9923,5,16,5,15,58,66,-8,53
Airdrieon,9923,6,11,11,14,48,60,-12,44
East Fife,9923,7,13,3,20,49,67,-18,42
Forfar,9923,8,10,5,21,40,67,-27,35
Albion,9923,9,9,6,21,59,79,-20,33
Queen's Park,9923,10,6,10,20,39,73,-34,28
Raith,9924,1,23,8,5,70,33,37,77
Ayr,9924,2,23,5,8,91,43,48,74
Arbroath,9924,3,17,8,11,71,50,21,59
Alloa,9924,4,17,8,11,57,45,12,59
Stranraer,9924,5,16,5,15,57,64,-7,53
Airdrieon,9924,6,10,12,14,46,59,-13,42
East Fife,9924,7,13,3,20,47,66,-19,42
Forfar,9924,8,10,6,20,39,65,-26,36
Albion,9924,9,8,7,21,58,79,-21,31
Queen's Park,9924,10,7,10,19,41,73,-32,31
Raith,9925,1,23,8,5,71,33,38,77
Ayr,9925,2,24,4,8,93,42,51,76
Arbroath,9925,3,17,9,10,71,49,22,60
Alloa,9925,4,17,8,11,57,46,11,59
Stranraer,9925,5,16,5,15,59,64,-5,53
East Fife,9925,6,13,3,20,47,68,-21,42
Airdrieon,9925,7,10,11,15,46,60,-14,41
Forfar,9925,8,11,5,20,40,65,-25,38
Albion,9925,9,8,6,22,57,81,-24,30
Queen's Park,9925,10,6,11,19,40,73,-33,29
Raith,9926,1,23,8,5,73,35,38,77
Ayr,9926,2,24,4,8,95,44,51,76
Arbroath,9926,3,18,8,10,73,48,25,62
Alloa,9926,4,17,8,11,59,48,11,59
Stranraer,9926,5,15,5,16,55,65,-10,50
East Fife,9926,6,14,3,19,48,64,-16,45
Airdrieon,9926,7,11,11,14,47,58,-11,44
Forfar,9926,8,10,5,21,38,66,-28,35
Albion,9926,9,8,6,22,59,83,-24,30
Queen's Park,9926,10,6,10,20,39,75,-36,28
Raith,9927,1,22,8,6,70,37,33,74
Ayr,9927,2,23,4,9,90,45,45,73
Alloa,9927,3,18,8,10,61,45,16,62
Arbroath,9927,4,17,9,10,71,49,22,60
Stranraer,9927,5,15,6,15,58,67,-9,51
East Fife,9927,6,13,4,19,50,67,-17,43
Airdrieon,9927,7,10,11,15,45,59,-14,41
Forfar,9927,8,11,5,20,39,64,-25,38
Albion,9927,9,9,6,21,60,78,-18,33
Queen's Park,9927,10,6,11,19,40,73,-33,29
Raith,9928,1,23,8,5,73,32,41,77
Ayr,9928,2,24,4,8,95,43,52,76
Arbroath,9928,3,17,8,11,71,53,18,59
Alloa,9928,4,17,8,11,56,48,8,59
Stranraer,9928,5,15,5,16,58,68,-10,50
East Fife,9928,6,14,3,19,51,67,-16,45
Airdrieon,9928,7,11,11,14,48,59,-11,44
Forfar,9928,8,10,5,21,39,67,-28,35
Queen's Park,9928,9,7,10,19,44,73,-29,31
Albion,9928,10,8,6,22,58,83,-25,30
Raith,9929,1,23,8,5,71,33,38,77
Ayr,9929,2,24,4,8,92,42,50,76
Arbroath,9929,3,18,8,10,75,51,24,62
Alloa,9929,4,17,8,11,57,46,11,59
Stranraer,9929,5,15,6,15,56,65,-9,51
Airdrieon,9929,6,11,11,14,46,58,-12,44
East Fife,9929,7,13,4,19,48,65,-17,43
Forfar,9929,8,10,5,21,38,65,-27,35
Albion,9929,9,8,6,22,57,80,-23,30
Queen's Park,9929,10,6,10,20,42,77,-35,28
Ayr,9930,1,23,5,8,91,43,48,74
Raith,9930,2,22,8,6,69,34,35,74
Arbroath,9930,3,18,8,10,76,48,28,62
Alloa,9930,4,18,8,10,58,44,14,62
Stranraer,9930,5,15,5,16,56,67,-11,50
East Fife,9930,6,14,3,19,50,65,-15,45
Airdrieon,9930,7,10,11,15,45,59,-14,41
Forfar,9930,8,11,5,20,39,64,-25,38
Albion,9930,9,8,7,21,58,79,-21,31
Queen's Park,9930,10,6,10,20,39,78,-39,28
Raith,9931,1,23,8,5,71,33,38,77
Ayr,9931,2,24,4,8,92,42,50,76
Arbroath,9931,3,17,9,10,73,51,22,60
Alloa,9931,4,17,8,11,57,46,11,59
Stranraer,9931,5,16,5,15,59,66,-7,53
Airdrieon,9931,6,10,12,14,47,60,-13,42
East Fife,9931,7,13,3,20,49,68,-19,42
Forfar,9931,8,10,6,20,40,66,-26,36
Albion,9931,9,8,6,22,57,80,-23,30
Queen's Park,9931,10,6,11,19,42,75,-33,29
Raith,9932,1,23,8,5,72,34,38,77
Ayr,9932,2,24,4,8,96,42,54,76
Arbroath,9932,3,17,9,10,71,49,22,60
Alloa,9932,4,17,8,11,58,47,11,59
Stranraer,9932,5,16,5,15,59,64,-5,53
Airdrieon,9932,6,10,12,14,46,59,-13,42
East Fife,9932,7,13,3,20,47,68,-21,42
Forfar,9932,8,10,6,20,39,65,-26,36
Albion,9932,9,8,6,22,57,84,-27,30
Queen's Park,9932,10,6,11,19,40,73,-33,29
Ayr,9933,1,24,4,8,93,43,50,76
Raith,9933,2,22,8,6,69,34,35,74
Alloa,9933,3,18,8,10,58,44,14,62
Arbroath,9933,4,17,9,10,71,49,22,60
Stranraer,9933,5,15,5,16,58,68,-10,50
East Fife,9933,6,14,3,19,51,67,-16,45
Airdrieon,9933,7,11,11,14,48,59,-11,44
Forfar,9933,8,10,5,21,39,67,-28,35
Albion,9933,9,8,6,22,58,81,-23,30
Queen's Park,9933,10,6,11,19,40,73,-33,29
Raith,9934,1,23,8,5,70,32,38,77
Ayr,9934,2,24,4,8,94,42,52,76
Arbroath,9934,3,18,8,10,73,50,23,62
Alloa,9934,4,17,8,11,56,45,11,59
Stranraer,9934,5,15,5,16,56,68,-12,50
East Fife,9934,6,14,3,19,51,65,-14,45
Airdrieon,9934,7,10,12,14,47,60,-13,42
Forfar,9934,8,10,6,20,40,66,-26,36
Albion,9934,9,8,6,22,57,82,-25,30
Queen's Park,9934,10,6,10,20,41,75,-34,28
Ayr,9935,1,24,4,8,93,42,51,76
Raith,9935,2,22,9,5,68,32,36,75
Alloa,9935,3,17,9,10,56,43,13,60
Arbroath,9935,4,17,8,11,72,51,21,59
Stranraer,9935,5,15,5,16,56,66,-10,50
East Fife,9935,6,14,3,19,49,65,-16,45
Airdrieon,9935,7,11,11,14,47,58,-11,44
Forfar,9935,8,10,5,21,38,66,-28,35
Queen's Park,9935,9,7,10,19,42,74,-32,31
Albion,9935,10,8,6,22,57,81,-24,30
Raith,9936,1,23,8,5,69,32,37,77
Ayr,9936,2,24,4,8,95,44,51,76
Arbroath,9936,3,18,8,10,73,48,25,62
Alloa,9936,4,17,8,11,56,44,12,59
Stranraer,9936,5,15,5,16,55,66,-11,50
East Fife,9936,6,14,3,19,49,64,-15,45
Airdrieon,9936,7,10,11,15,45,59,-14,41
Forfar,9936,8,11,5,20,39,64,-25,38
Albion,9936,9,8,6,22,59,83,-24,30
Queen's Park,9936,10,6,10,20,39,75,-36,28
Raith,9937,1,23,8,5,71,34,37,77
Ayr,9937,2,24,4,8,98,42,56,76
Arbroath,9937,3,17,8,11,71,50,21,59
Alloa,9937,4,17,8,11,58,46,12,59
Stranraer,9937,5,15,6,15,57,66,-9,51
East Fife,9937,6,13,4,19,49,66,-17,43
Airdrieon,9937,7,10,11,15,45,62,-17,41
Forfar,9937,8,11,5,20,42,64,-22,38
Queen's Park,9937,9,7,10,19,41,73,-32,31
Albion,9937,10,8,6,22,57,86,-29,30
Raith,9938,1,23,8,5,72,33,39,77
Ayr,9938,2,24,4,8,94,43,51,76
Arbroath,9938,3,17,9,10,70,48,22,60
Alloa,9938,4,17,8,11,57,47,10,59
Stranraer,9938,5,15,5,16,56,66,-10,50
East Fife,9938,6,14,3,19,49,65,-16,45
Airdrieon,9938,7,10,11,15,46,60,-14,41
Forfar,9938,8,11,5,20,40,65,-25,38
Albion,9938,9,8,6,22,58,82,-24,30
Queen's Park,9938,10,6,11,19,39,72,-33,29
Raith,9939,1,23,8,5,69,32,37,77
Ayr,9939,2,23,5,8,91,43,48,74
Arbroath,9939,3,17,8,11,70,50,20,59
Alloa,9939,4,17,8,11,56,44,12,59
Stranraer,9939,5,15,5,16,55,65,-10,50
East Fife,9939,6,14,3,19,48,64,-16,45
Airdrieon,9939,7,10,12,14,46,59,-13,42
Forfar,9939,8,10,6,20,39,65,-26,36
Albion,9939,9,8,7,21,58,79,-21,31
Queen's Park,9939,10,7,10,19,41,72,-31,31
Ayr,9940,1,24,4,8,93,44,49,76
Raith,9940,2,22,9,5,70,34,36,75
Arbroath,9940,3,18,8,10,72,49,23,62
Alloa,9940,4,17,9,10,58,45,13,60
Stranraer,9940,5,15,6,15,57,66,-9,51
Airdrieon,9940,6,11,11,14,46,58,-12,44
East Fife,9940,7,13,4,19,49,66,-17,43
Forfar,9940,8,10,5,21,38,65,-27,35
Albion,9940,9,8,6,22,59,81,-22,30
Queen's Park,9940,10,6,10,20,40,74,-34,28
Ayr,9941,1,24,4,8,93,43,50,76
Raith,9941,2,22,9,5,68,32,36,75
Arbroath,9941,3,18,8,10,71,48,23,62
Alloa,9941,4,17,9,10,56,43,13,60
Stranraer,9941,5,15,5,16,55,65,-10,50
East Fife,9941,6,14,3,19,48,64,-16,45
Airdrieon,9941,7,10,12,14,47,60,-13,42
Forfar,9941,8,10,6,20,40,66,-26,36
Albion,9941,9,8,6,22,58,81,-23,30
Queen's Park,9941,10,6,10,20,39,73,-34,28
Ayr,9942,1,24,4,8,96,44,52,76
Raith,9942,2,22,8,6,69,34,35,74
Alloa,9942,3,18,8,10,58,44,14,62
Arbroath,9942,4,17,9,10,73,51,22,60
Stranraer,9942,5,15,5,16,56,68,-12,50
East Fife,9942,6,14,3,19,51,65,-14,45
Airdrieon,9942,7,10,12,14,47,60,-13,42
Forfar,9942,8,10,6,20,40,66,-26,36
Albion,9942,9,8,6,22,59,84,-25,30
Queen's Park,9942,10,6,11,19,42,75,-33,29
Ayr,9943,1,24,4,8,94,44,50,76
Raith,9943,2,22,8,6,69,35,34,74
Arbroath,9943,3,18,8,10,72,49,23,62
Alloa,9943,4,18,8,10,59,44,15,62
Stranraer,9943,5,15,5,16,55,66,-11,50
East Fife,9943,6,14,3,19,49,64,-15,45
Airdrieon,9943,7,11,11,14,47,59,-12,44
Forfar,9943,8,10,5,21,39,66,-27,35
Albion,9943,9,8,6,22,59,82,-23,30
Queen's Park,9943,10,6,10,20,40,74,-34,28
Raith,9944,1,23,8,5,72,34,38,77
Ayr,9944,2,24,4,8,94,43,51,76
Arbroath,9944,3,18,8,10,71,48,23,62
Alloa,9944,4,17,8,11,58,47,11,59
Stranraer,9944,5,15,5,16,55,65,-10,50
East Fife,9944,6,14,3,19,48,64,-16,45
Airdrieon,9944,7,11,11,14,49,59,-10,44
Forfar,9944,8,10,5,21,39,68,-29,35
Albion,9944,9,8,6,22,58,82,-24,30
Queen's Park,9944,10,6,10,20,39,73,-34,28
Ayr,9945,1,24,4,8,94,44,50,76
Raith,9945,2,22,8,6,69,34,35,74
Alloa,9945,3,18,8,10,58,44,14,62
Arbroath,9945,4,17,8,11,71,50,21,59
Stranraer,9945,5,16,5,15,60,66,-6,53
Airdrieon,9945,6,11,11,14,47,59,-12,44
East Fife,9945,7,13,3,20,49,69,-20,42
Forfar,9945,8,10,5,21,39,66,-27,35
Queen's Park,9945,9,7,10,19,41,73,-32,31
Albion,9945,10,8,6,22,59,82,-23,30
Raith,9946,1,22,9,5,70,34,36,75
Ayr,9946,2,23,4,9,91,44,47,73
Arbroath,9946,3,18,8,10,75,51,24,62
Alloa,9946,4,17,9,10,58,45,13,60
Stranraer,9946,5,15,6,15,56,65,-9,51
East Fife,9946,6,13,4,19,48,65,-17,43
Airdrieon,9946,7,10,12,14,46,59,-13,42
Forfar,9946,8,10,6,20,39,65,-26,36
Albion,9946,9,9,6,21,59,79,-20,33
Queen's Park,9946,10,6,10,20,42,77,-35,28
Raith,9947,1,22,9,5,69,33,36,75
Ayr,9947,2,23,5,8,91,43,48,74
Arbroath,9947,3,18,8,10,73,48,25,62
Alloa,9947,4,17,9,10,57,44,13,60
Stranraer,9947,5,16,5,15,57,65,-8,53
Airdrieon,9947,6,11,11,14,46,58,-12,44
East Fife,9947,7,13,3,20,48,66,-18,42
Forfar,9947,8,10,5,21,38,65,-27,35
Albion,9947,9,8,7,21,58,79,-21,31
Queen's Park,9947,10,6,10,20,39,75,-36,28
Raith,9948,1,23,8,5,71,33,38,77
Ayr,9948,2,24,4,8,93,43,50,76
Arbroath,9948,3,17,8,11,72,51,21,59
Alloa,9948,4,17,8,11,57,46,11,59
Stranraer,9948,5,15,5,16,55,67,-12,50
East Fife,9948,6,14,3,19,50,64,-14,45
Airdrieon,9948,7,11,11,14,47,58,-11,44
Forfar,9948,8,10,5,21,38,66,-28,35
Queen's Park,9948,9,7,10,19,42,74,-32,31
Albion,9948,10,8,6,22,58,81,-23,30
Raith,9949,1,23,8,5,71,32,39,77
Ayr,9949,2,24,4,8,93,43,50,76
Arbroath,9949,3,17,9,10,71,49,22,60
Alloa,9949,4,17,8,11,56,46,10,59
Stranraer,9949,5,15,6,15,56,65,-9,51
East Fife,9949,6,13,4,19,48,65,-17,43
Airdrieon,9949,7,10,11,15,46,60,-14,41
Forfar,9949,8,11,5,20,40,65,-25,38
Albion,9949,9,8,6,22,58,81,-23,30
Queen's Park,9949,10,6,11,19,40,73,-33,29
Raith,9950,1,23,8,5,69,32,37,77
Ayr,9950,2,24,4,8,92,43,49,76
Arbroath,9950,3,17,8,11,70,50,20,59
Alloa,9950,4,17,8,11,56,44,12,59
Stranraer,9950,5,16,5,15,57,65,-8,53
East Fife,9950,6,13,3,20,48,66,-18,42
Airdrieon,9950,7,10,11,15,47,64,-17,41
Forfar,9950,8,11,5,20,44,66,-22,38
Queen's Park,9950,9,7,10,19,41,72,-31,31
Albion,9950,10,8,6,22,58,80,-22,30
Ayr,9951,1,24,4,8,96,42,54,76
Raith,9951,2,22,8,6,68,36,32,74
Alloa,9951,3,18,8,10,60,43,17,62
Arbroath,9951,4,17,9,10,71,49,22,60
Stranraer,9951,5,15,5,16,55,68,-13,50
East Fife,9951,6,14,3,19,51,64,-13,45
Airdrieon,9951,7,11,11,14,47,58,-11,44
Forfar,9951,8,10,5,21,38,66,-28,35
Albion,9951,9,8,6,22,57,84,-27,30
Queen's Park,9951,10,6,11,19,40,73,-33,29
Ayr,9952,1,24,4,8,91,42,49,76
Raith,9952,2,22,9,5,69,33,36,75
Alloa,9952,3,17,9,10,57,44,13,60
Arbroath,9952,4,17,8,11,71,51,20,59
Stranraer,9952,5,15,6,15,56,65,-9,51
Airdrieon,9952,6,11,11,14,46,58,-12,44
East Fife,9952,7,13,4,19,48,65,-17,43
Forfar,9952,8,10,5,21,38,65,-27,35
Queen's Park,9952,9,7,10,19,42,73,-31,31
Albion,9952,10,8,6,22,57,79,-22,30
Raith,9953,1,23,8,5,71,32,39,77
Ayr,9953,2,24,4,8,91,42,49,76
Arbroath,9953,3,18,8,10,72,48,24,62
Alloa,9953,4,17,8,11,56,46,10,59
Stranraer,9953,5,15,5,16,57,68,-11,50
East Fife,9953,6,14,3,19,51,66,-15,45
Airdrieon,9953,7,10,12,14,46,59,-13,42
Forfar,9953,8,10,6,20,39,65,-26,36
Albion,9953,9,8,6,22,57,79,-22,30
Queen's Park,9953,10,6,10,20,39,74,-35,28
Ayr,9954,1,24,4,8,94,43,51,76
Raith,9954,2,22,9,5,69,33,36,75
Arbroath,9954,3,17,9,10,72,50,22,60
Alloa,9954,4,17,9,10,57,44,13,60
Stranraer,9954,5,15,5,16,56,69,-13,50
East Fife,9954,6,14,3,19,52,65,-13,45
Airdrieon,9954,7,10,11,15,45,61,-16,41
Forfar,9954,8,11,5,20,41,64,-23,38
Albion,9954,9,8,6,22,58,82,-24,30
Queen's Park,9954,10,6,11,19,41,74,-33,29
Ayr,9955,1,24,4,8,96,44,52,76
Raith,9955,2,22,8,6,68,34,34,74
Alloa,9955,3,18,8,10,58,43,15,62
Arbroath,9955,4,17,9,10,71,49,22,60
Stranraer,9955,5,15,6,15,57,66,-9,51
Airdrieon,9955,6,11,11,14,47,58,-11,44
East Fife,9955,7,13,4,19,49,66,-17,43
Forfar,9955,8,10,5,21,38,66,-28,35
Albion,9955,9,8,6,22,59,84,-25,30
Queen's Park,9955,10,6,11,19,40,73,-33,29
Raith,9956,1,22,9,5,68,32,36,75
Ayr,9956,2,23,5,8,92,44,48,74
Arbroath,9956,3,18,8,10,71,48,23,62
Alloa,9956,4,17,9,10,56,43,13,60
Stranraer,9956,5,15,5,16,55,69,-14,50
East Fife,9956,6,14,3,19,52,64,-12,45
Airdrieon,9956,7,10,12,14,46,59,-13,42
Forfar,9956,8,10,6,20,39,65,-26,36
Albion,9956,9,8,7,21,59,80,-21,31
Queen's Park,9956,10,6,10,20,39,73,-34,28
Raith,9957,1,23,8,5,71,34,37,77
Ayr,9957,2,24,4,8,95,42,53,76
Arbroath,9957,3,17,9,10,71,49,22,60
Alloa,9957,4,17,8,11,58,46,12,59
Stranraer,9957,5,16,5,15,59,66,-7,53
East Fife,9957,6,13,3,20,49,68,-19,42
Airdrieon,9957,7,10,11,15,46,62,-16,41
Forfar,9957,8,11,5,20,42,65,-23,38
Albion,9957,9,8,6,22,57,83,-26,30
Queen's Park,9957,10,6,11,19,40,73,-33,29
Raith,9958,1,23,8,5,70,33,37,77
Ayr,9958,2,24,4,8,95,46,49,76
Arbroath,9958,3,18,8,10,72,48,24,62
Alloa,9958,4,17,8,11,57,45,12,59
Stranraer,9958,5,16,5,15,57,64,-7,53
Airdrieon,9958,6,11,11,14,47,58,-11,44
East Fife,9958,7,13,3,20,47,66,-19,42
Forfar,9958,8,10,5,21,38,66,-28,35
Albion,9958,9,8,6,22,61,83,-22,30
Queen's Park,9958,10,6,10,20,39,74,-35,28
Raith,9959,1,22,9,5,68,32,36,75
Ayr,9959,2,23,5,8,92,44,48,74
Arbroath,9959,3,18,8,10,71,48,23,62
Alloa,9959,4,17,9,10,56,43,13,60
Stranraer,9959,5,15,5,16,57,67,-10,50
East Fife,9959,6,14,3,19,50,66,-16,45
Airdrieon,9959,7,10,12,14,47,60,-13,42
Forfar,9959,8,10,6,20,40,66,-26,36
Albion,9959,9,8,7,21,59,80,-21,31
Queen's Park,9959,10,6,10,20,39,73,-34,28
Raith,9960,1,23,8,5,70,32,38,77
Ayr,9960,2,24,4,8,92,42,50,76
Arbroath,9960,3,18,8,10,75,50,25,62
Alloa,9960,4,17,8,11,56,45,11,59
Stranraer,9960,5,16,5,15,57,65,-8,53
Airdrieon,9960,6,10,12,14,45,58,-13,42
East Fife,9960,7,13,3,20,48,66,-18,42
Forfar,9960,8,10,6,20,38,64,-26,36
Albion,9960,9,8,6,22,57,80,-23,30
Queen's Park,9960,10,6,10,20,41,77,-36,28
Ayr,9961,1,24,4,8,92,42,50,76
Raith,9961,2,22,8,6,68,33,35,74
Alloa,9961,3,18,8,10,57,43,14,62
Arbroath,9961,4,17,9,10,70,48,22,60
Stranraer,9961,5,15,5,16,55,65,-10,50
East Fife,9961,6,14,3,19,48,64,-16,45
Airdrieon,9961,7,11,11,14,50,59,-9,44
Forfar,9961,8,10,5,21,39,69,-30,35
Albion,9961,9,8,6,22,57,80,-23,30
Queen's Park,9961,10,6,11,19,39,72,-33,29
Ayr,9962,1,24,4,8,92,43,49,76
Raith,9962,2,22,8,6,69,35,34,74
Arbroath,9962,3,18,8,10,72,49,23,62
Alloa,9962,4,18,8,10,59,44,15,62
Stranraer,9962,5,15,5,16,55,67,-12,50
East Fife,9962,6,14,3,19,50,64,-14,45
Airdrieon,9962,7,10,12,14,45,58,-13,42
Forfar,9962,8,10,6,20,38,64,-26,36
Albion,9962,9,8,6,22,58,80,-22,30
Queen's Park,9962,10,6,10,20,40,74,-34,28
Ayr,9963,1,24,4,8,93,42,51,76
Raith,9963,2,22,8,6,68,33,35,74
Alloa,9963,3,18,8,10,57,43,14,62
Arbroath,9963,4,17,8,11,72,52,20,59
Stranraer,9963,5,15,5,16,56,67,-11,50
East Fife,9963,6,14,3,19,50,65,-15,45
Airdrieon,9963,7,11,11,14,47,58,-11,44
Forfar,9963,8,10,5,21,38,66,-28,35
Queen's Park,9963,9,7,10,19,43,74,-31,31
Albion,9963,10,8,6,22,57,81,-24,30
Raith,9964,1,23,8,5,71,32,39,77
Ayr,9964,2,24,4,8,96,43,53,76
Arbroath,9964,3,17,9,10,72,50,22,60
Alloa,9964,4,17,8,11,56,46,10,59
Stranraer,9964,5,15,5,16,56,66,-10,50
East Fife,9964,6,14,3,19,49,65,-16,45
Airdrieon,9964,7,11,11,14,48,59,-11,44
Forfar,9964,8,10,5,21,39,67,-28,35
Albion,9964,9,8,6,22,58,84,-26,30
Queen's Park,9964,10,6,11,19,41,74,-33,29
Raith,9965,1,23,8,5,70,32,38,77
Ayr,9965,2,23,4,9,90,43,47,73
Arbroath,9965,3,18,8,10,72,49,23,62
Alloa,9965,4,17,8,11,56,45,11,59
Stranraer,9965,5,15,5,16,57,67,-10,50
East Fife,9965,6,14,3,19,50,66,-16,45
Airdrieon,9965,7,11,11,14,48,59,-11,44
Forfar,9965,8,10,5,21,39,67,-28,35
Albion,9965,9,9,6,21,58,78,-20,33
Queen's Park,9965,10,6,10,20,40,74,-34,28
Ayr,9966,1,24,4,8,93,43,50,76
Raith,9966,2,22,8,6,68,34,34,74
Arbroath,9966,3,18,8,10,73,50,23,62
Alloa,9966,4,18,8,10,58,43,15,62
Stranraer,9966,5,16,5,15,60,65,-5,53
Airdrieon,9966,6,10,12,14,46,59,-13,42
East Fife,9966,7,13,3,20,48,69,-21,42
Forfar,9966,8,10,6,20,39,65,-26,36
Albion,9966,9,8,6,22,58,81,-23,30
Queen's Park,9966,10,6,10,20,41,75,-34,28
Raith,9967,1,23,8,5,71,33,38,77
Ayr,9967,2,24,4,8,93,43,50,76
Arbroath,9967,3,18,8,10,73,49,24,62
Alloa,9967,4,17,8,11,57,46,11,59
Stranraer,9967,5,15,5,16,56,67,-11,50
East Fife,9967,6,14,3,19,50,65,-15,45
Airdrieon,9967,7,10,12,14,47,60,-13,42
Forfar,9967,8,10,6,20,40,66,-26,36
Albion,9967,9,8,6,22,58,81,-23,30
Queen's Park,9967,10,6,10,20,40,75,-35,28
Raith,9968,1,23,8,5,73,33,40,77
Ayr,9968,2,24,4,8,92,43,49,76
Arbroath,9968,3,18,8,10,75,49,26,62
Alloa,9968,4,17,8,11,57,48,9,59
Stranraer,9968,5,15,5,16,55,66,-11,50
East Fife,9968,6,14,3,19,49,64,-15,45
Airdrieon,9968,7,10,12,14,47,60,-13,42
Forfar,9968,8,10,6,20,40,66,-26,36
Albion,9968,9,8,6,22,58,80,-22,30
Queen's Park,9968,10,6,10,20,40,77,-37,28
Raith,9969,1,23,8,5,70,32,38,77
Ayr,9969,2,24,4,8,94,43,51,76
Arbroath,9969,3,17,8,11,70,49,21,59
Alloa,9969,4,17,8,11,56,45,11,59
Stranraer,9969,5,15,5,16,55,66,-11,50
East Fife,9969,6,14,3,19,49,64,-15,45
Airdrieon,9969,7,11,11,14,46,58,-12,44
Forfar,9969,8,10,5,21,38,65,-27,35
Queen's Park,9969,9,7,10,19,40,72,-32,31
Albion,9969,10,8,6,22,58,82,-24,30
Ayr,9970,1,24,4,8,92,43,49,76
Raith,9970,2,22,8,6,68,34,34,74
Alloa,9970,3,18,8,10,58,43,15,62
Arbroath,9970,4,17,8,11,72,51,21,59
Stranraer,9970,5,15,5,16,55,65,-10,50
East Fife,9970,6,14,3,19,48,64,-16,45
Airdrieon,9970,7,10,12,14,45,58,-13,42
Forfar,9970,8,10,6,20,38,64,-26,36
Queen's Park,9970,9,7,10,19,42,74,-32,31
Albion,9970,10,8,6,22,58,80,-22,30
Ayr,9971,1,24,4,8,96,44,52,76
Raith,9971,2,22,9,5,69,33,36,75
Arbroath,9971,3,17,9,10,71,49,22,60
Alloa,9971,4,17,9,10,57,44,13,60
Stranraer,9971,5,15,6,15,56,65,-9,51
Airdrieon,9971,6,11,11,14,48,59,-11,44
East Fife,9971,7,13,4,19,48,65,-17,43
Forfar,9971,8,10,5,21,39,67,-28,35
Albion,9971,9,8,6,22,59,84,-25,30
Queen's Park,9971,10,6,11,19,40,73,-33,29
Raith,9972,1,23,8,5,72,33,39,77
Ayr,9972,2,24,4,8,94,44,50,76
Arbroath,9972,3,17,8,11,73,52,21,59
Alloa,9972,4,17,8,11,57,47,10,59
Stranraer,9972,5,15,5,16,57,69,-12,50
East Fife,9972,6,14,3,19,52,66,-14,45
Airdrieon,9972,7,10,11,15,46,60,-14,41
Forfar,9972,8,11,5,20,40,65,-25,38
Queen's Park,9972,9,7,10,19,43,75,-32,31
Albion,9972,10,8,6,22,59,82,-23,30
Ayr,9973,1,24,4,8,96,44,52,76
Raith,9973,2,22,9,5,68,32,36,75
Arbroath,9973,3,17,9,10,71,49,22,60
Alloa,9973,4,17,9,10,56,43,13,60
Stranraer,9973,5,15,5,16,56,67,-11,50
East Fife,9973,6,14,3,19,50,65,-15,45
Airdrieon,9973,7,11,11,14,49,58,-9,44
Forfar,9973,8,10,5,21,38,68,-30,35
Albion,9973,9,8,6,22,59,84,-25,30
Queen's Park,9973,10,6,11,19,40,73,-33,29
Raith,9974,1,23,8,5,70,33,37,77
Ayr,9974,2,24,4,8,97,43,54,76
Arbroath,9974,3,17,9,10,71,49,22,60
Alloa,9974,4,17,8,11,57,45,12,59
Stranraer,9974,5,15,5,16,55,65,-10,50
East Fife,9974,6,14,3,19,48,64,-16,45
Airdrieon,9974,7,11,11,14,47,58,-11,44
Forfar,9974,8,10,5,21,38,66,-28,35
Albion,9974,9,8,6,22,58,85,-27,30
Queen's Park,9974,10,6,11,19,40,73,-33,29
Ayr,9975,1,24,4,8,95,43,52,76
Raith,9975,2,22,9,5,68,32,36,75
Arbroath,9975,3,18,8,10,71,48,23,62
Alloa,9975,4,17,9,10,56,43,13,60
Stranraer,9975,5,15,5,16,55,66,-11,50
East Fife,9975,6,14,3,19,49,64,-15,45
Airdrieon,9975,7,11,11,14,46,58,-12,44
Forfar,9975,8,10,5,21,38,65,-27,35
Albion,9975,9,8,6,22,58,83,-25,30
Queen's Park,9975,10,6,10,20,39,73,-34,28
Ayr,9976,1,24,4,8,93,42,51,76
Raith,9976,2,22,9,5,69,33,36,75
Alloa,9976,3,17,9,10,57,44,13,60
Arbroath,9976,4,17,8,11,71,50,21,59
Stranraer,9976,5,15,5,16,56,66,-10,50
East Fife,9976,6,14,3,19,49,65,-16,45
Airdrieon,9976,7,11,11,14,47,58,-11,44
Forfar,9976,8,10,5,21,38,66,-28,35
Queen's Park,9976,9,7,10,19,41,73,-32,31
Albion,9976,10,8,6,22,57,81,-24,30
Raith,9977,1,23,8,5,71,32,39,77
Ayr,9977,2,23,5,8,91,43,48,74
Arbroath,9977,3,17,9,10,71,49,22,60
Alloa,9977,4,17,8,11,56,46,10,59
Stranraer,9977,5,15,5,16,56,68,-12,50
East Fife,9977,6,14,3,19,51,65,-14,45
Airdrieon,9977,7,11,11,14,47,58,-11,44
Forfar,9977,8,10,5,21,38,66,-28,35
Albion,9977,9,8,7,21,58,79,-21,31
Queen's Park,9977,10,6,11,19,40,73,-33,29
Raith,9978,1,22,9,5,70,34,36,75
Ayr,9978,2,23,4,9,91,44,47,73
Arbroath,9978,3,18,8,10,72,48,24,62
Alloa,9978,4,17,9,10,58,45,13,60
Stranraer,9978,5,16,5,15,56,64,-8,53
Airdrieon,9978,6,11,11,14,47,58,-11,44
East Fife,9978,7,13,3,20,47,65,-18,42
Forfar,9978,8,10,5,21,38,66,-28,35
Albion,9978,9,9,6,21,59,79,-20,33
Queen's Park,9978,10,6,10,20,39,74,-35,28
Raith,9979,1,23,8,5,71,34,37,77
Ayr,9979,2,24,4,8,94,43,51,76
Arbroath,9979,3,17,9,10,72,50,22,60
Alloa,9979,4,17,8,11,58,46,12,59
Stranraer,9979,5,15,5,16,55,67,-12,50
East Fife,9979,6,14,3,19,50,64,-14,45
Airdrieon,9979,7,11,11,14,48,58,-10,44
Forfar,9979,8,10,5,21,38,67,-29,35
Albion,9979,9,8,6,22,58,82,-24,30
Queen's Park,9979,10,6,11,19,41,74,-33,29
Raith,9980,1,23,8,5,72,33,39,77
Ayr,9980,2,24,4,8,97,45,52,76
Arbroath,9980,3,17,8,11,71,50,21,59
Alloa,9980,4,17,8,11,57,47,10,59
Stranraer,9980,5,15,6,15,57,66,-9,51
Airdrieon,9980,6,11,11,14,49,58,-9,44
East Fife,9980,7,13,4,19,49,66,-17,43
Forfar,9980,8,10,5,21,38,68,-30,35
Queen's Park,9980,9,7,10,19,41,73,-32,31
Albion,9980,10,8,6,22,60,85,-25,30
Ayr,9981,1,24,4,8,95,42,53,76
Raith,9981,2,22,8,6,69,34,35,74
Arbroath,9981,3,18,8,10,73,49,24,62
Alloa,9981,4,18,8,10,58,44,14,62
Stranraer,9981,5,15,5,16,55,67,-12,50
East Fife,9981,6,14,3,19,50,64,-14,45
Airdrieon,9981,7,11,11,14,48,60,-12,44
Forfar,9981,8,10,5,21,40,67,-27,35
Albion,9981,9,8,6,22,57,83,-26,30
Queen's Park,9981,10,6,10,20,40,75,-35,28
Raith,9982,1,23,8,5,72,32,40,77
Ayr,9982,2,23,4,9,91,44,47,73
Arbroath,9982,3,17,9,10,70,48,22,60
Alloa,9982,4,17,8,11,56,47,9,59
Stranraer,9982,5,15,6,15,56,65,-9,51
East Fife,9982,6,13,4,19,48,65,-17,43
Airdrieon,9982,7,10,12,14,45,58,-13,42
Forfar,9982,8,10,6,20,38,64,-26,36
Albion,9982,9,9,6,21,59,79,-20,33
Queen's Park,9982,10,6,11,19,39,72,-33,29
Raith,9983,1,23,8,5,71,32,39,77
Ayr,9983,2,23,5,8,92,44,48,74
Arbroath,9983,3,18,8,10,71,48,23,62
Alloa,9983,4,17,8,11,56,46,10,59
Stranraer,9983,5,16,5,15,59,67,-8,53
East Fife,9983,6,13,3,20,50,68,-18,42
Airdrieon,9983,7,10,11,15,47,62,-15,41
Forfar,9983,8,11,5,20,42,66,-24,38
Albion,9983,9,8,7,21,59,80,-21,31
Queen's Park,9983,10,6,10,20,39,73,-34,28
Raith,9984,1,23,8,5,71,32,39,77
Ayr,9984,2,24,4,8,93,44,49,76
Arbroath,9984,3,18,8,10,73,50,23,62
Alloa,9984,4,17,8,11,56,46,10,59
Stranraer,9984,5,15,6,15,56,65,-9,51
East Fife,9984,6,13,4,19,48,65,-17,43
Airdrieon,9984,7,10,12,14,46,59,-13,42
Forfar,9984,8,10,6,20,39,65,-26,36
Albion,9984,9,8,6,22,59,81,-22,30
Queen's Park,9984,10,6,10,20,41,75,-34,28
Raith,9985,1,23,8,5,69,32,37,77
Ayr,9985,2,24,4,8,93,42,51,76
Arbroath,9985,3,18,8,10,72,48,24,62
Alloa,9985,4,17,8,11,56,44,12,59
Stranraer,9985,5,15,5,16,55,66,-11,50
East Fife,9985,6,14,3,19,49,64,-15,45
Airdrieon,9985,7,11,11,14,48,59,-11,44
Forfar,9985,8,10,5,21,39,67,-28,35
Albion,9985,9,8,6,22,57,81,-24,30
Queen's Park,9985,10,6,10,20,39,74,-35,28
Ayr,9986,1,24,4,8,96,42,54,76
Raith,9986,2,22,9,5,69,33,36,75
Alloa,9986,3,17,9,10,57,44,13,60
Arbroath,9986,4,17,8,11,70,50,20,59
Stranraer,9986,5,16,5,15,56,64,-8,53
East Fife,9986,6,13,3,20,47,65,-18,42
Airdrieon,9986,7,10,11,15,45,59,-14,41
Forfar,9986,8,11,5,20,39,64,-25,38
Queen's Park,9986,9,7,10,19,41,72,-31,31
Albion,9986,10,8,6,22,57,84,-27,30
Ayr,9987,1,24,4,8,95,42,53,76
Raith,9987,2,22,9,5,68,32,36,75
Arbroath,9987,3,17,9,10,71,49,22,60
Alloa,9987,4,17,9,10,56,43,13,60
Stranraer,9987,5,15,5,16,56,67,-11,50
East Fife,9987,6,14,3,19,50,65,-15,45
Airdrieon,9987,7,11,11,14,46,58,-12,44
Forfar,9987,8,10,5,21,38,65,-27,35
Albion,9987,9,8,6,22,57,83,-26,30
Queen's Park,9987,10,6,11,19,40,73,-33,29
Raith,9988,1,23,8,5,69,32,37,77
Ayr,9988,2,24,4,8,94,42,52,76
Arbroath,9988,3,17,8,11,70,49,21,59
Alloa,9988,4,17,8,11,56,44,12,59
Stranraer,9988,5,16,5,15,57,65,-8,53
Airdrieon,9988,6,11,11,14,48,59,-11,44
East Fife,9988,7,13,3,20,48,66,-18,42
Forfar,9988,8,10,5,21,39,67,-28,35
Queen's Park,9988,9,7,10,19,40,72,-32,31
Albion,9988,10,8,6,22,57,82,-25,30
Raith,9989,1,22,9,5,70,34,36,75
Ayr,9989,2,23,4,9,91,46,45,73
Arbroath,9989,3,17,9,10,70,48,22,60
Alloa,9989,4,17,9,10,58,45,13,60
Stranraer,9989,5,16,5,15,56,64,-8,53
Airdrieon,9989,6,11,11,14,47,59,-12,44
East Fife,9989,7,13,3,20,47,65,-18,42
Forfar,9989,8,10,5,21,39,66,-27,35
Albion,9989,9,9,6,21,61,79,-18,33
Queen's Park,9989,10,6,11,19,39,72,-33,29
Raith,9990,1,23,8,5,72,33,39,77
Ayr,9990,2,24,4,8,92,42,50,76
Arbroath,9990,3,18,8,10,73,49,24,62
Alloa,9990,4,17,8,11,57,47,10,59
Stranraer,9990,5,15,5,16,55,65,-10,50
East Fife,9990,6,14,3,19,48,64,-16,45
Airdrieon,9990,7,10,11,15,46,60,-14,41
Forfar,9990,8,11,5,20,40,65,-25,38
Albion,9990,9,8,6,22,57,80,-23,30
Queen's Park,9990,10,6,10,20,40,75,-35,28
Ayr,9991,1,24,4,8,94,43,51,76
Raith,9991,2,22,9,5,69,33,36,75
Arbroath,9991,3,17,9,10,73,51,22,60
Alloa,9991,4,17,9,10,57,44,13,60
Stranraer,9991,5,16,5,15,56,64,-8,53
Airdrieon,9991,6,11,11,14,46,58,-12,44
East Fife,9991,7,13,3,20,47,65,-18,42
Forfar,9991,8,10,5,21,38,65,-27,35
Albion,9991,9,8,6,22,58,82,-24,30
Queen's Park,9991,10,6,11,19,42,75,-33,29
Raith,9992,1,23,8,5,71,32,39,77
Ayr,9992,2,24,4,8,94,43,51,76
Arbroath,9992,3,17,8,11,71,51,20,59
Alloa,9992,4,17,8,11,56,46,10,59
Stranraer,9992,5,15,5,16,56,67,-11,50
East Fife,9992,6,14,3,19,50,65,-15,45
Airdrieon,9992,7,10,12,14,46,59,-13,42
Forfar,9992,8,10,6,20,39,65,-26,36
Queen's Park,9992,9,7,10,19,42,73,-31,31
Albion,9992,10,8,6,22,58,82,-24,30
Raith,9993,1,23,8,5,69,32,37,77
Ayr,9993,2,24,4,8,93,42,51,76
Arbroath,9993,3,17,8,11,70,49,21,59
Alloa,9993,4,17,8,11,56,44,12,59
Stranraer,9993,5,15,5,16,57,67,-10,50
East Fife,9993,6,14,3,19,50,66,-16,45
Airdrieon,9993,7,11,11,14,47,58,-11,44
Forfar,9993,8,10,5,21,38,66,-28,35
Queen's Park,9993,9,7,10,19,40,72,-32,31
Albion,9993,10,8,6,22,57,81,-24,30
Raith,9994,1,23,8,5,71,32,39,77
Ayr,9994,2,24,4,8,93,44,49,76
Arbroath,9994,3,18,8,10,72,49,23,62
Alloa,9994,4,17,8,11,56,46,10,59
Stranraer,9994,5,15,5,16,55,66,-11,50
East Fife,9994,6,14,3,19,49,64,-15,45
Airdrieon,9994,7,11,11,14,46,58,-12,44
Forfar,9994,8,10,5,21,38,65,-27,35
Albion,9994,9,8,6,22,59,81,-22,30
Queen's Park,9994,10,6,10,20,40,74,-34,28
Raith,9995,1,23,8,5,70,32,38,77
Ayr,9995,2,23,5,8,91,43,48,74
Arbroath,9995,3,18,8,10,71,48,23,62
Alloa,9995,4,17,8,11,56,45,11,59
Stranraer,9995,5,16,5,15,57,64,-7,53
East Fife,9995,6,13,3,20,47,66,-19,42
Airdrieon,9995,7,10,11,15,45,60,-15,41
Forfar,9995,8,11,5,20,40,64,-24,38
Albion,9995,9,8,7,21,58,79,-21,31
Queen's Park,9995,10,6,10,20,39,73,-34,28
Raith,9996,1,22,9,5,70,34,36,75
Ayr,9996,2,23,5,8,92,44,48,74
Alloa,9996,3,17,9,10,58,45,13,60
Arbroath,9996,4,17,8,11,70,50,20,59
Stranraer,9996,5,16,5,15,56,64,-8,53
East Fife,9996,6,13,3,20,47,65,-18,42
Airdrieon,9996,7,10,11,15,45,62,-17,41
Forfar,9996,8,11,5,20,42,64,-22,38
Albion,9996,9,8,7,21,59,80,-21,31
Queen's Park,9996,10,7,10,19,41,72,-31,31
Ayr,9997,1,24,4,8,96,43,53,76
Raith,9997,2,22,9,5,69,33,36,75
Arbroath,9997,3,17,9,10,70,48,22,60
Alloa,9997,4,17,9,10,57,44,13,60
Stranraer,9997,5,15,6,15,55,64,-9,51
Airdrieon,9997,6,11,11,14,46,58,-12,44
East Fife,9997,7,13,4,19,47,64,-17,43
Forfar,9997,8,10,5,21,38,65,-27,35
Albion,9997,9,8,6,22,58,84,-26,30
Queen's Park,9997,10,6,11,19,39,72,-33,29
Raith,9998,1,23,8,5,70,32,38,77
Ayr,9998,2,24,4,8,94,43,51,76
Arbroath,9998,3,17,8,11,71,50,21,59
Alloa,9998,4,17,8,11,56,45,11,59
Stranraer,9998,5,15,6,15,56,65,-9,51
Airdrieon,9998,6,11,11,14,47,58,-11,44
East Fife,9998,7,13,4,19,48,65,-17,43
Forfar,9998,8,10,5,21,38,66,-28,35
Queen's Park,9998,9,7,10,19,41,73,-32,31
Albion,9998,10,8,6,22,58,82,-24,30
Raith,9999,1,23,8,5,71,33,38,77
Ayr,9999,2,24,4,8,93,43,50,76
Arbroath,9999,3,17,9,10,72,50,22,60
Alloa,9999,4,17,8,11,57,46,11,59
Stranraer,9999,5,15,6,15,57,66,-9,51
Airdrieon,9999,6,11,11,14,50,58,-8,44
East Fife,9999,7,13,4,19,49,66,-17,43
Forfar,9999,8,10,5,21,38,69,-31,35
Albion,9999,9,8,6,22,58,81,-23,30
Queen's Park,9999,10,6,11,19,41,74,-33,29
